Nr.;"Darželio pavadinimas";"Grupės pavadinimas";"Vaiko Identifikacinis Nr.";"Deklaruotas mieste";"Pateisintos dėl ligos";"Pateisintos dėl kitų priežasčių";"Nepateisintos dienos";"Praleistos dienos Viso"
1;Aitvaras;"VIJURKAI (ALERG.)";6936031222;Ne;0;4;0;4
2;Aitvaras;"VIJURKAI (ALERG.)";6214880713;Ne;0;3;0;3
3;Aitvaras;"VIJURKAI (ALERG.)";2566375128;Ne;0;5;0;5
4;Aitvaras;"VIJURKAI (ALERG.)";1879540041;Ne;0;7;0;7
5;Aitvaras;"VIJURKAI (ALERG.)";1532588441;Ne;0;1;0;1
6;Aitvaras;"VIJURKAI (ALERG.)";8206046301;Ne;19;0;0;19
7;Aitvaras;"VIJURKAI (ALERG.)";1347364985;Ne;0;4;0;4
8;Aitvaras;"VIJURKAI (ALERG.)";9157794193;Ne;0;5;0;5
9;Aitvaras;"VIJURKAI (ALERG.)";9562494357;Ne;5;6;0;11
10;Aitvaras;"VIJURKAI (ALERG.)";6021342178;Ne;19;0;0;19
11;Aitvaras;"VIJURKAI (ALERG.)";2650483861;Ne;3;4;0;7
12;Aitvaras;"VIJURKAI (ALERG.)";2601983670;Ne;0;4;0;4
13;Aitvaras;"VIJURKAI (ALERG.)";2895663259;Ne;1;3;0;4
14;Aitvaras;"VIJURKAI (ALERG.)";3570820823;Ne;0;4;1;5
15;Aitvaras;"VIJURKAI (ALERG.)";6444377924;Ne;0;15;0;15
16;Aitvaras;"VIJURKAI (ALERG.)";4702400490;Ne;2;4;0;6
17;Aitvaras;"VIJURKAI (ALERG.)";9807784148;Ne;0;4;1;5
18;Aitvaras;"VIJURKAI (ALERG.)";8641433486;Ne;0;6;0;6
19;Aitvaras;"VIJURKAI (ALERG.)";5619137905;Ne;0;4;0;4
20;Aitvaras;"SMALSUČIAI (ALERG.)";7109001184;Ne;1;4;0;5
21;Aitvaras;"SMALSUČIAI (ALERG.)";4114397590;Ne;0;6;0;6
22;Aitvaras;"SMALSUČIAI (ALERG.)";2357399981;Ne;1;6;0;7
23;Aitvaras;"SMALSUČIAI (ALERG.)";2760970218;Ne;0;1;0;1
24;Aitvaras;"SMALSUČIAI (ALERG.)";8666824607;Ne;0;5;0;5
25;Aitvaras;"SMALSUČIAI (ALERG.)";5378212904;Ne;4;4;0;8
26;Aitvaras;"SMALSUČIAI (ALERG.)";5238819066;Ne;0;4;0;4
27;Aitvaras;"SMALSUČIAI (ALERG.)";4564723798;Ne;2;0;1;3
28;Aitvaras;"SMALSUČIAI (ALERG.)";4176681907;Ne;0;13;0;13
29;Aitvaras;"SMALSUČIAI (ALERG.)";3655710511;Ne;6;5;0;11
30;Aitvaras;"SMALSUČIAI (ALERG.)";7260577885;Ne;0;4;0;4
31;Aitvaras;"SMALSUČIAI (ALERG.)";5612991255;Ne;0;4;0;4
32;Aitvaras;"SMALSUČIAI (ALERG.)";5572538840;Ne;4;0;1;5
33;Aitvaras;"SMALSUČIAI (ALERG.)";4120515569;Ne;0;7;0;7
34;Aitvaras;"SMALSUČIAI (ALERG.)";4612994715;Ne;4;0;3;7
35;Aitvaras;"SMALSUČIAI (ALERG.)";9885781306;Ne;3;3;0;6
36;Aitvaras;"SMALSUČIAI (ALERG.)";1091372798;Ne;15;4;0;19
37;Aitvaras;"SMALSUČIAI (ALERG.)";1115202169;Taip;0;2;0;2
38;Aitvaras;"SMALSUČIAI (ALERG.)";1599183050;Ne;0;5;0;5
39;Aitvaras;"SMALSUČIAI (ALERG.)";2821221241;Ne;0;1;0;1
40;Aitvaras;PADAUŽIUKAI;8065540507;Ne;2;5;0;7
41;Aitvaras;PADAUŽIUKAI;2328771385;Ne;0;13;0;13
42;Aitvaras;PADAUŽIUKAI;1288810999;Ne;0;3;0;3
43;Aitvaras;PADAUŽIUKAI;6501943902;Ne;0;6;0;6
44;Aitvaras;PADAUŽIUKAI;3101015381;Ne;1;4;0;5
45;Aitvaras;PADAUŽIUKAI;4350590529;Ne;2;4;1;7
46;Aitvaras;PADAUŽIUKAI;7777235021;Ne;4;4;0;8
47;Aitvaras;PADAUŽIUKAI;5641224483;Ne;5;4;0;9
48;Aitvaras;PADAUŽIUKAI;6214572150;Ne;9;5;0;14
49;Aitvaras;PADAUŽIUKAI;1830134108;Ne;7;4;0;11
50;Aitvaras;PADAUŽIUKAI;3178965623;Ne;0;6;0;6
51;Aitvaras;PADAUŽIUKAI;5905456814;Ne;0;2;0;2
52;Aitvaras;PADAUŽIUKAI;6739827530;Ne;6;1;0;7
53;Aitvaras;PADAUŽIUKAI;3735941659;Ne;5;3;0;8
54;Aitvaras;PADAUŽIUKAI;3323458595;Ne;0;2;0;2
55;Aitvaras;PADAUŽIUKAI;2807595769;Ne;0;3;0;3
56;Aitvaras;PADAUŽIUKAI;8360380303;Ne;9;1;0;10
57;Aitvaras;PADAUŽIUKAI;1252145346;Ne;0;4;2;6
58;Aitvaras;PADAUŽIUKAI;8439586875;Ne;0;7;0;7
59;Aitvaras;PADAUŽIUKAI;1594675221;Ne;5;5;0;10
60;Aitvaras;"AITVARIUKAI (ALERG.)";3639102842;Ne;0;7;0;7
61;Aitvaras;"AITVARIUKAI (ALERG.)";7243387750;Ne;4;0;0;4
62;Aitvaras;"AITVARIUKAI (ALERG.)";6587437949;Ne;0;5;0;5
63;Aitvaras;"AITVARIUKAI (ALERG.)";7461284958;Ne;0;5;0;5
64;Aitvaras;"AITVARIUKAI (ALERG.)";3394251305;Ne;0;4;0;4
65;Aitvaras;"AITVARIUKAI (ALERG.)";6459307767;Ne;0;5;0;5
66;Aitvaras;"AITVARIUKAI (ALERG.)";5635576679;Ne;5;5;0;10
67;Aitvaras;"AITVARIUKAI (ALERG.)";7988247429;Ne;5;5;0;10
68;Aitvaras;"AITVARIUKAI (ALERG.)";8770777328;Ne;0;10;0;10
69;Aitvaras;"AITVARIUKAI (ALERG.)";3653879553;Ne;0;5;0;5
70;Aitvaras;"AITVARIUKAI (ALERG.)";9721273154;Ne;12;0;0;12
71;Aitvaras;"AITVARIUKAI (ALERG.)";8543644000;Taip;0;2;0;2
72;Aitvaras;"AITVARIUKAI (ALERG.)";1859647003;Ne;2;2;0;4
73;Aitvaras;"AITVARIUKAI (ALERG.)";4204923580;Ne;2;5;0;7
74;Aitvaras;"AITVARIUKAI (ALERG.)";4777266938;Ne;10;5;0;15
75;Aitvaras;"AITVARIUKAI (ALERG.)";7568388141;Ne;5;5;0;10
76;Aitvaras;"AITVARIUKAI (ALERG.)";3954840915;Ne;0;6;0;6
77;Aitvaras;"AITVARIUKAI (ALERG.)";2146963673;Ne;5;3;0;8
78;Aitvaras;"AITVARIUKAI (ALERG.)";9763502346;Ne;4;6;0;10
79;Aitvaras;"AITVARIUKAI (ALERG.)";9228736015;Ne;0;3;0;3
80;Aitvaras;"AITVARIUKAI (ALERG.)";3775634117;Ne;0;3;0;3
81;Aitvaras;"AITVARIUKAI (ALERG.)";2615576367;Ne;8;1;0;9
82;Aitvaras;"SAULĖS ZUIKUČIAI  (ALERG.)";5711324951;Ne;5;7;0;12
83;Aitvaras;"SAULĖS ZUIKUČIAI  (ALERG.)";4106097701;Ne;0;2;0;2
84;Aitvaras;"SAULĖS ZUIKUČIAI  (ALERG.)";9659883026;Ne;3;0;1;4
85;Aitvaras;"SAULĖS ZUIKUČIAI  (ALERG.)";2184231202;Ne;6;5;0;11
86;Aitvaras;"SAULĖS ZUIKUČIAI  (ALERG.)";2478737835;Ne;4;0;1;5
87;Aitvaras;"SAULĖS ZUIKUČIAI  (ALERG.)";1136438927;Ne;0;5;0;5
88;Aitvaras;"SAULĖS ZUIKUČIAI  (ALERG.)";8137900398;Ne;5;3;0;8
89;Aitvaras;"SAULĖS ZUIKUČIAI  (ALERG.)";9147954612;Ne;0;0;2;2
90;Aitvaras;"SAULĖS ZUIKUČIAI  (ALERG.)";2511844613;Ne;0;4;0;4
91;Aitvaras;"SAULĖS ZUIKUČIAI  (ALERG.)";7907357058;Ne;3;1;0;4
92;Aitvaras;"SAULĖS ZUIKUČIAI  (ALERG.)";9534206000;Ne;19;0;0;19
93;Aitvaras;"SAULĖS ZUIKUČIAI  (ALERG.)";3737054758;Ne;4;4;0;8
94;Aitvaras;"SAULĖS ZUIKUČIAI  (ALERG.)";4646876966;Ne;0;4;0;4
95;Aitvaras;"SAULĖS ZUIKUČIAI  (ALERG.)";9271534775;Ne;11;0;1;12
96;Aitvaras;"SAULĖS ZUIKUČIAI  (ALERG.)";8849563638;Ne;0;4;0;4
97;Aitvaras;"SAULĖS ZUIKUČIAI  (ALERG.)";6950820937;Ne;0;0;3;3
98;Aitvaras;"SAULĖS ZUIKUČIAI  (ALERG.)";5283056036;Ne;0;1;0;1
99;Aitvaras;"SAULĖS ZUIKUČIAI  (ALERG.)";5252728205;Ne;12;0;2;14
100;Aitvaras;"SAULĖS ZUIKUČIAI  (ALERG.)";2744696131;Ne;0;4;0;4
101;Aitvaras;"SAULĖS ZUIKUČIAI  (ALERG.)";2373509019;Ne;3;4;0;7
102;Aitvaras;"SAULĖS ZUIKUČIAI  (ALERG.)";2624566766;Ne;10;0;5;15
103;Aitvaras;"SAULĖS ZUIKUČIAI  (ALERG.)";3677551059;Ne;0;2;0;2
104;Aitvaras;"SAULĖS ZUIKUČIAI  (ALERG.)";2547934790;Ne;0;4;2;6
105;Aitvaras;"ŽEMYNUKAI (ALERG.)";8567255042;Ne;0;1;2;3
106;Aitvaras;"ŽEMYNUKAI (ALERG.)";6218019092;Ne;0;2;3;5
107;Aitvaras;"ŽEMYNUKAI (ALERG.)";3820930777;Ne;10;12;0;22
108;Aitvaras;"ŽEMYNUKAI (ALERG.)";6624986090;Ne;1;0;7;8
109;Aitvaras;"ŽEMYNUKAI (ALERG.)";4733627644;Ne;0;8;5;13
110;Aitvaras;"ŽEMYNUKAI (ALERG.)";3104109370;Ne;0;2;5;7
111;Aitvaras;"ŽEMYNUKAI (ALERG.)";7853714142;Ne;12;4;0;16
112;Aitvaras;"ŽEMYNUKAI (ALERG.)";1949144346;Ne;0;6;0;6
113;Aitvaras;"ŽEMYNUKAI (ALERG.)";3961423273;Ne;0;6;0;6
114;Aitvaras;"ŽEMYNUKAI (ALERG.)";9947610763;Ne;0;5;0;5
115;Aitvaras;"ŽEMYNUKAI (ALERG.)";7113016866;Ne;0;14;0;14
116;Aitvaras;"ŽEMYNUKAI (ALERG.)";4377666052;Ne;0;10;4;14
117;Aitvaras;"ŽEMYNUKAI (ALERG.)";8333823078;Ne;0;7;0;7
118;Aitvaras;"ŽEMYNUKAI (ALERG.)";5623106419;Ne;0;2;0;2
119;Aitvaras;"ŽEMYNUKAI (ALERG.)";5351333397;Ne;0;6;0;6
120;Aitvaras;"ŽEMYNUKAI (ALERG.)";2065988478;Ne;0;0;6;6
121;Aitvaras;"ŽEMYNUKAI (ALERG.)";3635354769;Ne;0;24;0;24
122;Aitvaras;"ŽEMYNUKAI (ALERG.)";3851322849;Ne;0;4;2;6
123;Aitvaras;"ŽEMYNUKAI (ALERG.)";7889947603;Ne;8;0;1;9
124;Aitvaras;"ŽEMYNUKAI (ALERG.)";1662289664;Ne;0;4;2;6
125;Aitvaras;"ŽEMYNUKAI (ALERG.)";6286268740;Ne;0;3;0;3
126;Aitvaras;"LINKSMUČIAI (ALERG.)";9356533125;Ne;0;5;0;5
127;Aitvaras;"LINKSMUČIAI (ALERG.)";4721229601;Ne;9;0;0;9
128;Aitvaras;"LINKSMUČIAI (ALERG.)";7598319477;Ne;3;0;0;3
129;Aitvaras;"LINKSMUČIAI (ALERG.)";2231465856;Ne;0;7;0;7
130;Aitvaras;"LINKSMUČIAI (ALERG.)";5697675670;Ne;2;2;0;4
131;Aitvaras;"LINKSMUČIAI (ALERG.)";4394700961;Ne;16;0;0;16
132;Aitvaras;"LINKSMUČIAI (ALERG.)";8161320750;Ne;6;0;0;6
133;Aitvaras;"LINKSMUČIAI (ALERG.)";9006105693;Ne;3;0;0;3
134;Aitvaras;"LINKSMUČIAI (ALERG.)";7886218360;Ne;21;0;0;21
135;Aitvaras;"LINKSMUČIAI (ALERG.)";4897595828;Ne;17;0;0;17
136;Aitvaras;"LINKSMUČIAI (ALERG.)";2209078997;Ne;6;6;0;12
137;Aitvaras;"LINKSMUČIAI (ALERG.)";7463592589;Ne;10;1;0;11
138;Aitvaras;"LINKSMUČIAI (ALERG.)";5308153768;Ne;11;0;0;11
139;Aitvaras;"LINKSMUČIAI (ALERG.)";4954780185;Ne;14;0;0;14
140;Aitvaras;"LINKSMUČIAI (ALERG.)";9294248422;Ne;6;0;0;6
141;Aitvaras;"LINKSMUČIAI (ALERG.)";2263139249;Ne;0;7;0;7
142;Aitvaras;NAMINUKAI;3053557807;Ne;0;2;2;4
143;Aitvaras;NAMINUKAI;6126913961;Ne;4;0;0;4
144;Aitvaras;NAMINUKAI;3347213578;Ne;0;5;2;7
145;Aitvaras;NAMINUKAI;9024245490;Taip;3;4;0;7
146;Aitvaras;NAMINUKAI;8512502118;Ne;0;6;0;6
147;Aitvaras;NAMINUKAI;1376605323;Ne;0;2;0;2
148;Aitvaras;NAMINUKAI;6060880045;Ne;0;2;0;2
149;Aitvaras;NAMINUKAI;6048701733;Ne;0;7;0;7
150;Aitvaras;NAMINUKAI;4555281655;Ne;0;1;0;1
151;Aitvaras;NAMINUKAI;8043062737;Ne;0;12;0;12
152;Aitvaras;NAMINUKAI;3005447572;Ne;0;4;0;4
153;Aitvaras;NAMINUKAI;1549552392;Ne;0;9;0;9
154;Aitvaras;NAMINUKAI;4498792867;Ne;0;5;0;5
155;Aitvaras;NAMINUKAI;9490714865;Ne;6;3;0;9
156;Aitvaras;NAMINUKAI;1498630458;Ne;0;1;1;2
157;Aitvaras;NAMINUKAI;5967188507;Ne;0;2;0;2
158;Aitvaras;NAMINUKAI;5161069611;Ne;0;1;5;6
159;Aitvaras;NAMINUKAI;7934344218;Ne;0;1;0;1
160;Aitvaras;NAMINUKAI;6279152796;Ne;0;5;0;5
161;Aitvaras;ŠELMIAI;4984058405;Ne;0;4;0;4
162;Aitvaras;ŠELMIAI;9725401255;Ne;2;0;2;4
163;Aitvaras;ŠELMIAI;4547342872;Ne;2;6;0;8
164;Aitvaras;ŠELMIAI;5684526288;Ne;0;2;0;2
165;Aitvaras;ŠELMIAI;7764574135;Ne;0;1;0;1
166;Aitvaras;ŠELMIAI;5601517340;Ne;0;7;0;7
167;Aitvaras;ŠELMIAI;1019103539;Ne;0;8;0;8
168;Aitvaras;ŠELMIAI;2185746898;Ne;0;3;0;3
169;Aitvaras;ŠELMIAI;8756012613;Ne;0;0;3;3
170;Aitvaras;ŠELMIAI;1203732956;Ne;4;4;0;8
171;Aitvaras;ŠELMIAI;5782609781;Ne;8;0;0;8
172;Aitvaras;ŠELMIAI;7805819121;Ne;0;2;0;2
173;Aitvaras;ŠELMIAI;4158520145;Ne;0;4;0;4
174;Aitvaras;ŠELMIAI;7352233454;Ne;3;4;1;8
175;Aitvaras;ŠELMIAI;4812423010;Ne;7;2;0;9
176;Aitvaras;ŠELMIAI;8644983502;Ne;0;4;0;4
177;Aitvaras;ŠELMIAI;9295561516;Ne;1;0;0;1
178;Aitvaras;ŠELMIAI;6188186413;Ne;0;6;0;6
179;Aitvaras;ŠELMIAI;5886199823;Ne;0;0;1;1
180;Aitvaras;KODĖLČIUKAI;1495399113;Ne;0;1;0;1
181;Aitvaras;KODĖLČIUKAI;4613021421;Ne;3;4;0;7
182;Aitvaras;KODĖLČIUKAI;2887681961;Ne;0;6;0;6
183;Aitvaras;KODĖLČIUKAI;4760801928;Ne;9;0;4;13
184;Aitvaras;KODĖLČIUKAI;7136674662;Ne;0;3;0;3
185;Aitvaras;KODĖLČIUKAI;7922937851;Ne;0;1;0;1
186;Aitvaras;KODĖLČIUKAI;4085134058;Ne;3;1;0;4
187;Aitvaras;KODĖLČIUKAI;4163871634;Ne;4;2;0;6
188;Aitvaras;KODĖLČIUKAI;3988226974;Ne;4;2;0;6
189;Aitvaras;KODĖLČIUKAI;1070324386;Ne;3;2;0;5
190;Aitvaras;KODĖLČIUKAI;1599296739;Taip;0;12;7;19
191;Aitvaras;KODĖLČIUKAI;4987412561;Ne;3;0;0;3
192;Aitvaras;KODĖLČIUKAI;2239387580;Ne;0;2;0;2
193;Aitvaras;KODĖLČIUKAI;9949206639;Ne;0;0;5;5
194;Aitvaras;KODĖLČIUKAI;2892898328;Taip;5;8;0;13
195;Aitvaras;KODĖLČIUKAI;3749008647;Ne;8;0;3;11
196;Aitvaras;KODĖLČIUKAI;2871973045;Ne;2;2;2;6
197;Aitvaras;KODĖLČIUKAI;9218287162;Ne;4;0;0;4
198;Aitvaras;KODĖLČIUKAI;7181317805;Ne;0;1;1;2
199;Aitvaras;KODĖLČIUKAI;5093291829;Ne;0;0;10;10
200;Aitvaras;KODĖLČIUKAI;6119148164;Ne;4;1;1;6
201;Aitvaras;PABIRUČIAI;5563725441;Ne;4;0;0;4
202;Aitvaras;PABIRUČIAI;1961795617;Ne;10;0;7;17
203;Aitvaras;PABIRUČIAI;9081528512;Ne;13;0;0;13
204;Aitvaras;PABIRUČIAI;9494510876;Ne;0;2;1;3
205;Aitvaras;PABIRUČIAI;4816698202;Ne;7;3;0;10
206;Aitvaras;PABIRUČIAI;2817620246;Ne;0;3;3;6
207;Aitvaras;PABIRUČIAI;6906900852;Ne;0;4;0;4
208;Aitvaras;PABIRUČIAI;4560348711;Ne;9;3;0;12
209;Aitvaras;PABIRUČIAI;4251238917;Ne;9;0;2;11
210;Aitvaras;PABIRUČIAI;8003130815;Ne;19;0;0;19
211;Aitvaras;PABIRUČIAI;2045368104;Ne;3;1;0;4
212;Aitvaras;PABIRUČIAI;6660146833;Ne;8;3;0;11
213;Aitvaras;PABIRUČIAI;1020056632;Ne;1;0;1;2
214;Aitvaras;PABIRUČIAI;9993426833;Ne;16;0;0;16
215;Aitvaras;PABIRUČIAI;2747113542;Ne;2;11;0;13
216;Aitvaras;"SVAJOKLIAI  (ALERG.)";3429046261;Ne;0;1;0;1
217;Aitvaras;"SVAJOKLIAI  (ALERG.)";5659897032;Ne;9;4;0;13
218;Aitvaras;"SVAJOKLIAI  (ALERG.)";4618560397;Ne;5;5;0;10
219;Aitvaras;"SVAJOKLIAI  (ALERG.)";7745736525;Ne;0;1;0;1
220;Aitvaras;"SVAJOKLIAI  (ALERG.)";9209862610;Ne;4;3;0;7
221;Aitvaras;"SVAJOKLIAI  (ALERG.)";6191938291;Ne;3;2;0;5
222;Aitvaras;"SVAJOKLIAI  (ALERG.)";7006713502;Ne;0;2;0;2
223;Aitvaras;"SVAJOKLIAI  (ALERG.)";3923601422;Ne;0;1;0;1
224;Aitvaras;"SVAJOKLIAI  (ALERG.)";5790551266;Ne;6;3;0;9
225;Aitvaras;"SVAJOKLIAI  (ALERG.)";2975696317;Ne;2;0;0;2
226;Aitvaras;"SVAJOKLIAI  (ALERG.)";3891067128;Ne;4;0;2;6
227;Aitvaras;"SVAJOKLIAI  (ALERG.)";8352951885;Ne;4;1;2;7
228;Aitvaras;"SVAJOKLIAI  (ALERG.)";5255843693;Ne;2;0;0;2
229;Aitvaras;"SVAJOKLIAI  (ALERG.)";1448307414;Ne;4;5;0;9
230;Aitvaras;"SVAJOKLIAI  (ALERG.)";5593105541;Ne;4;1;0;5
231;Aitvaras;"SVAJOKLIAI  (ALERG.)";8963214183;Ne;0;3;0;3
232;Aitvaras;"SVAJOKLIAI  (ALERG.)";6319953077;Ne;0;1;0;1
233;Aitvaras;"SVAJOKLIAI  (ALERG.)";1131690624;Ne;0;4;0;4
234;Aitvaras;"SVAJOKLIAI  (ALERG.)";4801034095;Ne;0;3;0;3
235;Aitvaras;"SVAJOKLIAI  (ALERG.)";6916032116;Ne;0;2;0;2
236;Aitvaras;"SVAJOKLIAI  (ALERG.)";8300788433;Ne;12;2;0;14
237;Aitvaras;"SVAJOKLIAI  (ALERG.)";3026234787;Ne;8;0;1;9
238;Aitvaras;"SVAJOKLIAI  (ALERG.)";9810208704;Ne;4;4;0;8
239;Atžalėlės;Gėlytės;4284673729;Ne;7;10;0;17
240;Atžalėlės;Gėlytės;2385614957;Ne;0;4;2;6
241;Atžalėlės;Gėlytės;5432433423;Ne;0;6;0;6
242;Atžalėlės;Gėlytės;9715625283;Ne;3;4;0;7
243;Atžalėlės;Gėlytės;4682216852;Ne;0;3;0;3
244;Atžalėlės;Gėlytės;2131592139;Ne;0;4;0;4
245;Atžalėlės;Gėlytės;3191066669;Ne;15;4;0;19
246;Atžalėlės;Gėlytės;1722233272;Ne;0;10;0;10
247;Atžalėlės;Gėlytės;5310990513;Ne;0;4;0;4
248;Atžalėlės;Gėlytės;9189223222;Ne;0;6;0;6
249;Atžalėlės;Gėlytės;3283415814;Ne;0;7;0;7
250;Atžalėlės;Gėlytės;1146492807;Ne;0;4;1;5
251;Atžalėlės;Gėlytės;3870758086;Ne;5;4;0;9
252;Atžalėlės;Gėlytės;6202250600;Ne;0;2;1;3
253;Atžalėlės;Gėlytės;4098210138;Ne;0;3;0;3
254;Atžalėlės;Gėlytės;6177038838;Ne;0;5;0;5
255;Atžalėlės;Gėlytės;5742471497;Ne;0;9;0;9
256;Atžalėlės;Gėlytės;1137741059;Ne;2;2;0;4
257;Atžalėlės;Gėlytės;4238773173;Ne;0;4;0;4
258;Atžalėlės;Gėlytės;1036410428;Ne;0;1;0;1
259;Atžalėlės;Gėlytės;1450609695;Ne;0;1;0;1
260;Atžalėlės;Gėlytės;6597540627;Ne;0;4;0;4
261;Atžalėlės;Drugeliai;9481268935;Ne;12;0;1;13
262;Atžalėlės;Drugeliai;3738127350;Ne;5;4;0;9
263;Atžalėlės;Drugeliai;6108989129;Ne;2;3;0;5
264;Atžalėlės;Drugeliai;1423254771;Ne;4;4;1;9
265;Atžalėlės;Drugeliai;1505286928;Ne;0;7;0;7
266;Atžalėlės;Drugeliai;7483616061;Ne;0;13;0;13
267;Atžalėlės;Drugeliai;4227804985;Ne;1;4;0;5
268;Atžalėlės;Drugeliai;9053620501;Ne;6;0;0;6
269;Atžalėlės;Drugeliai;5174826594;Ne;2;0;0;2
270;Atžalėlės;Drugeliai;4148412941;Ne;0;13;0;13
271;Atžalėlės;Drugeliai;9054589111;Ne;0;4;1;5
272;Atžalėlės;Drugeliai;7501772398;Ne;0;4;0;4
273;Atžalėlės;Drugeliai;9346744866;Taip;5;5;0;10
274;Atžalėlės;Drugeliai;1710646812;Ne;6;4;0;10
275;Atžalėlės;Drugeliai;6447615639;Ne;3;3;0;6
276;Atžalėlės;Drugeliai;5972419628;Ne;0;14;0;14
277;Atžalėlės;Gandriukai;2083260403;Ne;8;5;0;13
278;Atžalėlės;Gandriukai;3692090073;Ne;4;0;0;4
279;Atžalėlės;Gandriukai;5119260525;Ne;9;0;0;9
280;Atžalėlės;Gandriukai;1024559742;Ne;2;0;0;2
281;Atžalėlės;Gandriukai;4293557144;Ne;0;12;0;12
282;Atžalėlės;Gandriukai;9201449702;Ne;5;0;0;5
283;Atžalėlės;Gandriukai;1305611902;Ne;4;0;0;4
284;Atžalėlės;Voveriukai;3795729265;Ne;6;4;0;10
285;Atžalėlės;Voveriukai;8201582382;Ne;2;4;0;6
286;Atžalėlės;Voveriukai;4362058013;Ne;2;4;0;6
287;Atžalėlės;Voveriukai;8819893830;Ne;0;4;1;5
288;Atžalėlės;Voveriukai;3069192413;Ne;6;0;2;8
289;Atžalėlės;Voveriukai;5705303891;Ne;3;5;0;8
290;Atžalėlės;Voveriukai;2374624441;Ne;0;10;0;10
291;Atžalėlės;Voveriukai;1212074068;Ne;5;4;0;9
292;Atžalėlės;Voveriukai;9967641617;Ne;4;5;0;9
293;Atžalėlės;Voveriukai;6723689098;Ne;3;4;0;7
294;Atžalėlės;Voveriukai;4661388894;Ne;9;5;0;14
295;Atžalėlės;Voveriukai;9677943321;Ne;1;3;0;4
296;Atžalėlės;Voveriukai;1538643591;Ne;11;1;0;12
297;Atžalėlės;Voveriukai;5319794176;Ne;0;0;1;1
298;Atžalėlės;Voveriukai;9085453655;Ne;9;0;0;9
299;Atžalėlės;Voveriukai;7196464328;Ne;10;0;1;11
300;Atžalėlės;Voveriukai;7018297883;Ne;3;4;2;9
301;Atžalėlės;Voveriukai;9508110719;Ne;0;3;0;3
302;Atžalėlės;Voveriukai;5584105084;Ne;2;0;1;3
303;Atžalėlės;Voveriukai;7522643082;Ne;6;3;0;9
304;Atžalėlės;Voveriukai;7613931447;Ne;2;3;0;5
305;Atžalėlės;Voveriukai;7510951079;Ne;7;5;0;12
306;Atžalėlės;Voveriukai;8547622670;Ne;10;4;1;15
307;Atžalėlės;Voveriukai;3143856911;Taip;0;13;0;13
308;Atžalėlės;Paukšteliai;7807313362;Ne;0;4;0;4
309;Atžalėlės;Paukšteliai;6537864486;Ne;6;4;1;11
310;Atžalėlės;Paukšteliai;8524244526;Taip;8;5;0;13
311;Atžalėlės;Paukšteliai;6873507667;Ne;4;3;0;7
312;Atžalėlės;Paukšteliai;7321516783;Ne;0;0;6;6
313;Atžalėlės;Paukšteliai;6265777690;Ne;0;5;0;5
314;Atžalėlės;Paukšteliai;1844980319;Ne;0;2;2;4
315;Atžalėlės;Paukšteliai;5997958773;Ne;0;2;2;4
316;Atžalėlės;Paukšteliai;8512283024;Ne;0;8;0;8
317;Atžalėlės;Paukšteliai;2078781673;Ne;0;2;2;4
318;Atžalėlės;Paukšteliai;1520206753;Ne;17;0;0;17
319;Atžalėlės;Paukšteliai;4790322154;Ne;12;4;0;16
320;Atžalėlės;Paukšteliai;4081717007;Ne;2;0;1;3
321;Atžalėlės;Paukšteliai;1089221288;Ne;2;0;6;8
322;Atžalėlės;Paukšteliai;7356877676;Ne;0;1;0;1
323;Atžalėlės;Paukšteliai;4392352210;Ne;5;0;1;6
324;Atžalėlės;Paukšteliai;1774212280;Ne;15;4;0;19
325;Atžalėlės;Meškiukai;8586739429;Ne;0;0;2;2
326;Atžalėlės;Meškiukai;9925178685;Ne;5;4;0;9
327;Atžalėlės;Meškiukai;2617568019;Ne;5;1;4;10
328;Atžalėlės;Meškiukai;4233689945;Ne;3;2;0;5
329;Atžalėlės;Meškiukai;8619613890;Ne;2;6;0;8
330;Atžalėlės;Meškiukai;3281114596;Ne;0;11;0;11
331;Atžalėlės;Meškiukai;5466374223;Ne;1;0;7;8
332;Atžalėlės;Meškiukai;2433029299;Ne;0;0;5;5
333;Atžalėlės;Meškiukai;9631336340;Ne;1;1;0;2
334;Atžalėlės;Meškiukai;2930612059;Ne;9;1;0;10
335;Atžalėlės;Meškiukai;6385777303;Ne;0;4;0;4
336;Atžalėlės;Meškiukai;2569491645;Ne;0;4;0;4
337;Atžalėlės;Meškiukai;1431197358;Ne;0;7;0;7
338;Atžalėlės;Meškiukai;4177753994;Ne;0;1;9;10
339;Atžalėlės;Meškiukai;3982090601;Ne;2;3;0;5
340;Atžalėlės;Meškiukai;3743308789;Ne;8;2;0;10
341;Atžalėlės;Meškiukai;7936991925;Ne;6;1;0;7
342;Atžalėlės;Meškiukai;8976815736;Ne;0;5;2;7
343;Atžalėlės;Saulutės;8460997063;Ne;0;4;2;6
344;Atžalėlės;Saulutės;6048763811;Taip;10;4;1;15
345;Atžalėlės;Saulutės;8313999012;Ne;2;9;0;11
346;Atžalėlės;Saulutės;2291204010;Ne;3;2;1;6
347;Atžalėlės;Saulutės;2306086573;Ne;14;0;0;14
348;Atžalėlės;Saulutės;8208908249;Ne;0;8;2;10
349;Atžalėlės;Bitutės;8060332402;Ne;5;0;2;7
350;Atžalėlės;Bitutės;8396693160;Ne;0;4;0;4
351;Atžalėlės;Bitutės;8129858229;Ne;0;0;2;2
352;Atžalėlės;Bitutės;6253257539;Ne;0;0;3;3
353;Atžalėlės;Bitutės;6211002805;Ne;0;0;9;9
354;Atžalėlės;Bitutės;1939076303;Ne;3;4;0;7
355;Atžalėlės;Bitutės;7052938312;Ne;0;5;0;5
356;Atžalėlės;Bitutės;8707875125;Ne;11;0;0;11
357;Atžalėlės;Bitutės;3559977339;Ne;5;0;2;7
358;Atžalėlės;Bitutės;2322329918;Ne;0;0;7;7
359;Atžalėlės;Bitutės;6368553568;Ne;0;5;1;6
360;Atžalėlės;Bitutės;5148142239;Ne;5;0;5;10
361;Atžalėlės;Bitutės;5593774275;Ne;13;0;3;16
362;Atžalėlės;Bitutės;5511148178;Ne;19;0;0;19
363;Atžalėlės;Bitutės;6594440062;Ne;12;0;0;12
364;Atžalėlės;Boružiukai;7104671423;Ne;0;9;1;10
365;Atžalėlės;Boružiukai;3119998745;Ne;19;0;0;19
366;Atžalėlės;Boružiukai;3198845538;Ne;0;3;0;3
367;Atžalėlės;Boružiukai;3998483465;Ne;14;0;0;14
368;Atžalėlės;Boružiukai;5582697993;Ne;0;2;0;2
369;Atžalėlės;Boružiukai;8681809797;Ne;0;0;4;4
370;Atžalėlės;Boružiukai;3590987364;Ne;0;0;3;3
371;Atžalėlės;Boružiukai;6237597328;Ne;5;6;0;11
372;Atžalėlės;Boružiukai;1383944713;Ne;2;2;0;4
373;Atžalėlės;Boružiukai;7091939299;Ne;11;0;1;12
374;Atžalėlės;Šypsenėlės;9736390705;Ne;4;3;0;7
375;Atžalėlės;Šypsenėlės;4071402757;Ne;5;1;0;6
376;Atžalėlės;Šypsenėlės;2032772143;Ne;0;0;12;12
377;Atžalėlės;Šypsenėlės;9487375092;Ne;0;5;0;5
378;Atžalėlės;Šypsenėlės;1943349835;Ne;0;0;3;3
379;Atžalėlės;Šypsenėlės;6828140775;Ne;7;0;2;9
380;Atžalėlės;Šypsenėlės;8564143904;Ne;18;0;1;19
381;Atžalėlės;Šypsenėlės;3299724612;Ne;9;0;0;9
382;Atžalėlės;Šypsenėlės;2271887521;Taip;5;4;3;12
383;Atžalėlės;Šypsenėlės;9707462467;Ne;0;2;3;5
384;Atžalėlės;Šypsenėlės;2298114905;Ne;0;3;0;3
385;Atžalėlės;Šypsenėlės;3346193393;Ne;12;0;3;15
386;Atžalėlės;Šypsenėlės;5822532151;Ne;15;2;0;17
387;Aušrelė;PASAKIUKAI;1754138341;Ne;13;4;0;17
388;Aušrelė;PASAKIUKAI;6913824678;Ne;8;5;0;13
389;Aušrelė;PASAKIUKAI;8542012622;Ne;3;2;1;6
390;Aušrelė;PASAKIUKAI;6463141345;Ne;0;4;5;9
391;Aušrelė;PASAKIUKAI;3713528812;Ne;0;4;6;10
392;Aušrelė;PASAKIUKAI;2221714044;Ne;8;4;1;13
393;Aušrelė;PASAKIUKAI;1949809977;Ne;6;2;0;8
394;Aušrelė;PASAKIUKAI;8126701466;Ne;0;4;1;5
395;Aušrelė;PASAKIUKAI;9733877752;Ne;0;3;5;8
396;Aušrelė;PASAKIUKAI;4591518039;Ne;4;4;1;9
397;Aušrelė;PASAKIUKAI;1798478023;Ne;0;3;1;4
398;Aušrelė;PASAKIUKAI;8573348956;Ne;5;4;1;10
399;Aušrelė;PASAKIUKAI;1607338052;Ne;4;2;0;6
400;Aušrelė;PASAKIUKAI;1544869163;Ne;2;4;2;8
401;Aušrelė;PASAKIUKAI;6577540623;Ne;15;4;0;19
402;Aušrelė;PASAKIUKAI;5460833944;Ne;15;4;0;19
403;Aušrelė;PASAKIUKAI;6372004855;Ne;5;4;0;9
404;Aušrelė;PASAKIUKAI;2311552230;Ne;13;4;0;17
405;Aušrelė;PASAKIUKAI;7130040621;Ne;0;4;0;4
406;Aušrelė;PASAKIUKAI;7208341200;Ne;0;3;0;3
407;Aušrelė;BORUŽĖLĖS;5733298006;Ne;0;7;0;7
408;Aušrelė;BORUŽĖLĖS;7406063630;Ne;4;0;0;4
409;Aušrelė;BORUŽĖLĖS;4565813136;Ne;0;17;0;17
410;Aušrelė;BORUŽĖLĖS;9877307844;Ne;13;0;0;13
411;Aušrelė;BORUŽĖLĖS;2873845920;Ne;0;2;0;2
412;Aušrelė;BORUŽĖLĖS;1458580523;Ne;10;2;2;14
413;Aušrelė;BORUŽĖLĖS;1463724119;Ne;0;2;2;4
414;Aušrelė;BORUŽĖLĖS;5904797250;Ne;11;0;0;11
415;Aušrelė;BORUŽĖLĖS;1871799626;Ne;0;0;13;13
416;Aušrelė;BORUŽĖLĖS;4924950592;Ne;9;0;0;9
417;Aušrelė;BORUŽĖLĖS;8947695521;Ne;0;0;4;4
418;Aušrelė;BORUŽĖLĖS;6672975558;Ne;0;0;12;12
419;Aušrelė;BORUŽĖLĖS;8799928392;Ne;10;0;6;16
420;Aušrelė;BORUŽĖLĖS;5801943729;Ne;0;9;0;9
421;Aušrelė;BORUŽĖLĖS;5866673884;Ne;0;2;2;4
422;Aušrelė;BORUŽĖLĖS;6418762623;Ne;0;0;5;5
423;Aušrelė;BORUŽĖLĖS;8835689988;Ne;0;4;0;4
424;Aušrelė;BORUŽĖLĖS;8689174023;Ne;0;5;0;5
425;Aušrelė;BORUŽĖLĖS;7966060521;Ne;0;3;0;3
426;Aušrelė;BORUŽĖLĖS;5358736178;Ne;8;2;4;14
427;Aušrelė;SMALSUČIAI;6761263775;Ne;3;6;0;9
428;Aušrelė;SMALSUČIAI;3015028879;Ne;0;4;0;4
429;Aušrelė;SMALSUČIAI;5935579452;Ne;4;4;0;8
430;Aušrelė;SMALSUČIAI;2863655361;Ne;4;4;0;8
431;Aušrelė;SMALSUČIAI;2390128933;Ne;2;4;0;6
432;Aušrelė;SMALSUČIAI;8503309819;Ne;14;0;0;14
433;Aušrelė;SMALSUČIAI;2827216981;Ne;6;5;0;11
434;Aušrelė;SMALSUČIAI;9443641849;Ne;0;4;2;6
435;Aušrelė;SMALSUČIAI;7930717076;Ne;0;6;0;6
436;Aušrelė;SMALSUČIAI;7609339123;Ne;0;4;0;4
437;Aušrelė;SMALSUČIAI;1556010005;Ne;0;4;0;4
438;Aušrelė;SMALSUČIAI;5478028396;Ne;6;4;0;10
439;Aušrelė;SMALSUČIAI;7070013052;Ne;3;4;2;9
440;Aušrelė;SMALSUČIAI;3581155949;Ne;0;4;0;4
441;Aušrelė;SMALSUČIAI;6507218940;Ne;0;5;0;5
442;Aušrelė;SMALSUČIAI;2266390402;Ne;0;5;0;5
443;Aušrelė;SMALSUČIAI;8032661062;Ne;0;3;4;7
444;Aušrelė;SMALSUČIAI;4262596104;Ne;0;4;0;4
445;Aušrelė;SMALSUČIAI;1976613166;Ne;0;4;0;4
446;Aušrelė;KODĖLČIUKAI;7723159748;Ne;14;2;0;16
447;Aušrelė;KODĖLČIUKAI;7367268748;Ne;0;3;0;3
448;Aušrelė;KODĖLČIUKAI;5712867880;Ne;2;3;0;5
449;Aušrelė;KODĖLČIUKAI;3623813061;Ne;0;6;0;6
450;Aušrelė;KODĖLČIUKAI;4288695809;Ne;0;6;0;6
451;Aušrelė;KODĖLČIUKAI;8693750994;Ne;7;4;0;11
452;Aušrelė;KODĖLČIUKAI;7327544406;Ne;0;4;0;4
453;Aušrelė;KODĖLČIUKAI;9566144610;Ne;0;3;0;3
454;Aušrelė;KODĖLČIUKAI;6308519574;Ne;0;5;0;5
455;Aušrelė;KODĖLČIUKAI;6186758486;Ne;0;4;2;6
456;Aušrelė;KODĖLČIUKAI;3320399046;Ne;3;4;0;7
457;Aušrelė;KODĖLČIUKAI;6911735462;Ne;19;0;0;19
458;Aušrelė;KODĖLČIUKAI;4248808572;Ne;13;0;0;13
459;Aušrelė;KODĖLČIUKAI;5046027475;Ne;0;5;0;5
460;Aušrelė;KODĖLČIUKAI;8338569001;Ne;10;4;0;14
461;Aušrelė;KODĖLČIUKAI;2766357229;Ne;0;3;1;4
462;Aušrelė;KODĖLČIUKAI;7515666888;Ne;0;3;0;3
463;Aušrelė;KODĖLČIUKAI;8862488358;Ne;13;0;0;13
464;Aušrelė;KODĖLČIUKAI;4882556718;Ne;4;5;2;11
465;Aušrelė;KODĖLČIUKAI;6321332888;Ne;0;6;0;6
466;Aušrelė;KODĖLČIUKAI;8341539501;Ne;0;4;0;4
467;Aušrelė;PELĖDŽIUKAI;4725588671;Ne;0;4;0;4
468;Aušrelė;PELĖDŽIUKAI;3223092149;Ne;0;11;0;11
469;Aušrelė;PELĖDŽIUKAI;8580241126;Ne;0;3;10;13
470;Aušrelė;PELĖDŽIUKAI;4227228548;Ne;5;3;0;8
471;Aušrelė;PELĖDŽIUKAI;8996445434;Ne;5;3;0;8
472;Aušrelė;PELĖDŽIUKAI;8411336992;Ne;2;4;0;6
473;Aušrelė;PELĖDŽIUKAI;8917907028;Ne;5;4;0;9
474;Aušrelė;PELĖDŽIUKAI;7494298336;Ne;0;14;0;14
475;Aušrelė;PELĖDŽIUKAI;4012186237;Ne;0;2;0;2
476;Aušrelė;PELĖDŽIUKAI;3738923947;Ne;0;1;0;1
477;Aušrelė;PELĖDŽIUKAI;1642358593;Ne;0;4;5;9
478;Aušrelė;PELĖDŽIUKAI;2294224426;Ne;8;5;0;13
479;Aušrelė;PELĖDŽIUKAI;1276792874;Ne;0;3;2;5
480;Aušrelė;PELĖDŽIUKAI;8210698019;Ne;4;4;0;8
481;Aušrelė;PELĖDŽIUKAI;9004934832;Ne;1;2;0;3
482;Aušrelė;AITVARIUKAI;6833654667;Ne;4;3;0;7
483;Aušrelė;AITVARIUKAI;8102749675;Ne;0;4;0;4
484;Aušrelė;AITVARIUKAI;4595435635;Ne;0;5;0;5
485;Aušrelė;AITVARIUKAI;9608444990;Ne;1;5;0;6
486;Aušrelė;AITVARIUKAI;6434548772;Ne;7;4;0;11
487;Aušrelė;AITVARIUKAI;7978186455;Ne;0;8;0;8
488;Aušrelė;AITVARIUKAI;5602774323;Ne;0;5;0;5
489;Aušrelė;AITVARIUKAI;5708459561;Ne;1;2;0;3
490;Aušrelė;AITVARIUKAI;1039180129;Ne;2;10;0;12
491;Aušrelė;AITVARIUKAI;5125295651;Ne;0;4;0;4
492;Aušrelė;AITVARIUKAI;3807967685;Ne;2;2;0;4
493;Aušrelė;AITVARIUKAI;6081100604;Ne;5;3;0;8
494;Aušrelė;AITVARIUKAI;7847650967;Ne;0;4;0;4
495;Aušrelė;AITVARIUKAI;5727081833;Ne;0;2;0;2
496;Aušrelė;AITVARIUKAI;4942168388;Ne;8;5;0;13
497;Aušrelė;AITVARIUKAI;7788139791;Ne;0;5;0;5
498;Aušrelė;BITUTĖS;1741716341;Ne;2;12;0;14
499;Aušrelė;BITUTĖS;4989544273;Ne;0;6;0;6
500;Aušrelė;BITUTĖS;9960201865;Ne;0;4;0;4
501;Aušrelė;BITUTĖS;2071674661;Ne;0;13;0;13
502;Aušrelė;BITUTĖS;1450827353;Ne;0;4;0;4
503;Aušrelė;BITUTĖS;5598494461;Ne;0;4;0;4
504;Aušrelė;BITUTĖS;4935192851;Ne;2;0;0;2
505;Aušrelė;BITUTĖS;1931955562;Ne;0;6;0;6
506;Aušrelė;BITUTĖS;5614774250;Ne;0;2;0;2
507;Aušrelė;BITUTĖS;6591538425;Ne;0;13;0;13
508;Aušrelė;BITUTĖS;8203256528;Ne;0;19;0;19
509;Aušrelė;BITUTĖS;5741252819;Ne;0;19;0;19
510;Aušrelė;BITUTĖS;1243825974;Ne;0;9;0;9
511;Aušrelė;BITUTĖS;2468245186;Ne;0;7;0;7
512;Aušrelė;BITUTĖS;5266959731;Ne;6;5;0;11
513;Aušrelė;BITUTĖS;2545065554;Ne;0;7;0;7
514;Aušrelė;BITUTĖS;2543313198;Ne;0;10;0;10
515;Aušrelė;BITUTĖS;3288449407;Ne;0;15;0;15
516;Aušrelė;ŽIRNIUKAI;8833081700;Ne;0;5;0;5
517;Aušrelė;ŽIRNIUKAI;7028068342;Ne;0;2;0;2
518;Aušrelė;ŽIRNIUKAI;9274178180;Ne;9;2;0;11
519;Aušrelė;ŽIRNIUKAI;2553689977;Ne;0;4;0;4
520;Aušrelė;ŽIRNIUKAI;9859520649;Ne;10;1;0;11
521;Aušrelė;ŽIRNIUKAI;1915023166;Ne;0;2;0;2
522;Aušrelė;ŽIRNIUKAI;2543352192;Ne;9;3;0;12
523;Aušrelė;ŽIRNIUKAI;1528883001;Ne;15;4;0;19
524;Aušrelė;ŽIRNIUKAI;3023414781;Ne;3;2;0;5
525;Aušrelė;ŽIRNIUKAI;2582979005;Taip;2;5;0;7
526;Aušrelė;ŽIRNIUKAI;9884818480;Ne;2;4;0;6
527;Aušrelė;ŽIRNIUKAI;5429867368;Ne;2;0;0;2
528;Aušrelė;ŽIRNIUKAI;4004600465;Ne;0;6;0;6
529;Aušrelė;ŽIRNIUKAI;1138257807;Ne;5;4;0;9
530;Aušrelė;ŽIRNIUKAI;1451587500;Ne;0;2;0;2
531;Aušrelė;ŽIRNIUKAI;5689460984;Ne;7;4;0;11
532;Aušrelė;ŽIRNIUKAI;4260768468;Ne;10;1;0;11
533;Aušrelė;ŽIRNIUKAI;3295471821;Ne;6;5;0;11
534;Aušrelė;GRYBUKAI;2466858636;Taip;15;4;0;19
535;Aušrelė;GRYBUKAI;4213141410;Ne;0;5;0;5
536;Aušrelė;GRYBUKAI;6287520834;Ne;0;5;0;5
537;Aušrelė;GRYBUKAI;2450164324;Ne;5;3;0;8
538;Aušrelė;GRYBUKAI;6902592468;Ne;0;1;0;1
539;Aušrelė;GRYBUKAI;2845543931;Ne;4;3;0;7
540;Aušrelė;GRYBUKAI;4063895292;Ne;0;12;0;12
541;Aušrelė;GRYBUKAI;4719347430;Ne;11;3;0;14
542;Aušrelė;GRYBUKAI;9093567659;Ne;0;4;0;4
543;Aušrelė;GRYBUKAI;5409930406;Ne;1;3;0;4
544;Aušrelė;GRYBUKAI;7058664271;Taip;11;1;0;12
545;Aušrelė;GRYBUKAI;1934623405;Ne;8;1;0;9
546;Aušrelė;GRYBUKAI;8103112254;Ne;9;0;0;9
547;Aušrelė;GRYBUKAI;7670935967;Ne;8;3;0;11
548;Aušrelė;GRYBUKAI;9007129980;Ne;6;3;1;10
549;Aušrelė;GRYBUKAI;5709799539;Ne;8;4;0;12
550;Aušrelė;GRYBUKAI;8724802289;Ne;8;4;0;12
551;Aušrelė;GRYBUKAI;9075395810;Ne;14;3;0;17
552;Aušrelė;GRYBUKAI;4840787696;Ne;0;9;0;9
553;Aušrelė;DRUGELIAI;1209824814;Ne;5;2;0;7
554;Aušrelė;DRUGELIAI;3831695455;Ne;0;3;0;3
555;Aušrelė;DRUGELIAI;2737402297;Ne;5;4;0;9
556;Aušrelė;DRUGELIAI;3813270658;Ne;0;2;0;2
557;Aušrelė;DRUGELIAI;4254737302;Ne;2;1;0;3
558;Aušrelė;DRUGELIAI;4464947621;Taip;2;7;0;9
559;Aušrelė;DRUGELIAI;9126040500;Ne;0;9;0;9
560;Aušrelė;DRUGELIAI;7286960315;Ne;0;8;0;8
561;Aušrelė;DRUGELIAI;8102293098;Taip;5;5;0;10
562;Aušrelė;DRUGELIAI;2266835623;Ne;0;10;0;10
563;Aušrelė;DRUGELIAI;1094141305;Ne;0;5;0;5
564;Aušrelė;DRUGELIAI;9514049590;Ne;5;2;0;7
565;Aušrelė;DRUGELIAI;5815844340;Ne;0;3;0;3
566;Aušrelė;DRUGELIAI;5668908532;Ne;0;8;0;8
567;Aušrelė;DRUGELIAI;9819729046;Ne;8;2;0;10
568;Aušrelė;DRUGELIAI;5698248175;Ne;17;0;0;17
569;Aušrelė;NYKŠTUKAI;9914518299;Ne;10;2;0;12
570;Aušrelė;NYKŠTUKAI;4297417711;Ne;13;1;0;14
571;Aušrelė;NYKŠTUKAI;7964156691;Taip;14;1;0;15
572;Aušrelė;NYKŠTUKAI;7140465960;Ne;4;1;0;5
573;Aušrelė;NYKŠTUKAI;7937067384;Ne;7;0;0;7
574;Aušrelė;NYKŠTUKAI;8099338305;Ne;17;0;0;17
575;Aušrelė;NYKŠTUKAI;6513026989;Ne;7;0;0;7
576;Aušrelė;NYKŠTUKAI;4282189556;Ne;9;3;0;12
577;Aušrelė;NYKŠTUKAI;4252475967;Taip;0;1;0;1
578;Aušrelė;NYKŠTUKAI;1950091527;Taip;11;3;0;14
579;Aušrelė;NYKŠTUKAI;8378225406;Ne;7;6;0;13
580;Aušrelė;NYKŠTUKAI;3259828075;Ne;15;0;0;15
581;Aušrelė;NYKŠTUKAI;4952876188;Ne;4;2;0;6
582;Aušrelė;NYKŠTUKAI;6474867237;Ne;11;0;0;11
583;Aušrelė;NYKŠTUKAI;2645772675;Ne;2;4;0;6
584;Aušrelė;NYKŠTUKAI;8829298943;Ne;8;1;0;9
585;Aušrelė;NYKŠTUKAI;5018495543;Ne;9;0;0;9
586;Aušrelė;SPINDULIUKAI;8848358559;Ne;3;4;0;7
587;Aušrelė;SPINDULIUKAI;3194122285;Ne;10;3;0;13
588;Aušrelė;SPINDULIUKAI;2857158437;Ne;8;4;0;12
589;Aušrelė;SPINDULIUKAI;8801906679;Ne;4;4;0;8
590;Aušrelė;SPINDULIUKAI;1446194971;Ne;0;6;0;6
591;Aušrelė;SPINDULIUKAI;2319188134;Ne;13;2;0;15
592;Aušrelė;SPINDULIUKAI;8997650487;Ne;6;3;1;10
593;Aušrelė;SPINDULIUKAI;5274919078;Ne;0;6;0;6
594;Aušrelė;SPINDULIUKAI;2981314491;Ne;5;3;0;8
595;Aušrelė;SPINDULIUKAI;2441221298;Ne;0;5;1;6
596;Aušrelė;SPINDULIUKAI;8427699400;Ne;7;4;0;11
597;Aušrelė;SPINDULIUKAI;8797157671;Ne;19;0;0;19
598;Aušrelė;SPINDULIUKAI;3646395136;Ne;0;2;0;2
599;Aušrelė;SPINDULIUKAI;9973824348;Ne;17;2;0;19
600;Aušrelė;SPINDULIUKAI;8438945369;Ne;0;8;0;8
601;Aušrelė;SPINDULIUKAI;3072503569;Ne;10;5;0;15
602;Aušrelė;SPINDULIUKAI;9938762910;Ne;0;1;0;1
603;Beržynėlis;SVIRPLIUKAI;7360345539;Ne;4;4;0;8
604;Beržynėlis;SVIRPLIUKAI;4134371415;Ne;0;1;0;1
605;Beržynėlis;SVIRPLIUKAI;7278860816;Ne;0;3;0;3
606;Beržynėlis;SVIRPLIUKAI;4013099670;Ne;0;4;0;4
607;Beržynėlis;SVIRPLIUKAI;8404801225;Ne;2;2;0;4
608;Beržynėlis;SVIRPLIUKAI;7953957525;Ne;2;6;0;8
609;Beržynėlis;SVIRPLIUKAI;3841363368;Ne;3;0;0;3
610;Beržynėlis;SVIRPLIUKAI;3418730586;Ne;7;0;0;7
611;Beržynėlis;SVIRPLIUKAI;1468551784;Ne;5;2;0;7
612;Beržynėlis;SVIRPLIUKAI;2221708263;Ne;0;1;0;1
613;Beržynėlis;SVIRPLIUKAI;8880151537;Ne;3;0;0;3
614;Beržynėlis;SVIRPLIUKAI;6516665294;Ne;0;5;0;5
615;Beržynėlis;SVIRPLIUKAI;9580286493;Ne;0;3;0;3
616;Beržynėlis;SVIRPLIUKAI;6673910279;Ne;5;3;0;8
617;Beržynėlis;SVIRPLIUKAI;8701990625;Ne;0;3;0;3
618;Beržynėlis;SVIRPLIUKAI;5027712732;Ne;15;0;0;15
619;Beržynėlis;SVIRPLIUKAI;7555487759;Ne;0;1;0;1
620;Beržynėlis;SVIRPLIUKAI;7788532819;Ne;0;2;0;2
621;Beržynėlis;SVIRPLIUKAI;3315079004;Ne;5;3;0;8
622;Beržynėlis;SVIRPLIUKAI;8533912024;Ne;5;1;0;6
623;Beržynėlis;SVIRPLIUKAI;4978363316;Ne;0;1;0;1
624;Beržynėlis;SVIRPLIUKAI;5864265458;Ne;0;4;0;4
625;Beržynėlis;PELEDŽIUKAI;6837130893;Ne;4;0;1;5
626;Beržynėlis;PELEDŽIUKAI;5473666098;Ne;0;4;0;4
627;Beržynėlis;PELEDŽIUKAI;9088059487;Ne;0;4;0;4
628;Beržynėlis;PELEDŽIUKAI;6337962165;Ne;0;5;0;5
629;Beržynėlis;PELEDŽIUKAI;7589778533;Ne;0;4;0;4
630;Beržynėlis;PELEDŽIUKAI;8591800387;Ne;0;11;0;11
631;Beržynėlis;PELEDŽIUKAI;6739927917;Ne;3;2;1;6
632;Beržynėlis;PELEDŽIUKAI;2971686368;Ne;0;5;0;5
633;Beržynėlis;PELEDŽIUKAI;9409317403;Ne;0;5;0;5
634;Beržynėlis;PELEDŽIUKAI;9305279614;Ne;0;3;0;3
635;Beržynėlis;PELEDŽIUKAI;1325972861;Ne;2;0;2;4
636;Beržynėlis;PELEDŽIUKAI;5856519538;Ne;0;4;0;4
637;Beržynėlis;PELEDŽIUKAI;8114761925;Ne;0;3;1;4
638;Beržynėlis;PELEDŽIUKAI;9896122318;Ne;9;0;0;9
639;Beržynėlis;PELEDŽIUKAI;4970999989;Ne;0;1;0;1
640;Beržynėlis;PELEDŽIUKAI;4035764376;Ne;0;5;0;5
641;Beržynėlis;PELEDŽIUKAI;5308596559;Ne;0;5;0;5
642;Beržynėlis;PELEDŽIUKAI;8881566865;Ne;8;0;0;8
643;Beržynėlis;PELEDŽIUKAI;4161974847;Ne;0;4;0;4
644;Beržynėlis;ŽIOGELIAI;7903644161;Ne;6;0;0;6
645;Beržynėlis;ŽIOGELIAI;3100097647;Ne;8;0;0;8
646;Beržynėlis;ŽIOGELIAI;7084666673;Ne;4;0;0;4
647;Beržynėlis;ŽIOGELIAI;1707585750;Ne;4;0;1;5
648;Beržynėlis;ŽIOGELIAI;4382068779;Ne;5;0;0;5
649;Beržynėlis;ŽIOGELIAI;1831776326;Ne;11;0;0;11
650;Beržynėlis;ŽIOGELIAI;1118349439;Ne;8;0;0;8
651;Beržynėlis;ŽIOGELIAI;6592330036;Taip;6;2;0;8
652;Beržynėlis;ŽIOGELIAI;1503903200;Ne;8;2;0;10
653;Beržynėlis;ŽIOGELIAI;3593785967;Taip;4;0;0;4
654;Beržynėlis;ŽIOGELIAI;7972993168;Ne;6;1;0;7
655;Beržynėlis;ŽIOGELIAI;5049057730;Ne;0;0;1;1
656;Beržynėlis;ŽIOGELIAI;2583982025;Ne;3;2;0;5
657;Beržynėlis;ŽIOGELIAI;6932094459;Ne;2;2;0;4
658;Beržynėlis;ŽIOGELIAI;2155662035;Ne;0;2;0;2
659;Beržynėlis;ŽIOGELIAI;7870888327;Ne;6;0;0;6
660;Beržynėlis;ŽIOGELIAI;1558469002;Ne;5;0;0;5
661;Beržynėlis;ŽIOGELIAI;9603272698;Ne;19;0;0;19
662;Beržynėlis;ŽIOGELIAI;9493489114;Ne;19;0;0;19
663;Beržynėlis;ŽIOGELIAI;8665581794;Ne;19;0;0;19
664;Beržynėlis;ŽIOGELIAI;7806800327;Taip;19;0;0;19
665;Beržynėlis;ŽVIRBLIUKAI;2193460960;Ne;0;4;0;4
666;Beržynėlis;ŽVIRBLIUKAI;2482395208;Ne;0;4;0;4
667;Beržynėlis;ŽVIRBLIUKAI;7057284039;Taip;0;3;0;3
668;Beržynėlis;ŽVIRBLIUKAI;2892553878;Ne;0;5;0;5
669;Beržynėlis;ŽVIRBLIUKAI;4466393687;Ne;0;4;0;4
670;Beržynėlis;ŽVIRBLIUKAI;4774769217;Ne;3;3;0;6
671;Beržynėlis;ŽVIRBLIUKAI;8280378527;Ne;3;4;0;7
672;Beržynėlis;ŽVIRBLIUKAI;6713134631;Ne;2;2;0;4
673;Beržynėlis;ŽVIRBLIUKAI;5593146590;Ne;0;1;0;1
674;Beržynėlis;ŽVIRBLIUKAI;9754455116;Ne;0;5;0;5
675;Beržynėlis;ŽVIRBLIUKAI;3334994408;Ne;11;0;0;11
676;Beržynėlis;ŽVIRBLIUKAI;9777841895;Ne;0;5;0;5
677;Beržynėlis;ŽVIRBLIUKAI;6293884233;Ne;8;2;0;10
678;Beržynėlis;ŽVIRBLIUKAI;3209966996;Ne;0;7;0;7
679;Beržynėlis;ŽVIRBLIUKAI;5194416351;Ne;0;4;0;4
680;Beržynėlis;ŽVIRBLIUKAI;1228384088;Ne;2;0;0;2
681;Beržynėlis;ŽVIRBLIUKAI;5189335842;Ne;0;4;0;4
682;Beržynėlis;ŽVIRBLIUKAI;6864823739;Ne;0;1;0;1
683;Beržynėlis;ŽVIRBLIUKAI;3484188772;Ne;0;4;0;4
684;Beržynėlis;ŽIRNIUKAI;4944466205;Ne;0;2;0;2
685;Beržynėlis;ŽIRNIUKAI;6392773584;Ne;0;4;0;4
686;Beržynėlis;ŽIRNIUKAI;2154631640;Ne;3;1;0;4
687;Beržynėlis;ŽIRNIUKAI;9899702275;Ne;2;0;0;2
688;Beržynėlis;ŽIRNIUKAI;1320866413;Ne;6;0;0;6
689;Beržynėlis;ŽIRNIUKAI;5979829045;Ne;5;4;0;9
690;Beržynėlis;ŽIRNIUKAI;8027685774;Ne;0;3;0;3
691;Beržynėlis;ŽIRNIUKAI;2615367518;Ne;3;4;0;7
692;Beržynėlis;ŽIRNIUKAI;1986523281;Ne;6;0;0;6
693;Beržynėlis;ŽIRNIUKAI;4587584948;Ne;12;0;0;12
694;Beržynėlis;ŽIRNIUKAI;9901466559;Ne;2;0;0;2
695;Beržynėlis;VIŠČIUKAI;9480959071;Ne;5;14;0;19
696;Beržynėlis;VIŠČIUKAI;8716270335;Ne;16;0;0;16
697;Beržynėlis;VIŠČIUKAI;4248556027;Ne;15;0;0;15
698;Beržynėlis;VIŠČIUKAI;7017827446;Taip;0;4;0;4
699;Beržynėlis;VIŠČIUKAI;4308655600;Ne;14;0;0;14
700;Beržynėlis;VIŠČIUKAI;3192897091;Ne;8;0;0;8
701;Beržynėlis;VIŠČIUKAI;8052073990;Taip;6;0;0;6
702;Beržynėlis;VIŠČIUKAI;5630272112;Ne;3;0;0;3
703;Beržynėlis;VIŠČIUKAI;6514295883;Ne;6;0;0;6
704;Beržynėlis;VIŠČIUKAI;6312255348;Ne;6;0;0;6
705;Beržynėlis;VIŠČIUKAI;4786786104;Ne;0;8;0;8
706;Birutės;SKRUZDELIUKŲ;4968068043;Ne;0;2;1;3
707;Birutės;SKRUZDELIUKŲ;1761065941;Ne;0;4;0;4
708;Birutės;SKRUZDELIUKŲ;9610268046;Ne;0;4;1;5
709;Birutės;SKRUZDELIUKŲ;4027700332;Ne;0;4;0;4
710;Birutės;SKRUZDELIUKŲ;7685356079;Ne;2;3;0;5
711;Birutės;SKRUZDELIUKŲ;8636113039;Ne;2;6;0;8
712;Birutės;SKRUZDELIUKŲ;9411016611;Ne;0;2;0;2
713;Birutės;SKRUZDELIUKŲ;7119951690;Ne;4;0;0;4
714;Birutės;SKRUZDELIUKŲ;1945532852;Ne;0;4;0;4
715;Birutės;SKRUZDELIUKŲ;5154903444;Ne;0;4;0;4
716;Birutės;SKRUZDELIUKŲ;9541516589;Ne;5;0;2;7
717;Birutės;SKRUZDELIUKŲ;6815916679;Ne;0;5;0;5
718;Birutės;SKRUZDELIUKŲ;9187671201;Ne;8;1;0;9
719;Birutės;SKRUZDELIUKŲ;2140552221;Ne;0;0;2;2
720;Birutės;SKRUZDELIUKŲ;8413760872;Ne;0;2;0;2
721;Birutės;SKRUZDELIUKŲ;7940403585;Ne;0;4;0;4
722;Birutės;SKRUZDELIUKŲ;4375683234;Ne;0;3;0;3
723;Birutės;SKRUZDELIUKŲ;8432173636;Ne;0;0;3;3
724;Birutės;SKRUZDELIUKŲ;9904827482;Ne;0;2;2;4
725;Birutės;SKRUZDELIUKŲ;2859160609;Ne;0;2;0;2
726;Birutės;SKRUZDELIUKŲ;9479697733;Ne;0;4;0;4
727;Birutės;SKRUZDELIUKŲ;2329522074;Ne;0;4;4;8
728;Birutės;SKRUZDELIUKŲ;1072357835;Ne;0;3;0;3
729;Birutės;BITUČIŲ;2866807046;Ne;3;0;1;4
730;Birutės;BITUČIŲ;7477555732;Ne;7;0;0;7
731;Birutės;BITUČIŲ;3991168916;Ne;3;1;0;4
732;Birutės;BITUČIŲ;7859284810;Ne;1;0;0;1
733;Birutės;BITUČIŲ;9147604398;Ne;0;2;0;2
734;Birutės;BITUČIŲ;3562960250;Ne;4;0;0;4
735;Birutės;BITUČIŲ;4647941243;Ne;3;0;0;3
736;Birutės;BITUČIŲ;6931635742;Ne;2;0;0;2
737;Birutės;BITUČIŲ;5443447213;Ne;5;1;0;6
738;Birutės;BITUČIŲ;8736343179;Ne;10;0;1;11
739;Birutės;BITUČIŲ;9303655949;Ne;0;2;0;2
740;Birutės;BITUČIŲ;9627882026;Ne;3;0;0;3
741;Birutės;BITUČIŲ;2046634392;Ne;1;0;0;1
742;Birutės;BITUČIŲ;3993249933;Ne;1;0;0;1
743;Birutės;BITUČIŲ;4102490815;Ne;6;3;0;9
744;Birutės;BITUČIŲ;3584029960;Ne;10;5;0;15
745;Birutės;BITUČIŲ;7875884277;Ne;10;0;0;10
746;Birutės;BORUŽIUKAI;5893851353;Ne;1;4;0;5
747;Birutės;BORUŽIUKAI;5457357625;Ne;0;4;0;4
748;Birutės;BORUŽIUKAI;5869137292;Ne;6;0;0;6
749;Birutės;BORUŽIUKAI;5026442722;Ne;6;6;0;12
750;Birutės;BORUŽIUKAI;6977276295;Ne;19;0;0;19
751;Birutės;BORUŽIUKAI;9289922622;Taip;2;0;0;2
752;Birutės;BORUŽIUKAI;8011210158;Ne;2;3;0;5
753;Birutės;BORUŽIUKAI;9263238557;Ne;0;4;0;4
754;Birutės;BORUŽIUKAI;4488481136;Ne;12;0;0;12
755;Birutės;BORUŽIUKAI;6460415179;Ne;0;4;0;4
756;Birutės;BORUŽIUKAI;6973898557;Ne;2;3;0;5
757;Birutės;BORUŽIUKAI;7033907787;Ne;2;0;0;2
758;Birutės;BORUŽIUKAI;5745377474;Ne;3;4;0;7
759;Birutės;BORUŽIUKAI;5897671273;Ne;16;0;3;19
760;Birutės;BORUŽIUKAI;2016711225;Ne;2;2;0;4
761;Birutės;BORUŽIUKAI;7712882120;Ne;5;0;1;6
762;Birutės;BORUŽIUKAI;7741922416;Ne;0;9;0;9
763;Birutės;BORUŽIUKAI;1400510886;Ne;2;0;0;2
764;Birutės;BORUŽIUKAI;1776142202;Ne;3;0;0;3
765;Birutės;BORUŽIUKAI;4906874758;Ne;0;3;0;3
766;Birutės;BORUŽIUKAI;2681370776;Taip;6;0;0;6
767;Birutės;BORUŽIUKAI;7398022393;Taip;7;3;1;11
768;Birutės;DRUGELIAI;8854957814;Ne;10;0;1;11
769;Birutės;DRUGELIAI;6263985683;Ne;5;4;0;9
770;Birutės;DRUGELIAI;5957267018;Ne;0;0;2;2
771;Birutės;DRUGELIAI;1442496209;Ne;9;0;0;9
772;Birutės;DRUGELIAI;2318034045;Ne;15;0;0;15
773;Birutės;DRUGELIAI;9727836236;Ne;6;0;0;6
774;Birutės;DRUGELIAI;3516719248;Ne;0;3;2;5
775;Birutės;DRUGELIAI;5688633357;Ne;12;4;0;16
776;Birutės;DRUGELIAI;8559820030;Ne;10;4;5;19
777;Birutės;DRUGELIAI;9863681147;Ne;0;3;0;3
778;Birutės;DRUGELIAI;9307655828;Ne;8;0;0;8
779;Birutės;DRUGELIAI;3115571205;Ne;4;0;1;5
780;Birutės;DRUGELIAI;4674152995;Ne;0;2;0;2
781;Birutės;DRUGELIAI;5177528200;Ne;0;0;11;11
782;Birutės;DRUGELIAI;3391101786;Ne;5;1;0;6
783;Birutės;DRUGELIAI;7876057712;Ne;0;1;0;1
784;Birutės;DRUGELIAI;6765257633;Ne;0;1;0;1
785;Birutės;DRUGELIAI;2257683802;Ne;5;1;0;6
786;Birutės;DRUGELIAI;7336936451;Ne;0;12;0;12
787;Birutės;DRUGELIAI;4995437657;Ne;0;2;0;2
788;Bitutė;Aitvariukų;4474600934;Ne;9;0;0;9
789;Bitutė;Aitvariukų;5606049201;Ne;7;5;0;12
790;Bitutė;Aitvariukų;6035394425;Ne;13;6;0;19
791;Bitutė;Aitvariukų;7132616264;Ne;19;0;0;19
792;Bitutė;Aitvariukų;6030674568;Ne;15;0;0;15
793;Bitutė;Aitvariukų;9747786638;Ne;6;4;0;10
794;Bitutė;Aitvariukų;8259512455;Ne;12;0;0;12
795;Bitutė;Aitvariukų;2899217019;Ne;9;0;0;9
796;Bitutė;Aitvariukų;8670124052;Ne;0;2;0;2
797;Bitutė;Aitvariukų;1340530611;Ne;0;6;0;6
798;Bitutė;Aitvariukų;6759511692;Ne;7;4;0;11
799;Bitutė;Aitvariukų;4164058783;Ne;9;0;3;12
800;Bitutė;Aitvariukų;8908052679;Ne;19;0;0;19
801;Bitutė;Aitvariukų;4924483609;Ne;0;8;0;8
802;Bitutė;Aitvariukų;7447624247;Taip;4;7;0;11
803;Bitutė;Aitvariukų;5880651175;Ne;9;0;0;9
804;Bitutė;Aitvariukų;7433169909;Ne;14;1;0;15
805;Bitutė;Ežiukų;5126303823;Ne;0;2;1;3
806;Bitutė;Ežiukų;4764586168;Ne;3;5;1;9
807;Bitutė;Ežiukų;8905075899;Ne;6;2;0;8
808;Bitutė;Ežiukų;3600670185;Ne;0;4;0;4
809;Bitutė;Ežiukų;6341806464;Ne;6;0;0;6
810;Bitutė;Ežiukų;2812580726;Ne;0;5;0;5
811;Bitutė;Ežiukų;8186706520;Ne;0;19;0;19
812;Bitutė;Ežiukų;5378885117;Ne;0;4;0;4
813;Bitutė;Ežiukų;2122052883;Ne;8;0;1;9
814;Bitutė;Ežiukų;4444523140;Ne;2;5;0;7
815;Bitutė;Ežiukų;4024758152;Ne;2;4;0;6
816;Bitutė;Ežiukų;6194712643;Ne;0;4;0;4
817;Bitutė;Ežiukų;4468366941;Ne;8;0;0;8
818;Bitutė;Ežiukų;5188828679;Ne;0;4;0;4
819;Bitutė;Ežiukų;8109028957;Ne;0;4;0;4
820;Bitutė;Ežiukų;3156654672;Ne;6;5;0;11
821;Bitutė;Ežiukų;9106644834;Ne;5;4;0;9
822;Bitutė;Ežiukų;1397711778;Ne;2;4;1;7
823;Bitutė;Ežiukų;5146691157;Ne;9;0;0;9
824;Bitutė;Žvirbliukų;1290146001;Taip;0;4;0;4
825;Bitutė;Žvirbliukų;6226996242;Ne;9;1;0;10
826;Bitutė;Žvirbliukų;1460746240;Ne;10;0;0;10
827;Bitutė;Žvirbliukų;3359918177;Ne;0;4;0;4
828;Bitutė;Žvirbliukų;9352292654;Ne;2;0;6;8
829;Bitutė;Žvirbliukų;2819417600;Ne;0;4;1;5
830;Bitutė;Žvirbliukų;5421744666;Ne;2;0;1;3
831;Bitutė;Žvirbliukų;9780599803;Ne;11;1;0;12
832;Bitutė;Žvirbliukų;7741454857;Ne;0;0;5;5
833;Bitutė;Žvirbliukų;6091108131;Ne;13;0;0;13
834;Bitutė;Žvirbliukų;4617493676;Ne;14;0;0;14
835;Bitutė;Žvirbliukų;3860047703;Taip;3;0;0;3
836;Bitutė;Žvirbliukų;5375847129;Ne;0;5;0;5
837;Bitutė;Žvirbliukų;3806852067;Ne;0;19;0;19
838;Bitutė;Žvirbliukų;3528436838;Ne;9;0;0;9
839;Bitutė;Žvirbliukų;2583001947;Ne;9;0;0;9
840;Bitutė;Žvirbliukų;2129484313;Ne;0;5;0;5
841;Bitutė;Žvirbliukų;2144809294;Ne;5;4;1;10
842;Bitutė;Žvirbliukų;7013249141;Ne;9;0;5;14
843;Bitutė;Žvirbliukų;5081300818;Ne;0;4;0;4
844;Bitutė;Žvirbliukų;4524571780;Ne;11;0;0;11
845;Bitutė;Gandriukų;8373296210;Ne;7;2;0;9
846;Bitutė;Gandriukų;8789574593;Ne;0;2;0;2
847;Bitutė;Gandriukų;1985958540;Ne;0;3;0;3
848;Bitutė;Gandriukų;8743960488;Ne;8;2;0;10
849;Bitutė;Gandriukų;9451529077;Ne;8;0;0;8
850;Bitutė;Gandriukų;9217178863;Ne;0;4;0;4
851;Bitutė;Gandriukų;4639968278;Ne;5;4;0;9
852;Bitutė;Gandriukų;1907876695;Ne;0;3;0;3
853;Bitutė;Gandriukų;7720798466;Ne;0;3;0;3
854;Bitutė;Gandriukų;1662815358;Ne;0;4;0;4
855;Bitutė;Gandriukų;1733189730;Ne;0;6;0;6
856;Bitutė;Gandriukų;4566919587;Ne;0;2;0;2
857;Bitutė;Gandriukų;9966437881;Ne;0;4;0;4
858;Bitutė;Gandriukų;2806899030;Ne;0;2;0;2
859;Bitutė;Gandriukų;1241863345;Ne;7;2;0;9
860;Bitutė;Gandriukų;9465186207;Ne;0;4;0;4
861;Bitutė;Gandriukų;2658405980;Ne;0;4;0;4
862;Bitutė;Pelėdžiukai;2444289145;Ne;4;4;1;9
863;Bitutė;Pelėdžiukai;3517750478;Ne;6;2;0;8
864;Bitutė;Pelėdžiukai;3804171750;Ne;0;6;0;6
865;Bitutė;Pelėdžiukai;8545377054;Ne;1;1;0;2
866;Bitutė;Pelėdžiukai;5406667195;Ne;1;4;0;5
867;Bitutė;Pelėdžiukai;4458990772;Ne;0;4;0;4
868;Bitutė;Pelėdžiukai;3723040682;Ne;5;4;0;9
869;Bitutė;Pelėdžiukai;5291764696;Ne;3;2;2;7
870;Bitutė;Pelėdžiukai;6014726741;Ne;1;7;0;8
871;Bitutė;Pelėdžiukai;4527880105;Ne;2;4;0;6
872;Bitutė;Pelėdžiukai;2190439190;Ne;3;6;0;9
873;Bitutė;Pelėdžiukai;9834697190;Ne;0;2;0;2
874;Bitutė;Pelėdžiukai;7113693496;Ne;7;4;0;11
875;Bitutė;Pelėdžiukai;9523588597;Ne;3;4;0;7
876;Bitutė;Pelėdžiukai;7047262367;Ne;0;5;0;5
877;Bitutė;Pelėdžiukai;4177331531;Ne;1;4;0;5
878;Bitutė;Pelėdžiukai;2483462846;Ne;3;7;0;10
879;Bitutė;Pelėdžiukai;7678106084;Ne;4;4;0;8
880;Bitutė;Pelėdžiukai;9166624750;Ne;1;5;0;6
881;Bitutė;Pelėdžiukai;8373105196;Ne;2;4;0;6
882;Bitutė;Pelėdžiukai;6044969600;Ne;4;3;0;7
883;Bitutė;Pelėdžiukai;3654065124;Ne;3;4;0;7
884;Bitutė;Boružėlių;8276590981;Ne;12;0;3;15
885;Bitutė;Boružėlių;3026526421;Ne;3;0;0;3
886;Bitutė;Boružėlių;7503203424;Ne;11;0;0;11
887;Bitutė;Boružėlių;1711888057;Ne;1;0;2;3
888;Bitutė;Boružėlių;8355346371;Ne;7;0;0;7
889;Bitutė;Boružėlių;9545405359;Ne;4;0;0;4
890;Bitutė;Boružėlių;9691450767;Ne;0;0;3;3
891;Bitutė;Boružėlių;3170266155;Ne;10;0;0;10
892;Bitutė;Boružėlių;6455582149;Ne;3;0;0;3
893;Bitutė;Boružėlių;8011051470;Ne;13;0;0;13
894;Bitutė;Boružėlių;9521938997;Ne;5;0;0;5
895;Bitutė;Boružėlių;9668365838;Ne;14;3;0;17
896;Bitutė;Boružėlių;3870675531;Ne;10;0;0;10
897;Bitutė;Boružėlių;7095475821;Taip;2;0;3;5
898;Bitutė;Boružėlių;6255439813;Ne;11;0;0;11
899;Bitutė;Boružėlių;2623999429;Ne;3;1;0;4
900;Bitutė;Boružėlių;6840722112;Ne;10;0;1;11
901;Bitutė;Boružėlių;4884898917;Ne;2;0;0;2
902;Bitutė;Boružėlių;4869423833;Ne;14;0;0;14
903;Bitutė;Boružėlių;5071978105;Ne;5;0;1;6
904;Bitutė;Šokliukų;8211710975;Ne;0;7;0;7
905;Bitutė;Šokliukų;8872286273;Ne;2;5;0;7
906;Bitutė;Šokliukų;5169768042;Ne;0;6;0;6
907;Bitutė;Šokliukų;1348548294;Ne;0;3;0;3
908;Bitutė;Šokliukų;7318555933;Ne;0;1;0;1
909;Bitutė;Šokliukų;9924340801;Ne;0;5;0;5
910;Bitutė;Šokliukų;7165511381;Ne;5;2;0;7
911;Bitutė;Šokliukų;2853616585;Ne;0;4;0;4
912;Bitutė;Šokliukų;5109258680;Ne;0;1;0;1
913;Bitutė;Šokliukų;8439759353;Ne;0;2;0;2
914;Bitutė;Šokliukų;3417576747;Ne;1;2;0;3
915;Bitutė;Šokliukų;8422448947;Ne;0;5;0;5
916;Bitutė;Šokliukų;7926482326;Ne;0;8;0;8
917;Bitutė;Šokliukų;5876700984;Ne;3;5;0;8
918;Bitutė;Šokliukų;2177537591;Ne;1;5;0;6
919;Bitutė;Šokliukų;4471813998;Ne;0;8;0;8
920;Bitutė;Šokliukų;9234090775;Ne;2;0;0;2
921;Bitutė;Drugelių;9094567866;Ne;0;0;4;4
922;Bitutė;Drugelių;5759595005;Ne;6;0;1;7
923;Bitutė;Drugelių;2085899696;Ne;0;4;0;4
924;Bitutė;Drugelių;2029309955;Ne;0;3;0;3
925;Bitutė;Drugelių;7376746010;Ne;0;2;0;2
926;Bitutė;Drugelių;5845408472;Ne;6;4;0;10
927;Bitutė;Drugelių;3611348253;Ne;0;4;0;4
928;Bitutė;Drugelių;8727525320;Ne;0;4;0;4
929;Bitutė;Drugelių;5796600501;Ne;0;4;1;5
930;Bitutė;Drugelių;1558826102;Ne;0;1;0;1
931;Bitutė;Drugelių;6325890676;Ne;4;5;1;10
932;Bitutė;Drugelių;2848732083;Taip;0;4;0;4
933;Bitutė;Drugelių;5278510767;Ne;0;4;0;4
934;Bitutė;Drugelių;8962725357;Ne;2;4;0;6
935;Bitutė;Drugelių;5471241132;Ne;0;5;2;7
936;Bitutė;Drugelių;1218462939;Ne;0;5;0;5
937;Bitutė;Drugelių;8008237092;Ne;0;4;3;7
938;Bitutė;Drugelių;4545188971;Ne;0;11;0;11
939;Bitutė;Drugelių;9492898584;Ne;0;4;0;4
940;Bitutė;Kiškučių;3603716923;Ne;0;7;0;7
941;Bitutė;Kiškučių;5181958187;Ne;1;8;0;9
942;Bitutė;Kiškučių;4480187618;Ne;5;0;0;5
943;Bitutė;Kiškučių;4926289620;Ne;10;0;0;10
944;Bitutė;Kiškučių;7694916340;Ne;6;0;0;6
945;Bitutė;Kiškučių;5061164237;Ne;9;1;0;10
946;Bitutė;Kiškučių;8130382253;Ne;5;3;0;8
947;Bitutė;Kiškučių;5869737425;Ne;2;0;0;2
948;Bitutė;Kiškučių;5220694242;Ne;10;4;0;14
949;Bitutė;Kiškučių;8303932330;Ne;9;4;0;13
950;Bitutė;Kiškučių;8642411661;Ne;1;2;0;3
951;Bitutė;Kiškučių;1198024852;Ne;0;2;0;2
952;Bitutė;Kiškučių;9909017070;Ne;0;5;0;5
953;Bitutė;Kiškučių;3811028304;Ne;0;6;0;6
954;Bitutė;Kiškučių;9592567172;Ne;0;1;0;1
955;Bitutė;Kiškučių;7535583229;Ne;1;0;0;1
956;Bitutė;Kiškučių;7619112317;Ne;8;5;0;13
957;Bitutė;Kiškučių;8896842164;Ne;5;4;0;9
958;Bitutė;Kiškučių;8561037889;Ne;4;5;0;9
959;Bitutė;"Viščiukų ";2707925569;Ne;8;4;0;12
960;Bitutė;"Viščiukų ";9872069356;Ne;1;3;0;4
961;Bitutė;"Viščiukų ";7341046095;Ne;5;5;0;10
962;Bitutė;"Viščiukų ";9325422338;Ne;14;5;0;19
963;Bitutė;"Viščiukų ";1147029462;Ne;14;0;0;14
964;Bitutė;"Viščiukų ";9653424274;Ne;0;4;0;4
965;Bitutė;"Viščiukų ";3318389039;Ne;11;4;0;15
966;Bitutė;"Viščiukų ";7301966217;Ne;5;6;0;11
967;Bitutė;"Viščiukų ";4864590214;Taip;15;0;0;15
968;Bitutė;"Viščiukų ";5111232226;Ne;2;5;0;7
969;Bitutė;"Viščiukų ";7384402285;Ne;15;0;0;15
970;Bitutė;"Viščiukų ";6045476884;Ne;3;4;0;7
971;Bitutė;"Viščiukų ";7566001042;Taip;2;8;0;10
972;Bitutė;"Viščiukų ";2368846393;Ne;11;2;0;13
973;Bitutė;"Viščiukų ";4041036896;Ne;0;2;0;2
974;Bitutė;"Skruzdėliukai ";5686278261;Ne;8;4;0;12
975;Bitutė;"Skruzdėliukai ";1423694056;Ne;2;1;0;3
976;Bitutė;"Skruzdėliukai ";5942493696;Taip;0;4;0;4
977;Bitutė;"Skruzdėliukai ";6311396261;Ne;10;4;0;14
978;Bitutė;"Skruzdėliukai ";7145036085;Ne;11;0;0;11
979;Bitutė;"Skruzdėliukai ";2252157473;Ne;2;4;0;6
980;Bitutė;"Skruzdėliukai ";6169426273;Ne;5;4;0;9
981;Bitutė;"Skruzdėliukai ";4513783927;Ne;6;0;0;6
982;Bitutė;"Skruzdėliukai ";8667259778;Ne;8;0;0;8
983;Bitutė;"Skruzdėliukai ";8607718704;Ne;0;4;0;4
984;Bitutė;"Skruzdėliukai ";4413880918;Ne;5;0;1;6
985;Bitutė;"Skruzdėliukai ";9436414962;Ne;10;4;0;14
986;Bitutė;"Skruzdėliukai ";9864771568;Ne;0;4;0;4
987;Bitutė;"Skruzdėliukai ";6353690252;Ne;9;4;0;13
988;Bitutė;"Skruzdėliukai ";2160735504;Ne;11;0;0;11
989;Bitutė;"Skruzdėliukai ";1387310054;Ne;8;0;0;8
990;Bitutė;"Skruzdėliukai ";7245807233;Ne;8;0;2;10
991;Bitutė;"Skruzdėliukai ";4467090141;Ne;7;0;2;9
992;Bitutė;"Skruzdėliukai ";5433617195;Ne;14;1;0;15
993;Bitutė;"Skruzdėliukai ";2391170362;Ne;0;4;0;4
994;Bitutė;"Skruzdėliukai ";5490753578;Ne;12;0;0;12
995;Bitutė;"Nykštukų ";1677780832;Ne;3;4;1;8
996;Bitutė;"Nykštukų ";7093067437;Ne;5;3;0;8
997;Bitutė;"Nykštukų ";7494665747;Ne;8;1;1;10
998;Bitutė;"Nykštukų ";9392119453;Ne;0;19;0;19
999;Bitutė;"Nykštukų ";7618391238;Ne;5;5;0;10
1000;Bitutė;"Nykštukų ";7201520408;Ne;0;19;0;19
1001;Bitutė;"Nykštukų ";3564872382;Ne;9;0;0;9
1002;Bitutė;"Nykštukų ";2779363539;Ne;8;4;0;12
1003;Bitutė;"Nykštukų ";1094120235;Ne;8;0;0;8
1004;Bitutė;"Nykštukų ";8344844253;Ne;10;4;0;14
1005;Bitutė;"Nykštukų ";4341037730;Ne;9;1;0;10
1006;Bitutė;"Nykštukų ";6591026369;Ne;9;1;0;10
1007;Bitutė;"Nykštukų ";3430153178;Ne;3;1;0;4
1008;Bitutė;"Nykštukų ";3938392405;Ne;8;0;1;9
1009;Bitutė;"Nykštukų ";5974397461;Ne;1;0;0;1
1010;Bitutė;"Nykštukų ";1124437382;Ne;3;4;0;7
1011;Coliukė;"Bitutės (A.Kojelavičiaus g. 298)";6725408547;Ne;0;3;0;3
1012;Coliukė;"Bitutės (A.Kojelavičiaus g. 298)";2167230398;Ne;0;8;0;8
1013;Coliukė;"Bitutės (A.Kojelavičiaus g. 298)";5349969025;Ne;5;0;0;5
1014;Coliukė;"Bitutės (A.Kojelavičiaus g. 298)";8767261039;Ne;3;2;0;5
1015;Coliukė;"Bitutės (A.Kojelavičiaus g. 298)";7345905007;Ne;3;2;0;5
1016;Coliukė;"Bitutės (A.Kojelavičiaus g. 298)";1968467455;Ne;0;4;0;4
1017;Coliukė;"Bitutės (A.Kojelavičiaus g. 298)";9462610674;Ne;0;4;0;4
1018;Coliukė;"Bitutės (A.Kojelavičiaus g. 298)";4188233426;Ne;0;4;0;4
1019;Coliukė;"Bitutės (A.Kojelavičiaus g. 298)";9331485675;Ne;9;1;0;10
1020;Coliukė;"Bitutės (A.Kojelavičiaus g. 298)";2275327607;Ne;2;4;0;6
1021;Coliukė;"Bitutės (A.Kojelavičiaus g. 298)";9879369365;Ne;0;10;0;10
1022;Coliukė;"Bitutės (A.Kojelavičiaus g. 298)";4845247006;Ne;5;3;0;8
1023;Coliukė;"Bitutės (A.Kojelavičiaus g. 298)";9885547263;Ne;0;4;2;6
1024;Coliukė;"Bitutės (A.Kojelavičiaus g. 298)";8517128464;Ne;0;1;0;1
1025;Coliukė;"Bitutės (A.Kojelavičiaus g. 298)";8149118599;Ne;0;4;0;4
1026;Coliukė;"Bitutės (A.Kojelavičiaus g. 298)";7358018315;Ne;5;5;0;10
1027;Coliukė;"Bitutės (A.Kojelavičiaus g. 298)";8478006305;Ne;0;5;4;9
1028;Coliukė;"Bitutės (A.Kojelavičiaus g. 298)";9352547729;Ne;0;3;0;3
1029;Coliukė;"Bitutės (A.Kojelavičiaus g. 298)";9750447455;Ne;11;1;0;12
1030;Coliukė;"Bitutės (A.Kojelavičiaus g. 298)";7621095517;Ne;5;3;0;8
1031;Coliukė;"Bitutės (A.Kojelavičiaus g. 298)";1390751418;Ne;0;3;0;3
1032;Coliukė;"Bitutės (A.Kojelavičiaus g. 298)";4881447596;Ne;7;4;1;12
1033;Coliukė;"Bitutės (A.Kojelavičiaus g. 298)";2151108735;Ne;10;6;0;16
1034;Coliukė;"Boružėlės.spec. (Karklėnų g. 15)";5756690199;Ne;10;0;0;10
1035;Coliukė;"Boružėlės.spec. (Karklėnų g. 15)";4422823135;Ne;17;0;0;17
1036;Coliukė;"Boružėlės.spec. (Karklėnų g. 15)";2947495861;Ne;15;0;0;15
1037;Coliukė;"Boružėlės.spec. (Karklėnų g. 15)";5008183731;Ne;7;0;0;7
1038;Coliukė;"Boružėlės.spec. (Karklėnų g. 15)";1134875499;Ne;7;0;0;7
1039;Coliukė;"Boružėlės.spec. (Karklėnų g. 15)";2351866339;Ne;5;0;0;5
1040;Coliukė;"Boružėlės.spec. (Karklėnų g. 15)";8347206534;Ne;0;1;0;1
1041;Coliukė;"Boružėlės.spec. (Karklėnų g. 15)";3270283626;Ne;10;0;0;10
1042;Coliukė;"Boružėlės.spec. (Karklėnų g. 15)";1326014786;Ne;11;0;0;11
1043;Coliukė;"Boružėlės.spec. (Karklėnų g. 15)";7513522378;Ne;7;0;0;7
1044;Coliukė;"Boružėlės.spec. (Karklėnų g. 15)";3905904092;Ne;13;0;0;13
1045;Coliukė;"Nykštukai (A.Kojelavičiaus g. 298)";4149083597;Ne;3;0;0;3
1046;Coliukė;"Nykštukai (A.Kojelavičiaus g. 298)";2171894105;Ne;4;2;0;6
1047;Coliukė;"Nykštukai (A.Kojelavičiaus g. 298)";5481656345;Ne;0;4;0;4
1048;Coliukė;"Nykštukai (A.Kojelavičiaus g. 298)";2379680426;Ne;3;2;0;5
1049;Coliukė;"Nykštukai (A.Kojelavičiaus g. 298)";6483218499;Ne;7;0;0;7
1050;Coliukė;"Nykštukai (A.Kojelavičiaus g. 298)";1590896552;Ne;5;2;0;7
1051;Coliukė;"Nykštukai (A.Kojelavičiaus g. 298)";4887837499;Ne;4;0;0;4
1052;Coliukė;"Nykštukai (A.Kojelavičiaus g. 298)";1465212393;Ne;19;0;0;19
1053;Coliukė;"Nykštukai (A.Kojelavičiaus g. 298)";1516038730;Ne;5;0;0;5
1054;Coliukė;"Nykštukai (A.Kojelavičiaus g. 298)";7164457313;Ne;9;3;0;12
1055;Coliukė;"Nykštukai (A.Kojelavičiaus g. 298)";6441253648;Ne;5;3;0;8
1056;Coliukė;"Nykštukai (A.Kojelavičiaus g. 298)";4537756081;Ne;0;11;0;11
1057;Coliukė;"Nykštukai (A.Kojelavičiaus g. 298)";3719547522;Ne;6;4;0;10
1058;Coliukė;"Nykštukai (A.Kojelavičiaus g. 298)";5450167562;Ne;0;4;0;4
1059;Coliukė;"Nykštukai (A.Kojelavičiaus g. 298)";9498557347;Ne;4;0;0;4
1060;Coliukė;"Nykštukai (A.Kojelavičiaus g. 298)";3384332079;Ne;5;2;0;7
1061;Coliukė;"Nykštukai (A.Kojelavičiaus g. 298)";1198781036;Ne;0;4;0;4
1062;Coliukė;"Nykštukai (A.Kojelavičiaus g. 298)";5283583324;Ne;0;5;0;5
1063;Coliukė;"Nykštukai (A.Kojelavičiaus g. 298)";9334564869;Ne;0;6;0;6
1064;Coliukė;"Nykštukai (A.Kojelavičiaus g. 298)";3140659021;Ne;0;0;14;14
1065;Coliukė;"Nykštukai (A.Kojelavičiaus g. 298)";2321127662;Ne;4;0;0;4
1066;Coliukė;"Nykštukai (A.Kojelavičiaus g. 298)";1575061659;Ne;6;0;0;6
1067;Coliukė;"Nykštukai (A.Kojelavičiaus g. 298)";3678496820;Ne;4;0;0;4
1068;Coliukė;"Nykštukai (A.Kojelavičiaus g. 298)";8715608220;Ne;0;2;0;2
1069;Coliukė;"Nykštukai (A.Kojelavičiaus g. 298)";3908791146;Ne;4;2;0;6
1070;Coliukė;"Nykštukai (A.Kojelavičiaus g. 298)";4635299740;Ne;0;12;0;12
1071;Coliukė;"Gėlytės (A.Kojelavičiaus g. 304) ";6226741104;Ne;6;2;0;8
1072;Coliukė;"Gėlytės (A.Kojelavičiaus g. 304) ";1415007991;Ne;2;0;0;2
1073;Coliukė;"Gėlytės (A.Kojelavičiaus g. 304) ";3712638808;Ne;12;0;0;12
1074;Coliukė;"Gėlytės (A.Kojelavičiaus g. 304) ";7500857860;Ne;16;0;0;16
1075;Coliukė;"Gėlytės (A.Kojelavičiaus g. 304) ";2952029073;Ne;4;0;0;4
1076;Coliukė;"Gėlytės (A.Kojelavičiaus g. 304) ";4757165137;Ne;16;0;0;16
1077;Coliukė;"Gėlytės (A.Kojelavičiaus g. 304) ";3693899535;Ne;4;0;0;4
1078;Coliukė;"Gėlytės (A.Kojelavičiaus g. 304) ";3419764892;Taip;16;0;0;16
1079;Coliukė;"Gėlytės (A.Kojelavičiaus g. 304) ";7259282073;Ne;11;0;0;11
1080;Coliukė;"Gėlytės (A.Kojelavičiaus g. 304) ";4618661887;Ne;17;0;0;17
1081;Coliukė;"Gėlytės (A.Kojelavičiaus g. 304) ";4327259627;Ne;0;4;0;4
1082;Coliukė;"Drugeliai  (A.Kojelavičiaus g. 304)  ";6675290003;Ne;9;4;0;13
1083;Coliukė;"Drugeliai  (A.Kojelavičiaus g. 304)  ";8202294275;Ne;12;0;0;12
1084;Coliukė;"Drugeliai  (A.Kojelavičiaus g. 304)  ";8849541084;Ne;0;1;0;1
1085;Coliukė;"Drugeliai  (A.Kojelavičiaus g. 304)  ";7763035106;Ne;0;1;0;1
1086;Coliukė;"Drugeliai  (A.Kojelavičiaus g. 304)  ";8756465257;Ne;9;2;0;11
1087;Coliukė;"Drugeliai  (A.Kojelavičiaus g. 304)  ";6224089401;Ne;0;2;0;2
1088;Coliukė;"Drugeliai  (A.Kojelavičiaus g. 304)  ";6102405328;Ne;9;0;0;9
1089;Coliukė;"Drugeliai  (A.Kojelavičiaus g. 304)  ";1861955437;Ne;0;3;0;3
1090;Coliukė;"Drugeliai  (A.Kojelavičiaus g. 304)  ";1220834062;Taip;0;6;0;6
1091;Coliukė;"Drugeliai  (A.Kojelavičiaus g. 304)  ";3392367716;Ne;5;2;0;7
1092;Coliukė;"Drugeliai  (A.Kojelavičiaus g. 304)  ";8698370746;Ne;11;2;0;13
1093;Coliukė;"Drugeliai  (A.Kojelavičiaus g. 304)  ";6611713551;Ne;6;4;0;10
1094;Coliukė;"Drugeliai  (A.Kojelavičiaus g. 304)  ";6755886435;Ne;3;4;0;7
1095;Coliukė;"Drugeliai  (A.Kojelavičiaus g. 304)  ";1452034828;Ne;0;4;0;4
1096;Coliukė;"Drugeliai  (A.Kojelavičiaus g. 304)  ";6816085304;Ne;1;8;0;9
1097;Coliukė;"Drugeliai  (A.Kojelavičiaus g. 304)  ";6941719947;Ne;0;4;0;4
1098;Coliukė;"Drugeliai  (A.Kojelavičiaus g. 304)  ";8606195508;Taip;8;0;0;8
1099;Coliukė;"Drugeliai  (A.Kojelavičiaus g. 304)  ";2247086548;Ne;0;5;0;5
1100;Coliukė;"Drugeliai  (A.Kojelavičiaus g. 304)  ";9664610507;Ne;12;0;0;12
1101;Čiauškutis;BITUTĖS;7893181156;Ne;0;1;1;2
1102;Čiauškutis;BITUTĖS;7976738303;Ne;0;5;0;5
1103;Čiauškutis;BITUTĖS;4026881335;Ne;0;4;5;9
1104;Čiauškutis;BITUTĖS;9753680961;Ne;4;0;5;9
1105;Čiauškutis;BITUTĖS;4852837431;Ne;0;1;2;3
1106;Čiauškutis;BITUTĖS;4652951382;Ne;0;0;3;3
1107;Čiauškutis;BITUTĖS;3837360101;Ne;0;1;1;2
1108;Čiauškutis;BITUTĖS;2319237497;Ne;12;0;0;12
1109;Čiauškutis;BITUTĖS;1765857419;Ne;0;4;0;4
1110;Čiauškutis;BITUTĖS;7282041196;Ne;0;18;1;19
1111;Čiauškutis;ŽVIRBLIUKAI;5125518366;Ne;0;0;13;13
1112;Čiauškutis;ŽVIRBLIUKAI;4962200863;Ne;15;0;0;15
1113;Čiauškutis;ŽVIRBLIUKAI;7324659239;Ne;4;0;0;4
1114;Čiauškutis;ŽVIRBLIUKAI;9759888353;Ne;0;3;0;3
1115;Čiauškutis;ŽVIRBLIUKAI;1032711865;Ne;14;0;0;14
1116;Čiauškutis;ŽVIRBLIUKAI;4599018314;Ne;19;0;0;19
1117;Čiauškutis;ŽVIRBLIUKAI;1288177637;Ne;0;0;5;5
1118;Čiauškutis;ŽVIRBLIUKAI;7359935733;Ne;5;0;6;11
1119;Čiauškutis;ŽVIRBLIUKAI;5368435217;Ne;0;4;6;10
1120;Čiauškutis;ŽVIRBLIUKAI;8925047375;Ne;0;0;4;4
1121;Čiauškutis;SAULUTĖS;1158816422;Ne;0;17;2;19
1122;Čiauškutis;SAULUTĖS;7239878097;Ne;16;0;0;16
1123;Čiauškutis;SAULUTĖS;7489733038;Ne;6;4;0;10
1124;Čiauškutis;SAULUTĖS;2237570705;Ne;3;0;0;3
1125;Čiauškutis;SAULUTĖS;3724324861;Ne;0;19;0;19
1126;Čiauškutis;SAULUTĖS;8580034134;Ne;0;3;1;4
1127;Čiauškutis;SAULUTĖS;2445742257;Ne;5;10;4;19
1128;Čiauškutis;SAULUTĖS;2737503753;Ne;0;3;1;4
1129;Čiauškutis;SAULUTĖS;7428833348;Ne;0;3;2;5
1130;Čiauškutis;SAULUTĖS;2686038029;Ne;0;3;1;4
1131;Čiauškutis;EŽIUKAI;9565722619;Ne;0;13;6;19
1132;Čiauškutis;EŽIUKAI;7654242839;Ne;0;4;3;7
1133;Čiauškutis;EŽIUKAI;9294208012;Ne;0;1;0;1
1134;Čiauškutis;EŽIUKAI;8297774828;Ne;0;1;0;1
1135;Čiauškutis;EŽIUKAI;6303770262;Ne;6;4;0;10
1136;Čiauškutis;EŽIUKAI;2380881303;Ne;4;0;1;5
1137;Čiauškutis;EŽIUKAI;2829031299;Ne;6;0;0;6
1138;Čiauškutis;EŽIUKAI;5666325776;Ne;5;0;1;6
1139;Čiauškutis;DRUGELIAI;4681902267;Ne;0;4;4;8
1140;Čiauškutis;DRUGELIAI;1928404791;Ne;0;3;0;3
1141;Čiauškutis;DRUGELIAI;1234494170;Ne;6;0;2;8
1142;Čiauškutis;DRUGELIAI;5404165993;Ne;0;4;0;4
1143;Čiauškutis;DRUGELIAI;9897499968;Ne;0;19;0;19
1144;Čiauškutis;DRUGELIAI;7135435979;Ne;0;4;3;7
1145;Čiauškutis;DRUGELIAI;6726124641;Ne;0;4;0;4
1146;Čiauškutis;GENELIAI;5957587644;Ne;15;4;0;19
1147;Čiauškutis;GENELIAI;5052137859;Ne;2;17;0;19
1148;Čiauškutis;GENELIAI;8876608072;Ne;3;4;5;12
1149;Čiauškutis;GENELIAI;3650541072;Ne;0;2;2;4
1150;Čiauškutis;GENELIAI;6785604459;Ne;4;12;3;19
1151;Čiauškutis;GENELIAI;8679018030;Ne;8;4;0;12
1152;Čiauškutis;GENELIAI;7851357992;Ne;8;4;1;13
1153;Čiauškutis;GENELIAI;7928675053;Ne;0;19;0;19
1154;Čiauškutis;GENELIAI;3644842573;Ne;4;0;1;5
1155;Čiauškutis;GENELIAI;1113437256;Ne;12;4;1;17
1156;Čiauškutis;LINKSMUČIAI;7184626362;Ne;0;4;0;4
1157;Čiauškutis;LINKSMUČIAI;8689127061;Ne;0;5;5;10
1158;Čiauškutis;LINKSMUČIAI;9062135043;Ne;0;4;1;5
1159;Čiauškutis;LINKSMUČIAI;1306672095;Ne;0;4;2;6
1160;Čiauškutis;LINKSMUČIAI;5910818962;Ne;0;4;1;5
1161;Čiauškutis;LINKSMUČIAI;4881821738;Ne;0;4;0;4
1162;Čiauškutis;LINKSMUČIAI;4881821738;Ne;0;4;0;4
1163;Čiauškutis;LINKSMUČIAI;6146321785;Ne;0;1;0;1
1164;Čiauškutis;LINKSMUČIAI;6434727608;Ne;7;4;1;12
1165;Čiauškutis;LINKSMUČIAI;1733251156;Ne;0;4;0;4
1166;Čiauškutis;KIŠKUČIAI;1900086424;Ne;0;5;0;5
1167;Čiauškutis;KIŠKUČIAI;3465024013;Ne;0;19;0;19
1168;Čiauškutis;KIŠKUČIAI;2271458332;Ne;0;1;0;1
1169;Čiauškutis;KIŠKUČIAI;9754417066;Ne;6;13;0;19
1170;Čiauškutis;KIŠKUČIAI;5589764935;Ne;12;0;5;17
1171;Čiauškutis;KIŠKUČIAI;3583094831;Ne;0;2;0;2
1172;Čiauškutis;KIŠKUČIAI;4169517353;Ne;0;1;3;4
1173;Čiauškutis;KIŠKUČIAI;9569969519;Ne;0;1;6;7
1174;Čiauškutis;KIŠKUČIAI;3126627913;Ne;9;4;0;13
1175;Čiauškutis;LAPIUKAI;6810906239;Ne;0;19;0;19
1176;Čiauškutis;LAPIUKAI;9460608737;Ne;4;0;7;11
1177;Čiauškutis;LAPIUKAI;9928767253;Ne;0;18;1;19
1178;Čiauškutis;LAPIUKAI;9702568740;Ne;5;11;3;19
1179;Čiauškutis;LAPIUKAI;5427045039;Ne;2;0;0;2
1180;Čiauškutis;LAPIUKAI;8737871477;Ne;9;9;1;19
1181;Čiauškutis;LAPIUKAI;5842585542;Ne;5;13;1;19
1182;Čiauškutis;LAPIUKAI;6940865564;Ne;5;12;2;19
1183;Čiauškutis;MEŠKUČIAI;2172687454;Ne;7;4;0;11
1184;Čiauškutis;MEŠKUČIAI;3660195990;Ne;9;0;0;9
1185;Čiauškutis;MEŠKUČIAI;6109859056;Ne;2;0;0;2
1186;Čiauškutis;MEŠKUČIAI;8910832777;Ne;0;0;2;2
1187;Čiauškutis;MEŠKUČIAI;4213259879;Ne;0;5;0;5
1188;Čiauškutis;MEŠKUČIAI;1515680948;Ne;2;0;1;3
1189;Čiauškutis;MEŠKUČIAI;6608678558;Ne;0;4;0;4
1190;Čiauškutis;MEŠKUČIAI;7714816675;Ne;0;4;5;9
1191;Čiauškutis;MEŠKUČIAI;9684750515;Ne;4;0;0;4
1192;Čiauškutis;PELĖDŽIUKAI;4971788697;Ne;0;2;1;3
1193;Čiauškutis;PELĖDŽIUKAI;9228568063;Ne;0;0;1;1
1194;Čiauškutis;PELĖDŽIUKAI;1561833758;Ne;4;1;1;6
1195;Čiauškutis;PELĖDŽIUKAI;7931998640;Ne;0;3;3;6
1196;Čiauškutis;PELĖDŽIUKAI;3700692073;Ne;4;0;0;4
1197;Čiauškutis;PELĖDŽIUKAI;6615319751;Ne;15;0;1;16
1198;Čiauškutis;PELĖDŽIUKAI;2377986721;Ne;5;0;0;5
1199;Čiauškutis;PELĖDŽIUKAI;5446546214;Taip;3;0;0;3
1200;Čiauškutis;PELĖDŽIUKAI;8111541739;Taip;0;0;2;2
1201;Čiauškutis;PELĖDŽIUKAI;3298272815;Ne;10;0;0;10
1202;Čiauškutis;NYKŠTUKAI;8948893335;Ne;1;4;0;5
1203;Čiauškutis;NYKŠTUKAI;2633243682;Ne;0;0;1;1
1204;Čiauškutis;NYKŠTUKAI;6705934636;Ne;2;4;0;6
1205;Čiauškutis;NYKŠTUKAI;2044220236;Ne;2;3;0;5
1206;Čiauškutis;NYKŠTUKAI;7335655769;Ne;0;4;2;6
1207;Čiauškutis;NYKŠTUKAI;5686690700;Ne;19;0;0;19
1208;Čiauškutis;NYKŠTUKAI;6051208732;Ne;0;4;0;4
1209;Čiauškutis;NYKŠTUKAI;8626682787;Ne;2;0;4;6
1210;Delfinukas;Boružėlių;5963440967;Ne;8;0;1;9
1211;Delfinukas;Boružėlių;5320485170;Ne;2;0;4;6
1212;Delfinukas;Boružėlių;6878446154;Ne;9;0;0;9
1213;Delfinukas;Boružėlių;1970318187;Ne;11;0;0;11
1214;Delfinukas;Boružėlių;7752786752;Ne;11;0;0;11
1215;Delfinukas;Boružėlių;2459046463;Ne;8;0;0;8
1216;Delfinukas;Boružėlių;6133972529;Ne;3;1;0;4
1217;Delfinukas;Boružėlių;2323767897;Ne;13;0;2;15
1218;Delfinukas;Boružėlių;2830904360;Ne;8;0;0;8
1219;Delfinukas;Boružėlių;9127076507;Ne;0;7;0;7
1220;Delfinukas;Boružėlių;3015726598;Taip;8;0;4;12
1221;Delfinukas;Boružėlių;1843845065;Ne;0;0;5;5
1222;Delfinukas;Boružėlių;8554498555;Ne;3;0;0;3
1223;Delfinukas;Boružėlių;2716595364;Ne;12;4;1;17
1224;Delfinukas;Boružėlių;2450560824;Ne;5;10;4;19
1225;Delfinukas;Saulytės;8315269427;Ne;3;0;0;3
1226;Delfinukas;Saulytės;4215887291;Taip;0;2;0;2
1227;Delfinukas;Saulytės;3631520143;Ne;4;4;0;8
1228;Delfinukas;Saulytės;9424966984;Taip;10;5;0;15
1229;Delfinukas;Saulytės;6069600728;Taip;5;0;0;5
1230;Delfinukas;Saulytės;9729550922;Taip;0;3;0;3
1231;Delfinukas;Saulytės;1404270345;Taip;8;1;0;9
1232;Delfinukas;Saulytės;3842160990;Taip;0;1;0;1
1233;Delfinukas;Saulytės;8402529296;Taip;0;5;0;5
1234;Delfinukas;Saulytės;5125346405;Taip;0;1;0;1
1235;Delfinukas;Saulytės;5642328792;Ne;5;5;0;10
1236;Delfinukas;Saulytės;8176576958;Taip;14;0;0;14
1237;Delfinukas;Saulytės;8275943176;Taip;5;2;0;7
1238;Delfinukas;Saulytės;8085530134;Taip;0;8;0;8
1239;Delfinukas;Saulytės;8148610460;Ne;0;8;0;8
1240;Delfinukas;Saulytės;8186312409;Taip;0;4;0;4
1241;Delfinukas;Saulytės;1873630966;Ne;0;5;0;5
1242;Delfinukas;Saulytės;1953356983;Taip;0;3;0;3
1243;Delfinukas;Pelėdžiukų;3940838205;Taip;2;2;0;4
1244;Delfinukas;Pelėdžiukų;8774145277;Taip;0;8;0;8
1245;Delfinukas;Pelėdžiukų;6113662246;Ne;17;0;0;17
1246;Delfinukas;Pelėdžiukų;4710894128;Taip;1;1;0;2
1247;Delfinukas;Pelėdžiukų;1526129772;Taip;8;0;0;8
1248;Delfinukas;Pelėdžiukų;8659309242;Ne;0;2;0;2
1249;Delfinukas;Pelėdžiukų;8267992425;Ne;0;5;0;5
1250;Delfinukas;Pelėdžiukų;9319874239;Taip;0;4;0;4
1251;Delfinukas;Pelėdžiukų;2809947323;Ne;3;0;0;3
1252;Delfinukas;Pelėdžiukų;4096274346;Taip;8;2;0;10
1253;Delfinukas;Pelėdžiukų;5246300518;Ne;7;0;0;7
1254;Delfinukas;Pelėdžiukų;2420308954;Ne;5;1;0;6
1255;Delfinukas;Pelėdžiukų;6286748047;Ne;0;12;0;12
1256;Delfinukas;Pelėdžiukų;4465504676;Taip;0;6;0;6
1257;Delfinukas;Pelėdžiukų;6282501549;Ne;11;4;0;15
1258;Delfinukas;Pelėdžiukų;6025384346;Ne;6;0;0;6
1259;Delfinukas;Varliukų;4949220786;Ne;4;5;1;10
1260;Delfinukas;Varliukų;2792051636;Taip;2;4;0;6
1261;Delfinukas;Varliukų;4780352568;Ne;4;0;0;4
1262;Delfinukas;Varliukų;3577180085;Taip;13;4;0;17
1263;Delfinukas;Varliukų;6115370195;Taip;4;0;0;4
1264;Delfinukas;Varliukų;3050258185;Ne;3;0;0;3
1265;Delfinukas;Varliukų;7976681530;Ne;3;0;0;3
1266;Delfinukas;Varliukų;4338259551;Ne;3;2;0;5
1267;Delfinukas;Varliukų;6301601832;Ne;0;4;0;4
1268;Delfinukas;Varliukų;5095713834;Ne;11;2;0;13
1269;Delfinukas;Varliukų;5964021733;Ne;9;2;0;11
1270;Delfinukas;Varliukų;5821591959;Ne;5;4;0;9
1271;Delfinukas;Varliukų;9095895182;Ne;0;0;1;1
1272;Delfinukas;Varliukų;5138840297;Ne;0;1;0;1
1273;Delfinukas;Varliukų;7072060541;Ne;1;3;0;4
1274;Delfinukas;Varliukų;3797355501;Ne;16;0;0;16
1275;Delfinukas;Varliukų;4254414928;Taip;7;2;1;10
1276;Delfinukas;Varliukų;7359531377;Ne;4;4;0;8
1277;Delfinukas;Varpelių;8913681176;Ne;0;3;0;3
1278;Delfinukas;Varpelių;9514189769;Ne;0;5;0;5
1279;Delfinukas;Varpelių;3818558339;Ne;5;1;0;6
1280;Delfinukas;Varpelių;1484123788;Ne;8;1;0;9
1281;Delfinukas;Varpelių;8950528288;Ne;3;0;0;3
1282;Delfinukas;Varpelių;8829835426;Ne;4;0;0;4
1283;Delfinukas;Varpelių;6938708939;Ne;0;4;0;4
1284;Delfinukas;Varpelių;9898427089;Ne;0;4;0;4
1285;Delfinukas;Varpelių;2730512600;Ne;1;8;0;9
1286;Delfinukas;Varpelių;8911433659;Ne;6;0;0;6
1287;Delfinukas;Varpelių;6952314149;Ne;7;1;0;8
1288;Delfinukas;Varpelių;5158297103;Ne;0;1;0;1
1289;Delfinukas;Varpelių;4101463768;Ne;5;1;0;6
1290;Delfinukas;Varpelių;5467211088;Ne;0;8;0;8
1291;Delfinukas;Varpelių;7780893730;Ne;3;1;0;4
1292;Delfinukas;Varpelių;6071660741;Ne;1;4;0;5
1293;Delfinukas;Drugeliai;7615519932;Ne;0;4;0;4
1294;Delfinukas;Drugeliai;6604115681;Ne;0;13;0;13
1295;Delfinukas;Drugeliai;5990192934;Ne;5;5;0;10
1296;Delfinukas;Drugeliai;9635669748;Ne;0;1;0;1
1297;Delfinukas;Drugeliai;8526813977;Ne;0;1;0;1
1298;Delfinukas;Drugeliai;6873181103;Ne;5;9;0;14
1299;Delfinukas;Drugeliai;4484804360;Ne;0;2;0;2
1300;Delfinukas;Drugeliai;8328481987;Ne;0;5;0;5
1301;Delfinukas;Drugeliai;6992505341;Ne;0;7;0;7
1302;Delfinukas;Drugeliai;6884260821;Ne;0;2;0;2
1303;Delfinukas;Drugeliai;2756574162;Ne;0;3;0;3
1304;Delfinukas;Drugeliai;2985669766;Ne;14;0;0;14
1305;Delfinukas;Drugeliai;7609115506;Ne;0;4;0;4
1306;Delfinukas;Drugeliai;6457042338;Ne;0;3;0;3
1307;Delfinukas;Drugeliai;3134897964;Ne;0;7;0;7
1308;Delfinukas;Drugeliai;8411289299;Ne;0;4;0;4
1309;Delfinukas;Drugeliai;2683746435;Ne;4;0;0;4
1310;Delfinukas;Drugeliai;6623617856;Ne;0;5;0;5
1311;Delfinukas;Žuvytės;4384995354;Ne;5;1;0;6
1312;Delfinukas;Žuvytės;1918878505;Ne;4;2;0;6
1313;Delfinukas;Žuvytės;1575125658;Taip;5;0;1;6
1314;Delfinukas;Žuvytės;7354837777;Ne;10;2;0;12
1315;Delfinukas;Žuvytės;8884939114;Ne;0;4;0;4
1316;Delfinukas;Žuvytės;1296440609;Ne;0;0;1;1
1317;Delfinukas;Žuvytės;5665463557;Ne;10;0;0;10
1318;Delfinukas;Žuvytės;5646198202;Ne;6;0;0;6
1319;Delfinukas;Žuvytės;9686085316;Ne;1;0;0;1
1320;Delfinukas;Žuvytės;7464957954;Ne;7;0;4;11
1321;Delfinukas;Žuvytės;5281161835;Ne;5;0;8;13
1322;Delfinukas;Žuvytės;2425621326;Ne;7;0;1;8
1323;Delfinukas;Žuvytės;4782384361;Ne;10;0;0;10
1324;Delfinukas;Žuvytės;6865463448;Ne;5;1;4;10
1325;Delfinukas;Žuvytės;9773069890;Ne;2;0;3;5
1326;Delfinukas;Žuvytės;5397241026;Ne;4;5;0;9
1327;Delfinukas;Delfinai;8038737019;Taip;0;3;0;3
1328;Delfinukas;Delfinai;5797308373;Taip;0;4;0;4
1329;Delfinukas;Delfinai;5241426445;Ne;0;5;0;5
1330;Delfinukas;Delfinai;8099120371;Taip;0;4;0;4
1331;Delfinukas;Delfinai;7663934825;Taip;0;2;0;2
1332;Delfinukas;Delfinai;2382077576;Ne;4;4;0;8
1333;Delfinukas;Delfinai;7629622746;Ne;0;4;0;4
1334;Delfinukas;Delfinai;1922513830;Taip;0;2;0;2
1335;Delfinukas;Delfinai;6270012707;Ne;0;6;0;6
1336;Delfinukas;Delfinai;8085481968;Ne;0;5;0;5
1337;Delfinukas;Delfinai;3407321091;Taip;2;1;0;3
1338;Delfinukas;Delfinai;8415516743;Ne;0;0;5;5
1339;Delfinukas;Delfinai;4855210424;Taip;0;1;5;6
1340;Delfinukas;Delfinai;3465399369;Ne;0;2;0;2
1341;Delfinukas;Delfinai;2890469172;Ne;0;0;10;10
1342;Delfinukas;Paukšteliai;7366145460;Ne;3;3;0;6
1343;Delfinukas;Paukšteliai;5278689745;Ne;7;2;0;9
1344;Delfinukas;Paukšteliai;6002086491;Ne;0;4;0;4
1345;Delfinukas;Paukšteliai;1164720538;Ne;0;7;0;7
1346;Delfinukas;Paukšteliai;9351906710;Ne;2;1;0;3
1347;Delfinukas;Paukšteliai;9629225917;Ne;0;2;0;2
1348;Delfinukas;Paukšteliai;9332794060;Ne;9;0;0;9
1349;Delfinukas;Paukšteliai;6650725760;Ne;19;0;0;19
1350;Delfinukas;Paukšteliai;9776618488;Ne;15;0;0;15
1351;Delfinukas;Paukšteliai;4561911078;Ne;14;0;0;14
1352;Delfinukas;Paukšteliai;9289866851;Ne;12;1;2;15
1353;Delfinukas;Paukšteliai;1746566943;Ne;11;3;0;14
1354;Delfinukas;Paukšteliai;2186801708;Ne;11;5;0;16
1355;Delfinukas;Paukšteliai;6055420223;Taip;0;0;1;1
1356;Delfinukas;Kiškučiai;5585334518;Ne;10;2;0;12
1357;Delfinukas;Kiškučiai;4196156707;Ne;1;0;0;1
1358;Delfinukas;Kiškučiai;5443027988;Ne;0;3;0;3
1359;Delfinukas;Kiškučiai;6301767635;Ne;0;10;0;10
1360;Delfinukas;Kiškučiai;4488260667;Ne;4;1;0;5
1361;Delfinukas;Kiškučiai;9184207705;Ne;0;6;0;6
1362;Delfinukas;Kiškučiai;2163238846;Ne;2;1;0;3
1363;Delfinukas;Kiškučiai;9747075687;Ne;0;2;0;2
1364;Delfinukas;Kiškučiai;4327924499;Ne;9;0;0;9
1365;Delfinukas;Kiškučiai;7312438969;Taip;2;8;0;10
1366;Delfinukas;Kiškučiai;4985159933;Ne;0;1;0;1
1367;Delfinukas;Kiškučiai;6693756145;Ne;3;2;0;5
1368;Delfinukas;Kiškučiai;3205671100;Ne;0;5;0;5
1369;Delfinukas;Kiškučiai;4755699845;Ne;7;2;0;9
1370;Delfinukas;Kiškučiai;5164599763;Taip;12;0;0;12
1371;Delfinukas;Kiškučiai;9586646352;Taip;7;0;0;7
1372;Delfinukas;Kiškučiai;3487670354;Ne;1;0;0;1
1373;Delfinukas;Kiškučiai;9073634575;Ne;16;0;0;16
1374;Delfinukas;BITUTĖS;9719348837;Taip;6;0;0;6
1375;Delfinukas;BITUTĖS;6601922746;Ne;3;4;0;7
1376;Delfinukas;BITUTĖS;8896957908;Taip;3;0;3;6
1377;Delfinukas;BITUTĖS;3239635507;Ne;4;0;2;6
1378;Delfinukas;BITUTĖS;5339993544;Taip;0;9;1;10
1379;Delfinukas;BITUTĖS;6929926768;Ne;8;0;0;8
1380;Delfinukas;BITUTĖS;5557399916;Ne;4;0;0;4
1381;Delfinukas;BITUTĖS;8937594052;Ne;0;3;1;4
1382;Delfinukas;BITUTĖS;5179080544;Taip;0;7;0;7
1383;Delfinukas;BITUTĖS;7727263761;Ne;6;0;0;6
1384;Delfinukas;BITUTĖS;9941631164;Ne;0;6;0;6
1385;Delfinukas;BITUTĖS;4198261848;Taip;2;4;0;6
1386;Delfinukas;BITUTĖS;8081895401;Ne;8;0;2;10
1387;Delfinukas;BITUTĖS;5600320855;Ne;0;8;0;8
1388;Delfinukas;BITUTĖS;9195828884;Ne;1;0;1;2
1389;Delfinukas;BITUTĖS;2377204734;Ne;0;9;0;9
1390;Delfinukas;BITUTĖS;6243471374;Ne;5;5;0;10
1391;Delfinukas;BITUTĖS;4303234827;Ne;0;4;0;4
1392;Delfinukas;BITUTĖS;6325092903;Ne;1;4;0;5
1393;Drevinukas;ZUIKUČIAI;5500759834;Ne;2;0;0;2
1394;Drevinukas;ZUIKUČIAI;9817317105;Ne;7;0;0;7
1395;Drevinukas;ZUIKUČIAI;1595081335;Ne;12;0;0;12
1396;Drevinukas;ZUIKUČIAI;2772424629;Ne;5;5;0;10
1397;Drevinukas;ZUIKUČIAI;5928234487;Ne;1;4;0;5
1398;Drevinukas;ZUIKUČIAI;8873060121;Ne;2;2;0;4
1399;Drevinukas;ZUIKUČIAI;1567790084;Ne;0;3;0;3
1400;Drevinukas;ZUIKUČIAI;3293457412;Ne;2;5;0;7
1401;Drevinukas;ZUIKUČIAI;6243097297;Ne;15;4;0;19
1402;Drevinukas;ZUIKUČIAI;5704489483;Ne;8;1;0;9
1403;Drevinukas;ZUIKUČIAI;7054681115;Ne;3;3;0;6
1404;Drevinukas;ZUIKUČIAI;5887233286;Ne;1;6;0;7
1405;Drevinukas;ZUIKUČIAI;3381363132;Ne;15;4;0;19
1406;Drevinukas;ZUIKUČIAI;9174977150;Ne;0;4;0;4
1407;Drevinukas;ZUIKUČIAI;4243045398;Ne;19;0;0;19
1408;Drevinukas;ZUIKUČIAI;4309475233;Ne;19;0;0;19
1409;Drevinukas;ZUIKUČIAI;6393960467;Ne;6;1;0;7
1410;Drevinukas;ZUIKUČIAI;5578749226;Ne;9;1;0;10
1411;Drevinukas;AŽUOLIUKŲ;1644656704;Ne;8;4;0;12
1412;Drevinukas;AŽUOLIUKŲ;5721031754;Ne;10;0;0;10
1413;Drevinukas;AŽUOLIUKŲ;4714478955;Ne;5;4;0;9
1414;Drevinukas;AŽUOLIUKŲ;8701250912;Ne;6;0;0;6
1415;Drevinukas;AŽUOLIUKŲ;8143614891;Ne;0;5;0;5
1416;Drevinukas;AŽUOLIUKŲ;5673244101;Ne;0;4;0;4
1417;Drevinukas;AŽUOLIUKŲ;3643007998;Ne;4;0;0;4
1418;Drevinukas;AŽUOLIUKŲ;4262951360;Ne;14;0;0;14
1419;Drevinukas;AŽUOLIUKŲ;7689145214;Ne;0;3;0;3
1420;Drevinukas;AŽUOLIUKŲ;4572837478;Ne;8;4;0;12
1421;Drevinukas;AŽUOLIUKŲ;1564065835;Ne;11;0;0;11
1422;Drevinukas;AŽUOLIUKŲ;9289471118;Ne;1;0;0;1
1423;Drevinukas;AŽUOLIUKŲ;9915130747;Ne;5;5;0;10
1424;Drevinukas;AŽUOLIUKŲ;6891793135;Ne;12;0;0;12
1425;Drevinukas;AŽUOLIUKŲ;1058927778;Ne;0;4;0;4
1426;Drevinukas;AŽUOLIUKŲ;9534007163;Ne;10;0;0;10
1427;Drevinukas;AŽUOLIUKŲ;2300338724;Ne;3;0;0;3
1428;Drevinukas;AŽUOLIUKŲ;3725760478;Ne;4;3;0;7
1429;Drevinukas;AŽUOLIUKŲ;5436821826;Ne;4;0;0;4
1430;Drevinukas;AŽUOLIUKŲ;6165662595;Ne;8;1;0;9
1431;Drevinukas;AŽUOLIUKŲ;2740093399;Ne;0;8;0;8
1432;Drevinukas;PELĖDŽIUKAI;3032536983;Ne;0;4;0;4
1433;Drevinukas;PELĖDŽIUKAI;3392249574;Ne;4;4;0;8
1434;Drevinukas;PELĖDŽIUKAI;5524567803;Ne;5;4;0;9
1435;Drevinukas;PELĖDŽIUKAI;9016985238;Ne;2;4;0;6
1436;Drevinukas;PELĖDŽIUKAI;2929598743;Ne;0;1;0;1
1437;Drevinukas;PELĖDŽIUKAI;4076576850;Ne;4;4;0;8
1438;Drevinukas;PELĖDŽIUKAI;6373230526;Ne;0;5;0;5
1439;Drevinukas;PELĖDŽIUKAI;7642022439;Ne;1;4;0;5
1440;Drevinukas;PELĖDŽIUKAI;6316000019;Ne;0;2;0;2
1441;Drevinukas;PELĖDŽIUKAI;4404254932;Ne;5;4;0;9
1442;Drevinukas;PELĖDŽIUKAI;2378493422;Ne;5;4;0;9
1443;Drevinukas;PELĖDŽIUKAI;1859208322;Ne;4;4;0;8
1444;Drevinukas;PELĖDŽIUKAI;8984653958;Ne;0;9;0;9
1445;Drevinukas;PELĖDŽIUKAI;5620887702;Ne;2;4;0;6
1446;Drevinukas;PELĖDŽIUKAI;2281463885;Ne;0;3;0;3
1447;Drevinukas;PELĖDŽIUKAI;5875459639;Ne;5;3;0;8
1448;Drevinukas;PELĖDŽIUKAI;6582186497;Ne;9;1;0;10
1449;Drevinukas;PELĖDŽIUKAI;7218201733;Ne;2;3;0;5
1450;Drevinukas;BORUŽĖLĖS;4242944055;Ne;3;3;0;6
1451;Drevinukas;BORUŽĖLĖS;6492987985;Ne;2;0;0;2
1452;Drevinukas;BORUŽĖLĖS;6645506336;Ne;7;4;0;11
1453;Drevinukas;BORUŽĖLĖS;9845207619;Ne;4;0;0;4
1454;Drevinukas;BORUŽĖLĖS;9517560132;Ne;1;4;0;5
1455;Drevinukas;BORUŽĖLĖS;6895472558;Ne;8;4;0;12
1456;Drevinukas;BORUŽĖLĖS;2039086829;Ne;0;2;0;2
1457;Drevinukas;BORUŽĖLĖS;4147987057;Ne;0;9;0;9
1458;Drevinukas;BORUŽĖLĖS;6680003214;Ne;3;0;0;3
1459;Drevinukas;BORUŽĖLĖS;9695419813;Ne;0;5;0;5
1460;Drevinukas;BORUŽĖLĖS;8694887879;Ne;0;4;0;4
1461;Drevinukas;BORUŽĖLĖS;3192583690;Ne;5;1;0;6
1462;Drevinukas;BORUŽĖLĖS;6659263391;Ne;5;1;0;6
1463;Drevinukas;BORUŽĖLĖS;8719022482;Ne;5;4;0;9
1464;Drevinukas;BORUŽĖLĖS;5860361695;Ne;2;4;0;6
1465;Drevinukas;BORUŽĖLĖS;5999370094;Ne;2;3;0;5
1466;Drevinukas;BORUŽĖLĖS;4588368596;Ne;13;0;0;13
1467;Drevinukas;BORUŽĖLĖS;2571295179;Ne;4;4;0;8
1468;Drevinukas;BORUŽĖLĖS;2820241608;Ne;1;4;0;5
1469;Drevinukas;BORUŽĖLĖS;8940838262;Ne;1;5;0;6
1470;Drevinukas;BORUŽĖLĖS;3240313747;Ne;2;4;0;6
1471;Drevinukas;BORUŽĖLĖS;2179736991;Ne;6;4;0;10
1472;Drevinukas;BITUTĖS;5348609358;Ne;0;4;0;4
1473;Drevinukas;BITUTĖS;1098647410;Ne;0;3;0;3
1474;Drevinukas;BITUTĖS;2312241894;Ne;5;3;0;8
1475;Drevinukas;BITUTĖS;5394143000;Ne;0;4;0;4
1476;Drevinukas;BITUTĖS;3871506691;Ne;5;4;0;9
1477;Drevinukas;BITUTĖS;6914111231;Ne;5;4;0;9
1478;Drevinukas;BITUTĖS;3377957769;Ne;0;1;0;1
1479;Drevinukas;BITUTĖS;2423143170;Ne;4;0;0;4
1480;Drevinukas;BITUTĖS;1343431478;Ne;1;3;0;4
1481;Drevinukas;BITUTĖS;1829421385;Ne;0;4;0;4
1482;Drevinukas;BITUTĖS;8262224710;Ne;1;3;0;4
1483;Drevinukas;BITUTĖS;4203106313;Ne;11;0;0;11
1484;Drevinukas;BITUTĖS;8385750920;Ne;0;2;0;2
1485;Drevinukas;BITUTĖS;9513405583;Ne;4;4;0;8
1486;Drevinukas;BITUTĖS;5959004452;Ne;1;0;0;1
1487;Drevinukas;BITUTĖS;8896207423;Ne;0;3;0;3
1488;Drevinukas;BITUTĖS;3046196006;Ne;1;1;0;2
1489;Drevinukas;BITUTĖS;4662426451;Ne;0;4;0;4
1490;Drevinukas;BITUTĖS;5236292764;Ne;0;2;0;2
1491;Drevinukas;BITUTĖS;3617533357;Ne;15;4;0;19
1492;Drevinukas;NYKŠTUKAI;9105675010;Ne;4;0;0;4
1493;Drevinukas;NYKŠTUKAI;8578579808;Ne;7;0;0;7
1494;Drevinukas;NYKŠTUKAI;3611870655;Ne;3;0;0;3
1495;Drevinukas;NYKŠTUKAI;1094428951;Ne;2;0;0;2
1496;Drevinukas;NYKŠTUKAI;9283862598;Ne;7;1;0;8
1497;Drevinukas;NYKŠTUKAI;2201342382;Ne;16;0;0;16
1498;Drevinukas;NYKŠTUKAI;4759293403;Ne;5;0;0;5
1499;Drevinukas;NYKŠTUKAI;9004568476;Ne;2;0;0;2
1500;Drevinukas;NYKŠTUKAI;9715586195;Ne;3;0;0;3
1501;Drevinukas;NYKŠTUKAI;1368495173;Ne;3;4;0;7
1502;Drevinukas;NYKŠTUKAI;8284025903;Ne;3;2;0;5
1503;Drevinukas;NYKŠTUKAI;8654858364;Ne;12;0;0;12
1504;Drevinukas;NYKŠTUKAI;5445104383;Ne;3;0;0;3
1505;Drevinukas;NYKŠTUKAI;2662147175;Ne;13;0;0;13
1506;Drevinukas;NYKŠTUKAI;7801920518;Ne;19;0;0;19
1507;Drevinukas;NYKŠTUKAI;1570356979;Ne;6;0;0;6
1508;Drevinukas;NYKŠTUKAI;9123131368;Ne;5;0;0;5
1509;Drevinukas;NYKŠTUKAI;8877080179;Ne;6;0;0;6
1510;Drevinukas;NYKŠTUKAI;6492711565;Ne;5;0;0;5
1511;Drevinukas;NYKŠTUKAI;7316996793;Ne;0;3;0;3
1512;Drevinukas;NYKŠTUKAI;3408981880;Ne;1;1;0;2
1513;Drevinukas;NYKŠTUKAI;8953871512;Ne;11;0;0;11
1514;Drevinukas;NYKŠTUKAI;3983656958;Ne;3;1;0;4
1515;Drevinukas;SMALSUČIAI;7241671439;Ne;5;4;0;9
1516;Drevinukas;SMALSUČIAI;2246885419;Ne;0;4;0;4
1517;Drevinukas;SMALSUČIAI;4089351543;Ne;3;1;0;4
1518;Drevinukas;SMALSUČIAI;7863529560;Ne;1;0;0;1
1519;Drevinukas;SMALSUČIAI;8107900397;Ne;0;6;0;6
1520;Drevinukas;SMALSUČIAI;1757626792;Ne;6;0;0;6
1521;Drevinukas;SMALSUČIAI;5666172450;Ne;7;0;0;7
1522;Drevinukas;SMALSUČIAI;8704592094;Ne;5;0;0;5
1523;Drevinukas;SMALSUČIAI;1478224813;Ne;3;4;0;7
1524;Drevinukas;SMALSUČIAI;9707576704;Ne;6;3;0;9
1525;Drevinukas;SMALSUČIAI;2971775004;Ne;3;0;0;3
1526;Drevinukas;SMALSUČIAI;7466516412;Ne;2;0;0;2
1527;Drevinukas;SMALSUČIAI;2888797405;Ne;5;0;0;5
1528;Drevinukas;SMALSUČIAI;5614413092;Ne;3;0;0;3
1529;Drevinukas;SMALSUČIAI;4372760590;Ne;6;3;0;9
1530;Drevinukas;SMALSUČIAI;1934875187;Ne;1;0;0;1
1531;Drevinukas;ŽVIRBLIUKAI;2274377462;Ne;2;0;0;2
1532;Drevinukas;ŽVIRBLIUKAI;5702650036;Ne;6;0;0;6
1533;Drevinukas;ŽVIRBLIUKAI;5928679046;Ne;11;0;0;11
1534;Drevinukas;ŽVIRBLIUKAI;5785185025;Ne;14;0;0;14
1535;Drevinukas;ŽVIRBLIUKAI;8482376948;Ne;15;0;0;15
1536;Drevinukas;ŽVIRBLIUKAI;5640493477;Ne;10;0;0;10
1537;Drevinukas;ŽVIRBLIUKAI;7970286765;Ne;12;0;0;12
1538;Drevinukas;ŽVIRBLIUKAI;3598394850;Ne;12;0;0;12
1539;Drevinukas;ŽVIRBLIUKAI;2968317659;Ne;5;4;0;9
1540;Drevinukas;ŽVIRBLIUKAI;9583532096;Ne;8;0;0;8
1541;Drevinukas;ŽVIRBLIUKAI;6858049220;Ne;14;0;0;14
1542;Drevinukas;ŽVIRBLIUKAI;7639360777;Ne;16;0;0;16
1543;Drevinukas;ŽVIRBLIUKAI;5536448847;Ne;0;19;0;19
1544;Drevinukas;ŽVIRBLIUKAI;1471647820;Ne;14;0;0;14
1545;Drevinukas;ŽVIRBLIUKAI;7600838895;Ne;12;0;0;12
1546;Drevinukas;ŽVIRBLIUKAI;3049662927;Ne;8;0;0;8
1547;Drevinukas;ŽVIRBLIUKAI;4371848878;Ne;10;0;0;10
1548;Drugelis;NYKŠTUKŲ;9316073597;Ne;0;6;0;6
1549;Drugelis;NYKŠTUKŲ;3551095669;Ne;0;6;1;7
1550;Drugelis;NYKŠTUKŲ;1785724340;Ne;3;6;0;9
1551;Drugelis;NYKŠTUKŲ;7447519502;Ne;0;5;0;5
1552;Drugelis;NYKŠTUKŲ;4523513611;Ne;0;4;0;4
1553;Drugelis;NYKŠTUKŲ;6594452094;Ne;5;4;0;9
1554;Drugelis;NYKŠTUKŲ;5122256823;Ne;0;5;0;5
1555;Drugelis;NYKŠTUKŲ;4825232236;Ne;0;4;0;4
1556;Drugelis;NYKŠTUKŲ;7477547789;Ne;4;3;0;7
1557;Drugelis;NYKŠTUKŲ;8717445483;Ne;5;6;0;11
1558;Drugelis;NYKŠTUKŲ;4471405682;Ne;0;3;0;3
1559;Drugelis;NYKŠTUKŲ;4867387611;Ne;0;8;0;8
1560;Drugelis;NYKŠTUKŲ;7609530453;Ne;0;4;0;4
1561;Drugelis;NYKŠTUKŲ;4927896706;Ne;0;2;0;2
1562;Drugelis;NYKŠTUKŲ;5692743298;Ne;0;5;0;5
1563;Drugelis;NYKŠTUKŲ;6452921695;Ne;0;6;1;7
1564;Drugelis;NYKŠTUKŲ;5902687211;Ne;4;4;0;8
1565;Drugelis;NYKŠTUKŲ;8591548746;Ne;3;6;0;9
1566;Drugelis;NYKŠTUKŲ;5515894973;Ne;5;4;0;9
1567;Drugelis;SMALSUČIŲ;5121351234;Ne;15;4;0;19
1568;Drugelis;SMALSUČIŲ;6626437352;Ne;0;1;0;1
1569;Drugelis;SMALSUČIŲ;5000965458;Ne;5;7;0;12
1570;Drugelis;SMALSUČIŲ;9683350741;Ne;0;11;0;11
1571;Drugelis;SMALSUČIŲ;1617833459;Ne;6;0;0;6
1572;Drugelis;SMALSUČIŲ;4058293462;Ne;3;0;0;3
1573;Drugelis;SMALSUČIŲ;6533325098;Ne;0;5;0;5
1574;Drugelis;SMALSUČIŲ;4805858183;Ne;0;6;0;6
1575;Drugelis;SMALSUČIŲ;9650052415;Ne;0;3;2;5
1576;Drugelis;SMALSUČIŲ;5533529267;Ne;0;7;0;7
1577;Drugelis;SMALSUČIŲ;3733097479;Ne;5;5;0;10
1578;Drugelis;SMALSUČIŲ;9066572677;Ne;2;0;0;2
1579;Drugelis;SMALSUČIŲ;2196445523;Ne;0;4;0;4
1580;Drugelis;SMALSUČIŲ;3645668411;Ne;0;4;0;4
1581;Drugelis;SMALSUČIŲ;3261462674;Ne;0;4;0;4
1582;Drugelis;SMALSUČIŲ;8186338261;Ne;0;1;2;3
1583;Drugelis;SMALSUČIŲ;2644563881;Ne;0;2;2;4
1584;Drugelis;SMALSUČIŲ;6613520046;Ne;0;4;0;4
1585;Drugelis;SMALSUČIŲ;6890441262;Ne;0;6;0;6
1586;Drugelis;SMALSUČIŲ;3509593041;Ne;0;2;0;2
1587;Drugelis;SMALSUČIŲ;1417298801;Ne;5;0;3;8
1588;Drugelis;SMALSUČIŲ;1074913909;Ne;1;1;0;2
1589;Drugelis;MUMINUKŲ;7390061272;Ne;8;3;0;11
1590;Drugelis;MUMINUKŲ;3311620018;Ne;0;5;0;5
1591;Drugelis;MUMINUKŲ;8812550811;Ne;2;5;0;7
1592;Drugelis;MUMINUKŲ;5661335344;Ne;5;4;0;9
1593;Drugelis;MUMINUKŲ;6038184222;Ne;0;2;0;2
1594;Drugelis;MUMINUKŲ;9851124145;Ne;7;3;0;10
1595;Drugelis;MUMINUKŲ;7253876812;Ne;3;4;0;7
1596;Drugelis;MUMINUKŲ;1816845006;Ne;0;4;0;4
1597;Drugelis;MUMINUKŲ;1666992752;Ne;9;1;1;11
1598;Drugelis;MUMINUKŲ;9510744779;Ne;0;4;0;4
1599;Drugelis;MUMINUKŲ;9029137302;Ne;0;3;1;4
1600;Drugelis;MUMINUKŲ;9907121223;Ne;0;8;0;8
1601;Drugelis;MUMINUKŲ;8500348389;Ne;0;6;0;6
1602;Drugelis;MUMINUKŲ;1858504360;Ne;0;4;0;4
1603;Drugelis;MUMINUKŲ;8366330478;Ne;0;7;0;7
1604;Drugelis;MUMINUKŲ;8107970910;Ne;0;18;0;18
1605;Drugelis;MUMINUKŲ;8282807535;Ne;3;2;1;6
1606;Drugelis;MUMINUKŲ;3293212749;Ne;0;4;0;4
1607;Drugelis;MUMINUKŲ;2256221485;Ne;2;5;0;7
1608;Drugelis;MUMINUKŲ;9588931333;Ne;5;6;1;12
1609;Drugelis;MUMINUKŲ;3176174057;Taip;0;4;0;4
1610;Drugelis;MUMINUKŲ;1761596625;Ne;0;5;0;5
1611;Drugelis;MUMINUKŲ;6390802189;Ne;2;4;0;6
1612;Drugelis;PŪKUOTUKAI;3560294703;Ne;5;3;0;8
1613;Drugelis;PŪKUOTUKAI;1215586620;Ne;0;4;0;4
1614;Drugelis;PŪKUOTUKAI;9005448398;Ne;0;4;0;4
1615;Drugelis;PŪKUOTUKAI;2926662708;Ne;0;4;0;4
1616;Drugelis;PŪKUOTUKAI;6504082488;Ne;0;4;0;4
1617;Drugelis;PŪKUOTUKAI;7321544601;Ne;5;4;0;9
1618;Drugelis;PŪKUOTUKAI;9296067137;Ne;5;9;0;14
1619;Drugelis;PŪKUOTUKAI;9855121078;Ne;0;5;0;5
1620;Drugelis;PŪKUOTUKAI;6068102133;Ne;5;4;0;9
1621;Drugelis;PŪKUOTUKAI;7825151440;Ne;0;4;0;4
1622;Drugelis;PŪKUOTUKAI;4812322553;Ne;5;4;0;9
1623;Drugelis;PŪKUOTUKAI;3081918342;Ne;0;4;0;4
1624;Drugelis;PŪKUOTUKAI;6032568621;Ne;0;4;0;4
1625;Drugelis;PŪKUOTUKAI;4580456500;Ne;15;0;0;15
1626;Drugelis;PŪKUOTUKAI;8259051898;Ne;0;6;2;8
1627;Drugelis;PŪKUOTUKAI;2573357635;Ne;10;1;0;11
1628;Drugelis;PŪKUOTUKAI;3567930528;Ne;0;4;0;4
1629;Drugelis;PŪKUOTUKAI;1808917187;Ne;0;5;0;5
1630;Drugelis;PŪKUOTUKAI;5995208093;Ne;14;1;0;15
1631;Drugelis;PŪKUOTUKAI;6965297550;Ne;0;5;0;5
1632;Drugelis;PŪKUOTUKAI;3800496237;Ne;8;2;0;10
1633;Drugelis;PŪKUOTUKAI;5557284298;Taip;0;4;2;6
1634;Drugelis;PŪKUOTUKAI;8438128438;Ne;0;4;0;4
1635;Drugelis;SPINDULIUKAI;7775085427;Ne;12;4;0;16
1636;Drugelis;SPINDULIUKAI;5129433046;Taip;14;0;0;14
1637;Drugelis;SPINDULIUKAI;2456724368;Ne;2;0;2;4
1638;Drugelis;SPINDULIUKAI;5538435916;Ne;5;0;3;8
1639;Drugelis;SPINDULIUKAI;3473680112;Ne;5;4;0;9
1640;Drugelis;SPINDULIUKAI;4361777186;Ne;17;0;0;17
1641;Drugelis;SPINDULIUKAI;2105023760;Ne;10;0;0;10
1642;Drugelis;SPINDULIUKAI;9226673535;Ne;14;0;0;14
1643;Drugelis;SPINDULIUKAI;5082783072;Ne;8;0;4;12
1644;Drugelis;SPINDULIUKAI;5773336517;Ne;15;4;0;19
1645;Drugelis;SPINDULIUKAI;7160648094;Ne;8;6;0;14
1646;Drugelis;SPINDULIUKAI;5276647563;Ne;6;0;0;6
1647;Drugelis;SPINDULIUKAI;3883341684;Ne;0;8;11;19
1648;Drugelis;SPINDULIUKAI;5970909950;Ne;17;1;0;18
1649;Drugelis;SPINDULIUKAI;1084815681;Ne;5;3;0;8
1650;Drugelis;SPINDULIUKAI;9908380623;Ne;17;0;0;17
1651;Drugelis;SPINDULIUKAI;4347439776;Ne;18;1;0;19
1652;Drugelis;SPINDULIUKAI;4061717129;Ne;15;0;0;15
1653;Drugelis;KIŠKUČIAI;3603051567;Ne;5;0;0;5
1654;Drugelis;KIŠKUČIAI;4628926113;Ne;4;8;0;12
1655;Drugelis;KIŠKUČIAI;7307032077;Ne;0;5;0;5
1656;Drugelis;KIŠKUČIAI;1213610973;Taip;15;0;0;15
1657;Drugelis;KIŠKUČIAI;9211760307;Ne;0;0;6;6
1658;Drugelis;KIŠKUČIAI;6071997970;Taip;1;9;0;10
1659;Drugelis;KIŠKUČIAI;8819853863;Ne;9;0;0;9
1660;Drugelis;KIŠKUČIAI;5950704328;Ne;0;4;0;4
1661;Drugelis;KIŠKUČIAI;9900296726;Ne;8;0;0;8
1662;Drugelis;KIŠKUČIAI;4898099506;Ne;0;2;0;2
1663;Drugelis;KIŠKUČIAI;6997707085;Ne;2;2;0;4
1664;Drugelis;KIŠKUČIAI;5857726963;Ne;3;4;0;7
1665;Drugelis;KIŠKUČIAI;1817932444;Ne;14;0;0;14
1666;Drugelis;KIŠKUČIAI;8891228382;Ne;3;0;0;3
1667;Drugelis;KIŠKUČIAI;2729246397;Ne;19;0;0;19
1668;"Du gaideliai";Uodelių;5189121339;Ne;6;2;2;10
1669;"Du gaideliai";Uodelių;8624394105;Ne;5;6;0;11
1670;"Du gaideliai";Uodelių;9506572113;Ne;5;8;0;13
1671;"Du gaideliai";Uodelių;6224116229;Ne;3;0;4;7
1672;"Du gaideliai";Uodelių;5514521078;Ne;0;6;0;6
1673;"Du gaideliai";Uodelių;6630053388;Ne;11;0;0;11
1674;"Du gaideliai";Uodelių;3654057453;Ne;1;5;0;6
1675;"Du gaideliai";Uodelių;8921985681;Ne;0;18;0;18
1676;"Du gaideliai";Uodelių;5225949099;Ne;0;2;0;2
1677;"Du gaideliai";Uodelių;2122841302;Ne;11;0;0;11
1678;"Du gaideliai";Uodelių;3206388799;Taip;5;0;4;9
1679;"Du gaideliai";Uodelių;2084660815;Ne;0;3;0;3
1680;"Du gaideliai";Uodelių;7153424410;Ne;0;1;0;1
1681;"Du gaideliai";Uodelių;4799107717;Ne;5;4;0;9
1682;"Du gaideliai";Uodelių;5113352673;Ne;14;0;0;14
1683;"Du gaideliai";Uodelių;6054058539;Taip;0;6;0;6
1684;"Du gaideliai";Uodelių;9832883242;Ne;18;0;0;18
1685;"Du gaideliai";Uodelių;5016914497;Ne;0;0;6;6
1686;"Du gaideliai";Uodelių;4759244471;Ne;1;0;2;3
1687;"Du gaideliai";OŽIUKŲ;6942798420;Ne;0;8;0;8
1688;"Du gaideliai";OŽIUKŲ;8174023197;Ne;5;2;0;7
1689;"Du gaideliai";OŽIUKŲ;8420400705;Ne;0;9;0;9
1690;"Du gaideliai";OŽIUKŲ;7372149799;Ne;0;5;0;5
1691;"Du gaideliai";OŽIUKŲ;4157021754;Ne;0;8;0;8
1692;"Du gaideliai";OŽIUKŲ;1968978650;Ne;0;4;1;5
1693;"Du gaideliai";OŽIUKŲ;5291934919;Ne;0;9;0;9
1694;"Du gaideliai";OŽIUKŲ;2564259600;Ne;2;0;0;2
1695;"Du gaideliai";OŽIUKŲ;6132405512;Ne;0;13;0;13
1696;"Du gaideliai";OŽIUKŲ;7563789811;Ne;1;3;0;4
1697;"Du gaideliai";OŽIUKŲ;6704167983;Ne;0;2;0;2
1698;"Du gaideliai";OŽIUKŲ;9126780620;Ne;0;5;0;5
1699;"Du gaideliai";OŽIUKŲ;9374869616;Ne;0;3;0;3
1700;"Du gaideliai";OŽIUKŲ;5726096980;Ne;0;4;0;4
1701;"Du gaideliai";OŽIUKŲ;4408537397;Ne;0;12;0;12
1702;"Du gaideliai";OŽIUKŲ;1527839162;Ne;0;7;0;7
1703;"Du gaideliai";OŽIUKŲ;8896316882;Ne;0;1;1;2
1704;"Du gaideliai";OŽIUKŲ;5809089345;Ne;2;1;0;3
1705;"Du gaideliai";OŽIUKŲ;5867716168;Ne;14;0;0;14
1706;"Du gaideliai";OŽIUKŲ;1882241729;Taip;0;2;0;2
1707;"Du gaideliai";OŽIUKŲ;2616106413;Ne;2;2;0;4
1708;"Du gaideliai";OŽIUKŲ;9934568135;Ne;0;14;0;14
1709;"Du gaideliai";Vištyčių;2100449108;Ne;2;0;4;6
1710;"Du gaideliai";Vištyčių;7033276798;Ne;1;4;1;6
1711;"Du gaideliai";Vištyčių;7575534590;Ne;9;0;0;9
1712;"Du gaideliai";Vištyčių;8744467866;Ne;8;0;0;8
1713;"Du gaideliai";Vištyčių;3019797369;Ne;19;0;0;19
1714;"Du gaideliai";Vištyčių;9356275460;Taip;12;0;0;12
1715;"Du gaideliai";Vištyčių;6204233540;Ne;3;4;0;7
1716;"Du gaideliai";Vištyčių;2845145754;Ne;0;10;0;10
1717;"Du gaideliai";Vištyčių;7726490359;Ne;13;3;0;16
1718;"Du gaideliai";Vištyčių;5788923258;Ne;3;10;0;13
1719;"Du gaideliai";Vištyčių;6762171696;Ne;0;4;0;4
1720;"Du gaideliai";Vištyčių;6053941133;Ne;0;3;0;3
1721;"Du gaideliai";Vištyčių;5728374219;Ne;11;0;0;11
1722;"Du gaideliai";Vištyčių;5611102395;Ne;0;13;0;13
1723;"Du gaideliai";Vištyčių;8410547195;Ne;0;12;0;12
1724;"Du gaideliai";Vištyčių;6120647567;Ne;0;10;0;10
1725;"Du gaideliai";Vištyčių;2905083899;Taip;12;0;0;12
1726;"Du gaideliai";Vištyčių;9585785202;Ne;19;0;0;19
1727;"Du gaideliai";Vištyčių;2151825222;Ne;0;5;0;5
1728;"Du gaideliai";Vištyčių;8043896286;Ne;0;3;0;3
1729;"Du gaideliai";GAIDŽIUKŲ;2635903222;Ne;5;4;0;9
1730;"Du gaideliai";GAIDŽIUKŲ;6669130831;Ne;0;3;0;3
1731;"Du gaideliai";GAIDŽIUKŲ;7537924142;Ne;15;4;0;19
1732;"Du gaideliai";GAIDŽIUKŲ;2240947701;Ne;5;4;0;9
1733;"Du gaideliai";GAIDŽIUKŲ;3507387826;Ne;0;5;0;5
1734;"Du gaideliai";GAIDŽIUKŲ;4144269068;Ne;11;4;0;15
1735;"Du gaideliai";GAIDŽIUKŲ;1785976627;Ne;2;2;0;4
1736;"Du gaideliai";GAIDŽIUKŲ;8047413507;Ne;4;5;0;9
1737;"Du gaideliai";GAIDŽIUKŲ;9568647033;Ne;0;4;0;4
1738;"Du gaideliai";GAIDŽIUKŲ;5894974508;Ne;9;4;0;13
1739;"Du gaideliai";GAIDŽIUKŲ;6247706405;Ne;3;3;1;7
1740;"Du gaideliai";GAIDŽIUKŲ;1135098595;Ne;2;1;0;3
1741;"Du gaideliai";GAIDŽIUKŲ;3370029981;Ne;0;4;0;4
1742;"Du gaideliai";GAIDŽIUKŲ;1751328192;Ne;0;2;0;2
1743;"Du gaideliai";GAIDŽIUKŲ;5652662610;Ne;5;2;0;7
1744;"Du gaideliai";GAIDŽIUKŲ;6870356241;Ne;3;5;0;8
1745;"Du gaideliai";GAIDŽIUKŲ;5103483956;Ne;0;4;0;4
1746;"Du gaideliai";GAIDŽIUKŲ;6348951959;Ne;1;0;0;1
1747;"Du gaideliai";GAIDŽIUKŲ;1268479215;Ne;6;2;0;8
1748;"Du gaideliai";GAIDŽIUKŲ;3854355215;Ne;7;3;0;10
1749;"Du gaideliai";GAIDŽIUKŲ;3849899284;Ne;3;4;0;7
1750;"Du gaideliai";Musyčių;8819197022;Ne;0;4;0;4
1751;"Du gaideliai";Musyčių;6826558709;Ne;6;5;0;11
1752;"Du gaideliai";Musyčių;3058039700;Ne;6;0;2;8
1753;"Du gaideliai";Musyčių;7556954721;Ne;1;1;1;3
1754;"Du gaideliai";Musyčių;3601150560;Ne;0;5;0;5
1755;"Du gaideliai";Musyčių;3519099395;Ne;0;8;0;8
1756;"Du gaideliai";Musyčių;9561040908;Ne;6;1;0;7
1757;"Du gaideliai";Musyčių;9477645505;Ne;0;4;0;4
1758;"Du gaideliai";Musyčių;9619723983;Ne;0;3;0;3
1759;"Du gaideliai";Musyčių;5060904810;Ne;0;1;0;1
1760;"Du gaideliai";Musyčių;2266999698;Ne;0;1;0;1
1761;"Du gaideliai";Musyčių;1048130675;Taip;0;13;0;13
1762;"Du gaideliai";MALŪNO;9330406774;Ne;0;5;1;6
1763;"Du gaideliai";MALŪNO;4995471264;Ne;12;0;0;12
1764;"Du gaideliai";MALŪNO;2135080469;Ne;6;0;0;6
1765;"Du gaideliai";MALŪNO;9289309829;Ne;14;0;0;14
1766;"Du gaideliai";MALŪNO;1025181286;Ne;2;3;0;5
1767;"Du gaideliai";MALŪNO;8427621976;Ne;16;0;0;16
1768;"Du gaideliai";MALŪNO;5028947424;Ne;9;0;2;11
1769;"Du gaideliai";MALŪNO;2613120460;Ne;0;6;0;6
1770;"Du gaideliai";MALŪNO;3469559577;Ne;13;0;0;13
1771;"Du gaideliai";MALŪNO;8197231934;Ne;4;0;0;4
1772;"Du gaideliai";MALŪNO;2261152926;Ne;5;5;0;10
1773;"Du gaideliai";MALŪNO;4792733524;Ne;7;4;0;11
1774;Eglutė;RAMUNĖ;2998190195;Ne;0;3;0;3
1775;Eglutė;RAMUNĖ;4099257155;Ne;0;5;1;6
1776;Eglutė;RAMUNĖ;6009794480;Ne;0;6;0;6
1777;Eglutė;RAMUNĖ;7984911632;Ne;0;3;0;3
1778;Eglutė;RAMUNĖ;6539887315;Ne;5;0;0;5
1779;Eglutė;RAMUNĖ;4252256130;Ne;1;4;0;5
1780;Eglutė;RAMUNĖ;7234851379;Ne;5;4;0;9
1781;Eglutė;RAMUNĖ;5636437290;Ne;6;2;0;8
1782;Eglutė;RAMUNĖ;5190045146;Ne;7;5;0;12
1783;Eglutė;RAMUNĖ;3985929379;Ne;3;1;1;5
1784;Eglutė;RAMUNĖ;1842517164;Ne;8;0;6;14
1785;Eglutė;RAMUNĖ;7703290039;Ne;0;11;0;11
1786;Eglutė;RAMUNĖ;7530638623;Ne;0;2;0;2
1787;Eglutė;RAMUNĖ;2121177107;Taip;0;1;0;1
1788;Eglutė;RAMUNĖ;2357276888;Ne;0;3;2;5
1789;Eglutė;RAMUNĖ;2816913563;Ne;4;1;0;5
1790;Eglutė;RAMUNĖ;7098548563;Ne;0;4;1;5
1791;Eglutė;RAMUNĖ;7811667336;Ne;0;4;0;4
1792;Eglutė;RAMUNĖ;6146679388;Ne;0;19;0;19
1793;Eglutė;RAMUNĖ;5166183300;Ne;0;8;0;8
1794;Eglutė;PELĖDŽIUKAI;3883122650;Ne;0;4;0;4
1795;Eglutė;PELĖDŽIUKAI;7859815752;Ne;5;5;0;10
1796;Eglutė;PELĖDŽIUKAI;4176597208;Ne;2;5;0;7
1797;Eglutė;PELĖDŽIUKAI;7758643349;Ne;3;5;0;8
1798;Eglutė;PELĖDŽIUKAI;6483580751;Ne;0;5;0;5
1799;Eglutė;PELĖDŽIUKAI;4490295754;Ne;2;6;1;9
1800;Eglutė;PELĖDŽIUKAI;5924994736;Ne;0;4;1;5
1801;Eglutė;PELĖDŽIUKAI;1759383841;Ne;0;6;0;6
1802;Eglutė;PELĖDŽIUKAI;6597261061;Ne;0;2;0;2
1803;Eglutė;PELĖDŽIUKAI;9046652370;Ne;0;4;2;6
1804;Eglutė;PELĖDŽIUKAI;9356785605;Ne;0;4;0;4
1805;Eglutė;PELĖDŽIUKAI;8943684351;Ne;0;4;1;5
1806;Eglutė;PELĖDŽIUKAI;1932785408;Ne;0;14;0;14
1807;Eglutė;PELĖDŽIUKAI;8165126017;Ne;0;4;1;5
1808;Eglutė;PELĖDŽIUKAI;9967488317;Ne;0;4;0;4
1809;Eglutė;PELĖDŽIUKAI;3584247594;Ne;4;2;0;6
1810;Eglutė;PELĖDŽIUKAI;5678727198;Ne;0;4;4;8
1811;Eglutė;PELĖDŽIUKAI;1835565594;Ne;0;4;0;4
1812;Eglutė;PELĖDŽIUKAI;4027143502;Ne;0;5;0;5
1813;Eglutė;PELĖDŽIUKAI;2611896463;Ne;3;6;0;9
1814;Eglutė;KODĖLČIUKAI;7831541089;Ne;0;7;0;7
1815;Eglutė;KODĖLČIUKAI;7735192219;Ne;4;3;0;7
1816;Eglutė;KODĖLČIUKAI;3430016771;Ne;4;11;0;15
1817;Eglutė;KODĖLČIUKAI;6382927775;Ne;0;10;0;10
1818;Eglutė;KODĖLČIUKAI;7919553451;Ne;0;3;0;3
1819;Eglutė;KODĖLČIUKAI;7658345479;Ne;2;4;0;6
1820;Eglutė;KODĖLČIUKAI;7229612001;Ne;10;3;0;13
1821;Eglutė;KODĖLČIUKAI;5779671024;Ne;0;5;0;5
1822;Eglutė;KODĖLČIUKAI;5783776734;Ne;1;5;0;6
1823;Eglutė;KODĖLČIUKAI;4490541539;Ne;2;4;0;6
1824;Eglutė;KODĖLČIUKAI;5407757245;Ne;4;1;0;5
1825;Eglutė;KODĖLČIUKAI;3719202688;Ne;0;2;0;2
1826;Eglutė;KODĖLČIUKAI;3237476593;Ne;5;2;0;7
1827;Eglutė;KODĖLČIUKAI;9542103745;Ne;6;1;0;7
1828;Eglutė;KODĖLČIUKAI;3848175048;Ne;0;3;0;3
1829;Eglutė;KODĖLČIUKAI;5947727288;Ne;0;2;0;2
1830;Eglutė;KODĖLČIUKAI;6653111225;Ne;0;5;0;5
1831;Eglutė;KODĖLČIUKAI;1122907387;Ne;0;4;0;4
1832;Eglutė;KODĖLČIUKAI;9686836846;Ne;0;1;0;1
1833;Eglutė;KODĖLČIUKAI;3650609128;Ne;2;1;0;3
1834;Eglutė;KODĖLČIUKAI;8847930854;Ne;3;5;0;8
1835;Eglutė;KODĖLČIUKAI;5592515139;Ne;2;2;0;4
1836;Eglutė;OBUOLIUKAI;5704418881;Ne;0;2;2;4
1837;Eglutė;OBUOLIUKAI;3488060437;Ne;0;5;0;5
1838;Eglutė;OBUOLIUKAI;8698242107;Ne;0;2;9;11
1839;Eglutė;OBUOLIUKAI;1630732306;Ne;0;2;0;2
1840;Eglutė;OBUOLIUKAI;9381529574;Ne;2;3;1;6
1841;Eglutė;OBUOLIUKAI;9150254806;Ne;0;1;0;1
1842;Eglutė;OBUOLIUKAI;2107488723;Ne;12;0;0;12
1843;Eglutė;OBUOLIUKAI;4539946535;Ne;6;0;2;8
1844;Eglutė;OBUOLIUKAI;8749425471;Ne;5;4;0;9
1845;Eglutė;OBUOLIUKAI;5103022009;Ne;5;5;0;10
1846;Eglutė;OBUOLIUKAI;1460628870;Ne;4;1;0;5
1847;Eglutė;OBUOLIUKAI;8542684582;Ne;5;2;3;10
1848;Eglutė;OBUOLIUKAI;7313013331;Ne;5;0;1;6
1849;Eglutė;OBUOLIUKAI;3089527202;Ne;4;3;0;7
1850;Eglutė;OBUOLIUKAI;3091697091;Ne;0;1;0;1
1851;Eglutė;OBUOLIUKAI;8037564034;Ne;0;3;0;3
1852;Eglutė;OBUOLIUKAI;3051637136;Ne;8;4;0;12
1853;Eglutė;OBUOLIUKAI;2669400743;Ne;4;5;1;10
1854;Eglutė;OBUOLIUKAI;3011330968;Ne;0;6;0;6
1855;Eglutė;OBUOLIUKAI;4823811890;Ne;0;18;0;18
1856;Eglutė;OBUOLIUKAI;6965837585;Ne;0;4;0;4
1857;Eglutė;OBUOLIUKAI;9292940501;Ne;0;5;0;5
1858;Eglutė;KAŠTONAS;3107823269;Ne;4;7;0;11
1859;Eglutė;KAŠTONAS;3799824061;Taip;13;0;0;13
1860;Eglutė;KAŠTONAS;8655425408;Ne;5;0;0;5
1861;Eglutė;KAŠTONAS;1380219881;Ne;9;0;0;9
1862;Eglutė;KAŠTONAS;3387392137;Taip;0;1;0;1
1863;Eglutė;KAŠTONAS;7027121333;Ne;0;3;0;3
1864;Eglutė;KAŠTONAS;1744942011;Ne;10;0;0;10
1865;Eglutė;KAŠTONAS;8384141923;Ne;11;0;0;11
1866;Eglutė;KAŠTONAS;3903612086;Ne;0;2;0;2
1867;Eglutė;KAŠTONAS;3112281182;Ne;10;1;0;11
1868;Eglutė;KAŠTONAS;1432716037;Ne;5;1;0;6
1869;Eglutė;KAŠTONAS;4876032787;Ne;0;2;0;2
1870;Eglutė;KAŠTONAS;9542684993;Ne;0;4;0;4
1871;Eglutė;KAŠTONAS;6967074765;Ne;7;5;0;12
1872;Eglutė;KAŠTONAS;6679186715;Ne;16;0;0;16
1873;Eglutė;KAŠTONAS;9054104040;Ne;14;0;0;14
1874;Eglutė;KAŠTONAS;9193920390;Ne;4;2;0;6
1875;Eglutė;KAŠTONAS;8246870069;Ne;0;4;0;4
1876;Eglutė;KAŠTONAS;8721209423;Ne;0;5;0;5
1877;Eglutė;KAŠTONAS;7789753835;Ne;0;3;0;3
1878;Eglutė;KAŠTONAS;1774538642;Ne;7;0;0;7
1879;Eglutė;KAŠTONAS;7114040071;Ne;8;4;0;12
1880;Eglutė;KAŠTONAS;2192673126;Ne;5;0;0;5
1881;Eglutė;EŽIUKAI;1422631723;Ne;0;13;0;13
1882;Eglutė;EŽIUKAI;6709551046;Ne;0;4;0;4
1883;Eglutė;EŽIUKAI;6093932811;Ne;0;5;0;5
1884;Eglutė;EŽIUKAI;2651867769;Ne;0;4;0;4
1885;Eglutė;EŽIUKAI;3473388722;Ne;2;4;0;6
1886;Eglutė;EŽIUKAI;9402686801;Ne;0;5;0;5
1887;Eglutė;EŽIUKAI;2597978713;Ne;0;5;0;5
1888;Eglutė;EŽIUKAI;4451772812;Ne;0;5;0;5
1889;Eglutė;EŽIUKAI;8493750509;Ne;3;1;0;4
1890;Eglutė;EŽIUKAI;9929681000;Ne;1;1;0;2
1891;Eglutė;EŽIUKAI;6105927493;Ne;1;1;0;2
1892;Eglutė;EŽIUKAI;4560670047;Ne;5;2;0;7
1893;Eglutė;EŽIUKAI;1048451048;Ne;0;4;0;4
1894;Eglutė;EŽIUKAI;6279703448;Ne;3;4;0;7
1895;Eglutė;EŽIUKAI;6142326330;Ne;3;4;0;7
1896;Eglutė;EŽIUKAI;9728550000;Ne;0;4;0;4
1897;Eglutė;EŽIUKAI;1534556744;Ne;0;3;0;3
1898;Eglutė;EŽIUKAI;7598993411;Ne;2;4;0;6
1899;Eglutė;EŽIUKAI;4047404616;Ne;0;4;0;4
1900;Eglutė;EŽIUKAI;4230594049;Ne;13;4;0;17
1901;Eglutė;EŽIUKAI;8797889347;Taip;6;3;0;9
1902;Eglutė;EŽIUKAI;3006381069;Ne;0;2;0;2
1903;Eglutė;EŽIUKAI;3870885357;Ne;9;1;0;10
1904;Eglutė;GILĖ;1550045866;Ne;0;1;0;1
1905;Eglutė;GILĖ;6272115803;Taip;1;1;0;2
1906;Eglutė;GILĖ;6550999480;Ne;0;5;0;5
1907;Eglutė;GILĖ;2857760751;Ne;3;0;1;4
1908;Eglutė;GILĖ;5650957826;Ne;0;2;0;2
1909;Eglutė;GILĖ;8129230197;Ne;2;4;0;6
1910;Eglutė;GILĖ;1393626624;Ne;5;4;0;9
1911;Eglutė;GILĖ;2917925763;Ne;0;1;0;1
1912;Eglutė;GILĖ;9746021019;Ne;0;1;0;1
1913;Eglutė;GILĖ;2276311106;Ne;0;3;0;3
1914;Eglutė;GILĖ;6924344686;Ne;0;2;0;2
1915;Eglutė;GILĖ;5645197324;Ne;0;1;2;3
1916;Eglutė;GILĖ;9098132159;Ne;3;2;0;5
1917;Eglutė;GILĖ;2615824395;Ne;4;4;0;8
1918;Eglutė;GILĖ;1899379269;Ne;0;1;2;3
1919;Eglutė;GILĖ;3605053253;Ne;5;6;0;11
1920;Eglutė;GILĖ;1531942494;Taip;0;16;0;16
1921;Eglutė;GILĖ;5840014240;Ne;0;6;1;7
1922;Eglutė;GILĖ;9758104910;Ne;19;0;0;19
1923;Eglutė;GILĖ;9515238936;Ne;8;0;0;8
1924;Eglutė;GILĖ;6309529738;Ne;0;5;0;5
1925;Eglutė;SAULUTĖ;9741776217;Ne;0;7;0;7
1926;Eglutė;SAULUTĖ;5285593057;Ne;0;0;4;4
1927;Eglutė;SAULUTĖ;3091324735;Ne;0;5;0;5
1928;Eglutė;SAULUTĖ;8739346084;Ne;0;6;0;6
1929;Eglutė;SAULUTĖ;5518570006;Ne;0;4;0;4
1930;Eglutė;SAULUTĖ;5805450838;Ne;0;4;2;6
1931;Eglutė;SAULUTĖ;9084576953;Ne;2;6;0;8
1932;Eglutė;SAULUTĖ;4489150480;Ne;0;12;0;12
1933;Eglutė;SAULUTĖ;2425927050;Ne;0;9;0;9
1934;Eglutė;SAULUTĖ;5918429438;Ne;5;0;2;7
1935;Eglutė;SAULUTĖ;5006042568;Ne;0;4;0;4
1936;Eglutė;SAULUTĖ;5275306818;Ne;5;0;5;10
1937;Eglutė;SAULUTĖ;2621445549;Ne;0;3;0;3
1938;Eglutė;SAULUTĖ;6328900251;Ne;0;5;0;5
1939;Eglutė;SAULUTĖ;9661883776;Ne;0;2;0;2
1940;Eglutė;SAULUTĖ;5505398901;Ne;0;4;0;4
1941;Eglutė;SAULUTĖ;8799063905;Ne;0;4;0;4
1942;Eglutė;SAULUTĖ;5108928996;Ne;0;1;0;1
1943;Eglutė;SAULUTĖ;6572235324;Ne;0;4;2;6
1944;Eglutė;SAULUTĖ;1923176808;Ne;0;4;0;4
1945;Eglutė;SAULUTĖ;2872597971;Ne;2;0;1;3
1946;Eglutė;SAULUTĖ;3690266358;Ne;0;4;0;4
1947;Eglutė;ŠARKELĖ;1667851586;Ne;6;1;0;7
1948;Eglutė;ŠARKELĖ;8410302338;Ne;1;4;0;5
1949;Eglutė;ŠARKELĖ;1715411901;Ne;1;4;0;5
1950;Eglutė;ŠARKELĖ;9875724921;Ne;4;2;0;6
1951;Eglutė;ŠARKELĖ;7564179845;Taip;0;4;0;4
1952;Eglutė;ŠARKELĖ;6773894090;Ne;1;1;0;2
1953;Eglutė;ŠARKELĖ;5146804510;Ne;4;2;0;6
1954;Eglutė;ŠARKELĖ;7231828805;Ne;0;7;0;7
1955;Eglutė;ŠARKELĖ;7618937988;Ne;0;5;0;5
1956;Eglutė;ŠARKELĖ;6805213753;Ne;19;0;0;19
1957;Eglutė;ŠARKELĖ;4427853197;Ne;0;3;0;3
1958;Eglutė;ŠARKELĖ;3368734808;Ne;0;19;0;19
1959;Eglutė;ŠARKELĖ;4465995209;Ne;5;2;0;7
1960;Eglutė;ŠARKELĖ;2666894761;Ne;0;4;0;4
1961;Eglutė;ŠARKELĖ;4697026463;Ne;3;4;0;7
1962;Eglutė;ŠARKELĖ;9795027066;Ne;6;5;0;11
1963;Eglutė;ŠARKELĖ;3974970972;Taip;0;11;0;11
1964;Eglutė;ŠARKELĖ;2950414583;Ne;0;19;0;19
1965;Eglutė;ŠARKELĖ;6171697873;Ne;0;3;0;3
1966;Eglutė;ŠARKELĖ;6631296204;Ne;10;0;0;10
1967;Eglutė;NYKŠTUKAI;3210398495;Ne;3;5;0;8
1968;Eglutė;NYKŠTUKAI;4056836413;Ne;0;3;0;3
1969;Eglutė;NYKŠTUKAI;2546506486;Ne;13;4;2;19
1970;Eglutė;NYKŠTUKAI;3319230753;Ne;4;3;0;7
1971;Eglutė;NYKŠTUKAI;6173724448;Ne;10;1;0;11
1972;Eglutė;NYKŠTUKAI;4357784237;Ne;0;5;0;5
1973;Eglutė;NYKŠTUKAI;2073980883;Ne;0;5;0;5
1974;Eglutė;NYKŠTUKAI;2643648862;Ne;3;2;1;6
1975;Eglutė;NYKŠTUKAI;9415802329;Ne;0;4;1;5
1976;Eglutė;NYKŠTUKAI;2824749988;Ne;0;4;1;5
1977;Eglutė;NYKŠTUKAI;4508182019;Ne;4;4;0;8
1978;Eglutė;NYKŠTUKAI;5840899666;Ne;10;6;0;16
1979;Eglutė;NYKŠTUKAI;4759435431;Ne;0;4;1;5
1980;Eglutė;ŽIRNIUKAI;3706904006;Ne;3;0;8;11
1981;Eglutė;ŽIRNIUKAI;6336987111;Ne;5;5;0;10
1982;Eglutė;ŽIRNIUKAI;9538253415;Ne;0;3;0;3
1983;Eglutė;ŽIRNIUKAI;4539511980;Ne;0;0;1;1
1984;Eglutė;ŽIRNIUKAI;6898851909;Ne;5;0;4;9
1985;Eglutė;ŽIRNIUKAI;1645141463;Ne;0;5;0;5
1986;Eglutė;ŽIRNIUKAI;1950577531;Ne;5;2;2;9
1987;Eglutė;ŽIRNIUKAI;8640230418;Ne;6;1;0;7
1988;Eglutė;ŽIRNIUKAI;6469399675;Ne;0;2;3;5
1989;Eglutė;ŽIRNIUKAI;5991097138;Ne;5;2;4;11
1990;Eglutė;ŽIRNIUKAI;1861429195;Ne;0;7;3;10
1991;Eglutė;ŽIRNIUKAI;5328886016;Ne;0;15;0;15
1992;Eglutė;ŽIRNIUKAI;7022013669;Ne;13;0;0;13
1993;Eglutė;BORUŽIUKAI;5982037450;Ne;4;0;1;5
1994;Eglutė;BORUŽIUKAI;7994301287;Taip;7;2;0;9
1995;Eglutė;BORUŽIUKAI;9300315869;Ne;8;0;0;8
1996;Eglutė;BORUŽIUKAI;4476918512;Taip;19;0;0;19
1997;Eglutė;BORUŽIUKAI;8751687849;Ne;5;0;0;5
1998;Eglutė;BORUŽIUKAI;3228447710;Ne;9;0;0;9
1999;Eglutė;BORUŽIUKAI;7288367894;Ne;5;0;0;5
2000;Eglutė;BORUŽIUKAI;1446642492;Ne;0;15;0;15
2001;Eglutė;BORUŽIUKAI;4254216169;Ne;5;0;0;5
2002;Eglutė;BORUŽIUKAI;9894789541;Ne;19;0;0;19
2003;Eglutė;BORUŽIUKAI;1699040995;Ne;1;0;0;1
2004;Eglutė;BORUŽIUKAI;7184265921;Ne;4;0;0;4
2005;Eglutė;BORUŽIUKAI;6966897830;Ne;5;0;0;5
2006;Eglutė;BORUŽIUKAI;9925814376;Ne;3;0;0;3
2007;"Geniukų kalvė";SAULUTĖS;9557055841;Ne;4;5;0;9
2008;"Geniukų kalvė";SAULUTĖS;4329782598;Ne;0;4;1;5
2009;"Geniukų kalvė";SAULUTĖS;8932671578;Ne;0;4;3;7
2010;"Geniukų kalvė";SAULUTĖS;9522911738;Ne;0;4;1;5
2011;"Geniukų kalvė";SAULUTĖS;5348211316;Ne;0;5;0;5
2012;"Geniukų kalvė";SAULUTĖS;7886553419;Ne;4;1;0;5
2013;"Geniukų kalvė";SAULUTĖS;4946218794;Ne;0;4;1;5
2014;"Geniukų kalvė";SAULUTĖS;4525874796;Ne;0;3;0;3
2015;"Geniukų kalvė";SAULUTĖS;4745451344;Ne;0;4;2;6
2016;"Geniukų kalvė";SAULUTĖS;9768077014;Ne;3;4;0;7
2017;"Geniukų kalvė";SAULUTĖS;3889643236;Ne;8;4;0;12
2018;"Geniukų kalvė";SAULUTĖS;6102906310;Ne;0;4;0;4
2019;"Geniukų kalvė";SAULUTĖS;9976423099;Ne;2;2;0;4
2020;"Geniukų kalvė";SAULUTĖS;5180240547;Ne;0;9;1;10
2021;"Geniukų kalvė";SAULUTĖS;7140298387;Ne;5;4;1;10
2022;"Geniukų kalvė";SAULUTĖS;7006566384;Ne;0;1;0;1
2023;"Geniukų kalvė";SAULUTĖS;1571869318;Ne;0;8;0;8
2024;"Geniukų kalvė";BITUTĖS;5587035951;Ne;4;3;0;7
2025;"Geniukų kalvė";BITUTĖS;9323779212;Ne;18;0;0;18
2026;"Geniukų kalvė";BITUTĖS;2110578252;Ne;2;0;0;2
2027;"Geniukų kalvė";BITUTĖS;8577323715;Ne;0;4;1;5
2028;"Geniukų kalvė";BITUTĖS;7453065865;Ne;6;0;0;6
2029;"Geniukų kalvė";BITUTĖS;8570015975;Ne;1;0;0;1
2030;"Geniukų kalvė";BITUTĖS;9455124402;Ne;1;0;0;1
2031;"Geniukų kalvė";BITUTĖS;4633553106;Ne;4;2;1;7
2032;"Geniukų kalvė";BITUTĖS;3669378459;Ne;10;3;0;13
2033;"Geniukų kalvė";BITUTĖS;4201333532;Ne;8;4;1;13
2034;"Geniukų kalvė";BITUTĖS;5102325807;Ne;0;7;0;7
2035;"Geniukų kalvė";BITUTĖS;1492140432;Ne;4;0;0;4
2036;"Geniukų kalvė";BITUTĖS;1426555835;Ne;0;5;0;5
2037;"Geniukų kalvė";BITUTĖS;7747615302;Ne;8;0;0;8
2038;"Geniukų kalvė";BITUTĖS;4691978116;Ne;11;0;0;11
2039;"Geniukų kalvė";BITUTĖS;6111168227;Ne;0;4;0;4
2040;"Geniukų kalvė";BITUTĖS;7744441981;Ne;3;0;0;3
2041;"Geniukų kalvė";BITUTĖS;1209268848;Ne;3;0;0;3
2042;"Geniukų kalvė";BITUTĖS;6351861630;Ne;0;5;0;5
2043;"Geniukų kalvė";BITUTĖS;6214681079;Ne;0;6;0;6
2044;"Geniukų kalvė";BITUTĖS;3221034847;Ne;0;3;2;5
2045;"Geniukų kalvė";BITUTĖS;2813336498;Ne;3;0;0;3
2046;"Geniukų kalvė";KIŠKUČIAI;5253380852;Ne;4;0;3;7
2047;"Geniukų kalvė";KIŠKUČIAI;2684344984;Ne;7;0;0;7
2048;"Geniukų kalvė";KIŠKUČIAI;5078771341;Ne;5;6;0;11
2049;"Geniukų kalvė";KIŠKUČIAI;4849740486;Ne;4;0;0;4
2050;"Geniukų kalvė";KIŠKUČIAI;9730758999;Ne;4;2;0;6
2051;"Geniukų kalvė";KIŠKUČIAI;9579750299;Ne;4;0;0;4
2052;"Geniukų kalvė";KIŠKUČIAI;9543553237;Ne;0;0;2;2
2053;"Geniukų kalvė";KIŠKUČIAI;2032408983;Ne;0;0;2;2
2054;"Geniukų kalvė";KIŠKUČIAI;9386761753;Ne;8;5;0;13
2055;"Geniukų kalvė";KIŠKUČIAI;4864216994;Ne;3;8;1;12
2056;"Geniukų kalvė";KIŠKUČIAI;6188518268;Ne;0;4;1;5
2057;"Geniukų kalvė";KIŠKUČIAI;1945456486;Ne;0;0;2;2
2058;"Geniukų kalvė";KIŠKUČIAI;3887137828;Ne;14;0;0;14
2059;"Geniukų kalvė";KIŠKUČIAI;2396085192;Ne;0;3;0;3
2060;"Geniukų kalvė";KIŠKUČIAI;8760512032;Ne;2;0;2;4
2061;"Geniukų kalvė";KIŠKUČIAI;4249054993;Ne;4;4;2;10
2062;"Geniukų kalvė";KIŠKUČIAI;1642514752;Ne;8;0;1;9
2063;"Geniukų kalvė";KIŠKUČIAI;9199949456;Ne;3;0;0;3
2064;"Geniukų kalvė";KIŠKUČIAI;9368537477;Ne;9;0;3;12
2065;"Geniukų kalvė";KIŠKUČIAI;6022259388;Ne;0;0;3;3
2066;"Geniukų kalvė";KIŠKUČIAI;8340662627;Ne;5;4;0;9
2067;"Geniukų kalvė";KIŠKUČIAI;5817320560;Ne;1;0;3;4
2068;"Geniukų kalvė";VYTURĖLIAI;4958738745;Ne;2;4;0;6
2069;"Geniukų kalvė";VYTURĖLIAI;9069256760;Ne;0;2;0;2
2070;"Geniukų kalvė";VYTURĖLIAI;2665955524;Ne;0;7;0;7
2071;"Geniukų kalvė";VYTURĖLIAI;5161535756;Ne;0;5;0;5
2072;"Geniukų kalvė";VYTURĖLIAI;3493492581;Ne;0;4;0;4
2073;"Geniukų kalvė";VYTURĖLIAI;3193006249;Ne;2;1;0;3
2074;"Geniukų kalvė";VYTURĖLIAI;6828079735;Ne;0;4;1;5
2075;"Geniukų kalvė";VYTURĖLIAI;2205515766;Ne;1;1;0;2
2076;"Geniukų kalvė";VYTURĖLIAI;8769761434;Ne;0;3;0;3
2077;"Geniukų kalvė";VYTURĖLIAI;1454724752;Ne;0;3;0;3
2078;"Geniukų kalvė";VYTURĖLIAI;1891205998;Ne;0;5;0;5
2079;"Geniukų kalvė";VYTURĖLIAI;3085228868;Ne;0;6;0;6
2080;"Geniukų kalvė";VYTURĖLIAI;3297360222;Ne;3;4;0;7
2081;"Geniukų kalvė";VYTURĖLIAI;6794151223;Ne;0;4;0;4
2082;"Geniukų kalvė";VYTURĖLIAI;4777155321;Ne;0;4;0;4
2083;"Geniukų kalvė";VYTURĖLIAI;1037854104;Ne;0;1;0;1
2084;"Geniukų kalvė";VYTURĖLIAI;9643242164;Ne;1;5;0;6
2085;"Geniukų kalvė";VYTURĖLIAI;5684792148;Ne;2;2;0;4
2086;"Geniukų kalvė";DRUGELIAI;2217221922;Ne;0;5;0;5
2087;"Geniukų kalvė";DRUGELIAI;1811866428;Ne;0;2;0;2
2088;"Geniukų kalvė";DRUGELIAI;8271041553;Ne;0;4;0;4
2089;"Geniukų kalvė";DRUGELIAI;1237228692;Ne;0;4;0;4
2090;"Geniukų kalvė";DRUGELIAI;6410008429;Ne;0;2;0;2
2091;"Geniukų kalvė";DRUGELIAI;3055777730;Ne;1;5;0;6
2092;"Geniukų kalvė";DRUGELIAI;8770345339;Ne;7;3;0;10
2093;"Geniukų kalvė";DRUGELIAI;6070945557;Ne;0;3;0;3
2094;"Geniukų kalvė";DRUGELIAI;1051563985;Ne;0;3;0;3
2095;"Geniukų kalvė";DRUGELIAI;5146141771;Ne;4;1;0;5
2096;"Geniukų kalvė";DRUGELIAI;6174114461;Ne;1;10;0;11
2097;"Geniukų kalvė";DRUGELIAI;1611845627;Ne;0;3;0;3
2098;"Geniukų kalvė";DRUGELIAI;6237208661;Ne;1;3;0;4
2099;"Geniukų kalvė";DRUGELIAI;2659298240;Ne;0;3;0;3
2100;"Geniukų kalvė";DRUGELIAI;9677583445;Ne;0;5;0;5
2101;"Geniukų kalvė";DRUGELIAI;6737863183;Ne;0;5;0;5
2102;"Geniukų kalvė";DRUGELIAI;5704223824;Ne;0;2;0;2
2103;"Geniukų kalvė";DRUGELIAI;3166309530;Ne;0;4;0;4
2104;"Geniukų kalvė";"SAULĖS ZUIKUČIAI";7033628178;Ne;16;3;0;19
2105;"Geniukų kalvė";"SAULĖS ZUIKUČIAI";7082945033;Ne;0;1;0;1
2106;"Geniukų kalvė";"SAULĖS ZUIKUČIAI";2313382307;Ne;1;4;0;5
2107;"Geniukų kalvė";"SAULĖS ZUIKUČIAI";8309953586;Ne;3;0;0;3
2108;"Geniukų kalvė";"SAULĖS ZUIKUČIAI";7500079028;Ne;11;0;2;13
2109;"Geniukų kalvė";"SAULĖS ZUIKUČIAI";8071493871;Ne;3;4;0;7
2110;"Geniukų kalvė";"SAULĖS ZUIKUČIAI";1718428600;Ne;5;0;1;6
2111;"Geniukų kalvė";"SAULĖS ZUIKUČIAI";8914605154;Ne;2;2;0;4
2112;"Geniukų kalvė";"SAULĖS ZUIKUČIAI";6016585056;Taip;13;0;0;13
2113;"Geniukų kalvė";"SAULĖS ZUIKUČIAI";2816691996;Ne;4;3;0;7
2114;"Geniukų kalvė";"SAULĖS ZUIKUČIAI";5512172533;Ne;0;11;0;11
2115;"Geniukų kalvė";"SAULĖS ZUIKUČIAI";1375674317;Ne;2;4;0;6
2116;"Geniukų kalvė";"SAULĖS ZUIKUČIAI";4722801116;Ne;1;2;0;3
2117;"Geniukų kalvė";"SAULĖS ZUIKUČIAI";5763009912;Ne;7;4;0;11
2118;"Geniukų kalvė";"SAULĖS ZUIKUČIAI";5245434552;Ne;4;5;0;9
2119;"Geniukų kalvė";"SAULĖS ZUIKUČIAI";2952604528;Ne;5;1;0;6
2120;"Geniukų kalvė";"SAULĖS ZUIKUČIAI";5725034297;Ne;0;6;0;6
2121;"Geniukų kalvė";"SAULĖS ZUIKUČIAI";1499735818;Ne;5;4;1;10
2122;"Geniukų kalvė";"SAULĖS ZUIKUČIAI";4186376527;Ne;0;4;0;4
2123;"Geniukų kalvė";"SAULĖS ZUIKUČIAI";5161600326;Taip;3;0;5;8
2124;"Geniukų kalvė";"SAULĖS ZUIKUČIAI";4975437036;Ne;3;0;1;4
2125;"Geniukų kalvė";"SAULĖS ZUIKUČIAI";1277485419;Ne;0;0;2;2
2126;"Geniukų kalvė";SMALSUČIAI;2499796674;Ne;3;0;0;3
2127;"Geniukų kalvė";SMALSUČIAI;5974481787;Ne;0;2;0;2
2128;"Geniukų kalvė";SMALSUČIAI;7384802397;Ne;1;0;0;1
2129;"Geniukų kalvė";SMALSUČIAI;5993223458;Ne;2;0;0;2
2130;"Geniukų kalvė";SMALSUČIAI;8985466295;Ne;0;4;0;4
2131;"Geniukų kalvė";SMALSUČIAI;5129841490;Ne;2;1;0;3
2132;"Geniukų kalvė";SMALSUČIAI;5705917381;Ne;0;1;0;1
2133;"Geniukų kalvė";SMALSUČIAI;4231659246;Ne;4;0;0;4
2134;"Geniukų kalvė";SMALSUČIAI;2300947427;Ne;1;4;0;5
2135;"Geniukų kalvė";SMALSUČIAI;1028242614;Ne;9;0;0;9
2136;"Geniukų kalvė";SMALSUČIAI;2596680448;Ne;6;0;0;6
2137;"Geniukų kalvė";SMALSUČIAI;4405381922;Ne;4;0;0;4
2138;"Geniukų kalvė";SMALSUČIAI;6473724074;Ne;10;0;0;10
2139;"Geniukų kalvė";SMALSUČIAI;3627418555;Ne;0;6;0;6
2140;"Geniukų kalvė";SMALSUČIAI;9155681194;Ne;11;5;0;16
2141;"Geniukų kalvė";SMALSUČIAI;7440029486;Ne;0;6;0;6
2142;"Geniukų kalvė";SMALSUČIAI;6168422514;Ne;14;1;0;15
2143;"Geniukų kalvė";SMALSUČIAI;6514696294;Ne;2;1;0;3
2144;"Geniukų kalvė";SMALSUČIAI;6757580298;Ne;2;0;0;2
2145;"Geniukų kalvė";SMALSUČIAI;1573612317;Ne;4;7;0;11
2146;"Geniukų kalvė";SMALSUČIAI;6138451393;Ne;0;5;0;5
2147;"Geniukų kalvė";RUDNOSIUKAI;7079072084;Ne;6;0;0;6
2148;"Geniukų kalvė";RUDNOSIUKAI;6060825704;Ne;10;1;0;11
2149;"Geniukų kalvė";RUDNOSIUKAI;6149037133;Ne;0;10;0;10
2150;"Geniukų kalvė";RUDNOSIUKAI;5883913787;Ne;3;4;0;7
2151;"Geniukų kalvė";RUDNOSIUKAI;9696452101;Ne;0;4;0;4
2152;"Geniukų kalvė";RUDNOSIUKAI;2426186771;Ne;0;0;1;1
2153;"Geniukų kalvė";RUDNOSIUKAI;5205178173;Ne;0;4;0;4
2154;"Geniukų kalvė";RUDNOSIUKAI;2836282651;Ne;7;1;0;8
2155;"Geniukų kalvė";RUDNOSIUKAI;9847003556;Ne;4;1;0;5
2156;"Geniukų kalvė";RUDNOSIUKAI;5443596677;Ne;2;0;0;2
2157;"Geniukų kalvė";RUDNOSIUKAI;7300853810;Ne;5;4;0;9
2158;"Geniukų kalvė";RUDNOSIUKAI;4664026888;Ne;7;0;0;7
2159;"Geniukų kalvė";RUDNOSIUKAI;3852896932;Ne;0;7;0;7
2160;"Geniukų kalvė";RUDNOSIUKAI;2165793561;Ne;0;7;0;7
2161;"Geniukų kalvė";RUDNOSIUKAI;8973285553;Ne;0;2;0;2
2162;"Geniukų kalvė";RUDNOSIUKAI;5559324196;Ne;0;0;1;1
2163;"Geniukų kalvė";RUDNOSIUKAI;4985606198;Ne;2;0;3;5
2164;"Geniukų kalvė";RUDNOSIUKAI;3631181701;Taip;3;0;0;3
2165;"Geniukų kalvė";RUDNOSIUKAI;2798750158;Ne;0;5;0;5
2166;"Geniukų kalvė";RUDNOSIUKAI;6373989816;Ne;1;3;0;4
2167;"Geniukų kalvė";RUDNOSIUKAI;4476754204;Ne;7;4;0;11
2168;"Geniukų kalvė";PELĖDŽIUKAI;6783296167;Ne;0;3;1;4
2169;"Geniukų kalvė";PELĖDŽIUKAI;1844495906;Ne;3;4;0;7
2170;"Geniukų kalvė";PELĖDŽIUKAI;7234620406;Ne;1;0;2;3
2171;"Geniukų kalvė";PELĖDŽIUKAI;5744371590;Ne;0;1;1;2
2172;"Geniukų kalvė";PELĖDŽIUKAI;5847488152;Ne;10;1;0;11
2173;"Geniukų kalvė";PELĖDŽIUKAI;4890413509;Ne;17;0;0;17
2174;"Geniukų kalvė";PELĖDŽIUKAI;2490231586;Ne;0;0;4;4
2175;"Geniukų kalvė";PELĖDŽIUKAI;3676717541;Ne;5;0;5;10
2176;"Geniukų kalvė";PELĖDŽIUKAI;9319251542;Ne;0;0;4;4
2177;"Geniukų kalvė";PELĖDŽIUKAI;7310171451;Ne;0;7;0;7
2178;"Geniukų kalvė";PELĖDŽIUKAI;8653679467;Ne;0;0;1;1
2179;"Geniukų kalvė";PELĖDŽIUKAI;9820642056;Ne;0;5;0;5
2180;"Geniukų kalvė";PELĖDŽIUKAI;5115570519;Taip;0;1;0;1
2181;"Geniukų kalvė";PELĖDŽIUKAI;1179440839;Ne;0;1;1;2
2182;"Geniukų kalvė";PELĖDŽIUKAI;8277880528;Ne;1;0;3;4
2183;"Geniukų kalvė";PELĖDŽIUKAI;4037514656;Ne;3;0;4;7
2184;"Geniukų kalvė";PELĖDŽIUKAI;2884835744;Ne;0;4;1;5
2185;"Geniukų kalvė";PELĖDŽIUKAI;9958205266;Ne;5;0;2;7
2186;"Geniukų kalvė";PELĖDŽIUKAI;9107673658;Ne;0;0;2;2
2187;"Geniukų kalvė";PELĖDŽIUKAI;3921191150;Ne;0;0;4;4
2188;"Geniukų kalvė";BORUŽĖLĖS;2312298671;Ne;6;4;0;10
2189;"Geniukų kalvė";BORUŽĖLĖS;8217855034;Ne;0;5;0;5
2190;"Geniukų kalvė";BORUŽĖLĖS;1068112116;Ne;9;0;0;9
2191;"Geniukų kalvė";BORUŽĖLĖS;1421857914;Ne;0;3;0;3
2192;"Geniukų kalvė";BORUŽĖLĖS;1558977259;Ne;5;1;0;6
2193;"Geniukų kalvė";BORUŽĖLĖS;7736527608;Ne;2;1;0;3
2194;"Geniukų kalvė";BORUŽĖLĖS;4805806745;Ne;11;0;0;11
2195;"Geniukų kalvė";BORUŽĖLĖS;1383717352;Ne;11;0;0;11
2196;"Geniukų kalvė";BORUŽĖLĖS;3071724778;Ne;7;0;0;7
2197;"Geniukų kalvė";BORUŽĖLĖS;2302465593;Ne;2;3;0;5
2198;"Geniukų kalvė";BORUŽĖLĖS;3024701779;Ne;6;0;0;6
2199;"Geniukų kalvė";BORUŽĖLĖS;1822730314;Ne;1;0;0;1
2200;"Geniukų kalvė";BORUŽĖLĖS;3015544833;Ne;9;4;0;13
2201;"Geniukų kalvė";BORUŽĖLĖS;9264121921;Ne;9;0;0;9
2202;"Geniukų kalvė";BORUŽĖLĖS;3071147714;Ne;6;4;0;10
2203;"Geniukų kalvė";BORUŽĖLĖS;7776771879;Ne;3;0;0;3
2204;"Geniukų kalvė";BORUŽĖLĖS;9446649021;Ne;9;0;0;9
2205;"Geniukų kalvė";BORUŽĖLĖS;1733621845;Ne;9;0;0;9
2206;"Geniukų kalvė";BORUŽĖLĖS;9445669807;Ne;9;0;0;9
2207;"Geniukų kalvė";PAGRANDUKAI;8525540366;Ne;6;0;0;6
2208;"Geniukų kalvė";PAGRANDUKAI;8214399001;Ne;4;0;0;4
2209;"Geniukų kalvė";PAGRANDUKAI;4651934103;Ne;12;0;0;12
2210;"Geniukų kalvė";PAGRANDUKAI;2905400583;Ne;3;5;0;8
2211;"Geniukų kalvė";PAGRANDUKAI;2584997232;Ne;6;0;0;6
2212;"Geniukų kalvė";PAGRANDUKAI;3430336639;Ne;6;3;0;9
2213;"Geniukų kalvė";PAGRANDUKAI;1330046867;Ne;3;0;0;3
2214;"Geniukų kalvė";PAGRANDUKAI;9669738771;Ne;6;0;0;6
2215;"Geniukų kalvė";PAGRANDUKAI;3446219974;Ne;8;0;0;8
2216;"Geniukų kalvė";PAGRANDUKAI;9483545114;Ne;9;5;0;14
2217;"Geniukų kalvė";PAGRANDUKAI;8987495724;Ne;5;0;0;5
2218;"Geniukų kalvė";PAGRANDUKAI;1060081499;Ne;9;4;0;13
2219;"Geniukų kalvė";PAGRANDUKAI;3961089171;Taip;6;0;0;6
2220;"Geniukų kalvė";PAGRANDUKAI;9261284850;Ne;4;0;0;4
2221;"Geniukų kalvė";PAGRANDUKAI;5825079031;Ne;1;0;0;1
2222;"Geniukų kalvė";NYKŠTUKAI;9322790214;Ne;8;5;0;13
2223;"Geniukų kalvė";NYKŠTUKAI;6680434763;Ne;0;6;0;6
2224;"Geniukų kalvė";NYKŠTUKAI;7161460256;Ne;14;4;0;18
2225;"Geniukų kalvė";NYKŠTUKAI;9111691146;Ne;0;4;0;4
2226;"Geniukų kalvė";NYKŠTUKAI;7093135374;Ne;4;0;1;5
2227;"Geniukų kalvė";NYKŠTUKAI;3227799882;Ne;15;4;0;19
2228;"Geniukų kalvė";NYKŠTUKAI;1639585179;Ne;4;0;0;4
2229;"Geniukų kalvė";NYKŠTUKAI;5102755395;Ne;3;10;0;13
2230;"Geniukų kalvė";NYKŠTUKAI;4251353237;Ne;3;0;0;3
2231;"Geniukų kalvė";NYKŠTUKAI;6262489669;Ne;0;4;0;4
2232;"Geniukų kalvė";NYKŠTUKAI;3942415928;Ne;5;0;0;5
2233;"Geniukų kalvė";NYKŠTUKAI;1828348351;Ne;13;0;0;13
2234;"Geniukų kalvė";NYKŠTUKAI;1842445148;Ne;6;0;0;6
2235;"Geniukų kalvė";NYKŠTUKAI;3601085940;Ne;3;1;0;4
2236;Gelvonėlis;ĄŽUOLIUKAI;2329699993;Taip;0;5;0;5
2237;Gelvonėlis;ĄŽUOLIUKAI;9058956012;Ne;0;5;0;5
2238;Gelvonėlis;ĄŽUOLIUKAI;4111774915;Ne;0;3;0;3
2239;Gelvonėlis;ĄŽUOLIUKAI;3677100165;Ne;6;0;0;6
2240;Gelvonėlis;ĄŽUOLIUKAI;7449710008;Ne;0;4;0;4
2241;Gelvonėlis;ĄŽUOLIUKAI;8163855482;Ne;0;1;1;2
2242;Gelvonėlis;ĄŽUOLIUKAI;3942630720;Ne;4;8;0;12
2243;Gelvonėlis;ĄŽUOLIUKAI;1453271708;Taip;0;4;0;4
2244;Gelvonėlis;ĄŽUOLIUKAI;9756155028;Ne;17;0;0;17
2245;Gelvonėlis;ĄŽUOLIUKAI;8206816148;Taip;5;3;0;8
2246;Gelvonėlis;ĄŽUOLIUKAI;1274119900;Taip;0;2;0;2
2247;Gelvonėlis;ĄŽUOLIUKAI;5901499708;Ne;9;0;0;9
2248;Gelvonėlis;ĄŽUOLIUKAI;1403890893;Taip;0;0;4;4
2249;Gelvonėlis;ĄŽUOLIUKAI;2519955694;Ne;4;0;0;4
2250;Gelvonėlis;ĄŽUOLIUKAI;6620102515;Ne;8;0;0;8
2251;Gelvonėlis;ĄŽUOLIUKAI;6451006729;Ne;7;0;0;7
2252;Gelvonėlis;ĄŽUOLIUKAI;4190673346;Ne;8;5;0;13
2253;Gelvonėlis;ĄŽUOLIUKAI;2289745479;Taip;3;4;2;9
2254;Gelvonėlis;ĄŽUOLIUKAI;4913415466;Ne;0;0;3;3
2255;Gelvonėlis;ŽVIRBLIUKAI;5024860112;Ne;0;5;0;5
2256;Gelvonėlis;ŽVIRBLIUKAI;8987012601;Ne;3;0;1;4
2257;Gelvonėlis;ŽVIRBLIUKAI;7632523330;Ne;11;0;0;11
2258;Gelvonėlis;ŽVIRBLIUKAI;1112841066;Ne;5;10;0;15
2259;Gelvonėlis;ŽVIRBLIUKAI;4156493586;Ne;10;2;0;12
2260;Gelvonėlis;ŽVIRBLIUKAI;2553846157;Ne;0;5;2;7
2261;Gelvonėlis;ŽVIRBLIUKAI;8003522011;Taip;5;6;1;12
2262;Gelvonėlis;ŽVIRBLIUKAI;9900244859;Ne;12;0;3;15
2263;Gelvonėlis;ŽVIRBLIUKAI;4027647695;Ne;5;0;0;5
2264;Gelvonėlis;ŽVIRBLIUKAI;5713586282;Ne;5;4;0;9
2265;Gelvonėlis;ŽVIRBLIUKAI;8560940316;Ne;0;4;0;4
2266;Gelvonėlis;ŽVIRBLIUKAI;5874473596;Ne;0;10;0;10
2267;Gelvonėlis;ŽVIRBLIUKAI;5305480599;Ne;3;1;0;4
2268;Gelvonėlis;ŽVIRBLIUKAI;5124211917;Taip;0;0;1;1
2269;Gelvonėlis;ŽVIRBLIUKAI;8540204705;Ne;0;0;3;3
2270;Gelvonėlis;ŽVIRBLIUKAI;8124516993;Ne;7;0;3;10
2271;Gelvonėlis;ŽVIRBLIUKAI;9751580494;Ne;0;0;1;1
2272;Gelvonėlis;ŽVIRBLIUKAI;7888968558;Ne;0;4;2;6
2273;Gelvonėlis;ŽVIRBLIUKAI;6261019627;Ne;0;3;0;3
2274;Gelvonėlis;RASELĖS;1925203042;Ne;1;4;0;5
2275;Gelvonėlis;RASELĖS;5996128423;Ne;3;4;0;7
2276;Gelvonėlis;RASELĖS;9149117970;Ne;0;2;0;2
2277;Gelvonėlis;RASELĖS;6451557430;Ne;0;4;0;4
2278;Gelvonėlis;RASELĖS;1802520150;Ne;4;0;0;4
2279;Gelvonėlis;RASELĖS;3192542909;Ne;9;0;0;9
2280;Gelvonėlis;RASELĖS;9622818893;Ne;0;4;5;9
2281;Gelvonėlis;RASELĖS;2638430817;Ne;0;3;4;7
2282;Gelvonėlis;RASELĖS;6949090250;Taip;10;4;0;14
2283;Gelvonėlis;RASELĖS;1462716950;Ne;0;4;2;6
2284;Gelvonėlis;RASELĖS;9600526942;Ne;15;4;0;19
2285;Gelvonėlis;RASELĖS;1387948936;Ne;0;5;0;5
2286;Gelvonėlis;RASELĖS;9650922918;Ne;0;4;0;4
2287;Gelvonėlis;RASELĖS;7450074548;Ne;0;4;2;6
2288;Gelvonėlis;SAULUTĖ;7392743619;Ne;10;0;4;14
2289;Gelvonėlis;SAULUTĖ;8228796927;Ne;0;0;3;3
2290;Gelvonėlis;SAULUTĖ;1368982977;Ne;0;4;0;4
2291;Gelvonėlis;SAULUTĖ;4550077609;Ne;3;0;3;6
2292;Gelvonėlis;SAULUTĖ;1734685590;Ne;6;0;3;9
2293;Gelvonėlis;SAULUTĖ;7936622964;Taip;0;4;0;4
2294;Gelvonėlis;SAULUTĖ;3719670896;Taip;8;0;0;8
2295;Gelvonėlis;SAULUTĖ;1672409070;Ne;4;0;3;7
2296;Gelvonėlis;SAULUTĖ;3771796903;Ne;9;0;2;11
2297;Gelvonėlis;SAULUTĖ;4268590631;Ne;5;0;2;7
2298;Gelvonėlis;SAULUTĖ;5598186460;Ne;5;4;0;9
2299;Gelvonėlis;SAULUTĖ;9767254134;Ne;0;3;0;3
2300;Gelvonėlis;SAULUTĖ;2452711535;Ne;0;3;0;3
2301;Gelvonėlis;SAULUTĖ;3371560338;Ne;6;4;0;10
2302;Gelvonėlis;SAULUTĖ;4228323474;Ne;0;2;0;2
2303;Gelvonėlis;SAULUTĖ;2800795052;Ne;14;0;1;15
2304;Gelvonėlis;SAULUTĖ;6206837435;Ne;0;0;3;3
2305;Gelvonėlis;SAULUTĖ;6840560863;Ne;0;0;1;1
2306;Gelvonėlis;PELĖDŽIUKAI;6604992169;Ne;0;4;0;4
2307;Gelvonėlis;PELĖDŽIUKAI;8508450500;Ne;0;12;2;14
2308;Gelvonėlis;PELĖDŽIUKAI;8704971956;Ne;0;4;11;15
2309;Gelvonėlis;PELĖDŽIUKAI;6556472766;Ne;0;3;2;5
2310;Gelvonėlis;PELĖDŽIUKAI;7182180008;Ne;0;4;0;4
2311;Gelvonėlis;PELĖDŽIUKAI;8976258838;Ne;6;0;0;6
2312;Gelvonėlis;PELĖDŽIUKAI;6598178467;Ne;8;4;0;12
2313;Gelvonėlis;PELĖDŽIUKAI;8885088900;Ne;0;4;0;4
2314;Gelvonėlis;PELĖDŽIUKAI;2400289466;Ne;15;4;0;19
2315;Gelvonėlis;PELĖDŽIUKAI;9493536517;Ne;0;4;0;4
2316;Gelvonėlis;PELĖDŽIUKAI;9059244134;Ne;0;1;0;1
2317;Gelvonėlis;PELĖDŽIUKAI;1987204544;Ne;0;4;0;4
2318;Gelvonėlis;PELĖDŽIUKAI;2288951845;Ne;0;4;0;4
2319;Gelvonėlis;PELĖDŽIUKAI;2515471132;Ne;0;3;1;4
2320;Gelvonėlis;PELĖDŽIUKAI;4281431471;Ne;0;4;6;10
2321;Gelvonėlis;PELĖDŽIUKAI;1085845218;Ne;0;0;1;1
2322;Gelvonėlis;PELĖDŽIUKAI;6319058542;Ne;0;1;2;3
2323;Gelvonėlis;PELĖDŽIUKAI;9538571448;Ne;0;4;0;4
2324;Gelvonėlis;PELĖDŽIUKAI;9147186080;Ne;0;8;0;8
2325;Gelvonėlis;PELĖDŽIUKAI;7195164378;Ne;0;3;1;4
2326;Gelvonėlis;PELĖDŽIUKAI;7620280474;Ne;1;4;0;5
2327;Gelvonėlis;PELĖDŽIUKAI;8704971956;Ne;0;4;11;15
2328;Gelvonėlis;DRUGELIAI;2407650243;Ne;0;3;0;3
2329;Gelvonėlis;DRUGELIAI;2407650243;Ne;0;3;0;3
2330;Gelvonėlis;DRUGELIAI;7262185834;Ne;2;0;0;2
2331;Gelvonėlis;DRUGELIAI;7733244178;Ne;2;6;0;8
2332;Gelvonėlis;DRUGELIAI;1252450619;Ne;13;0;0;13
2333;Gelvonėlis;DRUGELIAI;7811394993;Ne;13;0;0;13
2334;Gelvonėlis;DRUGELIAI;6197211003;Ne;0;2;0;2
2335;Gelvonėlis;DRUGELIAI;1723279380;Ne;10;4;0;14
2336;Gelvonėlis;DRUGELIAI;4125444433;Ne;0;7;0;7
2337;Gelvonėlis;DRUGELIAI;5301772700;Ne;0;0;5;5
2338;Gelvonėlis;DRUGELIAI;7408801401;Ne;0;2;0;2
2339;Gelvonėlis;DRUGELIAI;4738577955;Ne;9;2;0;11
2340;Gelvonėlis;DRUGELIAI;3452557722;Taip;6;0;0;6
2341;Gelvonėlis;DRUGELIAI;2045223350;Ne;0;12;0;12
2342;Gelvonėlis;DRUGELIAI;5535353908;Ne;10;0;0;10
2343;Gelvonėlis;DRUGELIAI;5850515555;Taip;3;1;0;4
2344;Gelvonėlis;VARPELIAI;6131268672;Ne;7;0;1;8
2345;Gelvonėlis;VARPELIAI;4088437014;Ne;11;0;1;12
2346;Gelvonėlis;VARPELIAI;3150970953;Ne;7;0;2;9
2347;Gelvonėlis;VARPELIAI;2877046472;Ne;3;0;0;3
2348;Gelvonėlis;VARPELIAI;2896360160;Ne;8;1;0;9
2349;Gelvonėlis;VARPELIAI;4162701876;Ne;0;3;0;3
2350;Gelvonėlis;VARPELIAI;8365647638;Ne;0;3;1;4
2351;Gelvonėlis;VARPELIAI;3618681535;Ne;8;0;1;9
2352;Gelvonėlis;VARPELIAI;9386056584;Ne;6;2;0;8
2353;Gelvonėlis;VARPELIAI;2114734415;Ne;14;2;0;16
2354;Gelvonėlis;VARPELIAI;5882430535;Ne;0;4;0;4
2355;Gelvonėlis;VARPELIAI;9140900868;Ne;1;0;0;1
2356;Gelvonėlis;VARPELIAI;2645337382;Taip;11;0;1;12
2357;Gelvonėlis;VARPELIAI;3813000890;Ne;8;0;0;8
2358;Gelvonėlis;VARPELIAI;6662081736;Ne;5;1;0;6
2359;Gelvonėlis;VARPELIAI;5379820728;Ne;5;0;1;6
2360;Gelvonėlis;VARPELIAI;7938324572;Ne;12;0;0;12
2361;Gelvonėlis;VARPELIAI;1984082487;Ne;3;0;0;3
2362;Gelvonėlis;BORUŽĖLĖS;8209225630;Ne;0;6;1;7
2363;Gelvonėlis;BORUŽĖLĖS;6554989142;Ne;0;4;0;4
2364;Gelvonėlis;BORUŽĖLĖS;8056058298;Ne;4;3;0;7
2365;Gelvonėlis;BORUŽĖLĖS;2434789595;Ne;0;0;1;1
2366;Gelvonėlis;BORUŽĖLĖS;2698853686;Ne;6;0;0;6
2367;Gelvonėlis;BORUŽĖLĖS;4112607183;Ne;0;4;1;5
2368;Gelvonėlis;BORUŽĖLĖS;6243360625;Ne;0;10;0;10
2369;Gelvonėlis;BORUŽĖLĖS;8515746171;Ne;5;2;0;7
2370;Gelvonėlis;BORUŽĖLĖS;1712926391;Ne;11;4;0;15
2371;Gelvonėlis;BORUŽĖLĖS;6647585785;Ne;0;0;3;3
2372;Gelvonėlis;BORUŽĖLĖS;1539850989;Ne;0;0;5;5
2373;Gelvonėlis;BORUŽĖLĖS;8973272332;Ne;0;4;0;4
2374;Gelvonėlis;BORUŽĖLĖS;9849765037;Ne;2;4;0;6
2375;Gelvonėlis;BORUŽĖLĖS;3846916445;Ne;0;2;0;2
2376;Gelvonėlis;BORUŽĖLĖS;4749071286;Ne;0;4;0;4
2377;Gelvonėlis;BORUŽĖLĖS;3926733474;Ne;0;3;6;9
2378;Gelvonėlis;BORUŽĖLĖS;4620517551;Ne;0;0;1;1
2379;Gelvonėlis;BORUŽĖLĖS;6598688551;Ne;19;0;0;19
2380;Gelvonėlis;BORUŽĖLĖS;6680287456;Ne;0;2;1;3
2381;Gelvonėlis;BORUŽĖLĖS;2752664352;Ne;0;6;0;6
2382;Gelvonėlis;NYKŠTUKAI;9150177446;Ne;0;4;0;4
2383;Gelvonėlis;NYKŠTUKAI;5311057148;Ne;5;4;0;9
2384;Gelvonėlis;NYKŠTUKAI;9266138595;Ne;13;3;0;16
2385;Gelvonėlis;NYKŠTUKAI;6740297512;Ne;11;0;0;11
2386;Gelvonėlis;NYKŠTUKAI;2302268767;Ne;15;0;0;15
2387;Gelvonėlis;NYKŠTUKAI;4723497260;Ne;10;0;0;10
2388;Gelvonėlis;NYKŠTUKAI;8962769076;Ne;12;0;1;13
2389;Gelvonėlis;NYKŠTUKAI;3173327297;Ne;0;4;0;4
2390;Gelvonėlis;NYKŠTUKAI;2820416461;Ne;7;0;0;7
2391;Gelvonėlis;NYKŠTUKAI;9529938060;Ne;5;3;0;8
2392;Gelvonėlis;NYKŠTUKAI;6072327798;Ne;0;3;0;3
2393;Gelvonėlis;NYKŠTUKAI;4423931995;Ne;11;3;0;14
2394;Gelvonėlis;NYKŠTUKAI;2195887907;Taip;3;0;0;3
2395;Gelvonėlis;NYKŠTUKAI;4244879840;Ne;10;2;0;12
2396;Gelvonėlis;NYKŠTUKAI;1167713450;Ne;10;0;0;10
2397;Gelvonėlis;NYKŠTUKAI;8863386276;Ne;12;0;0;12
2398;Gelvonėlis;NYKŠTUKAI;4827817614;Ne;0;1;0;1
2399;Gelvonėlis;BITUTĖS;6534527571;Ne;10;7;0;17
2400;Gelvonėlis;BITUTĖS;1105838340;Ne;0;3;1;4
2401;Gelvonėlis;BITUTĖS;5865866507;Ne;5;4;2;11
2402;Gelvonėlis;BITUTĖS;5444127599;Ne;0;7;0;7
2403;Gelvonėlis;BITUTĖS;1980703633;Ne;0;2;0;2
2404;Gelvonėlis;BITUTĖS;5633162524;Ne;0;7;0;7
2405;Gelvonėlis;BITUTĖS;6330751030;Ne;2;4;0;6
2406;Gelvonėlis;BITUTĖS;6710189985;Ne;13;0;1;14
2407;Gelvonėlis;BITUTĖS;5281400074;Ne;2;6;0;8
2408;Gelvonėlis;BITUTĖS;3514762919;Ne;9;3;0;12
2409;Gelvonėlis;BITUTĖS;8792171281;Ne;0;3;0;3
2410;Gelvonėlis;BITUTĖS;7850553299;Ne;2;2;1;5
2411;Gelvonėlis;BITUTĖS;1730718430;Ne;6;5;0;11
2412;Gelvonėlis;BITUTĖS;8480138654;Ne;8;0;0;8
2413;Gelvonėlis;BITUTĖS;7725313260;Ne;0;14;0;14
2414;Gelvonėlis;BITUTĖS;5816373550;Ne;5;4;1;10
2415;Gelvonėlis;BITUTĖS;4380468764;Ne;11;2;0;13
2416;Gelvonėlis;BITUTĖS;3961569387;Ne;0;3;0;3
2417;Gelvonėlis;BITUTĖS;4388024957;Ne;0;5;2;7
2418;Gelvonėlis;RAMUNĖLĖS;1104204810;Ne;9;3;0;12
2419;Gelvonėlis;RAMUNĖLĖS;1355774181;Ne;0;4;0;4
2420;Gelvonėlis;RAMUNĖLĖS;2774170680;Ne;6;8;0;14
2421;Gelvonėlis;RAMUNĖLĖS;9403505858;Taip;6;9;0;15
2422;Gelvonėlis;RAMUNĖLĖS;7686930719;Ne;6;0;2;8
2423;Gelvonėlis;RAMUNĖLĖS;4450990418;Ne;0;0;2;2
2424;Gelvonėlis;RAMUNĖLĖS;7419947442;Ne;0;0;1;1
2425;Gelvonėlis;RAMUNĖLĖS;6883156109;Ne;4;6;0;10
2426;Gelvonėlis;RAMUNĖLĖS;1562829157;Ne;8;0;0;8
2427;Gelvonėlis;RAMUNĖLĖS;4211228746;Ne;5;1;0;6
2428;Gelvonėlis;RAMUNĖLĖS;1661034338;Ne;0;1;0;1
2429;Gelvonėlis;RAMUNĖLĖS;2821485779;Ne;11;0;2;13
2430;Gelvonėlis;RAMUNĖLĖS;7301596834;Ne;18;0;0;18
2431;Gelvonėlis;RAMUNĖLĖS;9046297659;Ne;5;9;0;14
2432;Gelvonėlis;RAMUNĖLĖS;9492898584;Ne;0;6;0;6
2433;Gelvonėlis;RAMUNĖLĖS;7654781219;Ne;2;5;0;7
2434;Gelvonėlis;RAMUNĖLĖS;7464963101;Ne;13;0;0;13
2435;Gelvonėlis;RAMUNĖLĖS;1938685620;Ne;6;0;0;6
2436;Gelvonėlis;RIEŠUTĖLIAI;3368423382;Ne;0;6;0;6
2437;Gelvonėlis;RIEŠUTĖLIAI;5461812139;Ne;0;6;0;6
2438;Gelvonėlis;RIEŠUTĖLIAI;5986018609;Ne;0;4;6;10
2439;Gelvonėlis;RIEŠUTĖLIAI;8532801167;Ne;0;4;0;4
2440;Gelvonėlis;RIEŠUTĖLIAI;4208103106;Ne;0;10;0;10
2441;Gelvonėlis;RIEŠUTĖLIAI;8766702456;Ne;0;4;2;6
2442;Gelvonėlis;RIEŠUTĖLIAI;6305084811;Ne;10;0;5;15
2443;Gelvonėlis;RIEŠUTĖLIAI;2005647155;Ne;0;4;2;6
2444;Gelvonėlis;RIEŠUTĖLIAI;1266479895;Ne;0;5;0;5
2445;Gelvonėlis;RIEŠUTĖLIAI;5934077931;Ne;0;4;0;4
2446;Gelvonėlis;RIEŠUTĖLIAI;4280463938;Ne;0;1;0;1
2447;Gelvonėlis;RIEŠUTĖLIAI;6471921512;Ne;0;4;0;4
2448;Gelvonėlis;RIEŠUTĖLIAI;3448444552;Ne;5;5;0;10
2449;Gelvonėlis;RIEŠUTĖLIAI;4832167372;Ne;7;5;0;12
2450;Gelvonėlis;RIEŠUTĖLIAI;9301814935;Ne;0;8;0;8
2451;Gelvonėlis;RIEŠUTĖLIAI;1466616814;Ne;0;9;0;9
2452;Gelvonėlis;RIEŠUTĖLIAI;2015807805;Ne;10;4;0;14
2453;Gelvonėlis;RIEŠUTĖLIAI;9323228591;Ne;0;4;0;4
2454;Gelvonėlis;RIEŠUTĖLIAI;2360728722;Ne;9;7;0;16
2455;Gelvonėlis;RIEŠUTĖLIAI;9132529216;Ne;0;15;0;15
2456;"Gervelė (Dzūkų g. 32)";ŽIRNIUKAI;7140356352;Ne;1;0;4;5
2457;"Gervelė (Dzūkų g. 32)";ŽIRNIUKAI;3170062234;Ne;0;0;3;3
2458;"Gervelė (Dzūkų g. 32)";ŽIRNIUKAI;8598429197;Ne;2;0;2;4
2459;"Gervelė (Dzūkų g. 32)";ŽIRNIUKAI;9294388176;Ne;3;0;0;3
2460;"Gervelė (Dzūkų g. 32)";ŽIRNIUKAI;3230279203;Ne;2;0;1;3
2461;"Gervelė (Dzūkų g. 32)";ŽIRNIUKAI;9532470407;Taip;10;0;0;10
2462;"Gervelė (Dzūkų g. 32)";ŽIRNIUKAI;5608916470;Ne;0;4;0;4
2463;"Gervelė (Dzūkų g. 32)";ŽIRNIUKAI;8098158634;Taip;2;4;0;6
2464;"Gervelė (Dzūkų g. 32)";ŽIRNIUKAI;7205673717;Ne;0;3;2;5
2465;"Gervelė (Dzūkų g. 32)";ŽIRNIUKAI;3554640994;Ne;0;1;4;5
2466;"Gervelė (Dzūkų g. 32)";ŽIRNIUKAI;1226130732;Taip;0;0;3;3
2467;"Gervelė (Dzūkų g. 32)";ŽIRNIUKAI;1020706652;Ne;0;0;3;3
2468;"Gervelė (Dzūkų g. 32)";ŽIRNIUKAI;4552290778;Ne;2;0;0;2
2469;"Gervelė (Dzūkų g. 32)";ŽIRNIUKAI;9884946783;Ne;14;0;1;15
2470;"Gervelė (Dzūkų g. 32)";ŽIRNIUKAI;4174471780;Ne;7;0;1;8
2471;"Gervelė (Dzūkų g. 32)";ŽIRNIUKAI;6424240375;Ne;19;0;0;19
2472;"Gervelė (Dzūkų g. 32)";ŽIRNIUKAI;2210605017;Ne;11;0;4;15
2473;"Gervelė (Dzūkų g. 32)";ŽIRNIUKAI;8882442987;Ne;3;0;2;5
2474;"Gervelė (Dzūkų g. 32)";ŽIRNIUKAI;1777909973;Ne;7;0;3;10
2475;"Gervelė (Dzūkų g. 32)";ŽIRNIUKAI;1400829693;Ne;0;0;12;12
2476;"Gervelė (Dzūkų g. 32)";ŽIRNIUKAI;4661861470;Ne;13;0;3;16
2477;"Gervelė (Dzūkų g. 32)";LAŠIUKAI;2523056808;Taip;1;5;0;6
2478;"Gervelė (Dzūkų g. 32)";LAŠIUKAI;2563081304;Ne;3;1;0;4
2479;"Gervelė (Dzūkų g. 32)";LAŠIUKAI;6844406500;Ne;0;5;0;5
2480;"Gervelė (Dzūkų g. 32)";LAŠIUKAI;8811086908;Ne;0;7;0;7
2481;"Gervelė (Dzūkų g. 32)";LAŠIUKAI;2046282471;Ne;19;0;0;19
2482;"Gervelė (Dzūkų g. 32)";LAŠIUKAI;1573560581;Ne;1;4;0;5
2483;"Gervelė (Dzūkų g. 32)";LAŠIUKAI;9133101055;Ne;9;4;0;13
2484;"Gervelė (Dzūkų g. 32)";LAŠIUKAI;7192663882;Ne;4;0;0;4
2485;"Gervelė (Dzūkų g. 32)";LAŠIUKAI;1024397071;Ne;13;0;0;13
2486;"Gervelė (Dzūkų g. 32)";LAŠIUKAI;1783612448;Ne;2;5;0;7
2487;"Gervelė (Dzūkų g. 32)";LAŠIUKAI;7040713170;Ne;15;0;0;15
2488;"Gervelė (Dzūkų g. 32)";LAŠIUKAI;6227091658;Ne;0;3;0;3
2489;"Gervelė (Dzūkų g. 32)";LAŠIUKAI;4075328330;Ne;5;0;0;5
2490;"Gervelė (Dzūkų g. 32)";LAŠIUKAI;7394199974;Ne;4;4;0;8
2491;"Gervelė (Dzūkų g. 32)";LAŠIUKAI;5497737178;Taip;11;0;0;11
2492;"Gervelė (Dzūkų g. 32)";LAŠIUKAI;5480025851;Ne;8;0;0;8
2493;"Gervelė (Dzūkų g. 32)";LAŠIUKAI;7363767471;Ne;17;0;0;17
2494;"Gervelė (Dzūkų g. 32)";LAŠIUKAI;4932912245;Taip;15;0;0;15
2495;"Gervelė (Dzūkų g. 32)";LAŠIUKAI;1808067249;Ne;5;0;0;5
2496;"Gervelė (Dzūkų g. 32)";PABIRUČIAI;1637204236;Ne;9;0;0;9
2497;"Gervelė (Dzūkų g. 32)";PABIRUČIAI;8157865822;Ne;0;4;1;5
2498;"Gervelė (Dzūkų g. 32)";PABIRUČIAI;7924884022;Ne;3;8;0;11
2499;"Gervelė (Dzūkų g. 32)";PABIRUČIAI;3702908570;Ne;5;2;0;7
2500;"Gervelė (Dzūkų g. 32)";PABIRUČIAI;1323074335;Ne;8;0;0;8
2501;"Gervelė (Dzūkų g. 32)";PABIRUČIAI;5799823801;Ne;12;1;0;13
2502;"Gervelė (Dzūkų g. 32)";PABIRUČIAI;6058944385;Ne;0;6;0;6
2503;"Gervelė (Dzūkų g. 32)";PABIRUČIAI;3647044817;Ne;0;4;0;4
2504;"Gervelė (Dzūkų g. 32)";PABIRUČIAI;2446758975;Ne;8;2;0;10
2505;"Gervelė (Dzūkų g. 32)";PABIRUČIAI;2413995770;Ne;3;4;0;7
2506;"Gervelė (Dzūkų g. 32)";PABIRUČIAI;1353920541;Ne;0;7;0;7
2507;"Gervelė (Dzūkų g. 32)";PABIRUČIAI;6895415337;Ne;3;3;0;6
2508;"Gervelė (Dzūkų g. 32)";PABIRUČIAI;8533480337;Ne;0;4;0;4
2509;"Gervelė (Dzūkų g. 32)";PABIRUČIAI;8287867336;Ne;12;3;0;15
2510;"Gervelė (Dzūkų g. 32)";PABIRUČIAI;2186818108;Ne;5;0;0;5
2511;"Gervelė (Dzūkų g. 32)";PABIRUČIAI;9799715031;Ne;0;0;10;10
2512;"Gervelė (Dzūkų g. 32)";PABIRUČIAI;8439479958;Ne;0;11;0;11
2513;"Gervelė (Dzūkų g. 32)";BITUTĖS;5360362280;Ne;0;0;3;3
2514;"Gervelė (Dzūkų g. 32)";BITUTĖS;5360362280;Ne;0;0;3;3
2515;"Gervelė (Dzūkų g. 32)";BITUTĖS;7317091881;Ne;5;0;0;5
2516;"Gervelė (Dzūkų g. 32)";BITUTĖS;6228025635;Ne;3;0;0;3
2517;"Gervelė (Dzūkų g. 32)";BITUTĖS;6951455424;Ne;0;3;0;3
2518;"Gervelė (Dzūkų g. 32)";BITUTĖS;9977349707;Ne;0;5;1;6
2519;"Gervelė (Dzūkų g. 32)";BITUTĖS;3333885493;Ne;9;0;1;10
2520;"Gervelė (Dzūkų g. 32)";BITUTĖS;4295743997;Ne;0;4;0;4
2521;"Gervelė (Dzūkų g. 32)";BITUTĖS;1112844296;Ne;4;0;0;4
2522;"Gervelė (Dzūkų g. 32)";BITUTĖS;7935059565;Ne;0;2;0;2
2523;"Gervelė (Dzūkų g. 32)";BITUTĖS;5267617723;Ne;9;0;1;10
2524;"Gervelė (Dzūkų g. 32)";BITUTĖS;5953552777;Ne;0;7;0;7
2525;"Gervelė (Dzūkų g. 32)";BITUTĖS;4038179503;Ne;0;4;0;4
2526;"Gervelė (Dzūkų g. 32)";BITUTĖS;1160084928;Ne;13;0;0;13
2527;"Gervelė (Dzūkų g. 32)";BITUTĖS;6287806975;Taip;4;1;1;6
2528;"Gervelė (Dzūkų g. 32)";BITUTĖS;5685222621;Ne;0;4;0;4
2529;"Gervelė (Dzūkų g. 32)";BITUTĖS;5167248493;Ne;0;0;4;4
2530;"Gervelė (Dzūkų g. 32)";BITUTĖS;9291855374;Ne;4;0;0;4
2531;"Gervelė (Dzūkų g. 32)";BITUTĖS;6431701403;Ne;9;0;1;10
2532;"Gervelė (Dzūkų g. 32)";BURATINO;9239897472;Ne;1;3;0;4
2533;"Gervelė (Dzūkų g. 32)";BURATINO;9982951468;Ne;4;4;0;8
2534;"Gervelė (Dzūkų g. 32)";BURATINO;4775822341;Ne;4;6;0;10
2535;"Gervelė (Dzūkų g. 32)";BURATINO;2913622440;Ne;7;3;0;10
2536;"Gervelė (Dzūkų g. 32)";BURATINO;4434618210;Ne;0;3;0;3
2537;"Gervelė (Dzūkų g. 32)";BURATINO;6166476760;Ne;11;0;0;11
2538;"Gervelė (Dzūkų g. 32)";BURATINO;4516538272;Ne;7;3;0;10
2539;"Gervelė (Dzūkų g. 32)";BURATINO;3723783633;Ne;1;3;0;4
2540;"Gervelė (Dzūkų g. 32)";BURATINO;8472436632;Taip;4;3;0;7
2541;"Gervelė (Dzūkų g. 32)";BURATINO;1655678792;Ne;7;0;0;7
2542;"Gervelė (Dzūkų g. 32)";BURATINO;9697299387;Taip;11;3;0;14
2543;"Gervelė (Dzūkų g. 32)";BURATINO;7300458249;Ne;10;3;0;13
2544;"Gervelė (Dzūkų g. 32)";BURATINO;7998812497;Ne;6;3;0;9
2545;"Gervelė (Dzūkų g. 32)";BURATINO;5737517940;Ne;6;1;0;7
2546;"Gervelė (Dzūkų g. 32)";BURATINO;6595410865;Ne;5;7;0;12
2547;"Gervelė (Dzūkų g. 32)";BURATINO;1328359434;Ne;3;0;0;3
2548;"Gervelė (Dzūkų g. 32)";BURATINO;1932916710;Ne;0;11;0;11
2549;"Gervelė (Dzūkų g. 32)";BURATINO;2080374597;Ne;1;3;0;4
2550;"Gervelė (Dzūkų g. 32)";BURATINO;9768014964;Ne;7;0;0;7
2551;"Gervelė (Dzūkų g. 32)";BURATINO;2359854614;Ne;7;3;0;10
2552;"Gervelė (Dzūkų g. 32)";VIŠČIUKŲ;5375779904;Ne;16;0;0;16
2553;"Gervelė (Dzūkų g. 32)";VIŠČIUKŲ;1810783092;Ne;2;0;3;5
2554;"Gervelė (Dzūkų g. 32)";VIŠČIUKŲ;3928187363;Ne;0;0;3;3
2555;"Gervelė (Dzūkų g. 32)";VIŠČIUKŲ;4112178405;Ne;0;4;1;5
2556;"Gervelė (Dzūkų g. 32)";VIŠČIUKŲ;8193126684;Ne;2;3;0;5
2557;"Gervelė (Dzūkų g. 32)";VIŠČIUKŲ;7152159380;Ne;3;0;3;6
2558;"Gervelė (Dzūkų g. 32)";VIŠČIUKŲ;6503715631;Ne;0;0;4;4
2559;"Gervelė (Dzūkų g. 32)";VIŠČIUKŲ;6071962550;Ne;13;0;1;14
2560;"Gervelė (Dzūkų g. 32)";VIŠČIUKŲ;8456221074;Ne;19;0;0;19
2561;"Gervelė (Dzūkų g. 32)";VIŠČIUKŲ;9738262953;Ne;0;4;1;5
2562;"Gervelė (Dzūkų g. 32)";VIŠČIUKŲ;8792240321;Ne;0;0;4;4
2563;"Gervelė (Dzūkų g. 32)";VIŠČIUKŲ;8392147716;Ne;0;4;0;4
2564;"Gilužis (Vydūno g. 11A)";Skruzdėliukų;9707968228;Ne;4;2;0;6
2565;"Gilužis (Vydūno g. 11A)";Skruzdėliukų;8628253655;Ne;9;5;0;14
2566;"Gilužis (Vydūno g. 11A)";Skruzdėliukų;9783700319;Ne;4;1;0;5
2567;"Gilužis (Vydūno g. 11A)";Skruzdėliukų;4509741536;Ne;6;4;0;10
2568;"Gilužis (Vydūno g. 11A)";Skruzdėliukų;2221786284;Ne;4;5;0;9
2569;"Gilužis (Vydūno g. 11A)";Skruzdėliukų;3002266577;Ne;0;4;0;4
2570;"Gilužis (Vydūno g. 11A)";Skruzdėliukų;5497242500;Ne;0;3;0;3
2571;"Gilužis (Vydūno g. 11A)";Skruzdėliukų;5190752112;Ne;6;4;1;11
2572;"Gilužis (Vydūno g. 11A)";Skruzdėliukų;2440762487;Ne;6;4;1;11
2573;"Gilužis (Vydūno g. 11A)";Skruzdėliukų;9104005195;Ne;3;3;0;6
2574;"Gilužis (Vydūno g. 11A)";Skruzdėliukų;5394693502;Ne;7;4;0;11
2575;"Gilužis (Vydūno g. 11A)";Skruzdėliukų;4106792355;Ne;0;5;0;5
2576;"Gilužis (Vydūno g. 11A)";Skruzdėliukų;4876074981;Ne;1;3;0;4
2577;"Gilužis (Vydūno g. 11A)";Skruzdėliukų;2633680406;Ne;0;8;0;8
2578;"Gilužis (Vydūno g. 11A)";Skruzdėliukų;4455977087;Ne;3;4;0;7
2579;"Gilužis (Vydūno g. 11A)";Skruzdėliukų;4475698906;Ne;7;1;0;8
2580;"Gilužis (Vydūno g. 11A)";Skruzdėliukų;1085130813;Ne;0;6;0;6
2581;"Gilužis (Vydūno g. 11A)";Skruzdėliukų;2615087717;Ne;2;6;1;9
2582;"Gilužis (Vydūno g. 11A)";Skruzdėliukų;2516315604;Ne;5;4;1;10
2583;"Gilužis (Vydūno g. 11A)";Skruzdėliukų;2706629834;Ne;5;1;0;6
2584;"Gilužis (Vydūno g. 11A)";Skruzdėliukų;6831107153;Ne;9;1;0;10
2585;"Gilužis (Vydūno g. 11A)";Skruzdėliukų;8852862161;Ne;9;1;0;10
2586;"Gilužis (Vydūno g. 11A)";Skruzdėliukų;2955779117;Ne;9;1;0;10
2587;"Gilužis (Vydūno g. 11A)";Nykštukų;3132445117;Ne;0;4;0;4
2588;"Gilužis (Vydūno g. 11A)";Nykštukų;4147821853;Ne;0;4;0;4
2589;"Gilužis (Vydūno g. 11A)";Nykštukų;7937643339;Ne;0;3;0;3
2590;"Gilužis (Vydūno g. 11A)";Nykštukų;3473889426;Ne;12;4;0;16
2591;"Gilužis (Vydūno g. 11A)";Nykštukų;9362581908;Ne;7;6;0;13
2592;"Gilužis (Vydūno g. 11A)";Nykštukų;8899557365;Ne;0;4;0;4
2593;"Gilužis (Vydūno g. 11A)";Nykštukų;2661894041;Ne;0;3;0;3
2594;"Gilužis (Vydūno g. 11A)";Nykštukų;5109935385;Ne;0;1;0;1
2595;"Gilužis (Vydūno g. 11A)";Nykštukų;7228498662;Ne;0;3;0;3
2596;"Gilužis (Vydūno g. 11A)";Nykštukų;3335512812;Ne;0;3;0;3
2597;"Gilužis (Vydūno g. 11A)";Nykštukų;1459273692;Ne;0;3;0;3
2598;"Gilužis (Vydūno g. 11A)";Nykštukų;4156613717;Ne;0;4;0;4
2599;"Gilužis (Vydūno g. 11A)";Nykštukų;5713786735;Ne;5;4;0;9
2600;"Gilužis (Vydūno g. 11A)";Nykštukų;4956685016;Ne;0;3;0;3
2601;"Gilužis (Vydūno g. 11A)";Nykštukų;6315155554;Ne;0;4;0;4
2602;"Gilužis (Vydūno g. 11A)";Nykštukų;4541291716;Ne;5;4;0;9
2603;"Gilužis (Vydūno g. 11A)";Nykštukų;8522552650;Ne;8;6;0;14
2604;"Gilužis (Vydūno g. 11A)";Nykštukų;3176305306;Ne;0;5;0;5
2605;"Gilužis (Vydūno g. 11A)";Nykštukų;4795108770;Ne;5;0;0;5
2606;"Gilužis (Vydūno g. 11A)";Nykštukų;4094486541;Ne;1;2;0;3
2607;"Gilužis (Vydūno g. 11A)";Nykštukų;6493142538;Ne;0;4;0;4
2608;"Gilužis (Vydūno g. 11A)";Nykštukų;5088561405;Ne;0;5;0;5
2609;"Gilužis (Vydūno g. 11A)";Bitučių;4841014668;Ne;2;3;0;5
2610;"Gilužis (Vydūno g. 11A)";Bitučių;3399162399;Ne;0;1;0;1
2611;"Gilužis (Vydūno g. 11A)";Bitučių;5973671038;Ne;0;1;0;1
2612;"Gilužis (Vydūno g. 11A)";Bitučių;1634295583;Ne;0;4;2;6
2613;"Gilužis (Vydūno g. 11A)";Bitučių;4360261750;Ne;0;4;2;6
2614;"Gilužis (Vydūno g. 11A)";Bitučių;5728341732;Ne;4;2;2;8
2615;"Gilužis (Vydūno g. 11A)";Bitučių;2780710383;Ne;0;2;0;2
2616;"Gilužis (Vydūno g. 11A)";Bitučių;6931726275;Ne;0;4;0;4
2617;"Gilužis (Vydūno g. 11A)";Bitučių;1867185320;Ne;0;10;0;10
2618;"Gilužis (Vydūno g. 11A)";Bitučių;3429435736;Ne;10;2;0;12
2619;"Gilužis (Vydūno g. 11A)";Bitučių;8539946703;Taip;0;19;0;19
2620;"Gilužis (Vydūno g. 11A)";Bitučių;9000351000;Ne;9;1;0;10
2621;"Gilužis (Vydūno g. 11A)";Bitučių;5366174839;Ne;3;2;0;5
2622;"Gilužis (Vydūno g. 11A)";Bitučių;5162397237;Ne;0;7;0;7
2623;"Gilužis (Vydūno g. 11A)";Bitučių;7250617867;Ne;0;0;3;3
2624;"Gilužis (Vydūno g. 11A)";Bitučių;9053608903;Ne;0;13;0;13
2625;"Gilužis (Vydūno g. 11A)";Bitučių;6115776872;Ne;0;0;4;4
2626;"Gilužis (Vydūno g. 11A)";Bitučių;5651799121;Ne;0;0;9;9
2627;"Gilužis (Vydūno g. 11A)";Bitučių;1334619137;Ne;0;2;0;2
2628;"Gilužis (Vydūno g. 11A)";Bitučių;2950813185;Ne;0;8;0;8
2629;"Gilužis (Vydūno g. 11A)";Bitučių;6515525848;Ne;0;9;0;9
2630;"Gilužis (Vydūno g. 11A)";Bitučių;2345403784;Ne;2;4;0;6
2631;"Gilužis (Vydūno g. 11A)";Kačiukų;1273655212;Ne;0;4;0;4
2632;"Gilužis (Vydūno g. 11A)";Kačiukų;4978922821;Ne;0;5;0;5
2633;"Gilužis (Vydūno g. 11A)";Kačiukų;2945406185;Ne;0;5;0;5
2634;"Gilužis (Vydūno g. 11A)";Kačiukų;1582241363;Ne;2;4;0;6
2635;"Gilužis (Vydūno g. 11A)";Kačiukų;7330938312;Ne;0;0;6;6
2636;"Gilužis (Vydūno g. 11A)";Kačiukų;6571132974;Ne;1;10;2;13
2637;"Gilužis (Vydūno g. 11A)";Kačiukų;7001112696;Ne;0;5;0;5
2638;"Gilužis (Vydūno g. 11A)";Kačiukų;9034842169;Ne;4;0;3;7
2639;"Gilužis (Vydūno g. 11A)";Kačiukų;6966795180;Ne;0;6;1;7
2640;"Gilužis (Vydūno g. 11A)";Kačiukų;5128383851;Ne;3;4;0;7
2641;"Gilužis (Vydūno g. 11A)";Kačiukų;8318405114;Ne;5;4;0;9
2642;"Gilužis (Vydūno g. 11A)";Kačiukų;7826015897;Ne;4;10;0;14
2643;"Gilužis (Vydūno g. 11A)";Kačiukų;4403218878;Ne;0;4;2;6
2644;"Gilužis (Vydūno g. 11A)";Kačiukų;3419281756;Ne;0;4;0;4
2645;"Gilužis (Vydūno g. 11A)";Kačiukų;1862524255;Ne;0;4;0;4
2646;"Gilužis (Vydūno g. 11A)";Kačiukų;9421351780;Ne;0;1;4;5
2647;"Gilužis (Vydūno g. 11A)";Kačiukų;6404411477;Ne;2;4;0;6
2648;"Gilužis (Vydūno g. 11A)";Kačiukų;4128387076;Ne;3;4;0;7
2649;"Gilužis (Vydūno g. 11A)";Kačiukų;7042664923;Ne;4;4;0;8
2650;"Gilužis (Vydūno g. 11A)";Kačiukų;9097165155;Ne;9;0;1;10
2651;"Gilužis (Vydūno g. 11A)";Kačiukų;8762534617;Ne;0;13;0;13
2652;"Gilužis (Vydūno g. 11A)";Kačiukų;5641406427;Ne;3;0;6;9
2653;"Gilužis (Vydūno g. 11A)";Pelėdžiukų;5217748032;Ne;0;6;0;6
2654;"Gilužis (Vydūno g. 11A)";Pelėdžiukų;5989314494;Ne;0;2;0;2
2655;"Gilužis (Vydūno g. 11A)";Pelėdžiukų;7998695149;Ne;7;2;0;9
2656;"Gilužis (Vydūno g. 11A)";Pelėdžiukų;7742783427;Ne;6;2;0;8
2657;"Gilužis (Vydūno g. 11A)";Pelėdžiukų;7358572344;Ne;5;4;0;9
2658;"Gilužis (Vydūno g. 11A)";Pelėdžiukų;4617259961;Ne;0;3;0;3
2659;"Gilužis (Vydūno g. 11A)";Pelėdžiukų;1222370750;Ne;0;11;0;11
2660;"Gilužis (Vydūno g. 11A)";Pelėdžiukų;9503516686;Ne;0;4;0;4
2661;"Gilužis (Vydūno g. 11A)";Pelėdžiukų;9833451628;Ne;0;3;0;3
2662;"Gilužis (Vydūno g. 11A)";Pelėdžiukų;6270071724;Ne;5;3;0;8
2663;"Gilužis (Vydūno g. 11A)";Pelėdžiukų;4051726208;Ne;0;4;0;4
2664;"Gilužis (Vydūno g. 11A)";Pelėdžiukų;7092060789;Ne;0;4;0;4
2665;"Gilužis (Vydūno g. 11A)";Pelėdžiukų;4435227217;Ne;0;1;0;1
2666;"Gilužis (Vydūno g. 11A)";Pelėdžiukų;1804218972;Ne;4;4;0;8
2667;"Gilužis (Vydūno g. 11A)";Pelėdžiukų;2434419240;Ne;0;3;0;3
2668;"Gilužis (Vydūno g. 11A)";Pelėdžiukų;3166161973;Ne;0;3;0;3
2669;"Gilužis (Vydūno g. 11A)";Pelėdžiukų;5070988982;Ne;0;5;0;5
2670;"Gilužis (Vydūno g. 11A)";Pelėdžiukų;7899274495;Ne;4;3;0;7
2671;"Gilužis (Vydūno g. 11A)";Pelėdžiukų;6093514885;Ne;10;3;0;13
2672;"Gilužis (Vydūno g. 11A)";Pelėdžiukų;2869506388;Ne;2;6;0;8
2673;"Gilužis (Vydūno g. 11A)";Pelėdžiukų;9520409342;Ne;0;4;0;4
2674;"Gilužis (Vydūno g. 11A)";Pelėdžiukų;9186274541;Ne;5;1;0;6
2675;"Gilužis (Vydūno g. 11A)";Drugelių;6121625070;Ne;19;0;0;19
2676;"Gilužis (Vydūno g. 11A)";Drugelių;1770064694;Ne;0;3;0;3
2677;"Gilužis (Vydūno g. 11A)";Drugelių;9591229878;Ne;5;0;0;5
2678;"Gilužis (Vydūno g. 11A)";Drugelių;9092013248;Ne;9;4;0;13
2679;"Gilužis (Vydūno g. 11A)";Drugelių;9109883577;Ne;5;0;0;5
2680;"Gilužis (Vydūno g. 11A)";Drugelių;8006465211;Ne;5;0;0;5
2681;"Gilužis (Vydūno g. 11A)";Drugelių;5118401707;Ne;1;0;1;2
2682;"Gilužis (Vydūno g. 11A)";Drugelių;3190597262;Ne;6;0;0;6
2683;"Gilužis (Vydūno g. 11A)";Drugelių;2988856911;Ne;0;6;0;6
2684;"Gilužis (Vydūno g. 11A)";Drugelių;3532863024;Ne;0;19;0;19
2685;"Gilužis (Vydūno g. 11A)";Drugelių;1376645277;Ne;0;1;0;1
2686;"Gilužis (Vydūno g. 11A)";Drugelių;1410870589;Ne;6;6;0;12
2687;"Gilužis (Vydūno g. 11A)";Drugelių;6786334223;Ne;5;0;0;5
2688;"Gilužis (Vydūno g. 11A)";Drugelių;9112993465;Ne;6;0;0;6
2689;"Gilužis (Vydūno g. 11A)";Drugelių;4909329417;Ne;0;3;0;3
2690;"Gilužis (Vydūno g. 11A)";Drugelių;8244385001;Ne;0;3;0;3
2691;"Gilužis (Vydūno g. 11A)";Drugelių;6429142049;Ne;4;0;0;4
2692;"Gilužis (Vydūno g. 11A)";Drugelių;7731169885;Ne;1;4;0;5
2693;"Gilužis (Vydūno g. 11A)";Drugelių;1093643746;Ne;0;7;0;7
2694;"Gilužis (Vydūno g. 11A)";Drugelių;6950139609;Ne;4;0;1;5
2695;"Gilužis (Vydūno g. 11A)";Drugelių;2397231165;Ne;2;1;0;3
2696;"Gilužis (Vydūno g. 11A)";Saulučių;5705945483;Ne;0;10;0;10
2697;"Gilužis (Vydūno g. 11A)";Saulučių;8237963602;Ne;9;0;1;10
2698;"Gilužis (Vydūno g. 11A)";Saulučių;6914566889;Ne;4;5;0;9
2699;"Gilužis (Vydūno g. 11A)";Saulučių;5306278297;Ne;14;0;0;14
2700;"Gilužis (Vydūno g. 11A)";Saulučių;1054809163;Ne;9;0;0;9
2701;"Gilužis (Vydūno g. 11A)";Saulučių;7887970476;Ne;8;4;0;12
2702;"Gilužis (Vydūno g. 11A)";Saulučių;6507021182;Ne;3;4;1;8
2703;"Gilužis (Vydūno g. 11A)";Saulučių;4652281185;Ne;8;0;1;9
2704;"Gilužis (Vydūno g. 11A)";Saulučių;4122073923;Ne;3;0;0;3
2705;"Gilužis (Vydūno g. 11A)";Saulučių;2364391112;Ne;9;0;0;9
2706;"Gilužis (Vydūno g. 11A)";Saulučių;7068801003;Ne;4;0;1;5
2707;"Gilužis (Vydūno g. 11A)";Saulučių;3081351563;Ne;12;0;0;12
2708;"Gilužis (Vydūno g. 11A)";Saulučių;1015379578;Ne;6;0;0;6
2709;"Gilužis (Vydūno g. 11A)";Saulučių;7247606321;Ne;5;4;1;10
2710;"Gilužis (Vydūno g. 11A)";Saulučių;2915024298;Ne;2;0;2;4
2711;"Gilužis (Vydūno g. 11A)";Saulučių;2567788346;Ne;0;0;3;3
2712;"Gilužis (Vydūno g. 11A)";Saulučių;8717811266;Ne;1;0;1;2
2713;"Gilužis (Vydūno g. 11A)";Saulučių;5769955074;Ne;4;0;0;4
2714;"Gilužis (Vydūno g. 11A)";Saulučių;7487731015;Ne;5;0;0;5
2715;"Gilužis (Vydūno g. 11A)";Saulučių;5079154238;Ne;15;0;0;15
2716;"Gilužis (Vydūno g. 11A)";Saulučių;5490128851;Ne;19;0;0;19
2717;"Gilužis (Vydūno g. 11A)";Saulučių;5784201106;Ne;8;0;0;8
2718;"Gilužis (Vydūno g. 11A)";Saulučių;8904873416;Ne;5;0;0;5
2719;"Gilužis (Vydūno g. 11A)";Saulučių;2851682356;Ne;2;0;1;3
2720;"Gilužis (Vydūno g. 11A)";Paukštelių;8662424856;Ne;0;4;0;4
2721;"Gilužis (Vydūno g. 11A)";Paukštelių;8110869130;Ne;2;4;0;6
2722;"Gilužis (Vydūno g. 11A)";Paukštelių;9934325492;Ne;1;3;1;5
2723;"Gilužis (Vydūno g. 11A)";Paukštelių;2883959240;Ne;0;5;0;5
2724;"Gilužis (Vydūno g. 11A)";Paukštelių;6322255194;Ne;0;4;0;4
2725;"Gilužis (Vydūno g. 11A)";Paukštelių;6572690788;Ne;0;4;0;4
2726;"Gilužis (Vydūno g. 11A)";Paukštelių;4153834736;Ne;5;4;0;9
2727;"Gilužis (Vydūno g. 11A)";Paukštelių;3646988912;Ne;0;5;0;5
2728;"Gilužis (Vydūno g. 11A)";Paukštelių;5030871828;Ne;6;4;0;10
2729;"Gilužis (Vydūno g. 11A)";Paukštelių;9919631327;Ne;2;4;1;7
2730;"Gilužis (Vydūno g. 11A)";Paukštelių;3954379433;Ne;0;8;0;8
2731;"Gilužis (Vydūno g. 11A)";Paukštelių;6129884232;Ne;0;3;0;3
2732;"Gilužis (Vydūno g. 11A)";Paukštelių;9520598359;Ne;0;2;2;4
2733;"Gilužis (Vydūno g. 11A)";Paukštelių;3804996594;Ne;5;3;0;8
2734;"Gilužis (Vydūno g. 11A)";Paukštelių;7307386173;Ne;0;4;0;4
2735;"Gilužis (Vydūno g. 11A)";Paukštelių;6478152041;Ne;0;6;0;6
2736;"Gilužis (Vydūno g. 11A)";Paukštelių;2524936605;Ne;5;4;0;9
2737;"Gilužis (Vydūno g. 11A)";Paukštelių;1005178052;Ne;7;5;0;12
2738;"Gilužis (Vydūno g. 11A)";Paukštelių;3141225891;Ne;0;5;0;5
2739;"Gilužis (Vydūno g. 11A)";Obuoliukų;8201769917;Ne;0;5;0;5
2740;"Gilužis (Vydūno g. 11A)";Obuoliukų;9892608223;Ne;4;6;0;10
2741;"Gilužis (Vydūno g. 11A)";Obuoliukų;4058698645;Ne;0;7;0;7
2742;"Gilužis (Vydūno g. 11A)";Obuoliukų;1540018160;Ne;5;4;0;9
2743;"Gilužis (Vydūno g. 11A)";Obuoliukų;7716908903;Ne;0;2;0;2
2744;"Gilužis (Vydūno g. 11A)";Obuoliukų;3131597174;Ne;0;4;0;4
2745;"Gilužis (Vydūno g. 11A)";Obuoliukų;6239369861;Ne;9;4;0;13
2746;"Gilužis (Vydūno g. 11A)";Obuoliukų;6172360933;Ne;7;4;0;11
2747;"Gilužis (Vydūno g. 11A)";Obuoliukų;7398446674;Ne;0;4;0;4
2748;"Gilužis (Vydūno g. 11A)";Obuoliukų;4592380105;Ne;17;2;0;19
2749;"Gilužis (Vydūno g. 11A)";Obuoliukų;4242362889;Ne;0;4;0;4
2750;"Gilužis (Vydūno g. 11A)";Obuoliukų;7560732216;Ne;0;4;0;4
2751;"Gilužis (Vydūno g. 11A)";Obuoliukų;5476140202;Ne;0;4;0;4
2752;"Gilužis (Vydūno g. 11A)";Obuoliukų;8194444043;Ne;5;2;0;7
2753;"Gilužis (Vydūno g. 11A)";Obuoliukų;7606394325;Ne;10;6;0;16
2754;"Gilužis (Vydūno g. 11A)";Obuoliukų;6737884137;Ne;0;10;0;10
2755;"Gilužis (Vydūno g. 11A)";Obuoliukų;6825745985;Ne;3;5;0;8
2756;"Gilužis (Vydūno g. 11A)";Obuoliukų;3458957423;Ne;3;4;0;7
2757;"Gilužis (Vydūno g. 11A)";Obuoliukų;8900414658;Ne;0;5;0;5
2758;"Gilužis (Vydūno g. 11A)";Obuoliukų;3219101391;Ne;7;6;0;13
2759;"Gilužis (Vydūno g. 11A)";Obuoliukų;4528131001;Ne;11;1;0;12
2760;"Gilužis (Vydūno g. 11A)";Obuoliukų;5895659747;Ne;6;11;0;17
2761;"Gilužis (Vydūno g. 11A)";Obuoliukų;3331616067;Ne;5;4;1;10
2762;"Gilužis (Vydūno g. 11A)";KIŠKUČIŲ;5744027226;Ne;0;5;0;5
2763;"Gilužis (Vydūno g. 11A)";KIŠKUČIŲ;8639633038;Ne;5;4;0;9
2764;"Gilužis (Vydūno g. 11A)";KIŠKUČIŲ;5721924532;Ne;0;3;0;3
2765;"Gilužis (Vydūno g. 11A)";KIŠKUČIŲ;9484221435;Ne;0;1;0;1
2766;"Gilužis (Vydūno g. 11A)";KIŠKUČIŲ;2680643896;Ne;0;11;0;11
2767;"Gilužis (Vydūno g. 11A)";KIŠKUČIŲ;5685074731;Ne;2;0;0;2
2768;"Gilužis (Vydūno g. 11A)";KIŠKUČIŲ;3649616461;Ne;2;2;0;4
2769;"Gilužis (Vydūno g. 11A)";KIŠKUČIŲ;7632771776;Ne;4;1;0;5
2770;"Gilužis (Vydūno g. 11A)";KIŠKUČIŲ;7477282548;Ne;7;0;1;8
2771;"Gilužis (Vydūno g. 11A)";KIŠKUČIŲ;9061835019;Ne;4;0;1;5
2772;"Gilužis (Vydūno g. 11A)";KIŠKUČIŲ;7560574633;Ne;7;1;0;8
2773;"Gilužis (Vydūno g. 11A)";KIŠKUČIŲ;4199633620;Ne;11;4;4;19
2774;"Gilužis (Vydūno g. 11A)";KIŠKUČIŲ;9851612698;Ne;13;1;0;14
2775;"Gilužis (Vydūno g. 11A)";KIŠKUČIŲ;1391410955;Ne;19;0;0;19
2776;"Gilužis (Vydūno g. 11A)";KIŠKUČIŲ;6383469680;Ne;0;13;0;13
2777;"Gilužis (Vydūno g. 11A)";KIŠKUČIŲ;8341597766;Taip;4;0;1;5
2778;"Gilužis (Vydūno g. 11A)";KIŠKUČIŲ;3171560628;Ne;3;1;0;4
2779;"Gilužis (Vydūno g. 11A)";KIŠKUČIŲ;4347319425;Ne;4;4;0;8
2780;"Gilužis (Vydūno g. 11A)";KIŠKUČIŲ;8591741716;Ne;4;1;0;5
2781;"Gilužis (Vydūno g. 11A)";KIŠKUČIŲ;8877445672;Ne;15;0;0;15
2782;"Gilužis (Vydūno g. 11A)";KIŠKUČIŲ;9489594782;Ne;3;3;0;6
2783;"Gilužis (Vydūno g. 11A)";KIŠKUČIŲ;7696478568;Taip;3;0;1;4
2784;"Gilužis (Vydūno g. 11A)";Meškučių;7263432152;Ne;6;4;0;10
2785;"Gilužis (Vydūno g. 11A)";Meškučių;4655266106;Ne;7;2;0;9
2786;"Gilužis (Vydūno g. 11A)";Meškučių;3800593189;Ne;2;7;0;9
2787;"Gilužis (Vydūno g. 11A)";Meškučių;4174307847;Ne;6;0;0;6
2788;"Gilužis (Vydūno g. 11A)";Meškučių;8393554697;Ne;0;8;0;8
2789;"Gilužis (Vydūno g. 11A)";Meškučių;8301535013;Ne;3;3;0;6
2790;"Gilužis (Vydūno g. 11A)";Meškučių;2939982311;Ne;15;4;0;19
2791;"Gilužis (Vydūno g. 11A)";Meškučių;3365778697;Ne;6;7;0;13
2792;"Gilužis (Vydūno g. 11A)";Meškučių;7912093880;Taip;6;4;0;10
2793;"Gilužis (Vydūno g. 11A)";Meškučių;2389277783;Ne;1;4;0;5
2794;"Gilužis (Vydūno g. 11A)";Meškučių;2500949029;Ne;3;5;0;8
2795;"Gilužis (Vydūno g. 11A)";Meškučių;4741129495;Ne;6;5;0;11
2796;"Gilužis (Vydūno g. 11A)";Meškučių;7992750316;Ne;0;19;0;19
2797;"Gilužis (Vydūno g. 11A)";Meškučių;5505153657;Ne;0;3;0;3
2798;"Gilužis (Vydūno g. 11A)";Meškučių;2577554894;Ne;4;4;0;8
2799;"Gilužis (Vydūno g. 11A)";Meškučių;3148477315;Ne;11;3;0;14
2800;"Gilužis (Vydūno g. 11A)";Meškučių;1068375927;Ne;2;0;0;2
2801;"Gilužis (Vydūno g. 11A)";Meškučių;8476240141;Ne;5;0;0;5
2802;"Gilužis (Vydūno g. 11A)";Meškučių;6185280967;Ne;14;0;0;14
2803;"Gilužis (Vydūno g. 11A)";Meškučių;5177805719;Ne;7;4;0;11
2804;"Gilužis (Vydūno g. 11A)";Meškučių;7045940267;Ne;13;0;0;13
2805;"Gilužis (Vydūno g. 11A)";Meškučių;5654754316;Ne;11;0;0;11
2806;"Gilužis (Vydūno g. 11A)";Pagrandukai;6884146146;Ne;2;5;0;7
2807;"Gilužis (Vydūno g. 11A)";Pagrandukai;6920910054;Ne;10;6;0;16
2808;"Gilužis (Vydūno g. 11A)";Pagrandukai;6501973647;Ne;0;3;0;3
2809;"Gilužis (Vydūno g. 11A)";Pagrandukai;5397975739;Ne;0;3;0;3
2810;"Gilužis (Vydūno g. 11A)";Pagrandukai;6109205159;Ne;0;2;0;2
2811;"Gilužis (Vydūno g. 11A)";Pagrandukai;2328338059;Ne;0;2;0;2
2812;"Gilužis (Vydūno g. 11A)";Pagrandukai;5376639182;Ne;3;3;0;6
2813;"Gilužis (Vydūno g. 11A)";Pagrandukai;5378701300;Ne;0;2;0;2
2814;"Gilužis (Vydūno g. 11A)";Pagrandukai;3366788027;Ne;0;2;0;2
2815;"Gilužis (Vydūno g. 11A)";Pagrandukai;5184511012;Ne;13;1;0;14
2816;"Gilužis (Vydūno g. 11A)";Pagrandukai;9587502317;Ne;13;1;0;14
2817;"Gilužis (Vydūno g. 11A)";Pagrandukai;5334441484;Ne;1;4;0;5
2818;"Gilužis (Vydūno g. 11A)";Pagrandukai;6485579727;Ne;8;0;0;8
2819;"Gilužis (Vydūno g. 11A)";Pagrandukai;8477445384;Ne;0;0;1;1
2820;"Gilužis (Vydūno g. 11A)";Pagrandukai;1758670627;Ne;1;1;0;2
2821;"Gilužis (Vydūno g. 11A)";Pagrandukai;6766559505;Taip;7;2;0;9
2822;"Gilužis (Vydūno g. 11A)";Pagrandukai;5737505086;Ne;0;3;1;4
2823;"Gilužis (Vydūno g. 11A)";Pagrandukai;3729538163;Ne;6;1;0;7
2824;"Gilužis (Vydūno g. 11A)";Pagrandukai;6207304860;Ne;3;2;0;5
2825;"Gilužis (Vydūno g. 11A)";Pagrandukai;5921538837;Ne;4;6;0;10
2826;"Gilužis (Vydūno g. 11A)";Pagrandukai;9846916206;Ne;13;2;0;15
2827;"Gilužis (Vydūno g. 11A)";Pagrandukai;9325927745;Ne;19;0;0;19
2828;"Gilužis (Vydūno g. 11A)";Pagrandukai;4927117901;Ne;2;4;0;6
2829;"Gilužis (Vydūno g. 11A)";Boružėlių;5581417252;Ne;11;6;0;17
2830;"Gilužis (Vydūno g. 11A)";Boružėlių;2819680099;Ne;0;3;0;3
2831;"Gilužis (Vydūno g. 11A)";Boružėlių;1209632075;Ne;8;3;0;11
2832;"Gilužis (Vydūno g. 11A)";Boružėlių;9753512366;Ne;11;5;0;16
2833;"Gilužis (Vydūno g. 11A)";Boružėlių;1541283216;Ne;8;0;0;8
2834;"Gilužis (Vydūno g. 11A)";Boružėlių;6514483362;Ne;3;0;1;4
2835;"Gilužis (Vydūno g. 11A)";Boružėlių;5664892047;Ne;6;0;1;7
2836;"Gilužis (Vydūno g. 11A)";Boružėlių;3379889899;Ne;11;0;0;11
2837;"Gilužis (Vydūno g. 11A)";Boružėlių;3917385813;Taip;10;0;0;10
2838;"Gilužis (Vydūno g. 11A)";Boružėlių;3194397689;Ne;6;0;0;6
2839;"Gilužis (Vydūno g. 11A)";Boružėlių;6586605929;Ne;11;0;0;11
2840;"Gilužis (Vydūno g. 11A)";Boružėlių;4325300253;Ne;4;0;0;4
2841;"Gilužis (Vydūno g. 11A)";Boružėlių;1826248450;Ne;7;3;0;10
2842;"Gilužis (Vydūno g. 11A)";Boružėlių;3279830266;Ne;7;0;0;7
2843;"Gilužis (Vydūno g. 11A)";Boružėlių;9676661005;Ne;7;0;0;7
2844;"Gilužis (Vydūno g. 11A)";Boružėlių;1306757860;Ne;7;0;0;7
2845;"Gilužis (Vydūno g. 11A)";Boružėlių;1604096952;Ne;9;0;0;9
2846;"Gilužis (Vydūno g. 11A)";Boružėlių;4266998302;Ne;10;1;0;11
2847;"Gintarėlis (Didlaukio g. 35)";PAPŪGĖLĖS;6402043654;Ne;3;3;0;6
2848;"Gintarėlis (Didlaukio g. 35)";PAPŪGĖLĖS;6558614008;Ne;11;4;0;15
2849;"Gintarėlis (Didlaukio g. 35)";PAPŪGĖLĖS;4348245746;Ne;0;3;0;3
2850;"Gintarėlis (Didlaukio g. 35)";PAPŪGĖLĖS;1400817076;Ne;6;0;0;6
2851;"Gintarėlis (Didlaukio g. 35)";PAPŪGĖLĖS;7372735642;Ne;1;0;0;1
2852;"Gintarėlis (Didlaukio g. 35)";PAPŪGĖLĖS;3091731769;Ne;4;5;0;9
2853;"Gintarėlis (Didlaukio g. 35)";PAPŪGĖLĖS;6484966941;Ne;0;4;0;4
2854;"Gintarėlis (Didlaukio g. 35)";PAPŪGĖLĖS;9476258741;Ne;1;2;0;3
2855;"Gintarėlis (Didlaukio g. 35)";PAPŪGĖLĖS;9004590065;Ne;2;4;0;6
2856;"Gintarėlis (Didlaukio g. 35)";PAPŪGĖLĖS;2624469768;Ne;0;2;0;2
2857;"Gintarėlis (Didlaukio g. 35)";PAPŪGĖLĖS;8784796186;Ne;0;6;0;6
2858;"Gintarėlis (Didlaukio g. 35)";PAPŪGĖLĖS;9622824643;Ne;14;0;0;14
2859;"Gintarėlis (Didlaukio g. 35)";PAPŪGĖLĖS;8516817506;Ne;0;2;0;2
2860;"Gintarėlis (Didlaukio g. 35)";PAPŪGĖLĖS;4809352525;Ne;0;4;0;4
2861;"Gintarėlis (Didlaukio g. 35)";PAPŪGĖLĖS;1371258551;Ne;3;2;0;5
2862;"Gintarėlis (Didlaukio g. 35)";PAPŪGĖLĖS;9970786396;Ne;4;6;0;10
2863;"Gintarėlis (Didlaukio g. 35)";PAPŪGĖLĖS;7118758040;Ne;3;4;0;7
2864;"Gintarėlis (Didlaukio g. 35)";PAPŪGĖLĖS;8213388778;Ne;3;0;0;3
2865;"Gintarėlis (Didlaukio g. 35)";PAPŪGĖLĖS;8355089218;Ne;4;1;0;5
2866;"Gintarėlis (Didlaukio g. 35)";PAPŪGĖLĖS;8471302686;Ne;5;4;0;9
2867;"Gintarėlis (Didlaukio g. 35)";PAPŪGĖLĖS;4266286613;Ne;11;2;0;13
2868;"Gintarėlis (Didlaukio g. 35)";SPINDULIUKAI;8498936096;Ne;0;4;0;4
2869;"Gintarėlis (Didlaukio g. 35)";SPINDULIUKAI;8913652291;Ne;4;4;0;8
2870;"Gintarėlis (Didlaukio g. 35)";SPINDULIUKAI;2485750596;Ne;0;4;0;4
2871;"Gintarėlis (Didlaukio g. 35)";SPINDULIUKAI;8610886062;Ne;5;5;0;10
2872;"Gintarėlis (Didlaukio g. 35)";SPINDULIUKAI;1033624080;Ne;0;3;0;3
2873;"Gintarėlis (Didlaukio g. 35)";SPINDULIUKAI;5811396263;Ne;0;4;0;4
2874;"Gintarėlis (Didlaukio g. 35)";SPINDULIUKAI;2919700367;Ne;4;5;0;9
2875;"Gintarėlis (Didlaukio g. 35)";SPINDULIUKAI;1511718436;Ne;0;10;0;10
2876;"Gintarėlis (Didlaukio g. 35)";SPINDULIUKAI;1768789948;Ne;3;2;0;5
2877;"Gintarėlis (Didlaukio g. 35)";SPINDULIUKAI;2595566032;Ne;1;3;0;4
2878;"Gintarėlis (Didlaukio g. 35)";SPINDULIUKAI;9141438560;Ne;1;3;0;4
2879;"Gintarėlis (Didlaukio g. 35)";SPINDULIUKAI;2235045173;Ne;0;4;0;4
2880;"Gintarėlis (Didlaukio g. 35)";SPINDULIUKAI;9494521554;Ne;0;6;0;6
2881;"Gintarėlis (Didlaukio g. 35)";SPINDULIUKAI;7494884360;Ne;4;3;0;7
2882;"Gintarėlis (Didlaukio g. 35)";SPINDULIUKAI;1648843117;Ne;2;3;0;5
2883;"Gintarėlis (Didlaukio g. 35)";SPINDULIUKAI;7147842224;Ne;0;4;0;4
2884;"Gintarėlis (Didlaukio g. 35)";SPINDULIUKAI;5783939567;Ne;0;5;2;7
2885;"Gintarėlis (Didlaukio g. 35)";SPINDULIUKAI;7674351459;Ne;0;4;0;4
2886;"Gintarėlis (Didlaukio g. 35)";SPINDULIUKAI;1861324153;Ne;0;7;0;7
2887;"Gintarėlis (Didlaukio g. 35)";SPINDULIUKAI;3457974670;Ne;6;4;0;10
2888;"Gintarėlis (Didlaukio g. 35)";SPINDULIUKAI;6080108998;Ne;0;6;0;6
2889;"Gintarėlis (Didlaukio g. 35)";SPINDULIUKAI;6655645997;Ne;0;6;0;6
2890;"Gintarėlis (Didlaukio g. 35)";SPINDULIUKAI;4484711857;Ne;0;4;0;4
2891;"Gintarėlis (Didlaukio g. 35)";SPINDULIUKAI;6292664833;Ne;2;3;0;5
2892;"Gintarėlis (Didlaukio g. 35)";LAŠIUKAI;6377674849;Ne;0;4;0;4
2893;"Gintarėlis (Didlaukio g. 35)";LAŠIUKAI;3820683506;Ne;0;4;0;4
2894;"Gintarėlis (Didlaukio g. 35)";LAŠIUKAI;2904118045;Ne;0;1;0;1
2895;"Gintarėlis (Didlaukio g. 35)";LAŠIUKAI;5717123412;Ne;1;5;0;6
2896;"Gintarėlis (Didlaukio g. 35)";LAŠIUKAI;3794027499;Ne;6;5;0;11
2897;"Gintarėlis (Didlaukio g. 35)";LAŠIUKAI;7813187438;Ne;0;4;0;4
2898;"Gintarėlis (Didlaukio g. 35)";LAŠIUKAI;9234476307;Ne;6;4;0;10
2899;"Gintarėlis (Didlaukio g. 35)";LAŠIUKAI;6561070982;Ne;0;8;0;8
2900;"Gintarėlis (Didlaukio g. 35)";LAŠIUKAI;2203238888;Ne;0;4;0;4
2901;"Gintarėlis (Didlaukio g. 35)";LAŠIUKAI;3484172382;Ne;0;4;0;4
2902;"Gintarėlis (Didlaukio g. 35)";LAŠIUKAI;2256002308;Ne;8;4;0;12
2903;"Gintarėlis (Didlaukio g. 35)";LAŠIUKAI;6607854244;Ne;0;4;0;4
2904;"Gintarėlis (Didlaukio g. 35)";LAŠIUKAI;1327681704;Ne;3;4;0;7
2905;"Gintarėlis (Didlaukio g. 35)";LAŠIUKAI;3987801707;Ne;7;0;0;7
2906;"Gintarėlis (Didlaukio g. 35)";LAŠIUKAI;7123016029;Ne;0;3;0;3
2907;"Gintarėlis (Didlaukio g. 35)";LAŠIUKAI;3000371147;Ne;0;3;0;3
2908;"Gintarėlis (Didlaukio g. 35)";LAŠIUKAI;7976989629;Ne;7;4;0;11
2909;"Gintarėlis (Didlaukio g. 35)";LAŠIUKAI;3444997417;Ne;0;3;0;3
2910;"Gintarėlis (Didlaukio g. 35)";LAŠIUKAI;8982034601;Ne;0;4;0;4
2911;"Gintarėlis (Didlaukio g. 35)";LAŠIUKAI;6545866812;Ne;2;6;0;8
2912;"Gintarėlis (Didlaukio g. 35)";LAŠIUKAI;5467958458;Ne;7;4;0;11
2913;"Gintarėlis (Didlaukio g. 35)";MEŠKUČIAI;2926488239;Ne;0;5;0;5
2914;"Gintarėlis (Didlaukio g. 35)";MEŠKUČIAI;6618240550;Ne;0;4;0;4
2915;"Gintarėlis (Didlaukio g. 35)";MEŠKUČIAI;8790078624;Ne;5;0;0;5
2916;"Gintarėlis (Didlaukio g. 35)";MEŠKUČIAI;2518840573;Ne;10;1;0;11
2917;"Gintarėlis (Didlaukio g. 35)";MEŠKUČIAI;5187894822;Ne;0;5;0;5
2918;"Gintarėlis (Didlaukio g. 35)";MEŠKUČIAI;3630567294;Ne;3;4;0;7
2919;"Gintarėlis (Didlaukio g. 35)";MEŠKUČIAI;5181872438;Ne;4;4;0;8
2920;"Gintarėlis (Didlaukio g. 35)";MEŠKUČIAI;1565802953;Ne;0;19;0;19
2921;"Gintarėlis (Didlaukio g. 35)";MEŠKUČIAI;2072435242;Ne;2;4;0;6
2922;"Gintarėlis (Didlaukio g. 35)";MEŠKUČIAI;7989239799;Ne;0;4;0;4
2923;"Gintarėlis (Didlaukio g. 35)";MEŠKUČIAI;4356211536;Ne;11;0;0;11
2924;"Gintarėlis (Didlaukio g. 35)";MEŠKUČIAI;1502740714;Ne;3;4;0;7
2925;"Gintarėlis (Didlaukio g. 35)";MEŠKUČIAI;6636835034;Ne;0;6;0;6
2926;"Gintarėlis (Didlaukio g. 35)";MEŠKUČIAI;3830154353;Ne;0;1;0;1
2927;"Gintarėlis (Didlaukio g. 35)";MEŠKUČIAI;3947405446;Ne;3;2;0;5
2928;"Gintarėlis (Didlaukio g. 35)";MEŠKUČIAI;7948438165;Ne;0;4;0;4
2929;"Gintarėlis (Didlaukio g. 35)";MEŠKUČIAI;4642142931;Ne;8;7;0;15
2930;"Gintarėlis (Didlaukio g. 35)";MEŠKUČIAI;6711753930;Ne;0;4;0;4
2931;"Gintarėlis (Didlaukio g. 35)";MEŠKUČIAI;9017592249;Ne;0;5;0;5
2932;"Gintarėlis (Didlaukio g. 35)";MEŠKUČIAI;8375475174;Ne;0;18;0;18
2933;"Gintarėlis (Didlaukio g. 35)";MEŠKUČIAI;7029401386;Ne;5;0;0;5
2934;"Gintarėlis (Didlaukio g. 35)";MEŠKUČIAI;1790629500;Ne;14;0;0;14
2935;"Gintarėlis (Didlaukio g. 35)";MEŠKUČIAI;7320085613;Ne;0;2;0;2
2936;"Gintarėlis (Didlaukio g. 35)";MEŠKUČIAI;3271736540;Ne;3;5;0;8
2937;"Gintarėlis (Didlaukio g. 35)";KAČIUKAI;5569843168;Ne;0;5;0;5
2938;"Gintarėlis (Didlaukio g. 35)";KAČIUKAI;3665764153;Ne;0;6;0;6
2939;"Gintarėlis (Didlaukio g. 35)";KAČIUKAI;9774056578;Ne;0;6;0;6
2940;"Gintarėlis (Didlaukio g. 35)";KAČIUKAI;2212296954;Ne;0;4;1;5
2941;"Gintarėlis (Didlaukio g. 35)";KAČIUKAI;3825700024;Ne;0;3;0;3
2942;"Gintarėlis (Didlaukio g. 35)";KAČIUKAI;7057877483;Ne;0;3;0;3
2943;"Gintarėlis (Didlaukio g. 35)";KAČIUKAI;9825811100;Ne;4;4;1;9
2944;"Gintarėlis (Didlaukio g. 35)";KAČIUKAI;7875981690;Ne;14;5;0;19
2945;"Gintarėlis (Didlaukio g. 35)";KAČIUKAI;2544338275;Ne;14;5;0;19
2946;"Gintarėlis (Didlaukio g. 35)";KAČIUKAI;9963329170;Taip;0;1;0;1
2947;"Gintarėlis (Didlaukio g. 35)";KAČIUKAI;4754929282;Ne;0;1;0;1
2948;"Gintarėlis (Didlaukio g. 35)";KAČIUKAI;5214984111;Ne;0;2;0;2
2949;"Gintarėlis (Didlaukio g. 35)";KAČIUKAI;1011749698;Ne;4;8;1;13
2950;"Gintarėlis (Didlaukio g. 35)";KAČIUKAI;8261770154;Ne;0;9;0;9
2951;"Gintarėlis (Didlaukio g. 35)";KAČIUKAI;7061545258;Ne;4;4;0;8
2952;"Gintarėlis (Didlaukio g. 35)";KAČIUKAI;5436695400;Ne;0;3;0;3
2953;"Gintarėlis (Didlaukio g. 35)";KAČIUKAI;5921751507;Ne;5;4;0;9
2954;"Gintarėlis (Didlaukio g. 35)";KAČIUKAI;9450900915;Ne;5;4;2;11
2955;"Gintarėlis (Didlaukio g. 35)";KAČIUKAI;5153948767;Ne;0;8;0;8
2956;"Gintarėlis (Didlaukio g. 35)";KAČIUKAI;3814485627;Ne;3;6;1;10
2957;"Gintarėlis (Didlaukio g. 35)";KAČIUKAI;1571260478;Ne;5;5;0;10
2958;"Gintarėlis (Didlaukio g. 35)";KAČIUKAI;9244715396;Ne;0;6;0;6
2959;"Gintarėlis (Didlaukio g. 35)";KAČIUKAI;3015327416;Ne;6;3;0;9
2960;"Gintarėlis (Didlaukio g. 35)";KIŠKUČIAI;7143014339;Ne;5;4;0;9
2961;"Gintarėlis (Didlaukio g. 35)";KIŠKUČIAI;1918879534;Ne;5;2;0;7
2962;"Gintarėlis (Didlaukio g. 35)";KIŠKUČIAI;7509100750;Ne;0;12;0;12
2963;"Gintarėlis (Didlaukio g. 35)";KIŠKUČIAI;5965570522;Ne;4;4;0;8
2964;"Gintarėlis (Didlaukio g. 35)";KIŠKUČIAI;8286814809;Ne;0;5;0;5
2965;"Gintarėlis (Didlaukio g. 35)";KIŠKUČIAI;3839660368;Ne;0;6;4;10
2966;"Gintarėlis (Didlaukio g. 35)";KIŠKUČIAI;5509394003;Ne;8;0;0;8
2967;"Gintarėlis (Didlaukio g. 35)";KIŠKUČIAI;3538300416;Ne;0;1;0;1
2968;"Gintarėlis (Didlaukio g. 35)";KIŠKUČIAI;9501012756;Ne;5;2;0;7
2969;"Gintarėlis (Didlaukio g. 35)";KIŠKUČIAI;7059730814;Ne;3;0;0;3
2970;"Gintarėlis (Didlaukio g. 35)";KIŠKUČIAI;9179216093;Ne;0;1;0;1
2971;"Gintarėlis (Didlaukio g. 35)";KIŠKUČIAI;1326797813;Ne;8;4;0;12
2972;"Gintarėlis (Didlaukio g. 35)";KIŠKUČIAI;7629635034;Taip;9;0;0;9
2973;"Gintarėlis (Didlaukio g. 35)";KIŠKUČIAI;1918458858;Ne;10;0;0;10
2974;"Gintarėlis (Didlaukio g. 35)";KIŠKUČIAI;2234295991;Taip;0;4;0;4
2975;"Gintarėlis (Didlaukio g. 35)";KIŠKUČIAI;8410642485;Ne;3;0;0;3
2976;"Gintarėlis (Didlaukio g. 35)";KIŠKUČIAI;3235154374;Ne;6;3;0;9
2977;"Gintarėlis (Didlaukio g. 35)";KIŠKUČIAI;6047468576;Ne;4;2;0;6
2978;"Gintarėlis (Didlaukio g. 35)";BORUŽĖLĖS;2499727321;Ne;10;6;0;16
2979;"Gintarėlis (Didlaukio g. 35)";BORUŽĖLĖS;2949035147;Ne;0;3;0;3
2980;"Gintarėlis (Didlaukio g. 35)";BORUŽĖLĖS;5991638696;Ne;5;2;0;7
2981;"Gintarėlis (Didlaukio g. 35)";BORUŽĖLĖS;6563281778;Ne;3;4;0;7
2982;"Gintarėlis (Didlaukio g. 35)";BORUŽĖLĖS;6133476137;Ne;17;0;0;17
2983;"Gintarėlis (Didlaukio g. 35)";BORUŽĖLĖS;6751822184;Ne;0;5;0;5
2984;"Gintarėlis (Didlaukio g. 35)";BORUŽĖLĖS;8721340357;Ne;5;0;3;8
2985;"Gintarėlis (Didlaukio g. 35)";BORUŽĖLĖS;6138593853;Ne;0;4;0;4
2986;"Gintarėlis (Didlaukio g. 35)";BORUŽĖLĖS;1482227839;Ne;6;6;0;12
2987;"Gintarėlis (Didlaukio g. 35)";BORUŽĖLĖS;3876016666;Ne;7;0;0;7
2988;"Gintarėlis (Didlaukio g. 35)";BORUŽĖLĖS;5338409090;Ne;0;8;0;8
2989;"Gintarėlis (Didlaukio g. 35)";BORUŽĖLĖS;8403881160;Ne;0;12;0;12
2990;"Gintarėlis (Didlaukio g. 35)";BORUŽĖLĖS;4462515146;Ne;0;4;0;4
2991;"Gintarėlis (Didlaukio g. 35)";BORUŽĖLĖS;2809388552;Ne;4;0;3;7
2992;"Gintarėlis (Didlaukio g. 35)";BORUŽĖLĖS;4686913324;Ne;0;2;0;2
2993;"Gintarėlis (Didlaukio g. 35)";BORUŽĖLĖS;2488622623;Ne;2;3;1;6
2994;"Gintarėlis (Didlaukio g. 35)";BORUŽĖLĖS;2482981227;Ne;11;0;1;12
2995;"Gintarėlis (Didlaukio g. 35)";BORUŽĖLĖS;8279078612;Ne;5;6;0;11
2996;"Gintarėlis (Didlaukio g. 35)";BORUŽĖLĖS;4146454470;Ne;9;0;0;9
2997;"Gintarėlis (Didlaukio g. 35)";BORUŽĖLĖS;7690748176;Ne;4;0;0;4
2998;"Gintarėlis (Didlaukio g. 35)";BORUŽĖLĖS;5824210469;Ne;0;0;1;1
2999;"Gintarėlis (Didlaukio g. 35)";EŽIUKAI;1082941468;Ne;0;2;0;2
3000;"Gintarėlis (Didlaukio g. 35)";EŽIUKAI;8529974367;Ne;0;5;0;5
3001;"Gintarėlis (Didlaukio g. 35)";EŽIUKAI;6991746305;Ne;2;2;0;4
3002;"Gintarėlis (Didlaukio g. 35)";EŽIUKAI;4623909811;Ne;0;4;0;4
3003;"Gintarėlis (Didlaukio g. 35)";EŽIUKAI;3357866319;Ne;0;5;0;5
3004;"Gintarėlis (Didlaukio g. 35)";EŽIUKAI;2814569415;Ne;0;7;0;7
3005;"Gintarėlis (Didlaukio g. 35)";EŽIUKAI;5355691986;Ne;0;4;0;4
3006;"Gintarėlis (Didlaukio g. 35)";EŽIUKAI;5796729245;Ne;0;6;0;6
3007;"Gintarėlis (Didlaukio g. 35)";EŽIUKAI;9915887420;Ne;0;6;0;6
3008;"Gintarėlis (Didlaukio g. 35)";EŽIUKAI;3792697409;Ne;4;4;1;9
3009;"Gintarėlis (Didlaukio g. 35)";EŽIUKAI;8287685690;Ne;0;4;0;4
3010;"Gintarėlis (Didlaukio g. 35)";EŽIUKAI;7815317644;Ne;0;10;0;10
3011;"Gintarėlis (Didlaukio g. 35)";EŽIUKAI;2165332442;Ne;0;2;0;2
3012;"Gintarėlis (Didlaukio g. 35)";EŽIUKAI;6914904213;Ne;3;5;0;8
3013;"Gintarėlis (Didlaukio g. 35)";EŽIUKAI;1696337909;Ne;3;5;0;8
3014;"Gintarėlis (Didlaukio g. 35)";EŽIUKAI;8116557698;Ne;0;5;0;5
3015;"Gintarėlis (Didlaukio g. 35)";EŽIUKAI;6862629244;Ne;0;2;0;2
3016;"Gintarėlis (Didlaukio g. 35)";EŽIUKAI;3398936974;Ne;2;3;0;5
3017;"Gintarėlis (Didlaukio g. 35)";EŽIUKAI;8704248985;Ne;0;6;0;6
3018;"Gintarėlis (Didlaukio g. 35)";"SAULĖS ZUIKUČIAI";5336654560;Ne;7;2;0;9
3019;"Gintarėlis (Didlaukio g. 35)";"SAULĖS ZUIKUČIAI";3732252177;Ne;7;2;0;9
3020;"Gintarėlis (Didlaukio g. 35)";"SAULĖS ZUIKUČIAI";4087751760;Ne;0;6;0;6
3021;"Gintarėlis (Didlaukio g. 35)";"SAULĖS ZUIKUČIAI";7004430575;Ne;0;2;0;2
3022;"Gintarėlis (Didlaukio g. 35)";"SAULĖS ZUIKUČIAI";5103780852;Ne;1;2;0;3
3023;"Gintarėlis (Didlaukio g. 35)";"SAULĖS ZUIKUČIAI";4579612197;Ne;14;0;2;16
3024;"Gintarėlis (Didlaukio g. 35)";"SAULĖS ZUIKUČIAI";4127749930;Ne;19;0;0;19
3025;"Gintarėlis (Didlaukio g. 35)";"SAULĖS ZUIKUČIAI";5594809861;Ne;8;6;0;14
3026;"Gintarėlis (Didlaukio g. 35)";"SAULĖS ZUIKUČIAI";5593638575;Ne;5;4;0;9
3027;"Gintarėlis (Didlaukio g. 35)";"SAULĖS ZUIKUČIAI";5064767935;Ne;9;0;2;11
3028;"Gintarėlis (Didlaukio g. 35)";"SAULĖS ZUIKUČIAI";8170509526;Ne;13;1;0;14
3029;"Gintarėlis (Didlaukio g. 35)";"SAULĖS ZUIKUČIAI";1408481989;Ne;0;6;1;7
3030;"Gintarėlis (Didlaukio g. 35)";"SAULĖS ZUIKUČIAI";5109775795;Ne;10;0;2;12
3031;"Gintarėlis (Didlaukio g. 35)";"SAULĖS ZUIKUČIAI";4811778274;Ne;0;5;0;5
3032;"Gintarėlis (Didlaukio g. 35)";"SAULĖS ZUIKUČIAI";1158055621;Ne;0;6;0;6
3033;"Gintarėlis (Didlaukio g. 35)";"SAULĖS ZUIKUČIAI";1474802737;Ne;10;4;0;14
3034;"Gintarėlis (Didlaukio g. 35)";"SAULĖS ZUIKUČIAI";4199030732;Ne;19;0;0;19
3035;"Gintarėlis (Didlaukio g. 35)";Šypsenėlės;3575375401;Ne;0;5;1;6
3036;"Gintarėlis (Didlaukio g. 35)";Šypsenėlės;3575375401;Ne;0;5;1;6
3037;"Gintarėlis (Didlaukio g. 35)";Šypsenėlės;3575375401;Ne;0;5;1;6
3038;"Gintarėlis (Didlaukio g. 35)";Šypsenėlės;9020619501;Ne;0;4;0;4
3039;"Gintarėlis (Didlaukio g. 35)";Šypsenėlės;5120761293;Ne;0;4;0;4
3040;"Gintarėlis (Didlaukio g. 35)";Šypsenėlės;9413836091;Ne;0;4;0;4
3041;"Gintarėlis (Didlaukio g. 35)";Šypsenėlės;7337543180;Ne;0;7;0;7
3042;"Gintarėlis (Didlaukio g. 35)";Šypsenėlės;7337543180;Ne;0;7;0;7
3043;"Gintarėlis (Didlaukio g. 35)";Šypsenėlės;7337543180;Ne;0;7;0;7
3044;"Gintarėlis (Didlaukio g. 35)";Šypsenėlės;1567290856;Ne;4;4;0;8
3045;"Gintarėlis (Didlaukio g. 35)";Šypsenėlės;7661638176;Taip;0;6;0;6
3046;"Gintarėlis (Didlaukio g. 35)";Šypsenėlės;9477018713;Ne;10;4;0;14
3047;"Gintarėlis (Didlaukio g. 35)";Šypsenėlės;9477018713;Ne;10;4;0;14
3048;"Gintarėlis (Didlaukio g. 35)";Šypsenėlės;9477018713;Ne;10;4;0;14
3049;"Gintarėlis (Didlaukio g. 35)";Šypsenėlės;3088663209;Ne;10;4;0;14
3050;"Gintarėlis (Didlaukio g. 35)";Šypsenėlės;3459439843;Ne;0;8;0;8
3051;"Gintarėlis (Didlaukio g. 35)";Šypsenėlės;1872534206;Ne;0;4;0;4
3052;"Gintarėlis (Didlaukio g. 35)";Šypsenėlės;4334349824;Ne;0;4;0;4
3053;"Gintarėlis (Didlaukio g. 35)";Šypsenėlės;9954282865;Ne;0;4;0;4
3054;"Gintarėlis (Didlaukio g. 35)";Šypsenėlės;8768094601;Ne;5;4;0;9
3055;"Gintarėlis (Didlaukio g. 35)";Šypsenėlės;5834772263;Ne;15;0;0;15
3056;"Gintarėlis (Didlaukio g. 35)";Šypsenėlės;4915783145;Ne;0;5;1;6
3057;"Gintarėlis (Didlaukio g. 35)";Šypsenėlės;1367305617;Ne;5;2;0;7
3058;"Gintarėlis (Didlaukio g. 35)";Šypsenėlės;7537009709;Ne;0;2;0;2
3059;"Gintarėlis (Didlaukio g. 35)";Šypsenėlės;1875958358;Ne;0;2;2;4
3060;"Gintarėlis (Didlaukio g. 35)";Šypsenėlės;4079793067;Ne;0;0;4;4
3061;"Gintarėlis (Didlaukio g. 35)";Smalsučiai;7486822380;Ne;9;2;1;12
3062;"Gintarėlis (Didlaukio g. 35)";Smalsučiai;8387819754;Ne;12;0;0;12
3063;"Gintarėlis (Didlaukio g. 35)";Smalsučiai;8292698645;Ne;5;3;1;9
3064;"Gintarėlis (Didlaukio g. 35)";Smalsučiai;5748677965;Ne;2;2;0;4
3065;"Gintarėlis (Didlaukio g. 35)";Smalsučiai;1876292168;Ne;0;13;0;13
3066;"Gintarėlis (Didlaukio g. 35)";Smalsučiai;9980747501;Ne;7;2;0;9
3067;"Gintarėlis (Didlaukio g. 35)";Smalsučiai;8754068506;Ne;4;2;2;8
3068;"Gintarėlis (Didlaukio g. 35)";Smalsučiai;1537528341;Taip;13;1;0;14
3069;"Gintarėlis (Didlaukio g. 35)";Smalsučiai;4757160835;Ne;1;0;4;5
3070;"Gintarėlis (Didlaukio g. 35)";Smalsučiai;6578588403;Ne;9;0;0;9
3071;"Gintarėlis (Didlaukio g. 35)";Smalsučiai;8815001033;Ne;4;2;0;6
3072;"Gintarėlis (Didlaukio g. 35)";Smalsučiai;1433395471;Ne;11;0;1;12
3073;"Gintarėlis (Didlaukio g. 35)";Smalsučiai;1766430091;Ne;10;2;2;14
3074;"Gintarėlis (Didlaukio g. 35)";Smalsučiai;9787141660;Ne;0;6;0;6
3075;"Gintarėlis (Didlaukio g. 35)";Smalsučiai;9533972547;Ne;9;0;2;11
3076;"Gintarėlis (Didlaukio g. 35)";Smalsučiai;1337062268;Ne;12;0;1;13
3077;"Gintarėlis (Didlaukio g. 35)";Gintariukai;6244066576;Ne;0;19;0;19
3078;"Gintarėlis (Didlaukio g. 35)";Gintariukai;6056471440;Ne;0;2;0;2
3079;"Gintarėlis (Didlaukio g. 35)";Gintariukai;9374716095;Ne;0;7;0;7
3080;"Gintarėlis (Didlaukio g. 35)";Gintariukai;8999913328;Ne;5;14;0;19
3081;"Gintarėlis (Didlaukio g. 35)";Gintariukai;1359894648;Ne;3;0;2;5
3082;"Gintarėlis (Didlaukio g. 35)";Gintariukai;6357825030;Ne;3;2;1;6
3083;"Gintarėlis (Didlaukio g. 35)";Gintariukai;3044631569;Ne;5;0;3;8
3084;"Gintarėlis (Didlaukio g. 35)";Gintariukai;8329253118;Ne;0;2;0;2
3085;"Gintarėlis (Didlaukio g. 35)";Gintariukai;1848386512;Ne;0;0;3;3
3086;"Gintarėlis (Didlaukio g. 35)";Gintariukai;7427026272;Ne;0;8;0;8
3087;"Gintarėlis (Didlaukio g. 35)";GILIUKAI;1981825456;Ne;0;3;0;3
3088;"Gintarėlis (Didlaukio g. 35)";GILIUKAI;3973889495;Ne;0;4;0;4
3089;"Gintarėlis (Didlaukio g. 35)";GILIUKAI;4749559606;Ne;9;0;0;9
3090;"Gintarėlis (Didlaukio g. 35)";GILIUKAI;4458703839;Ne;5;5;0;10
3091;"Gintarėlis (Didlaukio g. 35)";GILIUKAI;2178808286;Ne;7;6;0;13
3092;"Gintarėlis (Didlaukio g. 35)";GILIUKAI;9073499040;Ne;0;5;0;5
3093;"Gintarėlis (Didlaukio g. 35)";GILIUKAI;6711773127;Ne;9;5;0;14
3094;"Gintarėlis (Didlaukio g. 35)";GILIUKAI;6547060300;Ne;0;1;0;1
3095;"Gintarėlis (Didlaukio g. 35)";GILIUKAI;5930354746;Ne;0;4;0;4
3096;"Gintarėlis (Didlaukio g. 35)";GILIUKAI;4535071342;Ne;0;2;1;3
3097;"Gintarėlis (Didlaukio g. 35)";GILIUKAI;8448725884;Ne;0;2;1;3
3098;"Gintarėlis (Didlaukio g. 35)";GILIUKAI;6251670953;Ne;0;4;0;4
3099;"Gintarėlis (Didlaukio g. 35)";GILIUKAI;8805356168;Ne;0;5;0;5
3100;"Gintarėlis (Didlaukio g. 35)";GILIUKAI;4751066825;Ne;0;5;0;5
3101;"Gintarėlis (Didlaukio g. 35)";GILIUKAI;7562170082;Ne;0;16;0;16
3102;"Gintarėlis (Didlaukio g. 35)";GILIUKAI;7418672923;Ne;7;0;0;7
3103;"Gintarėlis (Didlaukio g. 35)";GILIUKAI;1039098192;Ne;8;4;0;12
3104;"Gintarėlis (Didlaukio g. 35)";GILIUKAI;9191264261;Ne;16;0;0;16
3105;"Gintarėlis (Didlaukio g. 35)";GILIUKAI;6042885133;Ne;7;4;0;11
3106;"Gintarėlis (Didlaukio g. 35)";GILIUKAI;3232990779;Ne;3;5;0;8
3107;"Gintarėlis (Didlaukio g. 35)";GILIUKAI;2920734274;Ne;11;1;0;12
3108;"Gintarėlis (Didlaukio g. 35)";GILIUKAI;8613554277;Ne;0;5;0;5
3109;"Gintarėlis (Didlaukio g. 35)";GILIUKAI;5202442681;Ne;5;0;0;5
3110;"Gintarėlis (Didlaukio g. 35)";GILIUKAI;7573269886;Ne;11;2;0;13
3111;Giraitė;Aviliukas;4292730355;Ne;0;3;0;3
3112;Giraitė;Aviliukas;7001163828;Ne;3;4;0;7
3113;Giraitė;Aviliukas;6159650070;Ne;4;4;2;10
3114;Giraitė;Aviliukas;5275912609;Ne;8;2;1;11
3115;Giraitė;Aviliukas;4758750245;Ne;9;0;0;9
3116;Giraitė;Aviliukas;2219854347;Ne;10;0;1;11
3117;Giraitė;Aviliukas;2338867192;Ne;4;4;2;10
3118;Giraitė;Aviliukas;3719285343;Ne;2;0;2;4
3119;Giraitė;Aviliukas;3085107071;Ne;0;0;2;2
3120;Giraitė;Aviliukas;7807844145;Ne;7;0;0;7
3121;Giraitė;Aviliukas;3757900478;Ne;8;3;0;11
3122;Giraitė;Aviliukas;7876457529;Ne;5;4;0;9
3123;Giraitė;Aviliukas;3992069614;Ne;5;6;0;11
3124;Giraitė;Aviliukas;6121586335;Ne;0;4;7;11
3125;Giraitė;Aviliukas;4440444700;Ne;0;4;0;4
3126;Giraitė;Aviliukas;6296485105;Ne;6;0;2;8
3127;Giraitė;Aviliukas;5356944812;Ne;12;0;0;12
3128;Giraitė;Aviliukas;4554565631;Ne;6;0;0;6
3129;Giraitė;Aviliukas;2031462126;Ne;5;4;0;9
3130;Giraitė;LapiukaI;6141730004;Ne;6;4;0;10
3131;Giraitė;LapiukaI;6325909670;Ne;2;4;1;7
3132;Giraitė;LapiukaI;7831526566;Ne;6;3;0;9
3133;Giraitė;LapiukaI;2740656695;Ne;8;5;0;13
3134;Giraitė;LapiukaI;5030697729;Ne;0;8;0;8
3135;Giraitė;LapiukaI;1921430434;Ne;3;3;1;7
3136;Giraitė;LapiukaI;4663343304;Ne;4;4;0;8
3137;Giraitė;LapiukaI;5382004098;Ne;3;3;0;6
3138;Giraitė;LapiukaI;4811513778;Ne;5;3;0;8
3139;Giraitė;LapiukaI;4296449093;Ne;4;2;0;6
3140;Giraitė;LapiukaI;1974159110;Ne;8;8;0;16
3141;Giraitė;LapiukaI;5532639133;Ne;2;6;0;8
3142;Giraitė;LapiukaI;5902161665;Ne;0;6;0;6
3143;Giraitė;LapiukaI;4955786826;Ne;0;4;0;4
3144;Giraitė;LapiukaI;4260343903;Ne;3;3;1;7
3145;Giraitė;LapiukaI;9088123796;Ne;6;4;0;10
3146;Giraitė;LapiukaI;7772177095;Ne;0;4;0;4
3147;Giraitė;LapiukaI;2880342138;Ne;0;4;0;4
3148;Giraitė;LapiukaI;9503157590;Ne;6;3;0;9
3149;Giraitė;LapiukaI;5471577047;Ne;8;1;0;9
3150;Giraitė;Voveriukai;8612554184;Ne;12;2;0;14
3151;Giraitė;Voveriukai;1436302175;Ne;10;0;1;11
3152;Giraitė;Voveriukai;2064019596;Ne;7;4;0;11
3153;Giraitė;Voveriukai;3039445733;Ne;5;7;1;13
3154;Giraitė;Voveriukai;8050306951;Ne;16;0;1;17
3155;Giraitė;Voveriukai;6378362980;Ne;4;0;0;4
3156;Giraitė;Voveriukai;1262854023;Ne;6;4;0;10
3157;Giraitė;Voveriukai;7260229442;Ne;9;0;1;10
3158;Giraitė;Voveriukai;1126576745;Ne;5;0;0;5
3159;Giraitė;Voveriukai;4719547384;Ne;11;0;0;11
3160;Giraitė;Voveriukai;1772997796;Ne;19;0;0;19
3161;Giraitė;Voveriukai;4008393576;Ne;19;0;0;19
3162;Giraitė;Voveriukai;9281071794;Ne;7;0;0;7
3163;Giraitė;Voveriukai;9766107773;Ne;12;0;0;12
3164;Giraitė;Voveriukai;9386943162;Ne;5;2;0;7
3165;Giraitė;Voveriukai;4749790368;Ne;4;3;0;7
3166;Giraitė;Voveriukai;3613828494;Ne;5;0;0;5
3167;Giraitė;Voveriukai;2686885139;Taip;9;0;1;10
3168;Giraitė;Voveriukai;9764802294;Ne;18;0;0;18
3169;Giraitė;Voveriukai;2726766768;Taip;4;0;1;5
3170;Giraitė;Voveriukai;6565165993;Ne;2;0;4;6
3171;Giraitė;Voveriukai;7392324344;Taip;3;0;1;4
3172;Giraitė;Grybukai;7354834895;Ne;0;4;0;4
3173;Giraitė;Grybukai;8799195526;Ne;0;3;0;3
3174;Giraitė;Grybukai;2177856916;Ne;5;2;0;7
3175;Giraitė;Grybukai;4387282125;Ne;0;5;0;5
3176;Giraitė;Grybukai;6225092500;Ne;0;2;0;2
3177;Giraitė;Grybukai;6265908751;Ne;0;2;0;2
3178;Giraitė;Grybukai;4137699629;Ne;0;4;2;6
3179;Giraitė;Grybukai;7919088987;Ne;5;4;0;9
3180;Giraitė;Grybukai;4822168634;Ne;3;1;0;4
3181;Giraitė;Grybukai;4773517160;Ne;8;0;0;8
3182;Giraitė;Grybukai;7739516049;Ne;2;4;1;7
3183;Giraitė;Grybukai;5616242311;Ne;0;4;3;7
3184;Giraitė;Grybukai;2074303013;Ne;0;4;0;4
3185;Giraitė;Grybukai;6963656869;Ne;0;6;0;6
3186;Giraitė;Grybukai;4932174149;Ne;0;3;0;3
3187;Giraitė;Grybukai;2088867630;Ne;1;4;0;5
3188;Giraitė;Grybukai;3875214088;Ne;0;11;0;11
3189;Giraitė;Grybukai;5202562049;Ne;0;3;0;3
3190;Giraitė;Grybukai;7441871219;Ne;0;4;0;4
3191;Giraitė;Grybukai;3607198556;Ne;6;4;0;10
3192;Giraitė;Grybukai;3896789232;Ne;0;2;0;2
3193;Giraitė;Grybukai;1583733838;Ne;0;4;0;4
3194;Giraitė;Riešutėliai;5365264259;Ne;6;0;4;10
3195;Giraitė;Riešutėliai;3158451613;Ne;11;0;0;11
3196;Giraitė;Riešutėliai;7910736839;Ne;0;0;6;6
3197;Giraitė;Riešutėliai;3308792461;Ne;0;0;6;6
3198;Giraitė;Riešutėliai;7423115504;Ne;3;0;1;4
3199;Giraitė;Riešutėliai;3116241918;Ne;1;0;2;3
3200;Giraitė;Riešutėliai;6838184704;Ne;5;4;0;9
3201;Giraitė;Riešutėliai;5161383686;Ne;0;4;0;4
3202;Giraitė;Riešutėliai;5148257412;Ne;7;4;0;11
3203;Giraitė;Riešutėliai;7566944002;Ne;0;3;1;4
3204;Giraitė;Riešutėliai;3839432744;Ne;3;1;5;9
3205;Giraitė;Riešutėliai;7113991095;Ne;0;4;0;4
3206;Giraitė;Riešutėliai;9144465313;Ne;3;4;0;7
3207;Giraitė;Riešutėliai;6288016799;Ne;9;0;2;11
3208;Giraitė;Riešutėliai;3278871662;Ne;5;2;0;7
3209;Giraitė;Riešutėliai;4168934880;Ne;0;6;0;6
3210;Giraitė;Riešutėliai;6337090583;Ne;16;0;0;16
3211;Giraitė;Meškiukai;9751078590;Ne;0;1;0;1
3212;Giraitė;Meškiukai;5447466102;Ne;0;6;0;6
3213;Giraitė;Meškiukai;5574589536;Ne;0;3;1;4
3214;Giraitė;Meškiukai;7744101334;Ne;0;2;0;2
3215;Giraitė;Meškiukai;9589760939;Ne;9;0;0;9
3216;Giraitė;Meškiukai;4500393769;Ne;10;0;0;10
3217;Giraitė;Meškiukai;3144724475;Taip;8;4;0;12
3218;Giraitė;Meškiukai;8427713392;Taip;0;2;0;2
3219;Giraitė;Meškiukai;5525538498;Ne;10;9;0;19
3220;Giraitė;Meškiukai;2867735227;Ne;13;0;0;13
3221;Giraitė;Meškiukai;4681342624;Ne;3;7;0;10
3222;Giraitė;Meškiukai;4431964254;Taip;2;0;3;5
3223;Giraitė;Meškiukai;9669849051;Taip;3;5;0;8
3224;Giraitė;Meškiukai;4946664007;Ne;0;0;1;1
3225;Giraitė;Meškiukai;1170698327;Ne;0;2;0;2
3226;Giraitė;Meškiukai;6865072274;Ne;13;0;0;13
3227;Giraitė;Meškiukai;3108521607;Ne;7;2;0;9
3228;Giraitė;Meškiukai;3612494313;Ne;5;0;1;6
3229;Giraitė;Meškiukai;2076989836;Ne;0;1;0;1
3230;Giraitė;Meškiukai;8139743188;Ne;0;1;0;1
3231;Giraitė;Uogelės;4717851198;Ne;0;0;4;4
3232;Giraitė;Uogelės;1729871315;Ne;0;1;0;1
3233;Giraitė;Uogelės;4317544803;Ne;4;4;0;8
3234;Giraitė;Uogelės;9927102264;Ne;0;12;0;12
3235;Giraitė;Uogelės;4121361794;Ne;1;3;0;4
3236;Giraitė;Uogelės;4843415587;Ne;3;6;0;9
3237;Giraitė;Uogelės;2732715332;Ne;5;0;0;5
3238;Giraitė;Uogelės;2307307454;Ne;2;4;0;6
3239;Giraitė;Uogelės;2102237550;Ne;0;1;0;1
3240;Giraitė;Uogelės;6065010363;Ne;0;3;0;3
3241;Giraitė;Uogelės;5255040944;Ne;8;0;0;8
3242;Giraitė;Uogelės;7094750784;Taip;4;0;0;4
3243;Giraitė;Uogelės;4009092043;Ne;4;1;0;5
3244;Giraitė;Uogelės;1356340471;Ne;3;8;1;12
3245;Giraitė;Uogelės;7377939409;Ne;0;6;0;6
3246;Giraitė;Uogelės;4288937528;Ne;3;0;2;5
3247;Giraitė;Uogelės;6293111179;Ne;5;3;0;8
3248;Giraitė;Uogelės;7390702355;Ne;0;2;0;2
3249;Giraitė;Uogelės;4680913596;Ne;4;0;0;4
3250;Giraitė;Šaltinėlis;1125576830;Ne;0;0;4;4
3251;Giraitė;Šaltinėlis;2223501723;Ne;3;0;2;5
3252;Giraitė;Šaltinėlis;3262098794;Ne;2;0;0;2
3253;Giraitė;Šaltinėlis;8938565070;Ne;0;3;0;3
3254;Giraitė;Šaltinėlis;4094300540;Ne;0;7;0;7
3255;Giraitė;Šaltinėlis;3978249830;Ne;0;4;0;4
3256;Giraitė;Šaltinėlis;7831610906;Ne;16;0;0;16
3257;Giraitė;Šaltinėlis;8686898517;Ne;3;0;0;3
3258;Giraitė;Šaltinėlis;9566341270;Ne;5;0;1;6
3259;Giraitė;Šaltinėlis;8928574407;Ne;2;0;0;2
3260;Giraitė;Šaltinėlis;6897620778;Ne;5;0;0;5
3261;Giraitė;Šaltinėlis;2652478107;Ne;5;0;0;5
3262;Giraitė;Šaltinėlis;3498087339;Ne;7;0;0;7
3263;Giraitė;Boružėlės;8552588816;Ne;14;0;1;15
3264;Giraitė;Boružėlės;4315974617;Ne;7;0;0;7
3265;Giraitė;Boružėlės;2782467129;Ne;10;0;2;12
3266;Giraitė;Boružėlės;7149126803;Ne;9;0;2;11
3267;Giraitė;Boružėlės;6989400181;Ne;11;0;0;11
3268;Giraitė;Boružėlės;8163272129;Ne;9;0;1;10
3269;Giraitė;Boružėlės;2463291913;Ne;6;5;0;11
3270;Giraitė;Boružėlės;2483204684;Ne;5;0;1;6
3271;Giraitė;Boružėlės;3643975279;Ne;8;0;1;9
3272;Giraitė;Boružėlės;3620400530;Ne;12;0;0;12
3273;Giraitė;Boružėlės;3801118082;Ne;10;0;0;10
3274;Giraitė;Boružėlės;4876614491;Ne;8;1;0;9
3275;Giraitė;Boružėlės;3035520579;Ne;4;0;1;5
3276;Giraitė;Boružėlės;2344506210;Ne;2;0;2;4
3277;Giraitė;Gandriukai;8525380061;Ne;0;7;0;7
3278;Giraitė;Gandriukai;4851987149;Ne;0;4;0;4
3279;Giraitė;Gandriukai;7008670489;Ne;5;4;0;9
3280;Giraitė;Gandriukai;6277788515;Ne;0;4;0;4
3281;Giraitė;Gandriukai;7767820565;Ne;7;0;0;7
3282;Giraitė;Gandriukai;8819218663;Ne;0;4;1;5
3283;Giraitė;Gandriukai;7269074498;Ne;5;2;0;7
3284;Giraitė;Gandriukai;1490748887;Taip;2;1;0;3
3285;Giraitė;Gandriukai;7789414361;Ne;12;5;0;17
3286;Giraitė;Gandriukai;9850432917;Ne;15;0;0;15
3287;Giraitė;Gandriukai;2313273738;Ne;3;2;0;5
3288;Giraitė;Gandriukai;9625436756;Ne;0;1;0;1
3289;Giraitė;Gandriukai;8101302584;Ne;14;0;0;14
3290;Giraitė;Gandriukai;9307640828;Ne;5;4;0;9
3291;Giraitė;Gandriukai;3027761044;Ne;3;4;0;7
3292;Giraitė;Gandriukai;4371263826;Ne;7;4;0;11
3293;Giraitė;Gandriukai;1227555563;Ne;2;0;4;6
3294;Giraitė;ŽVIRBLIUKAI;6715354865;Ne;2;0;0;2
3295;Giraitė;ŽVIRBLIUKAI;8461725999;Ne;6;0;2;8
3296;Giraitė;ŽVIRBLIUKAI;7395332578;Ne;0;4;0;4
3297;Giraitė;ŽVIRBLIUKAI;5086296808;Ne;0;6;0;6
3298;Giraitė;ŽVIRBLIUKAI;9669916418;Ne;3;0;2;5
3299;Giraitė;ŽVIRBLIUKAI;3481695682;Ne;2;4;2;8
3300;Giraitė;ŽVIRBLIUKAI;7551981095;Ne;0;4;0;4
3301;Giraitė;ŽVIRBLIUKAI;7678134658;Ne;0;4;0;4
3302;Giraitė;ŽVIRBLIUKAI;9471560738;Ne;0;2;0;2
3303;Giraitė;ŽVIRBLIUKAI;6677278422;Ne;0;4;0;4
3304;Giraitė;ŽVIRBLIUKAI;7230351549;Ne;7;1;6;14
3305;Giraitė;ŽVIRBLIUKAI;9728453316;Ne;0;1;0;1
3306;Giraitė;ŽVIRBLIUKAI;9114364139;Ne;0;4;0;4
3307;Giraitė;ŽVIRBLIUKAI;9392127689;Ne;3;4;0;7
3308;Giraitė;ŽVIRBLIUKAI;2416162886;Ne;2;4;2;8
3309;Giraitė;ŽVIRBLIUKAI;7543605905;Ne;0;7;0;7
3310;Giraitė;ŽVIRBLIUKAI;8128401630;Ne;6;0;1;7
3311;Giraitė;ŽVIRBLIUKAI;4233170371;Ne;5;3;0;8
3312;Giraitė;ŽVIRBLIUKAI;8871979627;Ne;2;0;2;4
3313;Giraitė;ŽVIRBLIUKAI;3214528809;Ne;5;0;3;8
3314;Giraitė;ŽVIRBLIUKAI;5548434439;Ne;0;0;6;6
3315;Giraitė;ŽVIRBLIUKAI;4450822125;Ne;0;2;1;3
3316;Giraitė;ŽVIRBLIUKAI;6474975269;Ne;0;4;0;4
3317;Giraitė;Kiškeliai;8259691835;Ne;12;0;0;12
3318;Giraitė;Kiškeliai;8782435144;Ne;6;0;1;7
3319;Giraitė;Kiškeliai;3457058930;Ne;4;2;1;7
3320;Giraitė;Kiškeliai;8787203512;Ne;12;0;0;12
3321;Giraitė;Kiškeliai;5364415038;Ne;3;0;1;4
3322;Giraitė;Kiškeliai;9503522932;Ne;10;0;0;10
3323;Giraitė;Kiškeliai;3599734091;Ne;13;0;0;13
3324;Giraitė;Kiškeliai;8869418518;Ne;9;0;0;9
3325;Giraitė;Kiškeliai;7227780890;Taip;9;0;0;9
3326;Giraitė;Kiškeliai;4964803735;Ne;15;0;0;15
3327;Giraitė;Kiškeliai;4858846263;Taip;5;0;0;5
3328;Giraitė;Kiškeliai;8148626841;Ne;16;0;0;16
3329;Giraitė;Kiškeliai;9459699089;Ne;15;0;0;15
3330;Gudrutis;Gandriukų;3264829331;Ne;2;0;0;2
3331;Gudrutis;Gandriukų;7143849852;Ne;8;0;0;8
3332;Gudrutis;Gandriukų;4600814480;Ne;0;1;0;1
3333;Gudrutis;Gandriukų;5931281687;Ne;17;0;0;17
3334;Gudrutis;Gandriukų;5498218329;Ne;13;0;0;13
3335;Gudrutis;Gandriukų;3760014407;Ne;0;3;0;3
3336;Gudrutis;Gandriukų;9454206104;Ne;3;0;2;5
3337;Gudrutis;Gandriukų;5911423362;Ne;7;0;0;7
3338;Gudrutis;Gandriukų;3316297441;Ne;0;4;0;4
3339;Gudrutis;Gandriukų;1170008457;Ne;5;0;0;5
3340;Gudrutis;Gandriukų;7930414623;Ne;1;2;0;3
3341;Gudrutis;Gandriukų;6307643172;Ne;0;3;0;3
3342;Gudrutis;Gandriukų;7531077386;Ne;0;2;0;2
3343;Gudrutis;Gandriukų;2278368966;Ne;4;0;0;4
3344;Gudrutis;Gandriukų;3000289515;Ne;0;1;0;1
3345;Gudrutis;Gandriukų;6458053920;Ne;0;4;0;4
3346;Gudrutis;Gandriukų;2256458624;Ne;10;2;0;12
3347;Gudrutis;Gandriukų;2784392885;Ne;3;3;0;6
3348;Gudrutis;Gandriukų;1588396018;Ne;3;3;0;6
3349;Gudrutis;Gandriukų;3136349573;Ne;0;4;0;4
3350;Gudrutis;Gandriukų;5257913623;Ne;5;0;1;6
3351;Gudrutis;"Saulės zuikučių";7934673005;Ne;6;0;0;6
3352;Gudrutis;"Saulės zuikučių";2199222671;Ne;4;0;0;4
3353;Gudrutis;"Saulės zuikučių";1587454709;Ne;0;4;0;4
3354;Gudrutis;"Saulės zuikučių";1670550212;Ne;5;1;0;6
3355;Gudrutis;"Saulės zuikučių";1225698076;Ne;0;2;0;2
3356;Gudrutis;"Saulės zuikučių";8500911420;Ne;7;1;1;9
3357;Gudrutis;"Saulės zuikučių";5408444872;Ne;4;0;0;4
3358;Gudrutis;"Saulės zuikučių";5728436444;Ne;0;4;0;4
3359;Gudrutis;"Saulės zuikučių";9041133527;Ne;0;2;0;2
3360;Gudrutis;"Saulės zuikučių";8621229735;Ne;0;9;0;9
3361;Gudrutis;"Saulės zuikučių";9697445037;Ne;0;0;1;1
3362;Gudrutis;"Saulės zuikučių";3281890659;Ne;0;7;0;7
3363;Gudrutis;"Saulės zuikučių";2291393238;Ne;7;0;0;7
3364;Gudrutis;"Saulės zuikučių";5585248878;Ne;0;0;3;3
3365;Gudrutis;"Saulės zuikučių";1384696362;Ne;3;0;1;4
3366;Gudrutis;"Saulės zuikučių";2666772437;Ne;0;0;1;1
3367;Gudrutis;"Saulės zuikučių";9044566825;Ne;0;5;0;5
3368;Gudrutis;"Saulės zuikučių";9683107780;Ne;0;4;0;4
3369;Gudrutis;"Saulės zuikučių";1197649093;Ne;9;0;2;11
3370;Gudrutis;Pelėdžiukų;7955353991;Ne;0;4;0;4
3371;Gudrutis;Pelėdžiukų;2197278086;Ne;10;2;0;12
3372;Gudrutis;Pelėdžiukų;6358318238;Ne;2;17;0;19
3373;Gudrutis;Pelėdžiukų;7942601528;Ne;0;3;0;3
3374;Gudrutis;Pelėdžiukų;1701035039;Ne;0;4;0;4
3375;Gudrutis;Pelėdžiukų;8774935740;Ne;19;0;0;19
3376;Gudrutis;Pelėdžiukų;4844838728;Ne;4;2;0;6
3377;Gudrutis;Pelėdžiukų;1685531183;Ne;5;0;0;5
3378;Gudrutis;Pelėdžiukų;9253468183;Ne;0;4;0;4
3379;Gudrutis;Pelėdžiukų;1051407930;Ne;3;0;0;3
3380;Gudrutis;Pelėdžiukų;7755882832;Ne;4;1;0;5
3381;Gudrutis;Pelėdžiukų;2487363252;Ne;1;0;0;1
3382;Gudrutis;Pelėdžiukų;9297898193;Ne;10;0;0;10
3383;Gudrutis;Pelėdžiukų;7663746093;Ne;9;2;0;11
3384;Gudrutis;Pelėdžiukų;8512130106;Ne;0;4;0;4
3385;Gudrutis;Pelėdžiukų;3919786807;Ne;9;2;0;11
3386;Gudrutis;Pelėdžiukų;1485530468;Ne;5;0;0;5
3387;Gudrutis;Pelėdžiukų;8598450150;Ne;15;0;0;15
3388;Gudrutis;Pelėdžiukų;2484715724;Ne;15;0;0;15
3389;Gudrutis;Pelėdžiukų;2118820249;Ne;0;4;0;4
3390;Gudrutis;Pelėdžiukų;5508723821;Ne;9;5;0;14
3391;Gudrutis;BITUČIŲ;6700254479;Ne;0;4;15;19
3392;Gudrutis;BITUČIŲ;7773150642;Ne;0;4;0;4
3393;Gudrutis;BITUČIŲ;2293472716;Ne;0;19;0;19
3394;Gudrutis;BITUČIŲ;6835038962;Ne;5;6;3;14
3395;Gudrutis;BITUČIŲ;6731806925;Ne;0;4;1;5
3396;Gudrutis;BITUČIŲ;2118727861;Ne;0;3;1;4
3397;Gudrutis;BITUČIŲ;9701111916;Ne;5;4;0;9
3398;Gudrutis;BITUČIŲ;1725920873;Ne;0;4;2;6
3399;Gudrutis;BITUČIŲ;1901358996;Ne;5;2;1;8
3400;Gudrutis;BITUČIŲ;7664517480;Ne;0;0;3;3
3401;Gudrutis;BITUČIŲ;9847597133;Ne;0;2;0;2
3402;Gudrutis;BITUČIŲ;3646335609;Ne;0;3;3;6
3403;Gudrutis;BITUČIŲ;7871991275;Ne;0;4;0;4
3404;Gudrutis;BITUČIŲ;5580618896;Ne;0;4;0;4
3405;Gudrutis;BITUČIŲ;2468434676;Ne;4;4;2;10
3406;Gudrutis;BITUČIŲ;3625838131;Ne;0;5;0;5
3407;Gudrutis;BITUČIŲ;2337493193;Ne;0;4;0;4
3408;Gudrutis;BITUČIŲ;2408038213;Ne;10;1;0;11
3409;Gudrutis;BITUČIŲ;2764843216;Ne;0;4;0;4
3410;Gudrutis;BITUČIŲ;1012579870;Ne;2;4;1;7
3411;Gudrutis;BITUČIŲ;8165828215;Ne;0;4;1;5
3412;Gudrutis;BITUČIŲ;8240340213;Ne;0;4;0;4
3413;Gudrutis;Boružėlių;4623428212;Ne;0;0;7;7
3414;Gudrutis;Boružėlių;9893732913;Ne;8;0;0;8
3415;Gudrutis;Boružėlių;2807547699;Ne;3;0;1;4
3416;Gudrutis;Boružėlių;6326258371;Ne;5;4;0;9
3417;Gudrutis;Boružėlių;7033634744;Ne;5;4;0;9
3418;Gudrutis;Boružėlių;5748775407;Ne;0;0;1;1
3419;Gudrutis;Boružėlių;8296416202;Ne;0;0;1;1
3420;Gudrutis;Boružėlių;3959030593;Ne;0;0;5;5
3421;Gudrutis;Boružėlių;4672748361;Ne;1;0;4;5
3422;Gudrutis;Boružėlių;8081931247;Ne;1;0;4;5
3423;Gudrutis;Boružėlių;5382755416;Ne;14;0;0;14
3424;Gudrutis;Boružėlių;4546694746;Ne;3;4;1;8
3425;Gudrutis;Boružėlių;9948022627;Ne;13;0;0;13
3426;Gudrutis;Boružėlių;1277537891;Ne;9;0;2;11
3427;Gudrutis;Boružėlių;5121141955;Ne;0;0;1;1
3428;Gudrutis;Boružėlių;4691454736;Ne;10;0;2;12
3429;Gudrutis;Drugeliai;6284712576;Ne;1;0;1;2
3430;Gudrutis;Drugeliai;3797656483;Ne;0;6;0;6
3431;Gudrutis;Drugeliai;9200644104;Ne;0;6;0;6
3432;Gudrutis;Drugeliai;9096764346;Ne;0;4;0;4
3433;Gudrutis;Drugeliai;5306281458;Ne;0;0;14;14
3434;Gudrutis;Drugeliai;8783180638;Ne;0;0;12;12
3435;Gudrutis;Drugeliai;1737001982;Ne;14;4;0;18
3436;Gudrutis;Drugeliai;8525851058;Ne;15;0;0;15
3437;Gudrutis;Drugeliai;8080976400;Ne;5;0;1;6
3438;Gudrutis;Drugeliai;9808350750;Ne;0;4;0;4
3439;Gudrutis;Drugeliai;6101410750;Ne;0;2;3;5
3440;Gudrutis;Drugeliai;5710348070;Ne;6;0;0;6
3441;Gudrutis;Drugeliai;8843761360;Ne;6;0;0;6
3442;Gudrutis;Drugeliai;5590297232;Ne;5;0;2;7
3443;Gudrutis;Drugeliai;2827279258;Ne;1;9;0;10
3444;Gudrutis;Drugeliai;5093267385;Ne;2;3;3;8
3445;Gudrutis;Drugeliai;1364145110;Ne;6;4;0;10
3446;Gudrutis;Drugeliai;8803747496;Ne;5;9;0;14
3447;Gudrutis;Drugeliai;9714712791;Ne;3;0;1;4
3448;Gudrutis;Drugeliai;6063661969;Ne;11;0;0;11
3449;Gudrutis;Drugeliai;2435945253;Ne;2;0;2;4
3450;Gudrutis;Drugeliai;6268669142;Taip;0;4;1;5
3451;Jurginėlis;Ąžuoliukai;7309052653;Ne;4;0;0;4
3452;Jurginėlis;Ąžuoliukai;2501462080;Ne;3;0;0;3
3453;Jurginėlis;Ąžuoliukai;8571054905;Ne;5;0;0;5
3454;Jurginėlis;Ąžuoliukai;8969526123;Ne;1;0;0;1
3455;Jurginėlis;Ąžuoliukai;6168508647;Ne;5;0;0;5
3456;Jurginėlis;Ąžuoliukai;5861832676;Ne;1;0;0;1
3457;Jurginėlis;Ąžuoliukai;3933113321;Ne;0;13;0;13
3458;Jurginėlis;Ąžuoliukai;5861418459;Ne;0;9;0;9
3459;Jurginėlis;Ąžuoliukai;5869170503;Ne;5;0;0;5
3460;Jurginėlis;Ąžuoliukai;3562210465;Ne;7;0;0;7
3461;Jurginėlis;Ąžuoliukai;6202225321;Ne;7;0;0;7
3462;Jurginėlis;Ąžuoliukai;7081618073;Ne;8;0;0;8
3463;Jurginėlis;Ąžuoliukai;6851855147;Ne;1;0;0;1
3464;Jurginėlis;Ąžuoliukai;9029587175;Ne;1;0;0;1
3465;Jurginėlis;Ąžuoliukai;9889620429;Ne;6;0;0;6
3466;Jurginėlis;Ąžuoliukai;3324811458;Ne;2;0;0;2
3467;Jurginėlis;Ąžuoliukai;6153432639;Ne;15;0;0;15
3468;Jurginėlis;Ąžuoliukai;9850874714;Ne;3;0;0;3
3469;Jurginėlis;Ąžuoliukai;8174251359;Ne;7;0;0;7
3470;Jurginėlis;Ąžuoliukai;2447025385;Ne;11;0;0;11
3471;Jurginėlis;Ąžuoliukai;5313627252;Ne;17;0;0;17
3472;Jurginėlis;Žiogeliai;8159210242;Ne;5;12;0;17
3473;Jurginėlis;Žiogeliai;7251598691;Ne;10;1;0;11
3474;Jurginėlis;Žiogeliai;6906225772;Ne;0;6;0;6
3475;Jurginėlis;Žiogeliai;7010130915;Ne;2;3;0;5
3476;Jurginėlis;Žiogeliai;7907096012;Ne;0;11;0;11
3477;Jurginėlis;Žiogeliai;7250246853;Ne;0;9;0;9
3478;Jurginėlis;Žiogeliai;5160581631;Ne;0;3;0;3
3479;Jurginėlis;Žiogeliai;6438669072;Ne;3;0;0;3
3480;Jurginėlis;Žiogeliai;7300018733;Ne;0;2;0;2
3481;Jurginėlis;Žiogeliai;4674128568;Ne;0;12;0;12
3482;Jurginėlis;Žiogeliai;9305884152;Ne;10;2;0;12
3483;Jurginėlis;Žiogeliai;9716328349;Ne;0;19;0;19
3484;Jurginėlis;Žiogeliai;4441183185;Ne;2;0;0;2
3485;Jurginėlis;Žiogeliai;4502564783;Ne;0;3;0;3
3486;Jurginėlis;Žiogeliai;1937927553;Ne;4;1;0;5
3487;Jurginėlis;Žiogeliai;7527178332;Ne;0;10;0;10
3488;Jurginėlis;Žiogeliai;4682125116;Ne;4;4;0;8
3489;Jurginėlis;Žiogeliai;3920971621;Ne;8;1;0;9
3490;Jurginėlis;Žiogeliai;9563102730;Taip;6;2;0;8
3491;Jurginėlis;Žiogeliai;5037980414;Ne;0;1;0;1
3492;Jurginėlis;Pelėdžiukų;8844614653;Ne;5;0;0;5
3493;Jurginėlis;Pelėdžiukų;1303323955;Ne;4;0;0;4
3494;Jurginėlis;Pelėdžiukų;6856023398;Ne;6;0;0;6
3495;Jurginėlis;Pelėdžiukų;4466955830;Ne;14;0;0;14
3496;Jurginėlis;Pelėdžiukų;6932501634;Ne;1;0;0;1
3497;Jurginėlis;Pelėdžiukų;2248773321;Ne;1;0;0;1
3498;Jurginėlis;Pelėdžiukų;3675820817;Ne;5;0;0;5
3499;Jurginėlis;Pelėdžiukų;6285599044;Ne;15;3;0;18
3500;Jurginėlis;Pelėdžiukų;5043815909;Ne;3;0;0;3
3501;Jurginėlis;Pelėdžiukų;2982526236;Ne;5;0;0;5
3502;Jurginėlis;Pelėdžiukų;4233910766;Ne;2;3;0;5
3503;Jurginėlis;Pelėdžiukų;1537710974;Ne;1;0;0;1
3504;Jurginėlis;Pelėdžiukų;6594025023;Ne;5;3;0;8
3505;Jurginėlis;Pelėdžiukų;3573167647;Ne;2;0;0;2
3506;Jurginėlis;Pelėdžiukų;6124147401;Ne;3;0;0;3
3507;Jurginėlis;Pelėdžiukų;6648657850;Ne;7;0;0;7
3508;Jurginėlis;Pelėdžiukų;9139025010;Ne;10;0;0;10
3509;Jurginėlis;Pelėdžiukų;7554346190;Ne;5;0;1;6
3510;Jurginėlis;Pelėdžiukų;4555257132;Taip;1;0;1;2
3511;Jurginėlis;Boružėlių;6806704355;Ne;0;3;0;3
3512;Jurginėlis;Boružėlių;3091019969;Ne;0;4;0;4
3513;Jurginėlis;Boružėlių;9288380246;Ne;1;1;0;2
3514;Jurginėlis;Boružėlių;2837099502;Ne;1;0;0;1
3515;Jurginėlis;Boružėlių;2548920722;Ne;1;4;0;5
3516;Jurginėlis;Boružėlių;7288921301;Ne;0;4;0;4
3517;Jurginėlis;Boružėlių;2263818210;Ne;0;3;0;3
3518;Jurginėlis;Boružėlių;4827340942;Ne;5;2;0;7
3519;Jurginėlis;Boružėlių;4463258777;Ne;0;4;0;4
3520;Jurginėlis;Boružėlių;2225892248;Ne;0;3;0;3
3521;Jurginėlis;Boružėlių;6579565337;Ne;0;4;0;4
3522;Jurginėlis;Boružėlių;3462969423;Ne;0;3;0;3
3523;Jurginėlis;Boružėlių;7990015623;Ne;0;4;0;4
3524;Jurginėlis;Boružėlių;7486778826;Ne;3;2;0;5
3525;Jurginėlis;Boružėlių;4158502752;Ne;0;4;0;4
3526;Jurginėlis;Boružėlių;5242359650;Taip;0;7;0;7
3527;Jurginėlis;Boružėlių;2214809186;Ne;0;4;0;4
3528;Jurginėlis;Boružėlių;3284464951;Ne;0;6;0;6
3529;Jurginėlis;Boružėlių;8144038013;Ne;0;10;0;10
3530;Jurginėlis;Boružėlių;2536744421;Ne;0;19;0;19
3531;Jurginėlis;Bitučių;9882919290;Ne;0;2;0;2
3532;Jurginėlis;Bitučių;5984893389;Ne;7;6;0;13
3533;Jurginėlis;Bitučių;3079495897;Ne;1;4;1;6
3534;Jurginėlis;Bitučių;8727844649;Ne;5;4;3;12
3535;Jurginėlis;Bitučių;1455749921;Ne;0;7;0;7
3536;Jurginėlis;Bitučių;7809274980;Ne;0;3;1;4
3537;Jurginėlis;Bitučių;2417314519;Ne;1;4;0;5
3538;Jurginėlis;Bitučių;6968528293;Ne;0;4;0;4
3539;Jurginėlis;Bitučių;9507571301;Ne;1;4;0;5
3540;Jurginėlis;Bitučių;8779807396;Ne;2;4;0;6
3541;Jurginėlis;Bitučių;9760394658;Ne;0;4;2;6
3542;Jurginėlis;Bitučių;8443412187;Ne;0;2;0;2
3543;Jurginėlis;Bitučių;4967548277;Ne;0;4;3;7
3544;Jurginėlis;Bitučių;2925253653;Ne;0;9;0;9
3545;Jurginėlis;Bitučių;1340689348;Ne;2;4;0;6
3546;Jurginėlis;Bitučių;2221708420;Ne;0;5;0;5
3547;Jurginėlis;Bitučių;6181547354;Ne;0;5;0;5
3548;Jurginėlis;Bitučių;2490875633;Ne;3;5;0;8
3549;Jurginėlis;Bitučių;4689913361;Ne;1;4;2;7
3550;Jurginėlis;Bitučių;9101617374;Ne;1;4;1;6
3551;Jurginėlis;Skruzdeliukų;1351306981;Ne;4;0;0;4
3552;Jurginėlis;Skruzdeliukų;9146039217;Ne;0;3;0;3
3553;Jurginėlis;Skruzdeliukų;1885598986;Ne;0;3;0;3
3554;Jurginėlis;Skruzdeliukų;3558752347;Ne;0;6;0;6
3555;Jurginėlis;Skruzdeliukų;5734506036;Ne;0;4;0;4
3556;Jurginėlis;Skruzdeliukų;3699180485;Ne;3;4;0;7
3557;Jurginėlis;Skruzdeliukų;1634502874;Ne;7;0;0;7
3558;Jurginėlis;Skruzdeliukų;4981043400;Ne;4;0;0;4
3559;Jurginėlis;Skruzdeliukų;1763849354;Ne;9;1;0;10
3560;Jurginėlis;Skruzdeliukų;4944292549;Ne;0;6;0;6
3561;Jurginėlis;Skruzdeliukų;9506129699;Ne;11;0;0;11
3562;Jurginėlis;Skruzdeliukų;9550110246;Ne;0;1;0;1
3563;Jurginėlis;Skruzdeliukų;3541542063;Ne;5;0;0;5
3564;Jurginėlis;Skruzdeliukų;1204999684;Ne;7;4;0;11
3565;Jurginėlis;Skruzdeliukų;9937405742;Ne;0;19;0;19
3566;Jurginėlis;Skruzdeliukų;1726968598;Ne;5;12;0;17
3567;Jurginėlis;Skruzdeliukų;2332714713;Ne;3;0;0;3
3568;Jurginėlis;Skruzdeliukų;9961083854;Ne;6;4;0;10
3569;Jurginėlis;Skruzdeliukų;6542567172;Ne;0;6;0;6
3570;Jurginėlis;Skruzdeliukų;1582948463;Ne;0;5;0;5
3571;Jurginėlis;Drugelių;2025403481;Ne;8;0;0;8
3572;Jurginėlis;Drugelių;9065349248;Ne;8;0;0;8
3573;Jurginėlis;Drugelių;8341951659;Ne;11;3;0;14
3574;Jurginėlis;Drugelių;7795042485;Ne;9;0;0;9
3575;Jurginėlis;Drugelių;5138832895;Ne;4;0;0;4
3576;Jurginėlis;Drugelių;5751977493;Taip;10;0;0;10
3577;Jurginėlis;Drugelių;3466562781;Ne;9;0;0;9
3578;Jurginėlis;Drugelių;6068645621;Taip;0;8;0;8
3579;Jurginėlis;Drugelių;4276237094;Ne;9;1;0;10
3580;Jurginėlis;Drugelių;2689492215;Ne;1;0;0;1
3581;Jurginėlis;Drugelių;3527520303;Ne;4;0;0;4
3582;Jurginėlis;Drugelių;9736737788;Ne;2;0;0;2
3583;Jurginėlis;Drugelių;1208882528;Ne;3;0;0;3
3584;Jurginėlis;Drugelių;5874949368;Ne;11;0;0;11
3585;Jurginėlis;Drugelių;7349309693;Ne;0;4;0;4
3586;Jurginėlis;Drugelių;3063084253;Ne;9;0;0;9
3587;Jurginėlis;Drugelių;7409019574;Ne;7;0;0;7
3588;Jurginėlis;Drugelių;5928303681;Ne;15;0;0;15
3589;Jurginėlis;Drugelių;5476486516;Ne;7;0;0;7
3590;Jurginėlis;Drugelių;8536084383;Ne;1;0;0;1
3591;Jurginėlis;Žibučių;4979618298;Ne;2;4;0;6
3592;Jurginėlis;Žibučių;6636147085;Ne;7;7;0;14
3593;Jurginėlis;Žibučių;1438159631;Ne;0;6;0;6
3594;Jurginėlis;Žibučių;1336429135;Ne;0;6;0;6
3595;Jurginėlis;Žibučių;6948834218;Ne;15;6;0;21
3596;Jurginėlis;Žibučių;7721612113;Ne;2;4;0;6
3597;Jurginėlis;Žibučių;6988386438;Ne;5;0;0;5
3598;Jurginėlis;Žibučių;8111158692;Ne;0;4;0;4
3599;Jurginėlis;Žibučių;5936508522;Taip;0;17;0;17
3600;Jurginėlis;Žibučių;6717892969;Ne;0;6;0;6
3601;Jurginėlis;Žibučių;7977676733;Ne;5;2;0;7
3602;Jurginėlis;Žibučių;7530846375;Ne;0;1;0;1
3603;Jurginėlis;Žibučių;3899526893;Ne;0;2;0;2
3604;Jurginėlis;Žibučių;3861311860;Ne;14;4;0;18
3605;Jurginėlis;Žibučių;1263601087;Ne;1;6;0;7
3606;Jurginėlis;Žibučių;5549766339;Ne;5;6;0;11
3607;Jurginėlis;Žibučių;4429780802;Ne;0;4;0;4
3608;Jurginėlis;Žibučių;8968718021;Ne;0;8;0;8
3609;Jurginėlis;Žibučių;2782553941;Ne;11;0;0;11
3610;Jurginėlis;Žibučių;6259461257;Ne;6;1;0;7
3611;Jurginėlis;Žibučių;7252041334;Ne;6;6;0;12
3612;Jurginėlis;Zuikučių;5958832413;Ne;3;6;0;9
3613;Jurginėlis;Zuikučių;4432849717;Ne;5;9;0;14
3614;Jurginėlis;Zuikučių;6587382160;Ne;5;1;0;6
3615;Jurginėlis;Zuikučių;8097652962;Ne;0;4;0;4
3616;Jurginėlis;Zuikučių;4763313715;Ne;11;2;0;13
3617;Jurginėlis;Zuikučių;6671759364;Ne;2;0;0;2
3618;Jurginėlis;Zuikučių;8937404520;Ne;0;0;1;1
3619;Jurginėlis;Zuikučių;2820249307;Ne;2;2;0;4
3620;Jurginėlis;Zuikučių;8823175066;Ne;0;2;0;2
3621;Jurginėlis;Zuikučių;8161347781;Ne;0;10;0;10
3622;Jurginėlis;Zuikučių;7283697595;Ne;0;0;3;3
3623;Jurginėlis;Zuikučių;4113264904;Ne;5;0;0;5
3624;Jurginėlis;Zuikučių;8117563141;Ne;4;0;0;4
3625;Jurginėlis;Zuikučių;5652597514;Ne;12;5;0;17
3626;Jurginėlis;Zuikučių;6341896288;Ne;0;0;4;4
3627;Jurginėlis;Zuikučių;4180071775;Ne;1;0;0;1
3628;Jurginėlis;Zuikučių;8017976529;Ne;0;3;0;3
3629;Jurginėlis;Zuikučių;3530906368;Ne;15;4;0;19
3630;Jurginėlis;Zuikučių;4292932046;Ne;4;0;0;4
3631;Jurginėlis;Viščiukų;1405338657;Ne;10;0;0;10
3632;Jurginėlis;Viščiukų;2211222679;Ne;5;5;0;10
3633;Jurginėlis;Viščiukų;9366610698;Ne;5;1;0;6
3634;Jurginėlis;Viščiukų;8050408300;Ne;8;0;0;8
3635;Jurginėlis;Viščiukų;2378007686;Ne;19;0;0;19
3636;Jurginėlis;Viščiukų;6657367395;Ne;0;3;0;3
3637;Jurginėlis;Viščiukų;3254001601;Ne;4;0;0;4
3638;Jurginėlis;Viščiukų;8050843105;Taip;3;1;0;4
3639;Jurginėlis;Viščiukų;9556978001;Ne;19;0;0;19
3640;Jurginėlis;Viščiukų;6550401531;Taip;6;0;0;6
3641;Jurginėlis;Viščiukų;1449454050;Ne;11;0;0;11
3642;Jurginėlis;Viščiukų;7684663210;Taip;8;0;0;8
3643;Jurginėlis;Viščiukų;6135184014;Ne;10;2;0;12
3644;Jurginėlis;Viščiukų;4515820114;Ne;0;7;0;7
3645;Jurginėlis;Meškiukų;6584048242;Ne;19;0;0;19
3646;Jurginėlis;Meškiukų;2652507538;Ne;6;1;0;7
3647;Jurginėlis;Meškiukų;4645348169;Ne;3;4;0;7
3648;Jurginėlis;Meškiukų;8348637578;Ne;17;0;0;17
3649;Jurginėlis;Meškiukų;6266328957;Taip;10;2;0;12
3650;Jurginėlis;Meškiukų;7424513586;Ne;8;0;0;8
3651;Jurginėlis;Meškiukų;5945075337;Ne;5;2;0;7
3652;Jurginėlis;Meškiukų;5472986119;Ne;9;2;0;11
3653;Jurginėlis;Meškiukų;5105758563;Ne;7;0;0;7
3654;Jurginėlis;Meškiukų;7892411156;Ne;11;2;0;13
3655;Jurginėlis;Meškiukų;2967314352;Ne;0;1;0;1
3656;Jurginėlis;Meškiukų;7053226448;Ne;6;4;0;10
3657;Jurginėlis;Gandriukų;6306274502;Taip;8;0;0;8
3658;Jurginėlis;Gandriukų;9603380131;Ne;14;0;0;14
3659;Jurginėlis;Gandriukų;7193314762;Ne;1;4;0;5
3660;Jurginėlis;Gandriukų;4506484183;Ne;8;0;0;8
3661;Jurginėlis;Gandriukų;5474358669;Ne;23;0;0;23
3662;Jurginėlis;Gandriukų;3741447134;Ne;1;0;0;1
3663;Jurginėlis;Gandriukų;2595002682;Ne;12;0;0;12
3664;Jurginėlis;Gandriukų;5866358319;Taip;19;1;0;20
3665;Jurginėlis;Gandriukų;4648875524;Ne;1;1;0;2
3666;Jurginėlis;Gandriukų;1598578487;Ne;15;0;0;15
3667;Jurginėlis;Gandriukų;4644476606;Ne;12;0;0;12
3668;Jurginėlis;Gandriukų;3622183526;Ne;2;0;0;2
3669;Jurginėlis;Gandriukų;3230200231;Ne;9;0;0;9
3670;Jurginėlis;Gandriukų;7636442845;Ne;18;0;0;18
3671;Jurginėlis;Gandriukų;1286603999;Ne;10;0;0;10
3672;Jurginėlis;Gandriukų;4617952912;Ne;5;0;0;5
3673;Jurginėlis;Gandriukų;3672557409;Ne;0;7;0;7
3674;Jurginėlis;Gandriukų;1043529560;Ne;10;2;0;12
3675;Jurginėlis;Gandriukų;1888949640;Ne;0;30;0;30
3676;Jurginėlis;Gandriukų;5688209539;Ne;10;0;0;10
3677;Jurginėlis;Gandriukų;2084877917;Ne;14;0;0;14
3678;Karuselė;PAGRANDUKAS;1621482372;Ne;10;7;0;17
3679;Karuselė;PAGRANDUKAS;3330374479;Ne;0;7;0;7
3680;Karuselė;PAGRANDUKAS;6183785840;Ne;0;3;0;3
3681;Karuselė;PAGRANDUKAS;3984262482;Ne;7;4;0;11
3682;Karuselė;PAGRANDUKAS;9130534156;Ne;0;1;0;1
3683;Karuselė;PAGRANDUKAS;3660843696;Ne;0;4;0;4
3684;Karuselė;PAGRANDUKAS;5132581245;Ne;0;10;0;10
3685;Karuselė;PAGRANDUKAS;2412418335;Ne;0;3;0;3
3686;Karuselė;PAGRANDUKAS;7393434659;Ne;0;1;0;1
3687;Karuselė;PAGRANDUKAS;5695697634;Ne;0;1;0;1
3688;Karuselė;PAGRANDUKAS;6252613489;Ne;15;4;0;19
3689;Karuselė;PAGRANDUKAS;6004882312;Ne;0;12;0;12
3690;Karuselė;PAGRANDUKAS;6856800484;Ne;0;5;0;5
3691;Karuselė;PAGRANDUKAS;3972815393;Ne;0;8;0;8
3692;Karuselė;PAGRANDUKAS;8157193503;Ne;1;5;0;6
3693;Karuselė;PAGRANDUKAS;9651192437;Ne;0;2;0;2
3694;Karuselė;PAGRANDUKAS;7916589127;Ne;0;5;0;5
3695;Karuselė;PAGRANDUKAS;7564618678;Ne;0;10;0;10
3696;Karuselė;PAGRANDUKAS;6546648346;Ne;0;3;0;3
3697;Karuselė;PAGRANDUKAS;8182071103;Ne;0;2;0;2
3698;Karuselė;NYKŠTUKAS;4966362343;Ne;1;2;0;3
3699;Karuselė;NYKŠTUKAS;9997776739;Ne;0;3;0;3
3700;Karuselė;NYKŠTUKAS;4445214427;Ne;0;15;0;15
3701;Karuselė;NYKŠTUKAS;9354431582;Ne;0;3;0;3
3702;Karuselė;NYKŠTUKAS;5216815933;Ne;0;2;0;2
3703;Karuselė;NYKŠTUKAS;7817417459;Ne;0;4;0;4
3704;Karuselė;NYKŠTUKAS;9654804545;Ne;0;14;0;14
3705;Karuselė;NYKŠTUKAS;6581798125;Ne;6;1;0;7
3706;Karuselė;NYKŠTUKAS;1486577955;Ne;9;1;0;10
3707;Karuselė;NYKŠTUKAS;5697305819;Taip;4;5;0;9
3708;Karuselė;NYKŠTUKAS;8007341411;Ne;18;0;0;18
3709;Karuselė;NYKŠTUKAS;4363388969;Ne;18;0;0;18
3710;Karuselė;NYKŠTUKAS;4296509304;Ne;0;1;0;1
3711;Karuselė;NYKŠTUKAS;9243932017;Ne;7;1;0;8
3712;Karuselė;NYKŠTUKAS;5986973796;Ne;18;0;0;18
3713;Karuselė;NYKŠTUKAS;4856589410;Ne;0;3;0;3
3714;Karuselė;NYKŠTUKAS;9999461542;Ne;10;0;0;10
3715;Karuselė;NYKŠTUKAS;9385698812;Ne;9;7;0;16
3716;Karuselė;NYKŠTUKAS;4868770355;Ne;0;2;0;2
3717;Karuselė;NYKŠTUKAS;1084415930;Ne;1;1;0;2
3718;Karuselė;NYKŠTUKAS;9071878406;Ne;5;0;0;5
3719;Karuselė;NYKŠTUKAS;1078396181;Ne;5;0;0;5
3720;Karuselė;BITUTĖ;8175498192;Ne;0;8;5;13
3721;Karuselė;BITUTĖ;5951045233;Ne;0;8;0;8
3722;Karuselė;BITUTĖ;7977133699;Ne;0;7;0;7
3723;Karuselė;BITUTĖ;6165548450;Ne;0;15;2;17
3724;Karuselė;BITUTĖ;4435125556;Ne;0;6;0;6
3725;Karuselė;BITUTĖ;3049506194;Ne;0;14;0;14
3726;Karuselė;BITUTĖ;7733032142;Ne;0;11;0;11
3727;Karuselė;BITUTĖ;1412890120;Ne;0;16;0;16
3728;Karuselė;BITUTĖ;5135054911;Ne;5;7;0;12
3729;Karuselė;BITUTĖ;4130693235;Ne;15;6;0;21
3730;Karuselė;BITUTĖ;8012963667;Ne;0;6;0;6
3731;Karuselė;BITUTĖ;9340167973;Ne;0;6;0;6
3732;Karuselė;BITUTĖ;6826455161;Ne;5;10;0;15
3733;Karuselė;BITUTĖ;3661917922;Ne;5;4;1;10
3734;Karuselė;BITUTĖ;2727440190;Ne;0;6;0;6
3735;Karuselė;BITUTĖ;2306922755;Ne;0;8;3;11
3736;Karuselė;BITUTĖ;6062361348;Ne;0;10;0;10
3737;Karuselė;BITUTĖ;9996567374;Ne;0;9;0;9
3738;Karuselė;BITUTĖ;2529641529;Ne;0;10;0;10
3739;Karuselė;BITUTĖ;4262640017;Ne;7;2;0;9
3740;Karuselė;BITUTĖ;6495631086;Ne;0;7;0;7
3741;Karuselė;BITUTĖ;8406462155;Ne;12;6;0;18
3742;Karuselė;BITUTĖ;2247913568;Ne;0;6;0;6
3743;Karuselė;BORUŽĖLĖ;7030946179;Ne;6;0;8;14
3744;Karuselė;BORUŽĖLĖ;6283563118;Ne;11;0;1;12
3745;Karuselė;BORUŽĖLĖ;9303194274;Ne;3;5;2;10
3746;Karuselė;BORUŽĖLĖ;7817670288;Ne;14;0;0;14
3747;Karuselė;BORUŽĖLĖ;7986277964;Ne;17;0;0;17
3748;Karuselė;BORUŽĖLĖ;5397256562;Ne;4;0;1;5
3749;Karuselė;BORUŽĖLĖ;8004953571;Ne;0;11;0;11
3750;Karuselė;BORUŽĖLĖ;8357973162;Ne;8;0;2;10
3751;Karuselė;BORUŽĖLĖ;8689140295;Ne;12;0;0;12
3752;Karuselė;BORUŽĖLĖ;7430518094;Ne;2;4;4;10
3753;Karuselė;BORUŽĖLĖ;9995800164;Ne;5;0;0;5
3754;Karuselė;BORUŽĖLĖ;8664628232;Ne;25;0;0;25
3755;Karuselė;BORUŽĖLĖ;8234778310;Ne;5;0;2;7
3756;Karuselė;BORUŽĖLĖ;7869324652;Ne;0;0;2;2
3757;Karuselė;BORUŽĖLĖ;5519366758;Ne;10;0;4;14
3758;Karuselė;BORUŽĖLĖ;6669293437;Ne;0;0;3;3
3759;Karuselė;BORUŽĖLĖ;1004895817;Ne;19;0;2;21
3760;Karuselė;UOGELĖ;1119373532;Ne;22;0;0;22
3761;Karuselė;UOGELĖ;2135332292;Ne;8;11;0;19
3762;Karuselė;UOGELĖ;8441520423;Ne;12;0;1;13
3763;Karuselė;UOGELĖ;9463553056;Ne;0;12;0;12
3764;Karuselė;UOGELĖ;8671884362;Ne;0;4;0;4
3765;Karuselė;UOGELĖ;4871960780;Ne;16;0;0;16
3766;Karuselė;UOGELĖ;3551143062;Ne;0;7;0;7
3767;Karuselė;UOGELĖ;8257771271;Ne;0;13;0;13
3768;Karuselė;UOGELĖ;7749015193;Ne;5;9;0;14
3769;Karuselė;UOGELĖ;2993499990;Ne;2;0;0;2
3770;Karuselė;UOGELĖ;3075592618;Ne;11;0;0;11
3771;Karuselė;UOGELĖ;2450390957;Ne;0;11;0;11
3772;Karuselė;UOGELĖ;7535451590;Ne;5;12;0;17
3773;Karuselė;UOGELĖ;4302662341;Ne;0;23;0;23
3774;Karuselė;UOGELĖ;4865727149;Ne;0;1;0;1
3775;Karuselė;UOGELĖ;8952114853;Ne;0;13;0;13
3776;Karuselė;UOGELĖ;9649615834;Ne;10;5;1;16
3777;Karuselė;UOGELĖ;3885475525;Ne;14;6;0;20
3778;Karuselė;UOGELĖ;6562490670;Ne;12;0;1;13
3779;Karuselė;UOGELĖ;4799230363;Ne;25;0;0;25
3780;Karuselė;GINTARĖLIS;3773170060;Ne;9;3;0;12
3781;Karuselė;GINTARĖLIS;3904453423;Ne;9;4;0;13
3782;Karuselė;GINTARĖLIS;7489136297;Ne;11;2;0;13
3783;Karuselė;GINTARĖLIS;3534074990;Ne;13;4;0;17
3784;Karuselė;GINTARĖLIS;7540323186;Ne;8;4;1;13
3785;Karuselė;GINTARĖLIS;1019322763;Ne;8;0;0;8
3786;Karuselė;GINTARĖLIS;8481143199;Ne;6;4;2;12
3787;Karuselė;GINTARĖLIS;3157893936;Ne;14;0;0;14
3788;Karuselė;GINTARĖLIS;8409412605;Ne;11;5;0;16
3789;Karuselė;GINTARĖLIS;7599328323;Ne;5;2;0;7
3790;Karuselė;GINTARĖLIS;2688863117;Ne;15;4;0;19
3791;Karuselė;GINTARĖLIS;7439791054;Ne;13;4;0;17
3792;Karuselė;GINTARĖLIS;3696384277;Ne;11;0;0;11
3793;Karuselė;GINTARĖLIS;2945027875;Ne;13;4;0;17
3794;Karuselė;GINTARĖLIS;8855096080;Ne;8;5;0;13
3795;Karuselė;GINTARĖLIS;9116238924;Ne;8;4;0;12
3796;Karuselė;GINTARĖLIS;6433987745;Ne;8;0;1;9
3797;Karuselė;GINTARĖLIS;9763326660;Ne;8;4;0;12
3798;Karuselė;GINTARĖLIS;9479962436;Taip;5;5;0;10
3799;Karuselė;GINTARĖLIS;6232570825;Ne;9;3;0;12
3800;Karuselė;GINTARĖLIS;3471091687;Ne;11;3;0;14
3801;Karuselė;GINTARĖLIS;4103816990;Ne;12;1;0;13
3802;Karuselė;GINTARĖLIS;4325959483;Ne;5;4;0;9
3803;Karuselė;GINTARĖLIS;6785226197;Ne;0;0;3;3
3804;Karuselė;SAULUTĖ;5627583683;Ne;2;6;0;8
3805;Karuselė;SAULUTĖ;2242659064;Ne;0;7;0;7
3806;Karuselė;SAULUTĖ;5704218177;Ne;12;6;0;18
3807;Karuselė;SAULUTĖ;5146709341;Ne;0;3;0;3
3808;Karuselė;SAULUTĖ;7814525717;Ne;0;8;0;8
3809;Karuselė;SAULUTĖ;8331985564;Ne;0;7;0;7
3810;Karuselė;SAULUTĖ;9400171357;Ne;5;4;0;9
3811;Karuselė;SAULUTĖ;9656723409;Ne;7;2;0;9
3812;Karuselė;SAULUTĖ;5766390337;Ne;0;6;0;6
3813;Karuselė;SAULUTĖ;4879654321;Ne;0;9;0;9
3814;Karuselė;SAULUTĖ;5803808409;Ne;0;13;0;13
3815;Karuselė;SAULUTĖ;2269840705;Ne;0;5;0;5
3816;Karuselė;SAULUTĖ;3149575456;Ne;15;4;0;19
3817;Karuselė;SAULUTĖ;5640656442;Ne;11;5;0;16
3818;Karuselė;SAULUTĖ;9451789237;Ne;0;7;0;7
3819;Karuselė;SAULUTĖ;9450841251;Ne;3;3;0;6
3820;Karuselė;SAULUTĖ;6338379641;Ne;2;2;0;4
3821;Karuselė;SAULUTĖ;8830559511;Ne;5;6;0;11
3822;Karuselė;SAULUTĖ;3228100488;Ne;5;5;2;12
3823;Karuselė;SAULUTĖ;5830080035;Ne;1;6;1;8
3824;Karuselė;SAULUTĖ;9985033530;Ne;7;6;0;13
3825;Karuselė;SAULUTĖ;4211688032;Ne;0;6;0;6
3826;Karuselė;SAULUTĖ;5802996641;Taip;0;14;0;14
3827;Karuselė;SAULUTĖ;3271464159;Ne;0;2;0;2
3828;Karuselė;SAULUTĖ;7501323454;Ne;2;10;0;12
3829;Karuselė;TIGRIUKAS;9561892809;Ne;9;4;0;13
3830;Karuselė;TIGRIUKAS;9726299722;Ne;0;5;0;5
3831;Karuselė;TIGRIUKAS;1576201225;Ne;7;5;0;12
3832;Karuselė;TIGRIUKAS;9344514262;Ne;10;5;0;15
3833;Karuselė;TIGRIUKAS;7131255599;Ne;3;7;0;10
3834;Karuselė;TIGRIUKAS;4180604225;Ne;3;7;0;10
3835;Karuselė;TIGRIUKAS;2397938004;Ne;0;1;0;1
3836;Karuselė;TIGRIUKAS;3605966015;Ne;15;0;0;15
3837;Karuselė;TIGRIUKAS;9633656827;Ne;7;2;0;9
3838;Karuselė;TIGRIUKAS;9252093125;Ne;4;4;0;8
3839;Karuselė;TIGRIUKAS;5176597751;Ne;0;7;0;7
3840;Karuselė;TIGRIUKAS;6656808100;Ne;8;4;0;12
3841;Karuselė;TIGRIUKAS;8474027736;Ne;0;8;0;8
3842;Karuselė;TIGRIUKAS;2549599594;Ne;19;0;0;19
3843;Karuselė;TIGRIUKAS;9394220081;Ne;6;4;0;10
3844;Karuselė;TIGRIUKAS;7618984957;Ne;7;5;0;12
3845;Karuselė;TIGRIUKAS;6678283260;Ne;7;0;0;7
3846;Karuselė;TIGRIUKAS;9736020767;Ne;4;0;0;4
3847;Karuselė;TIGRIUKAS;5964942317;Ne;11;3;0;14
3848;Karuselė;VAIVORYKŠTĖ;1289442716;Ne;1;1;0;2
3849;Karuselė;VAIVORYKŠTĖ;9855242602;Ne;0;7;0;7
3850;Karuselė;VAIVORYKŠTĖ;8063412271;Ne;3;4;0;7
3851;Karuselė;VAIVORYKŠTĖ;9408843254;Taip;4;0;0;4
3852;Karuselė;VAIVORYKŠTĖ;3514315636;Ne;5;1;0;6
3853;Karuselė;VAIVORYKŠTĖ;8085919723;Ne;5;1;0;6
3854;Karuselė;VAIVORYKŠTĖ;1581504806;Ne;8;0;0;8
3855;Karuselė;VAIVORYKŠTĖ;2215367063;Ne;0;1;0;1
3856;Karuselė;VAIVORYKŠTĖ;6424622497;Ne;3;5;0;8
3857;Karuselė;VAIVORYKŠTĖ;5855430678;Ne;4;0;0;4
3858;Karuselė;VAIVORYKŠTĖ;5128774216;Ne;0;14;0;14
3859;Karuselė;VAIVORYKŠTĖ;1604997207;Ne;0;3;0;3
3860;Karuselė;VAIVORYKŠTĖ;2757263085;Ne;0;6;0;6
3861;Karuselė;VAIVORYKŠTĖ;4110024673;Ne;0;4;0;4
3862;Karuselė;VAIVORYKŠTĖ;9400856559;Ne;0;5;0;5
3863;Karuselė;VAIVORYKŠTĖ;1083786182;Ne;0;5;0;5
3864;Karuselė;VAIVORYKŠTĖ;5998868204;Ne;0;1;0;1
3865;Karuselė;VAIVORYKŠTĖ;6734936247;Ne;4;1;0;5
3866;Karuselė;VAIVORYKŠTĖ;3082636224;Ne;3;2;0;5
3867;Karuselė;VAIVORYKŠTĖ;4749086136;Ne;6;0;0;6
3868;Karuselė;VAIVORYKŠTĖ;8371081106;Ne;7;0;1;8
3869;Karuselė;"AUKSINĖ ŽUVELĖ";1344025242;Ne;23;0;0;23
3870;Karuselė;"AUKSINĖ ŽUVELĖ";6048980111;Ne;12;0;0;12
3871;Karuselė;"AUKSINĖ ŽUVELĖ";9535490329;Ne;12;0;0;12
3872;Karuselė;"AUKSINĖ ŽUVELĖ";5313839511;Ne;25;0;0;25
3873;Karuselė;"AUKSINĖ ŽUVELĖ";8074453862;Ne;10;5;0;15
3874;Karuselė;"AUKSINĖ ŽUVELĖ";5912561598;Ne;10;6;0;16
3875;Karuselė;"AUKSINĖ ŽUVELĖ";3728662112;Ne;13;1;2;16
3876;Karuselė;"AUKSINĖ ŽUVELĖ";9170947196;Ne;5;5;0;10
3877;Karuselė;"AUKSINĖ ŽUVELĖ";9814977329;Ne;4;0;0;4
3878;Karuselė;"AUKSINĖ ŽUVELĖ";4982029137;Ne;26;0;0;26
3879;Karuselė;"AUKSINĖ ŽUVELĖ";3408146969;Ne;7;10;1;18
3880;Karuselė;"AUKSINĖ ŽUVELĖ";3464711958;Ne;0;30;0;30
3881;Karuselė;"AUKSINĖ ŽUVELĖ";1044597936;Ne;16;1;0;17
3882;Karuselė;"AUKSINĖ ŽUVELĖ";6932524178;Ne;13;0;0;13
3883;Karuselė;RAMUNĖ;6319361312;Ne;0;0;7;7
3884;Karuselė;RAMUNĖ;5666333470;Ne;0;5;0;5
3885;Karuselė;RAMUNĖ;6370060620;Ne;11;0;1;12
3886;Karuselė;RAMUNĖ;6844148347;Ne;15;2;0;17
3887;Karuselė;RAMUNĖ;7250708607;Ne;13;3;0;16
3888;Karuselė;RAMUNĖ;3890681011;Ne;21;0;0;21
3889;Karuselė;RAMUNĖ;6469579272;Ne;30;0;0;30
3890;Karuselė;RAMUNĖ;4707292159;Ne;9;1;0;10
3891;Karuselė;RAMUNĖ;5926712250;Ne;5;0;3;8
3892;Karuselė;RAMUNĖ;1427836663;Taip;10;0;2;12
3893;Karuselė;RAMUNĖ;3008219926;Ne;5;6;0;11
3894;Karuselė;RAMUNĖ;5736966465;Ne;5;0;3;8
3895;Karuselė;RAMUNĖ;9789687336;Ne;23;1;2;26
3896;Karuselė;RAMUNĖ;2843226066;Ne;15;0;0;15
3897;Karuselė;RAMUNĖ;8590035431;Ne;7;1;0;8
3898;Karuselė;RAMUNĖ;3276397300;Ne;9;13;0;22
3899;Karuselė;VILKELIS;7721986618;Ne;0;4;0;4
3900;Karuselė;VILKELIS;6300348828;Ne;4;1;0;5
3901;Karuselė;VILKELIS;3485160781;Ne;6;2;0;8
3902;Karuselė;VILKELIS;2500977616;Ne;0;2;0;2
3903;Karuselė;VILKELIS;8238334389;Ne;2;3;0;5
3904;Karuselė;VILKELIS;5036757881;Ne;10;6;0;16
3905;Karuselė;VILKELIS;7794320463;Ne;10;3;0;13
3906;Karuselė;VILKELIS;7052993128;Ne;3;0;1;4
3907;Karuselė;VILKELIS;7480485777;Ne;5;0;0;5
3908;Karuselė;VILKELIS;6341570221;Ne;14;0;0;14
3909;Karuselė;VILKELIS;3622914118;Ne;6;4;0;10
3910;Karuselė;VILKELIS;4566201460;Ne;9;0;0;9
3911;Karuselė;VILKELIS;8848085495;Ne;17;1;0;18
3912;Karuselė;VILKELIS;8362740639;Ne;4;1;0;5
3913;Karuselė;VILKELIS;2842034472;Ne;10;0;0;10
3914;Karuselė;VILKELIS;8531556390;Ne;0;5;0;5
3915;Karuselė;VILKELIS;4757820179;Ne;2;5;0;7
3916;Karuselė;VILKELIS;9415377698;Ne;0;5;0;5
3917;Karuselė;VILKELIS;2260731421;Ne;10;1;0;11
3918;Karuselė;VILKELIS;4196250786;Ne;12;0;0;12
3919;Karuselė;VILKELIS;3460470459;Ne;8;5;0;13
3920;Kaštonas;NYKŠTUKAI;8145965849;Ne;1;1;0;2
3921;Kaštonas;NYKŠTUKAI;2178971789;Ne;0;4;0;4
3922;Kaštonas;NYKŠTUKAI;2361839733;Ne;9;4;0;13
3923;Kaštonas;NYKŠTUKAI;4782280933;Ne;8;3;0;11
3924;Kaštonas;NYKŠTUKAI;1258105498;Ne;1;3;0;4
3925;Kaštonas;NYKŠTUKAI;8766848385;Ne;19;0;0;19
3926;Kaštonas;NYKŠTUKAI;3251132542;Ne;6;3;0;9
3927;Kaštonas;NYKŠTUKAI;1501441973;Ne;5;3;0;8
3928;Kaštonas;NYKŠTUKAI;5948707303;Ne;9;4;0;13
3929;Kaštonas;NYKŠTUKAI;1027896631;Ne;2;3;0;5
3930;Kaštonas;NYKŠTUKAI;4854158033;Ne;0;6;0;6
3931;Kaštonas;NYKŠTUKAI;8158855458;Ne;10;3;0;13
3932;Kaštonas;NYKŠTUKAI;4353473162;Ne;5;4;0;9
3933;Kaštonas;NYKŠTUKAI;3456815576;Ne;4;5;0;9
3934;Kaštonas;NYKŠTUKAI;5350239917;Ne;0;4;0;4
3935;Kaštonas;NYKŠTUKAI;6515739350;Ne;5;4;0;9
3936;Kaštonas;NYKŠTUKAI;2281935638;Ne;5;4;0;9
3937;Kaštonas;NYKŠTUKAI;7088197668;Ne;5;3;0;8
3938;Kaštonas;DRUGELIAI;8486955652;Ne;8;4;0;12
3939;Kaštonas;DRUGELIAI;2106924435;Ne;10;0;0;10
3940;Kaštonas;DRUGELIAI;8483888152;Ne;0;7;0;7
3941;Kaštonas;DRUGELIAI;7408901858;Ne;5;7;0;12
3942;Kaštonas;DRUGELIAI;8582453109;Ne;0;3;0;3
3943;Kaštonas;DRUGELIAI;2832688622;Ne;6;4;0;10
3944;Kaštonas;DRUGELIAI;9061158412;Ne;6;4;0;10
3945;Kaštonas;DRUGELIAI;5884427036;Ne;0;5;0;5
3946;Kaštonas;DRUGELIAI;5969052108;Ne;8;3;0;11
3947;Kaštonas;DRUGELIAI;8166925991;Ne;0;8;0;8
3948;Kaštonas;DRUGELIAI;4215759647;Ne;0;9;0;9
3949;Kaštonas;DRUGELIAI;5307755844;Ne;0;2;0;2
3950;Kaštonas;DRUGELIAI;8257643251;Ne;13;0;0;13
3951;Kaštonas;DRUGELIAI;4384907654;Ne;7;6;0;13
3952;Kaštonas;DRUGELIAI;1976138680;Ne;0;2;0;2
3953;Kaštonas;DRUGELIAI;7992154554;Ne;0;3;0;3
3954;Kaštonas;DRUGELIAI;7698074598;Ne;16;0;0;16
3955;Kaštonas;DRUGELIAI;1862173525;Ne;0;2;0;2
3956;Kaštonas;KIŠKUČIAI;9807554365;Ne;0;2;0;2
3957;Kaštonas;KIŠKUČIAI;4552007726;Ne;4;2;0;6
3958;Kaštonas;KIŠKUČIAI;2020612346;Ne;0;12;0;12
3959;Kaštonas;KIŠKUČIAI;6585977073;Ne;19;0;0;19
3960;Kaštonas;KIŠKUČIAI;7383219978;Ne;0;10;0;10
3961;Kaštonas;KIŠKUČIAI;4641535612;Ne;0;9;0;9
3962;Kaštonas;KIŠKUČIAI;4708114402;Ne;0;1;0;1
3963;Kaštonas;KIŠKUČIAI;2057499534;Ne;0;1;0;1
3964;Kaštonas;KIŠKUČIAI;6749679348;Ne;3;3;0;6
3965;Kaštonas;KIŠKUČIAI;3860613494;Ne;0;7;0;7
3966;Kaštonas;KIŠKUČIAI;9778140363;Ne;19;0;0;19
3967;Kaštonas;KIŠKUČIAI;7290414209;Ne;0;9;0;9
3968;Kaštonas;KIŠKUČIAI;9356018629;Ne;11;3;0;14
3969;Kaštonas;KIŠKUČIAI;9320223622;Ne;0;7;0;7
3970;Kaštonas;KIŠKUČIAI;6425908247;Ne;7;0;0;7
3971;Kaštonas;KIŠKUČIAI;2874873326;Ne;4;7;0;11
3972;Kaštonas;KIŠKUČIAI;6934262510;Ne;0;8;0;8
3973;Kaštonas;KIŠKUČIAI;9034859988;Ne;10;4;0;14
3974;Kaštonas;KIŠKUČIAI;9249007247;Ne;0;4;0;4
3975;Kaštonas;KIŠKUČIAI;2218450479;Ne;0;3;0;3
3976;Kaštonas;BITUTĖS;2898327157;Ne;0;9;0;9
3977;Kaštonas;BITUTĖS;1207372235;Ne;4;4;0;8
3978;Kaštonas;BITUTĖS;9298372326;Ne;4;0;0;4
3979;Kaštonas;BITUTĖS;4115242811;Ne;2;4;0;6
3980;Kaštonas;BITUTĖS;6896372095;Ne;0;5;0;5
3981;Kaštonas;BITUTĖS;4020980625;Ne;2;1;0;3
3982;Kaštonas;BITUTĖS;1684641447;Ne;9;4;0;13
3983;Kaštonas;BITUTĖS;1761520786;Ne;11;0;0;11
3984;Kaštonas;BITUTĖS;8250964197;Ne;0;11;0;11
3985;Kaštonas;BITUTĖS;7946379086;Ne;2;3;0;5
3986;Kaštonas;BITUTĖS;9285927858;Ne;0;8;0;8
3987;Kaštonas;BITUTĖS;9903176616;Ne;0;6;0;6
3988;Kaštonas;BITUTĖS;8275673303;Ne;6;0;0;6
3989;Kaštonas;BITUTĖS;1614180834;Ne;3;4;1;8
3990;Kaštonas;BITUTĖS;2877124424;Ne;3;8;0;11
3991;Kaštonas;BITUTĖS;1031628633;Ne;7;1;0;8
3992;Kaštonas;BITUTĖS;4551111709;Ne;5;1;0;6
3993;Kaštonas;BITUTĖS;7291448857;Ne;0;5;0;5
3994;Kaštonas;BITUTĖS;4837002666;Taip;17;0;0;17
3995;Kaštonas;BITUTĖS;6175014441;Ne;0;3;0;3
3996;Kaštonas;BITUTĖS;1748975865;Ne;9;5;0;14
3997;Kaštonas;BITUTĖS;3544696101;Ne;0;1;0;1
3998;Kaštonas;MEŠKIUKAI;2228759708;Ne;4;4;0;8
3999;Kaštonas;MEŠKIUKAI;6613837801;Ne;0;3;0;3
4000;Kaštonas;MEŠKIUKAI;6263544162;Ne;0;2;0;2
4001;Kaštonas;MEŠKIUKAI;8775608339;Ne;0;5;0;5
4002;Kaštonas;MEŠKIUKAI;6289073634;Ne;5;7;0;12
4003;Kaštonas;MEŠKIUKAI;4616084852;Ne;7;4;0;11
4004;Kaštonas;MEŠKIUKAI;5157500600;Ne;0;4;0;4
4005;Kaštonas;MEŠKIUKAI;6967725663;Ne;0;4;0;4
4006;Kaštonas;MEŠKIUKAI;4308169582;Ne;5;2;0;7
4007;Kaštonas;MEŠKIUKAI;6589898580;Ne;0;9;0;9
4008;Kaštonas;MEŠKIUKAI;4824511567;Ne;4;4;0;8
4009;Kaštonas;MEŠKIUKAI;3961661158;Ne;0;7;0;7
4010;Kaštonas;MEŠKIUKAI;8318869054;Ne;11;4;0;15
4011;Kaštonas;MEŠKIUKAI;2434765663;Ne;7;4;0;11
4012;Kaštonas;MEŠKIUKAI;8867446698;Ne;0;4;0;4
4013;Kaštonas;MEŠKIUKAI;4444087861;Ne;0;5;0;5
4014;Kaštonas;MEŠKIUKAI;9379171183;Ne;2;6;2;10
4015;Kaštonas;MEŠKIUKAI;6254250706;Ne;0;9;0;9
4016;Kaštonas;MEŠKIUKAI;1262404954;Ne;0;9;0;9
4017;Kaštonas;MEŠKIUKAI;9014726465;Ne;0;5;0;5
4018;Kaštonas;MEŠKIUKAI;2165890763;Ne;0;3;0;3
4019;Kaštonas;MEŠKIUKAI;3383390078;Ne;5;7;0;12
4020;Kaštonas;BORUŽĖLĖS;8637978949;Ne;19;0;0;19
4021;Kaštonas;BORUŽĖLĖS;6891429484;Ne;5;1;0;6
4022;Kaštonas;BORUŽĖLĖS;6442448667;Ne;4;5;0;9
4023;Kaštonas;BORUŽĖLĖS;2345742465;Ne;1;1;0;2
4024;Kaštonas;BORUŽĖLĖS;5060824071;Ne;0;5;0;5
4025;Kaštonas;BORUŽĖLĖS;7141682810;Ne;0;6;0;6
4026;Kaštonas;BORUŽĖLĖS;3279850526;Ne;0;1;0;1
4027;Kaštonas;BORUŽĖLĖS;4285107537;Ne;14;1;0;15
4028;Kaštonas;BORUŽĖLĖS;3153834010;Ne;14;1;0;15
4029;Kaštonas;BORUŽĖLĖS;8820616057;Ne;0;8;0;8
4030;Kaštonas;BORUŽĖLĖS;3839816548;Ne;9;4;0;13
4031;Kaštonas;BORUŽĖLĖS;5329898590;Ne;7;2;0;9
4032;Kaštonas;BORUŽĖLĖS;2356291627;Ne;10;2;0;12
4033;"Krivūlė (Lydos g. 5)";SPINDULIUKAI;1937803301;Ne;0;0;2;2
4034;"Krivūlė (Lydos g. 5)";SPINDULIUKAI;9865192795;Ne;0;0;2;2
4035;"Krivūlė (Lydos g. 5)";SPINDULIUKAI;3913058095;Ne;0;0;8;8
4036;"Krivūlė (Lydos g. 5)";SPINDULIUKAI;1840809151;Ne;0;4;3;7
4037;"Krivūlė (Lydos g. 5)";SPINDULIUKAI;7335245963;Ne;0;4;0;4
4038;"Krivūlė (Lydos g. 5)";SPINDULIUKAI;5802739148;Ne;0;8;0;8
4039;"Krivūlė (Lydos g. 5)";SPINDULIUKAI;5667934115;Ne;0;4;1;5
4040;"Krivūlė (Lydos g. 5)";SPINDULIUKAI;8348288864;Ne;0;4;0;4
4041;"Krivūlė (Lydos g. 5)";SPINDULIUKAI;7155162698;Ne;0;4;2;6
4042;"Krivūlė (Lydos g. 5)";SPINDULIUKAI;1151179495;Ne;0;4;0;4
4043;"Krivūlė (Lydos g. 5)";SPINDULIUKAI;9320613086;Ne;9;0;0;9
4044;"Krivūlė (Lydos g. 5)";SPINDULIUKAI;4750075323;Ne;0;4;0;4
4045;"Krivūlė (Lydos g. 5)";SPINDULIUKAI;3852793979;Ne;4;5;0;9
4046;"Krivūlė (Lydos g. 5)";SPINDULIUKAI;3184820008;Ne;0;0;5;5
4047;"Krivūlė (Lydos g. 5)";SPINDULIUKAI;7149268223;Ne;0;0;6;6
4048;"Krivūlė (Lydos g. 5)";SPINDULIUKAI;7025398689;Ne;9;0;0;9
4049;"Krivūlė (Lydos g. 5)";SPINDULIUKAI;4943482123;Ne;0;0;7;7
4050;"Krivūlė (Lydos g. 5)";SPINDULIUKAI;9815421737;Ne;6;0;6;12
4051;"Krivūlė (Lydos g. 5)";SPINDULIUKAI;4619224314;Ne;0;19;0;19
4052;"Krivūlė (Lydos g. 5)";SPINDULIUKAI;3999214263;Ne;0;0;5;5
4053;"Krivūlė (Lydos g. 5)";BORUŽĖLĖS;3357889614;Ne;7;0;0;7
4054;"Krivūlė (Lydos g. 5)";BORUŽĖLĖS;8711082048;Ne;0;0;5;5
4055;"Krivūlė (Lydos g. 5)";BORUŽĖLĖS;2915437387;Ne;0;0;3;3
4056;"Krivūlė (Lydos g. 5)";BORUŽĖLĖS;8304613793;Ne;0;0;4;4
4057;"Krivūlė (Lydos g. 5)";BORUŽĖLĖS;9030517214;Ne;0;0;2;2
4058;"Krivūlė (Lydos g. 5)";BORUŽĖLĖS;3588408699;Ne;0;0;3;3
4059;"Krivūlė (Lydos g. 5)";BORUŽĖLĖS;7102769750;Ne;0;4;0;4
4060;"Krivūlė (Lydos g. 5)";BORUŽĖLĖS;6854278025;Ne;9;1;3;13
4061;"Krivūlė (Lydos g. 5)";BORUŽĖLĖS;4944001828;Ne;0;0;8;8
4062;"Krivūlė (Lydos g. 5)";BORUŽĖLĖS;2240949291;Ne;0;0;4;4
4063;"Krivūlė (Lydos g. 5)";BORUŽĖLĖS;9732635621;Ne;0;0;5;5
4064;"Krivūlė (Lydos g. 5)";BORUŽĖLĖS;3368847042;Ne;8;0;0;8
4065;"Krivūlė (Lydos g. 5)";BORUŽĖLĖS;3230340284;Ne;0;0;7;7
4066;"Krivūlė (Lydos g. 5)";BORUŽĖLĖS;6283777399;Ne;0;4;7;11
4067;"Krivūlė (Lydos g. 5)";BORUŽĖLĖS;4454327278;Ne;12;4;0;16
4068;"Krivūlė (Lydos g. 5)";BORUŽĖLĖS;1220698436;Ne;0;19;0;19
4069;"Krivūlė (Lydos g. 5)";DRUGELIŲ;6004925249;Ne;0;4;0;4
4070;"Krivūlė (Lydos g. 5)";DRUGELIŲ;5113297248;Ne;0;4;7;11
4071;"Krivūlė (Lydos g. 5)";DRUGELIŲ;9306686488;Ne;0;4;0;4
4072;"Krivūlė (Lydos g. 5)";DRUGELIŲ;5596874303;Ne;11;4;0;15
4073;"Krivūlė (Lydos g. 5)";DRUGELIŲ;4297876008;Ne;0;3;4;7
4074;"Krivūlė (Lydos g. 5)";DRUGELIŲ;2138125571;Ne;0;4;0;4
4075;"Krivūlė (Lydos g. 5)";DRUGELIŲ;2711010212;Ne;0;5;3;8
4076;"Krivūlė (Lydos g. 5)";DRUGELIŲ;7781918674;Ne;0;4;0;4
4077;"Krivūlė (Lydos g. 5)";DRUGELIŲ;3246787504;Ne;0;0;6;6
4078;"Krivūlė (Lydos g. 5)";DRUGELIŲ;3605506478;Ne;0;0;1;1
4079;"Krivūlė (Lydos g. 5)";DRUGELIŲ;4896656209;Ne;0;0;1;1
4080;"Krivūlė (Lydos g. 5)";DRUGELIŲ;5531566792;Ne;0;0;3;3
4081;"Krivūlė (Lydos g. 5)";DRUGELIŲ;4025821636;Ne;0;0;1;1
4082;"Krivūlė (Lydos g. 5)";DRUGELIŲ;4972360440;Ne;0;0;1;1
4083;"Krivūlė (Lydos g. 5)";DRUGELIŲ;1171226193;Ne;0;0;6;6
4084;"Krivūlė (Lydos g. 5)";DRUGELIŲ;5683183310;Ne;6;2;1;9
4085;"Krivūlė (Lydos g. 5)";DRUGELIŲ;1815336153;Ne;0;5;0;5
4086;"Krivūlė (Lydos g. 5)";DRUGELIŲ;6832582194;Ne;0;0;5;5
4087;"Krivūlė (Lydos g. 5)";"BITUTĖS (VALDOFRO)";3769812444;Ne;0;4;0;4
4088;"Krivūlė (Lydos g. 5)";"BITUTĖS (VALDOFRO)";5128760019;Ne;0;4;0;4
4089;"Krivūlė (Lydos g. 5)";"BITUTĖS (VALDOFRO)";2647149927;Ne;0;5;0;5
4090;"Krivūlė (Lydos g. 5)";"BITUTĖS (VALDOFRO)";9632352765;Ne;0;5;0;5
4091;"Krivūlė (Lydos g. 5)";"BITUTĖS (VALDOFRO)";7848471009;Ne;0;0;2;2
4092;"Krivūlė (Lydos g. 5)";"BITUTĖS (VALDOFRO)";8834855616;Ne;4;6;0;10
4093;"Krivūlė (Lydos g. 5)";"BITUTĖS (VALDOFRO)";3655576855;Ne;0;4;1;5
4094;"Krivūlė (Lydos g. 5)";"BITUTĖS (VALDOFRO)";1561180871;Ne;0;13;0;13
4095;"Krivūlė (Lydos g. 5)";"BITUTĖS (VALDOFRO)";9702372816;Ne;15;0;0;15
4096;"Krivūlė (Lydos g. 5)";"BITUTĖS (VALDOFRO)";8105688948;Ne;5;4;0;9
4097;"Krivūlė (Lydos g. 5)";"BITUTĖS (VALDOFRO)";1932209134;Ne;0;0;9;9
4098;"Krivūlė (Lydos g. 5)";"BITUTĖS (VALDOFRO)";7768827505;Ne;0;0;9;9
4099;"Krivūlė (Lydos g. 5)";"BITUTĖS (VALDOFRO)";7199431924;Ne;0;4;0;4
4100;"Krivūlė (Lydos g. 5)";"BITUTĖS (VALDOFRO)";7714519095;Ne;12;0;1;13
4101;"Krivūlė (Lydos g. 5)";"BITUTĖS (VALDOFRO)";9409899522;Ne;0;0;4;4
4102;"Krivūlė (Lydos g. 5)";"BITUTĖS (VALDOFRO)";6365743037;Ne;0;4;0;4
4103;"Krivūlė (Lydos g. 5)";"BITUTĖS (VALDOFRO)";8748668583;Ne;0;0;4;4
4104;"Krivūlė (Lydos g. 5)";"BITUTĖS (VALDOFRO)";6830712749;Ne;0;0;6;6
4105;"Krivūlė (Lydos g. 5)";"BITUTĖS (VALDOFRO)";5600651110;Ne;5;4;0;9
4106;"Krivūlė (Lydos g. 5)";"BITUTĖS (VALDOFRO)";8352493729;Ne;0;0;2;2
4107;"Krivūlė (Lydos g. 5)";"BITUTĖS (VALDOFRO)";9229817861;Ne;0;0;6;6
4108;"Krivūlė (Lydos g. 5)";"BITUTĖS (VALDOFRO)";9388352593;Ne;0;0;4;4
4109;"Krivūlė (Lydos g. 5)";"BITUTĖS (VALDOFRO)";4699320250;Ne;0;0;5;5
4110;"Krivūlė (Lydos g. 5)";EŽIUKAI;8042185027;Ne;3;0;3;6
4111;"Krivūlė (Lydos g. 5)";EŽIUKAI;3616024832;Ne;0;4;3;7
4112;"Krivūlė (Lydos g. 5)";EŽIUKAI;7242596817;Ne;0;10;0;10
4113;"Krivūlė (Lydos g. 5)";EŽIUKAI;5664892835;Ne;7;0;0;7
4114;"Krivūlė (Lydos g. 5)";EŽIUKAI;8399607572;Ne;7;0;0;7
4115;"Krivūlė (Lydos g. 5)";EŽIUKAI;5369083173;Ne;2;0;4;6
4116;"Krivūlė (Lydos g. 5)";EŽIUKAI;9051038248;Ne;12;0;5;17
4117;"Krivūlė (Lydos g. 5)";EŽIUKAI;3144577262;Ne;0;0;8;8
4118;"Krivūlė (Lydos g. 5)";EŽIUKAI;1898389557;Ne;0;0;4;4
4119;"Krivūlė (Lydos g. 5)";EŽIUKAI;2607716072;Ne;0;0;8;8
4120;"Krivūlė (Lydos g. 5)";EŽIUKAI;3836712448;Ne;0;0;3;3
4121;"Krivūlė (Lydos g. 5)";EŽIUKAI;8873132189;Ne;0;2;0;2
4122;"Krivūlė (Lydos g. 5)";EŽIUKAI;2430372719;Ne;0;3;0;3
4123;"Krivūlė (Lydos g. 5)";EŽIUKAI;1893542120;Ne;0;0;7;7
4124;"Krivūlė (Lydos g. 5)";EŽIUKAI;1622229289;Ne;0;2;3;5
4125;"Krivūlė (Lydos g. 5)";EŽIUKAI;2157856704;Ne;0;0;5;5
4126;"Krivūlė (Lydos g. 5)";EŽIUKAI;4547087565;Ne;0;0;3;3
4127;"Krivūlė (Lydos g. 5)";EŽIUKAI;1189206089;Ne;0;0;8;8
4128;"Krivūlė (Lydos g. 5)";EŽIUKAI;1125863541;Ne;0;4;0;4
4129;"Krivūlė (Lydos g. 5)";EŽIUKAI;2448906549;Ne;0;0;3;3
4130;"Krivūlė (Lydos g. 5)";EŽIUKAI;6248684084;Ne;0;0;1;1
4131;"Krivūlė (Lydos g. 5)";NYKŠTUKAI;9820383193;Ne;0;4;0;4
4132;"Krivūlė (Lydos g. 5)";NYKŠTUKAI;2742783991;Ne;0;3;1;4
4133;"Krivūlė (Lydos g. 5)";NYKŠTUKAI;9401810791;Ne;0;0;3;3
4134;"Krivūlė (Lydos g. 5)";NYKŠTUKAI;8713384668;Ne;8;0;0;8
4135;"Krivūlė (Lydos g. 5)";NYKŠTUKAI;9678890051;Ne;0;5;0;5
4136;"Krivūlė (Lydos g. 5)";NYKŠTUKAI;8767554721;Ne;0;1;7;8
4137;"Krivūlė (Lydos g. 5)";NYKŠTUKAI;9529242858;Ne;2;0;2;4
4138;"Krivūlė (Lydos g. 5)";NYKŠTUKAI;8898023612;Ne;0;3;5;8
4139;"Krivūlė (Lydos g. 5)";NYKŠTUKAI;5768244312;Ne;0;5;0;5
4140;"Krivūlė (Lydos g. 5)";NYKŠTUKAI;7540940063;Ne;0;3;0;3
4141;"Krivūlė (Lydos g. 5)";NYKŠTUKAI;7262017017;Ne;0;3;0;3
4142;"Krivūlė (Lydos g. 5)";NYKŠTUKAI;6548893885;Ne;0;0;3;3
4143;"Krivūlė (Lydos g. 5)";NYKŠTUKAI;8674468359;Ne;0;0;15;15
4144;"Krivūlė (Lydos g. 5)";NYKŠTUKAI;8047735389;Ne;0;1;0;1
4145;"Krivūlė (Lydos g. 5)";NYKŠTUKAI;6466188552;Ne;16;0;0;16
4146;"Kodėlčiukas (Laisvės pr. 59)";Saulutės;6517880481;Ne;0;1;0;1
4147;"Kodėlčiukas (Laisvės pr. 59)";Saulutės;1725624698;Ne;1;4;0;5
4148;"Kodėlčiukas (Laisvės pr. 59)";Saulutės;7509476161;Ne;3;2;0;5
4149;"Kodėlčiukas (Laisvės pr. 59)";Saulutės;7327247516;Ne;3;4;0;7
4150;"Kodėlčiukas (Laisvės pr. 59)";Saulutės;1645680526;Ne;0;5;0;5
4151;"Kodėlčiukas (Laisvės pr. 59)";Saulutės;8992265000;Ne;2;3;1;6
4152;"Kodėlčiukas (Laisvės pr. 59)";Saulutės;6285018663;Ne;0;5;0;5
4153;"Kodėlčiukas (Laisvės pr. 59)";Saulutės;1033969800;Ne;0;4;0;4
4154;"Kodėlčiukas (Laisvės pr. 59)";Saulutės;2433094435;Ne;0;2;0;2
4155;"Kodėlčiukas (Laisvės pr. 59)";Saulutės;9042404309;Ne;0;4;1;5
4156;"Kodėlčiukas (Laisvės pr. 59)";Saulutės;3276075664;Ne;0;1;0;1
4157;"Kodėlčiukas (Laisvės pr. 59)";Saulutės;7611485881;Ne;0;5;0;5
4158;"Kodėlčiukas (Laisvės pr. 59)";Saulutės;7561763602;Ne;0;4;0;4
4159;"Kodėlčiukas (Laisvės pr. 59)";Saulutės;2289687766;Ne;0;3;0;3
4160;"Kodėlčiukas (Laisvės pr. 59)";Saulutės;1992569595;Ne;6;4;0;10
4161;"Kodėlčiukas (Laisvės pr. 59)";Saulutės;9527296531;Ne;0;3;7;10
4162;"Kodėlčiukas (Laisvės pr. 59)";Saulutės;8070400563;Ne;0;2;0;2
4163;"Kodėlčiukas (Laisvės pr. 59)";Saulutės;8447045958;Ne;8;4;0;12
4164;"Kodėlčiukas (Laisvės pr. 59)";Saulutės;2542104903;Ne;0;8;0;8
4165;"Kodėlčiukas (Laisvės pr. 59)";Saulutės;2162480212;Ne;0;1;0;1
4166;"Kodėlčiukas (Laisvės pr. 59)";Nežiniukai;9226992006;Ne;14;0;0;14
4167;"Kodėlčiukas (Laisvės pr. 59)";Nežiniukai;9404369378;Ne;9;0;2;11
4168;"Kodėlčiukas (Laisvės pr. 59)";Nežiniukai;2301454083;Ne;0;3;0;3
4169;"Kodėlčiukas (Laisvės pr. 59)";Nežiniukai;6041087039;Ne;9;0;0;9
4170;"Kodėlčiukas (Laisvės pr. 59)";Nežiniukai;7283028602;Ne;1;0;0;1
4171;"Kodėlčiukas (Laisvės pr. 59)";Nežiniukai;8439867734;Ne;0;4;0;4
4172;"Kodėlčiukas (Laisvės pr. 59)";Nežiniukai;8734412840;Ne;10;4;0;14
4173;"Kodėlčiukas (Laisvės pr. 59)";Nežiniukai;1682040192;Ne;3;0;0;3
4174;"Kodėlčiukas (Laisvės pr. 59)";Nežiniukai;3060543464;Ne;7;0;0;7
4175;"Kodėlčiukas (Laisvės pr. 59)";Nežiniukai;8475052982;Ne;1;0;0;1
4176;"Kodėlčiukas (Laisvės pr. 59)";Nežiniukai;7167508091;Ne;12;0;0;12
4177;"Kodėlčiukas (Laisvės pr. 59)";Nežiniukai;9770476641;Ne;8;0;0;8
4178;"Kodėlčiukas (Laisvės pr. 59)";Nežiniukai;2350656752;Ne;6;6;0;12
4179;"Kodėlčiukas (Laisvės pr. 59)";Nežiniukai;8644416746;Ne;12;0;0;12
4180;"Kodėlčiukas (Laisvės pr. 59)";Nežiniukai;6164851553;Ne;7;0;0;7
4181;"Kodėlčiukas (Laisvės pr. 59)";Nežiniukai;8435298904;Ne;6;1;0;7
4182;"Kodėlčiukas (Laisvės pr. 59)";Gintarėliai;5891546827;Ne;14;0;1;15
4183;"Kodėlčiukas (Laisvės pr. 59)";Gintarėliai;7710811301;Taip;6;0;2;8
4184;"Kodėlčiukas (Laisvės pr. 59)";Gintarėliai;9085395350;Ne;0;0;5;5
4185;"Kodėlčiukas (Laisvės pr. 59)";Gintarėliai;6409157827;Ne;4;0;0;4
4186;"Kodėlčiukas (Laisvės pr. 59)";Gintarėliai;8101197864;Ne;0;0;3;3
4187;"Kodėlčiukas (Laisvės pr. 59)";Gintarėliai;2543628770;Ne;1;0;4;5
4188;"Kodėlčiukas (Laisvės pr. 59)";Gintarėliai;8911944991;Taip;11;0;0;11
4189;"Kodėlčiukas (Laisvės pr. 59)";Gintarėliai;6670171992;Ne;0;0;4;4
4190;"Kodėlčiukas (Laisvės pr. 59)";Gintarėliai;2465920649;Ne;1;0;2;3
4191;"Kodėlčiukas (Laisvės pr. 59)";Gintarėliai;8348024909;Ne;3;0;4;7
4192;"Kodėlčiukas (Laisvės pr. 59)";Gintarėliai;4293763647;Ne;5;0;2;7
4193;"Kodėlčiukas (Laisvės pr. 59)";Gintarėliai;3878358193;Ne;0;0;4;4
4194;"Kodėlčiukas (Laisvės pr. 59)";Gintarėliai;6935233288;Ne;14;0;0;14
4195;"Kodėlčiukas (Laisvės pr. 59)";Gintarėliai;1835522972;Ne;8;1;1;10
4196;"Kodėlčiukas (Laisvės pr. 59)";Gintarėliai;5541555127;Ne;5;1;3;9
4197;"Kodėlčiukas (Laisvės pr. 59)";Gintarėliai;8759498015;Ne;2;0;3;5
4198;"Kodėlčiukas (Laisvės pr. 59)";Gintarėliai;2802895479;Ne;5;9;0;14
4199;"Kodėlčiukas (Laisvės pr. 59)";Gintarėliai;9914565606;Ne;5;0;7;12
4200;"Kodėlčiukas (Laisvės pr. 59)";Gintarėliai;7686420784;Ne;0;0;6;6
4201;"Kodėlčiukas (Laisvės pr. 59)";Gintarėliai;3037267215;Taip;5;4;0;9
4202;"Kodėlčiukas (Laisvės pr. 59)";Šnekučiai;6761903865;Ne;0;3;2;5
4203;"Kodėlčiukas (Laisvės pr. 59)";Šnekučiai;3778271049;Ne;1;4;0;5
4204;"Kodėlčiukas (Laisvės pr. 59)";Šnekučiai;7510273691;Ne;1;4;0;5
4205;"Kodėlčiukas (Laisvės pr. 59)";Šnekučiai;5075801618;Ne;0;4;0;4
4206;"Kodėlčiukas (Laisvės pr. 59)";Šnekučiai;4490196764;Ne;0;2;0;2
4207;"Kodėlčiukas (Laisvės pr. 59)";Šnekučiai;8779350309;Ne;0;2;0;2
4208;"Kodėlčiukas (Laisvės pr. 59)";Šnekučiai;5952121209;Ne;0;10;0;10
4209;"Kodėlčiukas (Laisvės pr. 59)";Šnekučiai;2351468626;Ne;0;2;0;2
4210;"Kodėlčiukas (Laisvės pr. 59)";Šnekučiai;9208137169;Ne;0;5;2;7
4211;"Kodėlčiukas (Laisvės pr. 59)";Šnekučiai;5876187643;Ne;1;4;0;5
4212;"Kodėlčiukas (Laisvės pr. 59)";Šnekučiai;4866089623;Ne;0;4;1;5
4213;"Kodėlčiukas (Laisvės pr. 59)";Šnekučiai;1206798597;Ne;5;4;0;9
4214;"Kodėlčiukas (Laisvės pr. 59)";Šnekučiai;9169500252;Ne;0;4;0;4
4215;"Kodėlčiukas (Laisvės pr. 59)";Šnekučiai;4941186694;Ne;3;4;0;7
4216;"Kodėlčiukas (Laisvės pr. 59)";Šnekučiai;6587593805;Ne;0;3;0;3
4217;"Kodėlčiukas (Laisvės pr. 59)";Šnekučiai;1074477043;Ne;7;3;0;10
4218;"Kodėlčiukas (Laisvės pr. 59)";Šnekučiai;9109362006;Ne;0;7;0;7
4219;"Kodėlčiukas (Laisvės pr. 59)";Šnekučiai;9724373368;Taip;5;5;0;10
4220;"Kodėlčiukas (Laisvės pr. 59)";Šnekučiai;2819860331;Ne;2;4;0;6
4221;"Kodėlčiukas (Laisvės pr. 59)";Šnekučiai;9252478832;Ne;2;5;0;7
4222;"Kodėlčiukas (Laisvės pr. 59)";Šnekučiai;4230906452;Ne;0;3;1;4
4223;"Kodėlčiukas (Laisvės pr. 59)";Pabiručiai;9278139998;Ne;0;2;0;2
4224;"Kodėlčiukas (Laisvės pr. 59)";Pabiručiai;6008027505;Ne;1;4;0;5
4225;"Kodėlčiukas (Laisvės pr. 59)";Pabiručiai;5894631257;Ne;0;0;1;1
4226;"Kodėlčiukas (Laisvės pr. 59)";Pabiručiai;6065858518;Ne;2;0;0;2
4227;"Kodėlčiukas (Laisvės pr. 59)";Pabiručiai;8586746296;Ne;2;3;0;5
4228;"Kodėlčiukas (Laisvės pr. 59)";Pabiručiai;9480926599;Ne;15;4;0;19
4229;"Kodėlčiukas (Laisvės pr. 59)";Pabiručiai;9511144369;Ne;0;3;1;4
4230;"Kodėlčiukas (Laisvės pr. 59)";Pabiručiai;7246943802;Ne;2;4;2;8
4231;"Kodėlčiukas (Laisvės pr. 59)";Pabiručiai;8189938439;Ne;2;0;0;2
4232;"Kodėlčiukas (Laisvės pr. 59)";Pabiručiai;5587200800;Ne;0;0;1;1
4233;"Kodėlčiukas (Laisvės pr. 59)";Pabiručiai;1433623973;Ne;0;11;0;11
4234;"Kodėlčiukas (Laisvės pr. 59)";Pabiručiai;7570122834;Ne;0;3;0;3
4235;"Kodėlčiukas (Laisvės pr. 59)";Pabiručiai;5359866071;Ne;0;7;0;7
4236;"Kodėlčiukas (Laisvės pr. 59)";Pabiručiai;5801430256;Ne;4;5;0;9
4237;"Kodėlčiukas (Laisvės pr. 59)";Pabiručiai;7455949617;Ne;0;0;3;3
4238;"Kodėlčiukas (Laisvės pr. 59)";Pabiručiai;1039982141;Ne;0;0;4;4
4239;"Kodėlčiukas (Laisvės pr. 59)";Pabiručiai;4507928289;Ne;5;0;1;6
4240;"Kodėlčiukas (Laisvės pr. 59)";Pabiručiai;9830842598;Ne;0;0;1;1
4241;"Kodėlčiukas (Laisvės pr. 59)";Pabiručiai;8291672306;Ne;0;0;3;3
4242;"Kodėlčiukas (Laisvės pr. 59)";Pabiručiai;3882838712;Ne;0;0;2;2
4243;"Kodėlčiukas (Laisvės pr. 59)";Pabiručiai;8635107742;Ne;0;0;3;3
4244;"Kodėlčiukas (Laisvės pr. 59)";Pabiručiai;5064526349;Ne;6;1;0;7
4245;"Kodėlčiukas (Laisvės pr. 59)";Smalsučiai;6950802941;Ne;10;1;0;11
4246;"Kodėlčiukas (Laisvės pr. 59)";Smalsučiai;6045564826;Ne;4;5;0;9
4247;"Kodėlčiukas (Laisvės pr. 59)";Smalsučiai;7136890681;Ne;2;1;0;3
4248;"Kodėlčiukas (Laisvės pr. 59)";Smalsučiai;7971932716;Ne;0;1;0;1
4249;"Kodėlčiukas (Laisvės pr. 59)";Smalsučiai;7282579315;Ne;0;4;0;4
4250;"Kodėlčiukas (Laisvės pr. 59)";Smalsučiai;6905424567;Ne;0;4;2;6
4251;"Kodėlčiukas (Laisvės pr. 59)";Smalsučiai;5443377251;Taip;0;4;0;4
4252;"Kodėlčiukas (Laisvės pr. 59)";Smalsučiai;6074758814;Ne;0;12;0;12
4253;"Kodėlčiukas (Laisvės pr. 59)";Smalsučiai;3150006441;Ne;0;4;0;4
4254;"Kodėlčiukas (Laisvės pr. 59)";Smalsučiai;1302383608;Ne;0;4;5;9
4255;"Kodėlčiukas (Laisvės pr. 59)";Smalsučiai;7626940433;Ne;0;4;0;4
4256;"Kodėlčiukas (Laisvės pr. 59)";Smalsučiai;5729391456;Ne;0;8;0;8
4257;"Kodėlčiukas (Laisvės pr. 59)";Smalsučiai;7286497455;Ne;1;4;0;5
4258;"Kodėlčiukas (Laisvės pr. 59)";Smalsučiai;1699358514;Ne;0;1;0;1
4259;"Kodėlčiukas (Laisvės pr. 59)";Smalsučiai;3473981974;Ne;0;1;0;1
4260;"Kodėlčiukas (Laisvės pr. 59)";Smalsučiai;4038168647;Ne;8;5;0;13
4261;"Kodėlčiukas (Laisvės pr. 59)";Smalsučiai;6000831611;Ne;0;4;0;4
4262;"Kodėlčiukas (Laisvės pr. 59)";Smalsučiai;1160612316;Ne;3;5;0;8
4263;"Kodėlčiukas (Laisvės pr. 59)";Smalsučiai;3470151604;Ne;0;1;0;1
4264;"Kodėlčiukas (Laisvės pr. 59)";Smalsučiai;5921714669;Ne;0;6;0;6
4265;"Kodėlčiukas (Laisvės pr. 59)";Smalsučiai;6764015170;Ne;0;5;0;5
4266;"Kodėlčiukas (Laisvės pr. 59)";Giliukai;9754425363;Ne;0;4;0;4
4267;"Kodėlčiukas (Laisvės pr. 59)";Giliukai;5587782917;Ne;6;4;0;10
4268;"Kodėlčiukas (Laisvės pr. 59)";Giliukai;8100861190;Taip;0;3;0;3
4269;"Kodėlčiukas (Laisvės pr. 59)";Giliukai;7639341503;Ne;9;0;0;9
4270;"Kodėlčiukas (Laisvės pr. 59)";Giliukai;8017465692;Ne;0;4;0;4
4271;"Kodėlčiukas (Laisvės pr. 59)";Giliukai;7937365710;Ne;4;0;1;5
4272;"Kodėlčiukas (Laisvės pr. 59)";Giliukai;1937181137;Ne;0;0;2;2
4273;"Kodėlčiukas (Laisvės pr. 59)";Giliukai;9733831323;Ne;0;0;1;1
4274;"Kodėlčiukas (Laisvės pr. 59)";Giliukai;7007386353;Ne;6;3;0;9
4275;"Kodėlčiukas (Laisvės pr. 59)";Giliukai;9721353724;Ne;13;0;0;13
4276;"Kodėlčiukas (Laisvės pr. 59)";Giliukai;2943146610;Ne;0;1;0;1
4277;"Kodėlčiukas (Laisvės pr. 59)";Giliukai;5573845415;Taip;5;0;1;6
4278;"Kodėlčiukas (Laisvės pr. 59)";Giliukai;2122779530;Ne;1;4;0;5
4279;"Kodėlčiukas (Laisvės pr. 59)";Giliukai;8785157050;Ne;0;16;0;16
4280;"Kodėlčiukas (Laisvės pr. 59)";Giliukai;5770748359;Ne;0;2;0;2
4281;"Kodėlčiukas (Laisvės pr. 59)";Giliukai;9992204262;Ne;0;5;1;6
4282;"Kodėlčiukas (Laisvės pr. 59)";Giliukai;6643473339;Ne;0;5;0;5
4283;"Kodėlčiukas (Laisvės pr. 59)";Giliukai;8107869258;Ne;0;0;1;1
4284;"Kodėlčiukas (Laisvės pr. 59)";Giliukai;3130715310;Ne;0;6;0;6
4285;"Kodėlčiukas (Laisvės pr. 59)";Giliukai;3686259290;Ne;0;2;0;2
4286;"Kodėlčiukas (Laisvės pr. 59)";Giliukai;2928885561;Ne;5;0;3;8
4287;"Kodėlčiukas (Laisvės pr. 59)";Giliukai;5909222351;Ne;0;0;3;3
4288;"Kodėlčiukas (Laisvės pr. 59)";Gudručiai;1191430672;Ne;0;0;1;1
4289;"Kodėlčiukas (Laisvės pr. 59)";Gudručiai;6988515253;Ne;0;6;0;6
4290;"Kodėlčiukas (Laisvės pr. 59)";Gudručiai;3385551650;Ne;7;1;0;8
4291;"Kodėlčiukas (Laisvės pr. 59)";Gudručiai;7318908956;Ne;0;4;4;8
4292;"Kodėlčiukas (Laisvės pr. 59)";Gudručiai;9865803714;Ne;0;0;2;2
4293;"Kodėlčiukas (Laisvės pr. 59)";Gudručiai;7430239198;Ne;2;4;1;7
4294;"Kodėlčiukas (Laisvės pr. 59)";Gudručiai;8400610717;Ne;12;0;0;12
4295;"Kodėlčiukas (Laisvės pr. 59)";Gudručiai;7116594055;Ne;5;0;1;6
4296;"Kodėlčiukas (Laisvės pr. 59)";Gudručiai;7326475644;Ne;3;0;0;3
4297;"Kodėlčiukas (Laisvės pr. 59)";Gudručiai;1801366890;Ne;0;4;0;4
4298;"Kodėlčiukas (Laisvės pr. 59)";Gudručiai;9483378853;Ne;0;5;0;5
4299;"Kodėlčiukas (Laisvės pr. 59)";Gudručiai;8890987483;Ne;0;0;4;4
4300;"Kodėlčiukas (Laisvės pr. 59)";Gudručiai;4687333060;Ne;0;5;0;5
4301;"Kodėlčiukas (Laisvės pr. 59)";Gudručiai;1491160730;Ne;0;0;2;2
4302;"Kodėlčiukas (Laisvės pr. 59)";Gudručiai;4543838852;Ne;0;0;2;2
4303;"Kodėlčiukas (Laisvės pr. 59)";Gudručiai;2216791610;Ne;0;4;0;4
4304;"Kodėlčiukas (Laisvės pr. 59)";Gudručiai;2987907651;Ne;0;4;0;4
4305;"Kodėlčiukas (Laisvės pr. 59)";Gudručiai;9028856983;Ne;7;4;0;11
4306;"Kodėlčiukas (Laisvės pr. 59)";Gudručiai;1588132166;Ne;7;4;0;11
4307;"Kodėlčiukas (Laisvės pr. 59)";Gudručiai;6014084915;Ne;7;4;0;11
4308;"Kodėlčiukas (Laisvės pr. 59)";Gudručiai;3068084704;Ne;5;4;0;9
4309;"Kodėlčiukas (Laisvės pr. 59)";Gudručiai;6985788287;Ne;0;0;4;4
4310;"Kodėlčiukas (Laisvės pr. 59)";Gudručiai;3427610168;Ne;4;4;0;8
4311;"Kodėlčiukas (Laisvės pr. 59)";Žirniukai;2402290604;Ne;3;0;0;3
4312;"Kodėlčiukas (Laisvės pr. 59)";Žirniukai;6522019070;Ne;11;0;0;11
4313;"Kodėlčiukas (Laisvės pr. 59)";Žirniukai;1050905569;Ne;1;0;0;1
4314;"Kodėlčiukas (Laisvės pr. 59)";Žirniukai;3053949510;Taip;10;3;0;13
4315;"Kodėlčiukas (Laisvės pr. 59)";Žirniukai;5325660102;Ne;0;3;0;3
4316;"Kodėlčiukas (Laisvės pr. 59)";Žirniukai;8429572505;Ne;9;0;0;9
4317;"Kodėlčiukas (Laisvės pr. 59)";Žirniukai;4321485862;Ne;4;0;0;4
4318;"Kodėlčiukas (Laisvės pr. 59)";Žirniukai;1550287298;Ne;0;4;0;4
4319;"Kodėlčiukas (Laisvės pr. 59)";Žirniukai;9045733092;Ne;3;0;0;3
4320;"Kodėlčiukas (Laisvės pr. 59)";Žirniukai;4341694264;Ne;0;4;0;4
4321;"Kodėlčiukas (Laisvės pr. 59)";Žirniukai;4597473929;Taip;8;0;0;8
4322;"Kodėlčiukas (Laisvės pr. 59)";Žirniukai;9702236745;Ne;2;4;0;6
4323;"Kodėlčiukas (Laisvės pr. 59)";Žirniukai;7189930025;Ne;0;4;0;4
4324;"Kodėlčiukas (Laisvės pr. 59)";Žirniukai;2002468844;Taip;5;0;0;5
4325;"Kodėlčiukas (Laisvės pr. 59)";Žirniukai;4187856743;Ne;4;0;0;4
4326;"Kodėlčiukas (Laisvės pr. 59)";Žirniukai;4530733149;Ne;5;5;0;10
4327;"Kodėlčiukas (Laisvės pr. 59)";Žirniukai;4896921433;Ne;8;0;0;8
4328;"Kodėlčiukas (Laisvės pr. 59)";Katinėliai;4730433849;Ne;4;0;4;8
4329;"Kodėlčiukas (Laisvės pr. 59)";Katinėliai;4995538090;Ne;0;0;4;4
4330;"Kodėlčiukas (Laisvės pr. 59)";Katinėliai;8045906704;Ne;5;0;0;5
4331;"Kodėlčiukas (Laisvės pr. 59)";Katinėliai;7306085848;Ne;5;0;0;5
4332;"Kodėlčiukas (Laisvės pr. 59)";Katinėliai;6576466300;Ne;0;1;0;1
4333;"Kodėlčiukas (Laisvės pr. 59)";Katinėliai;5650077893;Ne;5;0;0;5
4334;"Kodėlčiukas (Laisvės pr. 59)";Katinėliai;3239314295;Ne;0;0;2;2
4335;"Kodėlčiukas (Laisvės pr. 59)";Katinėliai;9221561862;Ne;3;0;0;3
4336;"Kodėlčiukas (Laisvės pr. 59)";Katinėliai;6355536268;Ne;0;0;1;1
4337;"Kodėlčiukas (Laisvės pr. 59)";Katinėliai;2147517344;Ne;16;1;0;17
4338;"Kodėlčiukas (Laisvės pr. 59)";Katinėliai;2119041584;Ne;5;5;0;10
4339;"Kodėlčiukas (Laisvės pr. 59)";Katinėliai;9826174805;Ne;7;0;1;8
4340;"Kodėlčiukas (Laisvės pr. 59)";Katinėliai;1570599010;Ne;9;0;0;9
4341;"Kodėlčiukas (Laisvės pr. 59)";Katinėliai;9670055064;Ne;0;0;2;2
4342;"Kodėlčiukas (Laisvės pr. 59)";Katinėliai;4727546035;Ne;5;6;0;11
4343;"Kodėlčiukas (Laisvės pr. 59)";Katinėliai;6011097577;Taip;19;0;0;19
4344;"Kodėlčiukas (Laisvės pr. 59)";Katinėliai;6334889816;Ne;7;0;0;7
4345;"Kodėlčiukas (Laisvės pr. 59)";Katinėliai;6135628975;Ne;3;0;0;3
4346;"Kodėlčiukas (Laisvės pr. 59)";Katinėliai;4028114251;Ne;0;0;4;4
4347;"Kodėlčiukas (Laisvės pr. 59)";Nykštukai;2722591942;Ne;0;0;1;1
4348;"Kodėlčiukas (Laisvės pr. 59)";Nykštukai;5719244938;Ne;10;0;4;14
4349;"Kodėlčiukas (Laisvės pr. 59)";Nykštukai;4643616472;Ne;2;4;1;7
4350;"Kodėlčiukas (Laisvės pr. 59)";Nykštukai;6498584861;Ne;6;5;0;11
4351;"Kodėlčiukas (Laisvės pr. 59)";Nykštukai;8324804944;Ne;9;1;0;10
4352;"Kodėlčiukas (Laisvės pr. 59)";Nykštukai;1776582488;Ne;4;4;0;8
4353;"Kodėlčiukas (Laisvės pr. 59)";Nykštukai;2394070354;Ne;6;4;0;10
4354;"Kodėlčiukas (Laisvės pr. 59)";Nykštukai;3018381817;Ne;11;4;0;15
4355;"Kodėlčiukas (Laisvės pr. 59)";Nykštukai;9330345860;Ne;6;0;0;6
4356;"Kodėlčiukas (Laisvės pr. 59)";Nykštukai;9645711345;Ne;6;0;4;10
4357;"Kodėlčiukas (Laisvės pr. 59)";Nykštukai;3663726193;Taip;0;0;1;1
4358;"Kodėlčiukas (Laisvės pr. 59)";Nykštukai;3509994698;Ne;19;0;0;19
4359;"Kodėlčiukas (Laisvės pr. 59)";Nykštukai;3737512833;Taip;4;0;0;4
4360;"Kodėlčiukas (Laisvės pr. 59)";Nykštukai;8399334364;Ne;0;4;0;4
4361;"Kodėlčiukas (Laisvės pr. 59)";Nykštukai;1498607108;Ne;9;0;0;9
4362;"Kodėlčiukas (Laisvės pr. 59)";Nykštukai;7963235116;Ne;14;0;0;14
4363;"Kodėlčiukas (Laisvės pr. 59)";ŽIOGELIAI;8769409404;Taip;0;0;4;4
4364;"Kodėlčiukas (Laisvės pr. 59)";ŽIOGELIAI;5189091564;Ne;0;4;0;4
4365;"Kodėlčiukas (Laisvės pr. 59)";ŽIOGELIAI;6745245907;Ne;2;0;1;3
4366;"Kodėlčiukas (Laisvės pr. 59)";ŽIOGELIAI;9055399463;Ne;0;0;5;5
4367;"Kodėlčiukas (Laisvės pr. 59)";ŽIOGELIAI;2081199093;Ne;19;0;0;19
4368;"Kodėlčiukas (Laisvės pr. 59)";ŽIOGELIAI;5115939251;Ne;0;0;1;1
4369;"Kodėlčiukas (Laisvės pr. 59)";ŽIOGELIAI;3603781385;Ne;0;2;1;3
4370;"Kodėlčiukas (Laisvės pr. 59)";ŽIOGELIAI;6749972956;Ne;2;0;0;2
4371;"Kodėlčiukas (Laisvės pr. 59)";ŽIOGELIAI;2189949450;Ne;0;9;0;9
4372;"Kodėlčiukas (Laisvės pr. 59)";ŽIOGELIAI;7497358286;Ne;0;8;0;8
4373;"Kodėlčiukas (Laisvės pr. 59)";ŽIOGELIAI;2990546939;Ne;0;0;3;3
4374;"Kodėlčiukas (Laisvės pr. 59)";ŽIOGELIAI;4089558399;Ne;8;0;0;8
4375;"Kodėlčiukas (Laisvės pr. 59)";ŽIOGELIAI;6843492891;Ne;8;0;4;12
4376;"Kodėlčiukas (Laisvės pr. 59)";ŽIOGELIAI;2933909503;Ne;11;0;3;14
4377;"Kodėlčiukas (Laisvės pr. 59)";ŽIOGELIAI;4969181023;Ne;5;0;3;8
4378;"Kodėlčiukas (Laisvės pr. 59)";BITUTĖS;8144034996;Ne;8;0;0;8
4379;"Kodėlčiukas (Laisvės pr. 59)";BITUTĖS;4444145328;Ne;2;0;0;2
4380;"Kodėlčiukas (Laisvės pr. 59)";BITUTĖS;6007820210;Ne;5;0;0;5
4381;"Kodėlčiukas (Laisvės pr. 59)";BITUTĖS;9844479346;Ne;16;0;0;16
4382;"Kodėlčiukas (Laisvės pr. 59)";BITUTĖS;5222125070;Ne;6;2;0;8
4383;"Kodėlčiukas (Laisvės pr. 59)";BITUTĖS;7251390043;Ne;4;0;0;4
4384;"Kodėlčiukas (Laisvės pr. 59)";BITUTĖS;6580462777;Ne;14;0;0;14
4385;"Kodėlčiukas (Laisvės pr. 59)";BITUTĖS;6800848383;Ne;6;0;0;6
4386;"Kodėlčiukas (Laisvės pr. 59)";BITUTĖS;5023273477;Ne;14;0;0;14
4387;"Kodėlčiukas (Laisvės pr. 59)";BITUTĖS;3970337050;Ne;15;0;0;15
4388;"Kodėlčiukas (Laisvės pr. 59)";BITUTĖS;7539430546;Ne;15;0;0;15
4389;"Kodėlčiukas (Laisvės pr. 59)";BITUTĖS;7148837596;Ne;9;0;0;9
4390;"Kodėlčiukas (Laisvės pr. 59)";BITUTĖS;5474194439;Ne;9;0;0;9
4391;"Kodėlčiukas (Laisvės pr. 59)";BITUTĖS;2272657477;Ne;6;0;0;6
4392;"Kodėlčiukas (Laisvės pr. 59)";VYŠNIUKAI;7705057116;Ne;0;4;0;4
4393;"Kodėlčiukas (Laisvės pr. 59)";VYŠNIUKAI;7643398934;Ne;3;4;0;7
4394;"Kodėlčiukas (Laisvės pr. 59)";VYŠNIUKAI;8799798070;Ne;0;0;5;5
4395;"Kodėlčiukas (Laisvės pr. 59)";VYŠNIUKAI;7119815662;Ne;0;4;0;4
4396;"Kodėlčiukas (Laisvės pr. 59)";VYŠNIUKAI;9398732476;Taip;9;0;5;14
4397;"Kodėlčiukas (Laisvės pr. 59)";VYŠNIUKAI;2720748563;Ne;2;2;0;4
4398;"Kodėlčiukas (Laisvės pr. 59)";VYŠNIUKAI;2871111867;Ne;2;3;0;5
4399;"Kodėlčiukas (Laisvės pr. 59)";VYŠNIUKAI;9914322177;Ne;2;0;1;3
4400;"Kodėlčiukas (Laisvės pr. 59)";VYŠNIUKAI;1925590099;Ne;0;6;0;6
4401;"Kodėlčiukas (Laisvės pr. 59)";VYŠNIUKAI;7242653444;Ne;0;4;0;4
4402;"Kodėlčiukas (Laisvės pr. 59)";VYŠNIUKAI;2298734536;Ne;0;5;0;5
4403;"Kodėlčiukas (Laisvės pr. 59)";VYŠNIUKAI;2549153581;Ne;11;4;0;15
4404;"Kodėlčiukas (Laisvės pr. 59)";VYŠNIUKAI;1808211253;Ne;1;4;0;5
4405;"Kodėlčiukas (Laisvės pr. 59)";VYŠNIUKAI;5178305435;Ne;4;7;0;11
4406;"Kodėlčiukas (Laisvės pr. 59)";VYŠNIUKAI;5061852590;Ne;6;3;0;9
4407;"Kodėlčiukas (Laisvės pr. 59)";VYŠNIUKAI;4782931414;Ne;0;5;0;5
4408;"Kodėlčiukas (Laisvės pr. 59)";VYŠNIUKAI;1803320085;Taip;2;0;5;7
4409;"Kodėlčiukas (Laisvės pr. 59)";VYŠNIUKAI;3938536446;Ne;3;0;6;9
4410;"Kodėlčiukas (Laisvės pr. 59)";VYŠNIUKAI;6656558797;Ne;0;0;1;1
4411;"Kodėlčiukas (Laisvės pr. 59)";BORUŽĖLĖS;2340866110;Taip;10;4;1;15
4412;"Kodėlčiukas (Laisvės pr. 59)";BORUŽĖLĖS;6726383331;Ne;4;3;0;7
4413;"Kodėlčiukas (Laisvės pr. 59)";BORUŽĖLĖS;1568628843;Ne;0;14;0;14
4414;"Kodėlčiukas (Laisvės pr. 59)";BORUŽĖLĖS;2438891967;Ne;2;0;0;2
4415;"Kodėlčiukas (Laisvės pr. 59)";BORUŽĖLĖS;3156788328;Ne;10;0;0;10
4416;"Kodėlčiukas (Laisvės pr. 59)";BORUŽĖLĖS;8037386529;Ne;0;0;2;2
4417;"Kodėlčiukas (Laisvės pr. 59)";BORUŽĖLĖS;7186835214;Ne;3;0;3;6
4418;"Kodėlčiukas (Laisvės pr. 59)";BORUŽĖLĖS;8829986201;Ne;0;4;3;7
4419;"Kodėlčiukas (Laisvės pr. 59)";BORUŽĖLĖS;4529565626;Ne;7;0;1;8
4420;"Kodėlčiukas (Laisvės pr. 59)";BORUŽĖLĖS;9020265248;Ne;0;0;3;3
4421;"Kodėlčiukas (Laisvės pr. 59)";BORUŽĖLĖS;2313607716;Ne;4;0;3;7
4422;"Kodėlčiukas (Laisvės pr. 59)";BORUŽĖLĖS;9209671311;Ne;10;0;0;10
4423;"Kodėlčiukas (Laisvės pr. 59)";BORUŽĖLĖS;9736751250;Ne;8;0;0;8
4424;"Kodėlčiukas (Laisvės pr. 59)";BORUŽĖLĖS;7227149646;Ne;0;0;4;4
4425;"Kodėlčiukas (Laisvės pr. 59)";BORUŽĖLĖS;1197049907;Ne;5;0;1;6
4426;"Kodėlčiukas (Laisvės pr. 59)";BORUŽĖLĖS;3985455729;Ne;0;0;1;1
4427;"Kodėlčiukas (Laisvės pr. 59)";BORUŽĖLĖS;5068611716;Taip;5;0;3;8
4428;"Kodėlčiukas (Laisvės pr. 59)";BORUŽĖLĖS;7910205296;Ne;7;0;1;8
4429;"Kodėlčiukas (Laisvės pr. 59)";BORUŽĖLĖS;1047209628;Ne;8;0;1;9
4430;"Kodėlčiukas (Laisvės pr. 59)";BORUŽĖLĖS;8932472612;Ne;2;0;4;6
4431;"Kodėlčiukas (Laisvės pr. 59)";VYTURĖLIAI;6714818379;Ne;0;4;0;4
4432;"Kodėlčiukas (Laisvės pr. 59)";VYTURĖLIAI;4218096561;Ne;9;5;0;14
4433;"Kodėlčiukas (Laisvės pr. 59)";VYTURĖLIAI;4514764005;Ne;0;4;0;4
4434;"Kodėlčiukas (Laisvės pr. 59)";VYTURĖLIAI;2169307879;Ne;2;0;0;2
4435;"Kodėlčiukas (Laisvės pr. 59)";VYTURĖLIAI;2448536092;Ne;2;0;0;2
4436;"Kodėlčiukas (Laisvės pr. 59)";VYTURĖLIAI;4585226357;Ne;6;0;0;6
4437;"Kodėlčiukas (Laisvės pr. 59)";VYTURĖLIAI;8263945732;Ne;16;0;0;16
4438;"Kodėlčiukas (Laisvės pr. 59)";VYTURĖLIAI;7612531087;Ne;0;4;0;4
4439;"Kodėlčiukas (Laisvės pr. 59)";VYTURĖLIAI;2904858964;Ne;9;4;0;13
4440;"Kodėlčiukas (Laisvės pr. 59)";VYTURĖLIAI;3413659259;Ne;4;0;0;4
4441;"Kodėlčiukas (Laisvės pr. 59)";VYTURĖLIAI;9673271313;Ne;5;0;0;5
4442;"Kodėlčiukas (Laisvės pr. 59)";VYTURĖLIAI;5710301153;Ne;10;0;0;10
4443;"Kodėlčiukas (Laisvės pr. 59)";VYTURĖLIAI;1746835627;Ne;3;0;0;3
4444;"Kodėlčiukas (Laisvės pr. 59)";VYTURĖLIAI;5474125905;Ne;0;10;0;10
4445;"Kodėlčiukas (Laisvės pr. 59)";VYTURĖLIAI;2298099102;Ne;0;7;0;7
4446;"Kodėlčiukas (Laisvės pr. 59)";VYTURĖLIAI;5181211722;Ne;9;0;0;9
4447;"Kodėlčiukas (Laisvės pr. 59)";VYTURĖLIAI;3472862544;Taip;5;0;0;5
4448;"Kodėlčiukas (Laisvės pr. 59)";VYTURĖLIAI;7778188733;Ne;7;0;0;7
4449;"Kodėlčiukas (Laisvės pr. 59)";VYTURĖLIAI;6476445296;Ne;1;4;0;5
4450;"Kodėlčiukas (Laisvės pr. 59)";DRUGELIAI;4165123345;Ne;5;0;0;5
4451;"Kodėlčiukas (Laisvės pr. 59)";DRUGELIAI;5772071707;Ne;5;0;0;5
4452;"Kodėlčiukas (Laisvės pr. 59)";DRUGELIAI;1149682376;Ne;4;4;5;13
4453;"Kodėlčiukas (Laisvės pr. 59)";DRUGELIAI;7587203481;Ne;0;4;0;4
4454;"Kodėlčiukas (Laisvės pr. 59)";DRUGELIAI;2353960861;Ne;0;7;0;7
4455;"Kodėlčiukas (Laisvės pr. 59)";DRUGELIAI;6103959702;Ne;2;0;1;3
4456;"Kodėlčiukas (Laisvės pr. 59)";DRUGELIAI;3267687337;Ne;1;4;0;5
4457;"Kodėlčiukas (Laisvės pr. 59)";DRUGELIAI;5505788210;Ne;3;0;0;3
4458;"Kodėlčiukas (Laisvės pr. 59)";DRUGELIAI;5577154148;Ne;4;5;0;9
4459;"Kodėlčiukas (Laisvės pr. 59)";DRUGELIAI;8547039654;Ne;4;0;0;4
4460;"Kodėlčiukas (Laisvės pr. 59)";DRUGELIAI;4202423480;Ne;3;0;0;3
4461;"Kodėlčiukas (Laisvės pr. 59)";DRUGELIAI;9979034031;Ne;0;4;0;4
4462;"Kodėlčiukas (Laisvės pr. 59)";DRUGELIAI;3240221130;Ne;0;2;0;2
4463;"Kodėlčiukas (Laisvės pr. 59)";DRUGELIAI;9139424911;Ne;3;0;0;3
4464;"Kodėlčiukas (Laisvės pr. 59)";DRUGELIAI;9664432781;Ne;2;3;0;5
4465;"Kodėlčiukas (Laisvės pr. 59)";DRUGELIAI;5197946954;Ne;9;0;0;9
4466;"Kodėlčiukas (Laisvės pr. 59)";DRUGELIAI;3651073383;Ne;1;2;0;3
4467;"Kodėlčiukas (Laisvės pr. 59)";DRUGELIAI;3854719881;Ne;7;0;0;7
4468;"Kodėlčiukas (Laisvės pr. 59)";DRUGELIAI;8315176054;Ne;0;7;0;7
4469;"Kodėlčiukas (Laisvės pr. 59)";DRUGELIAI;7908217415;Ne;5;0;6;11
4470;"Kodėlčiukas (Laisvės pr. 59)";DRUGELIAI;4937929385;Ne;2;0;0;2
4471;"Kodėlčiukas (Laisvės pr. 59)";OBUOLIUKAI;8784531004;Ne;9;3;0;12
4472;"Kodėlčiukas (Laisvės pr. 59)";OBUOLIUKAI;1289342844;Ne;3;4;3;10
4473;"Kodėlčiukas (Laisvės pr. 59)";OBUOLIUKAI;7318196860;Ne;3;3;0;6
4474;"Kodėlčiukas (Laisvės pr. 59)";OBUOLIUKAI;8208448849;Ne;5;2;0;7
4475;"Kodėlčiukas (Laisvės pr. 59)";OBUOLIUKAI;1683506414;Ne;7;0;0;7
4476;"Kodėlčiukas (Laisvės pr. 59)";OBUOLIUKAI;3315862631;Ne;0;6;0;6
4477;"Kodėlčiukas (Laisvės pr. 59)";OBUOLIUKAI;5896726125;Ne;6;0;1;7
4478;"Kodėlčiukas (Laisvės pr. 59)";OBUOLIUKAI;3168418461;Ne;0;7;0;7
4479;"Kodėlčiukas (Laisvės pr. 59)";OBUOLIUKAI;9645987751;Ne;16;0;0;16
4480;"Kodėlčiukas (Laisvės pr. 59)";OBUOLIUKAI;5860975805;Ne;3;4;0;7
4481;"Kodėlčiukas (Laisvės pr. 59)";OBUOLIUKAI;8782155591;Ne;7;5;1;13
4482;"Kodėlčiukas (Laisvės pr. 59)";OBUOLIUKAI;8104220950;Ne;0;2;0;2
4483;"Kodėlčiukas (Laisvės pr. 59)";OBUOLIUKAI;2005453189;Ne;5;4;0;9
4484;"Kodėlčiukas (Laisvės pr. 59)";OBUOLIUKAI;1180399735;Ne;0;4;0;4
4485;"Kodėlčiukas (Laisvės pr. 59)";OBUOLIUKAI;5173730926;Ne;1;4;0;5
4486;"Kodėlčiukas (Laisvės pr. 59)";OBUOLIUKAI;3442449482;Ne;0;4;0;4
4487;"Kodėlčiukas (Laisvės pr. 59)";OBUOLIUKAI;7946010973;Taip;5;7;0;12
4488;"Kodėlčiukas (Laisvės pr. 59)";OBUOLIUKAI;5342852235;Ne;0;4;0;4
4489;"Kodėlčiukas (Laisvės pr. 59)";OBUOLIUKAI;8563412043;Ne;3;0;0;3
4490;"Kodėlčiukas (Laisvės pr. 59)";OBUOLIUKAI;4026784012;Ne;6;4;0;10
4491;"Kodėlčiukas (Laisvės pr. 59)";OBUOLIUKAI;2114176689;Ne;2;3;0;5
4492;"Kodėlčiukas (Laisvės pr. 59)";OBUOLIUKAI;3033687110;Ne;0;4;0;4
4493;"Kodėlčiukas (Laisvės pr. 59)";OBUOLIUKAI;5252261660;Ne;5;8;0;13
4494;Kurpaitė;Viščiukų;9825971721;Ne;0;1;0;1
4495;Kurpaitė;Viščiukų;4572559234;Ne;19;0;0;19
4496;Kurpaitė;Viščiukų;1370461809;Ne;5;4;0;9
4497;Kurpaitė;Viščiukų;4855231867;Ne;0;3;0;3
4498;Kurpaitė;Viščiukų;9299294437;Ne;5;0;0;5
4499;Kurpaitė;Viščiukų;9761100202;Ne;16;0;0;16
4500;Kurpaitė;Viščiukų;1558096975;Ne;0;14;0;14
4501;Kurpaitė;Viščiukų;7973054986;Ne;0;3;0;3
4502;Kurpaitė;Viščiukų;5629017875;Ne;0;3;0;3
4503;Kurpaitė;Viščiukų;4423261705;Ne;0;14;0;14
4504;Kurpaitė;Viščiukų;5234784564;Ne;0;19;0;19
4505;Kurpaitė;Viščiukų;2772566963;Ne;0;4;0;4
4506;Kurpaitė;Gėlyčių;5952306163;Ne;0;6;0;6
4507;Kurpaitė;Gėlyčių;3139272175;Ne;0;16;0;16
4508;Kurpaitė;Gėlyčių;4769611100;Ne;10;0;0;10
4509;Kurpaitė;Gėlyčių;2629958613;Ne;2;2;0;4
4510;Kurpaitė;Gėlyčių;2629958613;Ne;2;2;0;4
4511;Kurpaitė;Gėlyčių;8683596623;Ne;2;0;0;2
4512;Kurpaitė;Gėlyčių;4687182527;Ne;13;0;0;13
4513;Kurpaitė;Gėlyčių;2373582223;Ne;0;19;0;19
4514;Kurpaitė;Gėlyčių;2157581956;Ne;0;7;0;7
4515;Kurpaitė;Gėlyčių;5175919323;Ne;0;16;0;16
4516;Kurpaitė;Gėlyčių;7194351335;Ne;14;0;0;14
4517;Kurpaitė;Gėlyčių;5701318496;Ne;0;1;0;1
4518;Kurpaitė;Gėlyčių;2744439309;Ne;0;2;0;2
4519;Kurpaitė;Gėlyčių;5923694769;Ne;11;1;0;12
4520;Kurpaitė;Gėlyčių;3481813493;Ne;0;3;0;3
4521;Kurpaitė;Gėlyčių;8402747029;Ne;0;2;0;2
4522;Kurpaitė;Gėlyčių;5557028481;Ne;6;0;0;6
4523;Kurpaitė;Gėlyčių;5447826458;Ne;0;12;0;12
4524;Kurpaitė;Gėlyčių;4657523142;Ne;0;3;0;3
4525;Kurpaitė;Gėlyčių;2867842844;Ne;15;0;0;15
4526;Kurpaitė;Gėlyčių;6859316204;Ne;6;0;0;6
4527;Kurpaitė;Gėlyčių;8655912398;Ne;2;1;0;3
4528;Kurpaitė;Drugelių;8868415451;Ne;0;5;0;5
4529;Kurpaitė;Drugelių;1273426668;Ne;0;5;0;5
4530;Kurpaitė;Drugelių;5220314051;Ne;2;0;0;2
4531;Kurpaitė;Drugelių;1413326858;Ne;5;0;0;5
4532;Kurpaitė;Drugelių;6568580994;Ne;0;11;0;11
4533;Kurpaitė;Drugelių;5396599834;Ne;0;3;0;3
4534;Kurpaitė;Drugelių;1752006477;Ne;13;0;0;13
4535;Kurpaitė;Drugelių;2757100599;Ne;5;0;0;5
4536;Kurpaitė;Drugelių;9922582884;Ne;2;0;0;2
4537;Kurpaitė;Drugelių;3989274600;Ne;0;3;0;3
4538;Kurpaitė;Drugelių;4426311033;Ne;0;3;0;3
4539;Kurpaitė;Drugelių;1927773278;Ne;0;9;0;9
4540;Kurpaitė;Drugelių;9221882007;Ne;4;2;0;6
4541;Kurpaitė;Drugelių;8361612709;Ne;0;4;0;4
4542;Kurpaitė;Drugelių;4754807319;Ne;0;3;0;3
4543;Kurpaitė;Drugelių;7703075096;Taip;8;0;0;8
4544;Kurpaitė;Drugelių;4607835570;Ne;6;3;0;9
4545;Kurpaitė;Drugelių;1964193512;Ne;0;1;0;1
4546;Kurpaitė;Drugelių;3174986114;Ne;2;0;0;2
4547;Kurpaitė;Pelyčių;7546409044;Ne;0;8;0;8
4548;Kurpaitė;Pelyčių;1209441106;Ne;0;4;6;10
4549;Kurpaitė;Pelyčių;4519369081;Ne;1;4;0;5
4550;Kurpaitė;Pelyčių;7897713994;Ne;0;15;0;15
4551;Kurpaitė;Pelyčių;5064875626;Ne;0;3;0;3
4552;Kurpaitė;Pelyčių;5609161523;Ne;2;3;0;5
4553;Kurpaitė;Pelyčių;9480290430;Ne;3;3;0;6
4554;Kurpaitė;Pelyčių;4188925256;Ne;0;9;0;9
4555;Kurpaitė;Pelyčių;3003517700;Ne;0;4;0;4
4556;Kurpaitė;Pelyčių;3634641300;Ne;0;5;0;5
4557;Kurpaitė;Pelyčių;5844470373;Ne;12;4;0;16
4558;Kurpaitė;Pelyčių;9200404698;Ne;0;1;0;1
4559;Kurpaitė;Pelyčių;1864484931;Ne;9;4;0;13
4560;Kurpaitė;Pelyčių;8069116180;Ne;0;3;9;12
4561;Kurpaitė;Pelyčių;9384218589;Ne;5;13;0;18
4562;Kurpaitė;Pelyčių;6309468728;Ne;10;4;0;14
4563;Kurpaitė;Pelyčių;4964063637;Ne;8;4;0;12
4564;Kurpaitė;Pelyčių;2827617670;Ne;0;10;0;10
4565;Kurpaitė;Pelyčių;4168882748;Ne;0;12;0;12
4566;"Kūlverstukas (Suvalkų g. 6)";Saulutės;4846324136;Ne;0;1;0;1
4567;"Kūlverstukas (Suvalkų g. 6)";Saulutės;7505926208;Ne;0;5;0;5
4568;"Kūlverstukas (Suvalkų g. 6)";Saulutės;1014630718;Ne;0;5;0;5
4569;"Kūlverstukas (Suvalkų g. 6)";Saulutės;5340239466;Ne;1;4;0;5
4570;"Kūlverstukas (Suvalkų g. 6)";Saulutės;8294873714;Ne;0;8;0;8
4571;"Kūlverstukas (Suvalkų g. 6)";Saulutės;7970898546;Ne;0;3;0;3
4572;"Kūlverstukas (Suvalkų g. 6)";Saulutės;8353856412;Ne;9;2;0;11
4573;"Kūlverstukas (Suvalkų g. 6)";Saulutės;5391554530;Ne;0;4;0;4
4574;"Kūlverstukas (Suvalkų g. 6)";Saulutės;4111966910;Ne;3;4;0;7
4575;"Kūlverstukas (Suvalkų g. 6)";Saulutės;8964753108;Ne;0;5;0;5
4576;"Kūlverstukas (Suvalkų g. 6)";Saulutės;2389231051;Ne;0;5;0;5
4577;"Kūlverstukas (Suvalkų g. 6)";Saulutės;6710735721;Ne;0;7;0;7
4578;"Kūlverstukas (Suvalkų g. 6)";Saulutės;1067182820;Ne;7;3;0;10
4579;"Kūlverstukas (Suvalkų g. 6)";Saulutės;3196099819;Ne;0;1;0;1
4580;"Kūlverstukas (Suvalkų g. 6)";Saulutės;8346712630;Ne;2;0;0;2
4581;"Kūlverstukas (Suvalkų g. 6)";Saulutės;8333084277;Ne;1;3;0;4
4582;"Kūlverstukas (Suvalkų g. 6)";Saulutės;8896967083;Ne;0;2;0;2
4583;"Kūlverstukas (Suvalkų g. 6)";Peledžiukai;8853848991;Ne;0;4;0;4
4584;"Kūlverstukas (Suvalkų g. 6)";Peledžiukai;4073233921;Ne;0;4;0;4
4585;"Kūlverstukas (Suvalkų g. 6)";Peledžiukai;3238807604;Ne;0;4;0;4
4586;"Kūlverstukas (Suvalkų g. 6)";Peledžiukai;1932066021;Ne;9;0;0;9
4587;"Kūlverstukas (Suvalkų g. 6)";Peledžiukai;9655585527;Ne;0;4;0;4
4588;"Kūlverstukas (Suvalkų g. 6)";Peledžiukai;5345423038;Ne;0;7;0;7
4589;"Kūlverstukas (Suvalkų g. 6)";Peledžiukai;3270176280;Ne;0;5;0;5
4590;"Kūlverstukas (Suvalkų g. 6)";Peledžiukai;4285624305;Ne;4;2;0;6
4591;"Kūlverstukas (Suvalkų g. 6)";Peledžiukai;6894291912;Ne;0;4;0;4
4592;"Kūlverstukas (Suvalkų g. 6)";Peledžiukai;3224736003;Ne;0;4;0;4
4593;"Kūlverstukas (Suvalkų g. 6)";Peledžiukai;2762230590;Ne;0;3;0;3
4594;"Kūlverstukas (Suvalkų g. 6)";Peledžiukai;2450625415;Ne;0;3;2;5
4595;"Kūlverstukas (Suvalkų g. 6)";Peledžiukai;2101490038;Ne;2;4;0;6
4596;"Kūlverstukas (Suvalkų g. 6)";Peledžiukai;9096819614;Ne;0;4;0;4
4597;"Kūlverstukas (Suvalkų g. 6)";Peledžiukai;8319255735;Ne;0;2;3;5
4598;"Kūlverstukas (Suvalkų g. 6)";Peledžiukai;1795306946;Ne;12;0;0;12
4599;"Kūlverstukas (Suvalkų g. 6)";Peledžiukai;7118949795;Ne;10;2;0;12
4600;"Kūlverstukas (Suvalkų g. 6)";Peledžiukai;4173514390;Ne;0;3;1;4
4601;"Kūlverstukas (Suvalkų g. 6)";Peledžiukai;3448880105;Ne;0;4;3;7
4602;"Kūlverstukas (Suvalkų g. 6)";Peledžiukai;4532151103;Ne;8;3;0;11
4603;"Kūlverstukas (Suvalkų g. 6)";Gelytės;1939668692;Ne;12;1;0;13
4604;"Kūlverstukas (Suvalkų g. 6)";Gelytės;8618967238;Ne;10;3;0;13
4605;"Kūlverstukas (Suvalkų g. 6)";Gelytės;3790418633;Ne;4;2;0;6
4606;"Kūlverstukas (Suvalkų g. 6)";Gelytės;1679412281;Ne;4;2;0;6
4607;"Kūlverstukas (Suvalkų g. 6)";Gelytės;4945943570;Ne;3;2;0;5
4608;"Kūlverstukas (Suvalkų g. 6)";Gelytės;9777005699;Ne;1;11;0;12
4609;"Kūlverstukas (Suvalkų g. 6)";Gelytės;4694784301;Ne;3;2;0;5
4610;"Kūlverstukas (Suvalkų g. 6)";Gelytės;8599785196;Ne;3;1;0;4
4611;"Kūlverstukas (Suvalkų g. 6)";Gelytės;2082087440;Ne;17;0;0;17
4612;"Kūlverstukas (Suvalkų g. 6)";Gelytės;6916013898;Ne;0;4;0;4
4613;"Kūlverstukas (Suvalkų g. 6)";Gelytės;1062604474;Ne;4;0;0;4
4614;"Kūlverstukas (Suvalkų g. 6)";Gelytės;1985177751;Ne;0;9;0;9
4615;"Kūlverstukas (Suvalkų g. 6)";Gelytės;2924333435;Ne;8;1;0;9
4616;"Kūlverstukas (Suvalkų g. 6)";Gelytės;9787833724;Ne;11;0;0;11
4617;"Kūlverstukas (Suvalkų g. 6)";Gelytės;3370339665;Ne;0;2;0;2
4618;"Kūlverstukas (Suvalkų g. 6)";Gelytės;3712773480;Ne;0;9;0;9
4619;"Kūlverstukas (Suvalkų g. 6)";Bitutės;8510004509;Ne;4;0;0;4
4620;"Kūlverstukas (Suvalkų g. 6)";Bitutės;1710691463;Ne;16;0;0;16
4621;"Kūlverstukas (Suvalkų g. 6)";Bitutės;6820256485;Ne;0;2;1;3
4622;"Kūlverstukas (Suvalkų g. 6)";Bitutės;8630469988;Ne;1;0;0;1
4623;"Kūlverstukas (Suvalkų g. 6)";Bitutės;5359152614;Ne;0;2;0;2
4624;"Kūlverstukas (Suvalkų g. 6)";Bitutės;7536805404;Ne;6;0;0;6
4625;"Kūlverstukas (Suvalkų g. 6)";Bitutės;3603297769;Ne;12;1;0;13
4626;"Kūlverstukas (Suvalkų g. 6)";Bitutės;1651670859;Ne;0;1;0;1
4627;"Kūlverstukas (Suvalkų g. 6)";Bitutės;3667698628;Ne;8;0;0;8
4628;"Kūlverstukas (Suvalkų g. 6)";Bitutės;4211069122;Ne;12;0;0;12
4629;"Kūlverstukas (Suvalkų g. 6)";Bitutės;5401016434;Ne;3;1;1;5
4630;"Kūlverstukas (Suvalkų g. 6)";Bitutės;3348354269;Ne;2;3;0;5
4631;Lakštingala;Saulutės;2156571482;Ne;8;6;0;14
4632;Lakštingala;Saulutės;2084960114;Ne;5;0;2;7
4633;Lakštingala;Saulutės;3911509979;Ne;0;2;2;4
4634;Lakštingala;Saulutės;1598639284;Ne;6;5;1;12
4635;Lakštingala;Saulutės;3723986383;Ne;0;0;8;8
4636;Lakštingala;Saulutės;1243254166;Ne;0;5;0;5
4637;Lakštingala;Saulutės;9457533516;Ne;0;0;3;3
4638;Lakštingala;Saulutės;6567480562;Ne;0;1;5;6
4639;Lakštingala;Saulutės;9495341480;Ne;0;10;0;10
4640;Lakštingala;Saulutės;2543779273;Ne;7;6;0;13
4641;Lakštingala;Saulutės;2093953744;Ne;0;2;1;3
4642;Lakštingala;Saulutės;1074616528;Ne;5;0;4;9
4643;Lakštingala;Saulutės;5432816139;Ne;5;4;0;9
4644;Lakštingala;Saulutės;8679582358;Ne;19;0;0;19
4645;Lakštingala;Saulutės;5815240975;Ne;0;0;6;6
4646;Lakštingala;Saulutės;3520592784;Ne;5;0;1;6
4647;Lakštingala;Saulutės;3369263112;Ne;4;1;1;6
4648;Lakštingala;Saulutės;8717764626;Ne;3;1;3;7
4649;Lakštingala;Saulutės;8160825203;Ne;0;2;0;2
4650;Lakštingala;Saulutės;6780591792;Ne;0;5;0;5
4651;Lakštingala;Saulutės;1220858944;Ne;0;7;0;7
4652;Lakštingala;Saulutės;4032030375;Ne;1;5;1;7
4653;Lakštingala;Saulutės;3839016986;Ne;0;2;1;3
4654;Lakštingala;Saulutės;9628476764;Ne;4;0;1;5
4655;Lakštingala;Saulutės;4344553248;Ne;0;8;1;9
4656;Lakštingala;Nykštukai;6861300785;Ne;0;4;0;4
4657;Lakštingala;Nykštukai;8915978498;Ne;0;0;1;1
4658;Lakštingala;Nykštukai;9578079018;Ne;0;0;1;1
4659;Lakštingala;Nykštukai;5943711793;Ne;11;0;8;19
4660;Lakštingala;Nykštukai;1561903802;Ne;0;0;1;1
4661;Lakštingala;Nykštukai;9420187643;Ne;1;5;0;6
4662;Lakštingala;Nykštukai;9339816191;Ne;0;0;3;3
4663;Lakštingala;Nykštukai;4045740078;Ne;0;15;0;15
4664;Lakštingala;Nykštukai;8310446552;Ne;0;0;4;4
4665;Lakštingala;Nykštukai;8063735934;Ne;0;4;0;4
4666;Lakštingala;Nykštukai;7396235662;Ne;7;4;0;11
4667;Lakštingala;Nykštukai;3863174791;Ne;2;7;0;9
4668;Lakštingala;Nykštukai;4725848201;Ne;16;0;0;16
4669;Lakštingala;Nykštukai;2165808562;Ne;6;4;3;13
4670;Lakštingala;Nykštukai;5539054769;Ne;0;4;0;4
4671;Lakštingala;Nykštukai;8421786788;Ne;0;0;4;4
4672;Lakštingala;Nykštukai;6974936332;Ne;0;4;1;5
4673;Lakštingala;Nykštukai;8764728846;Ne;0;4;0;4
4674;Lakštingala;Nykštukai;8663938939;Taip;3;0;0;3
4675;Lakštingala;Nykštukai;6231045485;Ne;4;0;0;4
4676;Lakštingala;Nykštukai;5165517709;Ne;1;4;0;5
4677;Lakštingala;Nykštukai;5965026791;Ne;9;0;0;9
4678;Lakštingala;Bitutės;6234559044;Ne;0;4;0;4
4679;Lakštingala;Bitutės;5727308039;Ne;0;5;0;5
4680;Lakštingala;Bitutės;5051773825;Ne;6;4;0;10
4681;Lakštingala;Bitutės;9390342572;Ne;2;4;1;7
4682;Lakštingala;Bitutės;2130192341;Ne;1;4;0;5
4683;Lakštingala;Bitutės;8171357606;Ne;2;4;0;6
4684;Lakštingala;Bitutės;8165998647;Ne;4;4;1;9
4685;Lakštingala;Bitutės;9774836470;Ne;0;4;0;4
4686;Lakštingala;Bitutės;1958696382;Ne;7;5;0;12
4687;Lakštingala;Bitutės;1587899391;Ne;0;4;1;5
4688;Lakštingala;Bitutės;9694524137;Ne;2;0;0;2
4689;Lakštingala;Bitutės;1458348357;Ne;2;4;1;7
4690;Lakštingala;Bitutės;4542992319;Ne;12;4;0;16
4691;Lakštingala;Bitutės;7272454093;Ne;0;5;1;6
4692;Lakštingala;Bitutės;5949665703;Ne;0;4;0;4
4693;Lakštingala;Bitutės;4722328994;Ne;0;4;0;4
4694;Lakštingala;Bitutės;4465752871;Ne;0;3;0;3
4695;Lakštingala;Bitutės;2593030897;Ne;5;4;0;9
4696;Lakštingala;Bitutės;6565318145;Ne;0;4;0;4
4697;Lakštingala;Bitutės;4384468922;Ne;6;8;0;14
4698;Lakštingala;Bitutės;6908873466;Ne;3;4;0;7
4699;Lakštingala;Bitutės;5379344261;Ne;0;3;0;3
4700;Lakštingala;Bitutės;7929034243;Ne;0;10;0;10
4701;Lakštingala;Bitutės;5854794141;Ne;3;4;0;7
4702;Lakštingala;Bitutės;2423761155;Ne;3;4;1;8
4703;Lakštingala;Bitutės;5920907667;Ne;0;7;1;8
4704;Lakštingala;Pūkeliai;9093654437;Ne;7;0;0;7
4705;Lakštingala;Pūkeliai;3877448215;Ne;9;0;0;9
4706;Lakštingala;Pūkeliai;6148942052;Ne;6;0;1;7
4707;Lakštingala;Pūkeliai;7623917384;Ne;5;0;1;6
4708;Lakštingala;Pūkeliai;6011421835;Ne;10;0;1;11
4709;Lakštingala;Pūkeliai;8861428074;Ne;5;0;2;7
4710;Lakštingala;Pūkeliai;2673030043;Ne;3;0;2;5
4711;Lakštingala;Pūkeliai;2346497467;Ne;10;0;0;10
4712;Lakštingala;Pūkeliai;2010478542;Ne;12;0;2;14
4713;Lakštingala;Pūkeliai;1903292595;Ne;1;4;0;5
4714;Lakštingala;Pūkeliai;6764453371;Ne;6;5;0;11
4715;Lakštingala;Pūkeliai;9894103692;Ne;12;0;0;12
4716;Lakštingala;Pūkeliai;1371422364;Ne;1;0;1;2
4717;Lakštingala;Pūkeliai;8800538473;Ne;9;0;0;9
4718;Lakštingala;Pūkeliai;6285766353;Ne;4;0;1;5
4719;Lakštingala;Pūkeliai;3752408599;Ne;3;0;1;4
4720;Lakštingala;Pūkeliai;9183206191;Ne;12;0;1;13
4721;Lakštingala;Pūkeliai;2611117446;Ne;12;0;2;14
4722;Lakštingala;Pūkeliai;5524522038;Ne;11;0;3;14
4723;Lakštingala;Pūkeliai;5890760362;Taip;12;0;0;12
4724;Lakštingala;Pūkeliai;5583075385;Ne;6;0;1;7
4725;Lakštingala;Pūkeliai;4234177812;Ne;8;0;1;9
4726;Lakštingala;Pūkeliai;5903339111;Ne;14;0;0;14
4727;Lakštingala;Aitvariukai;1474796466;Ne;0;1;0;1
4728;Lakštingala;Aitvariukai;9629855134;Ne;1;4;0;5
4729;Lakštingala;Aitvariukai;4546036762;Ne;1;4;0;5
4730;Lakštingala;Aitvariukai;6219896499;Ne;0;3;0;3
4731;Lakštingala;Aitvariukai;7876311404;Ne;0;3;0;3
4732;Lakštingala;Aitvariukai;1248909711;Ne;3;4;0;7
4733;Lakštingala;Aitvariukai;9676872125;Ne;6;0;0;6
4734;Lakštingala;Aitvariukai;9083753159;Ne;1;4;0;5
4735;Lakštingala;Aitvariukai;7879280198;Ne;0;9;0;9
4736;Lakštingala;Aitvariukai;4403673558;Taip;7;6;0;13
4737;Lakštingala;Aitvariukai;5693413287;Ne;5;4;0;9
4738;Lakštingala;Aitvariukai;7240426529;Ne;8;4;0;12
4739;Lakštingala;Aitvariukai;8558000223;Ne;0;4;0;4
4740;Lakštingala;Aitvariukai;5244646855;Ne;1;4;0;5
4741;Lakštingala;Aitvariukai;5602079341;Ne;11;4;0;15
4742;Lakštingala;Aitvariukai;7404386777;Ne;0;4;0;4
4743;Lakštingala;Aitvariukai;3166474163;Ne;5;4;0;9
4744;Lakštingala;Aitvariukai;8609822839;Ne;6;5;0;11
4745;Lakštingala;Aitvariukai;6180443056;Ne;9;4;0;13
4746;Lakštingala;Aitvariukai;3113050690;Ne;0;1;0;1
4747;Lakštingala;Aitvariukai;6389721877;Ne;15;4;0;19
4748;Lakštingala;Aitvariukai;4211861355;Ne;1;12;0;13
4749;Lakštingala;Aitvariukai;6872095965;Ne;0;3;0;3
4750;Lakštingala;Boružiukai;1898853302;Ne;0;4;0;4
4751;Lakštingala;Boružiukai;8284565948;Ne;2;5;0;7
4752;Lakštingala;Boružiukai;4857448665;Ne;0;1;0;1
4753;Lakštingala;Boružiukai;1863034132;Ne;0;4;0;4
4754;Lakštingala;Boružiukai;9879064676;Ne;0;4;0;4
4755;Lakštingala;Boružiukai;2941128360;Ne;1;4;0;5
4756;Lakštingala;Boružiukai;8217315818;Ne;7;1;0;8
4757;Lakštingala;Boružiukai;9912622093;Ne;0;4;0;4
4758;Lakštingala;Boružiukai;6292331193;Ne;3;3;0;6
4759;Lakštingala;Boružiukai;3509165175;Ne;0;3;0;3
4760;Lakštingala;Boružiukai;4179366572;Ne;5;5;0;10
4761;Lakštingala;Boružiukai;9489982241;Ne;0;6;0;6
4762;Lakštingala;Boružiukai;3993759015;Ne;12;4;0;16
4763;Lakštingala;Boružiukai;5445945319;Ne;2;6;0;8
4764;Lakštingala;Boružiukai;2652305131;Ne;0;5;0;5
4765;Lakštingala;Boružiukai;9725851433;Ne;0;4;0;4
4766;Lakštingala;Boružiukai;1655202909;Ne;0;5;0;5
4767;Lakštingala;Boružiukai;6009631424;Ne;0;4;0;4
4768;Lakštingala;Boružiukai;9375002191;Ne;0;6;0;6
4769;Lakštingala;Boružiukai;7963839249;Ne;4;4;0;8
4770;Lakštingala;Boružiukai;5162605666;Ne;3;4;1;8
4771;Lakštingala;Boružiukai;2073818724;Ne;11;5;0;16
4772;Lakštingala;Boružiukai;7994475429;Ne;1;5;0;6
4773;Lakštingala;Boružiukai;2266870318;Ne;0;4;1;5
4774;Lakštingala;Boružiukai;9346986726;Ne;0;4;0;4
4775;Lakštingala;Žiogeliai;8404025659;Ne;6;0;4;10
4776;Lakštingala;Žiogeliai;4113993067;Ne;0;7;0;7
4777;Lakštingala;Žiogeliai;6981178960;Ne;5;4;0;9
4778;Lakštingala;Žiogeliai;3908175786;Ne;19;0;0;19
4779;Lakštingala;Žiogeliai;9860169528;Ne;5;0;2;7
4780;Lakštingala;Žiogeliai;4935753482;Ne;3;2;3;8
4781;Lakštingala;Žiogeliai;5008933316;Ne;0;4;0;4
4782;Lakštingala;Žiogeliai;3439681068;Ne;0;4;0;4
4783;Lakštingala;Žiogeliai;3766986041;Ne;0;0;14;14
4784;Lakštingala;Žiogeliai;1974950823;Ne;1;0;3;4
4785;Lakštingala;Žiogeliai;6561743084;Ne;0;4;0;4
4786;Lakštingala;Žiogeliai;1226908540;Ne;0;0;3;3
4787;Lakštingala;Žiogeliai;3951057865;Ne;16;0;0;16
4788;Lakštingala;Žiogeliai;1494530289;Ne;0;0;5;5
4789;Lakštingala;Žiogeliai;7661973162;Ne;2;4;0;6
4790;Lakštingala;Žiogeliai;7104398627;Ne;1;5;0;6
4791;Lakštingala;Žiogeliai;7361353346;Ne;1;0;4;5
4792;Lakštingala;Žiogeliai;4790291839;Ne;5;4;0;9
4793;Lakštingala;Žiogeliai;8351970017;Ne;3;1;4;8
4794;Lakštingala;Žiogeliai;8333832673;Ne;5;4;0;9
4795;Lakštingala;Žiogeliai;5849662446;Ne;5;0;2;7
4796;Lakštingala;Žiogeliai;5854343571;Ne;0;2;2;4
4797;Lakštingala;SPINDULIUKAI;4365413054;Ne;15;0;0;15
4798;Lakštingala;SPINDULIUKAI;9762500668;Ne;0;6;1;7
4799;Lakštingala;SPINDULIUKAI;7640007392;Ne;0;11;0;11
4800;Lakštingala;SPINDULIUKAI;4784677514;Ne;2;6;0;8
4801;Lakštingala;SPINDULIUKAI;2022621678;Ne;0;1;6;7
4802;Lakštingala;SPINDULIUKAI;8429523368;Ne;0;4;0;4
4803;Lakštingala;SPINDULIUKAI;6668075753;Ne;8;4;3;15
4804;Lakštingala;SPINDULIUKAI;9081653166;Ne;0;5;0;5
4805;Lakštingala;SPINDULIUKAI;8722490845;Ne;7;0;1;8
4806;Lakštingala;SPINDULIUKAI;3823860988;Ne;0;0;6;6
4807;Lakštingala;SPINDULIUKAI;7141840160;Ne;5;5;1;11
4808;Lakštingala;SPINDULIUKAI;3282771613;Ne;0;4;6;10
4809;Lakštingala;SPINDULIUKAI;2795341401;Ne;0;7;2;9
4810;Lakštingala;SPINDULIUKAI;9052256710;Ne;0;9;0;9
4811;Lakštingala;SPINDULIUKAI;4651600682;Ne;0;0;4;4
4812;Lakštingala;SPINDULIUKAI;8130468345;Ne;0;4;0;4
4813;Lakštingala;SPINDULIUKAI;2626498928;Ne;0;3;0;3
4814;Lakštingala;SPINDULIUKAI;3531056799;Ne;0;1;1;2
4815;Lakštingala;SPINDULIUKAI;9441296489;Ne;7;0;0;7
4816;Lakštingala;SPINDULIUKAI;6606640383;Ne;0;7;1;8
4817;Lakštingala;Pėledžiukai;6135103377;Ne;0;5;2;7
4818;Lakštingala;Pėledžiukai;4774354751;Ne;4;0;4;8
4819;Lakštingala;Pėledžiukai;8375506323;Ne;0;2;5;7
4820;Lakštingala;Pėledžiukai;2738882466;Ne;5;0;0;5
4821;Lakštingala;Pėledžiukai;8075192528;Ne;0;6;4;10
4822;Lakštingala;Pėledžiukai;4270513515;Ne;0;4;0;4
4823;Lakštingala;Pėledžiukai;2514377385;Ne;3;4;0;7
4824;Lakštingala;Pėledžiukai;6161860331;Ne;5;0;2;7
4825;Lakštingala;Pėledžiukai;6866935290;Ne;11;4;0;15
4826;Lakštingala;Pėledžiukai;8787118512;Ne;0;6;5;11
4827;Lakštingala;Pėledžiukai;6805882038;Ne;0;3;0;3
4828;Lakštingala;Pėledžiukai;7139669240;Ne;0;6;3;9
4829;Lakštingala;Pėledžiukai;9502994399;Ne;0;14;0;14
4830;Lakštingala;Pėledžiukai;9431022632;Ne;8;0;2;10
4831;Lakštingala;Pėledžiukai;9856189053;Ne;0;6;0;6
4832;Lakštingala;Pėledžiukai;5391954600;Ne;0;1;0;1
4833;Lakštingala;Pėledžiukai;4608719006;Ne;0;4;0;4
4834;Lakštingala;Pėledžiukai;5812491783;Ne;5;0;1;6
4835;Lakštingala;Pėledžiukai;9899997020;Ne;0;2;9;11
4836;Lakštingala;Pėledžiukai;6369696598;Ne;10;4;0;14
4837;Lakštingala;Pėledžiukai;9297542026;Ne;0;9;0;9
4838;Lakštingala;Pėledžiukai;3618452008;Ne;0;2;1;3
4839;Lakštingala;Katinėliai;7351891043;Ne;0;3;0;3
4840;Lakštingala;Katinėliai;2610113024;Ne;7;1;0;8
4841;Lakštingala;Katinėliai;6685195244;Ne;0;1;0;1
4842;Lakštingala;Katinėliai;8444696089;Ne;0;2;4;6
4843;Lakštingala;Katinėliai;4896401452;Ne;0;3;0;3
4844;Lakštingala;Katinėliai;7987187638;Ne;16;1;0;17
4845;Lakštingala;Katinėliai;8900191763;Ne;16;2;0;18
4846;Lakštingala;Katinėliai;5682152095;Ne;11;0;0;11
4847;Lakštingala;Katinėliai;9923491804;Ne;5;2;2;9
4848;Lakštingala;Katinėliai;2599217481;Ne;5;7;0;12
4849;Lakštingala;Katinėliai;2029350217;Ne;0;3;0;3
4850;Lakštingala;Katinėliai;6180366812;Ne;0;2;0;2
4851;Lakštingala;Katinėliai;3899425918;Ne;5;3;1;9
4852;Lakštingala;Katinėliai;4165688458;Ne;5;1;1;7
4853;Lakštingala;Katinėliai;3213575443;Ne;0;1;0;1
4854;Lakštingala;Katinėliai;2841048627;Ne;5;1;2;8
4855;Lakštingala;Katinėliai;1643794450;Ne;0;1;0;1
4856;Lakštingala;Katinėliai;1279172936;Ne;0;2;1;3
4857;Lakštingala;Katinėliai;2333102026;Ne;8;2;1;11
4858;Lakštingala;Katinėliai;2662167519;Ne;0;3;0;3
4859;Lakštingala;Katinėliai;3227628813;Ne;11;2;0;13
4860;Lakštingala;Katinėliai;2770661353;Ne;0;2;5;7
4861;Lakštingala;Deimantėliai;2114708431;Ne;0;7;0;7
4862;Lakštingala;Deimantėliai;8074211850;Ne;7;2;0;9
4863;Lakštingala;Deimantėliai;6749980386;Ne;5;2;0;7
4864;Lakštingala;Deimantėliai;9072843429;Ne;4;4;0;8
4865;Lakštingala;Deimantėliai;8938720617;Ne;0;1;0;1
4866;Lakštingala;Deimantėliai;4903094629;Ne;12;4;0;16
4867;Lakštingala;Deimantėliai;7853382073;Ne;5;4;0;9
4868;Lakštingala;Deimantėliai;1276857151;Ne;14;0;0;14
4869;Lakštingala;Deimantėliai;6971655647;Ne;4;3;0;7
4870;Lakštingala;Deimantėliai;7043519686;Ne;2;4;1;7
4871;Lakštingala;Deimantėliai;4976683143;Ne;0;3;0;3
4872;Lakštingala;Deimantėliai;7078051438;Ne;2;4;0;6
4873;Lakštingala;Deimantėliai;8571415914;Ne;2;4;0;6
4874;Lakštingala;Deimantėliai;8711116860;Ne;0;4;0;4
4875;Lakštingala;Deimantėliai;2886415541;Ne;1;6;1;8
4876;Lakštingala;Deimantėliai;5980402440;Ne;5;1;0;6
4877;Lakštingala;Deimantėliai;1661358666;Ne;6;0;0;6
4878;Lakštingala;Deimantėliai;9312563560;Ne;0;0;1;1
4879;Lakštingala;Deimantėliai;4199371972;Ne;0;4;0;4
4880;Lakštingala;KIŠKUČIAI;6520436055;Ne;19;0;0;19
4881;Lakštingala;KIŠKUČIAI;3208321841;Ne;13;1;0;14
4882;Lakštingala;KIŠKUČIAI;5464460112;Ne;0;3;0;3
4883;Lakštingala;KIŠKUČIAI;6970022417;Ne;9;0;0;9
4884;Lakštingala;KIŠKUČIAI;5730122965;Ne;10;9;0;19
4885;Lakštingala;KIŠKUČIAI;4140403601;Ne;7;1;0;8
4886;Lakštingala;KIŠKUČIAI;5119365443;Ne;9;0;0;9
4887;Lakštingala;KIŠKUČIAI;6689018476;Ne;10;0;0;10
4888;Lakštingala;KIŠKUČIAI;7017047366;Ne;2;4;0;6
4889;Lakštingala;KIŠKUČIAI;9539081376;Ne;1;0;6;7
4890;Lakštingala;KIŠKUČIAI;4854843534;Ne;10;0;1;11
4891;Lakštingala;KIŠKUČIAI;9162902701;Ne;9;0;1;10
4892;Lakštingala;KIŠKUČIAI;5455119187;Ne;2;0;1;3
4893;Lakštingala;KIŠKUČIAI;1113674539;Ne;5;1;0;6
4894;Lakštingala;KIŠKUČIAI;4370431439;Ne;6;1;0;7
4895;Lakštingala;KIŠKUČIAI;1898108870;Ne;18;0;0;18
4896;Lakštingala;KIŠKUČIAI;6652822827;Ne;0;0;3;3
4897;Lakštingala;KIŠKUČIAI;2998581623;Ne;14;0;0;14
4898;Lakštingala;KIŠKUČIAI;8414220381;Ne;7;0;1;8
4899;Lakštingala;KIŠKUČIAI;7817830649;Ne;14;4;0;18
4900;Lakštingala;KIŠKUČIAI;4653006161;Ne;0;1;2;3
4901;Lakštingala;KIŠKUČIAI;1831078544;Ne;12;0;0;12
4902;Lašelis;VIŠČIUKAI;6477439886;Ne;2;4;0;6
4903;Lašelis;VIŠČIUKAI;6912802425;Ne;6;4;0;10
4904;Lašelis;VIŠČIUKAI;6857428142;Ne;0;4;0;4
4905;Lašelis;VIŠČIUKAI;5759317067;Ne;10;6;0;16
4906;Lašelis;VIŠČIUKAI;1367955273;Ne;0;10;0;10
4907;Lašelis;VIŠČIUKAI;2702582486;Ne;7;2;0;9
4908;Lašelis;VIŠČIUKAI;2824852871;Ne;19;0;0;19
4909;Lašelis;VIŠČIUKAI;1294930990;Ne;0;6;0;6
4910;Lašelis;VIŠČIUKAI;2121080776;Taip;10;0;1;11
4911;Lašelis;VIŠČIUKAI;3003679103;Ne;0;1;0;1
4912;Lašelis;VIŠČIUKAI;4427263877;Ne;0;11;0;11
4913;Lašelis;VIŠČIUKAI;1168408482;Ne;8;2;0;10
4914;Lašelis;VIŠČIUKAI;4748156580;Ne;2;3;0;5
4915;Lašelis;VIŠČIUKAI;4860925464;Ne;3;3;0;6
4916;Lašelis;VIŠČIUKAI;2915806799;Ne;0;4;0;4
4917;Lašelis;VIŠČIUKAI;2900106941;Ne;6;4;1;11
4918;Lašelis;VIŠČIUKAI;2748888134;Ne;11;4;0;15
4919;Lašelis;ŠYPSENA;4113842551;Ne;0;5;0;5
4920;Lašelis;ŠYPSENA;6317716501;Ne;4;0;0;4
4921;Lašelis;ŠYPSENA;7502668870;Ne;0;5;0;5
4922;Lašelis;ŠYPSENA;8905080707;Ne;2;5;0;7
4923;Lašelis;ŠYPSENA;7784416134;Ne;5;0;0;5
4924;Lašelis;ŠYPSENA;4051058266;Ne;5;0;0;5
4925;Lašelis;ŠYPSENA;2991487552;Ne;5;0;0;5
4926;Lašelis;ŠYPSENA;7418586100;Ne;3;0;0;3
4927;Lašelis;ŠYPSENA;1429188137;Ne;2;0;0;2
4928;Lašelis;ŠYPSENA;1343964112;Ne;18;0;0;18
4929;Lašelis;ŠYPSENA;7811809908;Ne;8;0;0;8
4930;Lašelis;ŠYPSENA;4893073148;Ne;1;0;0;1
4931;Lašelis;ŠYPSENA;2210081848;Ne;2;0;0;2
4932;Lašelis;ŠYPSENA;8834899622;Ne;9;0;0;9
4933;Lašelis;ŠYPSENA;4805028666;Ne;3;0;0;3
4934;Lašelis;ŠYPSENA;1511922965;Ne;1;0;0;1
4935;Lašelis;NYKŠTUKAI;2509469243;Ne;4;8;0;12
4936;Lašelis;NYKŠTUKAI;4832223461;Ne;14;4;0;18
4937;Lašelis;NYKŠTUKAI;5416590600;Ne;4;7;0;11
4938;Lašelis;NYKŠTUKAI;1490179832;Ne;0;12;0;12
4939;Lašelis;NYKŠTUKAI;3995905195;Ne;0;19;0;19
4940;Lašelis;NYKŠTUKAI;1060784180;Ne;12;0;0;12
4941;Lašelis;NYKŠTUKAI;6137626795;Ne;9;2;0;11
4942;Lašelis;NYKŠTUKAI;1635921119;Ne;0;6;0;6
4943;Lašelis;NYKŠTUKAI;6836452490;Ne;1;4;1;6
4944;Lašelis;NYKŠTUKAI;4933598046;Ne;2;3;0;5
4945;Lašelis;NYKŠTUKAI;9664015801;Ne;0;5;0;5
4946;Lašelis;NYKŠTUKAI;1983312896;Ne;0;5;0;5
4947;Lašelis;NYKŠTUKAI;2210915728;Ne;0;2;0;2
4948;Lašelis;NYKŠTUKAI;1279052767;Ne;5;4;0;9
4949;Lašelis;NYKŠTUKAI;8906479495;Ne;12;0;0;12
4950;Lašelis;NYKŠTUKAI;2306501498;Ne;1;1;0;2
4951;Lašelis;NYKŠTUKAI;2606193652;Ne;0;3;0;3
4952;Lašelis;NYKŠTUKAI;9434932943;Ne;9;3;0;12
4953;Lašelis;NYKŠTUKAI;2593126568;Ne;7;0;1;8
4954;Lašelis;SAULUTĖ;3495676199;Ne;0;1;0;1
4955;Lašelis;SAULUTĖ;1175045927;Ne;0;4;0;4
4956;Lašelis;SAULUTĖ;8132517365;Ne;7;4;0;11
4957;Lašelis;SAULUTĖ;1244168190;Ne;0;2;0;2
4958;Lašelis;SAULUTĖ;4566547120;Taip;0;5;0;5
4959;Lašelis;SAULUTĖ;9647340725;Ne;7;2;0;9
4960;Lašelis;SAULUTĖ;1042560186;Taip;0;7;0;7
4961;Lašelis;SAULUTĖ;1035888733;Ne;1;6;0;7
4962;Lašelis;SAULUTĖ;1926439959;Ne;2;7;0;9
4963;Lašelis;SAULUTĖ;4508779926;Ne;0;3;2;5
4964;Lašelis;SAULUTĖ;1415345442;Ne;1;11;0;12
4965;Lašelis;SAULUTĖ;8318512396;Taip;0;4;0;4
4966;Lašelis;SAULUTĖ;8814796010;Ne;5;5;0;10
4967;Lašelis;SAULUTĖ;2223293390;Taip;7;4;0;11
4968;Lašelis;SAULUTĖ;2886967297;Ne;0;7;0;7
4969;Lašelis;SAULUTĖ;3805049682;Ne;7;9;0;16
4970;Lašelis;SAULUTĖ;2401058384;Ne;6;6;0;12
4971;Lašelis;SAULUTĖ;3675606390;Ne;0;12;0;12
4972;Lašelis;BORUŽĖLĖS;3180139334;Ne;19;0;0;19
4973;Lašelis;BORUŽĖLĖS;5000188106;Ne;5;0;0;5
4974;Lašelis;BORUŽĖLĖS;6203027620;Ne;3;0;0;3
4975;Lašelis;BORUŽĖLĖS;7619426839;Ne;14;2;0;16
4976;Lašelis;BORUŽĖLĖS;8718481664;Ne;15;4;0;19
4977;Lašelis;BORUŽĖLĖS;3130271837;Ne;0;5;0;5
4978;Lašelis;BORUŽĖLĖS;2871149756;Ne;19;0;0;19
4979;Lašelis;BORUŽĖLĖS;7920615797;Ne;10;1;0;11
4980;Lašelis;BORUŽĖLĖS;8212250478;Ne;0;7;0;7
4981;Lašelis;BORUŽĖLĖS;1675784376;Ne;15;1;0;16
4982;Lašelis;BORUŽĖLĖS;4734160251;Ne;19;0;0;19
4983;Lašelis;BORUŽĖLĖS;6275226824;Ne;1;0;0;1
4984;Lašelis;BORUŽĖLĖS;6751223169;Ne;6;0;0;6
4985;Lašelis;BORUŽĖLĖS;7432843976;Ne;8;1;0;9
4986;Lašelis;BORUŽĖLĖS;3183193902;Ne;9;4;0;13
4987;Lašelis;BORUŽĖLĖS;8063361528;Ne;0;4;0;4
4988;Lašelis;BORUŽĖLĖS;9879208797;Ne;14;0;0;14
4989;Lašelis;SKRUZDELIUKAI;5535348173;Ne;5;0;0;5
4990;Lašelis;SKRUZDELIUKAI;7704247097;Taip;11;0;0;11
4991;Lašelis;SKRUZDELIUKAI;4571213887;Ne;6;0;0;6
4992;Lašelis;SKRUZDELIUKAI;7367252046;Ne;11;0;0;11
4993;Lašelis;SKRUZDELIUKAI;9364834089;Ne;8;4;0;12
4994;Lašelis;SKRUZDELIUKAI;2200081600;Ne;13;0;0;13
4995;Lašelis;SKRUZDELIUKAI;6130824517;Ne;11;4;0;15
4996;Lašelis;SKRUZDELIUKAI;9905868465;Ne;6;0;0;6
4997;Lašelis;SKRUZDELIUKAI;6947939251;Ne;10;0;0;10
4998;Lašelis;SKRUZDELIUKAI;9394906598;Ne;13;0;0;13
4999;Lašelis;SKRUZDELIUKAI;9976394850;Ne;14;1;0;15
5000;Lašelis;SKRUZDELIUKAI;7610658433;Ne;10;0;0;10
5001;Lašelis;SKRUZDELIUKAI;4802629905;Ne;14;0;0;14
5002;Lašelis;SKRUZDELIUKAI;4487717519;Ne;4;3;0;7
5003;Lazdynėlis;BITUTĖS;1748260780;Ne;0;4;6;10
5004;Lazdynėlis;BITUTĖS;2044188250;Ne;0;4;0;4
5005;Lazdynėlis;BITUTĖS;2032759165;Taip;1;2;0;3
5006;Lazdynėlis;BITUTĖS;4545757725;Ne;0;4;0;4
5007;Lazdynėlis;BITUTĖS;6920441303;Ne;0;4;0;4
5008;Lazdynėlis;BITUTĖS;4153294595;Ne;2;4;0;6
5009;Lazdynėlis;BITUTĖS;7910561870;Ne;3;4;0;7
5010;Lazdynėlis;BITUTĖS;6963058612;Ne;0;10;0;10
5011;Lazdynėlis;BITUTĖS;9761942869;Ne;3;4;0;7
5012;Lazdynėlis;BITUTĖS;6276697479;Ne;0;4;0;4
5013;Lazdynėlis;BITUTĖS;9886856760;Ne;0;19;0;19
5014;Lazdynėlis;BITUTĖS;2998606948;Ne;0;19;0;19
5015;Lazdynėlis;BITUTĖS;6415858184;Ne;4;4;0;8
5016;Lazdynėlis;BITUTĖS;5796381191;Ne;11;4;0;15
5017;Lazdynėlis;BITUTĖS;5557752248;Ne;0;3;0;3
5018;Lazdynėlis;BITUTĖS;4771173060;Ne;5;4;0;9
5019;Lazdynėlis;BITUTĖS;1355954767;Ne;0;4;2;6
5020;Lazdynėlis;BITUTĖS;1070172991;Ne;0;3;0;3
5021;Lazdynėlis;BITUTĖS;8037918468;Ne;0;4;1;5
5022;Lazdynėlis;EŽIUKAI;3040417651;Ne;0;3;1;4
5023;Lazdynėlis;EŽIUKAI;6021387236;Ne;0;0;5;5
5024;Lazdynėlis;EŽIUKAI;7945472048;Ne;7;0;0;7
5025;Lazdynėlis;EŽIUKAI;1168433014;Ne;0;7;0;7
5026;Lazdynėlis;EŽIUKAI;7655218276;Ne;3;5;1;9
5027;Lazdynėlis;EŽIUKAI;6031442797;Ne;0;9;0;9
5028;Lazdynėlis;EŽIUKAI;7561833526;Ne;5;3;0;8
5029;Lazdynėlis;EŽIUKAI;3764854654;Ne;0;4;0;4
5030;Lazdynėlis;EŽIUKAI;5832624944;Ne;0;6;0;6
5031;Lazdynėlis;EŽIUKAI;1499729462;Ne;10;3;0;13
5032;Lazdynėlis;EŽIUKAI;2294873565;Ne;3;1;2;6
5033;Lazdynėlis;EŽIUKAI;2911152510;Ne;3;3;0;6
5034;Lazdynėlis;EŽIUKAI;3036055537;Ne;0;4;0;4
5035;Lazdynėlis;EŽIUKAI;4745610579;Ne;0;3;0;3
5036;Lazdynėlis;EŽIUKAI;6817162699;Ne;0;3;0;3
5037;Lazdynėlis;EŽIUKAI;8530159773;Ne;0;2;0;2
5038;Lazdynėlis;EŽIUKAI;7552873109;Ne;8;3;1;12
5039;Lazdynėlis;EŽIUKAI;9519409694;Ne;5;0;1;6
5040;Lazdynėlis;EŽIUKAI;2526260625;Ne;5;2;4;11
5041;Lazdynėlis;EŽIUKAI;2933025284;Ne;5;1;0;6
5042;Lazdynėlis;EŽIUKAI;1961540377;Ne;0;0;1;1
5043;Lazdynėlis;BORUŽIUKAI;8337458289;Ne;0;19;0;19
5044;Lazdynėlis;BORUŽIUKAI;7692056055;Ne;5;4;0;9
5045;Lazdynėlis;BORUŽIUKAI;6394994841;Ne;0;4;0;4
5046;Lazdynėlis;BORUŽIUKAI;2009941344;Ne;1;4;0;5
5047;Lazdynėlis;BORUŽIUKAI;1653216959;Ne;6;0;0;6
5048;Lazdynėlis;BORUŽIUKAI;4190852647;Ne;0;4;0;4
5049;Lazdynėlis;BORUŽIUKAI;2058909635;Ne;0;19;0;19
5050;Lazdynėlis;BORUŽIUKAI;3105363578;Ne;0;19;0;19
5051;Lazdynėlis;BORUŽIUKAI;5622254334;Ne;6;4;1;11
5052;Lazdynėlis;BORUŽIUKAI;7587041613;Ne;1;10;0;11
5053;Lazdynėlis;BORUŽIUKAI;2632078843;Ne;10;4;0;14
5054;Lazdynėlis;BORUŽIUKAI;5756228709;Ne;0;8;0;8
5055;Lazdynėlis;BORUŽIUKAI;6824473598;Ne;0;4;1;5
5056;Lazdynėlis;BORUŽIUKAI;1707231039;Ne;0;19;0;19
5057;Lazdynėlis;BORUŽIUKAI;6413861274;Ne;6;0;0;6
5058;Lazdynėlis;BORUŽIUKAI;8030743153;Ne;5;0;0;5
5059;Lazdynėlis;BORUŽIUKAI;4642875037;Ne;0;9;0;9
5060;Lazdynėlis;BORUŽIUKAI;1722503577;Ne;8;4;0;12
5061;Lazdynėlis;BORUŽIUKAI;4595080695;Ne;0;19;0;19
5062;Lazdynėlis;BORUŽIUKAI;4958640516;Ne;3;3;2;8
5063;Lazdynėlis;BORUŽIUKAI;3351966091;Ne;0;19;0;19
5064;Lazdynėlis;BORUŽIUKAI;9548866880;Ne;6;4;0;10
5065;Lazdynėlis;BORUŽIUKAI;4266414341;Ne;14;0;0;14
5066;Lazdynėlis;BORUŽIUKAI;6633585181;Ne;4;4;0;8
5067;Lazdynėlis;KAČIUKAI;2958520599;Ne;5;4;0;9
5068;Lazdynėlis;KAČIUKAI;6657174602;Ne;0;4;2;6
5069;Lazdynėlis;KAČIUKAI;2013752858;Ne;0;4;0;4
5070;Lazdynėlis;KAČIUKAI;2586187455;Ne;5;4;0;9
5071;Lazdynėlis;KAČIUKAI;4142277927;Ne;0;1;2;3
5072;Lazdynėlis;KAČIUKAI;1450181711;Ne;0;4;0;4
5073;Lazdynėlis;KAČIUKAI;7911328294;Ne;0;0;1;1
5074;Lazdynėlis;KAČIUKAI;5562900372;Ne;0;4;0;4
5075;Lazdynėlis;KAČIUKAI;4881322530;Ne;0;5;1;6
5076;Lazdynėlis;KAČIUKAI;8159928299;Ne;5;0;9;14
5077;Lazdynėlis;KAČIUKAI;1574847460;Ne;0;4;0;4
5078;Lazdynėlis;KAČIUKAI;4462819848;Ne;0;4;0;4
5079;Lazdynėlis;KAČIUKAI;7464997080;Ne;0;2;2;4
5080;Lazdynėlis;KAČIUKAI;9693153118;Ne;0;4;1;5
5081;Lazdynėlis;KAČIUKAI;7719697394;Ne;5;4;1;10
5082;Lazdynėlis;KAČIUKAI;4055450300;Ne;9;4;0;13
5083;Lazdynėlis;KAČIUKAI;3362193379;Ne;0;4;0;4
5084;Lazdynėlis;KAČIUKAI;6056618348;Ne;0;4;0;4
5085;Lazdynėlis;KAČIUKAI;3667994076;Ne;0;5;0;5
5086;Lazdynėlis;KAČIUKAI;1668899344;Ne;0;5;1;6
5087;Lazdynėlis;KAČIUKAI;4809829190;Ne;0;1;0;1
5088;Lazdynėlis;VOVERIUKAI;4747688220;Ne;0;3;2;5
5089;Lazdynėlis;VOVERIUKAI;1039874409;Ne;0;1;1;2
5090;Lazdynėlis;VOVERIUKAI;1312649234;Ne;0;3;0;3
5091;Lazdynėlis;VOVERIUKAI;9362249595;Ne;0;3;1;4
5092;Lazdynėlis;VOVERIUKAI;7135087818;Ne;8;3;0;11
5093;Lazdynėlis;VOVERIUKAI;3097254722;Ne;0;3;2;5
5094;Lazdynėlis;VOVERIUKAI;6352480127;Ne;0;3;0;3
5095;Lazdynėlis;VOVERIUKAI;2354549025;Ne;8;0;0;8
5096;Lazdynėlis;VOVERIUKAI;5407785006;Ne;0;3;0;3
5097;Lazdynėlis;VOVERIUKAI;6814362584;Ne;0;3;1;4
5098;Lazdynėlis;VOVERIUKAI;7208223612;Ne;5;3;0;8
5099;Lazdynėlis;VOVERIUKAI;4293473176;Ne;2;3;0;5
5100;Lazdynėlis;VOVERIUKAI;2723284353;Ne;0;1;0;1
5101;Lazdynėlis;VOVERIUKAI;9219327706;Ne;0;17;0;17
5102;Lazdynėlis;VOVERIUKAI;9548653584;Ne;0;3;1;4
5103;Lazdynėlis;VOVERIUKAI;6008610525;Ne;5;1;0;6
5104;Lazdynėlis;VOVERIUKAI;3879017767;Ne;0;1;0;1
5105;Lazdynėlis;VOVERIUKAI;4031719765;Ne;12;3;0;15
5106;Lazdynėlis;VOVERIUKAI;7006931682;Ne;0;3;0;3
5107;Lazdynėlis;VOVERIUKAI;6582898708;Ne;1;0;0;1
5108;Lazdynėlis;RIEŠUTĖLIAI;3086059608;Ne;9;3;0;12
5109;Lazdynėlis;RIEŠUTĖLIAI;2478218103;Ne;3;0;0;3
5110;Lazdynėlis;RIEŠUTĖLIAI;5987500024;Ne;5;4;0;9
5111;Lazdynėlis;RIEŠUTĖLIAI;2453740823;Ne;14;0;0;14
5112;Lazdynėlis;RIEŠUTĖLIAI;4552505857;Ne;3;0;0;3
5113;Lazdynėlis;RIEŠUTĖLIAI;7545621720;Ne;0;3;0;3
5114;Lazdynėlis;RIEŠUTĖLIAI;9810842975;Ne;0;3;0;3
5115;Lazdynėlis;RIEŠUTĖLIAI;8179584161;Ne;0;7;0;7
5116;Lazdynėlis;RIEŠUTĖLIAI;3239107488;Ne;0;4;0;4
5117;Lazdynėlis;RIEŠUTĖLIAI;8942906327;Ne;16;0;0;16
5118;Lazdynėlis;RIEŠUTĖLIAI;9582702244;Ne;0;3;0;3
5119;Lazdynėlis;RIEŠUTĖLIAI;3062924645;Ne;0;3;0;3
5120;Lazdynėlis;RIEŠUTĖLIAI;4092363029;Ne;0;6;0;6
5121;Lazdynėlis;RIEŠUTĖLIAI;3250913116;Ne;0;3;0;3
5122;Lazdynėlis;RIEŠUTĖLIAI;8529192130;Ne;4;4;0;8
5123;Lazdynėlis;RIEŠUTĖLIAI;5354852979;Ne;0;4;0;4
5124;Lazdynėlis;RIEŠUTĖLIAI;9930553716;Ne;8;0;0;8
5125;Lazdynėlis;RIEŠUTĖLIAI;6831456807;Ne;0;3;0;3
5126;Lazdynėlis;RIEŠUTĖLIAI;4795464133;Ne;3;3;0;6
5127;Lazdynėlis;RIEŠUTĖLIAI;7754329238;Ne;3;4;0;7
5128;Lazdynėlis;RIEŠUTĖLIAI;1488371861;Ne;0;4;2;6
5129;Lazdynėlis;ANČIUKAI;3587681925;Ne;0;4;0;4
5130;Lazdynėlis;ANČIUKAI;4183342119;Ne;1;4;0;5
5131;Lazdynėlis;ANČIUKAI;8978670259;Ne;0;4;0;4
5132;Lazdynėlis;ANČIUKAI;4189563297;Ne;3;4;0;7
5133;Lazdynėlis;ANČIUKAI;2416662141;Ne;0;4;0;4
5134;Lazdynėlis;ANČIUKAI;6575706614;Ne;6;4;0;10
5135;Lazdynėlis;ANČIUKAI;4687709867;Ne;4;4;0;8
5136;Lazdynėlis;ANČIUKAI;8927785463;Ne;3;4;0;7
5137;Lazdynėlis;ANČIUKAI;6284781209;Ne;2;4;0;6
5138;Lazdynėlis;ANČIUKAI;7646625115;Ne;2;4;0;6
5139;Lazdynėlis;ANČIUKAI;1246581188;Ne;4;4;0;8
5140;Lazdynėlis;ANČIUKAI;7261983723;Ne;5;4;0;9
5141;Lazdynėlis;ANČIUKAI;7386794107;Ne;0;4;0;4
5142;Lazdynėlis;ANČIUKAI;9724741469;Ne;8;4;0;12
5143;Lazdynėlis;ANČIUKAI;3060705012;Ne;3;0;1;4
5144;Lazdynėlis;GUDRUČIAI;9407743178;Ne;3;3;0;6
5145;Lazdynėlis;GUDRUČIAI;3357092509;Ne;8;3;0;11
5146;Lazdynėlis;GUDRUČIAI;1335000592;Ne;0;3;0;3
5147;Lazdynėlis;GUDRUČIAI;6994408527;Ne;11;3;0;14
5148;Lazdynėlis;GUDRUČIAI;2514035189;Ne;16;0;0;16
5149;Lazdynėlis;GUDRUČIAI;5889772626;Ne;0;3;0;3
5150;Lazdynėlis;GUDRUČIAI;6559543013;Ne;10;2;0;12
5151;Lazdynėlis;GUDRUČIAI;9231049001;Ne;3;3;0;6
5152;Lazdynėlis;GUDRUČIAI;6164180360;Ne;0;5;0;5
5153;Lazdynėlis;GUDRUČIAI;8159724466;Ne;7;3;0;10
5154;Lazdynėlis;GUDRUČIAI;3062408541;Ne;0;2;0;2
5155;Lazdynėlis;GUDRUČIAI;3779983775;Ne;0;3;0;3
5156;Lazdynėlis;GUDRUČIAI;5051632567;Ne;12;0;0;12
5157;Lazdynėlis;GUDRUČIAI;4550819172;Ne;2;2;0;4
5158;Lazdynėlis;GUDRUČIAI;8314002741;Ne;9;1;0;10
5159;Lazdynėlis;GUDRUČIAI;3365726271;Ne;7;2;0;9
5160;Lazdynėlis;GUDRUČIAI;7941793866;Ne;8;3;0;11
5161;Lazdynėlis;GUDRUČIAI;2802505435;Ne;0;1;0;1
5162;Lazdynėlis;GUDRUČIAI;8003673668;Ne;9;0;0;9
5163;Lazdynėlis;MEŠKIUKAI;4094713096;Ne;3;3;2;8
5164;Lazdynėlis;MEŠKIUKAI;4267469349;Ne;0;3;1;4
5165;Lazdynėlis;MEŠKIUKAI;3427972329;Ne;8;2;0;10
5166;Lazdynėlis;MEŠKIUKAI;6941986839;Ne;16;3;0;19
5167;Lazdynėlis;MEŠKIUKAI;3697808826;Ne;0;2;0;2
5168;Lazdynėlis;MEŠKIUKAI;2812633983;Ne;0;7;1;8
5169;Lazdynėlis;MEŠKIUKAI;9590507486;Ne;0;4;1;5
5170;Lazdynėlis;MEŠKIUKAI;5982766841;Ne;0;5;0;5
5171;Lazdynėlis;MEŠKIUKAI;1984546310;Ne;0;3;0;3
5172;Lazdynėlis;MEŠKIUKAI;4408660083;Ne;0;3;0;3
5173;Lazdynėlis;MEŠKIUKAI;8567304224;Ne;7;4;0;11
5174;Lazdynėlis;MEŠKIUKAI;4366502064;Ne;2;4;0;6
5175;Lazdynėlis;MEŠKIUKAI;5301881620;Ne;0;3;0;3
5176;Lazdynėlis;MEŠKIUKAI;8473007295;Ne;13;3;1;17
5177;Liepsnelė;Žvirbliukai;7925446594;Ne;5;0;0;5
5178;Liepsnelė;Varpeliai;9868489949;Ne;20;0;0;20
5179;Markučiai;Žirniukų;3525681034;Ne;4;0;0;4
5180;Markučiai;Žirniukų;7312533881;Ne;5;0;0;5
5181;Markučiai;Žirniukų;8934965409;Ne;3;4;0;7
5182;Markučiai;Žirniukų;8360526946;Ne;7;7;0;14
5183;Markučiai;Žirniukų;7244815252;Ne;1;0;0;1
5184;Markučiai;Žirniukų;2096169972;Ne;1;4;0;5
5185;Markučiai;Žirniukų;3073404128;Ne;0;4;0;4
5186;Markučiai;Žirniukų;5614488534;Ne;2;2;0;4
5187;Markučiai;Žirniukų;2367999201;Ne;7;0;0;7
5188;Markučiai;Žirniukų;4242575616;Ne;1;2;0;3
5189;Markučiai;Žirniukų;2099285475;Taip;6;3;0;9
5190;Markučiai;Žirniukų;2344252204;Ne;6;0;0;6
5191;Markučiai;Žirniukų;9576412366;Ne;1;4;0;5
5192;Markučiai;Žirniukų;1395241501;Ne;7;0;0;7
5193;Markučiai;Žirniukų;2539486337;Ne;4;0;0;4
5194;Markučiai;Žirniukų;8046320044;Ne;2;3;0;5
5195;Markučiai;Žirniukų;2060024771;Ne;9;0;0;9
5196;Markučiai;Žirniukų;6815286823;Ne;15;0;0;15
5197;Markučiai;Nykštukų;7507551844;Ne;1;4;0;5
5198;Markučiai;Nykštukų;9545967631;Ne;1;4;0;5
5199;Markučiai;Nykštukų;6898055631;Ne;5;3;0;8
5200;Markučiai;Nykštukų;3378749042;Ne;0;9;0;9
5201;Markučiai;Nykštukų;1884388847;Ne;0;4;0;4
5202;Markučiai;Nykštukų;2170380827;Ne;1;4;0;5
5203;Markučiai;Nykštukų;4485929800;Ne;2;0;0;2
5204;Markučiai;Nykštukų;5183244346;Ne;0;10;0;10
5205;Markučiai;Nykštukų;7624913025;Ne;0;8;0;8
5206;Markučiai;Nykštukų;4679710493;Ne;13;0;0;13
5207;Markučiai;Nykštukų;2994895532;Ne;2;5;0;7
5208;Markučiai;Nykštukų;4846899377;Ne;5;4;0;9
5209;Markučiai;Nykštukų;4150956779;Ne;0;6;0;6
5210;Markučiai;Nykštukų;4920107818;Ne;2;0;0;2
5211;Markučiai;Nykštukų;7680126946;Ne;3;8;0;11
5212;Markučiai;Nykštukų;4222017733;Ne;8;0;0;8
5213;Markučiai;Nykštukų;3414015064;Ne;14;0;0;14
5214;Markučiai;Nykštukų;7642401516;Ne;0;11;0;11
5215;Markučiai;Nykštukų;8055783293;Ne;0;6;0;6
5216;Markučiai;Pelėdžiukų;9180404247;Ne;2;3;0;5
5217;Markučiai;Pelėdžiukų;3386071459;Ne;10;0;1;11
5218;Markučiai;Pelėdžiukų;4653663237;Ne;12;0;0;12
5219;Markučiai;Pelėdžiukų;5727655114;Ne;4;4;0;8
5220;Markučiai;Pelėdžiukų;7947287013;Ne;3;0;1;4
5221;Markučiai;Pelėdžiukų;5522654429;Ne;0;4;1;5
5222;Markučiai;Pelėdžiukų;9219710045;Ne;6;0;0;6
5223;Markučiai;Pelėdžiukų;7539605426;Ne;13;0;0;13
5224;Markučiai;Pelėdžiukų;8888538915;Ne;9;0;0;9
5225;Markučiai;Pelėdžiukų;1623728091;Ne;2;0;0;2
5226;Markučiai;Pelėdžiukų;1799946177;Ne;5;0;0;5
5227;Markučiai;Pelėdžiukų;7809719827;Taip;0;3;0;3
5228;Markučiai;Pelėdžiukų;4860961508;Ne;5;4;0;9
5229;Markučiai;Pelėdžiukų;6569807889;Ne;0;3;0;3
5230;Markučiai;Pelėdžiukų;5269411010;Ne;12;0;0;12
5231;Markučiai;Pelėdžiukų;1524727903;Ne;7;9;0;16
5232;Markučiai;Pelėdžiukų;1622197135;Ne;11;0;1;12
5233;Markučiai;Pelėdžiukų;8839679529;Ne;18;0;0;18
5234;Markučiai;Boružėlių;1171899107;Ne;0;8;0;8
5235;Markučiai;Boružėlių;8078777204;Ne;5;6;0;11
5236;Markučiai;Boružėlių;8244065962;Ne;0;6;0;6
5237;Markučiai;Boružėlių;5902165968;Ne;0;6;0;6
5238;Markučiai;Boružėlių;5981692282;Ne;0;6;0;6
5239;Markučiai;Boružėlių;3739566642;Ne;5;9;0;14
5240;Markučiai;Boružėlių;6868394315;Ne;0;6;1;7
5241;Markučiai;Boružėlių;7634475536;Ne;1;4;0;5
5242;Markučiai;Boružėlių;5663147778;Ne;1;7;0;8
5243;Markučiai;Boružėlių;8271830626;Ne;1;8;0;9
5244;Markučiai;Boružėlių;3315824027;Ne;13;7;0;20
5245;Markučiai;Boružėlių;5562960498;Ne;2;6;1;9
5246;Markučiai;Boružėlių;6260010822;Ne;2;6;0;8
5247;Markučiai;Boružėlių;6740434675;Ne;1;3;1;5
5248;Markučiai;Boružėlių;6707310242;Ne;11;6;0;17
5249;Markučiai;Boružėlių;9631684972;Ne;0;6;1;7
5250;Markučiai;Boružėlių;4911787595;Ne;0;6;0;6
5251;Markučiai;Boružėlių;1587323435;Ne;0;30;0;30
5252;Markučiai;Bitučių;1720541082;Ne;4;4;0;8
5253;Markučiai;Bitučių;8792524832;Ne;2;6;0;8
5254;Markučiai;Bitučių;1717624510;Ne;5;3;1;9
5255;Markučiai;Bitučių;9518247571;Ne;0;4;0;4
5256;Markučiai;Bitučių;4836298058;Ne;2;4;1;7
5257;Markučiai;Bitučių;9027071539;Ne;0;4;0;4
5258;Markučiai;Bitučių;8748794886;Ne;0;4;0;4
5259;Markučiai;Bitučių;7387460586;Ne;0;3;0;3
5260;Markučiai;Bitučių;8950442843;Ne;12;4;0;16
5261;Markučiai;Bitučių;2840564082;Ne;0;4;0;4
5262;Markučiai;Bitučių;3926993383;Ne;10;4;0;14
5263;Markučiai;Bitučių;6530101961;Ne;0;7;2;9
5264;Markučiai;Bitučių;1908302738;Ne;3;4;1;8
5265;Markučiai;Bitučių;7056367646;Ne;9;4;1;14
5266;Markučiai;Bitučių;8195584468;Ne;5;4;0;9
5267;Markučiai;Bitučių;2049497686;Ne;0;4;1;5
5268;Markučiai;Bitučių;8541042547;Ne;0;4;1;5
5269;Markučiai;Bitučių;1447116821;Ne;2;4;0;6
5270;Markučiai;Bitučių;2931958829;Ne;0;4;1;5
5271;Markučiai;Bitučių;9303448709;Ne;0;4;0;4
5272;Markučiai;Drugelių;2537459830;Ne;0;4;0;4
5273;Markučiai;Drugelių;2288910885;Ne;0;5;0;5
5274;Markučiai;Drugelių;3544565354;Ne;5;6;0;11
5275;Markučiai;Drugelių;6992161129;Ne;6;0;0;6
5276;Markučiai;Drugelių;9412129807;Ne;0;10;2;12
5277;Markučiai;Drugelių;6979218594;Ne;11;0;0;11
5278;Markučiai;Drugelių;3491734422;Ne;0;2;6;8
5279;Markučiai;Drugelių;3491734422;Ne;0;2;6;8
5280;Markučiai;Drugelių;3491734422;Ne;0;2;6;8
5281;Markučiai;Drugelių;3832641521;Ne;11;0;2;13
5282;Markučiai;Drugelių;4520724770;Ne;11;0;1;12
5283;Markučiai;Drugelių;8050852518;Ne;0;0;1;1
5284;Markučiai;Drugelių;9391866085;Ne;9;0;2;11
5285;Markučiai;Drugelių;9073616238;Ne;7;0;0;7
5286;Markučiai;Drugelių;2967726802;Ne;9;0;0;9
5287;Markučiai;Drugelių;6684544229;Ne;11;0;2;13
5288;Markučiai;Drugelių;3487571241;Ne;5;0;2;7
5289;Markučiai;Drugelių;1433469476;Ne;0;4;0;4
5290;Markučiai;Drugelių;7110705287;Ne;11;0;6;17
5291;Markučiai;Drugelių;6055822200;Ne;12;3;0;15
5292;Markučiai;Skruzdėliukų;5566529492;Ne;13;0;0;13
5293;Markučiai;Skruzdėliukų;8105747904;Ne;9;1;1;11
5294;Markučiai;Skruzdėliukų;6617799980;Ne;16;2;0;18
5295;Markučiai;Skruzdėliukų;4369408254;Ne;0;0;1;1
5296;Markučiai;Skruzdėliukų;7580249913;Ne;9;0;1;10
5297;Markučiai;Skruzdėliukų;2246646548;Ne;15;0;1;16
5298;Markučiai;Skruzdėliukų;9921530582;Ne;6;0;0;6
5299;Markučiai;Skruzdėliukų;6759427415;Ne;15;0;2;17
5300;Markučiai;Skruzdėliukų;4820576711;Ne;11;0;0;11
5301;Markučiai;Skruzdėliukų;1527620947;Ne;19;0;0;19
5302;Markučiai;Skruzdėliukų;8774323234;Ne;5;0;2;7
5303;Markučiai;Skruzdėliukų;7881183912;Ne;8;4;0;12
5304;Markučiai;Skruzdėliukų;9338996275;Ne;8;0;0;8
5305;Markučiai;Skruzdėliukų;5180034556;Ne;3;0;0;3
5306;Markučiai;Skruzdėliukų;4383128686;Ne;8;4;0;12
5307;Markučiai;Skruzdėliukų;1929417022;Ne;6;0;0;6
5308;Markučiai;Skruzdėliukų;8679791696;Ne;3;3;0;6
5309;Markučiai;Skruzdėliukų;2647189399;Ne;4;0;0;4
5310;Markučiai;Skruzdėliukų;3077125574;Ne;2;5;0;7
5311;Markučiai;Skruzdėliukų;1711102751;Ne;11;0;0;11
5312;Markučiai;ZUIKUČIŲ;8722494948;Ne;17;0;0;17
5313;Markučiai;ZUIKUČIŲ;8649978914;Ne;8;0;0;8
5314;Markučiai;ZUIKUČIŲ;6415773081;Ne;8;4;0;12
5315;Markučiai;ZUIKUČIŲ;5027052978;Ne;15;0;0;15
5316;Markučiai;ZUIKUČIŲ;6747211291;Ne;6;0;0;6
5317;Markučiai;ZUIKUČIŲ;9143465340;Ne;7;1;0;8
5318;Markučiai;ZUIKUČIŲ;8921802809;Ne;13;0;0;13
5319;Markučiai;ZUIKUČIŲ;8811544042;Ne;15;0;0;15
5320;Markučiai;ZUIKUČIŲ;7307805203;Ne;2;0;0;2
5321;Markučiai;ZUIKUČIŲ;6385023139;Ne;4;2;0;6
5322;Markučiai;ZUIKUČIŲ;8661268341;Ne;15;4;0;19
5323;Markučiai;ZUIKUČIŲ;1632196228;Ne;6;0;0;6
5324;Markučiai;ZUIKUČIŲ;2937486382;Ne;2;0;0;2
5325;Markučiai;ŽIOGELIŲ;3859363657;Ne;13;0;0;13
5326;Markučiai;ŽIOGELIŲ;3306931221;Ne;5;5;0;10
5327;Markučiai;ŽIOGELIŲ;9249362647;Ne;6;1;0;7
5328;Markučiai;ŽIOGELIŲ;7425442727;Ne;12;0;0;12
5329;Markučiai;ŽIOGELIŲ;6293219533;Ne;9;5;1;15
5330;Markučiai;ŽIOGELIŲ;9395009057;Ne;19;0;0;19
5331;Markučiai;ŽIOGELIŲ;4306059458;Ne;5;0;0;5
5332;Markučiai;ŽIOGELIŲ;5934853242;Ne;14;0;0;14
5333;Markučiai;ŽIOGELIŲ;8489604005;Ne;16;0;1;17
5334;Markučiai;ŽIOGELIŲ;1989450429;Ne;19;0;0;19
5335;Markučiai;ŽIOGELIŲ;6469869116;Ne;19;0;0;19
5336;Markučiai;ŽIOGELIŲ;7299207983;Taip;12;6;0;18
5337;Markučiai;ŽIOGELIŲ;5429666204;Ne;22;0;0;22
5338;Markučiai;ŽIOGELIŲ;4590625976;Ne;18;0;0;18
5339;Markučiai;Ežiukių;5474990334;Ne;6;13;0;19
5340;Markučiai;Ežiukių;4829322890;Ne;14;0;1;15
5341;Markučiai;Ežiukių;8045995558;Ne;12;0;3;15
5342;Markučiai;Ežiukių;3864391517;Ne;2;0;0;2
5343;Markučiai;Ežiukių;9448972984;Ne;16;0;0;16
5344;Markučiai;Ežiukių;9462937261;Ne;0;0;7;7
5345;Markučiai;Ežiukių;2109460312;Ne;8;0;0;8
5346;Markučiai;Ežiukių;8085781929;Ne;3;0;0;3
5347;Markučiai;Ežiukių;2222934026;Ne;0;0;6;6
5348;Markučiai;Ežiukių;5096397215;Ne;0;0;2;2
5349;Markučiai;Ežiukių;7266459848;Ne;6;4;3;13
5350;Markučiai;Ežiukių;3942674807;Ne;5;0;4;9
5351;Markučiai;Ežiukių;8338320308;Ne;2;0;5;7
5352;Markučiai;Ežiukių;1376430548;Ne;0;0;6;6
5353;Markučiai;Ežiukių;8670849222;Ne;5;9;0;14
5354;Mažylis;"2 DARŽELIO GR.";4639389587;Ne;7;0;5;12
5355;Mažylis;"2 DARŽELIO GR.";1500475643;Ne;4;0;4;8
5356;Mažylis;"2 DARŽELIO GR.";8259994523;Ne;0;0;4;4
5357;Mažylis;"2 DARŽELIO GR.";4347489809;Ne;6;0;0;6
5358;Mažylis;"2 DARŽELIO GR.";4985161657;Ne;6;0;1;7
5359;Mažylis;"2 DARŽELIO GR.";1993916098;Ne;5;0;0;5
5360;Mažylis;"2 DARŽELIO GR.";4309902086;Ne;0;0;8;8
5361;Mažylis;"2 DARŽELIO GR.";5727207294;Ne;0;3;1;4
5362;Mažylis;"2 DARŽELIO GR.";8871998701;Ne;0;3;0;3
5363;Mažylis;"2 DARŽELIO GR.";3064367996;Ne;0;13;0;13
5364;Mažylis;"2 DARŽELIO GR.";6500577246;Ne;0;1;0;1
5365;Mažylis;"2 DARŽELIO GR.";4557902728;Ne;9;0;0;9
5366;Mažylis;"2 DARŽELIO GR.";3098913589;Ne;6;0;0;6
5367;Mažylis;"2 DARŽELIO GR.";4201114033;Ne;4;9;1;14
5368;Mažylis;"2 DARŽELIO GR.";2110320072;Ne;0;4;0;4
5369;Mažylis;"2 DARŽELIO GR.";7810360699;Ne;0;0;6;6
5370;Mažylis;"2 DARŽELIO GR.";3911343193;Ne;0;4;2;6
5371;Mažylis;"2 DARŽELIO GR.";5225388496;Ne;0;9;0;9
5372;Mažylis;"4 PRIEŠMOKYKLINĖ GR.";2979849055;Ne;0;0;5;5
5373;Mažylis;"4 PRIEŠMOKYKLINĖ GR.";6162880220;Ne;0;4;1;5
5374;Mažylis;"4 PRIEŠMOKYKLINĖ GR.";6009637985;Ne;7;0;3;10
5375;Mažylis;"4 PRIEŠMOKYKLINĖ GR.";1762105763;Ne;0;4;5;9
5376;Mažylis;"4 PRIEŠMOKYKLINĖ GR.";2672500259;Ne;0;0;7;7
5377;Mažylis;"4 PRIEŠMOKYKLINĖ GR.";2935175014;Ne;13;0;0;13
5378;Mažylis;"4 PRIEŠMOKYKLINĖ GR.";8135596731;Ne;0;0;4;4
5379;Mažylis;"4 PRIEŠMOKYKLINĖ GR.";8866980930;Ne;1;0;0;1
5380;Mažylis;"4 PRIEŠMOKYKLINĖ GR.";2704741847;Ne;0;4;0;4
5381;Mažylis;"4 PRIEŠMOKYKLINĖ GR.";8297427176;Ne;8;0;2;10
5382;Mažylis;"4 PRIEŠMOKYKLINĖ GR.";5870983755;Ne;0;1;0;1
5383;Mažylis;"4 PRIEŠMOKYKLINĖ GR.";3327673298;Ne;0;0;3;3
5384;Mažylis;"4 PRIEŠMOKYKLINĖ GR.";5685988186;Ne;5;4;0;9
5385;Mažylis;"4 PRIEŠMOKYKLINĖ GR.";4280547746;Ne;1;4;0;5
5386;Mažylis;"4 PRIEŠMOKYKLINĖ GR.";9447747294;Ne;0;4;1;5
5387;Mažylis;"4 PRIEŠMOKYKLINĖ GR.";4542742002;Ne;3;3;4;10
5388;Mažylis;"4 PRIEŠMOKYKLINĖ GR.";2031457519;Ne;0;4;8;12
5389;Mažylis;"4 PRIEŠMOKYKLINĖ GR.";5102030168;Ne;5;0;0;5
5390;Mažylis;"4 PRIEŠMOKYKLINĖ GR.";3308427647;Ne;0;3;0;3
5391;Mažylis;"4 PRIEŠMOKYKLINĖ GR.";7923522942;Ne;0;0;7;7
5392;Mažylis;"3 DARŽELIO GR.";6100650710;Taip;0;0;15;15
5393;Mažylis;"3 DARŽELIO GR.";9401388775;Ne;0;0;6;6
5394;Mažylis;"3 DARŽELIO GR.";4817146074;Ne;2;4;0;6
5395;Mažylis;"3 DARŽELIO GR.";7106648054;Ne;0;0;2;2
5396;Mažylis;"3 DARŽELIO GR.";6809320247;Ne;0;4;0;4
5397;Mažylis;"3 DARŽELIO GR.";2006289999;Ne;0;3;0;3
5398;Mažylis;"3 DARŽELIO GR.";7652390515;Ne;0;0;5;5
5399;Mažylis;"3 DARŽELIO GR.";8639480781;Ne;0;4;0;4
5400;Mažylis;"3 DARŽELIO GR.";9341935211;Ne;1;0;6;7
5401;Mažylis;"3 DARŽELIO GR.";2989562406;Ne;2;0;4;6
5402;Mažylis;"3 DARŽELIO GR.";1151737098;Ne;5;4;1;10
5403;Mažylis;"3 DARŽELIO GR.";7642914458;Ne;0;4;0;4
5404;Mažylis;"3 DARŽELIO GR.";5938312001;Ne;0;0;3;3
5405;Mažylis;"3 DARŽELIO GR.";2119733659;Ne;0;9;3;12
5406;Mažylis;"3 DARŽELIO GR.";6904083734;Ne;0;0;7;7
5407;Mažylis;"3 DARŽELIO GR.";2319506343;Ne;0;3;11;14
5408;Mažylis;"3 DARŽELIO GR.";9416161833;Ne;5;0;0;5
5409;Mažylis;"3 DARŽELIO GR.";4592795281;Ne;6;0;9;15
5410;Mažylis;"3 DARŽELIO GR.";8999239172;Ne;0;0;3;3
5411;Mažylis;"6 DARŽELIO GR.";5388105083;Ne;0;6;1;7
5412;Mažylis;"6 DARŽELIO GR.";8589124394;Ne;0;2;3;5
5413;Mažylis;"6 DARŽELIO GR.";3641990617;Ne;0;0;4;4
5414;Mažylis;"6 DARŽELIO GR.";1892136590;Ne;0;4;0;4
5415;Mažylis;"6 DARŽELIO GR.";9479398581;Ne;0;4;0;4
5416;Mažylis;"6 DARŽELIO GR.";1381828313;Ne;0;0;5;5
5417;Mažylis;"6 DARŽELIO GR.";7725286603;Ne;0;4;6;10
5418;Mažylis;"6 DARŽELIO GR.";7754956214;Ne;4;3;1;8
5419;Mažylis;"6 DARŽELIO GR.";3615636349;Ne;0;0;4;4
5420;Mažylis;"6 DARŽELIO GR.";9894955253;Ne;0;0;4;4
5421;Mažylis;"6 DARŽELIO GR.";3400122626;Ne;0;0;4;4
5422;Mažylis;"6 DARŽELIO GR.";6270840529;Ne;3;0;4;7
5423;Mažylis;"6 DARŽELIO GR.";4100492642;Ne;0;0;9;9
5424;Mažylis;"6 DARŽELIO GR.";7841955949;Ne;0;0;4;4
5425;Mažylis;"6 DARŽELIO GR.";6492768766;Ne;0;0;3;3
5426;Mažylis;"6 DARŽELIO GR.";6423910850;Ne;10;4;0;14
5427;Mažylis;"6 DARŽELIO GR.";1555305826;Ne;0;3;0;3
5428;Mažylis;"6 DARŽELIO GR.";5977423702;Ne;0;0;5;5
5429;Mažylis;"6 DARŽELIO GR.";9562863405;Ne;3;0;5;8
5430;Mažylis;"6 DARŽELIO GR.";5990843024;Ne;2;0;0;2
5431;Mažylis;"6 DARŽELIO GR.";9981751097;Ne;12;0;0;12
5432;Mažylis;"6 DARŽELIO GR.";5137132420;Ne;11;0;1;12
5433;Mažylis;"1 NAUJA (LOPŠELIS)";1233510409;Ne;2;0;4;6
5434;Mažylis;"1 NAUJA (LOPŠELIS)";4688933880;Ne;0;6;1;7
5435;Mažylis;"1 NAUJA (LOPŠELIS)";5683455589;Taip;0;0;10;10
5436;Mažylis;"1 NAUJA (LOPŠELIS)";6441787213;Ne;0;0;3;3
5437;Mažylis;"1 NAUJA (LOPŠELIS)";1578050891;Ne;0;0;5;5
5438;Mažylis;"1 NAUJA (LOPŠELIS)";4828287511;Ne;0;0;9;9
5439;Mažylis;"1 NAUJA (LOPŠELIS)";8084695989;Ne;0;0;8;8
5440;Mažylis;"1 NAUJA (LOPŠELIS)";9416048380;Ne;9;0;0;9
5441;Mažylis;"1 NAUJA (LOPŠELIS)";1174743283;Ne;0;0;4;4
5442;Mažylis;"1 NAUJA (LOPŠELIS)";3898781037;Ne;0;4;11;15
5443;Mažylis;"1 NAUJA (LOPŠELIS)";7940550309;Ne;0;0;10;10
5444;Mažylis;"1 NAUJA (LOPŠELIS)";2331014727;Ne;0;4;0;4
5445;Mažylis;"1 NAUJA (LOPŠELIS)";4373022569;Ne;0;0;3;3
5446;Mažylis;"5 DARŽELIO GR.";8655053217;Ne;14;0;0;14
5447;Mažylis;"5 DARŽELIO GR.";1058725505;Ne;0;7;0;7
5448;Mažylis;"5 DARŽELIO GR.";1219174313;Ne;3;0;0;3
5449;Mažylis;"5 DARŽELIO GR.";9111101357;Ne;9;0;0;9
5450;Mažylis;"5 DARŽELIO GR.";6728351360;Ne;10;0;0;10
5451;Mažylis;"5 DARŽELIO GR.";6272047137;Ne;9;0;2;11
5452;Mažylis;"5 DARŽELIO GR.";7255856938;Ne;4;0;11;15
5453;Mažylis;"5 DARŽELIO GR.";2795618410;Ne;3;4;0;7
5454;Mažylis;"5 DARŽELIO GR.";4987487972;Ne;9;0;0;9
5455;Mažylis;"5 DARŽELIO GR.";9727982334;Ne;0;4;0;4
5456;Mažylis;"5 DARŽELIO GR.";2723677422;Ne;7;0;2;9
5457;Mažylis;"5 DARŽELIO GR.";7252955092;Ne;10;0;1;11
5458;Mažylis;"5 DARŽELIO GR.";3072841295;Ne;17;0;0;17
5459;Mažylis;"5 DARŽELIO GR.";4796712246;Ne;4;0;2;6
5460;Mažylis;"5 DARŽELIO GR.";3079202929;Ne;3;0;3;6
5461;Mažylis;"5 DARŽELIO GR.";7933156766;Ne;4;0;0;4
5462;Mažylis;"5 DARŽELIO GR.";7419432731;Ne;11;0;0;11
5463;Mažylis;"5 DARŽELIO GR.";2425437724;Ne;4;0;6;10
5464;Medynėlis;BITUTĖS;6238256156;Ne;0;6;0;6
5465;Medynėlis;BITUTĖS;8711567312;Ne;0;0;5;5
5466;Medynėlis;BITUTĖS;2993705115;Ne;0;5;2;7
5467;Medynėlis;BITUTĖS;1504612730;Ne;6;1;0;7
5468;Medynėlis;BITUTĖS;5522261530;Ne;0;4;1;5
5469;Medynėlis;BITUTĖS;6576401514;Ne;6;0;2;8
5470;Medynėlis;BITUTĖS;4107846958;Taip;3;7;0;10
5471;Medynėlis;BITUTĖS;7296044569;Ne;12;4;0;16
5472;Medynėlis;BITUTĖS;4418330478;Ne;4;0;0;4
5473;Medynėlis;BITUTĖS;7042766873;Taip;0;1;2;3
5474;Medynėlis;BITUTĖS;6074296305;Ne;0;3;0;3
5475;Medynėlis;BITUTĖS;6815521895;Ne;5;4;1;10
5476;Medynėlis;BITUTĖS;4374464298;Ne;0;4;1;5
5477;Medynėlis;BITUTĖS;8107171123;Ne;2;6;0;8
5478;Medynėlis;BITUTĖS;4545707752;Ne;11;0;1;12
5479;Medynėlis;BITUTĖS;4419503239;Ne;6;9;0;15
5480;Medynėlis;BITUTĖS;7870261906;Ne;0;4;0;4
5481;Medynėlis;BITUTĖS;6466874318;Taip;0;6;0;6
5482;Medynėlis;BITUTĖS;2798305000;Ne;0;4;0;4
5483;Medynėlis;BITUTĖS;4598267411;Ne;4;0;0;4
5484;Medynėlis;BITUTĖS;5194220650;Ne;0;5;1;6
5485;Medynėlis;BITUTĖS;4243521511;Ne;2;4;0;6
5486;Medynėlis;DRUGELIAI;9670396828;Ne;0;3;0;3
5487;Medynėlis;DRUGELIAI;5551121950;Ne;1;2;0;3
5488;Medynėlis;DRUGELIAI;2627421550;Ne;0;4;0;4
5489;Medynėlis;DRUGELIAI;2794274146;Ne;0;4;0;4
5490;Medynėlis;DRUGELIAI;2932544910;Ne;4;2;0;6
5491;Medynėlis;DRUGELIAI;9079900803;Ne;11;2;0;13
5492;Medynėlis;DRUGELIAI;5571641847;Ne;2;3;0;5
5493;Medynėlis;DRUGELIAI;9355165862;Ne;0;1;0;1
5494;Medynėlis;DRUGELIAI;9184868565;Ne;0;4;0;4
5495;Medynėlis;DRUGELIAI;6706028300;Ne;0;4;0;4
5496;Medynėlis;DRUGELIAI;6955467123;Ne;3;4;0;7
5497;Medynėlis;DRUGELIAI;5785463517;Ne;0;4;0;4
5498;Medynėlis;DRUGELIAI;4468967036;Ne;0;3;0;3
5499;Medynėlis;DRUGELIAI;9438854582;Ne;0;4;0;4
5500;Medynėlis;DRUGELIAI;1901805808;Ne;1;4;0;5
5501;Medynėlis;DRUGELIAI;5784691118;Ne;2;4;0;6
5502;Medynėlis;DRUGELIAI;3856908872;Ne;0;3;0;3
5503;Medynėlis;DRUGELIAI;5158507933;Ne;9;0;0;9
5504;Medynėlis;DRUGELIAI;7501831333;Ne;4;4;0;8
5505;Medynėlis;DRUGELIAI;2097758483;Ne;0;5;0;5
5506;Medynėlis;DRUGELIAI;4267654911;Ne;1;4;0;5
5507;Medynėlis;SKRUZDĖLIUKAI;2218838971;Ne;8;0;0;8
5508;Medynėlis;SKRUZDĖLIUKAI;1206480760;Ne;13;0;0;13
5509;Medynėlis;SKRUZDĖLIUKAI;3790099536;Ne;4;0;0;4
5510;Medynėlis;SKRUZDĖLIUKAI;9336656351;Ne;0;2;0;2
5511;Medynėlis;SKRUZDĖLIUKAI;7085226543;Ne;5;8;0;13
5512;Medynėlis;SKRUZDĖLIUKAI;5049081242;Ne;7;0;0;7
5513;Medynėlis;SKRUZDĖLIUKAI;6824842361;Ne;2;2;0;4
5514;Medynėlis;SKRUZDĖLIUKAI;1283602655;Ne;0;9;0;9
5515;Medynėlis;SKRUZDĖLIUKAI;4817353132;Ne;1;3;2;6
5516;Medynėlis;SKRUZDĖLIUKAI;7613699868;Ne;5;1;0;6
5517;Medynėlis;SKRUZDĖLIUKAI;3556203620;Ne;2;5;0;7
5518;Medynėlis;SKRUZDĖLIUKAI;5269794415;Ne;0;2;0;2
5519;Medynėlis;SKRUZDĖLIUKAI;4626655069;Ne;12;0;0;12
5520;Medynėlis;SKRUZDĖLIUKAI;6896823412;Ne;0;4;0;4
5521;Medynėlis;SKRUZDĖLIUKAI;5677747582;Ne;0;5;0;5
5522;Medynėlis;SKRUZDĖLIUKAI;3480190692;Ne;6;3;0;9
5523;Medynėlis;SKRUZDĖLIUKAI;5581973770;Ne;2;4;1;7
5524;Medynėlis;VOVERIUKAI;8275097931;Ne;8;4;0;12
5525;Medynėlis;VOVERIUKAI;1026253778;Ne;0;0;3;3
5526;Medynėlis;VOVERIUKAI;2523474347;Ne;19;0;0;19
5527;Medynėlis;VOVERIUKAI;5302122600;Ne;2;0;2;4
5528;Medynėlis;VOVERIUKAI;6609111216;Taip;0;0;2;2
5529;Medynėlis;VOVERIUKAI;6624835214;Ne;0;0;3;3
5530;Medynėlis;VOVERIUKAI;2160081492;Ne;12;5;0;17
5531;Medynėlis;VOVERIUKAI;4035587227;Ne;3;0;3;6
5532;Medynėlis;VOVERIUKAI;8162771849;Ne;5;0;7;12
5533;Medynėlis;VOVERIUKAI;9725019515;Ne;4;0;0;4
5534;Medynėlis;VOVERIUKAI;3185760752;Ne;3;0;0;3
5535;Medynėlis;VOVERIUKAI;1404831377;Ne;0;0;3;3
5536;Medynėlis;VOVERIUKAI;7814008588;Ne;5;0;11;16
5537;Medynėlis;VOVERIUKAI;5610660982;Ne;2;3;0;5
5538;Medynėlis;VOVERIUKAI;6282113738;Ne;0;5;0;5
5539;Medynėlis;VOVERIUKAI;4153545500;Ne;2;4;0;6
5540;Medynėlis;VOVERIUKAI;8299034970;Ne;0;9;0;9
5541;Medynėlis;VOVERIUKAI;7675101600;Taip;3;4;0;7
5542;Medynėlis;VOVERIUKAI;1668143166;Ne;4;5;0;9
5543;Medynėlis;VOVERIUKAI;1608019909;Ne;0;5;0;5
5544;Medynėlis;VOVERIUKAI;4010058673;Ne;2;0;0;2
5545;Medynėlis;VOVERIUKAI;6502531749;Taip;0;0;2;2
5546;Medynėlis;VOVERIUKAI;9076139419;Ne;0;0;4;4
5547;Medynėlis;MEŠKIUKAI;7140184593;Ne;6;4;0;10
5548;Medynėlis;MEŠKIUKAI;5114554577;Ne;0;4;0;4
5549;Medynėlis;MEŠKIUKAI;3365026025;Ne;0;4;0;4
5550;Medynėlis;MEŠKIUKAI;6107849795;Ne;0;4;0;4
5551;Medynėlis;MEŠKIUKAI;4488439037;Ne;5;5;0;10
5552;Medynėlis;MEŠKIUKAI;4100792567;Ne;0;2;0;2
5553;Medynėlis;MEŠKIUKAI;6101613567;Ne;1;4;0;5
5554;Medynėlis;MEŠKIUKAI;1056744101;Ne;0;6;1;7
5555;Medynėlis;MEŠKIUKAI;6485314750;Ne;4;5;0;9
5556;Medynėlis;MEŠKIUKAI;7455041214;Ne;0;4;0;4
5557;Medynėlis;MEŠKIUKAI;3761845905;Ne;0;4;0;4
5558;Medynėlis;MEŠKIUKAI;9825580191;Ne;0;4;0;4
5559;Medynėlis;MEŠKIUKAI;7272017225;Ne;0;3;0;3
5560;Medynėlis;MEŠKIUKAI;2784942324;Ne;0;4;0;4
5561;Medynėlis;MEŠKIUKAI;4092824377;Ne;0;7;0;7
5562;Medynėlis;MEŠKIUKAI;1475701065;Ne;0;5;0;5
5563;Medynėlis;MEŠKIUKAI;3674134340;Ne;0;4;0;4
5564;Medynėlis;MEŠKIUKAI;4645171858;Ne;4;5;0;9
5565;Medynėlis;PELĖDŽIUKAI;4222917765;Ne;0;3;0;3
5566;Medynėlis;PELĖDŽIUKAI;1621499650;Ne;0;3;0;3
5567;Medynėlis;PELĖDŽIUKAI;6681155625;Ne;0;4;0;4
5568;Medynėlis;PELĖDŽIUKAI;2702814930;Ne;0;0;6;6
5569;Medynėlis;PELĖDŽIUKAI;6211076154;Ne;4;2;0;6
5570;Medynėlis;PELĖDŽIUKAI;5658868407;Ne;0;4;1;5
5571;Medynėlis;PELĖDŽIUKAI;6975191449;Ne;16;0;0;16
5572;Medynėlis;PELĖDŽIUKAI;3905440176;Ne;0;1;0;1
5573;Medynėlis;PELĖDŽIUKAI;8441629302;Ne;0;4;0;4
5574;Medynėlis;PELĖDŽIUKAI;4783894465;Ne;7;8;0;15
5575;Medynėlis;PELĖDŽIUKAI;3761140697;Ne;8;4;0;12
5576;Medynėlis;PELĖDŽIUKAI;5330900656;Ne;13;0;0;13
5577;Medynėlis;PELĖDŽIUKAI;1142044361;Ne;0;4;0;4
5578;Medynėlis;PELĖDŽIUKAI;4897227188;Ne;11;0;1;12
5579;Medynėlis;PELĖDŽIUKAI;9873696787;Taip;10;6;3;19
5580;Medynėlis;PELĖDŽIUKAI;6802308420;Ne;0;5;0;5
5581;Medynėlis;PELĖDŽIUKAI;2339692406;Ne;12;0;0;12
5582;Medynėlis;PELĖDŽIUKAI;3947494044;Ne;0;3;1;4
5583;Medynėlis;PELĖDŽIUKAI;3295727210;Ne;3;4;1;8
5584;Medynėlis;PELĖDŽIUKAI;2234994999;Ne;0;4;0;4
5585;Medynėlis;BORUŽIUKAI;6622963662;Ne;7;0;0;7
5586;Medynėlis;BORUŽIUKAI;3638155321;Ne;0;4;0;4
5587;Medynėlis;BORUŽIUKAI;9290099536;Taip;0;4;0;4
5588;Medynėlis;BORUŽIUKAI;1500986498;Ne;11;0;0;11
5589;Medynėlis;BORUŽIUKAI;6924524346;Ne;7;5;0;12
5590;Medynėlis;BORUŽIUKAI;2877881247;Ne;0;16;0;16
5591;Medynėlis;BORUŽIUKAI;3709984586;Ne;6;0;0;6
5592;Medynėlis;BORUŽIUKAI;6470879334;Ne;3;0;0;3
5593;Medynėlis;BORUŽIUKAI;2379829985;Ne;6;4;0;10
5594;Medynėlis;BORUŽIUKAI;4145591997;Ne;3;4;0;7
5595;Medynėlis;BORUŽIUKAI;6926408544;Ne;3;0;0;3
5596;Medynėlis;BORUŽIUKAI;5391199861;Ne;2;4;0;6
5597;Medynėlis;BORUŽIUKAI;9485498942;Ne;5;4;0;9
5598;Medynėlis;BORUŽIUKAI;6095795724;Ne;0;4;0;4
5599;Medynėlis;BORUŽIUKAI;7914358405;Ne;0;4;0;4
5600;Medynėlis;BORUŽIUKAI;7695626630;Ne;0;4;0;4
5601;Medynėlis;BORUŽIUKAI;2816510180;Ne;0;4;0;4
5602;Medynėlis;BORUŽIUKAI;3538656650;Ne;0;9;0;9
5603;Medynėlis;BORUŽIUKAI;6993176904;Ne;3;3;0;6
5604;Medynėlis;BORUŽIUKAI;5389909872;Ne;5;1;0;6
5605;Medynėlis;BORUŽIUKAI;9418978658;Ne;7;0;0;7
5606;Medynėlis;BORUŽIUKAI;9705185906;Taip;5;4;0;9
5607;Medynėlis;EŽIUKAI;9729505759;Ne;0;4;0;4
5608;Medynėlis;EŽIUKAI;8125271445;Ne;0;8;0;8
5609;Medynėlis;EŽIUKAI;9847006679;Ne;9;0;0;9
5610;Medynėlis;EŽIUKAI;7317307957;Ne;0;4;0;4
5611;Medynėlis;EŽIUKAI;7860869675;Ne;10;0;0;10
5612;Medynėlis;EŽIUKAI;4471168173;Ne;1;4;0;5
5613;Medynėlis;EŽIUKAI;1062269215;Ne;12;0;0;12
5614;Medynėlis;EŽIUKAI;5197757730;Taip;9;0;0;9
5615;Medynėlis;EŽIUKAI;5333502849;Ne;9;1;0;10
5616;Medynėlis;EŽIUKAI;6536626390;Ne;8;0;0;8
5617;Medynėlis;EŽIUKAI;8953622684;Ne;6;1;0;7
5618;Medynėlis;EŽIUKAI;3230747109;Ne;11;0;0;11
5619;Medynėlis;EŽIUKAI;9175884049;Ne;7;0;0;7
5620;Medynėlis;EŽIUKAI;8609650186;Ne;4;0;0;4
5621;Medynėlis;EŽIUKAI;6826409129;Ne;9;0;0;9
5622;Medynėlis;EŽIUKAI;2929100410;Ne;10;0;0;10
5623;Medynėlis;EŽIUKAI;6359536923;Ne;4;0;0;4
5624;Medynėlis;EŽIUKAI;2676262920;Ne;16;0;0;16
5625;Medynėlis;EŽIUKAI;5339084041;Taip;7;0;0;7
5626;Medynėlis;EŽIUKAI;5766492584;Ne;8;0;0;8
5627;Medynėlis;EŽIUKAI;6561927001;Ne;0;4;0;4
5628;Medynėlis;EŽIUKAI;8838774666;Ne;8;4;0;12
5629;Medynėlis;EŽIUKAI;6349817783;Ne;14;0;0;14
5630;Medynėlis;ZUIKUČIAI;9857514451;Ne;0;0;5;5
5631;Medynėlis;ZUIKUČIAI;4498233742;Ne;0;0;5;5
5632;Medynėlis;ZUIKUČIAI;6641009653;Ne;9;0;0;9
5633;Medynėlis;ZUIKUČIAI;2896713695;Ne;0;0;4;4
5634;Medynėlis;ZUIKUČIAI;2512917914;Ne;4;1;7;12
5635;Medynėlis;ZUIKUČIAI;6888812634;Taip;1;0;0;1
5636;Medynėlis;ZUIKUČIAI;8904493539;Taip;3;0;0;3
5637;Medynėlis;ZUIKUČIAI;1260839046;Ne;0;1;3;4
5638;Medynėlis;ZUIKUČIAI;8542591286;Ne;4;0;0;4
5639;Medynėlis;ZUIKUČIAI;7312016138;Ne;9;0;2;11
5640;Medynėlis;ZUIKUČIAI;6847727830;Ne;8;0;0;8
5641;Medynėlis;ZUIKUČIAI;3048797634;Ne;3;4;0;7
5642;Medynėlis;ZUIKUČIAI;3446378114;Ne;19;0;0;19
5643;Medynėlis;KAČIUKAI;2735961000;Ne;4;0;3;7
5644;Medynėlis;KAČIUKAI;3187000487;Ne;6;0;0;6
5645;Medynėlis;KAČIUKAI;3079549158;Ne;2;0;0;2
5646;Medynėlis;KAČIUKAI;1616551970;Ne;3;0;0;3
5647;Medynėlis;KAČIUKAI;7737665102;Ne;2;1;0;3
5648;Medynėlis;KAČIUKAI;1840127319;Ne;17;0;0;17
5649;Medynėlis;KAČIUKAI;2259408744;Ne;3;0;0;3
5650;Medynėlis;KAČIUKAI;5096386323;Ne;8;0;1;9
5651;Medynėlis;KAČIUKAI;2322666023;Ne;4;0;1;5
5652;Medynėlis;KAČIUKAI;9352913210;Ne;0;3;0;3
5653;Medynėlis;KAČIUKAI;4328794578;Ne;2;0;0;2
5654;Medynėlis;KAČIUKAI;9389418983;Ne;17;0;0;17
5655;Medynėlis;KAČIUKAI;2507106460;Taip;5;0;0;5
5656;Medynėlis;KAČIUKAI;8879923257;Ne;2;0;0;2
5657;Medynėlis;KAČIUKAI;7488521058;Ne;2;0;0;2
5658;Medynėlis;KAČIUKAI;8382537735;Ne;0;0;5;5
5659;Medynėlis;KAČIUKAI;7268418306;Taip;1;2;0;3
5660;Medynėlis;KAČIUKAI;2028112718;Ne;7;0;0;7
5661;Medynėlis;PELIUKAI;6614028601;Ne;9;0;0;9
5662;Medynėlis;PELIUKAI;8439619837;Ne;11;4;0;15
5663;Medynėlis;PELIUKAI;9352391583;Ne;0;4;1;5
5664;Medynėlis;PELIUKAI;4040542730;Ne;4;7;0;11
5665;Medynėlis;PELIUKAI;6989524053;Ne;8;4;1;13
5666;Medynėlis;PELIUKAI;9774213537;Ne;4;4;0;8
5667;Medynėlis;PELIUKAI;7129951535;Ne;3;0;5;8
5668;Medynėlis;PELIUKAI;9977590259;Ne;4;1;0;5
5669;Medynėlis;PELIUKAI;7170801214;Ne;1;5;1;7
5670;Medynėlis;PELIUKAI;9373849916;Ne;14;0;0;14
5671;Medynėlis;PELIUKAI;8678054784;Ne;0;4;1;5
5672;Medynėlis;PELIUKAI;6462589513;Ne;0;4;0;4
5673;Medynėlis;PELIUKAI;4204366008;Ne;0;4;1;5
5674;Medynėlis;PELIUKAI;3348520838;Ne;8;4;0;12
5675;Medynėlis;PELIUKAI;4444555055;Taip;5;0;0;5
5676;Medynėlis;PELIUKAI;2231990831;Ne;5;0;0;5
5677;Medynėlis;PELIUKAI;8887092965;Ne;4;1;0;5
5678;Medynėlis;PELIUKAI;3299495310;Ne;9;0;1;10
5679;Medynėlis;ANČIUKAI;8175602822;Ne;1;4;0;5
5680;Medynėlis;ANČIUKAI;9975663209;Ne;3;0;0;3
5681;Medynėlis;ANČIUKAI;9536473088;Ne;0;2;0;2
5682;Medynėlis;ANČIUKAI;2409824337;Ne;5;0;0;5
5683;Medynėlis;ANČIUKAI;4006434252;Ne;3;0;0;3
5684;Medynėlis;ANČIUKAI;8994120910;Ne;11;0;1;12
5685;Medynėlis;ANČIUKAI;6948059114;Ne;11;0;1;12
5686;Medynėlis;ANČIUKAI;9288258906;Ne;0;6;2;8
5687;Medynėlis;ANČIUKAI;4869007055;Ne;14;0;0;14
5688;Medynėlis;ANČIUKAI;9025913427;Ne;15;0;0;15
5689;Medynėlis;ANČIUKAI;7661220337;Ne;8;0;0;8
5690;Medynėlis;ANČIUKAI;3739441317;Ne;13;0;0;13
5691;Medynėlis;ANČIUKAI;1936512553;Ne;2;0;2;4
5692;Medynėlis;ANČIUKAI;1864754712;Ne;15;0;0;15
5693;Molinukas;NYKŠTUKAI;4974513900;Ne;7;0;0;7
5694;Molinukas;NYKŠTUKAI;8313486714;Ne;0;7;2;9
5695;Molinukas;NYKŠTUKAI;8608465121;Ne;15;0;0;15
5696;Molinukas;NYKŠTUKAI;1826463800;Ne;0;4;0;4
5697;Molinukas;NYKŠTUKAI;3043679624;Ne;10;3;0;13
5698;Molinukas;NYKŠTUKAI;4992887072;Ne;0;3;0;3
5699;Molinukas;NYKŠTUKAI;8769667823;Ne;0;4;0;4
5700;Molinukas;NYKŠTUKAI;1651103318;Ne;0;0;1;1
5701;Molinukas;NYKŠTUKAI;6947938890;Ne;3;0;0;3
5702;Molinukas;NYKŠTUKAI;1970929144;Ne;3;4;0;7
5703;Molinukas;NYKŠTUKAI;1292778118;Ne;5;0;2;7
5704;Molinukas;NYKŠTUKAI;3510936830;Ne;0;4;0;4
5705;Molinukas;NYKŠTUKAI;1907287249;Ne;4;0;4;8
5706;Molinukas;NYKŠTUKAI;5172948843;Ne;0;1;1;2
5707;Molinukas;NYKŠTUKAI;7825545164;Ne;6;0;1;7
5708;Molinukas;NYKŠTUKAI;6190443233;Ne;0;0;9;9
5709;Molinukas;NYKŠTUKAI;6531106368;Ne;0;0;2;2
5710;Molinukas;NYKŠTUKAI;4122429163;Ne;0;7;0;7
5711;Molinukas;NYKŠTUKAI;8660958288;Ne;5;0;5;10
5712;Molinukas;NYKŠTUKAI;2862680065;Ne;6;3;0;9
5713;Molinukas;NYKŠTUKAI;3382913312;Ne;0;0;1;1
5714;Molinukas;NYKŠTUKAI;3331982964;Ne;5;4;0;9
5715;Molinukas;NYKŠTUKAI;2842168450;Ne;4;4;0;8
5716;Molinukas;NYKŠTUKAI;4044289280;Ne;17;0;0;17
5717;Molinukas;ZUIKUČIŲ;9203375647;Ne;7;4;0;11
5718;Molinukas;ZUIKUČIŲ;2982968605;Ne;2;4;0;6
5719;Molinukas;ZUIKUČIŲ;8479427729;Ne;1;0;0;1
5720;Molinukas;ZUIKUČIŲ;4225457772;Ne;8;2;0;10
5721;Molinukas;ZUIKUČIŲ;8114735116;Ne;3;6;0;9
5722;Molinukas;ZUIKUČIŲ;5597119459;Ne;8;4;0;12
5723;Molinukas;ZUIKUČIŲ;8582985479;Ne;15;0;0;15
5724;Molinukas;ZUIKUČIŲ;8490020853;Ne;15;0;0;15
5725;Molinukas;ZUIKUČIŲ;2651732418;Ne;6;5;0;11
5726;Molinukas;ZUIKUČIŲ;8988478990;Ne;0;4;0;4
5727;Molinukas;ZUIKUČIŲ;1059002689;Ne;14;0;0;14
5728;Molinukas;ZUIKUČIŲ;5302191209;Ne;16;0;0;16
5729;Molinukas;ZUIKUČIŲ;1605039166;Ne;12;1;0;13
5730;Molinukas;ZUIKUČIŲ;6804127471;Ne;12;1;0;13
5731;Molinukas;ZUIKUČIŲ;2878262979;Ne;0;3;0;3
5732;Molinukas;ZUIKUČIŲ;7441251480;Ne;0;3;0;3
5733;Molinukas;ZUIKUČIŲ;4733315902;Ne;6;4;0;10
5734;Molinukas;ZUIKUČIŲ;2595941277;Ne;19;0;0;19
5735;Molinukas;ZUIKUČIŲ;2706981559;Ne;5;4;0;9
5736;Molinukas;ZUIKUČIŲ;6638634402;Ne;10;0;0;10
5737;Molinukas;ZUIKUČIŲ;3516132254;Ne;10;0;0;10
5738;Molinukas;ZUIKUČIŲ;4718396549;Ne;5;0;0;5
5739;Molinukas;ZUIKUČIŲ;3577613732;Ne;7;0;0;7
5740;Molinukas;ZUIKUČIŲ;9972204424;Ne;7;0;0;7
5741;Molinukas;ZUIKUČIŲ;3419958136;Ne;8;0;0;8
5742;Molinukas;ZUIKUČIŲ;2789279432;Ne;0;4;0;4
5743;Molinukas;SRAIGIUKŲ;4806350914;Ne;2;4;1;7
5744;Molinukas;SRAIGIUKŲ;2757744826;Ne;0;4;0;4
5745;Molinukas;SRAIGIUKŲ;7451224160;Ne;0;14;0;14
5746;Molinukas;SRAIGIUKŲ;4475594896;Ne;1;4;3;8
5747;Molinukas;SRAIGIUKŲ;2348120316;Ne;0;4;0;4
5748;Molinukas;SRAIGIUKŲ;9244598883;Ne;8;0;0;8
5749;Molinukas;SRAIGIUKŲ;7623051674;Ne;4;4;0;8
5750;Molinukas;SRAIGIUKŲ;9448910819;Ne;5;4;0;9
5751;Molinukas;SRAIGIUKŲ;4101644021;Ne;0;4;0;4
5752;Molinukas;SRAIGIUKŲ;1651650182;Ne;0;3;0;3
5753;Molinukas;SRAIGIUKŲ;5580968328;Ne;5;5;0;10
5754;Molinukas;SRAIGIUKŲ;6353165459;Ne;0;8;0;8
5755;Molinukas;SRAIGIUKŲ;9293819449;Ne;0;4;6;10
5756;Molinukas;SRAIGIUKŲ;8536615996;Ne;0;3;1;4
5757;Molinukas;SRAIGIUKŲ;6087698882;Ne;4;4;0;8
5758;Molinukas;SRAIGIUKŲ;7602239077;Ne;5;1;1;7
5759;Molinukas;SRAIGIUKŲ;1849018608;Ne;0;4;0;4
5760;Molinukas;SRAIGIUKŲ;4171978721;Ne;0;4;3;7
5761;Molinukas;SRAIGIUKŲ;6681397435;Ne;10;4;1;15
5762;Molinukas;SRAIGIUKŲ;7134802574;Ne;0;2;0;2
5763;Molinukas;SRAIGIUKŲ;8260101075;Ne;0;2;0;2
5764;Molinukas;SRAIGIUKŲ;5525772579;Ne;0;6;0;6
5765;Molinukas;SRAIGIUKŲ;5876669121;Ne;0;4;0;4
5766;Molinukas;SRAIGIUKŲ;8053608348;Ne;0;4;0;4
5767;Molinukas;SRAIGIUKŲ;6014990150;Ne;8;3;0;11
5768;Molinukas;VOVERIUKAI;3469196411;Ne;5;3;0;8
5769;Molinukas;VOVERIUKAI;4583155940;Ne;6;0;0;6
5770;Molinukas;VOVERIUKAI;8541456847;Ne;0;9;1;10
5771;Molinukas;VOVERIUKAI;2286586693;Ne;14;0;0;14
5772;Molinukas;VOVERIUKAI;9413396859;Ne;1;0;1;2
5773;Molinukas;VOVERIUKAI;6898958282;Ne;0;0;3;3
5774;Molinukas;VOVERIUKAI;4000190261;Ne;7;0;0;7
5775;Molinukas;VOVERIUKAI;5685582215;Ne;0;5;0;5
5776;Molinukas;VOVERIUKAI;2356814145;Ne;5;5;1;11
5777;Molinukas;VOVERIUKAI;7446607510;Ne;1;10;0;11
5778;Molinukas;VOVERIUKAI;9667704959;Ne;7;1;4;12
5779;Molinukas;VOVERIUKAI;8516451290;Ne;15;0;0;15
5780;Molinukas;VOVERIUKAI;3030169626;Ne;0;4;1;5
5781;Molinukas;VOVERIUKAI;1865748733;Ne;2;0;0;2
5782;Molinukas;VOVERIUKAI;4209143136;Ne;11;0;0;11
5783;Molinukas;VOVERIUKAI;5648861702;Ne;11;0;0;11
5784;Molinukas;VOVERIUKAI;4957226547;Ne;3;4;1;8
5785;Molinukas;VOVERIUKAI;8865966572;Ne;10;0;0;10
5786;Molinukas;VOVERIUKAI;4950808381;Ne;19;0;0;19
5787;Molinukas;VOVERIUKAI;7378643086;Ne;0;4;0;4
5788;Molinukas;VOVERIUKAI;2779700726;Ne;13;0;0;13
5789;Molinukas;VOVERIUKAI;6832647220;Ne;0;4;1;5
5790;Molinukas;VOVERIUKAI;9318837973;Ne;0;2;0;2
5791;Molinukas;VOVERIUKAI;8247270556;Ne;0;4;0;4
5792;Molinukas;ŽVIRBLIUKŲ;2935945686;Ne;5;4;0;9
5793;Molinukas;ŽVIRBLIUKŲ;2090783609;Ne;3;0;0;3
5794;Molinukas;ŽVIRBLIUKŲ;9850656596;Ne;0;4;0;4
5795;Molinukas;ŽVIRBLIUKŲ;7052683028;Ne;14;0;0;14
5796;Molinukas;ŽVIRBLIUKŲ;6324308817;Ne;0;3;0;3
5797;Molinukas;ŽVIRBLIUKŲ;8578781383;Ne;2;0;0;2
5798;Molinukas;ŽVIRBLIUKŲ;6006474519;Ne;9;0;0;9
5799;Molinukas;ŽVIRBLIUKŲ;1768984445;Ne;9;0;0;9
5800;Molinukas;ŽVIRBLIUKŲ;5040258188;Ne;2;0;0;2
5801;Molinukas;ŽVIRBLIUKŲ;9936048965;Ne;10;0;0;10
5802;Molinukas;KAČIUKŲ;8973341322;Ne;3;0;0;3
5803;Molinukas;KAČIUKŲ;4356610282;Ne;15;0;0;15
5804;Molinukas;KAČIUKŲ;5166540248;Ne;17;0;1;18
5805;Molinukas;KAČIUKŲ;5834614345;Ne;17;0;1;18
5806;Molinukas;KAČIUKŲ;5665993086;Ne;0;0;1;1
5807;Molinukas;KAČIUKŲ;7349691727;Ne;5;4;0;9
5808;Molinukas;KAČIUKŲ;7192221243;Ne;0;3;0;3
5809;Molinukas;KAČIUKŲ;2866461509;Ne;18;0;0;18
5810;Molinukas;KAČIUKŲ;6096244346;Ne;0;0;6;6
5811;Molinukas;KAČIUKŲ;2537694744;Ne;10;0;0;10
5812;"Naminukas (Smėlio g. 13)";Drugeliai;6776805494;Ne;0;3;0;3
5813;"Naminukas (Smėlio g. 13)";Drugeliai;2395070574;Ne;0;4;0;4
5814;"Naminukas (Smėlio g. 13)";Drugeliai;5534073614;Ne;0;2;0;2
5815;"Naminukas (Smėlio g. 13)";Drugeliai;2132345627;Ne;0;4;0;4
5816;"Naminukas (Smėlio g. 13)";Drugeliai;1302119260;Ne;0;3;0;3
5817;"Naminukas (Smėlio g. 13)";Drugeliai;2864905392;Ne;6;7;1;14
5818;"Naminukas (Smėlio g. 13)";Drugeliai;7406775925;Ne;11;4;0;15
5819;"Naminukas (Smėlio g. 13)";Drugeliai;1333462200;Ne;0;3;2;5
5820;"Naminukas (Smėlio g. 13)";Drugeliai;5468218968;Ne;0;4;0;4
5821;"Naminukas (Smėlio g. 13)";Drugeliai;5713661641;Ne;6;4;0;10
5822;"Naminukas (Smėlio g. 13)";Drugeliai;6581925461;Ne;3;4;0;7
5823;"Naminukas (Smėlio g. 13)";Drugeliai;3320805432;Ne;0;3;0;3
5824;"Naminukas (Smėlio g. 13)";Drugeliai;9689866363;Ne;0;3;0;3
5825;"Naminukas (Smėlio g. 13)";Drugeliai;2198493034;Ne;0;8;0;8
5826;"Naminukas (Smėlio g. 13)";Drugeliai;8141324449;Ne;7;4;0;11
5827;"Naminukas (Smėlio g. 13)";Drugeliai;8564586014;Ne;0;4;0;4
5828;"Naminukas (Smėlio g. 13)";Drugeliai;3236525642;Ne;0;4;0;4
5829;"Naminukas (Smėlio g. 13)";Drugeliai;7347998152;Ne;0;5;0;5
5830;"Naminukas (Smėlio g. 13)";Drugeliai;7272465847;Ne;12;4;0;16
5831;"Naminukas (Smėlio g. 13)";Drugeliai;7471964981;Ne;1;8;0;9
5832;"Naminukas (Smėlio g. 13)";Drugeliai;8760638670;Ne;5;4;0;9
5833;"Naminukas (Smėlio g. 13)";Drugeliai;1648466517;Ne;0;6;0;6
5834;"Naminukas (Smėlio g. 13)";Bitutės;6057391542;Ne;3;4;1;8
5835;"Naminukas (Smėlio g. 13)";Bitutės;3546140753;Ne;0;4;0;4
5836;"Naminukas (Smėlio g. 13)";Bitutės;6351199828;Ne;4;0;0;4
5837;"Naminukas (Smėlio g. 13)";Bitutės;4624191456;Ne;12;4;0;16
5838;"Naminukas (Smėlio g. 13)";Bitutės;4671626416;Ne;0;5;0;5
5839;"Naminukas (Smėlio g. 13)";Bitutės;4941814027;Ne;0;2;1;3
5840;"Naminukas (Smėlio g. 13)";Bitutės;2179061425;Ne;0;2;0;2
5841;"Naminukas (Smėlio g. 13)";Bitutės;2270868598;Ne;0;5;0;5
5842;"Naminukas (Smėlio g. 13)";Bitutės;1095955939;Ne;0;2;0;2
5843;"Naminukas (Smėlio g. 13)";Bitutės;4422173848;Ne;13;0;1;14
5844;"Naminukas (Smėlio g. 13)";Bitutės;5741698937;Ne;0;4;0;4
5845;"Naminukas (Smėlio g. 13)";Bitutės;7717132979;Ne;0;6;0;6
5846;"Naminukas (Smėlio g. 13)";Bitutės;3355811632;Ne;0;0;1;1
5847;"Naminukas (Smėlio g. 13)";Bitutės;9357758815;Ne;0;0;2;2
5848;"Naminukas (Smėlio g. 13)";Bitutės;7807791056;Ne;5;2;3;10
5849;"Naminukas (Smėlio g. 13)";Bitutės;1217359876;Ne;6;6;0;12
5850;"Naminukas (Smėlio g. 13)";Bitutės;5465843371;Ne;2;6;0;8
5851;"Naminukas (Smėlio g. 13)";Bitutės;3550698982;Ne;0;4;2;6
5852;"Naminukas (Smėlio g. 13)";Paukšteliai;3501921619;Ne;0;2;0;2
5853;"Naminukas (Smėlio g. 13)";Paukšteliai;7297661383;Ne;0;2;2;4
5854;"Naminukas (Smėlio g. 13)";Paukšteliai;5056487802;Ne;2;4;0;6
5855;"Naminukas (Smėlio g. 13)";Paukšteliai;3438010199;Ne;0;0;8;8
5856;"Naminukas (Smėlio g. 13)";Paukšteliai;4998565160;Ne;0;5;0;5
5857;"Naminukas (Smėlio g. 13)";Paukšteliai;9405784626;Ne;0;3;8;11
5858;"Naminukas (Smėlio g. 13)";Paukšteliai;2583886896;Ne;0;4;0;4
5859;"Naminukas (Smėlio g. 13)";Paukšteliai;4778385421;Ne;0;0;10;10
5860;"Naminukas (Smėlio g. 13)";Paukšteliai;6178500478;Ne;0;4;1;5
5861;"Naminukas (Smėlio g. 13)";Paukšteliai;9440685520;Ne;0;3;0;3
5862;"Naminukas (Smėlio g. 13)";Paukšteliai;1406418130;Ne;0;0;4;4
5863;"Naminukas (Smėlio g. 13)";Paukšteliai;2012656186;Ne;0;0;5;5
5864;"Naminukas (Smėlio g. 13)";Paukšteliai;8470716196;Ne;0;4;1;5
5865;"Naminukas (Smėlio g. 13)";Paukšteliai;3727828033;Ne;0;4;0;4
5866;"Naminukas (Smėlio g. 13)";Paukšteliai;2652538212;Ne;0;2;0;2
5867;"Naminukas (Smėlio g. 13)";Paukšteliai;5280419144;Ne;0;2;0;2
5868;"Naminukas (Smėlio g. 13)";Paukšteliai;7107752795;Ne;0;6;0;6
5869;"Naminukas (Smėlio g. 13)";Paukšteliai;3018465520;Ne;0;9;0;9
5870;"Naminukas (Smėlio g. 13)";Paukšteliai;2551242973;Ne;0;4;4;8
5871;"Naminukas (Smėlio g. 13)";Paukšteliai;2113378945;Ne;0;5;0;5
5872;"Naminukas (Smėlio g. 13)";Paukšteliai;7450368045;Ne;0;5;0;5
5873;"Naminukas (Smėlio g. 13)";"NYKŠTUKAI ";7646186458;Ne;0;4;0;4
5874;"Naminukas (Smėlio g. 13)";"NYKŠTUKAI ";5519447152;Ne;0;5;0;5
5875;"Naminukas (Smėlio g. 13)";"NYKŠTUKAI ";1286329245;Ne;1;11;0;12
5876;"Naminukas (Smėlio g. 13)";"NYKŠTUKAI ";1618802271;Ne;7;0;1;8
5877;"Naminukas (Smėlio g. 13)";"NYKŠTUKAI ";1591540165;Ne;13;0;0;13
5878;"Naminukas (Smėlio g. 13)";"NYKŠTUKAI ";1118193598;Ne;0;0;3;3
5879;"Naminukas (Smėlio g. 13)";"NYKŠTUKAI ";2168486597;Ne;0;0;4;4
5880;"Naminukas (Smėlio g. 13)";"NYKŠTUKAI ";5498798560;Ne;0;0;1;1
5881;"Naminukas (Smėlio g. 13)";"NYKŠTUKAI ";5984789325;Ne;0;7;0;7
5882;"Naminukas (Smėlio g. 13)";"NYKŠTUKAI ";9891722891;Ne;0;5;0;5
5883;"Naminukas (Smėlio g. 13)";"NYKŠTUKAI ";7703842464;Ne;7;0;0;7
5884;"Naminukas (Smėlio g. 13)";"NYKŠTUKAI ";9518670147;Ne;4;0;2;6
5885;Nykštukas;SMAGURIAI;1148800623;Ne;1;0;0;1
5886;Nykštukas;SMAGURIAI;7320458031;Ne;5;4;0;9
5887;Nykštukas;SMAGURIAI;7432373335;Ne;0;4;0;4
5888;Nykštukas;SMAGURIAI;6337924089;Ne;11;3;0;14
5889;Nykštukas;SMAGURIAI;2748970206;Ne;6;4;0;10
5890;Nykštukas;SMAGURIAI;3441133631;Ne;0;8;0;8
5891;Nykštukas;SMAGURIAI;7562216310;Ne;0;7;0;7
5892;Nykštukas;SMAGURIAI;6594118834;Ne;12;0;0;12
5893;Nykštukas;SMAGURIAI;2455221957;Ne;0;4;0;4
5894;Nykštukas;SMAGURIAI;5429377807;Ne;5;4;0;9
5895;Nykštukas;SMAGURIAI;4071479304;Ne;7;3;0;10
5896;Nykštukas;SMAGURIAI;2910587300;Ne;5;4;0;9
5897;Nykštukas;SMAGURIAI;2770385957;Ne;5;4;2;11
5898;Nykštukas;SMAGURIAI;2052451745;Ne;0;3;0;3
5899;Nykštukas;SMAGURIAI;8695794490;Ne;12;4;0;16
5900;Nykštukas;SMAGURIAI;5085577592;Ne;0;2;0;2
5901;Nykštukas;SMAGURIAI;5281616311;Ne;5;4;0;9
5902;Nykštukas;SMAGURIAI;8372380734;Ne;6;1;1;8
5903;Nykštukas;SMAGURIAI;6672148719;Ne;4;6;0;10
5904;Nykštukas;SMAGURIAI;9790322329;Ne;0;5;0;5
5905;Nykštukas;SMAGURIAI;5718555692;Ne;10;4;0;14
5906;Nykštukas;SMAGURIAI;7564154155;Ne;4;2;0;6
5907;Nykštukas;SMALSIUKAI;6285425127;Ne;12;1;0;13
5908;Nykštukas;SMALSIUKAI;6786896381;Ne;0;1;0;1
5909;Nykštukas;SMALSIUKAI;4490310109;Ne;0;8;0;8
5910;Nykštukas;SMALSIUKAI;2947976429;Taip;5;0;0;5
5911;Nykštukas;SMALSIUKAI;6883272732;Ne;15;0;0;15
5912;Nykštukas;SMALSIUKAI;8919778025;Ne;0;9;0;9
5913;Nykštukas;SMALSIUKAI;8827094160;Ne;0;4;1;5
5914;Nykštukas;SMALSIUKAI;9887096503;Ne;0;4;0;4
5915;Nykštukas;SMALSIUKAI;4323166473;Ne;0;6;0;6
5916;Nykštukas;SMALSIUKAI;4622095064;Taip;13;4;0;17
5917;Nykštukas;SMALSIUKAI;4955003100;Ne;19;0;0;19
5918;Nykštukas;SMALSIUKAI;5103512898;Ne;8;0;0;8
5919;Nykštukas;SMALSIUKAI;8667489439;Ne;0;4;0;4
5920;Nykštukas;SMALSIUKAI;7603500691;Ne;2;4;0;6
5921;Nykštukas;SMALSIUKAI;6563871327;Ne;2;5;0;7
5922;Nykštukas;SMALSIUKAI;8819485547;Ne;10;2;1;13
5923;Nykštukas;SMALSIUKAI;5010715255;Ne;5;4;0;9
5924;Nykštukas;SMALSIUKAI;8047072198;Taip;3;4;0;7
5925;Nykštukas;SMALSIUKAI;4499337321;Ne;8;0;0;8
5926;Nykštukas;SMALSIUKAI;4445045176;Ne;6;5;0;11
5927;Nykštukas;SMALSIUKAI;5359280641;Ne;0;4;0;4
5928;Nykštukas;AITVARIUKAI;6923345088;Ne;5;4;0;9
5929;Nykštukas;AITVARIUKAI;8580777381;Ne;0;3;0;3
5930;Nykštukas;AITVARIUKAI;9319066179;Ne;7;4;0;11
5931;Nykštukas;AITVARIUKAI;2177539882;Ne;6;9;0;15
5932;Nykštukas;AITVARIUKAI;9595654681;Ne;10;6;0;16
5933;Nykštukas;AITVARIUKAI;9894698453;Ne;0;5;0;5
5934;Nykštukas;AITVARIUKAI;6351178752;Ne;2;2;0;4
5935;Nykštukas;AITVARIUKAI;2232317366;Ne;10;3;0;13
5936;Nykštukas;AITVARIUKAI;7332769878;Taip;4;1;0;5
5937;Nykštukas;AITVARIUKAI;7896338372;Ne;10;1;0;11
5938;Nykštukas;AITVARIUKAI;2208319289;Ne;0;5;0;5
5939;Nykštukas;AITVARIUKAI;5285669371;Ne;2;4;0;6
5940;Nykštukas;AITVARIUKAI;8548820023;Ne;8;5;0;13
5941;Nykštukas;AITVARIUKAI;9545178064;Ne;15;0;0;15
5942;Nykštukas;AITVARIUKAI;3561627809;Ne;5;0;0;5
5943;Nykštukas;AITVARIUKAI;5972246871;Ne;5;6;0;11
5944;Nykštukas;AITVARIUKAI;5538446312;Ne;10;0;0;10
5945;Nykštukas;AITVARIUKAI;4822304386;Ne;6;0;0;6
5946;Nykštukas;AITVARIUKAI;4177690371;Ne;0;2;1;3
5947;Nykštukas;AITVARIUKAI;5292127770;Ne;0;4;0;4
5948;Nykštukas;DAINORĖLIAI;7730918105;Ne;11;0;0;11
5949;Nykštukas;DAINORĖLIAI;8475127245;Ne;12;0;0;12
5950;Nykštukas;DAINORĖLIAI;5434220008;Ne;4;0;0;4
5951;Nykštukas;DAINORĖLIAI;1122600949;Ne;4;0;0;4
5952;Nykštukas;DAINORĖLIAI;3853935568;Ne;0;5;0;5
5953;Nykštukas;DAINORĖLIAI;9776630115;Ne;0;5;0;5
5954;Nykštukas;DAINORĖLIAI;9524639831;Ne;13;0;0;13
5955;Nykštukas;DAINORĖLIAI;3367348573;Ne;0;8;0;8
5956;Nykštukas;DAINORĖLIAI;5961945345;Ne;11;1;0;12
5957;Nykštukas;DAINORĖLIAI;6561696818;Ne;9;0;0;9
5958;Nykštukas;DAINORĖLIAI;1283453188;Ne;8;0;0;8
5959;Nykštukas;DAINORĖLIAI;1167614164;Ne;8;2;0;10
5960;Nykštukas;DAINORĖLIAI;7473124310;Taip;7;0;0;7
5961;Nykštukas;DAINORĖLIAI;1174618721;Ne;0;4;0;4
5962;Nykštukas;DAINORĖLIAI;8681884252;Ne;8;4;0;12
5963;Nykštukas;DAINORĖLIAI;5255726742;Ne;10;2;0;12
5964;Nykštukas;DAINORĖLIAI;9027355399;Ne;4;10;0;14
5965;Nykštukas;DAINORĖLIAI;4893494144;Ne;9;6;0;15
5966;Nykštukas;DAINORĖLIAI;8318089070;Ne;7;1;0;8
5967;Nykštukas;DAINORĖLIAI;2727074729;Ne;0;10;0;10
5968;Nykštukas;DAINORĖLIAI;9437700329;Ne;8;4;0;12
5969;Nykštukas;POKŠTUKAI;7382271765;Ne;5;4;0;9
5970;Nykštukas;POKŠTUKAI;1655428422;Ne;1;4;0;5
5971;Nykštukas;POKŠTUKAI;2649916049;Ne;5;6;0;11
5972;Nykštukas;POKŠTUKAI;1796016501;Ne;15;4;0;19
5973;Nykštukas;POKŠTUKAI;5958711585;Ne;7;5;0;12
5974;Nykštukas;POKŠTUKAI;3999004312;Ne;2;5;0;7
5975;Nykštukas;POKŠTUKAI;6719999304;Ne;6;6;0;12
5976;Nykštukas;POKŠTUKAI;8148163137;Ne;0;7;0;7
5977;Nykštukas;POKŠTUKAI;8708184278;Taip;6;4;0;10
5978;Nykštukas;POKŠTUKAI;5699671696;Ne;0;4;0;4
5979;Nykštukas;POKŠTUKAI;3843163586;Ne;0;7;0;7
5980;Nykštukas;POKŠTUKAI;1316018865;Ne;0;4;0;4
5981;Nykštukas;POKŠTUKAI;3507649457;Taip;3;4;0;7
5982;Nykštukas;POKŠTUKAI;3428031037;Ne;4;4;0;8
5983;Nykštukas;POKŠTUKAI;4508625009;Ne;0;4;0;4
5984;Nykštukas;POKŠTUKAI;6698622575;Ne;0;7;0;7
5985;Nykštukas;POKŠTUKAI;2982662650;Ne;0;7;0;7
5986;Nykštukas;POKŠTUKAI;2627736026;Ne;0;15;0;15
5987;Nykštukas;POKŠTUKAI;4401103119;Ne;5;8;0;13
5988;Nykštukas;POKŠTUKAI;5287713634;Ne;0;4;0;4
5989;Nykštukas;POKŠTUKAI;9703895923;Ne;9;4;0;13
5990;Nykštukas;KODĖLČIUKAI;8168579152;Ne;0;4;3;7
5991;Nykštukas;KODĖLČIUKAI;9285820767;Ne;0;4;0;4
5992;Nykštukas;KODĖLČIUKAI;2685400939;Ne;4;4;1;9
5993;Nykštukas;KODĖLČIUKAI;3278960733;Ne;4;3;1;8
5994;Nykštukas;KODĖLČIUKAI;5934979528;Ne;0;4;0;4
5995;Nykštukas;KODĖLČIUKAI;3760617860;Ne;0;1;15;16
5996;Nykštukas;KODĖLČIUKAI;6927545099;Ne;0;8;0;8
5997;Nykštukas;KODĖLČIUKAI;8042479133;Ne;5;3;0;8
5998;Nykštukas;KODĖLČIUKAI;6345791450;Ne;6;3;0;9
5999;Nykštukas;KODĖLČIUKAI;6999380958;Ne;5;1;0;6
6000;Nykštukas;KODĖLČIUKAI;6794885966;Ne;1;4;0;5
6001;Nykštukas;KODĖLČIUKAI;7616459970;Ne;7;4;0;11
6002;Nykštukas;KODĖLČIUKAI;2623254163;Taip;15;0;0;15
6003;Nykštukas;KODĖLČIUKAI;9296449928;Ne;13;4;0;17
6004;Nykštukas;KODĖLČIUKAI;2992219360;Ne;19;0;0;19
6005;Nykštukas;KODĖLČIUKAI;4667303597;Ne;1;4;0;5
6006;Nykštukas;KODĖLČIUKAI;8804969886;Ne;0;2;1;3
6007;Nykštukas;KODĖLČIUKAI;3552386621;Ne;0;4;0;4
6008;Nykštukas;KODĖLČIUKAI;3990260342;Ne;5;1;0;6
6009;Nykštukas;KODĖLČIUKAI;2692551262;Ne;0;4;0;4
6010;Nykštukas;KODĖLČIUKAI;6607025451;Ne;0;6;0;6
6011;Nykštukas;PASAKORIAI;2661110617;Ne;0;6;0;6
6012;Nykštukas;PASAKORIAI;3040001373;Ne;0;5;0;5
6013;Nykštukas;PASAKORIAI;1855278809;Ne;0;5;0;5
6014;Nykštukas;PASAKORIAI;8640715657;Ne;0;13;0;13
6015;Nykštukas;PASAKORIAI;5504584349;Ne;0;6;0;6
6016;Nykštukas;PASAKORIAI;7990462246;Ne;4;5;0;9
6017;Nykštukas;PASAKORIAI;9413198245;Ne;4;2;0;6
6018;Nykštukas;PASAKORIAI;2518342041;Ne;0;4;0;4
6019;Nykštukas;PASAKORIAI;7828733135;Ne;4;3;0;7
6020;Nykštukas;PASAKORIAI;4480184458;Ne;4;2;0;6
6021;Nykštukas;PASAKORIAI;4090494707;Ne;6;0;0;6
6022;Nykštukas;PASAKORIAI;3026598985;Ne;5;0;0;5
6023;Nykštukas;PASAKORIAI;9714310539;Taip;10;4;0;14
6024;Nykštukas;PASAKORIAI;4795301170;Ne;7;4;0;11
6025;Nykštukas;PASAKORIAI;1579064341;Taip;17;0;0;17
6026;Nykštukas;PASAKORIAI;4992654449;Ne;6;3;0;9
6027;Nykštukas;PASAKORIAI;5337728911;Ne;13;0;1;14
6028;Nykštukas;PASAKORIAI;9509051946;Taip;0;4;0;4
6029;Nykštukas;PASAKORIAI;3496434361;Ne;0;4;0;4
6030;Nykštukas;GUDRUČIAI;9871410323;Ne;0;4;0;4
6031;Nykštukas;GUDRUČIAI;4559818614;Ne;0;4;0;4
6032;Nykštukas;GUDRUČIAI;9250827058;Ne;0;3;0;3
6033;Nykštukas;GUDRUČIAI;7447202642;Ne;0;5;0;5
6034;Nykštukas;GUDRUČIAI;1714708754;Ne;0;4;0;4
6035;Nykštukas;GUDRUČIAI;5157799354;Ne;0;11;0;11
6036;Nykštukas;GUDRUČIAI;4325369395;Ne;8;4;0;12
6037;Nykštukas;GUDRUČIAI;6630804505;Ne;0;13;0;13
6038;Nykštukas;GUDRUČIAI;8363202198;Ne;0;4;0;4
6039;Nykštukas;GUDRUČIAI;7326535810;Ne;0;9;0;9
6040;Nykštukas;GUDRUČIAI;9712596180;Ne;0;2;0;2
6041;Nykštukas;GUDRUČIAI;9941937734;Ne;0;2;0;2
6042;Nykštukas;GUDRUČIAI;2494482185;Ne;0;1;0;1
6043;Nykštukas;GUDRUČIAI;3619459404;Ne;0;8;0;8
6044;Nykštukas;GUDRUČIAI;1934596739;Ne;0;2;0;2
6045;Nykštukas;GUDRUČIAI;7604740418;Ne;5;4;0;9
6046;Nykštukas;GUDRUČIAI;2970293467;Ne;8;5;0;13
6047;Nykštukas;GUDRUČIAI;2881323571;Ne;0;5;0;5
6048;Nykštukas;GUDRUČIAI;2872277381;Ne;0;4;0;4
6049;Nykštukas;GUDRUČIAI;9940519259;Ne;3;4;0;7
6050;Nykštukas;GUDRUČIAI;9023823445;Ne;0;4;0;4
6051;Nykštukas;GUDRUČIAI;8361758895;Ne;0;4;0;4
6052;Nykštukas;NAMINUKAI;7456007276;Ne;0;2;0;2
6053;Nykštukas;NAMINUKAI;7176519994;Ne;0;1;0;1
6054;Nykštukas;NAMINUKAI;2440574056;Ne;0;2;0;2
6055;Nykštukas;NAMINUKAI;4064016871;Ne;0;5;0;5
6056;Nykštukas;NAMINUKAI;9054070492;Ne;0;3;0;3
6057;Nykštukas;NAMINUKAI;6519078450;Ne;0;1;0;1
6058;Nykštukas;NAMINUKAI;6106373554;Ne;0;4;0;4
6059;Nykštukas;NAMINUKAI;5032283848;Ne;0;4;2;6
6060;Nykštukas;NAMINUKAI;7494444468;Ne;0;3;0;3
6061;Nykštukas;NAMINUKAI;3925958632;Ne;0;3;0;3
6062;Nykštukas;NAMINUKAI;6338717583;Taip;0;5;0;5
6063;Nykštukas;NAMINUKAI;7976689381;Ne;0;2;0;2
6064;Nykštukas;NAMINUKAI;9686815141;Ne;0;5;0;5
6065;Nykštukas;NAMINUKAI;9575291096;Ne;0;7;0;7
6066;Nykštukas;NAMINUKAI;4503830456;Ne;0;8;0;8
6067;Nykštukas;NAMINUKAI;4040123876;Ne;0;11;0;11
6068;Nykštukas;NAMINUKAI;1088633575;Ne;0;4;0;4
6069;Nykštukas;NAMINUKAI;8874850019;Ne;0;13;0;13
6070;Nykštukas;NAMINUKAI;1510338621;Ne;4;3;1;8
6071;Nykštukas;NAMINUKAI;3405633312;Taip;0;2;0;2
6072;Nykštukas;KŪLVERSTUKAI;7078264994;Ne;0;4;0;4
6073;Nykštukas;KŪLVERSTUKAI;3660330885;Ne;0;5;0;5
6074;Nykštukas;KŪLVERSTUKAI;4897443402;Ne;0;4;0;4
6075;Nykštukas;KŪLVERSTUKAI;6778384400;Ne;9;4;0;13
6076;Nykštukas;KŪLVERSTUKAI;6888025109;Ne;11;3;0;14
6077;Nykštukas;KŪLVERSTUKAI;8642152911;Ne;5;4;0;9
6078;Nykštukas;KŪLVERSTUKAI;6071938183;Taip;0;4;0;4
6079;Nykštukas;KŪLVERSTUKAI;7310647095;Ne;3;5;0;8
6080;Nykštukas;KŪLVERSTUKAI;6693597888;Ne;0;4;0;4
6081;Nykštukas;KŪLVERSTUKAI;5297046545;Ne;6;1;0;7
6082;Nykštukas;KŪLVERSTUKAI;8414521116;Ne;2;4;0;6
6083;Nykštukas;KŪLVERSTUKAI;1666098441;Ne;0;5;0;5
6084;Nykštukas;KŪLVERSTUKAI;9177683618;Ne;10;4;0;14
6085;Nykštukas;KŪLVERSTUKAI;1077620433;Ne;7;3;0;10
6086;Nykštukas;KŪLVERSTUKAI;5330663185;Ne;9;0;0;9
6087;Nykštukas;TREPSIUKAI;8701731017;Ne;0;6;0;6
6088;Nykštukas;TREPSIUKAI;8820983001;Ne;4;3;0;7
6089;Nykštukas;TREPSIUKAI;2995258838;Ne;10;4;0;14
6090;Nykštukas;TREPSIUKAI;9484110969;Ne;4;4;0;8
6091;Nykštukas;TREPSIUKAI;1355881784;Ne;6;4;0;10
6092;Nykštukas;TREPSIUKAI;1721306926;Ne;11;4;0;15
6093;Nykštukas;TREPSIUKAI;2974110726;Ne;3;3;0;6
6094;Nykštukas;TREPSIUKAI;7311244803;Ne;0;7;0;7
6095;Nykštukas;TREPSIUKAI;5183022629;Ne;2;1;1;4
6096;Nykštukas;TREPSIUKAI;6298299835;Ne;0;6;0;6
6097;Nykštukas;TREPSIUKAI;2759786932;Ne;4;4;0;8
6098;Nykštukas;TREPSIUKAI;4755908241;Ne;2;2;0;4
6099;Nykštukas;ŽIRNIUKAI;9661862689;Ne;8;4;0;12
6100;Nykštukas;ŽIRNIUKAI;1594734231;Ne;2;4;0;6
6101;Nykštukas;ŽIRNIUKAI;3339707558;Ne;0;3;0;3
6102;Nykštukas;ŽIRNIUKAI;7908029688;Ne;5;4;0;9
6103;Nykštukas;ŽIRNIUKAI;7299329150;Ne;1;4;0;5
6104;Nykštukas;ŽIRNIUKAI;9174636607;Ne;4;1;0;5
6105;Nykštukas;ŽIRNIUKAI;1218443707;Taip;6;4;0;10
6106;Nykštukas;ŽIRNIUKAI;7535385367;Taip;2;3;0;5
6107;Nykštukas;ŽIRNIUKAI;6709760898;Taip;4;3;0;7
6108;Nykštukas;ŽIRNIUKAI;2670682135;Ne;10;2;0;12
6109;Nykštukas;ŽIRNIUKAI;1202614927;Ne;0;3;0;3
6110;Nykštukas;ŽIRNIUKAI;1366524995;Ne;0;3;0;3
6111;Nykštukas;ŽIRNIUKAI;2800783215;Ne;11;4;0;15
6112;Nykštukas;ŽIRNIUKAI;2620150024;Ne;11;4;0;15
6113;Nykštukas;ŽIRNIUKAI;3032028847;Taip;9;4;0;13
6114;Nykštukas;ŽIRNIUKAI;4144437365;Ne;7;4;0;11
6115;Nykštukas;ŽIRNIUKAI;6884714823;Ne;0;2;0;2
6116;Nykštukas;ŽIRNIUKAI;1616644404;Ne;7;4;0;11
6117;Nykštukas;ŽIRNIUKAI;9270615518;Ne;1;4;0;5
6118;Nykštukas;ŽIRNIUKAI;2078586374;Ne;4;3;0;7
6119;Nykštukas;ŽIRNIUKAI;1102203704;Ne;0;1;0;1
6120;Ozas;Smalsučiai;4066900299;Ne;5;0;0;5
6121;Ozas;Smalsučiai;4694561135;Taip;2;0;1;3
6122;Ozas;Smalsučiai;4792735767;Ne;0;5;0;5
6123;Ozas;Smalsučiai;5651665799;Ne;2;0;1;3
6124;Ozas;Smalsučiai;7756424421;Ne;10;0;0;10
6125;Ozas;Smalsučiai;4334162942;Ne;3;0;0;3
6126;Ozas;Smalsučiai;1507372220;Ne;3;0;0;3
6127;Ozas;Smalsučiai;7884934528;Ne;16;0;0;16
6128;Ozas;Smalsučiai;1112829748;Ne;9;0;0;9
6129;Ozas;Smalsučiai;1699412266;Ne;10;0;0;10
6130;Ozas;Smalsučiai;8833452950;Ne;9;0;0;9
6131;Ozas;Smalsučiai;2189280675;Ne;14;0;0;14
6132;Ozas;Smalsučiai;6922447926;Ne;4;0;0;4
6133;Ozas;Smalsučiai;8860029000;Ne;15;0;0;15
6134;Ozas;Smalsučiai;4022390983;Taip;0;0;1;1
6135;Ozas;Smalsučiai;7786745329;Ne;6;0;0;6
6136;Ozas;Smalsučiai;1398871402;Ne;4;0;1;5
6137;Ozas;Drugeliai;6419221599;Taip;3;0;0;3
6138;Ozas;Drugeliai;1866535603;Taip;7;4;1;12
6139;Ozas;Drugeliai;4673128698;Ne;6;0;0;6
6140;Ozas;Drugeliai;7870419810;Ne;0;4;0;4
6141;Ozas;Drugeliai;2869987587;Ne;10;1;0;11
6142;Ozas;Drugeliai;5926100815;Ne;13;1;0;14
6143;Ozas;Drugeliai;9178967858;Ne;4;0;0;4
6144;Ozas;Drugeliai;5677543279;Ne;6;0;0;6
6145;Ozas;Drugeliai;2454569369;Ne;1;3;2;6
6146;Ozas;Drugeliai;8713970306;Ne;3;0;1;4
6147;Ozas;Drugeliai;1803782282;Ne;7;4;0;11
6148;Ozas;Drugeliai;2819545359;Ne;4;0;0;4
6149;Ozas;Drugeliai;3994760698;Ne;14;0;0;14
6150;Ozas;Drugeliai;7922667688;Ne;11;0;0;11
6151;Ozas;Drugeliai;1536889312;Ne;10;0;0;10
6152;Ozas;Drugeliai;8897904793;Ne;10;0;1;11
6153;Ozas;Drugeliai;3723247420;Ne;1;0;2;3
6154;Ozas;Drugeliai;1489355274;Ne;3;4;1;8
6155;Ozas;Drugeliai;9655492678;Ne;6;0;4;10
6156;Ozas;Drugeliai;1062591107;Taip;3;0;2;5
6157;Ozas;Drugeliai;3967307153;Ne;10;0;0;10
6158;Ozas;Boružėlės;3037323341;Ne;5;4;0;9
6159;Ozas;Boružėlės;6346123124;Ne;15;0;0;15
6160;Ozas;Boružėlės;2248812743;Ne;0;0;4;4
6161;Ozas;Boružėlės;3133776891;Ne;9;0;0;9
6162;Ozas;Boružėlės;2139224651;Ne;5;2;0;7
6163;Ozas;Boružėlės;9506090620;Ne;0;4;0;4
6164;Ozas;Boružėlės;5172367556;Ne;0;7;0;7
6165;Ozas;Boružėlės;8923372952;Ne;0;0;3;3
6166;Ozas;Boružėlės;7617839839;Ne;15;4;0;19
6167;Ozas;Boružėlės;6392066805;Ne;7;0;2;9
6168;Ozas;Boružėlės;8781771299;Ne;0;5;0;5
6169;Ozas;Boružėlės;3817138493;Ne;3;4;0;7
6170;Ozas;Boružėlės;8371368881;Ne;9;0;1;10
6171;Ozas;Boružėlės;6476147361;Taip;2;0;0;2
6172;Ozas;Boružėlės;4994121247;Ne;3;4;1;8
6173;Ozas;Boružėlės;3902722274;Ne;4;1;0;5
6174;Ozas;Boružėlės;7585213159;Ne;4;0;0;4
6175;Ozas;Boružėlės;6315443248;Ne;0;4;0;4
6176;Ozas;Boružėlės;3139289643;Ne;0;4;0;4
6177;Ozas;Boružėlės;6186850614;Ne;16;2;0;18
6178;Ozas;Boružėlės;6318419889;Ne;5;4;0;9
6179;Ozas;Boružėlės;7787473586;Ne;4;4;0;8
6180;Ozas;Žiogeliai;7461521320;Ne;3;5;0;8
6181;Ozas;Žiogeliai;6257625501;Ne;0;4;0;4
6182;Ozas;Žiogeliai;7402290524;Ne;0;3;1;4
6183;Ozas;Žiogeliai;1562277866;Ne;0;2;0;2
6184;Ozas;Žiogeliai;4571583671;Ne;0;4;1;5
6185;Ozas;Žiogeliai;5682027094;Ne;3;8;4;15
6186;Ozas;Žiogeliai;4966355020;Ne;0;3;0;3
6187;Ozas;Žiogeliai;9324647606;Ne;0;1;0;1
6188;Ozas;Žiogeliai;9392526836;Ne;0;2;1;3
6189;Ozas;Žiogeliai;4942550213;Ne;2;4;6;12
6190;Ozas;Žiogeliai;8676986286;Ne;0;4;1;5
6191;Ozas;Žiogeliai;2345112767;Ne;2;3;3;8
6192;Ozas;Žiogeliai;5420952391;Ne;0;3;10;13
6193;Ozas;Žiogeliai;9929822317;Ne;0;2;0;2
6194;Ozas;Žiogeliai;2837228320;Ne;5;4;0;9
6195;Ozas;Žiogeliai;2617258206;Ne;0;5;0;5
6196;Ozas;Žiogeliai;4030056504;Ne;1;1;0;2
6197;Ozas;Žiogeliai;5156383727;Ne;0;3;0;3
6198;Ozas;Žiogeliai;3770045761;Ne;0;4;0;4
6199;Ozas;Žiogeliai;9768754737;Ne;0;2;1;3
6200;Ozas;Žiogeliai;7264789334;Ne;9;3;0;12
6201;Ozas;Žiogeliai;7165299220;Ne;0;5;3;8
6202;Ozas;Bitutės;4220780257;Ne;4;4;0;8
6203;Ozas;Bitutės;1161776624;Ne;8;4;0;12
6204;Ozas;Bitutės;4227555342;Ne;0;4;1;5
6205;Ozas;Bitutės;7499756171;Ne;9;4;0;13
6206;Ozas;Bitutės;2705294874;Ne;0;4;0;4
6207;Ozas;Bitutės;2369544599;Ne;0;4;0;4
6208;Ozas;Bitutės;3329391600;Ne;3;4;0;7
6209;Ozas;Bitutės;4254601638;Ne;0;3;0;3
6210;Ozas;Bitutės;4699369567;Ne;0;4;0;4
6211;Ozas;Bitutės;8304671844;Ne;0;1;0;1
6212;Ozas;Bitutės;9772085405;Ne;0;4;1;5
6213;Ozas;Bitutės;7051699003;Ne;2;3;0;5
6214;Ozas;Bitutės;5383877034;Ne;0;4;4;8
6215;Ozas;Bitutės;1117208248;Ne;7;4;0;11
6216;Ozas;Bitutės;6811181735;Ne;12;5;0;17
6217;Ozas;Bitutės;8622621570;Ne;6;4;0;10
6218;Ozas;Bitutės;4260123123;Ne;2;4;0;6
6219;Ozas;Bitutės;7494307084;Ne;1;4;0;5
6220;Ozas;Bitutės;1895519949;Ne;0;1;1;2
6221;Ozas;Bitutės;1475005204;Ne;0;2;0;2
6222;Ozas;Bitutės;5968428143;Ne;5;4;0;9
6223;Ozas;Bitutės;4286058360;Ne;13;4;0;17
6224;Ozas;Aitvarėliai;1144679735;Ne;0;13;0;13
6225;Ozas;Aitvarėliai;2773182934;Ne;7;0;0;7
6226;Ozas;Aitvarėliai;4357737538;Ne;0;4;1;5
6227;Ozas;Aitvarėliai;5642468671;Ne;0;4;0;4
6228;Ozas;Aitvarėliai;1045890394;Ne;9;4;0;13
6229;Ozas;Aitvarėliai;7686706482;Ne;6;5;0;11
6230;Ozas;Aitvarėliai;2395567376;Ne;16;0;0;16
6231;Ozas;Aitvarėliai;5383739203;Ne;5;5;0;10
6232;Ozas;Aitvarėliai;4583818638;Ne;3;0;0;3
6233;Ozas;Aitvarėliai;1543683077;Ne;2;0;0;2
6234;Ozas;Aitvarėliai;2165291778;Ne;0;14;0;14
6235;Ozas;Aitvarėliai;8754244281;Ne;14;1;0;15
6236;Ozas;Aitvarėliai;6646671212;Ne;0;4;0;4
6237;Ozas;Aitvarėliai;9443843603;Ne;5;4;0;9
6238;Ozas;Aitvarėliai;3238019756;Ne;10;5;0;15
6239;Ozas;Aitvarėliai;8987796218;Ne;1;2;0;3
6240;Ozas;Aitvarėliai;3783477511;Ne;1;0;0;1
6241;Ozas;Aitvarėliai;6778987483;Ne;7;1;0;8
6242;Ozas;Aitvarėliai;7009893338;Taip;2;0;1;3
6243;Ozas;Aitvarėliai;4891451748;Ne;0;10;0;10
6244;Ozas;Aitvarėliai;9813020279;Ne;7;3;0;10
6245;Ozas;Aitvarėliai;2922370952;Ne;3;3;0;6
6246;Ozas;Aitvarėliai;2544858937;Ne;0;3;0;3
6247;Ozas;Voveraitės;8178298861;Ne;4;1;0;5
6248;Ozas;Voveraitės;6263062055;Ne;0;3;0;3
6249;Ozas;Voveraitės;9195536968;Ne;0;6;0;6
6250;Ozas;Voveraitės;2991511872;Ne;2;5;0;7
6251;Ozas;Voveraitės;5016547315;Ne;0;2;2;4
6252;Ozas;Voveraitės;1564826076;Ne;0;0;4;4
6253;Ozas;Voveraitės;2511477658;Ne;0;7;0;7
6254;Ozas;Voveraitės;1240233169;Ne;19;0;0;19
6255;Ozas;Voveraitės;6088757991;Ne;0;5;0;5
6256;Ozas;Voveraitės;5822871838;Ne;0;4;0;4
6257;Ozas;Voveraitės;2635045515;Ne;7;2;0;9
6258;Ozas;Voveraitės;6499549095;Ne;3;4;0;7
6259;Ozas;Voveraitės;6666591428;Ne;0;5;0;5
6260;Ozas;Voveraitės;2297650260;Ne;5;4;2;11
6261;Ozas;Voveraitės;7908028909;Ne;0;4;0;4
6262;Ozas;Voveraitės;9762737217;Ne;0;6;0;6
6263;Ozas;Voveraitės;7421484648;Ne;19;0;0;19
6264;Ozas;Voveraitės;1997125531;Taip;0;5;0;5
6265;Ozas;Voveraitės;5751808248;Ne;11;1;0;12
6266;Ozas;Voveraitės;4556076744;Ne;7;0;5;12
6267;Ozas;Voveraitės;8503041003;Ne;0;0;3;3
6268;Ozas;Voveraitės;6053885086;Ne;0;5;0;5
6269;Ozas;Voveraitės;7978092840;Ne;8;3;0;11
6270;Ozas;Kodelčiukai;8743467101;Ne;0;4;0;4
6271;Ozas;Kodelčiukai;2964318343;Ne;1;4;0;5
6272;Ozas;Kodelčiukai;8696127374;Ne;0;2;0;2
6273;Ozas;Kodelčiukai;3704303636;Ne;6;5;0;11
6274;Ozas;Kodelčiukai;2573702751;Ne;0;4;0;4
6275;Ozas;Kodelčiukai;3412369198;Ne;5;4;0;9
6276;Ozas;Kodelčiukai;2951875705;Ne;0;2;0;2
6277;Ozas;Kodelčiukai;7305274617;Ne;9;0;0;9
6278;Ozas;Kodelčiukai;9306887706;Ne;9;5;0;14
6279;Ozas;Kodelčiukai;9084187344;Ne;0;3;0;3
6280;Ozas;Kodelčiukai;1348751454;Ne;9;3;0;12
6281;Ozas;Kodelčiukai;9322080266;Ne;8;3;0;11
6282;Ozas;Kodelčiukai;6809992664;Taip;0;8;0;8
6283;Ozas;Kodelčiukai;4516291572;Ne;9;0;0;9
6284;Ozas;Kodelčiukai;4287719751;Ne;4;7;0;11
6285;Ozas;Kodelčiukai;9620747099;Ne;11;3;0;14
6286;Ozas;Kodelčiukai;5216695220;Ne;0;5;0;5
6287;Ozas;Kodelčiukai;8779047802;Ne;0;2;1;3
6288;Ozas;Kodelčiukai;6783755555;Taip;0;6;0;6
6289;Ozas;Kodelčiukai;8222112564;Ne;0;5;0;5
6290;Ozas;Kodelčiukai;8797919230;Ne;8;1;0;9
6291;Ozas;Kodelčiukai;4573329075;Taip;17;0;0;17
6292;Ozas;Pelėdžiukai;4640897674;Ne;0;3;0;3
6293;Ozas;Pelėdžiukai;9277208213;Ne;3;2;0;5
6294;Ozas;Pelėdžiukai;8040293681;Ne;0;4;0;4
6295;Ozas;Pelėdžiukai;1856258542;Ne;3;1;1;5
6296;Ozas;Pelėdžiukai;5922569280;Ne;6;4;0;10
6297;Ozas;Pelėdžiukai;7640409923;Ne;1;4;0;5
6298;Ozas;Pelėdžiukai;4601869799;Ne;4;5;0;9
6299;Ozas;Pelėdžiukai;5958055645;Ne;0;3;1;4
6300;Ozas;Pelėdžiukai;7125754645;Ne;0;4;1;5
6301;Ozas;Pelėdžiukai;2824133388;Ne;5;4;0;9
6302;Ozas;Pelėdžiukai;2637531106;Ne;0;5;0;5
6303;Ozas;Pelėdžiukai;7287989663;Ne;0;4;0;4
6304;Ozas;Pelėdžiukai;6819000895;Ne;0;3;0;3
6305;Ozas;Pelėdžiukai;5950860889;Ne;1;4;1;6
6306;Ozas;Pelėdžiukai;4886045470;Ne;0;4;0;4
6307;Ozas;Pelėdžiukai;3212050416;Ne;0;4;0;4
6308;Ozas;Pelėdžiukai;3725141591;Ne;0;1;0;1
6309;Ozas;Pelėdžiukai;3711403511;Ne;0;6;0;6
6310;Ozas;Pelėdžiukai;5392929222;Ne;19;0;0;19
6311;Ozas;Pelėdžiukai;7038928164;Taip;3;5;1;9
6312;Ozas;Pelėdžiukai;2281337233;Taip;3;2;2;7
6313;Ozas;Pelėdžiukai;4247941696;Ne;0;1;0;1
6314;Ozas;Pelėdžiukai;9334268998;Ne;5;0;1;6
6315;Ozas;"Kačiukai ";4857216527;Ne;12;0;0;12
6316;Ozas;"Kačiukai ";7776754188;Ne;17;0;0;17
6317;Ozas;"Kačiukai ";5097380041;Taip;15;0;0;15
6318;Ozas;"Kačiukai ";3109261153;Ne;9;4;0;13
6319;Ozas;"Kačiukai ";9781398468;Ne;13;0;0;13
6320;Ozas;"Kačiukai ";8488500486;Ne;4;0;0;4
6321;Ozas;"Kačiukai ";4595986358;Ne;10;4;0;14
6322;Ozas;"Kačiukai ";5421245991;Ne;7;4;0;11
6323;Ozas;"Kačiukai ";9781527964;Ne;9;5;0;14
6324;Ozas;"Kačiukai ";9496746778;Ne;0;0;1;1
6325;Ozas;"Kačiukai ";4514798132;Ne;19;0;0;19
6326;Ozas;"Kačiukai ";2729524188;Ne;9;0;1;10
6327;Ozas;"Kačiukai ";2522810593;Ne;6;0;0;6
6328;Ozas;"Kačiukai ";6456146804;Ne;0;0;3;3
6329;Ozas;"Kačiukai ";3269417874;Ne;1;1;1;3
6330;Ozas;"Kačiukai ";5866709636;Ne;8;6;0;14
6331;Ozas;"Kačiukai ";6632795981;Ne;10;0;1;11
6332;Ozas;"Kačiukai ";2599175140;Ne;14;0;0;14
6333;Ozas;"Kačiukai ";2030429825;Taip;13;4;0;17
6334;Ozas;"Kačiukai ";7885855133;Ne;17;0;0;17
6335;Ozas;"Kačiukai ";5761120671;Ne;7;0;0;7
6336;Ozas;Ančiukų;3472468379;Ne;12;0;0;12
6337;Ozas;Ančiukų;6512655578;Ne;19;0;0;19
6338;Ozas;Ančiukų;1092988354;Ne;13;0;0;13
6339;Ozas;Ančiukų;5811261087;Ne;9;0;0;9
6340;Ozas;Ančiukų;4424628807;Ne;11;0;0;11
6341;Ozas;Ančiukų;4347607193;Taip;5;0;0;5
6342;Ozas;Ančiukų;6894358457;Ne;10;0;0;10
6343;Ozas;Ančiukų;1671756798;Ne;1;0;0;1
6344;Ozas;Ančiukų;5163358861;Ne;14;0;0;14
6345;Ozas;Ančiukų;6653963888;Ne;10;0;0;10
6346;Ozas;Ančiukų;7611417346;Ne;12;0;0;12
6347;Ozas;Ančiukų;6305438823;Ne;12;0;0;12
6348;Ozas;Ančiukų;4941588023;Ne;5;0;0;5
6349;Ozas;Ančiukų;8772165816;Ne;16;0;0;16
6350;Ozas;Ančiukų;4910534724;Ne;6;0;0;6
6351;Ozas;Nykškukų;9319720476;Ne;0;3;0;3
6352;Ozas;Nykškukų;3540922740;Ne;8;1;0;9
6353;Ozas;Nykškukų;2794839285;Ne;5;4;0;9
6354;Ozas;Nykškukų;2326431805;Ne;0;5;0;5
6355;Ozas;Nykškukų;2334870680;Ne;7;0;0;7
6356;Ozas;Nykškukų;7005571081;Ne;7;0;0;7
6357;Ozas;Nykškukų;1760627703;Ne;3;0;0;3
6358;Ozas;Nykškukų;5126356120;Ne;17;0;0;17
6359;Ozas;Nykškukų;2490578190;Ne;12;4;0;16
6360;Ozas;Nykškukų;3310335918;Ne;12;0;0;12
6361;Ozas;Nykškukų;7789232957;Ne;9;0;0;9
6362;Ozas;Nykškukų;2531635671;Ne;2;1;0;3
6363;Ozas;Nykškukų;7556190089;Taip;0;3;0;3
6364;Ozas;Nykškukų;9685593404;Ne;10;0;0;10
6365;Ozas;Nykškukų;5008732127;Ne;2;2;0;4
6366;Pabiručiai;Voveriukų;4539246865;Taip;0;7;0;7
6367;Pabiručiai;Voveriukų;1498738549;Ne;0;4;0;4
6368;Pabiručiai;Voveriukų;2349337471;Ne;0;3;0;3
6369;Pabiručiai;Voveriukų;9564303781;Ne;6;3;1;10
6370;Pabiručiai;Voveriukų;4312364951;Ne;0;4;0;4
6371;Pabiručiai;Voveriukų;3756731363;Ne;2;3;0;5
6372;Pabiručiai;Voveriukų;7985360502;Ne;0;2;0;2
6373;Pabiručiai;Voveriukų;3936426174;Ne;0;4;2;6
6374;Pabiručiai;Voveriukų;4069564285;Ne;3;4;0;7
6375;Pabiručiai;Voveriukų;7278334800;Ne;0;5;0;5
6376;Pabiručiai;Voveriukų;9468698553;Ne;0;3;1;4
6377;Pabiručiai;Voveriukų;5232678556;Ne;0;3;0;3
6378;Pabiručiai;Voveriukų;7066037017;Ne;10;4;0;14
6379;Pabiručiai;Voveriukų;5549851164;Ne;0;2;0;2
6380;Pabiručiai;Voveriukų;4040533883;Ne;0;7;0;7
6381;Pabiručiai;Voveriukų;2514312233;Ne;0;6;0;6
6382;Pabiručiai;Voveriukų;7606274875;Ne;0;6;0;6
6383;Pabiručiai;Voveriukų;9356327400;Ne;0;4;0;4
6384;Pabiručiai;Voveriukų;4813206044;Ne;15;4;0;19
6385;Pabiručiai;Voveriukų;7846758352;Ne;0;2;0;2
6386;Pabiručiai;Boružiukų;6401188653;Ne;0;3;0;3
6387;Pabiručiai;Boružiukų;1673473814;Ne;0;6;0;6
6388;Pabiručiai;Boružiukų;5686769648;Ne;6;6;2;14
6389;Pabiručiai;Boružiukų;7524993271;Ne;0;5;0;5
6390;Pabiručiai;Boružiukų;5708597471;Ne;0;4;0;4
6391;Pabiručiai;Boružiukų;4006783343;Ne;5;1;0;6
6392;Pabiručiai;Boružiukų;7046122545;Ne;0;5;0;5
6393;Pabiručiai;Boružiukų;3096466200;Ne;0;6;0;6
6394;Pabiručiai;Boružiukų;4301904533;Ne;0;4;0;4
6395;Pabiručiai;Boružiukų;8175565139;Ne;0;3;0;3
6396;Pabiručiai;Boružiukų;8236964683;Ne;0;6;0;6
6397;Pabiručiai;Boružiukų;1240057541;Ne;0;2;0;2
6398;Pabiručiai;Boružiukų;1671027282;Ne;2;10;0;12
6399;Pabiručiai;Boružiukų;3759350345;Ne;0;6;0;6
6400;Pabiručiai;Boružiukų;3151360288;Ne;0;4;0;4
6401;Pabiručiai;Boružiukų;9299393363;Ne;0;9;0;9
6402;Pabiručiai;Boružiukų;1484291546;Ne;0;4;0;4
6403;Pabiručiai;Boružiukų;2771769336;Ne;0;7;0;7
6404;Pabiručiai;Boružiukų;2607840684;Ne;2;4;0;6
6405;Pabiručiai;Boružiukų;4681771534;Ne;0;4;0;4
6406;Pabiručiai;Boružiukų;7050339198;Ne;5;4;0;9
6407;Pabiručiai;Boružiukų;4798503931;Ne;10;3;1;14
6408;Pabiručiai;Boružiukų;1429061018;Ne;0;4;0;4
6409;Pabiručiai;Katinėlių;8649685325;Ne;0;0;3;3
6410;Pabiručiai;Katinėlių;5737214746;Ne;2;4;0;6
6411;Pabiručiai;Katinėlių;4929129093;Ne;4;10;0;14
6412;Pabiručiai;Katinėlių;2141365015;Ne;19;0;0;19
6413;Pabiručiai;Katinėlių;7914642744;Ne;4;0;0;4
6414;Pabiručiai;Katinėlių;1099080685;Ne;6;13;0;19
6415;Pabiručiai;Katinėlių;3011601512;Taip;0;0;2;2
6416;Pabiručiai;Katinėlių;4852287574;Ne;0;0;3;3
6417;Pabiručiai;Katinėlių;3826505104;Taip;0;0;3;3
6418;Pabiručiai;Katinėlių;6678717039;Ne;0;6;1;7
6419;Pabiručiai;Katinėlių;7798837336;Ne;0;6;0;6
6420;Pabiručiai;Katinėlių;7339565412;Ne;11;0;0;11
6421;Pabiručiai;Katinėlių;6742744014;Ne;0;8;0;8
6422;Pabiručiai;Katinėlių;1206012259;Ne;0;3;0;3
6423;Pabiručiai;Katinėlių;9790360371;Ne;3;1;1;5
6424;Pabiručiai;Katinėlių;9890225918;Ne;0;6;0;6
6425;Pabiručiai;Katinėlių;7980170279;Ne;0;0;2;2
6426;Pabiručiai;Katinėlių;5923385276;Ne;5;4;1;10
6427;Pabiručiai;Katinėlių;1138743823;Ne;0;7;0;7
6428;Pabiručiai;Katinėlių;1652633130;Ne;5;0;3;8
6429;Pabiručiai;Katinėlių;9813153308;Ne;14;0;1;15
6430;Pabiručiai;Katinėlių;6508093808;Ne;0;10;0;10
6431;Pabiručiai;Žiogelių;3531292373;Ne;0;3;0;3
6432;Pabiručiai;Žiogelių;1247522345;Ne;14;0;0;14
6433;Pabiručiai;Žiogelių;9878655387;Ne;5;4;0;9
6434;Pabiručiai;Žiogelių;8092886420;Ne;6;6;0;12
6435;Pabiručiai;Žiogelių;4012537474;Ne;5;0;0;5
6436;Pabiručiai;Žiogelių;7561916887;Ne;4;0;0;4
6437;Pabiručiai;Žiogelių;9651695086;Ne;10;2;0;12
6438;Pabiručiai;Žiogelių;5050966784;Ne;7;0;0;7
6439;Pabiručiai;Žiogelių;3262687187;Ne;0;1;0;1
6440;Pabiručiai;Žiogelių;4096412988;Ne;4;0;0;4
6441;Pabiručiai;Žiogelių;4876140467;Ne;10;4;0;14
6442;Pabiručiai;Žiogelių;5862643827;Ne;5;4;0;9
6443;Pabiručiai;Žiogelių;6014791534;Ne;9;0;0;9
6444;Pabiručiai;Žiogelių;5704073222;Ne;7;5;0;12
6445;Pabiručiai;Žiogelių;5019580409;Taip;5;4;0;9
6446;Pabiručiai;Žiogelių;8870657682;Ne;4;0;0;4
6447;Pabiručiai;Žiogelių;2924005478;Ne;14;0;0;14
6448;Pabiručiai;Žiogelių;8668524776;Ne;0;5;0;5
6449;Pabiručiai;Žiogelių;6513943228;Ne;12;0;0;12
6450;Pabiručiai;Žiogelių;4755427277;Ne;9;0;0;9
6451;Pabiručiai;Žiogelių;5184688482;Ne;1;0;0;1
6452;Pabiručiai;Žiogelių;7873575929;Ne;8;0;0;8
6453;Pabiručiai;Smalsiukai;2869383175;Ne;2;5;0;7
6454;Pabiručiai;Smalsiukai;7677235214;Ne;0;10;0;10
6455;Pabiručiai;Smalsiukai;9676561758;Ne;1;10;0;11
6456;Pabiručiai;Smalsiukai;7090116276;Ne;0;8;0;8
6457;Pabiručiai;Smalsiukai;4408666547;Ne;0;8;3;11
6458;Pabiručiai;Smalsiukai;9093137227;Ne;3;10;0;13
6459;Pabiručiai;Smalsiukai;6935913132;Ne;0;10;0;10
6460;Pabiručiai;Smalsiukai;1344711015;Ne;5;5;0;10
6461;Pabiručiai;Smalsiukai;7663581089;Ne;1;7;2;10
6462;Pabiručiai;Smalsiukai;7248314871;Ne;0;2;0;2
6463;Pabiručiai;Smalsiukai;9610623364;Ne;0;13;0;13
6464;Pabiručiai;Smalsiukai;8897462614;Ne;4;5;0;9
6465;Pabiručiai;Smalsiukai;2332338995;Ne;6;9;0;15
6466;Pabiručiai;Smalsiukai;4258226042;Ne;0;11;0;11
6467;Pabiručiai;Smalsiukai;3511851810;Ne;0;11;0;11
6468;Pabiručiai;Smalsiukai;6686039601;Ne;6;9;2;17
6469;Pabiručiai;Smalsiukai;5420231066;Ne;10;2;0;12
6470;Pabiručiai;Smalsiukai;8840885039;Ne;0;4;1;5
6471;Pabiručiai;Smalsiukai;9779260044;Ne;0;5;0;5
6472;Pabiručiai;Smalsiukai;2771891999;Ne;0;3;0;3
6473;Pabiručiai;Smalsiukai;7295052694;Ne;0;5;0;5
6474;Pabiručiai;Smalsiukai;6834663627;Ne;2;10;0;12
6475;Pabiručiai;Kiškučiai;3368607302;Ne;5;3;0;8
6476;Pabiručiai;Kiškučiai;9589005897;Ne;9;5;0;14
6477;Pabiručiai;Kiškučiai;9353062804;Ne;0;6;0;6
6478;Pabiručiai;Kiškučiai;1582754284;Ne;19;0;0;19
6479;Pabiručiai;Kiškučiai;4462744848;Ne;5;8;0;13
6480;Pabiručiai;Kiškučiai;5621183663;Ne;2;4;0;6
6481;Pabiručiai;Kiškučiai;5497318373;Ne;5;0;0;5
6482;Pabiručiai;Kiškučiai;9417138573;Ne;0;6;0;6
6483;Pabiručiai;Kiškučiai;1515270273;Taip;5;3;0;8
6484;Pabiručiai;Kiškučiai;2688728915;Ne;12;3;0;15
6485;Pabiručiai;Kiškučiai;5166525832;Ne;2;3;0;5
6486;Pabiručiai;Kiškučiai;8409455566;Ne;12;1;0;13
6487;Pabiručiai;Kiškučiai;1028312285;Ne;0;2;0;2
6488;Pabiručiai;Kiškučiai;5717534175;Ne;5;3;0;8
6489;Pabiručiai;Kiškučiai;3408518493;Ne;9;3;0;12
6490;Pabiručiai;Kiškučiai;7653129291;Ne;9;1;0;10
6491;Pabiručiai;Kiškučiai;7073230645;Taip;5;5;0;10
6492;Pabiručiai;Kiškučiai;8820585407;Ne;1;6;0;7
6493;Pabiručiai;Kiškučiai;7572077461;Ne;0;6;0;6
6494;Pabiručiai;Kiškučiai;5767879226;Ne;0;4;0;4
6495;Pabiručiai;Kiškučiai;6073797962;Taip;0;7;0;7
6496;Pabiručiai;"Pėledžiukai ";9834824219;Ne;0;11;0;11
6497;Pabiručiai;"Pėledžiukai ";1683369842;Ne;0;1;0;1
6498;Pabiručiai;"Pėledžiukai ";7961879916;Ne;0;2;0;2
6499;Pabiručiai;"Pėledžiukai ";9050994322;Ne;2;5;0;7
6500;Pabiručiai;"Pėledžiukai ";1049154287;Ne;9;2;0;11
6501;Pabiručiai;"Pėledžiukai ";6697518151;Ne;0;6;0;6
6502;Pabiručiai;"Pėledžiukai ";2596301235;Ne;2;3;0;5
6503;Pabiručiai;"Pėledžiukai ";4333645528;Ne;0;4;0;4
6504;Pabiručiai;"Pėledžiukai ";6289025538;Ne;3;11;0;14
6505;Pabiručiai;"Pėledžiukai ";2812291058;Ne;0;3;0;3
6506;Pabiručiai;"Pėledžiukai ";2343561322;Ne;0;4;0;4
6507;Pabiručiai;"Pėledžiukai ";3674583662;Ne;0;6;0;6
6508;Pabiručiai;"Pėledžiukai ";8268101318;Ne;0;7;0;7
6509;Pabiručiai;"Pėledžiukai ";2147165934;Ne;5;4;0;9
6510;Pabiručiai;"Pėledžiukai ";7385149524;Ne;0;4;0;4
6511;Pabiručiai;"Pėledžiukai ";7203091216;Ne;3;8;1;12
6512;Pabiručiai;"Pėledžiukai ";3224195892;Ne;0;5;0;5
6513;Pabiručiai;"Pėledžiukai ";1852744763;Ne;7;0;0;7
6514;Pabiručiai;"Pėledžiukai ";5165268747;Ne;0;6;0;6
6515;Pabiručiai;"Pėledžiukai ";1971996148;Ne;0;3;0;3
6516;Pabiručiai;"Kodelčiūkai ";5950654594;Ne;12;0;0;12
6517;Pabiručiai;"Kodelčiūkai ";8775727677;Taip;0;6;0;6
6518;Pabiručiai;"Kodelčiūkai ";2295503584;Ne;0;12;0;12
6519;Pabiručiai;"Kodelčiūkai ";4595458527;Ne;9;0;0;9
6520;Pabiručiai;"Kodelčiūkai ";8716879106;Ne;4;0;0;4
6521;Pabiručiai;"Kodelčiūkai ";9067653417;Ne;12;0;0;12
6522;Pabiručiai;"Kodelčiūkai ";5247780866;Ne;12;0;0;12
6523;Pabiručiai;"Kodelčiūkai ";3433419710;Ne;1;4;0;5
6524;Pabiručiai;"Kodelčiūkai ";6386335808;Ne;16;0;0;16
6525;Pabiručiai;"Kodelčiūkai ";5010271037;Ne;0;5;0;5
6526;Pabiručiai;"Kodelčiūkai ";9538339883;Ne;0;4;0;4
6527;Pabiručiai;"Kodelčiūkai ";8149732126;Ne;2;2;0;4
6528;Pabiručiai;"Kodelčiūkai ";7289131864;Ne;9;0;0;9
6529;Pabiručiai;"Kodelčiūkai ";6209553290;Ne;7;0;0;7
6530;Pabiručiai;"Kodelčiūkai ";3497466298;Ne;0;4;0;4
6531;Pabiručiai;"Kodelčiūkai ";8179285338;Ne;0;9;0;9
6532;Pabiručiai;"Kodelčiūkai ";1234230729;Ne;13;0;0;13
6533;Pabiručiai;"Kodelčiūkai ";2519371211;Ne;14;0;0;14
6534;Pabiručiai;"Kodelčiūkai ";5211115955;Ne;6;0;0;6
6535;Pabiručiai;"Kodelčiūkai ";2433997383;Ne;13;0;0;13
6536;Pabiručiai;"Peliukų ";3702521810;Ne;14;0;0;14
6537;Pabiručiai;"Peliukų ";4894380231;Ne;11;0;0;11
6538;Pabiručiai;"Peliukų ";1947729077;Ne;6;0;0;6
6539;Pabiručiai;"Peliukų ";7182565608;Ne;5;0;0;5
6540;Pabiručiai;"Peliukų ";1776325000;Ne;11;0;0;11
6541;Pabiručiai;"Peliukų ";5990497129;Ne;6;0;0;6
6542;Pabiručiai;"Peliukų ";7644854044;Ne;8;2;0;10
6543;Pabiručiai;"Peliukų ";9806520732;Taip;4;9;0;13
6544;Pabiručiai;"Peliukų ";2765716248;Ne;5;4;0;9
6545;Pabiručiai;"Peliukų ";8551913254;Ne;12;0;0;12
6546;Pabiručiai;"Peliukų ";1638037202;Ne;15;0;0;15
6547;Pabiručiai;"Peliukų ";6603404126;Ne;14;0;0;14
6548;Pabiručiai;"Peliukų ";1414752034;Ne;0;13;0;13
6549;Pabiručiai;"Peliukų ";2860703696;Ne;7;5;0;12
6550;Pabiručiai;"Peliukų ";3128998397;Ne;0;4;0;4
6551;Pabiručiai;"Peliukų ";1707526401;Ne;11;0;0;11
6552;Pabiručiai;"Peliukų ";5980457097;Ne;14;0;0;14
6553;Pabiručiai;"Viščiukų ";8048012241;Ne;7;0;1;8
6554;Pabiručiai;"Viščiukų ";2757879842;Ne;14;3;0;17
6555;Pabiručiai;"Viščiukų ";7101741906;Ne;3;0;5;8
6556;Pabiručiai;"Viščiukų ";3372218487;Ne;1;0;3;4
6557;Pabiručiai;"Viščiukų ";6044682613;Ne;7;0;2;9
6558;Pabiručiai;"Viščiukų ";7537470611;Ne;11;4;0;15
6559;Pabiručiai;"Viščiukų ";6581286069;Ne;7;0;3;10
6560;Pabiručiai;"Viščiukų ";3400423825;Ne;4;0;2;6
6561;Pabiručiai;"Viščiukų ";2116533837;Ne;17;0;0;17
6562;Pabiručiai;"Viščiukų ";4078487035;Ne;0;3;0;3
6563;Pabiručiai;"Viščiukų ";5561666659;Ne;0;0;2;2
6564;Pabiručiai;"Viščiukų ";7183696280;Ne;0;4;1;5
6565;Pabiručiai;"Viščiukų ";6547174468;Ne;0;4;1;5
6566;Pabiručiai;"Viščiukų ";4554910957;Ne;5;4;1;10
6567;Pabiručiai;"Viščiukų ";8571325340;Ne;0;0;5;5
6568;Pabiručiai;"Viščiukų ";7840617265;Ne;2;0;2;4
6569;Pabiručiai;"Viščiukų ";1424717472;Ne;0;0;2;2
6570;Pabiručiai;"Drugelių ";9890868992;Ne;9;0;0;9
6571;Pabiručiai;"Drugelių ";2556330147;Ne;2;10;0;12
6572;Pabiručiai;"Drugelių ";3004152898;Ne;2;7;0;9
6573;Pabiručiai;"Drugelių ";6481162347;Ne;1;0;0;1
6574;Pabiručiai;"Drugelių ";5147367745;Ne;5;0;0;5
6575;Pabiručiai;"Drugelių ";6612530931;Ne;7;0;0;7
6576;Pabiručiai;"Drugelių ";3189763918;Taip;4;9;0;13
6577;Pabiručiai;"Drugelių ";8268444485;Ne;17;0;0;17
6578;Pabiručiai;"Drugelių ";8066935182;Ne;6;0;0;6
6579;Pabiručiai;"Drugelių ";8822799881;Ne;1;0;0;1
6580;Pabiručiai;"Drugelių ";6831781849;Ne;13;0;0;13
6581;Pabiručiai;"Drugelių ";9878338803;Taip;2;0;0;2
6582;Pabiručiai;"Drugelių ";9297511341;Ne;9;0;0;9
6583;Pabiručiai;"Drugelių ";3886340836;Ne;19;0;0;19
6584;Pabiručiai;"Drugelių ";7067604564;Ne;6;0;0;6
6585;Pabiručiai;"Drugelių ";3486322043;Ne;9;0;0;9
6586;Pabiručiai;ŽIRNIUKŲ;9507212682;Ne;0;6;0;6
6587;Pabiručiai;ŽIRNIUKŲ;3239143202;Ne;9;0;0;9
6588;Pabiručiai;ŽIRNIUKŲ;8756826405;Ne;0;6;0;6
6589;Pabiručiai;ŽIRNIUKŲ;6059282085;Ne;2;9;0;11
6590;Pabiručiai;ŽIRNIUKŲ;4600476221;Ne;2;4;0;6
6591;Pabiručiai;ŽIRNIUKŲ;9042431134;Ne;9;0;0;9
6592;Pabiručiai;ŽIRNIUKŲ;1537534207;Ne;13;0;0;13
6593;Pabiručiai;ŽIRNIUKŲ;2142523078;Ne;5;2;0;7
6594;Pabiručiai;ŽIRNIUKŲ;3370660254;Ne;18;0;0;18
6595;Pabiručiai;ŽIRNIUKŲ;4229089612;Ne;0;6;0;6
6596;Pabiručiai;ŽIRNIUKŲ;8834001928;Ne;2;7;0;9
6597;Pabiručiai;ŽIRNIUKŲ;9185016818;Ne;10;5;0;15
6598;Pabiručiai;ŽIRNIUKŲ;2141466782;Ne;1;4;0;5
6599;Pabiručiai;ŽIRNIUKŲ;9748002526;Ne;1;4;0;5
6600;Pabiručiai;ŽIRNIUKŲ;5436055219;Ne;0;5;0;5
6601;Pabiručiai;ŽIRNIUKŲ;6601800828;Ne;3;0;0;3
6602;Pabiručiai;ŽIRNIUKŲ;8074555646;Ne;0;12;0;12
6603;Pabiručiai;ŽIRNIUKŲ;7045558084;Ne;5;0;0;5
6604;Pagrandukas;Saulytės;6915087488;Ne;0;3;0;3
6605;Pagrandukas;Saulytės;6349387692;Ne;9;1;0;10
6606;Pagrandukas;Saulytės;8186092469;Ne;0;5;0;5
6607;Pagrandukas;Saulytės;2934300533;Ne;7;4;0;11
6608;Pagrandukas;Saulytės;1548697124;Ne;3;5;0;8
6609;Pagrandukas;Saulytės;6711830251;Ne;4;4;0;8
6610;Pagrandukas;Saulytės;7146697128;Ne;0;16;0;16
6611;Pagrandukas;Saulytės;3157676207;Ne;4;4;0;8
6612;Pagrandukas;Saulytės;7511097160;Ne;0;4;0;4
6613;Pagrandukas;Saulytės;3783160018;Ne;0;5;0;5
6614;Pagrandukas;Saulytės;7454863899;Ne;0;6;0;6
6615;Pagrandukas;Saulytės;5560372136;Ne;0;1;0;1
6616;Pagrandukas;Saulytės;1766912463;Ne;0;4;0;4
6617;Pagrandukas;Saulytės;9849054467;Ne;3;10;0;13
6618;Pagrandukas;Saulytės;8024910647;Ne;0;5;0;5
6619;Pagrandukas;Saulytės;8481502330;Ne;0;6;0;6
6620;Pagrandukas;Saulytės;7160305478;Ne;0;4;0;4
6621;Pagrandukas;Saulytės;6388805960;Ne;9;4;5;18
6622;Pagrandukas;Saulytės;3050207849;Ne;0;3;0;3
6623;Pagrandukas;Saulytės;8836178193;Ne;0;9;0;9
6624;Pagrandukas;Saulytės;7157549179;Ne;4;3;0;7
6625;Pagrandukas;Saulytės;3494047045;Ne;0;6;0;6
6626;Pagrandukas;Zuikučiai;7834436515;Ne;0;5;0;5
6627;Pagrandukas;Zuikučiai;7435609306;Ne;0;0;2;2
6628;Pagrandukas;Zuikučiai;5903416384;Ne;2;4;1;7
6629;Pagrandukas;Zuikučiai;2439891231;Ne;0;0;4;4
6630;Pagrandukas;Zuikučiai;6710887776;Ne;0;0;4;4
6631;Pagrandukas;Zuikučiai;7665811353;Ne;3;0;3;6
6632;Pagrandukas;Zuikučiai;2212787835;Ne;0;7;0;7
6633;Pagrandukas;Zuikučiai;2711590019;Ne;0;12;1;13
6634;Pagrandukas;Zuikučiai;6449029299;Ne;0;0;3;3
6635;Pagrandukas;Zuikučiai;1405820070;Ne;0;5;4;9
6636;Pagrandukas;Zuikučiai;1054107640;Ne;5;9;0;14
6637;Pagrandukas;Zuikučiai;1885539883;Ne;0;4;1;5
6638;Pagrandukas;Zuikučiai;1795582354;Ne;5;4;0;9
6639;Pagrandukas;Zuikučiai;2822538227;Ne;0;0;2;2
6640;Pagrandukas;Zuikučiai;1587839122;Ne;4;0;0;4
6641;Pagrandukas;Zuikučiai;2101505576;Ne;3;0;3;6
6642;Pagrandukas;Zuikučiai;6765346578;Ne;0;0;4;4
6643;Pagrandukas;Zuikučiai;5030928303;Ne;0;8;0;8
6644;Pagrandukas;Zuikučiai;9139212151;Ne;3;4;0;7
6645;Pagrandukas;Zuikučiai;8643993939;Ne;4;0;6;10
6646;Pagrandukas;Zuikučiai;5021106231;Ne;0;6;0;6
6647;Pagrandukas;Boružėlių;5330598431;Ne;6;0;0;6
6648;Pagrandukas;Boružėlių;9141829963;Ne;2;0;0;2
6649;Pagrandukas;Boružėlių;3643271023;Ne;4;4;0;8
6650;Pagrandukas;Boružėlių;7897742424;Ne;9;0;0;9
6651;Pagrandukas;Boružėlių;3313757952;Ne;1;0;0;1
6652;Pagrandukas;Boružėlių;4013188468;Ne;1;2;2;5
6653;Pagrandukas;Boružėlių;8812047984;Ne;10;0;0;10
6654;Pagrandukas;Boružėlių;2893099852;Ne;0;4;0;4
6655;Pagrandukas;Boružėlių;6506518248;Ne;5;10;0;15
6656;Pagrandukas;Boružėlių;2244308184;Ne;0;4;0;4
6657;Pagrandukas;Boružėlių;4730178155;Ne;8;2;0;10
6658;Pagrandukas;Boružėlių;8869609106;Ne;7;0;0;7
6659;Pagrandukas;Boružėlių;2752197975;Ne;3;2;0;5
6660;Pagrandukas;Boružėlių;8948739929;Ne;0;5;0;5
6661;Pagrandukas;Boružėlių;9390682686;Ne;2;0;0;2
6662;Pagrandukas;Bitutės;9188382746;Ne;4;3;0;7
6663;Pagrandukas;Bitutės;1583104760;Ne;5;4;2;11
6664;Pagrandukas;Bitutės;5649084353;Ne;0;4;0;4
6665;Pagrandukas;Bitutės;5821945401;Ne;0;0;6;6
6666;Pagrandukas;Bitutės;7675694987;Ne;10;3;0;13
6667;Pagrandukas;Bitutės;3709131197;Ne;0;4;0;4
6668;Pagrandukas;Bitutės;2764732768;Ne;8;0;0;8
6669;Pagrandukas;Bitutės;9987717045;Ne;10;0;2;12
6670;Pagrandukas;Bitutės;4771506131;Ne;7;0;1;8
6671;Pagrandukas;Bitutės;9798727946;Ne;9;0;0;9
6672;Pagrandukas;Bitutės;5464426019;Ne;2;0;0;2
6673;Pagrandukas;Bitutės;6845210200;Ne;5;0;4;9
6674;Pagrandukas;Bitutės;6090721838;Ne;14;0;0;14
6675;Pagrandukas;Bitutės;6129335910;Ne;5;3;5;13
6676;Pagrandukas;Bitutės;1780452241;Ne;0;0;9;9
6677;Pagrandukas;Bitutės;7147518086;Ne;19;0;0;19
6678;Pagrandukas;Bitutės;5604315555;Ne;0;3;0;3
6679;Pagrandukas;Bitutės;7784155503;Ne;0;3;0;3
6680;Pagrandukas;Bitutės;7605508460;Ne;0;3;0;3
6681;Pagrandukas;Bitutės;6304701617;Ne;0;4;0;4
6682;Pagrandukas;Bitutės;5511396314;Ne;0;9;0;9
6683;Pagrandukas;Bitutės;2481532396;Ne;0;3;0;3
6684;Pagrandukas;Pelėdžiukai;1714449109;Ne;0;6;0;6
6685;Pagrandukas;Pelėdžiukai;3160109801;Ne;3;2;0;5
6686;Pagrandukas;Pelėdžiukai;7764147734;Ne;2;2;0;4
6687;Pagrandukas;Pelėdžiukai;8633116370;Ne;2;2;0;4
6688;Pagrandukas;Pelėdžiukai;2877401332;Ne;5;6;0;11
6689;Pagrandukas;Pelėdžiukai;8167118045;Ne;9;3;0;12
6690;Pagrandukas;Pelėdžiukai;3390664086;Ne;0;3;0;3
6691;Pagrandukas;Pelėdžiukai;1733723373;Ne;7;0;0;7
6692;Pagrandukas;Pelėdžiukai;6011346969;Ne;7;1;0;8
6693;Pagrandukas;Pelėdžiukai;1077792535;Ne;2;3;0;5
6694;Pagrandukas;Pelėdžiukai;9583471280;Ne;3;3;0;6
6695;Pagrandukas;Pelėdžiukai;4398016119;Ne;0;4;0;4
6696;Pagrandukas;Pelėdžiukai;2640777376;Ne;5;4;0;9
6697;Pagrandukas;Pelėdžiukai;4910151924;Ne;11;0;0;11
6698;Pagrandukas;Pelėdžiukai;9431513632;Ne;0;4;0;4
6699;Pagrandukas;Pelėdžiukai;1977974235;Ne;12;4;0;16
6700;Pagrandukas;Pelėdžiukai;7238694532;Ne;4;6;0;10
6701;Pagrandukas;Pelėdžiukai;4014238120;Ne;4;0;0;4
6702;Pagrandukas;Pelėdžiukai;8789320226;Ne;6;0;0;6
6703;Pagrandukas;Pelėdžiukai;3569618725;Ne;12;0;0;12
6704;Pagrandukas;Pelėdžiukai;7498372078;Ne;5;0;0;5
6705;Pagrandukas;ŠYPSENĖLIŲ;4627387596;Ne;3;0;0;3
6706;Pagrandukas;ŠYPSENĖLIŲ;7173561328;Ne;9;1;0;10
6707;Pagrandukas;ŠYPSENĖLIŲ;1101989969;Ne;11;0;0;11
6708;Pagrandukas;ŠYPSENĖLIŲ;5701479990;Ne;11;0;0;11
6709;Pagrandukas;ŠYPSENĖLIŲ;9981610798;Ne;0;1;0;1
6710;Pagrandukas;ŠYPSENĖLIŲ;8027783692;Ne;6;0;0;6
6711;Pagrandukas;ŠYPSENĖLIŲ;2904880156;Ne;10;0;0;10
6712;Pagrandukas;ŠYPSENĖLIŲ;5173633710;Ne;8;0;0;8
6713;Pagrandukas;ŠYPSENĖLIŲ;6057078416;Ne;5;0;0;5
6714;Pagrandukas;ŠYPSENĖLIŲ;1855833141;Ne;5;0;0;5
6715;Pagrandukas;ŠYPSENĖLIŲ;8475724797;Ne;3;0;0;3
6716;Pagrandukas;ŠYPSENĖLIŲ;5272914210;Ne;4;0;0;4
6717;Pagrandukas;ŠYPSENĖLIŲ;6517393406;Ne;5;0;0;5
6718;Pagrandukas;ŠYPSENĖLIŲ;4094086585;Ne;3;4;0;7
6719;Pagrandukas;ŠYPSENĖLIŲ;6306635507;Ne;0;9;0;9
6720;Pagrandukas;ŠYPSENĖLIŲ;5060059491;Ne;4;0;0;4
6721;Pagrandukas;ŠYPSENĖLIŲ;1728795744;Ne;3;0;0;3
6722;Pagrandukas;ŠYPSENĖLIŲ;8728782427;Ne;14;0;0;14
6723;Pagrandukas;ŠYPSENĖLIŲ;8638429638;Ne;6;0;0;6
6724;Pakalnutė;Pagrandukai;7475119623;Ne;0;12;0;12
6725;Pakalnutė;Pagrandukai;9677810607;Ne;2;3;0;5
6726;Pakalnutė;Pagrandukai;5275833872;Ne;7;4;0;11
6727;Pakalnutė;Pagrandukai;5943686565;Ne;1;3;0;4
6728;Pakalnutė;Pagrandukai;2296079246;Ne;2;4;0;6
6729;Pakalnutė;Pagrandukai;9313588621;Ne;1;4;0;5
6730;Pakalnutė;Pagrandukai;7962849592;Ne;0;4;0;4
6731;Pakalnutė;Pagrandukai;5180015882;Ne;9;4;0;13
6732;Pakalnutė;Pagrandukai;3794283102;Ne;0;4;0;4
6733;Pakalnutė;Pagrandukai;3070652992;Ne;0;4;0;4
6734;Pakalnutė;Pagrandukai;7477188659;Ne;0;2;0;2
6735;Pakalnutė;Pagrandukai;8522585063;Ne;0;3;0;3
6736;Pakalnutė;Pagrandukai;4390444128;Ne;2;4;0;6
6737;Pakalnutė;Pagrandukai;2642359967;Ne;0;3;0;3
6738;Pakalnutė;Pagrandukai;7417131378;Ne;5;4;0;9
6739;Pakalnutė;Pagrandukai;6396963609;Ne;0;4;0;4
6740;Pakalnutė;Pagrandukai;6708041407;Ne;14;4;0;18
6741;Pakalnutė;Pagrandukai;1883500676;Ne;5;4;0;9
6742;Pakalnutė;Pagrandukai;9537826109;Ne;0;4;0;4
6743;Pakalnutė;Pagrandukai;7669135310;Ne;1;4;0;5
6744;Pakalnutė;"Pelėdžiukų ";8730363504;Ne;13;0;0;13
6745;Pakalnutė;"Pelėdžiukų ";6002425101;Ne;11;0;0;11
6746;Pakalnutė;"Pelėdžiukų ";6592271501;Ne;6;5;0;11
6747;Pakalnutė;"Pelėdžiukų ";7028010813;Ne;4;0;0;4
6748;Pakalnutė;"Pelėdžiukų ";9167525974;Ne;7;0;0;7
6749;Pakalnutė;"Pelėdžiukų ";6981958616;Ne;18;0;0;18
6750;Pakalnutė;"Pelėdžiukų ";3139358443;Ne;7;0;0;7
6751;Pakalnutė;"Pelėdžiukų ";1999933222;Ne;6;0;0;6
6752;Pakalnutė;"Pelėdžiukų ";1783674258;Ne;4;0;0;4
6753;Pakalnutė;"Pelėdžiukų ";9624523658;Ne;5;6;0;11
6754;Pakalnutė;"Pelėdžiukų ";1307260377;Ne;4;0;0;4
6755;Pakalnutė;"Pelėdžiukų ";6555749105;Ne;3;0;0;3
6756;Pakalnutė;"Pelėdžiukų ";9253328160;Ne;11;0;0;11
6757;Pakalnutė;"Pelėdžiukų ";6866535420;Ne;15;0;0;15
6758;Pakalnutė;"Pelėdžiukų ";8996675127;Ne;7;4;0;11
6759;Pakalnutė;Ežiukai;5058727058;Ne;0;4;0;4
6760;Pakalnutė;Ežiukai;4052166895;Ne;4;0;0;4
6761;Pakalnutė;Ežiukai;9323200833;Ne;0;5;0;5
6762;Pakalnutė;Ežiukai;9781993614;Ne;6;0;0;6
6763;Pakalnutė;Ežiukai;9256219647;Ne;1;5;0;6
6764;Pakalnutė;Ežiukai;4317305712;Ne;4;0;0;4
6765;Pakalnutė;Ežiukai;6029905101;Ne;1;0;0;1
6766;Pakalnutė;Ežiukai;7734657452;Ne;7;0;0;7
6767;Pakalnutė;Ežiukai;9706455707;Ne;8;0;0;8
6768;Pakalnutė;Ežiukai;7881545979;Ne;0;9;0;9
6769;Pakalnutė;Ežiukai;8080989574;Ne;12;0;0;12
6770;Pakalnutė;Ežiukai;5911381706;Ne;0;5;0;5
6771;Pakalnutė;Ežiukai;2755412687;Ne;6;0;0;6
6772;Pakalnutė;Ežiukai;8236718590;Ne;0;2;0;2
6773;Pakalnutė;Ežiukai;3064391379;Ne;6;1;0;7
6774;Pakalnutė;Ežiukai;2015778005;Ne;7;0;0;7
6775;Pakalnutė;Ežiukai;8329725085;Ne;3;0;0;3
6776;Pakalnutė;Ežiukai;1662773049;Ne;5;0;0;5
6777;Pakalnutė;Ežiukai;4961361687;Ne;0;4;0;4
6778;Pakalnutė;Ežiukai;5685361033;Ne;4;1;0;5
6779;Pakalnutė;Skruzdėliukų;4033813807;Ne;19;0;0;19
6780;Pakalnutė;Skruzdėliukų;7503936754;Ne;9;0;0;9
6781;Pakalnutė;Skruzdėliukų;5409476517;Ne;0;12;0;12
6782;Pakalnutė;Skruzdėliukų;2670302354;Ne;5;0;0;5
6783;Pakalnutė;Skruzdėliukų;7105369111;Ne;17;0;0;17
6784;Pakalnutė;Skruzdėliukų;6944726166;Ne;7;0;0;7
6785;Pakalnutė;Skruzdėliukų;1195872320;Ne;0;5;0;5
6786;Pakalnutė;Skruzdėliukų;3211633472;Ne;6;4;0;10
6787;Pakalnutė;Skruzdėliukų;4423348418;Ne;0;4;0;4
6788;Pakalnutė;Skruzdėliukų;6055727963;Ne;4;4;0;8
6789;Pakalnutė;Skruzdėliukų;3215438452;Taip;3;3;0;6
6790;Pakalnutė;Skruzdėliukų;9681515221;Ne;10;0;0;10
6791;Pakalnutė;Skruzdėliukų;8496839980;Ne;1;4;0;5
6792;Pakalnutė;Skruzdėliukų;9336711927;Taip;4;7;0;11
6793;Pakalnutė;Skruzdėliukų;5356902834;Ne;4;0;0;4
6794;Pakalnutė;Skruzdėliukų;8768704484;Ne;3;4;0;7
6795;Pakalnutė;Skruzdėliukų;6675588261;Ne;1;4;0;5
6796;Pakalnutė;Bitučių;8461220770;Ne;0;5;0;5
6797;Pakalnutė;Bitučių;2367683002;Ne;3;4;0;7
6798;Pakalnutė;Bitučių;2765220889;Ne;0;4;0;4
6799;Pakalnutė;Bitučių;9445909071;Ne;0;4;0;4
6800;Pakalnutė;Bitučių;5532458706;Ne;0;5;0;5
6801;Pakalnutė;Bitučių;7526989580;Ne;3;4;0;7
6802;Pakalnutė;Bitučių;5941955322;Ne;1;1;0;2
6803;Pakalnutė;Bitučių;3306334576;Ne;5;4;0;9
6804;Pakalnutė;Bitučių;2095540372;Ne;0;4;0;4
6805;Pakalnutė;Bitučių;5342592825;Ne;0;4;0;4
6806;Pakalnutė;Bitučių;2932205226;Ne;0;4;0;4
6807;Pakalnutė;Bitučių;5464143742;Ne;12;4;0;16
6808;Pakalnutė;Bitučių;6351193702;Ne;0;3;0;3
6809;Pakalnutė;Bitučių;2070744110;Ne;2;4;0;6
6810;Pakalnutė;Bitučių;3965390135;Ne;0;5;0;5
6811;Pakalnutė;Bitučių;5355198213;Ne;1;4;0;5
6812;Pakalnutė;Bitučių;4533467194;Ne;0;3;0;3
6813;Pakalnutė;Bitučių;4523766424;Ne;0;5;0;5
6814;Pakalnutė;Bitučių;2992768162;Ne;0;5;0;5
6815;Pakalnutė;Bitučių;9505524183;Ne;0;5;0;5
6816;Pakalnutė;Bitučių;1330092247;Ne;5;4;0;9
6817;Pakalnutė;Bitučių;3267680599;Ne;1;5;0;6
6818;Pakalnutė;Boružiukų;6798939288;Ne;1;4;0;5
6819;Pakalnutė;Boružiukų;7357431226;Ne;0;3;0;3
6820;Pakalnutė;Boružiukų;4934095931;Ne;0;4;0;4
6821;Pakalnutė;Boružiukų;5039000154;Ne;0;3;0;3
6822;Pakalnutė;Boružiukų;7223747714;Ne;0;0;1;1
6823;Pakalnutė;Boružiukų;2835611316;Ne;0;4;0;4
6824;Pakalnutė;Boružiukų;7672252382;Ne;0;2;0;2
6825;Pakalnutė;Boružiukų;4950195858;Ne;10;4;0;14
6826;Pakalnutė;Boružiukų;4927086034;Ne;0;4;0;4
6827;Pakalnutė;Boružiukų;6557165567;Ne;1;4;0;5
6828;Pakalnutė;Boružiukų;3677709759;Ne;14;0;0;14
6829;Pakalnutė;Boružiukų;2597900983;Ne;0;4;0;4
6830;Pakalnutė;Boružiukų;2062721289;Ne;1;5;0;6
6831;Pakalnutė;Boružiukų;1340022702;Ne;4;4;0;8
6832;Pakalnutė;Boružiukų;6228196996;Ne;11;0;0;11
6833;Pakalnutė;Boružiukų;7563201788;Ne;0;2;0;2
6834;Pakalnutė;Boružiukų;5619262190;Ne;6;4;0;10
6835;Pakalnutė;Boružiukų;8553182620;Ne;1;3;0;4
6836;Pakalnutė;Boružiukų;3840499737;Ne;1;4;0;5
6837;Pakalnutė;Boružiukų;4220368864;Ne;0;4;0;4
6838;Pakalnutė;Boružiukų;7151877991;Ne;0;4;0;4
6839;Pakalnutė;Boružiukų;4353883274;Ne;1;4;0;5
6840;Pakalnutė;Boružiukų;8823232039;Ne;0;2;0;2
6841;Pakalnutė;Meškiukų;2101821362;Taip;0;5;0;5
6842;Pakalnutė;Meškiukų;4069910346;Ne;0;15;0;15
6843;Pakalnutė;Meškiukų;4313652059;Ne;0;4;0;4
6844;Pakalnutė;Meškiukų;7084798190;Ne;11;0;0;11
6845;Pakalnutė;Meškiukų;6133481935;Ne;0;3;0;3
6846;Pakalnutė;Meškiukų;3693337607;Taip;10;0;0;10
6847;Pakalnutė;Meškiukų;9954809499;Ne;1;0;0;1
6848;Pakalnutė;Meškiukų;8576580816;Taip;2;0;0;2
6849;Pakalnutė;Meškiukų;6082998947;Ne;6;0;0;6
6850;Pakalnutė;Meškiukų;7696196458;Ne;17;0;0;17
6851;Pakalnutė;Meškiukų;9327477300;Ne;0;12;0;12
6852;Pakalnutė;Nykštukai;9918277117;Taip;3;0;0;3
6853;Pakalnutė;Nykštukai;3870628774;Ne;9;0;0;9
6854;Pakalnutė;Nykštukai;8324219868;Ne;4;0;1;5
6855;Pakalnutė;Nykštukai;1864990681;Ne;5;0;0;5
6856;Pakalnutė;Nykštukai;1236187157;Ne;2;0;0;2
6857;Pakalnutė;Nykštukai;2063766287;Ne;9;0;0;9
6858;Pakalnutė;Nykštukai;6528913736;Taip;1;0;0;1
6859;Pakalnutė;Nykštukai;8217779439;Ne;9;0;0;9
6860;Pakalnutė;Nykštukai;6206296685;Ne;4;0;0;4
6861;Pakalnutė;Nykštukai;8855237588;Taip;4;0;0;4
6862;Pakalnutė;Nykštukai;1561411767;Ne;9;0;0;9
6863;Pakalnutė;Nykštukai;9443826616;Ne;9;1;0;10
6864;Pakalnutė;Nykštukai;7024440142;Ne;0;4;0;4
6865;Pakalnutė;Nykštukai;2578170222;Ne;4;0;0;4
6866;Pakalnutė;Nykštukai;3967515235;Ne;0;3;0;3
6867;Pakalnutė;Nykštukai;5377715404;Ne;12;4;0;16
6868;Pakalnutė;Nykštukai;3938091521;Ne;3;0;0;3
6869;Pakalnutė;Nykštukai;4971065032;Ne;5;1;0;6
6870;Pakalnutė;"Zuikučių ";3992958274;Taip;18;0;0;18
6871;Pakalnutė;"Zuikučių ";7665013940;Ne;7;4;0;11
6872;Pakalnutė;"Zuikučių ";5366218312;Ne;5;4;0;9
6873;Pakalnutė;"Zuikučių ";9093281442;Ne;2;4;1;7
6874;Pakalnutė;"Zuikučių ";5712352356;Ne;15;4;0;19
6875;Pakalnutė;"Zuikučių ";6346936964;Ne;6;4;1;11
6876;Pakalnutė;"Zuikučių ";8678783379;Ne;1;4;0;5
6877;Pakalnutė;"Zuikučių ";7200174700;Ne;2;4;0;6
6878;Pakalnutė;"Zuikučių ";2364777781;Ne;2;4;0;6
6879;Pakalnutė;"Zuikučių ";6817504559;Ne;0;2;0;2
6880;Pakalnutė;"Zuikučių ";4926207043;Ne;0;7;0;7
6881;Pakalnutė;"Zuikučių ";9324190244;Taip;19;0;0;19
6882;Pakalnutė;"Zuikučių ";1044084070;Ne;0;3;1;4
6883;Pakalnutė;"Zuikučių ";4587376166;Ne;5;4;0;9
6884;Pakalnutė;"Zuikučių ";7696333378;Ne;14;3;0;17
6885;Pakalnutė;"Zuikučių ";5285591409;Taip;5;4;0;9
6886;Pakalnutė;"Zuikučių ";5328042222;Ne;0;19;0;19
6887;Pakalnutė;"Drugelių ";5441477374;Ne;0;8;0;8
6888;Pakalnutė;"Drugelių ";7369661890;Ne;11;0;0;11
6889;Pakalnutė;"Drugelių ";5135811550;Ne;3;0;0;3
6890;Pakalnutė;"Drugelių ";7766653114;Ne;6;0;0;6
6891;Pakalnutė;"Drugelių ";7709684372;Ne;12;0;0;12
6892;Pakalnutė;"Drugelių ";9620000116;Ne;8;0;0;8
6893;Pakalnutė;"Drugelių ";5502444590;Ne;5;0;0;5
6894;Pakalnutė;"Drugelių ";3730712580;Ne;12;0;0;12
6895;Pakalnutė;"Drugelių ";1824418095;Ne;2;0;0;2
6896;Pakalnutė;"Drugelių ";9461133636;Ne;4;0;0;4
6897;Pakalnutė;"Drugelių ";4220406978;Ne;4;0;0;4
6898;Pakalnutė;"Drugelių ";5069038636;Ne;0;19;0;19
6899;Pakalnutė;"Drugelių ";7047587606;Ne;7;6;0;13
6900;Pakalnutė;"Drugelių ";2653667596;Ne;10;0;0;10
6901;Pakalnutė;"Drugelių ";2026242407;Ne;4;0;0;4
6902;Pakalnutė;"Drugelių ";2197533802;Ne;7;0;0;7
6903;Pakalnutė;"Drugelių ";1791607977;Ne;0;4;0;4
6904;Pakalnutė;"Drugelių ";4127500142;Ne;3;0;0;3
6905;Pakalnutė;"Drugelių ";9295709508;Taip;18;0;0;18
6906;Pakalnutė;"Drugelių ";6924023022;Ne;13;0;0;13
6907;Pakalnutė;"Drugelių ";8105507156;Ne;4;1;0;5
6908;Pakalnutė;Žvirbliukų;7421275778;Ne;4;0;0;4
6909;Pakalnutė;Žvirbliukų;3190067149;Taip;0;6;0;6
6910;Pakalnutė;Žvirbliukų;7548659665;Ne;0;1;0;1
6911;Pakalnutė;Žvirbliukų;8010667913;Ne;8;0;0;8
6912;Pakalnutė;Žvirbliukų;5531209454;Ne;17;0;0;17
6913;Pakalnutė;Žvirbliukų;3342793992;Ne;4;0;0;4
6914;Pakalnutė;Žvirbliukų;7258417347;Ne;11;0;0;11
6915;Pakalnutė;Žvirbliukų;5878352514;Ne;3;0;0;3
6916;Pakalnutė;Žvirbliukų;7782295402;Ne;4;0;0;4
6917;Pakalnutė;Žvirbliukų;7547661599;Taip;3;2;0;5
6918;Pakalnutė;Žvirbliukų;4469974699;Ne;4;0;0;4
6919;Pakalnutė;Žvirbliukų;6159955311;Ne;3;2;0;5
6920;Pakalnutė;Žvirbliukų;3903972025;Ne;0;4;0;4
6921;Pakalnutė;Žvirbliukų;5683073863;Taip;1;0;0;1
6922;Pakalnutė;Žvirbliukų;8394290574;Ne;10;0;0;10
6923;Pakalnutė;Žvirbliukų;8104124782;Ne;19;0;0;19
6924;Pakalnutė;Žvirbliukų;1368254053;Ne;4;0;0;4
6925;Pakalnutė;Žvirbliukų;6361966325;Ne;6;0;0;6
6926;Panerių;Rūtelė;9268618414;Ne;0;0;1;1
6927;Panerių;Rūtelė;2333355325;Taip;0;0;3;3
6928;Panerių;Rūtelė;2235123048;Ne;9;0;0;9
6929;Panerių;Rūtelė;3190117304;Ne;0;10;0;10
6930;Panerių;Rūtelė;8693113275;Taip;16;0;0;16
6931;Panerių;Rūtelė;6468190149;Ne;2;0;2;4
6932;Panerių;Rūtelė;9630302749;Ne;4;0;0;4
6933;Panerių;Rūtelė;3057714143;Ne;2;2;0;4
6934;Panerių;Rūtelė;9432171719;Ne;0;6;0;6
6935;Panerių;Rūtelė;1717129076;Ne;18;0;0;18
6936;Panerių;Rūtelė;2035822976;Ne;2;0;0;2
6937;Panerių;Rūtelė;3550194241;Ne;0;3;0;3
6938;Panerių;Rūtelė;9729731866;Ne;0;0;1;1
6939;Panerių;Rūtelė;8447920373;Ne;0;3;0;3
6940;Panerių;Rūtelė;6583134855;Ne;6;0;2;8
6941;Panerių;Rūtelė;4161189870;Taip;8;0;2;10
6942;Panerių;Rūtelė;3948776877;Ne;0;0;4;4
6943;Panerių;Rūtelė;2751334281;Ne;0;4;0;4
6944;Panerių;Rūtelė;1339256258;Ne;7;0;0;7
6945;Panerių;Rūtelė;3882802840;Ne;4;0;0;4
6946;Panerių;Gėlytės;5452996791;Ne;6;0;0;6
6947;Panerių;Gėlytės;3112608087;Taip;0;0;2;2
6948;Panerių;Gėlytės;5100874548;Taip;8;0;2;10
6949;Panerių;Gėlytės;9955613696;Ne;0;3;0;3
6950;Panerių;Gėlytės;6304387432;Ne;5;2;1;8
6951;Panerių;Gėlytės;7166964095;Ne;3;0;0;3
6952;Panerių;Gėlytės;7657860513;Taip;5;9;0;14
6953;Panerių;Gėlytės;4716214117;Ne;0;2;0;2
6954;Panerių;Gėlytės;4369979548;Taip;0;2;0;2
6955;Panerių;Gėlytės;9014387764;Ne;0;4;0;4
6956;Panerių;Gėlytės;3273655606;Ne;19;0;0;19
6957;Panerių;Gėlytės;8067240250;Ne;10;0;1;11
6958;Panerių;Gėlytės;3526636673;Ne;1;0;2;3
6959;Panerių;Gėlytės;8407995549;Ne;5;6;0;11
6960;Panerių;Gėlytės;3502494751;Ne;12;0;2;14
6961;Panerių;Gėlytės;6574858142;Ne;0;4;2;6
6962;Panerių;Gėlytės;6653710644;Ne;3;4;1;8
6963;Panerių;Gėlytės;4957564440;Ne;0;6;0;6
6964;Panerių;Gėlytės;7976634590;Taip;0;11;1;12
6965;Panerių;Gėlytės;1985780685;Ne;8;3;0;11
6966;Panerių;Boružė;5938568445;Ne;12;0;0;12
6967;Panerių;Boružė;6067429637;Ne;5;1;0;6
6968;Panerių;Boružė;8204542330;Ne;15;0;0;15
6969;Panerių;Boružė;9834947195;Ne;10;1;0;11
6970;Panerių;Boružė;7665286465;Ne;19;0;0;19
6971;Panerių;Boružė;7674680327;Ne;18;0;0;18
6972;Panerių;Boružė;2411155582;Ne;0;0;1;1
6973;Panerių;Boružė;9658945394;Ne;15;0;1;16
6974;Panerių;Boružė;5243109212;Ne;13;0;0;13
6975;Panerių;Boružė;7516118069;Taip;0;4;0;4
6976;Panerių;Boružė;9157312277;Ne;9;0;0;9
6977;Panerių;Boružė;5836583423;Ne;4;0;1;5
6978;Panerių;Boružė;6903412424;Ne;0;4;1;5
6979;Panerių;Boružė;7200320230;Ne;0;8;0;8
6980;Papartis;ZUIKUČIAI;8874222586;Ne;8;0;0;8
6981;Papartis;ZUIKUČIAI;2446379598;Ne;4;0;1;5
6982;Papartis;ZUIKUČIAI;3054883426;Ne;0;4;0;4
6983;Papartis;ZUIKUČIAI;1191546794;Ne;3;0;0;3
6984;Papartis;ZUIKUČIAI;7619963429;Ne;0;4;0;4
6985;Papartis;ZUIKUČIAI;8958880558;Ne;5;3;0;8
6986;Papartis;ZUIKUČIAI;4380030213;Ne;13;0;0;13
6987;Papartis;ZUIKUČIAI;4906248064;Ne;8;0;0;8
6988;Papartis;ZUIKUČIAI;8447326505;Ne;10;4;0;14
6989;Papartis;ZUIKUČIAI;1919362027;Ne;0;0;2;2
6990;Papartis;ZUIKUČIAI;4640068595;Ne;0;4;0;4
6991;Papartis;ZUIKUČIAI;5361925390;Ne;1;1;0;2
6992;Papartis;ZUIKUČIAI;9375751990;Ne;0;4;0;4
6993;Papartis;ZUIKUČIAI;5786648402;Ne;0;4;0;4
6994;Papartis;ZUIKUČIAI;5776038830;Ne;0;0;1;1
6995;Papartis;ZUIKUČIAI;5579899922;Ne;5;0;0;5
6996;Papartis;ZUIKUČIAI;8808902528;Ne;2;4;0;6
6997;Papartis;ZUIKUČIAI;9358310527;Ne;7;0;0;7
6998;Papartis;ZUIKUČIAI;5363926529;Ne;0;5;0;5
6999;Papartis;ZUIKUČIAI;1722192450;Ne;5;4;0;9
7000;Papartis;ZUIKUČIAI;8897061283;Ne;8;0;0;8
7001;Papartis;DRUGELIAI;8005876431;Ne;8;5;0;13
7002;Papartis;DRUGELIAI;7384518191;Ne;3;5;0;8
7003;Papartis;DRUGELIAI;6664178454;Ne;0;5;0;5
7004;Papartis;DRUGELIAI;2432516496;Ne;5;5;0;10
7005;Papartis;DRUGELIAI;7742769931;Ne;9;2;1;12
7006;Papartis;DRUGELIAI;8305560946;Ne;7;0;2;9
7007;Papartis;DRUGELIAI;4778327620;Ne;0;13;0;13
7008;Papartis;DRUGELIAI;7486667034;Ne;2;0;0;2
7009;Papartis;DRUGELIAI;7331682622;Ne;12;4;1;17
7010;Papartis;DRUGELIAI;2824078830;Ne;9;4;0;13
7011;Papartis;DRUGELIAI;8782882575;Ne;0;4;0;4
7012;Papartis;DRUGELIAI;1405767603;Ne;5;5;0;10
7013;Papartis;DRUGELIAI;6435625940;Ne;3;5;0;8
7014;Papartis;DRUGELIAI;7187797639;Ne;3;2;0;5
7015;Papartis;DRUGELIAI;3411472740;Ne;5;6;0;11
7016;Papartis;DRUGELIAI;3209105694;Ne;9;0;0;9
7017;Papartis;DRUGELIAI;8277830926;Ne;6;0;0;6
7018;Papartis;DRUGELIAI;1759982543;Ne;0;11;0;11
7019;Papartis;DRUGELIAI;4689046394;Ne;0;5;0;5
7020;Papartis;DRUGELIAI;5430993785;Ne;8;1;0;9
7021;Papartis;ŽVIRBLIUKAI;5538433120;Taip;0;2;0;2
7022;Papartis;ŽVIRBLIUKAI;9380951144;Ne;7;0;0;7
7023;Papartis;ŽVIRBLIUKAI;2812347963;Ne;0;3;0;3
7024;Papartis;ŽVIRBLIUKAI;3685642787;Ne;15;0;0;15
7025;Papartis;ŽVIRBLIUKAI;8420752169;Ne;0;4;4;8
7026;Papartis;ŽVIRBLIUKAI;4016297254;Ne;13;0;2;15
7027;Papartis;ŽVIRBLIUKAI;6585372451;Ne;0;6;0;6
7028;Papartis;ŽVIRBLIUKAI;6734567714;Ne;2;2;3;7
7029;Papartis;ŽVIRBLIUKAI;4597039190;Ne;5;0;1;6
7030;Papartis;ŽVIRBLIUKAI;1352401881;Ne;0;1;2;3
7031;Papartis;ŽVIRBLIUKAI;1231594320;Ne;4;1;0;5
7032;Papartis;ŽVIRBLIUKAI;3539507686;Ne;3;4;0;7
7033;Papartis;ŽVIRBLIUKAI;5465955537;Ne;13;4;0;17
7034;Papartis;ŽVIRBLIUKAI;6346776139;Ne;3;2;2;7
7035;Papartis;ŽVIRBLIUKAI;3595627659;Ne;0;4;0;4
7036;Papartis;ŽVIRBLIUKAI;6977513472;Ne;0;4;0;4
7037;Papartis;ŽVIRBLIUKAI;5323875279;Ne;0;7;0;7
7038;Papartis;ŽVIRBLIUKAI;6136213985;Ne;0;5;0;5
7039;Papartis;ŽVIRBLIUKAI;7107692314;Ne;0;4;0;4
7040;Papartis;ŽVIRBLIUKAI;5070767260;Ne;0;2;0;2
7041;Papartis;PELĖDŽIUKAI;9502229005;Ne;0;4;0;4
7042;Papartis;PELĖDŽIUKAI;1559196767;Ne;2;3;0;5
7043;Papartis;PELĖDŽIUKAI;5652560002;Ne;1;4;0;5
7044;Papartis;PELĖDŽIUKAI;6360881137;Ne;1;4;0;5
7045;Papartis;PELĖDŽIUKAI;6794076631;Ne;3;4;0;7
7046;Papartis;PELĖDŽIUKAI;6941978169;Ne;15;4;0;19
7047;Papartis;PELĖDŽIUKAI;4203241118;Ne;0;4;1;5
7048;Papartis;PELĖDŽIUKAI;9285319899;Ne;6;4;0;10
7049;Papartis;PELĖDŽIUKAI;5942160584;Ne;0;5;0;5
7050;Papartis;PELĖDŽIUKAI;9922091482;Ne;3;4;0;7
7051;Papartis;PELĖDŽIUKAI;8932290803;Ne;5;2;0;7
7052;Papartis;PELĖDŽIUKAI;1680412204;Ne;0;4;1;5
7053;Papartis;PELĖDŽIUKAI;6423401656;Ne;0;4;1;5
7054;Papartis;PELĖDŽIUKAI;9384670351;Ne;7;5;0;12
7055;Papartis;PELĖDŽIUKAI;4509843536;Ne;0;4;1;5
7056;Papartis;PELĖDŽIUKAI;6883101103;Ne;0;3;0;3
7057;Papartis;PELĖDŽIUKAI;4878190663;Ne;0;5;0;5
7058;Papartis;PELĖDŽIUKAI;9900023788;Ne;0;2;1;3
7059;Papartis;PELĖDŽIUKAI;9704930584;Ne;0;14;0;14
7060;Papartis;PELĖDŽIUKAI;9072635586;Ne;0;8;0;8
7061;Papartis;PELĖDŽIUKAI;1442806517;Ne;0;2;0;2
7062;Papartis;SAULUTĖS;8836419340;Ne;2;3;0;5
7063;Papartis;SAULUTĖS;8187136860;Ne;11;0;0;11
7064;Papartis;SAULUTĖS;6408828474;Taip;6;7;0;13
7065;Papartis;SAULUTĖS;1428163291;Ne;15;0;0;15
7066;Papartis;SAULUTĖS;6436061438;Ne;11;0;0;11
7067;Papartis;SAULUTĖS;8423259604;Ne;0;6;0;6
7068;Papartis;SAULUTĖS;4887468138;Ne;5;0;0;5
7069;Papartis;SAULUTĖS;8866437550;Ne;16;0;0;16
7070;Papartis;SAULUTĖS;9731930047;Ne;17;0;0;17
7071;Papartis;SAULUTĖS;3948323728;Ne;16;0;0;16
7072;Papartis;SAULUTĖS;2004327439;Ne;7;0;0;7
7073;Papartis;SAULUTĖS;6199807321;Ne;17;0;0;17
7074;Papartis;SAULUTĖS;4767287348;Ne;2;3;0;5
7075;Papartis;SAULUTĖS;4983959118;Ne;15;0;0;15
7076;Papartis;SAULUTĖS;6352542412;Ne;7;0;0;7
7077;Papartis;GANDRIUKAI;4969807705;Ne;4;2;0;6
7078;Papartis;GANDRIUKAI;5383936595;Ne;0;3;0;3
7079;Papartis;GANDRIUKAI;1698871014;Ne;0;4;0;4
7080;Papartis;GANDRIUKAI;6274608449;Ne;9;4;0;13
7081;Papartis;GANDRIUKAI;6664773988;Ne;0;3;0;3
7082;Papartis;GANDRIUKAI;8875490564;Ne;14;0;0;14
7083;Papartis;GANDRIUKAI;7149853209;Ne;0;1;0;1
7084;Papartis;GANDRIUKAI;2921187615;Ne;10;4;0;14
7085;Papartis;GANDRIUKAI;5128663521;Ne;8;1;0;9
7086;Papartis;GANDRIUKAI;4500675679;Ne;5;4;0;9
7087;Papartis;GANDRIUKAI;7203919287;Ne;5;3;0;8
7088;Papartis;GANDRIUKAI;5132031416;Ne;14;0;0;14
7089;Papartis;GANDRIUKAI;3395306653;Ne;10;5;0;15
7090;Papartis;GANDRIUKAI;1616537800;Ne;0;7;0;7
7091;Papartis;GANDRIUKAI;8303599213;Ne;6;0;0;6
7092;Papartis;GANDRIUKAI;1656161309;Ne;2;0;0;2
7093;Papartis;GANDRIUKAI;8410744610;Ne;4;5;0;9
7094;Papartis;AITVARELIAI;8891856856;Ne;0;4;0;4
7095;Papartis;AITVARELIAI;6889782462;Taip;10;4;0;14
7096;Papartis;AITVARELIAI;5736456872;Ne;0;4;0;4
7097;Papartis;AITVARELIAI;3040269026;Ne;0;4;0;4
7098;Papartis;AITVARELIAI;8532558577;Ne;0;7;0;7
7099;Papartis;AITVARELIAI;4918854899;Ne;9;5;0;14
7100;Papartis;AITVARELIAI;5252947502;Ne;10;2;0;12
7101;Papartis;AITVARELIAI;1916222143;Ne;4;3;0;7
7102;Papartis;AITVARELIAI;7803854703;Ne;0;4;0;4
7103;Papartis;AITVARELIAI;4261270064;Ne;8;2;0;10
7104;Papartis;AITVARELIAI;6416605464;Ne;3;0;0;3
7105;Papartis;AITVARELIAI;1266338760;Ne;0;1;0;1
7106;Papartis;AITVARELIAI;7504793827;Ne;5;0;0;5
7107;Papartis;AITVARELIAI;7156767639;Ne;11;4;0;15
7108;Papartis;AITVARELIAI;5268226380;Ne;0;4;0;4
7109;Papartis;AITVARELIAI;2116140075;Ne;7;1;0;8
7110;Papartis;AITVARELIAI;3896803048;Ne;0;2;0;2
7111;Papartis;AITVARELIAI;4138926711;Taip;0;2;0;2
7112;Papartis;AITVARELIAI;8989172483;Ne;9;0;10;19
7113;Papartis;SMALSUČIAI;5660932637;Ne;9;0;0;9
7114;Papartis;SMALSUČIAI;3576856223;Ne;6;0;0;6
7115;Papartis;SMALSUČIAI;5259754395;Ne;6;1;0;7
7116;Papartis;SMALSUČIAI;1157298413;Ne;3;0;0;3
7117;Papartis;SMALSUČIAI;3107245976;Ne;3;0;0;3
7118;Papartis;SMALSUČIAI;1381195839;Ne;4;0;0;4
7119;Papartis;SMALSUČIAI;5959006739;Ne;6;4;0;10
7120;Papartis;SMALSUČIAI;6776383676;Ne;3;0;0;3
7121;Papartis;SMALSUČIAI;2079105902;Ne;4;0;1;5
7122;Papartis;SMALSUČIAI;9838432144;Ne;3;0;0;3
7123;Papartis;SMALSUČIAI;9884399306;Ne;3;0;0;3
7124;Papartis;SMALSUČIAI;1511111597;Ne;11;1;0;12
7125;Papartis;SMALSUČIAI;8055310718;Ne;3;0;0;3
7126;Papartis;SMALSUČIAI;3490370261;Ne;10;3;0;13
7127;Papartis;SMALSUČIAI;1566259150;Ne;7;0;1;8
7128;Papartis;SMALSUČIAI;1159418157;Ne;2;0;1;3
7129;Papartis;SMALSUČIAI;4087823915;Ne;4;0;1;5
7130;Papartis;SMALSUČIAI;1293528737;Ne;7;0;11;18
7131;Papartis;SMALSUČIAI;6615368741;Ne;0;0;1;1
7132;Papartis;"ŽIRNIUKAI ";3310893254;Ne;0;1;0;1
7133;Papartis;"ŽIRNIUKAI ";1073755384;Ne;6;0;2;8
7134;Papartis;"ŽIRNIUKAI ";7647225316;Ne;7;2;0;9
7135;Papartis;"ŽIRNIUKAI ";1210592579;Ne;0;3;2;5
7136;Papartis;"ŽIRNIUKAI ";1519815331;Ne;0;3;1;4
7137;Papartis;"ŽIRNIUKAI ";4158525314;Ne;19;0;0;19
7138;Papartis;"ŽIRNIUKAI ";4978398085;Ne;9;6;0;15
7139;Papartis;"ŽIRNIUKAI ";9746397380;Ne;14;0;0;14
7140;Papartis;"ŽIRNIUKAI ";4952279543;Ne;0;9;0;9
7141;Papartis;"ŽIRNIUKAI ";5276806556;Ne;0;3;0;3
7142;Papartis;"ŽIRNIUKAI ";2521609574;Taip;7;0;0;7
7143;Papartis;"ŽIRNIUKAI ";7617558492;Ne;8;1;1;10
7144;Papartis;"ŽIRNIUKAI ";8412962815;Ne;2;0;0;2
7145;Papartis;"ŽIRNIUKAI ";2772758899;Ne;0;4;2;6
7146;Papartis;"ŽIRNIUKAI ";1183123161;Ne;4;0;2;6
7147;Papartis;"ŽIRNIUKAI ";1150772988;Ne;0;4;0;4
7148;Papartis;"ŽIRNIUKAI ";9518392031;Ne;0;0;4;4
7149;Papartis;"ŽIRNIUKAI ";1614261572;Ne;0;5;0;5
7150;Papartis;BORUŽĖLĖS;4156776066;Ne;11;0;0;11
7151;Papartis;BORUŽĖLĖS;4394324806;Ne;10;0;0;10
7152;Papartis;BORUŽĖLĖS;4128791207;Ne;10;0;0;10
7153;Papartis;BORUŽĖLĖS;1713966292;Ne;4;7;0;11
7154;Papartis;BORUŽĖLĖS;6512648672;Ne;16;0;3;19
7155;Papartis;BORUŽĖLĖS;1229841021;Ne;2;0;0;2
7156;Papartis;BORUŽĖLĖS;6971029839;Ne;6;0;0;6
7157;Papartis;BORUŽĖLĖS;3671248088;Ne;2;5;0;7
7158;Papartis;BORUŽĖLĖS;3033128518;Ne;4;0;0;4
7159;Papartis;BORUŽĖLĖS;3138701373;Ne;11;0;0;11
7160;Papartis;BORUŽĖLĖS;4800482635;Ne;8;0;0;8
7161;Papartis;BORUŽĖLĖS;2833918272;Ne;1;0;0;1
7162;Papartis;BORUŽĖLĖS;4656732095;Ne;1;0;0;1
7163;Papartis;BORUŽĖLĖS;8015824674;Ne;1;0;0;1
7164;Papartis;BORUŽĖLĖS;5459468987;Ne;11;0;0;11
7165;Papartis;VARPELIAI;8501388069;Ne;13;4;0;17
7166;Papartis;VARPELIAI;3639299679;Ne;2;4;2;8
7167;Papartis;VARPELIAI;5796633935;Ne;12;3;0;15
7168;Papartis;VARPELIAI;9141478403;Ne;8;0;0;8
7169;Papartis;VARPELIAI;5073439000;Ne;9;0;0;9
7170;Papartis;VARPELIAI;1390187546;Ne;12;0;0;12
7171;Papartis;VARPELIAI;6559847250;Ne;13;0;0;13
7172;Papartis;VARPELIAI;6053981340;Ne;13;0;0;13
7173;Papartis;VARPELIAI;5038105723;Ne;8;0;0;8
7174;Papartis;VARPELIAI;3327404107;Ne;10;0;0;10
7175;Papartis;VARPELIAI;3535455931;Ne;5;0;0;5
7176;Papartis;VARPELIAI;4839033346;Ne;9;0;0;9
7177;Papartis;VARPELIAI;5063367652;Ne;0;4;0;4
7178;Papartis;VARPELIAI;4620041887;Ne;7;0;0;7
7179;Papartis;VARPELIAI;1032653411;Ne;13;0;0;13
7180;Papartis;NYKŠTUKAI;7260304487;Ne;0;3;0;3
7181;Papartis;NYKŠTUKAI;9581159294;Ne;0;4;0;4
7182;Papartis;NYKŠTUKAI;2956950308;Ne;11;0;0;11
7183;Papartis;NYKŠTUKAI;6710049689;Ne;9;0;0;9
7184;Papartis;NYKŠTUKAI;2777359899;Ne;7;4;0;11
7185;Papartis;NYKŠTUKAI;1993893368;Ne;2;0;0;2
7186;Papartis;NYKŠTUKAI;7189999679;Ne;8;0;0;8
7187;Papartis;NYKŠTUKAI;4256878733;Ne;4;0;0;4
7188;Papartis;NYKŠTUKAI;8443731277;Ne;4;0;0;4
7189;Papartis;NYKŠTUKAI;3419374226;Ne;0;0;19;19
7190;Papartis;NYKŠTUKAI;8642079824;Ne;10;4;0;14
7191;Papartis;NYKŠTUKAI;2421158534;Ne;15;0;0;15
7192;Papartis;NYKŠTUKAI;2600724041;Ne;6;2;0;8
7193;Papartis;NYKŠTUKAI;8872914372;Ne;8;5;0;13
7194;Papartis;NYKŠTUKAI;2053568874;Ne;4;0;0;4
7195;Papartis;NYKŠTUKAI;3173271837;Ne;1;4;0;5
7196;Papartis;NYKŠTUKAI;4952700737;Ne;6;4;0;10
7197;Papartis;NYKŠTUKAI;9881509036;Ne;6;0;0;6
7198;Pasaka;Drugelių;2308992563;Ne;7;5;0;12
7199;Pasaka;Drugelių;7955645490;Ne;4;2;0;6
7200;Pasaka;Drugelių;9249389876;Ne;4;0;2;6
7201;Pasaka;Drugelių;2961210575;Ne;9;1;0;10
7202;Pasaka;Drugelių;2383607612;Ne;7;1;1;9
7203;Pasaka;Drugelių;5351364328;Ne;0;2;1;3
7204;Pasaka;Drugelių;4635912654;Ne;0;2;1;3
7205;Pasaka;Drugelių;9737445077;Ne;0;3;0;3
7206;Pasaka;Drugelių;9136521759;Ne;0;4;0;4
7207;Pasaka;Drugelių;2293613528;Ne;0;1;0;1
7208;Pasaka;Drugelių;5412931969;Ne;8;0;0;8
7209;Pasaka;Drugelių;6326056771;Ne;8;5;0;13
7210;Pasaka;Drugelių;4175157894;Ne;4;0;0;4
7211;Pasaka;Drugelių;7252498738;Ne;15;0;0;15
7212;Pasaka;Drugelių;4183646305;Ne;4;0;1;5
7213;Pasaka;Nykštukų;5768958388;Ne;1;4;3;8
7214;Pasaka;Nykštukų;2797217440;Ne;0;2;0;2
7215;Pasaka;Nykštukų;7292437626;Ne;5;4;0;9
7216;Pasaka;Nykštukų;2211744442;Ne;1;0;1;2
7217;Pasaka;Nykštukų;5912306325;Ne;9;2;0;11
7218;Pasaka;Nykštukų;2217868951;Ne;4;4;0;8
7219;Pasaka;Nykštukų;2217868951;Ne;4;4;0;8
7220;Pasaka;Nykštukų;2217868951;Ne;4;4;0;8
7221;Pasaka;Nykštukų;3066438231;Ne;0;0;3;3
7222;Pasaka;Nykštukų;3066438231;Ne;0;0;3;3
7223;Pasaka;Nykštukų;3066438231;Ne;0;0;3;3
7224;Pasaka;Nykštukų;3424189866;Ne;11;0;2;13
7225;Pasaka;Nykštukų;7214402510;Ne;0;2;0;2
7226;Pasaka;Nykštukų;6821289069;Ne;10;4;0;14
7227;Pasaka;Nykštukų;7240424576;Taip;0;3;0;3
7228;Pasaka;Nykštukų;3557547656;Ne;0;5;0;5
7229;Pasaka;Nykštukų;2422079450;Ne;11;1;1;13
7230;Pasaka;Nykštukų;4614626554;Ne;0;0;4;4
7231;Pasaka;Nykštukų;2121277188;Ne;6;0;0;6
7232;Pasaka;Nykštukų;8391715624;Ne;0;0;5;5
7233;Pasaka;Montesori;5240642967;Ne;0;0;1;1
7234;Pasaka;Montesori;5031538468;Ne;4;4;0;8
7235;Pasaka;Montesori;6625690696;Ne;4;5;0;9
7236;Pasaka;Montesori;4548601585;Taip;6;3;0;9
7237;Pasaka;Montesori;7887326763;Ne;0;3;1;4
7238;Pasaka;Montesori;9850592463;Ne;5;5;0;10
7239;Pasaka;Montesori;2995831258;Ne;9;4;0;13
7240;Pasaka;Montesori;6248810027;Ne;1;4;0;5
7241;Pasaka;Montesori;3620395122;Ne;4;4;0;8
7242;Pasaka;Montesori;5689164477;Ne;4;4;0;8
7243;Pasaka;Montesori;7751618911;Ne;4;0;0;4
7244;Pasaka;Montesori;5230621839;Ne;3;4;0;7
7245;Pasaka;Montesori;9471447977;Ne;0;4;2;6
7246;Pasaka;Montesori;4222952044;Ne;5;5;0;10
7247;Pasaka;Montesori;5194285627;Ne;5;5;0;10
7248;Pasaka;Montesori;5969883817;Ne;5;0;4;9
7249;Pasaka;Montesori;9488089168;Ne;5;4;0;9
7250;Pasaka;Montesori;2558448927;Ne;0;1;3;4
7251;Pasaka;Montesori;9567521319;Ne;11;0;0;11
7252;Pasaka;Žirniukų;9867183480;Ne;8;4;0;12
7253;Pasaka;Žirniukų;3783869856;Ne;0;4;0;4
7254;Pasaka;Žirniukų;2815348652;Ne;0;7;0;7
7255;Pasaka;Žirniukų;5651025350;Ne;6;4;0;10
7256;Pasaka;Žirniukų;2422958320;Ne;6;5;0;11
7257;Pasaka;Žirniukų;9438006825;Ne;0;3;0;3
7258;Pasaka;Žirniukų;9136524816;Ne;0;5;0;5
7259;Pasaka;Žirniukų;9766432049;Ne;8;2;2;12
7260;Pasaka;Žirniukų;6668421711;Ne;4;0;1;5
7261;Pasaka;Žirniukų;6387972576;Ne;7;2;1;10
7262;Pasaka;Žirniukų;4948174745;Ne;10;0;0;10
7263;Pasaka;Žirniukų;2144975281;Ne;5;0;3;8
7264;Pasaka;Žirniukų;4629119214;Ne;0;4;0;4
7265;Pasaka;Žirniukų;8519108324;Ne;0;6;0;6
7266;Pasaka;Žirniukų;9950979894;Ne;8;0;2;10
7267;Pasaka;Žirniukų;9654507441;Ne;10;0;0;10
7268;Pasaka;Žirniukų;9654507441;Ne;10;0;0;10
7269;Pasaka;Žirniukų;9654507441;Ne;10;0;0;10
7270;Pasaka;Žirniukų;5921553817;Ne;4;0;1;5
7271;Pasaka;Žirniukų;2569560383;Ne;10;5;0;15
7272;Pasaka;Žirniukų;9780490338;Ne;0;0;5;5
7273;Pasaka;Žirniukų;5139525557;Ne;0;2;0;2
7274;Pasaka;"Voveriukų ";3606141216;Ne;0;5;0;5
7275;Pasaka;"Voveriukų ";5217688848;Ne;0;6;0;6
7276;Pasaka;"Voveriukų ";4171004263;Ne;5;4;1;10
7277;Pasaka;"Voveriukų ";8504575043;Taip;0;0;11;11
7278;Pasaka;"Voveriukų ";1488711275;Ne;0;5;0;5
7279;Pasaka;"Voveriukų ";2854919649;Ne;0;0;2;2
7280;Pasaka;"Voveriukų ";1950145441;Ne;0;0;3;3
7281;Pasaka;"Voveriukų ";4466963221;Ne;2;3;0;5
7282;Pasaka;"Voveriukų ";9588247759;Ne;0;4;2;6
7283;Pasaka;"Voveriukų ";3536862796;Ne;4;1;0;5
7284;Pasaka;"Voveriukų ";8899289832;Ne;5;1;0;6
7285;Pasaka;"Voveriukų ";4915357646;Ne;6;0;1;7
7286;Pasaka;"Voveriukų ";7176272684;Ne;5;5;0;10
7287;Pasaka;"Voveriukų ";9687385445;Ne;4;1;0;5
7288;Pasaka;"Voveriukų ";4799036184;Ne;4;0;0;4
7289;Pasaka;"Voveriukų ";6684234474;Ne;0;13;4;17
7290;Pasaka;"Voveriukų ";9003508760;Ne;0;5;0;5
7291;Pasaka;"Voveriukų ";6925961600;Ne;6;2;0;8
7292;Pasaka;"Voveriukų ";8421404290;Ne;12;0;0;12
7293;Pasaka;"Voveriukų ";1745181416;Ne;0;0;6;6
7294;Pasaka;"Voveriukų ";6315362421;Ne;0;4;0;4
7295;Pasaka;"Voveriukų ";6315362421;Ne;0;4;0;4
7296;Pasaka;"VALDOFRO 12";8976424908;Ne;0;4;1;5
7297;Pasaka;"VALDOFRO 12";1305541319;Ne;0;4;0;4
7298;Pasaka;"VALDOFRO 12";7682903999;Ne;0;4;0;4
7299;Pasaka;"VALDOFRO 12";6448940090;Ne;2;1;0;3
7300;Pasaka;"VALDOFRO 12";8411025450;Ne;3;4;0;7
7301;Pasaka;"VALDOFRO 12";1756831961;Ne;0;1;0;1
7302;Pasaka;"VALDOFRO 12";3840053722;Ne;9;6;0;15
7303;Pasaka;"VALDOFRO 12";8995205555;Ne;2;1;0;3
7304;Pasaka;"VALDOFRO 12";4548945364;Ne;0;0;4;4
7305;Pasaka;"VALDOFRO 12";8912822936;Ne;2;0;3;5
7306;Pasaka;"VALDOFRO 12";5244582148;Ne;10;0;0;10
7307;Pasaka;"VALDOFRO 12";2650797982;Ne;8;2;0;10
7308;Pasaka;"VALDOFRO 12";9065016148;Ne;0;4;2;6
7309;Pasaka;"VALDOFRO 12";9809498406;Ne;0;2;1;3
7310;Pasaka;"VALDOFRO 12";6920718870;Ne;3;4;0;7
7311;Pasaka;"VALDOFRO 12";1791565631;Ne;14;0;0;14
7312;Pasaka;"VALDOFRO 12";5601416284;Ne;0;4;0;4
7313;Pasaka;"VALDOFRO 12";9324220807;Ne;5;4;0;9
7314;Pasaka;"VALDORFO 2";4620573687;Ne;0;4;1;5
7315;Pasaka;"VALDORFO 2";4825373152;Ne;4;3;1;8
7316;Pasaka;"VALDORFO 2";9462745431;Ne;5;4;1;10
7317;Pasaka;"VALDORFO 2";5399148997;Ne;1;4;0;5
7318;Pasaka;"VALDORFO 2";1799326151;Ne;0;4;0;4
7319;Pasaka;"VALDORFO 2";2273629510;Ne;1;4;0;5
7320;Pasaka;"VALDORFO 2";3778182691;Ne;0;4;1;5
7321;Pasaka;"VALDORFO 2";5742479853;Ne;0;3;1;4
7322;Pasaka;"VALDORFO 2";3049361712;Ne;0;4;0;4
7323;Pasaka;"VALDORFO 2";6497042042;Ne;0;0;4;4
7324;Pasaka;"VALDORFO 2";9150761761;Ne;4;0;0;4
7325;Pasaka;"VALDORFO 2";9821858308;Ne;2;0;3;5
7326;Pasaka;"VALDORFO 2";1648043715;Ne;0;0;7;7
7327;Pasaka;"VALDORFO 2";8855436141;Ne;0;0;3;3
7328;Pasaka;"VALDORFO 2";3796844193;Ne;4;0;0;4
7329;Pasaka;"VALDORFO 2";1940341287;Ne;6;3;0;9
7330;Pasaka;Gudručiai;5687494160;Ne;0;6;0;6
7331;Pasaka;Gudručiai;3151916774;Ne;0;5;0;5
7332;Pasaka;Gudručiai;4773893970;Ne;1;5;0;6
7333;Pasaka;Gudručiai;1813068555;Ne;14;3;0;17
7334;Pasaka;Gudručiai;7546205285;Ne;0;5;0;5
7335;Pasaka;Gudručiai;4082752808;Ne;5;1;0;6
7336;Pasaka;Gudručiai;6139825302;Ne;0;6;0;6
7337;Pasaka;Gudručiai;7248640367;Ne;0;4;0;4
7338;Pasaka;Gudručiai;8277245475;Ne;5;4;0;9
7339;Pasaka;Gudručiai;1720511696;Ne;2;0;0;2
7340;Pasaka;Gudručiai;4970812899;Ne;4;0;1;5
7341;Pasaka;Gudručiai;1335408890;Ne;0;6;0;6
7342;Pasaka;Gudručiai;8873115041;Ne;19;0;0;19
7343;Pasaka;Gudručiai;5723970763;Ne;1;4;0;5
7344;Pasaka;Gudručiai;2638182985;Ne;0;5;0;5
7345;Pasaka;Gudručiai;3351338617;Ne;5;4;0;9
7346;Pasaka;Gudručiai;2963373430;Ne;4;0;0;4
7347;Pasaka;Gudručiai;3367346582;Ne;8;5;0;13
7348;Pasaka;Gudručiai;6788771605;Ne;0;4;0;4
7349;Pasaka;Bitelių;4770547514;Ne;0;1;0;1
7350;Pasaka;Bitelių;7696383564;Ne;4;4;0;8
7351;Pasaka;Bitelių;4910817298;Ne;3;4;0;7
7352;Pasaka;Bitelių;7127138831;Ne;7;0;0;7
7353;Pasaka;Bitelių;9813397639;Ne;7;0;0;7
7354;Pasaka;Bitelių;9770811826;Ne;6;4;0;10
7355;Pasaka;Bitelių;4846146925;Ne;6;4;0;10
7356;Pasaka;Bitelių;4994426702;Ne;0;2;0;2
7357;Pasaka;Bitelių;8289010515;Ne;0;2;0;2
7358;Pasaka;Bitelių;8558563996;Ne;6;5;0;11
7359;Pasaka;Bitelių;3735117473;Ne;5;1;2;8
7360;Pasaka;Bitelių;6119419213;Ne;8;4;0;12
7361;Pasaka;Bitelių;7101898684;Ne;10;1;0;11
7362;Pasaka;Bitelių;4828789266;Ne;0;0;3;3
7363;Pasaka;Bitelių;8934425171;Ne;7;0;0;7
7364;Pasaka;Bitelių;9120786116;Ne;2;4;0;6
7365;Pasaka;Bitelių;7960739321;Ne;2;4;0;6
7366;Pasaka;"Pabiručių ";5111195289;Ne;2;0;4;6
7367;Pasaka;"Pabiručių ";6182223896;Ne;2;0;4;6
7368;Pasaka;"Pabiručių ";8276520594;Ne;7;0;4;11
7369;Pasaka;"Pabiručių ";3192466285;Ne;6;0;0;6
7370;Pasaka;"Pabiručių ";3730173516;Ne;4;0;3;7
7371;Pasaka;"Pabiručių ";4572517095;Ne;0;4;2;6
7372;Pasaka;"Pabiručių ";3546787595;Ne;0;0;1;1
7373;Pasaka;"Pabiručių ";5297950763;Ne;0;4;1;5
7374;Pasaka;"Pabiručių ";8662703330;Ne;2;4;1;7
7375;Pasaka;"Pabiručių ";6189170713;Ne;3;4;0;7
7376;Pasaka;"Pabiručių ";2963191890;Ne;2;2;0;4
7377;Pasaka;Šnekučių;3709664132;Ne;4;4;0;8
7378;Pasaka;Šnekučių;1512874567;Ne;5;3;0;8
7379;Pasaka;Šnekučių;1793176485;Ne;5;4;0;9
7380;Pasaka;Šnekučių;4296539838;Ne;5;3;1;9
7381;Pasaka;Šnekučių;1590306118;Ne;3;3;0;6
7382;Pasaka;Šnekučių;6795580569;Ne;0;4;0;4
7383;Pasaka;Šnekučių;3240292756;Ne;3;1;0;4
7384;Pasaka;Šnekučių;4215568107;Ne;0;4;0;4
7385;Pasaka;Šnekučių;8365256755;Ne;2;4;0;6
7386;Pasaka;Šnekučių;1562771242;Ne;0;2;0;2
7387;Pasaka;Šnekučių;4816441219;Ne;10;2;0;12
7388;Pasaka;Šnekučių;1795497567;Ne;9;4;1;14
7389;Pasaka;Šnekučių;8347051587;Ne;3;4;0;7
7390;Pasaka;Šnekučių;4975045894;Ne;2;4;0;6
7391;Pasaka;Šnekučių;3588073618;Ne;4;3;0;7
7392;Pasaka;Šnekučių;1194745876;Ne;3;1;0;4
7393;Pasaka;Šnekučių;1749821746;Ne;0;6;0;6
7394;Pasaka;Šnekučių;1723076060;Ne;0;7;0;7
7395;Pasaka;Šnekučių;8475365713;Ne;4;5;0;9
7396;Pasaka;Šnekučių;5656511105;Ne;2;4;0;6
7397;Pasaka;"KIŠKUČIŲ (Žirmūnų g. 92)";7311929329;Ne;0;2;0;2
7398;Pasaka;"KIŠKUČIŲ (Žirmūnų g. 92)";2368681819;Ne;6;2;0;8
7399;Pasaka;"KIŠKUČIŲ (Žirmūnų g. 92)";5134067973;Taip;0;4;0;4
7400;Pasaka;"KIŠKUČIŲ (Žirmūnų g. 92)";2135527938;Ne;0;2;0;2
7401;Pasaka;"KIŠKUČIŲ (Žirmūnų g. 92)";5073970913;Ne;0;0;4;4
7402;Pasaka;"KIŠKUČIŲ (Žirmūnų g. 92)";5255764606;Ne;0;4;10;14
7403;Pasaka;"KIŠKUČIŲ (Žirmūnų g. 92)";6950137606;Ne;0;0;5;5
7404;Pasaka;"KIŠKUČIŲ (Žirmūnų g. 92)";2575986215;Ne;0;3;2;5
7405;Pasaka;"KIŠKUČIŲ (Žirmūnų g. 92)";4924664211;Ne;3;0;0;3
7406;Pasaka;"KIŠKUČIŲ (Žirmūnų g. 92)";5632714212;Ne;19;0;0;19
7407;Pasaka;"KIŠKUČIŲ (Žirmūnų g. 92)";9928518840;Ne;4;1;1;6
7408;Pasaka;"KIŠKUČIŲ (Žirmūnų g. 92)";7699290051;Ne;6;0;3;9
7409;Pasaka;"KIŠKUČIŲ (Žirmūnų g. 92)";1780063295;Ne;6;0;3;9
7410;Pasaka;"EŽIUKŲ (Žirmūnų g. 92)";4389337333;Taip;4;4;1;9
7411;Pasaka;"EŽIUKŲ (Žirmūnų g. 92)";1527027437;Ne;5;2;0;7
7412;Pasaka;"EŽIUKŲ (Žirmūnų g. 92)";9266921444;Ne;0;2;0;2
7413;Pasaka;"EŽIUKŲ (Žirmūnų g. 92)";9922357232;Ne;0;2;0;2
7414;Pasaka;"EŽIUKŲ (Žirmūnų g. 92)";7811540398;Ne;9;3;0;12
7415;Pasaka;"EŽIUKŲ (Žirmūnų g. 92)";7964569326;Ne;9;3;0;12
7416;Pasaka;"EŽIUKŲ (Žirmūnų g. 92)";4061808534;Ne;12;4;0;16
7417;Pasaka;"EŽIUKŲ (Žirmūnų g. 92)";3567879839;Ne;2;4;0;6
7418;Pasaka;"EŽIUKŲ (Žirmūnų g. 92)";4458246330;Ne;9;5;0;14
7419;Pasaka;"EŽIUKŲ (Žirmūnų g. 92)";5450477466;Ne;5;3;0;8
7420;Pasaka;"EŽIUKŲ (Žirmūnų g. 92)";9409030208;Ne;6;4;0;10
7421;Pasaka;"EŽIUKŲ (Žirmūnų g. 92)";9717417413;Ne;6;2;0;8
7422;Pasaka;"EŽIUKŲ (Žirmūnų g. 92)";6780585061;Ne;9;4;0;13
7423;Pasaka;"EŽIUKŲ (Žirmūnų g. 92)";2313200719;Ne;2;4;2;8
7424;Pasaka;"SAULUČIŲ (Žirmūnų g. 92)";8164697203;Ne;0;4;2;6
7425;Pasaka;"SAULUČIŲ (Žirmūnų g. 92)";6991062262;Ne;0;0;1;1
7426;Pasaka;"SAULUČIŲ (Žirmūnų g. 92)";1214817944;Ne;4;0;0;4
7427;Pasaka;"SAULUČIŲ (Žirmūnų g. 92)";6087447128;Ne;2;0;0;2
7428;Pasaka;"SAULUČIŲ (Žirmūnų g. 92)";6157459742;Ne;4;9;0;13
7429;Pasaka;"SAULUČIŲ (Žirmūnų g. 92)";9369336996;Ne;0;4;1;5
7430;Pasaka;"SAULUČIŲ (Žirmūnų g. 92)";8866484797;Ne;4;0;2;6
7431;Pasaka;"SAULUČIŲ (Žirmūnų g. 92)";3587648653;Ne;10;0;1;11
7432;Pasaka;"SAULUČIŲ (Žirmūnų g. 92)";6388657745;Ne;10;0;1;11
7433;Pasaka;"SAULUČIŲ (Žirmūnų g. 92)";6280303158;Ne;0;2;1;3
7434;Pasaka;"SAULUČIŲ (Žirmūnų g. 92)";9403892434;Ne;4;0;6;10
7435;Pasaka;"SAULUČIŲ (Žirmūnų g. 92)";8837340945;Ne;8;0;2;10
7436;Pasaka;"SAULUČIŲ (Žirmūnų g. 92)";1083785206;Ne;0;0;2;2
7437;Paslaptis;MONTIKI;4683384309;Ne;0;4;0;4
7438;Paslaptis;MONTIKI;4962917136;Ne;9;0;0;9
7439;Paslaptis;MONTIKI;5908641161;Ne;14;0;0;14
7440;Paslaptis;MONTIKI;3822422339;Ne;5;0;0;5
7441;Paslaptis;MONTIKI;8444751869;Ne;15;0;0;15
7442;Paslaptis;MONTIKI;1869254264;Ne;0;0;1;1
7443;Paslaptis;MONTIKI;3463582845;Ne;9;0;1;10
7444;Paslaptis;MONTIKI;7867852953;Ne;12;0;0;12
7445;Paslaptis;MONTIKI;4038980805;Ne;0;1;1;2
7446;Paslaptis;MONTIKI;6648088541;Ne;0;0;3;3
7447;Paslaptis;FRUTIKI;4130010071;Ne;0;3;0;3
7448;Paslaptis;FRUTIKI;2105441745;Ne;3;5;0;8
7449;Paslaptis;FRUTIKI;6686352764;Ne;13;0;0;13
7450;Paslaptis;FRUTIKI;6513238386;Ne;0;5;1;6
7451;Paslaptis;FRUTIKI;8457752288;Ne;5;4;0;9
7452;Paslaptis;FRUTIKI;4159590988;Ne;5;0;1;6
7453;Paslaptis;FRUTIKI;9929877115;Ne;8;0;0;8
7454;Paslaptis;FRUTIKI;6860366087;Taip;4;1;0;5
7455;Paslaptis;FRUTIKI;3572102816;Ne;4;0;0;4
7456;Paslaptis;FRUTIKI;2927014406;Ne;9;1;0;10
7457;Paslaptis;FRUTIKI;8453213193;Ne;0;1;0;1
7458;Paslaptis;FRUTIKI;7053452493;Ne;7;0;0;7
7459;Paslaptis;FRUTIKI;8909545951;Ne;3;0;0;3
7460;Paslaptis;FRUTIKI;3963816472;Ne;10;4;0;14
7461;Paslaptis;FRUTIKI;5809630456;Ne;0;4;0;4
7462;Paslaptis;FRUTIKI;6764142182;Ne;3;5;0;8
7463;Paslaptis;FRUTIKI;9299390190;Ne;4;0;0;4
7464;Paslaptis;FRUTIKI;9497654214;Ne;3;0;3;6
7465;Paslaptis;FRUTIKI;1080710834;Ne;1;0;2;3
7466;Paslaptis;FRUTIKI;5480407965;Ne;2;6;1;9
7467;Paslaptis;KALAMBURIKI;1029321312;Ne;0;5;0;5
7468;Paslaptis;KALAMBURIKI;5852939221;Ne;0;4;2;6
7469;Paslaptis;KALAMBURIKI;3104525540;Ne;0;1;1;2
7470;Paslaptis;KALAMBURIKI;3398729758;Ne;0;0;6;6
7471;Paslaptis;KALAMBURIKI;7672102974;Ne;3;5;0;8
7472;Paslaptis;KALAMBURIKI;9100003209;Ne;0;4;0;4
7473;Paslaptis;KALAMBURIKI;3984799090;Ne;5;1;3;9
7474;Paslaptis;KALAMBURIKI;5886364670;Ne;2;0;0;2
7475;Paslaptis;KALAMBURIKI;9066462355;Ne;0;1;0;1
7476;Paslaptis;KALAMBURIKI;2675089401;Ne;6;0;0;6
7477;Paslaptis;KALAMBURIKI;1557783684;Ne;0;6;0;6
7478;Paslaptis;KALAMBURIKI;8895770223;Ne;0;2;2;4
7479;Paslaptis;KALAMBURIKI;5206529350;Ne;0;1;3;4
7480;Paslaptis;KALAMBURIKI;5456011928;Ne;0;9;0;9
7481;Paslaptis;KALAMBURIKI;8717111488;Ne;3;0;3;6
7482;Paslaptis;KALAMBURIKI;5646806136;Ne;0;0;4;4
7483;Paslaptis;KALAMBURIKI;6098345982;Ne;0;1;1;2
7484;Paslaptis;KALAMBURIKI;4810686225;Ne;0;1;6;7
7485;Paslaptis;KALAMBURIKI;8296575784;Ne;10;0;0;10
7486;Paslaptis;KALAMBURIKI;7638521198;Ne;0;4;1;5
7487;Pasakaitė;Vieversėlių;5162170061;Ne;0;0;4;4
7488;Pasakaitė;Vieversėlių;6795204239;Ne;0;6;2;8
7489;Pasakaitė;Vieversėlių;8559244062;Ne;5;0;0;5
7490;Pasakaitė;Vieversėlių;4316883215;Ne;0;1;0;1
7491;Pasakaitė;Vieversėlių;6682010485;Ne;0;4;0;4
7492;Pasakaitė;Vieversėlių;8478538959;Ne;0;19;0;19
7493;Pasakaitė;Vieversėlių;5279719152;Ne;15;4;0;19
7494;Pasakaitė;Vieversėlių;4098119950;Ne;0;5;0;5
7495;Pasakaitė;Vieversėlių;6160327808;Ne;5;0;4;9
7496;Pasakaitė;Vieversėlių;1705913604;Ne;9;0;2;11
7497;Pasakaitė;Vieversėlių;7399335037;Taip;0;3;0;3
7498;Pasakaitė;Vieversėlių;7885958426;Ne;11;4;0;15
7499;Pasakaitė;Vieversėlių;2041179927;Ne;12;3;0;15
7500;Pasakaitė;Vieversėlių;7965916747;Ne;9;5;0;14
7501;Pasakaitė;Vieversėlių;1279728451;Ne;5;0;5;10
7502;Pasakaitė;Vieversėlių;2584717150;Ne;15;0;0;15
7503;Pasakaitė;Vieversėlių;4397797616;Ne;14;0;0;14
7504;Pasakaitė;Vieversėlių;4659277297;Ne;4;10;0;14
7505;Pasakaitė;Vieversėlių;2899659479;Ne;0;0;7;7
7506;Pasakaitė;Vieversėlių;8160163060;Ne;4;0;1;5
7507;Pasakaitė;Vieversėlių;8350808883;Ne;5;0;4;9
7508;Pasakaitė;Vieversėlių;1122248122;Ne;0;19;0;19
7509;Pasakaitė;Vieversėlių;9114337491;Ne;0;4;0;4
7510;Pasakaitė;Vieversėlių;2801785334;Ne;14;0;0;14
7511;Pasakaitė;Spindulėlių;1697755753;Ne;0;10;0;10
7512;Pasakaitė;Spindulėlių;8105641645;Ne;0;5;1;6
7513;Pasakaitė;Spindulėlių;5791927811;Taip;0;25;0;25
7514;Pasakaitė;Spindulėlių;5094404397;Taip;0;25;0;25
7515;Pasakaitė;Spindulėlių;9870015737;Ne;0;6;0;6
7516;Pasakaitė;Spindulėlių;7474100735;Ne;0;6;0;6
7517;Pasakaitė;Spindulėlių;2733800758;Ne;4;0;0;4
7518;Pasakaitė;Spindulėlių;6256000265;Ne;9;6;0;15
7519;Pasakaitė;Spindulėlių;2891089579;Ne;9;6;0;15
7520;Pasakaitė;Spindulėlių;3381303531;Ne;7;0;0;7
7521;Pasakaitė;Spindulėlių;3652896053;Ne;8;0;1;9
7522;Pasakaitė;Spindulėlių;7265623955;Ne;23;0;0;23
7523;Pasakaitė;Spindulėlių;1564611671;Ne;10;6;0;16
7524;Pasakaitė;Spindulėlių;3283593388;Ne;15;0;0;15
7525;Pasakaitė;Spindulėlių;4268438476;Ne;6;6;1;13
7526;Pasakaitė;Spindulėlių;2340908210;Ne;0;10;0;10
7527;Pasakaitė;Spindulėlių;6229020982;Ne;0;11;1;12
7528;Pasakaitė;Spindulėlių;2278658674;Ne;0;6;0;6
7529;Pasakaitė;Spindulėlių;9982451343;Ne;0;19;0;19
7530;Pasakaitė;Spindulėlių;5745073940;Ne;13;0;1;14
7531;Pasakaitė;Spindulėlių;5180059311;Ne;0;10;0;10
7532;Pasakaitė;Spindulėlių;6745120294;Ne;0;6;0;6
7533;Pasakaitė;Pasagėlių;2810892060;Ne;0;1;2;3
7534;Pasakaitė;Pasagėlių;9895144528;Ne;0;10;0;10
7535;Pasakaitė;Pasagėlių;6609127382;Ne;0;0;3;3
7536;Pasakaitė;Pasagėlių;9409907631;Ne;0;4;0;4
7537;Pasakaitė;Pasagėlių;5589440439;Ne;5;4;0;9
7538;Pasakaitė;Pasagėlių;5959875562;Ne;0;0;7;7
7539;Pasakaitė;Pasagėlių;3355268509;Ne;0;7;0;7
7540;Pasakaitė;Pasagėlių;1959599606;Ne;0;3;1;4
7541;Pasakaitė;Pasagėlių;7440327561;Ne;0;9;0;9
7542;Pasakaitė;Pasagėlių;6325408070;Taip;0;5;0;5
7543;Pasakaitė;Pasagėlių;9238905834;Taip;10;6;0;16
7544;Pasakaitė;Pasagėlių;4826492004;Ne;0;4;0;4
7545;Pasakaitė;Pasagėlių;7666033916;Ne;5;1;0;6
7546;Pasakaitė;Pasagėlių;5540251866;Ne;0;4;0;4
7547;Pasakaitė;Pasagėlių;7219080600;Ne;0;8;0;8
7548;Pasakaitė;Pasagėlių;8264189678;Ne;0;2;0;2
7549;Pasakaitė;Pasagėlių;2341175137;Ne;0;4;3;7
7550;Pasakaitė;Pasagėlių;8165055476;Ne;0;7;0;7
7551;Pasakaitė;Pasagėlių;7360801624;Ne;7;0;0;7
7552;Pasakaitė;Pasagėlių;5617173998;Ne;0;2;1;3
7553;Pasakaitė;Pasagėlių;5034077389;Ne;0;4;0;4
7554;Pasakaitė;Pasagėlių;9645230615;Ne;0;1;1;2
7555;Pasakaitė;Švyturėlių;7702359586;Ne;0;4;3;7
7556;Pasakaitė;Švyturėlių;6847782430;Ne;0;11;0;11
7557;Pasakaitė;Švyturėlių;4728731352;Ne;0;0;2;2
7558;Pasakaitė;Švyturėlių;2404448954;Ne;0;0;1;1
7559;Pasakaitė;Švyturėlių;9821617981;Ne;5;0;3;8
7560;Pasakaitė;Švyturėlių;2329827275;Ne;4;0;1;5
7561;Pasakaitė;Švyturėlių;2933474317;Ne;0;3;1;4
7562;Pasakaitė;Švyturėlių;5498393070;Ne;10;2;0;12
7563;Pasakaitė;Švyturėlių;9012098645;Ne;10;2;0;12
7564;Pasakaitė;Švyturėlių;3417077517;Ne;4;0;0;4
7565;Pasakaitė;Švyturėlių;1793453325;Ne;0;3;0;3
7566;Pasakaitė;Švyturėlių;1384552110;Taip;5;0;0;5
7567;Pasakaitė;Švyturėlių;4694818333;Ne;0;3;0;3
7568;Pasakaitė;Švyturėlių;5115067331;Ne;0;1;0;1
7569;Pasakaitė;Švyturėlių;6522727154;Ne;10;4;0;14
7570;Pasakaitė;Švyturėlių;8711237946;Ne;0;1;2;3
7571;Pasakaitė;Švyturėlių;4977052991;Ne;5;3;0;8
7572;Pasakaitė;Švyturėlių;7604996145;Ne;14;0;0;14
7573;Pasakaitė;Švyturėlių;4144569088;Ne;3;0;0;3
7574;Pasakaitė;Švyturėlių;7539851375;Ne;2;2;0;4
7575;Pasakaitė;Švyturėlių;2546550685;Ne;0;0;1;1
7576;Pasakaitė;Švyturėlių;8381083251;Ne;19;0;0;19
7577;Pasakaitė;Švyturėlių;9606533767;Ne;3;4;2;9
7578;Pasakaitė;Švyturėlių;2902368705;Ne;0;14;0;14
7579;Pasakaitė;Švyturėlių;3659371923;Ne;0;2;1;3
7580;Pasakaitė;Kodėlčiukų;8662488739;Ne;0;2;0;2
7581;Pasakaitė;Kodėlčiukų;9972985920;Taip;4;2;1;7
7582;Pasakaitė;Kodėlčiukų;5699688792;Ne;9;4;1;14
7583;Pasakaitė;Kodėlčiukų;9441990175;Taip;6;3;4;13
7584;Pasakaitė;Kodėlčiukų;1588525307;Ne;0;0;2;2
7585;Pasakaitė;Kodėlčiukų;4485053261;Ne;5;0;5;10
7586;Pasakaitė;Kodėlčiukų;9351971114;Ne;0;4;1;5
7587;Pasakaitė;Kodėlčiukų;2303884875;Ne;8;1;0;9
7588;Pasakaitė;Kodėlčiukų;9543262464;Ne;0;3;0;3
7589;Pasakaitė;Kodėlčiukų;4878562841;Ne;7;0;1;8
7590;Pasakaitė;Kodėlčiukų;2994653871;Ne;6;0;0;6
7591;Pasakaitė;Kodėlčiukų;4328440534;Ne;0;0;3;3
7592;Pasakaitė;Kodėlčiukų;4881361200;Ne;5;0;0;5
7593;Pasakaitė;Kodėlčiukų;2389832646;Ne;0;3;0;3
7594;Pasakaitė;Kodėlčiukų;7138417196;Ne;0;2;2;4
7595;Pasakaitė;Kodėlčiukų;5581264184;Ne;0;9;0;9
7596;Pasakaitė;Kodėlčiukų;8037316673;Ne;11;3;0;14
7597;Pasakaitė;Kodėlčiukų;5732009054;Ne;0;7;0;7
7598;Pasakaitė;Kodėlčiukų;2407824666;Ne;0;3;2;5
7599;Pasakaitė;Kodėlčiukų;6755983130;Ne;8;0;0;8
7600;Pasakaitė;Kodėlčiukų;2476010561;Ne;0;6;0;6
7601;Pasakaitė;Kodėlčiukų;3925034196;Ne;0;8;0;8
7602;Pasakaitė;Kodėlčiukų;9512782063;Ne;0;2;0;2
7603;Pasakaitė;Gudručių;1513903341;Ne;0;5;0;5
7604;Pasakaitė;Gudručių;3231283338;Ne;3;5;1;9
7605;Pasakaitė;Gudručių;6736879757;Ne;5;5;0;10
7606;Pasakaitė;Gudručių;2194313054;Ne;0;6;0;6
7607;Pasakaitė;Gudručių;7963057831;Ne;0;5;0;5
7608;Pasakaitė;Gudručių;9543991684;Ne;3;5;0;8
7609;Pasakaitė;Gudručių;3444442287;Ne;4;4;1;9
7610;Pasakaitė;Gudručių;3680596008;Ne;0;4;0;4
7611;Pasakaitė;Gudručių;4191875802;Ne;0;1;0;1
7612;Pasakaitė;Gudručių;4882856664;Ne;0;4;1;5
7613;Pasakaitė;Gudručių;5485965486;Ne;4;3;0;7
7614;Pasakaitė;Gudručių;7685647972;Ne;5;4;0;9
7615;Pasakaitė;Gudručių;5953162958;Ne;0;3;3;6
7616;Pasakaitė;Gudručių;2849753418;Ne;0;1;1;2
7617;Pasakaitė;Gudručių;9018830962;Ne;4;4;0;8
7618;Pasakaitė;Gudručių;6459145539;Ne;0;5;0;5
7619;Pasakaitė;Gudručių;5948958906;Ne;0;4;0;4
7620;Pasakaitė;Gudručių;1060914693;Ne;3;3;0;6
7621;Pasakaitė;Gudručių;5020801150;Ne;0;4;0;4
7622;Pasakaitė;Gudručių;3710143250;Ne;0;4;1;5
7623;Pasakaitė;Gudručių;4864779439;Taip;0;4;6;10
7624;Pasakaitė;Gudručių;1533259056;Ne;0;4;0;4
7625;Pasakaitė;Gudručių;8223662339;Ne;0;4;0;4
7626;Pasakaitė;Čiulbonėlių;7526264241;Ne;0;4;2;6
7627;Pasakaitė;Čiulbonėlių;3541877287;Ne;0;4;0;4
7628;Pasakaitė;Čiulbonėlių;4974486850;Ne;0;4;2;6
7629;Pasakaitė;Čiulbonėlių;7607522887;Ne;0;4;0;4
7630;Pasakaitė;Čiulbonėlių;3606601644;Ne;0;4;0;4
7631;Pasakaitė;Čiulbonėlių;3579498202;Ne;0;4;0;4
7632;Pasakaitė;Čiulbonėlių;1220619991;Ne;0;3;0;3
7633;Pasakaitė;Čiulbonėlių;7790937149;Ne;0;4;0;4
7634;Pasakaitė;Čiulbonėlių;3400305768;Ne;0;4;0;4
7635;Pasakaitė;Čiulbonėlių;1619513932;Taip;5;3;0;8
7636;Pasakaitė;Čiulbonėlių;4604843442;Ne;0;11;0;11
7637;Pasakaitė;Čiulbonėlių;2751828639;Ne;0;4;0;4
7638;Pasakaitė;Čiulbonėlių;1962693480;Ne;0;3;0;3
7639;Pasakaitė;Čiulbonėlių;4758073190;Ne;0;4;0;4
7640;Pasakaitė;Čiulbonėlių;5628746801;Ne;0;2;2;4
7641;Pasakaitė;Čiulbonėlių;6015360076;Ne;0;4;0;4
7642;Pasakaitė;Čiulbonėlių;1056358241;Ne;5;4;0;9
7643;Pasakaitė;Čiulbonėlių;2652882309;Ne;0;4;0;4
7644;Pasakaitė;Čiulbonėlių;1449037968;Ne;6;4;0;10
7645;Pasakaitė;Čiulbonėlių;2563725297;Ne;0;4;0;4
7646;Pasakaitė;Čiulbonėlių;6714500298;Ne;0;2;0;2
7647;Pasakaitė;Čiulbonėlių;1184513606;Ne;0;2;1;3
7648;Pasakaitė;"Verpstelių ";7621306769;Ne;0;5;0;5
7649;Pasakaitė;"Verpstelių ";4946855684;Ne;0;7;0;7
7650;Pasakaitė;"Verpstelių ";5556362727;Ne;0;0;2;2
7651;Pasakaitė;"Verpstelių ";7759051761;Taip;0;8;0;8
7652;Pasakaitė;"Verpstelių ";8315840473;Ne;0;0;2;2
7653;Pasakaitė;"Verpstelių ";1744216870;Ne;0;0;4;4
7654;Pasakaitė;"Verpstelių ";1425166722;Ne;0;0;2;2
7655;Pasakaitė;"Verpstelių ";7813221735;Ne;0;11;0;11
7656;Pasakaitė;"Verpstelių ";9166649594;Ne;0;3;0;3
7657;Pasakaitė;"Verpstelių ";4246461594;Ne;0;0;6;6
7658;Pasakaitė;"Verpstelių ";1963102227;Ne;0;0;5;5
7659;Pasakaitė;"Verpstelių ";8267725352;Ne;0;0;3;3
7660;Pasakaitė;"Verpstelių ";8562284745;Ne;0;6;0;6
7661;Pasakaitė;"Verpstelių ";1041405418;Ne;0;11;0;11
7662;Pasakaitė;"Verpstelių ";7976921380;Ne;0;4;0;4
7663;Pasakaitė;"Verpstelių ";2505815026;Ne;0;0;8;8
7664;Pasakaitė;"Verpstelių ";5413457806;Ne;0;0;1;1
7665;Pasakaitė;"Verpstelių ";1115383380;Ne;19;0;0;19
7666;Pasakaitė;"Verpstelių ";2714905466;Ne;5;0;3;8
7667;Pasakaitė;"Verpstelių ";9226989209;Ne;0;3;0;3
7668;Pasakaitė;"Verpstelių ";8927014508;Ne;0;0;4;4
7669;Pasakaitė;Smalsučiai;7557414266;Ne;0;2;0;2
7670;Pasakaitė;Smalsučiai;7994712153;Ne;5;0;8;13
7671;Pasakaitė;Smalsučiai;1271645870;Ne;0;0;9;9
7672;Pasakaitė;Smalsučiai;6266150515;Taip;0;19;0;19
7673;Pasakaitė;Smalsučiai;3359676586;Ne;12;0;0;12
7674;Pasakaitė;Smalsučiai;3041099329;Ne;0;0;1;1
7675;Pasakaitė;Smalsučiai;6446178994;Ne;4;0;0;4
7676;Pasakaitė;Smalsučiai;6803651332;Ne;6;0;1;7
7677;Pasakaitė;Smalsučiai;3191302999;Ne;0;4;3;7
7678;Pasakaitė;Smalsučiai;2301346026;Ne;0;0;4;4
7679;Pasakaitė;Smalsučiai;7515747335;Taip;0;15;0;15
7680;Pasakaitė;Smalsučiai;8398100438;Ne;13;0;1;14
7681;Pasakaitė;Smalsučiai;4413770207;Ne;5;4;1;10
7682;Pasakaitė;Smalsučiai;8181710494;Ne;0;0;6;6
7683;Pasakaitė;"Čiauškučiai ";7585900157;Ne;2;0;0;2
7684;Pasakaitė;"Čiauškučiai ";2182900696;Ne;0;19;0;19
7685;Pasakaitė;"Čiauškučiai ";7378144738;Ne;17;1;0;18
7686;Pasakaitė;"Čiauškučiai ";9335770325;Ne;6;4;0;10
7687;Pasakaitė;"Čiauškučiai ";2780813752;Ne;0;19;0;19
7688;Pasakaitė;"Čiauškučiai ";5202153993;Taip;0;19;0;19
7689;Pasakaitė;"Čiauškučiai ";3329580710;Ne;7;0;0;7
7690;Pasakaitė;"Čiauškučiai ";4189572117;Ne;15;3;0;18
7691;Pasakaitė;"Čiauškučiai ";3931651662;Ne;0;0;1;1
7692;Pasakaitė;"Čiauškučiai ";6756484192;Ne;11;2;0;13
7693;Pasakaitė;"Čiauškučiai ";6033454938;Ne;4;0;0;4
7694;Pasakaitė;"Čiauškučiai ";7118164408;Ne;15;2;0;17
7695;Pasakaitė;"Čiauškučiai ";9823031346;Ne;13;3;0;16
7696;Pasakaitė;"Čiauškučiai ";9757659268;Ne;4;0;1;5
7697;Pasakaitė;Pabiručiai;1453976284;Ne;0;6;0;6
7698;Pasakaitė;Pabiručiai;9790988677;Ne;0;4;0;4
7699;Pasakaitė;Pabiručiai;5439936572;Ne;0;11;0;11
7700;Pasakaitė;Pabiručiai;3466308130;Ne;19;0;0;19
7701;Pasakaitė;Pabiručiai;9402238675;Ne;7;4;0;11
7702;Pasakaitė;Pabiručiai;4852610052;Ne;0;13;0;13
7703;Pasakaitė;Pabiručiai;9285254916;Ne;0;0;1;1
7704;Pasakaitė;Pabiručiai;6025275102;Ne;0;9;0;9
7705;Pasakaitė;Pabiručiai;7902661691;Ne;10;0;0;10
7706;Pasakaitė;Pabiručiai;2398839782;Ne;0;0;1;1
7707;Pasakaitė;Pabiručiai;3552340609;Ne;12;6;0;18
7708;Pasakaitė;Pabiručiai;2332609415;Ne;13;0;2;15
7709;Pasakaitė;Pabiručiai;4081701824;Ne;0;10;1;11
7710;Pasakaitė;Pabiručiai;8340813023;Ne;3;0;0;3
7711;Pasakaitė;Pabiručiai;3070478547;Ne;0;19;0;19
7712;Pasakaitė;Linksmučiai;8252123824;Ne;5;0;3;8
7713;Pasakaitė;Linksmučiai;4444725869;Ne;3;0;3;6
7714;Pasakaitė;Linksmučiai;3049219840;Ne;10;0;1;11
7715;Pasakaitė;Linksmučiai;9190078546;Ne;0;0;3;3
7716;Pasakaitė;Linksmučiai;5274145775;Ne;11;0;1;12
7717;Pasakaitė;Linksmučiai;8399160991;Ne;0;0;2;2
7718;Pasakaitė;Linksmučiai;9690867215;Ne;10;4;0;14
7719;Pasakaitė;Linksmučiai;1117035233;Ne;5;0;1;6
7720;Pasakaitė;Linksmučiai;5058070480;Ne;0;9;0;9
7721;Pasakaitė;Linksmučiai;9311649698;Ne;0;6;1;7
7722;Pasakaitė;Linksmučiai;4307883488;Ne;0;8;0;8
7723;Pasakaitė;Linksmučiai;3691817711;Ne;0;3;0;3
7724;Pelenė;Varpelis;2647876561;Ne;0;3;0;3
7725;Pelenė;Varpelis;8807342148;Ne;10;0;0;10
7726;Pelenė;Varpelis;5697826755;Ne;1;2;0;3
7727;Pelenė;Varpelis;4004975235;Ne;9;1;0;10
7728;Pelenė;Varpelis;8790613872;Ne;11;0;0;11
7729;Pelenė;Varpelis;2487632125;Ne;4;4;0;8
7730;Pelenė;Varpelis;5228983908;Ne;0;2;0;2
7731;Pelenė;Varpelis;3174009848;Ne;0;3;2;5
7732;Pelenė;Varpelis;6524101295;Ne;1;4;0;5
7733;Pelenė;Varpelis;4373886054;Ne;0;1;0;1
7734;Pelenė;Varpelis;8038559319;Ne;0;4;0;4
7735;Pelenė;Varpelis;7578318198;Ne;7;0;0;7
7736;Pelenė;Varpelis;1080017906;Ne;0;3;0;3
7737;Pelenė;Varpelis;4777496709;Ne;4;0;2;6
7738;Pelenė;Varpelis;9447223913;Ne;17;0;0;17
7739;Pelenė;Varpelis;6894978459;Ne;6;6;0;12
7740;Pelenė;Varpelis;6864263698;Ne;19;0;0;19
7741;Pelenė;Varpelis;9884224592;Ne;9;0;1;10
7742;Pelenė;Saulutės;4961852594;Ne;0;0;5;5
7743;Pelenė;Saulutės;8718308575;Ne;0;26;0;26
7744;Pelenė;Saulutės;6867256280;Ne;22;0;0;22
7745;Pelenė;Saulutės;4396011355;Ne;5;4;4;13
7746;Pelenė;Saulutės;9639135363;Ne;0;3;0;3
7747;Pelenė;Saulutės;5743530682;Ne;0;4;0;4
7748;Pelenė;Saulutės;6304818782;Ne;0;8;0;8
7749;Pelenė;Saulutės;1975574464;Ne;10;0;0;10
7750;Pelenė;Saulutės;3549088727;Ne;10;0;1;11
7751;Pelenė;Saulutės;5024793693;Ne;0;0;4;4
7752;Pelenė;Saulutės;2952739501;Ne;18;1;0;19
7753;Pelenė;Saulutės;6567413229;Ne;6;0;1;7
7754;Pelenė;Saulutės;6231387335;Ne;0;22;0;22
7755;Pelenė;Saulutės;4068236246;Ne;17;0;0;17
7756;Pelenė;Saulutės;3700618977;Ne;6;0;3;9
7757;Pelenė;Saulutės;5872711862;Ne;4;0;2;6
7758;Pelenė;Saulutės;6081335781;Ne;0;8;0;8
7759;Pelenė;Saulutės;2083848693;Ne;7;0;1;8
7760;Pelenė;Raktelis;4023923887;Ne;14;0;0;14
7761;Pelenė;Raktelis;4859437855;Ne;1;10;0;11
7762;Pelenė;Raktelis;5028095861;Ne;18;0;0;18
7763;Pelenė;Raktelis;8202196292;Ne;0;9;0;9
7764;Pelenė;Raktelis;5926700157;Ne;10;6;0;16
7765;Pelenė;Raktelis;5762403752;Ne;0;13;0;13
7766;Pelenė;Raktelis;7926586349;Ne;11;0;0;11
7767;Pelenė;Raktelis;2986690431;Ne;3;0;0;3
7768;Pelenė;Raktelis;4660385383;Ne;16;0;0;16
7769;Pelenė;Raktelis;4305733824;Ne;5;5;0;10
7770;Pelenė;Raktelis;5066227318;Ne;3;0;0;3
7771;Pelenė;Raktelis;8862429244;Ne;11;0;0;11
7772;Pelenė;Raktelis;9505945890;Ne;0;8;0;8
7773;Pelenė;Raktelis;8961082265;Ne;0;7;0;7
7774;Pelenė;Raktelis;2882716674;Ne;0;6;0;6
7775;Pelenė;Raktelis;4051874126;Ne;0;7;0;7
7776;Pelenė;Raktelis;5970146724;Ne;16;0;0;16
7777;Pelenė;Raktelis;1424479862;Ne;19;0;0;19
7778;Pelenė;Raktelis;1197137607;Ne;6;0;0;6
7779;Pelenė;Raktelis;9769835612;Ne;7;0;0;7
7780;Pelenė;Žvaigždutės;7064742769;Ne;5;0;0;5
7781;Pelenė;Žvaigždutės;9473901831;Ne;4;3;0;7
7782;Pelenė;Žvaigždutės;2476080951;Ne;5;0;0;5
7783;Pelenė;Žvaigždutės;5587759166;Ne;0;2;0;2
7784;Pelenė;Žvaigždutės;5548367924;Ne;13;0;0;13
7785;Pelenė;Žvaigždutės;5031778158;Ne;0;6;0;6
7786;Pelenė;Žvaigždutės;4056676361;Ne;0;1;0;1
7787;Pelenė;Žvaigždutės;4602503400;Ne;0;8;0;8
7788;Pelenė;Žvaigždutės;2555464779;Ne;0;6;0;6
7789;Pelenė;Žvaigždutės;9530531472;Ne;0;8;0;8
7790;Pelenė;Žvaigždutės;2040256240;Ne;3;0;0;3
7791;Pelenė;Žvaigždutės;4870187198;Ne;2;5;0;7
7792;Pelenė;Žvaigždutės;7640768043;Ne;14;0;0;14
7793;Pelenė;Žvaigždutės;7614130590;Ne;1;3;0;4
7794;Pelenė;Žvaigždutės;4856039707;Ne;0;4;0;4
7795;Pelenė;Žvaigždutės;5894429453;Ne;2;0;0;2
7796;Pelenė;Žvaigždutės;4737217659;Taip;0;3;0;3
7797;Pelenė;Žvaigždutės;4109516555;Ne;9;5;0;14
7798;Pelenė;Žvaigždutės;5357701072;Ne;18;0;0;18
7799;Pelenė;Žvaigždutės;7426299485;Ne;5;0;0;5
7800;Pelenė;Žvaigždutės;1136986980;Ne;5;0;0;5
7801;Pelenė;Nykštukas;1060619471;Ne;0;1;1;2
7802;Pelenė;Nykštukas;9195113444;Ne;0;1;1;2
7803;Pelenė;Nykštukas;5749399210;Ne;0;4;1;5
7804;Pelenė;Nykštukas;4448592497;Ne;6;4;0;10
7805;Pelenė;Nykštukas;9075193730;Ne;0;2;1;3
7806;Pelenė;Nykštukas;5333802902;Ne;0;8;0;8
7807;Pelenė;Nykštukas;4591637887;Ne;5;4;0;9
7808;Pelenė;Nykštukas;7088493729;Ne;2;1;0;3
7809;Pelenė;Nykštukas;4090532624;Ne;3;6;0;9
7810;Pelenė;Nykštukas;8123162647;Ne;0;0;1;1
7811;Pelenė;Nykštukas;3573543545;Ne;0;6;0;6
7812;Pelenė;Nykštukas;7659625628;Ne;0;4;4;8
7813;Pelenė;Nykštukas;6375060159;Ne;0;8;0;8
7814;Pelenė;Nykštukas;2210314952;Ne;0;10;0;10
7815;Pelenė;Nykštukas;6419661741;Ne;0;1;2;3
7816;Pelenė;Nykštukas;1049199372;Ne;0;2;0;2
7817;Pelenė;Nykštukas;5063098703;Ne;0;2;0;2
7818;Pelenė;Nykštukas;4089199552;Ne;6;4;6;16
7819;Pelenė;Nykštukas;6038229659;Ne;1;4;1;6
7820;Pelenė;Nykštukas;2241816838;Ne;1;2;2;5
7821;Pelenė;Nykštukas;5389865440;Ne;2;4;0;6
7822;Pelenė;Žirniukai;8529178313;Ne;3;0;0;3
7823;Pelenė;Žirniukai;2270989478;Ne;0;17;0;17
7824;Pelenė;Žirniukai;6661371876;Ne;9;0;0;9
7825;Pelenė;Žirniukai;2590035984;Ne;0;7;0;7
7826;Pelenė;Žirniukai;6046921077;Ne;0;5;0;5
7827;Pelenė;Žirniukai;9601582419;Ne;17;0;0;17
7828;Pelenė;Žirniukai;4703442187;Ne;7;0;0;7
7829;Pelenė;Žirniukai;7959433937;Ne;15;0;0;15
7830;Pelenė;Žirniukai;7057752202;Ne;8;0;0;8
7831;Pelenė;Žirniukai;7399112026;Ne;0;10;0;10
7832;Pelenė;Žirniukai;5686182866;Ne;13;0;0;13
7833;Pelenė;Žirniukai;2443906444;Ne;11;0;0;11
7834;Pelenė;Žirniukai;3863839750;Ne;11;0;0;11
7835;Pelenė;Žirniukai;5922348478;Ne;12;0;0;12
7836;Pelenė;Žirniukai;1313425695;Ne;3;4;0;7
7837;Pelenė;Žirniukai;2068793184;Ne;0;17;0;17
7838;Pelenė;Žirniukai;7383544475;Ne;0;18;0;18
7839;Pelenė;Žirniukai;1595627222;Ne;0;13;0;13
7840;Pelenė;Žirniukai;2438266396;Ne;0;8;0;8
7841;Pelenė;Žirniukai;1486025741;Ne;7;0;0;7
7842;Pelenė;Žirniukai;8685140364;Ne;7;9;0;16
7843;Pelenė;Lašeliai;7017031073;Ne;0;0;1;1
7844;Pelenė;Lašeliai;9018211726;Ne;0;4;0;4
7845;Pelenė;Lašeliai;9313153383;Ne;0;14;0;14
7846;Pelenė;Lašeliai;5836118223;Ne;11;3;1;15
7847;Pelenė;Lašeliai;6316640679;Ne;5;2;2;9
7848;Pelenė;Lašeliai;1711603372;Ne;9;8;0;17
7849;Pelenė;Lašeliai;1944933777;Ne;0;15;0;15
7850;Pelenė;Lašeliai;2303618074;Ne;0;3;3;6
7851;Pelenė;Lašeliai;6167965418;Ne;17;0;0;17
7852;Pelenė;Lašeliai;2765650058;Ne;4;0;0;4
7853;Pelenė;Lašeliai;8841183816;Ne;5;0;1;6
7854;Pelenė;Lašeliai;4431474395;Ne;10;0;0;10
7855;Pelenė;Lašeliai;9097123374;Ne;4;0;0;4
7856;Pelenė;Lašeliai;9162252512;Ne;7;2;0;9
7857;Pelenė;Lašeliai;4695104609;Ne;6;4;0;10
7858;Pelenė;Lašeliai;7148956863;Ne;5;6;0;11
7859;Pelenė;Lašeliai;3663288138;Ne;0;4;2;6
7860;Pelenė;Lašeliai;4148108151;Ne;0;9;0;9
7861;Pelenė;Lašeliai;1303066945;Ne;6;4;0;10
7862;Pelenė;Lašeliai;3563882751;Ne;0;7;0;7
7863;Pelenė;Grūdelis;6790396551;Ne;0;3;0;3
7864;Pelenė;Grūdelis;6221703608;Ne;0;2;0;2
7865;Pelenė;Grūdelis;1278011268;Ne;5;2;0;7
7866;Pelenė;Grūdelis;7880284433;Ne;0;4;0;4
7867;Pelenė;Grūdelis;4989239822;Ne;0;2;0;2
7868;Pelenė;Grūdelis;2426412323;Ne;4;3;0;7
7869;Pelenė;Grūdelis;6481466282;Ne;3;3;0;6
7870;Pelenė;Grūdelis;6707167720;Ne;0;1;1;2
7871;Pelenė;Grūdelis;6267178572;Ne;0;13;0;13
7872;Pelenė;Grūdelis;1468658102;Ne;9;4;0;13
7873;Pelenė;Grūdelis;1573848786;Ne;0;3;1;4
7874;Pelenė;Grūdelis;7985634731;Ne;0;4;1;5
7875;Pelenė;Grūdelis;1555782878;Ne;0;3;1;4
7876;Pelenė;Grūdelis;7858530013;Ne;0;8;0;8
7877;Pelenė;Grūdelis;7702502252;Ne;0;6;0;6
7878;Pelenė;Grūdelis;6678273450;Ne;3;4;0;7
7879;Pelenė;Grūdelis;6648966721;Ne;11;4;0;15
7880;Pelenė;Grūdelis;2544725334;Ne;0;1;0;1
7881;Pelenė;Grūdelis;8722776919;Taip;0;1;0;1
7882;Pelenė;Grūdelis;4717895416;Taip;0;1;0;1
7883;Pelenė;Braškytė;8504675439;Ne;0;4;0;4
7884;Pelenė;Braškytė;6306403720;Ne;10;5;0;15
7885;Pelenė;Braškytė;5243889672;Ne;9;0;0;9
7886;Pelenė;Braškytė;6213281783;Ne;5;0;0;5
7887;Pelenė;Braškytė;9123459933;Ne;2;0;0;2
7888;Pelenė;Braškytė;6325462265;Ne;3;2;0;5
7889;Pelenė;Braškytė;1124834153;Ne;4;2;0;6
7890;Pelenė;Braškytė;2425992275;Ne;26;0;0;26
7891;Pelenė;Braškytė;5215324103;Ne;26;0;0;26
7892;Pelenė;Braškytė;1783529770;Ne;0;1;0;1
7893;Pelenė;Braškytė;6181640181;Ne;3;3;0;6
7894;Pelenė;Braškytė;7143533875;Ne;0;2;0;2
7895;Pelenė;Braškytė;6154342149;Ne;0;1;0;1
7896;Pelenė;Braškytė;7171545733;Ne;0;11;0;11
7897;Pelenė;Braškytė;6025404134;Ne;0;9;0;9
7898;Pelenė;Boružėlės;4955162765;Ne;0;0;12;12
7899;Pelenė;Boružėlės;3200796745;Ne;7;0;6;13
7900;Pelenė;Boružėlės;6427008429;Ne;5;3;0;8
7901;Pelenė;Boružėlės;1075220572;Ne;7;0;0;7
7902;Pelenė;Boružėlės;8325318483;Ne;12;0;0;12
7903;Pelenė;Boružėlės;3677861360;Ne;6;0;1;7
7904;Pelenė;Boružėlės;8732297405;Ne;11;0;0;11
7905;Pelenė;Boružėlės;5845118981;Ne;2;0;5;7
7906;Pelenė;Boružėlės;8942422475;Ne;7;0;3;10
7907;Pelenė;Boružėlės;9554893953;Taip;19;0;0;19
7908;Pelenė;Boružėlės;7320738947;Ne;9;0;0;9
7909;Pelenė;Boružėlės;3004297722;Ne;14;3;0;17
7910;Pelenė;Boružėlės;7794147237;Ne;11;3;0;14
7911;Pelenė;Boružėlės;9772543894;Ne;12;0;0;12
7912;Pelenė;Boružėlės;6226160316;Ne;4;6;3;13
7913;Pelenė;Saldainiukai;2689903631;Ne;0;15;0;15
7914;Pelenė;Saldainiukai;4982869687;Ne;0;0;1;1
7915;Pelenė;Saldainiukai;3499827987;Ne;4;0;3;7
7916;Pelenė;Saldainiukai;8165766331;Ne;6;4;0;10
7917;Pelenė;Saldainiukai;2096373376;Ne;9;0;1;10
7918;Pelenė;Saldainiukai;1384382692;Ne;3;0;6;9
7919;Pelenė;Saldainiukai;9490816122;Ne;4;0;5;9
7920;Pelenė;Saldainiukai;4734502322;Ne;1;12;0;13
7921;Pelenė;Saldainiukai;7602432318;Ne;9;3;2;14
7922;Pelenė;Saldainiukai;2407328091;Taip;0;2;1;3
7923;Pelenė;Saldainiukai;8861981715;Ne;4;0;0;4
7924;Pelenė;Saldainiukai;7599381657;Ne;9;0;2;11
7925;Pelenė;Saldainiukai;7445137950;Ne;0;0;2;2
7926;Pelenė;Saldainiukai;2123466599;Ne;14;0;0;14
7927;Pelenė;Saldainiukai;9290443563;Ne;5;0;0;5
7928;Pelenė;Saldainiukai;2661260892;Ne;0;17;0;17
7929;Pelenė;Saldainiukai;2824244303;Ne;9;0;2;11
7930;Pelenė;Saldainiukai;1081582842;Ne;0;0;5;5
7931;Pelenė;Drugeliai;2540405047;Ne;0;4;7;11
7932;Pelenė;Drugeliai;3603352172;Ne;10;0;1;11
7933;Pelenė;Drugeliai;5084452088;Ne;0;2;0;2
7934;Pelenė;Drugeliai;9218868317;Ne;0;3;4;7
7935;Pelenė;Drugeliai;2628676128;Ne;0;7;0;7
7936;Pelenė;Drugeliai;6834792589;Ne;0;0;4;4
7937;Pelenė;Drugeliai;9810123679;Ne;0;4;0;4
7938;Pelenė;Drugeliai;1048899958;Ne;0;3;1;4
7939;Pelenė;Drugeliai;3327213856;Ne;1;4;0;5
7940;Pelenė;Drugeliai;6252972353;Ne;3;0;3;6
7941;Pelenė;Drugeliai;1274729537;Ne;0;4;0;4
7942;Pelenė;Drugeliai;1584256570;Ne;0;4;0;4
7943;Pelenė;Drugeliai;3205331614;Ne;1;4;0;5
7944;Pelenė;Drugeliai;2163737781;Ne;0;6;0;6
7945;Pelenė;Drugeliai;9004080625;Ne;0;14;0;14
7946;Pelenė;Drugeliai;7565331966;Ne;5;1;0;6
7947;Pelenė;Drugeliai;5074054534;Ne;0;6;0;6
7948;Pelenė;Drugeliai;8194354176;Ne;0;3;0;3
7949;Pelenė;Drugeliai;5579900958;Ne;7;0;0;7
7950;Pelenė;Drugeliai;9969975097;Ne;0;2;0;2
7951;Pipiras;EŽIUKAI;9728140172;Ne;0;4;0;4
7952;Pipiras;EŽIUKAI;8520454289;Ne;0;6;0;6
7953;Pipiras;EŽIUKAI;5512049762;Ne;0;4;0;4
7954;Pipiras;EŽIUKAI;5856735452;Ne;0;5;0;5
7955;Pipiras;EŽIUKAI;2267192782;Ne;0;1;0;1
7956;Pipiras;EŽIUKAI;1711168196;Ne;0;4;0;4
7957;Pipiras;EŽIUKAI;5908707752;Ne;1;4;0;5
7958;Pipiras;EŽIUKAI;4017042461;Ne;0;13;0;13
7959;Pipiras;EŽIUKAI;4725221169;Ne;0;6;0;6
7960;Pipiras;EŽIUKAI;5059203266;Ne;0;2;1;3
7961;Pipiras;EŽIUKAI;8140314304;Ne;0;3;0;3
7962;Pipiras;EŽIUKAI;8422419380;Ne;0;4;0;4
7963;Pipiras;EŽIUKAI;6791495556;Ne;8;5;0;13
7964;Pipiras;EŽIUKAI;4811029230;Ne;0;5;3;8
7965;Pipiras;EŽIUKAI;6363349541;Ne;2;6;0;8
7966;Pipiras;EŽIUKAI;1353114929;Ne;0;4;0;4
7967;Pipiras;EŽIUKAI;4426479971;Ne;0;5;0;5
7968;Pipiras;BITUTĖS;3851239592;Ne;12;4;0;16
7969;Pipiras;BITUTĖS;1645482584;Ne;0;3;0;3
7970;Pipiras;BITUTĖS;7891664385;Ne;0;6;0;6
7971;Pipiras;BITUTĖS;9050423801;Ne;0;4;0;4
7972;Pipiras;BITUTĖS;3794537946;Ne;0;0;2;2
7973;Pipiras;BITUTĖS;5047070127;Ne;11;0;0;11
7974;Pipiras;BITUTĖS;9394456452;Ne;13;4;0;17
7975;Pipiras;BITUTĖS;9610070604;Ne;1;8;0;9
7976;Pipiras;BITUTĖS;6362968454;Ne;0;1;0;1
7977;Pipiras;BITUTĖS;6273958740;Ne;5;3;0;8
7978;Pipiras;BITUTĖS;9950318827;Ne;0;4;0;4
7979;Pipiras;BITUTĖS;9733577233;Ne;10;4;0;14
7980;Pipiras;BITUTĖS;8983392098;Ne;10;4;0;14
7981;Pipiras;BITUTĖS;2337751973;Ne;0;13;0;13
7982;Pipiras;BITUTĖS;9540765088;Ne;0;4;0;4
7983;Pipiras;BITUTĖS;5735018704;Ne;0;6;0;6
7984;Pipiras;BITUTĖS;6306414173;Ne;0;4;1;5
7985;Pipiras;NYKŠTUKAI;6696824728;Taip;0;4;0;4
7986;Pipiras;NYKŠTUKAI;2016718354;Ne;0;6;0;6
7987;Pipiras;NYKŠTUKAI;1169481984;Ne;0;8;0;8
7988;Pipiras;NYKŠTUKAI;4198534687;Ne;0;8;0;8
7989;Pipiras;NYKŠTUKAI;4458730479;Ne;0;4;1;5
7990;Pipiras;NYKŠTUKAI;3980950261;Ne;0;7;0;7
7991;Pipiras;NYKŠTUKAI;7828638329;Ne;0;1;0;1
7992;Pipiras;NYKŠTUKAI;6775489564;Ne;11;4;0;15
7993;Pipiras;NYKŠTUKAI;7747049622;Ne;0;5;0;5
7994;Pipiras;NYKŠTUKAI;9892201598;Ne;0;8;0;8
7995;Pipiras;NYKŠTUKAI;7371386368;Ne;0;4;0;4
7996;Pipiras;NYKŠTUKAI;1019753152;Ne;1;6;0;7
7997;Pipiras;NYKŠTUKAI;9499869533;Ne;0;2;0;2
7998;Pipiras;NYKŠTUKAI;5141447649;Ne;0;3;0;3
7999;Pipiras;NYKŠTUKAI;9877682150;Ne;0;4;1;5
8000;Pipiras;NYKŠTUKAI;9248925267;Ne;1;6;0;7
8001;Pipiras;NYKŠTUKAI;9711147855;Ne;3;0;0;3
8002;Pipiras;NYKŠTUKAI;2120810457;Taip;0;14;0;14
8003;Pipiras;NYKŠTUKAI;7613592821;Taip;0;3;0;3
8004;Pipiras;PELĖDŽIUKAI;8985065850;Ne;4;5;0;9
8005;Pipiras;PELĖDŽIUKAI;3647356600;Ne;2;3;0;5
8006;Pipiras;PELĖDŽIUKAI;6465109403;Ne;3;4;0;7
8007;Pipiras;PELĖDŽIUKAI;6905506774;Ne;19;0;0;19
8008;Pipiras;PELĖDŽIUKAI;8040520887;Ne;0;4;0;4
8009;Pipiras;PELĖDŽIUKAI;7446225835;Ne;0;5;0;5
8010;Pipiras;PELĖDŽIUKAI;8800890503;Ne;0;5;0;5
8011;Pipiras;PELĖDŽIUKAI;6184943213;Ne;0;1;0;1
8012;Pipiras;PELĖDŽIUKAI;8028360748;Ne;0;9;0;9
8013;Pipiras;PELĖDŽIUKAI;1238280105;Ne;5;4;0;9
8014;Pipiras;PELĖDŽIUKAI;3299099535;Ne;7;4;0;11
8015;Pipiras;PELĖDŽIUKAI;5502186385;Ne;11;4;0;15
8016;Pipiras;PELĖDŽIUKAI;8707560610;Ne;0;3;0;3
8017;Pipiras;PELĖDŽIUKAI;4282267631;Ne;0;1;0;1
8018;Pipiras;PELĖDŽIUKAI;4940053409;Ne;9;0;0;9
8019;Pipiras;PELĖDŽIUKAI;2588075386;Ne;0;3;0;3
8020;Pipiras;PELĖDŽIUKAI;6666112357;Ne;0;4;0;4
8021;Pipiras;PELĖDŽIUKAI;9473056714;Ne;4;9;0;13
8022;Pipiras;DRUGELIAI;6482075896;Ne;11;1;0;12
8023;Pipiras;DRUGELIAI;6018174577;Ne;10;4;0;14
8024;Pipiras;DRUGELIAI;1393570307;Ne;10;4;2;16
8025;Pipiras;DRUGELIAI;3216664984;Ne;0;19;0;19
8026;Pipiras;DRUGELIAI;9307622469;Ne;10;4;0;14
8027;Pipiras;DRUGELIAI;6925577945;Ne;3;6;1;10
8028;Pipiras;DRUGELIAI;9639609431;Ne;5;4;0;9
8029;Pipiras;DRUGELIAI;9422467047;Ne;0;4;2;6
8030;Pipiras;DRUGELIAI;4743474665;Ne;0;19;0;19
8031;Pipiras;DRUGELIAI;9552763906;Ne;0;4;4;8
8032;Pipiras;DRUGELIAI;2159315426;Ne;0;8;0;8
8033;Pipiras;DRUGELIAI;8404246568;Ne;4;2;0;6
8034;Pipiras;DRUGELIAI;3641496225;Ne;0;11;0;11
8035;Pipiras;DRUGELIAI;4991725638;Ne;0;2;0;2
8036;Pipiras;DRUGELIAI;7200147039;Ne;9;3;0;12
8037;Pipiras;DRUGELIAI;5035593032;Ne;0;1;1;2
8038;Pipiras;DRUGELIAI;6361544649;Ne;3;1;0;4
8039;Pipiras;DRUGELIAI;1079088070;Ne;0;3;0;3
8040;Pipiras;GĖLYTĖS;9670710691;Ne;1;4;0;5
8041;Pipiras;GĖLYTĖS;8965139441;Ne;5;4;0;9
8042;Pipiras;GĖLYTĖS;2095794125;Ne;11;1;0;12
8043;Pipiras;GĖLYTĖS;8675473349;Ne;4;3;0;7
8044;Pipiras;GĖLYTĖS;4945164161;Ne;10;5;0;15
8045;Pipiras;GĖLYTĖS;7362002646;Ne;2;6;0;8
8046;Pipiras;GĖLYTĖS;3755824911;Ne;0;5;0;5
8047;Pipiras;GĖLYTĖS;6453274205;Ne;0;4;0;4
8048;Pipiras;GĖLYTĖS;4559954910;Ne;0;10;0;10
8049;Pipiras;GĖLYTĖS;7157187063;Ne;0;14;0;14
8050;Pipiras;GĖLYTĖS;4021613243;Ne;2;5;0;7
8051;Pipiras;GĖLYTĖS;1611488078;Ne;0;3;3;6
8052;Pipiras;GĖLYTĖS;4236597883;Ne;6;5;2;13
8053;Pipiras;GĖLYTĖS;4289497197;Ne;0;3;0;3
8054;Pipiras;GĖLYTĖS;2474548836;Taip;5;4;0;9
8055;Pipiras;GĖLYTĖS;8553422709;Ne;10;0;0;10
8056;Pipiras;GĖLYTĖS;5738334591;Ne;0;5;0;5
8057;Pipiras;GĖLYTĖS;6428525902;Ne;7;3;2;12
8058;Pipiras;GĖLYTĖS;8354158722;Ne;4;0;0;4
8059;Pipiras;BORUŽĖLĖS;4707794599;Ne;0;3;0;3
8060;Pipiras;BORUŽĖLĖS;8673271201;Ne;4;0;0;4
8061;Pipiras;BORUŽĖLĖS;5968015502;Ne;0;4;0;4
8062;Pipiras;BORUŽĖLĖS;4086728233;Ne;0;5;0;5
8063;Pipiras;BORUŽĖLĖS;8508292428;Ne;0;4;0;4
8064;Pipiras;BORUŽĖLĖS;1210940213;Ne;0;4;0;4
8065;Pipiras;BORUŽĖLĖS;8260680662;Ne;0;4;0;4
8066;Pipiras;BORUŽĖLĖS;1548928533;Ne;3;0;0;3
8067;Pipiras;BORUŽĖLĖS;9097987789;Taip;0;5;0;5
8068;Pipiras;BORUŽĖLĖS;6310054093;Ne;0;5;0;5
8069;Pipiras;BORUŽĖLĖS;8959946514;Taip;4;0;0;4
8070;Pipiras;BORUŽĖLĖS;9396979045;Ne;2;0;0;2
8071;Pipiras;BORUŽĖLĖS;1146369304;Ne;0;9;0;9
8072;Pipiras;BORUŽĖLĖS;9970587185;Ne;9;0;0;9
8073;Pipiras;BORUŽĖLĖS;6034298583;Ne;4;6;0;10
8074;Pipiras;BORUŽĖLĖS;6344932171;Ne;5;7;0;12
8075;Pipiras;BORUŽĖLĖS;1550959705;Ne;0;9;0;9
8076;Pipiras;BORUŽĖLĖS;9425682286;Ne;0;3;0;3
8077;Pipiras;SKRUZDĖLIUKAI;7969837759;Ne;0;9;0;9
8078;Pipiras;SKRUZDĖLIUKAI;2483867901;Ne;5;0;0;5
8079;Pipiras;SKRUZDĖLIUKAI;1315372873;Ne;0;6;0;6
8080;Pipiras;SKRUZDĖLIUKAI;9372109848;Ne;0;3;1;4
8081;Pipiras;SKRUZDĖLIUKAI;2296702730;Ne;0;1;0;1
8082;Pipiras;SKRUZDĖLIUKAI;3768825314;Ne;4;4;1;9
8083;Pipiras;SKRUZDĖLIUKAI;4309096743;Ne;2;0;0;2
8084;Pipiras;SKRUZDĖLIUKAI;2399588759;Ne;0;7;0;7
8085;Pipiras;SKRUZDĖLIUKAI;7212820879;Ne;0;1;0;1
8086;Pipiras;SKRUZDĖLIUKAI;8081343184;Ne;7;13;1;21
8087;Pipiras;SKRUZDĖLIUKAI;9852475056;Ne;3;6;0;9
8088;Pipiras;SKRUZDĖLIUKAI;6176818802;Ne;5;4;1;10
8089;Pipiras;SKRUZDĖLIUKAI;1215623527;Ne;0;1;0;1
8090;Pipiras;SKRUZDĖLIUKAI;9625933545;Ne;0;4;0;4
8091;Pipiras;SKRUZDĖLIUKAI;7211189491;Ne;0;1;0;1
8092;Pipiras;SKRUZDĖLIUKAI;6092576917;Ne;0;4;0;4
8093;Pipiras;SKRUZDĖLIUKAI;4321420201;Ne;0;9;0;9
8094;Pipiras;SKRUZDĖLIUKAI;5346249456;Ne;0;4;0;4
8095;Pipiras;ŽVIRBLIUKŲ;6342044341;Ne;0;4;0;4
8096;Pipiras;ŽVIRBLIUKŲ;5725956659;Ne;3;3;0;6
8097;Pipiras;ŽVIRBLIUKŲ;3852848863;Ne;0;4;0;4
8098;Pipiras;ŽVIRBLIUKŲ;3882437376;Ne;3;2;1;6
8099;Pipiras;ŽVIRBLIUKŲ;9157870634;Ne;0;4;0;4
8100;Pipiras;ŽVIRBLIUKŲ;5235868332;Ne;0;7;0;7
8101;Pipiras;ŽVIRBLIUKŲ;3554786173;Ne;0;3;0;3
8102;Pipiras;ŽVIRBLIUKŲ;1034182352;Ne;0;4;0;4
8103;Pipiras;ŽVIRBLIUKŲ;2075041950;Ne;0;4;0;4
8104;Pipiras;ŽVIRBLIUKŲ;6792777396;Ne;0;4;0;4
8105;Pipiras;ŽVIRBLIUKŲ;6780333972;Ne;0;9;0;9
8106;Pipiras;ŽVIRBLIUKŲ;5622119207;Ne;0;4;0;4
8107;Pipiras;ŽVIRBLIUKŲ;7934365114;Ne;6;1;0;7
8108;Pipiras;ŽVIRBLIUKŲ;9770780973;Ne;10;2;0;12
8109;Pipiras;ŽVIRBLIUKŲ;5845498558;Ne;0;7;0;7
8110;Pipiras;ŽVIRBLIUKŲ;9840040112;Ne;0;9;0;9
8111;Pipiras;ŽVIRBLIUKŲ;1784839485;Ne;0;5;0;5
8112;Pipiras;ŽVIRBLIUKŲ;3775916247;Ne;0;4;0;4
8113;Pipiras;ŽVIRBLIUKŲ;7350131214;Ne;0;7;0;7
8114;Pipiras;ZUIKUČIŲ;3299758617;Ne;3;1;0;4
8115;Pipiras;ZUIKUČIŲ;7202983046;Ne;19;0;0;19
8116;Pipiras;ZUIKUČIŲ;6392620549;Ne;0;6;0;6
8117;Pipiras;ZUIKUČIŲ;4017133866;Ne;0;4;0;4
8118;Pipiras;ZUIKUČIŲ;1443705808;Taip;15;0;1;16
8119;Pipiras;ZUIKUČIŲ;5273904507;Ne;19;0;0;19
8120;Pipiras;ZUIKUČIŲ;3779938901;Taip;9;0;0;9
8121;Pipiras;ZUIKUČIŲ;8364071068;Ne;19;0;0;19
8122;Pipiras;ZUIKUČIŲ;9206586291;Ne;0;3;0;3
8123;Pipiras;ZUIKUČIŲ;1326532597;Ne;5;4;1;10
8124;Pipiras;ZUIKUČIŲ;3759775049;Ne;10;6;0;16
8125;Pipiras;ZUIKUČIŲ;8716061709;Ne;0;3;0;3
8126;Pipiras;ZUIKUČIŲ;6700688846;Ne;0;19;0;19
8127;Pipiras;ZUIKUČIŲ;3390710493;Ne;18;0;0;18
8128;Pipiras;VARLIUKŲ;8952109131;Ne;14;0;0;14
8129;Pipiras;VARLIUKŲ;1419011066;Ne;10;0;0;10
8130;Pipiras;VARLIUKŲ;3553431200;Ne;9;5;0;14
8131;Pipiras;VARLIUKŲ;7262747212;Ne;0;5;0;5
8132;Pipiras;VARLIUKŲ;6221086316;Ne;1;0;0;1
8133;Pipiras;VARLIUKŲ;3219349754;Ne;3;13;0;16
8134;Pipiras;VARLIUKŲ;1254069142;Ne;0;6;0;6
8135;Pipiras;VARLIUKŲ;3548414064;Ne;0;4;2;6
8136;Pipiras;VARLIUKŲ;5735835403;Ne;6;0;0;6
8137;Pipiras;VARLIUKŲ;2248789873;Ne;4;0;0;4
8138;Pipiras;VARLIUKŲ;1995619760;Ne;10;4;0;14
8139;Pipiras;VARLIUKŲ;8128573827;Ne;9;7;0;16
8140;Pipiras;VARLIUKŲ;6349032299;Ne;4;7;0;11
8141;Pipiras;VARLIUKŲ;7209844964;Ne;6;0;0;6
8142;Pipiras;VARLIUKŲ;7689406983;Ne;3;4;0;7
8143;Pipiras;ŽIOGELIŲ;7510719254;Ne;10;4;0;14
8144;Pipiras;ŽIOGELIŲ;7802812858;Ne;0;8;0;8
8145;Pipiras;ŽIOGELIŲ;8697732892;Ne;15;4;0;19
8146;Pipiras;ŽIOGELIŲ;1466527534;Ne;0;4;1;5
8147;Pipiras;ŽIOGELIŲ;1172225661;Ne;0;4;0;4
8148;Pipiras;ŽIOGELIŲ;3825960148;Ne;8;4;0;12
8149;Pipiras;ŽIOGELIŲ;9747219629;Ne;0;9;0;9
8150;Pipiras;ŽIOGELIŲ;6602780166;Ne;0;1;2;3
8151;Pipiras;ŽIOGELIŲ;4229548366;Ne;4;4;2;10
8152;Pipiras;ŽIOGELIŲ;8666908143;Ne;10;5;0;15
8153;Pipiras;ŽIOGELIŲ;4083110785;Ne;0;3;0;3
8154;Pipiras;ŽIOGELIŲ;7011969610;Ne;0;4;0;4
8155;Pipiras;ŽIOGELIŲ;2784222529;Ne;5;3;0;8
8156;Pipiras;ŽIOGELIŲ;3701585967;Ne;10;4;0;14
8157;Pipiras;ŽIOGELIŲ;5274511724;Ne;8;4;0;12
8158;Pipiras;ŽIOGELIŲ;8852386906;Ne;4;4;0;8
8159;Pipiras;ŽIOGELIŲ;1417118390;Ne;6;7;0;13
8160;Pipiras;ŽIOGELIŲ;8364783015;Ne;10;4;5;19
8161;Pipiras;ŽIOGELIŲ;8351469544;Ne;0;9;0;9
8162;"Prie pasakų parko";ZUIKUČIAI;8493622886;Taip;5;0;0;5
8163;"Prie pasakų parko";ZUIKUČIAI;3998970024;Ne;0;5;0;5
8164;"Prie pasakų parko";ZUIKUČIAI;3907016976;Ne;7;0;0;7
8165;"Prie pasakų parko";ZUIKUČIAI;4904562817;Ne;4;3;0;7
8166;"Prie pasakų parko";ZUIKUČIAI;9659710840;Ne;14;0;0;14
8167;"Prie pasakų parko";ZUIKUČIAI;5394554484;Ne;5;0;0;5
8168;"Prie pasakų parko";ZUIKUČIAI;9707694441;Taip;0;4;0;4
8169;"Prie pasakų parko";ZUIKUČIAI;7220229641;Ne;6;3;0;9
8170;"Prie pasakų parko";ZUIKUČIAI;8616467675;Ne;9;0;0;9
8171;"Prie pasakų parko";ZUIKUČIAI;8215496569;Ne;1;0;0;1
8172;"Prie pasakų parko";ZUIKUČIAI;9742058853;Ne;1;0;0;1
8173;"Prie pasakų parko";ZUIKUČIAI;3038164555;Taip;6;0;0;6
8174;"Prie pasakų parko";ZUIKUČIAI;4183640714;Ne;13;0;0;13
8175;"Prie pasakų parko";ZUIKUČIAI;5326765354;Ne;19;0;0;19
8176;"Prie pasakų parko";PAUKŠČIUKŲ;7330033315;Ne;3;0;0;3
8177;"Prie pasakų parko";PAUKŠČIUKŲ;9061639276;Ne;4;0;0;4
8178;"Prie pasakų parko";PAUKŠČIUKŲ;1476515947;Ne;9;0;1;10
8179;"Prie pasakų parko";PAUKŠČIUKŲ;6601363351;Ne;4;0;0;4
8180;"Prie pasakų parko";PAUKŠČIUKŲ;7693728136;Taip;6;0;0;6
8181;"Prie pasakų parko";PAUKŠČIUKŲ;8882083855;Ne;6;0;0;6
8182;"Prie pasakų parko";PAUKŠČIUKŲ;8627379659;Ne;6;0;0;6
8183;"Prie pasakų parko";PAUKŠČIUKŲ;1644560882;Ne;14;0;0;14
8184;"Prie pasakų parko";PAUKŠČIUKŲ;4643624588;Ne;10;0;1;11
8185;"Prie pasakų parko";PAUKŠČIUKŲ;7349726598;Ne;6;0;0;6
8186;"Prie pasakų parko";PAUKŠČIUKŲ;9571177184;Ne;18;0;0;18
8187;"Prie pasakų parko";PAUKŠČIUKŲ;8949522672;Ne;9;0;0;9
8188;"Prie pasakų parko";PAUKŠČIUKŲ;1435069282;Ne;16;0;0;16
8189;"Prie pasakų parko";PAUKŠČIUKŲ;2088585478;Ne;8;0;0;8
8190;"Prie pasakų parko";PAUKŠČIUKŲ;3525929286;Taip;4;0;0;4
8191;"Prie pasakų parko";"LINKSMOJI ŠEIMYNĖLĖ (SPEC)";7955197522;Ne;3;0;0;3
8192;"Prie pasakų parko";"LINKSMOJI ŠEIMYNĖLĖ (SPEC)";2077861244;Ne;0;6;0;6
8193;"Prie pasakų parko";"LINKSMOJI ŠEIMYNĖLĖ (SPEC)";1427487116;Ne;1;0;0;1
8194;"Prie pasakų parko";"LINKSMOJI ŠEIMYNĖLĖ (SPEC)";1112142035;Ne;4;0;0;4
8195;"Prie pasakų parko";"LINKSMOJI ŠEIMYNĖLĖ (SPEC)";4895744524;Ne;16;0;0;16
8196;"Prie pasakų parko";"LINKSMOJI ŠEIMYNĖLĖ (SPEC)";2760980480;Ne;16;0;0;16
8197;"Prie pasakų parko";"LINKSMOJI ŠEIMYNĖLĖ (SPEC)";2272661119;Ne;12;0;0;12
8198;"Prie pasakų parko";NYKŠTUKŲ;2287711014;Ne;16;0;0;16
8199;"Prie pasakų parko";NYKŠTUKŲ;6491435655;Ne;12;0;2;14
8200;"Prie pasakų parko";NYKŠTUKŲ;1743429440;Ne;0;6;0;6
8201;"Prie pasakų parko";NYKŠTUKŲ;7739970115;Ne;7;0;0;7
8202;"Prie pasakų parko";NYKŠTUKŲ;6700916147;Ne;7;0;0;7
8203;"Prie pasakų parko";NYKŠTUKŲ;6733793491;Ne;6;0;0;6
8204;"Prie pasakų parko";NYKŠTUKŲ;2515928623;Ne;6;0;0;6
8205;"Prie pasakų parko";NYKŠTUKŲ;1316127369;Ne;19;0;0;19
8206;"Prie pasakų parko";NYKŠTUKŲ;2654978735;Ne;16;0;0;16
8207;"Prie pasakų parko";NYKŠTUKŲ;2661900328;Ne;0;0;2;2
8208;"Prie pasakų parko";NYKŠTUKŲ;3202292611;Ne;0;0;1;1
8209;"Prie pasakų parko";NYKŠTUKŲ;9225775914;Ne;4;0;0;4
8210;"Prie pasakų parko";NYKŠTUKŲ;4457827262;Ne;12;0;1;13
8211;"Prie pasakų parko";NYKŠTUKŲ;6171021539;Ne;10;0;1;11
8212;"Prie pasakų parko";NYKŠTUKŲ;4860316199;Ne;8;1;0;9
8213;"Prie pasakų parko";NYKŠTUKŲ;3907578461;Ne;9;0;1;10
8214;"Prie pasakų parko";NYKŠTUKŲ;9784398441;Ne;19;0;0;19
8215;"Prie pasakų parko";NYKŠTUKŲ;9550985822;Ne;0;0;2;2
8216;"Prie pasakų parko";NYKŠTUKŲ;1811994592;Ne;0;0;1;1
8217;"Prie pasakų parko";LAŠELIŲ;8574432191;Ne;0;1;1;2
8218;"Prie pasakų parko";LAŠELIŲ;4181676762;Ne;0;3;0;3
8219;"Prie pasakų parko";LAŠELIŲ;4548803933;Ne;0;4;1;5
8220;"Prie pasakų parko";LAŠELIŲ;6250610187;Ne;0;4;0;4
8221;"Prie pasakų parko";LAŠELIŲ;2216634402;Ne;10;4;0;14
8222;"Prie pasakų parko";LAŠELIŲ;2731544174;Ne;2;4;0;6
8223;"Prie pasakų parko";LAŠELIŲ;8339335908;Ne;0;2;0;2
8224;"Prie pasakų parko";LAŠELIŲ;2350325153;Ne;8;0;0;8
8225;"Prie pasakų parko";LAŠELIŲ;7390391804;Ne;0;1;1;2
8226;"Prie pasakų parko";LAŠELIŲ;6762267582;Ne;0;4;0;4
8227;"Prie pasakų parko";LAŠELIŲ;9072312203;Ne;7;4;0;11
8228;"Prie pasakų parko";LAŠELIŲ;2952868428;Ne;8;2;0;10
8229;"Prie pasakų parko";LAŠELIŲ;5159105661;Ne;0;7;0;7
8230;"Prie pasakų parko";LAŠELIŲ;6074218082;Ne;2;4;1;7
8231;"Prie pasakų parko";LAŠELIŲ;4351705573;Ne;4;1;0;5
8232;"Prie pasakų parko";"KAČIUKAI (SPEC)";2590693851;Ne;8;0;0;8
8233;"Prie pasakų parko";"KAČIUKAI (SPEC)";3949671257;Ne;10;0;0;10
8234;"Prie pasakų parko";"KAČIUKAI (SPEC)";2583331243;Ne;5;0;0;5
8235;"Prie pasakų parko";"KAČIUKAI (SPEC)";1370201372;Ne;0;5;0;5
8236;"Prie pasakų parko";"KAČIUKAI (SPEC)";8056265378;Ne;2;0;0;2
8237;"Prie pasakų parko";"KAČIUKAI (SPEC)";5594531224;Ne;9;0;0;9
8238;"Prie pasakų parko";"KAČIUKAI (SPEC)";1618225282;Ne;3;0;0;3
8239;"Prie pasakų parko";"ŽVAIGŽDUTĖS  (SPEC)";7216751216;Ne;5;0;2;7
8240;"Prie pasakų parko";"ŽVAIGŽDUTĖS  (SPEC)";5006152810;Ne;4;0;0;4
8241;"Prie pasakų parko";"ŽVAIGŽDUTĖS  (SPEC)";6989235061;Ne;10;0;1;11
8242;"Prie pasakų parko";"ŽVAIGŽDUTĖS  (SPEC)";5009168398;Ne;0;0;2;2
8243;"Prie pasakų parko";"ŽVAIGŽDUTĖS  (SPEC)";6585504578;Ne;16;0;0;16
8244;"Prie pasakų parko";"ŽVAIGŽDUTĖS  (SPEC)";1621710265;Ne;3;0;1;4
8245;"Prie pasakų parko";"ŽVAIGŽDUTĖS  (SPEC)";8203595449;Ne;15;0;0;15
8246;"Prie pasakų parko";"ŽVAIGŽDUTĖS  (SPEC)";7476984763;Ne;15;0;0;15
8247;"Prie pasakų parko";"ŽVAIGŽDUTĖS  (SPEC)";7449993309;Ne;13;0;0;13
8248;"Prie pasakų parko";"ANČIUKAI (SPEC)";6802898184;Ne;3;0;1;4
8249;"Prie pasakų parko";"ANČIUKAI (SPEC)";9529949992;Ne;16;0;0;16
8250;"Prie pasakų parko";"ANČIUKAI (SPEC)";4309482351;Ne;0;8;0;8
8251;"Prie pasakų parko";"ANČIUKAI (SPEC)";7200571639;Ne;3;0;1;4
8252;"Prie pasakų parko";"ANČIUKAI (SPEC)";2047018335;Ne;0;0;1;1
8253;"Prie pasakų parko";"ANČIUKAI (SPEC)";2731902356;Ne;11;0;0;11
8254;"Prie pasakų parko";"ANČIUKAI (SPEC)";5627477370;Ne;9;0;1;10
8255;"Prie pasakų parko";"ANČIUKAI (SPEC)";9999109437;Ne;12;0;0;12
8256;"Prie pasakų parko";"ANČIUKAI (SPEC)";9741985709;Ne;9;0;0;9
8257;"Prie pasakų parko";TIGRIUKAI;3918269702;Taip;4;4;1;9
8258;"Prie pasakų parko";TIGRIUKAI;6446562388;Ne;2;4;0;6
8259;"Prie pasakų parko";TIGRIUKAI;2168919559;Taip;0;8;0;8
8260;"Prie pasakų parko";TIGRIUKAI;2898016639;Taip;0;0;2;2
8261;"Prie pasakų parko";TIGRIUKAI;9476448601;Ne;4;0;2;6
8262;"Prie pasakų parko";TIGRIUKAI;8029428034;Ne;1;1;0;2
8263;"Prie pasakų parko";TIGRIUKAI;8715851643;Ne;0;4;4;8
8264;"Prie pasakų parko";TIGRIUKAI;3617673265;Ne;5;0;1;6
8265;"Prie pasakų parko";TIGRIUKAI;1704679306;Ne;0;4;0;4
8266;"Prie pasakų parko";TIGRIUKAI;7776961789;Ne;3;4;0;7
8267;"Prie pasakų parko";TIGRIUKAI;3373275644;Ne;14;0;0;14
8268;"Prie pasakų parko";TIGRIUKAI;5518041213;Ne;0;0;3;3
8269;"Prie pasakų parko";TIGRIUKAI;8738488104;Ne;0;0;3;3
8270;"Prie pasakų parko";TIGRIUKAI;6606867989;Ne;0;0;2;2
8271;"Prie pasakų parko";TIGRIUKAI;2263419475;Ne;0;0;2;2
8272;"Prie pasakų parko";TIGRIUKAI;6784471792;Ne;0;0;2;2
8273;"Prie pasakų parko";TIGRIUKAI;6110226958;Ne;0;0;6;6
8274;"Prie pasakų parko";"EŽIUKŲ (SPEC)";5944113879;Ne;0;0;1;1
8275;"Prie pasakų parko";"EŽIUKŲ (SPEC)";4950143153;Ne;7;0;0;7
8276;"Prie pasakų parko";"EŽIUKŲ (SPEC)";4799789212;Ne;7;0;1;8
8277;"Prie pasakų parko";"EŽIUKŲ (SPEC)";5834070970;Ne;8;0;0;8
8278;"Prie pasakų parko";"EŽIUKŲ (SPEC)";3579773269;Ne;5;0;1;6
8279;"Prie pasakų parko";"EŽIUKŲ (SPEC)";7313963137;Ne;4;0;1;5
8280;"Prie pasakų parko";"BORUŽIUKŲ (SPEC)";9715586563;Ne;7;0;3;10
8281;"Prie pasakų parko";"BORUŽIUKŲ (SPEC)";4504147902;Ne;6;0;0;6
8282;"Prie pasakų parko";"BORUŽIUKŲ (SPEC)";6051760219;Ne;4;0;2;6
8283;"Prie pasakų parko";"BORUŽIUKŲ (SPEC)";5821107898;Ne;2;0;0;2
8284;"Prie pasakų parko";"BORUŽIUKŲ (SPEC)";6772736175;Ne;19;0;0;19
8285;"Prie pasakų parko";"BORUŽIUKŲ (SPEC)";5847625697;Ne;12;0;1;13
8286;"Prie pasakų parko";SAULYTĖS;4827245401;Ne;1;4;0;5
8287;"Prie pasakų parko";SAULYTĖS;3430128279;Ne;0;18;0;18
8288;"Prie pasakų parko";SAULYTĖS;5039094555;Ne;2;3;0;5
8289;"Prie pasakų parko";SAULYTĖS;4580377882;Ne;4;3;0;7
8290;"Prie pasakų parko";SAULYTĖS;5676549541;Ne;4;0;0;4
8291;"Prie pasakų parko";SAULYTĖS;9464727980;Ne;3;0;0;3
8292;"Prie pasakų parko";SAULYTĖS;8621403184;Ne;12;0;0;12
8293;"Prie pasakų parko";SAULYTĖS;4844984321;Ne;6;0;0;6
8294;"Prie pasakų parko";SAULYTĖS;6955061957;Ne;0;8;0;8
8295;"Pumpurėlis (Kalvarijų g. 186)";RAMUNĖLIŲ;7652642088;Taip;0;4;0;4
8296;"Pumpurėlis (Kalvarijų g. 186)";RAMUNĖLIŲ;9052267552;Ne;0;12;0;12
8297;"Pumpurėlis (Kalvarijų g. 186)";RAMUNĖLIŲ;9372725707;Ne;0;6;0;6
8298;"Pumpurėlis (Kalvarijų g. 186)";RAMUNĖLIŲ;2715059752;Ne;0;3;1;4
8299;"Pumpurėlis (Kalvarijų g. 186)";RAMUNĖLIŲ;4249039048;Ne;0;3;0;3
8300;"Pumpurėlis (Kalvarijų g. 186)";RAMUNĖLIŲ;1082775039;Ne;4;6;0;10
8301;"Pumpurėlis (Kalvarijų g. 186)";RAMUNĖLIŲ;6982600785;Ne;0;4;0;4
8302;"Pumpurėlis (Kalvarijų g. 186)";RAMUNĖLIŲ;1667602636;Ne;16;0;0;16
8303;"Pumpurėlis (Kalvarijų g. 186)";RAMUNĖLIŲ;8212403350;Ne;0;4;0;4
8304;"Pumpurėlis (Kalvarijų g. 186)";RAMUNĖLIŲ;1448399754;Ne;0;3;1;4
8305;"Pumpurėlis (Kalvarijų g. 186)";RAMUNĖLIŲ;6795405194;Ne;0;4;1;5
8306;"Pumpurėlis (Kalvarijų g. 186)";RAMUNĖLIŲ;7443152469;Ne;0;19;0;19
8307;"Pumpurėlis (Kalvarijų g. 186)";RAMUNĖLIŲ;9306426978;Ne;0;8;0;8
8308;"Pumpurėlis (Kalvarijų g. 186)";RAMUNĖLIŲ;8458676611;Ne;0;4;0;4
8309;"Pumpurėlis (Kalvarijų g. 186)";RAMUNĖLIŲ;6939412463;Ne;2;7;0;9
8310;"Pumpurėlis (Kalvarijų g. 186)";RAMUNĖLIŲ;1856558407;Ne;6;0;0;6
8311;"Pumpurėlis (Kalvarijų g. 186)";RAMUNĖLIŲ;7002569226;Ne;5;0;0;5
8312;"Pumpurėlis (Kalvarijų g. 186)";RAMUNĖLIŲ;8534897580;Taip;0;9;1;10
8313;"Pumpurėlis (Kalvarijų g. 186)";RAMUNĖLIŲ;5208799121;Ne;0;4;0;4
8314;"Pumpurėlis (Kalvarijų g. 186)";VARPELIŲ;5326000400;Ne;9;6;0;15
8315;"Pumpurėlis (Kalvarijų g. 186)";VARPELIŲ;7998027741;Ne;9;0;0;9
8316;"Pumpurėlis (Kalvarijų g. 186)";VARPELIŲ;9395698760;Ne;14;0;0;14
8317;"Pumpurėlis (Kalvarijų g. 186)";VARPELIŲ;9478685443;Ne;6;0;0;6
8318;"Pumpurėlis (Kalvarijų g. 186)";VARPELIŲ;9903981454;Ne;5;3;0;8
8319;"Pumpurėlis (Kalvarijų g. 186)";VARPELIŲ;6647331393;Ne;4;0;1;5
8320;"Pumpurėlis (Kalvarijų g. 186)";VARPELIŲ;3537534154;Ne;3;3;0;6
8321;"Pumpurėlis (Kalvarijų g. 186)";VARPELIŲ;3001331278;Ne;0;0;2;2
8322;"Pumpurėlis (Kalvarijų g. 186)";VARPELIŲ;9735493140;Ne;14;0;0;14
8323;"Pumpurėlis (Kalvarijų g. 186)";VARPELIŲ;3964441086;Ne;6;0;0;6
8324;"Pumpurėlis (Kalvarijų g. 186)";VARPELIŲ;8550119831;Ne;10;1;0;11
8325;"Pumpurėlis (Kalvarijų g. 186)";VARPELIŲ;4245270154;Ne;0;6;0;6
8326;"Pumpurėlis (Kalvarijų g. 186)";VARPELIŲ;6860128064;Ne;4;0;0;4
8327;"Pumpurėlis (Kalvarijų g. 186)";VARPELIŲ;2282966743;Ne;3;3;0;6
8328;"Pumpurėlis (Kalvarijų g. 186)";VARPELIŲ;5968577443;Ne;12;0;2;14
8329;"Pumpurėlis (Kalvarijų g. 186)";VARPELIŲ;8083674991;Ne;6;2;0;8
8330;"Pumpurėlis (Kalvarijų g. 186)";VARPELIŲ;6422203618;Ne;5;0;0;5
8331;"Pumpurėlis (Kalvarijų g. 186)";VARPELIŲ;1782842327;Ne;17;0;0;17
8332;"Pumpurėlis (Kalvarijų g. 186)";VARPELIŲ;9750242149;Ne;10;4;1;15
8333;"Pumpurėlis (Kalvarijų g. 186)";VARPELIŲ;5420222684;Ne;0;1;0;1
8334;"Pumpurėlis (Kalvarijų g. 186)";DRUGELIŲ;5928552565;Ne;6;0;3;9
8335;"Pumpurėlis (Kalvarijų g. 186)";DRUGELIŲ;5897036076;Ne;0;4;0;4
8336;"Pumpurėlis (Kalvarijų g. 186)";DRUGELIŲ;7055989095;Ne;0;16;0;16
8337;"Pumpurėlis (Kalvarijų g. 186)";DRUGELIŲ;7078621340;Ne;0;4;0;4
8338;"Pumpurėlis (Kalvarijų g. 186)";DRUGELIŲ;1538548768;Ne;0;0;6;6
8339;"Pumpurėlis (Kalvarijų g. 186)";DRUGELIŲ;2368226822;Ne;10;4;0;14
8340;"Pumpurėlis (Kalvarijų g. 186)";DRUGELIŲ;3088476130;Ne;0;0;5;5
8341;"Pumpurėlis (Kalvarijų g. 186)";DRUGELIŲ;9640790401;Taip;0;4;2;6
8342;"Pumpurėlis (Kalvarijų g. 186)";DRUGELIŲ;8320987208;Ne;4;0;0;4
8343;"Pumpurėlis (Kalvarijų g. 186)";DRUGELIŲ;7832408524;Ne;3;4;1;8
8344;"Pumpurėlis (Kalvarijų g. 186)";DRUGELIŲ;8644853849;Ne;0;9;0;9
8345;"Pumpurėlis (Kalvarijų g. 186)";DRUGELIŲ;9417688597;Ne;0;4;0;4
8346;"Pumpurėlis (Kalvarijų g. 186)";DRUGELIŲ;9032255874;Ne;1;4;9;14
8347;"Pumpurėlis (Kalvarijų g. 186)";DRUGELIŲ;9996789041;Ne;0;0;4;4
8348;"Pumpurėlis (Kalvarijų g. 186)";DRUGELIŲ;2684592319;Ne;0;0;3;3
8349;"Pumpurėlis (Kalvarijų g. 186)";DRUGELIŲ;5835115428;Ne;0;4;0;4
8350;"Pumpurėlis (Kalvarijų g. 186)";DRUGELIŲ;2132563531;Ne;0;4;0;4
8351;"Pumpurėlis (Kalvarijų g. 186)";DRUGELIŲ;4506063812;Ne;5;7;2;14
8352;"Pumpurėlis (Kalvarijų g. 186)";DRUGELIŲ;2165141865;Ne;0;4;2;6
8353;"Pumpurėlis (Kalvarijų g. 186)";DRUGELIŲ;8671697745;Ne;4;0;0;4
8354;"Pumpurėlis (Kalvarijų g. 186)";DRUGELIŲ;3187815703;Ne;3;0;5;8
8355;"Pumpurėlis (Kalvarijų g. 186)";KODĖLČIUKŲ;8214602054;Ne;4;0;0;4
8356;"Pumpurėlis (Kalvarijų g. 186)";KODĖLČIUKŲ;9654958302;Ne;0;0;2;2
8357;"Pumpurėlis (Kalvarijų g. 186)";KODĖLČIUKŲ;5564844211;Ne;13;0;0;13
8358;"Pumpurėlis (Kalvarijų g. 186)";KODĖLČIUKŲ;1215117598;Ne;8;1;0;9
8359;"Pumpurėlis (Kalvarijų g. 186)";KODĖLČIUKŲ;6978091765;Ne;18;0;0;18
8360;"Pumpurėlis (Kalvarijų g. 186)";KODĖLČIUKŲ;6433757421;Ne;10;0;0;10
8361;"Pumpurėlis (Kalvarijų g. 186)";KODĖLČIUKŲ;3328647987;Ne;0;4;1;5
8362;"Pumpurėlis (Kalvarijų g. 186)";KODĖLČIUKŲ;3748601124;Ne;7;0;0;7
8363;"Pumpurėlis (Kalvarijų g. 186)";KODĖLČIUKŲ;6004234378;Ne;5;4;0;9
8364;"Pumpurėlis (Kalvarijų g. 186)";KODĖLČIUKŲ;4196409137;Ne;4;0;0;4
8365;"Pumpurėlis (Kalvarijų g. 186)";KODĖLČIUKŲ;6117720533;Ne;0;4;0;4
8366;"Pumpurėlis (Kalvarijų g. 186)";KODĖLČIUKŲ;8070486897;Ne;10;0;0;10
8367;"Pumpurėlis (Kalvarijų g. 186)";KODĖLČIUKŲ;3534133061;Ne;4;0;1;5
8368;"Pumpurėlis (Kalvarijų g. 186)";KODĖLČIUKŲ;2307819108;Ne;0;4;0;4
8369;"Pumpurėlis (Kalvarijų g. 186)";KODĖLČIUKŲ;9650395309;Ne;4;0;0;4
8370;"Pumpurėlis (Kalvarijų g. 186)";KODĖLČIUKŲ;6702744879;Ne;5;0;0;5
8371;"Pumpurėlis (Kalvarijų g. 186)";KODĖLČIUKŲ;2890596967;Ne;5;0;0;5
8372;"Pumpurėlis (Kalvarijų g. 186)";KODĖLČIUKŲ;9839285886;Taip;6;0;1;7
8373;"Pumpurėlis (Kalvarijų g. 186)";LINELIS;6780042929;Ne;0;7;0;7
8374;"Pumpurėlis (Kalvarijų g. 186)";LINELIS;7610949816;Ne;0;4;0;4
8375;"Pumpurėlis (Kalvarijų g. 186)";LINELIS;8667762689;Ne;0;6;0;6
8376;"Pumpurėlis (Kalvarijų g. 186)";LINELIS;3953103488;Ne;0;6;0;6
8377;"Pumpurėlis (Kalvarijų g. 186)";LINELIS;6977710645;Ne;0;3;0;3
8378;"Pumpurėlis (Kalvarijų g. 186)";LINELIS;6511527480;Ne;0;9;0;9
8379;"Pumpurėlis (Kalvarijų g. 186)";LINELIS;9431295796;Ne;0;7;0;7
8380;"Pumpurėlis (Kalvarijų g. 186)";LINELIS;3838705973;Ne;2;4;0;6
8381;"Pumpurėlis (Kalvarijų g. 186)";LINELIS;1395380236;Ne;4;4;0;8
8382;"Pumpurėlis (Kalvarijų g. 186)";LINELIS;9424449290;Ne;15;4;0;19
8383;"Pumpurėlis (Kalvarijų g. 186)";LINELIS;6955168163;Ne;0;4;0;4
8384;"Pumpurėlis (Kalvarijų g. 186)";LINELIS;5171198109;Ne;0;6;0;6
8385;"Pumpurėlis (Kalvarijų g. 186)";LINELIS;2233224512;Ne;0;4;0;4
8386;"Pumpurėlis (Kalvarijų g. 186)";LINELIS;9726028397;Ne;0;5;0;5
8387;"Pumpurėlis (Kalvarijų g. 186)";LINELIS;7229289985;Ne;4;2;0;6
8388;"Pumpurėlis (Kalvarijų g. 186)";LINELIS;7619709360;Ne;0;5;0;5
8389;"Pumpurėlis (Kalvarijų g. 186)";LINELIS;6726875853;Ne;12;4;0;16
8390;"Pumpurėlis (Kalvarijų g. 186)";LINELIS;7559071945;Ne;0;4;0;4
8391;"Pumpurėlis (Kalvarijų g. 186)";LINELIS;9117809080;Ne;0;3;0;3
8392;"Pumpurėlis (Kalvarijų g. 186)";SAULUTĖS;7182107790;Ne;0;3;2;5
8393;"Pumpurėlis (Kalvarijų g. 186)";SAULUTĖS;8525537588;Ne;0;2;0;2
8394;"Pumpurėlis (Kalvarijų g. 186)";SAULUTĖS;3101133244;Ne;0;4;0;4
8395;"Pumpurėlis (Kalvarijų g. 186)";SAULUTĖS;5023658988;Ne;0;4;0;4
8396;"Pumpurėlis (Kalvarijų g. 186)";SAULUTĖS;2668855786;Ne;0;7;0;7
8397;"Pumpurėlis (Kalvarijų g. 186)";SAULUTĖS;2103139845;Ne;0;4;1;5
8398;"Pumpurėlis (Kalvarijų g. 186)";SAULUTĖS;9612924972;Ne;0;5;0;5
8399;"Pumpurėlis (Kalvarijų g. 186)";SAULUTĖS;9884099545;Ne;0;5;0;5
8400;"Pumpurėlis (Kalvarijų g. 186)";SAULUTĖS;3733509497;Ne;0;4;0;4
8401;"Pumpurėlis (Kalvarijų g. 186)";SAULUTĖS;2247300456;Ne;1;2;0;3
8402;"Pumpurėlis (Kalvarijų g. 186)";SAULUTĖS;9224879966;Ne;0;3;0;3
8403;"Pumpurėlis (Kalvarijų g. 186)";SAULUTĖS;5564680653;Ne;0;4;3;7
8404;"Pumpurėlis (Kalvarijų g. 186)";SAULUTĖS;1411232443;Ne;0;4;0;4
8405;"Pumpurėlis (Kalvarijų g. 186)";SAULUTĖS;4508966729;Ne;5;3;0;8
8406;"Pumpurėlis (Kalvarijų g. 186)";SAULUTĖS;9552913910;Ne;0;4;0;4
8407;"Pumpurėlis (Kalvarijų g. 186)";SAULUTĖS;5196733185;Ne;0;4;0;4
8408;"Pumpurėlis (Kalvarijų g. 186)";SAULUTĖS;4629544683;Ne;0;2;0;2
8409;"Pumpurėlis (Kalvarijų g. 186)";SAULUTĖS;5583929465;Ne;1;2;0;3
8410;"Pumpurėlis (Kalvarijų g. 186)";BITUTĖS;4419940231;Ne;0;9;0;9
8411;"Pumpurėlis (Kalvarijų g. 186)";BITUTĖS;4985045047;Taip;0;4;1;5
8412;"Pumpurėlis (Kalvarijų g. 186)";BITUTĖS;2651037375;Ne;0;0;4;4
8413;"Pumpurėlis (Kalvarijų g. 186)";BITUTĖS;1768239820;Ne;4;0;2;6
8414;"Pumpurėlis (Kalvarijų g. 186)";BITUTĖS;2566557351;Ne;3;9;0;12
8415;"Pumpurėlis (Kalvarijų g. 186)";BITUTĖS;4426697956;Taip;0;0;7;7
8416;"Pumpurėlis (Kalvarijų g. 186)";BITUTĖS;7363814444;Taip;5;0;7;12
8417;"Pumpurėlis (Kalvarijų g. 186)";BITUTĖS;3405169131;Ne;0;4;0;4
8418;"Pumpurėlis (Kalvarijų g. 186)";BITUTĖS;3951445693;Ne;7;0;0;7
8419;"Pumpurėlis (Kalvarijų g. 186)";BITUTĖS;9612924316;Ne;0;15;0;15
8420;"Pumpurėlis (Kalvarijų g. 186)";BITUTĖS;1714440337;Ne;0;4;0;4
8421;"Pumpurėlis (Kalvarijų g. 186)";BITUTĖS;8655389224;Ne;0;0;1;1
8422;"Pumpurėlis (Kalvarijų g. 186)";BITUTĖS;1674341906;Taip;0;4;0;4
8423;"Pumpurėlis (Kalvarijų g. 186)";BITUTĖS;3842632260;Ne;0;4;0;4
8424;"Pumpurėlis (Kalvarijų g. 186)";BITUTĖS;1933502038;Ne;0;4;0;4
8425;"Pumpurėlis (Kalvarijų g. 186)";BITUTĖS;2230191718;Ne;0;4;0;4
8426;"Pumpurėlis (Kalvarijų g. 186)";BITUTĖS;7062090879;Ne;3;0;5;8
8427;"Pumpurėlis (Kalvarijų g. 186)";BITUTĖS;9245739052;Ne;5;0;2;7
8428;"Pumpurėlis (Kalvarijų g. 186)";BITUTĖS;8470433743;Ne;11;0;5;16
8429;"Pumpurėlis (Kalvarijų g. 186)";BITUTĖS;6474918016;Ne;0;0;3;3
8430;"Pumpurėlis (Kalvarijų g. 186)";DOBILIUKAI;9179780392;Ne;0;4;0;4
8431;"Pumpurėlis (Kalvarijų g. 186)";DOBILIUKAI;1839505206;Ne;0;10;0;10
8432;"Pumpurėlis (Kalvarijų g. 186)";DOBILIUKAI;3970253545;Ne;7;0;0;7
8433;"Pumpurėlis (Kalvarijų g. 186)";DOBILIUKAI;1808734330;Ne;7;0;0;7
8434;"Pumpurėlis (Kalvarijų g. 186)";DOBILIUKAI;6968264923;Ne;0;6;0;6
8435;"Pumpurėlis (Kalvarijų g. 186)";DOBILIUKAI;2700017433;Ne;0;9;0;9
8436;"Pumpurėlis (Kalvarijų g. 186)";DOBILIUKAI;7038597556;Ne;0;14;0;14
8437;"Pumpurėlis (Kalvarijų g. 186)";DOBILIUKAI;4130539703;Ne;8;3;0;11
8438;"Pumpurėlis (Kalvarijų g. 186)";DOBILIUKAI;6307988067;Ne;2;4;0;6
8439;"Pumpurėlis (Kalvarijų g. 186)";DOBILIUKAI;3374174445;Ne;0;6;0;6
8440;"Pumpurėlis (Kalvarijų g. 186)";DOBILIUKAI;3398517047;Ne;0;4;0;4
8441;"Pumpurėlis (Kalvarijų g. 186)";DOBILIUKAI;1961282282;Ne;0;4;0;4
8442;"Pumpurėlis (Kalvarijų g. 186)";DOBILIUKAI;7276322999;Ne;9;0;0;9
8443;"Pumpurėlis (Kalvarijų g. 186)";DOBILIUKAI;5587118874;Ne;4;4;0;8
8444;"Pumpurėlis (Kalvarijų g. 186)";DOBILIUKAI;9058493247;Ne;0;3;0;3
8445;"Pumpurėlis (Kalvarijų g. 186)";DOBILIUKAI;3214652626;Ne;1;4;0;5
8446;"Pumpurėlis (Kalvarijų g. 186)";DOBILIUKAI;5444879430;Ne;9;0;0;9
8447;"Pumpurėlis (Kalvarijų g. 186)";DOBILIUKAI;7825190756;Ne;9;0;0;9
8448;"Pumpurėlis (Kalvarijų g. 186)";DOBILIUKAI;1438740562;Ne;9;0;0;9
8449;"Pumpurėlis (Kalvarijų g. 186)";DOBILIUKAI;9740660699;Ne;0;5;0;5
8450;"Pumpurėlis (Kalvarijų g. 186)";PUPYČIŲ;9317274035;Ne;0;5;4;9
8451;"Pumpurėlis (Kalvarijų g. 186)";PUPYČIŲ;1555441484;Ne;0;5;4;9
8452;"Pumpurėlis (Kalvarijų g. 186)";PUPYČIŲ;5238756058;Ne;0;0;13;13
8453;"Pumpurėlis (Kalvarijų g. 186)";PUPYČIŲ;1945615416;Ne;0;0;2;2
8454;"Pumpurėlis (Kalvarijų g. 186)";PUPYČIŲ;3131907007;Ne;10;0;2;12
8455;"Pumpurėlis (Kalvarijų g. 186)";PUPYČIŲ;5384176825;Ne;0;0;4;4
8456;"Pumpurėlis (Kalvarijų g. 186)";PUPYČIŲ;5228548329;Ne;0;1;3;4
8457;"Pumpurėlis (Kalvarijų g. 186)";PUPYČIŲ;9789187163;Ne;0;0;10;10
8458;"Pumpurėlis (Kalvarijų g. 186)";PUPYČIŲ;7114896633;Ne;0;0;4;4
8459;"Pumpurėlis (Kalvarijų g. 186)";PUPYČIŲ;4133819653;Ne;0;0;9;9
8460;"Pumpurėlis (Kalvarijų g. 186)";PUPYČIŲ;8215233820;Ne;0;0;10;10
8461;"Pumpurėlis (Kalvarijų g. 186)";PUPYČIŲ;1413673339;Ne;15;0;4;19
8462;"Pumpurėlis (Kalvarijų g. 186)";PUPYČIŲ;1084209625;Ne;0;0;5;5
8463;"Pumpurėlis (Kalvarijų g. 186)";PUPYČIŲ;9164586359;Ne;8;0;0;8
8464;"Pumpurėlis (Kalvarijų g. 186)";PUPYČIŲ;9316908064;Ne;8;0;0;8
8465;"Pumpurėlis (Kalvarijų g. 186)";PUPYČIŲ;1082943651;Ne;1;0;3;4
8466;"Pumpurėlis (Kalvarijų g. 186)";ŽIRNIUKŲ;4198532140;Ne;4;0;0;4
8467;"Pumpurėlis (Kalvarijų g. 186)";ŽIRNIUKŲ;6162279957;Ne;8;0;0;8
8468;"Pumpurėlis (Kalvarijų g. 186)";ŽIRNIUKŲ;6602860291;Ne;10;0;1;11
8469;"Pumpurėlis (Kalvarijų g. 186)";ŽIRNIUKŲ;6535225429;Ne;6;5;2;13
8470;"Pumpurėlis (Kalvarijų g. 186)";ŽIRNIUKŲ;6606861732;Ne;4;0;4;8
8471;"Pumpurėlis (Kalvarijų g. 186)";ŽIRNIUKŲ;8057222613;Ne;13;0;0;13
8472;"Pumpurėlis (Kalvarijų g. 186)";ŽIRNIUKŲ;9704396561;Ne;6;0;1;7
8473;"Pumpurėlis (Kalvarijų g. 186)";ŽIRNIUKŲ;9033360796;Ne;6;0;1;7
8474;"Pumpurėlis (Kalvarijų g. 186)";ŽIRNIUKŲ;1550949005;Ne;0;1;2;3
8475;"Pumpurėlis (Kalvarijų g. 186)";ŽIRNIUKŲ;3438212768;Ne;8;0;0;8
8476;"Pumpurėlis (Kalvarijų g. 186)";ŽIRNIUKŲ;4686840292;Ne;0;0;4;4
8477;"Pumpurėlis (Kalvarijų g. 186)";ŽIRNIUKŲ;4195060928;Ne;3;4;0;7
8478;"Pumpurėlis (Kalvarijų g. 186)";ŽIRNIUKŲ;3966128737;Ne;9;0;0;9
8479;"Pumpurėlis (Kalvarijų g. 186)";ŽIRNIUKŲ;4446088965;Ne;8;0;0;8
8480;"Pumpurėlis (Kalvarijų g. 186)";ŽIRNIUKŲ;7994376089;Ne;0;4;1;5
8481;"Pumpurėlis (Kalvarijų g. 186)";ŽIRNIUKŲ;5765942106;Ne;14;0;0;14
8482;"Pumpurėlis (Kalvarijų g. 186)";ŽIRNIUKŲ;8978637291;Ne;5;0;4;9
8483;"Pumpurėlis (Kalvarijų g. 186)";ŽIRNIUKŲ;1756751203;Ne;12;0;0;12
8484;"Pumpurėlis (Kalvarijų g. 186)";BORUŽĖLIŲ;2269864490;Ne;4;0;1;5
8485;"Pumpurėlis (Kalvarijų g. 186)";BORUŽĖLIŲ;6223338814;Ne;6;4;1;11
8486;"Pumpurėlis (Kalvarijų g. 186)";BORUŽĖLIŲ;5659508302;Ne;0;4;0;4
8487;"Pumpurėlis (Kalvarijų g. 186)";BORUŽĖLIŲ;5998858670;Ne;5;4;0;9
8488;"Pumpurėlis (Kalvarijų g. 186)";BORUŽĖLIŲ;7398363498;Ne;4;0;1;5
8489;"Pumpurėlis (Kalvarijų g. 186)";BORUŽĖLIŲ;5835545051;Ne;0;4;0;4
8490;"Pumpurėlis (Kalvarijų g. 186)";BORUŽĖLIŲ;4188020534;Ne;3;0;0;3
8491;"Pumpurėlis (Kalvarijų g. 186)";BORUŽĖLIŲ;6256781298;Ne;0;7;0;7
8492;"Pumpurėlis (Kalvarijų g. 186)";BORUŽĖLIŲ;9136771401;Ne;0;4;0;4
8493;"Pumpurėlis (Kalvarijų g. 186)";BORUŽĖLIŲ;7045349032;Ne;11;8;0;19
8494;"Pumpurėlis (Kalvarijų g. 186)";BORUŽĖLIŲ;1017838338;Ne;0;6;4;10
8495;"Pumpurėlis (Kalvarijų g. 186)";BORUŽĖLIŲ;1648249689;Ne;0;4;0;4
8496;"Pumpurėlis (Kalvarijų g. 186)";BORUŽĖLIŲ;7535098093;Ne;4;0;1;5
8497;"Pumpurėlis (Kalvarijų g. 186)";BORUŽĖLIŲ;7843280418;Ne;3;4;0;7
8498;"Pumpurėlis (Kalvarijų g. 186)";BORUŽĖLIŲ;3531862496;Ne;3;1;0;4
8499;"Pumpurėlis (Kalvarijų g. 186)";BORUŽĖLIŲ;1441993078;Ne;0;4;3;7
8500;"Pumpurėlis (Kalvarijų g. 186)";BORUŽĖLIŲ;2768082342;Ne;0;3;2;5
8501;"Pumpurėlis (Kalvarijų g. 186)";BORUŽĖLIŲ;3407251558;Ne;4;0;2;6
8502;"Pumpurėlis (Kalvarijų g. 186)";BORUŽĖLIŲ;4355867863;Ne;0;4;0;4
8503;"Pumpurėlis (Kalvarijų g. 186)";BORUŽĖLIŲ;6386699443;Ne;0;0;2;2
8504;"Pumpurėlis (Kalvarijų g. 186)";SMALSUČIŲ;6212212516;Ne;14;0;0;14
8505;"Pumpurėlis (Kalvarijų g. 186)";SMALSUČIŲ;6604801631;Ne;12;0;2;14
8506;"Pumpurėlis (Kalvarijų g. 186)";SMALSUČIŲ;6988369637;Ne;6;0;1;7
8507;"Pumpurėlis (Kalvarijų g. 186)";SMALSUČIŲ;9363610488;Ne;1;5;1;7
8508;"Pumpurėlis (Kalvarijų g. 186)";SMALSUČIŲ;8380689261;Ne;0;0;1;1
8509;"Pumpurėlis (Kalvarijų g. 186)";SMALSUČIŲ;6483338028;Ne;4;0;0;4
8510;"Pumpurėlis (Kalvarijų g. 186)";SMALSUČIŲ;3492977569;Ne;6;0;0;6
8511;"Pumpurėlis (Kalvarijų g. 186)";SMALSUČIŲ;6959214331;Ne;0;4;0;4
8512;"Pumpurėlis (Kalvarijų g. 186)";SMALSUČIŲ;3085309902;Ne;7;0;0;7
8513;"Pumpurėlis (Kalvarijų g. 186)";SMALSUČIŲ;4964949574;Ne;11;0;0;11
8514;"Pumpurėlis (Kalvarijų g. 186)";SMALSUČIŲ;2905797053;Ne;3;0;1;4
8515;"Pumpurėlis (Kalvarijų g. 186)";SMALSUČIŲ;2026021360;Ne;5;4;1;10
8516;"Pumpurėlis (Kalvarijų g. 186)";SMALSUČIŲ;3871151401;Ne;4;0;2;6
8517;"Pumpurėlis (Kalvarijų g. 186)";SMALSUČIŲ;6557857672;Ne;5;4;0;9
8518;"Pumpurėlis (Kalvarijų g. 186)";SMALSUČIŲ;5212827184;Ne;2;6;0;8
8519;"Pumpurėlis (Kalvarijų g. 186)";SMALSUČIŲ;6614797909;Ne;0;0;2;2
8520;"Pumpurėlis (Kalvarijų g. 186)";SMALSUČIŲ;7813696919;Ne;4;5;0;9
8521;"Pumpurėlis (Kalvarijų g. 186)";SMALSUČIŲ;5278250113;Ne;4;5;1;10
8522;"Pumpurėlis (Kalvarijų g. 186)";SMALSUČIŲ;5236515914;Ne;5;0;1;6
8523;"Pumpurėlis (Kalvarijų g. 186)";SMALSUČIŲ;5456922203;Ne;0;4;0;4
8524;"Pumpurėlis (Kalvarijų g. 186)";SMALSUČIŲ;8886730333;Ne;0;4;0;4
8525;Puriena;Ančiukų;6158842119;Ne;0;6;0;6
8526;Puriena;Ančiukų;3557013127;Ne;4;4;0;8
8527;Puriena;Ančiukų;4100466337;Taip;3;9;0;12
8528;Puriena;Ančiukų;9251058353;Ne;4;0;0;4
8529;Puriena;Ančiukų;3681811493;Ne;0;2;0;2
8530;Puriena;Ančiukų;4060087185;Ne;4;4;0;8
8531;Puriena;Ančiukų;6280465748;Ne;11;2;0;13
8532;Puriena;Ančiukų;3033562627;Ne;5;4;0;9
8533;Puriena;Ančiukų;5777076971;Ne;5;4;0;9
8534;Puriena;Ančiukų;8310231540;Ne;2;5;2;9
8535;Puriena;Ančiukų;4460575818;Ne;0;6;0;6
8536;Puriena;Ančiukų;8120597514;Ne;0;4;0;4
8537;Puriena;Ančiukų;7967288875;Ne;5;0;1;6
8538;Puriena;Ančiukų;5336923102;Ne;2;4;0;6
8539;Puriena;Ančiukų;1907429094;Ne;0;4;1;5
8540;Puriena;Ančiukų;4605662701;Ne;7;4;0;11
8541;Puriena;Ančiukų;1819876614;Ne;0;4;6;10
8542;Puriena;Ančiukų;4776745276;Ne;4;2;0;6
8543;Puriena;Ančiukų;7769252165;Ne;0;5;0;5
8544;Puriena;Ančiukų;2170025682;Ne;4;0;1;5
8545;Puriena;Ančiukų;3772941726;Ne;0;8;0;8
8546;Puriena;Ančiukų;1428098802;Ne;0;8;0;8
8547;Puriena;Ančiukų;6416145396;Ne;8;1;1;10
8548;Puriena;Drugeliai;7016498639;Ne;4;0;4;8
8549;Puriena;Drugeliai;4016228982;Ne;3;0;0;3
8550;Puriena;Drugeliai;9671916745;Ne;2;1;0;3
8551;Puriena;Drugeliai;8195902319;Ne;0;2;4;6
8552;Puriena;Drugeliai;5797970231;Ne;8;0;0;8
8553;Puriena;Drugeliai;3382737176;Ne;5;0;6;11
8554;Puriena;Drugeliai;4587892949;Ne;9;0;0;9
8555;Puriena;Drugeliai;3440488785;Ne;0;0;3;3
8556;Puriena;Drugeliai;8284860687;Ne;5;4;0;9
8557;Puriena;Drugeliai;6941251095;Ne;19;0;0;19
8558;Puriena;Drugeliai;3252190329;Ne;5;3;0;8
8559;Puriena;Drugeliai;5927216569;Ne;0;0;5;5
8560;Puriena;Drugeliai;8474426340;Ne;0;6;0;6
8561;Puriena;Drugeliai;6308393533;Ne;0;6;1;7
8562;Puriena;Drugeliai;9907972536;Taip;0;4;0;4
8563;Puriena;Drugeliai;8239919265;Taip;3;0;2;5
8564;Puriena;Drugeliai;7634536770;Ne;0;5;0;5
8565;Puriena;Drugeliai;9176303276;Ne;0;6;0;6
8566;Puriena;Drugeliai;3604094165;Ne;6;0;5;11
8567;Puriena;Drugeliai;8110665629;Ne;8;0;0;8
8568;Puriena;Pelėdžiukai;2013783668;Ne;0;4;0;4
8569;Puriena;Pelėdžiukai;8874823029;Ne;3;0;6;9
8570;Puriena;Pelėdžiukai;3149718901;Ne;0;5;1;6
8571;Puriena;Pelėdžiukai;9041388275;Ne;0;4;1;5
8572;Puriena;Pelėdžiukai;3175917649;Ne;0;4;0;4
8573;Puriena;Pelėdžiukai;5619637663;Ne;0;0;3;3
8574;Puriena;Pelėdžiukai;2579402981;Ne;0;2;2;4
8575;Puriena;Pelėdžiukai;3671297035;Ne;5;1;1;7
8576;Puriena;Pelėdžiukai;2701942325;Ne;0;7;0;7
8577;Puriena;Pelėdžiukai;2267225709;Taip;0;0;1;1
8578;Puriena;Pelėdžiukai;4858971990;Ne;6;4;0;10
8579;Puriena;Pelėdžiukai;1417566073;Ne;0;0;4;4
8580;Puriena;Pelėdžiukai;6463129806;Ne;0;4;3;7
8581;Puriena;Pelėdžiukai;4501239330;Ne;2;4;0;6
8582;Puriena;Pelėdžiukai;5341228269;Ne;8;3;0;11
8583;Puriena;Pelėdžiukai;6786694796;Ne;0;0;5;5
8584;Puriena;Pelėdžiukai;8952508230;Taip;7;0;4;11
8585;Puriena;Pelėdžiukai;5080805225;Ne;0;0;4;4
8586;Puriena;Pelėdžiukai;1158768017;Ne;0;4;0;4
8587;Puriena;Pelėdžiukai;1658720269;Taip;0;1;3;4
8588;Puriena;Voveriukai;8772936125;Ne;5;0;8;13
8589;Puriena;Voveriukai;6428413592;Ne;14;0;0;14
8590;Puriena;Voveriukai;8242140541;Ne;4;2;5;11
8591;Puriena;Voveriukai;7066959314;Ne;8;0;0;8
8592;Puriena;Voveriukai;1455237224;Ne;4;1;0;5
8593;Puriena;Voveriukai;3094722037;Ne;11;3;0;14
8594;Puriena;Voveriukai;4193710604;Ne;0;0;1;1
8595;Puriena;Voveriukai;6227990580;Ne;9;0;0;9
8596;Puriena;Voveriukai;4165800035;Ne;6;9;0;15
8597;Puriena;Voveriukai;7334787183;Ne;8;1;1;10
8598;Puriena;Voveriukai;8412041946;Ne;14;0;1;15
8599;Puriena;Voveriukai;3287725982;Ne;19;0;0;19
8600;Puriena;Voveriukai;6496077328;Ne;10;0;0;10
8601;Puriena;Voveriukai;8845361962;Ne;0;18;0;18
8602;Puriena;Voveriukai;9965834233;Ne;0;3;0;3
8603;Puriena;Voveriukai;5841409384;Ne;12;0;1;13
8604;Puriena;Voveriukai;9934831745;Ne;5;0;0;5
8605;Puriena;Voveriukai;8310464710;Ne;19;0;0;19
8606;Puriena;Voveriukai;1614993691;Ne;0;4;0;4
8607;Puriena;Voveriukai;2172109284;Ne;14;0;0;14
8608;Puriena;Bitučių;1621772702;Ne;4;2;0;6
8609;Puriena;Bitučių;9413672989;Ne;0;1;4;5
8610;Puriena;Bitučių;1175665781;Ne;6;0;4;10
8611;Puriena;Bitučių;6853706997;Ne;0;3;0;3
8612;Puriena;Bitučių;1339162214;Ne;0;5;0;5
8613;Puriena;Bitučių;9543884311;Ne;0;7;0;7
8614;Puriena;Bitučių;6656013805;Ne;0;4;6;10
8615;Puriena;Bitučių;8022809059;Ne;0;0;4;4
8616;Puriena;Bitučių;5395382717;Ne;0;6;0;6
8617;Puriena;Bitučių;8237149969;Ne;0;2;2;4
8618;Puriena;Bitučių;7481642656;Ne;0;19;0;19
8619;Puriena;Bitučių;8512814466;Ne;0;13;0;13
8620;Puriena;Bitučių;7622407056;Ne;0;0;4;4
8621;Puriena;Bitučių;4017644414;Ne;0;6;1;7
8622;Puriena;Bitučių;1295692895;Ne;5;4;0;9
8623;Puriena;Bitučių;8416003733;Ne;1;5;0;6
8624;Puriena;Bitučių;8199607793;Ne;0;0;9;9
8625;Puriena;Bitučių;9854244405;Ne;0;4;0;4
8626;Puriena;Bitučių;6780164845;Ne;2;0;4;6
8627;Puriena;Bitučių;6413337915;Ne;6;4;2;12
8628;Puriena;Zylutės;2966464432;Ne;5;0;1;6
8629;Puriena;Zylutės;4760827000;Ne;0;0;3;3
8630;Puriena;Zylutės;1521955898;Ne;0;7;0;7
8631;Puriena;Zylutės;8881337164;Ne;0;3;0;3
8632;Puriena;Zylutės;5478026060;Ne;0;5;2;7
8633;Puriena;Zylutės;6914613438;Ne;0;0;1;1
8634;Puriena;Zylutės;8159342676;Ne;1;0;2;3
8635;Puriena;Zylutės;1121312813;Taip;0;4;0;4
8636;Puriena;Zylutės;2321753665;Ne;5;0;2;7
8637;Puriena;Zylutės;7021756459;Ne;8;0;4;12
8638;Puriena;Zylutės;1564155036;Ne;6;4;0;10
8639;Puriena;Zylutės;9098291788;Ne;0;3;0;3
8640;Puriena;Zylutės;6613654824;Ne;0;0;6;6
8641;Puriena;Zylutės;3738277048;Ne;3;0;2;5
8642;Puriena;Zylutės;7562458336;Ne;5;0;5;10
8643;Puriena;Zylutės;3579008577;Ne;0;12;0;12
8644;Puriena;Zylutės;7477278612;Ne;4;0;5;9
8645;Puriena;Zylutės;9847768390;Ne;0;0;3;3
8646;Puriena;Zylutės;9150157724;Ne;0;0;4;4
8647;Puriena;Meškučių;6234132927;Ne;9;6;0;15
8648;Puriena;Meškučių;4563681164;Ne;2;2;0;4
8649;Puriena;Meškučių;3153330970;Ne;7;3;0;10
8650;Puriena;Meškučių;9500729561;Ne;5;4;0;9
8651;Puriena;Meškučių;1238475246;Ne;0;2;1;3
8652;Puriena;Meškučių;5591189546;Ne;9;2;0;11
8653;Puriena;Meškučių;9748726934;Ne;4;1;0;5
8654;Puriena;Meškučių;5323549829;Ne;3;2;0;5
8655;Puriena;Meškučių;7466163131;Ne;0;0;1;1
8656;Puriena;Meškučių;2466609635;Ne;2;0;7;9
8657;Puriena;Meškučių;3309219271;Ne;0;9;0;9
8658;Puriena;Meškučių;9509041179;Ne;4;4;0;8
8659;Puriena;Meškučių;5176663365;Ne;12;1;0;13
8660;Puriena;Meškučių;9961074983;Ne;9;2;0;11
8661;Puriena;Meškučių;3011629747;Ne;9;4;0;13
8662;Puriena;Meškučių;2029981617;Ne;5;5;0;10
8663;Puriena;Meškučių;6185080390;Ne;0;0;7;7
8664;Puriena;Meškučių;3526684967;Ne;6;4;0;10
8665;Puriena;Meškučių;1513909923;Ne;10;0;2;12
8666;Puriena;Meškučių;7556975480;Ne;10;0;3;13
8667;Puriena;Meškučių;2711642252;Taip;5;1;0;6
8668;Puriena;Meškučių;8093664167;Taip;5;1;0;6
8669;Puriena;Nykštukų;1053386081;Ne;10;2;2;14
8670;Puriena;Nykštukų;5469827031;Taip;10;0;0;10
8671;Puriena;Nykštukų;7649596096;Taip;8;0;4;12
8672;Puriena;Nykštukų;2762325241;Ne;5;1;6;12
8673;Puriena;Nykštukų;9907142348;Ne;4;0;3;7
8674;Puriena;Nykštukų;9369786639;Ne;15;0;0;15
8675;Puriena;Nykštukų;4728991133;Ne;0;2;1;3
8676;Puriena;Nykštukų;2344061847;Ne;0;3;0;3
8677;Puriena;Nykštukų;3630564604;Ne;0;2;0;2
8678;Puriena;Nykštukų;9438604106;Ne;7;4;0;11
8679;Puriena;Nykštukų;9379314578;Ne;17;0;0;17
8680;Puriena;Nykštukų;4211784186;Ne;13;0;0;13
8681;Puriena;Nykštukų;2146727759;Ne;14;0;0;14
8682;Puriena;Nykštukų;1988826809;Ne;0;1;1;2
8683;Puriena;Nykštukų;6605817147;Ne;5;0;0;5
8684;Puriena;Nykštukų;6271951373;Ne;8;4;0;12
8685;Puriena;Nykštukų;7869104640;Ne;17;0;0;17
8686;Puriena;Nykštukų;9931397038;Ne;0;4;0;4
8687;Puriena;Nykštukų;9497287421;Ne;0;2;2;4
8688;Puriena;Nykštukų;4006267650;Ne;0;11;0;11
8689;Puriena;Nykštukų;5277351784;Ne;1;4;0;5
8690;Puriena;Nykštukų;3215364967;Ne;0;5;1;6
8691;Puriena;Ežiukai;6451492815;Ne;0;4;3;7
8692;Puriena;Ežiukai;7913847170;Ne;5;3;0;8
8693;Puriena;Ežiukai;8089081251;Ne;0;10;0;10
8694;Puriena;Ežiukai;2830409862;Ne;5;6;0;11
8695;Puriena;Ežiukai;5550321808;Ne;0;4;3;7
8696;Puriena;Ežiukai;8038573068;Ne;0;6;1;7
8697;Puriena;Ežiukai;2624283930;Ne;0;4;0;4
8698;Puriena;Ežiukai;6001659356;Ne;0;4;1;5
8699;Puriena;Ežiukai;5539708916;Ne;17;0;0;17
8700;Puriena;Ežiukai;7335537384;Ne;0;0;6;6
8701;Puriena;Ežiukai;3204824116;Ne;13;0;1;14
8702;Puriena;Ežiukai;7720549981;Ne;3;0;5;8
8703;Puriena;Ežiukai;5555076926;Ne;5;0;5;10
8704;Puriena;Ežiukai;2312297583;Ne;0;0;6;6
8705;Puriena;Ežiukai;3232981406;Ne;6;0;4;10
8706;Puriena;Ežiukai;9228372078;Ne;5;9;5;19
8707;Puriena;Ežiukai;5374864513;Ne;14;0;0;14
8708;Puriena;Ežiukai;1737249860;Ne;0;4;0;4
8709;Puriena;Ežiukai;4608801156;Ne;0;5;0;5
8710;Puriena;Ežiukai;6991740430;Ne;0;0;2;2
8711;Puriena;"Boružiukų ";9600515308;Taip;0;0;6;6
8712;Puriena;"Boružiukų ";7985332838;Ne;0;19;0;19
8713;Puriena;"Boružiukų ";2818282875;Ne;0;4;0;4
8714;Puriena;"Boružiukų ";1796123753;Ne;10;0;5;15
8715;Puriena;"Boružiukų ";9489913940;Ne;5;0;4;9
8716;Puriena;"Boružiukų ";7350776605;Ne;6;0;0;6
8717;Puriena;"Boružiukų ";3521550682;Ne;6;0;1;7
8718;Puriena;"Boružiukų ";7554505121;Ne;4;1;5;10
8719;Puriena;"Boružiukų ";9728603155;Ne;0;0;6;6
8720;Puriena;"Boružiukų ";1453976004;Ne;3;4;1;8
8721;Puriena;"Boružiukų ";9402161115;Ne;0;5;0;5
8722;Puriena;"Boružiukų ";6966564224;Ne;6;0;2;8
8723;Puriena;"Boružiukų ";3888242345;Ne;6;0;2;8
8724;Puriena;"Boružiukų ";9085439508;Ne;13;0;0;13
8725;Puriena;"Boružiukų ";4139839679;Ne;0;0;2;2
8726;Puriena;"Zuikučių ";6549867740;Ne;2;1;6;9
8727;Puriena;"Zuikučių ";9102891844;Ne;10;1;1;12
8728;Puriena;"Zuikučių ";4946887007;Ne;0;19;0;19
8729;Puriena;"Zuikučių ";8607005504;Ne;11;0;0;11
8730;Puriena;"Zuikučių ";9553026735;Ne;10;0;3;13
8731;Puriena;"Zuikučių ";5257520238;Ne;0;0;3;3
8732;Puriena;"Zuikučių ";4549244705;Ne;13;2;0;15
8733;Puriena;"Zuikučių ";4102059769;Ne;12;0;1;13
8734;Puriena;"Zuikučių ";4257334383;Ne;0;4;0;4
8735;Puriena;"Zuikučių ";2736255661;Ne;7;2;1;10
8736;Puriena;"Zuikučių ";4363865643;Ne;5;8;0;13
8737;Puriena;"Zuikučių ";6084041374;Ne;11;0;1;12
8738;Puriena;"Zuikučių ";1877494111;Ne;10;0;1;11
8739;Puriena;"Zuikučių ";3510157302;Ne;0;19;0;19
8740;Puriena;Skruzdėliukai;9729644429;Ne;1;2;0;3
8741;Puriena;Skruzdėliukai;3826282438;Taip;0;5;2;7
8742;Puriena;Skruzdėliukai;4283608124;Ne;12;4;0;16
8743;Puriena;Skruzdėliukai;8144488922;Ne;0;4;0;4
8744;Puriena;Skruzdėliukai;8476986855;Ne;4;5;0;9
8745;Puriena;Skruzdėliukai;3627403517;Ne;5;4;0;9
8746;Puriena;Skruzdėliukai;8130975863;Ne;6;4;0;10
8747;Puriena;Skruzdėliukai;6140294839;Ne;8;0;4;12
8748;Puriena;Skruzdėliukai;2813562677;Ne;7;4;0;11
8749;Puriena;Skruzdėliukai;9453994213;Ne;5;4;0;9
8750;Puriena;Skruzdėliukai;7120683581;Ne;0;4;0;4
8751;Puriena;Skruzdėliukai;4653085762;Ne;5;9;0;14
8752;Puriena;Skruzdėliukai;3542374463;Ne;0;4;0;4
8753;Puriena;Skruzdėliukai;8497070167;Taip;10;4;0;14
8754;Puriena;Skruzdėliukai;4498919764;Ne;2;10;3;15
8755;Puriena;Skruzdėliukai;1933733714;Taip;0;4;0;4
8756;Puriena;Skruzdėliukai;4517020977;Ne;0;5;0;5
8757;Puriena;Skruzdėliukai;6150437624;Ne;0;4;2;6
8758;Puriena;Skruzdėliukai;3455291312;Ne;7;4;1;12
8759;Puriena;Skruzdėliukai;9911792407;Ne;4;7;0;11
8760;Puriena;Skruzdėliukai;6352605894;Ne;2;3;0;5
8761;Pušaitė;Kodėlčiukai;8702361596;Ne;0;1;5;6
8762;Pušaitė;Kodėlčiukai;3832434608;Ne;0;4;0;4
8763;Pušaitė;Kodėlčiukai;4838345510;Ne;0;0;1;1
8764;Pušaitė;Kodėlčiukai;7068451014;Ne;3;5;0;8
8765;Pušaitė;Kodėlčiukai;6275090953;Ne;0;4;0;4
8766;Pušaitė;Kodėlčiukai;8750774616;Ne;0;4;0;4
8767;Pušaitė;Kodėlčiukai;4198571222;Ne;5;0;0;5
8768;Pušaitė;Kodėlčiukai;4743105731;Ne;0;0;2;2
8769;Pušaitė;Kodėlčiukai;9391350218;Ne;0;5;0;5
8770;Pušaitė;Kodėlčiukai;2793941689;Ne;4;0;0;4
8771;Pušaitė;Kodėlčiukai;9364887123;Ne;3;5;0;8
8772;Pušaitė;Kodėlčiukai;4326967247;Ne;3;2;0;5
8773;Pušaitė;Kodėlčiukai;5922053969;Ne;3;0;0;3
8774;Pušaitė;Kodėlčiukai;4473930703;Ne;0;6;2;8
8775;Pušaitė;Kodėlčiukai;6775428321;Ne;0;2;0;2
8776;Pušaitė;Kodėlčiukai;4615270419;Ne;11;2;0;13
8777;Pušaitė;Kodėlčiukai;7117784038;Ne;6;2;1;9
8778;Pušaitė;Kodėlčiukai;2253477550;Ne;0;1;0;1
8779;Pušaitė;Kodėlčiukai;8754286143;Ne;0;3;1;4
8780;Pušaitė;Kodėlčiukai;6186545163;Ne;0;4;0;4
8781;Pušaitė;Kodėlčiukai;3150144924;Ne;5;0;0;5
8782;Pušaitė;Kodėlčiukai;6189116357;Taip;12;0;4;16
8783;Pušaitė;Saulutės;2254269292;Ne;2;0;5;7
8784;Pušaitė;Saulutės;5306237557;Ne;0;0;7;7
8785;Pušaitė;Saulutės;7480846917;Ne;5;0;3;8
8786;Pušaitė;Saulutės;8355083823;Ne;2;4;4;10
8787;Pušaitė;Saulutės;2543188867;Ne;0;0;1;1
8788;Pušaitė;Saulutės;8914668904;Ne;0;9;3;12
8789;Pušaitė;Saulutės;2396217546;Ne;0;3;0;3
8790;Pušaitė;Saulutės;3126709123;Ne;0;0;3;3
8791;Pušaitė;Saulutės;5469990058;Ne;5;0;8;13
8792;Pušaitė;Saulutės;1044902638;Ne;9;0;0;9
8793;Pušaitė;Saulutės;6784729764;Ne;0;19;0;19
8794;Pušaitė;Saulutės;6215522656;Ne;3;0;0;3
8795;Pušaitė;Saulutės;2675136958;Ne;0;2;2;4
8796;Pušaitė;Saulutės;6261355186;Ne;0;4;10;14
8797;Pušaitė;Saulutės;7888103890;Ne;2;0;1;3
8798;Pušaitė;Saulutės;6848340140;Taip;0;3;0;3
8799;Pušaitė;Zuikučiai;7291412329;Ne;0;1;4;5
8800;Pušaitė;Zuikučiai;8931688329;Ne;8;0;1;9
8801;Pušaitė;Zuikučiai;5981944481;Ne;4;0;2;6
8802;Pušaitė;Zuikučiai;4511258460;Ne;0;1;8;9
8803;Pušaitė;Zuikučiai;5422616450;Ne;0;2;2;4
8804;Pušaitė;Zuikučiai;5819186055;Ne;5;0;2;7
8805;Pušaitė;Zuikučiai;9577925438;Ne;0;1;2;3
8806;Pušaitė;Zuikučiai;4234318548;Ne;0;3;0;3
8807;Pušaitė;Zuikučiai;1384820994;Ne;5;0;1;6
8808;Pušaitė;Zuikučiai;7237345427;Ne;3;1;2;6
8809;Pušaitė;Zuikučiai;9180309936;Ne;8;2;0;10
8810;Pušaitė;Zuikučiai;4754791489;Ne;0;1;1;2
8811;Pušaitė;Zuikučiai;4082173648;Ne;4;3;0;7
8812;Pušaitė;Zuikučiai;2264047794;Ne;5;2;2;9
8813;Pušaitė;Zuikučiai;3052743933;Ne;0;19;0;19
8814;Pušaitė;Zuikučiai;4278699624;Ne;0;4;0;4
8815;Pušaitė;Zuikučiai;8244793037;Ne;5;1;7;13
8816;Pušaitė;Zuikučiai;5002710062;Taip;0;14;0;14
8817;Pušaitė;Zuikučiai;3508664946;Ne;4;4;0;8
8818;Pušaitė;Zuikučiai;2887576870;Ne;3;0;1;4
8819;Pušaitė;Zuikučiai;7583243031;Ne;3;0;0;3
8820;Pušaitė;Zuikučiai;1180343204;Ne;0;6;0;6
8821;Pušaitė;Vėžliukai;1326581025;Ne;0;8;0;8
8822;Pušaitė;Vėžliukai;8135552679;Ne;0;0;2;2
8823;Pušaitė;Vėžliukai;5161142520;Ne;0;1;0;1
8824;Pušaitė;Vėžliukai;3485234259;Ne;0;2;0;2
8825;Pušaitė;Vėžliukai;3014867515;Ne;0;6;0;6
8826;Pušaitė;Vėžliukai;9414554800;Ne;0;2;3;5
8827;Pušaitė;Vėžliukai;9470667227;Ne;0;1;0;1
8828;Pušaitė;Vėžliukai;6739253961;Ne;0;6;0;6
8829;Pušaitė;Vėžliukai;3014180020;Ne;5;3;0;8
8830;Pušaitė;Vėžliukai;7890577174;Ne;0;6;0;6
8831;Pušaitė;Vėžliukai;7652706756;Ne;0;5;0;5
8832;Pušaitė;Vėžliukai;5318602924;Ne;0;3;0;3
8833;Pušaitė;Vėžliukai;6794867560;Ne;0;3;0;3
8834;Pušaitė;Vėžliukai;5296435012;Ne;0;0;1;1
8835;Pušaitė;Vėžliukai;6833083982;Ne;0;3;0;3
8836;Pušaitė;Vėžliukai;5512786073;Ne;10;3;0;13
8837;Pušaitė;Vėžliukai;8399589954;Ne;5;4;0;9
8838;Pušaitė;Vėžliukai;4281125486;Ne;0;2;1;3
8839;Pušaitė;Vėžliukai;2777222076;Ne;0;1;0;1
8840;Pušaitė;"Linksmieji nykštukai";9265357004;Ne;1;2;0;3
8841;Pušaitė;"Linksmieji nykštukai";7520393710;Ne;0;4;1;5
8842;Pušaitė;"Linksmieji nykštukai";4517181474;Ne;2;5;0;7
8843;Pušaitė;"Linksmieji nykštukai";9033615485;Ne;1;5;0;6
8844;Pušaitė;"Linksmieji nykštukai";3130824742;Ne;0;3;0;3
8845;Pušaitė;"Linksmieji nykštukai";1781601521;Ne;0;1;0;1
8846;Pušaitė;"Linksmieji nykštukai";1024996364;Ne;3;4;1;8
8847;Pušaitė;"Linksmieji nykštukai";4662871524;Ne;0;9;0;9
8848;Pušaitė;"Linksmieji nykštukai";8438652029;Ne;1;5;0;6
8849;Pušaitė;"Linksmieji nykštukai";6578483902;Ne;0;3;0;3
8850;Pušaitė;"Linksmieji nykštukai";3350461304;Ne;3;3;0;6
8851;Pušaitė;"Linksmieji nykštukai";9327636862;Ne;0;2;0;2
8852;Pušaitė;"Linksmieji nykštukai";4175909754;Ne;11;4;0;15
8853;Pušaitė;"Linksmieji nykštukai";3788392895;Ne;4;1;0;5
8854;Pušaitė;"Linksmieji nykštukai";3195191374;Ne;2;3;0;5
8855;Pušaitė;"Linksmieji nykštukai";9127444013;Ne;1;9;0;10
8856;Pušaitė;"Linksmieji nykštukai";5422784898;Ne;0;4;0;4
8857;Pušaitė;"Linksmieji nykštukai";5104111840;Ne;0;6;0;6
8858;Pušaitė;"Linksmieji nykštukai";9866431097;Ne;4;4;0;8
8859;Pušaitė;"Linksmieji nykštukai";4564478833;Ne;5;4;0;9
8860;Pušaitė;"Linksmieji nykštukai";4374232593;Ne;0;3;0;3
8861;Pušaitė;"Linksmieji nykštukai";8378313810;Ne;2;3;0;5
8862;Pušaitė;"Kačiukų trobelė";3695016765;Ne;15;1;0;16
8863;Pušaitė;"Kačiukų trobelė";5415680731;Ne;0;4;0;4
8864;Pušaitė;"Kačiukų trobelė";7614475216;Ne;0;1;0;1
8865;Pušaitė;"Kačiukų trobelė";1122112207;Ne;0;6;0;6
8866;Pušaitė;"Kačiukų trobelė";1635528919;Ne;3;4;0;7
8867;Pušaitė;"Kačiukų trobelė";2837439334;Ne;13;0;0;13
8868;Pušaitė;"Kačiukų trobelė";7014914682;Ne;1;1;0;2
8869;Pušaitė;"Kačiukų trobelė";1624587173;Ne;0;3;0;3
8870;Pušaitė;"Kačiukų trobelė";8793102437;Ne;0;10;0;10
8871;Pušaitė;"Kačiukų trobelė";9056933586;Ne;10;4;0;14
8872;Pušaitė;"Kačiukų trobelė";7898355721;Ne;3;2;0;5
8873;Pušaitė;"Kačiukų trobelė";6323180798;Ne;0;3;0;3
8874;Pušaitė;"Kačiukų trobelė";5191894075;Ne;0;3;0;3
8875;Pušaitė;"Kačiukų trobelė";1161519408;Ne;0;2;0;2
8876;Pušaitė;"Kačiukų trobelė";8822285103;Ne;0;3;0;3
8877;Pušaitė;"Kačiukų trobelė";9313564235;Ne;0;5;0;5
8878;Pušaitė;"Kačiukų trobelė";2865062081;Ne;5;3;0;8
8879;Pušaitė;"Kačiukų trobelė";2430891944;Ne;1;1;0;2
8880;Pušaitė;"Kačiukų trobelė";1978339054;Ne;0;3;0;3
8881;Pušaitė;"Kačiukų trobelė";5461822909;Ne;3;5;0;8
8882;Pušaitė;Ežiukai;5013833636;Ne;0;1;4;5
8883;Pušaitė;Ežiukai;6742576615;Ne;0;0;4;4
8884;Pušaitė;Ežiukai;7891007708;Ne;0;3;0;3
8885;Pušaitė;Ežiukai;3732377309;Ne;4;0;0;4
8886;Pušaitė;Ežiukai;6511940816;Ne;5;0;4;9
8887;Pušaitė;Ežiukai;9546541248;Ne;0;0;5;5
8888;Pušaitė;Ežiukai;4529006786;Ne;9;2;0;11
8889;Pušaitė;Ežiukai;6767281906;Ne;0;2;0;2
8890;Pušaitė;Ežiukai;7210529114;Ne;0;5;0;5
8891;Pušaitė;Ežiukai;9164927041;Ne;0;1;15;16
8892;Pušaitė;Ežiukai;9867041220;Ne;5;5;0;10
8893;Pušaitė;Ežiukai;9031289300;Ne;0;0;8;8
8894;Pušaitė;Ežiukai;2758026755;Ne;0;3;0;3
8895;Pušaitė;Ežiukai;6059415475;Ne;0;0;12;12
8896;Pušaitė;Ežiukai;6851908671;Ne;0;0;2;2
8897;Pušaitė;Ežiukai;7737524017;Ne;5;3;2;10
8898;Pušaitė;Ežiukai;1069369636;Ne;0;8;0;8
8899;Pušaitė;Ežiukai;2454348536;Ne;12;1;4;17
8900;Pušaitė;Ežiukai;4883211957;Ne;8;0;0;8
8901;Pušaitė;"Gudručių šalis";8763667682;Ne;0;3;0;3
8902;Pušaitė;"Gudručių šalis";2321256048;Ne;4;2;0;6
8903;Pušaitė;"Gudručių šalis";5488507646;Ne;0;19;0;19
8904;Pušaitė;"Gudručių šalis";1305526154;Ne;11;0;3;14
8905;Pušaitė;"Gudručių šalis";6205900423;Ne;0;19;0;19
8906;Pušaitė;"Gudručių šalis";2078734161;Ne;0;0;4;4
8907;Pušaitė;"Gudručių šalis";8790959900;Ne;0;2;3;5
8908;Pušaitė;"Gudručių šalis";2397106198;Ne;0;4;0;4
8909;Pušaitė;"Gudručių šalis";3694667637;Ne;11;0;3;14
8910;Pušaitė;"Gudručių šalis";8343949011;Ne;3;0;1;4
8911;Pušaitė;"Gudručių šalis";4101285889;Ne;5;0;8;13
8912;Pušaitė;"Gudručių šalis";3959838346;Ne;11;2;3;16
8913;Pušaitė;"Gudručių šalis";5563772495;Ne;10;4;0;14
8914;Pušaitė;"Gudručių šalis";6356263503;Ne;5;0;3;8
8915;Pušaitė;"Gudručių šalis";4626055123;Ne;1;2;0;3
8916;Pušaitė;"Gudručių šalis";2333176054;Ne;0;2;0;2
8917;Pušaitė;"Gudručių šalis";7066207306;Ne;0;7;0;7
8918;Pušaitė;"Gudručių šalis";4918124423;Ne;0;0;19;19
8919;Pušaitė;"Gudručių šalis";6734504906;Ne;0;0;4;4
8920;Pušaitė;"Gudručių šalis";7992567219;Ne;3;1;2;6
8921;Pušaitė;"Gudručių šalis";1807432967;Ne;0;0;3;3
8922;Pušaitė;"Lapučių mokyklėlė";9337726482;Ne;0;3;0;3
8923;Pušaitė;"Lapučių mokyklėlė";2666541612;Ne;0;2;0;2
8924;Pušaitė;"Lapučių mokyklėlė";8343225451;Ne;0;4;0;4
8925;Pušaitė;"Lapučių mokyklėlė";8218991320;Ne;4;2;0;6
8926;Pušaitė;"Lapučių mokyklėlė";1994898058;Ne;0;2;4;6
8927;Pušaitė;"Lapučių mokyklėlė";8551426938;Ne;4;4;0;8
8928;Pušaitė;"Lapučių mokyklėlė";4444972517;Ne;3;5;0;8
8929;Pušaitė;"Lapučių mokyklėlė";4857214952;Ne;5;2;0;7
8930;Pušaitė;"Lapučių mokyklėlė";4138386134;Ne;0;1;0;1
8931;Pušaitė;"Lapučių mokyklėlė";4103149433;Ne;2;5;0;7
8932;Pušaitė;"Lapučių mokyklėlė";4747611989;Ne;0;2;0;2
8933;Pušaitė;"Lapučių mokyklėlė";3387165403;Ne;0;4;0;4
8934;Pušaitė;"Lapučių mokyklėlė";5339878948;Ne;0;5;0;5
8935;Pušaitė;"Lapučių mokyklėlė";3610256789;Ne;4;6;1;11
8936;Pušaitė;"Lapučių mokyklėlė";6576647982;Ne;4;1;0;5
8937;Pušaitė;"Lapučių mokyklėlė";1395577340;Ne;0;5;0;5
8938;Pušaitė;"Lapučių mokyklėlė";1534764228;Ne;0;4;0;4
8939;Pušaitė;"Lapučių mokyklėlė";5328083339;Ne;11;0;0;11
8940;Pušaitė;"Lapučių mokyklėlė";3200968850;Ne;0;9;0;9
8941;Pušaitė;"Lapučių mokyklėlė";5270684456;Ne;3;3;0;6
8942;Pušaitė;"VOVERIUKAI ";1665030028;Ne;5;0;4;9
8943;Pušaitė;"VOVERIUKAI ";4818407739;Ne;7;0;0;7
8944;Pušaitė;"VOVERIUKAI ";8876092901;Ne;4;5;0;9
8945;Pušaitė;"VOVERIUKAI ";4767321724;Ne;3;5;0;8
8946;Pušaitė;"VOVERIUKAI ";1542239525;Ne;5;1;1;7
8947;Pušaitė;"VOVERIUKAI ";7971556404;Ne;16;0;0;16
8948;Pušaitė;"VOVERIUKAI ";6643741885;Ne;3;3;2;8
8949;Pušaitė;"VOVERIUKAI ";1439721280;Ne;17;0;0;17
8950;Pušaitė;"VOVERIUKAI ";8157849971;Taip;12;0;0;12
8951;Pušaitė;"VOVERIUKAI ";6891217457;Ne;11;0;0;11
8952;Pušaitė;"VOVERIUKAI ";6786313527;Ne;6;4;0;10
8953;Pušaitė;"VOVERIUKAI ";8739461926;Ne;0;13;0;13
8954;Pušaitė;"VOVERIUKAI ";8967363762;Ne;0;19;0;19
8955;Pušaitė;"VOVERIUKAI ";2699657569;Ne;4;0;0;4
8956;Pušaitė;"VOVERIUKAI ";5191447724;Ne;16;0;0;16
8957;Pušaitė;MEŠKUČIAI;6754402783;Taip;5;3;0;8
8958;Pušaitė;MEŠKUČIAI;3239486674;Ne;8;0;0;8
8959;Pušaitė;MEŠKUČIAI;9339706754;Ne;10;0;0;10
8960;Pušaitė;MEŠKUČIAI;9418440677;Ne;6;1;0;7
8961;Pušaitė;MEŠKUČIAI;7426036114;Ne;9;5;0;14
8962;Pušaitė;MEŠKUČIAI;9887693476;Ne;2;7;0;9
8963;Pušaitė;MEŠKUČIAI;1034005054;Ne;11;0;2;13
8964;Pušaitė;MEŠKUČIAI;8720258818;Taip;0;4;0;4
8965;Pušaitė;MEŠKUČIAI;8916214448;Ne;13;1;0;14
8966;Pušaitė;MEŠKUČIAI;3238080908;Ne;0;5;0;5
8967;Pušaitė;MEŠKUČIAI;4331500545;Ne;0;1;0;1
8968;Pušaitė;MEŠKUČIAI;7278950473;Ne;5;0;0;5
8969;Pušaitė;MEŠKUČIAI;3994799424;Ne;0;0;1;1
8970;Pušaitė;MEŠKUČIAI;5686927118;Ne;0;19;0;19
8971;Pušaitė;PELIUKAI;9177861202;Ne;10;6;0;16
8972;Pušaitė;PELIUKAI;6645711171;Ne;10;6;0;16
8973;Pušaitė;PELIUKAI;2618038364;Ne;11;4;0;15
8974;Pušaitė;PELIUKAI;5112517007;Ne;5;2;0;7
8975;Pušaitė;PELIUKAI;9261546370;Ne;0;3;0;3
8976;Pušaitė;PELIUKAI;7285450755;Ne;5;1;1;7
8977;Pušaitė;PELIUKAI;7204853123;Ne;0;8;0;8
8978;Pušaitė;PELIUKAI;4802860079;Ne;8;5;3;16
8979;Pušaitė;PELIUKAI;2772351972;Ne;9;0;0;9
8980;Pušaitė;PELIUKAI;5305731047;Ne;0;1;0;1
8981;Pušaitė;PELIUKAI;1450204608;Ne;0;19;0;19
8982;Pušaitė;PELIUKAI;7553389781;Ne;7;0;0;7
8983;Pušaitė;PELIUKAI;4420904389;Ne;0;19;0;19
8984;Pušaitė;PELIUKAI;8273198870;Ne;0;3;0;3
8985;Pušaitė;PELIUKAI;3245931596;Ne;0;19;0;19
8986;"Pušynėlis (Miglos g. 53)";PUMPURĖLIAI;8845728723;Ne;0;2;0;2
8987;"Pušynėlis (Miglos g. 53)";PUMPURĖLIAI;9465619945;Ne;0;3;0;3
8988;"Pušynėlis (Miglos g. 53)";PUMPURĖLIAI;4962270317;Ne;2;0;0;2
8989;"Pušynėlis (Miglos g. 53)";PUMPURĖLIAI;7689524787;Ne;11;0;0;11
8990;"Pušynėlis (Miglos g. 53)";PUMPURĖLIAI;1133655729;Ne;7;0;0;7
8991;"Pušynėlis (Miglos g. 53)";PUMPURĖLIAI;1517104634;Ne;0;6;0;6
8992;"Pušynėlis (Miglos g. 53)";PUMPURĖLIAI;7732546085;Ne;10;2;0;12
8993;"Pušynėlis (Miglos g. 53)";PUMPURĖLIAI;1240222214;Ne;7;3;0;10
8994;"Pušynėlis (Miglos g. 53)";PUMPURĖLIAI;6414064067;Ne;0;4;0;4
8995;"Pušynėlis (Miglos g. 53)";PUMPURĖLIAI;8933840402;Ne;10;0;0;10
8996;"Pušynėlis (Miglos g. 53)";PUMPURĖLIAI;1439408620;Ne;16;0;0;16
8997;"Pušynėlis (Miglos g. 53)";PUMPURĖLIAI;7964828070;Ne;2;4;0;6
8998;"Pušynėlis (Miglos g. 53)";PUMPURĖLIAI;3682719098;Ne;3;0;0;3
8999;"Pušynėlis (Miglos g. 53)";PUMPURĖLIAI;4449613959;Taip;19;0;0;19
9000;"Pušynėlis (Miglos g. 53)";PUMPURĖLIAI;3125802067;Ne;8;0;0;8
9001;"Pušynėlis (Miglos g. 53)";PUMPURĖLIAI;1508282873;Ne;4;0;0;4
9002;"Pušynėlis (Miglos g. 53)";PUMPURĖLIAI;4603625624;Ne;2;4;0;6
9003;"Pušynėlis (Miglos g. 53)";PUMPURĖLIAI;5488832089;Taip;5;0;0;5
9004;"Pušynėlis (Miglos g. 53)";PUMPURĖLIAI;5670094788;Ne;11;4;0;15
9005;"Pušynėlis (Miglos g. 53)";PUMPURĖLIAI;5264481173;Ne;10;0;0;10
9006;"Pušynėlis (Miglos g. 53)";PUMPURĖLIAI;6318952845;Ne;3;0;1;4
9007;"Pušynėlis (Miglos g. 53)";SAULUTĖS;5501281051;Ne;11;0;0;11
9008;"Pušynėlis (Miglos g. 53)";SAULUTĖS;2135996648;Ne;12;0;0;12
9009;"Pušynėlis (Miglos g. 53)";SAULUTĖS;9454407638;Ne;9;0;0;9
9010;"Pušynėlis (Miglos g. 53)";SAULUTĖS;5508064424;Ne;8;0;0;8
9011;"Pušynėlis (Miglos g. 53)";SAULUTĖS;5568838550;Ne;9;0;0;9
9012;"Pušynėlis (Miglos g. 53)";SAULUTĖS;2553444832;Ne;1;0;0;1
9013;"Pušynėlis (Miglos g. 53)";SAULUTĖS;2718421498;Ne;3;3;0;6
9014;"Pušynėlis (Miglos g. 53)";SAULUTĖS;2509111066;Ne;1;3;0;4
9015;"Pušynėlis (Miglos g. 53)";SAULUTĖS;8902047615;Ne;4;0;0;4
9016;"Pušynėlis (Miglos g. 53)";SAULUTĖS;3483639540;Ne;1;3;0;4
9017;"Pušynėlis (Miglos g. 53)";SAULUTĖS;2861000826;Ne;6;0;0;6
9018;"Pušynėlis (Miglos g. 53)";SAULUTĖS;5802582694;Ne;1;3;0;4
9019;"Pušynėlis (Miglos g. 53)";SAULUTĖS;3882064516;Ne;4;0;0;4
9020;"Pušynėlis (Miglos g. 53)";SAULUTĖS;9081582524;Ne;4;0;0;4
9021;"Pušynėlis (Miglos g. 53)";SAULUTĖS;9883505094;Ne;4;0;0;4
9022;"Pušynėlis (Miglos g. 53)";SAULUTĖS;4526807309;Ne;1;3;0;4
9023;"Pušynėlis (Miglos g. 53)";SAULUTĖS;7787646910;Ne;1;3;0;4
9024;"Pušynėlis (Miglos g. 53)";SAULUTĖS;7438923710;Ne;7;3;0;10
9025;"Pušynėlis (Miglos g. 53)";SAULUTĖS;6110878898;Ne;10;0;0;10
9026;"Pušynėlis (Miglos g. 53)";SAULUTĖS;8803766149;Ne;8;0;0;8
9027;"Pušynėlis (Miglos g. 53)";SAULUTĖS;8462742834;Ne;2;3;0;5
9028;"Pušynėlis (Miglos g. 53)";SAULUTĖS;8218331977;Ne;0;2;0;2
9029;"Pušynėlis (Miglos g. 53)";SAULUTĖS;6962705842;Ne;3;0;0;3
9030;"Pušynėlis (Miglos g. 53)";SAULUTĖS;2744665477;Ne;2;0;0;2
9031;"Pušynėlis (Miglos g. 53)";PRIEŠMOKYKLINĖ;4668634909;Ne;0;5;0;5
9032;"Pušynėlis (Miglos g. 53)";PRIEŠMOKYKLINĖ;4030500100;Ne;1;4;0;5
9033;"Pušynėlis (Miglos g. 53)";PRIEŠMOKYKLINĖ;8172450090;Ne;0;4;0;4
9034;"Pušynėlis (Miglos g. 53)";PRIEŠMOKYKLINĖ;3158789663;Ne;0;4;0;4
9035;"Pušynėlis (Miglos g. 53)";PRIEŠMOKYKLINĖ;9483417104;Ne;6;2;0;8
9036;"Pušynėlis (Miglos g. 53)";PRIEŠMOKYKLINĖ;1891728904;Ne;0;4;0;4
9037;"Pušynėlis (Miglos g. 53)";PRIEŠMOKYKLINĖ;7401066252;Ne;3;2;0;5
9038;"Pušynėlis (Miglos g. 53)";PRIEŠMOKYKLINĖ;6036296660;Ne;0;4;0;4
9039;"Pušynėlis (Miglos g. 53)";PRIEŠMOKYKLINĖ;1164201286;Ne;0;4;0;4
9040;"Pušynėlis (Miglos g. 53)";PRIEŠMOKYKLINĖ;2508640229;Ne;0;4;0;4
9041;"Pušynėlis (Miglos g. 53)";PRIEŠMOKYKLINĖ;1251787066;Ne;15;4;0;19
9042;"Pušynėlis (Miglos g. 53)";PRIEŠMOKYKLINĖ;5236219294;Ne;0;4;0;4
9043;"Pušynėlis (Miglos g. 53)";PRIEŠMOKYKLINĖ;6709692748;Ne;0;3;0;3
9044;"Pušynėlis (Miglos g. 53)";PRIEŠMOKYKLINĖ;8799095053;Ne;0;3;0;3
9045;"Pušynėlis (Miglos g. 53)";PRIEŠMOKYKLINĖ;5318223378;Ne;2;5;0;7
9046;"Pušynėlis (Miglos g. 53)";PRIEŠMOKYKLINĖ;4052132379;Ne;0;5;0;5
9047;"Pušynėlis (Miglos g. 53)";PRIEŠMOKYKLINĖ;3100230874;Ne;0;5;0;5
9048;"Pušynėlis (Miglos g. 53)";PRIEŠMOKYKLINĖ;8451160808;Ne;0;1;0;1
9049;"Pušynėlis (Miglos g. 53)";PRIEŠMOKYKLINĖ;7896617995;Ne;0;4;1;5
9050;"Pušynėlis (Miglos g. 53)";PRIEŠMOKYKLINĖ;5897839636;Ne;0;8;0;8
9051;"Pušynėlis (Miglos g. 53)";PRIEŠMOKYKLINĖ;1034336110;Ne;4;4;0;8
9052;"Pušynėlis (Miglos g. 53)";PRIEŠMOKYKLINĖ;3483007385;Ne;0;5;0;5
9053;"Pušynėlis (Miglos g. 53)";"TREPSIUKAI (2018.09)";4468698630;Ne;2;4;1;7
9054;"Pušynėlis (Miglos g. 53)";"TREPSIUKAI (2018.09)";7745507151;Ne;3;0;1;4
9055;"Pušynėlis (Miglos g. 53)";"TREPSIUKAI (2018.09)";8911046719;Ne;0;0;1;1
9056;"Pušynėlis (Miglos g. 53)";"TREPSIUKAI (2018.09)";8668256321;Ne;0;0;1;1
9057;"Pušynėlis (Miglos g. 53)";"TREPSIUKAI (2018.09)";4750005431;Ne;5;0;0;5
9058;"Pušynėlis (Miglos g. 53)";"TREPSIUKAI (2018.09)";5748126562;Ne;10;9;0;19
9059;"Pušynėlis (Miglos g. 53)";"TREPSIUKAI (2018.09)";7752614074;Ne;0;0;2;2
9060;"Pušynėlis (Miglos g. 53)";"TREPSIUKAI (2018.09)";9665045009;Ne;0;10;1;11
9061;"Pušynėlis (Miglos g. 53)";"TREPSIUKAI (2018.09)";1318218735;Ne;11;0;0;11
9062;"Pušynėlis (Miglos g. 53)";"TREPSIUKAI (2018.09)";5723212271;Ne;0;19;0;19
9063;Raktelis;LAŠIUKAI;4671391106;Ne;0;7;0;7
9064;Raktelis;LAŠIUKAI;9230053040;Ne;15;4;0;19
9065;Raktelis;LAŠIUKAI;9139322116;Ne;0;4;5;9
9066;Raktelis;LAŠIUKAI;6929358401;Ne;0;6;0;6
9067;Raktelis;LAŠIUKAI;4317705126;Ne;6;2;0;8
9068;Raktelis;LAŠIUKAI;2652125338;Ne;1;3;0;4
9069;Raktelis;LAŠIUKAI;5627179884;Ne;0;4;0;4
9070;Raktelis;LAŠIUKAI;4187804340;Ne;1;4;1;6
9071;Raktelis;LAŠIUKAI;9965855682;Ne;0;4;0;4
9072;Raktelis;LAŠIUKAI;7265543701;Ne;0;5;0;5
9073;Raktelis;LAŠIUKAI;4319176525;Ne;1;4;0;5
9074;Raktelis;LAŠIUKAI;5218387088;Ne;0;3;0;3
9075;Raktelis;LAŠIUKAI;5820028619;Ne;0;4;0;4
9076;Raktelis;LAŠIUKAI;5405322552;Ne;0;4;3;7
9077;Raktelis;LAŠIUKAI;3821849812;Ne;5;6;1;12
9078;Raktelis;LAŠIUKAI;4905982507;Ne;0;6;0;6
9079;Raktelis;LAŠIUKAI;7170546710;Ne;3;4;6;13
9080;Raktelis;LAŠIUKAI;9355380341;Ne;2;3;1;6
9081;Raktelis;LAŠIUKAI;9593639791;Ne;10;4;0;14
9082;Raktelis;LAŠIUKAI;1975411457;Ne;0;4;0;4
9083;Raktelis;LAŠIUKAI;6608224825;Ne;0;9;0;9
9084;Raktelis;LAŠIUKAI;2289954824;Ne;1;2;0;3
9085;Raktelis;LAŠIUKAI;6199212999;Ne;0;7;0;7
9086;Raktelis;LAŠIUKAI;1622504968;Ne;3;2;0;5
9087;Raktelis;LAŠIUKAI;9591285702;Ne;0;4;0;4
9088;Raktelis;BITUTĖS;3308623522;Ne;3;4;0;7
9089;Raktelis;BITUTĖS;4059286631;Ne;0;4;0;4
9090;Raktelis;BITUTĖS;5913060415;Ne;0;3;0;3
9091;Raktelis;BITUTĖS;6974263764;Ne;0;5;0;5
9092;Raktelis;BITUTĖS;6932820066;Ne;5;4;0;9
9093;Raktelis;BITUTĖS;2410682193;Ne;0;4;0;4
9094;Raktelis;BITUTĖS;5705825231;Ne;2;3;0;5
9095;Raktelis;BITUTĖS;4615337759;Ne;5;5;0;10
9096;Raktelis;BITUTĖS;4962251215;Ne;2;9;0;11
9097;Raktelis;BITUTĖS;8282429202;Ne;5;4;0;9
9098;Raktelis;BITUTĖS;7222856683;Ne;5;3;0;8
9099;Raktelis;BITUTĖS;7479542200;Ne;3;4;1;8
9100;Raktelis;BITUTĖS;6703168910;Ne;8;4;0;12
9101;Raktelis;BITUTĖS;1026592738;Ne;0;4;0;4
9102;Raktelis;BITUTĖS;7900644404;Ne;15;4;0;19
9103;Raktelis;BITUTĖS;6685891017;Ne;2;3;2;7
9104;Raktelis;BITUTĖS;3484991718;Ne;0;2;0;2
9105;Raktelis;BITUTĖS;6358227532;Ne;0;9;0;9
9106;Raktelis;BITUTĖS;9718355271;Ne;0;7;0;7
9107;Raktelis;BITUTĖS;8608093349;Ne;2;4;0;6
9108;Raktelis;BITUTĖS;6855863189;Ne;4;4;0;8
9109;Raktelis;BITUTĖS;7605822626;Ne;0;6;0;6
9110;Raktelis;BITUTĖS;9169797346;Ne;0;6;0;6
9111;Raktelis;BITUTĖS;2383174152;Ne;1;12;0;13
9112;Raktelis;BITUTĖS;7046291082;Ne;0;3;0;3
9113;Raktelis;BORUŽĖLĖS;7068061170;Ne;6;0;0;6
9114;Raktelis;BORUŽĖLĖS;2361477092;Ne;0;5;0;5
9115;Raktelis;BORUŽĖLĖS;4226277600;Ne;6;4;0;10
9116;Raktelis;BORUŽĖLĖS;2599670832;Ne;5;0;0;5
9117;Raktelis;BORUŽĖLĖS;1757601091;Ne;5;4;0;9
9118;Raktelis;BORUŽĖLĖS;5865484633;Ne;3;4;0;7
9119;Raktelis;BORUŽĖLĖS;4529213150;Ne;0;2;0;2
9120;Raktelis;BORUŽĖLĖS;4936637343;Ne;0;4;0;4
9121;Raktelis;BORUŽĖLĖS;4333191842;Ne;4;10;0;14
9122;Raktelis;BORUŽĖLĖS;9529797517;Ne;0;6;0;6
9123;Raktelis;BORUŽĖLĖS;4442395100;Ne;0;6;3;9
9124;Raktelis;BORUŽĖLĖS;5150954686;Ne;2;7;1;10
9125;Raktelis;BORUŽĖLĖS;3490428062;Ne;13;1;0;14
9126;Raktelis;BORUŽĖLĖS;1314972335;Ne;0;9;0;9
9127;Raktelis;BORUŽĖLĖS;3343352568;Ne;5;6;0;11
9128;Raktelis;BORUŽĖLĖS;2698820718;Ne;0;3;0;3
9129;Raktelis;BORUŽĖLĖS;7990626447;Ne;5;5;0;10
9130;Raktelis;BORUŽĖLĖS;7459272209;Ne;0;4;0;4
9131;Raktelis;BORUŽĖLĖS;5046450478;Taip;5;5;0;10
9132;Raktelis;BORUŽĖLĖS;1141447274;Ne;4;6;0;10
9133;Raktelis;BORUŽĖLĖS;5576511314;Ne;3;2;0;5
9134;Raktelis;BORUŽĖLĖS;9567582066;Ne;5;4;0;9
9135;Raktelis;BORUŽĖLĖS;3456093273;Ne;0;2;0;2
9136;Raktelis;BORUŽĖLĖS;8647112887;Ne;0;10;0;10
9137;Raktelis;KAČIUKAI;5270430511;Ne;6;4;0;10
9138;Raktelis;KAČIUKAI;4622683599;Ne;7;2;0;9
9139;Raktelis;KAČIUKAI;8600632097;Ne;0;5;0;5
9140;Raktelis;KAČIUKAI;7630501672;Ne;4;4;0;8
9141;Raktelis;KAČIUKAI;6007823584;Ne;5;2;1;8
9142;Raktelis;KAČIUKAI;3733786043;Ne;0;4;0;4
9143;Raktelis;KAČIUKAI;8456082594;Ne;0;3;0;3
9144;Raktelis;KAČIUKAI;4676213966;Ne;13;0;0;13
9145;Raktelis;KAČIUKAI;4631375439;Ne;0;6;0;6
9146;Raktelis;KAČIUKAI;6265489540;Ne;6;5;0;11
9147;Raktelis;KAČIUKAI;4160091258;Taip;4;4;0;8
9148;Raktelis;KAČIUKAI;3775306030;Ne;9;3;0;12
9149;Raktelis;KAČIUKAI;6550851582;Ne;6;3;0;9
9150;Raktelis;KAČIUKAI;4009105487;Ne;2;0;1;3
9151;Raktelis;KAČIUKAI;1843086151;Ne;3;5;0;8
9152;Raktelis;KAČIUKAI;2295251060;Ne;7;1;0;8
9153;Raktelis;KAČIUKAI;1983808547;Ne;7;5;0;12
9154;Raktelis;KAČIUKAI;5042538956;Ne;4;1;0;5
9155;Raktelis;KAČIUKAI;7260767942;Ne;4;2;1;7
9156;Raktelis;KAČIUKAI;1123693990;Ne;2;6;1;9
9157;Raktelis;KAČIUKAI;4979657165;Ne;0;13;0;13
9158;Raktelis;KAČIUKAI;9264550987;Ne;12;0;0;12
9159;Raktelis;KAČIUKAI;8767785444;Ne;0;4;0;4
9160;Raktelis;KIŠKUČIAI;1810732707;Ne;0;2;1;3
9161;Raktelis;KIŠKUČIAI;6473692639;Ne;3;2;0;5
9162;Raktelis;KIŠKUČIAI;1668164327;Ne;3;2;0;5
9163;Raktelis;KIŠKUČIAI;1058482540;Ne;6;5;0;11
9164;Raktelis;KIŠKUČIAI;6222364306;Ne;9;0;0;9
9165;Raktelis;KIŠKUČIAI;6451056434;Ne;4;0;0;4
9166;Raktelis;KIŠKUČIAI;1129962966;Ne;4;0;0;4
9167;Raktelis;KIŠKUČIAI;5213015670;Ne;6;0;0;6
9168;Raktelis;KIŠKUČIAI;7931502610;Ne;0;5;0;5
9169;Raktelis;KIŠKUČIAI;2976675359;Ne;18;0;0;18
9170;Raktelis;KIŠKUČIAI;9203811388;Ne;19;0;0;19
9171;Raktelis;KIŠKUČIAI;1511932941;Ne;10;0;0;10
9172;Raktelis;KIŠKUČIAI;5053933317;Ne;13;0;0;13
9173;Raktelis;KIŠKUČIAI;1664533959;Taip;12;1;0;13
9174;Raktelis;KIŠKUČIAI;4111432214;Ne;12;0;0;12
9175;Raktelis;NYKŠTUKAI;7865593006;Ne;3;0;0;3
9176;Raktelis;NYKŠTUKAI;4252867688;Ne;2;3;0;5
9177;Raktelis;NYKŠTUKAI;8817859592;Ne;4;2;0;6
9178;Raktelis;NYKŠTUKAI;4578445282;Ne;0;6;1;7
9179;Raktelis;NYKŠTUKAI;3890474241;Ne;0;3;0;3
9180;Raktelis;NYKŠTUKAI;9164539135;Ne;6;1;0;7
9181;Raktelis;NYKŠTUKAI;4147382341;Ne;0;6;0;6
9182;Raktelis;NYKŠTUKAI;3968555691;Ne;0;8;0;8
9183;Raktelis;NYKŠTUKAI;2234892629;Ne;1;1;0;2
9184;Raktelis;NYKŠTUKAI;8507551381;Ne;1;1;0;2
9185;Raktelis;NYKŠTUKAI;4764915486;Ne;2;3;0;5
9186;Raktelis;NYKŠTUKAI;4765483387;Ne;5;1;0;6
9187;Raktelis;NYKŠTUKAI;2803146830;Ne;10;4;0;14
9188;Raktelis;NYKŠTUKAI;1002851704;Ne;19;0;0;19
9189;Raktelis;NYKŠTUKAI;7202523804;Ne;0;6;0;6
9190;Raktelis;NYKŠTUKAI;6718159439;Ne;1;10;0;11
9191;Raktelis;NYKŠTUKAI;7058612493;Ne;7;1;0;8
9192;Raktelis;NYKŠTUKAI;9390692206;Ne;15;2;0;17
9193;Raktelis;NYKŠTUKAI;8992797384;Ne;0;5;0;5
9194;Raktelis;NYKŠTUKAI;9803505110;Ne;7;5;0;12
9195;Raktelis;NYKŠTUKAI;6587878165;Ne;0;4;0;4
9196;Raktelis;NYKŠTUKAI;2262854947;Ne;15;1;0;16
9197;Raktelis;NYKŠTUKAI;2278227649;Ne;3;6;0;9
9198;Raktelis;NYKŠTUKAI;3493159224;Ne;0;2;2;4
9199;Raktelis;PELIUKAI;2044812301;Ne;0;5;0;5
9200;Raktelis;PELIUKAI;7389910330;Ne;0;4;0;4
9201;Raktelis;PELIUKAI;8698736569;Ne;6;0;0;6
9202;Raktelis;PELIUKAI;9983004779;Ne;3;2;0;5
9203;Raktelis;PELIUKAI;6346741475;Ne;0;5;0;5
9204;Raktelis;PELIUKAI;7117319827;Ne;4;2;0;6
9205;Raktelis;PELIUKAI;4100807708;Ne;3;2;0;5
9206;Raktelis;PELIUKAI;9778807678;Ne;5;2;3;10
9207;Raktelis;PELIUKAI;2928040174;Ne;15;0;0;15
9208;Raktelis;PELIUKAI;5497606646;Ne;0;4;0;4
9209;Raktelis;PELIUKAI;4139932945;Ne;4;2;0;6
9210;Raktelis;PELIUKAI;8581379659;Ne;0;5;1;6
9211;Raktelis;PELIUKAI;7892633426;Ne;0;0;1;1
9212;Raktelis;PELIUKAI;7847787737;Ne;2;1;0;3
9213;Raktelis;AGUONOS;9039234219;Ne;15;0;0;15
9214;Raktelis;AGUONOS;3811586185;Ne;7;4;0;11
9215;Raktelis;AGUONOS;1714731965;Taip;16;0;0;16
9216;Raktelis;AGUONOS;9666909207;Ne;5;0;0;5
9217;Raktelis;AGUONOS;9992920721;Ne;14;0;0;14
9218;Raktelis;AGUONOS;3373893685;Ne;5;0;0;5
9219;Raktelis;AGUONOS;6499798110;Ne;5;0;0;5
9220;Raktelis;AGUONOS;2949132578;Ne;6;0;0;6
9221;Raktelis;AGUONOS;4828942464;Ne;3;5;0;8
9222;Raktelis;AGUONOS;5686613002;Ne;1;6;0;7
9223;Raktelis;AGUONOS;5362472918;Ne;5;4;0;9
9224;Raktelis;AGUONOS;9205511475;Ne;3;0;0;3
9225;Raktelis;AGUONOS;1197236154;Ne;4;0;0;4
9226;Raktelis;AGUONOS;2666984428;Ne;10;0;0;10
9227;Raktelis;AGUONOS;6019423312;Ne;10;0;0;10
9228;Raktelis;AGUONOS;2550528342;Ne;14;0;0;14
9229;Raktelis;LAPIUKŲ;3517484891;Ne;0;8;0;8
9230;Raktelis;LAPIUKŲ;2731096860;Ne;9;0;0;9
9231;Raktelis;LAPIUKŲ;1263150004;Ne;10;4;0;14
9232;Raktelis;LAPIUKŲ;9497620710;Ne;8;0;1;9
9233;Raktelis;LAPIUKŲ;1120263625;Ne;9;2;0;11
9234;Raktelis;LAPIUKŲ;5688795147;Ne;5;4;0;9
9235;Raktelis;LAPIUKŲ;8035618134;Ne;4;6;0;10
9236;Raktelis;LAPIUKŲ;8146076115;Ne;9;0;0;9
9237;Raktelis;LAPIUKŲ;8700012974;Ne;5;0;0;5
9238;Raktelis;LAPIUKŲ;1604357851;Ne;7;0;0;7
9239;Raktelis;LAPIUKŲ;5758873229;Ne;15;0;0;15
9240;Raktelis;LAPIUKŲ;9599034285;Ne;2;5;0;7
9241;Raktelis;LAPIUKŲ;3311870918;Ne;5;1;0;6
9242;Raktelis;LAPIUKŲ;6826993779;Ne;5;1;0;6
9243;Raktelis;LAPIUKŲ;6393143566;Ne;0;4;0;4
9244;Raktelis;LAPIUKŲ;2141128125;Ne;10;0;0;10
9245;Raktelis;LAPIUKŲ;4502236264;Ne;7;1;0;8
9246;Raktelis;LAPIUKŲ;2301442262;Ne;4;0;0;4
9247;Raktelis;LAPIUKŲ;6853881405;Ne;0;5;0;5
9248;Raktelis;LAPIUKŲ;4513031164;Ne;10;0;0;10
9249;Raktelis;LAPIUKŲ;4014822452;Ne;15;0;0;15
9250;Raktelis;PELĖDŽIUKAI;4583377785;Ne;4;5;0;9
9251;Raktelis;PELĖDŽIUKAI;7962509432;Ne;0;5;0;5
9252;Raktelis;PELĖDŽIUKAI;9716191639;Ne;0;4;4;8
9253;Raktelis;PELĖDŽIUKAI;8869030487;Ne;3;3;0;6
9254;Raktelis;PELĖDŽIUKAI;1322912585;Ne;0;4;6;10
9255;Raktelis;PELĖDŽIUKAI;6877934219;Ne;5;5;0;10
9256;Raktelis;PELĖDŽIUKAI;9130613710;Ne;4;5;0;9
9257;Raktelis;PELĖDŽIUKAI;9151796053;Ne;7;2;0;9
9258;Raktelis;PELĖDŽIUKAI;2282754345;Ne;0;2;0;2
9259;Raktelis;PELĖDŽIUKAI;8207675881;Ne;0;7;0;7
9260;Raktelis;PELĖDŽIUKAI;7869495911;Ne;0;2;0;2
9261;Raktelis;PELĖDŽIUKAI;5925441742;Ne;4;4;0;8
9262;Raktelis;PELĖDŽIUKAI;5082785025;Ne;0;3;0;3
9263;Raktelis;PELĖDŽIUKAI;7142823740;Taip;0;2;0;2
9264;Raktelis;PELĖDŽIUKAI;3395720463;Ne;0;6;0;6
9265;Raktelis;PELĖDŽIUKAI;4167194960;Taip;4;1;0;5
9266;Raktelis;PELĖDŽIUKAI;2809458453;Ne;11;2;0;13
9267;Raktelis;PELĖDŽIUKAI;6894769625;Ne;9;4;0;13
9268;Raktelis;PELĖDŽIUKAI;5487606214;Ne;0;0;3;3
9269;Raktelis;PELĖDŽIUKAI;2967941870;Taip;3;5;0;8
9270;Raktelis;PELĖDŽIUKAI;9048412613;Ne;0;3;0;3
9271;Raktelis;PELĖDŽIUKAI;7440866459;Ne;4;1;0;5
9272;Raktelis;PELĖDŽIUKAI;3884068578;Ne;0;4;0;4
9273;Raktelis;PELĖDŽIUKAI;4755892641;Ne;0;7;0;7
9274;Raktelis;MEŠKIUKAI;8851021346;Ne;2;1;0;3
9275;Raktelis;MEŠKIUKAI;4185763817;Ne;6;2;0;8
9276;Raktelis;MEŠKIUKAI;8341026400;Ne;2;2;0;4
9277;Raktelis;MEŠKIUKAI;2103900090;Ne;1;0;0;1
9278;Raktelis;MEŠKIUKAI;5718804414;Ne;3;0;0;3
9279;Raktelis;MEŠKIUKAI;2171952119;Ne;10;0;0;10
9280;Raktelis;MEŠKIUKAI;6409457833;Ne;5;5;0;10
9281;Raktelis;MEŠKIUKAI;8515886073;Ne;1;0;0;1
9282;Raktelis;MEŠKIUKAI;3956151570;Ne;14;0;0;14
9283;Raktelis;MEŠKIUKAI;1740426946;Ne;18;0;0;18
9284;Raktelis;MEŠKIUKAI;6992649778;Ne;0;9;0;9
9285;Raktelis;MEŠKIUKAI;1304479190;Ne;19;0;0;19
9286;Raktelis;MEŠKIUKAI;6391559356;Ne;11;1;0;12
9287;Raktelis;MEŠKIUKAI;5358970156;Ne;15;0;0;15
9288;Rasa;Nykštukai;5176175108;Ne;2;5;0;7
9289;Rasa;Nykštukai;3979273111;Ne;0;4;0;4
9290;Rasa;Nykštukai;4847544355;Ne;0;5;0;5
9291;Rasa;Nykštukai;9723040721;Ne;0;5;0;5
9292;Rasa;Nykštukai;1223962374;Ne;9;4;0;13
9293;Rasa;Nykštukai;3200377629;Ne;4;5;0;9
9294;Rasa;Nykštukai;1336291828;Ne;0;8;0;8
9295;Rasa;Nykštukai;5861229664;Ne;0;4;0;4
9296;Rasa;Nykštukai;1386880644;Ne;0;5;0;5
9297;Rasa;Nykštukai;7228037580;Ne;0;3;0;3
9298;Rasa;Nykštukai;2093263887;Ne;3;4;0;7
9299;Rasa;Nykštukai;2540124793;Ne;7;4;0;11
9300;Rasa;Nykštukai;5363748728;Ne;0;5;0;5
9301;Rasa;Nykštukai;2977737634;Ne;0;3;0;3
9302;Rasa;Nykštukai;7520665472;Ne;0;10;0;10
9303;Rasa;Nykštukai;7534306402;Ne;0;4;0;4
9304;Rasa;Nykštukai;3755794133;Ne;0;6;0;6
9305;Rasa;Nykštukai;8424049317;Ne;0;1;0;1
9306;Rasa;Nykštukai;2190948879;Ne;5;9;0;14
9307;Rasa;Nykštukai;4010262461;Ne;0;4;0;4
9308;Rasa;Nykštukai;8236464670;Ne;0;10;0;10
9309;Rasa;Nykštukai;6976298054;Ne;3;3;0;6
9310;Rasa;Nykštukai;2333938367;Ne;0;4;0;4
9311;Rasa;Meškiukai;8378755600;Ne;0;13;0;13
9312;Rasa;Meškiukai;3073804713;Ne;0;3;0;3
9313;Rasa;Meškiukai;6691161322;Ne;0;4;0;4
9314;Rasa;Meškiukai;8740659600;Ne;0;19;0;19
9315;Rasa;Meškiukai;4127921417;Ne;4;4;1;9
9316;Rasa;Meškiukai;7357915584;Ne;8;3;0;11
9317;Rasa;Meškiukai;8314522373;Ne;0;11;0;11
9318;Rasa;Meškiukai;3548008659;Ne;0;18;0;18
9319;Rasa;Meškiukai;3773600344;Ne;16;0;0;16
9320;Rasa;Meškiukai;2371282781;Ne;16;0;0;16
9321;Rasa;Meškiukai;2555108465;Ne;0;5;2;7
9322;Rasa;Meškiukai;1992726664;Ne;3;16;0;19
9323;Rasa;Meškiukai;7843789214;Ne;3;0;1;4
9324;Rasa;Meškiukai;5165588335;Ne;0;5;0;5
9325;Rasa;Meškiukai;7637404588;Ne;5;3;0;8
9326;Rasa;Meškiukai;7502435359;Ne;0;8;0;8
9327;Rasa;Meškiukai;6853285570;Taip;3;6;0;9
9328;Rasa;Meškiukai;8674133653;Ne;19;0;0;19
9329;Rasa;Meškiukai;2840437821;Ne;4;2;0;6
9330;Rasa;Sauliukai;3657956842;Ne;3;5;0;8
9331;Rasa;Sauliukai;6891623055;Ne;0;5;0;5
9332;Rasa;Sauliukai;9010812748;Ne;0;5;0;5
9333;Rasa;Sauliukai;7220007488;Ne;4;4;0;8
9334;Rasa;Sauliukai;4498966097;Ne;2;4;0;6
9335;Rasa;Sauliukai;5134342817;Ne;0;4;0;4
9336;Rasa;Sauliukai;4734775151;Ne;0;13;0;13
9337;Rasa;Sauliukai;8235869241;Ne;8;5;0;13
9338;Rasa;Sauliukai;3428261829;Ne;5;6;0;11
9339;Rasa;Sauliukai;5426981046;Ne;6;6;0;12
9340;Rasa;Sauliukai;9220749889;Ne;0;4;0;4
9341;Rasa;Sauliukai;5885520521;Ne;6;2;0;8
9342;Rasa;Sauliukai;3631124501;Ne;3;5;0;8
9343;Rasa;Sauliukai;2477057223;Ne;5;4;0;9
9344;Rasa;Sauliukai;2984661168;Ne;0;8;0;8
9345;Rasa;Sauliukai;4913483444;Ne;0;8;0;8
9346;Rasa;Sauliukai;9343039995;Ne;5;5;0;10
9347;Rasa;Sauliukai;4758138905;Ne;3;4;0;7
9348;Rasa;Sauliukai;4084236196;Ne;5;2;0;7
9349;Rasa;Sauliukai;6411372006;Ne;7;4;0;11
9350;Rasa;Sauliukai;9157136735;Ne;0;5;0;5
9351;Rasa;Sauliukai;4942819477;Ne;0;4;0;4
9352;Rasa;Smalsučiai;9288967646;Ne;8;3;0;11
9353;Rasa;Smalsučiai;6307149426;Ne;0;2;0;2
9354;Rasa;Smalsučiai;8350239611;Ne;6;4;0;10
9355;Rasa;Smalsučiai;3867443155;Ne;0;1;1;2
9356;Rasa;Smalsučiai;2480847070;Ne;0;3;1;4
9357;Rasa;Smalsučiai;4828855802;Ne;0;2;0;2
9358;Rasa;Smalsučiai;7250512345;Ne;0;0;1;1
9359;Rasa;Smalsučiai;8204386619;Ne;0;3;1;4
9360;Rasa;Smalsučiai;8888344226;Ne;0;4;0;4
9361;Rasa;Smalsučiai;1683652129;Ne;6;4;3;13
9362;Rasa;Smalsučiai;2368671762;Ne;9;2;1;12
9363;Rasa;Smalsučiai;7335907373;Ne;0;2;3;5
9364;Rasa;Smalsučiai;2647048529;Ne;0;4;1;5
9365;Rasa;Smalsučiai;7901163117;Ne;15;1;0;16
9366;Rasa;Smalsučiai;7389262967;Ne;0;4;1;5
9367;Rasa;"Pelėdžiukai ";3387615841;Ne;3;3;0;6
9368;Rasa;"Pelėdžiukai ";8816116600;Ne;3;2;0;5
9369;Rasa;"Pelėdžiukai ";8455168346;Ne;7;0;0;7
9370;Rasa;"Pelėdžiukai ";9056416308;Ne;4;5;0;9
9371;Rasa;"Pelėdžiukai ";5141906920;Ne;5;4;0;9
9372;Rasa;"Pelėdžiukai ";3381468321;Ne;6;0;0;6
9373;Rasa;"Pelėdžiukai ";1261868339;Ne;0;4;0;4
9374;Rasa;"Pelėdžiukai ";6553479199;Ne;11;0;0;11
9375;Rasa;"Pelėdžiukai ";4947382314;Ne;4;1;0;5
9376;Rasa;"Pelėdžiukai ";2968464121;Ne;0;4;0;4
9377;Rasa;"Pelėdžiukai ";5816940902;Taip;6;1;0;7
9378;Rasa;"Pelėdžiukai ";8403268732;Ne;10;4;0;14
9379;Rasa;"Pelėdžiukai ";4855210006;Ne;0;4;0;4
9380;Rasa;"Pelėdžiukai ";4661651050;Ne;0;1;0;1
9381;Rasa;"Pelėdžiukai ";4453855861;Ne;1;1;0;2
9382;Rasa;"Pelėdžiukai ";4234198467;Ne;6;4;0;10
9383;Rasa;"Pelėdžiukai ";6874601830;Ne;19;0;0;19
9384;Rasa;Katinėliai;8622210603;Ne;0;5;0;5
9385;Rasa;Katinėliai;8574946856;Taip;0;3;0;3
9386;Rasa;Katinėliai;1477018184;Ne;0;3;2;5
9387;Rasa;Katinėliai;1521328997;Ne;0;3;0;3
9388;Rasa;Katinėliai;4018241056;Ne;0;4;0;4
9389;Rasa;Katinėliai;7568880413;Ne;0;4;0;4
9390;Rasa;Katinėliai;4762348187;Ne;0;1;3;4
9391;Rasa;Katinėliai;3884782148;Ne;5;3;1;9
9392;Rasa;Katinėliai;9230334839;Taip;0;1;0;1
9393;Rasa;Katinėliai;4979105526;Ne;0;3;0;3
9394;Rasa;Katinėliai;6755131948;Ne;0;0;1;1
9395;Rasa;Katinėliai;6442933249;Ne;2;7;0;9
9396;Rasa;Katinėliai;1736903037;Ne;0;4;0;4
9397;Rasa;Katinėliai;6656230158;Ne;3;5;1;9
9398;Rasa;Katinėliai;7029860782;Ne;0;3;0;3
9399;Rasa;Katinėliai;6640475278;Ne;1;2;2;5
9400;Rasa;Katinėliai;6856440701;Ne;0;19;0;19
9401;Rasa;Katinėliai;1263070686;Ne;0;9;0;9
9402;Rasa;Katinėliai;5370449148;Ne;0;1;0;1
9403;Rasa;Ančiukai;5260636074;Ne;5;0;0;5
9404;Rasa;Ančiukai;3898763654;Ne;16;0;0;16
9405;Rasa;Ančiukai;4427497247;Ne;19;0;0;19
9406;Rasa;Ančiukai;5128743872;Ne;10;0;0;10
9407;Rasa;Ančiukai;6044145252;Ne;0;6;0;6
9408;Rasa;Ančiukai;5407988663;Ne;7;0;0;7
9409;Rasa;Ančiukai;2683337738;Ne;3;0;0;3
9410;Rasa;Ančiukai;5580054434;Ne;14;0;0;14
9411;Rasa;Ančiukai;9392162542;Taip;7;4;0;11
9412;Rasa;Ančiukai;3559964630;Ne;10;9;0;19
9413;Rasa;Ančiukai;6403716333;Ne;0;11;0;11
9414;Rasa;Ančiukai;3569945230;Ne;8;4;0;12
9415;Rasa;Ančiukai;4872698495;Ne;7;0;0;7
9416;Rasa;Ančiukai;8159424999;Ne;4;0;0;4
9417;Rasa;Ančiukai;5903790998;Ne;4;0;0;4
9418;Rasa;"Vyturiukai ";7028605422;Ne;5;14;0;19
9419;Rasa;"Vyturiukai ";9599510902;Ne;0;2;0;2
9420;Rasa;"Vyturiukai ";5869253167;Ne;0;6;0;6
9421;Rasa;"Vyturiukai ";7037958994;Ne;5;4;0;9
9422;Rasa;"Vyturiukai ";8236785255;Ne;4;4;0;8
9423;Rasa;"Vyturiukai ";6887471189;Ne;8;0;0;8
9424;Rasa;"Vyturiukai ";2347639286;Ne;2;0;1;3
9425;Rasa;"Vyturiukai ";1206005039;Ne;1;4;0;5
9426;Rasa;"Vyturiukai ";9788282861;Ne;3;4;0;7
9427;Rasa;"Vyturiukai ";2711923397;Ne;2;0;0;2
9428;Rasa;"Vyturiukai ";2769096357;Ne;16;0;0;16
9429;Rasa;"Vyturiukai ";6883073764;Ne;1;4;1;6
9430;Rasa;"Vyturiukai ";9706428782;Ne;0;11;0;11
9431;Rasa;"Vyturiukai ";6575864256;Ne;5;0;0;5
9432;Rasa;"Vyturiukai ";2434270419;Ne;2;0;0;2
9433;Rasa;"Vyturiukai ";8296425777;Ne;0;4;0;4
9434;Rasa;"Vyturiukai ";7284349651;Ne;4;0;0;4
9435;Rasa;"Vyturiukai ";7265752821;Ne;3;0;1;4
9436;Rasa;"Vyturiukai ";5686873929;Ne;3;0;1;4
9437;Rasa;Voveriukai;4111850024;Ne;0;4;0;4
9438;Rasa;Voveriukai;1978999728;Ne;0;0;3;3
9439;Rasa;Voveriukai;3546684695;Ne;0;6;0;6
9440;Rasa;Voveriukai;5740754301;Ne;0;0;3;3
9441;Rasa;Voveriukai;5977524939;Ne;0;2;3;5
9442;Rasa;Voveriukai;1592174114;Ne;0;4;2;6
9443;Rasa;Voveriukai;1564194649;Ne;5;0;2;7
9444;Rasa;Voveriukai;1764959761;Ne;0;2;1;3
9445;Rasa;Voveriukai;1765617605;Ne;0;5;0;5
9446;Rasa;Voveriukai;1733179752;Ne;4;4;0;8
9447;Rasa;Voveriukai;2895124729;Ne;5;7;0;12
9448;Rasa;Voveriukai;8469342353;Ne;0;1;0;1
9449;Rasa;Voveriukai;5622110823;Ne;0;6;0;6
9450;Rasa;Voveriukai;6221754830;Ne;3;2;1;6
9451;Rasa;Voveriukai;7218250981;Ne;0;7;0;7
9452;Rasa;Voveriukai;7152769140;Ne;9;0;1;10
9453;Rasa;Voveriukai;1167373091;Taip;0;5;0;5
9454;Rasa;Voveriukai;2699865274;Taip;0;5;0;5
9455;Rasa;"DRUGELIAI ";6621628020;Ne;1;2;0;3
9456;Rasa;"DRUGELIAI ";9959160342;Ne;1;2;0;3
9457;Rasa;"DRUGELIAI ";5761013588;Ne;0;19;0;19
9458;Rasa;"DRUGELIAI ";7220103314;Ne;1;0;1;2
9459;Rasa;"DRUGELIAI ";9506388242;Ne;8;5;0;13
9460;Rasa;"DRUGELIAI ";4188303400;Ne;5;0;0;5
9461;Rasa;"DRUGELIAI ";5483943978;Ne;8;3;0;11
9462;Rasa;"DRUGELIAI ";7251815682;Ne;11;0;0;11
9463;Rasa;"DRUGELIAI ";8702962863;Ne;10;0;0;10
9464;Rasa;"DRUGELIAI ";6291089659;Ne;9;0;0;9
9465;Rasa;"DRUGELIAI ";1575522555;Ne;11;3;0;14
9466;Rasa;"DRUGELIAI ";1610581364;Ne;4;0;0;4
9467;Rasa;"DRUGELIAI ";2881055956;Ne;19;0;0;19
9468;Rasa;"DRUGELIAI ";3113010641;Ne;12;0;2;14
9469;Rasa;"DRUGELIAI ";9938323938;Ne;7;0;0;7
9470;Rasa;Zuikučiai;8027532547;Ne;3;7;0;10
9471;Rasa;Zuikučiai;3470054190;Taip;7;0;0;7
9472;Rasa;Zuikučiai;7253736220;Ne;0;5;0;5
9473;Rasa;Zuikučiai;4940758709;Ne;0;5;0;5
9474;Rasa;Zuikučiai;7091899236;Ne;2;4;0;6
9475;Rasa;Zuikučiai;6574998939;Ne;0;4;0;4
9476;Rasa;Zuikučiai;4212798846;Ne;0;7;0;7
9477;Rasa;Zuikučiai;6505001743;Ne;7;4;0;11
9478;Rasa;Zuikučiai;6780996150;Taip;3;4;0;7
9479;Rasa;Zuikučiai;8159411349;Ne;15;4;0;19
9480;Rasa;Zuikučiai;8992548689;Ne;4;4;0;8
9481;Rasa;Zuikučiai;1983112873;Ne;3;4;0;7
9482;Rasa;Zuikučiai;6650473677;Ne;0;3;0;3
9483;Rasa;Zuikučiai;4508356130;Ne;5;4;0;9
9484;Rasa;Zuikučiai;8503010505;Ne;17;0;0;17
9485;Rasa;Zuikučiai;1843058886;Ne;0;11;0;11
9486;Rasa;Zuikučiai;2935957834;Ne;14;4;0;18
9487;Rasa;Širdelė;3668598028;Ne;0;1;0;1
9488;Rasa;Širdelė;9560289781;Ne;0;2;0;2
9489;Rasa;Širdelė;5719253028;Ne;0;1;0;1
9490;Rasa;Širdelė;9140875020;Ne;11;5;0;16
9491;Rasa;Širdelė;5710220699;Ne;3;4;0;7
9492;Rasa;Širdelė;4694382836;Ne;15;0;0;15
9493;Rasa;Širdelė;1796573723;Ne;1;6;0;7
9494;Rasa;Širdelė;3535655117;Ne;5;5;0;10
9495;Rasa;Širdelė;2830296197;Ne;0;1;0;1
9496;Rasa;Širdelė;4361959446;Ne;8;0;0;8
9497;Rasa;Širdelė;3215464914;Ne;10;3;0;13
9498;Rasa;Širdelė;6760723624;Ne;3;2;0;5
9499;Rasa;Širdelė;1447258806;Ne;5;0;0;5
9500;Rasa;Širdelė;1627996663;Ne;10;2;0;12
9501;Rasa;Širdelė;9884995175;Ne;0;4;0;4
9502;Rasa;Širdelė;3965976031;Ne;0;1;0;1
9503;Rasa;Širdelė;4982146852;Ne;4;2;0;6
9504;Rasa;Širdelė;4248042049;Ne;3;1;0;4
9505;Rasa;Širdelė;7604145882;Ne;15;0;0;15
9506;Rasa;Širdelė;9713743149;Ne;0;4;0;4
9507;Riešutėlis;Viščiukų;8413887888;Ne;15;0;0;15
9508;Riešutėlis;Viščiukų;7142412042;Ne;10;0;0;10
9509;Riešutėlis;Viščiukų;5659054276;Ne;5;0;0;5
9510;Riešutėlis;Viščiukų;7985174814;Ne;16;0;0;16
9511;Riešutėlis;Viščiukų;3508479107;Ne;4;8;0;12
9512;Riešutėlis;Viščiukų;6398881485;Ne;12;4;0;16
9513;Riešutėlis;Viščiukų;3040811647;Ne;0;4;0;4
9514;Riešutėlis;Viščiukų;3109659339;Ne;5;1;0;6
9515;Riešutėlis;Viščiukų;4554875389;Ne;10;2;0;12
9516;Riešutėlis;Viščiukų;4533005769;Ne;14;0;0;14
9517;Riešutėlis;Viščiukų;3883149010;Taip;8;0;0;8
9518;Riešutėlis;Viščiukų;9952450993;Ne;14;0;0;14
9519;Riešutėlis;Viščiukų;8049449033;Taip;5;2;0;7
9520;Riešutėlis;Viščiukų;1389302927;Ne;7;7;0;14
9521;Riešutėlis;Viščiukų;6105142818;Ne;3;4;0;7
9522;Riešutėlis;"Riešutėliai ";3800733442;Ne;4;0;0;4
9523;Riešutėlis;"Riešutėliai ";2117939721;Ne;6;1;0;7
9524;Riešutėlis;"Riešutėliai ";1343776985;Ne;5;0;0;5
9525;Riešutėlis;"Riešutėliai ";5915019363;Ne;3;6;0;9
9526;Riešutėlis;"Riešutėliai ";2207907790;Ne;12;0;0;12
9527;Riešutėlis;"Riešutėliai ";9699503472;Ne;12;0;0;12
9528;Riešutėlis;"Riešutėliai ";2098369052;Ne;8;0;0;8
9529;Riešutėlis;"Riešutėliai ";1426700414;Taip;6;1;0;7
9530;Riešutėlis;"Riešutėliai ";8539906445;Ne;4;0;0;4
9531;Riešutėlis;"Riešutėliai ";5873443383;Ne;5;0;0;5
9532;Riešutėlis;"Riešutėliai ";2301247729;Ne;5;4;0;9
9533;Riešutėlis;"Riešutėliai ";3602707130;Ne;4;1;0;5
9534;Riešutėlis;"Riešutėliai ";8991963843;Ne;12;0;0;12
9535;Riešutėlis;"Riešutėliai ";9318640304;Ne;4;0;0;4
9536;Riešutėlis;"Riešutėliai ";4293402095;Ne;8;4;0;12
9537;Riešutėlis;"Riešutėliai ";8917451081;Ne;4;2;0;6
9538;Riešutėlis;"Riešutėliai ";4698338374;Ne;4;4;0;8
9539;Riešutėlis;"Riešutėliai ";3345064565;Ne;13;0;0;13
9540;Riešutėlis;"Riešutėliai ";2560507294;Ne;0;4;0;4
9541;Riešutėlis;"Riešutėliai ";9078282526;Ne;9;1;0;10
9542;Riešutėlis;Ežiukai;5758442826;Ne;1;4;0;5
9543;Riešutėlis;Ežiukai;9888470246;Ne;1;4;0;5
9544;Riešutėlis;Ežiukai;6217500325;Ne;1;0;0;1
9545;Riešutėlis;Ežiukai;4042719626;Ne;2;4;0;6
9546;Riešutėlis;Ežiukai;1858791074;Ne;2;4;0;6
9547;Riešutėlis;Ežiukai;1006119133;Ne;6;2;0;8
9548;Riešutėlis;Ežiukai;3759837057;Ne;6;0;0;6
9549;Riešutėlis;Ežiukai;3249196007;Ne;3;0;0;3
9550;Riešutėlis;Ežiukai;4740516426;Taip;6;0;0;6
9551;Riešutėlis;Ežiukai;5078051087;Ne;1;4;0;5
9552;Riešutėlis;Ežiukai;3150141050;Ne;1;3;0;4
9553;Riešutėlis;Ežiukai;6580050526;Ne;7;0;0;7
9554;Riešutėlis;Ežiukai;4810919435;Ne;0;4;0;4
9555;Riešutėlis;Ežiukai;2736824231;Ne;2;0;0;2
9556;Riešutėlis;Ežiukai;2378301886;Ne;12;0;0;12
9557;Riešutėlis;Ežiukai;2483793992;Ne;0;1;0;1
9558;Riešutėlis;Ežiukai;5262881964;Ne;5;0;0;5
9559;Riešutėlis;Ežiukai;4328166135;Ne;1;2;0;3
9560;Riešutėlis;Ežiukai;9052991215;Ne;6;0;0;6
9561;Riešutėlis;Ežiukai;6318150385;Ne;9;0;0;9
9562;Riešutėlis;Pelėdžiukai;3975540383;Taip;2;0;0;2
9563;Riešutėlis;Pelėdžiukai;1705599429;Ne;4;4;0;8
9564;Riešutėlis;Pelėdžiukai;4116506453;Ne;0;2;0;2
9565;Riešutėlis;Pelėdžiukai;2467739101;Ne;4;0;0;4
9566;Riešutėlis;Pelėdžiukai;2587460110;Ne;12;0;0;12
9567;Riešutėlis;Pelėdžiukai;6147780439;Ne;10;0;0;10
9568;Riešutėlis;Pelėdžiukai;3287685792;Ne;5;2;0;7
9569;Riešutėlis;Pelėdžiukai;1811701628;Ne;19;0;0;19
9570;Riešutėlis;Pelėdžiukai;5183264581;Ne;0;4;0;4
9571;Riešutėlis;Pelėdžiukai;6121386391;Ne;7;0;2;9
9572;Riešutėlis;Pelėdžiukai;4448024452;Ne;2;0;0;2
9573;Riešutėlis;Pelėdžiukai;3251066115;Ne;1;5;0;6
9574;Riešutėlis;Pelėdžiukai;4808684145;Ne;0;2;0;2
9575;Riešutėlis;Pelėdžiukai;4897581681;Ne;8;1;0;9
9576;Riešutėlis;Pelėdžiukai;7256075146;Ne;0;4;0;4
9577;Riešutėlis;Pelėdžiukai;5443448616;Ne;3;9;0;12
9578;Riešutėlis;Pelėdžiukai;9598824163;Ne;4;2;0;6
9579;Riešutėlis;Pelėdžiukai;8839482370;Ne;14;0;0;14
9580;Riešutėlis;Pelėdžiukai;4692384639;Ne;12;0;0;12
9581;Riešutėlis;Meškiukai;7030346495;Ne;0;7;0;7
9582;Riešutėlis;Meškiukai;9750713954;Ne;2;6;0;8
9583;Riešutėlis;Meškiukai;3577669231;Ne;1;6;0;7
9584;Riešutėlis;Meškiukai;8066712255;Ne;0;3;0;3
9585;Riešutėlis;Meškiukai;2837471235;Ne;6;4;0;10
9586;Riešutėlis;Meškiukai;2699984170;Ne;8;4;0;12
9587;Riešutėlis;Meškiukai;7601776182;Ne;5;4;0;9
9588;Riešutėlis;Meškiukai;7050440691;Ne;8;3;0;11
9589;Riešutėlis;Meškiukai;6259158270;Ne;0;4;0;4
9590;Riešutėlis;Meškiukai;7381623086;Ne;4;5;0;9
9591;Riešutėlis;Meškiukai;6284614328;Ne;15;4;0;19
9592;Riešutėlis;Meškiukai;9964688413;Ne;8;4;0;12
9593;Riešutėlis;Meškiukai;1548585448;Ne;6;2;0;8
9594;Riešutėlis;Meškiukai;5728858361;Ne;0;5;0;5
9595;Riešutėlis;Meškiukai;1818130297;Ne;8;5;0;13
9596;Riešutėlis;Meškiukai;8954127616;Ne;9;5;0;14
9597;Riešutėlis;Meškiukai;2092933906;Ne;0;9;0;9
9598;Riešutėlis;Meškiukai;6813024366;Ne;5;3;0;8
9599;Riešutėlis;Meškiukai;3460145784;Ne;3;1;0;4
9600;Riešutėlis;Meškiukai;8480059272;Ne;2;5;0;7
9601;Riešutėlis;Meškiukai;8751571852;Ne;6;4;0;10
9602;Riešutėlis;Kiškučiai;9086474785;Ne;4;0;0;4
9603;Riešutėlis;Kiškučiai;3363757821;Ne;0;4;0;4
9604;Riešutėlis;Kiškučiai;2581250615;Ne;6;0;0;6
9605;Riešutėlis;Kiškučiai;8445984114;Ne;5;0;0;5
9606;Riešutėlis;Kiškučiai;5266946070;Ne;13;0;0;13
9607;Riešutėlis;Kiškučiai;9357375649;Ne;8;0;0;8
9608;Riešutėlis;Kiškučiai;9548551553;Ne;2;0;0;2
9609;Riešutėlis;Kiškučiai;9500744921;Ne;5;0;0;5
9610;Riešutėlis;Kiškučiai;4851336076;Ne;3;0;0;3
9611;Riešutėlis;Kiškučiai;6705754238;Ne;5;4;0;9
9612;Riešutėlis;Kiškučiai;1111543507;Ne;4;4;0;8
9613;Riešutėlis;Kiškučiai;9964105252;Ne;5;0;0;5
9614;Riešutėlis;Kiškučiai;5846061115;Ne;10;0;0;10
9615;Riešutėlis;Kiškučiai;9995814717;Ne;7;0;0;7
9616;Riešutėlis;Kiškučiai;3165015754;Ne;8;0;0;8
9617;Riešutėlis;Kiškučiai;5738764214;Ne;4;0;0;4
9618;Riešutėlis;Kiškučiai;1494363200;Ne;16;0;0;16
9619;Riešutėlis;Voveriukų;9864636983;Ne;9;4;0;13
9620;Riešutėlis;Voveriukų;5662911204;Ne;5;4;1;10
9621;Riešutėlis;Voveriukų;7663823906;Ne;0;9;0;9
9622;Riešutėlis;Voveriukų;1282121190;Ne;2;6;0;8
9623;Riešutėlis;Voveriukų;5336618381;Ne;0;4;0;4
9624;Riešutėlis;Voveriukų;7327578507;Ne;4;1;0;5
9625;Riešutėlis;Voveriukų;6368610810;Ne;5;4;0;9
9626;Riešutėlis;Voveriukų;2875416610;Ne;11;3;0;14
9627;Riešutėlis;Voveriukų;7313602281;Ne;3;1;0;4
9628;Riešutėlis;Voveriukų;9815988800;Ne;0;3;0;3
9629;Riešutėlis;Voveriukų;9296178632;Ne;5;3;1;9
9630;Riešutėlis;Voveriukų;6681930005;Ne;8;3;0;11
9631;Riešutėlis;Voveriukų;7259198785;Ne;0;2;0;2
9632;Riešutėlis;Voveriukų;2352984379;Ne;6;1;0;7
9633;Riešutėlis;Voveriukų;3152100512;Ne;2;4;1;7
9634;Riešutėlis;Voveriukų;2238641969;Ne;4;6;0;10
9635;Riešutėlis;Voveriukų;1058206787;Ne;10;1;0;11
9636;Riešutėlis;Voveriukų;9198289423;Ne;5;3;0;8
9637;Riešutėlis;Voveriukų;3340831522;Ne;19;0;0;19
9638;Riešutėlis;Saulutės;4004669930;Taip;0;2;0;2
9639;Riešutėlis;Saulutės;6721758785;Ne;5;4;0;9
9640;Riešutėlis;Saulutės;3694146893;Ne;0;4;0;4
9641;Riešutėlis;Saulutės;1748151109;Ne;0;3;0;3
9642;Riešutėlis;Saulutės;8504832383;Ne;5;4;0;9
9643;Riešutėlis;Saulutės;6292679662;Ne;2;4;0;6
9644;Riešutėlis;Saulutės;8738716660;Ne;0;5;0;5
9645;Riešutėlis;Saulutės;4828635362;Ne;0;1;0;1
9646;Riešutėlis;Saulutės;6635909614;Ne;0;4;0;4
9647;Riešutėlis;Saulutės;1196740726;Ne;7;5;0;12
9648;Riešutėlis;Saulutės;8415858895;Ne;1;3;2;6
9649;Riešutėlis;Saulutės;4498718519;Ne;7;4;0;11
9650;Riešutėlis;Saulutės;5753609922;Ne;5;6;0;11
9651;Riešutėlis;Saulutės;5013754772;Ne;3;4;0;7
9652;Riešutėlis;Saulutės;6468871352;Ne;12;0;0;12
9653;Riešutėlis;Saulutės;7154361660;Ne;10;4;0;14
9654;Riešutėlis;Saulutės;8677172126;Ne;7;4;0;11
9655;Riešutėlis;Saulutės;2395391926;Ne;0;6;2;8
9656;Riešutėlis;Saulutės;2572642260;Ne;4;0;0;4
9657;Riešutėlis;Saulutės;3544780386;Ne;9;0;1;10
9658;Riešutėlis;"Boruželės ";7666200219;Ne;0;3;4;7
9659;Riešutėlis;"Boruželės ";6626441225;Ne;2;0;3;5
9660;Riešutėlis;"Boruželės ";4426750525;Ne;2;0;2;4
9661;Riešutėlis;"Boruželės ";6906373822;Ne;0;3;0;3
9662;Riešutėlis;"Boruželės ";4636191548;Ne;1;0;3;4
9663;Riešutėlis;"Boruželės ";2734001106;Ne;0;2;1;3
9664;Riešutėlis;"Boruželės ";2493171003;Ne;0;0;4;4
9665;Riešutėlis;"Boruželės ";5133625078;Ne;0;5;0;5
9666;Riešutėlis;"Boruželės ";9341748384;Ne;0;1;8;9
9667;Riešutėlis;"Boruželės ";2235912189;Ne;0;1;2;3
9668;Riešutėlis;"Boruželės ";4429903561;Ne;19;0;0;19
9669;Riešutėlis;"Boruželės ";5317904812;Ne;0;0;5;5
9670;Riešutėlis;"Boruželės ";8235524536;Ne;4;0;0;4
9671;Riešutėlis;"Boruželės ";7795124495;Ne;1;0;4;5
9672;Riešutėlis;"Boruželės ";2832538856;Ne;4;8;0;12
9673;Riešutėlis;"Boruželės ";3730909181;Ne;5;0;1;6
9674;Riešutėlis;"Bitutės ";8498902448;Ne;2;1;0;3
9675;Riešutėlis;"Bitutės ";2498093110;Taip;3;7;0;10
9676;Riešutėlis;"Bitutės ";2459494071;Ne;1;2;0;3
9677;Riešutėlis;"Bitutės ";3931422170;Ne;8;3;0;11
9678;Riešutėlis;"Bitutės ";8265627960;Ne;0;4;0;4
9679;Riešutėlis;"Bitutės ";4591910912;Ne;0;2;0;2
9680;Riešutėlis;"Bitutės ";9285782325;Ne;5;4;0;9
9681;Riešutėlis;"Bitutės ";7473054556;Ne;0;5;0;5
9682;Riešutėlis;"Bitutės ";8996456595;Ne;3;2;0;5
9683;Riešutėlis;"Bitutės ";3475897400;Ne;0;1;0;1
9684;Riešutėlis;"Bitutės ";3592271009;Taip;4;3;0;7
9685;Riešutėlis;"Bitutės ";6815804556;Ne;2;1;0;3
9686;Riešutėlis;"Bitutės ";3348517050;Ne;2;4;0;6
9687;Riešutėlis;"Bitutės ";4358354602;Ne;8;4;0;12
9688;Riešutėlis;"Bitutės ";9903170301;Ne;3;1;0;4
9689;Riešutėlis;"Bitutės ";1842107341;Ne;5;4;2;11
9690;Riešutėlis;"Bitutės ";1033490929;Ne;0;4;0;4
9691;Riešutėlis;"Bitutės ";4211273525;Ne;0;4;0;4
9692;Riešutėlis;Drugelių;8266735624;Ne;0;4;0;4
9693;Riešutėlis;Drugelių;4776231497;Ne;0;4;0;4
9694;Riešutėlis;Drugelių;7769079730;Ne;0;3;0;3
9695;Riešutėlis;Drugelių;5811657782;Ne;2;1;0;3
9696;Riešutėlis;Drugelių;4221375847;Ne;0;4;0;4
9697;Riešutėlis;Drugelių;1075842434;Ne;0;4;0;4
9698;Riešutėlis;Drugelių;1942944625;Ne;0;3;0;3
9699;Riešutėlis;Drugelių;8845709386;Ne;5;4;0;9
9700;Riešutėlis;Drugelių;8128352818;Ne;0;2;0;2
9701;Riešutėlis;Drugelių;8352146446;Ne;4;4;0;8
9702;Riešutėlis;Drugelių;8180618419;Ne;0;3;0;3
9703;Riešutėlis;Drugelių;5412882446;Ne;2;3;0;5
9704;Riešutėlis;Drugelių;8020533200;Ne;0;4;0;4
9705;Riešutėlis;Drugelių;1164273595;Ne;7;4;0;11
9706;Riešutėlis;Drugelių;8918753084;Ne;6;4;0;10
9707;Riešutėlis;Drugelių;3836374000;Ne;4;4;0;8
9708;Riešutėlis;Drugelių;3071643137;Ne;0;4;0;4
9709;Riešutėlis;Drugelių;2599147931;Ne;0;4;0;4
9710;Riešutėlis;Drugelių;3151689985;Ne;3;4;0;7
9711;Riešutėlis;Drugelių;4845447863;Ne;4;1;0;5
9712;Riešutėlis;Drugelių;7225365172;Ne;0;3;0;3
9713;Riešutėlis;Nykštukų;3208422211;Ne;9;1;0;10
9714;Riešutėlis;Nykštukų;9445000826;Ne;10;0;0;10
9715;Riešutėlis;Nykštukų;2133207806;Ne;17;0;0;17
9716;Riešutėlis;Nykštukų;2965742701;Ne;5;0;0;5
9717;Riešutėlis;Nykštukų;8965323622;Ne;2;1;0;3
9718;Riešutėlis;Nykštukų;3304849985;Ne;7;0;0;7
9719;Riešutėlis;Nykštukų;4996921259;Ne;6;0;0;6
9720;Riešutėlis;Nykštukų;2380936705;Ne;4;0;0;4
9721;Riešutėlis;Nykštukų;1227857842;Ne;6;5;0;11
9722;Riešutėlis;Nykštukų;8857997445;Ne;8;5;0;13
9723;Riešutėlis;Nykštukų;5296617022;Ne;4;0;0;4
9724;Riešutėlis;Nykštukų;9445150366;Ne;5;4;0;9
9725;Riešutėlis;Nykštukų;9977733313;Ne;8;5;0;13
9726;Riešutėlis;Nykštukų;4746769566;Ne;9;0;0;9
9727;Riešutėlis;Nykštukų;9415334673;Ne;3;6;0;9
9728;Ramunėlė;SAULUTĖS;3852734401;Ne;0;4;0;4
9729;Ramunėlė;SAULUTĖS;1192743154;Ne;4;6;0;10
9730;Ramunėlė;SAULUTĖS;5714771643;Ne;0;5;0;5
9731;Ramunėlė;SAULUTĖS;1483391590;Ne;0;4;0;4
9732;Ramunėlė;SAULUTĖS;4209191105;Ne;0;4;0;4
9733;Ramunėlė;SAULUTĖS;9927068798;Ne;0;4;0;4
9734;Ramunėlė;SAULUTĖS;8929122197;Ne;0;2;0;2
9735;Ramunėlė;SAULUTĖS;7219400182;Ne;0;7;0;7
9736;Ramunėlė;SAULUTĖS;3779769727;Ne;0;8;0;8
9737;Ramunėlė;SAULUTĖS;5605444408;Ne;0;5;0;5
9738;Ramunėlė;SAULUTĖS;8912978935;Ne;2;7;0;9
9739;Ramunėlė;SAULUTĖS;1618282165;Ne;0;2;0;2
9740;Ramunėlė;SAULUTĖS;9533155706;Ne;5;6;0;11
9741;Ramunėlė;SAULUTĖS;3109623760;Ne;5;4;0;9
9742;Ramunėlė;SAULUTĖS;6329943991;Ne;3;6;0;9
9743;Ramunėlė;SAULUTĖS;4677819736;Ne;2;4;0;6
9744;Ramunėlė;SAULUTĖS;6310921755;Ne;0;4;0;4
9745;Ramunėlė;SAULUTĖS;1568531299;Ne;4;6;0;10
9746;Ramunėlė;SAULUTĖS;4605161267;Ne;7;7;0;14
9747;Ramunėlė;ŽIBUTĖ;4715809064;Ne;0;5;0;5
9748;Ramunėlė;ŽIBUTĖ;5315953299;Ne;0;3;0;3
9749;Ramunėlė;ŽIBUTĖ;2173425836;Ne;7;2;0;9
9750;Ramunėlė;ŽIBUTĖ;2686455030;Ne;7;2;0;9
9751;Ramunėlė;ŽIBUTĖ;5650659504;Ne;0;4;0;4
9752;Ramunėlė;ŽIBUTĖ;6627399830;Ne;2;2;0;4
9753;Ramunėlė;ŽIBUTĖ;8726443989;Ne;0;6;0;6
9754;Ramunėlė;ŽIBUTĖ;5801760033;Ne;0;3;0;3
9755;Ramunėlė;ŽIBUTĖ;6389008823;Ne;1;1;0;2
9756;Ramunėlė;ŽIBUTĖ;9136437288;Ne;0;3;0;3
9757;Ramunėlė;ŽIBUTĖ;6040461460;Ne;0;3;0;3
9758;Ramunėlė;ŽIBUTĖ;2605941371;Ne;0;3;0;3
9759;Ramunėlė;ŽIBUTĖ;7010828978;Ne;0;8;0;8
9760;Ramunėlė;ŽIBUTĖ;3879563193;Ne;0;6;0;6
9761;Ramunėlė;ŽIBUTĖ;2591052434;Ne;0;5;0;5
9762;Ramunėlė;ŽIBUTĖ;2446375037;Ne;0;5;0;5
9763;Ramunėlė;ŽIBUTĖ;1671759939;Ne;0;4;0;4
9764;Ramunėlė;ŽIBUTĖ;6606802660;Ne;0;5;0;5
9765;Ramunėlė;ŽIBUTĖ;5304803880;Ne;0;2;0;2
9766;Ramunėlė;ŽIBUTĖ;3525444906;Ne;0;7;0;7
9767;Ramunėlė;ŽIBUTĖ;8055844166;Ne;0;6;0;6
9768;Ramunėlė;ŽIRNIUKAI;7721421570;Ne;0;10;0;10
9769;Ramunėlė;ŽIRNIUKAI;8942483792;Ne;5;0;5;10
9770;Ramunėlė;ŽIRNIUKAI;6674467484;Ne;0;14;0;14
9771;Ramunėlė;ŽIRNIUKAI;7593855877;Ne;4;4;0;8
9772;Ramunėlė;ŽIRNIUKAI;2177200537;Ne;3;2;0;5
9773;Ramunėlė;ŽIRNIUKAI;7026935746;Ne;0;3;0;3
9774;Ramunėlė;ŽIRNIUKAI;5581693652;Ne;0;4;0;4
9775;Ramunėlė;ŽIRNIUKAI;4269170508;Ne;13;0;0;13
9776;Ramunėlė;ŽIRNIUKAI;7263195574;Ne;3;0;1;4
9777;Ramunėlė;ŽIRNIUKAI;4076525701;Ne;0;0;3;3
9778;Ramunėlė;ŽIRNIUKAI;4139935502;Ne;15;0;0;15
9779;Ramunėlė;ŽIRNIUKAI;1833069020;Ne;8;6;0;14
9780;Ramunėlė;ŽIRNIUKAI;4875011312;Ne;0;8;0;8
9781;Ramunėlė;ŽIRNIUKAI;4084046207;Ne;6;6;0;12
9782;Ramunėlė;ŽIRNIUKAI;2276657044;Ne;0;0;3;3
9783;Ramunėlė;ŽIRNIUKAI;5017020616;Ne;0;2;0;2
9784;Ramunėlė;ŽIRNIUKAI;6458458913;Ne;0;8;0;8
9785;Ramunėlė;ŽIRNIUKAI;6225605784;Ne;3;2;0;5
9786;Ramunėlė;ŽIRNIUKAI;4805808663;Ne;0;10;0;10
9787;Ramunėlė;ŽIRNIUKAI;7250951221;Ne;1;6;0;7
9788;Ramunėlė;BITUTĖS;5865482869;Ne;0;12;0;12
9789;Ramunėlė;BITUTĖS;7692958269;Ne;2;4;0;6
9790;Ramunėlė;BITUTĖS;1182350830;Ne;4;0;0;4
9791;Ramunėlė;BITUTĖS;6342801407;Ne;7;0;0;7
9792;Ramunėlė;BITUTĖS;4022818032;Ne;0;5;0;5
9793;Ramunėlė;BITUTĖS;1916520056;Ne;0;13;0;13
9794;Ramunėlė;BITUTĖS;2245564567;Ne;0;2;0;2
9795;Ramunėlė;BITUTĖS;6870110390;Ne;0;2;0;2
9796;Ramunėlė;BITUTĖS;6892481929;Ne;0;4;0;4
9797;Ramunėlė;BITUTĖS;6881228078;Ne;6;8;0;14
9798;Ramunėlė;BITUTĖS;9326288662;Ne;0;5;0;5
9799;Ramunėlė;BITUTĖS;3045477012;Ne;0;12;0;12
9800;Ramunėlė;BITUTĖS;8643188779;Ne;19;0;0;19
9801;Ramunėlė;BITUTĖS;3106987206;Ne;9;0;0;9
9802;Ramunėlė;BITUTĖS;1797997937;Ne;5;0;0;5
9803;Ramunėlė;BITUTĖS;2281370785;Ne;10;4;0;14
9804;Ramunėlė;BITUTĖS;4329292281;Ne;3;2;0;5
9805;Ramunėlė;BITUTĖS;9928703066;Ne;0;4;0;4
9806;Ramunėlė;BITUTĖS;4756689520;Ne;1;6;0;7
9807;Ramunėlė;BITUTĖS;3742982547;Ne;0;4;0;4
9808;Ramunėlė;DRUGELIAI;9984243153;Ne;5;4;0;9
9809;Ramunėlė;DRUGELIAI;4392309015;Ne;4;6;0;10
9810;Ramunėlė;DRUGELIAI;5049415445;Ne;9;3;1;13
9811;Ramunėlė;DRUGELIAI;8460527225;Ne;1;7;0;8
9812;Ramunėlė;DRUGELIAI;6809164145;Ne;0;7;0;7
9813;Ramunėlė;DRUGELIAI;6981729247;Ne;8;4;0;12
9814;Ramunėlė;DRUGELIAI;3683181174;Ne;5;0;1;6
9815;Ramunėlė;DRUGELIAI;7364976547;Ne;10;2;0;12
9816;Ramunėlė;DRUGELIAI;6156792400;Ne;0;11;0;11
9817;Ramunėlė;DRUGELIAI;2983986428;Ne;3;8;0;11
9818;Ramunėlė;DRUGELIAI;5548358138;Ne;0;5;0;5
9819;Ramunėlė;DRUGELIAI;2427399083;Ne;0;3;0;3
9820;Ramunėlė;DRUGELIAI;8623311748;Ne;4;2;0;6
9821;Ramunėlė;DRUGELIAI;6849205606;Ne;5;1;1;7
9822;Ramunėlė;DRUGELIAI;2422656007;Ne;0;4;3;7
9823;Ramunėlė;DRUGELIAI;7829765488;Ne;0;1;0;1
9824;Ramunėlė;DRUGELIAI;5153948802;Ne;0;4;0;4
9825;Ramunėlė;DRUGELIAI;4233978236;Ne;0;9;0;9
9826;Ramunėlė;DRUGELIAI;2558296296;Ne;6;0;2;8
9827;Ramunėlė;DRUGELIAI;4400154355;Ne;9;0;1;10
9828;Ramunėlė;NEUŽMIRŠTUOLĖS;2070729684;Ne;0;6;0;6
9829;Ramunėlė;NEUŽMIRŠTUOLĖS;6613469006;Ne;0;10;0;10
9830;Ramunėlė;NEUŽMIRŠTUOLĖS;9012749913;Ne;0;10;0;10
9831;Ramunėlė;NEUŽMIRŠTUOLĖS;1728034615;Ne;8;1;0;9
9832;Ramunėlė;NEUŽMIRŠTUOLĖS;1579527330;Ne;5;9;0;14
9833;Ramunėlė;NEUŽMIRŠTUOLĖS;7519551613;Ne;0;14;0;14
9834;Ramunėlė;NEUŽMIRŠTUOLĖS;2880352109;Ne;13;4;0;17
9835;Ramunėlė;NEUŽMIRŠTUOLĖS;3949246652;Ne;16;0;0;16
9836;Ramunėlė;NEUŽMIRŠTUOLĖS;5267145991;Ne;0;13;0;13
9837;Ramunėlė;NEUŽMIRŠTUOLĖS;1181787182;Ne;11;0;0;11
9838;Ramunėlė;NEUŽMIRŠTUOLĖS;9374972014;Ne;0;7;0;7
9839;Ramunėlė;NEUŽMIRŠTUOLĖS;6849227110;Ne;4;2;0;6
9840;Ramunėlė;NEUŽMIRŠTUOLĖS;3792795591;Ne;0;4;0;4
9841;Ramunėlė;NEUŽMIRŠTUOLĖS;4862989594;Ne;12;1;0;13
9842;Ramunėlė;NEUŽMIRŠTUOLĖS;9758688249;Ne;5;0;0;5
9843;Ramunėlė;NEUŽMIRŠTUOLĖS;9945561827;Ne;9;0;0;9
9844;Ramunėlė;OBUOLIUKAI;6604244856;Ne;0;3;0;3
9845;Ramunėlė;OBUOLIUKAI;8617271247;Ne;5;4;0;9
9846;Ramunėlė;OBUOLIUKAI;6413888803;Ne;0;2;0;2
9847;Ramunėlė;OBUOLIUKAI;5610672420;Ne;2;2;0;4
9848;Ramunėlė;OBUOLIUKAI;9861069932;Ne;10;4;0;14
9849;Ramunėlė;OBUOLIUKAI;7639613472;Ne;11;0;0;11
9850;Ramunėlė;OBUOLIUKAI;4040520907;Ne;5;7;0;12
9851;Ramunėlė;OBUOLIUKAI;5573083546;Ne;3;2;0;5
9852;Ramunėlė;OBUOLIUKAI;1215510902;Ne;3;1;0;4
9853;Ramunėlė;OBUOLIUKAI;8218201930;Ne;6;7;0;13
9854;Ramunėlė;OBUOLIUKAI;2760710235;Ne;0;5;0;5
9855;Ramunėlė;OBUOLIUKAI;4788062781;Ne;0;2;0;2
9856;Ramunėlė;OBUOLIUKAI;3166386231;Ne;0;5;0;5
9857;Ramunėlė;OBUOLIUKAI;4642590173;Ne;0;6;0;6
9858;Ramunėlė;OBUOLIUKAI;9549605315;Ne;7;0;0;7
9859;Ramunėlė;OBUOLIUKAI;1277413234;Ne;0;3;0;3
9860;Ramunėlė;SAULĖGRĄŽA;7836959157;Ne;4;0;0;4
9861;Ramunėlė;SAULĖGRĄŽA;2458101652;Ne;2;0;0;2
9862;Ramunėlė;SAULĖGRĄŽA;9663304288;Ne;7;0;0;7
9863;Ramunėlė;SAULĖGRĄŽA;5398069413;Ne;6;0;0;6
9864;Ramunėlė;SAULĖGRĄŽA;3793779715;Ne;4;2;0;6
9865;Ramunėlė;SAULĖGRĄŽA;6775947111;Ne;14;5;0;19
9866;Ramunėlė;SAULĖGRĄŽA;1102946363;Ne;7;0;0;7
9867;Ramunėlė;SAULĖGRĄŽA;3801952385;Ne;6;4;0;10
9868;Ramunėlė;SAULĖGRĄŽA;9120142666;Taip;5;0;0;5
9869;Ramunėlė;SAULĖGRĄŽA;6942789511;Ne;1;2;0;3
9870;Ramunėlė;SAULĖGRĄŽA;2415377154;Ne;0;4;0;4
9871;Ramunėlė;SAULĖGRĄŽA;9076692864;Ne;6;5;0;11
9872;Ramunėlė;SAULĖGRĄŽA;3744140961;Ne;15;0;0;15
9873;Ramunėlė;SAULĖGRĄŽA;4177116924;Ne;8;0;0;8
9874;Ramunėlė;SAULĖGRĄŽA;1071166494;Ne;9;2;0;11
9875;Ramunėlė;SAULĖGRĄŽA;9656732273;Ne;7;0;0;7
9876;Ramunėlė;SAULĖGRĄŽA;6983139076;Taip;7;0;0;7
9877;Ramunėlė;SAULĖGRĄŽA;8045080504;Ne;5;2;0;7
9878;Ramunėlė;SAULĖGRĄŽA;9127154444;Ne;8;0;0;8
9879;Ramunėlė;BORUŽĖLĖS;1818513881;Ne;2;9;3;14
9880;Ramunėlė;BORUŽĖLĖS;4581826404;Ne;3;0;0;3
9881;Ramunėlė;BORUŽĖLĖS;8310875815;Ne;10;4;0;14
9882;Ramunėlė;BORUŽĖLĖS;1491688322;Ne;2;6;1;9
9883;Ramunėlė;BORUŽĖLĖS;6606966969;Ne;0;4;0;4
9884;Ramunėlė;BORUŽĖLĖS;5703289545;Ne;8;0;0;8
9885;Ramunėlė;BORUŽĖLĖS;9934852622;Ne;0;9;0;9
9886;Ramunėlė;BORUŽĖLĖS;4968998913;Ne;7;4;0;11
9887;Ramunėlė;BORUŽĖLĖS;9292235402;Ne;5;0;2;7
9888;Ramunėlė;BORUŽĖLĖS;3996453947;Ne;4;2;0;6
9889;Ramunėlė;BORUŽĖLĖS;3461269451;Ne;5;4;0;9
9890;Ramunėlė;BORUŽĖLĖS;3474578046;Ne;0;5;0;5
9891;Ramunėlė;BORUŽĖLĖS;7544671346;Ne;0;3;0;3
9892;Ramunėlė;BORUŽĖLĖS;5544992493;Ne;0;3;0;3
9893;Ramunėlė;BORUŽĖLĖS;6433856416;Ne;0;4;0;4
9894;Ramunėlė;BORUŽĖLĖS;3542912372;Ne;13;2;0;15
9895;Ramunėlė;BORUŽĖLĖS;1159457001;Ne;3;2;0;5
9896;Ramunėlė;BORUŽĖLĖS;3735308599;Ne;5;6;0;11
9897;Ramunėlė;BORUŽĖLĖS;3272747656;Ne;5;6;0;11
9898;Ramunėlė;BORUŽĖLĖS;6347893013;Ne;4;0;0;4
9899;Ramunėlė;BORUŽĖLĖS;1811931985;Ne;0;9;0;9
9900;Ramunėlė;NYKŠTUKAS;7542328641;Ne;0;1;0;1
9901;Ramunėlė;NYKŠTUKAS;1802650607;Ne;0;1;0;1
9902;Ramunėlė;NYKŠTUKAS;7715458376;Ne;0;4;2;6
9903;Ramunėlė;NYKŠTUKAS;2874729290;Ne;4;1;0;5
9904;Ramunėlė;NYKŠTUKAS;5011852981;Ne;0;0;6;6
9905;Ramunėlė;NYKŠTUKAS;7049941095;Ne;0;4;0;4
9906;Ramunėlė;NYKŠTUKAS;7958270513;Ne;0;3;0;3
9907;Ramunėlė;NYKŠTUKAS;9005050527;Ne;2;0;0;2
9908;Ramunėlė;NYKŠTUKAS;2521516332;Ne;4;0;2;6
9909;Ramunėlė;UOGELĖ;2361409931;Taip;5;2;0;7
9910;Ramunėlė;UOGELĖ;9765904825;Ne;6;0;0;6
9911;Ramunėlė;UOGELĖ;5934414699;Ne;3;2;0;5
9912;Ramunėlė;UOGELĖ;3097478921;Ne;5;3;0;8
9913;Ramunėlė;UOGELĖ;1962502699;Ne;5;0;0;5
9914;Ramunėlė;UOGELĖ;2652236809;Ne;5;0;0;5
9915;Ramunėlė;UOGELĖ;9603368652;Ne;7;0;0;7
9916;Ramunėlė;UOGELĖ;5468189903;Ne;4;0;0;4
9917;Ramunėlė;UOGELĖ;9834640538;Ne;5;0;0;5
9918;Ramunėlė;UOGELĖ;3838004754;Ne;4;3;0;7
9919;Ramunėlė;UOGELĖ;3037286125;Ne;1;0;0;1
9920;Ramunėlė;UOGELĖ;5196627958;Ne;0;10;0;10
9921;Ramunėlė;UOGELĖ;1346734609;Ne;2;0;0;2
9922;Ramunėlė;UOGELĖ;8538153845;Ne;19;0;0;19
9923;Ramunėlė;VARPELIAI;8023404173;Ne;4;2;1;7
9924;Ramunėlė;VARPELIAI;7005354909;Ne;0;6;0;6
9925;Ramunėlė;VARPELIAI;5665429647;Ne;2;2;0;4
9926;Ramunėlė;VARPELIAI;4946797276;Ne;0;2;0;2
9927;Ramunėlė;VARPELIAI;9180197156;Ne;0;4;0;4
9928;Ramunėlė;VARPELIAI;5108864184;Ne;0;4;0;4
9929;Ramunėlė;VARPELIAI;4321527067;Ne;5;4;1;10
9930;Ramunėlė;VARPELIAI;2202879286;Ne;0;2;1;3
9931;Ramunėlė;VARPELIAI;1666033483;Ne;2;2;2;6
9932;Ramunėlė;VARPELIAI;7896711579;Ne;0;4;0;4
9933;Ramunėlė;VARPELIAI;9994601365;Ne;3;4;0;7
9934;Ramunėlė;VARPELIAI;2620747378;Ne;8;0;0;8
9935;Ramunėlė;VARPELIAI;5726947811;Ne;0;3;0;3
9936;Ramunėlė;VARPELIAI;4171905362;Ne;0;8;0;8
9937;Ramunėlė;VARPELIAI;8764042799;Ne;0;2;0;2
9938;Ramunėlė;VARPELIAI;7926168752;Taip;4;0;0;4
9939;Ramunėlė;VARPELIAI;5498856861;Ne;4;0;1;5
9940;Ramunėlė;VARPELIAI;3024065664;Ne;14;1;0;15
9941;Ramunėlė;VARPELIAI;4397072823;Ne;10;0;1;11
9942;Ramunėlė;VARPELIAI;3793699824;Ne;0;2;0;2
9943;Rūta;SMALSUČIAI;2601011765;Taip;18;0;0;18
9944;Rūta;SMALSUČIAI;5902965224;Ne;0;4;0;4
9945;Rūta;SMALSUČIAI;5579794648;Ne;10;4;0;14
9946;Rūta;SMALSUČIAI;9471291067;Ne;0;7;0;7
9947;Rūta;SMALSUČIAI;4165080541;Ne;0;0;6;6
9948;Rūta;SMALSUČIAI;8012225409;Ne;0;0;4;4
9949;Rūta;SMALSUČIAI;3877807687;Taip;9;0;0;9
9950;Rūta;SMALSUČIAI;9429856388;Ne;0;0;4;4
9951;Rūta;SMALSUČIAI;8483916287;Ne;6;4;0;10
9952;Rūta;SMALSUČIAI;1290867375;Ne;0;5;0;5
9953;Rūta;SMALSUČIAI;4780828296;Ne;0;0;7;7
9954;Rūta;SMALSUČIAI;2084935094;Ne;0;0;4;4
9955;Rūta;SMALSUČIAI;2830990163;Ne;0;0;3;3
9956;Rūta;SMALSUČIAI;7724451685;Ne;9;0;0;9
9957;Rūta;SMALSUČIAI;8320791295;Ne;0;4;0;4
9958;Rūta;SMALSUČIAI;3109709043;Ne;18;0;0;18
9959;Rūta;SMALSUČIAI;2733932207;Taip;0;10;0;10
9960;Rūta;SMALSUČIAI;3498596516;Ne;0;0;5;5
9961;Rūta;KŪLVERSTUKAI;5002760763;Ne;0;4;0;4
9962;Rūta;KŪLVERSTUKAI;4440148328;Ne;0;1;0;1
9963;Rūta;KŪLVERSTUKAI;1059126758;Ne;0;5;0;5
9964;Rūta;KŪLVERSTUKAI;6417693659;Ne;0;4;0;4
9965;Rūta;KŪLVERSTUKAI;3352007694;Ne;0;5;0;5
9966;Rūta;KŪLVERSTUKAI;4090915728;Ne;0;2;0;2
9967;Rūta;KŪLVERSTUKAI;4466522924;Ne;4;5;0;9
9968;Rūta;KŪLVERSTUKAI;7905893575;Ne;2;4;0;6
9969;Rūta;KŪLVERSTUKAI;4776631890;Ne;5;0;0;5
9970;Rūta;KŪLVERSTUKAI;4436482805;Ne;0;4;0;4
9971;Rūta;KŪLVERSTUKAI;1260386759;Ne;0;1;0;1
9972;Rūta;KŪLVERSTUKAI;8935780480;Ne;5;0;0;5
9973;Rūta;KŪLVERSTUKAI;4208678278;Ne;0;4;0;4
9974;Rūta;KŪLVERSTUKAI;6044060646;Ne;0;4;0;4
9975;Rūta;KŪLVERSTUKAI;1671179652;Ne;5;4;0;9
9976;Rūta;KŪLVERSTUKAI;9012256437;Ne;6;0;0;6
9977;Rūta;KŪLVERSTUKAI;1152453609;Ne;2;4;0;6
9978;Rūta;KŪLVERSTUKAI;3081348981;Ne;0;1;0;1
9979;Rūta;KODĖLČIUKAI;5962981130;Ne;0;0;2;2
9980;Rūta;KODĖLČIUKAI;4347678781;Ne;0;0;2;2
9981;Rūta;KODĖLČIUKAI;3736279705;Ne;10;0;2;12
9982;Rūta;KODĖLČIUKAI;8416455711;Ne;0;0;1;1
9983;Rūta;KODĖLČIUKAI;8668510009;Ne;0;2;3;5
9984;Rūta;KODĖLČIUKAI;2547849837;Ne;0;0;4;4
9985;Rūta;KODĖLČIUKAI;9501101073;Ne;0;1;3;4
9986;Rūta;KODĖLČIUKAI;8883578144;Ne;0;0;6;6
9987;Rūta;KODĖLČIUKAI;4546082355;Ne;4;0;0;4
9988;Rūta;KODĖLČIUKAI;1000645885;Ne;0;4;0;4
9989;Rūta;KODĖLČIUKAI;5766392854;Ne;0;7;0;7
9990;Rūta;KODĖLČIUKAI;4944413811;Ne;4;0;0;4
9991;Rūta;KODĖLČIUKAI;9916296056;Ne;13;0;0;13
9992;Rūta;KODĖLČIUKAI;4656138649;Taip;0;0;3;3
9993;Rūta;KODĖLČIUKAI;1605412505;Ne;11;0;1;12
9994;Rūta;KODĖLČIUKAI;4533816630;Ne;3;6;0;9
9995;Rūta;KODĖLČIUKAI;8455941633;Ne;3;0;6;9
9996;Rūta;KODĖLČIUKAI;8120157087;Ne;0;0;4;4
9997;Rūta;BORUŽĖLĖS;7712500278;Ne;0;4;0;4
9998;Rūta;BORUŽĖLĖS;3898579878;Ne;10;0;0;10
9999;Rūta;BORUŽĖLĖS;8945868791;Ne;19;0;0;19
10000;Rūta;BORUŽĖLĖS;3348066709;Ne;6;4;0;10
10001;Rūta;BORUŽĖLĖS;4279367893;Taip;13;0;0;13
10002;Rūta;BORUŽĖLĖS;5141290453;Ne;7;0;0;7
10003;Rūta;BORUŽĖLĖS;7006165453;Ne;0;1;0;1
10004;Rūta;BORUŽĖLĖS;8303314520;Ne;13;0;0;13
10005;Rūta;BORUŽĖLĖS;3470052541;Ne;11;4;0;15
10006;Rūta;BORUŽĖLĖS;2625691851;Ne;8;0;1;9
10007;Rūta;BORUŽĖLĖS;1804222979;Taip;7;0;0;7
10008;Rūta;BORUŽĖLĖS;5624054621;Ne;9;0;0;9
10009;Rūta;BORUŽĖLĖS;6853057649;Ne;8;0;1;9
10010;Rūta;BORUŽĖLĖS;2373746441;Ne;0;0;1;1
10011;Rūta;BORUŽĖLĖS;2724625200;Ne;15;0;0;15
10012;Rūta;BORUŽĖLĖS;2118244290;Ne;0;1;0;1
10013;Rūta;BORUŽĖLĖS;2492891254;Ne;15;0;0;15
10014;Rūta;BORUŽĖLĖS;4204930257;Ne;7;1;1;9
10015;Rūta;VYTURĖLIAI;7680605199;Ne;6;4;0;10
10016;Rūta;VYTURĖLIAI;6075632046;Ne;4;3;0;7
10017;Rūta;VYTURĖLIAI;9386595365;Ne;1;4;0;5
10018;Rūta;VYTURĖLIAI;6285841968;Ne;0;1;0;1
10019;Rūta;VYTURĖLIAI;7649756034;Ne;0;3;5;8
10020;Rūta;VYTURĖLIAI;5899860543;Ne;0;4;0;4
10021;Rūta;VYTURĖLIAI;1346124133;Ne;5;0;0;5
10022;Rūta;VYTURĖLIAI;4728904136;Ne;1;4;0;5
10023;Rūta;VYTURĖLIAI;9791861646;Ne;0;4;1;5
10024;Rūta;VYTURĖLIAI;2928803089;Ne;2;4;0;6
10025;Rūta;VYTURĖLIAI;8378318357;Ne;0;4;0;4
10026;Rūta;VYTURĖLIAI;1951202550;Ne;2;3;0;5
10027;Rūta;VYTURĖLIAI;3875136625;Ne;0;5;0;5
10028;Rūta;VYTURĖLIAI;4962272621;Ne;0;2;0;2
10029;Rūta;VYTURĖLIAI;9911151238;Ne;1;4;0;5
10030;Rūta;VYTURĖLIAI;7434152435;Ne;0;1;0;1
10031;Rūta;VYTURĖLIAI;1035527190;Ne;2;4;0;6
10032;Rūta;VYTURĖLIAI;3843325181;Ne;2;4;0;6
10033;Rūta;VYTURĖLIAI;8182243701;Ne;0;4;0;4
10034;Rūta;VYTURĖLIAI;8763382361;Ne;0;4;4;8
10035;Rūta;VYTURĖLIAI;8277677952;Ne;0;3;0;3
10036;Rūta;"PABIRUČIAI (LOGOPEDINĖ)";5211104903;Ne;11;0;0;11
10037;Rūta;"PABIRUČIAI (LOGOPEDINĖ)";1734479058;Ne;0;0;7;7
10038;Rūta;"PABIRUČIAI (LOGOPEDINĖ)";4134411156;Ne;0;0;1;1
10039;Rūta;"PABIRUČIAI (LOGOPEDINĖ)";2164103114;Ne;9;0;0;9
10040;Rūta;"PABIRUČIAI (LOGOPEDINĖ)";4271185150;Ne;0;0;5;5
10041;Rūta;"PABIRUČIAI (LOGOPEDINĖ)";6088978998;Ne;7;0;0;7
10042;Rūta;"PABIRUČIAI (LOGOPEDINĖ)";6849928601;Ne;11;0;1;12
10043;Rūta;"PABIRUČIAI (LOGOPEDINĖ)";4151633786;Ne;0;0;3;3
10044;Rūta;GUDRUČIAI;4044349935;Ne;0;0;1;1
10045;Rūta;GUDRUČIAI;3998791775;Ne;0;1;0;1
10046;Rūta;GUDRUČIAI;3043164521;Ne;0;4;0;4
10047;Rūta;GUDRUČIAI;3462986405;Ne;0;2;4;6
10048;Rūta;GUDRUČIAI;8548089843;Taip;4;0;1;5
10049;Rūta;GUDRUČIAI;4293920701;Ne;0;4;0;4
10050;Rūta;GUDRUČIAI;4473591998;Ne;0;6;1;7
10051;Rūta;GUDRUČIAI;9419809946;Ne;0;4;0;4
10052;Rūta;GUDRUČIAI;9589117921;Ne;0;9;0;9
10053;Rūta;GUDRUČIAI;3044976169;Ne;0;0;1;1
10054;Rūta;GUDRUČIAI;2546023973;Ne;0;0;5;5
10055;Rūta;GUDRUČIAI;8273644943;Ne;0;4;0;4
10056;Rūta;GUDRUČIAI;8963959004;Ne;11;5;0;16
10057;Rūta;GUDRUČIAI;3454881685;Ne;0;4;0;4
10058;Rūta;GUDRUČIAI;1811055786;Ne;0;9;0;9
10059;Rūta;GUDRUČIAI;1510268514;Ne;0;5;0;5
10060;Rūta;GUDRUČIAI;6814051598;Ne;0;3;0;3
10061;Rūta;GUDRUČIAI;2702537976;Ne;0;5;0;5
10062;Rūta;GUDRUČIAI;2772130413;Ne;0;1;0;1
10063;Rūta;GUDRUČIAI;1623968580;Ne;0;4;1;5
10064;Rūta;GUDRUČIAI;8592528906;Ne;0;3;0;3
10065;Rūta;GUDRUČIAI;1182222976;Ne;2;0;4;6
10066;Rūta;SEKLYTĖLĖ;4423305209;Ne;0;4;1;5
10067;Rūta;SEKLYTĖLĖ;9245618776;Ne;0;4;2;6
10068;Rūta;SEKLYTĖLĖ;1216786487;Ne;0;4;0;4
10069;Rūta;SEKLYTĖLĖ;9736567509;Ne;0;4;3;7
10070;Rūta;SEKLYTĖLĖ;7222494215;Ne;0;2;0;2
10071;Rūta;SEKLYTĖLĖ;7519931138;Ne;0;4;0;4
10072;Rūta;SEKLYTĖLĖ;4880804625;Ne;0;5;0;5
10073;Rūta;SEKLYTĖLĖ;3055345528;Ne;0;3;0;3
10074;Rūta;SEKLYTĖLĖ;3499727608;Ne;0;3;1;4
10075;Rūta;SEKLYTĖLĖ;9765301038;Ne;0;3;1;4
10076;Rūta;SEKLYTĖLĖ;9638495757;Ne;2;2;0;4
10077;Rūta;SEKLYTĖLĖ;1962172243;Ne;0;4;0;4
10078;Rūta;SEKLYTĖLĖ;8605070655;Ne;0;4;0;4
10079;Rūta;SEKLYTĖLĖ;7553844890;Ne;0;15;0;15
10080;Rūta;SEKLYTĖLĖ;3964922552;Ne;0;4;1;5
10081;Rūta;SEKLYTĖLĖ;8395765508;Ne;0;3;2;5
10082;Rūta;SEKLYTĖLĖ;5109138407;Taip;0;4;0;4
10083;Rūta;SEKLYTĖLĖ;9400586178;Ne;0;4;3;7
10084;Rūta;SEKLYTĖLĖ;3956912957;Ne;0;14;0;14
10085;Rūta;SEKLYTĖLĖ;2890569107;Ne;0;3;0;3
10086;Rūta;SEKLYTĖLĖ;2474991135;Ne;0;4;5;9
10087;Rūta;"VARPELIAI (LOGOPEDINĖ)";4911219947;Ne;0;4;2;6
10088;Rūta;"VARPELIAI (LOGOPEDINĖ)";9171781646;Ne;3;1;0;4
10089;Rūta;"VARPELIAI (LOGOPEDINĖ)";6221528830;Ne;19;0;0;19
10090;Rūta;"VARPELIAI (LOGOPEDINĖ)";5871960113;Ne;0;5;0;5
10091;Rūta;"VARPELIAI (LOGOPEDINĖ)";3814794448;Ne;0;2;6;8
10092;Rūta;"VARPELIAI (LOGOPEDINĖ)";1029871210;Ne;0;2;0;2
10093;Rūta;"VARPELIAI (LOGOPEDINĖ)";6572172779;Ne;0;1;0;1
10094;Rūta;"VARPELIAI (LOGOPEDINĖ)";7946139474;Ne;0;8;0;8
10095;Rūta;"VARPELIAI (LOGOPEDINĖ)";4931253729;Ne;2;1;0;3
10096;Rūta;KIŠKUČIŲ;6587625933;Ne;11;0;0;11
10097;Rūta;KIŠKUČIŲ;9526121339;Ne;7;0;0;7
10098;Rūta;KIŠKUČIŲ;3805738277;Ne;11;0;0;11
10099;Rūta;KIŠKUČIŲ;8038977034;Ne;16;0;0;16
10100;Rūta;KIŠKUČIŲ;6019344201;Ne;10;0;0;10
10101;Rūta;KIŠKUČIŲ;4712457100;Ne;10;0;0;10
10102;Rūta;KIŠKUČIŲ;8370305271;Ne;6;3;0;9
10103;Rūta;KIŠKUČIŲ;4244665683;Ne;6;0;0;6
10104;Rūta;KIŠKUČIŲ;1504057906;Ne;5;2;2;9
10105;Rūta;KIŠKUČIŲ;9842173401;Ne;0;6;0;6
10106;Rūta;KIŠKUČIŲ;2895194578;Taip;7;0;0;7
10107;Rūta;KIŠKUČIŲ;1893871283;Ne;0;19;0;19
10108;Rūta;KIŠKUČIŲ;8711505500;Ne;0;5;0;5
10109;Rūta;KIŠKUČIŲ;7694633171;Ne;0;0;3;3
10110;Rūta;KIŠKUČIŲ;2534754132;Ne;0;3;0;3
10111;Rūta;ŽVIRBLIUKAI;6778088225;Ne;0;5;0;5
10112;Rūta;ŽVIRBLIUKAI;1397028236;Ne;7;0;0;7
10113;Rūta;ŽVIRBLIUKAI;6567603848;Ne;7;0;0;7
10114;Rūta;ŽVIRBLIUKAI;7913626224;Ne;0;0;3;3
10115;Rūta;ŽVIRBLIUKAI;9803391980;Ne;3;5;0;8
10116;Rūta;ŽVIRBLIUKAI;4512761439;Ne;0;0;2;2
10117;Rūta;ŽVIRBLIUKAI;9695283747;Ne;10;0;0;10
10118;Rūta;ŽVIRBLIUKAI;1184265720;Ne;0;17;0;17
10119;Rūta;ŽVIRBLIUKAI;5868983105;Ne;6;0;1;7
10120;Rūta;ŽVIRBLIUKAI;8423092171;Ne;0;17;0;17
10121;Rūta;ŽVIRBLIUKAI;5375565821;Ne;4;0;3;7
10122;Rūta;SAULUTĖS;6869693434;Ne;0;0;2;2
10123;Rūta;SAULUTĖS;6585842434;Ne;12;0;0;12
10124;Rūta;SAULUTĖS;6620957022;Taip;4;0;0;4
10125;Rūta;SAULUTĖS;8806743371;Ne;0;0;2;2
10126;Rūta;SAULUTĖS;3765741047;Ne;7;0;5;12
10127;Rūta;SAULUTĖS;7762509383;Ne;0;2;0;2
10128;Rūta;SAULUTĖS;2685515977;Ne;8;2;0;10
10129;Rūta;SAULUTĖS;5512946296;Ne;3;2;0;5
10130;Rūta;SAULUTĖS;9308127402;Ne;5;0;1;6
10131;Rūta;SAULUTĖS;7422059414;Taip;11;5;0;16
10132;Rūta;SAULUTĖS;8479424939;Ne;3;0;0;3
10133;Rūta;SAULUTĖS;9014433476;Ne;0;6;0;6
10134;Rūta;SAULUTĖS;1207463357;Ne;0;3;1;4
10135;Rūta;SAULUTĖS;8715921452;Ne;0;6;0;6
10136;Rūta;SAULUTĖS;9243332756;Ne;0;14;0;14
10137;Rūta;SAULUTĖS;4785878572;Ne;3;2;0;5
10138;Sadutė;Kiškučiai;6645848193;Ne;0;4;0;4
10139;Sadutė;Kiškučiai;1589424708;Ne;0;4;0;4
10140;Sadutė;Kiškučiai;5992865266;Ne;2;4;0;6
10141;Sadutė;Kiškučiai;3568132830;Ne;0;4;0;4
10142;Sadutė;Kiškučiai;2087489114;Ne;0;4;0;4
10143;Sadutė;Kiškučiai;4360361866;Ne;4;4;0;8
10144;Sadutė;Kiškučiai;2139177648;Ne;9;4;0;13
10145;Sadutė;Kiškučiai;6493110772;Ne;0;4;0;4
10146;Sadutė;Kiškučiai;8397295024;Ne;0;3;0;3
10147;Sadutė;Kiškučiai;4075714061;Ne;7;4;0;11
10148;Sadutė;Kiškučiai;3285448692;Ne;0;4;0;4
10149;Sadutė;Kiškučiai;2845125335;Ne;0;4;0;4
10150;Sadutė;Kiškučiai;4135398332;Ne;4;4;0;8
10151;Sadutė;Kiškučiai;3954151590;Ne;10;0;0;10
10152;Sadutė;Kiškučiai;1860645542;Taip;0;19;0;19
10153;Sadutė;Kiškučiai;2472471722;Ne;0;1;0;1
10154;Sadutė;Kiškučiai;8841564884;Ne;0;4;1;5
10155;Sadutė;Kiškučiai;8350900604;Ne;6;5;0;11
10156;Sadutė;Kiškučiai;6784030565;Ne;5;4;0;9
10157;Sadutė;Kiškučiai;2807949826;Ne;5;4;2;11
10158;Sadutė;Boružėlės;9115304973;Ne;0;3;0;3
10159;Sadutė;Boružėlės;8442967732;Ne;0;4;0;4
10160;Sadutė;Boružėlės;1273355194;Ne;5;6;0;11
10161;Sadutė;Boružėlės;3119547420;Ne;4;6;0;10
10162;Sadutė;Boružėlės;8987528237;Ne;0;4;0;4
10163;Sadutė;Boružėlės;6994383907;Ne;2;2;0;4
10164;Sadutė;Boružėlės;8914509685;Ne;0;4;3;7
10165;Sadutė;Boružėlės;7242188081;Ne;3;5;0;8
10166;Sadutė;Boružėlės;3244211391;Ne;3;5;0;8
10167;Sadutė;Boružėlės;3875265137;Ne;0;4;0;4
10168;Sadutė;Boružėlės;5992119777;Ne;0;6;0;6
10169;Sadutė;Boružėlės;5682745869;Taip;5;3;0;8
10170;Sadutė;Boružėlės;7072437339;Ne;2;0;0;2
10171;Sadutė;Boružėlės;5579040052;Ne;0;4;0;4
10172;Sadutė;Boružėlės;3362830536;Ne;1;4;2;7
10173;Sadutė;Boružėlės;5395676303;Ne;0;4;2;6
10174;Sadutė;Boružėlės;1923014145;Ne;0;8;3;11
10175;Sadutė;Boružėlės;5698462283;Ne;13;0;2;15
10176;Sadutė;Boružėlės;3845369333;Ne;3;0;4;7
10177;Sadutė;Boružėlės;8200891038;Ne;2;1;1;4
10178;Sadutė;Boružėlės;4696990344;Ne;3;4;0;7
10179;Sadutė;Boružėlės;1753849762;Ne;4;0;1;5
10180;Sadutė;Boružėlės;7580736252;Ne;0;4;4;8
10181;Sadutė;Bitutės;1759479328;Ne;0;6;2;8
10182;Sadutė;Bitutės;1975767401;Ne;0;3;0;3
10183;Sadutė;Bitutės;4245873513;Ne;0;4;0;4
10184;Sadutė;Bitutės;1873928395;Ne;1;4;1;6
10185;Sadutė;Bitutės;5866461096;Ne;6;4;0;10
10186;Sadutė;Bitutės;4883934480;Ne;0;4;1;5
10187;Sadutė;Bitutės;7097653016;Ne;0;4;0;4
10188;Sadutė;Bitutės;4479315578;Ne;2;4;0;6
10189;Sadutė;Bitutės;2020766695;Taip;0;19;0;19
10190;Sadutė;Bitutės;5011320850;Ne;0;4;5;9
10191;Sadutė;Bitutės;4161502667;Ne;0;4;0;4
10192;Sadutė;Bitutės;5973513916;Ne;1;4;2;7
10193;Sadutė;Bitutės;5169694660;Ne;0;4;0;4
10194;Sadutė;Bitutės;3361904803;Ne;0;5;3;8
10195;Sadutė;Bitutės;1231048342;Ne;0;5;0;5
10196;Sadutė;Bitutės;8556086501;Ne;0;9;0;9
10197;Sadutė;Bitutės;6066145909;Ne;10;5;0;15
10198;Sadutė;Bitutės;5142566738;Ne;0;4;7;11
10199;Sadutė;Bitutės;8662375739;Ne;0;6;2;8
10200;Sadutė;Bitutės;9107727583;Ne;1;4;0;5
10201;Sadutė;Bitutės;6138604955;Ne;12;4;0;16
10202;Sadutė;Bitutės;3339522259;Ne;0;4;0;4
10203;Sadutė;Bitutės;9005989501;Ne;0;4;2;6
10204;Sadutė;Drugeliai;2965270548;Ne;14;3;0;17
10205;Sadutė;Drugeliai;7533550197;Ne;0;4;1;5
10206;Sadutė;Drugeliai;8308487263;Ne;0;4;0;4
10207;Sadutė;Drugeliai;5824843942;Ne;9;0;0;9
10208;Sadutė;Drugeliai;4753735028;Ne;0;19;0;19
10209;Sadutė;Drugeliai;6039555589;Ne;15;0;0;15
10210;Sadutė;Drugeliai;4132174495;Ne;0;3;0;3
10211;Sadutė;Drugeliai;4862514558;Ne;0;3;0;3
10212;Sadutė;Drugeliai;4866469773;Ne;0;19;0;19
10213;Sadutė;Drugeliai;4062325464;Ne;0;3;0;3
10214;Sadutė;Drugeliai;3450873020;Ne;2;1;0;3
10215;Sadutė;Drugeliai;5133144667;Ne;0;3;0;3
10216;Sadutė;Drugeliai;9224321056;Ne;6;0;0;6
10217;Sadutė;Drugeliai;3895799244;Ne;0;19;0;19
10218;Sadutė;Drugeliai;1907291315;Ne;0;3;1;4
10219;Sadutė;Drugeliai;3337178609;Ne;2;0;0;2
10220;Sadutė;Drugeliai;3540727678;Ne;12;4;0;16
10221;Sadutė;Pėledžiukai;9136727429;Ne;0;0;3;3
10222;Sadutė;Pėledžiukai;5616756293;Ne;0;4;2;6
10223;Sadutė;Pėledžiukai;2705458480;Ne;9;0;0;9
10224;Sadutė;Pėledžiukai;6314488650;Ne;0;2;0;2
10225;Sadutė;Pėledžiukai;6126235707;Ne;0;3;2;5
10226;Sadutė;Pėledžiukai;1537482438;Ne;0;8;0;8
10227;Sadutė;Pėledžiukai;6716550703;Ne;9;0;0;9
10228;Sadutė;Pėledžiukai;7551299839;Ne;0;3;5;8
10229;Sadutė;Pėledžiukai;8914706717;Ne;4;0;0;4
10230;Sadutė;Pėledžiukai;6379705269;Ne;0;0;3;3
10231;Sadutė;Pėledžiukai;5385678913;Ne;0;4;0;4
10232;Sadutė;Pėledžiukai;2747256989;Ne;0;0;5;5
10233;Sadutė;Pėledžiukai;3277826759;Ne;0;1;0;1
10234;Sadutė;Pėledžiukai;4791750087;Ne;0;1;0;1
10235;Sadutė;Pėledžiukai;2003300961;Ne;0;6;0;6
10236;Sadutė;Pėledžiukai;5580870821;Ne;6;0;1;7
10237;Sadutė;Pėledžiukai;6430493524;Ne;6;0;1;7
10238;Sadutė;Pėledžiukai;1510498753;Ne;6;0;1;7
10239;Sadutė;Kačiukų;1903961488;Ne;0;4;0;4
10240;Sadutė;Kačiukų;2890916313;Ne;3;8;0;11
10241;Sadutė;Kačiukų;2733633163;Ne;0;3;0;3
10242;Sadutė;Kačiukų;3993181500;Ne;0;4;0;4
10243;Sadutė;Kačiukų;8835627470;Ne;0;5;0;5
10244;Sadutė;Kačiukų;2532626934;Ne;0;5;0;5
10245;Sadutė;Kačiukų;2466024649;Ne;0;4;0;4
10246;Sadutė;Kačiukų;6253351299;Ne;2;4;0;6
10247;Sadutė;Kačiukų;2426974464;Ne;4;4;0;8
10248;Sadutė;Kačiukų;5438448926;Ne;0;4;0;4
10249;Sadutė;Kačiukų;8974374101;Ne;4;9;0;13
10250;Sadutė;Kačiukų;4401870028;Ne;0;6;0;6
10251;Sadutė;Kačiukų;8714168144;Ne;0;5;0;5
10252;Sadutė;Kačiukų;3927044011;Ne;0;4;0;4
10253;Sadutė;Kačiukų;8974225608;Ne;0;4;0;4
10254;Sadutė;Kačiukų;8770727233;Ne;1;5;0;6
10255;Sadutė;Kačiukų;8556218971;Ne;0;4;0;4
10256;Sadutė;Kačiukų;5267093203;Ne;5;14;0;19
10257;Sadutė;Kačiukų;6538356822;Ne;3;4;0;7
10258;Sadutė;Kačiukų;5614758320;Ne;11;6;0;17
10259;Sadutė;Kačiukų;2194387139;Ne;0;3;0;3
10260;Sakalėlis;GIRINUKŲ;6597274376;Ne;0;5;1;6
10261;Sakalėlis;GIRINUKŲ;5500248048;Ne;7;0;0;7
10262;Sakalėlis;GIRINUKŲ;8562164673;Ne;2;1;3;6
10263;Sakalėlis;GIRINUKŲ;1121818878;Ne;0;1;0;1
10264;Sakalėlis;GIRINUKŲ;2537030533;Ne;0;0;9;9
10265;Sakalėlis;GIRINUKŲ;3719351129;Ne;0;1;2;3
10266;Sakalėlis;GIRINUKŲ;3570413330;Ne;0;0;7;7
10267;Sakalėlis;GIRINUKŲ;6889888573;Ne;7;0;0;7
10268;Sakalėlis;GIRINUKŲ;5465596207;Ne;6;0;0;6
10269;Sakalėlis;GIRINUKŲ;7852255204;Ne;9;0;0;9
10270;Sakalėlis;GIRINUKŲ;9926328835;Ne;8;1;2;11
10271;Sakalėlis;GIRINUKŲ;1253452975;Ne;0;4;2;6
10272;Sakalėlis;GIRINUKŲ;8328069876;Ne;0;0;2;2
10273;Sakalėlis;GIRINUKŲ;7480286509;Ne;4;3;1;8
10274;Sakalėlis;GIRINUKŲ;2250828607;Ne;4;4;0;8
10275;Sakalėlis;GIRINUKŲ;2672429406;Ne;4;4;0;8
10276;Sakalėlis;GIRINUKŲ;2233966176;Ne;0;4;1;5
10277;Sakalėlis;GIRINUKŲ;7079300418;Ne;15;0;0;15
10278;Sakalėlis;GIRINUKŲ;6851247779;Ne;0;1;1;2
10279;Sakalėlis;GIRINUKŲ;8501785305;Ne;0;0;7;7
10280;Sakalėlis;GIRINUKŲ;2649804066;Ne;4;4;0;8
10281;Sakalėlis;GIRINUKŲ;6996901033;Ne;2;0;0;2
10282;Sakalėlis;VYTURIUKŲ;3927487265;Ne;0;4;0;4
10283;Sakalėlis;VYTURIUKŲ;2352118061;Ne;2;3;0;5
10284;Sakalėlis;VYTURIUKŲ;3680732318;Ne;0;10;0;10
10285;Sakalėlis;VYTURIUKŲ;4862004373;Ne;0;3;0;3
10286;Sakalėlis;VYTURIUKŲ;8422299669;Ne;0;4;0;4
10287;Sakalėlis;VYTURIUKŲ;6579827280;Ne;0;3;2;5
10288;Sakalėlis;VYTURIUKŲ;8381310908;Ne;3;5;0;8
10289;Sakalėlis;VYTURIUKŲ;6840368824;Ne;5;4;1;10
10290;Sakalėlis;VYTURIUKŲ;1742362136;Ne;0;4;0;4
10291;Sakalėlis;VYTURIUKŲ;5795250727;Ne;0;4;0;4
10292;Sakalėlis;VYTURIUKŲ;2985239904;Ne;0;4;0;4
10293;Sakalėlis;VYTURIUKŲ;3351218789;Ne;0;2;3;5
10294;Sakalėlis;VYTURIUKŲ;9120873899;Ne;0;4;4;8
10295;Sakalėlis;VYTURIUKŲ;4136266629;Ne;0;4;6;10
10296;Sakalėlis;VYTURIUKŲ;5991029760;Ne;0;4;6;10
10297;Sakalėlis;VYTURIUKŲ;6378711142;Ne;0;4;0;4
10298;Sakalėlis;VYTURIUKŲ;1736303381;Ne;0;2;3;5
10299;Sakalėlis;VYTURIUKŲ;7280513854;Ne;4;2;0;6
10300;Sakalėlis;VYTURIUKŲ;1806698668;Ne;0;4;1;5
10301;Sakalėlis;DRUGELIŲ;8095359035;Ne;15;0;0;15
10302;Sakalėlis;DRUGELIŲ;6515519140;Ne;0;4;0;4
10303;Sakalėlis;DRUGELIŲ;7706606275;Ne;14;0;0;14
10304;Sakalėlis;DRUGELIŲ;5911341542;Ne;3;0;0;3
10305;Sakalėlis;DRUGELIŲ;9272347788;Ne;0;4;0;4
10306;Sakalėlis;DRUGELIŲ;9416737436;Ne;7;0;0;7
10307;Sakalėlis;DRUGELIŲ;8331612396;Ne;9;0;0;9
10308;Sakalėlis;DRUGELIŲ;2898006208;Ne;0;0;2;2
10309;Sakalėlis;DRUGELIŲ;7542322748;Ne;7;0;1;8
10310;Sakalėlis;DRUGELIŲ;4918228191;Ne;0;2;0;2
10311;Sakalėlis;DRUGELIŲ;1201086815;Ne;8;0;0;8
10312;Sakalėlis;DRUGELIŲ;3934295338;Ne;5;4;2;11
10313;Sakalėlis;DRUGELIŲ;1117800518;Ne;12;0;0;12
10314;Sakalėlis;DRUGELIŲ;2515169899;Ne;0;4;0;4
10315;Sakalėlis;DRUGELIŲ;8160589611;Ne;4;7;0;11
10316;Sakalėlis;DRUGELIŲ;9836193857;Ne;0;4;1;5
10317;Sakalėlis;DRUGELIŲ;4004006771;Ne;0;4;0;4
10318;Sakalėlis;DRUGELIŲ;1833573491;Ne;7;0;1;8
10319;Sakalėlis;DRUGELIŲ;8713298648;Ne;14;0;0;14
10320;Sakalėlis;DRUGELIŲ;2889638745;Ne;10;4;0;14
10321;Sakalėlis;DRUGELIŲ;3329244758;Ne;0;0;3;3
10322;Sakalėlis;DRUGELIŲ;7540098033;Ne;7;0;1;8
10323;Sakalėlis;DRUGELIŲ;7285833058;Ne;5;4;0;9
10324;Sakalėlis;GENIUKŲ;2505477059;Ne;7;0;0;7
10325;Sakalėlis;GENIUKŲ;1004062550;Ne;3;0;0;3
10326;Sakalėlis;GENIUKŲ;5865993835;Ne;4;2;1;7
10327;Sakalėlis;GENIUKŲ;6328924318;Ne;8;0;0;8
10328;Sakalėlis;GENIUKŲ;2003090775;Ne;7;0;0;7
10329;Sakalėlis;GENIUKŲ;8228039819;Ne;19;0;0;19
10330;Sakalėlis;GENIUKŲ;7006304327;Ne;0;0;1;1
10331;Sakalėlis;GENIUKŲ;4633296169;Ne;2;0;1;3
10332;Sakalėlis;GENIUKŲ;4611384179;Ne;3;2;0;5
10333;Sakalėlis;GENIUKŲ;4490632523;Ne;6;0;0;6
10334;Sakalėlis;GENIUKŲ;8868588637;Taip;5;4;0;9
10335;Sakalėlis;GENIUKŲ;8015985605;Ne;10;4;0;14
10336;Sakalėlis;GENIUKŲ;5052638078;Ne;9;0;0;9
10337;Sakalėlis;GENIUKŲ;5327382009;Ne;9;0;0;9
10338;Sakalėlis;GENIUKŲ;6897550418;Ne;3;0;1;4
10339;Sakalėlis;GENIUKŲ;9642519454;Ne;2;4;0;6
10340;Sakalėlis;GENIUKŲ;4295210323;Ne;7;0;0;7
10341;Sakalėlis;GENIUKŲ;6300266321;Ne;0;4;1;5
10342;Sakalėlis;GENIUKŲ;8796728627;Ne;0;3;0;3
10343;Sakalėlis;GENIUKŲ;8659925528;Ne;12;0;0;12
10344;Sakalėlis;VOVERIUKŲ;5172421763;Ne;7;0;2;9
10345;Sakalėlis;VOVERIUKŲ;5233697077;Ne;5;4;2;11
10346;Sakalėlis;VOVERIUKŲ;6414564366;Taip;5;0;2;7
10347;Sakalėlis;VOVERIUKŲ;4358313171;Ne;0;0;4;4
10348;Sakalėlis;VOVERIUKŲ;6806170544;Ne;0;0;6;6
10349;Sakalėlis;VOVERIUKŲ;2557089391;Ne;0;0;8;8
10350;Sakalėlis;VOVERIUKŲ;8133985842;Ne;0;0;7;7
10351;Sakalėlis;VOVERIUKŲ;3574956316;Ne;0;6;0;6
10352;Sakalėlis;VOVERIUKŲ;1403384561;Ne;8;0;5;13
10353;Sakalėlis;VOVERIUKŲ;3927363997;Ne;0;4;0;4
10354;Sakalėlis;VOVERIUKŲ;6293226507;Ne;9;0;2;11
10355;Sakalėlis;VOVERIUKŲ;2699844937;Taip;0;7;0;7
10356;Sakalėlis;VOVERIUKŲ;1669610397;Ne;0;0;15;15
10357;Sakalėlis;VOVERIUKŲ;6016854405;Ne;0;7;0;7
10358;Sakalėlis;VOVERIUKŲ;2531146677;Ne;7;0;0;7
10359;Sakalėlis;VOVERIUKŲ;4968216193;Ne;0;0;3;3
10360;Sakalėlis;VOVERIUKŲ;3217646353;Ne;0;0;1;1
10361;Sakalėlis;PĖLEDŽIUKŲ;5405669698;Ne;0;2;3;5
10362;Sakalėlis;PĖLEDŽIUKŲ;2474164013;Ne;0;1;0;1
10363;Sakalėlis;PĖLEDŽIUKŲ;9566176151;Ne;5;0;0;5
10364;Sakalėlis;PĖLEDŽIUKŲ;9493905856;Ne;0;3;0;3
10365;Sakalėlis;PĖLEDŽIUKŲ;9250470549;Ne;0;4;0;4
10366;Sakalėlis;PĖLEDŽIUKŲ;5496044442;Ne;0;4;0;4
10367;Sakalėlis;PĖLEDŽIUKŲ;3165387995;Ne;0;3;0;3
10368;Sakalėlis;PĖLEDŽIUKŲ;6603105354;Ne;0;4;5;9
10369;Sakalėlis;PĖLEDŽIUKŲ;3418702674;Ne;2;1;0;3
10370;Sakalėlis;PĖLEDŽIUKŲ;3748865437;Ne;0;1;0;1
10371;Sakalėlis;PĖLEDŽIUKŲ;3333037807;Ne;2;4;0;6
10372;Sakalėlis;PĖLEDŽIUKŲ;8606714134;Ne;0;4;0;4
10373;Sakalėlis;PĖLEDŽIUKŲ;4596727938;Ne;0;3;0;3
10374;Sakalėlis;PĖLEDŽIUKŲ;1347171934;Ne;0;4;0;4
10375;Sakalėlis;PĖLEDŽIUKŲ;8790189865;Ne;0;1;2;3
10376;Sakalėlis;PĖLEDŽIUKŲ;4458071075;Ne;0;4;2;6
10377;Sakalėlis;PĖLEDŽIUKŲ;4209146744;Ne;0;4;0;4
10378;Sakalėlis;PĖLEDŽIUKŲ;6217643065;Ne;2;4;0;6
10379;Sakalėlis;PĖLEDŽIUKŲ;4344537391;Ne;0;2;0;2
10380;Sakalėlis;PĖLEDŽIUKŲ;9368758708;Ne;0;4;9;13
10381;Sakalėlis;PĖLEDŽIUKŲ;8326977226;Ne;8;0;1;9
10382;Sakalėlis;PĖLEDŽIUKŲ;4576495786;Ne;0;3;0;3
10383;Sakalėlis;"BITUČIŲ (LOGOPEDINĖ)";3938470708;Ne;6;0;0;6
10384;Sakalėlis;"BITUČIŲ (LOGOPEDINĖ)";5376872141;Ne;1;0;0;1
10385;Sakalėlis;"BITUČIŲ (LOGOPEDINĖ)";3079900548;Taip;2;0;0;2
10386;Sakalėlis;"BITUČIŲ (LOGOPEDINĖ)";2669711574;Ne;8;0;0;8
10387;Sakalėlis;"BITUČIŲ (LOGOPEDINĖ)";8638720071;Ne;5;0;0;5
10388;Sakalėlis;"BITUČIŲ (LOGOPEDINĖ)";4442027941;Ne;3;2;0;5
10389;Sakalėlis;"BITUČIŲ (LOGOPEDINĖ)";2691761427;Ne;5;0;0;5
10390;Sakalėlis;"BITUČIŲ (LOGOPEDINĖ)";1208798798;Ne;0;5;0;5
10391;Sakalėlis;"BITUČIŲ (LOGOPEDINĖ)";2748400429;Taip;0;12;0;12
10392;Sakalėlis;"BORUŽIUKŲ (LOGOPEDINĖ)";2124857941;Ne;6;0;0;6
10393;Sakalėlis;"BORUŽIUKŲ (LOGOPEDINĖ)";6250400609;Ne;3;4;0;7
10394;Sakalėlis;"BORUŽIUKŲ (LOGOPEDINĖ)";6222204020;Ne;4;8;0;12
10395;Sakalėlis;"BORUŽIUKŲ (LOGOPEDINĖ)";7602249339;Ne;2;0;0;2
10396;Sakalėlis;"BORUŽIUKŲ (LOGOPEDINĖ)";8263169658;Ne;11;4;0;15
10397;Sakalėlis;"BORUŽIUKŲ (LOGOPEDINĖ)";9776767584;Ne;7;0;0;7
10398;Sakalėlis;"BORUŽIUKŲ (LOGOPEDINĖ)";7620944079;Ne;0;4;0;4
10399;Sakalėlis;"BORUŽIUKŲ (LOGOPEDINĖ)";2732572235;Ne;4;4;0;8
10400;Sakalėlis;"BORUŽIUKŲ (LOGOPEDINĖ)";5677280944;Ne;9;0;0;9
10401;Sakalėlis;"BORUŽIUKŲ (LOGOPEDINĖ)";9337144831;Ne;1;1;0;2
10402;Sakalėlis;MEŠKUČIŲ;9546779717;Ne;4;5;0;9
10403;Sakalėlis;MEŠKUČIŲ;8535457018;Ne;0;5;0;5
10404;Sakalėlis;MEŠKUČIŲ;4813561523;Ne;0;0;4;4
10405;Sakalėlis;MEŠKUČIŲ;7154383856;Ne;9;0;0;9
10406;Sakalėlis;MEŠKUČIŲ;5082756444;Taip;0;0;4;4
10407;Sakalėlis;MEŠKUČIŲ;7839893402;Ne;0;0;1;1
10408;Sakalėlis;MEŠKUČIŲ;3092760315;Ne;0;9;0;9
10409;Sakalėlis;MEŠKUČIŲ;3524545708;Ne;0;6;0;6
10410;Sakalėlis;MEŠKUČIŲ;5961207419;Ne;8;0;2;10
10411;Sakalėlis;MEŠKUČIŲ;5961861760;Ne;0;0;1;1
10412;Sakalėlis;MEŠKUČIŲ;2389541483;Taip;0;6;0;6
10413;Sakalėlis;MEŠKUČIŲ;4063074948;Ne;0;0;1;1
10414;Sakalėlis;MEŠKUČIŲ;8108456923;Ne;8;0;0;8
10415;Sakalėlis;MEŠKUČIŲ;7285230768;Ne;7;4;0;11
10416;Sakalėlis;MEŠKUČIŲ;8888784168;Ne;1;4;0;5
10417;Sakalėlis;MEŠKUČIŲ;2090313887;Ne;0;9;0;9
10418;Sakalėlis;MEŠKUČIŲ;9794245922;Ne;0;0;10;10
10419;Sakalėlis;MEŠKUČIŲ;8106231242;Ne;10;0;3;13
10420;Sakalėlis;MEŠKUČIŲ;4520212128;Ne;0;9;0;9
10421;Sakalėlis;MEŠKUČIŲ;7228559861;Ne;0;10;0;10
10422;Sakalėlis;MEŠKUČIŲ;8000744698;Taip;14;0;3;17
10423;Sakalėlis;MEŠKUČIŲ;7664863335;Ne;4;0;0;4
10424;Sakalėlis;KIŠKUČIŲ;6029443196;Ne;7;5;2;14
10425;Sakalėlis;KIŠKUČIŲ;8036737782;Ne;14;5;0;19
10426;Sakalėlis;KIŠKUČIŲ;9621137382;Ne;14;0;0;14
10427;Sakalėlis;KIŠKUČIŲ;3941949117;Ne;1;0;0;1
10428;Sakalėlis;KIŠKUČIŲ;2117073621;Ne;2;0;2;4
10429;Sakalėlis;KIŠKUČIŲ;7796882816;Ne;6;0;0;6
10430;Sakalėlis;KIŠKUČIŲ;8788790889;Ne;3;0;0;3
10431;Sakalėlis;KIŠKUČIŲ;1270977572;Ne;7;0;1;8
10432;Sakalėlis;KIŠKUČIŲ;1213702668;Ne;6;0;0;6
10433;Sakalėlis;KIŠKUČIŲ;6682017840;Ne;11;0;0;11
10434;Sakalėlis;KIŠKUČIŲ;1913818905;Ne;3;0;2;5
10435;Sakalėlis;KIŠKUČIŲ;1969584481;Ne;17;0;1;18
10436;Sakalėlis;KIŠKUČIŲ;7764732694;Ne;4;0;0;4
10437;Sakalėlis;KIŠKUČIŲ;8461873822;Ne;1;4;0;5
10438;Sakalėlis;KIŠKUČIŲ;9172210601;Ne;0;7;0;7
10439;Sakalėlis;SVIRPLIUKŲ;1981444595;Ne;4;0;1;5
10440;Sakalėlis;SVIRPLIUKŲ;8562206323;Ne;8;0;0;8
10441;Sakalėlis;SVIRPLIUKŲ;5494452779;Ne;0;0;9;9
10442;Sakalėlis;SVIRPLIUKŲ;3294479203;Ne;2;0;1;3
10443;Sakalėlis;SVIRPLIUKŲ;9423279756;Ne;3;4;0;7
10444;Sakalėlis;SVIRPLIUKŲ;3205403024;Ne;3;0;3;6
10445;Sakalėlis;SVIRPLIUKŲ;1172937572;Ne;0;0;1;1
10446;Sakalėlis;SVIRPLIUKŲ;3963251786;Ne;0;0;4;4
10447;Sakalėlis;SVIRPLIUKŲ;8386308690;Ne;0;1;6;7
10448;Sakalėlis;SVIRPLIUKŲ;9410185441;Ne;0;0;2;2
10449;Sakalėlis;SVIRPLIUKŲ;8959937912;Ne;0;0;3;3
10450;Sakalėlis;SVIRPLIUKŲ;5649630720;Ne;6;0;2;8
10451;Sakalėlis;SVIRPLIUKŲ;5740175023;Ne;5;0;5;10
10452;Sakalėlis;SVIRPLIUKŲ;6476563646;Ne;0;0;3;3
10453;Sakalėlis;SVIRPLIUKŲ;8162876482;Ne;0;4;1;5
10454;Sakalėlis;GANDRIUKŲ;8502289806;Ne;0;4;0;4
10455;Sakalėlis;GANDRIUKŲ;7384400795;Ne;10;4;0;14
10456;Sakalėlis;GANDRIUKŲ;3644413861;Ne;1;5;0;6
10457;Sakalėlis;GANDRIUKŲ;4230762388;Taip;8;0;1;9
10458;Sakalėlis;GANDRIUKŲ;3228617971;Ne;6;0;2;8
10459;Sakalėlis;GANDRIUKŲ;5748438461;Taip;0;0;2;2
10460;Sakalėlis;GANDRIUKŲ;2481285439;Ne;0;0;2;2
10461;Sakalėlis;GANDRIUKŲ;7345113972;Ne;2;6;0;8
10462;Sakalėlis;GANDRIUKŲ;6069544792;Ne;0;0;5;5
10463;Sakalėlis;GANDRIUKŲ;8869621812;Ne;0;0;2;2
10464;Sakalėlis;GANDRIUKŲ;5460619168;Ne;0;0;4;4
10465;Sakalėlis;GANDRIUKŲ;1560077883;Ne;0;0;2;2
10466;Sakalėlis;GANDRIUKŲ;5387119771;Ne;16;0;1;17
10467;Sakalėlis;GANDRIUKŲ;9599801230;Ne;0;0;3;3
10468;Sakalėlis;GANDRIUKŲ;3611884072;Ne;0;0;2;2
10469;Sakalėlis;GANDRIUKŲ;7321913487;Ne;8;0;3;11
10470;Sakalėlis;GANDRIUKŲ;1820886350;Ne;13;0;0;13
10471;Sakalėlis;GANDRIUKŲ;4307106905;Ne;0;0;6;6
10472;Sakalėlis;GANDRIUKŲ;2889517278;Ne;16;0;0;16
10473;Salininkų;BORUŽIUKAI;1315946153;Ne;6;3;0;9
10474;Salininkų;BORUŽIUKAI;4251420816;Ne;5;5;0;10
10475;Salininkų;BORUŽIUKAI;4753007411;Ne;10;3;0;13
10476;Salininkų;BORUŽIUKAI;5023856698;Ne;17;0;0;17
10477;Salininkų;BORUŽIUKAI;9802972916;Ne;1;2;4;7
10478;Salininkų;BORUŽIUKAI;1198469626;Ne;5;2;2;9
10479;Salininkų;BORUŽIUKAI;3168392325;Ne;5;0;0;5
10480;Salininkų;BORUŽIUKAI;6477136976;Ne;19;0;0;19
10481;Salininkų;BORUŽIUKAI;6903692351;Ne;5;2;4;11
10482;Salininkų;BORUŽIUKAI;1161889732;Ne;0;2;2;4
10483;Salininkų;BORUŽIUKAI;8049341629;Ne;11;0;5;16
10484;Salininkų;BORUŽIUKAI;7022231494;Ne;0;2;0;2
10485;Salininkų;BORUŽIUKAI;4726550395;Ne;0;1;0;1
10486;Salininkų;BORUŽIUKAI;4742529598;Ne;0;1;0;1
10487;Salininkų;BORUŽIUKAI;4866786238;Ne;4;2;0;6
10488;Salininkų;BORUŽIUKAI;3710734769;Ne;0;6;0;6
10489;Salininkų;GĖLYTĖS;8718514114;Ne;7;2;0;9
10490;Salininkų;GĖLYTĖS;8329495685;Ne;15;0;0;15
10491;Salininkų;GĖLYTĖS;8930622266;Ne;0;5;0;5
10492;Salininkų;GĖLYTĖS;5447236646;Ne;13;0;0;13
10493;Salininkų;GĖLYTĖS;8911016037;Ne;9;1;0;10
10494;Salininkų;GĖLYTĖS;5045064069;Ne;8;0;1;9
10495;Salininkų;GĖLYTĖS;1647401700;Ne;10;0;0;10
10496;Salininkų;GĖLYTĖS;9817285587;Ne;6;0;0;6
10497;Salininkų;GĖLYTĖS;2146404021;Ne;8;2;0;10
10498;Salininkų;GĖLYTĖS;8823595510;Ne;4;0;0;4
10499;Salininkų;GĖLYTĖS;9416926474;Ne;16;0;0;16
10500;Salininkų;GĖLYTĖS;5671229613;Ne;19;0;0;19
10501;Salininkų;GĖLYTĖS;1005025619;Ne;0;9;0;9
10502;Salininkų;GĖLYTĖS;9855014750;Ne;5;0;0;5
10503;Salininkų;GĖLYTĖS;1254843449;Ne;3;7;0;10
10504;Salininkų;GĖLYTĖS;6315595048;Ne;0;1;0;1
10505;Salininkų;GĖLYTĖS;3231379271;Ne;5;3;0;8
10506;Salininkų;GĖLYTĖS;1346133493;Ne;0;1;0;1
10507;Salininkų;GĖLYTĖS;2273407270;Ne;0;1;0;1
10508;Salininkų;GĖLYTĖS;2056560837;Ne;13;0;0;13
10509;Salininkų;DRUGELIAI;2684868661;Ne;7;0;0;7
10510;Salininkų;DRUGELIAI;8063397588;Ne;4;0;0;4
10511;Salininkų;DRUGELIAI;4333027447;Ne;4;5;0;9
10512;Salininkų;DRUGELIAI;3115232507;Ne;6;5;0;11
10513;Salininkų;DRUGELIAI;2009246885;Ne;8;0;0;8
10514;Salininkų;DRUGELIAI;3420217477;Ne;0;0;3;3
10515;Salininkų;DRUGELIAI;3890914603;Ne;10;9;0;19
10516;Salininkų;DRUGELIAI;3181932118;Ne;7;4;0;11
10517;Salininkų;DRUGELIAI;5017068344;Ne;11;0;0;11
10518;Salininkų;DRUGELIAI;3761217912;Ne;8;4;0;12
10519;Salininkų;DRUGELIAI;2208607684;Ne;0;9;0;9
10520;Salininkų;DRUGELIAI;3963410827;Ne;8;4;0;12
10521;Salininkų;DRUGELIAI;5539560359;Ne;7;5;0;12
10522;Salininkų;DRUGELIAI;5587577036;Ne;5;0;1;6
10523;Salininkų;DRUGELIAI;5375668400;Ne;0;6;0;6
10524;Salininkų;DRUGELIAI;4529253958;Ne;0;5;0;5
10525;Salininkų;DRUGELIAI;5583804491;Ne;0;4;1;5
10526;Salininkų;DRUGELIAI;6786504670;Ne;0;1;0;1
10527;Salininkų;DRUGELIAI;7063718023;Ne;9;0;0;9
10528;Salininkų;DRUGELIAI;9018366347;Ne;11;0;0;11
10529;Salininkų;ŽIRNIUKAI;7643665643;Ne;5;6;0;11
10530;Salininkų;ŽIRNIUKAI;9198411540;Ne;2;4;0;6
10531;Salininkų;ŽIRNIUKAI;6885580632;Ne;7;4;0;11
10532;Salininkų;ŽIRNIUKAI;7409604480;Ne;0;11;0;11
10533;Salininkų;ŽIRNIUKAI;3677558828;Ne;0;7;0;7
10534;Salininkų;ŽIRNIUKAI;8095820690;Ne;11;0;0;11
10535;Salininkų;ŽIRNIUKAI;6482437251;Ne;3;0;0;3
10536;Salininkų;ŽIRNIUKAI;1380797788;Ne;19;0;0;19
10537;Salininkų;ŽIRNIUKAI;2495782496;Ne;11;2;0;13
10538;Salininkų;ŽIRNIUKAI;9896357816;Ne;10;4;0;14
10539;Salininkų;ŽIRNIUKAI;4568462071;Ne;8;0;0;8
10540;Salininkų;ŽIRNIUKAI;9137783249;Ne;4;1;0;5
10541;Salininkų;ŽIRNIUKAI;8524400656;Ne;4;1;0;5
10542;Salininkų;ŽIRNIUKAI;7463713798;Ne;13;1;0;14
10543;Salininkų;ŽIRNIUKAI;1111197633;Ne;2;3;0;5
10544;Salininkų;ŽIRNIUKAI;6143967744;Ne;9;0;0;9
10545;Salininkų;ŽIRNIUKAI;8552427446;Ne;5;0;0;5
10546;Salininkų;ŽIRNIUKAI;6586988786;Ne;14;0;0;14
10547;Salininkų;ŽIRNIUKAI;1587485662;Ne;8;0;0;8
10548;Salininkų;ŽIRNIUKAI;9611858211;Ne;5;0;0;5
10549;Salininkų;PAUKŠČIUKAI;2895782373;Ne;0;6;0;6
10550;Salininkų;PAUKŠČIUKAI;4971070998;Ne;3;0;0;3
10551;Salininkų;PAUKŠČIUKAI;9893985732;Ne;10;5;0;15
10552;Salininkų;PAUKŠČIUKAI;1284909139;Ne;8;2;0;10
10553;Salininkų;PAUKŠČIUKAI;3686372180;Ne;0;0;5;5
10554;Salininkų;PAUKŠČIUKAI;9892443649;Ne;0;5;0;5
10555;Salininkų;PAUKŠČIUKAI;5164367382;Ne;13;2;1;16
10556;Salininkų;PAUKŠČIUKAI;3703729963;Ne;0;2;2;4
10557;Salininkų;PAUKŠČIUKAI;3338213592;Ne;10;1;0;11
10558;Salininkų;PAUKŠČIUKAI;6506819265;Ne;0;5;0;5
10559;Salininkų;PAUKŠČIUKAI;6510096414;Ne;0;10;0;10
10560;Salininkų;PAUKŠČIUKAI;9482632726;Ne;0;1;0;1
10561;Salininkų;PAUKŠČIUKAI;2491796874;Ne;0;0;3;3
10562;Salininkų;PAUKŠČIUKAI;3464228778;Ne;8;0;0;8
10563;Salininkų;PAUKŠČIUKAI;2440831687;Ne;11;5;0;16
10564;Salininkų;PAUKŠČIUKAI;2726813574;Ne;4;2;0;6
10565;Salininkų;PAUKŠČIUKAI;8141168894;Ne;7;0;0;7
10566;Salininkų;PAUKŠČIUKAI;2798153926;Ne;0;2;0;2
10567;Salininkų;PAUKŠČIUKAI;8602489420;Ne;0;9;0;9
10568;Salininkų;PAUKŠČIUKAI;1453214735;Ne;10;2;0;12
10569;Salininkų;PAUKŠČIUKAI;8336855920;Ne;0;2;1;3
10570;Salininkų;BITUTĖS;3252151974;Ne;0;2;1;3
10571;Salininkų;BITUTĖS;6845471044;Ne;10;0;2;12
10572;Salininkų;BITUTĖS;2467926286;Ne;2;5;0;7
10573;Salininkų;BITUTĖS;9902751686;Ne;2;6;0;8
10574;Salininkų;BITUTĖS;6125152143;Ne;0;4;0;4
10575;Salininkų;BITUTĖS;2095952937;Ne;0;4;0;4
10576;Salininkų;BITUTĖS;6551489987;Taip;1;4;0;5
10577;Salininkų;BITUTĖS;3527495230;Ne;0;3;0;3
10578;Salininkų;BITUTĖS;5582091833;Ne;0;4;0;4
10579;Salininkų;BITUTĖS;2073939432;Taip;4;0;0;4
10580;Salininkų;BITUTĖS;9996809930;Taip;14;0;0;14
10581;Salininkų;BITUTĖS;8992580214;Ne;0;11;0;11
10582;Salininkų;BITUTĖS;3915336062;Ne;15;4;0;19
10583;Salininkų;BITUTĖS;7115888747;Ne;0;2;0;2
10584;Salininkų;BITUTĖS;7639362434;Ne;3;3;0;6
10585;Salininkų;BITUTĖS;2370778977;Ne;2;1;2;5
10586;Salininkų;BITUTĖS;1020073382;Ne;6;1;1;8
10587;Salininkų;BITUTĖS;4480303856;Ne;10;4;0;14
10588;Salininkų;BITUTĖS;7383557807;Ne;0;13;0;13
10589;Salvija;Daigelis(šatil);8337554678;Ne;6;4;0;10
10590;Salvija;Daigelis(šatil);6323383244;Ne;12;0;0;12
10591;Salvija;Daigelis(šatil);3857916185;Ne;2;4;3;9
10592;Salvija;Daigelis(šatil);1168900211;Ne;3;0;2;5
10593;Salvija;Daigelis(šatil);7410091250;Ne;0;3;0;3
10594;Salvija;Daigelis(šatil);5761622263;Ne;0;1;1;2
10595;Salvija;Daigelis(šatil);6797777730;Ne;2;3;1;6
10596;Salvija;Daigelis(šatil);1850688392;Ne;10;0;0;10
10597;Salvija;Daigelis(šatil);2959140033;Ne;0;4;0;4
10598;Salvija;Daigelis(šatil);9129939185;Ne;0;2;0;2
10599;Salvija;Daigelis(šatil);3856024521;Ne;0;2;0;2
10600;Salvija;Daigelis(šatil);2161008233;Ne;5;1;1;7
10601;Salvija;Daigelis(šatil);6690635579;Ne;0;3;0;3
10602;Salvija;Daigelis(šatil);6260496597;Ne;15;0;1;16
10603;Salvija;Daigelis(šatil);1019409172;Ne;0;0;1;1
10604;Salvija;Daigelis(šatil);1585988377;Ne;0;0;1;1
10605;Salvija;"Pienė (savjon)";8981331532;Ne;9;0;0;9
10606;Salvija;"Pienė (savjon)";8013023311;Ne;1;2;0;3
10607;Salvija;"Pienė (savjon)";4325636377;Ne;0;1;0;1
10608;Salvija;"Pienė (savjon)";7477171133;Ne;4;1;0;5
10609;Salvija;"Pienė (savjon)";6706565915;Ne;5;0;0;5
10610;Salvija;"Pienė (savjon)";8853389268;Ne;0;4;0;4
10611;Salvija;"Pienė (savjon)";3856351749;Ne;6;2;0;8
10612;Salvija;"Pienė (savjon)";7862619996;Ne;0;5;1;6
10613;Salvija;"Pienė (savjon)";3487446998;Ne;0;2;0;2
10614;Salvija;"Pienė (savjon)";4373711097;Ne;0;1;0;1
10615;Salvija;"Pienė (savjon)";9456556523;Ne;0;2;0;2
10616;Salvija;"Pienė (savjon)";5816893736;Ne;7;1;1;9
10617;Salvija;"Pienė (savjon)";1975032693;Ne;0;1;0;1
10618;Salvija;"Pienė (savjon)";5327735648;Ne;0;12;0;12
10619;Salvija;"Pienė (savjon)";4665919836;Ne;0;4;0;4
10620;Salvija;"Pienė (savjon)";4577248630;Ne;12;0;0;12
10621;Salvija;"Pienė (savjon)";1509182157;Ne;5;0;0;5
10622;Salvija;"Pienė (savjon)";1062662192;Ne;2;3;0;5
10623;Salvija;"Pienė (savjon)";9978634888;Ne;5;5;0;10
10624;Salvija;"Pienė (savjon)";1511271658;Ne;0;2;0;2
10625;Salvija;"Pienė (savjon)";3640213912;Ne;1;0;0;1
10626;Salvija;"Pienė (savjon)";1676795179;Ne;6;3;0;9
10627;Saulėtekis;BERŽELIS;3493175211;Ne;0;8;0;8
10628;Saulėtekis;BERŽELIS;8086451893;Ne;2;0;1;3
10629;Saulėtekis;BERŽELIS;9351122147;Ne;6;0;0;6
10630;Saulėtekis;BERŽELIS;6667804855;Ne;0;4;0;4
10631;Saulėtekis;BERŽELIS;5468364505;Ne;3;0;0;3
10632;Saulėtekis;BERŽELIS;4704426104;Ne;9;0;0;9
10633;Saulėtekis;BERŽELIS;7407540257;Ne;1;0;2;3
10634;Saulėtekis;BERŽELIS;6920619390;Ne;2;0;0;2
10635;Saulėtekis;BERŽELIS;5194925689;Ne;5;4;0;9
10636;Saulėtekis;BERŽELIS;2672108464;Ne;3;4;0;7
10637;Saulėtekis;BERŽELIS;9579088485;Ne;0;3;0;3
10638;Saulėtekis;BERŽELIS;7436158953;Ne;5;4;1;10
10639;Saulėtekis;BERŽELIS;7165739418;Ne;0;4;1;5
10640;Saulėtekis;BERŽELIS;1917500190;Ne;5;4;0;9
10641;Saulėtekis;BERŽELIS;2935641362;Ne;10;9;0;19
10642;Saulėtekis;BERŽELIS;4676218435;Ne;0;0;1;1
10643;Saulėtekis;BERŽELIS;7598254324;Ne;19;0;0;19
10644;Saulėtekis;BERŽELIS;6026600803;Ne;3;0;0;3
10645;Saulėtekis;BERŽELIS;8468491266;Ne;3;4;0;7
10646;Saulėtekis;BERŽELIS;6181992249;Ne;3;0;1;4
10647;Saulėtekis;BERŽELIS;5824537129;Ne;10;3;6;19
10648;Saulėtekis;BERŽELIS;8427457478;Ne;6;0;0;6
10649;Saulėtekis;ŠYPSENA;1198692142;Ne;8;0;0;8
10650;Saulėtekis;ŠYPSENA;8331205443;Ne;15;3;0;18
10651;Saulėtekis;ŠYPSENA;4975294724;Ne;16;0;1;17
10652;Saulėtekis;ŠYPSENA;2946991447;Ne;2;0;2;4
10653;Saulėtekis;ŠYPSENA;7780877703;Ne;3;0;1;4
10654;Saulėtekis;ŠYPSENA;2282128335;Ne;11;0;0;11
10655;Saulėtekis;ŠYPSENA;7759917109;Ne;0;0;3;3
10656;Saulėtekis;ŠYPSENA;3306250980;Taip;11;0;0;11
10657;Saulėtekis;ŠYPSENA;4391887095;Ne;0;1;1;2
10658;Saulėtekis;ŠYPSENA;1278985938;Ne;5;0;0;5
10659;Saulėtekis;ŠYPSENA;4765756650;Ne;13;0;0;13
10660;Saulėtekis;ŠYPSENA;8173628625;Ne;0;2;3;5
10661;Saulėtekis;ŠYPSENA;1237869114;Ne;3;0;1;4
10662;Saulėtekis;ŠYPSENA;1515580716;Ne;10;0;0;10
10663;Saulėtekis;ŠYPSENA;6831161042;Ne;10;0;0;10
10664;Saulėtekis;ŠYPSENA;4433821698;Ne;4;0;0;4
10665;Saulėtekis;NYKŠTUKAI;1896847801;Ne;5;0;0;5
10666;Saulėtekis;NYKŠTUKAI;7849181976;Ne;1;0;0;1
10667;Saulėtekis;NYKŠTUKAI;5748816813;Ne;8;0;0;8
10668;Saulėtekis;NYKŠTUKAI;7555273745;Ne;8;0;0;8
10669;Saulėtekis;NYKŠTUKAI;1416983683;Ne;3;4;0;7
10670;Saulėtekis;NYKŠTUKAI;4758423356;Ne;1;4;0;5
10671;Saulėtekis;NYKŠTUKAI;9270109327;Ne;1;4;0;5
10672;Saulėtekis;NYKŠTUKAI;5183297420;Ne;12;4;0;16
10673;Saulėtekis;NYKŠTUKAI;8007704080;Ne;2;4;0;6
10674;Saulėtekis;NYKŠTUKAI;8683571534;Ne;4;0;0;4
10675;Saulėtekis;NYKŠTUKAI;9481578412;Ne;15;0;0;15
10676;Saulėtekis;NYKŠTUKAI;8167740525;Ne;14;0;0;14
10677;Saulėtekis;NYKŠTUKAI;7273354670;Ne;9;0;0;9
10678;Saulėtekis;NYKŠTUKAI;3371045145;Ne;2;0;0;2
10679;Saulėtekis;NYKŠTUKAI;9818660340;Ne;15;4;0;19
10680;Saulėtekis;NYKŠTUKAI;3729811521;Ne;4;0;0;4
10681;Saulėtekis;NYKŠTUKAI;5888979911;Ne;5;0;0;5
10682;Saulėtekis;NYKŠTUKAI;8090571664;Ne;0;4;0;4
10683;Saulėtekis;NYKŠTUKAI;9104549419;Ne;1;0;0;1
10684;Saulėtekis;NYKŠTUKAI;3957655772;Ne;6;4;0;10
10685;Saulėtekis;NYKŠTUKAI;1331793286;Ne;15;0;0;15
10686;Saulėtekis;NYKŠTUKAI;8927598999;Ne;18;0;0;18
10687;Saulėtekis;PAGRANDUKAS;8098047919;Ne;3;2;1;6
10688;Saulėtekis;PAGRANDUKAS;8240764949;Ne;3;0;2;5
10689;Saulėtekis;PAGRANDUKAS;5970957754;Ne;1;3;0;4
10690;Saulėtekis;PAGRANDUKAS;5252265065;Taip;16;0;0;16
10691;Saulėtekis;PAGRANDUKAS;3903728416;Ne;0;4;0;4
10692;Saulėtekis;PAGRANDUKAS;3096623181;Ne;8;0;0;8
10693;Saulėtekis;PAGRANDUKAS;6029401583;Ne;11;4;0;15
10694;Saulėtekis;PAGRANDUKAS;5321135231;Ne;4;5;0;9
10695;Saulėtekis;PAGRANDUKAS;6008705995;Ne;10;4;0;14
10696;Saulėtekis;PAGRANDUKAS;5173602064;Ne;0;2;0;2
10697;Saulėtekis;PAGRANDUKAS;3142594542;Ne;0;2;0;2
10698;Saulėtekis;PAGRANDUKAS;1734813803;Ne;0;0;1;1
10699;Saulėtekis;PAGRANDUKAS;6966791665;Ne;2;4;0;6
10700;Saulėtekis;PAGRANDUKAS;7293735126;Ne;2;4;0;6
10701;Saulėtekis;PAGRANDUKAS;4066394876;Ne;2;4;1;7
10702;Saulėtekis;PAGRANDUKAS;9575338070;Ne;1;0;3;4
10703;Saulėtekis;RAMUNĖLIŲ;8739919774;Ne;7;1;0;8
10704;Saulėtekis;RAMUNĖLIŲ;4681031693;Ne;0;0;3;3
10705;Saulėtekis;RAMUNĖLIŲ;2316817605;Ne;0;4;0;4
10706;Saulėtekis;RAMUNĖLIŲ;3987535802;Ne;4;4;0;8
10707;Saulėtekis;RAMUNĖLIŲ;5297650157;Ne;0;7;0;7
10708;Saulėtekis;RAMUNĖLIŲ;6979741482;Ne;1;4;0;5
10709;Saulėtekis;RAMUNĖLIŲ;8348456528;Ne;7;4;0;11
10710;Saulėtekis;RAMUNĖLIŲ;3430209353;Ne;11;0;0;11
10711;Saulėtekis;RAMUNĖLIŲ;5980690239;Ne;1;4;0;5
10712;Saulėtekis;RAMUNĖLIŲ;2786112846;Ne;5;4;0;9
10713;Saulėtekis;RAMUNĖLIŲ;8876580678;Ne;5;4;0;9
10714;Saulėtekis;RAMUNĖLIŲ;1427323748;Ne;8;0;0;8
10715;Saulėtekis;RAMUNĖLIŲ;3224110585;Ne;10;4;0;14
10716;Saulėtekis;RAMUNĖLIŲ;2002180753;Ne;11;4;0;15
10717;Saulėtekis;RAMUNĖLIŲ;5685176596;Ne;0;1;1;2
10718;Saulėtekis;RAMUNĖLIŲ;9668125862;Ne;1;3;0;4
10719;Saulėtekis;RAMUNĖLIŲ;4736430248;Ne;6;4;0;10
10720;Saulėtekis;RAMUNĖLIŲ;1108736588;Ne;9;0;0;9
10721;Saulėtekis;RAMUNĖLIŲ;3680199463;Ne;0;4;2;6
10722;Saulėtekis;RAMUNĖLIŲ;2383861394;Ne;2;7;0;9
10723;Saulėtekis;RAMUNĖLIŲ;2872732978;Ne;3;0;0;3
10724;Saulėtekis;RAMUNĖLIŲ;9732352141;Ne;13;4;0;17
10725;Saulėtekis;RAMUNĖLIŲ;7494641077;Ne;0;3;0;3
10726;Saulėtekis;RAMUNĖLIŲ;1577609727;Ne;0;3;0;3
10727;Saulėtekis;PASAKAITĖ;8033763960;Ne;1;4;0;5
10728;Saulėtekis;PASAKAITĖ;9428709415;Ne;1;2;0;3
10729;Saulėtekis;PASAKAITĖ;5086871001;Ne;0;4;0;4
10730;Saulėtekis;PASAKAITĖ;2446282019;Ne;0;2;0;2
10731;Saulėtekis;PASAKAITĖ;8572701238;Ne;0;3;0;3
10732;Saulėtekis;PASAKAITĖ;6063956790;Ne;2;5;0;7
10733;Saulėtekis;PASAKAITĖ;4437540996;Ne;13;0;0;13
10734;Saulėtekis;PASAKAITĖ;7407451018;Ne;0;3;0;3
10735;Saulėtekis;PASAKAITĖ;9226317303;Ne;2;6;0;8
10736;Saulėtekis;PASAKAITĖ;9267790598;Ne;6;4;0;10
10737;Saulėtekis;PASAKAITĖ;6670590135;Ne;10;0;0;10
10738;Saulėtekis;PASAKAITĖ;6720758829;Ne;4;0;0;4
10739;Saulėtekis;PASAKAITĖ;7966714585;Ne;0;4;0;4
10740;Saulėtekis;PASAKAITĖ;3224883243;Ne;11;0;0;11
10741;Saulėtekis;PASAKAITĖ;9382031144;Ne;5;5;0;10
10742;Saulėtekis;PASAKAITĖ;3371914339;Ne;5;4;0;9
10743;Saulėtekis;PASAKAITĖ;6214539956;Ne;7;4;0;11
10744;Saulėtekis;PASAKAITĖ;9584556476;Ne;2;6;0;8
10745;Saulėtekis;PASAKAITĖ;9799880235;Ne;0;5;0;5
10746;Saulėtekis;PASAKAITĖ;2469458604;Ne;0;1;0;1
10747;Saulėtekis;PASAKAITĖ;3499575148;Ne;0;3;0;3
10748;Saulėtekis;PASAKAITĖ;2206038658;Ne;0;4;0;4
10749;Saulėtekis;PASAKAITĖ;7826554599;Ne;6;0;0;6
10750;Saulėtekis;VARPELIAI;3303064486;Ne;15;0;0;15
10751;Saulėtekis;VARPELIAI;1355354514;Ne;5;0;2;7
10752;Saulėtekis;VARPELIAI;8195320453;Ne;9;0;0;9
10753;Saulėtekis;VARPELIAI;5997903066;Ne;9;0;1;10
10754;Saulėtekis;VARPELIAI;9383203972;Ne;8;0;0;8
10755;Saulėtekis;VARPELIAI;5870177112;Ne;2;3;0;5
10756;Saulėtekis;VARPELIAI;7171550857;Ne;5;0;0;5
10757;Saulėtekis;VARPELIAI;3157110037;Ne;6;2;1;9
10758;Saulėtekis;VARPELIAI;8331659142;Ne;2;0;0;2
10759;Saulėtekis;VARPELIAI;1479530265;Ne;5;4;1;10
10760;Saulėtekis;VARPELIAI;1164913351;Taip;1;4;1;6
10761;Saulėtekis;VARPELIAI;3499215193;Ne;5;0;0;5
10762;Saulėtekis;VARPELIAI;5165684803;Ne;9;0;2;11
10763;Saulėtekis;VARPELIAI;3780019474;Ne;14;0;0;14
10764;Saulėtekis;VARPELIAI;9615110873;Ne;7;0;0;7
10765;Saulėtekis;VARPELIAI;7423380888;Ne;9;0;3;12
10766;Saulėtekis;VARPELIAI;2621773226;Ne;9;0;0;9
10767;Saulėtekis;VARPELIAI;4592401190;Ne;6;0;0;6
10768;Saulėtekis;VARPELIAI;3832717108;Ne;5;4;0;9
10769;Saulėtekis;VARPELIAI;1240595768;Ne;6;0;0;6
10770;Saulėtekis;GRŪDELIS;1864236745;Ne;8;4;1;13
10771;Saulėtekis;GRŪDELIS;7171048750;Ne;5;1;1;7
10772;Saulėtekis;GRŪDELIS;6535620172;Ne;10;0;0;10
10773;Saulėtekis;GRŪDELIS;8252953405;Taip;9;3;0;12
10774;Saulėtekis;GRŪDELIS;8219644557;Ne;0;3;1;4
10775;Saulėtekis;GRŪDELIS;5161940030;Ne;6;0;5;11
10776;Saulėtekis;GRŪDELIS;5218345414;Ne;0;1;0;1
10777;Saulėtekis;GRŪDELIS;9646060606;Ne;5;2;0;7
10778;Saulėtekis;GRŪDELIS;1934900185;Ne;10;0;0;10
10779;Saulėtekis;GRŪDELIS;9995919137;Ne;5;3;0;8
10780;Saulėtekis;GRŪDELIS;6928825133;Ne;9;1;1;11
10781;Saulėtekis;GRŪDELIS;8138047893;Ne;0;4;0;4
10782;Saulėtekis;GRŪDELIS;3953501167;Ne;9;4;0;13
10783;Saulėtekis;GRŪDELIS;2646213073;Ne;0;5;0;5
10784;Saulėtekis;GRŪDELIS;6482182524;Ne;5;3;0;8
10785;Saulėtekis;GRŪDELIS;6779891385;Ne;6;4;1;11
10786;Saulėtekis;GRŪDELIS;9743690247;Ne;8;0;1;9
10787;Saulėtekis;GRŪDELIS;7666624373;Ne;1;0;4;5
10788;Saulėtekis;GRŪDELIS;8061477303;Ne;6;4;0;10
10789;Saulėtekis;GRŪDELIS;2568544418;Ne;0;0;5;5
10790;Saulėtekis;GRŪDELIS;9734188792;Ne;6;4;0;10
10791;Saulėtekis;GRŪDELIS;6983324115;Ne;0;4;1;5
10792;Saulėtekis;GRŪDELIS;9787534807;Ne;8;0;1;9
10793;Saulėtekis;JONVABALIS;8239855620;Ne;0;4;0;4
10794;Saulėtekis;JONVABALIS;8603952810;Ne;10;4;0;14
10795;Saulėtekis;JONVABALIS;8881524909;Ne;10;4;0;14
10796;Saulėtekis;JONVABALIS;7673965242;Ne;7;4;0;11
10797;Saulėtekis;JONVABALIS;7730889108;Ne;15;4;0;19
10798;Saulėtekis;JONVABALIS;2686041419;Ne;3;7;0;10
10799;Saulėtekis;JONVABALIS;3166959569;Ne;2;5;0;7
10800;Saulėtekis;JONVABALIS;9972687066;Ne;0;9;0;9
10801;Saulėtekis;JONVABALIS;9661075465;Ne;0;2;0;2
10802;Saulėtekis;JONVABALIS;7346852524;Ne;0;3;0;3
10803;Saulėtekis;JONVABALIS;5518726567;Ne;0;3;0;3
10804;Saulėtekis;JONVABALIS;6072030240;Ne;0;6;0;6
10805;Saulėtekis;JONVABALIS;7435424899;Ne;15;4;0;19
10806;Saulėtekis;JONVABALIS;2177470008;Ne;0;9;0;9
10807;Saulėtekis;JONVABALIS;7893982893;Ne;0;4;0;4
10808;Saulėtekis;JONVABALIS;7803735686;Ne;6;4;0;10
10809;Saulėtekis;JONVABALIS;7505040675;Ne;0;4;0;4
10810;Saulėtekis;JONVABALIS;8143793642;Ne;0;5;0;5
10811;Saulėtekis;JONVABALIS;1720125332;Ne;0;4;0;4
10812;Saulėtekis;JONVABALIS;9694119292;Ne;10;4;0;14
10813;Saulėtekis;JONVABALIS;9791926936;Ne;0;6;0;6
10814;Saulėtekis;JONVABALIS;6608831217;Ne;0;5;0;5
10815;Saulėtekis;JONVABALIS;8023603198;Ne;8;4;0;12
10816;Saulėtekis;SMALSUČIAI;9941731250;Ne;0;3;0;3
10817;Saulėtekis;SMALSUČIAI;8102360466;Ne;1;4;0;5
10818;Saulėtekis;SMALSUČIAI;2371396923;Ne;3;4;0;7
10819;Saulėtekis;SMALSUČIAI;1020209414;Ne;4;4;0;8
10820;Saulėtekis;SMALSUČIAI;8745921541;Ne;3;4;0;7
10821;Saulėtekis;SMALSUČIAI;2728836108;Ne;4;4;1;9
10822;Saulėtekis;SMALSUČIAI;7164579375;Ne;2;4;0;6
10823;Saulėtekis;SMALSUČIAI;4038684284;Ne;4;4;0;8
10824;Saulėtekis;SMALSUČIAI;8390615573;Ne;1;4;0;5
10825;Saulėtekis;SMALSUČIAI;4152255439;Ne;3;4;0;7
10826;Saulėtekis;SMALSUČIAI;8574702901;Ne;6;4;0;10
10827;Saulėtekis;SMALSUČIAI;7186085219;Ne;0;4;2;6
10828;Saulėtekis;SMALSUČIAI;2209156661;Ne;0;4;0;4
10829;Saulėtekis;SMALSUČIAI;5552614092;Ne;0;4;0;4
10830;Saulėtekis;SMALSUČIAI;9497129509;Ne;5;1;1;7
10831;Saulėtekis;SMALSUČIAI;3366064429;Ne;2;4;0;6
10832;Saulėtekis;SMALSUČIAI;9870595577;Ne;6;4;0;10
10833;Saulėtekis;SMALSUČIAI;7766084857;Ne;0;4;1;5
10834;Saulėtekis;SMALSUČIAI;2154590089;Ne;0;3;0;3
10835;Saulėtekis;SMALSUČIAI;3220993253;Ne;4;4;0;8
10836;Saulėtekis;SMALSUČIAI;2698535938;Ne;0;4;0;4
10837;Saulėtekis;SMALSUČIAI;8517049464;Ne;0;2;0;2
10838;Saulėtekis;SMALSUČIAI;8620689981;Ne;3;4;0;7
10839;Saulėtekis;BITUTĖS;4252302344;Ne;0;3;0;3
10840;Saulėtekis;BITUTĖS;9382796391;Ne;7;0;0;7
10841;Saulėtekis;BITUTĖS;2095103400;Ne;7;0;0;7
10842;Saulėtekis;BITUTĖS;7614555277;Ne;10;0;0;10
10843;Saulėtekis;BITUTĖS;7308749675;Ne;6;6;0;12
10844;Saulėtekis;BITUTĖS;3898675190;Ne;4;0;0;4
10845;Saulėtekis;BITUTĖS;4135680619;Ne;0;4;0;4
10846;Saulėtekis;BITUTĖS;3768954974;Ne;9;0;1;10
10847;Saulėtekis;BITUTĖS;2939151459;Ne;3;0;0;3
10848;Saulėtekis;BITUTĖS;8522059028;Ne;2;0;0;2
10849;Saulėtekis;BITUTĖS;2790163936;Ne;1;3;0;4
10850;Saulėtekis;BITUTĖS;9649078106;Taip;2;0;1;3
10851;Saulėtekis;BITUTĖS;9892315045;Ne;6;3;0;9
10852;Saulėtekis;BITUTĖS;8890060293;Ne;1;1;0;2
10853;Saulėtekis;BITUTĖS;3954368962;Ne;2;0;2;4
10854;Saulėtekis;BITUTĖS;3349025533;Ne;10;0;0;10
10855;Saulėtekis;BITUTĖS;6468360941;Ne;16;0;0;16
10856;Saulėtekis;RIEŠUTĖLIAI;8767786444;Ne;6;3;0;9
10857;Saulėtekis;RIEŠUTĖLIAI;2224626144;Ne;2;0;0;2
10858;Saulėtekis;RIEŠUTĖLIAI;9270231819;Ne;0;2;0;2
10859;Saulėtekis;RIEŠUTĖLIAI;5898051775;Ne;2;2;0;4
10860;Saulėtekis;RIEŠUTĖLIAI;7898928446;Ne;4;1;0;5
10861;Saulėtekis;RIEŠUTĖLIAI;3356705340;Ne;6;0;0;6
10862;Saulėtekis;RIEŠUTĖLIAI;7824492464;Ne;4;0;4;8
10863;Saulėtekis;RIEŠUTĖLIAI;3935935671;Ne;0;1;0;1
10864;Saulėtekis;RIEŠUTĖLIAI;7807096583;Ne;0;0;7;7
10865;Saulėtekis;RIEŠUTĖLIAI;2548612572;Ne;4;4;1;9
10866;Saulėtekis;RIEŠUTĖLIAI;2908714227;Ne;18;0;0;18
10867;Saulėtekis;RIEŠUTĖLIAI;7305619721;Ne;0;0;15;15
10868;Saulėtekis;RIEŠUTĖLIAI;9516841263;Ne;0;0;4;4
10869;Saulėtekis;RIEŠUTĖLIAI;6557482092;Ne;0;2;1;3
10870;Saulėtekis;RIEŠUTĖLIAI;6183384994;Taip;5;3;0;8
10871;Saulėtekis;RIEŠUTĖLIAI;1540848694;Ne;3;3;0;6
10872;Saulėtekis;RIEŠUTĖLIAI;3559882322;Ne;0;2;1;3
10873;Saulėtekis;RIEŠUTĖLIAI;4767842376;Taip;4;0;4;8
10874;Saulėtekis;RIEŠUTĖLIAI;9351147084;Ne;9;0;5;14
10875;Saulėtekis;RIEŠUTĖLIAI;4413014466;Ne;0;2;0;2
10876;Saulėtekis;RIEŠUTĖLIAI;9246555859;Ne;0;2;1;3
10877;Saulėtekis;RIEŠUTĖLIAI;7338301696;Ne;7;5;0;12
10878;Saulėtekis;RIEŠUTĖLIAI;3206247299;Ne;0;4;2;6
10879;Skroblinukas;SVIRPLIUKŲ;2195112297;Ne;15;0;6;21
10880;Skroblinukas;SVIRPLIUKŲ;4198512202;Ne;11;0;6;17
10881;Skroblinukas;SVIRPLIUKŲ;7750501815;Ne;7;0;4;11
10882;Skroblinukas;SVIRPLIUKŲ;4960825597;Ne;0;4;0;4
10883;Skroblinukas;SVIRPLIUKŲ;1544598440;Ne;5;7;0;12
10884;Skroblinukas;SVIRPLIUKŲ;6574558658;Ne;2;3;1;6
10885;Skroblinukas;SVIRPLIUKŲ;4861971439;Ne;0;2;3;5
10886;Skroblinukas;SVIRPLIUKŲ;7817632987;Ne;10;6;0;16
10887;Skroblinukas;SVIRPLIUKŲ;7675772872;Ne;3;6;0;9
10888;Skroblinukas;SVIRPLIUKŲ;4266945644;Taip;0;0;7;7
10889;Skroblinukas;SVIRPLIUKŲ;7216760382;Ne;4;0;0;4
10890;Skroblinukas;SVIRPLIUKŲ;5154111867;Ne;0;4;0;4
10891;Skroblinukas;SVIRPLIUKŲ;8622930871;Ne;22;0;2;24
10892;Skroblinukas;SVIRPLIUKŲ;9661609284;Ne;5;0;0;5
10893;Skroblinukas;SVIRPLIUKŲ;3260267388;Ne;0;10;0;10
10894;Skroblinukas;SVIRPLIUKŲ;7761972818;Ne;0;6;0;6
10895;Skroblinukas;SVIRPLIUKŲ;9629502585;Ne;2;5;0;7
10896;Skroblinukas;SVIRPLIUKŲ;6461678336;Ne;4;0;2;6
10897;Skroblinukas;SVIRPLIUKŲ;8283516422;Ne;9;0;2;11
10898;Skroblinukas;GANDRIUKŲ;2197158518;Ne;0;4;1;5
10899;Skroblinukas;GANDRIUKŲ;2406619611;Ne;0;6;0;6
10900;Skroblinukas;GANDRIUKŲ;5646847921;Ne;1;10;0;11
10901;Skroblinukas;GANDRIUKŲ;1851920334;Ne;0;8;0;8
10902;Skroblinukas;GANDRIUKŲ;9377215921;Ne;6;13;0;19
10903;Skroblinukas;GANDRIUKŲ;6235844690;Ne;0;6;0;6
10904;Skroblinukas;GANDRIUKŲ;6489976163;Ne;5;6;1;12
10905;Skroblinukas;GANDRIUKŲ;1159546580;Ne;0;8;2;10
10906;Skroblinukas;GANDRIUKŲ;2630699296;Ne;0;4;0;4
10907;Skroblinukas;GANDRIUKŲ;2310750833;Ne;0;8;0;8
10908;Skroblinukas;GANDRIUKŲ;9888115079;Ne;0;5;0;5
10909;Skroblinukas;GANDRIUKŲ;9475514959;Ne;0;13;0;13
10910;Skroblinukas;GANDRIUKŲ;9031598603;Ne;0;6;0;6
10911;Skroblinukas;GANDRIUKŲ;5251903769;Ne;9;11;0;20
10912;Skroblinukas;GANDRIUKŲ;7385271438;Ne;0;6;3;9
10913;Skroblinukas;GANDRIUKŲ;7274368180;Ne;0;4;0;4
10914;Skroblinukas;GANDRIUKŲ;9541682085;Ne;0;6;0;6
10915;Skroblinukas;GANDRIUKŲ;1369962422;Ne;5;6;0;11
10916;Skroblinukas;VYTURIUKŲ;3954228349;Ne;0;0;8;8
10917;Skroblinukas;VYTURIUKŲ;4560580022;Ne;0;2;0;2
10918;Skroblinukas;VYTURIUKŲ;2330232287;Ne;0;0;1;1
10919;Skroblinukas;VYTURIUKŲ;3065235192;Taip;7;4;0;11
10920;Skroblinukas;VYTURIUKŲ;5902713448;Ne;6;8;0;14
10921;Skroblinukas;VYTURIUKŲ;3594000419;Ne;0;4;0;4
10922;Skroblinukas;VYTURIUKŲ;3512297435;Ne;0;4;0;4
10923;Skroblinukas;VYTURIUKŲ;2481980627;Ne;13;6;0;19
10924;Skroblinukas;VYTURIUKŲ;9725125130;Taip;3;4;0;7
10925;Skroblinukas;VYTURIUKŲ;2978284436;Ne;3;0;2;5
10926;Skroblinukas;VYTURIUKŲ;7068452970;Ne;7;2;0;9
10927;Skroblinukas;VYTURIUKŲ;3292517112;Ne;4;4;0;8
10928;Skroblinukas;VYTURIUKŲ;4129726208;Ne;0;0;3;3
10929;Skroblinukas;VYTURIUKŲ;3351309750;Ne;0;0;1;1
10930;Skroblinukas;VYTURIUKŲ;5101136022;Ne;0;4;1;5
10931;Skroblinukas;VYTURIUKŲ;9828486832;Ne;0;3;0;3
10932;Skroblinukas;VYTURIUKŲ;2263955772;Ne;0;10;0;10
10933;Skroblinukas;VYTURIUKŲ;9731326488;Ne;11;5;0;16
10934;Skroblinukas;GENIUKŲ;6011466024;Ne;0;6;0;6
10935;Skroblinukas;GENIUKŲ;8629189405;Taip;6;1;1;8
10936;Skroblinukas;GENIUKŲ;9809817630;Ne;6;0;1;7
10937;Skroblinukas;GENIUKŲ;8544069746;Ne;3;6;0;9
10938;Skroblinukas;GENIUKŲ;6475609065;Ne;0;0;27;27
10939;Skroblinukas;GENIUKŲ;4091852305;Ne;0;8;1;9
10940;Skroblinukas;GENIUKŲ;1820748152;Ne;5;2;0;7
10941;Skroblinukas;GENIUKŲ;3705638869;Ne;6;0;3;9
10942;Skroblinukas;GENIUKŲ;2511496284;Ne;15;0;0;15
10943;Skroblinukas;GENIUKŲ;7153774246;Ne;0;6;1;7
10944;Skroblinukas;GENIUKŲ;7045587415;Ne;0;0;13;13
10945;Skroblinukas;GENIUKŲ;5946356374;Ne;10;3;8;21
10946;Skroblinukas;GENIUKŲ;5274898590;Ne;6;11;0;17
10947;Skroblinukas;GENIUKŲ;1167332689;Ne;0;3;0;3
10948;Skroblinukas;GENIUKŲ;4491947846;Ne;8;5;0;13
10949;Skroblinukas;GENIUKŲ;7955574061;Ne;5;3;0;8
10950;Skroblinukas;GENIUKŲ;4002729040;Ne;3;1;0;4
10951;Skroblinukas;GENIUKŲ;9162582460;Ne;0;0;3;3
10952;Skroblinukas;GENIUKŲ;1014993354;Ne;6;2;3;11
10953;Skroblinukas;GENIUKŲ;1232121301;Ne;0;3;0;3
10954;Skroblinukas;GENIUKŲ;8680329175;Ne;6;5;0;11
10955;Skroblinukas;BITUČIŲ;4639384934;Ne;3;2;0;5
10956;Skroblinukas;BITUČIŲ;5206925237;Ne;4;0;0;4
10957;Skroblinukas;BITUČIŲ;7581372511;Ne;0;1;0;1
10958;Skroblinukas;BITUČIŲ;6717008836;Ne;0;7;0;7
10959;Skroblinukas;BITUČIŲ;8998236911;Ne;5;5;0;10
10960;Skroblinukas;BITUČIŲ;6791969485;Ne;0;5;1;6
10961;Skroblinukas;BITUČIŲ;2363368201;Ne;19;0;0;19
10962;Skroblinukas;BITUČIŲ;2885814517;Ne;6;4;0;10
10963;Skroblinukas;BITUČIŲ;3689247672;Ne;0;2;1;3
10964;Skroblinukas;BITUČIŲ;5354832150;Ne;0;0;1;1
10965;Skroblinukas;BITUČIŲ;5841866621;Ne;5;0;1;6
10966;Skroblinukas;BITUČIŲ;4688496560;Ne;0;3;0;3
10967;Skroblinukas;BITUČIŲ;9341501143;Ne;5;2;0;7
10968;Skroblinukas;BITUČIŲ;3490684777;Ne;8;1;0;9
10969;Skroblinukas;BITUČIŲ;2717586232;Taip;0;6;0;6
10970;Skroblinukas;BITUČIŲ;4840767748;Ne;4;2;0;6
10971;Skroblinukas;BITUČIŲ;9513546028;Ne;3;10;2;15
10972;Skroblinukas;BITUČIŲ;8715188878;Ne;0;8;1;9
10973;Skroblinukas;BITUČIŲ;7407601996;Ne;3;3;0;6
10974;Skroblinukas;BITUČIŲ;4631657273;Ne;5;0;3;8
10975;Skroblinukas;BITUČIŲ;7255510731;Ne;11;0;1;12
10976;Skroblinukas;BITUČIŲ;5694105568;Ne;5;0;2;7
10977;Skroblinukas;BORUŽĖLIŲ;2523742608;Ne;4;0;2;6
10978;Skroblinukas;BORUŽĖLIŲ;2311459579;Ne;3;0;2;5
10979;Skroblinukas;BORUŽĖLIŲ;7771969055;Ne;0;6;0;6
10980;Skroblinukas;BORUŽĖLIŲ;8711201474;Ne;0;6;0;6
10981;Skroblinukas;BORUŽĖLIŲ;2166244766;Ne;2;5;0;7
10982;Skroblinukas;BORUŽĖLIŲ;7729612420;Ne;24;0;0;24
10983;Skroblinukas;BORUŽĖLIŲ;5082212661;Ne;0;0;2;2
10984;Skroblinukas;BORUŽĖLIŲ;2720763966;Ne;0;0;1;1
10985;Skroblinukas;BORUŽĖLIŲ;4904084567;Ne;0;0;1;1
10986;Skroblinukas;BORUŽĖLIŲ;1357700154;Ne;21;0;0;21
10987;Skroblinukas;BORUŽĖLIŲ;2095608208;Ne;7;0;0;7
10988;Skroblinukas;BORUŽĖLIŲ;7446262781;Ne;15;0;0;15
10989;Skroblinukas;BORUŽĖLIŲ;6005897181;Ne;10;0;2;12
10990;Skroblinukas;BORUŽĖLIŲ;1547123058;Ne;12;2;0;14
10991;Skroblinukas;SKRUZDĖLIUKŲ;5688453546;Ne;0;9;1;10
10992;Skroblinukas;SKRUZDĖLIUKŲ;6890306112;Ne;0;4;0;4
10993;Skroblinukas;SKRUZDĖLIUKŲ;6445065388;Ne;0;11;0;11
10994;Skroblinukas;SKRUZDĖLIUKŲ;3006521657;Ne;0;5;0;5
10995;Skroblinukas;SKRUZDĖLIUKŲ;9448253468;Ne;1;5;0;6
10996;Skroblinukas;SKRUZDĖLIUKŲ;3771045336;Ne;0;5;0;5
10997;Skroblinukas;SKRUZDĖLIUKŲ;4424763028;Ne;7;7;0;14
10998;Skroblinukas;SKRUZDĖLIUKŲ;5252389111;Ne;0;4;0;4
10999;Skroblinukas;SKRUZDĖLIUKŲ;2883593274;Ne;0;5;0;5
11000;Skroblinukas;SKRUZDĖLIUKŲ;7493915017;Ne;0;6;0;6
11001;Skroblinukas;SKRUZDĖLIUKŲ;5157913924;Ne;7;4;0;11
11002;Skroblinukas;SKRUZDĖLIUKŲ;9368764758;Ne;6;6;0;12
11003;Skroblinukas;SKRUZDĖLIUKŲ;8576448571;Ne;6;6;0;12
11004;Skroblinukas;SKRUZDĖLIUKŲ;3290115134;Ne;0;17;0;17
11005;Skroblinukas;SKRUZDĖLIUKŲ;9813249677;Ne;0;3;0;3
11006;Skroblinukas;SKRUZDĖLIUKŲ;2101748012;Ne;0;3;0;3
11007;Skroblinukas;SKRUZDĖLIUKŲ;2706526326;Ne;0;2;0;2
11008;Skroblinukas;SKRUZDĖLIUKŲ;5915278745;Ne;0;5;0;5
11009;Skroblinukas;SKRUZDĖLIUKŲ;6640062847;Ne;3;2;0;5
11010;Skroblinukas;SKRUZDĖLIUKŲ;5433647187;Ne;0;6;0;6
11011;Skroblinukas;ŽVIRBLIUKŲ;3041669079;Ne;9;3;0;12
11012;Skroblinukas;ŽVIRBLIUKŲ;6068248705;Ne;16;0;0;16
11013;Skroblinukas;ŽVIRBLIUKŲ;3117532423;Ne;8;1;3;12
11014;Skroblinukas;ŽVIRBLIUKŲ;8124086303;Ne;7;2;0;9
11015;Skroblinukas;ŽVIRBLIUKŲ;7640540309;Ne;0;9;0;9
11016;Skroblinukas;ŽVIRBLIUKŲ;3858667425;Ne;13;0;1;14
11017;Skroblinukas;ŽVIRBLIUKŲ;1996484086;Ne;10;7;0;17
11018;Skroblinukas;ŽVIRBLIUKŲ;7527177120;Ne;0;9;0;9
11019;Skroblinukas;ŽVIRBLIUKŲ;6135412007;Ne;9;3;1;13
11020;Skroblinukas;ŽVIRBLIUKŲ;2312400921;Ne;6;3;2;11
11021;Skroblinukas;ŽVIRBLIUKŲ;7804920443;Ne;18;2;0;20
11022;Skroblinukas;ŽVIRBLIUKŲ;4197050176;Ne;5;8;0;13
11023;Skroblinukas;ŽVIRBLIUKŲ;4390614970;Taip;16;0;1;17
11024;Skroblinukas;ŽIOGELIŲ;6279909049;Ne;13;0;0;13
11025;Skroblinukas;ŽIOGELIŲ;9737310101;Ne;0;0;1;1
11026;Skroblinukas;ŽIOGELIŲ;8118284793;Ne;17;0;0;17
11027;Skroblinukas;ŽIOGELIŲ;1844211217;Ne;3;0;3;6
11028;Skroblinukas;ŽIOGELIŲ;4266029484;Ne;0;4;0;4
11029;Skroblinukas;ŽIOGELIŲ;9191337531;Ne;16;0;0;16
11030;Skroblinukas;ŽIOGELIŲ;7912986106;Ne;0;0;11;11
11031;Skroblinukas;ŽIOGELIŲ;3909811358;Ne;5;2;0;7
11032;Skroblinukas;ŽIOGELIŲ;7650915045;Ne;3;0;0;3
11033;Skroblinukas;ŽIOGELIŲ;6444788760;Ne;0;4;0;4
11034;Skroblinukas;ŽIOGELIŲ;6070633607;Ne;10;0;0;10
11035;Skroblinukas;STRAZDELIŲ;4799600999;Ne;3;1;0;4
11036;Skroblinukas;STRAZDELIŲ;8898971191;Ne;8;8;0;16
11037;Skroblinukas;STRAZDELIŲ;7480868540;Taip;10;0;1;11
11038;Skroblinukas;STRAZDELIŲ;5804217824;Ne;0;1;0;1
11039;Skroblinukas;STRAZDELIŲ;1762416639;Ne;10;2;0;12
11040;Skroblinukas;STRAZDELIŲ;7483556761;Ne;7;0;1;8
11041;Skroblinukas;STRAZDELIŲ;1306489851;Ne;19;0;4;23
11042;Skroblinukas;STRAZDELIŲ;1846830752;Ne;6;0;1;7
11043;Skroblinukas;STRAZDELIŲ;4500841908;Ne;9;0;0;9
11044;Skroblinukas;STRAZDELIŲ;8734405028;Ne;3;8;0;11
11045;Skroblinukas;STRAZDELIŲ;2132271995;Ne;2;10;0;12
11046;Skroblinukas;STRAZDELIŲ;5781343695;Ne;11;0;3;14
11047;Skroblinukas;STRAZDELIŲ;9524875796;Ne;18;0;1;19
11048;Skroblinukas;STRAZDELIŲ;9753194124;Ne;21;0;0;21
11049;Skroblinukas;DRUGELIŲ;8305867345;Ne;0;4;0;4
11050;Skroblinukas;DRUGELIŲ;7400908711;Ne;14;3;0;17
11051;Skroblinukas;DRUGELIŲ;3889890374;Ne;0;4;0;4
11052;Skroblinukas;DRUGELIŲ;9481718833;Ne;4;0;0;4
11053;Skroblinukas;DRUGELIŲ;8864594520;Ne;5;1;0;6
11054;Skroblinukas;DRUGELIŲ;2772360168;Ne;0;4;0;4
11055;Skroblinukas;DRUGELIŲ;3624518310;Ne;3;2;0;5
11056;Skroblinukas;DRUGELIŲ;4831370981;Ne;0;3;0;3
11057;Skroblinukas;DRUGELIŲ;5957417413;Ne;0;7;0;7
11058;Skroblinukas;DRUGELIŲ;3226115050;Ne;4;0;0;4
11059;Skroblinukas;DRUGELIŲ;2887161771;Ne;4;5;0;9
11060;Skroblinukas;DRUGELIŲ;4737605061;Ne;0;10;2;12
11061;Skroblinukas;DRUGELIŲ;3046542264;Ne;2;4;0;6
11062;Skroblinukas;DRUGELIŲ;8390240445;Ne;5;0;5;10
11063;Skroblinukas;DRUGELIŲ;2948231687;Ne;0;1;1;2
11064;Skroblinukas;DRUGELIŲ;5912771080;Ne;6;4;0;10
11065;Skroblinukas;DRUGELIŲ;7528824951;Ne;3;0;3;6
11066;Skroblinukas;DRUGELIŲ;2987938909;Ne;9;5;0;14
11067;Skroblinukas;DRUGELIŲ;8064713969;Ne;0;2;0;2
11068;Skroblinukas;DRUGELIŲ;8286842648;Ne;0;0;3;3
11069;Skroblinukas;DRUGELIŲ;1453029732;Ne;0;6;0;6
11070;Skroblinukas;PELĖDŽIUKŲ;8953844650;Ne;3;2;0;5
11071;Skroblinukas;PELĖDŽIUKŲ;5813075721;Ne;0;1;0;1
11072;Skroblinukas;PELĖDŽIUKŲ;3646325903;Ne;0;8;0;8
11073;Skroblinukas;PELĖDŽIUKŲ;9292990596;Ne;6;5;0;11
11074;Skroblinukas;PELĖDŽIUKŲ;8202855376;Ne;0;0;27;27
11075;Skroblinukas;PELĖDŽIUKŲ;8312341293;Ne;0;7;1;8
11076;Skroblinukas;PELĖDŽIUKŲ;3658815079;Ne;8;1;0;9
11077;Skroblinukas;PELĖDŽIUKŲ;5418212729;Ne;6;0;1;7
11078;Skroblinukas;PELĖDŽIUKŲ;4168542339;Ne;2;10;0;12
11079;Skroblinukas;PELĖDŽIUKŲ;8958893525;Ne;0;6;5;11
11080;Skroblinukas;PELĖDŽIUKŲ;6675716937;Ne;9;0;0;9
11081;Skroblinukas;PELĖDŽIUKŲ;1009065470;Taip;11;8;0;19
11082;Skroblinukas;PELĖDŽIUKŲ;9553242594;Ne;0;4;0;4
11083;Skroblinukas;PELĖDŽIUKŲ;4802801867;Ne;0;2;0;2
11084;Skroblinukas;PELĖDŽIUKŲ;1758987652;Ne;2;0;1;3
11085;Skroblinukas;PELĖDŽIUKŲ;8465074037;Ne;5;0;3;8
11086;Skroblinukas;PELĖDŽIUKŲ;2071093890;Ne;4;7;0;11
11087;Skroblinukas;PELĖDŽIUKŲ;9523720873;Ne;5;16;0;21
11088;Skroblinukas;PELĖDŽIUKŲ;7920117036;Ne;5;7;0;12
11089;Skroblinukas;PELĖDŽIUKŲ;2215428081;Ne;7;0;2;9
11090;Smalsučiai;Žibuoklės;6535494814;Ne;10;0;1;11
11091;Smalsučiai;Žibuoklės;3309134310;Ne;0;7;0;7
11092;Smalsučiai;Žibuoklės;2326167599;Ne;3;1;0;4
11093;Smalsučiai;Žibuoklės;4094037708;Ne;4;0;3;7
11094;Smalsučiai;Žibuoklės;5893045664;Ne;0;4;0;4
11095;Smalsučiai;Žibuoklės;5482692473;Ne;0;1;1;2
11096;Smalsučiai;Žibuoklės;2742992400;Ne;5;0;4;9
11097;Smalsučiai;Žibuoklės;6299355505;Ne;0;3;0;3
11098;Smalsučiai;Žibuoklės;3877274360;Ne;2;5;0;7
11099;Smalsučiai;Žibuoklės;7726086066;Ne;0;3;0;3
11100;Smalsučiai;Žibuoklės;9988599126;Ne;3;0;1;4
11101;Smalsučiai;Žibuoklės;5489140006;Ne;0;4;0;4
11102;Smalsučiai;Žibuoklės;1380214235;Ne;4;0;0;4
11103;Smalsučiai;Žibuoklės;3071594259;Ne;0;3;0;3
11104;Smalsučiai;Žibuoklės;7107126092;Ne;0;3;0;3
11105;Smalsučiai;Žibuoklės;7070240693;Ne;0;5;1;6
11106;Smalsučiai;Žibuoklės;4288788194;Ne;0;0;1;1
11107;Smalsučiai;Žibuoklės;8259056296;Ne;5;0;7;12
11108;Smalsučiai;Žibuoklės;9637877396;Ne;0;4;3;7
11109;Smalsučiai;Aitvarų;3349726106;Ne;9;1;0;10
11110;Smalsučiai;Aitvarų;2219168902;Ne;4;0;0;4
11111;Smalsučiai;Aitvarų;9305837033;Ne;0;2;1;3
11112;Smalsučiai;Aitvarų;9305837033;Ne;0;2;1;3
11113;Smalsučiai;Aitvarų;9305837033;Ne;0;2;1;3
11114;Smalsučiai;Aitvarų;8877566394;Ne;0;9;1;10
11115;Smalsučiai;Aitvarų;3888093640;Ne;2;4;0;6
11116;Smalsučiai;Aitvarų;8284740122;Ne;13;0;0;13
11117;Smalsučiai;Aitvarų;1309254661;Ne;0;4;0;4
11118;Smalsučiai;Aitvarų;8985656809;Ne;2;0;0;2
11119;Smalsučiai;Aitvarų;6032887449;Ne;4;5;0;9
11120;Smalsučiai;Aitvarų;9821259659;Ne;3;4;0;7
11121;Smalsučiai;Aitvarų;4054278651;Ne;5;2;1;8
11122;Smalsučiai;Aitvarų;6232068532;Ne;0;4;0;4
11123;Smalsučiai;Aitvarų;3157534923;Ne;7;0;0;7
11124;Smalsučiai;Aitvarų;6825499095;Ne;4;0;2;6
11125;Smalsučiai;Aitvarų;4832292565;Ne;0;4;0;4
11126;Smalsučiai;Aitvarų;2835117069;Ne;0;4;0;4
11127;Smalsučiai;Aitvarų;2610753472;Ne;7;0;1;8
11128;Smalsučiai;Aitvarų;6090244401;Ne;0;1;0;1
11129;Smalsučiai;Aitvarų;2350539797;Ne;4;0;0;4
11130;Smalsučiai;Aitvarų;1126565862;Ne;14;1;0;15
11131;Smalsučiai;Aitvarų;1162035522;Ne;0;13;0;13
11132;Smalsučiai;Sraigiukų;7933302912;Ne;0;8;0;8
11133;Smalsučiai;Sraigiukų;1471941426;Ne;1;4;0;5
11134;Smalsučiai;Sraigiukų;1458544456;Ne;0;7;0;7
11135;Smalsučiai;Sraigiukų;5406430393;Ne;2;5;0;7
11136;Smalsučiai;Sraigiukų;9582225178;Ne;0;4;0;4
11137;Smalsučiai;Sraigiukų;9604182559;Ne;5;4;0;9
11138;Smalsučiai;Sraigiukų;6469604093;Ne;0;6;0;6
11139;Smalsučiai;Sraigiukų;4364810458;Ne;0;4;0;4
11140;Smalsučiai;Sraigiukų;4566816316;Ne;3;6;0;9
11141;Smalsučiai;Sraigiukų;5184903287;Ne;0;4;0;4
11142;Smalsučiai;Sraigiukų;4629526320;Ne;0;4;0;4
11143;Smalsučiai;Sraigiukų;4134975456;Ne;0;4;0;4
11144;Smalsučiai;Sraigiukų;7396172351;Ne;0;4;0;4
11145;Smalsučiai;Sraigiukų;6358800570;Ne;3;5;0;8
11146;Smalsučiai;Sraigiukų;3787937467;Ne;0;11;0;11
11147;Smalsučiai;Sraigiukų;4824786207;Ne;3;2;0;5
11148;Smalsučiai;Sraigiukų;3399798448;Ne;1;4;0;5
11149;Smalsučiai;Sraigiukų;1997966082;Ne;5;4;0;9
11150;Smalsučiai;Sraigiukų;4585930202;Ne;0;4;0;4
11151;Smalsučiai;Sraigiukų;8193410963;Ne;0;4;0;4
11152;Smalsučiai;Sraigiukų;9155011285;Ne;0;4;0;4
11153;Smalsučiai;Saulučių;1776385691;Ne;6;0;0;6
11154;Smalsučiai;Saulučių;2259361924;Ne;8;0;0;8
11155;Smalsučiai;Saulučių;1162964613;Taip;5;0;1;6
11156;Smalsučiai;Saulučių;9934952886;Ne;3;10;0;13
11157;Smalsučiai;Saulučių;9556433086;Ne;5;1;1;7
11158;Smalsučiai;Saulučių;1904973393;Ne;13;0;0;13
11159;Smalsučiai;Saulučių;3252901131;Ne;6;0;0;6
11160;Smalsučiai;Saulučių;9743116843;Ne;2;0;4;6
11161;Smalsučiai;Saulučių;2392217952;Ne;7;0;0;7
11162;Smalsučiai;Saulučių;1447512509;Ne;19;0;0;19
11163;Smalsučiai;Saulučių;2034284973;Ne;1;4;0;5
11164;Smalsučiai;Saulučių;7423419934;Ne;6;0;0;6
11165;Smalsučiai;Saulučių;7049101015;Ne;1;1;3;5
11166;Smalsučiai;Saulučių;9183519167;Taip;17;0;0;17
11167;Smalsučiai;Saulučių;5708986552;Ne;8;0;0;8
11168;Smalsučiai;Saulučių;4889923629;Ne;7;0;0;7
11169;Smalsučiai;Saulučių;8630411244;Ne;7;2;1;10
11170;Smalsučiai;Saulučių;5541908981;Ne;4;0;0;4
11171;Smalsučiai;Saulučių;6927421427;Ne;8;0;0;8
11172;Smalsučiai;Saulučių;7874635165;Ne;0;0;7;7
11173;Smalsučiai;Saulučių;5536697307;Ne;0;19;0;19
11174;Smalsučiai;Viščiukų;6827441564;Ne;4;0;0;4
11175;Smalsučiai;Viščiukų;4760366724;Ne;0;2;0;2
11176;Smalsučiai;Viščiukų;2045283348;Ne;5;4;0;9
11177;Smalsučiai;Viščiukų;4847029162;Ne;3;0;0;3
11178;Smalsučiai;Viščiukų;9710944054;Ne;1;4;0;5
11179;Smalsučiai;Viščiukų;5213319192;Ne;2;2;0;4
11180;Smalsučiai;Viščiukų;8210141253;Ne;0;2;0;2
11181;Smalsučiai;Viščiukų;3782502443;Ne;0;4;0;4
11182;Smalsučiai;Viščiukų;6358968221;Ne;9;1;0;10
11183;Smalsučiai;Viščiukų;2926560092;Ne;11;0;0;11
11184;Smalsučiai;Viščiukų;4075656060;Ne;0;3;0;3
11185;Smalsučiai;Viščiukų;4030955447;Ne;1;10;0;11
11186;Smalsučiai;Viščiukų;6131743288;Ne;5;0;0;5
11187;Smalsučiai;Viščiukų;1331674807;Ne;0;1;0;1
11188;Smalsučiai;Viščiukų;9984878984;Ne;0;4;0;4
11189;Smalsučiai;Viščiukų;5535858303;Ne;0;4;0;4
11190;Smalsučiai;Viščiukų;8724759192;Ne;0;3;0;3
11191;Smalsučiai;Viščiukų;2662588310;Ne;6;1;0;7
11192;Smalsučiai;Viščiukų;7318218997;Ne;7;1;0;8
11193;Smalsučiai;Viščiukų;2668720481;Ne;2;2;0;4
11194;Smalsučiai;Viščiukų;2369569130;Ne;5;3;0;8
11195;Smalsučiai;Boružėlių;8606216911;Ne;0;5;0;5
11196;Smalsučiai;Boružėlių;1023255628;Ne;6;1;1;8
11197;Smalsučiai;Boružėlių;9181601713;Taip;0;6;0;6
11198;Smalsučiai;Boružėlių;6642882883;Ne;9;0;1;10
11199;Smalsučiai;Boružėlių;7637630200;Ne;0;2;4;6
11200;Smalsučiai;Boružėlių;1247774684;Ne;0;2;1;3
11201;Smalsučiai;Boružėlių;2375360937;Ne;4;0;2;6
11202;Smalsučiai;Boružėlių;1224857159;Ne;0;6;2;8
11203;Smalsučiai;Boružėlių;2015172985;Ne;0;4;0;4
11204;Smalsučiai;Boružėlių;4457317471;Ne;0;1;0;1
11205;Smalsučiai;Boružėlių;8893480054;Ne;4;2;2;8
11206;Smalsučiai;Boružėlių;3646740184;Ne;0;2;3;5
11207;Smalsučiai;Boružėlių;6996192450;Ne;0;2;7;9
11208;Smalsučiai;Boružėlių;9378696084;Ne;3;2;5;10
11209;Smalsučiai;Boružėlių;7143824796;Ne;0;0;2;2
11210;Smalsučiai;Boružėlių;7267389695;Ne;10;4;0;14
11211;Smalsučiai;Boružėlių;1344461213;Ne;0;0;5;5
11212;Smalsučiai;Boružėlių;4847212069;Ne;0;1;2;3
11213;Smalsučiai;Boružėlių;8690626891;Ne;0;4;0;4
11214;Smalsučiai;Zuikių;6006832443;Ne;0;2;0;2
11215;Smalsučiai;Zuikių;9864518144;Ne;4;4;0;8
11216;Smalsučiai;Zuikių;8128348060;Ne;1;2;0;3
11217;Smalsučiai;Zuikių;3757955200;Ne;0;5;0;5
11218;Smalsučiai;Zuikių;4847584492;Ne;0;4;0;4
11219;Smalsučiai;Zuikių;6415906523;Ne;1;4;0;5
11220;Smalsučiai;Zuikių;4425714802;Ne;0;1;0;1
11221;Smalsučiai;Zuikių;4379645417;Ne;0;10;0;10
11222;Smalsučiai;Zuikių;9732075162;Ne;0;4;0;4
11223;Smalsučiai;Zuikių;6090391818;Ne;7;4;0;11
11224;Smalsučiai;Zuikių;7023531176;Ne;0;3;0;3
11225;Smalsučiai;Zuikių;5098291946;Ne;0;0;19;19
11226;Smalsučiai;Zuikių;3582805599;Ne;0;3;0;3
11227;Smalsučiai;Zuikių;7137550663;Ne;0;2;0;2
11228;Smalsučiai;Zuikių;2958335372;Ne;0;2;0;2
11229;Smalsučiai;Zuikių;8578693978;Ne;0;12;0;12
11230;Smalsučiai;Zuikių;7713078413;Ne;0;6;0;6
11231;Smalsučiai;Zuikių;3627324317;Ne;10;4;0;14
11232;Smalsučiai;Zuikių;2034790691;Ne;0;1;0;1
11233;Smalsučiai;Zuikių;4506058735;Ne;1;2;0;3
11234;Smalsučiai;Nykštukų;3254574278;Ne;0;3;0;3
11235;Smalsučiai;Nykštukų;6589139999;Ne;0;4;0;4
11236;Smalsučiai;Nykštukų;8461139523;Ne;1;4;0;5
11237;Smalsučiai;Nykštukų;3162567266;Ne;0;4;0;4
11238;Smalsučiai;Nykštukų;8405943289;Ne;2;0;0;2
11239;Smalsučiai;Nykštukų;7231947961;Ne;0;3;0;3
11240;Smalsučiai;Nykštukų;5205336476;Ne;0;1;0;1
11241;Smalsučiai;Nykštukų;5537437823;Ne;0;2;0;2
11242;Smalsučiai;Nykštukų;4110887316;Ne;0;5;1;6
11243;Smalsučiai;Nykštukų;2271751532;Ne;0;3;0;3
11244;Smalsučiai;Nykštukų;7257857454;Ne;5;3;0;8
11245;Smalsučiai;Nykštukų;9299524862;Ne;19;0;0;19
11246;Smalsučiai;Nykštukų;6372742288;Ne;4;3;1;8
11247;Smalsučiai;Katinėlių;3636314894;Ne;1;1;0;2
11248;Smalsučiai;Katinėlių;8527953002;Ne;0;1;0;1
11249;Smalsučiai;Katinėlių;4306056807;Ne;0;1;0;1
11250;Smalsučiai;Katinėlių;7094624971;Ne;2;1;0;3
11251;Smalsučiai;Katinėlių;1956492436;Ne;1;4;0;5
11252;Smalsučiai;Katinėlių;2505732707;Taip;10;1;1;12
11253;Smalsučiai;Katinėlių;4517950062;Ne;4;3;0;7
11254;Smalsučiai;Katinėlių;7567134320;Ne;14;3;0;17
11255;Smalsučiai;Katinėlių;3325151724;Ne;1;4;0;5
11256;Smalsučiai;Katinėlių;5390381543;Ne;5;1;0;6
11257;Smalsučiai;Katinėlių;3104627678;Ne;10;1;0;11
11258;Smalsučiai;Katinėlių;4989144093;Ne;3;0;0;3
11259;Smalsučiai;Katinėlių;4275309820;Ne;8;4;0;12
11260;Smalsučiai;Katinėlių;9482651454;Taip;19;0;0;19
11261;Smalsučiai;Katinėlių;7123127278;Ne;2;1;0;3
11262;Smalsučiai;PELĖDŽIUKAI;9222858199;Ne;5;2;3;10
11263;Smalsučiai;PELĖDŽIUKAI;1909797307;Taip;11;0;1;12
11264;Smalsučiai;PELĖDŽIUKAI;7400990599;Ne;8;0;0;8
11265;Smalsučiai;PELĖDŽIUKAI;8615110249;Ne;2;0;0;2
11266;Smalsučiai;PELĖDŽIUKAI;2673224420;Ne;1;0;2;3
11267;Smalsučiai;PELĖDŽIUKAI;9771532192;Ne;9;5;0;14
11268;Smalsučiai;PELĖDŽIUKAI;8402519872;Ne;5;4;0;9
11269;Smalsučiai;PELĖDŽIUKAI;1305808180;Ne;0;5;0;5
11270;Smalsučiai;PELĖDŽIUKAI;6393203986;Ne;0;5;0;5
11271;Smalsučiai;PELĖDŽIUKAI;3746193901;Ne;0;6;0;6
11272;Smalsučiai;PELĖDŽIUKAI;8499612926;Ne;1;0;0;1
11273;Smalsučiai;PELĖDŽIUKAI;3625628040;Taip;0;3;0;3
11274;Smalsučiai;PELĖDŽIUKAI;2305950301;Ne;0;0;2;2
11275;Smalsučiai;PELĖDŽIUKAI;6128134712;Ne;0;4;0;4
11276;Smalsučiai;PELĖDŽIUKAI;8615789381;Ne;0;9;0;9
11277;Smalsučiai;PELĖDŽIUKAI;3045521655;Ne;0;1;0;1
11278;Smalsučiai;PELĖDŽIUKAI;5789420793;Ne;0;0;6;6
11279;Smalsučiai;PELĖDŽIUKAI;7973827402;Ne;5;0;0;5
11280;Smalsučiai;PELĖDŽIUKAI;5104153092;Ne;0;4;4;8
11281;Smalsučiai;Pingvinukai;2054305125;Ne;7;1;0;8
11282;Smalsučiai;Pingvinukai;7731862348;Ne;13;0;1;14
11283;Smalsučiai;Pingvinukai;3064333387;Ne;13;0;0;13
11284;Smalsučiai;Pingvinukai;7266585367;Ne;5;0;0;5
11285;Smalsučiai;Pingvinukai;4557510634;Ne;11;0;0;11
11286;Smalsučiai;Pingvinukai;3340929454;Ne;10;0;0;10
11287;Smalsučiai;Pingvinukai;1381962216;Ne;13;0;0;13
11288;Smalsučiai;Pingvinukai;7065180174;Ne;10;1;0;11
11289;Smalsučiai;Pingvinukai;8493312040;Ne;0;2;0;2
11290;Smalsučiai;Pingvinukai;5081708388;Ne;4;0;0;4
11291;Smalsučiai;Pingvinukai;6430983316;Ne;17;0;0;17
11292;Smalsučiai;Pingvinukai;6380199558;Ne;13;0;0;13
11293;Smalsučiai;Voverikų;4811022648;Ne;0;5;0;5
11294;Smalsučiai;Voverikų;4973651632;Ne;8;5;0;13
11295;Smalsučiai;Voverikų;3509573985;Ne;3;10;0;13
11296;Smalsučiai;Voverikų;1485450504;Ne;0;3;0;3
11297;Smalsučiai;Voverikų;3042578767;Ne;0;4;0;4
11298;Smalsučiai;Voverikų;2070248478;Ne;6;4;0;10
11299;Smalsučiai;Voverikų;7205498813;Ne;7;0;0;7
11300;Smalsučiai;Voverikų;2612579099;Ne;0;18;0;18
11301;Smalsučiai;Voverikų;2885279828;Ne;0;2;0;2
11302;Smalsučiai;Voverikų;5964344820;Ne;0;0;2;2
11303;Smalsučiai;Voverikų;4105866680;Ne;14;0;0;14
11304;Smalsučiai;Voverikų;4611852575;Ne;0;8;0;8
11305;Smalsučiai;Voverikų;7988779202;Ne;9;5;0;14
11306;Smalsučiai;Voverikų;2583712404;Ne;4;2;1;7
11307;Smalsučiai;Voverikų;6984861531;Ne;4;5;2;11
11308;Smalsučiai;Voverikų;4233687544;Ne;5;0;2;7
11309;Smalsučiai;Voverikų;5710530457;Ne;5;2;0;7
11310;Spragtukas;NYKŠTUKAI;4527798635;Ne;0;9;0;9
11311;Spragtukas;NYKŠTUKAI;8551195766;Ne;7;0;0;7
11312;Spragtukas;NYKŠTUKAI;8297700739;Ne;0;2;0;2
11313;Spragtukas;NYKŠTUKAI;9595221494;Ne;0;7;0;7
11314;Spragtukas;NYKŠTUKAI;8715073512;Ne;2;3;0;5
11315;Spragtukas;NYKŠTUKAI;1710184531;Ne;0;4;0;4
11316;Spragtukas;NYKŠTUKAI;2076126173;Ne;0;17;0;17
11317;Spragtukas;NYKŠTUKAI;3012345413;Ne;1;7;0;8
11318;Spragtukas;NYKŠTUKAI;8698492694;Ne;13;2;6;21
11319;Spragtukas;NYKŠTUKAI;1150002524;Ne;0;8;0;8
11320;Spragtukas;NYKŠTUKAI;4493810276;Ne;0;3;0;3
11321;Spragtukas;NYKŠTUKAI;8288793522;Ne;0;17;0;17
11322;Spragtukas;NYKŠTUKAI;6986034864;Ne;0;7;0;7
11323;Spragtukas;NYKŠTUKAI;9665371858;Ne;3;7;0;10
11324;Spragtukas;NYKŠTUKAI;9308064461;Ne;11;5;0;16
11325;Spragtukas;SAULUTĖ;3337355440;Taip;3;7;0;10
11326;Spragtukas;SAULUTĖ;4669257062;Ne;0;6;0;6
11327;Spragtukas;SAULUTĖ;3692960591;Ne;4;7;0;11
11328;Spragtukas;SAULUTĖ;6192381779;Ne;0;2;0;2
11329;Spragtukas;SAULUTĖ;4586034709;Taip;2;0;0;2
11330;Spragtukas;SAULUTĖ;2305568596;Ne;0;6;0;6
11331;Spragtukas;SAULUTĖ;3968434618;Ne;2;4;0;6
11332;Spragtukas;SAULUTĖ;9191831532;Ne;0;6;0;6
11333;Spragtukas;SAULUTĖ;3948232692;Ne;7;8;0;15
11334;Spragtukas;SAULUTĖ;9149954373;Ne;0;14;0;14
11335;Spragtukas;SAULUTĖ;7511680722;Ne;0;9;0;9
11336;Spragtukas;SAULUTĖ;8235791891;Ne;0;5;0;5
11337;Spragtukas;SAULUTĖ;2987638580;Ne;0;6;0;6
11338;Spragtukas;SAULUTĖ;5687853390;Ne;2;6;0;8
11339;Spragtukas;SAULUTĖ;6679886985;Ne;23;4;0;27
11340;Spragtukas;SAULUTĖ;2879077913;Ne;0;6;0;6
11341;Spragtukas;SAULUTĖ;1998148708;Ne;8;7;0;15
11342;Spragtukas;SAULUTĖ;8227086854;Ne;0;22;0;22
11343;Spragtukas;SAULUTĖ;5697451914;Ne;2;7;0;9
11344;Spragtukas;SAULUTĖ;3086399458;Ne;11;4;0;15
11345;Spragtukas;SAULUTĖ;2879614195;Ne;0;17;0;17
11346;Spragtukas;SAULUTĖ;4929866385;Ne;4;4;0;8
11347;Spragtukas;SAULUTĖ;8912031554;Ne;29;0;0;29
11348;Spragtukas;SPINDULĖLIAI;7515307409;Ne;5;0;2;7
11349;Spragtukas;SPINDULĖLIAI;4527531194;Ne;8;0;2;10
11350;Spragtukas;SPINDULĖLIAI;8083960192;Ne;5;0;0;5
11351;Spragtukas;SPINDULĖLIAI;2823642738;Ne;0;3;0;3
11352;Spragtukas;SPINDULĖLIAI;6228634157;Ne;0;2;0;2
11353;Spragtukas;SPINDULĖLIAI;5902286196;Ne;13;0;1;14
11354;Spragtukas;SPINDULĖLIAI;4194552077;Ne;5;0;1;6
11355;Spragtukas;SPINDULĖLIAI;5998318402;Ne;15;0;0;15
11356;Spragtukas;SPINDULĖLIAI;9074266444;Ne;15;0;0;15
11357;Spragtukas;SPINDULĖLIAI;6313941560;Ne;1;0;1;2
11358;Spragtukas;SPINDULĖLIAI;3323280861;Ne;6;0;1;7
11359;Spragtukas;SPINDULĖLIAI;8856554286;Ne;4;0;1;5
11360;Spragtukas;SPINDULĖLIAI;1928122722;Ne;15;4;0;19
11361;Spragtukas;SPINDULĖLIAI;3367731738;Ne;0;6;0;6
11362;Spragtukas;GINTARĖLIAI;8339926929;Ne;0;3;0;3
11363;Spragtukas;GINTARĖLIAI;1525489137;Ne;0;6;0;6
11364;Spragtukas;GINTARĖLIAI;5724874569;Ne;5;10;0;15
11365;Spragtukas;GINTARĖLIAI;1430632638;Ne;11;3;0;14
11366;Spragtukas;GINTARĖLIAI;8625143071;Ne;0;10;0;10
11367;Spragtukas;GINTARĖLIAI;2255007161;Ne;9;4;0;13
11368;Spragtukas;GINTARĖLIAI;6493380877;Ne;0;3;0;3
11369;Spragtukas;GINTARĖLIAI;9664130733;Ne;11;1;0;12
11370;Spragtukas;GINTARĖLIAI;2316071393;Ne;7;3;0;10
11371;Spragtukas;GINTARĖLIAI;8698469979;Ne;5;8;0;13
11372;Spragtukas;GINTARĖLIAI;1747417905;Ne;10;10;0;20
11373;Spragtukas;GINTARĖLIAI;6388163866;Ne;6;17;0;23
11374;Spragtukas;GINTARĖLIAI;8191270443;Ne;6;8;0;14
11375;Spragtukas;GINTARĖLIAI;8893190073;Ne;0;4;0;4
11376;Spragtukas;GINTARĖLIAI;3684183344;Ne;0;6;0;6
11377;Spragtukas;GINTARĖLIAI;7806145224;Ne;0;8;0;8
11378;Spragtukas;GINTARĖLIAI;2992201984;Ne;5;8;0;13
11379;Spragtukas;GINTARĖLIAI;2217627240;Ne;8;9;0;17
11380;Spragtukas;GINTARĖLIAI;1150727381;Ne;4;12;0;16
11381;Spragtukas;GINTARĖLIAI;2706473182;Ne;6;9;0;15
11382;Spragtukas;ČIPOLINO;9951226210;Ne;0;6;0;6
11383;Spragtukas;ČIPOLINO;7933945356;Ne;13;5;0;18
11384;Spragtukas;ČIPOLINO;8473814776;Ne;24;1;0;25
11385;Spragtukas;ČIPOLINO;4461217748;Ne;0;11;0;11
11386;Spragtukas;ČIPOLINO;2087416420;Ne;0;7;0;7
11387;Spragtukas;ČIPOLINO;9579825533;Ne;11;1;0;12
11388;Spragtukas;ČIPOLINO;9443091032;Ne;0;21;0;21
11389;Spragtukas;ČIPOLINO;7412489884;Ne;2;10;0;12
11390;Spragtukas;ČIPOLINO;1545887575;Ne;0;3;0;3
11391;Spragtukas;ČIPOLINO;9294770557;Ne;1;4;0;5
11392;Spragtukas;ČIPOLINO;8110631015;Ne;4;5;0;9
11393;Spragtukas;ČIPOLINO;2963449719;Ne;8;6;0;14
11394;Spragtukas;ČIPOLINO;8136108310;Ne;0;2;0;2
11395;Spragtukas;ČIPOLINO;8710910167;Ne;0;3;0;3
11396;Spragtukas;ČIPOLINO;7692148513;Ne;0;8;0;8
11397;Spragtukas;ČIPOLINO;2599579491;Ne;10;6;0;16
11398;Spragtukas;ČIPOLINO;7402797271;Ne;23;0;0;23
11399;Spragtukas;ČIPOLINO;8560471564;Ne;17;6;0;23
11400;Spragtukas;BORUŽĖLĖS;8614890958;Ne;0;11;0;11
11401;Spragtukas;BORUŽĖLĖS;2356476212;Ne;5;8;0;13
11402;Spragtukas;BORUŽĖLĖS;8287102733;Taip;8;9;0;17
11403;Spragtukas;BORUŽĖLĖS;6584145176;Ne;0;14;0;14
11404;Spragtukas;BORUŽĖLĖS;6824861247;Ne;0;7;0;7
11405;Spragtukas;BORUŽĖLĖS;7264683147;Ne;0;8;1;9
11406;Spragtukas;BORUŽĖLĖS;5556920140;Ne;7;7;0;14
11407;Spragtukas;BORUŽĖLĖS;6547167325;Ne;0;4;0;4
11408;Spragtukas;BORUŽĖLĖS;7073092344;Ne;17;3;0;20
11409;Spragtukas;BORUŽĖLĖS;7042345781;Ne;0;3;2;5
11410;Spragtukas;BORUŽĖLĖS;1046613540;Ne;0;11;0;11
11411;Spragtukas;BORUŽĖLĖS;1180285187;Taip;7;4;0;11
11412;Spragtukas;BORUŽĖLĖS;2268649859;Ne;8;7;0;15
11413;Spragtukas;BORUŽĖLĖS;3110077272;Ne;5;1;0;6
11414;Spragtukas;BORUŽĖLĖS;3225684296;Ne;7;2;1;10
11415;Spragtukas;BORUŽĖLĖS;5940679759;Ne;17;1;0;18
11416;Spragtukas;DRUGELIAI;7058848570;Ne;9;7;0;16
11417;Spragtukas;DRUGELIAI;7271482702;Ne;2;5;0;7
11418;Spragtukas;DRUGELIAI;9099921999;Ne;3;3;0;6
11419;Spragtukas;DRUGELIAI;4441290823;Ne;8;0;0;8
11420;Spragtukas;DRUGELIAI;5440632023;Ne;7;4;0;11
11421;Spragtukas;DRUGELIAI;8307801987;Ne;0;4;0;4
11422;Spragtukas;DRUGELIAI;9310818975;Ne;5;5;0;10
11423;Spragtukas;DRUGELIAI;1493711333;Ne;3;7;0;10
11424;Spragtukas;DRUGELIAI;8486415968;Ne;11;0;0;11
11425;Spragtukas;DRUGELIAI;4742132709;Taip;0;2;0;2
11426;Spragtukas;DRUGELIAI;3423699840;Ne;0;9;0;9
11427;Spragtukas;DRUGELIAI;7256772984;Ne;0;4;0;4
11428;Spragtukas;DRUGELIAI;2026249018;Taip;0;2;0;2
11429;Spragtukas;DRUGELIAI;1487259291;Ne;11;6;2;19
11430;Spragtukas;DRUGELIAI;5225669850;Ne;0;1;0;1
11431;Spragtukas;DRUGELIAI;8109894184;Ne;5;4;0;9
11432;Spragtukas;DRUGELIAI;8396134652;Ne;3;3;0;6
11433;Spragtukas;DRUGELIAI;1784758799;Ne;5;4;0;9
11434;Spragtukas;DRUGELIAI;8893500175;Ne;5;1;0;6
11435;Spragtukas;GAIDELIAI;2541126095;Ne;15;8;0;23
11436;Spragtukas;GAIDELIAI;4097458544;Ne;5;0;0;5
11437;Spragtukas;GAIDELIAI;8957903306;Ne;7;6;0;13
11438;Spragtukas;GAIDELIAI;1326714513;Ne;6;11;0;17
11439;Spragtukas;GAIDELIAI;7108640957;Ne;0;13;0;13
11440;Spragtukas;GAIDELIAI;7911124524;Ne;4;3;0;7
11441;Spragtukas;GAIDELIAI;9509296936;Ne;0;0;1;1
11442;Spragtukas;GAIDELIAI;3216796441;Ne;11;4;0;15
11443;Spragtukas;GAIDELIAI;8440836721;Ne;17;2;0;19
11444;Spragtukas;GAIDELIAI;4535021524;Ne;0;7;0;7
11445;Spragtukas;GAIDELIAI;2679834328;Ne;11;2;0;13
11446;Spragtukas;GAIDELIAI;7912840514;Ne;12;3;0;15
11447;Spragtukas;GAIDELIAI;1748358240;Ne;0;4;6;10
11448;Spragtukas;GAIDELIAI;7494879160;Taip;14;0;0;14
11449;Spragtukas;ŽUVELĖS;9078163633;Ne;0;5;0;5
11450;Spragtukas;ŽUVELĖS;8762832644;Ne;0;2;0;2
11451;Spragtukas;ŽUVELĖS;8652973900;Ne;0;4;0;4
11452;Spragtukas;ŽUVELĖS;3261213140;Ne;0;11;0;11
11453;Spragtukas;ŽUVELĖS;5689392663;Ne;0;6;1;7
11454;Spragtukas;ŽUVELĖS;9592271053;Ne;0;5;0;5
11455;Spragtukas;ŽUVELĖS;1272075883;Ne;0;5;0;5
11456;Spragtukas;ŽUVELĖS;6465991136;Ne;0;4;0;4
11457;Spragtukas;ŽUVELĖS;9282940430;Ne;0;4;0;4
11458;Spragtukas;ŽUVELĖS;6503842956;Ne;2;4;0;6
11459;Spragtukas;ŽUVELĖS;2578400770;Ne;2;4;0;6
11460;Spragtukas;ŽUVELĖS;3139748724;Ne;5;6;1;12
11461;Spragtukas;ŽUVELĖS;8640877497;Ne;5;4;0;9
11462;Spragtukas;ŽUVELĖS;2025314314;Ne;0;8;0;8
11463;Spragtukas;ŽUVELĖS;4848647219;Ne;0;4;0;4
11464;Spragtukas;ŽUVELĖS;3491418162;Ne;3;7;0;10
11465;Spragtukas;ŽUVELĖS;5836788916;Ne;2;5;0;7
11466;Spragtukas;ŽUVELĖS;5704941595;Ne;9;3;0;12
11467;Spragtukas;ŽUVELĖS;3286456855;Ne;3;4;0;7
11468;Spragtukas;ŽUVELĖS;9662188102;Ne;0;6;0;6
11469;Spragtukas;ŽUVELĖS;2539660577;Ne;5;4;0;9
11470;Spragtukas;ŽUVELĖS;6836232179;Ne;0;1;0;1
11471;Spragtukas;ŽUVELĖS;6757604305;Ne;5;3;0;8
11472;Spragtukas;ŽUVELĖS;6800727630;Ne;0;3;0;3
11473;Spragtukas;ŽUVELĖS;1627243902;Ne;0;4;0;4
11474;Spragtukas;RIEŠUTĖLIAI;8684246143;Ne;2;4;0;6
11475;Spragtukas;RIEŠUTĖLIAI;1407611561;Ne;1;0;1;2
11476;Spragtukas;RIEŠUTĖLIAI;8773952377;Ne;0;7;0;7
11477;Spragtukas;RIEŠUTĖLIAI;1977526177;Ne;0;1;0;1
11478;Spragtukas;RIEŠUTĖLIAI;7615522850;Ne;5;4;0;9
11479;Spragtukas;RIEŠUTĖLIAI;6797841737;Ne;2;4;0;6
11480;Spragtukas;RIEŠUTĖLIAI;9204569123;Ne;0;1;0;1
11481;Spragtukas;RIEŠUTĖLIAI;8342098575;Ne;0;2;0;2
11482;Spragtukas;RIEŠUTĖLIAI;1992850470;Ne;0;6;1;7
11483;Spragtukas;RIEŠUTĖLIAI;6158327941;Ne;5;7;0;12
11484;Spragtukas;RIEŠUTĖLIAI;4134127256;Ne;0;5;0;5
11485;Spragtukas;RIEŠUTĖLIAI;3009567338;Ne;0;7;0;7
11486;Spragtukas;RIEŠUTĖLIAI;2648358901;Ne;0;9;0;9
11487;Spragtukas;RIEŠUTĖLIAI;3822599790;Ne;5;15;0;20
11488;Spragtukas;RIEŠUTĖLIAI;7767940027;Ne;8;2;0;10
11489;Spragtukas;RIEŠUTĖLIAI;4625065223;Ne;4;4;0;8
11490;Spragtukas;RIEŠUTĖLIAI;6963190259;Ne;10;13;0;23
11491;Spragtukas;RIEŠUTĖLIAI;8732886749;Ne;5;6;0;11
11492;Spragtukas;RIEŠUTĖLIAI;1946493379;Ne;18;0;0;18
11493;Spragtukas;RIEŠUTĖLIAI;9975308171;Taip;0;10;0;10
11494;Spragtukas;VIŠČIUKAI;8291401010;Ne;6;7;0;13
11495;Spragtukas;VIŠČIUKAI;6219915771;Ne;2;4;0;6
11496;Spragtukas;VIŠČIUKAI;5497023448;Ne;3;6;0;9
11497;Spragtukas;VIŠČIUKAI;2359209112;Ne;9;0;1;10
11498;Spragtukas;VIŠČIUKAI;8371817233;Ne;0;8;0;8
11499;Spragtukas;VIŠČIUKAI;4489637427;Ne;5;2;0;7
11500;Spragtukas;VIŠČIUKAI;6804843816;Taip;5;3;0;8
11501;Spragtukas;VIŠČIUKAI;7883446348;Ne;0;3;0;3
11502;Spragtukas;VIŠČIUKAI;9617355214;Ne;13;0;0;13
11503;Spragtukas;VIŠČIUKAI;1878079499;Ne;0;2;2;4
11504;Spragtukas;VIŠČIUKAI;9198638303;Ne;0;3;0;3
11505;Spragtukas;VIŠČIUKAI;1572602399;Ne;0;3;0;3
11506;Spragtukas;MEŠKIUKAI;6477635199;Ne;19;0;0;19
11507;Spragtukas;MEŠKIUKAI;7730786172;Ne;8;4;0;12
11508;Spragtukas;MEŠKIUKAI;2422384041;Ne;15;0;0;15
11509;Spragtukas;MEŠKIUKAI;1411972930;Ne;10;4;0;14
11510;Spragtukas;MEŠKIUKAI;4654665538;Ne;2;3;0;5
11511;Spragtukas;MEŠKIUKAI;9313536781;Taip;0;2;0;2
11512;Spragtukas;MEŠKIUKAI;9616402367;Ne;10;4;0;14
11513;Spragtukas;MEŠKIUKAI;1869458751;Ne;9;1;0;10
11514;Spragtukas;MEŠKIUKAI;4332445650;Ne;2;1;0;3
11515;Spragtukas;MEŠKIUKAI;4900860607;Ne;10;0;0;10
11516;Spragtukas;MEŠKIUKAI;2172787507;Ne;3;4;0;7
11517;Spragtukas;MEŠKIUKAI;6073139322;Ne;1;3;0;4
11518;Strazdelis;Žiogelių;5346485534;Ne;1;4;0;5
11519;Strazdelis;Žiogelių;9933042249;Ne;0;11;0;11
11520;Strazdelis;Žiogelių;8581533423;Ne;0;4;0;4
11521;Strazdelis;Žiogelių;8209625399;Ne;16;1;0;17
11522;Strazdelis;Žiogelių;1141752802;Ne;3;1;0;4
11523;Strazdelis;Žiogelių;3596394112;Ne;9;5;0;14
11524;Strazdelis;Žiogelių;4563247013;Ne;14;0;0;14
11525;Strazdelis;Žiogelių;6437928004;Ne;4;1;0;5
11526;Strazdelis;Žiogelių;8971395173;Ne;1;4;0;5
11527;Strazdelis;Žiogelių;4955907851;Ne;2;5;0;7
11528;Strazdelis;Žiogelių;7425818775;Ne;1;3;0;4
11529;Strazdelis;Žiogelių;9567476872;Ne;3;0;0;3
11530;Strazdelis;Žiogelių;4516288199;Ne;0;6;0;6
11531;Strazdelis;Žiogelių;3028208428;Ne;8;0;0;8
11532;Strazdelis;Žiogelių;2753635198;Ne;7;3;0;10
11533;Strazdelis;Žiogelių;6651360492;Ne;9;6;0;15
11534;Strazdelis;Žiogelių;7913526787;Ne;8;4;0;12
11535;Strazdelis;Žiogelių;5742215922;Ne;6;2;0;8
11536;Strazdelis;Šeimynėlės;6570504154;Ne;0;4;0;4
11537;Strazdelis;Šeimynėlės;3848288765;Ne;1;0;0;1
11538;Strazdelis;Šeimynėlės;5033799225;Ne;1;0;0;1
11539;Strazdelis;Šeimynėlės;1683900907;Ne;0;1;0;1
11540;Strazdelis;Šeimynėlės;3897248010;Ne;4;1;0;5
11541;Strazdelis;Šeimynėlės;2990771887;Ne;0;12;0;12
11542;Strazdelis;Šeimynėlės;2185364583;Ne;9;0;0;9
11543;Strazdelis;Šeimynėlės;7905687363;Ne;10;2;0;12
11544;Strazdelis;Šeimynėlės;4501391298;Ne;0;7;0;7
11545;Strazdelis;Šeimynėlės;1277844969;Ne;9;2;0;11
11546;Strazdelis;Šeimynėlės;1012692326;Ne;7;1;0;8
11547;Strazdelis;Šeimynėlės;8899530711;Ne;7;1;0;8
11548;Strazdelis;Šeimynėlės;5784406335;Ne;0;5;0;5
11549;Strazdelis;Šeimynėlės;5296218650;Ne;4;0;0;4
11550;Strazdelis;Šeimynėlės;1754106518;Ne;3;0;0;3
11551;Strazdelis;Šeimynėlės;9806107189;Ne;1;5;0;6
11552;Strazdelis;Šeimynėlės;9209201954;Ne;0;3;0;3
11553;Strazdelis;Šeimynėlės;8295035233;Ne;3;0;1;4
11554;Strazdelis;Šeimynėlės;1553329770;Ne;9;1;0;10
11555;Strazdelis;Genelio;9586256979;Ne;2;4;0;6
11556;Strazdelis;Genelio;3084249678;Ne;0;4;0;4
11557;Strazdelis;Genelio;5499310072;Ne;0;6;0;6
11558;Strazdelis;Genelio;8333151969;Ne;0;4;0;4
11559;Strazdelis;Genelio;7083940713;Ne;0;1;0;1
11560;Strazdelis;Genelio;6271193831;Ne;3;3;0;6
11561;Strazdelis;Genelio;6480803618;Ne;7;4;0;11
11562;Strazdelis;Genelio;9490861272;Ne;8;6;0;14
11563;Strazdelis;Genelio;6071502600;Ne;0;5;0;5
11564;Strazdelis;Genelio;3713797440;Ne;0;5;0;5
11565;Strazdelis;Genelio;1034497200;Ne;0;1;1;2
11566;Strazdelis;Genelio;2459718449;Ne;0;5;0;5
11567;Strazdelis;Genelio;2483283363;Ne;0;1;0;1
11568;Strazdelis;Genelio;5714581201;Ne;5;4;0;9
11569;Strazdelis;Genelio;8956634754;Ne;0;1;0;1
11570;Strazdelis;Genelio;8762859576;Ne;0;4;1;5
11571;Strazdelis;Genelio;2306665561;Ne;0;4;0;4
11572;Strazdelis;Genelio;7680242840;Ne;3;5;0;8
11573;Strazdelis;Genelio;4545538133;Ne;0;1;0;1
11574;Strazdelis;Vikruolių;8287554571;Ne;0;3;0;3
11575;Strazdelis;Vikruolių;1901641517;Ne;0;3;0;3
11576;Strazdelis;Vikruolių;8637386316;Ne;0;4;0;4
11577;Strazdelis;Vikruolių;1704292727;Ne;5;4;1;10
11578;Strazdelis;Vikruolių;5892430004;Ne;0;10;0;10
11579;Strazdelis;Vikruolių;4617237063;Ne;5;3;0;8
11580;Strazdelis;Vikruolių;3036380561;Ne;4;3;0;7
11581;Strazdelis;Vikruolių;8371999002;Ne;0;6;0;6
11582;Strazdelis;Vikruolių;4562530311;Ne;0;4;2;6
11583;Strazdelis;Vikruolių;4004930488;Ne;0;4;1;5
11584;Strazdelis;Vikruolių;5768674837;Ne;10;4;0;14
11585;Strazdelis;Vikruolių;6046139859;Ne;1;3;0;4
11586;Strazdelis;Vikruolių;7349106795;Ne;3;2;1;6
11587;Strazdelis;Vikruolių;9761595867;Ne;6;4;0;10
11588;Strazdelis;Vikruolių;4448556404;Ne;5;5;0;10
11589;Strazdelis;Vikruolių;7876385010;Ne;3;2;0;5
11590;Strazdelis;Vikruolių;8854150040;Ne;0;3;1;4
11591;Strazdelis;Vyturėlių;7471890377;Ne;0;7;0;7
11592;Strazdelis;Vyturėlių;2848984531;Ne;0;4;0;4
11593;Strazdelis;Vyturėlių;4159072583;Ne;2;6;0;8
11594;Strazdelis;Vyturėlių;2662549392;Ne;0;3;0;3
11595;Strazdelis;Vyturėlių;7469848482;Ne;6;4;0;10
11596;Strazdelis;Vyturėlių;2251157025;Ne;2;3;0;5
11597;Strazdelis;Vyturėlių;1841285441;Ne;0;5;0;5
11598;Strazdelis;Vyturėlių;5904388732;Ne;0;8;0;8
11599;Strazdelis;Vyturėlių;3460993302;Ne;0;4;0;4
11600;Strazdelis;Vyturėlių;7393083827;Ne;4;3;0;7
11601;Strazdelis;Vyturėlių;6555803164;Ne;0;5;0;5
11602;Strazdelis;Vyturėlių;1955166372;Ne;3;4;0;7
11603;Strazdelis;Vyturėlių;1706026100;Ne;0;1;0;1
11604;Strazdelis;Vyturėlių;4873707286;Ne;0;1;0;1
11605;Strazdelis;Vyturėlių;6527855940;Ne;2;4;0;6
11606;Strazdelis;Vyturėlių;2824416350;Ne;0;7;0;7
11607;Strazdelis;Vyturėlių;3610250359;Ne;0;6;0;6
11608;Strazdelis;Vyturėlių;2789987994;Ne;0;3;0;3
11609;Strazdelis;Vyturėlių;1173067724;Ne;0;5;0;5
11610;Strazdelis;Vyturėlių;2766970956;Ne;0;3;0;3
11611;Strazdelis;Varpelio;9502341478;Ne;5;5;0;10
11612;Strazdelis;Varpelio;5924324241;Ne;7;5;0;12
11613;Strazdelis;Varpelio;6954336739;Ne;11;4;0;15
11614;Strazdelis;Varpelio;3456287323;Ne;7;4;0;11
11615;Strazdelis;Varpelio;2990465012;Ne;0;3;0;3
11616;Strazdelis;Varpelio;2438598773;Ne;5;5;0;10
11617;Strazdelis;Varpelio;8220751869;Ne;2;7;0;9
11618;Strazdelis;Varpelio;5425585036;Ne;3;2;0;5
11619;Strazdelis;Varpelio;1018598897;Ne;0;2;0;2
11620;Strazdelis;Varpelio;5314676261;Ne;2;6;0;8
11621;Strazdelis;Varpelio;5683969627;Ne;7;4;0;11
11622;Strazdelis;Varpelio;2398220397;Ne;7;1;0;8
11623;Strazdelis;Varpelio;1787432390;Ne;5;5;0;10
11624;Strazdelis;Varpelio;3106135598;Ne;0;3;0;3
11625;Strazdelis;Varpelio;1455467186;Ne;6;0;0;6
11626;Strazdelis;Varpelio;9955443967;Ne;0;6;0;6
11627;Strazdelis;Varpelio;4908660203;Ne;6;6;0;12
11628;Strazdelis;Varpelio;6522639028;Taip;2;5;0;7
11629;Strazdelis;Pelėdžiukų;7087235151;Ne;18;0;0;18
11630;Strazdelis;Pelėdžiukų;4461728361;Ne;5;2;0;7
11631;Strazdelis;Pelėdžiukų;1770338988;Ne;3;2;0;5
11632;Strazdelis;Pelėdžiukų;3030445367;Ne;0;4;0;4
11633;Strazdelis;Pelėdžiukų;4966668662;Ne;1;1;0;2
11634;Strazdelis;Pelėdžiukų;8484672456;Ne;2;4;0;6
11635;Strazdelis;Pelėdžiukų;6457478289;Ne;2;4;0;6
11636;Strazdelis;Pelėdžiukų;8953577585;Ne;0;5;0;5
11637;Strazdelis;Pelėdžiukų;3426039979;Ne;7;6;0;13
11638;Strazdelis;Pelėdžiukų;4715198107;Ne;6;4;0;10
11639;Strazdelis;Pelėdžiukų;4334385271;Ne;5;3;0;8
11640;Strazdelis;Pelėdžiukų;8677659019;Ne;2;3;0;5
11641;Strazdelis;Pelėdžiukų;4848650799;Ne;5;2;0;7
11642;Strazdelis;Pelėdžiukų;7716476995;Ne;3;4;0;7
11643;Strazdelis;Pelėdžiukų;8356680705;Ne;10;4;0;14
11644;Strazdelis;Pelėdžiukų;4174940099;Ne;6;5;0;11
11645;Strazdelis;Pelėdžiukų;8554043784;Ne;3;4;0;7
11646;Strazdelis;Pelėdžiukų;1952086370;Taip;3;6;0;9
11647;Strazdelis;Pelėdžiukų;7802337169;Ne;0;1;0;1
11648;Strazdelis;Saulutės;5604313206;Ne;0;4;0;4
11649;Strazdelis;Saulutės;8877104963;Ne;2;4;0;6
11650;Strazdelis;Saulutės;4726043862;Ne;3;0;0;3
11651;Strazdelis;Saulutės;8686828982;Taip;0;6;0;6
11652;Strazdelis;Saulutės;1228651165;Ne;0;9;0;9
11653;Strazdelis;Saulutės;7768700192;Ne;0;5;0;5
11654;Strazdelis;Saulutės;2852253325;Ne;0;3;0;3
11655;Strazdelis;Saulutės;3943914976;Ne;0;2;0;2
11656;Strazdelis;Saulutės;8938997208;Ne;0;2;0;2
11657;Strazdelis;Saulutės;2589303722;Ne;0;2;0;2
11658;Strazdelis;Saulutės;5232064496;Ne;0;5;0;5
11659;Strazdelis;Saulutės;2081538505;Ne;0;10;0;10
11660;Strazdelis;Saulutės;4784401449;Ne;0;1;0;1
11661;Strazdelis;Saulutės;9776075027;Ne;10;4;0;14
11662;Strazdelis;Saulutės;6311710825;Ne;0;4;0;4
11663;Strazdelis;Saulutės;1021364759;Ne;0;5;0;5
11664;Strazdelis;Bitutės;8485509145;Ne;0;6;0;6
11665;Strazdelis;Bitutės;6508933324;Ne;1;4;0;5
11666;Strazdelis;Bitutės;4020547762;Ne;0;3;0;3
11667;Strazdelis;Bitutės;8753316532;Ne;0;4;0;4
11668;Strazdelis;Bitutės;9435593972;Ne;0;4;0;4
11669;Strazdelis;Bitutės;9555240419;Ne;0;3;0;3
11670;Strazdelis;Bitutės;3043580835;Ne;7;6;0;13
11671;Strazdelis;Bitutės;1539984888;Ne;0;4;0;4
11672;Strazdelis;Bitutės;4400849922;Ne;0;6;0;6
11673;Strazdelis;Bitutės;7890064837;Ne;3;5;0;8
11674;Strazdelis;Bitutės;1881071425;Taip;6;4;0;10
11675;Strazdelis;Bitutės;2908567982;Ne;4;1;0;5
11676;Strazdelis;Bitutės;9548465554;Ne;0;2;0;2
11677;Strazdelis;Bitutės;7466648222;Ne;0;3;0;3
11678;Strazdelis;Bitutės;4463378251;Ne;3;5;0;8
11679;Strazdelis;Bitutės;2963535523;Ne;0;4;0;4
11680;Strazdelis;Bitutės;4369569609;Ne;0;5;0;5
11681;Strazdelis;Bitutės;8277333786;Ne;5;4;0;9
11682;Strazdelis;Mažylių;9357195019;Ne;0;0;1;1
11683;Strazdelis;Mažylių;5256750516;Ne;0;11;0;11
11684;Strazdelis;Mažylių;4965049621;Ne;2;1;0;3
11685;Strazdelis;Mažylių;2378910473;Ne;6;4;0;10
11686;Strazdelis;Mažylių;4699373769;Ne;6;3;0;9
11687;Strazdelis;Mažylių;3648883435;Ne;16;1;0;17
11688;Strazdelis;Mažylių;6788732053;Ne;0;1;0;1
11689;Strazdelis;Mažylių;2764495554;Ne;0;1;0;1
11690;Strazdelis;Mažylių;7039347901;Ne;0;0;2;2
11691;Strazdelis;Mažylių;4904388387;Ne;0;4;0;4
11692;Strazdelis;Mažylių;3082900425;Ne;5;2;0;7
11693;Strazdelis;Mažylių;1265557971;Ne;0;2;0;2
11694;Strazdelis;Mažylių;3900225484;Ne;9;0;0;9
11695;Strazdelis;Mažylių;8734458997;Ne;4;4;1;9
11696;Strazdelis;Mažylių;3561551193;Ne;6;5;0;11
11697;Strazdelis;Mažylių;1932428439;Ne;0;5;0;5
11698;Strazdelis;Mažylių;2871841427;Ne;6;2;0;8
11699;Strazdelis;Mažylių;3572665646;Ne;5;0;0;5
11700;Strazdelis;Mažylių;8699020650;Ne;1;0;0;1
11701;Strazdelis;Pabiručių;1823053560;Ne;19;0;0;19
11702;Strazdelis;Pabiručių;7065489134;Ne;9;4;0;13
11703;Strazdelis;Pabiručių;4740153387;Ne;0;1;0;1
11704;Strazdelis;Pabiručių;3688573846;Ne;0;2;0;2
11705;Strazdelis;Pabiručių;5326864534;Ne;0;2;0;2
11706;Strazdelis;Pabiručių;9870463329;Ne;6;0;2;8
11707;Strazdelis;Pabiručių;2128546121;Ne;0;5;0;5
11708;Strazdelis;Pabiručių;3124550569;Ne;0;2;0;2
11709;Strazdelis;Pabiručių;4356218766;Ne;0;2;1;3
11710;Strazdelis;Pabiručių;9387670022;Ne;0;7;0;7
11711;Strazdelis;Žvirbliukai;9327438394;Ne;0;2;0;2
11712;Strazdelis;Žvirbliukai;4435530603;Taip;13;0;1;14
11713;Strazdelis;Žvirbliukai;3655476635;Taip;6;0;0;6
11714;Strazdelis;Žvirbliukai;4101114308;Ne;3;0;1;4
11715;Strazdelis;Žvirbliukai;6853311266;Ne;11;0;1;12
11716;Strazdelis;Žvirbliukai;5109807137;Ne;9;0;0;9
11717;Strazdelis;Žvirbliukai;8345990558;Ne;2;4;1;7
11718;Strazdelis;Žvirbliukai;7500217232;Ne;6;0;0;6
11719;Strazdelis;Žvirbliukai;2262189227;Ne;4;4;1;9
11720;Strazdelis;Žvirbliukai;2987873520;Ne;0;4;0;4
11721;Strazdelis;Smalsučiai;2400659346;Ne;11;0;4;15
11722;Strazdelis;Smalsučiai;7927494186;Ne;0;4;0;4
11723;Strazdelis;Smalsučiai;3363137855;Ne;3;6;0;9
11724;Strazdelis;Smalsučiai;2353001006;Ne;7;0;0;7
11725;Strazdelis;Smalsučiai;9394055331;Ne;2;0;4;6
11726;Strazdelis;Smalsučiai;7376719255;Ne;0;1;0;1
11727;Strazdelis;Smalsučiai;3968872721;Ne;3;0;0;3
11728;Strazdelis;Smalsučiai;7028716451;Ne;7;0;0;7
11729;Strazdelis;Smalsučiai;1607989470;Ne;0;4;1;5
11730;Strazdelis;Smalsučiai;4403950626;Ne;8;0;0;8
11731;Strazdelis;Smalsučiai;6617345241;Ne;8;0;0;8
11732;Strazdelis;Zuikučiai;5709610161;Ne;19;0;0;19
11733;Strazdelis;Zuikučiai;4341506341;Ne;0;2;2;4
11734;Strazdelis;Zuikučiai;3117151676;Ne;0;4;1;5
11735;Strazdelis;Zuikučiai;6746494698;Ne;0;3;0;3
11736;Strazdelis;Zuikučiai;3868845362;Ne;10;0;0;10
11737;Strazdelis;Zuikučiai;3277336468;Ne;2;4;2;8
11738;Strazdelis;Zuikučiai;6370073120;Ne;2;2;0;4
11739;Strazdelis;Zuikučiai;8584413761;Ne;12;0;0;12
11740;Strazdelis;Zuikučiai;7879010008;Ne;9;0;0;9
11741;Strazdelis;Zuikučiai;7816174042;Ne;7;0;0;7
11742;Strazdelis;Zuikučiai;5842432403;Ne;0;2;0;2
11743;Strazdelis;Boružiukai;7722063228;Ne;0;5;0;5
11744;Strazdelis;Boružiukai;1360433419;Ne;0;4;1;5
11745;Strazdelis;Boružiukai;3414489196;Ne;5;2;0;7
11746;Strazdelis;Boružiukai;6199087019;Ne;0;5;0;5
11747;Strazdelis;Boružiukai;4135433644;Ne;0;1;0;1
11748;Strazdelis;Boružiukai;8372033449;Ne;0;4;0;4
11749;Strazdelis;Boružiukai;4510204830;Ne;3;1;0;4
11750;Strazdelis;Boružiukai;6163722469;Ne;0;11;0;11
11751;Strazdelis;Boružiukai;4855667876;Ne;5;2;0;7
11752;Strazdelis;Boružiukai;4210678130;Ne;2;1;0;3
11753;Strazdelis;Boružiukai;9400396057;Ne;0;3;2;5
11754;Strazdelis;Boružiukai;8841518149;Ne;7;4;0;11
11755;Strazdelis;Gandriukai;1303481940;Ne;0;3;0;3
11756;Strazdelis;Gandriukai;5327428351;Ne;3;1;0;4
11757;Strazdelis;Gandriukai;2337958830;Ne;3;0;0;3
11758;Strazdelis;Gandriukai;1511882237;Ne;5;1;0;6
11759;Strazdelis;Gandriukai;9357344413;Ne;5;3;0;8
11760;Strazdelis;Gandriukai;6113204629;Ne;0;4;0;4
11761;Strazdelis;Gandriukai;9931075329;Ne;7;6;0;13
11762;Strazdelis;Gandriukai;2474988890;Ne;0;3;0;3
11763;Strazdelis;Gandriukai;9036931027;Ne;0;4;0;4
11764;Strazdelis;Gandriukai;4284112438;Ne;0;4;0;4
11765;Strazdelis;Gandriukai;4335313098;Taip;19;0;0;19
11766;Strazdelis;Gandriukai;2230287744;Ne;5;5;0;10
11767;Strazdelis;Gandriukai;1361102201;Ne;10;1;0;11
11768;Strazdelis;Gandriukai;7158003869;Ne;0;4;0;4
11769;Strazdelis;Gandriukai;7403074070;Ne;2;1;0;3
11770;Šermukšnėlė;MOLINUKAI;9746313951;Ne;11;0;0;11
11771;Šermukšnėlė;MOLINUKAI;4638109666;Ne;0;0;1;1
11772;Šermukšnėlė;MOLINUKAI;9329824053;Ne;7;0;0;7
11773;Šermukšnėlė;MOLINUKAI;2714018690;Ne;1;4;1;6
11774;Šermukšnėlė;MOLINUKAI;5262882873;Ne;0;5;0;5
11775;Šermukšnėlė;MOLINUKAI;2985284699;Ne;0;3;0;3
11776;Šermukšnėlė;MOLINUKAI;4983510683;Ne;0;3;0;3
11777;Šermukšnėlė;MOLINUKAI;7385114026;Ne;0;2;1;3
11778;Šermukšnėlė;MOLINUKAI;2784732759;Ne;7;0;1;8
11779;Šermukšnėlė;MOLINUKAI;3342919832;Ne;1;5;1;7
11780;Šermukšnėlė;MOLINUKAI;9337047371;Ne;0;4;0;4
11781;Šermukšnėlė;MOLINUKAI;2098090763;Ne;0;4;0;4
11782;Šermukšnėlė;MOLINUKAI;5835100042;Ne;0;0;1;1
11783;Šermukšnėlė;MOLINUKAI;8000479161;Ne;0;4;1;5
11784;Šermukšnėlė;MOLINUKAI;4952285322;Ne;0;5;0;5
11785;Šermukšnėlė;MOLINUKAI;5733048755;Ne;3;4;0;7
11786;Šermukšnėlė;MOLINUKAI;6608458145;Ne;0;6;0;6
11787;Šermukšnėlė;MOLINUKAI;8104182167;Ne;3;0;1;4
11788;Šermukšnėlė;MOLINUKAI;6988120570;Ne;0;11;0;11
11789;Šermukšnėlė;MOLINUKAI;8728441474;Ne;3;4;0;7
11790;Šermukšnėlė;MOLINUKAI;4075151928;Ne;4;0;2;6
11791;Šermukšnėlė;MOLINUKAI;4968522498;Ne;0;9;0;9
11792;Šermukšnėlė;ŠIAUDINUKAI;7249568196;Ne;0;4;0;4
11793;Šermukšnėlė;ŠIAUDINUKAI;3451361097;Ne;0;0;1;1
11794;Šermukšnėlė;ŠIAUDINUKAI;7002917737;Ne;3;1;3;7
11795;Šermukšnėlė;ŠIAUDINUKAI;7785671936;Ne;8;0;0;8
11796;Šermukšnėlė;ŠIAUDINUKAI;3637882900;Ne;0;3;0;3
11797;Šermukšnėlė;ŠIAUDINUKAI;1159472154;Ne;5;4;0;9
11798;Šermukšnėlė;ŠIAUDINUKAI;4956414941;Ne;12;4;0;16
11799;Šermukšnėlė;ŠIAUDINUKAI;3499394539;Ne;2;4;0;6
11800;Šermukšnėlė;ŠIAUDINUKAI;1157979179;Ne;0;8;0;8
11801;Šermukšnėlė;ŠIAUDINUKAI;8048598135;Ne;0;0;4;4
11802;Šermukšnėlė;ŠIAUDINUKAI;3082272196;Taip;6;4;2;12
11803;Šermukšnėlė;ŠIAUDINUKAI;9903310024;Ne;0;0;1;1
11804;Šermukšnėlė;ŠIAUDINUKAI;6993702887;Ne;0;0;1;1
11805;Šermukšnėlė;ŠIAUDINUKAI;9012757607;Ne;0;4;0;4
11806;Šermukšnėlė;ŠIAUDINUKAI;5627334876;Ne;0;0;3;3
11807;Šermukšnėlė;ŠIAUDINUKAI;3550736579;Ne;12;0;0;12
11808;Šermukšnėlė;ŠIAUDINUKAI;5993599994;Ne;9;0;2;11
11809;Šermukšnėlė;ŠIAUDINUKAI;3522028983;Ne;10;0;1;11
11810;Šermukšnėlė;ŠIAUDINUKAI;6077798297;Ne;1;6;2;9
11811;Šermukšnėlė;ŠIAUDINUKAI;2351386211;Ne;4;0;0;4
11812;Šermukšnėlė;ŠIAUDINUKAI;1437314920;Ne;0;5;0;5
11813;Šermukšnėlė;TOŠINUKAI;3994316729;Ne;0;3;0;3
11814;Šermukšnėlė;TOŠINUKAI;7229632099;Ne;0;4;0;4
11815;Šermukšnėlė;TOŠINUKAI;7038705221;Ne;3;4;1;8
11816;Šermukšnėlė;TOŠINUKAI;9035625467;Ne;4;4;0;8
11817;Šermukšnėlė;TOŠINUKAI;3081548524;Ne;0;4;0;4
11818;Šermukšnėlė;TOŠINUKAI;1753169856;Ne;0;1;0;1
11819;Šermukšnėlė;TOŠINUKAI;9442514813;Ne;0;4;0;4
11820;Šermukšnėlė;TOŠINUKAI;9585435700;Ne;4;0;0;4
11821;Šermukšnėlė;TOŠINUKAI;1131780941;Ne;5;2;0;7
11822;Šermukšnėlė;TOŠINUKAI;6286039101;Ne;0;4;0;4
11823;Šermukšnėlė;TOŠINUKAI;9584702487;Ne;0;2;0;2
11824;Šermukšnėlė;TOŠINUKAI;8691777167;Ne;0;1;0;1
11825;Šermukšnėlė;TOŠINUKAI;2534758615;Ne;0;5;0;5
11826;Šermukšnėlė;TOŠINUKAI;1622834854;Ne;1;4;0;5
11827;Šermukšnėlė;TOŠINUKAI;4945395564;Ne;6;0;2;8
11828;Šermukšnėlė;TOŠINUKAI;2163955454;Ne;5;2;0;7
11829;Šermukšnėlė;TOŠINUKAI;7106405983;Ne;0;3;1;4
11830;Šermukšnėlė;ODINUKAI;4422415026;Ne;0;11;0;11
11831;Šermukšnėlė;ODINUKAI;5545018656;Ne;3;4;2;9
11832;Šermukšnėlė;ODINUKAI;2176788727;Ne;0;3;0;3
11833;Šermukšnėlė;ODINUKAI;5575518612;Ne;6;1;0;7
11834;Šermukšnėlė;ODINUKAI;5733540837;Ne;5;4;0;9
11835;Šermukšnėlė;ODINUKAI;7262199284;Ne;0;4;0;4
11836;Šermukšnėlė;ODINUKAI;5159461963;Ne;4;4;0;8
11837;Šermukšnėlė;ODINUKAI;5354978646;Ne;13;0;0;13
11838;Šermukšnėlė;ODINUKAI;1882432812;Ne;0;4;7;11
11839;Šermukšnėlė;ODINUKAI;3949629658;Ne;7;2;0;9
11840;Šermukšnėlė;ODINUKAI;4201283154;Ne;3;4;0;7
11841;Šermukšnėlė;ODINUKAI;6105915822;Ne;3;2;0;5
11842;Šermukšnėlė;ODINUKAI;9742208172;Ne;7;4;1;12
11843;Šermukšnėlė;ODINUKAI;7667114310;Ne;6;4;1;11
11844;Šermukšnėlė;ODINUKAI;7245206247;Ne;0;1;1;2
11845;Šermukšnėlė;ODINUKAI;5397385093;Ne;0;4;4;8
11846;Šermukšnėlė;ODINUKAI;4331948700;Ne;9;4;0;13
11847;Šermukšnėlė;ODINUKAI;6718242890;Ne;5;4;0;9
11848;Šermukšnėlė;ODINUKAI;9664249364;Ne;6;1;0;7
11849;Šermukšnėlė;ODINUKAI;1064222922;Ne;12;4;0;16
11850;Šermukšnėlė;ODINUKAI;7770630580;Ne;2;4;0;6
11851;Šermukšnėlė;ODINUKAI;6194188831;Ne;0;3;0;3
11852;Šermukšnėlė;KRIAUKLELĖS;4256630681;Ne;1;0;1;2
11853;Šermukšnėlė;KRIAUKLELĖS;8117261716;Ne;1;2;0;3
11854;Šermukšnėlė;KRIAUKLELĖS;7458930634;Ne;6;0;2;8
11855;Šermukšnėlė;KRIAUKLELĖS;6342714998;Ne;0;0;1;1
11856;Šermukšnėlė;KRIAUKLELĖS;9074111563;Ne;0;5;0;5
11857;Šermukšnėlė;KRIAUKLELĖS;9908568127;Ne;0;0;2;2
11858;Šermukšnėlė;KRIAUKLELĖS;9783673534;Ne;9;0;0;9
11859;Šermukšnėlė;KRIAUKLELĖS;3002999054;Ne;0;4;0;4
11860;Šermukšnėlė;KRIAUKLELĖS;5408843906;Taip;0;5;0;5
11861;Šermukšnėlė;KRIAUKLELĖS;4810571143;Ne;5;3;0;8
11862;Šermukšnėlė;KRIAUKLELĖS;4219655802;Ne;4;0;1;5
11863;Šermukšnėlė;KRIAUKLELĖS;6797936390;Ne;4;4;0;8
11864;Šermukšnėlė;KRIAUKLELĖS;6286235756;Ne;1;0;1;2
11865;Šermukšnėlė;KRIAUKLELĖS;9246072554;Ne;1;0;0;1
11866;Šermukšnėlė;KRIAUKLELĖS;9080074486;Ne;3;1;5;9
11867;Šermukšnėlė;KRIAUKLELĖS;7098953763;Ne;0;2;0;2
11868;Šermukšnėlė;VYTINUKAI;2235123503;Ne;9;0;0;9
11869;Šermukšnėlė;VYTINUKAI;5605191023;Ne;4;0;0;4
11870;Šermukšnėlė;VYTINUKAI;6928863055;Ne;7;0;2;9
11871;Šermukšnėlė;VYTINUKAI;8558117857;Ne;11;0;0;11
11872;Šermukšnėlė;VYTINUKAI;6531113007;Ne;0;2;0;2
11873;Šermukšnėlė;VYTINUKAI;8437052600;Ne;8;0;0;8
11874;Šermukšnėlė;VYTINUKAI;1318170904;Ne;5;0;0;5
11875;Šermukšnėlė;VYTINUKAI;8200175951;Ne;15;1;0;16
11876;Šermukšnėlė;VYTINUKAI;6149973884;Ne;15;0;0;15
11877;Šermukšnėlė;VYTINUKAI;5874725607;Ne;11;0;0;11
11878;Šermukšnėlė;VYTINUKAI;7532979465;Ne;12;0;0;12
11879;Šermukšnėlė;VYTINUKAI;7834844175;Ne;3;0;0;3
11880;Šermukšnėlė;VYTINUKAI;7211488009;Ne;4;0;0;4
11881;Šermukšnėlė;VYTINUKAI;7546040491;Ne;13;0;0;13
11882;Šermukšnėlė;VYTINUKAI;2698741674;Ne;0;5;0;5
11883;Šermukšnėlė;VYTINUKAI;3359398381;Ne;0;4;0;4
11884;Šermukšnėlė;VYTINUKAI;9872479998;Ne;9;0;0;9
11885;Šermukšnėlė;VYTINUKAI;1312471779;Taip;9;0;0;9
11886;Šermukšnėlė;VYTINUKAI;8802335133;Ne;0;3;0;3
11887;Šermukšnėlė;VYTINUKAI;8632561799;Ne;2;0;1;3
11888;Šermukšnėlė;GINTARĖLIAI;5069572637;Ne;0;3;0;3
11889;Šermukšnėlė;GINTARĖLIAI;8249749948;Ne;9;4;0;13
11890;Šermukšnėlė;GINTARĖLIAI;2989011150;Ne;0;5;0;5
11891;Šermukšnėlė;GINTARĖLIAI;3747531232;Ne;0;4;0;4
11892;Šermukšnėlė;GINTARĖLIAI;1996859146;Ne;2;3;0;5
11893;Šermukšnėlė;GINTARĖLIAI;4176986876;Ne;0;10;0;10
11894;Šermukšnėlė;GINTARĖLIAI;7036078780;Taip;5;5;0;10
11895;Šermukšnėlė;GINTARĖLIAI;1994737857;Ne;0;6;0;6
11896;Šermukšnėlė;GINTARĖLIAI;4619811264;Ne;0;5;0;5
11897;Šermukšnėlė;GINTARĖLIAI;5886893562;Ne;7;6;0;13
11898;Šermukšnėlė;GINTARĖLIAI;4783726095;Ne;0;4;0;4
11899;Šermukšnėlė;GINTARĖLIAI;9714566919;Ne;7;0;0;7
11900;Šermukšnėlė;GINTARĖLIAI;5172187141;Ne;4;3;0;7
11901;Šermukšnėlė;GINTARĖLIAI;3688946505;Ne;10;0;2;12
11902;Šermukšnėlė;GINTARĖLIAI;5905330617;Ne;3;4;0;7
11903;Šermukšnėlė;GINTARĖLIAI;1636944853;Ne;6;10;0;16
11904;Šermukšnėlė;GINTARĖLIAI;7053319091;Ne;0;5;1;6
11905;Šermukšnėlė;GINTARĖLIAI;6351841889;Taip;5;1;0;6
11906;Šermukšnėlė;GINTARĖLIAI;7305013368;Ne;0;1;0;1
11907;Šermukšnėlė;GINTARĖLIAI;6698650179;Ne;7;4;0;11
11908;Šermukšnėlė;GINTARĖLIAI;8541743148;Ne;2;2;0;4
11909;Šermukšnėlė;AKMENUKAI;8407947566;Ne;0;6;1;7
11910;Šermukšnėlė;AKMENUKAI;8669676262;Ne;0;10;0;10
11911;Šermukšnėlė;AKMENUKAI;3148857617;Ne;0;12;0;12
11912;Šermukšnėlė;AKMENUKAI;4965640386;Ne;0;6;3;9
11913;Šermukšnėlė;AKMENUKAI;3639954786;Ne;8;6;8;22
11914;Šermukšnėlė;AKMENUKAI;7843128263;Ne;4;7;0;11
11915;Šermukšnėlė;AKMENUKAI;9805841777;Ne;0;11;0;11
11916;Šermukšnėlė;AKMENUKAI;3945291560;Ne;0;7;0;7
11917;Šermukšnėlė;AKMENUKAI;5660238634;Ne;0;11;0;11
11918;Šermukšnėlė;AKMENUKAI;6067298318;Ne;0;8;0;8
11919;Šermukšnėlė;AKMENUKAI;5678559268;Ne;7;6;1;14
11920;Šermukšnėlė;AKMENUKAI;8479230675;Ne;1;10;0;11
11921;Šermukšnėlė;AKMENUKAI;6162830167;Ne;7;2;0;9
11922;Šermukšnėlė;AKMENUKAI;2913363351;Ne;15;0;2;17
11923;Šermukšnėlė;AKMENUKAI;3613456202;Ne;3;0;3;6
11924;Šermukšnėlė;AKMENUKAI;2506945279;Ne;0;0;1;1
11925;Šermukšnėlė;AKMENUKAI;8709426669;Ne;0;20;0;20
11926;Šermukšnėlė;AKMENUKAI;6585484701;Ne;2;1;0;3
11927;Šermukšnėlė;AKMENUKAI;6599779539;Ne;0;18;0;18
11928;Šermukšnėlė;AKMENUKAI;9876533442;Ne;0;5;6;11
11929;Šermukšnėlė;AKMENUKAI;3653792683;Ne;0;7;1;8
11930;Šermukšnėlė;SIŪLINUKAI;2967000352;Ne;6;4;0;10
11931;Šermukšnėlė;SIŪLINUKAI;4528448735;Ne;0;4;1;5
11932;Šermukšnėlė;SIŪLINUKAI;2740644605;Ne;8;4;0;12
11933;Šermukšnėlė;SIŪLINUKAI;8454298610;Ne;7;0;1;8
11934;Šermukšnėlė;SIŪLINUKAI;6429038861;Ne;2;0;3;5
11935;Šermukšnėlė;SIŪLINUKAI;6429038861;Ne;2;0;3;5
11936;Šermukšnėlė;SIŪLINUKAI;6429038861;Ne;2;0;3;5
11937;Šermukšnėlė;SIŪLINUKAI;6429038861;Ne;2;0;3;5
11938;Šermukšnėlė;SIŪLINUKAI;1819553019;Ne;14;0;1;15
11939;Šermukšnėlė;SIŪLINUKAI;7568969509;Ne;9;4;2;15
11940;Šermukšnėlė;SIŪLINUKAI;7758886713;Ne;0;2;0;2
11941;Šermukšnėlė;SIŪLINUKAI;4390650081;Ne;0;0;5;5
11942;Šermukšnėlė;SIŪLINUKAI;5072021867;Ne;9;2;0;11
11943;Šermukšnėlė;SIŪLINUKAI;7934772640;Ne;5;4;0;9
11944;Šermukšnėlė;SIŪLINUKAI;3994075596;Ne;0;4;1;5
11945;Šermukšnėlė;SIŪLINUKAI;3098629992;Ne;0;3;1;4
11946;Šermukšnėlė;SIŪLINUKAI;6231057889;Ne;3;2;0;5
11947;Šermukšnėlė;SIŪLINUKAI;3106890807;Ne;6;0;1;7
11948;Šermukšnėlė;SIŪLINUKAI;3979766151;Ne;3;0;1;4
11949;Šermukšnėlė;SIŪLINUKAI;9534316724;Ne;10;4;1;15
11950;Šermukšnėlė;SIŪLINUKAI;2705569653;Ne;9;0;4;13
11951;Šermukšnėlė;SIŪLINUKAI;9703804879;Ne;10;0;0;10
11952;Šermukšnėlė;SIŪLINUKAI;1754181467;Ne;0;0;4;4
11953;Šermukšnėlė;SIŪLINUKAI;6030012939;Ne;0;0;2;2
11954;Šermukšnėlė;MEDINUKAi;3819765572;Ne;10;0;0;10
11955;Šermukšnėlė;MEDINUKAi;2868258867;Ne;7;4;0;11
11956;Šermukšnėlė;MEDINUKAi;8301946408;Ne;1;0;0;1
11957;Šermukšnėlė;MEDINUKAi;5483843510;Ne;5;0;4;9
11958;Šermukšnėlė;MEDINUKAi;7832178585;Ne;5;4;0;9
11959;Šermukšnėlė;MEDINUKAi;7523588943;Ne;0;4;0;4
11960;Šermukšnėlė;MEDINUKAi;1931894084;Ne;2;3;1;6
11961;Šermukšnėlė;MEDINUKAi;9535836301;Ne;0;0;2;2
11962;Šermukšnėlė;MEDINUKAi;3138507073;Ne;3;0;3;6
11963;Šermukšnėlė;MEDINUKAi;6778901855;Ne;4;4;0;8
11964;Šermukšnėlė;MEDINUKAi;1502704170;Ne;8;5;1;14
11965;Šermukšnėlė;MEDINUKAi;9247356229;Ne;5;7;0;12
11966;Šermukšnėlė;MEDINUKAi;3206222470;Ne;1;0;1;2
11967;Šermukšnėlė;MEDINUKAi;5751303170;Ne;10;0;2;12
11968;Šermukšnėlė;MEDINUKAi;2810624440;Ne;5;4;0;9
11969;Šermukšnėlė;MEDINUKAi;3955219247;Ne;2;5;0;7
11970;Šermukšnėlė;MEDINUKAi;5564759354;Ne;5;0;1;6
11971;Šermukšnėlė;MEDINUKAi;5081685546;Taip;10;4;0;14
11972;Šermukšnėlė;SKUDURINUKAI;5162694179;Ne;7;3;1;11
11973;Šermukšnėlė;SKUDURINUKAI;4323596263;Ne;1;0;0;1
11974;Šermukšnėlė;SKUDURINUKAI;9005316719;Ne;0;8;0;8
11975;Šermukšnėlė;SKUDURINUKAI;8898016958;Ne;0;0;2;2
11976;Šermukšnėlė;SKUDURINUKAI;7353340444;Ne;4;4;0;8
11977;Šermukšnėlė;SKUDURINUKAI;6618875999;Ne;2;0;1;3
11978;Šermukšnėlė;SKUDURINUKAI;9258544213;Ne;7;0;0;7
11979;Šermukšnėlė;SKUDURINUKAI;4839548718;Ne;7;0;0;7
11980;Šermukšnėlė;SKUDURINUKAI;2154197839;Ne;8;0;0;8
11981;Šermukšnėlė;SKUDURINUKAI;2156273039;Ne;7;0;0;7
11982;Šermukšnėlė;SKUDURINUKAI;9777470572;Ne;0;5;0;5
11983;Šermukšnėlė;SKUDURINUKAI;3024192802;Ne;4;1;1;6
11984;Šermukšnėlė;SKUDURINUKAI;1208356789;Ne;12;0;0;12
11985;Šermukšnėlė;SKUDURINUKAI;6437380493;Ne;6;0;2;8
11986;Šermukšnėlė;SKUDURINUKAI;8726532739;Ne;2;2;0;4
11987;Šermukšnėlė;PAGRANDUKAI;6185588116;Ne;0;0;4;4
11988;Šermukšnėlė;PAGRANDUKAI;1209135668;Ne;5;6;4;15
11989;Šermukšnėlė;PAGRANDUKAI;8641098720;Ne;16;4;0;20
11990;Šermukšnėlė;PAGRANDUKAI;8130815072;Ne;0;7;0;7
11991;Šermukšnėlė;PAGRANDUKAI;9246403711;Ne;8;0;1;9
11992;Šermukšnėlė;PAGRANDUKAI;3105388312;Ne;2;0;4;6
11993;Šermukšnėlė;PAGRANDUKAI;7570038521;Ne;12;6;0;18
11994;Šermukšnėlė;PAGRANDUKAI;4627034424;Ne;15;6;1;22
11995;Šermukšnėlė;PAGRANDUKAI;7777832161;Ne;3;0;1;4
11996;Šermukšnėlė;PAGRANDUKAI;4776535014;Ne;0;3;1;4
11997;Šermukšnėlė;PAGRANDUKAI;1761737605;Ne;10;0;7;17
11998;Šermukšnėlė;PAGRANDUKAI;5397987456;Ne;24;0;2;26
11999;Šermukšnėlė;PAGRANDUKAI;3705620362;Ne;5;0;8;13
12000;Šypsena;NYKŠTUKAI;3806651280;Ne;0;10;4;14
12001;Šypsena;NYKŠTUKAI;4330797734;Ne;0;4;2;6
12002;Šypsena;NYKŠTUKAI;7876871684;Ne;2;3;0;5
12003;Šypsena;NYKŠTUKAI;6055482561;Ne;14;5;0;19
12004;Šypsena;NYKŠTUKAI;6028006499;Ne;4;5;0;9
12005;Šypsena;NYKŠTUKAI;3724483762;Ne;6;5;0;11
12006;Šypsena;NYKŠTUKAI;7817486488;Ne;15;6;1;22
12007;Šypsena;NYKŠTUKAI;9862387726;Ne;3;4;0;7
12008;Šypsena;NYKŠTUKAI;8001187137;Ne;6;2;1;9
12009;Šypsena;NYKŠTUKAI;8094166916;Ne;4;5;0;9
12010;Šypsena;NYKŠTUKAI;5446516798;Ne;4;5;0;9
12011;Šypsena;NYKŠTUKAI;5094556499;Ne;9;4;0;13
12012;Šypsena;NYKŠTUKAI;4496704989;Ne;8;5;8;21
12013;Šypsena;NYKŠTUKAI;7471913547;Ne;0;3;0;3
12014;Šypsena;NYKŠTUKAI;7174068697;Ne;0;1;0;1
12015;Šypsena;NYKŠTUKAI;7905089772;Ne;9;5;0;14
12016;Šypsena;NYKŠTUKAI;7960872132;Ne;0;5;6;11
12017;Šypsena;NYKŠTUKAI;4260693029;Ne;0;9;0;9
12018;Šypsena;SPINDULIUKAI;8627994583;Ne;3;5;0;8
12019;Šypsena;SPINDULIUKAI;9363618080;Ne;0;6;2;8
12020;Šypsena;SPINDULIUKAI;8913058656;Ne;0;4;0;4
12021;Šypsena;SPINDULIUKAI;9702364620;Ne;3;9;0;12
12022;Šypsena;SPINDULIUKAI;8508569167;Ne;0;1;0;1
12023;Šypsena;SPINDULIUKAI;3733757483;Ne;0;3;0;3
12024;Šypsena;SPINDULIUKAI;2179657619;Ne;0;5;0;5
12025;Šypsena;SPINDULIUKAI;2900195046;Ne;7;3;0;10
12026;Šypsena;SPINDULIUKAI;5818211923;Ne;0;6;0;6
12027;Šypsena;SPINDULIUKAI;3724645162;Ne;1;2;0;3
12028;Šypsena;SPINDULIUKAI;8665786789;Ne;8;1;0;9
12029;Šypsena;SPINDULIUKAI;3003901966;Ne;9;8;0;17
12030;Šypsena;SPINDULIUKAI;2182189246;Ne;3;4;0;7
12031;Šypsena;SPINDULIUKAI;1431850136;Ne;4;6;0;10
12032;Šypsena;SPINDULIUKAI;1716274053;Ne;12;6;5;23
12033;Šypsena;SPINDULIUKAI;8439694239;Ne;7;8;0;15
12034;Šypsena;SPINDULIUKAI;6377979434;Ne;5;6;0;11
12035;Šypsena;SPINDULIUKAI;6724776618;Ne;10;6;0;16
12036;Šypsena;SPINDULIUKAI;2790906806;Ne;3;5;0;8
12037;Šypsena;SKRUZDELIUKAI;7898387398;Ne;0;4;0;4
12038;Šypsena;SKRUZDELIUKAI;1324902555;Ne;2;5;0;7
12039;Šypsena;SKRUZDELIUKAI;5222603743;Ne;1;6;0;7
12040;Šypsena;SKRUZDELIUKAI;7120597034;Ne;0;6;4;10
12041;Šypsena;SKRUZDELIUKAI;5879506651;Ne;2;4;0;6
12042;Šypsena;SKRUZDELIUKAI;3823623458;Ne;0;3;0;3
12043;Šypsena;SKRUZDELIUKAI;3429836513;Ne;0;6;23;29
12044;Šypsena;SKRUZDELIUKAI;4695547847;Ne;0;1;1;2
12045;Šypsena;SKRUZDELIUKAI;3901424559;Ne;0;8;0;8
12046;Šypsena;SKRUZDELIUKAI;6713182218;Ne;0;10;0;10
12047;Šypsena;SKRUZDELIUKAI;8215278033;Ne;0;7;0;7
12048;Šypsena;SKRUZDELIUKAI;7537442618;Ne;0;8;0;8
12049;Šypsena;SKRUZDELIUKAI;2584574423;Ne;7;5;0;12
12050;Šypsena;SKRUZDELIUKAI;9704350208;Ne;0;8;0;8
12051;Šypsena;SKRUZDELIUKAI;5906001927;Ne;0;5;0;5
12052;Šypsena;SKRUZDELIUKAI;6951845385;Ne;0;6;0;6
12053;Šypsena;SKRUZDELIUKAI;7877396588;Ne;5;6;0;11
12054;Šypsena;SKRUZDELIUKAI;8765509994;Ne;6;4;0;10
12055;Šypsena;SKRUZDELIUKAI;4520148322;Ne;0;8;0;8
12056;Šypsena;Bitutės;1422418997;Ne;0;5;0;5
12057;Šypsena;Bitutės;2312828770;Ne;3;1;0;4
12058;Šypsena;Bitutės;3130841241;Ne;5;6;0;11
12059;Šypsena;Bitutės;3810433774;Ne;6;11;2;19
12060;Šypsena;Bitutės;9623451754;Ne;0;6;0;6
12061;Šypsena;Bitutės;5611440056;Ne;4;3;0;7
12062;Šypsena;Bitutės;1114341518;Ne;6;0;0;6
12063;Šypsena;Bitutės;1558614852;Ne;0;5;0;5
12064;Šypsena;Bitutės;1897176871;Ne;5;5;0;10
12065;Šypsena;Bitutės;1181590127;Ne;8;7;0;15
12066;Šypsena;Bitutės;4808041625;Ne;1;6;0;7
12067;Šypsena;Bitutės;5834057370;Ne;0;12;0;12
12068;Šypsena;Bitutės;3809171499;Ne;6;6;0;12
12069;Šypsena;Bitutės;5928432220;Ne;0;3;1;4
12070;Šypsena;Bitutės;5504570516;Ne;0;5;0;5
12071;Šypsena;Bitutės;1063834589;Ne;0;5;0;5
12072;Šypsena;Bitutės;5369445077;Ne;0;5;0;5
12073;Šypsena;Bitutės;2798819321;Ne;0;6;0;6
12074;Šypsena;Bitutės;4450146424;Ne;0;3;0;3
12075;Šypsena;MEŠKIUKAI;9696633725;Taip;5;2;0;7
12076;Šypsena;MEŠKIUKAI;4011596895;Ne;2;2;0;4
12077;Šypsena;MEŠKIUKAI;7234904026;Ne;14;1;0;15
12078;Šypsena;MEŠKIUKAI;3951000812;Ne;0;12;0;12
12079;Šypsena;MEŠKIUKAI;2177181171;Ne;17;0;0;17
12080;Šypsena;MEŠKIUKAI;1657019248;Ne;0;3;0;3
12081;Šypsena;MEŠKIUKAI;8756079118;Ne;3;4;0;7
12082;Šypsena;MEŠKIUKAI;4960714853;Ne;2;2;0;4
12083;Šypsena;MEŠKIUKAI;6224937025;Ne;0;3;0;3
12084;Šypsena;MEŠKIUKAI;1934857313;Ne;0;7;0;7
12085;Šypsena;MEŠKIUKAI;8109877136;Ne;6;4;0;10
12086;Šypsena;MEŠKIUKAI;9841955736;Ne;5;4;0;9
12087;Šypsena;MEŠKIUKAI;2692869989;Ne;3;3;0;6
12088;Šypsena;MEŠKIUKAI;3205854107;Ne;12;0;0;12
12089;Šypsena;BORUŽĖLĖS;3563748951;Ne;4;4;0;8
12090;Šypsena;BORUŽĖLĖS;8456684826;Ne;10;3;0;13
12091;Šypsena;BORUŽĖLĖS;1153036896;Ne;3;4;0;7
12092;Šypsena;BORUŽĖLĖS;3624678823;Ne;4;3;0;7
12093;Šypsena;BORUŽĖLĖS;9232229854;Ne;0;5;0;5
12094;Šypsena;BORUŽĖLĖS;1597728767;Ne;0;6;0;6
12095;Šypsena;BORUŽĖLĖS;3285293143;Ne;3;4;0;7
12096;Šypsena;BORUŽĖLĖS;6905376170;Ne;7;0;0;7
12097;Šypsena;BORUŽĖLĖS;3643736553;Ne;0;3;1;4
12098;Šnekutis;DRUGELIŲ;9543014297;Ne;0;2;1;3
12099;Šnekutis;DRUGELIŲ;3096125224;Ne;0;0;6;6
12100;Šnekutis;DRUGELIŲ;3386995244;Ne;5;0;0;5
12101;Šnekutis;DRUGELIŲ;8984597121;Ne;7;0;0;7
12102;Šnekutis;DRUGELIŲ;8810371475;Ne;0;0;4;4
12103;Šnekutis;DRUGELIŲ;7680962037;Ne;0;19;0;19
12104;Šnekutis;DRUGELIŲ;3611064172;Ne;6;4;0;10
12105;Šnekutis;DRUGELIŲ;8209686459;Ne;0;5;0;5
12106;Šnekutis;DRUGELIŲ;8036600501;Ne;2;4;0;6
12107;Šnekutis;DRUGELIŲ;1556960616;Ne;2;4;0;6
12108;Šnekutis;DRUGELIŲ;4380966487;Ne;4;0;0;4
12109;Šnekutis;DRUGELIŲ;7954240439;Ne;15;4;0;19
12110;Šnekutis;DRUGELIŲ;6330033887;Ne;0;8;0;8
12111;Šnekutis;DRUGELIŲ;6071004512;Ne;5;2;3;10
12112;Šnekutis;DRUGELIŲ;1504945841;Ne;14;5;0;19
12113;Šnekutis;DRUGELIŲ;3177449195;Ne;0;1;0;1
12114;Šnekutis;DRUGELIŲ;6305168453;Ne;0;0;1;1
12115;Šnekutis;DRUGELIŲ;1902486846;Ne;3;0;2;5
12116;Šnekutis;Kačiukų;2914145045;Ne;15;0;0;15
12117;Šnekutis;Kačiukų;2656152037;Ne;0;4;0;4
12118;Šnekutis;Kačiukų;5521822696;Ne;0;4;1;5
12119;Šnekutis;Kačiukų;2144568225;Ne;16;0;0;16
12120;Šnekutis;Kačiukų;4624075875;Ne;6;0;0;6
12121;Šnekutis;Kačiukų;5828953086;Ne;7;0;3;10
12122;Šnekutis;Kačiukų;3635781445;Ne;11;0;2;13
12123;Šnekutis;Kačiukų;7109850241;Ne;4;0;2;6
12124;Šnekutis;Kačiukų;2386547087;Ne;3;0;2;5
12125;Šnekutis;Kačiukų;6072420827;Ne;11;0;0;11
12126;Šnekutis;Kačiukų;2626247219;Ne;3;1;0;4
12127;Šnekutis;Kačiukų;7707897830;Ne;7;0;0;7
12128;Šnekutis;Kačiukų;2852111627;Ne;0;4;2;6
12129;Šnekutis;Kačiukų;3214549246;Ne;8;0;0;8
12130;Šnekutis;Kačiukų;9574210410;Ne;0;4;0;4
12131;Šnekutis;Kačiukų;8417485561;Ne;0;4;0;4
12132;Šnekutis;Kačiukų;2042842873;Ne;0;10;0;10
12133;Šnekutis;Kačiukų;5727476284;Ne;10;0;1;11
12134;Šnekutis;Kačiukų;7391278306;Ne;4;0;1;5
12135;Šnekutis;Kačiukų;5590071706;Ne;5;0;0;5
12136;Šnekutis;Pėlėdžiukų;4835202527;Ne;0;2;0;2
12137;Šnekutis;Pėlėdžiukų;7089000987;Ne;0;1;0;1
12138;Šnekutis;Pėlėdžiukų;9326455786;Ne;6;0;0;6
12139;Šnekutis;Pėlėdžiukų;2843483435;Ne;0;4;0;4
12140;Šnekutis;Pėlėdžiukų;6405894763;Ne;0;7;0;7
12141;Šnekutis;Pėlėdžiukų;3889176018;Taip;5;0;0;5
12142;Šnekutis;Pėlėdžiukų;9054899440;Ne;2;2;1;5
12143;Šnekutis;Pėlėdžiukų;9862362744;Ne;9;0;0;9
12144;Šnekutis;Pėlėdžiukų;6015384795;Ne;4;0;0;4
12145;Šnekutis;Pėlėdžiukų;7307895397;Ne;0;0;2;2
12146;Šnekutis;Pėlėdžiukų;3371393656;Ne;19;0;0;19
12147;Šnekutis;Pėlėdžiukų;5597629090;Ne;0;4;0;4
12148;Šnekutis;Pėlėdžiukų;3344425033;Ne;3;0;0;3
12149;Šnekutis;Pėlėdžiukų;6544973632;Ne;4;0;0;4
12150;Šnekutis;Pėlėdžiukų;8219465079;Ne;0;6;0;6
12151;Šnekutis;Pėlėdžiukų;2779793970;Ne;3;0;0;3
12152;Šnekutis;Pėlėdžiukų;6146988521;Taip;0;4;0;4
12153;Šnekutis;Pėlėdžiukų;5519015388;Ne;0;4;1;5
12154;Šnekutis;Pėlėdžiukų;3628210526;Ne;0;4;0;4
12155;Šnekutis;Pėlėdžiukų;5970951526;Taip;0;0;2;2
12156;Šnekutis;Pėlėdžiukų;3937465849;Ne;7;2;0;9
12157;Šnekutis;Boružėlių;9887692849;Ne;1;0;1;2
12158;Šnekutis;Boružėlių;1833392181;Ne;2;0;0;2
12159;Šnekutis;Boružėlių;3115675798;Ne;11;0;0;11
12160;Šnekutis;Boružėlių;1805259980;Ne;8;0;0;8
12161;Šnekutis;Boružėlių;9790241725;Ne;5;0;1;6
12162;Šnekutis;Boružėlių;5934631354;Ne;5;0;3;8
12163;Šnekutis;Boružėlių;7006343288;Ne;12;0;0;12
12164;Šnekutis;Boružėlių;9322106995;Ne;7;0;2;9
12165;Šnekutis;Boružėlių;1248466603;Ne;15;0;0;15
12166;Šnekutis;Boružėlių;3842436406;Ne;10;0;1;11
12167;Šnekutis;Boružėlių;9772257715;Taip;3;3;0;6
12168;Šnekutis;Boružėlių;3593766968;Ne;7;0;0;7
12169;Šnekutis;Boružėlių;5919317274;Ne;0;0;4;4
12170;Šnekutis;Boružėlių;7200356364;Ne;8;0;0;8
12171;Šnekutis;Boružėlių;9709701441;Ne;0;2;0;2
12172;Šnekutis;Boružėlių;6306269165;Taip;0;0;1;1
12173;Šnekutis;Boružėlių;2761479685;Taip;1;0;0;1
12174;Šnekutis;Boružėlių;8456957469;Ne;4;0;0;4
12175;Šnekutis;Boružėlių;1475304511;Ne;6;0;0;6
12176;Šnekutis;Boružėlių;6669530657;Ne;9;0;0;9
12177;Šnekutis;Meškučių;1219175855;Ne;2;0;1;3
12178;Šnekutis;Meškučių;7980166125;Ne;8;1;0;9
12179;Šnekutis;Meškučių;6041045276;Ne;5;0;0;5
12180;Šnekutis;Meškučių;2134556666;Ne;14;0;0;14
12181;Šnekutis;Meškučių;7775818807;Ne;2;1;0;3
12182;Šnekutis;Meškučių;9752334636;Ne;5;0;0;5
12183;Šnekutis;Meškučių;7704236799;Ne;1;0;0;1
12184;Šnekutis;Meškučių;8612528998;Ne;5;0;0;5
12185;Šnekutis;Meškučių;6915324469;Ne;5;4;0;9
12186;Šnekutis;Meškučių;5785972840;Ne;11;0;0;11
12187;Šnekutis;Meškučių;4963132460;Ne;9;0;0;9
12188;Šnekutis;Meškučių;5506037153;Ne;3;0;0;3
12189;Šnekutis;Meškučių;1772197145;Ne;14;0;0;14
12190;Šnekutis;Meškučių;4452941417;Ne;3;0;1;4
12191;Šnekutis;Meškučių;8332860563;Ne;8;0;0;8
12192;Šnekutis;Meškučių;3173995001;Ne;4;0;1;5
12193;Šnekutis;Meškučių;2615956847;Ne;19;0;0;19
12194;Šnekutis;Viščiukų;3588737003;Ne;0;14;0;14
12195;Šnekutis;Viščiukų;4848437026;Ne;10;0;0;10
12196;Šnekutis;Viščiukų;5059417996;Ne;2;1;0;3
12197;Šnekutis;Viščiukų;7914683654;Ne;11;4;0;15
12198;Šnekutis;Viščiukų;6849168221;Ne;12;0;0;12
12199;Šnekutis;Viščiukų;2817345948;Ne;12;0;0;12
12200;Šnekutis;Viščiukų;8061450452;Ne;11;0;1;12
12201;Šnekutis;Viščiukų;9238064074;Ne;12;0;0;12
12202;Šnekutis;Viščiukų;2258811969;Ne;7;4;0;11
12203;Šnekutis;Viščiukų;3852214850;Ne;9;0;0;9
12204;Šnekutis;Viščiukų;9433668798;Ne;14;3;0;17
12205;Šnekutis;Viščiukų;8241953257;Ne;8;0;0;8
12206;Šnekutis;Viščiukų;5185096482;Ne;11;4;0;15
12207;Šnekutis;Viščiukų;8900769157;Ne;5;4;0;9
12208;Šnekutis;Viščiukų;1811580823;Ne;10;0;0;10
12209;Šnekutis;Viščiukų;9385583890;Ne;3;13;3;19
12210;Užupiukas;VYTURĖLIŲ;9807212956;Ne;19;0;0;19
12211;Užupiukas;VYTURĖLIŲ;5182110542;Ne;0;0;3;3
12212;Užupiukas;VYTURĖLIŲ;3690562985;Ne;2;3;0;5
12213;Užupiukas;VYTURĖLIŲ;7034777770;Ne;0;0;5;5
12214;Užupiukas;VYTURĖLIŲ;4449466321;Ne;0;0;4;4
12215;Užupiukas;VYTURĖLIŲ;9872846882;Ne;5;0;6;11
12216;Užupiukas;VYTURĖLIŲ;5694960072;Ne;0;0;5;5
12217;Užupiukas;VYTURĖLIŲ;3879735445;Ne;6;0;6;12
12218;Užupiukas;VYTURĖLIŲ;2377079878;Ne;4;5;0;9
12219;Užupiukas;VYTURĖLIŲ;3474990673;Ne;9;0;1;10
12220;Užupiukas;VYTURĖLIŲ;1434083187;Ne;5;3;0;8
12221;Užupiukas;VYTURĖLIŲ;5851602817;Ne;0;0;5;5
12222;Užupiukas;VYTURĖLIŲ;8601594247;Ne;0;0;3;3
12223;Užupiukas;VYTURĖLIŲ;9556937880;Ne;5;5;1;11
12224;Užupiukas;VYTURĖLIŲ;4055044580;Ne;1;0;5;6
12225;Užupiukas;VYTURĖLIŲ;3654349639;Ne;0;4;0;4
12226;Užupiukas;VYTURĖLIŲ;3275112189;Ne;10;3;1;14
12227;Užupiukas;VYTURĖLIŲ;5280778870;Ne;0;4;5;9
12228;Užupiukas;VYTURĖLIŲ;7735497084;Ne;0;4;3;7
12229;Užupiukas;VYTURĖLIŲ;9278445367;Ne;15;4;0;19
12230;Užupiukas;VYTURĖLIŲ;8931872728;Ne;0;0;3;3
12231;Užupiukas;KAČIUKŲ;3905448176;Ne;0;1;0;1
12232;Užupiukas;KAČIUKŲ;3567963511;Ne;0;4;3;7
12233;Užupiukas;KAČIUKŲ;9991552624;Ne;1;4;0;5
12234;Užupiukas;KAČIUKŲ;3048959458;Ne;0;4;3;7
12235;Užupiukas;KAČIUKŲ;1809036046;Ne;5;4;0;9
12236;Užupiukas;KAČIUKŲ;1102468034;Ne;0;4;0;4
12237;Užupiukas;KAČIUKŲ;1464016943;Ne;5;4;1;10
12238;Užupiukas;KAČIUKŲ;1102293237;Ne;0;2;0;2
12239;Užupiukas;KAČIUKŲ;9386211193;Ne;0;4;0;4
12240;Užupiukas;KAČIUKŲ;1388346927;Ne;0;2;0;2
12241;Užupiukas;KAČIUKŲ;9333587467;Ne;0;4;1;5
12242;Užupiukas;KAČIUKŲ;7092857844;Ne;0;4;2;6
12243;Užupiukas;KAČIUKŲ;2606742144;Ne;0;4;0;4
12244;Užupiukas;KAČIUKŲ;3543913063;Ne;5;4;0;9
12245;Užupiukas;KAČIUKŲ;4920190785;Ne;0;7;0;7
12246;Užupiukas;KAČIUKŲ;1414888906;Ne;0;4;1;5
12247;Užupiukas;KAČIUKŲ;5436401811;Ne;0;4;1;5
12248;Užupiukas;KAČIUKŲ;3001874900;Ne;7;4;0;11
12249;Užupiukas;KAČIUKŲ;1930961813;Ne;0;4;0;4
12250;Užupiukas;KAČIUKŲ;3794021404;Ne;0;4;0;4
12251;Užupiukas;KAČIUKŲ;6685567970;Ne;3;4;0;7
12252;Užupiukas;DRUGELIŲ;8876174256;Ne;15;0;0;15
12253;Užupiukas;DRUGELIŲ;5239006321;Ne;0;5;1;6
12254;Užupiukas;DRUGELIŲ;7581152903;Ne;5;5;0;10
12255;Užupiukas;DRUGELIŲ;6698907535;Ne;0;5;0;5
12256;Užupiukas;DRUGELIŲ;3419182422;Ne;6;1;0;7
12257;Užupiukas;DRUGELIŲ;4854016957;Ne;4;5;2;11
12258;Užupiukas;DRUGELIŲ;4595291532;Ne;0;4;0;4
12259;Užupiukas;DRUGELIŲ;3383643388;Ne;8;4;0;12
12260;Užupiukas;DRUGELIŲ;3961733676;Ne;7;5;0;12
12261;Užupiukas;DRUGELIŲ;5006880916;Ne;5;4;0;9
12262;Užupiukas;DRUGELIŲ;9715624372;Ne;4;5;0;9
12263;Užupiukas;DRUGELIŲ;1108429907;Ne;5;5;0;10
12264;Užupiukas;DRUGELIŲ;9295230331;Ne;10;0;2;12
12265;Užupiukas;DRUGELIŲ;3575209839;Ne;0;3;0;3
12266;Užupiukas;DRUGELIŲ;5361599156;Ne;0;4;0;4
12267;Užupiukas;DRUGELIŲ;9577167600;Ne;5;4;0;9
12268;Užupiukas;DRUGELIŲ;8692826414;Ne;0;2;0;2
12269;Užupiukas;DRUGELIŲ;3940029893;Ne;0;2;0;2
12270;Užupiukas;DRUGELIŲ;1156471313;Ne;0;5;1;6
12271;Užupiukas;DRUGELIŲ;4075611307;Ne;0;1;0;1
12272;Užupiukas;DRUGELIŲ;4680027403;Ne;7;2;2;11
12273;Užupiukas;DRUGELIŲ;4507631652;Ne;0;2;0;2
12274;Užupiukas;EŽIUKŲ;8936209423;Ne;9;0;3;12
12275;Užupiukas;EŽIUKŲ;2522356285;Ne;8;2;0;10
12276;Užupiukas;EŽIUKŲ;5055376157;Ne;7;3;0;10
12277;Užupiukas;EŽIUKŲ;3235855849;Ne;0;0;2;2
12278;Užupiukas;EŽIUKŲ;9116065216;Ne;0;0;3;3
12279;Užupiukas;EŽIUKŲ;4788900708;Ne;11;0;0;11
12280;Užupiukas;EŽIUKŲ;4670096314;Ne;14;0;0;14
12281;Užupiukas;EŽIUKŲ;7914295007;Ne;10;0;0;10
12282;Užupiukas;EŽIUKŲ;7671705684;Ne;8;0;2;10
12283;Užupiukas;EŽIUKŲ;6016947840;Ne;6;4;1;11
12284;Užupiukas;EŽIUKŲ;8443732431;Ne;11;0;0;11
12285;Užupiukas;EŽIUKŲ;4583779329;Ne;14;0;2;16
12286;Užupiukas;EŽIUKŲ;1757695746;Ne;14;0;2;16
12287;Užupiukas;EŽIUKŲ;4357253574;Ne;15;0;1;16
12288;Užupiukas;EŽIUKŲ;7299810108;Ne;6;6;0;12
12289;Užupiukas;EŽIUKŲ;1989125835;Ne;0;0;18;18
12290;Užupiukas;EŽIUKŲ;5866437622;Ne;14;0;1;15
12291;Užupiukas;EŽIUKŲ;5784908270;Ne;6;3;1;10
12292;Užupiukas;EŽIUKŲ;9163947073;Ne;6;4;0;10
12293;Užupiukas;EŽIUKŲ;4034821342;Ne;10;2;0;12
12294;Užupiukas;EŽIUKŲ;7589905741;Ne;6;0;4;10
12295;Užupiukas;BORUŽĖLIŲ;8467502933;Ne;13;4;0;17
12296;Užupiukas;BORUŽĖLIŲ;4151757682;Ne;0;4;2;6
12297;Užupiukas;BORUŽĖLIŲ;3014087333;Ne;0;2;0;2
12298;Užupiukas;BORUŽĖLIŲ;1891855020;Ne;0;1;0;1
12299;Užupiukas;BORUŽĖLIŲ;1473606331;Ne;10;4;0;14
12300;Užupiukas;BORUŽĖLIŲ;9312234251;Ne;0;4;0;4
12301;Užupiukas;BORUŽĖLIŲ;5381329362;Ne;0;1;0;1
12302;Užupiukas;BORUŽĖLIŲ;4570457987;Ne;10;4;1;15
12303;Užupiukas;BORUŽĖLIŲ;6206118484;Ne;0;3;0;3
12304;Užupiukas;BORUŽĖLIŲ;4841475687;Ne;4;0;2;6
12305;Užupiukas;BORUŽĖLIŲ;9714322911;Ne;0;4;2;6
12306;Užupiukas;BORUŽĖLIŲ;7107441792;Ne;5;4;1;10
12307;Užupiukas;BORUŽĖLIŲ;7105857162;Ne;7;2;0;9
12308;Užupiukas;BORUŽĖLIŲ;8881187663;Ne;5;0;0;5
12309;Užupiukas;BORUŽĖLIŲ;7895825571;Ne;9;4;0;13
12310;Užupiukas;BORUŽĖLIŲ;8518137669;Ne;7;4;0;11
12311;Užupiukas;BORUŽĖLIŲ;7169272175;Ne;8;4;0;12
12312;Užupiukas;BORUŽĖLIŲ;7716893423;Ne;0;3;0;3
12313;Užupiukas;BORUŽĖLIŲ;6857321547;Ne;12;4;0;16
12314;Užupiukas;SPINDULIUKŲ;7443013255;Ne;0;4;0;4
12315;Užupiukas;SPINDULIUKŲ;3656400244;Ne;0;4;3;7
12316;Užupiukas;SPINDULIUKŲ;5718382826;Ne;10;4;1;15
12317;Užupiukas;SPINDULIUKŲ;2580733127;Ne;0;4;2;6
12318;Užupiukas;SPINDULIUKŲ;1791922219;Ne;5;3;1;9
12319;Užupiukas;SPINDULIUKŲ;1146968021;Ne;0;4;0;4
12320;Užupiukas;SPINDULIUKŲ;3829013911;Ne;0;4;1;5
12321;Užupiukas;SPINDULIUKŲ;9212428150;Ne;0;4;3;7
12322;Užupiukas;SPINDULIUKŲ;8001099421;Ne;10;3;0;13
12323;Užupiukas;SPINDULIUKŲ;4401569800;Ne;0;4;0;4
12324;Užupiukas;SPINDULIUKŲ;1391826582;Ne;2;4;1;7
12325;Užupiukas;SPINDULIUKŲ;5021163099;Ne;0;10;0;10
12326;Užupiukas;SPINDULIUKŲ;8960813016;Ne;5;4;0;9
12327;Užupiukas;SPINDULIUKŲ;9132605734;Ne;0;4;1;5
12328;Užupiukas;SPINDULIUKŲ;8347350503;Ne;4;4;1;9
12329;Užupiukas;SPINDULIUKŲ;7532497390;Ne;13;4;0;17
12330;Užupiukas;SPINDULIUKŲ;9209209113;Ne;4;4;2;10
12331;Užupiukas;SPINDULIUKŲ;5168946019;Ne;0;3;0;3
12332;Užupiukas;SPINDULIUKŲ;5116564840;Ne;3;4;1;8
12333;Užupiukas;SPINDULIUKŲ;8519118225;Ne;8;3;0;11
12334;Užupiukas;SPINDULIUKŲ;7549628277;Ne;8;3;0;11
12335;Užupiukas;ŽVIRBLIUKŲ;5085660507;Ne;5;8;0;13
12336;Užupiukas;ŽVIRBLIUKŲ;2273766308;Ne;4;4;2;10
12337;Užupiukas;ŽVIRBLIUKŲ;9925592494;Ne;2;2;0;4
12338;Užupiukas;ŽVIRBLIUKŲ;7345579721;Ne;0;7;0;7
12339;Užupiukas;ŽVIRBLIUKŲ;4710910251;Ne;0;6;0;6
12340;Užupiukas;ŽVIRBLIUKŲ;9428884149;Ne;0;8;0;8
12341;Užupiukas;ŽVIRBLIUKŲ;2210437775;Ne;0;7;0;7
12342;Užupiukas;ŽVIRBLIUKŲ;1995228207;Ne;0;4;0;4
12343;Užupiukas;ŽVIRBLIUKŲ;1496541880;Ne;5;0;14;19
12344;Užupiukas;ŽVIRBLIUKŲ;1684901495;Ne;0;6;0;6
12345;Užupiukas;ŽVIRBLIUKŲ;2390955083;Ne;0;5;0;5
12346;Užupiukas;ŽVIRBLIUKŲ;6001766518;Ne;0;9;0;9
12347;Užupiukas;ŽVIRBLIUKŲ;3768945773;Ne;0;4;1;5
12348;Užupiukas;ŽVIRBLIUKŲ;3224193396;Ne;0;2;0;2
12349;Užupiukas;ŽVIRBLIUKŲ;4785494419;Ne;0;5;0;5
12350;Užupiukas;ŽVIRBLIUKŲ;8119142600;Ne;6;4;2;12
12351;Užupiukas;ŽVIRBLIUKŲ;2362568676;Ne;0;3;0;3
12352;Užupiukas;ŽVIRBLIUKŲ;7530856195;Ne;0;1;0;1
12353;Užupiukas;ŽVIRBLIUKŲ;4054724625;Ne;3;4;0;7
12354;Užupiukas;ŽVIRBLIUKŲ;6308141378;Ne;0;2;0;2
12355;Užupiukas;ŽVIRBLIUKŲ;1843171673;Ne;0;4;0;4
12356;Užupiukas;ŽVIRBLIUKŲ;9719845726;Ne;0;7;3;10
12357;Užupiukas;ŽVIRBLIUKŲ;1647271985;Ne;0;4;0;4
12358;Užupiukas;PELĖDŽIUKŲ;3398225200;Ne;0;4;0;4
12359;Užupiukas;PELĖDŽIUKŲ;6699322898;Ne;8;4;3;15
12360;Užupiukas;PELĖDŽIUKŲ;5204808398;Ne;0;4;0;4
12361;Užupiukas;PELĖDŽIUKŲ;6512355340;Ne;3;2;0;5
12362;Užupiukas;PELĖDŽIUKŲ;9906475253;Ne;3;4;1;8
12363;Užupiukas;PELĖDŽIUKŲ;3171528288;Ne;0;4;2;6
12364;Užupiukas;PELĖDŽIUKŲ;7860601571;Ne;0;4;1;5
12365;Užupiukas;PELĖDŽIUKŲ;3611922301;Ne;0;4;1;5
12366;Užupiukas;PELĖDŽIUKŲ;8020138690;Ne;0;1;0;1
12367;Užupiukas;PELĖDŽIUKŲ;9774124589;Ne;5;4;0;9
12368;Užupiukas;PELĖDŽIUKŲ;2724216446;Ne;0;5;1;6
12369;Užupiukas;PELĖDŽIUKŲ;6823724962;Ne;0;4;5;9
12370;Užupiukas;PELĖDŽIUKŲ;9446562736;Ne;0;4;0;4
12371;Užupiukas;PELĖDŽIUKŲ;5072363435;Ne;0;4;0;4
12372;Užupiukas;PELĖDŽIUKŲ;1651249962;Ne;0;1;0;1
12373;Užupiukas;PELĖDŽIUKŲ;5538327364;Ne;0;2;0;2
12374;Užupiukas;PELĖDŽIUKŲ;1526296386;Ne;0;3;3;6
12375;Užupiukas;PELĖDŽIUKŲ;8720638097;Ne;4;4;0;8
12376;Užupiukas;PELĖDŽIUKŲ;3057147440;Ne;0;3;0;3
12377;Užupiukas;PELĖDŽIUKŲ;6370918943;Ne;0;4;2;6
12378;Užupiukas;PELĖDŽIUKŲ;1100574872;Ne;0;4;1;5
12379;Užupiukas;PELĖDŽIUKŲ;9357101972;Ne;3;4;0;7
12380;Užupiukas;VARPELIŲ;7919242126;Ne;0;0;6;6
12381;Užupiukas;VARPELIŲ;9310238442;Ne;0;0;1;1
12382;Užupiukas;VARPELIŲ;5941280824;Ne;0;0;8;8
12383;Užupiukas;VARPELIŲ;2485426055;Ne;7;0;4;11
12384;Užupiukas;VARPELIŲ;7314085267;Ne;9;0;0;9
12385;Užupiukas;VARPELIŲ;2752139377;Ne;4;0;0;4
12386;Užupiukas;VARPELIŲ;4106614478;Ne;8;1;0;9
12387;Užupiukas;VARPELIŲ;1407429980;Ne;0;0;3;3
12388;Užupiukas;VARPELIŲ;2767523129;Ne;0;0;2;2
12389;Užupiukas;VARPELIŲ;9523512906;Ne;14;0;0;14
12390;Užupiukas;VARPELIŲ;3745080560;Ne;3;0;1;4
12391;Užupiukas;VARPELIŲ;5148672602;Ne;0;0;11;11
12392;Užupiukas;VARPELIŲ;2769924857;Ne;0;0;5;5
12393;Užupiukas;VARPELIŲ;7837545732;Ne;0;0;4;4
12394;Užupiukas;VARPELIŲ;4112143599;Ne;6;0;0;6
12395;Užupiukas;VARPELIŲ;7628420639;Ne;19;0;0;19
12396;Užupiukas;VARPELIŲ;6879206867;Ne;2;0;2;4
12397;Užupiukas;VARPELIŲ;4206519159;Ne;0;0;7;7
12398;Užupiukas;VARPELIŲ;9514298829;Ne;0;0;4;4
12399;Užupiukas;VARPELIŲ;3394103404;Ne;0;0;4;4
12400;Užupiukas;VARPELIŲ;4446988239;Ne;9;0;1;10
12401;Užupiukas;SAULUČIŲ;5704945892;Ne;0;4;1;5
12402;Užupiukas;SAULUČIŲ;2681679016;Ne;0;3;4;7
12403;Užupiukas;SAULUČIŲ;3684774901;Ne;0;4;0;4
12404;Užupiukas;SAULUČIŲ;8163092636;Ne;0;0;3;3
12405;Užupiukas;SAULUČIŲ;1976775494;Ne;0;4;1;5
12406;Užupiukas;SAULUČIŲ;5874450724;Ne;0;0;3;3
12407;Užupiukas;SAULUČIŲ;3341292382;Ne;14;0;0;14
12408;Užupiukas;SAULUČIŲ;2211595125;Ne;0;4;1;5
12409;Užupiukas;SAULUČIŲ;5570569874;Ne;0;4;0;4
12410;Užupiukas;SAULUČIŲ;7643286183;Ne;3;4;0;7
12411;Užupiukas;SAULUČIŲ;2814556305;Ne;0;4;2;6
12412;Užupiukas;SAULUČIŲ;7209853233;Ne;0;3;0;3
12413;Užupiukas;SAULUČIŲ;9953994943;Ne;6;7;0;13
12414;Užupiukas;SAULUČIŲ;7956550754;Ne;9;4;0;13
12415;Užupiukas;SAULUČIŲ;5469735455;Ne;0;4;2;6
12416;Užupiukas;SAULUČIŲ;8489545569;Ne;4;4;2;10
12417;Užupiukas;SAULUČIŲ;7990479988;Ne;0;0;1;1
12418;Užupiukas;SAULUČIŲ;4691413468;Ne;3;4;0;7
12419;Užupiukas;SAULUČIŲ;7423292334;Ne;0;6;2;8
12420;Užupiukas;SAULUČIŲ;9216626936;Ne;6;4;0;10
12421;Užupiukas;SAULUČIŲ;9962455415;Ne;0;0;3;3
12422;Užupiukas;SAULUČIŲ;9709440406;Ne;2;3;0;5
12423;Užupiukas;SAULUČIŲ;9434907771;Ne;0;0;3;3
12424;Užupiukas;LAPIUKŲ;9833934299;Ne;8;4;0;12
12425;Užupiukas;LAPIUKŲ;4963679583;Ne;3;3;0;6
12426;Užupiukas;LAPIUKŲ;6004467875;Ne;0;4;0;4
12427;Užupiukas;LAPIUKŲ;1718048938;Ne;0;4;0;4
12428;Užupiukas;LAPIUKŲ;7986962850;Ne;0;4;2;6
12429;Užupiukas;LAPIUKŲ;2517606394;Ne;0;0;4;4
12430;Užupiukas;LAPIUKŲ;5965564175;Ne;0;3;0;3
12431;Užupiukas;LAPIUKŲ;5680350014;Ne;0;4;0;4
12432;Užupiukas;LAPIUKŲ;7161001771;Ne;2;5;0;7
12433;Užupiukas;LAPIUKŲ;1886792898;Ne;0;4;0;4
12434;Užupiukas;LAPIUKŲ;6967184410;Ne;0;4;2;6
12435;Užupiukas;LAPIUKŲ;1178152392;Ne;4;4;0;8
12436;Užupiukas;LAPIUKŲ;7029091978;Ne;0;3;0;3
12437;Užupiukas;LAPIUKŲ;3311694266;Ne;0;5;0;5
12438;Užupiukas;LAPIUKŲ;1041972540;Ne;0;4;0;4
12439;Užupiukas;LAPIUKŲ;4467470795;Ne;0;4;0;4
12440;Užupiukas;LAPIUKŲ;3333547785;Ne;3;5;0;8
12441;Užupiukas;LAPIUKŲ;8529259340;Ne;6;5;0;11
12442;Užupiukas;LAPIUKŲ;7487174943;Ne;0;3;0;3
12443;Užupiukas;LAPIUKŲ;8252575784;Ne;7;4;0;11
12444;Užupiukas;LAPIUKŲ;4900699267;Ne;2;1;0;3
12445;Užupiukas;LAPIUKŲ;7247347675;Ne;2;6;0;8
12446;Užupiukas;NYKŠTUKŲ;1399112659;Ne;5;3;1;9
12447;Užupiukas;NYKŠTUKŲ;4379182756;Ne;0;14;0;14
12448;Užupiukas;NYKŠTUKŲ;9785674147;Ne;0;14;0;14
12449;Užupiukas;NYKŠTUKŲ;3094320206;Ne;0;14;0;14
12450;Užupiukas;NYKŠTUKŲ;9118614894;Ne;5;0;2;7
12451;Užupiukas;NYKŠTUKŲ;1358906847;Ne;5;0;2;7
12452;Užupiukas;NYKŠTUKŲ;6628511386;Ne;6;0;3;9
12453;Užupiukas;NYKŠTUKŲ;8158567147;Ne;0;0;13;13
12454;Užupiukas;NYKŠTUKŲ;9580855533;Ne;0;0;13;13
12455;Užupiukas;NYKŠTUKŲ;9345093498;Ne;10;0;2;12
12456;Užupiukas;NYKŠTUKŲ;5343951688;Ne;4;0;4;8
12457;Užupiukas;NYKŠTUKŲ;5556719499;Ne;0;2;5;7
12458;Užupiukas;NYKŠTUKŲ;6716173079;Ne;5;4;0;9
12459;Užupiukas;NYKŠTUKŲ;4441941216;Ne;10;4;2;16
12460;Užupiukas;NYKŠTUKŲ;4489962171;Ne;5;4;0;9
12461;Užupiukas;NYKŠTUKŲ;1139748215;Ne;2;2;2;6
12462;Vaidilutė;Žiogelis;9568450630;Ne;6;2;0;8
12463;Vaidilutė;Žiogelis;8789527552;Ne;0;3;0;3
12464;Vaidilutė;Žiogelis;7319037375;Ne;0;4;0;4
12465;Vaidilutė;Žiogelis;4838951446;Ne;0;5;0;5
12466;Vaidilutė;Žiogelis;7494818866;Ne;0;4;2;6
12467;Vaidilutė;Žiogelis;5500950179;Ne;5;4;0;9
12468;Vaidilutė;Žiogelis;7306768961;Ne;0;4;1;5
12469;Vaidilutė;Žiogelis;7532115462;Ne;9;4;0;13
12470;Vaidilutė;Žiogelis;9437865610;Ne;0;4;1;5
12471;Vaidilutė;Žiogelis;1140011879;Ne;0;3;0;3
12472;Vaidilutė;Žiogelis;9563257771;Ne;0;5;0;5
12473;Vaidilutė;Žiogelis;3059654988;Ne;6;6;2;14
12474;Vaidilutė;Žiogelis;1341696594;Ne;3;4;0;7
12475;Vaidilutė;Žiogelis;1141947715;Ne;0;4;3;7
12476;Vaidilutė;Žiogelis;5482030284;Ne;0;4;1;5
12477;Vaidilutė;Žiogelis;8505156287;Ne;5;4;1;10
12478;Vaidilutė;Žiogelis;2189753894;Ne;0;4;5;9
12479;Vaidilutė;Žiogelis;2081959307;Ne;6;4;2;12
12480;Vaidilutė;Žiogelis;1171844031;Ne;0;4;0;4
12481;Vaidilutė;Rūtelė;6449710777;Ne;0;2;0;2
12482;Vaidilutė;Rūtelė;2444426554;Ne;0;2;0;2
12483;Vaidilutė;Rūtelė;4887753072;Ne;0;4;0;4
12484;Vaidilutė;Rūtelė;2876157676;Ne;7;0;0;7
12485;Vaidilutė;Rūtelė;3557654689;Ne;5;0;1;6
12486;Vaidilutė;Rūtelė;8257746012;Ne;4;0;1;5
12487;Vaidilutė;Rūtelė;8444010416;Ne;6;0;1;7
12488;Vaidilutė;Rūtelė;4568108299;Ne;0;0;3;3
12489;Vaidilutė;Rūtelė;1998966302;Ne;0;0;1;1
12490;Vaidilutė;Rūtelė;5026620305;Ne;0;0;6;6
12491;Vaidilutė;Rūtelė;3826303389;Ne;5;0;3;8
12492;Vaidilutė;Rūtelė;4469754560;Ne;3;0;0;3
12493;Vaidilutė;Rūtelė;8433116520;Ne;3;0;1;4
12494;Vaidilutė;Rūtelė;5918039529;Ne;0;0;4;4
12495;Vaidilutė;Rūtelė;3850868701;Ne;0;0;1;1
12496;Vaidilutė;Rūtelė;7660273021;Ne;0;4;8;12
12497;Vaidilutė;Rūtelė;6795083491;Ne;0;19;0;19
12498;Vaidilutė;Rūtelė;6604575848;Ne;0;19;0;19
12499;Vaidilutė;Rūtelė;7649954695;Ne;0;0;1;1
12500;Vaidilutė;Rūtelė;5797505797;Ne;0;0;3;3
12501;Vaidilutė;Voveraitė;3248203941;Ne;0;0;1;1
12502;Vaidilutė;Voveraitė;1608646909;Ne;15;0;0;15
12503;Vaidilutė;Voveraitė;9429544108;Ne;0;0;1;1
12504;Vaidilutė;Voveraitė;5652381296;Ne;0;0;3;3
12505;Vaidilutė;Voveraitė;8377824920;Ne;0;9;0;9
12506;Vaidilutė;Voveraitė;5296146822;Ne;0;2;0;2
12507;Vaidilutė;Voveraitė;3299081380;Ne;0;0;4;4
12508;Vaidilutė;Voveraitė;3634285869;Ne;10;0;9;19
12509;Vaidilutė;Voveraitė;7703578508;Ne;0;0;9;9
12510;Vaidilutė;Voveraitė;3150642420;Ne;0;0;2;2
12511;Vaidilutė;Voveraitė;5855762068;Ne;3;4;0;7
12512;Vaidilutė;Voveraitė;8177787790;Ne;0;4;0;4
12513;Vaidilutė;Voveraitė;7327131165;Ne;0;6;9;15
12514;Vaidilutė;Voveraitė;2318578603;Ne;0;4;3;7
12515;Vaidilutė;Voveraitė;9372280434;Ne;2;1;3;6
12516;Vaidilutė;Voveraitė;1372767364;Ne;5;4;3;12
12517;Vaidilutė;Voveraitė;7478943531;Ne;0;3;0;3
12518;Vaidilutė;Voveraitė;4738318120;Ne;0;14;0;14
12519;Vaidilutė;Voveraitė;3319615121;Ne;0;0;5;5
12520;Vaidilutė;Voveraitė;6299324271;Ne;0;1;2;3
12521;Vaidilutė;Voveraitė;4186708502;Ne;0;0;6;6
12522;Vaidilutė;Voveraitė;2855672500;Ne;0;10;0;10
12523;Vaidilutė;Voveraitė;8053548602;Ne;5;0;13;18
12524;Vaidilutė;Saulutė;2164241264;Ne;4;0;1;5
12525;Vaidilutė;Saulutė;4648985217;Ne;0;3;0;3
12526;Vaidilutė;Saulutė;4805621473;Ne;0;4;0;4
12527;Vaidilutė;Saulutė;4348206726;Ne;0;3;1;4
12528;Vaidilutė;Saulutė;5008411199;Ne;0;0;3;3
12529;Vaidilutė;Saulutė;5405461987;Ne;0;1;4;5
12530;Vaidilutė;Saulutė;6928815317;Ne;5;0;5;10
12531;Vaidilutė;Saulutė;1283676263;Ne;0;0;4;4
12532;Vaidilutė;Saulutė;6239494382;Ne;0;2;1;3
12533;Vaidilutė;Saulutė;8629789128;Ne;0;0;5;5
12534;Vaidilutė;Saulutė;8413764934;Ne;6;0;3;9
12535;Vaidilutė;Saulutė;2315322608;Ne;18;0;0;18
12536;Vaidilutė;Saulutė;7019245743;Ne;5;0;0;5
12537;Vaidilutė;Saulutė;7075509397;Ne;0;3;0;3
12538;Vaidilutė;Saulutė;8012451263;Ne;0;0;4;4
12539;Vaidilutė;Saulutė;4760330697;Ne;0;0;3;3
12540;Vaidilutė;Saulutė;5205356977;Ne;0;3;1;4
12541;Vaidilutė;Saulutė;5095161432;Ne;5;0;3;8
12542;Vaidilutė;Saulutė;7572407329;Ne;4;4;0;8
12543;Vaidilutė;Saulutė;4963577351;Ne;13;0;1;14
12544;Vaidilutė;Saulutė;6527155865;Ne;8;0;4;12
12545;Vaidilutė;Žibutė;4085959509;Taip;10;7;0;17
12546;Vaidilutė;Žibutė;1001320466;Ne;3;0;0;3
12547;Vaidilutė;Žibutė;3051006765;Ne;1;0;1;2
12548;Vaidilutė;Žibutė;9189713003;Ne;0;1;0;1
12549;Vaidilutė;Žibutė;7903242996;Ne;16;0;1;17
12550;Vaidilutė;Žibutė;7400197367;Ne;0;5;0;5
12551;Vaidilutė;Žibutė;5236154349;Ne;9;0;0;9
12552;Vaidilutė;Žibutė;3980894528;Ne;3;1;0;4
12553;Vaidilutė;Žibutė;1362256314;Ne;0;6;0;6
12554;Vaidilutė;Žibutė;7940581813;Ne;5;3;1;9
12555;Vaidilutė;Žibutė;2767482145;Ne;0;0;2;2
12556;Vaidilutė;Žibutė;7765298370;Ne;8;0;0;8
12557;Vaidilutė;Žibutė;8769601956;Ne;0;1;0;1
12558;Vaidilutė;Žibutė;1726638921;Ne;6;6;2;14
12559;Vaidilutė;Žibutė;5415279154;Ne;0;4;0;4
12560;Vaidilutė;Žibutė;1377015807;Ne;0;0;2;2
12561;Vaidilutė;Žibutė;4124217264;Ne;0;4;2;6
12562;Vaidilutė;Žibutė;7429825620;Ne;13;0;0;13
12563;Vaidilutė;Žibutė;3087959868;Ne;0;1;0;1
12564;Vaidilutė;Žibutė;7690470762;Ne;11;0;0;11
12565;Vaidilutė;Žibutė;1606864068;Ne;7;0;0;7
12566;Vaidilutė;"Ąžuoliukas ";3463112472;Ne;6;0;1;7
12567;Vaidilutė;"Ąžuoliukas ";3730573432;Ne;11;1;0;12
12568;Vaidilutė;"Ąžuoliukas ";6586072228;Ne;0;4;0;4
12569;Vaidilutė;"Ąžuoliukas ";5988376676;Ne;9;2;3;14
12570;Vaidilutė;"Ąžuoliukas ";1305478052;Ne;0;10;2;12
12571;Vaidilutė;"Ąžuoliukas ";4954285515;Ne;5;6;3;14
12572;Vaidilutė;"Ąžuoliukas ";5556351358;Ne;0;6;0;6
12573;Vaidilutė;"Ąžuoliukas ";5439973183;Ne;5;4;0;9
12574;Vaidilutė;"Ąžuoliukas ";4761992071;Ne;0;0;4;4
12575;Vaidilutė;"Ąžuoliukas ";3381544575;Ne;4;6;0;10
12576;Vaidilutė;"Ąžuoliukas ";5307486959;Ne;3;4;1;8
12577;Vaidilutė;"Ąžuoliukas ";1653497170;Ne;4;4;1;9
12578;Vaidilutė;"Ąžuoliukas ";1440819171;Ne;0;4;2;6
12579;Vaidilutė;"Ąžuoliukas ";2668758195;Ne;0;4;1;5
12580;Vaidilutė;"Ąžuoliukas ";4901387311;Ne;6;4;0;10
12581;Vaidilutė;"Ąžuoliukas ";9811981645;Ne;0;3;1;4
12582;Vaidilutė;"Ąžuoliukas ";2997948252;Ne;0;0;14;14
12583;Vaidilutė;"Ąžuoliukas ";9723156071;Ne;14;3;0;17
12584;Vaidilutė;"Ąžuoliukas ";4193108560;Ne;7;0;1;8
12585;Vaidilutė;"Ąžuoliukas ";3782651091;Ne;4;0;1;5
12586;Vaidilutė;"Ąžuoliukas ";6637224510;Ne;0;4;10;14
12587;Vaidilutė;"Ąžuoliukas ";6067801976;Ne;0;0;6;6
12588;Vaidilutė;"Žemuogėlė ";2131127298;Ne;0;3;1;4
12589;Vaidilutė;"Žemuogėlė ";2014160468;Ne;0;4;0;4
12590;Vaidilutė;"Žemuogėlė ";4680645841;Ne;0;3;6;9
12591;Vaidilutė;"Žemuogėlė ";2662468804;Ne;0;4;0;4
12592;Vaidilutė;"Žemuogėlė ";5217609332;Ne;0;4;1;5
12593;Vaidilutė;"Žemuogėlė ";8492055287;Ne;0;4;7;11
12594;Vaidilutė;"Žemuogėlė ";5945744595;Ne;5;5;0;10
12595;Vaidilutė;"Žemuogėlė ";2864731541;Ne;10;4;0;14
12596;Vaidilutė;"Žemuogėlė ";1998872078;Ne;3;3;0;6
12597;Vaidilutė;"Žemuogėlė ";2468220275;Ne;0;4;3;7
12598;Vaidilutė;"Žemuogėlė ";6844372910;Ne;0;2;3;5
12599;Vaidilutė;"Žemuogėlė ";4972645715;Ne;0;4;1;5
12600;Vaidilutė;"Žemuogėlė ";1610262589;Ne;5;2;0;7
12601;Vaidilutė;"Žemuogėlė ";2356037175;Ne;2;3;2;7
12602;Vaidilutė;"Žemuogėlė ";5054640268;Ne;0;4;2;6
12603;Vaidilutė;"Žemuogėlė ";6885473308;Ne;0;1;0;1
12604;Vaidilutė;"Žemuogėlė ";1092821241;Ne;0;1;0;1
12605;Vaidilutė;"Žemuogėlė ";7826111890;Ne;2;0;0;2
12606;Vaidilutė;"Žemuogėlė ";1355005114;Ne;0;4;0;4
12607;Vaidilutė;"Žemuogėlė ";2294802783;Ne;4;5;1;10
12608;Vaidilutė;"Žemuogėlė ";2419903023;Ne;19;0;0;19
12609;Vaidilutė;"Vyturėlis ";3121914268;Ne;9;0;2;11
12610;Vaidilutė;"Vyturėlis ";5050251048;Ne;0;4;0;4
12611;Vaidilutė;"Vyturėlis ";7106410219;Ne;7;0;2;9
12612;Vaidilutė;"Vyturėlis ";9558983004;Ne;0;13;0;13
12613;Vaidilutė;"Vyturėlis ";5326935037;Ne;1;5;0;6
12614;Vaidilutė;"Vyturėlis ";9689388330;Ne;3;4;0;7
12615;Vaidilutė;"Vyturėlis ";1539700521;Ne;5;0;0;5
12616;Vaidilutė;"Vyturėlis ";4230076320;Ne;2;4;0;6
12617;Vaidilutė;"Vyturėlis ";8628545847;Ne;0;1;3;4
12618;Vaidilutė;"Vyturėlis ";4388069915;Ne;6;1;0;7
12619;Vaidilutė;"Vyturėlis ";1401180999;Ne;3;4;0;7
12620;Vaidilutė;"Vyturėlis ";1417828163;Ne;5;4;0;9
12621;Vaidilutė;"Vyturėlis ";5651628204;Ne;0;1;0;1
12622;Vaidilutė;"Vyturėlis ";2251608691;Ne;0;0;1;1
12623;Vaidilutė;"Vyturėlis ";7914006128;Ne;5;0;0;5
12624;Vaidilutė;"Vyturėlis ";7131561558;Ne;0;5;1;6
12625;Vaidilutė;"Vyturėlis ";2194984060;Ne;10;4;0;14
12626;Vaidilutė;"Vyturėlis ";3351968717;Ne;0;3;0;3
12627;Vaidilutė;"Vyturėlis ";1732848786;Ne;19;0;0;19
12628;Vaidilutė;"Varpelis ";6250831269;Ne;0;3;0;3
12629;Vaidilutė;"Varpelis ";2763266518;Ne;0;8;0;8
12630;Vaidilutė;"Varpelis ";6037349527;Ne;11;4;1;16
12631;Vaidilutė;"Varpelis ";5867501558;Ne;0;4;0;4
12632;Vaidilutė;"Varpelis ";3832349858;Ne;5;3;2;10
12633;Vaidilutė;"Varpelis ";9317774960;Ne;2;2;0;4
12634;Vaidilutė;"Varpelis ";5448014291;Ne;0;3;0;3
12635;Vaidilutė;"Varpelis ";3497795848;Ne;0;3;0;3
12636;Vaidilutė;"Varpelis ";4280822951;Ne;0;4;1;5
12637;Vaidilutė;"Varpelis ";6107554047;Ne;8;0;0;8
12638;Vaidilutė;"Varpelis ";3453045619;Ne;0;4;1;5
12639;Vaidilutė;"Varpelis ";6022130248;Ne;0;3;0;3
12640;Vaidilutė;"Varpelis ";5101104226;Ne;2;0;0;2
12641;Vaidilutė;"Varpelis ";5594121340;Ne;0;3;0;3
12642;Vaidilutė;"Varpelis ";1882829340;Ne;5;2;2;9
12643;Vaidilutė;"Varpelis ";6097229427;Ne;0;4;0;4
12644;Vaidilutė;"Varpelis ";3353827105;Ne;10;3;0;13
12645;Vaidilutė;"Varpelis ";4362797606;Ne;8;5;0;13
12646;Vaidilutė;"Varpelis ";6322986820;Ne;2;3;0;5
12647;Vaidilutė;"Varpelis ";2941550026;Ne;0;4;8;12
12648;Vaidilutė;"Varpelis ";2058071219;Ne;12;4;1;17
12649;Vaidilutė;"Boružėlių ";2401619665;Ne;4;0;4;8
12650;Vaidilutė;"Boružėlių ";7992756674;Taip;5;10;0;15
12651;Vaidilutė;"Boružėlių ";4202779406;Ne;0;6;0;6
12652;Vaidilutė;"Boružėlių ";9206804444;Ne;3;0;0;3
12653;Vaidilutė;"Boružėlių ";9323633666;Ne;5;0;0;5
12654;Vaidilutė;"Boružėlių ";4826719079;Ne;5;0;0;5
12655;Vaidilutė;"Boružėlių ";7163100596;Ne;6;0;0;6
12656;Vaidilutė;"Boružėlių ";1924346626;Ne;15;0;0;15
12657;Vaidilutė;"Boružėlių ";7535557733;Ne;15;0;0;15
12658;Vaidilutė;"Boružėlių ";7082436875;Ne;4;0;2;6
12659;Vaidilutė;"Boružėlių ";1224632280;Ne;8;3;0;11
12660;Vaidilutė;"Boružėlių ";7916111396;Ne;9;0;0;9
12661;Vaidilutė;"Boružėlių ";7605835683;Ne;13;0;0;13
12662;Vaidilutė;"Boružėlių ";2194687285;Ne;13;0;0;13
12663;Vaidilutė;"Malūnelis ";8212137096;Ne;6;0;0;6
12664;Vaidilutė;"Malūnelis ";7406210603;Ne;0;4;15;19
12665;Vaidilutė;"Malūnelis ";6688767475;Ne;0;0;1;1
12666;Vaidilutė;"Malūnelis ";3509892176;Ne;10;0;0;10
12667;Vaidilutė;"Malūnelis ";9183056003;Ne;3;0;0;3
12668;Vaidilutė;"Malūnelis ";1562042820;Ne;0;0;1;1
12669;Vaidilutė;"Malūnelis ";6001198563;Ne;7;2;0;9
12670;Vaidilutė;"Malūnelis ";7109743847;Ne;9;8;0;17
12671;Vaidilutė;"Malūnelis ";7036611507;Ne;9;0;0;9
12672;Vaidilutė;"Malūnelis ";9007565120;Ne;4;1;0;5
12673;Vaidilutė;"Malūnelis ";2393977201;Ne;10;0;0;10
12674;Vaidilutė;"Malūnelis ";8042617129;Ne;2;0;0;2
12675;Vaidilutė;"Malūnelis ";5415659432;Ne;9;0;0;9
12676;Vaidilutė;"Malūnelis ";6541442524;Ne;14;0;2;16
12677;Vaidilutė;"Riešutėlis ";3605988018;Ne;0;0;4;4
12678;Vaidilutė;"Riešutėlis ";1161455376;Ne;0;0;3;3
12679;Vaidilutė;"Riešutėlis ";4518002596;Ne;1;0;4;5
12680;Vaidilutė;"Riešutėlis ";4657952465;Ne;0;0;3;3
12681;Vaidilutė;"Riešutėlis ";8756807918;Ne;0;0;14;14
12682;Vaidilutė;"Riešutėlis ";9782176726;Ne;9;0;0;9
12683;Vaidilutė;"Riešutėlis ";1206696843;Ne;0;7;0;7
12684;Vaidilutė;"Riešutėlis ";9872915544;Ne;0;4;0;4
12685;Vaidilutė;"Riešutėlis ";2976615414;Ne;0;0;7;7
12686;Vaidilutė;"Riešutėlis ";4709977896;Ne;0;2;0;2
12687;Vaidilutė;"Riešutėlis ";2409760986;Ne;6;0;1;7
12688;Vaidilutė;"Riešutėlis ";4051575845;Ne;3;4;1;8
12689;Vaidilutė;"Riešutėlis ";9025469107;Ne;0;0;12;12
12690;Vaidilutė;"Riešutėlis ";3862444839;Ne;0;0;4;4
12691;Vaidilutė;"Riešutėlis ";9567786222;Ne;0;0;2;2
12692;Vaidilutė;"Riešutėlis ";3321127541;Ne;0;0;1;1
12693;Vaidilutė;"Riešutėlis ";3064988592;Ne;0;0;9;9
12694;Vaidilutė;"Riešutėlis ";7043895152;Ne;0;0;4;4
12695;Vaidilutė;"Riešutėlis ";8296567629;Ne;5;0;0;5
12696;Vaidilutė;"Riešutėlis ";7871629009;Ne;0;0;7;7
12697;Vandenis;ŽUVĖDRŲ;5362078687;Ne;0;4;0;4
12698;Vandenis;ŽUVĖDRŲ;6784010746;Ne;2;6;0;8
12699;Vandenis;ŽUVĖDRŲ;2238926097;Ne;0;2;0;2
12700;Vandenis;ŽUVĖDRŲ;9334958945;Ne;5;4;0;9
12701;Vandenis;ŽUVĖDRŲ;7447487403;Ne;0;1;0;1
12702;Vandenis;ŽUVĖDRŲ;7646133208;Ne;0;4;0;4
12703;Vandenis;ŽUVĖDRŲ;4303303483;Ne;3;5;0;8
12704;Vandenis;ŽUVĖDRŲ;2325465812;Ne;5;4;0;9
12705;Vandenis;ŽUVĖDRŲ;2649542586;Ne;0;7;0;7
12706;Vandenis;ŽUVĖDRŲ;1144490168;Ne;0;4;0;4
12707;Vandenis;ŽUVĖDRŲ;7948161881;Ne;0;3;0;3
12708;Vandenis;ŽUVĖDRŲ;7391206543;Ne;0;4;0;4
12709;Vandenis;ŽUVĖDRŲ;9335319713;Ne;5;5;0;10
12710;Vandenis;ŽUVĖDRŲ;6068154206;Ne;1;3;0;4
12711;Vandenis;ŽUVĖDRŲ;7296608892;Ne;0;6;0;6
12712;Vandenis;ŽUVĖDRŲ;4117091634;Ne;0;4;0;4
12713;Vandenis;ŽUVĖDRŲ;5408971428;Ne;2;1;0;3
12714;Vandenis;ŽUVĖDRŲ;2276497021;Ne;1;1;0;2
12715;Vandenis;ŽUVĖDRŲ;6063181697;Ne;0;3;0;3
12716;Vandenis;ŽUVĖDRŲ;6661117114;Ne;10;3;0;13
12717;Vandenis;ŽUVĖDRŲ;5112768778;Ne;0;12;0;12
12718;Vandenis;ŽUVĖDRŲ;6456557095;Ne;5;0;0;5
12719;Vandenis;RUONIUKŲ;9756270419;Ne;5;3;0;8
12720;Vandenis;RUONIUKŲ;5438770600;Ne;2;3;0;5
12721;Vandenis;RUONIUKŲ;6851036864;Ne;6;0;0;6
12722;Vandenis;RUONIUKŲ;2144282854;Ne;7;2;0;9
12723;Vandenis;RUONIUKŲ;1969144957;Ne;3;5;0;8
12724;Vandenis;RUONIUKŲ;4319584977;Ne;19;0;0;19
12725;Vandenis;RUONIUKŲ;7950837626;Ne;15;0;0;15
12726;Vandenis;RUONIUKŲ;8001157954;Ne;0;2;0;2
12727;Vandenis;RUONIUKŲ;6882874044;Ne;11;0;0;11
12728;Vandenis;RUONIUKŲ;9178978753;Ne;3;0;0;3
12729;Vandenis;RUONIUKŲ;9095152994;Ne;5;7;0;12
12730;Vandenis;RUONIUKŲ;9756750533;Ne;5;3;0;8
12731;Vandenis;RUONIUKŲ;4525906178;Ne;0;4;0;4
12732;Vandenis;RUONIUKŲ;9316297713;Ne;19;0;0;19
12733;Vandenis;RUONIUKŲ;3101289470;Ne;0;5;0;5
12734;Vandenis;RUONIUKŲ;6134775528;Ne;6;0;0;6
12735;Vandenis;RUONIUKŲ;9542360827;Ne;20;0;0;20
12736;Vandenis;RUONIUKŲ;8047806483;Ne;0;2;0;2
12737;Vandenis;RUONIUKŲ;5516720117;Ne;7;0;0;7
12738;Vandenis;RUONIUKŲ;6008552395;Ne;0;5;0;5
12739;Vandenis;ŽUVYČIŲ;7565308536;Ne;0;6;0;6
12740;Vandenis;ŽUVYČIŲ;1120907086;Ne;2;4;0;6
12741;Vandenis;ŽUVYČIŲ;1563710105;Ne;1;2;0;3
12742;Vandenis;ŽUVYČIŲ;6330187732;Ne;0;7;0;7
12743;Vandenis;ŽUVYČIŲ;9527253920;Ne;0;6;0;6
12744;Vandenis;ŽUVYČIŲ;6158299885;Ne;0;3;0;3
12745;Vandenis;ŽUVYČIŲ;5535901447;Ne;0;5;0;5
12746;Vandenis;ŽUVYČIŲ;8971291182;Ne;0;6;0;6
12747;Vandenis;ŽUVYČIŲ;9688954631;Ne;0;3;0;3
12748;Vandenis;ŽUVYČIŲ;3664560833;Ne;0;5;0;5
12749;Vandenis;ŽUVYČIŲ;7702272913;Ne;2;1;0;3
12750;Vandenis;ŽUVYČIŲ;6476051751;Ne;2;6;0;8
12751;Vandenis;ŽUVYČIŲ;9162936403;Ne;0;4;0;4
12752;Vandenis;ŽUVYČIŲ;1051281257;Ne;4;5;0;9
12753;Vandenis;ŽUVYČIŲ;2422642232;Ne;4;5;0;9
12754;Vandenis;ŽUVYČIŲ;8729351613;Ne;3;1;0;4
12755;Vandenis;ŽUVYČIŲ;6986724058;Ne;0;4;0;4
12756;Vandenis;ŽUVYČIŲ;4971165639;Ne;0;4;0;4
12757;Vandenis;ŽUVYČIŲ;7754158588;Ne;0;4;0;4
12758;Vandenis;ŽUVYČIŲ;9731729915;Ne;0;2;0;2
12759;Vandenis;PERLIUKŲ;8239664149;Ne;5;0;0;5
12760;Vandenis;PERLIUKŲ;2451901210;Ne;4;0;0;4
12761;Vandenis;PERLIUKŲ;6724626527;Ne;10;0;0;10
12762;Vandenis;PERLIUKŲ;1799139825;Ne;3;1;0;4
12763;Vandenis;PERLIUKŲ;1786146371;Ne;10;0;0;10
12764;Vandenis;PERLIUKŲ;6570331247;Ne;5;1;0;6
12765;Vandenis;PERLIUKŲ;3038533882;Ne;4;1;0;5
12766;Vandenis;PERLIUKŲ;3393306645;Ne;0;4;0;4
12767;Vandenis;PERLIUKŲ;2506411643;Ne;0;4;0;4
12768;Vandenis;PERLIUKŲ;8841954633;Ne;10;0;0;10
12769;Vandenis;PERLIUKŲ;7001613448;Ne;10;0;0;10
12770;Vandenis;PERLIUKŲ;2661339448;Ne;3;1;0;4
12771;Vandenis;PERLIUKŲ;5675840354;Ne;0;2;0;2
12772;Vandenis;PERLIUKŲ;9380306986;Ne;0;2;0;2
12773;Vandenis;PERLIUKŲ;1983972864;Ne;6;0;0;6
12774;Vandenis;PERLIUKŲ;3173213991;Ne;0;7;0;7
12775;Vandenis;PERLIUKŲ;6067408982;Ne;0;1;0;1
12776;Vandenis;PERLIUKŲ;7233484054;Ne;0;2;0;2
12777;Vandenis;ANČIUKŲ;4607196473;Ne;10;0;0;10
12778;Vandenis;ANČIUKŲ;9763300020;Ne;5;5;0;10
12779;Vandenis;ANČIUKŲ;9968877035;Ne;0;4;0;4
12780;Vandenis;ANČIUKŲ;3639160500;Ne;0;4;0;4
12781;Vandenis;ANČIUKŲ;9458613523;Ne;0;3;0;3
12782;Vandenis;ANČIUKŲ;1213743099;Ne;0;6;0;6
12783;Vandenis;ANČIUKŲ;4954121871;Ne;5;4;0;9
12784;Vandenis;ANČIUKŲ;8751355814;Ne;0;2;0;2
12785;Vandenis;ANČIUKŲ;4983424940;Ne;1;1;0;2
12786;Vandenis;ANČIUKŲ;4978712442;Ne;0;4;0;4
12787;Vandenis;ANČIUKŲ;7631982912;Ne;0;2;0;2
12788;Vandenis;ANČIUKŲ;7581114286;Ne;0;5;0;5
12789;Vandenis;ANČIUKŲ;9679010239;Ne;2;6;0;8
12790;Vandenis;ANČIUKŲ;1132534461;Ne;0;4;0;4
12791;Vandenis;ANČIUKŲ;3544764716;Ne;2;4;0;6
12792;Vandenis;ANČIUKŲ;4530824157;Ne;0;10;0;10
12793;Vandenis;ANČIUKŲ;4954787474;Ne;3;3;0;6
12794;Vandenis;ANČIUKŲ;8967191975;Ne;3;4;0;7
12795;Vandenis;ANČIUKŲ;9784116399;Ne;6;6;0;12
12796;Vandenis;ANČIUKŲ;4091633411;Ne;0;2;0;2
12797;Vandenis;VĖŽLIUKŲ;2309166304;Ne;1;5;0;6
12798;Vandenis;VĖŽLIUKŲ;2872343656;Ne;2;5;0;7
12799;Vandenis;VĖŽLIUKŲ;5454049563;Ne;3;4;0;7
12800;Vandenis;VĖŽLIUKŲ;9805578141;Ne;3;4;0;7
12801;Vandenis;VĖŽLIUKŲ;8921666108;Ne;4;4;0;8
12802;Vandenis;VĖŽLIUKŲ;7069369080;Ne;2;0;0;2
12803;Vandenis;VĖŽLIUKŲ;7924399684;Ne;0;12;0;12
12804;Vandenis;VĖŽLIUKŲ;1187395353;Ne;6;4;0;10
12805;Vandenis;VĖŽLIUKŲ;7091356848;Ne;0;4;0;4
12806;Vandenis;VĖŽLIUKŲ;5126732658;Ne;0;1;0;1
12807;Vandenis;VĖŽLIUKŲ;7059385610;Ne;4;5;0;9
12808;Vandenis;VĖŽLIUKŲ;1707354287;Ne;5;4;0;9
12809;Vandenis;VĖŽLIUKŲ;4413648496;Ne;11;4;0;15
12810;Vandenis;VĖŽLIUKŲ;9704394568;Ne;5;4;0;9
12811;Vandenis;VĖŽLIUKŲ;4177166475;Ne;0;4;0;4
12812;Vandenis;VĖŽLIUKŲ;5218101579;Ne;1;3;0;4
12813;Vandenis;VĖŽLIUKŲ;8416839037;Ne;0;4;0;4
12814;Vandenis;VĖŽLIUKŲ;2936885357;Ne;5;0;0;5
12815;Vandenis;VĖŽLIUKŲ;8879608849;Ne;5;4;0;9
12816;Vandenis;AŠTUNKOJŲ;3429495073;Ne;0;5;0;5
12817;Vandenis;AŠTUNKOJŲ;6896047075;Ne;0;4;0;4
12818;Vandenis;AŠTUNKOJŲ;9304912028;Ne;0;1;0;1
12819;Vandenis;AŠTUNKOJŲ;5844576485;Ne;0;4;0;4
12820;Vandenis;AŠTUNKOJŲ;6295009202;Ne;0;5;0;5
12821;Vandenis;AŠTUNKOJŲ;3239754791;Ne;9;4;0;13
12822;Vandenis;AŠTUNKOJŲ;7598257845;Ne;0;3;0;3
12823;Vandenis;AŠTUNKOJŲ;5323428164;Ne;0;4;0;4
12824;Vandenis;AŠTUNKOJŲ;6073002418;Ne;0;6;0;6
12825;Vandenis;AŠTUNKOJŲ;5565147603;Ne;0;2;0;2
12826;Vandenis;AŠTUNKOJŲ;2690536940;Ne;0;1;0;1
12827;Vandenis;AŠTUNKOJŲ;2576575249;Ne;11;4;0;15
12828;Vandenis;AŠTUNKOJŲ;7832674282;Ne;0;4;0;4
12829;Vandenis;AŠTUNKOJŲ;9798192239;Ne;2;0;0;2
12830;Vandenis;AŠTUNKOJŲ;5129492284;Ne;0;4;0;4
12831;Vandenis;AŠTUNKOJŲ;1975385430;Ne;0;5;0;5
12832;Vandenis;AŠTUNKOJŲ;3061606138;Ne;0;3;0;3
12833;Vandenis;AŠTUNKOJŲ;8117385209;Ne;5;4;0;9
12834;Vandenis;AŠTUNKOJŲ;5613067534;Ne;0;4;0;4
12835;Vandenis;AŠTUNKOJŲ;2321919298;Ne;8;4;0;12
12836;Vandenis;GANDRIUKŲ;4753416316;Ne;5;0;0;5
12837;Vandenis;GANDRIUKŲ;8264797886;Ne;13;0;0;13
12838;Vandenis;GANDRIUKŲ;9936940067;Ne;1;0;0;1
12839;Vandenis;GANDRIUKŲ;6153669587;Ne;9;0;0;9
12840;Vandenis;GANDRIUKŲ;6260893699;Ne;16;0;0;16
12841;Vandenis;GANDRIUKŲ;1919577714;Ne;19;0;0;19
12842;Vandenis;GANDRIUKŲ;7019646962;Ne;5;5;0;10
12843;Vandenis;GANDRIUKŲ;2078767085;Ne;6;4;0;10
12844;Vandenis;GANDRIUKŲ;2976505868;Ne;10;0;0;10
12845;Vandenis;GANDRIUKŲ;6558155968;Ne;0;5;0;5
12846;Vandenis;GANDRIUKŲ;6691874473;Ne;15;0;0;15
12847;Vandenis;GANDRIUKŲ;6483030616;Ne;15;4;0;19
12848;Vandenis;GANDRIUKŲ;8144830789;Ne;7;0;0;7
12849;Vandenis;GANDRIUKŲ;2381566229;Ne;8;0;0;8
12850;Vandenis;GANDRIUKŲ;5899846599;Ne;10;1;0;11
12851;Vandenis;GANDRIUKŲ;8127873607;Ne;1;1;0;2
12852;Vandenis;GANDRIUKŲ;1606103904;Ne;2;11;0;13
12853;Vandenis;GANDRIUKŲ;1753180703;Ne;1;4;0;5
12854;Vandenis;GANDRIUKŲ;7303512055;Ne;9;0;0;9
12855;Vandenis;GANDRIUKŲ;7311677107;Ne;12;4;0;16
12856;Vandenis;GANDRIUKŲ;6586215199;Ne;2;9;0;11
12857;Vandenis;ŽĄSIUKAI;8034690071;Ne;7;0;0;7
12858;Vandenis;ŽĄSIUKAI;9937317687;Ne;0;5;0;5
12859;Vandenis;ŽĄSIUKAI;2004158593;Ne;1;1;0;2
12860;Vandenis;ŽĄSIUKAI;4984723792;Ne;7;0;0;7
12861;Vandenis;ŽĄSIUKAI;1333381525;Ne;1;2;0;3
12862;Vandenis;ŽĄSIUKAI;7071349847;Ne;0;5;0;5
12863;Vandenis;ŽĄSIUKAI;7070234429;Ne;0;5;0;5
12864;Vandenis;ŽĄSIUKAI;4072405890;Ne;0;3;0;3
12865;Vandenis;ŽĄSIUKAI;5684262347;Ne;2;2;0;4
12866;Vandenis;ŽĄSIUKAI;4349464804;Ne;0;1;0;1
12867;Vandenis;ŽĄSIUKAI;7596199296;Ne;2;8;0;10
12868;Vandenis;ŽĄSIUKAI;5607412408;Ne;0;6;0;6
12869;Vandenis;ŽĄSIUKAI;1925178245;Ne;3;3;0;6
12870;Vandenis;ŽĄSIUKAI;5641929490;Ne;0;3;0;3
12871;Vandenis;ŽĄSIUKAI;7058441500;Ne;0;1;0;1
12872;Vandenis;ŽĄSIUKAI;1850352131;Ne;9;0;0;9
12873;Vandenis;ŽĄSIUKAI;2454959791;Ne;0;6;0;6
12874;Vandenis;ŽĄSIUKAI;9801593009;Ne;8;4;0;12
12875;Vandenis;ŽĄSIUKAI;9093048795;Ne;10;0;0;10
12876;Vandenis;PURIENŲ;6851178154;Ne;0;5;0;5
12877;Vandenis;PURIENŲ;5440027798;Ne;5;2;0;7
12878;Vandenis;PURIENŲ;4455886780;Ne;0;4;0;4
12879;Vandenis;PURIENŲ;1031451445;Ne;0;4;0;4
12880;Vandenis;PURIENŲ;4815210197;Ne;0;4;0;4
12881;Vandenis;PURIENŲ;3337286021;Ne;2;4;0;6
12882;Vandenis;PURIENŲ;7020534318;Ne;5;1;0;6
12883;Vandenis;PURIENŲ;6027680514;Ne;0;3;0;3
12884;Vandenis;PURIENŲ;2960005490;Ne;7;3;0;10
12885;Vandenis;PURIENŲ;1180322026;Ne;7;2;0;9
12886;Vandenis;PURIENŲ;3633805607;Ne;0;5;0;5
12887;Vandenis;PURIENŲ;6332179750;Ne;0;5;0;5
12888;Vandenis;PURIENŲ;2315167746;Ne;0;1;0;1
12889;Vandenis;PURIENŲ;2719678617;Ne;0;4;0;4
12890;Vandenis;PURIENŲ;7171302906;Ne;8;3;0;11
12891;Vandenis;PURIENŲ;8085633453;Ne;7;3;0;10
12892;Vandenis;PURIENŲ;2614561762;Ne;0;3;0;3
12893;Vandenis;PURIENŲ;5764809162;Ne;0;4;0;4
12894;Vandenis;PURIENŲ;1244502945;Ne;0;8;0;8
12895;Vandenis;PURIENŲ;9158541919;Ne;0;4;0;4
12896;Vandenis;PURIENŲ;5959181898;Ne;0;4;0;4
12897;Vandenis;VARLIUKAI;3851301038;Ne;0;1;0;1
12898;Vandenis;VARLIUKAI;1557924470;Ne;4;0;0;4
12899;Vandenis;VARLIUKAI;4467604017;Ne;4;0;0;4
12900;Vandenis;VARLIUKAI;1586318209;Ne;1;4;0;5
12901;Vandenis;VARLIUKAI;1713088739;Ne;6;0;0;6
12902;Vandenis;VARLIUKAI;6348714341;Ne;7;4;0;11
12903;Vandenis;VARLIUKAI;1926484881;Ne;9;0;0;9
12904;Vandenis;VARLIUKAI;8866969905;Ne;3;0;0;3
12905;Vandenis;VARLIUKAI;1587789226;Ne;0;6;0;6
12906;Vandenis;VARLIUKAI;6061476765;Ne;1;2;0;3
12907;Vandenis;VARLIUKAI;4220080362;Ne;10;0;0;10
12908;Vandenis;VARLIUKAI;8642524068;Ne;10;0;0;10
12909;Vandenis;VARLIUKAI;8184314532;Ne;7;4;0;11
12910;Vandenis;VARLIUKAI;6499309064;Ne;6;2;0;8
12911;Vandenis;VARLIUKAI;1321803758;Ne;17;0;0;17
12912;Vandenis;VARLIUKAI;5310917664;Ne;0;4;0;4
12913;Vandenis;VARLIUKAI;3048168468;Ne;4;0;0;4
12914;Vandenis;PINGVINAI;9856199548;Ne;4;0;0;4
12915;Vandenis;PINGVINAI;2209513000;Ne;3;0;0;3
12916;Vandenis;PINGVINAI;2665865704;Ne;4;0;0;4
12917;Vandenis;PINGVINAI;8755050997;Ne;8;1;0;9
12918;Vandenis;PINGVINAI;1780124964;Ne;0;5;0;5
12919;Vandenis;PINGVINAI;9609168578;Ne;0;5;0;5
12920;Vandenis;PINGVINAI;2156775779;Ne;7;5;0;12
12921;Vandenis;PINGVINAI;3360623444;Ne;0;4;0;4
12922;Vandenis;PINGVINAI;5191604973;Ne;5;2;0;7
12923;Vandenis;PINGVINAI;2757376962;Ne;0;4;0;4
12924;Vandenis;PINGVINAI;6992750701;Ne;0;4;0;4
12925;Vandenis;PINGVINAI;3933306911;Ne;12;0;0;12
12926;Vandenis;PINGVINAI;2534991705;Ne;0;4;0;4
12927;Vandenis;PINGVINAI;7267965471;Ne;4;0;0;4
12928;Vandenis;PINGVINAI;5632082019;Ne;0;2;0;2
12929;Vandenis;PINGVINAI;9717294497;Ne;0;2;0;2
12930;Vandenis;PINGVINAI;7770227772;Ne;15;3;0;18
12931;Vandenis;PINGVINAI;8560123112;Ne;0;4;0;4
12932;Vandenis;Debesėlių;3163423293;Ne;0;1;4;5
12933;Vandenis;Debesėlių;6555465114;Ne;6;0;0;6
12934;Vandenis;Debesėlių;4226028904;Taip;10;2;2;14
12935;Vandenis;Debesėlių;2844636823;Ne;5;0;2;7
12936;Vandenis;Debesėlių;2426003664;Ne;0;2;0;2
12937;Vandenis;Debesėlių;8299531021;Taip;5;0;1;6
12938;Vandenis;Debesėlių;9521927635;Ne;1;2;3;6
12939;Vandenis;Debesėlių;6494266251;Ne;10;4;0;14
12940;Vandenis;Debesėlių;3835819023;Ne;2;2;3;7
12941;Vandenis;Debesėlių;2953842982;Ne;9;2;2;13
12942;Vandenis;Debesėlių;2645775090;Ne;4;8;0;12
12943;Vandenis;Debesėlių;8678508812;Ne;0;6;0;6
12944;Vandenis;Debesėlių;5609737826;Ne;0;0;10;10
12945;Vandenis;Debesėlių;5963181638;Ne;0;1;0;1
12946;Vandenis;Debesėlių;6327478049;Ne;0;0;18;18
12947;Vandenis;Debesėlių;3231434944;Ne;0;2;17;19
12948;Vandenis;Debesėlių;6003491409;Ne;0;5;0;5
12949;Vandenis;Debesėlių;5690075288;Ne;1;2;2;5
12950;Vandenis;Debesėlių;3701053997;Ne;14;4;0;18
12951;Vandenis;Debesėlių;1081283323;Ne;0;4;0;4
12952;Vandenis;Debesėlių;1081283323;Ne;0;4;0;4
12953;Vandenis;Debesėlių;1081283323;Ne;0;4;0;4
12954;Vandenis;Gintarėlių;1542662577;Ne;10;0;0;10
12955;Vandenis;Gintarėlių;5683829836;Ne;5;0;0;5
12956;Vandenis;Gintarėlių;5560529824;Ne;0;6;0;6
12957;Vandenis;Gintarėlių;5874429309;Ne;2;3;0;5
12958;Vandenis;Gintarėlių;7318344804;Ne;5;2;0;7
12959;Vandenis;Gintarėlių;7884422309;Ne;12;4;0;16
12960;Vandenis;Gintarėlių;8420609325;Ne;13;0;0;13
12961;Vandenis;Gintarėlių;5071489844;Ne;1;0;0;1
12962;Vandenis;Gintarėlių;5081501601;Ne;4;6;0;10
12963;Vandenis;Gintarėlių;9498231306;Ne;0;4;0;4
12964;Vandenis;Gintarėlių;3968719760;Ne;9;0;0;9
12965;Vandenis;Gintarėlių;4565893472;Ne;11;0;0;11
12966;Vandenis;Gintarėlių;3342147138;Ne;19;0;0;19
12967;Vandenis;Gintarėlių;7959438279;Ne;6;0;0;6
12968;Vandenis;Gintarėlių;1788652447;Ne;5;0;0;5
12969;Vandenis;Gintarėlių;5540306590;Ne;0;3;0;3
12970;Vandenis;Gintarėlių;4459177302;Ne;3;0;0;3
12971;Vandenis;Gintarėlių;3672852524;Ne;12;0;0;12
12972;Vandenis;Gintarėlių;4069657268;Ne;1;4;0;5
12973;Vandenis;Gintarėlių;9899621226;Ne;2;0;0;2
12974;Vandenis;Lašelių;1233236350;Ne;11;2;0;13
12975;Vandenis;Lašelių;5459023317;Ne;8;0;0;8
12976;Vandenis;Lašelių;2475761158;Ne;18;0;0;18
12977;Vandenis;Lašelių;6869501724;Ne;6;2;0;8
12978;Vandenis;Lašelių;4575455479;Ne;6;0;0;6
12979;Vandenis;Lašelių;8860667587;Ne;9;0;0;9
12980;Vandenis;Lašelių;8609549799;Ne;8;0;0;8
12981;Vandenis;Lašelių;5434744285;Ne;8;2;0;10
12982;Vandenis;Lašelių;5207600083;Ne;9;0;0;9
12983;Vandenis;Lašelių;2440317162;Ne;7;0;0;7
12984;Vandenis;Lašelių;7544597355;Ne;10;1;0;11
12985;Vandenis;Lašelių;7095534371;Ne;12;0;0;12
12986;Vandenis;Lašelių;1636387018;Ne;23;0;0;23
12987;Vandenis;Lašelių;5440102024;Ne;4;1;0;5
12988;Vandenis;Lašelių;6025496917;Ne;10;0;0;10
12989;Vandenis;Burbuliukų;5144953316;Ne;4;2;0;6
12990;Vandenis;Burbuliukų;3750162497;Ne;15;0;0;15
12991;Vandenis;Burbuliukų;6068144373;Ne;5;0;0;5
12992;Vandenis;Burbuliukų;2783738727;Ne;0;5;0;5
12993;Vandenis;Burbuliukų;2998970043;Ne;5;2;0;7
12994;Vandenis;Burbuliukų;7080129095;Ne;5;2;0;7
12995;Vandenis;Burbuliukų;7856148436;Ne;9;0;0;9
12996;Vandenis;Burbuliukų;1035549424;Ne;7;1;0;8
12997;Vandenis;Burbuliukų;7492804255;Ne;7;0;0;7
12998;Vandenis;Burbuliukų;4483401826;Ne;3;4;0;7
12999;Vandenis;Burbuliukų;9314410776;Ne;7;3;0;10
13000;Vandenis;Burbuliukų;2647966131;Ne;0;2;0;2
13001;Vandenis;Burbuliukų;5545019790;Ne;15;2;0;17
13002;Vandenis;Burbuliukų;9128547685;Ne;15;2;0;17
13003;Vandenis;Burbuliukų;6731336385;Ne;10;4;0;14
13004;Vandenis;Kriauklyčių;9130870495;Ne;9;2;0;11
13005;Vandenis;Kriauklyčių;2578294768;Ne;1;5;0;6
13006;Vandenis;Kriauklyčių;7736505435;Ne;3;2;0;5
13007;Vandenis;Kriauklyčių;5362018982;Ne;7;3;0;10
13008;Vandenis;Kriauklyčių;4219981694;Ne;8;2;0;10
13009;Vandenis;Kriauklyčių;8703465445;Ne;12;0;0;12
13010;Vandenis;Kriauklyčių;5983635986;Ne;3;3;1;7
13011;Vandenis;Kriauklyčių;4373688502;Ne;0;6;0;6
13012;Vandenis;Kriauklyčių;8921398489;Ne;15;6;0;21
13013;Vandenis;Kriauklyčių;6112591131;Ne;0;4;0;4
13014;Vandenis;Kriauklyčių;2528214535;Ne;8;1;3;12
13015;Vandenis;Kriauklyčių;6848032146;Ne;7;6;0;13
13016;Vandenis;Kriauklyčių;1836082819;Ne;0;1;0;1
13017;Vandenis;Kriauklyčių;2945086818;Ne;0;0;1;1
13018;Vandenis;Kriauklyčių;3262634002;Ne;6;1;0;7
13019;Vandenis;Kriauklyčių;3820448467;Ne;0;5;0;5
13020;Vandenis;Kriauklyčių;4168391832;Ne;0;2;0;2
13021;Vandenis;Kriauklyčių;2883058280;Ne;1;1;0;2
13022;Vandenis;Kriauklyčių;2997649372;Ne;16;3;0;19
13023;Vandenis;Kriauklyčių;9400150352;Ne;2;7;1;10
13024;Vėjelis;Pumpurėliai;2541077369;Ne;0;1;0;1
13025;Vėjelis;Pumpurėliai;3125815427;Ne;7;1;4;12
13026;Vėjelis;Pumpurėliai;5516672613;Ne;5;3;0;8
13027;Vėjelis;Pumpurėliai;2866394056;Ne;0;3;0;3
13028;Vėjelis;Pumpurėliai;3206025676;Ne;5;4;0;9
13029;Vėjelis;Pumpurėliai;5611813359;Ne;0;6;0;6
13030;Vėjelis;Pumpurėliai;1057586168;Ne;0;1;1;2
13031;Vėjelis;Pumpurėliai;9583495324;Ne;0;4;0;4
13032;Vėjelis;Pumpurėliai;7539681314;Ne;6;4;0;10
13033;Vėjelis;Pumpurėliai;3081923183;Ne;0;1;2;3
13034;Vėjelis;Pumpurėliai;9003601108;Ne;0;1;2;3
13035;Vėjelis;Pumpurėliai;6168648640;Ne;5;4;0;9
13036;Vėjelis;Pumpurėliai;6840643273;Ne;3;9;0;12
13037;Vėjelis;Pumpurėliai;9824130744;Ne;5;2;0;7
13038;Vėjelis;Pumpurėliai;1842552329;Ne;7;0;6;13
13039;Vėjelis;Pumpurėliai;8994680698;Ne;0;5;0;5
13040;Vėjelis;Pumpurėliai;2656895893;Ne;0;6;0;6
13041;Vėjelis;Pumpurėliai;2734891342;Taip;3;7;0;10
13042;Vėjelis;Pumpurėliai;7748975870;Taip;0;7;0;7
13043;Vėjelis;Drugeliai;1331334220;Ne;0;6;2;8
13044;Vėjelis;Drugeliai;2151737048;Ne;0;5;0;5
13045;Vėjelis;Drugeliai;4988352741;Ne;8;0;0;8
13046;Vėjelis;Drugeliai;4473677352;Ne;0;6;0;6
13047;Vėjelis;Drugeliai;4506243333;Ne;2;3;1;6
13048;Vėjelis;Drugeliai;3524350131;Ne;0;4;0;4
13049;Vėjelis;Drugeliai;6061966626;Ne;0;4;0;4
13050;Vėjelis;Drugeliai;6891260701;Ne;0;4;0;4
13051;Vėjelis;Drugeliai;9986867356;Ne;0;4;0;4
13052;Vėjelis;Drugeliai;1876663813;Ne;1;5;0;6
13053;Vėjelis;Drugeliai;8467887788;Ne;9;6;0;15
13054;Vėjelis;Drugeliai;5619026707;Ne;0;1;0;1
13055;Vėjelis;Drugeliai;1073818739;Ne;3;0;3;6
13056;Vėjelis;Drugeliai;6775556050;Ne;5;0;2;7
13057;Vėjelis;Drugeliai;1823215441;Ne;4;3;0;7
13058;Vėjelis;Drugeliai;5888429623;Ne;12;0;0;12
13059;Vėjelis;Drugeliai;9592852011;Ne;0;3;1;4
13060;Vėjelis;Drugeliai;7247057946;Ne;0;4;7;11
13061;Vėjelis;Drugeliai;8986581196;Ne;5;0;4;9
13062;Vėjelis;Drugeliai;4885237871;Ne;0;0;5;5
13063;Vėjelis;Malūnėlis;1994035417;Ne;0;6;0;6
13064;Vėjelis;Malūnėlis;7097474285;Ne;0;0;3;3
13065;Vėjelis;Malūnėlis;1448699738;Ne;9;1;0;10
13066;Vėjelis;Malūnėlis;3275186042;Ne;0;1;0;1
13067;Vėjelis;Malūnėlis;1882750621;Ne;12;4;0;16
13068;Vėjelis;Malūnėlis;5109441799;Ne;9;0;0;9
13069;Vėjelis;Malūnėlis;4171024976;Ne;0;8;0;8
13070;Vėjelis;Malūnėlis;1871467392;Ne;0;0;1;1
13071;Vėjelis;Malūnėlis;1342200813;Ne;0;9;2;11
13072;Vėjelis;Malūnėlis;8221349174;Ne;4;5;0;9
13073;Vėjelis;Malūnėlis;6600504736;Ne;0;3;0;3
13074;Vėjelis;Malūnėlis;8063276082;Ne;4;1;0;5
13075;Vėjelis;Malūnėlis;6244227830;Ne;6;4;0;10
13076;Vėjelis;Malūnėlis;1417987860;Ne;10;0;3;13
13077;Vėjelis;Malūnėlis;9636946669;Ne;15;0;0;15
13078;Vėjelis;Malūnėlis;5066748621;Ne;0;1;0;1
13079;Vėjelis;Malūnėlis;8822873586;Ne;0;0;1;1
13080;Vėjelis;Malūnėlis;6823103188;Ne;0;4;0;4
13081;Vėjelis;Malūnėlis;2887703782;Ne;0;12;0;12
13082;Vėjelis;Malūnėlis;4063795811;Ne;0;3;0;3
13083;Vėjelis;Žvaigždutės;4868574574;Taip;9;3;0;12
13084;Vėjelis;Žvaigždutės;3495322620;Ne;11;0;0;11
13085;Vėjelis;Žvaigždutės;1956418258;Ne;0;7;0;7
13086;Vėjelis;Žvaigždutės;7203026860;Ne;3;5;0;8
13087;Vėjelis;Žvaigždutės;7860576967;Ne;0;4;0;4
13088;Vėjelis;Žvaigždutės;1075188861;Ne;10;3;0;13
13089;Vėjelis;Žvaigždutės;9451358807;Ne;6;2;7;15
13090;Vėjelis;Žvaigždutės;8995478684;Ne;1;4;3;8
13091;Vėjelis;Žvaigždutės;8281508498;Ne;0;4;3;7
13092;Vėjelis;Žvaigždutės;6909799367;Ne;0;7;0;7
13093;Vėjelis;Žvaigždutės;4884057836;Ne;9;1;1;11
13094;Vėjelis;Žvaigždutės;9546928491;Ne;3;1;0;4
13095;Vėjelis;Žvaigždutės;9675488924;Ne;8;0;0;8
13096;Vėjelis;Žvaigždutės;7101585528;Ne;3;3;0;6
13097;Vėjelis;Žvaigždutės;9202471939;Ne;0;9;0;9
13098;Vėjelis;Žvaigždutės;1615837863;Ne;0;9;0;9
13099;Vėjelis;Žvaigždutės;8273890475;Ne;12;3;0;15
13100;Vėjelis;Žvaigždutės;9403445317;Ne;6;4;0;10
13101;Vėjelis;Varpeliai;7507448059;Ne;0;5;0;5
13102;Vėjelis;Varpeliai;4853650350;Ne;0;5;0;5
13103;Vėjelis;Varpeliai;8748218387;Ne;0;1;0;1
13104;Vėjelis;Varpeliai;9492690970;Ne;0;4;5;9
13105;Vėjelis;Varpeliai;9557135813;Ne;0;4;2;6
13106;Vėjelis;Varpeliai;4353239658;Ne;0;4;4;8
13107;Vėjelis;Varpeliai;9135807341;Ne;5;10;0;15
13108;Vėjelis;Varpeliai;2117924725;Ne;2;1;0;3
13109;Vėjelis;Varpeliai;8866974952;Ne;0;6;0;6
13110;Vėjelis;Varpeliai;2132551615;Ne;16;2;0;18
13111;Vėjelis;Varpeliai;4101161670;Ne;3;4;0;7
13112;Vėjelis;Varpeliai;1549518622;Ne;0;4;2;6
13113;Vėjelis;Varpeliai;6386092350;Ne;7;9;0;16
13114;Vėjelis;Varpeliai;7046938604;Ne;0;5;0;5
13115;Vėjelis;Varpeliai;6777528441;Ne;0;4;0;4
13116;Vėjelis;Varpeliai;6844704326;Ne;0;4;1;5
13117;Vėjelis;Varpeliai;3315240387;Taip;0;11;0;11
13118;Vėjelis;Varpeliai;8300497094;Ne;0;3;2;5
13119;Vėjelis;Pelėdžiukų;3067215309;Ne;0;4;0;4
13120;Vėjelis;Pelėdžiukų;7211756910;Ne;0;9;0;9
13121;Vėjelis;Pelėdžiukų;2302652824;Ne;0;2;0;2
13122;Vėjelis;Pelėdžiukų;4852532740;Ne;13;1;0;14
13123;Vėjelis;Pelėdžiukų;4450739919;Ne;0;1;0;1
13124;Vėjelis;Pelėdžiukų;9852892338;Ne;0;3;0;3
13125;Vėjelis;Pelėdžiukų;8433853523;Ne;0;2;0;2
13126;Vėjelis;Pelėdžiukų;4746355716;Ne;0;0;4;4
13127;Vėjelis;Pelėdžiukų;5507017221;Ne;0;5;0;5
13128;Vėjelis;Pelėdžiukų;1259743374;Ne;5;2;5;12
13129;Vėjelis;Pelėdžiukų;6226234271;Ne;19;0;0;19
13130;Vėjelis;Pelėdžiukų;3764096742;Ne;1;0;0;1
13131;Vėjelis;Pelėdžiukų;8153021028;Ne;5;1;0;6
13132;Vėjelis;Pelėdžiukų;8067153728;Ne;3;3;0;6
13133;Vėjelis;Pelėdžiukų;2283628712;Ne;5;2;5;12
13134;Vėjelis;Pelėdžiukų;9769871497;Ne;2;0;1;3
13135;Vėjelis;Pelėdžiukų;4318295503;Ne;3;0;3;6
13136;Vėjelis;Pelėdžiukų;9867392835;Ne;11;3;0;14
13137;Vėjelis;Pelėdžiukų;5662728912;Ne;0;4;0;4
13138;Vėjelis;Skruzdeliukų;3096861110;Ne;5;4;0;9
13139;Vėjelis;Skruzdeliukų;1938557472;Ne;9;0;0;9
13140;Vėjelis;Skruzdeliukų;9964641007;Ne;8;0;0;8
13141;Vėjelis;Skruzdeliukų;7577991381;Ne;9;0;0;9
13142;Vėjelis;Skruzdeliukų;2928489724;Ne;0;19;0;19
13143;Vėjelis;Skruzdeliukų;2238139120;Ne;10;1;0;11
13144;Vėjelis;Skruzdeliukų;4531125902;Ne;17;0;0;17
13145;Vėjelis;Skruzdeliukų;9528142262;Ne;17;0;0;17
13146;Vėjelis;Skruzdeliukų;4758209854;Ne;17;0;0;17
13147;Vėjelis;Skruzdeliukų;2486741803;Ne;12;1;0;13
13148;Vėjelis;Skruzdeliukų;1793991609;Ne;11;1;0;12
13149;Vėjelis;Skruzdeliukų;2987292658;Ne;11;1;0;12
13150;Vėjelis;Skruzdeliukų;4605288262;Ne;5;1;0;6
13151;Vėjelis;Skruzdeliukų;8963364725;Ne;5;1;0;6
13152;Vėjelis;Skruzdeliukų;5333058186;Ne;6;0;0;6
13153;Vėjelis;Pieštukų;7854614677;Ne;1;2;0;3
13154;Vėjelis;Pieštukų;6453605110;Ne;15;0;0;15
13155;Vėjelis;Pieštukų;2720886612;Ne;0;3;0;3
13156;Vėjelis;Pieštukų;6520167840;Ne;19;0;0;19
13157;Vėjelis;Pieštukų;3691974508;Ne;1;1;0;2
13158;Vėjelis;Pieštukų;7613786936;Ne;6;0;0;6
13159;Vėjelis;Pieštukų;2912640999;Ne;1;2;0;3
13160;Vėjelis;Pieštukų;6839116451;Ne;10;0;0;10
13161;Vėjelis;Pieštukų;6938777118;Ne;11;2;0;13
13162;Vėjelis;Pieštukų;2553724469;Ne;0;19;0;19
13163;Vėjelis;Pieštukų;3012722334;Ne;9;0;0;9
13164;Vėjelis;Pieštukų;7889625599;Ne;12;0;0;12
13165;Vėjelis;Pieštukų;7763996061;Ne;0;3;0;3
13166;Vėjelis;Pieštukų;7553070848;Ne;9;1;0;10
13167;Vėjelis;Pieštukų;8310513436;Ne;4;2;0;6
13168;Vėjelis;Pieštukų;1291592424;Ne;18;0;0;18
13169;Vėjelis;Ramunėlių;5331895599;Ne;7;7;0;14
13170;Vėjelis;Ramunėlių;4450872985;Ne;1;0;0;1
13171;Vėjelis;Ramunėlių;1506416880;Ne;8;0;0;8
13172;Vėjelis;Ramunėlių;3756116835;Ne;0;2;0;2
13173;Vėjelis;Ramunėlių;6576149860;Ne;0;1;0;1
13174;Vėjelis;Ramunėlių;4843434827;Ne;8;2;0;10
13175;Vėjelis;Ramunėlių;1452685229;Ne;10;3;0;13
13176;Vėjelis;Ramunėlių;6573481399;Ne;15;1;0;16
13177;Vėjelis;Ramunėlių;2534737343;Ne;9;3;0;12
13178;Vėjelis;Ramunėlių;2195618699;Ne;10;2;0;12
13179;Vėjelis;Ramunėlių;8505186157;Ne;4;0;0;4
13180;Vėjelis;Ramunėlių;4717248684;Ne;4;3;0;7
13181;Vėjelis;Ramunėlių;5291321394;Ne;6;0;0;6
13182;Vėjelis;Ramunėlių;9114597577;Ne;14;0;0;14
13183;Vėjelis;Nykštukai;6741600874;Ne;7;0;0;7
13184;Vėjelis;Nykštukai;9957614551;Ne;0;8;0;8
13185;Vėjelis;Nykštukai;7233448544;Ne;0;6;0;6
13186;Vėjelis;Nykštukai;5339200991;Ne;0;4;0;4
13187;Vėjelis;Nykštukai;6602964509;Ne;4;3;0;7
13188;Vėjelis;Nykštukai;2573683778;Ne;5;5;0;10
13189;Vėjelis;Nykštukai;3843601190;Ne;6;0;0;6
13190;Vėjelis;Nykštukai;3574432129;Ne;3;0;0;3
13191;Vėjelis;Nykštukai;4713754452;Ne;4;2;0;6
13192;Vėjelis;Nykštukai;3813509637;Ne;9;0;0;9
13193;Vėjelis;Nykštukai;8755889077;Ne;4;0;0;4
13194;Vėjelis;Nykštukai;9979979480;Ne;15;0;0;15
13195;Vėjelis;Nykštukai;6581265682;Ne;0;14;0;14
13196;Vėjelis;Nykštukai;8452132066;Ne;0;19;0;19
13197;Vėjelis;Nykštukai;7552365055;Ne;9;2;0;11
13198;Vėjelis;Nykštukai;6389449089;Ne;8;0;0;8
13199;Vėjelis;Nykštukai;9351658311;Ne;0;15;0;15
13200;Vėjelis;Nykštukai;1074246375;Ne;3;0;0;3
13201;Vėjelis;BITUTĖS;6824919005;Ne;2;3;0;5
13202;Vėjelis;BITUTĖS;4276237884;Taip;9;3;0;12
13203;Vėjelis;BITUTĖS;3772706363;Ne;0;5;0;5
13204;Vėjelis;BITUTĖS;1834203833;Ne;0;6;2;8
13205;Vėjelis;BITUTĖS;6283428333;Ne;12;0;0;12
13206;Vėjelis;BITUTĖS;1112394040;Ne;3;1;0;4
13207;Vėjelis;BITUTĖS;3767625080;Ne;0;4;0;4
13208;Vėjelis;BITUTĖS;6569848405;Ne;9;1;0;10
13209;Vėjelis;BITUTĖS;1457373815;Ne;17;0;0;17
13210;Vėjelis;BITUTĖS;8571757635;Ne;12;3;0;15
13211;Vėjelis;BITUTĖS;1022888418;Ne;5;4;0;9
13212;Vėjelis;BITUTĖS;1116238331;Ne;2;6;0;8
13213;Vėjelis;BITUTĖS;8286070405;Ne;10;3;0;13
13214;Vėjelis;BITUTĖS;1674810054;Ne;15;0;0;15
13215;Vėjelis;BITUTĖS;1070853175;Ne;11;0;0;11
13216;Vėjelis;BITUTĖS;4348246825;Ne;11;0;0;11
13217;Vėjelis;BITUTĖS;6660799519;Ne;3;3;0;6
13218;Vėjelis;BITUTĖS;6889825160;Taip;12;0;0;12
13219;Vėjelis;BITUTĖS;1235788079;Taip;9;0;0;9
13220;Vėjelis;BITUTĖS;4745262277;Ne;0;6;0;6
13221;Vėjelis;BITUTĖS;3123360955;Ne;9;1;0;10
13222;Vėjelis;BITUTĖS;7790713917;Taip;2;5;0;7
13223;Vėjelis;Boruželės;2199680661;Ne;0;4;3;7
13224;Vėjelis;Boruželės;1429496839;Ne;0;5;0;5
13225;Vėjelis;Boruželės;6108049183;Ne;0;7;0;7
13226;Vėjelis;Boruželės;1115802837;Ne;4;5;0;9
13227;Vėjelis;Boruželės;1494531065;Ne;0;2;0;2
13228;Vėjelis;Boruželės;3276062426;Ne;0;3;0;3
13229;Vėjelis;Boruželės;4132824111;Ne;7;4;1;12
13230;Vėjelis;Boruželės;7752923796;Ne;0;3;3;6
13231;Vėjelis;Boruželės;8957653216;Ne;0;5;1;6
13232;Vėjelis;Boruželės;6431589805;Ne;0;4;0;4
13233;Vėjelis;Boruželės;4412135676;Ne;0;4;2;6
13234;Vėjelis;Boruželės;4746932126;Ne;4;7;1;12
13235;Vėjelis;Boruželės;1978952781;Ne;0;4;1;5
13236;Vėjelis;Boruželės;8353084814;Ne;0;4;1;5
13237;Vėjelis;Boruželės;2416832899;Ne;0;4;0;4
13238;Vėjelis;Boruželės;7594586198;Ne;0;5;0;5
13239;Vėjelis;Boruželės;7981032872;Ne;0;5;2;7
13240;Vėjelis;Boruželės;7697394469;Ne;1;5;0;6
13241;Vėjelis;Boruželės;4066956765;Ne;0;5;3;8
13242;Vėjelis;Boruželės;2788205363;Ne;0;3;0;3
13243;Vėtrungė;Debesėlių;3655025938;Ne;0;3;0;3
13244;Vėtrungė;Debesėlių;2825732654;Ne;0;2;0;2
13245;Vėtrungė;Debesėlių;7863176604;Ne;3;4;0;7
13246;Vėtrungė;Debesėlių;3179715496;Ne;3;4;0;7
13247;Vėtrungė;Debesėlių;6439014588;Ne;5;4;2;11
13248;Vėtrungė;Debesėlių;9423361592;Ne;3;4;0;7
13249;Vėtrungė;Debesėlių;4269488000;Ne;0;1;0;1
13250;Vėtrungė;Debesėlių;1191007983;Ne;0;5;1;6
13251;Vėtrungė;Debesėlių;3745680607;Ne;12;5;0;17
13252;Vėtrungė;Debesėlių;9359012317;Ne;4;0;2;6
13253;Vėtrungė;Debesėlių;1807742144;Ne;6;4;8;18
13254;Vėtrungė;Debesėlių;3433811829;Ne;0;2;4;6
13255;Vėtrungė;Debesėlių;2447851565;Ne;7;4;4;15
13256;Vėtrungė;Debesėlių;5246813735;Ne;5;4;1;10
13257;Vėtrungė;Debesėlių;8957071345;Ne;0;3;0;3
13258;Vėtrungė;Debesėlių;5545581078;Ne;0;4;0;4
13259;Vėtrungė;Debesėlių;7185104341;Ne;4;5;4;13
13260;Vėtrungė;Debesėlių;5939537473;Taip;0;7;0;7
13261;Vėtrungė;Debesėlių;1871358961;Ne;4;0;0;4
13262;Vėtrungė;Debesėlių;1480035015;Ne;0;1;1;2
13263;Vėtrungė;Debesėlių;7632969321;Ne;1;4;1;6
13264;Vėtrungė;Debesėlių;9642541034;Ne;0;4;4;8
13265;Vėtrungė;Debesėlių;6115556675;Ne;2;1;0;3
13266;Vėtrungė;Zuikių;9332362038;Ne;0;2;1;3
13267;Vėtrungė;Zuikių;9407558097;Ne;0;9;0;9
13268;Vėtrungė;Zuikių;2985829593;Ne;0;4;0;4
13269;Vėtrungė;Zuikių;4121886031;Ne;0;5;0;5
13270;Vėtrungė;Zuikių;7573021445;Ne;0;7;0;7
13271;Vėtrungė;Zuikių;3335047815;Ne;0;3;0;3
13272;Vėtrungė;Zuikių;8157356569;Ne;0;3;0;3
13273;Vėtrungė;Zuikių;9742099165;Ne;8;4;0;12
13274;Vėtrungė;Zuikių;1215953192;Ne;0;4;0;4
13275;Vėtrungė;Zuikių;3908259010;Ne;1;4;1;6
13276;Vėtrungė;Zuikių;1729819557;Ne;1;4;0;5
13277;Vėtrungė;Zuikių;4916692634;Ne;0;6;0;6
13278;Vėtrungė;Zuikių;4197321604;Ne;0;4;0;4
13279;Vėtrungė;Zuikių;1007578933;Ne;5;1;0;6
13280;Vėtrungė;Zuikių;7558548846;Ne;5;1;0;6
13281;Vėtrungė;Zuikių;8742161467;Ne;0;7;0;7
13282;Vėtrungė;Zuikių;2537221101;Ne;5;4;0;9
13283;Vėtrungė;Zuikių;7342250921;Ne;1;6;0;7
13284;Vėtrungė;Zuikių;9248113268;Ne;0;1;0;1
13285;Vėtrungė;Zuikių;7435005821;Ne;4;5;0;9
13286;Vėtrungė;Zuikių;1280823326;Ne;0;8;0;8
13287;Vėtrungė;Zuikių;4508176017;Ne;3;3;0;6
13288;Vėtrungė;Zuikių;8958748086;Ne;0;4;0;4
13289;Vėtrungė;Zuikių;5887929703;Ne;5;1;0;6
13290;Vėtrungė;Drugelių;5622109033;Ne;0;5;0;5
13291;Vėtrungė;Drugelių;6457369177;Ne;0;1;0;1
13292;Vėtrungė;Drugelių;8744050633;Ne;0;1;0;1
13293;Vėtrungė;Drugelių;7943682529;Ne;4;0;0;4
13294;Vėtrungė;Drugelių;9090873546;Ne;11;0;0;11
13295;Vėtrungė;Drugelių;2124476787;Ne;0;4;0;4
13296;Vėtrungė;Drugelių;2970067995;Ne;10;4;0;14
13297;Vėtrungė;Drugelių;8729505032;Ne;7;0;0;7
13298;Vėtrungė;Drugelių;5251308945;Taip;10;4;0;14
13299;Vėtrungė;Drugelių;9812496068;Ne;5;0;0;5
13300;Vėtrungė;Drugelių;8753387108;Ne;2;6;0;8
13301;Vėtrungė;Drugelių;3634995652;Ne;7;4;0;11
13302;Vėtrungė;Drugelių;2123410772;Ne;4;0;0;4
13303;Vėtrungė;Drugelių;3744377479;Ne;0;2;0;2
13304;Vėtrungė;Drugelių;8905533826;Ne;3;1;0;4
13305;Vėtrungė;Drugelių;7186353024;Ne;4;9;0;13
13306;Vėtrungė;Drugelių;2933312366;Taip;0;14;0;14
13307;Vėtrungė;Drugelių;2508501223;Ne;0;11;0;11
13308;Vėtrungė;Drugelių;6538402680;Ne;1;1;0;2
13309;Vėtrungė;Drugelių;5887245282;Ne;5;6;0;11
13310;Vėtrungė;Drugelių;3306549764;Ne;10;5;0;15
13311;Vėtrungė;Drugelių;7974212517;Ne;11;1;0;12
13312;Vėtrungė;Drugelių;9423979719;Ne;11;1;0;12
13313;Vėtrungė;Drugelių;1611114179;Ne;15;0;0;15
13314;Vėtrungė;Do-re-mi;7752842285;Ne;22;0;0;22
13315;Vėtrungė;Do-re-mi;1408629891;Ne;13;6;0;19
13316;Vėtrungė;Do-re-mi;7411180918;Ne;5;1;0;6
13317;Vėtrungė;Do-re-mi;2832753464;Ne;4;0;1;5
13318;Vėtrungė;Do-re-mi;2643851525;Ne;5;7;5;17
13319;Vėtrungė;Do-re-mi;6782673546;Ne;4;6;0;10
13320;Vėtrungė;Do-re-mi;3885409650;Ne;23;0;0;23
13321;Vėtrungė;Do-re-mi;4944115709;Ne;7;7;0;14
13322;Vėtrungė;Do-re-mi;7175547800;Ne;12;6;0;18
13323;Vėtrungė;Do-re-mi;1024958500;Ne;0;6;6;12
13324;Vėtrungė;Do-re-mi;5272077870;Ne;5;9;2;16
13325;Vėtrungė;Do-re-mi;1185643576;Ne;0;2;3;5
13326;Vėtrungė;Do-re-mi;9158760410;Ne;8;0;18;26
13327;Vėtrungė;Do-re-mi;3000030998;Ne;13;0;0;13
13328;Vėtrungė;Do-re-mi;4602351198;Ne;2;1;0;3
13329;Vėtrungė;Smalsučių;1020095914;Ne;4;0;0;4
13330;Vėtrungė;Smalsučių;7270370939;Ne;0;4;0;4
13331;Vėtrungė;Smalsučių;9543456295;Ne;3;1;1;5
13332;Vėtrungė;Smalsučių;2510763357;Ne;6;4;0;10
13333;Vėtrungė;Smalsučių;4713420194;Ne;0;4;1;5
13334;Vėtrungė;Smalsučių;2520926439;Ne;0;1;0;1
13335;Vėtrungė;Smalsučių;9313438768;Ne;5;3;0;8
13336;Vėtrungė;Smalsučių;9685389270;Ne;0;4;0;4
13337;Vėtrungė;Smalsučių;9207846866;Ne;3;4;0;7
13338;Vėtrungė;Smalsučių;2226654309;Ne;4;4;0;8
13339;Vėtrungė;Smalsučių;1766599777;Ne;1;4;2;7
13340;Vėtrungė;Smalsučių;3328447991;Ne;0;4;0;4
13341;Vėtrungė;Smalsučių;7143997258;Ne;2;2;0;4
13342;Vėtrungė;Smalsučių;4624264759;Ne;0;2;0;2
13343;Vėtrungė;Smalsučių;5832298824;Ne;0;3;0;3
13344;Vėtrungė;Smalsučių;2136966687;Ne;0;8;0;8
13345;Vėtrungė;Smalsučių;9070732925;Ne;0;4;0;4
13346;Vėtrungė;Smalsučių;2207041148;Ne;4;4;0;8
13347;Vėtrungė;Smalsučių;5836190044;Ne;0;4;1;5
13348;Vėtrungė;Smalsučių;6374739740;Taip;4;4;0;8
13349;Vėtrungė;Gudručių;9994445948;Ne;0;4;0;4
13350;Vėtrungė;Gudručių;6595858698;Ne;0;4;0;4
13351;Vėtrungė;Gudručių;7496582551;Ne;0;4;1;5
13352;Vėtrungė;Gudručių;6449124019;Ne;0;1;0;1
13353;Vėtrungė;Gudručių;9079483362;Ne;1;4;1;6
13354;Vėtrungė;Gudručių;8956375453;Ne;1;4;0;5
13355;Vėtrungė;Gudručių;7807708310;Ne;0;4;1;5
13356;Vėtrungė;Gudručių;9271869305;Ne;0;4;1;5
13357;Vėtrungė;Gudručių;2883254822;Ne;1;4;1;6
13358;Vėtrungė;Gudručių;7895027909;Ne;0;4;0;4
13359;Vėtrungė;Gudručių;5452337780;Ne;0;3;0;3
13360;Vėtrungė;Gudručių;3200251047;Ne;0;4;2;6
13361;Vėtrungė;Gudručių;5430818470;Ne;0;4;2;6
13362;Vėtrungė;Gudručių;9324733839;Ne;3;4;0;7
13363;Vėtrungė;Gudručių;4709068324;Ne;0;4;0;4
13364;Vėtrungė;Gudručių;9865628172;Ne;0;4;0;4
13365;Vėtrungė;Kodėlčių;9172488122;Ne;0;3;2;5
13366;Vėtrungė;Kodėlčių;2739382736;Ne;10;2;1;13
13367;Vėtrungė;Kodėlčių;3903604247;Ne;7;0;1;8
13368;Vėtrungė;Kodėlčių;3500551575;Ne;0;5;0;5
13369;Vėtrungė;Kodėlčių;7872043253;Ne;0;2;2;4
13370;Vėtrungė;Kodėlčių;9852609222;Ne;0;6;0;6
13371;Vėtrungė;Kodėlčių;8465132902;Ne;0;1;0;1
13372;Vėtrungė;Kodėlčių;8859592174;Ne;0;4;0;4
13373;Vėtrungė;Kodėlčių;7862615352;Ne;0;5;0;5
13374;Vėtrungė;Kodėlčių;5385880910;Ne;11;3;0;14
13375;Vėtrungė;Kodėlčių;9211406129;Ne;0;5;0;5
13376;Vėtrungė;Kodėlčių;1032730549;Ne;0;1;0;1
13377;Vėtrungė;Kodėlčių;7511121411;Ne;0;2;1;3
13378;Vėtrungė;Kodėlčių;9127735773;Ne;5;2;0;7
13379;Vėtrungė;Kodėlčių;5830221727;Ne;0;2;0;2
13380;Vėtrungė;Kodėlčių;4756863295;Ne;0;7;0;7
13381;Vėtrungė;Kodėlčių;8985054558;Ne;0;4;0;4
13382;Vėtrungė;Kodėlčių;3922749661;Ne;8;2;0;10
13383;Vėtrungė;Kodėlčių;8013249618;Taip;8;3;0;11
13384;Vėtrungė;Kodėlčių;3887230224;Ne;0;6;0;6
13385;Vėtrungė;Kodėlčių;7740260264;Ne;4;0;0;4
13386;Vėtrungė;Kodėlčių;6807838878;Ne;6;5;1;12
13387;Vėtrungė;Kodėlčių;3638303693;Ne;8;2;1;11
13388;Vėtrungė;Paukštelių;6983172988;Ne;0;1;2;3
13389;Vėtrungė;Paukštelių;3957148270;Ne;9;2;0;11
13390;Vėtrungė;Paukštelių;3466149991;Ne;0;4;1;5
13391;Vėtrungė;Paukštelių;7258995031;Ne;6;1;0;7
13392;Vėtrungė;Paukštelių;4805836717;Ne;0;1;3;4
13393;Vėtrungė;Paukštelių;6812588777;Ne;5;3;0;8
13394;Vėtrungė;Paukštelių;2798915063;Ne;3;5;0;8
13395;Vėtrungė;Paukštelių;2981610749;Ne;0;0;10;10
13396;Vėtrungė;Paukštelių;6146327857;Ne;7;0;0;7
13397;Vėtrungė;Paukštelių;8149563485;Ne;4;0;1;5
13398;Vėtrungė;Paukštelių;2786721399;Ne;10;0;0;10
13399;Vėtrungė;Paukštelių;9461365083;Ne;6;4;1;11
13400;Vėtrungė;Paukštelių;9822462988;Ne;2;4;0;6
13401;Vėtrungė;Paukštelių;2741119142;Ne;5;0;0;5
13402;Vėtrungė;Viščiukų;2725607774;Ne;0;6;0;6
13403;Vėtrungė;Viščiukų;5808423634;Ne;5;0;4;9
13404;Vėtrungė;Viščiukų;6190900822;Ne;6;4;0;10
13405;Vėtrungė;Viščiukų;4597361099;Ne;5;0;8;13
13406;Vėtrungė;Viščiukų;2490075899;Ne;0;5;2;7
13407;Vėtrungė;Viščiukų;8761701511;Ne;8;0;5;13
13408;Vėtrungė;Viščiukų;3527585648;Ne;8;7;0;15
13409;Vėtrungė;Viščiukų;4145172377;Ne;4;0;5;9
13410;Vėtrungė;Viščiukų;3859501564;Ne;0;7;0;7
13411;Vėtrungė;Viščiukų;3917214308;Ne;15;0;0;15
13412;Vėtrungė;Viščiukų;9862408289;Ne;6;0;7;13
13413;Vėtrungė;Viščiukų;7065114742;Ne;9;0;4;13
13414;Vėtrungė;Viščiukų;2558088727;Ne;0;14;0;14
13415;Vėtrungė;Viščiukų;6495674830;Ne;5;4;0;9
13416;Vėtrungė;Viščiukų;4782989673;Ne;0;6;1;7
13417;Vėtrungė;Viščiukų;8276160906;Ne;0;0;19;19
13418;Vėtrungė;Viščiukų;4516633703;Ne;8;4;0;12
13419;Vėtrungė;Viščiukų;6279761125;Ne;9;0;1;10
13420;Vėtrungė;Nykštukų;9696984346;Ne;0;2;2;4
13421;Vėtrungė;Nykštukų;7819147751;Ne;0;1;0;1
13422;Vėtrungė;Nykštukų;6990506209;Ne;0;1;0;1
13423;Vėtrungė;Nykštukų;2348557463;Ne;0;13;0;13
13424;Vėtrungė;Nykštukų;7733472482;Ne;0;1;0;1
13425;Vėtrungė;Nykštukų;2309821873;Ne;0;3;0;3
13426;Vėtrungė;Nykštukų;8059553343;Ne;0;5;1;6
13427;Vėtrungė;Nykštukų;4020987532;Ne;0;1;0;1
13428;Vėtrungė;Nykštukų;9569555731;Ne;6;5;1;12
13429;Vėtrungė;Nykštukų;7699392279;Ne;0;9;0;9
13430;Vėtrungė;Nykštukų;9773838651;Ne;0;1;0;1
13431;Vėtrungė;Nykštukų;6866720274;Ne;0;3;0;3
13432;Vėtrungė;Nykštukų;3869546285;Ne;0;3;0;3
13433;Vėtrungė;Nykštukų;6783756347;Ne;0;1;0;1
13434;Vėtrungė;Nykštukų;4289435509;Ne;0;7;0;7
13435;Vėtrungė;Nykštukų;5132419026;Ne;3;5;0;8
13436;Vėtrungė;Nykštukų;7647363322;Ne;3;5;0;8
13437;Vėtrungė;Nykštukų;3046782145;Ne;0;3;0;3
13438;Vėtrungė;Nykštukų;7037942782;Ne;0;5;0;5
13439;Vėtrungė;Nykštukų;2205455847;Ne;0;11;0;11
13440;Vėtrungė;Ąžuoliukų;8775969909;Ne;8;0;0;8
13441;Vėtrungė;Ąžuoliukų;1034537691;Ne;10;0;0;10
13442;Vėtrungė;Ąžuoliukų;6363761237;Ne;5;2;0;7
13443;Vėtrungė;Ąžuoliukų;8913748584;Ne;0;4;10;14
13444;Vėtrungė;Ąžuoliukų;3073965379;Ne;1;4;2;7
13445;Vėtrungė;Ąžuoliukų;3938684888;Ne;10;3;2;15
13446;Vėtrungė;Ąžuoliukų;6073563461;Ne;0;4;0;4
13447;Vėtrungė;Ąžuoliukų;2977116563;Ne;5;4;0;9
13448;Vėtrungė;Ąžuoliukų;4925843510;Ne;5;0;3;8
13449;Vėtrungė;Ąžuoliukų;8867794275;Ne;0;5;0;5
13450;Vėtrungė;Ąžuoliukų;7096106273;Ne;8;0;8;16
13451;Vėtrungė;Ąžuoliukų;8026065367;Ne;0;3;0;3
13452;Vėtrungė;Ąžuoliukų;6476717645;Ne;4;8;0;12
13453;Vėtrungė;Ąžuoliukų;5167580818;Ne;10;0;1;11
13454;Vėtrungė;Ąžuoliukų;1169648551;Ne;0;0;3;3
13455;Vėtrungė;Ąžuoliukų;4489937085;Ne;11;4;0;15
13456;Vėtrungė;Ąžuoliukų;4740985408;Ne;0;0;6;6
13457;Vėtrungė;Ąžuoliukų;9684184905;Ne;7;0;0;7
13458;Vėtrungė;Ąžuoliukų;5021830780;Ne;15;0;0;15
13459;Vėtrungė;Ąžuoliukų;1568598938;Ne;0;5;2;7
13460;Vėtrungė;Ąžuoliukų;9459062715;Ne;12;1;0;13
13461;Vėtrungė;"&quot;MEŠKIUKŲ&quot;";9667227707;Taip;3;0;0;3
13462;Vėtrungė;"&quot;MEŠKIUKŲ&quot;";4529215724;Taip;1;0;0;1
13463;Vėtrungė;"&quot;MEŠKIUKŲ&quot;";7900887923;Ne;15;0;0;15
13464;Vėtrungė;"&quot;MEŠKIUKŲ&quot;";2462720995;Ne;0;2;0;2
13465;Vėtrungė;"&quot;MEŠKIUKŲ&quot;";7323779310;Ne;0;2;0;2
13466;Vėtrungė;"&quot;MEŠKIUKŲ&quot;";6791587580;Ne;9;1;0;10
13467;Vėtrungė;"&quot;MEŠKIUKŲ&quot;";4550285483;Ne;8;0;0;8
13468;Vėtrungė;"&quot;MEŠKIUKŲ&quot;";1568931607;Ne;10;0;0;10
13469;Vėtrungė;"&quot;MEŠKIUKŲ&quot;";2814666413;Ne;10;0;0;10
13470;Vėtrungė;"&quot;MEŠKIUKŲ&quot;";3019474140;Ne;15;0;0;15
13471;Vėtrungė;"&quot;MEŠKIUKŲ&quot;";6529918013;Ne;10;0;0;10
13472;Vėtrungė;"&quot;MEŠKIUKŲ&quot;";2711203550;Ne;15;4;0;19
13473;Vėtrungė;"&quot;MEŠKIUKŲ&quot;";8632209474;Ne;3;9;0;12
13474;Vilnelė;Lakštutė;8843094480;Ne;3;6;0;9
13475;Vilnelė;Lakštutė;5786086401;Ne;0;2;1;3
13476;Vilnelė;Lakštutė;6249731759;Ne;0;14;0;14
13477;Vilnelė;Lakštutė;6837850601;Ne;0;6;0;6
13478;Vilnelė;Lakštutė;5554451335;Ne;0;8;0;8
13479;Vilnelė;Lakštutė;1762024490;Ne;0;3;0;3
13480;Vilnelė;Lakštutė;8201829887;Ne;0;4;0;4
13481;Vilnelė;Lakštutė;7702217893;Ne;5;0;1;6
13482;Vilnelė;Lakštutė;4427383755;Ne;10;5;0;15
13483;Vilnelė;Lakštutė;1547117566;Ne;10;5;0;15
13484;Vilnelė;Lakštutė;3231387543;Ne;0;4;0;4
13485;Vilnelė;Lakštutė;1734277231;Ne;0;4;0;4
13486;Vilnelė;Lakštutė;3900484348;Ne;7;5;0;12
13487;Vilnelė;Lakštutė;5498574366;Ne;0;5;0;5
13488;Vilnelė;Lakštutė;6686896190;Ne;0;6;1;7
13489;Vilnelė;Lakštutė;3032273912;Ne;0;12;0;12
13490;Vilnelė;Lakštutė;4017436910;Ne;2;1;0;3
13491;Vilnelė;Lakštutė;6156838553;Ne;0;4;2;6
13492;Vilnelė;Lakštutė;9843449060;Ne;10;0;2;12
13493;Vilnelė;Lakštutė;2803880424;Ne;0;5;0;5
13494;Vilnelė;Lakštutė;2418216191;Ne;5;4;0;9
13495;Vilnelė;Lakštutė;5913967803;Ne;9;0;0;9
13496;Vilnelė;Vyturėlis;7536603663;Ne;0;5;1;6
13497;Vilnelė;Vyturėlis;3503461211;Ne;0;6;0;6
13498;Vilnelė;Vyturėlis;2788449626;Ne;2;3;1;6
13499;Vilnelė;Vyturėlis;1574809879;Ne;0;7;0;7
13500;Vilnelė;Vyturėlis;3558073399;Ne;0;2;0;2
13501;Vilnelė;Vyturėlis;6083082959;Ne;0;6;0;6
13502;Vilnelė;Vyturėlis;3993826389;Ne;0;4;0;4
13503;Vilnelė;Vyturėlis;7388336851;Ne;6;5;0;11
13504;Vilnelė;Vyturėlis;2923012145;Ne;0;4;0;4
13505;Vilnelė;Vyturėlis;8667403338;Ne;2;4;2;8
13506;Vilnelė;Vyturėlis;4166351390;Ne;0;3;1;4
13507;Vilnelė;Vyturėlis;1351798589;Ne;0;4;0;4
13508;Vilnelė;Vyturėlis;2841315531;Ne;2;3;3;8
13509;Vilnelė;Vyturėlis;9162681538;Ne;0;2;0;2
13510;Vilnelė;Vyturėlis;3075681823;Ne;0;2;0;2
13511;Vilnelė;Vyturėlis;9804772168;Ne;5;4;0;9
13512;Vilnelė;Vyturėlis;1596625263;Ne;0;1;1;2
13513;Vilnelė;Vyturėlis;7338573817;Ne;0;1;0;1
13514;Vilnelė;Vyturėlis;8121075430;Ne;3;2;0;5
13515;Vilnelė;Vyturėlis;6342242777;Ne;1;0;1;2
13516;Vilnelė;Vyturėlis;3843064564;Ne;2;4;0;6
13517;Vilnelė;Vyturėlis;9674145631;Ne;0;5;0;5
13518;Vilnelė;Pagrandukas;5508759323;Ne;10;0;0;10
13519;Vilnelė;Pagrandukas;2144925171;Ne;0;5;0;5
13520;Vilnelė;Pagrandukas;4295816753;Ne;0;3;0;3
13521;Vilnelė;Pagrandukas;3844066232;Ne;0;11;0;11
13522;Vilnelė;Pagrandukas;6659537454;Ne;2;4;0;6
13523;Vilnelė;Pagrandukas;4448413194;Ne;9;0;0;9
13524;Vilnelė;Pagrandukas;6830433856;Ne;0;2;4;6
13525;Vilnelė;Pagrandukas;4664946923;Ne;0;2;0;2
13526;Vilnelė;Pagrandukas;6982847450;Ne;0;6;0;6
13527;Vilnelė;Pagrandukas;7560124407;Ne;0;4;3;7
13528;Vilnelė;Pagrandukas;3685294539;Ne;3;0;0;3
13529;Vilnelė;Pagrandukas;4931943297;Ne;0;0;4;4
13530;Vilnelė;Pagrandukas;7882756938;Ne;0;1;0;1
13531;Vilnelė;Pagrandukas;7348404699;Ne;4;4;0;8
13532;Vilnelė;Pagrandukas;3323738649;Ne;5;5;0;10
13533;Vilnelė;Pagrandukas;8116613831;Ne;0;3;0;3
13534;Vilnelė;Pagrandukas;9489760844;Ne;0;2;0;2
13535;Vilnelė;Pagrandukas;6466321228;Ne;0;14;0;14
13536;Vilnelė;Pagrandukas;4478847902;Ne;0;10;0;10
13537;Vilnelė;Pagrandukas;9635159885;Ne;0;2;4;6
13538;Vilnelė;Pagrandukas;6448119003;Ne;0;3;0;3
13539;Vilnelė;Pagrandukas;2165389724;Ne;0;0;3;3
13540;Vilnelė;Bitutė;4718994967;Ne;0;19;0;19
13541;Vilnelė;Bitutė;3529718234;Ne;0;7;0;7
13542;Vilnelė;Bitutė;1880318663;Ne;0;5;0;5
13543;Vilnelė;Bitutė;9589410276;Ne;0;5;0;5
13544;Vilnelė;Bitutė;9879688569;Ne;0;3;0;3
13545;Vilnelė;Bitutė;5473379559;Ne;0;3;0;3
13546;Vilnelė;Bitutė;3781595939;Ne;0;7;0;7
13547;Vilnelė;Bitutė;3791258264;Ne;0;6;0;6
13548;Vilnelė;Bitutė;6132739519;Ne;1;10;0;11
13549;Vilnelė;Bitutė;1730149127;Ne;0;8;0;8
13550;Vilnelė;Bitutė;9884955712;Ne;11;6;0;17
13551;Vilnelė;Bitutė;5778176840;Ne;0;3;0;3
13552;Vilnelė;Bitutė;8162191913;Ne;0;7;0;7
13553;Vilnelė;Bitutė;6355912551;Ne;5;8;0;13
13554;Vilnelė;Bitutė;3945921490;Ne;0;20;0;20
13555;Vilnelė;Bitutė;7976798775;Ne;0;16;0;16
13556;Vilnelė;Bitutė;1975954784;Ne;7;3;0;10
13557;Vilnelė;Bitutė;8092642447;Ne;0;1;0;1
13558;Vilnelė;Bitutė;7199490431;Ne;0;6;0;6
13559;Vilnelė;Bitutė;3811289758;Ne;0;10;0;10
13560;Vilnelė;Bitutė;3856917286;Ne;0;15;0;15
13561;Vilnelė;Bitutė;7883724600;Ne;3;8;0;11
13562;Vilnelė;Šaltinėlis;5487729159;Ne;9;4;0;13
13563;Vilnelė;Šaltinėlis;1108529953;Ne;5;0;0;5
13564;Vilnelė;Šaltinėlis;8118746185;Ne;3;0;0;3
13565;Vilnelė;Šaltinėlis;7949990857;Ne;3;1;0;4
13566;Vilnelė;Šaltinėlis;8267286482;Ne;9;1;0;10
13567;Vilnelė;Šaltinėlis;3579253910;Ne;0;2;0;2
13568;Vilnelė;Šaltinėlis;4973214588;Ne;0;19;0;19
13569;Vilnelė;Šaltinėlis;4939435139;Ne;9;4;0;13
13570;Vilnelė;Šaltinėlis;6858955752;Ne;3;2;0;5
13571;Vilnelė;Šaltinėlis;9578062060;Taip;13;0;0;13
13572;Vilnelė;Šaltinėlis;5341996342;Ne;9;2;0;11
13573;Vilnelė;Šaltinėlis;2639194662;Ne;6;1;0;7
13574;Vilnelė;Šaltinėlis;5625236416;Ne;14;1;0;15
13575;Vilnelė;Šaltinėlis;9774791340;Ne;13;0;0;13
13576;Vilnelė;Šaltinėlis;1893356606;Taip;0;11;0;11
13577;Vilnelė;Šaltinėlis;2835124257;Ne;5;2;0;7
13578;Vilnelė;Šaltinėlis;7924367229;Ne;10;2;0;12
13579;Vilnelė;Riešutėllis;1027463000;Ne;5;2;0;7
13580;Vilnelė;Riešutėllis;7020707723;Ne;6;4;0;10
13581;Vilnelė;Riešutėllis;1960860528;Ne;4;0;0;4
13582;Vilnelė;Riešutėllis;4203549404;Ne;4;1;3;8
13583;Vilnelė;Riešutėllis;3290952017;Ne;0;2;0;2
13584;Vilnelė;Riešutėllis;8588430578;Ne;0;8;0;8
13585;Vilnelė;Riešutėllis;7957695470;Ne;0;5;0;5
13586;Vilnelė;Riešutėllis;8750705826;Ne;3;1;0;4
13587;Vilnelė;Riešutėllis;4780827432;Ne;0;5;0;5
13588;Vilnelė;Riešutėllis;4455099179;Ne;4;2;0;6
13589;Vilnelė;Riešutėllis;2367127222;Ne;0;4;0;4
13590;Vilnelė;Riešutėllis;5306723959;Ne;7;1;0;8
13591;Vilnelė;Riešutėllis;3670613082;Ne;5;6;0;11
13592;Vilnelė;Riešutėllis;3211657057;Ne;0;7;0;7
13593;Vilnelė;Riešutėllis;9016866597;Ne;6;8;0;14
13594;Vilnelė;Riešutėllis;7087798406;Ne;0;5;0;5
13595;Vilnelė;Riešutėllis;4254744025;Ne;10;3;0;13
13596;Vilnelė;Riešutėllis;3730997665;Ne;4;1;0;5
13597;Vilnelė;Riešutėllis;2706699572;Ne;0;4;0;4
13598;Vilnelė;Riešutėllis;8774842903;Ne;0;3;0;3
13599;Vilnelė;Riešutėllis;3031790547;Ne;0;1;0;1
13600;Vilnelė;Nykštukas;4210511566;Taip;9;0;0;9
13601;Vilnelė;Nykštukas;2891787022;Ne;3;4;0;7
13602;Vilnelė;Nykštukas;4734511521;Ne;12;3;0;15
13603;Vilnelė;Nykštukas;6344134620;Ne;0;5;0;5
13604;Vilnelė;Nykštukas;4295630317;Ne;30;0;0;30
13605;Vilnelė;Nykštukas;1554473199;Ne;9;9;0;18
13606;Vilnelė;Nykštukas;1819154122;Ne;3;0;0;3
13607;Vilnelė;Nykštukas;4060927733;Ne;12;2;0;14
13608;Vilnelė;Nykštukas;2299381653;Ne;0;16;0;16
13609;Vilnelė;Nykštukas;5041031750;Ne;5;6;0;11
13610;Vilnelė;Nykštukas;2157793186;Ne;7;7;0;14
13611;Vilnelė;Nykštukas;4516818999;Ne;2;20;0;22
13612;Vilnelė;Nykštukas;8579294202;Ne;0;23;0;23
13613;Vilnelė;Nykštukas;7161529969;Ne;0;7;0;7
13614;Vilnelė;Nykštukas;3720979747;Ne;0;4;0;4
13615;Vilnelė;Nykštukas;8493390146;Ne;5;1;0;6
13616;Vilnelė;Nykštukas;6048991617;Ne;5;6;1;12
13617;Vilnelė;Nykštukas;6054488692;Ne;0;13;0;13
13618;Vilnelė;Nykštukas;8630048961;Ne;0;12;0;12
13619;Vilnelė;Nykštukas;1500899512;Ne;0;2;0;2
13620;Vilnelė;Nykštukas;7592040226;Ne;0;9;0;9
13621;Vilnelė;Nykštukas;1515873552;Ne;8;7;0;15
13622;Vilnelė;Nykštukas;5629086127;Ne;4;2;0;6
13623;Vilnelė;Pieštukas;9882766915;Ne;0;13;0;13
13624;Vilnelė;Pieštukas;5444967820;Ne;7;0;0;7
13625;Vilnelė;Pieštukas;3828623778;Ne;3;2;0;5
13626;Vilnelė;Pieštukas;7698638698;Ne;11;0;0;11
13627;Vilnelė;Pieštukas;3064118212;Ne;3;5;0;8
13628;Vilnelė;Pieštukas;7231998656;Ne;12;1;0;13
13629;Vilnelė;Pieštukas;2343750614;Ne;11;0;0;11
13630;Vilnelė;Pieštukas;4670933970;Ne;1;3;0;4
13631;Vilnelė;Pieštukas;9317041585;Ne;13;0;1;14
13632;Vilnelė;Pieštukas;2683662906;Ne;19;0;0;19
13633;Vilnelė;Pieštukas;4982137749;Ne;0;3;0;3
13634;Vilnelė;Pieštukas;2700153185;Ne;5;1;0;6
13635;Vilnelė;Pieštukas;4817502971;Ne;11;2;0;13
13636;Vilnelė;Pieštukas;3712463891;Ne;3;3;0;6
13637;Vilnelė;Pieštukas;2576381995;Ne;1;0;1;2
13638;Vilnelė;Pieštukas;9476510950;Ne;10;0;1;11
13639;Vilnelė;Pieštukas;9316933315;Ne;0;3;0;3
13640;Vilnelė;Pieštukas;8848138564;Ne;2;6;0;8
13641;Vilnelė;Pieštukas;7752502124;Ne;5;0;0;5
13642;Vilnelė;Voverytė;1414168531;Ne;2;0;4;6
13643;Vilnelė;Voverytė;2918624119;Ne;5;0;2;7
13644;Vilnelė;Voverytė;3432602015;Ne;6;0;0;6
13645;Vilnelė;Voverytė;9660305163;Ne;2;8;1;11
13646;Vilnelė;Voverytė;9950598582;Taip;10;1;0;11
13647;Vilnelė;Voverytė;7968029402;Ne;0;2;2;4
13648;Vilnelė;Voverytė;7221712624;Ne;2;2;2;6
13649;Vilnelė;Voverytė;2964672357;Ne;0;8;0;8
13650;Vilnelė;Voverytė;5273665901;Ne;6;2;0;8
13651;Vilnelė;Voverytė;1566734465;Ne;5;0;2;7
13652;Vilnelė;Voverytė;1371066506;Ne;12;0;0;12
13653;Vilnelė;Voverytė;3654833067;Ne;0;3;2;5
13654;Vilnelė;Voverytė;4322462166;Ne;0;3;2;5
13655;Vilnelė;Voverytė;5649725693;Ne;9;6;0;15
13656;Vilnelė;Voverytė;3234028667;Ne;6;7;0;13
13657;Vilnelė;Voverytė;6569980514;Ne;26;0;0;26
13658;Vilnelė;Voverytė;4758117005;Taip;5;4;4;13
13659;Vilnelė;Voverytė;6634526716;Ne;10;4;0;14
13660;Vilnelė;Voverytė;1598555488;Ne;0;3;0;3
13661;Vilnelė;Voverytė;5960725916;Ne;0;16;0;16
13662;Vilnelė;Voverytė;7568755715;Ne;0;0;1;1
13663;Vilnelė;Kodėlčiukas;4642378600;Ne;8;3;0;11
13664;Vilnelė;Kodėlčiukas;6618109352;Ne;0;22;0;22
13665;Vilnelė;Kodėlčiukas;6715997340;Ne;8;0;0;8
13666;Vilnelė;Kodėlčiukas;9482133396;Ne;6;0;0;6
13667;Vilnelė;Kodėlčiukas;8620789304;Ne;0;4;0;4
13668;Vilnelė;Kodėlčiukas;8439505238;Ne;27;0;0;27
13669;Vilnelė;Kodėlčiukas;1580287517;Ne;0;7;0;7
13670;Vilnelė;Kodėlčiukas;5558378376;Ne;0;3;0;3
13671;Vilnelė;Kodėlčiukas;4328263940;Ne;5;7;0;12
13672;Vilnelė;Kodėlčiukas;3056845279;Ne;0;13;0;13
13673;Vilnelė;Kodėlčiukas;9537740492;Ne;10;0;0;10
13674;Vilnelė;Kodėlčiukas;9640330864;Ne;5;4;0;9
13675;Vilnelė;Kodėlčiukas;3848720970;Ne;6;2;0;8
13676;Vilnelė;Kodėlčiukas;7833531435;Ne;0;2;0;2
13677;Vilnelė;Kodėlčiukas;5961910077;Ne;7;6;0;13
13678;Vilnelė;Kodėlčiukas;3115242919;Ne;3;7;0;10
13679;Vilnelė;Kodėlčiukas;8543995029;Taip;9;9;0;18
13680;Vilnelė;Kodėlčiukas;1933660272;Ne;2;0;0;2
13681;Vilnelė;Kodėlčiukas;4986079102;Ne;0;6;0;6
13682;Vilnelė;Kodėlčiukas;5398303580;Ne;0;4;0;4
13683;Vilnelė;Kodėlčiukas;9418661965;Ne;0;3;0;3
13684;Vilnelė;Kodėlčiukas;5180951251;Ne;0;2;0;2
13685;Vilnelė;Žirniukas;9817054571;Ne;6;2;0;8
13686;Vilnelė;Žirniukas;5147406277;Ne;18;0;0;18
13687;Vilnelė;Žirniukas;9476348226;Ne;11;0;0;11
13688;Vilnelė;Žirniukas;9253975757;Ne;0;1;0;1
13689;Vilnelė;Žirniukas;9432188739;Ne;2;0;0;2
13690;Vilnelė;Žirniukas;8216383228;Ne;3;2;0;5
13691;Vilnelė;Žirniukas;2358167792;Ne;8;0;0;8
13692;Vilnelė;Žirniukas;2146981715;Ne;4;0;0;4
13693;Vilnelė;Žirniukas;1465849135;Ne;4;1;0;5
13694;Vilnelė;Žirniukas;9578715472;Ne;10;0;0;10
13695;Vilnelė;Žirniukas;2188575653;Ne;0;19;0;19
13696;Vilnelė;Žirniukas;2234709212;Ne;6;0;0;6
13697;Vilnelė;Žirniukas;1912897383;Ne;15;0;0;15
13698;Vilnelė;Žirniukas;4789175532;Ne;9;0;0;9
13699;Vilnelė;Pipiras;1977362135;Ne;15;0;0;15
13700;Vilnelė;Pipiras;6883775268;Ne;9;1;0;10
13701;Vilnelė;Pipiras;1336126156;Ne;5;4;0;9
13702;Vilnelė;Pipiras;8061099641;Ne;0;1;0;1
13703;Vilnelė;Pipiras;5855361002;Ne;5;0;0;5
13704;Vilnelė;Pipiras;1631249610;Ne;10;5;0;15
13705;Vilnelė;Pipiras;4692537934;Ne;0;3;0;3
13706;Vilnelė;Pipiras;9300237246;Ne;1;6;0;7
13707;Vilnelė;Pipiras;7090044022;Ne;5;0;0;5
13708;Vilnelė;Pipiras;8602843000;Ne;7;3;0;10
13709;Vilnelė;Pipiras;9909858294;Ne;1;7;0;8
13710;Vilnelė;Pipiras;6707024855;Ne;0;4;0;4
13711;Vilnelė;Pipiras;9016135318;Ne;0;5;0;5
13712;Vilnelė;Pipiras;8015908754;Ne;6;3;0;9
13713;Vilnelė;Pipiras;4445721874;Ne;0;19;0;19
13714;Vilnelė;Pipiras;1003518211;Ne;0;19;0;19
13715;Vilnelė;Pipiras;3980908303;Ne;4;1;0;5
13716;Vėrinėlis;GAIDELIAI;6162461750;Ne;0;0;3;3
13717;Vėrinėlis;GAIDELIAI;1944358526;Ne;14;0;0;14
13718;Vėrinėlis;GAIDELIAI;3500287869;Ne;10;4;0;14
13719;Vėrinėlis;GAIDELIAI;6500266853;Ne;3;0;1;4
13720;Vėrinėlis;GAIDELIAI;5891690000;Ne;13;0;0;13
13721;Vėrinėlis;GAIDELIAI;4401001009;Ne;8;8;0;16
13722;Vėrinėlis;GAIDELIAI;1685329004;Ne;6;5;0;11
13723;Vėrinėlis;GAIDELIAI;4498096701;Ne;6;0;1;7
13724;Vėrinėlis;GAIDELIAI;9144004655;Ne;12;0;0;12
13725;Vėrinėlis;GAIDELIAI;8272531606;Ne;9;1;0;10
13726;Vėrinėlis;GAIDELIAI;2114637828;Ne;0;5;1;6
13727;Vėrinėlis;GAIDELIAI;1844862699;Ne;12;0;1;13
13728;Vėrinėlis;GAIDELIAI;7455948332;Ne;0;5;0;5
13729;Vėrinėlis;GAIDELIAI;4965735537;Ne;5;0;0;5
13730;Vėrinėlis;GAIDELIAI;1014076118;Ne;7;3;0;10
13731;Vėrinėlis;GAIDELIAI;2273903945;Ne;10;0;2;12
13732;Vėrinėlis;GAIDELIAI;8817186115;Ne;0;5;0;5
13733;Vėrinėlis;GAIDELIAI;8050158529;Ne;1;0;0;1
13734;Vėrinėlis;GAIDELIAI;6211953526;Ne;0;0;1;1
13735;Vėrinėlis;GAIDELIAI;9522506115;Ne;0;6;0;6
13736;Vėrinėlis;GAIDELIAI;6159725406;Ne;2;4;0;6
13737;Vėrinėlis;SAULUTĖ;7224418233;Ne;12;0;0;12
13738;Vėrinėlis;SAULUTĖ;7471147288;Ne;0;4;0;4
13739;Vėrinėlis;SAULUTĖ;8238013636;Ne;13;0;0;13
13740;Vėrinėlis;SAULUTĖ;7273090217;Ne;0;4;0;4
13741;Vėrinėlis;SAULUTĖ;2337883071;Ne;6;0;2;8
13742;Vėrinėlis;SAULUTĖ;6913001318;Ne;0;4;0;4
13743;Vėrinėlis;SAULUTĖ;7440020169;Ne;0;8;0;8
13744;Vėrinėlis;SAULUTĖ;7913975075;Ne;0;7;0;7
13745;Vėrinėlis;SAULUTĖ;9967737864;Ne;0;8;0;8
13746;Vėrinėlis;SAULUTĖ;9009344779;Ne;0;6;0;6
13747;Vėrinėlis;SAULUTĖ;4059906525;Ne;9;0;1;10
13748;Vėrinėlis;SAULUTĖ;3832662507;Ne;5;0;1;6
13749;Vėrinėlis;SAULUTĖ;3291922401;Ne;7;3;0;10
13750;Vėrinėlis;SAULUTĖ;1007705906;Ne;5;4;0;9
13751;Vėrinėlis;SAULUTĖ;9289003583;Ne;0;5;0;5
13752;Vėrinėlis;SAULUTĖ;1684203955;Ne;0;5;0;5
13753;Vėrinėlis;SAULUTĖ;5942475043;Ne;0;9;0;9
13754;Vėrinėlis;SAULUTĖ;9310629340;Ne;14;0;0;14
13755;Vėrinėlis;SAULUTĖ;2369434537;Ne;0;7;0;7
13756;Vėrinėlis;SAULUTĖ;1515803985;Ne;0;3;1;4
13757;Vėrinėlis;SAULUTĖ;1303022448;Ne;13;0;0;13
13758;Vėrinėlis;NYKŠTUKAI;5488087105;Ne;5;6;0;11
13759;Vėrinėlis;NYKŠTUKAI;5859566909;Ne;0;1;0;1
13760;Vėrinėlis;NYKŠTUKAI;4423562494;Ne;12;0;0;12
13761;Vėrinėlis;NYKŠTUKAI;5167825818;Ne;0;0;15;15
13762;Vėrinėlis;NYKŠTUKAI;2646575761;Ne;0;4;0;4
13763;Vėrinėlis;NYKŠTUKAI;9300891973;Ne;11;1;0;12
13764;Vėrinėlis;NYKŠTUKAI;8980451743;Ne;0;2;1;3
13765;Vėrinėlis;NYKŠTUKAI;8397635057;Ne;17;1;0;18
13766;Vėrinėlis;NYKŠTUKAI;8423611087;Ne;13;0;0;13
13767;Vėrinėlis;NYKŠTUKAI;8294753714;Ne;6;2;0;8
13768;Vėrinėlis;NYKŠTUKAI;4841000338;Ne;7;1;0;8
13769;Vėrinėlis;NYKŠTUKAI;2403376619;Ne;5;3;0;8
13770;Vėrinėlis;NYKŠTUKAI;2384172198;Ne;2;2;0;4
13771;Vėrinėlis;NYKŠTUKAI;4133310852;Ne;4;0;0;4
13772;Vėrinėlis;NYKŠTUKAI;7958241295;Ne;10;4;0;14
13773;Vėrinėlis;BURATINAS;7093959212;Ne;5;5;0;10
13774;Vėrinėlis;BURATINAS;8100283579;Ne;2;2;0;4
13775;Vėrinėlis;BURATINAS;2774618380;Ne;0;5;0;5
13776;Vėrinėlis;BURATINAS;5429955166;Ne;4;4;0;8
13777;Vėrinėlis;BURATINAS;5429372946;Ne;6;0;0;6
13778;Vėrinėlis;BURATINAS;2467700639;Ne;16;0;0;16
13779;Vėrinėlis;BURATINAS;6136232912;Ne;0;5;0;5
13780;Vėrinėlis;BURATINAS;7092421890;Ne;0;2;0;2
13781;Vėrinėlis;BURATINAS;6058712578;Ne;0;8;0;8
13782;Vėrinėlis;BURATINAS;6413701823;Ne;5;0;0;5
13783;Vėrinėlis;BURATINAS;2364117224;Ne;0;4;0;4
13784;Vėrinėlis;BURATINAS;7287634205;Ne;8;0;0;8
13785;Vėrinėlis;BURATINAS;3898060925;Ne;9;7;0;16
13786;Vėrinėlis;BURATINAS;4676052255;Ne;2;10;0;12
13787;Vėrinėlis;BURATINAS;3882915774;Ne;0;5;0;5
13788;Vėrinėlis;BURATINAS;7167034587;Ne;0;7;0;7
13789;Vėrinėlis;BURATINAS;1919350623;Ne;18;0;0;18
13790;Vėrinėlis;BURATINAS;9612956692;Ne;0;6;0;6
13791;Vėrinėlis;BURATINAS;6310807762;Ne;5;0;0;5
13792;Vėrinėlis;BURATINAS;5514167627;Ne;0;1;0;1
13793;Vėrinėlis;GINTARĖLIAI;8372084728;Ne;10;3;0;13
13794;Vėrinėlis;GINTARĖLIAI;6054398276;Ne;8;0;0;8
13795;Vėrinėlis;GINTARĖLIAI;7432965615;Ne;6;4;0;10
13796;Vėrinėlis;GINTARĖLIAI;3457199716;Ne;7;4;0;11
13797;Vėrinėlis;GINTARĖLIAI;7743951577;Taip;8;4;0;12
13798;Vėrinėlis;GINTARĖLIAI;2006432327;Ne;10;4;0;14
13799;Vėrinėlis;GINTARĖLIAI;6785519869;Taip;16;0;0;16
13800;Vėrinėlis;GINTARĖLIAI;3363388500;Ne;3;10;0;13
13801;Vėrinėlis;GINTARĖLIAI;8545392429;Ne;2;0;0;2
13802;Vėrinėlis;GINTARĖLIAI;9171173116;Ne;0;1;0;1
13803;Vėrinėlis;GINTARĖLIAI;3192625484;Ne;2;2;0;4
13804;Vėrinėlis;GINTARĖLIAI;8343196405;Ne;4;5;0;9
13805;Vėrinėlis;GINTARĖLIAI;2284527544;Ne;4;0;0;4
13806;Vėrinėlis;GINTARĖLIAI;5644772729;Ne;1;3;0;4
13807;Vėrinėlis;GINTARĖLIAI;4034106321;Ne;3;0;0;3
13808;Vėrinėlis;GINTARĖLIAI;5654269153;Ne;5;0;0;5
13809;Vėrinėlis;GINTARĖLIAI;6226329879;Ne;4;0;0;4
13810;Vėrinėlis;GINTARĖLIAI;7069247393;Ne;6;0;0;6
13811;Vėrinėlis;GINTARĖLIAI;9370715798;Taip;9;0;0;9
13812;Vėrinėlis;GINTARĖLIAI;6055921178;Ne;3;4;0;7
13813;Vėrinėlis;RAMUNĖLĖS;5447760434;Ne;0;7;0;7
13814;Vėrinėlis;RAMUNĖLĖS;2911674984;Ne;14;6;0;20
13815;Vėrinėlis;RAMUNĖLĖS;4123553749;Ne;21;0;0;21
13816;Vėrinėlis;RAMUNĖLĖS;9234123596;Ne;6;0;0;6
13817;Vėrinėlis;RAMUNĖLĖS;5051742311;Ne;9;1;1;11
13818;Vėrinėlis;RAMUNĖLĖS;9257045102;Ne;4;0;0;4
13819;Vėrinėlis;RAMUNĖLĖS;5501075800;Ne;1;0;0;1
13820;Vėrinėlis;RAMUNĖLĖS;1699912818;Ne;13;0;0;13
13821;Vėrinėlis;RAMUNĖLĖS;4492269367;Ne;0;1;0;1
13822;Vėrinėlis;RAMUNĖLĖS;7294499755;Taip;10;6;0;16
13823;Vėrinėlis;RAMUNĖLĖS;7544881486;Ne;0;8;0;8
13824;Vėrinėlis;RAMUNĖLĖS;1403519604;Ne;21;0;0;21
13825;Vėrinėlis;RAMUNĖLĖS;6240649255;Ne;21;0;0;21
13826;Vėrinėlis;RAMUNĖLĖS;2763569936;Ne;0;4;0;4
13827;Vėrinėlis;RAMUNĖLĖS;7349463495;Ne;5;8;0;13
13828;Vėrinėlis;RAMUNĖLĖS;9935098198;Ne;5;0;0;5
13829;Vėrinėlis;KODELČIUKŲ;8722816580;Ne;7;0;2;9
13830;Vėrinėlis;KODELČIUKŲ;5342916562;Ne;9;0;0;9
13831;Vėrinėlis;KODELČIUKŲ;6316271212;Ne;10;0;0;10
13832;Vėrinėlis;KODELČIUKŲ;9650883071;Ne;13;0;0;13
13833;Vėrinėlis;KODELČIUKŲ;9349874701;Ne;3;0;0;3
13834;Vėrinėlis;KODELČIUKŲ;9179544549;Ne;17;0;0;17
13835;Vėrinėlis;KODELČIUKŲ;3830101723;Ne;15;0;0;15
13836;Vėrinėlis;KODELČIUKŲ;4818860992;Ne;4;4;0;8
13837;Vėrinėlis;KODELČIUKŲ;2908247336;Ne;16;0;0;16
13838;Vėrinėlis;KODELČIUKŲ;8389805682;Taip;8;4;0;12
13839;Vėrinėlis;KODELČIUKŲ;3563156582;Ne;13;0;1;14
13840;Vėrinėlis;KODELČIUKŲ;1119458722;Ne;16;0;0;16
13841;Vėrinėlis;KODELČIUKŲ;8029977991;Ne;10;0;0;10
13842;Vėrinėlis;KODELČIUKŲ;4065241921;Ne;5;4;0;9
13843;Vėrinėlis;KODELČIUKŲ;8977670959;Ne;14;0;0;14
13844;Vėrinėlis;KODELČIUKŲ;7382201231;Ne;13;0;0;13
13845;Vėrinėlis;ŽIRNIUKAI;1769852084;Ne;0;4;1;5
13846;Vėrinėlis;ŽIRNIUKAI;4718732261;Ne;0;4;0;4
13847;Vėrinėlis;ŽIRNIUKAI;4981127515;Ne;0;4;0;4
13848;Vėrinėlis;ŽIRNIUKAI;8329989952;Ne;4;0;0;4
13849;Vėrinėlis;ŽIRNIUKAI;3202518504;Ne;0;5;5;10
13850;Vėrinėlis;ŽIRNIUKAI;4752902173;Ne;5;5;0;10
13851;Vėrinėlis;ŽIRNIUKAI;7237945125;Ne;1;3;0;4
13852;Vėrinėlis;ŽIRNIUKAI;5600815908;Ne;5;4;0;9
13853;Vėrinėlis;ŽIRNIUKAI;1736733257;Ne;0;1;1;2
13854;Vėrinėlis;ŽIRNIUKAI;2687583764;Ne;4;0;0;4
13855;Vėrinėlis;ŽIRNIUKAI;2633143128;Ne;0;3;1;4
13856;Vėrinėlis;ŽIRNIUKAI;9419245081;Ne;0;3;0;3
13857;Vėrinėlis;ŽIRNIUKAI;7817387800;Ne;3;4;0;7
13858;Vėrinėlis;ŽIRNIUKAI;6377447141;Ne;7;3;1;11
13859;Vėrinėlis;ŽIRNIUKAI;7371908331;Ne;0;5;0;5
13860;Vėrinėlis;ŽIRNIUKAI;2087129236;Ne;0;3;0;3
13861;Vėrinėlis;ŽIRNIUKAI;6392625405;Ne;0;4;0;4
13862;Vėrinėlis;ŽIRNIUKAI;1896980533;Ne;4;1;1;6
13863;Vėrinėlis;ŽIRNIUKAI;8483525051;Ne;0;5;1;6
13864;Vėrinėlis;ŽIRNIUKAI;8397025332;Ne;0;4;0;4
13865;Vėrinėlis;ŽIRNIUKAI;6576726481;Ne;0;4;0;4
13866;Vėrinėlis;ŽIRNIUKAI;6220653152;Ne;0;4;0;4
13867;Vėrinėlis;VARPELIAI;7416041207;Ne;0;6;0;6
13868;Vėrinėlis;VARPELIAI;8655158155;Ne;9;4;0;13
13869;Vėrinėlis;VARPELIAI;3829146401;Ne;0;3;0;3
13870;Vėrinėlis;VARPELIAI;6177784856;Ne;0;2;0;2
13871;Vėrinėlis;VARPELIAI;6362125404;Ne;13;4;0;17
13872;Vėrinėlis;VARPELIAI;9599724421;Ne;5;2;0;7
13873;Vėrinėlis;VARPELIAI;7216867683;Ne;5;5;0;10
13874;Vėrinėlis;VARPELIAI;8336694468;Ne;0;2;0;2
13875;Vėrinėlis;VARPELIAI;2731207996;Ne;0;0;6;6
13876;Vėrinėlis;VARPELIAI;2625930005;Ne;0;0;2;2
13877;Vėrinėlis;VARPELIAI;1026312967;Ne;0;4;0;4
13878;Vėrinėlis;VARPELIAI;2561255096;Ne;17;0;0;17
13879;Vėrinėlis;VARPELIAI;3392458614;Ne;5;5;0;10
13880;Vėrinėlis;VARPELIAI;5837383907;Ne;0;5;0;5
13881;Vėrinėlis;VARPELIAI;3953496894;Ne;5;4;0;9
13882;Vėrinėlis;VARPELIAI;3663446767;Ne;4;1;0;5
13883;Vėrinėlis;VARPELIAI;4086695239;Ne;6;0;0;6
13884;Vėrinėlis;BORUŽĖLĖS;8759487574;Ne;6;4;0;10
13885;Vėrinėlis;BORUŽĖLĖS;4819016753;Ne;6;0;0;6
13886;Vėrinėlis;BORUŽĖLĖS;1910385020;Ne;6;4;0;10
13887;Vėrinėlis;BORUŽĖLĖS;2078857084;Ne;6;0;0;6
13888;Vėrinėlis;BORUŽĖLĖS;3934652683;Ne;6;0;0;6
13889;Vėrinėlis;BORUŽĖLĖS;6904733283;Ne;11;0;1;12
13890;Vėrinėlis;BORUŽĖLĖS;4446546335;Ne;5;4;0;9
13891;Vėrinėlis;BORUŽĖLĖS;3718510933;Ne;5;1;0;6
13892;Vėrinėlis;BORUŽĖLĖS;2501287529;Ne;0;3;0;3
13893;Vėrinėlis;BORUŽĖLĖS;8904833339;Ne;7;4;0;11
13894;Vėrinėlis;BORUŽĖLĖS;3312501759;Ne;7;4;0;11
13895;Vėrinėlis;BORUŽĖLĖS;9217188911;Ne;10;9;0;19
13896;Vėrinėlis;BORUŽĖLĖS;7414937335;Ne;19;0;0;19
13897;Vėrinėlis;BORUŽĖLĖS;2574507205;Ne;2;3;0;5
13898;Vėrinėlis;BORUŽĖLĖS;6671382987;Ne;7;0;0;7
13899;Vėrinėlis;BORUŽĖLĖS;4852563692;Ne;0;2;1;3
13900;Vėrinėlis;BORUŽĖLĖS;5865529907;Ne;6;0;0;6
13901;Vėrinėlis;BORUŽĖLĖS;9613642664;Ne;0;5;0;5
13902;Vėrinėlis;BORUŽĖLĖS;2467242845;Ne;0;7;0;7
13903;Vėrinėlis;BORUŽĖLĖS;4037594669;Ne;5;2;0;7
13904;Vėrinėlis;SVEIKUOLIAI;1909742394;Ne;0;1;0;1
13905;Vėrinėlis;SVEIKUOLIAI;6176308531;Ne;0;6;0;6
13906;Vėrinėlis;SVEIKUOLIAI;3070965434;Ne;0;3;0;3
13907;Vėrinėlis;SVEIKUOLIAI;6154618103;Ne;0;4;0;4
13908;Vėrinėlis;SVEIKUOLIAI;3563114419;Ne;8;0;0;8
13909;Vėrinėlis;SVEIKUOLIAI;3973272659;Ne;2;5;0;7
13910;Vėrinėlis;SVEIKUOLIAI;8032396191;Ne;3;0;0;3
13911;Vėrinėlis;SVEIKUOLIAI;6504377326;Ne;0;1;0;1
13912;Vėrinėlis;SVEIKUOLIAI;8716965452;Ne;8;4;0;12
13913;Vėrinėlis;SVEIKUOLIAI;7584124339;Ne;9;0;1;10
13914;Vėrinėlis;SVEIKUOLIAI;9352630743;Ne;0;4;0;4
13915;Vėrinėlis;SVEIKUOLIAI;4859330774;Ne;8;1;0;9
13916;Vėrinėlis;SVEIKUOLIAI;8543081245;Ne;0;2;0;2
13917;Vėrinėlis;SVEIKUOLIAI;1800434426;Ne;0;4;0;4
13918;Vėrinėlis;SVEIKUOLIAI;3958551159;Ne;0;2;0;2
13919;Vėrinėlis;SVEIKUOLIAI;5614185158;Ne;0;2;0;2
13920;Vėrinėlis;SVEIKUOLIAI;5539714292;Taip;0;7;0;7
13921;Vėrinėlis;SVEIKUOLIAI;2516474825;Ne;1;0;0;1
13922;Vėrinėlis;SVEIKUOLIAI;9058127692;Ne;3;1;0;4
13923;Vėrinėlis;SVEIKUOLIAI;1278914183;Ne;4;0;1;5
13924;Vėrinėlis;SVEIKUOLIAI;7573209012;Ne;0;4;0;4
13925;Vėrinėlis;SVEIKUOLIAI;3084117432;Ne;0;2;0;2
13926;Vėrinėlis;SVEIKUOLIAI;2015928440;Ne;3;2;0;5
13927;Vėrinėlis;ŠIRDELĖS;7734163541;Ne;0;3;0;3
13928;Vėrinėlis;ŠIRDELĖS;7811024382;Ne;4;0;1;5
13929;Vėrinėlis;ŠIRDELĖS;4378592116;Ne;5;2;0;7
13930;Vėrinėlis;ŠIRDELĖS;7517113022;Ne;6;1;0;7
13931;Vėrinėlis;ŠIRDELĖS;1841277321;Ne;0;3;0;3
13932;Vėrinėlis;ŠIRDELĖS;5588658517;Ne;10;5;0;15
13933;Vėrinėlis;ŠIRDELĖS;5653635907;Ne;0;9;0;9
13934;Vėrinėlis;ŠIRDELĖS;1152010178;Ne;0;9;0;9
13935;Vėrinėlis;ŠIRDELĖS;2038169885;Ne;0;17;0;17
13936;Vėrinėlis;ŠIRDELĖS;9375922889;Taip;11;7;0;18
13937;Vėrinėlis;ŠIRDELĖS;5813009126;Ne;0;13;0;13
13938;Vėrinėlis;ŠIRDELĖS;3511809411;Ne;0;2;0;2
13939;Vėrinėlis;ŠIRDELĖS;9217815657;Ne;0;8;0;8
13940;Vėrinėlis;ŠIRDELĖS;4403875733;Ne;0;0;1;1
13941;Vėrinėlis;ŠIRDELĖS;4700093328;Ne;0;5;4;9
13942;Vėrinėlis;ŠIRDELĖS;1339847370;Ne;0;0;3;3
13943;Vėrinėlis;ŠIRDELĖS;3687250255;Ne;0;6;0;6
13944;Vėrinėlis;ŠIRDELĖS;7361319518;Ne;0;0;4;4
13945;Vėrinėlis;ŠIRDELĖS;2847839917;Taip;10;4;0;14
13946;Vėrinėlis;ŠIRDELĖS;7311740859;Ne;0;11;0;11
13947;Vėrinėlis;ŠIRDELĖS;6905591549;Ne;0;16;0;16
13948;Viltenė;Drugeliai;3625763429;Ne;0;5;0;5
13949;Viltenė;Drugeliai;2392304909;Ne;0;4;0;4
13950;Viltenė;Drugeliai;5781655552;Ne;0;4;0;4
13951;Viltenė;Drugeliai;8679787688;Ne;0;9;0;9
13952;Viltenė;Drugeliai;4616047113;Ne;0;15;0;15
13953;Viltenė;Drugeliai;6810811656;Ne;0;4;0;4
13954;Viltenė;Drugeliai;3905014810;Ne;0;9;0;9
13955;Viltenė;Drugeliai;4121448859;Ne;0;3;0;3
13956;Viltenė;Drugeliai;9157616307;Ne;0;4;0;4
13957;Viltenė;Drugeliai;9476132305;Ne;5;0;0;5
13958;Viltenė;Drugeliai;5522245968;Ne;0;4;0;4
13959;Viltenė;Drugeliai;5552217000;Ne;0;2;0;2
13960;Viltenė;Drugeliai;9756519374;Ne;0;4;0;4
13961;Viltenė;Drugeliai;7928894276;Ne;0;7;0;7
13962;Viltenė;Drugeliai;4195708756;Ne;0;3;0;3
13963;Viltenė;Drugeliai;1081603034;Ne;0;7;0;7
13964;Viltenė;Drugeliai;7500965165;Ne;0;3;0;3
13965;Viltenė;Bitučių;4001205912;Ne;0;6;0;6
13966;Viltenė;Bitučių;5077874991;Ne;5;0;0;5
13967;Viltenė;Bitučių;7266522399;Ne;0;6;0;6
13968;Viltenė;Bitučių;5241075224;Taip;0;4;0;4
13969;Viltenė;Bitučių;1374979411;Ne;6;0;0;6
13970;Viltenė;Bitučių;1765335359;Ne;0;8;0;8
13971;Viltenė;Bitučių;8681961430;Ne;13;1;0;14
13972;Viltenė;Bitučių;9438542101;Ne;10;5;0;15
13973;Viltenė;Bitučių;8608269197;Ne;7;0;0;7
13974;Viltenė;Bitučių;9805422851;Ne;3;5;0;8
13975;Viltenė;Bitučių;3234013091;Ne;13;0;0;13
13976;Viltenė;Bitučių;1042857771;Ne;7;0;1;8
13977;Viltenė;Bitučių;2460019568;Ne;7;0;0;7
13978;Viltenė;Boružėlių;6642790962;Ne;7;1;0;8
13979;Viltenė;Boružėlių;9572407405;Ne;0;4;0;4
13980;Viltenė;Boružėlių;3738838707;Ne;0;4;0;4
13981;Viltenė;Boružėlių;8473588098;Ne;0;4;0;4
13982;Viltenė;Boružėlių;3995418079;Ne;6;4;0;10
13983;Viltenė;Boružėlių;1399653129;Ne;6;4;0;10
13984;Viltenė;Boružėlių;7526555727;Ne;0;9;0;9
13985;Viltenė;Boružėlių;5379804362;Ne;5;4;0;9
13986;Viltenė;Boružėlių;1936628249;Ne;0;4;0;4
13987;Viltenė;Boružėlių;7912396297;Ne;0;5;0;5
13988;Viltenė;Boružėlių;4036109404;Ne;0;5;0;5
13989;Viltenė;Boružėlių;4604298036;Ne;5;7;0;12
13990;Viltenė;Boružėlių;9197007374;Ne;0;4;0;4
13991;Viltenė;Boružėlių;9242034622;Ne;0;4;0;4
13992;Viltenė;Boružėlių;6621273812;Ne;1;2;0;3
13993;Viltenė;Boružėlių;7010024061;Ne;0;3;0;3
13994;Viltenė;Boružėlių;8527270437;Ne;0;4;0;4
13995;Viltenė;Boružėlių;3052677157;Ne;0;6;0;6
13996;Viltenė;Boružėlių;6293879765;Ne;0;1;0;1
13997;Viltenė;Boružėlių;5077189153;Ne;0;4;0;4
13998;Viltenė;Gandriukų;6481491422;Ne;0;4;0;4
13999;Viltenė;Gandriukų;2452782594;Ne;0;4;0;4
14000;Viltenė;Gandriukų;1126409020;Ne;0;5;0;5
14001;Viltenė;Gandriukų;2884698447;Ne;0;5;0;5
14002;Viltenė;Gandriukų;6060648988;Ne;0;5;0;5
14003;Viltenė;Gandriukų;1840626621;Ne;0;6;0;6
14004;Viltenė;Gandriukų;8549631247;Ne;0;4;0;4
14005;Viltenė;Gandriukų;7796422726;Ne;0;4;0;4
14006;Viltenė;Gandriukų;2815105107;Ne;0;2;0;2
14007;Viltenė;Gandriukų;6511850468;Ne;0;4;0;4
14008;Viltenė;Gandriukų;4945108189;Ne;0;6;0;6
14009;Viltenė;Gandriukų;5850652322;Ne;13;4;0;17
14010;Viltenė;Gandriukų;8110413064;Ne;0;5;0;5
14011;Viltenė;Gandriukų;1243595112;Ne;0;6;0;6
14012;Viltenė;Gandriukų;3073228245;Ne;5;4;4;13
14013;Viltenė;Gandriukų;4468743044;Ne;0;4;0;4
14014;Viltenė;Gandriukų;6355857716;Ne;0;4;0;4
14015;Viltenė;Gandriukų;5929135840;Ne;0;4;0;4
14016;Viltenė;Gandriukų;6473925760;Ne;10;2;0;12
14017;Viltenė;Gandriukų;8458769051;Ne;0;5;0;5
14018;Viltenė;Aitvariukai;5083515613;Ne;5;4;0;9
14019;Viltenė;Aitvariukai;2137929911;Ne;0;4;0;4
14020;Viltenė;Aitvariukai;9185054066;Ne;0;10;0;10
14021;Viltenė;Aitvariukai;2036902795;Ne;0;5;0;5
14022;Viltenė;Aitvariukai;5599943846;Ne;0;4;0;4
14023;Viltenė;Aitvariukai;6721689684;Ne;0;1;0;1
14024;Viltenė;Aitvariukai;6296509460;Ne;5;4;0;9
14025;Viltenė;Aitvariukai;9101795131;Ne;0;5;0;5
14026;Viltenė;Aitvariukai;3908574248;Ne;3;4;0;7
14027;Viltenė;Aitvariukai;8439859449;Ne;0;4;0;4
14028;Viltenė;Aitvariukai;2976705872;Ne;3;5;0;8
14029;Viltenė;Aitvariukai;2192086488;Ne;0;4;0;4
14030;Viltenė;Aitvariukai;2026654467;Ne;0;6;0;6
14031;Viltenė;Aitvariukai;4641365031;Ne;0;8;0;8
14032;Viltenė;Aitvariukai;7277455268;Ne;0;8;0;8
14033;Viltenė;Aitvariukai;3245284852;Ne;0;4;0;4
14034;Viltenė;Aitvariukai;2786572522;Ne;0;3;0;3
14035;Viltenė;Aitvariukai;6171399579;Ne;0;7;0;7
14036;Viltenė;Aitvariukai;3839680327;Taip;0;2;0;2
14037;Viltenė;Aitvariukai;1267187553;Ne;0;2;0;2
14038;Viltenė;Geniukų;3157417614;Ne;2;5;0;7
14039;Viltenė;Geniukų;2903596382;Ne;0;2;0;2
14040;Viltenė;Geniukų;1318750938;Ne;0;1;0;1
14041;Viltenė;Geniukų;6379567497;Ne;0;4;0;4
14042;Viltenė;Geniukų;7145240197;Ne;7;0;0;7
14043;Viltenė;Geniukų;7058586628;Ne;0;5;0;5
14044;Viltenė;Geniukų;7005219570;Ne;0;4;0;4
14045;Viltenė;Geniukų;4552355700;Ne;0;2;0;2
14046;Viltenė;Geniukų;8278572246;Ne;5;3;0;8
14047;Viltenė;Geniukų;1587868835;Ne;0;3;0;3
14048;Viltenė;Geniukų;2850146424;Ne;3;2;0;5
14049;Viltenė;Geniukų;4537287677;Ne;0;2;0;2
14050;Viltenė;Geniukų;3306285115;Ne;0;3;0;3
14051;Viltenė;Geniukų;9288406881;Ne;4;1;0;5
14052;Viltenė;Geniukų;6992120038;Ne;7;4;0;11
14053;Viltenė;Geniukų;4981225829;Ne;0;15;0;15
14054;Viltenė;Geniukų;3853518656;Ne;0;2;0;2
14055;Viltenė;Geniukų;5707049797;Ne;0;1;0;1
14056;Viltenė;Geniukų;9582577013;Taip;0;19;0;19
14057;Viltenė;Geniukų;3343045604;Ne;3;1;0;4
14058;Viltenė;Saulutės;8091905944;Ne;9;0;0;9
14059;Viltenė;Saulutės;5974408492;Ne;0;3;0;3
14060;Viltenė;Saulutės;1641406030;Taip;7;1;0;8
14061;Viltenė;Saulutės;4615393852;Ne;5;4;0;9
14062;Viltenė;Saulutės;9760364123;Ne;0;2;0;2
14063;Viltenė;Saulutės;9578037239;Ne;0;2;1;3
14064;Viltenė;Saulutės;1760899500;Ne;0;8;0;8
14065;Viltenė;Saulutės;3347380524;Ne;0;5;0;5
14066;Viltenė;Saulutės;2656363650;Ne;2;1;0;3
14067;Viltenė;Saulutės;4724382069;Ne;7;1;0;8
14068;Viltenė;Saulutės;2841144656;Ne;0;1;0;1
14069;Viltenė;Saulutės;4379784712;Ne;0;7;0;7
14070;Viltenė;Saulutės;7810374329;Ne;0;8;0;8
14071;Viltenė;Saulutės;9095458948;Ne;4;0;0;4
14072;Viltenė;Saulutės;4661430937;Ne;5;1;0;6
14073;Viltenė;Saulutės;8346933997;Ne;0;1;1;2
14074;Viltenė;Saulutės;8258247750;Ne;6;3;0;9
14075;Viltenė;Saulutės;6595715908;Ne;2;1;0;3
14076;Viltenė;Lapiukų;2034259692;Ne;0;9;0;9
14077;Viltenė;Lapiukų;3473533533;Ne;0;7;0;7
14078;Viltenė;Lapiukų;8696698257;Ne;0;4;0;4
14079;Viltenė;Lapiukų;8248514570;Ne;0;1;0;1
14080;Viltenė;Lapiukų;2878124826;Taip;2;5;0;7
14081;Viltenė;Lapiukų;2660622296;Ne;0;2;0;2
14082;Viltenė;Lapiukų;8122878153;Ne;5;4;0;9
14083;Viltenė;Lapiukų;9573891616;Ne;0;6;0;6
14084;Viltenė;Lapiukų;4243501722;Ne;0;4;0;4
14085;Viltenė;Lapiukų;5818645490;Ne;0;4;0;4
14086;Viltenė;Lapiukų;6429905246;Ne;3;4;0;7
14087;Viltenė;Lapiukų;6070264006;Ne;0;4;0;4
14088;Viltenė;Lapiukų;8187712849;Ne;0;3;0;3
14089;Viltenė;Lapiukų;3679704404;Ne;0;5;0;5
14090;Viltenė;Lapiukų;1507287948;Taip;0;5;0;5
14091;Viltenė;Lapiukų;9846205631;Ne;0;4;0;4
14092;Viltenė;Lapiukų;9063994291;Ne;2;1;0;3
14093;Viltenė;Lapiukų;1964849653;Ne;8;3;0;11
14094;Viltenė;Voveriukai;6888346135;Ne;5;5;0;10
14095;Viltenė;Voveriukai;2936670828;Ne;9;2;0;11
14096;Viltenė;Voveriukai;5816623708;Ne;0;16;0;16
14097;Viltenė;Voveriukai;5611839058;Ne;0;4;0;4
14098;Viltenė;Voveriukai;4414192600;Ne;5;5;0;10
14099;Viltenė;Voveriukai;2483760198;Ne;0;4;0;4
14100;Viltenė;Voveriukai;8341211836;Ne;10;4;0;14
14101;Viltenė;Voveriukai;6954065006;Ne;7;4;0;11
14102;Viltenė;Voveriukai;6741521720;Ne;0;10;0;10
14103;Viltenė;Voveriukai;2642080849;Ne;6;5;1;12
14104;Viltenė;Voveriukai;6040634853;Ne;0;6;0;6
14105;Viltenė;Voveriukai;7322841332;Ne;6;5;0;11
14106;Viltenė;Voveriukai;1888167096;Ne;0;5;0;5
14107;Viltenė;Voveriukai;3291926243;Ne;0;13;0;13
14108;Viltenė;Voveriukai;2013415571;Ne;0;4;0;4
14109;Viltenė;Voveriukai;2894570917;Taip;0;3;0;3
14110;Viltenė;Voveriukai;1890096287;Ne;3;2;0;5
14111;Viltenė;Kiškučiai;7314937470;Ne;5;1;0;6
14112;Viltenė;Kiškučiai;8150583354;Ne;12;1;0;13
14113;Viltenė;Kiškučiai;9862698928;Ne;19;0;0;19
14114;Viltenė;Kiškučiai;3996210451;Ne;0;5;0;5
14115;Viltenė;Kiškučiai;7273826810;Ne;15;0;0;15
14116;Viltenė;Kiškučiai;1512772072;Ne;3;1;0;4
14117;Viltenė;Kiškučiai;4970273010;Ne;7;1;2;10
14118;Viltenė;Kiškučiai;6971198297;Ne;5;2;0;7
14119;Viltenė;Kiškučiai;3719039209;Ne;0;4;0;4
14120;Viltenė;Kiškučiai;5633115904;Ne;5;0;0;5
14121;Viltenė;Kiškučiai;2413392645;Ne;2;3;0;5
14122;Viltenė;Kiškučiai;7948249597;Ne;0;4;0;4
14123;Viltenė;Kiškučiai;3501209955;Ne;0;8;0;8
14124;Viltenė;Kiškučiai;1828982237;Ne;5;3;2;10
14125;Viltenė;Kiškučiai;5575163907;Ne;8;0;0;8
14126;Viltenė;Nykštukų;9263941853;Ne;16;0;0;16
14127;Viltenė;Nykštukų;9308502487;Ne;6;2;4;12
14128;Viltenė;Nykštukų;3331402933;Ne;13;0;1;14
14129;Viltenė;Nykštukų;6715408809;Ne;11;2;0;13
14130;Viltenė;Nykštukų;7957033437;Ne;0;8;0;8
14131;Viltenė;Nykštukų;8423445808;Ne;5;1;0;6
14132;Viltenė;Nykštukų;4692894136;Ne;0;4;2;6
14133;Viltenė;Nykštukų;2675172000;Ne;8;1;2;11
14134;Viltenė;Nykštukų;7950534618;Ne;8;5;0;13
14135;Viltenė;Nykštukų;7281994705;Ne;0;2;1;3
14136;Viltenė;Nykštukų;9962055404;Ne;0;1;0;1
14137;Viltenė;Nykštukų;6805422614;Ne;0;1;2;3
14138;Viltenė;Nykštukų;2549050819;Ne;0;1;7;8
14139;Viltenė;Triušiukai;1788524515;Ne;2;5;0;7
14140;Viltenė;Triušiukai;5741994085;Ne;13;1;0;14
14141;Viltenė;Triušiukai;2720563160;Ne;0;4;0;4
14142;Viltenė;Triušiukai;7331321780;Ne;0;3;0;3
14143;Viltenė;Triušiukai;9211978362;Ne;0;2;0;2
14144;Viltenė;Triušiukai;3007260551;Ne;0;2;0;2
14145;Viltenė;Triušiukai;1324341385;Taip;0;1;0;1
14146;Viltenė;Triušiukai;5083086443;Ne;5;3;0;8
14147;Viltenė;Triušiukai;9643964097;Ne;0;5;0;5
14148;Viltenė;Triušiukai;9163535422;Ne;5;1;0;6
14149;Viltenė;Triušiukai;1280744308;Ne;9;10;0;19
14150;Viltenė;Triušiukai;8517635316;Ne;0;2;0;2
14151;Viltenė;Triušiukai;2077492267;Ne;4;0;0;4
14152;Voveraitė;ŽVIRBLIUKŲ;6684234832;Ne;0;4;5;9
14153;Voveraitė;ŽVIRBLIUKŲ;8119493388;Ne;0;4;0;4
14154;Voveraitė;ŽVIRBLIUKŲ;9715405072;Ne;0;4;0;4
14155;Voveraitė;ŽVIRBLIUKŲ;5804351872;Ne;0;4;4;8
14156;Voveraitė;ŽVIRBLIUKŲ;8925151080;Ne;0;4;0;4
14157;Voveraitė;ŽVIRBLIUKŲ;5510544648;Ne;0;3;2;5
14158;Voveraitė;ŽVIRBLIUKŲ;6959751328;Ne;0;4;7;11
14159;Voveraitė;ŽVIRBLIUKŲ;8803052781;Ne;0;2;3;5
14160;Voveraitė;ŽVIRBLIUKŲ;8257748589;Ne;0;4;0;4
14161;Voveraitė;ŽVIRBLIUKŲ;1522307865;Ne;0;4;1;5
14162;Voveraitė;ŽVIRBLIUKŲ;3811230983;Ne;0;4;8;12
14163;Voveraitė;ŽVIRBLIUKŲ;2142507659;Ne;5;2;0;7
14164;Voveraitė;ŽVIRBLIUKŲ;5395915359;Ne;4;4;3;11
14165;Voveraitė;ŽVIRBLIUKŲ;3247101840;Ne;0;4;6;10
14166;Voveraitė;ŽVIRBLIUKŲ;6643600680;Ne;0;3;2;5
14167;Voveraitė;ŽVIRBLIUKŲ;4460047281;Ne;0;3;2;5
14168;Voveraitė;ŽVIRBLIUKŲ;3877673172;Ne;9;4;3;16
14169;Voveraitė;ŽVIRBLIUKŲ;7008576999;Ne;0;4;1;5
14170;Voveraitė;ŽVIRBLIUKŲ;2716400502;Ne;0;4;3;7
14171;Voveraitė;ŽVIRBLIUKŲ;6994680282;Ne;0;4;0;4
14172;Voveraitė;ŽVIRBLIUKŲ;5605614222;Ne;0;3;2;5
14173;Voveraitė;ŽVIRBLIUKŲ;7248705010;Ne;0;4;7;11
14174;Voveraitė;VOVERIUKŲ;5104290434;Ne;7;3;0;10
14175;Voveraitė;VOVERIUKŲ;3883413387;Taip;8;0;0;8
14176;Voveraitė;VOVERIUKŲ;6762558038;Ne;9;0;0;9
14177;Voveraitė;VOVERIUKŲ;2317744694;Ne;10;0;0;10
14178;Voveraitė;VOVERIUKŲ;5484809515;Ne;0;2;0;2
14179;Voveraitė;VOVERIUKŲ;7047943041;Ne;7;0;0;7
14180;Voveraitė;VOVERIUKŲ;9350363241;Ne;12;0;0;12
14181;Voveraitė;VOVERIUKŲ;1177010991;Ne;3;0;0;3
14182;Voveraitė;VOVERIUKŲ;1003244190;Ne;15;0;0;15
14183;Voveraitė;VOVERIUKŲ;1805322222;Ne;1;0;0;1
14184;Voveraitė;VOVERIUKŲ;6179702518;Ne;15;0;0;15
14185;Voveraitė;VOVERIUKŲ;6177162728;Ne;14;0;0;14
14186;Voveraitė;VOVERIUKŲ;2035456422;Ne;0;1;0;1
14187;Voveraitė;VOVERIUKŲ;8936261148;Ne;5;0;0;5
14188;Voveraitė;KIŠKUČIŲ;9537862791;Ne;0;4;0;4
14189;Voveraitė;KIŠKUČIŲ;4478984171;Ne;4;7;0;11
14190;Voveraitė;KIŠKUČIŲ;3736638759;Ne;5;1;0;6
14191;Voveraitė;KIŠKUČIŲ;9011096222;Ne;0;3;0;3
14192;Voveraitė;KIŠKUČIŲ;3058377539;Ne;0;2;0;2
14193;Voveraitė;KIŠKUČIŲ;8507818993;Ne;0;2;0;2
14194;Voveraitė;KIŠKUČIŲ;8746008166;Ne;0;5;0;5
14195;Voveraitė;KIŠKUČIŲ;8084986328;Ne;0;1;0;1
14196;Voveraitė;KIŠKUČIŲ;6261152304;Ne;8;0;0;8
14197;Voveraitė;KIŠKUČIŲ;8220437514;Ne;0;6;0;6
14198;Voveraitė;KIŠKUČIŲ;4060906360;Ne;0;4;0;4
14199;Voveraitė;KIŠKUČIŲ;5069929376;Ne;0;3;0;3
14200;Voveraitė;KIŠKUČIŲ;7379045686;Ne;6;5;0;11
14201;Voveraitė;KIŠKUČIŲ;1961699588;Ne;6;3;0;9
14202;Voveraitė;KIŠKUČIŲ;1979839656;Ne;0;4;0;4
14203;Voveraitė;KIŠKUČIŲ;8121423914;Ne;3;5;0;8
14204;Voveraitė;KIŠKUČIŲ;4379372200;Ne;5;3;0;8
14205;Voveraitė;KIŠKUČIŲ;1322927329;Ne;4;0;0;4
14206;Voveraitė;KIŠKUČIŲ;8528435385;Ne;0;3;0;3
14207;Voveraitė;KIŠKUČIŲ;8937070276;Ne;4;1;0;5
14208;Voveraitė;KIŠKUČIŲ;3859125174;Ne;3;3;0;6
14209;Voveraitė;KIŠKUČIŲ;4234600509;Ne;8;1;0;9
14210;Voveraitė;KODĖLČIUKŲ;7868415893;Ne;0;1;0;1
14211;Voveraitė;KODĖLČIUKŲ;3274422598;Ne;3;1;0;4
14212;Voveraitė;KODĖLČIUKŲ;8438808999;Ne;0;2;2;4
14213;Voveraitė;KODĖLČIUKŲ;8818603905;Ne;15;0;0;15
14214;Voveraitė;KODĖLČIUKŲ;9397887760;Ne;0;5;0;5
14215;Voveraitė;KODĖLČIUKŲ;4151144278;Ne;0;2;0;2
14216;Voveraitė;KODĖLČIUKŲ;5598685365;Ne;0;4;0;4
14217;Voveraitė;KODĖLČIUKŲ;1482908802;Ne;0;0;3;3
14218;Voveraitė;KODĖLČIUKŲ;3384268786;Ne;0;3;0;3
14219;Voveraitė;KODĖLČIUKŲ;9887747925;Ne;0;4;0;4
14220;Voveraitė;KODĖLČIUKŲ;7605427741;Ne;0;11;0;11
14221;Voveraitė;KODĖLČIUKŲ;3344886524;Ne;0;1;0;1
14222;Voveraitė;KODĖLČIUKŲ;1046297151;Ne;0;5;0;5
14223;Voveraitė;KODĖLČIUKŲ;4996778855;Ne;0;6;0;6
14224;Voveraitė;KODĖLČIUKŲ;3432886020;Ne;0;5;0;5
14225;Voveraitė;KODĖLČIUKŲ;8154347030;Ne;0;8;0;8
14226;Voveraitė;KODĖLČIUKŲ;2482908027;Ne;2;9;0;11
14227;Voveraitė;KODĖLČIUKŲ;8692155848;Ne;3;0;2;5
14228;Voveraitė;KODĖLČIUKŲ;1040007977;Ne;6;1;0;7
14229;Voveraitė;KODĖLČIUKŲ;3881039538;Ne;3;3;0;6
14230;Voveraitė;KODĖLČIUKŲ;7281753415;Ne;3;3;0;6
14231;Voveraitė;KODĖLČIUKŲ;8021563060;Ne;0;5;0;5
14232;Voveraitė;KODĖLČIUKŲ;9816971493;Ne;0;2;1;3
14233;Voveraitė;MEŠKIUKŲ;8881070477;Ne;1;1;0;2
14234;Voveraitė;MEŠKIUKŲ;7253112849;Ne;5;3;0;8
14235;Voveraitė;MEŠKIUKŲ;7499150201;Ne;6;2;0;8
14236;Voveraitė;MEŠKIUKŲ;3217609712;Ne;0;9;0;9
14237;Voveraitė;MEŠKIUKŲ;3088866739;Ne;3;4;0;7
14238;Voveraitė;MEŠKIUKŲ;4207949414;Ne;0;8;0;8
14239;Voveraitė;MEŠKIUKŲ;7474214701;Ne;0;6;0;6
14240;Voveraitė;MEŠKIUKŲ;9729735431;Ne;9;2;0;11
14241;Voveraitė;MEŠKIUKŲ;6853358062;Ne;10;0;0;10
14242;Voveraitė;MEŠKIUKŲ;3539069705;Ne;9;2;0;11
14243;Voveraitė;MEŠKIUKŲ;6609235703;Ne;8;4;0;12
14244;Voveraitė;MEŠKIUKŲ;1528968162;Ne;8;0;0;8
14245;Voveraitė;MEŠKIUKŲ;3159659638;Ne;10;0;0;10
14246;Voveraitė;MEŠKIUKŲ;3532178114;Ne;10;0;0;10
14247;Voveraitė;MEŠKIUKŲ;5196036817;Ne;0;3;0;3
14248;Voveraitė;MEŠKIUKŲ;8534405352;Ne;8;0;0;8
14249;Voveraitė;MEŠKIUKŲ;5018335921;Ne;4;7;0;11
14250;Voveraitė;MEŠKIUKŲ;6579193196;Taip;12;4;0;16
14251;Voveraitė;MEŠKIUKŲ;8940421826;Ne;6;0;0;6
14252;Voveraitė;MEŠKIUKŲ;9332936763;Ne;0;6;0;6
14253;Voveraitė;MEŠKIUKŲ;6206817227;Ne;0;5;0;5
14254;Voveraitė;MEŠKIUKŲ;5721857611;Ne;3;3;0;6
14255;Voveraitė;BORUŽĖLIŲ;7969862374;Ne;2;3;0;5
14256;Voveraitė;BORUŽĖLIŲ;4233627593;Ne;3;0;1;4
14257;Voveraitė;BORUŽĖLIŲ;2446269570;Ne;7;2;0;9
14258;Voveraitė;BORUŽĖLIŲ;1542869765;Ne;10;0;0;10
14259;Voveraitė;BORUŽĖLIŲ;3408126903;Ne;1;3;0;4
14260;Voveraitė;BORUŽĖLIŲ;8675606844;Ne;2;4;0;6
14261;Voveraitė;BORUŽĖLIŲ;8627692360;Ne;6;0;0;6
14262;Voveraitė;BORUŽĖLIŲ;3168493145;Ne;7;0;2;9
14263;Voveraitė;BORUŽĖLIŲ;7776716092;Ne;0;1;0;1
14264;Voveraitė;BORUŽĖLIŲ;8693704363;Ne;18;0;0;18
14265;Voveraitė;BORUŽĖLIŲ;7718303218;Ne;8;0;0;8
14266;Voveraitė;BORUŽĖLIŲ;9218074631;Taip;11;0;1;12
14267;Voveraitė;BORUŽĖLIŲ;6443288864;Ne;0;6;0;6
14268;Voveraitė;BORUŽĖLIŲ;2552772063;Taip;3;1;0;4
14269;Voveraitė;BORUŽĖLIŲ;1921260351;Ne;3;2;0;5
14270;Voveraitė;BORUŽĖLIŲ;8695525951;Ne;6;0;0;6
14271;Voveraitė;BORUŽĖLIŲ;6650343917;Ne;5;4;0;9
14272;Voveraitė;BORUŽĖLIŲ;9120975451;Ne;2;0;0;2
14273;Voveraitė;BORUŽĖLIŲ;3452040361;Ne;3;6;0;9
14274;Voveraitė;BORUŽĖLIŲ;8451803815;Ne;0;4;0;4
14275;Voveraitė;BORUŽĖLIŲ;8382950248;Ne;0;2;0;2
14276;Voveraitė;BORUŽĖLIŲ;1293494284;Ne;2;4;0;6
14277;Voveraitė;PELĖDŽIUKŲ;7984755636;Ne;3;0;0;3
14278;Voveraitė;PELĖDŽIUKŲ;8705616608;Ne;9;0;0;9
14279;Voveraitė;PELĖDŽIUKŲ;2028714618;Ne;14;0;0;14
14280;Voveraitė;PELĖDŽIUKŲ;5415791380;Ne;2;0;0;2
14281;Voveraitė;PELĖDŽIUKŲ;2915226148;Ne;0;5;0;5
14282;Voveraitė;PELĖDŽIUKŲ;1971097565;Ne;3;0;0;3
14283;Voveraitė;PELĖDŽIUKŲ;2724402352;Ne;12;4;0;16
14284;Voveraitė;PELĖDŽIUKŲ;1063298119;Ne;8;0;0;8
14285;Voveraitė;PELĖDŽIUKŲ;1877131292;Ne;6;0;0;6
14286;Voveraitė;PELĖDŽIUKŲ;9074318124;Ne;13;0;6;19
14287;Voveraitė;PELĖDŽIUKŲ;6666893294;Ne;18;0;0;18
14288;Voveraitė;PELĖDŽIUKŲ;5918809105;Ne;7;0;0;7
14289;Voveraitė;PELĖDŽIUKŲ;9130691819;Ne;7;2;0;9
14290;Voveraitė;PELĖDŽIUKŲ;3729924233;Ne;4;1;0;5
14291;Voveraitė;PELĖDŽIUKŲ;8126894347;Ne;8;0;0;8
14292;Voveraitė;PELĖDŽIUKŲ;3279671808;Ne;3;0;0;3
14293;Voveraitė;PELĖDŽIUKŲ;2761041681;Ne;12;0;0;12
14294;Voveraitė;DRUGELIŲ;1441921029;Ne;0;3;0;3
14295;Voveraitė;DRUGELIŲ;7531020548;Ne;0;10;0;10
14296;Voveraitė;DRUGELIŲ;4300235743;Ne;5;2;0;7
14297;Voveraitė;DRUGELIŲ;1510853268;Ne;3;4;0;7
14298;Voveraitė;DRUGELIŲ;3388547792;Ne;0;8;0;8
14299;Voveraitė;DRUGELIŲ;8719547570;Ne;2;2;1;5
14300;Voveraitė;DRUGELIŲ;3475601049;Ne;0;5;0;5
14301;Voveraitė;DRUGELIŲ;4017408873;Ne;9;0;1;10
14302;Voveraitė;DRUGELIŲ;7533728486;Ne;6;4;0;10
14303;Voveraitė;DRUGELIŲ;1550830434;Ne;0;4;0;4
14304;Voveraitė;DRUGELIŲ;5114768009;Ne;0;6;0;6
14305;Voveraitė;DRUGELIŲ;1045204378;Ne;4;0;0;4
14306;Voveraitė;DRUGELIŲ;4605007814;Ne;0;3;0;3
14307;Voveraitė;DRUGELIŲ;4911291891;Ne;5;6;1;12
14308;Voveraitė;DRUGELIŲ;4782336282;Ne;0;3;0;3
14309;Voveraitė;DRUGELIŲ;6415024059;Taip;4;2;1;7
14310;Voveraitė;DRUGELIŲ;4350450125;Ne;0;8;0;8
14311;Voveraitė;DRUGELIŲ;8913940646;Ne;10;5;0;15
14312;Voveraitė;DRUGELIŲ;1201270622;Ne;3;2;2;7
14313;Voveraitė;DRUGELIŲ;7238482039;Taip;10;0;0;10
14314;Voveraitė;DRUGELIŲ;4961315260;Ne;0;6;2;8
14315;Voveraitė;DRUGELIŲ;8939638368;Ne;0;6;2;8
14316;Voveraitė;NYKŠTUKŲ;8206634977;Ne;1;3;0;4
14317;Voveraitė;NYKŠTUKŲ;3068683904;Ne;7;0;2;9
14318;Voveraitė;NYKŠTUKŲ;3600230896;Ne;7;0;1;8
14319;Voveraitė;NYKŠTUKŲ;1294012085;Ne;0;2;0;2
14320;Voveraitė;NYKŠTUKŲ;9363490578;Ne;0;7;0;7
14321;Voveraitė;NYKŠTUKŲ;8217771158;Ne;3;7;0;10
14322;Voveraitė;NYKŠTUKŲ;3409709168;Ne;0;6;0;6
14323;Voveraitė;NYKŠTUKŲ;1045121363;Ne;0;7;0;7
14324;Voveraitė;NYKŠTUKŲ;4319786615;Ne;4;6;0;10
14325;Voveraitė;NYKŠTUKŲ;1384430452;Ne;2;0;8;10
14326;Voveraitė;NYKŠTUKŲ;6648733729;Ne;4;4;0;8
14327;Voveraitė;NYKŠTUKŲ;2801245150;Ne;2;0;0;2
14328;Voveraitė;NYKŠTUKŲ;2839442228;Ne;1;0;6;7
14329;Voveraitė;NYKŠTUKŲ;5887384991;Ne;5;0;4;9
14330;Voveraitė;NYKŠTUKŲ;1647496426;Ne;0;2;1;3
14331;Voveraitė;NYKŠTUKŲ;3627796093;Ne;10;5;0;15
14332;Voveraitė;NYKŠTUKŲ;4329107736;Ne;9;0;4;13
14333;Voveraitė;GENIUKŲ;8697761112;Ne;7;2;0;9
14334;Voveraitė;GENIUKŲ;6007396459;Ne;3;4;1;8
14335;Voveraitė;GENIUKŲ;9514425475;Ne;0;5;0;5
14336;Voveraitė;GENIUKŲ;1663784931;Ne;3;4;0;7
14337;Voveraitė;GENIUKŲ;8373093305;Ne;2;4;0;6
14338;Voveraitė;GENIUKŲ;4054841724;Ne;0;4;0;4
14339;Voveraitė;GENIUKŲ;4563198733;Ne;0;5;0;5
14340;Voveraitė;GENIUKŲ;1141304286;Ne;0;5;0;5
14341;Voveraitė;GENIUKŲ;3276295199;Ne;2;2;0;4
14342;Voveraitė;GENIUKŲ;6891841301;Ne;0;3;0;3
14343;Voveraitė;GENIUKŲ;6017698476;Ne;0;3;0;3
14344;Voveraitė;GENIUKŲ;8344323109;Ne;0;3;0;3
14345;Voveraitė;GENIUKŲ;2594535017;Ne;0;5;0;5
14346;Voveraitė;GENIUKŲ;5956830012;Ne;0;5;0;5
14347;Voveraitė;GENIUKŲ;1960385335;Ne;8;4;0;12
14348;Voveraitė;GENIUKŲ;9912862474;Ne;0;3;0;3
14349;Voveraitė;GENIUKŲ;1340379090;Ne;0;18;0;18
14350;Voveraitė;GENIUKŲ;5935777154;Ne;0;1;0;1
14351;Voveraitė;GENIUKŲ;5138855000;Ne;2;4;0;6
14352;Voveraitė;GENIUKŲ;6113913885;Ne;0;5;0;5
14353;Voveraitė;GENIUKŲ;7744504020;Ne;5;0;0;5
14354;Voveraitė;GENIUKŲ;9195700962;Ne;0;17;0;17
14355;Voveraitė;GENIUKŲ;1515087924;Ne;0;3;0;3
14356;Voveraitė;LAPIUKŲ;8405238812;Ne;0;4;0;4
14357;Voveraitė;LAPIUKŲ;8152541593;Ne;5;0;2;7
14358;Voveraitė;LAPIUKŲ;9327593792;Ne;10;2;2;14
14359;Voveraitė;LAPIUKŲ;4139239328;Ne;10;2;2;14
14360;Voveraitė;LAPIUKŲ;6672252537;Ne;16;0;0;16
14361;Voveraitė;LAPIUKŲ;4689191326;Ne;8;0;1;9
14362;Voveraitė;LAPIUKŲ;7131189895;Ne;4;2;0;6
14363;Voveraitė;LAPIUKŲ;6766131083;Ne;0;9;10;19
14364;Voveraitė;LAPIUKŲ;4760054428;Ne;7;0;2;9
14365;Voveraitė;LAPIUKŲ;4848321265;Ne;0;0;17;17
14366;Voveraitė;LAPIUKŲ;3419973673;Ne;11;0;4;15
14367;Voveraitė;LAPIUKŲ;4402971359;Ne;0;8;0;8
14368;Voveraitė;LAPIUKŲ;1328831240;Ne;8;0;9;17
14369;Voveraitė;LAPIUKŲ;3955549715;Ne;3;0;2;5
14370;Voveraitė;LAPIUKŲ;9219176927;Ne;0;2;0;2
14371;Voveraitė;LAPIUKŲ;8382465808;Ne;11;0;2;13
14372;Voveraitė;EŽIUKŲ;5420123208;Ne;11;3;0;14
14373;Voveraitė;EŽIUKŲ;1692829228;Ne;7;0;5;12
14374;Voveraitė;EŽIUKŲ;8074808131;Ne;5;0;0;5
14375;Voveraitė;EŽIUKŲ;8229145014;Ne;0;0;7;7
14376;Voveraitė;EŽIUKŲ;2755043670;Ne;5;4;0;9
14377;Voveraitė;EŽIUKŲ;6481289149;Ne;0;1;1;2
14378;Voveraitė;EŽIUKŲ;6917511246;Ne;11;0;0;11
14379;Voveraitė;EŽIUKŲ;7227349394;Ne;9;0;4;13
14380;Voveraitė;EŽIUKŲ;9624353633;Ne;0;0;3;3
14381;Voveraitė;EŽIUKŲ;8663564002;Ne;5;5;0;10
14382;Voveraitė;EŽIUKŲ;3598956934;Ne;0;16;0;16
14383;Voveraitė;EŽIUKŲ;8465757758;Ne;5;0;1;6
14384;Voveraitė;EŽIUKŲ;2064720751;Ne;8;2;0;10
14385;Voveraitė;EŽIUKŲ;4913232575;Ne;0;5;0;5
14386;Voveraitė;EŽIUKŲ;9859868228;Ne;5;6;0;11
14387;"Trakų Vokė";Voveriukų;1252962923;Ne;10;1;0;11
14388;"Trakų Vokė";Voveriukų;2163756512;Ne;0;2;0;2
14389;"Trakų Vokė";Voveriukų;2318712376;Ne;2;0;0;2
14390;"Trakų Vokė";Voveriukų;9140597911;Ne;4;0;0;4
14391;"Trakų Vokė";Voveriukų;5741852704;Ne;14;0;0;14
14392;"Trakų Vokė";Voveriukų;8636196544;Ne;0;3;1;4
14393;"Trakų Vokė";Voveriukų;4516714702;Ne;3;3;0;6
14394;"Trakų Vokė";Voveriukų;3445611475;Ne;5;0;0;5
14395;"Trakų Vokė";Voveriukų;3422308444;Ne;0;4;3;7
14396;"Trakų Vokė";Voveriukų;6076083379;Ne;0;1;0;1
14397;"Trakų Vokė";Voveriukų;5626732539;Ne;0;8;0;8
14398;"Trakų Vokė";Voveriukų;7706665420;Ne;0;1;2;3
14399;"Trakų Vokė";Voveriukų;7656305410;Ne;8;0;0;8
14400;"Trakų Vokė";Voveriukų;7346128036;Ne;5;1;0;6
14401;"Trakų Vokė";Voveriukų;2812442474;Ne;0;1;0;1
14402;"Trakų Vokė";Voveriukų;7671121106;Ne;0;4;4;8
14403;"Trakų Vokė";Voveriukų;7797516793;Ne;0;4;2;6
14404;"Trakų Vokė";Voveriukų;2077669020;Ne;13;0;0;13
14405;"Trakų Vokė";Voveriukų;8938061997;Ne;12;0;0;12
14406;"Trakų Vokė";Voveriukų;1946140073;Ne;7;0;2;9
14407;"Trakų Vokė";Voveriukų;6494156059;Ne;0;9;0;9
14408;"Trakų Vokė";Voveriukų;6247495021;Ne;2;4;0;6
14409;"Trakų Vokė";Voveriukų;3471649998;Ne;19;0;0;19
14410;"Trakų Vokė";Boružėlių;6550998156;Ne;13;0;0;13
14411;"Trakų Vokė";Boružėlių;7705116536;Ne;3;0;0;3
14412;"Trakų Vokė";Boružėlių;4300812649;Ne;9;0;0;9
14413;"Trakų Vokė";Boružėlių;6495211591;Ne;10;4;0;14
14414;"Trakų Vokė";Boružėlių;2141759752;Ne;12;0;0;12
14415;"Trakų Vokė";Boružėlių;4621824988;Ne;10;0;0;10
14416;"Trakų Vokė";Boružėlių;7122970239;Ne;9;0;1;10
14417;"Trakų Vokė";Boružėlių;2287132096;Ne;2;0;2;4
14418;"Trakų Vokė";Boružėlių;1798327247;Ne;6;0;2;8
14419;"Trakų Vokė";Boružėlių;6004005405;Ne;8;0;2;10
14420;"Trakų Vokė";Boružėlių;3930137078;Ne;12;0;0;12
14421;"Trakų Vokė";Boružėlių;1515075178;Ne;0;0;2;2
14422;"Trakų Vokė";Boružėlių;4377392002;Ne;4;0;0;4
14423;"Trakų Vokė";Boružėlių;3733223248;Ne;0;0;3;3
14424;"Trakų Vokė";Boružėlių;7778039165;Ne;6;0;1;7
14425;"Trakų Vokė";Boružėlių;9334999599;Ne;0;0;1;1
14426;"Trakų Vokė";Boružėlių;7933901042;Ne;0;0;2;2
14427;"Trakų Vokė";Boružėlių;7042434004;Ne;0;0;3;3
14428;"Trakų Vokė";KIŠKUČIŲ;2348524235;Ne;12;0;0;12
14429;"Trakų Vokė";KIŠKUČIŲ;6916284436;Ne;12;0;0;12
14430;"Trakų Vokė";KIŠKUČIŲ;2027461389;Ne;8;0;0;8
14431;"Trakų Vokė";KIŠKUČIŲ;8148859043;Ne;18;0;0;18
14432;"Trakų Vokė";KIŠKUČIŲ;9375730686;Ne;16;0;0;16
14433;"Trakų Vokė";KIŠKUČIŲ;2327739950;Ne;9;4;0;13
14434;"Trakų Vokė";KIŠKUČIŲ;1436135794;Ne;11;0;0;11
14435;"Trakų Vokė";KIŠKUČIŲ;3233117814;Ne;2;3;0;5
14436;"Trakų Vokė";KIŠKUČIŲ;6450573461;Ne;4;0;0;4
14437;"Trakų Vokė";KIŠKUČIŲ;3146611814;Ne;6;4;0;10
14438;"Trakų Vokė";KIŠKUČIŲ;8601290001;Ne;19;0;0;19
14439;"Trakų Vokė";KIŠKUČIŲ;1941250346;Ne;6;2;0;8
14440;"Trakų Vokė";KIŠKUČIŲ;4832898751;Ne;4;3;0;7
14441;"Trakų Vokė";KIŠKUČIŲ;8861279937;Ne;8;0;0;8
14442;"Trakų Vokė";KIŠKUČIŲ;8747275362;Ne;0;2;0;2
14443;"Trakų Vokė";KIŠKUČIŲ;7799307934;Ne;13;0;0;13
14444;"Trakų Vokė";BITUČIŲ;7632198751;Ne;3;0;0;3
14445;"Trakų Vokė";BITUČIŲ;3686108421;Ne;6;0;0;6
14446;"Trakų Vokė";BITUČIŲ;5031669549;Ne;12;0;0;12
14447;"Trakų Vokė";BITUČIŲ;8703806519;Ne;15;0;0;15
14448;"Trakų Vokė";BITUČIŲ;4531294784;Ne;6;0;0;6
14449;"Trakų Vokė";BITUČIŲ;5720994041;Ne;5;0;0;5
14450;"Trakų Vokė";BITUČIŲ;7459132887;Ne;6;0;0;6
14451;"Trakų Vokė";BITUČIŲ;6402002961;Ne;10;0;0;10
14452;"Trakų Vokė";BITUČIŲ;3536227018;Ne;5;0;0;5
14453;"Trakų Vokė";BITUČIŲ;6787506848;Ne;0;4;0;4
14454;"Trakų Vokė";BITUČIŲ;3372734352;Ne;1;0;0;1
14455;"Trakų Vokė";BITUČIŲ;1359519176;Ne;4;0;0;4
14456;"Trakų Vokė";BITUČIŲ;1039317931;Ne;19;0;0;19
14457;"Trakų Vokė";BITUČIŲ;3333979364;Ne;0;1;0;1
14458;"Trakų Vokė";BITUČIŲ;5810595458;Ne;0;1;0;1
14459;"Trakų Vokė";BITUČIŲ;4212617288;Ne;1;0;0;1
14460;"Trakų Vokė";BITUČIŲ;2133793458;Ne;8;0;0;8
14461;"Trakų Vokė";BITUČIŲ;3023545645;Ne;6;0;0;6
14462;"Trakų Vokė";BITUČIŲ;6428645462;Ne;2;0;0;2
14463;"Trakų Vokė";BITUČIŲ;1000323267;Ne;2;0;0;2
14464;"Trakų Vokė";BITUČIŲ;8783922678;Ne;1;0;0;1
14465;"Trakų Vokė";BITUČIŲ;8496627262;Ne;19;0;0;19
14466;"Trakų Vokė";BITUČIŲ;1389577176;Ne;9;0;0;9
14467;Zylutė;Katerok;8749296671;Ne;0;5;0;5
14468;Zylutė;Katerok;4592825972;Ne;0;4;0;4
14469;Zylutė;Katerok;8747721198;Ne;6;4;0;10
14470;Zylutė;Katerok;8212030518;Ne;0;8;0;8
14471;Zylutė;Katerok;7706833089;Ne;7;7;0;14
14472;Zylutė;Katerok;3115223229;Ne;0;1;0;1
14473;Zylutė;Katerok;2968625045;Ne;0;5;1;6
14474;Zylutė;Katerok;1897871944;Ne;0;5;0;5
14475;Zylutė;Katerok;5687201052;Ne;0;3;0;3
14476;Zylutė;Katerok;3055559237;Ne;0;5;0;5
14477;Zylutė;Katerok;2792217953;Ne;0;3;0;3
14478;Zylutė;Katerok;5948147748;Ne;0;5;1;6
14479;Zylutė;Katerok;7851423851;Ne;5;4;0;9
14480;Zylutė;Katerok;1164530815;Ne;0;5;0;5
14481;Zylutė;Katerok;1423890598;Ne;7;4;0;11
14482;Zylutė;Katerok;2558354198;Ne;0;4;0;4
14483;Zylutė;Katerok;8268700439;Ne;0;7;3;10
14484;Zylutė;Katerok;4494567155;Ne;5;7;0;12
14485;Zylutė;Katerok;8618778936;Ne;0;1;0;1
14486;Zylutė;"Vesole misiaki";9162232979;Ne;0;3;0;3
14487;Zylutė;"Vesole misiaki";9737308076;Ne;0;5;0;5
14488;Zylutė;"Vesole misiaki";5589330186;Ne;9;4;0;13
14489;Zylutė;"Vesole misiaki";3848401615;Ne;5;4;0;9
14490;Zylutė;"Vesole misiaki";2913504349;Ne;0;4;0;4
14491;Zylutė;"Vesole misiaki";2501761963;Ne;5;8;0;13
14492;Zylutė;"Vesole misiaki";3976277394;Ne;0;3;0;3
14493;Zylutė;"Vesole misiaki";2489898107;Ne;0;9;0;9
14494;Zylutė;"Vesole misiaki";2313423907;Ne;6;5;0;11
14495;Zylutė;"Vesole misiaki";8121814945;Ne;0;4;0;4
14496;Zylutė;"Vesole misiaki";9159342804;Ne;3;4;0;7
14497;Zylutė;"Vesole misiaki";2201317313;Ne;0;4;0;4
14498;Zylutė;"Vesole misiaki";9018673580;Ne;8;4;1;13
14499;Zylutė;"Vesole misiaki";5369354390;Taip;9;4;2;15
14500;Zylutė;"Vesole misiaki";8023418946;Ne;0;4;0;4
14501;Zylutė;"Vesole misiaki";9507157625;Ne;0;4;0;4
14502;Zylutė;"Vesole misiaki";8101232865;Ne;0;5;0;5
14503;Zylutė;"Vesole misiaki";2484025931;Ne;0;8;0;8
14504;Zylutė;NYKŠTUKAI;1169490002;Ne;9;3;0;12
14505;Zylutė;NYKŠTUKAI;3994691080;Ne;1;4;0;5
14506;Zylutė;NYKŠTUKAI;4894611078;Ne;6;0;0;6
14507;Zylutė;NYKŠTUKAI;7648922403;Ne;5;0;0;5
14508;Zylutė;NYKŠTUKAI;2113594059;Ne;13;0;0;13
14509;Zylutė;NYKŠTUKAI;9615779237;Ne;0;4;0;4
14510;Zylutė;NYKŠTUKAI;2604844156;Ne;16;1;0;17
14511;Zylutė;NYKŠTUKAI;2511658462;Ne;0;0;4;4
14512;Zylutė;NYKŠTUKAI;3035745273;Ne;9;0;0;9
14513;Zylutė;NYKŠTUKAI;2620903587;Ne;17;0;0;17
14514;Zylutė;NYKŠTUKAI;4706933533;Ne;4;0;1;5
14515;Zylutė;NYKŠTUKAI;4491529018;Ne;7;0;0;7
14516;Zylutė;NYKŠTUKAI;8987407474;Ne;0;1;1;2
14517;Zylutė;NYKŠTUKAI;2745905798;Ne;4;0;0;4
14518;Zylutė;NYKŠTUKAI;5975875502;Ne;8;1;0;9
14519;Zylutė;NYKŠTUKAI;9107676840;Ne;0;0;5;5
14520;Zylutė;NYKŠTUKAI;4840138765;Ne;7;0;1;8
14521;Zylutė;NYKŠTUKAI;4035294615;Ne;0;1;1;2
14522;Zylutė;NYKŠTUKAI;9221414691;Taip;4;0;0;4
14523;Zylutė;NYKŠTUKAI;7433615959;Ne;9;4;1;14
14524;Zylutė;NYKŠTUKAI;2520744071;Ne;0;2;2;4
14525;Zylutė;Ručijok;5096881585;Ne;5;2;6;13
14526;Zylutė;Ručijok;9904758615;Ne;0;0;3;3
14527;Zylutė;Ručijok;4874246039;Ne;8;0;0;8
14528;Zylutė;Ručijok;2769424439;Ne;3;2;0;5
14529;Zylutė;Ručijok;1145229045;Ne;0;0;3;3
14530;Zylutė;Ručijok;3058040516;Ne;0;12;0;12
14531;Zylutė;Ručijok;5038936878;Ne;19;0;0;19
14532;Zylutė;Ručijok;2491905840;Taip;10;0;0;10
14533;Zylutė;Ručijok;5956114459;Ne;0;0;4;4
14534;Zylutė;Ručijok;6276017610;Ne;2;2;1;5
14535;Zylutė;Ručijok;3128535871;Ne;5;3;0;8
14536;Zylutė;Ručijok;6281989117;Ne;7;2;0;9
14537;Zylutė;Ručijok;2505224609;Ne;10;1;1;12
14538;Zylutė;Ručijok;7519900933;Ne;10;0;0;10
14539;Zylutė;Ručijok;3573761619;Ne;13;2;0;15
14540;Zylutė;Ručijok;7742044835;Taip;0;6;0;6
14541;Zylutė;Ručijok;3153857567;Ne;0;0;8;8
14542;Zylutė;Raduga;5573851165;Ne;6;7;0;13
14543;Zylutė;Raduga;2916622808;Ne;19;0;0;19
14544;Zylutė;Raduga;2527003662;Taip;19;0;0;19
14545;Zylutė;Raduga;3977730349;Ne;16;0;0;16
14546;Zylutė;Raduga;7911418657;Ne;16;0;0;16
14547;Zylutė;Raduga;5650984730;Ne;3;4;0;7
14548;Zylutė;Raduga;6422018564;Taip;8;6;0;14
14549;Zylutė;Raduga;5019654510;Ne;15;0;0;15
14550;Zylutė;Raduga;2826889413;Ne;19;0;0;19
14551;Zylutė;Raduga;1935817272;Ne;15;0;0;15
14552;Zylutė;Raduga;9584717697;Ne;1;7;0;8
14553;Zylutė;Raduga;8448343323;Ne;17;0;0;17
14554;Zylutė;Raduga;1108316842;Ne;0;2;0;2
14555;Zylutė;Raduga;4801678066;Ne;14;0;0;14
14556;Zylutė;"Miki Maus";7762245887;Taip;11;4;0;15
14557;Zylutė;"Miki Maus";9213491152;Ne;0;1;0;1
14558;Zylutė;"Miki Maus";3928932787;Ne;0;9;0;9
14559;Zylutė;"Miki Maus";4057419108;Taip;5;0;1;6
14560;Zylutė;"Miki Maus";3668160578;Ne;8;8;0;16
14561;Zylutė;"Miki Maus";9093777086;Ne;0;11;0;11
14562;Zylutė;"Miki Maus";7123399601;Ne;0;9;0;9
14563;Zylutė;"Miki Maus";9951774752;Ne;0;4;2;6
14564;Zylutė;"Miki Maus";7625237309;Ne;4;4;0;8
14565;Zylutė;"Miki Maus";8291414891;Ne;4;4;3;11
14566;Zylutė;"Miki Maus";7880958850;Ne;4;0;1;5
14567;Zylutė;"Miki Maus";8230673446;Ne;0;4;2;6
14568;Zylutė;"Miki Maus";6876326785;Ne;0;4;0;4
14569;Zylutė;"Miki Maus";6389666593;Ne;0;3;0;3
14570;Zylutė;"Miki Maus";4798370162;Ne;7;9;0;16
14571;Zylutė;Solnyško;8379932761;Ne;1;1;0;2
14572;Zylutė;Solnyško;5556769710;Ne;0;2;0;2
14573;Zylutė;Solnyško;2088316489;Ne;0;6;0;6
14574;Zylutė;Solnyško;1076803315;Ne;0;5;0;5
14575;Zylutė;Solnyško;7616444695;Ne;5;1;0;6
14576;Zylutė;Solnyško;5234846079;Ne;0;2;0;2
14577;Zylutė;Solnyško;5939522435;Ne;0;10;0;10
14578;Zylutė;Solnyško;5826813410;Ne;0;10;0;10
14579;Zylutė;Solnyško;8033573972;Ne;5;0;0;5
14580;Zylutė;Solnyško;7447067072;Ne;0;4;0;4
14581;Zylutė;Solnyško;1386683435;Ne;0;2;0;2
14582;Zylutė;Solnyško;4669449744;Ne;0;4;0;4
14583;Zylutė;Solnyško;1969578486;Ne;0;3;0;3
14584;Zylutė;Solnyško;6573541087;Ne;19;0;0;19
14585;Zylutė;Solnyško;3201966434;Ne;0;1;0;1
14586;Zylutė;Solnyško;3656587423;Ne;9;0;0;9
14587;Zylutė;Solnyško;5011947014;Ne;0;6;0;6
14588;Zylutė;Motyliok;7241045507;Ne;17;0;0;17
14589;Zylutė;Motyliok;9913001904;Ne;10;4;0;14
14590;Zylutė;Motyliok;6112586092;Ne;0;8;0;8
14591;Zylutė;Motyliok;8178488164;Ne;11;0;0;11
14592;Zylutė;Motyliok;5045652581;Ne;0;10;0;10
14593;Zylutė;Motyliok;9586800176;Ne;4;0;0;4
14594;Zylutė;Motyliok;4497904128;Ne;5;10;0;15
14595;Zylutė;Motyliok;3355159275;Ne;0;5;0;5
14596;Zylutė;Motyliok;9995791665;Ne;4;0;0;4
14597;Zylutė;Motyliok;1455822427;Ne;14;0;0;14
14598;Zylutė;Motyliok;3455374127;Ne;7;8;0;15
14599;Zylutė;Motyliok;1632490481;Ne;0;5;0;5
14600;Zylutė;Motyliok;1726060015;Ne;7;0;0;7
14601;Zylutė;Motyliok;3084870481;Ne;5;0;0;5
14602;Zylutė;Motyliok;6051657134;Ne;5;5;0;10
14603;Zylutė;Motyliok;3271366684;Ne;4;4;0;8
14604;Zylutė;Motyliok;3633983359;Ne;5;5;0;10
14605;Zylutė;Motyliok;9155513221;Ne;5;1;0;6
14606;Zylutė;Motyliok;8262929231;Ne;0;3;0;3
14607;Zylutė;Motyliok;6601967273;Ne;10;0;0;10
14608;Zylutė;Motyliok;6778361006;Ne;10;0;0;10
14609;Zylutė;ŽVIRBLIUKAI;1319040747;Ne;5;2;4;11
14610;Zylutė;ŽVIRBLIUKAI;8326987895;Ne;0;6;0;6
14611;Zylutė;ŽVIRBLIUKAI;9330583784;Ne;0;1;0;1
14612;Zylutė;ŽVIRBLIUKAI;1220439948;Ne;5;10;0;15
14613;Zylutė;ŽVIRBLIUKAI;4646273830;Ne;5;1;2;8
14614;Zylutė;ŽVIRBLIUKAI;9580188426;Ne;12;0;0;12
14615;Zylutė;ŽVIRBLIUKAI;1797701777;Ne;0;4;0;4
14616;Zylutė;ŽVIRBLIUKAI;2966482773;Ne;0;6;0;6
14617;Zylutė;ŽVIRBLIUKAI;1452384017;Ne;0;0;3;3
14618;Zylutė;ŽVIRBLIUKAI;8152140523;Ne;0;9;3;12
14619;Zylutė;ŽVIRBLIUKAI;2061747513;Taip;0;11;0;11
14620;Zylutė;ŽVIRBLIUKAI;4611555689;Ne;0;7;0;7
14621;Zylutė;ŽVIRBLIUKAI;3894885445;Ne;0;12;0;12
14622;Zylutė;ŽVIRBLIUKAI;7137348151;Taip;0;5;0;5
14623;Zylutė;ŽVIRBLIUKAI;3556698363;Ne;0;5;2;7
14624;Zylutė;ŽVIRBLIUKAI;5942010679;Ne;0;0;6;6
14625;Zylutė;ŽVIRBLIUKAI;5722697679;Ne;10;2;1;13
14626;Zylutė;"DRUŽNYJE REBIATA";5332039406;Ne;5;7;0;12
14627;Zylutė;"DRUŽNYJE REBIATA";9039665233;Ne;0;2;0;2
14628;Zylutė;"DRUŽNYJE REBIATA";6075614020;Ne;0;9;0;9
14629;Zylutė;"DRUŽNYJE REBIATA";9518714240;Ne;1;3;0;4
14630;Zylutė;"DRUŽNYJE REBIATA";2693961315;Taip;12;0;0;12
14631;Zylutė;"DRUŽNYJE REBIATA";3372639449;Ne;0;6;0;6
14632;Zylutė;"DRUŽNYJE REBIATA";4916625058;Ne;0;4;0;4
14633;Zylutė;"DRUŽNYJE REBIATA";3447644735;Ne;0;3;0;3
14634;Zylutė;"DRUŽNYJE REBIATA";3174042441;Ne;0;6;0;6
14635;Zylutė;"DRUŽNYJE REBIATA";6848387941;Ne;3;4;0;7
14636;Zylutė;"DRUŽNYJE REBIATA";1404949829;Ne;0;5;0;5
14637;Zylutė;"DRUŽNYJE REBIATA";4548205666;Ne;1;3;0;4
14638;Zylutė;"DRUŽNYJE REBIATA";6962852787;Ne;0;3;0;3
14639;Zylutė;"DRUŽNYJE REBIATA";9220918504;Ne;0;3;0;3
14640;Zylutė;"DRUŽNYJE REBIATA";9193349264;Ne;0;4;0;4
14641;Zylutė;"DRUŽNYJE REBIATA";2444440430;Ne;0;3;0;3
14642;Zylutė;"DRUŽNYJE REBIATA";8204885376;Ne;3;6;0;9
14643;Zylutė;"DRUŽNYJE REBIATA";8130859512;Ne;0;2;0;2
14644;Zylutė;"DRUŽNYJE REBIATA";9769201088;Ne;0;6;0;6
14645;Zylutė;"DRUŽNYJE REBIATA";5233163416;Ne;2;6;0;8
14646;Zylutė;"DRUŽNYJE REBIATA";5126282685;Ne;0;8;0;8
14647;Zylutė;VIEVERSĖLIAI;9748604675;Taip;9;0;2;11
14648;Zylutė;VIEVERSĖLIAI;9372402025;Taip;3;0;0;3
14649;Zylutė;VIEVERSĖLIAI;6540140502;Ne;6;0;0;6
14650;Zylutė;VIEVERSĖLIAI;5058082347;Ne;12;0;0;12
14651;Zylutė;VIEVERSĖLIAI;6311805184;Ne;2;0;0;2
14652;Zylutė;VIEVERSĖLIAI;7072947464;Ne;8;0;0;8
14653;Zylutė;VIEVERSĖLIAI;3449678598;Ne;8;0;0;8
14654;Zylutė;VIEVERSĖLIAI;1271913393;Ne;8;0;0;8
14655;Zylutė;VIEVERSĖLIAI;4135186333;Ne;4;0;0;4
14656;Zylutė;VIEVERSĖLIAI;7070131037;Ne;2;1;0;3
14657;Zylutė;VIEVERSĖLIAI;1501573278;Taip;10;0;0;10
14658;Zylutė;VIEVERSĖLIAI;3787829836;Ne;1;0;0;1
14659;Zylutė;VIEVERSĖLIAI;5125900173;Ne;9;2;1;12
14660;Zylutė;VIEVERSĖLIAI;7173499688;Ne;6;0;0;6
14661;Zylutė;VIEVERSĖLIAI;5444138006;Ne;15;0;0;15
14662;Zylutė;VIEVERSĖLIAI;4437827048;Ne;4;0;0;4
14663;Želmenėliai;Bitučių;3268310531;Ne;0;2;0;2
14664;Želmenėliai;Bitučių;2563117992;Ne;5;4;0;9
14665;Želmenėliai;Bitučių;6799702725;Ne;0;4;1;5
14666;Želmenėliai;Bitučių;8358780570;Ne;0;7;0;7
14667;Želmenėliai;Bitučių;9006406225;Ne;0;6;0;6
14668;Želmenėliai;Bitučių;2102401372;Ne;0;4;0;4
14669;Želmenėliai;Bitučių;4931835807;Ne;0;4;0;4
14670;Želmenėliai;Bitučių;5147895081;Ne;0;3;0;3
14671;Želmenėliai;Bitučių;9611741258;Ne;0;4;0;4
14672;Želmenėliai;Bitučių;1619143702;Ne;0;4;0;4
14673;Želmenėliai;Bitučių;9825545754;Ne;0;6;0;6
14674;Želmenėliai;Bitučių;5314438217;Ne;5;6;0;11
14675;Želmenėliai;Bitučių;4927030144;Ne;0;6;0;6
14676;Želmenėliai;Bitučių;8028761330;Ne;7;2;0;9
14677;Želmenėliai;Bitučių;2853659708;Ne;1;4;0;5
14678;Želmenėliai;Bitučių;9207984505;Ne;6;10;0;16
14679;Želmenėliai;Bitučių;8946365627;Ne;0;1;0;1
14680;Želmenėliai;Kačiukų;1292462938;Ne;5;0;4;9
14681;Želmenėliai;Kačiukų;2350936740;Ne;9;4;0;13
14682;Želmenėliai;Kačiukų;3063417708;Ne;0;9;0;9
14683;Želmenėliai;Kačiukų;2570248893;Ne;0;6;0;6
14684;Želmenėliai;Kačiukų;2577850672;Ne;0;8;0;8
14685;Želmenėliai;Kačiukų;7197717698;Ne;19;0;0;19
14686;Želmenėliai;Kačiukų;7849682820;Ne;0;9;0;9
14687;Želmenėliai;Kačiukų;2111008869;Ne;0;4;0;4
14688;Želmenėliai;Kačiukų;4589396143;Ne;10;0;0;10
14689;Želmenėliai;Kačiukų;4198085732;Ne;0;6;0;6
14690;Želmenėliai;Kačiukų;6509783586;Ne;0;5;0;5
14691;Želmenėliai;Kačiukų;4126499046;Ne;0;6;0;6
14692;Želmenėliai;Kačiukų;4758240577;Ne;4;3;0;7
14693;Želmenėliai;Kačiukų;7094853897;Ne;9;1;0;10
14694;Želmenėliai;Kačiukų;9493581034;Ne;5;6;3;14
14695;Želmenėliai;Kačiukų;4931664953;Ne;0;3;0;3
14696;Želmenėliai;Kačiukų;4376978921;Ne;0;9;0;9
14697;Želmenėliai;Kačiukų;9313666706;Ne;8;5;0;13
14698;Želmenėliai;Kačiukų;8590129703;Ne;0;4;9;13
14699;Želmenėliai;Kačiukų;3959066963;Ne;0;5;0;5
14700;Želmenėliai;Voveriukų;8418427863;Ne;2;4;0;6
14701;Želmenėliai;Voveriukų;5360157217;Ne;0;17;0;17
14702;Želmenėliai;Voveriukų;2545133678;Ne;7;1;0;8
14703;Želmenėliai;Voveriukų;4968328834;Ne;5;4;0;9
14704;Želmenėliai;Voveriukų;2025424742;Ne;9;0;0;9
14705;Želmenėliai;Voveriukų;2924134152;Ne;24;0;0;24
14706;Želmenėliai;Voveriukų;5975166975;Ne;10;14;0;24
14707;Želmenėliai;Voveriukų;6857922902;Ne;14;0;0;14
14708;Želmenėliai;Voveriukų;9811131936;Ne;17;0;0;17
14709;Želmenėliai;Voveriukų;8968533318;Ne;5;4;0;9
14710;Želmenėliai;Voveriukų;8952421941;Ne;0;5;0;5
14711;Želmenėliai;Voveriukų;7345540758;Ne;8;1;0;9
14712;Želmenėliai;Voveriukų;9709599805;Ne;10;2;0;12
14713;Želmenėliai;Voveriukų;4248374729;Ne;0;11;0;11
14714;Želmenėliai;Voveriukų;7263162876;Ne;20;1;0;21
14715;Želmenėliai;Voveriukų;1199920167;Ne;3;2;0;5
14716;Želmenėliai;Voveriukų;5247889693;Ne;17;1;1;19
14717;Želmenėliai;Voveriukų;5767158743;Ne;0;1;5;6
14718;Želmenėliai;Ežiukų;1652131150;Ne;5;2;0;7
14719;Želmenėliai;Ežiukų;5795735579;Ne;4;3;0;7
14720;Želmenėliai;Ežiukų;2311169187;Ne;1;0;1;2
14721;Želmenėliai;Ežiukų;3572462731;Ne;5;0;0;5
14722;Želmenėliai;Ežiukų;3353793939;Ne;9;0;0;9
14723;Želmenėliai;Ežiukų;7495157523;Ne;6;0;0;6
14724;Želmenėliai;Ežiukų;3972980949;Ne;0;6;0;6
14725;Želmenėliai;Ežiukų;6779746783;Ne;14;0;0;14
14726;Želmenėliai;Ežiukų;6876147546;Ne;17;0;0;17
14727;Želmenėliai;Ežiukų;9126715074;Taip;3;2;0;5
14728;Želmenėliai;Ežiukų;1260607572;Ne;3;2;0;5
14729;Želmenėliai;Ežiukų;5638248652;Ne;9;0;0;9
14730;Želmenėliai;Ežiukų;8154713582;Ne;7;4;0;11
14731;Želmenėliai;Ežiukų;2296870749;Ne;10;0;1;11
14732;Želmenėliai;Ežiukų;6180553648;Ne;5;5;0;10
14733;Želmenėliai;Ežiukų;7294722095;Ne;3;9;0;12
14734;Želmenėliai;Ežiukų;4120125150;Ne;16;0;0;16
14735;Želmenėliai;Ežiukų;5281861477;Ne;0;10;0;10
14736;Želmenėliai;Ežiukų;8987377791;Ne;0;6;0;6
14737;Želmenėliai;Ežiukų;7373892344;Ne;8;0;0;8
14738;Želmenėliai;Ežiukų;6481952132;Ne;0;5;0;5
14739;Želmenėliai;Peledžiukų;8491797555;Ne;0;14;0;14
14740;Želmenėliai;Peledžiukų;7058759730;Ne;0;4;0;4
14741;Želmenėliai;Peledžiukų;4485249321;Ne;4;2;4;10
14742;Želmenėliai;Peledžiukų;3869372021;Ne;0;1;0;1
14743;Želmenėliai;Peledžiukų;4374898642;Ne;0;5;1;6
14744;Želmenėliai;Peledžiukų;7751609462;Ne;0;5;0;5
14745;Želmenėliai;Peledžiukų;5929410363;Ne;0;4;0;4
14746;Želmenėliai;Peledžiukų;5205425589;Ne;0;5;0;5
14747;Želmenėliai;Peledžiukų;5362390260;Ne;2;3;0;5
14748;Želmenėliai;Peledžiukų;1580370689;Ne;0;7;0;7
14749;Želmenėliai;Peledžiukų;1983575576;Ne;5;0;0;5
14750;Želmenėliai;Peledžiukų;7672980212;Ne;14;1;0;15
14751;Želmenėliai;Peledžiukų;6260153299;Ne;0;7;2;9
14752;Želmenėliai;Peledžiukų;6187661667;Ne;0;5;0;5
14753;Želmenėliai;Peledžiukų;6109546917;Ne;10;5;0;15
14754;Želmenėliai;Peledžiukų;8118696261;Ne;11;3;0;14
14755;Želmenėliai;Peledžiukų;4746898209;Ne;5;5;1;11
14756;Želmenėliai;Peledžiukų;9929149682;Taip;11;4;0;15
14757;Želmenėliai;Peledžiukų;3723155757;Ne;0;5;1;6
14758;Želmenėliai;Peledžiukų;5401466574;Ne;0;5;0;5
14759;Želmenėliai;Peledžiukų;6662439747;Ne;0;6;0;6
14760;Želmenėliai;Drugelių;7123290599;Ne;0;0;3;3
14761;Želmenėliai;Drugelių;4526936339;Ne;0;0;3;3
14762;Želmenėliai;Drugelių;5052052744;Ne;1;6;0;7
14763;Želmenėliai;Drugelių;2878494111;Ne;15;5;0;20
14764;Želmenėliai;Drugelių;5169813205;Ne;12;0;0;12
14765;Želmenėliai;Drugelių;7341132501;Ne;10;4;0;14
14766;Želmenėliai;Drugelių;9661692350;Ne;3;8;0;11
14767;Želmenėliai;Drugelių;6230010537;Ne;0;7;0;7
14768;Želmenėliai;Drugelių;1025894534;Ne;12;13;0;25
14769;Želmenėliai;Drugelių;1606079948;Ne;0;4;0;4
14770;Želmenėliai;Drugelių;9250666159;Ne;21;1;0;22
14771;Želmenėliai;Drugelių;5569699398;Ne;21;1;0;22
14772;Želmenėliai;Drugelių;4207070475;Ne;7;3;0;10
14773;Želmenėliai;Drugelių;7925266303;Ne;0;2;0;2
14774;Želmenėliai;Drugelių;4979494010;Ne;0;2;0;2
14775;Želmenėliai;Drugelių;8409831053;Ne;9;6;0;15
14776;Želmenėliai;Drugelių;8060048377;Ne;16;1;0;17
14777;Želmenėliai;Drugelių;3608041516;Ne;2;6;0;8
14778;Želmenėliai;Drugelių;2578675950;Ne;22;0;0;22
14779;Želmenėliai;Drugelių;5454656514;Ne;5;2;0;7
14780;Želmenėliai;Drugelių;7792850272;Ne;0;6;0;6
14781;Želmenėliai;Voriukų;4264751761;Ne;0;2;0;2
14782;Želmenėliai;Voriukų;6916426436;Ne;0;4;0;4
14783;Želmenėliai;Voriukų;7563461821;Ne;0;6;0;6
14784;Želmenėliai;Voriukų;4534946646;Ne;0;2;0;2
14785;Želmenėliai;Voriukų;4075533071;Ne;0;5;0;5
14786;Želmenėliai;Voriukų;4545012342;Ne;7;4;0;11
14787;Želmenėliai;Voriukų;7505996978;Ne;0;9;0;9
14788;Želmenėliai;Voriukų;2722619508;Ne;5;4;0;9
14789;Želmenėliai;Voriukų;5025345647;Ne;4;3;0;7
14790;Želmenėliai;Voriukų;8892137326;Ne;0;2;0;2
14791;Želmenėliai;Voriukų;7700521261;Ne;0;6;0;6
14792;Želmenėliai;Voriukų;1649724696;Ne;0;4;0;4
14793;Želmenėliai;Voriukų;5794346039;Ne;0;6;0;6
14794;Želmenėliai;Voriukų;8273301992;Ne;0;6;0;6
14795;Želmenėliai;Voriukų;9427388681;Ne;0;1;0;1
14796;Želmenėliai;Voriukų;9977585033;Ne;0;2;0;2
14797;Želmenėliai;Voriukų;6343814445;Ne;3;4;0;7
14798;Želmenėliai;Voriukų;5171736943;Ne;0;4;0;4
14799;Želmenėliai;Voriukų;7833143421;Ne;0;6;0;6
14800;Želmenėliai;Voriukų;7423900312;Ne;0;8;0;8
14801;Želmenėliai;Boružėlių;1764468979;Ne;0;4;0;4
14802;Želmenėliai;Boružėlių;5161934903;Ne;0;1;0;1
14803;Želmenėliai;Boružėlių;8722573513;Ne;2;5;0;7
14804;Želmenėliai;Boružėlių;3516695805;Ne;4;6;0;10
14805;Želmenėliai;Boružėlių;5949535657;Ne;3;4;0;7
14806;Želmenėliai;Boružėlių;2262009049;Ne;2;4;0;6
14807;Želmenėliai;Boružėlių;7077832687;Ne;3;2;0;5
14808;Želmenėliai;Boružėlių;3896171121;Ne;11;0;0;11
14809;Želmenėliai;Boružėlių;2951719129;Ne;5;5;0;10
14810;Želmenėliai;Boružėlių;2066439950;Ne;0;5;3;8
14811;Želmenėliai;Boružėlių;5207899503;Ne;0;9;0;9
14812;Želmenėliai;Boružėlių;2111705047;Ne;0;5;0;5
14813;Želmenėliai;Boružėlių;8474210476;Taip;7;0;0;7
14814;Želmenėliai;Boružėlių;2179165096;Ne;6;6;0;12
14815;Želmenėliai;Boružėlių;6831569546;Ne;14;0;0;14
14816;Želmenėliai;Boružėlių;9042786857;Ne;8;4;0;12
14817;Želmenėliai;Boružėlių;5913022147;Ne;0;5;0;5
14818;Želmenėliai;Pūkuotukų;3558547171;Ne;0;4;0;4
14819;Želmenėliai;Pūkuotukų;3979635800;Ne;4;3;0;7
14820;Želmenėliai;Pūkuotukų;4485851428;Ne;0;4;0;4
14821;Želmenėliai;Pūkuotukų;2501163903;Ne;0;3;0;3
14822;Želmenėliai;Pūkuotukų;1426080041;Ne;6;3;0;9
14823;Želmenėliai;Pūkuotukų;9076874685;Ne;2;2;0;4
14824;Želmenėliai;Pūkuotukų;3346680108;Ne;19;0;0;19
14825;Želmenėliai;Pūkuotukų;8654298177;Ne;0;4;0;4
14826;Želmenėliai;Pūkuotukų;9182208354;Ne;5;4;0;9
14827;Želmenėliai;Pūkuotukų;9544233589;Ne;0;3;0;3
14828;Želmenėliai;Pūkuotukų;4679930998;Ne;4;3;0;7
14829;Želmenėliai;Pūkuotukų;3344426717;Ne;8;0;0;8
14830;Želmenėliai;Pūkuotukų;4930868989;Ne;0;5;0;5
14831;Želmenėliai;Pūkuotukų;4451798870;Ne;0;8;0;8
14832;Želmenėliai;Pūkuotukų;8104790589;Ne;16;0;0;16
14833;Želmenėliai;Pūkuotukų;4722890143;Ne;6;6;0;12
14834;Želmenėliai;Pūkuotukų;9901320882;Ne;2;2;0;4
14835;Želmenėliai;Pūkuotukų;3232996198;Ne;7;3;0;10
14836;Želmenėliai;Pūkuotukų;6764567873;Ne;9;4;0;13
14837;Želmenėliai;Pūkuotukų;3926238501;Ne;0;9;0;9
14838;Želmenėliai;Pūkuotukų;2095477479;Ne;2;4;0;6
14839;Želmenėliai;Ančiukų;9377359390;Ne;10;3;0;13
14840;Želmenėliai;Ančiukų;8165683014;Ne;29;0;0;29
14841;Želmenėliai;Ančiukų;3172645969;Ne;4;4;0;8
14842;Želmenėliai;Ančiukų;7128213908;Ne;0;12;0;12
14843;Želmenėliai;Ančiukų;6723870371;Ne;2;3;0;5
14844;Želmenėliai;Ančiukų;5872145297;Ne;2;4;0;6
14845;Želmenėliai;Ančiukų;4824276300;Ne;5;3;0;8
14846;Želmenėliai;Ančiukų;9558387704;Ne;2;4;0;6
14847;Želmenėliai;Ančiukų;7550865762;Ne;4;3;0;7
14848;Želmenėliai;Ančiukų;4841250486;Taip;13;0;0;13
14849;Želmenėliai;Ančiukų;3057181122;Ne;4;4;0;8
14850;Želmenėliai;Ančiukų;1359184372;Ne;9;3;0;12
14851;Želmenėliai;Ančiukų;9945526672;Ne;29;0;0;29
14852;Želmenėliai;Nykštukų;8276857357;Ne;0;4;0;4
14853;Želmenėliai;Nykštukų;3003922213;Ne;7;0;0;7
14854;Želmenėliai;Nykštukų;3539019330;Ne;7;0;0;7
14855;Želmenėliai;Nykštukų;3313780575;Ne;6;0;0;6
14856;Želmenėliai;Nykštukų;5560792581;Ne;0;1;1;2
14857;Želmenėliai;Nykštukų;8191484604;Ne;19;0;0;19
14858;Želmenėliai;Nykštukų;2028226797;Ne;0;9;0;9
14859;Želmenėliai;Nykštukų;2369379191;Taip;13;0;0;13
14860;Želmenėliai;Nykštukų;6172599827;Ne;9;0;1;10
14861;Želmenėliai;Nykštukų;2678902898;Ne;5;0;2;7
14862;Želmenėliai;Nykštukų;7537198352;Ne;12;1;0;13
14863;Želmenėliai;Nykštukų;2896053108;Ne;10;5;0;15
14864;Želmenėliai;Nykštukų;4165912796;Ne;2;6;0;8
14865;Želmenėliai;Nykštukų;2105799163;Ne;19;0;0;19
14866;Želmenėliai;Lašelių;9483665065;Ne;0;6;0;6
14867;Želmenėliai;Lašelių;5494517342;Ne;11;4;0;15
14868;Želmenėliai;Lašelių;9774587149;Ne;4;4;0;8
14869;Želmenėliai;Lašelių;2143421412;Ne;0;6;0;6
14870;Želmenėliai;Lašelių;9608259121;Ne;0;10;0;10
14871;Želmenėliai;Lašelių;7403060823;Ne;0;10;0;10
14872;Želmenėliai;Lašelių;9178657126;Ne;5;4;0;9
14873;Želmenėliai;Lašelių;6863082839;Ne;4;3;0;7
14874;Želmenėliai;Lašelių;6605391184;Ne;0;5;0;5
14875;Želmenėliai;Lašelių;4197691574;Ne;11;4;0;15
14876;Želmenėliai;Lašelių;7714476156;Ne;2;3;0;5
14877;Želmenėliai;Lašelių;3788587862;Taip;10;2;0;12
14878;Želmenėliai;Lašelių;7067545362;Ne;0;6;0;6
14879;Želmenėliai;Lašelių;4354709866;Ne;12;4;0;16
14880;Žemyna;Čiauškučiai;9985529041;Ne;5;4;2;11
14881;Žemyna;Čiauškučiai;9570187081;Ne;0;2;0;2
14882;Žemyna;Čiauškučiai;2547436771;Ne;0;4;1;5
14883;Žemyna;Čiauškučiai;6346173832;Ne;10;0;0;10
14884;Žemyna;Čiauškučiai;8694608716;Ne;0;4;0;4
14885;Žemyna;Čiauškučiai;3074391266;Ne;5;4;0;9
14886;Žemyna;Čiauškučiai;4693414703;Ne;0;1;1;2
14887;Žemyna;Čiauškučiai;1365045512;Ne;4;0;2;6
14888;Žemyna;Čiauškučiai;7620179886;Ne;0;5;1;6
14889;Žemyna;Čiauškučiai;2792702536;Ne;0;4;0;4
14890;Žemyna;Čiauškučiai;7376806308;Ne;0;2;0;2
14891;Žemyna;Čiauškučiai;7277970673;Ne;0;4;0;4
14892;Žemyna;Čiauškučiai;5069437469;Ne;0;4;0;4
14893;Žemyna;Čiauškučiai;7427119736;Ne;0;3;0;3
14894;Žemyna;Čiauškučiai;4642600915;Ne;5;4;3;12
14895;Žemyna;Čiauškučiai;2354265632;Ne;7;4;2;13
14896;Žemyna;Čiauškučiai;2887459684;Ne;0;4;4;8
14897;Žemyna;Čiauškučiai;1654157342;Ne;0;4;0;4
14898;Žemyna;Čiauškučiai;4652384557;Ne;0;2;0;2
14899;Žemyna;Čiauškučiai;7352868453;Ne;7;4;1;12
14900;Žemyna;Čiauškučiai;4501408683;Ne;0;4;0;4
14901;Žemyna;Čiauškučiai;4613946229;Ne;5;4;0;9
14902;Žemyna;Čiauškučiai;7675699775;Ne;0;3;0;3
14903;Žemyna;Čiauškučiai;6254811026;Ne;6;4;1;11
14904;Žemyna;Nykštukai;8965957442;Ne;4;0;2;6
14905;Žemyna;Nykštukai;6965700024;Ne;8;4;0;12
14906;Žemyna;Nykštukai;3413550977;Ne;6;2;3;11
14907;Žemyna;Nykštukai;1158238868;Ne;9;0;0;9
14908;Žemyna;Nykštukai;8234617396;Ne;9;0;0;9
14909;Žemyna;Nykštukai;2105658990;Ne;7;4;0;11
14910;Žemyna;Nykštukai;1241953155;Ne;6;0;2;8
14911;Žemyna;Nykštukai;5274759824;Ne;11;0;0;11
14912;Žemyna;Nykštukai;9457156368;Taip;11;0;0;11
14913;Žemyna;Nykštukai;5968816137;Ne;0;0;5;5
14914;Žemyna;Nykštukai;1581399038;Ne;4;0;1;5
14915;Žemyna;Nykštukai;4238528111;Ne;0;2;0;2
14916;Žemyna;Nykštukai;3741459808;Ne;0;2;0;2
14917;Žemyna;Nykštukai;3870917221;Ne;7;0;0;7
14918;Žemyna;Nykštukai;6571952468;Taip;4;0;1;5
14919;Žemyna;Nykštukai;6632827240;Ne;0;4;0;4
14920;Žemyna;Nykštukai;3935318882;Ne;2;2;0;4
14921;Žemyna;Nykštukai;2010676445;Ne;2;2;0;4
14922;Žemyna;Nykštukai;9788890112;Ne;8;0;0;8
14923;Žemyna;Nykštukai;8157281885;Ne;6;0;0;6
14924;Žemyna;Voveriukai;5448623202;Ne;0;0;1;1
14925;Žemyna;Voveriukai;6912605631;Ne;0;5;0;5
14926;Žemyna;Voveriukai;4549562657;Ne;0;4;0;4
14927;Žemyna;Voveriukai;8882641275;Ne;0;6;0;6
14928;Žemyna;Voveriukai;7121061078;Ne;0;3;0;3
14929;Žemyna;Voveriukai;4900914346;Ne;1;4;0;5
14930;Žemyna;Voveriukai;8241038433;Ne;0;4;0;4
14931;Žemyna;Voveriukai;5189603013;Ne;2;2;0;4
14932;Žemyna;Voveriukai;3500358886;Ne;0;4;0;4
14933;Žemyna;Voveriukai;6592356004;Ne;8;1;0;9
14934;Žemyna;Voveriukai;7468763527;Ne;0;1;0;1
14935;Žemyna;Voveriukai;7705964355;Ne;13;3;0;16
14936;Žemyna;Voveriukai;5486645485;Ne;0;5;0;5
14937;Žemyna;Voveriukai;5828590779;Ne;15;0;0;15
14938;Žemyna;Voveriukai;6070560979;Ne;0;1;0;1
14939;Žemyna;Voveriukai;8601806926;Ne;5;14;0;19
14940;Žemyna;Kiškučiai;9912869400;Ne;10;4;0;14
14941;Žemyna;Kiškučiai;2006173745;Ne;0;7;1;8
14942;Žemyna;Kiškučiai;6116581655;Ne;0;1;1;2
14943;Žemyna;Kiškučiai;6728229865;Ne;0;6;0;6
14944;Žemyna;Kiškučiai;7280740926;Ne;0;2;0;2
14945;Žemyna;Kiškučiai;4872348199;Ne;0;4;1;5
14946;Žemyna;Kiškučiai;2710551760;Ne;0;1;0;1
14947;Žemyna;Kiškučiai;6419974691;Ne;3;9;0;12
14948;Žemyna;Kiškučiai;9818711030;Ne;0;4;2;6
14949;Žemyna;Kiškučiai;6735720135;Ne;0;4;0;4
14950;Žemyna;Kiškučiai;6878669773;Ne;0;4;2;6
14951;Žemyna;Kiškučiai;7764615445;Ne;0;4;0;4
14952;Žemyna;Kiškučiai;4502958166;Ne;0;5;1;6
14953;Žemyna;Kiškučiai;5868208651;Ne;0;5;0;5
14954;Žemyna;Kiškučiai;3982766622;Ne;0;4;0;4
14955;Žemyna;Kiškučiai;3992383447;Ne;5;3;0;8
14956;Žemyna;Kiškučiai;9568886284;Ne;0;4;4;8
14957;Žemyna;Kiškučiai;9668975591;Ne;0;2;1;3
14958;Žemyna;Kiškučiai;6856737270;Ne;0;1;0;1
14959;Žemyna;Kiškučiai;4612112289;Ne;2;4;0;6
14960;Žemyna;Kiškučiai;5188496664;Ne;2;4;0;6
14961;Žemyna;Kiškučiai;9501126807;Ne;0;2;0;2
14962;Žemyna;Kiškučiai;4821941126;Ne;0;2;0;2
14963;Žemyna;Vyturiukai;2526949655;Ne;5;4;0;9
14964;Žemyna;Vyturiukai;1417007895;Ne;0;8;0;8
14965;Žemyna;Vyturiukai;5355845891;Ne;7;2;0;9
14966;Žemyna;Vyturiukai;1481273689;Ne;6;4;2;12
14967;Žemyna;Vyturiukai;7781332622;Ne;12;1;0;13
14968;Žemyna;Vyturiukai;9366133892;Ne;4;4;0;8
14969;Žemyna;Vyturiukai;1031171460;Ne;3;0;1;4
14970;Žemyna;Vyturiukai;5204349188;Ne;5;4;0;9
14971;Žemyna;Vyturiukai;1345704379;Ne;10;0;1;11
14972;Žemyna;Vyturiukai;6097681172;Ne;3;4;0;7
14973;Žemyna;Vyturiukai;5133115712;Ne;0;4;0;4
14974;Žemyna;Vyturiukai;5416338054;Ne;0;4;0;4
14975;Žemyna;Vyturiukai;3446774478;Ne;5;4;0;9
14976;Žemyna;Vyturiukai;6271057561;Ne;0;5;0;5
14977;Žemyna;Vyturiukai;2304633263;Ne;0;10;0;10
14978;Žemyna;Vyturiukai;7300819771;Ne;0;1;0;1
14979;Žemyna;Vyturiukai;3679990879;Ne;3;0;5;8
14980;Žemyna;Vyturiukai;8681308720;Ne;5;5;0;10
14981;Žemyna;Vyturiukai;9646494715;Ne;0;6;0;6
14982;Žemyna;Vyturiukai;4863350801;Taip;9;0;1;10
14983;Žemyna;Vyturiukai;6372465987;Ne;5;2;0;7
14984;Žemyna;Vyturiukai;5655302107;Ne;5;5;0;10
14985;Žemyna;Pelėdžiukai;8525229514;Ne;7;3;0;10
14986;Žemyna;Pelėdžiukai;1846287760;Ne;4;4;0;8
14987;Žemyna;Pelėdžiukai;8775518984;Ne;0;4;5;9
14988;Žemyna;Pelėdžiukai;5450351549;Ne;0;3;0;3
14989;Žemyna;Pelėdžiukai;8926045231;Ne;2;4;5;11
14990;Žemyna;Pelėdžiukai;3860791215;Ne;0;2;0;2
14991;Žemyna;Pelėdžiukai;9855080887;Ne;0;4;0;4
14992;Žemyna;Pelėdžiukai;8185243991;Ne;0;4;0;4
14993;Žemyna;Pelėdžiukai;9471382383;Ne;0;3;2;5
14994;Žemyna;Pelėdžiukai;7942276632;Ne;2;4;1;7
14995;Žemyna;Pelėdžiukai;2422672832;Ne;0;1;0;1
14996;Žemyna;Pelėdžiukai;8408275231;Ne;3;4;1;8
14997;Žemyna;Pelėdžiukai;7417179112;Ne;0;1;0;1
14998;Žemyna;Pelėdžiukai;5387026410;Ne;0;1;0;1
14999;Žemyna;Pelėdžiukai;9831054554;Ne;0;3;1;4
15000;Žemyna;Pelėdžiukai;9194899557;Ne;10;4;0;14
15001;Žemyna;Pelėdžiukai;6175213274;Ne;5;4;0;9
15002;Žemyna;Pelėdžiukai;7311046586;Ne;0;4;1;5
15003;Žemyna;Pelėdžiukai;5124507416;Ne;0;4;1;5
15004;Žemyna;Pelėdžiukai;7672879525;Ne;7;3;0;10
15005;Žemyna;Vijurkai;4524929331;Ne;9;2;0;11
15006;Žemyna;Vijurkai;5114094924;Ne;0;6;1;7
15007;Žemyna;Vijurkai;3643594001;Ne;0;6;1;7
15008;Žemyna;Vijurkai;9182709647;Ne;0;15;0;15
15009;Žemyna;Vijurkai;4257096808;Ne;0;4;0;4
15010;Žemyna;Vijurkai;3874855308;Ne;0;4;0;4
15011;Žemyna;Vijurkai;7121742098;Ne;0;4;0;4
15012;Žemyna;Vijurkai;2461700030;Ne;0;10;0;10
15013;Žemyna;Vijurkai;3519840747;Ne;0;2;0;2
15014;Žemyna;Vijurkai;7508491119;Ne;0;5;0;5
15015;Žemyna;Vijurkai;1725771976;Ne;4;4;0;8
15016;Žemyna;Vijurkai;9653530823;Ne;5;4;0;9
15017;Žemyna;Vijurkai;2860210906;Ne;2;5;1;8
15018;Žemyna;Vijurkai;7832066079;Ne;0;5;0;5
15019;Žemyna;Vijurkai;1468040559;Ne;3;4;0;7
15020;Žemyna;Vijurkai;4322192775;Ne;0;4;0;4
15021;Žemyna;Vijurkai;4444870782;Ne;0;4;0;4
15022;Žemyna;Vijurkai;4265606762;Ne;15;4;0;19
15023;Žemyna;Vijurkai;7781924111;Ne;0;4;0;4
15024;Žemyna;Vijurkai;2928125522;Ne;0;5;0;5
15025;Žemyna;Vijurkai;4759403487;Ne;0;11;0;11
15026;Žemyna;Vijurkai;5222774764;Ne;0;19;0;19
15027;Žemyna;Šnekučiai;4540472310;Ne;0;6;0;6
15028;Žemyna;Šnekučiai;9647706055;Ne;0;4;0;4
15029;Žemyna;Šnekučiai;2883862675;Ne;0;0;1;1
15030;Žemyna;Šnekučiai;7537145330;Ne;2;0;1;3
15031;Žemyna;Šnekučiai;7683443675;Ne;2;0;1;3
15032;Žemyna;Šnekučiai;3899901920;Ne;0;4;0;4
15033;Žemyna;Šnekučiai;7831778620;Ne;0;6;0;6
15034;Žemyna;Šnekučiai;9692952139;Ne;0;4;0;4
15035;Žemyna;Šnekučiai;1795919515;Ne;3;4;0;7
15036;Žemyna;Šnekučiai;8319442149;Ne;11;0;0;11
15037;Žemyna;Šnekučiai;1999410395;Ne;7;0;3;10
15038;Žemyna;Šnekučiai;6872208929;Ne;3;0;5;8
15039;Žemyna;Šnekučiai;4373063041;Ne;0;0;2;2
15040;Žemyna;Šnekučiai;9813765590;Ne;5;0;3;8
15041;Žemyna;Šnekučiai;4779461598;Ne;7;0;4;11
15042;Žemyna;Šnekučiai;3976010927;Ne;19;0;0;19
15043;Žemyna;Šnekučiai;4963338410;Ne;10;0;0;10
15044;Žemyna;Šnekučiai;1078809628;Taip;7;4;2;13
15045;Žemyna;Šnekučiai;3729250035;Taip;5;0;4;9
15046;Žemyna;Šnekučiai;9535234845;Ne;0;0;2;2
15047;Žemyna;Šnekučiai;9796331127;Ne;3;4;0;7
15048;Žemyna;Šnekučiai;3996577758;Ne;0;4;0;4
15049;Žemyna;Pabiručiai;9827401825;Ne;0;5;0;5
15050;Žemyna;Pabiručiai;5743535463;Ne;0;8;0;8
15051;Žemyna;Pabiručiai;6958537154;Ne;0;6;0;6
15052;Žemyna;Pabiručiai;7005045961;Ne;0;7;0;7
15053;Žemyna;Pabiručiai;1745197274;Ne;4;4;0;8
15054;Žemyna;Pabiručiai;6041223291;Ne;7;5;0;12
15055;Žemyna;Pabiručiai;8248443265;Ne;1;3;0;4
15056;Žemyna;Pabiručiai;7122276019;Ne;0;1;0;1
15057;Žemyna;Pabiručiai;9094718595;Ne;4;3;0;7
15058;Žemyna;Pabiručiai;6208953341;Ne;0;15;0;15
15059;Žemyna;Pabiručiai;1656335765;Ne;0;4;0;4
15060;Žemyna;Pabiručiai;5127174926;Ne;7;6;0;13
15061;Žemyna;Pabiručiai;8559870965;Ne;0;5;0;5
15062;Žemyna;Pabiručiai;1850100203;Ne;6;3;0;9
15063;Žemyna;Pabiručiai;2860232791;Ne;3;0;0;3
15064;Žemyna;Pabiručiai;4237778022;Ne;10;2;0;12
15065;Žemyna;Pabiručiai;2414400761;Ne;0;12;0;12
15066;Žemyna;Pabiručiai;9511935264;Ne;0;8;0;8
15067;Žemyna;Pabiručiai;4176386795;Ne;0;4;0;4
15068;Žemyna;Pabiručiai;3393414493;Ne;8;4;0;12
15069;Žemyna;Pabiručiai;4960936366;Ne;5;4;0;9
15070;Žemyna;Pabiručiai;2495616844;Ne;0;5;0;5
15071;Žemyna;Pabiručiai;6329592260;Ne;0;8;0;8
15072;Žemyna;Drugeliai;7564693757;Ne;19;0;0;19
15073;Žemyna;Drugeliai;8302345911;Ne;5;0;0;5
15074;Žemyna;Drugeliai;3505551915;Ne;0;2;8;10
15075;Žemyna;Drugeliai;2231967652;Ne;9;0;2;11
15076;Žemyna;Drugeliai;3755964840;Ne;5;3;0;8
15077;Žemyna;Drugeliai;9171823612;Ne;0;0;16;16
15078;Žemyna;Drugeliai;5518125715;Ne;0;0;9;9
15079;Žemyna;Drugeliai;9589582451;Ne;0;0;5;5
15080;Žemyna;Drugeliai;3872427931;Ne;2;0;0;2
15081;Žemyna;Drugeliai;1279981170;Ne;0;0;1;1
15082;Žemyna;Drugeliai;2102920661;Ne;1;0;1;2
15083;Žemyna;Drugeliai;6575272457;Ne;8;0;0;8
15084;Žemyna;Drugeliai;6164541167;Ne;0;3;1;4
15085;Žemyna;Drugeliai;7461187735;Ne;0;0;4;4
15086;Žemyna;Drugeliai;3390442637;Ne;9;4;0;13
15087;Žemyna;Drugeliai;2371069183;Ne;0;0;4;4
15088;Žemyna;Drugeliai;2139103576;Ne;2;0;2;4
15089;Žemyna;Drugeliai;7920398415;Ne;0;5;0;5
15090;Žemyna;Drugeliai;1695063377;Ne;0;0;3;3
15091;Žemyna;Drugeliai;7745383607;Ne;4;2;3;9
15092;Žemyna;Drugeliai;7661182825;Ne;1;0;7;8
15093;Žemyna;Drugeliai;4861799571;Ne;0;0;7;7
15094;Žemyna;Drugeliai;8709792653;Ne;0;0;4;4
15095;Žemyna;Drugeliai;7969518430;Ne;0;5;6;11
15096;Žemyna;"ŽIRNIUKAI ";8638419172;Ne;9;0;5;14
15097;Žemyna;"ŽIRNIUKAI ";5262196604;Ne;4;4;0;8
15098;Žemyna;"ŽIRNIUKAI ";6783675344;Ne;8;0;0;8
15099;Žemyna;"ŽIRNIUKAI ";9082375371;Ne;3;0;0;3
15100;Žemyna;"ŽIRNIUKAI ";3172071074;Ne;0;6;13;19
15101;Žemyna;"ŽIRNIUKAI ";7684869135;Ne;6;2;0;8
15102;Žemyna;"ŽIRNIUKAI ";8574497593;Ne;11;4;1;16
15103;Žemyna;"ŽIRNIUKAI ";3951546627;Ne;14;0;0;14
15104;Žemyna;"ŽIRNIUKAI ";2333634521;Ne;0;4;0;4
15105;Žemyna;"ŽIRNIUKAI ";8915491841;Ne;0;0;3;3
15106;Žemyna;"ŽIRNIUKAI ";7567666690;Ne;3;0;4;7
15107;Žemyna;"ŽIRNIUKAI ";1667692063;Ne;0;3;5;8
15108;Žemyna;"ŽIRNIUKAI ";1898736492;Ne;2;3;0;5
15109;Žemyna;"ŽIRNIUKAI ";8371442452;Ne;0;4;0;4
15110;Žemyna;"ŽIRNIUKAI ";2302222659;Ne;13;4;0;17
15111;Žemyna;"ŽIRNIUKAI ";3695746422;Ne;9;0;1;10
15112;Žemyna;"ŽIRNIUKAI ";1014787654;Ne;10;4;0;14
15113;Žemyna;"ŽIOGELIAI ";2039344248;Ne;0;0;1;1
15114;Žemyna;"ŽIOGELIAI ";5193466394;Ne;0;1;0;1
15115;Žemyna;"ŽIOGELIAI ";3164469202;Ne;3;0;0;3
15116;Žemyna;"ŽIOGELIAI ";8365200813;Ne;5;4;0;9
15117;Žemyna;"ŽIOGELIAI ";3234902380;Ne;1;0;1;2
15118;Žemyna;"ŽIOGELIAI ";8939113856;Ne;5;6;0;11
15119;Žemyna;"ŽIOGELIAI ";8205404725;Ne;5;4;1;10
15120;Žemyna;"ŽIOGELIAI ";6638712995;Ne;12;0;1;13
15121;Žemyna;"ŽIOGELIAI ";3768231563;Ne;2;3;0;5
15122;Žemyna;"ŽIOGELIAI ";7580529381;Ne;6;0;0;6
15123;Žemyna;"ŽIOGELIAI ";5593285877;Ne;6;0;0;6
15124;Žemyna;"ŽIOGELIAI ";3397833166;Ne;3;4;1;8
15125;Žemyna;"ŽIOGELIAI ";2255662379;Ne;10;0;0;10
15126;Žemyna;"ŽIOGELIAI ";8017209353;Ne;10;0;0;10
15127;Žemyna;"ŽIOGELIAI ";8036600474;Ne;0;4;0;4
15128;Žemyna;"ŽIOGELIAI ";6317657622;Ne;8;3;0;11
15129;Žemyna;"ŽIOGELIAI ";9992027222;Ne;17;0;0;17
15130;Žemuogėlė;Boružiukai;1350671777;Ne;11;0;2;13
15131;Žemuogėlė;Boružiukai;9344628661;Ne;2;1;2;5
15132;Žemuogėlė;Boružiukai;2158359435;Ne;10;0;0;10
15133;Žemuogėlė;Boružiukai;1639634300;Taip;12;1;0;13
15134;Žemuogėlė;Boružiukai;5521993938;Ne;0;0;2;2
15135;Žemuogėlė;Boružiukai;1267222057;Ne;7;3;1;11
15136;Žemuogėlė;Boružiukai;9562512849;Ne;9;7;0;16
15137;Žemuogėlė;Boružiukai;8661864424;Ne;0;1;0;1
15138;Žemuogėlė;Boružiukai;1150466286;Ne;4;5;0;9
15139;Žemuogėlė;Boružiukai;8040255583;Ne;0;7;0;7
15140;Žemuogėlė;Boružiukai;2190458676;Ne;5;1;0;6
15141;Žemuogėlė;Boružiukai;6073591450;Ne;0;0;4;4
15142;Žemuogėlė;Boružiukai;7328566035;Taip;7;0;3;10
15143;Žemuogėlė;Boružiukai;8557325116;Ne;5;2;0;7
15144;Žemuogėlė;Boružiukai;1350383125;Ne;0;2;3;5
15145;Žemuogėlė;Boružiukai;7050896262;Ne;0;2;0;2
15146;Žemuogėlė;Boružiukai;3413805578;Ne;4;0;4;8
15147;Žemuogėlė;Boružiukai;1187953952;Ne;0;0;3;3
15148;Žemuogėlė;Boružiukai;3677459716;Ne;0;1;2;3
15149;Žemuogėlė;Boružiukai;8426601160;Ne;6;0;0;6
15150;Žemuogėlė;Boružiukai;5911215640;Ne;3;2;7;12
15151;Žemuogėlė;Šviesuliukai;9599829363;Ne;2;4;0;6
15152;Žemuogėlė;Šviesuliukai;7288060676;Ne;14;0;2;16
15153;Žemuogėlė;Šviesuliukai;5447960062;Ne;9;0;2;11
15154;Žemuogėlė;Šviesuliukai;4654060157;Ne;0;2;6;8
15155;Žemuogėlė;Šviesuliukai;2652630375;Ne;2;6;0;8
15156;Žemuogėlė;Šviesuliukai;1250186598;Ne;0;7;0;7
15157;Žemuogėlė;Šviesuliukai;3287415964;Ne;0;8;0;8
15158;Žemuogėlė;Šviesuliukai;5094867109;Ne;9;0;2;11
15159;Žemuogėlė;Šviesuliukai;4974793430;Ne;3;0;6;9
15160;Žemuogėlė;Šviesuliukai;5125826172;Ne;0;10;0;10
15161;Žemuogėlė;Šviesuliukai;8262862183;Taip;4;6;1;11
15162;Žemuogėlė;Šviesuliukai;8798113318;Taip;1;2;2;5
15163;Žemuogėlė;Šviesuliukai;1280794094;Taip;2;7;0;9
15164;Žemuogėlė;Šviesuliukai;2251142510;Ne;0;6;0;6
15165;Žemuogėlė;Šviesuliukai;1417355297;Ne;0;3;0;3
15166;Žemuogėlė;Šviesuliukai;6659616731;Ne;0;4;0;4
15167;Žemuogėlė;Lašiukai;3190523750;Ne;7;0;1;8
15168;Žemuogėlė;Lašiukai;1251497003;Ne;0;5;0;5
15169;Žemuogėlė;Lašiukai;3706531223;Ne;0;6;0;6
15170;Žemuogėlė;Lašiukai;8029484123;Ne;6;3;0;9
15171;Žemuogėlė;Lašiukai;5992802843;Ne;4;0;0;4
15172;Žemuogėlė;Lašiukai;3753156044;Ne;0;3;2;5
15173;Žemuogėlė;Lašiukai;7592566602;Ne;9;1;1;11
15174;Žemuogėlė;Lašiukai;8644564820;Ne;0;2;0;2
15175;Žemuogėlė;Lašiukai;3546429231;Ne;0;13;0;13
15176;Žemuogėlė;Lašiukai;3073956225;Ne;18;0;0;18
15177;Žemuogėlė;Lašiukai;9693814425;Ne;9;0;0;9
15178;Žemuogėlė;Lašiukai;3059525247;Ne;0;5;0;5
15179;Žemuogėlė;Lašiukai;6747566307;Ne;0;5;0;5
15180;Žemuogėlė;Lašiukai;2115883173;Ne;7;0;2;9
15181;Žemuogėlė;Lašiukai;9848385521;Ne;12;0;0;12
15182;Žemuogėlė;Lašiukai;5602718614;Ne;0;6;6;12
15183;Žemuogėlė;Skambaliukai;7804015060;Ne;0;9;0;9
15184;Žemuogėlė;Skambaliukai;3765022476;Ne;1;10;0;11
15185;Žemuogėlė;Skambaliukai;9476688736;Ne;0;6;0;6
15186;Žemuogėlė;Skambaliukai;2001471529;Ne;3;3;0;6
15187;Žemuogėlė;Skambaliukai;9519563708;Ne;0;8;0;8
15188;Žemuogėlė;Skambaliukai;5266493632;Ne;0;1;0;1
15189;Žemuogėlė;Skambaliukai;2841634296;Ne;0;6;0;6
15190;Žemuogėlė;Skambaliukai;3237083654;Ne;0;5;0;5
15191;Žemuogėlė;Skambaliukai;2259779058;Ne;0;5;0;5
15192;Žemuogėlė;Skambaliukai;9693894254;Ne;0;7;0;7
15193;Žemuogėlė;Skambaliukai;9378432383;Ne;5;7;0;12
15194;Žemuogėlė;Skambaliukai;6913038845;Ne;5;5;0;10
15195;Žemuogėlė;Skambaliukai;6581889641;Ne;0;6;0;6
15196;Žemuogėlė;Skambaliukai;2555902309;Ne;2;8;0;10
15197;Žemuogėlė;Skambaliukai;2132549536;Ne;8;8;0;16
15198;Žemuogėlė;Skambaliukai;5532053268;Ne;5;9;0;14
15199;Žemuogėlė;Skambaliukai;8496353410;Ne;0;9;0;9
15200;Žemuogėlė;Skambaliukai;1733808230;Ne;13;5;0;18
15201;Žemuogėlė;Skambaliukai;1469759840;Ne;0;2;0;2
15202;Žemuogėlė;Skambaliukai;9579921777;Ne;5;6;0;11
15203;Žemuogėlė;Spinduliukai;9955429241;Taip;3;0;0;3
15204;Žemuogėlė;Spinduliukai;5971652934;Taip;0;8;0;8
15205;Žemuogėlė;Spinduliukai;4578291476;Ne;17;3;0;20
15206;Žemuogėlė;Spinduliukai;6707522989;Ne;8;6;0;14
15207;Žemuogėlė;Spinduliukai;7669457695;Taip;0;5;0;5
15208;Žemuogėlė;Spinduliukai;3041461125;Ne;6;2;0;8
15209;Žemuogėlė;Spinduliukai;4933948491;Ne;13;3;0;16
15210;Žemuogėlė;Spinduliukai;7342985744;Ne;19;0;7;26
15211;Žemuogėlė;Spinduliukai;8492878852;Ne;0;4;0;4
15212;Žemuogėlė;Spinduliukai;7551522580;Ne;9;0;2;11
15213;Žemuogėlė;Spinduliukai;5499401648;Ne;0;5;0;5
15214;Žemuogėlė;Spinduliukai;7603740057;Ne;13;0;4;17
15215;Žemuogėlė;Spinduliukai;3746045950;Ne;11;4;0;15
15216;Žemuogėlė;Spinduliukai;4506847669;Ne;5;3;0;8
15217;Žemuogėlė;Spinduliukai;7837251012;Ne;6;1;0;7
15218;Žemuogėlė;Spinduliukai;7189855370;Ne;0;14;0;14
15219;Žemuogėlė;Spinduliukai;3801534195;Ne;6;1;2;9
15220;Žemuogėlė;Perliukai;1002937953;Ne;4;1;0;5
15221;Žemuogėlė;Perliukai;6504659145;Ne;4;2;0;6
15222;Žemuogėlė;Perliukai;3505090532;Ne;8;0;0;8
15223;Žemuogėlė;Perliukai;1790341419;Taip;4;3;0;7
15224;Žemuogėlė;Perliukai;4998981337;Ne;0;5;0;5
15225;Žemuogėlė;Perliukai;6045257180;Ne;5;0;0;5
15226;Žemuogėlė;Perliukai;8301927361;Ne;7;0;0;7
15227;Žemuogėlė;Perliukai;2496321184;Ne;2;3;0;5
15228;Žemuogėlė;Perliukai;5208043522;Ne;11;0;0;11
15229;Žemuogėlė;Perliukai;2139102266;Ne;20;1;0;21
15230;Žemuogėlė;Perliukai;3740127955;Taip;1;19;0;20
15231;Žemuogėlė;Perliukai;5614510812;Ne;8;0;0;8
15232;Žemuogėlė;Perliukai;9735379466;Ne;0;7;1;8
15233;Žemuogėlė;Perliukai;4089939292;Ne;6;0;0;6
15234;Žemuogėlė;Perliukai;9584172565;Ne;9;5;0;14
15235;Žemuogėlė;Perliukai;8706379207;Ne;13;0;0;13
15236;Žemuogėlė;Perliukai;1457860763;Ne;7;0;0;7
15237;Žemuogėlė;Drugeliai;2745609317;Ne;4;2;2;8
15238;Žemuogėlė;Drugeliai;9694133286;Ne;0;5;0;5
15239;Žemuogėlė;Drugeliai;5557409350;Ne;5;10;0;15
15240;Žemuogėlė;Drugeliai;7668200447;Ne;0;1;0;1
15241;Žemuogėlė;Drugeliai;7148244029;Ne;8;3;0;11
15242;Žemuogėlė;Drugeliai;1901423257;Ne;0;5;0;5
15243;Žemuogėlė;Drugeliai;4862145385;Ne;8;2;0;10
15244;Žemuogėlė;Drugeliai;4368183799;Taip;8;3;0;11
15245;Žemuogėlė;Drugeliai;9902953729;Ne;15;7;0;22
15246;Žemuogėlė;Drugeliai;9537297860;Ne;7;3;0;10
15247;Žemuogėlė;Drugeliai;5170205929;Ne;7;6;0;13
15248;Žemuogėlė;Drugeliai;2428043195;Ne;0;7;0;7
15249;Žemuogėlė;Drugeliai;1716114524;Taip;0;8;0;8
15250;Žemuogėlė;Drugeliai;8137567729;Ne;0;10;0;10
15251;Žemuogėlė;Drugeliai;7974688217;Ne;16;3;0;19
15252;Žemuogėlė;Drugeliai;9273896998;Ne;12;1;0;13
15253;Žemuogėlė;Drugeliai;9801151322;Ne;0;10;0;10
15254;Žemuogėlė;Drugeliai;5142411841;Ne;0;6;0;6
15255;Žemuogėlė;Drugeliai;9872387354;Ne;17;0;2;19
15256;Žemuogėlė;Drugeliai;5300388726;Ne;1;2;0;3
15257;Žemuogėlė;"VIEVERSIUKAI ";6520776378;Ne;5;1;0;6
15258;Žemuogėlė;"VIEVERSIUKAI ";8048818368;Ne;1;0;3;4
15259;Žemuogėlė;"VIEVERSIUKAI ";6577040746;Ne;3;0;4;7
15260;Žemuogėlė;"VIEVERSIUKAI ";2674188340;Ne;1;2;4;7
15261;Žemuogėlė;"VIEVERSIUKAI ";4172356209;Taip;21;0;0;21
15262;Žemuogėlė;"VIEVERSIUKAI ";6379837644;Ne;6;0;2;8
15263;Žemuogėlė;"VIEVERSIUKAI ";3104276726;Ne;0;2;3;5
15264;Žemuogėlė;"VIEVERSIUKAI ";3419907292;Ne;1;0;0;1
15265;Žemuogėlė;"VIEVERSIUKAI ";2800160529;Taip;5;1;1;7
15266;Žemuogėlė;"VIEVERSIUKAI ";8934779062;Ne;10;6;0;16
15267;Žemuogėlė;"VIEVERSIUKAI ";3090630899;Ne;3;0;0;3
15268;Žemuogėlė;"VIEVERSIUKAI ";8091000121;Ne;4;1;2;7
15269;Žemuogėlė;"VIEVERSIUKAI ";2110963483;Ne;3;11;0;14
15270;Žemuogėlė;"VIEVERSIUKAI ";2574719380;Ne;9;0;2;11
15271;Žemuogėlė;"NYKŠTUKAI ";9205221446;Ne;1;1;0;2
15272;Žemuogėlė;"NYKŠTUKAI ";2655733505;Ne;3;6;0;9
15273;Žemuogėlė;"NYKŠTUKAI ";1911605637;Ne;6;0;0;6
15274;Žemuogėlė;"NYKŠTUKAI ";9798128294;Ne;26;0;0;26
15275;Žemuogėlė;"NYKŠTUKAI ";1916826391;Ne;5;1;0;6
15276;Žemuogėlė;"NYKŠTUKAI ";5948873766;Ne;5;2;0;7
15277;Žemuogėlė;"NYKŠTUKAI ";3010585170;Ne;8;8;2;18
15278;Žemuogėlė;"NYKŠTUKAI ";1769751604;Ne;3;1;0;4
15279;Žemuogėlė;"NYKŠTUKAI ";3462564692;Ne;26;0;0;26
15280;Žemuogėlė;"NYKŠTUKAI ";7565473877;Ne;3;1;0;4
15281;Žemuogėlė;"NYKŠTUKAI ";8211122634;Ne;1;0;0;1
15282;Žemuogėlė;"NYKŠTUKAI ";8706639942;Taip;3;0;0;3
15283;Žemuogėlė;"NYKŠTUKAI ";4180815331;Ne;12;0;1;13
15284;Žemuogėlė;"NYKŠTUKAI ";9290074229;Ne;2;0;1;3
15285;Žemuogėlė;"NYKŠTUKAI ";1601617523;Ne;5;2;1;8
15286;Žemuogėlė;KIŠKUČIAI;3467743802;Ne;17;0;0;17
15287;Žemuogėlė;KIŠKUČIAI;8584425313;Ne;2;6;0;8
15288;Žemuogėlė;KIŠKUČIAI;7423719480;Ne;1;7;2;10
15289;Žemuogėlė;KIŠKUČIAI;9889748260;Ne;3;2;1;6
15290;Žemuogėlė;KIŠKUČIAI;3385450072;Ne;0;4;0;4
15291;Žemuogėlė;KIŠKUČIAI;3842157786;Ne;3;5;0;8
15292;Žemuogėlė;KIŠKUČIAI;7190053438;Ne;2;1;0;3
15293;Žemuogėlė;KIŠKUČIAI;3726995259;Ne;1;1;0;2
15294;Žemuogėlė;KIŠKUČIAI;6557523361;Ne;0;1;0;1
15295;Žemuogėlė;KIŠKUČIAI;9153455673;Ne;16;0;0;16
15296;Žemuogėlė;KIŠKUČIAI;2091617436;Ne;13;1;2;16
15297;Žemuogėlė;KIŠKUČIAI;9501717210;Ne;13;1;2;16
15298;Žemuogėlė;KIŠKUČIAI;6901260056;Ne;6;0;0;6
15299;Žemuogėlė;KIŠKUČIAI;7263992351;Ne;10;2;0;12
15300;Žemuogėlė;KIŠKUČIAI;7508582586;Ne;0;6;0;6
15301;Žemuogėlė;Žiniukai;1306065826;Ne;0;6;0;6
15302;Žemuogėlė;Žiniukai;8106709288;Ne;0;4;0;4
15303;Žemuogėlė;Žiniukai;2664267604;Ne;0;4;0;4
15304;Žemuogėlė;Žiniukai;1060986850;Ne;0;1;0;1
15305;Žemuogėlė;Žiniukai;9150335499;Taip;4;5;0;9
15306;Žemuogėlė;Žiniukai;7794377881;Ne;6;4;0;10
15307;Žemuogėlė;Žiniukai;1658954821;Ne;5;6;0;11
15308;Žemuogėlė;Žiniukai;1079114347;Ne;6;3;0;9
15309;Žemuogėlė;Žiniukai;5902241163;Ne;4;5;0;9
15310;Žemuogėlė;Žiniukai;7879519193;Taip;3;10;0;13
15311;Žemuogėlė;Žiniukai;2922827304;Ne;2;6;0;8
15312;Žemuogėlė;Žiniukai;2109195565;Ne;0;6;0;6
15313;Žemuogėlė;Žiniukai;7415364637;Ne;10;5;0;15
15314;Žemuogėlė;Žiniukai;3710681463;Ne;3;3;0;6
15315;Žemuogėlė;Žiniukai;1796489729;Ne;5;5;0;10
15316;Žemuogėlė;Žiniukai;8215763877;Ne;6;6;0;12
15317;Žemuogėlė;Žiniukai;2934225120;Taip;5;6;0;11
15318;Žemuogėlė;Žiniukai;3426685084;Ne;1;6;0;7
15319;Žibutė;PELĖDŽIUKAI;3777544301;Ne;0;4;1;5
15320;Žibutė;PELĖDŽIUKAI;1362419302;Ne;1;4;0;5
15321;Žibutė;PELĖDŽIUKAI;9634311146;Ne;0;4;0;4
15322;Žibutė;PELĖDŽIUKAI;5677389434;Ne;2;4;0;6
15323;Žibutė;PELĖDŽIUKAI;5416015554;Ne;0;4;4;8
15324;Žibutė;PELĖDŽIUKAI;1366469428;Taip;0;1;0;1
15325;Žibutė;PELĖDŽIUKAI;4825064521;Ne;6;1;1;8
15326;Žibutė;PELĖDŽIUKAI;5826523148;Ne;4;4;0;8
15327;Žibutė;PELĖDŽIUKAI;7531027545;Ne;0;4;2;6
15328;Žibutė;PELĖDŽIUKAI;3957898269;Ne;0;3;0;3
15329;Žibutė;PELĖDŽIUKAI;3645481894;Ne;3;3;0;6
15330;Žibutė;PELĖDŽIUKAI;4382812297;Ne;0;2;0;2
15331;Žibutė;PELĖDŽIUKAI;6074488747;Ne;0;1;0;1
15332;Žibutė;PELĖDŽIUKAI;8880329060;Ne;5;1;0;6
15333;Žibutė;PELĖDŽIUKAI;5591698130;Ne;0;3;0;3
15334;Žibutė;PELĖDŽIUKAI;9868621666;Ne;0;4;1;5
15335;Žibutė;PELĖDŽIUKAI;5009495840;Ne;0;1;0;1
15336;Žibutė;PELĖDŽIUKAI;7136145033;Ne;2;4;0;6
15337;Žibutė;PELĖDŽIUKAI;6978977383;Ne;0;3;0;3
15338;Žibutė;PELĖDŽIUKAI;1004098038;Ne;0;1;0;1
15339;Žibutė;PELĖDŽIUKAI;2880593326;Ne;0;3;0;3
15340;Žibutė;PELĖDŽIUKAI;7479437931;Ne;0;5;0;5
15341;Žibutė;PELĖDŽIUKAI;9498011134;Ne;0;3;0;3
15342;Žibutė;KREGŽDUTĖS;7036454359;Ne;8;0;1;9
15343;Žibutė;KREGŽDUTĖS;3555071718;Ne;5;5;0;10
15344;Žibutė;KREGŽDUTĖS;5412917352;Ne;2;2;0;4
15345;Žibutė;KREGŽDUTĖS;5190377896;Ne;5;6;0;11
15346;Žibutė;KREGŽDUTĖS;6013340521;Ne;0;5;0;5
15347;Žibutė;KREGŽDUTĖS;3574946816;Ne;3;3;0;6
15348;Žibutė;KREGŽDUTĖS;9923687090;Ne;13;5;0;18
15349;Žibutė;KREGŽDUTĖS;4847295068;Ne;17;0;0;17
15350;Žibutė;KREGŽDUTĖS;9700866512;Ne;1;2;0;3
15351;Žibutė;KREGŽDUTĖS;7774532200;Ne;10;5;0;15
15352;Žibutė;KREGŽDUTĖS;2607509585;Ne;3;7;0;10
15353;Žibutė;KREGŽDUTĖS;8944042589;Ne;0;2;0;2
15354;Žibutė;KREGŽDUTĖS;2438980348;Ne;3;4;0;7
15355;Žibutė;KREGŽDUTĖS;9918283923;Ne;2;1;0;3
15356;Žibutė;KREGŽDUTĖS;5126232169;Ne;0;5;0;5
15357;Žibutė;KREGŽDUTĖS;8792292819;Ne;16;0;0;16
15358;Žibutė;KREGŽDUTĖS;7668484415;Ne;0;13;0;13
15359;Žibutė;KREGŽDUTĖS;2516448580;Ne;0;2;2;4
15360;Žibutė;KREGŽDUTĖS;3752375474;Ne;0;2;0;2
15361;Žibutė;KREGŽDUTĖS;8708083787;Ne;3;5;0;8
15362;Žibutė;BORUŽĖLĖS;5430856044;Ne;8;0;0;8
15363;Žibutė;BORUŽĖLĖS;8303166103;Ne;10;0;0;10
15364;Žibutė;BORUŽĖLĖS;4708691611;Ne;16;0;0;16
15365;Žibutė;BORUŽĖLĖS;9116859942;Ne;10;1;0;11
15366;Žibutė;BORUŽĖLĖS;1730975120;Ne;14;0;0;14
15367;Žibutė;BORUŽĖLĖS;9547812966;Ne;16;0;0;16
15368;Žibutė;BORUŽĖLĖS;9563567679;Ne;19;0;0;19
15369;Žibutė;BORUŽĖLĖS;7738606888;Ne;13;0;0;13
15370;Žibutė;BORUŽĖLĖS;6072605005;Ne;8;0;0;8
15371;Žibutė;BORUŽĖLĖS;8423264689;Ne;19;0;0;19
15372;Žibutė;BORUŽĖLĖS;7683703528;Ne;8;0;0;8
15373;Žibutė;BORUŽĖLĖS;5462787553;Ne;9;0;0;9
15374;Žibutė;BORUŽĖLĖS;3258258046;Ne;15;0;0;15
15375;Žibutė;BORUŽĖLĖS;9127784681;Ne;11;0;0;11
15376;Žibutė;BORUŽĖLĖS;6209156111;Ne;8;4;0;12
15377;Žibutė;BITUTĖS;7023683517;Taip;2;0;0;2
15378;Žibutė;BITUTĖS;7853531467;Ne;0;3;0;3
15379;Žibutė;BITUTĖS;3687123871;Ne;4;0;0;4
15380;Žibutė;BITUTĖS;2312717334;Ne;5;4;0;9
15381;Žibutė;BITUTĖS;6361543454;Ne;3;0;0;3
15382;Žibutė;BITUTĖS;1297347740;Ne;0;6;0;6
15383;Žibutė;BITUTĖS;6934760468;Ne;17;0;0;17
15384;Žibutė;BITUTĖS;4455757640;Ne;7;0;0;7
15385;Žibutė;BITUTĖS;8797870379;Ne;0;4;0;4
15386;Žibutė;BITUTĖS;7792267540;Ne;7;4;0;11
15387;Žibutė;BITUTĖS;9221523836;Ne;9;0;0;9
15388;Žibutė;BITUTĖS;3632745935;Ne;0;8;0;8
15389;Žibutė;BITUTĖS;7611641692;Ne;0;7;0;7
15390;Žibutė;BITUTĖS;5112512917;Ne;11;0;0;11
15391;Žibutė;BITUTĖS;8276724226;Ne;5;0;0;5
15392;Žibutė;BITUTĖS;4685356158;Ne;8;0;0;8
15393;Žibutė;BITUTĖS;1515636796;Ne;0;4;0;4
15394;Žibutė;BITUTĖS;7872636200;Ne;1;8;0;9
15395;Žibutė;BITUTĖS;6833179680;Ne;1;4;0;5
15396;Žibutė;BITUTĖS;1614551884;Ne;14;0;0;14
15397;Žibutė;KAČIUKAI;9611892163;Ne;1;4;0;5
15398;Žibutė;KAČIUKAI;1786332689;Ne;1;4;0;5
15399;Žibutė;KAČIUKAI;3618347199;Ne;4;2;0;6
15400;Žibutė;KAČIUKAI;5591970907;Ne;2;4;0;6
15401;Žibutė;KAČIUKAI;7764376193;Ne;8;0;0;8
15402;Žibutė;KAČIUKAI;8879347884;Ne;5;4;0;9
15403;Žibutė;KAČIUKAI;7608622330;Ne;6;0;0;6
15404;Žibutė;KAČIUKAI;5186839413;Ne;1;3;0;4
15405;Žibutė;KAČIUKAI;4278832423;Ne;4;4;0;8
15406;Žibutė;KAČIUKAI;1381488132;Ne;5;0;0;5
15407;Žibutė;KAČIUKAI;2910188022;Ne;1;0;0;1
15408;Žibutė;KAČIUKAI;4622674814;Ne;3;4;0;7
15409;Žibutė;KAČIUKAI;5632520305;Ne;3;0;0;3
15410;Žibutė;KAČIUKAI;7805758264;Ne;7;2;0;9
15411;Žibutė;KAČIUKAI;6672033757;Ne;0;3;0;3
15412;Žibutė;KAČIUKAI;3066580779;Ne;2;0;0;2
15413;Žibutė;KAČIUKAI;7481695788;Ne;5;0;0;5
15414;Žibutė;KAČIUKAI;8640664660;Ne;8;1;0;9
15415;Žibutė;KAČIUKAI;8155327668;Ne;1;5;0;6
15416;Žibutė;KAČIUKAI;2374119662;Ne;0;5;0;5
15417;Žibutė;ZUIKIAI;5326761360;Ne;6;5;0;11
15418;Žibutė;ZUIKIAI;4741505387;Ne;20;0;0;20
15419;Žibutė;ZUIKIAI;2787326978;Ne;10;0;0;10
15420;Žibutė;ZUIKIAI;4787010953;Ne;0;6;0;6
15421;Žibutė;ZUIKIAI;9645026432;Ne;6;7;0;13
15422;Žibutė;ZUIKIAI;3875455223;Ne;0;8;0;8
15423;Žibutė;ZUIKIAI;3449188614;Ne;1;3;0;4
15424;Žibutė;ZUIKIAI;4434623264;Ne;0;4;0;4
15425;Žibutė;ZUIKIAI;9769180056;Ne;0;6;0;6
15426;Žibutė;ZUIKIAI;2013724729;Ne;3;1;0;4
15427;Žibutė;ZUIKIAI;9379539151;Ne;3;4;0;7
15428;Žibutė;ZUIKIAI;6234135622;Ne;6;6;0;12
15429;Žibutė;ZUIKIAI;8585964720;Ne;1;8;0;9
15430;Žibutė;ZUIKIAI;9793570682;Ne;15;0;0;15
15431;Žibutė;ZUIKIAI;6618315401;Ne;14;0;0;14
15432;Žibutė;ZUIKIAI;6290821274;Ne;18;0;0;18
15433;Žibutė;ZUIKIAI;5045628452;Ne;0;11;0;11
15434;Žiedas;Bitutės;8208331527;Ne;0;7;0;7
15435;Žiedas;Bitutės;9140396365;Ne;0;2;0;2
15436;Žiedas;Bitutės;8148831014;Ne;2;4;0;6
15437;Žiedas;Bitutės;3230107921;Ne;0;5;0;5
15438;Žiedas;Bitutės;3178778438;Ne;0;8;0;8
15439;Žiedas;Bitutės;9602083568;Ne;8;4;0;12
15440;Žiedas;Bitutės;5061575884;Ne;3;4;0;7
15441;Žiedas;Bitutės;5628720422;Ne;3;7;0;10
15442;Žiedas;Bitutės;1582961378;Ne;2;1;0;3
15443;Žiedas;Bitutės;9020540780;Ne;1;1;0;2
15444;Žiedas;Bitutės;1878050384;Ne;0;3;0;3
15445;Žiedas;Bitutės;5578227349;Ne;1;6;0;7
15446;Žiedas;Bitutės;6914059680;Ne;0;8;0;8
15447;Žiedas;Bitutės;6515510381;Ne;8;3;0;11
15448;Žiedas;Bitutės;3842589827;Ne;5;3;0;8
15449;Žiedas;Bitutės;1043230748;Ne;0;4;0;4
15450;Žiedas;Bitutės;5835309107;Ne;10;4;0;14
15451;Žiedas;Bitutės;3387263016;Ne;3;6;0;9
15452;Žiedas;Bitutės;3178580610;Ne;5;6;0;11
15453;Žiedas;Varpeliai;2320543511;Ne;0;5;0;5
15454;Žiedas;Varpeliai;4699833757;Ne;0;3;0;3
15455;Žiedas;Varpeliai;8861734370;Taip;0;5;0;5
15456;Žiedas;Varpeliai;7780469974;Ne;0;5;0;5
15457;Žiedas;Varpeliai;4360175072;Ne;0;4;1;5
15458;Žiedas;Varpeliai;2149342412;Ne;0;1;0;1
15459;Žiedas;Varpeliai;1086714229;Ne;9;7;0;16
15460;Žiedas;Varpeliai;3051211643;Ne;7;4;0;11
15461;Žiedas;Varpeliai;8558784843;Ne;0;1;0;1
15462;Žiedas;Varpeliai;7445583512;Ne;0;7;0;7
15463;Žiedas;Varpeliai;1910079515;Ne;0;5;0;5
15464;Žiedas;Varpeliai;2714272604;Ne;5;4;1;10
15465;Žiedas;Varpeliai;8539301771;Ne;0;5;1;6
15466;Žiedas;Varpeliai;5108873389;Ne;19;0;0;19
15467;Žiedas;Varpeliai;2321239854;Ne;4;6;0;10
15468;Žiedas;Varpeliai;2680021778;Ne;0;3;0;3
15469;Žiedas;Varpeliai;9012779767;Ne;6;4;0;10
15470;Žiedas;Varpeliai;9400503719;Ne;0;5;0;5
15471;Žiedas;Varpeliai;2684888407;Ne;19;0;0;19
15472;Žiedas;Varpeliai;2884725931;Ne;19;0;0;19
15473;Žiedas;Ramunėlės;3055218791;Ne;0;6;0;6
15474;Žiedas;Ramunėlės;1333555044;Ne;8;4;0;12
15475;Žiedas;Ramunėlės;5789261620;Ne;0;2;0;2
15476;Žiedas;Ramunėlės;5577339739;Ne;10;4;0;14
15477;Žiedas;Ramunėlės;6884933845;Ne;5;5;0;10
15478;Žiedas;Ramunėlės;1659873036;Ne;2;6;0;8
15479;Žiedas;Ramunėlės;1243169901;Taip;13;0;0;13
15480;Žiedas;Ramunėlės;1580781723;Ne;0;4;0;4
15481;Žiedas;Ramunėlės;5920211041;Ne;0;3;0;3
15482;Žiedas;Ramunėlės;4933650089;Ne;3;5;0;8
15483;Žiedas;Ramunėlės;4044156905;Ne;0;8;0;8
15484;Žiedas;Ramunėlės;4844442247;Ne;7;6;0;13
15485;Žiedas;Ramunėlės;7294671324;Taip;0;6;0;6
15486;Žiedas;Ramunėlės;8415686253;Ne;6;4;0;10
15487;Žiedas;Ramunėlės;1309242930;Ne;0;2;0;2
15488;Žiedas;Ramunėlės;8797245208;Ne;0;3;0;3
15489;Žiedas;Ramunėlės;5635958124;Ne;2;6;0;8
15490;Žiedas;Ramunėlės;9337317396;Ne;1;4;0;5
15491;Žiedas;Ramunėlės;2320411618;Ne;4;5;0;9
15492;Žiedas;Ramunėlės;1184578906;Ne;3;3;0;6
15493;Žiedas;Pakalnutės;7798930533;Ne;0;7;0;7
15494;Žiedas;Pakalnutės;1094506858;Ne;3;4;0;7
15495;Žiedas;Pakalnutės;9375048835;Ne;4;6;0;10
15496;Žiedas;Pakalnutės;5266048033;Ne;0;10;0;10
15497;Žiedas;Pakalnutės;5804334198;Ne;0;4;2;6
15498;Žiedas;Pakalnutės;1721956438;Ne;0;7;0;7
15499;Žiedas;Pakalnutės;4808020243;Ne;0;6;0;6
15500;Žiedas;Pakalnutės;3742949697;Ne;0;3;0;3
15501;Žiedas;Pakalnutės;6343634478;Ne;2;4;0;6
15502;Žiedas;Pakalnutės;8015880569;Ne;0;1;0;1
15503;Žiedas;Pakalnutės;8857150598;Ne;8;4;0;12
15504;Žiedas;Pakalnutės;2416234016;Ne;0;4;0;4
15505;Žiedas;Pakalnutės;9054709268;Ne;3;7;0;10
15506;Žiedas;Pakalnutės;9964883646;Ne;0;1;0;1
15507;Žiedas;Pakalnutės;4917324037;Ne;2;3;0;5
15508;Žiedas;Pakalnutės;4021189767;Ne;1;2;0;3
15509;Žiedas;Pakalnutės;1346658299;Ne;0;5;0;5
15510;Žiedas;Pakalnutės;4663390744;Ne;0;3;0;3
15511;Žiedas;Pakalnutės;4697477761;Ne;0;4;0;4
15512;Žiedas;Pakalnutės;7678333395;Ne;5;5;0;10
15513;Žiedas;Pakalnutės;9207945616;Ne;0;5;0;5
15514;Žiedas;Pakalnutės;7221702677;Ne;4;6;0;10
15515;Žiedas;Pakalnutės;2393112381;Ne;0;6;0;6
15516;Žiedas;Rožytės;8846443535;Ne;0;8;0;8
15517;Žiedas;Rožytės;7799489700;Ne;9;7;0;16
15518;Žiedas;Rožytės;8927034492;Ne;0;19;0;19
15519;Žiedas;Rožytės;1777501190;Ne;1;2;0;3
15520;Žiedas;Rožytės;1844621525;Ne;0;5;0;5
15521;Žiedas;Rožytės;6459679214;Ne;10;8;0;18
15522;Žiedas;Rožytės;5987689515;Ne;10;4;0;14
15523;Žiedas;Rožytės;1035854293;Ne;2;4;2;8
15524;Žiedas;Rožytės;7584712202;Ne;7;5;0;12
15525;Žiedas;Rožytės;2642760082;Ne;0;7;0;7
15526;Žiedas;Rožytės;1917085385;Ne;0;3;0;3
15527;Žiedas;Rožytės;3099608553;Ne;10;6;0;16
15528;Žiedas;Rožytės;7228139235;Ne;10;4;0;14
15529;Žiedas;Rožytės;1975718197;Ne;0;3;1;4
15530;Žiedas;Rožytės;2312361963;Ne;8;6;0;14
15531;Žiedas;Rožytės;6859410675;Ne;11;4;0;15
15532;Žiedas;Rožytės;1390431397;Ne;0;1;1;2
15533;Žiedas;Rožytės;3490370918;Ne;2;8;0;10
15534;Žiedas;Rožytės;9183582003;Ne;2;8;0;10
15535;Žiedas;Pumpurėliai;1631534238;Ne;10;4;0;14
15536;Žiedas;Pumpurėliai;3994387532;Ne;15;4;0;19
15537;Žiedas;Pumpurėliai;5862164657;Ne;1;5;0;6
15538;Žiedas;Pumpurėliai;9143843408;Ne;1;4;0;5
15539;Žiedas;Pumpurėliai;9833875402;Ne;10;5;0;15
15540;Žiedas;Pumpurėliai;8336518449;Ne;15;4;0;19
15541;Žiedas;Pumpurėliai;8112164640;Ne;0;1;0;1
15542;Žiedas;Pumpurėliai;8592046023;Ne;6;5;0;11
15543;Žiedas;Pumpurėliai;9537901302;Ne;10;4;0;14
15544;Žiedas;Pumpurėliai;1980594198;Ne;19;0;0;19
15545;Žiedas;Pumpurėliai;5814371567;Ne;15;1;0;16
15546;Žiedas;Pumpurėliai;4854055565;Ne;0;5;0;5
15547;Žiedas;Pumpurėliai;7314459335;Taip;10;5;0;15
15548;Žiedas;Pumpurėliai;3075660919;Ne;1;4;0;5
15549;Žiedas;Pumpurėliai;7801566777;Ne;19;0;0;19
15550;Žiedas;Pumpurėliai;6543036900;Ne;10;0;0;10
15551;Žiedas;Pumpurėliai;3682750815;Ne;9;4;0;13
15552;Žiedas;Pumpurėliai;2013485224;Ne;2;1;0;3
15553;Žiedas;"Dobiliukai ";6066566242;Ne;10;4;0;14
15554;Žiedas;"Dobiliukai ";8436592169;Ne;0;6;1;7
15555;Žiedas;"Dobiliukai ";3654878543;Ne;4;4;0;8
15556;Žiedas;"Dobiliukai ";8794003030;Ne;0;1;0;1
15557;Žiedas;"Dobiliukai ";8444690698;Ne;6;4;3;13
15558;Žiedas;"Dobiliukai ";2715554681;Ne;5;2;0;7
15559;Žiedas;"Dobiliukai ";2132564079;Ne;5;4;0;9
15560;Žiedas;"Dobiliukai ";9586578606;Taip;0;7;0;7
15561;Žiedas;"Dobiliukai ";3940002957;Taip;4;4;0;8
15562;Žiedas;"Dobiliukai ";5353507617;Ne;7;6;1;14
15563;Žiedas;"Dobiliukai ";1610219365;Ne;0;5;0;5
15564;Žiedas;"Dobiliukai ";2794691006;Ne;0;6;0;6
15565;Žiedas;"Dobiliukai ";6665199013;Ne;0;2;0;2
15566;Žiedas;"Dobiliukai ";1852347789;Ne;0;4;0;4
15567;Žiedas;"Dobiliukai ";3284907486;Ne;0;4;0;4
15568;Žiedas;"Dobiliukai ";2633676360;Ne;6;4;3;13
15569;Žiedas;"Dobiliukai ";7677595571;Ne;0;6;3;9
15570;Žiedas;"Dobiliukai ";5106427067;Taip;5;5;0;10
15571;Žiedas;"Dobiliukai ";2182340305;Taip;7;4;0;11
15572;Žiedas;"Dobiliukai ";2402512731;Ne;12;3;0;15
15573;Žiedas;RŪTELĖS;1885623466;Ne;5;6;0;11
15574;Žiedas;RŪTELĖS;9464217926;Ne;0;5;0;5
15575;Žiedas;RŪTELĖS;9543860953;Ne;5;4;0;9
15576;Žiedas;RŪTELĖS;3247328978;Ne;5;4;0;9
15577;Žiedas;RŪTELĖS;4250009129;Ne;0;4;0;4
15578;Žiedas;RŪTELĖS;7399937598;Ne;0;5;0;5
15579;Žiedas;RŪTELĖS;1325715061;Ne;0;3;0;3
15580;Žiedas;RŪTELĖS;9111149805;Ne;0;4;0;4
15581;Žiedas;RŪTELĖS;4695900874;Ne;0;4;0;4
15582;Žiedas;RŪTELĖS;3258241663;Ne;0;5;0;5
15583;Žiedas;RŪTELĖS;6700593422;Ne;19;0;0;19
15584;Žiedas;RŪTELĖS;6245366671;Ne;0;6;0;6
15585;Žiedas;RŪTELĖS;3835714894;Ne;0;8;0;8
15586;Žiedas;RŪTELĖS;7535993061;Ne;8;1;0;9
15587;Žiedas;RŪTELĖS;1956219718;Ne;0;3;0;3
15588;Žiedas;RŪTELĖS;4809093267;Ne;0;9;0;9
15589;Žiedas;RŪTELĖS;6856477482;Ne;5;6;0;11
15590;Žiedas;RŪTELĖS;1874460511;Ne;0;10;0;10
15591;Žiedas;RŪTELĖS;7150427502;Ne;5;5;0;10
15592;Žiedas;RŪTELĖS;1562699898;Ne;5;3;0;8
15593;Žiedas;RŪTELĖS;6312115234;Ne;3;0;1;4
15594;Žiedas;RŪTELĖS;3831917542;Ne;6;4;0;10
15595;Žiedas;RŪTELĖS;1669599543;Taip;6;4;0;10
15596;Žiedas;SAULĖGRĄŽOS;1011602827;Ne;0;6;2;8
15597;Žiedas;SAULĖGRĄŽOS;8887021328;Ne;0;2;0;2
15598;Žiedas;SAULĖGRĄŽOS;2932857132;Ne;0;4;2;6
15599;Žiedas;SAULĖGRĄŽOS;5552786845;Ne;0;13;0;13
15600;Žiedas;SAULĖGRĄŽOS;8833895006;Ne;0;5;0;5
15601;Žiedas;SAULĖGRĄŽOS;5658235821;Ne;2;2;0;4
15602;Žiedas;SAULĖGRĄŽOS;4992446383;Ne;0;2;0;2
15603;Žiedas;SAULĖGRĄŽOS;9057761408;Ne;0;2;0;2
15604;Žiedas;SAULĖGRĄŽOS;1645402434;Ne;3;1;0;4
15605;Žiedas;SAULĖGRĄŽOS;2026540724;Ne;0;5;0;5
15606;Žiedas;SAULĖGRĄŽOS;4564268323;Ne;0;3;0;3
15607;Žiedas;SAULĖGRĄŽOS;8801900486;Ne;0;5;0;5
15608;Žiedas;SAULĖGRĄŽOS;1609487830;Ne;0;4;0;4
15609;Žiedas;SAULĖGRĄŽOS;3437651010;Ne;0;6;0;6
15610;Žiedas;SAULĖGRĄŽOS;3422053505;Ne;0;14;0;14
15611;Žiedas;SAULĖGRĄŽOS;5274845525;Ne;0;9;0;9
15612;Žiedas;SAULĖGRĄŽOS;6053010050;Ne;0;2;0;2
15613;Žiedas;SAULĖGRĄŽOS;7057747531;Ne;0;4;0;4
15614;Žiedas;SAULĖGRĄŽOS;8819018248;Ne;0;5;0;5
15615;Žiedas;SAULĖGRĄŽOS;7604200899;Ne;0;4;0;4
15616;Žiedas;SAULĖGRĄŽOS;3303581707;Ne;0;3;0;3
15617;Žiedas;SAULĖGRĄŽOS;2134466899;Ne;2;3;0;5
15618;Žiedas;SAULĖGRĄŽOS;6822887260;Ne;0;9;0;9
15619;Žiedas;SAULĖGRĄŽOS;1253833615;Ne;0;2;0;2
15620;Žiedas;SAULĖGRĄŽOS;7172793351;Ne;0;3;0;3
15621;Žiedas;RUGIAGĖLĖS;1826599535;Ne;5;5;0;10
15622;Žiedas;RUGIAGĖLĖS;3477341028;Ne;0;10;0;10
15623;Žiedas;RUGIAGĖLĖS;2124086277;Ne;6;4;0;10
15624;Žiedas;RUGIAGĖLĖS;1093479755;Ne;10;4;0;14
15625;Žiedas;RUGIAGĖLĖS;7381658912;Ne;10;5;0;15
15626;Žiedas;RUGIAGĖLĖS;2148027253;Taip;14;4;0;18
15627;Žiedas;RUGIAGĖLĖS;1758868055;Ne;0;4;0;4
15628;Žiedas;RUGIAGĖLĖS;1958481432;Ne;0;1;0;1
15629;Žiedas;RUGIAGĖLĖS;9393499257;Ne;0;6;0;6
15630;Žiedas;RUGIAGĖLĖS;8276022676;Taip;9;4;0;13
15631;Žiedas;RUGIAGĖLĖS;7418985667;Ne;10;3;0;13
15632;Žiedas;RUGIAGĖLĖS;6766710113;Ne;10;6;0;16
15633;Žiedas;RUGIAGĖLĖS;1835893385;Ne;10;5;0;15
15634;Žiedas;RUGIAGĖLĖS;3654749109;Ne;0;7;0;7
15635;Žiedas;RUGIAGĖLĖS;2913328259;Ne;7;5;0;12
15636;Žiedas;RUGIAGĖLĖS;4568189195;Ne;8;3;0;11
15637;Žiedas;RUGIAGĖLĖS;7114207461;Ne;7;6;0;13
15638;Žiedas;RUGIAGĖLĖS;3407247493;Ne;5;4;0;9
15639;Žiedas;RUGIAGĖLĖS;6923562927;Taip;5;4;0;9
15640;Žiedas;RUGIAGĖLĖS;1509140770;Ne;0;4;0;4
15641;Žiedas;RUGIAGĖLĖS;7498211984;Ne;5;5;0;10
15642;Žiedas;RUGIAGĖLĖS;3948942801;Ne;5;6;0;11
15643;Žiedas;RUGIAGĖLĖS;7441475685;Ne;12;4;0;16
15644;Žiedas;Boružėlės;9685152753;Ne;3;2;2;7
15645;Žiedas;Boružėlės;9218388800;Ne;0;6;0;6
15646;Žiedas;Boružėlės;5420327672;Ne;0;4;0;4
15647;Žiedas;Boružėlės;9352485926;Ne;11;4;0;15
15648;Žiedas;Boružėlės;5914428064;Ne;3;5;0;8
15649;Žiedas;Boružėlės;3857121753;Ne;5;6;0;11
15650;Žiedas;Boružėlės;6443633568;Ne;5;5;0;10
15651;Žiedas;Boružėlės;7491134119;Ne;2;4;0;6
15652;Žiedas;Boružėlės;5959899914;Ne;0;9;0;9
15653;Žiedas;Boružėlės;7333813704;Ne;0;1;0;1
15654;Žiedas;Boružėlės;3715928992;Ne;0;3;0;3
15655;Žiedas;Boružėlės;6658762922;Ne;0;5;0;5
15656;Žiedas;Boružėlės;5703750436;Ne;0;5;0;5
15657;Žiedas;Boružėlės;7578964555;Ne;0;2;0;2
15658;Žiedas;Boružėlės;5928377774;Ne;0;4;2;6
15659;Žiedas;Boružėlės;5126173608;Ne;5;5;0;10
15660;Žiedas;Boružėlės;7072578987;Ne;12;4;1;17
15661;Žiedas;Boružėlės;5647232875;Ne;0;4;0;4
15662;Žiedas;Boružėlės;4497634040;Ne;0;3;1;4
15663;Žiedas;Boružėlės;1738121071;Ne;0;5;0;5
15664;Žiedas;AGUONĖLĖS;5518670127;Ne;6;6;0;12
15665;Žiedas;AGUONĖLĖS;2846835865;Ne;4;3;0;7
15666;Žiedas;AGUONĖLĖS;6162306565;Ne;0;4;2;6
15667;Žiedas;AGUONĖLĖS;5211681615;Ne;5;4;0;9
15668;Žiedas;AGUONĖLĖS;5947851166;Ne;2;6;0;8
15669;Žiedas;AGUONĖLĖS;8978215481;Ne;9;4;0;13
15670;Žiedas;AGUONĖLĖS;7159730702;Ne;6;4;1;11
15671;Žiedas;AGUONĖLĖS;8485801027;Ne;5;4;1;10
15672;Žiedas;AGUONĖLĖS;3634949279;Ne;8;5;0;13
15673;Žiedas;AGUONĖLĖS;1147121060;Ne;5;4;0;9
15674;Žiedas;AGUONĖLĖS;5789381608;Ne;5;5;0;10
15675;Žiedas;AGUONĖLĖS;6635256945;Ne;11;3;0;14
15676;Žiedas;AGUONĖLĖS;1642330461;Ne;10;4;1;15
15677;Žiedas;AGUONĖLĖS;7161235417;Ne;0;2;0;2
15678;Žiedas;AGUONĖLĖS;5177625346;Ne;10;4;2;16
15679;Žiedas;AGUONĖLĖS;4914111970;Ne;10;5;0;15
15680;Žiedas;AGUONĖLĖS;6813477102;Ne;9;7;0;16
15681;Žiedas;ŽIBUTĖS;8638720939;Ne;1;6;0;7
15682;Žiedas;ŽIBUTĖS;4039958043;Ne;0;4;1;5
15683;Žiedas;ŽIBUTĖS;9269909624;Ne;0;5;0;5
15684;Žiedas;ŽIBUTĖS;8084555994;Ne;0;5;0;5
15685;Žiedas;ŽIBUTĖS;2935037966;Ne;0;5;0;5
15686;Žiedas;ŽIBUTĖS;6340071454;Ne;7;4;0;11
15687;Žiedas;ŽIBUTĖS;6248399763;Ne;0;3;0;3
15688;Žiedas;ŽIBUTĖS;8163426046;Ne;5;3;0;8
15689;Žiedas;ŽIBUTĖS;4530564746;Ne;0;4;0;4
15690;Žiedas;ŽIBUTĖS;1546447912;Ne;0;2;0;2
15691;Žiedas;ŽIBUTĖS;9202969623;Ne;4;5;0;9
15692;Žiedas;ŽIBUTĖS;3488618084;Ne;3;4;2;9
15693;Žiedas;ŽIBUTĖS;8162441626;Ne;0;4;1;5
15694;Žiedas;ŽIBUTĖS;8651843785;Ne;5;6;0;11
15695;Žiedas;ŽIBUTĖS;2853498452;Ne;3;5;0;8
15696;Žiedas;ŽIBUTĖS;9834096834;Ne;4;4;1;9
15697;Žiedas;DRUGELIAI;9763704573;Ne;15;4;0;19
15698;Žiedas;DRUGELIAI;5028265234;Ne;6;5;0;11
15699;Žiedas;DRUGELIAI;6852487760;Ne;13;4;0;17
15700;Žiedas;DRUGELIAI;8645771800;Ne;9;4;0;13
15701;Žiedas;DRUGELIAI;6041919197;Ne;0;4;0;4
15702;Žiedas;DRUGELIAI;8163645535;Ne;9;4;0;13
15703;Žiedas;DRUGELIAI;2182381160;Ne;0;3;0;3
15704;Žiedas;DRUGELIAI;8822472312;Ne;0;6;0;6
15705;Žiedas;DRUGELIAI;9021286246;Ne;2;3;0;5
15706;Žiedas;DRUGELIAI;6261847845;Ne;0;3;0;3
15707;Žiedas;DRUGELIAI;5020148822;Ne;4;4;0;8
15708;Žiedas;DRUGELIAI;1219634640;Ne;1;4;0;5
15709;Žiedas;DRUGELIAI;2170318597;Ne;0;4;0;4
15710;Žiedas;DRUGELIAI;1333233100;Ne;9;3;0;12
15711;Žiogelis;SKRUZDELYTĖS;2959983278;Ne;4;2;0;6
15712;Žiogelis;SKRUZDELYTĖS;4677024422;Ne;2;0;0;2
15713;Žiogelis;SKRUZDELYTĖS;6165380986;Ne;4;0;0;4
15714;Žiogelis;SKRUZDELYTĖS;5281321968;Ne;5;0;0;5
15715;Žiogelis;SKRUZDELYTĖS;8410428124;Ne;6;0;0;6
15716;Žiogelis;SKRUZDELYTĖS;3214640817;Ne;16;0;0;16
15717;Žiogelis;SKRUZDELYTĖS;1937740173;Ne;3;2;0;5
15718;Žiogelis;SKRUZDELYTĖS;4115425880;Ne;0;1;0;1
15719;Žiogelis;SKRUZDELYTĖS;5737326104;Ne;8;1;0;9
15720;Žiogelis;SKRUZDELYTĖS;2614574694;Ne;0;4;0;4
15721;Žiogelis;SKRUZDELYTĖS;7107814348;Ne;5;7;0;12
15722;Žiogelis;SKRUZDELYTĖS;7395901559;Ne;0;7;0;7
15723;Žiogelis;SKRUZDELYTĖS;9819352425;Ne;8;0;0;8
15724;Žiogelis;SKRUZDELYTĖS;8780773039;Ne;13;1;0;14
15725;Žiogelis;SKRUZDELYTĖS;7881734492;Ne;1;0;0;1
15726;Žiogelis;SKRUZDELYTĖS;2701091043;Ne;5;1;0;6
15727;Žiogelis;SKRUZDELYTĖS;9120836406;Ne;13;0;0;13
15728;Žiogelis;SKRUZDELYTĖS;6742462116;Ne;11;0;0;11
15729;Žiogelis;SKRUZDELYTĖS;6608146625;Ne;8;0;0;8
15730;Žiogelis;SKRUZDELYTĖS;9035254979;Ne;13;0;0;13
15731;Žiogelis;SKRUZDELYTĖS;8682279246;Ne;9;0;0;9
15732;Žiogelis;ŽIRNIUKAI;9769735869;Ne;3;2;0;5
15733;Žiogelis;ŽIRNIUKAI;1106149118;Ne;4;4;0;8
15734;Žiogelis;ŽIRNIUKAI;9737574835;Ne;0;2;0;2
15735;Žiogelis;ŽIRNIUKAI;6284764694;Ne;0;4;0;4
15736;Žiogelis;ŽIRNIUKAI;9842311161;Ne;3;4;0;7
15737;Žiogelis;ŽIRNIUKAI;2036243422;Ne;9;2;0;11
15738;Žiogelis;ŽIRNIUKAI;9634291623;Ne;6;2;0;8
15739;Žiogelis;ŽIRNIUKAI;6491130711;Ne;2;0;1;3
15740;Žiogelis;ŽIRNIUKAI;9378236361;Ne;12;0;0;12
15741;Žiogelis;ŽIRNIUKAI;5445409452;Ne;12;0;0;12
15742;Žiogelis;ŽIRNIUKAI;4155916507;Ne;4;1;0;5
15743;Žiogelis;ŽIRNIUKAI;4623532521;Ne;4;0;0;4
15744;Žiogelis;ŽIRNIUKAI;6988180082;Ne;12;0;0;12
15745;Žiogelis;ŽIRNIUKAI;4677227753;Ne;12;0;0;12
15746;Žiogelis;ŽIRNIUKAI;5996045442;Ne;4;4;0;8
15747;Žiogelis;ŽIRNIUKAI;5527793395;Ne;6;4;0;10
15748;Žiogelis;ŽIRNIUKAI;4974459437;Ne;12;2;0;14
15749;Žiogelis;ŽIRNIUKAI;8664568879;Ne;3;4;0;7
15750;Žiogelis;ŽIRNIUKAI;9941105459;Ne;5;6;0;11
15751;Žiogelis;ŽIRNIUKAI;3199884855;Ne;16;0;0;16
15752;Žiogelis;ŽIRNIUKAI;5245672298;Ne;14;2;0;16
15753;Žiogelis;ŽIRNIUKAI;7804701635;Ne;5;0;0;5
15754;Žiogelis;DOBILĖLIAI;8485067381;Ne;4;0;0;4
15755;Žiogelis;DOBILĖLIAI;1618384759;Ne;0;4;0;4
15756;Žiogelis;DOBILĖLIAI;5054228916;Ne;5;0;0;5
15757;Žiogelis;DOBILĖLIAI;8712788346;Ne;19;0;0;19
15758;Žiogelis;DOBILĖLIAI;3428197871;Ne;0;2;0;2
15759;Žiogelis;DOBILĖLIAI;7535167450;Ne;4;0;0;4
15760;Žiogelis;DOBILĖLIAI;3361421852;Ne;5;4;0;9
15761;Žiogelis;DOBILĖLIAI;1268908081;Ne;0;4;0;4
15762;Žiogelis;DOBILĖLIAI;3856321373;Ne;10;2;0;12
15763;Žiogelis;DOBILĖLIAI;6378295945;Ne;14;1;0;15
15764;Žiogelis;DOBILĖLIAI;8959934210;Ne;2;1;0;3
15765;Žiogelis;DOBILĖLIAI;8591680136;Ne;0;4;0;4
15766;Žiogelis;DOBILĖLIAI;6980853713;Ne;4;0;0;4
15767;Žiogelis;DOBILĖLIAI;7340918175;Ne;3;2;0;5
15768;Žiogelis;DOBILĖLIAI;5454676924;Ne;6;0;0;6
15769;Žiogelis;DOBILĖLIAI;5487213418;Ne;0;3;0;3
15770;Žiogelis;DOBILĖLIAI;8058231095;Ne;12;0;0;12
15771;Žiogelis;DOBILĖLIAI;6593794147;Ne;2;0;0;2
15772;Žiogelis;DOBILĖLIAI;1650284820;Ne;2;0;0;2
15773;Žiogelis;DOBILĖLIAI;6515890056;Ne;0;4;0;4
15774;Žiogelis;DOBILĖLIAI;7310459638;Ne;5;1;0;6
15775;Žiogelis;DOBILĖLIAI;1763603533;Ne;13;0;0;13
15776;Žiogelis;DOBILĖLIAI;9813150014;Ne;0;5;0;5
15777;Žiogelis;BORUŽĖLĖS;8683148826;Ne;10;4;0;14
15778;Žiogelis;BORUŽĖLĖS;6532218580;Ne;1;3;0;4
15779;Žiogelis;BORUŽĖLĖS;1763070523;Ne;0;5;0;5
15780;Žiogelis;BORUŽĖLĖS;3308563362;Ne;1;3;0;4
15781;Žiogelis;BORUŽĖLĖS;2117192553;Ne;1;1;0;2
15782;Žiogelis;BORUŽĖLĖS;3427704550;Ne;1;3;0;4
15783;Žiogelis;BORUŽĖLĖS;5911231906;Ne;0;1;0;1
15784;Žiogelis;BORUŽĖLĖS;1190395481;Ne;0;4;0;4
15785;Žiogelis;BORUŽĖLĖS;6115834138;Ne;0;4;0;4
15786;Žiogelis;BORUŽĖLĖS;1465027680;Ne;3;2;0;5
15787;Žiogelis;BORUŽĖLĖS;4103035195;Ne;0;3;0;3
15788;Žiogelis;BORUŽĖLĖS;3392582853;Ne;0;4;0;4
15789;Žiogelis;BORUŽĖLĖS;5557800297;Ne;0;4;0;4
15790;Žiogelis;BORUŽĖLĖS;6495456608;Ne;4;4;0;8
15791;Žiogelis;BORUŽĖLĖS;5364996984;Ne;0;2;0;2
15792;Žiogelis;BORUŽĖLĖS;9568208184;Ne;0;2;0;2
15793;Žiogelis;BORUŽĖLĖS;7065052244;Ne;0;4;0;4
15794;Žiogelis;BORUŽĖLĖS;6340620973;Ne;0;5;0;5
15795;Žiogelis;BORUŽĖLĖS;5961630249;Ne;0;1;0;1
15796;Žiogelis;BORUŽĖLĖS;3887222613;Ne;3;2;0;5
15797;Žiogelis;BORUŽĖLĖS;9610249055;Ne;0;4;0;4
15798;Žiogelis;BORUŽĖLĖS;3686409773;Ne;3;4;0;7
15799;Žiogelis;BORUŽĖLĖS;2122392982;Ne;5;4;0;9
15800;Žiogelis;DRUGELIAI;2797078863;Ne;10;0;0;10
15801;Žiogelis;DRUGELIAI;3813592739;Ne;7;0;0;7
15802;Žiogelis;DRUGELIAI;3820406417;Ne;16;0;0;16
15803;Žiogelis;DRUGELIAI;9533670829;Ne;5;0;0;5
15804;Žiogelis;DRUGELIAI;1673279182;Ne;13;2;0;15
15805;Žiogelis;DRUGELIAI;9964121573;Ne;7;4;0;11
15806;Žiogelis;DRUGELIAI;5104952346;Ne;7;0;0;7
15807;Žiogelis;DRUGELIAI;9717527407;Ne;3;0;0;3
15808;Žiogelis;DRUGELIAI;2622354022;Ne;0;5;0;5
15809;Žiogelis;DRUGELIAI;7462316396;Ne;0;7;0;7
15810;Žiogelis;DRUGELIAI;2243541285;Ne;4;4;0;8
15811;Žiogelis;DRUGELIAI;2326799191;Ne;3;0;0;3
15812;Žiogelis;DRUGELIAI;1833992163;Ne;8;4;0;12
15813;Žiogelis;DRUGELIAI;2529171444;Ne;0;1;0;1
15814;Žiogelis;DRUGELIAI;4946802677;Ne;8;0;0;8
15815;Žiogelis;DRUGELIAI;8763533677;Ne;7;0;0;7
15816;Žiogelis;DRUGELIAI;4994053705;Ne;4;4;0;8
15817;Žiogelis;DRUGELIAI;2655049586;Ne;12;0;0;12
15818;Žiogelis;DRUGELIAI;4120627587;Ne;2;3;0;5
15819;Žiogelis;PELĖDŽIUKAI;7128248940;Ne;0;5;0;5
15820;Žiogelis;PELĖDŽIUKAI;6709029770;Ne;0;4;0;4
15821;Žiogelis;PELĖDŽIUKAI;7502572217;Ne;2;5;0;7
15822;Žiogelis;PELĖDŽIUKAI;5876904663;Ne;0;4;0;4
15823;Žiogelis;PELĖDŽIUKAI;8217782981;Ne;5;4;0;9
15824;Žiogelis;PELĖDŽIUKAI;7120126547;Ne;0;3;0;3
15825;Žiogelis;PELĖDŽIUKAI;9387048672;Ne;0;10;0;10
15826;Žiogelis;PELĖDŽIUKAI;4378941619;Ne;0;2;0;2
15827;Žiogelis;PELĖDŽIUKAI;3937261260;Ne;0;4;0;4
15828;Žiogelis;PELĖDŽIUKAI;8873231715;Ne;0;2;0;2
15829;Žiogelis;PELĖDŽIUKAI;8894068297;Ne;0;5;0;5
15830;Žiogelis;PELĖDŽIUKAI;2160862681;Ne;0;4;0;4
15831;Žiogelis;PELĖDŽIUKAI;7725494899;Ne;0;6;0;6
15832;Žiogelis;PELĖDŽIUKAI;1939672072;Ne;0;4;0;4
15833;Žiogelis;PELĖDŽIUKAI;8689074067;Ne;2;5;0;7
15834;Žiogelis;PELĖDŽIUKAI;4565342104;Ne;0;4;0;4
15835;Žiogelis;PELĖDŽIUKAI;1223396469;Ne;5;5;0;10
15836;Žiogelis;PELĖDŽIUKAI;3500076229;Ne;0;19;0;19
15837;Žiogelis;PELĖDŽIUKAI;8715501524;Ne;19;0;0;19
15838;Žiogelis;PELĖDŽIUKAI;6347738933;Ne;9;5;0;14
15839;Žiogelis;PELĖDŽIUKAI;3520393042;Ne;0;1;0;1
15840;Žiogelis;VARPELIAI;8983731310;Ne;5;7;0;12
15841;Žiogelis;VARPELIAI;1954544417;Ne;17;0;0;17
15842;Žiogelis;VARPELIAI;9385596579;Ne;5;5;0;10
15843;Žiogelis;VARPELIAI;1447349850;Ne;6;1;0;7
15844;Žiogelis;VARPELIAI;3752358694;Ne;5;0;0;5
15845;Žiogelis;VARPELIAI;6402784913;Ne;0;5;0;5
15846;Žiogelis;VARPELIAI;4462189852;Ne;10;2;0;12
15847;Žiogelis;VARPELIAI;9470241656;Ne;7;0;0;7
15848;Žiogelis;VARPELIAI;8133583992;Ne;0;6;0;6
15849;Žiogelis;VARPELIAI;2346231162;Ne;13;0;0;13
15850;Žiogelis;VARPELIAI;6658457517;Ne;0;4;0;4
15851;Žiogelis;VARPELIAI;6650891980;Ne;12;0;0;12
15852;Žiogelis;VARPELIAI;5076511003;Ne;4;1;0;5
15853;Žiogelis;VARPELIAI;1139259000;Ne;9;3;0;12
15854;Žiogelis;VARPELIAI;7992701275;Ne;18;0;0;18
15855;Žiogelis;VARPELIAI;2238709964;Ne;16;1;0;17
15856;Žiogelis;VARPELIAI;5288197445;Ne;6;5;0;11
15857;Žiogelis;VARPELIAI;5336455992;Ne;11;4;0;15
15858;Žiogelis;VARPELIAI;9769801670;Ne;12;0;0;12
15859;Žiogelis;VARPELIAI;3606236367;Ne;7;1;0;8
15860;Žiogelis;VARPELIAI;5115094299;Ne;5;0;0;5
15861;Žiogelis;VARPELIAI;6942174644;Ne;0;7;0;7
15862;Žiogelis;VARPELIAI;1647252870;Ne;19;0;0;19
15863;Žiogelis;KREGŽDUTĖS;5042341085;Ne;11;4;0;15
15864;Žiogelis;KREGŽDUTĖS;9766966628;Ne;0;4;0;4
15865;Žiogelis;KREGŽDUTĖS;8835394030;Ne;0;3;0;3
15866;Žiogelis;KREGŽDUTĖS;3752355139;Ne;0;4;0;4
15867;Žiogelis;KREGŽDUTĖS;9627583831;Ne;0;5;0;5
15868;Žiogelis;KREGŽDUTĖS;3296450902;Ne;0;4;0;4
15869;Žiogelis;KREGŽDUTĖS;4814936645;Ne;0;2;0;2
15870;Žiogelis;KREGŽDUTĖS;3792114246;Ne;0;5;0;5
15871;Žiogelis;KREGŽDUTĖS;4645245689;Ne;0;1;0;1
15872;Žiogelis;KREGŽDUTĖS;9981130790;Ne;0;6;0;6
15873;Žiogelis;KREGŽDUTĖS;4605250897;Ne;2;3;0;5
15874;Žiogelis;KREGŽDUTĖS;3820534331;Ne;0;5;0;5
15875;Žiogelis;KREGŽDUTĖS;5139645108;Ne;0;3;0;3
15876;Žiogelis;KREGŽDUTĖS;4630381709;Ne;0;3;0;3
15877;Žiogelis;KREGŽDUTĖS;9790463889;Ne;0;2;0;2
15878;Žiogelis;KREGŽDUTĖS;9874412804;Ne;2;3;0;5
15879;Žiogelis;KREGŽDUTĖS;6024752960;Ne;0;4;0;4
15880;Žiogelis;KREGŽDUTĖS;8853905367;Ne;0;4;0;4
15881;Žiogelis;KREGŽDUTĖS;1397686161;Ne;6;5;0;11
15882;Žiogelis;KREGŽDUTĖS;2171351454;Ne;0;6;0;6
15883;Žiogelis;KREGŽDUTĖS;2173494736;Ne;0;4;0;4
15884;Žiogelis;KREGŽDUTĖS;4156736676;Ne;5;3;0;8
15885;Žiogelis;KREGŽDUTĖS;1134384178;Ne;5;4;0;9
15886;Žiogelis;KREGŽDUTĖS;4609861306;Ne;0;4;0;4
15887;Žiogelis;KREGŽDUTĖS;2759766559;Ne;5;5;0;10
15888;Žiogelis;ŽVIRBLIUKAI;6718866954;Ne;1;0;0;1
15889;Žiogelis;ŽVIRBLIUKAI;9756601090;Ne;5;0;0;5
15890;Žiogelis;ŽVIRBLIUKAI;4708377318;Ne;16;0;0;16
15891;Žiogelis;ŽVIRBLIUKAI;8601929848;Ne;2;0;0;2
15892;Žiogelis;ŽVIRBLIUKAI;2028344962;Ne;4;4;0;8
15893;Žiogelis;ŽVIRBLIUKAI;6925485778;Ne;12;0;0;12
15894;Žiogelis;ŽVIRBLIUKAI;7539495906;Ne;0;4;0;4
15895;Žiogelis;ŽVIRBLIUKAI;2753323641;Ne;9;0;0;9
15896;Žiogelis;ŽVIRBLIUKAI;8067244838;Ne;9;0;0;9
15897;Žiogelis;ŽVIRBLIUKAI;2925961701;Ne;6;0;0;6
15898;Žiogelis;ŽVIRBLIUKAI;1513739055;Ne;4;0;0;4
15899;Žiogelis;ŽVIRBLIUKAI;3407223108;Ne;12;0;0;12
15900;Žiogelis;ŽVIRBLIUKAI;4924536259;Ne;12;0;0;12
15901;Žiogelis;ŽVIRBLIUKAI;1093662117;Ne;10;0;0;10
15902;Žiogelis;ŽVIRBLIUKAI;2540274386;Ne;10;0;0;10
15903;Žiogelis;ŽVIRBLIUKAI;4602474688;Ne;3;0;0;3
15904;Žiogelis;BITUTĖS;5337641310;Ne;3;0;0;3
15905;Žiogelis;BITUTĖS;2771911603;Ne;4;3;0;7
15906;Žiogelis;BITUTĖS;4561384361;Ne;4;1;0;5
15907;Žiogelis;BITUTĖS;6617995346;Ne;10;0;0;10
15908;Žiogelis;BITUTĖS;4755709634;Ne;4;3;0;7
15909;Žiogelis;BITUTĖS;7936785905;Taip;2;2;0;4
15910;Žiogelis;BITUTĖS;2348525913;Ne;14;0;0;14
15911;Žiogelis;BITUTĖS;3628571567;Ne;3;0;0;3
15912;Žiogelis;BITUTĖS;9142952548;Ne;3;4;0;7
15913;Žiogelis;BITUTĖS;4450344120;Ne;3;4;0;7
15914;Žiogelis;BITUTĖS;5223426277;Ne;0;1;0;1
15915;Žiogelis;BITUTĖS;8998694866;Ne;6;0;0;6
15916;Žiogelis;BITUTĖS;3472310047;Ne;0;4;0;4
15917;Žiogelis;BITUTĖS;8018943297;Ne;1;3;0;4
15918;Žiogelis;BITUTĖS;3516143432;Ne;12;0;0;12
15919;Žiogelis;BITUTĖS;2833768296;Ne;3;2;0;5
15920;Žiogelis;BITUTĖS;9918493914;Ne;9;0;0;9
15921;Žiogelis;BITUTĖS;8038242532;Ne;12;0;0;12
15922;Žiogelis;BITUTĖS;2463360858;Ne;0;4;0;4
15923;Žiogelis;BITUTĖS;6857937795;Ne;8;1;0;9
15924;Žiogelis;BITUTĖS;1067136657;Ne;9;0;0;9
15925;Žiogelis;BITUTĖS;9672307977;Ne;4;0;0;4
15926;Žiogelis;BITUTĖS;2799966199;Ne;6;0;0;6
15927;Žiogelis;RIEŠUTĖLIAI;8634114085;Ne;0;2;0;2
15928;Žiogelis;RIEŠUTĖLIAI;6035707604;Ne;7;3;0;10
15929;Žiogelis;RIEŠUTĖLIAI;8743725024;Ne;12;1;0;13
15930;Žiogelis;RIEŠUTĖLIAI;9869864499;Ne;1;0;0;1
15931;Žiogelis;RIEŠUTĖLIAI;8547003106;Ne;0;4;0;4
15932;Žiogelis;RIEŠUTĖLIAI;8652050979;Ne;6;0;0;6
15933;Žiogelis;RIEŠUTĖLIAI;7428779654;Ne;14;0;0;14
15934;Žiogelis;RIEŠUTĖLIAI;3037415668;Ne;14;0;0;14
15935;Žiogelis;RIEŠUTĖLIAI;6470463492;Ne;0;4;0;4
15936;Žiogelis;RIEŠUTĖLIAI;6313053720;Ne;3;0;0;3
15937;Žiogelis;RIEŠUTĖLIAI;5146366874;Ne;18;0;0;18
15938;Žiogelis;RIEŠUTĖLIAI;8135592447;Ne;9;0;0;9
15939;Žiogelis;RIEŠUTĖLIAI;2454569485;Ne;12;0;0;12
15940;Žiogelis;RIEŠUTĖLIAI;1578732378;Ne;0;3;0;3
15941;Žiogelis;RIEŠUTĖLIAI;3242570582;Ne;3;0;0;3
15942;Žiogelis;RIEŠUTĖLIAI;7001506215;Ne;2;0;0;2
15943;Žiogelis;PAKALNUTĖS;9863503924;Ne;1;0;0;1
15944;Žiogelis;PAKALNUTĖS;9144282935;Ne;2;1;0;3
15945;Žiogelis;PAKALNUTĖS;6039409252;Ne;6;1;0;7
15946;Žiogelis;PAKALNUTĖS;2275123126;Ne;3;0;0;3
15947;Žiogelis;PAKALNUTĖS;4587838884;Ne;19;0;0;19
15948;Žiogelis;PAKALNUTĖS;6048534817;Ne;7;0;0;7
15949;Žiogelis;PAKALNUTĖS;5133034709;Ne;4;0;0;4
15950;Žiogelis;PAKALNUTĖS;8303283893;Ne;4;2;0;6
15951;Žiogelis;PAKALNUTĖS;4147132498;Ne;1;0;0;1
15952;Žiogelis;PAKALNUTĖS;2724389716;Ne;3;0;0;3
15953;Žiogelis;PAKALNUTĖS;7763941077;Ne;3;0;0;3
15954;Žiogelis;PAKALNUTĖS;7008807839;Ne;8;0;0;8
15955;Žiogelis;PAKALNUTĖS;2518015116;Ne;3;2;0;5
15956;Žiogelis;PAKALNUTĖS;5984496369;Ne;8;0;0;8
15957;Žiogelis;PAKALNUTĖS;5475797764;Ne;5;0;0;5
15958;Žiogelis;PAKALNUTĖS;4376301940;Ne;3;0;0;3
15959;Žiogelis;PAKALNUTĖS;2177479618;Ne;13;0;0;13
15960;Žiogelis;PAKALNUTĖS;6213118462;Ne;3;0;0;3
15961;Žolynėlis;Spanguolėlė;8810441600;Ne;0;15;0;15
15962;Žolynėlis;Spanguolėlė;6440991320;Ne;0;4;0;4
15963;Žolynėlis;Spanguolėlė;3631138915;Ne;1;4;0;5
15964;Žolynėlis;Spanguolėlė;5218448120;Ne;0;5;0;5
15965;Žolynėlis;Spanguolėlė;4076450179;Taip;0;3;0;3
15966;Žolynėlis;Spanguolėlė;4494255525;Ne;7;1;0;8
15967;Žolynėlis;Spanguolėlė;2493633505;Ne;9;1;0;10
15968;Žolynėlis;Spanguolėlė;5438607463;Ne;7;0;0;7
15969;Žolynėlis;Spanguolėlė;5208585298;Ne;0;3;0;3
15970;Žolynėlis;Spanguolėlė;7451189254;Ne;6;0;0;6
15971;Žolynėlis;Spanguolėlė;9498369210;Ne;8;3;0;11
15972;Žolynėlis;Spanguolėlė;7260397656;Ne;6;0;0;6
15973;Žolynėlis;Spanguolėlė;2315947380;Ne;8;0;0;8
15974;Žolynėlis;Spanguolėlė;5074658392;Ne;8;0;0;8
15975;Žolynėlis;Spanguolėlė;6288526291;Ne;1;2;0;3
15976;Žolynėlis;Spanguolėlė;7234022613;Ne;1;2;0;3
15977;Žolynėlis;Spanguolėlė;3222329369;Ne;0;19;0;19
15978;Žolynėlis;"SAULUTĖ (spec)";9675783636;Ne;4;4;0;8
15979;Žolynėlis;"SAULUTĖ (spec)";7962304738;Ne;2;2;0;4
15980;Žolynėlis;"SAULUTĖ (spec)";3934182673;Ne;5;2;0;7
15981;Žolynėlis;"SAULUTĖ (spec)";8588753136;Ne;6;2;0;8
15982;Žolynėlis;"SAULUTĖ (spec)";9507509872;Ne;0;10;0;10
15983;Žolynėlis;"LINELIS (spec)";8930536051;Ne;0;2;1;3
15984;Žolynėlis;"LINELIS (spec)";6510930436;Ne;15;0;0;15
15985;Žolynėlis;"LINELIS (spec)";6619551947;Ne;12;0;0;12
15986;Žolynėlis;"LINELIS (spec)";4000928238;Ne;11;6;0;17
15987;Žolynėlis;"LINELIS (spec)";1540454207;Ne;4;1;0;5
15988;Žolynėlis;"LINELIS (spec)";5610113641;Ne;0;4;0;4
15989;Žolynėlis;"LINELIS (spec)";6678697536;Ne;14;2;0;16
15990;Žolynėlis;"LINELIS (spec)";3043560150;Ne;5;8;0;13
15991;Žolynėlis;"RASAKILA (spec)";4971887781;Ne;0;4;0;4
15992;Žolynėlis;"RASAKILA (spec)";8839037219;Ne;0;5;0;5
15993;Žolynėlis;"RASAKILA (spec)";4481343085;Ne;0;4;0;4
15994;Žolynėlis;"RASAKILA (spec)";8577197481;Ne;10;3;0;13
15995;Žolynėlis;"RASAKILA (spec)";1412336878;Ne;4;3;0;7
15996;Žolynėlis;"RASAKILA (spec)";2327996393;Ne;1;5;0;6
15997;Žolynėlis;"RAMUNĖLĖS (spec)";4559404699;Ne;0;2;0;2
15998;Žolynėlis;"RAMUNĖLĖS (spec)";1703785525;Ne;5;6;0;11
15999;Žolynėlis;"RAMUNĖLĖS (spec)";2072569949;Ne;6;4;0;10
16000;Žolynėlis;"RAMUNĖLĖS (spec)";1090944316;Ne;3;2;1;6
16001;Žolynėlis;"RAMUNĖLĖS (spec)";5729519418;Ne;2;0;0;2
16002;Žolynėlis;"RAMUNĖLĖS (spec)";7266224868;Ne;6;1;0;7
16003;Žolynėlis;"RAMUNĖLĖS (spec)";7085655808;Ne;2;0;0;2
16004;Žolynėlis;"RAMUNĖLĖS (spec)";3748657353;Ne;3;7;0;10
16005;Žolynėlis;Dobiliukai;2005661306;Ne;0;3;0;3
16006;Žolynėlis;Dobiliukai;2820649587;Ne;4;0;0;4
16007;Žolynėlis;Dobiliukai;7581436340;Ne;19;0;0;19
16008;Žolynėlis;Dobiliukai;3385748516;Ne;0;6;0;6
16009;Žolynėlis;Dobiliukai;2957426163;Ne;9;3;0;12
16010;Žolynėlis;Dobiliukai;5456771327;Ne;1;1;0;2
16011;Žolynėlis;Dobiliukai;8341730420;Ne;5;1;0;6
16012;Žolynėlis;Dobiliukai;5634886191;Ne;4;5;0;9
16013;Žolynėlis;Dobiliukai;3350246193;Ne;1;2;0;3
16014;Žolynėlis;Dobiliukai;5269388947;Ne;1;5;0;6
16015;Žolynėlis;Dobiliukai;1206144208;Ne;5;1;0;6
16016;Žolynėlis;Dobiliukai;1213384150;Ne;4;4;0;8
16017;Žolynėlis;Dobiliukai;7485033527;Ne;2;5;1;8
16018;Žolynėlis;Dobiliukai;4462289757;Ne;3;0;0;3
16019;Žolynėlis;Dobiliukai;7053810996;Ne;3;0;0;3
16020;Žolynėlis;Dobiliukai;6124252688;Ne;2;0;0;2
16021;Žolynėlis;Dobiliukai;7201413203;Ne;0;0;1;1
16022;Žolynėlis;Dobiliukai;4229530366;Ne;8;5;0;13
16023;Žolynėlis;Aguonėlė;3071570864;Ne;11;0;0;11
16024;Žolynėlis;Aguonėlė;1440666914;Ne;0;4;0;4
16025;Žolynėlis;Aguonėlė;1365534272;Ne;7;2;0;9
16026;Žolynėlis;Aguonėlė;6740105842;Ne;6;4;0;10
16027;Žolynėlis;Aguonėlė;3952731134;Ne;3;0;0;3
16028;Žolynėlis;Aguonėlė;9904373687;Ne;6;0;0;6
16029;Žolynėlis;Aguonėlė;9285539649;Ne;1;1;0;2
16030;Žolynėlis;Aguonėlė;5243624422;Ne;14;1;0;15
16031;Žolynėlis;Aguonėlė;4761054847;Ne;8;0;0;8
16032;Žolynėlis;Aguonėlė;1748987196;Ne;7;6;0;13
16033;Žolynėlis;Aguonėlė;4094173207;Ne;2;0;0;2
16034;Žolynėlis;Aguonėlė;6034854963;Ne;10;6;0;16
16035;Žolynėlis;Aguonėlė;1847470349;Ne;1;0;0;1
16036;Žolynėlis;Pienė;3520272555;Ne;0;3;0;3
16037;Žolynėlis;Pienė;1163753820;Ne;0;4;0;4
16038;Žolynėlis;Pienė;9238832484;Ne;11;4;0;15
16039;Žolynėlis;Pienė;3877168024;Ne;7;5;0;12
16040;Žolynėlis;Pienė;4618251201;Ne;0;6;0;6
16041;Žolynėlis;Pienė;1264022895;Ne;10;4;0;14
16042;Žolynėlis;Pienė;8697184617;Ne;0;4;0;4
16043;Žolynėlis;Pienė;8713225753;Ne;0;4;0;4
16044;Žolynėlis;Pienė;5332349177;Ne;0;7;0;7
16045;Žolynėlis;Pienė;3091749692;Ne;4;4;0;8
16046;Žolynėlis;Pienė;2263679711;Ne;2;2;0;4
16047;Žolynėlis;Pienė;5149512625;Ne;0;4;0;4
16048;Žolynėlis;Pienė;5973298389;Ne;5;4;0;9
16049;Žolynėlis;Pienė;4048788625;Ne;0;3;0;3
16050;Žolynėlis;Pienė;8552635547;Ne;4;1;0;5
16051;Žolynėlis;Pienė;2256262371;Ne;0;6;0;6
16052;Žolynėlis;Čiobreliai;8215427354;Ne;6;7;0;13
16053;Žolynėlis;Čiobreliai;7339496409;Ne;3;1;0;4
16054;Žolynėlis;Čiobreliai;2565770471;Ne;8;4;0;12
16055;Žolynėlis;Čiobreliai;6829144389;Ne;0;13;0;13
16056;Žolynėlis;Čiobreliai;7256502393;Ne;0;5;0;5
16057;Žolynėlis;Čiobreliai;2108221942;Ne;5;6;0;11
16058;Žolynėlis;Čiobreliai;2881461471;Ne;13;4;0;17
16059;Žolynėlis;Čiobreliai;7339110559;Ne;0;7;0;7
16060;Žolynėlis;Čiobreliai;2460982987;Ne;0;7;0;7
16061;Žolynėlis;Čiobreliai;7980206574;Ne;0;4;0;4
16062;Žolynėlis;Čiobreliai;3088932720;Ne;3;7;0;10
16063;Žolynėlis;Čiobreliai;4758738231;Ne;3;7;0;10
16064;Žolynėlis;Čiobreliai;6024288147;Ne;0;3;0;3
16065;Žolynėlis;Čiobreliai;1485195267;Ne;4;5;0;9
16066;Žolynėlis;Čiobreliai;6679254518;Ne;0;4;0;4
16067;Žolynėlis;Čiobreliai;6763515483;Ne;0;3;0;3
16068;Žolynėlis;Čiobreliai;5432464074;Ne;0;6;0;6
16069;Žolynėlis;Čiobreliai;6416217971;Ne;0;11;0;11
16070;Žolynėlis;Čiobreliai;1879046798;Ne;0;5;0;5
16071;Žolynėlis;Čiobreliai;2934361190;Ne;4;5;0;9
16072;Žolynėlis;Čiobreliai;8510764089;Ne;0;5;0;5
16073;Žolynėlis;Avietėlė;4277871671;Ne;6;2;0;8
16074;Žolynėlis;Avietėlė;9404844632;Ne;6;2;0;8
16075;Žolynėlis;Avietėlė;5873931225;Ne;3;6;0;9
16076;Žolynėlis;Avietėlė;1266614631;Ne;10;5;0;15
16077;Žolynėlis;Avietėlė;7855260478;Ne;5;2;0;7
16078;Žolynėlis;Avietėlė;2718255075;Ne;16;1;0;17
16079;Žolynėlis;Avietėlė;6417150398;Taip;10;0;0;10
16080;Žolynėlis;Avietėlė;7517815798;Ne;4;0;0;4
16081;Žolynėlis;Avietėlė;5771745015;Ne;2;0;0;2
16082;Žolynėlis;Avietėlė;5581675294;Ne;19;0;0;19
16083;Žolynėlis;Avietėlė;1108820859;Ne;13;0;1;14
16084;Žolynėlis;Avietėlė;9905727117;Ne;5;5;0;10
16085;Žolynėlis;Avietėlė;4221470753;Ne;3;2;0;5
16086;Žolynėlis;Avietėlė;5234937076;Ne;15;0;0;15
16087;Žolynėlis;RŪTELĖ;3293250169;Ne;5;9;0;14
16088;Žolynėlis;RŪTELĖ;9993230229;Ne;5;3;0;8
16089;Žolynėlis;RŪTELĖ;2727273826;Ne;12;0;0;12
16090;Žolynėlis;RŪTELĖ;7264446456;Ne;12;0;0;12
16091;Žolynėlis;RŪTELĖ;3857544079;Ne;10;0;0;10
16092;Žolynėlis;RŪTELĖ;1130456335;Ne;10;6;0;16
16093;Žolynėlis;RŪTELĖ;3401352504;Ne;5;4;0;9
16094;Žolynėlis;RŪTELĖ;5175997689;Ne;11;0;0;11
16095;Žolynėlis;RŪTELĖ;8534977952;Ne;3;3;0;6
16096;Žolynėlis;RŪTELĖ;4780520358;Ne;9;0;0;9
16097;Žolynėlis;RŪTELĖ;3804251134;Ne;6;0;0;6
16098;Žolynėlis;RŪTELĖ;2181156327;Ne;0;6;0;6
16099;Žolynėlis;RŪTELĖ;5184931936;Ne;4;5;0;9
16100;Žolynėlis;RŪTELĖ;5666650566;Ne;7;0;0;7
16101;Žolynėlis;RŪTELĖ;5769654742;Ne;14;2;0;16
16102;Žolynėlis;RŪTELĖ;6808975784;Ne;0;0;1;1
16103;Žuvėdra;"JŪROS ŽVAIGŽDUTĖS";1200084485;Ne;0;8;0;8
16104;Žuvėdra;"JŪROS ŽVAIGŽDUTĖS";4177319374;Ne;0;17;0;17
16105;Žuvėdra;"JŪROS ŽVAIGŽDUTĖS";7121154799;Ne;5;10;0;15
16106;Žuvėdra;"JŪROS ŽVAIGŽDUTĖS";8162649794;Ne;6;3;0;9
16107;Žuvėdra;"JŪROS ŽVAIGŽDUTĖS";7710853637;Ne;0;1;0;1
16108;Žuvėdra;"JŪROS ŽVAIGŽDUTĖS";2858729034;Ne;4;4;1;9
16109;Žuvėdra;"JŪROS ŽVAIGŽDUTĖS";7958768355;Ne;0;1;0;1
16110;Žuvėdra;"JŪROS ŽVAIGŽDUTĖS";6672289932;Ne;9;1;0;10
16111;Žuvėdra;"JŪROS ŽVAIGŽDUTĖS";5571732399;Ne;10;0;3;13
16112;Žuvėdra;"JŪROS ŽVAIGŽDUTĖS";3620753237;Ne;10;0;1;11
16113;Žuvėdra;"JŪROS ŽVAIGŽDUTĖS";6651984898;Ne;2;1;0;3
16114;Žuvėdra;"JŪROS ŽVAIGŽDUTĖS";1974766090;Ne;0;11;0;11
16115;Žuvėdra;"JŪROS ŽVAIGŽDUTĖS";8869169590;Ne;0;6;0;6
16116;Žuvėdra;"JŪROS ŽVAIGŽDUTĖS";5436158437;Ne;0;2;0;2
16117;Žuvėdra;"JŪROS ŽVAIGŽDUTĖS";2082128566;Ne;0;10;0;10
16118;Žuvėdra;"JŪROS ŽVAIGŽDUTĖS";2582404760;Ne;1;6;1;8
16119;Žuvėdra;"JŪROS ŽVAIGŽDUTĖS";6952843736;Ne;0;3;0;3
16120;Žuvėdra;"JŪROS ŽVAIGŽDUTĖS";8308610070;Ne;0;5;0;5
16121;Žuvėdra;"JŪROS ŽVAIGŽDUTĖS";3616821462;Ne;0;4;0;4
16122;Žuvėdra;DELFINUKAI;7235005234;Ne;0;1;0;1
16123;Žuvėdra;DELFINUKAI;5876618912;Ne;4;0;0;4
16124;Žuvėdra;DELFINUKAI;6989906913;Ne;0;4;0;4
16125;Žuvėdra;DELFINUKAI;4702627979;Ne;0;4;0;4
16126;Žuvėdra;DELFINUKAI;6327915228;Ne;5;0;0;5
16127;Žuvėdra;DELFINUKAI;7803397430;Ne;0;1;0;1
16128;Žuvėdra;DELFINUKAI;7705946236;Ne;19;0;0;19
16129;Žuvėdra;DELFINUKAI;3069506904;Ne;7;0;3;10
16130;Žuvėdra;DELFINUKAI;5913580058;Ne;6;0;0;6
16131;Žuvėdra;DELFINUKAI;9651268462;Ne;4;0;3;7
16132;Žuvėdra;DELFINUKAI;3423051494;Ne;0;3;3;6
16133;Žuvėdra;DELFINUKAI;4881712317;Taip;19;0;0;19
16134;Žuvėdra;DELFINUKAI;8111760611;Ne;0;4;1;5
16135;Žuvėdra;DELFINUKAI;1993897043;Ne;8;1;0;9
16136;Žuvėdra;DELFINUKAI;9200342856;Ne;4;0;0;4
16137;Žuvėdra;DELFINUKAI;1604010000;Ne;5;0;0;5
16138;Žuvėdra;DELFINUKAI;2844920302;Ne;4;0;1;5
16139;Žuvėdra;DELFINUKAI;2323431685;Ne;0;4;1;5
16140;Žuvėdra;DELFINUKAI;9914814198;Ne;0;1;0;1
16141;Žuvėdra;OSMINOŽKI;5273726957;Ne;0;3;0;3
16142;Žuvėdra;OSMINOŽKI;5674529681;Ne;3;2;0;5
16143;Žuvėdra;OSMINOŽKI;7630057671;Ne;0;2;0;2
16144;Žuvėdra;OSMINOŽKI;7368183516;Ne;0;7;0;7
16145;Žuvėdra;OSMINOŽKI;3853045274;Ne;0;13;0;13
16146;Žuvėdra;OSMINOŽKI;3185158741;Ne;0;4;0;4
16147;Žuvėdra;OSMINOŽKI;5198825127;Ne;4;2;0;6
16148;Žuvėdra;OSMINOŽKI;5561903903;Ne;0;2;0;2
16149;Žuvėdra;OSMINOŽKI;5818639448;Ne;0;1;0;1
16150;Žuvėdra;OSMINOŽKI;4907571967;Ne;1;0;0;1
16151;Žuvėdra;OSMINOŽKI;3613045982;Ne;0;3;0;3
16152;Žuvėdra;OSMINOŽKI;7467154866;Ne;0;12;0;12
16153;Žuvėdra;OSMINOŽKI;5151984122;Ne;0;2;0;2
16154;Žuvėdra;OSMINOŽKI;8670342549;Ne;0;1;0;1
16155;Žuvėdra;OSMINOŽKI;6715416675;Ne;0;3;0;3
16156;Žuvėdra;OSMINOŽKI;3349158713;Ne;2;2;0;4
16157;Žuvėdra;OSMINOŽKI;8942228415;Ne;0;1;0;1
16158;Žuvėdra;OSMINOŽKI;4715123063;Ne;0;13;0;13
16159;Žuvėdra;RUSALAČKA;1707519901;Ne;0;8;0;8
16160;Žuvėdra;RUSALAČKA;1810114962;Ne;0;5;0;5
16161;Žuvėdra;RUSALAČKA;1960306957;Ne;0;10;0;10
16162;Žuvėdra;RUSALAČKA;2640238143;Ne;10;0;0;10
16163;Žuvėdra;RUSALAČKA;2577280901;Ne;6;4;1;11
16164;Žuvėdra;RUSALAČKA;5481785360;Ne;8;3;0;11
16165;Žuvėdra;RUSALAČKA;9011276878;Ne;0;3;0;3
16166;Žuvėdra;RUSALAČKA;7387863175;Ne;0;14;0;14
16167;Žuvėdra;RUSALAČKA;7464494386;Ne;0;2;0;2
16168;Žuvėdra;RUSALAČKA;3058300342;Ne;7;0;0;7
16169;Žuvėdra;RUSALAČKA;7227722516;Ne;11;1;0;12
16170;Žuvėdra;RUSALAČKA;4893062971;Ne;0;2;2;4
16171;Žuvėdra;RUSALAČKA;1219808187;Ne;0;5;0;5
16172;Žuvėdra;RUSALAČKA;7908898376;Ne;2;0;2;4
16173;Žuvėdra;RUSALAČKA;2197976174;Ne;0;2;0;2
16174;Žuvėdra;RUSALAČKA;9838754800;Ne;6;1;0;7
16175;Žuvėdra;RUSALAČKA;3781157324;Ne;5;1;1;7
16176;Žuvėdra;RUSALAČKA;1171751803;Ne;0;1;0;1
16177;Žuvėdra;RUSALAČKA;1039661177;Ne;10;3;2;15
16178;Žuvėdra;RUSALAČKA;6862766787;Ne;10;3;0;13
16179;Žuvėdra;JANTARIKI;1929548863;Ne;5;2;0;7
16180;Žuvėdra;JANTARIKI;1072201019;Ne;0;3;0;3
16181;Žuvėdra;JANTARIKI;9256424331;Ne;11;3;0;14
16182;Žuvėdra;JANTARIKI;2789379055;Ne;0;3;0;3
16183;Žuvėdra;JANTARIKI;8427721323;Ne;15;0;0;15
16184;Žuvėdra;JANTARIKI;9410938471;Ne;7;5;0;12
16185;Žuvėdra;JANTARIKI;1526878181;Ne;19;0;0;19
16186;Žuvėdra;JANTARIKI;5272918949;Ne;0;8;0;8
16187;Žuvėdra;JANTARIKI;1352508839;Ne;0;2;0;2
16188;Žuvėdra;JANTARIKI;8224363978;Ne;2;0;0;2
16189;Žuvėdra;JANTARIKI;1224866951;Ne;4;0;0;4
16190;Žuvėdra;JANTARIKI;3190173500;Ne;4;0;0;4
16191;Žuvėdra;"AUKSINĖ ŽUVELĖ";6287034023;Ne;0;2;0;2
16192;Žuvėdra;"AUKSINĖ ŽUVELĖ";9460887312;Ne;0;7;0;7
16193;Žuvėdra;"AUKSINĖ ŽUVELĖ";5009153711;Ne;0;2;0;2
16194;Žuvėdra;"AUKSINĖ ŽUVELĖ";4739865462;Ne;0;0;1;1
16195;Žuvėdra;"AUKSINĖ ŽUVELĖ";7135848009;Ne;4;0;0;4
16196;Žuvėdra;"AUKSINĖ ŽUVELĖ";9215777054;Taip;0;0;2;2
16197;Žuvėdra;"AUKSINĖ ŽUVELĖ";4217169024;Ne;7;0;0;7
16198;Žuvėdra;"AUKSINĖ ŽUVELĖ";6451721553;Ne;11;0;0;11
16199;Žuvėdra;"AUKSINĖ ŽUVELĖ";4447517071;Ne;0;0;6;6
16200;Žuvėdra;"AUKSINĖ ŽUVELĖ";2118573300;Taip;9;0;0;9
16201;Žuvėdra;"AUKSINĖ ŽUVELĖ";4207664070;Ne;8;0;0;8
16202;Žvangutis;PELIUKŲ;7616874368;Ne;6;2;0;8
16203;Žvangutis;PELIUKŲ;3906808900;Ne;0;1;0;1
16204;Žvangutis;PELIUKŲ;7722153982;Ne;0;5;0;5
16205;Žvangutis;PELIUKŲ;4295016449;Ne;0;6;0;6
16206;Žvangutis;PELIUKŲ;9958554027;Ne;5;4;0;9
16207;Žvangutis;PELIUKŲ;8592522675;Ne;0;4;0;4
16208;Žvangutis;PELIUKŲ;3957064486;Ne;2;3;0;5
16209;Žvangutis;PELIUKŲ;5817402847;Ne;19;0;0;19
16210;Žvangutis;PELIUKŲ;4407484687;Ne;5;0;0;5
16211;Žvangutis;PELIUKŲ;5638068914;Ne;12;0;0;12
16212;Žvangutis;PELIUKŲ;4337928288;Ne;0;6;0;6
16213;Žvangutis;PELIUKŲ;8062689240;Ne;0;4;0;4
16214;Žvangutis;PELIUKŲ;3875906173;Ne;4;3;0;7
16215;Žvangutis;PELIUKŲ;1328464199;Ne;0;5;0;5
16216;Žvangutis;PELIUKŲ;3546672690;Ne;0;5;0;5
16217;Žvangutis;PELIUKŲ;4992231141;Ne;7;2;0;9
16218;Žvangutis;PELIUKŲ;3408933802;Ne;3;1;1;5
16219;Žvangutis;PELIUKŲ;8481666202;Ne;0;7;0;7
16220;Žvangutis;PELIUKŲ;4705131089;Ne;0;4;0;4
16221;Žvangutis;PELIUKŲ;7844987649;Ne;0;4;0;4
16222;Žvangutis;ANČIUKŲ;5539992579;Ne;5;5;0;10
16223;Žvangutis;ANČIUKŲ;2411307963;Ne;0;4;0;4
16224;Žvangutis;ANČIUKŲ;8295525284;Ne;0;3;0;3
16225;Žvangutis;ANČIUKŲ;1324948757;Ne;0;4;0;4
16226;Žvangutis;ANČIUKŲ;6068428687;Ne;0;4;0;4
16227;Žvangutis;ANČIUKŲ;1322688456;Ne;0;1;0;1
16228;Žvangutis;ANČIUKŲ;9468660351;Ne;0;5;0;5
16229;Žvangutis;ANČIUKŲ;9149037184;Ne;0;5;0;5
16230;Žvangutis;ANČIUKŲ;1404378308;Ne;6;5;0;11
16231;Žvangutis;ANČIUKŲ;1185135525;Ne;0;5;0;5
16232;Žvangutis;ANČIUKŲ;5012996199;Ne;3;4;0;7
16233;Žvangutis;ANČIUKŲ;2623107843;Ne;0;4;0;4
16234;Žvangutis;ANČIUKŲ;3276065009;Ne;5;3;0;8
16235;Žvangutis;ANČIUKŲ;5723728310;Ne;0;4;0;4
16236;Žvangutis;ANČIUKŲ;1282567366;Ne;0;1;0;1
16237;Žvangutis;ANČIUKŲ;2570379643;Ne;0;4;0;4
16238;Žvangutis;ANČIUKŲ;9036869235;Ne;0;4;0;4
16239;Žvangutis;ANČIUKŲ;2922083476;Ne;0;5;0;5
16240;Žvangutis;ANČIUKŲ;6207989105;Ne;5;6;0;11
16241;Žvangutis;ANČIUKŲ;2755838558;Ne;0;4;0;4
16242;Žvangutis;ANČIUKŲ;6040986672;Ne;0;5;0;5
16243;Žvangutis;ANČIUKŲ;2716216474;Ne;0;5;0;5
16244;Žvangutis;PELĖDŽIUKŲ;7599491698;Ne;8;5;0;13
16245;Žvangutis;PELĖDŽIUKŲ;6094686500;Taip;0;0;3;3
16246;Žvangutis;PELĖDŽIUKŲ;2049990751;Ne;0;0;2;2
16247;Žvangutis;PELĖDŽIUKŲ;9711017196;Ne;0;0;5;5
16248;Žvangutis;PELĖDŽIUKŲ;7051007224;Ne;0;0;1;1
16249;Žvangutis;PELĖDŽIUKŲ;8906823569;Ne;13;0;1;14
16250;Žvangutis;PELĖDŽIUKŲ;8753815074;Ne;6;0;0;6
16251;Žvangutis;PELĖDŽIUKŲ;3781959962;Ne;0;2;4;6
16252;Žvangutis;PELĖDŽIUKŲ;8506809320;Ne;1;4;0;5
16253;Žvangutis;PELĖDŽIUKŲ;8376022173;Ne;0;1;3;4
16254;Žvangutis;PELĖDŽIUKŲ;6825952779;Ne;0;4;2;6
16255;Žvangutis;PELĖDŽIUKŲ;4920234186;Ne;0;7;0;7
16256;Žvangutis;PELĖDŽIUKŲ;8598396569;Ne;5;4;0;9
16257;Žvangutis;PELĖDŽIUKŲ;1590704985;Ne;0;0;3;3
16258;Žvangutis;PELĖDŽIUKŲ;9306755042;Ne;0;0;4;4
16259;Žvangutis;PELĖDŽIUKŲ;1352736819;Ne;0;3;0;3
16260;Žvangutis;PELĖDŽIUKŲ;2298103025;Ne;0;4;0;4
16261;Žvangutis;PELĖDŽIUKŲ;9523189658;Ne;11;0;1;12
16262;Žvangutis;PELĖDŽIUKŲ;5126809299;Ne;8;0;0;8
16263;Žvangutis;PELĖDŽIUKŲ;9883337991;Taip;14;0;0;14
16264;Žvangutis;PELĖDŽIUKŲ;2308726385;Ne;0;0;5;5
16265;Žvangutis;KAČIUKŲ;7213349517;Ne;2;4;0;6
16266;Žvangutis;KAČIUKŲ;7581320158;Ne;0;4;0;4
16267;Žvangutis;KAČIUKŲ;2296360416;Ne;0;7;0;7
16268;Žvangutis;KAČIUKŲ;7721746116;Ne;0;7;0;7
16269;Žvangutis;KAČIUKŲ;2598842770;Ne;0;4;0;4
16270;Žvangutis;KAČIUKŲ;1142315595;Ne;11;2;0;13
16271;Žvangutis;KAČIUKŲ;9239279639;Ne;0;5;0;5
16272;Žvangutis;KAČIUKŲ;4696437804;Ne;0;4;0;4
16273;Žvangutis;KAČIUKŲ;8492637734;Ne;0;8;0;8
16274;Žvangutis;KAČIUKŲ;2503355659;Ne;0;1;0;1
16275;Žvangutis;KAČIUKŲ;8360356476;Ne;3;0;0;3
16276;Žvangutis;KAČIUKŲ;8863909185;Ne;0;7;0;7
16277;Žvangutis;KAČIUKŲ;3498584864;Taip;0;5;0;5
16278;Žvangutis;KAČIUKŲ;4408086513;Ne;0;12;0;12
16279;Žvangutis;KAČIUKŲ;1256264382;Ne;0;10;0;10
16280;Žvangutis;KAČIUKŲ;8030520477;Ne;2;4;0;6
16281;Žvangutis;KAČIUKŲ;5166614226;Ne;4;0;0;4
16282;Žvangutis;KAČIUKŲ;8810739982;Ne;0;3;0;3
16283;Žvangutis;KAČIUKŲ;2740875969;Ne;7;0;0;7
16284;Žvangutis;KAČIUKŲ;8269992031;Ne;10;0;0;10
16285;Žvangutis;KAČIUKŲ;1224292338;Ne;5;0;0;5
16286;Žvangutis;KAČIUKŲ;1634651749;Ne;0;1;0;1
16287;Žvangutis;MEŠKUČIŲ;5714127995;Ne;9;5;0;14
16288;Žvangutis;MEŠKUČIŲ;8841791656;Ne;3;3;0;6
16289;Žvangutis;MEŠKUČIŲ;7007117864;Ne;3;3;0;6
16290;Žvangutis;MEŠKUČIŲ;5162865213;Ne;12;0;0;12
16291;Žvangutis;MEŠKUČIŲ;8081046191;Ne;7;4;0;11
16292;Žvangutis;MEŠKUČIŲ;2671205721;Ne;11;4;0;15
16293;Žvangutis;MEŠKUČIŲ;2148237530;Ne;12;0;0;12
16294;Žvangutis;MEŠKUČIŲ;6424312740;Ne;9;3;0;12
16295;Žvangutis;MEŠKUČIŲ;8324813274;Ne;4;1;0;5
16296;Žvangutis;MEŠKUČIŲ;7098816023;Taip;11;0;0;11
16297;Žvangutis;MEŠKUČIŲ;3734153710;Ne;11;0;0;11
16298;Žvangutis;MEŠKUČIŲ;5780339899;Ne;8;5;0;13
16299;Žvangutis;MEŠKUČIŲ;6189100246;Ne;14;0;0;14
16300;Žvangutis;MEŠKUČIŲ;6329268519;Ne;9;0;0;9
16301;Žvangutis;MEŠKUČIŲ;5579521166;Ne;11;0;0;11
16302;Žvangutis;MEŠKUČIŲ;9671139568;Ne;9;0;0;9
16303;Žvangutis;KIŠKUČIŲ;3940893168;Ne;0;0;5;5
16304;Žvangutis;KIŠKUČIŲ;1592158260;Ne;12;0;0;12
16305;Žvangutis;KIŠKUČIŲ;5022657156;Taip;0;0;4;4
16306;Žvangutis;KIŠKUČIŲ;7645908955;Ne;2;1;1;4
16307;Žvangutis;KIŠKUČIŲ;6741623841;Ne;3;0;2;5
16308;Žvangutis;KIŠKUČIŲ;3029382724;Ne;5;0;1;6
16309;Žvangutis;KIŠKUČIŲ;4128856598;Taip;11;0;1;12
16310;Žvangutis;KIŠKUČIŲ;4968365511;Taip;16;0;0;16
16311;Žvangutis;KIŠKUČIŲ;1706200292;Ne;0;0;1;1
16312;Žvangutis;KIŠKUČIŲ;5328547183;Ne;5;1;0;6
16313;Žvangutis;KIŠKUČIŲ;4471191112;Ne;0;0;2;2
16314;Žvangutis;KIŠKUČIŲ;3081929677;Ne;0;0;3;3
16315;Žvangutis;KIŠKUČIŲ;6768957624;Ne;13;0;0;13
16316;Žvangutis;KIŠKUČIŲ;8514691010;Ne;0;0;16;16
16317;Žvangutis;KIŠKUČIŲ;8233392333;Ne;10;0;0;10
16318;Žvangutis;KIŠKUČIŲ;2284700283;Ne;5;0;0;5
16319;Žvangutis;KIŠKUČIŲ;9292902597;Taip;7;0;0;7
16320;Žirniukas;Boružiukų;5311746004;Ne;0;0;17;17
16321;Žirniukas;Boružiukų;2476906136;Ne;0;2;3;5
16322;Žirniukas;Boružiukų;2528905738;Ne;0;2;2;4
16323;Žirniukas;Boružiukų;6268788036;Ne;0;4;0;4
16324;Žirniukas;Boružiukų;6363169823;Ne;0;2;0;2
16325;Žirniukas;Boružiukų;2636634198;Ne;0;9;0;9
16326;Žirniukas;Boružiukų;8148254025;Ne;3;4;0;7
16327;Žirniukas;Boružiukų;6531175340;Ne;0;6;0;6
16328;Žirniukas;Boružiukų;9647374339;Ne;0;4;0;4
16329;Žirniukas;Boružiukų;6641200341;Ne;0;3;0;3
16330;Žirniukas;Boružiukų;3022672028;Ne;7;4;0;11
16331;Žirniukas;Boružiukų;8180092480;Ne;0;0;1;1
16332;Žirniukas;Boružiukų;9896989995;Ne;0;1;0;1
16333;Žirniukas;Boružiukų;7397202752;Ne;0;6;4;10
16334;Žirniukas;Boružiukų;4233026576;Ne;5;0;4;9
16335;Žirniukas;Boružiukų;6598851580;Ne;0;0;7;7
16336;Žirniukas;Boružiukų;7965050711;Ne;0;0;5;5
16337;Žirniukas;Boružiukų;9986289837;Ne;0;0;4;4
16338;Žirniukas;Boružiukų;7872611724;Ne;1;5;0;6
16339;Žirniukas;Boružiukų;3189741449;Ne;0;1;0;1
16340;Žirniukas;Boružiukų;2140863010;Ne;0;0;19;19
16341;Žirniukas;Smalsučiai;5819443551;Ne;0;4;0;4
16342;Žirniukas;Smalsučiai;6096664609;Ne;5;5;0;10
16343;Žirniukas;Smalsučiai;1074945082;Ne;9;0;0;9
16344;Žirniukas;Smalsučiai;4433579937;Ne;3;2;1;6
16345;Žirniukas;Smalsučiai;1594735501;Ne;0;5;0;5
16346;Žirniukas;Smalsučiai;4229687519;Ne;0;3;0;3
16347;Žirniukas;Smalsučiai;2733313392;Ne;0;6;0;6
16348;Žirniukas;Smalsučiai;9707776533;Ne;0;4;0;4
16349;Žirniukas;Smalsučiai;7278153529;Ne;0;4;0;4
16350;Žirniukas;Smalsučiai;8151071354;Ne;0;3;0;3
16351;Žirniukas;Smalsučiai;7927815250;Ne;0;4;0;4
16352;Žirniukas;Smalsučiai;2325139043;Ne;6;5;0;11
16353;Žirniukas;Smalsučiai;4527367786;Ne;0;2;0;2
16354;Žirniukas;Smalsučiai;8599313527;Ne;4;7;0;11
16355;Žirniukas;Smalsučiai;4320686646;Ne;0;5;0;5
16356;Žirniukas;Smalsučiai;3610402086;Ne;0;4;0;4
16357;Žirniukas;Smalsučiai;6362626389;Ne;0;3;0;3
16358;Žirniukas;Smalsučiai;9961947583;Ne;0;2;0;2
16359;Žirniukas;Smalsučiai;4045432303;Ne;6;2;0;8
16360;Žirniukas;Gėlyčių;2982628594;Ne;0;6;1;7
16361;Žirniukas;Gėlyčių;6121388208;Ne;2;0;3;5
16362;Žirniukas;Gėlyčių;6201949014;Ne;6;0;4;10
16363;Žirniukas;Gėlyčių;9497414375;Ne;0;6;3;9
16364;Žirniukas;Gėlyčių;5427116799;Ne;0;1;3;4
16365;Žirniukas;Gėlyčių;6147030672;Ne;1;1;1;3
16366;Žirniukas;Gėlyčių;2423974973;Ne;5;0;0;5
16367;Žirniukas;Gėlyčių;9507651487;Ne;6;0;0;6
16368;Žirniukas;Gėlyčių;1368553187;Ne;16;0;1;17
16369;Žirniukas;Gėlyčių;2221770310;Ne;0;1;2;3
16370;Žirniukas;Gėlyčių;5554441466;Ne;13;0;0;13
16371;Žirniukas;Gėlyčių;6788087742;Ne;4;0;1;5
16372;Žirniukas;Gėlyčių;5317756167;Ne;2;2;1;5
16373;Žirniukas;Nykštukų;2489070480;Ne;2;0;1;3
16374;Žirniukas;Nykštukų;5734197350;Ne;2;2;0;4
16375;Žirniukas;Nykštukų;2746074694;Ne;0;2;0;2
16376;Žirniukas;Nykštukų;4282344625;Ne;0;3;0;3
16377;Žirniukas;Nykštukų;3874713264;Ne;0;4;0;4
16378;Žirniukas;Nykštukų;1532129054;Ne;0;3;0;3
16379;Žirniukas;Nykštukų;7368124402;Ne;0;5;0;5
16380;Žirniukas;Nykštukų;1635353228;Ne;0;2;0;2
16381;Žirniukas;Nykštukų;2526769571;Ne;3;1;0;4
16382;Žirniukas;Nykštukų;2027344763;Ne;9;1;0;10
16383;Žirniukas;Nykštukų;9730269905;Ne;0;1;0;1
16384;Žirniukas;Nykštukų;9478756666;Ne;0;3;0;3
16385;Žirniukas;Nykštukų;4732089209;Ne;0;3;0;3
16386;Žirniukas;Nykštukų;9988669252;Ne;0;1;0;1
16387;Žirniukas;Nykštukų;8242086461;Ne;0;2;0;2
16388;Žirniukas;Nykštukų;8242086461;Ne;0;2;0;2
16389;Žirniukas;Nykštukų;8242086461;Ne;0;2;0;2
16390;Žirniukas;Nykštukų;6511802399;Ne;0;2;0;2
16391;Žirniukas;Nykštukų;6511802399;Ne;0;2;0;2
16392;Žirniukas;Nykštukų;6511802399;Ne;0;2;0;2
16393;Žirniukas;Nykštukų;6349641015;Ne;4;2;0;6
16394;Žirniukas;Nykštukų;2635969699;Ne;4;2;0;6
16395;Žirniukas;Nykštukų;5422282267;Ne;6;1;1;8
16396;Žirniukas;Nykštukų;5103440019;Ne;10;0;0;10
16397;Žirniukas;Saulytės;5613818351;Ne;0;2;1;3
16398;Žirniukas;Saulytės;1345594362;Ne;0;3;0;3
16399;Žirniukas;Saulytės;9847840127;Ne;0;5;0;5
16400;Žirniukas;Saulytės;5212289551;Ne;2;0;0;2
16401;Žirniukas;Saulytės;1005139737;Ne;0;0;3;3
16402;Žirniukas;Saulytės;7968189099;Ne;8;2;0;10
16403;Žirniukas;Saulytės;7081683726;Ne;0;4;0;4
16404;Žirniukas;Saulytės;7021496832;Ne;1;0;4;5
16405;Žirniukas;Saulytės;1449763041;Ne;0;3;0;3
16406;Žirniukas;Saulytės;7269948694;Ne;0;2;0;2
16407;Žirniukas;Saulytės;6594686128;Ne;0;3;0;3
16408;Žirniukas;Saulytės;1679864330;Ne;10;0;0;10
16409;Žirniukas;Saulytės;3438394768;Ne;0;4;0;4
16410;Žirniukas;Saulytės;9569187800;Ne;3;2;1;6
16411;Žirniukas;Saulytės;2302878611;Ne;0;6;0;6
16412;Žirniukas;Saulytės;2115471433;Ne;0;2;1;3
16413;Žirniukas;Saulytės;3603956795;Ne;5;3;0;8
16414;Žirniukas;Saulytės;4902056654;Ne;5;3;0;8
16415;Žirniukas;Saulytės;7563892184;Ne;5;3;0;8
16416;Žirniukas;Saulytės;5194729029;Ne;0;1;0;1
16417;Žirniukas;Drugelių;6271194358;Ne;0;6;0;6
16418;Žirniukas;Drugelių;9232828844;Ne;0;2;0;2
16419;Žirniukas;Drugelių;5269074776;Ne;13;0;1;14
16420;Žirniukas;Drugelių;3509857181;Ne;4;2;0;6
16421;Žirniukas;Drugelių;2517524802;Ne;0;3;0;3
16422;Žirniukas;Drugelių;9901196251;Ne;0;2;0;2
16423;Žirniukas;Drugelių;2555959199;Ne;0;2;1;3
16424;Žirniukas;Drugelių;4762596462;Ne;0;0;3;3
16425;Žirniukas;Drugelių;5046469974;Ne;2;1;0;3
16426;Žirniukas;Drugelių;1826203483;Ne;8;0;0;8
16427;Žirniukas;Drugelių;4536071547;Ne;0;2;0;2
16428;Žirniukas;Drugelių;3996393849;Ne;14;0;0;14
16429;Žirniukas;Drugelių;7240364379;Ne;0;3;0;3
16430;Žirniukas;Drugelių;6300372863;Ne;0;3;0;3
16431;Žirniukas;Drugelių;5670489807;Ne;0;14;1;15
16432;Žirniukas;Drugelių;9794535841;Ne;11;0;0;11
16433;Žirniukas;Drugelių;1031316325;Ne;5;1;0;6
16434;Žirniukas;Drugelių;1018506580;Ne;0;2;0;2
16435;Žirniukas;Drugelių;6993784924;Ne;2;2;0;4
16436;Žirniukas;Drugelių;9384464752;Ne;2;3;0;5
16437;Žirniukas;Pelėdžiukai;7889803840;Ne;4;2;0;6
16438;Žirniukas;Pelėdžiukai;2895924102;Ne;1;4;0;5
16439;Žirniukas;Pelėdžiukai;4347695841;Ne;3;0;0;3
16440;Žirniukas;Pelėdžiukai;9381704756;Ne;7;0;0;7
16441;Žirniukas;Pelėdžiukai;4847093256;Ne;8;0;0;8
16442;Žirniukas;Pelėdžiukai;7356213150;Ne;0;13;0;13
16443;Žirniukas;Pelėdžiukai;7545458622;Ne;4;1;0;5
16444;Žirniukas;Pelėdžiukai;8354728917;Ne;1;0;0;1
16445;Žirniukas;Pelėdžiukai;5376080603;Ne;2;0;0;2
16446;Žirniukas;Pelėdžiukai;9511974432;Ne;2;2;0;4
16447;Žirniukas;Pelėdžiukai;7755938379;Ne;1;2;0;3
16448;Žirniukas;Pelėdžiukai;5470692657;Taip;11;2;0;13
16449;Žirniukas;Pelėdžiukai;8690042163;Ne;1;2;0;3
16450;Žirniukas;Pelėdžiukai;8808445761;Taip;0;1;0;1
16451;Žirniukas;Pelėdžiukai;2332260494;Ne;11;3;0;14
16452;Žirniukas;Pelėdžiukai;6941160450;Ne;5;0;0;5
16453;Žirniukas;Pelėdžiukai;4464151713;Ne;9;0;0;9
16454;Žirniukas;Pelėdžiukai;3907578167;Ne;0;1;0;1
16455;Žirniukas;Pelėdžiukai;4069128550;Ne;3;5;0;8
16456;Žirniukas;Pelėdžiukai;2489163786;Ne;1;0;0;1
16457;Žirniukas;Pelėdžiukai;7767762079;Ne;3;0;0;3
16458;Žirniukas;ZUIKUČIAI;4860680720;Ne;8;2;0;10
16459;Žirniukas;ZUIKUČIAI;9993119353;Ne;4;1;0;5
16460;Žirniukas;ZUIKUČIAI;2315136490;Ne;0;2;0;2
16461;Žirniukas;ZUIKUČIAI;4519996144;Ne;8;1;0;9
16462;Žirniukas;ZUIKUČIAI;2081378583;Ne;6;1;0;7
16463;Žirniukas;ZUIKUČIAI;8511341812;Ne;0;0;2;2
16464;Žirniukas;ZUIKUČIAI;7530076269;Ne;0;10;0;10
16465;Žirniukas;ZUIKUČIAI;1255561862;Ne;17;0;0;17
16466;Žirniukas;ZUIKUČIAI;6780809984;Ne;10;0;0;10
16467;Žirniukas;ZUIKUČIAI;5580500746;Ne;0;1;0;1
16468;Žirniukas;ZUIKUČIAI;2161897682;Ne;4;2;0;6
16469;Žirniukas;ZUIKUČIAI;6042654423;Taip;14;0;0;14
16470;Žirniukas;ZUIKUČIAI;6223594794;Ne;0;13;0;13
16471;Žirniukas;ZUIKUČIAI;7868678721;Ne;0;6;2;8
16472;Aušra;Kodėlčiukai;2199083085;Ne;2;1;0;3
16473;Aušra;Kodėlčiukai;4540040693;Ne;12;4;0;16
16474;Aušra;Kodėlčiukai;5013135853;Ne;15;4;0;19
16475;Aušra;Kodėlčiukai;7765504789;Ne;0;4;0;4
16476;Aušra;Kodėlčiukai;4824773027;Ne;0;6;0;6
16477;Aušra;Kodėlčiukai;6139706771;Ne;2;4;0;6
16478;Aušra;Kodėlčiukai;4720749995;Ne;2;4;0;6
16479;Aušra;Kodėlčiukai;8108663467;Ne;7;4;0;11
16480;Aušra;Kodėlčiukai;5046439805;Ne;0;3;0;3
16481;Aušra;Kodėlčiukai;3420851059;Ne;0;1;0;1
16482;Aušra;Kodėlčiukai;7314273812;Ne;0;4;0;4
16483;Aušra;Kodėlčiukai;1423840991;Ne;9;4;0;13
16484;Aušra;Kodėlčiukai;7469266085;Ne;13;4;0;17
16485;Aušra;Kodėlčiukai;1010721404;Ne;0;6;0;6
16486;Aušra;Kodėlčiukai;2611563172;Ne;6;4;0;10
16487;Aušra;Kodėlčiukai;1883185016;Ne;0;4;0;4
16488;Aušra;Kodėlčiukai;1773343262;Ne;0;2;0;2
16489;Aušra;Kodėlčiukai;9437530221;Ne;7;4;0;11
16490;Aušra;Kodėlčiukai;3627487971;Ne;2;4;0;6
16491;Aušra;Kodėlčiukai;7367602247;Ne;0;4;0;4
16492;Aušra;Smalsučiai;4010347313;Ne;0;8;0;8
16493;Aušra;Smalsučiai;5993984086;Ne;3;2;0;5
16494;Aušra;Smalsučiai;1630814772;Ne;1;3;0;4
16495;Aušra;Smalsučiai;2768220823;Ne;2;12;0;14
16496;Aušra;Smalsučiai;4000881716;Ne;3;4;0;7
16497;Aušra;Smalsučiai;5268479689;Ne;0;2;0;2
16498;Aušra;Smalsučiai;7710131755;Ne;2;5;0;7
16499;Aušra;Smalsučiai;8884580599;Ne;2;0;0;2
16500;Aušra;Smalsučiai;3468946868;Ne;10;6;0;16
16501;Aušra;Smalsučiai;8021547491;Ne;0;1;0;1
16502;Aušra;Smalsučiai;5925213006;Ne;14;0;0;14
16503;Aušra;Smalsučiai;2495610772;Ne;0;9;0;9
16504;Aušra;Smalsučiai;3526010606;Ne;0;4;0;4
16505;Aušra;Smalsučiai;4339450816;Ne;0;10;0;10
16506;Aušra;Smalsučiai;4163605313;Ne;0;9;0;9
16507;Aušra;Smalsučiai;6614027605;Ne;0;3;0;3
16508;Aušra;Smalsučiai;3860755808;Ne;0;7;0;7
16509;Aušra;Smalsučiai;2039920706;Ne;0;5;0;5
16510;Aušra;Smalsučiai;9333701196;Ne;0;8;0;8
16511;Aušra;Smalsučiai;8584355573;Ne;0;9;0;9
16512;Aušra;Smalsučiai;6965081051;Ne;0;7;0;7
16513;Aušra;Smalsučiai;8489362814;Ne;2;6;0;8
16514;Aušra;Smalsučiai;3675175233;Ne;0;6;0;6
16515;Aušra;"1A klasė";5524681006;Ne;0;4;0;4
16516;Aušra;"1A klasė";4404047456;Ne;0;4;0;4
16517;Aušra;"1A klasė";3680329197;Ne;0;4;0;4
16518;Aušra;"1A klasė";1575761029;Ne;1;4;0;5
16519;Aušra;"1A klasė";97102749430;Ne;0;4;0;4
16520;Aušra;"1A klasė";5777939563;Ne;0;4;0;4
16521;Aušra;"1A klasė";8740755922;Ne;0;4;0;4
16522;Aušra;"1A klasė";8500642069;Ne;0;4;0;4
16523;Aušra;"1A klasė";1450251779;Ne;0;4;0;4
16524;Aušra;"1A klasė";8176840834;Ne;0;4;0;4
16525;Aušra;"1A klasė";4922560649;Ne;1;4;0;5
16526;Aušra;"1A klasė";4946988585;Ne;0;4;0;4
16527;Aušra;"1A klasė";3767301684;Ne;1;4;0;5
16528;Aušra;"1A klasė";8755231814;Ne;0;4;0;4
16529;Aušra;"1A klasė";1625009666;Ne;0;4;0;4
16530;Aušra;"1A klasė";9058688663;Ne;0;4;0;4
16531;Aušra;"1A klasė";4468214107;Ne;2;4;0;6
16532;Aušra;"1A klasė";7708360056;Ne;0;4;0;4
16533;Aušra;"1A klasė";8096035110;Ne;0;4;0;4
16534;Aušra;"1A klasė";1687206394;Ne;0;4;0;4
16535;Aušra;"1A klasė";1557503831;Ne;3;4;0;7
16536;Aušra;"1A klasė";1636794584;Ne;0;4;0;4
16537;Aušra;"1A klasė";5258444578;Ne;5;4;0;9
16538;Aušra;"1A klasė";1612662076;Ne;1;4;0;5
16539;Aušra;"1A klasė";4013275108;Ne;0;4;0;4
16540;Aušra;"1B klasė";5409157554;Ne;4;4;0;8
16541;Aušra;"1B klasė";8709340592;Ne;2;4;0;6
16542;Aušra;"1B klasė";1940882109;Ne;3;4;0;7
16543;Aušra;"1B klasė";6384243597;Ne;2;4;0;6
16544;Aušra;"1B klasė";3898178166;Ne;0;4;0;4
16545;Aušra;"1B klasė";1343532870;Ne;2;4;0;6
16546;Aušra;"1B klasė";9614562473;Ne;2;4;0;6
16547;Aušra;"1B klasė";7921251819;Ne;9;4;0;13
16548;Aušra;"1B klasė";2523842161;Ne;1;4;0;5
16549;Aušra;"1B klasė";1465584524;Ne;3;4;0;7
16550;Aušra;"1B klasė";8036572198;Ne;3;4;0;7
16551;Aušra;"1B klasė";8525869648;Ne;1;4;0;5
16552;Aušra;"1B klasė";9589692031;Ne;3;4;0;7
16553;Aušra;"1B klasė";9972967198;Ne;2;4;0;6
16554;Aušra;"1B klasė";5522008237;Ne;1;4;0;5
16555;Aušra;"1B klasė";5269927048;Ne;4;4;0;8
16556;Aušra;"1B klasė";6084096300;Ne;5;4;0;9
16557;Aušra;"1B klasė";10796114623;Ne;1;4;0;5
16558;Aušra;"1B klasė";2052892422;Ne;3;4;0;7
16559;Aušra;"1B klasė";9197020006;Ne;3;4;0;7
16560;Aušra;"1B klasė";7178676049;Ne;0;4;0;4
16561;Aušra;"1B klasė";1298724775;Ne;1;4;0;5
16562;Aušra;"1B klasė";7918281270;Ne;4;4;0;8
16563;Aušra;"1B klasė";43123279348;Ne;4;4;0;8
16564;Aušra;"2A klasė";3001784066;Ne;0;4;0;4
16565;Aušra;"2A klasė";84116863778;Ne;3;4;0;7
16566;Aušra;"2A klasė";2227238810;Ne;0;4;0;4
16567;Aušra;"2A klasė";59837942520;Ne;3;4;0;7
16568;Aušra;"2A klasė";11053850075;Ne;0;4;0;4
16569;Aušra;"2A klasė";23609052737;Ne;0;4;0;4
16570;Aušra;"2A klasė";41017803426;Ne;0;4;0;4
16571;Aušra;"2A klasė";21544489661;Ne;0;4;0;4
16572;Aušra;"2A klasė";24625925423;Ne;5;4;0;9
16573;Aušra;"2A klasė";62186117615;Ne;5;4;0;9
16574;Aušra;"2A klasė";3526237179;Ne;0;4;0;4
16575;Aušra;"2A klasė";1893586984;Ne;0;19;0;19
16576;Aušra;"2A klasė";8686777160;Ne;0;4;0;4
16577;Aušra;"2A klasė";15657824495;Ne;0;4;0;4
16578;Aušra;"2A klasė";5988529284;Ne;1;4;0;5
16579;Aušra;"2A klasė";79051821501;Ne;0;4;0;4
16580;Aušra;"2A klasė";2062470430;Ne;1;4;0;5
16581;Aušra;"2A klasė";5815377310;Ne;0;4;0;4
16582;Aušra;"2A klasė";58254707316;Ne;0;4;0;4
16583;Aušra;"2A klasė";1385844067;Ne;0;4;0;4
16584;Aušra;"2A klasė";2121418946;Ne;0;4;0;4
16585;Aušra;"2A klasė";1219257874;Ne;0;19;0;19
16586;Aušra;"2A klasė";4325224130;Ne;0;4;0;4
16587;Aušra;"2A klasė";59267104215;Ne;0;4;0;4
16588;Aušra;"2A klasė";3732655408;Ne;0;4;0;4
16589;Aušra;"3A klasė";1049364899;Ne;0;4;0;4
16590;Aušra;"3A klasė";1473962346;Ne;0;4;0;4
16591;Aušra;"3A klasė";1427235223;Ne;3;4;0;7
16592;Aušra;"3A klasė";42344686036;Ne;4;4;0;8
16593;Aušra;"3A klasė";95586246863;Ne;0;4;0;4
16594;Aušra;"3A klasė";1167565535;Ne;0;4;0;4
16595;Aušra;"3A klasė";5468993286;Ne;0;4;0;4
16596;Aušra;"3A klasė";75047415039;Ne;0;4;0;4
16597;Aušra;"3A klasė";85826303673;Ne;1;4;0;5
16598;Aušra;"3A klasė";1145863002;Ne;4;4;0;8
16599;Aušra;"3A klasė";77966124767;Ne;2;4;0;6
16600;Aušra;"3A klasė";97312326369;Ne;1;4;0;5
16601;Aušra;"3A klasė";48817619537;Ne;1;4;0;5
16602;Aušra;"3A klasė";55937499558;Ne;0;4;0;4
16603;Aušra;"3A klasė";35779814505;Ne;0;4;0;4
16604;Aušra;"3A klasė";76280361479;Ne;0;4;0;4
16605;Aušra;"3A klasė";2131349938;Ne;0;4;0;4
16606;Aušra;"3A klasė";1455625997;Ne;0;4;0;4
16607;Aušra;"3A klasė";36447115547;Ne;0;4;0;4
16608;Aušra;"3A klasė";1393006122;Ne;0;4;0;4
16609;Aušra;"3A klasė";7998332115;Ne;0;4;0;4
16610;Aušra;"3A klasė";2647629246;Ne;0;4;0;4
16611;Aušra;"3A klasė";14611425618;Ne;0;19;0;19
16612;Aušra;"3A klasė";31458685084;Ne;0;4;0;4
16613;Aušra;"3A klasė";1315930711;Ne;0;4;0;4
16614;Aušra;"3A klasė";4110537888;Ne;1;4;0;5
16615;Aušra;"3A klasė";9603569117;Ne;0;4;0;4
16616;Aušra;"3A klasė";2019480768;Ne;0;4;0;4
16617;Aušra;"4A klasė";40499781883;Ne;3;4;0;7
16618;Aušra;"4A klasė";73509864636;Ne;0;4;0;4
16619;Aušra;"4A klasė";8510995681;Ne;1;4;0;5
16620;Aušra;"4A klasė";13157844661;Ne;0;4;0;4
16621;Aušra;"4A klasė";70233681803;Ne;0;19;0;19
16622;Aušra;"4A klasė";68160889669;Ne;0;4;0;4
16623;Aušra;"4A klasė";97781409787;Ne;0;4;0;4
16624;Aušra;"4A klasė";9605206310;Ne;2;4;0;6
16625;Aušra;"4A klasė";88655846176;Ne;2;4;0;6
16626;Aušra;"4A klasė";3284383302;Ne;0;4;0;4
16627;Aušra;"4A klasė";1437126272;Ne;0;4;0;4
16628;Aušra;"4A klasė";39537089288;Ne;0;4;0;4
16629;Aušra;"4A klasė";3965445196;Ne;0;4;0;4
16630;Aušra;"4A klasė";85578471272;Ne;0;19;0;19
16631;Aušra;"4A klasė";27958163601;Ne;0;4;0;4
16632;Aušra;"4A klasė";68031503463;Ne;0;19;0;19
16633;Aušra;"4A klasė";81633973264;Ne;0;19;0;19
16634;Aušra;"4A klasė";52985512945;Ne;0;19;0;19
16635;Aušra;"4A klasė";51185323645;Ne;0;19;0;19
16636;Aušra;"4A klasė";1437385365;Ne;0;19;0;19
16637;Aušra;"4A klasė";15330844181;Ne;0;19;0;19
16638;Aušra;"4A klasė";2062775070;Ne;0;19;0;19
16639;Aušra;"4A klasė";14157070764;Ne;1;4;0;5
16640;Aušra;"4A klasė";99073448709;Ne;0;4;0;4
16641;Aušra;"4A klasė";40714551025;Ne;0;4;0;4
16642;Aušra;"4A klasė";58699109274;Ne;0;4;0;4
16643;Aušra;"2B klasė";1988459596;Ne;0;4;0;4
16644;Aušra;"2B klasė";4930807661;Ne;0;4;0;4
16645;Aušra;"2B klasė";86128256406;Ne;0;4;0;4
16646;Aušra;"2B klasė";50687988382;Ne;0;4;0;4
16647;Aušra;"2B klasė";1021183555;Ne;0;4;0;4
16648;Aušra;"2B klasė";41268510292;Ne;0;4;0;4
16649;Aušra;"2B klasė";8428069167;Ne;0;4;0;4
16650;Aušra;"2B klasė";3910688753;Ne;2;4;0;6
16651;Aušra;"2B klasė";4024898537;Ne;1;4;0;5
16652;Aušra;"2B klasė";1238171728;Ne;0;4;0;4
16653;Aušra;"2B klasė";4103951942;Ne;0;4;0;4
16654;Aušra;"2B klasė";46481555688;Ne;1;4;0;5
16655;Aušra;"2B klasė";1063755068;Ne;4;4;0;8
16656;Aušra;"2B klasė";70844824182;Ne;0;4;0;4
16657;Aušra;"2B klasė";17098859260;Ne;0;4;0;4
16658;Aušra;"2B klasė";9940683245;Ne;0;4;0;4
16659;Aušra;"2B klasė";2841526614;Ne;0;4;0;4
16660;Aušra;"2B klasė";8813044848;Ne;6;4;0;10
16661;Aušra;"2B klasė";58741201573;Ne;0;4;0;4
16662;Aušra;"2B klasė";2003368811;Ne;0;4;0;4
16663;Aušra;"2B klasė";65840410497;Ne;0;4;0;4
16664;Aušra;"2B klasė";1640356242;Ne;1;4;0;5
16665;Aušra;"2B klasė";90604001837;Ne;1;4;0;5
16666;Aušra;"2B klasė";7794899167;Ne;0;4;0;4
16667;Aušra;Pabiručiai;8769357172;Ne;2;5;0;7
16668;Aušra;Pabiručiai;8462418277;Ne;0;4;0;4
16669;Aušra;Pabiručiai;6555345047;Ne;5;5;0;10
16670;Aušra;Pabiručiai;1306616759;Ne;6;2;0;8
16671;Aušra;Pabiručiai;3336605264;Ne;6;3;0;9
16672;Aušra;Pabiručiai;7476662446;Ne;0;3;0;3
16673;Aušra;Pabiručiai;7199483890;Ne;4;5;0;9
16674;Aušra;Pabiručiai;9466807067;Ne;12;4;0;16
16675;Aušra;Pabiručiai;3008573040;Ne;5;4;0;9
16676;Aušra;Pabiručiai;7926621700;Ne;0;3;0;3
16677;Aušra;Pabiručiai;2904303784;Ne;0;4;0;4
16678;Aušra;Pabiručiai;7888891808;Ne;5;1;0;6
16679;Aušra;Pabiručiai;7944904281;Ne;0;5;0;5
16680;Aušra;Pabiručiai;4646215025;Ne;2;3;0;5
16681;Aušra;Pabiručiai;6056923592;Ne;0;2;0;2
16682;Aušra;Pabiručiai;8665364744;Taip;6;4;0;10
16683;Aušra;Pabiručiai;3553620602;Ne;9;0;0;9
16684;Aušra;Pabiručiai;4071233786;Ne;0;1;0;1
16685;Aušra;Pabiručiai;3953653896;Ne;10;4;0;14
16686;Aušra;Pabiručiai;6508435821;Ne;9;2;0;11
16687;Aušra;Pabiručiai;5797692122;Ne;9;1;0;10
16688;Aušra;Pabiručiai;7159809546;Ne;0;6;0;6
16689;Aušra;Pabiručiai;7542690501;Ne;0;4;0;4
16690;Aušra;Pabiručiai;3759593393;Ne;0;4;0;4
16691;Aušra;Pabiručiai;2273160688;Ne;5;4;0;9
16692;Aušra;Gudručiai;1933801749;Ne;0;5;0;5
16693;Aušra;Gudručiai;6658178519;Ne;0;2;0;2
16694;Aušra;Gudručiai;5854637278;Ne;0;8;0;8
16695;Aušra;Gudručiai;4564561993;Ne;0;3;0;3
16696;Aušra;Gudručiai;2243689816;Ne;5;4;0;9
16697;Aušra;Gudručiai;5955385407;Ne;6;4;0;10
16698;Aušra;Gudručiai;2271582954;Ne;0;3;0;3
16699;Aušra;Gudručiai;9628651723;Ne;0;7;0;7
16700;Aušra;Gudručiai;1337138547;Ne;0;5;0;5
16701;Aušra;Gudručiai;3343235857;Ne;0;4;0;4
16702;Aušra;Gudručiai;8715912139;Ne;0;3;0;3
16703;Aušra;Gudručiai;7783006852;Ne;0;1;3;4
16704;Aušra;Gudručiai;1429548355;Ne;0;4;0;4
16705;Aušra;Gudručiai;1693711284;Ne;0;1;0;1
16706;Aušra;Gudručiai;6935310711;Ne;0;5;0;5
16707;Aušra;Gudručiai;3698868934;Ne;10;4;0;14
16708;Aušra;Gudručiai;9079804366;Ne;0;4;0;4
16709;Aušra;Gudručiai;3498143162;Ne;0;4;0;4
16710;Aušra;Gudručiai;5053808615;Ne;0;2;0;2
16711;Aušra;Gudručiai;2093165104;Ne;0;6;0;6
16712;Aušra;Naminukai;5596076175;Ne;10;5;0;15
16713;Aušra;Naminukai;5029468798;Ne;2;5;0;7
16714;Aušra;Naminukai;3889084120;Ne;8;4;0;12
16715;Aušra;Naminukai;9817943569;Ne;0;4;1;5
16716;Aušra;Naminukai;9783616691;Ne;4;5;0;9
16717;Aušra;Naminukai;7432671713;Ne;0;4;0;4
16718;Aušra;Naminukai;3600378899;Ne;4;1;0;5
16719;Aušra;Naminukai;2372043385;Ne;0;4;0;4
16720;Aušra;Naminukai;8872977307;Taip;8;4;0;12
16721;Aušra;Naminukai;5943702240;Ne;8;4;0;12
16722;Aušra;Naminukai;7833475076;Ne;11;4;0;15
16723;Aušra;Naminukai;4856488024;Ne;10;0;0;10
16724;Aušra;Naminukai;1415288593;Ne;2;4;3;9
16725;Aušra;Naminukai;2831726456;Ne;0;4;1;5
16726;Aušra;Naminukai;5245988936;Ne;0;4;4;8
16727;Aušra;Naminukai;3017627321;Ne;7;1;0;8
16728;Aušra;Naminukai;2109806524;Ne;6;1;0;7
16729;Aušra;Naminukai;4300801436;Ne;5;0;2;7
16730;Aušra;Naminukai;4824331856;Ne;5;4;1;10
16731;Aušra;Naminukai;4779994281;Ne;6;0;0;6
16732;Aušra;Naminukai;5270770998;Ne;5;4;0;9
16733;Aušra;"2 C klasė";1426802917;Ne;0;4;0;4
16734;Aušra;"2 C klasė";26010333641;Ne;3;4;0;7
16735;Aušra;"2 C klasė";3133031845;Ne;1;4;0;5
16736;Aušra;"2 C klasė";11130172902;Ne;0;4;0;4
16737;Aušra;"2 C klasė";43737170074;Ne;0;4;0;4
16738;Aušra;"2 C klasė";1370336984;Ne;5;4;0;9
16739;Aušra;"2 C klasė";6483078840;Ne;0;4;0;4
16740;Aušra;"2 C klasė";1684481833;Ne;1;4;0;5
16741;Aušra;"2 C klasė";1198248619;Ne;0;4;0;4
16742;Aušra;"2 C klasė";4765125810;Ne;0;4;0;4
16743;Aušra;"2 C klasė";5704281727;Ne;0;4;0;4
16744;Aušra;"2 C klasė";1479311429;Ne;0;4;0;4
16745;Aušra;"2 C klasė";1542575012;Ne;0;4;0;4
16746;Aušra;"2 C klasė";1291782232;Ne;0;4;0;4
16747;Aušra;"2 C klasė";90520726029;Ne;0;4;0;4
16748;Aušra;"2 C klasė";1844632980;Ne;0;4;0;4
16749;Aušra;"2 C klasė";94478599707;Ne;0;4;0;4
16750;Aušra;"2 C klasė";78489473446;Ne;0;4;0;4
16751;Aušra;"2 C klasė";29328876924;Ne;0;4;0;4
16752;Aušra;"2 C klasė";7649832094;Ne;3;4;0;7
16753;Aušra;"2 C klasė";8225188274;Ne;1;4;0;5
16754;Aušra;"2 C klasė";1371282149;Ne;0;4;0;4
16755;Aušra;"2 C klasė";57559227292;Ne;1;4;0;5
16756;Berželis;PČIOLKI;3613459846;Ne;5;2;0;7
16757;Berželis;PČIOLKI;4923631429;Ne;0;3;0;3
16758;Berželis;PČIOLKI;7781031211;Ne;0;4;5;9
16759;Berželis;PČIOLKI;4546285993;Ne;0;19;0;19
16760;Berželis;PČIOLKI;7940591009;Ne;0;3;2;5
16761;Berželis;PČIOLKI;6352635742;Ne;0;16;1;17
16762;Berželis;PČIOLKI;2030770943;Ne;0;4;0;4
16763;Berželis;PČIOLKI;6942559693;Ne;4;3;0;7
16764;Berželis;PČIOLKI;5688897783;Ne;0;4;0;4
16765;Berželis;PČIOLKI;2016194182;Ne;0;4;0;4
16766;Berželis;PČIOLKI;5069322062;Ne;0;4;0;4
16767;Berželis;PČIOLKI;6577232093;Ne;0;3;0;3
16768;Berželis;PČIOLKI;9585609150;Ne;0;8;0;8
16769;Berželis;PČIOLKI;9091691636;Ne;0;5;0;5
16770;Berželis;PČIOLKI;2667957070;Ne;0;4;0;4
16771;Berželis;PČIOLKI;8448872491;Ne;0;3;0;3
16772;Berželis;PČIOLKI;6387242787;Ne;0;19;0;19
16773;Berželis;PČIOLKI;2954451168;Ne;0;6;0;6
16774;Berželis;"BOŽJI KOROVKI";3162044236;Ne;0;1;0;1
16775;Berželis;"BOŽJI KOROVKI";7421059780;Ne;0;4;1;5
16776;Berželis;"BOŽJI KOROVKI";4100740863;Ne;0;7;0;7
16777;Berželis;"BOŽJI KOROVKI";5953387226;Ne;8;7;0;15
16778;Berželis;"BOŽJI KOROVKI";3070917065;Ne;7;6;0;13
16779;Berželis;"BOŽJI KOROVKI";8118040960;Ne;0;6;0;6
16780;Berželis;"BOŽJI KOROVKI";9848723402;Ne;0;4;0;4
16781;Berželis;"BOŽJI KOROVKI";5551459997;Ne;0;5;0;5
16782;Berželis;"BOŽJI KOROVKI";6651007152;Ne;3;2;0;5
16783;Berželis;"BOŽJI KOROVKI";8451877584;Ne;0;4;0;4
16784;Berželis;"BOŽJI KOROVKI";7080168105;Ne;0;1;0;1
16785;Berželis;"BOŽJI KOROVKI";9438498834;Ne;0;2;2;4
16786;Berželis;"BOŽJI KOROVKI";1132252592;Ne;10;1;0;11
16787;Berželis;"BOŽJI KOROVKI";5550598069;Ne;3;5;0;8
16788;Berželis;"BOŽJI KOROVKI";1852964349;Ne;0;5;0;5
16789;Berželis;"BOŽJI KOROVKI";8871199713;Ne;4;0;0;4
16790;Berželis;"BOŽJI KOROVKI";1722262813;Ne;0;3;0;3
16791;Berželis;"BOŽJI KOROVKI";9466461910;Ne;10;4;0;14
16792;Berželis;"BOŽJI KOROVKI";2901168499;Ne;2;1;0;3
16793;Berželis;"BOŽJI KOROVKI";1498165322;Ne;0;0;5;5
16794;Berželis;SOLNYŠKO;7411282628;Ne;13;0;0;13
16795;Berželis;SOLNYŠKO;8957312159;Ne;2;0;3;5
16796;Berželis;SOLNYŠKO;1167103292;Ne;9;0;0;9
16797;Berželis;SOLNYŠKO;5408368340;Ne;0;0;8;8
16798;Berželis;SOLNYŠKO;1070751052;Ne;7;0;1;8
16799;Berželis;SOLNYŠKO;5464385395;Ne;0;3;0;3
16800;Berželis;SOLNYŠKO;6422037185;Ne;0;0;1;1
16801;Berželis;SOLNYŠKO;1424868444;Ne;8;7;0;15
16802;Berželis;SOLNYŠKO;1146976812;Ne;0;4;0;4
16803;Berželis;SOLNYŠKO;6774460279;Ne;16;3;0;19
16804;Berželis;SOLNYŠKO;5866092980;Taip;0;0;3;3
16805;Berželis;SOLNYŠKO;9750863775;Ne;0;2;0;2
16806;Berželis;SOLNYŠKO;2146432569;Ne;14;0;0;14
16807;Berželis;SOLNYŠKO;4125566288;Ne;6;0;0;6
16808;Berželis;SOLNYŠKO;1503116062;Ne;11;0;1;12
16809;Berželis;SOLNYŠKO;8353172510;Ne;7;4;0;11
16810;Berželis;SOLNYŠKO;6281925938;Ne;6;7;0;13
16811;Berželis;SOLNYŠKO;5739847580;Ne;0;3;0;3
16812;Berželis;SOLNYŠKO;5194480946;Ne;3;3;0;6
16813;Berželis;BABOČKI;7535016799;Ne;3;0;1;4
16814;Berželis;BABOČKI;3929755468;Ne;5;0;1;6
16815;Berželis;BABOČKI;3118835709;Ne;9;0;0;9
16816;Berželis;BABOČKI;4511595124;Ne;4;0;0;4
16817;Berželis;BABOČKI;9233307928;Ne;0;19;0;19
16818;Berželis;BABOČKI;6476593246;Ne;3;0;0;3
16819;Berželis;BABOČKI;7672845584;Ne;3;0;1;4
16820;Berželis;BABOČKI;5460675556;Ne;10;0;0;10
16821;Berželis;BABOČKI;6465432599;Ne;9;0;0;9
16822;Berželis;BABOČKI;5357039865;Ne;2;0;2;4
16823;Berželis;BABOČKI;9300262294;Ne;2;1;0;3
16824;Berželis;SOVUŠKI;5350402890;Ne;2;0;1;3
16825;Berželis;SOVUŠKI;8185887403;Ne;6;0;0;6
16826;Berželis;SOVUŠKI;8989621715;Ne;3;0;0;3
16827;Berželis;SOVUŠKI;1289333809;Ne;0;0;1;1
16828;Berželis;SOVUŠKI;8086074279;Ne;4;3;0;7
16829;Berželis;SOVUŠKI;9273819928;Ne;4;2;0;6
16830;Berželis;SOVUŠKI;1769470120;Ne;3;3;1;7
16831;Berželis;SOVUŠKI;3885474466;Ne;4;0;0;4
16832;Berželis;SOVUŠKI;1825910306;Ne;4;0;0;4
16833;Berželis;SOVUŠKI;6706273205;Ne;6;0;0;6
16834;Berželis;SOVUŠKI;2895332184;Ne;11;0;0;11
16835;Berželis;SOVUŠKI;1464998584;Ne;12;0;1;13
16836;Berželis;SOVUŠKI;2844736188;Ne;7;0;0;7
16837;Berželis;SOVUŠKI;3835273594;Ne;14;0;0;14
16838;Berželis;SOVUŠKI;2632535013;Ne;1;6;0;7
16839;Berželis;SOVUŠKI;6698849108;Ne;7;0;0;7
16840;Berželis;SOVUŠKI;1583268041;Ne;3;2;0;5
16841;Berželis;SOVUŠKI;5925726854;Ne;9;0;0;9
16842;Berželis;SOVUŠKI;1044720859;Ne;0;5;0;5
16843;Berželis;SOVUŠKI;2615832804;Ne;3;8;0;11
16844;Berželis;PODSOLNUŠKI;3157906472;Ne;3;4;0;7
16845;Berželis;PODSOLNUŠKI;9945124824;Ne;5;2;0;7
16846;Berželis;PODSOLNUŠKI;8168498937;Ne;3;2;0;5
16847;Berželis;PODSOLNUŠKI;9072126286;Ne;7;0;1;8
16848;Berželis;PODSOLNUŠKI;8633724383;Ne;11;3;0;14
16849;Berželis;PODSOLNUŠKI;2259367998;Ne;0;3;3;6
16850;Berželis;PODSOLNUŠKI;3033042487;Ne;16;0;0;16
16851;Berželis;PODSOLNUŠKI;2136455625;Ne;2;6;1;9
16852;Berželis;PODSOLNUŠKI;1964320071;Ne;6;4;0;10
16853;Berželis;PODSOLNUŠKI;9133988149;Ne;0;9;0;9
16854;Berželis;PODSOLNUŠKI;5795151632;Ne;2;4;0;6
16855;Berželis;PODSOLNUŠKI;6686248053;Ne;0;3;0;3
16856;Berželis;PODSOLNUŠKI;5963915092;Ne;5;0;0;5
16857;Berželis;PODSOLNUŠKI;3378237475;Ne;5;0;0;5
16858;Berželis;PODSOLNUŠKI;4681334359;Ne;4;0;2;6
16859;Berželis;LAPIUKAI;3813964138;Ne;0;4;0;4
16860;Berželis;LAPIUKAI;9658062645;Ne;0;3;0;3
16861;Berželis;LAPIUKAI;9681310544;Taip;0;0;3;3
16862;Berželis;LAPIUKAI;9543499205;Ne;0;0;1;1
16863;Berželis;LAPIUKAI;9749516260;Ne;3;1;3;7
16864;Berželis;LAPIUKAI;4243086262;Ne;0;0;4;4
16865;Berželis;LAPIUKAI;8994102218;Taip;0;1;1;2
16866;Berželis;LAPIUKAI;4854931959;Ne;0;0;1;1
16867;Berželis;LAPIUKAI;9234691627;Ne;0;0;6;6
16868;Berželis;LAPIUKAI;4437437529;Taip;4;0;0;4
16869;Berželis;LAPIUKAI;9562165121;Ne;6;0;0;6
16870;Berželis;LAPIUKAI;7848240865;Ne;7;0;1;8
16871;Berželis;LAPIUKAI;7545277683;Ne;0;4;0;4
16872;Berželis;LAPIUKAI;7807553847;Ne;0;0;3;3
16873;Berželis;LAPIUKAI;1456066646;Ne;0;0;3;3
16874;Berželis;LAPIUKAI;9459031158;Ne;0;3;0;3
16875;Berželis;LAPIUKAI;6186408090;Ne;0;0;3;3
16876;Berželis;LAPIUKAI;1673524685;Ne;0;0;3;3
16877;Berželis;LAPIUKAI;7902774064;Taip;0;0;7;7
16878;Berželis;MEŠKIUKAI;2062794406;Ne;5;0;0;5
16879;Berželis;MEŠKIUKAI;9178527605;Taip;4;0;0;4
16880;Berželis;MEŠKIUKAI;1235617054;Ne;11;1;0;12
16881;Berželis;MEŠKIUKAI;1178588907;Ne;5;0;0;5
16882;Berželis;MEŠKIUKAI;5100214127;Ne;1;0;0;1
16883;Berželis;MEŠKIUKAI;3535856504;Taip;9;0;0;9
16884;Berželis;MEŠKIUKAI;8560266611;Ne;15;0;0;15
16885;Berželis;MEŠKIUKAI;3936106342;Ne;5;0;0;5
16886;Berželis;MEŠKIUKAI;6689893827;Ne;7;0;0;7
16887;Berželis;MEŠKIUKAI;8251510865;Ne;0;4;4;8
16888;Berželis;MEŠKIUKAI;9182053246;Ne;1;0;0;1
16889;Berželis;MEŠKIUKAI;7374231804;Ne;4;0;0;4
16890;Berželis;MEŠKIUKAI;6394357191;Ne;10;0;0;10
16891;Berželis;MEŠKIUKAI;8552923414;Ne;6;4;0;10
16892;Berželis;MEŠKIUKAI;3528575340;Ne;12;0;0;12
16893;Berželis;ŽIEDELIAI;3786609012;Ne;6;0;0;6
16894;Berželis;ŽIEDELIAI;9805181733;Ne;6;0;1;7
16895;Berželis;ŽIEDELIAI;2016827207;Ne;0;2;3;5
16896;Berželis;ŽIEDELIAI;9979442772;Ne;7;0;6;13
16897;Berželis;ŽIEDELIAI;9881246268;Ne;0;1;3;4
16898;Berželis;ŽIEDELIAI;7042967329;Ne;13;0;0;13
16899;Berželis;ŽIEDELIAI;9925865228;Ne;10;0;0;10
16900;Berželis;ŽIEDELIAI;1402975280;Ne;0;5;0;5
16901;Berželis;ŽIEDELIAI;2030492491;Ne;9;3;1;13
16902;Berželis;ŽIEDELIAI;3351114197;Ne;0;0;11;11
16903;Berželis;ŽIEDELIAI;5248880873;Ne;9;4;0;13
16904;Berželis;ŽIEDELIAI;2508532190;Ne;0;0;5;5
16905;Berželis;ŽIEDELIAI;2947072348;Ne;0;7;0;7
16906;Berželis;ŽIEDELIAI;7947225506;Ne;3;4;1;8
16907;Berželis;ŽIEDELIAI;1834920753;Taip;0;0;4;4
16908;Berželis;ŽIEDELIAI;6384939601;Ne;0;0;1;1
16909;Berželis;ŽIEDELIAI;2410514408;Ne;0;4;1;5
16910;Berželis;ŽIEDELIAI;2794074071;Taip;5;0;4;9
16911;Berželis;NYKŠTUKAI;8148104183;Ne;1;4;4;9
16912;Berželis;NYKŠTUKAI;7935684899;Ne;7;0;9;16
16913;Berželis;NYKŠTUKAI;1403664386;Ne;0;10;0;10
16914;Berželis;NYKŠTUKAI;5637168259;Ne;0;0;3;3
16915;Berželis;NYKŠTUKAI;9666648116;Ne;4;4;8;16
16916;Berželis;NYKŠTUKAI;3559065542;Ne;2;4;0;6
16917;Berželis;NYKŠTUKAI;3556594755;Ne;3;0;9;12
16918;Berželis;NYKŠTUKAI;2933069798;Ne;3;2;3;8
16919;Berželis;NYKŠTUKAI;8430372047;Ne;4;4;4;12
16920;Berželis;NYKŠTUKAI;5099275362;Taip;0;0;3;3
16921;Berželis;NYKŠTUKAI;5101382213;Ne;13;0;0;13
16922;Berželis;NYKŠTUKAI;7676141462;Ne;0;4;0;4
16923;Berželis;NYKŠTUKAI;3852021563;Ne;1;0;4;5
16924;Berželis;NYKŠTUKAI;3379227410;Ne;5;0;0;5
16925;Berželis;NYKŠTUKAI;4032178538;Taip;0;4;1;5
16926;Berželis;NYKŠTUKAI;5839964720;Ne;0;4;0;4
16927;Berželis;NYKŠTUKAI;5012540410;Ne;0;4;0;4
16928;Berželis;NYKŠTUKAI;9925281959;Ne;8;0;9;17
16929;Berželis;NYKŠTUKAI;5326178821;Ne;0;4;1;5
16930;Berželis;UOGELĖS;8735934456;Ne;0;1;0;1
16931;Berželis;UOGELĖS;6136155301;Ne;6;0;4;10
16932;Berželis;UOGELĖS;9950641759;Ne;0;0;4;4
16933;Berželis;UOGELĖS;9034464618;Ne;0;3;0;3
16934;Berželis;UOGELĖS;2321608974;Ne;0;8;0;8
16935;Berželis;UOGELĖS;3229996417;Ne;0;4;1;5
16936;Berželis;UOGELĖS;7750905743;Taip;0;1;0;1
16937;Berželis;UOGELĖS;4607486516;Ne;7;0;2;9
16938;Berželis;UOGELĖS;1847117067;Taip;4;0;4;8
16939;Berželis;UOGELĖS;4672663741;Taip;0;0;6;6
16940;Berželis;UOGELĖS;1307377636;Ne;0;4;0;4
16941;Berželis;KODĖLČIUKAI;5786052354;Ne;4;3;0;7
16942;Berželis;KODĖLČIUKAI;5134372871;Ne;0;0;1;1
16943;Berželis;KODĖLČIUKAI;7852089381;Ne;0;0;5;5
16944;Berželis;KODĖLČIUKAI;5751995154;Ne;4;0;4;8
16945;Berželis;KODĖLČIUKAI;3589890886;Ne;0;2;0;2
16946;Berželis;KODĖLČIUKAI;1127524998;Ne;2;8;2;12
16947;Berželis;KODĖLČIUKAI;3951962738;Taip;5;3;1;9
16948;Berželis;KODĖLČIUKAI;2193392844;Taip;0;0;7;7
16949;Berželis;KODĖLČIUKAI;9696962207;Ne;0;0;3;3
16950;Berželis;KODĖLČIUKAI;8286301258;Ne;10;2;0;12
16951;Berželis;KODĖLČIUKAI;6500588668;Ne;1;0;4;5
16952;Berželis;KODĖLČIUKAI;3327751482;Ne;0;0;2;2
16953;Berželis;KODĖLČIUKAI;6060490387;Taip;4;0;1;5
16954;Berželis;KODĖLČIUKAI;9418230816;Ne;0;10;2;12
16955;Berželis;KODĖLČIUKAI;4254592648;Ne;8;4;0;12
16956;Berželis;KODĖLČIUKAI;2144796691;Ne;7;7;0;14
16957;Berželis;KODĖLČIUKAI;8737788279;Ne;0;0;5;5
16958;Saulutė;Drugeliai;5987478379;Ne;0;15;0;15
16959;Saulutė;Drugeliai;5943795519;Ne;7;0;0;7
16960;Saulutė;Drugeliai;4067009709;Ne;1;4;0;5
16961;Saulutė;Drugeliai;3991128892;Ne;9;1;0;10
16962;Saulutė;Drugeliai;7689842018;Ne;2;0;0;2
16963;Saulutė;Drugeliai;4288298305;Ne;9;4;0;13
16964;Saulutė;Drugeliai;9133269796;Ne;9;0;0;9
16965;Saulutė;Drugeliai;6057938367;Ne;4;4;0;8
16966;Saulutė;Drugeliai;1268204445;Ne;7;0;0;7
16967;Saulutė;Drugeliai;1585403702;Ne;4;0;0;4
16968;Saulutė;Drugeliai;4915192103;Ne;5;0;0;5
16969;Saulutė;Drugeliai;8003855875;Ne;5;0;0;5
16970;Saulutė;Drugeliai;2301903550;Ne;13;0;0;13
16971;Saulutė;Drugeliai;2337702344;Ne;19;0;0;19
16972;Saulutė;Drugeliai;3662919521;Ne;0;4;0;4
16973;Saulutė;Drugeliai;6455593653;Ne;0;5;0;5
16974;Saulutė;Drugeliai;9410517602;Ne;13;0;0;13
16975;Saulutė;Drugeliai;1088813143;Ne;6;0;0;6
16976;Saulutė;Drugeliai;6304028361;Ne;10;0;0;10
16977;Saulutė;Drugeliai;7139492238;Ne;4;0;0;4
16978;Saulutė;Drugeliai;2750955550;Ne;19;0;0;19
16979;Saulutė;Drugeliai;5931269521;Ne;10;0;0;10
16980;Saulutė;Drugeliai;3730442890;Ne;0;6;0;6
16981;Saulutė;Drugeliai;8409958782;Ne;18;0;0;18
16982;Saulutė;"Saulės zuikučiai";6924891265;Ne;5;4;0;9
16983;Saulutė;"Saulės zuikučiai";5448950324;Ne;11;4;0;15
16984;Saulutė;"Saulės zuikučiai";3948540247;Ne;6;1;0;7
16985;Saulutė;"Saulės zuikučiai";4130972647;Ne;14;0;0;14
16986;Saulutė;"Saulės zuikučiai";3242810449;Ne;0;8;0;8
16987;Saulutė;"Saulės zuikučiai";9110162513;Ne;0;3;2;5
16988;Saulutė;"Saulės zuikučiai";1648978545;Ne;8;3;0;11
16989;Saulutė;"Saulės zuikučiai";6927834443;Taip;0;13;0;13
16990;Saulutė;"Saulės zuikučiai";8714520840;Ne;10;7;0;17
16991;Saulutė;"Saulės zuikučiai";9726675673;Ne;17;0;0;17
16992;Saulutė;"Saulės zuikučiai";8520474896;Ne;17;0;0;17
16993;Saulutė;"Saulės zuikučiai";6189637986;Ne;0;4;0;4
16994;Saulutė;"Saulės zuikučiai";7132125341;Ne;6;1;0;7
16995;Saulutė;"Saulės zuikučiai";3215349379;Ne;3;14;0;17
16996;Saulutė;"Saulės zuikučiai";3259790911;Ne;15;4;0;19
16997;Saulutė;"Saulės zuikučiai";7311594119;Ne;16;0;0;16
16998;Saulutė;"Saulės zuikučiai";9567511354;Ne;11;4;0;15
16999;Saulutė;"Saulės zuikučiai";6579874077;Ne;0;13;0;13
17000;Saulutė;"Saulės zuikučiai";6178908581;Ne;11;4;0;15
17001;Saulutė;"Saulės zuikučiai";8472510151;Ne;3;5;0;8
17002;Saulutė;"Saulės zuikučiai";7478215328;Ne;5;4;0;9
17003;Saulutė;"Saulės zuikučiai";9727366891;Ne;11;4;0;15
17004;Saulutė;"Saulės zuikučiai";4222649372;Ne;19;0;0;19
17005;Saulutė;Boružėlės;3295289082;Ne;0;6;0;6
17006;Saulutė;Boružėlės;1587328722;Ne;5;4;0;9
17007;Saulutė;Boružėlės;8390767549;Ne;7;4;0;11
17008;Saulutė;Boružėlės;7576532632;Ne;3;4;0;7
17009;Saulutė;Boružėlės;9314889468;Ne;9;4;0;13
17010;Saulutė;Boružėlės;7764493159;Ne;10;4;0;14
17011;Saulutė;Boružėlės;5565832676;Ne;3;4;0;7
17012;Saulutė;Boružėlės;5811810714;Ne;0;5;0;5
17013;Saulutė;Boružėlės;8643975544;Ne;2;4;0;6
17014;Saulutė;Boružėlės;7081700501;Ne;0;4;0;4
17015;Saulutė;Boružėlės;7474989619;Ne;3;11;0;14
17016;Saulutė;Boružėlės;1803710557;Ne;5;4;0;9
17017;Saulutė;Boružėlės;9173336078;Ne;4;1;0;5
17018;Saulutė;Boružėlės;9098663596;Ne;0;4;0;4
17019;Saulutė;Boružėlės;1265174091;Ne;5;4;0;9
17020;Saulutė;Boružėlės;2988010963;Ne;0;19;0;19
17021;Saulutė;Boružėlės;3852862834;Ne;2;4;0;6
17022;Saulutė;Boružėlės;1275552038;Ne;3;4;0;7
17023;Saulutė;Boružėlės;3363212754;Ne;5;6;0;11
17024;Saulutė;Boružėlės;8086759121;Ne;2;4;0;6
17025;Saulutė;Boružėlės;4840187188;Ne;13;4;0;17
17026;Saulutė;Nykštukai;2601822200;Ne;0;0;6;6
17027;Saulutė;Nykštukai;3244850673;Ne;0;9;0;9
17028;Saulutė;Nykštukai;5607937410;Ne;5;9;0;14
17029;Saulutė;Nykštukai;3571751974;Ne;0;0;2;2
17030;Saulutė;Nykštukai;3221612665;Ne;9;0;1;10
17031;Saulutė;Nykštukai;2140277182;Ne;13;4;0;17
17032;Saulutė;Nykštukai;4800144085;Ne;15;0;0;15
17033;Saulutė;Nykštukai;8257363228;Ne;0;0;7;7
17034;Saulutė;Nykštukai;9664809396;Ne;0;0;3;3
17035;Saulutė;Nykštukai;8984040932;Ne;7;6;0;13
17036;Saulutė;Nykštukai;3463428772;Ne;6;4;0;10
17037;Saulutė;Nykštukai;9930330487;Ne;10;3;0;13
17038;Saulutė;Nykštukai;7158455528;Ne;4;3;0;7
17039;Saulutė;Nykštukai;1229624643;Ne;14;0;0;14
17040;Saulutė;Nykštukai;9572394489;Ne;14;0;1;15
17041;Saulutė;Nykštukai;5509365461;Ne;5;0;0;5
17042;Saulutė;Nykštukai;3408369823;Ne;11;0;0;11
17043;Saulutė;Nykštukai;5264813819;Ne;4;0;0;4
17044;Saulutė;Nykštukai;3265401334;Ne;6;0;0;6
17045;Saulutė;Nykštukai;9497439410;Ne;0;10;0;10
17046;Saulutė;Nykštukai;5335820652;Ne;7;1;3;11
17047;Saulutė;Nykštukai;4510990261;Ne;15;0;0;15
17048;Saulutė;Nykštukai;7555183487;Ne;15;0;0;15
17049;Saulutė;Meškiukai;5219429911;Ne;4;0;3;7
17050;Saulutė;Meškiukai;8787977881;Ne;0;10;0;10
17051;Saulutė;Meškiukai;8147755754;Ne;17;0;0;17
17052;Saulutė;Meškiukai;1562476697;Ne;17;0;0;17
17053;Saulutė;Meškiukai;1776176097;Ne;18;0;0;18
17054;Saulutė;Meškiukai;1408451926;Ne;11;0;0;11
17055;Saulutė;Meškiukai;9175541045;Ne;5;0;0;5
17056;Saulutė;Meškiukai;6978306762;Ne;11;0;0;11
17057;Saulutė;Meškiukai;7757420187;Ne;18;0;0;18
17058;Saulutė;Meškiukai;1415128133;Ne;5;0;0;5
17059;Saulutė;Meškiukai;4451054381;Ne;5;0;0;5
17060;Saulutė;Meškiukai;9919098322;Ne;10;0;0;10
17061;Saulutė;Meškiukai;1848147862;Ne;10;7;0;17
17062;Saulutė;Meškiukai;3883395634;Ne;9;0;0;9
17063;Saulutė;Meškiukai;2929345460;Ne;16;0;0;16
17064;Saulutė;Meškiukai;9825396096;Ne;19;0;0;19
17065;Saulutė;Meškiukai;1175393220;Ne;6;0;0;6
17066;Saulutė;Meškiukai;8844784669;Ne;14;0;0;14
17067;Saulutė;Ežiukai;2813274509;Ne;10;0;0;10
17068;Saulutė;Ežiukai;2315812734;Ne;11;0;1;12
17069;Saulutė;Ežiukai;8736917541;Ne;7;0;6;13
17070;Saulutė;Ežiukai;4363210987;Ne;1;4;0;5
17071;Saulutė;Ežiukai;5972503001;Ne;0;4;5;9
17072;Saulutė;Ežiukai;6884472677;Ne;19;0;0;19
17073;Saulutė;Ežiukai;4194586403;Ne;14;0;0;14
17074;Saulutė;Ežiukai;1853984777;Ne;18;0;0;18
17075;Saulutė;Ežiukai;1666301750;Ne;15;4;0;19
17076;Saulutė;Ežiukai;3133714991;Ne;11;0;0;11
17077;Saulutė;Ežiukai;7967532537;Ne;0;0;2;2
17078;Saulutė;Ežiukai;2728669975;Ne;10;0;0;10
17079;Saulutė;Ežiukai;9398356470;Ne;0;0;11;11
17080;Saulutė;Ežiukai;6126870829;Ne;5;3;1;9
17081;Saulutė;Ežiukai;3565818383;Ne;0;0;6;6
17082;Saulutė;Ežiukai;9101950978;Ne;14;0;0;14
17083;Saulutė;Ežiukai;6982979199;Ne;9;0;3;12
17084;Saulutė;Ežiukai;8919457259;Ne;9;0;3;12
17085;Saulutė;Ežiukai;3125186472;Ne;19;0;0;19
17086;Saulutė;Ežiukai;7941601480;Ne;6;0;5;11
17087;Saulutė;Ežiukai;8961335897;Ne;15;0;0;15
17088;Saulutė;Ežiukai;4039065925;Ne;9;0;1;10
17089;Saulutė;Bitutės;5200638523;Ne;9;0;0;9
17090;Saulutė;Bitutės;5897526863;Ne;14;0;0;14
17091;Saulutė;Bitutės;6531388817;Ne;1;4;1;6
17092;Saulutė;Bitutės;1640977737;Ne;9;0;1;10
17093;Saulutė;Bitutės;8681103477;Ne;5;0;0;5
17094;Saulutė;Bitutės;2251663689;Ne;16;0;0;16
17095;Saulutė;Bitutės;8428335721;Ne;13;0;0;13
17096;Saulutė;Bitutės;5623547412;Ne;19;0;0;19
17097;Saulutė;Bitutės;1931298484;Ne;12;0;0;12
17098;Saulutė;Bitutės;5308928580;Ne;16;0;0;16
17099;Saulutė;Bitutės;9741004996;Ne;11;0;0;11
17100;Saulutė;Bitutės;3883903645;Ne;9;0;0;9
17101;Saulutė;Bitutės;2402895955;Ne;8;0;0;8
17102;Saulutė;Bitutės;4055603288;Ne;4;4;0;8
17103;Saulutė;Bitutės;8551251470;Ne;0;15;1;16
17104;Saulutė;Bitutės;2849357495;Ne;9;0;0;9
17105;Saulutė;Bitutės;1763631244;Ne;12;0;1;13
17106;Saulutė;Bitutės;7123687661;Ne;19;0;0;19
17107;Saulutė;Pelėdžiukai;8512137633;Ne;10;1;0;11
17108;Saulutė;Pelėdžiukai;4211866191;Ne;19;0;0;19
17109;Saulutė;Pelėdžiukai;2373409300;Ne;0;0;7;7
17110;Saulutė;Pelėdžiukai;8405262902;Taip;5;0;2;7
17111;Saulutė;Pelėdžiukai;1745754752;Ne;3;0;4;7
17112;Saulutė;Pelėdžiukai;4123500930;Ne;4;0;0;4
17113;Saulutė;Pelėdžiukai;1056158093;Ne;0;0;7;7
17114;Saulutė;Pelėdžiukai;8371366346;Ne;0;5;0;5
17115;Saulutė;Pelėdžiukai;6842585310;Ne;12;0;1;13
17116;Saulutė;Pelėdžiukai;1776164273;Ne;6;5;0;11
17117;Saulutė;Pelėdžiukai;5850783789;Ne;14;0;0;14
17118;Saulutė;Pelėdžiukai;7243072252;Ne;0;4;0;4
17119;Saulutė;Pelėdžiukai;9903380188;Ne;0;0;3;3
17120;Saulutė;Pelėdžiukai;2450554594;Ne;0;3;0;3
17121;Saulutė;Pelėdžiukai;7620841597;Ne;14;0;0;14
17122;Saulutė;Pelėdžiukai;7640441297;Ne;5;0;6;11
17123;Saulutė;Pelėdžiukai;6046611248;Ne;0;6;0;6
17124;Saulutė;Pelėdžiukai;4301516165;Ne;16;0;0;16
17125;Saulutė;Pelėdžiukai;7258180835;Ne;19;0;0;19
17126;Saulutė;Pelėdžiukai;2566263680;Ne;15;0;0;15
17127;Saulutė;Pelėdžiukai;9106119465;Ne;3;0;2;5
17128;Saulutė;Pelėdžiukai;4179271978;Ne;19;0;0;19
17129;Saulutė;Zylutės;3228226715;Ne;0;4;1;5
17130;Saulutė;Zylutės;8040751073;Ne;6;4;0;10
17131;Saulutė;Zylutės;2074473832;Ne;0;0;3;3
17132;Saulutė;Zylutės;6109527712;Ne;0;4;1;5
17133;Saulutė;Zylutės;4686825392;Ne;6;4;0;10
17134;Saulutė;Zylutės;7446423510;Ne;1;4;0;5
17135;Saulutė;Zylutės;8717210130;Ne;11;0;0;11
17136;Saulutė;Zylutės;8211523302;Ne;6;6;0;12
17137;Saulutė;Zylutės;3272296969;Ne;1;4;0;5
17138;Saulutė;Zylutės;7032417938;Taip;8;0;0;8
17139;Saulutė;Zylutės;1784093413;Ne;0;0;9;9
17140;Saulutė;Zylutės;8722717930;Ne;15;0;0;15
17141;Saulutė;Zylutės;5442075474;Ne;18;0;0;18
17142;Saulutė;Zylutės;4136425904;Ne;13;5;0;18
17143;Saulutė;Zylutės;4390098560;Ne;3;4;0;7
17144;Saulutė;Zylutės;4663795223;Ne;0;19;0;19
17145;Saulutė;Zylutės;7839168221;Ne;8;0;0;8
17146;Saulutė;Zylutės;2527027536;Ne;0;4;4;8
17147;Saulutė;Zylutės;2725491887;Ne;9;0;1;10
17148;Saulutė;Zylutės;1712365476;Ne;6;4;0;10
17149;Saulutė;Zylutės;4516130694;Ne;19;0;0;19
17150;Saulutė;"1 klasė";7844396402;Ne;2;6;0;8
17151;Saulutė;"1 klasė";8379304869;Ne;7;6;0;13
17152;Saulutė;"1 klasė";9947607411;Ne;1;6;0;7
17153;Saulutė;"1 klasė";7351477901;Ne;1;6;0;7
17154;Saulutė;"1 klasė";1324799653;Ne;5;6;0;11
17155;Saulutė;"1 klasė";95439358242;Ne;1;6;0;7
17156;Saulutė;"1 klasė";3691381351;Ne;2;6;0;8
17157;Saulutė;"1 klasė";8242602551;Ne;5;6;0;11
17158;Saulutė;"1 klasė";2397257894;Ne;4;6;0;10
17159;Saulutė;"1 klasė";5326279083;Ne;5;6;0;11
17160;Saulutė;"1 klasė";8946107286;Ne;0;6;0;6
17161;Saulutė;"1 klasė";7888435573;Ne;2;6;0;8
17162;Saulutė;"1 klasė";2781003892;Ne;0;6;0;6
17163;Saulutė;"1 klasė";2816806902;Ne;0;6;0;6
17164;Saulutė;"1 klasė";5247769309;Ne;5;6;0;11
17165;Saulutė;"1 klasė";9521155670;Ne;5;6;0;11
17166;Saulutė;"1 klasė";3620722907;Ne;3;6;0;9
17167;Saulutė;"1 klasė";3749374270;Ne;0;6;0;6
17168;Saulutė;"1 klasė";5148542811;Ne;1;6;0;7
17169;Saulutė;"1 klasė";1562393383;Ne;4;6;0;10
17170;Saulutė;"1 klasė";5641148690;Ne;4;6;0;10
17171;Saulutė;"1 klasė";4818911910;Ne;5;6;0;11
17172;Saulutė;"1 klasė";1833001939;Ne;4;6;0;10
17173;Saulutė;"1 klasė";8092104136;Ne;1;6;0;7
17174;Saulutė;"1 klasė";1625197280;Ne;0;6;0;6
17175;Saulutė;"1 klasė";4971244488;Ne;6;6;0;12
17176;Saulutė;"2 klasė";61073095949;Ne;4;6;0;10
17177;Saulutė;"2 klasė";1717909005;Ne;5;6;0;11
17178;Saulutė;"2 klasė";1513449225;Ne;0;6;0;6
17179;Saulutė;"2 klasė";87814849917;Ne;2;6;0;8
17180;Saulutė;"2 klasė";84919478493;Ne;0;6;0;6
17181;Saulutė;"2 klasė";1320018338;Ne;2;6;0;8
17182;Saulutė;"2 klasė";8599199376;Ne;6;6;0;12
17183;Saulutė;"2 klasė";8944601874;Ne;8;6;0;14
17184;Saulutė;"2 klasė";3064199909;Ne;0;6;0;6
17185;Saulutė;"2 klasė";1556270046;Ne;1;6;0;7
17186;Saulutė;"2 klasė";1911318708;Ne;0;6;0;6
17187;Saulutė;"2 klasė";4272320685;Ne;1;6;0;7
17188;Saulutė;"2 klasė";8952155496;Ne;0;6;0;6
17189;Saulutė;"2 klasė";28772515317;Ne;0;6;0;6
17190;Saulutė;"2 klasė";1291318940;Ne;1;6;0;7
17191;Saulutė;"2 klasė";2677995903;Ne;0;6;0;6
17192;Saulutė;"2 klasė";1391904744;Ne;1;6;0;7
17193;Saulutė;"2 klasė";1786491396;Ne;5;6;0;11
17194;Saulutė;"2 klasė";1386800520;Ne;2;6;0;8
17195;Saulutė;"2 klasė";6096297366;Ne;1;6;0;7
17196;Saulutė;"2 klasė";1332002470;Ne;0;6;0;6
17197;Saulutė;"2 klasė";1609952589;Ne;0;6;0;6
17198;Saulutė;"2 klasė";89920419797;Ne;0;4;0;4
17199;Saulutė;"3 klasė";45306237230;Ne;4;6;0;10
17200;Saulutė;"3 klasė";79438946697;Ne;3;6;0;9
17201;Saulutė;"3 klasė";79919438191;Ne;8;6;0;14
17202;Saulutė;"3 klasė";29074930927;Ne;6;6;0;12
17203;Saulutė;"3 klasė";8369703027;Ne;0;6;0;6
17204;Saulutė;"3 klasė";21605684303;Ne;2;6;0;8
17205;Saulutė;"3 klasė";31705050946;Ne;1;6;0;7
17206;Saulutė;"3 klasė";37315117916;Ne;1;6;0;7
17207;Saulutė;"3 klasė";3445723020;Ne;0;6;0;6
17208;Saulutė;"3 klasė";2098990667;Ne;0;6;0;6
17209;Saulutė;"3 klasė";27386434894;Ne;3;6;0;9
17210;Saulutė;"3 klasė";77923802656;Ne;9;6;0;15
17211;Saulutė;"3 klasė";46280382280;Ne;1;6;0;7
17212;Saulutė;"3 klasė";1935503629;Ne;1;6;0;7
17213;Saulutė;"3 klasė";75405796772;Ne;15;6;0;21
17214;Saulutė;"3 klasė";1277263391;Ne;1;6;0;7
17215;Saulutė;"3 klasė";97145959022;Ne;15;6;0;21
17216;Saulutė;"3 klasė";64418469679;Ne;6;6;0;12
17217;Saulutė;"3 klasė";77170708225;Ne;11;6;0;17
17218;Saulutė;"3 klasė";4640909915;Ne;1;6;0;7
17219;Saulutė;"3 klasė";65492344097;Ne;0;6;0;6
17220;Saulutė;"3 klasė";1704733670;Ne;1;6;0;7
17221;Saulutė;"3 klasė";1534183935;Ne;2;6;0;8
17222;Saulutė;"3 klasė";5574049005;Ne;1;6;0;7
17223;Saulutė;"3 klasė";1510434265;Ne;1;6;0;7
17224;Saulutė;"3 klasė";1422040758;Ne;2;6;0;8
17225;Saulutė;"3 klasė";77951768319;Ne;5;6;0;11
17226;Saulutė;"4 klasė";1005459768;Ne;2;6;0;8
17227;Saulutė;"4 klasė";1804521229;Ne;0;6;0;6
17228;Saulutė;"4 klasė";76108591835;Ne;0;6;0;6
17229;Saulutė;"4 klasė";1475031090;Ne;5;6;0;11
17230;Saulutė;"4 klasė";3156830821;Ne;0;6;0;6
17231;Saulutė;"4 klasė";5741276602;Ne;0;6;0;6
17232;Saulutė;"4 klasė";3246485288;Ne;3;6;0;9
17233;Saulutė;"4 klasė";44452051978;Ne;4;6;0;10
17234;Saulutė;"4 klasė";78967475616;Ne;1;6;0;7
17235;Saulutė;"4 klasė";89710141573;Ne;0;6;0;6
17236;Saulutė;"4 klasė";25124975646;Ne;2;6;0;8
17237;Saulutė;"4 klasė";3450668814;Ne;0;6;0;6
17238;Saulutė;"4 klasė";8168961080;Ne;4;2;0;6
17239;Saulutė;"4 klasė";57283533169;Ne;0;6;0;6
17240;Saulutė;"4 klasė";76744652185;Ne;6;6;0;12
17241;Saulutė;"4 klasė";97296161595;Ne;5;6;0;11
17242;Saulutė;"4 klasė";1205642335;Ne;4;6;0;10
17243;Saulutė;"4 klasė";2426509692;Ne;6;6;0;12
17244;Saulutė;"4 klasė";36414547943;Ne;3;6;0;9
17245;Saulutė;"4 klasė";99841176399;Ne;2;6;0;8
17246;Saulutė;"4 klasė";21703177024;Ne;0;6;0;6
17247;Saulutė;"4 klasė";1337654926;Ne;10;6;0;16
17248;Saulutė;"4 klasė";54950572289;Ne;1;6;0;7
17249;Saulutė;"4 klasė";2787531476;Ne;0;6;0;6
17250;Saulutė;"4 klasė";13147367113;Ne;0;6;0;6
17251;Saulutė;"4 klasė";2216383015;Ne;3;6;0;9
17252;Saulutė;"4 klasė";1644704074;Ne;1;6;0;7
17253;Saulutė;"4 klasė";96497471950;Ne;0;6;0;6
17254;Saulutė;"4 klasė";6557918941;Ne;0;6;0;6
17255;Svaja;SAULĖGRĄŽA;9811110367;Ne;0;0;2;2
17256;Svaja;SAULĖGRĄŽA;1579441289;Ne;0;0;2;2
17257;Svaja;SAULĖGRĄŽA;3792660330;Ne;0;4;0;4
17258;Svaja;SAULĖGRĄŽA;7575922215;Ne;0;5;1;6
17259;Svaja;SAULĖGRĄŽA;4510147045;Ne;0;7;0;7
17260;Svaja;SAULĖGRĄŽA;9680766688;Ne;0;5;6;11
17261;Svaja;SAULĖGRĄŽA;3912426942;Ne;0;4;0;4
17262;Svaja;SAULĖGRĄŽA;3809817617;Ne;0;4;2;6
17263;Svaja;SAULĖGRĄŽA;3501620040;Ne;0;5;0;5
17264;Svaja;SAULĖGRĄŽA;4333001830;Ne;0;2;2;4
17265;Svaja;SAULĖGRĄŽA;6928763381;Ne;12;0;2;14
17266;Svaja;SAULĖGRĄŽA;7408966637;Ne;0;5;0;5
17267;Svaja;SAULĖGRĄŽA;3563842321;Ne;0;0;1;1
17268;Svaja;SAULĖGRĄŽA;7089640807;Ne;6;4;0;10
17269;Svaja;SAULĖGRĄŽA;3461282516;Ne;5;4;0;9
17270;Svaja;SAULĖGRĄŽA;4253831334;Ne;0;0;5;5
17271;Svaja;SAULĖGRĄŽA;6963684639;Ne;4;4;0;8
17272;Svaja;SAULĖGRĄŽA;4189290919;Ne;0;19;0;19
17273;Svaja;SAULĖGRĄŽA;7747251736;Ne;0;4;0;4
17274;Svaja;SAULĖGRĄŽA;8875703109;Ne;0;4;1;5
17275;Svaja;SAULĖGRĄŽA;1496216379;Ne;0;0;4;4
17276;Svaja;"STEBUKLINGAS ŽIBINTAS";1558093905;Ne;0;4;0;4
17277;Svaja;"STEBUKLINGAS ŽIBINTAS";1050291871;Taip;10;4;0;14
17278;Svaja;"STEBUKLINGAS ŽIBINTAS";2200408537;Ne;0;4;2;6
17279;Svaja;"STEBUKLINGAS ŽIBINTAS";9814969596;Ne;7;4;0;11
17280;Svaja;"STEBUKLINGAS ŽIBINTAS";4290716676;Ne;0;4;1;5
17281;Svaja;"STEBUKLINGAS ŽIBINTAS";9545690301;Ne;5;14;0;19
17282;Svaja;"STEBUKLINGAS ŽIBINTAS";6128350581;Ne;0;4;0;4
17283;Svaja;"STEBUKLINGAS ŽIBINTAS";9843726794;Ne;3;4;0;7
17284;Svaja;"STEBUKLINGAS ŽIBINTAS";2658828200;Ne;0;4;0;4
17285;Svaja;"STEBUKLINGAS ŽIBINTAS";3940123543;Ne;0;4;0;4
17286;Svaja;"STEBUKLINGAS ŽIBINTAS";1860076171;Ne;4;0;0;4
17287;Svaja;"STEBUKLINGAS ŽIBINTAS";9086270220;Ne;0;0;2;2
17288;Svaja;"STEBUKLINGAS ŽIBINTAS";9259478140;Ne;9;0;0;9
17289;Svaja;"STEBUKLINGAS ŽIBINTAS";4237592104;Ne;0;19;0;19
17290;Svaja;"STEBUKLINGAS ŽIBINTAS";8363418532;Ne;3;0;4;7
17291;Svaja;"STEBUKLINGAS ŽIBINTAS";7277217069;Ne;0;4;4;8
17292;Svaja;"STEBUKLINGAS ŽIBINTAS";8172396846;Ne;0;4;2;6
17293;Svaja;"STEBUKLINGAS ŽIBINTAS";2188430052;Ne;6;4;2;12
17294;Svaja;"STEBUKLINGAS ŽIBINTAS";4004383843;Ne;0;4;0;4
17295;Svaja;"STEBUKLINGAS ŽIBINTAS";8353427144;Ne;3;3;1;7
17296;Svaja;"STEBUKLINGAS ŽIBINTAS";9102872020;Taip;4;0;0;4
17297;Svaja;"STEBUKLINGAS ŽIBINTAS";1150040935;Ne;0;4;0;4
17298;Svaja;"STEBUKLINGAS ŽIBINTAS";4565097904;Ne;3;4;0;7
17299;Svaja;SAULUTĖ;8890454460;Ne;7;3;0;10
17300;Svaja;SAULUTĖ;5440231053;Ne;9;4;0;13
17301;Svaja;SAULUTĖ;3382252131;Ne;11;0;0;11
17302;Svaja;SAULUTĖ;4250501744;Ne;8;4;0;12
17303;Svaja;SAULUTĖ;3684781373;Ne;6;4;0;10
17304;Svaja;SAULUTĖ;1013124074;Ne;5;4;0;9
17305;Svaja;SAULUTĖ;8632400763;Ne;10;4;0;14
17306;Svaja;SAULUTĖ;5051491859;Ne;4;0;0;4
17307;Svaja;SAULUTĖ;1312040427;Ne;15;4;0;19
17308;Svaja;SAULUTĖ;9004673086;Ne;3;2;0;5
17309;Svaja;SAULUTĖ;5455078232;Ne;8;4;0;12
17310;Svaja;SAULUTĖ;7087302180;Ne;5;8;0;13
17311;Svaja;SAULUTĖ;6335409702;Ne;7;4;0;11
17312;Svaja;SAULUTĖ;6027456849;Ne;11;0;0;11
17313;Svaja;SAULUTĖ;8609098948;Ne;7;3;0;10
17314;Svaja;SAULUTĖ;1344097741;Ne;4;4;0;8
17315;Svaja;SAULUTĖ;7520701357;Ne;11;0;0;11
17316;Svaja;SAULUTĖ;6765463228;Ne;0;4;0;4
17317;Svaja;SAULUTĖ;4577061794;Ne;7;0;0;7
17318;Svaja;SAULUTĖ;2599692546;Ne;18;0;0;18
17319;Svaja;SAULUTĖ;4415517674;Ne;4;4;0;8
17320;Svaja;SAULUTĖ;6837946814;Ne;7;0;0;7
17321;Svaja;SAULUTĖ;6354364944;Ne;16;0;0;16
17322;Svaja;SAULUTĖ;5186248897;Ne;15;0;0;15
17323;Svaja;"AUKSINĖ ŽUVELĖ";1914129062;Ne;7;4;1;12
17324;Svaja;"AUKSINĖ ŽUVELĖ";9826552657;Ne;0;0;1;1
17325;Svaja;"AUKSINĖ ŽUVELĖ";2427918378;Ne;0;4;0;4
17326;Svaja;"AUKSINĖ ŽUVELĖ";3377044908;Ne;8;4;0;12
17327;Svaja;"AUKSINĖ ŽUVELĖ";3567924341;Ne;0;4;6;10
17328;Svaja;"AUKSINĖ ŽUVELĖ";5033214011;Ne;7;0;0;7
17329;Svaja;"AUKSINĖ ŽUVELĖ";5013548619;Ne;0;0;7;7
17330;Svaja;"AUKSINĖ ŽUVELĖ";9091970902;Ne;0;0;4;4
17331;Svaja;"AUKSINĖ ŽUVELĖ";6028471687;Ne;9;0;2;11
17332;Svaja;"AUKSINĖ ŽUVELĖ";1877749103;Ne;3;3;0;6
17333;Svaja;"AUKSINĖ ŽUVELĖ";7605002899;Ne;0;3;2;5
17334;Svaja;"AUKSINĖ ŽUVELĖ";5230444195;Ne;5;4;0;9
17335;Svaja;"AUKSINĖ ŽUVELĖ";5224855138;Ne;5;4;0;9
17336;Svaja;"AUKSINĖ ŽUVELĖ";5908440171;Ne;0;0;6;6
17337;Svaja;"AUKSINĖ ŽUVELĖ";7562678317;Ne;7;4;1;12
17338;Svaja;"AUKSINĖ ŽUVELĖ";5198482539;Ne;0;1;3;4
17339;Svaja;"AUKSINĖ ŽUVELĖ";7434898745;Ne;0;5;0;5
17340;Svaja;"AUKSINĖ ŽUVELĖ";2641473764;Ne;0;0;1;1
17341;Svaja;"AUKSINĖ ŽUVELĖ";6086270618;Ne;0;0;3;3
17342;Svaja;"AUKSINĖ ŽUVELĖ";1932506236;Ne;11;4;4;19
17343;Svaja;"AUKSINĖ ŽUVELĖ";3708286263;Ne;0;3;0;3
17344;Svaja;"PRIE ĮLANKOS";9240037050;Ne;0;13;0;13
17345;Svaja;"PRIE ĮLANKOS";6980866050;Ne;0;4;0;4
17346;Svaja;"PRIE ĮLANKOS";3459060550;Ne;0;0;6;6
17347;Svaja;"PRIE ĮLANKOS";6361228838;Ne;10;0;0;10
17348;Svaja;"PRIE ĮLANKOS";7853479591;Ne;0;4;1;5
17349;Svaja;"PRIE ĮLANKOS";2770477678;Ne;4;0;2;6
17350;Svaja;"PRIE ĮLANKOS";5127370193;Ne;3;0;1;4
17351;Svaja;"PRIE ĮLANKOS";9689082202;Ne;0;0;2;2
17352;Svaja;"PRIE ĮLANKOS";3612833383;Ne;7;0;0;7
17353;Svaja;"PRIE ĮLANKOS";2993145079;Ne;4;0;1;5
17354;Svaja;"PRIE ĮLANKOS";6385127914;Ne;0;8;1;9
17355;Svaja;"PRIE ĮLANKOS";6102907953;Ne;12;0;0;12
17356;Svaja;"PRIE ĮLANKOS";2070084064;Ne;3;0;4;7
17357;Svaja;"PRIE ĮLANKOS";4256222944;Ne;6;0;0;6
17358;Svaja;"PRIE ĮLANKOS";4376033711;Ne;2;0;1;3
17359;Svaja;"PRIE ĮLANKOS";1953538445;Ne;0;0;1;1
17360;Svaja;"PRIE ĮLANKOS";5126348190;Ne;5;5;0;10
17361;Svaja;"PRIE ĮLANKOS";3823958567;Ne;5;0;0;5
17362;Svaja;"PRIE ĮLANKOS";6059069293;Ne;4;0;2;6
17363;Svaja;"PRIE ĮLANKOS";8622800666;Ne;5;0;3;8
17364;Svaja;"PRIE ĮLANKOS";5668878259;Ne;0;0;1;1
17365;Svaja;"1 B klasė";20473739993;Ne;3;16;0;19
17366;Svaja;"1 B klasė";50207734108;Ne;11;4;0;15
17367;Svaja;"1 B klasė";8689706130;Ne;1;4;0;5
17368;Svaja;"1 B klasė";1045300185;Ne;2;4;0;6
17369;Svaja;"1 B klasė";6665752307;Ne;0;4;0;4
17370;Svaja;"1 B klasė";5479482244;Ne;5;4;0;9
17371;Svaja;"1 B klasė";7020342969;Ne;0;4;0;4
17372;Svaja;"1 B klasė";2166382346;Ne;0;4;0;4
17373;Svaja;"1 B klasė";8503177793;Ne;1;4;0;5
17374;Svaja;"1 B klasė";1633236289;Ne;0;4;0;4
17375;Svaja;"1 B klasė";8656417794;Ne;1;4;0;5
17376;Svaja;"1 B klasė";4014493868;Ne;0;4;0;4
17377;Svaja;"1 B klasė";6388514464;Ne;0;4;0;4
17378;Svaja;"1 B klasė";1044733634;Ne;5;4;0;9
17379;Svaja;"1 B klasė";1392455608;Ne;1;4;0;5
17380;Svaja;"1 B klasė";9864664937;Ne;0;4;0;4
17381;Svaja;"1 B klasė";1617844709;Ne;7;4;0;11
17382;Svaja;"1 B klasė";5862570666;Ne;3;4;0;7
17383;Svaja;"1 B klasė";3102257512;Ne;3;4;0;7
17384;Svaja;"1 B klasė";4284157599;Ne;3;4;0;7
17385;Svaja;"1 B klasė";9950569499;Ne;0;4;0;4
17386;Svaja;"1 B klasė";3458374439;Ne;0;4;0;4
17387;Svaja;"1 B klasė";4541391191;Ne;4;4;0;8
17388;Svaja;"1 B klasė";7205437280;Ne;5;4;0;9
17389;Svaja;"1 B klasė";6638804854;Ne;0;4;0;4
17390;Svaja;"1 B klasė";67304194087;Ne;0;4;0;4
17391;Svaja;"1 B klasė";3000676765;Ne;3;4;0;7
17392;Svaja;"1 B klasė";2627089275;Ne;0;4;0;4
17393;Svaja;"1 A klasė";9112198914;Ne;0;4;0;4
17394;Svaja;"1 A klasė";6807834176;Ne;0;4;0;4
17395;Svaja;"1 A klasė";7936765752;Ne;0;4;0;4
17396;Svaja;"1 A klasė";3049808328;Ne;1;4;0;5
17397;Svaja;"1 A klasė";3802996573;Ne;4;4;0;8
17398;Svaja;"1 A klasė";5443682744;Ne;0;4;0;4
17399;Svaja;"1 A klasė";9475971731;Ne;2;4;0;6
17400;Svaja;"1 A klasė";4968201186;Ne;1;4;0;5
17401;Svaja;"1 A klasė";7473493846;Ne;1;4;0;5
17402;Svaja;"1 A klasė";30719991872;Ne;4;4;0;8
17403;Svaja;"1 A klasė";3633996231;Ne;1;4;0;5
17404;Svaja;"1 A klasė";2750615517;Ne;0;4;0;4
17405;Svaja;"1 A klasė";9311520300;Ne;0;4;0;4
17406;Svaja;"1 A klasė";5595087767;Ne;0;4;0;4
17407;Svaja;"1 A klasė";6676145522;Ne;1;4;0;5
17408;Svaja;"1 A klasė";2018689468;Ne;1;4;0;5
17409;Svaja;"1 A klasė";1671495181;Ne;3;4;0;7
17410;Svaja;"1 A klasė";7514587933;Ne;5;4;0;9
17411;Svaja;"1 A klasė";4393041946;Ne;3;4;0;7
17412;Svaja;"1 A klasė";3868254757;Ne;1;4;0;5
17413;Svaja;"1 A klasė";1377813636;Ne;0;4;0;4
17414;Svaja;"1 A klasė";3630922360;Ne;2;4;0;6
17415;Svaja;"1 A klasė";6995285377;Ne;5;4;0;9
17416;Svaja;"1 A klasė";2436416327;Ne;0;4;0;4
17417;Svaja;"1 A klasė";8357287467;Ne;0;4;0;4
17418;Svaja;"1 A klasė";3636826798;Ne;0;4;0;4
17419;Svaja;"1 A klasė";1114477688;Ne;0;4;0;4
17420;Svaja;"1 A klasė";5356005675;Ne;8;4;0;12
17421;Svaja;"2 A klasė";43307670660;Ne;4;5;0;9
17422;Svaja;"2 A klasė";58102699652;Ne;1;5;0;6
17423;Svaja;"2 A klasė";5335776957;Ne;1;18;0;19
17424;Svaja;"2 A klasė";22702341083;Ne;2;5;0;7
17425;Svaja;"2 A klasė";2076060840;Ne;2;5;0;7
17426;Svaja;"2 A klasė";27445299450;Ne;0;5;0;5
17427;Svaja;"2 A klasė";1576498450;Ne;3;5;0;8
17428;Svaja;"2 A klasė";1714711904;Ne;10;5;0;15
17429;Svaja;"2 A klasė";1046879533;Ne;1;5;0;6
17430;Svaja;"2 A klasė";65917456866;Ne;0;5;0;5
17431;Svaja;"2 A klasė";4846025153;Ne;4;5;0;9
17432;Svaja;"2 A klasė";47457128214;Ne;0;5;0;5
17433;Svaja;"2 A klasė";2147266053;Ne;4;5;0;9
17434;Svaja;"2 A klasė";1197826066;Ne;0;5;0;5
17435;Svaja;"2 A klasė";5337604370;Ne;3;5;0;8
17436;Svaja;"2 A klasė";73679997517;Ne;4;5;0;9
17437;Svaja;"2 A klasė";56117509354;Ne;6;5;0;11
17438;Svaja;"2 A klasė";7669562010;Ne;12;5;0;17
17439;Svaja;"2 A klasė";4900757614;Ne;0;5;0;5
17440;Svaja;"2 A klasė";1061894314;Ne;1;5;0;6
17441;Svaja;"2 A klasė";8697355813;Ne;6;5;0;11
17442;Svaja;"2 A klasė";193181908;Ne;0;5;0;5
17443;Svaja;"2 A klasė";193181908;Ne;0;5;0;5
17444;Svaja;"2 B klasė";25194696146;Ne;3;5;0;8
17445;Svaja;"2 B klasė";55925058866;Ne;14;5;0;19
17446;Svaja;"2 B klasė";1704075006;Ne;0;5;0;5
17447;Svaja;"2 B klasė";8875237023;Ne;1;5;0;6
17448;Svaja;"2 B klasė";8279605005;Ne;14;5;0;19
17449;Svaja;"2 B klasė";1437557657;Ne;10;5;0;15
17450;Svaja;"2 B klasė";36505115395;Ne;1;18;0;19
17451;Svaja;"2 B klasė";6593047776;Ne;0;5;0;5
17452;Svaja;"2 B klasė";7911488445;Ne;1;5;0;6
17453;Svaja;"2 B klasė";64196174690;Ne;2;17;0;19
17454;Svaja;"2 B klasė";7753488216;Ne;2;5;0;7
17455;Svaja;"2 B klasė";21871530266;Ne;3;5;0;8
17456;Svaja;"2 B klasė";9110985103;Ne;5;5;0;10
17457;Svaja;"2 B klasė";2985196852;Ne;1;5;0;6
17458;Svaja;"2 B klasė";3562817807;Ne;4;15;0;19
17459;Svaja;"2 B klasė";2069150261;Ne;0;5;0;5
17460;Svaja;"2 B klasė";1191494598;Ne;2;5;0;7
17461;Svaja;"2 B klasė";24863928147;Ne;0;5;0;5
17462;Svaja;"2 B klasė";15159708127;Ne;1;5;0;6
17463;Svaja;"2 B klasė";8491275729;Ne;0;5;0;5
17464;Svaja;"2 B klasė";11671380984;Ne;0;5;0;5
17465;Svaja;"2 B klasė";99183628764;Ne;7;5;0;12
17466;Svaja;"2 B klasė";1369637618;Ne;0;5;0;5
17467;Svaja;"2 B klasė";3660152224;Ne;0;5;0;5
17468;Svaja;"2 B klasė";1865658456;Ne;4;5;0;9
17469;Svaja;"3 A klasė";9628146488;Ne;2;4;0;6
17470;Svaja;"3 A klasė";1017471747;Ne;1;4;0;5
17471;Svaja;"3 A klasė";1304775332;Ne;2;4;0;6
17472;Svaja;"3 A klasė";26902749194;Ne;5;4;0;9
17473;Svaja;"3 A klasė";1297727288;Ne;1;4;0;5
17474;Svaja;"3 A klasė";30027404222;Ne;1;4;0;5
17475;Svaja;"3 A klasė";1352488176;Ne;1;4;0;5
17476;Svaja;"3 A klasė";1943166503;Ne;1;4;0;5
17477;Svaja;"3 A klasė";8198614500;Ne;3;4;0;7
17478;Svaja;"3 A klasė";5522433229;Ne;2;4;0;6
17479;Svaja;"3 A klasė";40856210635;Ne;4;4;0;8
17480;Svaja;"3 A klasė";67462299886;Ne;7;4;0;11
17481;Svaja;"3 A klasė";18733824395;Ne;2;4;0;6
17482;Svaja;"3 A klasė";26500981786;Ne;6;4;0;10
17483;Svaja;"3 A klasė";89042677798;Ne;4;4;0;8
17484;Svaja;"3 A klasė";3022690832;Ne;4;4;0;8
17485;Svaja;"3 A klasė";23112873505;Ne;1;4;0;5
17486;Svaja;"3 A klasė";15246943974;Ne;3;4;0;7
17487;Svaja;"3 A klasė";1562041360;Ne;2;4;0;6
17488;Svaja;"3 A klasė";2058827699;Ne;1;4;0;5
17489;Svaja;"3 A klasė";84508228457;Ne;2;4;0;6
17490;Svaja;"3 A klasė";1048576329;Ne;2;4;0;6
17491;Svaja;"3 B klasė";69028070656;Ne;2;4;0;6
17492;Svaja;"3 B klasė";30360097999;Ne;15;4;0;19
17493;Svaja;"3 B klasė";19887874988;Ne;2;4;0;6
17494;Svaja;"3 B klasė";1967394949;Ne;0;4;0;4
17495;Svaja;"3 B klasė";7719185632;Ne;5;4;0;9
17496;Svaja;"3 B klasė";57216954289;Ne;1;4;0;5
17497;Svaja;"3 B klasė";44989143252;Ne;0;4;0;4
17498;Svaja;"3 B klasė";87432529423;Ne;1;4;0;5
17499;Svaja;"3 B klasė";3077814152;Ne;1;4;0;5
17500;Svaja;"3 B klasė";6056157113;Ne;0;4;0;4
17501;Svaja;"3 B klasė";21608020858;Ne;2;4;0;6
17502;Svaja;"3 B klasė";1655551042;Ne;0;4;0;4
17503;Svaja;"3 B klasė";1601648171;Ne;1;4;0;5
17504;Svaja;"3 B klasė";1509272327;Ne;5;4;0;9
17505;Svaja;"3 B klasė";4804779327;Ne;5;14;0;19
17506;Svaja;"3 B klasė";40814723278;Ne;0;4;0;4
17507;Svaja;"3 B klasė";69413101571;Ne;1;4;0;5
17508;Svaja;"3 B klasė";54745410330;Ne;0;4;0;4
17509;Svaja;"3 B klasė";4881476441;Ne;0;5;0;5
17510;Svaja;"3 B klasė";78293798850;Ne;0;4;0;4
17511;Svaja;"3 B klasė";30036722764;Ne;5;4;0;9
17512;Svaja;"3 B klasė";89316574266;Ne;2;17;0;19
17513;Svaja;"3 B klasė";809734624;Ne;0;4;0;4
17514;Svaja;"3 B klasė";76618850202;Ne;1;4;0;5
17515;Svaja;"3 B klasė";1378219785;Ne;0;4;0;4
17516;Svaja;"4 A klasė";6057524892;Ne;0;4;0;4
17517;Svaja;"4 A klasė";63346231562;Ne;4;5;0;9
17518;Svaja;"4 A klasė";25578518444;Ne;0;5;0;5
17519;Svaja;"4 A klasė";64487515384;Ne;0;19;0;19
17520;Svaja;"4 A klasė";15252353189;Ne;0;5;0;5
17521;Svaja;"4 A klasė";4617061890;Ne;1;5;0;6
17522;Svaja;"4 A klasė";8828911320;Ne;0;19;0;19
17523;Svaja;"4 A klasė";75104768118;Ne;0;4;0;4
17524;Svaja;"4 A klasė";3604946305;Ne;0;19;0;19
17525;Svaja;"4 A klasė";34216516886;Ne;0;5;0;5
17526;Svaja;"4 A klasė";3474439050;Ne;0;4;0;4
17527;Svaja;"4 A klasė";72752022712;Ne;5;4;0;9
17528;Svaja;"4 A klasė";30754812113;Ne;7;4;0;11
17529;Svaja;"4 A klasė";75296600945;Ne;0;5;0;5
17530;Svaja;"4 A klasė";2321739150;Ne;0;4;0;4
17531;Svaja;"4 A klasė";1168637823;Ne;3;4;0;7
17532;Svaja;"4 A klasė";4906784415;Ne;0;5;0;5
17533;Svaja;"4 A klasė";60448774566;Ne;4;7;0;11
17534;Svaja;"4 A klasė";1649920341;Ne;1;4;0;5
17535;Svaja;"4 B klasė";70506691027;Ne;0;19;0;19
17536;Svaja;"4 B klasė";73391331150;Ne;2;17;0;19
17537;Svaja;"4 B klasė";70507326327;Ne;2;17;0;19
17538;Svaja;"4 B klasė";1470843400;Ne;0;5;0;5
17539;Svaja;"4 B klasė";8011137572;Ne;1;5;0;6
17540;Svaja;"4 B klasė";4416877973;Ne;1;5;0;6
17541;Svaja;"4 B klasė";54328462992;Ne;1;18;0;19
17542;Svaja;"4 B klasė";44418402260;Ne;0;5;0;5
17543;Svaja;"4 B klasė";1367687415;Ne;0;5;0;5
17544;Svaja;"4 B klasė";92044111261;Ne;0;5;0;5
17545;Svaja;"4 B klasė";1847775266;Ne;1;5;0;6
17546;Svaja;"4 B klasė";71708072632;Ne;4;5;0;9
17547;Svaja;"4 B klasė";56506642672;Ne;0;5;0;5
17548;Svaja;"4 B klasė";17947580061;Ne;11;5;0;16
17549;Svaja;"4 B klasė";3526873547;Ne;5;5;0;10
17550;Svaja;"4 B klasė";62971657427;Ne;0;5;0;5
17551;Svaja;"4 B klasė";50649509868;Ne;1;18;0;19
17552;Svaja;"4 B klasė";80772711351;Ne;0;5;0;5
17553;Svaja;"4 B klasė";11937575740;Ne;1;5;0;6
17554;Svaja;"4 B klasė";6969692916;Ne;5;5;0;10
17555;Svaja;"4 B klasė";4282243865;Ne;4;15;0;19
17556;Svaja;"4 B klasė";6905550313;Ne;0;5;0;5
17557;Svaja;"4 C klasė";93651139102;Ne;0;4;0;4
17558;Svaja;"4 C klasė";25934507261;Ne;1;4;0;5
17559;Svaja;"4 C klasė";89047123808;Ne;1;4;0;5
17560;Svaja;"4 C klasė";41183537732;Ne;4;4;0;8
17561;Svaja;"4 C klasė";50510924690;Ne;1;4;0;5
17562;Svaja;"4 C klasė";54462393937;Ne;1;4;0;5
17563;Svaja;"4 C klasė";74904581010;Ne;9;4;0;13
17564;Svaja;"4 C klasė";1795682827;Ne;4;4;0;8
17565;Svaja;"4 C klasė";2165716699;Ne;4;15;0;19
17566;Svaja;"4 C klasė";94449039022;Ne;0;19;0;19
17567;Svaja;"4 C klasė";85150525696;Ne;1;4;0;5
17568;Svaja;"4 C klasė";36001411632;Ne;2;4;0;6
17569;Svaja;"4 C klasė";34995551069;Ne;1;4;0;5
17570;Svaja;"4 C klasė";1742951527;Ne;1;4;0;5
17571;Svaja;"4 C klasė";1848422504;Ne;6;4;0;10
17572;Svaja;"4 C klasė";3743948734;Ne;10;4;0;14
17573;Svaja;"4 C klasė";70714898590;Ne;1;4;0;5
17574;Svaja;"4 C klasė";54852358913;Ne;1;4;0;5
17575;Svaja;"4 C klasė";57253216255;Ne;7;4;0;11
17576;Svaja;"4 C klasė";91855230473;Ne;9;4;0;13
17577;Svaja;"4 C klasė";1855559693;Ne;1;18;0;19
17578;Svaja;"4 C klasė";31216445971;Ne;4;15;0;19
17579;Svaja;"4 C klasė";20342193231;Ne;0;4;0;4
17580;Svaja;"4 C klasė";91088224294;Ne;10;9;0;19
17581;Šilelis;PAUKŠTELIAI;6128379060;Ne;8;1;0;9
17582;Šilelis;PAUKŠTELIAI;9653439873;Ne;0;4;0;4
17583;Šilelis;PAUKŠTELIAI;2823486581;Ne;5;1;0;6
17584;Šilelis;PAUKŠTELIAI;6369443270;Ne;2;3;0;5
17585;Šilelis;PAUKŠTELIAI;7595774842;Ne;2;0;3;5
17586;Šilelis;PAUKŠTELIAI;6614686867;Ne;10;0;0;10
17587;Šilelis;PAUKŠTELIAI;3053443777;Ne;11;0;1;12
17588;Šilelis;PAUKŠTELIAI;4960501068;Ne;0;8;0;8
17589;Šilelis;PAUKŠTELIAI;7072057348;Ne;0;7;0;7
17590;Šilelis;PAUKŠTELIAI;5974537364;Taip;0;4;0;4
17591;Šilelis;PAUKŠTELIAI;8166061969;Ne;8;0;0;8
17592;Šilelis;PAUKŠTELIAI;1124854378;Ne;0;1;0;1
17593;Šilelis;PAUKŠTELIAI;8184170908;Ne;0;0;2;2
17594;Šilelis;PAUKŠTELIAI;4432542988;Ne;0;0;1;1
17595;Šilelis;PAUKŠTELIAI;9799198904;Ne;0;0;2;2
17596;Šilelis;PAUKŠTELIAI;5493811298;Ne;0;4;1;5
17597;Šilelis;PAUKŠTELIAI;4032841142;Ne;6;0;1;7
17598;Šilelis;PAUKŠTELIAI;7652950762;Ne;14;0;0;14
17599;Šilelis;SKRUZDELIUKAI;7502057552;Ne;0;4;0;4
17600;Šilelis;SKRUZDELIUKAI;6359318134;Ne;7;4;0;11
17601;Šilelis;SKRUZDELIUKAI;5598152793;Taip;0;4;0;4
17602;Šilelis;SKRUZDELIUKAI;8090773379;Ne;0;8;0;8
17603;Šilelis;SKRUZDELIUKAI;1200024379;Ne;8;0;0;8
17604;Šilelis;SKRUZDELIUKAI;7299084520;Ne;0;2;0;2
17605;Šilelis;SKRUZDELIUKAI;8578620603;Ne;0;2;0;2
17606;Šilelis;SKRUZDELIUKAI;9589138527;Ne;0;8;0;8
17607;Šilelis;SKRUZDELIUKAI;3967932407;Taip;0;7;0;7
17608;Šilelis;SKRUZDELIUKAI;4629917226;Ne;4;0;0;4
17609;Šilelis;SKRUZDELIUKAI;2972202874;Taip;9;0;2;11
17610;Šilelis;SKRUZDELIUKAI;9461117894;Ne;0;5;0;5
17611;Šilelis;SKRUZDELIUKAI;5817818596;Ne;8;4;0;12
17612;Šilelis;SKRUZDELIUKAI;6827855685;Ne;9;0;0;9
17613;Šilelis;SKRUZDELIUKAI;5091571136;Ne;0;3;0;3
17614;Šilelis;SKRUZDELIUKAI;8297975308;Ne;0;10;0;10
17615;Šilelis;SKRUZDELIUKAI;3381053227;Ne;0;5;0;5
17616;Šilelis;SKRUZDELIUKAI;9276607554;Taip;10;1;0;11
17617;Šilelis;SKRUZDELIUKAI;6139976105;Ne;0;3;0;3
17618;Šilelis;SMERFY;3247333567;Ne;4;2;0;6
17619;Šilelis;SMERFY;9886134621;Ne;1;0;0;1
17620;Šilelis;SMERFY;3089270468;Ne;1;4;0;5
17621;Šilelis;SMERFY;4504627601;Ne;0;3;0;3
17622;Šilelis;SMERFY;7534468539;Ne;3;4;2;9
17623;Šilelis;SMERFY;6390855924;Ne;2;4;0;6
17624;Šilelis;SMERFY;1821827154;Ne;0;2;0;2
17625;Šilelis;SMERFY;4196893379;Ne;0;4;0;4
17626;Šilelis;SMERFY;1890114622;Ne;0;1;0;1
17627;Šilelis;SMERFY;5025956218;Ne;3;4;0;7
17628;Šilelis;SMERFY;8909345826;Ne;1;3;0;4
17629;Šilelis;SMERFY;9502563865;Ne;6;4;0;10
17630;Šilelis;SMERFY;3452984649;Ne;2;2;0;4
17631;Šilelis;SMERFY;8659845107;Ne;0;1;0;1
17632;Šilelis;SMERFY;1906712332;Ne;6;2;0;8
17633;Šilelis;EŽIUKAI;7074963804;Ne;0;1;0;1
17634;Šilelis;EŽIUKAI;4702068672;Ne;0;4;0;4
17635;Šilelis;EŽIUKAI;2295849333;Ne;7;5;0;12
17636;Šilelis;EŽIUKAI;1883483049;Ne;0;2;0;2
17637;Šilelis;EŽIUKAI;6854997486;Ne;0;3;0;3
17638;Šilelis;EŽIUKAI;6386996498;Ne;2;3;0;5
17639;Šilelis;EŽIUKAI;2681063256;Ne;0;0;1;1
17640;Šilelis;EŽIUKAI;6233673622;Ne;10;4;0;14
17641;Šilelis;EŽIUKAI;3312235148;Ne;11;4;0;15
17642;Šilelis;EŽIUKAI;5314433515;Ne;6;3;0;9
17643;Šilelis;EŽIUKAI;1980323777;Ne;6;3;0;9
17644;Šilelis;EŽIUKAI;9203888742;Ne;0;7;0;7
17645;Šilelis;EŽIUKAI;2289616655;Ne;5;4;0;9
17646;Šilelis;EŽIUKAI;5167084901;Ne;0;3;2;5
17647;Šilelis;EŽIUKAI;3669647107;Ne;0;4;0;4
17648;Šilelis;EŽIUKAI;2151250706;Ne;5;4;0;9
17649;Šilelis;EŽIUKAI;7891369140;Ne;11;4;0;15
17650;Šilelis;NYKŠTUKAI;3046954717;Ne;0;4;0;4
17651;Šilelis;NYKŠTUKAI;2862894359;Ne;4;4;0;8
17652;Šilelis;NYKŠTUKAI;3158708835;Ne;7;4;0;11
17653;Šilelis;NYKŠTUKAI;6195580698;Ne;0;4;1;5
17654;Šilelis;NYKŠTUKAI;6107771932;Ne;0;16;0;16
17655;Šilelis;NYKŠTUKAI;4323998445;Ne;2;4;2;8
17656;Šilelis;NYKŠTUKAI;2095572561;Taip;1;5;1;7
17657;Šilelis;NYKŠTUKAI;2161973782;Ne;14;0;0;14
17658;Šilelis;NYKŠTUKAI;4459114205;Ne;0;3;0;3
17659;Šilelis;NYKŠTUKAI;3728633100;Ne;2;7;0;9
17660;Šilelis;NYKŠTUKAI;3999426414;Ne;0;6;0;6
17661;Šilelis;NYKŠTUKAI;5745874033;Ne;0;5;0;5
17662;Šilelis;NYKŠTUKAI;9769483899;Ne;0;5;1;6
17663;Šilelis;NYKŠTUKAI;8944490184;Ne;0;4;2;6
17664;Šilelis;NYKŠTUKAI;2908840424;Ne;0;6;0;6
17665;Šilelis;NYKŠTUKAI;6980045156;Ne;0;6;0;6
17666;Šilelis;NYKŠTUKAI;4868465692;Ne;0;4;0;4
17667;Šilelis;NYKŠTUKAI;4754544277;Ne;3;7;0;10
17668;Šilelis;NYKŠTUKAI;1222028604;Ne;2;4;4;10
17669;Šilelis;NYKŠTUKAI;7480611069;Ne;0;4;0;4
17670;Šilelis;NYKŠTUKAI;9360553910;Ne;0;5;0;5
17671;Šilelis;NYKŠTUKAI;6852463814;Ne;4;10;0;14
17672;Šilelis;NYKŠTUKAI;9715544798;Ne;0;3;0;3
17673;Šilelis;ANČIUKAI;1726944289;Ne;4;0;3;7
17674;Šilelis;ANČIUKAI;4336942500;Ne;5;1;0;6
17675;Šilelis;ANČIUKAI;6616262730;Ne;5;4;3;12
17676;Šilelis;ANČIUKAI;4323750313;Ne;4;5;0;9
17677;Šilelis;ANČIUKAI;3221398692;Ne;0;2;2;4
17678;Šilelis;ANČIUKAI;6364741317;Ne;5;4;0;9
17679;Šilelis;ANČIUKAI;1325857464;Taip;4;2;0;6
17680;Šilelis;ANČIUKAI;9407916190;Ne;0;9;0;9
17681;Šilelis;ANČIUKAI;7128670936;Ne;5;0;5;10
17682;Šilelis;ANČIUKAI;8613748314;Ne;10;0;0;10
17683;Šilelis;ANČIUKAI;5381213051;Taip;5;4;0;9
17684;Šilelis;ANČIUKAI;2976607303;Ne;0;0;1;1
17685;Šilelis;ANČIUKAI;8807755852;Ne;0;1;0;1
17686;Šilelis;ANČIUKAI;4135383684;Ne;0;4;0;4
17687;Šilelis;ANČIUKAI;5926624138;Taip;0;0;4;4
17688;Šilelis;ANČIUKAI;8603589758;Ne;3;0;5;8
17689;Šilelis;ANČIUKAI;4996192593;Ne;7;0;5;12
17690;Šilelis;ANČIUKAI;6485433036;Ne;11;1;0;12
17691;Šilelis;ANČIUKAI;7968869585;Ne;6;0;2;8
17692;Šilelis;ANČIUKAI;3182336761;Ne;6;0;5;11
17693;Šilelis;ANČIUKAI;9767000842;Taip;14;4;0;18
17694;Šilelis;KAČIUKAI;9899047136;Ne;0;2;0;2
17695;Šilelis;KAČIUKAI;3216168797;Ne;0;0;4;4
17696;Šilelis;KAČIUKAI;9848760151;Ne;0;4;0;4
17697;Šilelis;KAČIUKAI;4743459915;Ne;0;4;0;4
17698;Šilelis;KAČIUKAI;8387022157;Ne;0;12;0;12
17699;Šilelis;KAČIUKAI;3393466953;Ne;0;7;0;7
17700;Šilelis;KAČIUKAI;2111979474;Ne;0;1;0;1
17701;Šilelis;KAČIUKAI;8064905796;Ne;0;7;0;7
17702;Šilelis;KAČIUKAI;7123048946;Ne;0;2;3;5
17703;Šilelis;KAČIUKAI;2906501601;Ne;0;6;0;6
17704;Šilelis;KAČIUKAI;6510813364;Ne;0;4;0;4
17705;Šilelis;KAČIUKAI;8319185507;Ne;0;4;0;4
17706;Šilelis;KAČIUKAI;8504187981;Ne;0;5;0;5
17707;Šilelis;KAČIUKAI;6470073008;Ne;0;5;0;5
17708;Šilelis;KAČIUKAI;3419284228;Ne;3;2;0;5
17709;Šilelis;KAČIUKAI;3712001932;Ne;0;2;0;2
17710;Šilelis;KAČIUKAI;9106999969;Ne;0;5;0;5
17711;Šilelis;KAČIUKAI;6894466509;Ne;5;0;0;5
17712;Šilelis;KAČIUKAI;5026203678;Ne;15;3;0;18
17713;Šilelis;KAČIUKAI;6561145380;Ne;0;6;0;6
17714;Šilelis;KAČIUKAI;5138192616;Ne;0;5;0;5
17715;Šilelis;KIŠKUČIAI;9480895465;Ne;0;4;2;6
17716;Šilelis;KIŠKUČIAI;8759694551;Ne;0;2;1;3
17717;Šilelis;KIŠKUČIAI;2209552706;Ne;8;4;0;12
17718;Šilelis;KIŠKUČIAI;3296197220;Ne;5;0;2;7
17719;Šilelis;KIŠKUČIAI;4386065478;Ne;0;0;1;1
17720;Šilelis;KIŠKUČIAI;7043644521;Ne;7;4;0;11
17721;Šilelis;KIŠKUČIAI;8096868221;Ne;0;4;0;4
17722;Šilelis;KIŠKUČIAI;3395084186;Ne;0;0;1;1
17723;Šilelis;KIŠKUČIAI;9746722034;Ne;0;3;0;3
17724;Šilelis;KIŠKUČIAI;5815768693;Ne;5;4;0;9
17725;Šilelis;KIŠKUČIAI;8598321310;Ne;0;3;3;6
17726;Šilelis;KIŠKUČIAI;4965573774;Ne;3;4;0;7
17727;Šilelis;KIŠKUČIAI;9992207035;Ne;10;4;2;16
17728;Šilelis;KIŠKUČIAI;5431978292;Ne;0;0;1;1
17729;Šilelis;KIŠKUČIAI;6415777619;Ne;7;4;0;11
17730;Šilelis;KIŠKUČIAI;7630784355;Ne;0;4;0;4
17731;Šilelis;KIŠKUČIAI;7822646258;Ne;5;0;1;6
17732;Šilelis;KIŠKUČIAI;4910899296;Ne;0;4;1;5
17733;Šilelis;KREGŽDUTĖS;1025643459;Ne;15;0;0;15
17734;Šilelis;KREGŽDUTĖS;2896605690;Ne;0;1;0;1
17735;Šilelis;KREGŽDUTĖS;8453070684;Ne;3;3;0;6
17736;Šilelis;KREGŽDUTĖS;1286082219;Ne;4;4;0;8
17737;Šilelis;KREGŽDUTĖS;3068950702;Ne;3;2;0;5
17738;Šilelis;KREGŽDUTĖS;8665357907;Ne;13;1;0;14
17739;Šilelis;KREGŽDUTĖS;1152159735;Taip;13;0;0;13
17740;Šilelis;KREGŽDUTĖS;6630114847;Taip;12;0;0;12
17741;Šilelis;KREGŽDUTĖS;3953114161;Taip;3;1;0;4
17742;Šilelis;KREGŽDUTĖS;2499322761;Ne;14;1;0;15
17743;Šilelis;KREGŽDUTĖS;5868594049;Ne;15;0;0;15
17744;Šilelis;KREGŽDUTĖS;8855625488;Ne;6;0;0;6
17745;Šilelis;KREGŽDUTĖS;5223262925;Ne;0;2;0;2
17746;Šilelis;KREGŽDUTĖS;1279361795;Taip;2;4;0;6
17747;Šilelis;KREGŽDUTĖS;9292761872;Ne;14;2;0;16
17748;Šilelis;KREGŽDUTĖS;6987557382;Ne;8;4;1;13
17749;Šilelis;KREGŽDUTĖS;9991765829;Ne;2;1;2;5
17750;Šilelis;KREGŽDUTĖS;4696129999;Ne;0;3;0;3
17751;Šilelis;KREGŽDUTĖS;1805615293;Ne;0;4;0;4
17752;Šilelis;KREGŽDUTĖS;5192604763;Ne;1;1;3;5
17753;Šilelis;KREGŽDUTĖS;6065839221;Ne;11;0;0;11
17754;Šilelis;PAGRANDUKAI;8616798722;Ne;10;0;0;10
17755;Šilelis;PAGRANDUKAI;6598481106;Ne;17;0;0;17
17756;Šilelis;PAGRANDUKAI;8654600612;Ne;14;0;0;14
17757;Šilelis;PAGRANDUKAI;7900611929;Ne;3;1;0;4
17758;Šilelis;PAGRANDUKAI;1325551883;Ne;10;0;0;10
17759;Šilelis;PAGRANDUKAI;6090493923;Ne;13;0;0;13
17760;Šilelis;PAGRANDUKAI;3627435667;Ne;5;2;0;7
17761;Šilelis;PAGRANDUKAI;5090120850;Ne;6;0;1;7
17762;Šilelis;PAGRANDUKAI;7890456241;Taip;11;0;1;12
17763;Šilelis;PAGRANDUKAI;3147394614;Ne;3;0;0;3
17764;Šilelis;PAGRANDUKAI;2693883266;Ne;3;0;1;4
17765;Šilelis;PAGRANDUKAI;2702371841;Ne;10;0;0;10
17766;Šilelis;PAGRANDUKAI;2378919393;Ne;13;0;0;13
17767;Šilelis;PAGRANDUKAI;6484740846;Ne;5;0;1;6
17768;Šilelis;PAGRANDUKAI;7849601686;Ne;11;0;0;11
17769;Šilelis;BITUTĖS;7512731255;Ne;8;2;0;10
17770;Šilelis;BITUTĖS;1268335563;Ne;0;1;0;1
17771;Šilelis;BITUTĖS;7814807923;Ne;5;6;0;11
17772;Šilelis;BITUTĖS;9071963194;Ne;0;4;0;4
17773;Šilelis;BITUTĖS;5843337891;Ne;2;4;0;6
17774;Šilelis;BITUTĖS;1960952604;Ne;4;5;1;10
17775;Šilelis;BITUTĖS;7350013139;Ne;0;1;0;1
17776;Šilelis;BITUTĖS;3879234745;Ne;0;2;2;4
17777;Šilelis;BITUTĖS;3062557053;Ne;0;2;0;2
17778;Šilelis;BITUTĖS;1390916076;Ne;0;3;4;7
17779;Šilelis;BITUTĖS;5375413045;Ne;0;12;0;12
17780;Šilelis;BITUTĖS;6830200578;Ne;0;3;0;3
17781;Šilelis;BITUTĖS;6479728064;Ne;0;9;0;9
17782;Šilelis;BITUTĖS;3686287802;Ne;0;3;0;3
17783;Šilelis;BITUTĖS;9602317911;Ne;0;11;0;11
17784;Šilelis;BITUTĖS;8304500877;Ne;0;4;2;6
17785;Šilelis;BITUTĖS;8741597642;Ne;0;3;3;6
17786;Šilelis;BITUTĖS;7061399035;Ne;15;4;0;19
17787;Šilelis;BITUTĖS;4272205822;Taip;0;4;0;4
17788;Šilelis;BITUTĖS;5484196739;Ne;0;4;5;9
17789;Šilelis;DRUGELIAI;6800679760;Ne;7;4;0;11
17790;Šilelis;DRUGELIAI;3100416582;Ne;10;4;0;14
17791;Šilelis;DRUGELIAI;8563843417;Ne;18;0;0;18
17792;Šilelis;DRUGELIAI;3134882364;Ne;5;3;0;8
17793;Šilelis;DRUGELIAI;5131513427;Ne;5;3;0;8
17794;Šilelis;DRUGELIAI;2575292661;Ne;0;9;0;9
17795;Šilelis;DRUGELIAI;4762848901;Ne;0;7;0;7
17796;Šilelis;DRUGELIAI;8579501639;Ne;15;1;0;16
17797;Šilelis;DRUGELIAI;2073341570;Ne;8;0;0;8
17798;Šilelis;DRUGELIAI;3940956024;Ne;1;2;0;3
17799;Šilelis;DRUGELIAI;3551123110;Ne;19;0;0;19
17800;Šilelis;DRUGELIAI;9047094780;Ne;5;4;0;9
17801;Šilelis;DRUGELIAI;4513916744;Taip;5;0;2;7
17802;Šilelis;DRUGELIAI;1244496708;Ne;0;0;2;2
17803;Šilelis;DRUGELIAI;9593306122;Ne;2;0;1;3
17804;Šilelis;DRUGELIAI;5845704184;Ne;0;6;0;6
17805;Šilelis;DRUGELIAI;5899112658;Ne;10;4;0;14
17806;Šilelis;DRUGELIAI;3080593571;Ne;0;10;0;10
17807;Vaduvos;PAGRANDUKAI;5509202519;Ne;0;1;0;1
17808;Vaduvos;PAGRANDUKAI;4576510280;Ne;19;0;0;19
17809;Vaduvos;PAGRANDUKAI;3060409258;Ne;5;4;0;9
17810;Vaduvos;PAGRANDUKAI;8070494719;Ne;5;4;0;9
17811;Vaduvos;PAGRANDUKAI;3206096414;Ne;16;0;0;16
17812;Vaduvos;PAGRANDUKAI;9232960362;Ne;4;0;0;4
17813;Vaduvos;PAGRANDUKAI;7425991335;Ne;6;1;0;7
17814;Vaduvos;PAGRANDUKAI;7592658267;Ne;6;0;0;6
17815;Vaduvos;PAGRANDUKAI;8533315132;Ne;0;4;0;4
17816;Vaduvos;PAGRANDUKAI;2508650990;Ne;0;14;0;14
17817;Vaduvos;PAGRANDUKAI;1466282653;Ne;12;1;0;13
17818;Vaduvos;PAGRANDUKAI;8055108164;Ne;11;1;0;12
17819;Vaduvos;PAGRANDUKAI;6943057114;Ne;7;5;0;12
17820;Vaduvos;PAGRANDUKAI;8669267296;Ne;5;4;0;9
17821;Vaduvos;PAGRANDUKAI;1736248725;Taip;3;5;0;8
17822;Vaduvos;PAGRANDUKAI;2369774637;Ne;0;10;0;10
17823;Vaduvos;PAGRANDUKAI;9385879695;Ne;7;0;0;7
17824;Vaduvos;PAGRANDUKAI;1414575326;Ne;0;5;0;5
17825;Vaduvos;PAGRANDUKAI;3710830036;Ne;3;13;0;16
17826;Vaduvos;PAGRANDUKAI;7205880191;Ne;10;7;0;17
17827;Vaduvos;PAGRANDUKAI;3695552176;Ne;0;3;0;3
17828;Vaduvos;KODĖLČIUKAI;3010510262;Ne;7;3;0;10
17829;Vaduvos;KODĖLČIUKAI;9429028460;Ne;0;4;0;4
17830;Vaduvos;KODĖLČIUKAI;6210729584;Ne;5;9;0;14
17831;Vaduvos;KODĖLČIUKAI;9606193112;Ne;1;3;0;4
17832;Vaduvos;KODĖLČIUKAI;4177935331;Ne;0;6;0;6
17833;Vaduvos;KODĖLČIUKAI;9983148737;Ne;0;4;0;4
17834;Vaduvos;KODĖLČIUKAI;9072097216;Ne;0;1;0;1
17835;Vaduvos;KODĖLČIUKAI;6810198013;Ne;0;5;0;5
17836;Vaduvos;KODĖLČIUKAI;4270137614;Ne;0;3;0;3
17837;Vaduvos;KODĖLČIUKAI;3682708061;Ne;0;1;0;1
17838;Vaduvos;KODĖLČIUKAI;5262165284;Ne;5;3;0;8
17839;Vaduvos;KODĖLČIUKAI;8603418399;Ne;19;0;0;19
17840;Vaduvos;KODĖLČIUKAI;3096104197;Ne;10;4;0;14
17841;Vaduvos;KODĖLČIUKAI;5761137540;Ne;0;5;0;5
17842;Vaduvos;KODĖLČIUKAI;9597857664;Ne;5;4;0;9
17843;Vaduvos;KODĖLČIUKAI;1054097622;Ne;0;7;0;7
17844;Vaduvos;KODĖLČIUKAI;6013737546;Ne;0;11;0;11
17845;Vaduvos;KODĖLČIUKAI;4789480822;Ne;1;3;0;4
17846;Vaduvos;KODĖLČIUKAI;7904713344;Ne;19;0;0;19
17847;Vaduvos;KODĖLČIUKAI;8324927031;Ne;0;7;0;7
17848;Vaduvos;SMALSUČIAI;2184711783;Ne;0;5;0;5
17849;Vaduvos;SMALSUČIAI;3091707832;Ne;0;4;0;4
17850;Vaduvos;SMALSUČIAI;7181151562;Ne;5;5;0;10
17851;Vaduvos;SMALSUČIAI;6462126837;Ne;5;0;0;5
17852;Vaduvos;SMALSUČIAI;1265287458;Ne;14;0;0;14
17853;Vaduvos;SMALSUČIAI;3948025914;Ne;7;0;0;7
17854;Vaduvos;SMALSUČIAI;6253552951;Ne;14;0;0;14
17855;Vaduvos;SMALSUČIAI;7508333714;Ne;0;6;0;6
17856;Vaduvos;SMALSUČIAI;7789888994;Ne;15;0;0;15
17857;Vaduvos;SMALSUČIAI;6593271671;Ne;9;4;0;13
17858;Vaduvos;SMALSUČIAI;6379952023;Ne;5;2;0;7
17859;Vaduvos;SMALSUČIAI;4550915388;Ne;7;5;0;12
17860;Vaduvos;SMALSUČIAI;3680758366;Ne;6;0;0;6
17861;Vaduvos;SMALSUČIAI;9896249776;Ne;3;4;0;7
17862;Vaduvos;SMALSUČIAI;2643410976;Ne;4;2;0;6
17863;Vaduvos;GILIUKAI;1277811729;Ne;13;2;0;15
17864;Vaduvos;GILIUKAI;1969325922;Taip;0;8;0;8
17865;Vaduvos;GILIUKAI;5376707663;Ne;2;3;0;5
17866;Vaduvos;GILIUKAI;6409466338;Ne;5;2;0;7
17867;Vaduvos;GILIUKAI;2835635250;Ne;3;0;0;3
17868;Vaduvos;GILIUKAI;2939561403;Ne;5;4;0;9
17869;Vaduvos;GILIUKAI;8188374113;Ne;13;0;0;13
17870;Vaduvos;GILIUKAI;6514406042;Ne;7;0;0;7
17871;Vaduvos;GILIUKAI;3057729267;Ne;0;4;0;4
17872;Vaduvos;GILIUKAI;6346625714;Ne;3;0;0;3
17873;Vaduvos;GILIUKAI;8580834401;Ne;0;2;0;2
17874;Vaduvos;GILIUKAI;9167796462;Ne;0;6;0;6
17875;Vaduvos;GILIUKAI;6276149710;Ne;13;1;0;14
17876;Vaduvos;GILIUKAI;6572776966;Ne;2;6;0;8
17877;Vaduvos;GILIUKAI;6676167440;Ne;1;1;0;2
17878;Vaduvos;GILIUKAI;2957685586;Ne;12;0;0;12
17879;Vaduvos;GILIUKAI;3540548094;Ne;2;4;0;6
17880;Vaduvos;GILIUKAI;8964194121;Ne;11;0;0;11
17881;Vaduvos;GILIUKAI;5297217576;Ne;0;5;0;5
17882;Vaduvos;GILIUKAI;5010914832;Ne;3;3;0;6
17883;Vaduvos;GILIUKAI;4030891958;Ne;8;1;0;9
17884;Vaduvos;GILIUKAI;7730737705;Ne;9;0;0;9
17885;Vaduvos;GILIUKAI;2011976336;Ne;0;2;0;2
17886;Vaduvos;GILIUKAI;5510687497;Ne;9;2;0;11
17887;Vaduvos;BORUŽĖLĖS;2277525837;Ne;0;2;0;2
17888;Vaduvos;BORUŽĖLĖS;6439773886;Ne;0;8;0;8
17889;Vaduvos;BORUŽĖLĖS;5634252033;Ne;6;4;0;10
17890;Vaduvos;BORUŽĖLĖS;6593754016;Ne;6;7;0;13
17891;Vaduvos;BORUŽĖLĖS;7521846747;Ne;0;5;0;5
17892;Vaduvos;BORUŽĖLĖS;1422507884;Ne;6;9;0;15
17893;Vaduvos;BORUŽĖLĖS;3461756429;Ne;5;4;0;9
17894;Vaduvos;BORUŽĖLĖS;2417613291;Ne;2;4;0;6
17895;Vaduvos;BORUŽĖLĖS;5717064754;Ne;0;5;0;5
17896;Vaduvos;BORUŽĖLĖS;8064111922;Ne;9;3;0;12
17897;Vaduvos;BORUŽĖLĖS;2923920649;Ne;0;3;0;3
17898;Vaduvos;BORUŽĖLĖS;6552763746;Ne;0;3;0;3
17899;Vaduvos;BORUŽĖLĖS;3255011809;Ne;5;5;0;10
17900;Vaduvos;BORUŽĖLĖS;7169054113;Ne;5;2;0;7
17901;Vaduvos;BORUŽĖLĖS;2366843609;Ne;14;0;1;15
17902;Vaduvos;BORUŽĖLĖS;1924714755;Ne;0;2;0;2
17903;Vaduvos;BORUŽĖLĖS;6991960029;Taip;3;2;0;5
17904;Vaduvos;BORUŽĖLĖS;3833382641;Ne;0;5;0;5
17905;Vaduvos;DRUGELIAI;4936598927;Ne;10;0;0;10
17906;Vaduvos;DRUGELIAI;2341467486;Ne;0;3;0;3
17907;Vaduvos;DRUGELIAI;9824469881;Ne;10;0;0;10
17908;Vaduvos;DRUGELIAI;5915272436;Ne;14;1;0;15
17909;Vaduvos;DRUGELIAI;4238942070;Ne;0;7;0;7
17910;Vaduvos;DRUGELIAI;1539465611;Taip;6;4;0;10
17911;Vaduvos;DRUGELIAI;8384302877;Ne;0;8;0;8
17912;Vaduvos;DRUGELIAI;6770559352;Ne;10;1;0;11
17913;Vaduvos;DRUGELIAI;4856601924;Ne;12;0;0;12
17914;Vaduvos;DRUGELIAI;3477273224;Ne;6;0;0;6
17915;Vaduvos;DRUGELIAI;2452309232;Taip;10;4;0;14
17916;Vaduvos;DRUGELIAI;6776150749;Ne;0;2;0;2
17917;Vaduvos;DRUGELIAI;4587836073;Ne;0;4;0;4
17918;Vaduvos;DRUGELIAI;9333495119;Ne;7;5;0;12
17919;Vaduvos;DRUGELIAI;7597268115;Ne;11;0;0;11
17920;Vaduvos;DRUGELIAI;8400344609;Ne;9;0;0;9
17921;Vaduvos;DRUGELIAI;2789503381;Ne;0;2;0;2
17922;Vaduvos;DRUGELIAI;1987969267;Ne;0;2;0;2
17923;Vaduvos;DRUGELIAI;8990472878;Ne;9;0;0;9
17924;Vaduvos;DRUGELIAI;2717887489;Ne;19;0;0;19
17925;Vaduvos;DRUGELIAI;5881009426;Ne;4;1;0;5
17926;Vaduvos;DRUGELIAI;1434871968;Ne;7;1;0;8
17927;Vaduvos;RIEŠUTĖLIAI;3855900628;Ne;11;4;0;15
17928;Vaduvos;RIEŠUTĖLIAI;8709781176;Ne;14;1;0;15
17929;Vaduvos;RIEŠUTĖLIAI;3690176756;Ne;5;3;0;8
17930;Vaduvos;RIEŠUTĖLIAI;5457850068;Ne;4;7;0;11
17931;Vaduvos;RIEŠUTĖLIAI;9420758132;Ne;0;5;0;5
17932;Vaduvos;RIEŠUTĖLIAI;5217573680;Ne;14;1;0;15
17933;Vaduvos;RIEŠUTĖLIAI;2838261867;Ne;7;3;0;10
17934;Vaduvos;RIEŠUTĖLIAI;3775261278;Ne;7;4;0;11
17935;Vaduvos;RIEŠUTĖLIAI;6824763956;Ne;10;3;0;13
17936;Vaduvos;RIEŠUTĖLIAI;6228969089;Ne;6;0;0;6
17937;Vaduvos;RIEŠUTĖLIAI;6163392340;Ne;19;0;0;19
17938;Vaduvos;RIEŠUTĖLIAI;9508198734;Ne;9;3;0;12
17939;Vaduvos;RIEŠUTĖLIAI;1247907161;Ne;13;0;0;13
17940;Vaduvos;RIEŠUTĖLIAI;5012931485;Ne;16;0;0;16
17941;Vaduvos;RIEŠUTĖLIAI;2767613126;Ne;0;2;0;2
17942;Vaduvos;"1 klasė";4805607216;Ne;0;8;0;8
17943;Vaduvos;"1 klasė";4805607216;Ne;0;8;0;8
17944;Vaduvos;"1 klasė";1696303051;Ne;0;4;0;4
17945;Vaduvos;"1 klasė";1431863758;Ne;0;5;0;5
17946;Vaduvos;"1 klasė";72724196791;Ne;0;4;0;4
17947;Vaduvos;"1 klasė";9371067563;Ne;0;4;0;4
17948;Vaduvos;"1 klasė";2897226343;Ne;0;4;0;4
17949;Vaduvos;"1 klasė";68848152670;Ne;0;4;0;4
17950;Vaduvos;"1 klasė";6425640531;Ne;0;4;0;4
17951;Vaduvos;"1 klasė";4029586203;Ne;0;4;0;4
17952;Vaduvos;"1 klasė";4105978403;Ne;0;5;0;5
17953;Vaduvos;"1 klasė";9540008495;Ne;0;6;0;6
17954;Vaduvos;"1 klasė";8299189235;Ne;0;8;0;8
17955;Vaduvos;"1 klasė";73800920781;Ne;0;4;0;4
17956;Vaduvos;"1 klasė";5428067167;Ne;0;4;0;4
17957;Vaduvos;"1 klasė";5954492368;Ne;0;7;0;7
17958;Vaduvos;"1 klasė";3699578284;Ne;0;4;0;4
17959;Vaduvos;"1 klasė";7397068779;Ne;0;4;0;4
17960;Vaduvos;"1 klasė";8875709110;Ne;0;5;0;5
17961;Vaduvos;"1 klasė";7305111076;Ne;0;5;0;5
17962;Vaduvos;"1 klasė";7163839896;Ne;0;4;0;4
17963;Vaduvos;"1 klasė";7493037613;Ne;0;4;0;4
17964;Vaduvos;"1 klasė";1423148023;Ne;0;4;0;4
17965;Vaduvos;"1 klasė";5573145836;Ne;0;4;0;4
17966;Vaduvos;"1 klasė";7337663549;Ne;0;5;0;5
17967;Vaduvos;"1 klasė";87008942241;Ne;0;4;0;4
17968;Vaduvos;"2 klasė";4365590843;Ne;0;4;0;4
17969;Vaduvos;"2 klasė";3174998523;Ne;0;4;0;4
17970;Vaduvos;"2 klasė";9112649520;Ne;0;4;0;4
17971;Vaduvos;"2 klasė";93702732546;Ne;0;4;0;4
17972;Vaduvos;"2 klasė";15757662594;Ne;0;5;0;5
17973;Vaduvos;"2 klasė";1599595256;Ne;0;4;0;4
17974;Vaduvos;"2 klasė";1825188497;Ne;0;4;0;4
17975;Vaduvos;"2 klasė";4513707989;Ne;0;6;0;6
17976;Vaduvos;"2 klasė";68937983441;Ne;0;6;0;6
17977;Vaduvos;"2 klasė";3722349868;Ne;0;7;0;7
17978;Vaduvos;"2 klasė";13888236429;Ne;0;4;0;4
17979;Vaduvos;"2 klasė";59616893535;Ne;0;4;0;4
17980;Vaduvos;"2 klasė";22641388717;Ne;0;5;0;5
17981;Vaduvos;"2 klasė";21499108813;Ne;0;4;0;4
17982;Vaduvos;"2 klasė";79437154441;Ne;0;4;0;4
17983;Vaduvos;"2 klasė";46608435244;Ne;0;6;0;6
17984;Vaduvos;"2 klasė";5307128703;Ne;0;4;0;4
17985;Vaduvos;"2 klasė";5435336235;Ne;0;4;0;4
17986;Vaduvos;"2 klasė";61046090149;Ne;0;4;0;4
17987;Vaduvos;"2 klasė";56280470781;Ne;0;4;0;4
17988;Vaduvos;"2 klasė";6128582180;Ne;0;6;0;6
17989;Vaduvos;"2 klasė";11202010413;Ne;0;19;0;19
17990;Vaduvos;"2 klasė";1681367373;Ne;0;5;0;5
17991;Vaduvos;"2 klasė";1370696345;Ne;0;4;0;4
17992;Vaduvos;"2 klasė";62183976729;Ne;0;4;0;4
17993;Vaduvos;"2 klasė";4342471835;Ne;0;4;0;4
17994;Vaduvos;"4 klasė";97423576166;Ne;0;4;0;4
17995;Vaduvos;"4 klasė";38504924027;Ne;0;4;0;4
17996;Vaduvos;"4 klasė";96148085691;Ne;0;19;0;19
17997;Vaduvos;"4 klasė";12330772986;Ne;0;4;0;4
17998;Vaduvos;"4 klasė";33277362439;Ne;0;13;0;13
17999;Vaduvos;"4 klasė";41272273463;Ne;0;4;0;4
18000;Vaduvos;"4 klasė";32138087379;Ne;0;19;0;19
18001;Vaduvos;"4 klasė";67324784528;Ne;0;4;0;4
18002;Vaduvos;"4 klasė";4807104855;Ne;0;4;0;4
18003;Vaduvos;"4 klasė";2181614424;Ne;0;4;0;4
18004;Vaduvos;"4 klasė";2019573643;Ne;0;7;0;7
18005;Vaduvos;"4 klasė";27419094487;Ne;0;4;0;4
18006;Vaduvos;"4 klasė";89793734700;Ne;0;5;0;5
18007;Vaduvos;"4 klasė";17473821556;Ne;0;19;0;19
18008;Vaduvos;"4 klasė";53866301875;Ne;0;19;0;19
18009;Vaduvos;"4 klasė";7786986697;Ne;0;4;0;4
18010;Vaduvos;"4 klasė";9147332638;Ne;0;4;0;4
18011;Vaduvos;"4 klasė";1532675814;Ne;0;4;0;4
18012;Vaduvos;"4 klasė";98259624669;Ne;0;19;0;19
18013;Vaduvos;"4 klasė";36931517006;Ne;0;5;0;5
18014;Vaduvos;"4 klasė";61243424057;Ne;0;5;0;5
18015;Vaduvos;"4 klasė";30979103892;Ne;0;4;0;4
18016;Vaduvos;"4 klasė";78245732319;Ne;0;4;0;4
18017;Vaduvos;"4 klasė";48433447683;Ne;0;7;0;7
18018;Vaduvos;"4 klasė";85090873161;Ne;0;19;0;19
18019;Vaduvos;3A;6279678482;Ne;0;6;0;6
18020;Vaduvos;3A;96892752634;Ne;0;5;0;5
18021;Vaduvos;3A;61243200177;Ne;0;4;0;4
18022;Vaduvos;3A;62703428759;Ne;0;4;0;4
18023;Vaduvos;3A;68420568339;Ne;0;5;0;5
18024;Vaduvos;3A;49738318631;Ne;0;4;0;4
18025;Vaduvos;3A;65647119496;Ne;0;4;0;4
18026;Vaduvos;3A;19390879176;Ne;0;5;0;5
18027;Vaduvos;3A;6155494370;Ne;0;4;0;4
18028;Vaduvos;3A;1139509471;Ne;0;19;0;19
18029;Vaduvos;3A;70693742936;Ne;0;5;0;5
18030;Vaduvos;3A;1010061503;Ne;0;13;0;13
18031;Vaduvos;3A;1107557891;Ne;0;19;0;19
18032;Vaduvos;3A;8802765960;Ne;0;4;0;4
18033;Vaduvos;3A;3172047211;Ne;0;4;0;4
18034;Vaduvos;3B;95104294893;Ne;0;7;0;7
18035;Vaduvos;3B;40872193458;Ne;0;19;0;19
18036;Vaduvos;3B;6500567162;Ne;0;6;0;6
18037;Vaduvos;3B;78931952732;Ne;0;4;0;4
18038;Vaduvos;3B;1241148402;Ne;0;6;0;6
18039;Vaduvos;3B;66359913774;Ne;0;5;0;5
18040;Vaduvos;3B;24887196729;Ne;0;4;0;4
18041;Vaduvos;3B;39687066893;Ne;0;7;0;7
18042;Vaduvos;3B;64074141491;Ne;0;4;0;4
18043;Vaduvos;3B;93924290247;Ne;0;8;0;8
18044;Vaduvos;3B;47465933557;Ne;0;9;0;9
18045;Vaduvos;3B;62521006557;Ne;0;4;0;4
18046;Vaduvos;3B;16882774330;Ne;0;4;0;4
18047;Vaduvos;3B;3259114583;Ne;0;10;0;10
18048;Vaduvos;3B;8782782031;Ne;0;4;0;4
18049;Vaduvos;3B;87671358423;Ne;0;19;0;19
18050;Vaduvos;3B;55138588393;Ne;0;4;0;4
18051;Vilkpėdės;PASAKORIŲ;3129307975;Ne;12;0;0;12
18052;Vilkpėdės;PASAKORIŲ;1268568294;Ne;3;0;0;3
18053;Vilkpėdės;PASAKORIŲ;7918728030;Ne;14;0;0;14
18054;Vilkpėdės;PASAKORIŲ;8819707366;Ne;9;0;0;9
18055;Vilkpėdės;PASAKORIŲ;8261543050;Ne;11;0;0;11
18056;Vilkpėdės;PASAKORIŲ;2102814426;Ne;6;0;0;6
18057;Vilkpėdės;PASAKORIŲ;6877083798;Ne;9;0;0;9
18058;Vilkpėdės;PASAKORIŲ;7780157972;Ne;4;0;0;4
18059;Vilkpėdės;PASAKORIŲ;9892981462;Ne;4;0;0;4
18060;Vilkpėdės;PASAKORIŲ;7937515587;Ne;8;0;0;8
18061;Vilkpėdės;PASAKORIŲ;4625117662;Ne;10;0;0;10
18062;Vilkpėdės;PASAKORIŲ;3548680401;Ne;8;0;0;8
18063;Vilkpėdės;PASAKORIŲ;4282952336;Ne;8;0;0;8
18064;Vilkpėdės;PASAKORIŲ;3646631186;Ne;0;5;0;5
18065;Vilkpėdės;PASAKORIŲ;9350127172;Ne;7;0;0;7
18066;Vilkpėdės;MĮSLIUKŲ;7705509136;Ne;5;4;0;9
18067;Vilkpėdės;MĮSLIUKŲ;7370710652;Ne;7;4;0;11
18068;Vilkpėdės;MĮSLIUKŲ;2116411914;Taip;2;4;1;7
18069;Vilkpėdės;MĮSLIUKŲ;4314657343;Ne;2;0;0;2
18070;Vilkpėdės;MĮSLIUKŲ;7184242648;Ne;5;3;0;8
18071;Vilkpėdės;MĮSLIUKŲ;4904820034;Ne;8;0;0;8
18072;Vilkpėdės;MĮSLIUKŲ;3863312205;Ne;14;0;0;14
18073;Vilkpėdės;MĮSLIUKŲ;3379294145;Ne;0;4;0;4
18074;Vilkpėdės;MĮSLIUKŲ;2505859673;Ne;0;4;0;4
18075;Vilkpėdės;MĮSLIUKŲ;8907004805;Ne;5;4;0;9
18076;Vilkpėdės;MĮSLIUKŲ;8348012645;Ne;0;5;0;5
18077;Vilkpėdės;MĮSLIUKŲ;9537458943;Ne;1;4;0;5
18078;Vilkpėdės;MĮSLIUKŲ;7334892130;Ne;4;0;0;4
18079;Vilkpėdės;MĮSLIUKŲ;7900956212;Ne;1;1;0;2
18080;Vilkpėdės;MĮSLIUKŲ;5110059560;Ne;0;4;0;4
18081;Vilkpėdės;ŽINIUKŲ;4270461575;Ne;6;0;0;6
18082;Vilkpėdės;ŽINIUKŲ;4998396593;Ne;5;0;0;5
18083;Vilkpėdės;ŽINIUKŲ;6819447340;Ne;13;0;0;13
18084;Vilkpėdės;ŽINIUKŲ;1278300322;Ne;3;0;3;6
18085;Vilkpėdės;ŽINIUKŲ;9797550851;Ne;3;0;2;5
18086;Vilkpėdės;ŽINIUKŲ;1040357501;Ne;3;0;1;4
18087;Vilkpėdės;ŽINIUKŲ;6876470245;Ne;3;0;1;4
18088;Vilkpėdės;ŽINIUKŲ;8431620518;Ne;3;1;0;4
18089;Vilkpėdės;ŽINIUKŲ;1655396296;Ne;7;2;0;9
18090;Vilkpėdės;ŽINIUKŲ;2358685682;Ne;17;0;0;17
18091;Vilkpėdės;ŽINIUKŲ;5076206526;Ne;0;6;0;6
18092;Vilkpėdės;ŽINIUKŲ;3611416887;Ne;0;6;0;6
18093;Vilkpėdės;ŽINIUKŲ;7008659662;Ne;0;1;0;1
18094;Vilkpėdės;ŽINIUKŲ;9501254301;Ne;0;2;0;2
18095;Vilkpėdės;IŠMINČIŲ;8002436634;Taip;0;3;0;3
18096;Vilkpėdės;IŠMINČIŲ;1249504082;Ne;0;3;1;4
18097;Vilkpėdės;IŠMINČIŲ;4052026470;Ne;4;3;0;7
18098;Vilkpėdės;IŠMINČIŲ;7992484314;Ne;5;3;0;8
18099;Vilkpėdės;IŠMINČIŲ;5050493757;Ne;9;6;0;15
18100;Vilkpėdės;IŠMINČIŲ;8217972925;Ne;0;6;0;6
18101;Vilkpėdės;IŠMINČIŲ;5677284428;Ne;0;4;0;4
18102;Vilkpėdės;IŠMINČIŲ;2232913117;Taip;0;4;14;18
18103;Vilkpėdės;IŠMINČIŲ;7805866055;Ne;2;2;0;4
18104;Vilkpėdės;IŠMINČIŲ;3994451071;Ne;0;0;3;3
18105;Vilkpėdės;IŠMINČIŲ;4726171678;Ne;2;0;0;2
18106;Vilkpėdės;IŠMINČIŲ;2529188623;Ne;4;4;2;10
18107;Vilkpėdės;IŠMINČIŲ;7519472444;Ne;0;3;0;3
18108;Vilkpėdės;IŠMINČIŲ;5569182344;Ne;4;4;0;8
18109;Vilkpėdės;IŠMINČIŲ;3991785883;Ne;1;3;3;7
18110;Vilkpėdės;IŠMINČIŲ;9334610111;Ne;7;2;0;9
18111;Vilkpėdės;IŠMINČIŲ;6268525635;Ne;12;3;0;15
18112;Vilkpėdės;IŠMINČIŲ;3521289746;Ne;11;2;0;13
18113;Vilkpėdės;IŠMINČIŲ;4277073629;Ne;0;19;0;19
18114;Vilkpėdės;IŠMINČIŲ;7489143683;Ne;2;6;0;8
18115;Vilkpėdės;TYRINĖTOJŲ;6418829930;Ne;0;5;0;5
18116;Vilkpėdės;TYRINĖTOJŲ;1633942236;Ne;0;9;0;9
18117;Vilkpėdės;TYRINĖTOJŲ;7829343719;Ne;2;4;0;6
18118;Vilkpėdės;TYRINĖTOJŲ;8484873068;Ne;9;0;0;9
18119;Vilkpėdės;TYRINĖTOJŲ;2503128176;Ne;2;1;0;3
18120;Vilkpėdės;TYRINĖTOJŲ;9570469277;Taip;15;3;0;18
18121;Vilkpėdės;TYRINĖTOJŲ;5274855225;Ne;12;0;0;12
18122;Vilkpėdės;TYRINĖTOJŲ;8860791478;Ne;0;4;0;4
18123;Vilkpėdės;TYRINĖTOJŲ;5420512675;Ne;5;0;1;6
18124;Vilkpėdės;TYRINĖTOJŲ;8613778606;Ne;9;4;0;13
18125;Vilkpėdės;TYRINĖTOJŲ;7991758361;Ne;0;4;0;4
18126;Vilkpėdės;TYRINĖTOJŲ;2736318576;Ne;0;0;2;2
18127;Vilkpėdės;TYRINĖTOJŲ;6064336759;Ne;0;4;0;4
18128;Vilkpėdės;TYRINĖTOJŲ;5577199802;Ne;3;1;0;4
18129;Vilkpėdės;TYRINĖTOJŲ;8930504912;Ne;5;0;0;5
18130;Vilkpėdės;TYRINĖTOJŲ;3303872633;Ne;0;3;0;3
18131;Vilkpėdės;TYRINĖTOJŲ;5972405023;Taip;2;1;0;3
18132;Vilkpėdės;TYRINĖTOJŲ;4485811377;Ne;15;0;0;15
18133;Vilkpėdės;TYRINĖTOJŲ;9841831811;Ne;13;0;0;13
18134;Vilkpėdės;GUDRUOLIŲ;2525399410;Ne;9;0;0;9
18135;Vilkpėdės;GUDRUOLIŲ;1985540746;Ne;8;4;0;12
18136;Vilkpėdės;GUDRUOLIŲ;6198736925;Ne;3;2;0;5
18137;Vilkpėdės;GUDRUOLIŲ;2703704892;Ne;0;2;2;4
18138;Vilkpėdės;GUDRUOLIŲ;5812430367;Ne;5;1;0;6
18139;Vilkpėdės;GUDRUOLIŲ;1478022307;Ne;0;4;0;4
18140;Vilkpėdės;GUDRUOLIŲ;2205143759;Ne;3;1;0;4
18141;Vilkpėdės;GUDRUOLIŲ;7661268641;Ne;4;2;0;6
18142;Vilkpėdės;GUDRUOLIŲ;4018140154;Ne;5;4;0;9
18143;Vilkpėdės;GUDRUOLIŲ;8804335248;Ne;0;4;0;4
18144;Vilkpėdės;GUDRUOLIŲ;1838974989;Ne;4;0;1;5
18145;Vilkpėdės;GUDRUOLIŲ;6598572049;Ne;0;1;0;1
18146;Vilkpėdės;GUDRUOLIŲ;2419661008;Ne;0;4;0;4
18147;Vilkpėdės;GUDRUOLIŲ;7931496783;Ne;0;4;0;4
18148;Vilkpėdės;GUDRUOLIŲ;2418313731;Ne;5;4;0;9
18149;Vilkpėdės;GUDRUOLIŲ;8385974099;Ne;0;5;0;5
18150;Vilkpėdės;GUDRUOLIŲ;1342167313;Ne;3;7;0;10
18151;Vilkpėdės;GUDRUOLIŲ;5334238235;Ne;0;4;0;4
18152;Vilkpėdės;GUDRUOLIŲ;4031175523;Ne;0;1;0;1
18153;Vilkpėdės;GUDRUOLIŲ;6671311193;Ne;0;4;0;4
18154;Vilkpėdės;GUDRUOLIŲ;7114183123;Ne;1;4;0;5
18155;Vilkpėdės;SMALSUOLIŲ;4095366279;Ne;0;9;0;9
18156;Vilkpėdės;SMALSUOLIŲ;1019057127;Ne;6;4;0;10
18157;Vilkpėdės;SMALSUOLIŲ;6522707709;Ne;5;4;0;9
18158;Vilkpėdės;SMALSUOLIŲ;7894766629;Ne;0;4;0;4
18159;Vilkpėdės;SMALSUOLIŲ;1655985778;Ne;9;3;0;12
18160;Vilkpėdės;SMALSUOLIŲ;4311938034;Ne;5;4;0;9
18161;Vilkpėdės;SMALSUOLIŲ;3664125930;Ne;0;2;0;2
18162;Vilkpėdės;SMALSUOLIŲ;8423972962;Ne;0;1;0;1
18163;Vilkpėdės;SMALSUOLIŲ;3350784810;Taip;9;0;0;9
18164;Vilkpėdės;SMALSUOLIŲ;5346798201;Ne;3;5;0;8
18165;Vilkpėdės;SMALSUOLIŲ;1396827668;Ne;0;2;0;2
18166;Vilkpėdės;SMALSUOLIŲ;5551822633;Ne;3;7;0;10
18167;Vilkpėdės;SMALSUOLIŲ;9544418642;Ne;0;3;2;5
18168;Vilkpėdės;SMALSUOLIŲ;1063740772;Ne;3;4;0;7
18169;Vilkpėdės;SMALSUOLIŲ;3666145718;Ne;5;4;0;9
18170;Vilkpėdės;SMALSUOLIŲ;5633014328;Ne;2;1;0;3
18171;Vilkpėdės;SMALSUOLIŲ;3737265597;Ne;5;4;0;9
18172;Vilkpėdės;SMALSUOLIŲ;5422061533;Ne;1;3;0;4
18173;Vilkpėdės;SMALSUOLIŲ;7634076203;Ne;7;0;0;7
18174;Vilkpėdės;SMALSUOLIŲ;2241104719;Ne;0;3;0;3
18175;Vilkpėdės;SMALSUOLIŲ;6690742997;Ne;0;3;0;3
18176;Vilkpėdės;KODĖLČIŲ;6283767445;Ne;1;4;0;5
18177;Vilkpėdės;KODĖLČIŲ;9605430333;Ne;1;5;0;6
18178;Vilkpėdės;KODĖLČIŲ;7745776486;Taip;3;3;0;6
18179;Vilkpėdės;KODĖLČIŲ;8969001990;Ne;1;5;0;6
18180;Vilkpėdės;KODĖLČIŲ;7158737372;Ne;9;6;0;15
18181;Vilkpėdės;KODĖLČIŲ;3785308006;Ne;2;3;0;5
18182;Vilkpėdės;KODĖLČIŲ;6744834487;Ne;4;6;0;10
18183;Vilkpėdės;KODĖLČIŲ;4166416292;Ne;7;8;0;15
18184;Vilkpėdės;KODĖLČIŲ;9601934563;Ne;0;5;0;5
18185;Vilkpėdės;KODĖLČIŲ;7401886306;Ne;0;5;0;5
18186;Vilkpėdės;KODĖLČIŲ;7284081203;Ne;2;3;0;5
18187;Vilkpėdės;KODĖLČIŲ;1528619779;Ne;3;5;0;8
18188;Vilkpėdės;KODĖLČIŲ;2359315281;Ne;0;5;0;5
18189;Vilkpėdės;KODĖLČIŲ;6820236577;Ne;0;3;0;3
18190;Vilkpėdės;KODĖLČIŲ;4255757333;Ne;0;3;0;3
18191;Vilkpėdės;KODĖLČIŲ;5053032081;Ne;0;3;0;3
18192;Vilkpėdės;KODĖLČIŲ;6778288398;Ne;0;4;0;4
18193;Vilkpėdės;KODĖLČIŲ;1537270256;Ne;4;4;0;8
18194;Vilkpėdės;KODĖLČIŲ;3229559339;Ne;4;4;0;8
18195;Vilkpėdės;MOKSLINČIŲ;9294350205;Ne;0;4;0;4
18196;Vilkpėdės;MOKSLINČIŲ;5048931309;Ne;0;4;0;4
18197;Vilkpėdės;MOKSLINČIŲ;7698759895;Ne;0;5;3;8
18198;Vilkpėdės;MOKSLINČIŲ;1217929358;Ne;0;4;0;4
18199;Vilkpėdės;MOKSLINČIŲ;1807884737;Ne;9;4;0;13
18200;Vilkpėdės;MOKSLINČIŲ;2251274741;Ne;7;5;0;12
18201;Vilkpėdės;MOKSLINČIŲ;6816745585;Ne;0;4;0;4
18202;Vilkpėdės;MOKSLINČIŲ;9460356725;Ne;0;4;0;4
18203;Vilkpėdės;MOKSLINČIŲ;8128254701;Ne;0;6;0;6
18204;Vilkpėdės;MOKSLINČIŲ;8015392054;Ne;0;3;0;3
18205;Vilkpėdės;MOKSLINČIŲ;2320350937;Ne;0;6;0;6
18206;Vilkpėdės;MOKSLINČIŲ;7747013579;Ne;0;4;0;4
18207;Vilkpėdės;MOKSLINČIŲ;3987021185;Ne;5;8;0;13
18208;Vilkpėdės;MOKSLINČIŲ;7908813288;Ne;0;4;0;4
18209;Vilkpėdės;MOKSLINČIŲ;9795696242;Ne;0;9;2;11
18210;Vilkpėdės;MOKSLINČIŲ;8581661608;Ne;0;4;0;4
18211;Vilkpėdės;MOKSLINČIŲ;6261547304;Ne;0;2;0;2
18212;Vilkpėdės;MOKSLINČIŲ;2420271759;Ne;0;11;0;11
18213;Vilkpėdės;MOKSLINČIŲ;3696611509;Ne;0;3;0;3
18214;Vilkpėdės;MOKSLINČIŲ;4735164204;Ne;0;4;0;4
18215;Vilkpėdės;MOKSLINČIŲ;2604179994;Ne;0;4;0;4
18216;Vilkpėdės;MOKSLINČIŲ;3888880306;Ne;2;6;1;9
18217;Vilkpėdės;MOKSLINČIŲ;1063561954;Ne;0;5;0;5
18218;Vilkpėdės;MOKSLINČIŲ;8783790519;Ne;1;5;1;7
18219;Žiburėlis;Nykštukai;4109288891;Taip;12;4;0;16
18220;Žiburėlis;Nykštukai;7522040537;Ne;3;2;0;5
18221;Žiburėlis;Nykštukai;1015624216;Ne;0;4;0;4
18222;Žiburėlis;Nykštukai;9526477121;Ne;0;8;0;8
18223;Žiburėlis;Nykštukai;4387021429;Ne;0;6;0;6
18224;Žiburėlis;Nykštukai;4910787530;Ne;0;14;0;14
18225;Žiburėlis;Nykštukai;9783567484;Ne;0;5;0;5
18226;Žiburėlis;Nykštukai;4916545915;Ne;0;11;0;11
18227;Žiburėlis;Nykštukai;8133371774;Ne;0;11;0;11
18228;Žiburėlis;Nykštukai;7278242428;Taip;3;4;0;7
18229;Žiburėlis;Nykštukai;5732540560;Ne;0;6;0;6
18230;Žiburėlis;Nykštukai;1833704617;Ne;0;4;0;4
18231;Žiburėlis;Nykštukai;1228806324;Ne;0;1;0;1
18232;Žiburėlis;Nykštukai;2163018032;Ne;0;12;0;12
18233;Žiburėlis;Nykštukai;4581800760;Taip;0;1;0;1
18234;Žiburėlis;Nykštukai;5002691930;Ne;0;1;0;1
18235;Žiburėlis;Nykštukai;8346571253;Ne;5;3;0;8
18236;Žiburėlis;Nykštukai;5098955523;Ne;0;9;0;9
18237;Žiburėlis;Nykštukai;5629404179;Ne;3;4;0;7
18238;Žiburėlis;Nykštukai;6647598068;Ne;0;4;0;4
18239;Žiburėlis;Nykštukai;1190058462;Ne;0;4;0;4
18240;Žiburėlis;Nykštukai;7111530833;Ne;0;2;0;2
18241;Žiburėlis;"Žiniukai ";3687703187;Ne;0;6;0;6
18242;Žiburėlis;"Žiniukai ";1061646244;Ne;1;2;0;3
18243;Žiburėlis;"Žiniukai ";8215816053;Ne;0;4;0;4
18244;Žiburėlis;"Žiniukai ";7465939429;Ne;0;3;0;3
18245;Žiburėlis;"Žiniukai ";4710995351;Ne;1;3;0;4
18246;Žiburėlis;"Žiniukai ";9932264675;Ne;0;2;0;2
18247;Žiburėlis;"Žiniukai ";7211961512;Ne;0;1;0;1
18248;Žiburėlis;"Žiniukai ";1559091567;Ne;0;4;0;4
18249;Žiburėlis;"Žiniukai ";3750024153;Ne;0;4;0;4
18250;Žiburėlis;"Žiniukai ";7633450988;Ne;1;4;0;5
18251;Žiburėlis;"Žiniukai ";8480167191;Ne;11;4;0;15
18252;Žiburėlis;"Žiniukai ";2292895729;Ne;1;1;0;2
18253;Žiburėlis;"Žiniukai ";2253167147;Ne;1;2;0;3
18254;Žiburėlis;"Žiniukai ";7163594513;Ne;6;4;0;10
18255;Žiburėlis;"Žiniukai ";5408766721;Ne;0;5;0;5
18256;Žiburėlis;"Žiniukai ";1764592065;Ne;0;4;0;4
18257;Žiburėlis;"Žiniukai ";7862546963;Ne;2;3;0;5
18258;Žiburėlis;"Žiniukai ";8902837168;Ne;2;3;0;5
18259;Žiburėlis;"Žiniukai ";6696156248;Ne;0;2;0;2
18260;Žiburėlis;"Žiniukai ";3938379566;Ne;0;6;0;6
18261;Žiburėlis;"Žiniukai ";5174211773;Ne;0;3;0;3
18262;Žiburėlis;"Žiniukai ";9818415192;Ne;3;5;0;8
18263;Žiburėlis;"Smalsiukai ";5438697081;Ne;0;6;0;6
18264;Žiburėlis;"Smalsiukai ";1126972447;Ne;0;4;0;4
18265;Žiburėlis;"Smalsiukai ";3936418539;Ne;0;4;0;4
18266;Žiburėlis;"Smalsiukai ";2072972990;Ne;0;4;0;4
18267;Žiburėlis;"Smalsiukai ";8875517201;Ne;0;5;0;5
18268;Žiburėlis;"Smalsiukai ";8065557477;Ne;0;5;0;5
18269;Žiburėlis;"Smalsiukai ";3770227955;Ne;0;1;0;1
18270;Žiburėlis;"Smalsiukai ";1843213137;Ne;0;7;0;7
18271;Žiburėlis;"Smalsiukai ";8953230752;Ne;0;6;0;6
18272;Žiburėlis;"Smalsiukai ";7402647048;Ne;0;3;0;3
18273;Žiburėlis;"Smalsiukai ";9352485231;Ne;0;5;0;5
18274;Žiburėlis;"Smalsiukai ";2491972986;Ne;0;13;0;13
18275;Žiburėlis;"Smalsiukai ";8973307069;Ne;0;3;0;3
18276;Žiburėlis;"Smalsiukai ";7825665451;Ne;0;6;0;6
18277;Žiburėlis;"Smalsiukai ";5556807335;Ne;0;2;0;2
18278;Žiburėlis;"Smalsiukai ";8970153523;Ne;0;6;0;6
18279;Žiburėlis;"Smalsiukai ";5145195661;Ne;0;6;0;6
18280;Žiburėlis;"Smalsiukai ";8018718405;Ne;0;3;0;3
18281;Žiburėlis;"Giliukai ";7310274376;Ne;1;0;0;1
18282;Žiburėlis;"Giliukai ";1090883494;Ne;1;3;0;4
18283;Žiburėlis;"Giliukai ";9215654134;Taip;1;6;0;7
18284;Žiburėlis;"Giliukai ";2866098551;Ne;13;0;0;13
18285;Žiburėlis;"Giliukai ";6918525245;Ne;0;5;0;5
18286;Žiburėlis;"Giliukai ";6946621147;Ne;0;5;0;5
18287;Žiburėlis;"Giliukai ";5148264064;Ne;4;3;0;7
18288;Žiburėlis;"Giliukai ";6733333096;Ne;0;5;0;5
18289;Žiburėlis;"Giliukai ";1943162133;Ne;0;4;0;4
18290;Žiburėlis;"Giliukai ";6232492947;Ne;8;4;0;12
18291;Žiburėlis;"Giliukai ";3807588865;Ne;0;1;0;1
18292;Žiburėlis;"Giliukai ";4091901597;Ne;0;5;0;5
18293;Žiburėlis;"Giliukai ";4016969144;Ne;3;4;0;7
18294;Žiburėlis;"Giliukai ";3776569251;Ne;4;3;0;7
18295;Žiburėlis;"Giliukai ";9494271740;Ne;0;3;0;3
18296;Žiburėlis;"Giliukai ";3992503848;Ne;1;4;0;5
18297;Žiburėlis;"Giliukai ";8440073413;Ne;3;4;0;7
18298;Žiburėlis;"Giliukai ";6121237159;Ne;3;4;0;7
18299;Žiburėlis;"Giliukai ";6289338466;Ne;6;5;0;11
18300;Žiburėlis;"Giliukai ";7977098545;Ne;10;1;0;11
18301;Žiburėlis;"Giliukai ";8697451319;Ne;1;6;0;7
18302;Žiburėlis;Meškiukai;3593851196;Ne;4;3;2;9
18303;Žiburėlis;Meškiukai;9470154520;Ne;2;4;5;11
18304;Žiburėlis;Meškiukai;2285666668;Ne;0;4;1;5
18305;Žiburėlis;Meškiukai;9321467329;Ne;0;1;0;1
18306;Žiburėlis;Meškiukai;2254407798;Ne;0;4;0;4
18307;Žiburėlis;Meškiukai;4887304311;Ne;1;0;0;1
18308;Žiburėlis;Meškiukai;1651713696;Ne;2;2;0;4
18309;Žiburėlis;Meškiukai;1105220246;Ne;7;4;0;11
18310;Žiburėlis;Meškiukai;8415647388;Ne;0;3;0;3
18311;Žiburėlis;Meškiukai;2371990135;Ne;0;4;0;4
18312;Žiburėlis;Meškiukai;8883542394;Ne;0;1;0;1
18313;Žiburėlis;Meškiukai;6218255066;Ne;3;0;0;3
18314;Žiburėlis;Meškiukai;3522480911;Taip;3;4;6;13
18315;Žiburėlis;Meškiukai;4667559315;Ne;0;4;0;4
18316;Žiburėlis;Meškiukai;1606332622;Ne;0;1;1;2
18317;Žiburėlis;Meškiukai;1758251348;Ne;0;1;0;1
18318;Žiburėlis;Meškiukai;8284913889;Ne;6;0;2;8
18319;Žiburėlis;Meškiukai;1121755119;Ne;5;2;0;7
18320;Žiburėlis;Meškiukai;2851350451;Ne;4;2;0;6
18321;Žiburėlis;Meškiukai;6206770019;Ne;0;13;0;13
18322;Žiburėlis;Viščiukai;2720743003;Taip;6;0;0;6
18323;Žiburėlis;Viščiukai;5059109680;Ne;4;0;0;4
18324;Žiburėlis;Viščiukai;9806711776;Ne;12;0;0;12
18325;Žiburėlis;Viščiukai;7426295852;Ne;4;4;0;8
18326;Žiburėlis;Viščiukai;4679250546;Ne;2;2;0;4
18327;Žiburėlis;Viščiukai;9160488283;Ne;1;0;0;1
18328;Žiburėlis;Viščiukai;3069436943;Ne;18;0;0;18
18329;Žiburėlis;Viščiukai;1507346142;Ne;16;0;0;16
18330;Žiburėlis;Viščiukai;4066875778;Ne;3;0;0;3
18331;Žiburėlis;Viščiukai;9369610274;Ne;7;1;0;8
18332;Žiburėlis;Viščiukai;9009869114;Ne;7;0;0;7
18333;Žiburėlis;Viščiukai;1839099729;Ne;3;0;0;3
18334;Žiburėlis;Viščiukai;1758228365;Ne;4;0;0;4
18335;Žiburėlis;Viščiukai;2382486049;Ne;2;0;0;2
18336;Žiburėlis;Viščiukai;6856548398;Ne;3;0;0;3
18337;Žiburėlis;Viščiukai;5490536675;Ne;5;0;0;5
18338;Žiburėlis;Viščiukai;6145211660;Ne;3;0;0;3
18339;Žiburėlis;Viščiukai;8694628008;Ne;7;0;0;7
18340;Žiburėlis;"Drambliukai ";5115160061;Taip;29;0;0;29
18341;Žiburėlis;"Drambliukai ";7364102991;Ne;12;6;0;18
18342;Žiburėlis;"Drambliukai ";8179414341;Ne;5;3;0;8
18343;Žiburėlis;"Drambliukai ";3323538690;Ne;0;2;0;2
18344;Žiburėlis;"Drambliukai ";3738184802;Ne;5;4;0;9
18345;Žiburėlis;"Drambliukai ";8603154782;Ne;0;8;0;8
18346;Žiburėlis;"Drambliukai ";5213049603;Ne;25;0;0;25
18347;Žiburėlis;"Drambliukai ";6750601280;Taip;8;4;0;12
18348;Žiburėlis;"Drambliukai ";9048781241;Ne;16;0;0;16
18349;Žiburėlis;"Drambliukai ";6126086504;Ne;15;3;0;18
18350;Žiburėlis;"Drambliukai ";7687475882;Ne;14;0;0;14
18351;Žiburėlis;"Drambliukai ";5254196326;Ne;5;2;0;7
18352;Žiburėlis;"Drambliukai ";8444514098;Ne;21;0;0;21
18353;Žiburėlis;"Drambliukai ";4459356832;Ne;9;3;0;12
18354;Žiburėlis;"Drambliukai ";3787858744;Ne;0;5;0;5
18355;Žiburėlis;"Drambliukai ";5579727416;Ne;15;2;0;17
18356;Žiburėlis;"Drambliukai ";1449541244;Taip;19;4;0;23
18357;Žiburėlis;"Drambliukai ";2472729022;Ne;5;13;0;18
18358;Žiburėlis;BORUŽIUKAI;3723613593;Ne;7;4;0;11
18359;Žiburėlis;BORUŽIUKAI;9964255985;Ne;0;2;0;2
18360;Žiburėlis;BORUŽIUKAI;7895148630;Ne;5;3;0;8
18361;Žiburėlis;BORUŽIUKAI;8936912406;Ne;3;4;0;7
18362;Žiburėlis;BORUŽIUKAI;4631232618;Ne;3;2;0;5
18363;Žiburėlis;BORUŽIUKAI;5793531526;Ne;0;5;0;5
18364;Žiburėlis;BORUŽIUKAI;4578828135;Ne;1;4;0;5
18365;Žiburėlis;BORUŽIUKAI;6128571259;Taip;5;2;0;7
18366;Žiburėlis;BORUŽIUKAI;3760039280;Ne;0;4;0;4
18367;Žiburėlis;BORUŽIUKAI;5799439634;Ne;0;2;0;2
18368;Žiburėlis;BORUŽIUKAI;4229040996;Ne;0;3;0;3
18369;Žiburėlis;BORUŽIUKAI;8373944614;Ne;11;4;0;15
18370;Žiburėlis;BORUŽIUKAI;9256751455;Ne;6;2;0;8
18371;Žiburėlis;BORUŽIUKAI;9357376188;Ne;3;6;0;9
18372;Žiburėlis;BORUŽIUKAI;4233222771;Ne;0;4;0;4
18373;Žiburėlis;BORUŽIUKAI;9029039015;Ne;2;4;0;6
18374;Žiburėlis;BORUŽIUKAI;7017574924;Ne;5;4;0;9
18375;Žiburėlis;BORUŽIUKAI;1661456806;Ne;1;4;0;5
18376;Žiburėlis;BORUŽIUKAI;2527837980;Ne;19;0;0;19
18377;Žiburėlis;BORUŽIUKAI;9771442035;Ne;2;4;0;6
18378;Žiburėlis;SPINDULIUKAI;2995697464;Ne;6;6;0;12
18379;Žiburėlis;SPINDULIUKAI;7856708616;Ne;0;5;0;5
18380;Žiburėlis;SPINDULIUKAI;5205959106;Ne;0;7;0;7
18381;Žiburėlis;SPINDULIUKAI;5951659866;Ne;0;4;0;4
18382;Žiburėlis;SPINDULIUKAI;1775465307;Ne;0;6;0;6
18383;Žiburėlis;SPINDULIUKAI;4720567144;Ne;0;2;0;2
18384;Žiburėlis;SPINDULIUKAI;2808361570;Ne;0;3;0;3
18385;Žiburėlis;SPINDULIUKAI;5881242405;Ne;0;5;0;5
18386;Žiburėlis;SPINDULIUKAI;2131951626;Ne;0;5;0;5
18387;Žiburėlis;SPINDULIUKAI;3253759256;Taip;0;7;0;7
18388;Žiburėlis;SPINDULIUKAI;6969335298;Ne;2;2;0;4
18389;Žiburėlis;SPINDULIUKAI;5835919483;Ne;14;0;0;14
18390;Žiburėlis;SPINDULIUKAI;4738991020;Ne;1;4;0;5
18391;Žiburėlis;SPINDULIUKAI;6080914975;Ne;9;4;0;13
18392;Žiburėlis;SPINDULIUKAI;9325991773;Ne;1;4;0;5
18393;Žiburėlis;SPINDULIUKAI;6674351628;Ne;0;5;0;5
18394;Žiburėlis;SPINDULIUKAI;5075522632;Ne;0;3;0;3
18395;Žiburėlis;SPINDULIUKAI;1908345602;Ne;6;3;0;9
18396;Žiburėlis;SPINDULIUKAI;8140848665;Ne;8;4;0;12
18397;Žiburėlis;SPINDULIUKAI;4727673956;Ne;0;4;0;4
18398;Žiburėlis;SPINDULIUKAI;2186032732;Ne;4;1;0;5
18399;Žiburėlis;KIŠKUČIAI;6492467281;Ne;0;9;0;9
18400;Žiburėlis;KIŠKUČIAI;3352845095;Ne;3;4;0;7
18401;Žiburėlis;KIŠKUČIAI;1004953300;Taip;0;4;0;4
18402;Žiburėlis;KIŠKUČIAI;3296994981;Ne;0;9;0;9
18403;Žiburėlis;KIŠKUČIAI;6019278045;Ne;5;4;0;9
18404;Žiburėlis;KIŠKUČIAI;5418413225;Ne;0;4;0;4
18405;Žiburėlis;KIŠKUČIAI;6044837042;Taip;0;9;1;10
18406;Žiburėlis;KIŠKUČIAI;1334695206;Ne;5;4;0;9
18407;Žiburėlis;KIŠKUČIAI;7597762608;Ne;0;1;0;1
18408;Žiburėlis;KIŠKUČIAI;6562748977;Ne;9;4;0;13
18409;Žiburėlis;KIŠKUČIAI;4477396434;Ne;4;6;0;10
18410;Žiburėlis;KIŠKUČIAI;2712358146;Taip;5;4;0;9
18411;Žiburėlis;KIŠKUČIAI;5410394172;Ne;1;6;0;7
18412;Žiburėlis;KIŠKUČIAI;4003368130;Ne;15;4;0;19
18413;Žiburėlis;KIŠKUČIAI;2456703958;Ne;4;4;1;9
18414;Žiburėlis;KIŠKUČIAI;1868558773;Taip;4;5;0;9
18415;Žiburėlis;KIŠKUČIAI;2083500905;Ne;0;7;0;7
18416;Žiburėlis;KIŠKUČIAI;6577061306;Ne;0;4;1;5
18417;Žiburėlis;KIŠKUČIAI;9731661697;Taip;4;0;0;4
18418;Žiburėlis;DRUGELIAI;9551175579;Ne;10;4;0;14
18419;Žiburėlis;DRUGELIAI;2872122574;Ne;19;0;0;19
18420;Žiburėlis;DRUGELIAI;5422660783;Ne;19;0;0;19
18421;Žiburėlis;DRUGELIAI;5758539955;Ne;19;0;0;19
18422;Žiburėlis;DRUGELIAI;3780842203;Taip;0;7;0;7
18423;Žiburėlis;DRUGELIAI;6751043071;Ne;4;1;0;5
18424;Žiburėlis;DRUGELIAI;8082088504;Taip;0;6;0;6
18425;Žiburėlis;DRUGELIAI;5025452484;Taip;0;9;0;9
18426;Žiburėlis;DRUGELIAI;5724506894;Ne;0;7;0;7
18427;Žiburėlis;DRUGELIAI;8207315673;Taip;0;3;0;3
18428;Žiburėlis;DRUGELIAI;4656467260;Ne;0;2;0;2
18429;Žiburėlis;DRUGELIAI;9344950711;Ne;5;3;0;8
18430;Žiburėlis;DRUGELIAI;2102574423;Ne;0;2;0;2
18431;Žiburėlis;DRUGELIAI;6274583813;Ne;0;1;0;1
18432;Žiburėlis;DRUGELIAI;5194593598;Ne;12;1;0;13
18433;Žiburėlis;DRUGELIAI;2383554216;Ne;0;4;0;4
18434;Žiburėlis;DRUGELIAI;9041469393;Taip;0;5;0;5
18435;Žiburėlis;DRUGELIAI;8285987095;Ne;5;9;0;14
18436;Žiburėlis;DRUGELIAI;8752098051;Ne;0;3;0;3
18437;Žiburėlis;DRUGELIAI;4937518207;Ne;0;4;5;9
18438;Žiburėlis;DRUGELIAI;2805244671;Ne;0;0;4;4
18439;Bangelė;Aštuonkojai;6216334243;Ne;0;7;0;7
18440;Bangelė;Aštuonkojai;8406002339;Ne;0;2;2;4
18441;Bangelė;Aštuonkojai;8385661612;Ne;8;0;1;9
18442;Bangelė;Aštuonkojai;7434358474;Ne;0;14;0;14
18443;Bangelė;Aštuonkojai;3471355267;Ne;9;1;0;10
18444;Bangelė;Aštuonkojai;6978215876;Ne;3;0;6;9
18445;Bangelė;Aštuonkojai;9801978617;Ne;0;3;0;3
18446;Bangelė;Aštuonkojai;9608900293;Ne;0;0;1;1
18447;Bangelė;Aštuonkojai;7434879947;Ne;4;0;0;4
18448;Bangelė;Aštuonkojai;7107685761;Ne;0;2;0;2
18449;Bangelė;Aštuonkojai;5994720767;Ne;4;5;0;9
18450;Bangelė;Aštuonkojai;4532810332;Ne;0;10;0;10
18451;Bangelė;Aštuonkojai;8575020060;Ne;0;10;0;10
18452;Bangelė;Aštuonkojai;3344441441;Ne;7;0;0;7
18453;Bangelė;Aštuonkojai;2858929915;Ne;7;4;1;12
18454;Bangelė;Aštuonkojai;7068305612;Ne;7;0;3;10
18455;Bangelė;Aštuonkojai;8661284187;Ne;4;0;2;6
18456;Bangelė;Aštuonkojai;8943721679;Ne;0;5;0;5
18457;Bangelė;Delfinukai,;9142460659;Ne;5;0;0;5
18458;Bangelė;Delfinukai,;6566277472;Ne;10;0;1;11
18459;Bangelė;Delfinukai,;1541525635;Ne;0;4;1;5
18460;Bangelė;Delfinukai,;7362196984;Ne;11;0;0;11
18461;Bangelė;Delfinukai,;4317054990;Ne;4;4;0;8
18462;Bangelė;Delfinukai,;4651237403;Ne;4;0;0;4
18463;Bangelė;Delfinukai,;4712616315;Ne;0;3;0;3
18464;Bangelė;Delfinukai,;2518820268;Ne;1;0;1;2
18465;Bangelė;Delfinukai,;4940247006;Ne;10;0;0;10
18466;Bangelė;Delfinukai,;8335931279;Ne;0;5;0;5
18467;Bangelė;Delfinukai,;9311379746;Ne;0;4;5;9
18468;Bangelė;Delfinukai,;5980274157;Ne;0;4;0;4
18469;Bangelė;Delfinukai,;4851593235;Ne;0;4;5;9
18470;Bangelė;Delfinukai,;8998648968;Ne;5;4;0;9
18471;Bangelė;Delfinukai,;7016039389;Ne;0;1;0;1
18472;Bangelė;Delfinukai,;2127734178;Ne;7;0;1;8
18473;Bangelė;Delfinukai,;2107766301;Ne;19;0;0;19
18474;Bangelė;Delfinukai,;5237434283;Ne;0;4;0;4
18475;Bangelė;"Saulės spindulėliai";9488932192;Ne;0;4;0;4
18476;Bangelė;"Saulės spindulėliai";4843411757;Ne;6;4;0;10
18477;Bangelė;"Saulės spindulėliai";1754002501;Ne;0;5;0;5
18478;Bangelė;"Saulės spindulėliai";2491928697;Ne;0;2;0;2
18479;Bangelė;"Saulės spindulėliai";6953698592;Ne;0;3;0;3
18480;Bangelė;"Saulės spindulėliai";3063439996;Ne;0;4;0;4
18481;Bangelė;"Saulės spindulėliai";6026399355;Ne;0;6;0;6
18482;Bangelė;"Saulės spindulėliai";2156837975;Ne;0;6;0;6
18483;Bangelė;"Saulės spindulėliai";9143945953;Ne;0;3;2;5
18484;Bangelė;"Saulės spindulėliai";3022508446;Ne;0;4;2;6
18485;Bangelė;"Saulės spindulėliai";5476753511;Ne;0;4;1;5
18486;Bangelė;"Saulės spindulėliai";5546256869;Ne;0;1;0;1
18487;Bangelė;"Saulės spindulėliai";6980232224;Ne;0;4;0;4
18488;Bangelė;"Saulės spindulėliai";1390623903;Ne;0;4;0;4
18489;Bangelė;"Saulės spindulėliai";9788923823;Ne;0;9;0;9
18490;Bangelė;"Saulės spindulėliai";7136625230;Ne;0;4;0;4
18491;Bangelė;"Saulės spindulėliai";9168310196;Ne;0;5;0;5
18492;Bangelė;"Saulės spindulėliai";9790680407;Taip;6;4;1;11
18493;Bangelė;"Pingvinukai ";2405364948;Ne;16;0;0;16
18494;Bangelė;"Pingvinukai ";7782233807;Ne;6;0;1;7
18495;Bangelė;"Pingvinukai ";8959248662;Ne;0;0;3;3
18496;Bangelė;"Pingvinukai ";5054826517;Ne;0;0;5;5
18497;Bangelė;"Pingvinukai ";8943497040;Ne;0;11;0;11
18498;Bangelė;"Pingvinukai ";8297403610;Ne;0;0;8;8
18499;Bangelė;"Pingvinukai ";2023033514;Ne;8;0;6;14
18500;Bangelė;"Pingvinukai ";3351519357;Ne;8;0;0;8
18501;Bangelė;"Pingvinukai ";7794085741;Ne;0;4;8;12
18502;Bangelė;"Pingvinukai ";8372151959;Ne;0;0;5;5
18503;Bangelė;"Pingvinukai ";2279517392;Ne;19;0;0;19
18504;Bangelė;"Pingvinukai ";6433126719;Ne;7;0;0;7
18505;Bangelė;"Pingvinukai ";9740713810;Ne;8;4;7;19
18506;Bangelė;"Pingvinukai ";5829865386;Ne;10;0;2;12
18507;Bangelė;"Pingvinukai ";7808569484;Ne;0;4;8;12
18508;Bangelė;"Pingvinukai ";8981519368;Ne;0;0;4;4
18509;Bangelė;"Pingvinukai ";2362345363;Ne;19;0;0;19
18510;Bangelė;"Jūros žvaigždutės ";9447145378;Ne;0;0;4;4
18511;Bangelė;"Jūros žvaigždutės ";8745595583;Ne;18;0;0;18
18512;Bangelė;"Jūros žvaigždutės ";6174617493;Ne;7;6;0;13
18513;Bangelė;"Jūros žvaigždutės ";8075810032;Ne;0;3;0;3
18514;Bangelė;"Jūros žvaigždutės ";2624013880;Ne;5;0;2;7
18515;Bangelė;"Jūros žvaigždutės ";6397805392;Ne;10;5;0;15
18516;Bangelė;"Jūros žvaigždutės ";1724955001;Ne;3;4;1;8
18517;Bangelė;"Jūros žvaigždutės ";5961647252;Ne;0;7;0;7
18518;Bangelė;"Jūros žvaigždutės ";3851738513;Ne;0;3;0;3
18519;Bangelė;"Jūros žvaigždutės ";4891131242;Ne;10;4;0;14
18520;Bangelė;"Jūros žvaigždutės ";8931569423;Ne;2;1;2;5
18521;Bangelė;"Jūros žvaigždutės ";7364368699;Ne;10;4;0;14
18522;Bangelė;"Jūros žvaigždutės ";7755966282;Ne;0;4;1;5
18523;Bangelė;"Jūros žvaigždutės ";6400785821;Ne;0;3;1;4
18524;Bangelė;"Jūros žvaigždutės ";8765892966;Ne;0;2;0;2
18525;Bangelė;"Jūros žvaigždutės ";4480762963;Ne;6;4;1;11
18526;Bangelė;"Jūros žvaigždutės ";5370269001;Ne;15;2;0;17
18527;Bangelė;Žuvytės;7174742281;Ne;8;8;0;16
18528;Bangelė;Žuvytės;6806911810;Ne;3;6;0;9
18529;Bangelė;Žuvytės;6548270099;Ne;8;4;0;12
18530;Bangelė;Žuvytės;7074211876;Ne;0;0;1;1
18531;Bangelė;Žuvytės;4086446380;Ne;2;6;0;8
18532;Bangelė;Žuvytės;9268294844;Ne;0;4;1;5
18533;Bangelė;Žuvytės;4831656996;Ne;0;0;2;2
18534;Bangelė;Žuvytės;3069288815;Ne;0;0;4;4
18535;Bangelė;Žuvytės;9633372201;Ne;0;3;0;3
18536;Bangelė;Žuvytės;8563674709;Ne;0;3;1;4
18537;Bangelė;Žuvytės;5673493708;Ne;5;9;0;14
18538;Bangelė;Žuvytės;3946690047;Taip;0;0;2;2
18539;Bangelė;Žuvytės;3500097405;Taip;19;0;0;19
18540;Bangelė;Žuvytės;1544311819;Ne;0;1;0;1
18541;Bangelė;Žuvytės;4080993439;Ne;5;0;0;5
18542;Bangelė;Žuvytės;3744789873;Ne;12;0;1;13
18543;Bangelė;Žuvytės;3016778137;Ne;3;0;0;3
18544;Bangelė;Žuvytės;1898671487;Ne;0;3;1;4
18545;Bangelė;Ruoniai;7685394517;Ne;0;1;0;1
18546;Bangelė;Ruoniai;8758933649;Ne;0;4;3;7
18547;Bangelė;Ruoniai;8702632542;Ne;0;5;0;5
18548;Bangelė;Ruoniai;6480681705;Ne;0;1;0;1
18549;Bangelė;Ruoniai;7142694888;Ne;5;8;0;13
18550;Bangelė;Ruoniai;8734511431;Ne;0;6;0;6
18551;Bangelė;Ruoniai;1895213200;Ne;0;0;7;7
18552;Bangelė;Ruoniai;9765268154;Ne;0;10;0;10
18553;Bangelė;Ruoniai;8495423628;Ne;0;5;0;5
18554;Bangelė;Ruoniai;7419016784;Ne;0;4;5;9
18555;Bangelė;Ruoniai;5190563034;Ne;4;3;0;7
18556;Bangelė;Ruoniai;9980881014;Ne;0;6;0;6
18557;Bangelė;Ruoniai;9954762483;Ne;0;5;0;5
18558;Bangelė;Ruoniai;9493465898;Ne;0;4;0;4
18559;Bangelė;Ruoniai;5597329949;Ne;0;6;0;6
18560;Bangelė;Ruoniai;2134225414;Ne;3;0;3;6
18561;Bangelė;Ruoniai;4494049529;Ne;0;0;2;2
18562;Bangelė;Ruoniai;3334029244;Ne;5;0;6;11
18563;Bangelė;Ruoniai;6496580354;Ne;0;12;0;12
18564;Bangelė;Ruoniai;6165322599;Ne;0;2;0;2
18565;Bangelė;"Pagrandukai ";9355348960;Ne;6;3;1;10
18566;Bangelė;"Pagrandukai ";1467390411;Ne;5;1;0;6
18567;Bangelė;"Pagrandukai ";7503518328;Ne;0;6;0;6
18568;Bangelė;"Pagrandukai ";4927362383;Ne;4;2;0;6
18569;Bangelė;"Pagrandukai ";7432980844;Ne;14;0;0;14
18570;Bangelė;"Pagrandukai ";2011446859;Ne;1;0;1;2
18571;Bangelė;"Pagrandukai ";8880874539;Ne;1;0;1;2
18572;Bangelė;"Pagrandukai ";7729373603;Ne;8;0;3;11
18573;Bangelė;"Pagrandukai ";5237637695;Ne;5;4;0;9
18574;Bangelė;"Pagrandukai ";7138947462;Ne;5;4;0;9
18575;Bangelė;"Pagrandukai ";2535189316;Ne;17;0;0;17
18576;Bangelė;"Pagrandukai ";9430653481;Ne;16;0;0;16
18577;Bangelė;"Pagrandukai ";4558724094;Ne;9;0;0;9
18578;Bangelė;"Pagrandukai ";3557202302;Ne;7;4;0;11
18579;Bangelė;"Pagrandukai ";7188182741;Ne;0;0;1;1
18580;Bangelė;"Zuikučiai ";6925192867;Ne;5;4;0;9
18581;Bangelė;"Zuikučiai ";6965660021;Ne;5;3;0;8
18582;Bangelė;"Zuikučiai ";3994276744;Ne;18;0;0;18
18583;Bangelė;"Zuikučiai ";3059847953;Ne;18;0;0;18
18584;Bangelė;"Zuikučiai ";5909385625;Ne;11;0;0;11
18585;Bangelė;"Zuikučiai ";4401415720;Ne;1;3;0;4
18586;Bangelė;"Zuikučiai ";1610384455;Ne;7;0;0;7
18587;Bangelė;"Zuikučiai ";9841829359;Ne;3;3;0;6
18588;Bangelė;"Zuikučiai ";8836768508;Ne;3;0;1;4
18589;Bangelė;"Zuikučiai ";6100558953;Ne;2;4;0;6
18590;Bangelė;"Zuikučiai ";5192643204;Ne;3;0;0;3
18591;Bangelė;Vėžliukai;4037426263;Ne;11;5;0;16
18592;Bangelė;Vėžliukai;7862345122;Ne;0;0;2;2
18593;Bangelė;Vėžliukai;2630571748;Ne;5;5;0;10
18594;Bangelė;Vėžliukai;6003859569;Ne;0;0;1;1
18595;Bangelė;Vėžliukai;3978683237;Ne;0;0;3;3
18596;Bangelė;Vėžliukai;5779198855;Ne;0;3;0;3
18597;Bangelė;Vėžliukai;5746189515;Ne;0;6;0;6
18598;Bangelė;Vėžliukai;8454369872;Taip;0;3;0;3
18599;Bangelė;Vėžliukai;9561221619;Ne;0;2;0;2
18600;Bangelė;Vėžliukai;1182624046;Ne;0;8;0;8
18601;Bangelė;Vėžliukai;9010238689;Ne;0;7;0;7
18602;Bangelė;Vėžliukai;9128326823;Ne;14;0;0;14
18603;Bangelė;Vėžliukai;6415607960;Ne;16;0;0;16
18604;Bangelė;Vėžliukai;2730545639;Ne;7;5;0;12
18605;Bangelė;Vėžliukai;2301343701;Ne;5;6;0;11
18606;Bangelė;Vėžliukai;6506241123;Taip;18;0;0;18
18607;Bangelė;Vėžliukai;8950435528;Ne;2;3;0;5
18608;Gėlynas;PAKALNUTĖ;4557380282;Ne;8;0;0;8
18609;Gėlynas;PAKALNUTĖ;6884111634;Ne;0;0;5;5
18610;Gėlynas;PAKALNUTĖ;1548317086;Ne;1;0;0;1
18611;Gėlynas;PAKALNUTĖ;3470963396;Ne;0;5;0;5
18612;Gėlynas;PAKALNUTĖ;6053841081;Ne;2;0;0;2
18613;Gėlynas;PAKALNUTĖ;2171064300;Ne;3;0;0;3
18614;Gėlynas;PAKALNUTĖ;2404562144;Ne;0;11;0;11
18615;Gėlynas;PAKALNUTĖ;7504469409;Ne;0;5;0;5
18616;Gėlynas;PAKALNUTĖ;4366442459;Ne;8;0;0;8
18617;Gėlynas;PAKALNUTĖ;1463783538;Ne;0;0;3;3
18618;Gėlynas;PAKALNUTĖ;7064068912;Ne;0;0;10;10
18619;Gėlynas;PAKALNUTĖ;1822933936;Ne;0;3;0;3
18620;Gėlynas;PAKALNUTĖ;4668195919;Ne;9;0;0;9
18621;Gėlynas;PAKALNUTĖ;8555408466;Ne;0;8;0;8
18622;Gėlynas;PAKALNUTĖ;2377323648;Taip;0;4;1;5
18623;Gėlynas;PAKALNUTĖ;5382148888;Ne;3;3;0;6
18624;Gėlynas;PAKALNUTĖ;6296728638;Ne;8;1;0;9
18625;Gėlynas;PAKALNUTĖ;2273705177;Ne;12;0;0;12
18626;Gėlynas;PAKALNUTĖ;5350834071;Ne;0;0;3;3
18627;Gėlynas;PAKALNUTĖ;2520140743;Taip;3;0;0;3
18628;Gėlynas;PAKALNUTĖ;6244314445;Ne;0;3;3;6
18629;Gėlynas;PAKALNUTĖ;9707677931;Ne;4;0;0;4
18630;Gėlynas;VARPELIS;5898582218;Ne;0;2;0;2
18631;Gėlynas;VARPELIS;1505666690;Ne;4;0;0;4
18632;Gėlynas;VARPELIS;9330385153;Ne;2;4;0;6
18633;Gėlynas;VARPELIS;9724668402;Ne;0;4;0;4
18634;Gėlynas;VARPELIS;2742456983;Ne;0;6;0;6
18635;Gėlynas;VARPELIS;2784709117;Ne;7;0;1;8
18636;Gėlynas;VARPELIS;6114995335;Ne;5;4;0;9
18637;Gėlynas;VARPELIS;6815740588;Ne;11;3;0;14
18638;Gėlynas;VARPELIS;3606076029;Ne;0;8;0;8
18639;Gėlynas;VARPELIS;5291444399;Ne;6;3;0;9
18640;Gėlynas;VARPELIS;5320531856;Ne;0;3;0;3
18641;Gėlynas;VARPELIS;7730322729;Ne;0;4;0;4
18642;Gėlynas;VARPELIS;4505012978;Ne;10;4;0;14
18643;Gėlynas;VARPELIS;5634213306;Ne;0;2;0;2
18644;Gėlynas;VARPELIS;9508507084;Ne;0;2;0;2
18645;Gėlynas;VARPELIS;2348787949;Ne;3;4;0;7
18646;Gėlynas;VARPELIS;5541707540;Taip;1;4;1;6
18647;Gėlynas;VARPELIS;5124029118;Ne;6;4;0;10
18648;Gėlynas;VARPELIS;6528464599;Ne;4;3;0;7
18649;Gėlynas;VARPELIS;8615943743;Ne;0;3;0;3
18650;Gėlynas;VARPELIS;3572020585;Ne;0;4;0;4
18651;Gėlynas;VARPELIS;8458276300;Ne;0;2;1;3
18652;Gėlynas;VARPELIS;8999346908;Ne;2;5;0;7
18653;Gėlynas;VARPELIS;3491517766;Ne;0;2;0;2
18654;Gėlynas;RAKTAŽOLĖ;7389502638;Ne;0;4;0;4
18655;Gėlynas;RAKTAŽOLĖ;1590299264;Ne;6;0;0;6
18656;Gėlynas;RAKTAŽOLĖ;5751256561;Ne;9;0;0;9
18657;Gėlynas;RAKTAŽOLĖ;8080660097;Ne;4;0;0;4
18658;Gėlynas;RAKTAŽOLĖ;1015554617;Ne;3;0;0;3
18659;Gėlynas;RAKTAŽOLĖ;6875794958;Ne;6;0;0;6
18660;Gėlynas;RAKTAŽOLĖ;3492361041;Ne;7;0;0;7
18661;Gėlynas;RAKTAŽOLĖ;6451922757;Ne;7;0;0;7
18662;Gėlynas;RAKTAŽOLĖ;2141722631;Ne;3;0;0;3
18663;Gėlynas;RAKTAŽOLĖ;7150367866;Ne;1;0;0;1
18664;Gėlynas;RAKTAŽOLĖ;4983822000;Ne;6;0;0;6
18665;Gėlynas;RAKTAŽOLĖ;9462822190;Ne;0;4;0;4
18666;Gėlynas;RAKTAŽOLĖ;3549079170;Ne;5;0;0;5
18667;Gėlynas;RAKTAŽOLĖ;5964419627;Ne;5;0;0;5
18668;Gėlynas;RAKTAŽOLĖ;4824667762;Ne;4;0;0;4
18669;Gėlynas;RAKTAŽOLĖ;7998013477;Ne;6;0;0;6
18670;Gėlynas;RAKTAŽOLĖ;8447789767;Ne;0;8;0;8
18671;Gėlynas;RAKTAŽOLĖ;8743722205;Ne;6;0;0;6
18672;Gėlynas;RAKTAŽOLĖ;1468588114;Ne;3;4;0;7
18673;Gėlynas;RAKTAŽOLĖ;9305282699;Ne;0;4;0;4
18674;Gėlynas;RAKTAŽOLĖ;1235384604;Ne;3;0;0;3
18675;Gėlynas;RAKTAŽOLĖ;8693415786;Ne;6;0;0;6
18676;Gėlynas;RAKTAŽOLĖ;2800420481;Ne;2;4;0;6
18677;Gėlynas;RAKTAŽOLĖ;8444505017;Ne;0;4;0;4
18678;Gėlynas;SAULĖGRĄŽA;3746597878;Ne;0;1;2;3
18679;Gėlynas;SAULĖGRĄŽA;9182072776;Ne;0;4;2;6
18680;Gėlynas;SAULĖGRĄŽA;1862266440;Ne;4;0;4;8
18681;Gėlynas;SAULĖGRĄŽA;2790269385;Ne;3;4;5;12
18682;Gėlynas;SAULĖGRĄŽA;7988094745;Ne;0;4;0;4
18683;Gėlynas;SAULĖGRĄŽA;4192292896;Ne;5;4;0;9
18684;Gėlynas;SAULĖGRĄŽA;9552677108;Ne;2;6;0;8
18685;Gėlynas;SAULĖGRĄŽA;2608369575;Ne;2;6;0;8
18686;Gėlynas;SAULĖGRĄŽA;1949260962;Ne;0;4;0;4
18687;Gėlynas;SAULĖGRĄŽA;6635004996;Ne;4;0;3;7
18688;Gėlynas;SAULĖGRĄŽA;5942466822;Ne;7;0;4;11
18689;Gėlynas;SAULĖGRĄŽA;2193861056;Ne;0;0;4;4
18690;Gėlynas;SAULĖGRĄŽA;6826311903;Ne;0;4;4;8
18691;Gėlynas;SAULĖGRĄŽA;9230984365;Ne;4;0;2;6
18692;Gėlynas;SAULĖGRĄŽA;6221721945;Ne;10;0;0;10
18693;Gėlynas;SAULĖGRĄŽA;1681208354;Ne;0;0;3;3
18694;Gėlynas;SAULĖGRĄŽA;7005278902;Ne;0;0;2;2
18695;Gėlynas;SAULĖGRĄŽA;6790040590;Ne;0;4;1;5
18696;Gėlynas;SAULĖGRĄŽA;4854709904;Taip;10;0;0;10
18697;Gėlynas;SAULĖGRĄŽA;1665668966;Ne;0;0;12;12
18698;Gėlynas;SAULĖGRĄŽA;1570975863;Ne;9;0;3;12
18699;Gėlynas;SAULĖGRĄŽA;9302757372;Ne;0;19;0;19
18700;Gėlynas;SAULĖGRĄŽA;6342888072;Ne;0;12;0;12
18701;Gėlynas;RAMUNĖLĖ;5813156578;Ne;12;2;0;14
18702;Gėlynas;RAMUNĖLĖ;8550986498;Ne;6;0;0;6
18703;Gėlynas;RAMUNĖLĖ;1003739544;Ne;19;0;0;19
18704;Gėlynas;RAMUNĖLĖ;8483711968;Ne;4;0;0;4
18705;Gėlynas;RAMUNĖLĖ;5576414317;Ne;13;0;0;13
18706;Gėlynas;RAMUNĖLĖ;1625163282;Ne;3;0;0;3
18707;Gėlynas;RAMUNĖLĖ;1962457749;Ne;12;0;0;12
18708;Gėlynas;RAMUNĖLĖ;2968257637;Ne;7;0;0;7
18709;Gėlynas;RAMUNĖLĖ;9063119595;Ne;8;0;0;8
18710;Gėlynas;RAMUNĖLĖ;1923691283;Ne;9;0;0;9
18711;Gėlynas;RAMUNĖLĖ;1360487284;Ne;5;0;0;5
18712;Gėlynas;RAMUNĖLĖ;2043763411;Ne;0;1;0;1
18713;Gėlynas;RAMUNĖLĖ;4666515153;Ne;0;0;3;3
18714;Gėlynas;RAMUNĖLĖ;1074695140;Ne;0;0;1;1
18715;Gėlynas;RAMUNĖLĖ;6447818933;Ne;0;0;2;2
18716;Gėlynas;ŽIBUTĖ;8681345327;Ne;0;4;0;4
18717;Gėlynas;ŽIBUTĖ;1556683639;Ne;0;4;0;4
18718;Gėlynas;ŽIBUTĖ;2885148633;Ne;4;0;0;4
18719;Gėlynas;ŽIBUTĖ;9786032406;Ne;0;4;0;4
18720;Gėlynas;ŽIBUTĖ;6053762333;Ne;12;6;0;18
18721;Gėlynas;ŽIBUTĖ;4018507719;Ne;0;3;0;3
18722;Gėlynas;ŽIBUTĖ;4012165601;Ne;0;3;0;3
18723;Gėlynas;ŽIBUTĖ;7633304238;Ne;0;7;0;7
18724;Gėlynas;ŽIBUTĖ;2194665295;Ne;2;0;0;2
18725;Gėlynas;ŽIBUTĖ;1579053252;Ne;12;4;0;16
18726;Gėlynas;ŽIBUTĖ;9980617252;Ne;4;0;0;4
18727;Gėlynas;ŽIBUTĖ;9859626078;Ne;0;4;6;10
18728;Gėlynas;ŽIBUTĖ;1073904355;Ne;7;2;1;10
18729;Gėlynas;ŽIBUTĖ;9256960820;Ne;8;0;1;9
18730;Gėlynas;ŽIBUTĖ;9513419357;Ne;9;6;0;15
18731;Gėlynas;ŽIBUTĖ;3629326461;Ne;0;10;0;10
18732;Gėlynas;ŽIBUTĖ;8122748285;Ne;0;0;1;1
18733;Obelėlė;Gudručiai;9900484892;Ne;0;5;2;7
18734;Obelėlė;Gudručiai;6145113624;Ne;0;4;0;4
18735;Obelėlė;Gudručiai;9586720282;Ne;0;7;0;7
18736;Obelėlė;Gudručiai;9567704282;Ne;0;4;0;4
18737;Obelėlė;Gudručiai;4015702815;Ne;5;4;0;9
18738;Obelėlė;Gudručiai;4309139638;Ne;0;4;0;4
18739;Obelėlė;Gudručiai;5141585309;Ne;0;3;0;3
18740;Obelėlė;Gudručiai;9736557012;Ne;7;4;0;11
18741;Obelėlė;Gudručiai;6720058972;Ne;0;4;1;5
18742;Obelėlė;Gudručiai;2053807216;Ne;0;4;0;4
18743;Obelėlė;Gudručiai;2204293216;Ne;0;19;0;19
18744;Obelėlė;Gudručiai;1184082097;Ne;0;4;1;5
18745;Obelėlė;Gudručiai;2533715287;Ne;0;19;0;19
18746;Obelėlė;Gudručiai;1312484983;Ne;10;4;1;15
18747;Obelėlė;Gudručiai;1565630870;Ne;3;4;0;7
18748;Obelėlė;Gudručiai;1598785483;Ne;8;5;0;13
18749;Obelėlė;Gudručiai;2170134084;Ne;6;5;0;11
18750;Obelėlė;Gudručiai;8155712451;Ne;0;4;1;5
18751;Obelėlė;Gudručiai;8371648703;Ne;0;1;0;1
18752;Obelėlė;Gudručiai;1362135757;Ne;3;4;1;8
18753;Obelėlė;Gudručiai;3769993089;Ne;5;4;0;9
18754;Obelėlė;Gudručiai;1630067014;Ne;0;3;0;3
18755;Obelėlė;Pasakaitė;9008900055;Ne;9;0;1;10
18756;Obelėlė;Pasakaitė;9332534001;Ne;9;0;1;10
18757;Obelėlė;Pasakaitė;1788880520;Ne;5;0;4;9
18758;Obelėlė;Pasakaitė;2465101384;Ne;2;0;2;4
18759;Obelėlė;Pasakaitė;5366112771;Ne;2;0;1;3
18760;Obelėlė;Pasakaitė;3452970142;Taip;1;0;0;1
18761;Obelėlė;Pasakaitė;4505857257;Ne;4;0;0;4
18762;Obelėlė;Pasakaitė;6945301927;Ne;3;4;0;7
18763;Obelėlė;Pasakaitė;5603904852;Ne;3;4;1;8
18764;Obelėlė;Pasakaitė;9995891955;Ne;0;4;0;4
18765;Obelėlė;Pasakaitė;3646359565;Ne;10;0;2;12
18766;Obelėlė;Pasakaitė;2663004768;Ne;11;0;0;11
18767;Obelėlė;Pasakaitė;4707488292;Ne;19;0;0;19
18768;Obelėlė;Pasakaitė;2031637374;Ne;5;0;2;7
18769;Obelėlė;Pasakaitė;4678269928;Taip;4;0;0;4
18770;Obelėlė;Pasakaitė;8060994250;Ne;16;0;0;16
18771;Obelėlė;Pasakaitė;5617103957;Ne;10;0;0;10
18772;Obelėlė;Pasakaitė;6321178561;Ne;6;0;3;9
18773;Obelėlė;Pasakaitė;9903010418;Ne;4;0;2;6
18774;Obelėlė;Pasakaitė;4673426170;Ne;10;4;0;14
18775;Obelėlė;Pasakaitė;7901070568;Ne;0;1;1;2
18776;Obelėlė;Svajokliai;9981446556;Ne;0;4;0;4
18777;Obelėlė;Svajokliai;4849499826;Ne;5;0;0;5
18778;Obelėlė;Svajokliai;1469593267;Ne;5;4;1;10
18779;Obelėlė;Svajokliai;9819048265;Taip;4;1;0;5
18780;Obelėlė;Svajokliai;1010954005;Ne;0;0;2;2
18781;Obelėlė;Svajokliai;4489212434;Ne;2;0;0;2
18782;Obelėlė;Svajokliai;6325027163;Ne;2;0;0;2
18783;Obelėlė;Svajokliai;5312394513;Ne;2;0;0;2
18784;Obelėlė;Svajokliai;5620250331;Ne;8;0;0;8
18785;Obelėlė;Svajokliai;1705232474;Ne;6;0;0;6
18786;Obelėlė;Svajokliai;7094715237;Ne;4;0;0;4
18787;Obelėlė;Svajokliai;9070960601;Ne;0;4;0;4
18788;Obelėlė;Svajokliai;8231489868;Ne;1;4;0;5
18789;Obelėlė;Svajokliai;3986892111;Ne;0;4;0;4
18790;Obelėlė;Svajokliai;7003947655;Ne;0;1;0;1
18791;Obelėlė;Svajokliai;9641297002;Ne;0;4;0;4
18792;Obelėlė;Svajokliai;8918176312;Ne;0;4;5;9
18793;Obelėlė;Svajokliai;8604451971;Ne;4;0;0;4
18794;Obelėlė;Svajokliai;7794072582;Ne;0;0;2;2
18795;Obelėlė;Svajokliai;6785654280;Ne;4;0;1;5
18796;Obelėlė;Svajokliai;6311322617;Ne;9;0;0;9
18797;Obelėlė;Svajokliai;2813927086;Ne;1;4;0;5
18798;Obelėlė;Smalsučiai;6497584911;Ne;2;0;0;2
18799;Obelėlė;Smalsučiai;7687093936;Ne;5;4;0;9
18800;Obelėlė;Smalsučiai;1469375976;Ne;7;0;1;8
18801;Obelėlė;Smalsučiai;7108517080;Ne;0;0;3;3
18802;Obelėlė;Smalsučiai;6008839269;Taip;0;0;1;1
18803;Obelėlė;Smalsučiai;6020342761;Ne;0;0;1;1
18804;Obelėlė;Smalsučiai;4987747783;Ne;7;0;0;7
18805;Obelėlė;Smalsučiai;5085970254;Ne;9;1;0;10
18806;Obelėlė;Smalsučiai;8709758561;Ne;9;0;3;12
18807;Obelėlė;Smalsučiai;4318546408;Ne;0;4;0;4
18808;Obelėlė;Smalsučiai;5739522736;Ne;0;3;0;3
18809;Obelėlė;Smalsučiai;2631405243;Ne;0;4;1;5
18810;Obelėlė;Smalsučiai;8173307704;Ne;14;0;0;14
18811;Obelėlė;Smalsučiai;6720808705;Ne;0;4;2;6
18812;Obelėlė;Smalsučiai;7850656031;Ne;0;4;1;5
18813;Obelėlė;Smalsučiai;9084969712;Taip;4;0;0;4
18814;Obelėlė;Smalsučiai;6364101139;Ne;0;7;0;7
18815;Obelėlė;Smalsučiai;6064646690;Ne;0;0;2;2
18816;Obelėlė;Smalsučiai;8183287212;Ne;0;2;1;3
18817;Obelėlė;Smalsučiai;2574840626;Ne;0;6;0;6
18818;Obelėlė;Smalsučiai;8981403984;Ne;15;0;0;15
18819;Obelėlė;Pabiručiai;2035035265;Ne;9;0;0;9
18820;Obelėlė;Pabiručiai;5763713052;Taip;11;0;0;11
18821;Obelėlė;Pabiručiai;7667966704;Ne;2;0;0;2
18822;Obelėlė;Pabiručiai;1819480590;Ne;1;0;0;1
18823;Obelėlė;Pabiručiai;8579887226;Ne;10;0;0;10
18824;Obelėlė;Pabiručiai;6946457363;Ne;1;0;0;1
18825;Obelėlė;Pabiručiai;8948297718;Ne;4;0;0;4
18826;Obelėlė;Pabiručiai;3951816174;Ne;12;0;0;12
18827;Obelėlė;Pabiručiai;5599466885;Ne;4;0;1;5
18828;Obelėlė;Pabiručiai;9634414572;Ne;4;0;0;4
18829;Obelėlė;Pabiručiai;2262107831;Ne;1;0;0;1
18830;Obelėlė;Pabiručiai;4851824672;Ne;3;0;1;4
18831;Obelėlė;Pabiručiai;3526079444;Ne;2;0;2;4
18832;Obelėlė;Pabiručiai;9731565368;Ne;4;0;0;4
18833;Obelėlė;Pabiručiai;8827515572;Ne;7;0;0;7
18834;Obelėlė;Pabiručiai;2399173200;Ne;9;0;0;9
18835;Obelėlė;Pabiručiai;8443192155;Ne;7;0;0;7
18836;Obelėlė;Pabiručiai;9627134967;Ne;4;0;0;4
18837;Obelėlė;Pabiručiai;4575139158;Ne;4;0;3;7
18838;Obelėlė;Strakaliukai;1706102918;Taip;0;4;0;4
18839;Obelėlė;Strakaliukai;8682794598;Ne;0;4;1;5
18840;Obelėlė;Strakaliukai;8754552660;Ne;6;4;0;10
18841;Obelėlė;Strakaliukai;8092024850;Ne;0;3;0;3
18842;Obelėlė;Strakaliukai;9716500560;Ne;0;3;0;3
18843;Obelėlė;Strakaliukai;4251418414;Ne;3;1;0;4
18844;Obelėlė;Strakaliukai;7128421330;Ne;3;4;0;7
18845;Obelėlė;Strakaliukai;5943314566;Ne;0;4;1;5
18846;Obelėlė;Strakaliukai;3116100694;Ne;10;4;0;14
18847;Obelėlė;Strakaliukai;5741823041;Ne;3;3;0;6
18848;Obelėlė;Strakaliukai;8050551266;Ne;0;3;0;3
18849;Obelėlė;Strakaliukai;7468335279;Ne;1;4;0;5
18850;Obelėlė;Strakaliukai;1180508643;Ne;5;4;0;9
18851;Obelėlė;Strakaliukai;7124393375;Ne;5;2;0;7
18852;Obelėlė;Strakaliukai;5001844064;Ne;8;4;0;12
18853;Obelėlė;Strakaliukai;9976694313;Ne;0;1;1;2
18854;Obelėlė;Strakaliukai;1537769810;Ne;1;3;0;4
18855;Obelėlė;Strakaliukai;5776116844;Ne;0;7;0;7
18856;Obelėlė;Strakaliukai;1909459236;Ne;1;2;0;3
18857;Obelėlė;Strakaliukai;1419189517;Ne;4;4;0;8
18858;Obelėlė;Strakaliukai;3425736276;Ne;2;3;0;5
18859;Obelėlė;Strakaliukai;8487088625;Ne;0;1;0;1
18860;Obelėlė;Strakaliukai;5374979248;Ne;4;3;0;7
18861;Obelėlė;Saulutė;2772753891;Taip;4;1;0;5
18862;Obelėlė;Saulutė;8486560892;Ne;5;5;0;10
18863;Obelėlė;Saulutė;1858251094;Ne;5;0;5;10
18864;Obelėlė;Saulutė;2893378990;Ne;11;0;0;11
18865;Obelėlė;Saulutė;6874039388;Ne;0;0;1;1
18866;Obelėlė;Saulutė;7491934262;Ne;5;0;4;9
18867;Obelėlė;Saulutė;9043542844;Ne;0;0;4;4
18868;Obelėlė;Saulutė;4321210604;Ne;9;0;4;13
18869;Obelėlė;Saulutė;4209489251;Ne;4;0;0;4
18870;Obelėlė;Saulutė;4309622934;Ne;14;0;0;14
18871;Obelėlė;Saulutė;3590915973;Ne;3;0;3;6
18872;Obelėlė;Saulutė;6470533765;Ne;13;0;0;13
18873;Obelėlė;Saulutė;8223715886;Ne;13;0;0;13
18874;Obelėlė;Saulutė;8461505586;Ne;8;0;4;12
18875;Obelėlė;Saulutė;2730569223;Ne;18;0;0;18
18876;Obelėlė;Saulutė;4218895290;Ne;4;0;4;8
18877;Obelėlė;Saulutė;3460171136;Taip;14;0;0;14
18878;Obelėlė;Saulutė;4262041356;Ne;5;0;3;8
18879;Obelėlė;Rieduliukai;7358561581;Ne;7;0;0;7
18880;Obelėlė;Rieduliukai;6288343928;Ne;7;0;0;7
18881;Obelėlė;Rieduliukai;8518041886;Ne;8;4;0;12
18882;Obelėlė;Rieduliukai;8672239434;Ne;0;0;1;1
18883;Obelėlė;Rieduliukai;9980499571;Ne;7;0;0;7
18884;Obelėlė;Rieduliukai;7254219285;Ne;10;0;1;11
18885;Obelėlė;Rieduliukai;9329425457;Ne;5;0;1;6
18886;Obelėlė;Rieduliukai;9418600546;Ne;2;0;0;2
18887;Obelėlė;Rieduliukai;1246354139;Ne;3;0;0;3
18888;Obelėlė;Rieduliukai;4004797759;Ne;12;0;0;12
18889;Obelėlė;Rieduliukai;4872101613;Ne;3;0;0;3
18890;Obelėlė;Rieduliukai;8963630504;Ne;2;0;0;2
18891;Obelėlė;Rieduliukai;5441524884;Ne;10;0;0;10
18892;Obelėlė;Rieduliukai;3210789582;Ne;5;0;0;5
18893;Obelėlė;Rieduliukai;1039878043;Ne;5;0;0;5
18894;Obelėlė;Rieduliukai;7111855298;Ne;0;0;1;1
18895;Obelėlė;Rieduliukai;9359921446;Ne;0;0;2;2
18896;Obelėlė;Žirniukai;9542303128;Ne;6;0;0;6
18897;Obelėlė;Žirniukai;3886008149;Ne;14;0;0;14
18898;Obelėlė;Žirniukai;4676986978;Ne;5;0;0;5
18899;Obelėlė;Žirniukai;9222485883;Taip;10;4;0;14
18900;Obelėlė;Žirniukai;4708077301;Ne;14;0;0;14
18901;Obelėlė;Žirniukai;3199776998;Ne;4;0;0;4
18902;Obelėlė;Žirniukai;4979811410;Taip;4;0;0;4
18903;Obelėlė;Žirniukai;1369344706;Ne;11;0;0;11
18904;Obelėlė;Žirniukai;2561695305;Ne;14;0;0;14
18905;Obelėlė;Žirniukai;1329818819;Ne;4;0;0;4
18906;Obelėlė;Žirniukai;5933225940;Ne;5;0;0;5
18907;Obelėlė;Žirniukai;3347690540;Ne;6;0;0;6
18908;Obelėlė;Žirniukai;9502503757;Ne;0;0;1;1
18909;Obelėlė;Žirniukai;3474007758;Ne;6;0;0;6
18910;Obelėlė;Žirniukai;8777938603;Ne;5;0;0;5
18911;Obelėlė;Žirniukai;5213900934;Ne;8;0;0;8
18912;Obelėlė;Žirniukai;4862765923;Ne;15;0;0;15
18913;Obelėlė;Bičiuliai;5209482838;Ne;12;0;1;13
18914;Obelėlė;Bičiuliai;8422696011;Ne;0;4;2;6
18915;Obelėlė;Bičiuliai;1799603610;Ne;15;0;0;15
18916;Obelėlė;Bičiuliai;5192989376;Taip;0;19;0;19
18917;Obelėlė;Bičiuliai;5503843905;Ne;0;3;1;4
18918;Obelėlė;Bičiuliai;3287262204;Ne;0;3;0;3
18919;Obelėlė;Bičiuliai;2769784741;Ne;0;12;0;12
18920;Obelėlė;Bičiuliai;1222183008;Ne;5;4;0;9
18921;Obelėlė;Bičiuliai;7813350634;Ne;3;0;0;3
18922;Obelėlė;Bičiuliai;6133596410;Ne;6;0;2;8
18923;Obelėlė;Bičiuliai;3568124213;Ne;4;0;0;4
18924;Obelėlė;Bičiuliai;2702773541;Ne;2;0;2;4
18925;Obelėlė;Bičiuliai;5478392319;Ne;1;1;0;2
18926;Obelėlė;Bičiuliai;4223995429;Ne;0;4;0;4
18927;Obelėlė;Bičiuliai;9005520809;Ne;0;5;0;5
18928;Obelėlė;Bičiuliai;8982197866;Ne;7;0;4;11
18929;Obelėlė;Bičiuliai;5073364608;Ne;4;3;0;7
18930;Obelėlė;Bičiuliai;3881456534;Ne;15;4;0;19
18931;Obelėlė;Kodėlčiukai;9960526051;Ne;9;0;0;9
18932;Obelėlė;Kodėlčiukai;1050919659;Ne;9;0;0;9
18933;Obelėlė;Kodėlčiukai;7014872044;Ne;4;0;0;4
18934;Obelėlė;Kodėlčiukai;3028107343;Ne;10;3;0;13
18935;Obelėlė;Kodėlčiukai;4717038536;Ne;4;0;1;5
18936;Obelėlė;Kodėlčiukai;4840134079;Ne;0;0;3;3
18937;Obelėlė;Kodėlčiukai;8762518354;Ne;6;0;0;6
18938;Obelėlė;Kodėlčiukai;3320493372;Ne;0;0;1;1
18939;Obelėlė;Kodėlčiukai;8366162313;Ne;5;4;0;9
18940;Obelėlė;Kodėlčiukai;6481365666;Ne;3;0;0;3
18941;Obelėlė;Kodėlčiukai;2227383487;Ne;2;4;0;6
18942;Obelėlė;Kodėlčiukai;8818153952;Ne;9;0;0;9
18943;Obelėlė;Kodėlčiukai;4887103549;Ne;4;0;0;4
18944;Obelėlė;Kodėlčiukai;5221918341;Taip;9;0;0;9
18945;Obelėlė;Kodėlčiukai;3748406335;Ne;3;0;0;3
18946;Obelėlė;Kodėlčiukai;5233321854;Ne;6;0;0;6
18947;Obelėlė;Kodėlčiukai;1472630240;Ne;10;0;2;12
18948;Obelėlė;Kodėlčiukai;7422668691;Ne;4;0;0;4
18949;Obelėlė;Kodėlčiukai;6138943813;Ne;3;0;0;3
18950;Obelėlė;Pagrandukai;7934967787;Ne;5;0;0;5
18951;Obelėlė;Pagrandukai;8711370875;Ne;2;0;0;2
18952;Obelėlė;Pagrandukai;6938326798;Ne;7;0;0;7
18953;Obelėlė;Pagrandukai;9258651395;Ne;15;0;0;15
18954;Obelėlė;Pagrandukai;3563701047;Ne;7;0;0;7
18955;Obelėlė;Pagrandukai;8664564820;Taip;7;0;0;7
18956;Obelėlė;Pagrandukai;9170515841;Ne;16;0;0;16
18957;Obelėlė;Pagrandukai;4930485327;Ne;9;0;0;9
18958;Obelėlė;Pagrandukai;9514739912;Ne;13;0;0;13
18959;Obelėlė;Pagrandukai;7368698046;Ne;12;0;0;12
18960;Obelėlė;Pagrandukai;3738932600;Ne;5;0;0;5
18961;Obelėlė;Pagrandukai;2203568007;Ne;11;0;0;11
18962;Obelėlė;Pagrandukai;1423488655;Ne;6;0;0;6
18963;Obelėlė;Pagrandukai;6045739549;Taip;14;0;0;14
18964;Spygliukas;Bitutės;8272537768;Ne;5;0;0;5
18965;Spygliukas;Bitutės;8404929784;Ne;0;4;0;4
18966;Spygliukas;Bitutės;4835818382;Ne;0;4;0;4
18967;Spygliukas;Bitutės;3041184642;Ne;0;3;0;3
18968;Spygliukas;Bitutės;9413950200;Ne;0;3;0;3
18969;Spygliukas;Bitutės;1664878188;Ne;0;5;0;5
18970;Spygliukas;Bitutės;5134327772;Ne;1;1;0;2
18971;Spygliukas;Bitutės;8869320003;Ne;4;0;0;4
18972;Spygliukas;Bitutės;8476882854;Ne;8;4;0;12
18973;Spygliukas;Bitutės;3761715811;Ne;4;0;0;4
18974;Spygliukas;Bitutės;8270525839;Ne;0;2;0;2
18975;Spygliukas;Bitutės;3697691132;Ne;12;1;0;13
18976;Spygliukas;Bitutės;1550737449;Ne;1;7;0;8
18977;Spygliukas;Bitutės;2395961015;Ne;3;1;0;4
18978;Spygliukas;Bitutės;5180736358;Ne;3;0;0;3
18979;Spygliukas;Bitutės;9431217584;Ne;0;9;0;9
18980;Spygliukas;Bitutės;8289288541;Ne;3;0;0;3
18981;Spygliukas;Bitutės;8825264090;Taip;2;1;0;3
18982;Spygliukas;Kiškučiai;8426426785;Taip;11;0;0;11
18983;Spygliukas;Kiškučiai;1243647769;Ne;7;0;0;7
18984;Spygliukas;Kiškučiai;6680699873;Ne;4;0;0;4
18985;Spygliukas;Kiškučiai;5043843336;Ne;3;0;0;3
18986;Spygliukas;Kiškučiai;8509447147;Ne;4;0;0;4
18987;Spygliukas;Kiškučiai;2955219028;Ne;15;4;0;19
18988;Spygliukas;Kiškučiai;5739075961;Ne;3;0;0;3
18989;Spygliukas;Kiškučiai;1823720183;Ne;16;0;0;16
18990;Spygliukas;Kiškučiai;7324915516;Ne;13;1;0;14
18991;Spygliukas;Kiškučiai;6414439254;Ne;13;1;0;14
18992;Spygliukas;Kiškučiai;8565217488;Ne;11;0;0;11
18993;Spygliukas;Kiškučiai;3065727701;Ne;12;0;0;12
18994;Spygliukas;Kiškučiai;2367685286;Ne;0;19;0;19
18995;Spygliukas;Kiškučiai;7663839690;Ne;7;0;0;7
18996;Spygliukas;Kiškučiai;2738766977;Ne;2;0;0;2
18997;Spygliukas;Kiškučiai;9060123423;Ne;11;0;0;11
18998;Spygliukas;Boružėlės;5615854225;Ne;0;10;0;10
18999;Spygliukas;Boružėlės;6195903792;Ne;2;0;0;2
19000;Spygliukas;Boružėlės;1927028026;Ne;2;5;0;7
19001;Spygliukas;Boružėlės;7261580644;Ne;0;8;0;8
19002;Spygliukas;Boružėlės;6246925536;Taip;17;0;0;17
19003;Spygliukas;Boružėlės;3094528907;Ne;4;1;0;5
19004;Spygliukas;Boružėlės;8299276429;Ne;7;0;0;7
19005;Spygliukas;Boružėlės;8981549891;Ne;5;0;0;5
19006;Spygliukas;Boružėlės;7243104877;Taip;1;5;0;6
19007;Spygliukas;Boružėlės;9813995933;Taip;2;11;0;13
19008;Spygliukas;Boružėlės;4013601534;Ne;8;0;0;8
19009;Spygliukas;Boružėlės;1436452804;Ne;18;0;0;18
19010;Spygliukas;Boružėlės;3959136555;Ne;6;0;0;6
19011;Spygliukas;Boružėlės;6383264068;Ne;7;0;0;7
19012;Spygliukas;Boružėlės;5369930705;Ne;11;0;0;11
19013;Spygliukas;Boružėlės;1330384915;Ne;12;0;0;12
19014;Spygliukas;Boružėlės;1037321774;Ne;0;7;0;7
19015;Spygliukas;Boružėlės;1683270282;Ne;0;11;0;11
19016;Spygliukas;Boružėlės;9025238241;Ne;7;4;0;11
19017;Spygliukas;Boružėlės;5255993275;Taip;17;0;0;17
19018;Spygliukas;Ežiukai;2164549239;Ne;5;0;0;5
19019;Spygliukas;Ežiukai;4340767624;Ne;4;0;0;4
19020;Spygliukas;Ežiukai;4615217628;Taip;0;4;0;4
19021;Spygliukas;Ežiukai;5612894706;Ne;0;4;0;4
19022;Spygliukas;Ežiukai;6552944183;Ne;2;0;0;2
19023;Spygliukas;Ežiukai;1353217998;Ne;0;1;0;1
19024;Spygliukas;Ežiukai;6459076295;Ne;0;4;0;4
19025;Spygliukas;Ežiukai;7749937772;Ne;19;0;0;19
19026;Spygliukas;Ežiukai;2719100414;Ne;9;4;0;13
19027;Spygliukas;Ežiukai;1429613380;Ne;7;0;0;7
19028;Spygliukas;Ežiukai;4026252608;Ne;0;4;0;4
19029;Spygliukas;Ežiukai;4098112375;Ne;2;5;0;7
19030;Spygliukas;Ežiukai;9321493897;Ne;1;5;0;6
19031;Spygliukas;Ežiukai;7908419787;Taip;8;0;0;8
19032;Spygliukas;Ežiukai;5366783639;Ne;0;5;0;5
19033;Spygliukas;Ežiukai;3088387895;Ne;0;4;0;4
19034;Spygliukas;Ežiukai;7287543571;Ne;9;0;0;9
19035;Spygliukas;Ežiukai;3297728501;Ne;3;0;0;3
19036;Spygliukas;Ežiukai;3959227706;Ne;2;0;0;2
19037;Spygliukas;Geniukai;8821434815;Ne;10;0;0;10
19038;Spygliukas;Geniukai;2713999021;Ne;0;8;0;8
19039;Spygliukas;Geniukai;5782501698;Ne;6;0;0;6
19040;Spygliukas;Geniukai;6700076900;Ne;11;0;0;11
19041;Spygliukas;Geniukai;8338260940;Ne;0;2;0;2
19042;Spygliukas;Geniukai;1863442354;Ne;5;1;0;6
19043;Spygliukas;Geniukai;9945315122;Ne;0;5;0;5
19044;Spygliukas;Geniukai;1291429206;Ne;0;4;0;4
19045;Spygliukas;Geniukai;7477731865;Ne;13;0;0;13
19046;Spygliukas;Geniukai;7561072315;Ne;0;3;0;3
19047;Spygliukas;Geniukai;2950722789;Ne;6;4;0;10
19048;Spygliukas;Geniukai;8093949301;Ne;5;0;0;5
19049;Spygliukas;Geniukai;9141146733;Ne;3;0;0;3
19050;Spygliukas;Geniukai;8308394841;Ne;0;1;0;1
19051;Spygliukas;Geniukai;1127941700;Ne;0;2;0;2
19052;Spygliukas;Geniukai;9783154498;Ne;3;1;0;4
19053;Spygliukas;Geniukai;8581453160;Ne;14;1;0;15
19054;Spygliukas;Geniukai;7573756485;Ne;4;0;0;4
19055;Spygliukas;Geniukai;9770852356;Ne;10;0;0;10
19056;Spygliukas;Riešutėliai;9070219319;Ne;0;3;0;3
19057;Spygliukas;Riešutėliai;1333556956;Ne;1;3;0;4
19058;Spygliukas;Riešutėliai;7271659513;Ne;5;5;0;10
19059;Spygliukas;Riešutėliai;9392554576;Ne;5;0;0;5
19060;Spygliukas;Riešutėliai;8604767396;Ne;5;9;0;14
19061;Spygliukas;Riešutėliai;4634660174;Ne;0;5;0;5
19062;Spygliukas;Riešutėliai;8646122773;Ne;0;5;0;5
19063;Spygliukas;Riešutėliai;7924880159;Ne;7;5;0;12
19064;Spygliukas;Riešutėliai;4368224847;Ne;3;1;0;4
19065;Spygliukas;Riešutėliai;9316731983;Ne;0;4;0;4
19066;Spygliukas;Riešutėliai;6630979640;Ne;0;1;0;1
19067;Spygliukas;Riešutėliai;5012876830;Ne;0;1;0;1
19068;Spygliukas;Riešutėliai;2315421636;Ne;0;4;0;4
19069;Spygliukas;Riešutėliai;7125425492;Ne;0;4;0;4
19070;Spygliukas;Riešutėliai;5214431060;Ne;0;6;0;6
19071;Spygliukas;Riešutėliai;9052337501;Ne;0;4;0;4
19072;Spygliukas;Riešutėliai;1974541155;Ne;0;2;0;2
19073;Spygliukas;Riešutėliai;4505044604;Ne;9;6;0;15
19074;Spygliukas;Riešutėliai;2989701249;Ne;2;3;0;5
19075;Spygliukas;Riešutėliai;9086986643;Ne;14;5;0;19
19076;Spygliukas;Pelėdžiukai;3569857813;Ne;2;4;0;6
19077;Spygliukas;Pelėdžiukai;5493599614;Ne;0;3;0;3
19078;Spygliukas;Pelėdžiukai;4577592862;Ne;0;4;0;4
19079;Spygliukas;Pelėdžiukai;6931145017;Ne;3;0;0;3
19080;Spygliukas;Pelėdžiukai;8802722601;Ne;9;4;0;13
19081;Spygliukas;Pelėdžiukai;9285259322;Ne;0;4;0;4
19082;Spygliukas;Pelėdžiukai;6835488489;Ne;0;5;0;5
19083;Spygliukas;Pelėdžiukai;3919560072;Ne;0;2;0;2
19084;Spygliukas;Pelėdžiukai;1341333016;Ne;11;4;0;15
19085;Spygliukas;Pelėdžiukai;5561426508;Ne;8;0;0;8
19086;Spygliukas;Pelėdžiukai;8806126755;Ne;1;2;0;3
19087;Spygliukas;Pelėdžiukai;4477402331;Ne;12;4;0;16
19088;Spygliukas;Pelėdžiukai;2772801133;Ne;8;4;0;12
19089;Spygliukas;Pelėdžiukai;6332646009;Ne;0;4;0;4
19090;Spygliukas;Pelėdžiukai;3706443395;Ne;0;4;0;4
19091;Spygliukas;Pelėdžiukai;5765106914;Ne;0;2;0;2
19092;Spygliukas;Pelėdžiukai;3416275094;Ne;5;4;0;9
19093;Spygliukas;Pelėdžiukai;1401951658;Ne;0;2;0;2
19094;Spygliukas;Pelėdžiukai;7900652746;Ne;5;3;0;8
19095;Spygliukas;Pelėdžiukai;6248409896;Ne;0;2;0;2
19096;Spygliukas;Zylutės;2135024989;Ne;19;0;0;19
19097;Spygliukas;Zylutės;7351963782;Ne;14;0;0;14
19098;Spygliukas;Zylutės;9348022137;Ne;5;0;0;5
19099;Spygliukas;Zylutės;3804738695;Taip;15;0;0;15
19100;Spygliukas;Zylutės;3036959597;Ne;9;0;0;9
19101;Spygliukas;Zylutės;5565042215;Ne;16;0;0;16
19102;Spygliukas;Zylutės;4161787684;Ne;10;0;0;10
19103;Spygliukas;Zylutės;8536017163;Ne;1;0;0;1
19104;Spygliukas;Zylutės;6061859914;Ne;15;4;0;19
19105;Spygliukas;Zylutės;4097562838;Ne;2;0;0;2
19106;Spygliukas;Zylutės;6021859437;Ne;19;0;0;19
19107;Spygliukas;Zylutės;5357257525;Ne;17;0;0;17
19108;Spygliukas;Zylutės;9382060963;Ne;13;0;0;13
19109;Spygliukas;Zylutės;8246963847;Ne;9;0;0;9
19110;Spygliukas;Skruzdėliukai;9370633403;Ne;0;19;0;19
19111;Spygliukas;Skruzdėliukai;9155444846;Ne;10;0;0;10
19112;Spygliukas;Skruzdėliukai;6828136677;Ne;9;0;0;9
19113;Spygliukas;Skruzdėliukai;7524773805;Ne;0;8;0;8
19114;Spygliukas;Skruzdėliukai;2921299830;Ne;9;4;0;13
19115;Spygliukas;Skruzdėliukai;9138352625;Ne;11;0;0;11
19116;Spygliukas;Skruzdėliukai;1419835654;Ne;11;0;0;11
19117;Spygliukas;Skruzdėliukai;5513126879;Ne;19;0;0;19
19118;Spygliukas;Skruzdėliukai;3458761442;Ne;3;9;0;12
19119;Spygliukas;Skruzdėliukai;9211070397;Ne;7;2;0;9
19120;Spygliukas;Skruzdėliukai;1210648053;Ne;2;0;0;2
19121;Spygliukas;Skruzdėliukai;7163485844;Ne;4;4;0;8
19122;Spygliukas;Skruzdėliukai;4974008654;Ne;15;4;0;19
19123;Spygliukas;Skruzdėliukai;4928125811;Ne;9;0;0;9
19124;Spygliukas;Skruzdėliukai;6749921681;Ne;0;2;0;2
19125;Spygliukas;Voveraitės;9112172144;Ne;3;4;0;7
19126;Spygliukas;Voveraitės;7897603878;Ne;0;9;0;9
19127;Spygliukas;Voveraitės;7741841634;Ne;3;7;0;10
19128;Spygliukas;Voveraitės;3077468722;Ne;5;4;0;9
19129;Spygliukas;Voveraitės;1177439438;Ne;0;4;0;4
19130;Spygliukas;Voveraitės;4948147941;Ne;0;1;0;1
19131;Spygliukas;Voveraitės;2272141731;Ne;2;4;0;6
19132;Spygliukas;Voveraitės;6587957213;Ne;0;7;0;7
19133;Spygliukas;Voveraitės;6758336405;Ne;0;9;0;9
19134;Spygliukas;Voveraitės;3668191959;Ne;0;4;0;4
19135;Spygliukas;Voveraitės;1426267001;Ne;4;3;0;7
19136;Spygliukas;Voveraitės;8189748611;Ne;2;4;0;6
19137;Spygliukas;Voveraitės;6405496193;Ne;2;5;0;7
19138;Spygliukas;Voveraitės;7113913750;Ne;7;3;0;10
19139;Spygliukas;Voveraitės;9231097598;Ne;3;4;0;7
19140;Spygliukas;Voveraitės;4681061579;Ne;11;4;0;15
19141;Spygliukas;Voveraitės;1234195733;Ne;0;3;0;3
19142;Spygliukas;Giliukų;1761340174;Ne;0;1;0;1
19143;Spygliukas;Giliukų;4854168938;Taip;16;0;0;16
19144;Spygliukas;Giliukų;7522567241;Ne;2;1;0;3
19145;Spygliukas;Giliukų;7460280684;Ne;19;0;0;19
19146;Spygliukas;Giliukų;4429961491;Ne;13;0;0;13
19147;Spygliukas;Giliukų;8821028259;Ne;3;0;0;3
19148;Spygliukas;Giliukų;6485350404;Ne;8;10;0;18
19149;Spygliukas;Giliukų;3237501537;Ne;6;4;0;10
19150;Spygliukas;Giliukų;8722863277;Ne;6;4;0;10
19151;Spygliukas;Giliukų;3603606800;Ne;7;2;0;9
19152;Spygliukas;Giliukų;6290439938;Ne;1;3;0;4
19153;Spygliukas;Giliukų;7776811391;Ne;1;3;0;4
19154;Spygliukas;Giliukų;3777763305;Ne;5;0;0;5
19155;Spygliukas;Giliukų;4626877679;Ne;2;5;0;7
19156;Spygliukas;Giliukų;4494339318;Ne;9;0;0;9
19157;Spygliukas;Drugeliai;8178732077;Ne;0;19;0;19
19158;Spygliukas;Drugeliai;5164567779;Ne;3;0;0;3
19159;Spygliukas;Drugeliai;8366571422;Ne;1;1;0;2
19160;Spygliukas;Drugeliai;9465470810;Ne;9;0;0;9
19161;Spygliukas;Drugeliai;9601530981;Ne;4;0;0;4
19162;Spygliukas;Drugeliai;3988253265;Taip;0;1;0;1
19163;Spygliukas;Drugeliai;3317395260;Ne;11;1;0;12
19164;Spygliukas;Drugeliai;3811864870;Ne;2;0;0;2
19165;Spygliukas;Drugeliai;6858338620;Ne;7;0;0;7
19166;Spygliukas;Drugeliai;5638595939;Ne;6;4;0;10
19167;Spygliukas;Drugeliai;8408234202;Ne;1;1;0;2
19168;Spygliukas;Drugeliai;1729199382;Taip;3;1;0;4
19169;Spygliukas;Drugeliai;5006372835;Ne;3;0;0;3
19170;Spygliukas;Drugeliai;3268222954;Ne;9;0;0;9
19171;Spygliukas;Drugeliai;3066293772;Ne;10;0;0;10
19172;Spygliukas;Drugeliai;6343141973;Ne;2;3;0;5
19173;Spygliukas;Drugeliai;2632672131;Taip;15;4;0;19
19174;Vieversys;Žirniukai;5365334453;Ne;4;1;0;5
19175;Vieversys;Žirniukai;7029322013;Ne;2;3;0;5
19176;Vieversys;Žirniukai;2266222087;Ne;7;0;0;7
19177;Vieversys;Žirniukai;2869545222;Ne;3;0;0;3
19178;Vieversys;Žirniukai;7601876587;Ne;9;0;0;9
19179;Vieversys;Žirniukai;2024837493;Ne;5;0;0;5
19180;Vieversys;Žirniukai;8129566710;Ne;5;4;1;10
19181;Vieversys;Žirniukai;5576923685;Ne;13;3;0;16
19182;Vieversys;Žirniukai;6052943894;Ne;2;0;0;2
19183;Vieversys;Žirniukai;3295424711;Ne;0;0;2;2
19184;Vieversys;Žirniukai;7309040730;Ne;0;0;1;1
19185;Vieversys;Žirniukai;3575906273;Ne;0;0;3;3
19186;Vieversys;Žirniukai;1724543625;Ne;3;0;0;3
19187;Vieversys;Žirniukai;6530685517;Ne;0;1;0;1
19188;Vieversys;Žirniukai;3533711179;Taip;0;3;0;3
19189;Vieversys;Žirniukai;2242368843;Ne;8;0;0;8
19190;Vieversys;Žirniukai;9666764935;Ne;16;0;0;16
19191;Vieversys;Žirniukai;8966020793;Ne;10;0;0;10
19192;Vieversys;Žirniukai;6000875464;Ne;0;3;1;4
19193;Vieversys;Žirniukai;3683573041;Ne;2;0;0;2
19194;Vieversys;Varpelių;5150986489;Ne;0;3;0;3
19195;Vieversys;Varpelių;9463693741;Ne;2;0;0;2
19196;Vieversys;Varpelių;1924774817;Taip;8;3;0;11
19197;Vieversys;Varpelių;3595005599;Ne;3;6;0;9
19198;Vieversys;Varpelių;9155896981;Ne;0;6;0;6
19199;Vieversys;Varpelių;5160814541;Ne;0;4;0;4
19200;Vieversys;Varpelių;9580031042;Ne;0;3;0;3
19201;Vieversys;Varpelių;2635722489;Ne;7;3;0;10
19202;Vieversys;Varpelių;3262738994;Ne;10;4;0;14
19203;Vieversys;Varpelių;8350070741;Ne;7;0;0;7
19204;Vieversys;Varpelių;2805682329;Ne;5;4;0;9
19205;Vieversys;Varpelių;9453100342;Ne;0;2;0;2
19206;Vieversys;Varpelių;2956566201;Ne;7;1;0;8
19207;Vieversys;Varpelių;1727558984;Ne;14;0;0;14
19208;Vieversys;Varpelių;3780226431;Ne;11;0;1;12
19209;Vieversys;Varpelių;3572628491;Ne;11;0;0;11
19210;Vieversys;Varpelių;1128991679;Ne;13;0;0;13
19211;Vieversys;Varpelių;7611047781;Ne;3;1;0;4
19212;Vieversys;Varpelių;8079885165;Ne;11;0;0;11
19213;Vieversys;Varpelių;4510888337;Ne;0;6;0;6
19214;Vieversys;Kiškučių;3405502715;Ne;0;4;0;4
19215;Vieversys;Kiškučių;6127272124;Ne;0;4;1;5
19216;Vieversys;Kiškučių;4892622551;Ne;0;1;0;1
19217;Vieversys;Kiškučių;3360981720;Taip;10;1;0;11
19218;Vieversys;Kiškučių;5654533451;Ne;0;4;4;8
19219;Vieversys;Kiškučių;9972526744;Ne;0;2;2;4
19220;Vieversys;Kiškučių;9985374057;Ne;5;4;1;10
19221;Vieversys;Kiškučių;9308040716;Ne;5;1;0;6
19222;Vieversys;Kiškučių;4741252829;Ne;5;1;0;6
19223;Vieversys;Kiškučių;2140887757;Ne;0;2;0;2
19224;Vieversys;Kiškučių;3164280186;Ne;0;2;3;5
19225;Vieversys;Kiškučių;1748006118;Ne;0;1;0;1
19226;Vieversys;Kiškučių;4690095102;Ne;1;4;1;6
19227;Vieversys;Kiškučių;7048475906;Ne;0;4;0;4
19228;Vieversys;Kiškučių;4072323869;Ne;0;5;0;5
19229;Vieversys;Kiškučių;2663322242;Ne;15;4;0;19
19230;Vieversys;Kiškučių;7596355010;Ne;0;13;0;13
19231;Vieversys;Kiškučių;9322322737;Ne;0;4;2;6
19232;Vieversys;Kiškučių;9164615794;Ne;0;7;0;7
19233;Vieversys;Kiškučių;8174124875;Taip;0;3;0;3
19234;Vieversys;Pelėdžiukų;3681120339;Ne;5;4;3;12
19235;Vieversys;Pelėdžiukų;6882614465;Ne;8;4;0;12
19236;Vieversys;Pelėdžiukų;7007620994;Ne;0;4;1;5
19237;Vieversys;Pelėdžiukų;3946609345;Ne;0;4;1;5
19238;Vieversys;Pelėdžiukų;9686787125;Ne;0;4;0;4
19239;Vieversys;Pelėdžiukų;3684937630;Ne;4;2;0;6
19240;Vieversys;Pelėdžiukų;4455039401;Ne;0;4;0;4
19241;Vieversys;Pelėdžiukų;6563139211;Ne;2;5;2;9
19242;Vieversys;Pelėdžiukų;4294676988;Ne;5;4;2;11
19243;Vieversys;Pelėdžiukų;4835022593;Ne;0;4;1;5
19244;Vieversys;Pelėdžiukų;3249717073;Ne;1;4;0;5
19245;Vieversys;Pelėdžiukų;7120329258;Ne;0;5;0;5
19246;Vieversys;Pelėdžiukų;9494957750;Ne;6;3;0;9
19247;Vieversys;Pelėdžiukų;9835682858;Ne;0;4;5;9
19248;Vieversys;Pelėdžiukų;5907903394;Ne;0;4;0;4
19249;Vieversys;Pelėdžiukų;5769453869;Ne;3;4;0;7
19250;Vieversys;Saulučių;8492908398;Ne;3;0;0;3
19251;Vieversys;Saulučių;8706336322;Ne;5;0;0;5
19252;Vieversys;Saulučių;5966170543;Ne;13;0;0;13
19253;Vieversys;Saulučių;9268459013;Ne;8;0;0;8
19254;Vieversys;Saulučių;5210732072;Ne;18;0;0;18
19255;Vieversys;Saulučių;2072413459;Ne;4;0;0;4
19256;Vieversys;Saulučių;9476611261;Taip;0;19;0;19
19257;Vieversys;Saulučių;9978867863;Ne;9;3;0;12
19258;Vieversys;Saulučių;5479620291;Ne;12;0;0;12
19259;Vieversys;Saulučių;6083402842;Ne;3;0;0;3
19260;Vieversys;Saulučių;3601928285;Ne;6;0;0;6
19261;Vieversys;Saulučių;6839896363;Ne;3;0;0;3
19262;Vieversys;Saulučių;2661027772;Taip;14;0;0;14
19263;Vieversys;Saulučių;4428101863;Ne;0;6;0;6
19264;Vieversys;Saulučių;5417413393;Ne;10;0;0;10
19265;Vieversys;Saulučių;4335653911;Ne;4;0;0;4
19266;Vieversys;Saulučių;2931875387;Ne;5;0;0;5
19267;Vieversys;Saulučių;9092693925;Taip;6;0;0;6
19268;Vieversys;Kregždučių;3156245273;Ne;0;3;0;3
19269;Vieversys;Kregždučių;5645852451;Taip;0;4;0;4
19270;Vieversys;Kregždučių;9088171869;Ne;0;4;0;4
19271;Vieversys;Kregždučių;7998100115;Ne;2;4;2;8
19272;Vieversys;Kregždučių;9093088054;Ne;0;4;0;4
19273;Vieversys;Kregždučių;4870401841;Ne;0;2;1;3
19274;Vieversys;Kregždučių;2849852593;Ne;0;3;0;3
19275;Vieversys;Kregždučių;6808541662;Ne;0;0;5;5
19276;Vieversys;Kregždučių;2529690060;Ne;0;4;3;7
19277;Vieversys;Kregždučių;2230503026;Ne;0;4;0;4
19278;Vieversys;Kregždučių;7568415178;Ne;4;0;0;4
19279;Vieversys;Kregždučių;8141710663;Ne;0;4;0;4
19280;Vieversys;Kregždučių;6157594693;Ne;0;4;0;4
19281;Vieversys;Kregždučių;1322953831;Ne;0;4;1;5
19282;Vieversys;Kregždučių;9090281352;Ne;1;0;2;3
19283;Vieversys;Kregždučių;4308330177;Ne;0;0;6;6
19284;Vieversys;Kregždučių;4347494053;Ne;0;4;0;4
19285;Vieversys;Kregždučių;3122763958;Ne;0;8;0;8
19286;Vieversys;Kregždučių;2938302462;Ne;0;0;5;5
19287;Vieversys;Kregždučių;9577869269;Ne;1;0;2;3
19288;Vieversys;Boružėlių;8587368497;Ne;0;4;3;7
19289;Vieversys;Boružėlių;9884517851;Ne;0;4;0;4
19290;Vieversys;Boružėlių;4565799599;Ne;0;3;0;3
19291;Vieversys;Boružėlių;7399326463;Ne;8;0;0;8
19292;Vieversys;Boružėlių;4088189914;Ne;0;5;0;5
19293;Vieversys;Boružėlių;7364582681;Ne;3;5;0;8
19294;Vieversys;Boružėlių;8084767846;Ne;0;4;0;4
19295;Vieversys;Boružėlių;9826657384;Ne;0;2;1;3
19296;Vieversys;Boružėlių;3731412573;Ne;1;4;0;5
19297;Vieversys;Boružėlių;7429565381;Ne;0;5;2;7
19298;Vieversys;Boružėlių;4297477514;Ne;0;1;8;9
19299;Vieversys;Boružėlių;8816714193;Ne;0;2;3;5
19300;Vieversys;Boružėlių;2701284187;Ne;9;3;0;12
19301;Vieversys;Boružėlių;6234199996;Ne;15;0;0;15
19302;Vieversys;Boružėlių;4183584366;Ne;12;0;0;12
19303;Vieversys;Boružėlių;4061364544;Ne;0;0;2;2
19304;Vieversys;Boružėlių;8446180685;Ne;13;0;0;13
19305;Vieversys;Boružėlių;1013074080;Ne;13;0;0;13
19306;Vieversys;Boružėlių;6838828193;Ne;0;4;1;5
19307;Vieversys;Bitučių;3529067497;Ne;0;1;0;1
19308;Vieversys;Bitučių;7427200045;Ne;4;0;0;4
19309;Vieversys;Bitučių;8339300439;Ne;7;7;0;14
19310;Vieversys;Bitučių;6133686703;Ne;4;0;0;4
19311;Vieversys;Bitučių;8916379820;Ne;5;0;0;5
19312;Vieversys;Bitučių;6070871599;Ne;6;1;0;7
19313;Vieversys;Bitučių;8443729534;Ne;5;1;0;6
19314;Vieversys;Bitučių;7623394512;Ne;0;0;9;9
19315;Vieversys;Bitučių;5598338574;Taip;10;0;0;10
19316;Vieversys;Bitučių;3798183613;Ne;3;0;0;3
19317;Vieversys;Bitučių;3539906884;Ne;0;19;0;19
19318;Vieversys;Bitučių;5226457473;Ne;0;19;0;19
19319;Vieversys;Bitučių;4138476832;Ne;5;5;0;10
19320;Vieversys;Bitučių;1844718177;Ne;0;8;0;8
19321;Vieversys;Smalsučių;9412299328;Ne;13;0;0;13
19322;Vieversys;Smalsučių;8199984460;Ne;0;0;19;19
19323;Vieversys;Smalsučių;7539934804;Ne;0;0;2;2
19324;Vieversys;Smalsučių;1714096583;Ne;9;0;0;9
19325;Vieversys;Smalsučių;8371839883;Ne;1;0;4;5
19326;Vieversys;Smalsučių;6474334564;Ne;4;0;2;6
19327;Vieversys;Smalsučių;4952182897;Ne;0;4;0;4
19328;Vieversys;Smalsučių;2092872414;Ne;0;0;4;4
19329;Vieversys;Smalsučių;5394635510;Ne;4;4;0;8
19330;Vieversys;Smalsučių;1160455554;Ne;12;0;3;15
19331;Vieversys;Smalsučių;8200432952;Ne;16;0;0;16
19332;Vieversys;Smalsučių;2535992834;Ne;7;0;1;8
19333;Vieversys;Smalsučių;4974924858;Ne;1;4;0;5
19334;Vieversys;Smalsučių;7111551694;Ne;5;0;4;9
19335;Vieversys;Smalsučių;2107000312;Ne;0;0;2;2
19336;Vieversys;Smalsučių;4743593002;Ne;2;0;7;9
19337;Vieversys;Smalsučių;6092848276;Ne;6;0;4;10
19338;Vieversys;Smalsučių;6498432810;Ne;19;0;0;19
19339;Vieversys;Kodėlčiukų;5037806018;Ne;6;0;0;6
19340;Vieversys;Kodėlčiukų;1752359969;Taip;3;5;0;8
19341;Vieversys;Kodėlčiukų;6791121542;Ne;5;4;0;9
19342;Vieversys;Kodėlčiukų;5898422871;Ne;14;3;0;17
19343;Vieversys;Kodėlčiukų;6709556873;Ne;4;0;0;4
19344;Vieversys;Kodėlčiukų;4193031329;Ne;0;7;0;7
19345;Vieversys;Kodėlčiukų;7453156612;Ne;2;0;0;2
19346;Vieversys;Kodėlčiukų;6926960486;Ne;0;3;0;3
19347;Vieversys;Kodėlčiukų;3180687885;Ne;5;4;0;9
19348;Vieversys;Kodėlčiukų;1881076551;Ne;0;5;0;5
19349;Vieversys;Kodėlčiukų;1384388802;Ne;7;8;0;15
19350;Vieversys;Kodėlčiukų;2562413607;Ne;13;0;0;13
19351;Vieversys;Kodėlčiukų;9965162863;Ne;7;0;0;7
19352;Vieversys;Kodėlčiukų;4702339508;Taip;11;0;0;11
19353;Vieversys;Kodėlčiukų;4631238425;Ne;10;4;0;14
19354;Vieversys;Kodėlčiukų;8512643926;Ne;14;0;0;14
19355;Vieversys;Kodėlčiukų;7967372524;Ne;6;0;0;6
19356;Vieversys;Kodėlčiukų;4703696958;Ne;0;3;0;3
19357;Vieversys;Kodėlčiukų;9747443326;Ne;11;0;0;11
19358;Vieversys;NYKŠTUKAI;7778432049;Ne;5;0;0;5
19359;Vieversys;NYKŠTUKAI;6767212393;Ne;3;0;1;4
19360;Vieversys;NYKŠTUKAI;2143285915;Ne;19;0;0;19
19361;Vieversys;NYKŠTUKAI;7340840045;Ne;15;4;0;19
19362;Vieversys;NYKŠTUKAI;3557067985;Ne;5;3;1;9
19363;Vieversys;NYKŠTUKAI;8054640386;Ne;0;0;1;1
19364;Vieversys;NYKŠTUKAI;9812354315;Ne;17;0;0;17
19365;Vieversys;NYKŠTUKAI;1377293916;Ne;8;0;0;8
19366;Vieversys;NYKŠTUKAI;4482612962;Ne;15;4;0;19
19367;Vieversys;NYKŠTUKAI;6408198729;Ne;11;0;1;12
19368;Vieversys;DRUGELIAI;2638813853;Ne;10;4;0;14
19369;Vieversys;DRUGELIAI;7508850558;Ne;2;0;0;2
19370;Vieversys;DRUGELIAI;1552959751;Ne;0;0;1;1
19371;Vieversys;DRUGELIAI;6669012722;Ne;0;6;0;6
19372;Vieversys;DRUGELIAI;9813883328;Ne;0;3;0;3
19373;Vieversys;DRUGELIAI;7708807923;Ne;0;3;0;3
19374;Vieversys;DRUGELIAI;4129333932;Ne;8;0;0;8
19375;Vieversys;DRUGELIAI;6581002790;Ne;3;0;0;3
19376;Vieversys;DRUGELIAI;1720061988;Taip;11;2;0;13
19377;Vieversys;DRUGELIAI;6014448044;Ne;0;4;0;4
19378;Vieversys;DRUGELIAI;6222790462;Ne;5;0;2;7
19379;Vieversys;DRUGELIAI;1752390411;Ne;0;8;0;8
19380;Vieversys;DRUGELIAI;4743557459;Ne;14;0;0;14
19381;Vieversys;DRUGELIAI;9377014366;Ne;10;0;1;11
19382;Vieversys;DRUGELIAI;8595221658;Ne;3;0;1;4
19383;Žirmūnėliai;SAULUTĖS;5560694124;Ne;2;3;0;5
19384;Žirmūnėliai;SAULUTĖS;6116321928;Ne;4;0;0;4
19385;Žirmūnėliai;SAULUTĖS;2310523676;Ne;0;3;0;3
19386;Žirmūnėliai;SAULUTĖS;4922028935;Ne;5;2;0;7
19387;Žirmūnėliai;SAULUTĖS;1948299433;Ne;0;1;0;1
19388;Žirmūnėliai;SAULUTĖS;4763350308;Ne;2;0;0;2
19389;Žirmūnėliai;SAULUTĖS;5626711530;Ne;0;7;0;7
19390;Žirmūnėliai;SAULUTĖS;3902161368;Ne;0;5;0;5
19391;Žirmūnėliai;SAULUTĖS;6072407337;Ne;0;4;0;4
19392;Žirmūnėliai;SAULUTĖS;4338673048;Ne;0;2;0;2
19393;Žirmūnėliai;SAULUTĖS;4793967980;Ne;2;2;0;4
19394;Žirmūnėliai;SAULUTĖS;6177408775;Ne;0;2;0;2
19395;Žirmūnėliai;SAULUTĖS;8242112212;Ne;3;4;0;7
19396;Žirmūnėliai;SAULUTĖS;1940552890;Ne;0;4;0;4
19397;Žirmūnėliai;SAULUTĖS;2392106040;Ne;4;3;0;7
19398;Žirmūnėliai;SAULUTĖS;4343419766;Ne;5;2;0;7
19399;Žirmūnėliai;SAULUTĖS;9145626116;Ne;19;0;0;19
19400;Žirmūnėliai;SAULUTĖS;7675488865;Ne;0;1;0;1
19401;Žirmūnėliai;SAULUTĖS;8345632807;Ne;0;4;0;4
19402;Žirmūnėliai;SAULUTĖS;8592714547;Ne;7;4;0;11
19403;Žirmūnėliai;SAULUTĖS;4134541560;Ne;4;3;0;7
19404;Žirmūnėliai;SAULUTĖS;8481357052;Ne;13;0;0;13
19405;Žirmūnėliai;GILIUKAI;6430944858;Ne;7;0;1;8
19406;Žirmūnėliai;GILIUKAI;3562689670;Ne;0;7;0;7
19407;Žirmūnėliai;GILIUKAI;5929166560;Ne;0;2;0;2
19408;Žirmūnėliai;GILIUKAI;3767421827;Ne;0;1;0;1
19409;Žirmūnėliai;GILIUKAI;4327504033;Ne;4;0;0;4
19410;Žirmūnėliai;GILIUKAI;5104310002;Ne;0;10;0;10
19411;Žirmūnėliai;GILIUKAI;1025809131;Taip;0;1;0;1
19412;Žirmūnėliai;GILIUKAI;6899109664;Ne;5;4;0;9
19413;Žirmūnėliai;GILIUKAI;5089884149;Ne;1;0;2;3
19414;Žirmūnėliai;GILIUKAI;1791977446;Ne;4;1;0;5
19415;Žirmūnėliai;GILIUKAI;6875484657;Ne;4;0;0;4
19416;Žirmūnėliai;GILIUKAI;9871163622;Ne;0;4;0;4
19417;Žirmūnėliai;GILIUKAI;3532895278;Ne;0;2;0;2
19418;Žirmūnėliai;GILIUKAI;2959090234;Ne;5;5;1;11
19419;Žirmūnėliai;GILIUKAI;8618410295;Ne;18;0;0;18
19420;Žirmūnėliai;GILIUKAI;1941509002;Ne;8;0;6;14
19421;Žirmūnėliai;GILIUKAI;3646039695;Ne;0;5;0;5
19422;Žirmūnėliai;GILIUKAI;2866010286;Ne;0;4;0;4
19423;Žirmūnėliai;GILIUKAI;2904787614;Ne;0;5;0;5
19424;Žirmūnėliai;GILIUKAI;4807331877;Ne;3;4;0;7
19425;Žirmūnėliai;DRUGELIAI;2802717644;Ne;9;0;0;9
19426;Žirmūnėliai;DRUGELIAI;3029428022;Ne;0;3;0;3
19427;Žirmūnėliai;DRUGELIAI;5281338626;Ne;7;2;0;9
19428;Žirmūnėliai;DRUGELIAI;6892941066;Ne;0;6;0;6
19429;Žirmūnėliai;DRUGELIAI;9280663182;Ne;0;12;0;12
19430;Žirmūnėliai;DRUGELIAI;6427861912;Ne;0;0;1;1
19431;Žirmūnėliai;DRUGELIAI;2736632324;Ne;0;2;0;2
19432;Žirmūnėliai;DRUGELIAI;5892153807;Ne;7;0;0;7
19433;Žirmūnėliai;DRUGELIAI;2870069039;Ne;0;2;0;2
19434;Žirmūnėliai;DRUGELIAI;8271996884;Ne;0;5;0;5
19435;Žirmūnėliai;DRUGELIAI;4291114238;Ne;0;4;0;4
19436;Žirmūnėliai;DRUGELIAI;3012945005;Ne;7;1;0;8
19437;Žirmūnėliai;DRUGELIAI;8782085662;Ne;9;4;0;13
19438;Žirmūnėliai;DRUGELIAI;4836165731;Ne;0;3;0;3
19439;Žirmūnėliai;DRUGELIAI;9472372819;Ne;2;1;0;3
19440;Žirmūnėliai;DRUGELIAI;3174613910;Ne;0;2;0;2
19441;Žirmūnėliai;DRUGELIAI;6812682361;Ne;9;0;0;9
19442;Žirmūnėliai;DRUGELIAI;5668266601;Ne;13;0;0;13
19443;Žirmūnėliai;DRUGELIAI;5616289290;Ne;0;5;0;5
19444;Žirmūnėliai;DRUGELIAI;9908958250;Taip;0;13;0;13
19445;Žirmūnėliai;DRUGELIAI;9978718231;Ne;0;1;0;1
19446;Žirmūnėliai;BORUŽIUKAI;5209700153;Ne;0;2;1;3
19447;Žirmūnėliai;BORUŽIUKAI;4815427530;Ne;3;0;1;4
19448;Žirmūnėliai;BORUŽIUKAI;5316869112;Ne;3;0;0;3
19449;Žirmūnėliai;BORUŽIUKAI;6641667315;Ne;0;6;1;7
19450;Žirmūnėliai;BORUŽIUKAI;8538773532;Ne;0;5;0;5
19451;Žirmūnėliai;BORUŽIUKAI;1401001989;Ne;0;4;0;4
19452;Žirmūnėliai;BORUŽIUKAI;5154076629;Ne;0;4;0;4
19453;Žirmūnėliai;BORUŽIUKAI;1356219744;Ne;6;6;0;12
19454;Žirmūnėliai;BORUŽIUKAI;2985092368;Ne;16;0;0;16
19455;Žirmūnėliai;BORUŽIUKAI;2841958534;Ne;0;4;0;4
19456;Žirmūnėliai;BORUŽIUKAI;8999160836;Ne;0;5;0;5
19457;Žirmūnėliai;BORUŽIUKAI;5736502380;Ne;2;5;1;8
19458;Žirmūnėliai;BORUŽIUKAI;9241738140;Ne;5;3;0;8
19459;Žirmūnėliai;BORUŽIUKAI;9378860669;Ne;5;4;0;9
19460;Žirmūnėliai;BORUŽIUKAI;8607934394;Ne;2;5;1;8
19461;Žirmūnėliai;BORUŽIUKAI;7422544482;Ne;0;5;0;5
19462;Žirmūnėliai;BORUŽIUKAI;5723289396;Ne;0;4;0;4
19463;Žirmūnėliai;BORUŽIUKAI;4336415033;Ne;0;2;0;2
19464;Žirmūnėliai;BORUŽIUKAI;8917966812;Ne;2;3;0;5
19465;Žirmūnėliai;BORUŽIUKAI;8459217612;Ne;3;3;0;6
19466;Žirmūnėliai;BORUŽIUKAI;1473482823;Ne;1;0;0;1
19467;Žirmūnėliai;EŽIUKAI;7011701994;Ne;0;3;0;3
19468;Žirmūnėliai;EŽIUKAI;2661052835;Ne;6;5;0;11
19469;Žirmūnėliai;EŽIUKAI;1655437833;Ne;0;2;0;2
19470;Žirmūnėliai;EŽIUKAI;3640979388;Ne;10;4;0;14
19471;Žirmūnėliai;EŽIUKAI;6878528100;Ne;0;4;3;7
19472;Žirmūnėliai;EŽIUKAI;8440187348;Ne;5;1;0;6
19473;Žirmūnėliai;EŽIUKAI;4565479092;Ne;0;3;0;3
19474;Žirmūnėliai;EŽIUKAI;4968278870;Ne;4;4;1;9
19475;Žirmūnėliai;EŽIUKAI;2693415717;Ne;5;2;0;7
19476;Žirmūnėliai;EŽIUKAI;7953019230;Ne;0;6;0;6
19477;Žirmūnėliai;EŽIUKAI;1832367936;Ne;0;4;0;4
19478;Žirmūnėliai;EŽIUKAI;3180116136;Ne;15;4;0;19
19479;Žirmūnėliai;EŽIUKAI;9759491055;Ne;1;1;0;2
19480;Žirmūnėliai;EŽIUKAI;1127214387;Ne;10;5;0;15
19481;Žirmūnėliai;EŽIUKAI;4101748829;Ne;0;8;0;8
19482;Žirmūnėliai;EŽIUKAI;2379638934;Ne;0;9;0;9
19483;Žirmūnėliai;EŽIUKAI;4710829908;Ne;0;5;0;5
19484;Žirmūnėliai;EŽIUKAI;7996709950;Ne;0;10;0;10
19485;Žirmūnėliai;EŽIUKAI;7580002502;Ne;15;4;0;19
19486;Žirmūnėliai;EŽIUKAI;4638575301;Ne;4;4;0;8
19487;Žirmūnėliai;EŽIUKAI;3310847619;Ne;0;2;0;2
19488;Žirmūnėliai;EŽIUKAI;1977798059;Ne;0;4;4;8
19489;Žirmūnėliai;EŽIUKAI;3458810185;Ne;1;4;0;5
19490;Žirmūnėliai;ŽVIRBLIUKAI;7410921362;Ne;0;2;0;2
19491;Žirmūnėliai;ŽVIRBLIUKAI;4218266688;Ne;0;3;1;4
19492;Žirmūnėliai;ŽVIRBLIUKAI;7020486370;Ne;0;13;0;13
19493;Žirmūnėliai;ŽVIRBLIUKAI;3449815783;Ne;0;4;0;4
19494;Žirmūnėliai;ŽVIRBLIUKAI;7892626521;Ne;0;15;0;15
19495;Žirmūnėliai;ŽVIRBLIUKAI;4778339658;Ne;0;5;0;5
19496;Žirmūnėliai;ŽVIRBLIUKAI;9541122034;Ne;5;2;0;7
19497;Žirmūnėliai;ŽVIRBLIUKAI;8209309240;Ne;0;9;0;9
19498;Žirmūnėliai;ŽVIRBLIUKAI;2837129621;Ne;3;4;0;7
19499;Žirmūnėliai;ŽVIRBLIUKAI;1273684243;Ne;0;4;2;6
19500;Žirmūnėliai;ŽVIRBLIUKAI;2971175236;Ne;0;5;0;5
19501;Žirmūnėliai;ŽVIRBLIUKAI;9154874729;Ne;0;5;0;5
19502;Žirmūnėliai;ŽVIRBLIUKAI;6594728970;Ne;0;5;0;5
19503;Žirmūnėliai;ŽVIRBLIUKAI;3795476732;Ne;0;3;0;3
19504;Žirmūnėliai;ŽVIRBLIUKAI;9732291476;Ne;2;0;0;2
19505;Žirmūnėliai;ŽVIRBLIUKAI;7087770068;Ne;0;2;0;2
19506;Žirmūnėliai;ŽVIRBLIUKAI;3431320961;Ne;0;2;0;2
19507;Žirmūnėliai;ŽVIRBLIUKAI;1571242696;Ne;3;2;0;5
19508;Žirmūnėliai;ŽVIRBLIUKAI;3766779594;Ne;0;1;0;1
19509;Žirmūnėliai;SPALVELĖS;9936156579;Ne;0;4;0;4
19510;Žirmūnėliai;SPALVELĖS;6259368139;Ne;0;6;0;6
19511;Žirmūnėliai;SPALVELĖS;6934204209;Ne;2;0;1;3
19512;Žirmūnėliai;SPALVELĖS;9306935083;Ne;3;4;0;7
19513;Žirmūnėliai;SPALVELĖS;6817236579;Ne;0;0;2;2
19514;Žirmūnėliai;SPALVELĖS;9042509512;Ne;5;6;0;11
19515;Žirmūnėliai;SPALVELĖS;5076712824;Ne;5;5;0;10
19516;Žirmūnėliai;SPALVELĖS;8444883234;Ne;0;4;0;4
19517;Žirmūnėliai;SPALVELĖS;3977279181;Ne;0;2;0;2
19518;Žirmūnėliai;SPALVELĖS;8002655555;Ne;8;7;0;15
19519;Žirmūnėliai;SPALVELĖS;1116572386;Ne;5;3;0;8
19520;Žirmūnėliai;SPALVELĖS;1255294064;Ne;8;2;1;11
19521;Žirmūnėliai;SPALVELĖS;3520677404;Ne;3;5;0;8
19522;Žirmūnėliai;SPALVELĖS;1724203157;Ne;0;0;1;1
19523;Žirmūnėliai;SPALVELĖS;5646794795;Ne;12;0;5;17
19524;Žirmūnėliai;SPALVELĖS;7589155099;Ne;0;3;0;3
19525;Žirmūnėliai;SPALVELĖS;5901940160;Ne;7;0;0;7
19526;Žirmūnėliai;SPALVELĖS;4641264260;Ne;0;6;0;6
19527;Žirmūnėliai;SPALVELĖS;9858198555;Ne;0;8;0;8
19528;Žirmūnėliai;SPALVELĖS;6523502376;Ne;0;0;2;2
19529;Žirmūnėliai;DEBESĖLIAI;6908512961;Ne;0;15;0;15
19530;Žirmūnėliai;DEBESĖLIAI;4347548125;Ne;19;0;0;19
19531;Žirmūnėliai;DEBESĖLIAI;3330603362;Ne;8;4;0;12
19532;Žirmūnėliai;DEBESĖLIAI;5440814849;Ne;0;5;0;5
19533;Žirmūnėliai;DEBESĖLIAI;7680479258;Ne;0;8;0;8
19534;Žirmūnėliai;DEBESĖLIAI;8136265008;Ne;0;13;0;13
19535;Žirmūnėliai;DEBESĖLIAI;7568228423;Ne;6;9;0;15
19536;Žirmūnėliai;DEBESĖLIAI;9813507899;Ne;0;0;2;2
19537;Žirmūnėliai;DEBESĖLIAI;8687642039;Ne;2;3;0;5
19538;Žirmūnėliai;DEBESĖLIAI;5982848146;Ne;10;9;0;19
19539;Žirmūnėliai;DEBESĖLIAI;5676730437;Ne;0;0;3;3
19540;Žirmūnėliai;DEBESĖLIAI;4653124134;Ne;4;0;0;4
19541;Žirmūnėliai;DEBESĖLIAI;4501490189;Ne;0;6;2;8
19542;Žirmūnėliai;DEBESĖLIAI;8239982682;Taip;2;0;0;2
19543;Žirmūnėliai;DEBESĖLIAI;6066212109;Ne;6;2;0;8
19544;Žirmūnėliai;DEBESĖLIAI;9759504463;Ne;5;4;0;9
19545;Žirmūnėliai;DEBESĖLIAI;3641319043;Ne;0;5;0;5
19546;Žirmūnėliai;DEBESĖLIAI;5622319185;Ne;19;0;0;19
19547;Žirmūnėliai;DEBESĖLIAI;7053321410;Ne;8;0;1;9
19548;Žirmūnėliai;DEBESĖLIAI;4512970900;Ne;0;1;0;1
19549;Žirmūnėliai;DEBESĖLIAI;8615363279;Ne;0;2;0;2
19550;Žirmūnėliai;VIŠČIUKAI;9688789802;Taip;10;0;0;10
19551;Žirmūnėliai;VIŠČIUKAI;2898177059;Ne;5;1;0;6
19552;Žirmūnėliai;VIŠČIUKAI;1512873821;Ne;6;0;0;6
19553;Žirmūnėliai;VIŠČIUKAI;5659912057;Ne;3;2;0;5
19554;Žirmūnėliai;VIŠČIUKAI;4019091254;Ne;6;0;0;6
19555;Žirmūnėliai;VIŠČIUKAI;7517228946;Ne;7;0;0;7
19556;Žirmūnėliai;VIŠČIUKAI;1522323117;Ne;0;2;0;2
19557;Žirmūnėliai;VIŠČIUKAI;3144841534;Ne;8;2;0;10
19558;Žirmūnėliai;VIŠČIUKAI;6640314231;Ne;9;0;0;9
19559;Žirmūnėliai;VIŠČIUKAI;7421097025;Ne;9;0;0;9
19560;Žirmūnėliai;VIŠČIUKAI;4464218112;Ne;11;0;0;11
19561;Žirmūnėliai;VIŠČIUKAI;7287108760;Ne;9;0;0;9
19562;Žirmūnėliai;VIŠČIUKAI;2353478333;Ne;9;0;0;9
19563;Žirmūnėliai;VIŠČIUKAI;4260032711;Ne;9;0;0;9
19564;Žirmūnėliai;VIŠČIUKAI;2821518346;Taip;0;2;0;2
19565;Žirmūnėliai;ZUIKUČIŲ;2074215403;Ne;19;0;0;19
19566;Žirmūnėliai;ZUIKUČIŲ;5981759291;Ne;0;4;0;4
19567;Žirmūnėliai;ZUIKUČIŲ;6122934687;Ne;4;0;0;4
19568;Žirmūnėliai;ZUIKUČIŲ;3560820710;Taip;3;3;2;8
19569;Žirmūnėliai;ZUIKUČIŲ;1582955541;Ne;0;5;0;5
19570;Žirmūnėliai;ZUIKUČIŲ;5772120262;Ne;0;4;14;18
19571;Žirmūnėliai;ZUIKUČIŲ;9448915252;Ne;11;0;0;11
19572;Žirmūnėliai;ZUIKUČIŲ;8526701525;Ne;0;2;2;4
19573;Žirmūnėliai;ZUIKUČIŲ;9953641492;Ne;16;0;0;16
19574;Žirmūnėliai;ZUIKUČIŲ;1498162175;Ne;11;0;0;11
19575;Žirmūnėliai;ZUIKUČIŲ;7232606752;Ne;11;1;0;12
19576;Žirmūnėliai;ZUIKUČIŲ;2857408011;Taip;0;6;0;6
19577;Žirmūnėliai;ZUIKUČIŲ;7771277342;Ne;10;0;0;10
19578;Žirmūnėliai;ZUIKUČIŲ;3825102173;Ne;5;0;0;5
19579;Žirmūnėliai;ZUIKUČIŲ;2069337771;Ne;14;0;0;14
19580;Žirmūnėliai;OBUOLIUKAI;4575123456;Ne;0;4;0;4
19581;Žirmūnėliai;OBUOLIUKAI;9002868728;Ne;0;4;0;4
19582;Žirmūnėliai;OBUOLIUKAI;2073922023;Taip;7;0;0;7
19583;Žirmūnėliai;OBUOLIUKAI;7059249540;Ne;0;3;0;3
19584;Žirmūnėliai;OBUOLIUKAI;4999561481;Ne;0;8;0;8
19585;Žirmūnėliai;OBUOLIUKAI;6358006462;Ne;0;3;0;3
19586;Žirmūnėliai;OBUOLIUKAI;2497258407;Ne;0;4;0;4
19587;Žirmūnėliai;OBUOLIUKAI;3949374730;Ne;0;2;0;2
19588;Žirmūnėliai;OBUOLIUKAI;6869102228;Ne;5;4;0;9
19589;Žirmūnėliai;OBUOLIUKAI;9367849317;Ne;0;4;0;4
19590;Žirmūnėliai;OBUOLIUKAI;9892620134;Ne;9;0;0;9
19591;Žirmūnėliai;OBUOLIUKAI;6450412481;Ne;0;7;0;7
19592;Žirmūnėliai;OBUOLIUKAI;9225654910;Ne;0;5;0;5
19593;Žirmūnėliai;OBUOLIUKAI;5483418311;Ne;0;5;0;5
19594;Žirmūnėliai;OBUOLIUKAI;7945713337;Ne;0;4;0;4
19595;Žirmūnėliai;OBUOLIUKAI;8823426998;Ne;0;8;0;8
19596;Žirmūnėliai;OBUOLIUKAI;2263820829;Ne;0;3;0;3
19597;Žirmūnėliai;OBUOLIUKAI;9823124599;Ne;0;0;18;18
19598;Žirmūnėliai;OBUOLIUKAI;9682309860;Ne;0;4;0;4
19599;Žirmūnėliai;OBUOLIUKAI;9924145022;Ne;0;4;0;4
19600;Žirmūnėliai;DAINORĖLIAI;6397359786;Ne;6;1;0;7
19601;Žirmūnėliai;DAINORĖLIAI;3493835685;Ne;5;4;0;9
19602;Žirmūnėliai;DAINORĖLIAI;7113999217;Ne;5;0;3;8
19603;Žirmūnėliai;DAINORĖLIAI;9483005892;Ne;6;0;0;6
19604;Žirmūnėliai;DAINORĖLIAI;6736693899;Ne;2;0;2;4
19605;Žirmūnėliai;DAINORĖLIAI;5977682064;Ne;19;0;0;19
19606;Žirmūnėliai;DAINORĖLIAI;1162986139;Ne;3;6;0;9
19607;Žirmūnėliai;DAINORĖLIAI;9220007612;Ne;7;0;3;10
19608;Žirmūnėliai;DAINORĖLIAI;2991492176;Ne;11;0;0;11
19609;Žirmūnėliai;DAINORĖLIAI;4578525446;Ne;0;1;0;1
19610;Žirmūnėliai;DAINORĖLIAI;3319602277;Ne;7;1;0;8
19611;Žirmūnėliai;DAINORĖLIAI;5750554959;Ne;7;0;0;7
19612;Žirmūnėliai;DAINORĖLIAI;8512701905;Ne;5;2;0;7
19613;Žirmūnėliai;DAINORĖLIAI;6026141001;Ne;6;12;0;18
19614;"Dainorėliai (Ankštoji g. 11)";VARPELIAI;3094277796;Ne;11;0;0;11
19615;"Dainorėliai (Ankštoji g. 11)";VARPELIAI;2340411409;Ne;0;0;4;4
19616;"Dainorėliai (Ankštoji g. 11)";VARPELIAI;3205801143;Ne;1;0;1;2
19617;"Dainorėliai (Ankštoji g. 11)";VARPELIAI;6708318702;Ne;0;0;3;3
19618;"Dainorėliai (Ankštoji g. 11)";VARPELIAI;8045118516;Ne;0;1;0;1
19619;"Dainorėliai (Ankštoji g. 11)";VARPELIAI;3463422617;Ne;1;0;0;1
19620;"Dainorėliai (Ankštoji g. 11)";VARPELIAI;5326096582;Ne;0;3;0;3
19621;"Dainorėliai (Ankštoji g. 11)";VARPELIAI;4812986408;Ne;2;4;0;6
19622;"Dainorėliai (Ankštoji g. 11)";VARPELIAI;1822342787;Ne;4;2;0;6
19623;"Dainorėliai (Ankštoji g. 11)";VARPELIAI;6652070415;Ne;4;0;0;4
19624;"Dainorėliai (Ankštoji g. 11)";VARPELIAI;5098256007;Ne;2;0;4;6
19625;"Dainorėliai (Ankštoji g. 11)";VARPELIAI;5900613350;Ne;5;4;0;9
19626;"Dainorėliai (Ankštoji g. 11)";VARPELIAI;7476236758;Ne;0;2;0;2
19627;"Dainorėliai (Ankštoji g. 11)";VARPELIAI;4312828453;Ne;10;0;2;12
19628;"Dainorėliai (Ankštoji g. 11)";VARPELIAI;2732648440;Ne;15;3;0;18
19629;"Dainorėliai (Ankštoji g. 11)";VARPELIAI;1505858775;Ne;0;0;4;4
19630;"Dainorėliai (Ankštoji g. 11)";VARPELIAI;9612167901;Ne;14;0;3;17
19631;"Dainorėliai (Ankštoji g. 11)";VARPELIAI;6192380237;Ne;0;2;4;6
19632;"Dainorėliai (Ankštoji g. 11)";VARPELIAI;9372212913;Ne;8;0;1;9
19633;"Dainorėliai (Ankštoji g. 11)";ŽIOGELIAI;5591598390;Ne;0;4;0;4
19634;"Dainorėliai (Ankštoji g. 11)";ŽIOGELIAI;8140354445;Ne;0;4;0;4
19635;"Dainorėliai (Ankštoji g. 11)";ŽIOGELIAI;2450726148;Ne;2;0;0;2
19636;"Dainorėliai (Ankštoji g. 11)";ŽIOGELIAI;5793828922;Ne;0;4;0;4
19637;"Dainorėliai (Ankštoji g. 11)";ŽIOGELIAI;7591953671;Ne;13;0;0;13
19638;"Dainorėliai (Ankštoji g. 11)";ŽIOGELIAI;6169434322;Ne;2;2;0;4
19639;"Dainorėliai (Ankštoji g. 11)";ŽIOGELIAI;2094849111;Ne;4;4;0;8
19640;"Dainorėliai (Ankštoji g. 11)";ŽIOGELIAI;3887433142;Ne;0;4;0;4
19641;"Dainorėliai (Ankštoji g. 11)";ŽIOGELIAI;2541781620;Ne;6;0;0;6
19642;"Dainorėliai (Ankštoji g. 11)";ŽIOGELIAI;8239000041;Ne;0;4;0;4
19643;"Dainorėliai (Ankštoji g. 11)";ŽIOGELIAI;7984447187;Ne;10;0;0;10
19644;"Dainorėliai (Ankštoji g. 11)";ŽIOGELIAI;5715129088;Ne;5;0;1;6
19645;"Dainorėliai (Ankštoji g. 11)";ŽIOGELIAI;9132532505;Ne;3;1;0;4
19646;"Dainorėliai (Ankštoji g. 11)";ŽIOGELIAI;3897725337;Ne;3;0;0;3
19647;"Dainorėliai (Ankštoji g. 11)";ŽIOGELIAI;3592770633;Ne;4;0;0;4
19648;"Dainorėliai (Ankštoji g. 11)";ŽIOGELIAI;3598951899;Ne;0;3;0;3
19649;"Dainorėliai (Ankštoji g. 11)";ŽIOGELIAI;5715129088;Ne;5;0;1;6
19650;"Dainorėliai (Ankštoji g. 11)";ŽIOGELIAI;9132532505;Ne;3;1;0;4
19651;"Dainorėliai (Ankštoji g. 11)";ŽIOGELIAI;3897725337;Ne;3;0;0;3
19652;"Dainorėliai (Ankštoji g. 11)";ŽIOGELIAI;3592770633;Ne;4;0;0;4
19653;"Dainorėliai (Ankštoji g. 11)";ŽIOGELIAI;3598951899;Ne;0;3;0;3
19654;"Dainorėliai (Ankštoji g. 11)";ŽIOGELIAI;4973241539;Ne;10;0;1;11
19655;"Dainorėliai (Ankštoji g. 11)";ŽIOGELIAI;8280877177;Ne;3;2;0;5
19656;"Dainorėliai (Ankštoji g. 11)";ŽIOGELIAI;2215481883;Ne;4;5;0;9
19657;"Dainorėliai (Ankštoji g. 11)";DRUGELIAI;6403389248;Ne;12;0;0;12
19658;"Dainorėliai (Ankštoji g. 11)";DRUGELIAI;4900234806;Ne;3;0;0;3
19659;"Dainorėliai (Ankštoji g. 11)";DRUGELIAI;2703267758;Ne;0;7;0;7
19660;"Dainorėliai (Ankštoji g. 11)";DRUGELIAI;6899629612;Ne;0;5;0;5
19661;"Dainorėliai (Ankštoji g. 11)";DRUGELIAI;2605119306;Ne;0;6;0;6
19662;"Dainorėliai (Ankštoji g. 11)";DRUGELIAI;9976869100;Ne;6;5;0;11
19663;"Dainorėliai (Ankštoji g. 11)";DRUGELIAI;3063825996;Ne;4;4;1;9
19664;"Dainorėliai (Ankštoji g. 11)";DRUGELIAI;5854379630;Ne;6;4;0;10
19665;"Dainorėliai (Ankštoji g. 11)";DRUGELIAI;3711954197;Ne;0;7;0;7
19666;"Dainorėliai (Ankštoji g. 11)";DRUGELIAI;3573324654;Ne;0;4;0;4
19667;"Dainorėliai (Ankštoji g. 11)";DRUGELIAI;8088948564;Ne;5;7;0;12
19668;"Dainorėliai (Ankštoji g. 11)";DRUGELIAI;2803571247;Ne;8;4;0;12
19669;"Dainorėliai (Ankštoji g. 11)";DRUGELIAI;5084474142;Ne;0;3;0;3
19670;"Dainorėliai (Ankštoji g. 11)";DRUGELIAI;1332165159;Ne;13;4;0;17
19671;"Dainorėliai (Ankštoji g. 11)";DRUGELIAI;8684975630;Ne;0;13;1;14
19672;"Dainorėliai (Ankštoji g. 11)";DRUGELIAI;2740773904;Ne;3;7;0;10
19673;"Dainorėliai (Ankštoji g. 11)";DRUGELIAI;9303046800;Ne;4;0;0;4
19674;"Dainorėliai (Ankštoji g. 11)";DRUGELIAI;9592384914;Ne;6;4;0;10
19675;"Dainorėliai (Ankštoji g. 11)";DRUGELIAI;3741337791;Ne;0;5;0;5
19676;"Dainorėliai (Ankštoji g. 11)";DRUGELIAI;7478484190;Ne;0;8;0;8
19677;"Dainorėliai (Ankštoji g. 11)";DRUGELIAI;7030974201;Ne;12;0;0;12
19678;"Dainorėliai (Ankštoji g. 11)";"1 klasė";88781762328;Ne;5;4;0;9
19679;"Dainorėliai (Ankštoji g. 11)";"1 klasė";5959380807;Ne;0;4;0;4
19680;"Dainorėliai (Ankštoji g. 11)";"1 klasė";7822546498;Ne;0;4;0;4
19681;"Dainorėliai (Ankštoji g. 11)";"1 klasė";4591161640;Ne;0;4;0;4
19682;"Dainorėliai (Ankštoji g. 11)";"1 klasė";9319771186;Ne;1;4;0;5
19683;"Dainorėliai (Ankštoji g. 11)";"1 klasė";6909583023;Ne;0;4;0;4
19684;"Dainorėliai (Ankštoji g. 11)";"1 klasė";9996171088;Ne;3;4;0;7
19685;"Dainorėliai (Ankštoji g. 11)";"1 klasė";6493730577;Ne;0;4;0;4
19686;"Dainorėliai (Ankštoji g. 11)";"1 klasė";7320625500;Ne;0;9;0;9
19687;"Dainorėliai (Ankštoji g. 11)";"1 klasė";7664689396;Ne;3;4;0;7
19688;"Dainorėliai (Ankštoji g. 11)";"1 klasė";2917508421;Ne;1;4;0;5
19689;"Dainorėliai (Ankštoji g. 11)";"1 klasė";2812688181;Ne;2;4;0;6
19690;"Dainorėliai (Ankštoji g. 11)";"1 klasė";18233813290;Ne;0;5;0;5
19691;"Dainorėliai (Ankštoji g. 11)";"1 klasė";2095914442;Ne;1;4;0;5
19692;"Dainorėliai (Ankštoji g. 11)";"1 klasė";4255893222;Ne;5;4;0;9
19693;"Dainorėliai (Ankštoji g. 11)";"1 klasė";1666616466;Ne;1;4;0;5
19694;"Dainorėliai (Ankštoji g. 11)";"1 klasė";1307749129;Ne;0;4;0;4
19695;"Dainorėliai (Ankštoji g. 11)";"1 klasė";1088248393;Ne;0;4;0;4
19696;"Dainorėliai (Ankštoji g. 11)";"1 klasė";2031800114;Ne;0;4;0;4
19697;"Dainorėliai (Ankštoji g. 11)";"1 klasė";43097490633;Ne;0;4;0;4
19698;"Dainorėliai (Ankštoji g. 11)";"1 klasė";65467351140;Ne;0;4;0;4
19699;"Dainorėliai (Ankštoji g. 11)";"1 klasė";87242570532;Ne;1;5;0;6
19700;"Dainorėliai (Ankštoji g. 11)";"1 klasė";5693385617;Ne;0;4;0;4
19701;"Dainorėliai (Ankštoji g. 11)";"1 klasė";9608529135;Ne;0;4;0;4
19702;"Dainorėliai (Ankštoji g. 11)";"1 klasė";68134437706;Ne;2;4;0;6
19703;"Dainorėliai (Ankštoji g. 11)";"1 klasė";3034686938;Ne;0;4;0;4
19704;"Dainorėliai (Ankštoji g. 11)";"2 klasė";2520667095;Ne;0;4;0;4
19705;"Dainorėliai (Ankštoji g. 11)";"2 klasė";1333499160;Ne;0;4;0;4
19706;"Dainorėliai (Ankštoji g. 11)";"2 klasė";50432354832;Ne;4;4;0;8
19707;"Dainorėliai (Ankštoji g. 11)";"2 klasė";1626877066;Ne;0;4;0;4
19708;"Dainorėliai (Ankštoji g. 11)";"2 klasė";1158895670;Ne;0;4;0;4
19709;"Dainorėliai (Ankštoji g. 11)";"2 klasė";73649870571;Ne;5;4;0;9
19710;"Dainorėliai (Ankštoji g. 11)";"2 klasė";1531362555;Ne;0;4;0;4
19711;"Dainorėliai (Ankštoji g. 11)";"2 klasė";19286303769;Ne;1;4;0;5
19712;"Dainorėliai (Ankštoji g. 11)";"2 klasė";73386013083;Ne;4;4;0;8
19713;"Dainorėliai (Ankštoji g. 11)";"2 klasė";27521381629;Ne;0;4;0;4
19714;"Dainorėliai (Ankštoji g. 11)";"2 klasė";53935690864;Ne;0;4;0;4
19715;"Dainorėliai (Ankštoji g. 11)";"2 klasė";2287353933;Ne;1;4;0;5
19716;"Dainorėliai (Ankštoji g. 11)";"2 klasė";1120848949;Ne;0;4;0;4
19717;"Dainorėliai (Ankštoji g. 11)";"2 klasė";36313982965;Ne;7;4;0;11
19718;"Dainorėliai (Ankštoji g. 11)";"2 klasė";86659723162;Ne;0;4;0;4
19719;"Dainorėliai (Ankštoji g. 11)";"2 klasė";6195426672;Ne;1;4;0;5
19720;"Dainorėliai (Ankštoji g. 11)";"2 klasė";5479496104;Ne;5;4;0;9
19721;"Dainorėliai (Ankštoji g. 11)";"2 klasė";94480397292;Ne;0;4;0;4
19722;"Dainorėliai (Ankštoji g. 11)";"2 klasė";6404337541;Ne;0;4;0;4
19723;"Dainorėliai (Ankštoji g. 11)";"2 klasė";49483881135;Ne;1;4;0;5
19724;"Dainorėliai (Ankštoji g. 11)";"2 klasė";86187568203;Ne;0;4;0;4
19725;"Dainorėliai (Ankštoji g. 11)";"2 klasė";1015870220;Ne;0;4;0;4
19726;"Dainorėliai (Ankštoji g. 11)";"2 klasė";1515552402;Ne;0;4;0;4
19727;"Dainorėliai (Ankštoji g. 11)";"2 klasė";7114409929;Ne;0;4;0;4
19728;"Dainorėliai (Ankštoji g. 11)";"2 klasė";1084400276;Ne;0;4;0;4
19729;"Dainorėliai (Ankštoji g. 11)";"2 klasė";1910653135;Ne;8;4;0;12
19730;"Dainorėliai (Ankštoji g. 11)";"3 klasė";67124516230;Ne;6;4;0;10
19731;"Dainorėliai (Ankštoji g. 11)";"3 klasė";7506194777;Ne;1;4;0;5
19732;"Dainorėliai (Ankštoji g. 11)";"3 klasė";1829858221;Ne;6;4;0;10
19733;"Dainorėliai (Ankštoji g. 11)";"3 klasė";1470784692;Ne;0;4;0;4
19734;"Dainorėliai (Ankštoji g. 11)";"3 klasė";7569146994;Ne;0;4;0;4
19735;"Dainorėliai (Ankštoji g. 11)";"3 klasė";45577031767;Ne;0;4;0;4
19736;"Dainorėliai (Ankštoji g. 11)";"3 klasė";1646521870;Ne;6;4;0;10
19737;"Dainorėliai (Ankštoji g. 11)";"3 klasė";29132059636;Ne;0;4;0;4
19738;"Dainorėliai (Ankštoji g. 11)";"3 klasė";32573583030;Ne;0;4;0;4
19739;"Dainorėliai (Ankštoji g. 11)";"3 klasė";97947842490;Ne;0;4;0;4
19740;"Dainorėliai (Ankštoji g. 11)";"3 klasė";63211091321;Ne;0;4;0;4
19741;"Dainorėliai (Ankštoji g. 11)";"3 klasė";87717571411;Ne;0;4;0;4
19742;"Dainorėliai (Ankštoji g. 11)";"3 klasė";18936645521;Ne;0;4;0;4
19743;"Dainorėliai (Ankštoji g. 11)";"3 klasė";80499999855;Ne;0;4;0;4
19744;"Dainorėliai (Ankštoji g. 11)";"3 klasė";6948863728;Ne;0;4;0;4
19745;"Dainorėliai (Ankštoji g. 11)";"3 klasė";2531690903;Ne;0;4;0;4
19746;"Dainorėliai (Ankštoji g. 11)";"3 klasė";35134511946;Ne;0;4;0;4
19747;"Dainorėliai (Ankštoji g. 11)";"3 klasė";1121139222;Ne;0;4;0;4
19748;"Dainorėliai (Ankštoji g. 11)";"3 klasė";99597416067;Ne;0;4;0;4
19749;"Dainorėliai (Ankštoji g. 11)";"3 klasė";77718940253;Ne;0;4;0;4
19750;"Dainorėliai (Ankštoji g. 11)";"3 klasė";5236797727;Ne;0;4;0;4
19751;"Dainorėliai (Ankštoji g. 11)";"3 klasė";33847164571;Ne;0;4;0;4
19752;"Dainorėliai (Ankštoji g. 11)";"4 klasė";49342277188;Ne;0;4;0;4
19753;"Dainorėliai (Ankštoji g. 11)";"4 klasė";42402953271;Ne;0;4;0;4
19754;"Dainorėliai (Ankštoji g. 11)";"4 klasė";34219208558;Ne;0;4;0;4
19755;"Dainorėliai (Ankštoji g. 11)";"4 klasė";2045625141;Ne;6;4;0;10
19756;"Dainorėliai (Ankštoji g. 11)";"4 klasė";2441164154;Ne;3;4;0;7
19757;"Dainorėliai (Ankštoji g. 11)";"4 klasė";69556449215;Ne;0;4;0;4
19758;"Dainorėliai (Ankštoji g. 11)";"4 klasė";8244355193;Ne;1;4;0;5
19759;"Dainorėliai (Ankštoji g. 11)";"4 klasė";98796240124;Ne;0;4;0;4
19760;"Dainorėliai (Ankštoji g. 11)";"4 klasė";2142553899;Ne;6;4;0;10
19761;"Dainorėliai (Ankštoji g. 11)";"4 klasė";37660372564;Ne;0;4;0;4
19762;"Dainorėliai (Ankštoji g. 11)";"4 klasė";13138644060;Ne;0;4;0;4
19763;"Dainorėliai (Ankštoji g. 11)";"4 klasė";84084897419;Ne;0;4;0;4
19764;"Dainorėliai (Ankštoji g. 11)";"4 klasė";98830139164;Ne;0;4;0;4
19765;"Dainorėliai (Ankštoji g. 11)";"4 klasė";37708779599;Ne;0;4;0;4
19766;"Dainorėliai (Ankštoji g. 11)";"4 klasė";18741625569;Ne;3;4;0;7
19767;"Dainorėliai (Ankštoji g. 11)";"4 klasė";84424772471;Ne;2;4;0;6
19768;"Dainorėliai (Ankštoji g. 11)";"4 klasė";34686211072;Ne;5;4;0;9
19769;"Dainorėliai (Ankštoji g. 11)";"4 klasė";79461209783;Ne;6;4;0;10
19770;"Dainorėliai (Ankštoji g. 11)";"4 klasė";47323045857;Ne;1;4;0;5
19771;"Dainorėliai (Ankštoji g. 11)";"4 klasė";10679627657;Ne;1;4;0;5
19772;"Dainorėliai (Ankštoji g. 11)";"4 klasė";25073134850;Ne;5;4;0;9
19773;"Dainorėliai (Ankštoji g. 11)";"4 klasė";65118883315;Ne;2;4;0;6
19774;"Dainorėliai (Ankštoji g. 11)";"4 klasė";84999972369;Ne;1;4;0;5
19775;"Dainorėliai (Ankštoji g. 11)";"4 klasė";1209781483;Ne;1;4;0;5
19776;"Dainorėliai (Ankštoji g. 11)";"4 klasė";69732047046;Ne;0;4;0;4
19777;"Dainorėliai (Ankštoji g. 11)";SAULUTĖS;9130473411;Ne;3;1;0;4
19778;"Dainorėliai (Ankštoji g. 11)";SAULUTĖS;8857018998;Ne;0;5;1;6
19779;"Dainorėliai (Ankštoji g. 11)";SAULUTĖS;4612995336;Ne;0;5;0;5
19780;"Dainorėliai (Ankštoji g. 11)";SAULUTĖS;6704354150;Ne;0;4;0;4
19781;"Dainorėliai (Ankštoji g. 11)";SAULUTĖS;5632663846;Ne;0;4;0;4
19782;"Dainorėliai (Ankštoji g. 11)";SAULUTĖS;1547686786;Ne;0;1;0;1
19783;"Dainorėliai (Ankštoji g. 11)";SAULUTĖS;6385439136;Ne;0;5;0;5
19784;"Dainorėliai (Ankštoji g. 11)";SAULUTĖS;1552829080;Ne;0;5;0;5
19785;"Dainorėliai (Ankštoji g. 11)";SAULUTĖS;5410183494;Ne;0;4;1;5
19786;"Dainorėliai (Ankštoji g. 11)";SAULUTĖS;5587907483;Ne;0;5;1;6
19787;"Dainorėliai (Ankštoji g. 11)";SAULUTĖS;2064843848;Ne;0;6;3;9
19788;"Dainorėliai (Ankštoji g. 11)";SAULUTĖS;5687390372;Ne;0;3;0;3
19789;"Dainorėliai (Ankštoji g. 11)";SAULUTĖS;7804441689;Ne;0;4;0;4
19790;"Dainorėliai (Ankštoji g. 11)";SAULUTĖS;6090746954;Ne;0;6;3;9
19791;"Dainorėliai (Ankštoji g. 11)";SAULUTĖS;4431804759;Ne;0;4;0;4
19792;"Dainorėliai (Ankštoji g. 11)";SAULUTĖS;6697149560;Ne;8;4;2;14
19793;"Dainorėliai (Ankštoji g. 11)";SAULUTĖS;3762178533;Ne;0;3;0;3
19794;"Dainorėliai (Ankštoji g. 11)";SAULUTĖS;8857018998;Ne;0;5;1;6
19795;"Dainorėliai (Ankštoji g. 11)";SAULUTĖS;1547686786;Ne;0;1;0;1
19796;"Dainorėliai (Ankštoji g. 11)";SAULUTĖS;6697149560;Ne;8;4;2;14
19797;"Dainorėliai (Ankštoji g. 11)";SAULUTĖS;4798415786;Ne;0;3;0;3
19798;"Dainorėliai (Ankštoji g. 11)";SAULUTĖS;4079711515;Ne;0;4;0;4
19799;"Dainorėliai (Ankštoji g. 11)";SAULUTĖS;4798415786;Ne;0;3;0;3
19800;"Dainorėliai (Ankštoji g. 11)";SAULUTĖS;4798415786;Ne;0;3;0;3
19801;"Dainorėliai (Ankštoji g. 11)";SAULUTĖS;4969782237;Ne;0;4;0;4
19802;Lokiukas;BITUTĖS;9834746275;Ne;0;2;0;2
19803;Lokiukas;BITUTĖS;3397999534;Ne;0;5;0;5
19804;Lokiukas;BITUTĖS;2126391728;Ne;1;0;0;1
19805;Lokiukas;BITUTĖS;4551069961;Ne;5;4;0;9
19806;Lokiukas;BITUTĖS;8059759103;Ne;4;2;0;6
19807;Lokiukas;BITUTĖS;5217458476;Ne;8;4;0;12
19808;Lokiukas;BITUTĖS;6260486656;Ne;2;8;0;10
19809;Lokiukas;BITUTĖS;9480025132;Ne;2;4;0;6
19810;Lokiukas;BITUTĖS;8334800302;Ne;0;3;0;3
19811;Lokiukas;BITUTĖS;6883994020;Ne;2;4;0;6
19812;Lokiukas;BITUTĖS;1987485885;Ne;0;6;0;6
19813;Lokiukas;BITUTĖS;5794303981;Ne;0;6;0;6
19814;Lokiukas;BITUTĖS;2671053309;Taip;2;3;0;5
19815;Lokiukas;BITUTĖS;1647778939;Ne;2;1;0;3
19816;Lokiukas;BITUTĖS;8994257898;Ne;9;4;0;13
19817;Lokiukas;BITUTĖS;8378138411;Ne;4;4;0;8
19818;Lokiukas;BITUTĖS;8656751314;Ne;10;4;0;14
19819;Lokiukas;BITUTĖS;3896883842;Ne;0;7;0;7
19820;Lokiukas;BITUTĖS;1376124245;Ne;0;19;0;19
19821;Lokiukas;BITUTĖS;7920238202;Ne;0;4;0;4
19822;Lokiukas;BITUTĖS;3329205450;Ne;8;5;0;13
19823;Lokiukas;BITUTĖS;2051644210;Ne;0;1;0;1
19824;Lokiukas;BITUTĖS;6612382588;Ne;0;5;0;5
19825;Lokiukas;"1 B klasė";1210407640;Ne;5;4;0;9
19826;Lokiukas;"1 B klasė";1733486244;Ne;5;4;0;9
19827;Lokiukas;"1 B klasė";6336140882;Ne;6;4;0;10
19828;Lokiukas;"1 B klasė";3485639108;Ne;0;4;0;4
19829;Lokiukas;"1 B klasė";1606617694;Ne;2;4;0;6
19830;Lokiukas;"1 B klasė";8243342948;Ne;1;4;0;5
19831;Lokiukas;"1 B klasė";3991821717;Ne;2;4;0;6
19832;Lokiukas;"1 B klasė";4633366779;Ne;19;0;0;19
19833;Lokiukas;"1 B klasė";1188049956;Ne;2;4;0;6
19834;Lokiukas;"1 B klasė";5446430319;Ne;5;4;0;9
19835;Lokiukas;"1 B klasė";2354942164;Ne;1;4;0;5
19836;Lokiukas;"1 B klasė";35364823312;Ne;0;4;0;4
19837;Lokiukas;"1 B klasė";8687864179;Ne;0;4;0;4
19838;Lokiukas;"1 B klasė";5076773045;Ne;3;4;0;7
19839;Lokiukas;"1 B klasė";1620856143;Ne;3;4;0;7
19840;Lokiukas;"1 B klasė";1604886863;Ne;1;4;0;5
19841;Lokiukas;"1 B klasė";54341630847;Ne;1;4;0;5
19842;Lokiukas;"1 B klasė";8320696048;Ne;4;4;0;8
19843;Lokiukas;"1 B klasė";2701448160;Ne;0;4;0;4
19844;Lokiukas;"1 B klasė";4024866819;Ne;2;4;0;6
19845;Lokiukas;"1 B klasė";2753402906;Ne;1;4;0;5
19846;Lokiukas;"1 B klasė";5275588088;Ne;7;4;0;11
19847;Lokiukas;"1 B klasė";67972824332;Ne;1;4;0;5
19848;Lokiukas;"1 B klasė";9053427316;Ne;1;4;0;5
19849;Lokiukas;"1 B klasė";8189217660;Ne;0;4;0;4
19850;Lokiukas;"1 B klasė";3423529085;Ne;1;4;0;5
19851;Lokiukas;"1 A klasė";2642065594;Ne;1;4;0;5
19852;Lokiukas;"1 A klasė";1025576053;Ne;0;4;0;4
19853;Lokiukas;"1 A klasė";6069516217;Ne;0;4;0;4
19854;Lokiukas;"1 A klasė";34546519642;Ne;0;4;0;4
19855;Lokiukas;"1 A klasė";1752784666;Ne;8;4;0;12
19856;Lokiukas;"1 A klasė";7943213321;Ne;0;4;0;4
19857;Lokiukas;"1 A klasė";8915504279;Ne;6;4;0;10
19858;Lokiukas;"1 A klasė";8796640190;Ne;0;4;0;4
19859;Lokiukas;"1 A klasė";5943412920;Ne;0;4;0;4
19860;Lokiukas;"1 A klasė";3694653020;Ne;3;4;0;7
19861;Lokiukas;"1 A klasė";8902619265;Ne;0;4;0;4
19862;Lokiukas;"1 A klasė";1040288021;Ne;1;4;0;5
19863;Lokiukas;"1 A klasė";8286358519;Ne;1;4;0;5
19864;Lokiukas;"1 A klasė";3744484616;Ne;1;4;0;5
19865;Lokiukas;"1 A klasė";6758550653;Ne;5;4;0;9
19866;Lokiukas;"1 A klasė";5467387832;Ne;0;4;0;4
19867;Lokiukas;"1 A klasė";9336617879;Ne;2;4;0;6
19868;Lokiukas;"1 A klasė";1886540733;Ne;1;4;0;5
19869;Lokiukas;"1 A klasė";7936978436;Ne;0;4;0;4
19870;Lokiukas;"1 A klasė";3843999609;Ne;9;0;0;9
19871;Lokiukas;"1 A klasė";1898004894;Ne;1;4;0;5
19872;Lokiukas;"1 A klasė";2397366916;Ne;1;4;0;5
19873;Lokiukas;"1 A klasė";4985243068;Ne;2;4;0;6
19874;Lokiukas;"1 A klasė";7623203279;Ne;0;4;0;4
19875;Lokiukas;"1 A klasė";7623203279;Ne;0;4;0;4
19876;Lokiukas;GUDRUČIAI;3930463578;Ne;5;6;0;11
19877;Lokiukas;GUDRUČIAI;6277388612;Ne;0;5;0;5
19878;Lokiukas;GUDRUČIAI;4919744559;Ne;0;8;0;8
19879;Lokiukas;GUDRUČIAI;1974049743;Ne;2;9;0;11
19880;Lokiukas;GUDRUČIAI;9354491312;Ne;7;6;0;13
19881;Lokiukas;GUDRUČIAI;3826815202;Ne;2;6;0;8
19882;Lokiukas;GUDRUČIAI;7208757038;Ne;5;6;0;11
19883;Lokiukas;GUDRUČIAI;4660479216;Ne;0;6;0;6
19884;Lokiukas;GUDRUČIAI;1049009199;Ne;0;9;0;9
19885;Lokiukas;GUDRUČIAI;1586414960;Ne;0;2;0;2
19886;Lokiukas;GUDRUČIAI;7904803011;Ne;0;9;0;9
19887;Lokiukas;GUDRUČIAI;8440973450;Ne;0;11;0;11
19888;Lokiukas;GUDRUČIAI;8481539433;Ne;1;6;0;7
19889;Lokiukas;GUDRUČIAI;3411390558;Ne;0;6;0;6
19890;Lokiukas;GUDRUČIAI;2185853339;Ne;0;6;0;6
19891;Lokiukas;GUDRUČIAI;5131051261;Ne;1;6;0;7
19892;Lokiukas;GUDRUČIAI;3832151457;Ne;1;13;0;14
19893;Lokiukas;BORUŽĖLĖS;5473316050;Ne;3;4;0;7
19894;Lokiukas;BORUŽĖLĖS;2266747745;Ne;11;4;0;15
19895;Lokiukas;BORUŽĖLĖS;8758248334;Ne;11;4;0;15
19896;Lokiukas;BORUŽĖLĖS;5893844708;Ne;6;4;0;10
19897;Lokiukas;BORUŽĖLĖS;3015119335;Ne;4;4;0;8
19898;Lokiukas;BORUŽĖLĖS;7509043689;Ne;9;4;0;13
19899;Lokiukas;BORUŽĖLĖS;1756658146;Ne;4;2;0;6
19900;Lokiukas;BORUŽĖLĖS;4417116107;Ne;4;1;0;5
19901;Lokiukas;BORUŽĖLĖS;3849212461;Ne;11;4;0;15
19902;Lokiukas;BORUŽĖLĖS;3668903653;Ne;1;2;0;3
19903;Lokiukas;BORUŽĖLĖS;2466354050;Ne;7;4;0;11
19904;Lokiukas;BORUŽĖLĖS;6827710384;Ne;6;4;0;10
19905;Lokiukas;BORUŽĖLĖS;5843699073;Ne;11;4;0;15
19906;Lokiukas;BORUŽĖLĖS;7955048052;Ne;10;4;0;14
19907;Lokiukas;BORUŽĖLĖS;8144936688;Ne;9;4;0;13
19908;Lokiukas;BORUŽĖLĖS;2999594131;Ne;3;4;0;7
19909;Lokiukas;BORUŽĖLĖS;8420913680;Taip;10;4;0;14
19910;Lokiukas;BORUŽĖLĖS;8139809541;Ne;10;4;0;14
19911;Lokiukas;BORUŽĖLĖS;2754009962;Ne;2;1;0;3
19912;Lokiukas;BORUŽĖLĖS;5673557301;Ne;0;4;0;4
19913;Lokiukas;BORUŽĖLĖS;3383354228;Ne;15;4;0;19
19914;Lokiukas;ANČIUKAI;5944620142;Ne;3;3;0;6
19915;Lokiukas;ANČIUKAI;9253014845;Ne;0;6;0;6
19916;Lokiukas;ANČIUKAI;2323620627;Ne;0;6;0;6
19917;Lokiukas;ANČIUKAI;3452792650;Ne;5;4;0;9
19918;Lokiukas;ANČIUKAI;7147146400;Ne;3;2;0;5
19919;Lokiukas;ANČIUKAI;8311551538;Ne;0;4;0;4
19920;Lokiukas;ANČIUKAI;5837961451;Ne;0;4;0;4
19921;Lokiukas;ANČIUKAI;7991284293;Ne;0;19;0;19
19922;Lokiukas;ANČIUKAI;5503888257;Ne;0;2;0;2
19923;Lokiukas;ANČIUKAI;7195614260;Ne;0;4;0;4
19924;Lokiukas;ANČIUKAI;1243077419;Ne;0;19;0;19
19925;Lokiukas;ANČIUKAI;1027917827;Ne;0;10;0;10
19926;Lokiukas;ANČIUKAI;1741109639;Ne;0;19;0;19
19927;Lokiukas;ANČIUKAI;6944809045;Ne;0;3;0;3
19928;Lokiukas;ANČIUKAI;5785049399;Ne;0;4;0;4
19929;Lokiukas;KODĖLČIUKAI;8630112458;Ne;0;4;0;4
19930;Lokiukas;KODĖLČIUKAI;4585621105;Ne;5;3;0;8
19931;Lokiukas;KODĖLČIUKAI;8576418875;Ne;1;10;0;11
19932;Lokiukas;KODĖLČIUKAI;6869785650;Ne;0;7;0;7
19933;Lokiukas;KODĖLČIUKAI;4849031542;Ne;0;5;0;5
19934;Lokiukas;KODĖLČIUKAI;2625981190;Ne;3;4;0;7
19935;Lokiukas;KODĖLČIUKAI;4617372387;Ne;3;5;0;8
19936;Lokiukas;KODĖLČIUKAI;5401463671;Ne;2;1;0;3
19937;Lokiukas;KODĖLČIUKAI;9798351980;Ne;0;3;0;3
19938;Lokiukas;KODĖLČIUKAI;1170293017;Ne;3;6;0;9
19939;Lokiukas;KODĖLČIUKAI;9996442005;Ne;2;1;0;3
19940;Lokiukas;KODĖLČIUKAI;4317453894;Ne;0;4;0;4
19941;Lokiukas;KODĖLČIUKAI;3876368364;Ne;2;4;0;6
19942;Lokiukas;KODĖLČIUKAI;7426579018;Ne;3;4;0;7
19943;Lokiukas;KODĖLČIUKAI;1724976098;Ne;5;5;0;10
19944;Lokiukas;KODĖLČIUKAI;3733581089;Ne;0;4;0;4
19945;Lokiukas;KODĖLČIUKAI;1076719080;Ne;6;6;0;12
19946;Lokiukas;KODĖLČIUKAI;6102196040;Ne;0;4;0;4
19947;Lokiukas;KODĖLČIUKAI;9779789133;Ne;0;4;0;4
19948;Lokiukas;KODĖLČIUKAI;9266061396;Ne;0;1;0;1
19949;Lokiukas;KODĖLČIUKAI;6987657237;Ne;0;1;0;1
19950;Lokiukas;KODĖLČIUKAI;5353687011;Ne;0;5;0;5
19951;Lokiukas;DRUGELIAI;4858829710;Ne;0;1;4;5
19952;Lokiukas;DRUGELIAI;4206181176;Ne;2;4;0;6
19953;Lokiukas;DRUGELIAI;8329540746;Ne;0;2;0;2
19954;Lokiukas;DRUGELIAI;4442073527;Ne;0;2;0;2
19955;Lokiukas;DRUGELIAI;7532603655;Ne;0;4;0;4
19956;Lokiukas;DRUGELIAI;7006828256;Ne;0;2;0;2
19957;Lokiukas;DRUGELIAI;8596706753;Ne;0;4;3;7
19958;Lokiukas;DRUGELIAI;4197547631;Ne;10;2;0;12
19959;Lokiukas;DRUGELIAI;8266708371;Ne;0;3;0;3
19960;Lokiukas;DRUGELIAI;6226281752;Ne;0;1;0;1
19961;Lokiukas;DRUGELIAI;7195184433;Ne;0;2;0;2
19962;Lokiukas;DRUGELIAI;2374601283;Ne;0;4;0;4
19963;Lokiukas;DRUGELIAI;1390586527;Ne;7;3;0;10
19964;Lokiukas;DRUGELIAI;2093224908;Ne;0;4;0;4
19965;Lokiukas;DRUGELIAI;1341265560;Ne;0;6;0;6
19966;Lokiukas;DRUGELIAI;5131662172;Ne;0;4;1;5
19967;Lokiukas;DRUGELIAI;4284574166;Ne;0;4;3;7
19968;Lokiukas;DRUGELIAI;1913742619;Ne;2;5;0;7
19969;Lokiukas;DRUGELIAI;4521556853;Ne;6;3;0;9
19970;Lokiukas;DRUGELIAI;5092095494;Ne;0;14;1;15
19971;Lokiukas;"2 A klasė";1626698185;Ne;0;4;0;4
19972;Lokiukas;"2 A klasė";39222094073;Ne;0;4;0;4
19973;Lokiukas;"2 A klasė";69364831994;Ne;3;4;0;7
19974;Lokiukas;"2 A klasė";74169282323;Ne;1;4;0;5
19975;Lokiukas;"2 A klasė";1625137322;Ne;1;4;0;5
19976;Lokiukas;"2 A klasė";8452600632;Ne;5;4;0;9
19977;Lokiukas;"2 A klasė";35890122494;Ne;0;4;0;4
19978;Lokiukas;"2 A klasė";8270572748;Ne;1;4;0;5
19979;Lokiukas;"2 A klasė";2170176922;Ne;1;4;0;5
19980;Lokiukas;"2 A klasė";8455869600;Ne;0;4;0;4
19981;Lokiukas;"2 A klasė";34800098950;Ne;0;4;0;4
19982;Lokiukas;"2 A klasė";3825101647;Ne;19;0;0;19
19983;Lokiukas;"2 A klasė";8618280811;Ne;19;0;0;19
19984;Lokiukas;"2 A klasė";8323172347;Ne;2;4;0;6
19985;Lokiukas;"2 A klasė";7844351275;Ne;1;4;0;5
19986;Lokiukas;"2 A klasė";2045735700;Ne;0;4;0;4
19987;Lokiukas;"2 A klasė";3981653153;Ne;0;4;0;4
19988;Lokiukas;"2 A klasė";6318538591;Ne;5;4;0;9
19989;Lokiukas;"2 A klasė";43500434912;Ne;1;4;0;5
19990;Lokiukas;"2 A klasė";25141529581;Ne;0;4;0;4
19991;Lokiukas;"2 A klasė";3369746590;Ne;0;4;0;4
19992;Lokiukas;"2 A klasė";3004895246;Ne;15;4;0;19
19993;Lokiukas;"2 A klasė";3061816821;Ne;3;4;0;7
19994;Lokiukas;"2 A klasė";56069293343;Ne;0;4;0;4
19995;Lokiukas;"2 A klasė";4677444685;Ne;1;4;0;5
19996;Lokiukas;"2 B klasė";14605095801;Ne;2;4;0;6
19997;Lokiukas;"2 B klasė";39975872119;Ne;0;4;0;4
19998;Lokiukas;"2 B klasė";8568285232;Ne;2;4;0;6
19999;Lokiukas;"2 B klasė";5453470660;Ne;1;4;0;5
20000;Lokiukas;"2 B klasė";5879386524;Ne;0;4;0;4
20001;Lokiukas;"2 B klasė";7591418969;Ne;0;4;0;4
20002;Lokiukas;"2 B klasė";8036643654;Ne;0;4;0;4
20003;Lokiukas;"2 B klasė";2548712970;Ne;0;4;0;4
20004;Lokiukas;"2 B klasė";4427448272;Ne;19;0;0;19
20005;Lokiukas;"2 B klasė";4580716838;Ne;1;4;0;5
20006;Lokiukas;"2 B klasė";2673522432;Ne;19;0;0;19
20007;Lokiukas;"2 B klasė";8399364170;Ne;0;4;0;4
20008;Lokiukas;"2 B klasė";9625041533;Ne;0;4;0;4
20009;Lokiukas;"2 B klasė";2476231041;Ne;2;4;0;6
20010;Lokiukas;"2 B klasė";5943583254;Ne;0;4;0;4
20011;Lokiukas;"2 B klasė";5437008837;Ne;1;4;0;5
20012;Lokiukas;"2 B klasė";4569798381;Ne;8;4;0;12
20013;Lokiukas;"2 B klasė";97284171512;Ne;1;4;0;5
20014;Lokiukas;"2 B klasė";3070998871;Ne;3;4;0;7
20015;Lokiukas;"2 B klasė";9501202273;Ne;5;4;0;9
20016;Lokiukas;"2 B klasė";20659573470;Ne;19;0;0;19
20017;Lokiukas;"2 B klasė";8943496964;Ne;19;0;0;19
20018;Lokiukas;"2 B klasė";3505492809;Ne;0;4;0;4
20019;Lokiukas;"3 A klasė";83086633109;Ne;4;4;0;8
20020;Lokiukas;"3 A klasė";131300206;Ne;1;4;0;5
20021;Lokiukas;"3 A klasė";82025637099;Ne;2;4;0;6
20022;Lokiukas;"3 A klasė";73515179103;Ne;2;4;0;6
20023;Lokiukas;"3 A klasė";73696992182;Ne;0;4;0;4
20024;Lokiukas;"3 A klasė";8240261104;Ne;1;4;0;5
20025;Lokiukas;"3 A klasė";83528495608;Ne;0;4;0;4
20026;Lokiukas;"3 A klasė";8846527481;Ne;2;4;0;6
20027;Lokiukas;"3 A klasė";67133709394;Ne;0;4;0;4
20028;Lokiukas;"3 A klasė";66528256040;Ne;7;4;0;11
20029;Lokiukas;"3 A klasė";36677665098;Ne;0;4;0;4
20030;Lokiukas;"3 A klasė";1056075876;Ne;11;4;0;15
20031;Lokiukas;"3 A klasė";52940830874;Ne;1;4;0;5
20032;Lokiukas;"3 A klasė";1201125655;Ne;0;4;0;4
20033;Lokiukas;"3 A klasė";38884246104;Ne;3;4;0;7
20034;Lokiukas;"3 A klasė";2502465398;Ne;0;4;0;4
20035;Lokiukas;"3 A klasė";9890308887;Ne;4;4;0;8
20036;Lokiukas;"3 A klasė";77512682081;Ne;0;4;0;4
20037;Lokiukas;"3 A klasė";86120193313;Ne;0;4;0;4
20038;Lokiukas;"3 A klasė";45028887854;Ne;0;4;0;4
20039;Lokiukas;"3 A klasė";51237034253;Ne;0;4;0;4
20040;Lokiukas;"3 A klasė";27403835292;Ne;3;4;0;7
20041;Lokiukas;"3 A klasė";4989577303;Ne;12;0;0;12
20042;Lokiukas;"3 A klasė";1106442860;Ne;1;4;0;5
20043;Lokiukas;"3 A klasė";1224477393;Ne;1;4;0;5
20044;Lokiukas;"3 B klasė";61807094999;Ne;0;4;0;4
20045;Lokiukas;"3 B klasė";51059574159;Ne;10;0;0;10
20046;Lokiukas;"3 B klasė";32714964224;Ne;6;4;0;10
20047;Lokiukas;"3 B klasė";8920359311;Ne;4;4;0;8
20048;Lokiukas;"3 B klasė";2959877846;Ne;19;0;0;19
20049;Lokiukas;"3 B klasė";57505829630;Ne;3;4;0;7
20050;Lokiukas;"3 B klasė";1072148409;Ne;1;4;0;5
20051;Lokiukas;"3 B klasė";7130407913;Ne;1;4;0;5
20052;Lokiukas;"3 B klasė";7235277422;Ne;2;4;0;6
20053;Lokiukas;"3 B klasė";1133294157;Ne;0;4;0;4
20054;Lokiukas;"3 B klasė";7334971595;Ne;0;4;0;4
20055;Lokiukas;"3 B klasė";92373834478;Ne;1;4;0;5
20056;Lokiukas;"3 B klasė";2054450461;Ne;0;4;0;4
20057;Lokiukas;"3 B klasė";14234831040;Ne;1;4;0;5
20058;Lokiukas;"3 B klasė";4662981914;Ne;2;4;0;6
20059;Lokiukas;"3 B klasė";6414861823;Ne;19;0;0;19
20060;Lokiukas;"3 B klasė";98045145204;Ne;19;0;0;19
20061;Lokiukas;"3 B klasė";68390568000;Ne;0;4;0;4
20062;Lokiukas;"3 B klasė";14937983736;Ne;4;4;0;8
20063;Lokiukas;"3 B klasė";8996622650;Ne;0;4;0;4
20064;Lokiukas;"3 B klasė";2078673522;Ne;1;4;0;5
20065;Lokiukas;"3 B klasė";40006848965;Ne;2;4;0;6
20066;Lokiukas;"3 B klasė";3255141230;Ne;19;0;0;19
20067;Lokiukas;"3 B klasė";3255141230;Ne;19;0;0;19
20068;Lokiukas;"3 B klasė";38001876942;Ne;2;4;0;6
20069;Lokiukas;"4 A klasė";15406362908;Ne;2;4;0;6
20070;Lokiukas;"4 A klasė";45122233067;Ne;0;4;0;4
20071;Lokiukas;"4 A klasė";10948160841;Ne;19;0;0;19
20072;Lokiukas;"4 A klasė";21802863853;Ne;1;4;0;5
20073;Lokiukas;"4 A klasė";22979689191;Ne;4;4;0;8
20074;Lokiukas;"4 A klasė";80754592972;Ne;1;4;0;5
20075;Lokiukas;"4 A klasė";14903100496;Ne;0;4;0;4
20076;Lokiukas;"4 A klasė";4608275224;Ne;1;4;0;5
20077;Lokiukas;"4 A klasė";99706061553;Ne;3;4;0;7
20078;Lokiukas;"4 A klasė";7785940412;Ne;1;4;0;5
20079;Lokiukas;"4 A klasė";72092394330;Ne;0;4;0;4
20080;Lokiukas;"4 A klasė";35769782473;Ne;19;0;0;19
20081;Lokiukas;"4 A klasė";38531751377;Ne;0;4;0;4
20082;Lokiukas;"4 A klasė";59840033826;Ne;0;4;0;4
20083;Lokiukas;"4 A klasė";80793623068;Ne;7;4;0;11
20084;Lokiukas;"4 A klasė";43070670534;Ne;0;4;0;4
20085;Lokiukas;"4 A klasė";5198408183;Ne;3;4;0;7
20086;Lokiukas;"4 A klasė";24099693663;Ne;19;0;0;19
20087;Lokiukas;"4 A klasė";9747265775;Ne;19;0;0;19
20088;Lokiukas;"4 A klasė";93374754851;Ne;2;4;0;6
20089;Lokiukas;"4 A klasė";25170045140;Ne;19;0;0;19
20090;Lokiukas;"4 A klasė";84273668685;Ne;2;4;0;6
20091;Lokiukas;"4 A klasė";15685936471;Ne;0;4;0;4
20092;Lokiukas;"4 A klasė";97609897018;Ne;1;4;0;5
20093;Lokiukas;"4 A klasė";23688235312;Ne;0;4;0;4
20094;Lokiukas;"4 A klasė";15574258138;Ne;0;4;0;4
20095;Lokiukas;"4 A klasė";9077016953;Ne;0;4;0;4
20096;Lokiukas;"4 A klasė";24523198513;Ne;19;0;0;19
20097;Lokiukas;"4 A klasė";29577495646;Ne;1;4;0;5
20098;Lokiukas;"4 B klasė";32506466236;Ne;3;4;0;7
20099;Lokiukas;"4 B klasė";7324496782;Ne;2;4;0;6
20100;Lokiukas;"4 B klasė";10811780420;Ne;3;4;0;7
20101;Lokiukas;"4 B klasė";28796727185;Ne;19;0;0;19
20102;Lokiukas;"4 B klasė";88415635113;Ne;18;0;0;18
20103;Lokiukas;"4 B klasė";95910336503;Ne;3;4;0;7
20104;Lokiukas;"4 B klasė";7903535850;Ne;3;4;0;7
20105;Lokiukas;"4 B klasė";7497324442;Ne;19;0;0;19
20106;Lokiukas;"4 B klasė";96046361641;Ne;3;4;0;7
20107;Lokiukas;"4 B klasė";18646642032;Ne;1;4;0;5
20108;Lokiukas;"4 B klasė";79109699217;Ne;4;4;0;8
20109;Lokiukas;"4 B klasė";61890775725;Ne;12;4;0;16
20110;Lokiukas;"4 B klasė";24221829774;Ne;2;4;0;6
20111;Lokiukas;"4 B klasė";58513885211;Ne;3;4;0;7
20112;Lokiukas;"4 B klasė";50713289266;Ne;1;4;0;5
20113;Lokiukas;"4 B klasė";20231469825;Ne;5;4;0;9
20114;Lokiukas;"4 B klasė";1146878499;Ne;9;4;0;13
20115;Lokiukas;"4 B klasė";46587243900;Ne;2;4;0;6
20116;Lokiukas;"4 B klasė";9141446821;Ne;2;4;0;6
20117;Lokiukas;"4 B klasė";75507005694;Ne;1;4;0;5
20118;Lokiukas;"4 B klasė";73426072972;Ne;11;4;0;15
20119;Lokiukas;"4 B klasė";59913848400;Ne;6;4;0;10
20120;Lokiukas;"4 B klasė";62268017779;Ne;2;4;0;6
20121;Lokiukas;"4 B klasė";2105377652;Ne;2;4;0;6
20122;Lokiukas;"4 B klasė";39867459515;Ne;11;4;0;15
20123;Lokiukas;"4 B klasė";5311341721;Ne;19;0;0;19
20124;Lokiukas;"4 B klasė";9516336072;Ne;1;4;0;5
20125;Šaltinėlis;Ančiukų;3901200729;Ne;4;3;0;7
20126;Šaltinėlis;Ančiukų;1312785137;Ne;3;6;0;9
20127;Šaltinėlis;Ančiukų;9209105445;Ne;14;1;0;15
20128;Šaltinėlis;Ančiukų;9112527921;Ne;0;7;0;7
20129;Šaltinėlis;Ančiukų;9398488555;Ne;0;4;0;4
20130;Šaltinėlis;Ančiukų;2027779524;Ne;5;5;0;10
20131;Šaltinėlis;Ančiukų;5498764523;Ne;2;4;0;6
20132;Šaltinėlis;Ančiukų;4226929875;Ne;5;4;0;9
20133;Šaltinėlis;Ančiukų;1489377928;Ne;3;4;0;7
20134;Šaltinėlis;Ančiukų;5005394548;Ne;0;10;0;10
20135;Šaltinėlis;Ančiukų;1102861619;Taip;0;5;0;5
20136;Šaltinėlis;Ančiukų;1928794692;Ne;11;4;0;15
20137;Šaltinėlis;Ančiukų;1742421427;Ne;4;4;0;8
20138;Šaltinėlis;Ančiukų;9581384663;Ne;3;4;0;7
20139;Šaltinėlis;Ančiukų;9465174636;Ne;3;4;0;7
20140;Šaltinėlis;Ančiukų;8034195267;Ne;0;6;0;6
20141;Šaltinėlis;Ančiukų;5455997139;Ne;5;4;0;9
20142;Šaltinėlis;Ančiukų;9588260206;Ne;19;0;0;19
20143;Šaltinėlis;Ančiukų;8116985061;Ne;0;19;0;19
20144;Šaltinėlis;Ančiukų;6371994202;Ne;5;5;0;10
20145;Šaltinėlis;Ančiukų;6244924079;Ne;4;4;0;8
20146;Šaltinėlis;Ančiukų;3806267811;Ne;9;4;0;13
20147;Šaltinėlis;Bitučių;7311831014;Ne;0;5;0;5
20148;Šaltinėlis;Bitučių;5854723120;Ne;0;8;0;8
20149;Šaltinėlis;Bitučių;1678450741;Ne;0;6;0;6
20150;Šaltinėlis;Bitučių;5833136956;Ne;0;2;0;2
20151;Šaltinėlis;Bitučių;3483756240;Ne;0;6;0;6
20152;Šaltinėlis;Bitučių;6380346298;Ne;0;4;0;4
20153;Šaltinėlis;Bitučių;5799032398;Ne;10;4;0;14
20154;Šaltinėlis;Bitučių;5525740049;Ne;0;9;0;9
20155;Šaltinėlis;Bitučių;5343279219;Ne;5;5;0;10
20156;Šaltinėlis;Bitučių;3507180650;Ne;3;3;0;6
20157;Šaltinėlis;Bitučių;7118672118;Ne;0;4;0;4
20158;Šaltinėlis;Bitučių;8950694484;Ne;3;4;0;7
20159;Šaltinėlis;Bitučių;2465009553;Ne;4;4;0;8
20160;Šaltinėlis;Bitučių;5382567842;Ne;0;4;0;4
20161;Šaltinėlis;Bitučių;4681460322;Ne;11;4;0;15
20162;Šaltinėlis;Bitučių;3968514430;Ne;0;5;0;5
20163;Šaltinėlis;Bitučių;6721510313;Ne;0;4;0;4
20164;Šaltinėlis;Bitučių;1978469605;Ne;0;6;0;6
20165;Šaltinėlis;Bitučių;5774391181;Ne;6;4;0;10
20166;Šaltinėlis;Bitučių;2499890317;Ne;1;4;0;5
20167;Šaltinėlis;Bitučių;7650840990;Ne;1;4;0;5
20168;Šaltinėlis;Bitučių;5345738219;Ne;6;4;0;10
20169;Šaltinėlis;Bitučių;3579974049;Ne;0;8;0;8
20170;Šaltinėlis;Bitučių;4743907195;Ne;0;8;0;8
20171;Šaltinėlis;Bitučių;1287205292;Ne;4;4;0;8
20172;Šaltinėlis;Bitučių;7973137015;Ne;9;4;0;13
20173;Šaltinėlis;Bitučių;7519967594;Ne;8;4;0;12
20174;Šaltinėlis;Bitučių;3017437426;Ne;0;6;0;6
20175;Šaltinėlis;Bitučių;9983153464;Ne;0;9;0;9
20176;Šaltinėlis;Saulutės;3159555258;Ne;10;4;0;14
20177;Šaltinėlis;Saulutės;9753396159;Ne;0;5;0;5
20178;Šaltinėlis;Saulutės;8258039377;Ne;5;4;0;9
20179;Šaltinėlis;Saulutės;2550355455;Ne;0;6;0;6
20180;Šaltinėlis;Saulutės;5871681602;Ne;11;0;0;11
20181;Šaltinėlis;Saulutės;3448242910;Ne;0;10;0;10
20182;Šaltinėlis;Saulutės;8147526528;Ne;4;5;0;9
20183;Šaltinėlis;Saulutės;6109197821;Ne;3;2;0;5
20184;Šaltinėlis;Saulutės;8439306703;Ne;3;3;0;6
20185;Šaltinėlis;Saulutės;3505001330;Ne;11;0;0;11
20186;Šaltinėlis;Saulutės;8973369897;Ne;5;2;0;7
20187;Šaltinėlis;Saulutės;6145605567;Ne;0;10;0;10
20188;Šaltinėlis;Saulutės;3780870805;Ne;11;0;0;11
20189;Šaltinėlis;Saulutės;2157520281;Ne;5;6;0;11
20190;Šaltinėlis;Saulutės;8995954572;Ne;0;5;0;5
20191;Šaltinėlis;Saulutės;5996579651;Ne;2;4;0;6
20192;Šaltinėlis;Saulutės;9613234759;Ne;0;4;0;4
20193;Šaltinėlis;Saulutės;9218436977;Ne;0;7;0;7
20194;Šaltinėlis;Meškiukų;6915625306;Ne;0;2;0;2
20195;Šaltinėlis;Meškiukų;6645807642;Ne;5;5;0;10
20196;Šaltinėlis;Meškiukų;9759912102;Ne;5;4;0;9
20197;Šaltinėlis;Meškiukų;4664741207;Ne;11;0;0;11
20198;Šaltinėlis;Meškiukų;1400918201;Ne;16;0;0;16
20199;Šaltinėlis;Meškiukų;1656674673;Ne;5;5;0;10
20200;Šaltinėlis;Meškiukų;4248763165;Ne;0;12;0;12
20201;Šaltinėlis;Meškiukų;5982018366;Ne;0;4;0;4
20202;Šaltinėlis;Meškiukų;9922223978;Ne;8;4;0;12
20203;Šaltinėlis;Meškiukų;8995077908;Ne;3;6;0;9
20204;Šaltinėlis;Meškiukų;5982188743;Ne;8;0;0;8
20205;Šaltinėlis;Meškiukų;6586783795;Ne;0;5;0;5
20206;Šaltinėlis;Meškiukų;7468640592;Ne;0;6;0;6
20207;Šaltinėlis;Meškiukų;4064231806;Ne;3;4;0;7
20208;Šaltinėlis;Meškiukų;4159654434;Ne;7;0;0;7
20209;Šaltinėlis;Meškiukų;6688536661;Ne;5;0;0;5
20210;Šaltinėlis;Meškiukų;8880659539;Ne;10;1;0;11
20211;Šaltinėlis;Meškiukų;3228788999;Ne;4;4;0;8
20212;Šaltinėlis;Meškiukų;5905345563;Ne;11;0;0;11
20213;Šaltinėlis;Meškiukų;2332065937;Ne;2;0;0;2
20214;Šaltinėlis;Meškiukų;4936982698;Ne;2;5;0;7
20215;Šaltinėlis;Nykštukai;9766640995;Ne;15;0;0;15
20216;Šaltinėlis;Nykštukai;3356138058;Ne;19;0;0;19
20217;Šaltinėlis;Nykštukai;5434349511;Ne;19;0;0;19
20218;Šaltinėlis;Nykštukai;4226068669;Ne;0;2;0;2
20219;Šaltinėlis;Nykštukai;2976773344;Ne;6;0;0;6
20220;Šaltinėlis;Nykštukai;3687243030;Ne;4;0;0;4
20221;Šaltinėlis;Nykštukai;4364256563;Ne;13;0;0;13
20222;Šaltinėlis;Nykštukai;9333013048;Ne;7;0;0;7
20223;Šaltinėlis;Nykštukai;4029616063;Ne;4;0;0;4
20224;Šaltinėlis;Nykštukai;6530797082;Ne;6;0;0;6
20225;Šaltinėlis;Nykštukai;7534585887;Ne;17;0;0;17
20226;Šaltinėlis;Nykštukai;8977029692;Ne;10;0;0;10
20227;Šaltinėlis;Nykštukai;7120592596;Ne;9;0;0;9
20228;Šaltinėlis;Nykštukai;3497881408;Ne;11;0;0;11
20229;Šaltinėlis;Nykštukai;6383844995;Ne;8;0;0;8
20230;Šaltinėlis;Nykštukai;1441937630;Ne;4;0;0;4
20231;Šaltinėlis;Nykštukai;4742849747;Ne;11;0;0;11
20232;Šaltinėlis;Nykštukai;2353630084;Ne;4;0;0;4
20233;Šaltinėlis;Nykštukai;5593692486;Ne;14;0;0;14
20234;Šaltinėlis;Nykštukai;1496105338;Ne;9;0;0;9
20235;Šaltinėlis;Nykštukai;7432957835;Ne;6;0;0;6
20236;Šaltinėlis;Nykštukai;1468854968;Ne;8;0;0;8
20237;Šaltinėlis;Perliukų;2825412170;Ne;1;4;0;5
20238;Šaltinėlis;Perliukų;1686009371;Ne;12;0;0;12
20239;Šaltinėlis;Perliukų;9075507649;Ne;4;0;0;4
20240;Šaltinėlis;Perliukų;7068058767;Ne;3;4;0;7
20241;Šaltinėlis;Perliukų;2189112609;Ne;11;0;0;11
20242;Šaltinėlis;Perliukų;8914777163;Ne;10;5;0;15
20243;Šaltinėlis;Perliukų;7387221265;Ne;3;4;0;7
20244;Šaltinėlis;Perliukų;9674923143;Ne;9;3;0;12
20245;Šaltinėlis;Perliukų;1823048790;Ne;10;2;0;12
20246;Šaltinėlis;Perliukų;3073692882;Ne;8;1;0;9
20247;Šaltinėlis;Perliukų;5325974488;Ne;2;4;0;6
20248;Šaltinėlis;Perliukų;2022956307;Ne;3;1;0;4
20249;Šaltinėlis;Perliukų;2126751248;Ne;1;4;0;5
20250;Šaltinėlis;Perliukų;3271931810;Ne;9;1;0;10
20251;Šaltinėlis;Perliukų;7955094634;Ne;0;2;0;2
20252;Šaltinėlis;Perliukų;1445108285;Ne;5;4;0;9
20253;Šaltinėlis;Perliukų;7133044918;Ne;9;0;0;9
20254;Šaltinėlis;Perliukų;2806453623;Ne;2;0;0;2
20255;Šaltinėlis;Perliukų;9691993251;Ne;0;4;0;4
20256;Šaltinėlis;Perliukų;8695191968;Ne;0;4;0;4
20257;Šaltinėlis;Perliukų;4430546695;Ne;10;4;0;14
20258;Šaltinėlis;Perliukų;8506287076;Ne;0;1;0;1
20259;Šaltinėlis;BORUŽĖLĖS;2222188915;Ne;0;6;0;6
20260;Šaltinėlis;BORUŽĖLĖS;1012869495;Ne;4;2;0;6
20261;Šaltinėlis;BORUŽĖLĖS;7007255432;Ne;9;7;0;16
20262;Šaltinėlis;BORUŽĖLĖS;2704220005;Ne;0;2;0;2
20263;Šaltinėlis;BORUŽĖLĖS;7074953363;Ne;5;3;0;8
20264;Šaltinėlis;BORUŽĖLĖS;1283839856;Ne;0;4;0;4
20265;Šaltinėlis;BORUŽĖLĖS;4754031495;Ne;11;3;0;14
20266;Šaltinėlis;BORUŽĖLĖS;8806353914;Ne;9;4;0;13
20267;Šaltinėlis;BORUŽĖLĖS;5943247739;Ne;10;3;0;13
20268;Šaltinėlis;BORUŽĖLĖS;9258088219;Ne;13;0;0;13
20269;Šaltinėlis;BORUŽĖLĖS;4825400376;Ne;9;2;0;11
20270;Šaltinėlis;BORUŽĖLĖS;8979939577;Ne;5;5;0;10
20271;Šaltinėlis;BORUŽĖLĖS;2053262491;Ne;5;0;0;5
20272;Šaltinėlis;BORUŽĖLĖS;2856977335;Ne;10;4;0;14
20273;Šaltinėlis;BORUŽĖLĖS;6553155860;Ne;19;0;0;19
20274;Šaltinėlis;"4B klasė";93256161233;Ne;0;5;0;5
20275;Šaltinėlis;"4B klasė";83173349544;Ne;0;5;0;5
20276;Šaltinėlis;"4B klasė";39088869084;Ne;0;6;0;6
20277;Šaltinėlis;"4B klasė";1422035829;Ne;0;5;0;5
20278;Šaltinėlis;"4B klasė";7711903999;Ne;0;15;0;15
20279;Šaltinėlis;"4B klasė";95542489944;Ne;0;10;0;10
20280;Šaltinėlis;"4B klasė";3072314714;Ne;0;5;0;5
20281;Šaltinėlis;"4B klasė";1220687492;Ne;0;5;0;5
20282;Šaltinėlis;"4B klasė";74337710550;Ne;0;6;0;6
20283;Šaltinėlis;"4B klasė";35401075864;Ne;0;5;0;5
20284;Šaltinėlis;"4B klasė";19630605543;Ne;0;6;0;6
20285;Šaltinėlis;"4B klasė";84522552145;Ne;0;10;0;10
20286;Šaltinėlis;"4B klasė";3626545396;Ne;0;10;0;10
20287;Šaltinėlis;"4B klasė";6317111400;Ne;0;7;0;7
20288;Šaltinėlis;"4B klasė";4762756751;Ne;0;5;0;5
20289;Šaltinėlis;"4B klasė";72372808270;Ne;0;5;0;5
20290;Šaltinėlis;"4B klasė";1924418657;Ne;0;12;0;12
20291;Šaltinėlis;"4B klasė";77194317310;Ne;0;10;0;10
20292;Šaltinėlis;"4B klasė";57847832778;Ne;0;6;0;6
20293;Šaltinėlis;"4B klasė";2099800744;Ne;0;5;0;5
20294;Šaltinėlis;"4B klasė";70315400705;Ne;0;8;0;8
20295;Šaltinėlis;"4B klasė";81082410620;Ne;0;5;0;5
20296;Šaltinėlis;1A;6487378225;Ne;0;4;0;4
20297;Šaltinėlis;1A;56396772538;Ne;0;5;0;5
20298;Šaltinėlis;1A;5251390843;Ne;0;7;0;7
20299;Šaltinėlis;1A;8500790262;Ne;0;4;0;4
20300;Šaltinėlis;1A;4332884673;Ne;0;8;0;8
20301;Šaltinėlis;1A;3493429067;Ne;0;7;0;7
20302;Šaltinėlis;1A;9362495172;Ne;0;4;0;4
20303;Šaltinėlis;1A;6462738640;Ne;0;4;0;4
20304;Šaltinėlis;1A;77872075694;Ne;0;4;0;4
20305;Šaltinėlis;1A;7133143923;Ne;0;4;0;4
20306;Šaltinėlis;1A;6887838949;Ne;0;19;0;19
20307;Šaltinėlis;1A;1543331408;Ne;0;5;0;5
20308;Šaltinėlis;1A;2630875135;Ne;0;7;0;7
20309;Šaltinėlis;1A;9218883174;Ne;0;4;0;4
20310;Šaltinėlis;1A;2973820849;Ne;0;6;0;6
20311;Šaltinėlis;1A;7737797979;Ne;0;4;0;4
20312;Šaltinėlis;1A;9820788524;Ne;0;19;0;19
20313;Šaltinėlis;1A;2646901307;Ne;0;4;0;4
20314;Šaltinėlis;1A;9274165569;Ne;0;4;0;4
20315;Šaltinėlis;1A;3691635011;Ne;0;4;0;4
20316;Šaltinėlis;1A;2084451705;Ne;0;6;0;6
20317;Šaltinėlis;"2A klasė";1580090516;Ne;0;7;0;7
20318;Šaltinėlis;"2A klasė";2034838765;Ne;0;5;0;5
20319;Šaltinėlis;"2A klasė";2105963102;Ne;0;5;0;5
20320;Šaltinėlis;"2A klasė";3582666579;Ne;0;6;0;6
20321;Šaltinėlis;"2A klasė";46569341613;Ne;0;6;0;6
20322;Šaltinėlis;"2A klasė";2801321116;Ne;0;5;0;5
20323;Šaltinėlis;"2A klasė";1091056386;Ne;0;6;0;6
20324;Šaltinėlis;"2A klasė";52142182972;Ne;0;19;0;19
20325;Šaltinėlis;"2A klasė";6880337593;Ne;0;7;0;7
20326;Šaltinėlis;"2A klasė";9188065549;Ne;0;6;0;6
20327;Šaltinėlis;"2A klasė";9305706589;Ne;0;6;0;6
20328;Šaltinėlis;"2A klasė";3516760367;Ne;0;6;0;6
20329;Šaltinėlis;"2A klasė";56542341895;Ne;0;6;0;6
20330;Šaltinėlis;"2A klasė";5077603802;Ne;0;6;0;6
20331;Šaltinėlis;"2A klasė";1910670134;Ne;0;7;0;7
20332;Šaltinėlis;"2A klasė";9595350871;Ne;0;5;0;5
20333;Šaltinėlis;"2A klasė";15925823621;Ne;0;6;0;6
20334;Šaltinėlis;"2A klasė";8902634958;Ne;0;6;0;6
20335;Šaltinėlis;"2A klasė";9757246434;Ne;0;14;0;14
20336;Šaltinėlis;"2A klasė";7262120071;Ne;0;8;0;8
20337;Šaltinėlis;"2A klasė";1004445904;Ne;0;6;0;6
20338;Šaltinėlis;"2B klasė";84494627465;Ne;0;6;0;6
20339;Šaltinėlis;"2B klasė";2146141461;Ne;0;8;0;8
20340;Šaltinėlis;"2B klasė";6068980312;Ne;0;8;0;8
20341;Šaltinėlis;"2B klasė";9425353041;Ne;0;5;0;5
20342;Šaltinėlis;"2B klasė";17147527171;Ne;0;19;0;19
20343;Šaltinėlis;"2B klasė";1716801722;Ne;0;5;0;5
20344;Šaltinėlis;"2B klasė";2333071711;Ne;0;7;0;7
20345;Šaltinėlis;"2B klasė";23301579810;Ne;0;19;0;19
20346;Šaltinėlis;"2B klasė";526307704;Ne;0;13;0;13
20347;Šaltinėlis;"2B klasė";1958647188;Ne;0;7;0;7
20348;Šaltinėlis;"2B klasė";1583520894;Ne;0;6;0;6
20349;Šaltinėlis;"2B klasė";11083638216;Ne;0;6;0;6
20350;Šaltinėlis;"2B klasė";1023238509;Ne;0;8;0;8
20351;Šaltinėlis;"3A klasė";32264290873;Ne;0;6;0;6
20352;Šaltinėlis;"3A klasė";1767635282;Ne;0;4;0;4
20353;Šaltinėlis;"3A klasė";1390316465;Ne;0;4;0;4
20354;Šaltinėlis;"3A klasė";5442943843;Ne;0;5;0;5
20355;Šaltinėlis;"3A klasė";6764006747;Ne;0;7;0;7
20356;Šaltinėlis;"3A klasė";1658370782;Ne;0;4;0;4
20357;Šaltinėlis;"3A klasė";10918276041;Ne;0;6;0;6
20358;Šaltinėlis;"3A klasė";3455754351;Ne;0;19;0;19
20359;Šaltinėlis;"3A klasė";66575684640;Ne;0;5;0;5
20360;Šaltinėlis;"3A klasė";86592374576;Ne;0;19;0;19
20361;Šaltinėlis;"3A klasė";13808708760;Ne;0;5;0;5
20362;Šaltinėlis;"3A klasė";1614411921;Ne;0;8;0;8
20363;Šaltinėlis;"3A klasė";79406746980;Ne;0;6;0;6
20364;Šaltinėlis;"3A klasė";3577137327;Ne;0;7;0;7
20365;Šaltinėlis;"3A klasė";1224027643;Ne;0;5;0;5
20366;Šaltinėlis;"3A klasė";48525545812;Ne;0;6;0;6
20367;Šaltinėlis;"3A klasė";3022926855;Ne;0;5;0;5
20368;Šaltinėlis;"3A klasė";1190394855;Ne;0;6;0;6
20369;Šaltinėlis;"3A klasė";40186714037;Ne;0;5;0;5
20370;Šaltinėlis;"3A klasė";1456486363;Ne;0;5;0;5
20371;Šaltinėlis;"3A klasė";32949623652;Ne;0;4;0;4
20372;Šaltinėlis;"4A klasė";14213856824;Ne;0;5;0;5
20373;Šaltinėlis;"4A klasė";80649337160;Ne;0;5;0;5
20374;Šaltinėlis;"4A klasė";92958012146;Ne;0;4;0;4
20375;Šaltinėlis;"4A klasė";84656960510;Ne;0;19;0;19
20376;Šaltinėlis;"4A klasė";83621946293;Ne;0;19;0;19
20377;Šaltinėlis;"4A klasė";67808618878;Ne;0;19;0;19
20378;Šaltinėlis;"4A klasė";1278910777;Ne;0;4;0;4
20379;Šaltinėlis;"4A klasė";9647785988;Ne;0;7;0;7
20380;Šaltinėlis;"4A klasė";82671662416;Ne;0;4;0;4
20381;Šaltinėlis;"4A klasė";54025577281;Ne;0;4;0;4
20382;Šaltinėlis;"4A klasė";488285764;Ne;0;5;0;5
20383;Šaltinėlis;"4A klasė";29482180151;Ne;0;4;0;4
20384;Šaltinėlis;"4A klasė";54753218491;Ne;0;5;0;5
20385;Šaltinėlis;"4A klasė";86029472773;Ne;0;5;0;5
20386;Šaltinėlis;"4A klasė";64821172553;Ne;0;9;0;9
20387;Šaltinėlis;"4A klasė";5744976843;Ne;0;4;0;4
20388;Šaltinėlis;"4A klasė";25459069972;Ne;0;7;0;7
20389;Šaltinėlis;"4A klasė";6669392157;Ne;0;4;0;4
20390;Šaltinėlis;"4A klasė";89358384113;Ne;0;10;0;10
20391;Šaltinėlis;"4A klasė";28956971978;Ne;0;5;0;5
20392;Šaltinėlis;"4A klasė";4050444191;Ne;0;4;0;4
20393;Šaltinėlis;"4A klasė";89093437170;Ne;0;4;0;4
20394;Šaltinėlis;"4A klasė";51872331010;Ne;0;6;0;6
20395;Šaltinėlis;1B;7723290276;Ne;0;6;0;6
20396;Šaltinėlis;1B;3660687688;Ne;0;12;0;12
20397;Šaltinėlis;1B;1348724947;Ne;0;19;0;19
20398;Šaltinėlis;1B;2230403251;Ne;0;6;0;6
20399;Šaltinėlis;1B;4387568448;Ne;0;6;0;6
20400;Šaltinėlis;1B;2658414287;Ne;0;6;0;6
20401;Šaltinėlis;1B;7918995181;Ne;0;8;0;8
20402;Šaltinėlis;1B;3638565578;Ne;0;8;0;8
20403;Šaltinėlis;1B;1367082230;Ne;0;4;0;4
20404;Šaltinėlis;1B;5869977541;Ne;0;8;0;8
20405;Šaltinėlis;1B;5099997904;Ne;0;6;0;6
20406;Šaltinėlis;1B;8721116918;Ne;0;9;0;9
20407;Šaltinėlis;1B;3609939325;Ne;0;6;0;6
20408;Šaltinėlis;1B;7211267255;Ne;0;7;0;7
20409;Šaltinėlis;1B;9108653045;Ne;0;6;0;6
20410;Šaltinėlis;1B;6816346946;Ne;0;5;0;5
20411;Šaltinėlis;1B;5495098615;Ne;0;7;0;7
20412;Šaltinėlis;1B;9762392403;Ne;0;5;0;5
20413;Gabijėlė;GANDRIUKŲ;4498088417;Ne;10;4;0;14
20414;Gabijėlė;GANDRIUKŲ;2277489032;Ne;0;4;2;6
20415;Gabijėlė;GANDRIUKŲ;8994076883;Ne;0;4;0;4
20416;Gabijėlė;GANDRIUKŲ;7087892822;Ne;0;5;0;5
20417;Gabijėlė;GANDRIUKŲ;5057272847;Ne;8;9;0;17
20418;Gabijėlė;GANDRIUKŲ;3532989398;Ne;3;5;0;8
20419;Gabijėlė;GANDRIUKŲ;2215880644;Ne;3;6;1;10
20420;Gabijėlė;GANDRIUKŲ;3799003783;Ne;0;4;0;4
20421;Gabijėlė;GANDRIUKŲ;5513530983;Ne;0;4;0;4
20422;Gabijėlė;GANDRIUKŲ;6004026516;Ne;0;6;0;6
20423;Gabijėlė;GANDRIUKŲ;4634029418;Ne;0;5;0;5
20424;Gabijėlė;GANDRIUKŲ;9706026832;Ne;0;2;0;2
20425;Gabijėlė;GANDRIUKŲ;2491503656;Ne;0;3;0;3
20426;Gabijėlė;GANDRIUKŲ;8904768332;Ne;0;6;1;7
20427;Gabijėlė;GANDRIUKŲ;5715645968;Ne;12;0;0;12
20428;Gabijėlė;GANDRIUKŲ;8572833698;Ne;2;2;1;5
20429;Gabijėlė;GANDRIUKŲ;7433142478;Ne;5;0;0;5
20430;Gabijėlė;GANDRIUKŲ;5054419205;Ne;3;5;0;8
20431;Gabijėlė;GANDRIUKŲ;9929652398;Ne;0;4;1;5
20432;Gabijėlė;GANDRIUKŲ;7530976246;Ne;0;4;1;5
20433;Gabijėlė;GANDRIUKŲ;3920525584;Ne;2;0;0;2
20434;Gabijėlė;GANDRIUKŲ;2682112101;Ne;0;5;0;5
20435;Gabijėlė;GANDRIUKŲ;5312189552;Ne;3;4;0;7
20436;Gabijėlė;LAKŠTINGALIUKŲ;7019425859;Ne;0;0;4;4
20437;Gabijėlė;LAKŠTINGALIUKŲ;1611004144;Ne;5;4;0;9
20438;Gabijėlė;LAKŠTINGALIUKŲ;5862882027;Ne;6;4;0;10
20439;Gabijėlė;LAKŠTINGALIUKŲ;8798786098;Ne;17;0;0;17
20440;Gabijėlė;LAKŠTINGALIUKŲ;8035360208;Ne;0;11;0;11
20441;Gabijėlė;LAKŠTINGALIUKŲ;2384469423;Ne;6;3;0;9
20442;Gabijėlė;LAKŠTINGALIUKŲ;8167646385;Ne;0;4;0;4
20443;Gabijėlė;LAKŠTINGALIUKŲ;8926268619;Ne;16;0;0;16
20444;Gabijėlė;LAKŠTINGALIUKŲ;9480021589;Ne;0;7;0;7
20445;Gabijėlė;LAKŠTINGALIUKŲ;3215569531;Ne;4;4;0;8
20446;Gabijėlė;LAKŠTINGALIUKŲ;5992403900;Ne;5;0;0;5
20447;Gabijėlė;LAKŠTINGALIUKŲ;9116943443;Ne;9;1;0;10
20448;Gabijėlė;LAKŠTINGALIUKŲ;8383489040;Ne;0;4;0;4
20449;Gabijėlė;LAKŠTINGALIUKŲ;6927730664;Ne;6;0;0;6
20450;Gabijėlė;LAKŠTINGALIUKŲ;7444385669;Ne;4;4;0;8
20451;Gabijėlė;LAKŠTINGALIUKŲ;9398722388;Ne;0;5;0;5
20452;Gabijėlė;LAKŠTINGALIUKŲ;9491327802;Ne;4;0;0;4
20453;Gabijėlė;LAKŠTINGALIUKŲ;6730947751;Ne;0;3;0;3
20454;Gabijėlė;LAKŠTINGALIUKŲ;2550300871;Ne;0;6;0;6
20455;Gabijėlė;LAKŠTINGALIUKŲ;9324498850;Ne;5;4;0;9
20456;Gabijėlė;LAKŠTINGALIUKŲ;8314088016;Ne;2;2;0;4
20457;Gabijėlė;LAKŠTINGALIUKŲ;6295299651;Ne;2;2;0;4
20458;Gabijėlė;LAKŠTINGALIUKŲ;9694544564;Ne;15;0;0;15
20459;Gabijėlė;ŽVIRBLIUKŲ;7043775905;Ne;1;5;0;6
20460;Gabijėlė;ŽVIRBLIUKŲ;4475530177;Ne;7;5;2;14
20461;Gabijėlė;ŽVIRBLIUKŲ;5743861607;Ne;0;4;1;5
20462;Gabijėlė;ŽVIRBLIUKŲ;7410541320;Ne;4;15;0;19
20463;Gabijėlė;ŽVIRBLIUKŲ;4493192224;Ne;5;4;0;9
20464;Gabijėlė;ŽVIRBLIUKŲ;9259964641;Ne;0;4;0;4
20465;Gabijėlė;ŽVIRBLIUKŲ;3268231136;Ne;0;12;0;12
20466;Gabijėlė;ŽVIRBLIUKŲ;5332825339;Ne;2;4;2;8
20467;Gabijėlė;ŽVIRBLIUKŲ;2264669298;Ne;0;3;1;4
20468;Gabijėlė;ŽVIRBLIUKŲ;5942625633;Ne;12;2;0;14
20469;Gabijėlė;ŽVIRBLIUKŲ;3155403180;Ne;0;4;5;9
20470;Gabijėlė;ŽVIRBLIUKŲ;1158461185;Ne;0;4;4;8
20471;Gabijėlė;ŽVIRBLIUKŲ;3218415151;Ne;10;5;0;15
20472;Gabijėlė;ŽVIRBLIUKŲ;8823299212;Ne;0;4;3;7
20473;Gabijėlė;ŽVIRBLIUKŲ;8879972953;Ne;4;4;2;10
20474;Gabijėlė;ŽVIRBLIUKŲ;9627906252;Ne;3;5;0;8
20475;Gabijėlė;ŽVIRBLIUKŲ;1725665169;Ne;0;4;0;4
20476;Gabijėlė;ŽVIRBLIUKŲ;6674038058;Ne;0;4;0;4
20477;Gabijėlė;ŽVIRBLIUKŲ;4146051969;Ne;0;2;2;4
20478;Gabijėlė;ŽVIRBLIUKŲ;6604681536;Ne;0;2;0;2
20479;Gabijėlė;ŽVIRBLIUKŲ;1273722177;Ne;0;4;1;5
20480;Gabijėlė;ŽVIRBLIUKŲ;6310234092;Ne;6;5;0;11
20481;Gabijėlė;ŽVIRBLIUKŲ;6154378055;Ne;7;4;2;13
20482;Gabijėlė;ŽVIRBLIUKŲ;9259673720;Ne;5;4;0;9
20483;Gabijėlė;ŽVIRBLIUKŲ;8292463617;Ne;0;4;0;4
20484;Gabijėlė;GENIUKŲ;9215101617;Ne;0;0;3;3
20485;Gabijėlė;GENIUKŲ;4827797140;Ne;0;8;0;8
20486;Gabijėlė;GENIUKŲ;6931780900;Ne;7;0;0;7
20487;Gabijėlė;GENIUKŲ;2030555139;Ne;0;7;0;7
20488;Gabijėlė;GENIUKŲ;4908791060;Ne;1;5;0;6
20489;Gabijėlė;GENIUKŲ;7261932151;Ne;0;0;3;3
20490;Gabijėlė;GENIUKŲ;2539692903;Ne;10;0;0;10
20491;Gabijėlė;GENIUKŲ;6923511443;Ne;6;6;0;12
20492;Gabijėlė;GENIUKŲ;8384795164;Ne;0;3;2;5
20493;Gabijėlė;GENIUKŲ;3209491491;Ne;7;0;0;7
20494;Gabijėlė;GENIUKŲ;8185042446;Ne;1;0;4;5
20495;Gabijėlė;GENIUKŲ;9413654318;Ne;13;0;0;13
20496;Gabijėlė;GENIUKŲ;5297866989;Ne;0;4;0;4
20497;Gabijėlė;GENIUKŲ;4664011011;Ne;6;0;0;6
20498;Gabijėlė;GENIUKŲ;4490619514;Ne;0;0;4;4
20499;Gabijėlė;GENIUKŲ;1021920133;Ne;6;0;4;10
20500;Gabijėlė;GENIUKŲ;1345747441;Ne;0;0;4;4
20501;Gabijėlė;GENIUKŲ;7597037953;Ne;0;0;2;2
20502;Gabijėlė;GENIUKŲ;6469409776;Ne;7;0;4;11
20503;Gabijėlė;GENIUKŲ;6539078572;Ne;0;4;0;4
20504;Gabijėlė;GENIUKŲ;7509112343;Ne;0;2;4;6
20505;Gabijėlė;DAGILIUKŲ;9348393550;Ne;4;4;0;8
20506;Gabijėlė;DAGILIUKŲ;4264925447;Ne;4;4;0;8
20507;Gabijėlė;DAGILIUKŲ;9120107749;Ne;2;4;0;6
20508;Gabijėlė;DAGILIUKŲ;9494313873;Ne;0;4;0;4
20509;Gabijėlė;DAGILIUKŲ;9783343968;Ne;0;5;1;6
20510;Gabijėlė;DAGILIUKŲ;3017939983;Ne;0;5;0;5
20511;Gabijėlė;DAGILIUKŲ;4462129182;Ne;9;6;0;15
20512;Gabijėlė;DAGILIUKŲ;9503639471;Ne;0;4;0;4
20513;Gabijėlė;DAGILIUKŲ;1988597157;Ne;3;5;0;8
20514;Gabijėlė;DAGILIUKŲ;9895518740;Ne;15;0;1;16
20515;Gabijėlė;DAGILIUKŲ;9449023766;Ne;0;5;0;5
20516;Gabijėlė;DAGILIUKŲ;1286688629;Ne;5;4;0;9
20517;Gabijėlė;DAGILIUKŲ;8864190314;Ne;0;2;0;2
20518;Gabijėlė;DAGILIUKŲ;1455856766;Ne;0;4;0;4
20519;Gabijėlė;DAGILIUKŲ;3700639354;Ne;0;1;0;1
20520;Gabijėlė;DAGILIUKŲ;6438144206;Ne;7;4;0;11
20521;Gabijėlė;DAGILIUKŲ;8662914262;Ne;0;6;0;6
20522;Gabijėlė;DAGILIUKŲ;9280283478;Ne;2;6;1;9
20523;Gabijėlė;DAGILIUKŲ;2254104149;Ne;0;9;0;9
20524;Gabijėlė;DAGILIUKŲ;8078326688;Ne;0;4;0;4
20525;Gabijėlė;DAGILIUKŲ;2386980295;Ne;0;4;0;4
20526;Gabijėlė;DAGILIUKŲ;9581539166;Ne;6;4;1;11
20527;Gabijėlė;DAGILIUKŲ;3548399391;Ne;2;5;0;7
20528;Gabijėlė;DAGILIUKŲ;4328252445;Ne;0;6;0;6
20529;Gabijėlė;DAGILIUKŲ;9893869150;Ne;0;4;0;4
20530;Gabijėlė;PELEDŽIUKŲ;4170105224;Ne;0;4;1;5
20531;Gabijėlė;PELEDŽIUKŲ;5675574534;Ne;0;0;4;4
20532;Gabijėlė;PELEDŽIUKŲ;5163460269;Ne;0;1;0;1
20533;Gabijėlė;PELEDŽIUKŲ;1356830225;Ne;0;0;4;4
20534;Gabijėlė;PELEDŽIUKŲ;9265103627;Ne;3;0;2;5
20535;Gabijėlė;PELEDŽIUKŲ;9451897367;Ne;11;0;1;12
20536;Gabijėlė;PELEDŽIUKŲ;1583034900;Ne;0;0;1;1
20537;Gabijėlė;PELEDŽIUKŲ;2128428173;Ne;11;0;1;12
20538;Gabijėlė;PELEDŽIUKŲ;7028670164;Ne;0;0;1;1
20539;Gabijėlė;PELEDŽIUKŲ;2885913045;Ne;0;4;2;6
20540;Gabijėlė;PELEDŽIUKŲ;5869580147;Ne;0;0;5;5
20541;Gabijėlė;PELEDŽIUKŲ;7096789623;Ne;0;0;3;3
20542;Gabijėlė;PELEDŽIUKŲ;4724322463;Ne;0;7;0;7
20543;Gabijėlė;PELEDŽIUKŲ;1810898809;Taip;7;4;1;12
20544;Gabijėlė;PELEDŽIUKŲ;5801792404;Ne;19;0;0;19
20545;Gabijėlė;PELEDŽIUKŲ;5579070948;Ne;0;1;0;1
20546;Gabijėlė;PELEDŽIUKŲ;1076369632;Ne;5;0;2;7
20547;Gabijėlė;PELEDŽIUKŲ;8549800358;Ne;5;0;1;6
20548;Gabijėlė;PELEDŽIUKŲ;8133131896;Ne;0;0;2;2
20549;Gabijėlė;PELEDŽIUKŲ;2048046055;Ne;6;0;0;6
20550;Gabijėlė;PELEDŽIUKŲ;8088806507;Ne;6;4;0;10
20551;Gabijėlė;PELEDŽIUKŲ;6728495961;Ne;12;0;1;13
20552;Gabijėlė;KREGZDŽIUKŲ;1759118326;Ne;0;13;0;13
20553;Gabijėlė;KREGZDŽIUKŲ;9533325351;Ne;0;13;0;13
20554;Gabijėlė;KREGZDŽIUKŲ;5407565441;Ne;5;0;2;7
20555;Gabijėlė;KREGZDŽIUKŲ;6845038692;Ne;0;6;0;6
20556;Gabijėlė;KREGZDŽIUKŲ;9683202312;Ne;9;0;0;9
20557;Gabijėlė;KREGZDŽIUKŲ;2357515455;Ne;3;0;1;4
20558;Gabijėlė;KREGZDŽIUKŲ;1574272380;Ne;9;8;0;17
20559;Gabijėlė;KREGZDŽIUKŲ;9675186834;Ne;10;0;0;10
20560;Gabijėlė;KREGZDŽIUKŲ;2634722171;Ne;4;0;0;4
20561;Gabijėlė;KREGZDŽIUKŲ;4317708029;Ne;0;12;0;12
20562;Gabijėlė;KREGZDŽIUKŲ;8555272917;Taip;0;8;0;8
20563;Gabijėlė;KREGZDŽIUKŲ;1142939183;Ne;0;14;0;14
20564;Gabijėlė;KREGZDŽIUKŲ;9676186208;Ne;0;15;0;15
20565;Gabijėlė;KREGZDŽIUKŲ;3584692524;Ne;8;1;0;9
20566;Gabijėlė;KREGZDŽIUKŲ;8613821848;Ne;11;0;0;11
20567;Gabijėlė;KREGZDŽIUKŲ;7038167942;Ne;0;11;0;11
20568;Gabijėlė;KREGZDŽIUKŲ;6570702235;Ne;2;0;0;2
20569;Gabijėlė;KREGZDŽIUKŲ;9528783892;Ne;0;15;0;15
20570;Gabijėlė;KREGZDŽIUKŲ;9358478209;Ne;5;0;0;5
20571;Gabijėlė;KREGZDŽIUKŲ;9030890792;Ne;11;0;0;11
20572;Gabijėlė;KREGZDŽIUKŲ;3031333199;Ne;11;0;0;11
20573;Gabijėlė;KREGZDŽIUKŲ;9116153981;Ne;5;1;0;6
20574;Gabijėlė;KREGZDŽIUKŲ;4575230225;Ne;5;0;0;5
20575;Gabijėlė;ZYLIUKŲ;7700700293;Ne;3;4;2;9
20576;Gabijėlė;ZYLIUKŲ;6759447513;Ne;0;9;0;9
20577;Gabijėlė;ZYLIUKŲ;1090635644;Ne;19;0;0;19
20578;Gabijėlė;ZYLIUKŲ;2764185879;Ne;0;4;0;4
20579;Gabijėlė;ZYLIUKŲ;6463161337;Ne;0;4;1;5
20580;Gabijėlė;ZYLIUKŲ;7921467223;Ne;0;4;2;6
20581;Gabijėlė;ZYLIUKŲ;6562965816;Ne;1;3;1;5
20582;Gabijėlė;ZYLIUKŲ;4376486874;Ne;0;2;2;4
20583;Gabijėlė;ZYLIUKŲ;7047606048;Ne;0;4;2;6
20584;Gabijėlė;ZYLIUKŲ;6983092888;Ne;13;0;0;13
20585;Gabijėlė;ZYLIUKŲ;2727329238;Ne;0;0;3;3
20586;Gabijėlė;ZYLIUKŲ;4267803371;Ne;0;0;2;2
20587;Gabijėlė;ZYLIUKŲ;8362509831;Ne;9;0;2;11
20588;Gabijėlė;ZYLIUKŲ;4907669556;Ne;0;10;0;10
20589;Gabijėlė;ZYLIUKŲ;1947898190;Ne;0;14;0;14
20590;Gabijėlė;ZYLIUKŲ;2384174631;Ne;13;0;2;15
20591;Gabijėlė;ZYLIUKŲ;3181607628;Ne;10;0;0;10
20592;Gabijėlė;ZYLIUKŲ;4166561084;Ne;0;0;2;2
20593;Gabijėlė;ZYLIUKŲ;5736012194;Ne;19;0;0;19
20594;Gabijėlė;ZYLIUKŲ;4712780337;Ne;5;0;0;5
20595;Gabijėlė;ZYLIUKŲ;1004297369;Ne;1;1;3;5
20596;Gabijėlė;ZYLIUKŲ;7180444215;Ne;7;4;2;13
20597;Gabijėlė;ZYLIUKŲ;6446842432;Ne;9;0;0;9
20598;Gabijėlė;VOLUNGĖLIŲ;2099510027;Ne;19;0;0;19
20599;Gabijėlė;VOLUNGĖLIŲ;6842537434;Ne;0;10;0;10
20600;Gabijėlė;VOLUNGĖLIŲ;2227816651;Ne;2;5;0;7
20601;Gabijėlė;VOLUNGĖLIŲ;6956030813;Ne;10;1;0;11
20602;Gabijėlė;VOLUNGĖLIŲ;3902737481;Ne;0;7;0;7
20603;Gabijėlė;VOLUNGĖLIŲ;8733551230;Ne;15;0;0;15
20604;Gabijėlė;VOLUNGĖLIŲ;3763595874;Ne;0;5;1;6
20605;Gabijėlė;VOLUNGĖLIŲ;5360985745;Ne;9;0;0;9
20606;Gabijėlė;VOLUNGĖLIŲ;4580305437;Ne;0;5;0;5
20607;Gabijėlė;VOLUNGĖLIŲ;5737066080;Ne;9;1;2;12
20608;Gabijėlė;VOLUNGĖLIŲ;5972136800;Ne;2;4;0;6
20609;Gabijėlė;VOLUNGĖLIŲ;6643563560;Ne;0;8;0;8
20610;Gabijėlė;VOLUNGĖLIŲ;8312753333;Ne;0;6;0;6
20611;Gabijėlė;VOLUNGĖLIŲ;2523400466;Ne;5;1;1;7
20612;Gabijėlė;VOLUNGĖLIŲ;8569742033;Ne;0;5;0;5
20613;Gabijėlė;VOLUNGĖLIŲ;8327903800;Ne;0;4;0;4
20614;Gabijėlė;VOLUNGĖLIŲ;2251276876;Ne;0;1;0;1
20615;Gabijėlė;VOLUNGĖLIŲ;6960725029;Ne;12;1;0;13
20616;Gabijėlė;VOLUNGĖLIŲ;3098846537;Ne;0;1;1;2
20617;Gabijėlė;VOLUNGĖLIŲ;3995459990;Ne;0;4;0;4
20618;Gabijėlė;VOLUNGĖLIŲ;3267339129;Ne;12;0;0;12
20619;Gabijėlė;VOLUNGĖLIŲ;4304012457;Ne;6;1;0;7
20620;Gabijėlė;VOLUNGĖLIŲ;3324631994;Ne;0;1;1;2
20621;Gabijėlė;ANČIUKŲ;2107898976;Ne;8;5;0;13
20622;Gabijėlė;ANČIUKŲ;4000838897;Ne;5;5;0;10
20623;Gabijėlė;ANČIUKŲ;5060265729;Ne;19;0;0;19
20624;Gabijėlė;ANČIUKŲ;3972933727;Ne;15;0;0;15
20625;Gabijėlė;ANČIUKŲ;9657713903;Ne;11;0;0;11
20626;Gabijėlė;ANČIUKŲ;4278783863;Ne;0;1;0;1
20627;Gabijėlė;ANČIUKŲ;4087903129;Ne;0;11;0;11
20628;Gabijėlė;ANČIUKŲ;2398441433;Ne;10;0;0;10
20629;Gabijėlė;ANČIUKŲ;7049399327;Ne;12;0;0;12
20630;Gabijėlė;ANČIUKŲ;8611258788;Ne;14;0;0;14
20631;Gabijėlė;ANČIUKŲ;8834028360;Ne;12;1;0;13
20632;Gabijėlė;ANČIUKŲ;1002680245;Ne;17;0;0;17
20633;Gabijėlė;ANČIUKŲ;6393256426;Ne;14;0;0;14
20634;Gabijėlė;ANČIUKŲ;4692161807;Ne;11;0;0;11
20635;Gabijėlė;ANČIUKŲ;6040818549;Ne;19;0;0;19
20636;Gabijėlė;ANČIUKŲ;6481368028;Ne;19;0;0;19
20637;Gabijėlė;ANČIUKŲ;7590725504;Ne;1;2;0;3
20638;Gabijėlė;ANČIUKŲ;1230236612;Ne;6;0;0;6
20639;Gabijėlė;ANČIUKŲ;5776683791;Ne;10;1;0;11
20640;Gabijėlė;ANČIUKŲ;6850461646;Ne;11;0;0;11
20641;Gabijėlė;ANČIUKŲ;1525969706;Ne;6;0;0;6
20642;Gabijėlė;ANČIUKŲ;5310270057;Ne;12;0;0;12
20643;Gabijėlė;BALANDŽIUKŲ;3652632748;Ne;9;0;0;9
20644;Gabijėlė;BALANDŽIUKŲ;8514099621;Ne;3;0;0;3
20645;Gabijėlė;BALANDŽIUKŲ;6795173519;Ne;0;2;0;2
20646;Gabijėlė;BALANDŽIUKŲ;6748378606;Ne;7;6;0;13
20647;Gabijėlė;BALANDŽIUKŲ;1612957739;Ne;11;0;0;11
20648;Gabijėlė;BALANDŽIUKŲ;8388297947;Ne;3;0;0;3
20649;Gabijėlė;BALANDŽIUKŲ;7888013969;Ne;5;0;0;5
20650;Gabijėlė;BALANDŽIUKŲ;3011163947;Ne;0;0;1;1
20651;Gabijėlė;BALANDŽIUKŲ;5788152675;Ne;2;0;0;2
20652;Gabijėlė;BALANDŽIUKŲ;6296983654;Ne;0;4;0;4
20653;Gabijėlė;BALANDŽIUKŲ;2462497997;Ne;1;0;0;1
20654;Gabijėlė;BALANDŽIUKŲ;4160646449;Ne;0;5;0;5
20655;Gabijėlė;BALANDŽIUKŲ;1467864178;Ne;1;0;0;1
20656;Gabijėlė;BALANDŽIUKŲ;2185615215;Ne;3;0;0;3
20657;Gabijėlė;BALANDŽIUKŲ;9279727778;Ne;0;4;0;4
20658;Gabijėlė;BALANDŽIUKŲ;7224216275;Ne;4;0;0;4
20659;Gabijėlė;BALANDŽIUKŲ;7447079902;Ne;8;4;0;12
20660;Gabijėlė;BALANDŽIUKŲ;2289016022;Ne;7;0;0;7
20661;Gabijėlė;BALANDŽIUKŲ;8965185578;Ne;10;0;0;10
20662;Gabijėlė;VYTURIUKŲ;6131649116;Ne;5;4;0;9
20663;Gabijėlė;VYTURIUKŲ;8461048184;Ne;3;2;0;5
20664;Gabijėlė;VYTURIUKŲ;7894667201;Ne;12;0;0;12
20665;Gabijėlė;VYTURIUKŲ;3960795412;Ne;0;1;0;1
20666;Gabijėlė;VYTURIUKŲ;3973977318;Ne;0;1;0;1
20667;Gabijėlė;VYTURIUKŲ;3454061135;Ne;8;0;0;8
20668;Gabijėlė;VYTURIUKŲ;9628900843;Ne;4;0;3;7
20669;Gabijėlė;VYTURIUKŲ;5769331689;Ne;7;0;2;9
20670;Gabijėlė;VYTURIUKŲ;5652244967;Ne;0;9;0;9
20671;Gabijėlė;VYTURIUKŲ;6013482554;Ne;6;0;0;6
20672;Gabijėlė;VYTURIUKŲ;3343196830;Ne;3;0;1;4
20673;Gabijėlė;VYTURIUKŲ;9021225516;Ne;0;2;0;2
20674;Gabijėlė;VYTURIUKŲ;1523190444;Ne;3;0;0;3
20675;Gabijėlė;VYTURIUKŲ;7295985579;Ne;3;3;0;6
20676;Gabijėlė;VYTURIUKŲ;6834871835;Ne;12;0;0;12
20677;Gabijėlė;VYTURIUKŲ;8749080961;Ne;2;0;3;5
20678;Gabijėlė;VYTURIUKŲ;1185216449;Ne;2;0;5;7
20679;Gabijėlė;VYTURIUKŲ;6107630313;Ne;2;0;0;2
20680;Gabijėlė;VYTURIUKŲ;4248856615;Ne;0;2;0;2
20681;Gabijėlė;VYTURIUKŲ;4355537090;Ne;0;0;3;3
20682;Gabijėlė;STRAZDELIŲ;7010757358;Ne;10;0;0;10
20683;Gabijėlė;STRAZDELIŲ;1317441841;Ne;0;5;0;5
20684;Gabijėlė;STRAZDELIŲ;4496696197;Ne;2;0;0;2
20685;Gabijėlė;STRAZDELIŲ;1995157457;Ne;6;4;0;10
20686;Gabijėlė;STRAZDELIŲ;5312756424;Ne;2;0;0;2
20687;Gabijėlė;STRAZDELIŲ;8853553967;Ne;10;0;0;10
20688;Gabijėlė;STRAZDELIŲ;7873372479;Ne;13;0;0;13
20689;Gabijėlė;STRAZDELIŲ;1843742298;Ne;6;0;0;6
20690;Gabijėlė;STRAZDELIŲ;6360474547;Ne;9;0;0;9
20691;Gabijėlė;STRAZDELIŲ;6137289651;Ne;6;0;0;6
20692;Gabijėlė;STRAZDELIŲ;7338336807;Ne;5;0;0;5
20693;Gabijėlė;STRAZDELIŲ;2831569080;Ne;11;4;0;15
20694;Gabijėlė;STRAZDELIŲ;7178485867;Ne;0;4;0;4
20695;Gabijėlė;LIEPSNELIŲ;5545178531;Ne;6;0;0;6
20696;Gabijėlė;LIEPSNELIŲ;6767640941;Ne;3;0;0;3
20697;Gabijėlė;LIEPSNELIŲ;9974370666;Ne;7;0;0;7
20698;Gabijėlė;LIEPSNELIŲ;5130974504;Ne;0;0;1;1
20699;Gabijėlė;LIEPSNELIŲ;9739945109;Ne;8;0;0;8
20700;Gabijėlė;LIEPSNELIŲ;5929075145;Ne;1;0;6;7
20701;Gabijėlė;LIEPSNELIŲ;6689082073;Ne;8;4;2;14
20702;Gabijėlė;LIEPSNELIŲ;5333058186;Ne;5;0;0;5
20703;Gabijėlė;GULBIUKŲ;5101043078;Ne;0;9;0;9
20704;Gabijėlė;GULBIUKŲ;2594203606;Ne;14;0;0;14
20705;Gabijėlė;GULBIUKŲ;3554373183;Ne;16;0;0;16
20706;Gabijėlė;GULBIUKŲ;8725246789;Ne;15;0;0;15
20707;Gabijėlė;GULBIUKŲ;8817074528;Ne;0;0;3;3
20708;Gabijėlė;GULBIUKŲ;1046603287;Ne;4;0;0;4
20709;Gabijėlė;GULBIUKŲ;8217857692;Ne;9;0;0;9
20710;Gabijėlė;GULBIUKŲ;4807870665;Ne;10;0;1;11
20711;Gabijėlė;GULBIUKŲ;3044741085;Ne;6;0;1;7
20712;Gabijėlė;GULBIUKŲ;5885231742;Ne;5;0;0;5
20713;Gabijėlė;SAKALĖLIŲ;7392240890;Ne;14;0;0;14
20714;Gabijėlė;SAKALĖLIŲ;2071652069;Ne;11;0;0;11
20715;Gabijėlė;SAKALĖLIŲ;1481910063;Ne;12;0;0;12
20716;Gabijėlė;SAKALĖLIŲ;8970842145;Ne;15;0;0;15
20717;Gabijėlė;SAKALĖLIŲ;8597241034;Ne;3;0;0;3
20718;Gabijėlė;SAKALĖLIŲ;5298975959;Ne;14;0;0;14
20719;Gabijėlė;SAKALĖLIŲ;2237979473;Ne;11;0;0;11
20720;Gabijėlė;SAKALĖLIŲ;3217755689;Ne;6;0;0;6
20721;Gabijėlė;SAKALĖLIŲ;5473567608;Ne;0;0;2;2
20722;Gabijėlė;SAKALĖLIŲ;7804655608;Ne;5;0;0;5
20723;Gabijėlė;SAKALĖLIŲ;2459512602;Ne;0;3;0;3
20724;Gabijėlė;GERVELIŲ;7015425600;Ne;0;4;1;5
20725;Gabijėlė;GERVELIŲ;8783241759;Ne;8;0;0;8
20726;Gabijėlė;GERVELIŲ;9940768072;Ne;10;0;0;10
20727;Gabijėlė;GERVELIŲ;3634759008;Ne;0;0;4;4
20728;Gabijėlė;GERVELIŲ;1826223317;Ne;5;0;4;9
20729;Gabijėlė;GERVELIŲ;2118463552;Ne;6;4;0;10
20730;Gabijėlė;GERVELIŲ;4895199396;Ne;4;0;4;8
20731;Gabijėlė;GERVELIŲ;3715332948;Ne;0;0;1;1
20732;Gabijėlė;GERVELIŲ;3064541598;Ne;16;0;0;16
20733;"Pilaitukas (I. Kanto al. 7A)";BITUTĖS;8943142551;Ne;13;1;0;14
20734;"Pilaitukas (I. Kanto al. 7A)";BITUTĖS;6225968272;Ne;13;1;0;14
20735;"Pilaitukas (I. Kanto al. 7A)";BITUTĖS;2892275540;Ne;0;6;1;7
20736;"Pilaitukas (I. Kanto al. 7A)";BITUTĖS;5904710385;Ne;14;0;0;14
20737;"Pilaitukas (I. Kanto al. 7A)";BITUTĖS;1486895496;Ne;14;0;0;14
20738;"Pilaitukas (I. Kanto al. 7A)";BITUTĖS;1746050808;Ne;0;4;0;4
20739;"Pilaitukas (I. Kanto al. 7A)";BITUTĖS;9441608677;Ne;11;0;0;11
20740;"Pilaitukas (I. Kanto al. 7A)";BITUTĖS;7555601497;Ne;3;3;0;6
20741;"Pilaitukas (I. Kanto al. 7A)";BITUTĖS;5979852431;Ne;8;4;0;12
20742;"Pilaitukas (I. Kanto al. 7A)";BITUTĖS;9950619644;Ne;3;5;0;8
20743;"Pilaitukas (I. Kanto al. 7A)";BITUTĖS;2633256935;Ne;9;0;0;9
20744;"Pilaitukas (I. Kanto al. 7A)";BITUTĖS;8747053041;Ne;7;0;0;7
20745;"Pilaitukas (I. Kanto al. 7A)";BITUTĖS;6271751691;Ne;5;4;0;9
20746;"Pilaitukas (I. Kanto al. 7A)";BITUTĖS;9306169443;Ne;1;0;0;1
20747;"Pilaitukas (I. Kanto al. 7A)";BITUTĖS;1568651642;Ne;11;0;0;11
20748;"Pilaitukas (I. Kanto al. 7A)";BITUTĖS;5155899628;Ne;11;0;0;11
20749;"Pilaitukas (I. Kanto al. 7A)";BITUTĖS;5340877261;Ne;11;0;0;11
20750;"Pilaitukas (I. Kanto al. 7A)";BITUTĖS;6064545501;Ne;6;4;0;10
20751;"Pilaitukas (I. Kanto al. 7A)";BITUTĖS;3751157025;Ne;13;1;0;14
20752;"Pilaitukas (I. Kanto al. 7A)";BITUTĖS;7011500012;Ne;5;4;1;10
20753;"Pilaitukas (I. Kanto al. 7A)";ZUIKUČIAI;4118652467;Ne;6;5;0;11
20754;"Pilaitukas (I. Kanto al. 7A)";ZUIKUČIAI;1841240800;Ne;5;4;0;9
20755;"Pilaitukas (I. Kanto al. 7A)";ZUIKUČIAI;4710865219;Ne;5;4;0;9
20756;"Pilaitukas (I. Kanto al. 7A)";ZUIKUČIAI;6054821801;Ne;5;3;0;8
20757;"Pilaitukas (I. Kanto al. 7A)";ZUIKUČIAI;5691854235;Ne;0;0;2;2
20758;"Pilaitukas (I. Kanto al. 7A)";ZUIKUČIAI;3952708917;Ne;5;4;0;9
20759;"Pilaitukas (I. Kanto al. 7A)";ZUIKUČIAI;6337917448;Ne;10;3;0;13
20760;"Pilaitukas (I. Kanto al. 7A)";ZUIKUČIAI;3636976107;Ne;8;3;0;11
20761;"Pilaitukas (I. Kanto al. 7A)";ZUIKUČIAI;5026344198;Ne;0;4;0;4
20762;"Pilaitukas (I. Kanto al. 7A)";ZUIKUČIAI;8207648026;Ne;10;0;0;10
20763;"Pilaitukas (I. Kanto al. 7A)";ZUIKUČIAI;3921932673;Ne;10;0;0;10
20764;"Pilaitukas (I. Kanto al. 7A)";ZUIKUČIAI;5682244165;Ne;0;3;0;3
20765;"Pilaitukas (I. Kanto al. 7A)";ZUIKUČIAI;1290017967;Ne;0;7;0;7
20766;"Pilaitukas (I. Kanto al. 7A)";ZUIKUČIAI;5564784922;Ne;5;3;0;8
20767;"Pilaitukas (I. Kanto al. 7A)";ZUIKUČIAI;9327651233;Ne;10;4;0;14
20768;"Pilaitukas (I. Kanto al. 7A)";ZUIKUČIAI;9150579386;Ne;2;0;2;4
20769;"Pilaitukas (I. Kanto al. 7A)";ZUIKUČIAI;6238537739;Ne;4;0;4;8
20770;"Pilaitukas (I. Kanto al. 7A)";ZUIKUČIAI;6876537203;Ne;1;0;1;2
20771;"Pilaitukas (I. Kanto al. 7A)";ZUIKUČIAI;4312344789;Ne;2;4;0;6
20772;"Pilaitukas (I. Kanto al. 7A)";ZUIKUČIAI;1040103641;Ne;0;0;2;2
20773;"Pilaitukas (I. Kanto al. 7A)";ANČIUKAI;3357097410;Ne;0;1;1;2
20774;"Pilaitukas (I. Kanto al. 7A)";ANČIUKAI;7773318230;Ne;0;8;0;8
20775;"Pilaitukas (I. Kanto al. 7A)";ANČIUKAI;4097742120;Ne;0;2;0;2
20776;"Pilaitukas (I. Kanto al. 7A)";ANČIUKAI;2923272767;Ne;0;2;0;2
20777;"Pilaitukas (I. Kanto al. 7A)";ANČIUKAI;8620858011;Ne;5;4;0;9
20778;"Pilaitukas (I. Kanto al. 7A)";ANČIUKAI;4286388920;Ne;0;0;2;2
20779;"Pilaitukas (I. Kanto al. 7A)";ANČIUKAI;3761827714;Ne;0;4;3;7
20780;"Pilaitukas (I. Kanto al. 7A)";ANČIUKAI;8643066116;Ne;2;3;0;5
20781;"Pilaitukas (I. Kanto al. 7A)";ANČIUKAI;1120549352;Ne;4;0;0;4
20782;"Pilaitukas (I. Kanto al. 7A)";ANČIUKAI;6888607864;Ne;10;4;1;15
20783;"Pilaitukas (I. Kanto al. 7A)";ANČIUKAI;7876850509;Ne;0;3;0;3
20784;"Pilaitukas (I. Kanto al. 7A)";ANČIUKAI;3035456834;Ne;0;1;0;1
20785;"Pilaitukas (I. Kanto al. 7A)";ANČIUKAI;2476942319;Ne;0;1;0;1
20786;"Pilaitukas (I. Kanto al. 7A)";ANČIUKAI;8033540052;Ne;11;2;0;13
20787;"Pilaitukas (I. Kanto al. 7A)";ANČIUKAI;1781762820;Ne;1;5;0;6
20788;"Pilaitukas (I. Kanto al. 7A)";ANČIUKAI;7189824054;Ne;0;4;0;4
20789;"Pilaitukas (I. Kanto al. 7A)";ANČIUKAI;9332831979;Ne;0;4;0;4
20790;"Pilaitukas (I. Kanto al. 7A)";ANČIUKAI;5706918634;Ne;18;0;0;18
20791;"Pilaitukas (I. Kanto al. 7A)";ANČIUKAI;8954370321;Ne;5;4;1;10
20792;"Pilaitukas (I. Kanto al. 7A)";ANČIUKAI;1660462256;Ne;9;4;0;13
20793;"Pilaitukas (I. Kanto al. 7A)";MEŠKIUKAI;8577357264;Ne;6;3;0;9
20794;"Pilaitukas (I. Kanto al. 7A)";MEŠKIUKAI;5297214263;Ne;0;3;0;3
20795;"Pilaitukas (I. Kanto al. 7A)";MEŠKIUKAI;8268790017;Ne;4;1;0;5
20796;"Pilaitukas (I. Kanto al. 7A)";MEŠKIUKAI;2054626415;Ne;5;2;0;7
20797;"Pilaitukas (I. Kanto al. 7A)";MEŠKIUKAI;9742268665;Ne;13;0;0;13
20798;"Pilaitukas (I. Kanto al. 7A)";MEŠKIUKAI;8322980583;Ne;3;4;0;7
20799;"Pilaitukas (I. Kanto al. 7A)";MEŠKIUKAI;1610122884;Ne;3;4;0;7
20800;"Pilaitukas (I. Kanto al. 7A)";MEŠKIUKAI;3867660147;Ne;4;2;0;6
20801;"Pilaitukas (I. Kanto al. 7A)";MEŠKIUKAI;2365387089;Ne;0;3;0;3
20802;"Pilaitukas (I. Kanto al. 7A)";MEŠKIUKAI;9670329628;Ne;0;6;0;6
20803;"Pilaitukas (I. Kanto al. 7A)";MEŠKIUKAI;7750575554;Ne;5;6;0;11
20804;"Pilaitukas (I. Kanto al. 7A)";MEŠKIUKAI;9397435605;Ne;3;4;0;7
20805;"Pilaitukas (I. Kanto al. 7A)";MEŠKIUKAI;9187961584;Ne;1;1;0;2
20806;"Pilaitukas (I. Kanto al. 7A)";MEŠKIUKAI;7781507786;Ne;2;3;0;5
20807;"Pilaitukas (I. Kanto al. 7A)";MEŠKIUKAI;4171896175;Ne;0;3;0;3
20808;"Pilaitukas (I. Kanto al. 7A)";MEŠKIUKAI;1362132769;Ne;2;4;0;6
20809;"Pilaitukas (I. Kanto al. 7A)";MEŠKIUKAI;3027792710;Ne;0;4;0;4
20810;"Pilaitukas (I. Kanto al. 7A)";MEŠKIUKAI;6807166920;Ne;4;5;0;9
20811;"Pilaitukas (I. Kanto al. 7A)";MEŠKIUKAI;1591276987;Ne;0;2;0;2
20812;"Pilaitukas (I. Kanto al. 7A)";MEŠKIUKAI;2830212921;Ne;2;4;0;6
20813;"Pilaitukas (I. Kanto al. 7A)";MEŠKIUKAI;9930306085;Ne;11;1;0;12
20814;"Pilaitukas (I. Kanto al. 7A)";ŽUVYTĖS;2317213283;Ne;0;5;0;5
20815;"Pilaitukas (I. Kanto al. 7A)";ŽUVYTĖS;4353195155;Ne;0;7;0;7
20816;"Pilaitukas (I. Kanto al. 7A)";ŽUVYTĖS;8913709682;Ne;3;2;0;5
20817;"Pilaitukas (I. Kanto al. 7A)";ŽUVYTĖS;8877142428;Ne;0;4;1;5
20818;"Pilaitukas (I. Kanto al. 7A)";ŽUVYTĖS;2862447956;Ne;0;4;0;4
20819;"Pilaitukas (I. Kanto al. 7A)";ŽUVYTĖS;8727175656;Ne;0;4;0;4
20820;"Pilaitukas (I. Kanto al. 7A)";ŽUVYTĖS;8207194955;Ne;0;4;0;4
20821;"Pilaitukas (I. Kanto al. 7A)";ŽUVYTĖS;5640802570;Ne;8;3;0;11
20822;"Pilaitukas (I. Kanto al. 7A)";ŽUVYTĖS;8993885764;Ne;2;2;0;4
20823;"Pilaitukas (I. Kanto al. 7A)";ŽUVYTĖS;9260893320;Ne;0;2;0;2
20824;"Pilaitukas (I. Kanto al. 7A)";ŽUVYTĖS;5710747769;Ne;3;9;0;12
20825;"Pilaitukas (I. Kanto al. 7A)";ŽUVYTĖS;5206637809;Ne;0;4;2;6
20826;"Pilaitukas (I. Kanto al. 7A)";ŽUVYTĖS;5288784331;Ne;0;4;0;4
20827;"Pilaitukas (I. Kanto al. 7A)";ŽUVYTĖS;9688421636;Ne;0;2;1;3
20828;"Pilaitukas (I. Kanto al. 7A)";ŽUVYTĖS;1704055907;Ne;0;4;5;9
20829;"Pilaitukas (I. Kanto al. 7A)";ŽUVYTĖS;8255398803;Ne;9;5;0;14
20830;"Pilaitukas (I. Kanto al. 7A)";ŽUVYTĖS;6426415533;Ne;0;4;0;4
20831;"Pilaitukas (I. Kanto al. 7A)";ŽUVYTĖS;1607454890;Ne;5;4;0;9
20832;"Pilaitukas (I. Kanto al. 7A)";ŽUVYTĖS;9735358433;Ne;1;4;0;5
20833;"Pilaitukas (I. Kanto al. 7A)";ŽUVYTĖS;9878890346;Ne;0;4;0;4
20834;"Pilaitukas (I. Kanto al. 7A)";PAUKŠTELIAI;1295215465;Ne;0;5;0;5
20835;"Pilaitukas (I. Kanto al. 7A)";PAUKŠTELIAI;7082099968;Ne;0;12;0;12
20836;"Pilaitukas (I. Kanto al. 7A)";PAUKŠTELIAI;1253300093;Ne;1;5;0;6
20837;"Pilaitukas (I. Kanto al. 7A)";PAUKŠTELIAI;3037850837;Ne;0;2;0;2
20838;"Pilaitukas (I. Kanto al. 7A)";PAUKŠTELIAI;1729494874;Ne;0;4;0;4
20839;"Pilaitukas (I. Kanto al. 7A)";PAUKŠTELIAI;2242454299;Ne;0;3;0;3
20840;"Pilaitukas (I. Kanto al. 7A)";PAUKŠTELIAI;9793278788;Ne;0;4;0;4
20841;"Pilaitukas (I. Kanto al. 7A)";PAUKŠTELIAI;4082490488;Ne;1;5;0;6
20842;"Pilaitukas (I. Kanto al. 7A)";PAUKŠTELIAI;3345387791;Ne;0;7;0;7
20843;"Pilaitukas (I. Kanto al. 7A)";PAUKŠTELIAI;6099109886;Ne;0;5;0;5
20844;"Pilaitukas (I. Kanto al. 7A)";PAUKŠTELIAI;3913169122;Ne;1;4;0;5
20845;"Pilaitukas (I. Kanto al. 7A)";PAUKŠTELIAI;3541354283;Ne;4;2;0;6
20846;"Pilaitukas (I. Kanto al. 7A)";PAUKŠTELIAI;3519198814;Ne;0;4;0;4
20847;"Pilaitukas (I. Kanto al. 7A)";PAUKŠTELIAI;5740951665;Ne;3;4;0;7
20848;"Pilaitukas (I. Kanto al. 7A)";PAUKŠTELIAI;4591799893;Ne;14;4;0;18
20849;"Pilaitukas (I. Kanto al. 7A)";PAUKŠTELIAI;6308557885;Ne;5;4;0;9
20850;"Pilaitukas (I. Kanto al. 7A)";PAUKŠTELIAI;6514731102;Ne;8;4;0;12
20851;"Pilaitukas (I. Kanto al. 7A)";PAUKŠTELIAI;5331915157;Ne;0;5;0;5
20852;"Pilaitukas (I. Kanto al. 7A)";PAUKŠTELIAI;8169484415;Ne;0;4;0;4
20853;"Pilaitukas (I. Kanto al. 7A)";PAUKŠTELIAI;3159733673;Ne;3;4;0;7
20854;"Pilaitukas (I. Kanto al. 7A)";BORUŽĖLĖS;9898379569;Ne;0;4;0;4
20855;"Pilaitukas (I. Kanto al. 7A)";BORUŽĖLĖS;5185051301;Ne;0;7;1;8
20856;"Pilaitukas (I. Kanto al. 7A)";BORUŽĖLĖS;1731106179;Ne;0;10;0;10
20857;"Pilaitukas (I. Kanto al. 7A)";BORUŽĖLĖS;3784944532;Ne;5;4;0;9
20858;"Pilaitukas (I. Kanto al. 7A)";BORUŽĖLĖS;5186675623;Ne;1;1;0;2
20859;"Pilaitukas (I. Kanto al. 7A)";BORUŽĖLĖS;4317406707;Ne;0;4;0;4
20860;"Pilaitukas (I. Kanto al. 7A)";BORUŽĖLĖS;1944443723;Ne;9;4;0;13
20861;"Pilaitukas (I. Kanto al. 7A)";BORUŽĖLĖS;6280870972;Ne;0;5;4;9
20862;"Pilaitukas (I. Kanto al. 7A)";BORUŽĖLĖS;8380819975;Ne;0;4;0;4
20863;"Pilaitukas (I. Kanto al. 7A)";BORUŽĖLĖS;3849247594;Ne;0;13;0;13
20864;"Pilaitukas (I. Kanto al. 7A)";BORUŽĖLĖS;5201301769;Ne;0;4;0;4
20865;"Pilaitukas (I. Kanto al. 7A)";BORUŽĖLĖS;2555073719;Ne;6;4;1;11
20866;"Pilaitukas (I. Kanto al. 7A)";BORUŽĖLĖS;6835592675;Ne;7;5;3;15
20867;"Pilaitukas (I. Kanto al. 7A)";BORUŽĖLĖS;5066594124;Ne;2;4;0;6
20868;"Pilaitukas (I. Kanto al. 7A)";BORUŽĖLĖS;2336933998;Ne;1;2;0;3
20869;"Pilaitukas (I. Kanto al. 7A)";BORUŽĖLĖS;8047683859;Ne;9;4;0;13
20870;"Pilaitukas (I. Kanto al. 7A)";BORUŽĖLĖS;8694369154;Ne;9;4;0;13
20871;"Pilaitukas (I. Kanto al. 7A)";BORUŽĖLĖS;9587140991;Ne;6;4;2;12
20872;"Pilaitukas (I. Kanto al. 7A)";BORUŽĖLĖS;9405479859;Ne;0;4;0;4
20873;"Pilaitukas (I. Kanto al. 7A)";DRUGELIAI;2917197418;Ne;7;4;0;11
20874;"Pilaitukas (I. Kanto al. 7A)";DRUGELIAI;7807341574;Ne;5;4;1;10
20875;"Pilaitukas (I. Kanto al. 7A)";DRUGELIAI;5215800828;Ne;0;5;0;5
20876;"Pilaitukas (I. Kanto al. 7A)";DRUGELIAI;2414941263;Ne;6;0;8;14
20877;"Pilaitukas (I. Kanto al. 7A)";DRUGELIAI;7830059468;Ne;7;4;0;11
20878;"Pilaitukas (I. Kanto al. 7A)";DRUGELIAI;5901884512;Ne;0;4;0;4
20879;"Pilaitukas (I. Kanto al. 7A)";DRUGELIAI;8710069256;Ne;15;0;0;15
20880;"Pilaitukas (I. Kanto al. 7A)";DRUGELIAI;3609692114;Ne;12;0;4;16
20881;"Pilaitukas (I. Kanto al. 7A)";DRUGELIAI;9601295632;Ne;4;0;4;8
20882;"Pilaitukas (I. Kanto al. 7A)";DRUGELIAI;2768655540;Ne;15;0;0;15
20883;"Pilaitukas (I. Kanto al. 7A)";DRUGELIAI;1052452915;Ne;15;0;0;15
20884;"Pilaitukas (I. Kanto al. 7A)";DRUGELIAI;7478616628;Ne;0;4;0;4
20885;"Pilaitukas (I. Kanto al. 7A)";DRUGELIAI;1134083816;Ne;13;1;0;14
20886;"Pilaitukas (I. Kanto al. 7A)";DRUGELIAI;1452645899;Ne;5;4;2;11
20887;"Pilaitukas (I. Kanto al. 7A)";DRUGELIAI;8092422909;Ne;0;0;9;9
20888;"Pilaitukas (I. Kanto al. 7A)";PELIUKAI;9246925227;Ne;4;0;0;4
20889;"Pilaitukas (I. Kanto al. 7A)";PELIUKAI;7808204054;Ne;1;1;0;2
20890;"Pilaitukas (I. Kanto al. 7A)";PELIUKAI;8769116377;Ne;2;0;0;2
20891;"Pilaitukas (I. Kanto al. 7A)";PELIUKAI;8501376663;Ne;0;4;0;4
20892;"Pilaitukas (I. Kanto al. 7A)";PELIUKAI;5421602723;Ne;10;6;0;16
20893;"Pilaitukas (I. Kanto al. 7A)";PELIUKAI;6754825353;Ne;0;4;0;4
20894;"Pilaitukas (I. Kanto al. 7A)";PELIUKAI;8168228529;Ne;0;4;0;4
20895;"Pilaitukas (I. Kanto al. 7A)";PELIUKAI;6833933586;Ne;0;5;0;5
20896;"Pilaitukas (I. Kanto al. 7A)";PELIUKAI;2416277190;Ne;8;0;0;8
20897;"Pilaitukas (I. Kanto al. 7A)";PELIUKAI;1270365948;Ne;0;1;0;1
20898;"Pilaitukas (I. Kanto al. 7A)";PELIUKAI;7604004800;Ne;0;5;0;5
20899;"Pilaitukas (I. Kanto al. 7A)";PELIUKAI;9556421129;Ne;7;0;0;7
20900;"Pilaitukas (I. Kanto al. 7A)";PELIUKAI;3954210452;Ne;0;2;0;2
20901;"Pilaitukas (I. Kanto al. 7A)";PELIUKAI;3651140874;Ne;0;3;0;3
20902;"Pilaitukas (I. Kanto al. 7A)";PELIUKAI;2823859128;Ne;1;4;1;6
20903;"Pilaitukas (I. Kanto al. 7A)";PELIUKAI;7750936973;Ne;5;4;0;9
20904;"Pilaitukas (I. Kanto al. 7A)";PELIUKAI;6185954940;Ne;4;0;0;4
20905;"Pilaitukas (I. Kanto al. 7A)";PELIUKAI;1781241002;Ne;0;0;3;3
20906;"Pilaitukas (I. Kanto al. 7A)";PELIUKAI;7766403199;Ne;4;4;0;8
20907;"Pilaitukas (I. Kanto al. 7A)";PELIUKAI;4383174356;Ne;2;0;0;2
20908;"Pilaitukas (I. Kanto al. 7A)";KAČIUKAI;1585341963;Ne;0;4;0;4
20909;"Pilaitukas (I. Kanto al. 7A)";KAČIUKAI;9038324313;Ne;0;4;0;4
20910;"Pilaitukas (I. Kanto al. 7A)";KAČIUKAI;7594484959;Ne;6;4;0;10
20911;"Pilaitukas (I. Kanto al. 7A)";KAČIUKAI;2463482642;Ne;0;6;1;7
20912;"Pilaitukas (I. Kanto al. 7A)";KAČIUKAI;3080014745;Ne;13;1;0;14
20913;"Pilaitukas (I. Kanto al. 7A)";KAČIUKAI;6525191057;Ne;0;0;2;2
20914;"Pilaitukas (I. Kanto al. 7A)";KAČIUKAI;8009040109;Ne;10;4;0;14
20915;"Pilaitukas (I. Kanto al. 7A)";KAČIUKAI;2105380328;Ne;0;2;0;2
20916;"Pilaitukas (I. Kanto al. 7A)";KAČIUKAI;5326689274;Ne;5;4;1;10
20917;"Pilaitukas (I. Kanto al. 7A)";KAČIUKAI;9653647227;Ne;10;4;0;14
20918;"Pilaitukas (I. Kanto al. 7A)";KAČIUKAI;4022543517;Ne;0;2;0;2
20919;"Pilaitukas (I. Kanto al. 7A)";KAČIUKAI;3825942473;Ne;0;9;0;9
20920;"Pilaitukas (I. Kanto al. 7A)";KAČIUKAI;1611371690;Ne;4;0;6;10
20921;"Pilaitukas (I. Kanto al. 7A)";KAČIUKAI;9247501721;Ne;1;1;0;2
20922;"Pilaitukas (I. Kanto al. 7A)";KAČIUKAI;6436694057;Ne;0;3;0;3
20923;"Pilaitukas (I. Kanto al. 7A)";KAČIUKAI;9974310580;Ne;2;1;0;3
20924;"Pilaitukas (I. Kanto al. 7A)";KAČIUKAI;6235375235;Ne;3;4;4;11
20925;"Pilaitukas (I. Kanto al. 7A)";KAČIUKAI;9914575692;Ne;0;3;0;3
20926;"Pilaitukas (I. Kanto al. 7A)";KAČIUKAI;4341157841;Ne;1;0;0;1
20927;"Pilaitukas (I. Kanto al. 7A)";SAULUTĖS;2110996493;Ne;15;0;0;15
20928;"Pilaitukas (I. Kanto al. 7A)";SAULUTĖS;8306015313;Ne;12;3;0;15
20929;"Pilaitukas (I. Kanto al. 7A)";SAULUTĖS;8801358120;Ne;4;0;0;4
20930;"Pilaitukas (I. Kanto al. 7A)";SAULUTĖS;3927713632;Ne;3;0;0;3
20931;"Pilaitukas (I. Kanto al. 7A)";SAULUTĖS;1970389617;Ne;12;0;0;12
20932;"Pilaitukas (I. Kanto al. 7A)";SAULUTĖS;1351676866;Ne;14;0;0;14
20933;"Pilaitukas (I. Kanto al. 7A)";SAULUTĖS;4947536980;Ne;14;0;0;14
20934;"Pilaitukas (I. Kanto al. 7A)";SAULUTĖS;8484807843;Ne;7;0;0;7
20935;"Pilaitukas (I. Kanto al. 7A)";SAULUTĖS;8586082743;Ne;7;0;0;7
20936;"Pilaitukas (I. Kanto al. 7A)";SAULUTĖS;8693322790;Ne;9;0;0;9
20937;"Pilaitukas (I. Kanto al. 7A)";SAULUTĖS;1294204962;Ne;1;7;0;8
20938;"Pilaitukas (I. Kanto al. 7A)";SAULUTĖS;9041750889;Ne;0;19;0;19
20939;"Pilaitukas (I. Kanto al. 7A)";MENULIUKAI;1620231835;Ne;4;2;0;6
20940;"Pilaitukas (I. Kanto al. 7A)";MENULIUKAI;8873155277;Ne;9;3;0;12
20941;"Pilaitukas (I. Kanto al. 7A)";MENULIUKAI;1532252453;Ne;0;8;0;8
20942;"Pilaitukas (I. Kanto al. 7A)";MENULIUKAI;8225571149;Ne;9;4;0;13
20943;"Pilaitukas (I. Kanto al. 7A)";MENULIUKAI;7855892595;Ne;7;1;0;8
20944;"Pilaitukas (I. Kanto al. 7A)";MENULIUKAI;8058057477;Ne;11;4;0;15
20945;"Pilaitukas (I. Kanto al. 7A)";MENULIUKAI;7369920743;Ne;5;4;0;9
20946;"Pilaitukas (I. Kanto al. 7A)";MENULIUKAI;9106756175;Ne;11;0;0;11
20947;"Pilaitukas (I. Kanto al. 7A)";MENULIUKAI;5213352941;Ne;7;0;1;8
20948;"Pilaitukas (I. Kanto al. 7A)";MENULIUKAI;4811066607;Ne;2;0;0;2
20949;"Pilaitukas (I. Kanto al. 7A)";MENULIUKAI;4917076546;Ne;3;0;0;3
20950;"Pilaitukas (I. Kanto al. 7A)";MENULIUKAI;9800474455;Taip;5;5;0;10
20951;"Pilaitukas (I. Kanto al. 7A)";MENULIUKAI;2215317686;Ne;2;0;1;3
20952;"Pilaitukas (I. Kanto al. 7A)";MENULIUKAI;1528707459;Ne;16;0;0;16
20953;"Pilaitukas (I. Kanto al. 7A)";ĖŽIUKAI;6019760696;Ne;3;4;0;7
20954;"Pilaitukas (I. Kanto al. 7A)";ĖŽIUKAI;2342453729;Ne;0;5;0;5
20955;"Pilaitukas (I. Kanto al. 7A)";ĖŽIUKAI;2484405944;Ne;5;0;3;8
20956;"Pilaitukas (I. Kanto al. 7A)";ĖŽIUKAI;3283178614;Ne;8;1;0;9
20957;"Pilaitukas (I. Kanto al. 7A)";ĖŽIUKAI;4577941964;Ne;0;4;0;4
20958;"Pilaitukas (I. Kanto al. 7A)";ĖŽIUKAI;9099718179;Ne;3;0;0;3
20959;"Pilaitukas (I. Kanto al. 7A)";ĖŽIUKAI;7075283592;Ne;0;6;0;6
20960;"Pilaitukas (I. Kanto al. 7A)";ĖŽIUKAI;8312146534;Ne;0;4;0;4
20961;"Pilaitukas (I. Kanto al. 7A)";ĖŽIUKAI;2982393064;Ne;2;0;1;3
20962;"Pilaitukas (I. Kanto al. 7A)";ĖŽIUKAI;1251079289;Ne;6;1;0;7
20963;"Pilaitukas (I. Kanto al. 7A)";ĖŽIUKAI;2600504692;Ne;0;19;0;19
20964;"Pilaitukas (I. Kanto al. 7A)";ĖŽIUKAI;2717071397;Ne;15;4;0;19
20965;"Pilaitukas (I. Kanto al. 7A)";ĖŽIUKAI;9577523612;Ne;0;0;3;3
20966;"Pilaitukas (I. Kanto al. 7A)";ĖŽIUKAI;6509866343;Ne;0;0;3;3
20967;Švelnukas;Pelėdžiukai;8016531082;Ne;0;4;0;4
20968;Švelnukas;Pelėdžiukai;8219071968;Ne;1;3;1;5
20969;Švelnukas;Pelėdžiukai;9008722163;Ne;2;4;1;7
20970;Švelnukas;Pelėdžiukai;5699300764;Ne;1;0;4;5
20971;Švelnukas;Pelėdžiukai;1116279011;Ne;7;0;0;7
20972;Švelnukas;Pelėdžiukai;3892058023;Ne;7;0;0;7
20973;Švelnukas;Pelėdžiukai;5681611554;Ne;0;0;2;2
20974;Švelnukas;Pelėdžiukai;8589226595;Ne;19;0;0;19
20975;Švelnukas;Pelėdžiukai;9802064955;Ne;0;4;0;4
20976;Švelnukas;Pelėdžiukai;5041138716;Ne;0;3;0;3
20977;Švelnukas;Pelėdžiukai;3804532959;Ne;0;5;0;5
20978;Švelnukas;Pelėdžiukai;1462620951;Ne;0;2;0;2
20979;Švelnukas;Pelėdžiukai;8650902343;Ne;0;4;0;4
20980;Švelnukas;Pelėdžiukai;1409803554;Ne;1;3;0;4
20981;Švelnukas;Pelėdžiukai;1991507109;Ne;11;3;0;14
20982;Švelnukas;Pelėdžiukai;9808833734;Ne;6;0;1;7
20983;Švelnukas;Pelėdžiukai;6318581157;Ne;1;0;3;4
20984;Švelnukas;Pelėdžiukai;6069027553;Ne;6;0;3;9
20985;Švelnukas;Pelėdžiukai;9814032171;Ne;7;3;0;10
20986;Švelnukas;Pelėdžiukai;7489142128;Ne;0;0;2;2
20987;Švelnukas;Ežiukai;4711482287;Ne;6;3;0;9
20988;Švelnukas;Ežiukai;2892176166;Ne;0;1;0;1
20989;Švelnukas;Ežiukai;2400781175;Ne;0;1;0;1
20990;Švelnukas;Ežiukai;6209334207;Ne;10;1;0;11
20991;Švelnukas;Ežiukai;1201550386;Ne;0;4;0;4
20992;Švelnukas;Ežiukai;2348752207;Ne;0;19;0;19
20993;Švelnukas;Ežiukai;1143579276;Ne;0;0;3;3
20994;Švelnukas;Ežiukai;3645855145;Ne;0;4;0;4
20995;Švelnukas;Ežiukai;9402567487;Ne;7;2;0;9
20996;Švelnukas;Ežiukai;8569985034;Ne;1;2;0;3
20997;Švelnukas;Ežiukai;3235768013;Taip;0;4;0;4
20998;Švelnukas;Ežiukai;9347355242;Ne;2;0;1;3
20999;Švelnukas;Ežiukai;3832011837;Ne;2;1;0;3
21000;Švelnukas;Ežiukai;9829912750;Ne;1;4;0;5
21001;Švelnukas;Ežiukai;9394816723;Ne;1;2;0;3
21002;Švelnukas;Ežiukai;6658530716;Ne;3;0;5;8
21003;Švelnukas;Ežiukai;6004580752;Ne;0;4;0;4
21004;Švelnukas;Ežiukai;4035050422;Ne;7;0;0;7
21005;Švelnukas;Ežiukai;4048599050;Ne;9;0;0;9
21006;Švelnukas;Ežiukai;9712567632;Ne;8;0;1;9
21007;Švelnukas;Ežiukai;2106591525;Ne;1;2;0;3
21008;Švelnukas;Švelnukai;4681584014;Ne;0;4;2;6
21009;Švelnukas;Švelnukai;6607578153;Ne;0;0;1;1
21010;Švelnukas;Švelnukai;8847738918;Ne;0;3;1;4
21011;Švelnukas;Švelnukai;1982267458;Ne;0;2;0;2
21012;Švelnukas;Švelnukai;9766734938;Ne;0;3;0;3
21013;Švelnukas;Švelnukai;3020524039;Ne;2;4;0;6
21014;Švelnukas;Švelnukai;1411710913;Ne;0;4;0;4
21015;Švelnukas;Švelnukai;2464467471;Ne;1;4;0;5
21016;Švelnukas;Švelnukai;5032829856;Ne;0;4;0;4
21017;Švelnukas;Švelnukai;5213589179;Ne;0;7;0;7
21018;Švelnukas;Švelnukai;4544791546;Ne;0;4;0;4
21019;Švelnukas;Švelnukai;1963518457;Ne;2;4;0;6
21020;Švelnukas;Švelnukai;4194249709;Ne;2;4;0;6
21021;Švelnukas;Švelnukai;5936821902;Ne;0;0;4;4
21022;Švelnukas;Švelnukai;7607215137;Ne;2;4;0;6
21023;Švelnukas;Švelnukai;4629757899;Ne;5;4;0;9
21024;Švelnukas;Švelnukai;6964997767;Ne;0;4;1;5
21025;Švelnukas;Švelnukai;8951810066;Ne;0;0;2;2
21026;Švelnukas;Švelnukai;2663990082;Ne;0;4;0;4
21027;Švelnukas;Švelnukai;6204286255;Ne;0;1;2;3
21028;Švelnukas;Švelnukai;5960966542;Ne;3;5;0;8
21029;Švelnukas;Boružiukai;1951447127;Ne;0;4;2;6
21030;Švelnukas;Boružiukai;3849957906;Ne;0;4;2;6
21031;Švelnukas;Boružiukai;5550841477;Ne;5;4;0;9
21032;Švelnukas;Boružiukai;9722532034;Ne;0;3;0;3
21033;Švelnukas;Boružiukai;1264256177;Ne;0;3;2;5
21034;Švelnukas;Boružiukai;1332533332;Ne;0;4;1;5
21035;Švelnukas;Boružiukai;8787505507;Ne;0;2;0;2
21036;Švelnukas;Boružiukai;4134678301;Ne;0;4;1;5
21037;Švelnukas;Boružiukai;8458233793;Ne;0;4;5;9
21038;Švelnukas;Boružiukai;7967996032;Ne;3;1;2;6
21039;Švelnukas;Boružiukai;8951980999;Ne;0;2;3;5
21040;Švelnukas;Boružiukai;4990399144;Ne;4;8;0;12
21041;Švelnukas;Boružiukai;9575767514;Ne;0;3;4;7
21042;Švelnukas;Boružiukai;6282137936;Ne;0;6;0;6
21043;Švelnukas;Boružiukai;9479536507;Ne;0;3;0;3
21044;Švelnukas;Boružiukai;2088128734;Ne;0;4;1;5
21045;Švelnukas;Boružiukai;2077614498;Ne;0;4;0;4
21046;Švelnukas;Boružiukai;3145935641;Ne;0;4;1;5
21047;Švelnukas;Boružiukai;4404904322;Ne;0;4;4;8
21048;Švelnukas;Boružiukai;3561920685;Ne;0;2;3;5
21049;Švelnukas;Boružiukai;8895028305;Ne;0;4;0;4
21050;Švelnukas;Boružiukai;4961854528;Ne;0;4;1;5
21051;Švelnukas;Boružiukai;4823928859;Ne;4;0;0;4
21052;Švelnukas;Smalsučiai;9558811523;Ne;0;4;4;8
21053;Švelnukas;Smalsučiai;5085517759;Ne;0;4;0;4
21054;Švelnukas;Smalsučiai;1661019352;Ne;0;2;0;2
21055;Švelnukas;Smalsučiai;5554625346;Ne;0;1;3;4
21056;Švelnukas;Smalsučiai;3282020958;Ne;0;1;3;4
21057;Švelnukas;Smalsučiai;2730288544;Ne;0;4;0;4
21058;Švelnukas;Smalsučiai;5805289419;Ne;0;0;4;4
21059;Švelnukas;Smalsučiai;1415899173;Ne;0;3;0;3
21060;Švelnukas;Smalsučiai;8193690277;Ne;0;5;1;6
21061;Švelnukas;Smalsučiai;3472774028;Ne;0;0;3;3
21062;Švelnukas;Smalsučiai;5845744917;Ne;0;4;5;9
21063;Švelnukas;Smalsučiai;6764222588;Ne;0;4;14;18
21064;Švelnukas;Smalsučiai;1840752560;Ne;0;5;0;5
21065;Švelnukas;Smalsučiai;8268391509;Taip;0;4;0;4
21066;Švelnukas;Smalsučiai;4467095100;Ne;0;0;3;3
21067;Švelnukas;Smalsučiai;7125883267;Ne;10;0;0;10
21068;Švelnukas;Smalsučiai;8210720087;Ne;1;4;1;6
21069;Švelnukas;Smalsučiai;4427274462;Ne;2;0;0;2
21070;Švelnukas;Smalsučiai;1836913588;Ne;0;0;1;1
21071;Švelnukas;Smalsučiai;6155098464;Ne;0;0;2;2
21072;Švelnukas;Smalsučiai;1100719254;Ne;0;4;0;4
21073;Švelnukas;Smalsučiai;8829819783;Ne;0;4;8;12
21074;Švelnukas;Nykštukai;1058623863;Ne;12;4;0;16
21075;Švelnukas;Nykštukai;7987715134;Ne;0;0;1;1
21076;Švelnukas;Nykštukai;3455801077;Ne;0;0;6;6
21077;Švelnukas;Nykštukai;9371102717;Ne;0;19;0;19
21078;Švelnukas;Nykštukai;6714948468;Ne;0;0;2;2
21079;Švelnukas;Nykštukai;5969852813;Ne;0;19;0;19
21080;Švelnukas;Nykštukai;5483481191;Ne;4;0;4;8
21081;Švelnukas;Nykštukai;5097880045;Ne;0;0;6;6
21082;Švelnukas;Nykštukai;8572664468;Ne;0;0;5;5
21083;Švelnukas;Nykštukai;1983560609;Ne;9;0;0;9
21084;Švelnukas;Nykštukai;6135073159;Ne;6;4;2;12
21085;Švelnukas;Nykštukai;6731324414;Ne;2;0;1;3
21086;Švelnukas;Nykštukai;5066121542;Ne;2;0;2;4
21087;Švelnukas;Nykštukai;3173070733;Ne;0;5;0;5
21088;Boružėlė;"Nykštukai gudručiai";7736917485;Ne;0;19;0;19
21089;Boružėlė;"Nykštukai gudručiai";9520696660;Ne;0;5;14;19
21090;Boružėlė;"Nykštukai gudručiai";5691884576;Ne;8;4;0;12
21091;Boružėlė;"Nykštukai gudručiai";9193273478;Ne;19;0;0;19
21092;Boružėlė;"Nykštukai gudručiai";3237771499;Ne;5;4;0;9
21093;Boružėlė;"Nykštukai gudručiai";8359957290;Ne;0;4;0;4
21094;Boružėlė;"Nykštukai gudručiai";8141240094;Ne;0;4;0;4
21095;Boružėlė;"Nykštukai gudručiai";2349571778;Ne;4;2;0;6
21096;Boružėlė;"Nykštukai gudručiai";1894170218;Ne;4;1;0;5
21097;Boružėlė;"Nykštukai gudručiai";3509512899;Ne;12;0;0;12
21098;Boružėlė;"Nykštukai gudručiai";8888151470;Ne;12;0;0;12
21099;Boružėlė;"Nykštukai gudručiai";3430953692;Ne;8;7;0;15
21100;Boružėlė;"Nykštukai gudručiai";6166247730;Ne;0;2;0;2
21101;Boružėlė;"Nykštukai gudručiai";8365962523;Ne;3;7;0;10
21102;Boružėlė;"Nykštukai gudručiai";6876323023;Ne;0;6;0;6
21103;Boružėlė;"Nykštukai gudručiai";2744894565;Ne;11;4;0;15
21104;Boružėlė;"Nykštukai gudručiai";6590829182;Ne;0;7;1;8
21105;Boružėlė;"Nykštukai gudručiai";3129825206;Ne;0;6;0;6
21106;Boružėlė;"Nykštukai gudručiai";9771767352;Ne;12;0;0;12
21107;Boružėlė;"Nykštukai gudručiai";8789209196;Ne;0;4;0;4
21108;Boružėlė;"Nykštukai gudručiai";2571360077;Ne;0;4;0;4
21109;Boružėlė;"Nykštukai gudručiai";9078805020;Ne;0;1;0;1
21110;Boružėlė;"Saulės zuikučiai";4554260776;Ne;0;4;0;4
21111;Boružėlė;"Saulės zuikučiai";5298170118;Ne;8;4;0;12
21112;Boružėlė;"Saulės zuikučiai";2133849514;Ne;0;6;0;6
21113;Boružėlė;"Saulės zuikučiai";1116012068;Ne;0;2;2;4
21114;Boružėlė;"Saulės zuikučiai";1292298259;Ne;0;4;2;6
21115;Boružėlė;"Saulės zuikučiai";3130977416;Ne;0;6;0;6
21116;Boružėlė;"Saulės zuikučiai";7256396576;Ne;0;2;1;3
21117;Boružėlė;"Saulės zuikučiai";4323998138;Ne;0;0;6;6
21118;Boružėlė;"Saulės zuikučiai";2087238951;Ne;0;4;0;4
21119;Boružėlė;"Saulės zuikučiai";4509233532;Ne;0;6;0;6
21120;Boružėlė;"Saulės zuikučiai";3952645542;Ne;1;8;0;9
21121;Boružėlė;"Saulės zuikučiai";5516103398;Ne;0;0;8;8
21122;Boružėlė;"Saulės zuikučiai";8259586236;Ne;0;3;0;3
21123;Boružėlė;"Saulės zuikučiai";3955841578;Ne;0;3;0;3
21124;Boružėlė;"Saulės zuikučiai";1583223569;Ne;0;3;0;3
21125;Boružėlė;"Saulės zuikučiai";4433248526;Ne;3;2;0;5
21126;Boružėlė;"Saulės zuikučiai";1547802140;Ne;0;0;6;6
21127;Boružėlė;"Saulės zuikučiai";4020348640;Ne;5;0;3;8
21128;Boružėlė;"Saulės zuikučiai";2842256033;Ne;0;2;2;4
21129;Boružėlė;"Saulės zuikučiai";2561969142;Ne;0;2;3;5
21130;Boružėlė;"Saulės zuikučiai";7262515868;Ne;0;5;0;5
21131;Boružėlė;"Saulės zuikučiai";6527254253;Ne;0;5;0;5
21132;Boružėlė;"Saulės zuikučiai";7942043844;Ne;0;4;0;4
21133;Boružėlė;"Saulės zuikučiai";2515608520;Ne;0;2;3;5
21134;Boružėlė;Gėlytės;1146297996;Ne;0;4;0;4
21135;Boružėlė;Gėlytės;3288141024;Ne;3;4;0;7
21136;Boružėlė;Gėlytės;1166207929;Ne;12;1;0;13
21137;Boružėlė;Gėlytės;7956982615;Ne;0;4;0;4
21138;Boružėlė;Gėlytės;4637656311;Ne;0;4;0;4
21139;Boružėlė;Gėlytės;3226733236;Ne;0;5;0;5
21140;Boružėlė;Gėlytės;6070356395;Ne;0;5;0;5
21141;Boružėlė;Gėlytės;4180537253;Ne;4;4;0;8
21142;Boružėlė;Gėlytės;6722353853;Ne;0;6;1;7
21143;Boružėlė;Gėlytės;8376436755;Ne;0;1;0;1
21144;Boružėlė;Gėlytės;3300678477;Ne;0;3;0;3
21145;Boružėlė;Gėlytės;7763958937;Ne;0;4;0;4
21146;Boružėlė;Gėlytės;9855354210;Ne;0;3;6;9
21147;Boružėlė;Gėlytės;3354291446;Ne;0;10;0;10
21148;Boružėlė;Gėlytės;8520403894;Ne;19;0;0;19
21149;Boružėlė;Gėlytės;4268486154;Ne;0;11;0;11
21150;Boružėlė;Gėlytės;7614216150;Ne;0;2;0;2
21151;Boružėlė;Gėlytės;4448964310;Ne;4;1;0;5
21152;Boružėlė;Gėlytės;8205706322;Ne;0;6;3;9
21153;Boružėlė;Gėlytės;8834231529;Ne;10;3;0;13
21154;Boružėlė;Gėlytės;8929444125;Ne;3;1;1;5
21155;Boružėlė;Gėlytės;3604658753;Ne;0;4;0;4
21156;Boružėlė;Gėlytės;9255292099;Ne;0;5;0;5
21157;Boružėlė;Smalsutis;2629139832;Ne;0;1;0;1
21158;Boružėlė;Smalsutis;4125177837;Ne;4;5;0;9
21159;Boružėlė;Smalsutis;6734750713;Ne;4;4;0;8
21160;Boružėlė;Smalsutis;5456349784;Ne;3;0;2;5
21161;Boružėlė;Smalsutis;9615931888;Ne;2;0;1;3
21162;Boružėlė;Smalsutis;9993823313;Ne;13;2;1;16
21163;Boružėlė;Smalsutis;5108107657;Ne;0;1;2;3
21164;Boružėlė;Smalsutis;3891448188;Ne;0;0;4;4
21165;Boružėlė;Smalsutis;4606274286;Ne;0;15;0;15
21166;Boružėlė;Smalsutis;8956248864;Ne;5;0;1;6
21167;Boružėlė;Smalsutis;8239372270;Ne;5;5;0;10
21168;Boružėlė;Smalsutis;6057263329;Ne;0;0;4;4
21169;Boružėlė;Smalsutis;7132100212;Ne;0;0;4;4
21170;Boružėlė;Smalsutis;6367963436;Ne;7;5;1;13
21171;Boružėlė;Smalsutis;5220224249;Ne;5;0;3;8
21172;Boružėlė;Smalsutis;1969793682;Ne;5;5;0;10
21173;Boružėlė;Smalsutis;6767206150;Ne;3;1;4;8
21174;Boružėlė;Smalsutis;6430695398;Ne;4;5;0;9
21175;Boružėlė;Smalsutis;4859297816;Ne;0;0;3;3
21176;Boružėlė;Smalsutis;6599359132;Ne;0;0;1;1
21177;Boružėlė;Smalsutis;7089148766;Ne;0;2;2;4
21178;Boružėlė;Drugeliai;8357946299;Ne;0;2;0;2
21179;Boružėlė;Drugeliai;1130980139;Ne;0;4;0;4
21180;Boružėlė;Drugeliai;6463583187;Ne;0;4;0;4
21181;Boružėlė;Drugeliai;3136028536;Ne;2;2;0;4
21182;Boružėlė;Drugeliai;2211576663;Ne;0;2;0;2
21183;Boružėlė;Drugeliai;1559001916;Ne;5;2;0;7
21184;Boružėlė;Drugeliai;4233602822;Ne;0;4;0;4
21185;Boružėlė;Drugeliai;9463322491;Ne;0;4;0;4
21186;Boružėlė;Drugeliai;3108758436;Ne;8;0;0;8
21187;Boružėlė;Drugeliai;8482813204;Ne;2;2;0;4
21188;Boružėlė;Drugeliai;6369070055;Ne;9;0;0;9
21189;Boružėlė;Drugeliai;6902130914;Ne;3;2;0;5
21190;Boružėlė;Drugeliai;3459207879;Ne;6;1;0;7
21191;Boružėlė;Drugeliai;6980022864;Ne;0;4;0;4
21192;Boružėlė;Drugeliai;7756929745;Ne;0;4;0;4
21193;Boružėlė;Drugeliai;5726187445;Ne;5;1;0;6
21194;Boružėlė;Drugeliai;2308405580;Ne;1;10;0;11
21195;Boružėlė;Drugeliai;6049501362;Ne;0;2;0;2
21196;Boružėlė;Drugeliai;8213060214;Ne;2;0;0;2
21197;Boružėlė;Drugeliai;3331238309;Ne;19;0;0;19
21198;Boružėlė;Drugeliai;2783338563;Ne;0;4;0;4
21199;Boružėlė;Drugeliai;3271262071;Ne;0;4;0;4
21200;Boružėlė;Vyturėliai;7934628014;Ne;9;0;0;9
21201;Boružėlė;Vyturėliai;7887412867;Ne;9;1;0;10
21202;Boružėlė;Vyturėliai;6233993159;Ne;1;0;4;5
21203;Boružėlė;Vyturėliai;6721005189;Ne;0;1;0;1
21204;Boružėlė;Vyturėliai;3991218067;Ne;10;4;0;14
21205;Boružėlė;Vyturėliai;3331139963;Ne;7;0;0;7
21206;Boružėlė;Vyturėliai;2104101406;Ne;6;1;0;7
21207;Boružėlė;Vyturėliai;8377410278;Ne;5;1;3;9
21208;Boružėlė;Vyturėliai;4928818565;Ne;10;0;0;10
21209;Boružėlė;Vyturėliai;5619719965;Ne;5;1;0;6
21210;Boružėlė;Vyturėliai;9822629428;Ne;0;2;0;2
21211;Boružėlė;Vyturėliai;9663535338;Ne;0;2;0;2
21212;Boružėlė;Vyturėliai;8073918985;Ne;13;0;0;13
21213;Boružėlė;Vyturėliai;1047419932;Ne;0;9;0;9
21214;Boružėlė;Vyturėliai;1929202434;Ne;19;0;0;19
21215;Boružėlė;Vyturėliai;4217116059;Ne;0;2;0;2
21216;Boružėlė;Vyturėliai;8165748779;Ne;10;1;0;11
21217;Boružėlė;Vyturėliai;7068409148;Ne;9;1;1;11
21218;Boružėlė;Vyturėliai;8434178580;Ne;2;1;0;3
21219;Boružėlė;Vyturėliai;1551933321;Ne;11;0;0;11
21220;Boružėlė;Vyturėliai;2084361709;Ne;0;2;1;3
21221;Boružėlė;Vyturėliai;3281431237;Ne;13;0;0;13
21222;Boružėlė;Žvaigždutės;4990831292;Ne;6;0;0;6
21223;Boružėlė;Žvaigždutės;9838823214;Ne;0;4;0;4
21224;Boružėlė;Žvaigždutės;7825636053;Ne;0;5;0;5
21225;Boružėlė;Žvaigždutės;7901880926;Ne;5;4;1;10
21226;Boružėlė;Žvaigždutės;6242220139;Ne;2;5;0;7
21227;Boružėlė;Žvaigždutės;3489498503;Ne;0;8;2;10
21228;Boružėlė;Žvaigždutės;5274016839;Ne;0;4;0;4
21229;Boružėlė;Žvaigždutės;9720535449;Ne;0;6;0;6
21230;Boružėlė;Žvaigždutės;6435556131;Ne;0;6;0;6
21231;Boružėlė;Žvaigždutės;3140264242;Ne;0;4;0;4
21232;Boružėlė;Žvaigždutės;5307997577;Ne;0;6;5;11
21233;Boružėlė;Žvaigždutės;8916241914;Ne;0;4;0;4
21234;Boružėlė;Žvaigždutės;6724101421;Ne;0;5;0;5
21235;Boružėlė;Žvaigždutės;7078709057;Ne;0;4;0;4
21236;Boružėlė;Žvaigždutės;6972646373;Ne;0;6;0;6
21237;Boružėlė;Žvaigždutės;8820827882;Ne;0;6;0;6
21238;Boružėlė;Žvaigždutės;2857645329;Ne;0;2;0;2
21239;Boružėlė;Žvaigždutės;5242187638;Ne;0;3;0;3
21240;Boružėlė;Žvaigždutės;1799882790;Ne;5;4;0;9
21241;Boružėlė;Žvaigždutės;5420788580;Ne;0;6;4;10
21242;Boružėlė;Žvaigždutės;6130634131;Ne;0;4;0;4
21243;Boružėlė;Žvaigždutės;2075050639;Ne;0;4;2;6
21244;Boružėlė;Ąžuoliukai;1874865061;Ne;12;0;3;15
21245;Boružėlė;Ąžuoliukai;6820122408;Ne;0;3;0;3
21246;Boružėlė;Ąžuoliukai;6708666819;Ne;0;2;6;8
21247;Boružėlė;Ąžuoliukai;9818317963;Ne;0;0;3;3
21248;Boružėlė;Ąžuoliukai;1237441386;Ne;5;0;0;5
21249;Boružėlė;Ąžuoliukai;6297693776;Ne;0;2;3;5
21250;Boružėlė;Ąžuoliukai;5401338963;Ne;0;6;2;8
21251;Boružėlė;Ąžuoliukai;8734782540;Ne;5;6;0;11
21252;Boružėlė;Ąžuoliukai;7065907155;Ne;0;5;0;5
21253;Boružėlė;Ąžuoliukai;4113917886;Ne;7;3;0;10
21254;Boružėlė;Ąžuoliukai;1608652924;Ne;0;0;11;11
21255;Boružėlė;Ąžuoliukai;3005601935;Ne;0;7;4;11
21256;Boružėlė;Ąžuoliukai;8752343077;Ne;3;4;1;8
21257;Boružėlė;Ąžuoliukai;4727351240;Ne;5;6;5;16
21258;Boružėlė;Ąžuoliukai;4497753570;Ne;9;0;2;11
21259;Boružėlė;Ąžuoliukai;1865891989;Ne;0;1;0;1
21260;Boružėlė;Ąžuoliukai;8739264310;Ne;12;1;1;14
21261;Boružėlė;Ąžuoliukai;3097874340;Ne;2;2;6;10
21262;Boružėlė;Ąžuoliukai;7149439740;Ne;7;5;0;12
21263;Boružėlė;Ąžuoliukai;1630903587;Ne;0;9;0;9
21264;Boružėlė;Ąžuoliukai;9964146295;Ne;0;0;1;1
21265;Boružėlė;Ąžuoliukai;9544043839;Ne;10;0;1;11
21266;Boružėlė;Saulutės;9492548829;Ne;2;2;0;4
21267;Boružėlė;Saulutės;5437943626;Ne;12;2;0;14
21268;Boružėlė;Saulutės;3503931241;Ne;13;2;0;15
21269;Boružėlė;Saulutės;8882070834;Ne;10;0;0;10
21270;Boružėlė;Saulutės;6265279517;Ne;0;2;2;4
21271;Boružėlė;Saulutės;6275425512;Ne;10;0;0;10
21272;Boružėlė;Saulutės;2879726579;Ne;4;0;0;4
21273;Boružėlė;Saulutės;8804878419;Ne;0;7;0;7
21274;Boružėlė;Saulutės;3871593172;Ne;0;7;0;7
21275;Boružėlė;Saulutės;3953507461;Ne;0;6;1;7
21276;Boružėlė;Saulutės;1492091211;Ne;13;2;0;15
21277;Boružėlė;Saulutės;1830043506;Ne;10;2;0;12
21278;Boružėlė;Saulutės;5680510186;Ne;5;4;0;9
21279;Boružėlė;Saulutės;1152697871;Ne;0;4;0;4
21280;Boružėlė;Saulutės;1779839709;Ne;0;6;0;6
21281;Boružėlė;Saulutės;7260471712;Ne;0;8;0;8
21282;Boružėlė;Saulutės;5064892417;Ne;8;0;0;8
21283;Boružėlė;Saulutės;8577301586;Ne;0;3;0;3
21284;Boružėlė;Saulutės;8660954142;Ne;0;3;0;3
21285;Boružėlė;Saulutės;3093287452;Ne;7;2;0;9
21286;Boružėlė;Saulutės;7596876368;Ne;5;2;0;7
21287;Boružėlė;Ežiukai;9342498392;Ne;0;3;0;3
21288;Boružėlė;Ežiukai;8195442951;Ne;0;6;3;9
21289;Boružėlė;Ežiukai;6448688592;Ne;0;5;0;5
21290;Boružėlė;Ežiukai;2429696310;Ne;0;4;0;4
21291;Boružėlė;Ežiukai;9893643199;Ne;0;4;0;4
21292;Boružėlė;Ežiukai;3112016309;Ne;0;5;0;5
21293;Boružėlė;Ežiukai;5394149649;Ne;0;5;0;5
21294;Boružėlė;Ežiukai;9391811395;Ne;0;5;0;5
21295;Boružėlė;Ežiukai;8167376712;Ne;0;5;0;5
21296;Boružėlė;Ežiukai;1784594085;Ne;6;3;0;9
21297;Boružėlė;Ežiukai;9423458813;Ne;5;1;0;6
21298;Boružėlė;Ežiukai;5825164520;Ne;10;3;0;13
21299;Boružėlė;Ežiukai;7459531236;Ne;0;4;2;6
21300;Boružėlė;Ežiukai;8818358360;Ne;0;4;2;6
21301;Boružėlė;Ežiukai;1693082285;Ne;0;4;0;4
21302;Boružėlė;Ežiukai;2926620929;Ne;0;6;0;6
21303;Boružėlė;Ežiukai;6609156790;Ne;0;5;0;5
21304;Boružėlė;Ežiukai;8291389794;Ne;0;5;0;5
21305;Boružėlė;Ežiukai;2524469162;Ne;1;3;0;4
21306;Boružėlė;Ežiukai;5492228053;Ne;0;5;0;5
21307;Boružėlė;Ežiukai;6087811262;Ne;2;4;0;6
21308;Boružėlė;Boružiukai;8944790932;Ne;8;0;0;8
21309;Boružėlė;Boružiukai;2298750617;Ne;4;0;1;5
21310;Boružėlė;Boružiukai;3097217902;Ne;0;3;0;3
21311;Boružėlė;Boružiukai;6026505923;Ne;5;1;0;6
21312;Boružėlė;Boružiukai;4771951587;Ne;5;4;0;9
21313;Boružėlė;Boružiukai;8868736347;Ne;0;6;0;6
21314;Boružėlė;Boružiukai;3814031203;Ne;7;0;0;7
21315;Boružėlė;Boružiukai;1070536820;Ne;2;0;1;3
21316;Boružėlė;Boružiukai;6856426845;Ne;5;0;0;5
21317;Boružėlė;Boružiukai;8512180544;Ne;7;0;0;7
21318;Boružėlė;Boružiukai;3209486458;Ne;5;4;0;9
21319;Boružėlė;Boružiukai;3972950428;Ne;0;14;0;14
21320;Boružėlė;Boružiukai;6010385301;Ne;0;2;1;3
21321;Boružėlė;Boružiukai;2304719318;Ne;7;3;0;10
21322;Boružėlė;Boružiukai;5667227930;Ne;8;0;1;9
21323;Boružėlė;Boružiukai;5545252373;Ne;0;7;0;7
21324;Boružėlė;Nykštukai;1966066642;Ne;7;4;0;11
21325;Boružėlė;Nykštukai;6267999965;Ne;5;3;0;8
21326;Boružėlė;Nykštukai;6776735311;Ne;0;2;3;5
21327;Boružėlė;Nykštukai;6221965115;Ne;19;0;0;19
21328;Boružėlė;Nykštukai;2657554726;Ne;0;5;0;5
21329;Boružėlė;Nykštukai;2930463607;Ne;0;6;2;8
21330;Boružėlė;Nykštukai;6529896335;Ne;16;0;0;16
21331;Boružėlė;Nykštukai;2730704495;Ne;0;3;0;3
21332;Boružėlė;Nykštukai;6273128752;Ne;0;6;2;8
21333;Boružėlė;Nykštukai;6733644286;Ne;2;0;1;3
21334;Boružėlė;Nykštukai;2984478360;Ne;0;5;0;5
21335;Boružėlė;Nykštukai;3471567359;Ne;0;5;0;5
21336;Boružėlė;Nykštukai;1444196386;Ne;5;2;2;9
21337;Boružėlė;Nykštukai;8970308091;Ne;12;1;0;13
21338;Boružėlė;Nykštukai;6330458151;Ne;15;0;0;15
21339;Boružėlė;Nykštukai;7436380846;Ne;9;2;0;11
21340;Žaliakalnio;Drugeliai;8056516915;Ne;1;6;0;7
21341;Žaliakalnio;Drugeliai;9106286038;Ne;2;3;0;5
21342;Žaliakalnio;Drugeliai;1004188539;Ne;2;4;0;6
21343;Žaliakalnio;Drugeliai;9762481841;Ne;0;3;0;3
21344;Žaliakalnio;Drugeliai;9710185940;Ne;11;9;0;20
21345;Žaliakalnio;Drugeliai;5626776693;Ne;12;1;0;13
21346;Žaliakalnio;Drugeliai;4945570058;Ne;4;6;0;10
21347;Žaliakalnio;Drugeliai;6521902343;Ne;0;14;0;14
21348;Žaliakalnio;Drugeliai;7351146376;Ne;5;2;0;7
21349;Žaliakalnio;Drugeliai;9790375448;Ne;3;11;0;14
21350;Žaliakalnio;Drugeliai;7966604753;Ne;4;5;0;9
21351;Žaliakalnio;Drugeliai;7078689014;Ne;14;0;0;14
21352;Žaliakalnio;Drugeliai;4642184038;Ne;6;1;0;7
21353;Žaliakalnio;Drugeliai;7229655569;Ne;5;1;0;6
21354;Žaliakalnio;Drugeliai;4888533074;Ne;16;2;0;18
21355;Žaliakalnio;Drugeliai;5305220570;Ne;17;0;0;17
21356;Žaliakalnio;Drugeliai;8852165484;Ne;6;2;2;10
21357;Žaliakalnio;Drugeliai;9167631614;Ne;3;5;0;8
21358;Žaliakalnio;Drugeliai;6166482260;Ne;12;5;0;17
21359;Žaliakalnio;Boružėlių;5843020412;Ne;0;6;0;6
21360;Žaliakalnio;Boružėlių;7087535800;Ne;3;7;0;10
21361;Žaliakalnio;Boružėlių;1528111839;Ne;0;8;0;8
21362;Žaliakalnio;Boružėlių;7023886811;Ne;0;7;0;7
21363;Žaliakalnio;Boružėlių;2284465378;Ne;0;6;0;6
21364;Žaliakalnio;Boružėlių;7977009681;Ne;0;6;0;6
21365;Žaliakalnio;Boružėlių;2808776865;Ne;13;6;0;19
21366;Žaliakalnio;Boružėlių;2278681435;Ne;0;9;0;9
21367;Žaliakalnio;Boružėlių;9421259943;Ne;1;5;0;6
21368;Žaliakalnio;Boružėlių;3105500733;Ne;8;7;0;15
21369;Žaliakalnio;Boružėlių;1200844791;Ne;0;7;3;10
21370;Žaliakalnio;Boružėlių;8052539476;Ne;4;16;0;20
21371;Žaliakalnio;Boružėlių;6590016097;Ne;0;13;0;13
21372;Žaliakalnio;Boružėlių;8304431519;Ne;0;7;2;9
21373;Žaliakalnio;Boružėlių;5488964606;Ne;15;6;0;21
21374;Žaliakalnio;Boružėlių;8429135626;Ne;0;11;0;11
21375;Žaliakalnio;Boružėlių;8073554707;Ne;3;6;0;9
21376;Žaliakalnio;Boružėlių;2987217910;Ne;0;10;0;10
21377;Žaliakalnio;Boružėlių;9032003195;Ne;10;7;0;17
21378;Žaliakalnio;Boružėlių;8715718525;Ne;0;5;0;5
21379;Žaliakalnio;Boružėlių;6602037942;Ne;0;2;0;2
21380;Žaliakalnio;Boružėlių;4961762841;Ne;0;5;0;5
21381;Žaliakalnio;Boružėlių;3027735957;Ne;12;6;0;18
21382;Žaliakalnio;Zuikučiai;3072808139;Ne;16;7;0;23
21383;Žaliakalnio;Zuikučiai;9382616403;Ne;0;5;0;5
21384;Žaliakalnio;Zuikučiai;2111418502;Ne;0;10;0;10
21385;Žaliakalnio;Zuikučiai;2654494663;Ne;2;2;0;4
21386;Žaliakalnio;Zuikučiai;8576412247;Ne;8;6;0;14
21387;Žaliakalnio;Zuikučiai;9317649996;Ne;0;5;0;5
21388;Žaliakalnio;Zuikučiai;6872615333;Ne;7;6;0;13
21389;Žaliakalnio;Zuikučiai;5645294219;Ne;4;8;0;12
21390;Žaliakalnio;Zuikučiai;4879096956;Ne;16;3;0;19
21391;Žaliakalnio;Zuikučiai;7258677907;Ne;0;12;0;12
21392;Žaliakalnio;Zuikučiai;9868348859;Ne;10;4;0;14
21393;Žaliakalnio;Zuikučiai;5939383017;Ne;5;8;0;13
21394;Žaliakalnio;Zuikučiai;4231316753;Ne;14;3;0;17
21395;Žaliakalnio;Zuikučiai;9478722760;Ne;7;9;0;16
21396;Žaliakalnio;Zuikučiai;7099047041;Ne;5;4;0;9
21397;Žaliakalnio;Zuikučiai;9378617562;Ne;8;4;0;12
21398;Žaliakalnio;Zuikučiai;6659576919;Ne;14;7;0;21
21399;Žaliakalnio;Zuikučiai;7047556229;Ne;0;4;0;4
21400;Žaliakalnio;Zuikučiai;4563419248;Ne;5;9;0;14
21401;Žaliakalnio;Zuikučiai;3032513275;Ne;10;7;0;17
21402;Žaliakalnio;Zuikučiai;7495990953;Ne;2;5;0;7
21403;Žaliakalnio;Bitutė;5744370516;Ne;4;5;0;9
21404;Žaliakalnio;Bitutė;3619817569;Ne;0;3;0;3
21405;Žaliakalnio;Bitutė;3905448562;Ne;5;8;0;13
21406;Žaliakalnio;Bitutė;8481665290;Ne;3;6;0;9
21407;Žaliakalnio;Bitutė;8950583202;Ne;9;3;0;12
21408;Žaliakalnio;Bitutė;6324315523;Ne;15;5;0;20
21409;Žaliakalnio;Bitutė;6877235095;Ne;0;7;0;7
21410;Žaliakalnio;Bitutė;2280683252;Ne;0;7;0;7
21411;Žaliakalnio;Bitutė;7711347723;Ne;13;0;3;16
21412;Žaliakalnio;Bitutė;4561672875;Ne;0;5;0;5
21413;Žaliakalnio;Bitutė;8185190219;Ne;0;2;0;2
21414;Žaliakalnio;Bitutė;7830692152;Ne;3;8;0;11
21415;Žaliakalnio;Bitutė;1423481154;Ne;1;7;0;8
21416;Žaliakalnio;Bitutė;4928400872;Ne;0;5;0;5
21417;Žaliakalnio;Bitutė;2613771302;Ne;5;6;0;11
21418;Žaliakalnio;Bitutė;8599646291;Ne;5;5;0;10
21419;Žaliakalnio;Bitutė;1343293430;Ne;0;5;0;5
21420;Žaliakalnio;Bitutė;3721878250;Ne;13;6;0;19
21421;Žaliakalnio;Bitutė;6291287113;Ne;0;7;0;7
21422;Žaliakalnio;Bitutė;1173977434;Ne;7;7;0;14
21423;Žaliakalnio;Bitutė;9485995178;Ne;0;11;0;11
21424;Žaliakalnio;Bitutė;1309236035;Ne;3;6;0;9
21425;Žaliakalnio;Bitutė;8534973941;Ne;6;9;0;15
21426;Žaliakalnio;Nykštukų;9069518153;Ne;0;17;0;17
21427;Žaliakalnio;Nykštukų;8142435757;Ne;3;9;0;12
21428;Žaliakalnio;Nykštukų;3446593135;Ne;1;6;0;7
21429;Žaliakalnio;Nykštukų;1064854294;Ne;0;7;0;7
21430;Žaliakalnio;Nykštukų;4891656355;Ne;0;9;0;9
21431;Žaliakalnio;Nykštukų;1632465983;Ne;0;9;0;9
21432;Žaliakalnio;Nykštukų;8472945857;Ne;0;6;0;6
21433;Žaliakalnio;Nykštukų;9521104462;Ne;5;7;0;12
21434;Žaliakalnio;Nykštukų;5565027085;Ne;5;3;0;8
21435;Žaliakalnio;Nykštukų;2242604156;Ne;0;7;0;7
21436;Žaliakalnio;Nykštukų;9801618806;Ne;6;2;0;8
21437;Žaliakalnio;Nykštukų;2225778044;Ne;2;3;0;5
21438;Žaliakalnio;Nykštukų;4255734788;Ne;2;7;0;9
21439;Žaliakalnio;Nykštukų;7793937917;Ne;10;6;0;16
21440;Žaliakalnio;Nykštukų;8117013474;Ne;7;7;0;14
21441;Žaliakalnio;Nykštukų;7205368281;Ne;8;5;0;13
21442;Žaliakalnio;Nykštukų;4036239701;Ne;0;12;0;12
21443;Žaliakalnio;Nykštukų;5258266970;Ne;9;1;0;10
21444;Žaliakalnio;Nykštukų;3041002600;Ne;13;4;0;17
21445;Žaliakalnio;Nykštukų;7636933790;Ne;3;4;0;7
21446;Žaliakalnio;Nykštukų;4154737541;Ne;8;4;0;12
21447;Žaliakalnio;Nykštukų;2155412338;Ne;0;11;0;11
21448;Žaliakalnio;Nykštukų;1511302012;Ne;3;7;0;10
21449;Žaliakalnio;ŽIOGELIAI;2426844621;Ne;0;12;0;12
21450;Žaliakalnio;ŽIOGELIAI;5752912101;Ne;0;6;0;6
21451;Žaliakalnio;ŽIOGELIAI;9967098834;Ne;10;3;0;13
21452;Žaliakalnio;ŽIOGELIAI;1133557422;Ne;6;8;0;14
21453;Žaliakalnio;ŽIOGELIAI;3464935314;Ne;4;8;0;12
21454;Žaliakalnio;ŽIOGELIAI;7648422668;Ne;9;6;0;15
21455;Žaliakalnio;ŽIOGELIAI;4702470511;Ne;3;6;0;9
21456;Žaliakalnio;ŽIOGELIAI;2272043654;Ne;6;6;0;12
21457;Žaliakalnio;ŽIOGELIAI;8518422934;Ne;0;7;0;7
21458;Žaliakalnio;ŽIOGELIAI;6674631040;Ne;5;3;0;8
21459;Žaliakalnio;ŽIOGELIAI;8245784590;Ne;24;0;0;24
21460;Žaliakalnio;ŽIOGELIAI;8383425712;Ne;3;3;1;7
21461;Žaliakalnio;ŽIOGELIAI;7025195076;Ne;6;5;0;11
21462;Žaliakalnio;ŽIOGELIAI;2514763739;Ne;0;9;0;9
21463;Žaliakalnio;ŽIOGELIAI;8891815592;Ne;10;4;0;14
21464;Žaliakalnio;ŽIOGELIAI;6294045755;Ne;10;2;0;12
21465;Žaliakalnio;ŽIOGELIAI;8232697563;Ne;0;10;0;10
21466;Žaliakalnio;ŽIOGELIAI;2694424532;Ne;0;9;0;9
21467;Žaliakalnio;ŽIOGELIAI;6136717862;Ne;4;4;0;8
21468;Žaliakalnio;ŽIOGELIAI;8316505307;Ne;2;6;0;8
21469;Žaliakalnio;ŽIOGELIAI;8568306789;Ne;0;7;0;7
21470;Žaliakalnio;ŽIOGELIAI;9383567339;Ne;0;9;0;9
21471;Žaliakalnio;SAULUTĖS;2328766492;Ne;0;4;0;4
21472;Žaliakalnio;SAULUTĖS;1253655689;Ne;7;6;0;13
21473;Žaliakalnio;SAULUTĖS;3016537413;Ne;0;5;0;5
21474;Žaliakalnio;SAULUTĖS;6795532166;Ne;1;4;0;5
21475;Žaliakalnio;SAULUTĖS;7913029369;Ne;0;6;0;6
21476;Žaliakalnio;SAULUTĖS;7793917852;Ne;3;9;0;12
21477;Žaliakalnio;SAULUTĖS;3018398546;Ne;0;7;0;7
21478;Žaliakalnio;SAULUTĖS;8765159796;Ne;3;12;0;15
21479;Žaliakalnio;SAULUTĖS;3028921540;Ne;9;10;0;19
21480;Žaliakalnio;SAULUTĖS;4355433666;Ne;6;6;0;12
21481;Žaliakalnio;SAULUTĖS;9016032548;Ne;0;5;0;5
21482;Žaliakalnio;SAULUTĖS;1715385224;Ne;1;7;0;8
21483;Žaliakalnio;SAULUTĖS;3304186400;Ne;5;14;0;19
21484;Žaliakalnio;SAULUTĖS;3434815790;Ne;7;0;0;7
21485;Žaliakalnio;SAULUTĖS;3832291926;Ne;0;6;0;6
21486;Žaliakalnio;SAULUTĖS;7071209465;Ne;7;3;0;10
21487;Žaliakalnio;SAULUTĖS;7543073516;Ne;0;7;0;7
21488;Žaliakalnio;SAULUTĖS;9379373983;Ne;0;7;0;7
21489;Žaliakalnio;SAULUTĖS;2806386840;Ne;12;6;0;18
21490;Žaliakalnio;SAULUTĖS;9267349375;Ne;3;5;0;8
21491;Žaliakalnio;SAULUTĖS;7989372873;Ne;0;8;0;8
21492;Žaliakalnio;SAULUTĖS;4412760433;Ne;1;6;0;7
21493;Žaliakalnio;SAULUTĖS;4177369871;Ne;3;5;0;8
21494;Volungė;Bitutės;6661730121;Ne;5;4;0;9
21495;Volungė;Bitutės;5791161943;Ne;0;3;2;5
21496;Volungė;Bitutės;3307326410;Ne;2;4;3;9
21497;Volungė;Bitutės;5300334761;Ne;0;4;0;4
21498;Volungė;Bitutės;6755366051;Ne;0;4;1;5
21499;Volungė;Bitutės;4013639324;Ne;0;4;1;5
21500;Volungė;Bitutės;2599441104;Ne;0;4;0;4
21501;Volungė;Bitutės;5892600735;Ne;0;12;2;14
21502;Volungė;Bitutės;1902122510;Ne;0;4;3;7
21503;Volungė;Bitutės;1752817125;Ne;5;4;0;9
21504;Volungė;Bitutės;3515725398;Ne;0;4;0;4
21505;Volungė;Bitutės;3666364101;Ne;0;4;0;4
21506;Volungė;Bitutės;7151952679;Ne;0;4;2;6
21507;Volungė;Bitutės;5960027749;Ne;0;3;9;12
21508;Volungė;Bitutės;5149291935;Ne;0;1;0;1
21509;Volungė;Bitutės;8166517073;Ne;0;1;1;2
21510;Volungė;Bitutės;9842009354;Ne;3;4;1;8
21511;Volungė;Bitutės;4437625791;Ne;2;1;0;3
21512;Volungė;Bitutės;9933980783;Ne;5;4;0;9
21513;Volungė;Bitutės;4685227759;Ne;0;4;1;5
21514;Volungė;Boružiukai;6445614647;Ne;16;0;0;16
21515;Volungė;Boružiukai;9382043452;Ne;0;0;3;3
21516;Volungė;Boružiukai;5650558154;Ne;0;4;0;4
21517;Volungė;Boružiukai;6127398531;Ne;0;4;0;4
21518;Volungė;Boružiukai;1592634034;Ne;5;3;0;8
21519;Volungė;Boružiukai;5588544003;Ne;0;4;2;6
21520;Volungė;Boružiukai;3758750922;Ne;0;0;12;12
21521;Volungė;Boružiukai;2663288986;Ne;0;4;0;4
21522;Volungė;Boružiukai;3460701723;Ne;0;0;2;2
21523;Volungė;Boružiukai;5561683986;Ne;0;4;2;6
21524;Volungė;Boružiukai;9562426487;Ne;0;10;4;14
21525;Volungė;Boružiukai;4136178027;Ne;2;2;0;4
21526;Volungė;Boružiukai;4664635246;Ne;0;1;7;8
21527;Volungė;Boružiukai;8987748481;Ne;4;2;0;6
21528;Volungė;Boružiukai;5882826586;Ne;5;2;2;9
21529;Volungė;Boružiukai;5338942678;Ne;0;2;4;6
21530;Volungė;Boružiukai;5054666349;Ne;11;4;1;16
21531;Volungė;Žvirbliukai;2360026330;Ne;5;4;0;9
21532;Volungė;Žvirbliukai;8414351815;Ne;11;0;0;11
21533;Volungė;Žvirbliukai;2051410463;Ne;0;3;9;12
21534;Volungė;Žvirbliukai;5074093178;Ne;0;0;2;2
21535;Volungė;Žvirbliukai;5750385275;Taip;19;0;0;19
21536;Volungė;Žvirbliukai;9575894080;Taip;5;2;0;7
21537;Volungė;Žvirbliukai;8927595898;Ne;0;4;2;6
21538;Volungė;Žvirbliukai;9384821249;Ne;4;1;2;7
21539;Volungė;Žvirbliukai;5361410157;Ne;0;4;0;4
21540;Volungė;Žvirbliukai;4235842588;Ne;1;2;0;3
21541;Volungė;Žvirbliukai;3028611395;Ne;0;1;7;8
21542;Volungė;Žvirbliukai;2949033093;Ne;0;4;3;7
21543;Volungė;Žvirbliukai;2159667991;Ne;14;0;0;14
21544;Volungė;Žvirbliukai;5470252589;Ne;0;4;2;6
21545;Volungė;Žvirbliukai;7923029388;Ne;0;2;0;2
21546;Volungė;Žvirbliukai;1022606584;Ne;4;4;2;10
21547;Volungė;Žvirbliukai;8894121428;Ne;3;4;0;7
21548;Volungė;Žvirbliukai;9139746132;Ne;0;3;0;3
21549;Volungė;Žvirbliukai;3332069842;Ne;0;4;0;4
21550;Volungė;Žvirbliukai;4605844193;Ne;10;3;0;13
21551;Volungė;Žiogeliai;6360834021;Ne;0;2;0;2
21552;Volungė;Žiogeliai;4856240879;Ne;0;4;6;10
21553;Volungė;Žiogeliai;4694016281;Ne;0;4;4;8
21554;Volungė;Žiogeliai;8640511964;Ne;0;4;1;5
21555;Volungė;Žiogeliai;5170536566;Ne;0;4;0;4
21556;Volungė;Žiogeliai;8421730419;Ne;0;14;1;15
21557;Volungė;Žiogeliai;6532202782;Ne;0;14;0;14
21558;Volungė;Žiogeliai;2712034356;Ne;0;4;7;11
21559;Volungė;Žiogeliai;2246291631;Ne;0;4;0;4
21560;Volungė;Žiogeliai;2456643081;Ne;0;4;1;5
21561;Volungė;Žiogeliai;6920821813;Ne;0;0;1;1
21562;Volungė;Žiogeliai;8299305464;Ne;6;4;0;10
21563;Volungė;Žiogeliai;1781838937;Ne;0;4;6;10
21564;Volungė;Žiogeliai;1988082807;Ne;0;4;0;4
21565;Volungė;Žiogeliai;3091641738;Ne;0;4;0;4
21566;Volungė;Žiogeliai;8578521969;Ne;0;4;0;4
21567;Volungė;Žiogeliai;5710662590;Ne;0;4;4;8
21568;Volungė;Žiogeliai;4839484528;Ne;0;4;0;4
21569;Volungė;Žiogeliai;5174427959;Ne;0;3;3;6
21570;Volungė;Žiogeliai;7281448136;Ne;0;3;2;5
21571;Volungė;Žiogeliai;2187800215;Ne;0;4;4;8
21572;Volungė;Pelėdžiukai;6431477042;Ne;0;3;3;6
21573;Volungė;Pelėdžiukai;3528581949;Ne;0;4;4;8
21574;Volungė;Pelėdžiukai;1137713075;Ne;0;6;3;9
21575;Volungė;Pelėdžiukai;2322594823;Ne;5;4;0;9
21576;Volungė;Pelėdžiukai;7965601199;Ne;0;3;1;4
21577;Volungė;Pelėdžiukai;2603335248;Ne;0;4;1;5
21578;Volungė;Pelėdžiukai;3746978206;Ne;0;4;2;6
21579;Volungė;Pelėdžiukai;1974650443;Ne;0;3;1;4
21580;Volungė;Pelėdžiukai;2068447339;Ne;0;19;0;19
21581;Volungė;Pelėdžiukai;9188994935;Ne;0;12;0;12
21582;Volungė;Pelėdžiukai;1757041481;Ne;0;4;6;10
21583;Volungė;Pelėdžiukai;8285309230;Ne;7;4;0;11
21584;Volungė;Pelėdžiukai;7149986415;Ne;0;4;4;8
21585;Volungė;Pelėdžiukai;4598763851;Ne;0;4;0;4
21586;Volungė;Pelėdžiukai;9677732243;Ne;0;2;0;2
21587;Volungė;Pelėdžiukai;2627555750;Ne;0;3;1;4
21588;Volungė;Pelėdžiukai;7867741556;Ne;0;2;6;8
21589;Volungė;Pelėdžiukai;7971287899;Ne;10;6;0;16
21590;Volungė;Pelėdžiukai;9729285419;Ne;0;4;3;7
21591;Volungė;Pelėdžiukai;9343118795;Ne;0;0;2;2
21592;Volungė;Pelėdžiukai;8459167833;Ne;0;4;0;4
21593;Volungė;Drugeliai;6280208510;Ne;0;4;2;6
21594;Volungė;Drugeliai;4032261812;Ne;4;4;2;10
21595;Volungė;Drugeliai;6488473384;Ne;8;0;1;9
21596;Volungė;Drugeliai;8045459660;Ne;0;3;1;4
21597;Volungė;Drugeliai;1402200673;Ne;0;3;1;4
21598;Volungė;Drugeliai;7574856429;Ne;6;0;0;6
21599;Volungė;Drugeliai;5284011092;Ne;1;1;3;5
21600;Volungė;Drugeliai;4427076715;Ne;0;1;0;1
21601;Volungė;Drugeliai;2686827560;Ne;10;0;0;10
21602;Volungė;Drugeliai;9973604148;Ne;3;4;0;7
21603;Volungė;Drugeliai;8905401944;Ne;0;5;0;5
21604;Volungė;Drugeliai;1164632050;Ne;0;3;3;6
21605;Volungė;Drugeliai;2923810441;Ne;0;4;2;6
21606;Volungė;Drugeliai;6782622442;Ne;11;4;0;15
21607;Volungė;Drugeliai;3020629341;Ne;6;0;0;6
21608;Volungė;Drugeliai;4252713086;Ne;3;4;0;7
21609;Volungė;Drugeliai;2530804242;Ne;0;1;2;3
21610;Volungė;Drugeliai;5354511593;Ne;0;0;3;3
21611;Volungė;Drugeliai;4745609424;Ne;7;0;0;7
21612;Volungė;Drugeliai;7584598377;Ne;6;3;0;9
21613;Volungė;"SKRUZDĖLIUKAI ";3394646139;Ne;10;4;2;16
21614;Volungė;"SKRUZDĖLIUKAI ";4223287277;Ne;8;0;0;8
21615;Volungė;"SKRUZDĖLIUKAI ";6464890465;Ne;6;0;0;6
21616;Volungė;"SKRUZDĖLIUKAI ";2493541457;Ne;10;0;0;10
21617;Volungė;"SKRUZDĖLIUKAI ";1948015523;Ne;0;4;0;4
21618;Volungė;"SKRUZDĖLIUKAI ";1101228927;Ne;10;4;0;14
21619;Volungė;"SKRUZDĖLIUKAI ";5332306628;Ne;5;4;0;9
21620;Volungė;"SKRUZDĖLIUKAI ";9319825151;Taip;4;4;0;8
21621;Volungė;"SKRUZDĖLIUKAI ";6370584522;Ne;6;5;0;11
21622;Volungė;"SKRUZDĖLIUKAI ";8168630107;Ne;0;7;0;7
21623;Volungė;"SKRUZDĖLIUKAI ";8992514683;Ne;4;3;0;7
21624;Volungė;"SKRUZDĖLIUKAI ";5833091791;Ne;4;0;2;6
21625;Volungė;"SKRUZDĖLIUKAI ";5994884455;Ne;7;0;0;7
21626;Volungė;"SKRUZDĖLIUKAI ";3818924175;Ne;9;0;0;9
21627;Volungė;"SKRUZDĖLIUKAI ";8244731771;Ne;0;4;0;4
21628;Volungė;"SKRUZDĖLIUKAI ";6110117105;Ne;19;0;0;19
21629;Volungė;"SKRUZDĖLIUKAI ";4944556574;Ne;4;4;0;8
21630;Volungė;"SKRUZDĖLIUKAI ";2212423676;Ne;8;4;0;12
21631;Volungė;"SKRUZDĖLIUKAI ";5942497397;Ne;8;3;0;11
21632;Volungė;"SKRUZDĖLIUKAI ";4991465781;Ne;0;4;0;4
21633;Volungė;"SKRUZDĖLIUKAI ";8613580206;Ne;6;4;1;11
21634;Volungė;Zylutės;1040993908;Ne;0;3;3;6
21635;Volungė;Zylutės;6715770777;Ne;6;4;0;10
21636;Volungė;Zylutės;2874194121;Ne;5;4;1;10
21637;Volungė;Zylutės;4363877851;Ne;7;3;0;10
21638;Volungė;Zylutės;1877753679;Ne;6;3;1;10
21639;Volungė;Zylutės;9005691348;Ne;0;3;4;7
21640;Volungė;Zylutės;2765042584;Ne;7;4;1;12
21641;Volungė;Zylutės;7754202158;Ne;8;4;0;12
21642;Volungė;Zylutės;9519564424;Ne;4;2;4;10
21643;Volungė;Zylutės;5497911485;Ne;0;0;3;3
21644;Volungė;Zylutės;5345072950;Ne;9;4;1;14
21645;Volungė;Zylutės;3042694602;Ne;0;1;0;1
21646;Volungė;Zylutės;1744137167;Ne;0;4;3;7
21647;Volungė;Zylutės;2404239677;Ne;3;2;3;8
21648;Giliukas;SMALSUČIAI;9462634699;Ne;1;0;0;1
21649;Giliukas;SMALSUČIAI;7646966187;Ne;6;0;0;6
21650;Giliukas;SMALSUČIAI;3274313536;Ne;0;2;0;2
21651;Giliukas;SMALSUČIAI;9287193955;Ne;6;2;0;8
21652;Giliukas;SMALSUČIAI;7944198886;Ne;5;0;0;5
21653;Giliukas;SMALSUČIAI;5527212334;Ne;10;0;0;10
21654;Giliukas;SMALSUČIAI;9499591494;Ne;6;0;0;6
21655;Giliukas;SMALSUČIAI;2099575372;Ne;2;0;0;2
21656;Giliukas;SMALSUČIAI;7195772641;Ne;8;0;0;8
21657;Giliukas;SMALSUČIAI;4258921446;Ne;2;2;0;4
21658;Giliukas;SMALSUČIAI;1439350058;Ne;10;0;0;10
21659;Giliukas;SMALSUČIAI;4843920452;Ne;12;0;0;12
21660;Giliukas;SMALSUČIAI;2004782696;Taip;0;1;0;1
21661;Giliukas;SMALSUČIAI;8977247073;Ne;4;0;0;4
21662;Giliukas;SMALSUČIAI;9475918013;Ne;3;0;0;3
21663;Giliukas;SMALSUČIAI;9229086918;Ne;6;2;0;8
21664;Giliukas;SMALSUČIAI;8147492951;Ne;3;0;0;3
21665;Giliukas;SMALSUČIAI;2349166172;Ne;2;0;1;3
21666;Giliukas;SMALSUČIAI;8241215831;Ne;10;0;0;10
21667;Giliukas;GUDRUČIAI;4960232685;Ne;0;5;0;5
21668;Giliukas;GUDRUČIAI;9458262379;Ne;9;1;0;10
21669;Giliukas;GUDRUČIAI;6148883070;Ne;0;9;0;9
21670;Giliukas;GUDRUČIAI;8666628432;Ne;0;1;0;1
21671;Giliukas;GUDRUČIAI;7425654504;Ne;0;6;0;6
21672;Giliukas;GUDRUČIAI;7130696530;Ne;2;3;0;5
21673;Giliukas;GUDRUČIAI;6422178450;Ne;0;5;0;5
21674;Giliukas;GUDRUČIAI;3150981084;Ne;2;9;0;11
21675;Giliukas;GUDRUČIAI;6134554678;Ne;0;13;0;13
21676;Giliukas;GUDRUČIAI;3137768675;Ne;1;6;0;7
21677;Giliukas;GUDRUČIAI;2064182165;Ne;5;4;0;9
21678;Giliukas;GUDRUČIAI;6956862865;Ne;2;7;0;9
21679;Giliukas;GUDRUČIAI;9617542456;Ne;0;6;0;6
21680;Giliukas;GUDRUČIAI;9274289812;Ne;0;3;0;3
21681;Giliukas;GUDRUČIAI;3718774263;Ne;19;0;0;19
21682;Giliukas;GUDRUČIAI;9152432124;Ne;6;3;1;10
21683;Giliukas;GUDRUČIAI;4854370266;Ne;0;6;0;6
21684;Giliukas;GUDRUČIAI;6338583515;Ne;3;7;0;10
21685;Giliukas;GUDRUČIAI;6703080106;Ne;0;9;0;9
21686;Giliukas;GUDRUČIAI;4347883309;Ne;0;1;0;1
21687;Giliukas;PABIRUČIAI;4183026763;Ne;0;3;0;3
21688;Giliukas;PABIRUČIAI;4247090684;Ne;12;0;0;12
21689;Giliukas;PABIRUČIAI;2379370477;Ne;2;0;0;2
21690;Giliukas;PABIRUČIAI;3054591644;Ne;3;2;0;5
21691;Giliukas;PABIRUČIAI;3870143024;Ne;7;0;0;7
21692;Giliukas;PABIRUČIAI;6914013230;Ne;11;1;0;12
21693;Giliukas;PABIRUČIAI;7013767174;Ne;5;0;0;5
21694;Giliukas;PABIRUČIAI;4810236703;Ne;8;1;0;9
21695;Giliukas;PABIRUČIAI;4105974682;Ne;5;0;0;5
21696;Giliukas;PABIRUČIAI;8874804636;Ne;5;0;0;5
21697;Giliukas;PABIRUČIAI;8626920684;Ne;7;1;1;9
21698;Giliukas;PABIRUČIAI;7012272912;Ne;3;0;3;6
21699;Giliukas;PABIRUČIAI;2229737837;Ne;5;2;0;7
21700;Giliukas;PABIRUČIAI;1075275967;Ne;7;0;0;7
21701;Giliukas;PABIRUČIAI;3268682615;Ne;6;0;0;6
21702;Giliukas;PABIRUČIAI;4838600191;Ne;10;0;0;10
21703;Giliukas;PABIRUČIAI;1395779355;Ne;6;0;0;6
21704;Giliukas;PABIRUČIAI;7541075946;Ne;8;0;0;8
21705;Giliukas;ŠVELNUKAI;9224387185;Ne;14;0;0;14
21706;Giliukas;ŠVELNUKAI;9360994563;Ne;0;0;1;1
21707;Giliukas;ŠVELNUKAI;2012365132;Ne;4;0;1;5
21708;Giliukas;ŠVELNUKAI;4565216956;Ne;7;0;0;7
21709;Giliukas;ŠVELNUKAI;5834233526;Ne;3;0;0;3
21710;Giliukas;ŠVELNUKAI;5000654626;Ne;6;0;1;7
21711;Giliukas;ŠVELNUKAI;8973584424;Ne;4;0;2;6
21712;Giliukas;ŠVELNUKAI;9679421414;Ne;16;0;2;18
21713;Giliukas;ŠVELNUKAI;3238820351;Ne;1;0;1;2
21714;Giliukas;ŠVELNUKAI;4340602792;Ne;6;0;1;7
21715;Giliukas;ŠVELNUKAI;6563305502;Ne;13;1;0;14
21716;Giliukas;ŠVELNUKAI;4301950538;Ne;0;0;1;1
21717;Giliukas;ŠVELNUKAI;7657935162;Ne;0;0;2;2
21718;Giliukas;ŽINIUKAI;2502801547;Ne;1;8;0;9
21719;Giliukas;ŽINIUKAI;2562809633;Ne;4;6;0;10
21720;Giliukas;ŽINIUKAI;5326178821;Ne;5;0;0;5
21721;Giliukas;ŽINIUKAI;5201020765;Ne;15;7;0;22
21722;Giliukas;ŽINIUKAI;2042324002;Ne;1;5;0;6
21723;Giliukas;ŽINIUKAI;2801731379;Ne;2;6;0;8
21724;Giliukas;ŽINIUKAI;8499893356;Ne;0;12;0;12
21725;Giliukas;ŽINIUKAI;9205911152;Ne;1;4;2;7
21726;Giliukas;ŽINIUKAI;3720032249;Ne;6;4;7;17
21727;Giliukas;ŽINIUKAI;3659105022;Ne;3;11;0;14
21728;Giliukas;ŽINIUKAI;4940718205;Ne;0;3;2;5
21729;Giliukas;ŽINIUKAI;8491008130;Taip;9;10;0;19
21730;Giliukas;ŽINIUKAI;4163383707;Ne;3;4;0;7
21731;Giliukas;ŽINIUKAI;1332725572;Ne;0;12;0;12
21732;Giliukas;ŽINIUKAI;2798676079;Ne;0;7;0;7
21733;Giliukas;ŽINIUKAI;4404761569;Ne;6;0;5;11
21734;Giliukas;ŽINIUKAI;1915809569;Ne;0;1;0;1
21735;Giliukas;ŽINIUKAI;2787116787;Ne;0;5;0;5
21736;Giliukas;MYLIMUKAI;7481387658;Ne;4;0;0;4
21737;Giliukas;MYLIMUKAI;7290236898;Ne;14;0;0;14
21738;Giliukas;MYLIMUKAI;8786230522;Ne;3;0;0;3
21739;Giliukas;MYLIMUKAI;8012946026;Ne;7;0;0;7
21740;Giliukas;MYLIMUKAI;7406406981;Ne;10;0;0;10
21741;Giliukas;MYLIMUKAI;2169949712;Ne;0;4;0;4
21742;Giliukas;MYLIMUKAI;5467076457;Ne;2;0;0;2
21743;Giliukas;MYLIMUKAI;2109668106;Ne;2;0;0;2
21744;Giliukas;MYLIMUKAI;5199968458;Ne;5;0;0;5
21745;Giliukas;MYLIMUKAI;3185622470;Ne;13;0;0;13
21746;Giliukas;MYLIMUKAI;8414652507;Ne;19;0;0;19
21747;Giliukas;MYLIMUKAI;7560774044;Ne;9;0;0;9
21748;Giliukas;MYLIMUKAI;3717956257;Ne;10;0;0;10
21749;Giliukas;ČIAUŠKUČIAI;8701216181;Ne;0;6;0;6
21750;Giliukas;ČIAUŠKUČIAI;6742406486;Ne;5;4;2;11
21751;Giliukas;ČIAUŠKUČIAI;9556962586;Ne;0;1;0;1
21752;Giliukas;ČIAUŠKUČIAI;2840410579;Ne;6;6;0;12
21753;Giliukas;ČIAUŠKUČIAI;2378721717;Ne;3;6;0;9
21754;Giliukas;ČIAUŠKUČIAI;7316126011;Ne;8;0;0;8
21755;Giliukas;ČIAUŠKUČIAI;9134734376;Ne;4;0;0;4
21756;Giliukas;ČIAUŠKUČIAI;3728323646;Ne;8;2;0;10
21757;Giliukas;ČIAUŠKUČIAI;1710286878;Ne;4;1;3;8
21758;Giliukas;ČIAUŠKUČIAI;9704885611;Ne;0;8;0;8
21759;Giliukas;ČIAUŠKUČIAI;7993049824;Ne;18;0;1;19
21760;Giliukas;ČIAUŠKUČIAI;2700296404;Ne;0;4;4;8
21761;Giliukas;ČIAUŠKUČIAI;7412960823;Taip;0;2;0;2
21762;Giliukas;ČIAUŠKUČIAI;9160815037;Ne;1;3;2;6
21763;Giliukas;ČIAUŠKUČIAI;1221640023;Ne;2;3;2;7
21764;Giliukas;ČIAUŠKUČIAI;2298554837;Ne;0;4;0;4
21765;Giliukas;ČIAUŠKUČIAI;7871670134;Ne;0;0;2;2
21766;Giliukas;ŠNEKUČIAI;1762536884;Ne;14;0;0;14
21767;Giliukas;ŠNEKUČIAI;2612551188;Ne;13;0;0;13
21768;Giliukas;ŠNEKUČIAI;9366734581;Ne;8;2;0;10
21769;Giliukas;ŠNEKUČIAI;7053406257;Ne;8;0;0;8
21770;Giliukas;ŠNEKUČIAI;2226855971;Ne;12;2;0;14
21771;Giliukas;ŠNEKUČIAI;2742106493;Ne;4;5;0;9
21772;Giliukas;ŠNEKUČIAI;3726149759;Ne;11;3;0;14
21773;Giliukas;ŠNEKUČIAI;6748766233;Ne;5;2;0;7
21774;Giliukas;ŠNEKUČIAI;6953123617;Ne;0;3;0;3
21775;Giliukas;ŠNEKUČIAI;5222092567;Ne;5;0;0;5
21776;Giliukas;ŠNEKUČIAI;5300517567;Taip;0;2;0;2
21777;Giliukas;ŠNEKUČIAI;3055598917;Ne;2;2;0;4
21778;Giliukas;ŠNEKUČIAI;4581414740;Ne;15;2;0;17
21779;Giliukas;ŠNEKUČIAI;7431116067;Ne;12;0;0;12
21780;Giliukas;ŠNEKUČIAI;7205807049;Ne;12;2;0;14
21781;Giliukas;ŠNEKUČIAI;1165810193;Ne;7;2;0;9
21782;Giliukas;ŠNEKUČIAI;1916905497;Ne;7;3;0;10
21783;Giliukas;ŠNEKUČIAI;4207939009;Ne;4;0;0;4
21784;Giliukas;ŠNEKUČIAI;5625404051;Ne;10;0;0;10
21785;"Lazdynų mokykla (Žėručio g. 4)";LEPG;7487278074;Ne;1;3;0;4
21786;"Lazdynų mokykla (Žėručio g. 4)";LEPG;7320049068;Ne;5;4;1;10
21787;"Lazdynų mokykla (Žėručio g. 4)";LEPG;1396367371;Ne;0;3;0;3
21788;"Lazdynų mokykla (Žėručio g. 4)";LEPG;7324846434;Ne;2;4;0;6
21789;"Lazdynų mokykla (Žėručio g. 4)";LEPG;7659209862;Ne;8;4;0;12
21790;"Lazdynų mokykla (Žėručio g. 4)";LEPG;9654428418;Ne;1;3;0;4
21791;"Lazdynų mokykla (Žėručio g. 4)";LEPG;3435025978;Ne;8;4;1;13
21792;"Lazdynų mokykla (Žėručio g. 4)";LEPG;5420067622;Ne;0;4;0;4
21793;"Lazdynų mokykla (Žėručio g. 4)";LEPG;1738732866;Ne;0;4;2;6
21794;"Lazdynų mokykla (Žėručio g. 4)";LEPG;2059342403;Ne;2;3;0;5
21795;"Lazdynų mokykla (Žėručio g. 4)";LEPG;3268305561;Ne;0;3;0;3
21796;"Lazdynų mokykla (Žėručio g. 4)";LEPG;4562536818;Ne;0;3;1;4
21797;"Lazdynų mokykla (Žėručio g. 4)";LEPG;8990701154;Ne;0;4;0;4
21798;"Lazdynų mokykla (Žėručio g. 4)";LEPG;2666441234;Ne;2;4;0;6
21799;"Lazdynų mokykla (Žėručio g. 4)";LEPG;9382900638;Ne;6;4;0;10
21800;"Lazdynų mokykla (Žėručio g. 4)";LEPG;1624578455;Ne;6;4;0;10
21801;"Lazdynų mokykla (Žėručio g. 4)";RUPG-1;4776074273;Ne;11;4;0;15
21802;"Lazdynų mokykla (Žėručio g. 4)";RUPG-1;7110858765;Ne;0;3;0;3
21803;"Lazdynų mokykla (Žėručio g. 4)";RUPG-1;6577255841;Ne;1;4;0;5
21804;"Lazdynų mokykla (Žėručio g. 4)";RUPG-1;7647195979;Ne;0;4;0;4
21805;"Lazdynų mokykla (Žėručio g. 4)";RUPG-1;4715171946;Ne;9;4;0;13
21806;"Lazdynų mokykla (Žėručio g. 4)";RUPG-1;2700475528;Ne;0;4;0;4
21807;"Lazdynų mokykla (Žėručio g. 4)";RUPG-1;7180617984;Ne;1;4;0;5
21808;"Lazdynų mokykla (Žėručio g. 4)";RUPG-1;2308739823;Ne;5;4;0;9
21809;"Lazdynų mokykla (Žėručio g. 4)";RUPG-1;5015519090;Ne;11;4;0;15
21810;"Lazdynų mokykla (Žėručio g. 4)";RUPG-1;9968637187;Ne;10;4;0;14
21811;"Lazdynų mokykla (Žėručio g. 4)";RUPG-1;8886654664;Ne;0;4;0;4
21812;"Lazdynų mokykla (Žėručio g. 4)";RUPG-1;1351714626;Ne;0;4;0;4
21813;"Lazdynų mokykla (Žėručio g. 4)";RUPG-1;4494932923;Ne;2;3;0;5
21814;"Lazdynų mokykla (Žėručio g. 4)";RUPG-1;2035060922;Ne;0;4;0;4
21815;"Lazdynų mokykla (Žėručio g. 4)";RUPG-2;3837424301;Ne;0;3;1;4
21816;"Lazdynų mokykla (Žėručio g. 4)";RUPG-2;8720878006;Ne;0;19;0;19
21817;"Lazdynų mokykla (Žėručio g. 4)";RUPG-2;8675089149;Ne;0;3;1;4
21818;"Lazdynų mokykla (Žėručio g. 4)";RUPG-2;7963866641;Ne;0;4;0;4
21819;"Lazdynų mokykla (Žėručio g. 4)";RUPG-2;9982496951;Ne;4;4;0;8
21820;"Lazdynų mokykla (Žėručio g. 4)";RUPG-2;8229454863;Ne;0;4;0;4
21821;"Lazdynų mokykla (Žėručio g. 4)";RUPG-2;1118653070;Ne;0;4;0;4
21822;"Lazdynų mokykla (Žėručio g. 4)";RUPG-2;5806696915;Ne;4;4;0;8
21823;"Lazdynų mokykla (Žėručio g. 4)";RUPG-2;3634678954;Ne;7;4;0;11
21824;"Lazdynų mokykla (Žėručio g. 4)";RUPG-2;5770044886;Ne;5;5;0;10
21825;"Lazdynų mokykla (Žėručio g. 4)";RUPG-2;2539006620;Ne;0;19;0;19
21826;"Lazdynų mokykla (Žėručio g. 4)";RUPG-2;8757701456;Ne;0;5;0;5
21827;"Lazdynų mokykla (Žėručio g. 4)";RUPG-2;4165354124;Ne;2;4;0;6
21828;"Lazdynų mokykla (Žėručio g. 4)";RUPG-2;9534937419;Ne;5;4;1;10
21829;"Lazdynų mokykla (Žėručio g. 4)";RUPG-2;3715070791;Ne;0;4;1;5
21830;"Lazdynų mokykla (Žėručio g. 4)";RUPG-2;8448546818;Ne;0;13;0;13
21831;"Vilnios pagrindinė mokykla";DRUGELIAI;8384925496;Ne;16;0;0;16
21832;"„Atžalyno” mokykla-darželis";Giliukai;7652421432;Ne;3;2;0;5
21833;"„Atžalyno” mokykla-darželis";Giliukai;1961428224;Ne;6;4;0;10
21834;"„Atžalyno” mokykla-darželis";Giliukai;9101301819;Ne;7;0;0;7
21835;"„Atžalyno” mokykla-darželis";Giliukai;8320161812;Ne;9;4;0;13
21836;"„Atžalyno” mokykla-darželis";Giliukai;7669725276;Ne;0;3;0;3
21837;"„Atžalyno” mokykla-darželis";Giliukai;4784990018;Ne;1;4;0;5
21838;"„Atžalyno” mokykla-darželis";Giliukai;2462839180;Ne;2;4;0;6
21839;"„Atžalyno” mokykla-darželis";Giliukai;8070499557;Ne;2;3;1;6
21840;"„Atžalyno” mokykla-darželis";Giliukai;1915676392;Ne;6;4;0;10
21841;"„Atžalyno” mokykla-darželis";Giliukai;4107946143;Ne;0;3;0;3
21842;"„Atžalyno” mokykla-darželis";Giliukai;9913048992;Ne;5;4;0;9
21843;"„Atžalyno” mokykla-darželis";Giliukai;5335059675;Ne;1;2;0;3
21844;"„Atžalyno” mokykla-darželis";Giliukai;9690554753;Ne;3;3;0;6
21845;"„Atžalyno” mokykla-darželis";Giliukai;2446697763;Ne;0;0;1;1
21846;"„Atžalyno” mokykla-darželis";Giliukai;7579781779;Ne;0;4;0;4
21847;"„Atžalyno” mokykla-darželis";Giliukai;7883570492;Ne;6;4;0;10
21848;"„Atžalyno” mokykla-darželis";Giliukai;4616870552;Ne;2;4;0;6
21849;"„Atžalyno” mokykla-darželis";Giliukai;5986664970;Ne;3;2;0;5
21850;"„Atžalyno” mokykla-darželis";Giliukai;6903825217;Ne;4;3;0;7
21851;"„Atžalyno” mokykla-darželis";Giliukai;8357021249;Ne;1;3;0;4
21852;"„Atžalyno” mokykla-darželis";Giliukai;4582284727;Ne;0;4;0;4
21853;"„Atžalyno” mokykla-darželis";Giliukai;4785607785;Ne;0;4;0;4
21854;"„Atžalyno” mokykla-darželis";Giliukai;4166521512;Ne;8;4;0;12
21855;"„Atžalyno” mokykla-darželis";Giliukai;8372179128;Ne;2;4;0;6
21856;"„Atžalyno” mokykla-darželis";Riešutėliai;4360099345;Ne;8;1;0;9
21857;"„Atžalyno” mokykla-darželis";Riešutėliai;5947938371;Ne;9;0;2;11
21858;"„Atžalyno” mokykla-darželis";Riešutėliai;5384245347;Ne;13;0;0;13
21859;"„Atžalyno” mokykla-darželis";Riešutėliai;4246430352;Ne;8;4;0;12
21860;"„Atžalyno” mokykla-darželis";Riešutėliai;8574494664;Ne;6;6;0;12
21861;"„Atžalyno” mokykla-darželis";Riešutėliai;5815412814;Ne;2;0;1;3
21862;"„Atžalyno” mokykla-darželis";Riešutėliai;4161658496;Ne;0;8;0;8
21863;"„Atžalyno” mokykla-darželis";Riešutėliai;8942132574;Ne;0;8;0;8
21864;"„Atžalyno” mokykla-darželis";Riešutėliai;3564781987;Ne;0;2;1;3
21865;"„Atžalyno” mokykla-darželis";Riešutėliai;7368616441;Ne;4;0;6;10
21866;"„Atžalyno” mokykla-darželis";Riešutėliai;5242752663;Ne;6;0;0;6
21867;"„Atžalyno” mokykla-darželis";Riešutėliai;5709028342;Ne;7;5;0;12
21868;"„Atžalyno” mokykla-darželis";Riešutėliai;8803555426;Ne;2;1;2;5
21869;"„Atžalyno” mokykla-darželis";Riešutėliai;5994983369;Ne;0;4;0;4
21870;"„Atžalyno” mokykla-darželis";Riešutėliai;7676614240;Ne;4;0;0;4
21871;"„Atžalyno” mokykla-darželis";Riešutėliai;3751729666;Ne;8;0;2;10
21872;"„Atžalyno” mokykla-darželis";Riešutėliai;3441950153;Ne;0;8;0;8
21873;"„Atžalyno” mokykla-darželis";Riešutėliai;4223591454;Ne;0;3;2;5
21874;"„Atžalyno” mokykla-darželis";Riešutėliai;8625074554;Ne;0;8;0;8
21875;"„Atžalyno” mokykla-darželis";Riešutėliai;3555868198;Ne;5;6;0;11
21876;"„Atžalyno” mokykla-darželis";Žirniukai;2849915655;Ne;4;7;0;11
21877;"„Atžalyno” mokykla-darželis";Žirniukai;6120955217;Ne;0;11;0;11
21878;"„Atžalyno” mokykla-darželis";Žirniukai;1787256844;Ne;11;1;0;12
21879;"„Atžalyno” mokykla-darželis";Žirniukai;2547003287;Ne;11;1;0;12
21880;"„Atžalyno” mokykla-darželis";Žirniukai;4503448206;Ne;0;6;0;6
21881;"„Atžalyno” mokykla-darželis";Žirniukai;3664056583;Ne;4;8;0;12
21882;"„Atžalyno” mokykla-darželis";Žirniukai;5456248305;Ne;16;0;1;17
21883;"„Atžalyno” mokykla-darželis";Žirniukai;3719072139;Ne;5;6;0;11
21884;"„Atžalyno” mokykla-darželis";Žirniukai;9245994735;Ne;15;0;0;15
21885;"„Atžalyno” mokykla-darželis";Žirniukai;2000352986;Ne;0;8;0;8
21886;"„Atžalyno” mokykla-darželis";Žirniukai;2177213062;Ne;7;0;1;8
21887;"„Atžalyno” mokykla-darželis";Žirniukai;4635394632;Ne;16;0;0;16
21888;"„Atžalyno” mokykla-darželis";Žirniukai;3524131672;Ne;10;0;0;10
21889;"„Atžalyno” mokykla-darželis";Žirniukai;4840490901;Ne;6;6;0;12
21890;"„Atžalyno” mokykla-darželis";Žirniukai;4796052680;Ne;14;0;1;15
21891;"„Atžalyno” mokykla-darželis";Žirniukai;3181675972;Ne;2;0;1;3
21892;"„Atžalyno” mokykla-darželis";Žirniukai;8163063211;Ne;15;0;7;22
21893;"„Atžalyno” mokykla-darželis";Žirniukai;4431437971;Ne;0;5;0;5
21894;"„Atžalyno” mokykla-darželis";Žirniukai;3770167696;Ne;2;2;5;9
21895;"„Atžalyno” mokykla-darželis";Žirniukai;6307949550;Ne;20;0;9;29
21896;"„Atžalyno” mokykla-darželis";Žirniukai;7625074947;Ne;15;8;1;24
21897;"„Atžalyno” mokykla-darželis";VYŠNIUKAI;9216535506;Ne;5;4;0;9
21898;"„Atžalyno” mokykla-darželis";VYŠNIUKAI;6960661098;Ne;3;3;0;6
21899;"„Atžalyno” mokykla-darželis";VYŠNIUKAI;1059756637;Ne;8;6;0;14
21900;"„Atžalyno” mokykla-darželis";VYŠNIUKAI;7999992997;Ne;19;0;0;19
21901;"„Atžalyno” mokykla-darželis";VYŠNIUKAI;8872288787;Ne;12;4;0;16
21902;"„Atžalyno” mokykla-darželis";VYŠNIUKAI;5410469885;Ne;13;4;0;17
21903;"„Atžalyno” mokykla-darželis";VYŠNIUKAI;5878874414;Ne;4;2;0;6
21904;"„Atžalyno” mokykla-darželis";VYŠNIUKAI;3930056490;Ne;6;3;0;9
21905;"„Atžalyno” mokykla-darželis";VYŠNIUKAI;6984404118;Ne;14;0;0;14
21906;"„Atžalyno” mokykla-darželis";VYŠNIUKAI;6939741360;Ne;5;5;0;10
21907;"„Atžalyno” mokykla-darželis";VYŠNIUKAI;5398871923;Ne;0;7;0;7
21908;"„Atžalyno” mokykla-darželis";VYŠNIUKAI;2825064244;Ne;6;4;0;10
21909;"„Atžalyno” mokykla-darželis";VYŠNIUKAI;3768908704;Ne;3;3;0;6
21910;"„Atžalyno” mokykla-darželis";VYŠNIUKAI;6959131424;Ne;3;1;0;4
21911;"„Atžalyno” mokykla-darželis";VYŠNIUKAI;1851189680;Ne;0;5;0;5
21912;"„Atžalyno” mokykla-darželis";VYŠNIUKAI;5562429493;Ne;3;4;0;7
21913;"„Atžalyno” mokykla-darželis";PIPIRIUKAI;5615246040;Ne;0;6;1;7
21914;"„Atžalyno” mokykla-darželis";PIPIRIUKAI;1988657552;Ne;5;0;22;27
21915;"„Atžalyno” mokykla-darželis";PIPIRIUKAI;6721771665;Ne;8;6;5;19
21916;"„Atžalyno” mokykla-darželis";PIPIRIUKAI;2921181385;Ne;0;0;8;8
21917;"„Atžalyno” mokykla-darželis";PIPIRIUKAI;2108706876;Ne;6;6;3;15
21918;"„Atžalyno” mokykla-darželis";PIPIRIUKAI;1228919159;Ne;0;15;0;15
21919;"„Atžalyno” mokykla-darželis";PIPIRIUKAI;3919301151;Ne;0;5;6;11
21920;"„Atžalyno” mokykla-darželis";PIPIRIUKAI;3624299098;Ne;8;4;0;12
21921;"„Atžalyno” mokykla-darželis";PIPIRIUKAI;2537063401;Ne;8;6;1;15
21922;"„Atžalyno” mokykla-darželis";PIPIRIUKAI;3204191459;Ne;8;8;0;16
21923;"„Atžalyno” mokykla-darželis";PIPIRIUKAI;5321475187;Ne;1;6;3;10
21924;"„Atžalyno” mokykla-darželis";PIPIRIUKAI;3015863723;Ne;5;9;0;14
21925;"„Atžalyno” mokykla-darželis";PIPIRIUKAI;3323233525;Ne;5;9;0;14
21926;"„Atžalyno” mokykla-darželis";PIPIRIUKAI;4596770586;Ne;5;6;3;14
21927;"„Atžalyno” mokykla-darželis";PIPIRIUKAI;1664011018;Ne;9;6;1;16
21928;"„Atžalyno” mokykla-darželis";PIPIRIUKAI;1866452425;Ne;3;5;2;10
21929;"„Atžalyno” mokykla-darželis";PIPIRIUKAI;9737568538;Ne;1;5;1;7
21930;"„Atžalyno” mokykla-darželis";PIPIRIUKAI;5406800599;Ne;4;8;0;12
21931;"„Atžalyno” mokykla-darželis";PIPIRIUKAI;3312254613;Ne;4;4;0;8
21932;"„Atžalyno” mokykla-darželis";PIPIRIUKAI;1443004141;Ne;0;0;8;8
21933;"Vilniaus Naujininkų mokykla";"SAULĖS ZUIKUČIAI";9856315057;Taip;2;4;0;6
21934;"Vilniaus Naujininkų mokykla";"SAULĖS ZUIKUČIAI";1901250406;Ne;0;6;0;6
21935;"Vilniaus Naujininkų mokykla";"SAULĖS ZUIKUČIAI";9411054207;Ne;0;10;0;10
21936;"Vilniaus Naujininkų mokykla";"SAULĖS ZUIKUČIAI";9544088525;Ne;9;4;0;13
21937;"Vilniaus Naujininkų mokykla";"SAULĖS ZUIKUČIAI";9488762308;Ne;9;4;0;13
21938;"Vilniaus Naujininkų mokykla";"SAULĖS ZUIKUČIAI";3929956703;Ne;7;4;0;11
21939;"Vilniaus Naujininkų mokykla";"SAULĖS ZUIKUČIAI";3502355847;Ne;2;0;0;2
21940;"Vilniaus Naujininkų mokykla";"SAULĖS ZUIKUČIAI";4675274695;Taip;7;5;0;12
21941;"Vilniaus Naujininkų mokykla";"SAULĖS ZUIKUČIAI";3243090025;Ne;7;4;0;11
21942;"Vilniaus Naujininkų mokykla";"SAULĖS ZUIKUČIAI";9786654519;Ne;0;5;0;5
21943;"Vilniaus Naujininkų mokykla";"SAULĖS ZUIKUČIAI";8161853174;Ne;0;4;0;4
21944;"Vilniaus Naujininkų mokykla";"SAULĖS ZUIKUČIAI";6235626283;Ne;0;6;0;6
21945;"Vilniaus Naujininkų mokykla";"SAULĖS ZUIKUČIAI";9699407871;Ne;3;4;0;7
21946;"Vilniaus Naujininkų mokykla";"SAULĖS ZUIKUČIAI";4317656984;Ne;0;4;0;4
21947;"Vilniaus Naujininkų mokykla";SMALSUČIAI;3654667879;Ne;7;6;0;13
21948;"Vilniaus Naujininkų mokykla";SMALSUČIAI;5236782382;Ne;1;6;0;7
21949;"Vilniaus Naujininkų mokykla";SMALSUČIAI;7020599764;Ne;0;6;0;6
21950;"Vilniaus Naujininkų mokykla";SMALSUČIAI;3192556582;Ne;0;7;0;7
21951;"Vilniaus Naujininkų mokykla";SMALSUČIAI;4985740210;Ne;2;6;0;8
21952;"Vilniaus Naujininkų mokykla";SMALSUČIAI;1460027521;Ne;3;6;0;9
21953;"Vilniaus Naujininkų mokykla";SMALSUČIAI;9993335478;Ne;11;6;0;17
21954;"Vilniaus Naujininkų mokykla";SMALSUČIAI;1306106945;Ne;2;6;0;8
21955;"Vilniaus Naujininkų mokykla";SMALSUČIAI;8555610571;Ne;19;2;0;21
21956;"Vilniaus Naujininkų mokykla";SMALSUČIAI;8637047688;Ne;2;5;0;7
21957;"Vilniaus Naujininkų mokykla";SMALSUČIAI;6417648753;Ne;1;6;0;7
21958;"Vilniaus Naujininkų mokykla";SMALSUČIAI;7407987673;Ne;0;6;0;6
21959;"Vilniaus Naujininkų mokykla";SMALSUČIAI;8935072613;Ne;19;2;0;21
21960;"Vilniaus Naujininkų mokykla";SMALSUČIAI;5512321795;Ne;0;7;0;7
21961;"Vilniaus Naujininkų mokykla";SMALSUČIAI;3810550099;Ne;2;5;0;7
21962;"Vilniaus Naujininkų mokykla";SMALSUČIAI;7692387379;Ne;3;3;0;6
21963;"Vilniaus Naujininkų mokykla";SMALSUČIAI;1096474672;Ne;5;6;0;11
21964;"Vilniaus Naujininkų mokykla";SMALSUČIAI;4784667239;Ne;7;6;0;13
21965;"Vilniaus Naujininkų mokykla";SMALSUČIAI;3475476348;Ne;4;6;0;10
21966;"Vilniaus karaliaus Mindaugo mokykla";"PUG 2";4684525618;Ne;9;0;0;9
21967;"Vilniaus karaliaus Mindaugo mokykla";"PUG 2";2938446054;Ne;0;4;0;4
21968;"Vilniaus karaliaus Mindaugo mokykla";"PUG 2";3068754741;Ne;0;4;0;4
21969;"Vilniaus karaliaus Mindaugo mokykla";"PUG 2";3170928052;Ne;5;0;1;6
21970;"Vilniaus karaliaus Mindaugo mokykla";"PUG 2";4992188525;Ne;0;4;0;4
21971;"Vilniaus karaliaus Mindaugo mokykla";"PUG 2";2287044278;Ne;1;4;2;7
21972;"Vilniaus karaliaus Mindaugo mokykla";"PUG 2";7615716438;Ne;0;0;4;4
21973;"Vilniaus karaliaus Mindaugo mokykla";"PUG 2";6906137103;Ne;4;0;1;5
21974;"Vilniaus karaliaus Mindaugo mokykla";"PUG 2";8229593318;Ne;0;4;0;4
21975;"Vilniaus karaliaus Mindaugo mokykla";"PUG 2";4143844589;Ne;4;0;0;4
21976;"Vilniaus karaliaus Mindaugo mokykla";"PUG 2";7236658561;Ne;0;4;0;4
21977;"Vilniaus karaliaus Mindaugo mokykla";"PUG 2";8456560292;Ne;0;4;2;6
21978;"Vilniaus karaliaus Mindaugo mokykla";"PUG 2";6384832317;Ne;6;4;1;11
21979;"Vilniaus karaliaus Mindaugo mokykla";"PUG 2";9670205249;Ne;4;5;2;11
21980;"Vilniaus karaliaus Mindaugo mokykla";"PUG 2";3741784446;Ne;0;19;0;19
21981;"Vilniaus karaliaus Mindaugo mokykla";"PUG 2";8578903763;Ne;8;0;0;8
21982;"Vilniaus karaliaus Mindaugo mokykla";"PUG 2";8340697546;Ne;4;0;1;5
21983;"Vilniaus karaliaus Mindaugo mokykla";"PUG 2";3281475303;Ne;0;3;0;3
21984;"Vilniaus karaliaus Mindaugo mokykla";"PUG 2";9780684867;Ne;0;0;5;5
21985;"Vilniaus karaliaus Mindaugo mokykla";"PUG 2";4920263429;Ne;2;0;3;5
21986;"Vilniaus karaliaus Mindaugo mokykla";"PUG 1";3888408459;Ne;0;0;4;4
21987;"Vilniaus karaliaus Mindaugo mokykla";"PUG 1";6315627367;Ne;0;0;2;2
21988;"Vilniaus karaliaus Mindaugo mokykla";"PUG 1";7043125057;Ne;0;4;2;6
21989;"Vilniaus karaliaus Mindaugo mokykla";"PUG 1";7064391685;Ne;0;5;1;6
21990;"Vilniaus karaliaus Mindaugo mokykla";"PUG 1";5640182548;Ne;4;0;0;4
21991;"Vilniaus karaliaus Mindaugo mokykla";"PUG 1";1998073387;Ne;0;4;5;9
21992;"Vilniaus karaliaus Mindaugo mokykla";"PUG 1";9790803767;Ne;0;4;0;4
21993;"Vilniaus karaliaus Mindaugo mokykla";"PUG 1";4405567649;Ne;4;0;2;6
21994;"Vilniaus karaliaus Mindaugo mokykla";"PUG 1";5752454925;Ne;0;0;5;5
21995;"Vilniaus karaliaus Mindaugo mokykla";"PUG 1";5648658237;Ne;0;0;8;8
21996;"Vilniaus karaliaus Mindaugo mokykla";"PUG 1";5946007985;Ne;0;1;0;1
21997;"Vilniaus karaliaus Mindaugo mokykla";"PUG 1";7770852445;Ne;0;1;0;1
21998;"Vilniaus karaliaus Mindaugo mokykla";"PUG 1";3953844737;Ne;4;0;0;4
21999;"Vilniaus karaliaus Mindaugo mokykla";"PUG 1";7271589727;Ne;5;0;1;6
22000;"Vilniaus karaliaus Mindaugo mokykla";"PUG 1";1403569615;Ne;0;4;0;4
22001;"Vilniaus karaliaus Mindaugo mokykla";"PUG 1";9651789217;Ne;0;0;6;6
22002;"Vilniaus karaliaus Mindaugo mokykla";"PUG 1";2926077771;Ne;0;6;0;6
22003;"Vilniaus karaliaus Mindaugo mokykla";"PUG 1";3587941684;Ne;0;0;3;3
22004;"Vilniaus karaliaus Mindaugo mokykla";"PUG 1";2549704540;Ne;0;4;1;5
22005;"Vilniaus karaliaus Mindaugo mokykla";"PUG 1";2361829423;Ne;4;0;0;4
22006;"Vilniaus karaliaus Mindaugo mokykla";"PUG 3";6406285034;Ne;0;4;1;5
22007;"Vilniaus karaliaus Mindaugo mokykla";"PUG 3";7433354196;Ne;0;0;4;4
22008;"Vilniaus karaliaus Mindaugo mokykla";"PUG 3";3252419072;Ne;1;0;0;1
22009;"Vilniaus karaliaus Mindaugo mokykla";"PUG 3";9056468879;Ne;5;0;4;9
22010;"Vilniaus karaliaus Mindaugo mokykla";"PUG 3";4559316741;Ne;0;4;0;4
22011;"Vilniaus karaliaus Mindaugo mokykla";"PUG 3";1945918102;Ne;12;4;0;16
22012;"Vilniaus karaliaus Mindaugo mokykla";"PUG 3";1814323427;Ne;2;4;0;6
22013;"Vilniaus karaliaus Mindaugo mokykla";"PUG 3";2319707653;Ne;10;0;0;10
22014;"Vilniaus karaliaus Mindaugo mokykla";"PUG 3";4741154518;Ne;0;4;0;4
22015;"Vilniaus karaliaus Mindaugo mokykla";"PUG 3";4215451069;Ne;2;0;0;2
22016;"Vilniaus karaliaus Mindaugo mokykla";"PUG 3";9921191336;Ne;0;4;0;4
22017;"Vilniaus karaliaus Mindaugo mokykla";"PUG 3";2044795759;Ne;8;0;2;10
22018;"Vilniaus karaliaus Mindaugo mokykla";"PUG 3";5103259175;Ne;0;0;8;8
22019;"Vilniaus karaliaus Mindaugo mokykla";"PUG 3";5613442667;Ne;7;0;3;10
22020;"Vilniaus karaliaus Mindaugo mokykla";"PUG 3";7149197796;Ne;0;19;0;19
22021;"Vilniaus karaliaus Mindaugo mokykla";"PUG 3";8705825002;Ne;0;0;2;2
22022;"Vilniaus karaliaus Mindaugo mokykla";"PUG 3";7638190553;Ne;0;0;3;3
22023;"Vilniaus karaliaus Mindaugo mokykla";"PUG 3";6762306583;Ne;14;1;0;15
22024;"Vilniaus karaliaus Mindaugo mokykla";"PUG 3";1621497786;Ne;2;0;3;5
22025;"Vilniaus Levo Karsavino vidurinė mokykla";PELEDŽIUKAI;4043810535;Ne;0;2;2;4
22026;"Vilniaus Levo Karsavino vidurinė mokykla";PELEDŽIUKAI;1887013803;Ne;0;2;3;5
22027;"Vilniaus Levo Karsavino vidurinė mokykla";PELEDŽIUKAI;6464887268;Ne;0;8;0;8
22028;"Vilniaus Levo Karsavino vidurinė mokykla";PELEDŽIUKAI;5876182759;Ne;0;4;0;4
22029;"Vilniaus Levo Karsavino vidurinė mokykla";PELEDŽIUKAI;6569135467;Ne;0;2;1;3
22030;"Vilniaus Levo Karsavino vidurinė mokykla";PELEDŽIUKAI;3117948118;Ne;3;2;3;8
22031;"Vilniaus Levo Karsavino vidurinė mokykla";PELEDŽIUKAI;2654373943;Ne;2;2;2;6
22032;"Vilniaus Levo Karsavino vidurinė mokykla";PELEDŽIUKAI;9988041515;Ne;0;2;2;4
22033;"Vilniaus Levo Karsavino vidurinė mokykla";PELEDŽIUKAI;9108428738;Ne;0;2;2;4
22034;"Vilniaus Levo Karsavino vidurinė mokykla";PELEDŽIUKAI;6099940488;Ne;11;2;1;14
22035;"Vilniaus Levo Karsavino vidurinė mokykla";PELEDŽIUKAI;7824348276;Ne;0;2;2;4
22036;"Vilniaus Levo Karsavino vidurinė mokykla";PELEDŽIUKAI;3547185618;Ne;0;2;2;4
22037;"Vilniaus Levo Karsavino vidurinė mokykla";PELEDŽIUKAI;2681013154;Ne;3;2;0;5
22038;"Vilniaus Levo Karsavino vidurinė mokykla";PELEDŽIUKAI;3780475392;Ne;0;10;0;10
22039;"Vilniaus Levo Karsavino vidurinė mokykla";PELEDŽIUKAI;3211649292;Ne;0;2;2;4
22040;"Vilniaus Levo Karsavino vidurinė mokykla";PELEDŽIUKAI;8386409466;Ne;4;2;2;8
22041;"Vilniaus Levo Karsavino vidurinė mokykla";PELEDŽIUKAI;3059970035;Ne;4;2;1;7
22042;"Vilniaus Levo Karsavino vidurinė mokykla";PELEDŽIUKAI;7023534254;Ne;0;8;4;12
22043;"Vilniaus Levo Karsavino vidurinė mokykla";PELEDŽIUKAI;4493469560;Ne;0;2;3;5
22044;"Vilniaus Levo Karsavino vidurinė mokykla";PELEDŽIUKAI;3608920051;Ne;0;6;0;6
22045;"Vilniaus Levo Karsavino vidurinė mokykla";ŽINIUKAI;4416434150;Ne;11;2;0;13
22046;"Vilniaus Levo Karsavino vidurinė mokykla";ŽINIUKAI;9325387975;Ne;0;2;3;5
22047;"Vilniaus Levo Karsavino vidurinė mokykla";ŽINIUKAI;2013694393;Ne;11;2;2;15
22048;"Vilniaus Levo Karsavino vidurinė mokykla";ŽINIUKAI;2107123106;Ne;0;2;4;6
22049;"Vilniaus Levo Karsavino vidurinė mokykla";ŽINIUKAI;7482740111;Ne;0;2;2;4
22050;"Vilniaus Levo Karsavino vidurinė mokykla";ŽINIUKAI;5408157164;Ne;0;2;5;7
22051;"Vilniaus Levo Karsavino vidurinė mokykla";ŽINIUKAI;2122665619;Ne;0;5;1;6
22052;"Vilniaus Levo Karsavino vidurinė mokykla";ŽINIUKAI;1632925219;Ne;0;4;3;7
22053;"Vilniaus Levo Karsavino vidurinė mokykla";ŽINIUKAI;1750209600;Ne;0;2;1;3
22054;"Vilniaus Levo Karsavino vidurinė mokykla";ŽINIUKAI;8364902911;Ne;0;2;0;2
22055;"Vilniaus Levo Karsavino vidurinė mokykla";ŽINIUKAI;8827421660;Ne;0;4;0;4
22056;"Vilniaus Levo Karsavino vidurinė mokykla";ŽINIUKAI;3943002728;Ne;2;2;1;5
22057;"Vilniaus Levo Karsavino vidurinė mokykla";ŽINIUKAI;2697867000;Ne;0;7;1;8
22058;"Vilniaus Levo Karsavino vidurinė mokykla";ŽINIUKAI;1165219272;Ne;4;2;0;6
22059;"Vilniaus Levo Karsavino vidurinė mokykla";ŽINIUKAI;7541217656;Ne;0;2;3;5
22060;"Vilniaus Levo Karsavino vidurinė mokykla";ŽINIUKAI;6391999153;Ne;0;2;0;2
22061;"Vilniaus Levo Karsavino vidurinė mokykla";ŽINIUKAI;4613894944;Ne;0;2;2;4
22062;"Vilniaus Levo Karsavino vidurinė mokykla";ŽINIUKAI;8517226350;Ne;0;2;2;4
22063;"Vilniaus Levo Karsavino vidurinė mokykla";ŽINIUKAI;5102718403;Ne;0;2;6;8
22064;"Vilniaus Levo Karsavino vidurinė mokykla";ŽINIUKAI;5692603837;Ne;0;2;2;4
22065;"Vilniaus Levo Karsavino vidurinė mokykla";ŽINIUKAI;6945510312;Ne;0;2;7;9
22066;"Vilniaus Liepkalnio Pagrindinė Mokykla";Bitutės;3144718477;Ne;2;4;0;6
22067;"Vilniaus Liepkalnio Pagrindinė Mokykla";Bitutės;5682528849;Ne;0;4;0;4
22068;"Vilniaus Liepkalnio Pagrindinė Mokykla";Bitutės;1777442316;Ne;0;4;0;4
22069;"Vilniaus Liepkalnio Pagrindinė Mokykla";Bitutės;8723898832;Ne;0;4;0;4
22070;"Vilniaus Liepkalnio Pagrindinė Mokykla";Bitutės;8080492986;Ne;6;4;0;10
22071;"Vilniaus Liepkalnio Pagrindinė Mokykla";Bitutės;3239288878;Ne;0;4;1;5
22072;"Vilniaus Liepkalnio Pagrindinė Mokykla";Bitutės;6829438486;Ne;0;4;1;5
22073;"Vilniaus Liepkalnio Pagrindinė Mokykla";Bitutės;3369970611;Ne;0;4;3;7
22074;"Vilniaus Liepkalnio Pagrindinė Mokykla";Bitutės;4344780723;Ne;0;4;3;7
22075;"Vilniaus Liepkalnio Pagrindinė Mokykla";Bitutės;1085400709;Ne;0;4;1;5
22076;"Vilniaus Liepkalnio Pagrindinė Mokykla";Bitutės;8387453394;Ne;0;4;0;4
22077;"Vilniaus Liepkalnio Pagrindinė Mokykla";Bitutės;8478417679;Ne;0;4;0;4
22078;"Vilniaus Pranciškaus Skorinos gimnazija";SAULYTĖ;3621289572;Ne;5;6;0;11
22079;"Vilniaus Pranciškaus Skorinos gimnazija";SAULYTĖ;8946940285;Ne;0;6;3;9
22080;"Vilniaus Pranciškaus Skorinos gimnazija";SAULYTĖ;2978563798;Ne;4;6;0;10
22081;"Vilniaus Pranciškaus Skorinos gimnazija";SAULYTĖ;2347857813;Ne;1;6;1;8
22082;"Vilniaus Pranciškaus Skorinos gimnazija";SAULYTĖ;2220506064;Ne;0;6;5;11
22083;"Vilniaus Pranciškaus Skorinos gimnazija";SAULYTĖ;1797706575;Ne;0;6;5;11
22084;"Vilniaus Pranciškaus Skorinos gimnazija";SAULYTĖ;9424930375;Ne;0;6;5;11
22085;"Vilniaus Pranciškaus Skorinos gimnazija";SAULYTĖ;3558729735;Ne;0;9;0;9
22086;"Vilniaus Pranciškaus Skorinos gimnazija";SAULYTĖ;7197420388;Ne;0;6;0;6
22087;"Vilniaus Pranciškaus Skorinos gimnazija";SAULYTĖ;9107920165;Ne;0;6;0;6
22088;"Vilniaus Pranciškaus Skorinos gimnazija";SAULYTĖ;8262426350;Ne;0;2;0;2
22089;"Vilniaus Pranciškaus Skorinos gimnazija";SAULYTĖ;2290343066;Ne;0;21;0;21
22090;"Vilniaus Pranciškaus Skorinos gimnazija";SAULYTĖ;4500542668;Ne;7;6;0;13
22091;"Vilniaus Pranciškaus Skorinos gimnazija";SAULYTĖ;2782818158;Ne;0;6;1;7
22092;"Vilniaus Pranciškaus Skorinos gimnazija";SAULYTĖ;4719223490;Ne;7;6;1;14
22093;"Vilniaus Pranciškaus Skorinos gimnazija";SAULYTĖ;6892006495;Ne;0;7;0;7
22094;"Vilniaus Pranciškaus Skorinos gimnazija";SAULYTĖ;8592478282;Ne;0;6;3;9
22095;"Vilniaus Pranciškaus Skorinos gimnazija";SAULYTĖ;4522879237;Ne;5;6;3;14
22096;"Vilniaus Simono Konarskio gimnazija";"1 GR.";9988467124;Ne;4;4;0;8
22097;"Vilniaus Simono Konarskio gimnazija";"1 GR.";4029765504;Ne;0;4;0;4
22098;"Vilniaus Simono Konarskio gimnazija";"1 GR.";6861123988;Ne;0;4;0;4
22099;"Vilniaus Simono Konarskio gimnazija";"1 GR.";7233139048;Ne;2;4;0;6
22100;"Vilniaus Simono Konarskio gimnazija";"1 GR.";3835878101;Ne;0;4;0;4
22101;"Vilniaus Simono Konarskio gimnazija";"1 GR.";9009809585;Ne;0;4;0;4
22102;"Vilniaus Simono Konarskio gimnazija";"1 GR.";6044653707;Ne;0;4;0;4
22103;"Vilniaus Simono Konarskio gimnazija";"1 GR.";1915827035;Ne;0;4;0;4
22104;"Vilniaus Simono Konarskio gimnazija";"1 GR.";8052276633;Ne;0;4;0;4
22105;"Vilniaus Simono Konarskio gimnazija";"1 GR.";9041585534;Ne;0;4;0;4
22106;"Vilniaus Simono Konarskio gimnazija";"1 GR.";4048726627;Ne;0;4;0;4
22107;"Vilniaus Simono Konarskio gimnazija";"1 GR.";4713033873;Ne;0;4;0;4
22108;"Vilniaus Simono Konarskio gimnazija";"1 GR.";6693019825;Ne;0;4;0;4
22109;"Vilniaus Simono Konarskio gimnazija";"1 GR.";8916218916;Ne;0;4;0;4
22110;"Vilniaus Simono Konarskio gimnazija";"1 GR.";1532248269;Ne;0;4;0;4
22111;"Vilniaus Simono Konarskio gimnazija";"1 GR.";3675401775;Ne;0;4;0;4
22112;"Vilniaus Simono Konarskio gimnazija";"1 GR.";2764009011;Ne;0;4;0;4
22113;"Vilniaus Simono Konarskio gimnazija";"1 GR.";4338067260;Ne;0;4;0;4
22114;"Vilniaus Simono Konarskio gimnazija";"1 GR.";3641822841;Ne;0;4;0;4
22115;"Vilniaus Simono Konarskio gimnazija";"1 GR.";4858617162;Ne;1;4;0;5
22116;"Vilniaus Simono Konarskio gimnazija";"1 GR.";9205217788;Ne;0;4;0;4
22117;"Vilniaus Simono Konarskio gimnazija";"1 GR.";3900236858;Ne;0;4;0;4
22118;"Vilniaus Simono Konarskio gimnazija";"1 GR.";9065848425;Ne;2;4;0;6
22119;"Vilniaus Simono Konarskio gimnazija";"1 GR.";7230987338;Ne;0;4;0;4
22120;"Vilniaus Simono Konarskio gimnazija";"1 GR.";7337449523;Ne;5;4;0;9
22121;"Vilniaus Trakų Vokės gimnazija";DRUGELIAI;8874384610;Ne;11;6;2;19
22122;"Vilniaus Trakų Vokės gimnazija";DRUGELIAI;4535167417;Ne;4;6;0;10
22123;"Vilniaus Trakų Vokės gimnazija";DRUGELIAI;2539647111;Ne;0;5;0;5
22124;"Vilniaus Trakų Vokės gimnazija";DRUGELIAI;2453791555;Ne;8;2;2;12
22125;"Vilniaus Trakų Vokės gimnazija";DRUGELIAI;4854440884;Ne;16;6;0;22
22126;"Vilniaus Trakų Vokės gimnazija";DRUGELIAI;2761614687;Ne;19;6;0;25
22127;"Vilniaus Trakų Vokės gimnazija";DRUGELIAI;8706990390;Ne;22;0;0;22
22128;"Vilniaus Trakų Vokės gimnazija";DRUGELIAI;9094930495;Ne;4;4;1;9
22129;"Vilniaus Trakų Vokės gimnazija";DRUGELIAI;9483709021;Ne;5;6;0;11
22130;"Vilniaus Trakų Vokės gimnazija";DRUGELIAI;2880299812;Ne;4;0;1;5
22131;"Vilniaus Trakų Vokės gimnazija";DRUGELIAI;9506008651;Ne;10;0;1;11
22132;"Vilniaus Trakų Vokės gimnazija";DRUGELIAI;6326568445;Ne;0;6;0;6
22133;"Vilniaus Trakų Vokės gimnazija";DRUGELIAI;1360046096;Ne;9;5;0;14
22134;"Vilniaus Trakų Vokės gimnazija";DRUGELIAI;2503382218;Ne;7;0;0;7
22135;"Vilniaus Trakų Vokės gimnazija";DRUGELIAI;3278842582;Ne;3;0;2;5
22136;"Vilniaus Trakų Vokės gimnazija";DRUGELIAI;3611639112;Ne;0;6;0;6
22137;"Vilniaus Trakų Vokės gimnazija";DRUGELIAI;8605461082;Ne;10;0;4;14
22138;"Vilniaus Trakų Vokės gimnazija";DRUGELIAI;3328527700;Ne;0;5;0;5
22139;"Vilniaus Trakų Vokės gimnazija";DRUGELIAI;5206616285;Ne;0;7;0;7
22140;"Vilniaus Trakų Vokės gimnazija";DRUGELIAI;8929514493;Ne;7;6;0;13
22141;"Vilniaus Trakų Vokės gimnazija";DRUGELIAI;9233090228;Ne;14;0;1;15
22142;"Vilniaus Trakų Vokės gimnazija";VOVERIUKAI;1088928094;Ne;1;0;0;1
22143;"Vilniaus Trakų Vokės gimnazija";VOVERIUKAI;7318458282;Ne;0;6;0;6
22144;"Vilniaus Trakų Vokės gimnazija";VOVERIUKAI;1080300137;Ne;0;7;0;7
22145;"Vilniaus Trakų Vokės gimnazija";VOVERIUKAI;2469340933;Ne;1;1;0;2
22146;"Vilniaus Trakų Vokės gimnazija";VOVERIUKAI;6908913934;Ne;4;6;0;10
22147;"Vilniaus Trakų Vokės gimnazija";VOVERIUKAI;4362066941;Ne;6;8;0;14
22148;"Vilniaus Trakų Vokės gimnazija";VOVERIUKAI;3209594216;Ne;4;0;0;4
22149;"Vilniaus Trakų Vokės gimnazija";VOVERIUKAI;3555513755;Ne;0;6;0;6
22150;"Vilniaus Trakų Vokės gimnazija";VOVERIUKAI;5338798362;Ne;0;6;0;6
22151;"Vilniaus Trakų Vokės gimnazija";VOVERIUKAI;9582511053;Ne;0;9;0;9
22152;"Vilniaus Trakų Vokės gimnazija";VOVERIUKAI;3319243283;Ne;3;0;0;3
22153;"Vilniaus Trakų Vokės gimnazija";VOVERIUKAI;1039690987;Ne;5;0;0;5
22154;"Vilniaus Trakų Vokės gimnazija";VOVERIUKAI;6908487075;Ne;5;6;0;11
22155;"Vilniaus Trakų Vokės gimnazija";VOVERIUKAI;1910363787;Ne;3;7;0;10
22156;"Vilniaus Trakų Vokės gimnazija";VOVERIUKAI;7858812338;Ne;3;0;0;3
22157;"Vilniaus Trakų Vokės gimnazija";VOVERIUKAI;3913623741;Ne;5;0;0;5
22158;"Vilniaus Trakų Vokės gimnazija";VOVERIUKAI;4520091712;Ne;7;0;0;7
22159;"Vilniaus Trakų Vokės gimnazija";VOVERIUKAI;8168960897;Ne;4;6;0;10
22160;"Vilniaus Trakų Vokės gimnazija";VOVERIUKAI;1057189769;Ne;7;0;0;7
22161;"Vilniaus Trakų Vokės gimnazija";VOVERIUKAI;4014027030;Ne;11;1;0;12
22162;"Vilniaus Trakų Vokės gimnazija";VOVERIUKAI;7660240598;Ne;9;11;0;20
22163;"Vilniaus Trakų Vokės gimnazija";VOVERIUKAI;4438127190;Ne;4;4;0;8
22164;"Vilniaus Trakų Vokės gimnazija";VOVERIUKAI;2388817616;Ne;7;0;0;7
22165;"Vilniaus Trakų Vokės gimnazija";VOVERIUKAI;8472834181;Ne;6;2;0;8
22166;"Vilniaus Trakų Vokės gimnazija";BITUTĖS;6369848950;Ne;0;1;7;8
22167;"Vilniaus Trakų Vokės gimnazija";BITUTĖS;6732422645;Ne;0;4;4;8
22168;"Vilniaus Trakų Vokės gimnazija";BITUTĖS;7909596435;Ne;7;0;5;12
22169;"Vilniaus Trakų Vokės gimnazija";BITUTĖS;6751625456;Ne;4;1;4;9
22170;"Vilniaus Trakų Vokės gimnazija";BITUTĖS;7752786907;Ne;0;6;1;7
22171;"Vilniaus Trakų Vokės gimnazija";BITUTĖS;2475068032;Ne;0;0;6;6
22172;"Vilniaus Trakų Vokės gimnazija";BITUTĖS;9819489467;Ne;2;6;1;9
22173;"Vilniaus Trakų Vokės gimnazija";BITUTĖS;2516219363;Ne;0;3;3;6
22174;"Vilniaus Trakų Vokės gimnazija";BITUTĖS;2571561865;Ne;8;1;3;12
22175;"Vilniaus Trakų Vokės gimnazija";BITUTĖS;6765094662;Ne;4;6;1;11
22176;"Vilniaus Trakų Vokės gimnazija";BITUTĖS;4601374629;Ne;0;0;4;4
22177;"Vilniaus Trakų Vokės gimnazija";BITUTĖS;9051697544;Ne;1;2;12;15
22178;"Vilniaus Trakų Vokės gimnazija";BITUTĖS;3346395516;Ne;2;6;2;10
22179;"Vilniaus Trakų Vokės gimnazija";BITUTĖS;9453317084;Ne;0;6;1;7
22180;"Vilniaus Trakų Vokės gimnazija";BITUTĖS;2869217654;Taip;2;3;0;5
22181;"Vilniaus Trakų Vokės gimnazija";BITUTĖS;7508070996;Ne;7;4;7;18
22182;"Vilniaus Trakų Vokės gimnazija";BITUTĖS;1602352855;Ne;4;0;3;7
22183;"Vilniaus Trakų Vokės gimnazija";BITUTĖS;5695160925;Ne;3;6;3;12
22184;"Vilniaus Trakų Vokės gimnazija";BITUTĖS;9668538340;Ne;0;8;0;8
22185;"Vilniaus Trakų Vokės gimnazija";BITUTĖS;3449317958;Ne;0;1;2;3
22186;"Vilniaus Trakų Vokės gimnazija";BITUTĖS;1398572100;Ne;0;7;2;9
22187;"Vilniaus Trakų Vokės gimnazija";BITUTĖS;2469486746;Ne;2;1;10;13
22188;"Vilniaus Ryto progimnazija";RYTUKAI;3397350274;Ne;7;4;0;11
22189;"Vilniaus Ryto progimnazija";RYTUKAI;4822495270;Ne;0;4;0;4
22190;"Vilniaus Ryto progimnazija";RYTUKAI;5267128750;Ne;0;4;0;4
22191;"Vilniaus Ryto progimnazija";RYTUKAI;3235523199;Ne;6;4;0;10
22192;"Vilniaus Ryto progimnazija";RYTUKAI;9197480840;Ne;0;4;1;5
22193;"Vilniaus Ryto progimnazija";RYTUKAI;8625023976;Ne;5;4;0;9
22194;"Vilniaus Ryto progimnazija";RYTUKAI;2537442505;Ne;2;4;0;6
22195;"Vilniaus Ryto progimnazija";RYTUKAI;7365398150;Ne;9;4;0;13
22196;"Vilniaus Ryto progimnazija";RYTUKAI;7873373923;Ne;10;3;0;13
22197;"Vilniaus Ryto progimnazija";RYTUKAI;3461165182;Ne;0;4;15;19
22198;"Vilniaus Ryto progimnazija";RYTUKAI;6340323302;Ne;0;4;0;4
22199;"Vilniaus Ryto progimnazija";RYTUKAI;7638618099;Ne;0;8;2;10
22200;"Vilniaus Ryto progimnazija";RYTUKAI;6852734826;Ne;0;4;6;10
22201;"Vilniaus Ryto progimnazija";RYTUKAI;5494350183;Ne;0;6;0;6
22202;"Vilniaus Ryto progimnazija";RYTUKAI;5148002236;Ne;1;4;0;5
22203;"Vilniaus Ryto progimnazija";RYTUKAI;3192818461;Ne;0;4;0;4
22204;"Vilniaus Ryto progimnazija";RYTUKAI;4086461803;Ne;5;4;0;9
22205;"Vilniaus Ryto progimnazija";RYTUKAI;2921485707;Ne;6;4;0;10
22206;"Vilniaus Ryto progimnazija";RYTUKAI;8011986769;Ne;3;4;0;7
22207;"Vilniaus Ryto progimnazija";RYTUKAI;4029370760;Ne;8;4;0;12
22208;"Vilniaus Salininkų gimnazija";"Priešmokyklinė A";6850925495;Ne;0;4;1;5
22209;"Vilniaus Salininkų gimnazija";"Priešmokyklinė A";6577237672;Ne;0;5;0;5
22210;"Vilniaus Salininkų gimnazija";"Priešmokyklinė A";2760231414;Ne;3;4;0;7
22211;"Vilniaus Salininkų gimnazija";"Priešmokyklinė A";7665409499;Ne;0;5;0;5
22212;"Vilniaus Salininkų gimnazija";"Priešmokyklinė A";8603759429;Ne;0;5;0;5
22213;"Vilniaus Salininkų gimnazija";"Priešmokyklinė A";9724367035;Ne;0;4;0;4
22214;"Vilniaus Salininkų gimnazija";"Priešmokyklinė A";8995565864;Ne;0;5;0;5
22215;"Vilniaus Salininkų gimnazija";"Priešmokyklinė A";7782972361;Ne;0;4;0;4
22216;"Vilniaus Salininkų gimnazija";"Priešmokyklinė A";8394582546;Ne;0;6;0;6
22217;"Vilniaus Salininkų gimnazija";"Priešmokyklinė A";6327046935;Ne;1;6;0;7
22218;"Vilniaus Salininkų gimnazija";"Priešmokyklinė A";4425748908;Ne;6;7;0;13
22219;"Vilniaus Salininkų gimnazija";"Priešmokyklinė A";8774984357;Ne;0;5;0;5
22220;"Vilniaus Salininkų gimnazija";"Priešmokyklinė A";6155979185;Ne;0;7;0;7
22221;"Vilniaus Salininkų gimnazija";"Priešmokyklinė A";6485917683;Ne;0;4;0;4
22222;"Vilniaus Salininkų gimnazija";"Priešmokyklinė A";8206979332;Taip;0;7;0;7
22223;"Vilniaus Salininkų gimnazija";"Priešmokyklinė A";7737045952;Ne;0;4;0;4
22224;"Vilniaus Salininkų gimnazija";"Priešmokyklinė A";4323257798;Ne;0;4;0;4
22225;"Vilniaus Salininkų gimnazija";"Priešmokyklinė A";1975168626;Ne;0;5;0;5
22226;"Vilniaus Salininkų gimnazija";"Priešmokyklinė A";8016341646;Ne;0;4;0;4
22227;"Vilniaus Salininkų gimnazija";"Priešmokyklinė A";2262425557;Ne;0;6;0;6
22228;"Vilniaus Salininkų gimnazija";"PRIEŠMOKYKLINĖ B";5427013789;Ne;0;4;0;4
22229;"Vilniaus Salininkų gimnazija";"PRIEŠMOKYKLINĖ B";3100499807;Ne;0;4;0;4
22230;"Vilniaus Salininkų gimnazija";"PRIEŠMOKYKLINĖ B";5867676844;Ne;1;4;0;5
22231;"Vilniaus Salininkų gimnazija";"PRIEŠMOKYKLINĖ B";3122948974;Ne;0;4;0;4
22232;"Vilniaus Salininkų gimnazija";"PRIEŠMOKYKLINĖ B";3585435095;Ne;5;4;0;9
22233;"Vilniaus Salininkų gimnazija";"PRIEŠMOKYKLINĖ B";1658695150;Ne;1;4;1;6
22234;"Vilniaus Salininkų gimnazija";"PRIEŠMOKYKLINĖ B";3737834032;Ne;0;9;0;9
22235;"Vilniaus Salininkų gimnazija";"PRIEŠMOKYKLINĖ B";9344614003;Ne;0;4;0;4
22236;"Vilniaus Salininkų gimnazija";"PRIEŠMOKYKLINĖ B";2808778763;Ne;9;4;0;13
22237;"Vilniaus Salininkų gimnazija";"PRIEŠMOKYKLINĖ B";9890660815;Ne;0;4;0;4
22238;"Vilniaus Salininkų gimnazija";"PRIEŠMOKYKLINĖ B";8189699392;Ne;0;4;1;5
22239;"Vilniaus Salininkų gimnazija";"PRIEŠMOKYKLINĖ B";8047582970;Ne;1;4;0;5
22240;"Vilniaus Salininkų gimnazija";"PRIEŠMOKYKLINĖ B";3739751121;Ne;10;4;0;14
22241;"Vilniaus Salininkų gimnazija";"PRIEŠMOKYKLINĖ B";7403996266;Ne;0;4;0;4
22242;"Vilniaus Salininkų gimnazija";"PRIEŠMOKYKLINĖ B";2495718547;Ne;1;4;0;5
22243;"Vilniaus Salininkų gimnazija";"PRIEŠMOKYKLINĖ B";9813360176;Ne;2;5;0;7
22244;"Vilniaus Salininkų gimnazija";"PRIEŠMOKYKLINĖ B";6656578271;Ne;2;4;0;6
22245;"Vilniaus Salininkų gimnazija";"PRIEŠMOKYKLINĖ B";6266609965;Ne;0;5;0;5
22246;"Vilniaus Salininkų gimnazija";"PRIEŠMOKYKLINĖ B";3196285660;Ne;0;4;1;5
22247;"Vilniaus Salininkų gimnazija";"PRIEŠMOKYKLINĖ B";4771867627;Ne;0;7;0;7
22248;"Vilniaus „Spindulio“ progimnazija";PM2;4119370256;Ne;0;4;0;4
22249;"Vilniaus „Spindulio“ progimnazija";PM2;8076961367;Ne;0;5;0;5
22250;"Vilniaus „Spindulio“ progimnazija";PM2;8439204095;Ne;0;4;0;4
22251;"Vilniaus „Spindulio“ progimnazija";PM2;6352250868;Ne;0;4;0;4
22252;"Vilniaus „Spindulio“ progimnazija";PM2;7273838695;Ne;0;4;0;4
22253;"Vilniaus „Spindulio“ progimnazija";PM2;8440546956;Ne;4;4;0;8
22254;"Vilniaus „Spindulio“ progimnazija";PM2;1030958414;Ne;0;4;0;4
22255;"Vilniaus „Spindulio“ progimnazija";PM2;5030400578;Ne;0;4;0;4
22256;"Vilniaus „Spindulio“ progimnazija";PM2;1200205376;Ne;0;4;0;4
22257;"Vilniaus „Spindulio“ progimnazija";PM2;2010703982;Ne;0;4;0;4
22258;"Vilniaus „Spindulio“ progimnazija";PM2;1455509576;Ne;0;4;0;4
22259;"Vilniaus „Spindulio“ progimnazija";PM2;6935992202;Ne;1;4;0;5
22260;"Vilniaus „Spindulio“ progimnazija";PM2;2094258481;Ne;3;5;0;8
22261;"Vilniaus „Spindulio“ progimnazija";PM2;1005082012;Ne;1;4;0;5
22262;"Vilniaus „Spindulio“ progimnazija";PM2;7197544314;Ne;10;4;0;14
22263;"Vilniaus „Spindulio“ progimnazija";PM2;4678970810;Ne;2;4;0;6
22264;"Vilniaus „Spindulio“ progimnazija";PM2;3985610575;Ne;0;6;1;7
22265;"Vilniaus „Spindulio“ progimnazija";PM2;6531930806;Ne;0;4;0;4
22266;"Vilniaus „Spindulio“ progimnazija";PM2;4179507316;Ne;3;5;0;8
22267;"Vilniaus „Spindulio“ progimnazija";PM2;5783537897;Ne;0;4;0;4
22268;"Vilniaus „Spindulio“ progimnazija";PM2;8936645508;Ne;0;4;0;4
22269;"Vilniaus „Spindulio“ progimnazija";PM2;1153948822;Ne;0;4;0;4
22270;"Vilniaus „Spindulio“ progimnazija";PM2;3284212595;Ne;0;4;0;4
22271;"Vilniaus „Spindulio“ progimnazija";PM2;8728791932;Ne;0;4;0;4
22272;"Vilniaus „Spindulio“ progimnazija";PM1;8160982025;Ne;0;6;0;6
22273;"Vilniaus „Spindulio“ progimnazija";PM1;5835209357;Ne;0;4;0;4
22274;"Vilniaus „Spindulio“ progimnazija";PM1;6578506861;Ne;6;4;0;10
22275;"Vilniaus „Spindulio“ progimnazija";PM1;9628317328;Ne;0;5;1;6
22276;"Vilniaus „Spindulio“ progimnazija";PM1;9898412288;Ne;5;4;0;9
22277;"Vilniaus „Spindulio“ progimnazija";PM1;6577214344;Ne;7;4;1;12
22278;"Vilniaus „Spindulio“ progimnazija";PM1;8432654056;Ne;0;4;0;4
22279;"Vilniaus „Spindulio“ progimnazija";PM1;7487111570;Ne;0;4;3;7
22280;"Vilniaus „Spindulio“ progimnazija";PM1;5327627748;Ne;0;4;1;5
22281;"Vilniaus „Spindulio“ progimnazija";PM1;6575909478;Ne;3;5;1;9
22282;"Vilniaus „Spindulio“ progimnazija";PM1;6047881184;Ne;1;4;0;5
22283;"Vilniaus „Spindulio“ progimnazija";PM1;6826790492;Ne;0;4;0;4
22284;"Vilniaus „Spindulio“ progimnazija";PM1;5123666058;Ne;0;4;0;4
22285;"Vilniaus „Spindulio“ progimnazija";PM1;5305660046;Ne;4;4;0;8
22286;"Vilniaus „Spindulio“ progimnazija";PM1;5210301367;Ne;1;4;0;5
22287;"Vilniaus „Spindulio“ progimnazija";PM1;2948291866;Ne;2;4;0;6
22288;"Vilniaus „Spindulio“ progimnazija";PM1;2945894661;Ne;4;4;1;9
22289;"Vilniaus „Spindulio“ progimnazija";PM1;1392036584;Ne;4;4;0;8
22290;"Vilniaus „Spindulio“ progimnazija";PM1;4713803167;Ne;3;5;0;8
22291;"Vilniaus „Spindulio“ progimnazija";PM1;2066127119;Ne;3;4;0;7
22292;"Vilniaus „Spindulio“ progimnazija";PM1;9074294473;Ne;0;19;0;19
22293;"Vilniaus „Spindulio“ progimnazija";PM1;3554823424;Ne;0;4;0;4
22294;"Vilniaus „Spindulio“ progimnazija";PM1;4347116918;Ne;4;4;0;8
22295;"Vilniaus Vladislavo Sirokomlės gimnazija";Nykštukai;1588062393;Ne;0;8;0;8
22296;"Vilniaus Vladislavo Sirokomlės gimnazija";Nykštukai;4715704693;Ne;4;6;0;10
22297;"Vilniaus Vladislavo Sirokomlės gimnazija";Nykštukai;6451722893;Ne;0;7;0;7
22298;"Vilniaus Vladislavo Sirokomlės gimnazija";Nykštukai;2923698853;Ne;2;27;0;29
22299;"Vilniaus Vladislavo Sirokomlės gimnazija";Nykštukai;7364698713;Ne;0;11;0;11
22300;"Vilniaus Vladislavo Sirokomlės gimnazija";Nykštukai;6613003059;Ne;1;7;0;8
22301;"Vilniaus Vladislavo Sirokomlės gimnazija";Nykštukai;7113970557;Ne;1;7;0;8
22302;"Vilniaus Vladislavo Sirokomlės gimnazija";Nykštukai;1698478530;Ne;0;7;0;7
22303;"Vilniaus Vladislavo Sirokomlės gimnazija";Nykštukai;7413098580;Ne;3;8;0;11
22304;"Vilniaus Vladislavo Sirokomlės gimnazija";Nykštukai;6843262303;Ne;0;7;0;7
22305;"Vilniaus Vladislavo Sirokomlės gimnazija";Nykštukai;5150028968;Ne;0;7;0;7
22306;"Vilniaus Vladislavo Sirokomlės gimnazija";Nykštukai;5999318972;Ne;1;6;0;7
22307;"Vilniaus Vladislavo Sirokomlės gimnazija";Nykštukai;2092319455;Ne;2;8;0;10
22308;"Vilniaus Vladislavo Sirokomlės gimnazija";Nykštukai;5822045625;Ne;1;9;0;10
22309;"Vilniaus Vladislavo Sirokomlės gimnazija";Nykštukai;2373600520;Ne;0;7;0;7
22310;"Vilniaus Vladislavo Sirokomlės gimnazija";Nykštukai;6166192468;Ne;2;8;0;10
22311;"Vilniaus Vladislavo Sirokomlės gimnazija";Nykštukai;1272758839;Ne;15;6;0;21
22312;"Vilniaus Vladislavo Sirokomlės gimnazija";Nykštukai;1512245903;Ne;5;7;0;12
22313;"Vilniaus Vladislavo Sirokomlės gimnazija";Smurfai;2262586409;Ne;0;30;0;30
22314;"Vilniaus Vladislavo Sirokomlės gimnazija";Smurfai;9457457032;Ne;0;7;0;7
22315;"Vilniaus Vladislavo Sirokomlės gimnazija";Smurfai;5041189990;Ne;3;8;0;11
22316;"Vilniaus Vladislavo Sirokomlės gimnazija";Smurfai;7429739147;Ne;2;7;0;9
22317;"Vilniaus Vladislavo Sirokomlės gimnazija";Smurfai;6866592245;Ne;0;8;0;8
22318;"Vilniaus Vladislavo Sirokomlės gimnazija";Smurfai;9396676137;Ne;0;6;0;6
22319;"Vilniaus Vladislavo Sirokomlės gimnazija";Smurfai;9353066785;Ne;0;6;0;6
22320;"Vilniaus Vladislavo Sirokomlės gimnazija";Smurfai;4415030161;Ne;0;7;0;7
22321;"Vilniaus Vladislavo Sirokomlės gimnazija";Smurfai;1386916991;Ne;3;9;0;12
22322;"Vilniaus Vladislavo Sirokomlės gimnazija";Smurfai;2999425729;Ne;5;7;0;12
22323;"Vilniaus Vladislavo Sirokomlės gimnazija";Smurfai;7334310944;Ne;8;6;0;14
22324;"Vilniaus Vladislavo Sirokomlės gimnazija";Smurfai;6385918522;Ne;0;10;0;10
22325;"Vilniaus Vladislavo Sirokomlės gimnazija";Smurfai;1894717954;Ne;0;7;0;7
22326;"Vilniaus Vladislavo Sirokomlės gimnazija";Smurfai;3810261864;Ne;0;9;0;9
22327;"Vilniaus Vladislavo Sirokomlės gimnazija";Smurfai;4658530212;Ne;0;11;0;11
22328;"Vilniaus Vladislavo Sirokomlės gimnazija";Smurfai;4191386053;Ne;0;8;0;8
22329;"Vilniaus Vladislavo Sirokomlės gimnazija";Smurfai;4760204642;Ne;0;7;0;7
22330;"Vilniaus Vladislavo Sirokomlės gimnazija";Smurfai;3316897176;Ne;3;7;0;10
22331;"Vilniaus „Pelėdos” pradinė mokykla";BITUTĖS;1540892686;Ne;6;4;0;10
22332;"Vilniaus „Pelėdos” pradinė mokykla";BITUTĖS;1775717256;Ne;2;4;0;6
22333;"Vilniaus „Pelėdos” pradinė mokykla";BITUTĖS;7587887488;Ne;0;4;0;4
22334;"Vilniaus „Pelėdos” pradinė mokykla";BITUTĖS;6886461269;Ne;0;4;2;6
22335;"Vilniaus „Pelėdos” pradinė mokykla";BITUTĖS;8466974910;Ne;0;4;0;4
22336;"Vilniaus „Pelėdos” pradinė mokykla";BITUTĖS;8874979704;Ne;0;4;2;6
22337;"Vilniaus „Pelėdos” pradinė mokykla";BITUTĖS;4315677064;Ne;0;4;0;4
22338;"Vilniaus „Pelėdos” pradinė mokykla";BITUTĖS;3247532201;Ne;10;4;4;18
22339;"Vilniaus „Pelėdos” pradinė mokykla";BITUTĖS;5490544278;Ne;0;2;0;2
22340;"Vilniaus „Pelėdos” pradinė mokykla";BITUTĖS;2737277656;Ne;0;4;0;4
22341;"Vilniaus „Pelėdos” pradinė mokykla";BITUTĖS;6505671642;Ne;0;2;0;2
22342;"Vilniaus „Pelėdos” pradinė mokykla";BITUTĖS;6191899254;Ne;1;4;0;5
22343;"Vilniaus „Pelėdos” pradinė mokykla";BITUTĖS;8016820352;Ne;0;2;0;2
22344;"Vilniaus „Pelėdos” pradinė mokykla";BITUTĖS;6191427974;Ne;0;4;1;5
22345;"Vilniaus „Pelėdos” pradinė mokykla";BITUTĖS;8650379074;Ne;5;4;1;10
22346;"Vilniaus „Pelėdos” pradinė mokykla";BITUTĖS;8874149122;Ne;1;4;0;5
22347;"Vilniaus „Pelėdos” pradinė mokykla";BITUTĖS;3318222372;Ne;0;4;0;4
22348;"Vilniaus „Pelėdos” pradinė mokykla";BITUTĖS;5061655822;Ne;7;4;0;11
22349;"Vilniaus „Pelėdos” pradinė mokykla";BITUTĖS;7960825423;Ne;6;2;0;8
22350;"Vilniaus „Pelėdos” pradinė mokykla";BITUTĖS;4324931449;Ne;1;4;0;5
22351;"Vilniaus „Pelėdos” pradinė mokykla";BITUTĖS;5924332293;Ne;1;4;0;5
22352;"Vilniaus Joachimo Lelevelio inžinerijos gimnazija";0A;7508357392;Ne;0;4;0;4
22353;"Vilniaus Joachimo Lelevelio inžinerijos gimnazija";0A;9106152447;Ne;0;5;0;5
22354;"Vilniaus Joachimo Lelevelio inžinerijos gimnazija";0A;4033866425;Ne;0;4;0;4
22355;"Vilniaus Joachimo Lelevelio inžinerijos gimnazija";0A;8086994543;Ne;0;4;0;4
22356;"Vilniaus Joachimo Lelevelio inžinerijos gimnazija";0A;2701042709;Ne;1;4;0;5
22357;"Vilniaus Joachimo Lelevelio inžinerijos gimnazija";0A;3649329598;Ne;0;4;0;4
22358;"Vilniaus Joachimo Lelevelio inžinerijos gimnazija";0A;2225787182;Ne;4;4;0;8
22359;"Vilniaus Joachimo Lelevelio inžinerijos gimnazija";0A;7307307882;Ne;0;9;0;9
22360;"Vilniaus Joachimo Lelevelio inžinerijos gimnazija";0A;6316768460;Ne;2;4;0;6
22361;"Vilniaus Joachimo Lelevelio inžinerijos gimnazija";0A;9798993200;Ne;3;4;0;7
22362;"Vilniaus Joachimo Lelevelio inžinerijos gimnazija";0A;6417545510;Ne;0;4;0;4
22363;"Vilniaus Joachimo Lelevelio inžinerijos gimnazija";0B;9965517774;Ne;0;13;0;13
22364;"Vilniaus Joachimo Lelevelio inžinerijos gimnazija";0B;7138581709;Ne;0;13;0;13
22365;"Vilniaus Joachimo Lelevelio inžinerijos gimnazija";0B;7911007041;Ne;4;9;0;13
22366;"Vilniaus Joachimo Lelevelio inžinerijos gimnazija";0B;2125410714;Ne;3;8;0;11
22367;"Vilniaus Joachimo Lelevelio inžinerijos gimnazija";0B;7956422880;Ne;10;6;0;16
22368;"Vilniaus Joachimo Lelevelio inžinerijos gimnazija";0B;8446233414;Ne;5;11;0;16
22369;"Vilniaus Joachimo Lelevelio inžinerijos gimnazija";0B;5689369492;Ne;5;8;0;13
22370;"Vilniaus Joachimo Lelevelio inžinerijos gimnazija";0B;8797584508;Ne;4;6;0;10
22371;"Vilniaus Joachimo Lelevelio inžinerijos gimnazija";0B;7553024183;Ne;13;6;0;19
22372;"Vilniaus Joachimo Lelevelio inžinerijos gimnazija";0B;6861062723;Ne;5;8;0;13
22373;"Vilniaus Joachimo Lelevelio inžinerijos gimnazija";0B;8703116268;Ne;5;8;0;13
22374;"Vilniaus Joachimo Lelevelio inžinerijos gimnazija";0B;4312062240;Ne;9;6;0;15
22375;"Vilniaus Juzefo Ignacijaus Kraševskio gimnazija";DRUGĖLIAI;5157814568;Ne;2;4;0;6
22376;"Vilniaus Juzefo Ignacijaus Kraševskio gimnazija";DRUGĖLIAI;8747343811;Ne;0;4;0;4
22377;"Vilniaus Juzefo Ignacijaus Kraševskio gimnazija";DRUGĖLIAI;7502911642;Ne;5;4;0;9
22378;"Vilniaus Juzefo Ignacijaus Kraševskio gimnazija";DRUGĖLIAI;6028582927;Ne;0;4;0;4
22379;"Vilniaus Juzefo Ignacijaus Kraševskio gimnazija";DRUGĖLIAI;6403149921;Ne;6;4;0;10
22380;"Vilniaus Juzefo Ignacijaus Kraševskio gimnazija";DRUGĖLIAI;5328263421;Ne;0;4;0;4
22381;"Vilniaus Juzefo Ignacijaus Kraševskio gimnazija";DRUGĖLIAI;4022408510;Ne;0;4;0;4
22382;"Vilniaus Juzefo Ignacijaus Kraševskio gimnazija";DRUGĖLIAI;4257115650;Ne;0;4;0;4
22383;"Vilniaus Juzefo Ignacijaus Kraševskio gimnazija";DRUGĖLIAI;8521846076;Ne;0;7;0;7
22384;"Vilniaus Juzefo Ignacijaus Kraševskio gimnazija";DRUGĖLIAI;6427289718;Ne;6;4;0;10
22385;"Vilniaus Juzefo Ignacijaus Kraševskio gimnazija";DRUGĖLIAI;8214699601;Ne;0;5;0;5
22386;"Vilniaus Juzefo Ignacijaus Kraševskio gimnazija";DRUGĖLIAI;7685428258;Ne;1;4;0;5
22387;"Vilniaus Juzefo Ignacijaus Kraševskio gimnazija";DRUGĖLIAI;6781303455;Ne;0;5;0;5
22388;"Vilniaus Juzefo Ignacijaus Kraševskio gimnazija";DRUGĖLIAI;7841179083;Ne;0;4;0;4
22389;"Vilniaus Juzefo Ignacijaus Kraševskio gimnazija";DRUGĖLIAI;4845049639;Ne;5;4;0;9
22390;"Vilniaus Juzefo Ignacijaus Kraševskio gimnazija";DRUGĖLIAI;3522200752;Ne;4;5;0;9
22391;"Vilniaus Juzefo Ignacijaus Kraševskio gimnazija";DRUGĖLIAI;8808382134;Ne;10;4;0;14
22392;"Vilniaus Juzefo Ignacijaus Kraševskio gimnazija";DRUGĖLIAI;9333766622;Ne;15;4;0;19
22393;"Vilniaus Juzefo Ignacijaus Kraševskio gimnazija";DRUGĖLIAI;3698808100;Ne;0;8;0;8
22394;"Vilniaus Jono Pauliaus II progimnazija";Nykštukai;2493612905;Ne;5;6;0;11
22395;"Vilniaus Jono Pauliaus II progimnazija";Nykštukai;6742119549;Ne;0;12;0;12
22396;"Vilniaus Jono Pauliaus II progimnazija";Nykštukai;8047799576;Ne;0;7;0;7
22397;"Vilniaus Jono Pauliaus II progimnazija";Nykštukai;1381191703;Ne;0;21;0;21
22398;"Vilniaus Jono Pauliaus II progimnazija";Nykštukai;9042329808;Ne;2;7;0;9
22399;"Vilniaus Jono Pauliaus II progimnazija";Nykštukai;5909697341;Ne;0;7;0;7
22400;"Vilniaus Jono Pauliaus II progimnazija";Nykštukai;6525761466;Ne;0;6;0;6
22401;"Vilniaus Jono Pauliaus II progimnazija";Nykštukai;1254369602;Ne;0;6;0;6
22402;"Vilniaus Jono Pauliaus II progimnazija";Nykštukai;3346154143;Ne;5;6;0;11
22403;"Vilniaus Jono Pauliaus II progimnazija";Nykštukai;5734602455;Ne;4;6;0;10
22404;"Vilniaus Jono Pauliaus II progimnazija";Nykštukai;8054114720;Ne;0;8;0;8
22405;"Vilniaus Jono Pauliaus II progimnazija";Nykštukai;2190583964;Ne;3;6;0;9
22406;"Vilniaus Jono Pauliaus II progimnazija";Nykštukai;3920229653;Ne;3;6;0;9
22407;"Vilniaus Jono Pauliaus II progimnazija";Nykštukai;8092890260;Ne;0;6;0;6
22408;"Vilniaus Jono Pauliaus II progimnazija";Nykštukai;3998988004;Ne;10;7;0;17
22409;"Vilniaus Jono Pauliaus II progimnazija";Nykštukai;6756184787;Ne;4;6;0;10
22410;"Vilniaus Jono Pauliaus II progimnazija";Nykštukai;5768470608;Ne;3;6;0;9
22411;"Vilniaus Jono Pauliaus II progimnazija";Nykštukai;3584347608;Ne;3;7;0;10
22412;"Vilniaus Jono Pauliaus II progimnazija";Nykštukai;2948716989;Ne;0;7;0;7
22413;"Vilniaus Jono Pauliaus II progimnazija";Žiniukai;3687735991;Ne;0;6;0;6
22414;"Vilniaus Jono Pauliaus II progimnazija";Žiniukai;8678437720;Ne;0;4;0;4
22415;"Vilniaus Jono Pauliaus II progimnazija";Žiniukai;4543822765;Ne;2;4;1;7
22416;"Vilniaus Jono Pauliaus II progimnazija";Žiniukai;7459673719;Ne;0;6;0;6
22417;"Vilniaus Jono Pauliaus II progimnazija";Žiniukai;4566817285;Ne;2;4;0;6
22418;"Vilniaus Jono Pauliaus II progimnazija";Žiniukai;3332865242;Ne;3;4;0;7
22419;"Vilniaus Jono Pauliaus II progimnazija";Žiniukai;5978993456;Ne;2;4;0;6
22420;"Vilniaus Jono Pauliaus II progimnazija";Žiniukai;4288487063;Ne;3;4;0;7
22421;"Vilniaus Jono Pauliaus II progimnazija";Žiniukai;9522524163;Ne;6;5;0;11
22422;"Vilniaus Jono Pauliaus II progimnazija";Žiniukai;6712878938;Ne;4;5;0;9
22423;"Vilniaus Jono Pauliaus II progimnazija";Žiniukai;9414051187;Ne;10;4;0;14
22424;"Vilniaus Jono Pauliaus II progimnazija";Žiniukai;8812316692;Ne;1;4;0;5
22425;"Vilniaus Jono Pauliaus II progimnazija";Žiniukai;9357757604;Ne;4;6;0;10
22426;"Vilniaus Jono Pauliaus II progimnazija";Žiniukai;4291690659;Ne;0;5;0;5
22427;"Vilniaus Jono Pauliaus II progimnazija";Žiniukai;3489127587;Ne;0;10;0;10
22428;"Vilniaus Jono Pauliaus II progimnazija";Žiniukai;3772830210;Ne;0;4;0;4
22429;"Vilniaus Jono Pauliaus II progimnazija";Žiniukai;5043122065;Ne;1;4;0;5
22430;"Vilniaus Jono Pauliaus II progimnazija";Žiniukai;3349199472;Ne;0;15;0;15
22431;"Vilniaus Jono Pauliaus II progimnazija";Žiniukai;2654794460;Ne;3;4;0;7
22432;"Vilniaus Jono Pauliaus II progimnazija";Žiniukai;6478873536;Ne;7;4;0;11
22433;"Vilniaus Jono Pauliaus II progimnazija";Spindulėlis;5492437864;Ne;9;6;0;15
22434;"Vilniaus Jono Pauliaus II progimnazija";Spindulėlis;3269357241;Ne;0;7;0;7
22435;"Vilniaus Jono Pauliaus II progimnazija";Spindulėlis;2840112908;Ne;5;6;0;11
22436;"Vilniaus Jono Pauliaus II progimnazija";Spindulėlis;4433799070;Ne;0;6;0;6
22437;"Vilniaus Jono Pauliaus II progimnazija";Spindulėlis;5440679175;Ne;5;6;0;11
22438;"Vilniaus Jono Pauliaus II progimnazija";Spindulėlis;7178844364;Ne;0;9;1;10
22439;"Vilniaus Jono Pauliaus II progimnazija";Spindulėlis;4426643908;Ne;2;6;0;8
22440;"Vilniaus Jono Pauliaus II progimnazija";Spindulėlis;6281687751;Ne;0;6;0;6
22441;"Vilniaus Jono Pauliaus II progimnazija";Spindulėlis;6996900411;Ne;9;7;1;17
22442;"Vilniaus Jono Pauliaus II progimnazija";Spindulėlis;2090334618;Ne;12;6;1;19
22443;"Vilniaus Jono Pauliaus II progimnazija";Spindulėlis;8753972322;Ne;0;7;0;7
22444;"Vilniaus Jono Pauliaus II progimnazija";Spindulėlis;6435612222;Ne;10;8;1;19
22445;"Vilniaus Jono Pauliaus II progimnazija";Spindulėlis;1583038469;Ne;5;6;1;12
22446;"Vilniaus Jono Pauliaus II progimnazija";Spindulėlis;9226214856;Ne;3;6;0;9
22447;"Vilniaus Jono Pauliaus II progimnazija";Spindulėlis;3121251271;Ne;0;10;0;10
22448;"Vilniaus Jono Pauliaus II progimnazija";Spindulėlis;4189943614;Ne;0;8;0;8
22449;"Vilniaus Jono Pauliaus II progimnazija";Spindulėlis;2515028280;Ne;3;8;0;11
22450;"Vilniaus Jono Pauliaus II progimnazija";Spindulėlis;5987294293;Ne;3;11;1;15
22451;"Vilniaus Jono Pauliaus II progimnazija";Spindulėlis;9531574134;Ne;3;6;0;9
22452;"Vilniaus Jono Pauliaus II progimnazija";Spindulėlis;8043493934;Ne;0;6;0;6
22453;"Vilniaus Jono Pauliaus II progimnazija";Uogytės;3502278745;Ne;7;6;0;13
22454;"Vilniaus Jono Pauliaus II progimnazija";Uogytės;3445649442;Ne;2;6;0;8
22455;"Vilniaus Jono Pauliaus II progimnazija";Uogytės;3900091129;Ne;4;6;0;10
22456;"Vilniaus Jono Pauliaus II progimnazija";Uogytės;6367875352;Ne;8;6;0;14
22457;"Vilniaus Jono Pauliaus II progimnazija";Uogytės;2843328732;Ne;1;6;0;7
22458;"Vilniaus Jono Pauliaus II progimnazija";Uogytės;1440531672;Ne;4;6;0;10
22459;"Vilniaus Jono Pauliaus II progimnazija";Uogytės;1502013942;Ne;3;6;0;9
22460;"Vilniaus Jono Pauliaus II progimnazija";Uogytės;2205400512;Ne;8;6;0;14
22461;"Vilniaus Jono Pauliaus II progimnazija";Uogytės;4969561425;Ne;1;6;0;7
22462;"Vilniaus Jono Pauliaus II progimnazija";Uogytės;4726351175;Ne;4;6;0;10
22463;"Vilniaus Jono Pauliaus II progimnazija";Uogytės;5028510873;Ne;14;6;0;20
22464;"Vilniaus Jono Pauliaus II progimnazija";Uogytės;4335378625;Ne;2;6;0;8
22465;"Vilniaus Jono Pauliaus II progimnazija";Uogytės;5600979545;Ne;8;6;0;14
22466;"Vilniaus Jono Pauliaus II progimnazija";Uogytės;8459980712;Ne;8;6;0;14
22467;"Vilniaus Jono Pauliaus II progimnazija";Uogytės;7089883250;Ne;6;6;0;12
22468;"Vilniaus Jono Pauliaus II progimnazija";Uogytės;4733227215;Ne;10;6;0;16
22469;"Vilniaus Jono Pauliaus II progimnazija";Uogytės;1290248125;Ne;4;6;0;10
22470;"Vilniaus Jono Pauliaus II progimnazija";Uogytės;9037835899;Ne;11;6;0;17
22471;"Vilniaus Jono Pauliaus II progimnazija";Uogytės;9235884407;Ne;3;21;0;24
22472;"Vilniaus Jono Pauliaus II progimnazija";Uogytės;8949018147;Ne;8;6;0;14
22473;"Vilniaus Verkių mokykla-daugiafunkcis centras";"SĮUP I m.m., SĮUP II m.m. klasė";1853931111;Ne;0;14;0;14
22474;"Vilniaus Verkių mokykla-daugiafunkcis centras";"SĮUP I m.m., SĮUP II m.m. klasė";2457359072;Ne;0;5;0;5
22475;"Vilniaus Verkių mokykla-daugiafunkcis centras";"SĮUP I m.m., SĮUP II m.m. klasė";6808441017;Ne;0;4;0;4
22476;"Vilniaus Verkių mokykla-daugiafunkcis centras";"SĮUP I m.m., SĮUP II m.m. klasė";7886245604;Ne;0;9;0;9
22477;"Vilniaus Verkių mokykla-daugiafunkcis centras";"SĮUP I m.m., SĮUP II m.m. klasė";5256639859;Ne;0;4;0;4
22478;"Vilniaus Verkių mokykla-daugiafunkcis centras";"SĮUP I m.m., SĮUP II m.m. klasė";6213577188;Ne;0;7;0;7
22479;"Vilniaus Verkių mokykla-daugiafunkcis centras";"SĮUP I m.m., SĮUP II m.m. klasė";8732243137;Ne;0;10;0;10
22480;"Vilniaus Verkių mokykla-daugiafunkcis centras";"SĮUP I m.m., SĮUP II m.m. klasė";6301505187;Ne;0;14;0;14
22481;"Vilniaus Verkių mokykla-daugiafunkcis centras";"SĮUP I m.m., SĮUP II m.m. klasė";9975744237;Ne;0;6;0;6
22482;"Vilniaus Verkių mokykla-daugiafunkcis centras";"SĮUP I m.m., SĮUP II m.m. klasė";5476038315;Ne;0;7;0;7
22483;"Vilniaus Verkių mokykla-daugiafunkcis centras";"SĮUP I m.m., SĮUP II m.m., SĮUP III m.m. klasė ";4518835802;Ne;0;11;0;11
22484;"Vilniaus Verkių mokykla-daugiafunkcis centras";"SĮUP I m.m., SĮUP II m.m., SĮUP III m.m. klasė ";9666721487;Ne;0;9;0;9
22485;"Vilniaus Verkių mokykla-daugiafunkcis centras";"SĮUP I m.m., SĮUP II m.m., SĮUP III m.m. klasė ";2714397701;Ne;0;6;0;6
22486;"Vilniaus Verkių mokykla-daugiafunkcis centras";"SĮUP I m.m., SĮUP II m.m., SĮUP III m.m. klasė ";4054448861;Ne;0;5;0;5
22487;"Vilniaus Verkių mokykla-daugiafunkcis centras";"SĮUP I m.m., SĮUP II m.m., SĮUP III m.m. klasė ";4857786109;Ne;0;4;0;4
22488;"Vilniaus Verkių mokykla-daugiafunkcis centras";"SĮUP I m.m., SĮUP II m.m., SĮUP III m.m. klasė ";9330275690;Ne;0;5;0;5
22489;"Vilniaus Verkių mokykla-daugiafunkcis centras";"SĮUP I m.m., SĮUP II m.m., SĮUP III m.m. klasė ";6901885288;Ne;0;5;0;5
22490;"Vilniaus Verkių mokykla-daugiafunkcis centras";"SĮUP I m.m., SĮUP II m.m., SĮUP III m.m. klasė ";7381890668;Ne;0;5;0;5
22491;"Vilniaus Verkių mokykla-daugiafunkcis centras";"SĮUP I m.m., SĮUP II m.m., SĮUP III m.m. klasė ";2708620759;Ne;0;18;0;18
22492;"Vilniaus Verkių mokykla-daugiafunkcis centras";"SĮUP I m.m., SĮUP II m.m., SĮUP III m.m. klasė ";7323583579;Ne;0;5;0;5
22493;"Vilniaus Verkių mokykla-daugiafunkcis centras";"9, 10 L klasė";2810286239;Ne;0;19;0;19
22494;"Vilniaus Verkių mokykla-daugiafunkcis centras";"9, 10 L klasė";2054806833;Ne;0;6;0;6
22495;"Vilniaus Verkių mokykla-daugiafunkcis centras";"9, 10 L klasė";9613466086;Ne;0;8;0;8
22496;"Vilniaus Verkių mokykla-daugiafunkcis centras";"9, 10 L klasė";9613466086;Ne;0;8;0;8
22497;"Vilniaus Verkių mokykla-daugiafunkcis centras";"9, 10 L klasė";7616694308;Ne;0;10;0;10
22498;"Vilniaus Verkių mokykla-daugiafunkcis centras";"9, 10 L klasė";1480378589;Ne;0;19;0;19
22499;"Vilniaus Verkių mokykla-daugiafunkcis centras";"9, 10 L klasė";3519068093;Ne;0;6;0;6
22500;"Vilniaus Verkių mokykla-daugiafunkcis centras";"9, 10 L klasė";1990482351;Ne;0;7;0;7
22501;"Vilniaus Verkių mokykla-daugiafunkcis centras";"9, 10 S klasė";8199430682;Ne;0;6;0;6
22502;"Vilniaus Verkių mokykla-daugiafunkcis centras";"9, 10 S klasė";1368271218;Ne;0;4;0;4
22503;"Vilniaus Verkių mokykla-daugiafunkcis centras";"9, 10 S klasė";7689301739;Ne;0;10;0;10
22504;"Vilniaus Verkių mokykla-daugiafunkcis centras";"9, 10 S klasė";6396691531;Ne;0;19;0;19
22505;"Vilniaus Verkių mokykla-daugiafunkcis centras";"9, 10 S klasė";1937996951;Ne;0;4;0;4
22506;"Vilniaus Verkių mokykla-daugiafunkcis centras";"9, 10 S klasė";7819002176;Ne;0;6;0;6
22507;"Vilniaus Verkių mokykla-daugiafunkcis centras";"9, 10 S klasė";9420292538;Ne;0;4;0;4
22508;"Vilniaus Verkių mokykla-daugiafunkcis centras";"9, 10 S klasė";5030855634;Ne;0;17;0;17
22509;"Vilniaus Verkių mokykla-daugiafunkcis centras";"9, 10 S klasė";1259538808;Ne;0;19;0;19
22510;"Vilniaus Verkių mokykla-daugiafunkcis centras";"9, 10 S klasė";5835522029;Ne;0;14;0;14
22511;"Vilniaus Verkių mokykla-daugiafunkcis centras";"8, 9 S klasė";2360897023;Ne;0;5;0;5
22512;"Vilniaus Verkių mokykla-daugiafunkcis centras";"8, 9 S klasė";2415067230;Ne;0;4;0;4
22513;"Vilniaus Verkių mokykla-daugiafunkcis centras";"8, 9 S klasė";1514869108;Ne;0;9;0;9
22514;"Vilniaus Verkių mokykla-daugiafunkcis centras";"8, 9 S klasė";3145397791;Ne;0;9;0;9
22515;"Vilniaus Verkių mokykla-daugiafunkcis centras";"8, 9 S klasė";8779088808;Ne;0;9;0;9
22516;"Vilniaus Verkių mokykla-daugiafunkcis centras";"8, 9 S klasė";3870610295;Ne;0;6;0;6
22517;"Vilniaus Verkių mokykla-daugiafunkcis centras";"8, 9 S klasė";3444507772;Ne;0;5;0;5
22518;"Vilniaus Verkių mokykla-daugiafunkcis centras";"8, 9 S klasė";3215674630;Ne;0;5;0;5
22519;"Vilniaus Verkių mokykla-daugiafunkcis centras";"7 S klasė";3631392717;Ne;0;6;0;6
22520;"Vilniaus Verkių mokykla-daugiafunkcis centras";"7 S klasė";11657021053;Ne;0;7;0;7
22521;"Vilniaus Verkių mokykla-daugiafunkcis centras";"7 S klasė";13432910676;Ne;0;5;0;5
22522;"Vilniaus Verkių mokykla-daugiafunkcis centras";"7 S klasė";8272359516;Ne;0;6;0;6
22523;"Vilniaus Verkių mokykla-daugiafunkcis centras";"7 S klasė";9598385220;Ne;0;7;0;7
22524;"Vilniaus Verkių mokykla-daugiafunkcis centras";"7 S klasė";4914336091;Ne;0;4;0;4
22525;"Vilniaus Verkių mokykla-daugiafunkcis centras";"7 S klasė";4914336091;Ne;0;4;0;4
22526;"Vilniaus Verkių mokykla-daugiafunkcis centras";"7 S klasė";2254324740;Ne;0;15;0;15
22527;"Vilniaus Verkių mokykla-daugiafunkcis centras";"5, 6, 7, 8 L klasė";37572425955;Ne;0;11;0;11
22528;"Vilniaus Verkių mokykla-daugiafunkcis centras";"5, 6, 7, 8 L klasė";44425437058;Ne;0;13;0;13
22529;"Vilniaus Verkių mokykla-daugiafunkcis centras";"5, 6, 7, 8 L klasė";2261393560;Ne;0;11;0;11
22530;"Vilniaus Verkių mokykla-daugiafunkcis centras";"5, 6, 7, 8 L klasė";7438765543;Ne;0;7;0;7
22531;"Vilniaus Verkių mokykla-daugiafunkcis centras";"5, 6, 7, 8 L klasė";37848550744;Ne;0;19;0;19
22532;"Vilniaus Verkių mokykla-daugiafunkcis centras";"5, 6, 7, 8 L klasė";9362938835;Ne;0;5;0;5
22533;"Vilniaus Verkių mokykla-daugiafunkcis centras";"5, 6, 7, 8 L klasė";5937487837;Ne;0;5;0;5
22534;"Vilniaus Verkių mokykla-daugiafunkcis centras";"5, 6, 7, 8 L klasė";1350580842;Ne;0;6;0;6
22535;"Vilniaus Verkių mokykla-daugiafunkcis centras";"5, 6, 7, 8 L klasė";5865808613;Ne;0;6;0;6
22536;"Vilniaus Verkių mokykla-daugiafunkcis centras";"5, 6, 7, 8 L klasė";1891856371;Ne;0;8;0;8
22537;"Vilniaus Verkių mokykla-daugiafunkcis centras";"5, 6 S klasė";2396841187;Ne;0;6;0;6
22538;"Vilniaus Verkių mokykla-daugiafunkcis centras";"5, 6 S klasė";8342540661;Ne;0;6;0;6
22539;"Vilniaus Verkių mokykla-daugiafunkcis centras";"5, 6 S klasė";9634174513;Ne;0;9;0;9
22540;"Vilniaus Verkių mokykla-daugiafunkcis centras";"5, 6 S klasė";62513475987;Ne;0;6;0;6
22541;"Vilniaus Verkių mokykla-daugiafunkcis centras";"5, 6 S klasė";2728524848;Ne;0;11;0;11
22542;"Vilniaus Verkių mokykla-daugiafunkcis centras";"5, 6 S klasė";9816043688;Ne;0;12;0;12
22543;"Vilniaus Verkių mokykla-daugiafunkcis centras";"5, 6 S klasė";5899020119;Ne;0;5;0;5
22544;"Vilniaus Verkių mokykla-daugiafunkcis centras";"5, 6 S klasė";93185505974;Ne;0;8;0;8
22545;"Vilniaus Verkių mokykla-daugiafunkcis centras";"5, 6 S klasė";24268622677;Ne;0;13;0;13
22546;"Vilniaus Verkių mokykla-daugiafunkcis centras";"5, 6 S klasė";24268622677;Ne;0;13;0;13
22547;"Vilniaus Verkių mokykla-daugiafunkcis centras";"5, 6 S klasė";24268622677;Ne;0;13;0;13
22548;"Vilniaus Verkių mokykla-daugiafunkcis centras";"5, 6 S klasė";24268622677;Ne;0;13;0;13
22549;"Vilniaus Verkių mokykla-daugiafunkcis centras";"5, 6 S klasė";67335258608;Ne;0;19;0;19
22550;"Vilniaus Verkių mokykla-daugiafunkcis centras";"5, 6 S klasė";5754278814;Ne;0;19;0;19
22551;"Vilniaus Verkių mokykla-daugiafunkcis centras";"3, 4 S klasė";3669076308;Ne;0;4;0;4
22552;"Vilniaus Verkių mokykla-daugiafunkcis centras";"3, 4 S klasė";4436123342;Ne;0;4;0;4
22553;"Vilniaus Verkių mokykla-daugiafunkcis centras";"3, 4 S klasė";6417342868;Ne;0;9;0;9
22554;"Vilniaus Verkių mokykla-daugiafunkcis centras";"3, 4 S klasė";2428312586;Ne;0;4;0;4
22555;"Vilniaus Verkių mokykla-daugiafunkcis centras";"3, 4 S klasė";2160146000;Ne;0;10;0;10
22556;"Vilniaus Verkių mokykla-daugiafunkcis centras";"3, 4 S klasė";4675792296;Ne;0;19;0;19
22557;"Vilniaus Verkių mokykla-daugiafunkcis centras";"3, 4 S klasė";4675792296;Ne;0;19;0;19
22558;"Vilniaus Verkių mokykla-daugiafunkcis centras";"Priešmokyklinio, 1, 2 S klasė";7942036741;Ne;0;4;0;4
22559;"Vilniaus Verkių mokykla-daugiafunkcis centras";"Priešmokyklinio, 1, 2 S klasė";5586925136;Ne;0;7;0;7
22560;"Vilniaus Verkių mokykla-daugiafunkcis centras";"Priešmokyklinio, 1, 2 S klasė";1809511815;Ne;0;5;0;5
22561;"Vilniaus Verkių mokykla-daugiafunkcis centras";"Priešmokyklinio, 1, 2 S klasė";8844612659;Ne;0;5;0;5
22562;"Vilniaus Verkių mokykla-daugiafunkcis centras";"Priešmokyklinio, 1, 2 S klasė";42873989145;Ne;0;16;0;16
22563;"Vilniaus Verkių mokykla-daugiafunkcis centras";"Priešmokyklinio, 1, 2 S klasė";1732370199;Ne;0;7;0;7
22564;"Vilniaus Verkių mokykla-daugiafunkcis centras";"1, 2, 3, 4 S, L klasė rusų";9256422807;Ne;0;4;0;4
22565;"Vilniaus Verkių mokykla-daugiafunkcis centras";"1, 2, 3, 4 S, L klasė rusų";3504918499;Ne;0;4;0;4
22566;"Vilniaus Verkių mokykla-daugiafunkcis centras";"1, 2, 3, 4 S, L klasė rusų";3504918499;Ne;0;4;0;4
22567;"Vilniaus Verkių mokykla-daugiafunkcis centras";"1, 2, 3, 4 S, L klasė rusų";1515290326;Ne;0;4;0;4
22568;"Vilniaus Verkių mokykla-daugiafunkcis centras";"1, 2, 3, 4 S, L klasė rusų";7977250483;Ne;0;6;0;6
22569;"Vilniaus Verkių mokykla-daugiafunkcis centras";"1, 2, 3, 4 S, L klasė rusų";6951842417;Ne;0;8;0;8
22570;"Vilniaus Verkių mokykla-daugiafunkcis centras";"1, 2, 3, 4 S, L klasė rusų";4011623622;Ne;0;17;0;17
22571;"Vilniaus Verkių mokykla-daugiafunkcis centras";"1, 2, 3, 4 S, L klasė rusų";2064565430;Ne;0;13;0;13
22572;"Vilniaus Verkių mokykla-daugiafunkcis centras";"1, 2, 3, 5, 7 S, L klasė lenkų";6215345468;Ne;0;19;0;19
22573;"Vilniaus Verkių mokykla-daugiafunkcis centras";"1, 2, 3, 5, 7 S, L klasė lenkų";5802046806;Ne;0;14;0;14
22574;"Vilniaus Verkių mokykla-daugiafunkcis centras";"1, 2, 3, 5, 7 S, L klasė lenkų";7591511377;Ne;0;6;0;6
22575;"Vilniaus Verkių mokykla-daugiafunkcis centras";"1, 2, 3, 5, 7 S, L klasė lenkų";6868531249;Ne;0;5;0;5
22576;"Vilniaus Verkių mokykla-daugiafunkcis centras";"1, 2, 3, 5, 7 S, L klasė lenkų";6868531249;Ne;0;5;0;5
22577;"Vilniaus Verkių mokykla-daugiafunkcis centras";"1, 2, 3, 5, 7 S, L klasė lenkų";6868531249;Ne;0;5;0;5
22578;"Vilniaus Verkių mokykla-daugiafunkcis centras";"1, 2, 3, 5, 7 S, L klasė lenkų";6868531249;Ne;0;5;0;5
22579;"Vilniaus Verkių mokykla-daugiafunkcis centras";"1, 2, 3, 5, 7 S, L klasė lenkų";6868531249;Ne;0;5;0;5
22580;"Vilniaus Verkių mokykla-daugiafunkcis centras";"1, 2, 3, 5, 7 S, L klasė lenkų";6868531249;Ne;0;5;0;5
22581;"Vilniaus Verkių mokykla-daugiafunkcis centras";"1, 2, 3, 5, 7 S, L klasė lenkų";5603432321;Ne;0;4;0;4
22582;"Vilniaus Verkių mokykla-daugiafunkcis centras";"1, 2, 3, 5, 7 S, L klasė lenkų";9355917461;Ne;0;9;0;9
22583;"Vilniaus Verkių mokykla-daugiafunkcis centras";"1, 2, 3, 5, 7 S, L klasė lenkų";4187084284;Ne;0;4;0;4
22584;"Vilniaus Verkių mokykla-daugiafunkcis centras";"5, 6, 7, 8 L klasė RU";64637387481;Ne;0;6;0;6
22585;"Vilniaus Verkių mokykla-daugiafunkcis centras";"5, 6, 7, 8 L klasė RU";64637387481;Ne;0;6;0;6
22586;"Vilniaus Verkių mokykla-daugiafunkcis centras";"5, 6, 7, 8 L klasė RU";4066377955;Ne;0;17;0;17
22587;"Vilniaus Verkių mokykla-daugiafunkcis centras";"5, 6, 7, 8 L klasė RU";44372408680;Ne;0;4;0;4
22588;"Vilniaus Verkių mokykla-daugiafunkcis centras";"5, 6, 7, 8 L klasė RU";1503792026;Ne;0;17;0;17
22589;"Vilniaus Verkių mokykla-daugiafunkcis centras";"5, 6, 7, 8 L klasė RU";55421735777;Ne;0;4;0;4
22590;"Vilniaus Verkių mokykla-daugiafunkcis centras";"5, 6, 7, 8 L klasė RU";9259642351;Ne;0;19;0;19
22591;"Vilniaus Verkių mokykla-daugiafunkcis centras";" SĮUP I m.m., SĮUP II m.m. klasė RU";7000432264;Ne;0;4;0;4
22592;"Vilniaus Verkių mokykla-daugiafunkcis centras";" SĮUP I m.m., SĮUP II m.m. klasė RU";9098854782;Ne;0;9;0;9
22593;"Vilniaus Verkių mokykla-daugiafunkcis centras";" SĮUP I m.m., SĮUP II m.m. klasė RU";6937513931;Ne;0;19;0;19
22594;"Vilniaus Verkių mokykla-daugiafunkcis centras";" SĮUP I m.m., SĮUP II m.m. klasė RU";3155197214;Ne;0;19;0;19
22595;"Vilniaus Verkių mokykla-daugiafunkcis centras";" SĮUP I m.m., SĮUP II m.m. klasė RU";1454746961;Ne;0;4;0;4
22596;"Vilniaus Verkių mokykla-daugiafunkcis centras";" SĮUP I m.m., SĮUP II m.m. klasė RU";2076640938;Ne;0;12;0;12
22597;"Vilniaus Verkių mokykla-daugiafunkcis centras";" SĮUP I m.m., SĮUP II m.m. klasė RU";1062601239;Ne;0;8;0;8
22598;"Vilniaus Verkių mokykla-daugiafunkcis centras";" SĮUP I m.m., SĮUP II m.m. klasė RU";6958157444;Ne;0;7;0;7
22599;"Vilniaus Verkių mokykla-daugiafunkcis centras";" SĮUP I m.m., SĮUP II m.m. klasė RU";9430569608;Ne;0;19;0;19
22600;"Vilniaus Verkių mokykla-daugiafunkcis centras";" SĮUP I m.m., SĮUP II m.m. klasė RU";2305478898;Ne;0;5;0;5
22601;"Vilniaus Verkių mokykla-daugiafunkcis centras";" SĮUP I m.m., SĮUP II m.m. klasė RU";2518928115;Ne;0;7;0;7
22602;Gluosnis;KIŠKUČIAI;8689557248;Ne;0;2;0;2
22603;Gluosnis;KIŠKUČIAI;2984134115;Ne;0;1;3;4
22604;Gluosnis;KIŠKUČIAI;6955695422;Ne;4;0;0;4
22605;Gluosnis;KIŠKUČIAI;1305651237;Ne;8;0;0;8
22606;Gluosnis;KIŠKUČIAI;4285562600;Ne;6;3;0;9
22607;Gluosnis;KIŠKUČIAI;8009719622;Ne;9;0;2;11
22608;Gluosnis;KIŠKUČIAI;9833971809;Ne;5;0;0;5
22609;Gluosnis;KIŠKUČIAI;6883663577;Ne;2;2;0;4
22610;Gluosnis;KIŠKUČIAI;1512855055;Ne;14;0;0;14
22611;Gluosnis;KIŠKUČIAI;8337313448;Ne;7;0;4;11
22612;Gluosnis;KIŠKUČIAI;4632419177;Ne;0;0;3;3
22613;Gluosnis;KIŠKUČIAI;6113153127;Ne;3;0;1;4
22614;Gluosnis;KIŠKUČIAI;7769522093;Ne;0;4;0;4
22615;Gluosnis;KIŠKUČIAI;8928597187;Ne;0;0;4;4
22616;Gluosnis;KIŠKUČIAI;9993638596;Ne;0;0;4;4
22617;Gluosnis;KIŠKUČIAI;6994005000;Ne;2;4;1;7
22618;Gluosnis;KIŠKUČIAI;9221983318;Ne;6;0;3;9
22619;Gluosnis;KIŠKUČIAI;2187312618;Ne;0;4;1;5
22620;Gluosnis;KIŠKUČIAI;5664156894;Ne;0;0;1;1
22621;Gluosnis;KIŠKUČIAI;7073637619;Ne;8;0;4;12
22622;Gluosnis;KIŠKUČIAI;1391404073;Ne;9;5;0;14
22623;Gluosnis;KIŠKUČIAI;4591550636;Ne;0;7;0;7
22624;Gluosnis;KIŠKUČIAI;6212693015;Taip;11;5;1;17
22625;Gluosnis;KIŠKUČIAI;3673702157;Ne;8;0;0;8
22626;Gluosnis;EŽIUKAI;4153713911;Ne;2;1;0;3
22627;Gluosnis;EŽIUKAI;4493877427;Ne;0;2;0;2
22628;Gluosnis;EŽIUKAI;1301904113;Ne;0;0;1;1
22629;Gluosnis;EŽIUKAI;5350702449;Ne;5;3;0;8
22630;Gluosnis;EŽIUKAI;8577271806;Ne;0;3;2;5
22631;Gluosnis;EŽIUKAI;6622415563;Ne;0;4;0;4
22632;Gluosnis;EŽIUKAI;3988305400;Ne;0;1;0;1
22633;Gluosnis;EŽIUKAI;9788278155;Ne;3;0;0;3
22634;Gluosnis;EŽIUKAI;7974944779;Ne;0;4;0;4
22635;Gluosnis;EŽIUKAI;7526020668;Ne;0;4;0;4
22636;Gluosnis;EŽIUKAI;5522411084;Ne;0;3;1;4
22637;Gluosnis;EŽIUKAI;5392759654;Taip;1;0;0;1
22638;Gluosnis;EŽIUKAI;6681653921;Ne;0;5;0;5
22639;Gluosnis;EŽIUKAI;4902627153;Taip;5;4;0;9
22640;Gluosnis;EŽIUKAI;2525780494;Ne;6;7;0;13
22641;Gluosnis;EŽIUKAI;9389736360;Ne;5;4;0;9
22642;Gluosnis;EŽIUKAI;2707855273;Ne;2;4;0;6
22643;Gluosnis;EŽIUKAI;7523459118;Ne;0;0;3;3
22644;Gluosnis;EŽIUKAI;2794163383;Ne;0;1;1;2
22645;Gluosnis;EŽIUKAI;7264550578;Ne;0;4;3;7
22646;Gluosnis;EŽIUKAI;5368171142;Ne;0;9;3;12
22647;Gluosnis;EŽIUKAI;6754799196;Ne;4;0;0;4
22648;Gluosnis;EŽIUKAI;9888037899;Ne;0;0;4;4
22649;Gluosnis;MEŠKIUKAI;8981904827;Ne;0;0;4;4
22650;Gluosnis;MEŠKIUKAI;8998776286;Ne;4;0;0;4
22651;Gluosnis;MEŠKIUKAI;1846499141;Ne;19;0;0;19
22652;Gluosnis;MEŠKIUKAI;7935750427;Ne;0;0;7;7
22653;Gluosnis;MEŠKIUKAI;4905002832;Ne;0;4;0;4
22654;Gluosnis;MEŠKIUKAI;9102081648;Ne;0;0;12;12
22655;Gluosnis;MEŠKIUKAI;4498429439;Ne;0;0;6;6
22656;Gluosnis;MEŠKIUKAI;8259160584;Ne;0;3;0;3
22657;Gluosnis;MEŠKIUKAI;1235091885;Ne;4;6;0;10
22658;Gluosnis;MEŠKIUKAI;1165636758;Ne;4;2;2;8
22659;Gluosnis;MEŠKIUKAI;8499748544;Ne;0;4;0;4
22660;Gluosnis;MEŠKIUKAI;2867319899;Ne;0;1;0;1
22661;Gluosnis;MEŠKIUKAI;9699577397;Ne;4;0;3;7
22662;Gluosnis;MEŠKIUKAI;4107344313;Ne;3;0;3;6
22663;Gluosnis;MEŠKIUKAI;1101472999;Ne;3;4;0;7
22664;Gluosnis;MEŠKIUKAI;7995558671;Ne;0;3;0;3
22665;Gluosnis;MEŠKIUKAI;1602556462;Ne;7;0;0;7
22666;Gluosnis;MEŠKIUKAI;8842139496;Ne;5;0;3;8
22667;Gluosnis;MEŠKIUKAI;4060859156;Ne;0;4;0;4
22668;Gluosnis;MEŠKIUKAI;6428753580;Ne;0;0;3;3
22669;Gluosnis;MEŠKIUKAI;3323237449;Ne;0;6;0;6
22670;Gluosnis;MEŠKIUKAI;6246512101;Ne;0;7;0;7
22671;Gluosnis;MEŠKIUKAI;3038732180;Ne;11;6;0;17
22672;Gluosnis;MEŠKIUKAI;1712795835;Ne;0;10;0;10
22673;Gluosnis;BORUŽĖLĖS;8840658383;Ne;2;4;0;6
22674;Gluosnis;BORUŽĖLĖS;1102935178;Ne;5;3;3;11
22675;Gluosnis;BORUŽĖLĖS;2167312808;Ne;0;0;1;1
22676;Gluosnis;BORUŽĖLĖS;4204797742;Ne;5;9;0;14
22677;Gluosnis;BORUŽĖLĖS;6302765948;Ne;3;4;2;9
22678;Gluosnis;BORUŽĖLĖS;9938235476;Ne;0;2;0;2
22679;Gluosnis;BORUŽĖLĖS;2945796648;Ne;0;4;0;4
22680;Gluosnis;BORUŽĖLĖS;2173191971;Ne;0;3;3;6
22681;Gluosnis;BORUŽĖLĖS;4237053702;Ne;0;4;0;4
22682;Gluosnis;BORUŽĖLĖS;6320411660;Ne;0;1;0;1
22683;Gluosnis;BORUŽĖLĖS;7731887361;Ne;2;0;0;2
22684;Gluosnis;BORUŽĖLĖS;8502947568;Ne;0;3;0;3
22685;Gluosnis;BORUŽĖLĖS;9664090375;Ne;4;1;0;5
22686;Gluosnis;BORUŽĖLĖS;1335152703;Ne;5;4;0;9
22687;Gluosnis;BORUŽĖLĖS;1314992969;Ne;0;4;3;7
22688;Gluosnis;BORUŽĖLĖS;2515646510;Ne;0;4;0;4
22689;Gluosnis;BORUŽĖLĖS;6086258054;Ne;11;0;0;11
22690;Gluosnis;BORUŽĖLĖS;1351519995;Ne;0;6;2;8
22691;Gluosnis;BORUŽĖLĖS;6960673767;Taip;0;9;0;9
22692;Gluosnis;LAPIUKAI;7025815772;Ne;6;0;2;8
22693;Gluosnis;LAPIUKAI;5266206726;Ne;9;0;0;9
22694;Gluosnis;LAPIUKAI;2968946946;Ne;0;5;0;5
22695;Gluosnis;LAPIUKAI;8976032500;Ne;0;0;2;2
22696;Gluosnis;LAPIUKAI;3190331209;Taip;0;1;2;3
22697;Gluosnis;LAPIUKAI;5376108804;Ne;3;0;1;4
22698;Gluosnis;LAPIUKAI;9386396460;Ne;0;0;1;1
22699;Gluosnis;LAPIUKAI;1664508998;Ne;10;4;0;14
22700;Gluosnis;LAPIUKAI;1296975213;Ne;1;0;1;2
22701;Gluosnis;LAPIUKAI;8227732558;Ne;3;1;0;4
22702;Gluosnis;LAPIUKAI;4146877525;Ne;0;8;0;8
22703;Gluosnis;LAPIUKAI;4616132460;Ne;2;4;0;6
22704;Gluosnis;LAPIUKAI;7090336454;Ne;0;3;0;3
22705;Gluosnis;LAPIUKAI;2889837198;Ne;0;0;4;4
22706;Gluosnis;PELĖDŽIUKAI;5633386146;Taip;7;0;1;8
22707;Gluosnis;PELĖDŽIUKAI;1144177849;Ne;12;0;0;12
22708;Gluosnis;PELĖDŽIUKAI;6747244713;Ne;2;0;1;3
22709;Gluosnis;PELĖDŽIUKAI;3900322680;Ne;13;0;0;13
22710;Gluosnis;PELĖDŽIUKAI;6729016081;Ne;10;3;0;13
22711;Gluosnis;PELĖDŽIUKAI;4069584911;Ne;0;3;1;4
22712;Gluosnis;PELĖDŽIUKAI;2423433989;Ne;1;4;0;5
22713;Gluosnis;PELĖDŽIUKAI;1263019496;Ne;10;5;0;15
22714;Gluosnis;PELĖDŽIUKAI;6119618742;Ne;5;4;0;9
22715;Gluosnis;PELĖDŽIUKAI;8109714321;Taip;9;0;0;9
22716;Gluosnis;PELĖDŽIUKAI;2794080237;Ne;13;0;0;13
22717;Gluosnis;PELĖDŽIUKAI;4564193030;Ne;6;0;2;8
22718;Gluosnis;PELĖDŽIUKAI;5623135790;Ne;0;4;0;4
22719;Gluosnis;PELĖDŽIUKAI;2310874591;Ne;3;1;0;4
22720;Gluosnis;PELĖDŽIUKAI;5210930032;Ne;0;9;0;9
22721;Gluosnis;PELĖDŽIUKAI;5008836118;Ne;0;0;3;3
22722;Gluosnis;PELĖDŽIUKAI;4224637208;Ne;2;3;0;5
22723;Gluosnis;PELĖDŽIUKAI;4361177196;Ne;10;4;0;14
22724;Gluosnis;PELĖDŽIUKAI;9484423786;Ne;6;0;0;6
22725;Gluosnis;PELĖDŽIUKAI;9423229931;Ne;5;0;0;5
22726;Gluosnis;PELĖDŽIUKAI;3578467708;Ne;4;0;0;4
22727;Gluosnis;VOVERIUKAI;4798207493;Ne;5;0;1;6
22728;Gluosnis;VOVERIUKAI;5822836262;Ne;6;0;2;8
22729;Gluosnis;VOVERIUKAI;8374694200;Ne;2;0;0;2
22730;Gluosnis;VOVERIUKAI;8299388060;Ne;7;4;2;13
22731;Gluosnis;VOVERIUKAI;6617408330;Ne;2;0;4;6
22732;Gluosnis;VOVERIUKAI;5972818467;Ne;14;0;0;14
22733;Gluosnis;VOVERIUKAI;3400563947;Ne;3;4;0;7
22734;Gluosnis;VOVERIUKAI;5850079627;Ne;15;0;0;15
22735;Gluosnis;VOVERIUKAI;2243717506;Ne;0;0;5;5
22736;Gluosnis;VOVERIUKAI;8904254546;Ne;4;0;2;6
22737;Gluosnis;VOVERIUKAI;1757821835;Ne;9;3;0;12
22738;Gluosnis;VOVERIUKAI;8310409721;Ne;6;0;4;10
22739;Gluosnis;VOVERIUKAI;2746499687;Ne;2;0;3;5
22740;Gluosnis;VOVERIUKAI;1636516971;Ne;3;4;0;7
22741;Gluosnis;VOVERIUKAI;4566061172;Ne;0;0;10;10
22742;Gluosnis;DRUGELIAI;5949954525;Ne;1;4;0;5
22743;Gluosnis;DRUGELIAI;1716235604;Ne;0;7;0;7
22744;Gluosnis;DRUGELIAI;7642311375;Ne;0;0;1;1
22745;Gluosnis;DRUGELIAI;8430102757;Ne;0;4;1;5
22746;Gluosnis;DRUGELIAI;4125830926;Ne;0;4;0;4
22747;Gluosnis;DRUGELIAI;6358187113;Ne;7;4;1;12
22748;Gluosnis;DRUGELIAI;9084785666;Ne;8;5;0;13
22749;Gluosnis;DRUGELIAI;4940563623;Ne;5;1;0;6
22750;Gluosnis;DRUGELIAI;1113731535;Ne;0;8;0;8
22751;Gluosnis;DRUGELIAI;4653963373;Ne;3;0;0;3
22752;Gluosnis;DRUGELIAI;2458662117;Ne;0;1;1;2
22753;Gluosnis;DRUGELIAI;4220504133;Ne;5;4;0;9
22754;Gluosnis;DRUGELIAI;9931766935;Ne;0;3;9;12
22755;Gluosnis;DRUGELIAI;3527418865;Ne;5;4;0;9
22756;Gluosnis;DRUGELIAI;6914171069;Ne;0;4;0;4
22757;Gluosnis;DRUGELIAI;7756397778;Ne;3;3;0;6
22758;Gluosnis;DRUGELIAI;5943955268;Ne;4;4;0;8
22759;Gluosnis;DRUGELIAI;8690911930;Ne;0;7;5;12
22760;Gluosnis;DRUGELIAI;1543842220;Ne;5;4;0;9
22761;Gluosnis;DRUGELIAI;1787206205;Ne;0;5;0;5
22762;Gluosnis;DRUGELIAI;5264930854;Ne;0;4;0;4
22763;Gluosnis;BITUTĖS;4176300773;Ne;9;4;0;13
22764;Gluosnis;BITUTĖS;2554790908;Ne;3;9;0;12
22765;Gluosnis;BITUTĖS;8281499182;Ne;3;2;0;5
22766;Gluosnis;BITUTĖS;2403029153;Ne;0;4;0;4
22767;Gluosnis;BITUTĖS;6432475763;Ne;6;1;0;7
22768;Gluosnis;BITUTĖS;9542889575;Ne;0;4;0;4
22769;Gluosnis;BITUTĖS;1966484574;Ne;1;4;6;11
22770;Gluosnis;BITUTĖS;5889360726;Ne;0;4;1;5
22771;Gluosnis;BITUTĖS;8035097045;Ne;2;4;0;6
22772;Gluosnis;BITUTĖS;3362089746;Ne;8;4;2;14
22773;Gluosnis;BITUTĖS;7390361159;Ne;2;3;0;5
22774;Gluosnis;BITUTĖS;8380310240;Ne;0;4;0;4
22775;Gluosnis;BITUTĖS;4481544177;Ne;5;4;0;9
22776;Gluosnis;BITUTĖS;9098141563;Ne;3;4;0;7
22777;Gluosnis;BITUTĖS;9201769624;Ne;0;4;1;5
22778;Gluosnis;BITUTĖS;1306381382;Ne;2;4;0;6
22779;Gluosnis;BITUTĖS;6767500085;Ne;0;1;1;2
22780;Gluosnis;BITUTĖS;6001358241;Ne;0;4;4;8
22781;Gluosnis;BITUTĖS;5380755693;Ne;0;4;1;5
22782;Gluosnis;BITUTĖS;6197840105;Ne;3;6;0;9
22783;Gluosnis;BITUTĖS;5204445760;Ne;4;5;0;9
22784;Gluosnis;BITUTĖS;5432102004;Ne;0;4;3;7
22785;"Vilniaus Simono Stanevičiaus progimnazija";BITUTĖS;7528014407;Ne;0;4;0;4
22786;"Vilniaus Simono Stanevičiaus progimnazija";BITUTĖS;5140264695;Ne;1;4;0;5
22787;"Vilniaus Simono Stanevičiaus progimnazija";BITUTĖS;6700169944;Ne;0;4;0;4
22788;"Vilniaus Simono Stanevičiaus progimnazija";BITUTĖS;9894466439;Ne;0;19;0;19
22789;"Vilniaus Simono Stanevičiaus progimnazija";BITUTĖS;5292978341;Ne;0;4;0;4
22790;"Vilniaus Simono Stanevičiaus progimnazija";BITUTĖS;5733610359;Ne;8;4;0;12
22791;"Vilniaus Simono Stanevičiaus progimnazija";BITUTĖS;2021296978;Ne;3;7;0;10
22792;"Vilniaus Simono Stanevičiaus progimnazija";BITUTĖS;8667155756;Ne;3;3;0;6
22793;"Vilniaus Simono Stanevičiaus progimnazija";BITUTĖS;1566011843;Ne;3;3;0;6
22794;"Vilniaus Simono Stanevičiaus progimnazija";BITUTĖS;9331479613;Ne;2;4;0;6
22795;"Vilniaus Simono Stanevičiaus progimnazija";BITUTĖS;4586098882;Ne;0;6;0;6
22796;"Vilniaus Simono Stanevičiaus progimnazija";BITUTĖS;4303490614;Ne;0;5;0;5
22797;"Vilniaus Simono Stanevičiaus progimnazija";BITUTĖS;8378295683;Ne;0;5;0;5
22798;"Vilniaus Simono Stanevičiaus progimnazija";BITUTĖS;8866490265;Ne;0;5;0;5
22799;"Vilniaus Simono Stanevičiaus progimnazija";BITUTĖS;2738119814;Ne;0;5;0;5
22800;"Vilniaus Simono Stanevičiaus progimnazija";BITUTĖS;3678796113;Ne;5;14;0;19
22801;"Vilniaus Simono Stanevičiaus progimnazija";BITUTĖS;7251592439;Ne;0;4;0;4
22802;"Vilniaus Simono Stanevičiaus progimnazija";BITUTĖS;2780141413;Ne;0;7;0;7
22803;"Vilniaus Simono Stanevičiaus progimnazija";BITUTĖS;7335784416;Ne;0;4;0;4
22804;"Vilniaus Simono Stanevičiaus progimnazija";BITUTĖS;6259640492;Ne;7;0;0;7
22805;"Vilniaus Simono Stanevičiaus progimnazija";BITUTĖS;6800864033;Ne;2;5;0;7
22806;"Vilniaus Simono Stanevičiaus progimnazija";KATINĖLIAI;1294225767;Ne;0;1;0;1
22807;"Vilniaus Simono Stanevičiaus progimnazija";KATINĖLIAI;9192285159;Ne;0;1;0;1
22808;"Vilniaus Simono Stanevičiaus progimnazija";KATINĖLIAI;2487784714;Ne;4;1;0;5
22809;"Vilniaus Simono Stanevičiaus progimnazija";KATINĖLIAI;7991650887;Ne;2;2;0;4
22810;"Vilniaus Simono Stanevičiaus progimnazija";KATINĖLIAI;4682659878;Ne;10;5;5;20
22811;"Vilniaus Simono Stanevičiaus progimnazija";KATINĖLIAI;1051805733;Ne;0;1;0;1
22812;"Vilniaus Simono Stanevičiaus progimnazija";KATINĖLIAI;4973969827;Ne;0;1;0;1
22813;"Vilniaus Simono Stanevičiaus progimnazija";KATINĖLIAI;1569084597;Ne;0;1;0;1
22814;"Vilniaus Simono Stanevičiaus progimnazija";KATINĖLIAI;1166282379;Ne;0;1;0;1
22815;"Vilniaus Simono Stanevičiaus progimnazija";KATINĖLIAI;6073971598;Ne;0;1;0;1
22816;"Vilniaus Simono Stanevičiaus progimnazija";KATINĖLIAI;2734024890;Ne;0;1;0;1
22817;"Vilniaus Simono Stanevičiaus progimnazija";KATINĖLIAI;2483957349;Ne;0;1;0;1
22818;"Vilniaus Simono Stanevičiaus progimnazija";KATINĖLIAI;6248532738;Ne;0;1;0;1
22819;"Vilniaus Simono Stanevičiaus progimnazija";KATINĖLIAI;8967704928;Ne;0;1;0;1
22820;"Vilniaus Simono Stanevičiaus progimnazija";KATINĖLIAI;8799003374;Ne;0;19;0;19
22821;"Vilniaus Simono Stanevičiaus progimnazija";KATINĖLIAI;7367485961;Ne;0;1;0;1
22822;"Vilniaus Simono Stanevičiaus progimnazija";KATINĖLIAI;1545323439;Ne;0;1;0;1
22823;"Vilniaus Simono Stanevičiaus progimnazija";KATINĖLIAI;9823633774;Ne;0;1;0;1
22824;"Vilniaus Saulėtekio mokykla-daugiafunkcinis centras";"PRIEŠMOKYKLINĖ 2";7903833413;Ne;0;6;1;7
22825;"Vilniaus Saulėtekio mokykla-daugiafunkcinis centras";"PRIEŠMOKYKLINĖ 2";3499348606;Ne;0;30;0;30
22826;"Vilniaus Saulėtekio mokykla-daugiafunkcinis centras";"PRIEŠMOKYKLINĖ 2";4730746531;Ne;2;6;2;10
22827;"Vilniaus Saulėtekio mokykla-daugiafunkcinis centras";"PRIEŠMOKYKLINĖ 2";1231703889;Ne;0;6;2;8
22828;"Vilniaus Saulėtekio mokykla-daugiafunkcinis centras";"PRIEŠMOKYKLINĖ 2";9471880764;Ne;7;6;1;14
22829;"Vilniaus Saulėtekio mokykla-daugiafunkcinis centras";"PRIEŠMOKYKLINĖ 2";8012122042;Ne;0;6;0;6
22830;"Vilniaus Saulėtekio mokykla-daugiafunkcinis centras";"PRIEŠMOKYKLINĖ 2";2034007263;Ne;0;6;0;6
22831;"Vilniaus Saulėtekio mokykla-daugiafunkcinis centras";"PRIEŠMOKYKLINĖ 2";7958528778;Ne;0;30;0;30
22832;"Vilniaus Saulėtekio mokykla-daugiafunkcinis centras";"PRIEŠMOKYKLINĖ 2";3080668107;Ne;4;6;1;11
22833;"Vilniaus Saulėtekio mokykla-daugiafunkcinis centras";"PRIEŠMOKYKLINĖ 2";6080664872;Ne;10;6;0;16
22834;"Vilniaus Saulėtekio mokykla-daugiafunkcinis centras";"PRIEŠMOKYKLINĖ 2";9962905184;Ne;0;6;0;6
22835;"Vilniaus Saulėtekio mokykla-daugiafunkcinis centras";"PRIEŠMOKYKLINĖ 2";3873345138;Ne;10;6;2;18
22836;"Vilniaus Saulėtekio mokykla-daugiafunkcinis centras";"PRIEŠMOKYKLINĖ 2";6702207851;Ne;0;6;2;8
22837;"Vilniaus Saulėtekio mokykla-daugiafunkcinis centras";"PRIEŠMOKYKLINĖ 2";5551184248;Ne;0;30;0;30
22838;"Vilniaus Saulėtekio mokykla-daugiafunkcinis centras";"PRIEŠMOKYKLINĖ 2";2631120189;Ne;23;6;0;29
22839;"Vilniaus Saulėtekio mokykla-daugiafunkcinis centras";"PRIEŠMOKYKLINĖ 2";4402503971;Ne;0;6;1;7
22840;"Vilniaus Saulėtekio mokykla-daugiafunkcinis centras";"PRIEŠMOKYKLINĖ 2";5998344519;Ne;13;6;0;19
22841;"Vilniaus Saulėtekio mokykla-daugiafunkcinis centras";"PRIEŠMOKYKLINĖ 2";1825755877;Ne;0;6;1;7
22842;"Vilniaus Saulėtekio mokykla-daugiafunkcinis centras";"PRIEŠMOKYKLINĖ  1";1816377082;Ne;0;6;2;8
22843;"Vilniaus Saulėtekio mokykla-daugiafunkcinis centras";"PRIEŠMOKYKLINĖ  1";7735063486;Ne;6;6;0;12
22844;"Vilniaus Saulėtekio mokykla-daugiafunkcinis centras";"PRIEŠMOKYKLINĖ  1";3744848906;Ne;11;6;1;18
22845;"Vilniaus Saulėtekio mokykla-daugiafunkcinis centras";"PRIEŠMOKYKLINĖ  1";4234425668;Ne;0;9;0;9
22846;"Vilniaus Saulėtekio mokykla-daugiafunkcinis centras";"PRIEŠMOKYKLINĖ  1";4852738818;Ne;8;6;0;14
22847;"Vilniaus Saulėtekio mokykla-daugiafunkcinis centras";"PRIEŠMOKYKLINĖ  1";5399981203;Ne;0;8;0;8
22848;"Vilniaus Saulėtekio mokykla-daugiafunkcinis centras";"PRIEŠMOKYKLINĖ  1";8997525194;Ne;0;6;5;11
22849;"Vilniaus Saulėtekio mokykla-daugiafunkcinis centras";"PRIEŠMOKYKLINĖ  1";6860696706;Ne;10;6;0;16
22850;"Vilniaus Saulėtekio mokykla-daugiafunkcinis centras";"PRIEŠMOKYKLINĖ  1";9031478765;Ne;0;6;1;7
22851;"Vilniaus Saulėtekio mokykla-daugiafunkcinis centras";"PRIEŠMOKYKLINĖ  1";5532685692;Ne;0;6;1;7
22852;"Vilniaus Saulėtekio mokykla-daugiafunkcinis centras";"PRIEŠMOKYKLINĖ  1";5817562139;Ne;0;27;0;27
22853;"Vilniaus Saulėtekio mokykla-daugiafunkcinis centras";"PRIEŠMOKYKLINĖ  1";8889959782;Ne;0;6;0;6
22854;"Vilniaus Saulėtekio mokykla-daugiafunkcinis centras";"PRIEŠMOKYKLINĖ  1";1625321820;Ne;6;6;0;12
22855;"Vilniaus Saulėtekio mokykla-daugiafunkcinis centras";"PRIEŠMOKYKLINĖ  1";3382354753;Ne;8;6;0;14
22856;"Vilniaus Saulėtekio mokykla-daugiafunkcinis centras";"PRIEŠMOKYKLINĖ  1";9099285081;Ne;0;6;0;6
22857;"Vilniaus Saulėtekio mokykla-daugiafunkcinis centras";"PRIEŠMOKYKLINĖ  1";1839351438;Ne;0;6;0;6
22858;"Vilniaus Saulėtekio mokykla-daugiafunkcinis centras";"PRIEŠMOKYKLINĖ  1";5586871557;Ne;0;27;0;27
22859;"Vilniaus Saulėtekio mokykla-daugiafunkcinis centras";"PRIEŠMOKYKLINĖ  1";2429527586;Ne;0;6;5;11
22860;"Vilniaus Maironio progimnazija";"1 PU";5652769035;Ne;0;6;0;6
22861;"Vilniaus Maironio progimnazija";"1 PU";5593526943;Ne;0;6;0;6
22862;"Vilniaus Maironio progimnazija";"1 PU";1603752483;Ne;9;6;0;15
22863;"Vilniaus Maironio progimnazija";"1 PU";6171650517;Ne;0;6;0;6
22864;"Vilniaus Maironio progimnazija";"1 PU";1591999024;Ne;0;6;0;6
22865;"Vilniaus Maironio progimnazija";"1 PU";5022388487;Ne;0;6;0;6
22866;"Vilniaus Maironio progimnazija";"1 PU";1024337077;Ne;0;30;0;30
22867;"Vilniaus Maironio progimnazija";"1 PU";6176234300;Ne;1;6;0;7
22868;"Vilniaus Maironio progimnazija";"1 PU";1339850717;Ne;10;6;0;16
22869;"Vilniaus Maironio progimnazija";"1 PU";4806652727;Ne;0;6;0;6
22870;"Vilniaus Maironio progimnazija";"1 PU";4570512336;Ne;0;6;0;6
22871;"Vilniaus Maironio progimnazija";"1 PU";6266095782;Ne;5;6;0;11
22872;"Vilniaus Maironio progimnazija";"1 PU";5322766823;Ne;0;6;0;6
22873;"Vilniaus Maironio progimnazija";"1 PU";9803206596;Ne;6;6;0;12
22874;"Vilniaus Maironio progimnazija";"1 PU";5957889361;Ne;0;6;0;6
22875;"Vilniaus Maironio progimnazija";"1 PU";2707029719;Ne;4;6;0;10
22876;"Vilniaus Maironio progimnazija";"1 PU";4917910801;Ne;7;6;0;13
22877;"Vilniaus Maironio progimnazija";"1 PU";3347146751;Ne;1;6;0;7
22878;"Vilniaus Maironio progimnazija";"1 PU";8393893311;Ne;0;6;0;6
22879;"Vilniaus Maironio progimnazija";"1 PU";2443856355;Ne;5;6;0;11
22880;"Vilniaus Maironio progimnazija";"1 PU";3443745088;Taip;0;6;0;6
22881;"Vilniaus Maironio progimnazija";"2 PU";7395477522;Ne;0;7;0;7
22882;"Vilniaus Maironio progimnazija";"2 PU";8768526171;Ne;0;6;0;6
22883;"Vilniaus Maironio progimnazija";"2 PU";6949120693;Ne;4;7;0;11
22884;"Vilniaus Maironio progimnazija";"2 PU";7080578299;Ne;8;6;0;14
22885;"Vilniaus Maironio progimnazija";"2 PU";9968072478;Ne;4;7;0;11
22886;"Vilniaus Maironio progimnazija";"2 PU";8480891793;Ne;3;6;0;9
22887;"Vilniaus Maironio progimnazija";"2 PU";2783708905;Ne;3;7;0;10
22888;"Vilniaus Maironio progimnazija";"2 PU";8946678515;Ne;0;7;0;7
22889;"Vilniaus Maironio progimnazija";"2 PU";3320524073;Ne;2;7;0;9
22890;"Vilniaus Maironio progimnazija";"2 PU";2339010385;Ne;2;7;0;9
22891;"Vilniaus Maironio progimnazija";"2 PU";3895256591;Ne;1;7;0;8
22892;"Vilniaus Maironio progimnazija";"2 PU";1827752731;Ne;3;6;0;9
22893;"Vilniaus Maironio progimnazija";"2 PU";7859096984;Ne;2;7;0;9
22894;"Vilniaus Maironio progimnazija";"2 PU";7252265838;Ne;0;6;0;6
22895;"Vilniaus Maironio progimnazija";"2 PU";5883751305;Ne;0;6;0;6
22896;"Vilniaus Maironio progimnazija";"2 PU";2215846642;Ne;0;6;0;6
22897;"Vilniaus Maironio progimnazija";"2 PU";2868899342;Ne;2;7;0;9
22898;"Vilniaus Maironio progimnazija";"2 PU";9804863902;Ne;0;6;0;6
22899;"Vilniaus Maironio progimnazija";"2 PU";8606551477;Ne;6;6;0;12
22900;"Vilniaus Maironio progimnazija";"2 PU";2334234258;Ne;0;7;0;7
22901;"Vilniaus Maironio progimnazija";"2 PU";9978625382;Ne;6;6;0;12
22902;"Vilniaus kunigaikščio Gedimino progimnazija";NYKŠTUKAI;5909584565;Ne;3;7;0;10
22903;"Vilniaus kunigaikščio Gedimino progimnazija";NYKŠTUKAI;6234943180;Ne;2;7;0;9
22904;"Vilniaus kunigaikščio Gedimino progimnazija";NYKŠTUKAI;2406183145;Ne;0;6;0;6
22905;"Vilniaus kunigaikščio Gedimino progimnazija";NYKŠTUKAI;2379660463;Ne;0;6;0;6
22906;"Vilniaus kunigaikščio Gedimino progimnazija";NYKŠTUKAI;3363824185;Ne;0;6;0;6
22907;"Vilniaus kunigaikščio Gedimino progimnazija";NYKŠTUKAI;9408948207;Ne;0;6;0;6
22908;"Vilniaus kunigaikščio Gedimino progimnazija";NYKŠTUKAI;6942029629;Ne;0;6;0;6
22909;"Vilniaus kunigaikščio Gedimino progimnazija";NYKŠTUKAI;7161727352;Ne;0;6;0;6
22910;"Vilniaus kunigaikščio Gedimino progimnazija";NYKŠTUKAI;5695333666;Ne;0;6;0;6
22911;"Vilniaus kunigaikščio Gedimino progimnazija";NYKŠTUKAI;8061678477;Ne;2;7;0;9
22912;"Vilniaus kunigaikščio Gedimino progimnazija";NYKŠTUKAI;4635123721;Ne;0;6;0;6
22913;"Vilniaus kunigaikščio Gedimino progimnazija";NYKŠTUKAI;6574415196;Ne;1;6;0;7
22914;"Vilniaus kunigaikščio Gedimino progimnazija";NYKŠTUKAI;9777202512;Ne;10;6;0;16
22915;"Vilniaus kunigaikščio Gedimino progimnazija";NYKŠTUKAI;5187411500;Ne;0;6;0;6
22916;"Vilniaus kunigaikščio Gedimino progimnazija";NYKŠTUKAI;1420438624;Ne;0;6;0;6
22917;"Vilniaus kunigaikščio Gedimino progimnazija";NYKŠTUKAI;4681686872;Ne;0;8;0;8
22918;"Gintarėlis (Popieriaus g. 46A)";SKRUZDĖLIUKAI;5738933125;Ne;8;4;0;12
22919;"Gintarėlis (Popieriaus g. 46A)";SKRUZDĖLIUKAI;7510541192;Ne;10;0;0;10
22920;"Gintarėlis (Popieriaus g. 46A)";SKRUZDĖLIUKAI;1955719034;Ne;8;4;0;12
22921;"Gintarėlis (Popieriaus g. 46A)";SKRUZDĖLIUKAI;1215549844;Ne;11;0;0;11
22922;"Gintarėlis (Popieriaus g. 46A)";SKRUZDĖLIUKAI;5961603860;Ne;10;4;0;14
22923;"Gintarėlis (Popieriaus g. 46A)";SKRUZDĖLIUKAI;5190355636;Ne;12;0;0;12
22924;"Gintarėlis (Popieriaus g. 46A)";SKRUZDĖLIUKAI;4290033336;Ne;7;1;0;8
22925;"Gintarėlis (Popieriaus g. 46A)";SKRUZDĖLIUKAI;5474876914;Ne;9;0;0;9
22926;"Gintarėlis (Popieriaus g. 46A)";SKRUZDĖLIUKAI;6333647073;Ne;12;0;0;12
22927;"Gintarėlis (Popieriaus g. 46A)";SKRUZDĖLIUKAI;7274616480;Ne;9;0;0;9
22928;"Gintarėlis (Popieriaus g. 46A)";SKRUZDĖLIUKAI;1362980885;Ne;15;0;0;15
22929;"Gintarėlis (Popieriaus g. 46A)";SKRUZDĖLIUKAI;9762364250;Ne;8;0;0;8
22930;"Gintarėlis (Popieriaus g. 46A)";SKRUZDĖLIUKAI;7206593645;Ne;6;0;0;6
22931;"Gintarėlis (Popieriaus g. 46A)";SKRUZDĖLIUKAI;7400455090;Ne;6;5;0;11
22932;"Gintarėlis (Popieriaus g. 46A)";SKRUZDĖLIUKAI;7413074674;Ne;4;0;0;4
22933;"Gintarėlis (Popieriaus g. 46A)";PELĖDŽIUKAI;6506180216;Ne;0;10;2;12
22934;"Gintarėlis (Popieriaus g. 46A)";PELĖDŽIUKAI;3254739432;Ne;0;0;5;5
22935;"Gintarėlis (Popieriaus g. 46A)";PELĖDŽIUKAI;8019543081;Ne;0;0;4;4
22936;"Gintarėlis (Popieriaus g. 46A)";PELĖDŽIUKAI;1628276472;Ne;0;4;0;4
22937;"Gintarėlis (Popieriaus g. 46A)";PELĖDŽIUKAI;8792175474;Ne;0;4;0;4
22938;"Gintarėlis (Popieriaus g. 46A)";PELĖDŽIUKAI;3304191482;Ne;1;2;0;3
22939;"Gintarėlis (Popieriaus g. 46A)";PELĖDŽIUKAI;2731865977;Ne;0;2;2;4
22940;"Gintarėlis (Popieriaus g. 46A)";PELĖDŽIUKAI;4181430769;Ne;0;7;0;7
22941;"Gintarėlis (Popieriaus g. 46A)";PELĖDŽIUKAI;3202819190;Ne;2;0;5;7
22942;"Gintarėlis (Popieriaus g. 46A)";PELĖDŽIUKAI;2308673417;Ne;0;5;0;5
22943;"Gintarėlis (Popieriaus g. 46A)";PELĖDŽIUKAI;6883573289;Ne;5;2;4;11
22944;"Gintarėlis (Popieriaus g. 46A)";PELĖDŽIUKAI;3127881266;Ne;0;7;0;7
22945;"Gintarėlis (Popieriaus g. 46A)";PELĖDŽIUKAI;2052962147;Ne;2;0;6;8
22946;"Gintarėlis (Popieriaus g. 46A)";PELĖDŽIUKAI;8677500463;Ne;1;1;5;7
22947;"Gintarėlis (Popieriaus g. 46A)";PELĖDŽIUKAI;7031945895;Ne;1;5;0;6
22948;"Gintarėlis (Popieriaus g. 46A)";PELĖDŽIUKAI;3744569118;Ne;0;19;0;19
22949;"Gintarėlis (Popieriaus g. 46A)";"LINKSMASIS AVILYS";7872515649;Ne;17;2;0;19
22950;"Gintarėlis (Popieriaus g. 46A)";"LINKSMASIS AVILYS";7256557310;Ne;0;13;0;13
22951;"Gintarėlis (Popieriaus g. 46A)";"LINKSMASIS AVILYS";7010430969;Ne;0;6;0;6
22952;"Gintarėlis (Popieriaus g. 46A)";"LINKSMASIS AVILYS";8680339493;Ne;10;0;0;10
22953;"Gintarėlis (Popieriaus g. 46A)";"LINKSMASIS AVILYS";5223116373;Ne;10;0;0;10
22954;"Gintarėlis (Popieriaus g. 46A)";"LINKSMASIS AVILYS";6162836315;Ne;7;0;0;7
22955;"Gintarėlis (Popieriaus g. 46A)";"LINKSMASIS AVILYS";3825572125;Ne;0;2;0;2
22956;"Gintarėlis (Popieriaus g. 46A)";"LINKSMASIS AVILYS";1994856959;Ne;8;4;0;12
22957;"Gintarėlis (Popieriaus g. 46A)";"LINKSMASIS AVILYS";8223747534;Ne;5;1;0;6
22958;"Gintarėlis (Popieriaus g. 46A)";"LINKSMASIS AVILYS";1045355492;Ne;10;3;0;13
22959;"Gintarėlis (Popieriaus g. 46A)";"LINKSMASIS AVILYS";6193540660;Ne;12;2;0;14
22960;"Gintarėlis (Popieriaus g. 46A)";"LINKSMASIS AVILYS";7916257692;Ne;12;4;0;16
22961;"Gintarėlis (Popieriaus g. 46A)";"LINKSMASIS AVILYS";9045108717;Ne;15;0;0;15
22962;"Gintarėlis (Popieriaus g. 46A)";"LINKSMASIS AVILYS";5379858630;Ne;0;4;7;11
22963;"Gintarėlis (Popieriaus g. 46A)";"LINKSMASIS AVILYS";1909958944;Ne;4;1;0;5
22964;"Gintarėlis (Popieriaus g. 46A)";Varliukai;6821929306;Ne;0;0;7;7
22965;"Gintarėlis (Popieriaus g. 46A)";Varliukai;4263315669;Ne;14;0;0;14
22966;"Gintarėlis (Popieriaus g. 46A)";Varliukai;6514247750;Ne;1;2;0;3
22967;"Gintarėlis (Popieriaus g. 46A)";Varliukai;1166720069;Ne;4;0;0;4
22968;"Gintarėlis (Popieriaus g. 46A)";Varliukai;4556644354;Ne;13;4;0;17
22969;"Gintarėlis (Popieriaus g. 46A)";Varliukai;7510641510;Ne;0;4;0;4
22970;"Gintarėlis (Popieriaus g. 46A)";Varliukai;6534072038;Ne;8;4;0;12
22971;"Gintarėlis (Popieriaus g. 46A)";Varliukai;5478441530;Ne;5;4;0;9
22972;"Gintarėlis (Popieriaus g. 46A)";Varliukai;5771196440;Ne;7;0;0;7
22973;"Gintarėlis (Popieriaus g. 46A)";Varliukai;7783860076;Taip;0;5;0;5
22974;"Gintarėlis (Popieriaus g. 46A)";Varliukai;7201714826;Ne;1;3;0;4
22975;"Gintarėlis (Popieriaus g. 46A)";Varliukai;6796839291;Ne;0;10;0;10
22976;"Gintarėlis (Popieriaus g. 46A)";Varliukai;3842338529;Ne;0;19;0;19
22977;"Gintarėlis (Popieriaus g. 46A)";Varliukai;2742819175;Ne;6;4;0;10
22978;"Gintarėlis (Popieriaus g. 46A)";Varliukai;2692117849;Ne;10;5;0;15
22979;"Gintarėlis (Popieriaus g. 46A)";Varliukai;9063374884;Ne;5;5;0;10
22980;"Gintarėlis (Popieriaus g. 46A)";Varliukai;8226000686;Ne;5;2;0;7
22981;"Gintarėlis (Popieriaus g. 46A)";Varliukai;7128652904;Taip;7;1;0;8
22982;"Pušynėlis (A. Mickevičiaus g. 21)";DAIGIUKAI;8668906624;Ne;11;1;0;12
22983;"Pušynėlis (A. Mickevičiaus g. 21)";DAIGIUKAI;9835049161;Ne;0;6;0;6
22984;"Pušynėlis (A. Mickevičiaus g. 21)";DAIGIUKAI;8473976622;Ne;6;0;0;6
22985;"Pušynėlis (A. Mickevičiaus g. 21)";DAIGIUKAI;7200341988;Ne;8;0;0;8
22986;"Pušynėlis (A. Mickevičiaus g. 21)";DAIGIUKAI;6630085270;Ne;4;0;0;4
22987;"Pušynėlis (A. Mickevičiaus g. 21)";DAIGIUKAI;6321506677;Ne;15;0;0;15
22988;"Pušynėlis (A. Mickevičiaus g. 21)";DAIGIUKAI;7825721993;Ne;0;2;1;3
22989;"Pušynėlis (A. Mickevičiaus g. 21)";DAIGIUKAI;2905910220;Ne;8;0;0;8
22990;"Pušynėlis (A. Mickevičiaus g. 21)";DAIGIUKAI;2283845338;Ne;5;0;0;5
22991;"Pušynėlis (A. Mickevičiaus g. 21)";DAIGIUKAI;2543730165;Ne;18;0;0;18
22992;"Pušynėlis (A. Mickevičiaus g. 21)";NYKŠTUKAI;8820865805;Ne;0;19;0;19
22993;"Pušynėlis (A. Mickevičiaus g. 21)";NYKŠTUKAI;9520423020;Ne;0;7;0;7
22994;"Pušynėlis (A. Mickevičiaus g. 21)";NYKŠTUKAI;3574446664;Taip;0;6;0;6
22995;"Pušynėlis (A. Mickevičiaus g. 21)";NYKŠTUKAI;8512699165;Ne;0;5;0;5
22996;"Pušynėlis (A. Mickevičiaus g. 21)";NYKŠTUKAI;5364537212;Ne;7;2;3;12
22997;"Pušynėlis (A. Mickevičiaus g. 21)";NYKŠTUKAI;8327830781;Ne;0;5;0;5
22998;"Pušynėlis (A. Mickevičiaus g. 21)";NYKŠTUKAI;1177938753;Ne;14;0;0;14
22999;"Pušynėlis (A. Mickevičiaus g. 21)";NYKŠTUKAI;7172604103;Ne;0;0;1;1
23000;"Pušynėlis (A. Mickevičiaus g. 21)";NYKŠTUKAI;5317547220;Ne;3;0;3;6
23001;"Pušynėlis (A. Mickevičiaus g. 21)";NYKŠTUKAI;9025539389;Ne;5;0;4;9
23002;"Pušynėlis (A. Mickevičiaus g. 21)";NYKŠTUKAI;6594473055;Ne;1;2;0;3
23003;"Pušynėlis (A. Mickevičiaus g. 21)";NYKŠTUKAI;2763762463;Ne;0;8;0;8
23004;"Pušynėlis (A. Mickevičiaus g. 21)";NYKŠTUKAI;8211464695;Ne;0;1;0;1
23005;"Pušynėlis (A. Mickevičiaus g. 21)";NYKŠTUKAI;6270870180;Taip;3;1;0;4
23006;"Pušynėlis (A. Mickevičiaus g. 21)";NYKŠTUKAI;4685125111;Ne;5;0;0;5
23007;"Pušynėlis (A. Mickevičiaus g. 21)";NYKŠTUKAI;9717473430;Ne;0;3;0;3
23008;"Pušynėlis (A. Mickevičiaus g. 21)";NYKŠTUKAI;1057676386;Ne;0;2;0;2
23009;"Pušynėlis (A. Mickevičiaus g. 21)";NYKŠTUKAI;5512586591;Ne;8;0;1;9
23010;"Pušynėlis (A. Mickevičiaus g. 21)";NYKŠTUKAI;1085678424;Ne;7;0;0;7
23011;"Pušynėlis (A. Mickevičiaus g. 21)";GILIUKAI;9517319856;Ne;10;4;0;14
23012;"Pušynėlis (A. Mickevičiaus g. 21)";GILIUKAI;2825756894;Ne;9;2;0;11
23013;"Pušynėlis (A. Mickevičiaus g. 21)";GILIUKAI;2712755125;Taip;0;0;7;7
23014;"Pušynėlis (A. Mickevičiaus g. 21)";GILIUKAI;3301741162;Ne;0;2;0;2
23015;"Pušynėlis (A. Mickevičiaus g. 21)";GILIUKAI;9028515427;Ne;0;1;0;1
23016;"Pušynėlis (A. Mickevičiaus g. 21)";GILIUKAI;1134325833;Ne;0;1;0;1
23017;"Pušynėlis (A. Mickevičiaus g. 21)";GILIUKAI;8298368128;Ne;4;0;1;5
23018;"Pušynėlis (A. Mickevičiaus g. 21)";GILIUKAI;8712141140;Ne;9;0;0;9
23019;"Pušynėlis (A. Mickevičiaus g. 21)";GILIUKAI;9220344337;Ne;3;0;0;3
23020;"Pušynėlis (A. Mickevičiaus g. 21)";GILIUKAI;1050710006;Ne;0;2;0;2
23021;"Pušynėlis (A. Mickevičiaus g. 21)";GILIUKAI;7596876368;Ne;2;0;0;2
23022;"Pušynėlis (A. Mickevičiaus g. 21)";GILIUKAI;1758632291;Ne;4;0;0;4
23023;"Pušynėlis (A. Mickevičiaus g. 21)";GILIUKAI;2892213973;Ne;5;4;0;9
23024;"Pušynėlis (A. Mickevičiaus g. 21)";GILIUKAI;7429853563;Ne;10;3;0;13
23025;"Pušynėlis (A. Mickevičiaus g. 21)";GILIUKAI;8464672994;Ne;0;4;0;4
23026;"Pušynėlis (A. Mickevičiaus g. 21)";GILIUKAI;9055713601;Ne;3;0;0;3
23027;"Pušynėlis (A. Mickevičiaus g. 21)";GILIUKAI;1904434730;Ne;9;0;1;10
23028;"Pušynėlis (A. Mickevičiaus g. 21)";GILIUKAI;3362971538;Ne;0;2;0;2
23029;"Pušynėlis (A. Mickevičiaus g. 21)";GILIUKAI;8699085292;Ne;3;1;0;4
23030;"Pušynėlis (A. Mickevičiaus g. 21)";GILIUKAI;2222790161;Ne;0;2;2;4
23031;"Pušynėlis (A. Mickevičiaus g. 21)";LINELIS;4126444564;Ne;6;6;0;12
23032;"Pušynėlis (A. Mickevičiaus g. 21)";LINELIS;4738909947;Ne;7;2;0;9
23033;"Pušynėlis (A. Mickevičiaus g. 21)";LINELIS;2315614501;Ne;0;3;0;3
23034;"Pušynėlis (A. Mickevičiaus g. 21)";LINELIS;3189188757;Ne;0;10;0;10
23035;"Pušynėlis (A. Mickevičiaus g. 21)";LINELIS;3682550072;Ne;0;4;0;4
23036;"Pušynėlis (A. Mickevičiaus g. 21)";LINELIS;8654487151;Taip;0;5;0;5
23037;"Pušynėlis (A. Mickevičiaus g. 21)";LINELIS;6160295507;Ne;0;4;0;4
23038;"Pušynėlis (A. Mickevičiaus g. 21)";LINELIS;8837847094;Ne;0;12;0;12
23039;"Pušynėlis (A. Mickevičiaus g. 21)";LINELIS;6374352500;Ne;5;0;0;5
23040;"Pušynėlis (A. Mickevičiaus g. 21)";LINELIS;9216703884;Ne;0;3;0;3
23041;"Pušynėlis (A. Mickevičiaus g. 21)";LINELIS;5668765825;Ne;13;4;0;17
23042;"Pušynėlis (A. Mickevičiaus g. 21)";LINELIS;3954867816;Ne;0;1;0;1
23043;"Pušynėlis (A. Mickevičiaus g. 21)";LINELIS;7685809238;Ne;5;4;0;9
23044;"Pušynėlis (A. Mickevičiaus g. 21)";LINELIS;7011836009;Ne;8;2;0;10
23045;"Pušynėlis (A. Mickevičiaus g. 21)";LINELIS;6735037523;Ne;4;2;0;6
23046;"Pušynėlis (A. Mickevičiaus g. 21)";LINELIS;9401101407;Ne;2;5;0;7
23047;"Pušynėlis (A. Mickevičiaus g. 21)";LINELIS;9147558926;Ne;0;2;1;3
23048;"Pušynėlis (A. Mickevičiaus g. 21)";LINELIS;7881263225;Ne;7;3;0;10
23049;"Pušynėlis (A. Mickevičiaus g. 21)";LINELIS;1612049897;Ne;0;7;0;7
23050;"Pušynėlis (A. Mickevičiaus g. 21)";LINELIS;9920959446;Ne;2;4;0;6
23051;"Pušynėlis (A. Mickevičiaus g. 21)";LINELIS;4898147530;Ne;15;0;0;15
23052;"Pušynėlis (A. Mickevičiaus g. 21)";LINELIS;2228682366;Ne;0;9;0;9
23053;"Pušynėlis (A. Mickevičiaus g. 21)";LINELIS;4464615995;Ne;3;2;0;5
23054;"Naminukas (Klinikų g. 5)";VARPELIAI;3281707263;Ne;9;0;0;9
23055;"Naminukas (Klinikų g. 5)";VARPELIAI;3683089217;Ne;2;6;0;8
23056;"Naminukas (Klinikų g. 5)";VARPELIAI;1086919259;Ne;12;2;0;14
23057;"Naminukas (Klinikų g. 5)";VARPELIAI;2576516583;Ne;15;4;0;19
23058;"Naminukas (Klinikų g. 5)";VARPELIAI;8694425584;Ne;6;0;4;10
23059;"Naminukas (Klinikų g. 5)";VARPELIAI;8782832803;Ne;5;3;0;8
23060;"Naminukas (Klinikų g. 5)";VARPELIAI;7555926818;Ne;8;0;3;11
23061;"Naminukas (Klinikų g. 5)";VARPELIAI;8392480469;Ne;0;2;0;2
23062;"Naminukas (Klinikų g. 5)";VARPELIAI;9426969493;Ne;5;1;0;6
23063;"Naminukas (Klinikų g. 5)";VARPELIAI;6834388512;Ne;15;4;0;19
23064;"Naminukas (Klinikų g. 5)";VARPELIAI;8212264128;Ne;10;1;0;11
23065;"Naminukas (Klinikų g. 5)";VARPELIAI;8659342548;Ne;11;0;0;11
23066;"Naminukas (Klinikų g. 5)";VARPELIAI;1415188327;Ne;12;0;0;12
23067;"Naminukas (Klinikų g. 5)";VARPELIAI;5154177047;Ne;12;0;0;12
23068;"Naminukas (Klinikų g. 5)";SAULUTĖS;7947598191;Ne;5;0;2;7
23069;"Naminukas (Klinikų g. 5)";SAULUTĖS;1635395128;Ne;0;0;1;1
23070;"Naminukas (Klinikų g. 5)";SAULUTĖS;2516513740;Ne;0;2;0;2
23071;"Naminukas (Klinikų g. 5)";SAULUTĖS;2721723305;Ne;0;4;1;5
23072;"Naminukas (Klinikų g. 5)";SAULUTĖS;6559544449;Ne;8;0;0;8
23073;"Naminukas (Klinikų g. 5)";SAULUTĖS;8052458976;Ne;5;4;0;9
23074;"Naminukas (Klinikų g. 5)";SAULUTĖS;2089455192;Ne;8;0;0;8
23075;"Naminukas (Klinikų g. 5)";SAULUTĖS;1828220049;Ne;5;1;1;7
23076;"Naminukas (Klinikų g. 5)";SAULUTĖS;5172385044;Ne;17;0;0;17
23077;"Naminukas (Klinikų g. 5)";SAULUTĖS;7772300667;Ne;8;0;1;9
23078;"Naminukas (Klinikų g. 5)";SAULUTĖS;3497829075;Ne;2;0;1;3
23079;"Naminukas (Klinikų g. 5)";SAULUTĖS;3938225198;Ne;5;4;0;9
23080;"Naminukas (Klinikų g. 5)";SAULUTĖS;6515021073;Ne;11;0;1;12
23081;"Naminukas (Klinikų g. 5)";SAULUTĖS;9894306360;Ne;6;4;0;10
23082;"Naminukas (Klinikų g. 5)";SAULUTĖS;5991261279;Ne;10;0;0;10
23083;"Naminukas (Klinikų g. 5)";SAULUTĖS;9537360943;Ne;10;0;0;10
23084;"Naminukas (Klinikų g. 5)";SAULUTĖS;7304789836;Ne;3;0;0;3
23085;"Naminukas (Klinikų g. 5)";DRUGELIAI;7033053271;Ne;4;4;0;8
23086;"Naminukas (Klinikų g. 5)";DRUGELIAI;7184471307;Ne;3;0;0;3
23087;"Naminukas (Klinikų g. 5)";DRUGELIAI;8432194383;Ne;8;5;0;13
23088;"Naminukas (Klinikų g. 5)";DRUGELIAI;9835701381;Ne;3;0;0;3
23089;"Naminukas (Klinikų g. 5)";DRUGELIAI;1092799944;Ne;3;1;1;5
23090;"Naminukas (Klinikų g. 5)";DRUGELIAI;8595804874;Ne;0;4;0;4
23091;"Naminukas (Klinikų g. 5)";DRUGELIAI;3911352454;Ne;13;2;0;15
23092;"Naminukas (Klinikų g. 5)";DRUGELIAI;7107337857;Ne;1;4;2;7
23093;"Naminukas (Klinikų g. 5)";DRUGELIAI;7301768930;Ne;0;0;2;2
23094;"Naminukas (Klinikų g. 5)";DRUGELIAI;9212800864;Ne;0;5;0;5
23095;"Naminukas (Klinikų g. 5)";DRUGELIAI;2336627398;Ne;14;0;0;14
23096;"Naminukas (Klinikų g. 5)";DRUGELIAI;1879925655;Ne;0;4;0;4
23097;"Naminukas (Klinikų g. 5)";DRUGELIAI;2881576194;Ne;5;1;1;7
23098;"Naminukas (Klinikų g. 5)";DRUGELIAI;4836599508;Ne;9;0;0;9
23099;"Naminukas (Klinikų g. 5)";DRUGELIAI;1563213488;Ne;0;0;1;1
23100;"Naminukas (Klinikų g. 5)";DRUGELIAI;4709625816;Ne;0;0;1;1
23101;"Naminukas (Klinikų g. 5)";DRUGELIAI;6471277755;Ne;0;4;0;4
23102;"Naminukas (Klinikų g. 5)";DRUGELIAI;1932169696;Ne;7;0;0;7
23103;"Naminukas (Klinikų g. 5)";DRUGELIAI;9215327479;Ne;8;0;1;9
23104;"Naminukas (Klinikų g. 5)";BITUTĖS;6592057292;Ne;7;5;0;12
23105;"Naminukas (Klinikų g. 5)";BITUTĖS;5578151523;Ne;0;3;0;3
23106;"Naminukas (Klinikų g. 5)";BITUTĖS;5288557629;Ne;4;8;0;12
23107;"Naminukas (Klinikų g. 5)";BITUTĖS;5233044803;Ne;5;2;0;7
23108;"Naminukas (Klinikų g. 5)";BITUTĖS;3791118736;Ne;0;4;1;5
23109;"Naminukas (Klinikų g. 5)";BITUTĖS;7099787230;Ne;5;4;0;9
23110;"Naminukas (Klinikų g. 5)";BITUTĖS;3088386659;Ne;0;4;0;4
23111;"Naminukas (Klinikų g. 5)";BITUTĖS;8412724452;Ne;6;2;0;8
23112;"Naminukas (Klinikų g. 5)";BITUTĖS;3276656641;Ne;10;0;4;14
23113;"Naminukas (Klinikų g. 5)";BITUTĖS;2004615252;Ne;0;4;0;4
23114;"Naminukas (Klinikų g. 5)";BITUTĖS;6633031473;Ne;0;4;1;5
23115;"Naminukas (Klinikų g. 5)";BITUTĖS;4116151797;Taip;9;0;0;9
23116;"Naminukas (Klinikų g. 5)";BITUTĖS;2339599448;Ne;0;4;0;4
23117;"Naminukas (Klinikų g. 5)";BITUTĖS;4077985773;Ne;1;4;0;5
23118;"Naminukas (Klinikų g. 5)";BITUTĖS;1454039572;Ne;5;0;1;6
23119;"Naminukas (Klinikų g. 5)";BITUTĖS;9740815635;Ne;0;2;0;2
23120;"Naminukas (Klinikų g. 5)";BITUTĖS;6949857110;Ne;0;4;0;4
23121;"Naminukas (Klinikų g. 5)";BITUTĖS;8039086094;Ne;0;4;0;4
23122;"Naminukas (Klinikų g. 5)";BITUTĖS;7463647806;Ne;0;1;0;1
23123;"Naminukas (Klinikų g. 5)";BITUTĖS;4171789569;Ne;0;6;0;6
23124;"Naminukas (Klinikų g. 5)";BITUTĖS;6880075874;Ne;6;4;0;10
23125;"Naminukas (Klinikų g. 5)";BITUTĖS;8793327541;Ne;0;4;0;4
23126;"Gervelė (Stadiono g. 5)";BORUŽĖLĖS;4354544070;Ne;2;0;2;4
23127;"Gervelė (Stadiono g. 5)";BORUŽĖLĖS;3448452820;Ne;14;0;0;14
23128;"Gervelė (Stadiono g. 5)";BORUŽĖLĖS;2794943031;Ne;7;0;0;7
23129;"Gervelė (Stadiono g. 5)";BORUŽĖLĖS;5697289420;Ne;0;0;3;3
23130;"Gervelė (Stadiono g. 5)";BORUŽĖLĖS;8763515382;Ne;7;0;0;7
23131;"Gervelė (Stadiono g. 5)";BORUŽĖLĖS;3516734802;Ne;2;0;2;4
23132;"Gervelė (Stadiono g. 5)";BORUŽĖLĖS;6340371637;Ne;10;0;1;11
23133;"Gervelė (Stadiono g. 5)";BORUŽĖLĖS;9370956691;Ne;13;0;0;13
23134;"Gervelė (Stadiono g. 5)";BORUŽĖLĖS;6336219323;Ne;2;0;0;2
23135;"Gervelė (Stadiono g. 5)";BORUŽĖLĖS;8067639732;Ne;12;0;0;12
23136;"Gervelė (Stadiono g. 5)";PAUKŠTELIAI;7959839478;Ne;8;4;0;12
23137;"Gervelė (Stadiono g. 5)";PAUKŠTELIAI;2892214705;Ne;0;11;0;11
23138;"Gervelė (Stadiono g. 5)";PAUKŠTELIAI;9154032804;Ne;0;9;0;9
23139;"Gervelė (Stadiono g. 5)";PAUKŠTELIAI;7843800194;Ne;0;2;0;2
23140;"Gervelė (Stadiono g. 5)";PAUKŠTELIAI;4588890423;Taip;0;12;0;12
23141;"Gervelė (Stadiono g. 5)";PAUKŠTELIAI;7847393041;Ne;0;15;0;15
23142;"Gervelė (Stadiono g. 5)";PAUKŠTELIAI;6427072260;Ne;0;2;0;2
23143;"Gervelė (Stadiono g. 5)";PAUKŠTELIAI;5285868851;Ne;0;2;0;2
23144;"Gervelė (Stadiono g. 5)";PAUKŠTELIAI;2622183564;Ne;15;4;0;19
23145;"Gervelė (Stadiono g. 5)";PAUKŠTELIAI;1006720360;Ne;0;6;0;6
23146;"Gervelė (Stadiono g. 5)";PAUKŠTELIAI;8190190100;Ne;0;3;0;3
23147;"Gervelė (Stadiono g. 5)";PAUKŠTELIAI;2712133300;Ne;0;11;0;11
23148;"Gervelė (Stadiono g. 5)";PAUKŠTELIAI;4191553800;Ne;3;3;0;6
23149;"Gervelė (Stadiono g. 5)";PAUKŠTELIAI;3679218086;Ne;2;2;0;4
23150;"Gervelė (Stadiono g. 5)";SPINDULĖLIAI;4051246539;Ne;0;1;2;3
23151;"Gervelė (Stadiono g. 5)";SPINDULĖLIAI;5705915729;Ne;0;6;0;6
23152;"Gervelė (Stadiono g. 5)";SPINDULĖLIAI;6241611652;Ne;0;15;0;15
23153;"Gervelė (Stadiono g. 5)";SPINDULĖLIAI;1204513844;Ne;0;4;3;7
23154;"Gervelė (Stadiono g. 5)";SPINDULĖLIAI;8710469480;Ne;0;12;0;12
23155;"Gervelė (Stadiono g. 5)";SPINDULĖLIAI;9777308731;Ne;0;3;1;4
23156;"Gervelė (Stadiono g. 5)";SPINDULĖLIAI;6573919007;Ne;0;9;0;9
23157;"Gervelė (Stadiono g. 5)";SPINDULĖLIAI;3676856569;Ne;0;4;0;4
23158;"Gervelė (Stadiono g. 5)";SPINDULĖLIAI;3567687304;Ne;0;2;3;5
23159;"Gervelė (Stadiono g. 5)";SPINDULĖLIAI;6372245141;Ne;0;4;3;7
23160;"Gervelė (Stadiono g. 5)";SPINDULĖLIAI;5818430690;Ne;0;4;5;9
23161;"Gervelė (Stadiono g. 5)";SPINDULĖLIAI;1515920896;Ne;2;0;4;6
23162;"Gervelė (Stadiono g. 5)";SPINDULĖLIAI;4168864882;Ne;2;1;2;5
23163;"Gervelė (Stadiono g. 5)";SPINDULĖLIAI;5828514911;Ne;0;1;0;1
23164;"Gervelė (Stadiono g. 5)";SPINDULĖLIAI;9542729826;Ne;9;4;1;14
23165;"Gervelė (Stadiono g. 5)";SPINDULĖLIAI;1751440418;Ne;0;3;2;5
23166;"Gervelė (Stadiono g. 5)";GĖLYTĖS;6621769160;Ne;0;3;1;4
23167;"Gervelė (Stadiono g. 5)";GĖLYTĖS;7115198351;Ne;0;1;0;1
23168;"Gervelė (Stadiono g. 5)";GĖLYTĖS;4832348492;Ne;0;0;1;1
23169;"Gervelė (Stadiono g. 5)";GĖLYTĖS;1749117711;Ne;2;4;2;8
23170;"Gervelė (Stadiono g. 5)";GĖLYTĖS;7855598075;Ne;0;4;0;4
23171;"Gervelė (Stadiono g. 5)";GĖLYTĖS;6488139414;Ne;3;1;0;4
23172;"Gervelė (Stadiono g. 5)";GĖLYTĖS;3216423543;Ne;0;2;0;2
23173;"Gervelė (Stadiono g. 5)";GĖLYTĖS;4925983616;Ne;0;3;3;6
23174;"Gervelė (Stadiono g. 5)";GĖLYTĖS;7952102572;Ne;15;1;0;16
23175;"Gervelė (Stadiono g. 5)";GĖLYTĖS;5966215998;Ne;9;4;0;13
23176;"Gervelė (Stadiono g. 5)";GĖLYTĖS;7463376031;Ne;0;9;0;9
23177;"Gervelė (Stadiono g. 5)";GĖLYTĖS;2431435960;Ne;9;4;1;14
23178;"Gervelė (Stadiono g. 5)";GĖLYTĖS;9100411947;Ne;3;4;0;7
23179;"Kūlverstukas (Mindaugo g. 7)";GNOMIKI;1720671485;Ne;0;5;0;5
23180;"Kūlverstukas (Mindaugo g. 7)";GNOMIKI;4894478262;Taip;7;0;0;7
23181;"Kūlverstukas (Mindaugo g. 7)";GNOMIKI;2501327054;Ne;0;3;0;3
23182;"Kūlverstukas (Mindaugo g. 7)";GNOMIKI;8348978878;Ne;0;3;0;3
23183;"Kūlverstukas (Mindaugo g. 7)";GNOMIKI;8927489885;Ne;16;0;0;16
23184;"Kūlverstukas (Mindaugo g. 7)";GNOMIKI;2709547427;Ne;0;3;0;3
23185;"Kūlverstukas (Mindaugo g. 7)";GNOMIKI;5532063862;Ne;8;0;3;11
23186;"Kūlverstukas (Mindaugo g. 7)";GNOMIKI;5747277587;Ne;0;4;0;4
23187;"Kūlverstukas (Mindaugo g. 7)";GNOMIKI;1848018684;Ne;0;4;0;4
23188;"Kūlverstukas (Mindaugo g. 7)";GNOMIKI;1166429762;Ne;0;5;0;5
23189;"Kūlverstukas (Mindaugo g. 7)";GNOMIKI;6514730230;Ne;5;0;0;5
23190;"Kūlverstukas (Mindaugo g. 7)";GNOMIKI;3239566139;Ne;0;3;0;3
23191;"Kūlverstukas (Mindaugo g. 7)";GNOMIKI;5260820316;Ne;6;2;0;8
23192;"Kūlverstukas (Mindaugo g. 7)";GNOMIKI;6387540242;Ne;5;2;0;7
23193;"Kūlverstukas (Mindaugo g. 7)";GNOMIKI;3029705994;Ne;5;4;0;9
23194;"Kūlverstukas (Mindaugo g. 7)";GNOMIKI;1869389013;Ne;14;0;0;14
23195;"Kūlverstukas (Mindaugo g. 7)";GNOMIKI;3201081769;Ne;9;0;0;9
23196;"Kūlverstukas (Mindaugo g. 7)";GNOMIKI;2822906102;Ne;6;0;0;6
23197;"Kūlverstukas (Mindaugo g. 7)";GNOMIKI;3336317999;Ne;4;0;0;4
23198;"Kūlverstukas (Mindaugo g. 7)";ZAIČIATA;8994705290;Ne;5;7;0;12
23199;"Kūlverstukas (Mindaugo g. 7)";ZAIČIATA;2494202134;Ne;0;5;0;5
23200;"Kūlverstukas (Mindaugo g. 7)";ZAIČIATA;2714297182;Ne;0;2;0;2
23201;"Kūlverstukas (Mindaugo g. 7)";ZAIČIATA;4998847820;Ne;3;0;0;3
23202;"Kūlverstukas (Mindaugo g. 7)";ZAIČIATA;3660002342;Ne;1;0;0;1
23203;"Kūlverstukas (Mindaugo g. 7)";ZAIČIATA;7883325884;Ne;2;2;0;4
23204;"Kūlverstukas (Mindaugo g. 7)";ZAIČIATA;6621027840;Ne;5;0;0;5
23205;"Kūlverstukas (Mindaugo g. 7)";ZAIČIATA;6090797103;Ne;5;0;0;5
23206;"Kūlverstukas (Mindaugo g. 7)";ZAIČIATA;6872789727;Ne;7;0;0;7
23207;"Kūlverstukas (Mindaugo g. 7)";ZAIČIATA;1229210560;Ne;19;0;0;19
23208;"Kūlverstukas (Mindaugo g. 7)";ZAIČIATA;9596978613;Ne;0;2;0;2
23209;"Kūlverstukas (Mindaugo g. 7)";ZAIČIATA;8841423764;Ne;3;0;0;3
23210;"Kūlverstukas (Mindaugo g. 7)";ZAIČIATA;8973143142;Ne;17;0;0;17
23211;"Kūlverstukas (Mindaugo g. 7)";ZAIČIATA;1443431065;Ne;6;0;0;6
23212;"Kūlverstukas (Mindaugo g. 7)";SVETLIAČKI;2154916232;Ne;0;4;0;4
23213;"Kūlverstukas (Mindaugo g. 7)";SVETLIAČKI;5794471794;Ne;1;0;0;1
23214;"Kūlverstukas (Mindaugo g. 7)";SVETLIAČKI;7829384850;Ne;1;0;0;1
23215;"Kūlverstukas (Mindaugo g. 7)";SVETLIAČKI;3449300504;Ne;0;2;0;2
23216;"Kūlverstukas (Mindaugo g. 7)";SVETLIAČKI;1102996499;Ne;7;0;0;7
23217;"Kūlverstukas (Mindaugo g. 7)";SVETLIAČKI;6311116034;Ne;7;0;0;7
23218;"Kūlverstukas (Mindaugo g. 7)";SVETLIAČKI;1635418112;Ne;0;10;0;10
23219;"Kūlverstukas (Mindaugo g. 7)";SVETLIAČKI;4352034102;Ne;10;0;0;10
23220;"Kūlverstukas (Mindaugo g. 7)";SVETLIAČKI;6497373567;Ne;0;4;0;4
23221;"Kūlverstukas (Mindaugo g. 7)";SVETLIAČKI;1034428300;Ne;1;0;0;1
23222;"Kūlverstukas (Mindaugo g. 7)";SVETLIAČKI;2434552926;Ne;6;0;0;6
23223;"Kūlverstukas (Mindaugo g. 7)";SVETLIAČKI;8496678513;Ne;3;0;0;3
23224;"Kūlverstukas (Mindaugo g. 7)";SVETLIAČKI;5079635330;Ne;2;3;0;5
23225;"Kūlverstukas (Mindaugo g. 7)";SVETLIAČKI;9021495553;Ne;4;0;0;4
23226;"Kūlverstukas (Mindaugo g. 7)";SVETLIAČKI;6319075079;Ne;5;0;0;5
23227;"Kūlverstukas (Mindaugo g. 7)";ZVONOČKI;1486878343;Ne;1;1;0;2
23228;"Kūlverstukas (Mindaugo g. 7)";ZVONOČKI;8835111916;Ne;0;6;0;6
23229;"Kūlverstukas (Mindaugo g. 7)";ZVONOČKI;5724787637;Ne;0;2;0;2
23230;"Kūlverstukas (Mindaugo g. 7)";ZVONOČKI;9835391223;Ne;5;4;0;9
23231;"Kūlverstukas (Mindaugo g. 7)";ZVONOČKI;1566191212;Ne;5;0;2;7
23232;"Kūlverstukas (Mindaugo g. 7)";ZVONOČKI;9569296370;Ne;5;6;0;11
23233;"Kūlverstukas (Mindaugo g. 7)";ZVONOČKI;1047459617;Ne;0;3;0;3
23234;"Kūlverstukas (Mindaugo g. 7)";ZVONOČKI;2091204077;Ne;0;5;0;5
23235;"Kūlverstukas (Mindaugo g. 7)";ZVONOČKI;4934613845;Ne;0;4;2;6
23236;"Kūlverstukas (Mindaugo g. 7)";ZVONOČKI;6463626516;Ne;3;1;2;6
23237;"Kūlverstukas (Mindaugo g. 7)";ZVONOČKI;8814110710;Ne;0;0;1;1
23238;"Kūlverstukas (Mindaugo g. 7)";ZVONOČKI;4152186586;Ne;0;4;1;5
23239;"Kūlverstukas (Mindaugo g. 7)";ZVONOČKI;6680792848;Ne;0;3;0;3
23240;"Kūlverstukas (Mindaugo g. 7)";ZVONOČKI;4424095457;Ne;4;1;0;5
23241;"Kūlverstukas (Mindaugo g. 7)";ZVONOČKI;5731394231;Ne;0;3;1;4
23242;"Kūlverstukas (Mindaugo g. 7)";ZVONOČKI;1808699695;Ne;6;4;2;12
23243;"Kūlverstukas (Mindaugo g. 7)";ZVONOČKI;1646912457;Ne;0;3;0;3
23244;"Kūlverstukas (Mindaugo g. 7)";ZVONOČKI;4116831802;Ne;0;1;0;1
23245;"Kūlverstukas (Mindaugo g. 7)";ZVONOČKI;6219872984;Ne;3;3;2;8
23246;"Kūlverstukas (Mindaugo g. 7)";ZVONOČKI;9098427210;Ne;1;3;2;6
23247;"Kūlverstukas (Mindaugo g. 7)";ZVONOČKI;1916522637;Ne;3;0;5;8
23248;"Vilniaus Pavilnio pagrindinė mokykla";"PRIEŠMOKYKLINĖ RU";1445328501;Ne;2;4;0;6
23249;"Vilniaus Pavilnio pagrindinė mokykla";"PRIEŠMOKYKLINĖ RU";6537464526;Ne;9;4;0;13
23250;"Vilniaus Pavilnio pagrindinė mokykla";"PRIEŠMOKYKLINĖ RU";1509519996;Ne;4;4;0;8
23251;"Vilniaus Pavilnio pagrindinė mokykla";"PRIEŠMOKYKLINĖ RU";5706671963;Ne;5;4;0;9
23252;"Vilniaus Pavilnio pagrindinė mokykla";"PRIEŠMOKYKLINĖ RU";1035890284;Ne;4;4;0;8
23253;"Vilniaus Pavilnio pagrindinė mokykla";"PRIEŠMOKYKLINĖ RU";4602268315;Ne;9;4;0;13
23254;"Vilniaus Pavilnio pagrindinė mokykla";"PRIEŠMOKYKLINĖ RU";1107633909;Ne;4;4;0;8
23255;"Vilniaus Pavilnio pagrindinė mokykla";"PRIEŠMOKYKLINĖ RU";1344983194;Ne;5;5;0;10
23256;"Vilniaus Pavilnio pagrindinė mokykla";"PRIEŠMOKYKLINĖ RU";8684207189;Ne;0;19;0;19
23257;"Vilniaus Pavilnio pagrindinė mokykla";"PRIEŠMOKYKLINĖ RU";8262619320;Ne;5;4;0;9
23258;"Vilniaus Pavilnio pagrindinė mokykla";"PRIEŠMOKYKLINĖ RU";4516507512;Ne;3;4;0;7
23259;"Vilniaus Pavilnio pagrindinė mokykla";"PRIEŠMOKYKLINĖ PL";4038279267;Ne;4;4;0;8
23260;"Vilniaus Pavilnio pagrindinė mokykla";"PRIEŠMOKYKLINĖ PL";9533901360;Ne;4;4;0;8
23261;"Vilniaus Pavilnio pagrindinė mokykla";"PRIEŠMOKYKLINĖ PL";6716558946;Ne;5;4;0;9
23262;"Vilniaus Pavilnio pagrindinė mokykla";"PRIEŠMOKYKLINĖ PL";5760026802;Ne;5;4;0;9
23263;"Lazdynų mokykla (Liudvinavo g.128)";DRUGELIAI;7524849851;Ne;0;5;0;5
23264;"Lazdynų mokykla (Liudvinavo g.128)";DRUGELIAI;8650496265;Ne;0;3;0;3
23265;"Lazdynų mokykla (Liudvinavo g.128)";DRUGELIAI;9309081745;Taip;1;5;0;6
23266;"Lazdynų mokykla (Liudvinavo g.128)";DRUGELIAI;1951041742;Ne;0;4;0;4
23267;"Lazdynų mokykla (Liudvinavo g.128)";DRUGELIAI;9196184984;Ne;0;4;0;4
23268;"Lazdynų mokykla (Liudvinavo g.128)";DRUGELIAI;2767732459;Ne;0;9;0;9
23269;"Lazdynų mokykla (Liudvinavo g.128)";DRUGELIAI;6394098306;Ne;10;0;0;10
23270;"Lazdynų mokykla (Liudvinavo g.128)";DRUGELIAI;7074859809;Taip;9;2;0;11
23271;"Lazdynų mokykla (Liudvinavo g.128)";DRUGELIAI;4097980299;Ne;1;4;0;5
23272;"Lazdynų mokykla (Liudvinavo g.128)";DRUGELIAI;8001610972;Ne;2;4;0;6
23273;"Lazdynų mokykla (Liudvinavo g.128)";DRUGELIAI;5902104981;Ne;0;7;0;7
23274;"Lazdynų mokykla (Liudvinavo g.128)";DRUGELIAI;7590111138;Ne;0;5;0;5
23275;"Lazdynų mokykla (Liudvinavo g.128)";DRUGELIAI;2027751624;Ne;6;4;0;10
23276;"Lazdynų mokykla (Liudvinavo g.128)";DRUGELIAI;8011040528;Ne;0;4;0;4
23277;"Lazdynų mokykla (Liudvinavo g.128)";DRUGELIAI;5632106043;Ne;7;0;0;7
23278;"Lazdynų mokykla (Liudvinavo g.128)";ZUIKUČIAI;7232402011;Ne;0;8;0;8
23279;"Lazdynų mokykla (Liudvinavo g.128)";ZUIKUČIAI;4166599533;Taip;5;0;0;5
23280;"Lazdynų mokykla (Liudvinavo g.128)";ZUIKUČIAI;3265099747;Ne;4;0;0;4
23281;"Lazdynų mokykla (Liudvinavo g.128)";ZUIKUČIAI;3302443490;Ne;2;1;0;3
23282;"Lazdynų mokykla (Liudvinavo g.128)";ZUIKUČIAI;7000921682;Ne;0;1;0;1
23283;"Lazdynų mokykla (Liudvinavo g.128)";ZUIKUČIAI;3535244441;Ne;9;0;0;9
23284;"Lazdynų mokykla (Liudvinavo g.128)";ZUIKUČIAI;7594978836;Ne;0;1;0;1
23285;"Lazdynų mokykla (Liudvinavo g.128)";ZUIKUČIAI;5465094647;Ne;0;7;0;7
23286;"Lazdynų mokykla (Liudvinavo g.128)";ZUIKUČIAI;1044630813;Ne;0;3;0;3
23287;"Lazdynų mokykla (Liudvinavo g.128)";ZUIKUČIAI;7229926614;Ne;9;0;0;9
23288;"Lazdynų mokykla (Liudvinavo g.128)";ZUIKUČIAI;8899186547;Ne;14;0;0;14
23289;"Lazdynų mokykla (Liudvinavo g.128)";ZUIKUČIAI;5181200460;Ne;2;4;0;6
23290;"Lazdynų mokykla (Liudvinavo g.128)";ZUIKUČIAI;9169301469;Ne;4;0;0;4
23291;"Vilniaus Šilo mokykla";Boružėlės;7122041826;Ne;9;4;0;13
23292;"Vilniaus Šilo mokykla";Boružėlės;9967276147;Ne;3;4;0;7
23293;"Vilniaus Šilo mokykla";Boružėlės;5962551687;Ne;0;4;0;4
23294;"Vilniaus Šilo mokykla";Boružėlės;1196172221;Ne;15;4;0;19
23295;"Vilniaus Šilo mokykla";Boružėlės;1538635985;Ne;11;4;0;15
23296;"Vilniaus Šilo mokykla";Boružėlės;6136087920;Ne;0;19;0;19
23297;"Vilniaus Šilo mokykla";Boružėlės;4544126354;Ne;2;4;0;6
23298;"Vilniaus Šilo mokykla";Boružėlės;8897729962;Ne;2;4;0;6
23299;"Vilniaus Šilo mokykla";"3 spec.";73899364649;Ne;0;4;0;4
23300;"Vilniaus Šilo mokykla";"3 spec.";1417978731;Ne;0;4;0;4
23301;"Vilniaus Šilo mokykla";"3 spec.";28814860843;Ne;0;19;0;19
23302;"Vilniaus Šilo mokykla";"3 spec.";93519259505;Ne;0;4;0;4
23303;"Vilniaus Šilo mokykla";"3 spec.";63472451321;Ne;0;4;0;4
23304;"Vilniaus Šilo mokykla";"3 spec.";3473596157;Ne;4;4;0;8
23305;"Vilniaus Šilo mokykla";"3 spec.";1475766630;Ne;0;19;0;19
23306;"Vilniaus Šilo mokykla";"3 spec.";1401546788;Ne;0;4;0;4
23307;"Vilniaus Šilo mokykla";"7-10 spec.";9944901942;Ne;4;4;0;8
23308;"Vilniaus Šilo mokykla";"7-10 spec.";3333634089;Ne;0;19;0;19
23309;"Vilniaus Šilo mokykla";"7-10 spec.";8548722736;Ne;1;4;0;5
23310;"Vilniaus Šilo mokykla";"7-10 spec.";5255365063;Ne;3;4;0;7
23311;"Vilniaus Šilo mokykla";"7-10 spec.";6452740859;Ne;4;4;0;8
23312;"Vilniaus Šilo mokykla";"7-10 spec.";60608633947;Ne;1;4;0;5
23313;"Vilniaus Šilo mokykla";"7-10 spec.";4906175269;Ne;3;4;0;7
23314;"Vilniaus Šilo mokykla";"7-10 spec.";9264140610;Ne;1;4;0;5
23315;"Vilniaus Šilo mokykla";"7-10 lav.";92425322676;Ne;0;4;0;4
23316;"Vilniaus Šilo mokykla";"7-10 lav.";5905008395;Ne;0;4;0;4
23317;"Vilniaus Šilo mokykla";"7-10 lav.";4738867530;Ne;0;4;0;4
23318;"Vilniaus Šilo mokykla";"7-10 lav.";8490224829;Ne;0;4;0;4
23319;"Vilniaus Šilo mokykla";"7-10 lav.";81654551230;Ne;5;4;0;9
23320;"Vilniaus Šilo mokykla";"7-10 lav.";7740504510;Ne;15;4;0;19
23321;"Vilniaus Šilo mokykla";"7-10 lav.";5388697695;Ne;0;4;0;4
23322;"Vilniaus Šilo mokykla";"7-10 lav.";20604410476;Ne;0;4;0;4
23323;"Vilniaus Šilo mokykla";"7-10 lav.";6868265902;Ne;0;19;0;19
23324;"Vilniaus Šilo mokykla";"7-10 lav.";2234931428;Ne;0;19;0;19
23325;"Vilniaus Šilo mokykla";"SĮ A";6954467869;Ne;0;19;0;19
23326;"Vilniaus Šilo mokykla";"SĮ A";9354191217;Ne;0;4;0;4
23327;"Vilniaus Šilo mokykla";"SĮ A";9471629029;Ne;2;4;0;6
23328;"Vilniaus Šilo mokykla";"SĮ A";6088433049;Ne;1;4;0;5
23329;"Vilniaus Šilo mokykla";"SĮ A";1819519275;Ne;0;4;0;4
23330;"Vilniaus Šilo mokykla";"SĮ A";9845575989;Ne;2;4;0;6
23331;"Vilniaus Šilo mokykla";"SĮ A";3308772529;Ne;1;4;0;5
23332;"Vilniaus Šilo mokykla";"SĮ A";1726056983;Ne;6;4;0;10
23333;"Vilniaus Šilo mokykla";"SĮ A";3442250711;Ne;8;4;0;12
23334;"Vilniaus Šilo mokykla";"SĮ A";2755910347;Ne;1;4;0;5
23335;"Vilniaus Šilo mokykla";"SĮ C";1322335360;Ne;0;4;0;4
23336;"Vilniaus Šilo mokykla";"SĮ C";8642665550;Ne;0;4;0;4
23337;"Vilniaus Šilo mokykla";"SĮ C";5309862220;Ne;0;19;0;19
23338;"Vilniaus Šilo mokykla";"SĮ C";1010885560;Ne;0;4;0;4
23339;"Vilniaus Šilo mokykla";"SĮ C";2501187241;Ne;0;4;0;4
23340;"Vilniaus Šilo mokykla";"SĮ C";2681438925;Ne;1;4;0;5
23341;"Vilniaus Šilo mokykla";"8 spec.";948748525;Ne;2;4;0;6
23342;"Vilniaus Šilo mokykla";"8 spec.";1422218905;Ne;0;19;0;19
23343;"Vilniaus Šilo mokykla";"8 spec.";1177826873;Ne;1;4;0;5
23344;"Vilniaus Šilo mokykla";"8 spec.";3776046409;Ne;2;4;0;6
23345;"Vilniaus Šilo mokykla";"8 spec.";9784624648;Ne;8;4;0;12
23346;"Vilniaus Šilo mokykla";"8 spec.";3621978449;Ne;1;4;0;5
23347;"Vilniaus Šilo mokykla";"8 spec.";5186364504;Ne;0;19;0;19
23348;"Vilniaus Šilo mokykla";"8 spec.";9277299634;Ne;3;4;0;7
23349;"Vilniaus Šilo mokykla";"8 spec.";2672192094;Ne;0;4;0;4
23350;"Vilniaus Šilo mokykla";"8 spec.";2672192094;Ne;0;4;0;4
23351;"Vilniaus Šilo mokykla";"8-10 lav.";2020417997;Ne;10;4;0;14
23352;"Vilniaus Šilo mokykla";"8-10 lav.";1298624014;Ne;0;4;0;4
23353;"Vilniaus Šilo mokykla";"8-10 lav.";8926954085;Ne;0;4;0;4
23354;"Vilniaus Šilo mokykla";"8-10 lav.";1742331213;Ne;0;4;0;4
23355;"Vilniaus Šilo mokykla";"8-10 lav.";7040253931;Ne;1;4;0;5
23356;"Vilniaus Šilo mokykla";"8-10 lav.";8276932013;Ne;0;4;0;4
23357;"Vilniaus Šilo mokykla";"7 lav.";3612746646;Ne;1;4;0;5
23358;"Vilniaus Šilo mokykla";"7 lav.";9054390753;Ne;2;4;0;6
23359;"Vilniaus Šilo mokykla";"7 lav.";29353956408;Ne;4;4;0;8
23360;"Vilniaus Šilo mokykla";"7 lav.";83007167743;Ne;0;4;0;4
23361;"Vilniaus Šilo mokykla";"7 lav.";2862598950;Ne;1;4;0;5
23362;"Vilniaus Šilo mokykla";"7 lav.";67989956617;Ne;0;19;0;19
23363;"Vilniaus Šilo mokykla";"7 lav.";49892720109;Ne;1;4;0;5
23364;"Vilniaus Šilo mokykla";"7 lav.";7418552136;Ne;0;4;0;4
23365;"Vilniaus Šilo mokykla";"7-8 lav.";4081645294;Ne;8;4;0;12
23366;"Vilniaus Šilo mokykla";"7-8 lav.";1705610089;Ne;0;19;0;19
23367;"Vilniaus Šilo mokykla";"7-8 lav.";62142659591;Ne;0;4;0;4
23368;"Vilniaus Šilo mokykla";"7-8 lav.";8566222716;Ne;0;4;0;4
23369;"Vilniaus Šilo mokykla";"7-8 lav.";7056277395;Ne;0;19;0;19
23370;"Vilniaus Šilo mokykla";"7-8 lav.";74897451962;Ne;0;4;0;4
23371;"Vilniaus Šilo mokykla";"7-8 lav.";6700004229;Ne;1;4;0;5
23372;"Vilniaus Šilo mokykla";"7-8 lav.";50288610995;Ne;5;4;0;9
23373;"Vilniaus Šilo mokykla";"7-8 lav.";4416954354;Ne;3;4;0;7
23374;"Vilniaus Šilo mokykla";"6-9 spec.";4887033681;Ne;1;4;0;5
23375;"Vilniaus Šilo mokykla";"6-9 spec.";61123788986;Ne;0;19;0;19
23376;"Vilniaus Šilo mokykla";"6-9 spec.";2631958308;Ne;3;4;0;7
23377;"Vilniaus Šilo mokykla";"6-9 spec.";73335629450;Ne;1;4;0;5
23378;"Vilniaus Šilo mokykla";"6-9 spec.";6695507703;Ne;1;4;0;5
23379;"Vilniaus Šilo mokykla";"6-9 spec.";94126055953;Ne;1;4;0;5
23380;"Vilniaus Šilo mokykla";"6-9 spec.";6930420609;Ne;4;4;0;8
23381;"Vilniaus Šilo mokykla";"5-10 lav.";6356218442;Ne;0;4;0;4
23382;"Vilniaus Šilo mokykla";"5-10 lav.";88721781220;Ne;15;4;0;19
23383;"Vilniaus Šilo mokykla";"5-10 lav.";4990112920;Ne;0;4;0;4
23384;"Vilniaus Šilo mokykla";"5-10 lav.";9057435844;Ne;0;4;0;4
23385;"Vilniaus Šilo mokykla";"5-10 lav.";7354905114;Ne;2;4;0;6
23386;"Vilniaus Šilo mokykla";"5-10 lav.";4890362155;Ne;0;4;0;4
23387;"Vilniaus Šilo mokykla";"5-10 lav.";2000234311;Ne;1;4;0;5
23388;"Vilniaus Šilo mokykla";"5-10 lav.";63508565206;Ne;0;4;0;4
23389;"Vilniaus Šilo mokykla";"5-6 spec. RU";3419495275;Ne;1;4;0;5
23390;"Vilniaus Šilo mokykla";"5-6 spec. RU";9789373884;Ne;0;19;0;19
23391;"Vilniaus Šilo mokykla";"5-6 spec. RU";1989565075;Ne;0;19;0;19
23392;"Vilniaus Šilo mokykla";"5-6 spec. RU";11529512484;Ne;4;4;0;8
23393;"Vilniaus Šilo mokykla";"5-6 spec. RU";13277011762;Ne;0;4;0;4
23394;"Vilniaus Šilo mokykla";"5-6 spec. RU";34463714051;Ne;3;4;0;7
23395;"Vilniaus Šilo mokykla";"5-6 lav.";7329254454;Ne;0;19;0;19
23396;"Vilniaus Šilo mokykla";"5-6 lav.";1535004699;Ne;11;4;0;15
23397;"Vilniaus Šilo mokykla";"5-6 lav.";3194974747;Ne;3;4;0;7
23398;"Vilniaus Šilo mokykla";"5-6 lav.";26052502707;Ne;6;4;0;10
23399;"Vilniaus Šilo mokykla";"5-6 lav.";74782962545;Ne;0;19;0;19
23400;"Vilniaus Šilo mokykla";"5-6 lav.";72751441075;Ne;9;4;0;13
23401;"Vilniaus Šilo mokykla";"5-6 lav.";87692349348;Ne;0;19;0;19
23402;"Vilniaus Šilo mokykla";"3-4 spec. LT";5835827997;Ne;0;19;0;19
23403;"Vilniaus Šilo mokykla";"3-4 spec. LT";17920063762;Ne;0;4;0;4
23404;"Vilniaus Šilo mokykla";"3-4 spec. LT";7418149721;Ne;0;4;0;4
23405;"Vilniaus Šilo mokykla";"3-4 spec. LT";7418149721;Ne;0;4;0;4
23406;"Vilniaus Šilo mokykla";"3-4 spec. LT";19739614989;Ne;5;4;0;9
23407;"Vilniaus Šilo mokykla";"3-4 spec. LT";3366848846;Ne;8;4;0;12
23408;"Vilniaus Šilo mokykla";"3-4 spec. LT";78634860827;Ne;0;4;0;4
23409;"Vilniaus Šilo mokykla";"3-4 spec. LT";67103811533;Ne;3;4;0;7
23410;"Vilniaus Šilo mokykla";"3-4 spec. LT";30738331224;Ne;0;4;0;4
23411;"Vilniaus Šilo mokykla";"1 spec. B";3237698420;Ne;15;4;0;19
23412;"Vilniaus Šilo mokykla";"1 spec. B";1657452686;Ne;1;4;0;5
23413;"Vilniaus Šilo mokykla";"1 spec. B";3055294324;Ne;0;4;0;4
23414;"Vilniaus Šilo mokykla";"1 spec. B";9072764004;Ne;0;4;0;4
23415;"Vilniaus Šilo mokykla";"1 spec. B";1739403100;Ne;0;19;0;19
23416;"Vilniaus Šilo mokykla";"1 spec. B";8500010303;Ne;0;19;0;19
23417;"Vilniaus Šilo mokykla";"1 spec. B";60265156684;Ne;8;4;0;12
23418;"Vilniaus Šilo mokykla";"2-4 spec. RU";4908579339;Ne;1;4;0;5
23419;"Vilniaus Šilo mokykla";"2-4 spec. RU";2401287472;Ne;8;4;0;12
23420;"Vilniaus Šilo mokykla";"2-4 spec. RU";8817950372;Ne;1;4;0;5
23421;"Vilniaus Šilo mokykla";"2-4 spec. RU";8817950372;Ne;1;4;0;5
23422;"Vilniaus Šilo mokykla";"2-4 spec. RU";70678189213;Ne;0;4;0;4
23423;"Vilniaus Šilo mokykla";"2-4 spec. RU";4078721064;Ne;0;4;0;4
23424;"Vilniaus Šilo mokykla";"2-4 spec. RU";4574965127;Ne;1;4;0;5
23425;"Vilniaus Šilo mokykla";"2-4 spec. RU";6813357731;Ne;0;4;0;4
23426;"Vilniaus Šilo mokykla";"2 spec.";1153167430;Ne;12;4;0;16
23427;"Vilniaus Šilo mokykla";"2 spec.";4438939800;Ne;1;4;0;5
23428;"Vilniaus Šilo mokykla";"2 spec.";1971717759;Ne;0;4;0;4
23429;"Vilniaus Šilo mokykla";"2 spec.";2290889395;Ne;0;4;0;4
23430;"Vilniaus Šilo mokykla";"2 spec.";1180183091;Ne;0;19;0;19
23431;"Vilniaus Šilo mokykla";"2 spec.";8863021708;Ne;1;4;0;5
23432;"Vilniaus Šilo mokykla";"3-4 lav. ";3127870635;Ne;7;4;0;11
23433;"Vilniaus Šilo mokykla";"3-4 lav. ";1505697405;Ne;0;4;0;4
23434;"Vilniaus Šilo mokykla";"3-4 lav. ";1999375828;Ne;0;19;0;19
23435;"Vilniaus Šilo mokykla";"3-4 lav. ";3748420427;Ne;12;4;0;16
23436;"Vilniaus Šilo mokykla";"3-4 lav. ";2954393415;Ne;0;4;0;4
23437;"Vilniaus Šilo mokykla";"1 spec. A";5311183877;Ne;14;4;0;18
23438;"Vilniaus Šilo mokykla";"1 spec. A";1675384533;Ne;4;4;0;8
23439;"Vilniaus Šilo mokykla";"1 spec. A";2070454339;Ne;0;19;0;19
23440;"Vilniaus Šilo mokykla";"1 spec. A";8915901727;Ne;1;4;0;5
23441;"Vilniaus Šilo mokykla";"1 spec. A";7966574791;Ne;15;4;0;19
23442;"Vilniaus Šilo mokykla";"1 spec. A";2048595572;Ne;1;4;0;5
23443;"Vilniaus Šilo mokykla";"1 spec. A";30383556768;Ne;0;19;0;19
23444;"Vilniaus Šilo mokykla";"5-6 spec. ";90363704660;Ne;6;4;0;10
23445;"Vilniaus Šilo mokykla";"5-6 spec. ";3120638166;Ne;0;4;0;4
23446;"Vilniaus Šilo mokykla";"5-6 spec. ";1079077463;Ne;1;4;0;5
23447;"Vilniaus Šilo mokykla";"5-6 spec. ";2321953405;Ne;5;4;0;9
23448;"Vilniaus Šilo mokykla";"5-6 spec. ";2093680385;Ne;1;4;0;5
23449;"Vilniaus Šilo mokykla";"5-6 spec. ";3352991548;Ne;2;4;0;6
23450;"Vilniaus Šilo mokykla";"5-6 spec. ";1340301492;Ne;5;4;0;9
23451;"Vilniaus Šilo mokykla";"5-6 spec. ";987829287;Ne;0;4;0;4
23452;"Vilniaus Šilo mokykla";"5-6 spec. ";99943424821;Ne;0;4;0;4
23453;Malūnėlis;BITUTĖS;1001575740;Ne;0;3;0;3
23454;Malūnėlis;BITUTĖS;8618778205;Ne;0;6;0;6
23455;Malūnėlis;BITUTĖS;2545930114;Ne;0;5;0;5
23456;Malūnėlis;BITUTĖS;3329510128;Ne;9;4;0;13
23457;Malūnėlis;BITUTĖS;5402027714;Ne;0;6;0;6
23458;Malūnėlis;BITUTĖS;6199265600;Ne;5;3;0;8
23459;Malūnėlis;BITUTĖS;7144098762;Ne;10;8;0;18
23460;Malūnėlis;BITUTĖS;1146723570;Ne;0;1;1;2
23461;Malūnėlis;BITUTĖS;9891418762;Ne;0;11;0;11
23462;Malūnėlis;BITUTĖS;8642960989;Ne;0;4;0;4
23463;Malūnėlis;BITUTĖS;5959610426;Taip;0;5;0;5
23464;Malūnėlis;BITUTĖS;4367009696;Ne;0;5;0;5
23465;Malūnėlis;BITUTĖS;9936144392;Ne;0;5;0;5
23466;Malūnėlis;BITUTĖS;8643210289;Ne;0;2;0;2
23467;Malūnėlis;BITUTĖS;8440160819;Ne;0;9;0;9
23468;Malūnėlis;BITUTĖS;1528972517;Ne;0;13;0;13
23469;Malūnėlis;BITUTĖS;4202723476;Ne;19;0;0;19
23470;Malūnėlis;BITUTĖS;8007350745;Ne;2;6;0;8
23471;Malūnėlis;BITUTĖS;3402561453;Ne;3;8;0;11
23472;Malūnėlis;BITUTĖS;6805587761;Ne;15;0;0;15
23473;Malūnėlis;BITUTĖS;2495112045;Ne;0;5;2;7
23474;Malūnėlis;BITUTĖS;4802771311;Ne;0;4;0;4
23475;Malūnėlis;BITUTĖS;3935474148;Ne;0;5;0;5
23476;Malūnėlis;BITUTĖS;8528076375;Ne;0;12;0;12
23477;Malūnėlis;VOVERIUKAI;3293082023;Ne;7;1;0;8
23478;Malūnėlis;VOVERIUKAI;3779723692;Ne;0;6;0;6
23479;Malūnėlis;VOVERIUKAI;9592117637;Ne;0;1;0;1
23480;Malūnėlis;VOVERIUKAI;2029506037;Ne;4;0;0;4
23481;Malūnėlis;VOVERIUKAI;2246526281;Ne;3;0;0;3
23482;Malūnėlis;VOVERIUKAI;2192305527;Ne;14;0;0;14
23483;Malūnėlis;VOVERIUKAI;3371260811;Ne;4;0;0;4
23484;Malūnėlis;VOVERIUKAI;5061720786;Ne;9;0;0;9
23485;Malūnėlis;VOVERIUKAI;1770049356;Ne;9;4;0;13
23486;Malūnėlis;VOVERIUKAI;6081634102;Ne;6;5;0;11
23487;Malūnėlis;VOVERIUKAI;5540120728;Ne;13;4;0;17
23488;Malūnėlis;VOVERIUKAI;7556990784;Ne;4;0;0;4
23489;Malūnėlis;VOVERIUKAI;2525923211;Ne;5;4;0;9
23490;Malūnėlis;VOVERIUKAI;9304119075;Ne;2;0;0;2
23491;Malūnėlis;VOVERIUKAI;1574941416;Ne;4;0;0;4
23492;Malūnėlis;VOVERIUKAI;6531364407;Ne;2;1;0;3
23493;Malūnėlis;VOVERIUKAI;5727725132;Ne;11;4;0;15
23494;Malūnėlis;VOVERIUKAI;2637299307;Ne;13;0;0;13
23495;Malūnėlis;VOVERIUKAI;8277245773;Ne;0;1;0;1
23496;Malūnėlis;VOVERIUKAI;5686301875;Ne;4;1;0;5
23497;Malūnėlis;BORUŽĖLĖS;8551271848;Ne;0;4;1;5
23498;Malūnėlis;BORUŽĖLĖS;4787212056;Ne;0;4;0;4
23499;Malūnėlis;BORUŽĖLĖS;9185138453;Ne;7;9;0;16
23500;Malūnėlis;BORUŽĖLĖS;7350160970;Ne;5;5;0;10
23501;Malūnėlis;BORUŽĖLĖS;5722497620;Ne;4;5;0;9
23502;Malūnėlis;BORUŽĖLĖS;3364355098;Ne;4;4;0;8
23503;Malūnėlis;BORUŽĖLĖS;9539119799;Taip;8;0;0;8
23504;Malūnėlis;BORUŽĖLĖS;1523505295;Ne;8;4;0;12
23505;Malūnėlis;BORUŽĖLĖS;7756102926;Ne;8;4;0;12
23506;Malūnėlis;BORUŽĖLĖS;4164843364;Ne;0;3;0;3
23507;Malūnėlis;BORUŽĖLĖS;3504339452;Ne;0;7;0;7
23508;Malūnėlis;BORUŽĖLĖS;5197527972;Ne;5;4;0;9
23509;Malūnėlis;BORUŽĖLĖS;4288943715;Ne;13;4;0;17
23510;Malūnėlis;Skruzdėliukų;9798968369;Ne;11;0;0;11
23511;Malūnėlis;Skruzdėliukų;4859886340;Ne;13;0;0;13
23512;Malūnėlis;Skruzdėliukų;1213476648;Ne;3;0;0;3
23513;Malūnėlis;Skruzdėliukų;9300944734;Ne;19;0;0;19
23514;Malūnėlis;Skruzdėliukų;5877882690;Ne;4;0;0;4
23515;Malūnėlis;Skruzdėliukų;5474437579;Ne;5;0;0;5
23516;Malūnėlis;Skruzdėliukų;1549241453;Ne;16;0;0;16
23517;Malūnėlis;Skruzdėliukų;5478561852;Ne;7;0;0;7
23518;Malūnėlis;Skruzdėliukų;9207327884;Ne;19;0;0;19
23519;Malūnėlis;Skruzdėliukų;6609446450;Ne;4;0;0;4
23520;Malūnėlis;Skruzdėliukų;5687585794;Ne;9;0;0;9
23521;Malūnėlis;Skruzdėliukų;8076487157;Ne;12;0;0;12
23522;Malūnėlis;Skruzdėliukų;8751365673;Ne;8;0;0;8
23523;Malūnėlis;Skruzdėliukų;4307232411;Ne;2;0;0;2
23524;Malūnėlis;Skruzdėliukų;6575258889;Taip;10;0;0;10
23525;Malūnėlis;Skruzdėliukų;1003043129;Taip;9;0;0;9
23526;Malūnėlis;Skruzdėliukų;7983537913;Ne;10;0;0;10
23527;Malūnėlis;Skruzdėliukų;9894452403;Ne;3;5;0;8
23528;Malūnėlis;Skruzdėliukų;9342720464;Ne;0;8;0;8
23529;Malūnėlis;Skruzdėliukų;5232728972;Ne;6;0;0;6
23530;Malūnėlis;Skruzdėliukų;2574604828;Ne;0;5;0;5
23531;Malūnėlis;Skruzdėliukų;5909022614;Taip;3;0;0;3
23532;Malūnėlis;Žirniukų;3791873303;Ne;7;5;0;12
23533;Malūnėlis;Žirniukų;3031849277;Ne;13;0;0;13
23534;Malūnėlis;Žirniukų;6747286787;Ne;0;2;0;2
23535;Malūnėlis;Žirniukų;4539998453;Ne;6;3;0;9
23536;Malūnėlis;Žirniukų;6943968536;Ne;2;0;0;2
23537;Malūnėlis;Žirniukų;4841028952;Ne;10;9;0;19
23538;Malūnėlis;Žirniukų;7097858329;Ne;2;2;0;4
23539;Malūnėlis;Žirniukų;5893575540;Ne;13;4;0;17
23540;Malūnėlis;Žirniukų;1398391534;Ne;4;2;0;6
23541;Malūnėlis;Žirniukų;2961972215;Ne;11;0;0;11
23542;Malūnėlis;Žirniukų;5622982984;Ne;0;1;0;1
23543;Malūnėlis;Žirniukų;3315571256;Ne;5;3;0;8
23544;Malūnėlis;Žirniukų;3315571256;Ne;5;3;0;8
23545;Malūnėlis;Žirniukų;3315571256;Ne;5;3;0;8
23546;Malūnėlis;Žirniukų;9941335615;Ne;14;3;0;17
23547;Malūnėlis;Žirniukų;3464224841;Ne;5;1;0;6
23548;Malūnėlis;Žirniukų;6047042736;Ne;14;3;0;17
23549;Malūnėlis;Žirniukų;4875859413;Ne;4;3;0;7
23550;Malūnėlis;Žirniukų;6647872886;Taip;1;2;0;3
23551;Malūnėlis;Žirniukų;9559372808;Ne;11;3;0;14
23552;Malūnėlis;Žirniukų;1407908511;Ne;9;0;0;9
23553;Malūnėlis;Žirniukų;7740957549;Taip;2;4;0;6
23554;"Dainorėliai (Goštauto g. 4)";PUMPURĖLIAI;6132543858;Ne;0;24;0;24
23555;"Dainorėliai (Goštauto g. 4)";PUMPURĖLIAI;4560328911;Ne;2;6;0;8
23556;"Dainorėliai (Goštauto g. 4)";PUMPURĖLIAI;4435310580;Ne;2;7;0;9
23557;"Dainorėliai (Goštauto g. 4)";PUMPURĖLIAI;7197089520;Ne;2;10;0;12
23558;"Dainorėliai (Goštauto g. 4)";PUMPURĖLIAI;5534783929;Ne;0;9;0;9
23559;"Dainorėliai (Goštauto g. 4)";PUMPURĖLIAI;4826994208;Ne;4;3;0;7
23560;"Dainorėliai (Goštauto g. 4)";PUMPURĖLIAI;4848146301;Ne;0;3;0;3
23561;"Dainorėliai (Goštauto g. 4)";PUMPURĖLIAI;1796037404;Ne;0;4;0;4
23562;"Dainorėliai (Goštauto g. 4)";PUMPURĖLIAI;1030872812;Ne;6;7;0;13
23563;"Dainorėliai (Goštauto g. 4)";PUMPURĖLIAI;7986631005;Ne;4;8;0;12
23564;"Dainorėliai (Goštauto g. 4)";PUMPURĖLIAI;8664502412;Ne;2;0;0;2
23565;"Dainorėliai (Goštauto g. 4)";PUMPURĖLIAI;7802165127;Ne;0;7;0;7
23566;"Dainorėliai (Goštauto g. 4)";PUMPURĖLIAI;7961803424;Ne;4;1;0;5
23567;"Dainorėliai (Goštauto g. 4)";PUMPURĖLIAI;6203352124;Ne;4;6;0;10
23568;"Dainorėliai (Goštauto g. 4)";PUMPURĖLIAI;6254125398;Ne;5;3;0;8
23569;"Dainorėliai (Goštauto g. 4)";PUMPURĖLIAI;8097565000;Ne;8;5;0;13
23570;"Dainorėliai (Goštauto g. 4)";DEBESĖLIŲ;6513417505;Ne;2;6;0;8
23571;"Dainorėliai (Goštauto g. 4)";DEBESĖLIŲ;1873415679;Ne;0;3;0;3
23572;"Dainorėliai (Goštauto g. 4)";DEBESĖLIŲ;4286864865;Ne;0;1;0;1
23573;"Dainorėliai (Goštauto g. 4)";DEBESĖLIŲ;1554081754;Ne;2;3;0;5
23574;"Dainorėliai (Goštauto g. 4)";DEBESĖLIŲ;4033317616;Ne;0;5;0;5
23575;"Dainorėliai (Goštauto g. 4)";DEBESĖLIŲ;9285865812;Ne;0;3;0;3
23576;"Dainorėliai (Goštauto g. 4)";DEBESĖLIŲ;6284140548;Ne;0;10;0;10
23577;"Dainorėliai (Goštauto g. 4)";DEBESĖLIŲ;8015545426;Ne;0;3;0;3
23578;"Dainorėliai (Goštauto g. 4)";DEBESĖLIŲ;5691833295;Ne;0;13;0;13
23579;"Dainorėliai (Goštauto g. 4)";DEBESĖLIŲ;6362265057;Ne;0;3;0;3
23580;"Dainorėliai (Goštauto g. 4)";DEBESĖLIŲ;3561729784;Ne;0;4;1;5
23581;"Dainorėliai (Goštauto g. 4)";DEBESĖLIŲ;3705286231;Ne;0;3;0;3
23582;"Dainorėliai (Goštauto g. 4)";DEBESĖLIŲ;4302308605;Ne;0;5;0;5
23583;"Dainorėliai (Goštauto g. 4)";DEBESĖLIŲ;5714565603;Ne;0;5;0;5
23584;"Dainorėliai (Goštauto g. 4)";DEBESĖLIŲ;1233029451;Ne;0;18;0;18
23585;"Dainorėliai (Goštauto g. 4)";DEBESĖLIŲ;6449332338;Ne;0;7;0;7
23586;"Krivūlė (Vokiečių g. 1)";PABIRUČIAI;9011102232;Ne;0;10;3;13
23587;"Krivūlė (Vokiečių g. 1)";PABIRUČIAI;1944288576;Ne;0;1;1;2
23588;"Krivūlė (Vokiečių g. 1)";PABIRUČIAI;3696403149;Ne;5;3;0;8
23589;"Krivūlė (Vokiečių g. 1)";PABIRUČIAI;5721252419;Ne;0;8;3;11
23590;"Krivūlė (Vokiečių g. 1)";PABIRUČIAI;4600688626;Ne;11;0;0;11
23591;"Krivūlė (Vokiečių g. 1)";PABIRUČIAI;4608957977;Ne;0;0;3;3
23592;"Krivūlė (Vokiečių g. 1)";PABIRUČIAI;4884789671;Ne;0;0;12;12
23593;"Krivūlė (Vokiečių g. 1)";PABIRUČIAI;8678565710;Ne;19;0;0;19
23594;"Krivūlė (Vokiečių g. 1)";PABIRUČIAI;3976974038;Ne;3;0;4;7
23595;"Krivūlė (Vokiečių g. 1)";PABIRUČIAI;2259139771;Ne;0;0;7;7
23596;"Krivūlė (Vokiečių g. 1)";PABIRUČIAI;3138555448;Ne;7;12;0;19
23597;"Krivūlė (Vokiečių g. 1)";PABIRUČIAI;2784118970;Ne;0;0;1;1
23598;"Krivūlė (Vokiečių g. 1)";PABIRUČIAI;3227555647;Ne;0;0;13;13
23599;"Krivūlė (Vokiečių g. 1)";PABIRUČIAI;4261770381;Ne;5;0;1;6
23600;"Krivūlė (Vokiečių g. 1)";PABIRUČIAI;6632875947;Ne;0;3;0;3
23601;"Krivūlė (Vokiečių g. 1)";PABIRUČIAI;7556723960;Ne;10;0;0;10
23602;"Krivūlė (Vokiečių g. 1)";PABIRUČIAI;6422534805;Ne;7;4;0;11
23603;"Krivūlė (Vokiečių g. 1)";PABIRUČIAI;3209201717;Ne;0;0;5;5
23604;"Krivūlė (Vokiečių g. 1)";SMALSUČIAI;5304221329;Ne;0;4;2;6
23605;"Krivūlė (Vokiečių g. 1)";SMALSUČIAI;7508079584;Ne;0;0;4;4
23606;"Krivūlė (Vokiečių g. 1)";SMALSUČIAI;4814488445;Ne;0;2;0;2
23607;"Krivūlė (Vokiečių g. 1)";SMALSUČIAI;7997564406;Ne;0;4;0;4
23608;"Krivūlė (Vokiečių g. 1)";SMALSUČIAI;8710938907;Ne;10;4;0;14
23609;"Krivūlė (Vokiečių g. 1)";SMALSUČIAI;4491462086;Taip;5;0;3;8
23610;"Krivūlė (Vokiečių g. 1)";SMALSUČIAI;4773564048;Ne;0;4;0;4
23611;"Krivūlė (Vokiečių g. 1)";SMALSUČIAI;3324090723;Ne;0;0;4;4
23612;"Krivūlė (Vokiečių g. 1)";SMALSUČIAI;4094383258;Ne;0;0;9;9
23613;"Krivūlė (Vokiečių g. 1)";SMALSUČIAI;8042469720;Ne;0;5;0;5
23614;"Krivūlė (Vokiečių g. 1)";SMALSUČIAI;4845066055;Ne;0;4;15;19
23615;"Krivūlė (Vokiečių g. 1)";SMALSUČIAI;9328365491;Ne;11;0;4;15
23616;"Krivūlė (Vokiečių g. 1)";SMALSUČIAI;7528273082;Ne;0;1;2;3
23617;"Krivūlė (Vokiečių g. 1)";SMALSUČIAI;6521798502;Ne;0;0;1;1
23618;"Krivūlė (Vokiečių g. 1)";SMALSUČIAI;5790418638;Ne;0;0;3;3
23619;"Krivūlė (Vokiečių g. 1)";SMALSUČIAI;9625239512;Ne;0;0;7;7
23620;"Krivūlė (Vokiečių g. 1)";GUDRUČIAI;4681543921;Ne;0;0;6;6
23621;"Krivūlė (Vokiečių g. 1)";GUDRUČIAI;8520470321;Ne;0;10;4;14
23622;"Krivūlė (Vokiečių g. 1)";GUDRUČIAI;5753204752;Ne;0;0;1;1
23623;"Krivūlė (Vokiečių g. 1)";GUDRUČIAI;2659604299;Ne;0;0;4;4
23624;"Krivūlė (Vokiečių g. 1)";GUDRUČIAI;2536472220;Ne;0;3;0;3
23625;"Krivūlė (Vokiečių g. 1)";GUDRUČIAI;7727246187;Ne;0;4;0;4
23626;"Krivūlė (Vokiečių g. 1)";GUDRUČIAI;6072261879;Ne;6;0;2;8
23627;"Krivūlė (Vokiečių g. 1)";GUDRUČIAI;7904390075;Ne;0;4;0;4
23628;"Krivūlė (Vokiečių g. 1)";GUDRUČIAI;6931566125;Ne;0;0;4;4
23629;"Krivūlė (Vokiečių g. 1)";GUDRUČIAI;5149419581;Ne;0;0;2;2
23630;"Krivūlė (Vokiečių g. 1)";GUDRUČIAI;7789605738;Ne;0;4;3;7
23631;"Krivūlė (Vokiečių g. 1)";GUDRUČIAI;5097101097;Ne;0;1;0;1
23632;"Krivūlė (Vokiečių g. 1)";GUDRUČIAI;9693693101;Ne;10;0;1;11
23633;"Krivūlė (Vokiečių g. 1)";GUDRUČIAI;5462491857;Ne;0;7;2;9
23634;"Krivūlė (Vokiečių g. 1)";GUDRUČIAI;8871794542;Ne;6;4;0;10
23635;"Krivūlė (Vokiečių g. 1)";GUDRUČIAI;3076382863;Ne;0;4;0;4
23636;"Krivūlė (Vokiečių g. 1)";GUDRUČIAI;5199600243;Ne;0;4;9;13
23637;"Pumpurėlis (Trinapolio g. 11)";GUDRUČIAI;9353403057;Ne;1;2;0;3
23638;"Pumpurėlis (Trinapolio g. 11)";GUDRUČIAI;9353403057;Ne;1;2;0;3
23639;"Pumpurėlis (Trinapolio g. 11)";GUDRUČIAI;5187890514;Ne;0;0;5;5
23640;"Pumpurėlis (Trinapolio g. 11)";GUDRUČIAI;3387386473;Ne;2;4;0;6
23641;"Pumpurėlis (Trinapolio g. 11)";GUDRUČIAI;7177681927;Ne;2;0;0;2
23642;"Pumpurėlis (Trinapolio g. 11)";GUDRUČIAI;2130008026;Ne;0;0;7;7
23643;"Pumpurėlis (Trinapolio g. 11)";GUDRUČIAI;8475215020;Ne;0;0;8;8
23644;"Pumpurėlis (Trinapolio g. 11)";GUDRUČIAI;3333547914;Taip;9;4;1;14
23645;"Pumpurėlis (Trinapolio g. 11)";GUDRUČIAI;9550967420;Ne;7;9;3;19
23646;"Pumpurėlis (Trinapolio g. 11)";GUDRUČIAI;1750311606;Ne;7;0;3;10
23647;"Pumpurėlis (Trinapolio g. 11)";GUDRUČIAI;8134060801;Ne;0;19;0;19
23648;"Pumpurėlis (Trinapolio g. 11)";GUDRUČIAI;1682281017;Ne;0;0;4;4
23649;"Pumpurėlis (Trinapolio g. 11)";GUDRUČIAI;9154835447;Ne;5;0;5;10
23650;"Pumpurėlis (Trinapolio g. 11)";GUDRUČIAI;3546444707;Ne;3;0;1;4
23651;"Pumpurėlis (Trinapolio g. 11)";GUDRUČIAI;2071687578;Ne;0;0;2;2
23652;"Pumpurėlis (Trinapolio g. 11)";GUDRUČIAI;8090926450;Ne;0;6;0;6
23653;"Pumpurėlis (Trinapolio g. 11)";GUDRUČIAI;6459621192;Ne;0;4;3;7
23654;"Pumpurėlis (Trinapolio g. 11)";GUDRUČIAI;6766514486;Ne;2;0;5;7
23655;"Pumpurėlis (Trinapolio g. 11)";PABIRUČIAI;9824315755;Ne;4;5;0;9
23656;"Pumpurėlis (Trinapolio g. 11)";PABIRUČIAI;4565317498;Ne;10;0;0;10
23657;"Pumpurėlis (Trinapolio g. 11)";PABIRUČIAI;7910361194;Ne;11;7;0;18
23658;"Pumpurėlis (Trinapolio g. 11)";PABIRUČIAI;5249717804;Ne;12;0;0;12
23659;"Pumpurėlis (Trinapolio g. 11)";PABIRUČIAI;5403012236;Ne;9;0;0;9
23660;"Pumpurėlis (Trinapolio g. 11)";PABIRUČIAI;4955734206;Ne;6;0;0;6
23661;"Pumpurėlis (Trinapolio g. 11)";PABIRUČIAI;8704865319;Ne;0;11;0;11
23662;"Pumpurėlis (Trinapolio g. 11)";PABIRUČIAI;8207951541;Ne;0;4;0;4
23663;"Pumpurėlis (Trinapolio g. 11)";PABIRUČIAI;4696006714;Taip;14;0;0;14
23664;"Pumpurėlis (Trinapolio g. 11)";PABIRUČIAI;9597889927;Ne;0;2;0;2
23665;"Pumpurėlis (Trinapolio g. 11)";PABIRUČIAI;2187090934;Ne;5;0;2;7
23666;"Pumpurėlis (Trinapolio g. 11)";PABIRUČIAI;1222204689;Ne;2;0;1;3
23667;"Pumpurėlis (Trinapolio g. 11)";PABIRUČIAI;6920353753;Ne;10;2;0;12
23668;"Pumpurėlis (Trinapolio g. 11)";PABIRUČIAI;6920353753;Ne;10;2;0;12
23669;"Pumpurėlis (Trinapolio g. 11)";PABIRUČIAI;3841134563;Ne;12;0;0;12
23670;"Pumpurėlis (Trinapolio g. 11)";PABIRUČIAI;3841134563;Ne;12;0;0;12
23671;"Pumpurėlis (Trinapolio g. 11)";PABIRUČIAI;3841134563;Ne;12;0;0;12
23672;"Pumpurėlis (Trinapolio g. 11)";PABIRUČIAI;6732130591;Ne;7;1;0;8
23673;"Pumpurėlis (Trinapolio g. 11)";PABIRUČIAI;7145050820;Ne;7;0;0;7
23674;"Pumpurėlis (Trinapolio g. 11)";PABIRUČIAI;3464806589;Ne;7;0;5;12
23675;"Pumpurėlis (Trinapolio g. 11)";PABIRUČIAI;9012133443;Ne;5;4;0;9
23676;"Pumpurėlis (Trinapolio g. 11)";PABIRUČIAI;5703275497;Ne;8;5;0;13
23677;"Pumpurėlis (Trinapolio g. 11)";PABIRUČIAI;7199184901;Ne;0;3;2;5
23678;"Gilužis (Įsruties g. 30)";AITVARIUKŲ;3612834040;Ne;10;0;3;13
23679;"Gilužis (Įsruties g. 30)";AITVARIUKŲ;6279641042;Ne;0;3;1;4
23680;"Gilužis (Įsruties g. 30)";AITVARIUKŲ;2971604057;Ne;2;2;0;4
23681;"Gilužis (Įsruties g. 30)";AITVARIUKŲ;6430615720;Ne;16;0;0;16
23682;"Gilužis (Įsruties g. 30)";AITVARIUKŲ;4351997862;Ne;19;0;0;19
23683;"Gilužis (Įsruties g. 30)";AITVARIUKŲ;2094662680;Ne;17;0;0;17
23684;"Gilužis (Įsruties g. 30)";AITVARIUKŲ;6020457766;Ne;0;5;1;6
23685;"Gilužis (Įsruties g. 30)";AITVARIUKŲ;1766021430;Ne;12;0;1;13
23686;"Gilužis (Įsruties g. 30)";AITVARIUKŲ;2401999477;Ne;11;0;0;11
23687;"Gilužis (Įsruties g. 30)";AITVARIUKŲ;8268273217;Ne;4;0;4;8
23688;"Gilužis (Įsruties g. 30)";AITVARIUKŲ;8412189871;Ne;0;4;1;5
23689;"Gilužis (Įsruties g. 30)";AITVARIUKŲ;9434214933;Taip;11;0;0;11
23690;"Gilužis (Įsruties g. 30)";AITVARIUKŲ;4731369089;Ne;10;0;1;11
23691;"Gilužis (Įsruties g. 30)";AITVARIUKŲ;2614683353;Ne;12;3;0;15
23692;"Gilužis (Įsruties g. 30)";AITVARIUKŲ;2657805562;Ne;15;0;0;15
23693;"Gilužis (Įsruties g. 30)";AITVARIUKŲ;6713383000;Ne;12;0;0;12
23694;"Gilužis (Įsruties g. 30)";SPINDULIUKŲ;8951766269;Ne;7;0;4;11
23695;"Gilužis (Įsruties g. 30)";SPINDULIUKŲ;8712363813;Ne;13;0;0;13
23696;"Gilužis (Įsruties g. 30)";SPINDULIUKŲ;8499650174;Ne;1;0;5;6
23697;"Gilužis (Įsruties g. 30)";SPINDULIUKŲ;4939683067;Ne;14;0;0;14
23698;"Gilužis (Įsruties g. 30)";SPINDULIUKŲ;4483309790;Ne;7;0;0;7
23699;"Gilužis (Įsruties g. 30)";SPINDULIUKŲ;7513403761;Ne;8;4;0;12
23700;"Gilužis (Įsruties g. 30)";SPINDULIUKŲ;8587454386;Ne;0;4;0;4
23701;"Gilužis (Įsruties g. 30)";SPINDULIUKŲ;6582408024;Ne;5;0;1;6
23702;"Gilužis (Įsruties g. 30)";SPINDULIUKŲ;7606952525;Ne;2;0;0;2
23703;"Gilužis (Įsruties g. 30)";SPINDULIUKŲ;8238801880;Ne;19;0;0;19
23704;"Gilužis (Įsruties g. 30)";SPINDULIUKŲ;7924726810;Ne;3;0;1;4
23705;"Gilužis (Įsruties g. 30)";SPINDULIUKŲ;5971465705;Ne;14;0;0;14
23706;"Gilužis (Įsruties g. 30)";SPINDULIUKŲ;9352644751;Ne;8;4;0;12
23707;"Gilužis (Įsruties g. 30)";SPINDULIUKŲ;9689776829;Ne;7;3;2;12
23708;"Gilužis (Įsruties g. 30)";SPINDULIUKŲ;9807489364;Ne;5;0;3;8
23709;"Gilužis (Įsruties g. 30)";ŽIRNIUKŲ;1660797528;Ne;7;1;3;11
23710;"Gilužis (Įsruties g. 30)";ŽIRNIUKŲ;1584356386;Ne;17;0;0;17
23711;"Gilužis (Įsruties g. 30)";ŽIRNIUKŲ;3355341868;Ne;17;0;0;17
23712;"Gilužis (Įsruties g. 30)";ŽIRNIUKŲ;1710906417;Ne;7;0;4;11
23713;"Gilužis (Įsruties g. 30)";ŽIRNIUKŲ;2831924292;Ne;12;0;1;13
23714;"Gilužis (Įsruties g. 30)";ŽIRNIUKŲ;5229186298;Ne;8;0;1;9
23715;"Gilužis (Įsruties g. 30)";ŽIRNIUKŲ;3250662431;Ne;0;0;7;7
23716;"Gilužis (Įsruties g. 30)";ŽIRNIUKŲ;8078194153;Ne;0;0;3;3
23717;"Gilužis (Įsruties g. 30)";ŽIRNIUKŲ;3224917490;Ne;6;0;0;6
23718;"Gilužis (Įsruties g. 30)";ŽIRNIUKŲ;3272561030;Ne;5;0;0;5
23719;"Gilužis (Įsruties g. 30)";ŽIRNIUKŲ;4224203032;Ne;0;1;0;1
23720;"Gilužis (Įsruties g. 30)";ŽIRNIUKŲ;7620828905;Ne;2;1;1;4
23721;"Gilužis (Įsruties g. 30)";ŽIRNIUKŲ;1173529743;Ne;0;0;1;1
23722;"Gilužis (Įsruties g. 30)";ŽIRNIUKŲ;3504412599;Ne;12;0;4;16
23723;"Pilaitukas (Įsruties g. 27)";ŠNEKUČIAI;9940643503;Ne;4;0;0;4
23724;"Pilaitukas (Įsruties g. 27)";ŠNEKUČIAI;1445759374;Ne;5;0;0;5
23725;"Pilaitukas (Įsruties g. 27)";ŠNEKUČIAI;1859101624;Ne;2;0;0;2
23726;"Pilaitukas (Įsruties g. 27)";ŠNEKUČIAI;8479229073;Ne;2;0;0;2
23727;"Pilaitukas (Įsruties g. 27)";ŠNEKUČIAI;9731380502;Ne;6;0;0;6
23728;"Pilaitukas (Įsruties g. 27)";ŠNEKUČIAI;7224121082;Ne;6;0;0;6
23729;"Pilaitukas (Įsruties g. 27)";ŠNEKUČIAI;9115588495;Ne;4;0;0;4
23730;"Pilaitukas (Įsruties g. 27)";ŠNEKUČIAI;8801482035;Ne;4;0;0;4
23731;"Pilaitukas (Įsruties g. 27)";ŠNEKUČIAI;2894028512;Ne;3;0;0;3
23732;"Pilaitukas (Įsruties g. 27)";ŠNEKUČIAI;9622989196;Ne;9;0;0;9
23733;"Pilaitukas (Įsruties g. 27)";ŠNEKUČIAI;1356473379;Ne;0;19;0;19
23734;"Pilaitukas (Įsruties g. 27)";ŠNEKUČIAI;2883122532;Ne;2;0;0;2
23735;"Pilaitukas (Įsruties g. 27)";ŠNEKUČIAI;2883122532;Ne;2;0;0;2
23736;"Pilaitukas (Įsruties g. 27)";ŠNEKUČIAI;2883122532;Ne;2;0;0;2
23737;"Pilaitukas (Įsruties g. 27)";ŠNEKUČIAI;2939090118;Ne;7;0;0;7
23738;"Pilaitukas (Įsruties g. 27)";ŠNEKUČIAI;1309209771;Ne;3;0;0;3
23739;"Pilaitukas (Įsruties g. 27)";ŠNEKUČIAI;6092611227;Ne;7;0;0;7
23740;"Pilaitukas (Įsruties g. 27)";ŠNEKUČIAI;4567479900;Ne;3;0;0;3
23741;"Pilaitukas (Įsruties g. 27)";ŠNEKUČIAI;7933780448;Ne;1;0;0;1
23742;"Pilaitukas (Įsruties g. 27)";ŠNEKUČIAI;3653807287;Ne;1;0;0;1
23743;"Pilaitukas (Įsruties g. 27)";SMALSUČIAI;1815311248;Ne;2;0;0;2
23744;"Pilaitukas (Įsruties g. 27)";SMALSUČIAI;1414751236;Ne;6;0;0;6
23745;"Pilaitukas (Įsruties g. 27)";SMALSUČIAI;3215689222;Ne;9;0;0;9
23746;"Pilaitukas (Įsruties g. 27)";SMALSUČIAI;8755603496;Ne;4;0;0;4
23747;"Pilaitukas (Įsruties g. 27)";SMALSUČIAI;1974429718;Ne;15;1;0;16
23748;"Pilaitukas (Įsruties g. 27)";SMALSUČIAI;4544849086;Ne;5;0;3;8
23749;"Pilaitukas (Įsruties g. 27)";SMALSUČIAI;6934677745;Ne;0;2;0;2
23750;"Pilaitukas (Įsruties g. 27)";SMALSUČIAI;6496708020;Ne;6;0;1;7
23751;"Pilaitukas (Įsruties g. 27)";SMALSUČIAI;4608105047;Ne;14;0;0;14
23752;"Pilaitukas (Įsruties g. 27)";SMALSUČIAI;8698639192;Ne;0;4;1;5
23753;"Pilaitukas (Įsruties g. 27)";SMALSUČIAI;3273127718;Ne;9;4;0;13
23754;"Pilaitukas (Įsruties g. 27)";SMALSUČIAI;3501783231;Ne;0;0;1;1
23755;"Pilaitukas (Įsruties g. 27)";SMALSUČIAI;4898803794;Ne;0;4;0;4
23756;"Pilaitukas (Įsruties g. 27)";SMALSUČIAI;3544734838;Ne;5;3;0;8
23757;"Pilaitukas (Įsruties g. 27)";SMALSUČIAI;7034013577;Ne;10;0;0;10
23758;"Pilaitukas (Įsruties g. 27)";SMALSUČIAI;1793393776;Ne;8;3;3;14
23759;"Pilaitukas (Įsruties g. 27)";SMALSUČIAI;6906821879;Ne;1;0;2;3
23760;"Pilaitukas (Įsruties g. 27)";SMALSUČIAI;2210253038;Taip;8;4;0;12
23761;"Pilaitukas (Įsruties g. 27)";SMALSUČIAI;5490465905;Ne;1;1;0;2
23762;"Pilaitukas (Įsruties g. 27)";SMALSUČIAI;8787181006;Ne;10;0;0;10
23763;"Pilaitukas (Įsruties g. 27)";" GUDRUČIAI";3068325053;Ne;1;4;0;5
23764;"Pilaitukas (Įsruties g. 27)";" GUDRUČIAI";1571691020;Ne;1;4;0;5
23765;"Pilaitukas (Įsruties g. 27)";" GUDRUČIAI";9186679454;Ne;0;4;0;4
23766;"Pilaitukas (Įsruties g. 27)";" GUDRUČIAI";8584321345;Ne;0;3;0;3
23767;"Pilaitukas (Įsruties g. 27)";" GUDRUČIAI";3621245783;Ne;5;4;0;9
23768;"Pilaitukas (Įsruties g. 27)";" GUDRUČIAI";3927118900;Ne;4;3;1;8
23769;"Pilaitukas (Įsruties g. 27)";" GUDRUČIAI";5464065587;Ne;9;0;0;9
23770;"Pilaitukas (Įsruties g. 27)";" GUDRUČIAI";6844500395;Ne;1;4;0;5
23771;"Pilaitukas (Įsruties g. 27)";" GUDRUČIAI";5440233814;Ne;0;0;5;5
23772;"Pilaitukas (Įsruties g. 27)";" GUDRUČIAI";4810825253;Ne;0;5;0;5
23773;"Pilaitukas (Įsruties g. 27)";" GUDRUČIAI";3395656390;Ne;0;2;0;2
23774;"Pilaitukas (Įsruties g. 27)";" GUDRUČIAI";9774222130;Ne;4;4;0;8
23775;"Pilaitukas (Įsruties g. 27)";" GUDRUČIAI";4623818227;Ne;0;4;0;4
23776;"Pilaitukas (Įsruties g. 27)";" GUDRUČIAI";7568744500;Ne;6;4;0;10
23777;"Pilaitukas (Įsruties g. 27)";" GUDRUČIAI";5407354218;Ne;4;8;0;12
23778;"Pilaitukas (Įsruties g. 27)";" GUDRUČIAI";6838035491;Ne;0;1;0;1
23779;"Pilaitukas (Įsruties g. 27)";" GUDRUČIAI";5326258755;Ne;0;2;0;2
23780;"Kodėlčiukas (Pavilnionių g. 29)";VOVERIUKAI;4489705749;Ne;5;0;2;7
23781;"Kodėlčiukas (Pavilnionių g. 29)";VOVERIUKAI;9356462891;Ne;0;0;4;4
23782;"Kodėlčiukas (Pavilnionių g. 29)";VOVERIUKAI;7670611028;Taip;13;0;0;13
23783;"Kodėlčiukas (Pavilnionių g. 29)";VOVERIUKAI;1495887897;Taip;0;0;6;6
23784;"Kodėlčiukas (Pavilnionių g. 29)";VOVERIUKAI;2004990546;Ne;0;0;5;5
23785;"Kodėlčiukas (Pavilnionių g. 29)";VOVERIUKAI;4463423519;Ne;4;0;0;4
23786;"Kodėlčiukas (Pavilnionių g. 29)";VOVERIUKAI;9262386562;Ne;0;0;3;3
23787;"Kodėlčiukas (Pavilnionių g. 29)";VOVERIUKAI;7015036278;Ne;0;3;0;3
23788;"Kodėlčiukas (Pavilnionių g. 29)";VOVERIUKAI;2624402719;Taip;0;0;5;5
23789;"Kodėlčiukas (Pavilnionių g. 29)";AITVARIUKAI;3071951746;Ne;3;0;4;7
23790;"Kodėlčiukas (Pavilnionių g. 29)";AITVARIUKAI;9389125350;Taip;0;0;4;4
23791;"Kodėlčiukas (Pavilnionių g. 29)";AITVARIUKAI;9389125350;Taip;0;0;4;4
23792;"Kodėlčiukas (Pavilnionių g. 29)";AITVARIUKAI;1784673088;Taip;11;0;0;11
23793;"Kodėlčiukas (Pavilnionių g. 29)";AITVARIUKAI;1784673088;Taip;11;0;0;11
23794;"Kodėlčiukas (Pavilnionių g. 29)";AITVARIUKAI;9573073973;Ne;1;0;4;5
23795;"Kodėlčiukas (Pavilnionių g. 29)";AITVARIUKAI;2429997257;Taip;2;0;0;2
23796;"Kodėlčiukas (Pavilnionių g. 29)";AITVARIUKAI;2429997257;Taip;2;0;0;2
23797;"Kodėlčiukas (Pavilnionių g. 29)";AITVARIUKAI;3735299373;Ne;0;0;2;2
23798;"Kodėlčiukas (Pavilnionių g. 29)";AITVARIUKAI;1775864846;Taip;0;0;4;4
23799;"Kodėlčiukas (Pavilnionių g. 29)";AITVARIUKAI;1775864846;Taip;0;0;4;4
23800;"Kodėlčiukas (Pavilnionių g. 29)";AITVARIUKAI;1029573241;Taip;7;0;1;8
23801;"Kodėlčiukas (Pavilnionių g. 29)";AITVARIUKAI;1029573241;Taip;7;0;1;8
23802;"Kodėlčiukas (Pavilnionių g. 29)";AITVARIUKAI;2892318767;Taip;16;0;0;16
23803;"Kodėlčiukas (Pavilnionių g. 29)";AITVARIUKAI;2892318767;Taip;16;0;0;16
23804;"Kodėlčiukas (Pavilnionių g. 29)";AITVARIUKAI;6809202793;Taip;7;0;0;7
23805;"Kodėlčiukas (Pavilnionių g. 29)";AITVARIUKAI;6809202793;Taip;7;0;0;7
23806;"Kodėlčiukas (Pavilnionių g. 29)";AITVARIUKAI;8707777661;Taip;13;0;2;15
23807;"Kodėlčiukas (Pavilnionių g. 29)";AITVARIUKAI;8707777661;Taip;13;0;2;15
23808;"Kodėlčiukas (Pavilnionių g. 29)";AITVARIUKAI;4366942357;Taip;5;0;0;5
23809;"Kodėlčiukas (Pavilnionių g. 29)";AITVARIUKAI;4366942357;Taip;5;0;0;5
23810;"Kodėlčiukas (Pavilnionių g. 29)";AITVARIUKAI;2601561338;Taip;2;0;2;4
23811;"Kodėlčiukas (Pavilnionių g. 29)";DEBESĖLIAI;2048119857;Ne;15;0;0;15
23812;"Kodėlčiukas (Pavilnionių g. 29)";DEBESĖLIAI;6567146331;Taip;0;0;1;1
23813;"Kodėlčiukas (Pavilnionių g. 29)";DEBESĖLIAI;6567146331;Taip;0;0;1;1
23814;"Kodėlčiukas (Pavilnionių g. 29)";DEBESĖLIAI;7141979862;Taip;4;0;0;4
23815;"Kodėlčiukas (Pavilnionių g. 29)";DEBESĖLIAI;7141979862;Taip;4;0;0;4
23816;"Kodėlčiukas (Pavilnionių g. 29)";DEBESĖLIAI;5786431452;Ne;11;0;0;11
23817;"Kodėlčiukas (Pavilnionių g. 29)";DEBESĖLIAI;1056383365;Ne;6;0;0;6
23818;"Kodėlčiukas (Pavilnionių g. 29)";DEBESĖLIAI;1725192281;Ne;0;4;1;5
23819;"Kodėlčiukas (Pavilnionių g. 29)";DEBESĖLIAI;1725192281;Ne;0;4;1;5
23820;"Kodėlčiukas (Pavilnionių g. 29)";DEBESĖLIAI;7242480118;Ne;4;0;3;7
23821;"Kodėlčiukas (Pavilnionių g. 29)";DEBESĖLIAI;7242480118;Ne;4;0;3;7
23822;"Kodėlčiukas (Pavilnionių g. 29)";DEBESĖLIAI;2914410829;Ne;14;0;1;15
23823;"Kodėlčiukas (Pavilnionių g. 29)";DEBESĖLIAI;3662576624;Ne;0;7;0;7
23824;"Kodėlčiukas (Pavilnionių g. 29)";DEBESĖLIAI;3609685477;Ne;3;0;1;4
23825;"Kodėlčiukas (Pavilnionių g. 29)";DEBESĖLIAI;5286211766;Ne;3;0;0;3
23826;"Kodėlčiukas (Pavilnionių g. 29)";DEBESĖLIAI;5286211766;Ne;3;0;0;3
23827;"Kodėlčiukas (Pavilnionių g. 29)";LAPIUKAI;1891196716;Ne;0;4;0;4
23828;"Kodėlčiukas (Pavilnionių g. 29)";LAPIUKAI;8571338844;Ne;4;0;0;4
23829;"Kodėlčiukas (Pavilnionių g. 29)";LAPIUKAI;8571338844;Ne;4;0;0;4
23830;"Kodėlčiukas (Pavilnionių g. 29)";LAPIUKAI;1317117419;Ne;3;0;0;3
23831;"Kodėlčiukas (Pavilnionių g. 29)";LAPIUKAI;3684778189;Ne;9;0;0;9
23832;"Kodėlčiukas (Pavilnionių g. 29)";LAPIUKAI;6930466455;Ne;6;0;0;6
23833;"Kodėlčiukas (Pavilnionių g. 29)";LAPIUKAI;9735976439;Taip;6;0;0;6
23834;"Kodėlčiukas (Pavilnionių g. 29)";LAPIUKAI;9735976439;Taip;6;0;0;6
23835;"Kodėlčiukas (Pavilnionių g. 29)";LAPIUKAI;8735489387;Taip;8;0;0;8
23836;"Kodėlčiukas (Pavilnionių g. 29)";LAPIUKAI;8735489387;Taip;8;0;0;8
23837;"Kodėlčiukas (Pavilnionių g. 29)";LAPIUKAI;7299634969;Taip;4;0;0;4
23838;"Kodėlčiukas (Pavilnionių g. 29)";LAPIUKAI;7299634969;Taip;4;0;0;4
23839;"Kodėlčiukas (Pavilnionių g. 29)";LAPIUKAI;4119254199;Ne;7;0;0;7
23840;"Kodėlčiukas (Pavilnionių g. 29)";LAPIUKAI;4119254199;Ne;7;0;0;7
23841;"Kodėlčiukas (Pavilnionių g. 29)";LAPIUKAI;1480546152;Taip;5;0;0;5
23842;"Kodėlčiukas (Pavilnionių g. 29)";LAPIUKAI;1480546152;Taip;5;0;0;5
23843;"Kodėlčiukas (Pavilnionių g. 29)";LAPIUKAI;8896158382;Ne;7;0;0;7
23844;"Kodėlčiukas (Pavilnionių g. 29)";LAPIUKAI;8896158382;Ne;7;0;0;7
23845;"Kodėlčiukas (Pavilnionių g. 29)";LAPIUKAI;6826429156;Ne;6;0;0;6
23846;"Kodėlčiukas (Pavilnionių g. 29)";LAPIUKAI;6826429156;Ne;6;0;0;6
23847;"Kodėlčiukas (Pavilnionių g. 29)";LAPIUKAI;1671448610;Taip;4;0;0;4
23848;"Kodėlčiukas (Pavilnionių g. 29)";LAPIUKAI;1671448610;Taip;4;0;0;4
23849;"Kodėlčiukas (Pavilnionių g. 29)";EŽIUKAI;1761109453;Ne;8;4;0;12
23850;"Kodėlčiukas (Pavilnionių g. 29)";EŽIUKAI;3869434109;Ne;0;0;1;1
23851;"Kodėlčiukas (Pavilnionių g. 29)";EŽIUKAI;1906930504;Ne;3;0;2;5
23852;"Kodėlčiukas (Pavilnionių g. 29)";EŽIUKAI;7107700885;Ne;1;8;0;9
23853;"Kodėlčiukas (Pavilnionių g. 29)";EŽIUKAI;7107700885;Ne;1;8;0;9
23854;"Kodėlčiukas (Pavilnionių g. 29)";EŽIUKAI;4842829705;Ne;0;9;0;9
23855;"Kodėlčiukas (Pavilnionių g. 29)";EŽIUKAI;4842829705;Ne;0;9;0;9
23856;"Kodėlčiukas (Pavilnionių g. 29)";EŽIUKAI;3529385544;Ne;0;0;4;4
23857;"Kodėlčiukas (Pavilnionių g. 29)";EŽIUKAI;2728038596;Ne;3;3;0;6
23858;"Kodėlčiukas (Pavilnionių g. 29)";EŽIUKAI;6373705667;Ne;4;0;1;5
23859;"Kodėlčiukas (Pavilnionių g. 29)";EŽIUKAI;6373705667;Ne;4;0;1;5
23860;"Kodėlčiukas (Pavilnionių g. 29)";EŽIUKAI;7035441207;Ne;4;4;0;8
23861;"Kodėlčiukas (Pavilnionių g. 29)";EŽIUKAI;2999381333;Taip;0;0;6;6
23862;"Kodėlčiukas (Pavilnionių g. 29)";EŽIUKAI;2999381333;Taip;0;0;6;6
23863;"Kodėlčiukas (Pavilnionių g. 29)";EŽIUKAI;5540660080;Ne;5;0;4;9
23864;"Kodėlčiukas (Pavilnionių g. 29)";EŽIUKAI;4795230461;Ne;8;0;1;9
23865;"Kodėlčiukas (Pavilnionių g. 29)";EŽIUKAI;9424975662;Taip;0;7;0;7
23866;"Kodėlčiukas (Pavilnionių g. 29)";EŽIUKAI;9424975662;Taip;0;7;0;7
23867;"Kodėlčiukas (Pavilnionių g. 29)";EŽIUKAI;5025581128;Ne;2;0;0;2
23868;"Kodėlčiukas (Pavilnionių g. 29)";EŽIUKAI;5025581128;Ne;2;0;0;2
23869;"Kodėlčiukas (Pavilnionių g. 29)";EŽIUKAI;9092413482;Ne;0;0;2;2
23870;"Kodėlčiukas (Pavilnionių g. 29)";EŽIUKAI;3598405258;Ne;7;0;0;7
23871;"Kodėlčiukas (Pavilnionių g. 29)";EŽIUKAI;3598405258;Ne;7;0;0;7
