Nr.;"Darželio pavadinimas";"Grupės pavadinimas";"Vaiko Identifikacinis Nr.";"Deklaruotas mieste";"Pateisintos dėl ligos";"Pateisintos dėl kitų priežasčių";"Nepateisintos dienos";"Praleistos dienos Viso"
1;Aitvaras;"VIJURKAI (ALERG.)";6936031222;Ne;0;5;7;12
2;Aitvaras;"VIJURKAI (ALERG.)";6214880713;Ne;0;12;0;12
3;Aitvaras;"VIJURKAI (ALERG.)";2566375128;Ne;0;7;0;7
4;Aitvaras;"VIJURKAI (ALERG.)";1879540041;Ne;0;10;0;10
5;Aitvaras;"VIJURKAI (ALERG.)";1532588441;Ne;12;5;0;17
6;Aitvaras;"VIJURKAI (ALERG.)";8206046301;Ne;6;3;0;9
7;Aitvaras;"VIJURKAI (ALERG.)";1347364985;Ne;0;10;2;12
8;Aitvaras;"VIJURKAI (ALERG.)";9157794193;Ne;5;12;1;18
9;Aitvaras;"VIJURKAI (ALERG.)";9562494357;Ne;4;9;2;15
10;Aitvaras;"VIJURKAI (ALERG.)";6021342178;Ne;0;10;0;10
11;Aitvaras;"VIJURKAI (ALERG.)";2650483861;Ne;0;8;0;8
12;Aitvaras;"VIJURKAI (ALERG.)";2601983670;Ne;0;4;0;4
13;Aitvaras;"VIJURKAI (ALERG.)";3570820823;Ne;0;2;0;2
14;Aitvaras;"VIJURKAI (ALERG.)";6444377924;Ne;0;5;0;5
15;Aitvaras;"VIJURKAI (ALERG.)";4702400490;Ne;5;5;0;10
16;Aitvaras;"SMALSUČIAI (ALERG.)";4868552034;Ne;0;10;0;10
17;Aitvaras;"SMALSUČIAI (ALERG.)";6166757095;Ne;0;21;0;21
18;Aitvaras;"SMALSUČIAI (ALERG.)";4480921300;Ne;0;8;1;9
19;Aitvaras;"SMALSUČIAI (ALERG.)";1019661577;Ne;0;6;0;6
20;Aitvaras;"SMALSUČIAI (ALERG.)";5425259260;Ne;0;3;0;3
21;Aitvaras;"SMALSUČIAI (ALERG.)";5750154036;Ne;0;8;5;13
22;Aitvaras;"SMALSUČIAI (ALERG.)";1275561645;Ne;1;2;0;3
23;Aitvaras;"SMALSUČIAI (ALERG.)";6084096300;Ne;0;7;2;9
24;Aitvaras;"SMALSUČIAI (ALERG.)";2004112424;Ne;0;5;0;5
25;Aitvaras;"SMALSUČIAI (ALERG.)";5330618557;Ne;6;8;0;14
26;Aitvaras;"SMALSUČIAI (ALERG.)";3488467265;Ne;13;4;1;18
27;Aitvaras;"SMALSUČIAI (ALERG.)";9745864667;Ne;0;9;0;9
28;Aitvaras;"SMALSUČIAI (ALERG.)";9810370596;Ne;0;1;0;1
29;Aitvaras;"SMALSUČIAI (ALERG.)";1954364886;Ne;0;6;0;6
30;Aitvaras;"SMALSUČIAI (ALERG.)";3535659630;Ne;0;2;3;5
31;Aitvaras;"SMALSUČIAI (ALERG.)";4833313373;Ne;0;0;1;1
32;Aitvaras;"SMALSUČIAI (ALERG.)";5504431748;Ne;2;1;2;5
33;Aitvaras;"SMALSUČIAI (ALERG.)";5389627560;Ne;0;7;0;7
34;Aitvaras;"SMALSUČIAI (ALERG.)";2953536545;Ne;0;6;0;6
35;Aitvaras;"SMALSUČIAI (ALERG.)";1636794584;Ne;0;4;0;4
36;Aitvaras;"SMALSUČIAI (ALERG.)";5956333024;Ne;0;1;0;1
37;Aitvaras;"SMALSUČIAI (ALERG.)";5595233402;Ne;0;2;1;3
38;Aitvaras;PADAUŽIUKAI;1494094426;Ne;0;1;0;1
39;Aitvaras;PADAUŽIUKAI;9332771711;Ne;2;0;0;2
40;Aitvaras;PADAUŽIUKAI;6550426644;Ne;7;6;0;13
41;Aitvaras;PADAUŽIUKAI;5818794912;Ne;0;4;0;4
42;Aitvaras;PADAUŽIUKAI;58780461337;Ne;0;1;9;10
43;Aitvaras;PADAUŽIUKAI;2034293999;Ne;22;9;0;31
44;Aitvaras;PADAUŽIUKAI;1116271183;Ne;0;1;0;1
45;Aitvaras;PADAUŽIUKAI;44046627149;Taip;0;12;0;12
46;Aitvaras;PADAUŽIUKAI;43711349817;Ne;0;0;1;1
47;Aitvaras;PADAUŽIUKAI;2804106417;Ne;0;4;0;4
48;Aitvaras;PADAUŽIUKAI;2711888522;Ne;0;8;0;8
49;Aitvaras;PADAUŽIUKAI;1996524718;Ne;0;4;1;5
50;Aitvaras;PADAUŽIUKAI;4110585744;Ne;0;8;0;8
51;Aitvaras;PADAUŽIUKAI;6010324894;Ne;0;9;0;9
52;Aitvaras;PADAUŽIUKAI;2408952971;Ne;15;0;0;15
53;Aitvaras;PADAUŽIUKAI;2330782717;Ne;0;5;0;5
54;Aitvaras;PADAUŽIUKAI;47875842134;Ne;0;2;0;2
55;Aitvaras;PADAUŽIUKAI;40799643122;Ne;7;5;0;12
56;Aitvaras;PADAUŽIUKAI;9015675095;Ne;7;0;0;7
57;Aitvaras;PADAUŽIUKAI;8503279655;Ne;0;2;1;3
58;Aitvaras;PADAUŽIUKAI;8121858940;Ne;0;8;1;9
59;Aitvaras;"AITVARIUKAI (ALERG.)";3639102842;Ne;0;3;0;3
60;Aitvaras;"AITVARIUKAI (ALERG.)";7243387750;Ne;0;11;0;11
61;Aitvaras;"AITVARIUKAI (ALERG.)";6587437949;Ne;0;8;0;8
62;Aitvaras;"AITVARIUKAI (ALERG.)";7461284958;Ne;0;12;0;12
63;Aitvaras;"AITVARIUKAI (ALERG.)";3394251305;Ne;0;9;0;9
64;Aitvaras;"AITVARIUKAI (ALERG.)";6459307767;Ne;0;5;2;7
65;Aitvaras;"AITVARIUKAI (ALERG.)";5635576679;Ne;7;10;0;17
66;Aitvaras;"AITVARIUKAI (ALERG.)";7988247429;Ne;0;2;0;2
67;Aitvaras;"AITVARIUKAI (ALERG.)";8770777328;Ne;0;4;0;4
68;Aitvaras;"AITVARIUKAI (ALERG.)";3653879553;Ne;0;9;4;13
69;Aitvaras;"AITVARIUKAI (ALERG.)";9721273154;Ne;7;2;0;9
70;Aitvaras;"AITVARIUKAI (ALERG.)";5103105065;Ne;22;10;0;32
71;Aitvaras;"AITVARIUKAI (ALERG.)";8543644000;Ne;0;4;0;4
72;Aitvaras;"AITVARIUKAI (ALERG.)";4204923580;Ne;0;8;0;8
73;Aitvaras;"AITVARIUKAI (ALERG.)";4777266938;Ne;11;10;0;21
74;Aitvaras;"AITVARIUKAI (ALERG.)";7568388141;Ne;15;14;0;29
75;Aitvaras;"AITVARIUKAI (ALERG.)";2146963673;Ne;13;10;0;23
76;Aitvaras;"AITVARIUKAI (ALERG.)";9763502346;Ne;7;10;0;17
77;Aitvaras;"AITVARIUKAI (ALERG.)";9228736015;Ne;5;9;0;14
78;Aitvaras;"AITVARIUKAI (ALERG.)";3775634117;Ne;0;11;0;11
79;Aitvaras;"AITVARIUKAI (ALERG.)";2615576367;Ne;0;7;0;7
80;Aitvaras;"SAULĖS ZUIKUČIAI  (ALERG.)";5711324951;Ne;5;0;0;5
81;Aitvaras;"SAULĖS ZUIKUČIAI  (ALERG.)";5619137905;Ne;0;1;0;1
82;Aitvaras;"SAULĖS ZUIKUČIAI  (ALERG.)";4106097701;Ne;0;4;0;4
83;Aitvaras;"SAULĖS ZUIKUČIAI  (ALERG.)";9659883026;Ne;3;0;0;3
84;Aitvaras;"SAULĖS ZUIKUČIAI  (ALERG.)";2184231202;Ne;4;0;0;4
85;Aitvaras;"SAULĖS ZUIKUČIAI  (ALERG.)";2478737835;Ne;5;7;0;12
86;Aitvaras;"SAULĖS ZUIKUČIAI  (ALERG.)";1136438927;Ne;3;2;5;10
87;Aitvaras;"SAULĖS ZUIKUČIAI  (ALERG.)";8137900398;Ne;0;1;0;1
88;Aitvaras;"SAULĖS ZUIKUČIAI  (ALERG.)";9147954612;Ne;5;0;0;5
89;Aitvaras;"SAULĖS ZUIKUČIAI  (ALERG.)";2511844613;Ne;11;0;0;11
90;Aitvaras;"SAULĖS ZUIKUČIAI  (ALERG.)";7907357058;Ne;0;2;1;3
91;Aitvaras;"SAULĖS ZUIKUČIAI  (ALERG.)";9534206000;Ne;17;1;0;18
92;Aitvaras;"SAULĖS ZUIKUČIAI  (ALERG.)";3737054758;Ne;18;1;0;19
93;Aitvaras;"SAULĖS ZUIKUČIAI  (ALERG.)";4646876966;Ne;0;1;0;1
94;Aitvaras;"SAULĖS ZUIKUČIAI  (ALERG.)";9271534775;Ne;16;0;2;18
95;Aitvaras;"SAULĖS ZUIKUČIAI  (ALERG.)";6950820937;Ne;0;4;3;7
96;Aitvaras;"SAULĖS ZUIKUČIAI  (ALERG.)";5283056036;Ne;0;1;0;1
97;Aitvaras;"SAULĖS ZUIKUČIAI  (ALERG.)";5252728205;Ne;4;0;1;5
98;Aitvaras;"SAULĖS ZUIKUČIAI  (ALERG.)";2373509019;Ne;10;3;0;13
99;Aitvaras;"SAULĖS ZUIKUČIAI  (ALERG.)";2624566766;Ne;5;0;0;5
100;Aitvaras;"ŽEMYNUKAI (ALERG.)";8567255042;Ne;0;5;2;7
101;Aitvaras;"ŽEMYNUKAI (ALERG.)";6218019092;Ne;0;12;0;12
102;Aitvaras;"ŽEMYNUKAI (ALERG.)";7560642918;Ne;0;1;0;1
103;Aitvaras;"ŽEMYNUKAI (ALERG.)";3820930777;Ne;22;10;0;32
104;Aitvaras;"ŽEMYNUKAI (ALERG.)";6624986090;Ne;14;3;1;18
105;Aitvaras;"ŽEMYNUKAI (ALERG.)";4733627644;Ne;0;5;3;8
106;Aitvaras;"ŽEMYNUKAI (ALERG.)";3104109370;Ne;0;5;8;13
107;Aitvaras;"ŽEMYNUKAI (ALERG.)";7853714142;Ne;2;12;1;15
108;Aitvaras;"ŽEMYNUKAI (ALERG.)";1949144346;Ne;7;10;0;17
109;Aitvaras;"ŽEMYNUKAI (ALERG.)";8641433486;Ne;11;5;2;18
110;Aitvaras;"ŽEMYNUKAI (ALERG.)";9947610763;Ne;0;6;0;6
111;Aitvaras;"ŽEMYNUKAI (ALERG.)";7113016866;Ne;0;8;0;8
112;Aitvaras;"ŽEMYNUKAI (ALERG.)";4377666052;Ne;7;10;0;17
113;Aitvaras;"ŽEMYNUKAI (ALERG.)";8333823078;Ne;5;1;0;6
114;Aitvaras;"ŽEMYNUKAI (ALERG.)";5623106419;Ne;5;16;0;21
115;Aitvaras;"ŽEMYNUKAI (ALERG.)";5351333397;Ne;0;3;0;3
116;Aitvaras;"ŽEMYNUKAI (ALERG.)";2065988478;Ne;5;4;2;11
117;Aitvaras;"ŽEMYNUKAI (ALERG.)";3635354769;Ne;0;5;0;5
118;Aitvaras;"ŽEMYNUKAI (ALERG.)";3851322849;Ne;0;10;8;18
119;Aitvaras;"ŽEMYNUKAI (ALERG.)";7889947603;Ne;12;3;0;15
120;Aitvaras;"ŽEMYNUKAI (ALERG.)";1662289664;Ne;0;9;0;9
121;Aitvaras;"ŽEMYNUKAI (ALERG.)";2839442228;Ne;0;8;3;11
122;Aitvaras;"LINKSMUČIAI (ALERG.)";5238819066;Ne;0;0;2;2
123;Aitvaras;"LINKSMUČIAI (ALERG.)";7109001184;Ne;2;1;1;4
124;Aitvaras;"LINKSMUČIAI (ALERG.)";5378212904;Ne;18;9;0;27
125;Aitvaras;"LINKSMUČIAI (ALERG.)";3655710511;Ne;0;1;0;1
126;Aitvaras;"LINKSMUČIAI (ALERG.)";1091372798;Ne;0;11;0;11
127;Aitvaras;"LINKSMUČIAI (ALERG.)";8666824607;Ne;0;5;5;10
128;Aitvaras;"LINKSMUČIAI (ALERG.)";5612991255;Ne;0;5;0;5
129;Aitvaras;"LINKSMUČIAI (ALERG.)";7260577885;Ne;0;2;0;2
130;Aitvaras;"LINKSMUČIAI (ALERG.)";1599183050;Ne;0;4;0;4
131;Aitvaras;"LINKSMUČIAI (ALERG.)";1115202169;Ne;0;4;0;4
132;Aitvaras;"LINKSMUČIAI (ALERG.)";4613894944;Ne;0;9;9;18
133;Aitvaras;"LINKSMUČIAI (ALERG.)";2760970218;Ne;13;3;0;16
134;Aitvaras;"LINKSMUČIAI (ALERG.)";4120515569;Ne;7;19;0;26
135;Aitvaras;"LINKSMUČIAI (ALERG.)";9885781306;Ne;0;4;0;4
136;Aitvaras;"LINKSMUČIAI (ALERG.)";4564723798;Ne;1;4;0;5
137;Aitvaras;"LINKSMUČIAI (ALERG.)";4612994715;Ne;4;10;1;15
138;Aitvaras;"LINKSMUČIAI (ALERG.)";4176681907;Ne;0;10;1;11
139;Aitvaras;"LINKSMUČIAI (ALERG.)";6286268740;Ne;0;3;1;4
140;Aitvaras;"LINKSMUČIAI (ALERG.)";2547934790;Ne;0;15;1;16
141;Aitvaras;"LINKSMUČIAI (ALERG.)";2357399981;Ne;0;7;1;8
142;Aitvaras;"LINKSMUČIAI (ALERG.)";5572538840;Ne;0;9;0;9
143;Aitvaras;NAMINUKAI;3053557807;Ne;2;1;2;5
144;Aitvaras;NAMINUKAI;6126913961;Ne;2;2;1;5
145;Aitvaras;NAMINUKAI;3347213578;Ne;0;1;6;7
146;Aitvaras;NAMINUKAI;9024245490;Ne;0;2;2;4
147;Aitvaras;NAMINUKAI;8512502118;Ne;0;1;1;2
148;Aitvaras;NAMINUKAI;2821221241;Ne;0;2;0;2
149;Aitvaras;NAMINUKAI;9039303562;Ne;0;0;21;21
150;Aitvaras;NAMINUKAI;6080549524;Ne;22;0;0;22
151;Aitvaras;NAMINUKAI;6048701733;Ne;0;1;2;3
152;Aitvaras;NAMINUKAI;4555281655;Ne;7;0;0;7
153;Aitvaras;NAMINUKAI;8043062737;Ne;0;1;0;1
154;Aitvaras;NAMINUKAI;3005447572;Ne;10;0;0;10
155;Aitvaras;NAMINUKAI;1549552392;Ne;16;1;0;17
156;Aitvaras;NAMINUKAI;9490714865;Ne;0;6;0;6
157;Aitvaras;NAMINUKAI;1498630458;Ne;0;0;1;1
158;Aitvaras;NAMINUKAI;5967188507;Ne;0;1;3;4
159;Aitvaras;NAMINUKAI;7934344218;Ne;2;0;1;3
160;Aitvaras;NAMINUKAI;6279152796;Ne;0;9;0;9
161;Aitvaras;ŠELMIAI;4984058405;Ne;0;13;0;13
162;Aitvaras;ŠELMIAI;9725401255;Ne;5;0;0;5
163;Aitvaras;ŠELMIAI;4547342872;Ne;0;1;0;1
164;Aitvaras;ŠELMIAI;5684526288;Ne;0;3;1;4
165;Aitvaras;ŠELMIAI;7764574135;Ne;4;0;0;4
166;Aitvaras;ŠELMIAI;5601517340;Ne;0;14;0;14
167;Aitvaras;ŠELMIAI;1019103539;Ne;7;0;0;7
168;Aitvaras;ŠELMIAI;2185746898;Ne;0;1;0;1
169;Aitvaras;ŠELMIAI;8756012613;Ne;0;5;0;5
170;Aitvaras;ŠELMIAI;1203732956;Ne;18;6;0;24
171;Aitvaras;ŠELMIAI;5782609781;Ne;3;16;0;19
172;Aitvaras;ŠELMIAI;7805819121;Ne;5;6;0;11
173;Aitvaras;ŠELMIAI;8558414510;Ne;0;6;0;6
174;Aitvaras;ŠELMIAI;4551774368;Ne;0;6;0;6
175;Aitvaras;ŠELMIAI;4158520145;Ne;0;6;0;6
176;Aitvaras;ŠELMIAI;7352233454;Ne;0;7;0;7
177;Aitvaras;ŠELMIAI;1901118931;Ne;0;4;1;5
178;Aitvaras;ŠELMIAI;4812423010;Ne;14;6;0;20
179;Aitvaras;ŠELMIAI;1112142035;Ne;0;1;0;1
180;Aitvaras;ŠELMIAI;8644983502;Ne;1;1;0;2
181;Aitvaras;ŠELMIAI;9295561516;Ne;0;6;0;6
182;Aitvaras;ŠELMIAI;6188186413;Ne;7;2;4;13
183;Aitvaras;KODĖLČIUKAI;6214572150;Ne;9;2;0;11
184;Aitvaras;KODĖLČIUKAI;3323458595;Ne;0;1;0;1
185;Aitvaras;KODĖLČIUKAI;8065540507;Ne;0;7;0;7
186;Aitvaras;KODĖLČIUKAI;1288810999;Ne;0;3;0;3
187;Aitvaras;KODĖLČIUKAI;6501943902;Ne;0;13;0;13
188;Aitvaras;KODĖLČIUKAI;7777235021;Ne;0;14;0;14
189;Aitvaras;KODĖLČIUKAI;5641224483;Ne;0;2;1;3
190;Aitvaras;KODĖLČIUKAI;1830134108;Ne;0;2;5;7
191;Aitvaras;KODĖLČIUKAI;3178965623;Ne;0;1;0;1
192;Aitvaras;KODĖLČIUKAI;5905456814;Ne;2;1;0;3
193;Aitvaras;KODĖLČIUKAI;1761446849;Ne;0;6;0;6
194;Aitvaras;KODĖLČIUKAI;2807595769;Ne;0;2;0;2
195;Aitvaras;KODĖLČIUKAI;1252145346;Ne;0;0;3;3
196;Aitvaras;KODĖLČIUKAI;7455895024;Ne;0;5;1;6
197;Aitvaras;KODĖLČIUKAI;8439586875;Ne;0;2;1;3
198;Aitvaras;KODĖLČIUKAI;2328771385;Ne;0;18;0;18
199;Aitvaras;KODĖLČIUKAI;8360380303;Ne;0;1;0;1
200;Aitvaras;KODĖLČIUKAI;1594675221;Ne;0;6;1;7
201;Aitvaras;KODĖLČIUKAI;5922357091;Ne;5;6;0;11
202;Aitvaras;PABIRUČIAI;7136674662;Ne;0;4;0;4
203;Aitvaras;PABIRUČIAI;9949206639;Ne;0;0;3;3
204;Aitvaras;PABIRUČIAI;2887681961;Ne;0;7;0;7
205;Aitvaras;PABIRUČIAI;7922937851;Ne;0;1;0;1
206;Aitvaras;PABIRUČIAI;4085134058;Ne;6;5;0;11
207;Aitvaras;PABIRUČIAI;8746884740;Ne;0;3;0;3
208;Aitvaras;PABIRUČIAI;4163871634;Ne;0;7;0;7
209;Aitvaras;PABIRUČIAI;3988226974;Ne;0;7;0;7
210;Aitvaras;PABIRUČIAI;1070324386;Ne;0;1;0;1
211;Aitvaras;PABIRUČIAI;2239387580;Ne;0;2;0;2
212;Aitvaras;PABIRUČIAI;6119148164;Ne;0;11;0;11
213;Aitvaras;PABIRUČIAI;2892898328;Ne;0;8;0;8
214;Aitvaras;PABIRUČIAI;3749008647;Ne;0;2;3;5
215;Aitvaras;PABIRUČIAI;4760801928;Ne;2;5;20;27
216;Aitvaras;PABIRUČIAI;1599296739;Taip;0;5;19;24
217;Aitvaras;PABIRUČIAI;4987412561;Ne;5;5;1;11
218;Aitvaras;"SVAJOKLIAI  (ALERG.)";3429046261;Ne;0;1;0;1
219;Aitvaras;"SVAJOKLIAI  (ALERG.)";5659897032;Ne;0;1;0;1
220;Aitvaras;"SVAJOKLIAI  (ALERG.)";4618560397;Ne;13;0;0;13
221;Aitvaras;"SVAJOKLIAI  (ALERG.)";9209862610;Ne;2;5;0;7
222;Aitvaras;"SVAJOKLIAI  (ALERG.)";6191938291;Ne;5;0;0;5
223;Aitvaras;"SVAJOKLIAI  (ALERG.)";7006713502;Ne;15;0;7;22
224;Aitvaras;"SVAJOKLIAI  (ALERG.)";3923601422;Ne;7;5;0;12
225;Aitvaras;"SVAJOKLIAI  (ALERG.)";5790551266;Ne;3;2;0;5
226;Aitvaras;"SVAJOKLIAI  (ALERG.)";2975696317;Ne;2;1;1;4
227;Aitvaras;"SVAJOKLIAI  (ALERG.)";3891067128;Ne;0;2;0;2
228;Aitvaras;"SVAJOKLIAI  (ALERG.)";1030872812;Ne;2;3;0;5
229;Aitvaras;"SVAJOKLIAI  (ALERG.)";5255843693;Ne;10;0;1;11
230;Aitvaras;"SVAJOKLIAI  (ALERG.)";5593105541;Ne;0;2;0;2
231;Aitvaras;"SVAJOKLIAI  (ALERG.)";8963214183;Ne;10;1;0;11
232;Aitvaras;"SVAJOKLIAI  (ALERG.)";6319953077;Ne;6;2;0;8
233;Aitvaras;"SVAJOKLIAI  (ALERG.)";1131690624;Ne;14;1;0;15
234;Aitvaras;"SVAJOKLIAI  (ALERG.)";4801034095;Ne;0;2;0;2
235;Aitvaras;"SVAJOKLIAI  (ALERG.)";6916032116;Ne;0;1;0;1
236;Aitvaras;"SVAJOKLIAI  (ALERG.)";8300788433;Ne;6;3;0;9
237;Atžalėlės;Gėlytės;4284673729;Ne;0;14;8;22
238;Atžalėlės;Gėlytės;8695865604;Ne;0;4;0;4
239;Atžalėlės;Gėlytės;2385614957;Ne;7;0;0;7
240;Atžalėlės;Gėlytės;5432433423;Ne;0;10;0;10
241;Atžalėlės;Gėlytės;9715625283;Ne;10;2;0;12
242;Atžalėlės;Gėlytės;4682216852;Ne;0;0;2;2
243;Atžalėlės;Gėlytės;2131592139;Ne;6;1;0;7
244;Atžalėlės;Gėlytės;1500456945;Ne;0;0;5;5
245;Atžalėlės;Gėlytės;1722233272;Ne;0;9;0;9
246;Atžalėlės;Gėlytės;9189223222;Ne;0;6;0;6
247;Atžalėlės;Gėlytės;3283415814;Ne;0;3;0;3
248;Atžalėlės;Gėlytės;1146492807;Ne;0;0;5;5
249;Atžalėlės;Gėlytės;3870758086;Ne;0;2;1;3
250;Atžalėlės;Gėlytės;6202250600;Ne;0;0;2;2
251;Atžalėlės;Gėlytės;4098210138;Ne;7;1;2;10
252;Atžalėlės;Gėlytės;6177038838;Ne;0;1;5;6
253;Atžalėlės;Gėlytės;5742471497;Ne;7;4;1;12
254;Atžalėlės;Gėlytės;1137741059;Ne;5;0;2;7
255;Atžalėlės;Gėlytės;4238773173;Ne;6;1;0;7
256;Atžalėlės;Gėlytės;1036410428;Ne;0;0;1;1
257;Atžalėlės;Gėlytės;6597540627;Ne;0;0;3;3
258;Atžalėlės;Drugeliai;6903666624;Ne;2;0;0;2
259;Atžalėlės;Drugeliai;2315790531;Ne;0;2;0;2
260;Atžalėlės;Drugeliai;6782007470;Ne;0;11;0;11
261;Atžalėlės;Drugeliai;1805496887;Ne;0;6;6;12
262;Atžalėlės;Drugeliai;7953922166;Ne;0;1;0;1
263;Atžalėlės;Drugeliai;5147078840;Ne;0;4;0;4
264;Atžalėlės;Drugeliai;9222670655;Ne;0;1;0;1
265;Atžalėlės;Drugeliai;1429493246;Ne;0;4;0;4
266;Atžalėlės;Drugeliai;6114426973;Ne;0;8;0;8
267;Atžalėlės;Drugeliai;1456979448;Ne;0;5;0;5
268;Atžalėlės;Drugeliai;4032519781;Ne;17;0;0;17
269;Atžalėlės;Drugeliai;7756889911;Ne;0;1;0;1
270;Atžalėlės;Drugeliai;5063094678;Ne;0;1;2;3
271;Atžalėlės;Drugeliai;3422605135;Ne;0;1;1;2
272;Atžalėlės;Drugeliai;8718036014;Ne;0;2;11;13
273;Atžalėlės;Drugeliai;4884599397;Ne;0;2;11;13
274;Atžalėlės;Drugeliai;4902947406;Ne;0;1;2;3
275;Atžalėlės;Drugeliai;6695872204;Ne;0;4;0;4
276;Atžalėlės;Drugeliai;6393090675;Ne;5;1;0;6
277;Atžalėlės;Gandriukai;2083260403;Ne;0;14;0;14
278;Atžalėlės;Gandriukai;3692090073;Ne;8;0;0;8
279;Atžalėlės;Gandriukai;2078549599;Ne;0;0;1;1
280;Atžalėlės;Gandriukai;5119260525;Taip;4;0;0;4
281;Atžalėlės;Gandriukai;1024559742;Ne;7;0;0;7
282;Atžalėlės;Gandriukai;7510951079;Taip;7;8;0;15
283;Atžalėlės;Gandriukai;6594440062;Ne;11;0;0;11
284;Atžalėlės;Gandriukai;4293557144;Ne;0;9;0;9
285;Atžalėlės;Gandriukai;6211002805;Ne;0;0;3;3
286;Atžalėlės;Gandriukai;1305611902;Ne;0;0;1;1
287;Atžalėlės;Voveriukai;1865339755;Ne;0;5;1;6
288;Atžalėlės;Voveriukai;4467364336;Ne;0;0;7;7
289;Atžalėlės;Voveriukai;9699811980;Ne;1;7;0;8
290;Atžalėlės;Voveriukai;8847754477;Ne;0;4;0;4
291;Atžalėlės;Voveriukai;3795729265;Ne;4;0;1;5
292;Atžalėlės;Voveriukai;8201582382;Ne;0;0;5;5
293;Atžalėlės;Voveriukai;4362058013;Ne;0;0;5;5
294;Atžalėlės;Voveriukai;8819893830;Ne;0;0;8;8
295;Atžalėlės;Voveriukai;3069192413;Ne;0;0;3;3
296;Atžalėlės;Voveriukai;2067246260;Ne;0;0;10;10
297;Atžalėlės;Voveriukai;5705303891;Taip;0;3;0;3
298;Atžalėlės;Voveriukai;5650427433;Ne;0;1;0;1
299;Atžalėlės;Voveriukai;1316154666;Ne;0;0;6;6
300;Atžalėlės;Voveriukai;6975941393;Ne;0;0;1;1
301;Atžalėlės;Voveriukai;8138683218;Ne;8;2;0;10
302;Atžalėlės;Voveriukai;7689394485;Ne;1;0;13;14
303;Atžalėlės;Voveriukai;4996777116;Ne;0;0;1;1
304;Atžalėlės;Voveriukai;6684979914;Ne;5;0;2;7
305;Atžalėlės;Voveriukai;8470059012;Ne;0;0;7;7
306;Atžalėlės;Voveriukai;5767549779;Ne;5;5;0;10
307;Atžalėlės;Žirniukai;2374624441;Ne;0;2;0;2
308;Atžalėlės;Žirniukai;9707462467;Ne;0;10;0;10
309;Atžalėlės;Žirniukai;5584105084;Ne;0;0;6;6
310;Atžalėlės;Žirniukai;9677943321;Ne;0;0;2;2
311;Atžalėlės;Žirniukai;9967641617;Ne;0;4;0;4
312;Atžalėlės;Žirniukai;9508110719;Ne;8;0;3;11
313;Atžalėlės;Žirniukai;9085453655;Ne;0;2;0;2
314;Atžalėlės;Žirniukai;1538643591;Ne;9;9;4;22
315;Atžalėlės;Žirniukai;3143856911;Ne;0;7;0;7
316;Atžalėlės;Žirniukai;1212074068;Ne;6;0;0;6
317;Atžalėlės;Žirniukai;9736390705;Ne;10;0;1;11
318;Atžalėlės;Žirniukai;4661388894;Ne;2;0;0;2
319;Atžalėlės;Žirniukai;5319794176;Ne;0;0;2;2
320;Atžalėlės;Žirniukai;7196464328;Ne;0;13;0;13
321;Atžalėlės;Žirniukai;7522643082;Ne;0;2;1;3
322;Atžalėlės;Žirniukai;7613931447;Ne;0;2;1;3
323;Atžalėlės;Žirniukai;6723689098;Ne;0;1;2;3
324;Atžalėlės;Žirniukai;9281138840;Ne;14;1;0;15
325;Atžalėlės;Žirniukai;7018297883;Ne;0;2;0;2
326;Atžalėlės;Ežiukai;4227804985;Ne;0;0;2;2
327;Atžalėlės;Ežiukai;9053620501;Ne;0;0;6;6
328;Atžalėlės;Ežiukai;9054589111;Ne;4;7;0;11
329;Atžalėlės;Ežiukai;9346744866;Taip;0;3;0;3
330;Atžalėlės;Ežiukai;1505286928;Ne;10;9;0;19
331;Atžalėlės;Ežiukai;4148412941;Ne;0;1;0;1
332;Atžalėlės;Ežiukai;3333808381;Ne;8;0;0;8
333;Atžalėlės;Ežiukai;1710646812;Ne;0;0;4;4
334;Atžalėlės;Ežiukai;6447615639;Ne;6;0;3;9
335;Atžalėlės;Ežiukai;5972419628;Ne;3;7;0;10
336;Atžalėlės;Ežiukai;3738127350;Ne;5;0;1;6
337;Atžalėlės;Ežiukai;1423254771;Ne;0;0;4;4
338;Atžalėlės;Ežiukai;6108989129;Ne;0;0;1;1
339;Atžalėlės;Ežiukai;5174826594;Ne;0;0;2;2
340;Atžalėlės;Ežiukai;7501772398;Ne;0;0;5;5
341;Atžalėlės;Paukšteliai;7807313362;Ne;0;1;0;1
342;Atžalėlės;Paukšteliai;6537864486;Ne;0;0;1;1
343;Atžalėlės;Paukšteliai;8768704484;Ne;0;0;18;18
344;Atžalėlės;Paukšteliai;6675588261;Ne;0;0;18;18
345;Atžalėlės;Paukšteliai;8524244526;Ne;7;4;1;12
346;Atžalėlės;Paukšteliai;6873507667;Ne;3;0;0;3
347;Atžalėlės;Paukšteliai;7321516783;Ne;0;0;6;6
348;Atžalėlės;Paukšteliai;6265777690;Ne;4;0;0;4
349;Atžalėlės;Paukšteliai;1844980319;Ne;0;10;0;10
350;Atžalėlės;Paukšteliai;5997958773;Ne;0;9;0;9
351;Atžalėlės;Paukšteliai;8512283024;Ne;0;1;0;1
352;Atžalėlės;Paukšteliai;2078781673;Ne;5;1;1;7
353;Atžalėlės;Paukšteliai;1520206753;Ne;10;0;18;28
354;Atžalėlės;Paukšteliai;4790322154;Ne;4;1;0;5
355;Atžalėlės;Paukšteliai;4081717007;Ne;5;0;1;6
356;Atžalėlės;Paukšteliai;4392352210;Ne;2;0;10;12
357;Atžalėlės;Paukšteliai;1774212280;Ne;22;0;0;22
358;Atžalėlės;Meškiukai;8586739429;Ne;0;2;0;2
359;Atžalėlės;Meškiukai;9925178685;Ne;0;0;1;1
360;Atžalėlės;Meškiukai;2617568019;Ne;11;0;0;11
361;Atžalėlės;Meškiukai;4233689945;Ne;0;0;1;1
362;Atžalėlės;Meškiukai;8619613890;Ne;0;0;1;1
363;Atžalėlės;Meškiukai;3281114596;Ne;0;8;0;8
364;Atžalėlės;Meškiukai;5466374223;Ne;0;0;2;2
365;Atžalėlės;Meškiukai;2433029299;Ne;5;0;4;9
366;Atžalėlės;Meškiukai;5682652546;Ne;0;0;18;18
367;Atžalėlės;Meškiukai;9631336340;Ne;0;1;0;1
368;Atžalėlės;Meškiukai;2930612059;Ne;2;0;20;22
369;Atžalėlės;Meškiukai;6385777303;Ne;4;0;1;5
370;Atžalėlės;Meškiukai;2569491645;Ne;4;0;0;4
371;Atžalėlės;Meškiukai;1431197358;Ne;0;7;0;7
372;Atžalėlės;Meškiukai;4177753994;Ne;0;0;4;4
373;Atžalėlės;Meškiukai;3982090601;Ne;0;0;1;1
374;Atžalėlės;Meškiukai;3743308789;Ne;0;1;0;1
375;Atžalėlės;Meškiukai;7936991925;Ne;0;0;2;2
376;Atžalėlės;Meškiukai;8976815736;Ne;6;3;0;9
377;Atžalėlės;"BITUTĖS (MODULINĖ)";8707875125;Ne;8;6;0;14
378;Atžalėlės;"BITUTĖS (MODULINĖ)";8060332402;Ne;17;0;0;17
379;Atžalėlės;"BITUTĖS (MODULINĖ)";8396693160;Ne;0;1;0;1
380;Atžalėlės;"BITUTĖS (MODULINĖ)";6253257539;Ne;11;0;0;11
381;Atžalėlės;"BITUTĖS (MODULINĖ)";7052938312;Ne;6;1;0;7
382;Atžalėlės;"BITUTĖS (MODULINĖ)";3559977339;Ne;3;0;2;5
383;Atžalėlės;"BITUTĖS (MODULINĖ)";5593774275;Ne;17;0;0;17
384;Atžalėlės;"BITUTĖS (MODULINĖ)";1939076303;Ne;0;0;5;5
385;Atžalėlės;"BITUTĖS (MODULINĖ)";2322329918;Ne;5;0;0;5
386;Atžalėlės;"BITUTĖS (MODULINĖ)";6368553568;Ne;0;1;4;5
387;Atžalėlės;"BITUTĖS (MODULINĖ)";5148142239;Ne;0;10;0;10
388;Atžalėlės;"BITUTĖS (MODULINĖ)";5511148178;Ne;11;0;0;11
389;Atžalėlės;"ŠYPSENĖLĖS (MODULINĖ)";4071402757;Ne;5;0;0;5
390;Atžalėlės;"ŠYPSENĖLĖS (MODULINĖ)";1943349835;Ne;0;0;4;4
391;Atžalėlės;"ŠYPSENĖLĖS (MODULINĖ)";8564143904;Ne;0;1;8;9
392;Atžalėlės;"ŠYPSENĖLĖS (MODULINĖ)";7159628246;Ne;0;0;1;1
393;Atžalėlės;"ŠYPSENĖLĖS (MODULINĖ)";3299724612;Ne;11;2;0;13
394;Atžalėlės;"BORUŽIUKAI (MODULINĖ)";7104671423;Ne;10;0;4;14
395;Atžalėlės;"BORUŽIUKAI (MODULINĖ)";3198845538;Ne;5;0;0;5
396;Atžalėlės;"BORUŽIUKAI (MODULINĖ)";8681809797;Ne;13;0;0;13
397;Atžalėlės;"BORUŽIUKAI (MODULINĖ)";3590987364;Ne;5;0;1;6
398;Atžalėlės;"BORUŽIUKAI (MODULINĖ)";6237597328;Ne;5;0;0;5
399;Atžalėlės;"BORUŽIUKAI (MODULINĖ)";1383944713;Ne;10;0;0;10
400;Atžalėlės;"BORUŽIUKAI (MODULINĖ)";5582697993;Ne;2;0;0;2
401;Atžalėlės;"BORUŽIUKAI (MODULINĖ)";9201449702;Ne;4;0;0;4
402;Atžalėlės;"BORUŽIUKAI (MODULINĖ)";7980775632;Ne;0;18;0;18
403;Atžalėlės;"SAULUTĖS (MODULINĖ)";3408850663;Ne;3;0;0;3
404;Atžalėlės;"SAULUTĖS (MODULINĖ)";4268941401;Ne;7;0;15;22
405;Atžalėlės;"SAULUTĖS (MODULINĖ)";1797932125;Ne;10;0;0;10
406;Atžalėlės;"SAULUTĖS (MODULINĖ)";2306086573;Ne;0;0;5;5
407;Atžalėlės;"SAULUTĖS (MODULINĖ)";8460997063;Ne;0;2;0;2
408;Atžalėlės;"SAULUTĖS (MODULINĖ)";5490741021;Ne;5;2;7;14
409;Atžalėlės;"SAULUTĖS (MODULINĖ)";8208908249;Ne;17;4;0;21
410;Atžalėlės;"SAULUTĖS (MODULINĖ)";6048763811;Ne;7;5;0;12
411;Aušrelė;PASAKIUKAI;1659335142;Ne;0;3;0;3
412;Aušrelė;PASAKIUKAI;1327431679;Ne;5;0;0;5
413;Aušrelė;PASAKIUKAI;6037757548;Ne;0;0;1;1
414;Aušrelė;PASAKIUKAI;1408751702;Ne;0;4;0;4
415;Aušrelė;PASAKIUKAI;1502146844;Ne;0;1;0;1
416;Aušrelė;PASAKIUKAI;8341539501;Ne;0;1;1;2
417;Aušrelė;PASAKIUKAI;8230362307;Ne;5;0;0;5
418;Aušrelė;PASAKIUKAI;5777214701;Ne;5;0;0;5
419;Aušrelė;PASAKIUKAI;6277405405;Ne;0;6;0;6
420;Aušrelė;PASAKIUKAI;3682523696;Ne;3;0;0;3
421;Aušrelė;PASAKIUKAI;34891640909;Ne;4;6;0;10
422;Aušrelė;PASAKIUKAI;2125080379;Ne;0;0;13;13
423;Aušrelė;PASAKIUKAI;3165692699;Ne;0;3;0;3
424;Aušrelė;BORUŽĖLĖS;6673034329;Ne;7;1;0;8
425;Aušrelė;BORUŽĖLĖS;4957581753;Ne;0;2;0;2
426;Aušrelė;BORUŽĖLĖS;1928260563;Ne;0;2;0;2
427;Aušrelė;BORUŽĖLĖS;8243716759;Ne;0;7;1;8
428;Aušrelė;BORUŽĖLĖS;1549962200;Ne;0;2;0;2
429;Aušrelė;BORUŽĖLĖS;4505922394;Ne;0;0;5;5
430;Aušrelė;BORUŽĖLĖS;2991828434;Ne;0;0;3;3
431;Aušrelė;BORUŽĖLĖS;8030685444;Ne;0;2;0;2
432;Aušrelė;BORUŽĖLĖS;1814972981;Ne;0;2;8;10
433;Aušrelė;BORUŽĖLĖS;3397741232;Ne;0;8;0;8
434;Aušrelė;SMALSUČIAI;6761263775;Ne;0;9;0;9
435;Aušrelė;SMALSUČIAI;3015028879;Ne;0;22;0;22
436;Aušrelė;SMALSUČIAI;2863655361;Ne;0;1;0;1
437;Aušrelė;SMALSUČIAI;2390128933;Ne;0;0;1;1
438;Aušrelė;SMALSUČIAI;2827216981;Ne;0;5;0;5
439;Aušrelė;SMALSUČIAI;9443641849;Ne;0;13;0;13
440;Aušrelė;SMALSUČIAI;7930717076;Ne;5;2;1;8
441;Aušrelė;SMALSUČIAI;7609339123;Ne;9;0;0;9
442;Aušrelė;SMALSUČIAI;1556010005;Ne;0;0;1;1
443;Aušrelė;SMALSUČIAI;5478028396;Ne;3;7;0;10
444;Aušrelė;SMALSUČIAI;7070013052;Ne;0;4;0;4
445;Aušrelė;SMALSUČIAI;3581155949;Ne;0;7;2;9
446;Aušrelė;SMALSUČIAI;6507218940;Ne;0;1;0;1
447;Aušrelė;SMALSUČIAI;2266390402;Ne;0;2;0;2
448;Aušrelė;SMALSUČIAI;8032661062;Ne;0;0;2;2
449;Aušrelė;SMALSUČIAI;4262596104;Ne;0;4;0;4
450;Aušrelė;SMALSUČIAI;1976613166;Ne;0;11;6;17
451;Aušrelė;KODĖLČIUKAI;7723159748;Ne;17;0;0;17
452;Aušrelė;KODĖLČIUKAI;7367268748;Ne;0;1;0;1
453;Aušrelė;KODĖLČIUKAI;5712867880;Ne;0;0;2;2
454;Aušrelė;KODĖLČIUKAI;3623813061;Ne;7;2;0;9
455;Aušrelė;KODĖLČIUKAI;4288695809;Ne;1;0;0;1
456;Aušrelė;KODĖLČIUKAI;9566144610;Ne;0;0;2;2
457;Aušrelė;KODĖLČIUKAI;6308519574;Ne;0;8;0;8
458;Aušrelė;KODĖLČIUKAI;6186758486;Ne;0;0;1;1
459;Aušrelė;KODĖLČIUKAI;3320399046;Ne;0;1;4;5
460;Aušrelė;KODĖLČIUKAI;6911735462;Ne;12;2;0;14
461;Aušrelė;KODĖLČIUKAI;5046027475;Ne;0;0;1;1
462;Aušrelė;KODĖLČIUKAI;8338569001;Ne;0;0;5;5
463;Aušrelė;KODĖLČIUKAI;2766357229;Ne;6;0;0;6
464;Aušrelė;KODĖLČIUKAI;7515666888;Ne;0;5;0;5
465;Aušrelė;KODĖLČIUKAI;8862488358;Ne;0;1;0;1
466;Aušrelė;KODĖLČIUKAI;6321332888;Ne;0;2;5;7
467;Aušrelė;PELĖDŽIUKAI;4725588671;Ne;0;1;0;1
468;Aušrelė;PELĖDŽIUKAI;3223092149;Ne;0;15;0;15
469;Aušrelė;PELĖDŽIUKAI;8580241126;Ne;0;0;17;17
470;Aušrelė;PELĖDŽIUKAI;2545065554;Ne;0;2;2;4
471;Aušrelė;PELĖDŽIUKAI;4227228548;Ne;0;5;0;5
472;Aušrelė;PELĖDŽIUKAI;8996445434;Ne;0;5;0;5
473;Aušrelė;PELĖDŽIUKAI;8411336992;Ne;0;0;2;2
474;Aušrelė;PELĖDŽIUKAI;8917907028;Ne;5;0;0;5
475;Aušrelė;PELĖDŽIUKAI;7494298336;Ne;0;4;0;4
476;Aušrelė;PELĖDŽIUKAI;4012186237;Ne;0;0;4;4
477;Aušrelė;PELĖDŽIUKAI;5312189552;Taip;0;2;2;4
478;Aušrelė;PELĖDŽIUKAI;1642358593;Ne;0;0;1;1
479;Aušrelė;PELĖDŽIUKAI;2294224426;Ne;11;1;0;12
480;Aušrelė;PELĖDŽIUKAI;1276792874;Ne;0;0;4;4
481;Aušrelė;AITVARIUKAI;6833654667;Ne;0;1;0;1
482;Aušrelė;AITVARIUKAI;8102749675;Ne;0;7;0;7
483;Aušrelė;AITVARIUKAI;4595435635;Ne;0;6;0;6
484;Aušrelė;AITVARIUKAI;9608444990;Ne;0;2;0;2
485;Aušrelė;AITVARIUKAI;6434548772;Ne;18;0;2;20
486;Aušrelė;AITVARIUKAI;9158248746;Ne;7;2;0;9
487;Aušrelė;AITVARIUKAI;7978186455;Ne;5;7;0;12
488;Aušrelė;AITVARIUKAI;5602774323;Ne;0;8;0;8
489;Aušrelė;AITVARIUKAI;1039180129;Ne;0;8;0;8
490;Aušrelė;AITVARIUKAI;6081100604;Ne;0;1;0;1
491;Aušrelė;AITVARIUKAI;7847650967;Ne;0;4;0;4
492;Aušrelė;AITVARIUKAI;8210698019;Ne;0;22;0;22
493;Aušrelė;AITVARIUKAI;4942168388;Ne;22;0;0;22
494;Aušrelė;BITUTĖS;1741716341;Ne;0;22;0;22
495;Aušrelė;BITUTĖS;4989544273;Ne;0;2;0;2
496;Aušrelė;BITUTĖS;9960201865;Ne;0;1;0;1
497;Aušrelė;BITUTĖS;2071674661;Ne;0;19;0;19
498;Aušrelė;BITUTĖS;5598494461;Ne;0;3;0;3
499;Aušrelė;BITUTĖS;4935192851;Ne;0;5;0;5
500;Aušrelė;BITUTĖS;6591538425;Ne;0;22;0;22
501;Aušrelė;BITUTĖS;8203256528;Ne;17;1;0;18
502;Aušrelė;BITUTĖS;5741252819;Ne;17;1;0;18
503;Aušrelė;BITUTĖS;1243825974;Ne;0;1;0;1
504;Aušrelė;BITUTĖS;5266959731;Ne;0;0;1;1
505;Aušrelė;ŽIRNIUKAI;1949809977;Ne;0;6;0;6
506;Aušrelė;ŽIRNIUKAI;1544869163;Ne;1;1;0;2
507;Aušrelė;ŽIRNIUKAI;6577540623;Ne;14;0;0;14
508;Aušrelė;ŽIRNIUKAI;5460833944;Ne;12;0;3;15
509;Aušrelė;ŽIRNIUKAI;6372004855;Ne;3;2;0;5
510;Aušrelė;ŽIRNIUKAI;3713528812;Ne;8;0;0;8
511;Aušrelė;ŽIRNIUKAI;2107898976;Taip;11;1;0;12
512;Aušrelė;ŽIRNIUKAI;1607338052;Ne;0;3;0;3
513;Aušrelė;ŽIRNIUKAI;8573348956;Ne;0;22;0;22
514;Aušrelė;ŽIRNIUKAI;6463141345;Ne;0;1;0;1
515;Aušrelė;ŽIRNIUKAI;1798478023;Ne;0;6;0;6
516;Aušrelė;ŽIRNIUKAI;1754138341;Ne;0;14;0;14
517;Aušrelė;ŽIRNIUKAI;6913824678;Ne;0;1;0;1
518;Aušrelė;ŽIRNIUKAI;4591518039;Ne;0;1;0;1
519;Aušrelė;ŽIRNIUKAI;8126701466;Ne;0;8;0;8
520;Aušrelė;ŽIRNIUKAI;8833081700;Ne;1;1;0;2
521;Aušrelė;GRYBUKAI;7406063630;Ne;17;0;0;17
522;Aušrelė;GRYBUKAI;9938762910;Ne;7;0;0;7
523;Aušrelė;GRYBUKAI;8438945369;Ne;0;5;0;5
524;Aušrelė;GRYBUKAI;6672975558;Ne;0;0;1;1
525;Aušrelė;GRYBUKAI;4565813136;Ne;9;0;0;9
526;Aušrelė;GRYBUKAI;8947695521;Ne;7;0;0;7
527;Aušrelė;GRYBUKAI;7130040621;Ne;0;0;19;19
528;Aušrelė;GRYBUKAI;2311552230;Ne;7;0;10;17
529;Aušrelė;GRYBUKAI;5733298006;Ne;0;1;0;1
530;Aušrelė;GRYBUKAI;4924950592;Ne;0;2;1;3
531;Aušrelė;GRYBUKAI;2466858636;Ne;0;22;0;22
532;Aušrelė;GRYBUKAI;2873845920;Ne;0;0;6;6
533;Aušrelė;GRYBUKAI;5904797250;Ne;5;0;2;7
534;Aušrelė;DRUGELIAI;9763241451;Ne;2;0;0;2
535;Aušrelė;DRUGELIAI;1209824814;Ne;9;0;0;9
536;Aušrelė;DRUGELIAI;7948024164;Ne;9;0;0;9
537;Aušrelė;DRUGELIAI;5429867368;Ne;0;6;0;6
538;Aušrelė;DRUGELIAI;2737402297;Ne;0;0;13;13
539;Aušrelė;DRUGELIAI;3813270658;Ne;0;4;0;4
540;Aušrelė;DRUGELIAI;4254737302;Ne;3;0;0;3
541;Aušrelė;DRUGELIAI;4464947621;Ne;4;11;0;15
542;Aušrelė;DRUGELIAI;9126040500;Ne;9;0;0;9
543;Aušrelė;DRUGELIAI;7286960315;Ne;0;15;0;15
544;Aušrelė;DRUGELIAI;8102293098;Ne;12;1;0;13
545;Aušrelė;DRUGELIAI;2266835623;Ne;0;10;0;10
546;Aušrelė;DRUGELIAI;1094141305;Ne;9;1;0;10
547;Aušrelė;DRUGELIAI;9514049590;Ne;6;0;0;6
548;Aušrelė;DRUGELIAI;5709799539;Ne;0;9;0;9
549;Aušrelė;DRUGELIAI;8724802289;Ne;0;10;0;10
550;Aušrelė;DRUGELIAI;5815844340;Ne;3;3;0;6
551;Aušrelė;DRUGELIAI;5668908532;Ne;10;0;0;10
552;Aušrelė;NYKŠTUKAI;9914518299;Ne;12;0;0;12
553;Aušrelė;NYKŠTUKAI;4297417711;Ne;0;1;0;1
554;Aušrelė;NYKŠTUKAI;4004600465;Ne;0;6;0;6
555;Aušrelė;NYKŠTUKAI;7964156691;Taip;5;9;0;14
556;Aušrelė;NYKŠTUKAI;7140465960;Ne;5;3;0;8
557;Aušrelė;NYKŠTUKAI;7937067384;Ne;0;4;0;4
558;Aušrelė;NYKŠTUKAI;8099338305;Ne;12;0;0;12
559;Aušrelė;NYKŠTUKAI;6513026989;Ne;6;0;0;6
560;Aušrelė;NYKŠTUKAI;4282189556;Ne;10;8;0;18
561;Aušrelė;NYKŠTUKAI;8829298943;Ne;8;1;0;9
562;Aušrelė;NYKŠTUKAI;8378225406;Ne;12;7;0;19
563;Aušrelė;NYKŠTUKAI;5018495543;Ne;9;1;0;10
564;Aušrelė;NYKŠTUKAI;3259828075;Ne;10;0;0;10
565;Aušrelė;SPINDULIUKAI;8848358559;Ne;0;22;0;22
566;Aušrelė;SPINDULIUKAI;3194122285;Ne;0;22;0;22
567;Aušrelė;SPINDULIUKAI;5358736178;Ne;7;2;0;9
568;Aušrelė;SPINDULIUKAI;2857158437;Ne;5;8;0;13
569;Aušrelė;SPINDULIUKAI;8801906679;Ne;10;5;0;15
570;Aušrelė;SPINDULIUKAI;7208341200;Ne;0;1;0;1
571;Aušrelė;SPINDULIUKAI;1446194971;Ne;9;5;0;14
572;Aušrelė;SPINDULIUKAI;9251919940;Ne;0;0;22;22
573;Aušrelė;SPINDULIUKAI;8997650487;Ne;5;0;4;9
574;Aušrelė;SPINDULIUKAI;7966060521;Ne;0;3;0;3
575;Aušrelė;SPINDULIUKAI;5866673884;Ne;0;1;0;1
576;Aušrelė;SPINDULIUKAI;6418762623;Ne;0;1;0;1
577;Aušrelė;SPINDULIUKAI;8835689988;Ne;0;3;0;3
578;Aušrelė;SPINDULIUKAI;5274919078;Ne;0;2;0;2
579;Aušrelė;SPINDULIUKAI;2981314491;Ne;0;5;0;5
580;Aušrelė;SPINDULIUKAI;2441221298;Ne;0;22;0;22
581;Beržynėlis;SVIRPLIUKAI;7360345539;Ne;0;8;0;8
582;Beržynėlis;SVIRPLIUKAI;4134371415;Ne;0;7;0;7
583;Beržynėlis;SVIRPLIUKAI;7278860816;Ne;8;0;0;8
584;Beržynėlis;SVIRPLIUKAI;4013099670;Ne;0;1;0;1
585;Beržynėlis;SVIRPLIUKAI;8404801225;Ne;0;5;0;5
586;Beržynėlis;SVIRPLIUKAI;8303684788;Ne;0;2;0;2
587;Beržynėlis;SVIRPLIUKAI;7953957525;Ne;0;1;0;1
588;Beržynėlis;SVIRPLIUKAI;3418730586;Ne;6;2;0;8
589;Beržynėlis;SVIRPLIUKAI;1468551784;Ne;10;0;0;10
590;Beržynėlis;SVIRPLIUKAI;2221708263;Ne;11;2;0;13
591;Beržynėlis;SVIRPLIUKAI;8880151537;Ne;0;3;0;3
592;Beržynėlis;SVIRPLIUKAI;6516665294;Ne;0;2;0;2
593;Beržynėlis;SVIRPLIUKAI;9580286493;Ne;0;2;0;2
594;Beržynėlis;SVIRPLIUKAI;6673910279;Ne;7;0;0;7
595;Beržynėlis;SVIRPLIUKAI;8701990625;Ne;5;11;0;16
596;Beržynėlis;SVIRPLIUKAI;5027712732;Ne;6;2;0;8
597;Beržynėlis;SVIRPLIUKAI;7788532819;Ne;0;1;0;1
598;Beržynėlis;SVIRPLIUKAI;3315079004;Ne;12;0;0;12
599;Beržynėlis;PELEDŽIUKAI;3278699117;Ne;5;2;1;8
600;Beržynėlis;PELEDŽIUKAI;1516309509;Ne;0;4;0;4
601;Beržynėlis;PELEDŽIUKAI;1395819329;Ne;0;0;3;3
602;Beržynėlis;PELEDŽIUKAI;1838631438;Ne;10;0;0;10
603;Beržynėlis;PELEDŽIUKAI;9566341884;Ne;15;0;0;15
604;Beržynėlis;PELEDŽIUKAI;1682929565;Ne;7;0;6;13
605;Beržynėlis;PELEDŽIUKAI;7248602510;Ne;0;1;0;1
606;Beržynėlis;PELEDŽIUKAI;2681482042;Ne;0;0;5;5
607;Beržynėlis;PELEDŽIUKAI;5196910604;Ne;0;1;0;1
608;Beržynėlis;PELEDŽIUKAI;7649359221;Ne;0;1;0;1
609;Beržynėlis;PELEDŽIUKAI;6395436937;Ne;0;3;0;3
610;Beržynėlis;PELEDŽIUKAI;3641421009;Ne;7;0;0;7
611;Beržynėlis;PELEDŽIUKAI;2791734213;Ne;0;1;0;1
612;Beržynėlis;PELEDŽIUKAI;74856278886;Ne;0;2;3;5
613;Beržynėlis;PELEDŽIUKAI;1136091326;Ne;0;5;0;5
614;Beržynėlis;PELEDŽIUKAI;71505149611;Ne;0;1;0;1
615;Beržynėlis;PELEDŽIUKAI;1176943273;Ne;22;0;0;22
616;Beržynėlis;PELEDŽIUKAI;7929997884;Ne;0;4;3;7
617;Beržynėlis;PELEDŽIUKAI;8688852668;Ne;0;1;0;1
618;Beržynėlis;ŽIOGELIAI;5308596559;Ne;5;6;0;11
619;Beržynėlis;ŽIOGELIAI;4970999989;Ne;5;0;0;5
620;Beržynėlis;ŽIOGELIAI;1325972861;Ne;0;0;2;2
621;Beržynėlis;ŽIOGELIAI;9088059487;Ne;0;2;0;2
622;Beržynėlis;ŽIOGELIAI;7589778533;Ne;0;5;0;5
623;Beržynėlis;ŽIOGELIAI;8591800387;Ne;0;2;0;2
624;Beržynėlis;ŽIOGELIAI;6739927917;Ne;0;11;0;11
625;Beržynėlis;ŽIOGELIAI;2971686368;Ne;0;11;0;11
626;Beržynėlis;ŽIOGELIAI;9409317403;Ne;6;2;0;8
627;Beržynėlis;ŽIOGELIAI;9305279614;Ne;0;2;3;5
628;Beržynėlis;ŽIOGELIAI;9511051386;Ne;0;2;1;3
629;Beržynėlis;ŽIOGELIAI;5856519538;Ne;0;17;0;17
630;Beržynėlis;ŽIOGELIAI;3339522259;Ne;0;6;0;6
631;Beržynėlis;ŽIOGELIAI;6337962165;Ne;0;2;1;3
632;Beržynėlis;ŽIOGELIAI;6864823739;Ne;0;2;6;8
633;Beržynėlis;ŽIOGELIAI;9896122318;Ne;0;2;0;2
634;Beržynėlis;ŽIOGELIAI;6837130893;Ne;0;0;1;1
635;Beržynėlis;ŽIOGELIAI;3484188772;Ne;0;0;2;2
636;Beržynėlis;ŽVIRBLIUKAI;2193460960;Ne;11;2;0;13
637;Beržynėlis;ŽVIRBLIUKAI;2482395208;Ne;0;2;0;2
638;Beržynėlis;ŽVIRBLIUKAI;7057284039;Ne;5;0;0;5
639;Beržynėlis;ŽVIRBLIUKAI;2892553878;Ne;0;7;0;7
640;Beržynėlis;ŽVIRBLIUKAI;4466393687;Ne;0;11;0;11
641;Beržynėlis;ŽVIRBLIUKAI;4774769217;Ne;0;0;3;3
642;Beržynėlis;ŽVIRBLIUKAI;9503352345;Ne;0;1;0;1
643;Beržynėlis;ŽVIRBLIUKAI;8881566865;Ne;0;0;7;7
644;Beržynėlis;ŽVIRBLIUKAI;8280378527;Ne;0;9;0;9
645;Beržynėlis;ŽVIRBLIUKAI;6713134631;Ne;6;0;0;6
646;Beržynėlis;ŽVIRBLIUKAI;5593146590;Ne;0;1;0;1
647;Beržynėlis;ŽVIRBLIUKAI;9754455116;Ne;4;1;0;5
648;Beržynėlis;ŽVIRBLIUKAI;3334994408;Ne;4;9;0;13
649;Beržynėlis;ŽVIRBLIUKAI;9777841895;Ne;0;1;0;1
650;Beržynėlis;ŽVIRBLIUKAI;6293884233;Ne;0;2;0;2
651;Beržynėlis;ŽVIRBLIUKAI;4161974847;Ne;0;2;0;2
652;Beržynėlis;ŽVIRBLIUKAI;3209966996;Ne;0;5;3;8
653;Beržynėlis;ŽVIRBLIUKAI;5194416351;Ne;0;1;0;1
654;Beržynėlis;ŽVIRBLIUKAI;5189335842;Ne;15;0;0;15
655;Beržynėlis;ŽIRNIUKAI;6932094459;Ne;0;10;0;10
656;Beržynėlis;ŽIRNIUKAI;5864265458;Ne;0;11;0;11
657;Beržynėlis;ŽIRNIUKAI;2583982025;Ne;0;3;0;3
658;Beržynėlis;ŽIRNIUKAI;7870888327;Ne;8;0;0;8
659;Beržynėlis;ŽIRNIUKAI;9603272698;Ne;12;3;2;17
660;Beržynėlis;ŽIRNIUKAI;9493489114;Ne;12;3;2;17
661;Beržynėlis;ŽIRNIUKAI;4786786104;Ne;5;5;0;10
662;Beržynėlis;ŽIRNIUKAI;4944466205;Ne;9;1;0;10
663;Beržynėlis;ŽIRNIUKAI;2155662035;Ne;12;0;0;12
664;Beržynėlis;ŽIRNIUKAI;4978363316;Ne;16;1;0;17
665;Beržynėlis;ŽIRNIUKAI;6845342905;Ne;0;0;3;3
666;Beržynėlis;ŽIRNIUKAI;7806800327;Taip;17;0;0;17
667;Beržynėlis;ŽIRNIUKAI;2154631640;Ne;12;0;0;12
668;Beržynėlis;VIŠČIUKAI;7903644161;Ne;3;0;0;3
669;Beržynėlis;VIŠČIUKAI;1707585750;Ne;2;0;0;2
670;Beržynėlis;VIŠČIUKAI;4382068779;Ne;0;0;1;1
671;Beržynėlis;VIŠČIUKAI;2272661119;Ne;7;4;0;11
672;Beržynėlis;VIŠČIUKAI;1831776326;Ne;16;0;0;16
673;Beržynėlis;VIŠČIUKAI;1118349439;Ne;5;0;0;5
674;Beržynėlis;VIŠČIUKAI;4369803044;Ne;0;2;0;2
675;Beržynėlis;VIŠČIUKAI;7972993168;Ne;0;1;0;1
676;Beržynėlis;VIŠČIUKAI;5049057730;Ne;4;0;0;4
677;Beržynėlis;VIŠČIUKAI;7084666673;Ne;0;1;0;1
678;Beržynėlis;VIŠČIUKAI;6592330036;Ne;12;0;0;12
679;Beržynėlis;VIŠČIUKAI;3100097647;Ne;7;0;2;9
680;Birutės;SKRUZDELIUKŲ;4968068043;Ne;0;10;2;12
681;Birutės;SKRUZDELIUKŲ;1761065941;Ne;0;2;0;2
682;Birutės;SKRUZDELIUKŲ;4027700332;Ne;3;0;3;6
683;Birutės;SKRUZDELIUKŲ;7685356079;Ne;2;0;0;2
684;Birutės;SKRUZDELIUKŲ;8636113039;Ne;0;5;2;7
685;Birutės;SKRUZDELIUKŲ;9411016611;Ne;0;2;0;2
686;Birutės;SKRUZDELIUKŲ;7119951690;Ne;6;0;0;6
687;Birutės;SKRUZDELIUKŲ;5154903444;Ne;0;0;1;1
688;Birutės;SKRUZDELIUKŲ;9541516589;Ne;0;10;6;16
689;Birutės;SKRUZDELIUKŲ;6815916679;Ne;10;1;0;11
690;Birutės;SKRUZDELIUKŲ;9187671201;Ne;2;1;9;12
691;Birutės;SKRUZDELIUKŲ;7404631298;Ne;0;0;1;1
692;Birutės;SKRUZDELIUKŲ;8432173636;Ne;4;0;0;4
693;Birutės;SKRUZDELIUKŲ;9904827482;Ne;0;2;0;2
694;Birutės;SKRUZDELIUKŲ;2140552221;Ne;0;0;1;1
695;Birutės;SKRUZDELIUKŲ;8413760872;Taip;4;1;0;5
696;Birutės;SKRUZDELIUKŲ;7940403585;Ne;0;2;0;2
697;Birutės;SKRUZDELIUKŲ;2859160609;Ne;0;6;0;6
698;Birutės;SKRUZDELIUKŲ;4375683234;Ne;0;0;7;7
699;Birutės;BITUČIŲ;33770983649;Ne;10;0;3;13
700;Birutės;BITUČIŲ;87693588654;Ne;0;2;0;2
701;Birutės;BITUČIŲ;2975442228;Ne;8;0;0;8
702;Birutės;BITUČIŲ;98391790116;Ne;0;6;0;6
703;Birutės;BITUČIŲ;5947971037;Ne;0;3;0;3
704;Birutės;BITUČIŲ;3870702348;Ne;0;1;0;1
705;Birutės;BITUČIŲ;3436637062;Ne;0;6;0;6
706;Birutės;BITUČIŲ;8465645434;Ne;4;0;0;4
707;Birutės;BITUČIŲ;9722922540;Ne;2;0;0;2
708;Birutės;BITUČIŲ;6081472534;Ne;4;0;0;4
709;Birutės;BITUČIŲ;2674259453;Ne;0;0;7;7
710;Birutės;BITUČIŲ;17865476849;Ne;3;1;2;6
711;Birutės;BITUČIŲ;1243603625;Ne;0;0;1;1
712;Birutės;BITUČIŲ;4253571334;Ne;2;0;0;2
713;Birutės;BITUČIŲ;1447494370;Ne;0;0;1;1
714;Birutės;BORUŽIUKAI;5893851353;Ne;0;0;2;2
715;Birutės;BORUŽIUKAI;5457357625;Ne;2;0;0;2
716;Birutės;BORUŽIUKAI;5869137292;Ne;7;1;2;10
717;Birutės;BORUŽIUKAI;5026442722;Ne;5;2;0;7
718;Birutės;BORUŽIUKAI;6977276295;Ne;5;1;0;6
719;Birutės;BORUŽIUKAI;9289922622;Ne;0;0;3;3
720;Birutės;BORUŽIUKAI;1776142202;Ne;0;0;3;3
721;Birutės;BORUŽIUKAI;8011210158;Ne;0;1;0;1
722;Birutės;BORUŽIUKAI;4906874758;Ne;0;10;1;11
723;Birutės;BORUŽIUKAI;9263238557;Ne;0;1;0;1
724;Birutės;BORUŽIUKAI;4488481136;Ne;0;0;2;2
725;Birutės;BORUŽIUKAI;6460415179;Ne;6;0;0;6
726;Birutės;BORUŽIUKAI;6973898557;Ne;0;4;0;4
727;Birutės;BORUŽIUKAI;7033907787;Ne;5;0;0;5
728;Birutės;BORUŽIUKAI;5745377474;Ne;6;0;0;6
729;Birutės;BORUŽIUKAI;5897671273;Ne;9;0;6;15
730;Birutės;BORUŽIUKAI;2016711225;Ne;10;0;1;11
731;Birutės;BORUŽIUKAI;1400510886;Ne;3;5;0;8
732;Birutės;BORUŽIUKAI;7494879160;Ne;9;0;0;9
733;Birutės;BORUŽIUKAI;7398022393;Taip;0;0;2;2
734;Birutės;BORUŽIUKAI;7712882120;Ne;3;0;3;6
735;Birutės;BORUŽIUKAI;7741922416;Ne;0;13;0;13
736;Birutės;BORUŽIUKAI;2681370776;Ne;1;0;0;1
737;Birutės;DRUGELIAI;8854957814;Ne;0;0;7;7
738;Birutės;DRUGELIAI;6263985683;Ne;13;0;2;15
739;Birutės;DRUGELIAI;4995437657;Ne;0;0;6;6
740;Birutės;DRUGELIAI;5957267018;Ne;0;0;7;7
741;Birutės;DRUGELIAI;1442496209;Ne;11;1;0;12
742;Birutės;DRUGELIAI;2318034045;Ne;13;0;1;14
743;Birutės;DRUGELIAI;9727836236;Ne;10;0;0;10
744;Birutės;DRUGELIAI;3516719248;Ne;0;0;5;5
745;Birutės;DRUGELIAI;5688633357;Ne;0;2;10;12
746;Birutės;DRUGELIAI;8559820030;Ne;0;0;20;20
747;Birutės;DRUGELIAI;9863681147;Ne;0;0;2;2
748;Birutės;DRUGELIAI;9307655828;Ne;18;0;0;18
749;Birutės;DRUGELIAI;3115571205;Ne;6;0;4;10
750;Birutės;DRUGELIAI;4674152995;Ne;11;0;1;12
751;Birutės;DRUGELIAI;3391101786;Ne;2;0;0;2
752;Birutės;DRUGELIAI;7876057712;Ne;0;0;1;1
753;Birutės;DRUGELIAI;6765257633;Ne;8;0;0;8
754;Birutės;DRUGELIAI;2257683802;Ne;4;0;2;6
755;Birutės;DRUGELIAI;7336936451;Ne;0;9;0;9
756;Bitutė;Aitvariukų;4474600934;Ne;0;0;4;4
757;Bitutė;Aitvariukų;5606049201;Taip;2;1;0;3
758;Bitutė;Aitvariukų;6035394425;Taip;11;1;0;12
759;Bitutė;Aitvariukų;7132616264;Ne;0;5;0;5
760;Bitutė;Aitvariukų;8796728627;Ne;10;2;0;12
761;Bitutė;Aitvariukų;6030674568;Ne;7;0;3;10
762;Bitutė;Aitvariukų;9747786638;Ne;10;0;3;13
763;Bitutė;Aitvariukų;8259512455;Ne;0;5;4;9
764;Bitutė;Aitvariukų;9106644834;Ne;0;17;0;17
765;Bitutė;Aitvariukų;2899217019;Ne;10;4;3;17
766;Bitutė;Aitvariukų;8670124052;Ne;0;1;1;2
767;Bitutė;Aitvariukų;6759511692;Ne;0;0;1;1
768;Bitutė;Aitvariukų;4164058783;Ne;2;22;0;24
769;Bitutė;Aitvariukų;8908052679;Ne;9;13;0;22
770;Bitutė;Aitvariukų;4924483609;Ne;5;5;0;10
771;Bitutė;Aitvariukų;7447624247;Taip;0;8;0;8
772;Bitutė;Aitvariukų;5880651175;Ne;0;2;0;2
773;Bitutė;Ežiukų;56287634684;Ne;0;0;1;1
774;Bitutė;Ežiukų;5126303823;Ne;7;4;0;11
775;Bitutė;Ežiukų;4764586168;Ne;0;8;4;12
776;Bitutė;Ežiukų;8905075899;Ne;10;3;0;13
777;Bitutė;Ežiukų;3600670185;Ne;5;0;0;5
778;Bitutė;Ežiukų;6341806464;Ne;0;18;1;19
779;Bitutė;Ežiukų;7456328992;Ne;0;8;0;8
780;Bitutė;Ežiukų;2812580726;Ne;7;5;5;17
781;Bitutė;Ežiukų;8186706520;Ne;0;32;0;32
782;Bitutė;Ežiukų;5378885117;Ne;2;0;0;2
783;Bitutė;Ežiukų;2122052883;Ne;0;4;0;4
784;Bitutė;Ežiukų;4444523140;Ne;0;19;0;19
785;Bitutė;Ežiukų;4024758152;Ne;0;5;0;5
786;Bitutė;Ežiukų;6194712643;Ne;0;5;0;5
787;Bitutė;Ežiukų;4468366941;Ne;10;7;0;17
788;Bitutė;Ežiukų;5188828679;Ne;0;1;0;1
789;Bitutė;Ežiukų;8109028957;Ne;0;1;0;1
790;Bitutė;Ežiukų;3156654672;Ne;3;4;1;8
791;Bitutė;Žvirbliukų;7047262367;Ne;0;2;1;3
792;Bitutė;Žvirbliukų;3804171750;Ne;0;1;0;1
793;Bitutė;Žvirbliukų;5406667195;Ne;0;5;1;6
794;Bitutė;Žvirbliukų;4458990772;Ne;0;7;0;7
795;Bitutė;Žvirbliukų;3723040682;Ne;15;7;0;22
796;Bitutė;Žvirbliukų;2190439190;Ne;0;13;0;13
797;Bitutė;Žvirbliukų;7113693496;Ne;12;10;0;22
798;Bitutė;Žvirbliukų;4177331531;Ne;0;1;1;2
799;Bitutė;Žvirbliukų;2483462846;Ne;0;17;0;17
800;Bitutė;Žvirbliukų;7678106084;Ne;0;5;0;5
801;Bitutė;Žvirbliukų;6044969600;Ne;0;5;0;5
802;Bitutė;Žvirbliukų;2444289145;Ne;0;3;0;3
803;Bitutė;Žvirbliukų;3517750478;Ne;0;5;0;5
804;Bitutė;Žvirbliukų;5291764696;Ne;0;3;0;3
805;Bitutė;Žvirbliukų;9523588597;Ne;0;0;1;1
806;Bitutė;Žvirbliukų;3654065124;Ne;0;5;0;5
807;Bitutė;Žvirbliukų;9166624750;Ne;12;1;1;14
808;Bitutė;Žvirbliukų;8373105196;Ne;0;13;3;16
809;Bitutė;Žvirbliukų;6014726741;Ne;0;3;0;3
810;Bitutė;Žvirbliukų;4527880105;Ne;0;9;4;13
811;Bitutė;Žvirbliukų;9834697190;Ne;0;3;0;3
812;Bitutė;Gandriukų;8519978626;Ne;0;20;2;22
813;Bitutė;Gandriukų;1809034174;Ne;0;7;0;7
814;Bitutė;Gandriukų;6586888742;Ne;0;10;0;10
815;Bitutė;Gandriukų;5783154071;Ne;0;4;0;4
816;Bitutė;Gandriukų;7387822939;Ne;0;11;0;11
817;Bitutė;Gandriukų;6052204491;Ne;0;9;0;9
818;Bitutė;Gandriukų;37105491775;Ne;0;7;0;7
819;Bitutė;Gandriukų;90943054285;Ne;0;16;0;16
820;Bitutė;Gandriukų;9683582019;Ne;0;3;0;3
821;Bitutė;Gandriukų;11567978993;Ne;0;22;0;22
822;Bitutė;Gandriukų;2350260809;Ne;0;9;0;9
823;Bitutė;Gandriukų;27144303911;Ne;0;6;0;6
824;Bitutė;Gandriukų;1942685472;Ne;0;12;0;12
825;Bitutė;Gandriukų;1307749129;Ne;0;12;0;12
826;Bitutė;Gandriukų;5653055907;Ne;0;1;0;1
827;Bitutė;Gandriukų;6678928989;Ne;0;8;0;8
828;Bitutė;Gandriukų;1802887869;Ne;0;10;0;10
829;Bitutė;Gandriukų;51054491845;Ne;0;5;0;5
830;Bitutė;Gandriukų;47316276655;Ne;0;17;0;17
831;Bitutė;Pelėdžiukai;3254061362;Ne;0;4;0;4
832;Bitutė;Pelėdžiukai;5455919343;Ne;0;2;0;2
833;Bitutė;Pelėdžiukai;8743734366;Ne;4;15;0;19
834;Bitutė;Pelėdžiukai;2804203556;Ne;0;16;0;16
835;Bitutė;Pelėdžiukai;8394685672;Ne;0;2;0;2
836;Bitutė;Pelėdžiukai;7056737587;Ne;0;2;0;2
837;Bitutė;Pelėdžiukai;4985270536;Ne;0;7;0;7
838;Bitutė;Pelėdžiukai;1590501589;Ne;0;7;1;8
839;Bitutė;Pelėdžiukai;3796188100;Ne;0;3;1;4
840;Bitutė;Pelėdžiukai;1564763789;Ne;0;5;0;5
841;Bitutė;Pelėdžiukai;1846974702;Ne;0;3;1;4
842;Bitutė;Pelėdžiukai;5679397165;Ne;0;0;1;1
843;Bitutė;Pelėdžiukai;3432065233;Ne;3;3;0;6
844;Bitutė;Pelėdžiukai;1560715159;Ne;3;0;0;3
845;Bitutė;Pelėdžiukai;2518730247;Ne;6;6;0;12
846;Bitutė;Pelėdžiukai;5810344229;Ne;0;1;0;1
847;Bitutė;Pelėdžiukai;3227252972;Ne;4;2;1;7
848;Bitutė;Boružėlių;8276590981;Ne;0;0;21;21
849;Bitutė;Boružėlių;7503203424;Ne;7;0;3;10
850;Bitutė;Boružėlių;8355346371;Ne;0;0;3;3
851;Bitutė;Boružėlių;2583001947;Ne;15;0;2;17
852;Bitutė;Boružėlių;9545405359;Ne;0;0;5;5
853;Bitutė;Boružėlių;2129484313;Ne;4;5;0;9
854;Bitutė;Boružėlių;9691450767;Ne;0;0;8;8
855;Bitutė;Boružėlių;3170266155;Ne;0;0;6;6
856;Bitutė;Boružėlių;6455582149;Ne;7;0;0;7
857;Bitutė;Boružėlių;2144809294;Ne;4;0;2;6
858;Bitutė;Boružėlių;8011051470;Ne;0;0;10;10
859;Bitutė;Boružėlių;9521938997;Ne;4;0;0;4
860;Bitutė;Boružėlių;9668365838;Ne;4;2;0;6
861;Bitutė;Boružėlių;7095475821;Taip;0;5;0;5
862;Bitutė;Boružėlių;6255439813;Ne;7;1;5;13
863;Bitutė;Boružėlių;2623999429;Ne;0;3;0;3
864;Bitutė;Boružėlių;6840722112;Ne;0;0;3;3
865;Bitutė;Boružėlių;4884898917;Ne;0;2;0;2
866;Bitutė;Boružėlių;4869423833;Ne;0;0;5;5
867;Bitutė;Boružėlių;5071978105;Ne;9;0;1;10
868;Bitutė;Šokliukų;8211710975;Ne;0;10;0;10
869;Bitutė;Šokliukų;8872286273;Ne;4;7;0;11
870;Bitutė;Šokliukų;5169768042;Ne;10;4;0;14
871;Bitutė;Šokliukų;4917599786;Taip;2;5;0;7
872;Bitutė;Šokliukų;1348548294;Ne;0;5;0;5
873;Bitutė;Šokliukų;7318555933;Ne;5;3;0;8
874;Bitutė;Šokliukų;1012702386;Ne;0;12;0;12
875;Bitutė;Šokliukų;9924340801;Ne;7;21;0;28
876;Bitutė;Šokliukų;7165511381;Ne;0;9;0;9
877;Bitutė;Šokliukų;9465186207;Ne;5;9;0;14
878;Bitutė;Šokliukų;2853616585;Ne;0;7;0;7
879;Bitutė;Šokliukų;5109258680;Ne;0;3;3;6
880;Bitutė;Šokliukų;3417576747;Ne;0;8;0;8
881;Bitutė;Šokliukų;8422448947;Ne;0;9;0;9
882;Bitutė;Šokliukų;7926482326;Ne;5;11;0;16
883;Bitutė;Šokliukų;5876700984;Ne;0;8;0;8
884;Bitutė;Šokliukų;2177537591;Ne;7;0;0;7
885;Bitutė;Šokliukų;5759407291;Ne;0;6;0;6
886;Bitutė;Šokliukų;4471813998;Ne;0;3;0;3
887;Bitutė;Šokliukų;9234090775;Ne;0;12;2;14
888;Bitutė;Drugelių;9094567866;Ne;0;2;0;2
889;Bitutė;Drugelių;5759595005;Ne;0;10;3;13
890;Bitutė;Drugelių;2085899696;Ne;5;1;3;9
891;Bitutė;Drugelių;2029309955;Ne;0;2;0;2
892;Bitutė;Drugelių;7376746010;Ne;0;0;7;7
893;Bitutė;Drugelių;5845408472;Ne;2;3;0;5
894;Bitutė;Drugelių;3611348253;Ne;0;4;0;4
895;Bitutė;Drugelių;8727525320;Ne;0;4;0;4
896;Bitutė;Drugelių;5796600501;Ne;0;2;0;2
897;Bitutė;Drugelių;6325890676;Ne;0;25;2;27
898;Bitutė;Drugelių;2748400429;Ne;0;26;0;26
899;Bitutė;Drugelių;5146691157;Ne;3;9;0;12
900;Bitutė;Drugelių;2848732083;Taip;12;0;1;13
901;Bitutė;Drugelių;5278510767;Ne;0;8;0;8
902;Bitutė;Drugelių;8962725357;Ne;5;9;0;14
903;Bitutė;Drugelių;5471241132;Ne;0;3;1;4
904;Bitutė;Drugelių;1218462939;Ne;0;13;0;13
905;Bitutė;Drugelių;5081300818;Ne;0;1;1;2
906;Bitutė;Drugelių;7013249141;Ne;0;6;11;17
907;Bitutė;Drugelių;1397711778;Ne;13;0;0;13
908;Bitutė;Drugelių;8008237092;Ne;5;10;6;21
909;Bitutė;Drugelių;4545188971;Ne;14;13;0;27
910;Bitutė;Kiškučių;9451529077;Ne;0;15;0;15
911;Bitutė;Kiškučių;1733189730;Ne;5;4;0;9
912;Bitutė;Kiškučių;9966437881;Ne;2;4;0;6
913;Bitutė;Kiškučių;1985958540;Ne;0;2;0;2
914;Bitutė;Kiškučių;8743960488;Ne;0;6;0;6
915;Bitutė;Kiškučių;9337144831;Ne;14;0;0;14
916;Bitutė;Kiškučių;4566919587;Ne;3;0;0;3
917;Bitutė;Kiškučių;2806899030;Ne;0;4;0;4
918;Bitutė;Kiškučių;5443722813;Ne;0;9;0;9
919;Bitutė;Kiškučių;1241863345;Ne;0;4;0;4
920;Bitutė;Kiškučių;8789574593;Ne;11;0;0;11
921;Bitutė;Kiškučių;4639968278;Ne;0;2;0;2
922;Bitutė;Kiškučių;5490753578;Ne;10;5;6;21
923;Bitutė;"Viščiukų ";3603716923;Ne;15;6;0;21
924;Bitutė;"Viščiukų ";5181958187;Ne;5;8;0;13
925;Bitutė;"Viščiukų ";7694916340;Ne;15;10;0;25
926;Bitutė;"Viščiukų ";8303932330;Ne;7;2;0;9
927;Bitutė;"Viščiukų ";8642411661;Ne;7;4;0;11
928;Bitutė;"Viščiukų ";1198024852;Ne;0;15;0;15
929;Bitutė;"Viščiukų ";9909017070;Ne;0;14;0;14
930;Bitutė;"Viščiukų ";3811028304;Ne;9;4;0;13
931;Bitutė;"Viščiukų ";9592567172;Ne;0;7;0;7
932;Bitutė;"Viščiukų ";7619112317;Ne;0;10;0;10
933;Bitutė;"Viščiukų ";1715987321;Ne;9;0;0;9
934;Bitutė;"Viščiukų ";4926289620;Ne;20;10;0;30
935;Bitutė;"Viščiukų ";8130382253;Ne;7;11;0;18
936;Bitutė;"Viščiukų ";5869737425;Ne;7;5;0;12
937;Bitutė;"Viščiukų ";5220694242;Ne;0;5;0;5
938;Bitutė;"Viščiukų ";7535583229;Ne;2;6;0;8
939;Bitutė;"Viščiukų ";4480187618;Ne;2;4;0;6
940;Bitutė;"Viščiukų ";5061164237;Ne;10;0;0;10
941;Bitutė;"Skruzdėliukai ";5686278261;Ne;0;10;3;13
942;Bitutė;"Skruzdėliukai ";1423694056;Ne;0;4;1;5
943;Bitutė;"Skruzdėliukai ";5942493696;Taip;0;5;0;5
944;Bitutė;"Skruzdėliukai ";6311396261;Ne;7;11;0;18
945;Bitutė;"Skruzdėliukai ";7145036085;Ne;0;7;1;8
946;Bitutė;"Skruzdėliukai ";2252157473;Ne;0;0;9;9
947;Bitutė;"Skruzdėliukai ";6169426273;Ne;0;0;3;3
948;Bitutė;"Skruzdėliukai ";4513783927;Ne;0;10;1;11
949;Bitutė;"Skruzdėliukai ";8667259778;Ne;0;10;4;14
950;Bitutė;"Skruzdėliukai ";8607718704;Ne;0;0;2;2
951;Bitutė;"Skruzdėliukai ";4413880918;Ne;0;10;3;13
952;Bitutė;"Skruzdėliukai ";9436414962;Ne;4;10;0;14
953;Bitutė;"Skruzdėliukai ";9864771568;Ne;5;0;0;5
954;Bitutė;"Skruzdėliukai ";6353690252;Ne;6;0;1;7
955;Bitutė;"Skruzdėliukai ";2160735504;Ne;4;9;0;13
956;Bitutė;"Skruzdėliukai ";1387310054;Ne;0;17;0;17
957;Bitutė;"Skruzdėliukai ";7245807233;Ne;5;1;3;9
958;Bitutė;"Skruzdėliukai ";4467090141;Ne;0;6;0;6
959;Bitutė;"Skruzdėliukai ";5433617195;Ne;0;9;0;9
960;Bitutė;"Skruzdėliukai ";2391170362;Ne;5;0;0;5
961;Bitutė;"Nykštukų ";1290146001;Taip;13;3;1;17
962;Bitutė;"Nykštukų ";3359918177;Ne;0;2;0;2
963;Bitutė;"Nykštukų ";9352292654;Ne;2;7;1;10
964;Bitutė;"Nykštukų ";5421744666;Ne;5;1;0;6
965;Bitutė;"Nykštukų ";9780599803;Ne;6;3;0;9
966;Bitutė;"Nykštukų ";7741454857;Ne;2;1;3;6
967;Bitutė;"Nykštukų ";3860047703;Ne;6;7;0;13
968;Bitutė;"Nykštukų ";6226996242;Ne;6;9;0;15
969;Bitutė;"Nykštukų ";1460746240;Ne;4;5;0;9
970;Bitutė;"Nykštukų ";8896842164;Ne;0;32;0;32
971;Bitutė;"Nykštukų ";2819417600;Ne;0;10;6;16
972;Bitutė;"Nykštukų ";8561037889;Ne;0;21;0;21
973;Bitutė;"Nykštukų ";6091108131;Ne;9;11;8;28
974;Bitutė;"Nykštukų ";5375847129;Ne;0;10;0;10
975;Bitutė;"Nykštukų ";4617493676;Ne;9;5;8;22
976;Bitutė;"Nykštukų ";3806852067;Ne;0;30;0;30
977;Coliukė;DRUGELIAI;6675290003;Ne;13;0;2;15
978;Coliukė;DRUGELIAI;9890663421;Ne;0;4;0;4
979;Coliukė;DRUGELIAI;9688432169;Ne;4;0;1;5
980;Coliukė;DRUGELIAI;7513522378;Ne;6;6;0;12
981;Coliukė;DRUGELIAI;8478006305;Ne;0;0;7;7
982;Coliukė;DRUGELIAI;9352547729;Ne;0;2;0;2
983;Coliukė;DRUGELIAI;3908791146;Ne;5;0;0;5
984;Coliukė;DRUGELIAI;9750447455;Ne;0;12;0;12
985;Coliukė;DRUGELIAI;3367789231;Ne;5;0;7;12
986;Coliukė;DRUGELIAI;1220834062;Ne;0;1;0;1
987;Coliukė;DRUGELIAI;3392367716;Ne;15;1;0;16
988;Coliukė;DRUGELIAI;7621095517;Ne;0;0;4;4
989;Coliukė;DRUGELIAI;4140716483;Ne;9;0;0;9
990;Coliukė;DRUGELIAI;2385917598;Ne;16;0;0;16
991;Coliukė;DRUGELIAI;1390751418;Ne;15;0;0;15
992;Coliukė;DRUGELIAI;4881447596;Ne;0;8;0;8
993;Coliukė;DRUGELIAI;6224089401;Ne;0;1;0;1
994;Coliukė;DRUGELIAI;7284465232;Ne;14;0;0;14
995;Coliukė;DRUGELIAI;8756465257;Ne;5;8;0;13
996;Coliukė;BITUTĖS;6725408547;Ne;0;15;0;15
997;Coliukė;BITUTĖS;2167230398;Ne;0;2;0;2
998;Coliukė;BITUTĖS;5349969025;Ne;0;10;0;10
999;Coliukė;BITUTĖS;1960898805;Ne;0;10;0;10
1000;Coliukė;BITUTĖS;7920728387;Ne;0;4;0;4
1001;Coliukė;BITUTĖS;8767261039;Ne;2;1;0;3
1002;Coliukė;BITUTĖS;1968467455;Ne;0;2;0;2
1003;Coliukė;BITUTĖS;9462610674;Ne;2;6;0;8
1004;Coliukė;BITUTĖS;4188233426;Ne;8;2;1;11
1005;Coliukė;BITUTĖS;8457120425;Ne;3;1;0;4
1006;Coliukė;BITUTĖS;1240946719;Ne;0;5;0;5
1007;Coliukė;BITUTĖS;9331485675;Ne;7;3;0;10
1008;Coliukė;BITUTĖS;9311775782;Ne;0;1;0;1
1009;Coliukė;BITUTĖS;2275327607;Ne;8;1;0;9
1010;Coliukė;BITUTĖS;3346269598;Ne;7;1;0;8
1011;Coliukė;BITUTĖS;9879369365;Ne;4;9;0;13
1012;Coliukė;BITUTĖS;4845247006;Ne;0;5;0;5
1013;Coliukė;BITUTĖS;9885547263;Ne;6;0;0;6
1014;Coliukė;BITUTĖS;6860757091;Ne;0;2;1;3
1015;Coliukė;BITUTĖS;8517128464;Ne;1;2;0;3
1016;Coliukė;BITUTĖS;8149118599;Ne;0;1;0;1
1017;Coliukė;BITUTĖS;7345905007;Ne;2;1;0;3
1018;Coliukė;BITUTĖS;7358018315;Ne;13;0;1;14
1019;Coliukė;VABALIUKAI;1537341012;Ne;13;0;1;14
1020;Coliukė;VABALIUKAI;6984254334;Ne;0;1;2;3
1021;Coliukė;VABALIUKAI;5835199087;Ne;0;9;0;9
1022;Coliukė;VABALIUKAI;4626722910;Ne;5;0;1;6
1023;Coliukė;VABALIUKAI;9526108197;Ne;10;3;0;13
1024;Coliukė;VABALIUKAI;6475497234;Ne;10;1;0;11
1025;Coliukė;VABALIUKAI;5596775091;Ne;10;1;0;11
1026;Coliukė;VABALIUKAI;4172517506;Ne;4;1;0;5
1027;Coliukė;VABALIUKAI;4493314926;Ne;7;5;0;12
1028;Coliukė;VABALIUKAI;2469993058;Ne;0;5;0;5
1029;Coliukė;VABALIUKAI;4739310916;Ne;0;3;0;3
1030;Coliukė;VABALIUKAI;5541328815;Ne;12;1;1;14
1031;Coliukė;VABALIUKAI;4649987214;Ne;0;1;0;1
1032;Coliukė;VABALIUKAI;3905904092;Ne;15;1;0;16
1033;Coliukė;VABALIUKAI;9083546061;Ne;0;2;0;2
1034;Coliukė;VABALIUKAI;1476750428;Ne;0;1;0;1
1035;Coliukė;VABALIUKAI;7622526793;Ne;0;3;0;3
1036;Coliukė;VABALIUKAI;1328505569;Ne;5;5;0;10
1037;Coliukė;VABALIUKAI;9268436167;Ne;5;4;0;9
1038;Coliukė;VABALIUKAI;9368334915;Ne;0;3;0;3
1039;Coliukė;VABALIUKAI;5108993131;Ne;6;2;2;10
1040;Coliukė;NYKŠTUKAI;6441253648;Ne;7;1;0;8
1041;Coliukė;NYKŠTUKAI;9693392372;Ne;1;1;0;2
1042;Coliukė;NYKŠTUKAI;4537756081;Ne;0;8;0;8
1043;Coliukė;NYKŠTUKAI;3719547522;Ne;2;2;0;4
1044;Coliukė;NYKŠTUKAI;5450167562;Ne;0;1;0;1
1045;Coliukė;NYKŠTUKAI;9498557347;Ne;0;7;0;7
1046;Coliukė;NYKŠTUKAI;3384332079;Ne;0;0;5;5
1047;Coliukė;NYKŠTUKAI;1198781036;Ne;0;1;0;1
1048;Coliukė;NYKŠTUKAI;5283583324;Ne;0;1;0;1
1049;Coliukė;NYKŠTUKAI;9334564869;Ne;19;3;0;22
1050;Coliukė;NYKŠTUKAI;6781303455;Ne;0;4;0;4
1051;Coliukė;NYKŠTUKAI;3140659021;Ne;0;0;18;18
1052;Coliukė;NYKŠTUKAI;4845049639;Ne;0;0;3;3
1053;Coliukė;NYKŠTUKAI;3221157300;Ne;0;15;0;15
1054;Coliukė;NYKŠTUKAI;7870865302;Ne;10;2;0;12
1055;Coliukė;NYKŠTUKAI;1575061659;Ne;5;0;0;5
1056;Coliukė;NYKŠTUKAI;2321127662;Ne;0;0;1;1
1057;Coliukė;NYKŠTUKAI;8715608220;Ne;0;6;0;6
1058;Coliukė;NYKŠTUKAI;4635299740;Ne;7;10;2;19
1059;Coliukė;GĖLYTĖS;9442511803;Ne;0;0;22;22
1060;Coliukė;GĖLYTĖS;6611713551;Ne;0;11;0;11
1061;Coliukė;GĖLYTĖS;6755886435;Ne;8;0;1;9
1062;Coliukė;GĖLYTĖS;1220385522;Ne;6;1;1;8
1063;Coliukė;GĖLYTĖS;8601059431;Ne;6;0;1;7
1064;Coliukė;GĖLYTĖS;1452034828;Ne;0;1;2;3
1065;Coliukė;GĖLYTĖS;6816085304;Ne;0;4;0;4
1066;Coliukė;GĖLYTĖS;6941719947;Ne;0;1;0;1
1067;Coliukė;GĖLYTĖS;5347456579;Ne;9;0;0;9
1068;Coliukė;GĖLYTĖS;9107676840;Taip;0;1;0;1
1069;Coliukė;GĖLYTĖS;8606195508;Taip;0;12;5;17
1070;Coliukė;"BORUŽĖLĖS (SPEC.)";2080118127;Ne;0;2;0;2
1071;Coliukė;"BORUŽĖLĖS (SPEC.)";2617816991;Ne;0;1;0;1
1072;Coliukė;"BORUŽĖLĖS (SPEC.)";1233731506;Ne;0;12;1;13
1073;Coliukė;"BORUŽĖLĖS (SPEC.)";1644303265;Ne;0;0;19;19
1074;Coliukė;"BORUŽĖLĖS (SPEC.)";7826554599;Ne;7;0;3;10
1075;Coliukė;"BORUŽĖLĖS (SPEC.)";6920961967;Ne;5;4;0;9
1076;Coliukė;"BORUŽĖLĖS (SPEC.)";1134875499;Ne;10;3;0;13
1077;Coliukė;"BORUŽĖLĖS (SPEC.)";5756690199;Ne;7;6;0;13
1078;Coliukė;"BORUŽĖLĖS (SPEC.)";6972921877;Ne;12;0;1;13
1079;Coliukė;"BORUŽĖLĖS (SPEC.)";2947495861;Ne;0;0;7;7
1080;Coliukė;"BORUŽĖLĖS (SPEC.)";6246392335;Ne;2;2;0;4
1081;Coliukė;"BORUŽĖLĖS (SPEC.)";8347206534;Ne;5;0;0;5
1082;Coliukė;"BORUŽĖLĖS (SPEC.)";5008183731;Ne;5;1;0;6
1083;Čiauškutis;BITUTĖS;7893181156;Ne;3;0;0;3
1084;Čiauškutis;BITUTĖS;7976738303;Ne;0;6;0;6
1085;Čiauškutis;BITUTĖS;4026881335;Ne;11;0;2;13
1086;Čiauškutis;BITUTĖS;9753680961;Ne;2;7;0;9
1087;Čiauškutis;BITUTĖS;4652951382;Ne;0;13;9;22
1088;Čiauškutis;BITUTĖS;3837360101;Ne;0;5;0;5
1089;Čiauškutis;BITUTĖS;2319237497;Ne;4;5;1;10
1090;Čiauškutis;BITUTĖS;1765857419;Ne;0;3;0;3
1091;Čiauškutis;BITUTĖS;7282041196;Ne;6;16;0;22
1092;Čiauškutis;ŽVIRBLIUKAI;7654242839;Ne;22;0;0;22
1093;Čiauškutis;ŽVIRBLIUKAI;9565722619;Ne;0;22;0;22
1094;Čiauškutis;ŽVIRBLIUKAI;5125518366;Ne;4;0;0;4
1095;Čiauškutis;ŽVIRBLIUKAI;4962200863;Ne;17;0;0;17
1096;Čiauškutis;ŽVIRBLIUKAI;7468763527;Ne;0;0;1;1
1097;Čiauškutis;ŽVIRBLIUKAI;2096533965;Ne;10;1;2;13
1098;Čiauškutis;ŽVIRBLIUKAI;8297774828;Ne;3;0;0;3
1099;Čiauškutis;SAULUTĖS;98579606504;Ne;22;0;0;22
1100;Čiauškutis;SAULUTĖS;7027181377;Ne;0;21;1;22
1101;Čiauškutis;SAULUTĖS;43313173294;Ne;0;14;0;14
1102;Čiauškutis;SAULUTĖS;9052859205;Ne;6;0;1;7
1103;Čiauškutis;SAULUTĖS;4658994599;Ne;3;0;0;3
1104;Čiauškutis;SAULUTĖS;6115354862;Ne;0;1;8;9
1105;Čiauškutis;SAULUTĖS;5759367884;Ne;0;2;2;4
1106;Čiauškutis;SAULUTĖS;1313716840;Ne;0;1;0;1
1107;Čiauškutis;EŽIUKAI;7746580858;Ne;0;0;3;3
1108;Čiauškutis;EŽIUKAI;2686038029;Ne;0;0;4;4
1109;Čiauškutis;EŽIUKAI;7489733038;Ne;7;0;0;7
1110;Čiauškutis;EŽIUKAI;5404165993;Ne;8;0;0;8
1111;Čiauškutis;EŽIUKAI;9959952114;Ne;0;0;3;3
1112;Čiauškutis;EŽIUKAI;1158816422;Ne;0;0;1;1
1113;Čiauškutis;EŽIUKAI;7239878097;Ne;3;1;1;5
1114;Čiauškutis;EŽIUKAI;5910818962;Ne;2;0;0;2
1115;Čiauškutis;EŽIUKAI;1234494170;Ne;5;0;1;6
1116;Čiauškutis;DRUGELIAI;7080320173;Ne;4;0;1;5
1117;Čiauškutis;DRUGELIAI;7312776041;Ne;5;0;0;5
1118;Čiauškutis;DRUGELIAI;9072764004;Ne;0;0;3;3
1119;Čiauškutis;DRUGELIAI;1036358147;Ne;2;0;5;7
1120;Čiauškutis;DRUGELIAI;3724324861;Ne;0;22;0;22
1121;Čiauškutis;DRUGELIAI;2237570705;Ne;5;0;0;5
1122;Čiauškutis;DRUGELIAI;9073514151;Ne;0;0;2;2
1123;Čiauškutis;DRUGELIAI;4681902267;Ne;0;0;7;7
1124;Čiauškutis;GENELIAI;76449285846;Ne;0;2;4;6
1125;Čiauškutis;GENELIAI;6435287215;Ne;4;1;0;5
1126;Čiauškutis;GENELIAI;1456067541;Ne;0;1;0;1
1127;Čiauškutis;GENELIAI;1657452686;Ne;5;2;0;7
1128;Čiauškutis;GENELIAI;1739403100;Ne;0;22;0;22
1129;Čiauškutis;GENELIAI;6994301415;Ne;0;0;6;6
1130;Čiauškutis;GENELIAI;1224986101;Ne;0;1;0;1
1131;Čiauškutis;GENELIAI;1809511815;Ne;14;0;0;14
1132;Čiauškutis;LINKSMUČIAI;73016259669;Ne;0;2;1;3
1133;Čiauškutis;LINKSMUČIAI;7184626362;Ne;0;1;1;2
1134;Čiauškutis;LINKSMUČIAI;8689127061;Ne;22;0;0;22
1135;Čiauškutis;LINKSMUČIAI;9062135043;Ne;5;0;3;8
1136;Čiauškutis;LINKSMUČIAI;1533938659;Ne;0;0;1;1
1137;Čiauškutis;LINKSMUČIAI;2218793969;Ne;12;0;0;12
1138;Čiauškutis;LINKSMUČIAI;2672796261;Ne;3;0;1;4
1139;Čiauškutis;LINKSMUČIAI;8857039064;Ne;0;0;1;1
1140;Čiauškutis;KIŠKUČIAI;1900086424;Ne;3;0;0;3
1141;Čiauškutis;KIŠKUČIAI;1396093940;Ne;0;0;9;9
1142;Čiauškutis;KIŠKUČIAI;3465024013;Ne;5;15;2;22
1143;Čiauškutis;KIŠKUČIAI;2271458332;Ne;0;2;0;2
1144;Čiauškutis;KIŠKUČIAI;9754417066;Ne;7;0;0;7
1145;Čiauškutis;KIŠKUČIAI;8580034134;Taip;3;0;4;7
1146;Čiauškutis;KIŠKUČIAI;3650541072;Ne;0;0;1;1
1147;Čiauškutis;KIŠKUČIAI;2445742257;Ne;1;15;6;22
1148;Čiauškutis;KIŠKUČIAI;6785604459;Ne;14;0;8;22
1149;Čiauškutis;LAPIUKAI;5052137859;Ne;0;15;7;22
1150;Čiauškutis;LAPIUKAI;7428833348;Ne;10;0;0;10
1151;Čiauškutis;LAPIUKAI;9897499968;Ne;0;22;0;22
1152;Čiauškutis;LAPIUKAI;2737503753;Ne;4;0;1;5
1153;Čiauškutis;LAPIUKAI;8876608072;Ne;0;0;6;6
1154;Čiauškutis;LAPIUKAI;6810906239;Ne;4;14;4;22
1155;Čiauškutis;LAPIUKAI;9460608737;Ne;10;0;1;11
1156;Čiauškutis;MEŠKUČIAI;7630342576;Ne;10;0;2;12
1157;Čiauškutis;MEŠKUČIAI;7135435979;Ne;4;0;3;7
1158;Čiauškutis;MEŠKUČIAI;6146321785;Ne;0;0;6;6
1159;Čiauškutis;MEŠKUČIAI;6434727608;Ne;3;9;10;22
1160;Čiauškutis;MEŠKUČIAI;3660195990;Ne;22;0;0;22
1161;Čiauškutis;PELĖDŽIUKAI;4971788697;Ne;0;0;6;6
1162;Čiauškutis;PELĖDŽIUKAI;9228568063;Ne;7;0;3;10
1163;Čiauškutis;PELĖDŽIUKAI;6615319751;Ne;20;0;1;21
1164;Čiauškutis;PELĖDŽIUKAI;2377986721;Ne;22;0;0;22
1165;Čiauškutis;NYKŠTUKAI;8948893335;Ne;5;0;10;15
1166;Čiauškutis;NYKŠTUKAI;2633243682;Ne;0;3;0;3
1167;Čiauškutis;NYKŠTUKAI;4037117222;Ne;1;0;5;6
1168;Čiauškutis;NYKŠTUKAI;6726124641;Ne;0;4;0;4
1169;Čiauškutis;NYKŠTUKAI;5957587644;Ne;0;0;4;4
1170;Čiauškutis;NYKŠTUKAI;1733251156;Ne;5;0;0;5
1171;Čiauškutis;NYKŠTUKAI;5575614158;Ne;8;3;2;13
1172;Čiauškutis;NYKŠTUKAI;2044220236;Ne;0;1;0;1
1173;Daigelis;Bitutės;2252139639;Ne;4;0;0;4
1174;Daigelis;Bitutės;8855668502;Ne;15;0;0;15
1175;Daigelis;Bitutės;6285764348;Ne;3;0;0;3
1176;Daigelis;Bitutės;7503012332;Ne;5;0;0;5
1177;Daigelis;"VIEVERSĖLIAI (SPEC)";9392290289;Ne;11;0;0;11
1178;Daigelis;"SAULUTĖ (SPEC.sav.)";1948334713;Ne;9;0;0;9
1179;Daigelis;"SAULUTĖ (SPEC.sav.)";1999979060;Ne;5;0;0;5
1180;Daigelis;Spinduliukai;4715171946;Ne;9;0;0;9
1181;Daigelis;Pelėdžiukai;7616571136;Ne;2;0;0;2
1182;Daigelis;Žvaigždutės;9937741863;Ne;2;0;0;2
1183;Daigelis;Žvaigždutės;5590883475;Ne;5;0;0;5
1184;Daigelis;Žvaigždutės;9588934306;Ne;19;0;0;19
1185;Daigelis;Skruzdėliukai;4682302955;Taip;6;0;0;6
1186;Daigelis;Skruzdėliukai;3383805498;Ne;14;0;0;14
1187;Daigelis;Gėlytės;5249108137;Ne;8;0;0;8
1188;Daigelis;Gėlytės;9987516903;Ne;19;0;0;19
1189;Daigelis;Funtiki;9724634409;Ne;9;0;0;9
1190;Daigelis;Funtiki;3544739738;Ne;5;0;0;5
1191;Daigelis;Funtiki;5503176248;Ne;7;0;0;7
1192;Daigelis;Nevaliaški;6979105726;Ne;3;0;0;3
1193;Daigelis;Nevaliaški;2619313944;Ne;3;0;0;3
1194;Daigelis;Nevaliaški;8511644393;Ne;10;0;0;10
1195;Daigelis;Nevaliaški;1417334688;Ne;2;0;0;2
1196;Daigelis;Nevaliaški;6518661502;Ne;14;0;0;14
1197;Daigelis;Nevaliaški;4615798936;Ne;4;0;0;4
1198;Daigelis;Nevaliaški;1883094184;Ne;4;0;0;4
1199;Delfinukas;Boružėlių;9184207705;Ne;0;2;2;4
1200;Delfinukas;Boružėlių;2819680099;Taip;0;2;0;2
1201;Delfinukas;Boružėlių;3205671100;Ne;0;3;0;3
1202;Delfinukas;Boružėlių;1119373532;Ne;10;0;1;11
1203;Delfinukas;Boružėlių;4488260667;Ne;5;0;0;5
1204;Delfinukas;Boružėlių;4985159933;Ne;2;0;0;2
1205;Delfinukas;Boružėlių;5443027988;Ne;0;3;0;3
1206;Delfinukas;Boružėlių;2163238846;Ne;5;0;0;5
1207;Delfinukas;Boružėlių;4567479900;Ne;11;0;0;11
1208;Delfinukas;Boružėlių;7312438969;Taip;0;0;1;1
1209;Delfinukas;Boružėlių;5585334518;Ne;7;0;0;7
1210;Delfinukas;Boružėlių;6071660741;Ne;11;2;0;13
1211;Delfinukas;Boružėlių;4327924499;Ne;0;0;3;3
1212;Delfinukas;Boružėlių;6693756145;Ne;0;2;0;2
1213;Delfinukas;Boružėlių;6301767635;Ne;0;14;0;14
1214;Delfinukas;Saulytės;8315269427;Ne;7;0;6;13
1215;Delfinukas;Saulytės;4215887291;Ne;0;2;5;7
1216;Delfinukas;Saulytės;3631520143;Ne;0;0;2;2
1217;Delfinukas;Saulytės;9424966984;Ne;0;0;15;15
1218;Delfinukas;Saulytės;6069600728;Ne;6;0;0;6
1219;Delfinukas;Saulytės;9729550922;Taip;0;3;0;3
1220;Delfinukas;Saulytės;1404270345;Ne;0;6;4;10
1221;Delfinukas;Saulytės;3842160990;Ne;0;8;0;8
1222;Delfinukas;Saulytės;8402529296;Taip;6;0;0;6
1223;Delfinukas;Saulytės;5642328792;Ne;2;2;0;4
1224;Delfinukas;Saulytės;8176576958;Ne;12;0;1;13
1225;Delfinukas;Saulytės;8275943176;Ne;0;0;12;12
1226;Delfinukas;Saulytės;8085530134;Taip;0;11;0;11
1227;Delfinukas;Saulytės;8148610460;Ne;0;2;3;5
1228;Delfinukas;Saulytės;8186312409;Ne;0;2;1;3
1229;Delfinukas;Saulytės;5665463557;Ne;5;0;0;5
1230;Delfinukas;Saulytės;1296440609;Ne;4;4;0;8
1231;Delfinukas;Saulytės;5397241026;Ne;0;8;1;9
1232;Delfinukas;Pelėdžiukų;3940838205;Taip;2;0;0;2
1233;Delfinukas;Pelėdžiukų;8774145277;Ne;0;3;0;3
1234;Delfinukas;Pelėdžiukų;6113662246;Ne;0;13;6;19
1235;Delfinukas;Pelėdžiukų;4710894128;Ne;0;1;4;5
1236;Delfinukas;Pelėdžiukų;1526129772;Ne;0;1;3;4
1237;Delfinukas;Pelėdžiukų;8659309242;Ne;6;5;0;11
1238;Delfinukas;Pelėdžiukų;8267992425;Ne;0;6;0;6
1239;Delfinukas;Pelėdžiukų;9319874239;Taip;0;3;0;3
1240;Delfinukas;Pelėdžiukų;3465186420;Ne;0;1;4;5
1241;Delfinukas;Pelėdžiukų;4096274346;Taip;0;2;3;5
1242;Delfinukas;Pelėdžiukų;5246300518;Ne;2;0;5;7
1243;Delfinukas;Pelėdžiukų;3702341009;Ne;0;2;0;2
1244;Delfinukas;Pelėdžiukų;2420308954;Ne;3;1;0;4
1245;Delfinukas;Pelėdžiukų;6286748047;Ne;3;9;0;12
1246;Delfinukas;Pelėdžiukų;1918878505;Ne;0;2;3;5
1247;Delfinukas;Pelėdžiukų;3795705735;Ne;0;11;0;11
1248;Delfinukas;Pelėdžiukų;1575125658;Ne;11;3;0;14
1249;Delfinukas;Pelėdžiukų;4384995354;Ne;0;2;1;3
1250;Delfinukas;Pelėdžiukų;3633392440;Ne;18;0;0;18
1251;Delfinukas;Varliukų;4949220786;Ne;0;2;3;5
1252;Delfinukas;Varliukų;2792051636;Taip;2;8;3;13
1253;Delfinukas;Varliukų;4780352568;Ne;6;1;1;8
1254;Delfinukas;Varliukų;3577180085;Ne;11;0;1;12
1255;Delfinukas;Varliukų;6115370195;Taip;0;0;1;1
1256;Delfinukas;Varliukų;3050258185;Ne;0;0;5;5
1257;Delfinukas;Varliukų;9360553910;Ne;6;3;0;9
1258;Delfinukas;Varliukų;6301601832;Ne;3;0;0;3
1259;Delfinukas;Varliukų;5095713834;Ne;5;6;3;14
1260;Delfinukas;Varliukų;5964021733;Ne;8;4;0;12
1261;Delfinukas;Varliukų;5821591959;Ne;0;4;0;4
1262;Delfinukas;Varliukų;9095895182;Ne;0;0;4;4
1263;Delfinukas;Varliukų;5138840297;Ne;0;13;0;13
1264;Delfinukas;Varliukų;7072060541;Ne;5;1;1;7
1265;Delfinukas;Varliukų;3797355501;Ne;7;4;0;11
1266;Delfinukas;Varliukų;4751611934;Taip;0;1;0;1
1267;Delfinukas;Varliukų;4254414928;Taip;4;2;2;8
1268;Delfinukas;Varpelių;9514189769;Ne;0;2;0;2
1269;Delfinukas;Varpelių;4713803167;Ne;10;1;0;11
1270;Delfinukas;Varpelių;1484123788;Ne;0;1;2;3
1271;Delfinukas;Varpelių;8950528288;Ne;0;0;1;1
1272;Delfinukas;Varpelių;8829835426;Ne;9;0;2;11
1273;Delfinukas;Varpelių;7780893730;Ne;12;1;2;15
1274;Delfinukas;Varpelių;6938708939;Ne;0;2;1;3
1275;Delfinukas;Varpelių;9898427089;Ne;0;1;0;1
1276;Delfinukas;Varpelių;8911433659;Ne;0;0;1;1
1277;Delfinukas;Drugeliai;7615519932;Ne;9;0;0;9
1278;Delfinukas;Drugeliai;6604115681;Ne;0;11;0;11
1279;Delfinukas;Drugeliai;5990192934;Ne;10;1;0;11
1280;Delfinukas;Drugeliai;9635669748;Ne;5;5;0;10
1281;Delfinukas;Drugeliai;8526813977;Ne;5;5;0;10
1282;Delfinukas;Drugeliai;6873181103;Ne;0;3;0;3
1283;Delfinukas;Drugeliai;4484804360;Ne;0;2;2;4
1284;Delfinukas;Drugeliai;8328481987;Ne;6;1;0;7
1285;Delfinukas;Drugeliai;6992505341;Ne;0;1;14;15
1286;Delfinukas;Drugeliai;8129592398;Ne;5;1;0;6
1287;Delfinukas;Drugeliai;8606989493;Ne;5;0;0;5
1288;Delfinukas;Drugeliai;6884260821;Ne;0;2;0;2
1289;Delfinukas;Drugeliai;2756574162;Ne;7;1;0;8
1290;Delfinukas;Drugeliai;2985669766;Ne;12;3;1;16
1291;Delfinukas;Drugeliai;7609115506;Ne;6;7;0;13
1292;Delfinukas;Drugeliai;6457042338;Taip;5;7;0;12
1293;Delfinukas;Drugeliai;8411289299;Ne;0;5;0;5
1294;Delfinukas;Drugeliai;2683746435;Ne;9;0;0;9
1295;Delfinukas;Drugeliai;6623617856;Ne;0;2;1;3
1296;Delfinukas;Žuvytės;6445868759;Ne;0;9;3;12
1297;Delfinukas;Delfinai;2890469172;Ne;0;6;1;7
1298;Delfinukas;Delfinai;9628317328;Ne;0;2;1;3
1299;Delfinukas;Delfinai;5797308373;Ne;0;1;0;1
1300;Delfinukas;Delfinai;5241426445;Ne;0;2;0;2
1301;Delfinukas;Delfinai;3108430680;Ne;0;11;0;11
1302;Delfinukas;Delfinai;7663934825;Ne;0;1;1;2
1303;Delfinukas;Delfinai;2382077576;Ne;0;1;0;1
1304;Delfinukas;Delfinai;4347116918;Ne;0;12;0;12
1305;Delfinukas;Delfinai;6270012707;Ne;5;7;0;12
1306;Delfinukas;Delfinai;8085481968;Ne;0;4;0;4
1307;Delfinukas;Delfinai;9605756229;Ne;0;1;0;1
1308;Delfinukas;Delfinai;3407321091;Ne;7;0;0;7
1309;Delfinukas;Delfinai;7354837777;Ne;13;0;1;14
1310;Delfinukas;Delfinai;9903010418;Ne;0;7;0;7
1311;Delfinukas;Delfinai;6522639028;Taip;5;0;6;11
1312;Delfinukas;Paukšteliai;7366145460;Ne;0;2;2;4
1313;Delfinukas;Paukšteliai;5278689745;Ne;0;1;0;1
1314;Delfinukas;Paukšteliai;1164720538;Ne;2;4;0;6
1315;Delfinukas;Paukšteliai;9351906710;Ne;3;1;0;4
1316;Delfinukas;Paukšteliai;9629225917;Ne;3;1;0;4
1317;Delfinukas;Paukšteliai;9332794060;Ne;17;0;0;17
1318;Delfinukas;Paukšteliai;6650725760;Ne;11;1;4;16
1319;Delfinukas;Paukšteliai;5164599763;Ne;17;0;0;17
1320;Delfinukas;Paukšteliai;9776618488;Ne;3;1;0;4
1321;Delfinukas;Paukšteliai;9586646352;Ne;2;2;1;5
1322;Delfinukas;Paukšteliai;4561911078;Ne;8;0;9;17
1323;Delfinukas;Paukšteliai;4755699845;Ne;2;2;1;5
1324;Delfinukas;Kiškučiai;2094258481;Ne;0;2;1;3
1325;Delfinukas;Kiškučiai;6577214344;Ne;0;8;0;8
1326;Delfinukas;BITUTĖS;9719348837;Ne;0;6;0;6
1327;Delfinukas;BITUTĖS;6211076154;Ne;0;2;0;2
1328;Delfinukas;BITUTĖS;6601922746;Ne;0;6;0;6
1329;Delfinukas;BITUTĖS;3239635507;Ne;0;2;0;2
1330;Delfinukas;BITUTĖS;5339993544;Taip;0;0;1;1
1331;Delfinukas;BITUTĖS;6929926768;Ne;7;6;0;13
1332;Delfinukas;BITUTĖS;5179080544;Taip;0;12;0;12
1333;Delfinukas;BITUTĖS;7727263761;Ne;3;1;0;4
1334;Delfinukas;BITUTĖS;9941631164;Ne;0;8;0;8
1335;Delfinukas;BITUTĖS;4198261848;Ne;16;0;0;16
1336;Delfinukas;BITUTĖS;8081895401;Ne;10;0;0;10
1337;Delfinukas;BITUTĖS;5600320855;Ne;0;13;4;17
1338;Delfinukas;BITUTĖS;9195828884;Ne;5;0;2;7
1339;Delfinukas;BITUTĖS;2377204734;Ne;0;9;0;9
1340;Delfinukas;BITUTĖS;6243471374;Ne;0;9;0;9
1341;Delfinukas;BITUTĖS;4303234827;Ne;22;0;0;22
1342;Delfinukas;BITUTĖS;6325092903;Ne;5;1;0;6
1343;Drevinukas;ZUIKUČIAI;9817317105;Ne;0;0;1;1
1344;Drevinukas;ZUIKUČIAI;1595081335;Ne;0;8;5;13
1345;Drevinukas;ZUIKUČIAI;2646799484;Ne;0;0;7;7
1346;Drevinukas;ZUIKUČIAI;2772424629;Ne;0;2;12;14
1347;Drevinukas;ZUIKUČIAI;5928234487;Ne;0;1;1;2
1348;Drevinukas;ZUIKUČIAI;8873060121;Ne;0;0;7;7
1349;Drevinukas;ZUIKUČIAI;1567790084;Ne;4;0;0;4
1350;Drevinukas;ZUIKUČIAI;3293457412;Ne;0;3;1;4
1351;Drevinukas;ZUIKUČIAI;6243097297;Ne;0;2;7;9
1352;Drevinukas;ZUIKUČIAI;5704489483;Ne;0;4;4;8
1353;Drevinukas;ZUIKUČIAI;3381363132;Ne;0;2;3;5
1354;Drevinukas;ZUIKUČIAI;3070518153;Ne;4;1;0;5
1355;Drevinukas;ZUIKUČIAI;4243045398;Ne;0;9;0;9
1356;Drevinukas;ZUIKUČIAI;4309475233;Ne;0;9;0;9
1357;Drevinukas;ZUIKUČIAI;6393960467;Ne;0;10;2;12
1358;Drevinukas;ZUIKUČIAI;5810253467;Ne;0;0;11;11
1359;Drevinukas;AŽUOLIUKŲ;1644656704;Ne;0;1;0;1
1360;Drevinukas;AŽUOLIUKŲ;5721031754;Ne;8;2;0;10
1361;Drevinukas;AŽUOLIUKŲ;4714478955;Ne;0;7;0;7
1362;Drevinukas;AŽUOLIUKŲ;8701250912;Ne;6;7;0;13
1363;Drevinukas;AŽUOLIUKŲ;8143614891;Ne;4;3;0;7
1364;Drevinukas;AŽUOLIUKŲ;5673244101;Ne;0;1;0;1
1365;Drevinukas;AŽUOLIUKŲ;3643007998;Ne;0;9;0;9
1366;Drevinukas;AŽUOLIUKŲ;4262951360;Ne;15;0;0;15
1367;Drevinukas;AŽUOLIUKŲ;5959004452;Ne;0;2;0;2
1368;Drevinukas;AŽUOLIUKŲ;7689145214;Ne;0;2;0;2
1369;Drevinukas;AŽUOLIUKŲ;4572837478;Ne;0;15;0;15
1370;Drevinukas;AŽUOLIUKŲ;1564065835;Ne;0;8;0;8
1371;Drevinukas;AŽUOLIUKŲ;9289471118;Ne;0;11;0;11
1372;Drevinukas;AŽUOLIUKŲ;9915130747;Ne;7;4;0;11
1373;Drevinukas;AŽUOLIUKŲ;6891793135;Ne;0;7;0;7
1374;Drevinukas;AŽUOLIUKŲ;1058927778;Ne;0;1;0;1
1375;Drevinukas;AŽUOLIUKŲ;9534007163;Ne;0;1;0;1
1376;Drevinukas;AŽUOLIUKŲ;2300338724;Ne;15;0;0;15
1377;Drevinukas;AŽUOLIUKŲ;3725760478;Ne;0;1;0;1
1378;Drevinukas;AŽUOLIUKŲ;9513405583;Ne;0;7;0;7
1379;Drevinukas;AŽUOLIUKŲ;8896207423;Ne;3;0;0;3
1380;Drevinukas;PELĖDŽIUKAI;1123115847;Ne;8;0;0;8
1381;Drevinukas;PELĖDŽIUKAI;1987939679;Ne;0;0;8;8
1382;Drevinukas;PELĖDŽIUKAI;9336227821;Ne;0;0;8;8
1383;Drevinukas;PELĖDŽIUKAI;2070374746;Ne;0;0;1;1
1384;Drevinukas;PELĖDŽIUKAI;8661862777;Ne;0;0;1;1
1385;Drevinukas;PELĖDŽIUKAI;9803670483;Ne;0;0;14;14
1386;Drevinukas;PELĖDŽIUKAI;7519369167;Ne;0;7;0;7
1387;Drevinukas;PELĖDŽIUKAI;16952164778;Ne;6;0;0;6
1388;Drevinukas;PELĖDŽIUKAI;3657451903;Ne;2;0;0;2
1389;Drevinukas;PELĖDŽIUKAI;8180027849;Ne;6;0;0;6
1390;Drevinukas;PELĖDŽIUKAI;4332606643;Ne;0;0;3;3
1391;Drevinukas;PELĖDŽIUKAI;7632515230;Ne;0;0;1;1
1392;Drevinukas;PELĖDŽIUKAI;6304169257;Ne;0;0;1;1
1393;Drevinukas;PELĖDŽIUKAI;56028675283;Ne;0;0;8;8
1394;Drevinukas;PELĖDŽIUKAI;85288014888;Ne;0;0;1;1
1395;Drevinukas;PELĖDŽIUKAI;1019214451;Ne;0;0;3;3
1396;Drevinukas;PELĖDŽIUKAI;6954102486;Ne;4;0;1;5
1397;Drevinukas;PELĖDŽIUKAI;3086451968;Ne;4;0;0;4
1398;Drevinukas;PELĖDŽIUKAI;6833120798;Ne;0;0;7;7
1399;Drevinukas;PELĖDŽIUKAI;7607135647;Ne;0;0;3;3
1400;Drevinukas;BORUŽĖLĖS;4134729710;Ne;3;0;0;3
1401;Drevinukas;BORUŽĖLĖS;2378493422;Ne;6;0;0;6
1402;Drevinukas;BORUŽĖLĖS;1859208322;Ne;10;0;0;10
1403;Drevinukas;BITUTĖS;3981507849;Ne;0;10;2;12
1404;Drevinukas;BITUTĖS;7753238387;Ne;7;0;2;9
1405;Drevinukas;BITUTĖS;3617570755;Ne;0;0;11;11
1406;Drevinukas;BITUTĖS;5679723776;Ne;0;2;0;2
1407;Drevinukas;BITUTĖS;1720464417;Ne;0;6;0;6
1408;Drevinukas;BITUTĖS;6095020718;Ne;0;6;1;7
1409;Drevinukas;BITUTĖS;1099462840;Ne;0;4;1;5
1410;Drevinukas;BITUTĖS;1152161183;Ne;0;0;4;4
1411;Drevinukas;BITUTĖS;8611131264;Ne;0;1;0;1
1412;Drevinukas;BITUTĖS;8936058501;Ne;0;8;2;10
1413;Drevinukas;BITUTĖS;9772484901;Ne;4;0;0;4
1414;Drevinukas;BITUTĖS;5348609358;Ne;5;2;0;7
1415;Drevinukas;BITUTĖS;1098647410;Ne;4;0;0;4
1416;Drevinukas;BITUTĖS;2312241894;Ne;0;5;0;5
1417;Drevinukas;BITUTĖS;5394143000;Ne;13;1;0;14
1418;Drevinukas;BITUTĖS;3377957769;Ne;0;0;3;3
1419;Drevinukas;BITUTĖS;2423143170;Ne;0;12;0;12
1420;Drevinukas;BITUTĖS;1343431478;Ne;0;0;2;2
1421;Drevinukas;BITUTĖS;1829421385;Ne;3;0;0;3
1422;Drevinukas;BITUTĖS;8262224710;Ne;0;11;0;11
1423;Drevinukas;BITUTĖS;8479979176;Ne;0;1;0;1
1424;Drevinukas;BITUTĖS;2531207946;Ne;0;0;1;1
1425;Drevinukas;NYKŠTUKAI;8385750920;Ne;0;8;0;8
1426;Drevinukas;NYKŠTUKAI;6165662595;Ne;0;7;5;12
1427;Drevinukas;NYKŠTUKAI;4147987057;Ne;0;4;0;4
1428;Drevinukas;NYKŠTUKAI;6645506336;Ne;15;2;0;17
1429;Drevinukas;NYKŠTUKAI;3240313747;Ne;0;0;1;1
1430;Drevinukas;NYKŠTUKAI;8940838262;Ne;5;0;0;5
1431;Drevinukas;NYKŠTUKAI;8719022482;Ne;2;0;2;4
1432;Drevinukas;NYKŠTUKAI;9695419813;Ne;0;1;7;8
1433;Drevinukas;NYKŠTUKAI;9517560132;Ne;7;0;0;7
1434;Drevinukas;NYKŠTUKAI;6895472558;Ne;7;0;0;7
1435;Drevinukas;NYKŠTUKAI;2571295179;Ne;0;9;0;9
1436;Drevinukas;NYKŠTUKAI;2820241608;Ne;0;7;0;7
1437;Drevinukas;NYKŠTUKAI;5860361695;Ne;0;0;2;2
1438;Drevinukas;NYKŠTUKAI;9845207619;Ne;10;0;2;12
1439;Drevinukas;NYKŠTUKAI;8694887879;Ne;0;10;0;10
1440;Drevinukas;NYKŠTUKAI;6680003214;Ne;0;5;3;8
1441;Drevinukas;NYKŠTUKAI;3192583690;Ne;0;0;4;4
1442;Drevinukas;NYKŠTUKAI;6659263391;Ne;0;0;4;4
1443;Drevinukas;NYKŠTUKAI;4588368596;Ne;0;0;3;3
1444;Drevinukas;SMALSUČIAI;4242944055;Ne;0;1;0;1
1445;Drevinukas;SMALSUČIAI;1094428951;Ne;0;5;1;6
1446;Drevinukas;SMALSUČIAI;2179736991;Ne;0;2;3;5
1447;Drevinukas;SMALSUČIAI;9105675010;Ne;0;1;2;3
1448;Drevinukas;SMALSUČIAI;9004568476;Ne;4;0;0;4
1449;Drevinukas;SMALSUČIAI;9283862598;Ne;5;1;4;10
1450;Drevinukas;SMALSUČIAI;8578579808;Ne;1;8;1;10
1451;Drevinukas;SMALSUČIAI;3611870655;Ne;5;1;1;7
1452;Drevinukas;SMALSUČIAI;7241671439;Ne;19;0;0;19
1453;Drevinukas;SMALSUČIAI;2246885419;Ne;0;9;0;9
1454;Drevinukas;SMALSUČIAI;4089351543;Ne;0;7;0;7
1455;Drevinukas;SMALSUČIAI;2201342382;Ne;6;0;0;6
1456;Drevinukas;SMALSUČIAI;4759293403;Ne;0;15;0;15
1457;Drevinukas;SMALSUČIAI;7863529560;Ne;7;0;0;7
1458;Drevinukas;SMALSUČIAI;9715586195;Ne;13;7;0;20
1459;Drevinukas;SMALSUČIAI;1368495173;Ne;0;7;0;7
1460;Drevinukas;SMALSUČIAI;8284025903;Ne;8;1;0;9
1461;Drevinukas;SMALSUČIAI;6492987985;Ne;5;0;1;6
1462;Drevinukas;ŽVIRBLIUKAI;8654858364;Ne;8;0;3;11
1463;Drevinukas;ŽVIRBLIUKAI;2662147175;Ne;5;1;0;6
1464;Drevinukas;ŽVIRBLIUKAI;7801920518;Ne;0;2;20;22
1465;Drevinukas;ŽVIRBLIUKAI;1570356979;Ne;13;0;0;13
1466;Drevinukas;ŽVIRBLIUKAI;8877080179;Ne;5;0;0;5
1467;Drevinukas;ŽVIRBLIUKAI;6492711565;Ne;0;0;3;3
1468;Drevinukas;ŽVIRBLIUKAI;2274377462;Taip;0;2;0;2
1469;Drevinukas;ŽVIRBLIUKAI;7316996793;Ne;0;1;0;1
1470;Drevinukas;ŽVIRBLIUKAI;3408981880;Ne;4;8;0;12
1471;Drevinukas;ŽVIRBLIUKAI;8953871512;Ne;2;0;0;2
1472;Drevinukas;ŽVIRBLIUKAI;3983656958;Ne;6;2;1;9
1473;Drevinukas;ŽVIRBLIUKAI;1957961770;Ne;0;0;3;3
1474;Drevinukas;ŽVIRBLIUKAI;5702650036;Ne;0;4;0;4
1475;Drugelis;NYKŠTUKŲ;3551095669;Ne;3;2;2;7
1476;Drugelis;NYKŠTUKŲ;1785724340;Ne;0;8;0;8
1477;Drugelis;NYKŠTUKŲ;6632884258;Ne;0;2;3;5
1478;Drugelis;NYKŠTUKŲ;7447519502;Ne;0;1;0;1
1479;Drugelis;NYKŠTUKŲ;4825232236;Ne;0;2;0;2
1480;Drugelis;NYKŠTUKŲ;7477547789;Ne;6;2;0;8
1481;Drugelis;NYKŠTUKŲ;8717445483;Ne;4;1;0;5
1482;Drugelis;NYKŠTUKŲ;4471405682;Ne;0;0;2;2
1483;Drugelis;NYKŠTUKŲ;4867387611;Ne;0;13;0;13
1484;Drugelis;NYKŠTUKŲ;7609530453;Ne;0;9;3;12
1485;Drugelis;NYKŠTUKŲ;5692743298;Ne;0;2;7;9
1486;Drugelis;NYKŠTUKŲ;6452921695;Ne;6;2;3;11
1487;Drugelis;NYKŠTUKŲ;5902687211;Ne;0;0;3;3
1488;Drugelis;NYKŠTUKŲ;8591548746;Ne;0;15;0;15
1489;Drugelis;SMALSUČIŲ;5121351234;Ne;7;1;0;8
1490;Drugelis;SMALSUČIŲ;6626437352;Ne;0;2;0;2
1491;Drugelis;SMALSUČIŲ;5000965458;Ne;2;10;0;12
1492;Drugelis;SMALSUČIŲ;9683350741;Ne;10;1;0;11
1493;Drugelis;SMALSUČIŲ;1617833459;Ne;5;0;0;5
1494;Drugelis;SMALSUČIŲ;4058293462;Ne;2;0;0;2
1495;Drugelis;SMALSUČIŲ;4805858183;Ne;2;2;2;6
1496;Drugelis;SMALSUČIŲ;9650052415;Ne;0;8;5;13
1497;Drugelis;SMALSUČIŲ;5533529267;Ne;0;3;0;3
1498;Drugelis;SMALSUČIŲ;3733097479;Ne;8;0;1;9
1499;Drugelis;SMALSUČIŲ;9066572677;Ne;0;5;1;6
1500;Drugelis;SMALSUČIŲ;2196445523;Ne;0;3;0;3
1501;Drugelis;SMALSUČIŲ;3645668411;Ne;0;3;0;3
1502;Drugelis;SMALSUČIŲ;3261462674;Ne;0;2;0;2
1503;Drugelis;SMALSUČIŲ;2644563881;Ne;4;1;0;5
1504;Drugelis;SMALSUČIŲ;6890441262;Ne;5;2;0;7
1505;Drugelis;MUMINUKŲ;7390061272;Ne;0;7;0;7
1506;Drugelis;MUMINUKŲ;3311620018;Ne;0;2;1;3
1507;Drugelis;MUMINUKŲ;8812550811;Ne;0;2;3;5
1508;Drugelis;MUMINUKŲ;5661335344;Ne;0;1;0;1
1509;Drugelis;MUMINUKŲ;6038184222;Ne;0;1;0;1
1510;Drugelis;MUMINUKŲ;9851124145;Ne;5;0;0;5
1511;Drugelis;MUMINUKŲ;7253876812;Ne;13;0;0;13
1512;Drugelis;MUMINUKŲ;1816845006;Ne;0;4;0;4
1513;Drugelis;MUMINUKŲ;1666992752;Ne;5;0;1;6
1514;Drugelis;MUMINUKŲ;9510744779;Ne;0;2;2;4
1515;Drugelis;MUMINUKŲ;9029137302;Ne;13;0;0;13
1516;Drugelis;MUMINUKŲ;9907121223;Ne;11;3;0;14
1517;Drugelis;MUMINUKŲ;8500348389;Ne;7;2;0;9
1518;Drugelis;MUMINUKŲ;1858504360;Ne;16;0;0;16
1519;Drugelis;MUMINUKŲ;8107970910;Ne;0;0;1;1
1520;Drugelis;MUMINUKŲ;5515894973;Ne;7;2;0;9
1521;Drugelis;MUMINUKŲ;8282807535;Ne;8;0;0;8
1522;Drugelis;MUMINUKŲ;3293212749;Ne;0;6;1;7
1523;Drugelis;MUMINUKŲ;2256221485;Ne;5;2;0;7
1524;Drugelis;MUMINUKŲ;9588931333;Ne;0;7;1;8
1525;Drugelis;MUMINUKŲ;1761596625;Ne;2;4;0;6
1526;Drugelis;PŪKUOTUKAI;9149748841;Ne;0;7;5;12
1527;Drugelis;PŪKUOTUKAI;1217635751;Ne;0;8;5;13
1528;Drugelis;PŪKUOTUKAI;9612696781;Ne;0;5;0;5
1529;Drugelis;PŪKUOTUKAI;1888002607;Ne;0;1;0;1
1530;Drugelis;PŪKUOTUKAI;27569805506;Ne;0;11;6;17
1531;Drugelis;PŪKUOTUKAI;1961898730;Ne;0;5;0;5
1532;Drugelis;PŪKUOTUKAI;7406396614;Ne;0;3;0;3
1533;Drugelis;PŪKUOTUKAI;1901608445;Ne;10;1;0;11
1534;Drugelis;PŪKUOTUKAI;1506988472;Ne;0;3;0;3
1535;Drugelis;PŪKUOTUKAI;1991420008;Ne;0;3;0;3
1536;Drugelis;PŪKUOTUKAI;1255124184;Ne;3;1;0;4
1537;Drugelis;PŪKUOTUKAI;1856912386;Ne;0;2;0;2
1538;Drugelis;PŪKUOTUKAI;1576853049;Ne;0;0;1;1
1539;Drugelis;PŪKUOTUKAI;68223183150;Ne;5;6;0;11
1540;Drugelis;PŪKUOTUKAI;3202149560;Ne;0;1;0;1
1541;Drugelis;PŪKUOTUKAI;5954059321;Ne;6;1;1;8
1542;Drugelis;PŪKUOTUKAI;1541276266;Ne;0;0;1;1
1543;Drugelis;PŪKUOTUKAI;4788423265;Ne;0;0;1;1
1544;Drugelis;PŪKUOTUKAI;3096906506;Ne;2;2;0;4
1545;Drugelis;SPINDULIUKAI;3560294703;Ne;5;0;3;8
1546;Drugelis;SPINDULIUKAI;9005448398;Ne;19;0;3;22
1547;Drugelis;SPINDULIUKAI;7775085427;Ne;0;15;3;18
1548;Drugelis;SPINDULIUKAI;6504082488;Ne;5;1;0;6
1549;Drugelis;SPINDULIUKAI;7321544601;Ne;0;1;0;1
1550;Drugelis;SPINDULIUKAI;9296067137;Ne;0;11;11;22
1551;Drugelis;SPINDULIUKAI;9855121078;Ne;0;7;0;7
1552;Drugelis;SPINDULIUKAI;6068102133;Ne;4;6;0;10
1553;Drugelis;SPINDULIUKAI;4812322553;Ne;0;3;0;3
1554;Drugelis;SPINDULIUKAI;4580456500;Ne;0;13;0;13
1555;Drugelis;SPINDULIUKAI;8259051898;Ne;0;2;2;4
1556;Drugelis;SPINDULIUKAI;3567930528;Ne;2;2;0;4
1557;Drugelis;SPINDULIUKAI;2573357635;Ne;0;5;4;9
1558;Drugelis;KIŠKUČIAI;3603051567;Ne;9;0;0;9
1559;Drugelis;KIŠKUČIAI;4628926113;Ne;10;3;0;13
1560;Drugelis;KIŠKUČIAI;7307032077;Ne;0;0;1;1
1561;Drugelis;KIŠKUČIAI;4871624566;Ne;5;0;0;5
1562;Drugelis;KIŠKUČIAI;1213610973;Taip;14;1;0;15
1563;Drugelis;KIŠKUČIAI;9211760307;Ne;8;0;2;10
1564;Drugelis;KIŠKUČIAI;6071997970;Ne;8;4;0;12
1565;Drugelis;KIŠKUČIAI;8819853863;Ne;5;6;0;11
1566;Drugelis;KIŠKUČIAI;5950704328;Ne;6;0;0;6
1567;Drugelis;KIŠKUČIAI;9900296726;Ne;8;0;1;9
1568;Drugelis;KIŠKUČIAI;6997707085;Ne;9;1;0;10
1569;Drugelis;KIŠKUČIAI;1375535260;Ne;2;0;0;2
1570;Drugelis;KIŠKUČIAI;5857726963;Ne;10;0;1;11
1571;Drugelis;KIŠKUČIAI;1817932444;Ne;17;0;0;17
1572;Drugelis;KIŠKUČIAI;1074913909;Ne;9;0;0;9
1573;"Du gaideliai";Uodelių;8896316882;Ne;0;10;0;10
1574;"Du gaideliai";Uodelių;6704167983;Ne;10;0;0;10
1575;"Du gaideliai";Uodelių;6942798420;Ne;0;5;0;5
1576;"Du gaideliai";Uodelių;8420400705;Ne;0;11;0;11
1577;"Du gaideliai";Uodelių;4157021754;Ne;0;0;5;5
1578;"Du gaideliai";Uodelių;7193151965;Ne;0;8;0;8
1579;"Du gaideliai";Uodelių;1968978650;Ne;0;1;0;1
1580;"Du gaideliai";Uodelių;2564259600;Ne;10;0;0;10
1581;"Du gaideliai";Uodelių;6132405512;Ne;8;6;0;14
1582;"Du gaideliai";Uodelių;2756525592;Ne;0;1;0;1
1583;"Du gaideliai";Uodelių;7563789811;Ne;5;1;0;6
1584;"Du gaideliai";Uodelių;9126780620;Ne;3;2;1;6
1585;"Du gaideliai";Uodelių;9374869616;Ne;0;2;0;2
1586;"Du gaideliai";Uodelių;5726096980;Ne;5;0;0;5
1587;"Du gaideliai";Uodelių;4408537397;Ne;0;3;0;3
1588;"Du gaideliai";Uodelių;1527839162;Ne;0;1;0;1
1589;"Du gaideliai";Uodelių;5809089345;Ne;0;4;0;4
1590;"Du gaideliai";Uodelių;8174023197;Ne;8;1;0;9
1591;"Du gaideliai";Uodelių;7372149799;Ne;10;7;0;17
1592;"Du gaideliai";Uodelių;5291934919;Ne;0;8;0;8
1593;"Du gaideliai";OŽIUKŲ;8744467866;Ne;3;0;0;3
1594;"Du gaideliai";OŽIUKŲ;7033276798;Ne;2;0;0;2
1595;"Du gaideliai";OŽIUKŲ;5788923258;Ne;0;6;0;6
1596;"Du gaideliai";OŽIUKŲ;2100449108;Ne;0;7;1;8
1597;"Du gaideliai";OŽIUKŲ;7575534590;Ne;2;4;0;6
1598;"Du gaideliai";OŽIUKŲ;3019797369;Ne;12;0;0;12
1599;"Du gaideliai";OŽIUKŲ;9356275460;Ne;2;6;2;10
1600;"Du gaideliai";OŽIUKŲ;6204233540;Ne;9;1;0;10
1601;"Du gaideliai";OŽIUKŲ;2845145754;Ne;0;12;0;12
1602;"Du gaideliai";OŽIUKŲ;7726490359;Ne;16;0;0;16
1603;"Du gaideliai";OŽIUKŲ;6762171696;Ne;0;1;0;1
1604;"Du gaideliai";OŽIUKŲ;5728374219;Ne;7;0;0;7
1605;"Du gaideliai";OŽIUKŲ;5611102395;Ne;0;9;0;9
1606;"Du gaideliai";OŽIUKŲ;8410547195;Ne;0;3;0;3
1607;"Du gaideliai";OŽIUKŲ;9585785202;Ne;17;0;0;17
1608;"Du gaideliai";OŽIUKŲ;2151825222;Ne;0;1;0;1
1609;"Du gaideliai";OŽIUKŲ;8043896286;Ne;3;4;1;8
1610;"Du gaideliai";OŽIUKŲ;6053941133;Ne;0;2;1;3
1611;"Du gaideliai";OŽIUKŲ;6120647567;Ne;0;12;0;12
1612;"Du gaideliai";OŽIUKŲ;5668878259;Ne;5;9;0;14
1613;"Du gaideliai";Vištyčių;1135098595;Ne;0;0;3;3
1614;"Du gaideliai";Vištyčių;3370029981;Ne;0;2;0;2
1615;"Du gaideliai";Vištyčių;2240947701;Ne;0;0;6;6
1616;"Du gaideliai";Vištyčių;3507387826;Ne;0;14;0;14
1617;"Du gaideliai";Vištyčių;4144269068;Ne;10;3;0;13
1618;"Du gaideliai";Vištyčių;1785976627;Ne;0;0;2;2
1619;"Du gaideliai";Vištyčių;8047413507;Ne;0;2;4;6
1620;"Du gaideliai";Vištyčių;9568647033;Ne;0;0;3;3
1621;"Du gaideliai";Vištyčių;5894974508;Ne;0;0;5;5
1622;"Du gaideliai";Vištyčių;1751328192;Ne;6;1;0;7
1623;"Du gaideliai";Vištyčių;6870356241;Ne;2;0;1;3
1624;"Du gaideliai";Vištyčių;5103483956;Ne;5;1;3;9
1625;"Du gaideliai";Vištyčių;6348951959;Ne;0;0;3;3
1626;"Du gaideliai";Vištyčių;1268479215;Ne;0;2;0;2
1627;"Du gaideliai";Vištyčių;3854355215;Ne;0;0;7;7
1628;"Du gaideliai";Vištyčių;3849899284;Ne;4;0;2;6
1629;"Du gaideliai";GAIDŽIUKŲ;1758546983;Ne;0;12;0;12
1630;"Du gaideliai";GAIDŽIUKŲ;7783203480;Ne;10;1;0;11
1631;"Du gaideliai";GAIDŽIUKŲ;94639433266;Ne;0;4;0;4
1632;"Du gaideliai";GAIDŽIUKŲ;9324740716;Ne;5;6;0;11
1633;"Du gaideliai";GAIDŽIUKŲ;6715434585;Ne;2;1;0;3
1634;"Du gaideliai";GAIDŽIUKŲ;7084763712;Ne;10;2;0;12
1635;"Du gaideliai";GAIDŽIUKŲ;1500684755;Ne;0;14;0;14
1636;"Du gaideliai";GAIDŽIUKŲ;6750787450;Ne;0;8;0;8
1637;"Du gaideliai";GAIDŽIUKŲ;5430986033;Ne;2;0;1;3
1638;"Du gaideliai";GAIDŽIUKŲ;27733314504;Ne;0;2;0;2
1639;"Du gaideliai";GAIDŽIUKŲ;1074783418;Ne;0;2;0;2
1640;"Du gaideliai";GAIDŽIUKŲ;5167460184;Ne;0;0;1;1
1641;"Du gaideliai";GAIDŽIUKŲ;1549762923;Ne;8;2;0;10
1642;"Du gaideliai";GAIDŽIUKŲ;3771563320;Ne;0;1;0;1
1643;"Du gaideliai";GAIDŽIUKŲ;6203383711;Ne;0;0;5;5
1644;"Du gaideliai";GAIDŽIUKŲ;6170362846;Ne;9;8;0;17
1645;"Du gaideliai";GAIDŽIUKŲ;7373413569;Ne;0;8;0;8
1646;"Du gaideliai";GAIDŽIUKŲ;1557413692;Ne;0;8;0;8
1647;"Du gaideliai";GAIDŽIUKŲ;3273574176;Ne;4;2;1;7
1648;"Du gaideliai";GAIDŽIUKŲ;7471332824;Ne;0;9;0;9
1649;"Du gaideliai";GAIDŽIUKŲ;4378924981;Ne;0;2;0;2
1650;"Du gaideliai";Musyčių;9506572113;Ne;10;4;0;14
1651;"Du gaideliai";Musyčių;6224116229;Ne;0;0;6;6
1652;"Du gaideliai";Musyčių;6630053388;Ne;9;0;2;11
1653;"Du gaideliai";Musyčių;5867716168;Ne;8;0;0;8
1654;"Du gaideliai";Musyčių;3654057453;Ne;8;1;0;9
1655;"Du gaideliai";Musyčių;8921985681;Ne;0;18;4;22
1656;"Du gaideliai";Musyčių;1882241729;Ne;0;6;3;9
1657;"Du gaideliai";Musyčių;5225949099;Ne;0;1;0;1
1658;"Du gaideliai";Musyčių;4204930257;Ne;5;0;4;9
1659;"Du gaideliai";Musyčių;3206388799;Taip;0;15;3;18
1660;"Du gaideliai";Musyčių;2616106413;Ne;3;0;0;3
1661;"Du gaideliai";Musyčių;2084660815;Ne;8;8;0;16
1662;"Du gaideliai";Musyčių;9934568135;Ne;0;11;0;11
1663;"Du gaideliai";Musyčių;4799107717;Ne;7;3;0;10
1664;"Du gaideliai";Musyčių;8624394105;Ne;0;14;0;14
1665;"Du gaideliai";Musyčių;2122841302;Ne;0;18;3;21
1666;"Du gaideliai";Musyčių;7153424410;Ne;0;4;0;4
1667;"Du gaideliai";Musyčių;5514521078;Ne;0;10;0;10
1668;"Du gaideliai";MALŪNO;9561040908;Ne;6;5;0;11
1669;"Du gaideliai";MALŪNO;2266999698;Ne;15;2;0;17
1670;"Du gaideliai";MALŪNO;1048130675;Taip;4;10;3;17
1671;"Du gaideliai";MALŪNO;3601150560;Ne;0;4;0;4
1672;"Du gaideliai";MALŪNO;3519099395;Ne;17;0;2;19
1673;"Du gaideliai";MALŪNO;1777283565;Ne;8;0;2;10
1674;"Du gaideliai";MALŪNO;1940981083;Ne;20;0;0;20
1675;"Du gaideliai";MALŪNO;5113352673;Ne;11;0;0;11
1676;"Du gaideliai";MALŪNO;9477645505;Ne;3;2;1;6
1677;"Du gaideliai";MALŪNO;7855653537;Ne;10;0;1;11
1678;"Du gaideliai";MALŪNO;9832883242;Ne;7;0;0;7
1679;"Du gaideliai";MALŪNO;9619723983;Ne;7;0;0;7
1680;"Du gaideliai";MALŪNO;5016914497;Ne;0;0;2;2
1681;"Du gaideliai";MALŪNO;5060904810;Ne;6;0;0;6
1682;"Du gaideliai";MALŪNO;4759244471;Ne;0;6;0;6
1683;"Du gaideliai";MALŪNO;6054058539;Ne;4;0;1;5
1684;"Du gaideliai";MALŪNO;7389148136;Ne;11;0;0;11
1685;Eglutė;RAMUNĖ;1422631723;Ne;0;17;0;17
1686;Eglutė;RAMUNĖ;2651867769;Ne;0;5;0;5
1687;Eglutė;RAMUNĖ;3473388722;Ne;3;0;0;3
1688;Eglutė;RAMUNĖ;2597978713;Ne;0;8;0;8
1689;Eglutė;RAMUNĖ;4451772812;Ne;0;11;1;12
1690;Eglutė;RAMUNĖ;9929681000;Ne;0;0;9;9
1691;Eglutė;RAMUNĖ;6105927493;Ne;0;5;0;5
1692;Eglutė;RAMUNĖ;6142326330;Ne;0;16;0;16
1693;Eglutė;RAMUNĖ;1534556744;Ne;0;2;4;6
1694;Eglutė;RAMUNĖ;4047404616;Ne;4;7;0;11
1695;Eglutė;RAMUNĖ;4230594049;Ne;0;1;5;6
1696;Eglutė;RAMUNĖ;2998190195;Ne;7;0;0;7
1697;Eglutė;RAMUNĖ;9402686801;Ne;0;4;0;4
1698;Eglutė;RAMUNĖ;6279703448;Ne;0;16;0;16
1699;Eglutė;RAMUNĖ;7598993411;Ne;4;12;0;16
1700;Eglutė;PELĖDŽIUKAI;9066178904;Ne;0;1;0;1
1701;Eglutė;PELĖDŽIUKAI;7149060118;Ne;0;7;1;8
1702;Eglutė;PELĖDŽIUKAI;8606991706;Ne;2;0;1;3
1703;Eglutė;PELĖDŽIUKAI;6518497374;Ne;8;3;0;11
1704;Eglutė;PELĖDŽIUKAI;3203786388;Ne;0;0;4;4
1705;Eglutė;PELĖDŽIUKAI;8033370429;Ne;0;7;5;12
1706;Eglutė;PELĖDŽIUKAI;3178489517;Ne;0;2;7;9
1707;Eglutė;PELĖDŽIUKAI;1510706652;Ne;0;2;0;2
1708;Eglutė;PELĖDŽIUKAI;1695732622;Ne;0;2;0;2
1709;Eglutė;PELĖDŽIUKAI;5856250605;Ne;0;10;0;10
1710;Eglutė;PELĖDŽIUKAI;2082716398;Ne;0;11;0;11
1711;Eglutė;PELĖDŽIUKAI;3616979217;Ne;2;2;0;4
1712;Eglutė;PELĖDŽIUKAI;9950953029;Ne;5;2;4;11
1713;Eglutė;PELĖDŽIUKAI;7148210944;Ne;0;13;0;13
1714;Eglutė;PELĖDŽIUKAI;1324622835;Ne;0;0;10;10
1715;Eglutė;PELĖDŽIUKAI;3275796441;Ne;2;0;4;6
1716;Eglutė;PELĖDŽIUKAI;3390360525;Ne;0;0;1;1
1717;Eglutė;KODĖLČIUKAI;4490295754;Ne;0;1;0;1
1718;Eglutė;KODĖLČIUKAI;1932785408;Ne;10;0;0;10
1719;Eglutė;KODĖLČIUKAI;3883122650;Ne;0;7;0;7
1720;Eglutė;KODĖLČIUKAI;7859815752;Ne;0;4;0;4
1721;Eglutė;KODĖLČIUKAI;4176597208;Ne;0;1;0;1
1722;Eglutė;KODĖLČIUKAI;7758643349;Ne;0;1;0;1
1723;Eglutė;KODĖLČIUKAI;5924994736;Ne;0;2;0;2
1724;Eglutė;KODĖLČIUKAI;1759383841;Ne;0;5;0;5
1725;Eglutė;KODĖLČIUKAI;6597261061;Ne;0;2;0;2
1726;Eglutė;KODĖLČIUKAI;9356785605;Ne;0;6;0;6
1727;Eglutė;KODĖLČIUKAI;8943684351;Ne;5;0;0;5
1728;Eglutė;KODĖLČIUKAI;8165126017;Ne;0;1;0;1
1729;Eglutė;KODĖLČIUKAI;9967488317;Ne;0;1;0;1
1730;Eglutė;KODĖLČIUKAI;3584247594;Ne;0;9;0;9
1731;Eglutė;KODĖLČIUKAI;9758104910;Ne;0;0;2;2
1732;Eglutė;KODĖLČIUKAI;1531942494;Ne;0;5;0;5
1733;Eglutė;KODĖLČIUKAI;9515238936;Ne;0;22;0;22
1734;Eglutė;KODĖLČIUKAI;5840014240;Ne;0;9;0;9
1735;Eglutė;OBUOLIUKAI;3799824061;Ne;0;12;0;12
1736;Eglutė;OBUOLIUKAI;1744942011;Ne;0;0;3;3
1737;Eglutė;OBUOLIUKAI;7027121333;Ne;0;6;3;9
1738;Eglutė;OBUOLIUKAI;6679186715;Ne;0;0;15;15
1739;Eglutė;OBUOLIUKAI;8655425408;Ne;1;0;4;5
1740;Eglutė;OBUOLIUKAI;3387392137;Taip;2;2;0;4
1741;Eglutė;OBUOLIUKAI;8384141923;Ne;0;2;8;10
1742;Eglutė;OBUOLIUKAI;3112281182;Ne;15;0;1;16
1743;Eglutė;OBUOLIUKAI;4876032787;Ne;0;0;1;1
1744;Eglutė;OBUOLIUKAI;9542684993;Ne;0;2;0;2
1745;Eglutė;OBUOLIUKAI;6967074765;Ne;0;11;0;11
1746;Eglutė;OBUOLIUKAI;9193920390;Ne;0;1;0;1
1747;Eglutė;OBUOLIUKAI;1380219881;Ne;0;0;4;4
1748;Eglutė;OBUOLIUKAI;8721209423;Ne;0;7;2;9
1749;Eglutė;OBUOLIUKAI;1774538642;Ne;5;0;2;7
1750;Eglutė;OBUOLIUKAI;3903612086;Ne;0;6;0;6
1751;Eglutė;OBUOLIUKAI;7789753835;Ne;5;0;0;5
1752;Eglutė;KAŠTONAS;4099257155;Ne;0;22;0;22
1753;Eglutė;KAŠTONAS;6009794480;Ne;0;2;0;2
1754;Eglutė;KAŠTONAS;6539887315;Ne;0;5;0;5
1755;Eglutė;KAŠTONAS;4252256130;Ne;3;5;2;10
1756;Eglutė;KAŠTONAS;8534997648;Ne;14;0;2;16
1757;Eglutė;KAŠTONAS;7234851379;Ne;0;0;2;2
1758;Eglutė;KAŠTONAS;5636437290;Ne;0;2;1;3
1759;Eglutė;KAŠTONAS;8797889347;Taip;0;1;0;1
1760;Eglutė;KAŠTONAS;1842517164;Ne;0;0;14;14
1761;Eglutė;KAŠTONAS;2121177107;Taip;0;0;1;1
1762;Eglutė;KAŠTONAS;2357276888;Ne;0;0;2;2
1763;Eglutė;KAŠTONAS;2816913563;Ne;7;1;0;8
1764;Eglutė;KAŠTONAS;6146679388;Ne;4;1;0;5
1765;Eglutė;KAŠTONAS;5166183300;Ne;0;10;0;10
1766;Eglutė;KAŠTONAS;7984911632;Ne;0;2;0;2
1767;Eglutė;KAŠTONAS;7811667336;Ne;0;1;0;1
1768;Eglutė;KAŠTONAS;3650609128;Ne;0;1;0;1
1769;Eglutė;EŽIUKAI;7491022301;Ne;0;1;0;1
1770;Eglutė;EŽIUKAI;5943856319;Ne;0;2;3;5
1771;Eglutė;EŽIUKAI;1436966647;Ne;0;1;0;1
1772;Eglutė;EŽIUKAI;6891834971;Ne;0;1;0;1
1773;Eglutė;EŽIUKAI;7307564177;Ne;0;6;0;6
1774;Eglutė;EŽIUKAI;7823828202;Ne;0;2;1;3
1775;Eglutė;EŽIUKAI;7354260503;Ne;0;2;0;2
1776;Eglutė;EŽIUKAI;9439309687;Ne;0;2;4;6
1777;Eglutė;EŽIUKAI;1122308715;Ne;0;1;0;1
1778;Eglutė;EŽIUKAI;8523618773;Ne;0;22;0;22
1779;Eglutė;EŽIUKAI;3856651647;Ne;0;2;1;3
1780;Eglutė;EŽIUKAI;8421062747;Ne;2;2;2;6
1781;Eglutė;EŽIUKAI;5731355126;Ne;0;2;0;2
1782;Eglutė;EŽIUKAI;8364693548;Ne;0;4;0;4
1783;Eglutė;EŽIUKAI;1265463853;Ne;0;2;0;2
1784;Eglutė;EŽIUKAI;1908835124;Ne;0;12;0;12
1785;Eglutė;EŽIUKAI;9527732584;Ne;0;1;0;1
1786;Eglutė;EŽIUKAI;8162972897;Ne;0;9;0;9
1787;Eglutė;EŽIUKAI;4348313801;Ne;0;4;1;5
1788;Eglutė;EŽIUKAI;9042793284;Ne;0;3;0;3
1789;Eglutė;GILĖ;1550045866;Ne;1;0;0;1
1790;Eglutė;GILĖ;8325288373;Ne;0;0;7;7
1791;Eglutė;GILĖ;6272115803;Taip;2;2;0;4
1792;Eglutė;GILĖ;5650957826;Ne;0;1;0;1
1793;Eglutė;GILĖ;8129230197;Ne;0;7;5;12
1794;Eglutė;GILĖ;1835565594;Ne;0;2;1;3
1795;Eglutė;GILĖ;1393626624;Ne;0;11;0;11
1796;Eglutė;GILĖ;2917925763;Ne;4;0;0;4
1797;Eglutė;GILĖ;3740322448;Ne;7;0;0;7
1798;Eglutė;GILĖ;2276311106;Ne;0;2;0;2
1799;Eglutė;GILĖ;5645197324;Ne;0;0;6;6
1800;Eglutė;GILĖ;2615824395;Ne;8;2;0;10
1801;Eglutė;GILĖ;1899379269;Ne;0;0;3;3
1802;Eglutė;GILĖ;3605053253;Ne;16;0;0;16
1803;Eglutė;SAULUTĖ;9741776217;Ne;0;4;0;4
1804;Eglutė;SAULUTĖ;3091324735;Ne;0;2;0;2
1805;Eglutė;SAULUTĖ;8739346084;Ne;0;2;0;2
1806;Eglutė;SAULUTĖ;5518570006;Ne;8;2;0;10
1807;Eglutė;SAULUTĖ;5805450838;Ne;0;2;0;2
1808;Eglutė;SAULUTĖ;9084576953;Ne;0;1;12;13
1809;Eglutė;SAULUTĖ;6309529738;Ne;0;1;0;1
1810;Eglutė;SAULUTĖ;2259077568;Ne;0;2;0;2
1811;Eglutė;SAULUTĖ;4489150480;Ne;17;2;1;20
1812;Eglutė;SAULUTĖ;2425927050;Ne;0;7;0;7
1813;Eglutė;SAULUTĖ;5918429438;Ne;8;0;1;9
1814;Eglutė;SAULUTĖ;5006042568;Ne;0;8;0;8
1815;Eglutė;SAULUTĖ;5275306818;Ne;0;0;11;11
1816;Eglutė;SAULUTĖ;2621445549;Ne;2;0;0;2
1817;Eglutė;SAULUTĖ;6328900251;Ne;2;1;1;4
1818;Eglutė;SAULUTĖ;9661883776;Ne;0;1;0;1
1819;Eglutė;SAULUTĖ;8799063905;Ne;0;1;0;1
1820;Eglutė;SAULUTĖ;5108928996;Ne;0;5;3;8
1821;Eglutė;SAULUTĖ;6572235324;Ne;0;10;0;10
1822;Eglutė;SAULUTĖ;1923176808;Ne;0;11;0;11
1823;Eglutė;SAULUTĖ;2872597971;Ne;0;2;2;4
1824;Eglutė;SAULUTĖ;6424893248;Ne;7;2;0;9
1825;Eglutė;SAULUTĖ;3690266358;Ne;0;7;5;12
1826;Eglutė;ŠARKELĖ;7831541089;Ne;0;22;0;22
1827;Eglutė;ŠARKELĖ;3430016771;Ne;0;18;0;18
1828;Eglutė;ŠARKELĖ;6382927775;Ne;0;13;0;13
1829;Eglutė;ŠARKELĖ;7919553451;Ne;0;5;0;5
1830;Eglutė;ŠARKELĖ;7229612001;Ne;0;7;0;7
1831;Eglutė;ŠARKELĖ;4932945207;Ne;2;1;0;3
1832;Eglutė;ŠARKELĖ;5407757245;Ne;4;5;0;9
1833;Eglutė;ŠARKELĖ;3237476593;Ne;0;3;0;3
1834;Eglutė;ŠARKELĖ;9542103745;Ne;14;0;0;14
1835;Eglutė;ŠARKELĖ;1122907387;Ne;0;2;0;2
1836;Eglutė;ŠARKELĖ;9686836846;Ne;0;4;0;4
1837;Eglutė;ŠARKELĖ;7735192219;Ne;0;4;0;4
1838;Eglutė;ŠARKELĖ;5779671024;Ne;0;2;0;2
1839;Eglutė;ŠARKELĖ;5783776734;Ne;0;15;0;15
1840;Eglutė;ŠARKELĖ;4490541539;Ne;0;1;0;1
1841;Eglutė;ŠARKELĖ;6653111225;Ne;0;0;4;4
1842;Eglutė;NYKŠTUKAI;3011330968;Ne;0;2;2;4
1843;Eglutė;NYKŠTUKAI;8037564034;Ne;0;13;0;13
1844;Eglutė;NYKŠTUKAI;3368734808;Ne;0;0;1;1
1845;Eglutė;NYKŠTUKAI;8749425471;Ne;0;1;0;1
1846;Eglutė;NYKŠTUKAI;4151258155;Ne;15;1;0;16
1847;Eglutė;NYKŠTUKAI;6965837585;Ne;4;0;0;4
1848;Eglutė;NYKŠTUKAI;5103022009;Ne;9;2;0;11
1849;Eglutė;NYKŠTUKAI;8542684582;Ne;0;0;22;22
1850;Eglutė;NYKŠTUKAI;3091697091;Ne;0;7;1;8
1851;Eglutė;NYKŠTUKAI;4823811890;Ne;4;1;0;5
1852;Eglutė;NYKŠTUKAI;9292940501;Ne;8;1;0;9
1853;Eglutė;NYKŠTUKAI;3210398495;Ne;0;1;6;7
1854;Eglutė;NYKŠTUKAI;7313013331;Ne;0;10;1;11
1855;Eglutė;NYKŠTUKAI;3051637136;Ne;15;0;0;15
1856;Eglutė;NYKŠTUKAI;4056836413;Ne;6;1;0;7
1857;Eglutė;NYKŠTUKAI;3089527202;Ne;3;0;2;5
1858;Eglutė;NYKŠTUKAI;2669400743;Ne;0;16;0;16
1859;Eglutė;NYKŠTUKAI;9845413768;Ne;7;0;2;9
1860;Eglutė;NYKŠTUKAI;1460628870;Ne;13;2;2;17
1861;Eglutė;ŽIRNIUKAI;3706904006;Ne;5;0;3;8
1862;Eglutė;ŽIRNIUKAI;8698242107;Ne;10;0;11;21
1863;Eglutė;ŽIRNIUKAI;2546506486;Ne;0;0;13;13
1864;Eglutė;ŽIRNIUKAI;6103657328;Ne;11;0;0;11
1865;Eglutė;ŽIRNIUKAI;4465995209;Ne;2;1;0;3
1866;Eglutė;ŽIRNIUKAI;9795027066;Ne;15;0;0;15
1867;Eglutė;ŽIRNIUKAI;3006002253;Ne;0;0;15;15
1868;Eglutė;ŽIRNIUKAI;4539946535;Ne;3;0;8;11
1869;Eglutė;ŽIRNIUKAI;4697026463;Ne;5;4;0;9
1870;Eglutė;ŽIRNIUKAI;2107488723;Ne;13;0;0;13
1871;Eglutė;ŽIRNIUKAI;9381529574;Ne;12;0;3;15
1872;Eglutė;ŽIRNIUKAI;9150254806;Ne;7;5;0;12
1873;Eglutė;ŽIRNIUKAI;7256251859;Ne;5;0;0;5
1874;Eglutė;ŽIRNIUKAI;6336987111;Ne;9;1;0;10
1875;Eglutė;ŽIRNIUKAI;2950414583;Ne;0;0;11;11
1876;Eglutė;BORUŽIUKAI;5592515139;Ne;5;0;0;5
1877;Eglutė;BORUŽIUKAI;9964146295;Ne;0;2;0;2
1878;Eglutė;BORUŽIUKAI;1630903587;Ne;2;16;0;18
1879;Eglutė;BORUŽIUKAI;7254436716;Ne;0;1;0;1
1880;Eglutė;BORUŽIUKAI;5982037450;Ne;0;10;0;10
1881;Eglutė;BORUŽIUKAI;7994301287;Ne;0;19;0;19
1882;Eglutė;BORUŽIUKAI;9300315869;Ne;0;22;0;22
1883;Eglutė;BORUŽIUKAI;7231828805;Ne;0;9;0;9
1884;Eglutė;BORUŽIUKAI;5704418881;Ne;11;0;0;11
1885;Eglutė;BORUŽIUKAI;8410302338;Ne;0;7;0;7
1886;Eglutė;BORUŽIUKAI;1667851586;Ne;8;0;2;10
1887;Eglutė;BORUŽIUKAI;1715411901;Ne;0;2;6;8
1888;Eglutė;BORUŽIUKAI;7564179845;Ne;0;0;1;1
1889;Eglutė;BORUŽIUKAI;9178835404;Ne;0;2;0;2
1890;Eglutė;BORUŽIUKAI;5146804510;Ne;0;0;1;1
1891;Eglutė;BORUŽIUKAI;6805213753;Ne;10;0;5;15
1892;"Geniukų kalvė";SAULUTĖS;9557055841;Ne;12;0;0;12
1893;"Geniukų kalvė";SAULUTĖS;4329782598;Ne;0;12;0;12
1894;"Geniukų kalvė";SAULUTĖS;8932671578;Ne;13;0;0;13
1895;"Geniukų kalvė";SAULUTĖS;9711047774;Ne;2;0;1;3
1896;"Geniukų kalvė";SAULUTĖS;9522911738;Ne;5;6;0;11
1897;"Geniukų kalvė";SAULUTĖS;5348211316;Ne;0;5;0;5
1898;"Geniukų kalvė";SAULUTĖS;7886553419;Ne;0;1;0;1
1899;"Geniukų kalvė";SAULUTĖS;4946218794;Ne;0;0;2;2
1900;"Geniukų kalvė";SAULUTĖS;4525874796;Ne;0;0;1;1
1901;"Geniukų kalvė";SAULUTĖS;4745451344;Ne;4;0;3;7
1902;"Geniukų kalvė";SAULUTĖS;9768077014;Ne;5;0;0;5
1903;"Geniukų kalvė";SAULUTĖS;3889643236;Ne;9;0;0;9
1904;"Geniukų kalvė";SAULUTĖS;6102906310;Ne;0;0;2;2
1905;"Geniukų kalvė";SAULUTĖS;6016735700;Ne;7;8;0;15
1906;"Geniukų kalvė";SAULUTĖS;9976423099;Ne;8;5;0;13
1907;"Geniukų kalvė";BITUTĖS;5587035951;Ne;2;0;0;2
1908;"Geniukų kalvė";BITUTĖS;9323779212;Ne;11;0;0;11
1909;"Geniukų kalvė";BITUTĖS;8577323715;Ne;10;0;0;10
1910;"Geniukų kalvė";BITUTĖS;7453065865;Ne;18;0;0;18
1911;"Geniukų kalvė";BITUTĖS;8570015975;Ne;7;0;0;7
1912;"Geniukų kalvė";BITUTĖS;4633553106;Ne;10;0;0;10
1913;"Geniukų kalvė";BITUTĖS;3669378459;Ne;10;0;0;10
1914;"Geniukų kalvė";BITUTĖS;4201333532;Ne;0;1;0;1
1915;"Geniukų kalvė";BITUTĖS;5102325807;Ne;9;4;0;13
1916;"Geniukų kalvė";BITUTĖS;1492140432;Ne;15;0;0;15
1917;"Geniukų kalvė";BITUTĖS;1426555835;Ne;10;2;0;12
1918;"Geniukų kalvė";BITUTĖS;6138451393;Ne;5;4;0;9
1919;"Geniukų kalvė";BITUTĖS;7747615302;Ne;5;6;0;11
1920;"Geniukų kalvė";BITUTĖS;4691978116;Ne;24;0;0;24
1921;"Geniukų kalvė";BITUTĖS;6111168227;Ne;9;0;0;9
1922;"Geniukų kalvė";BITUTĖS;7744441981;Ne;3;0;2;5
1923;"Geniukų kalvė";BITUTĖS;1209268848;Ne;0;0;5;5
1924;"Geniukų kalvė";BITUTĖS;6351861630;Ne;9;1;0;10
1925;"Geniukų kalvė";BITUTĖS;6214681079;Ne;0;1;0;1
1926;"Geniukų kalvė";BITUTĖS;3221034847;Ne;10;0;4;14
1927;"Geniukų kalvė";KIŠKUČIAI;5253380852;Ne;0;0;5;5
1928;"Geniukų kalvė";KIŠKUČIAI;2684344984;Ne;10;0;0;10
1929;"Geniukų kalvė";KIŠKUČIAI;9075192344;Ne;0;8;0;8
1930;"Geniukų kalvė";KIŠKUČIAI;5078771341;Ne;11;0;0;11
1931;"Geniukų kalvė";KIŠKUČIAI;4849740486;Ne;6;0;0;6
1932;"Geniukų kalvė";KIŠKUČIAI;9730758999;Ne;12;0;0;12
1933;"Geniukų kalvė";KIŠKUČIAI;9579750299;Ne;0;0;1;1
1934;"Geniukų kalvė";KIŠKUČIAI;4507631652;Ne;0;0;2;2
1935;"Geniukų kalvė";KIŠKUČIAI;9386761753;Ne;7;6;0;13
1936;"Geniukų kalvė";KIŠKUČIAI;4864216994;Ne;10;0;0;10
1937;"Geniukų kalvė";KIŠKUČIAI;6188518268;Ne;0;0;3;3
1938;"Geniukų kalvė";KIŠKUČIAI;1945456486;Ne;8;0;4;12
1939;"Geniukų kalvė";KIŠKUČIAI;3887137828;Ne;12;0;0;12
1940;"Geniukų kalvė";KIŠKUČIAI;2396085192;Ne;7;6;0;13
1941;"Geniukų kalvė";VYTURĖLIAI;1568133009;Ne;0;6;0;6
1942;"Geniukų kalvė";VYTURĖLIAI;8939171238;Ne;0;1;0;1
1943;"Geniukų kalvė";VYTURĖLIAI;2337226175;Ne;0;3;0;3
1944;"Geniukų kalvė";VYTURĖLIAI;2140334255;Ne;0;2;0;2
1945;"Geniukų kalvė";VYTURĖLIAI;7664689396;Ne;0;5;0;5
1946;"Geniukų kalvė";VYTURĖLIAI;4844734556;Ne;0;4;0;4
1947;"Geniukų kalvė";VYTURĖLIAI;8635708009;Ne;10;4;0;14
1948;"Geniukų kalvė";VYTURĖLIAI;4758435835;Ne;0;4;0;4
1949;"Geniukų kalvė";VYTURĖLIAI;2729442911;Ne;0;2;0;2
1950;"Geniukų kalvė";VYTURĖLIAI;23023070502;Ne;0;1;0;1
1951;"Geniukų kalvė";VYTURĖLIAI;9081596975;Ne;0;13;0;13
1952;"Geniukų kalvė";VYTURĖLIAI;8668696743;Ne;0;7;0;7
1953;"Geniukų kalvė";VYTURĖLIAI;2890934301;Ne;9;1;0;10
1954;"Geniukų kalvė";VYTURĖLIAI;2904091819;Ne;0;4;0;4
1955;"Geniukų kalvė";VYTURĖLIAI;43097490633;Ne;0;18;0;18
1956;"Geniukų kalvė";VYTURĖLIAI;1460456166;Ne;0;2;0;2
1957;"Geniukų kalvė";VYTURĖLIAI;30932565379;Ne;4;4;0;8
1958;"Geniukų kalvė";VYTURĖLIAI;3826265557;Ne;0;2;0;2
1959;"Geniukų kalvė";VYTURĖLIAI;5756909142;Ne;3;2;0;5
1960;"Geniukų kalvė";DRUGELIAI;9676782662;Ne;2;0;0;2
1961;"Geniukų kalvė";DRUGELIAI;7745656622;Ne;0;3;0;3
1962;"Geniukų kalvė";DRUGELIAI;6520429663;Ne;0;0;1;1
1963;"Geniukų kalvė";DRUGELIAI;5542539934;Ne;0;2;0;2
1964;"Geniukų kalvė";DRUGELIAI;6466912385;Ne;0;5;0;5
1965;"Geniukų kalvė";DRUGELIAI;2016254460;Ne;0;3;0;3
1966;"Geniukų kalvė";DRUGELIAI;3984265624;Ne;0;7;0;7
1967;"Geniukų kalvė";DRUGELIAI;4813232640;Ne;5;0;0;5
1968;"Geniukų kalvė";DRUGELIAI;7081093742;Ne;0;0;1;1
1969;"Geniukų kalvė";DRUGELIAI;5776314197;Ne;2;0;0;2
1970;"Geniukų kalvė";DRUGELIAI;1897809684;Ne;0;2;0;2
1971;"Geniukų kalvė";DRUGELIAI;8872900558;Ne;0;1;0;1
1972;"Geniukų kalvė";DRUGELIAI;2031800114;Ne;0;2;0;2
1973;"Geniukų kalvė";DRUGELIAI;1451190239;Ne;0;2;1;3
1974;"Geniukų kalvė";DRUGELIAI;6500641378;Ne;0;2;0;2
1975;"Geniukų kalvė";DRUGELIAI;2143334688;Ne;5;1;0;6
1976;"Geniukų kalvė";DRUGELIAI;9990243525;Ne;0;0;3;3
1977;"Geniukų kalvė";DRUGELIAI;48818906299;Ne;0;2;0;2
1978;"Geniukų kalvė";"SAULĖS ZUIKUČIAI";7033628178;Ne;0;2;0;2
1979;"Geniukų kalvė";"SAULĖS ZUIKUČIAI";7082945033;Ne;2;1;0;3
1980;"Geniukų kalvė";"SAULĖS ZUIKUČIAI";2313382307;Ne;0;0;1;1
1981;"Geniukų kalvė";"SAULĖS ZUIKUČIAI";7500079028;Ne;9;0;5;14
1982;"Geniukų kalvė";"SAULĖS ZUIKUČIAI";8071493871;Ne;12;0;0;12
1983;"Geniukų kalvė";"SAULĖS ZUIKUČIAI";1718428600;Ne;3;0;0;3
1984;"Geniukų kalvė";"SAULĖS ZUIKUČIAI";8914605154;Ne;2;0;3;5
1985;"Geniukų kalvė";"SAULĖS ZUIKUČIAI";6016585056;Ne;0;0;1;1
1986;"Geniukų kalvė";"SAULĖS ZUIKUČIAI";5512172533;Ne;5;5;0;10
1987;"Geniukų kalvė";"SAULĖS ZUIKUČIAI";1375674317;Ne;0;3;0;3
1988;"Geniukų kalvė";"SAULĖS ZUIKUČIAI";4722801116;Ne;0;1;0;1
1989;"Geniukų kalvė";"SAULĖS ZUIKUČIAI";5763009912;Ne;5;1;0;6
1990;"Geniukų kalvė";"SAULĖS ZUIKUČIAI";5245434552;Ne;0;2;0;2
1991;"Geniukų kalvė";"SAULĖS ZUIKUČIAI";2952604528;Ne;10;0;0;10
1992;"Geniukų kalvė";"SAULĖS ZUIKUČIAI";5725034297;Ne;0;4;0;4
1993;"Geniukų kalvė";"SAULĖS ZUIKUČIAI";1499735818;Ne;8;7;0;15
1994;"Geniukų kalvė";"SAULĖS ZUIKUČIAI";4186376527;Ne;10;1;0;11
1995;"Geniukų kalvė";"SAULĖS ZUIKUČIAI";5161600326;Ne;0;0;3;3
1996;"Geniukų kalvė";SMALSUČIAI;5974481787;Ne;8;0;0;8
1997;"Geniukų kalvė";SMALSUČIAI;8985466295;Ne;2;0;0;2
1998;"Geniukų kalvė";SMALSUČIAI;5129841490;Ne;9;1;0;10
1999;"Geniukų kalvė";SMALSUČIAI;4231659246;Ne;4;0;0;4
2000;"Geniukų kalvė";SMALSUČIAI;2300947427;Ne;0;1;0;1
2001;"Geniukų kalvė";SMALSUČIAI;1028242614;Ne;5;1;0;6
2002;"Geniukų kalvė";SMALSUČIAI;2596680448;Ne;0;15;0;15
2003;"Geniukų kalvė";SMALSUČIAI;6730270449;Ne;10;1;0;11
2004;"Geniukų kalvė";SMALSUČIAI;4405381922;Ne;5;1;0;6
2005;"Geniukų kalvė";SMALSUČIAI;6473724074;Ne;13;0;0;13
2006;"Geniukų kalvė";SMALSUČIAI;3627418555;Ne;0;5;0;5
2007;"Geniukų kalvė";SMALSUČIAI;9155681194;Taip;5;1;0;6
2008;"Geniukų kalvė";SMALSUČIAI;7440029486;Ne;0;2;0;2
2009;"Geniukų kalvė";SMALSUČIAI;7140298387;Ne;10;0;0;10
2010;"Geniukų kalvė";SMALSUČIAI;6168422514;Ne;13;0;0;13
2011;"Geniukų kalvė";SMALSUČIAI;6514696294;Ne;0;5;0;5
2012;"Geniukų kalvė";SMALSUČIAI;6757580298;Ne;6;0;0;6
2013;"Geniukų kalvė";RUDNOSIUKAI;6149037133;Ne;0;17;0;17
2014;"Geniukų kalvė";RUDNOSIUKAI;5883913787;Ne;0;3;0;3
2015;"Geniukų kalvė";RUDNOSIUKAI;9696452101;Ne;0;3;1;4
2016;"Geniukų kalvė";RUDNOSIUKAI;2426186771;Ne;3;0;0;3
2017;"Geniukų kalvė";RUDNOSIUKAI;5205178173;Ne;3;0;1;4
2018;"Geniukų kalvė";RUDNOSIUKAI;9847003556;Ne;7;0;0;7
2019;"Geniukų kalvė";RUDNOSIUKAI;7300853810;Ne;6;0;0;6
2020;"Geniukų kalvė";RUDNOSIUKAI;2839299179;Ne;0;1;0;1
2021;"Geniukų kalvė";RUDNOSIUKAI;4664026888;Ne;0;2;1;3
2022;"Geniukų kalvė";RUDNOSIUKAI;3852896932;Ne;9;0;0;9
2023;"Geniukų kalvė";RUDNOSIUKAI;2165793561;Ne;0;7;0;7
2024;"Geniukų kalvė";RUDNOSIUKAI;8973285553;Ne;10;0;0;10
2025;"Geniukų kalvė";RUDNOSIUKAI;4985606198;Ne;0;0;1;1
2026;"Geniukų kalvė";RUDNOSIUKAI;3152130511;Ne;12;0;1;13
2027;"Geniukų kalvė";RUDNOSIUKAI;2798750158;Ne;0;1;0;1
2028;"Geniukų kalvė";PELĖDŽIUKAI;1237228692;Ne;1;0;0;1
2029;"Geniukų kalvė";PELĖDŽIUKAI;3055777730;Ne;0;5;0;5
2030;"Geniukų kalvė";PELĖDŽIUKAI;6070945557;Taip;0;4;0;4
2031;"Geniukų kalvė";PELĖDŽIUKAI;1051563985;Ne;0;1;0;1
2032;"Geniukų kalvė";PELĖDŽIUKAI;6174114461;Ne;7;1;0;8
2033;"Geniukų kalvė";PELĖDŽIUKAI;2659298240;Ne;0;1;0;1
2034;"Geniukų kalvė";PELĖDŽIUKAI;6737863183;Ne;0;2;4;6
2035;"Geniukų kalvė";PELĖDŽIUKAI;5704223824;Taip;10;0;0;10
2036;"Geniukų kalvė";PELĖDŽIUKAI;1811866428;Ne;0;15;0;15
2037;"Geniukų kalvė";PELĖDŽIUKAI;4843411757;Ne;0;2;0;2
2038;"Geniukų kalvė";PELĖDŽIUKAI;8770345339;Ne;0;8;5;13
2039;"Geniukų kalvė";PELĖDŽIUKAI;5146141771;Ne;0;0;2;2
2040;"Geniukų kalvė";PELĖDŽIUKAI;9677583445;Ne;9;2;0;11
2041;"Geniukų kalvė";BORUŽĖLĖS;9613720001;Ne;5;1;0;6
2042;"Geniukų kalvė";BORUŽĖLĖS;4958738745;Ne;0;8;0;8
2043;"Geniukų kalvė";BORUŽĖLĖS;9069256760;Ne;9;0;0;9
2044;"Geniukų kalvė";BORUŽĖLĖS;5161535756;Ne;2;3;0;5
2045;"Geniukų kalvė";BORUŽĖLĖS;3493492581;Ne;0;1;1;2
2046;"Geniukų kalvė";BORUŽĖLĖS;3085228868;Ne;14;1;0;15
2047;"Geniukų kalvė";BORUŽĖLĖS;6794151223;Ne;10;1;0;11
2048;"Geniukų kalvė";BORUŽĖLĖS;1037854104;Ne;6;1;0;7
2049;"Geniukų kalvė";BORUŽĖLĖS;2205515766;Ne;3;0;0;3
2050;"Geniukų kalvė";BORUŽĖLĖS;8769761434;Ne;5;3;0;8
2051;"Geniukų kalvė";BORUŽĖLĖS;1891205998;Ne;0;6;0;6
2052;"Geniukų kalvė";BORUŽĖLĖS;9643242164;Ne;3;2;0;5
2053;"Geniukų kalvė";BORUŽĖLĖS;2665955524;Ne;0;1;1;2
2054;"Geniukų kalvė";BORUŽĖLĖS;4872435715;Ne;10;0;1;11
2055;"Geniukų kalvė";BORUŽĖLĖS;3297360222;Ne;0;12;0;12
2056;"Geniukų kalvė";BORUŽĖLĖS;6828079735;Ne;4;1;2;7
2057;"Geniukų kalvė";BORUŽĖLĖS;2710207578;Ne;6;1;2;9
2058;"Geniukų kalvė";BORUŽĖLĖS;1454724752;Ne;7;0;0;7
2059;"Geniukų kalvė";PAGRANDUKAI;1844495906;Ne;5;10;0;15
2060;"Geniukų kalvė";PAGRANDUKAI;4890413509;Ne;14;0;0;14
2061;"Geniukų kalvė";PAGRANDUKAI;2490231586;Ne;0;5;0;5
2062;"Geniukų kalvė";PAGRANDUKAI;9319251542;Ne;2;0;0;2
2063;"Geniukų kalvė";PAGRANDUKAI;7310171451;Ne;8;3;1;12
2064;"Geniukų kalvė";PAGRANDUKAI;8214399001;Ne;0;6;0;6
2065;"Geniukų kalvė";PAGRANDUKAI;8653679467;Ne;0;8;0;8
2066;"Geniukų kalvė";PAGRANDUKAI;9820642056;Ne;4;2;3;9
2067;"Geniukų kalvė";PAGRANDUKAI;5115570519;Taip;7;0;0;7
2068;"Geniukų kalvė";PAGRANDUKAI;6783296167;Ne;5;0;4;9
2069;"Geniukų kalvė";PAGRANDUKAI;8525540366;Ne;9;0;1;10
2070;"Geniukų kalvė";PAGRANDUKAI;5744371590;Ne;0;0;3;3
2071;"Geniukų kalvė";PAGRANDUKAI;5847488152;Ne;10;1;0;11
2072;"Geniukų kalvė";PAGRANDUKAI;3676717541;Ne;5;0;3;8
2073;"Geniukų kalvė";NYKŠTUKAI;7561521903;Ne;0;0;7;7
2074;"Geniukų kalvė";NYKŠTUKAI;2312298671;Ne;22;0;0;22
2075;"Geniukų kalvė";NYKŠTUKAI;8217855034;Ne;0;10;0;10
2076;"Geniukų kalvė";NYKŠTUKAI;1421857914;Ne;0;5;1;6
2077;"Geniukų kalvė";NYKŠTUKAI;1558977259;Ne;0;2;1;3
2078;"Geniukų kalvė";NYKŠTUKAI;4805806745;Ne;11;0;0;11
2079;"Geniukų kalvė";NYKŠTUKAI;1383717352;Ne;11;0;0;11
2080;"Geniukų kalvė";NYKŠTUKAI;3071724778;Ne;0;15;1;16
2081;"Geniukų kalvė";NYKŠTUKAI;2302465593;Ne;6;0;0;6
2082;"Geniukų kalvė";NYKŠTUKAI;3024701779;Ne;0;4;0;4
2083;"Geniukų kalvė";NYKŠTUKAI;1822730314;Ne;10;0;2;12
2084;"Geniukų kalvė";NYKŠTUKAI;3015544833;Ne;14;2;2;18
2085;"Geniukų kalvė";NYKŠTUKAI;6680434763;Ne;0;3;0;3
2086;"Geniukų kalvė";NYKŠTUKAI;7736527608;Ne;5;1;0;6
2087;"Geniukų kalvė";NYKŠTUKAI;6860580488;Ne;15;0;0;15
2088;"Geniukų kalvė";NYKŠTUKAI;9322790214;Ne;7;0;1;8
2089;Gelvonėlis;ĄŽUOLIUKAI;2329699993;Ne;4;2;0;6
2090;Gelvonėlis;ĄŽUOLIUKAI;9058956012;Ne;18;0;0;18
2091;Gelvonėlis;ĄŽUOLIUKAI;4111774915;Ne;0;0;3;3
2092;Gelvonėlis;ĄŽUOLIUKAI;3677100165;Ne;10;0;1;11
2093;Gelvonėlis;ĄŽUOLIUKAI;7449710008;Ne;0;10;0;10
2094;Gelvonėlis;ĄŽUOLIUKAI;9492898584;Ne;0;6;0;6
2095;Gelvonėlis;ĄŽUOLIUKAI;8163855482;Ne;0;5;6;11
2096;Gelvonėlis;ĄŽUOLIUKAI;3942630720;Ne;4;7;0;11
2097;Gelvonėlis;ĄŽUOLIUKAI;1453271708;Ne;10;2;0;12
2098;Gelvonėlis;ĄŽUOLIUKAI;9756155028;Ne;5;5;0;10
2099;Gelvonėlis;ĄŽUOLIUKAI;8206816148;Ne;8;1;0;9
2100;Gelvonėlis;ĄŽUOLIUKAI;1274119900;Ne;0;0;4;4
2101;Gelvonėlis;ĄŽUOLIUKAI;5901499708;Ne;2;7;0;9
2102;Gelvonėlis;ĄŽUOLIUKAI;1403890893;Taip;5;13;0;18
2103;Gelvonėlis;ŽVIRBLIUKAI;6604992169;Ne;0;4;0;4
2104;Gelvonėlis;ŽVIRBLIUKAI;6556472766;Ne;0;0;11;11
2105;Gelvonėlis;ŽVIRBLIUKAI;7182180008;Ne;0;7;1;8
2106;Gelvonėlis;ŽVIRBLIUKAI;8885088900;Ne;7;0;0;7
2107;Gelvonėlis;ŽVIRBLIUKAI;2400289466;Ne;0;0;11;11
2108;Gelvonėlis;ŽVIRBLIUKAI;9493536517;Ne;0;0;2;2
2109;Gelvonėlis;ŽVIRBLIUKAI;9059244134;Ne;0;0;1;1
2110;Gelvonėlis;ŽVIRBLIUKAI;1987204544;Ne;0;11;0;11
2111;Gelvonėlis;ŽVIRBLIUKAI;2288951845;Ne;0;0;1;1
2112;Gelvonėlis;ŽVIRBLIUKAI;2515471132;Ne;0;0;2;2
2113;Gelvonėlis;ŽVIRBLIUKAI;1085845218;Ne;9;0;0;9
2114;Gelvonėlis;ŽVIRBLIUKAI;6319058542;Ne;0;0;1;1
2115;Gelvonėlis;ŽVIRBLIUKAI;9538571448;Ne;0;8;0;8
2116;Gelvonėlis;ŽVIRBLIUKAI;9147186080;Ne;0;1;0;1
2117;Gelvonėlis;ŽVIRBLIUKAI;7620280474;Ne;0;0;2;2
2118;Gelvonėlis;ŽVIRBLIUKAI;7195164378;Ne;0;0;1;1
2119;Gelvonėlis;ŽVIRBLIUKAI;6598178467;Ne;0;1;4;5
2120;Gelvonėlis;ŽVIRBLIUKAI;6068473734;Ne;2;0;0;2
2121;Gelvonėlis;ŽVIRBLIUKAI;8508450500;Ne;0;7;0;7
2122;Gelvonėlis;ŽVIRBLIUKAI;8704971956;Ne;11;0;2;13
2123;Gelvonėlis;ŽVIRBLIUKAI;4281431471;Ne;0;0;7;7
2124;Gelvonėlis;ŽVIRBLIUKAI;8976258838;Ne;5;1;0;6
2125;Gelvonėlis;RASELĖS;9667024635;Ne;10;0;1;11
2126;Gelvonėlis;RASELĖS;9369121356;Ne;0;0;1;1
2127;Gelvonėlis;RASELĖS;2119550116;Ne;12;0;2;14
2128;Gelvonėlis;RASELĖS;5047022305;Ne;8;0;0;8
2129;Gelvonėlis;RASELĖS;6189110767;Ne;2;0;0;2
2130;Gelvonėlis;RASELĖS;7983982378;Ne;0;2;0;2
2131;Gelvonėlis;RASELĖS;2108690954;Ne;17;0;0;17
2132;Gelvonėlis;RASELĖS;1753617545;Ne;0;0;2;2
2133;Gelvonėlis;RASELĖS;7759317220;Ne;0;1;0;1
2134;Gelvonėlis;RASELĖS;1399518471;Ne;0;0;2;2
2135;Gelvonėlis;RASELĖS;5283207520;Ne;10;0;0;10
2136;Gelvonėlis;RASELĖS;3059903126;Ne;0;0;2;2
2137;Gelvonėlis;RASELĖS;6226970200;Ne;0;0;2;2
2138;Gelvonėlis;RASELĖS;1246591538;Ne;1;0;2;3
2139;Gelvonėlis;RASELĖS;6256962184;Ne;0;0;2;2
2140;Gelvonėlis;RASELĖS;1610362831;Ne;0;0;3;3
2141;Gelvonėlis;RASELĖS;9387523651;Ne;0;14;0;14
2142;Gelvonėlis;RASELĖS;75676389361;Ne;0;0;3;3
2143;Gelvonėlis;RASELĖS;4120103012;Ne;10;0;2;12
2144;Gelvonėlis;SAULUTĖ;7392743619;Ne;5;5;0;10
2145;Gelvonėlis;SAULUTĖ;8228796927;Ne;2;0;0;2
2146;Gelvonėlis;SAULUTĖ;1368982977;Ne;0;1;0;1
2147;Gelvonėlis;SAULUTĖ;4550077609;Ne;0;0;3;3
2148;Gelvonėlis;SAULUTĖ;1734685590;Ne;0;6;0;6
2149;Gelvonėlis;SAULUTĖ;7936622964;Ne;4;10;0;14
2150;Gelvonėlis;SAULUTĖ;3719670896;Ne;0;8;0;8
2151;Gelvonėlis;SAULUTĖ;1672409070;Ne;6;0;0;6
2152;Gelvonėlis;SAULUTĖ;3771796903;Ne;5;0;0;5
2153;Gelvonėlis;SAULUTĖ;8022270555;Ne;0;8;4;12
2154;Gelvonėlis;SAULUTĖ;4268590631;Ne;0;5;0;5
2155;Gelvonėlis;SAULUTĖ;5598186460;Ne;10;0;0;10
2156;Gelvonėlis;SAULUTĖ;9767254134;Ne;0;0;3;3
2157;Gelvonėlis;SAULUTĖ;2452711535;Ne;0;11;0;11
2158;Gelvonėlis;PELĖDŽIUKAI;3830940009;Ne;0;0;2;2
2159;Gelvonėlis;PELĖDŽIUKAI;2742000725;Ne;0;0;2;2
2160;Gelvonėlis;PELĖDŽIUKAI;3147489259;Ne;0;2;0;2
2161;Gelvonėlis;PELĖDŽIUKAI;1284359362;Ne;0;8;1;9
2162;Gelvonėlis;PELĖDŽIUKAI;4855800131;Ne;0;0;1;1
2163;Gelvonėlis;PELĖDŽIUKAI;8775661719;Ne;0;1;0;1
2164;Gelvonėlis;PELĖDŽIUKAI;3089755141;Ne;0;6;0;6
2165;Gelvonėlis;PELĖDŽIUKAI;1408313697;Ne;0;0;2;2
2166;Gelvonėlis;PELĖDŽIUKAI;3670612781;Ne;3;7;0;10
2167;Gelvonėlis;PELĖDŽIUKAI;69073786634;Ne;0;0;7;7
2168;Gelvonėlis;PELĖDŽIUKAI;29928181395;Ne;0;5;0;5
2169;Gelvonėlis;PELĖDŽIUKAI;6255253658;Ne;0;1;3;4
2170;Gelvonėlis;PELĖDŽIUKAI;9323579468;Ne;4;0;1;5
2171;Gelvonėlis;PELĖDŽIUKAI;7919814808;Ne;0;6;0;6
2172;Gelvonėlis;PELĖDŽIUKAI;1355742622;Ne;0;6;0;6
2173;Gelvonėlis;PELĖDŽIUKAI;5798439412;Ne;0;0;1;1
2174;Gelvonėlis;DRUGELIAI;2407650243;Ne;7;0;0;7
2175;Gelvonėlis;DRUGELIAI;2896360160;Ne;1;1;0;2
2176;Gelvonėlis;DRUGELIAI;9386056584;Ne;0;9;0;9
2177;Gelvonėlis;DRUGELIAI;2114734415;Ne;16;0;0;16
2178;Gelvonėlis;DRUGELIAI;5882430535;Ne;2;0;0;2
2179;Gelvonėlis;DRUGELIAI;2645337382;Ne;6;0;0;6
2180;Gelvonėlis;DRUGELIAI;3813000890;Ne;1;4;0;5
2181;Gelvonėlis;DRUGELIAI;6662081736;Ne;15;0;0;15
2182;Gelvonėlis;DRUGELIAI;5379820728;Ne;10;0;0;10
2183;Gelvonėlis;DRUGELIAI;4228323474;Ne;1;0;0;1
2184;Gelvonėlis;DRUGELIAI;4162701876;Ne;22;0;0;22
2185;Gelvonėlis;DRUGELIAI;2407650243;Ne;7;0;0;7
2186;Gelvonėlis;VARPELIAI;9149117970;Ne;0;2;0;2
2187;Gelvonėlis;VARPELIAI;2791652988;Ne;15;1;0;16
2188;Gelvonėlis;VARPELIAI;2638430817;Ne;0;1;11;12
2189;Gelvonėlis;VARPELIAI;9600526942;Ne;0;3;0;3
2190;Gelvonėlis;VARPELIAI;1387948936;Ne;0;10;0;10
2191;Gelvonėlis;VARPELIAI;9650922918;Ne;0;1;0;1
2192;Gelvonėlis;VARPELIAI;1462716950;Ne;0;3;0;3
2193;Gelvonėlis;VARPELIAI;6949090250;Ne;0;0;5;5
2194;Gelvonėlis;VARPELIAI;9622818893;Ne;2;0;1;3
2195;Gelvonėlis;VARPELIAI;6869418701;Ne;0;0;3;3
2196;Gelvonėlis;VARPELIAI;9963769327;Ne;0;1;0;1
2197;Gelvonėlis;VARPELIAI;3192542909;Ne;0;0;2;2
2198;Gelvonėlis;VARPELIAI;1802520150;Ne;0;0;1;1
2199;Gelvonėlis;BORUŽĖLĖS;8209225630;Ne;9;1;1;11
2200;Gelvonėlis;BORUŽĖLĖS;6554989142;Ne;0;1;1;2
2201;Gelvonėlis;BORUŽĖLĖS;8056058298;Ne;0;1;3;4
2202;Gelvonėlis;BORUŽĖLĖS;4112607183;Ne;0;2;0;2
2203;Gelvonėlis;BORUŽĖLĖS;6243360625;Ne;0;11;0;11
2204;Gelvonėlis;BORUŽĖLĖS;5790038422;Ne;0;0;2;2
2205;Gelvonėlis;BORUŽĖLĖS;8515746171;Ne;0;0;21;21
2206;Gelvonėlis;BORUŽĖLĖS;6647585785;Ne;7;0;1;8
2207;Gelvonėlis;BORUŽĖLĖS;1539850989;Ne;0;0;1;1
2208;Gelvonėlis;BORUŽĖLĖS;1107633909;Ne;0;3;0;3
2209;Gelvonėlis;BORUŽĖLĖS;8973272332;Ne;0;2;0;2
2210;Gelvonėlis;BORUŽĖLĖS;3846916445;Ne;0;3;0;3
2211;Gelvonėlis;BORUŽĖLĖS;4749071286;Ne;6;0;0;6
2212;Gelvonėlis;BORUŽĖLĖS;8806934077;Ne;0;0;13;13
2213;Gelvonėlis;BORUŽĖLĖS;3926733474;Ne;0;0;12;12
2214;Gelvonėlis;BORUŽĖLĖS;4620517551;Ne;0;0;3;3
2215;Gelvonėlis;BORUŽĖLĖS;6598688551;Ne;7;0;0;7
2216;Gelvonėlis;NYKŠTUKAI;8987012601;Ne;12;0;0;12
2217;Gelvonėlis;NYKŠTUKAI;7632523330;Ne;0;6;4;10
2218;Gelvonėlis;NYKŠTUKAI;1112841066;Ne;5;7;0;12
2219;Gelvonėlis;NYKŠTUKAI;2553846157;Ne;7;0;0;7
2220;Gelvonėlis;NYKŠTUKAI;8003522011;Ne;0;5;0;5
2221;Gelvonėlis;NYKŠTUKAI;5713586282;Ne;0;10;0;10
2222;Gelvonėlis;NYKŠTUKAI;3217646353;Ne;0;2;1;3
2223;Gelvonėlis;NYKŠTUKAI;8560940316;Ne;0;3;0;3
2224;Gelvonėlis;NYKŠTUKAI;8540204705;Ne;4;1;0;5
2225;Gelvonėlis;NYKŠTUKAI;8124516993;Ne;8;0;3;11
2226;Gelvonėlis;NYKŠTUKAI;4156493586;Ne;0;0;2;2
2227;Gelvonėlis;NYKŠTUKAI;5305480599;Ne;6;0;0;6
2228;Gelvonėlis;NYKŠTUKAI;5874473596;Ne;0;5;0;5
2229;Gelvonėlis;NYKŠTUKAI;9900244859;Ne;0;0;18;18
2230;Gelvonėlis;NYKŠTUKAI;9597033956;Ne;0;0;2;2
2231;Gelvonėlis;NYKŠTUKAI;4027647695;Ne;0;0;7;7
2232;Gelvonėlis;BITUTĖS;6534527571;Ne;0;5;0;5
2233;Gelvonėlis;BITUTĖS;1105838340;Ne;14;0;0;14
2234;Gelvonėlis;BITUTĖS;5444127599;Ne;2;4;0;6
2235;Gelvonėlis;BITUTĖS;1980703633;Ne;9;2;0;11
2236;Gelvonėlis;BITUTĖS;6330751030;Ne;2;0;0;2
2237;Gelvonėlis;BITUTĖS;6710189985;Ne;10;6;0;16
2238;Gelvonėlis;BITUTĖS;5281400074;Ne;5;0;6;11
2239;Gelvonėlis;BITUTĖS;3514762919;Ne;0;3;2;5
2240;Gelvonėlis;BITUTĖS;8792171281;Ne;0;3;0;3
2241;Gelvonėlis;BITUTĖS;1730718430;Ne;12;0;5;17
2242;Gelvonėlis;BITUTĖS;8480138654;Ne;0;2;0;2
2243;Gelvonėlis;BITUTĖS;7725313260;Ne;10;0;1;11
2244;Gelvonėlis;BITUTĖS;5816373550;Ne;3;0;0;3
2245;Gelvonėlis;BITUTĖS;4380468764;Ne;0;15;0;15
2246;Gelvonėlis;RAMUNĖLĖS;1104204810;Ne;7;0;0;7
2247;Gelvonėlis;RAMUNĖLĖS;1355774181;Ne;10;0;0;10
2248;Gelvonėlis;RAMUNĖLĖS;2774170680;Ne;0;0;9;9
2249;Gelvonėlis;RAMUNĖLĖS;3269417874;Ne;7;0;1;8
2250;Gelvonėlis;RAMUNĖLĖS;9403505858;Ne;5;4;0;9
2251;Gelvonėlis;RAMUNĖLĖS;7686930719;Ne;5;0;0;5
2252;Gelvonėlis;RAMUNĖLĖS;4450990418;Ne;22;0;0;22
2253;Gelvonėlis;RAMUNĖLĖS;7419947442;Ne;0;0;1;1
2254;Gelvonėlis;RAMUNĖLĖS;6883156109;Ne;7;5;0;12
2255;Gelvonėlis;RAMUNĖLĖS;1562829157;Ne;8;0;0;8
2256;Gelvonėlis;RAMUNĖLĖS;4211228746;Ne;9;1;0;10
2257;Gelvonėlis;RAMUNĖLĖS;6365451610;Ne;7;0;0;7
2258;Gelvonėlis;RAMUNĖLĖS;1661034338;Ne;22;0;0;22
2259;Gelvonėlis;RAMUNĖLĖS;2821485779;Ne;16;0;0;16
2260;Gelvonėlis;RAMUNĖLĖS;6518583809;Ne;0;0;16;16
2261;Gelvonėlis;RAMUNĖLĖS;2818319130;Ne;1;0;0;1
2262;Gelvonėlis;RIEŠUTĖLIAI;3368423382;Ne;5;3;0;8
2263;Gelvonėlis;RIEŠUTĖLIAI;3973248307;Ne;0;12;0;12
2264;Gelvonėlis;RIEŠUTĖLIAI;5461812139;Ne;0;18;0;18
2265;Gelvonėlis;RIEŠUTĖLIAI;5986018609;Ne;0;1;9;10
2266;Gelvonėlis;RIEŠUTĖLIAI;8532801167;Ne;0;0;4;4
2267;Gelvonėlis;RIEŠUTĖLIAI;4208103106;Ne;0;1;10;11
2268;Gelvonėlis;RIEŠUTĖLIAI;8766702456;Ne;0;0;2;2
2269;Gelvonėlis;RIEŠUTĖLIAI;6305084811;Ne;10;0;0;10
2270;Gelvonėlis;RIEŠUTĖLIAI;2005647155;Ne;0;1;0;1
2271;Gelvonėlis;RIEŠUTĖLIAI;1266479895;Ne;7;0;0;7
2272;Gelvonėlis;RIEŠUTĖLIAI;5934077931;Ne;17;0;0;17
2273;Gelvonėlis;RIEŠUTĖLIAI;4280463938;Ne;9;0;1;10
2274;Gelvonėlis;RIEŠUTĖLIAI;6471921512;Ne;0;1;0;1
2275;Gelvonėlis;RIEŠUTĖLIAI;4832167372;Ne;22;0;0;22
2276;Gelvonėlis;RIEŠUTĖLIAI;9301814935;Ne;5;6;0;11
2277;Gelvonėlis;RIEŠUTĖLIAI;1466616814;Ne;0;0;3;3
2278;Gelvonėlis;RIEŠUTĖLIAI;2015807805;Ne;12;2;1;15
2279;Gelvonėlis;RIEŠUTĖLIAI;9323228591;Ne;0;0;2;2
2280;Gelvonėlis;RIEŠUTĖLIAI;2360728722;Ne;19;0;1;20
2281;Gelvonėlis;RIEŠUTĖLIAI;9132529216;Ne;4;15;0;19
2282;"Gervelė (Dzūkų g. 32)";ŽIRNIUKAI;2523056808;Taip;0;8;2;10
2283;"Gervelė (Dzūkų g. 32)";ŽIRNIUKAI;8533480337;Ne;0;1;0;1
2284;"Gervelė (Dzūkų g. 32)";ŽIRNIUKAI;6227091658;Ne;0;1;0;1
2285;"Gervelė (Dzūkų g. 32)";ŽIRNIUKAI;8439479958;Ne;0;5;0;5
2286;"Gervelė (Dzūkų g. 32)";ŽIRNIUKAI;6844406500;Ne;0;6;0;6
2287;"Gervelė (Dzūkų g. 32)";ŽIRNIUKAI;2359854614;Ne;0;8;0;8
2288;"Gervelė (Dzūkų g. 32)";ŽIRNIUKAI;8811086908;Ne;0;10;0;10
2289;"Gervelė (Dzūkų g. 32)";ŽIRNIUKAI;1573560581;Ne;0;0;2;2
2290;"Gervelė (Dzūkų g. 32)";ŽIRNIUKAI;9133101055;Ne;18;0;0;18
2291;"Gervelė (Dzūkų g. 32)";ŽIRNIUKAI;7192663882;Ne;2;0;0;2
2292;"Gervelė (Dzūkų g. 32)";ŽIRNIUKAI;1783612448;Ne;0;0;12;12
2293;"Gervelė (Dzūkų g. 32)";ŽIRNIUKAI;6650473677;Ne;2;5;0;7
2294;"Gervelė (Dzūkų g. 32)";ŽIRNIUKAI;2563081304;Ne;0;1;0;1
2295;"Gervelė (Dzūkų g. 32)";ŽIRNIUKAI;1101877666;Ne;17;0;1;18
2296;"Gervelė (Dzūkų g. 32)";ŽIRNIUKAI;2046282471;Ne;22;0;0;22
2297;"Gervelė (Dzūkų g. 32)";ŽIRNIUKAI;1024397071;Ne;0;0;3;3
2298;"Gervelė (Dzūkų g. 32)";ŽIRNIUKAI;7040713170;Ne;0;1;0;1
2299;"Gervelė (Dzūkų g. 32)";ŽIRNIUKAI;4075328330;Ne;0;0;22;22
2300;"Gervelė (Dzūkų g. 32)";LAŠIUKAI;3702908570;Ne;5;8;0;13
2301;"Gervelė (Dzūkų g. 32)";LAŠIUKAI;3647044817;Ne;5;0;2;7
2302;"Gervelė (Dzūkų g. 32)";LAŠIUKAI;6431701403;Ne;7;0;2;9
2303;"Gervelė (Dzūkų g. 32)";LAŠIUKAI;2413995770;Ne;7;1;2;10
2304;"Gervelė (Dzūkų g. 32)";LAŠIUKAI;1637204236;Ne;5;0;0;5
2305;"Gervelė (Dzūkų g. 32)";LAŠIUKAI;7924884022;Ne;0;11;0;11
2306;"Gervelė (Dzūkų g. 32)";LAŠIUKAI;1323074335;Ne;6;0;4;10
2307;"Gervelė (Dzūkų g. 32)";LAŠIUKAI;6058944385;Ne;3;2;0;5
2308;"Gervelė (Dzūkų g. 32)";LAŠIUKAI;2446758975;Taip;4;7;0;11
2309;"Gervelė (Dzūkų g. 32)";LAŠIUKAI;1353920541;Ne;3;2;0;5
2310;"Gervelė (Dzūkų g. 32)";LAŠIUKAI;5799823801;Ne;7;0;0;7
2311;"Gervelė (Dzūkų g. 32)";LAŠIUKAI;4899690598;Ne;7;0;1;8
2312;"Gervelė (Dzūkų g. 32)";LAŠIUKAI;6895415337;Ne;0;0;1;1
2313;"Gervelė (Dzūkų g. 32)";PABIRUČIAI;7317091881;Ne;6;0;1;7
2314;"Gervelė (Dzūkų g. 32)";PABIRUČIAI;6951455424;Ne;6;0;4;10
2315;"Gervelė (Dzūkų g. 32)";PABIRUČIAI;1112844296;Ne;0;0;2;2
2316;"Gervelė (Dzūkų g. 32)";PABIRUČIAI;6287806975;Taip;14;2;0;16
2317;"Gervelė (Dzūkų g. 32)";PABIRUČIAI;6228025635;Ne;0;0;2;2
2318;"Gervelė (Dzūkų g. 32)";PABIRUČIAI;9977349707;Ne;8;5;0;13
2319;"Gervelė (Dzūkų g. 32)";PABIRUČIAI;4295743997;Ne;3;5;0;8
2320;"Gervelė (Dzūkų g. 32)";PABIRUČIAI;7935059565;Ne;0;0;2;2
2321;"Gervelė (Dzūkų g. 32)";PABIRUČIAI;5267617723;Ne;9;2;0;11
2322;"Gervelė (Dzūkų g. 32)";PABIRUČIAI;5953552777;Ne;5;5;0;10
2323;"Gervelė (Dzūkų g. 32)";PABIRUČIAI;4038179503;Ne;8;0;3;11
2324;"Gervelė (Dzūkų g. 32)";PABIRUČIAI;1160084928;Ne;0;0;6;6
2325;"Gervelė (Dzūkų g. 32)";PABIRUČIAI;5685222621;Ne;3;0;0;3
2326;"Gervelė (Dzūkų g. 32)";PABIRUČIAI;4294916559;Ne;0;7;0;7
2327;"Gervelė (Dzūkų g. 32)";BITUTĖS;6090290046;Ne;0;4;0;4
2328;"Gervelė (Dzūkų g. 32)";BITUTĖS;75080308291;Ne;0;1;0;1
2329;"Gervelė (Dzūkų g. 32)";BITUTĖS;6737174004;Ne;0;6;0;6
2330;"Gervelė (Dzūkų g. 32)";BITUTĖS;1616949023;Ne;12;0;0;12
2331;"Gervelė (Dzūkų g. 32)";BITUTĖS;3427400844;Ne;0;0;7;7
2332;"Gervelė (Dzūkų g. 32)";BITUTĖS;8152446576;Ne;2;0;0;2
2333;"Gervelė (Dzūkų g. 32)";BITUTĖS;7302238728;Ne;3;2;0;5
2334;"Gervelė (Dzūkų g. 32)";BITUTĖS;1400044294;Ne;0;0;6;6
2335;"Gervelė (Dzūkų g. 32)";BITUTĖS;8062089041;Ne;4;7;0;11
2336;"Gervelė (Dzūkų g. 32)";BITUTĖS;7697761552;Ne;0;0;4;4
2337;"Gervelė (Dzūkų g. 32)";BITUTĖS;5989713844;Ne;0;1;0;1
2338;"Gervelė (Dzūkų g. 32)";BITUTĖS;4560752068;Ne;0;13;0;13
2339;"Gervelė (Dzūkų g. 32)";BITUTĖS;89076506192;Ne;7;0;2;9
2340;"Gervelė (Dzūkų g. 32)";BITUTĖS;87619285504;Ne;0;0;3;3
2341;"Gervelė (Dzūkų g. 32)";BITUTĖS;1991238577;Ne;0;0;9;9
2342;"Gervelė (Dzūkų g. 32)";BITUTĖS;2167744244;Ne;0;8;0;8
2343;"Gervelė (Dzūkų g. 32)";BITUTĖS;3525060645;Ne;0;0;7;7
2344;"Gervelė (Dzūkų g. 32)";BITUTĖS;7162551366;Ne;0;22;0;22
2345;"Gervelė (Dzūkų g. 32)";BURATINO;3946391650;Ne;0;7;0;7
2346;"Gervelė (Dzūkų g. 32)";BURATINO;7620764911;Ne;0;6;0;6
2347;"Gervelė (Dzūkų g. 32)";BURATINO;9239897472;Ne;2;3;0;5
2348;"Gervelė (Dzūkų g. 32)";BURATINO;3359793310;Ne;0;0;7;7
2349;"Gervelė (Dzūkų g. 32)";BURATINO;9982951468;Ne;20;0;1;21
2350;"Gervelė (Dzūkų g. 32)";BURATINO;5900623823;Ne;5;7;0;12
2351;"Gervelė (Dzūkų g. 32)";BURATINO;4775822341;Ne;0;6;0;6
2352;"Gervelė (Dzūkų g. 32)";BURATINO;2541771432;Ne;0;8;0;8
2353;"Gervelė (Dzūkų g. 32)";BURATINO;2913622440;Ne;0;0;3;3
2354;"Gervelė (Dzūkų g. 32)";BURATINO;4434618210;Ne;0;0;3;3
2355;"Gervelė (Dzūkų g. 32)";BURATINO;1108744283;Ne;0;9;0;9
2356;"Gervelė (Dzūkų g. 32)";BURATINO;6166476760;Ne;0;0;1;1
2357;"Gervelė (Dzūkų g. 32)";BURATINO;4516538272;Ne;0;0;5;5
2358;"Gervelė (Dzūkų g. 32)";BURATINO;9256422807;Ne;2;0;1;3
2359;"Gervelė (Dzūkų g. 32)";BURATINO;9997346812;Ne;6;0;3;9
2360;"Gervelė (Dzūkų g. 32)";BURATINO;8472436632;Ne;0;0;3;3
2361;"Gervelė (Dzūkų g. 32)";VIŠČIUKŲ;1020706652;Ne;5;0;0;5
2362;"Gervelė (Dzūkų g. 32)";VIŠČIUKŲ;9532470407;Ne;1;0;0;1
2363;"Gervelė (Dzūkų g. 32)";VIŠČIUKŲ;7205673717;Ne;0;0;5;5
2364;"Gervelė (Dzūkų g. 32)";VIŠČIUKŲ;7140356352;Ne;0;0;1;1
2365;"Gervelė (Dzūkų g. 32)";VIŠČIUKŲ;8598429197;Ne;0;0;7;7
2366;"Gervelė (Dzūkų g. 32)";VIŠČIUKŲ;9294388176;Ne;8;0;0;8
2367;"Gervelė (Dzūkų g. 32)";VIŠČIUKŲ;8392147716;Ne;2;0;7;9
2368;"Gervelė (Dzūkų g. 32)";VIŠČIUKŲ;5608916470;Ne;0;0;5;5
2369;"Gervelė (Dzūkų g. 32)";VIŠČIUKŲ;8098158634;Taip;3;0;0;3
2370;"Gervelė (Dzūkų g. 32)";VIŠČIUKŲ;9478720027;Ne;10;12;0;22
2371;"Gervelė (Dzūkų g. 32)";VIŠČIUKŲ;4552290778;Ne;0;5;0;5
2372;"Gervelė (Dzūkų g. 32)";VIŠČIUKŲ;3170062234;Ne;0;0;2;2
2373;"Gervelė (Dzūkų g. 32)";VIŠČIUKŲ;1226130732;Taip;0;0;5;5
2374;"Gilužis (Vydūno g. 11A)";Skruzdėliukų;35511006307;Ne;0;2;1;3
2375;"Gilužis (Vydūno g. 11A)";Skruzdėliukų;1615293331;Ne;0;2;0;2
2376;"Gilužis (Vydūno g. 11A)";Skruzdėliukų;9474400084;Ne;0;1;0;1
2377;"Gilužis (Vydūno g. 11A)";Skruzdėliukų;70959404439;Ne;3;2;0;5
2378;"Gilužis (Vydūno g. 11A)";Skruzdėliukų;4611735601;Ne;5;2;0;7
2379;"Gilužis (Vydūno g. 11A)";Skruzdėliukų;5920357223;Ne;0;4;0;4
2380;"Gilužis (Vydūno g. 11A)";Skruzdėliukų;8595541498;Ne;2;6;0;8
2381;"Gilužis (Vydūno g. 11A)";Skruzdėliukų;5365582271;Ne;5;2;0;7
2382;"Gilužis (Vydūno g. 11A)";Skruzdėliukų;7364297673;Ne;3;0;0;3
2383;"Gilužis (Vydūno g. 11A)";Skruzdėliukų;3216004438;Ne;0;1;1;2
2384;"Gilužis (Vydūno g. 11A)";Skruzdėliukų;48365991937;Ne;0;2;0;2
2385;"Gilužis (Vydūno g. 11A)";Skruzdėliukų;29586826889;Ne;0;12;0;12
2386;"Gilužis (Vydūno g. 11A)";Skruzdėliukų;3071312399;Ne;1;5;0;6
2387;"Gilužis (Vydūno g. 11A)";Nykštukų;4147821853;Ne;0;2;0;2
2388;"Gilužis (Vydūno g. 11A)";Nykštukų;7937643339;Ne;0;1;0;1
2389;"Gilužis (Vydūno g. 11A)";Nykštukų;3473889426;Ne;5;0;0;5
2390;"Gilužis (Vydūno g. 11A)";Nykštukų;9362581908;Ne;5;0;0;5
2391;"Gilužis (Vydūno g. 11A)";Nykštukų;8899557365;Ne;10;0;0;10
2392;"Gilužis (Vydūno g. 11A)";Nykštukų;2661894041;Ne;8;1;0;9
2393;"Gilužis (Vydūno g. 11A)";Nykštukų;7228498662;Ne;0;6;0;6
2394;"Gilužis (Vydūno g. 11A)";Nykštukų;3335512812;Ne;0;3;0;3
2395;"Gilužis (Vydūno g. 11A)";Nykštukų;1459273692;Ne;2;1;0;3
2396;"Gilužis (Vydūno g. 11A)";Nykštukų;4156613717;Ne;0;1;0;1
2397;"Gilužis (Vydūno g. 11A)";Nykštukų;4956685016;Ne;1;2;0;3
2398;"Gilužis (Vydūno g. 11A)";Nykštukų;6315155554;Ne;8;0;0;8
2399;"Gilužis (Vydūno g. 11A)";Nykštukų;4541291716;Ne;4;0;0;4
2400;"Gilužis (Vydūno g. 11A)";Nykštukų;8522552650;Ne;0;15;0;15
2401;"Gilužis (Vydūno g. 11A)";Nykštukų;3176305306;Ne;4;0;0;4
2402;"Gilužis (Vydūno g. 11A)";Nykštukų;4094486541;Ne;9;0;0;9
2403;"Gilužis (Vydūno g. 11A)";Nykštukų;6493142538;Ne;0;4;1;5
2404;"Gilužis (Vydūno g. 11A)";Nykštukų;5088561405;Ne;0;4;0;4
2405;"Gilužis (Vydūno g. 11A)";Bitučių;4841014668;Ne;4;1;0;5
2406;"Gilužis (Vydūno g. 11A)";Bitučių;3399162399;Ne;1;1;0;2
2407;"Gilužis (Vydūno g. 11A)";Bitučių;5973671038;Ne;9;1;0;10
2408;"Gilužis (Vydūno g. 11A)";Bitučių;1634295583;Ne;5;0;0;5
2409;"Gilužis (Vydūno g. 11A)";Bitučių;4360261750;Ne;0;1;4;5
2410;"Gilužis (Vydūno g. 11A)";Bitučių;5728341732;Ne;0;3;0;3
2411;"Gilužis (Vydūno g. 11A)";Bitučių;2780710383;Ne;4;0;0;4
2412;"Gilužis (Vydūno g. 11A)";Bitučių;6931726275;Ne;0;10;0;10
2413;"Gilužis (Vydūno g. 11A)";Bitučių;1867185320;Ne;6;0;0;6
2414;"Gilužis (Vydūno g. 11A)";Bitučių;3429435736;Ne;0;1;0;1
2415;"Gilužis (Vydūno g. 11A)";Bitučių;8539946703;Taip;0;22;0;22
2416;"Gilužis (Vydūno g. 11A)";Bitučių;9000351000;Ne;5;1;0;6
2417;"Gilužis (Vydūno g. 11A)";Bitučių;5366174839;Ne;0;1;0;1
2418;"Gilužis (Vydūno g. 11A)";Bitučių;5162397237;Ne;11;8;0;19
2419;"Gilužis (Vydūno g. 11A)";Bitučių;7250617867;Ne;6;0;0;6
2420;"Gilužis (Vydūno g. 11A)";Bitučių;9053608903;Ne;10;6;0;16
2421;"Gilužis (Vydūno g. 11A)";Bitučių;6115776872;Ne;4;0;1;5
2422;"Gilužis (Vydūno g. 11A)";Bitučių;5651799121;Ne;0;0;7;7
2423;"Gilužis (Vydūno g. 11A)";Bitučių;1334619137;Ne;0;2;0;2
2424;"Gilužis (Vydūno g. 11A)";Bitučių;2950813185;Ne;13;0;0;13
2425;"Gilužis (Vydūno g. 11A)";Bitučių;6515525848;Ne;0;1;0;1
2426;"Gilužis (Vydūno g. 11A)";Bitučių;2345403784;Ne;5;7;0;12
2427;"Gilužis (Vydūno g. 11A)";Kačiukų;4978922821;Ne;7;3;0;10
2428;"Gilužis (Vydūno g. 11A)";Kačiukų;2945406185;Ne;5;3;0;8
2429;"Gilužis (Vydūno g. 11A)";Kačiukų;1582241363;Ne;7;0;0;7
2430;"Gilužis (Vydūno g. 11A)";Kačiukų;7330938312;Ne;18;0;0;18
2431;"Gilužis (Vydūno g. 11A)";Kačiukų;6571132974;Ne;0;22;0;22
2432;"Gilužis (Vydūno g. 11A)";Kačiukų;7001112696;Ne;0;0;2;2
2433;"Gilužis (Vydūno g. 11A)";Kačiukų;9034842169;Ne;0;4;0;4
2434;"Gilužis (Vydūno g. 11A)";Kačiukų;6966795180;Ne;0;0;3;3
2435;"Gilužis (Vydūno g. 11A)";Kačiukų;5128383851;Ne;5;0;7;12
2436;"Gilužis (Vydūno g. 11A)";Kačiukų;8318405114;Ne;3;0;1;4
2437;"Gilužis (Vydūno g. 11A)";Kačiukų;7826015897;Ne;0;13;0;13
2438;"Gilužis (Vydūno g. 11A)";Kačiukų;9186274541;Ne;0;0;1;1
2439;"Gilužis (Vydūno g. 11A)";Kačiukų;1862524255;Ne;3;0;0;3
2440;"Gilužis (Vydūno g. 11A)";Kačiukų;9421351780;Ne;9;0;0;9
2441;"Gilužis (Vydūno g. 11A)";Kačiukų;6404411477;Ne;0;5;0;5
2442;"Gilužis (Vydūno g. 11A)";Kačiukų;4128387076;Ne;0;0;10;10
2443;"Gilužis (Vydūno g. 11A)";Kačiukų;9097165155;Ne;10;0;0;10
2444;"Gilužis (Vydūno g. 11A)";Kačiukų;8762534617;Ne;0;8;0;8
2445;"Gilužis (Vydūno g. 11A)";Pelėdžiukų;5217748032;Ne;0;8;0;8
2446;"Gilužis (Vydūno g. 11A)";Pelėdžiukų;5989314494;Ne;0;2;0;2
2447;"Gilužis (Vydūno g. 11A)";Pelėdžiukų;7998695149;Ne;3;0;0;3
2448;"Gilužis (Vydūno g. 11A)";Pelėdžiukų;7742783427;Ne;4;0;0;4
2449;"Gilužis (Vydūno g. 11A)";Pelėdžiukų;7358572344;Ne;7;2;0;9
2450;"Gilužis (Vydūno g. 11A)";Pelėdžiukų;4617259961;Ne;0;2;1;3
2451;"Gilužis (Vydūno g. 11A)";Pelėdžiukų;1222370750;Ne;0;9;0;9
2452;"Gilužis (Vydūno g. 11A)";Pelėdžiukų;9503516686;Ne;5;1;0;6
2453;"Gilužis (Vydūno g. 11A)";Pelėdžiukų;4051726208;Ne;0;1;0;1
2454;"Gilužis (Vydūno g. 11A)";Pelėdžiukų;4435227217;Ne;4;7;0;11
2455;"Gilužis (Vydūno g. 11A)";Pelėdžiukų;2434419240;Ne;0;1;0;1
2456;"Gilužis (Vydūno g. 11A)";Pelėdžiukų;1832039250;Ne;22;0;0;22
2457;"Gilužis (Vydūno g. 11A)";Pelėdžiukų;3166161973;Ne;8;1;0;9
2458;"Gilužis (Vydūno g. 11A)";Pelėdžiukų;5070988982;Ne;0;5;0;5
2459;"Gilužis (Vydūno g. 11A)";Pelėdžiukų;7899274495;Ne;0;0;3;3
2460;"Gilužis (Vydūno g. 11A)";Pelėdžiukų;6093514885;Ne;2;0;0;2
2461;"Gilužis (Vydūno g. 11A)";Pelėdžiukų;2869506388;Ne;0;2;0;2
2462;"Gilužis (Vydūno g. 11A)";Drugelių;6121625070;Ne;7;0;1;8
2463;"Gilužis (Vydūno g. 11A)";Drugelių;1770064694;Ne;0;2;0;2
2464;"Gilužis (Vydūno g. 11A)";Drugelių;9591229878;Ne;0;0;1;1
2465;"Gilužis (Vydūno g. 11A)";Drugelių;9092013248;Ne;5;10;0;15
2466;"Gilužis (Vydūno g. 11A)";Drugelių;9109883577;Ne;5;1;0;6
2467;"Gilužis (Vydūno g. 11A)";Drugelių;8006465211;Ne;0;1;0;1
2468;"Gilužis (Vydūno g. 11A)";Drugelių;5118401707;Ne;8;0;0;8
2469;"Gilužis (Vydūno g. 11A)";Drugelių;3190597262;Ne;0;0;1;1
2470;"Gilužis (Vydūno g. 11A)";Drugelių;2988856911;Ne;0;1;0;1
2471;"Gilužis (Vydūno g. 11A)";Drugelių;3532863024;Ne;0;22;0;22
2472;"Gilužis (Vydūno g. 11A)";Drugelių;1376645277;Ne;0;5;0;5
2473;"Gilužis (Vydūno g. 11A)";Drugelių;1410870589;Ne;0;7;0;7
2474;"Gilužis (Vydūno g. 11A)";Drugelių;9112993465;Ne;2;0;1;3
2475;"Gilužis (Vydūno g. 11A)";Drugelių;4909329417;Ne;4;0;0;4
2476;"Gilužis (Vydūno g. 11A)";Drugelių;8244385001;Ne;7;1;0;8
2477;"Gilužis (Vydūno g. 11A)";Drugelių;6429142049;Ne;0;0;1;1
2478;"Gilužis (Vydūno g. 11A)";Drugelių;7731169885;Ne;5;0;0;5
2479;"Gilužis (Vydūno g. 11A)";Drugelių;1093643746;Ne;0;3;0;3
2480;"Gilužis (Vydūno g. 11A)";Drugelių;3902713866;Ne;6;0;0;6
2481;"Gilužis (Vydūno g. 11A)";Drugelių;6950139609;Ne;8;0;5;13
2482;"Gilužis (Vydūno g. 11A)";Drugelių;2397231165;Ne;0;8;1;9
2483;"Gilužis (Vydūno g. 11A)";Saulučių;17896774143;Ne;3;0;9;12
2484;"Gilužis (Vydūno g. 11A)";Saulučių;8595551150;Ne;0;1;0;1
2485;"Gilužis (Vydūno g. 11A)";Saulučių;4575619425;Ne;0;2;1;3
2486;"Gilužis (Vydūno g. 11A)";Saulučių;4473810097;Ne;0;2;0;2
2487;"Gilužis (Vydūno g. 11A)";Saulučių;1649256496;Ne;0;4;0;4
2488;"Gilužis (Vydūno g. 11A)";Saulučių;96550272401;Ne;4;0;0;4
2489;"Gilužis (Vydūno g. 11A)";Saulučių;69504888193;Ne;11;0;0;11
2490;"Gilužis (Vydūno g. 11A)";Saulučių;18997894859;Ne;0;0;3;3
2491;"Gilužis (Vydūno g. 11A)";Saulučių;7744997250;Ne;7;0;2;9
2492;"Gilužis (Vydūno g. 11A)";Saulučių;32730847948;Ne;0;0;1;1
2493;"Gilužis (Vydūno g. 11A)";Saulučių;5905237803;Ne;0;0;3;3
2494;"Gilužis (Vydūno g. 11A)";Saulučių;2872439079;Ne;0;0;2;2
2495;"Gilužis (Vydūno g. 11A)";Saulučių;87425898496;Ne;0;0;1;1
2496;"Gilužis (Vydūno g. 11A)";Saulučių;9367673896;Ne;0;0;1;1
2497;"Gilužis (Vydūno g. 11A)";Saulučių;1453976300;Ne;0;3;0;3
2498;"Gilužis (Vydūno g. 11A)";Saulučių;1211233315;Ne;0;0;2;2
2499;"Gilužis (Vydūno g. 11A)";Saulučių;5621912516;Ne;0;1;0;1
2500;"Gilužis (Vydūno g. 11A)";Paukštelių;46597815116;Ne;0;6;0;6
2501;"Gilužis (Vydūno g. 11A)";Paukštelių;1146713023;Ne;0;3;0;3
2502;"Gilužis (Vydūno g. 11A)";Paukštelių;1980250599;Ne;4;0;0;4
2503;"Gilužis (Vydūno g. 11A)";Paukštelių;1962914764;Ne;0;0;12;12
2504;"Gilužis (Vydūno g. 11A)";Paukštelių;7636249706;Ne;0;0;2;2
2505;"Gilužis (Vydūno g. 11A)";Paukštelių;2508958685;Ne;0;1;6;7
2506;"Gilužis (Vydūno g. 11A)";Paukštelių;72738770293;Ne;0;4;1;5
2507;"Gilužis (Vydūno g. 11A)";Paukštelių;8875479631;Ne;0;7;0;7
2508;"Gilužis (Vydūno g. 11A)";Paukštelių;5759145600;Ne;0;22;0;22
2509;"Gilužis (Vydūno g. 11A)";Paukštelių;8662424856;Ne;0;1;5;6
2510;"Gilužis (Vydūno g. 11A)";Paukštelių;2436416327;Ne;0;0;4;4
2511;"Gilužis (Vydūno g. 11A)";Paukštelių;6218943275;Ne;0;1;0;1
2512;"Gilužis (Vydūno g. 11A)";Paukštelių;2754594238;Ne;0;2;0;2
2513;"Gilužis (Vydūno g. 11A)";Paukštelių;8110869130;Ne;2;0;0;2
2514;"Gilužis (Vydūno g. 11A)";Paukštelių;4297300799;Ne;4;2;0;6
2515;"Gilužis (Vydūno g. 11A)";Paukštelių;8531121002;Ne;7;4;0;11
2516;"Gilužis (Vydūno g. 11A)";Paukštelių;9314893329;Ne;2;0;0;2
2517;"Gilužis (Vydūno g. 11A)";Paukštelių;46276990963;Ne;0;2;2;4
2518;"Gilužis (Vydūno g. 11A)";Paukštelių;5303511810;Ne;6;5;5;16
2519;"Gilužis (Vydūno g. 11A)";Obuoliukų;8201769917;Ne;0;8;0;8
2520;"Gilužis (Vydūno g. 11A)";Obuoliukų;9892608223;Ne;0;12;0;12
2521;"Gilužis (Vydūno g. 11A)";Obuoliukų;4058698645;Ne;0;1;0;1
2522;"Gilužis (Vydūno g. 11A)";Obuoliukų;1540018160;Ne;10;0;0;10
2523;"Gilužis (Vydūno g. 11A)";Obuoliukų;7716908903;Ne;2;1;0;3
2524;"Gilužis (Vydūno g. 11A)";Obuoliukų;3131597174;Ne;11;7;0;18
2525;"Gilužis (Vydūno g. 11A)";Obuoliukų;6239369861;Ne;10;0;2;12
2526;"Gilužis (Vydūno g. 11A)";Obuoliukų;6172360933;Ne;10;1;0;11
2527;"Gilužis (Vydūno g. 11A)";Obuoliukų;7398446674;Ne;10;0;0;10
2528;"Gilužis (Vydūno g. 11A)";Obuoliukų;4592380105;Ne;6;13;0;19
2529;"Gilužis (Vydūno g. 11A)";Obuoliukų;4242362889;Ne;0;2;0;2
2530;"Gilužis (Vydūno g. 11A)";Obuoliukų;7560732216;Ne;0;2;0;2
2531;"Gilužis (Vydūno g. 11A)";Obuoliukų;5476140202;Ne;3;2;0;5
2532;"Gilužis (Vydūno g. 11A)";Obuoliukų;7606394325;Ne;8;2;0;10
2533;"Gilužis (Vydūno g. 11A)";Obuoliukų;6737884137;Ne;0;9;0;9
2534;"Gilužis (Vydūno g. 11A)";Obuoliukų;6825745985;Ne;0;7;0;7
2535;"Gilužis (Vydūno g. 11A)";Obuoliukų;3458957423;Ne;13;2;0;15
2536;"Gilužis (Vydūno g. 11A)";Obuoliukų;8900414658;Ne;4;2;0;6
2537;"Gilužis (Vydūno g. 11A)";Obuoliukų;3219101391;Ne;10;2;0;12
2538;"Gilužis (Vydūno g. 11A)";Obuoliukų;4528131001;Ne;4;8;0;12
2539;"Gilužis (Vydūno g. 11A)";Obuoliukų;5895659747;Ne;15;6;0;21
2540;"Gilužis (Vydūno g. 11A)";KIŠKUČIŲ;5744027226;Ne;3;0;0;3
2541;"Gilužis (Vydūno g. 11A)";KIŠKUČIŲ;8639633038;Ne;2;0;0;2
2542;"Gilužis (Vydūno g. 11A)";KIŠKUČIŲ;5721924532;Ne;4;0;0;4
2543;"Gilužis (Vydūno g. 11A)";KIŠKUČIŲ;9484221435;Ne;2;7;0;9
2544;"Gilužis (Vydūno g. 11A)";KIŠKUČIŲ;2680643896;Ne;0;9;0;9
2545;"Gilužis (Vydūno g. 11A)";KIŠKUČIŲ;5685074731;Ne;5;0;0;5
2546;"Gilužis (Vydūno g. 11A)";KIŠKUČIŲ;3649616461;Ne;2;1;0;3
2547;"Gilužis (Vydūno g. 11A)";KIŠKUČIŲ;7632771776;Ne;4;0;3;7
2548;"Gilužis (Vydūno g. 11A)";KIŠKUČIŲ;7477282548;Ne;12;0;0;12
2549;"Gilužis (Vydūno g. 11A)";KIŠKUČIŲ;9061835019;Ne;13;0;0;13
2550;"Gilužis (Vydūno g. 11A)";KIŠKUČIŲ;7560574633;Ne;9;0;0;9
2551;"Gilužis (Vydūno g. 11A)";KIŠKUČIŲ;4199633620;Ne;12;0;1;13
2552;"Gilužis (Vydūno g. 11A)";KIŠKUČIŲ;9851612698;Ne;9;0;0;9
2553;"Gilužis (Vydūno g. 11A)";KIŠKUČIŲ;1391410955;Ne;0;22;0;22
2554;"Gilužis (Vydūno g. 11A)";KIŠKUČIŲ;6383469680;Ne;13;5;0;18
2555;"Gilužis (Vydūno g. 11A)";KIŠKUČIŲ;8341597766;Ne;0;7;0;7
2556;"Gilužis (Vydūno g. 11A)";KIŠKUČIŲ;3171560628;Ne;0;2;0;2
2557;"Gilužis (Vydūno g. 11A)";KIŠKUČIŲ;4347319425;Ne;7;0;0;7
2558;"Gilužis (Vydūno g. 11A)";KIŠKUČIŲ;8591741716;Ne;0;0;3;3
2559;"Gilužis (Vydūno g. 11A)";KIŠKUČIŲ;8877445672;Ne;17;0;0;17
2560;"Gilužis (Vydūno g. 11A)";KIŠKUČIŲ;9489594782;Ne;0;0;1;1
2561;"Gilužis (Vydūno g. 11A)";Meškučių;7263432152;Ne;12;1;0;13
2562;"Gilužis (Vydūno g. 11A)";Meškučių;4655266106;Ne;6;1;0;7
2563;"Gilužis (Vydūno g. 11A)";Meškučių;3800593189;Ne;6;8;0;14
2564;"Gilužis (Vydūno g. 11A)";Meškučių;4174307847;Ne;7;0;0;7
2565;"Gilužis (Vydūno g. 11A)";Meškučių;8393554697;Ne;11;1;0;12
2566;"Gilužis (Vydūno g. 11A)";Meškučių;8301535013;Ne;7;0;0;7
2567;"Gilužis (Vydūno g. 11A)";Meškučių;2939982311;Ne;13;6;0;19
2568;"Gilužis (Vydūno g. 11A)";Meškučių;3365778697;Ne;7;3;0;10
2569;"Gilužis (Vydūno g. 11A)";Meškučių;7912093880;Taip;18;0;0;18
2570;"Gilužis (Vydūno g. 11A)";Meškučių;2389277783;Ne;5;0;0;5
2571;"Gilužis (Vydūno g. 11A)";Meškučių;2500949029;Ne;8;5;0;13
2572;"Gilužis (Vydūno g. 11A)";Meškučių;4741129495;Ne;11;1;0;12
2573;"Gilužis (Vydūno g. 11A)";Meškučių;7992750316;Ne;14;0;0;14
2574;"Gilužis (Vydūno g. 11A)";Meškučių;5505153657;Ne;0;0;1;1
2575;"Gilužis (Vydūno g. 11A)";Meškučių;2577554894;Ne;13;0;0;13
2576;"Gilužis (Vydūno g. 11A)";Meškučių;3148477315;Ne;8;0;0;8
2577;"Gilužis (Vydūno g. 11A)";Meškučių;1068375927;Ne;7;0;3;10
2578;"Gilužis (Vydūno g. 11A)";Meškučių;8476240141;Ne;8;0;0;8
2579;"Gilužis (Vydūno g. 11A)";Meškučių;8780573054;Ne;0;5;0;5
2580;"Gilužis (Vydūno g. 11A)";Meškučių;6185280967;Ne;16;1;0;17
2581;"Gilužis (Vydūno g. 11A)";Meškučių;5177805719;Ne;0;4;0;4
2582;"Gilužis (Vydūno g. 11A)";Meškučių;7045940267;Ne;0;1;0;1
2583;"Gilužis (Vydūno g. 11A)";Pagrandukai;6884146146;Ne;0;22;0;22
2584;"Gilužis (Vydūno g. 11A)";Pagrandukai;6920910054;Ne;10;12;0;22
2585;"Gilužis (Vydūno g. 11A)";Pagrandukai;5705945483;Ne;1;5;0;6
2586;"Gilužis (Vydūno g. 11A)";Pagrandukai;5397975739;Ne;0;1;0;1
2587;"Gilužis (Vydūno g. 11A)";Pagrandukai;5376639182;Ne;0;2;0;2
2588;"Gilužis (Vydūno g. 11A)";Pagrandukai;5378701300;Ne;6;1;0;7
2589;"Gilužis (Vydūno g. 11A)";Pagrandukai;3366788027;Ne;6;1;0;7
2590;"Gilužis (Vydūno g. 11A)";Pagrandukai;9676661005;Ne;10;6;0;16
2591;"Gilužis (Vydūno g. 11A)";Pagrandukai;1306757860;Ne;7;7;0;14
2592;"Gilužis (Vydūno g. 11A)";Pagrandukai;2706629834;Ne;9;5;0;14
2593;"Gilužis (Vydūno g. 11A)";Pagrandukai;5184511012;Ne;13;0;0;13
2594;"Gilužis (Vydūno g. 11A)";Pagrandukai;9587502317;Ne;13;0;0;13
2595;"Gilužis (Vydūno g. 11A)";Pagrandukai;4266998302;Ne;0;4;0;4
2596;"Gilužis (Vydūno g. 11A)";Pagrandukai;5334441484;Ne;6;0;0;6
2597;"Gilužis (Vydūno g. 11A)";Pagrandukai;8852862161;Ne;3;0;0;3
2598;"Gilužis (Vydūno g. 11A)";Boružėlių;5497242500;Ne;0;4;0;4
2599;"Gilužis (Vydūno g. 11A)";Boružėlių;2516315604;Ne;5;10;1;16
2600;"Gilužis (Vydūno g. 11A)";Boružėlių;9783700319;Ne;4;1;0;5
2601;"Gilužis (Vydūno g. 11A)";Boružėlių;5394693502;Ne;11;0;0;11
2602;"Gilužis (Vydūno g. 11A)";Boružėlių;4455977087;Ne;5;0;0;5
2603;"Gilužis (Vydūno g. 11A)";Boružėlių;4876074981;Ne;0;1;0;1
2604;"Gilužis (Vydūno g. 11A)";Boružėlių;2633680406;Ne;0;2;1;3
2605;"Gilužis (Vydūno g. 11A)";Boružėlių;3002266577;Ne;5;8;0;13
2606;"Gilužis (Vydūno g. 11A)";Boružėlių;5190752112;Ne;10;1;0;11
2607;"Gilužis (Vydūno g. 11A)";Boružėlių;2440762487;Ne;10;1;0;11
2608;"Gilužis (Vydūno g. 11A)";Boružėlių;4509741536;Ne;2;3;0;5
2609;"Gilužis (Vydūno g. 11A)";Boružėlių;9707968228;Ne;7;0;0;7
2610;"Gilužis (Vydūno g. 11A)";Boružėlių;8628253655;Ne;6;10;0;16
2611;"Gilužis (Vydūno g. 11A)";Boružėlių;9104005195;Ne;8;0;0;8
2612;"Gilužis (Vydūno g. 11A)";Boružėlių;5581417252;Ne;0;22;0;22
2613;"Gilužis (Vydūno g. 11A)";Boružėlių;4106792355;Ne;0;1;0;1
2614;"Gilužis (Vydūno g. 11A)";Boružėlių;4475698906;Ne;15;0;0;15
2615;"Gilužis (Vydūno g. 11A)";Boružėlių;2615087717;Ne;2;1;1;4
2616;"Gintarėlis (Didlaukio g. 35)";PAPŪGĖLĖS;8498936096;Ne;0;7;0;7
2617;"Gintarėlis (Didlaukio g. 35)";PAPŪGĖLĖS;8913652291;Ne;2;0;0;2
2618;"Gintarėlis (Didlaukio g. 35)";PAPŪGĖLĖS;2485750596;Ne;0;0;1;1
2619;"Gintarėlis (Didlaukio g. 35)";PAPŪGĖLĖS;1033624080;Ne;0;2;0;2
2620;"Gintarėlis (Didlaukio g. 35)";PAPŪGĖLĖS;2919700367;Ne;0;8;1;9
2621;"Gintarėlis (Didlaukio g. 35)";PAPŪGĖLĖS;1768789948;Ne;14;0;0;14
2622;"Gintarėlis (Didlaukio g. 35)";PAPŪGĖLĖS;2235045173;Ne;0;6;0;6
2623;"Gintarėlis (Didlaukio g. 35)";PAPŪGĖLĖS;9494521554;Ne;0;14;0;14
2624;"Gintarėlis (Didlaukio g. 35)";PAPŪGĖLĖS;5783939567;Ne;0;2;3;5
2625;"Gintarėlis (Didlaukio g. 35)";PAPŪGĖLĖS;7674351459;Ne;0;1;0;1
2626;"Gintarėlis (Didlaukio g. 35)";PAPŪGĖLĖS;6292664833;Ne;0;0;9;9
2627;"Gintarėlis (Didlaukio g. 35)";PAPŪGĖLĖS;8610886062;Ne;0;1;0;1
2628;"Gintarėlis (Didlaukio g. 35)";PAPŪGĖLĖS;5811396263;Ne;0;4;0;4
2629;"Gintarėlis (Didlaukio g. 35)";PAPŪGĖLĖS;1648843117;Ne;0;12;0;12
2630;"Gintarėlis (Didlaukio g. 35)";PAPŪGĖLĖS;1861324153;Ne;0;6;0;6
2631;"Gintarėlis (Didlaukio g. 35)";PAPŪGĖLĖS;3457974670;Ne;5;15;0;20
2632;"Gintarėlis (Didlaukio g. 35)";PAPŪGĖLĖS;1511718436;Ne;0;2;8;10
2633;"Gintarėlis (Didlaukio g. 35)";PAPŪGĖLĖS;4484711857;Ne;0;0;8;8
2634;"Gintarėlis (Didlaukio g. 35)";PAPŪGĖLĖS;6080108998;Ne;5;1;0;6
2635;"Gintarėlis (Didlaukio g. 35)";PAPŪGĖLĖS;6655645997;Ne;2;1;0;3
2636;"Gintarėlis (Didlaukio g. 35)";SPINDULIUKAI;6091264509;Ne;0;4;0;4
2637;"Gintarėlis (Didlaukio g. 35)";SPINDULIUKAI;56124970238;Ne;0;1;0;1
2638;"Gintarėlis (Didlaukio g. 35)";SPINDULIUKAI;22394648690;Ne;0;2;0;2
2639;"Gintarėlis (Didlaukio g. 35)";SPINDULIUKAI;21658913551;Ne;9;0;0;9
2640;"Gintarėlis (Didlaukio g. 35)";SPINDULIUKAI;8405210216;Ne;0;2;3;5
2641;"Gintarėlis (Didlaukio g. 35)";SPINDULIUKAI;18715625324;Ne;0;7;0;7
2642;"Gintarėlis (Didlaukio g. 35)";SPINDULIUKAI;2721386855;Ne;0;1;0;1
2643;"Gintarėlis (Didlaukio g. 35)";SPINDULIUKAI;2914156353;Ne;0;0;7;7
2644;"Gintarėlis (Didlaukio g. 35)";SPINDULIUKAI;5916948150;Ne;0;2;2;4
2645;"Gintarėlis (Didlaukio g. 35)";SPINDULIUKAI;45480802894;Ne;0;4;0;4
2646;"Gintarėlis (Didlaukio g. 35)";SPINDULIUKAI;3978892232;Ne;0;1;0;1
2647;"Gintarėlis (Didlaukio g. 35)";SPINDULIUKAI;1770479969;Ne;0;1;0;1
2648;"Gintarėlis (Didlaukio g. 35)";SPINDULIUKAI;1441282039;Ne;0;2;4;6
2649;"Gintarėlis (Didlaukio g. 35)";SPINDULIUKAI;9539570835;Ne;0;15;0;15
2650;"Gintarėlis (Didlaukio g. 35)";SPINDULIUKAI;7878911379;Ne;0;2;0;2
2651;"Gintarėlis (Didlaukio g. 35)";LAŠIUKAI;6142819210;Ne;0;4;1;5
2652;"Gintarėlis (Didlaukio g. 35)";LAŠIUKAI;7971810025;Ne;7;0;0;7
2653;"Gintarėlis (Didlaukio g. 35)";LAŠIUKAI;28704617970;Ne;0;7;0;7
2654;"Gintarėlis (Didlaukio g. 35)";LAŠIUKAI;8247701603;Ne;0;1;0;1
2655;"Gintarėlis (Didlaukio g. 35)";LAŠIUKAI;4498326942;Ne;0;2;5;7
2656;"Gintarėlis (Didlaukio g. 35)";LAŠIUKAI;1655837441;Ne;0;2;1;3
2657;"Gintarėlis (Didlaukio g. 35)";LAŠIUKAI;1690400583;Ne;5;2;2;9
2658;"Gintarėlis (Didlaukio g. 35)";LAŠIUKAI;8186804032;Ne;4;5;0;9
2659;"Gintarėlis (Didlaukio g. 35)";LAŠIUKAI;9560190761;Ne;0;2;0;2
2660;"Gintarėlis (Didlaukio g. 35)";LAŠIUKAI;5434952733;Ne;0;2;0;2
2661;"Gintarėlis (Didlaukio g. 35)";LAŠIUKAI;9230924100;Ne;0;1;2;3
2662;"Gintarėlis (Didlaukio g. 35)";LAŠIUKAI;7286562743;Ne;2;4;0;6
2663;"Gintarėlis (Didlaukio g. 35)";LAŠIUKAI;8000297636;Ne;0;2;0;2
2664;"Gintarėlis (Didlaukio g. 35)";LAŠIUKAI;3359584322;Ne;0;1;3;4
2665;"Gintarėlis (Didlaukio g. 35)";LAŠIUKAI;3820683506;Ne;0;6;0;6
2666;"Gintarėlis (Didlaukio g. 35)";MEŠKUČIAI;2926488239;Ne;0;2;0;2
2667;"Gintarėlis (Didlaukio g. 35)";MEŠKUČIAI;6618240550;Ne;0;2;0;2
2668;"Gintarėlis (Didlaukio g. 35)";MEŠKUČIAI;8790078624;Ne;0;10;0;10
2669;"Gintarėlis (Didlaukio g. 35)";MEŠKUČIAI;2518840573;Ne;0;2;0;2
2670;"Gintarėlis (Didlaukio g. 35)";MEŠKUČIAI;5187894822;Ne;0;1;0;1
2671;"Gintarėlis (Didlaukio g. 35)";MEŠKUČIAI;3630567294;Ne;5;3;0;8
2672;"Gintarėlis (Didlaukio g. 35)";MEŠKUČIAI;5181872438;Ne;0;1;0;1
2673;"Gintarėlis (Didlaukio g. 35)";MEŠKUČIAI;1565802953;Ne;0;22;0;22
2674;"Gintarėlis (Didlaukio g. 35)";MEŠKUČIAI;2072435242;Ne;22;0;0;22
2675;"Gintarėlis (Didlaukio g. 35)";MEŠKUČIAI;7989239799;Ne;7;1;0;8
2676;"Gintarėlis (Didlaukio g. 35)";MEŠKUČIAI;4356211536;Ne;4;0;0;4
2677;"Gintarėlis (Didlaukio g. 35)";MEŠKUČIAI;1502740714;Ne;0;1;0;1
2678;"Gintarėlis (Didlaukio g. 35)";MEŠKUČIAI;6636835034;Ne;0;7;0;7
2679;"Gintarėlis (Didlaukio g. 35)";MEŠKUČIAI;3830154353;Ne;0;1;0;1
2680;"Gintarėlis (Didlaukio g. 35)";MEŠKUČIAI;3947405446;Ne;7;7;0;14
2681;"Gintarėlis (Didlaukio g. 35)";MEŠKUČIAI;7948438165;Ne;0;2;0;2
2682;"Gintarėlis (Didlaukio g. 35)";MEŠKUČIAI;4642142931;Ne;9;2;0;11
2683;"Gintarėlis (Didlaukio g. 35)";MEŠKUČIAI;6711753930;Ne;0;2;0;2
2684;"Gintarėlis (Didlaukio g. 35)";MEŠKUČIAI;9017592249;Ne;0;8;0;8
2685;"Gintarėlis (Didlaukio g. 35)";MEŠKUČIAI;8375475174;Ne;0;13;0;13
2686;"Gintarėlis (Didlaukio g. 35)";MEŠKUČIAI;7029401386;Ne;2;0;0;2
2687;"Gintarėlis (Didlaukio g. 35)";MEŠKUČIAI;1790629500;Ne;6;0;0;6
2688;"Gintarėlis (Didlaukio g. 35)";MEŠKUČIAI;7320085613;Ne;0;4;0;4
2689;"Gintarėlis (Didlaukio g. 35)";DRUGELIAI;1462949250;Ne;0;2;1;3
2690;"Gintarėlis (Didlaukio g. 35)";DRUGELIAI;9737200226;Ne;0;1;0;1
2691;"Gintarėlis (Didlaukio g. 35)";DRUGELIAI;6655809299;Ne;0;0;2;2
2692;"Gintarėlis (Didlaukio g. 35)";DRUGELIAI;2614258442;Ne;0;14;0;14
2693;"Gintarėlis (Didlaukio g. 35)";DRUGELIAI;1452402931;Ne;0;4;0;4
2694;"Gintarėlis (Didlaukio g. 35)";DRUGELIAI;4217329880;Ne;0;1;0;1
2695;"Gintarėlis (Didlaukio g. 35)";DRUGELIAI;9687974376;Ne;0;1;0;1
2696;"Gintarėlis (Didlaukio g. 35)";DRUGELIAI;8419453060;Ne;0;6;1;7
2697;"Gintarėlis (Didlaukio g. 35)";DRUGELIAI;7449437199;Ne;0;2;0;2
2698;"Gintarėlis (Didlaukio g. 35)";DRUGELIAI;2016067859;Ne;0;14;1;15
2699;"Gintarėlis (Didlaukio g. 35)";DRUGELIAI;9579497944;Ne;2;0;1;3
2700;"Gintarėlis (Didlaukio g. 35)";DRUGELIAI;3341850450;Ne;0;0;1;1
2701;"Gintarėlis (Didlaukio g. 35)";DRUGELIAI;1759218238;Taip;0;1;0;1
2702;"Gintarėlis (Didlaukio g. 35)";DRUGELIAI;1248017244;Ne;4;8;0;12
2703;"Gintarėlis (Didlaukio g. 35)";DRUGELIAI;2792618575;Ne;0;7;1;8
2704;"Gintarėlis (Didlaukio g. 35)";DRUGELIAI;8171192401;Ne;4;2;0;6
2705;"Gintarėlis (Didlaukio g. 35)";DRUGELIAI;7694587246;Ne;0;1;0;1
2706;"Gintarėlis (Didlaukio g. 35)";DRUGELIAI;4904966263;Ne;0;5;2;7
2707;"Gintarėlis (Didlaukio g. 35)";KAČIUKAI;5569843168;Ne;2;6;0;8
2708;"Gintarėlis (Didlaukio g. 35)";KAČIUKAI;3665764153;Ne;0;4;1;5
2709;"Gintarėlis (Didlaukio g. 35)";KAČIUKAI;9774056578;Ne;1;4;0;5
2710;"Gintarėlis (Didlaukio g. 35)";KAČIUKAI;2212296954;Ne;0;0;5;5
2711;"Gintarėlis (Didlaukio g. 35)";KAČIUKAI;3825700024;Ne;0;2;1;3
2712;"Gintarėlis (Didlaukio g. 35)";KAČIUKAI;7057877483;Ne;0;2;1;3
2713;"Gintarėlis (Didlaukio g. 35)";KAČIUKAI;9825811100;Ne;10;0;3;13
2714;"Gintarėlis (Didlaukio g. 35)";KAČIUKAI;7875981690;Ne;0;5;0;5
2715;"Gintarėlis (Didlaukio g. 35)";KAČIUKAI;2544338275;Ne;0;5;0;5
2716;"Gintarėlis (Didlaukio g. 35)";KAČIUKAI;7182964126;Ne;0;2;0;2
2717;"Gintarėlis (Didlaukio g. 35)";KAČIUKAI;4754929282;Ne;0;2;0;2
2718;"Gintarėlis (Didlaukio g. 35)";KAČIUKAI;1011749698;Ne;0;2;6;8
2719;"Gintarėlis (Didlaukio g. 35)";KAČIUKAI;8261770154;Ne;0;13;0;13
2720;"Gintarėlis (Didlaukio g. 35)";KAČIUKAI;7061545258;Ne;0;1;0;1
2721;"Gintarėlis (Didlaukio g. 35)";KAČIUKAI;5436695400;Ne;0;2;0;2
2722;"Gintarėlis (Didlaukio g. 35)";KAČIUKAI;5921751507;Ne;0;1;0;1
2723;"Gintarėlis (Didlaukio g. 35)";KAČIUKAI;9450900915;Ne;0;0;6;6
2724;"Gintarėlis (Didlaukio g. 35)";KAČIUKAI;5153948767;Ne;0;2;0;2
2725;"Gintarėlis (Didlaukio g. 35)";KAČIUKAI;3814485627;Ne;0;7;0;7
2726;"Gintarėlis (Didlaukio g. 35)";KAČIUKAI;1571260478;Ne;5;1;0;6
2727;"Gintarėlis (Didlaukio g. 35)";KAČIUKAI;9244715396;Ne;15;1;0;16
2728;"Gintarėlis (Didlaukio g. 35)";KIŠKUČIAI;9279399214;Ne;8;1;0;9
2729;"Gintarėlis (Didlaukio g. 35)";KIŠKUČIAI;3921015919;Ne;0;2;1;3
2730;"Gintarėlis (Didlaukio g. 35)";KIŠKUČIAI;2814569415;Ne;0;3;6;9
2731;"Gintarėlis (Didlaukio g. 35)";KIŠKUČIAI;7143014339;Ne;0;1;0;1
2732;"Gintarėlis (Didlaukio g. 35)";KIŠKUČIAI;5796729245;Ne;0;3;0;3
2733;"Gintarėlis (Didlaukio g. 35)";KIŠKUČIAI;9915887420;Ne;0;3;0;3
2734;"Gintarėlis (Didlaukio g. 35)";KIŠKUČIAI;8287685690;Ne;0;6;0;6
2735;"Gintarėlis (Didlaukio g. 35)";KIŠKUČIAI;7815317644;Ne;0;2;0;2
2736;"Gintarėlis (Didlaukio g. 35)";KIŠKUČIAI;2165332442;Ne;0;1;0;1
2737;"Gintarėlis (Didlaukio g. 35)";KIŠKUČIAI;6914904213;Ne;13;2;0;15
2738;"Gintarėlis (Didlaukio g. 35)";KIŠKUČIAI;1696337909;Ne;13;2;0;15
2739;"Gintarėlis (Didlaukio g. 35)";KIŠKUČIAI;6862629244;Ne;0;5;0;5
2740;"Gintarėlis (Didlaukio g. 35)";KIŠKUČIAI;3398936974;Ne;0;15;0;15
2741;"Gintarėlis (Didlaukio g. 35)";KIŠKUČIAI;1918879534;Ne;7;0;0;7
2742;"Gintarėlis (Didlaukio g. 35)";KIŠKUČIAI;7509100750;Ne;0;7;0;7
2743;"Gintarėlis (Didlaukio g. 35)";KIŠKUČIAI;6991746305;Ne;0;2;2;4
2744;"Gintarėlis (Didlaukio g. 35)";KIŠKUČIAI;3792697409;Ne;0;0;1;1
2745;"Gintarėlis (Didlaukio g. 35)";KIŠKUČIAI;6239242631;Ne;7;0;0;7
2746;"Gintarėlis (Didlaukio g. 35)";KIŠKUČIAI;5965570522;Ne;0;2;1;3
2747;"Gintarėlis (Didlaukio g. 35)";KIŠKUČIAI;4623909811;Ne;0;2;7;9
2748;"Gintarėlis (Didlaukio g. 35)";KIŠKUČIAI;3357866319;Taip;5;3;0;8
2749;"Gintarėlis (Didlaukio g. 35)";KIŠKUČIAI;8704248985;Ne;7;3;0;10
2750;"Gintarėlis (Didlaukio g. 35)";KIŠKUČIAI;5355691986;Ne;0;1;0;1
2751;"Gintarėlis (Didlaukio g. 35)";KIŠKUČIAI;5919205817;Ne;0;3;2;5
2752;"Gintarėlis (Didlaukio g. 35)";VYTURIUKAI;8768094601;Ne;10;1;0;11
2753;"Gintarėlis (Didlaukio g. 35)";VYTURIUKAI;5834772263;Ne;5;2;0;7
2754;"Gintarėlis (Didlaukio g. 35)";VYTURIUKAI;9533972547;Ne;5;9;5;19
2755;"Gintarėlis (Didlaukio g. 35)";VYTURIUKAI;4915783145;Ne;2;0;1;3
2756;"Gintarėlis (Didlaukio g. 35)";BORUŽĖLĖS;6402043654;Ne;0;1;0;1
2757;"Gintarėlis (Didlaukio g. 35)";BORUŽĖLĖS;6558614008;Ne;10;2;0;12
2758;"Gintarėlis (Didlaukio g. 35)";BORUŽĖLĖS;4348245746;Ne;0;2;1;3
2759;"Gintarėlis (Didlaukio g. 35)";BORUŽĖLĖS;3091731769;Ne;9;7;0;16
2760;"Gintarėlis (Didlaukio g. 35)";BORUŽĖLĖS;6484966941;Ne;0;2;0;2
2761;"Gintarėlis (Didlaukio g. 35)";BORUŽĖLĖS;9004590065;Ne;0;12;0;12
2762;"Gintarėlis (Didlaukio g. 35)";BORUŽĖLĖS;2624469768;Ne;0;2;0;2
2763;"Gintarėlis (Didlaukio g. 35)";BORUŽĖLĖS;8784796186;Ne;0;1;0;1
2764;"Gintarėlis (Didlaukio g. 35)";BORUŽĖLĖS;3538300416;Ne;0;1;0;1
2765;"Gintarėlis (Didlaukio g. 35)";BORUŽĖLĖS;8516817506;Ne;0;5;0;5
2766;"Gintarėlis (Didlaukio g. 35)";BORUŽĖLĖS;3235154374;Ne;0;22;0;22
2767;"Gintarėlis (Didlaukio g. 35)";BORUŽĖLĖS;7059730814;Ne;10;0;0;10
2768;"Gintarėlis (Didlaukio g. 35)";BORUŽĖLĖS;9970786396;Ne;0;14;0;14
2769;"Gintarėlis (Didlaukio g. 35)";BORUŽĖLĖS;7118758040;Ne;0;7;0;7
2770;"Gintarėlis (Didlaukio g. 35)";BORUŽĖLĖS;9622824643;Ne;15;1;0;16
2771;"Gintarėlis (Didlaukio g. 35)";BORUŽĖLĖS;9476258741;Ne;6;1;0;7
2772;"Gintarėlis (Didlaukio g. 35)";BORUŽĖLĖS;1400817076;Ne;6;0;0;6
2773;"Gintarėlis (Didlaukio g. 35)";BORUŽĖLĖS;1371258551;Ne;6;7;1;14
2774;"Gintarėlis (Didlaukio g. 35)";BORUŽĖLĖS;4334349824;Ne;0;2;0;2
2775;"Gintarėlis (Didlaukio g. 35)";BORUŽĖLĖS;8410642485;Ne;4;2;4;10
2776;"Gintarėlis (Didlaukio g. 35)";BORUŽĖLĖS;9501012756;Ne;7;15;0;22
2777;"Gintarėlis (Didlaukio g. 35)";EŽIUKAI;4487346983;Ne;0;5;0;5
2778;"Gintarėlis (Didlaukio g. 35)";EŽIUKAI;2263102527;Ne;0;1;1;2
2779;"Gintarėlis (Didlaukio g. 35)";EŽIUKAI;7919771693;Ne;0;0;1;1
2780;"Gintarėlis (Didlaukio g. 35)";EŽIUKAI;8055928882;Ne;0;9;0;9
2781;"Gintarėlis (Didlaukio g. 35)";EŽIUKAI;5024727902;Ne;0;2;0;2
2782;"Gintarėlis (Didlaukio g. 35)";EŽIUKAI;2088008759;Ne;0;12;2;14
2783;"Gintarėlis (Didlaukio g. 35)";EŽIUKAI;3799412062;Ne;0;1;0;1
2784;"Gintarėlis (Didlaukio g. 35)";EŽIUKAI;94354056029;Ne;0;7;0;7
2785;"Gintarėlis (Didlaukio g. 35)";EŽIUKAI;78359050717;Ne;3;0;0;3
2786;"Gintarėlis (Didlaukio g. 35)";EŽIUKAI;7192722296;Ne;0;2;3;5
2787;"Gintarėlis (Didlaukio g. 35)";EŽIUKAI;2970527490;Ne;0;1;0;1
2788;"Gintarėlis (Didlaukio g. 35)";EŽIUKAI;1066741732;Ne;6;0;1;7
2789;"Gintarėlis (Didlaukio g. 35)";EŽIUKAI;9917367735;Ne;0;0;1;1
2790;"Gintarėlis (Didlaukio g. 35)";EŽIUKAI;4514340634;Ne;0;2;0;2
2791;"Gintarėlis (Didlaukio g. 35)";VIŠČIUKAI;1981825456;Ne;0;2;1;3
2792;"Gintarėlis (Didlaukio g. 35)";VIŠČIUKAI;3973889495;Ne;0;2;2;4
2793;"Gintarėlis (Didlaukio g. 35)";VIŠČIUKAI;4749559606;Ne;12;2;0;14
2794;"Gintarėlis (Didlaukio g. 35)";VIŠČIUKAI;4458703839;Ne;0;7;2;9
2795;"Gintarėlis (Didlaukio g. 35)";VIŠČIUKAI;2178808286;Ne;0;18;0;18
2796;"Gintarėlis (Didlaukio g. 35)";VIŠČIUKAI;9073499040;Ne;15;2;0;17
2797;"Gintarėlis (Didlaukio g. 35)";VIŠČIUKAI;6547060300;Ne;0;7;0;7
2798;"Gintarėlis (Didlaukio g. 35)";VIŠČIUKAI;4535071342;Ne;5;1;0;6
2799;"Gintarėlis (Didlaukio g. 35)";VIŠČIUKAI;8448725884;Ne;5;1;0;6
2800;"Gintarėlis (Didlaukio g. 35)";VIŠČIUKAI;6251670953;Ne;0;10;0;10
2801;"Gintarėlis (Didlaukio g. 35)";VIŠČIUKAI;8805356168;Ne;0;8;0;8
2802;"Gintarėlis (Didlaukio g. 35)";VIŠČIUKAI;4751066825;Ne;12;1;0;13
2803;"Gintarėlis (Didlaukio g. 35)";VIŠČIUKAI;1039098192;Ne;0;2;1;3
2804;"Gintarėlis (Didlaukio g. 35)";VIŠČIUKAI;6042885133;Ne;5;15;0;20
2805;"Gintarėlis (Didlaukio g. 35)";VIŠČIUKAI;7418672923;Ne;8;0;0;8
2806;"Gintarėlis (Didlaukio g. 35)";VIŠČIUKAI;7562170082;Ne;0;17;0;17
2807;"Gintarėlis (Didlaukio g. 35)";VIŠČIUKAI;1367305617;Ne;5;1;0;6
2808;"Gintarėlis (Didlaukio g. 35)";VIŠČIUKAI;6711773127;Ne;5;6;0;11
2809;"Gintarėlis (Didlaukio g. 35)";VIŠČIUKAI;7537009709;Ne;5;1;0;6
2810;"Gintarėlis (Didlaukio g. 35)";VIŠČIUKAI;9191264261;Ne;0;0;4;4
2811;"Gintarėlis (Didlaukio g. 35)";VIŠČIUKAI;2920734274;Ne;0;0;7;7
2812;"Gintarėlis (Didlaukio g. 35)";VIŠČIUKAI;3232990779;Ne;6;8;0;14
2813;"Gintarėlis (Didlaukio g. 35)";"SAULĖS ZUIKUČIAI";4278770021;Ne;0;1;0;1
2814;"Gintarėlis (Didlaukio g. 35)";"SAULĖS ZUIKUČIAI";9915228593;Ne;0;2;0;2
2815;"Gintarėlis (Didlaukio g. 35)";"SAULĖS ZUIKUČIAI";2499727321;Ne;7;0;0;7
2816;"Gintarėlis (Didlaukio g. 35)";"SAULĖS ZUIKUČIAI";2949035147;Ne;1;10;0;11
2817;"Gintarėlis (Didlaukio g. 35)";"SAULĖS ZUIKUČIAI";3839660368;Ne;0;4;4;8
2818;"Gintarėlis (Didlaukio g. 35)";"SAULĖS ZUIKUČIAI";5991638696;Ne;0;7;0;7
2819;"Gintarėlis (Didlaukio g. 35)";"SAULĖS ZUIKUČIAI";6133476137;Ne;7;2;0;9
2820;"Gintarėlis (Didlaukio g. 35)";"SAULĖS ZUIKUČIAI";6751822184;Ne;0;4;4;8
2821;"Gintarėlis (Didlaukio g. 35)";"SAULĖS ZUIKUČIAI";3876016666;Ne;6;0;0;6
2822;"Gintarėlis (Didlaukio g. 35)";"SAULĖS ZUIKUČIAI";8403881160;Ne;2;7;0;9
2823;"Gintarėlis (Didlaukio g. 35)";"SAULĖS ZUIKUČIAI";5336654560;Ne;0;1;0;1
2824;"Gintarėlis (Didlaukio g. 35)";"SAULĖS ZUIKUČIAI";3732252177;Ne;0;1;0;1
2825;"Gintarėlis (Didlaukio g. 35)";"SAULĖS ZUIKUČIAI";4087751760;Ne;9;0;0;9
2826;"Gintarėlis (Didlaukio g. 35)";"SAULĖS ZUIKUČIAI";4462515146;Ne;0;1;0;1
2827;"Gintarėlis (Didlaukio g. 35)";"SAULĖS ZUIKUČIAI";5338409090;Ne;0;1;0;1
2828;"Gintarėlis (Didlaukio g. 35)";"SAULĖS ZUIKUČIAI";1482227839;Ne;0;3;0;3
2829;"Gintarėlis (Didlaukio g. 35)";Pabiručiai;8286814809;Ne;5;2;0;7
2830;"Gintarėlis (Didlaukio g. 35)";Pabiručiai;4757160835;Ne;0;0;4;4
2831;"Gintarėlis (Didlaukio g. 35)";Pabiručiai;1158055621;Ne;0;2;0;2
2832;"Gintarėlis (Didlaukio g. 35)";Pabiručiai;1474802737;Ne;0;2;0;2
2833;"Gintarėlis (Didlaukio g. 35)";Pabiručiai;6578588403;Ne;13;2;1;16
2834;"Gintarėlis (Didlaukio g. 35)";Šypsenėlės;3575375401;Ne;0;2;2;4
2835;"Gintarėlis (Didlaukio g. 35)";Šypsenėlės;3575375401;Ne;0;2;2;4
2836;"Gintarėlis (Didlaukio g. 35)";Šypsenėlės;3575375401;Ne;0;2;2;4
2837;"Gintarėlis (Didlaukio g. 35)";Šypsenėlės;9020619501;Ne;0;2;5;7
2838;"Gintarėlis (Didlaukio g. 35)";Šypsenėlės;2904118045;Ne;6;0;3;9
2839;"Gintarėlis (Didlaukio g. 35)";Šypsenėlės;9413836091;Ne;0;2;4;6
2840;"Gintarėlis (Didlaukio g. 35)";Šypsenėlės;7337543180;Ne;2;2;0;4
2841;"Gintarėlis (Didlaukio g. 35)";Šypsenėlės;7337543180;Ne;2;2;0;4
2842;"Gintarėlis (Didlaukio g. 35)";Šypsenėlės;7337543180;Ne;2;2;0;4
2843;"Gintarėlis (Didlaukio g. 35)";Šypsenėlės;1567290856;Ne;0;0;1;1
2844;"Gintarėlis (Didlaukio g. 35)";Šypsenėlės;7661638176;Taip;0;4;0;4
2845;"Gintarėlis (Didlaukio g. 35)";Šypsenėlės;9477018713;Ne;6;2;0;8
2846;"Gintarėlis (Didlaukio g. 35)";Šypsenėlės;9477018713;Ne;6;2;0;8
2847;"Gintarėlis (Didlaukio g. 35)";Šypsenėlės;9477018713;Ne;6;2;0;8
2848;"Gintarėlis (Didlaukio g. 35)";Šypsenėlės;3088663209;Ne;0;2;0;2
2849;"Gintarėlis (Didlaukio g. 35)";Šypsenėlės;3794027499;Ne;0;2;0;2
2850;"Gintarėlis (Didlaukio g. 35)";Šypsenėlės;7813187438;Ne;0;2;0;2
2851;"Gintarėlis (Didlaukio g. 35)";Šypsenėlės;9234476307;Ne;0;2;0;2
2852;"Gintarėlis (Didlaukio g. 35)";Šypsenėlės;6561070982;Ne;0;7;0;7
2853;"Gintarėlis (Didlaukio g. 35)";Šypsenėlės;2203238888;Ne;0;2;0;2
2854;"Gintarėlis (Didlaukio g. 35)";Šypsenėlės;3484172382;Ne;0;2;1;3
2855;"Gintarėlis (Didlaukio g. 35)";Šypsenėlės;2256002308;Ne;0;2;8;10
2856;"Gintarėlis (Didlaukio g. 35)";Šypsenėlės;6607854244;Ne;0;2;0;2
2857;"Gintarėlis (Didlaukio g. 35)";Šypsenėlės;1327681704;Ne;0;2;0;2
2858;"Gintarėlis (Didlaukio g. 35)";Šypsenėlės;3987801707;Ne;4;2;0;6
2859;"Gintarėlis (Didlaukio g. 35)";Šypsenėlės;7123016029;Ne;0;2;0;2
2860;"Gintarėlis (Didlaukio g. 35)";Šypsenėlės;3000371147;Ne;0;7;0;7
2861;"Gintarėlis (Didlaukio g. 35)";Šypsenėlės;5717123412;Ne;5;9;0;14
2862;"Gintarėlis (Didlaukio g. 35)";Šypsenėlės;1480486900;Ne;5;2;5;12
2863;"Gintarėlis (Didlaukio g. 35)";Šypsenėlės;3459439843;Ne;2;6;0;8
2864;"Gintarėlis (Didlaukio g. 35)";Smalsučiai;7486822380;Ne;0;2;3;5
2865;"Gintarėlis (Didlaukio g. 35)";Smalsučiai;8387819754;Ne;0;3;0;3
2866;"Gintarėlis (Didlaukio g. 35)";Smalsučiai;5748677965;Ne;3;6;0;9
2867;"Gintarėlis (Didlaukio g. 35)";Smalsučiai;1876292168;Ne;6;6;0;12
2868;"Gintarėlis (Didlaukio g. 35)";Smalsučiai;9980747501;Ne;0;0;1;1
2869;"Gintarėlis (Didlaukio g. 35)";Smalsučiai;8754068506;Ne;2;2;2;6
2870;"Gintarėlis (Didlaukio g. 35)";Smalsučiai;7690748176;Ne;4;0;1;5
2871;"Gintarėlis (Didlaukio g. 35)";Kodėlčiukai;1537528341;Taip;0;2;0;2
2872;"Gintarėlis (Didlaukio g. 35)";Kodėlčiukai;7976989629;Ne;17;0;0;17
2873;"Gintarėlis (Didlaukio g. 35)";Kodėlčiukai;3444997417;Ne;0;1;3;4
2874;"Gintarėlis (Didlaukio g. 35)";Kodėlčiukai;8982034601;Ne;0;0;1;1
2875;"Gintarėlis (Didlaukio g. 35)";Kodėlčiukai;2234295991;Ne;0;2;0;2
2876;"Gintarėlis (Didlaukio g. 35)";Kodėlčiukai;6545866812;Ne;4;2;7;13
2877;"Gintarėlis (Didlaukio g. 35)";Kodėlčiukai;5467958458;Ne;0;1;0;1
2878;"Gintarėlis (Didlaukio g. 35)";Kodėlčiukai;5824210469;Ne;0;5;0;5
2879;"Gintarėlis (Didlaukio g. 35)";Kodėlčiukai;5202442681;Ne;0;11;0;11
2880;"Gintarėlis (Didlaukio g. 35)";Gintariukai;5109775795;Ne;3;0;0;3
2881;"Gintarėlis (Didlaukio g. 35)";Gintariukai;6056471440;Ne;0;22;0;22
2882;"Gintarėlis (Didlaukio g. 35)";Gintariukai;2809388552;Ne;0;0;1;1
2883;"Gintarėlis (Didlaukio g. 35)";Gintariukai;9374716095;Ne;16;0;0;16
2884;"Gintarėlis (Didlaukio g. 35)";Gintariukai;1359894648;Ne;5;0;0;5
2885;"Gintarėlis (Didlaukio g. 35)";Gintariukai;8815001033;Ne;0;2;0;2
2886;Giraitė;Aviliukas;4292730355;Ne;0;3;0;3
2887;Giraitė;Aviliukas;7001163828;Ne;5;0;0;5
2888;Giraitė;Aviliukas;6159650070;Ne;5;0;4;9
2889;Giraitė;Aviliukas;5275912609;Ne;0;0;4;4
2890;Giraitė;Aviliukas;4758750245;Ne;5;2;0;7
2891;Giraitė;Aviliukas;2219854347;Ne;0;0;7;7
2892;Giraitė;Aviliukas;2338867192;Ne;0;9;5;14
2893;Giraitė;Aviliukas;3719285343;Ne;0;0;1;1
2894;Giraitė;Aviliukas;7807844145;Ne;3;0;0;3
2895;Giraitė;Aviliukas;3757900478;Ne;5;0;1;6
2896;Giraitė;Aviliukas;7876457529;Ne;0;1;1;2
2897;Giraitė;Aviliukas;3992069614;Ne;5;0;2;7
2898;Giraitė;Aviliukas;6121586335;Ne;0;0;10;10
2899;Giraitė;Aviliukas;4440444700;Ne;5;0;0;5
2900;Giraitė;Aviliukas;6296485105;Ne;1;0;0;1
2901;Giraitė;Aviliukas;5356944812;Ne;0;0;3;3
2902;Giraitė;Aviliukas;4554565631;Ne;17;0;0;17
2903;Giraitė;LapiukaI;6141730004;Ne;0;1;0;1
2904;Giraitė;LapiukaI;2740656695;Ne;17;0;0;17
2905;Giraitė;LapiukaI;5030697729;Ne;0;2;0;2
2906;Giraitė;LapiukaI;1921430434;Ne;0;1;2;3
2907;Giraitė;LapiukaI;5006156109;Ne;0;2;0;2
2908;Giraitė;LapiukaI;4663343304;Ne;2;1;0;3
2909;Giraitė;LapiukaI;5382004098;Ne;0;3;0;3
2910;Giraitė;LapiukaI;4811513778;Ne;0;1;0;1
2911;Giraitė;LapiukaI;4296449093;Taip;0;4;0;4
2912;Giraitė;LapiukaI;1974159110;Ne;6;5;0;11
2913;Giraitė;LapiukaI;5532639133;Ne;2;0;0;2
2914;Giraitė;LapiukaI;4076402180;Ne;0;1;1;2
2915;Giraitė;LapiukaI;5902161665;Ne;0;9;0;9
2916;Giraitė;LapiukaI;4260343903;Ne;3;0;0;3
2917;Giraitė;LapiukaI;9088123796;Ne;12;0;0;12
2918;Giraitė;LapiukaI;7772177095;Ne;1;0;0;1
2919;Giraitė;LapiukaI;2880342138;Ne;0;0;2;2
2920;Giraitė;Voveriukai;7354834895;Ne;0;1;0;1
2921;Giraitė;Voveriukai;4387282125;Ne;3;0;0;3
2922;Giraitė;Voveriukai;4822168634;Ne;0;0;3;3
2923;Giraitė;Voveriukai;2074303013;Ne;0;0;1;1
2924;Giraitė;Voveriukai;3875214088;Ne;8;2;0;10
2925;Giraitė;Voveriukai;5202562049;Ne;0;1;0;1
2926;Giraitė;Voveriukai;7441871219;Ne;2;0;1;3
2927;Giraitė;Voveriukai;7481895278;Ne;6;0;0;6
2928;Giraitė;Voveriukai;3607198556;Ne;0;3;0;3
2929;Giraitė;Voveriukai;6225092500;Ne;4;0;1;5
2930;Giraitė;Voveriukai;5616242311;Ne;14;0;0;14
2931;Giraitė;Voveriukai;4773517160;Ne;4;0;3;7
2932;Giraitė;Voveriukai;2177856916;Ne;0;1;0;1
2933;Giraitė;Grybukai;2990968206;Ne;0;0;11;11
2934;Giraitė;Grybukai;1312761239;Ne;0;2;0;2
2935;Giraitė;Grybukai;5721669627;Ne;0;1;1;2
2936;Giraitė;Grybukai;5892950503;Ne;0;6;0;6
2937;Giraitė;Grybukai;4839351300;Ne;0;5;0;5
2938;Giraitė;Grybukai;4336519836;Ne;0;8;0;8
2939;Giraitė;Grybukai;6836412890;Ne;0;0;1;1
2940;Giraitė;Grybukai;9224845723;Ne;0;1;0;1
2941;Giraitė;Grybukai;4687228561;Ne;2;0;1;3
2942;Giraitė;Grybukai;9882372025;Ne;0;10;0;10
2943;Giraitė;Grybukai;9918028862;Ne;0;3;0;3
2944;Giraitė;Grybukai;5167002022;Ne;3;2;1;6
2945;Giraitė;Grybukai;4785524898;Ne;0;8;0;8
2946;Giraitė;Grybukai;8596389737;Ne;0;0;4;4
2947;Giraitė;Grybukai;1111614295;Ne;0;4;0;4
2948;Giraitė;Grybukai;5029839281;Ne;0;0;3;3
2949;Giraitė;Grybukai;8869728241;Ne;1;0;0;1
2950;Giraitė;Grybukai;3683700626;Ne;2;0;0;2
2951;Giraitė;Grybukai;9026736929;Ne;9;1;0;10
2952;Giraitė;Riešutėliai;5365264259;Ne;0;0;1;1
2953;Giraitė;Riešutėliai;3158451613;Ne;14;0;0;14
2954;Giraitė;Riešutėliai;7910736839;Ne;22;0;0;22
2955;Giraitė;Riešutėliai;3308792461;Ne;22;0;0;22
2956;Giraitė;Riešutėliai;7423115504;Ne;0;0;1;1
2957;Giraitė;Riešutėliai;3116241918;Ne;0;2;0;2
2958;Giraitė;Riešutėliai;6838184704;Ne;0;6;3;9
2959;Giraitė;Riešutėliai;5161383686;Ne;0;8;1;9
2960;Giraitė;Riešutėliai;5148257412;Ne;0;0;1;1
2961;Giraitė;Riešutėliai;7566944002;Ne;0;2;2;4
2962;Giraitė;Riešutėliai;3839432744;Ne;0;1;1;2
2963;Giraitė;Riešutėliai;7803047658;Ne;4;2;0;6
2964;Giraitė;Riešutėliai;9144465313;Ne;2;0;0;2
2965;Giraitė;Riešutėliai;6288016799;Ne;11;0;0;11
2966;Giraitė;Riešutėliai;3278871662;Ne;13;2;2;17
2967;Giraitė;Riešutėliai;4168934880;Ne;0;10;0;10
2968;Giraitė;Riešutėliai;6337090583;Ne;0;3;1;4
2969;Giraitė;Riešutėliai;3843211767;Ne;0;2;3;5
2970;Giraitė;Meškiukai;27501094616;Ne;0;1;0;1
2971;Giraitė;Meškiukai;2513312448;Ne;0;4;0;4
2972;Giraitė;Meškiukai;1608876140;Ne;0;2;0;2
2973;Giraitė;Meškiukai;5461837332;Ne;0;1;0;1
2974;Giraitė;Meškiukai;1355594003;Ne;0;2;0;2
2975;Giraitė;Meškiukai;1560868105;Ne;0;13;0;13
2976;Giraitė;Meškiukai;1050699551;Ne;0;0;4;4
2977;Giraitė;Meškiukai;1876815077;Ne;0;2;0;2
2978;Giraitė;Meškiukai;1063628206;Ne;0;2;0;2
2979;Giraitė;Meškiukai;1318214394;Ne;0;7;0;7
2980;Giraitė;Meškiukai;9195735923;Ne;0;1;0;1
2981;Giraitė;Meškiukai;1704154980;Ne;0;0;3;3
2982;Giraitė;Meškiukai;1819657811;Ne;0;2;0;2
2983;Giraitė;Meškiukai;2571892050;Ne;0;0;2;2
2984;Giraitė;Meškiukai;6156715234;Ne;10;0;0;10
2985;Giraitė;Meškiukai;1594965200;Ne;0;0;6;6
2986;Giraitė;Meškiukai;9723242940;Ne;2;0;0;2
2987;Giraitė;Meškiukai;5726182600;Ne;3;0;0;3
2988;Giraitė;Meškiukai;1772790396;Ne;5;3;0;8
2989;Giraitė;Meškiukai;2551280794;Ne;0;9;0;9
2990;Giraitė;Uogelės;8908602761;Ne;0;2;0;2
2991;Giraitė;Uogelės;4717851198;Ne;0;0;3;3
2992;Giraitė;Uogelės;1729871315;Ne;0;2;0;2
2993;Giraitė;Uogelės;9503157590;Ne;0;3;0;3
2994;Giraitė;Uogelės;4317544803;Ne;5;0;0;5
2995;Giraitė;Uogelės;9927102264;Ne;12;0;0;12
2996;Giraitė;Uogelės;4121361794;Ne;2;1;1;4
2997;Giraitė;Uogelės;4843415587;Ne;0;5;0;5
2998;Giraitė;Uogelės;5471577047;Ne;7;4;0;11
2999;Giraitė;Uogelės;2732715332;Ne;0;2;0;2
3000;Giraitė;Uogelės;2307307454;Ne;6;0;2;8
3001;Giraitė;Uogelės;2102237550;Ne;0;1;0;1
3002;Giraitė;Uogelės;5255040944;Ne;0;0;3;3
3003;Giraitė;Uogelės;7094750784;Taip;0;1;1;2
3004;Giraitė;Uogelės;1583733838;Ne;0;6;0;6
3005;Giraitė;Uogelės;4009092043;Ne;8;0;0;8
3006;Giraitė;Uogelės;1356340471;Ne;0;12;2;14
3007;Giraitė;Uogelės;7377939409;Ne;22;0;0;22
3008;Giraitė;Uogelės;4288937528;Ne;0;0;2;2
3009;Giraitė;Uogelės;6293111179;Ne;0;2;0;2
3010;Giraitė;Uogelės;7390702355;Ne;0;1;0;1
3011;Giraitė;Šaltinėlis;5876711899;Ne;7;5;0;12
3012;Giraitė;Šaltinėlis;8427713392;Taip;6;0;4;10
3013;Giraitė;Šaltinėlis;3612494313;Ne;0;6;3;9
3014;Giraitė;Šaltinėlis;2076989836;Ne;8;0;0;8
3015;Giraitė;Šaltinėlis;9589760939;Ne;9;0;0;9
3016;Giraitė;Šaltinėlis;4500393769;Ne;0;1;0;1
3017;Giraitė;Šaltinėlis;3144724475;Taip;7;10;1;18
3018;Giraitė;Šaltinėlis;5525538498;Ne;9;0;0;9
3019;Giraitė;Šaltinėlis;4681342624;Ne;5;0;0;5
3020;Giraitė;Šaltinėlis;4431964254;Ne;10;0;0;10
3021;Giraitė;Šaltinėlis;4946664007;Ne;10;0;0;10
3022;Giraitė;Šaltinėlis;1170698327;Ne;5;4;0;9
3023;Giraitė;Šaltinėlis;3108521607;Ne;9;0;1;10
3024;Giraitė;Šaltinėlis;8139743188;Ne;7;0;0;7
3025;Giraitė;Šaltinėlis;2867735227;Ne;6;0;0;6
3026;Giraitė;Šaltinėlis;9669849051;Ne;7;0;0;7
3027;Giraitė;Boružėlės;6378362980;Ne;2;0;1;3
3028;Giraitė;Boružėlės;8612554184;Ne;7;0;0;7
3029;Giraitė;Boružėlės;1436302175;Ne;0;3;0;3
3030;Giraitė;Boružėlės;2064019596;Ne;0;2;0;2
3031;Giraitė;Boružėlės;7260229442;Ne;0;2;0;2
3032;Giraitė;Boružėlės;1126576745;Ne;8;0;0;8
3033;Giraitė;Boružėlės;1772997796;Ne;14;0;0;14
3034;Giraitė;Boružėlės;6333747274;Ne;16;5;1;22
3035;Giraitė;Boružėlės;9281071794;Ne;11;0;0;11
3036;Giraitė;Boružėlės;9386943162;Ne;19;0;0;19
3037;Giraitė;Boružėlės;4749790368;Ne;3;0;0;3
3038;Giraitė;Boružėlės;3039445733;Ne;2;0;4;6
3039;Giraitė;Boružėlės;4719547384;Ne;8;0;0;8
3040;Giraitė;Boružėlės;4008393576;Ne;0;2;0;2
3041;Giraitė;Boružėlės;9766107773;Ne;7;0;1;8
3042;Giraitė;Gandriukai;4680913596;Ne;10;0;1;11
3043;Giraitė;Gandriukai;7384795349;Ne;7;0;0;7
3044;Giraitė;Gandriukai;3643426944;Ne;0;4;0;4
3045;Giraitė;Gandriukai;8525380061;Ne;0;7;0;7
3046;Giraitė;Gandriukai;4851987149;Ne;5;3;0;8
3047;Giraitė;Gandriukai;2205108811;Ne;0;0;2;2
3048;Giraitė;Gandriukai;7008670489;Ne;0;0;2;2
3049;Giraitė;Gandriukai;7767820565;Ne;7;1;3;11
3050;Giraitė;Gandriukai;8819218663;Ne;0;8;0;8
3051;Giraitė;Gandriukai;7269074498;Ne;6;0;0;6
3052;Giraitė;Gandriukai;1490748887;Ne;3;10;0;13
3053;Giraitė;Gandriukai;9850432917;Ne;17;0;0;17
3054;Giraitė;Gandriukai;2313273738;Ne;0;1;0;1
3055;Giraitė;Gandriukai;9625436756;Ne;0;8;0;8
3056;Giraitė;Gandriukai;8101302584;Ne;8;0;3;11
3057;Giraitė;Gandriukai;9307640828;Ne;0;0;1;1
3058;Giraitė;Gandriukai;1125863541;Ne;0;2;3;5
3059;Giraitė;Gandriukai;4371263826;Ne;5;4;0;9
3060;Giraitė;ŽVIRBLIUKAI;6715354865;Ne;7;0;0;7
3061;Giraitė;ŽVIRBLIUKAI;8461725999;Ne;8;0;1;9
3062;Giraitė;ŽVIRBLIUKAI;7395332578;Ne;9;0;0;9
3063;Giraitė;ŽVIRBLIUKAI;5086296808;Ne;0;8;0;8
3064;Giraitė;ŽVIRBLIUKAI;9669916418;Ne;0;0;1;1
3065;Giraitė;ŽVIRBLIUKAI;3481695682;Ne;7;0;1;8
3066;Giraitė;ŽVIRBLIUKAI;7678134658;Ne;2;0;0;2
3067;Giraitė;ŽVIRBLIUKAI;9471560738;Ne;2;2;0;4
3068;Giraitė;ŽVIRBLIUKAI;6677278422;Ne;0;0;1;1
3069;Giraitė;ŽVIRBLIUKAI;7230351549;Ne;0;5;12;17
3070;Giraitė;ŽVIRBLIUKAI;9728453316;Ne;2;8;0;10
3071;Giraitė;ŽVIRBLIUKAI;9392127689;Ne;0;0;8;8
3072;Giraitė;ŽVIRBLIUKAI;2416162886;Ne;0;0;3;3
3073;Giraitė;ŽVIRBLIUKAI;7543605905;Ne;8;7;0;15
3074;Giraitė;ŽVIRBLIUKAI;8128401630;Ne;7;0;0;7
3075;Giraitė;ŽVIRBLIUKAI;4233170371;Ne;5;0;0;5
3076;Giraitė;ŽVIRBLIUKAI;8871979627;Ne;0;6;0;6
3077;Giraitė;ŽVIRBLIUKAI;5548434439;Ne;2;0;0;2
3078;Giraitė;ŽVIRBLIUKAI;6474975269;Ne;0;0;1;1
3079;Giraitė;Kiškeliai;5870376620;Ne;2;0;0;2
3080;Giraitė;Kiškeliai;8138768065;Ne;5;0;1;6
3081;Giraitė;Kiškeliai;1227555563;Ne;22;0;0;22
3082;Giraitė;Kiškeliai;3613828494;Ne;7;0;0;7
3083;Giraitė;Kiškeliai;5447466102;Ne;0;11;0;11
3084;Giraitė;Kiškeliai;2686885139;Taip;4;0;0;4
3085;Giraitė;Kiškeliai;9764802294;Ne;0;5;1;6
3086;Giraitė;Kiškeliai;5574589536;Ne;8;0;0;8
3087;Giraitė;Kiškeliai;2726766768;Taip;5;2;0;7
3088;Giraitė;Kiškeliai;6565165993;Ne;0;0;4;4
3089;Giraitė;Kiškeliai;1456726379;Ne;0;0;1;1
3090;Giraitė;Kiškeliai;7392324344;Taip;12;0;2;14
3091;Giraitė;Kiškeliai;7744101334;Ne;0;0;2;2
3092;Giraitė;Kiškeliai;9751078590;Ne;7;0;0;7
3093;Gudrutis;Gandriukų;2197278086;Ne;8;0;0;8
3094;Gudrutis;Gandriukų;6358318238;Ne;0;7;0;7
3095;Gudrutis;Gandriukų;7942601528;Ne;0;7;0;7
3096;Gudrutis;Gandriukų;4844838728;Ne;0;9;0;9
3097;Gudrutis;Gandriukų;9253468183;Ne;3;2;5;10
3098;Gudrutis;Gandriukų;1051407930;Ne;0;4;3;7
3099;Gudrutis;Gandriukų;7755882832;Ne;0;2;0;2
3100;Gudrutis;Gandriukų;7663746093;Ne;11;1;0;12
3101;Gudrutis;Gandriukų;1012579870;Ne;0;2;3;5
3102;Gudrutis;Gandriukų;8512130106;Ne;0;2;8;10
3103;Gudrutis;Gandriukų;3919786807;Ne;0;2;12;14
3104;Gudrutis;Gandriukų;8165828215;Ne;0;1;0;1
3105;Gudrutis;Gandriukų;1485530468;Ne;8;0;2;10
3106;Gudrutis;Gandriukų;5508723821;Ne;15;1;0;16
3107;Gudrutis;Gandriukų;9044566825;Taip;0;1;11;12
3108;Gudrutis;Gandriukų;8774935740;Taip;0;8;0;8
3109;Gudrutis;Gandriukų;9784116399;Ne;15;0;1;16
3110;Gudrutis;"Saulės zuikučių";7934673005;Ne;12;0;0;12
3111;Gudrutis;"Saulės zuikučių";2199222671;Ne;0;7;2;9
3112;Gudrutis;"Saulės zuikučių";1587454709;Ne;2;2;0;4
3113;Gudrutis;"Saulės zuikučių";1670550212;Ne;0;4;1;5
3114;Gudrutis;"Saulės zuikučių";1225698076;Ne;0;0;1;1
3115;Gudrutis;"Saulės zuikučių";8500911420;Ne;0;2;1;3
3116;Gudrutis;"Saulės zuikučių";5408444872;Ne;0;2;6;8
3117;Gudrutis;"Saulės zuikučių";9041133527;Ne;0;2;0;2
3118;Gudrutis;"Saulės zuikučių";9697445037;Ne;0;2;0;2
3119;Gudrutis;"Saulės zuikučių";6846653547;Ne;4;0;1;5
3120;Gudrutis;"Saulės zuikučių";3281890659;Ne;4;0;0;4
3121;Gudrutis;"Saulės zuikučių";2291393238;Ne;4;0;3;7
3122;Gudrutis;"Saulės zuikučių";9752360809;Ne;0;5;0;5
3123;Gudrutis;"Saulės zuikučių";5585248878;Ne;0;5;0;5
3124;Gudrutis;"Saulės zuikučių";1384696362;Ne;0;10;2;12
3125;Gudrutis;"Saulės zuikučių";2666772437;Ne;2;0;2;4
3126;Gudrutis;"Saulės zuikučių";2994309084;Ne;5;1;0;6
3127;Gudrutis;"Saulės zuikučių";3743529726;Taip;7;0;1;8
3128;Gudrutis;Pelėdžiukų;2293472716;Ne;0;5;5;10
3129;Gudrutis;Pelėdžiukų;6835038962;Ne;0;0;4;4
3130;Gudrutis;Pelėdžiukų;2118727861;Ne;4;0;0;4
3131;Gudrutis;Pelėdžiukų;9701111916;Ne;0;19;1;20
3132;Gudrutis;Pelėdžiukų;1901358996;Ne;0;0;2;2
3133;Gudrutis;Pelėdžiukų;7664517480;Ne;6;0;0;6
3134;Gudrutis;Pelėdžiukų;9847597133;Ne;0;12;0;12
3135;Gudrutis;Pelėdžiukų;3646335609;Ne;0;0;13;13
3136;Gudrutis;Pelėdžiukų;7871991275;Ne;0;0;7;7
3137;Gudrutis;Pelėdžiukų;5580618896;Ne;0;0;6;6
3138;Gudrutis;Pelėdžiukų;2468434676;Ne;0;5;0;5
3139;Gudrutis;Pelėdžiukų;3625838131;Ne;0;1;0;1
3140;Gudrutis;Pelėdžiukų;2408038213;Ne;14;0;1;15
3141;Gudrutis;Pelėdžiukų;2764843216;Ne;0;1;0;1
3142;Gudrutis;Pelėdžiukų;7955353991;Ne;0;2;0;2
3143;Gudrutis;Pelėdžiukų;2118820249;Ne;0;0;1;1
3144;Gudrutis;BITUČIŲ;4193661251;Ne;0;11;0;11
3145;Gudrutis;BITUČIŲ;7443277768;Ne;4;1;0;5
3146;Gudrutis;BITUČIŲ;5574287734;Ne;0;0;3;3
3147;Gudrutis;BITUČIŲ;2431077357;Ne;0;2;0;2
3148;Gudrutis;BITUČIŲ;7116979528;Ne;0;2;0;2
3149;Gudrutis;BITUČIŲ;1228190677;Ne;0;0;2;2
3150;Gudrutis;BITUČIŲ;6700254479;Ne;20;0;0;20
3151;Gudrutis;BITUČIŲ;1693306014;Ne;0;0;4;4
3152;Gudrutis;BITUČIŲ;8398961969;Ne;0;2;1;3
3153;Gudrutis;BITUČIŲ;9841172472;Ne;0;2;1;3
3154;Gudrutis;BITUČIŲ;4945755164;Ne;4;0;0;4
3155;Gudrutis;BITUČIŲ;7773150642;Ne;2;0;1;3
3156;Gudrutis;BITUČIŲ;6198012431;Ne;2;1;0;3
3157;Gudrutis;Boružėlių;2497248749;Ne;0;0;1;1
3158;Gudrutis;Boružėlių;6284712576;Ne;0;0;1;1
3159;Gudrutis;Boružėlių;9096764346;Ne;0;4;0;4
3160;Gudrutis;Boružėlių;5306281458;Ne;0;0;5;5
3161;Gudrutis;Boružėlių;8783180638;Ne;0;0;5;5
3162;Gudrutis;Boružėlių;8525851058;Ne;0;9;0;9
3163;Gudrutis;Boružėlių;8080976400;Ne;6;0;4;10
3164;Gudrutis;Boružėlių;9808350750;Ne;0;2;0;2
3165;Gudrutis;Boružėlių;6101410750;Ne;0;1;2;3
3166;Gudrutis;Boružėlių;5710348070;Ne;20;0;0;20
3167;Gudrutis;Boružėlių;8843761360;Ne;20;0;0;20
3168;Gudrutis;Boružėlių;5590297232;Ne;10;1;0;11
3169;Gudrutis;Boružėlių;2145834885;Ne;0;0;18;18
3170;Gudrutis;Boružėlių;5093267385;Ne;3;4;2;9
3171;Gudrutis;Boružėlių;1364145110;Ne;1;3;2;6
3172;Gudrutis;Boružėlių;1737001982;Ne;1;2;1;4
3173;Gudrutis;Boružėlių;9200644104;Ne;0;0;2;2
3174;Gudrutis;Boružėlių;3797656483;Ne;0;0;2;2
3175;Gudrutis;Drugeliai;7930414623;Ne;1;1;1;3
3176;Gudrutis;Drugeliai;6458053920;Ne;0;1;0;1
3177;Gudrutis;Drugeliai;5498218329;Ne;8;0;0;8
3178;Gudrutis;Drugeliai;4600814480;Ne;7;0;0;7
3179;Gudrutis;Drugeliai;9454206104;Ne;0;2;1;3
3180;Gudrutis;Drugeliai;5054363773;Ne;10;0;0;10
3181;Gudrutis;Drugeliai;7531077386;Ne;0;12;0;12
3182;Gudrutis;Drugeliai;5931281687;Ne;0;12;1;13
3183;Gudrutis;Drugeliai;3264829331;Ne;4;1;0;5
3184;Gudrutis;Drugeliai;7143849852;Ne;19;0;0;19
3185;Gudrutis;Drugeliai;3760014407;Ne;0;7;0;7
3186;Gudrutis;Drugeliai;1588396018;Ne;6;0;3;9
3187;Gudrutis;Drugeliai;3316297441;Ne;0;0;9;9
3188;Gudrutis;Drugeliai;6307643172;Ne;0;0;4;4
3189;Gudrutis;Drugeliai;2256458624;Ne;10;0;0;10
3190;Gudrutis;Drugeliai;2278368966;Ne;2;1;8;11
3191;Gudrutis;Drugeliai;5911423362;Ne;7;0;0;7
3192;Gudrutis;Drugeliai;3000289515;Ne;5;2;0;7
3193;Gudrutis;Drugeliai;2784392885;Ne;0;10;0;10
3194;Gudrutis;Drugeliai;1170008457;Ne;5;0;1;6
3195;Jovarėlis;KIŠKUČIAI;7558562002;Ne;4;0;0;4
3196;Jovarėlis;DRUGELIAI;5420254689;Ne;6;0;0;6
3197;Jovarėlis;DRUGELIAI;5724777390;Ne;10;0;0;10
3198;Jovarėlis;DRUGELIAI;7579261984;Ne;7;0;0;7
3199;Jovarėlis;NYKŠTUKAI;5454098417;Ne;4;0;0;4
3200;Jovarėlis;NYKŠTUKAI;7301592301;Ne;4;0;0;4
3201;Jovarėlis;NYKŠTUKAI;7194183817;Ne;6;0;0;6
3202;Jovarėlis;BORUŽĖLĖS;6162652743;Ne;2;0;0;2
3203;Jovarėlis;BORUŽĖLĖS;4526606597;Ne;3;0;0;3
3204;Jovarėlis;BORUŽĖLĖS;6303503283;Ne;6;0;0;6
3205;Jovarėlis;OBUOLIUKAI;8470832744;Ne;1;0;0;1
3206;Jovarėlis;OBUOLIUKAI;3937838168;Ne;1;0;0;1
3207;Jovarėlis;OBUOLIUKAI;2126014566;Ne;4;0;0;4
3208;Jovarėlis;SKRUZDĖLIUKAI;1038855467;Ne;12;0;0;12
3209;Jovarėlis;SKRUZDĖLIUKAI;1392350648;Ne;7;0;0;7
3210;Jurginėlis;Ąžuoliukai;7309052653;Ne;0;22;0;22
3211;Jurginėlis;Ąžuoliukai;2501462080;Ne;1;6;0;7
3212;Jurginėlis;Ąžuoliukai;8571054905;Ne;6;0;0;6
3213;Jurginėlis;Ąžuoliukai;8969526123;Ne;0;0;2;2
3214;Jurginėlis;Ąžuoliukai;6168508647;Ne;14;0;4;18
3215;Jurginėlis;Ąžuoliukai;5861832676;Ne;4;0;0;4
3216;Jurginėlis;Ąžuoliukai;3933113321;Ne;0;15;0;15
3217;Jurginėlis;Ąžuoliukai;5861418459;Ne;0;10;0;10
3218;Jurginėlis;Ąžuoliukai;5869170503;Ne;0;10;1;11
3219;Jurginėlis;Ąžuoliukai;3562210465;Ne;5;0;0;5
3220;Jurginėlis;Ąžuoliukai;6202225321;Ne;7;1;0;8
3221;Jurginėlis;Ąžuoliukai;7081618073;Ne;0;2;0;2
3222;Jurginėlis;Ąžuoliukai;6851855147;Ne;2;0;3;5
3223;Jurginėlis;Ąžuoliukai;9029587175;Ne;3;5;6;14
3224;Jurginėlis;Ąžuoliukai;9889620429;Ne;14;0;1;15
3225;Jurginėlis;Ąžuoliukai;3324811458;Ne;0;0;1;1
3226;Jurginėlis;Ąžuoliukai;6153432639;Ne;10;0;0;10
3227;Jurginėlis;Ąžuoliukai;9850874714;Ne;0;0;5;5
3228;Jurginėlis;Ąžuoliukai;8174251359;Ne;4;1;7;12
3229;Jurginėlis;Ąžuoliukai;2447025385;Ne;8;10;2;20
3230;Jurginėlis;Ąžuoliukai;5313627252;Ne;5;0;3;8
3231;Jurginėlis;Žiogeliai;8159210242;Ne;5;18;0;23
3232;Jurginėlis;Žiogeliai;7251598691;Ne;2;4;0;6
3233;Jurginėlis;Žiogeliai;3083045137;Ne;10;17;0;27
3234;Jurginėlis;Žiogeliai;6906225772;Ne;5;9;0;14
3235;Jurginėlis;Žiogeliai;7010130915;Ne;0;9;0;9
3236;Jurginėlis;Žiogeliai;7907096012;Ne;0;17;0;17
3237;Jurginėlis;Žiogeliai;7250246853;Ne;0;23;0;23
3238;Jurginėlis;Žiogeliai;5160581631;Ne;0;8;0;8
3239;Jurginėlis;Žiogeliai;5037980414;Ne;0;1;0;1
3240;Jurginėlis;Žiogeliai;7300018733;Ne;0;2;0;2
3241;Jurginėlis;Žiogeliai;4674128568;Ne;0;25;0;25
3242;Jurginėlis;Žiogeliai;9305884152;Ne;0;18;0;18
3243;Jurginėlis;Žiogeliai;9716328349;Ne;0;32;0;32
3244;Jurginėlis;Žiogeliai;4441183185;Ne;12;2;0;14
3245;Jurginėlis;Žiogeliai;4502564783;Ne;10;5;0;15
3246;Jurginėlis;Žiogeliai;1937927553;Ne;5;1;0;6
3247;Jurginėlis;Žiogeliai;7527178332;Ne;0;5;0;5
3248;Jurginėlis;Žiogeliai;4682125116;Ne;18;7;0;25
3249;Jurginėlis;Žiogeliai;3920971621;Ne;9;3;0;12
3250;Jurginėlis;Pelėdžiukų;9882919290;Ne;0;2;0;2
3251;Jurginėlis;Pelėdžiukų;5984893389;Ne;0;11;0;11
3252;Jurginėlis;Pelėdžiukų;3079495897;Ne;6;4;0;10
3253;Jurginėlis;Pelėdžiukų;8727844649;Ne;10;0;12;22
3254;Jurginėlis;Pelėdžiukų;1455749921;Ne;0;10;0;10
3255;Jurginėlis;Pelėdžiukų;7809274980;Ne;0;5;0;5
3256;Jurginėlis;Pelėdžiukų;2417314519;Ne;5;1;0;6
3257;Jurginėlis;Pelėdžiukų;6968528293;Ne;6;0;0;6
3258;Jurginėlis;Pelėdžiukų;4292932046;Ne;1;0;0;1
3259;Jurginėlis;Pelėdžiukų;9507571301;Ne;10;0;0;10
3260;Jurginėlis;Pelėdžiukų;8779807396;Ne;6;0;0;6
3261;Jurginėlis;Pelėdžiukų;8443412187;Ne;0;8;0;8
3262;Jurginėlis;Pelėdžiukų;4967548277;Ne;0;9;0;9
3263;Jurginėlis;Pelėdžiukų;2925253653;Ne;2;6;0;8
3264;Jurginėlis;Pelėdžiukų;1340689348;Ne;0;6;0;6
3265;Jurginėlis;Pelėdžiukų;2221708420;Ne;0;1;0;1
3266;Jurginėlis;Pelėdžiukų;6181547354;Ne;22;0;0;22
3267;Jurginėlis;Pelėdžiukų;2490875633;Ne;5;0;0;5
3268;Jurginėlis;Pelėdžiukų;9760394658;Ne;0;1;4;5
3269;Jurginėlis;Pelėdžiukų;3786379532;Ne;22;0;0;22
3270;Jurginėlis;Boružėlių;4295285885;Ne;22;0;0;22
3271;Jurginėlis;Boružėlių;8920304044;Ne;0;2;0;2
3272;Jurginėlis;Boružėlių;3027573572;Ne;18;0;0;18
3273;Jurginėlis;Boružėlių;8338173095;Taip;6;3;0;9
3274;Jurginėlis;Boružėlių;1758862051;Ne;0;1;0;1
3275;Jurginėlis;Boružėlių;1467200002;Ne;1;4;0;5
3276;Jurginėlis;Boružėlių;4851923549;Ne;0;8;0;8
3277;Jurginėlis;Boružėlių;6111863896;Ne;0;13;0;13
3278;Jurginėlis;Boružėlių;1701720412;Ne;12;1;0;13
3279;Jurginėlis;Boružėlių;1563317396;Ne;0;2;0;2
3280;Jurginėlis;Boružėlių;2133447073;Ne;0;1;0;1
3281;Jurginėlis;Boružėlių;8784076886;Ne;0;2;0;2
3282;Jurginėlis;Boružėlių;2446630485;Ne;0;9;0;9
3283;Jurginėlis;Boružėlių;1829089083;Ne;0;1;0;1
3284;Jurginėlis;Boružėlių;1361108271;Ne;0;1;0;1
3285;Jurginėlis;Boružėlių;5386710069;Ne;0;5;0;5
3286;Jurginėlis;Boružėlių;8972814655;Ne;0;1;0;1
3287;Jurginėlis;Boružėlių;4852619394;Ne;0;13;0;13
3288;Jurginėlis;Boružėlių;7753784918;Ne;0;17;0;17
3289;Jurginėlis;Bitučių;9589394406;Ne;0;0;1;1
3290;Jurginėlis;Bitučių;3708774681;Ne;5;0;8;13
3291;Jurginėlis;Bitučių;6413324051;Ne;5;4;0;9
3292;Jurginėlis;Bitučių;2639125463;Ne;0;0;3;3
3293;Jurginėlis;Bitučių;1787311340;Ne;0;11;0;11
3294;Jurginėlis;Bitučių;7297672386;Ne;2;0;1;3
3295;Jurginėlis;Bitučių;1586599624;Ne;0;0;2;2
3296;Jurginėlis;Bitučių;2710889915;Ne;0;1;0;1
3297;Jurginėlis;Bitučių;1983924909;Ne;0;8;0;8
3298;Jurginėlis;Bitučių;1175441410;Ne;0;1;0;1
3299;Jurginėlis;Bitučių;4806248290;Ne;0;13;0;13
3300;Jurginėlis;Bitučių;9646318532;Ne;0;2;0;2
3301;Jurginėlis;Bitučių;8227660508;Ne;0;0;3;3
3302;Jurginėlis;Bitučių;77480957625;Ne;0;0;1;1
3303;Jurginėlis;Bitučių;1547101731;Ne;0;0;1;1
3304;Jurginėlis;Bitučių;2624313807;Ne;1;0;0;1
3305;Jurginėlis;Bitučių;7928799065;Ne;0;3;0;3
3306;Jurginėlis;Bitučių;3018576350;Ne;5;0;6;11
3307;Jurginėlis;Skruzdeliukų;1351306981;Ne;0;6;0;6
3308;Jurginėlis;Skruzdeliukų;9146039217;Ne;5;1;0;6
3309;Jurginėlis;Skruzdeliukų;3558752347;Ne;5;3;0;8
3310;Jurginėlis;Skruzdeliukų;5734506036;Ne;0;2;0;2
3311;Jurginėlis;Skruzdeliukų;3699180485;Ne;1;13;0;14
3312;Jurginėlis;Skruzdeliukų;1634502874;Ne;5;1;3;9
3313;Jurginėlis;Skruzdeliukų;1763849354;Ne;19;0;0;19
3314;Jurginėlis;Skruzdeliukų;4944292549;Ne;0;6;0;6
3315;Jurginėlis;Skruzdeliukų;9506129699;Ne;10;0;0;10
3316;Jurginėlis;Skruzdeliukų;9550110246;Ne;5;4;0;9
3317;Jurginėlis;Skruzdeliukų;3822916547;Ne;12;2;1;15
3318;Jurginėlis;Skruzdeliukų;1204999684;Ne;18;0;0;18
3319;Jurginėlis;Skruzdeliukų;9937405742;Ne;8;0;2;10
3320;Jurginėlis;Skruzdeliukų;1726968598;Ne;0;17;0;17
3321;Jurginėlis;Skruzdeliukų;2332714713;Ne;10;3;0;13
3322;Jurginėlis;Skruzdeliukų;9961083854;Ne;0;5;0;5
3323;Jurginėlis;Skruzdeliukų;6542567172;Ne;0;9;0;9
3324;Jurginėlis;Drugelių;2025403481;Ne;0;0;3;3
3325;Jurginėlis;Drugelių;9065349248;Ne;0;2;2;4
3326;Jurginėlis;Drugelių;8341951659;Ne;5;4;0;9
3327;Jurginėlis;Drugelių;7795042485;Taip;18;0;0;18
3328;Jurginėlis;Drugelių;5138832895;Ne;5;0;0;5
3329;Jurginėlis;Drugelių;5751977493;Taip;4;0;2;6
3330;Jurginėlis;Drugelių;6068645621;Taip;7;4;0;11
3331;Jurginėlis;Drugelių;4276237094;Ne;0;3;2;5
3332;Jurginėlis;Drugelių;2689492215;Ne;0;5;1;6
3333;Jurginėlis;Drugelių;1208882528;Ne;5;0;0;5
3334;Jurginėlis;Drugelių;5874949368;Ne;18;0;0;18
3335;Jurginėlis;Drugelių;7349309693;Ne;0;5;0;5
3336;Jurginėlis;Drugelių;3063084253;Ne;22;0;0;22
3337;Jurginėlis;Drugelių;7409019574;Ne;2;4;0;6
3338;Jurginėlis;Drugelių;5928303681;Ne;0;22;0;22
3339;Jurginėlis;Žibučių;4979618298;Ne;10;0;0;10
3340;Jurginėlis;Žibučių;6636147085;Ne;6;6;0;12
3341;Jurginėlis;Žibučių;1438159631;Ne;0;3;0;3
3342;Jurginėlis;Žibučių;1336429135;Ne;6;0;0;6
3343;Jurginėlis;Žibučių;6948834218;Ne;17;3;0;20
3344;Jurginėlis;Žibučių;7721612113;Ne;5;1;1;7
3345;Jurginėlis;Žibučių;6988386438;Ne;2;0;0;2
3346;Jurginėlis;Žibučių;8111158692;Ne;16;1;0;17
3347;Jurginėlis;Žibučių;5936508522;Taip;7;17;0;24
3348;Jurginėlis;Žibučių;6717892969;Ne;5;13;3;21
3349;Jurginėlis;Žibučių;7977676733;Ne;17;10;0;27
3350;Jurginėlis;Žibučių;7530846375;Ne;0;6;0;6
3351;Jurginėlis;Žibučių;3899526893;Ne;0;15;0;15
3352;Jurginėlis;Žibučių;3861311860;Ne;11;11;0;22
3353;Jurginėlis;Žibučių;1263601087;Ne;4;1;0;5
3354;Jurginėlis;Žibučių;5549766339;Ne;0;10;0;10
3355;Jurginėlis;Žibučių;4429780802;Ne;0;7;0;7
3356;Jurginėlis;Žibučių;8968718021;Ne;18;3;0;21
3357;Jurginėlis;Žibučių;2782553941;Ne;12;0;0;12
3358;Jurginėlis;Žibučių;6259461257;Ne;3;1;0;4
3359;Jurginėlis;Žibučių;7252041334;Ne;2;1;2;5
3360;Jurginėlis;Zuikučių;6587382160;Ne;11;0;1;12
3361;Jurginėlis;Zuikučių;4763313715;Ne;3;1;2;6
3362;Jurginėlis;Zuikučių;6197396872;Ne;0;0;2;2
3363;Jurginėlis;Zuikučių;8937404520;Ne;0;0;3;3
3364;Jurginėlis;Zuikučių;2820249307;Ne;0;0;1;1
3365;Jurginėlis;Zuikučių;8823175066;Ne;0;2;0;2
3366;Jurginėlis;Zuikučių;8161347781;Ne;0;5;0;5
3367;Jurginėlis;Zuikučių;4113264904;Ne;0;0;1;1
3368;Jurginėlis;Zuikučių;8117563141;Ne;0;2;6;8
3369;Jurginėlis;Zuikučių;5652597514;Ne;5;0;2;7
3370;Jurginėlis;Zuikučių;6341896288;Ne;10;0;0;10
3371;Jurginėlis;Viščiukų;7193314762;Ne;0;11;0;11
3372;Jurginėlis;Viščiukų;6306274502;Taip;5;0;3;8
3373;Jurginėlis;Viščiukų;5474358669;Ne;0;22;0;22
3374;Jurginėlis;Viščiukų;3741447134;Ne;9;0;0;9
3375;Jurginėlis;Viščiukų;2595002682;Ne;0;0;2;2
3376;Jurginėlis;Viščiukų;5866358319;Taip;10;0;3;13
3377;Jurginėlis;Viščiukų;4648875524;Ne;7;1;0;8
3378;Jurginėlis;Viščiukų;1598578487;Ne;8;6;0;14
3379;Jurginėlis;Viščiukų;4644476606;Ne;7;0;1;8
3380;Jurginėlis;Viščiukų;3622183526;Ne;8;0;0;8
3381;Jurginėlis;Viščiukų;3230200231;Ne;0;2;0;2
3382;Jurginėlis;Viščiukų;7636442845;Ne;0;0;6;6
3383;Jurginėlis;Viščiukų;4617952912;Ne;5;0;1;6
3384;Jurginėlis;Viščiukų;9603380131;Ne;10;0;0;10
3385;Jurginėlis;Meškiukų;8844614653;Ne;0;8;0;8
3386;Jurginėlis;Meškiukų;1303323955;Ne;3;0;3;6
3387;Jurginėlis;Meškiukų;4466955830;Ne;0;1;2;3
3388;Jurginėlis;Meškiukų;6932501634;Ne;0;0;1;1
3389;Jurginėlis;Meškiukų;2248773321;Ne;0;0;2;2
3390;Jurginėlis;Meškiukų;3675820817;Ne;0;10;0;10
3391;Jurginėlis;Meškiukų;6285599044;Ne;18;0;0;18
3392;Jurginėlis;Meškiukų;5043815909;Ne;0;6;0;6
3393;Jurginėlis;Meškiukų;2982526236;Ne;2;2;0;4
3394;Jurginėlis;Meškiukų;4233910766;Ne;8;1;0;9
3395;Jurginėlis;Meškiukų;1537710974;Ne;8;3;0;11
3396;Jurginėlis;Meškiukų;6594025023;Ne;0;8;0;8
3397;Jurginėlis;Meškiukų;6648657850;Ne;9;0;0;9
3398;Jurginėlis;Meškiukų;6856023398;Ne;0;0;3;3
3399;Jurginėlis;Meškiukų;6124147401;Ne;0;0;1;1
3400;Jurginėlis;Gandriukų;8017976529;Ne;15;0;0;15
3401;Jurginėlis;Gandriukų;3530906368;Ne;0;10;1;11
3402;Jurginėlis;Gandriukų;6806704355;Ne;15;0;0;15
3403;Jurginėlis;Gandriukų;9288380246;Ne;0;0;3;3
3404;Jurginėlis;Gandriukų;2548920722;Ne;3;6;3;12
3405;Jurginėlis;Gandriukų;7288921301;Ne;3;1;0;4
3406;Jurginėlis;Gandriukų;4827340942;Ne;5;0;2;7
3407;Jurginėlis;Gandriukų;4463258777;Ne;5;5;1;11
3408;Jurginėlis;Gandriukų;1414888906;Taip;0;11;4;15
3409;Jurginėlis;Gandriukų;2225892248;Ne;0;1;6;7
3410;Jurginėlis;Gandriukų;6579565337;Ne;2;0;2;4
3411;Jurginėlis;Gandriukų;7990015623;Ne;0;8;0;8
3412;Jurginėlis;Gandriukų;4158502752;Ne;0;6;0;6
3413;Jurginėlis;Gandriukų;2214809186;Ne;0;7;0;7
3414;Jurginėlis;Gandriukų;3284464951;Ne;14;9;0;23
3415;Jurginėlis;Gandriukų;2263818210;Ne;0;9;0;9
3416;Jurginėlis;Gandriukų;3091019969;Taip;7;5;0;12
3417;Jurginėlis;Gandriukų;2837099502;Ne;0;0;1;1
3418;Jurginėlis;Gandriukų;3462969423;Ne;0;6;0;6
3419;Jurginėlis;Gandriukų;7486778826;Ne;4;1;0;5
3420;Jurginėlis;Gandriukų;5242359650;Taip;0;11;0;11
3421;Jurginėlis;Gandriukų;8144038013;Ne;0;3;0;3
3422;Karuselė;PAGRANDUKAS;1621482372;Ne;0;11;0;11
3423;Karuselė;PAGRANDUKAS;3330374479;Ne;10;0;0;10
3424;Karuselė;PAGRANDUKAS;6183785840;Ne;0;3;0;3
3425;Karuselė;PAGRANDUKAS;3984262482;Ne;11;0;1;12
3426;Karuselė;PAGRANDUKAS;9130534156;Ne;0;0;2;2
3427;Karuselė;PAGRANDUKAS;3660843696;Ne;0;1;0;1
3428;Karuselė;PAGRANDUKAS;5132581245;Ne;0;2;0;2
3429;Karuselė;PAGRANDUKAS;7393434659;Ne;0;2;0;2
3430;Karuselė;PAGRANDUKAS;5695697634;Ne;0;3;0;3
3431;Karuselė;PAGRANDUKAS;3429495073;Ne;0;2;0;2
3432;Karuselė;PAGRANDUKAS;6252613489;Ne;20;0;0;20
3433;Karuselė;PAGRANDUKAS;5595950213;Ne;3;1;0;4
3434;Karuselė;PAGRANDUKAS;6004882312;Ne;0;16;0;16
3435;Karuselė;PAGRANDUKAS;6856800484;Ne;0;0;2;2
3436;Karuselė;PAGRANDUKAS;3972815393;Ne;0;9;0;9
3437;Karuselė;PAGRANDUKAS;8157193503;Ne;6;5;0;11
3438;Karuselė;PAGRANDUKAS;9651192437;Ne;0;0;3;3
3439;Karuselė;NYKŠTUKAS;4910899296;Ne;6;2;0;8
3440;Karuselė;NYKŠTUKAS;4966362343;Ne;11;0;0;11
3441;Karuselė;NYKŠTUKAS;9997776739;Ne;6;0;2;8
3442;Karuselė;NYKŠTUKAS;4445214427;Ne;0;10;0;10
3443;Karuselė;NYKŠTUKAS;9354431582;Ne;0;2;0;2
3444;Karuselė;NYKŠTUKAS;5216815933;Ne;5;2;2;9
3445;Karuselė;NYKŠTUKAS;3418266059;Ne;0;2;0;2
3446;Karuselė;NYKŠTUKAS;9654804545;Ne;0;12;0;12
3447;Karuselė;NYKŠTUKAS;6581798125;Ne;3;1;0;4
3448;Karuselė;NYKŠTUKAS;1486577955;Ne;14;1;0;15
3449;Karuselė;NYKŠTUKAS;8007341411;Ne;0;7;0;7
3450;Karuselė;NYKŠTUKAS;4363388969;Ne;18;0;0;18
3451;Karuselė;NYKŠTUKAS;9243932017;Ne;0;14;0;14
3452;Karuselė;NYKŠTUKAS;5986973796;Ne;3;0;0;3
3453;Karuselė;NYKŠTUKAS;4856589410;Ne;0;2;1;3
3454;Karuselė;NYKŠTUKAS;9999461542;Ne;13;2;0;15
3455;Karuselė;NYKŠTUKAS;9385698812;Ne;0;2;0;2
3456;Karuselė;NYKŠTUKAS;5328762735;Ne;4;4;0;8
3457;Karuselė;BITUTĖ;1593728369;Ne;5;1;0;6
3458;Karuselė;BITUTĖ;2426822679;Ne;0;3;0;3
3459;Karuselė;BITUTĖ;1205498782;Ne;0;3;0;3
3460;Karuselė;BITUTĖ;7824913364;Ne;8;1;0;9
3461;Karuselė;BITUTĖ;5651238035;Ne;4;1;0;5
3462;Karuselė;BITUTĖ;8175498192;Ne;8;2;1;11
3463;Karuselė;BITUTĖ;5951045233;Ne;2;2;1;5
3464;Karuselė;BITUTĖ;1211005513;Ne;0;14;0;14
3465;Karuselė;BITUTĖ;2160071272;Ne;0;5;0;5
3466;Karuselė;BITUTĖ;1691769088;Ne;0;3;0;3
3467;Karuselė;BITUTĖ;7167895711;Ne;8;2;0;10
3468;Karuselė;BITUTĖ;3116403256;Ne;0;2;0;2
3469;Karuselė;BITUTĖ;7977133699;Taip;0;1;0;1
3470;Karuselė;BITUTĖ;6165548450;Taip;0;5;0;5
3471;Karuselė;BITUTĖ;3049506194;Ne;10;0;0;10
3472;Karuselė;BITUTĖ;7733032142;Ne;0;6;0;6
3473;Karuselė;BORUŽĖLĖ;1705790474;Ne;0;2;2;4
3474;Karuselė;BORUŽĖLĖ;1311907441;Ne;0;6;0;6
3475;Karuselė;BORUŽĖLĖ;6313010762;Ne;7;1;1;9
3476;Karuselė;BORUŽĖLĖ;37349219339;Ne;0;5;0;5
3477;Karuselė;BORUŽĖLĖ;6811862463;Ne;0;7;0;7
3478;Karuselė;BORUŽĖLĖ;5471989295;Ne;10;2;0;12
3479;Karuselė;BORUŽĖLĖ;9753876554;Ne;0;0;4;4
3480;Karuselė;BORUŽĖLĖ;8717484092;Ne;0;6;0;6
3481;Karuselė;BORUŽĖLĖ;1994682683;Ne;12;0;0;12
3482;Karuselė;BORUŽĖLĖ;5632697184;Ne;0;1;1;2
3483;Karuselė;BORUŽĖLĖ;2247913568;Ne;7;4;0;11
3484;Karuselė;BORUŽĖLĖ;4262640017;Ne;0;1;1;2
3485;Karuselė;BORUŽĖLĖ;8406462155;Ne;6;1;0;7
3486;Karuselė;BORUŽĖLĖ;6495631086;Ne;0;2;0;2
3487;Karuselė;BORUŽĖLĖ;3389843421;Ne;0;4;0;4
3488;Karuselė;BORUŽĖLĖ;4818655110;Ne;5;0;0;5
3489;Karuselė;UOGELĖ;9805481603;Ne;3;4;0;7
3490;Karuselė;UOGELĖ;8182071103;Ne;8;2;0;10
3491;Karuselė;UOGELĖ;9992989896;Ne;0;1;0;1
3492;Karuselė;UOGELĖ;8316147204;Ne;11;0;0;11
3493;Karuselė;UOGELĖ;5504719953;Ne;0;15;0;15
3494;Karuselė;UOGELĖ;4199597984;Ne;0;4;0;4
3495;Karuselė;UOGELĖ;2383023280;Ne;0;7;0;7
3496;Karuselė;UOGELĖ;1575408822;Ne;6;5;0;11
3497;Karuselė;UOGELĖ;3917113787;Ne;8;2;0;10
3498;Karuselė;UOGELĖ;4638918427;Ne;0;1;0;1
3499;Karuselė;UOGELĖ;3615957761;Ne;5;3;0;8
3500;Karuselė;UOGELĖ;1891147022;Ne;0;0;10;10
3501;Karuselė;UOGELĖ;9389017016;Ne;0;2;0;2
3502;Karuselė;UOGELĖ;3872322338;Ne;0;2;4;6
3503;Karuselė;UOGELĖ;3963576314;Ne;0;0;12;12
3504;Karuselė;GINTARĖLIS;3904453423;Ne;0;13;3;16
3505;Karuselė;GINTARĖLIS;7489136297;Ne;0;2;0;2
3506;Karuselė;GINTARĖLIS;3534074990;Ne;8;10;0;18
3507;Karuselė;GINTARĖLIS;7540323186;Ne;5;0;2;7
3508;Karuselė;GINTARĖLIS;1019322763;Ne;0;5;6;11
3509;Karuselė;GINTARĖLIS;8481143199;Ne;0;0;6;6
3510;Karuselė;GINTARĖLIS;3157893936;Ne;4;1;1;6
3511;Karuselė;GINTARĖLIS;8409412605;Ne;9;1;3;13
3512;Karuselė;GINTARĖLIS;3136606610;Ne;0;17;1;18
3513;Karuselė;GINTARĖLIS;7599328323;Ne;0;0;2;2
3514;Karuselė;GINTARĖLIS;2688863117;Ne;0;2;5;7
3515;Karuselė;GINTARĖLIS;7439791054;Ne;10;0;1;11
3516;Karuselė;GINTARĖLIS;3696384277;Ne;0;0;1;1
3517;Karuselė;GINTARĖLIS;2945027875;Ne;0;0;1;1
3518;Karuselė;GINTARĖLIS;8855096080;Ne;0;0;1;1
3519;Karuselė;GINTARĖLIS;9116238924;Ne;7;0;0;7
3520;Karuselė;GINTARĖLIS;6433987745;Ne;2;0;6;8
3521;Karuselė;GINTARĖLIS;9763326660;Ne;5;0;0;5
3522;Karuselė;GINTARĖLIS;6232570825;Ne;0;3;1;4
3523;Karuselė;GINTARĖLIS;3460470459;Ne;0;3;0;3
3524;Karuselė;SAULUTĖ;5627583683;Ne;20;0;0;20
3525;Karuselė;SAULUTĖ;2242659064;Ne;6;6;0;12
3526;Karuselė;SAULUTĖ;7814525717;Ne;0;1;0;1
3527;Karuselė;SAULUTĖ;9996567374;Ne;0;3;0;3
3528;Karuselė;SAULUTĖ;9400171357;Ne;5;1;0;6
3529;Karuselė;SAULUTĖ;9656723409;Ne;0;1;0;1
3530;Karuselė;SAULUTĖ;5766390337;Ne;7;0;0;7
3531;Karuselė;SAULUTĖ;2269840705;Ne;6;1;0;7
3532;Karuselė;SAULUTĖ;3149575456;Ne;0;2;1;3
3533;Karuselė;SAULUTĖ;5640656442;Ne;0;5;2;7
3534;Karuselė;SAULUTĖ;9451789237;Ne;18;0;0;18
3535;Karuselė;SAULUTĖ;9450841251;Ne;7;1;4;12
3536;Karuselė;SAULUTĖ;6338379641;Ne;7;0;0;7
3537;Karuselė;SAULUTĖ;8830559511;Ne;0;0;6;6
3538;Karuselė;SAULUTĖ;3228100488;Ne;2;0;2;4
3539;Karuselė;TIGRIUKAS;8946147763;Ne;6;6;0;12
3540;Karuselė;TIGRIUKAS;8076851284;Ne;0;1;0;1
3541;Karuselė;TIGRIUKAS;4426462711;Ne;0;3;0;3
3542;Karuselė;TIGRIUKAS;9484773068;Ne;4;1;1;6
3543;Karuselė;TIGRIUKAS;9561892809;Ne;8;2;0;10
3544;Karuselė;TIGRIUKAS;9726299722;Ne;0;3;0;3
3545;Karuselė;TIGRIUKAS;1576201225;Ne;0;10;0;10
3546;Karuselė;TIGRIUKAS;9344514262;Ne;8;0;1;9
3547;Karuselė;TIGRIUKAS;7131255599;Ne;11;3;0;14
3548;Karuselė;TIGRIUKAS;4180604225;Ne;11;3;0;14
3549;Karuselė;TIGRIUKAS;2397938004;Ne;0;1;0;1
3550;Karuselė;TIGRIUKAS;3605966015;Ne;2;0;0;2
3551;Karuselė;TIGRIUKAS;9252093125;Ne;12;2;0;14
3552;Karuselė;TIGRIUKAS;5176597751;Ne;0;1;0;1
3553;Karuselė;TIGRIUKAS;6656808100;Ne;4;0;0;4
3554;Karuselė;VAIVORYKŠTĖ;1289442716;Ne;5;0;6;11
3555;Karuselė;VAIVORYKŠTĖ;9855242602;Ne;0;0;1;1
3556;Karuselė;VAIVORYKŠTĖ;6546648346;Ne;0;17;0;17
3557;Karuselė;VAIVORYKŠTĖ;8063412271;Ne;10;0;0;10
3558;Karuselė;VAIVORYKŠTĖ;9408843254;Ne;0;1;4;5
3559;Karuselė;VAIVORYKŠTĖ;3514315636;Ne;5;0;0;5
3560;Karuselė;VAIVORYKŠTĖ;8085919723;Ne;5;0;0;5
3561;Karuselė;VAIVORYKŠTĖ;5444753290;Ne;0;10;0;10
3562;Karuselė;VAIVORYKŠTĖ;1581504806;Ne;12;0;0;12
3563;Karuselė;VAIVORYKŠTĖ;2215367063;Ne;2;5;0;7
3564;Karuselė;VAIVORYKŠTĖ;6424622497;Ne;7;1;2;10
3565;Karuselė;VAIVORYKŠTĖ;5855430678;Ne;0;4;0;4
3566;Karuselė;VAIVORYKŠTĖ;5128774216;Ne;8;0;0;8
3567;Karuselė;VAIVORYKŠTĖ;1604997207;Ne;0;1;0;1
3568;Karuselė;VAIVORYKŠTĖ;2757263085;Ne;5;1;1;7
3569;Karuselė;VAIVORYKŠTĖ;4110024673;Ne;0;9;0;9
3570;Karuselė;VAIVORYKŠTĖ;9400856559;Ne;0;9;0;9
3571;Karuselė;VAIVORYKŠTĖ;1083786182;Ne;0;9;0;9
3572;Karuselė;VAIVORYKŠTĖ;5998868204;Ne;6;1;2;9
3573;Karuselė;VAIVORYKŠTĖ;6734936247;Ne;10;3;0;13
3574;Karuselė;VAIVORYKŠTĖ;3082636224;Ne;7;6;0;13
3575;Karuselė;VAIVORYKŠTĖ;4749086136;Ne;7;0;0;7
3576;Karuselė;"AUKSINĖ ŽUVELĖ";2993499990;Ne;0;0;3;3
3577;Karuselė;"AUKSINĖ ŽUVELĖ";6341570221;Ne;0;0;5;5
3578;Karuselė;"AUKSINĖ ŽUVELĖ";2135332292;Ne;10;0;0;10
3579;Karuselė;"AUKSINĖ ŽUVELĖ";8441520423;Ne;4;0;0;4
3580;Karuselė;"AUKSINĖ ŽUVELĖ";9463553056;Ne;0;13;0;13
3581;Karuselė;"AUKSINĖ ŽUVELĖ";4566201460;Ne;17;5;0;22
3582;Karuselė;"AUKSINĖ ŽUVELĖ";3551143062;Ne;5;1;0;6
3583;Karuselė;"AUKSINĖ ŽUVELĖ";8257771271;Ne;0;7;0;7
3584;Karuselė;"AUKSINĖ ŽUVELĖ";7749015193;Ne;0;15;0;15
3585;Karuselė;"AUKSINĖ ŽUVELĖ";3075592618;Ne;0;0;7;7
3586;Karuselė;"AUKSINĖ ŽUVELĖ";2450390957;Ne;0;2;0;2
3587;Karuselė;"AUKSINĖ ŽUVELĖ";4871960780;Ne;7;0;4;11
3588;Karuselė;RAMUNĖ;4302662341;Ne;7;14;0;21
3589;Karuselė;RAMUNĖ;8474027736;Ne;0;11;0;11
3590;Karuselė;RAMUNĖ;9394220081;Ne;0;2;2;4
3591;Karuselė;RAMUNĖ;7535451590;Ne;7;8;0;15
3592;Karuselė;RAMUNĖ;4865727149;Ne;9;0;0;9
3593;Karuselė;RAMUNĖ;2842034472;Ne;0;0;1;1
3594;Karuselė;RAMUNĖ;8531556390;Ne;0;1;0;1
3595;Karuselė;RAMUNĖ;8952114853;Ne;0;2;4;6
3596;Karuselė;RAMUNĖ;4757820179;Ne;0;2;3;5
3597;Karuselė;RAMUNĖ;9649615834;Ne;9;0;3;12
3598;Karuselė;RAMUNĖ;3885475525;Ne;22;0;0;22
3599;Karuselė;RAMUNĖ;6678283260;Ne;0;1;0;1
3600;Karuselė;RAMUNĖ;4196250786;Ne;4;6;0;10
3601;Karuselė;VILKELIS;1412890120;Ne;0;13;0;13
3602;Karuselė;VILKELIS;4951249625;Ne;9;0;0;9
3603;Karuselė;VILKELIS;5135054911;Ne;2;0;0;2
3604;Karuselė;VILKELIS;4130693235;Ne;9;6;2;17
3605;Karuselė;VILKELIS;8012963667;Ne;6;0;0;6
3606;Karuselė;VILKELIS;9340167973;Ne;0;6;0;6
3607;Karuselė;VILKELIS;9985033530;Ne;5;0;0;5
3608;Karuselė;VILKELIS;6826455161;Ne;0;0;1;1
3609;Karuselė;VILKELIS;3661917922;Ne;0;0;5;5
3610;Karuselė;VILKELIS;4211688032;Ne;0;10;0;10
3611;Karuselė;VILKELIS;2727440190;Ne;0;0;3;3
3612;Karuselė;VILKELIS;9304912028;Ne;0;1;0;1
3613;Karuselė;VILKELIS;5802996641;Taip;0;9;3;12
3614;Karuselė;VILKELIS;2306922755;Ne;0;15;0;15
3615;Karuselė;VILKELIS;4325959483;Ne;0;7;0;7
3616;Karuselė;VILKELIS;3271464159;Taip;12;1;0;13
3617;Karuselė;VILKELIS;6062361348;Ne;0;0;2;2
3618;Karuselė;VILKELIS;7501323454;Ne;0;1;4;5
3619;Karuselė;VILKELIS;6785226197;Ne;0;5;0;5
3620;Kaštonas;NYKŠTUKAI;7703842464;Ne;4;0;4;8
3621;Kaštonas;NYKŠTUKAI;1262404954;Ne;0;10;0;10
3622;Kaštonas;NYKŠTUKAI;6254250706;Ne;0;10;0;10
3623;Kaštonas;NYKŠTUKAI;8145965849;Ne;1;0;0;1
3624;Kaštonas;NYKŠTUKAI;8867446698;Ne;0;6;1;7
3625;Kaštonas;NYKŠTUKAI;8775608339;Ne;5;5;0;10
3626;Kaštonas;NYKŠTUKAI;6934262510;Ne;0;9;0;9
3627;Kaštonas;NYKŠTUKAI;6589898580;Ne;3;1;8;12
3628;Kaštonas;NYKŠTUKAI;4824511567;Ne;0;1;0;1
3629;Kaštonas;NYKŠTUKAI;4384907654;Ne;19;0;0;19
3630;Kaštonas;NYKŠTUKAI;3961661158;Ne;0;11;0;11
3631;Kaštonas;NYKŠTUKAI;8318869054;Ne;14;0;0;14
3632;Kaštonas;NYKŠTUKAI;2434765663;Ne;5;1;0;6
3633;Kaštonas;NYKŠTUKAI;2178971789;Ne;8;0;0;8
3634;Kaštonas;NYKŠTUKAI;4444087861;Ne;9;0;0;9
3635;Kaštonas;NYKŠTUKAI;9379171183;Ne;4;0;4;8
3636;Kaštonas;NYKŠTUKAI;9014726465;Ne;12;2;0;14
3637;Kaštonas;NYKŠTUKAI;2361839733;Ne;14;0;0;14
3638;Kaštonas;NYKŠTUKAI;3383390078;Ne;0;17;0;17
3639;Kaštonas;DRUGELIAI;8486955652;Ne;10;11;0;21
3640;Kaštonas;DRUGELIAI;2106924435;Ne;8;3;0;11
3641;Kaštonas;DRUGELIAI;8483888152;Ne;0;2;0;2
3642;Kaštonas;DRUGELIAI;7408901858;Ne;4;18;0;22
3643;Kaštonas;DRUGELIAI;5099098185;Ne;0;1;0;1
3644;Kaštonas;DRUGELIAI;8582453109;Ne;0;4;0;4
3645;Kaštonas;DRUGELIAI;2832688622;Ne;0;10;0;10
3646;Kaštonas;DRUGELIAI;9061158412;Ne;0;9;0;9
3647;Kaštonas;DRUGELIAI;5884427036;Ne;6;10;0;16
3648;Kaštonas;DRUGELIAI;1141693073;Ne;0;5;0;5
3649;Kaštonas;DRUGELIAI;6251564828;Ne;0;5;0;5
3650;Kaštonas;DRUGELIAI;1249299633;Ne;0;4;0;4
3651;Kaštonas;DRUGELIAI;8166925991;Ne;0;12;0;12
3652;Kaštonas;DRUGELIAI;4215759647;Ne;0;1;0;1
3653;Kaštonas;DRUGELIAI;5307755844;Ne;0;2;0;2
3654;Kaštonas;DRUGELIAI;2417951642;Ne;0;3;0;3
3655;Kaštonas;DRUGELIAI;8257643251;Ne;0;18;0;18
3656;Kaštonas;KIŠKUČIAI;2020612346;Ne;7;4;0;11
3657;Kaštonas;KIŠKUČIAI;6585977073;Ne;13;1;0;14
3658;Kaštonas;KIŠKUČIAI;1761520786;Ne;10;0;0;10
3659;Kaštonas;KIŠKUČIAI;9298372326;Ne;14;2;0;16
3660;Kaštonas;KIŠKUČIAI;9778140363;Ne;1;6;0;7
3661;Kaštonas;KIŠKUČIAI;8250964197;Ne;0;8;0;8
3662;Kaštonas;KIŠKUČIAI;7290414209;Ne;0;19;0;19
3663;Kaštonas;KIŠKUČIAI;9356018629;Ne;2;0;0;2
3664;Kaštonas;KIŠKUČIAI;4115242811;Ne;0;13;0;13
3665;Kaštonas;KIŠKUČIAI;1684641447;Ne;0;5;0;5
3666;Kaštonas;KIŠKUČIAI;1207372235;Ne;0;2;0;2
3667;Kaštonas;KIŠKUČIAI;4570064071;Ne;20;0;0;20
3668;Kaštonas;KIŠKUČIAI;2898327157;Ne;5;0;0;5
3669;Kaštonas;KIŠKUČIAI;9320223622;Ne;0;8;0;8
3670;Kaštonas;KIŠKUČIAI;3544696101;Ne;7;0;0;7
3671;Kaštonas;BITUTĖS;7946379086;Ne;6;0;3;9
3672;Kaštonas;BITUTĖS;9285927858;Ne;6;5;0;11
3673;Kaštonas;BITUTĖS;9903176616;Ne;2;0;0;2
3674;Kaštonas;BITUTĖS;4061364544;Ne;7;0;0;7
3675;Kaštonas;BITUTĖS;8275673303;Ne;9;0;0;9
3676;Kaštonas;BITUTĖS;1614180834;Ne;2;0;1;3
3677;Kaštonas;BITUTĖS;6711295699;Ne;0;4;0;4
3678;Kaštonas;BITUTĖS;2877124424;Ne;0;2;0;2
3679;Kaštonas;BITUTĖS;1031628633;Ne;12;1;0;13
3680;Kaštonas;BITUTĖS;4551111709;Ne;5;2;0;7
3681;Kaštonas;BITUTĖS;8906976150;Ne;9;2;0;11
3682;Kaštonas;BITUTĖS;8151333699;Ne;6;2;0;8
3683;Kaštonas;BITUTĖS;8152577445;Ne;0;1;1;2
3684;Kaštonas;BITUTĖS;7291448857;Ne;0;4;0;4
3685;Kaštonas;BITUTĖS;4837002666;Ne;18;0;0;18
3686;Kaštonas;BITUTĖS;6175014441;Ne;0;0;2;2
3687;Kaštonas;BITUTĖS;1748975865;Ne;9;2;0;11
3688;Kaštonas;MEŠKIUKAI;5350239917;Ne;9;0;2;11
3689;Kaštonas;MEŠKIUKAI;6289073634;Ne;0;17;0;17
3690;Kaštonas;MEŠKIUKAI;4616084852;Ne;0;2;0;2
3691;Kaštonas;MEŠKIUKAI;5157500600;Ne;5;0;0;5
3692;Kaštonas;MEŠKIUKAI;6967725663;Ne;3;6;0;9
3693;Kaštonas;MEŠKIUKAI;4308169582;Ne;3;8;1;12
3694;Kaštonas;BORUŽĖLĖS;1501441973;Ne;5;2;0;7
3695;Kaštonas;BORUŽĖLĖS;1612086010;Ne;0;14;0;14
3696;Kaštonas;BORUŽĖLĖS;1027896631;Ne;5;4;0;9
3697;Kaštonas;BORUŽĖLĖS;9034859988;Ne;9;0;0;9
3698;Kaštonas;BORUŽĖLĖS;9249007247;Ne;11;3;0;14
3699;Kaštonas;BORUŽĖLĖS;6896372095;Ne;5;0;0;5
3700;Kaštonas;BORUŽĖLĖS;1976138680;Ne;10;0;0;10
3701;Kaštonas;BORUŽĖLĖS;9807554365;Taip;3;0;0;3
3702;Kaštonas;BORUŽĖLĖS;4708114402;Ne;2;9;0;11
3703;Kaštonas;BORUŽĖLĖS;4641535612;Ne;0;17;0;17
3704;Kaštonas;BORUŽĖLĖS;7383219978;Ne;0;6;0;6
3705;Kaštonas;BORUŽĖLĖS;3251132542;Ne;4;1;0;5
3706;Kaštonas;BORUŽĖLĖS;6425908247;Ne;6;0;0;6
3707;Kaštonas;BORUŽĖLĖS;3860613494;Ne;0;22;0;22
3708;Kaštonas;BORUŽĖLĖS;5948707303;Ne;14;4;0;18
3709;Kaštonas;BORUŽĖLĖS;7698074598;Ne;23;2;0;25
3710;Kaštonas;BORUŽĖLĖS;6749679348;Ne;7;0;0;7
3711;Kaštonas;BORUŽĖLĖS;5060824071;Ne;9;1;0;10
3712;Kaštonas;BITUTĖS;3279850526;Ne;10;0;0;10
3713;"Krivūlė (Lydos g. 5)";SPINDULIUKAI;1937803301;Ne;0;0;1;1
3714;"Krivūlė (Lydos g. 5)";SPINDULIUKAI;9865192795;Ne;0;0;1;1
3715;"Krivūlė (Lydos g. 5)";SPINDULIUKAI;3913058095;Ne;5;0;2;7
3716;"Krivūlė (Lydos g. 5)";SPINDULIUKAI;1840809151;Ne;10;0;0;10
3717;"Krivūlė (Lydos g. 5)";SPINDULIUKAI;7335245963;Ne;0;0;4;4
3718;"Krivūlė (Lydos g. 5)";SPINDULIUKAI;5802739148;Ne;0;4;1;5
3719;"Krivūlė (Lydos g. 5)";SPINDULIUKAI;1151179495;Ne;0;0;3;3
3720;"Krivūlė (Lydos g. 5)";SPINDULIUKAI;9320613086;Ne;8;10;0;18
3721;"Krivūlė (Lydos g. 5)";SPINDULIUKAI;4750075323;Ne;0;0;1;1
3722;"Krivūlė (Lydos g. 5)";SPINDULIUKAI;3852793979;Ne;0;8;5;13
3723;"Krivūlė (Lydos g. 5)";SPINDULIUKAI;3184820008;Ne;0;0;7;7
3724;"Krivūlė (Lydos g. 5)";SPINDULIUKAI;7149268223;Ne;0;0;5;5
3725;"Krivūlė (Lydos g. 5)";SPINDULIUKAI;7025398689;Ne;0;22;0;22
3726;"Krivūlė (Lydos g. 5)";BORUŽĖLĖS;4845515196;Ne;0;1;1;2
3727;"Krivūlė (Lydos g. 5)";BORUŽĖLĖS;5676562063;Ne;2;0;5;7
3728;"Krivūlė (Lydos g. 5)";BORUŽĖLĖS;6935969502;Ne;10;0;2;12
3729;"Krivūlė (Lydos g. 5)";BORUŽĖLĖS;4972360440;Ne;11;0;1;12
3730;"Krivūlė (Lydos g. 5)";BORUŽĖLĖS;7318064702;Ne;0;0;12;12
3731;"Krivūlė (Lydos g. 5)";BORUŽĖLĖS;3912620138;Ne;0;0;5;5
3732;"Krivūlė (Lydos g. 5)";BORUŽĖLĖS;3246787504;Ne;0;0;3;3
3733;"Krivūlė (Lydos g. 5)";BORUŽĖLĖS;5531566792;Ne;0;0;5;5
3734;"Krivūlė (Lydos g. 5)";BORUŽĖLĖS;2386053480;Ne;0;0;6;6
3735;"Krivūlė (Lydos g. 5)";BORUŽĖLĖS;8586287004;Ne;12;0;0;12
3736;"Krivūlė (Lydos g. 5)";BORUŽĖLĖS;4540069843;Ne;0;0;3;3
3737;"Krivūlė (Lydos g. 5)";BORUŽĖLĖS;4297876008;Ne;5;0;2;7
3738;"Krivūlė (Lydos g. 5)";BORUŽĖLĖS;2138125571;Ne;0;0;1;1
3739;"Krivūlė (Lydos g. 5)";BORUŽĖLĖS;4177660973;Ne;0;3;0;3
3740;"Krivūlė (Lydos g. 5)";BORUŽĖLĖS;2711010212;Ne;0;2;0;2
3741;"Krivūlė (Lydos g. 5)";BORUŽĖLĖS;4025821636;Ne;3;0;0;3
3742;"Krivūlė (Lydos g. 5)";BORUŽĖLĖS;7781918674;Ne;0;2;2;4
3743;"Krivūlė (Lydos g. 5)";BORUŽĖLĖS;1987255206;Ne;5;0;2;7
3744;"Krivūlė (Lydos g. 5)";BORUŽĖLĖS;1171226193;Ne;0;0;9;9
3745;"Krivūlė (Lydos g. 5)";DRUGELIŲ;5966543639;Ne;0;0;21;21
3746;"Krivūlė (Lydos g. 5)";DRUGELIŲ;5818988913;Ne;0;2;0;2
3747;"Krivūlė (Lydos g. 5)";DRUGELIŲ;7873123757;Ne;0;1;1;2
3748;"Krivūlė (Lydos g. 5)";DRUGELIŲ;2903062788;Ne;0;0;3;3
3749;"Krivūlė (Lydos g. 5)";DRUGELIŲ;10005041572;Ne;0;0;1;1
3750;"Krivūlė (Lydos g. 5)";DRUGELIŲ;37502093836;Ne;1;0;2;3
3751;"Krivūlė (Lydos g. 5)";DRUGELIŲ;83840444975;Ne;0;0;3;3
3752;"Krivūlė (Lydos g. 5)";DRUGELIŲ;2654066358;Ne;0;4;0;4
3753;"Krivūlė (Lydos g. 5)";DRUGELIŲ;6861483854;Ne;2;10;2;14
3754;"Krivūlė (Lydos g. 5)";DRUGELIŲ;1515185307;Ne;0;1;4;5
3755;"Krivūlė (Lydos g. 5)";DRUGELIŲ;1217856292;Ne;0;0;4;4
3756;"Krivūlė (Lydos g. 5)";DRUGELIŲ;9311270695;Ne;0;2;0;2
3757;"Krivūlė (Lydos g. 5)";DRUGELIŲ;73760357378;Ne;0;0;2;2
3758;"Krivūlė (Lydos g. 5)";DRUGELIŲ;6753080815;Ne;0;0;11;11
3759;"Krivūlė (Lydos g. 5)";DRUGELIŲ;4261133734;Ne;5;0;3;8
3760;"Krivūlė (Lydos g. 5)";DRUGELIŲ;6429160371;Ne;0;1;1;2
3761;"Krivūlė (Lydos g. 5)";DRUGELIŲ;3924127476;Ne;0;5;1;6
3762;"Krivūlė (Lydos g. 5)";"BITUTĖS (VALDOFRO)";18486357195;Ne;0;0;11;11
3763;"Krivūlė (Lydos g. 5)";"BITUTĖS (VALDOFRO)";3769812444;Ne;8;1;0;9
3764;"Krivūlė (Lydos g. 5)";"BITUTĖS (VALDOFRO)";5128760019;Ne;7;0;0;7
3765;"Krivūlė (Lydos g. 5)";"BITUTĖS (VALDOFRO)";7789248863;Ne;0;0;6;6
3766;"Krivūlė (Lydos g. 5)";"BITUTĖS (VALDOFRO)";2647149927;Ne;0;6;0;6
3767;"Krivūlė (Lydos g. 5)";"BITUTĖS (VALDOFRO)";5113297248;Ne;0;0;9;9
3768;"Krivūlė (Lydos g. 5)";"BITUTĖS (VALDOFRO)";9632352765;Ne;0;6;0;6
3769;"Krivūlė (Lydos g. 5)";"BITUTĖS (VALDOFRO)";7848471009;Ne;0;0;8;8
3770;"Krivūlė (Lydos g. 5)";"BITUTĖS (VALDOFRO)";5405660104;Ne;0;0;5;5
3771;"Krivūlė (Lydos g. 5)";"BITUTĖS (VALDOFRO)";8834855616;Ne;0;3;0;3
3772;"Krivūlė (Lydos g. 5)";"BITUTĖS (VALDOFRO)";3655576855;Ne;0;0;6;6
3773;"Krivūlė (Lydos g. 5)";"BITUTĖS (VALDOFRO)";1561180871;Ne;0;8;0;8
3774;"Krivūlė (Lydos g. 5)";"BITUTĖS (VALDOFRO)";9702372816;Ne;0;15;0;15
3775;"Krivūlė (Lydos g. 5)";"BITUTĖS (VALDOFRO)";4619224314;Ne;0;22;0;22
3776;"Krivūlė (Lydos g. 5)";"BITUTĖS (VALDOFRO)";8105688948;Ne;5;0;3;8
3777;"Krivūlė (Lydos g. 5)";"BITUTĖS (VALDOFRO)";1932209134;Ne;0;0;5;5
3778;"Krivūlė (Lydos g. 5)";"BITUTĖS (VALDOFRO)";7768827505;Ne;3;0;7;10
3779;"Krivūlė (Lydos g. 5)";"BITUTĖS (VALDOFRO)";7199431924;Ne;0;0;2;2
3780;"Krivūlė (Lydos g. 5)";"BITUTĖS (VALDOFRO)";7714519095;Ne;0;15;0;15
3781;"Krivūlė (Lydos g. 5)";"BITUTĖS (VALDOFRO)";9409899522;Ne;5;5;0;10
3782;"Krivūlė (Lydos g. 5)";"BITUTĖS (VALDOFRO)";6365743037;Ne;0;0;3;3
3783;"Krivūlė (Lydos g. 5)";"BITUTĖS (VALDOFRO)";6217494808;Ne;9;6;4;19
3784;"Krivūlė (Lydos g. 5)";"BITUTĖS (VALDOFRO)";8748668583;Ne;10;0;0;10
3785;"Krivūlė (Lydos g. 5)";EŽIUKAI;8042185027;Ne;4;0;0;4
3786;"Krivūlė (Lydos g. 5)";EŽIUKAI;3616024832;Ne;0;0;3;3
3787;"Krivūlė (Lydos g. 5)";EŽIUKAI;5664892835;Ne;0;0;4;4
3788;"Krivūlė (Lydos g. 5)";EŽIUKAI;8399607572;Ne;0;0;4;4
3789;"Krivūlė (Lydos g. 5)";EŽIUKAI;5369083173;Ne;0;22;0;22
3790;"Krivūlė (Lydos g. 5)";EŽIUKAI;9051038248;Ne;9;0;0;9
3791;"Krivūlė (Lydos g. 5)";EŽIUKAI;3144577262;Ne;0;0;7;7
3792;"Krivūlė (Lydos g. 5)";EŽIUKAI;1898389557;Ne;0;0;4;4
3793;"Krivūlė (Lydos g. 5)";EŽIUKAI;2607716072;Ne;0;0;6;6
3794;"Krivūlė (Lydos g. 5)";EŽIUKAI;6830712749;Ne;0;0;4;4
3795;"Krivūlė (Lydos g. 5)";EŽIUKAI;8873132189;Ne;0;10;5;15
3796;"Krivūlė (Lydos g. 5)";EŽIUKAI;2430372719;Ne;0;0;1;1
3797;"Krivūlė (Lydos g. 5)";EŽIUKAI;1893542120;Ne;0;22;0;22
3798;"Krivūlė (Lydos g. 5)";EŽIUKAI;1622229289;Ne;0;0;1;1
3799;"Krivūlė (Lydos g. 5)";NYKŠTUKAI;8713384668;Ne;0;22;0;22
3800;"Krivūlė (Lydos g. 5)";NYKŠTUKAI;9553953446;Ne;0;0;8;8
3801;"Krivūlė (Lydos g. 5)";NYKŠTUKAI;5268832682;Ne;5;0;0;5
3802;"Krivūlė (Lydos g. 5)";NYKŠTUKAI;8767554721;Ne;3;1;0;4
3803;"Krivūlė (Lydos g. 5)";NYKŠTUKAI;9529242858;Ne;0;0;2;2
3804;"Krivūlė (Lydos g. 5)";NYKŠTUKAI;8898023612;Ne;0;0;5;5
3805;"Krivūlė (Lydos g. 5)";NYKŠTUKAI;5768244312;Ne;2;8;0;10
3806;"Krivūlė (Lydos g. 5)";NYKŠTUKAI;7540940063;Ne;0;0;1;1
3807;"Krivūlė (Lydos g. 5)";NYKŠTUKAI;7262017017;Ne;0;2;0;2
3808;"Krivūlė (Lydos g. 5)";NYKŠTUKAI;9773092651;Ne;0;0;1;1
3809;"Krivūlė (Lydos g. 5)";NYKŠTUKAI;6548893885;Ne;0;0;4;4
3810;"Krivūlė (Lydos g. 5)";NYKŠTUKAI;8674468359;Ne;0;22;0;22
3811;Kodėlčiukas;Saulutės;6517880481;Ne;2;0;0;2
3812;Kodėlčiukas;Saulutės;1725624698;Ne;5;0;1;6
3813;Kodėlčiukas;Saulutės;7509476161;Ne;0;4;0;4
3814;Kodėlčiukas;Saulutės;7327247516;Ne;6;0;0;6
3815;Kodėlčiukas;Saulutės;1645680526;Ne;5;0;0;5
3816;Kodėlčiukas;Saulutės;6285018663;Ne;5;1;0;6
3817;Kodėlčiukas;Saulutės;1033969800;Ne;5;8;0;13
3818;Kodėlčiukas;Saulutės;2433094435;Ne;6;0;0;6
3819;Kodėlčiukas;Saulutės;9042404309;Ne;0;0;16;16
3820;Kodėlčiukas;Saulutės;3276075664;Ne;2;0;0;2
3821;Kodėlčiukas;Saulutės;9476376350;Ne;2;7;1;10
3822;Kodėlčiukas;Saulutės;7561763602;Ne;2;0;0;2
3823;Kodėlčiukas;Saulutės;2289687766;Ne;0;0;1;1
3824;Kodėlčiukas;Saulutės;6476445296;Ne;4;1;0;5
3825;Kodėlčiukas;Saulutės;1992569595;Ne;17;0;1;18
3826;Kodėlčiukas;Saulutės;9527296531;Ne;0;0;3;3
3827;Kodėlčiukas;Saulutės;8070400563;Ne;0;0;2;2
3828;Kodėlčiukas;Saulutės;8447045958;Ne;0;2;4;6
3829;Kodėlčiukas;Saulutės;2542104903;Ne;0;6;0;6
3830;Kodėlčiukas;Nežiniukai;6045564826;Ne;7;8;0;15
3831;Kodėlčiukas;Nežiniukai;7136890681;Ne;5;0;0;5
3832;Kodėlčiukas;Nežiniukai;7971932716;Ne;5;0;1;6
3833;Kodėlčiukas;Nežiniukai;7282579315;Ne;7;0;1;8
3834;Kodėlčiukas;Nežiniukai;6905424567;Ne;2;0;4;6
3835;Kodėlčiukas;Nežiniukai;5443377251;Taip;0;6;0;6
3836;Kodėlčiukas;Nežiniukai;3150006441;Ne;0;0;3;3
3837;Kodėlčiukas;Nežiniukai;7626940433;Ne;0;5;0;5
3838;Kodėlčiukas;Nežiniukai;4917910801;Taip;0;1;2;3
3839;Kodėlčiukas;Nežiniukai;3473981974;Ne;0;5;4;9
3840;Kodėlčiukas;Nežiniukai;4038168647;Ne;7;0;3;10
3841;Kodėlčiukas;Nežiniukai;6000831611;Ne;0;0;5;5
3842;Kodėlčiukas;Nežiniukai;7286497455;Ne;0;5;10;15
3843;Kodėlčiukas;Nežiniukai;6074758814;Ne;0;6;0;6
3844;Kodėlčiukas;Nežiniukai;1699358514;Ne;5;1;0;6
3845;Kodėlčiukas;Nežiniukai;1302383608;Ne;0;0;5;5
3846;Kodėlčiukas;Nežiniukai;1160612316;Ne;0;8;0;8
3847;Kodėlčiukas;Nežiniukai;3470151604;Ne;0;0;1;1
3848;Kodėlčiukas;Nežiniukai;5729391456;Ne;9;2;0;11
3849;Kodėlčiukas;Gintarėliai;2560864315;Ne;0;4;1;5
3850;Kodėlčiukas;Gintarėliai;58406224468;Ne;0;0;7;7
3851;Kodėlčiukas;Gintarėliai;1485012710;Ne;0;0;1;1
3852;Kodėlčiukas;Gintarėliai;20084022099;Ne;0;0;3;3
3853;Kodėlčiukas;Gintarėliai;9686497547;Ne;0;2;0;2
3854;Kodėlčiukas;Gintarėliai;4884104023;Ne;2;0;0;2
3855;Kodėlčiukas;Gintarėliai;1632458573;Ne;0;0;2;2
3856;Kodėlčiukas;Gintarėliai;9332136116;Ne;3;0;1;4
3857;Kodėlčiukas;Gintarėliai;4944791330;Ne;0;0;1;1
3858;Kodėlčiukas;Gintarėliai;8219424737;Ne;0;0;2;2
3859;Kodėlčiukas;Gintarėliai;4849314647;Ne;0;0;2;2
3860;Kodėlčiukas;Gintarėliai;5093139270;Ne;0;0;9;9
3861;Kodėlčiukas;Gintarėliai;4738357524;Ne;0;0;13;13
3862;Kodėlčiukas;Gintarėliai;8873629130;Ne;2;2;0;4
3863;Kodėlčiukas;Gintarėliai;1190408818;Ne;0;0;11;11
3864;Kodėlčiukas;Gintarėliai;2162480212;Ne;0;0;2;2
3865;Kodėlčiukas;Gintarėliai;6764015170;Ne;14;8;0;22
3866;Kodėlčiukas;Gintarėliai;6248137523;Ne;0;1;1;2
3867;Kodėlčiukas;Šnekučiai;1844016431;Ne;11;0;0;11
3868;Kodėlčiukas;Šnekučiai;1550915654;Ne;0;15;0;15
3869;Kodėlčiukas;Šnekučiai;1935757837;Ne;0;3;0;3
3870;Kodėlčiukas;Šnekučiai;8114859362;Ne;0;11;0;11
3871;Kodėlčiukas;Šnekučiai;1666743304;Ne;0;1;0;1
3872;Kodėlčiukas;Šnekučiai;1432342305;Ne;0;0;3;3
3873;Kodėlčiukas;Šnekučiai;9178209049;Ne;0;0;4;4
3874;Kodėlčiukas;Šnekučiai;5988863934;Ne;4;3;1;8
3875;Kodėlčiukas;Šnekučiai;76164689333;Ne;13;0;0;13
3876;Kodėlčiukas;Šnekučiai;5386820408;Ne;10;0;0;10
3877;Kodėlčiukas;Šnekučiai;6194726931;Ne;0;2;0;2
3878;Kodėlčiukas;Šnekučiai;7074381835;Ne;0;6;0;6
3879;Kodėlčiukas;Šnekučiai;2988674717;Ne;0;8;3;11
3880;Kodėlčiukas;Šnekučiai;1834696935;Ne;0;6;0;6
3881;Kodėlčiukas;Šnekučiai;4273202718;Ne;5;0;2;7
3882;Kodėlčiukas;Šnekučiai;2244326972;Ne;5;0;6;11
3883;Kodėlčiukas;Šnekučiai;6761903865;Ne;0;4;0;4
3884;Kodėlčiukas;Šnekučiai;3778271049;Ne;0;0;2;2
3885;Kodėlčiukas;Šnekučiai;7647582987;Ne;0;0;9;9
3886;Kodėlčiukas;Šnekučiai;7510273691;Ne;9;2;0;11
3887;Kodėlčiukas;Pabiručiai;9278139998;Ne;0;16;0;16
3888;Kodėlčiukas;Pabiručiai;6008027505;Ne;4;0;5;9
3889;Kodėlčiukas;Pabiručiai;6065858518;Ne;5;1;0;6
3890;Kodėlčiukas;Pabiručiai;8586746296;Ne;0;1;0;1
3891;Kodėlčiukas;Pabiručiai;9480926599;Ne;0;2;1;3
3892;Kodėlčiukas;Pabiručiai;9511144369;Ne;17;0;0;17
3893;Kodėlčiukas;Pabiručiai;7246943802;Ne;8;0;0;8
3894;Kodėlčiukas;Pabiručiai;8189938439;Ne;3;0;2;5
3895;Kodėlčiukas;Pabiručiai;5587200800;Ne;7;0;1;8
3896;Kodėlčiukas;Pabiručiai;1433623973;Ne;11;0;0;11
3897;Kodėlčiukas;Pabiručiai;1087808091;Ne;8;1;0;9
3898;Kodėlčiukas;Pabiručiai;7570122834;Ne;6;0;2;8
3899;Kodėlčiukas;Pabiručiai;5359866071;Ne;0;11;0;11
3900;Kodėlčiukas;Pabiručiai;5801430256;Ne;0;5;0;5
3901;Kodėlčiukas;Pabiručiai;7455949617;Ne;7;5;0;12
3902;Kodėlčiukas;Pabiručiai;4507928289;Ne;6;0;0;6
3903;Kodėlčiukas;Pabiručiai;9830842598;Ne;8;0;3;11
3904;Kodėlčiukas;Pabiručiai;8291672306;Ne;0;5;2;7
3905;Kodėlčiukas;Pabiručiai;3882838712;Ne;0;0;9;9
3906;Kodėlčiukas;Pabiručiai;8635107742;Ne;6;0;1;7
3907;Kodėlčiukas;Smalsučiai;7630180473;Ne;11;1;0;12
3908;Kodėlčiukas;Smalsučiai;7246243975;Ne;0;2;0;2
3909;Kodėlčiukas;Smalsučiai;1600501494;Ne;0;7;1;8
3910;Kodėlčiukas;Smalsučiai;3880019350;Ne;3;0;5;8
3911;Kodėlčiukas;Smalsučiai;4818678923;Ne;6;1;1;8
3912;Kodėlčiukas;Smalsučiai;9589692031;Ne;7;10;0;17
3913;Kodėlčiukas;Smalsučiai;1906128091;Ne;5;0;0;5
3914;Kodėlčiukas;Smalsučiai;8302606312;Ne;0;1;0;1
3915;Kodėlčiukas;Smalsučiai;9460792167;Ne;2;7;0;9
3916;Kodėlčiukas;Smalsučiai;9794875862;Ne;0;0;6;6
3917;Kodėlčiukas;Smalsučiai;9528997865;Ne;0;9;0;9
3918;Kodėlčiukas;Smalsučiai;1919722425;Ne;0;0;4;4
3919;Kodėlčiukas;Smalsučiai;8879977943;Ne;0;0;3;3
3920;Kodėlčiukas;Smalsučiai;8647609373;Ne;0;8;0;8
3921;Kodėlčiukas;Smalsučiai;2062878300;Ne;3;0;3;6
3922;Kodėlčiukas;Smalsučiai;6950802941;Ne;13;0;2;15
3923;Kodėlčiukas;Smalsučiai;1233880820;Taip;0;0;1;1
3924;Kodėlčiukas;Giliukai;9754425363;Ne;5;8;0;13
3925;Kodėlčiukas;Giliukai;5587782917;Ne;11;5;0;16
3926;Kodėlčiukas;Giliukai;8100861190;Taip;7;1;0;8
3927;Kodėlčiukas;Giliukai;7639341503;Ne;3;2;0;5
3928;Kodėlčiukas;Giliukai;8017465692;Ne;5;2;0;7
3929;Kodėlčiukas;Giliukai;7937365710;Ne;7;2;1;10
3930;Kodėlčiukas;Giliukai;9733831323;Ne;4;2;1;7
3931;Kodėlčiukas;Giliukai;7007386353;Ne;0;2;0;2
3932;Kodėlčiukas;Giliukai;2943146610;Ne;7;0;0;7
3933;Kodėlčiukas;Giliukai;5573845415;Ne;0;0;1;1
3934;Kodėlčiukas;Giliukai;8785157050;Ne;0;13;0;13
3935;Kodėlčiukas;Giliukai;5770748359;Ne;14;0;0;14
3936;Kodėlčiukas;Giliukai;9992204262;Taip;11;0;0;11
3937;Kodėlčiukas;Giliukai;6643473339;Ne;0;6;0;6
3938;Kodėlčiukas;Giliukai;5909222351;Ne;3;2;0;5
3939;Kodėlčiukas;Giliukai;3130715310;Ne;5;15;0;20
3940;Kodėlčiukas;Giliukai;3686259290;Ne;0;0;1;1
3941;Kodėlčiukas;Gudručiai;1191430672;Ne;10;2;0;12
3942;Kodėlčiukas;Gudručiai;6988515253;Ne;0;9;0;9
3943;Kodėlčiukas;Gudručiai;3385551650;Ne;11;0;1;12
3944;Kodėlčiukas;Gudručiai;7318908956;Ne;0;5;0;5
3945;Kodėlčiukas;Gudručiai;7430239198;Ne;0;0;2;2
3946;Kodėlčiukas;Gudručiai;8400610717;Ne;9;0;2;11
3947;Kodėlčiukas;Gudručiai;7116594055;Ne;7;0;1;8
3948;Kodėlčiukas;Gudručiai;7326475644;Ne;2;0;1;3
3949;Kodėlčiukas;Gudručiai;1801366890;Ne;8;0;0;8
3950;Kodėlčiukas;Gudručiai;9483378853;Ne;0;9;1;10
3951;Kodėlčiukas;Gudručiai;8890987483;Ne;17;0;1;18
3952;Kodėlčiukas;Gudručiai;4687333060;Ne;0;1;0;1
3953;Kodėlčiukas;Gudručiai;4543838852;Ne;5;11;0;16
3954;Kodėlčiukas;Gudručiai;2216791610;Ne;13;0;3;16
3955;Kodėlčiukas;Gudručiai;2987907651;Ne;11;0;0;11
3956;Kodėlčiukas;Gudručiai;9028856983;Ne;10;0;0;10
3957;Kodėlčiukas;Gudručiai;1588132166;Ne;1;7;0;8
3958;Kodėlčiukas;Gudručiai;6014084915;Ne;9;0;0;9
3959;Kodėlčiukas;Gudručiai;3068084704;Ne;4;2;2;8
3960;Kodėlčiukas;Gudručiai;6985788287;Ne;6;0;0;6
3961;Kodėlčiukas;Gudručiai;3427610168;Ne;8;6;1;15
3962;Kodėlčiukas;Žirniukai;2402290604;Ne;7;0;0;7
3963;Kodėlčiukas;Žirniukai;6522019070;Ne;12;0;0;12
3964;Kodėlčiukas;Žirniukai;1050905569;Ne;0;0;7;7
3965;Kodėlčiukas;Žirniukai;3053949510;Ne;12;7;0;19
3966;Kodėlčiukas;Žirniukai;5325660102;Ne;5;1;0;6
3967;Kodėlčiukas;Žirniukai;8429572505;Ne;9;0;0;9
3968;Kodėlčiukas;Žirniukai;4321485862;Ne;10;0;0;10
3969;Kodėlčiukas;Žirniukai;6011097577;Ne;0;22;0;22
3970;Kodėlčiukas;Žirniukai;1550287298;Ne;9;0;0;9
3971;Kodėlčiukas;Žirniukai;9045733092;Ne;5;0;2;7
3972;Kodėlčiukas;Žirniukai;4341694264;Ne;17;0;0;17
3973;Kodėlčiukas;Žirniukai;4597473929;Ne;10;0;3;13
3974;Kodėlčiukas;Žirniukai;9702236745;Ne;0;0;1;1
3975;Kodėlčiukas;Žirniukai;7189930025;Ne;9;0;0;9
3976;Kodėlčiukas;Žirniukai;2002468844;Ne;9;0;1;10
3977;Kodėlčiukas;Žirniukai;4187856743;Ne;5;0;0;5
3978;Kodėlčiukas;Žirniukai;1656161309;Ne;26;0;0;26
3979;Kodėlčiukas;Katinėliai;4730433849;Ne;10;0;1;11
3980;Kodėlčiukas;Katinėliai;6474867237;Ne;0;0;3;3
3981;Kodėlčiukas;Katinėliai;4995538090;Ne;5;0;1;6
3982;Kodėlčiukas;Katinėliai;8045906704;Ne;2;0;2;4
3983;Kodėlčiukas;Katinėliai;7306085848;Ne;8;0;0;8
3984;Kodėlčiukas;Katinėliai;6576466300;Ne;12;0;0;12
3985;Kodėlčiukas;Katinėliai;5650077893;Ne;8;5;2;15
3986;Kodėlčiukas;Katinėliai;3239314295;Ne;20;0;0;20
3987;Kodėlčiukas;Katinėliai;9221561862;Ne;5;0;0;5
3988;Kodėlčiukas;Katinėliai;6355536268;Ne;0;5;2;7
3989;Kodėlčiukas;Katinėliai;2147517344;Ne;8;0;3;11
3990;Kodėlčiukas;Katinėliai;2119041584;Ne;7;2;2;11
3991;Kodėlčiukas;Katinėliai;1570599010;Ne;7;5;0;12
3992;Kodėlčiukas;Katinėliai;9670055064;Ne;7;11;0;18
3993;Kodėlčiukas;Katinėliai;4727546035;Ne;7;1;0;8
3994;Kodėlčiukas;Nykštukai;6670171992;Ne;0;5;0;5
3995;Kodėlčiukas;Nykštukai;6935233288;Ne;17;0;0;17
3996;Kodėlčiukas;Nykštukai;7686420784;Ne;10;1;2;13
3997;Kodėlčiukas;Nykštukai;8348024909;Taip;0;1;0;1
3998;Kodėlčiukas;Nykštukai;8759498015;Ne;5;0;0;5
3999;Kodėlčiukas;Nykštukai;9418778626;Ne;15;0;0;15
4000;Kodėlčiukas;Nykštukai;8911944991;Ne;11;0;2;13
4001;Kodėlčiukas;Nykštukai;2465920649;Ne;22;0;0;22
4002;Kodėlčiukas;Nykštukai;4293763647;Ne;0;0;1;1
4003;Kodėlčiukas;Nykštukai;3878358193;Ne;15;0;2;17
4004;Kodėlčiukas;Nykštukai;1835522972;Ne;9;0;0;9
4005;Kodėlčiukas;Nykštukai;4986413731;Ne;12;0;0;12
4006;Kodėlčiukas;Nykštukai;2802895479;Ne;0;10;0;10
4007;Kodėlčiukas;Nykštukai;9914565606;Ne;0;0;8;8
4008;Kodėlčiukas;Nykštukai;2543628770;Ne;9;0;10;19
4009;Kodėlčiukas;Nykštukai;5541555127;Ne;11;1;0;12
4010;Kodėlčiukas;Nykštukai;3037267215;Taip;0;0;3;3
4011;Kodėlčiukas;ŽIOGELIAI;6745245907;Ne;7;2;0;9
4012;Kodėlčiukas;ŽIOGELIAI;9055399463;Ne;5;5;0;10
4013;Kodėlčiukas;ŽIOGELIAI;2081199093;Ne;0;0;22;22
4014;Kodėlčiukas;ŽIOGELIAI;4779994281;Taip;3;0;0;3
4015;Kodėlčiukas;ŽIOGELIAI;5115939251;Ne;6;0;0;6
4016;Kodėlčiukas;ŽIOGELIAI;3223461282;Ne;15;0;0;15
4017;Kodėlčiukas;ŽIOGELIAI;3603781385;Ne;0;4;0;4
4018;Kodėlčiukas;ŽIOGELIAI;6749972956;Ne;10;0;0;10
4019;Kodėlčiukas;ŽIOGELIAI;2189949450;Ne;7;0;0;7
4020;Kodėlčiukas;ŽIOGELIAI;7497358286;Ne;9;1;0;10
4021;Kodėlčiukas;ŽIOGELIAI;2990546939;Ne;0;0;1;1
4022;Kodėlčiukas;ŽIOGELIAI;2933909503;Ne;17;0;0;17
4023;Kodėlčiukas;BITUTĖS;2438891967;Ne;11;11;0;22
4024;Kodėlčiukas;BITUTĖS;8829986201;Ne;0;0;10;10
4025;Kodėlčiukas;BITUTĖS;3985455729;Ne;0;0;4;4
4026;Kodėlčiukas;BITUTĖS;8144034996;Ne;0;0;3;3
4027;Kodėlčiukas;BITUTĖS;3156788328;Ne;6;0;2;8
4028;Kodėlčiukas;BITUTĖS;7910205296;Ne;0;3;0;3
4029;Kodėlčiukas;BITUTĖS;9736751250;Ne;10;0;0;10
4030;Kodėlčiukas;BITUTĖS;8037386529;Ne;5;6;0;11
4031;Kodėlčiukas;BITUTĖS;1047209628;Ne;10;0;2;12
4032;Kodėlčiukas;BITUTĖS;5068611716;Ne;5;0;0;5
4033;Kodėlčiukas;BITUTĖS;8932472612;Ne;0;0;4;4
4034;Kodėlčiukas;BITUTĖS;4529565626;Ne;5;0;3;8
4035;Kodėlčiukas;BITUTĖS;7227149646;Ne;1;5;5;11
4036;Kodėlčiukas;BITUTĖS;1568628843;Ne;0;10;0;10
4037;Kodėlčiukas;BITUTĖS;9209671311;Ne;19;0;0;19
4038;Kodėlčiukas;BITUTĖS;6726383331;Ne;11;0;0;11
4039;Kodėlčiukas;BITUTĖS;1197049907;Ne;0;14;0;14
4040;Kodėlčiukas;VYŠNIUKAI;7705057116;Ne;0;1;2;3
4041;Kodėlčiukas;VYŠNIUKAI;7643398934;Ne;0;1;5;6
4042;Kodėlčiukas;VYŠNIUKAI;8799798070;Ne;0;0;5;5
4043;Kodėlčiukas;VYŠNIUKAI;7119815662;Ne;0;0;6;6
4044;Kodėlčiukas;VYŠNIUKAI;9398732476;Ne;0;0;11;11
4045;Kodėlčiukas;VYŠNIUKAI;2720748563;Ne;0;2;5;7
4046;Kodėlčiukas;VYŠNIUKAI;2871111867;Ne;0;1;0;1
4047;Kodėlčiukas;VYŠNIUKAI;7242653444;Ne;0;0;1;1
4048;Kodėlčiukas;VYŠNIUKAI;2298734536;Ne;0;10;0;10
4049;Kodėlčiukas;VYŠNIUKAI;6261333618;Taip;0;0;1;1
4050;Kodėlčiukas;VYŠNIUKAI;2549153581;Ne;22;0;0;22
4051;Kodėlčiukas;VYŠNIUKAI;1808211253;Ne;9;3;0;12
4052;Kodėlčiukas;VYŠNIUKAI;5178305435;Ne;7;0;2;9
4053;Kodėlčiukas;VYŠNIUKAI;5061852590;Ne;3;5;0;8
4054;Kodėlčiukas;VYŠNIUKAI;4782931414;Ne;0;2;0;2
4055;Kodėlčiukas;VYŠNIUKAI;1803320085;Ne;0;0;3;3
4056;Kodėlčiukas;VYŠNIUKAI;3938536446;Ne;0;0;5;5
4057;Kodėlčiukas;VYŠNIUKAI;5752818911;Ne;0;6;0;6
4058;Kodėlčiukas;BORUŽĖLĖS;9109362006;Ne;0;11;0;11
4059;Kodėlčiukas;BORUŽĖLĖS;9169500252;Ne;0;4;0;4
4060;Kodėlčiukas;BORUŽĖLĖS;9724373368;Ne;2;8;0;10
4061;Kodėlčiukas;BORUŽĖLĖS;5075801618;Ne;8;0;4;12
4062;Kodėlčiukas;BORUŽĖLĖS;2819860331;Ne;0;0;3;3
4063;Kodėlčiukas;BORUŽĖLĖS;4941186694;Ne;0;3;0;3
4064;Kodėlčiukas;BORUŽĖLĖS;4866089623;Ne;0;1;0;1
4065;Kodėlčiukas;BORUŽĖLĖS;5952121209;Ne;0;8;0;8
4066;Kodėlčiukas;BORUŽĖLĖS;4230906452;Ne;0;5;0;5
4067;Kodėlčiukas;BORUŽĖLĖS;9208137169;Ne;7;5;0;12
4068;Kodėlčiukas;BORUŽĖLĖS;1206798597;Ne;0;0;1;1
4069;Kodėlčiukas;BORUŽĖLĖS;1889809198;Ne;0;0;1;1
4070;Kodėlčiukas;BORUŽĖLĖS;4490196764;Ne;14;0;0;14
4071;Kodėlčiukas;BORUŽĖLĖS;1074477043;Ne;0;5;2;7
4072;Kodėlčiukas;BORUŽĖLĖS;3403889915;Ne;0;10;0;10
4073;Kodėlčiukas;VYTURĖLIAI;6714818379;Ne;0;6;0;6
4074;Kodėlčiukas;VYTURĖLIAI;4218096561;Ne;0;15;0;15
4075;Kodėlčiukas;VYTURĖLIAI;2169307879;Ne;9;0;2;11
4076;Kodėlčiukas;VYTURĖLIAI;2448536092;Ne;0;0;2;2
4077;Kodėlčiukas;VYTURĖLIAI;4585226357;Ne;0;0;2;2
4078;Kodėlčiukas;VYTURĖLIAI;4884233329;Ne;0;0;1;1
4079;Kodėlčiukas;VYTURĖLIAI;8263945732;Ne;8;0;4;12
4080;Kodėlčiukas;VYTURĖLIAI;2904858964;Ne;2;0;5;7
4081;Kodėlčiukas;VYTURĖLIAI;9673271313;Ne;10;0;2;12
4082;Kodėlčiukas;VYTURĖLIAI;5710301153;Ne;7;0;5;12
4083;Kodėlčiukas;VYTURĖLIAI;5474125905;Ne;8;3;0;11
4084;Kodėlčiukas;VYTURĖLIAI;5921714669;Ne;7;4;0;11
4085;Kodėlčiukas;DRUGELIAI;5772071707;Ne;0;0;2;2
4086;Kodėlčiukas;DRUGELIAI;1149682376;Ne;2;3;0;5
4087;Kodėlčiukas;DRUGELIAI;7587203481;Ne;0;0;6;6
4088;Kodėlčiukas;DRUGELIAI;2353960861;Ne;0;8;0;8
4089;Kodėlčiukas;DRUGELIAI;6103959702;Ne;0;0;1;1
4090;Kodėlčiukas;DRUGELIAI;3267687337;Ne;16;0;1;17
4091;Kodėlčiukas;DRUGELIAI;5505788210;Ne;12;0;0;12
4092;Kodėlčiukas;DRUGELIAI;5577154148;Ne;2;8;0;10
4093;Kodėlčiukas;DRUGELIAI;4202423480;Ne;6;0;0;6
4094;Kodėlčiukas;DRUGELIAI;9979034031;Ne;4;3;0;7
4095;Kodėlčiukas;DRUGELIAI;9139424911;Ne;0;0;1;1
4096;Kodėlčiukas;DRUGELIAI;5197946954;Ne;9;0;1;10
4097;Kodėlčiukas;DRUGELIAI;8315176054;Ne;5;5;0;10
4098;Kodėlčiukas;DRUGELIAI;3854719881;Ne;12;5;2;19
4099;Kodėlčiukas;DRUGELIAI;7908217415;Ne;0;0;10;10
4100;Kodėlčiukas;OBUOLIUKAI;1289342844;Ne;0;2;0;2
4101;Kodėlčiukas;OBUOLIUKAI;8208448849;Ne;7;0;0;7
4102;Kodėlčiukas;OBUOLIUKAI;1683506414;Ne;0;10;1;11
4103;Kodėlčiukas;OBUOLIUKAI;3315862631;Ne;0;11;0;11
4104;Kodėlčiukas;OBUOLIUKAI;3168418461;Ne;6;3;0;9
4105;Kodėlčiukas;OBUOLIUKAI;9645987751;Ne;8;5;0;13
4106;Kodėlčiukas;OBUOLIUKAI;5860975805;Ne;0;0;2;2
4107;Kodėlčiukas;OBUOLIUKAI;8782155591;Ne;0;0;8;8
4108;Kodėlčiukas;OBUOLIUKAI;8104220950;Ne;0;13;0;13
4109;Kodėlčiukas;OBUOLIUKAI;2005453189;Ne;4;0;0;4
4110;Kodėlčiukas;OBUOLIUKAI;1180399735;Ne;2;0;0;2
4111;Kodėlčiukas;OBUOLIUKAI;5173730926;Ne;0;6;0;6
4112;Kodėlčiukas;OBUOLIUKAI;3442449482;Ne;0;0;1;1
4113;Kodėlčiukas;OBUOLIUKAI;7946010973;Taip;0;11;0;11
4114;Kodėlčiukas;OBUOLIUKAI;5342852235;Ne;0;0;1;1
4115;Kodėlčiukas;OBUOLIUKAI;8563412043;Ne;5;0;0;5
4116;Kodėlčiukas;OBUOLIUKAI;4026784012;Ne;0;0;3;3
4117;Kodėlčiukas;OBUOLIUKAI;2114176689;Ne;0;22;0;22
4118;Kodėlčiukas;OBUOLIUKAI;3033687110;Ne;7;1;0;8
4119;Kurpaitė;Viščiukų;4657523142;Ne;0;2;0;2
4120;Kurpaitė;Viščiukų;2157581956;Ne;0;22;0;22
4121;Kurpaitė;Viščiukų;8402747029;Ne;0;2;0;2
4122;Kurpaitė;Viščiukų;2373582223;Ne;0;22;0;22
4123;Kurpaitė;Viščiukų;5175919323;Ne;0;1;0;1
4124;Kurpaitė;Viščiukų;7194351335;Ne;2;15;0;17
4125;Kurpaitė;Viščiukų;2744439309;Ne;0;5;0;5
4126;Kurpaitė;Viščiukų;5447826458;Ne;0;22;0;22
4127;Kurpaitė;Viščiukų;9825971721;Ne;0;2;0;2
4128;Kurpaitė;Viščiukų;6859316204;Ne;1;0;0;1
4129;Kurpaitė;Gėlyčių;9922582884;Ne;2;9;0;11
4130;Kurpaitė;Gėlyčių;7703075096;Ne;0;0;1;1
4131;Kurpaitė;Gėlyčių;2757100599;Ne;0;6;0;6
4132;Kurpaitė;Gėlyčių;5745448950;Ne;22;0;0;22
4133;Kurpaitė;Gėlyčių;3989274600;Ne;0;6;0;6
4134;Kurpaitė;Gėlyčių;3139272175;Ne;0;5;0;5
4135;Kurpaitė;Gėlyčių;4769611100;Ne;5;2;0;7
4136;Kurpaitė;Gėlyčių;4426311033;Ne;4;0;0;4
4137;Kurpaitė;Gėlyčių;1927773278;Ne;0;8;0;8
4138;Kurpaitė;Gėlyčių;3456815576;Ne;0;14;0;14
4139;Kurpaitė;Gėlyčių;8361612709;Ne;0;12;0;12
4140;Kurpaitė;Gėlyčių;4607835570;Ne;4;0;0;4
4141;Kurpaitė;Gėlyčių;2629958613;Ne;3;0;0;3
4142;Kurpaitė;Gėlyčių;2629958613;Ne;3;0;0;3
4143;Kurpaitė;Drugelių;3003517700;Ne;0;2;0;2
4144;Kurpaitė;Drugelių;9915241987;Ne;0;3;0;3
4145;Kurpaitė;Drugelių;9200404698;Ne;0;5;0;5
4146;Kurpaitė;Drugelių;5064875626;Ne;2;0;0;2
4147;Kurpaitė;Drugelių;4592795281;Ne;0;18;0;18
4148;Kurpaitė;Drugelių;8868415451;Ne;0;1;0;1
4149;Kurpaitė;Drugelių;4188925256;Ne;0;8;0;8
4150;Kurpaitė;Drugelių;1273426668;Ne;0;6;0;6
4151;Kurpaitė;Drugelių;3634641300;Ne;0;5;0;5
4152;Kurpaitė;Drugelių;4602268315;Ne;0;2;0;2
4153;Kurpaitė;Drugelių;8592478282;Ne;0;10;0;10
4154;Kurpaitė;Drugelių;6568580994;Ne;0;10;0;10
4155;Kurpaitė;Drugelių;5396599834;Ne;4;0;0;4
4156;Kurpaitė;Pelyčių;4964063637;Ne;4;0;0;4
4157;Kurpaitė;Pelyčių;7546409044;Ne;0;12;0;12
4158;Kurpaitė;Pelyčių;7249931704;Ne;0;8;0;8
4159;Kurpaitė;Pelyčių;1218040871;Ne;0;11;0;11
4160;Kurpaitė;Pelyčių;1505783589;Ne;0;8;0;8
4161;Kurpaitė;Pelyčių;2359555461;Ne;0;1;0;1
4162;Kurpaitė;Pelyčių;65434834152;Ne;0;2;0;2
4163;Kurpaitė;Pelyčių;9063294667;Ne;0;2;0;2
4164;Kurpaitė;Pelyčių;2827617670;Ne;0;7;0;7
4165;Kurpaitė;Pelyčių;1457318954;Ne;0;4;0;4
4166;Kurpaitė;Pelyčių;7897713994;Ne;0;1;0;1
4167;Kurpaitė;Pelyčių;4168882748;Ne;0;9;0;9
4168;Kurpaitė;Pelyčių;72710210157;Ne;0;0;1;1
4169;Kurpaitė;Pelyčių;58127430940;Ne;0;9;0;9
4170;Kurpaitė;Pelyčių;2116580903;Ne;0;3;0;3
4171;Kurpaitė;Pelyčių;24410351286;Ne;0;11;0;11
4172;"Kūlverstukas (Suvalkų g. 6)";Saulutės;7449993309;Ne;6;7;0;13
4173;"Kūlverstukas (Suvalkų g. 6)";Saulutės;2450625415;Ne;12;2;0;14
4174;"Kūlverstukas (Suvalkų g. 6)";Saulutės;2101490038;Ne;12;2;0;14
4175;"Kūlverstukas (Suvalkų g. 6)";Saulutės;9096819614;Ne;0;1;0;1
4176;"Kūlverstukas (Suvalkų g. 6)";Saulutės;2762230590;Ne;8;9;0;17
4177;"Kūlverstukas (Suvalkų g. 6)";Saulutės;8319255735;Ne;0;8;1;9
4178;"Kūlverstukas (Suvalkų g. 6)";Saulutės;4846324136;Ne;0;4;0;4
4179;"Kūlverstukas (Suvalkų g. 6)";Saulutės;7505926208;Ne;2;0;0;2
4180;"Kūlverstukas (Suvalkų g. 6)";Saulutės;1014630718;Ne;2;0;0;2
4181;"Kūlverstukas (Suvalkų g. 6)";Saulutės;1795306946;Ne;10;0;0;10
4182;"Kūlverstukas (Suvalkų g. 6)";Saulutės;1898905623;Ne;4;0;0;4
4183;"Kūlverstukas (Suvalkų g. 6)";Saulutės;5340239466;Ne;0;4;0;4
4184;"Kūlverstukas (Suvalkų g. 6)";Saulutės;3448880105;Ne;0;4;2;6
4185;"Kūlverstukas (Suvalkų g. 6)";Saulutės;8294873714;Ne;0;15;0;15
4186;"Kūlverstukas (Suvalkų g. 6)";Saulutės;7970898546;Ne;0;1;0;1
4187;"Kūlverstukas (Suvalkų g. 6)";Saulutės;4532151103;Ne;4;14;0;18
4188;"Kūlverstukas (Suvalkų g. 6)";Saulutės;8353856412;Ne;0;15;0;15
4189;"Kūlverstukas (Suvalkų g. 6)";Saulutės;4173514390;Ne;0;1;0;1
4190;"Kūlverstukas (Suvalkų g. 6)";Peledžiukai;5488011852;Ne;0;0;4;4
4191;"Kūlverstukas (Suvalkų g. 6)";Peledžiukai;3937419139;Ne;0;0;2;2
4192;"Kūlverstukas (Suvalkų g. 6)";Peledžiukai;1452422691;Ne;0;1;3;4
4193;"Kūlverstukas (Suvalkų g. 6)";Peledžiukai;4396230034;Ne;0;22;0;22
4194;"Kūlverstukas (Suvalkų g. 6)";Peledžiukai;7359354944;Ne;1;0;0;1
4195;"Kūlverstukas (Suvalkų g. 6)";Peledžiukai;8092104136;Ne;0;0;8;8
4196;"Kūlverstukas (Suvalkų g. 6)";Peledžiukai;3238807604;Ne;0;1;0;1
4197;"Kūlverstukas (Suvalkų g. 6)";Peledžiukai;1932066021;Ne;0;0;2;2
4198;"Kūlverstukas (Suvalkų g. 6)";Peledžiukai;9655585527;Ne;0;2;0;2
4199;"Kūlverstukas (Suvalkų g. 6)";Peledžiukai;5488852698;Ne;8;0;0;8
4200;"Kūlverstukas (Suvalkų g. 6)";Peledžiukai;7480593611;Ne;12;0;0;12
4201;"Kūlverstukas (Suvalkų g. 6)";Peledžiukai;5345423038;Ne;0;9;0;9
4202;"Kūlverstukas (Suvalkų g. 6)";Peledžiukai;4285624305;Ne;0;1;0;1
4203;"Kūlverstukas (Suvalkų g. 6)";Peledžiukai;6894291912;Ne;12;1;0;13
4204;"Kūlverstukas (Suvalkų g. 6)";Peledžiukai;6287636806;Ne;0;1;5;6
4205;"Kūlverstukas (Suvalkų g. 6)";Gelytės;3811616695;Ne;0;4;7;11
4206;"Kūlverstukas (Suvalkų g. 6)";Gelytės;8346712630;Ne;3;0;3;6
4207;"Kūlverstukas (Suvalkų g. 6)";Gelytės;1939668692;Ne;10;0;0;10
4208;"Kūlverstukas (Suvalkų g. 6)";Gelytės;3196099819;Ne;0;0;1;1
4209;"Kūlverstukas (Suvalkų g. 6)";Gelytės;7112217569;Ne;7;0;2;9
4210;"Kūlverstukas (Suvalkų g. 6)";Gelytės;5391554530;Ne;0;4;0;4
4211;"Kūlverstukas (Suvalkų g. 6)";Gelytės;8701405518;Ne;0;22;0;22
4212;"Kūlverstukas (Suvalkų g. 6)";Gelytės;4111966910;Ne;0;1;1;2
4213;"Kūlverstukas (Suvalkų g. 6)";Gelytės;8964753108;Ne;0;1;0;1
4214;"Kūlverstukas (Suvalkų g. 6)";Gelytės;2389231051;Ne;0;1;0;1
4215;"Kūlverstukas (Suvalkų g. 6)";Gelytės;1067182820;Ne;0;0;4;4
4216;"Kūlverstukas (Suvalkų g. 6)";Gelytės;1967837561;Ne;0;0;1;1
4217;"Kūlverstukas (Suvalkų g. 6)";Gelytės;8333084277;Ne;0;4;6;10
4218;"Kūlverstukas (Suvalkų g. 6)";Gelytės;6710735721;Ne;0;4;2;6
4219;"Kūlverstukas (Suvalkų g. 6)";Gelytės;8618967238;Ne;4;10;4;18
4220;"Kūlverstukas (Suvalkų g. 6)";Gelytės;3790418633;Ne;0;8;0;8
4221;"Kūlverstukas (Suvalkų g. 6)";Gelytės;1679412281;Ne;0;8;0;8
4222;"Kūlverstukas (Suvalkų g. 6)";Bitutės;9777005699;Ne;4;0;0;4
4223;"Kūlverstukas (Suvalkų g. 6)";Bitutės;8599785196;Ne;7;0;0;7
4224;"Kūlverstukas (Suvalkų g. 6)";Bitutės;6319075079;Ne;17;0;4;21
4225;"Kūlverstukas (Suvalkų g. 6)";Bitutės;1062604474;Ne;9;0;2;11
4226;"Kūlverstukas (Suvalkų g. 6)";Bitutės;3712773480;Ne;0;0;5;5
4227;"Kūlverstukas (Suvalkų g. 6)";Bitutės;1985177751;Ne;0;3;1;4
4228;"Kūlverstukas (Suvalkų g. 6)";Bitutės;2924333435;Ne;5;0;2;7
4229;"Kūlverstukas (Suvalkų g. 6)";Bitutės;9787833724;Ne;5;0;1;6
4230;"Kūlverstukas (Suvalkų g. 6)";Bitutės;3370339665;Ne;4;0;0;4
4231;"Kūlverstukas (Suvalkų g. 6)";Bitutės;6916013898;Ne;2;10;0;12
4232;"Kūlverstukas (Suvalkų g. 6)";Bitutės;4694784301;Ne;11;9;0;20
4233;"Kūlverstukas (Suvalkų g. 6)";Bitutės;9976311692;Ne;0;15;0;15
4234;Lakštingala;Saulutės;2156571482;Ne;0;2;3;5
4235;Lakštingala;Saulutės;4651600682;Ne;10;0;0;10
4236;Lakštingala;Saulutės;2084960114;Ne;4;0;7;11
4237;Lakštingala;Saulutės;3911509979;Ne;4;2;0;6
4238;Lakštingala;Saulutės;1598639284;Ne;0;2;7;9
4239;Lakštingala;Saulutės;3723986383;Ne;0;0;2;2
4240;Lakštingala;Saulutės;1243254166;Ne;9;5;0;14
4241;Lakštingala;Saulutės;9628476764;Ne;0;2;3;5
4242;Lakštingala;Saulutės;4344553248;Ne;0;0;16;16
4243;Lakštingala;Saulutės;9457533516;Ne;0;0;2;2
4244;Lakštingala;Saulutės;6567480562;Ne;3;1;0;4
4245;Lakštingala;Saulutės;9495341480;Ne;0;12;0;12
4246;Lakštingala;Saulutės;2543779273;Ne;5;2;2;9
4247;Lakštingala;Saulutės;2093953744;Ne;2;2;2;6
4248;Lakštingala;Saulutės;1074616528;Ne;0;0;3;3
4249;Lakštingala;Saulutės;2626498928;Ne;6;0;0;6
4250;Lakštingala;Saulutės;9441296489;Ne;0;2;5;7
4251;Lakštingala;Saulutės;9297542026;Ne;0;4;0;4
4252;Lakštingala;Saulutės;9899997020;Ne;0;0;1;1
4253;Lakštingala;Saulutės;8130468345;Ne;4;1;0;5
4254;Lakštingala;Nykštukai;9725851433;Ne;0;0;9;9
4255;Lakštingala;Nykštukai;8217315818;Ne;3;0;1;4
4256;Lakštingala;Nykštukai;2769474812;Ne;0;0;5;5
4257;Lakštingala;Nykštukai;9879064676;Ne;2;0;0;2
4258;Lakštingala;Nykštukai;2941128360;Ne;0;1;0;1
4259;Lakštingala;Nykštukai;9912622093;Ne;0;0;1;1
4260;Lakštingala;Nykštukai;3509165175;Ne;7;0;2;9
4261;Lakštingala;Nykštukai;3993759015;Ne;0;10;0;10
4262;Lakštingala;Nykštukai;5445945319;Ne;0;15;0;15
4263;Lakštingala;Nykštukai;6332498461;Ne;0;0;2;2
4264;Lakštingala;Nykštukai;1655202909;Ne;2;2;0;4
4265;Lakštingala;Nykštukai;6009631424;Ne;0;1;0;1
4266;Lakštingala;Nykštukai;5162605666;Ne;0;0;2;2
4267;Lakštingala;Nykštukai;2073818724;Ne;9;0;1;10
4268;Lakštingala;Nykštukai;1863034132;Ne;0;0;22;22
4269;Lakštingala;Nykštukai;6292331193;Ne;1;0;0;1
4270;Lakštingala;Nykštukai;9489982241;Ne;0;2;0;2
4271;Lakštingala;Nykštukai;4032030375;Ne;0;7;0;7
4272;Lakštingala;Nykštukai;2652305131;Ne;0;0;4;4
4273;Lakštingala;Nykštukai;7963839249;Ne;0;6;5;11
4274;Lakštingala;Nykštukai;9375002191;Ne;0;12;0;12
4275;Lakštingala;Nykštukai;4179366572;Ne;0;0;22;22
4276;Lakštingala;Nykštukai;4857448665;Ne;0;1;0;1
4277;Lakštingala;Bitutės;8890852891;Ne;0;1;1;2
4278;Lakštingala;Bitutės;7918688955;Ne;5;1;0;6
4279;Lakštingala;Bitutės;1832608585;Ne;2;0;1;3
4280;Lakštingala;Bitutės;9958821769;Ne;5;0;0;5
4281;Lakštingala;Bitutės;7953724873;Ne;0;1;0;1
4282;Lakštingala;Bitutės;7900597697;Ne;0;1;4;5
4283;Lakštingala;Bitutės;1411121466;Ne;0;0;15;15
4284;Lakštingala;Bitutės;8944088082;Ne;0;0;12;12
4285;Lakštingala;Bitutės;9897713625;Ne;0;1;0;1
4286;Lakštingala;Bitutės;2104150466;Ne;0;0;1;1
4287;Lakštingala;Bitutės;70798601578;Ne;0;5;0;5
4288;Lakštingala;Bitutės;1265027238;Ne;0;1;0;1
4289;Lakštingala;Bitutės;1736130324;Ne;0;9;0;9
4290;Lakštingala;Bitutės;2039579203;Ne;0;9;0;9
4291;Lakštingala;Bitutės;5672932116;Ne;0;0;22;22
4292;Lakštingala;Bitutės;5598711072;Ne;0;7;0;7
4293;Lakštingala;Bitutės;9346986726;Ne;0;1;0;1
4294;Lakštingala;Bitutės;3872205876;Ne;7;0;0;7
4295;Lakštingala;Bitutės;5920907667;Ne;0;1;7;8
4296;Lakštingala;Bitutės;8679582358;Ne;22;0;0;22
4297;Lakštingala;Bitutės;2266870318;Ne;0;1;6;7
4298;Lakštingala;Pūkeliai;9774836470;Ne;7;2;3;12
4299;Lakštingala;Pūkeliai;1958696382;Ne;0;1;1;2
4300;Lakštingala;Pūkeliai;4542992319;Ne;5;0;0;5
4301;Lakštingala;Pūkeliai;2593030897;Ne;0;8;0;8
4302;Lakštingala;Pūkeliai;6908873466;Ne;1;0;0;1
4303;Lakštingala;Pūkeliai;7929034243;Ne;6;6;0;12
4304;Lakštingala;Pūkeliai;2130192341;Ne;5;0;0;5
4305;Lakštingala;Pūkeliai;8165998647;Ne;17;0;0;17
4306;Lakštingala;Pūkeliai;1458348357;Ne;22;0;0;22
4307;Lakštingala;Pūkeliai;4465752871;Ne;0;0;5;5
4308;Lakštingala;Pūkeliai;4722328994;Ne;2;0;3;5
4309;Lakštingala;Pūkeliai;7272454093;Ne;3;1;3;7
4310;Lakštingala;Pūkeliai;1587899391;Ne;4;0;0;4
4311;Lakštingala;Pūkeliai;6234559044;Ne;0;0;1;1
4312;Lakštingala;Pūkeliai;5051773825;Ne;7;0;0;7
4313;Lakštingala;Pūkeliai;9390342572;Ne;7;7;0;14
4314;Lakštingala;Pūkeliai;9694524137;Ne;0;0;1;1
4315;Lakštingala;Pūkeliai;5949665703;Ne;3;0;0;3
4316;Lakštingala;Pūkeliai;6565318145;Ne;0;1;0;1
4317;Lakštingala;Pūkeliai;4384468922;Ne;1;0;5;6
4318;Lakštingala;Pūkeliai;2423761155;Ne;11;3;1;15
4319;Lakštingala;Pūkeliai;8171357606;Ne;0;6;0;6
4320;Lakštingala;Aitvariukai;1474796466;Ne;0;1;0;1
4321;Lakštingala;Aitvariukai;9629855134;Ne;0;1;0;1
4322;Lakštingala;Aitvariukai;4546036762;Ne;3;1;0;4
4323;Lakštingala;Aitvariukai;6219896499;Ne;12;6;0;18
4324;Lakštingala;Aitvariukai;7876311404;Ne;7;2;0;9
4325;Lakštingala;Aitvariukai;1248909711;Ne;13;0;0;13
4326;Lakštingala;Aitvariukai;9676872125;Ne;9;1;0;10
4327;Lakštingala;Aitvariukai;9083753159;Ne;0;5;0;5
4328;Lakštingala;Aitvariukai;7879280198;Ne;2;5;0;7
4329;Lakštingala;Aitvariukai;4403673558;Taip;7;3;0;10
4330;Lakštingala;Aitvariukai;5693413287;Ne;14;2;0;16
4331;Lakštingala;Aitvariukai;7240426529;Ne;9;2;0;11
4332;Lakštingala;Aitvariukai;8558000223;Ne;10;1;0;11
4333;Lakštingala;Aitvariukai;5244646855;Ne;8;1;0;9
4334;Lakštingala;Aitvariukai;5602079341;Ne;11;5;0;16
4335;Lakštingala;Aitvariukai;7404386777;Ne;0;1;0;1
4336;Lakštingala;Aitvariukai;3166474163;Ne;5;0;0;5
4337;Lakštingala;Aitvariukai;8609822839;Ne;5;0;1;6
4338;Lakštingala;Aitvariukai;6180443056;Ne;0;1;2;3
4339;Lakštingala;Boružiukai;9795993812;Ne;0;5;0;5
4340;Lakštingala;Boružiukai;9004336424;Ne;0;8;0;8
4341;Lakštingala;Boružiukai;8820053026;Ne;0;1;0;1
4342;Lakštingala;Boružiukai;2072883878;Ne;0;1;0;1
4343;Lakštingala;Boružiukai;4811759034;Ne;0;8;0;8
4344;Lakštingala;Boružiukai;1898853302;Ne;0;1;0;1
4345;Lakštingala;Boružiukai;7443563000;Ne;0;0;2;2
4346;Lakštingala;Boružiukai;55720630870;Ne;0;0;1;1
4347;Lakštingala;Boružiukai;4818524423;Ne;6;2;3;11
4348;Lakštingala;Boružiukai;1444534032;Ne;0;2;0;2
4349;Lakštingala;Boružiukai;9724531753;Ne;0;6;0;6
4350;Lakštingala;Boružiukai;1106475925;Ne;0;0;1;1
4351;Lakštingala;Boružiukai;1667277983;Ne;0;1;0;1
4352;Lakštingala;Boružiukai;6947565845;Ne;0;10;1;11
4353;Lakštingala;Boružiukai;3009692491;Ne;0;0;1;1
4354;Lakštingala;Boružiukai;1800927281;Ne;7;2;0;9
4355;Lakštingala;Boružiukai;9998322501;Ne;0;2;1;3
4356;Lakštingala;Boružiukai;8284565948;Ne;13;2;0;15
4357;Lakštingala;Boružiukai;2423651716;Ne;0;0;1;1
4358;Lakštingala;Boružiukai;9445476887;Ne;0;0;6;6
4359;Lakštingala;Boružiukai;8899572475;Ne;0;0;3;3
4360;Lakštingala;Boružiukai;9492056071;Ne;0;2;2;4
4361;Lakštingala;Žiogeliai;5048686136;Ne;0;2;0;2
4362;Lakštingala;Žiogeliai;8404025659;Ne;0;0;12;12
4363;Lakštingala;Žiogeliai;4113993067;Ne;0;3;0;3
4364;Lakštingala;Žiogeliai;6981178960;Ne;0;7;1;8
4365;Lakštingala;Žiogeliai;3908175786;Ne;5;0;17;22
4366;Lakštingala;Žiogeliai;9860169528;Ne;9;0;2;11
4367;Lakštingala;Žiogeliai;4935753482;Ne;6;0;10;16
4368;Lakštingala;Žiogeliai;5008933316;Ne;0;0;1;1
4369;Lakštingala;Žiogeliai;3439681068;Ne;0;1;1;2
4370;Lakštingala;Žiogeliai;3766986041;Ne;0;10;8;18
4371;Lakštingala;Žiogeliai;1974950823;Ne;0;15;0;15
4372;Lakštingala;Žiogeliai;6561743084;Ne;0;0;3;3
4373;Lakštingala;Žiogeliai;1226908540;Ne;0;0;6;6
4374;Lakštingala;Žiogeliai;3951057865;Ne;0;7;10;17
4375;Lakštingala;Žiogeliai;1494530289;Ne;2;0;1;3
4376;Lakštingala;Žiogeliai;7661973162;Ne;10;0;5;15
4377;Lakštingala;Žiogeliai;7104398627;Ne;5;4;5;14
4378;Lakštingala;Žiogeliai;7361353346;Ne;5;4;0;9
4379;Lakštingala;Žiogeliai;4790291839;Ne;3;0;0;3
4380;Lakštingala;Žiogeliai;8351970017;Ne;0;1;1;2
4381;Lakštingala;Žiogeliai;8333832673;Ne;0;8;3;11
4382;Lakštingala;Žiogeliai;6872095965;Ne;0;0;5;5
4383;Lakštingala;SPINDULIUKAI;4365413054;Ne;6;0;7;13
4384;Lakštingala;SPINDULIUKAI;9762500668;Ne;2;7;1;10
4385;Lakštingala;SPINDULIUKAI;7640007392;Ne;0;8;0;8
4386;Lakštingala;SPINDULIUKAI;4784677514;Ne;2;1;1;4
4387;Lakštingala;SPINDULIUKAI;1619201521;Ne;2;5;0;7
4388;Lakštingala;SPINDULIUKAI;2022621678;Ne;2;0;2;4
4389;Lakštingala;SPINDULIUKAI;8429523368;Ne;2;2;3;7
4390;Lakštingala;SPINDULIUKAI;6668075753;Ne;9;0;3;12
4391;Lakštingala;SPINDULIUKAI;9081653166;Ne;0;3;0;3
4392;Lakštingala;SPINDULIUKAI;6780591792;Ne;10;0;0;10
4393;Lakštingala;SPINDULIUKAI;4698879435;Ne;7;0;0;7
4394;Lakštingala;SPINDULIUKAI;8722490845;Ne;7;0;1;8
4395;Lakštingala;SPINDULIUKAI;1220858944;Ne;0;1;1;2
4396;Lakštingala;SPINDULIUKAI;3823860988;Ne;2;0;1;3
4397;Lakštingala;SPINDULIUKAI;7141840160;Ne;0;1;0;1
4398;Lakštingala;SPINDULIUKAI;3282771613;Ne;3;2;0;5
4399;Lakštingala;SPINDULIUKAI;2795341401;Ne;0;2;1;3
4400;Lakštingala;SPINDULIUKAI;5815240975;Ne;0;4;0;4
4401;Lakštingala;Pėledžiukai;3520592784;Ne;0;2;0;2
4402;Lakštingala;Pėledžiukai;5258588961;Ne;0;0;4;4
4403;Lakštingala;Pėledžiukai;6135103377;Ne;0;1;0;1
4404;Lakštingala;Pėledžiukai;4774354751;Ne;0;2;8;10
4405;Lakštingala;Pėledžiukai;3369263112;Ne;3;2;6;11
4406;Lakštingala;Pėledžiukai;8375506323;Ne;0;2;3;5
4407;Lakštingala;Pėledžiukai;2738882466;Ne;0;12;0;12
4408;Lakštingala;Pėledžiukai;8717764626;Ne;6;0;6;12
4409;Lakštingala;Pėledžiukai;8075192528;Ne;0;2;8;10
4410;Lakštingala;Pėledžiukai;3766779594;Taip;0;7;0;7
4411;Lakštingala;Pėledžiukai;4270513515;Ne;0;1;0;1
4412;Lakštingala;Pėledžiukai;2514377385;Ne;0;2;0;2
4413;Lakštingala;Pėledžiukai;6161860331;Ne;5;0;0;5
4414;Lakštingala;Pėledžiukai;6866935290;Ne;20;0;0;20
4415;Lakštingala;Pėledžiukai;8787118512;Ne;17;1;0;18
4416;Lakštingala;Pėledžiukai;6805882038;Ne;5;2;6;13
4417;Lakštingala;Pėledžiukai;7139669240;Ne;0;2;0;2
4418;Lakštingala;Pėledžiukai;9502994399;Ne;4;0;2;6
4419;Lakštingala;Pėledžiukai;9431022632;Ne;3;0;3;6
4420;Lakštingala;Pėledžiukai;9856189053;Ne;0;2;2;4
4421;Lakštingala;Katinėliai;8861428074;Ne;4;0;0;4
4422;Lakštingala;Katinėliai;2346497467;Ne;10;0;1;11
4423;Lakštingala;Katinėliai;9894103692;Ne;0;2;2;4
4424;Lakštingala;Katinėliai;8800538473;Ne;13;0;0;13
4425;Lakštingala;Katinėliai;9093654437;Ne;0;0;6;6
4426;Lakštingala;Katinėliai;6011421835;Ne;0;0;3;3
4427;Lakštingala;Katinėliai;2673030043;Ne;2;0;0;2
4428;Lakštingala;Katinėliai;2010478542;Ne;7;0;11;18
4429;Lakštingala;Katinėliai;1371422364;Ne;0;0;2;2
4430;Lakštingala;Katinėliai;6285766353;Ne;9;0;0;9
4431;Lakštingala;Katinėliai;3877448215;Ne;0;0;5;5
4432;Lakštingala;Katinėliai;6148942052;Ne;0;0;6;6
4433;Lakštingala;Katinėliai;7623917384;Ne;6;0;0;6
4434;Lakštingala;Katinėliai;1903292595;Ne;11;2;10;23
4435;Lakštingala;Katinėliai;6764453371;Ne;4;1;0;5
4436;Lakštingala;Katinėliai;4184814075;Ne;4;1;0;5
4437;Lakštingala;Deimantėliai;8310446552;Ne;17;0;0;17
4438;Lakštingala;Deimantėliai;8063735934;Ne;0;1;0;1
4439;Lakštingala;Deimantėliai;7396235662;Ne;8;0;0;8
4440;Lakštingala;Deimantėliai;4725848201;Ne;14;0;0;14
4441;Lakštingala;Deimantėliai;6930466455;Taip;7;3;0;10
4442;Lakštingala;Deimantėliai;2165808562;Ne;11;1;0;12
4443;Lakštingala;Deimantėliai;3352073562;Ne;0;0;20;20
4444;Lakštingala;Deimantėliai;5539054769;Ne;9;0;0;9
4445;Lakštingala;Deimantėliai;6974936332;Ne;7;0;0;7
4446;Lakštingala;Deimantėliai;8663938939;Ne;12;0;0;12
4447;Lakštingala;Deimantėliai;6231045485;Ne;0;7;0;7
4448;Lakštingala;Deimantėliai;5165517709;Ne;9;0;0;9
4449;Lakštingala;Deimantėliai;5965026791;Ne;0;2;0;2
4450;Lakštingala;KIŠKUČIAI;6520436055;Ne;20;0;0;20
4451;Lakštingala;KIŠKUČIAI;3208321841;Ne;0;1;8;9
4452;Lakštingala;KIŠKUČIAI;5464460112;Ne;0;2;0;2
4453;Lakštingala;KIŠKUČIAI;6970022417;Ne;5;0;1;6
4454;Lakštingala;KIŠKUČIAI;5730122965;Ne;0;2;14;16
4455;Lakštingala;KIŠKUČIAI;4140403601;Ne;0;7;1;8
4456;Lakštingala;KIŠKUČIAI;5119365443;Ne;8;2;0;10
4457;Lakštingala;KIŠKUČIAI;6689018476;Ne;0;2;0;2
4458;Lakštingala;KIŠKUČIAI;7017047366;Ne;0;0;5;5
4459;Lakštingala;KIŠKUČIAI;9539081376;Ne;0;0;6;6
4460;Lakštingala;KIŠKUČIAI;4854843534;Ne;0;0;2;2
4461;Lakštingala;KIŠKUČIAI;9162902701;Ne;0;0;19;19
4462;Lakštingala;KIŠKUČIAI;5455119187;Ne;3;0;0;3
4463;Lakštingala;KIŠKUČIAI;1113674539;Ne;3;0;3;6
4464;Lakštingala;KIŠKUČIAI;4370431439;Ne;0;1;0;1
4465;Lakštingala;KIŠKUČIAI;1898108870;Ne;0;0;21;21
4466;Lakštingala;KIŠKUČIAI;6652822827;Ne;0;1;3;4
4467;Lakštingala;KIŠKUČIAI;2998581623;Ne;10;2;0;12
4468;Lakštingala;KIŠKUČIAI;8414220381;Ne;3;0;2;5
4469;Lakštingala;KIŠKUČIAI;7817830649;Ne;0;11;0;11
4470;Lašelis;VIŠČIUKAI;6477439886;Ne;0;1;0;1
4471;Lašelis;VIŠČIUKAI;6912802425;Ne;22;0;0;22
4472;Lašelis;VIŠČIUKAI;6857428142;Ne;0;5;0;5
4473;Lašelis;VIŠČIUKAI;5759317067;Ne;12;2;0;14
4474;Lašelis;VIŠČIUKAI;1367955273;Ne;5;0;4;9
4475;Lašelis;VIŠČIUKAI;2702582486;Ne;11;2;0;13
4476;Lašelis;VIŠČIUKAI;2824852871;Ne;0;13;2;15
4477;Lašelis;VIŠČIUKAI;1517104634;Ne;0;3;0;3
4478;Lašelis;VIŠČIUKAI;1294930990;Ne;7;5;0;12
4479;Lašelis;VIŠČIUKAI;9440665009;Ne;0;0;1;1
4480;Lašelis;VIŠČIUKAI;2121080776;Taip;2;0;1;3
4481;Lašelis;VIŠČIUKAI;4427263877;Ne;0;0;6;6
4482;Lašelis;VIŠČIUKAI;1168408482;Ne;2;0;0;2
4483;Lašelis;VIŠČIUKAI;4860925464;Ne;5;0;0;5
4484;Lašelis;VIŠČIUKAI;8287867336;Ne;0;9;0;9
4485;Lašelis;ŠYPSENA;7137348151;Ne;6;0;0;6
4486;Lašelis;ŠYPSENA;1808067249;Ne;10;3;0;13
4487;Lašelis;ŠYPSENA;1060784180;Ne;3;3;0;6
4488;Lašelis;ŠYPSENA;2509469243;Ne;7;0;6;13
4489;Lašelis;ŠYPSENA;4832223461;Ne;7;0;5;12
4490;Lašelis;ŠYPSENA;5416590600;Ne;9;8;1;18
4491;Lašelis;ŠYPSENA;1490179832;Ne;0;10;0;10
4492;Lašelis;ŠYPSENA;6836452490;Ne;0;0;4;4
4493;Lašelis;ŠYPSENA;1983312896;Ne;8;2;0;10
4494;Lašelis;ŠYPSENA;1279052767;Ne;0;0;1;1
4495;Lašelis;ŠYPSENA;8906479495;Ne;0;0;16;16
4496;Lašelis;ŠYPSENA;2593126568;Ne;6;0;3;9
4497;Lašelis;ŠYPSENA;3995905195;Ne;0;22;0;22
4498;Lašelis;ŠYPSENA;6137626795;Ne;0;0;4;4
4499;Lašelis;ŠYPSENA;1635921119;Ne;0;5;0;5
4500;Lašelis;ŠYPSENA;9664015801;Ne;5;4;0;9
4501;Lašelis;ŠYPSENA;2606193652;Ne;0;0;4;4
4502;Lašelis;ŠYPSENA;9434932943;Ne;0;12;0;12
4503;Lašelis;NYKŠTUKAI;4508779926;Ne;0;0;2;2
4504;Lašelis;NYKŠTUKAI;1175045927;Ne;3;0;0;3
4505;Lašelis;NYKŠTUKAI;8132517365;Ne;19;0;0;19
4506;Lašelis;NYKŠTUKAI;1244168190;Ne;5;0;1;6
4507;Lašelis;NYKŠTUKAI;4566547120;Ne;0;1;0;1
4508;Lašelis;NYKŠTUKAI;1035888733;Ne;0;6;0;6
4509;Lašelis;NYKŠTUKAI;1926439959;Ne;0;9;0;9
4510;Lašelis;NYKŠTUKAI;8318512396;Ne;6;0;0;6
4511;Lašelis;NYKŠTUKAI;2886967297;Ne;3;1;0;4
4512;Lašelis;NYKŠTUKAI;3805049682;Ne;22;0;0;22
4513;Lašelis;NYKŠTUKAI;2401058384;Ne;6;0;2;8
4514;Lašelis;NYKŠTUKAI;1042560186;Ne;5;3;0;8
4515;Lašelis;NYKŠTUKAI;8814796010;Ne;5;4;3;12
4516;Lašelis;NYKŠTUKAI;2223293390;Taip;0;2;3;5
4517;Lašelis;NYKŠTUKAI;3675606390;Ne;0;22;0;22
4518;Lašelis;NYKŠTUKAI;9647340725;Ne;0;11;0;11
4519;Lašelis;SAULUTĖ;1460027521;Taip;11;3;0;14
4520;Lašelis;SAULUTĖ;6669130831;Ne;0;5;0;5
4521;Lašelis;SAULUTĖ;6829438486;Ne;0;0;5;5
4522;Lašelis;SAULUTĖ;6080664872;Ne;5;5;0;10
4523;Lašelis;SAULUTĖ;2204859014;Ne;8;2;0;10
4524;Lašelis;SAULUTĖ;3495676199;Ne;8;1;0;9
4525;Lašelis;SAULUTĖ;1085950130;Ne;0;0;1;1
4526;Lašelis;BORUŽĖLĖS;1343964112;Ne;15;0;0;15
4527;Lašelis;BORUŽĖLĖS;7502668870;Ne;0;6;0;6
4528;Lašelis;BORUŽĖLĖS;7418586100;Ne;19;0;2;21
4529;Lašelis;BORUŽĖLĖS;1429188137;Ne;0;0;3;3
4530;Lašelis;BORUŽĖLĖS;8394290574;Ne;15;3;0;18
4531;Lašelis;BORUŽĖLĖS;7811809908;Ne;3;3;0;6
4532;Lašelis;BORUŽĖLĖS;4893073148;Ne;5;0;0;5
4533;Lašelis;BORUŽĖLĖS;4113842551;Ne;8;1;0;9
4534;Lašelis;BORUŽĖLĖS;1882188961;Ne;16;0;0;16
4535;Lašelis;BORUŽĖLĖS;6317716501;Ne;0;0;2;2
4536;Lašelis;BORUŽĖLĖS;8905080707;Ne;0;4;0;4
4537;Lašelis;BORUŽĖLĖS;2991487552;Ne;12;0;2;14
4538;Lašelis;BORUŽĖLĖS;2210081848;Ne;7;0;0;7
4539;Lašelis;BORUŽĖLĖS;1131591230;Ne;18;0;0;18
4540;Lašelis;BORUŽĖLĖS;4051058266;Ne;0;7;0;7
4541;Lašelis;BORUŽĖLĖS;7784416134;Ne;0;7;0;7
4542;Lašelis;SKRUZDELIUKAI;8212250478;Ne;7;2;0;9
4543;Lašelis;SKRUZDELIUKAI;5000188106;Ne;9;4;0;13
4544;Lašelis;SKRUZDELIUKAI;6203027620;Ne;17;0;0;17
4545;Lašelis;SKRUZDELIUKAI;9954809499;Ne;1;6;0;7
4546;Lašelis;SKRUZDELIUKAI;6158377421;Ne;6;8;0;14
4547;Lašelis;SKRUZDELIUKAI;3130271837;Ne;5;1;0;6
4548;Lašelis;SKRUZDELIUKAI;2871149756;Ne;16;2;0;18
4549;Lašelis;SKRUZDELIUKAI;7920615797;Ne;17;0;0;17
4550;Lašelis;SKRUZDELIUKAI;7619426839;Ne;7;12;0;19
4551;Lašelis;SKRUZDELIUKAI;8718481664;Ne;17;0;0;17
4552;Lašelis;SKRUZDELIUKAI;5535348173;Ne;9;0;0;9
4553;Lazdynėlis;BITUTĖS;4881322530;Ne;6;0;0;6
4554;Lazdynėlis;BITUTĖS;1748260780;Ne;7;0;2;9
4555;Lazdynėlis;BITUTĖS;8159928299;Ne;7;0;0;7
4556;Lazdynėlis;BITUTĖS;7911328294;Ne;0;0;5;5
4557;Lazdynėlis;BITUTĖS;1450181711;Ne;0;1;0;1
4558;Lazdynėlis;BITUTĖS;2044188250;Ne;2;0;0;2
4559;Lazdynėlis;BITUTĖS;4142277927;Ne;0;7;1;8
4560;Lazdynėlis;BITUTĖS;2032759165;Taip;0;0;5;5
4561;Lazdynėlis;BITUTĖS;4826167852;Ne;3;0;5;8
4562;Lazdynėlis;BITUTĖS;2802505435;Ne;0;0;2;2
4563;Lazdynėlis;BITUTĖS;2586187455;Ne;10;1;0;11
4564;Lazdynėlis;BITUTĖS;2013752858;Ne;0;0;7;7
4565;Lazdynėlis;BITUTĖS;4545757725;Ne;5;0;1;6
4566;Lazdynėlis;BITUTĖS;5562900372;Ne;0;22;0;22
4567;Lazdynėlis;BITUTĖS;6963058612;Ne;0;7;0;7
4568;Lazdynėlis;BITUTĖS;6920441303;Ne;0;0;3;3
4569;Lazdynėlis;BITUTĖS;4153294595;Ne;4;0;0;4
4570;Lazdynėlis;BITUTĖS;7910561870;Ne;0;22;0;22
4571;Lazdynėlis;BITUTĖS;4809829190;Ne;0;0;1;1
4572;Lazdynėlis;EŽIUKAI;9362249595;Ne;4;0;0;4
4573;Lazdynėlis;EŽIUKAI;7135087818;Ne;7;0;1;8
4574;Lazdynėlis;EŽIUKAI;6352480127;Ne;0;2;2;4
4575;Lazdynėlis;EŽIUKAI;6814362584;Ne;4;5;4;13
4576;Lazdynėlis;EŽIUKAI;9219327706;Ne;0;1;0;1
4577;Lazdynėlis;EŽIUKAI;8229454863;Ne;0;0;8;8
4578;Lazdynėlis;EŽIUKAI;4747688220;Ne;5;0;0;5
4579;Lazdynėlis;EŽIUKAI;1312649234;Ne;0;0;2;2
4580;Lazdynėlis;EŽIUKAI;3040417651;Ne;3;2;7;12
4581;Lazdynėlis;EŽIUKAI;2354549025;Ne;7;0;0;7
4582;Lazdynėlis;EŽIUKAI;4293473176;Ne;2;0;3;5
4583;Lazdynėlis;EŽIUKAI;2723284353;Ne;0;2;1;3
4584;Lazdynėlis;EŽIUKAI;6008610525;Ne;9;6;0;15
4585;Lazdynėlis;EŽIUKAI;4031719765;Ne;0;2;4;6
4586;Lazdynėlis;BORUŽIUKAI;8337458289;Ne;0;22;0;22
4587;Lazdynėlis;BORUŽIUKAI;2592852361;Ne;0;22;0;22
4588;Lazdynėlis;BORUŽIUKAI;7692056055;Ne;2;4;0;6
4589;Lazdynėlis;BORUŽIUKAI;2009941344;Ne;0;0;5;5
4590;Lazdynėlis;BORUŽIUKAI;1653216959;Ne;9;0;0;9
4591;Lazdynėlis;BORUŽIUKAI;4190852647;Ne;0;0;6;6
4592;Lazdynėlis;BORUŽIUKAI;2058909635;Ne;0;1;0;1
4593;Lazdynėlis;BORUŽIUKAI;3105363578;Ne;5;17;0;22
4594;Lazdynėlis;BORUŽIUKAI;5622254334;Ne;15;0;0;15
4595;Lazdynėlis;BORUŽIUKAI;7587041613;Ne;5;0;0;5
4596;Lazdynėlis;BORUŽIUKAI;2632078843;Ne;18;0;0;18
4597;Lazdynėlis;BORUŽIUKAI;5756228709;Ne;0;9;0;9
4598;Lazdynėlis;BORUŽIUKAI;1707231039;Ne;0;22;0;22
4599;Lazdynėlis;BORUŽIUKAI;6413861274;Ne;3;0;0;3
4600;Lazdynėlis;BORUŽIUKAI;8030743153;Ne;3;0;0;3
4601;Lazdynėlis;BORUŽIUKAI;4642875037;Ne;6;2;0;8
4602;Lazdynėlis;BORUŽIUKAI;1722503577;Ne;9;0;0;9
4603;Lazdynėlis;BORUŽIUKAI;4595080695;Ne;0;22;0;22
4604;Lazdynėlis;BORUŽIUKAI;4958640516;Ne;0;0;1;1
4605;Lazdynėlis;BORUŽIUKAI;3351966091;Ne;0;22;0;22
4606;Lazdynėlis;BORUŽIUKAI;9548866880;Ne;4;2;0;6
4607;Lazdynėlis;KAČIUKAI;5888646355;Ne;0;7;0;7
4608;Lazdynėlis;KAČIUKAI;5708643953;Ne;0;2;1;3
4609;Lazdynėlis;KAČIUKAI;8295967906;Ne;0;1;0;1
4610;Lazdynėlis;KAČIUKAI;1424382629;Ne;5;1;1;7
4611;Lazdynėlis;KAČIUKAI;6787228086;Ne;0;0;12;12
4612;Lazdynėlis;KAČIUKAI;4842228703;Ne;3;0;2;5
4613;Lazdynėlis;KAČIUKAI;6542840562;Ne;0;1;1;2
4614;Lazdynėlis;KAČIUKAI;1265404063;Ne;0;9;0;9
4615;Lazdynėlis;KAČIUKAI;5301460250;Ne;4;8;0;12
4616;Lazdynėlis;KAČIUKAI;2958520599;Ne;0;0;8;8
4617;Lazdynėlis;KAČIUKAI;73057057862;Ne;12;2;1;15
4618;Lazdynėlis;KAČIUKAI;7455989945;Ne;5;1;2;8
4619;Lazdynėlis;KAČIUKAI;1817075429;Ne;0;1;0;1
4620;Lazdynėlis;KAČIUKAI;5030460904;Ne;0;0;2;2
4621;Lazdynėlis;KAČIUKAI;2164717183;Ne;0;0;10;10
4622;Lazdynėlis;KAČIUKAI;5031826548;Ne;7;0;0;7
4623;Lazdynėlis;KAČIUKAI;6657174602;Ne;0;0;5;5
4624;Lazdynėlis;VOVERIUKAI;6994408527;Ne;2;0;6;8
4625;Lazdynėlis;VOVERIUKAI;8159724466;Ne;4;0;0;4
4626;Lazdynėlis;VOVERIUKAI;5051632567;Ne;16;7;0;23
4627;Lazdynėlis;VOVERIUKAI;6276697479;Ne;3;7;0;10
4628;Lazdynėlis;VOVERIUKAI;1335000592;Ne;0;2;1;3
4629;Lazdynėlis;VOVERIUKAI;2514035189;Ne;3;10;8;21
4630;Lazdynėlis;VOVERIUKAI;5889772626;Ne;0;4;0;4
4631;Lazdynėlis;VOVERIUKAI;6559543013;Ne;16;0;0;16
4632;Lazdynėlis;VOVERIUKAI;9231049001;Ne;0;2;1;3
4633;Lazdynėlis;VOVERIUKAI;9886856760;Ne;9;0;0;9
4634;Lazdynėlis;VOVERIUKAI;2998606948;Ne;4;2;1;7
4635;Lazdynėlis;VOVERIUKAI;6164180360;Ne;0;1;0;1
4636;Lazdynėlis;VOVERIUKAI;6415858184;Ne;0;10;0;10
4637;Lazdynėlis;VOVERIUKAI;5796381191;Ne;13;2;1;16
4638;Lazdynėlis;VOVERIUKAI;3062408541;Ne;0;3;0;3
4639;Lazdynėlis;VOVERIUKAI;3779983775;Ne;0;1;0;1
4640;Lazdynėlis;VOVERIUKAI;4550819172;Ne;0;2;1;3
4641;Lazdynėlis;VOVERIUKAI;4771173060;Ne;13;0;1;14
4642;Lazdynėlis;VOVERIUKAI;8314002741;Ne;5;0;1;6
4643;Lazdynėlis;VOVERIUKAI;3365726271;Ne;0;1;0;1
4644;Lazdynėlis;VOVERIUKAI;1355954767;Ne;5;0;0;5
4645;Lazdynėlis;VOVERIUKAI;7941793866;Ne;12;5;0;17
4646;Lazdynėlis;RIEŠUTĖLIAI;3086059608;Ne;5;1;1;7
4647;Lazdynėlis;RIEŠUTĖLIAI;9693153118;Ne;2;2;0;4
4648;Lazdynėlis;RIEŠUTĖLIAI;6056618348;Ne;0;22;0;22
4649;Lazdynėlis;RIEŠUTĖLIAI;5987500024;Ne;4;0;0;4
4650;Lazdynėlis;RIEŠUTĖLIAI;2453740823;Ne;15;2;0;17
4651;Lazdynėlis;RIEŠUTĖLIAI;4552505857;Ne;5;1;0;6
4652;Lazdynėlis;RIEŠUTĖLIAI;7545621720;Ne;3;0;0;3
4653;Lazdynėlis;RIEŠUTĖLIAI;8179584161;Ne;0;6;0;6
4654;Lazdynėlis;RIEŠUTĖLIAI;3239107488;Ne;0;5;0;5
4655;Lazdynėlis;RIEŠUTĖLIAI;4055450300;Ne;22;0;0;22
4656;Lazdynėlis;RIEŠUTĖLIAI;8942906327;Ne;8;1;0;9
4657;Lazdynėlis;RIEŠUTĖLIAI;3362193379;Ne;0;1;1;2
4658;Lazdynėlis;RIEŠUTĖLIAI;3062924645;Ne;6;0;0;6
4659;Lazdynėlis;RIEŠUTĖLIAI;3667994076;Ne;9;0;0;9
4660;Lazdynėlis;RIEŠUTĖLIAI;7523052754;Ne;0;0;1;1
4661;Lazdynėlis;RIEŠUTĖLIAI;1668899344;Ne;4;1;1;6
4662;Lazdynėlis;RIEŠUTĖLIAI;4092363029;Ne;9;2;0;11
4663;Lazdynėlis;RIEŠUTĖLIAI;3250913116;Ne;5;1;1;7
4664;Lazdynėlis;RIEŠUTĖLIAI;8529192130;Ne;6;0;0;6
4665;Lazdynėlis;RIEŠUTĖLIAI;7719697394;Ne;11;1;0;12
4666;Lazdynėlis;ANČIUKAI;9519409694;Ne;3;0;0;3
4667;Lazdynėlis;ANČIUKAI;2526260625;Ne;3;0;0;3
4668;Lazdynėlis;ANČIUKAI;6031442797;Ne;0;6;0;6
4669;Lazdynėlis;ANČIUKAI;7552873109;Ne;13;0;0;13
4670;Lazdynėlis;ANČIUKAI;7655218276;Ne;5;0;0;5
4671;Lazdynėlis;ANČIUKAI;7561833526;Ne;2;0;1;3
4672;Lazdynėlis;ANČIUKAI;6817162699;Ne;8;5;0;13
4673;Lazdynėlis;ANČIUKAI;2294873565;Ne;8;0;1;9
4674;Lazdynėlis;ANČIUKAI;1499729462;Ne;7;1;4;12
4675;Lazdynėlis;ANČIUKAI;8530159773;Ne;3;0;0;3
4676;Lazdynėlis;ANČIUKAI;2911152510;Ne;0;0;4;4
4677;Lazdynėlis;ANČIUKAI;2933025284;Ne;11;4;0;15
4678;Lazdynėlis;ANČIUKAI;5832624944;Ne;10;0;1;11
4679;Lazdynėlis;ANČIUKAI;1168433014;Ne;0;7;0;7
4680;Lazdynėlis;ANČIUKAI;3764854654;Ne;0;0;1;1
4681;Lazdynėlis;ANČIUKAI;1961540377;Ne;10;0;0;10
4682;Lazdynėlis;GUDRUČIAI;4425724586;Ne;0;0;2;2
4683;Lazdynėlis;GUDRUČIAI;4928593615;Ne;0;0;1;1
4684;Lazdynėlis;GUDRUČIAI;6684940385;Ne;0;0;1;1
4685;Lazdynėlis;GUDRUČIAI;9187681789;Ne;0;6;1;7
4686;Lazdynėlis;GUDRUČIAI;6307407620;Ne;0;0;2;2
4687;Lazdynėlis;GUDRUČIAI;1107441074;Ne;5;0;0;5
4688;Lazdynėlis;GUDRUČIAI;158059657;Ne;0;0;8;8
4689;Lazdynėlis;GUDRUČIAI;1852865534;Ne;5;0;0;5
4690;Lazdynėlis;GUDRUČIAI;2587142646;Ne;0;0;3;3
4691;Lazdynėlis;GUDRUČIAI;3902772678;Ne;0;1;0;1
4692;Lazdynėlis;GUDRUČIAI;8822378464;Ne;2;0;1;3
4693;Lazdynėlis;GUDRUČIAI;1386686123;Ne;7;0;0;7
4694;Lazdynėlis;GUDRUČIAI;6863715428;Ne;5;1;1;7
4695;Lazdynėlis;GUDRUČIAI;4779025603;Ne;7;0;8;15
4696;Lazdynėlis;GUDRUČIAI;3043350186;Ne;0;14;0;14
4697;Lazdynėlis;MEŠKIUKAI;4094713096;Ne;4;0;1;5
4698;Lazdynėlis;MEŠKIUKAI;4267469349;Ne;2;0;2;4
4699;Lazdynėlis;MEŠKIUKAI;5354852979;Ne;7;0;0;7
4700;Lazdynėlis;MEŠKIUKAI;3427972329;Ne;8;0;0;8
4701;Lazdynėlis;MEŠKIUKAI;6941986839;Ne;9;0;0;9
4702;Lazdynėlis;MEŠKIUKAI;3697808826;Ne;7;6;1;14
4703;Lazdynėlis;MEŠKIUKAI;2812633983;Ne;0;0;4;4
4704;Lazdynėlis;MEŠKIUKAI;9590507486;Ne;8;0;0;8
4705;Lazdynėlis;MEŠKIUKAI;1488371861;Ne;10;0;1;11
4706;Lazdynėlis;MEŠKIUKAI;5982766841;Ne;6;16;0;22
4707;Lazdynėlis;MEŠKIUKAI;4408660083;Ne;0;19;0;19
4708;Lazdynėlis;MEŠKIUKAI;9930553716;Ne;4;0;2;6
4709;Lazdynėlis;MEŠKIUKAI;6831456807;Ne;3;0;0;3
4710;Lazdynėlis;MEŠKIUKAI;4795464133;Ne;0;4;0;4
4711;Lazdynėlis;MEŠKIUKAI;8567304224;Ne;10;0;0;10
4712;Lazdynėlis;MEŠKIUKAI;7754329238;Ne;5;0;0;5
4713;Lazdynėlis;MEŠKIUKAI;4366502064;Ne;11;0;0;11
4714;Lazdynėlis;MEŠKIUKAI;1331380925;Ne;0;22;0;22
4715;Liepsnelė;Zuikučiai;4798353152;Ne;20;0;0;20
4716;Liepsnelė;Zuikučiai;8082265078;Ne;2;0;0;2
4717;Liepsnelė;Meškiukai;5138923652;Ne;15;0;0;15
4718;Liepsnelė;Meškiukai;4850013650;Ne;8;0;0;8
4719;Liepsnelė;SAULUTĖ;9864646484;Ne;9;0;0;9
4720;Liepsnelė;SAULUTĖ;8216737803;Ne;9;0;0;9
4721;Liepsnelė;SAULUTĖ;8216737803;Ne;9;0;0;9
4722;Liepsnelė;SAULUTĖ;8598242099;Ne;10;0;0;10
4723;"Lokiuko giraitė";Bitutės;5347988495;Ne;3;0;0;3
4724;"Lokiuko giraitė";Geniukų;6095929896;Ne;10;0;0;10
4725;"Lokiuko giraitė";Geniukų;4804464203;Ne;6;0;0;6
4726;"Lokiuko giraitė";Drugelių;5529404234;Ne;11;0;0;11
4727;"Lokiuko giraitė";Gandriukų;6033382372;Ne;22;0;0;22
4728;"Lokiuko giraitė";Gandriukų;5287134614;Ne;11;0;0;11
4729;"Lokiuko giraitė";Gandriukų;3862009155;Ne;7;0;0;7
4730;"Lokiuko giraitė";Gandriukų;5828857219;Ne;22;0;0;22
4731;"Lokiuko giraitė";Gandriukų;5672634750;Ne;17;0;0;17
4732;"Lokiuko giraitė";Gandriukų;2027726779;Ne;17;0;0;17
4733;"Lokiuko giraitė";Žiogelių;9368545424;Ne;10;0;0;10
4734;"Lokiuko giraitė";Žiogelių;4616888903;Ne;17;0;0;17
4735;"Lokiuko giraitė";Žiogelių;9467860399;Ne;4;0;0;4
4736;"Lokiuko giraitė";Žiogelių;3786260384;Ne;14;0;0;14
4737;"Lokiuko giraitė";Žiogelių;5453553670;Ne;6;0;0;6
4738;"Lokiuko giraitė";Žiogelių;3436606327;Ne;6;0;0;6
4739;"Lokiuko giraitė";Peliukų;2029494514;Ne;9;0;0;9
4740;"Lokiuko giraitė";Žvirbliukai;5973080803;Ne;3;0;0;3
4741;"Lokiuko giraitė";Voveriukų;1300397979;Ne;10;0;0;10
4742;"Lokiuko giraitė";PELĖDŽIUKŲ;7565904637;Ne;10;0;0;10
4743;"Lokiuko giraitė";PELĖDŽIUKŲ;7831508050;Ne;8;0;0;8
4744;"Lokiuko giraitė";PELĖDŽIUKŲ;2122510641;Ne;15;0;0;15
4745;"Lokiuko giraitė";PELĖDŽIUKŲ;8657413379;Ne;17;0;0;17
4746;"Lokiuko giraitė";PELĖDŽIUKŲ;3952024310;Ne;9;0;0;9
4747;"Lokiuko giraitė";PELĖDŽIUKŲ;2206053922;Ne;2;0;0;2
4748;"Lokiuko giraitė";PELĖDŽIUKŲ;8815290063;Ne;3;0;0;3
4749;"Lokiuko giraitė";KIŠKUČIŲ;7009062808;Ne;5;0;0;5
4750;"Lokiuko giraitė";KIŠKUČIŲ;3369075194;Ne;10;0;0;10
4751;"Lokiuko giraitė";KIŠKUČIŲ;5831978563;Ne;8;0;0;8
4752;"Lokiuko giraitė";KIŠKUČIŲ;1524540555;Ne;8;0;0;8
4753;"Lokiuko giraitė";BORUŽĖLIŲ;1143490905;Ne;6;0;0;6
4754;"Lokiuko giraitė";BORUŽĖLIŲ;9130870709;Ne;9;0;0;9
4755;"Lokiuko giraitė";BORUŽĖLIŲ;2908267390;Ne;4;0;0;4
4756;"Lokiuko giraitė";BORUŽĖLIŲ;6688280083;Ne;10;0;0;10
4757;"Lokiuko giraitė";EŽIUKŲ;8075543297;Ne;5;0;0;5
4758;"Lokiuko giraitė";EŽIUKŲ;1461506496;Ne;12;0;0;12
4759;Markučiai;Žirniukų;3525681034;Ne;0;9;0;9
4760;Markučiai;Žirniukų;7312533881;Ne;1;9;0;10
4761;Markučiai;Žirniukų;5250815223;Ne;0;3;1;4
4762;Markučiai;Žirniukų;8934965409;Ne;7;1;0;8
4763;Markučiai;Žirniukų;8360526946;Ne;0;28;0;28
4764;Markučiai;Žirniukų;7244815252;Ne;4;7;0;11
4765;Markučiai;Žirniukų;2096169972;Ne;0;6;0;6
4766;Markučiai;Žirniukų;3073404128;Ne;9;10;0;19
4767;Markučiai;Žirniukų;6674351628;Ne;8;0;1;9
4768;Markučiai;Žirniukų;5614488534;Ne;8;1;0;9
4769;Markučiai;Žirniukų;2367999201;Ne;10;6;1;17
4770;Markučiai;Žirniukų;4242575616;Ne;0;1;0;1
4771;Markučiai;Žirniukų;4223653505;Ne;5;8;0;13
4772;Markučiai;Žirniukų;2099285475;Taip;1;10;4;15
4773;Markučiai;Žirniukų;2344252204;Ne;0;22;10;32
4774;Markučiai;Žirniukų;9576412366;Ne;0;9;0;9
4775;Markučiai;Žirniukų;1395241501;Ne;0;10;2;12
4776;Markučiai;Nykštukų;7507551844;Ne;0;8;0;8
4777;Markučiai;Nykštukų;9545967631;Ne;0;0;2;2
4778;Markučiai;Nykštukų;6121911851;Ne;0;0;1;1
4779;Markučiai;Nykštukų;6898055631;Ne;0;1;2;3
4780;Markučiai;Nykštukų;3378749042;Ne;0;9;0;9
4781;Markučiai;Nykštukų;4485929800;Ne;0;6;0;6
4782;Markučiai;Nykštukų;5183244346;Ne;0;2;0;2
4783;Markučiai;Nykštukų;7624913025;Ne;0;6;0;6
4784;Markučiai;Nykštukų;4679710493;Ne;0;5;1;6
4785;Markučiai;Nykštukų;2994895532;Ne;9;1;0;10
4786;Markučiai;Nykštukų;4150956779;Ne;0;1;0;1
4787;Markučiai;Nykštukų;4920107818;Ne;0;0;1;1
4788;Markučiai;Nykštukų;7680126946;Ne;10;0;2;12
4789;Markučiai;Nykštukų;4222017733;Ne;0;0;1;1
4790;Markučiai;Nykštukų;3414015064;Ne;0;0;1;1
4791;Markučiai;Nykštukų;7642401516;Ne;0;2;3;5
4792;Markučiai;Nykštukų;8055783293;Ne;4;0;0;4
4793;Markučiai;Pelėdžiukų;9180404247;Ne;4;10;1;15
4794;Markučiai;Pelėdžiukų;4653663237;Ne;6;10;1;17
4795;Markučiai;Pelėdžiukų;5727655114;Ne;3;5;0;8
4796;Markučiai;Pelėdžiukų;6740434675;Ne;8;1;0;9
4797;Markučiai;Pelėdžiukų;6707310242;Ne;0;3;9;12
4798;Markučiai;Pelėdžiukų;7947287013;Ne;0;1;1;2
4799;Markučiai;Pelėdžiukų;4418580273;Ne;8;0;1;9
4800;Markučiai;Pelėdžiukų;5522654429;Ne;10;10;0;20
4801;Markučiai;Pelėdžiukų;9219710045;Ne;0;1;0;1
4802;Markučiai;Pelėdžiukų;7539605426;Ne;0;1;2;3
4803;Markučiai;Pelėdžiukų;8888538915;Ne;9;10;0;19
4804;Markučiai;Pelėdžiukų;1623728091;Ne;0;0;1;1
4805;Markučiai;Pelėdžiukų;1799946177;Ne;10;0;0;10
4806;Markučiai;Pelėdžiukų;7809719827;Taip;0;16;1;17
4807;Markučiai;Pelėdžiukų;4860961508;Ne;11;0;0;11
4808;Markučiai;Pelėdžiukų;6260010822;Ne;5;7;2;14
4809;Markučiai;Pelėdžiukų;6569807889;Ne;8;5;0;13
4810;Markučiai;Pelėdžiukų;5269411010;Ne;6;10;3;19
4811;Markučiai;Boružėlių;8078777204;Ne;7;0;6;13
4812;Markučiai;Boružėlių;8244065962;Ne;0;2;0;2
4813;Markučiai;Boružėlių;5902165968;Ne;8;0;0;8
4814;Markučiai;Boružėlių;5981692282;Ne;0;7;0;7
4815;Markučiai;Boružėlių;3739566642;Ne;5;3;0;8
4816;Markučiai;Boružėlių;6868394315;Ne;2;1;0;3
4817;Markučiai;Boružėlių;5663147778;Ne;0;0;7;7
4818;Markučiai;Boružėlių;8271830626;Ne;4;0;4;8
4819;Markučiai;Boružėlių;8046320044;Ne;0;7;0;7
4820;Markučiai;Boružėlių;3315824027;Ne;0;15;2;17
4821;Markučiai;Boružėlių;2060024771;Ne;12;0;0;12
4822;Markučiai;Boružėlių;2539486337;Ne;0;3;0;3
4823;Markučiai;Boružėlių;5562960498;Ne;0;11;3;14
4824;Markučiai;Bitučių;8792524832;Ne;0;6;2;8
4825;Markučiai;Bitučių;9518247571;Ne;0;2;2;4
4826;Markučiai;Bitučių;4836298058;Ne;5;9;2;16
4827;Markučiai;Bitučių;9027071539;Ne;5;1;1;7
4828;Markučiai;Bitučių;8748794886;Ne;0;10;5;15
4829;Markučiai;Bitučių;7387460586;Ne;0;5;0;5
4830;Markučiai;Bitučių;8950442843;Ne;8;7;1;16
4831;Markučiai;Bitučių;2840564082;Ne;0;10;0;10
4832;Markučiai;Bitučių;3926993383;Ne;0;8;6;14
4833;Markučiai;Bitučių;6530101961;Ne;0;13;5;18
4834;Markučiai;Bitučių;1908302738;Ne;0;20;1;21
4835;Markučiai;Bitučių;7056367646;Ne;9;10;0;19
4836;Markučiai;Bitučių;8195584468;Ne;0;1;0;1
4837;Markučiai;Bitučių;2049497686;Ne;0;14;0;14
4838;Markučiai;Bitučių;8541042547;Ne;9;0;3;12
4839;Markučiai;Bitučių;1447116821;Ne;7;1;2;10
4840;Markučiai;Bitučių;2931958829;Ne;0;4;0;4
4841;Markučiai;Drugelių;2537459830;Ne;10;0;1;11
4842;Markučiai;Drugelių;2288910885;Ne;9;0;0;9
4843;Markučiai;Drugelių;3544565354;Ne;0;5;5;10
4844;Markučiai;Drugelių;6992161129;Ne;13;4;0;17
4845;Markučiai;Drugelių;5024860112;Ne;0;3;0;3
4846;Markučiai;Drugelių;9412129807;Ne;2;13;0;15
4847;Markučiai;Drugelių;6979218594;Ne;2;0;4;6
4848;Markučiai;Drugelių;3491734422;Ne;0;5;4;9
4849;Markučiai;Drugelių;3491734422;Ne;0;5;4;9
4850;Markučiai;Drugelių;3491734422;Ne;0;5;4;9
4851;Markučiai;Drugelių;3832641521;Ne;11;6;0;17
4852;Markučiai;Drugelių;4520724770;Ne;4;3;1;8
4853;Markučiai;Drugelių;9391866085;Ne;3;2;10;15
4854;Markučiai;Drugelių;9073616238;Ne;4;0;0;4
4855;Markučiai;Drugelių;2967726802;Ne;12;10;5;27
4856;Markučiai;Drugelių;6684544229;Ne;7;5;3;15
4857;Markučiai;Drugelių;3487571241;Ne;9;0;0;9
4858;Markučiai;Skruzdėliukų;5566529492;Ne;7;0;1;8
4859;Markučiai;Skruzdėliukų;8105747904;Ne;0;19;0;19
4860;Markučiai;Skruzdėliukų;6617799980;Ne;10;5;0;15
4861;Markučiai;Skruzdėliukų;7580249913;Ne;19;0;0;19
4862;Markučiai;Skruzdėliukų;2246646548;Ne;7;0;1;8
4863;Markučiai;Skruzdėliukų;9921530582;Ne;0;0;1;1
4864;Markučiai;Skruzdėliukų;6759427415;Ne;5;0;0;5
4865;Markučiai;Skruzdėliukų;4820576711;Ne;17;0;0;17
4866;Markučiai;Skruzdėliukų;1527620947;Ne;2;16;0;18
4867;Markučiai;Skruzdėliukų;8774323234;Ne;4;0;0;4
4868;Markučiai;Skruzdėliukų;7881183912;Ne;10;2;0;12
4869;Markučiai;Skruzdėliukų;9338996275;Ne;13;0;0;13
4870;Markučiai;Skruzdėliukų;5180034556;Ne;2;0;0;2
4871;Markučiai;Skruzdėliukų;4383128686;Ne;0;0;8;8
4872;Markučiai;Skruzdėliukų;1929417022;Ne;9;0;0;9
4873;Markučiai;Skruzdėliukų;8679791696;Ne;2;0;0;2
4874;Markučiai;ZUIKUČIŲ;82320812575;Ne;0;8;0;8
4875;Markučiai;ZUIKUČIŲ;4861535057;Ne;0;1;0;1
4876;Markučiai;ZUIKUČIŲ;11751635395;Ne;0;6;0;6
4877;Markučiai;ZUIKUČIŲ;1184908076;Ne;0;10;2;12
4878;Markučiai;ZUIKUČIŲ;7729045227;Ne;0;10;1;11
4879;Markučiai;ZUIKUČIŲ;8061880631;Ne;8;10;2;20
4880;Markučiai;ZUIKUČIŲ;1392582514;Ne;0;13;0;13
4881;Markučiai;ZUIKUČIŲ;7691410556;Ne;9;3;0;12
4882;Markučiai;ZUIKUČIŲ;6453095915;Ne;5;5;0;10
4883;Markučiai;ZUIKUČIŲ;6808291628;Ne;0;18;0;18
4884;Markučiai;ZUIKUČIŲ;5387571295;Ne;0;10;4;14
4885;Markučiai;ZUIKUČIŲ;3794643964;Ne;0;5;0;5
4886;Markučiai;ZUIKUČIŲ;91228262895;Ne;0;4;1;5
4887;Markučiai;ZUIKUČIŲ;5749873170;Ne;0;5;0;5
4888;Markučiai;ZUIKUČIŲ;8605357678;Ne;0;7;0;7
4889;Markučiai;ZUIKUČIŲ;6055058096;Ne;0;4;0;4
4890;Markučiai;ZUIKUČIŲ;1956224017;Ne;7;5;0;12
4891;Markučiai;ŽIOGELIŲ;3163226803;Ne;0;4;1;5
4892;Markučiai;ŽIOGELIŲ;76025616287;Ne;0;0;2;2
4893;Markučiai;ŽIOGELIŲ;54892037118;Ne;0;1;7;8
4894;Markučiai;ŽIOGELIŲ;1054802708;Ne;0;0;2;2
4895;Markučiai;ŽIOGELIŲ;67074776419;Ne;0;1;1;2
4896;Markučiai;ŽIOGELIŲ;1007919702;Ne;0;17;0;17
4897;Markučiai;ŽIOGELIŲ;7850311496;Ne;2;0;0;2
4898;Markučiai;ŽIOGELIŲ;2169583290;Ne;0;7;0;7
4899;Markučiai;ŽIOGELIŲ;3340385503;Taip;0;0;1;1
4900;Markučiai;ŽIOGELIŲ;1742944578;Ne;0;0;3;3
4901;Markučiai;ŽIOGELIŲ;7481923902;Ne;4;1;0;5
4902;Markučiai;ŽIOGELIŲ;4324776209;Ne;0;0;2;2
4903;Markučiai;Ežiukių;4925856706;Ne;2;3;0;5
4904;Markučiai;Ežiukių;6570638672;Ne;0;9;0;9
4905;Markučiai;Ežiukių;5975331223;Ne;0;6;1;7
4906;Markučiai;Ežiukių;2687320408;Ne;0;2;0;2
4907;Markučiai;Ežiukių;8990923872;Ne;9;7;0;16
4908;Markučiai;Ežiukių;6308368050;Ne;0;2;0;2
4909;Markučiai;Ežiukių;4249158803;Ne;2;0;0;2
4910;Markučiai;Ežiukių;5958705106;Ne;7;1;0;8
4911;Markučiai;Ežiukių;1769984489;Ne;0;0;5;5
4912;Markučiai;Ežiukių;7791500322;Ne;0;1;0;1
4913;Markučiai;Ežiukių;9059302464;Ne;8;0;0;8
4914;Markučiai;Ežiukių;6574037877;Ne;5;0;0;5
4915;Markučiai;Ežiukių;5752762229;Ne;0;1;0;1
4916;Markučiai;Ežiukių;4383421917;Ne;0;4;0;4
4917;Markučiai;Ežiukių;9789274040;Ne;6;1;0;7
4918;Mažylis;"4 PRIEŠMOKYKLINĖ GR.";9411559447;Ne;5;0;7;12
4919;Mažylis;"4 PRIEŠMOKYKLINĖ GR.";4252408251;Ne;3;12;1;16
4920;Mažylis;"4 PRIEŠMOKYKLINĖ GR.";4503734408;Ne;5;0;7;12
4921;Mažylis;"4 PRIEŠMOKYKLINĖ GR.";8352202912;Ne;0;0;3;3
4922;Mažylis;"4 PRIEŠMOKYKLINĖ GR.";38277640135;Ne;3;0;6;9
4923;Mažylis;"4 PRIEŠMOKYKLINĖ GR.";1663347167;Ne;8;1;4;13
4924;Mažylis;"4 PRIEŠMOKYKLINĖ GR.";6854350717;Ne;0;0;3;3
4925;Mažylis;"4 PRIEŠMOKYKLINĖ GR.";4104052524;Ne;0;5;2;7
4926;Mažylis;"4 PRIEŠMOKYKLINĖ GR.";3860760654;Ne;5;0;0;5
4927;Mažylis;"4 PRIEŠMOKYKLINĖ GR.";7185347381;Ne;0;0;1;1
4928;Mažylis;"4 PRIEŠMOKYKLINĖ GR.";3344476309;Ne;0;0;3;3
4929;Mažylis;"4 PRIEŠMOKYKLINĖ GR.";6851169340;Ne;0;2;0;2
4930;Mažylis;"4 PRIEŠMOKYKLINĖ GR.";3217527771;Ne;0;1;2;3
4931;Mažylis;"4 PRIEŠMOKYKLINĖ GR.";7416381505;Ne;8;0;9;17
4932;Mažylis;"4 PRIEŠMOKYKLINĖ GR.";1514640197;Ne;0;0;1;1
4933;Mažylis;"4 PRIEŠMOKYKLINĖ GR.";1002832487;Ne;4;0;2;6
4934;Mažylis;"4 PRIEŠMOKYKLINĖ GR.";9608529135;Ne;0;0;1;1
4935;Mažylis;"4 PRIEŠMOKYKLINĖ GR.";4645411379;Ne;0;0;2;2
4936;Mažylis;"3 DARŽELIO GR.";6100650710;Ne;0;0;1;1
4937;Mažylis;"3 DARŽELIO GR.";9401388775;Ne;0;0;2;2
4938;Mažylis;"3 DARŽELIO GR.";7106648054;Ne;0;0;2;2
4939;Mažylis;"3 DARŽELIO GR.";6809320247;Ne;0;0;1;1
4940;Mažylis;"3 DARŽELIO GR.";2006289999;Ne;5;0;1;6
4941;Mažylis;"3 DARŽELIO GR.";8639480781;Ne;1;0;0;1
4942;Mažylis;"3 DARŽELIO GR.";9341935211;Ne;0;0;3;3
4943;Mažylis;"3 DARŽELIO GR.";2989562406;Ne;0;0;5;5
4944;Mažylis;"3 DARŽELIO GR.";1151737098;Ne;7;0;0;7
4945;Mažylis;"3 DARŽELIO GR.";5938312001;Ne;4;2;2;8
4946;Mažylis;"3 DARŽELIO GR.";2119733659;Ne;5;0;1;6
4947;Mažylis;"3 DARŽELIO GR.";2319506343;Ne;0;0;14;14
4948;Mažylis;"3 DARŽELIO GR.";9416161833;Ne;2;0;1;3
4949;Mažylis;"3 DARŽELIO GR.";9807376076;Ne;0;0;5;5
4950;Mažylis;"6 DARŽELIO GR.";5388105083;Ne;4;13;0;17
4951;Mažylis;"6 DARŽELIO GR.";8589124394;Ne;4;0;0;4
4952;Mažylis;"6 DARŽELIO GR.";3641990617;Ne;10;0;2;12
4953;Mažylis;"6 DARŽELIO GR.";1892136590;Ne;7;0;0;7
4954;Mažylis;"6 DARŽELIO GR.";9479398581;Ne;6;0;0;6
4955;Mažylis;"6 DARŽELIO GR.";1381828313;Ne;0;0;10;10
4956;Mažylis;"6 DARŽELIO GR.";7725286603;Ne;8;1;4;13
4957;Mažylis;"6 DARŽELIO GR.";7754956214;Ne;3;0;1;4
4958;Mažylis;"6 DARŽELIO GR.";3615636349;Ne;4;0;5;9
4959;Mažylis;"6 DARŽELIO GR.";3400122626;Ne;0;0;1;1
4960;Mažylis;"6 DARŽELIO GR.";6270840529;Ne;7;0;5;12
4961;Mažylis;"6 DARŽELIO GR.";4100492642;Ne;6;0;14;20
4962;Mažylis;"6 DARŽELIO GR.";5569913242;Ne;0;0;17;17
4963;Mažylis;"6 DARŽELIO GR.";7841955949;Ne;7;0;0;7
4964;Mažylis;"6 DARŽELIO GR.";6492768766;Ne;5;0;5;10
4965;Mažylis;"6 DARŽELIO GR.";6423910850;Ne;13;0;2;15
4966;Mažylis;"6 DARŽELIO GR.";1555305826;Ne;0;0;3;3
4967;Mažylis;"6 DARŽELIO GR.";5977423702;Ne;7;9;1;17
4968;Mažylis;"6 DARŽELIO GR.";9562863405;Ne;5;0;2;7
4969;Mažylis;"6 DARŽELIO GR.";5990843024;Ne;4;0;9;13
4970;Mažylis;"6 DARŽELIO GR.";9981751097;Ne;0;0;3;3
4971;Mažylis;"6 DARŽELIO GR.";5137132420;Ne;13;0;2;15
4972;Mažylis;"1 NAUJA (LOPŠELIS)";4985161657;Ne;0;0;1;1
4973;Mažylis;"1 NAUJA (LOPŠELIS)";5297935198;Ne;5;1;0;6
4974;Mažylis;"1 NAUJA (LOPŠELIS)";1993916098;Ne;6;8;3;17
4975;Mažylis;"1 NAUJA (LOPŠELIS)";4309902086;Ne;0;0;2;2
4976;Mažylis;"1 NAUJA (LOPŠELIS)";5727207294;Ne;7;0;0;7
4977;Mažylis;"1 NAUJA (LOPŠELIS)";3064367996;Ne;0;3;0;3
4978;Mažylis;"1 NAUJA (LOPŠELIS)";2110320072;Ne;0;12;2;14
4979;Mažylis;"1 NAUJA (LOPŠELIS)";7810360699;Ne;5;0;0;5
4980;Mažylis;"1 NAUJA (LOPŠELIS)";5225388496;Ne;0;0;6;6
4981;Mažylis;"1 NAUJA (LOPŠELIS)";8259994523;Ne;0;0;2;2
4982;Mažylis;"1 NAUJA (LOPŠELIS)";6500577246;Ne;0;0;6;6
4983;Mažylis;"1 NAUJA (LOPŠELIS)";4201114033;Ne;5;0;1;6
4984;Mažylis;"1 NAUJA (LOPŠELIS)";8871998701;Ne;0;0;13;13
4985;Mažylis;"1 NAUJA (LOPŠELIS)";4347489809;Ne;0;0;8;8
4986;Mažylis;"1 NAUJA (LOPŠELIS)";4557902728;Ne;0;0;1;1
4987;Mažylis;"5 DARŽELIO GR.";2935175014;Ne;6;0;7;13
4988;Mažylis;"5 DARŽELIO GR.";6162880220;Ne;0;0;6;6
4989;Mažylis;"5 DARŽELIO GR.";2672500259;Ne;0;0;9;9
4990;Mažylis;"5 DARŽELIO GR.";8135596731;Ne;5;0;0;5
4991;Mažylis;"5 DARŽELIO GR.";8866980930;Ne;2;1;0;3
4992;Mažylis;"5 DARŽELIO GR.";3327673298;Ne;0;0;1;1
4993;Mažylis;"5 DARŽELIO GR.";4280547746;Ne;0;0;4;4
4994;Mažylis;"5 DARŽELIO GR.";9447747294;Taip;0;0;10;10
4995;Mažylis;"5 DARŽELIO GR.";4542742002;Ne;5;0;0;5
4996;Mažylis;"5 DARŽELIO GR.";2126108232;Ne;0;0;5;5
4997;Mažylis;"5 DARŽELIO GR.";4553092508;Ne;5;0;3;8
4998;Mažylis;"5 DARŽELIO GR.";8297427176;Ne;0;1;0;1
4999;Mažylis;"5 DARŽELIO GR.";6009637985;Ne;2;0;2;4
5000;Mažylis;"5 DARŽELIO GR.";5685988186;Ne;0;12;2;14
5001;Mažylis;"5 DARŽELIO GR.";5870983755;Ne;3;0;2;5
5002;Mažylis;"5 DARŽELIO GR.";8999239172;Ne;0;0;2;2
5003;Mažylis;"5 DARŽELIO GR.";3365026025;Ne;3;0;0;3
5004;Mažylis;"DARŽELIS 2 GR.";2795618410;Ne;0;0;9;9
5005;Mažylis;"DARŽELIS 2 GR.";9727982334;Ne;0;0;6;6
5006;Mažylis;"DARŽELIS 2 GR.";8655053217;Ne;2;0;0;2
5007;Mažylis;"DARŽELIS 2 GR.";7414398772;Ne;10;0;0;10
5008;Mažylis;"DARŽELIS 2 GR.";1058725505;Ne;11;0;0;11
5009;Mažylis;"DARŽELIS 2 GR.";9111101357;Ne;18;0;0;18
5010;Mažylis;"DARŽELIS 2 GR.";1533948576;Ne;0;2;2;4
5011;Mažylis;"DARŽELIS 2 GR.";6728351360;Ne;5;8;0;13
5012;Mažylis;"DARŽELIS 2 GR.";6272047137;Ne;0;1;0;1
5013;Mažylis;"DARŽELIS 2 GR.";7255856938;Ne;0;0;11;11
5014;Mažylis;"DARŽELIS 2 GR.";4987487972;Ne;0;0;2;2
5015;Mažylis;"DARŽELIS 2 GR.";5165268747;Ne;6;0;3;9
5016;Mažylis;"DARŽELIS 2 GR.";2425437724;Ne;0;0;11;11
5017;Mažylis;"DARŽELIS 2 GR.";2723677422;Ne;5;0;9;14
5018;Mažylis;"DARŽELIS 2 GR.";5658868407;Ne;5;0;0;5
5019;Medynėlis;BITUTĖS;6238256156;Ne;6;5;0;11
5020;Medynėlis;BITUTĖS;8711567312;Ne;5;0;0;5
5021;Medynėlis;BITUTĖS;2993705115;Ne;0;2;5;7
5022;Medynėlis;BITUTĖS;1504612730;Ne;10;0;0;10
5023;Medynėlis;BITUTĖS;5522261530;Ne;0;4;0;4
5024;Medynėlis;BITUTĖS;6576401514;Ne;6;0;2;8
5025;Medynėlis;BITUTĖS;4107846958;Taip;4;2;0;6
5026;Medynėlis;BITUTĖS;7296044569;Ne;0;3;0;3
5027;Medynėlis;BITUTĖS;4418330478;Ne;9;0;1;10
5028;Medynėlis;BITUTĖS;7042766873;Ne;8;0;0;8
5029;Medynėlis;BITUTĖS;6074296305;Ne;0;1;0;1
5030;Medynėlis;BITUTĖS;6815521895;Ne;0;0;1;1
5031;Medynėlis;BITUTĖS;4374464298;Ne;10;0;0;10
5032;Medynėlis;BITUTĖS;8107171123;Ne;3;1;0;4
5033;Medynėlis;BITUTĖS;4545707752;Ne;0;1;1;2
5034;Medynėlis;BITUTĖS;4419503239;Ne;6;0;0;6
5035;Medynėlis;BITUTĖS;7870261906;Ne;0;0;5;5
5036;Medynėlis;BITUTĖS;6466874318;Taip;20;0;0;20
5037;Medynėlis;BITUTĖS;2798305000;Ne;5;0;0;5
5038;Medynėlis;BITUTĖS;5440233814;Taip;0;0;1;1
5039;Medynėlis;BITUTĖS;4598267411;Ne;18;0;0;18
5040;Medynėlis;BITUTĖS;5194220650;Ne;8;0;0;8
5041;Medynėlis;DRUGELIAI;33981260502;Ne;0;0;14;14
5042;Medynėlis;DRUGELIAI;4581683292;Ne;0;8;0;8
5043;Medynėlis;DRUGELIAI;5530782065;Ne;0;1;0;1
5044;Medynėlis;DRUGELIAI;8948133343;Ne;0;3;0;3
5045;Medynėlis;DRUGELIAI;9413309043;Ne;0;4;0;4
5046;Medynėlis;DRUGELIAI;3773215372;Ne;7;0;0;7
5047;Medynėlis;DRUGELIAI;1795479738;Ne;12;2;0;14
5048;Medynėlis;DRUGELIAI;4024866819;Ne;0;4;0;4
5049;Medynėlis;DRUGELIAI;7244497661;Ne;0;2;0;2
5050;Medynėlis;DRUGELIAI;5269927048;Ne;0;2;0;2
5051;Medynėlis;DRUGELIAI;1827495325;Ne;0;1;0;1
5052;Medynėlis;DRUGELIAI;2540325264;Ne;0;2;0;2
5053;Medynėlis;DRUGELIAI;3870665108;Ne;0;5;0;5
5054;Medynėlis;DRUGELIAI;5551121950;Ne;2;0;0;2
5055;Medynėlis;DRUGELIAI;2627421550;Ne;0;1;0;1
5056;Medynėlis;DRUGELIAI;2794274146;Ne;0;6;0;6
5057;Medynėlis;SKRUZDĖLIUKAI;4783894465;Ne;2;1;3;6
5058;Medynėlis;SKRUZDĖLIUKAI;1142044361;Ne;2;0;0;2
5059;Medynėlis;SKRUZDĖLIUKAI;8719860414;Ne;5;0;0;5
5060;Medynėlis;SKRUZDĖLIUKAI;6802308420;Ne;9;0;0;9
5061;Medynėlis;SKRUZDĖLIUKAI;4645171858;Ne;0;0;8;8
5062;Medynėlis;SKRUZDĖLIUKAI;3947494044;Ne;0;3;0;3
5063;Medynėlis;SKRUZDĖLIUKAI;3295727210;Ne;0;5;0;5
5064;Medynėlis;SKRUZDĖLIUKAI;8441629302;Ne;0;2;0;2
5065;Medynėlis;SKRUZDĖLIUKAI;3761140697;Ne;11;0;1;12
5066;Medynėlis;SKRUZDĖLIUKAI;5330900656;Ne;5;0;3;8
5067;Medynėlis;SKRUZDĖLIUKAI;4897227188;Ne;11;1;0;12
5068;Medynėlis;SKRUZDĖLIUKAI;2339692406;Ne;0;0;2;2
5069;Medynėlis;SKRUZDĖLIUKAI;9705185906;Taip;5;0;0;5
5070;Medynėlis;SKRUZDĖLIUKAI;9873696787;Taip;10;5;0;15
5071;Medynėlis;SKRUZDĖLIUKAI;2218838971;Ne;0;0;17;17
5072;Medynėlis;SKRUZDĖLIUKAI;1206480760;Ne;16;0;0;16
5073;Medynėlis;SKRUZDĖLIUKAI;3790099536;Ne;0;0;2;2
5074;Medynėlis;VOVERIUKAI;2627655353;Ne;0;5;0;5
5075;Medynėlis;VOVERIUKAI;4488439037;Ne;0;0;1;1
5076;Medynėlis;VOVERIUKAI;4100792567;Ne;1;5;2;8
5077;Medynėlis;VOVERIUKAI;6101613567;Ne;0;0;7;7
5078;Medynėlis;VOVERIUKAI;1056744101;Ne;0;0;13;13
5079;Medynėlis;VOVERIUKAI;6485314750;Ne;5;0;0;5
5080;Medynėlis;VOVERIUKAI;7455041214;Ne;0;0;4;4
5081;Medynėlis;VOVERIUKAI;3761845905;Ne;0;0;8;8
5082;Medynėlis;VOVERIUKAI;9825580191;Ne;0;2;0;2
5083;Medynėlis;VOVERIUKAI;7272017225;Ne;0;1;0;1
5084;Medynėlis;VOVERIUKAI;4092824377;Ne;0;14;0;14
5085;Medynėlis;VOVERIUKAI;1475701065;Ne;0;3;0;3
5086;Medynėlis;VOVERIUKAI;3674134340;Ne;0;0;4;4
5087;Medynėlis;VOVERIUKAI;5028189785;Ne;2;3;0;5
5088;Medynėlis;MEŠKIUKAI;2086963376;Ne;0;5;0;5
5089;Medynėlis;MEŠKIUKAI;7740591575;Ne;0;6;1;7
5090;Medynėlis;MEŠKIUKAI;9304002459;Ne;0;0;4;4
5091;Medynėlis;MEŠKIUKAI;5586407412;Ne;0;0;2;2
5092;Medynėlis;MEŠKIUKAI;90556319090;Ne;0;0;3;3
5093;Medynėlis;MEŠKIUKAI;2834559432;Ne;0;0;1;1
5094;Medynėlis;MEŠKIUKAI;9800678364;Ne;5;0;9;14
5095;Medynėlis;MEŠKIUKAI;5982453884;Ne;0;6;0;6
5096;Medynėlis;MEŠKIUKAI;2310200034;Ne;0;4;0;4
5097;Medynėlis;MEŠKIUKAI;8441104709;Ne;0;0;1;1
5098;Medynėlis;MEŠKIUKAI;1237589979;Ne;0;0;4;4
5099;Medynėlis;MEŠKIUKAI;1820113382;Ne;0;6;1;7
5100;Medynėlis;MEŠKIUKAI;6406459222;Ne;5;1;10;16
5101;Medynėlis;MEŠKIUKAI;1173510831;Ne;4;4;3;11
5102;Medynėlis;MEŠKIUKAI;4985243068;Ne;7;0;3;10
5103;Medynėlis;MEŠKIUKAI;7108619017;Ne;0;0;3;3
5104;Medynėlis;MEŠKIUKAI;6999562417;Ne;7;2;7;16
5105;Medynėlis;MEŠKIUKAI;7140184593;Ne;10;0;3;13
5106;Medynėlis;PELĖDŽIUKAI;2932544910;Ne;5;0;0;5
5107;Medynėlis;PELĖDŽIUKAI;9079900803;Ne;14;0;0;14
5108;Medynėlis;PELĖDŽIUKAI;5571641847;Ne;8;2;0;10
5109;Medynėlis;PELĖDŽIUKAI;2103255454;Ne;0;3;0;3
5110;Medynėlis;PELĖDŽIUKAI;9355165862;Ne;2;0;0;2
5111;Medynėlis;PELĖDŽIUKAI;9184868565;Ne;6;0;0;6
5112;Medynėlis;PELĖDŽIUKAI;6706028300;Ne;0;5;0;5
5113;Medynėlis;PELĖDŽIUKAI;6955467123;Ne;0;4;0;4
5114;Medynėlis;PELĖDŽIUKAI;6073797962;Ne;6;0;0;6
5115;Medynėlis;PELĖDŽIUKAI;5785463517;Ne;2;0;0;2
5116;Medynėlis;PELĖDŽIUKAI;4222917765;Ne;0;0;1;1
5117;Medynėlis;PELĖDŽIUKAI;1621499650;Ne;0;0;1;1
5118;Medynėlis;PELĖDŽIUKAI;6681155625;Ne;7;3;0;10
5119;Medynėlis;PELĖDŽIUKAI;9438854582;Ne;0;0;3;3
5120;Medynėlis;PELĖDŽIUKAI;1901805808;Ne;0;5;1;6
5121;Medynėlis;PELĖDŽIUKAI;5784691118;Ne;0;5;3;8
5122;Medynėlis;PELĖDŽIUKAI;3856908872;Ne;0;5;0;5
5123;Medynėlis;PELĖDŽIUKAI;4468967036;Ne;0;0;1;1
5124;Medynėlis;PELĖDŽIUKAI;2702814930;Ne;0;0;1;1
5125;Medynėlis;BORUŽIUKAI;3787172254;Ne;0;8;0;8
5126;Medynėlis;BORUŽIUKAI;7232396755;Ne;0;0;1;1
5127;Medynėlis;BORUŽIUKAI;7651663404;Ne;2;0;2;4
5128;Medynėlis;BORUŽIUKAI;1406029765;Ne;6;0;0;6
5129;Medynėlis;BORUŽIUKAI;9764215406;Taip;4;1;1;6
5130;Medynėlis;BORUŽIUKAI;8271170887;Ne;0;1;0;1
5131;Medynėlis;BORUŽIUKAI;5532880670;Ne;0;0;4;4
5132;Medynėlis;BORUŽIUKAI;1525185037;Ne;0;2;0;2
5133;Medynėlis;BORUŽIUKAI;9919108302;Ne;0;7;0;7
5134;Medynėlis;BORUŽIUKAI;1162859552;Ne;0;5;0;5
5135;Medynėlis;BORUŽIUKAI;6032067904;Ne;5;0;0;5
5136;Medynėlis;BORUŽIUKAI;4315717555;Ne;0;2;0;2
5137;Medynėlis;BORUŽIUKAI;8276864168;Taip;0;0;3;3
5138;Medynėlis;BORUŽIUKAI;5544663829;Ne;0;2;0;2
5139;Medynėlis;BORUŽIUKAI;2701448160;Ne;0;0;5;5
5140;Medynėlis;BORUŽIUKAI;1658457155;Ne;5;0;0;5
5141;Medynėlis;BORUŽIUKAI;8074251036;Ne;11;0;0;11
5142;Medynėlis;BORUŽIUKAI;7501831333;Ne;0;1;1;2
5143;Medynėlis;BORUŽIUKAI;2097758483;Ne;0;5;0;5
5144;Medynėlis;EŽIUKAI;9729505759;Ne;22;0;0;22
5145;Medynėlis;EŽIUKAI;8125271445;Ne;0;3;0;3
5146;Medynėlis;EŽIUKAI;9847006679;Ne;10;0;0;10
5147;Medynėlis;EŽIUKAI;7317307957;Ne;7;0;1;8
5148;Medynėlis;EŽIUKAI;7860869675;Ne;5;0;1;6
5149;Medynėlis;EŽIUKAI;4471168173;Ne;0;0;1;1
5150;Medynėlis;EŽIUKAI;1062269215;Ne;0;12;4;16
5151;Medynėlis;EŽIUKAI;5197757730;Taip;0;1;0;1
5152;Medynėlis;EŽIUKAI;5333502849;Ne;0;1;1;2
5153;Medynėlis;EŽIUKAI;6536626390;Ne;8;0;3;11
5154;Medynėlis;EŽIUKAI;8953622684;Ne;7;0;0;7
5155;Medynėlis;EŽIUKAI;3230747109;Ne;6;1;0;7
5156;Medynėlis;EŽIUKAI;9175884049;Ne;0;0;2;2
5157;Medynėlis;EŽIUKAI;8609650186;Ne;10;0;0;10
5158;Medynėlis;EŽIUKAI;6826409129;Ne;10;0;0;10
5159;Medynėlis;EŽIUKAI;2929100410;Ne;7;0;1;8
5160;Medynėlis;EŽIUKAI;6359536923;Ne;0;7;2;9
5161;Medynėlis;EŽIUKAI;2676262920;Ne;0;0;5;5
5162;Medynėlis;EŽIUKAI;5339084041;Taip;17;0;0;17
5163;Medynėlis;EŽIUKAI;5766492584;Ne;2;0;1;3
5164;Medynėlis;EŽIUKAI;8838774666;Ne;22;0;0;22
5165;Medynėlis;ZUIKUČIAI;6614028601;Ne;9;0;0;9
5166;Medynėlis;ZUIKUČIAI;8439619837;Ne;10;0;1;11
5167;Medynėlis;ZUIKUČIAI;5389909872;Ne;0;2;0;2
5168;Medynėlis;ZUIKUČIAI;9352391583;Ne;0;0;8;8
5169;Medynėlis;ZUIKUČIAI;4941353702;Ne;0;5;0;5
5170;Medynėlis;ZUIKUČIAI;4040542730;Taip;0;9;0;9
5171;Medynėlis;ZUIKUČIAI;6989524053;Ne;22;0;0;22
5172;Medynėlis;ZUIKUČIAI;9774213537;Ne;0;7;0;7
5173;Medynėlis;ZUIKUČIAI;7129951535;Ne;3;4;2;9
5174;Medynėlis;ZUIKUČIAI;9977590259;Ne;0;10;0;10
5175;Medynėlis;ZUIKUČIAI;7170801214;Ne;0;5;2;7
5176;Medynėlis;ZUIKUČIAI;9373849916;Ne;16;0;0;16
5177;Medynėlis;ZUIKUČIAI;4204366008;Ne;0;1;0;1
5178;Medynėlis;ZUIKUČIAI;6569938649;Ne;0;0;2;2
5179;Medynėlis;ZUIKUČIAI;3480190692;Ne;7;0;0;7
5180;Medynėlis;ZUIKUČIAI;5581973770;Ne;0;0;19;19
5181;Medynėlis;KAČIUKAI;8275097931;Ne;3;1;2;6
5182;Medynėlis;KAČIUKAI;5302122600;Ne;0;0;2;2
5183;Medynėlis;KAČIUKAI;6609111216;Ne;10;0;0;10
5184;Medynėlis;KAČIUKAI;2160081492;Ne;10;0;0;10
5185;Medynėlis;KAČIUKAI;4035587227;Ne;0;3;0;3
5186;Medynėlis;KAČIUKAI;8162771849;Ne;0;12;1;13
5187;Medynėlis;KAČIUKAI;3185760752;Ne;5;0;0;5
5188;Medynėlis;KAČIUKAI;5610660982;Ne;0;0;3;3
5189;Medynėlis;KAČIUKAI;6282113738;Ne;0;0;1;1
5190;Medynėlis;KAČIUKAI;4153545500;Ne;6;5;0;11
5191;Medynėlis;KAČIUKAI;8299034970;Ne;0;6;0;6
5192;Medynėlis;KAČIUKAI;7675101600;Taip;2;0;0;2
5193;Medynėlis;KAČIUKAI;1668143166;Ne;0;0;3;3
5194;Medynėlis;KAČIUKAI;4010058673;Ne;2;3;0;5
5195;Medynėlis;KAČIUKAI;6502531749;Taip;13;0;1;14
5196;Medynėlis;KAČIUKAI;9076139419;Ne;11;0;0;11
5197;Medynėlis;KAČIUKAI;1608019909;Ne;0;5;0;5
5198;Medynėlis;KAČIUKAI;1026253778;Ne;6;5;0;11
5199;Medynėlis;KAČIUKAI;1404831377;Ne;16;0;1;17
5200;Medynėlis;KAČIUKAI;2523474347;Ne;7;1;0;8
5201;Medynėlis;KAČIUKAI;7814008588;Ne;8;0;0;8
5202;Medynėlis;PELIUKAI;6622963662;Ne;9;0;0;9
5203;Medynėlis;PELIUKAI;3638155321;Ne;0;1;2;3
5204;Medynėlis;PELIUKAI;9290099536;Taip;1;0;2;3
5205;Medynėlis;PELIUKAI;1500986498;Ne;2;0;1;3
5206;Medynėlis;PELIUKAI;6924524346;Ne;0;6;0;6
5207;Medynėlis;PELIUKAI;2379829985;Ne;8;0;0;8
5208;Medynėlis;PELIUKAI;6926408544;Ne;7;0;1;8
5209;Medynėlis;PELIUKAI;5391199861;Ne;5;8;0;13
5210;Medynėlis;PELIUKAI;9485498942;Ne;0;1;0;1
5211;Medynėlis;PELIUKAI;6095795724;Ne;19;0;0;19
5212;Medynėlis;PELIUKAI;7914358405;Ne;3;0;6;9
5213;Medynėlis;PELIUKAI;7695626630;Ne;0;0;1;1
5214;Medynėlis;PELIUKAI;9182653290;Ne;0;8;0;8
5215;Medynėlis;PELIUKAI;3538656650;Ne;0;12;10;22
5216;Medynėlis;PELIUKAI;6993176904;Ne;0;5;0;5
5217;Medynėlis;PELIUKAI;2877881247;Ne;19;0;1;20
5218;Medynėlis;PELIUKAI;4145591997;Ne;11;0;0;11
5219;Medynėlis;PELIUKAI;8382537735;Ne;2;0;3;5
5220;Medynėlis;PELIUKAI;7268418306;Taip;5;0;0;5
5221;Medynėlis;PELIUKAI;6470879334;Ne;5;0;0;5
5222;Medynėlis;PELIUKAI;2816510180;Ne;2;0;3;5
5223;Medynėlis;PELIUKAI;3709984586;Ne;7;0;0;7
5224;Medynėlis;ANČIUKAI;9857514451;Ne;18;2;0;20
5225;Medynėlis;ANČIUKAI;6730475188;Ne;8;0;0;8
5226;Medynėlis;ANČIUKAI;6824842361;Ne;5;8;1;14
5227;Medynėlis;ANČIUKAI;5677747582;Ne;9;1;1;11
5228;Medynėlis;ANČIUKAI;4498233742;Ne;9;0;0;9
5229;Medynėlis;ANČIUKAI;5269794415;Ne;0;0;2;2
5230;Medynėlis;ANČIUKAI;5049081242;Ne;7;0;8;15
5231;Medynėlis;ANČIUKAI;4910857912;Ne;5;0;0;5
5232;Medynėlis;ANČIUKAI;4817353132;Ne;5;0;3;8
5233;Medynėlis;ANČIUKAI;7613699868;Ne;7;0;0;7
5234;Medynėlis;ANČIUKAI;9336656351;Ne;0;0;7;7
5235;Medynėlis;ANČIUKAI;7085226543;Ne;10;2;3;15
5236;Medynėlis;ANČIUKAI;1283602655;Ne;0;8;11;19
5237;Medynėlis;ANČIUKAI;3556203620;Ne;4;0;3;7
5238;Medynėlis;ANČIUKAI;2896713695;Ne;0;0;1;1
5239;Medynėlis;ANČIUKAI;4626655069;Ne;3;5;0;8
5240;Medynėlis;ANČIUKAI;5456045449;Ne;5;1;0;6
5241;Medynėlis;ANČIUKAI;8667441678;Ne;5;1;0;6
5242;Medynėlis;ANČIUKAI;6896823412;Ne;5;0;0;5
5243;Medynėlis;ANČIUKAI;6641009653;Ne;10;0;0;10
5244;Medynėlis;ANČIUKAI;8887092965;Ne;0;10;0;10
5245;Medynėlis;STIRNIUKAI;8542591286;Ne;5;0;0;5
5246;Molinukas;NYKŠTUKAI;6353165459;Ne;0;3;0;3
5247;Molinukas;NYKŠTUKAI;5876669121;Ne;4;0;0;4
5248;Molinukas;NYKŠTUKAI;6087698882;Ne;0;0;1;1
5249;Molinukas;NYKŠTUKAI;2211909678;Ne;0;12;2;14
5250;Molinukas;NYKŠTUKAI;2348120316;Ne;0;2;0;2
5251;Molinukas;NYKŠTUKAI;8053608348;Ne;8;0;12;20
5252;Molinukas;NYKŠTUKAI;6014990150;Ne;0;0;1;1
5253;Molinukas;NYKŠTUKAI;7623051674;Ne;5;2;0;7
5254;Molinukas;NYKŠTUKAI;8536615996;Ne;2;0;1;3
5255;Molinukas;NYKŠTUKAI;1849018608;Ne;0;1;0;1
5256;Molinukas;NYKŠTUKAI;4171978721;Ne;7;2;0;9
5257;Molinukas;NYKŠTUKAI;7134802574;Ne;0;0;3;3
5258;Molinukas;NYKŠTUKAI;8260101075;Ne;0;0;3;3
5259;Molinukas;NYKŠTUKAI;9293819449;Ne;0;0;7;7
5260;Molinukas;NYKŠTUKAI;5525772579;Ne;0;4;3;7
5261;Molinukas;NYKŠTUKAI;4475594896;Ne;4;6;0;10
5262;Molinukas;NYKŠTUKAI;7248705010;Ne;0;4;0;4
5263;Molinukas;NYKŠTUKAI;4101644021;Ne;5;10;0;15
5264;Molinukas;NYKŠTUKAI;6681397435;Ne;12;0;10;22
5265;Molinukas;ZUIKUČIŲ;9203375647;Ne;4;6;0;10
5266;Molinukas;ZUIKUČIŲ;2982968605;Ne;1;4;0;5
5267;Molinukas;ZUIKUČIŲ;8479427729;Ne;5;5;0;10
5268;Molinukas;ZUIKUČIŲ;4225457772;Ne;10;0;0;10
5269;Molinukas;ZUIKUČIŲ;8114735116;Ne;0;1;0;1
5270;Molinukas;ZUIKUČIŲ;5597119459;Ne;7;0;7;14
5271;Molinukas;ZUIKUČIŲ;8582985479;Ne;11;0;0;11
5272;Molinukas;ZUIKUČIŲ;8490020853;Ne;11;0;0;11
5273;Molinukas;ZUIKUČIŲ;8988478990;Ne;0;0;1;1
5274;Molinukas;ZUIKUČIŲ;1059002689;Ne;0;14;8;22
5275;Molinukas;ZUIKUČIŲ;5302191209;Ne;5;0;17;22
5276;Molinukas;ZUIKUČIŲ;1605039166;Ne;7;2;0;9
5277;Molinukas;ZUIKUČIŲ;6804127471;Ne;7;2;0;9
5278;Molinukas;ZUIKUČIŲ;2878262979;Ne;5;0;0;5
5279;Molinukas;ZUIKUČIŲ;7441251480;Ne;4;0;0;4
5280;Molinukas;ZUIKUČIŲ;4733315902;Ne;14;0;0;14
5281;Molinukas;ZUIKUČIŲ;2706981559;Ne;0;2;0;2
5282;Molinukas;ZUIKUČIŲ;6638634402;Ne;7;0;0;7
5283;Molinukas;ZUIKUČIŲ;3516132254;Ne;3;0;0;3
5284;Molinukas;ZUIKUČIŲ;4718396549;Ne;7;2;0;9
5285;Molinukas;ZUIKUČIŲ;3577613732;Ne;10;0;0;10
5286;Molinukas;ZUIKUČIŲ;9972204424;Ne;13;0;0;13
5287;Molinukas;ZUIKUČIŲ;3419958136;Ne;15;0;0;15
5288;Molinukas;SRAIGIUKŲ;8416644024;Ne;0;0;2;2
5289;Molinukas;SRAIGIUKŲ;1686122652;Ne;0;1;0;1
5290;Molinukas;SRAIGIUKŲ;9948685221;Ne;0;1;5;6
5291;Molinukas;SRAIGIUKŲ;6326031969;Ne;5;0;3;8
5292;Molinukas;SRAIGIUKŲ;8393217418;Ne;0;3;0;3
5293;Molinukas;SRAIGIUKŲ;6636118069;Ne;0;2;0;2
5294;Molinukas;SRAIGIUKŲ;4766547534;Ne;0;0;2;2
5295;Molinukas;SRAIGIUKŲ;7377137582;Ne;0;0;2;2
5296;Molinukas;SRAIGIUKŲ;6084682084;Ne;0;2;0;2
5297;Molinukas;SRAIGIUKŲ;8913137310;Ne;0;2;11;13
5298;Molinukas;SRAIGIUKŲ;5387818175;Ne;0;1;0;1
5299;Molinukas;SRAIGIUKŲ;8604288346;Ne;0;2;6;8
5300;Molinukas;SRAIGIUKŲ;4806350914;Ne;5;0;2;7
5301;Molinukas;SRAIGIUKŲ;8617979245;Ne;0;0;3;3
5302;Molinukas;SRAIGIUKŲ;2757744826;Ne;4;0;9;13
5303;Molinukas;SRAIGIUKŲ;4534279257;Ne;1;2;0;3
5304;Molinukas;SRAIGIUKŲ;4918181437;Ne;0;7;0;7
5305;Molinukas;SRAIGIUKŲ;7451224160;Ne;0;6;0;6
5306;Molinukas;SRAIGIUKŲ;8688180482;Ne;0;0;1;1
5307;Molinukas;VOVERIUKAI;3469196411;Ne;5;0;0;5
5308;Molinukas;VOVERIUKAI;8541456847;Ne;0;5;1;6
5309;Molinukas;VOVERIUKAI;2286586693;Ne;4;2;3;9
5310;Molinukas;VOVERIUKAI;6898958282;Ne;1;0;3;4
5311;Molinukas;VOVERIUKAI;4000190261;Ne;7;0;2;9
5312;Molinukas;VOVERIUKAI;5685582215;Ne;0;1;0;1
5313;Molinukas;VOVERIUKAI;2356814145;Ne;0;0;3;3
5314;Molinukas;VOVERIUKAI;7446607510;Ne;5;3;0;8
5315;Molinukas;VOVERIUKAI;9667704959;Ne;3;1;10;14
5316;Molinukas;VOVERIUKAI;8516451290;Ne;5;0;0;5
5317;Molinukas;VOVERIUKAI;3030169626;Ne;0;0;3;3
5318;Molinukas;VOVERIUKAI;3207373459;Ne;0;0;6;6
5319;Molinukas;VOVERIUKAI;1865748733;Ne;0;6;1;7
5320;Molinukas;VOVERIUKAI;4209143136;Ne;0;1;1;2
5321;Molinukas;VOVERIUKAI;5648861702;Ne;0;1;1;2
5322;Molinukas;VOVERIUKAI;4950808381;Ne;4;8;4;16
5323;Molinukas;VOVERIUKAI;7378643086;Ne;5;0;0;5
5324;Molinukas;VOVERIUKAI;2779700726;Ne;0;0;20;20
5325;Molinukas;VOVERIUKAI;6832647220;Ne;7;0;1;8
5326;Molinukas;VOVERIUKAI;9318837973;Ne;0;0;1;1
5327;Molinukas;VOVERIUKAI;8247270556;Ne;5;2;0;7
5328;Molinukas;ŽVIRBLIUKŲ;2935945686;Ne;2;1;12;15
5329;Molinukas;ŽVIRBLIUKŲ;7825545164;Ne;0;0;6;6
5330;Molinukas;ŽVIRBLIUKŲ;6190443233;Ne;7;4;0;11
5331;Molinukas;ŽVIRBLIUKŲ;6531106368;Ne;6;0;2;8
5332;Molinukas;ŽVIRBLIUKŲ;8660958288;Ne;2;0;2;4
5333;Molinukas;ŽVIRBLIUKŲ;2862680065;Ne;0;7;0;7
5334;Molinukas;ŽVIRBLIUKŲ;3382913312;Ne;0;0;5;5
5335;Molinukas;ŽVIRBLIUKŲ;3331982964;Ne;0;0;1;1
5336;Molinukas;ŽVIRBLIUKŲ;2448588784;Ne;21;1;0;22
5337;Molinukas;ŽVIRBLIUKŲ;2842168450;Ne;7;0;0;7
5338;Molinukas;KAČIUKŲ;4992887072;Ne;3;0;0;3
5339;Molinukas;KAČIUKŲ;1907287249;Ne;4;0;0;4
5340;Molinukas;KAČIUKŲ;8769667823;Ne;0;0;1;1
5341;Molinukas;KAČIUKŲ;8313486714;Ne;0;7;0;7
5342;Molinukas;KAČIUKŲ;4974513900;Ne;4;2;0;6
5343;Molinukas;KAČIUKŲ;1826463800;Ne;0;4;0;4
5344;Molinukas;KAČIUKŲ;6947938890;Ne;0;0;1;1
5345;Molinukas;KAČIUKŲ;1970929144;Ne;0;0;1;1
5346;Molinukas;KAČIUKŲ;3510936830;Ne;0;7;2;9
5347;Molinukas;KAČIUKŲ;8608465121;Ne;0;0;1;1
5348;Molinukas;KAČIUKŲ;1651103318;Ne;0;0;4;4
5349;"Naminukas (Smėlio g. 13)";Drugeliai;6776805494;Ne;0;2;0;2
5350;"Naminukas (Smėlio g. 13)";Drugeliai;2395070574;Ne;6;1;4;11
5351;"Naminukas (Smėlio g. 13)";Drugeliai;2132345627;Ne;0;8;0;8
5352;"Naminukas (Smėlio g. 13)";Drugeliai;1302119260;Ne;0;1;0;1
5353;"Naminukas (Smėlio g. 13)";Drugeliai;2864905392;Ne;0;7;2;9
5354;"Naminukas (Smėlio g. 13)";Drugeliai;7406775925;Ne;5;0;0;5
5355;"Naminukas (Smėlio g. 13)";Drugeliai;1333462200;Ne;5;0;5;10
5356;"Naminukas (Smėlio g. 13)";Drugeliai;5713661641;Ne;0;12;1;13
5357;"Naminukas (Smėlio g. 13)";Drugeliai;6581925461;Ne;6;6;0;12
5358;"Naminukas (Smėlio g. 13)";Drugeliai;2198493034;Ne;0;1;0;1
5359;"Naminukas (Smėlio g. 13)";Drugeliai;8141324449;Ne;10;0;2;12
5360;"Naminukas (Smėlio g. 13)";Drugeliai;8564586014;Ne;2;10;0;12
5361;"Naminukas (Smėlio g. 13)";Drugeliai;3236525642;Ne;17;0;0;17
5362;"Naminukas (Smėlio g. 13)";Drugeliai;7347998152;Ne;0;11;0;11
5363;"Naminukas (Smėlio g. 13)";Drugeliai;7272465847;Ne;0;0;7;7
5364;"Naminukas (Smėlio g. 13)";Drugeliai;7450368045;Ne;5;0;0;5
5365;"Naminukas (Smėlio g. 13)";Bitutės;1956749138;Ne;0;8;0;8
5366;"Naminukas (Smėlio g. 13)";Bitutės;6503569633;Ne;0;11;4;15
5367;"Naminukas (Smėlio g. 13)";Bitutės;3192885665;Ne;0;2;4;6
5368;"Naminukas (Smėlio g. 13)";Bitutės;9530232649;Ne;0;1;0;1
5369;"Naminukas (Smėlio g. 13)";Bitutės;8131328042;Ne;0;7;4;11
5370;"Naminukas (Smėlio g. 13)";Bitutės;7888950723;Ne;0;5;0;5
5371;"Naminukas (Smėlio g. 13)";Bitutės;1710002948;Ne;0;1;0;1
5372;"Naminukas (Smėlio g. 13)";Bitutės;3994190066;Ne;0;3;0;3
5373;"Naminukas (Smėlio g. 13)";Bitutės;5195078101;Ne;0;1;0;1
5374;"Naminukas (Smėlio g. 13)";Bitutės;9541388086;Ne;0;5;0;5
5375;"Naminukas (Smėlio g. 13)";Bitutės;2424412518;Ne;0;5;0;5
5376;"Naminukas (Smėlio g. 13)";Bitutės;41538301616;Ne;0;1;0;1
5377;"Naminukas (Smėlio g. 13)";Bitutės;5493709688;Ne;14;0;1;15
5378;"Naminukas (Smėlio g. 13)";Bitutės;9821244713;Ne;2;0;2;4
5379;"Naminukas (Smėlio g. 13)";Bitutės;7847923107;Ne;5;0;0;5
5380;"Naminukas (Smėlio g. 13)";Bitutės;1480152104;Taip;8;0;0;8
5381;"Naminukas (Smėlio g. 13)";Bitutės;4331408714;Ne;2;0;0;2
5382;"Naminukas (Smėlio g. 13)";Paukšteliai;7297661383;Ne;0;2;2;4
5383;"Naminukas (Smėlio g. 13)";Paukšteliai;5056487802;Ne;0;13;0;13
5384;"Naminukas (Smėlio g. 13)";Paukšteliai;3438010199;Ne;0;0;10;10
5385;"Naminukas (Smėlio g. 13)";Paukšteliai;4998565160;Ne;0;8;0;8
5386;"Naminukas (Smėlio g. 13)";Paukšteliai;9405784626;Ne;10;0;4;14
5387;"Naminukas (Smėlio g. 13)";Paukšteliai;2583886896;Ne;9;0;0;9
5388;"Naminukas (Smėlio g. 13)";Paukšteliai;4778385421;Ne;0;14;0;14
5389;"Naminukas (Smėlio g. 13)";Paukšteliai;6178500478;Ne;5;0;1;6
5390;"Naminukas (Smėlio g. 13)";Paukšteliai;1406418130;Ne;5;5;0;10
5391;"Naminukas (Smėlio g. 13)";Paukšteliai;9891722891;Ne;0;10;0;10
5392;"Naminukas (Smėlio g. 13)";Paukšteliai;2012656186;Ne;0;0;4;4
5393;"Naminukas (Smėlio g. 13)";Paukšteliai;8470716196;Ne;3;0;0;3
5394;"Naminukas (Smėlio g. 13)";Paukšteliai;3727828033;Ne;0;9;2;11
5395;"Naminukas (Smėlio g. 13)";Paukšteliai;9657786543;Ne;7;0;0;7
5396;"Naminukas (Smėlio g. 13)";Paukšteliai;2652538212;Ne;5;0;0;5
5397;"Naminukas (Smėlio g. 13)";Paukšteliai;5280419144;Ne;11;0;1;12
5398;"Naminukas (Smėlio g. 13)";"NYKŠTUKAI ";7646186458;Ne;3;0;0;3
5399;"Naminukas (Smėlio g. 13)";"NYKŠTUKAI ";5519447152;Ne;6;8;0;14
5400;"Naminukas (Smėlio g. 13)";"NYKŠTUKAI ";5741698937;Ne;12;5;0;17
5401;"Naminukas (Smėlio g. 13)";"NYKŠTUKAI ";1286329245;Ne;0;18;0;18
5402;"Naminukas (Smėlio g. 13)";"NYKŠTUKAI ";7717132979;Ne;5;4;0;9
5403;"Naminukas (Smėlio g. 13)";"NYKŠTUKAI ";1618802271;Ne;17;0;0;17
5404;"Naminukas (Smėlio g. 13)";"NYKŠTUKAI ";1591540165;Taip;6;0;3;9
5405;"Naminukas (Smėlio g. 13)";"NYKŠTUKAI ";9537360943;Ne;7;8;0;15
5406;"Naminukas (Smėlio g. 13)";"NYKŠTUKAI ";1118193598;Ne;12;0;0;12
5407;"Naminukas (Smėlio g. 13)";"NYKŠTUKAI ";8102805098;Ne;8;4;0;12
5408;"Naminukas (Smėlio g. 13)";"NYKŠTUKAI ";1012030182;Ne;0;0;1;1
5409;"Naminukas (Smėlio g. 13)";"NYKŠTUKAI ";6992199844;Ne;0;0;1;1
5410;"Naminukas (Smėlio g. 13)";"NYKŠTUKAI ";9357758815;Ne;0;12;0;12
5411;"Naminukas (Smėlio g. 13)";"NYKŠTUKAI ";4422173848;Ne;11;11;0;22
5412;Nykštukas;SMALSIUKAI;9532956150;Ne;5;1;0;6
5413;Nykštukas;SMALSIUKAI;9303832542;Ne;0;1;1;2
5414;Nykštukas;AITVARIUKAI;6923345088;Ne;0;2;0;2
5415;Nykštukas;AITVARIUKAI;8580777381;Ne;5;0;0;5
5416;Nykštukas;AITVARIUKAI;9216544103;Ne;0;16;0;16
5417;Nykštukas;AITVARIUKAI;9319066179;Ne;12;0;0;12
5418;Nykštukas;AITVARIUKAI;2177539882;Ne;0;13;1;14
5419;Nykštukas;AITVARIUKAI;9595654681;Ne;17;0;0;17
5420;Nykštukas;AITVARIUKAI;9894698453;Ne;0;3;0;3
5421;Nykštukas;AITVARIUKAI;6351178752;Ne;4;0;0;4
5422;Nykštukas;AITVARIUKAI;7332769878;Taip;4;0;0;4
5423;Nykštukas;AITVARIUKAI;7896338372;Ne;2;0;0;2
5424;Nykštukas;AITVARIUKAI;2208319289;Ne;8;3;0;11
5425;Nykštukas;AITVARIUKAI;5285669371;Ne;5;0;0;5
5426;Nykštukas;AITVARIUKAI;8548820023;Ne;12;0;0;12
5427;Nykštukas;AITVARIUKAI;9545178064;Ne;0;1;0;1
5428;Nykštukas;AITVARIUKAI;3561627809;Ne;6;0;0;6
5429;Nykštukas;AITVARIUKAI;5972246871;Ne;10;0;1;11
5430;Nykštukas;AITVARIUKAI;5538446312;Ne;2;0;8;10
5431;Nykštukas;AITVARIUKAI;4177690371;Ne;0;0;4;4
5432;Nykštukas;AITVARIUKAI;5292127770;Ne;0;2;2;4
5433;Nykštukas;DAINORĖLIAI;7730918105;Ne;15;0;0;15
5434;Nykštukas;DAINORĖLIAI;8475127245;Ne;7;0;0;7
5435;Nykštukas;DAINORĖLIAI;5434220008;Ne;0;11;0;11
5436;Nykštukas;DAINORĖLIAI;1122600949;Ne;9;0;0;9
5437;Nykštukas;DAINORĖLIAI;3853935568;Ne;9;0;0;9
5438;Nykštukas;DAINORĖLIAI;9776630115;Ne;0;2;0;2
5439;Nykštukas;DAINORĖLIAI;5291104224;Ne;3;0;0;3
5440;Nykštukas;DAINORĖLIAI;3367348573;Ne;6;6;0;12
5441;Nykštukas;DAINORĖLIAI;5961945345;Ne;15;0;0;15
5442;Nykštukas;DAINORĖLIAI;6561696818;Ne;17;0;0;17
5443;Nykštukas;DAINORĖLIAI;1283453188;Ne;0;1;0;1
5444;Nykštukas;DAINORĖLIAI;1167614164;Ne;7;1;0;8
5445;Nykštukas;DAINORĖLIAI;7473124310;Taip;0;13;0;13
5446;Nykštukas;DAINORĖLIAI;1174618721;Ne;9;0;0;9
5447;Nykštukas;DAINORĖLIAI;8681884252;Ne;0;1;0;1
5448;Nykštukas;DAINORĖLIAI;5255726742;Ne;11;9;0;20
5449;Nykštukas;DAINORĖLIAI;9027355399;Ne;7;6;0;13
5450;Nykštukas;DAINORĖLIAI;4893494144;Ne;15;0;0;15
5451;Nykštukas;DAINORĖLIAI;8318089070;Ne;0;0;1;1
5452;Nykštukas;DAINORĖLIAI;2727074729;Ne;0;12;1;13
5453;Nykštukas;DAINORĖLIAI;9437700329;Ne;0;1;0;1
5454;Nykštukas;POKŠTUKAI;7382271765;Ne;14;0;0;14
5455;Nykštukas;POKŠTUKAI;1655428422;Ne;0;3;0;3
5456;Nykštukas;POKŠTUKAI;2649916049;Ne;17;0;0;17
5457;Nykštukas;POKŠTUKAI;1796016501;Ne;12;2;0;14
5458;Nykštukas;POKŠTUKAI;5958711585;Ne;6;2;0;8
5459;Nykštukas;POKŠTUKAI;6719999304;Ne;6;5;0;11
5460;Nykštukas;POKŠTUKAI;8148163137;Ne;0;8;0;8
5461;Nykštukas;POKŠTUKAI;8708184278;Ne;0;2;0;2
5462;Nykštukas;POKŠTUKAI;3843163586;Ne;0;2;0;2
5463;Nykštukas;POKŠTUKAI;3507649457;Ne;21;0;0;21
5464;Nykštukas;POKŠTUKAI;6698622575;Ne;0;2;0;2
5465;Nykštukas;POKŠTUKAI;2982662650;Ne;0;4;0;4
5466;Nykštukas;POKŠTUKAI;2627736026;Ne;0;17;0;17
5467;Nykštukas;POKŠTUKAI;4401103119;Ne;0;6;0;6
5468;Nykštukas;POKŠTUKAI;5287713634;Ne;0;6;0;6
5469;Nykštukas;KODĖLČIUKAI;8168579152;Ne;6;0;0;6
5470;Nykštukas;KODĖLČIUKAI;9285820767;Ne;8;0;0;8
5471;Nykštukas;KODĖLČIUKAI;2685400939;Ne;0;14;0;14
5472;Nykštukas;KODĖLČIUKAI;3278960733;Ne;0;0;2;2
5473;Nykštukas;KODĖLČIUKAI;5934979528;Ne;10;0;3;13
5474;Nykštukas;KODĖLČIUKAI;3760617860;Ne;2;6;0;8
5475;Nykštukas;KODĖLČIUKAI;6927545099;Ne;0;2;0;2
5476;Nykštukas;KODĖLČIUKAI;8042479133;Ne;6;2;4;12
5477;Nykštukas;KODĖLČIUKAI;6345791450;Ne;0;0;3;3
5478;Nykštukas;KODĖLČIUKAI;6999380958;Ne;12;0;0;12
5479;Nykštukas;KODĖLČIUKAI;6794885966;Ne;11;7;0;18
5480;Nykštukas;KODĖLČIUKAI;2623254163;Ne;22;0;0;22
5481;Nykštukas;KODĖLČIUKAI;9296449928;Ne;15;0;1;16
5482;Nykštukas;KODĖLČIUKAI;2992219360;Ne;0;22;0;22
5483;Nykštukas;KODĖLČIUKAI;4667303597;Ne;11;0;0;11
5484;Nykštukas;KODĖLČIUKAI;8804969886;Ne;2;10;0;12
5485;Nykštukas;KODĖLČIUKAI;3552386621;Ne;0;1;2;3
5486;Nykštukas;KODĖLČIUKAI;3990260342;Ne;6;0;0;6
5487;Nykštukas;KODĖLČIUKAI;2692551262;Ne;8;3;1;12
5488;Nykštukas;PASAKORIAI;2661110617;Ne;0;4;0;4
5489;Nykštukas;PASAKORIAI;3040001373;Ne;0;1;0;1
5490;Nykštukas;PASAKORIAI;1855278809;Ne;0;2;0;2
5491;Nykštukas;PASAKORIAI;8640715657;Ne;4;4;0;8
5492;Nykštukas;PASAKORIAI;5504584349;Ne;10;0;0;10
5493;Nykštukas;PASAKORIAI;7990462246;Ne;0;4;0;4
5494;Nykštukas;PASAKORIAI;2518342041;Ne;0;2;0;2
5495;Nykštukas;PASAKORIAI;4480184458;Ne;0;2;0;2
5496;Nykštukas;PASAKORIAI;4090494707;Ne;0;8;0;8
5497;Nykštukas;PASAKORIAI;3026598985;Ne;11;0;0;11
5498;Nykštukas;PASAKORIAI;9714310539;Ne;0;2;0;2
5499;Nykštukas;PASAKORIAI;4795301170;Ne;8;3;0;11
5500;Nykštukas;PASAKORIAI;1579064341;Ne;5;0;0;5
5501;Nykštukas;PASAKORIAI;4992654449;Ne;11;0;1;12
5502;Nykštukas;PASAKORIAI;5337728911;Ne;0;3;0;3
5503;Nykštukas;PASAKORIAI;9509051946;Ne;0;6;0;6
5504;Nykštukas;PASAKORIAI;8371081106;Ne;6;11;0;17
5505;Nykštukas;GUDRUČIAI;9871410323;Ne;0;1;0;1
5506;Nykštukas;GUDRUČIAI;4559818614;Ne;0;10;0;10
5507;Nykštukas;GUDRUČIAI;9250827058;Ne;0;4;0;4
5508;Nykštukas;GUDRUČIAI;7447202642;Ne;6;7;0;13
5509;Nykštukas;GUDRUČIAI;1714708754;Ne;0;4;0;4
5510;Nykštukas;GUDRUČIAI;5157799354;Ne;22;0;0;22
5511;Nykštukas;GUDRUČIAI;4325369395;Ne;14;0;0;14
5512;Nykštukas;GUDRUČIAI;6630804505;Ne;2;5;0;7
5513;Nykštukas;GUDRUČIAI;8363202198;Ne;0;5;0;5
5514;Nykštukas;GUDRUČIAI;7326535810;Ne;0;7;0;7
5515;Nykštukas;GUDRUČIAI;9712596180;Ne;5;0;2;7
5516;Nykštukas;GUDRUČIAI;9941937734;Ne;0;0;1;1
5517;Nykštukas;GUDRUČIAI;2494482185;Ne;2;0;0;2
5518;Nykštukas;GUDRUČIAI;3619459404;Ne;4;0;1;5
5519;Nykštukas;GUDRUČIAI;7604740418;Ne;0;7;0;7
5520;Nykštukas;GUDRUČIAI;2970293467;Ne;10;4;0;14
5521;Nykštukas;GUDRUČIAI;2881323571;Ne;0;6;1;7
5522;Nykštukas;GUDRUČIAI;2872277381;Ne;0;3;0;3
5523;Nykštukas;GUDRUČIAI;9940519259;Ne;2;0;3;5
5524;Nykštukas;NAMINUKAI;7456007276;Ne;0;4;0;4
5525;Nykštukas;NAMINUKAI;7176519994;Ne;11;0;0;11
5526;Nykštukas;NAMINUKAI;2440574056;Ne;0;5;0;5
5527;Nykštukas;NAMINUKAI;4064016871;Ne;7;1;0;8
5528;Nykštukas;NAMINUKAI;5032283848;Ne;0;0;1;1
5529;Nykštukas;NAMINUKAI;7494444468;Ne;5;2;1;8
5530;Nykštukas;NAMINUKAI;3925958632;Ne;5;2;1;8
5531;Nykštukas;NAMINUKAI;6338717583;Ne;0;3;0;3
5532;Nykštukas;NAMINUKAI;7976689381;Ne;0;0;4;4
5533;Nykštukas;NAMINUKAI;9686815141;Ne;0;3;0;3
5534;Nykštukas;NAMINUKAI;9575291096;Ne;0;1;0;1
5535;Nykštukas;NAMINUKAI;4503830456;Ne;2;1;0;3
5536;Nykštukas;NAMINUKAI;4040123876;Ne;0;16;0;16
5537;Nykštukas;NAMINUKAI;1088633575;Ne;10;3;0;13
5538;Nykštukas;NAMINUKAI;5088668786;Ne;0;16;0;16
5539;Nykštukas;NAMINUKAI;8874850019;Ne;0;2;0;2
5540;Nykštukas;NAMINUKAI;1510338621;Ne;3;0;0;3
5541;Nykštukas;NAMINUKAI;9067774103;Ne;22;0;0;22
5542;Nykštukas;KŪLVERSTUKAI;7320458031;Ne;17;0;0;17
5543;Nykštukas;KŪLVERSTUKAI;1148800623;Taip;0;1;0;1
5544;Nykštukas;KŪLVERSTUKAI;7078264994;Ne;4;0;0;4
5545;Nykštukas;KŪLVERSTUKAI;6786896381;Ne;11;0;0;11
5546;Nykštukas;KŪLVERSTUKAI;7432373335;Ne;0;7;0;7
5547;Nykštukas;KŪLVERSTUKAI;3660330885;Ne;8;2;0;10
5548;Nykštukas;KŪLVERSTUKAI;8919778025;Ne;5;6;0;11
5549;Nykštukas;KŪLVERSTUKAI;6337924089;Ne;13;0;0;13
5550;Nykštukas;KŪLVERSTUKAI;4323166473;Ne;14;0;0;14
5551;Nykštukas;KŪLVERSTUKAI;2748970206;Ne;22;0;0;22
5552;Nykštukas;KŪLVERSTUKAI;3441133631;Ne;0;2;0;2
5553;Nykštukas;KŪLVERSTUKAI;4490310109;Ne;9;1;0;10
5554;Nykštukas;KŪLVERSTUKAI;2947976429;Ne;22;0;0;22
5555;Nykštukas;KŪLVERSTUKAI;2763268154;Ne;0;2;0;2
5556;Nykštukas;KŪLVERSTUKAI;9887096503;Ne;0;3;0;3
5557;Nykštukas;KŪLVERSTUKAI;7562216310;Ne;0;6;0;6
5558;Nykštukas;TREPSIUKAI;2052451745;Ne;7;0;0;7
5559;Nykštukas;TREPSIUKAI;8701731017;Ne;1;2;1;4
5560;Nykštukas;TREPSIUKAI;4955003100;Ne;15;0;0;15
5561;Nykštukas;TREPSIUKAI;5103512898;Ne;14;0;0;14
5562;Nykštukas;TREPSIUKAI;7603500691;Ne;12;0;0;12
5563;Nykštukas;TREPSIUKAI;7266550834;Ne;11;0;0;11
5564;Nykštukas;TREPSIUKAI;6563871327;Ne;3;7;0;10
5565;Nykštukas;TREPSIUKAI;5085577592;Ne;0;1;0;1
5566;Nykštukas;TREPSIUKAI;8819485547;Ne;14;0;0;14
5567;Nykštukas;TREPSIUKAI;5281616311;Ne;10;0;0;10
5568;Nykštukas;TREPSIUKAI;8372380734;Ne;0;1;0;1
5569;Nykštukas;TREPSIUKAI;6672148719;Ne;19;0;0;19
5570;Nykštukas;TREPSIUKAI;5718555692;Ne;0;2;0;2
5571;Nykštukas;TREPSIUKAI;4499337321;Ne;13;0;0;13
5572;Nykštukas;TREPSIUKAI;8667489439;Ne;0;1;0;1
5573;Nykštukas;TREPSIUKAI;5010715255;Ne;4;1;0;5
5574;Nykštukas;TREPSIUKAI;8047072198;Ne;5;0;0;5
5575;Nykštukas;TREPSIUKAI;9790322329;Ne;0;1;0;1
5576;Nykštukas;TREPSIUKAI;8695794490;Ne;0;11;0;11
5577;Nykštukas;ŽIRNIUKAI;9661862689;Ne;18;0;0;18
5578;Nykštukas;ŽIRNIUKAI;1671340074;Ne;8;0;0;8
5579;Nykštukas;ŽIRNIUKAI;3339707558;Ne;0;1;0;1
5580;Nykštukas;ŽIRNIUKAI;7908029688;Ne;0;1;1;2
5581;Nykštukas;ŽIRNIUKAI;7299329150;Ne;5;5;0;10
5582;Nykštukas;ŽIRNIUKAI;9174636607;Ne;5;0;0;5
5583;Nykštukas;ŽIRNIUKAI;7535385367;Taip;1;7;0;8
5584;Nykštukas;ŽIRNIUKAI;6709760898;Ne;10;0;0;10
5585;Nykštukas;ŽIRNIUKAI;2670682135;Ne;9;2;0;11
5586;Nykštukas;ŽIRNIUKAI;1202614927;Ne;2;0;1;3
5587;Nykštukas;ŽIRNIUKAI;1366524995;Ne;0;2;0;2
5588;Nykštukas;ŽIRNIUKAI;2800783215;Ne;0;22;0;22
5589;Nykštukas;ŽIRNIUKAI;2620150024;Ne;0;0;19;19
5590;Nykštukas;ŽIRNIUKAI;3032028847;Ne;20;0;0;20
5591;Nykštukas;ŽIRNIUKAI;4144437365;Ne;0;6;0;6
5592;Nykštukas;ŽIRNIUKAI;6884714823;Ne;0;4;0;4
5593;Nykštukas;ŽIRNIUKAI;1616644404;Ne;6;1;4;11
5594;Nykštukas;ŽIRNIUKAI;9270615518;Ne;6;2;0;8
5595;Nykštukas;ŽIRNIUKAI;2078586374;Ne;0;5;2;7
5596;Nykštukas;ŽIRNIUKAI;1102203704;Ne;5;0;0;5
5597;Ozas;Smalsučiai;2641398988;Ne;5;0;0;5
5598;Ozas;Smalsučiai;9227939420;Ne;5;0;0;5
5599;Ozas;Smalsučiai;87218067796;Ne;10;1;0;11
5600;Ozas;Smalsučiai;4397034031;Ne;7;2;0;9
5601;Ozas;Smalsučiai;1974320330;Ne;3;2;0;5
5602;Ozas;Smalsučiai;1173284700;Ne;0;7;0;7
5603;Ozas;Smalsučiai;67987032400;Ne;0;0;1;1
5604;Ozas;Smalsučiai;71695973592;Ne;2;2;1;5
5605;Ozas;Smalsučiai;57069047630;Ne;7;8;1;16
5606;Ozas;Smalsučiai;3326395879;Ne;9;0;0;9
5607;Ozas;Smalsučiai;5150746885;Ne;0;1;0;1
5608;Ozas;Smalsučiai;1893257809;Ne;4;0;1;5
5609;Ozas;Smalsučiai;6540803077;Ne;5;0;0;5
5610;Ozas;Smalsučiai;8072802467;Ne;6;0;0;6
5611;Ozas;Smalsučiai;1248092034;Ne;0;1;0;1
5612;Ozas;Smalsučiai;43381497677;Ne;2;0;2;4
5613;Ozas;Smalsučiai;7351651916;Ne;10;0;0;10
5614;Ozas;Smalsučiai;3286170280;Ne;0;0;3;3
5615;Ozas;Smalsučiai;9521048381;Ne;8;0;1;9
5616;Ozas;Smalsučiai;5342394742;Ne;0;1;0;1
5617;Ozas;Drugeliai;7802699257;Ne;0;3;0;3
5618;Ozas;Drugeliai;6668470892;Ne;0;0;1;1
5619;Ozas;Drugeliai;2302999759;Ne;0;1;0;1
5620;Ozas;Drugeliai;8088330187;Ne;0;13;0;13
5621;Ozas;Drugeliai;9322806566;Ne;0;9;0;9
5622;Ozas;Drugeliai;2676747542;Ne;8;0;6;14
5623;Ozas;Drugeliai;2812687451;Ne;10;0;0;10
5624;Ozas;Drugeliai;8289643065;Ne;0;1;0;1
5625;Ozas;Drugeliai;9987863302;Ne;0;8;2;10
5626;Ozas;Drugeliai;2980799420;Ne;22;0;0;22
5627;Ozas;Drugeliai;8318380547;Ne;0;5;0;5
5628;Ozas;Drugeliai;4884054504;Ne;4;0;0;4
5629;Ozas;Drugeliai;43660054250;Ne;0;20;0;20
5630;Ozas;Drugeliai;7565002863;Ne;0;0;2;2
5631;Ozas;Drugeliai;15262583232;Ne;2;17;0;19
5632;Ozas;Drugeliai;1103685699;Ne;0;1;0;1
5633;Ozas;Drugeliai;1335655483;Ne;9;0;0;9
5634;Ozas;Drugeliai;4207160323;Ne;12;0;0;12
5635;Ozas;Drugeliai;1837947633;Ne;0;6;0;6
5636;Ozas;Boružėlės;1348960421;Ne;0;0;10;10
5637;Ozas;Boružėlės;1375643969;Ne;0;0;14;14
5638;Ozas;Boružėlės;63852147122;Ne;0;1;3;4
5639;Ozas;Boružėlės;8190314087;Ne;13;1;0;14
5640;Ozas;Boružėlės;3803998816;Ne;0;4;0;4
5641;Ozas;Boružėlės;1212358423;Ne;7;1;0;8
5642;Ozas;Boružėlės;7615907271;Ne;0;3;2;5
5643;Ozas;Boružėlės;1560342499;Ne;0;2;0;2
5644;Ozas;Boružėlės;8529654920;Ne;0;1;1;2
5645;Ozas;Boružėlės;2527574646;Ne;0;5;0;5
5646;Ozas;Boružėlės;36523514229;Ne;0;8;0;8
5647;Ozas;Boružėlės;1367050160;Ne;10;0;1;11
5648;Ozas;Boružėlės;2678629892;Ne;0;0;4;4
5649;Ozas;Boružėlės;1826499734;Ne;0;2;0;2
5650;Ozas;Boružėlės;6432357144;Ne;0;0;3;3
5651;Ozas;Boružėlės;1498656201;Ne;10;0;0;10
5652;Ozas;Boružėlės;9130645878;Ne;9;0;1;10
5653;Ozas;Boružėlės;60194872867;Ne;11;1;0;12
5654;Ozas;Boružėlės;7172573921;Ne;0;0;5;5
5655;Ozas;Boružėlės;1109113859;Ne;2;0;5;7
5656;Ozas;Boružėlės;68364031736;Ne;0;3;0;3
5657;Ozas;Žiogeliai;7461521320;Ne;0;2;0;2
5658;Ozas;Žiogeliai;1562277866;Ne;0;7;0;7
5659;Ozas;Žiogeliai;4571583671;Ne;0;0;2;2
5660;Ozas;Žiogeliai;5682027094;Ne;0;8;12;20
5661;Ozas;Žiogeliai;4966355020;Ne;5;0;0;5
5662;Ozas;Žiogeliai;3770045761;Ne;0;0;1;1
5663;Ozas;Žiogeliai;9324647606;Ne;0;0;2;2
5664;Ozas;Žiogeliai;9392526836;Ne;0;1;0;1
5665;Ozas;Žiogeliai;4942550213;Ne;0;0;12;12
5666;Ozas;Žiogeliai;8676986286;Ne;0;9;2;11
5667;Ozas;Žiogeliai;5420952391;Ne;0;9;0;9
5668;Ozas;Žiogeliai;9929822317;Ne;0;5;0;5
5669;Ozas;Žiogeliai;2837228320;Ne;0;3;0;3
5670;Ozas;Žiogeliai;5156383727;Ne;0;6;0;6
5671;Ozas;Žiogeliai;2617258206;Ne;0;16;1;17
5672;Ozas;Žiogeliai;9768754737;Ne;0;14;0;14
5673;Ozas;Žiogeliai;4030056504;Ne;4;0;1;5
5674;Ozas;Bitutės;4220780257;Ne;9;0;0;9
5675;Ozas;Bitutės;1161776624;Ne;0;0;3;3
5676;Ozas;Bitutės;4227555342;Taip;15;0;0;15
5677;Ozas;Bitutės;7499756171;Ne;0;22;0;22
5678;Ozas;Bitutės;2369544599;Ne;0;1;0;1
5679;Ozas;Bitutės;3329391600;Ne;0;5;0;5
5680;Ozas;Bitutės;4254601638;Ne;9;0;0;9
5681;Ozas;Bitutės;4699369567;Taip;0;0;3;3
5682;Ozas;Bitutės;8304671844;Ne;0;3;0;3
5683;Ozas;Bitutės;9772085405;Ne;0;1;1;2
5684;Ozas;Bitutės;7051699003;Ne;3;10;0;13
5685;Ozas;Bitutės;5383877034;Ne;0;0;5;5
5686;Ozas;Bitutės;1117208248;Ne;10;1;0;11
5687;Ozas;Bitutės;6811181735;Ne;20;2;0;22
5688;Ozas;Bitutės;8622621570;Ne;14;0;1;15
5689;Ozas;Bitutės;7494307084;Ne;8;2;0;10
5690;Ozas;Bitutės;1475005204;Ne;0;6;1;7
5691;Ozas;Bitutės;1895519949;Ne;0;0;2;2
5692;Ozas;Aitvarėliai;1144679735;Ne;17;0;1;18
5693;Ozas;Aitvarėliai;2773182934;Ne;11;0;1;12
5694;Ozas;Aitvarėliai;4357737538;Ne;0;0;2;2
5695;Ozas;Aitvarėliai;5642468671;Ne;3;0;1;4
5696;Ozas;Aitvarėliai;1045890394;Ne;0;0;3;3
5697;Ozas;Aitvarėliai;7686706482;Ne;0;1;0;1
5698;Ozas;Aitvarėliai;2395567376;Ne;0;0;4;4
5699;Ozas;Aitvarėliai;2922370952;Ne;0;0;4;4
5700;Ozas;Aitvarėliai;5383739203;Ne;4;1;0;5
5701;Ozas;Aitvarėliai;4583818638;Ne;0;9;0;9
5702;Ozas;Aitvarėliai;2165291778;Ne;0;6;0;6
5703;Ozas;Aitvarėliai;8754244281;Ne;0;9;3;12
5704;Ozas;Aitvarėliai;6646671212;Ne;7;0;0;7
5705;Ozas;Aitvarėliai;9443843603;Ne;0;8;1;9
5706;Ozas;Aitvarėliai;3238019756;Ne;13;1;0;14
5707;Ozas;Aitvarėliai;8987796218;Ne;12;5;0;17
5708;Ozas;Aitvarėliai;2544858937;Ne;4;0;1;5
5709;Ozas;Aitvarėliai;3783477511;Ne;0;13;0;13
5710;Ozas;Aitvarėliai;6778987483;Ne;4;0;0;4
5711;Ozas;Aitvarėliai;9813020279;Ne;0;7;0;7
5712;Ozas;Aitvarėliai;7009893338;Ne;12;0;0;12
5713;Ozas;Voveraitės;8178298861;Ne;6;4;4;14
5714;Ozas;Voveraitės;6263062055;Ne;0;4;0;4
5715;Ozas;Voveraitės;9195536968;Ne;0;10;3;13
5716;Ozas;Voveraitės;2991511872;Ne;7;0;0;7
5717;Ozas;Voveraitės;5016547315;Ne;2;7;0;9
5718;Ozas;Voveraitės;1564826076;Ne;0;15;0;15
5719;Ozas;Voveraitės;2511477658;Ne;0;5;0;5
5720;Ozas;Voveraitės;1240233169;Ne;0;0;2;2
5721;Ozas;Voveraitės;6088757991;Ne;4;2;0;6
5722;Ozas;Voveraitės;5822871838;Ne;7;2;0;9
5723;Ozas;Voveraitės;2635045515;Ne;0;1;0;1
5724;Ozas;Voveraitės;6666591428;Ne;5;2;0;7
5725;Ozas;Voveraitės;2297650260;Ne;2;5;0;7
5726;Ozas;Voveraitės;7908028909;Ne;2;0;0;2
5727;Ozas;Voveraitės;9762737217;Ne;0;2;0;2
5728;Ozas;Voveraitės;7421484648;Ne;13;0;9;22
5729;Ozas;Voveraitės;1997125531;Ne;8;3;0;11
5730;Ozas;Voveraitės;6053885086;Ne;0;1;0;1
5731;Ozas;Voveraitės;7978092840;Ne;0;2;0;2
5732;Ozas;Voveraitės;5751808248;Ne;5;0;1;6
5733;Ozas;Voveraitės;4556076744;Ne;1;0;5;6
5734;Ozas;Voveraitės;8503041003;Ne;0;0;2;2
5735;Ozas;Kodelčiukai;8743467101;Ne;0;7;0;7
5736;Ozas;Kodelčiukai;2964318343;Ne;7;0;2;9
5737;Ozas;Kodelčiukai;8696127374;Ne;0;3;0;3
5738;Ozas;Kodelčiukai;3704303636;Ne;0;8;0;8
5739;Ozas;Kodelčiukai;2951875705;Ne;0;3;0;3
5740;Ozas;Kodelčiukai;7305274617;Ne;5;0;0;5
5741;Ozas;Kodelčiukai;9306887706;Ne;7;0;1;8
5742;Ozas;Kodelčiukai;1348751454;Ne;5;12;0;17
5743;Ozas;Kodelčiukai;9322080266;Ne;0;2;0;2
5744;Ozas;Kodelčiukai;6809992664;Taip;2;9;0;11
5745;Ozas;Kodelčiukai;4516291572;Ne;0;1;0;1
5746;Ozas;Kodelčiukai;4287719751;Ne;5;7;0;12
5747;Ozas;Kodelčiukai;9620747099;Ne;10;0;0;10
5748;Ozas;Kodelčiukai;5216695220;Ne;2;0;0;2
5749;Ozas;Kodelčiukai;8779047802;Ne;8;1;0;9
5750;Ozas;Kodelčiukai;6783755555;Taip;0;8;0;8
5751;Ozas;Kodelčiukai;8797919230;Ne;0;0;1;1
5752;Ozas;Pelėdžiukai;4640897674;Ne;0;7;0;7
5753;Ozas;Pelėdžiukai;9277208213;Ne;14;0;0;14
5754;Ozas;Pelėdžiukai;8040293681;Ne;0;0;6;6
5755;Ozas;Pelėdžiukai;1856258542;Ne;5;5;0;10
5756;Ozas;Pelėdžiukai;7640409923;Ne;0;3;0;3
5757;Ozas;Pelėdžiukai;4601869799;Ne;0;1;1;2
5758;Ozas;Pelėdžiukai;5958055645;Ne;7;0;1;8
5759;Ozas;Pelėdžiukai;7125754645;Ne;4;0;10;14
5760;Ozas;Pelėdžiukai;2824133388;Ne;7;1;0;8
5761;Ozas;Pelėdžiukai;2637531106;Ne;3;7;0;10
5762;Ozas;Pelėdžiukai;7287989663;Ne;4;0;0;4
5763;Ozas;Pelėdžiukai;6819000895;Ne;0;0;1;1
5764;Ozas;Pelėdžiukai;5950860889;Ne;0;6;0;6
5765;Ozas;Pelėdžiukai;4886045470;Ne;3;5;0;8
5766;Ozas;Pelėdžiukai;3212050416;Ne;0;2;0;2
5767;Ozas;Pelėdžiukai;3725141591;Ne;0;0;2;2
5768;Ozas;Pelėdžiukai;3711403511;Ne;0;10;5;15
5769;Ozas;Pelėdžiukai;5392929222;Ne;22;0;0;22
5770;Ozas;Pelėdžiukai;7038928164;Ne;4;0;0;4
5771;Ozas;Pelėdžiukai;8131525146;Ne;7;0;0;7
5772;Ozas;"Kačiukai ";4857216527;Ne;0;0;1;1
5773;Ozas;"Kačiukai ";7776754188;Ne;12;0;0;12
5774;Ozas;"Kačiukai ";5097380041;Ne;5;0;1;6
5775;Ozas;"Kačiukai ";3109261153;Ne;8;0;0;8
5776;Ozas;"Kačiukai ";9781398468;Ne;21;0;0;21
5777;Ozas;"Kačiukai ";8488500486;Ne;6;0;0;6
5778;Ozas;"Kačiukai ";2512535949;Ne;13;0;0;13
5779;Ozas;"Kačiukai ";5421245991;Ne;0;2;0;2
5780;Ozas;"Kačiukai ";9781527964;Ne;3;14;0;17
5781;Ozas;"Kačiukai ";4514798132;Ne;0;8;11;19
5782;Ozas;"Kačiukai ";9655492678;Ne;4;0;0;4
5783;Ozas;"Kačiukai ";2729524188;Ne;18;0;0;18
5784;Ozas;Ančiukų;3037323341;Ne;3;2;0;5
5785;Ozas;Ančiukų;2869987587;Ne;6;2;0;8
5786;Ozas;Ančiukų;5926100815;Ne;0;1;0;1
5787;Ozas;Ančiukų;9178967858;Ne;9;0;2;11
5788;Ozas;Ančiukų;2454569369;Ne;6;0;0;6
5789;Ozas;Ančiukų;3133776891;Ne;0;0;1;1
5790;Ozas;Ančiukų;2139224651;Ne;0;0;8;8
5791;Ozas;Ančiukų;2819545359;Ne;0;12;0;12
5792;Ozas;Ančiukų;1803782282;Taip;8;2;0;10
5793;Ozas;Ančiukų;5172367556;Ne;0;14;0;14
5794;Ozas;Ančiukų;5677543279;Ne;2;0;0;2
5795;Ozas;Ančiukų;8923372952;Ne;3;0;0;3
5796;Ozas;Ančiukų;7617839839;Ne;10;1;0;11
5797;Ozas;Ančiukų;9506090620;Ne;0;2;0;2
5798;Ozas;Ančiukų;6346123124;Ne;13;1;0;14
5799;Ozas;Nykškukų;3139289643;Ne;0;9;0;9
5800;Ozas;Nykškukų;7585213159;Ne;2;7;0;9
5801;Ozas;Nykškukų;3902722274;Ne;2;11;0;13
5802;Ozas;Nykškukų;7922667688;Ne;12;0;4;16
5803;Ozas;Nykškukų;8781771299;Ne;4;0;0;4
5804;Ozas;Nykškukų;3817138493;Ne;2;4;0;6
5805;Ozas;Nykškukų;8371368881;Ne;12;0;0;12
5806;Ozas;Nykškukų;6476147361;Ne;0;0;3;3
5807;Ozas;Nykškukų;4994121247;Ne;12;5;0;17
5808;Ozas;Nykškukų;6315443248;Ne;10;1;0;11
5809;Ozas;Nykškukų;3723247420;Ne;18;0;0;18
5810;Ozas;Nykškukų;6318419889;Taip;5;1;0;6
5811;Ozas;Nykškukų;6186850614;Ne;0;0;1;1
5812;Ozas;Nykškukų;5182160089;Ne;17;0;0;17
5813;Ozas;Nykškukų;1536889312;Ne;13;5;0;18
5814;Ozas;Nykškukų;8897904793;Ne;9;0;0;9
5815;Pabiručiai;Voveriukų;4539246865;Ne;0;6;0;6
5816;Pabiručiai;Voveriukų;1498738549;Ne;1;4;0;5
5817;Pabiručiai;Voveriukų;2349337471;Ne;9;1;0;10
5818;Pabiručiai;Voveriukų;9564303781;Ne;0;0;5;5
5819;Pabiručiai;Voveriukų;4312364951;Ne;0;12;1;13
5820;Pabiručiai;Voveriukų;3756731363;Ne;0;0;8;8
5821;Pabiručiai;Voveriukų;7985360502;Ne;4;0;0;4
5822;Pabiručiai;Voveriukų;3936426174;Ne;0;0;1;1
5823;Pabiručiai;Voveriukų;4069564285;Ne;0;5;0;5
5824;Pabiručiai;Voveriukų;7278334800;Ne;0;2;0;2
5825;Pabiručiai;Voveriukų;9468698553;Ne;0;8;0;8
5826;Pabiručiai;Voveriukų;5232678556;Taip;0;1;0;1
5827;Pabiručiai;Voveriukų;7066037017;Ne;3;0;0;3
5828;Pabiručiai;Voveriukų;5549851164;Ne;8;2;0;10
5829;Pabiručiai;Voveriukų;4040533883;Ne;0;14;0;14
5830;Pabiručiai;Voveriukų;2514312233;Ne;0;4;0;4
5831;Pabiručiai;Voveriukų;7606274875;Ne;0;4;0;4
5832;Pabiručiai;Voveriukų;9356327400;Ne;0;1;0;1
5833;Pabiručiai;Voveriukų;4813206044;Ne;0;8;0;8
5834;Pabiručiai;Voveriukų;7846758352;Ne;6;2;0;8
5835;Pabiručiai;Boružiukų;6401188653;Ne;0;1;0;1
5836;Pabiručiai;Boružiukų;1673473814;Ne;10;7;0;17
5837;Pabiručiai;Boružiukų;5686769648;Ne;0;12;0;12
5838;Pabiručiai;Boružiukų;7524993271;Ne;3;1;0;4
5839;Pabiručiai;Boružiukų;5708597471;Ne;0;1;0;1
5840;Pabiručiai;Boružiukų;7046122545;Ne;0;3;0;3
5841;Pabiručiai;Boružiukų;3096466200;Ne;0;2;0;2
5842;Pabiručiai;Boružiukų;4301904533;Ne;0;2;1;3
5843;Pabiručiai;Boružiukų;8236964683;Ne;0;1;0;1
5844;Pabiručiai;Boružiukų;1240057541;Ne;0;3;0;3
5845;Pabiručiai;Boružiukų;1671027282;Ne;0;3;0;3
5846;Pabiručiai;Boružiukų;3759350345;Ne;0;8;0;8
5847;Pabiručiai;Boružiukų;3151360288;Ne;0;5;0;5
5848;Pabiručiai;Boružiukų;9299393363;Ne;0;5;0;5
5849;Pabiručiai;Boružiukų;1484291546;Ne;0;2;0;2
5850;Pabiručiai;Boružiukų;2771769336;Ne;0;1;0;1
5851;Pabiručiai;Boružiukų;2607840684;Ne;0;1;0;1
5852;Pabiručiai;Boružiukų;4681771534;Ne;3;1;0;4
5853;Pabiručiai;Boružiukų;7050339198;Ne;0;16;0;16
5854;Pabiručiai;Boružiukų;4798503931;Ne;10;0;2;12
5855;Pabiručiai;Katinėlių;8284711578;Ne;0;0;1;1
5856;Pabiručiai;Katinėlių;8710389714;Ne;0;0;1;1
5857;Pabiručiai;Katinėlių;1670938208;Ne;7;0;1;8
5858;Pabiručiai;Katinėlių;4205107384;Ne;0;0;1;1
5859;Pabiručiai;Katinėlių;4501176225;Ne;0;1;0;1
5860;Pabiručiai;Katinėlių;1749155319;Ne;0;2;8;10
5861;Pabiručiai;Katinėlių;2572570925;Ne;0;9;0;9
5862;Pabiručiai;Katinėlių;34883375155;Ne;0;2;0;2
5863;Pabiručiai;Katinėlių;8306688649;Ne;0;1;0;1
5864;Pabiručiai;Katinėlių;1705085006;Ne;10;9;0;19
5865;Pabiručiai;Katinėlių;58112415466;Ne;5;2;1;8
5866;Pabiručiai;Katinėlių;95695057362;Ne;0;1;0;1
5867;Pabiručiai;Katinėlių;42877891797;Ne;0;11;0;11
5868;Pabiručiai;Katinėlių;6285940478;Ne;0;1;0;1
5869;Pabiručiai;Katinėlių;1122183123;Ne;0;2;12;14
5870;Pabiručiai;Žiogelių;6548776238;Ne;1;0;2;3
5871;Pabiručiai;Žiogelių;3272576627;Ne;0;0;1;1
5872;Pabiručiai;Žiogelių;5522447437;Ne;2;1;0;3
5873;Pabiručiai;Žiogelių;3585198013;Ne;0;10;0;10
5874;Pabiručiai;Žiogelių;7974345478;Ne;0;4;0;4
5875;Pabiručiai;Žiogelių;3206962828;Ne;7;0;1;8
5876;Pabiručiai;Žiogelių;3355875364;Ne;0;2;0;2
5877;Pabiručiai;Žiogelių;5311762824;Ne;13;0;3;16
5878;Pabiručiai;Žiogelių;1587905929;Ne;0;2;0;2
5879;Pabiručiai;Žiogelių;4667769378;Ne;0;5;0;5
5880;Pabiručiai;Žiogelių;7085036701;Ne;0;11;0;11
5881;Pabiručiai;Žiogelių;8736658575;Ne;0;8;0;8
5882;Pabiručiai;Žiogelių;8106446562;Ne;0;3;0;3
5883;Pabiručiai;Žiogelių;8421025940;Ne;0;1;0;1
5884;Pabiručiai;Žiogelių;1311650644;Ne;0;5;0;5
5885;Pabiručiai;Žiogelių;3028063887;Ne;0;0;7;7
5886;Pabiručiai;Smalsiukai;7677235214;Ne;0;0;1;1
5887;Pabiručiai;Smalsiukai;9676561758;Ne;0;4;0;4
5888;Pabiručiai;Smalsiukai;7632969321;Ne;0;19;0;19
5889;Pabiručiai;Smalsiukai;7090116276;Ne;0;0;4;4
5890;Pabiručiai;Smalsiukai;4408666547;Ne;0;0;1;1
5891;Pabiručiai;Smalsiukai;9093137227;Ne;0;5;0;5
5892;Pabiručiai;Smalsiukai;6935913132;Ne;10;0;0;10
5893;Pabiručiai;Smalsiukai;1344711015;Ne;0;1;0;1
5894;Pabiručiai;Smalsiukai;7663581089;Ne;0;2;3;5
5895;Pabiručiai;Smalsiukai;9610623364;Ne;0;7;0;7
5896;Pabiručiai;Smalsiukai;8897462614;Ne;0;2;4;6
5897;Pabiručiai;Smalsiukai;2332338995;Ne;16;0;0;16
5898;Pabiručiai;Smalsiukai;4258226042;Ne;0;3;0;3
5899;Pabiručiai;Smalsiukai;3511851810;Ne;0;1;0;1
5900;Pabiručiai;Smalsiukai;6686039601;Ne;0;0;13;13
5901;Pabiručiai;Smalsiukai;8840885039;Ne;0;0;2;2
5902;Pabiručiai;Smalsiukai;2771891999;Ne;2;0;3;5
5903;Pabiručiai;Smalsiukai;7295052694;Ne;0;4;0;4
5904;Pabiručiai;Smalsiukai;6834663627;Ne;6;8;0;14
5905;Pabiručiai;Kiškučiai;3368607302;Ne;10;1;0;11
5906;Pabiručiai;Kiškučiai;9589005897;Ne;0;2;0;2
5907;Pabiručiai;Kiškučiai;9353062804;Ne;15;0;0;15
5908;Pabiručiai;Kiškučiai;1582754284;Ne;22;0;0;22
5909;Pabiručiai;Kiškučiai;4462744848;Ne;5;14;0;19
5910;Pabiručiai;Kiškučiai;5621183663;Ne;6;5;0;11
5911;Pabiručiai;Kiškučiai;9417138573;Ne;0;7;0;7
5912;Pabiručiai;Kiškučiai;1515270273;Ne;0;6;0;6
5913;Pabiručiai;Kiškučiai;2688728915;Ne;11;4;0;15
5914;Pabiručiai;Kiškučiai;5166525832;Ne;5;4;0;9
5915;Pabiručiai;Kiškučiai;8409455566;Ne;9;2;0;11
5916;Pabiručiai;Kiškučiai;1028312285;Ne;0;3;0;3
5917;Pabiručiai;Kiškučiai;5346249456;Taip;0;12;0;12
5918;Pabiručiai;Kiškučiai;5717534175;Ne;4;8;0;12
5919;Pabiručiai;Kiškučiai;3408518493;Ne;0;8;0;8
5920;Pabiručiai;Kiškučiai;7653129291;Ne;0;1;0;1
5921;Pabiručiai;Kiškučiai;7073230645;Taip;0;1;0;1
5922;Pabiručiai;Kiškučiai;8820585407;Ne;0;3;0;3
5923;Pabiručiai;Kiškučiai;7572077461;Ne;3;1;0;4
5924;Pabiručiai;Kiškučiai;5767879226;Ne;0;4;0;4
5925;Pabiručiai;"Pėledžiukai ";9834824219;Taip;4;15;0;19
5926;Pabiručiai;"Pėledžiukai ";6831569546;Ne;7;0;2;9
5927;Pabiručiai;"Pėledžiukai ";1683369842;Ne;5;0;0;5
5928;Pabiručiai;"Pėledžiukai ";7961879916;Ne;7;0;0;7
5929;Pabiručiai;"Pėledžiukai ";9050994322;Ne;20;0;0;20
5930;Pabiručiai;"Pėledžiukai ";1049154287;Ne;5;0;0;5
5931;Pabiručiai;"Pėledžiukai ";6697518151;Ne;3;2;0;5
5932;Pabiručiai;"Pėledžiukai ";2596301235;Ne;5;1;4;10
5933;Pabiručiai;"Pėledžiukai ";4333645528;Ne;0;4;0;4
5934;Pabiručiai;"Pėledžiukai ";6289025538;Ne;0;10;0;10
5935;Pabiručiai;"Pėledžiukai ";2343561322;Ne;0;2;0;2
5936;Pabiručiai;"Pėledžiukai ";3674583662;Ne;6;0;1;7
5937;Pabiručiai;"Pėledžiukai ";8268101318;Ne;0;6;0;6
5938;Pabiručiai;"Pėledžiukai ";2147165934;Ne;11;3;0;14
5939;Pabiručiai;"Pėledžiukai ";7385149524;Ne;0;10;0;10
5940;Pabiručiai;"Pėledžiukai ";3929956703;Ne;0;0;1;1
5941;Pabiručiai;"Pėledžiukai ";7203091216;Ne;10;0;0;10
5942;Pabiručiai;"Pėledžiukai ";3224195892;Ne;2;1;1;4
5943;Pabiručiai;"Kodelčiūkai ";5950654594;Ne;0;4;0;4
5944;Pabiručiai;"Kodelčiūkai ";8775727677;Ne;0;6;0;6
5945;Pabiručiai;"Kodelčiūkai ";4317656984;Ne;7;0;1;8
5946;Pabiručiai;"Kodelčiūkai ";4785878572;Ne;0;1;0;1
5947;Pabiručiai;"Kodelčiūkai ";2295503584;Ne;0;9;0;9
5948;Pabiručiai;"Kodelčiūkai ";4595458527;Ne;0;4;2;6
5949;Pabiručiai;"Kodelčiūkai ";8716879106;Ne;0;0;1;1
5950;Pabiručiai;"Kodelčiūkai ";9067653417;Ne;11;0;2;13
5951;Pabiručiai;"Kodelčiūkai ";3433419710;Ne;7;0;3;10
5952;Pabiručiai;"Kodelčiūkai ";6386335808;Ne;0;0;9;9
5953;Pabiručiai;"Kodelčiūkai ";5010271037;Ne;0;2;0;2
5954;Pabiručiai;"Kodelčiūkai ";9538339883;Ne;0;2;7;9
5955;Pabiručiai;"Kodelčiūkai ";7289131864;Ne;0;1;0;1
5956;Pabiručiai;"Kodelčiūkai ";6209553290;Ne;22;0;0;22
5957;Pabiručiai;"Kodelčiūkai ";3748657353;Ne;9;0;4;13
5958;Pabiručiai;"Kodelčiūkai ";3497466298;Ne;5;6;0;11
5959;Pabiručiai;"Kodelčiūkai ";8179285338;Ne;5;4;0;9
5960;Pabiručiai;"Kodelčiūkai ";1234230729;Ne;7;0;2;9
5961;Pabiručiai;"Peliukų ";3702521810;Ne;8;0;1;9
5962;Pabiručiai;"Peliukų ";4894380231;Ne;15;0;0;15
5963;Pabiručiai;"Peliukų ";1947729077;Ne;12;9;0;21
5964;Pabiručiai;"Peliukų ";6678717039;Taip;6;1;0;7
5965;Pabiručiai;"Peliukų ";7182565608;Ne;0;5;0;5
5966;Pabiručiai;"Peliukų ";1776325000;Ne;12;0;1;13
5967;Pabiručiai;"Peliukų ";1099080685;Ne;10;7;0;17
5968;Pabiručiai;"Peliukų ";5990497129;Ne;0;2;0;2
5969;Pabiručiai;"Peliukų ";9890225918;Ne;5;10;0;15
5970;Pabiručiai;"Peliukų ";7644854044;Ne;0;1;0;1
5971;Pabiručiai;"Peliukų ";3826505104;Taip;5;0;0;5
5972;Pabiručiai;"Peliukų ";1971996148;Ne;1;0;0;1
5973;Pabiručiai;"Peliukų ";4852287574;Ne;15;0;0;15
5974;Pabiručiai;"Peliukų ";1206012259;Ne;0;10;0;10
5975;Pabiručiai;"Peliukų ";7980170279;Ne;5;2;0;7
5976;Pabiručiai;"Peliukų ";9806520732;Taip;6;0;0;6
5977;Pabiručiai;"Peliukų ";5923385276;Ne;4;1;0;5
5978;Pabiručiai;"Viščiukų ";8571325340;Ne;0;1;0;1
5979;Pabiručiai;"Viščiukų ";8254676845;Ne;0;22;0;22
5980;Pabiručiai;"Viščiukų ";6742744014;Ne;0;4;0;4
5981;Pabiručiai;"Viščiukų ";7339565412;Ne;2;1;0;3
5982;Pabiručiai;"Viščiukų ";4880717493;Ne;15;0;3;18
5983;Pabiručiai;"Viščiukų ";1138743823;Ne;0;1;0;1
5984;Pabiručiai;"Viščiukų ";3011601512;Taip;6;0;0;6
5985;Pabiručiai;"Viščiukų ";7798837336;Ne;5;1;0;6
5986;Pabiručiai;"Viščiukų ";5737214746;Ne;5;0;1;6
5987;Pabiručiai;"Viščiukų ";6508093808;Ne;0;5;0;5
5988;Pabiručiai;"Viščiukų ";8649685325;Ne;5;0;0;5
5989;Pabiručiai;"Viščiukų ";4929129093;Ne;0;9;0;9
5990;Pabiručiai;"Drugelių ";6014791534;Ne;12;0;0;12
5991;Pabiručiai;"Drugelių ";9890868992;Ne;8;0;0;8
5992;Pabiručiai;"Drugelių ";6601800828;Ne;14;0;1;15
5993;Pabiručiai;"Drugelių ";3491721002;Ne;8;0;2;10
5994;Pabiručiai;"Drugelių ";2556330147;Ne;6;8;0;14
5995;Pabiručiai;"Drugelių ";3004152898;Ne;7;2;0;9
5996;Pabiručiai;"Drugelių ";5050966784;Ne;17;0;0;17
5997;Pabiručiai;"Drugelių ";5019580409;Taip;4;1;0;5
5998;Pabiručiai;"Drugelių ";3531292373;Ne;0;6;0;6
5999;Pabiručiai;"Drugelių ";7561916887;Ne;0;17;0;17
6000;Pabiručiai;"Drugelių ";8668524776;Ne;0;3;0;3
6001;Pabiručiai;"Drugelių ";9878655387;Ne;4;0;0;4
6002;Pabiručiai;"Drugelių ";4876140467;Ne;7;5;6;18
6003;Pabiručiai;"Drugelių ";4012537474;Ne;4;0;1;5
6004;Pabiručiai;"Drugelių ";4701982784;Ne;0;0;1;1
6005;Pabiručiai;"Drugelių ";5147367745;Ne;4;0;0;4
6006;Pabiručiai;ŽIRNIUKŲ;5704073222;Ne;14;3;0;17
6007;Pabiručiai;ŽIRNIUKŲ;2924005478;Ne;0;5;0;5
6008;Pabiručiai;ŽIRNIUKŲ;1247522345;Ne;2;5;6;13
6009;Pabiručiai;ŽIRNIUKŲ;1852744763;Ne;10;0;1;11
6010;Pabiručiai;ŽIRNIUKŲ;4851108740;Ne;6;0;0;6
6011;Pabiručiai;ŽIRNIUKŲ;6513943228;Ne;8;0;1;9
6012;Pabiručiai;ŽIRNIUKŲ;2794484633;Ne;15;1;0;16
6013;Pabiručiai;ŽIRNIUKŲ;8870657682;Ne;6;3;0;9
6014;Pabiručiai;ŽIRNIUKŲ;4096412988;Ne;6;1;0;7
6015;Pabiručiai;ŽIRNIUKŲ;8092886420;Ne;0;10;0;10
6016;Pabiručiai;ŽIRNIUKŲ;7873575929;Ne;6;6;0;12
6017;Pabiručiai;ŽIRNIUKŲ;5862643827;Ne;10;2;2;14
6018;Pabiručiai;ŽIRNIUKŲ;5184688482;Ne;11;0;1;12
6019;Pabiručiai;ŽIRNIUKŲ;4755427277;Ne;5;1;0;6
6020;Pabiručiai;ŽIRNIUKŲ;9507212682;Ne;0;6;0;6
6021;Pabiručiai;ŽIRNIUKŲ;9651695086;Ne;0;0;1;1
6022;Pabiručiai;ŽIRNIUKŲ;5899880680;Ne;19;0;1;20
6023;Pagrandukas;Saulytės;6915087488;Ne;3;4;0;7
6024;Pagrandukas;Saulytės;7605508460;Ne;0;10;2;12
6025;Pagrandukas;Saulytės;6349387692;Ne;7;1;3;11
6026;Pagrandukas;Saulytės;8186092469;Ne;0;13;0;13
6027;Pagrandukas;Saulytės;2934300533;Ne;0;23;0;23
6028;Pagrandukas;Saulytės;1548697124;Ne;0;7;0;7
6029;Pagrandukas;Saulytės;6711830251;Ne;8;15;0;23
6030;Pagrandukas;Saulytės;7146697128;Ne;10;4;0;14
6031;Pagrandukas;Saulytės;3157676207;Ne;0;9;0;9
6032;Pagrandukas;Saulytės;7511097160;Ne;0;21;0;21
6033;Pagrandukas;Saulytės;3783160018;Ne;0;12;0;12
6034;Pagrandukas;Saulytės;7454863899;Ne;0;2;0;2
6035;Pagrandukas;Saulytės;5560372136;Ne;0;8;0;8
6036;Pagrandukas;Saulytės;1766912463;Ne;0;12;0;12
6037;Pagrandukas;Saulytės;9849054467;Ne;12;0;0;12
6038;Pagrandukas;Saulytės;8024910647;Ne;0;7;0;7
6039;Pagrandukas;Saulytės;8481502330;Ne;0;8;0;8
6040;Pagrandukas;Saulytės;7160305478;Ne;5;4;0;9
6041;Pagrandukas;Saulytės;3008997793;Ne;0;4;0;4
6042;Pagrandukas;Saulytės;6388805960;Ne;6;10;5;21
6043;Pagrandukas;Saulytės;3050207849;Ne;5;3;0;8
6044;Pagrandukas;Saulytės;8836178193;Ne;0;9;0;9
6045;Pagrandukas;Saulytės;7157549179;Ne;8;0;0;8
6046;Pagrandukas;Zuikučiai;7435609306;Ne;4;0;2;6
6047;Pagrandukas;Zuikučiai;2439891231;Ne;0;4;0;4
6048;Pagrandukas;Zuikučiai;6710887776;Ne;0;4;0;4
6049;Pagrandukas;Zuikučiai;7665811353;Ne;4;0;3;7
6050;Pagrandukas;Zuikučiai;2212787835;Ne;4;7;0;11
6051;Pagrandukas;Zuikučiai;6449029299;Ne;0;0;1;1
6052;Pagrandukas;Zuikučiai;1405820070;Ne;6;0;0;6
6053;Pagrandukas;Zuikučiai;1054107640;Ne;0;3;0;3
6054;Pagrandukas;Zuikučiai;2822538227;Ne;0;0;1;1
6055;Pagrandukas;Zuikučiai;1587839122;Ne;10;0;2;12
6056;Pagrandukas;Zuikučiai;2101505576;Ne;0;0;11;11
6057;Pagrandukas;Zuikučiai;6765346578;Ne;0;0;1;1
6058;Pagrandukas;Zuikučiai;5030928303;Ne;5;0;1;6
6059;Pagrandukas;Zuikučiai;9139212151;Ne;0;0;5;5
6060;Pagrandukas;Zuikučiai;8643993939;Ne;3;5;1;9
6061;Pagrandukas;Zuikučiai;5021106231;Ne;0;0;1;1
6062;Pagrandukas;Zuikučiai;3494047045;Ne;0;1;0;1
6063;Pagrandukas;Boružėlių;5511396314;Ne;7;8;0;15
6064;Pagrandukas;Boružėlių;8286183393;Ne;10;0;0;10
6065;Pagrandukas;Bitutės;6044667668;Ne;0;7;0;7
6066;Pagrandukas;Bitutės;1938604743;Ne;0;6;0;6
6067;Pagrandukas;Bitutės;8625382465;Ne;6;0;0;6
6068;Pagrandukas;Bitutės;9188382746;Ne;0;3;2;5
6069;Pagrandukas;Bitutės;4603185679;Ne;5;0;0;5
6070;Pagrandukas;Bitutės;2923517578;Ne;0;18;0;18
6071;Pagrandukas;Bitutės;4322675634;Ne;0;5;0;5
6072;Pagrandukas;Bitutės;3875062228;Ne;0;13;0;13
6073;Pagrandukas;Bitutės;1583104760;Ne;0;7;0;7
6074;Pagrandukas;Bitutės;5649084353;Ne;0;5;1;6
6075;Pagrandukas;Bitutės;8719834064;Ne;7;1;1;9
6076;Pagrandukas;Bitutės;5821945401;Ne;0;5;5;10
6077;Pagrandukas;Bitutės;7675694987;Ne;9;0;0;9
6078;Pagrandukas;Bitutės;3709131197;Ne;0;3;0;3
6079;Pagrandukas;Bitutės;2098182423;Ne;0;10;0;10
6080;Pagrandukas;Bitutės;8280877177;Ne;0;11;6;17
6081;Pagrandukas;Bitutės;2764732768;Ne;0;2;2;4
6082;Pagrandukas;Pelėdžiukai;1714449109;Ne;5;2;0;7
6083;Pagrandukas;Pelėdžiukai;3160109801;Ne;5;0;0;5
6084;Pagrandukas;Pelėdžiukai;7764147734;Ne;5;0;0;5
6085;Pagrandukas;Pelėdžiukai;8633116370;Ne;5;0;0;5
6086;Pagrandukas;Pelėdžiukai;2877401332;Ne;7;2;0;9
6087;Pagrandukas;Pelėdžiukai;8167118045;Ne;19;0;0;19
6088;Pagrandukas;Pelėdžiukai;3390664086;Ne;0;2;0;2
6089;Pagrandukas;Pelėdžiukai;1733723373;Ne;5;2;2;9
6090;Pagrandukas;Pelėdžiukai;6011346969;Ne;15;2;0;17
6091;Pagrandukas;Pelėdžiukai;1077792535;Ne;14;0;0;14
6092;Pagrandukas;Pelėdžiukai;9583471280;Ne;12;2;0;14
6093;Pagrandukas;Pelėdžiukai;2481532396;Ne;0;2;1;3
6094;Pagrandukas;Pelėdžiukai;4398016119;Ne;5;1;0;6
6095;Pagrandukas;Pelėdžiukai;2640777376;Ne;10;0;0;10
6096;Pagrandukas;Pelėdžiukai;4910151924;Ne;6;0;0;6
6097;Pagrandukas;Pelėdžiukai;9431513632;Ne;7;0;0;7
6098;Pagrandukas;Pelėdžiukai;1977974235;Ne;5;2;6;13
6099;Pagrandukas;Pelėdžiukai;7238694532;Ne;5;1;0;6
6100;Pagrandukas;ŠYPSENĖLIŲ;4627387596;Ne;0;0;2;2
6101;Pagrandukas;ŠYPSENĖLIŲ;7173561328;Ne;12;10;0;22
6102;Pagrandukas;ŠYPSENĖLIŲ;1101989969;Ne;0;2;0;2
6103;Pagrandukas;ŠYPSENĖLIŲ;5701479990;Ne;0;8;0;8
6104;Pagrandukas;ŠYPSENĖLIŲ;9981610798;Ne;0;6;0;6
6105;Pagrandukas;ŠYPSENĖLIŲ;8027783692;Ne;27;0;0;27
6106;Pagrandukas;ŠYPSENĖLIŲ;6248684084;Ne;10;1;3;14
6107;Pagrandukas;ŠYPSENĖLIŲ;2904880156;Ne;3;6;0;9
6108;Pagrandukas;ŠYPSENĖLIŲ;5173633710;Ne;3;0;0;3
6109;Pagrandukas;ŠYPSENĖLIŲ;6057078416;Ne;0;0;7;7
6110;Pagrandukas;ŠYPSENĖLIŲ;1475375452;Ne;2;0;4;6
6111;Pagrandukas;ŠYPSENĖLIŲ;8475724797;Ne;2;8;0;10
6112;Pagrandukas;ŠYPSENĖLIŲ;5272914210;Ne;0;10;0;10
6113;Pagrandukas;ŠYPSENĖLIŲ;6517393406;Ne;13;0;1;14
6114;Pagrandukas;ŠYPSENĖLIŲ;4094086585;Ne;0;1;3;4
6115;Pagrandukas;ŠYPSENĖLIŲ;6306635507;Ne;2;2;0;4
6116;Pagrandukas;ŠYPSENĖLIŲ;5060059491;Ne;2;0;0;2
6117;Pakalnutė;Pagrandukai;7475119623;Ne;0;5;0;5
6118;Pakalnutė;Pagrandukai;5275833872;Ne;12;3;0;15
6119;Pakalnutė;Pagrandukai;5943686565;Ne;7;0;0;7
6120;Pakalnutė;Pagrandukai;2296079246;Ne;10;0;0;10
6121;Pakalnutė;Pagrandukai;7962849592;Ne;0;1;0;1
6122;Pakalnutė;Pagrandukai;5180015882;Ne;7;0;0;7
6123;Pakalnutė;Pagrandukai;3794283102;Ne;0;5;0;5
6124;Pakalnutė;Pagrandukai;3070652992;Ne;8;2;0;10
6125;Pakalnutė;Pagrandukai;7477188659;Ne;2;2;0;4
6126;Pakalnutė;Pagrandukai;4390444128;Ne;0;0;1;1
6127;Pakalnutė;Pagrandukai;2642359967;Ne;0;1;0;1
6128;Pakalnutė;Pagrandukai;7417131378;Ne;9;0;0;9
6129;Pakalnutė;Pagrandukai;6396963609;Ne;18;0;0;18
6130;Pakalnutė;Pagrandukai;1883500676;Ne;10;0;0;10
6131;Pakalnutė;"Pelėdžiukų ";8553182620;Ne;0;4;0;4
6132;Pakalnutė;"Pelėdžiukų ";3840499737;Ne;14;0;1;15
6133;Pakalnutė;"Pelėdžiukų ";4523766424;Ne;3;1;7;11
6134;Pakalnutė;"Pelėdžiukų ";7151877991;Ne;0;0;4;4
6135;Pakalnutė;"Pelėdžiukų ";2992768162;Ne;1;0;0;1
6136;Pakalnutė;"Pelėdžiukų ";9505524183;Ne;27;0;0;27
6137;Pakalnutė;"Pelėdžiukų ";8823232039;Ne;0;3;0;3
6138;Pakalnutė;"Pelėdžiukų ";4220368864;Ne;0;5;1;6
6139;Pakalnutė;"Pelėdžiukų ";1330092247;Ne;12;9;1;22
6140;Pakalnutė;"Pelėdžiukų ";3267680599;Ne;0;5;0;5
6141;Pakalnutė;"Pelėdžiukų ";4452372238;Ne;2;0;0;2
6142;Pakalnutė;"Pelėdžiukų ";4353883274;Ne;7;1;0;8
6143;Pakalnutė;Ežiukai;4052166895;Ne;3;0;0;3
6144;Pakalnutė;Ežiukai;1070172991;Ne;0;2;3;5
6145;Pakalnutė;Ežiukai;9323200833;Ne;5;1;0;6
6146;Pakalnutė;Ežiukai;9256219647;Ne;0;0;1;1
6147;Pakalnutė;Ežiukai;4317305712;Ne;6;0;0;6
6148;Pakalnutė;Ežiukai;6029905101;Ne;4;0;0;4
6149;Pakalnutė;Ežiukai;7734657452;Ne;0;1;0;1
6150;Pakalnutė;Ežiukai;8081932074;Ne;9;0;0;9
6151;Pakalnutė;Ežiukai;9706455707;Ne;10;0;0;10
6152;Pakalnutė;Ežiukai;7881545979;Ne;0;7;0;7
6153;Pakalnutė;Ežiukai;8080989574;Ne;3;9;3;15
6154;Pakalnutė;Ežiukai;8236718590;Ne;7;0;0;7
6155;Pakalnutė;Ežiukai;3064391379;Ne;5;0;4;9
6156;Pakalnutė;Ežiukai;2015778005;Ne;4;0;2;6
6157;Pakalnutė;Skruzdėliukų;4033813807;Ne;7;0;0;7
6158;Pakalnutė;Skruzdėliukų;5409476517;Ne;4;13;0;17
6159;Pakalnutė;Skruzdėliukų;1195872320;Ne;0;2;0;2
6160;Pakalnutė;Skruzdėliukų;3211633472;Ne;5;0;0;5
6161;Pakalnutė;Skruzdėliukų;4423348418;Ne;0;2;0;2
6162;Pakalnutė;Skruzdėliukų;5619262190;Ne;5;0;0;5
6163;Pakalnutė;Skruzdėliukų;3215438452;Ne;0;12;0;12
6164;Pakalnutė;Skruzdėliukų;9336711927;Ne;3;10;0;13
6165;Pakalnutė;Skruzdėliukų;3288449407;Ne;4;0;0;4
6166;Pakalnutė;Skruzdėliukų;1540045675;Ne;0;1;0;1
6167;Pakalnutė;Bitučių;2765220889;Ne;18;2;0;20
6168;Pakalnutė;Bitučių;9445909071;Ne;0;6;0;6
6169;Pakalnutė;Bitučių;5532458706;Ne;0;9;0;9
6170;Pakalnutė;Bitučių;5941955322;Ne;0;0;1;1
6171;Pakalnutė;Bitučių;3306334576;Ne;3;0;0;3
6172;Pakalnutė;Bitučių;2095540372;Ne;0;3;0;3
6173;Pakalnutė;Bitučių;5342592825;Ne;0;3;0;3
6174;Pakalnutė;Bitučių;2932205226;Ne;2;0;0;2
6175;Pakalnutė;Bitučių;5464143742;Ne;0;0;3;3
6176;Pakalnutė;Bitučių;6351193702;Ne;0;0;1;1
6177;Pakalnutė;Bitučių;3965390135;Ne;0;0;1;1
6178;Pakalnutė;Bitučių;5355198213;Ne;0;7;1;8
6179;Pakalnutė;Bitučių;4533467194;Ne;0;0;2;2
6180;Pakalnutė;Boružiukų;6798939288;Ne;0;0;1;1
6181;Pakalnutė;Boružiukų;7357431226;Ne;2;1;1;4
6182;Pakalnutė;Boružiukų;4934095931;Ne;0;0;2;2
6183;Pakalnutė;Boružiukų;5039000154;Ne;0;2;0;2
6184;Pakalnutė;Boružiukų;2835611316;Ne;0;0;3;3
6185;Pakalnutė;Boružiukų;4950195858;Ne;0;0;1;1
6186;Pakalnutė;Boružiukų;4927086034;Ne;7;0;1;8
6187;Pakalnutė;Boružiukų;6557165567;Ne;8;0;3;11
6188;Pakalnutė;Boružiukų;3677709759;Ne;5;10;2;17
6189;Pakalnutė;Boružiukų;2597900983;Ne;4;0;0;4
6190;Pakalnutė;Boružiukų;1340022702;Ne;12;3;0;15
6191;Pakalnutė;Boružiukų;6228196996;Ne;19;0;0;19
6192;Pakalnutė;Meškiukų;2666441234;Ne;7;0;0;7
6193;Pakalnutė;Meškiukų;2101821362;Ne;0;10;0;10
6194;Pakalnutė;Meškiukų;4313652059;Ne;0;3;0;3
6195;Pakalnutė;Meškiukų;7084798190;Ne;0;5;0;5
6196;Pakalnutė;Meškiukų;3693337607;Ne;17;0;0;17
6197;Pakalnutė;Meškiukų;1369906621;Ne;0;0;1;1
6198;Pakalnutė;Nykštukai;9918277117;Ne;5;0;2;7
6199;Pakalnutė;Nykštukai;6633585181;Ne;13;0;3;16
6200;Pakalnutė;Nykštukai;3870628774;Ne;9;0;0;9
6201;Pakalnutė;Nykštukai;1864990681;Ne;0;0;4;4
6202;Pakalnutė;Nykštukai;1236187157;Ne;3;0;3;6
6203;Pakalnutė;Nykštukai;2063766287;Ne;12;5;0;17
6204;Pakalnutė;Nykštukai;6528913736;Ne;0;3;0;3
6205;Pakalnutė;Nykštukai;8217779439;Ne;0;2;0;2
6206;Pakalnutė;Nykštukai;6206296685;Ne;5;3;0;8
6207;Pakalnutė;Nykštukai;8855237588;Taip;4;5;0;9
6208;Pakalnutė;Nykštukai;1561411767;Ne;9;0;0;9
6209;Pakalnutė;Nykštukai;9443826616;Ne;7;0;0;7
6210;Pakalnutė;Nykštukai;7024440142;Ne;10;0;0;10
6211;Pakalnutė;Nykštukai;2578170222;Ne;0;11;0;11
6212;Pakalnutė;Nykštukai;3967515235;Ne;3;2;0;5
6213;Pakalnutė;Nykštukai;5377715404;Ne;10;1;0;11
6214;Pakalnutė;Nykštukai;3938091521;Ne;8;7;0;15
6215;Pakalnutė;Nykštukai;4971065032;Ne;4;0;0;4
6216;Pakalnutė;"Zuikučių ";1198230323;Ne;0;0;1;1
6217;Pakalnutė;"Zuikučių ";3609982613;Ne;0;1;0;1
6218;Pakalnutė;"Zuikučių ";5958653847;Ne;3;10;0;13
6219;Pakalnutė;"Zuikučių ";1147843795;Ne;7;0;0;7
6220;Pakalnutė;"Zuikučių ";3555822605;Ne;0;1;0;1
6221;Pakalnutė;"Zuikučių ";6377564215;Ne;9;0;1;10
6222;Pakalnutė;"Zuikučių ";8813262660;Ne;0;2;0;2
6223;Pakalnutė;"Zuikučių ";81578522887;Ne;0;1;0;1
6224;Pakalnutė;"Zuikučių ";2002555659;Ne;0;0;7;7
6225;Pakalnutė;"Zuikučių ";4681267749;Ne;0;6;0;6
6226;Pakalnutė;"Zuikučių ";5912904296;Ne;0;2;0;2
6227;Pakalnutė;"Drugelių ";5441477374;Ne;0;7;0;7
6228;Pakalnutė;"Drugelių ";7369661890;Ne;10;0;0;10
6229;Pakalnutė;"Drugelių ";5135811550;Ne;0;5;1;6
6230;Pakalnutė;"Drugelių ";7766653114;Ne;8;0;2;10
6231;Pakalnutė;"Drugelių ";7709684372;Ne;0;22;0;22
6232;Pakalnutė;"Drugelių ";9620000116;Ne;8;5;0;13
6233;Pakalnutė;"Drugelių ";5502444590;Ne;0;9;1;10
6234;Pakalnutė;"Drugelių ";3730712580;Ne;4;0;6;10
6235;Pakalnutė;"Drugelių ";1824418095;Ne;0;1;0;1
6236;Pakalnutė;"Drugelių ";4220406978;Ne;0;0;1;1
6237;Pakalnutė;"Drugelių ";5069038636;Ne;0;12;5;17
6238;Pakalnutė;"Drugelių ";7047587606;Ne;0;14;0;14
6239;Pakalnutė;"Drugelių ";2653667596;Ne;3;0;2;5
6240;Pakalnutė;"Drugelių ";2197533802;Ne;5;1;2;8
6241;Pakalnutė;"Drugelių ";1791607977;Ne;0;1;0;1
6242;Pakalnutė;"Drugelių ";4127500142;Ne;0;5;2;7
6243;Pakalnutė;"Drugelių ";9295709508;Taip;22;0;0;22
6244;Pakalnutė;"Drugelių ";6924023022;Ne;12;0;1;13
6245;Pakalnutė;Žvirbliukų;7421275778;Ne;7;0;0;7
6246;Pakalnutė;Žvirbliukų;8329725085;Ne;0;2;2;4
6247;Pakalnutė;Žvirbliukų;3190067149;Taip;11;5;0;16
6248;Pakalnutė;Žvirbliukų;7548659665;Ne;0;0;8;8
6249;Pakalnutė;Žvirbliukų;8010667913;Ne;6;0;5;11
6250;Pakalnutė;Žvirbliukų;1662773049;Ne;13;1;0;14
6251;Pakalnutė;Žvirbliukų;5531209454;Ne;21;0;0;21
6252;Pakalnutė;Žvirbliukų;3342793992;Ne;0;0;4;4
6253;Pakalnutė;Žvirbliukų;7258417347;Ne;22;0;0;22
6254;Pakalnutė;Žvirbliukų;4961361687;Ne;2;2;1;5
6255;Pakalnutė;Žvirbliukų;5878352514;Ne;0;0;3;3
6256;Pakalnutė;Žvirbliukų;5685361033;Ne;0;0;3;3
6257;Pakalnutė;Žvirbliukų;7782295402;Ne;0;0;1;1
6258;Pakalnutė;Žvirbliukų;7547661599;Taip;7;0;0;7
6259;Pakalnutė;Žvirbliukų;4469974699;Ne;6;0;0;6
6260;Pakalnutė;Žvirbliukų;6159955311;Ne;0;1;0;1
6261;Pakalnutė;Žvirbliukų;3903972025;Ne;0;2;1;3
6262;Pakalnutė;Žvirbliukų;8567965305;Ne;0;0;4;4
6263;Pakalnutė;Žvirbliukų;3458404368;Ne;0;2;0;2
6264;Panerių;Rūtelė;2195332401;Ne;0;0;7;7
6265;Panerių;Rūtelė;2643410976;Ne;0;0;6;6
6266;Panerių;Rūtelė;8771264170;Ne;0;0;6;6
6267;Panerių;Rūtelė;7805429137;Ne;0;0;1;1
6268;Panerių;Rūtelė;9268618414;Ne;0;0;4;4
6269;Panerių;Rūtelė;1419817211;Ne;0;1;0;1
6270;Panerių;Rūtelė;2333355325;Ne;0;0;1;1
6271;Panerių;Rūtelė;2235123048;Ne;0;0;12;12
6272;Panerių;Rūtelė;3190117304;Taip;0;11;0;11
6273;Panerių;Rūtelė;8693113275;Taip;0;0;8;8
6274;Panerių;Rūtelė;9630302749;Ne;1;0;1;2
6275;Panerių;Rūtelė;3057714143;Ne;0;0;5;5
6276;Panerių;Gėlytės;1339256258;Ne;0;0;1;1
6277;Panerių;Gėlytės;9729731866;Ne;0;3;0;3
6278;Panerių;Gėlytės;6583134855;Ne;5;0;8;13
6279;Panerių;Gėlytės;3948776877;Ne;0;0;2;2
6280;Panerių;Gėlytės;2751334281;Ne;4;7;0;11
6281;Panerių;Gėlytės;9432171719;Ne;5;0;0;5
6282;Panerių;Gėlytės;1717129076;Ne;22;0;0;22
6283;Panerių;Gėlytės;2035822976;Ne;0;0;4;4
6284;Panerių;Gėlytės;8447920373;Ne;14;0;0;14
6285;Panerių;Gėlytės;4161189870;Ne;0;10;7;17
6286;Panerių;Gėlytės;9004310393;Ne;19;0;0;19
6287;Panerių;Gėlytės;3112608087;Ne;5;0;0;5
6288;Panerių;Gėlytės;5100874548;Ne;3;0;1;4
6289;Panerių;Gėlytės;9955613696;Ne;0;3;0;3
6290;Panerių;Gėlytės;6304387432;Ne;0;0;1;1
6291;Panerių;Gėlytės;7166964095;Ne;0;0;3;3
6292;Panerių;Gėlytės;8109366029;Ne;0;0;6;6
6293;Panerių;Boružė;7657860513;Ne;0;9;5;14
6294;Panerių;Boružė;9014387764;Ne;0;3;0;3
6295;Panerių;Boružė;4369979548;Taip;0;6;0;6
6296;Panerių;Boružė;3273655606;Ne;12;0;0;12
6297;Panerių;Boružė;8067240250;Ne;4;0;0;4
6298;Panerių;Boružė;3526636673;Ne;4;0;0;4
6299;Panerių;Boružė;8407995549;Ne;6;1;0;7
6300;Panerių;Boružė;3502494751;Ne;0;0;10;10
6301;Panerių;Boružė;6574858142;Ne;0;0;1;1
6302;Panerių;Boružė;6653710644;Ne;0;5;0;5
6303;Panerių;Boružė;9288515724;Ne;0;0;12;12
6304;Panerių;Boružė;7976634590;Ne;0;0;1;1
6305;Panerių;Boružė;4716214117;Ne;0;6;0;6
6306;Papartis;ZUIKUČIAI;8874222586;Ne;0;0;3;3
6307;Papartis;ZUIKUČIAI;2446379598;Ne;0;0;2;2
6308;Papartis;ZUIKUČIAI;3054883426;Ne;5;0;0;5
6309;Papartis;ZUIKUČIAI;1191546794;Ne;0;7;4;11
6310;Papartis;ZUIKUČIAI;7619963429;Ne;2;2;0;4
6311;Papartis;ZUIKUČIAI;8958880558;Ne;5;1;4;10
6312;Papartis;ZUIKUČIAI;4380030213;Ne;0;0;1;1
6313;Papartis;ZUIKUČIAI;4906248064;Ne;2;5;3;10
6314;Papartis;ZUIKUČIAI;8447326505;Ne;0;1;0;1
6315;Papartis;ZUIKUČIAI;1919362027;Ne;5;0;0;5
6316;Papartis;ZUIKUČIAI;4640068595;Ne;0;7;0;7
6317;Papartis;ZUIKUČIAI;5361925390;Ne;0;8;2;10
6318;Papartis;ZUIKUČIAI;5796928317;Ne;12;0;0;12
6319;Papartis;ZUIKUČIAI;9375751990;Ne;0;14;1;15
6320;Papartis;ZUIKUČIAI;5786648402;Ne;5;0;0;5
6321;Papartis;ZUIKUČIAI;5776038830;Ne;5;0;1;6
6322;Papartis;ZUIKUČIAI;9358310527;Ne;12;6;0;18
6323;Papartis;ZUIKUČIAI;5363926529;Ne;0;9;0;9
6324;Papartis;ZUIKUČIAI;1722192450;Ne;22;0;0;22
6325;Papartis;DRUGELIAI;8005876431;Ne;12;0;0;12
6326;Papartis;DRUGELIAI;7384518191;Ne;0;1;1;2
6327;Papartis;DRUGELIAI;6664178454;Ne;0;2;2;4
6328;Papartis;DRUGELIAI;2432516496;Ne;0;2;1;3
6329;Papartis;DRUGELIAI;7742769931;Ne;6;1;0;7
6330;Papartis;DRUGELIAI;8305560946;Ne;5;0;1;6
6331;Papartis;DRUGELIAI;4778327620;Ne;0;3;0;3
6332;Papartis;DRUGELIAI;7331682622;Ne;12;0;0;12
6333;Papartis;DRUGELIAI;2824078830;Ne;0;7;0;7
6334;Papartis;DRUGELIAI;8782882575;Ne;0;4;0;4
6335;Papartis;DRUGELIAI;1405767603;Ne;0;2;2;4
6336;Papartis;DRUGELIAI;6435625940;Ne;5;0;0;5
6337;Papartis;DRUGELIAI;7187797639;Ne;6;0;0;6
6338;Papartis;DRUGELIAI;3411472740;Ne;0;2;7;9
6339;Papartis;DRUGELIAI;3209105694;Ne;2;0;2;4
6340;Papartis;DRUGELIAI;8277830926;Ne;0;7;0;7
6341;Papartis;DRUGELIAI;1759982543;Ne;2;13;0;15
6342;Papartis;DRUGELIAI;4689046394;Ne;0;2;0;2
6343;Papartis;DRUGELIAI;5430993785;Ne;0;1;0;1
6344;Papartis;ŽVIRBLIUKAI;7590170146;Ne;0;0;2;2
6345;Papartis;ŽVIRBLIUKAI;3408756311;Ne;10;1;8;19
6346;Papartis;ŽVIRBLIUKAI;4935694347;Ne;0;1;0;1
6347;Papartis;ŽVIRBLIUKAI;7067369268;Ne;0;5;0;5
6348;Papartis;ŽVIRBLIUKAI;4508053349;Ne;0;3;2;5
6349;Papartis;ŽVIRBLIUKAI;2778629398;Ne;8;1;2;11
6350;Papartis;ŽVIRBLIUKAI;2535412635;Ne;0;5;1;6
6351;Papartis;ŽVIRBLIUKAI;7102350653;Ne;7;6;1;14
6352;Papartis;ŽVIRBLIUKAI;1205854439;Ne;0;6;2;8
6353;Papartis;ŽVIRBLIUKAI;1672028156;Ne;0;1;3;4
6354;Papartis;ŽVIRBLIUKAI;8148483438;Ne;0;6;3;9
6355;Papartis;ŽVIRBLIUKAI;3295731801;Ne;0;5;11;16
6356;Papartis;ŽVIRBLIUKAI;6797687614;Ne;0;2;0;2
6357;Papartis;ŽVIRBLIUKAI;3475745012;Ne;0;1;5;6
6358;Papartis;ŽVIRBLIUKAI;4634683589;Ne;0;6;5;11
6359;Papartis;ŽVIRBLIUKAI;3267416367;Ne;0;5;0;5
6360;Papartis;ŽVIRBLIUKAI;3243869451;Ne;0;5;2;7
6361;Papartis;ŽVIRBLIUKAI;5265293240;Ne;0;3;0;3
6362;Papartis;ŽVIRBLIUKAI;9134335737;Ne;0;3;0;3
6363;Papartis;ŽVIRBLIUKAI;7387281720;Ne;0;8;0;8
6364;Papartis;PELĖDŽIUKAI;7606939822;Ne;0;0;2;2
6365;Papartis;PELĖDŽIUKAI;2447926422;Ne;0;1;0;1
6366;Papartis;PELĖDŽIUKAI;1260151691;Ne;0;1;1;2
6367;Papartis;PELĖDŽIUKAI;4346817695;Ne;0;0;1;1
6368;Papartis;PELĖDŽIUKAI;1527263538;Ne;0;4;0;4
6369;Papartis;PELĖDŽIUKAI;1219140467;Ne;0;10;2;12
6370;Papartis;PELĖDŽIUKAI;5410369044;Ne;0;10;5;15
6371;Papartis;PELĖDŽIUKAI;1065128993;Ne;0;21;0;21
6372;Papartis;PELĖDŽIUKAI;6126912448;Ne;0;12;1;13
6373;Papartis;PELĖDŽIUKAI;8952917454;Ne;0;0;1;1
6374;Papartis;PELĖDŽIUKAI;3182457453;Ne;14;4;0;18
6375;Papartis;PELĖDŽIUKAI;5675537250;Ne;6;1;0;7
6376;Papartis;PELĖDŽIUKAI;72182866449;Ne;0;3;2;5
6377;Papartis;PELĖDŽIUKAI;4992305227;Ne;0;0;1;1
6378;Papartis;PELĖDŽIUKAI;7703070601;Ne;0;1;2;3
6379;Papartis;PELĖDŽIUKAI;7902130389;Ne;0;7;0;7
6380;Papartis;PELĖDŽIUKAI;1974159967;Ne;0;1;2;3
6381;Papartis;PELĖDŽIUKAI;5732853976;Ne;0;7;10;17
6382;Papartis;PELĖDŽIUKAI;1554777403;Ne;7;1;2;10
6383;Papartis;PELĖDŽIUKAI;7768672610;Ne;0;1;2;3
6384;Papartis;PELĖDŽIUKAI;9939850340;Ne;0;3;0;3
6385;Papartis;SAULUTĖS;5538433120;Taip;0;8;1;9
6386;Papartis;SAULUTĖS;6585372451;Ne;0;11;3;14
6387;Papartis;SAULUTĖS;6734567714;Ne;0;4;0;4
6388;Papartis;SAULUTĖS;1231594320;Ne;0;3;0;3
6389;Papartis;SAULUTĖS;3539507686;Ne;2;7;1;10
6390;Papartis;SAULUTĖS;3595627659;Ne;2;1;0;3
6391;Papartis;SAULUTĖS;6977513472;Ne;0;9;0;9
6392;Papartis;SAULUTĖS;5070767260;Ne;0;6;0;6
6393;Papartis;SAULUTĖS;9380951144;Ne;0;11;1;12
6394;Papartis;SAULUTĖS;4016297254;Ne;0;10;6;16
6395;Papartis;SAULUTĖS;5323875279;Ne;5;10;0;15
6396;Papartis;SAULUTĖS;5465955537;Ne;6;10;3;19
6397;Papartis;SAULUTĖS;2812347963;Ne;7;11;1;19
6398;Papartis;SAULUTĖS;4597039190;Ne;0;13;0;13
6399;Papartis;SAULUTĖS;8420752169;Ne;0;12;2;14
6400;Papartis;SAULUTĖS;6346776139;Ne;8;8;1;17
6401;Papartis;SAULUTĖS;1352401881;Ne;0;23;0;23
6402;Papartis;SAULUTĖS;3685642787;Ne;6;10;0;16
6403;Papartis;SAULUTĖS;6136213985;Ne;0;2;0;2
6404;Papartis;SAULUTĖS;7107692314;Ne;0;2;0;2
6405;Papartis;GANDRIUKAI;4878190663;Ne;7;0;1;8
6406;Papartis;GANDRIUKAI;9900023788;Ne;2;0;0;2
6407;Papartis;GANDRIUKAI;6883101103;Ne;0;2;0;2
6408;Papartis;GANDRIUKAI;9968072478;Ne;0;0;2;2
6409;Papartis;GANDRIUKAI;9704930584;Ne;2;0;0;2
6410;Papartis;GANDRIUKAI;9072635586;Ne;0;2;0;2
6411;Papartis;GANDRIUKAI;4509843536;Ne;22;0;0;22
6412;Papartis;AITVARELIAI;8891856856;Ne;0;2;0;2
6413;Papartis;AITVARELIAI;6889782462;Taip;5;13;0;18
6414;Papartis;AITVARELIAI;5736456872;Ne;1;2;0;3
6415;Papartis;AITVARELIAI;3040269026;Ne;1;2;0;3
6416;Papartis;AITVARELIAI;8532558577;Ne;0;2;1;3
6417;Papartis;AITVARELIAI;5252947502;Ne;5;0;0;5
6418;Papartis;AITVARELIAI;7018190169;Ne;0;1;0;1
6419;Papartis;AITVARELIAI;7803854703;Ne;0;1;0;1
6420;Papartis;AITVARELIAI;4261270064;Ne;1;0;0;1
6421;Papartis;AITVARELIAI;6416605464;Ne;6;8;0;14
6422;Papartis;AITVARELIAI;1266338760;Ne;0;7;0;7
6423;Papartis;AITVARELIAI;7504793827;Ne;10;7;0;17
6424;Papartis;AITVARELIAI;7156767639;Ne;0;2;0;2
6425;Papartis;AITVARELIAI;5268226380;Ne;0;2;0;2
6426;Papartis;AITVARELIAI;2116140075;Ne;0;1;0;1
6427;Papartis;AITVARELIAI;4138926711;Taip;1;0;0;1
6428;Papartis;AITVARELIAI;8989172483;Ne;0;0;15;15
6429;Papartis;AITVARELIAI;9384475270;Ne;0;5;0;5
6430;Papartis;SMALSUČIAI;4969807705;Ne;1;8;0;9
6431;Papartis;SMALSUČIAI;5383936595;Ne;6;3;0;9
6432;Papartis;SMALSUČIAI;1698871014;Ne;0;6;0;6
6433;Papartis;SMALSUČIAI;6274608449;Ne;11;0;0;11
6434;Papartis;SMALSUČIAI;6664773988;Ne;10;0;0;10
6435;Papartis;SMALSUČIAI;8875490564;Ne;13;0;0;13
6436;Papartis;SMALSUČIAI;2921187615;Ne;10;2;0;12
6437;Papartis;SMALSUČIAI;5128663521;Ne;4;0;0;4
6438;Papartis;SMALSUČIAI;4500675679;Ne;15;1;0;16
6439;Papartis;SMALSUČIAI;1486770896;Ne;10;2;0;12
6440;Papartis;SMALSUČIAI;5132031416;Ne;18;0;0;18
6441;Papartis;SMALSUČIAI;3395306653;Ne;0;15;0;15
6442;Papartis;SMALSUČIAI;7149853209;Ne;4;0;0;4
6443;Papartis;SMALSUČIAI;1616537800;Ne;0;12;0;12
6444;Papartis;"ŽIRNIUKAI ";8897061283;Ne;9;7;0;16
6445;Papartis;"ŽIRNIUKAI ";3310893254;Ne;6;3;1;10
6446;Papartis;"ŽIRNIUKAI ";1073755384;Ne;0;8;11;19
6447;Papartis;"ŽIRNIUKAI ";7647225316;Ne;7;16;0;23
6448;Papartis;"ŽIRNIUKAI ";1210592579;Ne;2;3;2;7
6449;Papartis;"ŽIRNIUKAI ";1519815331;Ne;9;0;0;9
6450;Papartis;"ŽIRNIUKAI ";4158525314;Ne;0;0;1;1
6451;Papartis;"ŽIRNIUKAI ";4978398085;Ne;0;19;11;30
6452;Papartis;"ŽIRNIUKAI ";9746397380;Ne;7;8;3;18
6453;Papartis;"ŽIRNIUKAI ";4952279543;Ne;6;10;0;16
6454;Papartis;"ŽIRNIUKAI ";5276806556;Ne;8;0;3;11
6455;Papartis;"ŽIRNIUKAI ";2521609574;Ne;0;9;1;10
6456;Papartis;"ŽIRNIUKAI ";7617558492;Ne;0;1;6;7
6457;Papartis;"ŽIRNIUKAI ";8412962815;Ne;8;5;0;13
6458;Papartis;"ŽIRNIUKAI ";2772758899;Ne;11;8;1;20
6459;Papartis;"ŽIRNIUKAI ";1183123161;Ne;0;0;1;1
6460;Papartis;"ŽIRNIUKAI ";1150772988;Ne;2;11;0;13
6461;Papartis;"ŽIRNIUKAI ";9518392031;Ne;7;6;0;13
6462;Papartis;"ŽIRNIUKAI ";6615368741;Ne;23;1;0;24
6463;Papartis;"ŽIRNIUKAI ";7108606229;Ne;5;8;0;13
6464;Papartis;"ŽIRNIUKAI ";1614261572;Ne;2;18;0;20
6465;Papartis;"ŽIRNIUKAI ";8834463589;Ne;0;1;0;1
6466;Papartis;BORUŽĖLĖS;3576856223;Ne;0;11;0;11
6467;Papartis;BORUŽĖLĖS;7492923318;Ne;16;1;1;18
6468;Papartis;BORUŽĖLĖS;1157298413;Ne;7;3;0;10
6469;Papartis;BORUŽĖLĖS;2079105902;Ne;6;0;0;6
6470;Papartis;BORUŽĖLĖS;1159418157;Ne;5;1;0;6
6471;Papartis;BORUŽĖLĖS;3490370261;Ne;17;0;0;17
6472;Papartis;BORUŽĖLĖS;3107245976;Ne;4;0;0;4
6473;Papartis;BORUŽĖLĖS;1566259150;Ne;5;5;0;10
6474;Papartis;BORUŽĖLĖS;1381195839;Ne;5;7;0;12
6475;Papartis;BORUŽĖLĖS;6107558090;Ne;12;1;0;13
6476;Papartis;BORUŽĖLĖS;6776383676;Ne;0;22;0;22
6477;Papartis;BORUŽĖLĖS;9838432144;Ne;12;0;0;12
6478;Papartis;BORUŽĖLĖS;9884399306;Ne;9;1;0;10
6479;Papartis;BORUŽĖLĖS;1511111597;Ne;9;0;0;9
6480;Papartis;BORUŽĖLĖS;8055310718;Ne;12;0;0;12
6481;Papartis;BORUŽĖLĖS;5259754395;Ne;5;1;0;6
6482;Papartis;BORUŽĖLĖS;5959006739;Ne;6;2;0;8
6483;Papartis;BORUŽĖLĖS;5660932637;Ne;17;1;0;18
6484;Papartis;VARPELIAI;7260304487;Ne;9;0;0;9
6485;Papartis;VARPELIAI;9581159294;Ne;8;0;3;11
6486;Papartis;VARPELIAI;2956950308;Ne;7;0;1;8
6487;Papartis;VARPELIAI;6710049689;Ne;3;2;3;8
6488;Papartis;VARPELIAI;2777359899;Taip;10;2;0;12
6489;Papartis;VARPELIAI;1993893368;Ne;4;0;1;5
6490;Papartis;VARPELIAI;3345085436;Ne;1;0;0;1
6491;Papartis;VARPELIAI;7189999679;Ne;13;0;0;13
6492;Papartis;VARPELIAI;4256878733;Ne;0;0;1;1
6493;Papartis;VARPELIAI;8443731277;Ne;4;0;1;5
6494;Papartis;VARPELIAI;3419374226;Ne;2;0;5;7
6495;Papartis;VARPELIAI;2600724041;Ne;9;0;0;9
6496;Papartis;VARPELIAI;2053568874;Ne;14;3;0;17
6497;Papartis;VARPELIAI;4952700737;Ne;14;0;0;14
6498;Papartis;VARPELIAI;8642079824;Ne;2;0;2;4
6499;Papartis;VARPELIAI;8872914372;Ne;9;0;2;11
6500;Papartis;NYKŠTUKAI;5942160584;Ne;5;0;0;5
6501;Papartis;NYKŠTUKAI;9922091482;Ne;0;1;0;1
6502;Papartis;NYKŠTUKAI;9502229005;Ne;7;0;2;9
6503;Papartis;NYKŠTUKAI;6794076631;Ne;0;2;0;2
6504;Papartis;NYKŠTUKAI;5608868738;Ne;0;2;0;2
6505;Papartis;NYKŠTUKAI;4203241118;Ne;5;0;1;6
6506;Papartis;NYKŠTUKAI;8932290803;Ne;0;1;1;2
6507;Papartis;NYKŠTUKAI;5652560002;Ne;0;1;0;1
6508;Papartis;NYKŠTUKAI;1559196767;Ne;3;7;1;11
6509;Papartis;NYKŠTUKAI;6360881137;Ne;0;1;1;2
6510;Papartis;NYKŠTUKAI;6941978169;Ne;4;3;0;7
6511;Pasaka;Drugelių;5665758011;Ne;0;4;0;4
6512;Pasaka;Drugelių;3092993659;Ne;0;2;0;2
6513;Pasaka;Drugelių;5027755073;Ne;0;2;3;5
6514;Pasaka;Drugelių;1300996831;Ne;0;2;1;3
6515;Pasaka;Drugelių;1313576071;Ne;0;1;1;2
6516;Pasaka;Drugelių;2621046003;Ne;0;6;0;6
6517;Pasaka;Drugelių;7040953491;Ne;0;5;0;5
6518;Pasaka;Drugelių;7455544922;Ne;0;1;0;1
6519;Pasaka;Drugelių;8963465320;Ne;0;2;2;4
6520;Pasaka;Drugelių;4743331873;Ne;0;11;5;16
6521;Pasaka;Drugelių;1583090840;Ne;0;1;6;7
6522;Pasaka;Drugelių;2774371800;Ne;0;2;8;10
6523;Pasaka;Drugelių;5547931812;Ne;0;2;4;6
6524;Pasaka;Drugelių;9060396476;Ne;0;1;1;2
6525;Pasaka;Drugelių;7078492847;Ne;0;2;5;7
6526;Pasaka;Nykštukų;7546205285;Ne;0;3;0;3
6527;Pasaka;Nykštukų;5687494160;Ne;4;1;0;5
6528;Pasaka;Nykštukų;3151916774;Ne;0;2;3;5
6529;Pasaka;Nykštukų;4773893970;Ne;0;5;0;5
6530;Pasaka;Nykštukų;4082752808;Ne;2;0;3;5
6531;Pasaka;Nykštukų;5412931969;Ne;3;0;1;4
6532;Pasaka;Nykštukų;9567521319;Ne;0;0;1;1
6533;Pasaka;Nykštukų;8400549247;Ne;6;7;0;13
6534;Pasaka;Nykštukų;6326056771;Ne;0;2;4;6
6535;Pasaka;Nykštukų;4175157894;Ne;3;0;2;5
6536;Pasaka;Nykštukų;5768958388;Ne;0;0;6;6
6537;Pasaka;Nykštukų;7292437626;Ne;0;2;2;4
6538;Pasaka;Montesori;16974081144;Ne;0;0;1;1
6539;Pasaka;Montesori;1514381003;Ne;0;0;4;4
6540;Pasaka;Montesori;5812041166;Ne;0;0;4;4
6541;Pasaka;Montesori;4305485747;Ne;2;0;1;3
6542;Pasaka;Montesori;7837662446;Ne;0;0;7;7
6543;Pasaka;Montesori;5240642967;Ne;5;0;1;6
6544;Pasaka;Montesori;3047931231;Ne;0;0;6;6
6545;Pasaka;Montesori;5031538468;Ne;0;0;2;2
6546;Pasaka;Montesori;4548601585;Ne;3;1;0;4
6547;Pasaka;Montesori;7887326763;Ne;0;0;2;2
6548;Pasaka;Montesori;4366930715;Ne;0;0;1;1
6549;Pasaka;Montesori;9850592463;Ne;5;0;0;5
6550;Pasaka;Montesori;6248810027;Ne;0;0;6;6
6551;Pasaka;Montesori;3620395122;Ne;2;0;1;3
6552;Pasaka;Montesori;5689164477;Ne;6;0;0;6
6553;Pasaka;Montesori;6484610418;Ne;0;0;22;22
6554;Pasaka;Žirniukų;9867183480;Ne;0;0;1;1
6555;Pasaka;Žirniukų;3783869856;Ne;3;0;1;4
6556;Pasaka;Žirniukų;2815348652;Ne;0;0;2;2
6557;Pasaka;Žirniukų;2422958320;Ne;3;0;3;6
6558;Pasaka;Žirniukų;9438006825;Ne;0;0;6;6
6559;Pasaka;Žirniukų;9136524816;Ne;0;8;0;8
6560;Pasaka;Žirniukų;9766432049;Ne;0;0;3;3
6561;Pasaka;Žirniukų;6387972576;Ne;2;0;0;2
6562;Pasaka;Žirniukų;4948174745;Ne;5;0;9;14
6563;Pasaka;Žirniukų;2144975281;Ne;0;0;3;3
6564;Pasaka;Žirniukų;4629119214;Ne;0;0;1;1
6565;Pasaka;Žirniukų;8519108324;Ne;0;2;1;3
6566;Pasaka;Žirniukų;9654507441;Ne;0;0;6;6
6567;Pasaka;Žirniukų;9654507441;Ne;0;0;6;6
6568;Pasaka;Žirniukų;9654507441;Ne;0;0;6;6
6569;Pasaka;Žirniukų;5921553817;Ne;0;0;2;2
6570;Pasaka;Žirniukų;2569560383;Ne;5;0;2;7
6571;Pasaka;"Voveriukų ";3606141216;Ne;0;11;0;11
6572;Pasaka;"Voveriukų ";5217688848;Ne;0;10;0;10
6573;Pasaka;"Voveriukų ";4171004263;Ne;0;0;3;3
6574;Pasaka;"Voveriukų ";8504575043;Ne;0;0;5;5
6575;Pasaka;"Voveriukų ";1488711275;Ne;0;3;0;3
6576;Pasaka;"Voveriukų ";1950145441;Ne;0;0;2;2
6577;Pasaka;"Voveriukų ";9588247759;Ne;0;3;3;6
6578;Pasaka;"Voveriukų ";4915357646;Ne;3;0;3;6
6579;Pasaka;"Voveriukų ";7176272684;Ne;6;4;1;11
6580;Pasaka;"Voveriukų ";9687385445;Ne;0;1;0;1
6581;Pasaka;"Voveriukų ";6684234474;Ne;0;0;5;5
6582;Pasaka;"Voveriukų ";8421404290;Ne;5;1;0;6
6583;Pasaka;"Voveriukų ";1745181416;Ne;8;0;6;14
6584;Pasaka;"Voveriukų ";9780490338;Ne;22;0;0;22
6585;Pasaka;"Voveriukų ";6315362421;Ne;0;1;0;1
6586;Pasaka;"Voveriukų ";6315362421;Ne;0;1;0;1
6587;Pasaka;"VALDOFRO 12";7010681103;Ne;0;6;0;6
6588;Pasaka;"VALDOFRO 12";5141156728;Ne;0;0;2;2
6589;Pasaka;"VALDOFRO 12";2268625523;Ne;3;0;0;3
6590;Pasaka;"VALDOFRO 12";8701112181;Ne;2;0;0;2
6591;Pasaka;"VALDOFRO 12";7682903999;Ne;0;0;3;3
6592;Pasaka;"VALDOFRO 12";4325198579;Ne;0;0;3;3
6593;Pasaka;"VALDOFRO 12";8411025450;Ne;5;0;0;5
6594;Pasaka;"VALDOFRO 12";1756831961;Ne;2;0;0;2
6595;Pasaka;"VALDOFRO 12";3840053722;Ne;0;13;0;13
6596;Pasaka;"VALDOFRO 12";8995205555;Ne;0;0;1;1
6597;Pasaka;"VALDOFRO 12";4548945364;Ne;0;0;3;3
6598;Pasaka;"VALDOFRO 12";4301573328;Ne;0;0;4;4
6599;Pasaka;"VALDOFRO 12";5244582148;Ne;12;0;0;12
6600;Pasaka;"VALDOFRO 12";2650797982;Ne;0;0;1;1
6601;Pasaka;"VALDOFRO 12";9065016148;Ne;0;0;4;4
6602;Pasaka;"VALDOFRO 12";9809498406;Ne;0;0;3;3
6603;Pasaka;"VALDOFRO 12";5040348350;Ne;0;0;14;14
6604;Pasaka;"VALDORFO 2";77904202630;Ne;0;0;2;2
6605;Pasaka;"VALDORFO 2";4752117533;Ne;8;0;1;9
6606;Pasaka;"VALDORFO 2";8590385693;Ne;0;0;11;11
6607;Pasaka;"VALDORFO 2";4620573687;Ne;0;2;0;2
6608;Pasaka;"VALDORFO 2";4825373152;Ne;0;0;1;1
6609;Pasaka;"VALDORFO 2";9462745431;Ne;0;0;4;4
6610;Pasaka;"VALDORFO 2";1799326151;Ne;4;0;1;5
6611;Pasaka;"VALDORFO 2";2273629510;Ne;4;0;1;5
6612;Pasaka;"VALDORFO 2";5903270845;Ne;0;0;14;14
6613;Pasaka;"VALDORFO 2";3778182691;Ne;0;2;0;2
6614;Pasaka;"VALDORFO 2";8947139321;Ne;0;0;1;1
6615;Pasaka;"VALDORFO 2";5742479853;Ne;0;0;10;10
6616;Pasaka;"VALDORFO 2";3049361712;Ne;6;0;1;7
6617;Pasaka;"VALDORFO 2";6497042042;Ne;0;0;2;2
6618;Pasaka;"VALDORFO 2";9150761761;Ne;4;0;0;4
6619;Pasaka;"VALDORFO 2";9821858308;Ne;5;0;1;6
6620;Pasaka;"VALDORFO 2";1648043715;Ne;0;0;11;11
6621;Pasaka;Gudručiai;6253266504;Ne;0;1;0;1
6622;Pasaka;Gudručiai;4137222204;Ne;1;5;0;6
6623;Pasaka;Gudručiai;7103485358;Ne;0;3;0;3
6624;Pasaka;Gudručiai;7648503006;Ne;0;1;0;1
6625;Pasaka;Gudručiai;2400455036;Ne;4;5;0;9
6626;Pasaka;Gudručiai;9722435751;Ne;0;7;0;7
6627;Pasaka;Gudručiai;73703706115;Ne;0;2;0;2
6628;Pasaka;Gudručiai;79170702319;Ne;0;3;3;6
6629;Pasaka;Gudručiai;5965121999;Ne;0;0;3;3
6630;Pasaka;Gudručiai;7286419663;Ne;0;2;0;2
6631;Pasaka;Gudručiai;5973028582;Ne;0;12;0;12
6632;Pasaka;Gudručiai;7445696309;Ne;0;3;0;3
6633;Pasaka;Gudručiai;1565873178;Ne;0;8;0;8
6634;Pasaka;Gudručiai;2697014098;Ne;0;1;0;1
6635;Pasaka;Gudručiai;5651452381;Ne;0;8;0;8
6636;Pasaka;Gudručiai;6441884677;Ne;0;8;0;8
6637;Pasaka;Gudručiai;2018620389;Ne;0;6;0;6
6638;Pasaka;Gudručiai;2671403814;Ne;5;0;1;6
6639;Pasaka;Gudručiai;42548487389;Ne;10;2;0;12
6640;Pasaka;Gudručiai;8448558788;Ne;4;1;0;5
6641;Pasaka;Bitelių;5351364328;Ne;0;0;4;4
6642;Pasaka;Bitelių;4635912654;Ne;0;0;4;4
6643;Pasaka;Bitelių;7248640367;Ne;0;5;0;5
6644;Pasaka;Bitelių;8277245475;Ne;0;0;12;12
6645;Pasaka;Bitelių;6868519179;Ne;0;0;2;2
6646;Pasaka;Bitelių;6759415053;Ne;0;0;2;2
6647;Pasaka;Bitelių;9136521759;Ne;0;2;1;3
6648;Pasaka;Bitelių;3367346582;Ne;0;3;2;5
6649;Pasaka;Bitelių;3351338617;Ne;0;2;0;2
6650;Pasaka;Bitelių;5371046207;Ne;2;10;1;13
6651;Pasaka;Bitelių;1335408890;Ne;0;1;0;1
6652;Pasaka;Bitelių;6139825302;Ne;0;2;0;2
6653;Pasaka;Bitelių;4970812899;Ne;5;0;0;5
6654;Pasaka;Bitelių;8873115041;Ne;4;0;0;4
6655;Pasaka;Bitelių;1720511696;Ne;18;0;0;18
6656;Pasaka;Bitelių;2963373430;Ne;0;0;1;1
6657;Pasaka;"Pabiručių ";4846146925;Ne;0;0;22;22
6658;Pasaka;"Pabiručių ";9770811826;Ne;0;0;22;22
6659;Pasaka;"Pabiručių ";9471447977;Ne;0;4;1;5
6660;Pasaka;"Pabiručių ";7751618911;Ne;0;1;0;1
6661;Pasaka;"Pabiručių ";7696383564;Ne;1;0;2;3
6662;Pasaka;"Pabiručių ";3796844193;Ne;2;0;0;2
6663;Pasaka;"Pabiručių ";4910817298;Ne;3;0;3;6
6664;Pasaka;"Pabiručių ";4222952044;Ne;10;0;0;10
6665;Pasaka;"Pabiručių ";4994426702;Ne;0;0;5;5
6666;Pasaka;"Pabiručių ";8289010515;Ne;0;0;5;5
6667;Pasaka;"Pabiručių ";5111195289;Ne;2;4;6;12
6668;Pasaka;"Pabiručių ";6182223896;Ne;2;4;6;12
6669;Pasaka;"Pabiručių ";8558563996;Ne;0;0;1;1
6670;Pasaka;"Pabiručių ";3557547656;Ne;0;0;22;22
6671;Pasaka;Šnekučių;1512874567;Ne;5;0;0;5
6672;Pasaka;Šnekučių;1793176485;Ne;0;1;0;1
6673;Pasaka;Šnekučių;4296539838;Taip;0;0;1;1
6674;Pasaka;Šnekučių;6795580569;Ne;0;9;0;9
6675;Pasaka;Šnekučių;3240292756;Ne;0;2;0;2
6676;Pasaka;Šnekučių;4215568107;Ne;0;1;0;1
6677;Pasaka;Šnekučių;8365256755;Ne;0;3;0;3
6678;Pasaka;Šnekučių;1562771242;Ne;0;2;0;2
6679;Pasaka;Šnekučių;4816441219;Ne;0;2;3;5
6680;Pasaka;Šnekučių;1795497567;Ne;0;2;5;7
6681;Pasaka;Šnekučių;8347051587;Ne;2;1;0;3
6682;Pasaka;Šnekučių;3588073618;Ne;0;8;1;9
6683;Pasaka;Šnekučių;1749821746;Ne;0;3;1;4
6684;Pasaka;Šnekučių;1723076060;Ne;0;1;0;1
6685;Pasaka;Šnekučių;8475365713;Ne;5;1;0;6
6686;Pasaka;Šnekučių;5656511105;Ne;9;0;0;9
6687;Pasaka;"KIŠKUČIŲ (Žirmūnų g. 92)";7311929329;Ne;0;0;1;1
6688;Pasaka;"KIŠKUČIŲ (Žirmūnų g. 92)";5134067973;Taip;2;0;0;2
6689;Pasaka;"KIŠKUČIŲ (Žirmūnų g. 92)";5073970913;Ne;0;0;1;1
6690;Pasaka;"KIŠKUČIŲ (Žirmūnų g. 92)";5255764606;Ne;10;0;4;14
6691;Pasaka;"KIŠKUČIŲ (Žirmūnų g. 92)";6950137606;Ne;0;0;4;4
6692;Pasaka;"KIŠKUČIŲ (Žirmūnų g. 92)";2575986215;Ne;9;0;0;9
6693;Pasaka;"KIŠKUČIŲ (Žirmūnų g. 92)";5632714212;Ne;8;0;4;12
6694;Pasaka;"KIŠKUČIŲ (Žirmūnų g. 92)";9928518840;Ne;5;4;0;9
6695;Pasaka;"KIŠKUČIŲ (Žirmūnų g. 92)";4572517095;Ne;0;9;0;9
6696;Pasaka;"EŽIUKŲ (Žirmūnų g. 92)";9369336996;Ne;0;0;1;1
6697;Pasaka;"EŽIUKŲ (Žirmūnų g. 92)";8866484797;Ne;0;0;7;7
6698;Pasaka;"EŽIUKŲ (Žirmūnų g. 92)";3735117473;Ne;0;0;2;2
6699;Pasaka;"EŽIUKŲ (Žirmūnų g. 92)";6280303158;Ne;0;0;3;3
6700;Pasaka;"EŽIUKŲ (Žirmūnų g. 92)";9324220807;Ne;2;0;0;2
6701;Pasaka;"EŽIUKŲ (Žirmūnų g. 92)";5630598566;Ne;13;0;6;19
6702;Pasaka;"EŽIUKŲ (Žirmūnų g. 92)";1083785206;Ne;0;0;7;7
6703;Pasaka;"EŽIUKŲ (Žirmūnų g. 92)";3587648653;Ne;16;0;0;16
6704;Pasaka;"EŽIUKŲ (Žirmūnų g. 92)";6388657745;Ne;16;0;0;16
6705;Pasaka;"EŽIUKŲ (Žirmūnų g. 92)";8837340945;Ne;7;5;0;12
6706;Pasaka;"EŽIUKŲ (Žirmūnų g. 92)";8082395844;Ne;8;0;0;8
6707;Pasaka;"EŽIUKŲ (Žirmūnų g. 92)";9403892434;Ne;5;0;3;8
6708;Pasaka;"EŽIUKŲ (Žirmūnų g. 92)";6498432810;Ne;18;0;6;24
6709;Pasaka;"SAULUČIŲ (Žirmūnų g. 92)";1963481567;Ne;0;0;3;3
6710;Pasaka;"SAULUČIŲ (Žirmūnų g. 92)";2217868951;Ne;7;0;1;8
6711;Pasaka;"SAULUČIŲ (Žirmūnų g. 92)";2217868951;Ne;7;0;1;8
6712;Pasaka;"SAULUČIŲ (Žirmūnų g. 92)";2217868951;Ne;7;0;1;8
6713;Pasaka;"SAULUČIŲ (Žirmūnų g. 92)";8164697203;Ne;0;0;4;4
6714;Pasaka;"SAULUČIŲ (Žirmūnų g. 92)";6991062262;Ne;0;0;2;2
6715;Pasaka;"SAULUČIŲ (Žirmūnų g. 92)";1214817944;Ne;0;0;8;8
6716;Pasaka;"SAULUČIŲ (Žirmūnų g. 92)";2211744442;Ne;0;3;0;3
6717;Pasaka;"SAULUČIŲ (Žirmūnų g. 92)";5912306325;Ne;10;1;0;11
6718;Pasaka;"SAULUČIŲ (Žirmūnų g. 92)";6087447128;Ne;0;0;1;1
6719;Pasaka;"SAULUČIŲ (Žirmūnų g. 92)";3066438231;Ne;10;0;7;17
6720;Pasaka;"SAULUČIŲ (Žirmūnų g. 92)";3066438231;Ne;10;0;7;17
6721;Pasaka;"SAULUČIŲ (Žirmūnų g. 92)";3066438231;Ne;10;0;7;17
6722;Pasaka;"SAULUČIŲ (Žirmūnų g. 92)";6157459742;Ne;10;0;2;12
6723;Pasaka;"SAULUČIŲ (Žirmūnų g. 92)";3424189866;Ne;10;0;0;10
6724;Pasaka;"SAULUČIŲ (Žirmūnų g. 92)";5969883817;Ne;0;0;7;7
6725;Pasaka;"SAULUČIŲ (Žirmūnų g. 92)";6821289069;Ne;9;0;1;10
6726;Pasaka;"SAULUČIŲ (Žirmūnų g. 92)";5414186755;Ne;0;7;13;20
6727;Paslaptis;MONTIKI;4683384309;Ne;2;2;0;4
6728;Paslaptis;MONTIKI;9929877115;Ne;0;8;0;8
6729;Paslaptis;MONTIKI;6860366087;Taip;6;0;0;6
6730;Paslaptis;MONTIKI;2927014406;Taip;12;0;2;14
6731;Paslaptis;MONTIKI;7053452493;Ne;12;0;0;12
6732;Paslaptis;MONTIKI;3963816472;Ne;4;0;4;8
6733;Paslaptis;MONTIKI;5809630456;Ne;3;0;1;4
6734;Paslaptis;MONTIKI;6764142182;Ne;0;6;0;6
6735;Paslaptis;MONTIKI;5480407965;Ne;18;0;0;18
6736;Paslaptis;FRUTIKI;9100003209;Ne;12;4;0;16
6737;Paslaptis;FRUTIKI;3984799090;Ne;0;1;0;1
6738;Paslaptis;FRUTIKI;5886364670;Ne;4;0;0;4
6739;Paslaptis;FRUTIKI;5406800599;Ne;9;0;0;9
6740;Paslaptis;FRUTIKI;2675089401;Ne;8;1;0;9
6741;Paslaptis;FRUTIKI;1557783684;Ne;9;3;0;12
6742;Paslaptis;FRUTIKI;8895770223;Ne;5;0;0;5
6743;Paslaptis;FRUTIKI;5206529350;Ne;0;6;0;6
6744;Paslaptis;FRUTIKI;2105441745;Ne;5;1;2;8
6745;Paslaptis;FRUTIKI;6686352764;Ne;22;0;0;22
6746;Paslaptis;FRUTIKI;5456011928;Ne;0;2;0;2
6747;Paslaptis;FRUTIKI;8717111488;Ne;9;2;0;11
6748;Paslaptis;FRUTIKI;5646806136;Ne;0;1;1;2
6749;Paslaptis;FRUTIKI;6513238386;Ne;0;7;0;7
6750;Paslaptis;FRUTIKI;6098345982;Ne;0;1;0;1
6751;Paslaptis;FRUTIKI;4810686225;Ne;2;1;1;4
6752;Paslaptis;FRUTIKI;8296575784;Ne;0;11;0;11
6753;Paslaptis;FRUTIKI;1754621741;Ne;22;0;0;22
6754;Paslaptis;FRUTIKI;7638521198;Ne;0;1;0;1
6755;Paslaptis;KALAMBURIKI;1029321312;Ne;2;2;0;4
6756;Paslaptis;KALAMBURIKI;3093280943;Ne;1;1;0;2
6757;Paslaptis;KALAMBURIKI;9559318660;Ne;4;0;0;4
6758;Paslaptis;KALAMBURIKI;2705751628;Ne;0;0;3;3
6759;Paslaptis;KALAMBURIKI;2879752620;Ne;0;9;0;9
6760;Paslaptis;KALAMBURIKI;8280740387;Ne;11;0;1;12
6761;Paslaptis;KALAMBURIKI;5852939221;Ne;0;1;0;1
6762;Paslaptis;KALAMBURIKI;2891547963;Ne;0;2;1;3
6763;Paslaptis;KALAMBURIKI;3104525540;Ne;7;0;9;16
6764;Paslaptis;KALAMBURIKI;1186681520;Ne;10;3;0;13
6765;Paslaptis;KALAMBURIKI;3415869190;Ne;9;3;0;12
6766;Paslaptis;KALAMBURIKI;1983773762;Ne;0;2;1;3
6767;Paslaptis;KALAMBURIKI;5557019619;Ne;0;2;1;3
6768;Paslaptis;KALAMBURIKI;3549998192;Ne;0;0;4;4
6769;Paslaptis;KALAMBURIKI;1782398974;Ne;0;4;0;4
6770;Paslaptis;KALAMBURIKI;8146824196;Ne;0;0;2;2
6771;Paslaptis;KALAMBURIKI;4109288950;Ne;6;1;0;7
6772;Paslaptis;KALAMBURIKI;3398729758;Ne;0;0;11;11
6773;Paslaptis;KALAMBURIKI;8083478190;Ne;0;0;3;3
6774;Paslaptis;KALAMBURIKI;2089780119;Ne;6;8;6;20
6775;Pasakaitė;Vieversėlių;7685647972;Ne;9;0;1;10
6776;Pasakaitė;Vieversėlių;6459145539;Ne;2;10;0;12
6777;Pasakaitė;Vieversėlių;2194313054;Taip;0;3;0;3
6778;Pasakaitė;Vieversėlių;9587489514;Ne;6;0;1;7
6779;Pasakaitė;Vieversėlių;3444442287;Ne;4;10;4;18
6780;Pasakaitė;Vieversėlių;5485965486;Ne;7;3;0;10
6781;Pasakaitė;Vieversėlių;2563725297;Ne;9;0;0;9
6782;Pasakaitė;Vieversėlių;2849753418;Ne;0;10;4;14
6783;Pasakaitė;Vieversėlių;7963057831;Ne;0;2;0;2
6784;Pasakaitė;Vieversėlių;9543991684;Ne;0;8;0;8
6785;Pasakaitė;Vieversėlių;3680596008;Ne;0;4;0;4
6786;Pasakaitė;Vieversėlių;4882856664;Ne;0;2;2;4
6787;Pasakaitė;Vieversėlių;5948958906;Ne;0;7;0;7
6788;Pasakaitė;Vieversėlių;1060914693;Ne;13;0;0;13
6789;Pasakaitė;Vieversėlių;7761162338;Ne;0;2;0;2
6790;Pasakaitė;Vieversėlių;8463220257;Ne;0;16;0;16
6791;Pasakaitė;Vieversėlių;9018830962;Ne;12;12;0;24
6792;Pasakaitė;Vieversėlių;6736879757;Ne;22;10;0;32
6793;Pasakaitė;Vieversėlių;4191875802;Ne;0;6;6;12
6794;Pasakaitė;Vieversėlių;5020801150;Ne;6;0;0;6
6795;Pasakaitė;Spindulėlių;1962693480;Ne;0;11;0;11
6796;Pasakaitė;Spindulėlių;4758073190;Ne;2;0;0;2
6797;Pasakaitė;Spindulėlių;6714500298;Ne;0;14;0;14
6798;Pasakaitė;Spindulėlių;1697755753;Ne;2;2;0;4
6799;Pasakaitė;Spindulėlių;1056358241;Ne;3;14;0;17
6800;Pasakaitė;Spindulėlių;8105641645;Ne;0;4;0;4
6801;Pasakaitė;Spindulėlių;5791927811;Taip;0;32;0;32
6802;Pasakaitė;Spindulėlių;5094404397;Taip;0;32;0;32
6803;Pasakaitė;Spindulėlių;9870015737;Ne;0;7;0;7
6804;Pasakaitė;Spindulėlių;1449037968;Ne;0;11;0;11
6805;Pasakaitė;Spindulėlių;7474100735;Ne;0;4;0;4
6806;Pasakaitė;Spindulėlių;6015360076;Ne;0;26;0;26
6807;Pasakaitė;Spindulėlių;6256000265;Ne;3;5;1;9
6808;Pasakaitė;Spindulėlių;2891089579;Ne;3;5;0;8
6809;Pasakaitė;Spindulėlių;3381303531;Ne;0;1;0;1
6810;Pasakaitė;Spindulėlių;3652896053;Ne;0;5;0;5
6811;Pasakaitė;Spindulėlių;7265623955;Ne;16;6;0;22
6812;Pasakaitė;Spindulėlių;1564611671;Ne;20;5;0;25
6813;Pasakaitė;Spindulėlių;3283593388;Ne;7;0;2;9
6814;Pasakaitė;Spindulėlių;2652882309;Ne;2;1;3;6
6815;Pasakaitė;Spindulėlių;4268438476;Ne;7;10;0;17
6816;Pasakaitė;Spindulėlių;2340908210;Ne;4;4;0;8
6817;Pasakaitė;Pasagėlių;2810892060;Ne;3;9;0;12
6818;Pasakaitė;Pasagėlių;9895144528;Ne;0;6;6;12
6819;Pasakaitė;Pasagėlių;6609127382;Ne;0;7;0;7
6820;Pasakaitė;Pasagėlių;9409907631;Ne;19;6;0;25
6821;Pasakaitė;Pasagėlių;5589440439;Ne;8;7;0;15
6822;Pasakaitė;Pasagėlių;5959875562;Ne;0;8;0;8
6823;Pasakaitė;Pasagėlių;3355268509;Ne;2;21;0;23
6824;Pasakaitė;Pasagėlių;1959599606;Ne;0;12;0;12
6825;Pasakaitė;Pasagėlių;7440327561;Ne;0;12;0;12
6826;Pasakaitė;Pasagėlių;6325408070;Taip;11;1;1;13
6827;Pasakaitė;Pasagėlių;9238905834;Taip;0;17;0;17
6828;Pasakaitė;Pasagėlių;4826492004;Ne;6;6;0;12
6829;Pasakaitė;Pasagėlių;7666033916;Ne;5;10;0;15
6830;Pasakaitė;Pasagėlių;5540251866;Ne;0;10;0;10
6831;Pasakaitė;Pasagėlių;7219080600;Ne;0;9;0;9
6832;Pasakaitė;Pasagėlių;8264189678;Ne;0;4;1;5
6833;Pasakaitė;Pasagėlių;2341175137;Ne;0;10;5;15
6834;Pasakaitė;Pasagėlių;8905681529;Ne;0;7;3;10
6835;Pasakaitė;Pasagėlių;8165055476;Ne;0;7;4;11
6836;Pasakaitė;Pasagėlių;7360801624;Ne;10;0;1;11
6837;Pasakaitė;Pasagėlių;5617173998;Ne;0;7;0;7
6838;Pasakaitė;Pasagėlių;5034077389;Ne;0;8;2;10
6839;Pasakaitė;Švyturėlių;7702359586;Ne;0;1;0;1
6840;Pasakaitė;Švyturėlių;2721048424;Ne;0;0;1;1
6841;Pasakaitė;Švyturėlių;6847782430;Ne;0;7;0;7
6842;Pasakaitė;Švyturėlių;1533259056;Ne;0;0;2;2
6843;Pasakaitė;Švyturėlių;4728731352;Ne;0;0;1;1
6844;Pasakaitė;Švyturėlių;9821617981;Ne;0;0;9;9
6845;Pasakaitė;Švyturėlių;1184513606;Ne;0;0;10;10
6846;Pasakaitė;Švyturėlių;2751828639;Ne;0;0;1;1
6847;Pasakaitė;Švyturėlių;2329827275;Ne;2;0;0;2
6848;Pasakaitė;Švyturėlių;2933474317;Ne;6;0;2;8
6849;Pasakaitė;Švyturėlių;5498393070;Ne;0;22;0;22
6850;Pasakaitė;Švyturėlių;9012098645;Ne;0;22;0;22
6851;Pasakaitė;Švyturėlių;3417077517;Ne;3;0;1;4
6852;Pasakaitė;Švyturėlių;1793453325;Ne;0;5;0;5
6853;Pasakaitė;Švyturėlių;4694818333;Ne;0;0;2;2
6854;Pasakaitė;Kodėlčiukų;8662488739;Ne;22;0;0;22
6855;Pasakaitė;Kodėlčiukų;9972985920;Ne;4;0;2;6
6856;Pasakaitė;Kodėlčiukų;5699688792;Ne;21;0;0;21
6857;Pasakaitė;Kodėlčiukų;9441990175;Ne;0;0;11;11
6858;Pasakaitė;Kodėlčiukų;4485053261;Ne;7;0;0;7
6859;Pasakaitė;Kodėlčiukų;9351971114;Ne;5;0;1;6
6860;Pasakaitė;Kodėlčiukų;2303884875;Ne;16;0;1;17
6861;Pasakaitė;Kodėlčiukų;4878562841;Ne;8;0;1;9
6862;Pasakaitė;Kodėlčiukų;2994653871;Ne;0;0;2;2
6863;Pasakaitė;Kodėlčiukų;4328440534;Ne;0;0;1;1
6864;Pasakaitė;Kodėlčiukų;4881361200;Ne;4;0;2;6
6865;Pasakaitė;Kodėlčiukų;2389832646;Ne;0;5;0;5
6866;Pasakaitė;Kodėlčiukų;7138417196;Ne;5;1;1;7
6867;Pasakaitė;Kodėlčiukų;5581264184;Ne;0;2;0;2
6868;Pasakaitė;Kodėlčiukų;8037316673;Ne;5;0;0;5
6869;Pasakaitė;Kodėlčiukų;5732009054;Ne;0;6;0;6
6870;Pasakaitė;Kodėlčiukų;6755983130;Ne;8;0;0;8
6871;Pasakaitė;Kodėlčiukų;2476010561;Ne;10;0;0;10
6872;Pasakaitė;Kodėlčiukų;3925034196;Ne;10;0;0;10
6873;Pasakaitė;Gudručių;6568538767;Ne;0;1;0;1
6874;Pasakaitė;Gudručių;1523034176;Ne;0;0;5;5
6875;Pasakaitė;Gudručių;5369558652;Ne;0;1;1;2
6876;Pasakaitė;Gudručių;4703375416;Ne;0;7;0;7
6877;Pasakaitė;Gudručių;1707428977;Ne;0;0;3;3
6878;Pasakaitė;Gudručių;9680682204;Ne;0;0;1;1
6879;Pasakaitė;Gudručių;3345955615;Ne;0;0;2;2
6880;Pasakaitė;Gudručių;1791015854;Ne;0;7;2;9
6881;Pasakaitė;Gudručių;39853246609;Ne;0;2;0;2
6882;Pasakaitė;Gudručių;67374677045;Ne;0;0;6;6
6883;Pasakaitė;Gudručių;4959175420;Ne;0;2;0;2
6884;Pasakaitė;Gudručių;6839399035;Ne;5;0;0;5
6885;Pasakaitė;Gudručių;3778906698;Ne;0;0;2;2
6886;Pasakaitė;Gudručių;1940545723;Ne;0;10;0;10
6887;Pasakaitė;Gudručių;1809383469;Ne;2;0;1;3
6888;Pasakaitė;Gudručių;1592521766;Ne;0;0;1;1
6889;Pasakaitė;Gudručių;4008826950;Ne;20;0;2;22
6890;Pasakaitė;Gudručių;9031690002;Ne;12;0;0;12
6891;Pasakaitė;Gudručių;2742595829;Ne;0;0;2;2
6892;Pasakaitė;Gudručių;1513903341;Ne;0;4;0;4
6893;Pasakaitė;Gudručių;8390366303;Ne;0;0;3;3
6894;Pasakaitė;Gudručių;3231283338;Ne;0;0;5;5
6895;Pasakaitė;Čiulbonėlių;4680949976;Ne;0;1;0;1
6896;Pasakaitė;Čiulbonėlių;7152349570;Ne;0;11;0;11
6897;Pasakaitė;Čiulbonėlių;1458338379;Ne;0;8;0;8
6898;Pasakaitė;Čiulbonėlių;7526264241;Ne;0;0;6;6
6899;Pasakaitė;Čiulbonėlių;3541877287;Ne;0;0;1;1
6900;Pasakaitė;Čiulbonėlių;7607522887;Ne;8;4;0;12
6901;Pasakaitė;Čiulbonėlių;3606601644;Ne;0;1;0;1
6902;Pasakaitė;Čiulbonėlių;5313360864;Ne;5;0;0;5
6903;Pasakaitė;Čiulbonėlių;3579498202;Ne;0;3;0;3
6904;Pasakaitė;Čiulbonėlių;7790937149;Ne;12;0;0;12
6905;Pasakaitė;Čiulbonėlių;3400305768;Ne;12;0;0;12
6906;Pasakaitė;Čiulbonėlių;83018133588;Ne;0;0;4;4
6907;Pasakaitė;Čiulbonėlių;5605619860;Ne;0;11;0;11
6908;Pasakaitė;Čiulbonėlių;61230317080;Ne;0;2;0;2
6909;Pasakaitė;Čiulbonėlių;8466086339;Ne;0;0;3;3
6910;Pasakaitė;Čiulbonėlių;5467179333;Ne;7;0;0;7
6911;Pasakaitė;Čiulbonėlių;1740419218;Ne;0;7;0;7
6912;Pasakaitė;Čiulbonėlių;8469043564;Ne;0;0;8;8
6913;Pasakaitė;"Verpstelių ";7621306769;Ne;0;8;0;8
6914;Pasakaitė;"Verpstelių ";4946855684;Ne;0;9;0;9
6915;Pasakaitė;"Verpstelių ";5556362727;Ne;0;0;3;3
6916;Pasakaitė;"Verpstelių ";7451624229;Ne;0;1;0;1
6917;Pasakaitė;"Verpstelių ";7759051761;Ne;0;3;0;3
6918;Pasakaitė;"Verpstelių ";8315840473;Ne;0;1;0;1
6919;Pasakaitė;"Verpstelių ";1425166722;Ne;0;1;1;2
6920;Pasakaitė;"Verpstelių ";7813221735;Ne;10;1;0;11
6921;Pasakaitė;"Verpstelių ";4246461594;Ne;0;0;4;4
6922;Pasakaitė;"Verpstelių ";1963102227;Ne;0;2;3;5
6923;Pasakaitė;"Verpstelių ";8562284745;Ne;0;16;0;16
6924;Pasakaitė;"Verpstelių ";1041405418;Ne;0;13;0;13
6925;Pasakaitė;"Verpstelių ";7976921380;Ne;0;7;0;7
6926;Pasakaitė;"Verpstelių ";2505815026;Ne;19;5;3;27
6927;Pasakaitė;"Verpstelių ";5413457806;Ne;3;1;0;4
6928;Pasakaitė;"Verpstelių ";1115383380;Ne;0;0;1;1
6929;Pasakaitė;"Verpstelių ";2714905466;Ne;22;5;0;27
6930;Pasakaitė;"Verpstelių ";9226989209;Ne;0;2;0;2
6931;Pasakaitė;Smalsučiai;7539851375;Ne;8;0;0;8
6932;Pasakaitė;Smalsučiai;9114337491;Ne;0;4;0;4
6933;Pasakaitė;Smalsučiai;2278658674;Ne;2;5;5;12
6934;Pasakaitė;Smalsučiai;6522727154;Ne;9;6;2;17
6935;Pasakaitė;Smalsučiai;8711237946;Ne;0;1;1;2
6936;Pasakaitė;Smalsučiai;1122248122;Ne;11;10;0;21
6937;Pasakaitė;Smalsučiai;9982451343;Ne;0;8;8;16
6938;Pasakaitė;Smalsučiai;4977052991;Ne;0;18;0;18
6939;Pasakaitė;Smalsučiai;7604996145;Ne;9;10;0;19
6940;Pasakaitė;Smalsučiai;4144569088;Ne;0;5;1;6
6941;Pasakaitė;Smalsučiai;4307883488;Ne;12;10;0;22
6942;Pasakaitė;Smalsučiai;2546550685;Ne;0;1;0;1
6943;Pasakaitė;Smalsučiai;5115067331;Ne;0;10;0;10
6944;Pasakaitė;Smalsučiai;7994712153;Ne;0;10;12;22
6945;Pasakaitė;"Čiauškučiai ";4098119950;Ne;8;2;0;10
6946;Pasakaitė;"Čiauškučiai ";9512782063;Ne;7;0;0;7
6947;Pasakaitė;"Čiauškučiai ";6229020982;Ne;0;0;1;1
6948;Pasakaitė;"Čiauškučiai ";5279719152;Ne;2;4;0;6
6949;Pasakaitė;"Čiauškučiai ";6160327808;Ne;4;0;1;5
6950;Pasakaitė;"Čiauškučiai ";1705913604;Ne;2;0;1;3
6951;Pasakaitė;"Čiauškučiai ";4898974534;Ne;12;0;0;12
6952;Pasakaitė;"Čiauškučiai ";3691817711;Ne;17;0;0;17
6953;Pasakaitė;"Čiauškučiai ";3659371923;Ne;0;9;0;9
6954;Pasakaitė;"Čiauškučiai ";7885958426;Ne;5;5;0;10
6955;Pasakaitė;"Čiauškučiai ";2902368705;Ne;0;21;0;21
6956;Pasakaitė;"Čiauškučiai ";2041179927;Ne;5;0;0;5
6957;Pasakaitė;"Čiauškučiai ";6745120294;Ne;0;4;0;4
6958;Pasakaitė;"Čiauškučiai ";4120765793;Ne;0;4;0;4
6959;Pasakaitė;Pabiručiai;5180059311;Ne;0;5;3;8
6960;Pasakaitė;Pabiručiai;5162170061;Ne;0;10;1;11
6961;Pasakaitė;Pabiručiai;8478538959;Ne;0;0;6;6
6962;Pasakaitė;Pabiručiai;6795204239;Ne;4;0;0;4
6963;Pasakaitė;Pabiručiai;5058070480;Ne;7;11;0;18
6964;Pasakaitė;Pabiručiai;1453976284;Ne;0;14;3;17
6965;Pasakaitė;Pabiručiai;8559244062;Ne;0;5;1;6
6966;Pasakaitė;Pabiručiai;9790988677;Ne;2;5;2;9
6967;Pasakaitė;Pabiručiai;5439936572;Ne;7;3;0;10
6968;Pasakaitė;Pabiručiai;4316883215;Ne;5;1;0;6
6969;Pasakaitė;Pabiručiai;6682010485;Ne;14;0;0;14
6970;Pasakaitė;Pabiručiai;3466308130;Ne;17;0;1;18
6971;Pasakaitė;Pabiručiai;9402238675;Ne;5;0;1;6
6972;Pasakaitė;Pabiručiai;9311649698;Ne;13;0;0;13
6973;Pasakaitė;Pabiručiai;5499373802;Ne;12;0;4;16
6974;Pasakaitė;Linksmučiai;7965916747;Ne;2;10;3;15
6975;Pasakaitė;Linksmučiai;1279728451;Ne;0;5;2;7
6976;Pasakaitė;Linksmučiai;2584717150;Ne;7;0;3;10
6977;Pasakaitė;Linksmučiai;4397797616;Ne;22;0;0;22
6978;Pasakaitė;Linksmučiai;4659277297;Ne;6;5;1;12
6979;Pasakaitė;Linksmučiai;8381083251;Ne;9;9;1;19
6980;Pasakaitė;Linksmučiai;8252123824;Ne;8;0;0;8
6981;Pasakaitė;Linksmučiai;4444725869;Taip;8;0;0;8
6982;Pasakaitė;Linksmučiai;2801785334;Ne;15;0;4;19
6983;Pasakaitė;Linksmučiai;9606533767;Ne;9;0;0;9
6984;Pasakaitė;Linksmučiai;2899659479;Ne;8;0;0;8
6985;Pasakaitė;Linksmučiai;8160163060;Ne;6;0;5;11
6986;Pasakaitė;Linksmučiai;8350808883;Ne;0;8;0;8
6987;Pasakaitė;Linksmučiai;5745073940;Ne;5;0;0;5
6988;Pelėda;PELIUKAI;9946001722;Ne;8;0;0;8
6989;Pelėda;PELIUKAI;9517601102;Ne;10;0;0;10
6990;Pelėda;GUDRUČIAI;7297186734;Ne;8;0;0;8
6991;Pelėda;ŽIRNIUKAI;4561020945;Ne;10;0;0;10
6992;Pelėda;ŽIRNIUKAI;9150480625;Ne;13;0;0;13
6993;Pelėda;ŽIRNIUKAI;7202399026;Ne;5;0;0;5
6994;Pelėda;ŽIRNIUKAI;8448771456;Ne;11;0;0;11
6995;Pelėda;ŽIRNIUKAI;3189487277;Ne;5;0;0;5
6996;Pelėda;ĄŽUOLIUKAI;7555580849;Ne;10;0;0;10
6997;Pelėda;BORUŽIUKŲ;8148826427;Ne;10;0;0;10
6998;Pelėda;BORUŽIUKŲ;2626787696;Ne;5;0;0;5
6999;Pelėda;BORUŽIUKŲ;8768572308;Ne;5;0;0;5
7000;Pelėda;BORUŽIUKŲ;5563116254;Ne;9;0;0;9
7001;Pelėda;DRUGELIAI;2972697161;Ne;15;0;0;15
7002;Pelėda;DRUGELIAI;9786523383;Ne;12;0;0;12
7003;Pelėda;DRUGELIAI;9470036802;Ne;9;0;0;9
7004;Pelėda;OBUOLIUKAI;4473075270;Ne;13;0;0;13
7005;Pelėda;OBUOLIUKAI;9836170452;Ne;7;0;0;7
7006;Pelėda;OBUOLIUKAI;4380328321;Ne;12;0;0;12
7007;Pelėda;OBUOLIUKAI;7955805701;Ne;5;0;0;5
7008;Pelėda;OBUOLIUKAI;2671545779;Ne;6;0;0;6
7009;Pelėda;OBUOLIUKAI;8371096927;Ne;10;0;0;10
7010;Pelėda;BITUTĖS;2018682468;Ne;10;0;0;10
7011;Pelėda;SMALSUČIAI;9981001823;Ne;8;0;0;8
7012;Pelėda;SMALSUČIAI;9243579706;Ne;8;0;0;8
7013;Pelėda;SMALSUČIAI;8775397229;Ne;3;0;0;3
7014;Pelėda;SMALSUČIAI;1962928106;Ne;5;0;0;5
7015;Pelėda;SMALSUČIAI;4486503894;Ne;5;0;0;5
7016;Pelėda;"NAUJA DARŽELIS";9104022893;Ne;20;0;0;20
7017;Pelenė;Varpelis;8807342148;Ne;2;0;1;3
7018;Pelenė;Varpelis;5697826755;Ne;0;0;1;1
7019;Pelenė;Varpelis;8239650471;Ne;5;0;0;5
7020;Pelenė;Varpelis;4004975235;Ne;6;0;0;6
7021;Pelenė;Varpelis;8790613872;Ne;6;0;0;6
7022;Pelenė;Varpelis;2487632125;Ne;0;0;8;8
7023;Pelenė;Varpelis;5228983908;Ne;7;0;3;10
7024;Pelenė;Varpelis;6524101295;Ne;13;0;0;13
7025;Pelenė;Varpelis;4373886054;Ne;5;2;0;7
7026;Pelenė;Varpelis;8038559319;Ne;0;0;1;1
7027;Pelenė;Varpelis;7578318198;Ne;11;1;0;12
7028;Pelenė;Varpelis;7164790060;Ne;0;1;0;1
7029;Pelenė;Varpelis;4777496709;Ne;0;0;2;2
7030;Pelenė;Varpelis;9447223913;Ne;11;10;0;21
7031;Pelenė;Varpelis;6894978459;Ne;13;2;0;15
7032;Pelenė;Varpelis;2103177773;Ne;0;0;2;2
7033;Pelenė;Varpelis;6864263698;Ne;0;0;21;21
7034;Pelenė;Saulutės;7880284433;Ne;0;2;4;6
7035;Pelenė;Saulutės;1468658102;Ne;0;0;17;17
7036;Pelenė;Saulutės;5389865440;Ne;3;0;1;4
7037;Pelenė;Saulutės;6481466282;Ne;0;0;5;5
7038;Pelenė;Saulutės;2393964666;Taip;4;5;0;9
7039;Pelenė;Saulutės;5780697554;Ne;0;6;0;6
7040;Pelenė;Saulutės;4989239822;Ne;0;5;2;7
7041;Pelenė;Saulutės;6221703608;Ne;0;0;1;1
7042;Pelenė;Saulutės;1278011268;Ne;3;0;0;3
7043;Pelenė;Saulutės;2426412323;Ne;0;0;1;1
7044;Pelenė;Saulutės;6267178572;Ne;0;10;0;10
7045;Pelenė;Raktelis;9195113444;Ne;15;7;0;22
7046;Pelenė;Raktelis;9075193730;Ne;4;0;0;4
7047;Pelenė;Raktelis;4591637887;Ne;0;2;0;2
7048;Pelenė;Raktelis;7088493729;Ne;8;0;0;8
7049;Pelenė;Raktelis;4090532624;Ne;12;6;0;18
7050;Pelenė;Raktelis;8123162647;Ne;0;9;0;9
7051;Pelenė;Raktelis;3573543545;Ne;0;5;0;5
7052;Pelenė;Raktelis;7659625628;Ne;0;0;6;6
7053;Pelenė;Raktelis;6375060159;Ne;7;7;0;14
7054;Pelenė;Raktelis;2210314952;Ne;0;3;0;3
7055;Pelenė;Raktelis;6419661741;Ne;5;2;0;7
7056;Pelenė;Raktelis;4089199552;Ne;11;10;0;21
7057;Pelenė;Raktelis;6038229659;Ne;0;0;8;8
7058;Pelenė;Raktelis;5749399210;Ne;7;0;0;7
7059;Pelenė;Raktelis;5333802902;Ne;3;9;0;12
7060;Pelenė;Raktelis;1049199372;Ne;0;2;0;2
7061;Pelenė;Raktelis;2241816838;Ne;10;0;1;11
7062;Pelenė;Raktelis;5063098703;Ne;0;0;4;4
7063;Pelenė;Raktelis;6007163187;Ne;0;0;15;15
7064;Pelenė;Žvaigždutės;9473901831;Ne;2;0;1;3
7065;Pelenė;Žvaigždutės;2476080951;Ne;0;9;0;9
7066;Pelenė;Žvaigždutės;5587759166;Ne;0;0;2;2
7067;Pelenė;Žvaigždutės;5548367924;Ne;7;0;9;16
7068;Pelenė;Žvaigždutės;5031778158;Ne;0;5;0;5
7069;Pelenė;Žvaigždutės;4056676361;Ne;0;0;3;3
7070;Pelenė;Žvaigždutės;2555464779;Ne;5;1;0;6
7071;Pelenė;Žvaigždutės;9530531472;Ne;12;6;0;18
7072;Pelenė;Žvaigždutės;2040256240;Ne;0;5;1;6
7073;Pelenė;Žvaigždutės;4870187198;Ne;0;1;0;1
7074;Pelenė;Žvaigždutės;7640768043;Ne;11;0;0;11
7075;Pelenė;Žvaigždutės;7614130590;Ne;6;5;0;11
7076;Pelenė;Žvaigždutės;4856039707;Ne;0;5;0;5
7077;Pelenė;Žvaigždutės;5894429453;Ne;0;0;1;1
7078;Pelenė;Žvaigždutės;4109516555;Ne;8;6;0;14
7079;Pelenė;Žvaigždutės;5357701072;Ne;0;0;17;17
7080;Pelenė;Nykštukas;4541391191;Ne;0;6;2;8
7081;Pelenė;Nykštukas;9584503078;Ne;0;0;11;11
7082;Pelenė;Nykštukas;8770771520;Ne;0;0;1;1
7083;Pelenė;Nykštukas;7254981715;Ne;4;5;0;9
7084;Pelenė;Nykštukas;6579504852;Ne;0;4;0;4
7085;Pelenė;Nykštukas;6021833025;Ne;0;10;0;10
7086;Pelenė;Nykštukas;1978481168;Ne;0;13;0;13
7087;Pelenė;Nykštukas;3596386480;Ne;0;2;0;2
7088;Pelenė;Nykštukas;7205437280;Ne;5;0;1;6
7089;Pelenė;Nykštukas;3189305906;Ne;7;5;0;12
7090;Pelenė;Nykštukas;1750366978;Ne;7;0;4;11
7091;Pelenė;Nykštukas;2092775878;Ne;0;9;0;9
7092;Pelenė;Nykštukas;8675348688;Ne;7;0;8;15
7093;Pelenė;Nykštukas;1142014148;Ne;0;0;3;3
7094;Pelenė;Nykštukas;1605794833;Ne;0;6;0;6
7095;Pelenė;Nykštukas;9063588699;Ne;0;9;0;9
7096;Pelenė;Nykštukas;9621197758;Ne;0;5;0;5
7097;Pelenė;Nykštukas;3296147024;Ne;0;6;0;6
7098;Pelenė;Žirniukai;8529178313;Ne;11;0;1;12
7099;Pelenė;Žirniukai;6046921077;Ne;0;0;1;1
7100;Pelenė;Žirniukai;7057752202;Ne;2;5;0;7
7101;Pelenė;Žirniukai;7399112026;Ne;0;0;8;8
7102;Pelenė;Žirniukai;2443906444;Ne;6;0;0;6
7103;Pelenė;Žirniukai;5922348478;Ne;16;0;0;16
7104;Pelenė;Žirniukai;1313425695;Ne;0;1;0;1
7105;Pelenė;Žirniukai;5211115955;Taip;0;9;7;16
7106;Pelenė;Žirniukai;1595627222;Ne;0;9;0;9
7107;Pelenė;Žirniukai;2438266396;Ne;0;6;0;6
7108;Pelenė;Žirniukai;3863839750;Ne;0;0;2;2
7109;Pelenė;Žirniukai;7383544475;Ne;0;12;0;12
7110;Pelenė;Žirniukai;6661371876;Ne;2;0;0;2
7111;Pelenė;Žirniukai;2270989478;Ne;0;20;0;20
7112;Pelenė;Žirniukai;7959433937;Ne;5;0;3;8
7113;Pelenė;Žirniukai;4703442187;Ne;3;0;0;3
7114;Pelenė;Lašeliai;9018211726;Ne;0;0;1;1
7115;Pelenė;Lašeliai;9313153383;Ne;0;8;0;8
7116;Pelenė;Lašeliai;5836118223;Ne;10;0;1;11
7117;Pelenė;Lašeliai;6316640679;Ne;5;0;6;11
7118;Pelenė;Lašeliai;1711603372;Ne;17;0;5;22
7119;Pelenė;Lašeliai;1944933777;Ne;0;15;0;15
7120;Pelenė;Lašeliai;2303618074;Ne;10;0;2;12
7121;Pelenė;Lašeliai;6167965418;Ne;5;0;1;6
7122;Pelenė;Lašeliai;2765650058;Ne;0;8;0;8
7123;Pelenė;Lašeliai;4431474395;Ne;0;4;0;4
7124;Pelenė;Lašeliai;9097123374;Ne;9;0;0;9
7125;Pelenė;Lašeliai;9162252512;Ne;0;0;7;7
7126;Pelenė;Lašeliai;4695104609;Ne;9;3;0;12
7127;Pelenė;Lašeliai;7148956863;Ne;10;2;0;12
7128;Pelenė;Lašeliai;3663288138;Ne;0;0;2;2
7129;Pelenė;Lašeliai;4148108151;Ne;0;3;0;3
7130;Pelenė;Lašeliai;1303066945;Ne;4;4;0;8
7131;Pelenė;Lašeliai;3563882751;Ne;0;12;0;12
7132;Pelenė;Grūdelis;4624325473;Ne;0;9;0;9
7133;Pelenė;Grūdelis;1902314385;Ne;0;0;1;1
7134;Pelenė;Grūdelis;1140030742;Ne;0;4;1;5
7135;Pelenė;Grūdelis;1336431888;Ne;0;0;4;4
7136;Pelenė;Grūdelis;6632188229;Ne;0;9;0;9
7137;Pelenė;Grūdelis;39705461573;Ne;0;7;0;7
7138;Pelenė;Grūdelis;2154553741;Ne;0;1;1;2
7139;Pelenė;Grūdelis;3497915398;Ne;0;1;1;2
7140;Pelenė;Grūdelis;8598498275;Ne;0;1;0;1
7141;Pelenė;Grūdelis;1710249888;Ne;0;0;2;2
7142;Pelenė;Grūdelis;5325176433;Ne;0;13;1;14
7143;Pelenė;Grūdelis;1114786936;Ne;0;0;4;4
7144;Pelenė;Grūdelis;1245955282;Ne;0;4;0;4
7145;Pelenė;Braškytė;7602432318;Ne;0;11;0;11
7146;Pelenė;Braškytė;2689903631;Ne;0;15;0;15
7147;Pelenė;Braškytė;4982869687;Ne;11;0;1;12
7148;Pelenė;Braškytė;3499827987;Ne;12;0;5;17
7149;Pelenė;Braškytė;8165766331;Ne;5;0;0;5
7150;Pelenė;Braškytė;1384382692;Ne;18;0;0;18
7151;Pelenė;Braškytė;4734502322;Ne;2;0;2;4
7152;Pelenė;Braškytė;8504675439;Ne;9;2;0;11
7153;Pelenė;Braškytė;2407328091;Ne;0;2;0;2
7154;Pelenė;Braškytė;8861981715;Ne;1;0;2;3
7155;Pelenė;Braškytė;6306403720;Ne;20;2;0;22
7156;Pelenė;Braškytė;9490816122;Ne;6;0;0;6
7157;Pelenė;Braškytė;2096373376;Ne;7;6;0;13
7158;Pelenė;Braškytė;5944620142;Ne;5;0;7;12
7159;Pelenė;Boružėlės;9639135363;Ne;4;0;1;5
7160;Pelenė;Boružėlės;1975574464;Ne;22;0;0;22
7161;Pelenė;Boružėlės;3549088727;Ne;5;0;1;6
7162;Pelenė;Boružėlės;6567413229;Ne;7;0;0;7
7163;Pelenė;Boružėlės;6231387335;Ne;2;18;0;20
7164;Pelenė;Boružėlės;3700618977;Ne;1;0;1;2
7165;Pelenė;Boružėlės;5872711862;Ne;10;0;0;10
7166;Pelenė;Boružėlės;6081335781;Ne;0;5;0;5
7167;Pelenė;Boružėlės;3060502977;Ne;0;0;1;1
7168;Pelenė;Boružėlės;2083848693;Ne;7;0;0;7
7169;Pelenė;Boružėlės;4396011355;Ne;0;0;1;1
7170;Pelenė;Boružėlės;8718308575;Ne;0;20;0;20
7171;Pelenė;Boružėlės;6867256280;Ne;0;0;6;6
7172;Pelenė;Saldainiukai;5028095861;Ne;0;0;3;3
7173;Pelenė;Saldainiukai;9505945890;Ne;5;0;0;5
7174;Pelenė;Saldainiukai;8202196292;Ne;9;0;2;11
7175;Pelenė;Saldainiukai;5066227318;Ne;7;0;1;8
7176;Pelenė;Saldainiukai;7926586349;Ne;5;0;0;5
7177;Pelenė;Saldainiukai;4305733824;Ne;4;0;2;6
7178;Pelenė;Saldainiukai;2986690431;Ne;6;0;1;7
7179;Pelenė;Saldainiukai;4660385383;Ne;9;0;0;9
7180;Pelenė;Saldainiukai;8862429244;Ne;15;0;2;17
7181;Pelenė;Saldainiukai;9969975097;Ne;6;0;0;6
7182;Pelenė;Saldainiukai;5762403752;Ne;0;8;0;8
7183;Pelenė;Saldainiukai;5926700157;Ne;5;0;0;5
7184;Pelenė;Saldainiukai;2882716674;Ne;0;0;2;2
7185;Pelenė;Saldainiukai;4859437855;Ne;0;0;9;9
7186;Pelenė;Saldainiukai;4023923887;Ne;5;0;13;18
7187;Pelenė;Saldainiukai;4521556853;Ne;2;5;0;7
7188;Pelenė;Drugeliai;2540405047;Ne;4;0;9;13
7189;Pelenė;Drugeliai;3603352172;Ne;0;0;2;2
7190;Pelenė;Drugeliai;5084452088;Ne;0;7;0;7
7191;Pelenė;Drugeliai;6834792589;Ne;0;0;1;1
7192;Pelenė;Drugeliai;9810123679;Ne;0;2;0;2
7193;Pelenė;Drugeliai;1048899958;Ne;0;0;1;1
7194;Pelenė;Drugeliai;3327213856;Ne;5;0;0;5
7195;Pelenė;Drugeliai;6252972353;Ne;0;0;1;1
7196;Pelenė;Drugeliai;1584256570;Ne;3;0;0;3
7197;Pelenė;Drugeliai;3205331614;Ne;5;0;0;5
7198;Pelenė;Drugeliai;5631629419;Ne;0;13;0;13
7199;Pelenė;Drugeliai;2163737781;Ne;0;14;0;14
7200;Pelenė;Drugeliai;9004080625;Ne;10;0;3;13
7201;Pelenė;Drugeliai;7565331966;Ne;0;10;0;10
7202;Pelenė;Drugeliai;5074054534;Ne;0;1;0;1
7203;Pelenė;Drugeliai;8194354176;Ne;0;8;3;11
7204;Pipiras;EŽIUKAI;1876870081;Ne;0;3;0;3
7205;Pipiras;EŽIUKAI;9275905384;Ne;0;7;0;7
7206;Pipiras;EŽIUKAI;41585818819;Ne;0;3;0;3
7207;Pipiras;EŽIUKAI;1391958633;Ne;0;7;0;7
7208;Pipiras;EŽIUKAI;5637557921;Ne;0;4;0;4
7209;Pipiras;EŽIUKAI;7799786844;Ne;0;8;0;8
7210;Pipiras;EŽIUKAI;5014457985;Ne;0;2;0;2
7211;Pipiras;EŽIUKAI;4927845000;Ne;6;0;0;6
7212;Pipiras;EŽIUKAI;1904376366;Ne;0;1;0;1
7213;Pipiras;EŽIUKAI;3008358842;Ne;6;5;0;11
7214;Pipiras;EŽIUKAI;2024777430;Ne;4;7;0;11
7215;Pipiras;EŽIUKAI;2402351134;Ne;0;5;0;5
7216;Pipiras;EŽIUKAI;2255644686;Ne;0;0;7;7
7217;Pipiras;EŽIUKAI;7736031786;Ne;2;3;0;5
7218;Pipiras;EŽIUKAI;4959823035;Ne;0;2;0;2
7219;Pipiras;EŽIUKAI;1128674099;Ne;0;6;0;6
7220;Pipiras;EŽIUKAI;6339186940;Ne;0;3;0;3
7221;Pipiras;EŽIUKAI;3422170541;Ne;0;4;0;4
7222;Pipiras;EŽIUKAI;3314276870;Ne;0;7;0;7
7223;Pipiras;EŽIUKAI;7784343130;Ne;0;2;0;2
7224;Pipiras;BITUTĖS;3851239592;Ne;10;2;0;12
7225;Pipiras;BITUTĖS;7891664385;Ne;0;22;0;22
7226;Pipiras;BITUTĖS;9050423801;Ne;0;5;0;5
7227;Pipiras;BITUTĖS;3794537946;Ne;0;10;0;10
7228;Pipiras;BITUTĖS;5047070127;Ne;8;0;0;8
7229;Pipiras;BITUTĖS;2645772675;Ne;0;1;0;1
7230;Pipiras;BITUTĖS;9394456452;Ne;17;0;0;17
7231;Pipiras;BITUTĖS;9610070604;Ne;2;4;0;6
7232;Pipiras;BITUTĖS;7009194986;Ne;11;1;0;12
7233;Pipiras;BITUTĖS;2887703782;Taip;0;3;0;3
7234;Pipiras;BITUTĖS;9733577233;Ne;16;0;0;16
7235;Pipiras;NYKŠTUKAI;6696824728;Taip;5;3;0;8
7236;Pipiras;NYKŠTUKAI;1169481984;Ne;3;2;1;6
7237;Pipiras;NYKŠTUKAI;4198534687;Ne;0;5;0;5
7238;Pipiras;NYKŠTUKAI;4458730479;Ne;0;0;6;6
7239;Pipiras;NYKŠTUKAI;3980950261;Ne;0;2;0;2
7240;Pipiras;NYKŠTUKAI;7828638329;Ne;0;8;0;8
7241;Pipiras;NYKŠTUKAI;6775489564;Ne;0;0;6;6
7242;Pipiras;NYKŠTUKAI;8689174023;Ne;0;1;0;1
7243;Pipiras;NYKŠTUKAI;7747049622;Ne;0;0;1;1
7244;Pipiras;NYKŠTUKAI;9892201598;Ne;5;0;0;5
7245;Pipiras;NYKŠTUKAI;7371386368;Ne;0;1;0;1
7246;Pipiras;NYKŠTUKAI;1019753152;Ne;0;3;0;3
7247;Pipiras;NYKŠTUKAI;5141447649;Ne;0;0;7;7
7248;Pipiras;NYKŠTUKAI;9248925267;Ne;0;3;0;3
7249;Pipiras;NYKŠTUKAI;9711147855;Ne;3;0;0;3
7250;Pipiras;PELĖDŽIUKAI;6342044341;Ne;5;4;0;9
7251;Pipiras;PELĖDŽIUKAI;5725956659;Ne;6;0;0;6
7252;Pipiras;PELĖDŽIUKAI;3852848863;Ne;0;2;0;2
7253;Pipiras;PELĖDŽIUKAI;3882437376;Ne;4;0;0;4
7254;Pipiras;PELĖDŽIUKAI;9157870634;Ne;0;1;0;1
7255;Pipiras;PELĖDŽIUKAI;5235868332;Ne;0;3;0;3
7256;Pipiras;PELĖDŽIUKAI;3554786173;Ne;0;2;0;2
7257;Pipiras;PELĖDŽIUKAI;1034182352;Ne;0;7;0;7
7258;Pipiras;PELĖDŽIUKAI;6792777396;Ne;0;3;0;3
7259;Pipiras;PELĖDŽIUKAI;6780333972;Ne;12;5;0;17
7260;Pipiras;PELĖDŽIUKAI;5622119207;Ne;0;1;0;1
7261;Pipiras;PELĖDŽIUKAI;7934365114;Ne;15;0;0;15
7262;Pipiras;PELĖDŽIUKAI;9770780973;Ne;16;0;1;17
7263;Pipiras;PELĖDŽIUKAI;5845498558;Ne;0;2;0;2
7264;Pipiras;PELĖDŽIUKAI;9840040112;Ne;0;6;0;6
7265;Pipiras;PELĖDŽIUKAI;1784839485;Ne;0;5;0;5
7266;Pipiras;PELĖDŽIUKAI;7350131214;Ne;0;5;0;5
7267;Pipiras;DRUGELIAI;5908707752;Ne;0;0;1;1
7268;Pipiras;DRUGELIAI;5856735452;Ne;5;2;2;9
7269;Pipiras;DRUGELIAI;2267192782;Ne;0;14;0;14
7270;Pipiras;DRUGELIAI;1045583136;Ne;2;1;0;3
7271;Pipiras;DRUGELIAI;1711168196;Ne;5;1;0;6
7272;Pipiras;DRUGELIAI;9479697733;Ne;5;5;0;10
7273;Pipiras;DRUGELIAI;4017042461;Ne;0;5;0;5
7274;Pipiras;DRUGELIAI;4725221169;Ne;5;1;0;6
7275;Pipiras;DRUGELIAI;5059203266;Ne;2;0;0;2
7276;Pipiras;DRUGELIAI;8422419380;Ne;2;1;0;3
7277;Pipiras;DRUGELIAI;6791495556;Ne;8;7;0;15
7278;Pipiras;DRUGELIAI;4811029230;Ne;0;12;0;12
7279;Pipiras;DRUGELIAI;6363349541;Ne;0;17;0;17
7280;Pipiras;DRUGELIAI;6685567970;Ne;4;2;5;11
7281;Pipiras;DRUGELIAI;1353114929;Ne;0;3;0;3
7282;Pipiras;DRUGELIAI;4426479971;Taip;0;6;0;6
7283;Pipiras;DRUGELIAI;5512049762;Ne;0;1;0;1
7284;Pipiras;GĖLYTĖS;9670710691;Ne;0;0;9;9
7285;Pipiras;GĖLYTĖS;8965139441;Ne;0;2;1;3
7286;Pipiras;GĖLYTĖS;2095794125;Ne;2;0;0;2
7287;Pipiras;GĖLYTĖS;8675473349;Ne;0;0;1;1
7288;Pipiras;GĖLYTĖS;4945164161;Ne;8;0;0;8
7289;Pipiras;GĖLYTĖS;7362002646;Ne;8;0;0;8
7290;Pipiras;GĖLYTĖS;3755824911;Ne;0;2;0;2
7291;Pipiras;GĖLYTĖS;6453274205;Ne;4;0;0;4
7292;Pipiras;GĖLYTĖS;4559954910;Ne;0;13;0;13
7293;Pipiras;GĖLYTĖS;7157187063;Ne;0;1;0;1
7294;Pipiras;GĖLYTĖS;4021613243;Ne;5;2;0;7
7295;Pipiras;GĖLYTĖS;1611488078;Ne;0;2;2;4
7296;Pipiras;GĖLYTĖS;2474548836;Taip;0;9;3;12
7297;Pipiras;GĖLYTĖS;8553422709;Ne;7;0;2;9
7298;Pipiras;GĖLYTĖS;5738334591;Ne;0;8;0;8
7299;Pipiras;GĖLYTĖS;6428525902;Ne;15;0;0;15
7300;Pipiras;GĖLYTĖS;8354158722;Ne;2;3;0;5
7301;Pipiras;BORUŽĖLĖS;4707794599;Ne;12;0;0;12
7302;Pipiras;BORUŽĖLĖS;8673271201;Ne;0;0;3;3
7303;Pipiras;BORUŽĖLĖS;5968015502;Ne;0;4;1;5
7304;Pipiras;BORUŽĖLĖS;4086728233;Ne;12;0;0;12
7305;Pipiras;BORUŽĖLĖS;8508292428;Ne;0;7;1;8
7306;Pipiras;BORUŽĖLĖS;1210940213;Ne;0;2;6;8
7307;Pipiras;BORUŽĖLĖS;8260680662;Ne;7;1;0;8
7308;Pipiras;BORUŽĖLĖS;1548928533;Ne;6;0;0;6
7309;Pipiras;BORUŽĖLĖS;9097987789;Taip;0;10;0;10
7310;Pipiras;BORUŽĖLĖS;8959946514;Taip;9;0;1;10
7311;Pipiras;BORUŽĖLĖS;9396979045;Ne;4;0;0;4
7312;Pipiras;BORUŽĖLĖS;1146369304;Ne;0;1;0;1
7313;Pipiras;BORUŽĖLĖS;9970587185;Ne;0;1;3;4
7314;Pipiras;BORUŽĖLĖS;6034298583;Ne;0;4;5;9
7315;Pipiras;BORUŽĖLĖS;1550959705;Ne;0;0;4;4
7316;Pipiras;BORUŽĖLĖS;9425682286;Ne;0;5;0;5
7317;Pipiras;SKRUZDĖLIUKAI;7969837759;Ne;0;4;0;4
7318;Pipiras;SKRUZDĖLIUKAI;2483867901;Ne;9;3;0;12
7319;Pipiras;SKRUZDĖLIUKAI;1315372873;Ne;0;13;0;13
7320;Pipiras;SKRUZDĖLIUKAI;9372109848;Ne;6;0;3;9
7321;Pipiras;SKRUZDĖLIUKAI;9968182443;Ne;2;0;0;2
7322;Pipiras;SKRUZDĖLIUKAI;2296702730;Ne;0;0;10;10
7323;Pipiras;SKRUZDĖLIUKAI;3768825314;Ne;12;0;1;13
7324;Pipiras;SKRUZDĖLIUKAI;5888429623;Ne;0;3;0;3
7325;Pipiras;SKRUZDĖLIUKAI;2399588759;Ne;0;3;0;3
7326;Pipiras;SKRUZDĖLIUKAI;8081343184;Ne;22;0;0;22
7327;Pipiras;SKRUZDĖLIUKAI;9852475056;Ne;22;0;0;22
7328;Pipiras;SKRUZDĖLIUKAI;6176818802;Ne;0;0;3;3
7329;Pipiras;SKRUZDĖLIUKAI;1215623527;Ne;0;1;0;1
7330;Pipiras;SKRUZDĖLIUKAI;1998249512;Taip;9;0;1;10
7331;Pipiras;SKRUZDĖLIUKAI;9625933545;Ne;0;1;0;1
7332;Pipiras;SKRUZDĖLIUKAI;7211189491;Ne;0;1;0;1
7333;Pipiras;ŽVIRBLIUKŲ;1242260242;Ne;6;0;0;6
7334;Pipiras;ŽVIRBLIUKŲ;4266424785;Ne;0;6;0;6
7335;Pipiras;ŽVIRBLIUKŲ;3421769229;Ne;0;1;0;1
7336;Pipiras;ŽVIRBLIUKŲ;8520454289;Ne;0;2;0;2
7337;Pipiras;ŽVIRBLIUKŲ;5422547144;Ne;0;3;0;3
7338;Pipiras;ŽVIRBLIUKŲ;1144813356;Ne;0;0;3;3
7339;Pipiras;ŽVIRBLIUKŲ;6694920607;Ne;0;8;0;8
7340;Pipiras;ŽVIRBLIUKŲ;3141822820;Ne;0;7;0;7
7341;Pipiras;ŽVIRBLIUKŲ;7870521230;Ne;12;0;0;12
7342;Pipiras;ŽVIRBLIUKŲ;4428216634;Ne;0;0;2;2
7343;Pipiras;ŽVIRBLIUKŲ;5502001191;Ne;0;0;1;1
7344;Pipiras;ŽVIRBLIUKŲ;5778300856;Ne;0;0;6;6
7345;Pipiras;ŽVIRBLIUKŲ;7026118693;Ne;0;2;0;2
7346;Pipiras;ŽVIRBLIUKŲ;1391682850;Ne;7;0;5;12
7347;Pipiras;ŽVIRBLIUKŲ;87924002679;Ne;5;4;0;9
7348;Pipiras;ŽVIRBLIUKŲ;4496076326;Ne;0;0;2;2
7349;Pipiras;ZUIKUČIŲ;3641496225;Ne;0;7;0;7
7350;Pipiras;ZUIKUČIŲ;6925577945;Ne;0;7;2;9
7351;Pipiras;ZUIKUČIŲ;9639609431;Ne;2;0;0;2
7352;Pipiras;ZUIKUČIŲ;2159315426;Ne;2;0;0;2
7353;Pipiras;ZUIKUČIŲ;8404246568;Ne;4;1;0;5
7354;Pipiras;ZUIKUČIŲ;7200147039;Ne;2;4;0;6
7355;Pipiras;ZUIKUČIŲ;5035593032;Ne;2;0;6;8
7356;Pipiras;ZUIKUČIŲ;6361544649;Ne;2;1;0;3
7357;Pipiras;ZUIKUČIŲ;1079088070;Ne;2;1;0;3
7358;Pipiras;ZUIKUČIŲ;4743474665;Ne;17;6;0;23
7359;Pipiras;ZUIKUČIŲ;9422467047;Ne;0;0;6;6
7360;Pipiras;ZUIKUČIŲ;4991725638;Ne;0;0;4;4
7361;Pipiras;ZUIKUČIŲ;9552763906;Ne;3;0;0;3
7362;Pipiras;VARLIUKŲ;7446225835;Ne;5;2;1;8
7363;Pipiras;VARLIUKŲ;8800890503;Ne;10;0;0;10
7364;Pipiras;VARLIUKŲ;6184943213;Ne;4;2;0;6
7365;Pipiras;VARLIUKŲ;8028360748;Ne;0;1;0;1
7366;Pipiras;VARLIUKŲ;1238280105;Ne;0;3;0;3
7367;Pipiras;VARLIUKŲ;3299099535;Ne;2;2;0;4
7368;Pipiras;VARLIUKŲ;8364783015;Ne;15;7;0;22
7369;Pipiras;VARLIUKŲ;5502186385;Ne;0;0;1;1
7370;Pipiras;VARLIUKŲ;8707560610;Ne;7;0;0;7
7371;Pipiras;VARLIUKŲ;4940053409;Ne;20;0;0;20
7372;Pipiras;VARLIUKŲ;2588075386;Ne;7;0;0;7
7373;Pipiras;VARLIUKŲ;6666112357;Ne;2;0;0;2
7374;Pipiras;VARLIUKŲ;9473056714;Ne;7;15;0;22
7375;Pipiras;VARLIUKŲ;8040520887;Ne;0;1;0;1
7376;Pipiras;ŽIOGELIŲ;7510719254;Ne;10;0;0;10
7377;Pipiras;ŽIOGELIŲ;7802812858;Ne;15;1;0;16
7378;Pipiras;ŽIOGELIŲ;8697732892;Ne;11;0;0;11
7379;Pipiras;ŽIOGELIŲ;1466527534;Ne;0;0;9;9
7380;Pipiras;ŽIOGELIŲ;1172225661;Ne;7;0;1;8
7381;Pipiras;ŽIOGELIŲ;3825960148;Ne;0;7;6;13
7382;Pipiras;ŽIOGELIŲ;9747219629;Ne;20;1;0;21
7383;Pipiras;ŽIOGELIŲ;8445608419;Taip;7;0;0;7
7384;Pipiras;ŽIOGELIŲ;6602780166;Ne;7;0;0;7
7385;Pipiras;ŽIOGELIŲ;4229548366;Ne;7;0;0;7
7386;Pipiras;ŽIOGELIŲ;8666908143;Ne;0;2;9;11
7387;Pipiras;ŽIOGELIŲ;4083110785;Ne;7;0;0;7
7388;Pipiras;ŽIOGELIŲ;2784222529;Ne;9;0;5;14
7389;"Prie pasakų parko";ZUIKUČIAI;8493622886;Ne;21;0;0;21
7390;"Prie pasakų parko";ZUIKUČIAI;3998970024;Ne;5;2;0;7
7391;"Prie pasakų parko";ZUIKUČIAI;3907016976;Ne;7;0;4;11
7392;"Prie pasakų parko";ZUIKUČIAI;4904562817;Taip;10;0;0;10
7393;"Prie pasakų parko";ZUIKUČIAI;9659710840;Ne;11;0;0;11
7394;"Prie pasakų parko";ZUIKUČIAI;8781483295;Ne;7;0;1;8
7395;"Prie pasakų parko";ZUIKUČIAI;5394554484;Ne;2;0;0;2
7396;"Prie pasakų parko";ZUIKUČIAI;9707694441;Taip;7;0;0;7
7397;"Prie pasakų parko";ZUIKUČIAI;7220229641;Ne;9;3;0;12
7398;"Prie pasakų parko";ZUIKUČIAI;8616467675;Ne;14;3;0;17
7399;"Prie pasakų parko";ZUIKUČIAI;8215496569;Ne;5;0;0;5
7400;"Prie pasakų parko";ZUIKUČIAI;9742058853;Ne;5;0;1;6
7401;"Prie pasakų parko";PAUKŠČIUKŲ;4860316199;Ne;9;0;0;9
7402;"Prie pasakų parko";PAUKŠČIUKŲ;3907578461;Ne;10;0;0;10
7403;"Prie pasakų parko";PAUKŠČIUKŲ;7330033315;Ne;5;0;0;5
7404;"Prie pasakų parko";PAUKŠČIUKŲ;9061639276;Ne;3;0;1;4
7405;"Prie pasakų parko";PAUKŠČIUKŲ;6601363351;Ne;4;5;0;9
7406;"Prie pasakų parko";PAUKŠČIUKŲ;9784398441;Ne;9;0;0;9
7407;"Prie pasakų parko";PAUKŠČIUKŲ;4891232161;Ne;4;5;0;9
7408;"Prie pasakų parko";PAUKŠČIUKŲ;9550985822;Ne;6;2;0;8
7409;"Prie pasakų parko";PAUKŠČIUKŲ;5737517940;Ne;7;0;3;10
7410;"Prie pasakų parko";PAUKŠČIUKŲ;7693728136;Taip;5;1;0;6
7411;"Prie pasakų parko";PAUKŠČIUKŲ;3717956257;Ne;10;0;1;11
7412;"Prie pasakų parko";"LINKSMOJI ŠEIMYNĖLĖ (SPEC)";2820889357;Ne;7;4;0;11
7413;"Prie pasakų parko";"LINKSMOJI ŠEIMYNĖLĖ (SPEC)";29445903073;Ne;0;0;2;2
7414;"Prie pasakų parko";"LINKSMOJI ŠEIMYNĖLĖ (SPEC)";1549137154;Ne;7;0;0;7
7415;"Prie pasakų parko";"LINKSMOJI ŠEIMYNĖLĖ (SPEC)";9469871636;Ne;0;0;2;2
7416;"Prie pasakų parko";"LINKSMOJI ŠEIMYNĖLĖ (SPEC)";5641148690;Ne;12;2;0;14
7417;"Prie pasakų parko";"LINKSMOJI ŠEIMYNĖLĖ (SPEC)";9594976173;Ne;3;0;0;3
7418;"Prie pasakų parko";"LINKSMOJI ŠEIMYNĖLĖ (SPEC)";1828638638;Ne;5;0;2;7
7419;"Prie pasakų parko";"LINKSMOJI ŠEIMYNĖLĖ (SPEC)";5356005675;Ne;0;0;3;3
7420;"Prie pasakų parko";"LINKSMOJI ŠEIMYNĖLĖ (SPEC)";9789977863;Ne;6;0;2;8
7421;"Prie pasakų parko";NYKŠTUKŲ;2287711014;Ne;0;0;2;2
7422;"Prie pasakų parko";NYKŠTUKŲ;6491435655;Ne;0;7;0;7
7423;"Prie pasakų parko";NYKŠTUKŲ;1743429440;Ne;0;10;0;10
7424;"Prie pasakų parko";NYKŠTUKŲ;1811994592;Taip;0;0;2;2
7425;"Prie pasakų parko";NYKŠTUKŲ;7739970115;Ne;2;0;6;8
7426;"Prie pasakų parko";NYKŠTUKŲ;6700916147;Ne;8;0;0;8
7427;"Prie pasakų parko";NYKŠTUKŲ;4674683653;Taip;3;0;1;4
7428;"Prie pasakų parko";NYKŠTUKŲ;2515928623;Ne;0;0;1;1
7429;"Prie pasakų parko";NYKŠTUKŲ;4726737519;Taip;4;0;0;4
7430;"Prie pasakų parko";NYKŠTUKŲ;1316127369;Ne;5;0;0;5
7431;"Prie pasakų parko";NYKŠTUKŲ;2654978735;Ne;22;0;0;22
7432;"Prie pasakų parko";NYKŠTUKŲ;2661900328;Ne;0;3;0;3
7433;"Prie pasakų parko";NYKŠTUKŲ;3202292611;Ne;0;0;1;1
7434;"Prie pasakų parko";NYKŠTUKŲ;9225775914;Ne;0;5;0;5
7435;"Prie pasakų parko";LAŠELIŲ;6865751947;Ne;0;0;3;3
7436;"Prie pasakų parko";LAŠELIŲ;6992830082;Ne;0;0;2;2
7437;"Prie pasakų parko";LAŠELIŲ;1588062393;Ne;2;0;3;5
7438;"Prie pasakų parko";LAŠELIŲ;1278065349;Ne;0;0;3;3
7439;"Prie pasakų parko";LAŠELIŲ;4548803933;Ne;0;0;1;1
7440;"Prie pasakų parko";LAŠELIŲ;6250610187;Ne;0;6;0;6
7441;"Prie pasakų parko";LAŠELIŲ;9190379838;Ne;6;0;5;11
7442;"Prie pasakų parko";LAŠELIŲ;8215830508;Ne;2;3;0;5
7443;"Prie pasakų parko";LAŠELIŲ;2216634402;Ne;0;0;1;1
7444;"Prie pasakų parko";LAŠELIŲ;8849417734;Ne;2;0;1;3
7445;"Prie pasakų parko";LAŠELIŲ;7545372781;Ne;0;0;3;3
7446;"Prie pasakų parko";LAŠELIŲ;2731544174;Ne;6;0;1;7
7447;"Prie pasakų parko";LAŠELIŲ;5494350183;Ne;0;4;0;4
7448;"Prie pasakų parko";"KAČIUKAI (SPEC)";6772736175;Ne;15;0;0;15
7449;"Prie pasakų parko";"KAČIUKAI (SPEC)";5847625697;Ne;0;0;7;7
7450;"Prie pasakų parko";"KAČIUKAI (SPEC)";2590693851;Ne;0;0;1;1
7451;"Prie pasakų parko";"KAČIUKAI (SPEC)";3949671257;Ne;10;0;0;10
7452;"Prie pasakų parko";"KAČIUKAI (SPEC)";2583331243;Ne;0;0;3;3
7453;"Prie pasakų parko";"KAČIUKAI (SPEC)";1370201372;Ne;0;0;5;5
7454;"Prie pasakų parko";"ŽVAIGŽDUTĖS  (SPEC)";7216751216;Ne;15;0;0;15
7455;"Prie pasakų parko";"ŽVAIGŽDUTĖS  (SPEC)";4037594669;Ne;0;0;1;1
7456;"Prie pasakų parko";"ŽVAIGŽDUTĖS  (SPEC)";9072312203;Ne;8;0;0;8
7457;"Prie pasakų parko";"ŽVAIGŽDUTĖS  (SPEC)";5006152810;Ne;5;0;0;5
7458;"Prie pasakų parko";"ŽVAIGŽDUTĖS  (SPEC)";6989235061;Ne;12;0;8;20
7459;"Prie pasakų parko";"ŽVAIGŽDUTĖS  (SPEC)";6585504578;Taip;17;0;1;18
7460;"Prie pasakų parko";"ŽVAIGŽDUTĖS  (SPEC)";8203595449;Ne;5;0;5;10
7461;"Prie pasakų parko";"ŽVAIGŽDUTĖS  (SPEC)";7476984763;Ne;12;0;4;16
7462;"Prie pasakų parko";"ANČIUKAI (SPEC)";8339335908;Ne;2;0;7;9
7463;"Prie pasakų parko";"ANČIUKAI (SPEC)";6802898184;Ne;0;0;1;1
7464;"Prie pasakų parko";"ANČIUKAI (SPEC)";9529949992;Ne;0;0;4;4
7465;"Prie pasakų parko";"ANČIUKAI (SPEC)";4309482351;Ne;5;8;0;13
7466;"Prie pasakų parko";"ANČIUKAI (SPEC)";2263419475;Ne;0;0;5;5
7467;"Prie pasakų parko";"ANČIUKAI (SPEC)";7200571639;Ne;5;0;4;9
7468;"Prie pasakų parko";"ANČIUKAI (SPEC)";2047018335;Ne;0;0;1;1
7469;"Prie pasakų parko";"ANČIUKAI (SPEC)";2731902356;Ne;7;0;5;12
7470;"Prie pasakų parko";"ANČIUKAI (SPEC)";5627477370;Ne;8;0;4;12
7471;"Prie pasakų parko";TIGRIUKAI;7858530013;Ne;10;5;0;15
7472;"Prie pasakų parko";TIGRIUKAI;3918269702;Taip;6;0;6;12
7473;"Prie pasakų parko";TIGRIUKAI;6446562388;Ne;0;2;0;2
7474;"Prie pasakų parko";TIGRIUKAI;2168919559;Ne;0;3;0;3
7475;"Prie pasakų parko";TIGRIUKAI;8899375521;Ne;7;0;2;9
7476;"Prie pasakų parko";TIGRIUKAI;6561145380;Ne;8;0;4;12
7477;"Prie pasakų parko";TIGRIUKAI;8029428034;Ne;0;4;0;4
7478;"Prie pasakų parko";TIGRIUKAI;8715851643;Ne;0;0;1;1
7479;"Prie pasakų parko";TIGRIUKAI;3617673265;Ne;0;0;1;1
7480;"Prie pasakų parko";TIGRIUKAI;1704679306;Ne;0;0;1;1
7481;"Prie pasakų parko";TIGRIUKAI;7776961789;Ne;0;0;6;6
7482;"Prie pasakų parko";TIGRIUKAI;8285260113;Ne;0;0;6;6
7483;"Prie pasakų parko";TIGRIUKAI;3373275644;Ne;14;1;0;15
7484;"Prie pasakų parko";TIGRIUKAI;8406002339;Ne;0;0;3;3
7485;"Prie pasakų parko";"EŽIUKŲ (SPEC)";2952868428;Ne;4;0;2;6
7486;"Prie pasakų parko";"EŽIUKŲ (SPEC)";5944113879;Ne;9;0;2;11
7487;"Prie pasakų parko";"EŽIUKŲ (SPEC)";4950143153;Ne;0;0;6;6
7488;"Prie pasakų parko";"EŽIUKŲ (SPEC)";4799789212;Ne;5;0;7;12
7489;"Prie pasakų parko";"EŽIUKŲ (SPEC)";5834070970;Ne;5;0;4;9
7490;"Prie pasakų parko";"EŽIUKŲ (SPEC)";3579773269;Ne;5;1;0;6
7491;"Prie pasakų parko";"BORUŽIUKŲ (SPEC)";9715586563;Ne;0;10;4;14
7492;"Prie pasakų parko";"BORUŽIUKŲ (SPEC)";6215345468;Ne;0;0;5;5
7493;"Prie pasakų parko";"BORUŽIUKŲ (SPEC)";7000191099;Ne;0;0;1;1
7494;"Prie pasakų parko";"BORUŽIUKŲ (SPEC)";2104412442;Ne;0;0;1;1
7495;"Prie pasakų parko";SAULYTĖS;6762267582;Ne;5;0;1;6
7496;"Prie pasakų parko";SAULYTĖS;4351705573;Ne;0;0;1;1
7497;"Prie pasakų parko";SAULYTĖS;7390391804;Ne;1;0;0;1
7498;"Prie pasakų parko";SAULYTĖS;8685140364;Taip;12;6;0;18
7499;"Prie pasakų parko";SAULYTĖS;6606867989;Ne;3;0;2;5
7500;"Prie pasakų parko";SAULYTĖS;2206221105;Ne;3;5;0;8
7501;"Prie pasakų parko";SAULYTĖS;3038164555;Taip;0;7;4;11
7502;"Prie pasakų parko";SAULYTĖS;4183640714;Ne;22;0;0;22
7503;"Pumpurėlis (Kalvarijų g. 186)";RAMUNĖLIŲ;7610949816;Ne;4;0;1;5
7504;"Pumpurėlis (Kalvarijų g. 186)";RAMUNĖLIŲ;6977710645;Ne;10;0;2;12
7505;"Pumpurėlis (Kalvarijų g. 186)";RAMUNĖLIŲ;9431295796;Ne;0;0;7;7
7506;"Pumpurėlis (Kalvarijų g. 186)";RAMUNĖLIŲ;1395380236;Ne;0;3;0;3
7507;"Pumpurėlis (Kalvarijų g. 186)";RAMUNĖLIŲ;9424449290;Ne;8;3;0;11
7508;"Pumpurėlis (Kalvarijų g. 186)";RAMUNĖLIŲ;6955168163;Ne;13;0;2;15
7509;"Pumpurėlis (Kalvarijų g. 186)";RAMUNĖLIŲ;5171198109;Ne;10;0;0;10
7510;"Pumpurėlis (Kalvarijų g. 186)";RAMUNĖLIŲ;9726028397;Ne;0;0;1;1
7511;"Pumpurėlis (Kalvarijų g. 186)";RAMUNĖLIŲ;7229289985;Ne;2;12;1;15
7512;"Pumpurėlis (Kalvarijų g. 186)";RAMUNĖLIŲ;2969734731;Ne;0;0;3;3
7513;"Pumpurėlis (Kalvarijų g. 186)";RAMUNĖLIŲ;7559071945;Ne;0;1;0;1
7514;"Pumpurėlis (Kalvarijų g. 186)";RAMUNĖLIŲ;3953103488;Taip;0;5;0;5
7515;"Pumpurėlis (Kalvarijų g. 186)";RAMUNĖLIŲ;6511527480;Ne;0;4;0;4
7516;"Pumpurėlis (Kalvarijų g. 186)";RAMUNĖLIŲ;3838705973;Ne;10;0;2;12
7517;"Pumpurėlis (Kalvarijų g. 186)";RAMUNĖLIŲ;6726875853;Ne;0;6;4;10
7518;"Pumpurėlis (Kalvarijų g. 186)";RAMUNĖLIŲ;8667762689;Ne;10;0;2;12
7519;"Pumpurėlis (Kalvarijų g. 186)";RAMUNĖLIŲ;3874188848;Ne;15;0;0;15
7520;"Pumpurėlis (Kalvarijų g. 186)";RAMUNĖLIŲ;2233224512;Ne;0;10;0;10
7521;"Pumpurėlis (Kalvarijų g. 186)";RAMUNĖLIŲ;7619709360;Ne;0;0;1;1
7522;"Pumpurėlis (Kalvarijų g. 186)";VARPELIŲ;3101133244;Ne;0;2;1;3
7523;"Pumpurėlis (Kalvarijų g. 186)";VARPELIŲ;3893768713;Ne;0;13;0;13
7524;"Pumpurėlis (Kalvarijų g. 186)";VARPELIŲ;5023658988;Ne;0;2;4;6
7525;"Pumpurėlis (Kalvarijų g. 186)";VARPELIŲ;2668855786;Ne;0;7;0;7
7526;"Pumpurėlis (Kalvarijų g. 186)";VARPELIŲ;8258560345;Ne;0;3;0;3
7527;"Pumpurėlis (Kalvarijų g. 186)";VARPELIŲ;9612924972;Ne;0;2;0;2
7528;"Pumpurėlis (Kalvarijų g. 186)";VARPELIŲ;9884099545;Taip;6;5;0;11
7529;"Pumpurėlis (Kalvarijų g. 186)";VARPELIŲ;3733509497;Ne;0;0;2;2
7530;"Pumpurėlis (Kalvarijų g. 186)";VARPELIŲ;9552913910;Ne;0;0;7;7
7531;"Pumpurėlis (Kalvarijų g. 186)";VARPELIŲ;5196733185;Ne;7;0;1;8
7532;"Pumpurėlis (Kalvarijų g. 186)";VARPELIŲ;4928495108;Ne;0;0;4;4
7533;"Pumpurėlis (Kalvarijų g. 186)";VARPELIŲ;8886730333;Ne;5;0;0;5
7534;"Pumpurėlis (Kalvarijų g. 186)";VARPELIŲ;2247300456;Ne;0;7;0;7
7535;"Pumpurėlis (Kalvarijų g. 186)";VARPELIŲ;5564680653;Ne;0;0;7;7
7536;"Pumpurėlis (Kalvarijų g. 186)";VARPELIŲ;1411232443;Ne;0;10;0;10
7537;"Pumpurėlis (Kalvarijų g. 186)";VARPELIŲ;8525537588;Ne;0;0;1;1
7538;"Pumpurėlis (Kalvarijų g. 186)";VARPELIŲ;2103139845;Ne;0;0;2;2
7539;"Pumpurėlis (Kalvarijų g. 186)";VARPELIŲ;6780042929;Ne;0;22;0;22
7540;"Pumpurėlis (Kalvarijų g. 186)";VARPELIŲ;7182107790;Ne;14;0;0;14
7541;"Pumpurėlis (Kalvarijų g. 186)";VARPELIŲ;4629544683;Ne;7;3;0;10
7542;"Pumpurėlis (Kalvarijų g. 186)";VARPELIŲ;9224879966;Ne;4;0;1;5
7543;"Pumpurėlis (Kalvarijų g. 186)";DRUGELIŲ;5928552565;Ne;7;0;1;8
7544;"Pumpurėlis (Kalvarijų g. 186)";DRUGELIŲ;5897036076;Ne;0;5;3;8
7545;"Pumpurėlis (Kalvarijų g. 186)";DRUGELIŲ;7055989095;Ne;0;16;0;16
7546;"Pumpurėlis (Kalvarijų g. 186)";DRUGELIŲ;7078621340;Ne;5;2;0;7
7547;"Pumpurėlis (Kalvarijų g. 186)";DRUGELIŲ;1538548768;Ne;12;0;2;14
7548;"Pumpurėlis (Kalvarijų g. 186)";DRUGELIŲ;2368226822;Ne;10;0;5;15
7549;"Pumpurėlis (Kalvarijų g. 186)";DRUGELIŲ;3088476130;Ne;0;0;2;2
7550;"Pumpurėlis (Kalvarijų g. 186)";DRUGELIŲ;9640790401;Taip;0;0;4;4
7551;"Pumpurėlis (Kalvarijų g. 186)";DRUGELIŲ;8320987208;Ne;5;6;1;12
7552;"Pumpurėlis (Kalvarijų g. 186)";DRUGELIŲ;7832408524;Ne;0;5;0;5
7553;"Pumpurėlis (Kalvarijų g. 186)";DRUGELIŲ;8644853849;Ne;3;3;0;6
7554;"Pumpurėlis (Kalvarijų g. 186)";DRUGELIŲ;9417688597;Ne;0;0;4;4
7555;"Pumpurėlis (Kalvarijų g. 186)";DRUGELIŲ;9032255874;Ne;0;0;14;14
7556;"Pumpurėlis (Kalvarijų g. 186)";DRUGELIŲ;9996789041;Ne;0;0;3;3
7557;"Pumpurėlis (Kalvarijų g. 186)";DRUGELIŲ;2684592319;Ne;5;0;0;5
7558;"Pumpurėlis (Kalvarijų g. 186)";DRUGELIŲ;5835115428;Ne;0;0;5;5
7559;"Pumpurėlis (Kalvarijų g. 186)";DRUGELIŲ;2132563531;Ne;10;0;0;10
7560;"Pumpurėlis (Kalvarijų g. 186)";DRUGELIŲ;4506063812;Ne;0;4;6;10
7561;"Pumpurėlis (Kalvarijų g. 186)";DRUGELIŲ;2165141865;Ne;0;0;3;3
7562;"Pumpurėlis (Kalvarijų g. 186)";DRUGELIŲ;8671697745;Ne;0;0;9;9
7563;"Pumpurėlis (Kalvarijų g. 186)";DRUGELIŲ;3187815703;Ne;0;0;18;18
7564;"Pumpurėlis (Kalvarijų g. 186)";KODĖLČIUKŲ;8214602054;Ne;0;0;12;12
7565;"Pumpurėlis (Kalvarijų g. 186)";KODĖLČIUKŲ;9654958302;Ne;0;0;1;1
7566;"Pumpurėlis (Kalvarijų g. 186)";KODĖLČIUKŲ;5564844211;Ne;10;8;0;18
7567;"Pumpurėlis (Kalvarijų g. 186)";KODĖLČIUKŲ;1215117598;Ne;7;2;0;9
7568;"Pumpurėlis (Kalvarijų g. 186)";KODĖLČIUKŲ;6978091765;Ne;8;0;5;13
7569;"Pumpurėlis (Kalvarijų g. 186)";KODĖLČIUKŲ;6433757421;Ne;2;0;5;7
7570;"Pumpurėlis (Kalvarijų g. 186)";KODĖLČIUKŲ;3328647987;Ne;0;0;1;1
7571;"Pumpurėlis (Kalvarijų g. 186)";KODĖLČIUKŲ;3748601124;Ne;6;0;0;6
7572;"Pumpurėlis (Kalvarijų g. 186)";KODĖLČIUKŲ;6004234378;Ne;8;0;2;10
7573;"Pumpurėlis (Kalvarijų g. 186)";KODĖLČIUKŲ;4196409137;Ne;8;0;0;8
7574;"Pumpurėlis (Kalvarijų g. 186)";KODĖLČIUKŲ;6117720533;Ne;0;0;3;3
7575;"Pumpurėlis (Kalvarijų g. 186)";KODĖLČIUKŲ;8070486897;Ne;10;0;3;13
7576;"Pumpurėlis (Kalvarijų g. 186)";KODĖLČIUKŲ;3534133061;Ne;3;1;1;5
7577;"Pumpurėlis (Kalvarijų g. 186)";KODĖLČIUKŲ;2611141763;Ne;0;0;3;3
7578;"Pumpurėlis (Kalvarijų g. 186)";KODĖLČIUKŲ;9650395309;Ne;3;0;0;3
7579;"Pumpurėlis (Kalvarijų g. 186)";KODĖLČIUKŲ;3563609848;Ne;22;0;0;22
7580;"Pumpurėlis (Kalvarijų g. 186)";KODĖLČIUKŲ;6702744879;Ne;0;0;4;4
7581;"Pumpurėlis (Kalvarijų g. 186)";KODĖLČIUKŲ;2890596967;Ne;11;0;2;13
7582;"Pumpurėlis (Kalvarijų g. 186)";KODĖLČIUKŲ;9839285886;Taip;0;7;0;7
7583;"Pumpurėlis (Kalvarijų g. 186)";LINELIS;1017483419;Ne;4;7;0;11
7584;"Pumpurėlis (Kalvarijų g. 186)";LINELIS;6957047759;Ne;0;8;0;8
7585;"Pumpurėlis (Kalvarijų g. 186)";LINELIS;1492810528;Ne;0;5;0;5
7586;"Pumpurėlis (Kalvarijų g. 186)";LINELIS;1835168438;Ne;0;0;1;1
7587;"Pumpurėlis (Kalvarijų g. 186)";LINELIS;5615260965;Ne;0;2;0;2
7588;"Pumpurėlis (Kalvarijų g. 186)";LINELIS;3298821054;Ne;0;0;3;3
7589;"Pumpurėlis (Kalvarijų g. 186)";LINELIS;8830261792;Ne;0;1;0;1
7590;"Pumpurėlis (Kalvarijų g. 186)";LINELIS;8806961007;Ne;0;5;0;5
7591;"Pumpurėlis (Kalvarijų g. 186)";LINELIS;18928851032;Ne;0;1;0;1
7592;"Pumpurėlis (Kalvarijų g. 186)";LINELIS;8747439652;Ne;0;0;1;1
7593;"Pumpurėlis (Kalvarijų g. 186)";LINELIS;5964953923;Ne;0;0;2;2
7594;"Pumpurėlis (Kalvarijų g. 186)";SAULUTĖS;3751769136;Ne;3;0;0;3
7595;"Pumpurėlis (Kalvarijų g. 186)";SAULUTĖS;7488342792;Ne;0;0;2;2
7596;"Pumpurėlis (Kalvarijų g. 186)";SAULUTĖS;2129779614;Ne;0;0;2;2
7597;"Pumpurėlis (Kalvarijų g. 186)";SAULUTĖS;1053338730;Ne;5;0;1;6
7598;"Pumpurėlis (Kalvarijų g. 186)";SAULUTĖS;7123915287;Ne;0;0;9;9
7599;"Pumpurėlis (Kalvarijų g. 186)";SAULUTĖS;83388662869;Ne;2;0;0;2
7600;"Pumpurėlis (Kalvarijų g. 186)";SAULUTĖS;1397924008;Ne;0;0;1;1
7601;"Pumpurėlis (Kalvarijų g. 186)";SAULUTĖS;6230500803;Ne;0;3;5;8
7602;"Pumpurėlis (Kalvarijų g. 186)";SAULUTĖS;1306102772;Ne;5;0;5;10
7603;"Pumpurėlis (Kalvarijų g. 186)";SAULUTĖS;1230058211;Ne;0;7;0;7
7604;"Pumpurėlis (Kalvarijų g. 186)";SAULUTĖS;6535398274;Ne;0;0;10;10
7605;"Pumpurėlis (Kalvarijų g. 186)";SAULUTĖS;1261919194;Ne;0;0;1;1
7606;"Pumpurėlis (Kalvarijų g. 186)";SAULUTĖS;9733380187;Ne;0;1;0;1
7607;"Pumpurėlis (Kalvarijų g. 186)";SAULUTĖS;2102427499;Ne;5;1;0;6
7608;"Pumpurėlis (Kalvarijų g. 186)";SAULUTĖS;1225377038;Ne;0;2;0;2
7609;"Pumpurėlis (Kalvarijų g. 186)";SAULUTĖS;9317495169;Ne;0;7;0;7
7610;"Pumpurėlis (Kalvarijų g. 186)";BITUTĖS;4419940231;Ne;7;8;0;15
7611;"Pumpurėlis (Kalvarijų g. 186)";BITUTĖS;4985045047;Ne;5;0;1;6
7612;"Pumpurėlis (Kalvarijų g. 186)";BITUTĖS;2651037375;Ne;5;0;0;5
7613;"Pumpurėlis (Kalvarijų g. 186)";BITUTĖS;1768239820;Ne;6;0;6;12
7614;"Pumpurėlis (Kalvarijų g. 186)";BITUTĖS;2566557351;Taip;5;0;1;6
7615;"Pumpurėlis (Kalvarijų g. 186)";BITUTĖS;7363814444;Ne;0;8;0;8
7616;"Pumpurėlis (Kalvarijų g. 186)";BITUTĖS;3405169131;Ne;0;0;2;2
7617;"Pumpurėlis (Kalvarijų g. 186)";BITUTĖS;3951445693;Ne;0;0;9;9
7618;"Pumpurėlis (Kalvarijų g. 186)";BITUTĖS;9612924316;Ne;0;3;0;3
7619;"Pumpurėlis (Kalvarijų g. 186)";BITUTĖS;8655389224;Ne;3;1;0;4
7620;"Pumpurėlis (Kalvarijų g. 186)";BITUTĖS;1674341906;Taip;5;0;0;5
7621;"Pumpurėlis (Kalvarijų g. 186)";BITUTĖS;1933502038;Ne;0;1;0;1
7622;"Pumpurėlis (Kalvarijų g. 186)";BITUTĖS;2230191718;Ne;3;0;0;3
7623;"Pumpurėlis (Kalvarijų g. 186)";BITUTĖS;7062090879;Ne;0;0;2;2
7624;"Pumpurėlis (Kalvarijų g. 186)";BITUTĖS;9245739052;Ne;0;2;0;2
7625;"Pumpurėlis (Kalvarijų g. 186)";BITUTĖS;8470433743;Ne;5;0;17;22
7626;"Pumpurėlis (Kalvarijų g. 186)";BITUTĖS;6474918016;Ne;0;1;0;1
7627;"Pumpurėlis (Kalvarijų g. 186)";DOBILIUKAI;1839505206;Ne;0;5;0;5
7628;"Pumpurėlis (Kalvarijų g. 186)";DOBILIUKAI;3970253545;Ne;0;0;2;2
7629;"Pumpurėlis (Kalvarijų g. 186)";DOBILIUKAI;1808734330;Ne;0;1;0;1
7630;"Pumpurėlis (Kalvarijų g. 186)";DOBILIUKAI;6968264923;Ne;5;6;0;11
7631;"Pumpurėlis (Kalvarijų g. 186)";DOBILIUKAI;7038597556;Ne;0;11;0;11
7632;"Pumpurėlis (Kalvarijų g. 186)";DOBILIUKAI;4130539703;Ne;4;0;0;4
7633;"Pumpurėlis (Kalvarijų g. 186)";DOBILIUKAI;6307988067;Ne;0;2;0;2
7634;"Pumpurėlis (Kalvarijų g. 186)";DOBILIUKAI;3374174445;Ne;0;1;0;1
7635;"Pumpurėlis (Kalvarijų g. 186)";DOBILIUKAI;1961282282;Ne;6;0;1;7
7636;"Pumpurėlis (Kalvarijų g. 186)";DOBILIUKAI;7276322999;Ne;0;3;0;3
7637;"Pumpurėlis (Kalvarijų g. 186)";DOBILIUKAI;3214652626;Ne;0;0;1;1
7638;"Pumpurėlis (Kalvarijų g. 186)";DOBILIUKAI;5444879430;Ne;5;1;3;9
7639;"Pumpurėlis (Kalvarijų g. 186)";DOBILIUKAI;7825190756;Ne;0;0;4;4
7640;"Pumpurėlis (Kalvarijų g. 186)";DOBILIUKAI;1438740562;Ne;0;3;0;3
7641;"Pumpurėlis (Kalvarijų g. 186)";DOBILIUKAI;9740660699;Ne;17;1;0;18
7642;"Pumpurėlis (Kalvarijų g. 186)";PUPYČIŲ;7652642088;Ne;7;0;0;7
7643;"Pumpurėlis (Kalvarijų g. 186)";PUPYČIŲ;9317274035;Ne;14;0;0;14
7644;"Pumpurėlis (Kalvarijų g. 186)";PUPYČIŲ;1555441484;Ne;14;0;0;14
7645;"Pumpurėlis (Kalvarijų g. 186)";PUPYČIŲ;9052267552;Ne;0;0;1;1
7646;"Pumpurėlis (Kalvarijų g. 186)";PUPYČIŲ;9372725707;Ne;1;0;0;1
7647;"Pumpurėlis (Kalvarijų g. 186)";PUPYČIŲ;4249039048;Ne;0;2;2;4
7648;"Pumpurėlis (Kalvarijų g. 186)";PUPYČIŲ;1082775039;Ne;0;0;1;1
7649;"Pumpurėlis (Kalvarijų g. 186)";PUPYČIŲ;6982600785;Ne;6;0;3;9
7650;"Pumpurėlis (Kalvarijų g. 186)";PUPYČIŲ;1667602636;Ne;14;0;3;17
7651;"Pumpurėlis (Kalvarijų g. 186)";PUPYČIŲ;8212403350;Ne;0;0;3;3
7652;"Pumpurėlis (Kalvarijų g. 186)";PUPYČIŲ;6795405194;Ne;0;0;4;4
7653;"Pumpurėlis (Kalvarijų g. 186)";PUPYČIŲ;7443152469;Ne;0;0;22;22
7654;"Pumpurėlis (Kalvarijų g. 186)";PUPYČIŲ;9306426978;Ne;0;0;7;7
7655;"Pumpurėlis (Kalvarijų g. 186)";PUPYČIŲ;3259416263;Ne;15;0;0;15
7656;"Pumpurėlis (Kalvarijų g. 186)";PUPYČIŲ;6939412463;Ne;0;7;3;10
7657;"Pumpurėlis (Kalvarijų g. 186)";PUPYČIŲ;2715059752;Ne;0;0;2;2
7658;"Pumpurėlis (Kalvarijų g. 186)";PUPYČIŲ;8458676611;Taip;0;0;4;4
7659;"Pumpurėlis (Kalvarijų g. 186)";ŽIRNIUKŲ;3537534154;Ne;0;7;0;7
7660;"Pumpurėlis (Kalvarijų g. 186)";ŽIRNIUKŲ;1782842327;Ne;13;1;0;14
7661;"Pumpurėlis (Kalvarijų g. 186)";ŽIRNIUKŲ;9478685443;Ne;0;2;0;2
7662;"Pumpurėlis (Kalvarijų g. 186)";ŽIRNIUKŲ;6647331393;Ne;7;0;1;8
7663;"Pumpurėlis (Kalvarijų g. 186)";ŽIRNIUKŲ;3001331278;Ne;4;0;0;4
7664;"Pumpurėlis (Kalvarijų g. 186)";ŽIRNIUKŲ;9735493140;Ne;3;0;1;4
7665;"Pumpurėlis (Kalvarijų g. 186)";ŽIRNIUKŲ;3964441086;Ne;11;0;0;11
7666;"Pumpurėlis (Kalvarijų g. 186)";ŽIRNIUKŲ;8550119831;Ne;0;4;3;7
7667;"Pumpurėlis (Kalvarijų g. 186)";ŽIRNIUKŲ;4245270154;Ne;5;0;1;6
7668;"Pumpurėlis (Kalvarijų g. 186)";ŽIRNIUKŲ;6860128064;Ne;5;1;1;7
7669;"Pumpurėlis (Kalvarijų g. 186)";ŽIRNIUKŲ;5968577443;Ne;5;0;4;9
7670;"Pumpurėlis (Kalvarijų g. 186)";ŽIRNIUKŲ;8083674991;Ne;5;0;0;5
7671;"Pumpurėlis (Kalvarijų g. 186)";ŽIRNIUKŲ;9750242149;Ne;8;1;1;10
7672;"Pumpurėlis (Kalvarijų g. 186)";ŽIRNIUKŲ;5420222684;Ne;3;1;0;4
7673;"Pumpurėlis (Kalvarijų g. 186)";ŽIRNIUKŲ;4198532140;Ne;3;0;3;6
7674;"Pumpurėlis (Kalvarijų g. 186)";ŽIRNIUKŲ;6422203618;Ne;14;0;0;14
7675;"Pumpurėlis (Kalvarijų g. 186)";BORUŽĖLIŲ;2269864490;Ne;3;0;0;3
7676;"Pumpurėlis (Kalvarijų g. 186)";BORUŽĖLIŲ;6223338814;Ne;0;0;4;4
7677;"Pumpurėlis (Kalvarijų g. 186)";BORUŽĖLIŲ;5659508302;Ne;0;2;0;2
7678;"Pumpurėlis (Kalvarijų g. 186)";BORUŽĖLIŲ;5998858670;Ne;0;0;3;3
7679;"Pumpurėlis (Kalvarijų g. 186)";BORUŽĖLIŲ;7398363498;Ne;0;2;0;2
7680;"Pumpurėlis (Kalvarijų g. 186)";BORUŽĖLIŲ;5835545051;Ne;0;0;1;1
7681;"Pumpurėlis (Kalvarijų g. 186)";BORUŽĖLIŲ;4188020534;Ne;0;0;1;1
7682;"Pumpurėlis (Kalvarijų g. 186)";BORUŽĖLIŲ;6256781298;Ne;12;3;0;15
7683;"Pumpurėlis (Kalvarijų g. 186)";BORUŽĖLIŲ;9136771401;Ne;0;0;5;5
7684;"Pumpurėlis (Kalvarijų g. 186)";BORUŽĖLIŲ;7045349032;Ne;4;4;2;10
7685;"Pumpurėlis (Kalvarijų g. 186)";BORUŽĖLIŲ;1017838338;Ne;6;0;3;9
7686;"Pumpurėlis (Kalvarijų g. 186)";BORUŽĖLIŲ;7535098093;Ne;0;0;2;2
7687;"Pumpurėlis (Kalvarijų g. 186)";BORUŽĖLIŲ;7843280418;Ne;0;0;5;5
7688;"Pumpurėlis (Kalvarijų g. 186)";BORUŽĖLIŲ;3531862496;Ne;0;1;0;1
7689;"Pumpurėlis (Kalvarijų g. 186)";BORUŽĖLIŲ;1441993078;Ne;0;0;8;8
7690;"Pumpurėlis (Kalvarijų g. 186)";BORUŽĖLIŲ;2768082342;Ne;0;0;11;11
7691;"Pumpurėlis (Kalvarijų g. 186)";BORUŽĖLIŲ;3407251558;Ne;0;0;3;3
7692;"Pumpurėlis (Kalvarijų g. 186)";BORUŽĖLIŲ;4355867863;Ne;0;0;2;2
7693;"Pumpurėlis (Kalvarijų g. 186)";SMALSUČIŲ;6212212516;Ne;0;0;9;9
7694;"Pumpurėlis (Kalvarijų g. 186)";SMALSUČIŲ;6604801631;Ne;9;0;0;9
7695;"Pumpurėlis (Kalvarijų g. 186)";SMALSUČIŲ;6988369637;Ne;0;0;1;1
7696;"Pumpurėlis (Kalvarijų g. 186)";SMALSUČIŲ;9363610488;Ne;0;3;1;4
7697;"Pumpurėlis (Kalvarijų g. 186)";SMALSUČIŲ;8380689261;Ne;6;0;0;6
7698;"Pumpurėlis (Kalvarijų g. 186)";SMALSUČIŲ;6483338028;Ne;4;0;2;6
7699;"Pumpurėlis (Kalvarijų g. 186)";SMALSUČIŲ;3492977569;Ne;0;0;3;3
7700;"Pumpurėlis (Kalvarijų g. 186)";SMALSUČIŲ;6959214331;Ne;0;2;4;6
7701;"Pumpurėlis (Kalvarijų g. 186)";SMALSUČIŲ;3085309902;Ne;6;0;0;6
7702;"Pumpurėlis (Kalvarijų g. 186)";SMALSUČIŲ;4964949574;Ne;0;0;1;1
7703;"Pumpurėlis (Kalvarijų g. 186)";SMALSUČIŲ;2905797053;Ne;15;0;0;15
7704;"Pumpurėlis (Kalvarijų g. 186)";SMALSUČIŲ;2026021360;Ne;9;0;1;10
7705;"Pumpurėlis (Kalvarijų g. 186)";SMALSUČIŲ;6557857672;Ne;12;0;1;13
7706;"Pumpurėlis (Kalvarijų g. 186)";SMALSUČIŲ;5212827184;Ne;6;0;0;6
7707;"Pumpurėlis (Kalvarijų g. 186)";SMALSUČIŲ;7813696919;Ne;0;0;5;5
7708;"Pumpurėlis (Kalvarijų g. 186)";SMALSUČIŲ;5236515914;Ne;0;2;0;2
7709;"Pumpurėlis (Kalvarijų g. 186)";SMALSUČIŲ;5456922203;Ne;10;0;0;10
7710;Puriena;Ančiukų;1658720269;Ne;6;0;0;6
7711;Puriena;Ančiukų;6158842119;Ne;0;4;0;4
7712;Puriena;Ančiukų;4100466337;Ne;10;0;5;15
7713;Puriena;Ančiukų;3681811493;Ne;0;1;0;1
7714;Puriena;Ančiukų;4060087185;Ne;0;0;6;6
7715;Puriena;Ančiukų;6280465748;Ne;0;2;2;4
7716;Puriena;Ančiukų;3033562627;Ne;12;8;0;20
7717;Puriena;Ančiukų;5777076971;Ne;12;8;0;20
7718;Puriena;Ančiukų;8310231540;Ne;2;2;0;4
7719;Puriena;Ančiukų;4460575818;Ne;0;10;0;10
7720;Puriena;Ančiukų;8120597514;Ne;7;0;0;7
7721;Puriena;Ančiukų;7967288875;Ne;0;0;16;16
7722;Puriena;Ančiukų;5336923102;Ne;0;1;0;1
7723;Puriena;Ančiukų;1907429094;Ne;0;0;7;7
7724;Puriena;Ančiukų;4605662701;Ne;0;5;0;5
7725;Puriena;Ančiukų;1819876614;Ne;0;0;5;5
7726;Puriena;Ančiukų;4776745276;Ne;9;1;0;10
7727;Puriena;Ančiukų;7769252165;Ne;0;2;1;3
7728;Puriena;Ančiukų;3772941726;Ne;0;14;0;14
7729;Puriena;Ančiukų;1428098802;Ne;0;14;0;14
7730;Puriena;Drugeliai;4760827000;Ne;0;0;1;1
7731;Puriena;Drugeliai;4812271011;Ne;0;22;0;22
7732;Puriena;Drugeliai;1521955898;Ne;0;2;3;5
7733;Puriena;Drugeliai;5478026060;Ne;0;5;2;7
7734;Puriena;Drugeliai;6914613438;Ne;0;1;0;1
7735;Puriena;Drugeliai;8159342676;Ne;2;0;1;3
7736;Puriena;Drugeliai;1121312813;Ne;0;4;0;4
7737;Puriena;Drugeliai;2321753665;Ne;0;8;0;8
7738;Puriena;Drugeliai;7021756459;Ne;22;0;0;22
7739;Puriena;Drugeliai;9098291788;Ne;0;5;0;5
7740;Puriena;Drugeliai;6613654824;Ne;0;0;12;12
7741;Puriena;Drugeliai;3738277048;Ne;0;13;0;13
7742;Puriena;Drugeliai;3579008577;Ne;2;5;0;7
7743;Puriena;Drugeliai;7477278612;Ne;0;9;0;9
7744;Puriena;Drugeliai;9847768390;Ne;7;5;3;15
7745;Puriena;Drugeliai;1455237224;Ne;0;1;2;3
7746;Puriena;Drugeliai;6212693015;Ne;15;4;0;19
7747;Puriena;Drugeliai;5593526943;Ne;7;1;0;8
7748;Puriena;Pelėdžiukai;2013783668;Ne;10;0;0;10
7749;Puriena;Pelėdžiukai;8874823029;Ne;0;6;0;6
7750;Puriena;Pelėdžiukai;3149718901;Ne;0;4;3;7
7751;Puriena;Pelėdžiukai;9041388275;Ne;5;2;0;7
7752;Puriena;Pelėdžiukai;8061605125;Ne;15;0;0;15
7753;Puriena;Pelėdžiukai;2579402981;Ne;0;0;5;5
7754;Puriena;Pelėdžiukai;3671297035;Ne;5;0;1;6
7755;Puriena;Pelėdžiukai;2701942325;Ne;0;3;0;3
7756;Puriena;Pelėdžiukai;2267225709;Taip;0;1;3;4
7757;Puriena;Pelėdžiukai;4858971990;Ne;3;2;5;10
7758;Puriena;Pelėdžiukai;1417566073;Ne;0;1;0;1
7759;Puriena;Pelėdžiukai;6463129806;Ne;0;0;3;3
7760;Puriena;Pelėdžiukai;5341228269;Ne;0;9;0;9
7761;Puriena;Pelėdžiukai;6352605894;Ne;0;0;1;1
7762;Puriena;Pelėdžiukai;6786694796;Ne;4;0;2;6
7763;Puriena;Pelėdžiukai;8952508230;Ne;13;0;2;15
7764;Puriena;Pelėdžiukai;5080805225;Ne;14;0;0;14
7765;Puriena;Pelėdžiukai;1158768017;Ne;0;1;0;1
7766;Puriena;Voveriukai;9911792407;Ne;5;2;0;7
7767;Puriena;Voveriukai;3826282438;Ne;5;0;1;6
7768;Puriena;Voveriukai;9453994213;Ne;1;0;1;2
7769;Puriena;Voveriukai;8497070167;Taip;5;0;1;6
7770;Puriena;Voveriukai;4517020977;Ne;0;0;3;3
7771;Puriena;Voveriukai;4283608124;Ne;0;0;3;3
7772;Puriena;Voveriukai;8144488922;Ne;0;0;1;1
7773;Puriena;Voveriukai;8476986855;Ne;3;3;0;6
7774;Puriena;Voveriukai;3627403517;Ne;0;0;5;5
7775;Puriena;Voveriukai;2813562677;Ne;4;2;0;6
7776;Puriena;Voveriukai;4653085762;Ne;1;12;2;15
7777;Puriena;Voveriukai;3542374463;Ne;0;2;0;2
7778;Puriena;Voveriukai;1933733714;Ne;0;1;0;1
7779;Puriena;Voveriukai;6150437624;Ne;0;3;0;3
7780;Puriena;Voveriukai;8772936125;Ne;0;0;9;9
7781;Puriena;Voveriukai;6428413592;Ne;17;0;0;17
7782;Puriena;Voveriukai;4498919764;Ne;4;0;1;5
7783;Puriena;Voveriukai;9729644429;Ne;0;1;0;1
7784;Puriena;Voveriukai;6140294839;Ne;7;0;2;9
7785;Puriena;Voveriukai;3455291312;Ne;10;5;0;15
7786;Puriena;Voveriukai;7066959314;Ne;0;0;1;1
7787;Puriena;Bitučių;1621772702;Ne;0;0;4;4
7788;Puriena;Bitučių;9413672989;Ne;0;0;9;9
7789;Puriena;Bitučių;5224135638;Ne;0;0;11;11
7790;Puriena;Bitučių;1175665781;Ne;0;0;2;2
7791;Puriena;Bitučių;9962011647;Ne;0;0;22;22
7792;Puriena;Bitučių;1339162214;Ne;0;2;7;9
7793;Puriena;Bitučių;9543884311;Ne;0;3;0;3
7794;Puriena;Bitučių;8022809059;Ne;1;0;0;1
7795;Puriena;Bitučių;5395382717;Ne;2;1;2;5
7796;Puriena;Bitučių;8237149969;Ne;0;1;0;1
7797;Puriena;Bitučių;7481642656;Ne;0;22;0;22
7798;Puriena;Bitučių;8512814466;Ne;0;7;0;7
7799;Puriena;Bitučių;4017644414;Ne;0;1;6;7
7800;Puriena;Bitučių;1295692895;Ne;0;0;1;1
7801;Puriena;Bitučių;8416003733;Ne;0;2;0;2
7802;Puriena;Bitučių;8199607793;Ne;0;0;18;18
7803;Puriena;Bitučių;9854244405;Ne;0;2;1;3
7804;Puriena;Bitučių;6780164845;Ne;3;0;0;3
7805;Puriena;Zylutės;7337038503;Ne;4;0;0;4
7806;Puriena;Zylutės;5891404983;Ne;0;10;0;10
7807;Puriena;Zylutės;63196502622;Ne;11;0;0;11
7808;Puriena;Zylutės;9239618299;Ne;0;18;0;18
7809;Puriena;Zylutės;2083071198;Ne;6;9;0;15
7810;Puriena;Zylutės;20286870431;Ne;8;2;0;10
7811;Puriena;Zylutės;8618298134;Ne;0;18;0;18
7812;Puriena;Zylutės;1748337587;Ne;7;0;0;7
7813;Puriena;Zylutės;1820719083;Ne;0;0;1;1
7814;Puriena;Zylutės;11497629767;Ne;0;2;0;2
7815;Puriena;Zylutės;2146036332;Ne;0;5;0;5
7816;Puriena;Zylutės;2378865002;Ne;0;3;0;3
7817;Puriena;Zylutės;2131343339;Ne;8;3;0;11
7818;Puriena;Zylutės;8213725698;Ne;9;1;0;10
7819;Puriena;Zylutės;8707076857;Ne;7;0;2;9
7820;Puriena;Zylutės;48468411549;Ne;0;2;2;4
7821;Puriena;Zylutės;1703078658;Ne;11;0;0;11
7822;Puriena;Zylutės;6416145396;Ne;0;0;4;4
7823;Puriena;Zylutės;3031725530;Ne;0;0;7;7
7824;Puriena;Zylutės;6813480086;Ne;6;2;1;9
7825;Puriena;Meškučių;6234132927;Ne;0;2;9;11
7826;Puriena;Meškučių;3153330970;Ne;15;1;0;16
7827;Puriena;Meškučių;9500729561;Ne;8;0;0;8
7828;Puriena;Meškučių;1238475246;Ne;0;2;8;10
7829;Puriena;Meškučių;5591189546;Ne;6;6;0;12
7830;Puriena;Meškučių;9748726934;Ne;5;9;0;14
7831;Puriena;Meškučių;7466163131;Ne;0;7;0;7
7832;Puriena;Meškučių;2466609635;Ne;9;2;8;19
7833;Puriena;Meškučių;3309219271;Ne;0;6;0;6
7834;Puriena;Meškučių;9509041179;Ne;0;0;7;7
7835;Puriena;Meškučių;5176663365;Ne;7;1;0;8
7836;Puriena;Meškučių;9961074983;Ne;11;0;0;11
7837;Puriena;Meškučių;3011629747;Ne;5;0;1;6
7838;Puriena;Meškučių;2029981617;Ne;4;1;0;5
7839;Puriena;Meškučių;6185080390;Ne;8;2;5;15
7840;Puriena;Meškučių;3526684967;Ne;7;2;1;10
7841;Puriena;Meškučių;1513909923;Ne;10;0;10;20
7842;Puriena;Meškučių;7556975480;Ne;2;4;4;10
7843;Puriena;Meškučių;8093664167;Taip;0;1;0;1
7844;Puriena;Nykštukų;5469827031;Taip;5;0;0;5
7845;Puriena;Nykštukų;7649596096;Taip;0;0;6;6
7846;Puriena;Nykštukų;2762325241;Ne;10;1;3;14
7847;Puriena;Nykštukų;9907142348;Ne;0;0;6;6
7848;Puriena;Nykštukų;9369786639;Ne;0;0;1;1
7849;Puriena;Nykštukų;2344061847;Taip;0;1;2;3
7850;Puriena;Nykštukų;9438604106;Ne;4;10;0;14
7851;Puriena;Nykštukų;9379314578;Ne;21;0;0;21
7852;Puriena;Nykštukų;1610219365;Taip;8;1;0;9
7853;Puriena;Nykštukų;2146727759;Ne;0;2;0;2
7854;Puriena;Nykštukų;1988826809;Ne;0;0;2;2
7855;Puriena;Nykštukų;6605817147;Ne;5;0;0;5
7856;Puriena;Nykštukų;6271951373;Ne;0;0;2;2
7857;Puriena;Nykštukų;7869104640;Ne;4;1;0;5
7858;Puriena;Ežiukai;6451492815;Ne;0;1;0;1
7859;Puriena;Ežiukai;6612468095;Ne;10;4;0;14
7860;Puriena;Ežiukai;7913847170;Ne;10;0;0;10
7861;Puriena;Ežiukai;8089081251;Ne;10;0;0;10
7862;Puriena;Ežiukai;2830409862;Ne;7;6;0;13
7863;Puriena;Ežiukai;5550321808;Ne;7;1;0;8
7864;Puriena;Ežiukai;8038573068;Ne;7;1;0;8
7865;Puriena;Ežiukai;2624283930;Ne;0;3;0;3
7866;Puriena;Ežiukai;6001659356;Ne;6;0;0;6
7867;Puriena;Ežiukai;5539708916;Ne;2;11;0;13
7868;Puriena;Ežiukai;7335537384;Ne;5;0;0;5
7869;Puriena;Ežiukai;3204824116;Ne;7;0;5;12
7870;Puriena;Ežiukai;4954787474;Ne;15;0;0;15
7871;Puriena;Ežiukai;7720549981;Ne;17;0;0;17
7872;Puriena;Ežiukai;5555076926;Ne;7;5;0;12
7873;Puriena;Ežiukai;2312297583;Ne;0;9;6;15
7874;Puriena;Ežiukai;3232981406;Ne;7;7;0;14
7875;Puriena;Ežiukai;9228372078;Ne;21;0;0;21
7876;Puriena;Ežiukai;5374864513;Ne;14;0;1;15
7877;Puriena;Ežiukai;1737249860;Ne;0;1;0;1
7878;Puriena;Ežiukai;6991740430;Ne;0;2;0;2
7879;Puriena;"Boružiukų ";9600515308;Ne;7;0;3;10
7880;Puriena;"Boružiukų ";7985332838;Ne;0;22;0;22
7881;Puriena;"Boružiukų ";9671916745;Ne;5;0;0;5
7882;Puriena;"Boružiukų ";8195902319;Ne;4;6;0;10
7883;Puriena;"Boružiukų ";4587892949;Ne;22;0;0;22
7884;Puriena;"Boružiukų ";9497287421;Ne;5;0;5;10
7885;Puriena;"Boružiukų ";2818282875;Ne;0;1;1;2
7886;Puriena;"Boružiukų ";3215364967;Ne;0;1;2;3
7887;Puriena;"Boružiukų ";7016498639;Ne;2;0;1;3
7888;Puriena;"Boružiukų ";5797970231;Ne;9;2;0;11
7889;Puriena;"Boružiukų ";3382737176;Ne;14;0;0;14
7890;Puriena;"Boružiukų ";8110665629;Ne;5;6;0;11
7891;Puriena;"Boružiukų ";4006267650;Ne;8;7;0;15
7892;Puriena;"Boružiukų ";3440488785;Ne;0;0;8;8
7893;Puriena;"Boružiukų ";4016228982;Ne;5;0;0;5
7894;Puriena;"Boružiukų ";1796123753;Ne;7;0;2;9
7895;Puriena;"Boružiukų ";5277351784;Ne;7;0;0;7
7896;Puriena;"Boružiukų ";9931397038;Ne;5;0;5;10
7897;Puriena;"Zuikučių ";3252190329;Ne;4;0;3;7
7898;Puriena;"Zuikučių ";9907972536;Taip;15;2;0;17
7899;Puriena;"Zuikučių ";4165800035;Ne;5;0;3;8
7900;Puriena;"Zuikučių ";7634536770;Ne;3;1;0;4
7901;Puriena;"Zuikučių ";9423229931;Ne;0;3;0;3
7902;Puriena;"Zuikučių ";8284860687;Ne;0;1;0;1
7903;Puriena;"Zuikučių ";7334787183;Ne;0;1;4;5
7904;Puriena;"Zuikučių ";9176303276;Ne;0;15;3;18
7905;Puriena;"Zuikučių ";6941251095;Ne;22;0;0;22
7906;Puriena;"Zuikučių ";4193710604;Ne;0;0;2;2
7907;Puriena;"Zuikučių ";8474426340;Ne;17;0;0;17
7908;Puriena;"Zuikučių ";6227990580;Ne;19;0;0;19
7909;Puriena;"Zuikučių ";2172109284;Ne;4;2;0;6
7910;Puriena;"Zuikučių ";8239919265;Taip;5;0;0;5
7911;Puriena;"Zuikučių ";3094722037;Ne;7;0;0;7
7912;Puriena;"Zuikučių ";6308393533;Ne;10;2;2;14
7913;Puriena;"Zuikučių ";5927216569;Ne;15;0;0;15
7914;Puriena;Skruzdėliukai;2203259310;Ne;7;0;0;7
7915;Puriena;Skruzdėliukai;8478901457;Ne;2;2;0;4
7916;Puriena;Skruzdėliukai;4647433927;Ne;0;22;0;22
7917;Puriena;Skruzdėliukai;5257713434;Ne;0;22;0;22
7918;Puriena;Skruzdėliukai;6285846517;Ne;0;0;1;1
7919;Puriena;Skruzdėliukai;6053657231;Ne;0;1;1;2
7920;Puriena;Skruzdėliukai;9139110598;Ne;0;2;1;3
7921;Puriena;Skruzdėliukai;5501308683;Ne;0;3;2;5
7922;Puriena;Skruzdėliukai;2663832596;Ne;0;2;0;2
7923;Puriena;Skruzdėliukai;6057477307;Ne;0;0;2;2
7924;Puriena;Skruzdėliukai;4966293604;Ne;0;0;5;5
7925;Puriena;Skruzdėliukai;1381379515;Ne;5;1;0;6
7926;Puriena;Skruzdėliukai;1290962809;Ne;0;1;0;1
7927;Puriena;Skruzdėliukai;23746358787;Ne;0;1;0;1
7928;Puriena;Skruzdėliukai;1263637124;Ne;0;5;0;5
7929;Puriena;Skruzdėliukai;1290933817;Ne;4;0;0;4
7930;Puriena;Skruzdėliukai;8112003551;Ne;4;0;0;4
7931;Pušaitė;Kodėlčiukai;8702361596;Ne;4;0;0;4
7932;Pušaitė;Kodėlčiukai;3832434608;Ne;0;9;0;9
7933;Pušaitė;Kodėlčiukai;7068451014;Ne;0;12;1;13
7934;Pušaitė;Kodėlčiukai;8750774616;Ne;0;2;1;3
7935;Pušaitė;Kodėlčiukai;4198571222;Ne;1;0;2;3
7936;Pušaitė;Kodėlčiukai;9391350218;Ne;0;8;0;8
7937;Pušaitė;Kodėlčiukai;2793941689;Ne;0;4;2;6
7938;Pušaitė;Kodėlčiukai;9364887123;Ne;0;1;0;1
7939;Pušaitė;Kodėlčiukai;4326967247;Ne;5;0;0;5
7940;Pušaitė;Kodėlčiukai;5922053969;Ne;0;5;1;6
7941;Pušaitė;Kodėlčiukai;4473930703;Ne;0;1;5;6
7942;Pušaitė;Kodėlčiukai;6775428321;Ne;0;0;4;4
7943;Pušaitė;Kodėlčiukai;4615270419;Ne;0;2;0;2
7944;Pušaitė;Kodėlčiukai;7117784038;Ne;7;2;0;9
7945;Pušaitė;Kodėlčiukai;2253477550;Ne;0;1;0;1
7946;Pušaitė;Kodėlčiukai;6115556675;Taip;2;0;0;2
7947;Pušaitė;Saulutės;4511258460;Ne;7;1;5;13
7948;Pušaitė;Saulutės;5422616450;Ne;0;0;1;1
7949;Pušaitė;Saulutės;7237345427;Ne;4;0;0;4
7950;Pušaitė;Saulutės;5819186055;Ne;5;0;3;8
7951;Pušaitė;Saulutės;8931688329;Ne;17;0;0;17
7952;Pušaitė;Saulutės;5981944481;Ne;3;3;0;6
7953;Pušaitė;Saulutės;2254269292;Ne;0;0;7;7
7954;Pušaitė;Saulutės;5306237557;Ne;22;0;0;22
7955;Pušaitė;Saulutės;4234318548;Ne;0;5;4;9
7956;Pušaitė;Saulutės;4883211957;Ne;0;22;0;22
7957;Pušaitė;Saulutės;1384820994;Ne;3;1;0;4
7958;Pušaitė;Saulutės;7480846917;Ne;0;6;1;7
7959;Pušaitė;Saulutės;7291412329;Ne;7;0;2;9
7960;Pušaitė;Saulutės;2543188867;Ne;5;0;0;5
7961;Pušaitė;Saulutės;9577925438;Ne;5;0;1;6
7962;Pušaitė;Saulutės;8914668904;Ne;2;0;2;4
7963;Pušaitė;Zuikučiai;2115591523;Ne;0;5;9;14
7964;Pušaitė;Zuikučiai;8738827821;Ne;0;1;2;3
7965;Pušaitė;Zuikučiai;7477429922;Ne;5;3;0;8
7966;Pušaitė;Zuikučiai;6306133416;Ne;0;6;1;7
7967;Pušaitė;Zuikučiai;6355379926;Ne;0;6;0;6
7968;Pušaitė;Zuikučiai;80743691769;Ne;11;0;1;12
7969;Pušaitė;Zuikučiai;1296700534;Ne;0;1;3;4
7970;Pušaitė;Zuikučiai;51500717235;Ne;0;15;0;15
7971;Pušaitė;Zuikučiai;2125574493;Ne;0;1;0;1
7972;Pušaitė;Zuikučiai;5398532705;Ne;0;0;6;6
7973;Pušaitė;Zuikučiai;4881689337;Ne;0;7;0;7
7974;Pušaitė;Zuikučiai;3718196299;Ne;0;0;1;1
7975;Pušaitė;Zuikučiai;1295203136;Ne;5;0;0;5
7976;Pušaitė;Zuikučiai;2944418714;Ne;1;1;1;3
7977;Pušaitė;Zuikučiai;3813761666;Ne;5;1;8;14
7978;Pušaitė;Zuikučiai;4762094720;Ne;0;1;0;1
7979;Pušaitė;Zuikučiai;6600314608;Ne;7;0;2;9
7980;Pušaitė;Zuikučiai;2130767942;Ne;0;9;3;12
7981;Pušaitė;Zuikučiai;9179757395;Ne;3;0;13;16
7982;Pušaitė;Zuikučiai;8592426606;Ne;0;1;0;1
7983;Pušaitė;Zuikučiai;7251064118;Ne;0;0;4;4
7984;Pušaitė;Vėžliukai;8412276797;Ne;5;0;0;5
7985;Pušaitė;Vėžliukai;1326581025;Ne;0;12;0;12
7986;Pušaitė;Vėžliukai;8135552679;Ne;0;10;0;10
7987;Pušaitė;Vėžliukai;5161142520;Ne;9;0;1;10
7988;Pušaitė;Vėžliukai;3485234259;Ne;0;1;0;1
7989;Pušaitė;Vėžliukai;3014867515;Ne;2;0;4;6
7990;Pušaitė;Vėžliukai;9414554800;Ne;4;6;0;10
7991;Pušaitė;Vėžliukai;9470667227;Ne;0;1;0;1
7992;Pušaitė;Vėžliukai;6739253961;Ne;0;10;0;10
7993;Pušaitė;Vėžliukai;3014180020;Ne;0;0;1;1
7994;Pušaitė;Vėžliukai;7890577174;Ne;0;2;0;2
7995;Pušaitė;Vėžliukai;7652706756;Ne;0;7;0;7
7996;Pušaitė;Vėžliukai;5318602924;Ne;0;22;0;22
7997;Pušaitė;Vėžliukai;6794867560;Ne;0;5;0;5
7998;Pušaitė;Vėžliukai;5296435012;Ne;0;8;0;8
7999;Pušaitė;Vėžliukai;6833083982;Ne;0;0;5;5
8000;Pušaitė;Vėžliukai;5512786073;Ne;5;0;0;5
8001;Pušaitė;Vėžliukai;8399589954;Ne;0;1;0;1
8002;Pušaitė;Vėžliukai;2777222076;Ne;4;6;0;10
8003;Pušaitė;Vėžliukai;8459530338;Ne;0;3;0;3
8004;Pušaitė;"Linksmieji nykštukai";9265357004;Ne;0;1;0;1
8005;Pušaitė;"Linksmieji nykštukai";3150144924;Ne;5;1;0;6
8006;Pušaitė;"Linksmieji nykštukai";7520393710;Ne;0;0;5;5
8007;Pušaitė;"Linksmieji nykštukai";4517181474;Ne;0;2;0;2
8008;Pušaitė;"Linksmieji nykštukai";9033615485;Ne;8;7;1;16
8009;Pušaitė;"Linksmieji nykštukai";3130824742;Ne;3;1;0;4
8010;Pušaitė;"Linksmieji nykštukai";1024996364;Ne;0;0;1;1
8011;Pušaitė;"Linksmieji nykštukai";4662871524;Ne;0;1;0;1
8012;Pušaitė;"Linksmieji nykštukai";8438652029;Ne;3;0;3;6
8013;Pušaitė;"Linksmieji nykštukai";6578483902;Ne;0;10;6;16
8014;Pušaitė;"Linksmieji nykštukai";3350461304;Ne;2;7;0;9
8015;Pušaitė;"Linksmieji nykštukai";9327636862;Ne;0;2;1;3
8016;Pušaitė;"Linksmieji nykštukai";4175909754;Ne;4;0;5;9
8017;Pušaitė;"Linksmieji nykštukai";3788392895;Ne;10;1;0;11
8018;Pušaitė;"Linksmieji nykštukai";3195191374;Ne;0;2;0;2
8019;Pušaitė;"Linksmieji nykštukai";9127444013;Ne;0;2;0;2
8020;Pušaitė;"Linksmieji nykštukai";5422784898;Ne;9;2;0;11
8021;Pušaitė;"Linksmieji nykštukai";5104111840;Ne;5;6;0;11
8022;Pušaitė;"Linksmieji nykštukai";9866431097;Ne;1;2;0;3
8023;Pušaitė;"Linksmieji nykštukai";4374232593;Ne;6;8;0;14
8024;Pušaitė;"Linksmieji nykštukai";8378313810;Ne;0;1;0;1
8025;Pušaitė;"Kačiukų trobelė";3695016765;Ne;10;0;0;10
8026;Pušaitė;"Kačiukų trobelė";1122112207;Ne;0;10;0;10
8027;Pušaitė;"Kačiukų trobelė";8793102437;Ne;4;10;0;14
8028;Pušaitė;"Kačiukų trobelė";9056933586;Ne;5;4;0;9
8029;Pušaitė;"Kačiukų trobelė";6323180798;Ne;0;1;1;2
8030;Pušaitė;"Kačiukų trobelė";1161519408;Ne;2;15;0;17
8031;Pušaitė;"Kačiukų trobelė";8822285103;Ne;0;2;0;2
8032;Pušaitė;"Kačiukų trobelė";9313564235;Ne;0;2;0;2
8033;Pušaitė;"Kačiukų trobelė";2865062081;Ne;5;1;0;6
8034;Pušaitė;"Kačiukų trobelė";1978339054;Ne;0;2;0;2
8035;Pušaitė;"Kačiukų trobelė";6189116357;Ne;11;0;3;14
8036;Pušaitė;Ežiukai;2090143259;Ne;0;1;0;1
8037;Pušaitė;Ežiukai;2951618391;Ne;0;1;0;1
8038;Pušaitė;Ežiukai;9524002395;Ne;0;6;0;6
8039;Pušaitė;Ežiukai;1111143593;Ne;12;0;0;12
8040;Pušaitė;Ežiukai;5394378197;Ne;0;0;2;2
8041;Pušaitė;Ežiukai;3359574190;Ne;0;1;0;1
8042;Pušaitė;Ežiukai;1143122778;Ne;0;3;0;3
8043;Pušaitė;Ežiukai;9461292576;Ne;0;1;0;1
8044;Pušaitė;Ežiukai;4671293211;Ne;0;7;1;8
8045;Pušaitė;Ežiukai;8958364766;Ne;0;1;0;1
8046;Pušaitė;Ežiukai;7575143890;Ne;0;0;1;1
8047;Pušaitė;Ežiukai;7808186865;Ne;0;12;0;12
8048;Pušaitė;Ežiukai;4842783897;Ne;0;0;7;7
8049;Pušaitė;Ežiukai;6472169278;Ne;0;7;0;7
8050;Pušaitė;Ežiukai;8021494509;Ne;0;12;0;12
8051;Pušaitė;Ežiukai;2172342063;Ne;5;2;0;7
8052;Pušaitė;Ežiukai;8309000712;Ne;0;1;0;1
8053;Pušaitė;"Gudručių šalis";8763667682;Ne;4;0;1;5
8054;Pušaitė;"Gudručių šalis";2321256048;Ne;8;0;0;8
8055;Pušaitė;"Gudručių šalis";5488507646;Ne;0;0;8;8
8056;Pušaitė;"Gudručių šalis";1305526154;Ne;8;0;6;14
8057;Pušaitė;"Gudručių šalis";6205900423;Ne;0;22;0;22
8058;Pušaitė;"Gudručių šalis";2078734161;Ne;0;5;3;8
8059;Pušaitė;"Gudručių šalis";8790959900;Ne;0;9;0;9
8060;Pušaitė;"Gudručių šalis";3694667637;Ne;0;0;1;1
8061;Pušaitė;"Gudručių šalis";4101285889;Ne;0;0;6;6
8062;Pušaitė;"Gudručių šalis";3959838346;Ne;3;0;0;3
8063;Pušaitė;"Gudručių šalis";5563772495;Ne;0;0;7;7
8064;Pušaitė;"Gudručių šalis";6356263503;Ne;0;0;2;2
8065;Pušaitė;"Gudručių šalis";4626055123;Ne;0;1;0;1
8066;Pušaitė;"Gudručių šalis";2333176054;Ne;0;1;0;1
8067;Pušaitė;"Gudručių šalis";4918124423;Ne;0;0;5;5
8068;Pušaitė;"Gudručių šalis";6734504906;Ne;0;8;0;8
8069;Pušaitė;"Gudručių šalis";7992567219;Ne;15;0;1;16
8070;Pušaitė;"Gudručių šalis";1807432967;Ne;9;0;4;13
8071;Pušaitė;"Gudručių šalis";3380836598;Ne;0;0;2;2
8072;Pušaitė;"Lapučių mokyklėlė";9337726482;Ne;0;1;0;1
8073;Pušaitė;"Lapučių mokyklėlė";5139525557;Ne;3;2;4;9
8074;Pušaitė;"Lapučių mokyklėlė";2666541612;Ne;1;2;0;3
8075;Pušaitė;"Lapučių mokyklėlė";8343225451;Ne;10;2;0;12
8076;Pušaitė;"Lapučių mokyklėlė";8218991320;Ne;0;2;4;6
8077;Pušaitė;"Lapučių mokyklėlė";1994898058;Ne;0;22;0;22
8078;Pušaitė;"Lapučių mokyklėlė";8551426938;Ne;11;8;0;19
8079;Pušaitė;"Lapučių mokyklėlė";4444972517;Ne;7;0;0;7
8080;Pušaitė;"Lapučių mokyklėlė";7615253880;Ne;0;0;6;6
8081;Pušaitė;"Lapučių mokyklėlė";4508356130;Ne;0;6;0;6
8082;Pušaitė;"Lapučių mokyklėlė";4857214952;Ne;0;2;1;3
8083;Pušaitė;"Lapučių mokyklėlė";4138386134;Ne;7;2;0;9
8084;Pušaitė;"Lapučių mokyklėlė";4103149433;Ne;0;6;0;6
8085;Pušaitė;"Lapučių mokyklėlė";4747611989;Ne;4;2;1;7
8086;Pušaitė;"Lapučių mokyklėlė";3387165403;Ne;3;1;0;4
8087;Pušaitė;"Lapučių mokyklėlė";5281161835;Taip;6;0;0;6
8088;Pušaitė;"Lapučių mokyklėlė";5339878948;Ne;2;10;2;14
8089;Pušaitė;"Lapučių mokyklėlė";3610256789;Ne;13;0;0;13
8090;Pušaitė;"Lapučių mokyklėlė";1534764228;Ne;0;2;0;2
8091;Pušaitė;"Lapučių mokyklėlė";5328083339;Ne;2;1;0;3
8092;Pušaitė;"Lapučių mokyklėlė";3200968850;Ne;6;10;3;19
8093;Pušaitė;"VOVERIUKAI ";7891007708;Ne;0;1;0;1
8094;Pušaitė;"VOVERIUKAI ";3732377309;Ne;0;1;1;2
8095;Pušaitė;"VOVERIUKAI ";4344634837;Ne;0;22;0;22
8096;Pušaitė;"VOVERIUKAI ";1665030028;Taip;7;0;1;8
8097;Pušaitė;"VOVERIUKAI ";5013833636;Ne;5;0;0;5
8098;Pušaitė;"VOVERIUKAI ";4769806128;Ne;13;0;0;13
8099;Pušaitė;"VOVERIUKAI ";6742576615;Ne;0;0;1;1
8100;Pušaitė;"VOVERIUKAI ";6511940816;Ne;0;22;0;22
8101;Pušaitė;"VOVERIUKAI ";4818407739;Ne;5;0;0;5
8102;Pušaitė;"VOVERIUKAI ";8876092901;Ne;5;0;3;8
8103;Pušaitė;"VOVERIUKAI ";9546541248;Ne;0;6;0;6
8104;Pušaitė;"VOVERIUKAI ";4767321724;Ne;7;0;0;7
8105;Pušaitė;"VOVERIUKAI ";1542239525;Ne;5;0;2;7
8106;Pušaitė;"VOVERIUKAI ";4529006786;Ne;6;0;0;6
8107;Pušaitė;MEŠKUČIAI;5002710062;Ne;0;12;1;13
8108;Pušaitė;MEŠKUČIAI;9872317190;Ne;6;0;0;6
8109;Pušaitė;MEŠKUČIAI;3052743933;Ne;0;22;0;22
8110;Pušaitė;MEŠKUČIAI;3646346787;Ne;0;22;0;22
8111;Pušaitė;MEŠKUČIAI;6754402783;Ne;0;0;1;1
8112;Pušaitė;MEŠKUČIAI;9180309936;Ne;10;1;0;11
8113;Pušaitė;MEŠKUČIAI;2264047794;Ne;7;2;0;9
8114;Pušaitė;MEŠKUČIAI;4278699624;Ne;0;1;0;1
8115;Pušaitė;MEŠKUČIAI;8244793037;Ne;8;9;0;17
8116;Pušaitė;MEŠKUČIAI;3508664946;Ne;0;12;3;15
8117;Pušaitė;MEŠKUČIAI;3239486674;Taip;10;0;1;11
8118;Pušaitė;MEŠKUČIAI;9339706754;Ne;8;0;0;8
8119;Pušaitė;MEŠKUČIAI;2887576870;Ne;0;0;1;1
8120;Pušaitė;MEŠKUČIAI;9418440677;Ne;2;0;3;5
8121;Pušaitė;MEŠKUČIAI;4082173648;Ne;0;8;0;8
8122;Pušaitė;PELIUKAI;9177861202;Ne;12;0;2;14
8123;Pušaitė;PELIUKAI;9164927041;Ne;0;22;0;22
8124;Pušaitė;PELIUKAI;2454348536;Ne;0;0;3;3
8125;Pušaitė;PELIUKAI;6645711171;Ne;11;2;2;15
8126;Pušaitė;PELIUKAI;9867041220;Ne;0;1;3;4
8127;Pušaitė;PELIUKAI;7210529114;Ne;3;1;0;4
8128;Pušaitė;PELIUKAI;6851908671;Ne;2;0;2;4
8129;Pušaitė;PELIUKAI;2618038364;Ne;0;7;0;7
8130;Pušaitė;PELIUKAI;1180343204;Ne;6;7;0;13
8131;Pušaitė;PELIUKAI;1069369636;Ne;0;2;0;2
8132;Pušaitė;PELIUKAI;5112517007;Ne;17;0;0;17
8133;Pušaitė;PELIUKAI;9261546370;Ne;4;0;0;4
8134;Pušaitė;PELIUKAI;6059415475;Ne;0;1;11;12
8135;"Pušynėlis (Miglos g. 53)";PUMPURĖLIAI;5725602894;Ne;6;0;16;22
8136;"Pušynėlis (Miglos g. 53)";PUMPURĖLIAI;2718421498;Ne;3;0;0;3
8137;"Pušynėlis (Miglos g. 53)";PUMPURĖLIAI;3882064516;Ne;12;0;0;12
8138;"Pušynėlis (Miglos g. 53)";PUMPURĖLIAI;9081582524;Ne;12;0;0;12
8139;"Pušynėlis (Miglos g. 53)";PUMPURĖLIAI;8218331977;Ne;0;7;0;7
8140;"Pušynėlis (Miglos g. 53)";PUMPURĖLIAI;4526807309;Ne;0;2;0;2
8141;"Pušynėlis (Miglos g. 53)";PUMPURĖLIAI;5568838550;Ne;6;0;0;6
8142;"Pušynėlis (Miglos g. 53)";PUMPURĖLIAI;2744665477;Ne;3;2;0;5
8143;"Pušynėlis (Miglos g. 53)";PUMPURĖLIAI;2509111066;Ne;0;2;0;2
8144;"Pušynėlis (Miglos g. 53)";PUMPURĖLIAI;8902047615;Ne;0;5;0;5
8145;"Pušynėlis (Miglos g. 53)";PUMPURĖLIAI;3483639540;Ne;0;8;0;8
8146;"Pušynėlis (Miglos g. 53)";PUMPURĖLIAI;2861000826;Ne;0;5;0;5
8147;"Pušynėlis (Miglos g. 53)";PUMPURĖLIAI;8845728723;Ne;0;3;0;3
8148;"Pušynėlis (Miglos g. 53)";PUMPURĖLIAI;5802582694;Ne;0;1;0;1
8149;"Pušynėlis (Miglos g. 53)";PUMPURĖLIAI;9883505094;Ne;0;6;0;6
8150;"Pušynėlis (Miglos g. 53)";PUMPURĖLIAI;7438923710;Ne;18;0;0;18
8151;"Pušynėlis (Miglos g. 53)";PUMPURĖLIAI;8803766149;Ne;3;1;0;4
8152;"Pušynėlis (Miglos g. 53)";PUMPURĖLIAI;8462742834;Ne;0;12;0;12
8153;"Pušynėlis (Miglos g. 53)";PUMPURĖLIAI;6962705842;Ne;0;0;22;22
8154;"Pušynėlis (Miglos g. 53)";PUMPURĖLIAI;6110878898;Ne;0;0;2;2
8155;"Pušynėlis (Miglos g. 53)";SAULUTĖS;3483007385;Ne;0;12;0;12
8156;"Pušynėlis (Miglos g. 53)";SAULUTĖS;1891728904;Ne;0;8;0;8
8157;"Pušynėlis (Miglos g. 53)";SAULUTĖS;2508640229;Ne;0;0;1;1
8158;"Pušynėlis (Miglos g. 53)";SAULUTĖS;5236219294;Ne;0;0;2;2
8159;"Pušynėlis (Miglos g. 53)";SAULUTĖS;4052132379;Ne;0;1;0;1
8160;"Pušynėlis (Miglos g. 53)";SAULUTĖS;1102029570;Ne;0;0;1;1
8161;"Pušynėlis (Miglos g. 53)";SAULUTĖS;9483417104;Ne;5;0;0;5
8162;"Pušynėlis (Miglos g. 53)";SAULUTĖS;4052365035;Ne;0;0;1;1
8163;"Pušynėlis (Miglos g. 53)";SAULUTĖS;7401066252;Ne;0;9;0;9
8164;"Pušynėlis (Miglos g. 53)";SAULUTĖS;6036296660;Ne;0;2;0;2
8165;"Pušynėlis (Miglos g. 53)";SAULUTĖS;1164201286;Ne;0;6;0;6
8166;"Pušynėlis (Miglos g. 53)";SAULUTĖS;1251787066;Ne;0;0;2;2
8167;"Pušynėlis (Miglos g. 53)";SAULUTĖS;6709692748;Ne;8;1;0;9
8168;"Pušynėlis (Miglos g. 53)";SAULUTĖS;5318223378;Ne;0;0;7;7
8169;"Pušynėlis (Miglos g. 53)";SAULUTĖS;3100230874;Ne;0;22;0;22
8170;"Pušynėlis (Miglos g. 53)";SAULUTĖS;7896617995;Ne;0;0;6;6
8171;"Pušynėlis (Miglos g. 53)";SAULUTĖS;5897839636;Ne;0;7;0;7
8172;"Pušynėlis (Miglos g. 53)";SAULUTĖS;1034336110;Ne;0;1;0;1
8173;"Pušynėlis (Miglos g. 53)";SAULUTĖS;8799095053;Ne;5;5;0;10
8174;"Pušynėlis (Miglos g. 53)";SAULUTĖS;5501281051;Ne;0;8;12;20
8175;"Pušynėlis (Miglos g. 53)";PRIEŠMOKYKLINĖ;25261143142;Ne;0;4;0;4
8176;"Pušynėlis (Miglos g. 53)";PRIEŠMOKYKLINĖ;6549217377;Ne;3;0;1;4
8177;"Pušynėlis (Miglos g. 53)";PRIEŠMOKYKLINĖ;6077698697;Ne;0;0;5;5
8178;"Pušynėlis (Miglos g. 53)";PRIEŠMOKYKLINĖ;4668634909;Ne;0;2;0;2
8179;"Pušynėlis (Miglos g. 53)";PRIEŠMOKYKLINĖ;6560054869;Ne;0;7;0;7
8180;"Pušynėlis (Miglos g. 53)";PRIEŠMOKYKLINĖ;3037031809;Ne;0;7;1;8
8181;"Pušynėlis (Miglos g. 53)";PRIEŠMOKYKLINĖ;4030500100;Ne;0;0;2;2
8182;"Pušynėlis (Miglos g. 53)";PRIEŠMOKYKLINĖ;8172450090;Ne;0;0;2;2
8183;"Pušynėlis (Miglos g. 53)";PRIEŠMOKYKLINĖ;2793982816;Ne;0;2;4;6
8184;"Pušynėlis (Miglos g. 53)";PRIEŠMOKYKLINĖ;7046421581;Ne;0;1;4;5
8185;"Pušynėlis (Miglos g. 53)";PRIEŠMOKYKLINĖ;9466109315;Ne;0;1;0;1
8186;"Pušynėlis (Miglos g. 53)";PRIEŠMOKYKLINĖ;9154108688;Ne;0;1;7;8
8187;"Pušynėlis (Miglos g. 53)";PRIEŠMOKYKLINĖ;1573574250;Ne;0;0;1;1
8188;"Pušynėlis (Miglos g. 53)";PRIEŠMOKYKLINĖ;3510202379;Ne;0;2;3;5
8189;"Pušynėlis (Miglos g. 53)";PRIEŠMOKYKLINĖ;2765869141;Ne;2;1;0;3
8190;"Pušynėlis (Miglos g. 53)";PRIEŠMOKYKLINĖ;2141785580;Ne;0;5;0;5
8191;"Pušynėlis (Miglos g. 53)";"TREPSIUKAI (2018.09)";7732546085;Ne;2;10;4;16
8192;"Pušynėlis (Miglos g. 53)";"TREPSIUKAI (2018.09)";4449613959;Ne;0;0;21;21
8193;"Pušynėlis (Miglos g. 53)";"TREPSIUKAI (2018.09)";8933840402;Ne;3;2;2;7
8194;"Pušynėlis (Miglos g. 53)";"TREPSIUKAI (2018.09)";5488832089;Ne;7;0;1;8
8195;"Pušynėlis (Miglos g. 53)";"TREPSIUKAI (2018.09)";6414064067;Ne;0;2;0;2
8196;"Pušynėlis (Miglos g. 53)";"TREPSIUKAI (2018.09)";5670094788;Ne;0;0;4;4
8197;"Pušynėlis (Miglos g. 53)";"TREPSIUKAI (2018.09)";5264481173;Ne;0;2;0;2
8198;"Pušynėlis (Miglos g. 53)";"TREPSIUKAI (2018.09)";4468698630;Ne;0;0;4;4
8199;"Pušynėlis (Miglos g. 53)";"TREPSIUKAI (2018.09)";1240222214;Ne;0;0;5;5
8200;"Pušynėlis (Miglos g. 53)";"TREPSIUKAI (2018.09)";1508282873;Ne;0;0;2;2
8201;"Pušynėlis (Miglos g. 53)";"TREPSIUKAI (2018.09)";7745507151;Ne;5;0;2;7
8202;"Pušynėlis (Miglos g. 53)";"TREPSIUKAI (2018.09)";8372033449;Ne;13;3;0;16
8203;"Pušynėlis (Miglos g. 53)";"TREPSIUKAI (2018.09)";4603625624;Ne;0;6;0;6
8204;"Pušynėlis (Miglos g. 53)";"TREPSIUKAI (2018.09)";3682719098;Ne;0;5;1;6
8205;"Pušynėlis (Miglos g. 53)";"TREPSIUKAI (2018.09)";5038740377;Ne;0;4;0;4
8206;Raktelis;LAŠIUKAI;5031703240;Ne;4;1;0;5
8207;Raktelis;LAŠIUKAI;4671391106;Ne;0;1;0;1
8208;Raktelis;LAŠIUKAI;9313156299;Ne;0;2;0;2
8209;Raktelis;LAŠIUKAI;8117871963;Ne;0;14;0;14
8210;Raktelis;LAŠIUKAI;1192775994;Ne;0;2;1;3
8211;Raktelis;LAŠIUKAI;6854111162;Ne;0;1;0;1
8212;Raktelis;LAŠIUKAI;9230053040;Ne;13;4;0;17
8213;Raktelis;LAŠIUKAI;8410301417;Ne;0;5;0;5
8214;Raktelis;LAŠIUKAI;3713386556;Ne;13;2;0;15
8215;Raktelis;LAŠIUKAI;5818899732;Ne;0;7;1;8
8216;Raktelis;LAŠIUKAI;7487507324;Ne;0;3;0;3
8217;Raktelis;LAŠIUKAI;9584164290;Ne;0;2;2;4
8218;Raktelis;LAŠIUKAI;6049420030;Ne;0;0;1;1
8219;Raktelis;LAŠIUKAI;3345708690;Ne;0;2;1;3
8220;Raktelis;LAŠIUKAI;95104355224;Ne;0;1;0;1
8221;Raktelis;LAŠIUKAI;54221331553;Ne;0;0;3;3
8222;Raktelis;LAŠIUKAI;5802689482;Ne;9;4;0;13
8223;Raktelis;LAŠIUKAI;5000264125;Ne;3;2;0;5
8224;Raktelis;LAŠIUKAI;1457880868;Ne;5;2;0;7
8225;Raktelis;LAŠIUKAI;5711863758;Ne;0;1;4;5
8226;Raktelis;LAŠIUKAI;53034039807;Ne;9;5;0;14
8227;Raktelis;LAŠIUKAI;7248631013;Ne;5;0;2;7
8228;Raktelis;LAŠIUKAI;8559758812;Ne;4;6;0;10
8229;Raktelis;LAŠIUKAI;9210856228;Ne;0;0;4;4
8230;Raktelis;BITUTĖS;7265543701;Ne;0;2;1;3
8231;Raktelis;BITUTĖS;5627179884;Ne;0;1;0;1
8232;Raktelis;BITUTĖS;5405322552;Ne;2;0;4;6
8233;Raktelis;BITUTĖS;5218387088;Ne;0;2;1;3
8234;Raktelis;BITUTĖS;9139322116;Ne;0;1;4;5
8235;Raktelis;BITUTĖS;6929358401;Ne;0;5;0;5
8236;Raktelis;BITUTĖS;9965855682;Ne;0;2;0;2
8237;Raktelis;BITUTĖS;4319176525;Ne;0;1;0;1
8238;Raktelis;BITUTĖS;4317705126;Ne;0;10;0;10
8239;Raktelis;BITUTĖS;4187804340;Ne;0;0;2;2
8240;Raktelis;BITUTĖS;5820028619;Ne;5;1;0;6
8241;Raktelis;BITUTĖS;2652125338;Ne;0;0;5;5
8242;Raktelis;BITUTĖS;3821849812;Ne;13;1;0;14
8243;Raktelis;BITUTĖS;3308623522;Ne;7;2;1;10
8244;Raktelis;BITUTĖS;4059286631;Ne;0;6;0;6
8245;Raktelis;BITUTĖS;5913060415;Ne;3;1;0;4
8246;Raktelis;BITUTĖS;6974263764;Ne;0;1;0;1
8247;Raktelis;BITUTĖS;6932820066;Ne;10;0;1;11
8248;Raktelis;BITUTĖS;2410682193;Ne;0;7;1;8
8249;Raktelis;BITUTĖS;5705825231;Ne;4;0;0;4
8250;Raktelis;BITUTĖS;4615337759;Ne;4;0;0;4
8251;Raktelis;BITUTĖS;4962251215;Ne;0;9;0;9
8252;Raktelis;BITUTĖS;8282429202;Ne;0;4;2;6
8253;Raktelis;BORUŽĖLĖS;7068061170;Ne;22;0;0;22
8254;Raktelis;BORUŽĖLĖS;2361477092;Ne;9;12;0;21
8255;Raktelis;BORUŽĖLĖS;4226277600;Ne;7;0;0;7
8256;Raktelis;BORUŽĖLĖS;2599670832;Ne;11;2;0;13
8257;Raktelis;BORUŽĖLĖS;1757601091;Ne;5;0;0;5
8258;Raktelis;BORUŽĖLĖS;5865484633;Ne;0;3;0;3
8259;Raktelis;BORUŽĖLĖS;4529213150;Ne;6;0;0;6
8260;Raktelis;BORUŽĖLĖS;4936637343;Ne;0;2;0;2
8261;Raktelis;BORUŽĖLĖS;4333191842;Ne;16;0;1;17
8262;Raktelis;BORUŽĖLĖS;9529797517;Ne;0;4;0;4
8263;Raktelis;BORUŽĖLĖS;1618225282;Ne;0;0;3;3
8264;Raktelis;BORUŽĖLĖS;4442395100;Ne;3;2;1;6
8265;Raktelis;BORUŽĖLĖS;5150954686;Ne;18;0;1;19
8266;Raktelis;BORUŽĖLĖS;3490428062;Ne;5;3;0;8
8267;Raktelis;BORUŽĖLĖS;5404673733;Ne;8;1;0;9
8268;Raktelis;BORUŽĖLĖS;1314972335;Ne;0;6;0;6
8269;Raktelis;BORUŽĖLĖS;3343352568;Ne;0;2;6;8
8270;Raktelis;BORUŽĖLĖS;2698820718;Ne;7;1;0;8
8271;Raktelis;BORUŽĖLĖS;7990626447;Ne;0;3;0;3
8272;Raktelis;BORUŽĖLĖS;7459272209;Ne;10;0;0;10
8273;Raktelis;BORUŽĖLĖS;5046450478;Ne;9;1;0;10
8274;Raktelis;BORUŽĖLĖS;1141447274;Ne;0;7;0;7
8275;Raktelis;BORUŽĖLĖS;3456093273;Ne;7;0;1;8
8276;Raktelis;BORUŽĖLĖS;5576511314;Ne;7;4;0;11
8277;Raktelis;KAČIUKAI;8600632097;Ne;0;2;0;2
8278;Raktelis;KAČIUKAI;7630501672;Ne;6;0;0;6
8279;Raktelis;KAČIUKAI;6007823584;Ne;0;1;0;1
8280;Raktelis;KAČIUKAI;3733786043;Ne;0;2;1;3
8281;Raktelis;KAČIUKAI;8456082594;Ne;0;5;0;5
8282;Raktelis;KAČIUKAI;4676213966;Ne;12;10;0;22
8283;Raktelis;KAČIUKAI;4631375439;Ne;0;10;0;10
8284;Raktelis;KAČIUKAI;6265489540;Ne;0;1;0;1
8285;Raktelis;KAČIUKAI;4160091258;Ne;10;2;0;12
8286;Raktelis;KAČIUKAI;3775306030;Ne;11;0;0;11
8287;Raktelis;KAČIUKAI;6550851582;Ne;5;1;0;6
8288;Raktelis;KAČIUKAI;4009105487;Ne;0;0;2;2
8289;Raktelis;KAČIUKAI;1843086151;Ne;15;2;2;19
8290;Raktelis;KAČIUKAI;1983808547;Ne;18;0;0;18
8291;Raktelis;KAČIUKAI;5042538956;Ne;7;2;0;9
8292;Raktelis;KAČIUKAI;7260767942;Ne;0;1;0;1
8293;Raktelis;KAČIUKAI;6323223256;Ne;0;7;0;7
8294;Raktelis;KAČIUKAI;1123693990;Ne;2;2;1;5
8295;Raktelis;KAČIUKAI;4979657165;Ne;7;2;0;9
8296;Raktelis;KIŠKUČIAI;9390692206;Ne;20;0;0;20
8297;Raktelis;KIŠKUČIAI;7847787737;Ne;0;0;2;2
8298;Raktelis;KIŠKUČIAI;7046291082;Ne;3;0;0;3
8299;Raktelis;KIŠKUČIAI;2278227649;Ne;0;1;7;8
8300;Raktelis;KIŠKUČIAI;8992797384;Ne;4;1;0;5
8301;Raktelis;KIŠKUČIAI;9803505110;Ne;5;2;1;8
8302;Raktelis;KIŠKUČIAI;6473692639;Ne;5;0;0;5
8303;Raktelis;KIŠKUČIAI;1668164327;Ne;5;0;0;5
8304;Raktelis;KIŠKUČIAI;9169797346;Ne;0;5;3;8
8305;Raktelis;KIŠKUČIAI;2262854947;Ne;10;2;1;13
8306;Raktelis;KIŠKUČIAI;3493159224;Ne;0;0;3;3
8307;Raktelis;KIŠKUČIAI;1810732707;Ne;7;7;0;14
8308;Raktelis;KIŠKUČIAI;5293558630;Ne;0;2;3;5
8309;Raktelis;KIŠKUČIAI;7605822626;Ne;5;0;4;9
8310;Raktelis;NYKŠTUKAI;4252867688;Ne;2;0;0;2
8311;Raktelis;NYKŠTUKAI;7058612493;Ne;2;5;0;7
8312;Raktelis;NYKŠTUKAI;8817859592;Ne;0;1;2;3
8313;Raktelis;NYKŠTUKAI;4578445282;Ne;14;2;0;16
8314;Raktelis;NYKŠTUKAI;9164539135;Ne;5;2;1;8
8315;Raktelis;NYKŠTUKAI;4147382341;Ne;0;0;2;2
8316;Raktelis;NYKŠTUKAI;4764915486;Ne;0;0;2;2
8317;Raktelis;NYKŠTUKAI;9114203596;Ne;0;5;0;5
8318;Raktelis;NYKŠTUKAI;2803146830;Ne;17;0;0;17
8319;Raktelis;NYKŠTUKAI;1002851704;Ne;10;1;0;11
8320;Raktelis;NYKŠTUKAI;7202523804;Ne;0;9;0;9
8321;Raktelis;NYKŠTUKAI;6718159439;Ne;0;6;0;6
8322;Raktelis;PELIUKAI;9599034285;Ne;0;10;0;10
8323;Raktelis;PELIUKAI;1604357851;Ne;16;3;3;22
8324;Raktelis;PELIUKAI;6393143566;Ne;5;1;0;6
8325;Raktelis;PELIUKAI;4014822452;Ne;15;0;0;15
8326;Raktelis;PELIUKAI;5758873229;Ne;8;5;0;13
8327;Raktelis;PELIUKAI;2141128125;Ne;10;0;2;12
8328;Raktelis;PELIUKAI;4502236264;Ne;6;1;0;7
8329;Raktelis;PELIUKAI;4834301832;Ne;6;0;0;6
8330;Raktelis;PELIUKAI;3311870918;Ne;10;2;3;15
8331;Raktelis;PELIUKAI;6826993779;Ne;10;2;3;15
8332;Raktelis;PELIUKAI;8698736569;Ne;3;1;0;4
8333;Raktelis;PELIUKAI;2044812301;Ne;0;11;0;11
8334;Raktelis;PELIUKAI;2301442262;Ne;7;0;1;8
8335;Raktelis;PELIUKAI;6853881405;Ne;0;2;3;5
8336;Raktelis;PELIUKAI;9983004779;Ne;8;0;0;8
8337;Raktelis;PELIUKAI;7389910330;Ne;18;0;0;18
8338;Raktelis;PELIUKAI;4513031164;Ne;8;0;1;9
8339;Raktelis;AGUONOS;6199212999;Ne;0;8;0;8
8340;Raktelis;AGUONOS;1975411457;Ne;13;1;0;14
8341;Raktelis;AGUONOS;7170546710;Ne;7;7;0;14
8342;Raktelis;AGUONOS;9593639791;Ne;0;5;0;5
8343;Raktelis;AGUONOS;6608224825;Ne;5;5;0;10
8344;Raktelis;AGUONOS;4335378625;Ne;0;9;0;9
8345;Raktelis;AGUONOS;9355380341;Ne;0;0;1;1
8346;Raktelis;AGUONOS;2289954824;Ne;3;0;0;3
8347;Raktelis;LAPIUKŲ;6894769625;Ne;5;7;1;13
8348;Raktelis;LAPIUKŲ;9048412613;Ne;3;0;0;3
8349;Raktelis;LAPIUKŲ;7142823740;Ne;6;1;0;7
8350;Raktelis;LAPIUKŲ;3395720463;Ne;0;2;1;3
8351;Raktelis;LAPIUKŲ;2809458453;Ne;11;0;5;16
8352;Raktelis;LAPIUKŲ;2967941870;Ne;0;6;0;6
8353;Raktelis;LAPIUKŲ;6892006495;Ne;0;11;0;11
8354;Raktelis;LAPIUKŲ;3884068578;Ne;0;2;0;2
8355;Raktelis;LAPIUKŲ;4755892641;Ne;0;9;0;9
8356;Raktelis;LAPIUKŲ;7440866459;Ne;0;5;1;6
8357;Raktelis;LAPIUKŲ;3517484891;Ne;3;6;2;11
8358;Raktelis;LAPIUKŲ;5688795147;Ne;13;0;0;13
8359;Raktelis;LAPIUKŲ;8035618134;Ne;0;8;0;8
8360;Raktelis;LAPIUKŲ;6822021176;Ne;22;0;0;22
8361;Raktelis;LAPIUKŲ;8146076115;Ne;0;3;0;3
8362;Raktelis;LAPIUKŲ;2731096860;Ne;7;0;0;7
8363;Raktelis;LAPIUKŲ;8700012974;Ne;3;0;0;3
8364;Raktelis;LAPIUKŲ;1263150004;Ne;10;3;1;14
8365;Raktelis;LAPIUKŲ;1445359221;Ne;9;0;0;9
8366;Raktelis;LAPIUKŲ;9497620710;Ne;15;0;0;15
8367;Raktelis;LAPIUKŲ;1120263625;Ne;6;0;0;6
8368;Raktelis;PELĖDŽIUKAI;5275588088;Ne;0;4;0;4
8369;Raktelis;PELĖDŽIUKAI;54341630847;Ne;0;2;4;6
8370;Raktelis;PELĖDŽIUKAI;4583377785;Ne;0;5;0;5
8371;Raktelis;PELĖDŽIUKAI;8320696048;Ne;0;4;0;4
8372;Raktelis;PELĖDŽIUKAI;67304194087;Ne;0;2;1;3
8373;Raktelis;PELĖDŽIUKAI;2753402906;Ne;0;4;0;4
8374;Raktelis;PELĖDŽIUKAI;7962509432;Ne;0;3;0;3
8375;Raktelis;PELĖDŽIUKAI;67972824332;Ne;0;1;0;1
8376;Raktelis;PELĖDŽIUKAI;9053427316;Ne;0;1;7;8
8377;Raktelis;PELĖDŽIUKAI;3423529085;Ne;0;0;1;1
8378;Raktelis;PELĖDŽIUKAI;9716191639;Ne;10;1;1;12
8379;Raktelis;PELĖDŽIUKAI;8869030487;Taip;0;0;1;1
8380;Raktelis;PELĖDŽIUKAI;1322912585;Ne;0;0;22;22
8381;Raktelis;PELĖDŽIUKAI;6877934219;Taip;13;2;0;15
8382;Raktelis;PELĖDŽIUKAI;9130613710;Ne;0;6;0;6
8383;Raktelis;PELĖDŽIUKAI;9151796053;Ne;3;0;6;9
8384;Raktelis;PELĖDŽIUKAI;2282754345;Ne;0;3;0;3
8385;Raktelis;PELĖDŽIUKAI;8207675881;Ne;0;5;0;5
8386;Raktelis;PELĖDŽIUKAI;7869495911;Ne;0;2;1;3
8387;Raktelis;PELĖDŽIUKAI;5925441742;Ne;5;1;0;6
8388;Raktelis;PELĖDŽIUKAI;5082785025;Ne;0;0;5;5
8389;Raktelis;MEŠKIUKAI;8851021346;Ne;11;0;0;11
8390;Raktelis;MEŠKIUKAI;6685891017;Ne;0;0;7;7
8391;Raktelis;MEŠKIUKAI;3484991718;Ne;8;1;0;9
8392;Raktelis;MEŠKIUKAI;6855863189;Ne;0;0;1;1
8393;Raktelis;MEŠKIUKAI;1026592738;Ne;0;2;3;5
8394;Raktelis;MEŠKIUKAI;7900644404;Ne;22;0;0;22
8395;Raktelis;MEŠKIUKAI;5718804414;Ne;0;0;4;4
8396;Raktelis;MEŠKIUKAI;9718355271;Ne;7;4;0;11
8397;Raktelis;MEŠKIUKAI;6358227532;Ne;0;10;0;10
8398;Raktelis;MEŠKIUKAI;8341026400;Ne;0;2;0;2
8399;Raktelis;MEŠKIUKAI;8608093349;Ne;2;8;2;12
8400;Raktelis;MEŠKIUKAI;2103900090;Ne;0;0;1;1
8401;Rasa;Nykštukai;3979273111;Ne;0;2;0;2
8402;Rasa;Nykštukai;4847544355;Ne;6;2;2;10
8403;Rasa;Nykštukai;9723040721;Ne;0;2;0;2
8404;Rasa;Nykštukai;7004232909;Ne;0;2;2;4
8405;Rasa;Nykštukai;1223962374;Ne;0;0;9;9
8406;Rasa;Nykštukai;3200377629;Ne;0;3;0;3
8407;Rasa;Nykštukai;1336291828;Ne;0;7;0;7
8408;Rasa;Nykštukai;5861229664;Ne;17;0;0;17
8409;Rasa;Nykštukai;1386880644;Ne;0;2;5;7
8410;Rasa;Nykštukai;7228037580;Ne;0;1;0;1
8411;Rasa;Nykštukai;2977737634;Ne;0;1;0;1
8412;Rasa;Nykštukai;8310400946;Ne;6;1;0;7
8413;Rasa;Nykštukai;7520665472;Ne;0;3;0;3
8414;Rasa;Nykštukai;7534306402;Ne;8;3;0;11
8415;Rasa;Nykštukai;3755794133;Ne;0;1;0;1
8416;Rasa;Meškiukai;8378755600;Ne;5;14;0;19
8417;Rasa;Meškiukai;8740659600;Ne;0;22;0;22
8418;Rasa;Meškiukai;6874601830;Ne;6;16;0;22
8419;Rasa;Meškiukai;4127921417;Ne;0;0;9;9
8420;Rasa;Meškiukai;7357915584;Ne;0;9;1;10
8421;Rasa;Meškiukai;3548008659;Ne;0;22;0;22
8422;Rasa;Meškiukai;3773600344;Ne;5;1;2;8
8423;Rasa;Meškiukai;2371282781;Ne;5;1;2;8
8424;Rasa;Meškiukai;2555108465;Ne;0;1;1;2
8425;Rasa;Meškiukai;1992726664;Ne;3;1;0;4
8426;Rasa;Meškiukai;5165588335;Ne;0;7;0;7
8427;Rasa;Meškiukai;7637404588;Ne;0;0;5;5
8428;Rasa;Meškiukai;7502435359;Ne;5;0;0;5
8429;Rasa;Meškiukai;6853285570;Taip;5;0;0;5
8430;Rasa;Meškiukai;8674133653;Ne;0;22;0;22
8431;Rasa;Meškiukai;2840437821;Ne;1;2;1;4
8432;Rasa;Sauliukai;72772661373;Ne;0;5;0;5
8433;Rasa;Sauliukai;6879558965;Ne;11;4;0;15
8434;Rasa;Sauliukai;6356448094;Ne;17;4;0;21
8435;Rasa;Sauliukai;2683897055;Ne;5;7;0;12
8436;Rasa;Sauliukai;2982016133;Ne;1;5;2;8
8437;Rasa;Sauliukai;8052120247;Ne;0;4;0;4
8438;Rasa;Sauliukai;7534548604;Ne;0;7;0;7
8439;Rasa;Sauliukai;3567565920;Ne;0;3;0;3
8440;Rasa;Sauliukai;7565880116;Ne;0;14;0;14
8441;Rasa;Sauliukai;4790859112;Ne;5;0;0;5
8442;Rasa;Sauliukai;2110008545;Ne;4;6;0;10
8443;Rasa;Sauliukai;5932187584;Ne;0;3;0;3
8444;Rasa;Sauliukai;4837280374;Ne;9;0;0;9
8445;Rasa;Sauliukai;4260142706;Ne;0;6;0;6
8446;Rasa;Sauliukai;5145978804;Ne;16;6;0;22
8447;Rasa;Sauliukai;8818450386;Ne;5;1;1;7
8448;Rasa;Sauliukai;6734478649;Ne;0;6;0;6
8449;Rasa;Sauliukai;63673920646;Ne;3;11;0;14
8450;Rasa;Sauliukai;8953448462;Ne;0;1;0;1
8451;Rasa;Sauliukai;7899008995;Ne;22;10;0;32
8452;Rasa;Smalsučiai;5599182715;Ne;0;10;0;10
8453;Rasa;Smalsučiai;9648034081;Ne;0;7;0;7
8454;Rasa;Smalsučiai;2626361958;Ne;0;6;0;6
8455;Rasa;Smalsučiai;7065597550;Ne;0;3;0;3
8456;Rasa;Smalsučiai;2132535297;Ne;0;3;1;4
8457;Rasa;Smalsučiai;1690518970;Ne;0;5;0;5
8458;Rasa;Smalsučiai;3023088027;Ne;0;10;0;10
8459;Rasa;Smalsučiai;4758605343;Ne;0;4;0;4
8460;Rasa;Smalsučiai;3091012313;Ne;0;10;0;10
8461;Rasa;Smalsučiai;7558966891;Ne;11;8;0;19
8462;Rasa;Smalsučiai;6345614521;Ne;0;4;0;4
8463;Rasa;Smalsučiai;1651905746;Ne;0;5;0;5
8464;Rasa;Smalsučiai;1823276800;Ne;5;2;0;7
8465;Rasa;Smalsučiai;6773004268;Ne;0;10;0;10
8466;Rasa;Smalsučiai;1457384318;Ne;0;10;0;10
8467;Rasa;Smalsučiai;5325275053;Ne;0;5;2;7
8468;Rasa;Smalsučiai;2121070882;Ne;0;14;0;14
8469;Rasa;Smalsučiai;6704162447;Ne;0;1;0;1
8470;Rasa;Smalsučiai;4603188598;Ne;5;1;0;6
8471;Rasa;"Pelėdžiukai ";3387615841;Ne;0;2;0;2
8472;Rasa;"Pelėdžiukai ";8816116600;Ne;0;0;4;4
8473;Rasa;"Pelėdžiukai ";8455168346;Ne;7;0;0;7
8474;Rasa;"Pelėdžiukai ";9056416308;Ne;0;10;0;10
8475;Rasa;"Pelėdžiukai ";5141906920;Ne;0;3;0;3
8476;Rasa;"Pelėdžiukai ";3381468321;Ne;4;1;0;5
8477;Rasa;"Pelėdžiukai ";1261868339;Ne;5;1;3;9
8478;Rasa;"Pelėdžiukai ";6553479199;Ne;15;2;0;17
8479;Rasa;"Pelėdžiukai ";4947382314;Ne;0;10;0;10
8480;Rasa;"Pelėdžiukai ";2968464121;Ne;5;2;3;10
8481;Rasa;"Pelėdžiukai ";5816940902;Taip;5;0;1;6
8482;Rasa;"Pelėdžiukai ";4389917247;Ne;0;22;0;22
8483;Rasa;"Pelėdžiukai ";8403268732;Ne;0;0;5;5
8484;Rasa;"Pelėdžiukai ";4855210006;Ne;0;1;0;1
8485;Rasa;Katinėliai;3657956842;Ne;4;0;1;5
8486;Rasa;Katinėliai;6891623055;Ne;7;1;2;10
8487;Rasa;Katinėliai;9010812748;Ne;5;0;2;7
8488;Rasa;Katinėliai;7220007488;Ne;0;0;1;1
8489;Rasa;Katinėliai;8235869241;Ne;7;1;0;8
8490;Rasa;Katinėliai;4913483444;Ne;0;11;0;11
8491;Rasa;Katinėliai;4734775151;Ne;0;13;0;13
8492;Rasa;Katinėliai;4758138905;Ne;0;0;1;1
8493;Rasa;Katinėliai;9447346901;Ne;0;20;0;20
8494;Rasa;Katinėliai;3631124501;Taip;18;0;0;18
8495;Rasa;Katinėliai;9343039995;Ne;12;1;0;13
8496;Rasa;Katinėliai;4498966097;Ne;0;0;2;2
8497;Rasa;Katinėliai;3428261829;Ne;0;7;0;7
8498;Rasa;Katinėliai;2477057223;Ne;0;18;0;18
8499;Rasa;Katinėliai;5134342817;Ne;0;1;0;1
8500;Rasa;Katinėliai;9220749889;Ne;0;8;0;8
8501;Rasa;Ančiukai;1477018184;Ne;5;0;0;5
8502;Rasa;Ančiukai;4018241056;Ne;9;0;0;9
8503;Rasa;Ančiukai;1736903037;Ne;7;0;0;7
8504;Rasa;Ančiukai;7568880413;Ne;9;0;0;9
8505;Rasa;Ančiukai;8622210603;Ne;8;6;0;14
8506;Rasa;Ančiukai;1521328997;Ne;0;3;0;3
8507;Rasa;Ančiukai;3884782148;Ne;6;0;0;6
8508;Rasa;Ančiukai;9230334839;Taip;8;0;0;8
8509;Rasa;Ančiukai;8574946856;Ne;3;1;1;5
8510;Rasa;Ančiukai;6442933249;Ne;7;3;0;10
8511;Rasa;Ančiukai;4979105526;Ne;1;0;1;2
8512;Rasa;"Vyturiukai ";7028605422;Ne;5;1;5;11
8513;Rasa;"Vyturiukai ";9599510902;Ne;0;1;0;1
8514;Rasa;"Vyturiukai ";2800420481;Ne;0;1;8;9
8515;Rasa;"Vyturiukai ";5869253167;Ne;0;0;6;6
8516;Rasa;"Vyturiukai ";7037958994;Ne;7;0;0;7
8517;Rasa;"Vyturiukai ";8236785255;Ne;0;2;0;2
8518;Rasa;"Vyturiukai ";6887471189;Ne;3;5;1;9
8519;Rasa;"Vyturiukai ";4694111253;Ne;0;1;1;2
8520;Rasa;"Vyturiukai ";2347639286;Ne;0;1;1;2
8521;Rasa;"Vyturiukai ";9788282861;Ne;2;1;1;4
8522;Rasa;"Vyturiukai ";2711923397;Ne;0;5;1;6
8523;Rasa;"Vyturiukai ";2769096357;Ne;22;0;0;22
8524;Rasa;"Vyturiukai ";6883073764;Ne;0;0;8;8
8525;Rasa;"Vyturiukai ";9706428782;Ne;0;6;0;6
8526;Rasa;"Vyturiukai ";7043271718;Ne;3;0;3;6
8527;Rasa;"Vyturiukai ";6575864256;Ne;2;0;0;2
8528;Rasa;Voveriukai;4111850024;Ne;0;2;0;2
8529;Rasa;Voveriukai;2190948879;Ne;0;15;0;15
8530;Rasa;Voveriukai;1978999728;Ne;10;0;2;12
8531;Rasa;Voveriukai;3546684695;Ne;3;0;2;5
8532;Rasa;Voveriukai;4010262461;Ne;9;0;0;9
8533;Rasa;Voveriukai;5740754301;Ne;0;0;2;2
8534;Rasa;Voveriukai;5977524939;Ne;0;0;4;4
8535;Rasa;Voveriukai;1592174114;Ne;0;0;10;10
8536;Rasa;Voveriukai;1564194649;Ne;0;0;5;5
8537;Rasa;Voveriukai;1764959761;Ne;0;0;4;4
8538;Rasa;Voveriukai;1765617605;Ne;0;0;6;6
8539;Rasa;Voveriukai;1733179752;Ne;0;2;0;2
8540;Rasa;Voveriukai;2895124729;Ne;7;7;0;14
8541;Rasa;Voveriukai;8469342353;Ne;0;0;1;1
8542;Rasa;Voveriukai;1679709767;Ne;0;0;1;1
8543;Rasa;Voveriukai;5622110823;Ne;0;2;1;3
8544;Rasa;Voveriukai;6221754830;Ne;10;0;0;10
8545;Rasa;Voveriukai;7218250981;Ne;0;6;1;7
8546;Rasa;"DRUGELIAI ";6621628020;Ne;20;0;0;20
8547;Rasa;"DRUGELIAI ";9959160342;Ne;20;0;0;20
8548;Rasa;"DRUGELIAI ";5761013588;Ne;1;0;3;4
8549;Rasa;"DRUGELIAI ";7220103314;Ne;1;0;2;3
8550;Rasa;"DRUGELIAI ";9506388242;Ne;0;11;0;11
8551;Rasa;"DRUGELIAI ";4188303400;Ne;3;0;1;4
8552;Rasa;"DRUGELIAI ";5483943978;Ne;4;2;2;8
8553;Rasa;"DRUGELIAI ";7251815682;Ne;22;0;0;22
8554;Rasa;"DRUGELIAI ";8702962863;Ne;1;2;6;9
8555;Rasa;"DRUGELIAI ";6291089659;Taip;0;0;3;3
8556;Rasa;"DRUGELIAI ";1575522555;Ne;11;5;6;22
8557;Rasa;Zuikučiai;8027532547;Ne;9;2;4;15
8558;Rasa;Zuikučiai;3470054190;Taip;4;0;3;7
8559;Rasa;Zuikučiai;8180141204;Ne;0;1;0;1
8560;Rasa;Zuikučiai;7253736220;Ne;20;0;0;20
8561;Rasa;Zuikučiai;4940758709;Ne;10;0;0;10
8562;Rasa;Zuikučiai;7091899236;Ne;6;1;0;7
8563;Rasa;Zuikučiai;6574998939;Ne;0;2;0;2
8564;Rasa;Zuikučiai;4212798846;Ne;9;1;0;10
8565;Rasa;Zuikučiai;6505001743;Ne;12;1;0;13
8566;Rasa;Zuikučiai;6780996150;Taip;3;3;0;6
8567;Rasa;Zuikučiai;8159411349;Ne;4;2;0;6
8568;Rasa;Zuikučiai;8992548689;Ne;9;0;0;9
8569;Rasa;Širdelė;8424049317;Ne;4;0;0;4
8570;Rasa;Širdelė;8236464670;Ne;0;4;0;4
8571;Rasa;Širdelė;6976298054;Ne;0;1;0;1
8572;Rasa;Širdelė;3668598028;Ne;0;13;0;13
8573;Rasa;Širdelė;2333938367;Ne;0;4;0;4
8574;Rasa;Širdelė;5719253028;Ne;4;0;0;4
8575;Rasa;Širdelė;9140875020;Ne;0;13;0;13
8576;Rasa;Širdelė;4694382836;Ne;0;1;1;2
8577;Rasa;Širdelė;1796573723;Ne;0;2;0;2
8578;Rasa;Širdelė;3535655117;Ne;0;4;0;4
8579;Rasa;Širdelė;2830296197;Ne;0;0;1;1
8580;Rasa;Širdelė;4361959446;Ne;0;1;0;1
8581;Rasa;Širdelė;3215464914;Ne;0;5;0;5
8582;Rasa;Širdelė;6760723624;Ne;0;2;4;6
8583;Rasa;Širdelė;6606982242;Ne;0;1;0;1
8584;Rasa;Širdelė;1627996663;Ne;17;3;0;20
8585;Rugelis;Kiškučiai;2548567224;Ne;7;0;0;7
8586;Rugelis;Kiškučiai;7578087466;Ne;6;0;0;6
8587;Rugelis;Kiškučiai;1636702072;Ne;10;0;0;10
8588;Rugelis;Kiškučiai;4927838136;Ne;5;0;0;5
8589;Rugelis;Nykštukai;8884152807;Ne;7;0;0;7
8590;Rugelis;Nykštukai;3856766711;Ne;9;0;0;9
8591;Rugelis;Saulutės;9276682078;Ne;3;0;0;3
8592;Rugelis;Saulutės;6831078728;Ne;9;0;0;9
8593;Rugelis;Saulutės;9106734166;Ne;7;0;0;7
8594;Rugelis;Saulutės;6747662090;Ne;5;0;0;5
8595;Rugelis;Saulutės;8425090839;Ne;8;0;0;8
8596;Rugelis;Drugeliai;1420157174;Ne;4;0;0;4
8597;Rugelis;Drugeliai;3688023203;Ne;3;0;0;3
8598;Rugelis;Drugeliai;9776104569;Ne;3;0;0;3
8599;Rugelis;Drugeliai;6240217969;Ne;12;0;0;12
8600;Rugelis;Drugeliai;4425775068;Ne;5;0;0;5
8601;Rugelis;Ežiukai;4381627613;Ne;12;0;0;12
8602;Rugelis;Ežiukai;5649014411;Ne;8;0;0;8
8603;Rugelis;Bitutės;8529645041;Ne;6;0;0;6
8604;Rugelis;Bitutės;8560266148;Ne;13;0;0;13
8605;Rugelis;Bitutės;6305217730;Ne;10;0;0;10
8606;Rugelis;Bitutės;6172087627;Ne;6;0;0;6
8607;Rugelis;Bitutės;7385030387;Ne;6;0;0;6
8608;Rugelis;Bitutės;8411522319;Ne;3;0;0;3
8609;Rugelis;Žirniukai;6630323760;Ne;5;0;0;5
8610;Rugelis;Žirniukai;9780302551;Ne;5;0;0;5
8611;Rugelis;Žirniukai;3136867979;Ne;10;0;0;10
8612;Rugelis;Žirniukai;1658486720;Ne;3;0;0;3
8613;Rugelis;Žirniukai;4074302113;Ne;5;0;0;5
8614;Rugelis;Žvirbliukai;6760192823;Ne;6;0;0;6
8615;Rugelis;Žvirbliukai;5387358344;Ne;4;0;0;4
8616;Rugelis;Žvirbliukai;4582173664;Ne;10;0;0;10
8617;Rugelis;Ramunėlės;5223662752;Ne;5;0;0;5
8618;Rugelis;Ramunėlės;5347341795;Ne;8;0;0;8
8619;Rugelis;Ramunėlės;5117109538;Ne;4;0;0;4
8620;Rugelis;Ramunėlės;9743904886;Ne;9;0;0;9
8621;Rugelis;Ramunėlės;7677290493;Ne;6;0;0;6
8622;Rugelis;Ramunėlės;8988696728;Ne;10;0;0;10
8623;Rugelis;Pipirai;7943300111;Ne;6;0;0;6
8624;Rugelis;Pipirai;8235025116;Ne;2;0;0;2
8625;Rugelis;Pipirai;8359970599;Ne;21;0;0;21
8626;Rugelis;Pipirai;3766702811;Ne;6;0;0;6
8627;Rugelis;Pipirai;3219628162;Ne;12;0;0;12
8628;Rugelis;Meškučiai;8335991623;Ne;4;0;0;4
8629;Rugelis;Meškučiai;8451655848;Ne;5;0;0;5
8630;Rugelis;Meškučiai;6109565432;Ne;4;0;0;4
8631;Rugelis;Boružėlės;5964946032;Ne;7;0;0;7
8632;Rugelis;Boružėlės;1121258767;Ne;5;0;0;5
8633;Rugelis;Boružėlės;9286992729;Ne;3;0;0;3
8634;Rugelis;Boružėlės;5323815863;Ne;22;0;0;22
8635;Riešutėlis;Viščiukų;7666200219;Ne;13;9;0;22
8636;Riešutėlis;Viščiukų;7071757771;Ne;4;0;0;4
8637;Riešutėlis;Viščiukų;6626441225;Ne;10;0;0;10
8638;Riešutėlis;Viščiukų;5013456470;Ne;8;0;1;9
8639;Riešutėlis;Viščiukų;6906373822;Ne;15;1;0;16
8640;Riešutėlis;Viščiukų;4636191548;Ne;4;0;1;5
8641;Riešutėlis;Viščiukų;2734001106;Ne;4;0;0;4
8642;Riešutėlis;Viščiukų;2493171003;Ne;8;0;2;10
8643;Riešutėlis;Viščiukų;5133625078;Ne;5;2;0;7
8644;Riešutėlis;Viščiukų;2235912189;Ne;4;0;1;5
8645;Riešutėlis;Viščiukų;9864636983;Ne;12;0;0;12
8646;Riešutėlis;Viščiukų;4429903561;Ne;6;0;0;6
8647;Riešutėlis;Viščiukų;5317904812;Ne;9;0;1;10
8648;Riešutėlis;Viščiukų;8235524536;Ne;9;0;0;9
8649;Riešutėlis;Viščiukų;7795124495;Ne;10;0;0;10
8650;Riešutėlis;Viščiukų;2832538856;Ne;11;2;1;14
8651;Riešutėlis;Viščiukų;3730909181;Ne;9;0;0;9
8652;Riešutėlis;Viščiukų;4426750525;Ne;0;0;5;5
8653;Riešutėlis;Viščiukų;9341748384;Ne;9;4;0;13
8654;Riešutėlis;"Riešutėliai ";3800733442;Ne;13;1;0;14
8655;Riešutėlis;"Riešutėliai ";2117939721;Ne;22;0;0;22
8656;Riešutėlis;"Riešutėliai ";1343776985;Ne;12;0;0;12
8657;Riešutėlis;"Riešutėliai ";5915019363;Ne;0;12;0;12
8658;Riešutėlis;"Riešutėliai ";2207907790;Ne;9;0;0;9
8659;Riešutėlis;"Riešutėliai ";9699503472;Ne;10;0;4;14
8660;Riešutėlis;"Riešutėliai ";2098369052;Ne;2;0;4;6
8661;Riešutėlis;"Riešutėliai ";1426700414;Ne;18;1;0;19
8662;Riešutėlis;"Riešutėliai ";8539906445;Ne;10;0;0;10
8663;Riešutėlis;"Riešutėliai ";5873443383;Ne;2;0;3;5
8664;Riešutėlis;"Riešutėliai ";2301247729;Ne;0;7;0;7
8665;Riešutėlis;"Riešutėliai ";3602707130;Ne;0;11;0;11
8666;Riešutėlis;"Riešutėliai ";9318640304;Ne;5;0;2;7
8667;Riešutėlis;"Riešutėliai ";4293402095;Ne;12;2;3;17
8668;Riešutėlis;"Riešutėliai ";8917451081;Ne;7;3;0;10
8669;Riešutėlis;"Riešutėliai ";4698338374;Ne;2;1;0;3
8670;Riešutėlis;"Riešutėliai ";3345064565;Ne;12;0;0;12
8671;Riešutėlis;"Riešutėliai ";2560507294;Ne;0;1;4;5
8672;Riešutėlis;"Riešutėliai ";9078282526;Ne;0;1;8;9
8673;Riešutėlis;Ežiukai;7030346495;Ne;0;17;0;17
8674;Riešutėlis;Ežiukai;9750713954;Ne;4;6;0;10
8675;Riešutėlis;Ežiukai;7601776182;Ne;6;0;0;6
8676;Riešutėlis;Ežiukai;7381623086;Ne;3;2;0;5
8677;Riešutėlis;Ežiukai;9964688413;Ne;0;0;2;2
8678;Riešutėlis;Ežiukai;1548585448;Ne;0;1;0;1
8679;Riešutėlis;Ežiukai;8954127616;Ne;16;1;0;17
8680;Riešutėlis;Ežiukai;2092933906;Ne;0;15;0;15
8681;Riešutėlis;Ežiukai;6813024366;Ne;0;1;0;1
8682;Riešutėlis;Ežiukai;3460145784;Ne;0;10;0;10
8683;Riešutėlis;Ežiukai;8480059272;Ne;9;2;0;11
8684;Riešutėlis;Ežiukai;5728858361;Ne;0;2;0;2
8685;Riešutėlis;Ežiukai;5327627748;Ne;0;8;0;8
8686;Riešutėlis;Ežiukai;6259158270;Ne;0;5;0;5
8687;Riešutėlis;Ežiukai;6194259707;Ne;0;1;0;1
8688;Riešutėlis;Ežiukai;2837471235;Ne;0;15;0;15
8689;Riešutėlis;Ežiukai;2699984170;Ne;0;2;0;2
8690;Riešutėlis;Ežiukai;7050440691;Ne;0;0;7;7
8691;Riešutėlis;Ežiukai;8066712255;Ne;0;7;0;7
8692;Riešutėlis;Ežiukai;3577669231;Ne;0;5;0;5
8693;Riešutėlis;Ežiukai;9670912357;Ne;6;1;0;7
8694;Riešutėlis;Ežiukai;1818130297;Ne;0;5;0;5
8695;Riešutėlis;Ežiukai;6284614328;Ne;0;8;0;8
8696;Riešutėlis;Pelėdžiukai;3975540383;Taip;0;3;1;4
8697;Riešutėlis;Pelėdžiukai;1705599429;Ne;7;0;3;10
8698;Riešutėlis;Pelėdžiukai;4116506453;Ne;0;7;0;7
8699;Riešutėlis;Pelėdžiukai;2467739101;Ne;9;10;0;19
8700;Riešutėlis;Pelėdžiukai;2587460110;Ne;8;0;2;10
8701;Riešutėlis;Pelėdžiukai;6147780439;Ne;15;1;0;16
8702;Riešutėlis;Pelėdžiukai;3287685792;Ne;0;7;6;13
8703;Riešutėlis;Pelėdžiukai;1811701628;Ne;5;0;6;11
8704;Riešutėlis;Pelėdžiukai;5183264581;Ne;0;2;1;3
8705;Riešutėlis;Pelėdžiukai;4866613045;Ne;0;0;8;8
8706;Riešutėlis;Pelėdžiukai;6121386391;Ne;15;0;0;15
8707;Riešutėlis;Pelėdžiukai;4448024452;Ne;4;5;3;12
8708;Riešutėlis;Pelėdžiukai;3251066115;Ne;0;3;0;3
8709;Riešutėlis;Pelėdžiukai;4808684145;Ne;0;8;1;9
8710;Riešutėlis;Pelėdžiukai;4897581681;Ne;0;0;4;4
8711;Riešutėlis;Pelėdžiukai;7256075146;Ne;9;2;0;11
8712;Riešutėlis;Pelėdžiukai;5443448616;Ne;0;7;0;7
8713;Riešutėlis;Pelėdžiukai;8839482370;Ne;16;0;0;16
8714;Riešutėlis;Pelėdžiukai;4692384639;Ne;0;0;5;5
8715;Riešutėlis;Meškiukai;5537309549;Ne;0;8;1;9
8716;Riešutėlis;Meškiukai;1091941952;Ne;9;1;0;10
8717;Riešutėlis;Meškiukai;8271632629;Ne;5;0;0;5
8718;Riešutėlis;Meškiukai;2097580659;Ne;7;0;0;7
8719;Riešutėlis;Meškiukai;8313605541;Ne;0;2;2;4
8720;Riešutėlis;Meškiukai;7987368969;Ne;0;6;0;6
8721;Riešutėlis;Meškiukai;65873300738;Ne;0;5;0;5
8722;Riešutėlis;Meškiukai;26781529460;Ne;0;0;4;4
8723;Riešutėlis;Meškiukai;1936519033;Ne;0;2;1;3
8724;Riešutėlis;Meškiukai;4131218911;Ne;0;12;0;12
8725;Riešutėlis;Meškiukai;4276034784;Ne;0;6;0;6
8726;Riešutėlis;Meškiukai;4344185375;Ne;0;4;0;4
8727;Riešutėlis;Meškiukai;6594928740;Ne;2;0;0;2
8728;Riešutėlis;Meškiukai;2566084613;Ne;2;0;1;3
8729;Riešutėlis;Meškiukai;8087180983;Ne;0;0;7;7
8730;Riešutėlis;Meškiukai;16561622902;Ne;7;2;0;9
8731;Riešutėlis;Meškiukai;2611705234;Ne;0;1;0;1
8732;Riešutėlis;Meškiukai;4404544549;Ne;12;1;0;13
8733;Riešutėlis;Meškiukai;1709857621;Ne;7;1;0;8
8734;Riešutėlis;Kiškučiai;9297835044;Ne;1;3;0;4
8735;Riešutėlis;Kiškučiai;3363757821;Ne;12;0;0;12
8736;Riešutėlis;Kiškučiai;2581250615;Ne;8;0;0;8
8737;Riešutėlis;Kiškučiai;8445984114;Ne;16;0;0;16
8738;Riešutėlis;Kiškučiai;5266946070;Ne;9;0;0;9
8739;Riešutėlis;Kiškučiai;9357375649;Ne;5;1;0;6
8740;Riešutėlis;Kiškučiai;9548551553;Ne;0;0;1;1
8741;Riešutėlis;Kiškučiai;9500744921;Ne;6;1;0;7
8742;Riešutėlis;Kiškučiai;4851336076;Ne;0;8;0;8
8743;Riešutėlis;Kiškučiai;6705754238;Ne;0;12;5;17
8744;Riešutėlis;Kiškučiai;9964105252;Ne;21;0;0;21
8745;Riešutėlis;Kiškučiai;5846061115;Ne;5;2;0;7
8746;Riešutėlis;Kiškučiai;2618556733;Ne;0;10;6;16
8747;Riešutėlis;Kiškučiai;9995814717;Ne;5;0;0;5
8748;Riešutėlis;Kiškučiai;3165015754;Ne;0;4;4;8
8749;Riešutėlis;Kiškučiai;5738764214;Ne;0;5;2;7
8750;Riešutėlis;Voveriukų;5995176001;Ne;0;6;0;6
8751;Riešutėlis;Voveriukų;5598052531;Ne;0;1;0;1
8752;Riešutėlis;Voveriukų;8751571852;Ne;2;0;0;2
8753;Riešutėlis;Voveriukų;5282039544;Ne;3;0;0;3
8754;Riešutėlis;Voveriukų;6303767779;Ne;7;0;0;7
8755;Riešutėlis;Voveriukų;6405116059;Ne;0;0;4;4
8756;Riešutėlis;Voveriukų;2430518637;Ne;4;5;0;9
8757;Riešutėlis;Voveriukų;1457008581;Ne;3;0;0;3
8758;Riešutėlis;Voveriukų;1638021880;Ne;5;8;0;13
8759;Riešutėlis;Voveriukų;7225365172;Ne;5;3;0;8
8760;Riešutėlis;Voveriukų;8750531305;Ne;5;1;0;6
8761;Riešutėlis;Voveriukų;5479780116;Ne;0;5;0;5
8762;Riešutėlis;Voveriukų;9839084885;Ne;8;0;0;8
8763;Riešutėlis;Voveriukų;4451419273;Ne;0;16;0;16
8764;Riešutėlis;Voveriukų;8018914251;Ne;0;2;0;2
8765;Riešutėlis;Voveriukų;9040123535;Ne;0;2;0;2
8766;Riešutėlis;Voveriukų;6928558714;Ne;0;1;0;1
8767;Riešutėlis;Voveriukų;8012201566;Ne;5;6;0;11
8768;Riešutėlis;Voveriukų;7198434243;Ne;0;7;0;7
8769;Riešutėlis;Voveriukų;4581184004;Ne;8;0;0;8
8770;Riešutėlis;Voveriukų;1941869661;Ne;0;4;0;4
8771;Riešutėlis;Voveriukų;9023304543;Ne;0;2;0;2
8772;Riešutėlis;Saulutės;4004669930;Taip;0;2;5;7
8773;Riešutėlis;Saulutės;7177632315;Ne;6;0;0;6
8774;Riešutėlis;Saulutės;6721758785;Ne;0;12;0;12
8775;Riešutėlis;Saulutės;3694146893;Ne;5;0;0;5
8776;Riešutėlis;Saulutės;1748151109;Ne;0;4;1;5
8777;Riešutėlis;Saulutės;8504832383;Ne;0;1;0;1
8778;Riešutėlis;Saulutės;6292679662;Ne;0;7;5;12
8779;Riešutėlis;Saulutės;8738716660;Ne;0;2;8;10
8780;Riešutėlis;Saulutės;1196740726;Ne;0;2;0;2
8781;Riešutėlis;Saulutės;8415858895;Ne;0;1;6;7
8782;Riešutėlis;Saulutės;4498718519;Ne;0;1;8;9
8783;Riešutėlis;Saulutės;5753609922;Ne;5;4;0;9
8784;Riešutėlis;Saulutės;1860995033;Ne;0;11;11;22
8785;Riešutėlis;Saulutės;5013754772;Ne;13;1;0;14
8786;Riešutėlis;Saulutės;6468871352;Ne;1;3;1;5
8787;Riešutėlis;Saulutės;7154361660;Ne;22;0;0;22
8788;Riešutėlis;Saulutės;8677172126;Ne;0;0;6;6
8789;Riešutėlis;Saulutės;2395391926;Ne;0;0;1;1
8790;Riešutėlis;Saulutės;2572642260;Ne;16;6;0;22
8791;Riešutėlis;Saulutės;3544780386;Ne;0;6;4;10
8792;Riešutėlis;"Boruželės ";4118652467;Taip;0;22;0;22
8793;Riešutėlis;"Boruželės ";5662911204;Ne;3;0;0;3
8794;Riešutėlis;"Boruželės ";7663823906;Ne;5;9;1;15
8795;Riešutėlis;"Boruželės ";5336618381;Ne;0;6;0;6
8796;Riešutėlis;"Boruželės ";7327578507;Ne;3;0;0;3
8797;Riešutėlis;"Boruželės ";6368610810;Ne;12;0;0;12
8798;Riešutėlis;"Boruželės ";9296178632;Ne;0;1;0;1
8799;Riešutėlis;"Boruželės ";6681930005;Ne;7;0;0;7
8800;Riešutėlis;"Boruželės ";2352984379;Ne;0;9;9;18
8801;Riešutėlis;"Boruželės ";2238641969;Ne;13;0;1;14
8802;Riešutėlis;"Boruželės ";6217500325;Ne;0;22;0;22
8803;Riešutėlis;"Boruželės ";1058206787;Ne;11;0;0;11
8804;Riešutėlis;"Boruželės ";1282121190;Ne;11;0;0;11
8805;Riešutėlis;"Boruželės ";7259198785;Ne;0;0;1;1
8806;Riešutėlis;"Boruželės ";2875416610;Ne;0;10;0;10
8807;Riešutėlis;"Bitutės ";8498902448;Ne;0;7;2;9
8808;Riešutėlis;"Bitutės ";2459494071;Ne;0;0;5;5
8809;Riešutėlis;"Bitutės ";3931422170;Ne;0;0;9;9
8810;Riešutėlis;"Bitutės ";9285782325;Ne;9;3;0;12
8811;Riešutėlis;"Bitutės ";7473054556;Ne;0;2;0;2
8812;Riešutėlis;"Bitutės ";8996456595;Ne;0;1;0;1
8813;Riešutėlis;"Bitutės ";3475897400;Ne;0;0;3;3
8814;Riešutėlis;"Bitutės ";3592271009;Taip;5;3;3;11
8815;Riešutėlis;"Bitutės ";6815804556;Ne;0;10;0;10
8816;Riešutėlis;"Bitutės ";1626888090;Ne;7;1;0;8
8817;Riešutėlis;"Bitutės ";3348517050;Ne;4;0;0;4
8818;Riešutėlis;"Bitutės ";4358354602;Ne;14;0;0;14
8819;Riešutėlis;"Bitutės ";1494363200;Ne;10;0;0;10
8820;Riešutėlis;Drugelių;8266735624;Ne;0;1;0;1
8821;Riešutėlis;Drugelių;4776231497;Ne;0;1;0;1
8822;Riešutėlis;Drugelių;7769079730;Ne;0;2;0;2
8823;Riešutėlis;Drugelių;5811657782;Ne;0;5;0;5
8824;Riešutėlis;Drugelių;4221375847;Ne;0;4;0;4
8825;Riešutėlis;Drugelių;1075842434;Ne;0;0;1;1
8826;Riešutėlis;Drugelių;1942944625;Ne;0;1;0;1
8827;Riešutėlis;Drugelių;8845709386;Ne;0;10;0;10
8828;Riešutėlis;Drugelių;8352146446;Ne;4;1;2;7
8829;Riešutėlis;Drugelių;5412882446;Ne;0;1;5;6
8830;Riešutėlis;Drugelių;8020533200;Ne;0;4;3;7
8831;Riešutėlis;Drugelių;1164273595;Ne;14;0;0;14
8832;Riešutėlis;Drugelių;3836374000;Ne;0;3;0;3
8833;Riešutėlis;Drugelių;3975091711;Ne;0;1;0;1
8834;Riešutėlis;Drugelių;3071643137;Ne;2;0;0;2
8835;Riešutėlis;Drugelių;2599147931;Ne;0;1;0;1
8836;Riešutėlis;Drugelių;4845447863;Ne;3;5;0;8
8837;Riešutėlis;Nykštukų;1858791074;Ne;10;1;0;11
8838;Riešutėlis;Nykštukų;3759837057;Ne;9;1;0;10
8839;Riešutėlis;Nykštukų;4740516426;Taip;7;0;0;7
8840;Riešutėlis;Nykštukų;3150141050;Ne;7;0;0;7
8841;Riešutėlis;Nykštukų;6580050526;Ne;0;1;0;1
8842;Riešutėlis;Nykštukų;4810919435;Ne;0;0;6;6
8843;Riešutėlis;Nykštukų;2736824231;Ne;0;0;7;7
8844;Riešutėlis;Nykštukų;2378301886;Ne;5;4;0;9
8845;Riešutėlis;Nykštukų;2483793992;Ne;11;0;0;11
8846;Riešutėlis;Nykštukų;5262881964;Ne;3;0;3;6
8847;Riešutėlis;Nykštukų;4328166135;Ne;0;11;0;11
8848;Riešutėlis;Nykštukų;9052991215;Ne;0;13;5;18
8849;Riešutėlis;Nykštukų;6582898708;Taip;5;0;0;5
8850;Riešutėlis;Nykštukų;6318150385;Ne;2;5;6;13
8851;Riešutėlis;Nykštukų;4042719626;Ne;2;0;4;6
8852;Riešutėlis;Nykštukų;5078051087;Ne;0;1;0;1
8853;Riešutėlis;Nykštukų;3249196007;Ne;4;5;1;10
8854;Rytas;Geniukų;9286509610;Ne;1;0;0;1
8855;Rytas;Geniukų;2920533714;Ne;5;0;0;5
8856;Rytas;Geniukų;9583564559;Ne;10;0;0;10
8857;Rytas;Geniukų;4715624133;Ne;5;0;0;5
8858;Rytas;Svirpliukų;1481377422;Ne;1;0;0;1
8859;Rytas;Svirpliukų;8633375369;Ne;10;0;0;10
8860;Rytas;Svirpliukų;8000993383;Ne;22;0;0;22
8861;Rytas;Svirpliukų;4720782276;Ne;5;0;0;5
8862;Rytas;Boružėlių;5750528155;Ne;6;0;0;6
8863;Rytas;Boružėlių;8037918468;Ne;3;0;0;3
8864;Rytas;Drugelių;1709743791;Ne;7;0;0;7
8865;Rytas;Drugelių;12832347269;Ne;10;0;0;10
8866;Rytas;Ežiukų;6120494681;Ne;2;0;0;2
8867;Rytas;Žirniukų;7879688720;Ne;5;0;0;5
8868;Rytas;Žirniukų;8039515180;Ne;6;0;0;6
8869;Rytas;Žirniukų;1485585025;Ne;6;0;0;6
8870;Rytas;Voveriukų;9787664718;Ne;7;0;0;7
8871;Rytas;Voveriukų;2956282831;Ne;3;0;0;3
8872;Rytas;Voveriukų;3618566807;Ne;4;0;0;4
8873;Rytas;NAUJA;7555580849;Ne;10;0;0;10
8874;Ramunėlė;SAULUTĖS;3852734401;Ne;5;6;0;11
8875;Ramunėlė;SAULUTĖS;1192743154;Ne;0;9;0;9
8876;Ramunėlė;SAULUTĖS;5714771643;Ne;0;2;0;2
8877;Ramunėlė;SAULUTĖS;1483391590;Ne;0;1;1;2
8878;Ramunėlė;SAULUTĖS;4209191105;Ne;0;1;0;1
8879;Ramunėlė;SAULUTĖS;9927068798;Ne;3;2;0;5
8880;Ramunėlė;SAULUTĖS;7219400182;Ne;0;9;0;9
8881;Ramunėlė;SAULUTĖS;3779769727;Ne;0;11;0;11
8882;Ramunėlė;SAULUTĖS;5605444408;Ne;0;2;0;2
8883;Ramunėlė;SAULUTĖS;8912978935;Ne;0;3;0;3
8884;Ramunėlė;SAULUTĖS;1618282165;Ne;0;0;6;6
8885;Ramunėlė;SAULUTĖS;9533155706;Ne;0;4;0;4
8886;Ramunėlė;SAULUTĖS;3109623760;Ne;0;8;0;8
8887;Ramunėlė;SAULUTĖS;2697757513;Ne;11;3;0;14
8888;Ramunėlė;ŽIBUTĖ;4715809064;Ne;0;2;0;2
8889;Ramunėlė;ŽIBUTĖ;5315953299;Ne;0;1;0;1
8890;Ramunėlė;ŽIBUTĖ;2173425836;Ne;3;2;1;6
8891;Ramunėlė;ŽIBUTĖ;2686455030;Ne;0;2;3;5
8892;Ramunėlė;ŽIBUTĖ;6627399830;Ne;0;3;3;6
8893;Ramunėlė;ŽIBUTĖ;8726443989;Ne;0;12;1;13
8894;Ramunėlė;ŽIBUTĖ;5801760033;Ne;0;2;0;2
8895;Ramunėlė;ŽIBUTĖ;6389008823;Ne;12;9;0;21
8896;Ramunėlė;ŽIBUTĖ;9136437288;Ne;0;14;0;14
8897;Ramunėlė;ŽIBUTĖ;6040461460;Ne;14;5;2;21
8898;Ramunėlė;ŽIBUTĖ;2605941371;Ne;0;1;0;1
8899;Ramunėlė;ŽIBUTĖ;7010828978;Ne;0;5;7;12
8900;Ramunėlė;ŽIBUTĖ;3879563193;Ne;0;6;0;6
8901;Ramunėlė;ŽIBUTĖ;2591052434;Ne;0;3;0;3
8902;Ramunėlė;ŽIBUTĖ;2446375037;Ne;6;5;2;13
8903;Ramunėlė;ŽIBUTĖ;1671759939;Ne;0;1;0;1
8904;Ramunėlė;ŽIBUTĖ;6606802660;Ne;3;11;0;14
8905;Ramunėlė;ŽIBUTĖ;5304803880;Ne;0;2;0;2
8906;Ramunėlė;ŽIBUTĖ;3525444906;Ne;0;3;2;5
8907;Ramunėlė;ŽIBUTĖ;8055844166;Ne;5;12;0;17
8908;Ramunėlė;ŽIRNIUKAI;7721421570;Ne;0;15;1;16
8909;Ramunėlė;ŽIRNIUKAI;8942483792;Ne;0;8;3;11
8910;Ramunėlė;ŽIRNIUKAI;6674467484;Ne;0;21;0;21
8911;Ramunėlė;ŽIRNIUKAI;7593855877;Ne;0;4;0;4
8912;Ramunėlė;ŽIRNIUKAI;2177200537;Ne;0;9;0;9
8913;Ramunėlė;ŽIRNIUKAI;7026935746;Ne;0;5;0;5
8914;Ramunėlė;ŽIRNIUKAI;5581693652;Ne;0;1;0;1
8915;Ramunėlė;ŽIRNIUKAI;4269170508;Ne;8;10;3;21
8916;Ramunėlė;ŽIRNIUKAI;7263195574;Ne;0;1;0;1
8917;Ramunėlė;ŽIRNIUKAI;4076525701;Ne;4;0;1;5
8918;Ramunėlė;ŽIRNIUKAI;4139935502;Ne;0;7;0;7
8919;Ramunėlė;ŽIRNIUKAI;1833069020;Ne;15;10;0;25
8920;Ramunėlė;ŽIRNIUKAI;4875011312;Ne;2;3;0;5
8921;Ramunėlė;ŽIRNIUKAI;4084046207;Ne;0;11;0;11
8922;Ramunėlė;ŽIRNIUKAI;2276657044;Ne;0;7;4;11
8923;Ramunėlė;ŽIRNIUKAI;5017020616;Ne;0;2;0;2
8924;Ramunėlė;ŽIRNIUKAI;6458458913;Ne;0;6;0;6
8925;Ramunėlė;ŽIRNIUKAI;6225605784;Ne;0;14;0;14
8926;Ramunėlė;ŽIRNIUKAI;4805808663;Ne;0;8;0;8
8927;Ramunėlė;BITUTĖS;8098492540;Ne;0;16;0;16
8928;Ramunėlė;BITUTĖS;6329943991;Ne;0;5;9;14
8929;Ramunėlė;BITUTĖS;5865482869;Ne;0;12;0;12
8930;Ramunėlė;BITUTĖS;7692958269;Ne;0;6;1;7
8931;Ramunėlė;BITUTĖS;9789690425;Ne;0;13;0;13
8932;Ramunėlė;BITUTĖS;1182350830;Ne;0;0;2;2
8933;Ramunėlė;BITUTĖS;6342801407;Ne;0;0;2;2
8934;Ramunėlė;BITUTĖS;7220407572;Ne;0;12;0;12
8935;Ramunėlė;BITUTĖS;1916520056;Ne;2;11;0;13
8936;Ramunėlė;BITUTĖS;6870110390;Ne;0;1;0;1
8937;Ramunėlė;BITUTĖS;6892481929;Ne;0;7;0;7
8938;Ramunėlė;BITUTĖS;2558296296;Ne;0;5;2;7
8939;Ramunėlė;BITUTĖS;6881228078;Ne;0;25;0;25
8940;Ramunėlė;DRUGELIAI;6930505887;Ne;0;1;0;1
8941;Ramunėlė;DRUGELIAI;8402889872;Ne;0;3;1;4
8942;Ramunėlė;DRUGELIAI;7228065409;Ne;0;9;0;9
8943;Ramunėlė;DRUGELIAI;5170325023;Ne;0;4;4;8
8944;Ramunėlė;DRUGELIAI;3617897977;Ne;0;2;0;2
8945;Ramunėlė;DRUGELIAI;8768539595;Ne;0;11;0;11
8946;Ramunėlė;DRUGELIAI;7955507702;Ne;15;0;0;15
8947;Ramunėlė;DRUGELIAI;1078618047;Ne;0;17;0;17
8948;Ramunėlė;DRUGELIAI;9984243153;Ne;0;1;0;1
8949;Ramunėlė;DRUGELIAI;1199673371;Ne;0;6;1;7
8950;Ramunėlė;DRUGELIAI;4392309015;Ne;0;0;2;2
8951;Ramunėlė;DRUGELIAI;5049415445;Ne;0;6;8;14
8952;Ramunėlė;DRUGELIAI;8460527225;Ne;0;16;0;16
8953;Ramunėlė;DRUGELIAI;1800967823;Ne;2;0;1;3
8954;Ramunėlė;DRUGELIAI;8205893352;Ne;0;4;0;4
8955;Ramunėlė;DRUGELIAI;6809164145;Ne;5;2;4;11
8956;Ramunėlė;DRUGELIAI;6837877393;Ne;7;2;1;10
8957;Ramunėlė;NEUŽMIRŠTUOLĖS;1797997937;Ne;7;5;1;13
8958;Ramunėlė;NEUŽMIRŠTUOLĖS;9326288662;Ne;6;0;0;6
8959;Ramunėlė;NEUŽMIRŠTUOLĖS;9928703066;Ne;0;1;0;1
8960;Ramunėlė;NEUŽMIRŠTUOLĖS;4756689520;Ne;0;17;0;17
8961;Ramunėlė;NEUŽMIRŠTUOLĖS;2070729684;Ne;0;6;0;6
8962;Ramunėlė;NEUŽMIRŠTUOLĖS;4329292281;Ne;0;6;1;7
8963;Ramunėlė;NEUŽMIRŠTUOLĖS;6613469006;Ne;0;10;0;10
8964;Ramunėlė;NEUŽMIRŠTUOLĖS;3742982547;Ne;0;4;2;6
8965;Ramunėlė;NEUŽMIRŠTUOLĖS;3106987206;Ne;5;0;0;5
8966;Ramunėlė;NEUŽMIRŠTUOLĖS;8643188779;Ne;12;1;1;14
8967;Ramunėlė;NEUŽMIRŠTUOLĖS;9012749913;Ne;7;5;0;12
8968;Ramunėlė;NEUŽMIRŠTUOLĖS;1728034615;Ne;5;1;0;6
8969;Ramunėlė;NEUŽMIRŠTUOLĖS;1579527330;Ne;0;23;0;23
8970;Ramunėlė;NEUŽMIRŠTUOLĖS;7519551613;Ne;0;6;0;6
8971;Ramunėlė;NEUŽMIRŠTUOLĖS;2880352109;Ne;1;15;3;19
8972;Ramunėlė;NEUŽMIRŠTUOLĖS;3949246652;Ne;15;0;0;15
8973;Ramunėlė;NEUŽMIRŠTUOLĖS;3045477012;Ne;10;12;0;22
8974;Ramunėlė;NEUŽMIRŠTUOLĖS;5267145991;Ne;8;7;0;15
8975;Ramunėlė;NEUŽMIRŠTUOLĖS;1181787182;Ne;13;2;0;15
8976;Ramunėlė;OBUOLIUKAI;3683181174;Ne;4;5;0;9
8977;Ramunėlė;OBUOLIUKAI;7364976547;Ne;0;7;2;9
8978;Ramunėlė;OBUOLIUKAI;6156792400;Ne;0;6;0;6
8979;Ramunėlė;OBUOLIUKAI;4233978236;Ne;3;1;0;4
8980;Ramunėlė;OBUOLIUKAI;2983986428;Ne;0;23;0;23
8981;Ramunėlė;OBUOLIUKAI;5548358138;Ne;0;11;0;11
8982;Ramunėlė;OBUOLIUKAI;2422656007;Ne;2;2;7;11
8983;Ramunėlė;OBUOLIUKAI;7829765488;Ne;0;10;0;10
8984;Ramunėlė;OBUOLIUKAI;8623311748;Ne;0;18;0;18
8985;Ramunėlė;OBUOLIUKAI;6604244856;Ne;0;2;0;2
8986;Ramunėlė;OBUOLIUKAI;8617271247;Ne;0;2;0;2
8987;Ramunėlė;OBUOLIUKAI;6413888803;Ne;0;3;1;4
8988;Ramunėlė;OBUOLIUKAI;5610672420;Ne;8;7;1;16
8989;Ramunėlė;OBUOLIUKAI;4400154355;Ne;0;5;2;7
8990;Ramunėlė;OBUOLIUKAI;7250951221;Ne;0;1;0;1
8991;Ramunėlė;OBUOLIUKAI;3802924434;Ne;0;7;1;8
8992;Ramunėlė;OBUOLIUKAI;6981729247;Ne;5;9;1;15
8993;Ramunėlė;SAULĖGRĄŽA;2458101652;Ne;11;0;0;11
8994;Ramunėlė;SAULĖGRĄŽA;9663304288;Ne;5;1;2;8
8995;Ramunėlė;SAULĖGRĄŽA;5398069413;Ne;3;1;2;6
8996;Ramunėlė;SAULĖGRĄŽA;7873462803;Ne;8;5;3;16
8997;Ramunėlė;SAULĖGRĄŽA;3793779715;Ne;0;0;1;1
8998;Ramunėlė;SAULĖGRĄŽA;6775947111;Ne;0;10;20;30
8999;Ramunėlė;SAULĖGRĄŽA;1102946363;Ne;0;0;6;6
9000;Ramunėlė;SAULĖGRĄŽA;3801952385;Ne;0;8;0;8
9001;Ramunėlė;SAULĖGRĄŽA;9120142666;Ne;6;0;0;6
9002;Ramunėlė;SAULĖGRĄŽA;6942789511;Ne;0;1;0;1
9003;Ramunėlė;SAULĖGRĄŽA;2415377154;Ne;0;9;2;11
9004;Ramunėlė;SAULĖGRĄŽA;9076692864;Ne;0;4;0;4
9005;Ramunėlė;BORUŽĖLĖS;7825538259;Ne;5;11;0;16
9006;Ramunėlė;BORUŽĖLĖS;8496322672;Ne;5;1;0;6
9007;Ramunėlė;BORUŽĖLĖS;6695672297;Ne;0;5;0;5
9008;Ramunėlė;BORUŽĖLĖS;7295041630;Ne;4;1;0;5
9009;Ramunėlė;BORUŽĖLĖS;58028743912;Ne;3;10;1;14
9010;Ramunėlė;BORUŽĖLĖS;7750405604;Ne;9;12;0;21
9011;Ramunėlė;BORUŽĖLĖS;1216101539;Ne;0;13;0;13
9012;Ramunėlė;BORUŽĖLĖS;4677819736;Ne;0;8;1;9
9013;Ramunėlė;BORUŽĖLĖS;4349250416;Ne;0;6;0;6
9014;Ramunėlė;BORUŽĖLĖS;1303053333;Ne;0;1;0;1
9015;Ramunėlė;BORUŽĖLĖS;3554787356;Ne;0;9;2;11
9016;Ramunėlė;BORUŽĖLĖS;3685786758;Ne;0;5;0;5
9017;Ramunėlė;BORUŽĖLĖS;6837072361;Ne;0;9;0;9
9018;Ramunėlė;BORUŽĖLĖS;1534723406;Ne;0;8;3;11
9019;Ramunėlė;BORUŽĖLĖS;8323020864;Ne;0;0;5;5
9020;Ramunėlė;BORUŽĖLĖS;10704826206;Ne;5;12;3;20
9021;Ramunėlė;BORUŽĖLĖS;3065727741;Ne;13;10;0;23
9022;Ramunėlė;BORUŽĖLĖS;9924675250;Ne;0;2;0;2
9023;Ramunėlė;BORUŽĖLĖS;6251432968;Ne;0;2;0;2
9024;Ramunėlė;NYKŠTUKAS;3166386231;Ne;0;12;0;12
9025;Ramunėlė;NYKŠTUKAS;8045080504;Ne;3;14;0;17
9026;Ramunėlė;NYKŠTUKAS;6983139076;Ne;8;2;1;11
9027;Ramunėlė;NYKŠTUKAS;7639613472;Ne;0;27;0;27
9028;Ramunėlė;NYKŠTUKAS;4642590173;Ne;9;14;0;23
9029;Ramunėlė;NYKŠTUKAS;9549605315;Ne;2;6;0;8
9030;Ramunėlė;NYKŠTUKAS;4491147309;Ne;8;4;3;15
9031;Ramunėlė;NYKŠTUKAS;4040520907;Ne;5;10;0;15
9032;Ramunėlė;NYKŠTUKAS;7542328641;Ne;7;3;0;10
9033;Ramunėlė;NYKŠTUKAS;1277413234;Ne;0;1;0;1
9034;Ramunėlė;NYKŠTUKAS;1215510902;Ne;5;9;0;14
9035;Ramunėlė;NYKŠTUKAS;8218201930;Ne;7;23;0;30
9036;Ramunėlė;NYKŠTUKAS;2760710235;Ne;0;8;0;8
9037;Ramunėlė;NYKŠTUKAS;5573083546;Ne;10;0;0;10
9038;Ramunėlė;NYKŠTUKAS;1802650607;Ne;12;10;0;22
9039;Ramunėlė;UOGELĖ;6294697776;Taip;5;4;0;9
9040;Ramunėlė;UOGELĖ;7005354909;Ne;0;5;0;5
9041;Ramunėlė;UOGELĖ;5665429647;Ne;5;3;0;8
9042;Ramunėlė;UOGELĖ;9180197156;Ne;11;0;0;11
9043;Ramunėlė;UOGELĖ;5108864184;Ne;7;0;0;7
9044;Ramunėlė;UOGELĖ;4321527067;Ne;0;12;0;12
9045;Ramunėlė;UOGELĖ;2202879286;Ne;0;1;0;1
9046;Ramunėlė;UOGELĖ;7896711579;Ne;13;2;0;15
9047;Ramunėlė;UOGELĖ;5726947811;Ne;0;5;6;11
9048;Ramunėlė;UOGELĖ;4171905362;Ne;0;2;0;2
9049;Ramunėlė;UOGELĖ;1729152997;Ne;11;7;0;18
9050;Ramunėlė;UOGELĖ;8764042799;Ne;0;1;0;1
9051;Ramunėlė;UOGELĖ;7926168752;Taip;11;5;0;16
9052;Ramunėlė;UOGELĖ;5498856861;Ne;7;0;0;7
9053;Ramunėlė;UOGELĖ;3024065664;Ne;0;9;0;9
9054;Ramunėlė;UOGELĖ;1666033483;Ne;5;2;0;7
9055;Ramunėlė;UOGELĖ;9994601365;Ne;10;9;0;19
9056;Ramunėlė;UOGELĖ;2620747378;Ne;2;0;2;4
9057;Ramunėlė;VARPELIAI;1159457001;Ne;12;12;1;25
9058;Ramunėlė;VARPELIAI;6606966969;Ne;5;0;0;5
9059;Ramunėlė;VARPELIAI;9292235402;Ne;11;4;0;15
9060;Ramunėlė;VARPELIAI;1811931985;Ne;0;15;0;15
9061;Ramunėlė;VARPELIAI;1818513881;Ne;0;12;1;13
9062;Ramunėlė;VARPELIAI;4581826404;Ne;0;7;0;7
9063;Ramunėlė;VARPELIAI;8310875815;Ne;4;1;0;5
9064;Ramunėlė;VARPELIAI;1491688322;Ne;0;12;4;16
9065;Ramunėlė;VARPELIAI;5703289545;Ne;0;1;6;7
9066;Ramunėlė;VARPELIAI;9934852622;Ne;5;5;0;10
9067;Ramunėlė;VARPELIAI;4968998913;Ne;0;10;7;17
9068;Ramunėlė;VARPELIAI;3996453947;Ne;0;10;0;10
9069;Ramunėlė;VARPELIAI;3461269451;Ne;0;11;0;11
9070;Ramunėlė;VARPELIAI;3474578046;Ne;7;3;0;10
9071;Ramunėlė;VARPELIAI;7544671346;Ne;0;5;0;5
9072;Ramunėlė;VARPELIAI;5544992493;Ne;0;8;0;8
9073;Ramunėlė;VARPELIAI;6433856416;Ne;0;3;0;3
9074;Ramunėlė;VARPELIAI;3542912372;Ne;22;10;0;32
9075;Ramunėlė;VARPELIAI;3735308599;Ne;4;2;0;6
9076;Ramunėlė;VARPELIAI;3272747656;Ne;0;4;0;4
9077;Ramunėlė;VARPELIAI;6347893013;Ne;2;3;0;5
9078;Rūta;SMALSUČIAI;6285841968;Ne;7;0;0;7
9079;Rūta;SMALSUČIAI;7649756034;Ne;0;0;3;3
9080;Rūta;SMALSUČIAI;5899860543;Ne;0;12;0;12
9081;Rūta;SMALSUČIAI;1346124133;Ne;7;0;0;7
9082;Rūta;SMALSUČIAI;4728904136;Ne;6;3;0;9
9083;Rūta;SMALSUČIAI;9791861646;Ne;2;0;5;7
9084;Rūta;SMALSUČIAI;2928803089;Ne;0;1;0;1
9085;Rūta;SMALSUČIAI;8378318357;Ne;5;0;0;5
9086;Rūta;SMALSUČIAI;1951202550;Ne;0;0;5;5
9087;Rūta;SMALSUČIAI;9911151238;Ne;0;2;0;2
9088;Rūta;SMALSUČIAI;7434152435;Ne;0;8;0;8
9089;Rūta;SMALSUČIAI;3843325181;Ne;0;0;3;3
9090;Rūta;SMALSUČIAI;8182243701;Ne;0;1;1;2
9091;Rūta;SMALSUČIAI;9386595365;Ne;0;0;6;6
9092;Rūta;SMALSUČIAI;7680605199;Taip;0;12;0;12
9093;Rūta;SMALSUČIAI;6075632046;Ne;0;13;0;13
9094;Rūta;SMALSUČIAI;1035527190;Ne;0;0;2;2
9095;Rūta;KŪLVERSTUKAI;4423305209;Ne;7;0;1;8
9096;Rūta;KŪLVERSTUKAI;9736567509;Ne;0;0;2;2
9097;Rūta;KŪLVERSTUKAI;7222494215;Ne;0;1;0;1
9098;Rūta;KŪLVERSTUKAI;7519931138;Ne;0;0;2;2
9099;Rūta;KŪLVERSTUKAI;4880804625;Ne;0;0;7;7
9100;Rūta;KŪLVERSTUKAI;3055345528;Ne;0;0;3;3
9101;Rūta;KŪLVERSTUKAI;3499727608;Ne;0;0;19;19
9102;Rūta;KŪLVERSTUKAI;9765301038;Ne;0;0;19;19
9103;Rūta;KŪLVERSTUKAI;9638495757;Taip;3;3;0;6
9104;Rūta;KŪLVERSTUKAI;1962172243;Ne;5;0;0;5
9105;Rūta;KŪLVERSTUKAI;8605070655;Ne;0;1;7;8
9106;Rūta;KŪLVERSTUKAI;7553844890;Ne;0;10;0;10
9107;Rūta;KŪLVERSTUKAI;3964922552;Ne;0;1;3;4
9108;Rūta;KŪLVERSTUKAI;8395765508;Ne;0;1;0;1
9109;Rūta;KŪLVERSTUKAI;9400586178;Ne;7;0;6;13
9110;Rūta;KŪLVERSTUKAI;3956912957;Ne;0;0;9;9
9111;Rūta;KŪLVERSTUKAI;2890569107;Ne;0;2;0;2
9112;Rūta;KŪLVERSTUKAI;2474991135;Ne;0;3;6;9
9113;Rūta;KŪLVERSTUKAI;1216786487;Ne;0;5;0;5
9114;Rūta;KŪLVERSTUKAI;9245618776;Ne;0;15;0;15
9115;Rūta;KŪLVERSTUKAI;5109138407;Taip;5;5;0;10
9116;Rūta;KODĖLČIUKAI;5962981130;Ne;8;0;0;8
9117;Rūta;KODĖLČIUKAI;4347678781;Ne;0;0;2;2
9118;Rūta;KODĖLČIUKAI;3736279705;Ne;0;0;5;5
9119;Rūta;KODĖLČIUKAI;8416455711;Ne;0;2;2;4
9120;Rūta;KODĖLČIUKAI;8668510009;Ne;0;7;0;7
9121;Rūta;KODĖLČIUKAI;2547849837;Ne;2;0;6;8
9122;Rūta;KODĖLČIUKAI;9501101073;Ne;0;0;4;4
9123;Rūta;KODĖLČIUKAI;8883578144;Ne;5;0;2;7
9124;Rūta;KODĖLČIUKAI;4546082355;Ne;5;7;0;12
9125;Rūta;KODĖLČIUKAI;1000645885;Ne;7;0;0;7
9126;Rūta;KODĖLČIUKAI;5766392854;Ne;0;2;0;2
9127;Rūta;KODĖLČIUKAI;9916296056;Ne;0;8;0;8
9128;Rūta;KODĖLČIUKAI;4656138649;Taip;0;0;2;2
9129;Rūta;KODĖLČIUKAI;1605412505;Ne;0;0;2;2
9130;Rūta;KODĖLČIUKAI;2492891254;Ne;10;0;4;14
9131;Rūta;BORUŽĖLĖS;7712500278;Ne;0;1;0;1
9132;Rūta;BORUŽĖLĖS;8945868791;Ne;0;1;6;7
9133;Rūta;BORUŽĖLĖS;8023404173;Ne;6;1;0;7
9134;Rūta;BORUŽĖLĖS;3348066709;Ne;2;0;1;3
9135;Rūta;BORUŽĖLĖS;4279367893;Ne;7;0;1;8
9136;Rūta;BORUŽĖLĖS;5141290453;Ne;0;7;0;7
9137;Rūta;BORUŽĖLĖS;6587625933;Ne;0;1;1;2
9138;Rūta;BORUŽĖLĖS;8303314520;Ne;0;15;0;15
9139;Rūta;BORUŽĖLĖS;3470052541;Ne;11;1;0;12
9140;Rūta;BORUŽĖLĖS;2625691851;Ne;4;0;6;10
9141;Rūta;BORUŽĖLĖS;1804222979;Taip;6;10;0;16
9142;Rūta;VYTURĖLIAI;1967141665;Ne;0;3;7;10
9143;Rūta;VYTURĖLIAI;3873876608;Ne;5;1;0;6
9144;Rūta;VYTURĖLIAI;3478456813;Ne;0;9;0;9
9145;Rūta;VYTURĖLIAI;6207902435;Ne;0;2;0;2
9146;Rūta;VYTURĖLIAI;8889388348;Ne;0;0;1;1
9147;Rūta;VYTURĖLIAI;1346367896;Ne;0;2;1;3
9148;Rūta;VYTURĖLIAI;4363571135;Ne;0;0;3;3
9149;Rūta;VYTURĖLIAI;6006094035;Ne;5;0;0;5
9150;Rūta;VYTURĖLIAI;1521231573;Ne;8;0;0;8
9151;Rūta;VYTURĖLIAI;7552644990;Ne;0;2;0;2
9152;Rūta;VYTURĖLIAI;1092908255;Ne;1;0;0;1
9153;Rūta;VYTURĖLIAI;8673942478;Ne;0;2;0;2
9154;Rūta;VYTURĖLIAI;4754142240;Ne;0;1;0;1
9155;Rūta;VYTURĖLIAI;6136733410;Ne;0;2;0;2
9156;Rūta;VYTURĖLIAI;1565896222;Ne;4;0;0;4
9157;Rūta;VYTURĖLIAI;7631229177;Ne;0;3;0;3
9158;Rūta;"PABIRUČIAI (LOGOPEDINĖ)";6221528830;Ne;7;0;0;7
9159;Rūta;"PABIRUČIAI (LOGOPEDINĖ)";4911219947;Ne;14;0;0;14
9160;Rūta;"PABIRUČIAI (LOGOPEDINĖ)";8763382361;Ne;0;0;4;4
9161;Rūta;"PABIRUČIAI (LOGOPEDINĖ)";9171781646;Ne;0;0;4;4
9162;Rūta;"PABIRUČIAI (LOGOPEDINĖ)";5211104903;Ne;17;0;0;17
9163;Rūta;"PABIRUČIAI (LOGOPEDINĖ)";3814794448;Ne;0;0;8;8
9164;Rūta;GUDRUČIAI;3998791775;Ne;0;5;1;6
9165;Rūta;GUDRUČIAI;3462986405;Ne;8;0;0;8
9166;Rūta;GUDRUČIAI;8548089843;Taip;2;0;2;4
9167;Rūta;GUDRUČIAI;4473591998;Ne;8;1;0;9
9168;Rūta;GUDRUČIAI;9419809946;Ne;0;1;0;1
9169;Rūta;GUDRUČIAI;3044976169;Ne;0;0;1;1
9170;Rūta;GUDRUČIAI;8273644943;Ne;8;1;0;9
9171;Rūta;GUDRUČIAI;8963959004;Ne;0;2;0;2
9172;Rūta;GUDRUČIAI;3454881685;Ne;0;10;3;13
9173;Rūta;GUDRUČIAI;1811055786;Ne;5;0;0;5
9174;Rūta;GUDRUČIAI;1510268514;Ne;0;2;1;3
9175;Rūta;GUDRUČIAI;6814051598;Ne;0;7;0;7
9176;Rūta;GUDRUČIAI;2702537976;Ne;0;1;0;1
9177;Rūta;GUDRUČIAI;2772130413;Ne;0;1;0;1
9178;Rūta;GUDRUČIAI;1623968580;Ne;0;2;0;2
9179;Rūta;GUDRUČIAI;8592528906;Ne;5;6;0;11
9180;Rūta;GUDRUČIAI;1182222976;Ne;15;0;0;15
9181;Rūta;SEKLYTĖLĖ;1301573542;Ne;0;4;0;4
9182;Rūta;SEKLYTĖLĖ;5009619812;Ne;0;1;0;1
9183;Rūta;SEKLYTĖLĖ;3567273206;Ne;0;8;0;8
9184;Rūta;SEKLYTĖLĖ;1671913833;Ne;0;3;0;3
9185;Rūta;SEKLYTĖLĖ;1186493111;Ne;0;14;0;14
9186;Rūta;SEKLYTĖLĖ;9675482322;Ne;0;14;0;14
9187;Rūta;SEKLYTĖLĖ;3820689725;Ne;0;1;0;1
9188;Rūta;SEKLYTĖLĖ;1415664888;Ne;0;5;0;5
9189;Rūta;SEKLYTĖLĖ;4426456302;Ne;0;1;0;1
9190;Rūta;SEKLYTĖLĖ;4282074540;Ne;6;4;0;10
9191;Rūta;SEKLYTĖLĖ;8607455403;Ne;0;3;0;3
9192;Rūta;SEKLYTĖLĖ;4168356825;Ne;0;3;0;3
9193;Rūta;SEKLYTĖLĖ;9569447586;Ne;0;3;0;3
9194;Rūta;SEKLYTĖLĖ;2677062861;Ne;0;2;0;2
9195;Rūta;SEKLYTĖLĖ;1390207547;Ne;0;1;0;1
9196;Rūta;SEKLYTĖLĖ;32004750783;Ne;4;6;0;10
9197;Rūta;SEKLYTĖLĖ;5866619097;Ne;1;0;0;1
9198;Rūta;SEKLYTĖLĖ;2912054049;Ne;5;3;0;8
9199;Rūta;"VARPELIAI (LOGOPEDINĖ)";3055294324;Ne;0;0;11;11
9200;Rūta;"VARPELIAI (LOGOPEDINĖ)";3810636967;Ne;10;0;0;10
9201;Rūta;"VARPELIAI (LOGOPEDINĖ)";8992775168;Ne;0;0;8;8
9202;Rūta;"VARPELIAI (LOGOPEDINĖ)";8026402652;Ne;5;1;0;6
9203;Rūta;"VARPELIAI (LOGOPEDINĖ)";2584812163;Ne;4;0;0;4
9204;Rūta;"VARPELIAI (LOGOPEDINĖ)";6032985748;Ne;0;7;0;7
9205;Rūta;"VARPELIAI (LOGOPEDINĖ)";4858914868;Ne;5;0;0;5
9206;Rūta;KIŠKUČIŲ;7837861265;Ne;0;0;3;3
9207;Rūta;KIŠKUČIŲ;2601011765;Taip;0;0;16;16
9208;Rūta;KIŠKUČIŲ;5579794648;Ne;0;5;0;5
9209;Rūta;KIŠKUČIŲ;4165080541;Ne;4;0;3;7
9210;Rūta;KIŠKUČIŲ;3877807687;Ne;11;0;2;13
9211;Rūta;KIŠKUČIŲ;9429856388;Ne;0;0;2;2
9212;Rūta;KIŠKUČIŲ;8483916287;Ne;20;0;0;20
9213;Rūta;KIŠKUČIŲ;7724451685;Ne;0;5;0;5
9214;Rūta;KIŠKUČIŲ;2733932207;Taip;7;3;0;10
9215;Rūta;KIŠKUČIŲ;5902965224;Ne;7;0;0;7
9216;Rūta;KIŠKUČIŲ;9471291067;Ne;6;6;0;12
9217;Rūta;KIŠKUČIŲ;8012225409;Ne;1;0;0;1
9218;Rūta;KIŠKUČIŲ;1290867375;Ne;5;11;0;16
9219;Rūta;KIŠKUČIŲ;2084935094;Ne;10;0;0;10
9220;Rūta;KIŠKUČIŲ;8320791295;Ne;7;0;1;8
9221;Rūta;KIŠKUČIŲ;3109709043;Ne;10;0;6;16
9222;Rūta;KIŠKUČIŲ;2830990163;Ne;3;0;0;3
9223;Rūta;KIŠKUČIŲ;4780828296;Ne;0;0;4;4
9224;Rūta;ŽVIRBLIUKAI;3352007694;Ne;0;2;6;8
9225;Rūta;ŽVIRBLIUKAI;9243332756;Ne;0;8;0;8
9226;Rūta;ŽVIRBLIUKAI;1059126758;Ne;5;8;0;13
9227;Rūta;ŽVIRBLIUKAI;6417693659;Ne;0;0;7;7
9228;Rūta;ŽVIRBLIUKAI;4090915728;Ne;0;6;0;6
9229;Rūta;ŽVIRBLIUKAI;4466522924;Ne;0;3;5;8
9230;Rūta;ŽVIRBLIUKAI;7905893575;Ne;5;0;8;13
9231;Rūta;ŽVIRBLIUKAI;4436482805;Ne;0;1;0;1
9232;Rūta;ŽVIRBLIUKAI;1260386759;Ne;5;1;0;6
9233;Rūta;ŽVIRBLIUKAI;4208678278;Ne;5;0;0;5
9234;Rūta;ŽVIRBLIUKAI;6044060646;Ne;6;2;1;9
9235;Rūta;ŽVIRBLIUKAI;9220661972;Ne;0;8;0;8
9236;Rūta;ŽVIRBLIUKAI;5109026000;Ne;3;8;0;11
9237;Rūta;ŽVIRBLIUKAI;4776631890;Ne;0;0;1;1
9238;Rūta;ŽVIRBLIUKAI;4440148328;Ne;0;2;3;5
9239;Rūta;ŽVIRBLIUKAI;1671179652;Ne;7;0;1;8
9240;Rūta;ŽVIRBLIUKAI;1152453609;Ne;0;2;0;2
9241;Rūta;ŽVIRBLIUKAI;9012256437;Ne;6;0;0;6
9242;Rūta;SAULUTĖS;6585842434;Ne;0;3;4;7
9243;Rūta;SAULUTĖS;6620957022;Taip;8;0;0;8
9244;Rūta;SAULUTĖS;8806743371;Ne;7;0;0;7
9245;Rūta;SAULUTĖS;8320521011;Ne;0;0;2;2
9246;Rūta;SAULUTĖS;2391120026;Ne;5;5;2;12
9247;Rūta;SAULUTĖS;3765741047;Ne;0;0;2;2
9248;Rūta;SAULUTĖS;7762509383;Ne;0;1;2;3
9249;Rūta;SAULUTĖS;2685515977;Ne;14;1;5;20
9250;Rūta;SAULUTĖS;5512946296;Ne;5;4;0;9
9251;Rūta;SAULUTĖS;9308127402;Ne;0;0;6;6
9252;Rūta;SAULUTĖS;7422059414;Taip;14;4;0;18
9253;Rūta;SAULUTĖS;6186413364;Ne;0;2;0;2
9254;Rūta;SAULUTĖS;8571905994;Ne;4;0;0;4
9255;Rūta;SAULUTĖS;8479424939;Ne;14;5;0;19
9256;Rūta;SAULUTĖS;9014433476;Ne;0;7;0;7
9257;Rūta;SAULUTĖS;1207463357;Ne;9;0;0;9
9258;Rūta;SAULUTĖS;1131910047;Ne;0;17;0;17
9259;Sadutė;Kiškučiai;6645848193;Ne;2;5;1;8
9260;Sadutė;Kiškučiai;1589424708;Ne;6;9;4;19
9261;Sadutė;Kiškučiai;5992865266;Ne;9;7;0;16
9262;Sadutė;Kiškučiai;3568132830;Ne;0;32;0;32
9263;Sadutė;Kiškučiai;2087489114;Ne;7;0;1;8
9264;Sadutė;Kiškučiai;6652070415;Ne;0;24;0;24
9265;Sadutė;Kiškučiai;4360361866;Ne;0;1;1;2
9266;Sadutė;Kiškučiai;2139177648;Ne;6;9;0;15
9267;Sadutė;Kiškučiai;6493110772;Ne;6;0;0;6
9268;Sadutė;Kiškučiai;8397295024;Ne;5;0;0;5
9269;Sadutė;Kiškučiai;4075714061;Ne;0;5;0;5
9270;Sadutė;Kiškučiai;3285448692;Ne;0;0;3;3
9271;Sadutė;Kiškučiai;2845125335;Ne;0;0;6;6
9272;Sadutė;Kiškučiai;4135398332;Ne;7;6;0;13
9273;Sadutė;Kiškučiai;3954151590;Ne;2;11;0;13
9274;Sadutė;Kiškučiai;1860645542;Ne;16;9;0;25
9275;Sadutė;Kiškučiai;2472471722;Ne;0;1;1;2
9276;Sadutė;Boružėlės;9115304973;Ne;0;0;7;7
9277;Sadutė;Boružėlės;1273355194;Ne;0;5;0;5
9278;Sadutė;Boružėlės;3119547420;Ne;0;5;0;5
9279;Sadutė;Boružėlės;8987528237;Ne;0;0;1;1
9280;Sadutė;Boružėlės;6994383907;Ne;7;0;0;7
9281;Sadutė;Boružėlės;7242188081;Ne;0;0;2;2
9282;Sadutė;Boružėlės;3244211391;Ne;0;0;2;2
9283;Sadutė;Boružėlės;3875265137;Ne;0;0;1;1
9284;Sadutė;Boružėlės;5992119777;Ne;0;8;0;8
9285;Sadutė;Boružėlės;5682745869;Ne;0;0;1;1
9286;Sadutė;Boružėlės;5579040052;Ne;0;0;3;3
9287;Sadutė;Boružėlės;3362830536;Ne;0;0;3;3
9288;Sadutė;Boružėlės;5395676303;Ne;2;15;0;17
9289;Sadutė;Boružėlės;1923014145;Ne;0;0;8;8
9290;Sadutė;Boružėlės;5698462283;Ne;0;0;7;7
9291;Sadutė;Boružėlės;3845369333;Ne;0;0;20;20
9292;Sadutė;Boružėlės;8200891038;Ne;0;3;0;3
9293;Sadutė;Bitutės;1759479328;Ne;0;1;5;6
9294;Sadutė;Bitutės;4245873513;Ne;4;4;1;9
9295;Sadutė;Bitutės;1873928395;Ne;4;1;1;6
9296;Sadutė;Bitutės;5866461096;Ne;4;6;0;10
9297;Sadutė;Bitutės;4883934480;Ne;7;1;0;8
9298;Sadutė;Bitutės;7097653016;Ne;0;1;2;3
9299;Sadutė;Bitutės;4479315578;Ne;2;1;0;3
9300;Sadutė;Bitutės;2020766695;Ne;0;22;0;22
9301;Sadutė;Bitutės;5011320850;Ne;0;6;5;11
9302;Sadutė;Bitutės;4161502667;Ne;0;1;2;3
9303;Sadutė;Bitutės;5973513916;Ne;6;2;0;8
9304;Sadutė;Bitutės;5169694660;Ne;0;1;0;1
9305;Sadutė;Bitutės;3361904803;Ne;12;0;1;13
9306;Sadutė;Bitutės;2355177889;Ne;3;0;0;3
9307;Sadutė;Bitutės;8556086501;Ne;9;2;0;11
9308;Sadutė;Bitutės;6066145909;Ne;0;1;7;8
9309;Sadutė;Bitutės;5142566738;Ne;9;1;3;13
9310;Sadutė;Bitutės;8662375739;Ne;0;1;3;4
9311;Sadutė;Bitutės;9692905987;Ne;11;0;2;13
9312;Sadutė;Bitutės;9107727583;Ne;0;5;2;7
9313;Sadutė;Bitutės;6138604955;Ne;6;0;0;6
9314;Sadutė;Drugeliai;9090754149;Ne;0;1;1;2
9315;Sadutė;Drugeliai;1552350084;Ne;0;5;1;6
9316;Sadutė;Drugeliai;7910380894;Ne;1;0;0;1
9317;Sadutė;Drugeliai;4402558234;Ne;0;2;0;2
9318;Sadutė;Drugeliai;6994547344;Ne;0;0;1;1
9319;Sadutė;Drugeliai;1782594187;Ne;2;10;0;12
9320;Sadutė;Drugeliai;5816844295;Ne;0;0;2;2
9321;Sadutė;Drugeliai;8803249656;Ne;3;4;1;8
9322;Sadutė;Drugeliai;6196282159;Ne;11;1;0;12
9323;Sadutė;Drugeliai;5139219626;Ne;0;3;0;3
9324;Sadutė;Drugeliai;1735450955;Ne;0;1;0;1
9325;Sadutė;Drugeliai;2064784580;Ne;0;1;0;1
9326;Sadutė;Drugeliai;2883991326;Ne;0;3;0;3
9327;Sadutė;Drugeliai;7731164484;Ne;0;8;0;8
9328;Sadutė;Drugeliai;6124376554;Ne;0;0;2;2
9329;Sadutė;Drugeliai;36769610742;Ne;0;0;2;2
9330;Sadutė;Drugeliai;4623727349;Ne;7;1;0;8
9331;Sadutė;Drugeliai;7940706717;Ne;0;0;1;1
9332;Sadutė;Pėledžiukai;5616756293;Ne;0;22;0;22
9333;Sadutė;Pėledžiukai;2705458480;Ne;0;0;2;2
9334;Sadutė;Pėledžiukai;6314488650;Ne;0;0;1;1
9335;Sadutė;Pėledžiukai;6716550703;Ne;10;0;0;10
9336;Sadutė;Pėledžiukai;8914706717;Ne;0;0;3;3
9337;Sadutė;Pėledžiukai;6379705269;Ne;0;7;2;9
9338;Sadutė;Pėledžiukai;5385678913;Ne;7;0;0;7
9339;Sadutė;Pėledžiukai;2055127699;Ne;5;0;2;7
9340;Sadutė;Pėledžiukai;2747256989;Ne;0;0;2;2
9341;Sadutė;Pėledžiukai;3277826759;Ne;0;0;3;3
9342;Sadutė;Pėledžiukai;2003300961;Ne;5;0;0;5
9343;Sadutė;Kačiukų;1507052440;Ne;0;7;0;7
9344;Sadutė;Kačiukų;1903961488;Ne;0;0;11;11
9345;Sadutė;Kačiukų;3993181500;Ne;0;0;2;2
9346;Sadutė;Kačiukų;8835627470;Ne;0;6;0;6
9347;Sadutė;Kačiukų;2532626934;Ne;0;1;0;1
9348;Sadutė;Kačiukų;2466024649;Ne;0;2;0;2
9349;Sadutė;Kačiukų;5438448926;Ne;0;0;1;1
9350;Sadutė;Kačiukų;8974374101;Ne;2;0;3;5
9351;Sadutė;Kačiukų;4401870028;Ne;0;0;3;3
9352;Sadutė;Kačiukų;3927044011;Taip;0;0;3;3
9353;Sadutė;Kačiukų;8974225608;Ne;5;0;0;5
9354;Sadutė;Kačiukų;8770727233;Ne;0;0;4;4
9355;Sadutė;Kačiukų;8556218971;Ne;0;5;2;7
9356;Sadutė;Kačiukų;5267093203;Ne;0;0;18;18
9357;Sadutė;Kačiukų;5614758320;Ne;0;12;0;12
9358;Sadutė;Kačiukų;2194387139;Ne;0;2;0;2
9359;Sakalėlis;GIRINUKŲ;9566176151;Ne;14;0;0;14
9360;Sakalėlis;GIRINUKŲ;5405669698;Ne;4;1;1;6
9361;Sakalėlis;GIRINUKŲ;2474164013;Ne;5;1;0;6
9362;Sakalėlis;GIRINUKŲ;9493905856;Ne;0;0;3;3
9363;Sakalėlis;GIRINUKŲ;5496044442;Ne;5;0;0;5
9364;Sakalėlis;GIRINUKŲ;3165387995;Ne;5;0;1;6
9365;Sakalėlis;GIRINUKŲ;6603105354;Ne;0;0;5;5
9366;Sakalėlis;GIRINUKŲ;3418702674;Ne;0;5;1;6
9367;Sakalėlis;GIRINUKŲ;3748865437;Ne;0;0;3;3
9368;Sakalėlis;GIRINUKŲ;6700169944;Ne;0;0;2;2
9369;Sakalėlis;GIRINUKŲ;4596727938;Ne;0;2;0;2
9370;Sakalėlis;GIRINUKŲ;8790189865;Ne;5;0;0;5
9371;Sakalėlis;GIRINUKŲ;4209146744;Ne;0;2;0;2
9372;Sakalėlis;GIRINUKŲ;1347171934;Ne;19;0;0;19
9373;Sakalėlis;GIRINUKŲ;9250470549;Ne;0;4;0;4
9374;Sakalėlis;VYTURIUKŲ;3927487265;Ne;0;7;0;7
9375;Sakalėlis;VYTURIUKŲ;2352118061;Ne;0;2;0;2
9376;Sakalėlis;VYTURIUKŲ;3680732318;Ne;0;7;0;7
9377;Sakalėlis;VYTURIUKŲ;8422299669;Ne;10;0;3;13
9378;Sakalėlis;VYTURIUKŲ;6579827280;Ne;0;12;0;12
9379;Sakalėlis;VYTURIUKŲ;8381310908;Ne;5;0;2;7
9380;Sakalėlis;VYTURIUKŲ;6840368824;Ne;16;0;1;17
9381;Sakalėlis;VYTURIUKŲ;7285833058;Ne;0;0;2;2
9382;Sakalėlis;VYTURIUKŲ;2985239904;Ne;11;0;0;11
9383;Sakalėlis;VYTURIUKŲ;9120873899;Ne;5;0;8;13
9384;Sakalėlis;VYTURIUKŲ;4136266629;Ne;0;0;11;11
9385;Sakalėlis;VYTURIUKŲ;5991029760;Taip;0;0;10;10
9386;Sakalėlis;VYTURIUKŲ;6378711142;Ne;9;0;0;9
9387;Sakalėlis;VYTURIUKŲ;1736303381;Ne;0;10;0;10
9388;Sakalėlis;VYTURIUKŲ;7280513854;Ne;0;0;4;4
9389;Sakalėlis;DRUGELIŲ;8095359035;Ne;8;5;5;18
9390;Sakalėlis;DRUGELIŲ;6515519140;Ne;12;9;0;21
9391;Sakalėlis;DRUGELIŲ;7706606275;Ne;0;6;0;6
9392;Sakalėlis;DRUGELIŲ;5911341542;Ne;8;0;0;8
9393;Sakalėlis;DRUGELIŲ;9272347788;Ne;0;7;0;7
9394;Sakalėlis;DRUGELIŲ;9416737436;Ne;0;10;0;10
9395;Sakalėlis;DRUGELIŲ;2898006208;Ne;0;15;0;15
9396;Sakalėlis;DRUGELIŲ;7542322748;Ne;22;0;0;22
9397;Sakalėlis;DRUGELIŲ;4918228191;Ne;0;5;0;5
9398;Sakalėlis;DRUGELIŲ;1201086815;Ne;13;0;0;13
9399;Sakalėlis;DRUGELIŲ;3934295338;Ne;0;0;2;2
9400;Sakalėlis;DRUGELIŲ;1117800518;Ne;10;0;2;12
9401;Sakalėlis;DRUGELIŲ;2515169899;Ne;0;0;1;1
9402;Sakalėlis;DRUGELIŲ;8160589611;Ne;0;3;0;3
9403;Sakalėlis;DRUGELIŲ;9836193857;Ne;5;0;1;6
9404;Sakalėlis;DRUGELIŲ;4004006771;Ne;13;0;1;14
9405;Sakalėlis;DRUGELIŲ;1833573491;Ne;5;0;0;5
9406;Sakalėlis;DRUGELIŲ;8713298648;Ne;0;5;0;5
9407;Sakalėlis;DRUGELIŲ;2889638745;Ne;0;0;2;2
9408;Sakalėlis;DRUGELIŲ;7540098033;Ne;0;0;7;7
9409;Sakalėlis;GENIUKŲ;4763858893;Ne;0;0;6;6
9410;Sakalėlis;GENIUKŲ;3337299648;Ne;2;0;1;3
9411;Sakalėlis;GENIUKŲ;9830907922;Ne;5;4;0;9
9412;Sakalėlis;GENIUKŲ;43677485606;Ne;0;4;1;5
9413;Sakalėlis;GENIUKŲ;8649226611;Ne;0;0;2;2
9414;Sakalėlis;GENIUKŲ;5717022080;Ne;8;0;1;9
9415;Sakalėlis;GENIUKŲ;4515180509;Ne;0;0;1;1
9416;Sakalėlis;GENIUKŲ;1027765680;Ne;0;6;0;6
9417;Sakalėlis;GENIUKŲ;81681433432;Ne;0;0;3;3
9418;Sakalėlis;GENIUKŲ;96053733139;Ne;0;0;2;2
9419;Sakalėlis;GENIUKŲ;4612388683;Ne;0;8;0;8
9420;Sakalėlis;GENIUKŲ;7159705304;Ne;0;1;1;2
9421;Sakalėlis;GENIUKŲ;4775685174;Ne;4;0;2;6
9422;Sakalėlis;GENIUKŲ;69916351348;Ne;0;0;5;5
9423;Sakalėlis;GENIUKŲ;8936933971;Ne;0;0;7;7
9424;Sakalėlis;GENIUKŲ;3371763993;Ne;2;8;2;12
9425;Sakalėlis;GENIUKŲ;7085108710;Ne;4;0;0;4
9426;Sakalėlis;GENIUKŲ;36670171187;Taip;0;0;5;5
9427;Sakalėlis;GENIUKŲ;6301366135;Ne;0;5;0;5
9428;Sakalėlis;GENIUKŲ;4364341933;Ne;5;0;6;11
9429;Sakalėlis;VOVERIUKŲ;5172421763;Ne;0;0;5;5
9430;Sakalėlis;VOVERIUKŲ;5233697077;Ne;11;0;1;12
9431;Sakalėlis;VOVERIUKŲ;6414564366;Taip;22;0;0;22
9432;Sakalėlis;VOVERIUKŲ;4358313171;Ne;5;0;5;10
9433;Sakalėlis;VOVERIUKŲ;6806170544;Ne;0;0;6;6
9434;Sakalėlis;VOVERIUKŲ;2557089391;Ne;7;4;0;11
9435;Sakalėlis;VOVERIUKŲ;8133985842;Ne;0;0;1;1
9436;Sakalėlis;VOVERIUKŲ;3574956316;Ne;3;1;0;4
9437;Sakalėlis;VOVERIUKŲ;1403384561;Ne;2;0;7;9
9438;Sakalėlis;VOVERIUKŲ;3927363997;Ne;0;14;0;14
9439;Sakalėlis;VOVERIUKŲ;6293226507;Ne;10;2;1;13
9440;Sakalėlis;VOVERIUKŲ;2699844937;Ne;0;6;0;6
9441;Sakalėlis;VOVERIUKŲ;1273843302;Ne;2;0;4;6
9442;Sakalėlis;VOVERIUKŲ;6217643065;Ne;7;0;6;13
9443;Sakalėlis;VOVERIUKŲ;1669610397;Ne;5;0;10;15
9444;Sakalėlis;VOVERIUKŲ;4344537391;Ne;0;0;5;5
9445;Sakalėlis;VOVERIUKŲ;6016854405;Ne;0;6;0;6
9446;Sakalėlis;VOVERIUKŲ;2531146677;Ne;5;0;1;6
9447;Sakalėlis;VOVERIUKŲ;4968216193;Ne;0;0;3;3
9448;Sakalėlis;PĖLEDŽIUKŲ;1133377117;Ne;0;0;1;1
9449;Sakalėlis;PĖLEDŽIUKŲ;6190741162;Ne;0;7;0;7
9450;Sakalėlis;PĖLEDŽIUKŲ;4430763418;Ne;0;13;0;13
9451;Sakalėlis;PĖLEDŽIUKŲ;1104881142;Ne;0;0;3;3
9452;Sakalėlis;PĖLEDŽIUKŲ;6321575268;Ne;0;1;0;1
9453;Sakalėlis;PĖLEDŽIUKŲ;1702964714;Ne;0;7;1;8
9454;Sakalėlis;PĖLEDŽIUKŲ;30987215315;Ne;0;0;5;5
9455;Sakalėlis;PĖLEDŽIUKŲ;2796230671;Ne;0;0;5;5
9456;Sakalėlis;PĖLEDŽIUKŲ;3962436122;Ne;0;4;0;4
9457;Sakalėlis;PĖLEDŽIUKŲ;1912068116;Ne;7;0;0;7
9458;Sakalėlis;PĖLEDŽIUKŲ;34464485043;Ne;5;0;2;7
9459;Sakalėlis;PĖLEDŽIUKŲ;5782214279;Ne;5;0;1;6
9460;Sakalėlis;PĖLEDŽIUKŲ;8852001037;Ne;0;0;5;5
9461;Sakalėlis;PĖLEDŽIUKŲ;6180987643;Ne;0;0;3;3
9462;Sakalėlis;PĖLEDŽIUKŲ;3678172501;Ne;0;4;0;4
9463;Sakalėlis;PĖLEDŽIUKŲ;7567476424;Ne;6;0;1;7
9464;Sakalėlis;PĖLEDŽIUKŲ;1839096675;Ne;0;3;0;3
9465;Sakalėlis;PĖLEDŽIUKŲ;5884781964;Ne;2;0;1;3
9466;Sakalėlis;PĖLEDŽIUKŲ;4495453007;Ne;0;0;4;4
9467;Sakalėlis;"BITUČIŲ (LOGOPEDINĖ)";7241416465;Ne;5;0;2;7
9468;Sakalėlis;"BITUČIŲ (LOGOPEDINĖ)";8610668395;Ne;0;11;1;12
9469;Sakalėlis;"BITUČIŲ (LOGOPEDINĖ)";1723436498;Ne;0;0;2;2
9470;Sakalėlis;"BITUČIŲ (LOGOPEDINĖ)";3938470708;Ne;2;0;1;3
9471;Sakalėlis;"BITUČIŲ (LOGOPEDINĖ)";5376872141;Ne;15;0;0;15
9472;Sakalėlis;"BITUČIŲ (LOGOPEDINĖ)";4303490614;Ne;17;0;0;17
9473;Sakalėlis;"BORUŽIUKŲ (LOGOPEDINĖ)";4514546151;Ne;0;1;0;1
9474;Sakalėlis;"BORUŽIUKŲ (LOGOPEDINĖ)";3972897839;Ne;2;0;5;7
9475;Sakalėlis;"BORUŽIUKŲ (LOGOPEDINĖ)";2124857941;Ne;0;2;0;2
9476;Sakalėlis;"BORUŽIUKŲ (LOGOPEDINĖ)";1806698668;Ne;5;0;1;6
9477;Sakalėlis;"BORUŽIUKŲ (LOGOPEDINĖ)";6727251397;Ne;0;1;0;1
9478;Sakalėlis;"BORUŽIUKŲ (LOGOPEDINĖ)";6250400609;Ne;0;0;3;3
9479;Sakalėlis;"BORUŽIUKŲ (LOGOPEDINĖ)";6222204020;Ne;0;0;2;2
9480;Sakalėlis;"BORUŽIUKŲ (LOGOPEDINĖ)";7602249339;Ne;7;0;0;7
9481;Sakalėlis;"BORUŽIUKŲ (LOGOPEDINĖ)";8263169658;Ne;10;0;1;11
9482;Sakalėlis;MEŠKUČIŲ;9546779717;Ne;14;6;2;22
9483;Sakalėlis;MEŠKUČIŲ;8535457018;Ne;0;3;0;3
9484;Sakalėlis;MEŠKUČIŲ;7154383856;Ne;22;0;0;22
9485;Sakalėlis;MEŠKUČIŲ;5082756444;Taip;0;5;0;5
9486;Sakalėlis;MEŠKUČIŲ;7839893402;Ne;6;0;1;7
9487;Sakalėlis;MEŠKUČIŲ;3092760315;Ne;0;8;0;8
9488;Sakalėlis;MEŠKUČIŲ;3524545708;Ne;0;10;0;10
9489;Sakalėlis;MEŠKUČIŲ;5961207419;Ne;0;6;0;6
9490;Sakalėlis;MEŠKUČIŲ;2389541483;Taip;10;1;0;11
9491;Sakalėlis;MEŠKUČIŲ;4063074948;Ne;3;0;0;3
9492;Sakalėlis;MEŠKUČIŲ;8108456923;Ne;15;0;0;15
9493;Sakalėlis;MEŠKUČIŲ;7285230768;Ne;0;1;0;1
9494;Sakalėlis;MEŠKUČIŲ;2090313887;Ne;17;0;0;17
9495;Sakalėlis;MEŠKUČIŲ;9794245922;Ne;0;0;4;4
9496;Sakalėlis;MEŠKUČIŲ;8106231242;Ne;0;6;0;6
9497;Sakalėlis;MEŠKUČIŲ;4520212128;Ne;0;8;0;8
9498;Sakalėlis;MEŠKUČIŲ;7228559861;Ne;0;11;0;11
9499;Sakalėlis;MEŠKUČIŲ;1208798798;Ne;5;0;0;5
9500;Sakalėlis;KIŠKUČIŲ;2505477059;Ne;0;6;2;8
9501;Sakalėlis;KIŠKUČIŲ;1004062550;Ne;10;0;0;10
9502;Sakalėlis;KIŠKUČIŲ;5865993835;Ne;8;0;1;9
9503;Sakalėlis;KIŠKUČIŲ;2003090775;Ne;0;0;1;1
9504;Sakalėlis;KIŠKUČIŲ;8228039819;Ne;3;0;0;3
9505;Sakalėlis;KIŠKUČIŲ;7006304327;Ne;0;0;4;4
9506;Sakalėlis;KIŠKUČIŲ;6029443196;Ne;22;0;0;22
9507;Sakalėlis;KIŠKUČIŲ;4633296169;Ne;6;0;0;6
9508;Sakalėlis;KIŠKUČIŲ;4611384179;Ne;10;2;1;13
9509;Sakalėlis;KIŠKUČIŲ;4490632523;Ne;11;0;0;11
9510;Sakalėlis;KIŠKUČIŲ;8015985605;Ne;7;10;0;17
9511;Sakalėlis;KIŠKUČIŲ;5052638078;Ne;2;0;3;5
9512;Sakalėlis;KIŠKUČIŲ;5327382009;Ne;2;0;3;5
9513;Sakalėlis;KIŠKUČIŲ;6897550418;Ne;2;9;2;13
9514;Sakalėlis;KIŠKUČIŲ;9642519454;Ne;5;0;0;5
9515;Sakalėlis;KIŠKUČIŲ;5387119771;Taip;15;0;1;16
9516;Sakalėlis;KIŠKUČIŲ;6328924318;Ne;5;0;1;6
9517;Sakalėlis;KIŠKUČIŲ;8868588637;Taip;2;0;11;13
9518;Sakalėlis;SVIRPLIUKŲ;6597274376;Ne;4;7;0;11
9519;Sakalėlis;SVIRPLIUKŲ;5500248048;Ne;4;1;2;7
9520;Sakalėlis;SVIRPLIUKŲ;8562164673;Ne;6;1;1;8
9521;Sakalėlis;SVIRPLIUKŲ;2537030533;Ne;0;0;5;5
9522;Sakalėlis;SVIRPLIUKŲ;3570413330;Ne;0;0;6;6
9523;Sakalėlis;SVIRPLIUKŲ;6889888573;Ne;0;0;1;1
9524;Sakalėlis;SVIRPLIUKŲ;7852255204;Ne;4;0;1;5
9525;Sakalėlis;SVIRPLIUKŲ;1253452975;Ne;5;0;1;6
9526;Sakalėlis;SVIRPLIUKŲ;8328069876;Ne;0;0;5;5
9527;Sakalėlis;SVIRPLIUKŲ;7480286509;Ne;0;0;2;2
9528;Sakalėlis;SVIRPLIUKŲ;2250828607;Ne;5;1;6;12
9529;Sakalėlis;SVIRPLIUKŲ;2672429406;Ne;6;1;5;12
9530;Sakalėlis;SVIRPLIUKŲ;6851247779;Ne;4;0;0;4
9531;Sakalėlis;SVIRPLIUKŲ;9776767584;Ne;14;0;2;16
9532;Sakalėlis;SVIRPLIUKŲ;1121818878;Ne;3;0;0;3
9533;Sakalėlis;SVIRPLIUKŲ;5465596207;Taip;3;0;0;3
9534;Sakalėlis;SVIRPLIUKŲ;2233966176;Ne;0;0;10;10
9535;Sakalėlis;SVIRPLIUKŲ;7079300418;Ne;0;0;5;5
9536;Sakalėlis;SVIRPLIUKŲ;8659925528;Ne;6;0;4;10
9537;Sakalėlis;GANDRIUKŲ;8502289806;Ne;0;3;0;3
9538;Sakalėlis;GANDRIUKŲ;9368758708;Ne;9;0;0;9
9539;Sakalėlis;GANDRIUKŲ;8326977226;Ne;5;0;0;5
9540;Sakalėlis;GANDRIUKŲ;7384400795;Ne;4;12;0;16
9541;Sakalėlis;GANDRIUKŲ;3644413861;Ne;4;0;0;4
9542;Sakalėlis;GANDRIUKŲ;4576495786;Ne;0;2;1;3
9543;Sakalėlis;GANDRIUKŲ;4230762388;Taip;2;11;0;13
9544;Sakalėlis;GANDRIUKŲ;2734462553;Ne;5;0;0;5
9545;Sakalėlis;GANDRIUKŲ;7345113972;Ne;0;6;0;6
9546;Sakalėlis;GANDRIUKŲ;6069544792;Ne;0;0;4;4
9547;Sakalėlis;GANDRIUKŲ;8869621812;Ne;2;0;0;2
9548;Sakalėlis;GANDRIUKŲ;5460619168;Ne;15;0;0;15
9549;Salininkų;BORUŽIUKAI;8329495685;Ne;5;0;0;5
9550;Salininkų;BORUŽIUKAI;1005025619;Ne;3;8;0;11
9551;Salininkų;BORUŽIUKAI;3925860408;Ne;10;1;0;11
9552;Salininkų;BORUŽIUKAI;2146404021;Ne;0;2;0;2
9553;Salininkų;BORUŽIUKAI;8718514114;Ne;15;0;0;15
9554;Salininkų;BORUŽIUKAI;8930622266;Ne;0;9;0;9
9555;Salininkų;BORUŽIUKAI;5447236646;Ne;12;1;1;14
9556;Salininkų;BORUŽIUKAI;2208793412;Ne;0;12;0;12
9557;Salininkų;BORUŽIUKAI;5045064069;Ne;1;0;0;1
9558;Salininkų;BORUŽIUKAI;1647401700;Ne;22;0;0;22
9559;Salininkų;BORUŽIUKAI;9817285587;Ne;9;0;0;9
9560;Salininkų;BORUŽIUKAI;8823595510;Ne;0;1;0;1
9561;Salininkų;BORUŽIUKAI;9416926474;Ne;19;1;0;20
9562;Salininkų;BORUŽIUKAI;1254843449;Ne;5;5;0;10
9563;Salininkų;BORUŽIUKAI;3231379271;Ne;25;1;0;26
9564;Salininkų;BORUŽIUKAI;1346133493;Ne;0;2;0;2
9565;Salininkų;BORUŽIUKAI;2273407270;Ne;0;2;0;2
9566;Salininkų;BORUŽIUKAI;9855014750;Ne;6;0;2;8
9567;Salininkų;BORUŽIUKAI;8911016037;Ne;7;2;0;9
9568;Salininkų;GĖLYTĖS;8602489420;Ne;3;7;0;10
9569;Salininkų;GĖLYTĖS;2895782373;Ne;8;3;0;11
9570;Salininkų;GĖLYTĖS;4971070998;Ne;0;0;4;4
9571;Salininkų;GĖLYTĖS;9893985732;Ne;6;5;0;11
9572;Salininkų;GĖLYTĖS;3686372180;Ne;11;0;0;11
9573;Salininkų;GĖLYTĖS;9892443649;Ne;0;1;0;1
9574;Salininkų;GĖLYTĖS;3703729963;Ne;5;2;3;10
9575;Salininkų;GĖLYTĖS;3338213592;Ne;0;4;0;4
9576;Salininkų;GĖLYTĖS;6506819265;Ne;3;1;0;4
9577;Salininkų;GĖLYTĖS;6510096414;Ne;0;7;0;7
9578;Salininkų;GĖLYTĖS;2491796874;Ne;0;6;0;6
9579;Salininkų;GĖLYTĖS;3464228778;Ne;10;0;0;10
9580;Salininkų;GĖLYTĖS;8141168894;Ne;1;5;0;6
9581;Salininkų;GĖLYTĖS;2440831687;Ne;0;9;0;9
9582;Salininkų;GĖLYTĖS;1284909139;Ne;2;6;0;8
9583;Salininkų;GĖLYTĖS;5164367382;Ne;17;2;0;19
9584;Salininkų;GĖLYTĖS;2798153926;Ne;0;3;0;3
9585;Salininkų;GĖLYTĖS;2726813574;Ne;0;0;1;1
9586;Salininkų;GĖLYTĖS;1453214735;Ne;2;0;0;2
9587;Salininkų;DRUGELIAI;2684868661;Ne;0;0;2;2
9588;Salininkų;DRUGELIAI;8063397588;Ne;0;0;3;3
9589;Salininkų;DRUGELIAI;4333027447;Ne;5;3;0;8
9590;Salininkų;DRUGELIAI;3115232507;Ne;20;0;0;20
9591;Salininkų;DRUGELIAI;2009246885;Ne;5;0;6;11
9592;Salininkų;DRUGELIAI;3420217477;Ne;5;0;1;6
9593;Salininkų;DRUGELIAI;3890914603;Ne;5;8;0;13
9594;Salininkų;DRUGELIAI;3181932118;Ne;4;7;0;11
9595;Salininkų;DRUGELIAI;3761217912;Ne;0;9;0;9
9596;Salininkų;DRUGELIAI;2208607684;Ne;7;2;0;9
9597;Salininkų;DRUGELIAI;3963410827;Ne;4;0;3;7
9598;Salininkų;DRUGELIAI;5539560359;Ne;3;1;9;13
9599;Salininkų;DRUGELIAI;5587577036;Ne;10;0;2;12
9600;Salininkų;DRUGELIAI;5375668400;Ne;0;3;0;3
9601;Salininkų;DRUGELIAI;4529253958;Ne;6;0;0;6
9602;Salininkų;DRUGELIAI;6786504670;Ne;0;1;0;1
9603;Salininkų;DRUGELIAI;7063718023;Ne;4;0;2;6
9604;Salininkų;DRUGELIAI;9018366347;Ne;9;0;0;9
9605;Salininkų;ŽIRNIUKAI;7643665643;Ne;3;3;0;6
9606;Salininkų;ŽIRNIUKAI;9198411540;Ne;9;1;0;10
9607;Salininkų;ŽIRNIUKAI;6885580632;Ne;0;7;0;7
9608;Salininkų;ŽIRNIUKAI;7409604480;Ne;0;4;0;4
9609;Salininkų;ŽIRNIUKAI;8095820690;Ne;0;0;1;1
9610;Salininkų;ŽIRNIUKAI;6482437251;Ne;0;2;0;2
9611;Salininkų;ŽIRNIUKAI;1380797788;Ne;0;5;0;5
9612;Salininkų;ŽIRNIUKAI;2495782496;Ne;0;2;4;6
9613;Salininkų;ŽIRNIUKAI;9896357816;Ne;19;0;0;19
9614;Salininkų;ŽIRNIUKAI;9137783249;Ne;12;3;0;15
9615;Salininkų;ŽIRNIUKAI;8524400656;Ne;11;3;0;14
9616;Salininkų;ŽIRNIUKAI;7463713798;Ne;5;7;0;12
9617;Salininkų;ŽIRNIUKAI;9617873735;Ne;2;1;0;3
9618;Salininkų;ŽIRNIUKAI;1111197633;Ne;0;1;0;1
9619;Salininkų;ŽIRNIUKAI;6143967744;Ne;10;0;0;10
9620;Salininkų;ŽIRNIUKAI;8552427446;Ne;0;0;3;3
9621;Salininkų;ŽIRNIUKAI;6586988786;Ne;0;0;7;7
9622;Salininkų;ŽIRNIUKAI;1587485662;Ne;7;0;0;7
9623;Salininkų;ŽIRNIUKAI;9611858211;Ne;12;0;3;15
9624;Salininkų;PAUKŠČIUKAI;7383557807;Ne;5;12;0;17
9625;Salininkų;BITUTĖS;3252151974;Ne;18;0;0;18
9626;Salininkų;BITUTĖS;6845471044;Ne;0;0;6;6
9627;Salininkų;BITUTĖS;7253347059;Ne;10;0;2;12
9628;Salininkų;BITUTĖS;2467926286;Ne;0;10;0;10
9629;Salininkų;BITUTĖS;9902751686;Ne;14;0;0;14
9630;Salininkų;BITUTĖS;6125152143;Ne;3;0;0;3
9631;Salininkų;BITUTĖS;2095952937;Ne;0;0;1;1
9632;Salininkų;BITUTĖS;6551489987;Ne;0;1;0;1
9633;Salininkų;BITUTĖS;3527495230;Ne;0;1;1;2
9634;Salininkų;BITUTĖS;5582091833;Taip;0;1;0;1
9635;Salininkų;BITUTĖS;9996809930;Ne;0;0;5;5
9636;Salininkų;BITUTĖS;3915336062;Ne;0;0;1;1
9637;Salininkų;BITUTĖS;7115888747;Ne;0;0;10;10
9638;Salininkų;BITUTĖS;7639362434;Ne;0;7;2;9
9639;Salininkų;BITUTĖS;2370778977;Ne;0;0;6;6
9640;Salininkų;BITUTĖS;1020073382;Ne;0;0;6;6
9641;Salininkų;BITUTĖS;4480303856;Ne;0;0;5;5
9642;Salininkų;"NAUJA (LOPŠELIS)";6315595048;Ne;4;0;0;4
9643;Salvija;Daigelis(šatil);1062662192;Ne;0;0;2;2
9644;Salvija;Daigelis(šatil);4577248630;Ne;0;14;0;14
9645;Salvija;Daigelis(šatil);9978634888;Ne;0;0;7;7
9646;Salvija;Daigelis(šatil);1676795179;Ne;7;0;2;9
9647;Salvija;Daigelis(šatil);6509829735;Ne;0;0;1;1
9648;Salvija;Daigelis(šatil);4665919836;Ne;4;0;0;4
9649;Salvija;Daigelis(šatil);1511271658;Ne;11;0;0;11
9650;Salvija;Daigelis(šatil);3345231579;Ne;22;0;0;22
9651;Salvija;Daigelis(šatil);3640213912;Ne;0;0;7;7
9652;Salvija;Daigelis(šatil);1509182157;Ne;0;0;7;7
9653;Salvija;Daigelis(šatil);8337554678;Ne;0;0;1;1
9654;Salvija;Daigelis(šatil);5327735648;Ne;5;0;7;12
9655;Salvija;Daigelis(šatil);6323383244;Ne;0;14;0;14
9656;Salvija;Daigelis(šatil);3857916185;Ne;7;0;6;13
9657;Salvija;Daigelis(šatil);4719344565;Ne;0;0;7;7
9658;Salvija;Daigelis(šatil);5554431690;Ne;0;0;12;12
9659;Salvija;Daigelis(šatil);1065575041;Ne;0;0;12;12
9660;Salvija;Daigelis(šatil);1168900211;Ne;7;0;0;7
9661;Salvija;Daigelis(šatil);7410091250;Ne;0;0;4;4
9662;Salvija;Daigelis(šatil);5761622263;Ne;4;0;2;6
9663;Salvija;Daigelis(šatil);6797777730;Ne;9;0;0;9
9664;Salvija;"Pienė (savjon)";5494438837;Ne;0;0;2;2
9665;Salvija;"Pienė (savjon)";8023422294;Ne;5;0;2;7
9666;Salvija;"Pienė (savjon)";4152602039;Ne;2;0;0;2
9667;Salvija;"Pienė (savjon)";8981331532;Ne;18;0;0;18
9668;Salvija;"Pienė (savjon)";8306404275;Ne;9;0;0;9
9669;Salvija;"Pienė (savjon)";8013023311;Ne;1;0;2;3
9670;Salvija;"Pienė (savjon)";1653831148;Ne;0;2;0;2
9671;Salvija;"Pienė (savjon)";8892646200;Ne;10;0;2;12
9672;Salvija;"Pienė (savjon)";7477171133;Ne;6;0;0;6
9673;Salvija;"Pienė (savjon)";6706565915;Ne;2;3;0;5
9674;Salvija;"Pienė (savjon)";8853389268;Ne;7;2;0;9
9675;Salvija;"Pienė (savjon)";3856351749;Ne;0;4;0;4
9676;Salvija;"Pienė (savjon)";8158680641;Ne;2;1;0;3
9677;Salvija;"Pienė (savjon)";3487446998;Ne;7;0;0;7
9678;Salvija;"Pienė (savjon)";4373711097;Ne;2;0;1;3
9679;Salvija;"Pienė (savjon)";5816893736;Ne;22;0;0;22
9680;Salvija;"Pienė (savjon)";1975032693;Ne;0;4;0;4
9681;Saulėtekis;BERŽELIS;3493175211;Ne;0;7;0;7
9682;Saulėtekis;BERŽELIS;8023603198;Ne;0;9;0;9
9683;Saulėtekis;BERŽELIS;8086451893;Ne;8;0;0;8
9684;Saulėtekis;BERŽELIS;9351122147;Ne;11;0;0;11
9685;Saulėtekis;BERŽELIS;6667804855;Ne;7;0;1;8
9686;Saulėtekis;BERŽELIS;1852180633;Ne;15;0;0;15
9687;Saulėtekis;BERŽELIS;5468364505;Ne;7;0;0;7
9688;Saulėtekis;BERŽELIS;4704426104;Ne;10;0;0;10
9689;Saulėtekis;BERŽELIS;7407540257;Ne;19;0;0;19
9690;Saulėtekis;BERŽELIS;6920619390;Ne;6;7;0;13
9691;Saulėtekis;BERŽELIS;5194925689;Ne;0;1;0;1
9692;Saulėtekis;BERŽELIS;7494641077;Ne;7;2;0;9
9693;Saulėtekis;BERŽELIS;1577609727;Ne;7;2;0;9
9694;Saulėtekis;BERŽELIS;2672108464;Ne;7;0;0;7
9695;Saulėtekis;BERŽELIS;9579088485;Ne;0;1;0;1
9696;Saulėtekis;BERŽELIS;2568544418;Ne;11;0;0;11
9697;Saulėtekis;BERŽELIS;8927598999;Ne;22;0;0;22
9698;Saulėtekis;BERŽELIS;9734188792;Ne;15;0;3;18
9699;Saulėtekis;BERŽELIS;6983324115;Ne;5;0;1;6
9700;Saulėtekis;BERŽELIS;8061477303;Ne;9;0;0;9
9701;Saulėtekis;BERŽELIS;7436158953;Ne;0;0;3;3
9702;Saulėtekis;BERŽELIS;7165739418;Ne;11;0;1;12
9703;Saulėtekis;ŠYPSENA;9972687066;Ne;1;1;4;6
9704;Saulėtekis;ŠYPSENA;7346852524;Ne;5;1;0;6
9705;Saulėtekis;ŠYPSENA;7893982893;Ne;0;5;2;7
9706;Saulėtekis;ŠYPSENA;7505040675;Ne;5;0;0;5
9707;Saulėtekis;ŠYPSENA;9791926936;Ne;0;0;5;5
9708;Saulėtekis;ŠYPSENA;8620689981;Ne;0;0;2;2
9709;Saulėtekis;ŠYPSENA;7673965242;Ne;15;0;0;15
9710;Saulėtekis;ŠYPSENA;3166959569;Ne;0;5;0;5
9711;Saulėtekis;ŠYPSENA;9661075465;Ne;0;10;0;10
9712;Saulėtekis;ŠYPSENA;9383567339;Taip;10;0;4;14
9713;Saulėtekis;ŠYPSENA;6608831217;Ne;7;0;0;7
9714;Saulėtekis;ŠYPSENA;7730889108;Ne;5;0;7;12
9715;Saulėtekis;ŠYPSENA;7435424899;Ne;17;0;1;18
9716;Saulėtekis;ŠYPSENA;9694119292;Ne;17;0;0;17
9717;Saulėtekis;ŠYPSENA;8881524909;Ne;5;0;3;8
9718;Saulėtekis;ŠYPSENA;5518726567;Ne;7;1;0;8
9719;Saulėtekis;ŠYPSENA;2177470008;Ne;0;0;1;1
9720;Saulėtekis;ŠYPSENA;4250589212;Ne;0;0;13;13
9721;Saulėtekis;ŠYPSENA;2686041419;Ne;0;0;4;4
9722;Saulėtekis;NYKŠTUKAI;1896847801;Ne;7;0;0;7
9723;Saulėtekis;NYKŠTUKAI;7849181976;Ne;0;3;0;3
9724;Saulėtekis;NYKŠTUKAI;5748816813;Ne;0;1;0;1
9725;Saulėtekis;NYKŠTUKAI;7555273745;Ne;5;0;0;5
9726;Saulėtekis;NYKŠTUKAI;1416983683;Ne;0;7;0;7
9727;Saulėtekis;NYKŠTUKAI;4758423356;Ne;0;5;0;5
9728;Saulėtekis;NYKŠTUKAI;9270109327;Ne;0;1;0;1
9729;Saulėtekis;NYKŠTUKAI;5183297420;Ne;12;1;0;13
9730;Saulėtekis;NYKŠTUKAI;8007704080;Ne;15;0;0;15
9731;Saulėtekis;NYKŠTUKAI;8683571534;Ne;7;3;0;10
9732;Saulėtekis;NYKŠTUKAI;9481578412;Ne;18;0;0;18
9733;Saulėtekis;NYKŠTUKAI;8167740525;Ne;12;0;0;12
9734;Saulėtekis;NYKŠTUKAI;3371045145;Ne;8;0;0;8
9735;Saulėtekis;NYKŠTUKAI;9818660340;Ne;22;0;0;22
9736;Saulėtekis;NYKŠTUKAI;3729811521;Ne;7;1;0;8
9737;Saulėtekis;NYKŠTUKAI;5888979911;Ne;0;5;0;5
9738;Saulėtekis;NYKŠTUKAI;9787534807;Ne;0;6;0;6
9739;Saulėtekis;NYKŠTUKAI;8090571664;Ne;15;0;0;15
9740;Saulėtekis;NYKŠTUKAI;9104549419;Ne;0;1;0;1
9741;Saulėtekis;NYKŠTUKAI;3957655772;Ne;18;0;0;18
9742;Saulėtekis;NYKŠTUKAI;3270283626;Ne;12;8;0;20
9743;Saulėtekis;PAGRANDUKAS;8102360466;Ne;0;0;5;5
9744;Saulėtekis;PAGRANDUKAS;2209156661;Ne;11;0;1;12
9745;Saulėtekis;PAGRANDUKAS;5552614092;Ne;5;0;0;5
9746;Saulėtekis;PAGRANDUKAS;9497129509;Ne;6;4;0;10
9747;Saulėtekis;PAGRANDUKAS;1020209414;Ne;9;0;0;9
9748;Saulėtekis;PAGRANDUKAS;8745921541;Ne;7;0;0;7
9749;Saulėtekis;PAGRANDUKAS;2728836108;Ne;0;0;5;5
9750;Saulėtekis;PAGRANDUKAS;7164579375;Ne;1;0;0;1
9751;Saulėtekis;PAGRANDUKAS;9941731250;Ne;0;2;0;2
9752;Saulėtekis;PAGRANDUKAS;4038684284;Ne;0;0;12;12
9753;Saulėtekis;PAGRANDUKAS;2935641362;Ne;15;2;0;17
9754;Saulėtekis;PAGRANDUKAS;7598254324;Ne;14;0;0;14
9755;Saulėtekis;PAGRANDUKAS;6026600803;Ne;7;0;0;7
9756;Saulėtekis;PAGRANDUKAS;9737568538;Ne;1;0;0;1
9757;Saulėtekis;PAGRANDUKAS;8468491266;Ne;10;0;0;10
9758;Saulėtekis;PAGRANDUKAS;6181992249;Ne;0;0;4;4
9759;Saulėtekis;PAGRANDUKAS;8390615573;Ne;7;0;0;7
9760;Saulėtekis;PAGRANDUKAS;3366064429;Ne;9;2;2;13
9761;Saulėtekis;PAGRANDUKAS;5824537129;Ne;7;0;1;8
9762;Saulėtekis;RAMUNĖLIŲ;8739919774;Ne;0;15;0;15
9763;Saulėtekis;RAMUNĖLIŲ;4681031693;Ne;0;0;4;4
9764;Saulėtekis;RAMUNĖLIŲ;2316817605;Ne;11;0;0;11
9765;Saulėtekis;RAMUNĖLIŲ;3987535802;Ne;15;0;0;15
9766;Saulėtekis;RAMUNĖLIŲ;5297650157;Ne;8;0;0;8
9767;Saulėtekis;RAMUNĖLIŲ;6979741482;Ne;9;0;0;9
9768;Saulėtekis;RAMUNĖLIŲ;8348456528;Ne;0;0;2;2
9769;Saulėtekis;RAMUNĖLIŲ;3430209353;Ne;0;1;0;1
9770;Saulėtekis;RAMUNĖLIŲ;5980690239;Ne;9;0;0;9
9771;Saulėtekis;RAMUNĖLIŲ;1427323748;Ne;11;0;0;11
9772;Saulėtekis;RAMUNĖLIŲ;3224110585;Ne;11;6;0;17
9773;Saulėtekis;RAMUNĖLIŲ;2002180753;Ne;12;0;0;12
9774;Saulėtekis;RAMUNĖLIŲ;5685176596;Ne;6;0;0;6
9775;Saulėtekis;RAMUNĖLIŲ;9668125862;Ne;0;0;3;3
9776;Saulėtekis;RAMUNĖLIŲ;4736430248;Ne;12;1;0;13
9777;Saulėtekis;RAMUNĖLIŲ;1108736588;Ne;11;0;0;11
9778;Saulėtekis;RAMUNĖLIŲ;3680199463;Ne;15;0;3;18
9779;Saulėtekis;RAMUNĖLIŲ;2383861394;Ne;0;10;0;10
9780;Saulėtekis;RAMUNĖLIŲ;2872732978;Ne;0;12;0;12
9781;Saulėtekis;RAMUNĖLIŲ;9732352141;Ne;15;0;0;15
9782;Saulėtekis;PASAKAITĖ;8033763960;Ne;0;1;0;1
9783;Saulėtekis;PASAKAITĖ;5086871001;Ne;0;6;0;6
9784;Saulėtekis;PASAKAITĖ;2446282019;Ne;3;3;0;6
9785;Saulėtekis;PASAKAITĖ;8572701238;Ne;2;4;0;6
9786;Saulėtekis;PASAKAITĖ;6063956790;Ne;0;1;0;1
9787;Saulėtekis;PASAKAITĖ;7407451018;Ne;0;5;0;5
9788;Saulėtekis;PASAKAITĖ;9226317303;Ne;0;4;0;4
9789;Saulėtekis;PASAKAITĖ;9267790598;Ne;0;2;9;11
9790;Saulėtekis;PASAKAITĖ;6670590135;Ne;0;1;0;1
9791;Saulėtekis;PASAKAITĖ;6720758829;Ne;4;3;0;7
9792;Saulėtekis;PASAKAITĖ;7966714585;Ne;5;0;0;5
9793;Saulėtekis;PASAKAITĖ;3224883243;Ne;10;0;0;10
9794;Saulėtekis;PASAKAITĖ;9382031144;Ne;0;8;0;8
9795;Saulėtekis;PASAKAITĖ;6214539956;Ne;5;0;0;5
9796;Saulėtekis;PASAKAITĖ;9584556476;Ne;0;2;0;2
9797;Saulėtekis;PASAKAITĖ;2469458604;Ne;3;7;0;10
9798;Saulėtekis;PASAKAITĖ;2206038658;Ne;5;2;2;9
9799;Saulėtekis;VARPELIAI;3303064486;Ne;6;0;3;9
9800;Saulėtekis;VARPELIAI;1355354514;Ne;0;12;5;17
9801;Saulėtekis;VARPELIAI;8195320453;Ne;11;0;1;12
9802;Saulėtekis;VARPELIAI;6534433593;Ne;5;0;0;5
9803;Saulėtekis;VARPELIAI;5997903066;Ne;0;0;9;9
9804;Saulėtekis;VARPELIAI;7338301696;Ne;9;0;4;13
9805;Saulėtekis;VARPELIAI;9383203972;Ne;2;0;2;4
9806;Saulėtekis;VARPELIAI;5870177112;Ne;4;0;1;5
9807;Saulėtekis;VARPELIAI;7171550857;Ne;10;0;4;14
9808;Saulėtekis;VARPELIAI;3157110037;Ne;10;2;2;14
9809;Saulėtekis;VARPELIAI;8331659142;Ne;11;0;0;11
9810;Saulėtekis;VARPELIAI;3832717108;Ne;13;0;0;13
9811;Saulėtekis;VARPELIAI;1198692142;Ne;11;0;0;11
9812;Saulėtekis;VARPELIAI;1240595768;Ne;10;0;0;10
9813;Saulėtekis;VARPELIAI;9246555859;Ne;10;0;1;11
9814;Saulėtekis;VARPELIAI;1479530265;Ne;6;0;5;11
9815;Saulėtekis;VARPELIAI;1164913351;Ne;5;0;1;6
9816;Saulėtekis;VARPELIAI;3499215193;Ne;7;0;1;8
9817;Saulėtekis;GRŪDELIS;1864236745;Ne;0;0;4;4
9818;Saulėtekis;GRŪDELIS;7171048750;Ne;7;4;0;11
9819;Saulėtekis;GRŪDELIS;6535620172;Ne;10;0;5;15
9820;Saulėtekis;GRŪDELIS;8252953405;Taip;11;0;2;13
9821;Saulėtekis;GRŪDELIS;8219644557;Ne;0;0;7;7
9822;Saulėtekis;GRŪDELIS;5161940030;Ne;5;0;0;5
9823;Saulėtekis;GRŪDELIS;5218345414;Ne;5;0;0;5
9824;Saulėtekis;GRŪDELIS;9646060606;Ne;9;0;0;9
9825;Saulėtekis;GRŪDELIS;1934900185;Ne;12;1;0;13
9826;Saulėtekis;GRŪDELIS;1331793286;Taip;14;0;6;20
9827;Saulėtekis;GRŪDELIS;9995919137;Ne;13;0;0;13
9828;Saulėtekis;GRŪDELIS;6928825133;Ne;0;1;0;1
9829;Saulėtekis;GRŪDELIS;8138047893;Ne;11;0;0;11
9830;Saulėtekis;GRŪDELIS;3953501167;Ne;10;0;6;16
9831;Saulėtekis;GRŪDELIS;2646213073;Ne;0;6;2;8
9832;Saulėtekis;GRŪDELIS;6482182524;Ne;3;3;0;6
9833;Saulėtekis;GRŪDELIS;6779891385;Ne;20;0;0;20
9834;Saulėtekis;GRŪDELIS;9743690247;Ne;8;0;0;8
9835;Saulėtekis;GRŪDELIS;7666624373;Ne;2;0;1;3
9836;Saulėtekis;JONVABALIS;1715634399;Ne;5;1;0;6
9837;Saulėtekis;JONVABALIS;7227802003;Ne;0;1;0;1
9838;Saulėtekis;JONVABALIS;4613040294;Ne;9;2;0;11
9839;Saulėtekis;JONVABALIS;1655720839;Ne;9;1;0;10
9840;Saulėtekis;JONVABALIS;6599452886;Ne;9;2;0;11
9841;Saulėtekis;JONVABALIS;8896065807;Ne;7;2;0;9
9842;Saulėtekis;JONVABALIS;3207128776;Ne;11;0;0;11
9843;Saulėtekis;JONVABALIS;2311184444;Ne;0;6;0;6
9844;Saulėtekis;JONVABALIS;9618342480;Ne;5;0;2;7
9845;Saulėtekis;JONVABALIS;1516164123;Ne;18;0;0;18
9846;Saulėtekis;JONVABALIS;60462712074;Ne;2;1;0;3
9847;Saulėtekis;JONVABALIS;1902333363;Ne;3;0;0;3
9848;Saulėtekis;JONVABALIS;4610536784;Ne;8;1;0;9
9849;Saulėtekis;JONVABALIS;8239855620;Ne;0;5;0;5
9850;Saulėtekis;JONVABALIS;8231869593;Ne;8;6;0;14
9851;Saulėtekis;JONVABALIS;8603952810;Ne;6;0;0;6
9852;Saulėtekis;JONVABALIS;9657195627;Ne;4;4;0;8
9853;Saulėtekis;JONVABALIS;4663268649;Ne;0;1;0;1
9854;Saulėtekis;JONVABALIS;9228189399;Ne;6;3;0;9
9855;Saulėtekis;SMALSUČIAI;2474900044;Ne;0;2;0;2
9856;Saulėtekis;SMALSUČIAI;7051608858;Ne;0;6;3;9
9857;Saulėtekis;SMALSUČIAI;2021901593;Ne;1;0;1;2
9858;Saulėtekis;SMALSUČIAI;2546789906;Ne;0;1;0;1
9859;Saulėtekis;SMALSUČIAI;8002806189;Ne;0;0;1;1
9860;Saulėtekis;SMALSUČIAI;4832534190;Ne;7;1;0;8
9861;Saulėtekis;SMALSUČIAI;2238947856;Ne;0;1;3;4
9862;Saulėtekis;SMALSUČIAI;5678858566;Ne;0;4;0;4
9863;Saulėtekis;SMALSUČIAI;3450907715;Ne;0;16;0;16
9864;Saulėtekis;SMALSUČIAI;4338502152;Ne;3;1;0;4
9865;Saulėtekis;SMALSUČIAI;81153273188;Ne;0;6;0;6
9866;Saulėtekis;SMALSUČIAI;6102064617;Ne;0;1;1;2
9867;Saulėtekis;SMALSUČIAI;9945647968;Ne;0;7;0;7
9868;Saulėtekis;SMALSUČIAI;9983577817;Ne;4;0;0;4
9869;Saulėtekis;SMALSUČIAI;5487547105;Ne;0;22;0;22
9870;Saulėtekis;SMALSUČIAI;1922979974;Ne;4;1;1;6
9871;Saulėtekis;BITUTĖS;7766084857;Ne;0;0;1;1
9872;Saulėtekis;BITUTĖS;4537254306;Ne;0;1;0;1
9873;Saulėtekis;BITUTĖS;1699576940;Ne;0;8;0;8
9874;Saulėtekis;BITUTĖS;1481503733;Ne;0;0;1;1
9875;Saulėtekis;BITUTĖS;8302260087;Ne;0;0;2;2
9876;Saulėtekis;BITUTĖS;2593106154;Ne;0;10;0;10
9877;Saulėtekis;BITUTĖS;2813949848;Ne;0;0;3;3
9878;Saulėtekis;BITUTĖS;6643388548;Ne;0;0;4;4
9879;Saulėtekis;BITUTĖS;6087170055;Ne;0;0;8;8
9880;Saulėtekis;BITUTĖS;2077976415;Ne;0;0;7;7
9881;Saulėtekis;BITUTĖS;9870595577;Ne;0;0;1;1
9882;Saulėtekis;BITUTĖS;2154590089;Ne;0;1;0;1
9883;Saulėtekis;BITUTĖS;3220993253;Ne;0;2;4;6
9884;Saulėtekis;BITUTĖS;9918219913;Ne;5;0;2;7
9885;Saulėtekis;BITUTĖS;8517049464;Ne;0;8;0;8
9886;Saulėtekis;BITUTĖS;2656659133;Ne;0;1;1;2
9887;Saulėtekis;RIEŠUTĖLIAI;8767786444;Ne;7;2;0;9
9888;Saulėtekis;RIEŠUTĖLIAI;2224626144;Ne;12;0;0;12
9889;Saulėtekis;RIEŠUTĖLIAI;9270231819;Ne;0;6;0;6
9890;Saulėtekis;RIEŠUTĖLIAI;7898928446;Ne;3;10;0;13
9891;Saulėtekis;RIEŠUTĖLIAI;3356705340;Ne;20;0;0;20
9892;Saulėtekis;RIEŠUTĖLIAI;7824492464;Ne;0;0;2;2
9893;Saulėtekis;RIEŠUTĖLIAI;3935935671;Ne;4;6;0;10
9894;Saulėtekis;RIEŠUTĖLIAI;7807096583;Ne;2;0;1;3
9895;Saulėtekis;RIEŠUTĖLIAI;2548612572;Ne;7;0;0;7
9896;Saulėtekis;RIEŠUTĖLIAI;2908714227;Ne;11;0;11;22
9897;Saulėtekis;RIEŠUTĖLIAI;7305619721;Ne;0;0;21;21
9898;Saulėtekis;RIEŠUTĖLIAI;6557482092;Ne;5;0;1;6
9899;Saulėtekis;RIEŠUTĖLIAI;6183384994;Taip;0;0;4;4
9900;Saulėtekis;RIEŠUTĖLIAI;1540848694;Ne;2;3;0;5
9901;Saulėtekis;RIEŠUTĖLIAI;3559882322;Ne;5;0;0;5
9902;Saulėtekis;RIEŠUTĖLIAI;4767842376;Ne;0;0;4;4
9903;Saulėtekis;RIEŠUTĖLIAI;2849915655;Ne;0;0;6;6
9904;Skroblinukas;SVIRPLIUKŲ;5433647187;Ne;0;2;0;2
9905;Skroblinukas;SVIRPLIUKŲ;2195112297;Ne;0;9;8;17
9906;Skroblinukas;SVIRPLIUKŲ;4198512202;Ne;2;8;17;27
9907;Skroblinukas;SVIRPLIUKŲ;7750501815;Ne;8;6;2;16
9908;Skroblinukas;SVIRPLIUKŲ;4960825597;Ne;0;8;1;9
9909;Skroblinukas;SVIRPLIUKŲ;1544598440;Ne;0;5;0;5
9910;Skroblinukas;SVIRPLIUKŲ;6574558658;Ne;7;6;1;14
9911;Skroblinukas;SVIRPLIUKŲ;4861971439;Ne;0;11;1;12
9912;Skroblinukas;SVIRPLIUKŲ;7817632987;Ne;0;13;1;14
9913;Skroblinukas;SVIRPLIUKŲ;7675772872;Ne;0;6;4;10
9914;Skroblinukas;SVIRPLIUKŲ;4266945644;Taip;6;1;5;12
9915;Skroblinukas;SVIRPLIUKŲ;9003855190;Ne;0;22;0;22
9916;Skroblinukas;SVIRPLIUKŲ;7216760382;Ne;0;6;0;6
9917;Skroblinukas;SVIRPLIUKŲ;5154111867;Ne;0;2;0;2
9918;Skroblinukas;SVIRPLIUKŲ;8622930871;Ne;5;8;1;14
9919;Skroblinukas;SVIRPLIUKŲ;9661609284;Ne;0;8;0;8
9920;Skroblinukas;SVIRPLIUKŲ;3260267388;Ne;0;0;2;2
9921;Skroblinukas;SVIRPLIUKŲ;7761972818;Ne;0;5;0;5
9922;Skroblinukas;SVIRPLIUKŲ;9629502585;Ne;2;12;0;14
9923;Skroblinukas;SVIRPLIUKŲ;6461678336;Ne;7;9;0;16
9924;Skroblinukas;SVIRPLIUKŲ;8283516422;Ne;7;5;2;14
9925;Skroblinukas;GANDRIUKŲ;2197158518;Ne;6;4;1;11
9926;Skroblinukas;GANDRIUKŲ;2406619611;Ne;0;7;2;9
9927;Skroblinukas;GANDRIUKŲ;9572912046;Ne;0;26;3;29
9928;Skroblinukas;GANDRIUKŲ;5646847921;Ne;0;5;1;6
9929;Skroblinukas;GANDRIUKŲ;1851920334;Ne;0;4;1;5
9930;Skroblinukas;GANDRIUKŲ;9377215921;Ne;0;13;0;13
9931;Skroblinukas;GANDRIUKŲ;6235844690;Ne;0;16;0;16
9932;Skroblinukas;GANDRIUKŲ;6489976163;Ne;7;3;0;10
9933;Skroblinukas;GANDRIUKŲ;1159546580;Ne;0;11;3;14
9934;Skroblinukas;GANDRIUKŲ;2630699296;Ne;0;3;0;3
9935;Skroblinukas;GANDRIUKŲ;2310750833;Ne;0;11;2;13
9936;Skroblinukas;GANDRIUKŲ;9888115079;Ne;0;3;4;7
9937;Skroblinukas;GANDRIUKŲ;9475514959;Ne;0;10;0;10
9938;Skroblinukas;GANDRIUKŲ;9031598603;Ne;0;1;0;1
9939;Skroblinukas;GANDRIUKŲ;5251903769;Ne;0;18;0;18
9940;Skroblinukas;GANDRIUKŲ;7385271438;Ne;0;9;0;9
9941;Skroblinukas;VYTURIUKŲ;3954228349;Ne;10;3;1;14
9942;Skroblinukas;VYTURIUKŲ;6879979868;Ne;0;1;2;3
9943;Skroblinukas;VYTURIUKŲ;2330232287;Ne;11;2;4;17
9944;Skroblinukas;VYTURIUKŲ;3065235192;Taip;8;7;0;15
9945;Skroblinukas;VYTURIUKŲ;5902713448;Ne;10;10;0;20
9946;Skroblinukas;VYTURIUKŲ;3594000419;Ne;0;7;0;7
9947;Skroblinukas;VYTURIUKŲ;3512297435;Ne;0;7;0;7
9948;Skroblinukas;VYTURIUKŲ;2481980627;Ne;16;0;0;16
9949;Skroblinukas;VYTURIUKŲ;9725125130;Ne;0;7;0;7
9950;Skroblinukas;VYTURIUKŲ;2978284436;Ne;0;12;0;12
9951;Skroblinukas;VYTURIUKŲ;7068452970;Ne;10;0;4;14
9952;Skroblinukas;VYTURIUKŲ;3292517112;Ne;0;1;0;1
9953;Skroblinukas;VYTURIUKŲ;4129726208;Ne;0;1;0;1
9954;Skroblinukas;VYTURIUKŲ;3351309750;Ne;5;5;0;10
9955;Skroblinukas;VYTURIUKŲ;5101136022;Ne;0;3;5;8
9956;Skroblinukas;GENIUKŲ;1325903217;Ne;0;6;0;6
9957;Skroblinukas;GENIUKŲ;8380073853;Ne;0;2;3;5
9958;Skroblinukas;GENIUKŲ;4436698905;Ne;0;1;0;1
9959;Skroblinukas;GENIUKŲ;1905085978;Ne;0;3;5;8
9960;Skroblinukas;GENIUKŲ;1557733803;Ne;0;15;0;15
9961;Skroblinukas;GENIUKŲ;9433465007;Ne;0;1;0;1
9962;Skroblinukas;GENIUKŲ;1395950886;Ne;5;0;0;5
9963;Skroblinukas;GENIUKŲ;1696303051;Ne;2;1;0;3
9964;Skroblinukas;GENIUKŲ;9846569195;Ne;0;0;2;2
9965;Skroblinukas;GENIUKŲ;4773576465;Ne;0;1;0;1
9966;Skroblinukas;GENIUKŲ;9564385215;Ne;0;0;3;3
9967;Skroblinukas;GENIUKŲ;3128337104;Ne;0;6;0;6
9968;Skroblinukas;GENIUKŲ;4272941994;Ne;0;2;1;3
9969;Skroblinukas;GENIUKŲ;3864043251;Ne;0;0;1;1
9970;Skroblinukas;GENIUKŲ;1064449916;Ne;0;0;1;1
9971;Skroblinukas;GENIUKŲ;2071447940;Ne;0;6;0;6
9972;Skroblinukas;BITUČIŲ;1255323441;Ne;0;6;0;6
9973;Skroblinukas;BITUČIŲ;1934804499;Ne;2;3;0;5
9974;Skroblinukas;BITUČIŲ;2134821488;Ne;0;0;4;4
9975;Skroblinukas;BITUČIŲ;6604496585;Ne;0;2;0;2
9976;Skroblinukas;BITUČIŲ;3736883850;Ne;0;1;0;1
9977;Skroblinukas;BITUČIŲ;7191689856;Ne;12;13;2;27
9978;Skroblinukas;BITUČIŲ;8778072326;Ne;0;11;1;12
9979;Skroblinukas;BITUČIŲ;2032621707;Ne;0;1;8;9
9980;Skroblinukas;BITUČIŲ;8277152812;Ne;0;3;0;3
9981;Skroblinukas;BITUČIŲ;8374103872;Ne;0;5;0;5
9982;Skroblinukas;BITUČIŲ;8618587013;Ne;11;9;0;20
9983;Skroblinukas;BITUČIŲ;4945107862;Ne;0;3;9;12
9984;Skroblinukas;BITUČIŲ;9594078223;Ne;0;5;0;5
9985;Skroblinukas;BITUČIŲ;1688990637;Ne;0;7;1;8
9986;Skroblinukas;BITUČIŲ;1957488412;Ne;0;5;3;8
9987;Skroblinukas;BITUČIŲ;1000804920;Ne;0;6;0;6
9988;Skroblinukas;BITUČIŲ;1711568129;Ne;0;0;4;4
9989;Skroblinukas;BITUČIŲ;1293348150;Ne;0;11;2;13
9990;Skroblinukas;BITUČIŲ;9664357125;Ne;7;5;9;21
9991;Skroblinukas;BITUČIŲ;5001921323;Ne;0;3;1;4
9992;Skroblinukas;BITUČIŲ;6227583229;Ne;0;0;1;1
9993;Skroblinukas;BORUŽĖLIŲ;8715188878;Ne;0;19;8;27
9994;Skroblinukas;BORUŽĖLIŲ;4688496560;Ne;0;0;5;5
9995;Skroblinukas;BORUŽĖLIŲ;7255510731;Ne;4;0;0;4
9996;Skroblinukas;BORUŽĖLIŲ;5841866621;Ne;0;9;2;11
9997;Skroblinukas;BORUŽĖLIŲ;2523742608;Ne;7;5;2;14
9998;Skroblinukas;BORUŽĖLIŲ;2311459579;Ne;7;0;1;8
9999;Skroblinukas;BORUŽĖLIŲ;3490684777;Ne;10;2;2;14
10000;Skroblinukas;BORUŽĖLIŲ;2717586232;Taip;0;7;0;7
10001;Skroblinukas;BORUŽĖLIŲ;4840767748;Ne;0;2;0;2
10002;Skroblinukas;BORUŽĖLIŲ;5694105568;Ne;0;7;8;15
10003;Skroblinukas;BORUŽĖLIŲ;7771969055;Ne;5;0;0;5
10004;Skroblinukas;BORUŽĖLIŲ;4631657273;Ne;8;5;9;22
10005;Skroblinukas;BORUŽĖLIŲ;8711201474;Ne;0;3;5;8
10006;Skroblinukas;BORUŽĖLIŲ;9513546028;Ne;10;2;6;18
10007;Skroblinukas;SKRUZDĖLIUKŲ;5688453546;Ne;0;0;1;1
10008;Skroblinukas;SKRUZDĖLIUKŲ;6445065388;Ne;7;5;0;12
10009;Skroblinukas;SKRUZDĖLIUKŲ;9448253468;Ne;0;0;1;1
10010;Skroblinukas;SKRUZDĖLIUKŲ;3771045336;Ne;0;1;0;1
10011;Skroblinukas;SKRUZDĖLIUKŲ;9353353289;Ne;5;2;0;7
10012;Skroblinukas;SKRUZDĖLIUKŲ;5252389111;Ne;0;1;0;1
10013;Skroblinukas;SKRUZDĖLIUKŲ;2883593274;Ne;0;5;0;5
10014;Skroblinukas;SKRUZDĖLIUKŲ;7493915017;Ne;0;0;3;3
10015;Skroblinukas;SKRUZDĖLIUKŲ;5157913924;Ne;9;5;0;14
10016;Skroblinukas;SKRUZDĖLIUKŲ;9368764758;Ne;0;8;0;8
10017;Skroblinukas;SKRUZDĖLIUKŲ;9958188318;Ne;0;7;0;7
10018;Skroblinukas;SKRUZDĖLIUKŲ;8576448571;Ne;0;10;0;10
10019;Skroblinukas;SKRUZDĖLIUKŲ;1002570367;Ne;0;2;4;6
10020;Skroblinukas;SKRUZDĖLIUKŲ;3290115134;Ne;0;13;0;13
10021;Skroblinukas;SKRUZDĖLIUKŲ;9813249677;Ne;0;6;0;6
10022;Skroblinukas;SKRUZDĖLIUKŲ;2101748012;Ne;0;4;2;6
10023;Skroblinukas;SKRUZDĖLIUKŲ;6640062847;Ne;0;2;0;2
10024;Skroblinukas;ŽVIRBLIUKŲ;9162582460;Ne;2;2;2;6
10025;Skroblinukas;ŽVIRBLIUKŲ;7955574061;Ne;0;5;0;5
10026;Skroblinukas;ŽVIRBLIUKŲ;1232121301;Ne;0;2;0;2
10027;Skroblinukas;ŽVIRBLIUKŲ;1014993354;Ne;0;3;0;3
10028;Skroblinukas;ŽVIRBLIUKŲ;7527177120;Ne;0;1;0;1
10029;Skroblinukas;ŽVIRBLIUKŲ;4002729040;Ne;0;1;0;1
10030;Skroblinukas;ŽVIRBLIUKŲ;4197050176;Ne;0;8;0;8
10031;Skroblinukas;ŽVIRBLIUKŲ;4390614970;Ne;5;0;4;9
10032;Skroblinukas;ŽVIRBLIUKŲ;6070633607;Ne;6;0;0;6
10033;Skroblinukas;ŽVIRBLIUKŲ;6135412007;Ne;10;0;4;14
10034;Skroblinukas;ŽVIRBLIUKŲ;2312400921;Ne;10;0;4;14
10035;Skroblinukas;ŽVIRBLIUKŲ;4491947846;Ne;7;4;1;12
10036;Skroblinukas;ŽVIRBLIUKŲ;7804920443;Ne;11;0;1;12
10037;Skroblinukas;ŽIOGELIŲ;2885814517;Ne;0;5;0;5
10038;Skroblinukas;ŽIOGELIŲ;2363368201;Ne;15;2;0;17
10039;Skroblinukas;ŽIOGELIŲ;4639384934;Ne;0;5;1;6
10040;Skroblinukas;ŽIOGELIŲ;5206925237;Ne;17;0;0;17
10041;Skroblinukas;ŽIOGELIŲ;6279909049;Ne;7;0;0;7
10042;Skroblinukas;ŽIOGELIŲ;8998236911;Ne;0;2;0;2
10043;Skroblinukas;ŽIOGELIŲ;6791969485;Ne;20;0;0;20
10044;Skroblinukas;ŽIOGELIŲ;8680329175;Ne;10;1;0;11
10045;Skroblinukas;ŽIOGELIŲ;8118284793;Ne;0;0;1;1
10046;Skroblinukas;ŽIOGELIŲ;1844211217;Ne;4;0;0;4
10047;Skroblinukas;ŽIOGELIŲ;5354832150;Ne;0;3;0;3
10048;Skroblinukas;ŽIOGELIŲ;3689247672;Ne;2;0;0;2
10049;Skroblinukas;ŽIOGELIŲ;6717008836;Ne;0;4;0;4
10050;Skroblinukas;STRAZDELIŲ;1820748152;Ne;7;2;0;9
10051;Skroblinukas;STRAZDELIŲ;5946356374;Ne;15;9;1;25
10052;Skroblinukas;STRAZDELIŲ;5274898590;Ne;10;10;0;20
10053;Skroblinukas;STRAZDELIŲ;8629189405;Taip;14;5;0;19
10054;Skroblinukas;STRAZDELIŲ;4091852305;Ne;5;11;0;16
10055;Skroblinukas;STRAZDELIŲ;9809817630;Ne;10;4;0;14
10056;Skroblinukas;STRAZDELIŲ;6475609065;Ne;6;9;6;21
10057;Skroblinukas;STRAZDELIŲ;1762416639;Ne;2;0;0;2
10058;Skroblinukas;STRAZDELIŲ;3705638869;Ne;6;2;0;8
10059;Skroblinukas;STRAZDELIŲ;2511496284;Ne;10;9;0;19
10060;Skroblinukas;STRAZDELIŲ;7153774246;Ne;8;1;1;10
10061;Skroblinukas;STRAZDELIŲ;7045587415;Ne;5;6;2;13
10062;Skroblinukas;STRAZDELIŲ;8734405028;Ne;0;16;0;16
10063;Skroblinukas;STRAZDELIŲ;3885884265;Ne;5;19;2;26
10064;Skroblinukas;STRAZDELIŲ;8544069746;Ne;7;6;0;13
10065;Skroblinukas;STRAZDELIŲ;6011466024;Ne;7;9;1;17
10066;Skroblinukas;DRUGELIŲ;7400908711;Ne;0;17;0;17
10067;Skroblinukas;DRUGELIŲ;3889890374;Ne;0;3;0;3
10068;Skroblinukas;DRUGELIŲ;9481718833;Ne;1;0;0;1
10069;Skroblinukas;DRUGELIŲ;8864594520;Ne;0;3;5;8
10070;Skroblinukas;DRUGELIŲ;2772360168;Ne;0;3;0;3
10071;Skroblinukas;DRUGELIŲ;3624518310;Ne;0;6;0;6
10072;Skroblinukas;DRUGELIŲ;4831370981;Ne;0;2;0;2
10073;Skroblinukas;DRUGELIŲ;5957417413;Taip;0;8;0;8
10074;Skroblinukas;DRUGELIŲ;3226115050;Ne;10;0;0;10
10075;Skroblinukas;DRUGELIŲ;4737605061;Ne;0;22;6;28
10076;Skroblinukas;DRUGELIŲ;3046542264;Ne;0;4;0;4
10077;Skroblinukas;DRUGELIŲ;5912771080;Ne;0;4;0;4
10078;Skroblinukas;DRUGELIŲ;7528824951;Ne;0;6;4;10
10079;Skroblinukas;DRUGELIŲ;2987938909;Ne;0;13;7;20
10080;Skroblinukas;DRUGELIŲ;8064713969;Ne;1;0;0;1
10081;Skroblinukas;DRUGELIŲ;8286842648;Ne;4;1;4;9
10082;Skroblinukas;DRUGELIŲ;1453029732;Ne;0;18;4;22
10083;Skroblinukas;PELĖDŽIUKŲ;8953844650;Ne;0;10;0;10
10084;Skroblinukas;PELĖDŽIUKŲ;3646325903;Ne;0;3;0;3
10085;Skroblinukas;PELĖDŽIUKŲ;9292990596;Ne;0;9;1;10
10086;Skroblinukas;PELĖDŽIUKŲ;8202855376;Ne;5;9;17;31
10087;Skroblinukas;PELĖDŽIUKŲ;8312341293;Ne;0;6;5;11
10088;Skroblinukas;PELĖDŽIUKŲ;3658815079;Ne;3;3;0;6
10089;Skroblinukas;PELĖDŽIUKŲ;5418212729;Ne;4;1;0;5
10090;Skroblinukas;PELĖDŽIUKŲ;4168542339;Ne;13;0;0;13
10091;Skroblinukas;PELĖDŽIUKŲ;8958893525;Ne;3;0;1;4
10092;Skroblinukas;PELĖDŽIUKŲ;6675716937;Ne;0;4;1;5
10093;Skroblinukas;PELĖDŽIUKŲ;1009065470;Taip;0;22;0;22
10094;Skroblinukas;PELĖDŽIUKŲ;9699407871;Ne;11;8;0;19
10095;Skroblinukas;PELĖDŽIUKŲ;9553242594;Ne;0;8;0;8
10096;Skroblinukas;PELĖDŽIUKŲ;3532258904;Ne;3;6;0;9
10097;Skroblinukas;PELĖDŽIUKŲ;1758987652;Ne;0;10;0;10
10098;Skroblinukas;PELĖDŽIUKŲ;8465074037;Ne;0;14;4;18
10099;Skroblinukas;PELĖDŽIUKŲ;9523720873;Ne;19;8;1;28
10100;Skroblinukas;PELĖDŽIUKŲ;7920117036;Ne;3;9;0;12
10101;Skroblinukas;PELĖDŽIUKŲ;2215428081;Ne;0;9;0;9
10102;Smalsučiai;Žibuoklės;6535494814;Ne;5;0;0;5
10103;Smalsučiai;Žibuoklės;3309134310;Ne;0;4;0;4
10104;Smalsučiai;Žibuoklės;2326167599;Ne;4;0;0;4
10105;Smalsučiai;Žibuoklės;4094037708;Ne;0;0;4;4
10106;Smalsučiai;Žibuoklės;5482692473;Ne;0;0;1;1
10107;Smalsučiai;Žibuoklės;3877274360;Ne;0;1;0;1
10108;Smalsučiai;Žibuoklės;7726086066;Ne;0;0;1;1
10109;Smalsučiai;Žibuoklės;9988599126;Ne;0;0;2;2
10110;Smalsučiai;Žibuoklės;5489140006;Ne;0;1;0;1
10111;Smalsučiai;Žibuoklės;5900294530;Ne;0;2;1;3
10112;Smalsučiai;Žibuoklės;1380214235;Ne;5;0;1;6
10113;Smalsučiai;Žibuoklės;8644849194;Ne;12;2;8;22
10114;Smalsučiai;Žibuoklės;4506058735;Ne;0;2;3;5
10115;Smalsučiai;Žibuoklės;6931092874;Ne;5;0;2;7
10116;Smalsučiai;Žibuoklės;3071594259;Ne;0;1;0;1
10117;Smalsučiai;Žibuoklės;7107126092;Ne;0;1;0;1
10118;Smalsučiai;Žibuoklės;7070240693;Ne;0;2;4;6
10119;Smalsučiai;Aitvarų;3349726106;Ne;10;0;0;10
10120;Smalsučiai;Aitvarų;2219168902;Ne;0;7;0;7
10121;Smalsučiai;Aitvarų;9305837033;Ne;6;0;1;7
10122;Smalsučiai;Aitvarų;9305837033;Ne;6;0;1;7
10123;Smalsučiai;Aitvarų;9305837033;Ne;6;0;1;7
10124;Smalsučiai;Aitvarų;8877566394;Ne;2;0;0;2
10125;Smalsučiai;Aitvarų;3888093640;Ne;6;1;1;8
10126;Smalsučiai;Aitvarų;8284740122;Taip;0;0;12;12
10127;Smalsučiai;Aitvarų;8985656809;Ne;0;0;1;1
10128;Smalsučiai;Aitvarų;6032887449;Ne;0;2;0;2
10129;Smalsučiai;Aitvarų;4054278651;Ne;17;0;0;17
10130;Smalsučiai;Aitvarų;6232068532;Ne;7;3;2;12
10131;Smalsučiai;Aitvarų;3157534923;Ne;14;0;0;14
10132;Smalsučiai;Aitvarų;6825499095;Ne;0;8;6;14
10133;Smalsučiai;Aitvarų;4832292565;Ne;12;0;0;12
10134;Smalsučiai;Aitvarų;2835117069;Ne;10;1;0;11
10135;Smalsučiai;Aitvarų;2610753472;Ne;1;5;1;7
10136;Smalsučiai;Aitvarų;6090244401;Ne;0;0;4;4
10137;Smalsučiai;Sraigiukų;1471941426;Ne;0;10;0;10
10138;Smalsučiai;Sraigiukų;1458544456;Ne;0;6;0;6
10139;Smalsučiai;Sraigiukų;5406430393;Ne;0;4;0;4
10140;Smalsučiai;Sraigiukų;9582225178;Ne;0;2;0;2
10141;Smalsučiai;Sraigiukų;9604182559;Taip;0;19;0;19
10142;Smalsučiai;Sraigiukų;6469604093;Ne;0;11;0;11
10143;Smalsučiai;Sraigiukų;4566816316;Ne;0;2;0;2
10144;Smalsučiai;Sraigiukų;5184903287;Ne;0;1;0;1
10145;Smalsučiai;Sraigiukų;4134975456;Ne;0;5;0;5
10146;Smalsučiai;Sraigiukų;6358800570;Ne;0;2;0;2
10147;Smalsučiai;Sraigiukų;2327930850;Ne;0;9;0;9
10148;Smalsučiai;Sraigiukų;3787937467;Ne;0;15;0;15
10149;Smalsučiai;Sraigiukų;4824786207;Ne;0;2;0;2
10150;Smalsučiai;Sraigiukų;3399798448;Ne;0;2;0;2
10151;Smalsučiai;Sraigiukų;1997966082;Ne;0;2;0;2
10152;Smalsučiai;Sraigiukų;4585930202;Ne;0;4;0;4
10153;Smalsučiai;Sraigiukų;8193410963;Ne;0;1;0;1
10154;Smalsučiai;Sraigiukų;9155011285;Ne;0;2;0;2
10155;Smalsučiai;Saulučių;1776385691;Ne;0;7;0;7
10156;Smalsučiai;Saulučių;2259361924;Ne;9;0;1;10
10157;Smalsučiai;Saulučių;1162964613;Taip;7;0;0;7
10158;Smalsučiai;Saulučių;9934952886;Ne;6;0;6;12
10159;Smalsučiai;Saulučių;9556433086;Ne;0;4;0;4
10160;Smalsučiai;Saulučių;1904973393;Ne;7;0;0;7
10161;Smalsučiai;Saulučių;3252901131;Ne;7;0;0;7
10162;Smalsučiai;Saulučių;2392217952;Ne;16;0;0;16
10163;Smalsučiai;Saulučių;1447512509;Ne;14;0;8;22
10164;Smalsučiai;Saulučių;7774766882;Ne;0;5;0;5
10165;Smalsučiai;Saulučių;2034284973;Ne;0;5;0;5
10166;Smalsučiai;Saulučių;9183519167;Ne;0;0;13;13
10167;Smalsučiai;Saulučių;5708986552;Ne;11;0;1;12
10168;Smalsučiai;Saulučių;4889923629;Ne;0;8;0;8
10169;Smalsučiai;Saulučių;8630411244;Ne;3;0;0;3
10170;Smalsučiai;Viščiukų;6006832443;Ne;4;2;0;6
10171;Smalsučiai;Viščiukų;9864518144;Ne;0;5;0;5
10172;Smalsučiai;Viščiukų;8128348060;Ne;0;5;10;15
10173;Smalsučiai;Viščiukų;4847584492;Ne;7;0;1;8
10174;Smalsučiai;Viščiukų;9732075162;Ne;0;0;4;4
10175;Smalsučiai;Viščiukų;6090391818;Ne;17;0;0;17
10176;Smalsučiai;Viščiukų;7023531176;Ne;0;3;1;4
10177;Smalsučiai;Viščiukų;8259056296;Ne;0;0;2;2
10178;Smalsučiai;Viščiukų;9637877396;Ne;10;0;4;14
10179;Smalsučiai;Viščiukų;7137550663;Ne;0;11;0;11
10180;Smalsučiai;Viščiukų;2958335372;Ne;6;0;0;6
10181;Smalsučiai;Viščiukų;3582805599;Ne;0;1;1;2
10182;Smalsučiai;Viščiukų;3757955200;Ne;0;7;1;8
10183;Smalsučiai;Viščiukų;4288788194;Ne;0;0;1;1
10184;Smalsučiai;Viščiukų;7874635165;Ne;0;5;15;20
10185;Smalsučiai;Viščiukų;5098291946;Ne;0;2;1;3
10186;Smalsučiai;Viščiukų;8578693978;Ne;0;14;0;14
10187;Smalsučiai;Viščiukų;4379645417;Ne;0;12;0;12
10188;Smalsučiai;Viščiukų;5536697307;Ne;0;0;22;22
10189;Smalsučiai;Boružėlių;9426629964;Ne;0;1;0;1
10190;Smalsučiai;Boružėlių;1703679877;Ne;0;0;3;3
10191;Smalsučiai;Boružėlių;2208462326;Ne;0;2;0;2
10192;Smalsučiai;Boružėlių;6643253926;Ne;0;5;0;5
10193;Smalsučiai;Boružėlių;1473016908;Ne;5;2;1;8
10194;Smalsučiai;Boružėlių;7226242747;Ne;5;2;1;8
10195;Smalsučiai;Boružėlių;6085020049;Ne;0;12;0;12
10196;Smalsučiai;Boružėlių;8340768848;Ne;0;8;0;8
10197;Smalsučiai;Boružėlių;69450514879;Ne;0;2;5;7
10198;Smalsučiai;Boružėlių;2737886714;Ne;0;7;0;7
10199;Smalsučiai;Boružėlių;2034790691;Ne;0;7;2;9
10200;Smalsučiai;Boružėlių;5325706638;Ne;0;2;0;2
10201;Smalsučiai;Boružėlių;9314811354;Ne;0;9;0;9
10202;Smalsučiai;Boružėlių;9196634595;Ne;10;0;2;12
10203;Smalsučiai;Boružėlių;6899040199;Ne;0;1;0;1
10204;Smalsučiai;Zuikių;2802867649;Ne;0;2;0;2
10205;Smalsučiai;Zuikių;96002139110;Ne;0;6;0;6
10206;Smalsučiai;Zuikių;2953239027;Ne;0;2;0;2
10207;Smalsučiai;Zuikių;2638709634;Ne;0;7;0;7
10208;Smalsučiai;Zuikių;5441966713;Ne;2;0;0;2
10209;Smalsučiai;Zuikių;8306946163;Ne;0;2;0;2
10210;Smalsučiai;Zuikių;6469044880;Ne;0;9;0;9
10211;Smalsučiai;Zuikių;99467576480;Ne;0;2;4;6
10212;Smalsučiai;Zuikių;2059832436;Ne;0;2;2;4
10213;Smalsučiai;Zuikių;1316590100;Ne;0;2;0;2
10214;Smalsučiai;Zuikių;1372591510;Ne;0;2;1;3
10215;Smalsučiai;Zuikių;8810690546;Ne;0;7;0;7
10216;Smalsučiai;Zuikių;9703726869;Ne;0;2;2;4
10217;Smalsučiai;Zuikių;9481692900;Ne;0;4;0;4
10218;Smalsučiai;Zuikių;4909226602;Ne;0;2;0;2
10219;Smalsučiai;Zuikių;6536165801;Ne;0;8;0;8
10220;Smalsučiai;Zuikių;3644256220;Ne;0;2;1;3
10221;Smalsučiai;Nykštukų;9181601713;Taip;0;3;0;3
10222;Smalsučiai;Nykštukų;7637630200;Ne;2;6;1;9
10223;Smalsučiai;Nykštukų;1247774684;Ne;6;8;0;14
10224;Smalsučiai;Nykštukų;2375360937;Ne;10;0;0;10
10225;Smalsučiai;Nykštukų;2015172985;Taip;3;6;0;9
10226;Smalsučiai;Nykštukų;8893480054;Ne;2;0;0;2
10227;Smalsučiai;Nykštukų;6996192450;Ne;0;6;8;14
10228;Smalsučiai;Nykštukų;9378696084;Ne;10;0;0;10
10229;Smalsučiai;Nykštukų;7267389695;Ne;22;0;0;22
10230;Smalsučiai;Nykštukų;6996901033;Ne;0;0;3;3
10231;Smalsučiai;Nykštukų;4847212069;Ne;5;0;3;8
10232;Smalsučiai;Nykštukų;1344461213;Ne;7;0;0;7
10233;Smalsučiai;Nykštukų;1224857159;Ne;0;10;0;10
10234;Smalsučiai;Nykštukų;8690626891;Ne;0;5;0;5
10235;Smalsučiai;Nykštukų;5719056997;Ne;18;0;4;22
10236;Smalsučiai;Nykštukų;6642882883;Ne;15;0;3;18
10237;Smalsučiai;Nykštukų;7143824796;Ne;0;0;2;2
10238;Smalsučiai;Nykštukų;4457317471;Ne;12;0;0;12
10239;Smalsučiai;Nykštukų;1023255628;Ne;9;0;0;9
10240;Smalsučiai;Katinėlių;4760366724;Ne;0;2;0;2
10241;Smalsučiai;Katinėlių;2045283348;Ne;2;2;0;4
10242;Smalsučiai;Katinėlių;3782502443;Ne;0;6;0;6
10243;Smalsučiai;Katinėlių;6358968221;Ne;0;3;0;3
10244;Smalsučiai;Katinėlių;9984878984;Ne;0;5;0;5
10245;Smalsučiai;Katinėlių;2662588310;Ne;0;7;5;12
10246;Smalsučiai;Katinėlių;2668720481;Ne;5;4;0;9
10247;Smalsučiai;Katinėlių;4030955447;Ne;0;1;0;1
10248;Smalsučiai;Katinėlių;4075656060;Ne;0;1;0;1
10249;Smalsučiai;Katinėlių;2926560092;Ne;6;0;0;6
10250;Smalsučiai;Katinėlių;8210141253;Ne;0;7;0;7
10251;Smalsučiai;Katinėlių;6131743288;Ne;7;2;0;9
10252;Smalsučiai;Katinėlių;7318218997;Ne;13;1;0;14
10253;Smalsučiai;Katinėlių;1331674807;Ne;0;5;0;5
10254;Smalsučiai;PELĖDŽIUKAI;1668692281;Ne;0;0;2;2
10255;Smalsučiai;PELĖDŽIUKAI;7794541741;Ne;0;0;3;3
10256;Smalsučiai;PELĖDŽIUKAI;1599488035;Ne;0;2;0;2
10257;Smalsučiai;PELĖDŽIUKAI;8520753848;Ne;0;4;0;4
10258;Smalsučiai;PELĖDŽIUKAI;22791221635;Ne;0;1;0;1
10259;Smalsučiai;PELĖDŽIUKAI;3607226859;Ne;0;6;0;6
10260;Smalsučiai;PELĖDŽIUKAI;1467603676;Ne;0;1;0;1
10261;Smalsučiai;PELĖDŽIUKAI;5159799570;Ne;0;0;3;3
10262;Smalsučiai;PELĖDŽIUKAI;19592364606;Ne;0;17;0;17
10263;Smalsučiai;PELĖDŽIUKAI;1824321380;Ne;0;6;0;6
10264;Smalsučiai;PELĖDŽIUKAI;6207026048;Ne;0;3;0;3
10265;Smalsučiai;PELĖDŽIUKAI;6529889121;Ne;0;2;0;2
10266;Smalsučiai;PELĖDŽIUKAI;2618753095;Ne;0;0;1;1
10267;Smalsučiai;PELĖDŽIUKAI;1673246147;Ne;0;7;0;7
10268;Smalsučiai;PELĖDŽIUKAI;7713078413;Ne;0;5;0;5
10269;Smalsučiai;PELĖDŽIUKAI;3627324317;Ne;0;16;0;16
10270;Smalsučiai;PELĖDŽIUKAI;5730866119;Ne;0;5;0;5
10271;Smalsučiai;PELĖDŽIUKAI;5611487967;Ne;0;1;0;1
10272;Smalsučiai;Pingvinukai;2305950301;Ne;0;1;3;4
10273;Smalsučiai;Pingvinukai;9222858199;Ne;10;0;0;10
10274;Smalsučiai;Pingvinukai;1909797307;Ne;11;0;2;13
10275;Smalsučiai;Pingvinukai;7400990599;Ne;0;0;3;3
10276;Smalsučiai;Pingvinukai;2673224420;Ne;0;5;7;12
10277;Smalsučiai;Pingvinukai;9771532192;Ne;0;16;0;16
10278;Smalsučiai;Pingvinukai;8402519872;Ne;7;0;0;7
10279;Smalsučiai;Pingvinukai;3746193901;Ne;4;1;0;5
10280;Smalsučiai;Pingvinukai;8499612926;Ne;7;0;1;8
10281;Smalsučiai;Pingvinukai;3625628040;Taip;11;0;0;11
10282;Smalsučiai;Pingvinukai;6128134712;Ne;22;0;2;24
10283;Smalsučiai;Pingvinukai;3045521655;Ne;6;0;1;7
10284;Smalsučiai;Pingvinukai;8615789381;Ne;5;1;5;11
10285;Smalsučiai;Pingvinukai;6393203986;Ne;0;3;0;3
10286;Smalsučiai;Pingvinukai;8615110249;Ne;4;0;0;4
10287;Smalsučiai;Voverikų;4811022648;Ne;0;2;0;2
10288;Smalsučiai;Voverikų;4973651632;Ne;7;0;0;7
10289;Smalsučiai;Voverikų;3509573985;Ne;15;3;0;18
10290;Smalsučiai;Voverikų;2878060759;Ne;6;0;0;6
10291;Smalsučiai;Voverikų;1485450504;Ne;6;8;0;14
10292;Smalsučiai;Voverikų;3042578767;Ne;5;3;0;8
10293;Smalsučiai;Voverikų;2070248478;Ne;5;6;0;11
10294;Smalsučiai;Voverikų;7205498813;Ne;12;2;1;15
10295;Smalsučiai;Voverikų;2612579099;Ne;0;21;0;21
10296;Smalsučiai;Voverikų;1559069582;Ne;3;0;6;9
10297;Smalsučiai;Voverikų;2885279828;Ne;6;0;0;6
10298;Smalsučiai;Voverikų;1162035522;Ne;5;0;9;14
10299;Smalsučiai;Voverikų;5964344820;Ne;17;0;0;17
10300;Smalsučiai;Voverikų;4105866680;Ne;8;3;0;11
10301;Smalsučiai;Voverikų;8493718326;Ne;2;1;0;3
10302;Spragtukas;NYKŠTUKAI;4527798635;Ne;0;0;1;1
10303;Spragtukas;NYKŠTUKAI;8551195766;Ne;0;0;2;2
10304;Spragtukas;NYKŠTUKAI;2943832694;Ne;8;0;2;10
10305;Spragtukas;NYKŠTUKAI;8297700739;Ne;6;0;0;6
10306;Spragtukas;NYKŠTUKAI;9595221494;Ne;0;1;0;1
10307;Spragtukas;NYKŠTUKAI;1710184531;Ne;2;0;0;2
10308;Spragtukas;NYKŠTUKAI;2076126173;Ne;0;9;0;9
10309;Spragtukas;NYKŠTUKAI;3012345413;Ne;2;0;1;3
10310;Spragtukas;NYKŠTUKAI;8698492694;Ne;0;7;0;7
10311;Spragtukas;NYKŠTUKAI;1150002524;Ne;0;3;0;3
10312;Spragtukas;NYKŠTUKAI;4493810276;Ne;0;0;2;2
10313;Spragtukas;NYKŠTUKAI;8288793522;Ne;3;5;0;8
10314;Spragtukas;NYKŠTUKAI;6986034864;Ne;0;4;0;4
10315;Spragtukas;NYKŠTUKAI;9665371858;Ne;0;7;0;7
10316;Spragtukas;SAULUTĖ;3337355440;Taip;0;2;2;4
10317;Spragtukas;SAULUTĖ;4669257062;Ne;0;1;0;1
10318;Spragtukas;SAULUTĖ;3692960591;Ne;2;4;0;6
10319;Spragtukas;SAULUTĖ;4586034709;Taip;0;4;0;4
10320;Spragtukas;SAULUTĖ;3968434618;Ne;0;1;0;1
10321;Spragtukas;SAULUTĖ;1150727381;Ne;4;17;0;21
10322;Spragtukas;SAULUTĖ;9191831532;Ne;0;1;0;1
10323;Spragtukas;SAULUTĖ;3948232692;Ne;5;2;4;11
10324;Spragtukas;SAULUTĖ;9149954373;Ne;0;11;0;11
10325;Spragtukas;SAULUTĖ;8235791891;Ne;3;0;0;3
10326;Spragtukas;SAULUTĖ;2987638580;Ne;0;1;0;1
10327;Spragtukas;SAULUTĖ;5687853390;Ne;0;2;1;3
10328;Spragtukas;SAULUTĖ;6679886985;Ne;10;9;2;21
10329;Spragtukas;SAULUTĖ;2879077913;Ne;0;3;0;3
10330;Spragtukas;SAULUTĖ;1998148708;Ne;0;11;0;11
10331;Spragtukas;SAULUTĖ;8227086854;Ne;0;10;0;10
10332;Spragtukas;SAULUTĖ;5697451914;Ne;0;1;0;1
10333;Spragtukas;SAULUTĖ;3086399458;Ne;0;0;1;1
10334;Spragtukas;SAULUTĖ;2879614195;Ne;0;21;0;21
10335;Spragtukas;SPINDULĖLIAI;4675031453;Ne;0;0;9;9
10336;Spragtukas;SPINDULĖLIAI;9781727236;Ne;5;0;4;9
10337;Spragtukas;SPINDULĖLIAI;1029392579;Ne;2;2;1;5
10338;Spragtukas;SPINDULĖLIAI;6417098461;Ne;0;1;0;1
10339;Spragtukas;SPINDULĖLIAI;4485715299;Ne;0;13;0;13
10340;Spragtukas;SPINDULĖLIAI;4224693184;Ne;0;0;1;1
10341;Spragtukas;SPINDULĖLIAI;3411349574;Ne;0;0;8;8
10342;Spragtukas;SPINDULĖLIAI;1827458781;Ne;3;0;7;10
10343;Spragtukas;SPINDULĖLIAI;4764295850;Ne;0;0;6;6
10344;Spragtukas;SPINDULĖLIAI;6385589724;Ne;0;0;3;3
10345;Spragtukas;SPINDULĖLIAI;8912031554;Ne;0;18;0;18
10346;Spragtukas;SPINDULĖLIAI;6634972088;Ne;0;22;0;22
10347;Spragtukas;SPINDULĖLIAI;7326816081;Ne;0;22;0;22
10348;Spragtukas;SPINDULĖLIAI;5864894208;Ne;0;22;0;22
10349;Spragtukas;GINTARĖLIAI;8339926929;Ne;2;3;0;5
10350;Spragtukas;GINTARĖLIAI;5724874569;Ne;0;10;0;10
10351;Spragtukas;GINTARĖLIAI;1430632638;Ne;7;1;0;8
10352;Spragtukas;GINTARĖLIAI;8625143071;Ne;0;3;0;3
10353;Spragtukas;GINTARĖLIAI;2255007161;Ne;0;2;0;2
10354;Spragtukas;GINTARĖLIAI;6493380877;Ne;0;1;0;1
10355;Spragtukas;GINTARĖLIAI;9664130733;Ne;7;6;0;13
10356;Spragtukas;GINTARĖLIAI;2316071393;Ne;7;0;0;7
10357;Spragtukas;GINTARĖLIAI;8698469979;Ne;0;6;0;6
10358;Spragtukas;GINTARĖLIAI;1747417905;Ne;2;2;0;4
10359;Spragtukas;GINTARĖLIAI;6388163866;Ne;0;9;0;9
10360;Spragtukas;GINTARĖLIAI;8191270443;Ne;0;12;0;12
10361;Spragtukas;GINTARĖLIAI;8893190073;Ne;0;2;0;2
10362;Spragtukas;GINTARĖLIAI;3684183344;Taip;0;1;0;1
10363;Spragtukas;GINTARĖLIAI;7806145224;Ne;0;3;0;3
10364;Spragtukas;GINTARĖLIAI;2217627240;Ne;0;13;0;13
10365;Spragtukas;ČIPOLINO;2371848091;Ne;0;8;0;8
10366;Spragtukas;ČIPOLINO;6582680700;Ne;0;7;0;7
10367;Spragtukas;ČIPOLINO;1599958343;Ne;0;7;0;7
10368;Spragtukas;ČIPOLINO;1547670082;Ne;0;3;0;3
10369;Spragtukas;ČIPOLINO;7504632314;Ne;9;1;0;10
10370;Spragtukas;ČIPOLINO;1597988501;Ne;0;1;0;1
10371;Spragtukas;ČIPOLINO;6526633051;Ne;0;2;0;2
10372;Spragtukas;ČIPOLINO;1058970799;Ne;0;4;0;4
10373;Spragtukas;ČIPOLINO;45661532130;Ne;0;2;0;2
10374;Spragtukas;ČIPOLINO;3045382299;Ne;0;2;0;2
10375;Spragtukas;ČIPOLINO;7640805299;Ne;0;11;0;11
10376;Spragtukas;ČIPOLINO;1365907314;Ne;0;5;0;5
10377;Spragtukas;ČIPOLINO;4941531443;Ne;0;5;0;5
10378;Spragtukas;ČIPOLINO;3566797064;Ne;1;2;0;3
10379;Spragtukas;ČIPOLINO;69114720307;Ne;0;6;0;6
10380;Spragtukas;ČIPOLINO;1044112039;Ne;8;0;0;8
10381;Spragtukas;ČIPOLINO;5707084920;Ne;0;14;0;14
10382;Spragtukas;ČIPOLINO;1482803930;Ne;0;3;0;3
10383;Spragtukas;ČIPOLINO;3356307067;Ne;0;12;0;12
10384;Spragtukas;ČIPOLINO;2691004546;Ne;0;22;0;22
10385;Spragtukas;BORUŽĖLĖS;8614890958;Ne;0;7;0;7
10386;Spragtukas;BORUŽĖLĖS;6548270099;Ne;3;0;0;3
10387;Spragtukas;BORUŽĖLĖS;8287102733;Ne;2;0;0;2
10388;Spragtukas;BORUŽĖLĖS;6584145176;Ne;0;8;0;8
10389;Spragtukas;BORUŽĖLĖS;9965087132;Ne;0;2;0;2
10390;Spragtukas;BORUŽĖLĖS;6824861247;Ne;0;3;0;3
10391;Spragtukas;BORUŽĖLĖS;7264683147;Ne;9;10;0;19
10392;Spragtukas;BORUŽĖLĖS;5556920140;Ne;0;3;0;3
10393;Spragtukas;BORUŽĖLĖS;6547167325;Ne;2;1;0;3
10394;Spragtukas;BORUŽĖLĖS;7073092344;Ne;8;9;0;17
10395;Spragtukas;BORUŽĖLĖS;7042345781;Ne;0;0;5;5
10396;Spragtukas;BORUŽĖLĖS;1046613540;Ne;0;8;0;8
10397;Spragtukas;DRUGELIAI;1336973131;Ne;7;2;1;10
10398;Spragtukas;DRUGELIAI;1514277186;Ne;0;5;0;5
10399;Spragtukas;DRUGELIAI;1326603216;Ne;0;0;1;1
10400;Spragtukas;DRUGELIAI;5306883933;Ne;1;2;0;3
10401;Spragtukas;DRUGELIAI;6573750143;Ne;2;0;0;2
10402;Spragtukas;DRUGELIAI;72636559695;Ne;0;0;2;2
10403;Spragtukas;DRUGELIAI;8246512283;Ne;0;3;0;3
10404;Spragtukas;DRUGELIAI;1627243902;Ne;0;5;0;5
10405;Spragtukas;DRUGELIAI;3113106252;Ne;0;2;0;2
10406;Spragtukas;DRUGELIAI;70413855110;Ne;0;1;0;1
10407;Spragtukas;GAIDELIAI;2541126095;Ne;0;4;0;4
10408;Spragtukas;GAIDELIAI;4097458544;Ne;11;0;0;11
10409;Spragtukas;GAIDELIAI;8957903306;Ne;3;2;4;9
10410;Spragtukas;GAIDELIAI;1326714513;Ne;2;2;1;5
10411;Spragtukas;GAIDELIAI;4676052255;Ne;0;15;0;15
10412;Spragtukas;GAIDELIAI;7108640957;Ne;5;0;0;5
10413;Spragtukas;GAIDELIAI;6370760287;Ne;0;0;1;1
10414;Spragtukas;GAIDELIAI;7911124524;Ne;0;1;0;1
10415;Spragtukas;GAIDELIAI;3216796441;Ne;2;2;12;16
10416;Spragtukas;GAIDELIAI;8440836721;Ne;12;3;0;15
10417;Spragtukas;GAIDELIAI;4535021524;Ne;0;5;0;5
10418;Spragtukas;GAIDELIAI;2679834328;Ne;4;1;0;5
10419;Spragtukas;GAIDELIAI;7313963137;Ne;8;0;0;8
10420;Spragtukas;ŽUVELĖS;9078163633;Ne;4;2;0;6
10421;Spragtukas;ŽUVELĖS;8652973900;Ne;0;5;0;5
10422;Spragtukas;ŽUVELĖS;3261213140;Ne;4;6;0;10
10423;Spragtukas;ŽUVELĖS;5689392663;Ne;7;0;0;7
10424;Spragtukas;ŽUVELĖS;1272075883;Ne;0;2;1;3
10425;Spragtukas;ŽUVELĖS;6465991136;Ne;0;1;0;1
10426;Spragtukas;ŽUVELĖS;9282940430;Ne;0;4;0;4
10427;Spragtukas;ŽUVELĖS;6503842956;Ne;0;1;0;1
10428;Spragtukas;ŽUVELĖS;3139748724;Ne;0;2;7;9
10429;Spragtukas;ŽUVELĖS;8640877497;Ne;0;2;2;4
10430;Spragtukas;ŽUVELĖS;2025314314;Ne;0;11;0;11
10431;Spragtukas;ŽUVELĖS;4848647219;Taip;0;2;0;2
10432;Spragtukas;ŽUVELĖS;3491418162;Ne;0;2;1;3
10433;Spragtukas;ŽUVELĖS;5836788916;Ne;0;2;0;2
10434;Spragtukas;ŽUVELĖS;5704941595;Ne;0;9;0;9
10435;Spragtukas;ŽUVELĖS;3286456855;Ne;0;2;1;3
10436;Spragtukas;ŽUVELĖS;2539660577;Ne;0;10;0;10
10437;Spragtukas;ŽUVELĖS;6836232179;Ne;0;2;0;2
10438;Spragtukas;RIEŠUTĖLIAI;8684246143;Ne;0;0;3;3
10439;Spragtukas;RIEŠUTĖLIAI;1407611561;Ne;1;0;0;1
10440;Spragtukas;RIEŠUTĖLIAI;8773952377;Ne;0;3;0;3
10441;Spragtukas;RIEŠUTĖLIAI;1977526177;Ne;0;4;0;4
10442;Spragtukas;RIEŠUTĖLIAI;7615522850;Ne;8;0;0;8
10443;Spragtukas;RIEŠUTĖLIAI;6797841737;Ne;0;2;1;3
10444;Spragtukas;RIEŠUTĖLIAI;8342098575;Ne;10;0;0;10
10445;Spragtukas;RIEŠUTĖLIAI;4134127256;Ne;0;3;0;3
10446;Spragtukas;RIEŠUTĖLIAI;3009567338;Ne;5;0;0;5
10447;Spragtukas;RIEŠUTĖLIAI;2648358901;Ne;0;11;0;11
10448;Spragtukas;RIEŠUTĖLIAI;3822599790;Ne;0;15;0;15
10449;Spragtukas;RIEŠUTĖLIAI;7767940027;Ne;0;9;1;10
10450;Spragtukas;RIEŠUTĖLIAI;6963190259;Ne;5;0;1;6
10451;Spragtukas;RIEŠUTĖLIAI;8732886749;Ne;0;1;0;1
10452;Spragtukas;RIEŠUTĖLIAI;9975308171;Taip;0;2;0;2
10453;Spragtukas;VIŠČIUKAI;8473814776;Ne;0;1;0;1
10454;Spragtukas;VIŠČIUKAI;2268649859;Ne;19;1;0;20
10455;Spragtukas;VIŠČIUKAI;9951226210;Ne;4;2;0;6
10456;Spragtukas;VIŠČIUKAI;9294770557;Ne;0;0;1;1
10457;Spragtukas;VIŠČIUKAI;9443091032;Ne;0;8;0;8
10458;Spragtukas;VIŠČIUKAI;4461217748;Ne;0;12;0;12
10459;Spragtukas;VIŠČIUKAI;7412489884;Ne;0;22;0;22
10460;Spragtukas;VIŠČIUKAI;9579825533;Ne;15;0;0;15
10461;Spragtukas;VIŠČIUKAI;1545887575;Ne;4;3;0;7
10462;Spragtukas;VIŠČIUKAI;8110631015;Ne;0;3;0;3
10463;Spragtukas;VIŠČIUKAI;3110077272;Ne;4;1;0;5
10464;Spragtukas;MEŠKIUKAI;5440632023;Ne;6;2;0;8
10465;Spragtukas;MEŠKIUKAI;7271482702;Ne;2;2;6;10
10466;Spragtukas;MEŠKIUKAI;9099921999;Ne;2;0;0;2
10467;Spragtukas;MEŠKIUKAI;8307801987;Ne;5;1;0;6
10468;Spragtukas;MEŠKIUKAI;1493711333;Ne;0;2;3;5
10469;Spragtukas;MEŠKIUKAI;4742132709;Taip;0;18;0;18
10470;Spragtukas;MEŠKIUKAI;1487259291;Ne;11;6;5;22
10471;Spragtukas;MEŠKIUKAI;8109894184;Ne;0;2;1;3
10472;Spragtukas;MEŠKIUKAI;8396134652;Ne;5;0;2;7
10473;Spragtukas;MEŠKIUKAI;1784758799;Ne;0;2;1;3
10474;Spragtukas;MEŠKIUKAI;4441290823;Ne;0;1;0;1
10475;Spragtukas;MEŠKIUKAI;8486415968;Ne;0;5;0;5
10476;Spragtukas;MEŠKIUKAI;2026249018;Ne;0;3;0;3
10477;Spragtukas;MEŠKIUKAI;3423699840;Ne;0;2;0;2
10478;Spragtukas;MEŠKIUKAI;1928122722;Ne;5;0;0;5
10479;Strazdelis;Žiogelių;9933042249;Ne;0;10;0;10
10480;Strazdelis;Žiogelių;8581533423;Ne;6;1;0;7
10481;Strazdelis;Žiogelių;8209625399;Ne;0;15;0;15
10482;Strazdelis;Žiogelių;1141752802;Ne;0;1;0;1
10483;Strazdelis;Žiogelių;1228651165;Ne;0;4;0;4
10484;Strazdelis;Žiogelių;7768700192;Ne;0;0;1;1
10485;Strazdelis;Žiogelių;3596394112;Ne;0;2;7;9
10486;Strazdelis;Žiogelių;4563247013;Ne;22;0;0;22
10487;Strazdelis;Žiogelių;6437928004;Ne;0;1;7;8
10488;Strazdelis;Žiogelių;8971395173;Ne;6;2;0;8
10489;Strazdelis;Žiogelių;4955907851;Ne;0;10;0;10
10490;Strazdelis;Žiogelių;7425818775;Ne;0;10;0;10
10491;Strazdelis;Žiogelių;4516288199;Ne;0;2;2;4
10492;Strazdelis;Žiogelių;3028208428;Ne;7;5;0;12
10493;Strazdelis;Žiogelių;2753635198;Ne;0;8;2;10
10494;Strazdelis;Žiogelių;1194918926;Ne;0;0;2;2
10495;Strazdelis;Žiogelių;6651360492;Ne;0;11;0;11
10496;Strazdelis;Žiogelių;8686828982;Taip;0;0;3;3
10497;Strazdelis;Žiogelių;7913526787;Ne;0;0;4;4
10498;Strazdelis;Šeimynėlės;3848288765;Ne;0;1;3;4
10499;Strazdelis;Šeimynėlės;5033799225;Ne;0;1;3;4
10500;Strazdelis;Šeimynėlės;1683900907;Ne;0;0;1;1
10501;Strazdelis;Šeimynėlės;2990771887;Ne;0;10;0;10
10502;Strazdelis;Šeimynėlės;2185364583;Ne;0;6;1;7
10503;Strazdelis;Šeimynėlės;7905687363;Ne;0;1;2;3
10504;Strazdelis;Šeimynėlės;4501391298;Ne;0;3;0;3
10505;Strazdelis;Šeimynėlės;9057914477;Ne;0;0;5;5
10506;Strazdelis;Šeimynėlės;1277844969;Ne;0;1;0;1
10507;Strazdelis;Šeimynėlės;1012692326;Ne;1;13;0;14
10508;Strazdelis;Šeimynėlės;8899530711;Ne;2;13;0;15
10509;Strazdelis;Šeimynėlės;8336759173;Ne;7;0;11;18
10510;Strazdelis;Šeimynėlės;5784406335;Ne;0;1;0;1
10511;Strazdelis;Šeimynėlės;5296218650;Ne;5;0;0;5
10512;Strazdelis;Šeimynėlės;1754106518;Ne;0;4;1;5
10513;Strazdelis;Šeimynėlės;9806107189;Ne;8;0;0;8
10514;Strazdelis;Šeimynėlės;5924324241;Ne;0;0;14;14
10515;Strazdelis;Šeimynėlės;8295035233;Ne;0;0;1;1
10516;Strazdelis;Šeimynėlės;1553329770;Ne;4;0;0;4
10517;Strazdelis;Genelio;8277333786;Ne;4;0;1;5
10518;Strazdelis;Genelio;9586256979;Ne;1;1;0;2
10519;Strazdelis;Genelio;3084249678;Ne;0;8;2;10
10520;Strazdelis;Genelio;7083940713;Ne;2;1;0;3
10521;Strazdelis;Genelio;6480803618;Ne;9;2;0;11
10522;Strazdelis;Genelio;9490861272;Ne;0;12;0;12
10523;Strazdelis;Genelio;6071502600;Ne;0;1;0;1
10524;Strazdelis;Genelio;3713797440;Ne;0;1;0;1
10525;Strazdelis;Genelio;3456287323;Ne;0;4;0;4
10526;Strazdelis;Genelio;1034497200;Ne;5;0;0;5
10527;Strazdelis;Genelio;2459718449;Ne;2;4;0;6
10528;Strazdelis;Genelio;2483283363;Ne;0;3;0;3
10529;Strazdelis;Genelio;5714581201;Ne;3;0;0;3
10530;Strazdelis;Genelio;8956634754;Ne;5;0;0;5
10531;Strazdelis;Genelio;8762859576;Ne;2;0;4;6
10532;Strazdelis;Genelio;2306665561;Ne;0;6;0;6
10533;Strazdelis;Genelio;7680242840;Ne;2;10;0;12
10534;Strazdelis;Genelio;5742215922;Ne;1;3;0;4
10535;Strazdelis;Genelio;6954336739;Ne;10;0;0;10
10536;Strazdelis;Vikruolių;2078150337;Ne;5;2;0;7
10537;Strazdelis;Vikruolių;8182994112;Ne;0;1;0;1
10538;Strazdelis;Vikruolių;2871673641;Ne;2;8;0;10
10539;Strazdelis;Vikruolių;9198429790;Ne;0;7;0;7
10540;Strazdelis;Vikruolių;4655931716;Ne;0;2;0;2
10541;Strazdelis;Vikruolių;6147183190;Ne;2;1;0;3
10542;Strazdelis;Vikruolių;7216768880;Ne;7;1;0;8
10543;Strazdelis;Vikruolių;7823110477;Ne;0;12;0;12
10544;Strazdelis;Vikruolių;7308925265;Ne;0;5;0;5
10545;Strazdelis;Vikruolių;50350281905;Ne;0;3;0;3
10546;Strazdelis;Vikruolių;5580738386;Ne;0;10;0;10
10547;Strazdelis;Vikruolių;3955783379;Ne;0;7;0;7
10548;Strazdelis;Vikruolių;4076266466;Ne;20;1;0;21
10549;Strazdelis;Vyturėlių;4929828091;Ne;0;1;0;1
10550;Strazdelis;Vyturėlių;4454199703;Ne;2;5;0;7
10551;Strazdelis;Vyturėlių;3662217925;Ne;0;4;0;4
10552;Strazdelis;Vyturėlių;4698566091;Ne;0;2;0;2
10553;Strazdelis;Vyturėlių;8274897977;Ne;9;1;0;10
10554;Strazdelis;Vyturėlių;1665134387;Ne;0;2;1;3
10555;Strazdelis;Vyturėlių;45083023033;Ne;2;0;3;5
10556;Strazdelis;Vyturėlių;5698472204;Ne;0;0;1;1
10557;Strazdelis;Vyturėlių;43314069648;Ne;0;1;0;1
10558;Strazdelis;Vyturėlių;1481671624;Ne;0;0;3;3
10559;Strazdelis;Vyturėlių;4697537943;Ne;0;4;0;4
10560;Strazdelis;Vyturėlių;6014213362;Ne;7;2;0;9
10561;Strazdelis;Vyturėlių;7900362267;Ne;0;0;1;1
10562;Strazdelis;Vyturėlių;9835716116;Ne;0;2;0;2
10563;Strazdelis;Vyturėlių;3943578036;Ne;3;1;0;4
10564;Strazdelis;Vyturėlių;2802486859;Ne;0;8;0;8
10565;Strazdelis;Vyturėlių;3482802557;Ne;0;2;0;2
10566;Strazdelis;Vyturėlių;5749300013;Ne;0;9;0;9
10567;Strazdelis;Vyturėlių;7215063033;Ne;0;1;0;1
10568;Strazdelis;Vyturėlių;7149827850;Ne;5;2;1;8
10569;Strazdelis;Vyturėlių;5834348507;Ne;0;11;0;11
10570;Strazdelis;Vyturėlių;2238875354;Ne;0;2;0;2
10571;Strazdelis;Varpelio;4159072583;Ne;0;5;0;5
10572;Strazdelis;Varpelio;2662549392;Ne;0;1;0;1
10573;Strazdelis;Varpelio;9502341478;Ne;0;2;0;2
10574;Strazdelis;Varpelio;6311710825;Ne;0;1;0;1
10575;Strazdelis;Varpelio;1955166372;Ne;0;5;0;5
10576;Strazdelis;Varpelio;4873707286;Ne;0;5;0;5
10577;Strazdelis;Varpelio;6527855940;Ne;0;3;0;3
10578;Strazdelis;Varpelio;2824416350;Ne;0;2;0;2
10579;Strazdelis;Varpelio;3610250359;Ne;0;5;0;5
10580;Strazdelis;Varpelio;2766970956;Ne;0;1;0;1
10581;Strazdelis;Varpelio;1173067724;Ne;5;1;0;6
10582;Strazdelis;Varpelio;1021364759;Ne;1;4;0;5
10583;Strazdelis;Varpelio;7393083827;Ne;0;7;0;7
10584;Strazdelis;Varpelio;6555803164;Ne;0;2;0;2
10585;Strazdelis;Varpelio;1706026100;Ne;9;0;0;9
10586;Strazdelis;Varpelio;8035603341;Ne;9;0;0;9
10587;Strazdelis;Varpelio;2789987994;Ne;0;5;0;5
10588;Strazdelis;Varpelio;2251157025;Ne;0;3;0;3
10589;Strazdelis;Varpelio;5904388732;Ne;0;6;0;6
10590;Strazdelis;Varpelio;3460993302;Ne;0;17;0;17
10591;Strazdelis;Varpelio;9776075027;Ne;14;0;0;14
10592;Strazdelis;Pelėdžiukų;5892430004;Taip;0;14;0;14
10593;Strazdelis;Pelėdžiukų;8637386316;Ne;0;1;3;4
10594;Strazdelis;Pelėdžiukų;1704292727;Ne;0;3;0;3
10595;Strazdelis;Pelėdžiukų;8371999002;Ne;0;8;0;8
10596;Strazdelis;Pelėdžiukų;6046139859;Ne;2;1;0;3
10597;Strazdelis;Pelėdžiukų;8287554571;Ne;0;3;0;3
10598;Strazdelis;Pelėdžiukų;8854150040;Ne;0;1;0;1
10599;Strazdelis;Pelėdžiukų;4004930488;Ne;0;2;1;3
10600;Strazdelis;Pelėdžiukų;5768674837;Ne;0;0;9;9
10601;Strazdelis;Pelėdžiukų;9761595867;Ne;4;6;0;10
10602;Strazdelis;Pelėdžiukų;1901641517;Ne;7;0;0;7
10603;Strazdelis;Pelėdžiukų;4617237063;Ne;0;2;0;2
10604;Strazdelis;Pelėdžiukų;3036380561;Ne;0;2;0;2
10605;Strazdelis;Pelėdžiukų;7471890377;Ne;0;4;0;4
10606;Strazdelis;Pelėdžiukų;7349106795;Ne;0;2;5;7
10607;Strazdelis;Pelėdžiukų;8938997208;Ne;0;2;0;2
10608;Strazdelis;Pelėdžiukų;4562530311;Ne;0;0;2;2
10609;Strazdelis;Saulutės;27177757900;Ne;0;2;0;2
10610;Strazdelis;Saulutės;40932140069;Ne;11;2;0;13
10611;Strazdelis;Saulutės;1523471662;Ne;0;1;0;1
10612;Strazdelis;Saulutės;7578229276;Ne;0;0;2;2
10613;Strazdelis;Saulutės;6614184499;Ne;0;1;0;1
10614;Strazdelis;Saulutės;4129957131;Ne;0;1;0;1
10615;Strazdelis;Saulutės;3425430317;Ne;0;2;0;2
10616;Strazdelis;Saulutės;7081517417;Ne;0;1;0;1
10617;Strazdelis;Saulutės;67641340859;Ne;0;2;0;2
10618;Strazdelis;Saulutės;15298412755;Ne;0;7;0;7
10619;Strazdelis;Saulutės;1802092125;Ne;0;9;0;9
10620;Strazdelis;Saulutės;1391009140;Ne;0;5;0;5
10621;Strazdelis;Saulutės;3316451889;Ne;0;2;0;2
10622;Strazdelis;Saulutės;6113491562;Ne;0;4;0;4
10623;Strazdelis;Saulutės;3753612757;Ne;0;1;0;1
10624;Strazdelis;Saulutės;1474503932;Ne;11;0;0;11
10625;Strazdelis;Saulutės;6779352728;Ne;2;0;0;2
10626;Strazdelis;Saulutės;9662566992;Ne;0;6;0;6
10627;Strazdelis;Bitutės;8485509145;Ne;4;5;0;9
10628;Strazdelis;Bitutės;6508933324;Ne;0;2;0;2
10629;Strazdelis;Bitutės;4020547762;Ne;0;4;0;4
10630;Strazdelis;Bitutės;8753316532;Ne;0;6;0;6
10631;Strazdelis;Bitutės;5232064496;Ne;0;6;0;6
10632;Strazdelis;Bitutės;9435593972;Ne;0;3;0;3
10633;Strazdelis;Bitutės;9555240419;Ne;0;9;0;9
10634;Strazdelis;Bitutės;3043580835;Ne;0;3;0;3
10635;Strazdelis;Bitutės;1539984888;Ne;0;2;0;2
10636;Strazdelis;Bitutės;4400849922;Ne;9;1;0;10
10637;Strazdelis;Bitutės;1881071425;Taip;3;0;2;5
10638;Strazdelis;Bitutės;2908567982;Ne;0;5;0;5
10639;Strazdelis;Bitutės;9548465554;Ne;0;13;0;13
10640;Strazdelis;Bitutės;7466648222;Ne;0;8;0;8
10641;Strazdelis;Bitutės;4463378251;Ne;2;1;0;3
10642;Strazdelis;Bitutės;2963535523;Ne;0;1;0;1
10643;Strazdelis;Bitutės;4369569609;Ne;0;4;1;5
10644;Strazdelis;Bitutės;2589303722;Ne;0;3;0;3
10645;Strazdelis;Bitutės;3149930355;Ne;0;3;0;3
10646;Strazdelis;Bitutės;2081538505;Ne;3;4;0;7
10647;Strazdelis;Mažylių;9357195019;Ne;0;0;2;2
10648;Strazdelis;Mažylių;5256750516;Ne;0;6;0;6
10649;Strazdelis;Mažylių;4740153387;Ne;10;1;0;11
10650;Strazdelis;Mažylių;4965049621;Ne;0;1;0;1
10651;Strazdelis;Mažylių;2378910473;Ne;0;22;0;22
10652;Strazdelis;Mažylių;3648883435;Ne;0;2;6;8
10653;Strazdelis;Mažylių;6788732053;Ne;2;1;0;3
10654;Strazdelis;Mažylių;2764495554;Ne;2;1;0;3
10655;Strazdelis;Mažylių;7039347901;Ne;0;8;2;10
10656;Strazdelis;Mažylių;4904388387;Ne;7;0;0;7
10657;Strazdelis;Mažylių;1265557971;Ne;0;2;1;3
10658;Strazdelis;Mažylių;3900225484;Ne;4;4;0;8
10659;Strazdelis;Mažylių;8734458997;Ne;3;0;3;6
10660;Strazdelis;Mažylių;3561551193;Ne;0;7;0;7
10661;Strazdelis;Mažylių;1932428439;Ne;0;1;0;1
10662;Strazdelis;Mažylių;2871841427;Ne;3;10;0;13
10663;Strazdelis;Mažylių;3572665646;Ne;0;0;1;1
10664;Strazdelis;Pabiručių;7087235151;Ne;11;6;0;17
10665;Strazdelis;Pabiručių;6853311266;Ne;12;1;0;13
10666;Strazdelis;Pabiručių;3030445367;Ne;4;1;0;5
10667;Strazdelis;Pabiručių;4966668662;Ne;2;0;0;2
10668;Strazdelis;Pabiručių;8484672456;Ne;7;1;0;8
10669;Strazdelis;Pabiručių;8953577585;Ne;3;0;0;3
10670;Strazdelis;Pabiručių;1823053560;Ne;7;0;15;22
10671;Strazdelis;Pabiručių;8677659019;Ne;12;1;0;13
10672;Strazdelis;Pabiručių;4848650799;Ne;4;7;0;11
10673;Strazdelis;Pabiručių;7716476995;Ne;10;0;0;10
10674;Strazdelis;Pabiručių;4174940099;Ne;15;2;0;17
10675;Strazdelis;Pabiručių;7065489134;Ne;5;0;0;5
10676;Strazdelis;Pabiručių;8554043784;Ne;0;16;2;18
10677;Strazdelis;Pabiručių;1952086370;Ne;0;11;0;11
10678;Strazdelis;Pabiručių;7802337169;Ne;8;0;0;8
10679;Strazdelis;Pabiručių;4461728361;Ne;5;0;3;8
10680;Strazdelis;Pabiručių;8356680705;Ne;6;2;0;8
10681;Strazdelis;Pabiručių;6457478289;Ne;7;1;0;8
10682;Strazdelis;Pabiručių;3426039979;Ne;18;1;0;19
10683;Strazdelis;Pabiručių;4715198107;Ne;5;0;0;5
10684;Strazdelis;Pabiručių;4334385271;Ne;10;0;0;10
10685;Strazdelis;Pabiručių;1770338988;Ne;0;6;0;6
10686;Strazdelis;"NAUJA (MODUILINIS)";4135433644;Ne;5;0;0;5
10687;Sveikuolis;Gintarėlis;4270680590;Ne;5;0;0;5
10688;Sveikuolis;Boružėlė;5591658359;Ne;7;0;0;7
10689;Sveikuolis;Boružėlė;5596741669;Ne;3;0;0;3
10690;Sveikuolis;BITUTĖ;6409695736;Ne;13;0;0;13
10691;Sveikuolis;VARPELIS;5936442120;Ne;10;0;0;10
10692;Sveikuolis;VARPELIS;5515614747;Ne;17;0;0;17
10693;Sveikuolis;VARPELIS;9873943920;Ne;11;0;0;11
10694;Sveikuolis;DRUGELIAI;1265118618;Ne;11;0;0;11
10695;Sveikuolis;DRUGELIAI;9694991713;Ne;7;0;0;7
10696;Sveikuolis;DRUGELIAI;4876267122;Ne;22;0;0;22
10697;Sveikuolis;ŽVAIGŽDUTĖ;8011420868;Ne;11;0;0;11
10698;Sveikuolis;ŽVAIGŽDUTĖ;8105068323;Ne;4;0;0;4
10699;Sveikuolis;ŽVAIGŽDUTĖ;9893764995;Ne;11;0;0;11
10700;Sveikuolis;SAULĖGRĄŽA;9148884980;Ne;4;0;0;4
10701;Sveikuolis;SAULĖGRĄŽA;3193360581;Ne;9;0;0;9
10702;Šermukšnėlė;MOLINUKAI;4638109666;Ne;0;0;7;7
10703;Šermukšnėlė;MOLINUKAI;9329824053;Ne;0;8;0;8
10704;Šermukšnėlė;MOLINUKAI;2714018690;Ne;7;0;2;9
10705;Šermukšnėlė;MOLINUKAI;5262882873;Ne;12;1;0;13
10706;Šermukšnėlė;MOLINUKAI;2784732759;Ne;0;0;5;5
10707;Šermukšnėlė;MOLINUKAI;3342919832;Ne;11;0;0;11
10708;Šermukšnėlė;MOLINUKAI;9337047371;Ne;0;0;1;1
10709;Šermukšnėlė;MOLINUKAI;2098090763;Ne;0;0;2;2
10710;Šermukšnėlė;MOLINUKAI;5835100042;Ne;2;0;4;6
10711;Šermukšnėlė;MOLINUKAI;8000479161;Ne;0;0;1;1
10712;Šermukšnėlė;MOLINUKAI;4952285322;Ne;0;12;0;12
10713;Šermukšnėlė;MOLINUKAI;6608458145;Ne;0;0;1;1
10714;Šermukšnėlė;MOLINUKAI;8104182167;Ne;5;0;5;10
10715;Šermukšnėlė;MOLINUKAI;6988120570;Ne;0;14;0;14
10716;Šermukšnėlė;MOLINUKAI;8728441474;Ne;10;0;0;10
10717;Šermukšnėlė;MOLINUKAI;4075151928;Ne;0;0;4;4
10718;Šermukšnėlė;MOLINUKAI;9527382390;Ne;0;0;1;1
10719;Šermukšnėlė;MOLINUKAI;4968522498;Ne;9;7;0;16
10720;Šermukšnėlė;ŠIAUDINUKAI;7002917737;Ne;12;0;0;12
10721;Šermukšnėlė;ŠIAUDINUKAI;7785671936;Ne;6;0;0;6
10722;Šermukšnėlė;ŠIAUDINUKAI;3637882900;Ne;0;8;0;8
10723;Šermukšnėlė;ŠIAUDINUKAI;1159472154;Ne;0;0;2;2
10724;Šermukšnėlė;ŠIAUDINUKAI;4956414941;Ne;12;0;2;14
10725;Šermukšnėlė;ŠIAUDINUKAI;3499394539;Ne;22;0;0;22
10726;Šermukšnėlė;ŠIAUDINUKAI;1157979179;Ne;0;6;0;6
10727;Šermukšnėlė;ŠIAUDINUKAI;3701053997;Taip;10;0;3;13
10728;Šermukšnėlė;ŠIAUDINUKAI;3082272196;Ne;0;0;4;4
10729;Šermukšnėlė;ŠIAUDINUKAI;9903310024;Ne;0;1;1;2
10730;Šermukšnėlė;ŠIAUDINUKAI;5627334876;Ne;7;0;0;7
10731;Šermukšnėlė;ŠIAUDINUKAI;3550736579;Ne;22;0;0;22
10732;Šermukšnėlė;ŠIAUDINUKAI;5993599994;Ne;0;0;11;11
10733;Šermukšnėlė;ŠIAUDINUKAI;6077798297;Ne;0;0;1;1
10734;Šermukšnėlė;ŠIAUDINUKAI;2351386211;Ne;7;0;3;10
10735;Šermukšnėlė;TOŠINUKAI;2160616078;Ne;0;0;8;8
10736;Šermukšnėlė;TOŠINUKAI;1661977128;Ne;9;0;3;12
10737;Šermukšnėlė;TOŠINUKAI;3994316729;Ne;0;0;3;3
10738;Šermukšnėlė;TOŠINUKAI;1459253197;Ne;0;0;2;2
10739;Šermukšnėlė;TOŠINUKAI;78341448188;Ne;11;0;2;13
10740;Šermukšnėlė;TOŠINUKAI;8279692394;Ne;0;0;6;6
10741;Šermukšnėlė;TOŠINUKAI;5096946133;Ne;0;0;2;2
10742;Šermukšnėlė;TOŠINUKAI;2380988728;Ne;0;1;2;3
10743;Šermukšnėlė;TOŠINUKAI;8956573129;Ne;0;0;1;1
10744;Šermukšnėlė;TOŠINUKAI;4981204674;Ne;0;1;0;1
10745;Šermukšnėlė;TOŠINUKAI;7229632099;Ne;8;0;2;10
10746;Šermukšnėlė;TOŠINUKAI;2529526401;Ne;0;0;5;5
10747;Šermukšnėlė;TOŠINUKAI;7038705221;Ne;0;13;0;13
10748;Šermukšnėlė;TOŠINUKAI;6413821285;Ne;4;12;0;16
10749;Šermukšnėlė;TOŠINUKAI;9035625467;Ne;5;0;4;9
10750;Šermukšnėlė;TOŠINUKAI;5832072195;Ne;0;8;0;8
10751;Šermukšnėlė;TOŠINUKAI;3222466449;Ne;1;0;4;5
10752;Šermukšnėlė;TOŠINUKAI;6430627501;Ne;0;0;2;2
10753;Šermukšnėlė;ODINUKAI;4422415026;Ne;0;0;8;8
10754;Šermukšnėlė;ODINUKAI;5545018656;Ne;0;0;1;1
10755;Šermukšnėlė;ODINUKAI;2176788727;Ne;0;0;6;6
10756;Šermukšnėlė;ODINUKAI;5733540837;Ne;0;0;4;4
10757;Šermukšnėlė;ODINUKAI;7262199284;Ne;1;0;2;3
10758;Šermukšnėlė;ODINUKAI;5159461963;Ne;0;1;0;1
10759;Šermukšnėlė;ODINUKAI;5354978646;Ne;5;1;2;8
10760;Šermukšnėlė;ODINUKAI;1882432812;Ne;5;1;2;8
10761;Šermukšnėlė;ODINUKAI;3949629658;Ne;0;13;0;13
10762;Šermukšnėlė;ODINUKAI;7667114310;Ne;14;0;0;14
10763;Šermukšnėlė;ODINUKAI;7245206247;Ne;0;0;4;4
10764;Šermukšnėlė;ODINUKAI;5397385093;Ne;0;0;2;2
10765;Šermukšnėlė;ODINUKAI;4331948700;Ne;0;0;2;2
10766;Šermukšnėlė;ODINUKAI;6718242890;Ne;0;0;3;3
10767;Šermukšnėlė;ODINUKAI;9664249364;Taip;5;0;0;5
10768;Šermukšnėlė;ODINUKAI;1064222922;Ne;1;0;3;4
10769;Šermukšnėlė;ODINUKAI;7770630580;Ne;0;0;1;1
10770;Šermukšnėlė;ODINUKAI;6194188831;Ne;0;0;4;4
10771;Šermukšnėlė;KRIAUKLELĖS;8541743148;Ne;0;1;0;1
10772;Šermukšnėlė;KRIAUKLELĖS;8709426669;Ne;11;9;0;20
10773;Šermukšnėlė;KRIAUKLELĖS;6585484701;Ne;8;0;1;9
10774;Šermukšnėlė;KRIAUKLELĖS;6599779539;Ne;3;5;0;8
10775;Šermukšnėlė;KRIAUKLELĖS;9876533442;Ne;0;0;6;6
10776;Šermukšnėlė;KRIAUKLELĖS;3653792683;Ne;0;2;4;6
10777;Šermukšnėlė;KRIAUKLELĖS;2506945279;Ne;0;0;3;3
10778;Šermukšnėlė;KRIAUKLELĖS;7266947985;Ne;0;0;1;1
10779;Šermukšnėlė;KRIAUKLELĖS;4256630681;Ne;5;0;0;5
10780;Šermukšnėlė;KRIAUKLELĖS;8117261716;Ne;7;0;0;7
10781;Šermukšnėlė;KRIAUKLELĖS;3245643086;Ne;5;9;0;14
10782;Šermukšnėlė;KRIAUKLELĖS;6342714998;Ne;0;0;2;2
10783;Šermukšnėlė;KRIAUKLELĖS;6946711443;Ne;0;0;1;1
10784;Šermukšnėlė;KRIAUKLELĖS;9074111563;Ne;0;1;0;1
10785;Šermukšnėlė;KRIAUKLELĖS;9908568127;Ne;3;4;0;7
10786;Šermukšnėlė;KRIAUKLELĖS;9783673534;Ne;0;0;1;1
10787;Šermukšnėlė;KRIAUKLELĖS;5408843906;Ne;0;1;0;1
10788;Šermukšnėlė;VYTINUKAI;1523361932;Ne;2;0;0;2
10789;Šermukšnėlė;VYTINUKAI;8531953934;Ne;0;0;3;3
10790;Šermukšnėlė;VYTINUKAI;25189813939;Ne;0;7;1;8
10791;Šermukšnėlė;VYTINUKAI;83123267733;Ne;0;0;1;1
10792;Šermukšnėlė;VYTINUKAI;20028832329;Ne;0;4;0;4
10793;Šermukšnėlė;VYTINUKAI;3959795064;Ne;2;0;0;2
10794;Šermukšnėlė;VYTINUKAI;1244964311;Ne;2;0;0;2
10795;Šermukšnėlė;VYTINUKAI;83882579952;Ne;0;3;0;3
10796;Šermukšnėlė;VYTINUKAI;1025787925;Ne;0;3;0;3
10797;Šermukšnėlė;VYTINUKAI;1519623099;Ne;0;2;0;2
10798;Šermukšnėlė;VYTINUKAI;9654198217;Ne;8;0;2;10
10799;Šermukšnėlė;VYTINUKAI;1670047548;Ne;4;0;3;7
10800;Šermukšnėlė;VYTINUKAI;5281637612;Ne;0;0;5;5
10801;Šermukšnėlė;VYTINUKAI;8123096990;Ne;0;10;0;10
10802;Šermukšnėlė;VYTINUKAI;8511421692;Ne;0;0;1;1
10803;Šermukšnėlė;VYTINUKAI;3883861823;Ne;0;8;0;8
10804;Šermukšnėlė;VYTINUKAI;2163955454;Ne;0;0;2;2
10805;Šermukšnėlė;GINTARĖLIAI;8249749948;Ne;0;0;2;2
10806;Šermukšnėlė;GINTARĖLIAI;2989011150;Ne;0;1;0;1
10807;Šermukšnėlė;GINTARĖLIAI;3747531232;Ne;0;1;2;3
10808;Šermukšnėlė;GINTARĖLIAI;1996859146;Ne;0;0;1;1
10809;Šermukšnėlė;GINTARĖLIAI;4176986876;Ne;0;5;0;5
10810;Šermukšnėlė;GINTARĖLIAI;7036078780;Ne;0;5;0;5
10811;Šermukšnėlė;GINTARĖLIAI;1994737857;Ne;0;11;0;11
10812;Šermukšnėlė;GINTARĖLIAI;4619811264;Ne;0;9;0;9
10813;Šermukšnėlė;GINTARĖLIAI;5886893562;Ne;21;0;0;21
10814;Šermukšnėlė;GINTARĖLIAI;4783726095;Ne;0;4;0;4
10815;Šermukšnėlė;GINTARĖLIAI;9714566919;Ne;0;8;0;8
10816;Šermukšnėlė;GINTARĖLIAI;5172187141;Ne;0;8;0;8
10817;Šermukšnėlė;GINTARĖLIAI;3688946505;Ne;0;0;5;5
10818;Šermukšnėlė;GINTARĖLIAI;5905330617;Ne;2;0;1;3
10819;Šermukšnėlė;GINTARĖLIAI;1636944853;Ne;0;13;0;13
10820;Šermukšnėlė;GINTARĖLIAI;7053319091;Ne;0;0;2;2
10821;Šermukšnėlė;GINTARĖLIAI;6351841889;Taip;15;0;0;15
10822;Šermukšnėlė;GINTARĖLIAI;7305013368;Ne;0;1;0;1
10823;Šermukšnėlė;GINTARĖLIAI;6698650179;Ne;0;0;1;1
10824;Šermukšnėlė;GINTARĖLIAI;7106405983;Ne;2;0;1;3
10825;Šermukšnėlė;AKMENUKAI;3543061360;Ne;6;1;0;7
10826;Šermukšnėlė;AKMENUKAI;7564745299;Ne;0;10;0;10
10827;Šermukšnėlė;AKMENUKAI;9617044855;Ne;18;2;0;20
10828;Šermukšnėlė;AKMENUKAI;1856012121;Ne;0;0;5;5
10829;Šermukšnėlė;AKMENUKAI;8407947566;Ne;2;0;0;2
10830;Šermukšnėlė;AKMENUKAI;8859731179;Ne;0;0;1;1
10831;Šermukšnėlė;AKMENUKAI;1902848560;Ne;0;7;0;7
10832;Šermukšnėlė;AKMENUKAI;3513568460;Ne;0;0;9;9
10833;Šermukšnėlė;AKMENUKAI;6896990721;Ne;1;0;1;2
10834;Šermukšnėlė;AKMENUKAI;4230698872;Ne;4;0;0;4
10835;Šermukšnėlė;AKMENUKAI;8669676262;Ne;0;7;0;7
10836;Šermukšnėlė;AKMENUKAI;3148857617;Ne;0;11;0;11
10837;Šermukšnėlė;AKMENUKAI;3639954786;Ne;13;0;6;19
10838;Šermukšnėlė;AKMENUKAI;7843128263;Ne;0;1;0;1
10839;Šermukšnėlė;AKMENUKAI;9805841777;Ne;13;1;0;14
10840;Šermukšnėlė;AKMENUKAI;3945291560;Ne;0;7;0;7
10841;Šermukšnėlė;AKMENUKAI;5660238634;Ne;1;8;0;9
10842;Šermukšnėlė;AKMENUKAI;6067298318;Ne;11;0;0;11
10843;Šermukšnėlė;AKMENUKAI;5678559268;Ne;5;0;1;6
10844;Šermukšnėlė;AKMENUKAI;8479230675;Ne;7;6;0;13
10845;Šermukšnėlė;AKMENUKAI;6162830167;Ne;15;0;0;15
10846;Šermukšnėlė;AKMENUKAI;2913363351;Ne;1;0;0;1
10847;Šermukšnėlė;SIŪLINUKAI;4619600451;Ne;0;0;1;1
10848;Šermukšnėlė;SIŪLINUKAI;2967000352;Ne;3;0;1;4
10849;Šermukšnėlė;SIŪLINUKAI;2740644605;Ne;13;0;0;13
10850;Šermukšnėlė;SIŪLINUKAI;8454298610;Ne;8;0;0;8
10851;Šermukšnėlė;SIŪLINUKAI;6429038861;Ne;8;0;1;9
10852;Šermukšnėlė;SIŪLINUKAI;6429038861;Ne;8;0;1;9
10853;Šermukšnėlė;SIŪLINUKAI;6429038861;Ne;8;0;1;9
10854;Šermukšnėlė;SIŪLINUKAI;6429038861;Ne;8;0;1;9
10855;Šermukšnėlė;SIŪLINUKAI;1819553019;Ne;17;0;5;22
10856;Šermukšnėlė;SIŪLINUKAI;7568969509;Ne;22;0;0;22
10857;Šermukšnėlė;SIŪLINUKAI;7758886713;Ne;10;0;0;10
10858;Šermukšnėlė;SIŪLINUKAI;4390650081;Ne;0;1;1;2
10859;Šermukšnėlė;SIŪLINUKAI;5072021867;Ne;3;3;0;6
10860;Šermukšnėlė;SIŪLINUKAI;7934772640;Ne;3;3;0;6
10861;Šermukšnėlė;SIŪLINUKAI;3994075596;Ne;5;0;0;5
10862;Šermukšnėlė;SIŪLINUKAI;6231057889;Ne;0;0;1;1
10863;Šermukšnėlė;SIŪLINUKAI;3106890807;Ne;6;1;0;7
10864;Šermukšnėlė;SIŪLINUKAI;3979766151;Ne;10;0;0;10
10865;Šermukšnėlė;SIŪLINUKAI;9534316724;Ne;11;0;0;11
10866;Šermukšnėlė;SIŪLINUKAI;2705569653;Ne;0;0;1;1
10867;Šermukšnėlė;MEDINUKAi;8558117857;Ne;0;0;1;1
10868;Šermukšnėlė;MEDINUKAi;6149973884;Taip;0;2;3;5
10869;Šermukšnėlė;MEDINUKAi;5874725607;Ne;0;0;2;2
10870;Šermukšnėlė;MEDINUKAi;7532979465;Ne;4;1;1;6
10871;Šermukšnėlė;MEDINUKAi;3359398381;Ne;0;6;0;6
10872;Šermukšnėlė;MEDINUKAi;8200175951;Ne;10;0;2;12
10873;Šermukšnėlė;MEDINUKAi;7546040491;Ne;21;0;0;21
10874;Šermukšnėlė;MEDINUKAi;9872479998;Ne;13;0;2;15
10875;Šermukšnėlė;MEDINUKAi;5605191023;Ne;22;0;0;22
10876;Šermukšnėlė;MEDINUKAi;2698741674;Ne;0;4;1;5
10877;Šermukšnėlė;SKUDURINUKAI;7523588943;Ne;0;0;4;4
10878;Šermukšnėlė;SKUDURINUKAI;2235123503;Ne;0;0;3;3
10879;Šermukšnėlė;SKUDURINUKAI;3138507073;Ne;7;0;4;11
10880;Šermukšnėlė;SKUDURINUKAI;5162694179;Ne;5;10;1;16
10881;Šermukšnėlė;SKUDURINUKAI;9247356229;Ne;11;9;0;20
10882;Šermukšnėlė;SKUDURINUKAI;3206222470;Ne;18;0;0;18
10883;Šermukšnėlė;SKUDURINUKAI;5751303170;Ne;19;0;0;19
10884;Šermukšnėlė;SKUDURINUKAI;2810624440;Ne;0;5;0;5
10885;Šermukšnėlė;SKUDURINUKAI;3955219247;Ne;5;14;0;19
10886;Šermukšnėlė;SKUDURINUKAI;5564759354;Ne;15;0;0;15
10887;Šermukšnėlė;SKUDURINUKAI;1931894084;Ne;10;0;0;10
10888;Šermukšnėlė;SKUDURINUKAI;6778901855;Ne;0;0;3;3
10889;Šermukšnėlė;SKUDURINUKAI;1502704170;Ne;7;0;3;10
10890;Šermukšnėlė;SKUDURINUKAI;6524173015;Ne;0;8;0;8
10891;Šermukšnėlė;SKUDURINUKAI;4323596263;Ne;4;0;1;5
10892;Šermukšnėlė;SKUDURINUKAI;9005316719;Ne;14;1;0;15
10893;Šermukšnėlė;PAGRANDUKAI;8802335133;Ne;7;0;3;10
10894;Šermukšnėlė;PAGRANDUKAI;6797936390;Ne;0;2;0;2
10895;Šermukšnėlė;PAGRANDUKAI;1312471779;Taip;10;0;1;11
10896;Šermukšnėlė;PAGRANDUKAI;6286235756;Ne;2;1;0;3
10897;Šermukšnėlė;PAGRANDUKAI;4219655802;Ne;6;0;1;7
10898;Šermukšnėlė;PAGRANDUKAI;4337084152;Ne;7;0;1;8
10899;Šermukšnėlė;PAGRANDUKAI;8092422909;Ne;11;0;4;15
10900;Šermukšnėlė;PAGRANDUKAI;9246072554;Ne;8;1;0;9
10901;Šermukšnėlė;PAGRANDUKAI;6185588116;Taip;10;0;0;10
10902;Šermukšnėlė;PAGRANDUKAI;1209135668;Ne;12;0;0;12
10903;Šermukšnėlė;PAGRANDUKAI;9080074486;Ne;7;1;2;10
10904;Šermukšnėlė;PAGRANDUKAI;7098953763;Ne;9;0;1;10
10905;Šermukšnėlė;PAGRANDUKAI;5081685546;Ne;12;2;5;19
10906;Šermukšnėlė;PAGRANDUKAI;5456669766;Ne;6;1;0;7
10907;Šermukšnėlė;PAGRANDUKAI;8641098720;Ne;7;0;1;8
10908;Šermukšnėlė;PAGRANDUKAI;4810571143;Ne;6;1;0;7
10909;Šermukšnėlė;PAGRANDUKAI;8130815072;Ne;0;1;0;1
10910;Šypsena;NYKŠTUKAI;8913058656;Ne;0;1;7;8
10911;Šypsena;NYKŠTUKAI;8508569167;Ne;3;2;0;5
10912;Šypsena;NYKŠTUKAI;5818211923;Ne;0;8;0;8
10913;Šypsena;NYKŠTUKAI;8665786789;Ne;9;5;4;18
10914;Šypsena;NYKŠTUKAI;1716274053;Ne;0;1;3;4
10915;Šypsena;NYKŠTUKAI;6724776618;Ne;5;10;7;22
10916;Šypsena;NYKŠTUKAI;2790906806;Ne;0;5;1;6
10917;Šypsena;NYKŠTUKAI;9363618080;Ne;11;1;0;12
10918;Šypsena;NYKŠTUKAI;9702364620;Ne;0;10;0;10
10919;Šypsena;NYKŠTUKAI;3733757483;Ne;2;12;2;16
10920;Šypsena;NYKŠTUKAI;2179657619;Ne;0;5;0;5
10921;Šypsena;NYKŠTUKAI;2900195046;Ne;8;7;0;15
10922;Šypsena;NYKŠTUKAI;3724645162;Ne;4;5;0;9
10923;Šypsena;NYKŠTUKAI;3003901966;Ne;5;9;0;14
10924;Šypsena;NYKŠTUKAI;2182189246;Ne;5;4;0;9
10925;Šypsena;NYKŠTUKAI;1431850136;Ne;0;6;0;6
10926;Šypsena;NYKŠTUKAI;5142969776;Ne;0;12;4;16
10927;Šypsena;NYKŠTUKAI;8439694239;Ne;8;6;0;14
10928;Šypsena;NYKŠTUKAI;6377979434;Ne;0;3;6;9
10929;Šypsena;NYKŠTUKAI;7332307199;Ne;10;0;0;10
10930;Šypsena;NYKŠTUKAI;7074211876;Ne;0;11;0;11
10931;Šypsena;SPINDULIUKAI;7898387398;Ne;0;1;6;7
10932;Šypsena;SPINDULIUKAI;1324902555;Ne;5;10;0;15
10933;Šypsena;SPINDULIUKAI;5222603743;Ne;0;1;0;1
10934;Šypsena;SPINDULIUKAI;7120597034;Ne;0;9;6;15
10935;Šypsena;SPINDULIUKAI;5879506651;Ne;0;9;0;9
10936;Šypsena;SPINDULIUKAI;4695547847;Ne;5;0;0;5
10937;Šypsena;SPINDULIUKAI;6713182218;Ne;0;11;0;11
10938;Šypsena;SPINDULIUKAI;8215278033;Ne;0;8;0;8
10939;Šypsena;SPINDULIUKAI;7537442618;Ne;0;8;0;8
10940;Šypsena;SPINDULIUKAI;2584574423;Ne;0;7;0;7
10941;Šypsena;SPINDULIUKAI;9704350208;Ne;0;0;4;4
10942;Šypsena;SPINDULIUKAI;5906001927;Ne;11;3;0;14
10943;Šypsena;SPINDULIUKAI;6951845385;Ne;0;4;3;7
10944;Šypsena;SPINDULIUKAI;7877396588;Ne;0;12;0;12
10945;Šypsena;SPINDULIUKAI;4520148322;Ne;7;0;0;7
10946;Šypsena;SPINDULIUKAI;3901424559;Ne;0;13;0;13
10947;Šypsena;SPINDULIUKAI;8765509994;Ne;0;12;2;14
10948;Šypsena;SPINDULIUKAI;3429836513;Ne;0;9;22;31
10949;Šypsena;SPINDULIUKAI;8566236342;Ne;8;0;3;11
10950;Šypsena;SKRUZDELIUKAI;5611440056;Ne;4;8;0;12
10951;Šypsena;SKRUZDELIUKAI;1114341518;Taip;0;10;5;15
10952;Šypsena;SKRUZDELIUKAI;1558614852;Ne;0;15;0;15
10953;Šypsena;SKRUZDELIUKAI;1897176871;Ne;5;12;0;17
10954;Šypsena;SKRUZDELIUKAI;1181590127;Ne;9;18;0;27
10955;Šypsena;SKRUZDELIUKAI;4808041625;Ne;20;5;0;25
10956;Šypsena;SKRUZDELIUKAI;5834057370;Ne;0;6;0;6
10957;Šypsena;SKRUZDELIUKAI;5504570516;Ne;0;5;3;8
10958;Šypsena;SKRUZDELIUKAI;1063834589;Ne;5;1;0;6
10959;Šypsena;SKRUZDELIUKAI;5369445077;Ne;0;8;0;8
10960;Šypsena;SKRUZDELIUKAI;2798819321;Ne;0;6;0;6
10961;Šypsena;SKRUZDELIUKAI;4450146424;Ne;9;0;0;9
10962;Šypsena;Bitutės;1796837022;Ne;0;2;2;4
10963;Šypsena;Bitutės;6590285866;Ne;0;0;8;8
10964;Šypsena;Bitutės;4766170132;Ne;0;3;1;4
10965;Šypsena;Bitutės;7569495879;Ne;7;3;0;10
10966;Šypsena;Bitutės;6832433711;Ne;0;5;0;5
10967;Šypsena;Bitutės;2995753269;Ne;0;6;2;8
10968;Šypsena;Bitutės;2312828770;Ne;4;2;0;6
10969;Šypsena;Bitutės;2248628927;Ne;0;8;0;8
10970;Šypsena;Bitutės;2706678026;Ne;8;0;0;8
10971;Šypsena;Bitutės;7413098580;Ne;0;11;0;11
10972;Šypsena;Bitutės;3063226692;Ne;0;0;4;4
10973;Šypsena;Bitutės;5985974927;Ne;5;1;0;6
10974;Šypsena;Bitutės;3387625466;Ne;7;0;0;7
10975;Šypsena;Bitutės;1669768648;Ne;7;10;0;17
10976;Šypsena;Bitutės;1575413188;Ne;0;11;0;11
10977;Šypsena;Bitutės;6511231991;Ne;0;1;0;1
10978;Šypsena;Bitutės;2005543016;Ne;0;1;1;2
10979;Šypsena;Bitutės;5568502083;Ne;0;4;0;4
10980;Šypsena;MEŠKIUKAI;9696633725;Ne;17;0;0;17
10981;Šypsena;MEŠKIUKAI;7876871684;Ne;5;5;0;10
10982;Šypsena;MEŠKIUKAI;6055482561;Ne;23;0;0;23
10983;Šypsena;MEŠKIUKAI;6028006499;Ne;10;1;2;13
10984;Šypsena;MEŠKIUKAI;3724483762;Ne;16;5;0;21
10985;Šypsena;MEŠKIUKAI;7817486488;Ne;22;10;0;32
10986;Šypsena;MEŠKIUKAI;9862387726;Ne;5;7;0;12
10987;Šypsena;MEŠKIUKAI;8001187137;Ne;0;7;0;7
10988;Šypsena;MEŠKIUKAI;3663446767;Ne;0;8;0;8
10989;Šypsena;MEŠKIUKAI;8094166916;Ne;8;0;0;8
10990;Šypsena;MEŠKIUKAI;5446516798;Ne;10;0;0;10
10991;Šypsena;MEŠKIUKAI;5094556499;Ne;15;0;1;16
10992;Šypsena;MEŠKIUKAI;4496704989;Ne;0;15;3;18
10993;Šypsena;MEŠKIUKAI;7471913547;Ne;0;0;1;1
10994;Šypsena;MEŠKIUKAI;7174068697;Ne;9;0;0;9
10995;Šypsena;BORUŽĖLĖS;6738149077;Ne;9;2;11;22
10996;Šypsena;BORUŽĖLĖS;7905089772;Ne;1;0;3;4
10997;Šypsena;BORUŽĖLĖS;4011596895;Ne;7;0;3;10
10998;Šypsena;BORUŽĖLĖS;7234904026;Ne;11;5;0;16
10999;Šypsena;BORUŽĖLĖS;8963484558;Ne;8;1;0;9
11000;Šypsena;BORUŽĖLĖS;3951000812;Ne;0;17;0;17
11001;Šypsena;BORUŽĖLĖS;2177181171;Ne;12;0;3;15
11002;Šypsena;BORUŽĖLĖS;7960872132;Ne;10;0;0;10
11003;Šypsena;BORUŽĖLĖS;4260693029;Ne;0;18;0;18
11004;Šypsena;BORUŽĖLĖS;1657019248;Ne;11;0;0;11
11005;Šypsena;BORUŽĖLĖS;8756079118;Ne;0;9;0;9
11006;Šypsena;BORUŽĖLĖS;6859531936;Ne;2;1;5;8
11007;Šnekutis;DRUGELIŲ;1504945841;Ne;5;13;0;18
11008;Šnekutis;DRUGELIŲ;3096125224;Ne;0;14;1;15
11009;Šnekutis;DRUGELIŲ;3386995244;Ne;2;0;0;2
11010;Šnekutis;DRUGELIŲ;2131948397;Ne;0;10;0;10
11011;Šnekutis;DRUGELIŲ;1902486846;Ne;0;0;1;1
11012;Šnekutis;DRUGELIŲ;8984597121;Ne;12;0;0;12
11013;Šnekutis;DRUGELIŲ;8810371475;Ne;5;0;0;5
11014;Šnekutis;DRUGELIŲ;7680962037;Ne;0;12;10;22
11015;Šnekutis;DRUGELIŲ;3611064172;Ne;0;3;3;6
11016;Šnekutis;DRUGELIŲ;8209686459;Ne;0;2;0;2
11017;Šnekutis;DRUGELIŲ;8036600501;Ne;5;0;0;5
11018;Šnekutis;DRUGELIŲ;6071004512;Ne;0;1;4;5
11019;Šnekutis;DRUGELIŲ;8570372260;Ne;0;1;1;2
11020;Šnekutis;DRUGELIŲ;1556960616;Ne;0;2;17;19
11021;Šnekutis;DRUGELIŲ;3177449195;Ne;0;3;0;3
11022;Šnekutis;DRUGELIŲ;4380966487;Ne;0;0;1;1
11023;Šnekutis;DRUGELIŲ;7954240439;Ne;9;2;0;11
11024;Šnekutis;DRUGELIŲ;6330033887;Ne;0;4;0;4
11025;Šnekutis;Kačiukų;9780684867;Ne;0;9;0;9
11026;Šnekutis;Kačiukų;3166309530;Ne;0;1;3;4
11027;Šnekutis;Kačiukų;7638626055;Taip;0;0;4;4
11028;Šnekutis;Kačiukų;2914145045;Ne;16;5;0;21
11029;Šnekutis;Kačiukų;8340697546;Ne;0;1;2;3
11030;Šnekutis;Kačiukų;2656152037;Ne;0;3;0;3
11031;Šnekutis;Kačiukų;9051956302;Ne;2;0;20;22
11032;Šnekutis;Kačiukų;5521822696;Ne;0;15;0;15
11033;Šnekutis;Kačiukų;9942669058;Ne;0;1;3;4
11034;Šnekutis;Kačiukų;4624075875;Ne;10;1;0;11
11035;Šnekutis;Pėlėdžiukų;5188035949;Ne;0;0;6;6
11036;Šnekutis;Pėlėdžiukų;4334155280;Ne;0;1;2;3
11037;Šnekutis;Pėlėdžiukų;77534335117;Ne;0;0;5;5
11038;Šnekutis;Pėlėdžiukų;8866360301;Ne;0;1;0;1
11039;Šnekutis;Pėlėdžiukų;8745465796;Ne;0;0;20;20
11040;Šnekutis;Pėlėdžiukų;3578045341;Ne;0;1;2;3
11041;Šnekutis;Pėlėdžiukų;5117544317;Ne;0;0;2;2
11042;Šnekutis;Pėlėdžiukų;5615869149;Ne;11;1;0;12
11043;Šnekutis;Pėlėdžiukų;1329958641;Ne;0;1;5;6
11044;Šnekutis;Pėlėdžiukų;9511116249;Ne;0;1;0;1
11045;Šnekutis;Pėlėdžiukų;1682748852;Taip;3;7;1;11
11046;Šnekutis;Pėlėdžiukų;9601932777;Ne;15;2;4;21
11047;Šnekutis;Pėlėdžiukų;4302555600;Ne;15;2;4;21
11048;Šnekutis;Pėlėdžiukų;7507857415;Ne;0;1;4;5
11049;Šnekutis;Pėlėdžiukų;7514753023;Ne;0;0;22;22
11050;Šnekutis;Pėlėdžiukų;54532738133;Taip;0;1;1;2
11051;Šnekutis;Boružėlių;4835202527;Ne;0;2;0;2
11052;Šnekutis;Boružėlių;9326455786;Ne;0;2;0;2
11053;Šnekutis;Boružėlių;9054899440;Ne;0;15;0;15
11054;Šnekutis;Boružėlių;9862362744;Ne;0;10;0;10
11055;Šnekutis;Boružėlių;7089000987;Taip;0;0;1;1
11056;Šnekutis;Boružėlių;2843483435;Ne;10;0;0;10
11057;Šnekutis;Boružėlių;6405894763;Ne;0;7;0;7
11058;Šnekutis;Boružėlių;3889176018;Ne;7;0;3;10
11059;Šnekutis;Boružėlių;6749848086;Ne;0;0;8;8
11060;Šnekutis;Boružėlių;6544973632;Ne;0;15;0;15
11061;Šnekutis;Boružėlių;6146988521;Taip;0;2;0;2
11062;Šnekutis;Boružėlių;5519015388;Ne;0;7;0;7
11063;Šnekutis;Boružėlių;3628210526;Ne;0;0;3;3
11064;Šnekutis;Boružėlių;7344776758;Ne;0;0;1;1
11065;Šnekutis;Boružėlių;5970951526;Ne;0;3;0;3
11066;Šnekutis;Boružėlių;3344425033;Ne;0;1;8;9
11067;Šnekutis;Boružėlių;3937465849;Ne;0;11;0;11
11068;Šnekutis;Boružėlių;8219465079;Ne;3;10;0;13
11069;Šnekutis;Boružėlių;6015384795;Ne;5;0;0;5
11070;Šnekutis;Boružėlių;7307895397;Ne;2;0;1;3
11071;Šnekutis;Boružėlių;3371393656;Ne;16;0;1;17
11072;Šnekutis;Boružėlių;2779793970;Ne;2;2;0;4
11073;Šnekutis;Meškučių;2852111627;Ne;1;0;0;1
11074;Šnekutis;Meškučių;6306269165;Ne;0;2;0;2
11075;Šnekutis;Meškučių;2626247219;Ne;5;1;0;6
11076;Šnekutis;Meškučių;7707897830;Ne;0;3;0;3
11077;Šnekutis;Meškučių;2042842873;Ne;0;12;0;12
11078;Šnekutis;Meškučių;2140099519;Ne;4;0;0;4
11079;Šnekutis;Meškučių;9709701441;Ne;3;2;0;5
11080;Šnekutis;Meškučių;2761479685;Ne;2;10;0;12
11081;Šnekutis;Meškučių;1219175855;Ne;3;0;0;3
11082;Šnekutis;Meškučių;9574210410;Ne;7;0;0;7
11083;Šnekutis;Meškučių;7980166125;Ne;9;1;0;10
11084;Šnekutis;Meškučių;3572114463;Ne;12;0;0;12
11085;Šnekutis;Meškučių;8417485561;Ne;10;5;0;15
11086;Šnekutis;Meškučių;2312968654;Ne;8;0;0;8
11087;Šnekutis;Viščiukų;9790241725;Ne;0;2;7;9
11088;Šnekutis;Viščiukų;9322106995;Ne;8;0;0;8
11089;Šnekutis;Viščiukų;3842436406;Ne;12;2;0;14
11090;Šnekutis;Viščiukų;3115675798;Ne;11;0;0;11
11091;Šnekutis;Viščiukų;9385583890;Ne;0;13;9;22
11092;Šnekutis;Viščiukų;5934631354;Ne;0;10;2;12
11093;Šnekutis;Viščiukų;4848437026;Ne;0;1;7;8
11094;Šnekutis;Viščiukų;9772257715;Taip;4;1;0;5
11095;Šnekutis;Viščiukų;3593766968;Ne;7;0;11;18
11096;Šnekutis;Viščiukų;1833392181;Ne;10;0;2;12
11097;Šnekutis;Viščiukų;1805259980;Ne;14;0;0;14
11098;Šnekutis;Viščiukų;3588737003;Ne;12;4;0;16
11099;Šnekutis;Viščiukų;7200356364;Ne;0;8;0;8
11100;Šnekutis;Viščiukų;1248466603;Ne;17;0;0;17
11101;Šnekutis;Viščiukų;7006343288;Ne;22;0;0;22
11102;Šnekutis;Viščiukų;5919317274;Ne;0;0;1;1
11103;Šnekutis;VIŠČIUKŲ;7914683654;Ne;8;0;0;8
11104;Užupiukas;VYTURĖLIŲ;5116564840;Ne;0;0;5;5
11105;Užupiukas;VYTURĖLIŲ;7443013255;Ne;0;2;1;3
11106;Užupiukas;VYTURĖLIŲ;3656400244;Ne;0;12;0;12
11107;Užupiukas;VYTURĖLIŲ;3829013911;Ne;10;0;0;10
11108;Užupiukas;VYTURĖLIŲ;8001099421;Ne;3;0;1;4
11109;Užupiukas;VYTURĖLIŲ;4401569800;Ne;0;0;4;4
11110;Užupiukas;VYTURĖLIŲ;1391826582;Ne;3;0;6;9
11111;Užupiukas;VYTURĖLIŲ;9132605734;Ne;10;0;1;11
11112;Užupiukas;VYTURĖLIŲ;8245876832;Ne;0;1;0;1
11113;Užupiukas;VYTURĖLIŲ;7532497390;Ne;2;5;2;9
11114;Užupiukas;VYTURĖLIŲ;5168946019;Ne;0;0;1;1
11115;Užupiukas;VYTURĖLIŲ;5718382826;Ne;5;4;5;14
11116;Užupiukas;VYTURĖLIŲ;9209209113;Ne;0;0;3;3
11117;Užupiukas;VYTURĖLIŲ;1146968021;Ne;0;1;0;1
11118;Užupiukas;VYTURĖLIŲ;1791922219;Ne;8;0;0;8
11119;Užupiukas;VYTURĖLIŲ;8347350503;Ne;0;0;6;6
11120;Užupiukas;VYTURĖLIŲ;2580733127;Ne;2;1;0;3
11121;Užupiukas;KAČIUKŲ;3048959458;Ne;0;0;3;3
11122;Užupiukas;KAČIUKŲ;1809036046;Ne;15;0;1;16
11123;Užupiukas;KAČIUKŲ;1102468034;Ne;0;0;4;4
11124;Užupiukas;KAČIUKŲ;1464016943;Ne;5;0;0;5
11125;Užupiukas;KAČIUKŲ;1102293237;Ne;0;0;1;1
11126;Užupiukas;KAČIUKŲ;9386211193;Ne;0;11;3;14
11127;Užupiukas;KAČIUKŲ;7048114101;Ne;0;0;11;11
11128;Užupiukas;KAČIUKŲ;1388346927;Ne;0;6;0;6
11129;Užupiukas;KAČIUKŲ;2606742144;Ne;0;0;1;1
11130;Užupiukas;KAČIUKŲ;5233447872;Ne;0;0;22;22
11131;Užupiukas;KAČIUKŲ;9719845726;Ne;8;0;1;9
11132;Užupiukas;KAČIUKŲ;3543913063;Ne;0;7;2;9
11133;Užupiukas;KAČIUKŲ;4920190785;Ne;0;0;22;22
11134;Užupiukas;DRUGELIŲ;8876174256;Ne;4;0;7;11
11135;Užupiukas;DRUGELIŲ;5239006321;Ne;0;2;3;5
11136;Užupiukas;DRUGELIŲ;7581152903;Ne;0;2;4;6
11137;Užupiukas;DRUGELIŲ;5361599156;Ne;3;0;0;3
11138;Užupiukas;DRUGELIŲ;4680027403;Ne;0;0;1;1
11139;Užupiukas;DRUGELIŲ;6698907535;Ne;0;1;4;5
11140;Užupiukas;DRUGELIŲ;9577167600;Ne;1;0;1;2
11141;Užupiukas;DRUGELIŲ;3419182422;Ne;0;0;1;1
11142;Užupiukas;DRUGELIŲ;4854016957;Ne;6;1;0;7
11143;Užupiukas;DRUGELIŲ;8692826414;Ne;4;0;0;4
11144;Užupiukas;DRUGELIŲ;7169272175;Ne;0;1;3;4
11145;Užupiukas;DRUGELIŲ;1156471313;Ne;0;0;1;1
11146;Užupiukas;DRUGELIŲ;4595291532;Ne;0;0;6;6
11147;Užupiukas;DRUGELIŲ;3383643388;Ne;0;0;5;5
11148;Užupiukas;DRUGELIŲ;3961733676;Ne;0;1;15;16
11149;Užupiukas;DRUGELIŲ;5006880916;Ne;8;1;0;9
11150;Užupiukas;DRUGELIŲ;4075611307;Ne;5;2;2;9
11151;Užupiukas;DRUGELIŲ;9715624372;Ne;0;1;9;10
11152;Užupiukas;DRUGELIŲ;1108429907;Ne;6;1;8;15
11153;Užupiukas;DRUGELIŲ;9295230331;Ne;0;0;9;9
11154;Užupiukas;DRUGELIŲ;3940029893;Ne;0;0;7;7
11155;Užupiukas;EŽIUKŲ;1526296386;Ne;8;0;0;8
11156;Užupiukas;EŽIUKŲ;9774124589;Ne;0;0;2;2
11157;Užupiukas;EŽIUKŲ;2724216446;Ne;0;12;0;12
11158;Užupiukas;EŽIUKŲ;1100574872;Ne;10;0;0;10
11159;Užupiukas;EŽIUKŲ;5204808398;Ne;0;0;3;3
11160;Užupiukas;EŽIUKŲ;3171528288;Ne;0;0;8;8
11161;Užupiukas;EŽIUKŲ;3611922301;Ne;0;13;2;15
11162;Užupiukas;EŽIUKŲ;8020138690;Ne;0;0;2;2
11163;Užupiukas;EŽIUKŲ;6823724962;Ne;9;0;9;18
11164;Užupiukas;EŽIUKŲ;5538327364;Ne;4;0;0;4
11165;Užupiukas;EŽIUKŲ;3057147440;Ne;5;0;1;6
11166;Užupiukas;EŽIUKŲ;6370918943;Ne;0;0;1;1
11167;Užupiukas;EŽIUKŲ;9357101972;Ne;0;0;3;3
11168;Užupiukas;EŽIUKŲ;9906475253;Ne;0;0;7;7
11169;Užupiukas;BORUŽĖLIŲ;4781598862;Ne;0;4;3;7
11170;Užupiukas;BORUŽĖLIŲ;7861121290;Ne;0;0;2;2
11171;Užupiukas;BORUŽĖLIŲ;12787288319;Ne;0;5;0;5
11172;Užupiukas;BORUŽĖLIŲ;6526550727;Ne;2;0;0;2
11173;Užupiukas;BORUŽĖLIŲ;1582921323;Ne;0;0;12;12
11174;Užupiukas;BORUŽĖLIŲ;1503714343;Ne;0;0;1;1
11175;Užupiukas;BORUŽĖLIŲ;8313812681;Ne;0;0;3;3
11176;Užupiukas;BORUŽĖLIŲ;9677572224;Ne;7;0;0;7
11177;Užupiukas;BORUŽĖLIŲ;2445335267;Ne;0;0;1;1
11178;Užupiukas;BORUŽĖLIŲ;1514268763;Ne;1;0;0;1
11179;Užupiukas;BORUŽĖLIŲ;2307600884;Ne;0;0;1;1
11180;Užupiukas;BORUŽĖLIŲ;6073039842;Ne;2;3;0;5
11181;Užupiukas;BORUŽĖLIŲ;6601099182;Ne;11;5;0;16
11182;Užupiukas;BORUŽĖLIŲ;3940264504;Ne;0;0;1;1
11183;Užupiukas;BORUŽĖLIŲ;2704243085;Ne;0;2;1;3
11184;Užupiukas;BORUŽĖLIŲ;5517458323;Ne;0;4;0;4
11185;Užupiukas;BORUŽĖLIŲ;7427702848;Ne;0;4;0;4
11186;Užupiukas;SPINDULIUKŲ;1718518621;Ne;0;0;4;4
11187;Užupiukas;SPINDULIUKŲ;7140606152;Ne;0;0;1;1
11188;Užupiukas;SPINDULIUKŲ;1679324943;Ne;0;8;2;10
11189;Užupiukas;SPINDULIUKŲ;7298322865;Ne;3;0;0;3
11190;Užupiukas;SPINDULIUKŲ;8734960045;Ne;0;0;2;2
11191;Užupiukas;SPINDULIUKŲ;9863097416;Ne;0;0;3;3
11192;Užupiukas;SPINDULIUKŲ;3298267311;Ne;0;1;0;1
11193;Užupiukas;SPINDULIUKŲ;9617597828;Ne;0;0;2;2
11194;Užupiukas;SPINDULIUKŲ;8915159672;Taip;0;11;0;11
11195;Užupiukas;SPINDULIUKŲ;1554333137;Ne;0;5;17;22
11196;Užupiukas;SPINDULIUKŲ;9723966502;Ne;0;0;6;6
11197;Užupiukas;SPINDULIUKŲ;9655636851;Ne;0;0;3;3
11198;Užupiukas;SPINDULIUKŲ;8724566014;Ne;0;0;15;15
11199;Užupiukas;SPINDULIUKŲ;8870229834;Ne;5;0;2;7
11200;Užupiukas;SPINDULIUKŲ;9096157655;Ne;0;3;1;4
11201;Užupiukas;SPINDULIUKŲ;9782972949;Ne;0;0;1;1
11202;Užupiukas;SPINDULIUKŲ;3958071677;Ne;0;0;9;9
11203;Užupiukas;SPINDULIUKŲ;3231001225;Ne;0;0;4;4
11204;Užupiukas;SPINDULIUKŲ;5406866873;Ne;0;0;4;4
11205;Užupiukas;ŽVIRBLIUKŲ;8519118225;Ne;0;0;1;1
11206;Užupiukas;ŽVIRBLIUKŲ;7549628277;Ne;0;0;1;1
11207;Užupiukas;ŽVIRBLIUKŲ;5085660507;Ne;5;0;0;5
11208;Užupiukas;ŽVIRBLIUKŲ;2273766308;Ne;0;1;0;1
11209;Užupiukas;ŽVIRBLIUKŲ;7530856195;Ne;0;5;2;7
11210;Užupiukas;ŽVIRBLIUKŲ;9925592494;Ne;5;0;0;5
11211;Užupiukas;ŽVIRBLIUKŲ;7345579721;Ne;0;1;0;1
11212;Užupiukas;ŽVIRBLIUKŲ;4710910251;Ne;0;0;5;5
11213;Užupiukas;ŽVIRBLIUKŲ;9428884149;Ne;0;0;5;5
11214;Užupiukas;ŽVIRBLIUKŲ;4054724625;Ne;2;6;0;8
11215;Užupiukas;ŽVIRBLIUKŲ;1995228207;Ne;0;0;3;3
11216;Užupiukas;ŽVIRBLIUKŲ;1496541880;Ne;0;10;3;13
11217;Užupiukas;ŽVIRBLIUKŲ;1684901495;Ne;0;1;0;1
11218;Užupiukas;ŽVIRBLIUKŲ;2390955083;Ne;0;5;0;5
11219;Užupiukas;ŽVIRBLIUKŲ;6001766518;Ne;7;2;0;9
11220;Užupiukas;ŽVIRBLIUKŲ;3768945773;Ne;0;1;0;1
11221;Užupiukas;ŽVIRBLIUKŲ;1843171673;Ne;6;0;0;6
11222;Užupiukas;ŽVIRBLIUKŲ;6308141378;Ne;0;1;2;3
11223;Užupiukas;ŽVIRBLIUKŲ;4785494419;Ne;0;6;0;6
11224;Užupiukas;ŽVIRBLIUKŲ;8119142600;Ne;1;0;7;8
11225;Užupiukas;ŽVIRBLIUKŲ;2362568676;Ne;0;2;0;2
11226;Užupiukas;PELĖDŽIUKŲ;2938276316;Ne;0;0;2;2
11227;Užupiukas;PELĖDŽIUKŲ;5665323444;Ne;0;0;5;5
11228;Užupiukas;PELĖDŽIUKŲ;4880828482;Ne;0;0;11;11
11229;Užupiukas;PELĖDŽIUKŲ;6478702476;Ne;0;0;12;12
11230;Užupiukas;PELĖDŽIUKŲ;6110869303;Ne;0;0;10;10
11231;Užupiukas;PELĖDŽIUKŲ;3205769002;Ne;0;6;0;6
11232;Užupiukas;PELĖDŽIUKŲ;4608233152;Ne;0;0;3;3
11233;Užupiukas;PELĖDŽIUKŲ;5498369850;Ne;0;0;7;7
11234;Užupiukas;PELĖDŽIUKŲ;2821350355;Ne;0;0;3;3
11235;Užupiukas;PELĖDŽIUKŲ;3309195572;Ne;0;0;4;4
11236;Užupiukas;PELĖDŽIUKŲ;4132760111;Ne;0;1;0;1
11237;Užupiukas;PELĖDŽIUKŲ;22401995674;Ne;0;0;1;1
11238;Užupiukas;PELĖDŽIUKŲ;53412835151;Ne;0;5;2;7
11239;Užupiukas;PELĖDŽIUKŲ;6236652118;Ne;0;0;2;2
11240;Užupiukas;PELĖDŽIUKŲ;3774364829;Ne;0;0;2;2
11241;Užupiukas;PELĖDŽIUKŲ;9197242545;Ne;0;0;2;2
11242;Užupiukas;PELĖDŽIUKŲ;5046355276;Ne;0;5;0;5
11243;Užupiukas;PELĖDŽIUKŲ;1091861376;Ne;0;0;12;12
11244;Užupiukas;VARPELIŲ;7107441792;Ne;5;0;2;7
11245;Užupiukas;VARPELIŲ;8881187663;Ne;0;5;1;6
11246;Užupiukas;VARPELIŲ;7895825571;Ne;0;5;1;6
11247;Užupiukas;VARPELIŲ;8518137669;Ne;2;0;0;2
11248;Užupiukas;VARPELIŲ;7919242126;Ne;0;2;1;3
11249;Užupiukas;VARPELIŲ;9310238442;Ne;0;0;1;1
11250;Užupiukas;VARPELIŲ;2769924857;Ne;5;0;2;7
11251;Užupiukas;VARPELIŲ;5941280824;Ne;0;0;6;6
11252;Užupiukas;VARPELIŲ;7105857162;Ne;0;0;6;6
11253;Užupiukas;VARPELIŲ;2485426055;Ne;5;0;1;6
11254;Užupiukas;VARPELIŲ;7314085267;Ne;0;0;4;4
11255;Užupiukas;VARPELIŲ;2752139377;Ne;10;0;0;10
11256;Užupiukas;VARPELIŲ;4811619739;Ne;0;5;0;5
11257;Užupiukas;VARPELIŲ;7837545732;Ne;0;0;1;1
11258;Užupiukas;VARPELIŲ;9523512906;Ne;6;0;0;6
11259;Užupiukas;VARPELIŲ;3745080560;Ne;0;0;2;2
11260;Užupiukas;VARPELIŲ;5148672602;Ne;0;0;3;3
11261;Užupiukas;SAULUČIŲ;5704945892;Ne;0;0;12;12
11262;Užupiukas;SAULUČIŲ;2681679016;Ne;0;2;0;2
11263;Užupiukas;SAULUČIŲ;3684774901;Ne;0;1;0;1
11264;Užupiukas;SAULUČIŲ;8163092636;Ne;0;0;2;2
11265;Užupiukas;SAULUČIŲ;1976775494;Ne;0;8;0;8
11266;Užupiukas;SAULUČIŲ;5874450724;Ne;0;0;6;6
11267;Užupiukas;SAULUČIŲ;3341292382;Ne;0;12;8;20
11268;Užupiukas;SAULUČIŲ;2211595125;Ne;0;0;5;5
11269;Užupiukas;SAULUČIŲ;5570569874;Ne;9;0;1;10
11270;Užupiukas;SAULUČIŲ;7643286183;Ne;0;0;2;2
11271;Užupiukas;SAULUČIŲ;2814556305;Ne;0;4;3;7
11272;Užupiukas;SAULUČIŲ;9953994943;Ne;0;6;0;6
11273;Užupiukas;SAULUČIŲ;7956550754;Ne;0;0;2;2
11274;Užupiukas;SAULUČIŲ;5469735455;Ne;5;1;3;9
11275;Užupiukas;SAULUČIŲ;8489545569;Ne;0;1;2;3
11276;Užupiukas;SAULUČIŲ;4691413468;Ne;0;0;2;2
11277;Užupiukas;SAULUČIŲ;7423292334;Ne;11;2;0;13
11278;Užupiukas;SAULUČIŲ;9216626936;Ne;0;0;1;1
11279;Užupiukas;SAULUČIŲ;9962455415;Ne;0;0;1;1
11280;Užupiukas;LAPIUKŲ;9833934299;Ne;2;3;0;5
11281;Užupiukas;LAPIUKŲ;2679915982;Ne;0;10;0;10
11282;Užupiukas;LAPIUKŲ;6004467875;Ne;0;1;0;1
11283;Užupiukas;LAPIUKŲ;1718048938;Ne;0;2;0;2
11284;Užupiukas;LAPIUKŲ;7986962850;Ne;0;4;0;4
11285;Užupiukas;LAPIUKŲ;2517606394;Ne;0;8;3;11
11286;Užupiukas;LAPIUKŲ;5965564175;Ne;0;1;3;4
11287;Užupiukas;LAPIUKŲ;5680350014;Ne;0;1;0;1
11288;Užupiukas;LAPIUKŲ;7559183263;Ne;0;1;0;1
11289;Užupiukas;LAPIUKŲ;1886792898;Ne;5;0;0;5
11290;Užupiukas;LAPIUKŲ;6967184410;Ne;0;1;2;3
11291;Užupiukas;LAPIUKŲ;4900699267;Ne;0;3;2;5
11292;Užupiukas;LAPIUKŲ;1178152392;Ne;0;7;1;8
11293;Užupiukas;LAPIUKŲ;7029091978;Ne;0;1;0;1
11294;Užupiukas;LAPIUKŲ;8252575784;Ne;0;1;1;2
11295;Užupiukas;LAPIUKŲ;3333547785;Ne;8;5;1;14
11296;Užupiukas;LAPIUKŲ;8529259340;Ne;0;1;11;12
11297;Užupiukas;NYKŠTUKŲ;4895744524;Ne;19;0;0;19
11298;Užupiukas;NYKŠTUKŲ;3811750547;Ne;0;0;2;2
11299;Užupiukas;NYKŠTUKŲ;2158976125;Ne;0;0;2;2
11300;Užupiukas;NYKŠTUKŲ;6857321547;Ne;9;0;13;22
11301;Užupiukas;NYKŠTUKŲ;5381329362;Ne;0;0;2;2
11302;Užupiukas;NYKŠTUKŲ;4841475687;Ne;0;0;3;3
11303;Užupiukas;NYKŠTUKŲ;1399112659;Ne;7;0;15;22
11304;Užupiukas;NYKŠTUKŲ;4379182756;Ne;0;0;14;14
11305;Užupiukas;NYKŠTUKŲ;9785674147;Ne;0;0;14;14
11306;Užupiukas;NYKŠTUKŲ;3094320206;Ne;0;0;14;14
11307;Užupiukas;NYKŠTUKŲ;9714322911;Ne;0;0;4;4
11308;Užupiukas;NYKŠTUKŲ;7589905741;Ne;15;0;4;19
11309;Užupiukas;NYKŠTUKŲ;1891855020;Ne;0;0;1;1
11310;Užupiukas;NYKŠTUKŲ;1473606331;Ne;0;0;5;5
11311;Užupiukas;NYKŠTUKŲ;4570457987;Ne;0;12;7;19
11312;Užupiukas;NYKŠTUKŲ;9312234251;Ne;0;0;2;2
11313;Vaidilutė;Žiogelis;7779630805;Ne;7;2;2;11
11314;Vaidilutė;Žiogelis;9876388990;Ne;0;6;1;7
11315;Vaidilutė;Žiogelis;45949026707;Ne;0;0;4;4
11316;Vaidilutė;Žiogelis;1853463568;Ne;5;0;2;7
11317;Vaidilutė;Žiogelis;5620009051;Ne;0;0;2;2
11318;Vaidilutė;Žiogelis;5203062837;Ne;0;0;1;1
11319;Vaidilutė;Žiogelis;3112025222;Ne;3;0;0;3
11320;Vaidilutė;Žiogelis;4334934114;Ne;5;0;1;6
11321;Vaidilutė;Žiogelis;7843388119;Ne;0;1;0;1
11322;Vaidilutė;Žiogelis;2041126370;Ne;0;0;1;1
11323;Vaidilutė;Žiogelis;3152118407;Ne;0;0;1;1
11324;Vaidilutė;Žiogelis;5991149222;Ne;0;5;2;7
11325;Vaidilutė;Žiogelis;1786022030;Ne;0;0;2;2
11326;Vaidilutė;Žiogelis;1266927367;Ne;0;0;5;5
11327;Vaidilutė;Žiogelis;1430802591;Ne;0;0;1;1
11328;Vaidilutė;Žiogelis;9556632708;Ne;0;0;4;4
11329;Vaidilutė;Žiogelis;1769926207;Ne;0;5;0;5
11330;Vaidilutė;Rūtelė;2131127298;Ne;0;0;1;1
11331;Vaidilutė;Rūtelė;7319037375;Ne;0;0;11;11
11332;Vaidilutė;Rūtelė;4838951446;Ne;0;1;0;1
11333;Vaidilutė;Rūtelė;7494818866;Ne;0;0;3;3
11334;Vaidilutė;Rūtelė;5500950179;Ne;0;6;1;7
11335;Vaidilutė;Rūtelė;9563257771;Ne;0;2;0;2
11336;Vaidilutė;Rūtelė;2024078532;Ne;0;0;1;1
11337;Vaidilutė;Rūtelė;5482030284;Ne;0;0;3;3
11338;Vaidilutė;Rūtelė;8505156287;Ne;8;0;0;8
11339;Vaidilutė;Rūtelė;7532115462;Ne;8;0;1;9
11340;Vaidilutė;Rūtelė;6896047075;Ne;0;4;1;5
11341;Vaidilutė;Rūtelė;3059654988;Ne;0;12;3;15
11342;Vaidilutė;Rūtelė;1141947715;Ne;7;0;4;11
11343;Vaidilutė;Rūtelė;9437865610;Ne;0;0;2;2
11344;Vaidilutė;Rūtelė;2014160468;Ne;0;8;0;8
11345;Vaidilutė;Voveraitė;1608646909;Ne;12;0;1;13
11346;Vaidilutė;Voveraitė;9429544108;Ne;0;10;6;16
11347;Vaidilutė;Voveraitė;5652381296;Taip;7;0;0;7
11348;Vaidilutė;Voveraitė;8377824920;Ne;0;11;0;11
11349;Vaidilutė;Voveraitė;3299081380;Ne;1;0;4;5
11350;Vaidilutė;Voveraitė;3634285869;Ne;2;0;10;12
11351;Vaidilutė;Voveraitė;7703578508;Ne;0;0;10;10
11352;Vaidilutė;Voveraitė;3150642420;Ne;7;0;0;7
11353;Vaidilutė;Voveraitė;5855762068;Ne;0;10;1;11
11354;Vaidilutė;Voveraitė;7327131165;Ne;0;2;4;6
11355;Vaidilutė;Voveraitė;2318578603;Ne;0;0;9;9
11356;Vaidilutė;Voveraitė;9372280434;Ne;10;0;0;10
11357;Vaidilutė;Voveraitė;1372767364;Ne;7;0;2;9
11358;Vaidilutė;Voveraitė;7478943531;Ne;5;0;1;6
11359;Vaidilutė;Voveraitė;4738318120;Ne;0;14;0;14
11360;Vaidilutė;Voveraitė;3319615121;Ne;7;0;0;7
11361;Vaidilutė;Voveraitė;6299324271;Ne;6;3;1;10
11362;Vaidilutė;Voveraitė;4186708502;Ne;6;0;2;8
11363;Vaidilutė;Voveraitė;2855672500;Ne;0;4;0;4
11364;Vaidilutė;Voveraitė;8053548602;Ne;0;0;3;3
11365;Vaidilutė;Saulutė;8492055287;Ne;0;0;1;1
11366;Vaidilutė;Saulutė;6844372910;Ne;11;3;3;17
11367;Vaidilutė;Saulutė;4972645715;Ne;0;0;1;1
11368;Vaidilutė;Saulutė;4680645841;Ne;0;0;3;3
11369;Vaidilutė;Saulutė;2662468804;Ne;0;0;5;5
11370;Vaidilutė;Saulutė;5217609332;Ne;0;0;3;3
11371;Vaidilutė;Saulutė;2864731541;Ne;12;0;2;14
11372;Vaidilutė;Saulutė;1998872078;Ne;0;0;5;5
11373;Vaidilutė;Saulutė;2468220275;Ne;0;0;2;2
11374;Vaidilutė;Saulutė;1610262589;Ne;12;0;0;12
11375;Vaidilutė;Saulutė;2356037175;Ne;0;1;0;1
11376;Vaidilutė;Saulutė;5054640268;Ne;4;0;4;8
11377;Vaidilutė;Saulutė;7826111890;Ne;2;0;6;8
11378;Vaidilutė;Saulutė;9870763434;Ne;0;0;2;2
11379;Vaidilutė;Saulutė;5945744595;Taip;5;0;2;7
11380;Vaidilutė;Saulutė;6674238265;Ne;0;0;5;5
11381;Vaidilutė;Saulutė;1092821241;Ne;3;0;0;3
11382;Vaidilutė;Saulutė;2294802783;Ne;0;5;0;5
11383;Vaidilutė;Žibutė;5668493994;Ne;4;0;1;5
11384;Vaidilutė;Žibutė;4085959509;Ne;0;0;2;2
11385;Vaidilutė;Žibutė;1001320466;Ne;6;0;2;8
11386;Vaidilutė;Žibutė;3051006765;Ne;0;0;2;2
11387;Vaidilutė;Žibutė;9189713003;Ne;9;1;0;10
11388;Vaidilutė;Žibutė;7903242996;Ne;0;0;15;15
11389;Vaidilutė;Žibutė;7400197367;Ne;3;1;0;4
11390;Vaidilutė;Žibutė;3980894528;Ne;7;0;2;9
11391;Vaidilutė;Žibutė;1362256314;Ne;0;17;0;17
11392;Vaidilutė;Žibutė;7940581813;Ne;2;0;1;3
11393;Vaidilutė;Žibutė;2767482145;Ne;6;0;1;7
11394;Vaidilutė;Žibutė;7765298370;Ne;0;5;3;8
11395;Vaidilutė;Žibutė;1726638921;Ne;0;12;3;15
11396;Vaidilutė;Žibutė;5415279154;Ne;0;2;3;5
11397;Vaidilutė;Žibutė;4124217264;Ne;0;0;6;6
11398;Vaidilutė;Žibutė;7429825620;Ne;4;0;0;4
11399;Vaidilutė;Žibutė;7690470762;Ne;4;1;0;5
11400;Vaidilutė;"Ąžuoliukas ";3463112472;Ne;2;0;0;2
11401;Vaidilutė;"Ąžuoliukas ";3730573432;Ne;5;7;0;12
11402;Vaidilutė;"Ąžuoliukas ";6586072228;Ne;0;1;0;1
11403;Vaidilutė;"Ąžuoliukas ";5988376676;Ne;5;0;2;7
11404;Vaidilutė;"Ąžuoliukas ";1305478052;Ne;0;0;1;1
11405;Vaidilutė;"Ąžuoliukas ";4954285515;Ne;0;1;0;1
11406;Vaidilutė;"Ąžuoliukas ";5439973183;Ne;7;0;0;7
11407;Vaidilutė;"Ąžuoliukas ";3381544575;Ne;7;0;0;7
11408;Vaidilutė;"Ąžuoliukas ";5307486959;Ne;0;2;0;2
11409;Vaidilutė;"Ąžuoliukas ";1653497170;Ne;0;2;0;2
11410;Vaidilutė;"Ąžuoliukas ";1440819171;Ne;7;0;0;7
11411;Vaidilutė;"Ąžuoliukas ";2668758195;Ne;2;0;6;8
11412;Vaidilutė;"Ąžuoliukas ";4901387311;Ne;6;2;0;8
11413;Vaidilutė;"Ąžuoliukas ";2997948252;Ne;6;1;0;7
11414;Vaidilutė;"Ąžuoliukas ";9723156071;Ne;0;0;8;8
11415;Vaidilutė;"Ąžuoliukas ";4193108560;Ne;0;0;6;6
11416;Vaidilutė;"Ąžuoliukas ";3782651091;Ne;0;0;5;5
11417;Vaidilutė;"Ąžuoliukas ";6637224510;Ne;0;0;7;7
11418;Vaidilutė;"Ąžuoliukas ";6067801976;Ne;9;0;2;11
11419;Vaidilutė;"Žemuogėlė ";42503303158;Ne;0;0;2;2
11420;Vaidilutė;"Žemuogėlė ";9869134464;Ne;0;5;0;5
11421;Vaidilutė;"Žemuogėlė ";29153363263;Ne;13;0;0;13
11422;Vaidilutė;"Žemuogėlė ";3069613102;Ne;0;0;1;1
11423;Vaidilutė;"Žemuogėlė ";1297817018;Ne;0;0;1;1
11424;Vaidilutė;"Žemuogėlė ";5177060346;Ne;0;0;4;4
11425;Vaidilutė;"Žemuogėlė ";4671287016;Ne;0;0;2;2
11426;Vaidilutė;"Žemuogėlė ";9124975928;Ne;0;2;0;2
11427;Vaidilutė;"Žemuogėlė ";1363913645;Ne;4;2;0;6
11428;Vaidilutė;"Žemuogėlė ";5252637701;Ne;0;0;2;2
11429;Vaidilutė;"Žemuogėlė ";3202508790;Ne;0;0;6;6
11430;Vaidilutė;"Žemuogėlė ";1320999237;Ne;0;2;0;2
11431;Vaidilutė;"Žemuogėlė ";1691407801;Ne;0;0;4;4
11432;Vaidilutė;"Žemuogėlė ";1704155743;Ne;0;1;0;1
11433;Vaidilutė;"Žemuogėlė ";1139332221;Ne;0;0;3;3
11434;Vaidilutė;"Žemuogėlė ";5276088687;Ne;5;5;0;10
11435;Vaidilutė;"Žemuogėlė ";1477508451;Ne;0;0;1;1
11436;Vaidilutė;"Vyturėlis ";3121914268;Ne;3;0;2;5
11437;Vaidilutė;"Vyturėlis ";5050251048;Ne;6;1;0;7
11438;Vaidilutė;"Vyturėlis ";9558983004;Ne;9;4;1;14
11439;Vaidilutė;"Vyturėlis ";5326935037;Ne;0;0;4;4
11440;Vaidilutė;"Vyturėlis ";2189753894;Ne;0;3;0;3
11441;Vaidilutė;"Vyturėlis ";9689388330;Ne;0;5;0;5
11442;Vaidilutė;"Vyturėlis ";9584702487;Ne;0;4;0;4
11443;Vaidilutė;"Vyturėlis ";2081959307;Ne;0;7;0;7
11444;Vaidilutė;"Vyturėlis ";8882402632;Ne;0;0;4;4
11445;Vaidilutė;"Vyturėlis ";1539700521;Ne;0;0;2;2
11446;Vaidilutė;"Vyturėlis ";8628545847;Ne;0;1;0;1
11447;Vaidilutė;"Vyturėlis ";2058071219;Ne;5;0;0;5
11448;Vaidilutė;"Vyturėlis ";1401180999;Ne;5;2;0;7
11449;Vaidilutė;"Vyturėlis ";1417828163;Ne;0;7;0;7
11450;Vaidilutė;"Vyturėlis ";7914006128;Ne;7;0;0;7
11451;Vaidilutė;"Vyturėlis ";7131561558;Ne;0;6;1;7
11452;Vaidilutė;"Vyturėlis ";2194984060;Ne;0;0;1;1
11453;Vaidilutė;"Vyturėlis ";3351968717;Ne;0;16;0;16
11454;Vaidilutė;"Varpelis ";6250831269;Ne;10;0;0;10
11455;Vaidilutė;"Varpelis ";6037349527;Ne;5;0;0;5
11456;Vaidilutė;"Varpelis ";5867501558;Ne;2;0;5;7
11457;Vaidilutė;"Varpelis ";9317774960;Ne;0;0;2;2
11458;Vaidilutė;"Varpelis ";4280822951;Ne;0;13;0;13
11459;Vaidilutė;"Varpelis ";6107554047;Ne;5;0;0;5
11460;Vaidilutė;"Varpelis ";6022130248;Ne;0;1;0;1
11461;Vaidilutė;"Varpelis ";5101104226;Ne;0;0;2;2
11462;Vaidilutė;"Varpelis ";5594121340;Ne;0;0;1;1
11463;Vaidilutė;"Varpelis ";1882829340;Ne;0;2;2;4
11464;Vaidilutė;"Varpelis ";6097229427;Ne;0;0;3;3
11465;Vaidilutė;"Varpelis ";3353827105;Ne;7;0;3;10
11466;Vaidilutė;"Varpelis ";4362797606;Ne;0;2;0;2
11467;Vaidilutė;"Varpelis ";6322986820;Ne;0;0;3;3
11468;Vaidilutė;"Boružėlių ";6928815317;Ne;11;0;7;18
11469;Vaidilutė;"Boružėlių ";2164241264;Ne;6;0;1;7
11470;Vaidilutė;"Boružėlių ";4648985217;Ne;2;0;0;2
11471;Vaidilutė;"Boružėlių ";4348206726;Taip;13;0;3;16
11472;Vaidilutė;"Boružėlių ";5008411199;Taip;10;0;0;10
11473;Vaidilutė;"Boružėlių ";5405461987;Ne;6;0;1;7
11474;Vaidilutė;"Boružėlių ";1283676263;Ne;0;0;1;1
11475;Vaidilutė;"Boružėlių ";8629789128;Ne;7;0;1;8
11476;Vaidilutė;"Boružėlių ";8413764934;Ne;0;2;0;2
11477;Vaidilutė;"Boružėlių ";2315322608;Ne;5;0;1;6
11478;Vaidilutė;"Boružėlių ";7019245743;Ne;19;0;0;19
11479;Vaidilutė;"Boružėlių ";7075509397;Ne;9;0;0;9
11480;Vaidilutė;"Boružėlių ";8012451263;Ne;0;1;0;1
11481;Vaidilutė;"Boružėlių ";4760330697;Ne;5;0;1;6
11482;Vaidilutė;"Boružėlių ";5095161432;Ne;0;10;0;10
11483;Vaidilutė;"Malūnelis ";4887753072;Ne;0;4;0;4
11484;Vaidilutė;"Malūnelis ";7726116370;Ne;0;0;1;1
11485;Vaidilutė;"Malūnelis ";2876157676;Ne;2;0;0;2
11486;Vaidilutė;"Malūnelis ";3557654689;Ne;1;0;1;2
11487;Vaidilutė;"Malūnelis ";8444010416;Ne;11;3;1;15
11488;Vaidilutė;"Malūnelis ";1998966302;Ne;1;0;2;3
11489;Vaidilutė;"Malūnelis ";5026620305;Ne;0;0;3;3
11490;Vaidilutė;"Malūnelis ";3826303389;Ne;0;0;5;5
11491;Vaidilutė;"Malūnelis ";4469754560;Ne;0;0;2;2
11492;Vaidilutė;"Malūnelis ";8433116520;Ne;5;0;0;5
11493;Vaidilutė;"Malūnelis ";5918039529;Ne;4;0;4;8
11494;Vaidilutė;"Malūnelis ";3850868701;Ne;0;0;2;2
11495;Vaidilutė;"Malūnelis ";7660273021;Ne;4;0;0;4
11496;Vaidilutė;"Malūnelis ";6449710777;Ne;0;0;9;9
11497;Vaidilutė;"Malūnelis ";2444426554;Ne;0;0;9;9
11498;Vaidilutė;"Riešutėlis ";3605988018;Ne;2;6;0;8
11499;Vaidilutė;"Riešutėlis ";1161455376;Ne;13;0;1;14
11500;Vaidilutė;"Riešutėlis ";4518002596;Ne;0;0;1;1
11501;Vaidilutė;"Riešutėlis ";4657952465;Ne;10;0;4;14
11502;Vaidilutė;"Riešutėlis ";8756807918;Ne;0;0;6;6
11503;Vaidilutė;"Riešutėlis ";9782176726;Ne;0;7;1;8
11504;Vaidilutė;"Riešutėlis ";1206696843;Ne;0;0;5;5
11505;Vaidilutė;"Riešutėlis ";9872915544;Ne;0;4;0;4
11506;Vaidilutė;"Riešutėlis ";2976615414;Ne;10;0;3;13
11507;Vaidilutė;"Riešutėlis ";4709977896;Ne;5;0;1;6
11508;Vaidilutė;"Riešutėlis ";2409760986;Ne;5;0;1;6
11509;Vaidilutė;"Riešutėlis ";2564536281;Ne;5;0;0;5
11510;Vaidilutė;"Riešutėlis ";9025469107;Ne;0;0;4;4
11511;Vaidilutė;"Riešutėlis ";3862444839;Ne;2;0;0;2
11512;Vaidilutė;"Riešutėlis ";9567786222;Ne;2;0;1;3
11513;Vaidilutė;"Riešutėlis ";3321127541;Ne;0;0;2;2
11514;Vaidilutė;"Riešutėlis ";3064988592;Ne;0;0;3;3
11515;Vaidilutė;"Riešutėlis ";7043895152;Ne;2;0;0;2
11516;Vaidilutė;"Riešutėlis ";7871629009;Ne;0;0;11;11
11517;Vandenis;ŽUVĖDRŲ;5362078687;Ne;0;12;0;12
11518;Vandenis;ŽUVĖDRŲ;6784010746;Ne;7;1;2;10
11519;Vandenis;ŽUVĖDRŲ;2238926097;Ne;0;1;0;1
11520;Vandenis;ŽUVĖDRŲ;9334958945;Ne;2;2;0;4
11521;Vandenis;ŽUVĖDRŲ;7646133208;Ne;0;4;0;4
11522;Vandenis;ŽUVĖDRŲ;4303303483;Ne;0;1;0;1
11523;Vandenis;ŽUVĖDRŲ;2325465812;Ne;0;2;0;2
11524;Vandenis;ŽUVĖDRŲ;2649542586;Ne;0;11;0;11
11525;Vandenis;ŽUVĖDRŲ;1144490168;Ne;7;4;3;14
11526;Vandenis;ŽUVĖDRŲ;7948161881;Ne;6;0;0;6
11527;Vandenis;ŽUVĖDRŲ;9335319713;Ne;10;4;1;15
11528;Vandenis;ŽUVĖDRŲ;6068154206;Ne;0;8;0;8
11529;Vandenis;ŽUVĖDRŲ;7296608892;Ne;0;2;0;2
11530;Vandenis;ŽUVĖDRŲ;4117091634;Ne;5;1;0;6
11531;Vandenis;ŽUVĖDRŲ;6063181697;Ne;0;1;0;1
11532;Vandenis;ŽUVĖDRŲ;6661117114;Ne;4;2;0;6
11533;Vandenis;ŽUVĖDRŲ;5112768778;Ne;6;9;0;15
11534;Vandenis;RUONIUKŲ;2422642232;Ne;0;13;0;13
11535;Vandenis;RUONIUKŲ;1051281257;Ne;0;13;0;13
11536;Vandenis;RUONIUKŲ;1120907086;Ne;0;5;0;5
11537;Vandenis;RUONIUKŲ;1563710105;Ne;0;0;1;1
11538;Vandenis;RUONIUKŲ;7702272913;Ne;5;3;1;9
11539;Vandenis;RUONIUKŲ;6476051751;Ne;0;13;0;13
11540;Vandenis;RUONIUKŲ;9162936403;Ne;6;0;0;6
11541;Vandenis;RUONIUKŲ;9527253920;Ne;0;2;2;4
11542;Vandenis;RUONIUKŲ;8971291182;Ne;4;0;1;5
11543;Vandenis;RUONIUKŲ;6330187732;Ne;0;8;0;8
11544;Vandenis;RUONIUKŲ;9688954631;Ne;0;9;0;9
11545;Vandenis;RUONIUKŲ;8729351613;Ne;0;1;0;1
11546;Vandenis;RUONIUKŲ;4971165639;Ne;6;5;0;11
11547;Vandenis;RUONIUKŲ;6158299885;Ne;0;0;2;2
11548;Vandenis;RUONIUKŲ;3664560833;Ne;0;3;0;3
11549;Vandenis;RUONIUKŲ;5535901447;Ne;0;1;0;1
11550;Vandenis;ŽUVYČIŲ;55421695186;Ne;0;2;2;4
11551;Vandenis;ŽUVYČIŲ;9608871155;Ne;0;1;0;1
11552;Vandenis;ŽUVYČIŲ;8430706407;Ne;0;2;0;2
11553;Vandenis;ŽUVYČIŲ;4085256182;Ne;0;0;1;1
11554;Vandenis;ŽUVYČIŲ;6828175620;Ne;0;4;0;4
11555;Vandenis;ŽUVYČIŲ;1535450614;Ne;0;0;1;1
11556;Vandenis;ŽUVYČIŲ;7408758565;Ne;0;0;1;1
11557;Vandenis;ŽUVYČIŲ;1598122777;Ne;1;2;0;3
11558;Vandenis;ŽUVYČIŲ;1815765498;Ne;5;1;0;6
11559;Vandenis;ŽUVYČIŲ;5549292096;Ne;0;10;0;10
11560;Vandenis;ŽUVYČIŲ;8705188652;Ne;13;7;0;20
11561;Vandenis;ŽUVYČIŲ;24217366528;Ne;0;3;0;3
11562;Vandenis;ŽUVYČIŲ;3544717790;Ne;5;1;0;6
11563;Vandenis;ŽUVYČIŲ;4643267945;Ne;0;2;0;2
11564;Vandenis;ŽUVYČIŲ;27409922803;Ne;3;0;0;3
11565;Vandenis;ŽUVYČIŲ;2638433939;Ne;0;4;0;4
11566;Vandenis;PERLIUKŲ;5844576485;Ne;0;14;0;14
11567;Vandenis;PERLIUKŲ;6295009202;Ne;0;16;0;16
11568;Vandenis;PERLIUKŲ;7598257845;Ne;5;3;0;8
11569;Vandenis;PERLIUKŲ;7473692892;Ne;0;5;0;5
11570;Vandenis;PERLIUKŲ;5323428164;Ne;0;1;0;1
11571;Vandenis;PERLIUKŲ;6073002418;Ne;0;8;0;8
11572;Vandenis;PERLIUKŲ;5565147603;Ne;8;4;0;12
11573;Vandenis;PERLIUKŲ;2576575249;Ne;0;9;0;9
11574;Vandenis;PERLIUKŲ;1975385430;Ne;0;4;0;4
11575;Vandenis;PERLIUKŲ;3061606138;Ne;0;15;0;15
11576;Vandenis;PERLIUKŲ;8117385209;Ne;0;0;5;5
11577;Vandenis;PERLIUKŲ;5613067534;Ne;2;2;6;10
11578;Vandenis;PERLIUKŲ;2321919298;Ne;10;0;0;10
11579;Vandenis;PERLIUKŲ;3239754791;Ne;0;15;0;15
11580;Vandenis;PERLIUKŲ;5129492284;Ne;0;2;0;2
11581;Vandenis;ANČIUKŲ;4607196473;Ne;0;0;1;1
11582;Vandenis;ANČIUKŲ;6189862061;Ne;4;5;0;9
11583;Vandenis;ANČIUKŲ;4345021061;Ne;4;5;0;9
11584;Vandenis;ANČIUKŲ;9763300020;Ne;22;0;0;22
11585;Vandenis;ANČIUKŲ;3639160500;Ne;0;5;0;5
11586;Vandenis;ANČIUKŲ;1213743099;Ne;0;2;0;2
11587;Vandenis;ANČIUKŲ;4954121871;Ne;0;4;0;4
11588;Vandenis;ANČIUKŲ;8751355814;Ne;5;4;0;9
11589;Vandenis;ANČIUKŲ;4983424940;Ne;2;0;0;2
11590;Vandenis;ANČIUKŲ;4978712442;Ne;9;0;0;9
11591;Vandenis;ANČIUKŲ;7581114286;Ne;0;4;0;4
11592;Vandenis;ANČIUKŲ;9679010239;Ne;2;10;0;12
11593;Vandenis;ANČIUKŲ;1132534461;Ne;4;0;0;4
11594;Vandenis;ANČIUKŲ;3544764716;Ne;12;1;0;13
11595;Vandenis;ANČIUKŲ;4530824157;Ne;15;0;0;15
11596;Vandenis;VĖŽLIUKŲ;2309166304;Ne;2;2;0;4
11597;Vandenis;VĖŽLIUKŲ;2872343656;Ne;0;0;3;3
11598;Vandenis;VĖŽLIUKŲ;5454049563;Ne;0;2;0;2
11599;Vandenis;VĖŽLIUKŲ;9805578141;Ne;0;2;0;2
11600;Vandenis;VĖŽLIUKŲ;8921666108;Ne;0;11;0;11
11601;Vandenis;VĖŽLIUKŲ;7069369080;Ne;0;4;0;4
11602;Vandenis;VĖŽLIUKŲ;7924399684;Ne;0;3;0;3
11603;Vandenis;VĖŽLIUKŲ;1187395353;Ne;0;5;0;5
11604;Vandenis;VĖŽLIUKŲ;7091356848;Ne;0;5;0;5
11605;Vandenis;VĖŽLIUKŲ;5126732658;Ne;0;2;0;2
11606;Vandenis;VĖŽLIUKŲ;7059385610;Ne;0;4;0;4
11607;Vandenis;VĖŽLIUKŲ;9158541919;Ne;0;1;0;1
11608;Vandenis;VĖŽLIUKŲ;5959181898;Ne;0;1;0;1
11609;Vandenis;VĖŽLIUKŲ;1707354287;Ne;0;6;0;6
11610;Vandenis;VĖŽLIUKŲ;4413648496;Ne;1;0;1;2
11611;Vandenis;VĖŽLIUKŲ;9704394568;Ne;0;7;0;7
11612;Vandenis;VĖŽLIUKŲ;5218101579;Ne;0;4;0;4
11613;Vandenis;VĖŽLIUKŲ;2936885357;Ne;2;4;1;7
11614;Vandenis;VĖŽLIUKŲ;8879608849;Ne;0;12;0;12
11615;Vandenis;AŠTUNKOJŲ;2096950367;Ne;0;4;1;5
11616;Vandenis;AŠTUNKOJŲ;71786730314;Ne;0;2;0;2
11617;Vandenis;AŠTUNKOJŲ;6181866272;Ne;0;2;0;2
11618;Vandenis;AŠTUNKOJŲ;33317650043;Ne;0;2;0;2
11619;Vandenis;AŠTUNKOJŲ;7522472652;Ne;0;1;0;1
11620;Vandenis;AŠTUNKOJŲ;3243079651;Ne;0;7;0;7
11621;Vandenis;AŠTUNKOJŲ;3067868099;Ne;0;2;0;2
11622;Vandenis;AŠTUNKOJŲ;61120985165;Ne;0;0;2;2
11623;Vandenis;AŠTUNKOJŲ;8251169901;Ne;0;2;0;2
11624;Vandenis;AŠTUNKOJŲ;1314724267;Ne;5;0;2;7
11625;Vandenis;AŠTUNKOJŲ;1282499654;Ne;0;2;0;2
11626;Vandenis;AŠTUNKOJŲ;7168910452;Ne;0;1;0;1
11627;Vandenis;AŠTUNKOJŲ;2489776665;Ne;10;0;3;13
11628;Vandenis;AŠTUNKOJŲ;33782837791;Ne;0;2;0;2
11629;Vandenis;GANDRIUKŲ;4753416316;Ne;10;3;0;13
11630;Vandenis;GANDRIUKŲ;8264797886;Ne;14;0;0;14
11631;Vandenis;GANDRIUKŲ;9936940067;Ne;4;5;0;9
11632;Vandenis;GANDRIUKŲ;6260893699;Ne;0;5;1;6
11633;Vandenis;GANDRIUKŲ;1919577714;Ne;6;0;6;12
11634;Vandenis;GANDRIUKŲ;7019646962;Ne;0;5;0;5
11635;Vandenis;GANDRIUKŲ;2078767085;Ne;13;0;1;14
11636;Vandenis;GANDRIUKŲ;2976505868;Ne;22;0;0;22
11637;Vandenis;GANDRIUKŲ;6558155968;Ne;0;1;0;1
11638;Vandenis;GANDRIUKŲ;6691874473;Ne;0;0;3;3
11639;Vandenis;GANDRIUKŲ;6483030616;Ne;13;0;0;13
11640;Vandenis;GANDRIUKŲ;8144830789;Ne;19;0;0;19
11641;Vandenis;GANDRIUKŲ;2381566229;Ne;0;0;6;6
11642;Vandenis;GANDRIUKŲ;5899846599;Ne;5;0;0;5
11643;Vandenis;GANDRIUKŲ;8127873607;Ne;5;0;0;5
11644;Vandenis;GANDRIUKŲ;1606103904;Ne;17;1;0;18
11645;Vandenis;GANDRIUKŲ;1753180703;Ne;0;0;2;2
11646;Vandenis;GANDRIUKŲ;7303512055;Ne;0;1;1;2
11647;Vandenis;GANDRIUKŲ;7311677107;Ne;7;0;0;7
11648;Vandenis;GANDRIUKŲ;6586215199;Ne;0;6;0;6
11649;Vandenis;ŽĄSIUKAI;8034690071;Ne;10;0;0;10
11650;Vandenis;ŽĄSIUKAI;9937317687;Ne;0;2;0;2
11651;Vandenis;ŽĄSIUKAI;4984723792;Ne;0;2;0;2
11652;Vandenis;ŽĄSIUKAI;1333381525;Taip;0;1;0;1
11653;Vandenis;ŽĄSIUKAI;7071349847;Ne;0;4;0;4
11654;Vandenis;ŽĄSIUKAI;7070234429;Ne;0;1;0;1
11655;Vandenis;ŽĄSIUKAI;4072405890;Ne;3;2;0;5
11656;Vandenis;ŽĄSIUKAI;7596199296;Ne;0;3;0;3
11657;Vandenis;ŽĄSIUKAI;6876019354;Ne;0;4;0;4
11658;Vandenis;ŽĄSIUKAI;5607412408;Ne;19;0;0;19
11659;Vandenis;ŽĄSIUKAI;5641929490;Ne;2;4;0;6
11660;Vandenis;ŽĄSIUKAI;1850352131;Ne;0;1;0;1
11661;Vandenis;ŽĄSIUKAI;2454959791;Ne;0;2;0;2
11662;Vandenis;ŽĄSIUKAI;9801593009;Ne;6;0;0;6
11663;Vandenis;PURIENŲ;6851178154;Ne;0;5;0;5
11664;Vandenis;PURIENŲ;4455886780;Ne;4;0;0;4
11665;Vandenis;PURIENŲ;1031451445;Ne;5;0;0;5
11666;Vandenis;PURIENŲ;4815210197;Ne;7;1;0;8
11667;Vandenis;PURIENŲ;3337286021;Ne;0;15;0;15
11668;Vandenis;PURIENŲ;7020534318;Ne;15;0;0;15
11669;Vandenis;PURIENŲ;6027680514;Ne;8;2;0;10
11670;Vandenis;PURIENŲ;2960005490;Ne;8;2;0;10
11671;Vandenis;PURIENŲ;1180322026;Ne;8;2;0;10
11672;Vandenis;PURIENŲ;3633805607;Ne;0;1;0;1
11673;Vandenis;PURIENŲ;6332179750;Ne;0;2;0;2
11674;Vandenis;PURIENŲ;7171302906;Ne;5;8;0;13
11675;Vandenis;PURIENŲ;8085633453;Ne;5;8;0;13
11676;Vandenis;PURIENŲ;2614561762;Ne;0;1;0;1
11677;Vandenis;PURIENŲ;1244502945;Ne;0;2;0;2
11678;Vandenis;VARLIUKAI;2661339448;Ne;7;1;0;8
11679;Vandenis;VARLIUKAI;2451901210;Ne;13;0;0;13
11680;Vandenis;VARLIUKAI;1786146371;Ne;5;0;0;5
11681;Vandenis;VARLIUKAI;3393306645;Ne;7;0;0;7
11682;Vandenis;VARLIUKAI;2506411643;Ne;12;0;0;12
11683;Vandenis;VARLIUKAI;8841954633;Ne;17;0;0;17
11684;Vandenis;VARLIUKAI;7001613448;Ne;17;0;0;17
11685;Vandenis;VARLIUKAI;1983972864;Ne;12;1;0;13
11686;Vandenis;VARLIUKAI;6067408982;Ne;0;2;0;2
11687;Vandenis;VARLIUKAI;8239664149;Ne;11;2;0;13
11688;Vandenis;VARLIUKAI;9380306986;Ne;4;2;0;6
11689;Vandenis;VARLIUKAI;1953052452;Ne;2;1;0;3
11690;Vandenis;VARLIUKAI;3038533882;Ne;15;1;0;16
11691;Vandenis;VARLIUKAI;3173213991;Ne;0;6;0;6
11692;Vandenis;VARLIUKAI;6570331247;Ne;7;2;0;9
11693;Vandenis;PINGVINAI;9856199548;Ne;2;0;0;2
11694;Vandenis;PINGVINAI;2665865704;Ne;3;1;0;4
11695;Vandenis;PINGVINAI;8755050997;Ne;2;3;0;5
11696;Vandenis;PINGVINAI;1780124964;Ne;0;1;0;1
11697;Vandenis;PINGVINAI;9609168578;Ne;0;6;0;6
11698;Vandenis;PINGVINAI;2156775779;Ne;9;0;0;9
11699;Vandenis;PINGVINAI;5191604973;Ne;0;3;0;3
11700;Vandenis;PINGVINAI;2757376962;Ne;0;10;0;10
11701;Vandenis;PINGVINAI;6992750701;Ne;0;1;0;1
11702;Vandenis;PINGVINAI;6731336385;Ne;10;2;0;12
11703;Vandenis;PINGVINAI;3933306911;Ne;8;0;0;8
11704;Vandenis;PINGVINAI;2534991705;Ne;2;2;0;4
11705;Vandenis;PINGVINAI;7267965471;Ne;21;0;0;21
11706;Vandenis;PINGVINAI;9717294497;Ne;0;1;0;1
11707;Vandenis;PINGVINAI;7770227772;Ne;5;14;0;19
11708;Vandenis;PINGVINAI;8560123112;Ne;0;18;0;18
11709;Vandenis;PINGVINAI;4091633411;Ne;0;1;0;1
11710;Vandenis;Debesėlių;3163423293;Ne;0;0;11;11
11711;Vandenis;Debesėlių;6555465114;Ne;0;4;0;4
11712;Vandenis;Debesėlių;4226028904;Ne;15;0;0;15
11713;Vandenis;Debesėlių;2844636823;Ne;0;1;2;3
11714;Vandenis;Debesėlių;2426003664;Ne;0;2;0;2
11715;Vandenis;Debesėlių;9521927635;Ne;5;0;0;5
11716;Vandenis;Debesėlių;6494266251;Ne;7;0;0;7
11717;Vandenis;Debesėlių;3835819023;Ne;4;5;0;9
11718;Vandenis;Debesėlių;2953842982;Ne;0;2;9;11
11719;Vandenis;Debesėlių;8678508812;Ne;0;2;0;2
11720;Vandenis;Debesėlių;5609737826;Ne;0;10;3;13
11721;Vandenis;Debesėlių;6327478049;Ne;18;0;2;20
11722;Vandenis;Debesėlių;3231434944;Ne;0;2;19;21
11723;Vandenis;Gintarėlių;1542662577;Ne;8;0;0;8
11724;Vandenis;Gintarėlių;5683829836;Ne;0;0;2;2
11725;Vandenis;Gintarėlių;5560529824;Ne;0;3;1;4
11726;Vandenis;Gintarėlių;5874429309;Ne;11;0;2;13
11727;Vandenis;Gintarėlių;7318344804;Ne;0;0;2;2
11728;Vandenis;Gintarėlių;7884422309;Ne;8;0;2;10
11729;Vandenis;Gintarėlių;8420609325;Ne;15;0;1;16
11730;Vandenis;Gintarėlių;4611293254;Ne;0;0;1;1
11731;Vandenis;Gintarėlių;5071489844;Ne;5;0;1;6
11732;Vandenis;Gintarėlių;5081501601;Ne;2;0;1;3
11733;Vandenis;Gintarėlių;9093048795;Ne;0;0;1;1
11734;Vandenis;Gintarėlių;3968719760;Ne;0;0;6;6
11735;Vandenis;Gintarėlių;3342147138;Ne;17;0;1;18
11736;Vandenis;Gintarėlių;7959438279;Ne;11;7;0;18
11737;Vandenis;Gintarėlių;1788652447;Ne;0;0;4;4
11738;Vandenis;Gintarėlių;5540306590;Ne;0;1;0;1
11739;Vandenis;Lašelių;9756270419;Ne;10;0;1;11
11740;Vandenis;Lašelių;5438770600;Ne;5;5;0;10
11741;Vandenis;Lašelių;1701119089;Ne;10;0;0;10
11742;Vandenis;Lašelių;1969144957;Ne;0;0;5;5
11743;Vandenis;Lašelių;8001157954;Ne;15;0;0;15
11744;Vandenis;Lašelių;6882874044;Ne;10;0;0;10
11745;Vandenis;Lašelių;9095152994;Ne;0;0;7;7
11746;Vandenis;Lašelių;9756750533;Ne;0;6;0;6
11747;Vandenis;Lašelių;4525906178;Ne;0;0;2;2
11748;Vandenis;Lašelių;6851036864;Ne;20;0;0;20
11749;Vandenis;Lašelių;2144282854;Ne;0;0;3;3
11750;Vandenis;Lašelių;9178978753;Ne;0;0;8;8
11751;Vandenis;Burbuliukų;5144953316;Ne;0;1;0;1
11752;Vandenis;Burbuliukų;3750162497;Ne;15;0;2;17
11753;Vandenis;Burbuliukų;6068144373;Ne;0;0;21;21
11754;Vandenis;Burbuliukų;2783738727;Ne;0;2;4;6
11755;Vandenis;Burbuliukų;7080129095;Ne;8;1;0;9
11756;Vandenis;Burbuliukų;7856148436;Ne;8;0;0;8
11757;Vandenis;Burbuliukų;1035549424;Ne;6;0;0;6
11758;Vandenis;Burbuliukų;7492804255;Ne;0;10;1;11
11759;Vandenis;Burbuliukų;4483401826;Ne;3;0;0;3
11760;Vandenis;Burbuliukų;9314410776;Ne;5;0;0;5
11761;Vandenis;Burbuliukų;2647966131;Ne;2;0;0;2
11762;Vandenis;Burbuliukų;4715198793;Ne;0;0;1;1
11763;Vandenis;Kriauklyčių;9130870495;Ne;20;0;0;20
11764;Vandenis;Kriauklyčių;2578294768;Ne;0;10;0;10
11765;Vandenis;Kriauklyčių;7736505435;Ne;4;15;0;19
11766;Vandenis;Kriauklyčių;5362018982;Ne;3;5;1;9
11767;Vandenis;Kriauklyčių;4219981694;Ne;15;0;1;16
11768;Vandenis;Kriauklyčių;8703465445;Ne;0;15;0;15
11769;Vandenis;Kriauklyčių;5983635986;Ne;0;5;1;6
11770;Vandenis;Kriauklyčių;4373688502;Ne;0;1;0;1
11771;Vandenis;Kriauklyčių;8921398489;Ne;19;0;0;19
11772;Vandenis;Kriauklyčių;6112591131;Ne;4;0;0;4
11773;Vandenis;Kriauklyčių;2528214535;Ne;9;5;0;14
11774;Vandenis;Kriauklyčių;6848032146;Ne;8;11;0;19
11775;Vandenis;Kriauklyčių;2945086818;Ne;8;0;2;10
11776;Vandenis;Kriauklyčių;4168391832;Ne;14;4;0;18
11777;Varpelis;NYKŠTUKAI;3840270467;Ne;14;0;0;14
11778;Varpelis;NYKŠTUKAI;5155733224;Ne;13;0;0;13
11779;Varpelis;"SPINDULIUKŲ su Valdorfo elementais";7878525896;Ne;2;0;0;2
11780;Varpelis;"SPINDULIUKŲ su Valdorfo elementais";3055411665;Ne;8;0;0;8
11781;Varpelis;"SPINDULIUKŲ su Valdorfo elementais";8468458454;Ne;17;0;0;17
11782;Varpelis;GINTARĖLIAI;8829065644;Ne;8;0;0;8
11783;Varpelis;GINTARĖLIAI;4315014085;Ne;5;0;0;5
11784;Varpelis;GINTARĖLIAI;2075280051;Ne;6;0;0;6
11785;Varpelis;AITVARIUKŲ;7557698033;Ne;8;0;0;8
11786;Varpelis;AITVARIUKŲ;6820400111;Ne;19;0;0;19
11787;Varpelis;ZUIKUČIŲ;1336468541;Ne;1;0;0;1
11788;Varpelis;ZUIKUČIŲ;7370494042;Ne;6;0;0;6
11789;Varpelis;ZUIKUČIŲ;9471404892;Ne;4;0;0;4
11790;Varpelis;ZUIKUČIŲ;1029481623;Ne;3;0;0;3
11791;Varpelis;BITUTĖS;6272649584;Ne;5;0;0;5
11792;Varpelis;BITUTĖS;4811186406;Ne;15;0;0;15
11793;Varpelis;DRUGELIAI;6397377742;Ne;4;0;0;4
11794;Varpelis;DRUGELIAI;5530898751;Ne;3;0;0;3
11795;Varpelis;LAŠIUKŲ;8203343084;Ne;10;0;0;10
11796;Varpelis;LAŠIUKŲ;7029102540;Ne;12;0;0;12
11797;Varpelis;ŽIRNIUKŲ;3767484917;Taip;10;0;0;10
11798;Varpelis;ŽIRNIUKŲ;1251914675;Ne;11;0;0;11
11799;Varpelis;ŽIRNIUKŲ;6478769033;Ne;12;0;0;12
11800;Vėjelis;Pumpurėliai;2541077369;Ne;7;9;0;16
11801;Vėjelis;Pumpurėliai;3125815427;Ne;17;0;0;17
11802;Vėjelis;Pumpurėliai;5516672613;Ne;5;5;0;10
11803;Vėjelis;Pumpurėliai;2866394056;Ne;2;0;0;2
11804;Vėjelis;Pumpurėliai;3206025676;Ne;0;7;0;7
11805;Vėjelis;Pumpurėliai;5611813359;Ne;3;2;0;5
11806;Vėjelis;Pumpurėliai;1057586168;Ne;14;0;0;14
11807;Vėjelis;Pumpurėliai;9583495324;Ne;4;1;0;5
11808;Vėjelis;Pumpurėliai;7539681314;Ne;0;2;0;2
11809;Vėjelis;Pumpurėliai;6168648640;Ne;0;2;1;3
11810;Vėjelis;Pumpurėliai;1876663813;Ne;2;2;2;6
11811;Vėjelis;Pumpurėliai;6840643273;Ne;0;1;0;1
11812;Vėjelis;Pumpurėliai;9824130744;Ne;0;1;0;1
11813;Vėjelis;Pumpurėliai;1842552329;Ne;7;0;0;7
11814;Vėjelis;Pumpurėliai;8467887788;Ne;0;11;0;11
11815;Vėjelis;Pumpurėliai;9274287800;Taip;5;2;0;7
11816;Vėjelis;Pumpurėliai;8994680698;Ne;11;0;0;11
11817;Vėjelis;Pumpurėliai;2656895893;Ne;10;0;0;10
11818;Vėjelis;Drugeliai;4746932126;Ne;0;1;2;3
11819;Vėjelis;Drugeliai;1978952781;Ne;0;0;1;1
11820;Vėjelis;Drugeliai;2416832899;Ne;0;1;0;1
11821;Vėjelis;Drugeliai;2734024890;Taip;0;8;0;8
11822;Vėjelis;Drugeliai;7981032872;Ne;0;22;0;22
11823;Vėjelis;Drugeliai;7594586198;Ne;0;0;4;4
11824;Vėjelis;Drugeliai;7697394469;Ne;7;0;3;10
11825;Vėjelis;Drugeliai;4066956765;Ne;0;0;2;2
11826;Vėjelis;Drugeliai;2788205363;Ne;8;0;3;11
11827;Vėjelis;Drugeliai;1331334220;Ne;0;2;5;7
11828;Vėjelis;Drugeliai;2151737048;Ne;0;5;0;5
11829;Vėjelis;Drugeliai;3982318250;Ne;2;0;0;2
11830;Vėjelis;Drugeliai;4473677352;Ne;0;5;0;5
11831;Vėjelis;Drugeliai;4506243333;Ne;0;0;1;1
11832;Vėjelis;Drugeliai;3524350131;Ne;0;0;3;3
11833;Vėjelis;Drugeliai;3453119286;Ne;0;0;3;3
11834;Vėjelis;Drugeliai;6891260701;Ne;0;3;0;3
11835;Vėjelis;Malūnėlis;1448699738;Ne;0;5;10;15
11836;Vėjelis;Malūnėlis;3275186042;Ne;0;1;0;1
11837;Vėjelis;Malūnėlis;1882750621;Ne;17;0;0;17
11838;Vėjelis;Malūnėlis;5109441799;Ne;2;0;2;4
11839;Vėjelis;Malūnėlis;4171024976;Ne;4;0;3;7
11840;Vėjelis;Malūnėlis;8221349174;Ne;0;2;0;2
11841;Vėjelis;Malūnėlis;6600504736;Ne;0;3;0;3
11842;Vėjelis;Malūnėlis;8063276082;Ne;6;0;0;6
11843;Vėjelis;Malūnėlis;6244227830;Ne;0;0;3;3
11844;Vėjelis;Malūnėlis;1417987860;Ne;17;0;2;19
11845;Vėjelis;Malūnėlis;9636946669;Ne;7;0;3;10
11846;Vėjelis;Malūnėlis;8822873586;Ne;4;7;0;11
11847;Vėjelis;Malūnėlis;6823103188;Ne;5;8;0;13
11848;Vėjelis;Žvaigždutės;9492690970;Ne;0;1;1;2
11849;Vėjelis;Žvaigždutės;1436893015;Ne;7;0;0;7
11850;Vėjelis;Žvaigždutės;2117924725;Ne;3;0;0;3
11851;Vėjelis;Žvaigždutės;8866974952;Ne;0;1;0;1
11852;Vėjelis;Žvaigždutės;1549518622;Ne;7;0;5;12
11853;Vėjelis;Žvaigždutės;6386092350;Ne;0;18;0;18
11854;Vėjelis;Žvaigždutės;6844704326;Ne;0;0;1;1
11855;Vėjelis;Žvaigždutės;4353239658;Ne;5;10;0;15
11856;Vėjelis;Žvaigždutės;3315240387;Taip;0;15;0;15
11857;Vėjelis;Žvaigždutės;9557135813;Ne;0;1;0;1
11858;Vėjelis;Žvaigždutės;2132551615;Ne;0;22;0;22
11859;Vėjelis;Žvaigždutės;2522750651;Ne;7;0;0;7
11860;Vėjelis;Žvaigždutės;6777528441;Ne;0;1;0;1
11861;Vėjelis;Žvaigždutės;9135807341;Ne;0;0;1;1
11862;Vėjelis;Žvaigždutės;4101161670;Ne;0;2;0;2
11863;Vėjelis;Žvaigždutės;7247057946;Ne;7;0;4;11
11864;Vėjelis;Žvaigždutės;7046938604;Ne;0;0;1;1
11865;Vėjelis;Žvaigždutės;3495322620;Ne;7;10;0;17
11866;Vėjelis;Žvaigždutės;1956418258;Ne;0;13;0;13
11867;Vėjelis;Žvaigždutės;7203026860;Ne;19;0;0;19
11868;Vėjelis;Žvaigždutės;8300497094;Ne;0;1;3;4
11869;Vėjelis;Varpeliai;7274745807;Ne;0;2;1;3
11870;Vėjelis;Varpeliai;9926991259;Ne;0;2;6;8
11871;Vėjelis;Varpeliai;6608657740;Ne;8;0;0;8
11872;Vėjelis;Varpeliai;2794205377;Ne;0;1;2;3
11873;Vėjelis;Varpeliai;7507448059;Ne;0;8;0;8
11874;Vėjelis;Varpeliai;2363974247;Ne;5;7;0;12
11875;Vėjelis;Varpeliai;8379298947;Ne;5;7;0;12
11876;Vėjelis;Varpeliai;1205392813;Ne;6;1;0;7
11877;Vėjelis;Varpeliai;5396347620;Ne;0;1;0;1
11878;Vėjelis;Varpeliai;4219672982;Ne;0;2;5;7
11879;Vėjelis;Varpeliai;50124109589;Ne;0;2;0;2
11880;Vėjelis;Varpeliai;4853650350;Ne;3;1;0;4
11881;Vėjelis;Varpeliai;4521161684;Ne;0;10;0;10
11882;Vėjelis;Varpeliai;60890519853;Ne;0;2;2;4
11883;Vėjelis;Varpeliai;8684461171;Ne;0;3;0;3
11884;Vėjelis;Varpeliai;7133454882;Ne;0;4;0;4
11885;Vėjelis;Varpeliai;1863210064;Ne;0;9;0;9
11886;Vėjelis;Varpeliai;6221257045;Ne;0;1;3;4
11887;Vėjelis;Varpeliai;1534169381;Ne;0;5;0;5
11888;Vėjelis;Varpeliai;2957105835;Ne;5;0;3;8
11889;Vėjelis;Varpeliai;8748218387;Ne;3;0;1;4
11890;Vėjelis;Pelėdžiukų;3067215309;Ne;0;1;0;1
11891;Vėjelis;Pelėdžiukų;7211756910;Ne;0;3;0;3
11892;Vėjelis;Pelėdžiukų;2302652824;Ne;8;2;4;14
11893;Vėjelis;Pelėdžiukų;4852532740;Ne;0;22;0;22
11894;Vėjelis;Pelėdžiukų;9202471939;Ne;5;1;0;6
11895;Vėjelis;Pelėdžiukų;1615837863;Ne;5;1;0;6
11896;Vėjelis;Pelėdžiukų;9852892338;Ne;1;2;0;3
11897;Vėjelis;Pelėdžiukų;8433853523;Ne;0;0;1;1
11898;Vėjelis;Pelėdžiukų;4746355716;Ne;0;0;6;6
11899;Vėjelis;Pelėdžiukų;5507017221;Ne;0;1;0;1
11900;Vėjelis;Pelėdžiukų;1259743374;Ne;2;2;13;17
11901;Vėjelis;Pelėdžiukų;6226234271;Ne;0;22;0;22
11902;Vėjelis;Pelėdžiukų;3764096742;Ne;1;0;1;2
11903;Vėjelis;Pelėdžiukų;8153021028;Ne;0;2;2;4
11904;Vėjelis;Pelėdžiukų;8067153728;Ne;1;0;0;1
11905;Vėjelis;Pelėdžiukų;2283628712;Ne;0;2;3;5
11906;Vėjelis;Pelėdžiukų;9769871497;Ne;0;0;1;1
11907;Vėjelis;Pelėdžiukų;4318295503;Ne;10;0;3;13
11908;Vėjelis;Pelėdžiukų;9867392835;Ne;0;13;0;13
11909;Vėjelis;Pelėdžiukų;5662728912;Ne;0;0;9;9
11910;Vėjelis;Skruzdeliukų;2167025998;Ne;0;2;2;4
11911;Vėjelis;Skruzdeliukų;2467377103;Ne;14;0;0;14
11912;Vėjelis;Skruzdeliukų;8470977526;Ne;0;10;0;10
11913;Vėjelis;Skruzdeliukų;1952141664;Ne;12;0;2;14
11914;Vėjelis;Skruzdeliukų;3264153232;Ne;0;1;0;1
11915;Vėjelis;Skruzdeliukų;4992783345;Ne;0;12;3;15
11916;Vėjelis;Skruzdeliukų;4997987762;Ne;0;0;7;7
11917;Vėjelis;Skruzdeliukų;4412135676;Ne;0;0;5;5
11918;Vėjelis;Skruzdeliukų;8356715925;Ne;0;0;4;4
11919;Vėjelis;Skruzdeliukų;4946988585;Ne;0;5;1;6
11920;Vėjelis;Skruzdeliukų;7240155487;Ne;0;0;3;3
11921;Vėjelis;Skruzdeliukų;7695719991;Ne;0;0;4;4
11922;Vėjelis;Skruzdeliukų;6618114389;Ne;0;2;0;2
11923;Vėjelis;Skruzdeliukų;1381923971;Ne;0;4;0;4
11924;Vėjelis;Skruzdeliukų;8630131152;Ne;3;0;1;4
11925;Vėjelis;Skruzdeliukų;9177137585;Ne;0;6;0;6
11926;Vėjelis;Skruzdeliukų;4080198912;Ne;5;0;3;8
11927;Vėjelis;Skruzdeliukų;1555270425;Ne;0;0;1;1
11928;Vėjelis;Skruzdeliukų;7400967836;Ne;0;0;1;1
11929;Vėjelis;Pieštukų;8995478684;Ne;0;10;0;10
11930;Vėjelis;Pieštukų;7860576967;Ne;5;0;0;5
11931;Vėjelis;Pieštukų;9546928491;Ne;10;0;1;11
11932;Vėjelis;Pieštukų;9675488924;Ne;6;0;0;6
11933;Vėjelis;Pieštukų;4884057836;Ne;0;0;4;4
11934;Vėjelis;Pieštukų;3898751303;Ne;15;7;0;22
11935;Vėjelis;Pieštukų;8281508498;Ne;5;0;9;14
11936;Vėjelis;Pieštukų;7748975870;Taip;5;3;0;8
11937;Vėjelis;Pieštukų;1075188861;Ne;0;0;2;2
11938;Vėjelis;Pieštukų;7854614677;Ne;8;0;0;8
11939;Vėjelis;Pieštukų;9451358807;Ne;6;0;6;12
11940;Vėjelis;Pieštukų;6453605110;Ne;0;22;0;22
11941;Vėjelis;Pieštukų;2720886612;Ne;0;3;0;3
11942;Vėjelis;Pieštukų;2734891342;Taip;7;15;0;22
11943;Vėjelis;Pieštukų;7101585528;Ne;0;0;2;2
11944;Vėjelis;Pieštukų;2373132607;Ne;8;0;1;9
11945;Vėjelis;Ramunėlių;6660799519;Ne;12;0;0;12
11946;Vėjelis;Ramunėlių;6889825160;Ne;0;1;0;1
11947;Vėjelis;Ramunėlių;4745262277;Ne;2;0;0;2
11948;Vėjelis;Ramunėlių;7790713917;Ne;0;3;0;3
11949;Vėjelis;Ramunėlių;8986581196;Ne;5;0;0;5
11950;Vėjelis;Ramunėlių;3123360955;Ne;0;1;0;1
11951;Vėjelis;Nykštukai;6741600874;Ne;10;0;0;10
11952;Vėjelis;Nykštukai;7233448544;Ne;16;2;0;18
11953;Vėjelis;Nykštukai;5339200991;Ne;0;5;0;5
11954;Vėjelis;Nykštukai;6602964509;Ne;0;1;0;1
11955;Vėjelis;Nykštukai;2573683778;Ne;0;5;0;5
11956;Vėjelis;Nykštukai;3843601190;Ne;5;0;3;8
11957;Vėjelis;Nykštukai;4713754452;Ne;0;3;0;3
11958;Vėjelis;Nykštukai;7889625599;Ne;5;1;0;6
11959;Vėjelis;Nykštukai;7763996061;Ne;0;2;0;2
11960;Vėjelis;Nykštukai;3813509637;Ne;0;1;0;1
11961;Vėjelis;Nykštukai;8755889077;Ne;0;6;2;8
11962;Vėjelis;Nykštukai;2763569936;Ne;0;5;1;6
11963;Vėjelis;Nykštukai;9979979480;Ne;6;0;10;16
11964;Vėjelis;Nykštukai;4063795811;Ne;0;2;0;2
11965;Vėjelis;BITUTĖS;4276237884;Ne;15;2;0;17
11966;Vėjelis;BITUTĖS;3772706363;Ne;0;11;0;11
11967;Vėjelis;BITUTĖS;1834203833;Ne;9;1;0;10
11968;Vėjelis;BITUTĖS;8452132066;Ne;0;22;0;22
11969;Vėjelis;BITUTĖS;6283428333;Ne;20;0;0;20
11970;Vėjelis;BITUTĖS;1112394040;Ne;7;1;0;8
11971;Vėjelis;BITUTĖS;3767625080;Ne;4;2;0;6
11972;Vėjelis;BITUTĖS;6569848405;Ne;10;0;0;10
11973;Vėjelis;BITUTĖS;1457373815;Ne;20;0;0;20
11974;Vėjelis;BITUTĖS;8571757635;Ne;10;2;0;12
11975;Vėjelis;BITUTĖS;1022888418;Ne;0;2;0;2
11976;Vėjelis;BITUTĖS;1116238331;Ne;7;7;0;14
11977;Vėjelis;BITUTĖS;8286070405;Ne;0;5;0;5
11978;Vėjelis;BITUTĖS;1674810054;Ne;12;0;2;14
11979;Vėjelis;BITUTĖS;6581265682;Ne;12;3;0;15
11980;Vėjelis;BITUTĖS;1070853175;Ne;12;0;0;12
11981;Vėjelis;BITUTĖS;4348246825;Ne;3;0;0;3
11982;Vėjelis;BITUTĖS;8273890475;Ne;0;3;0;3
11983;Vėjelis;Boruželės;2199680661;Ne;0;0;3;3
11984;Vėjelis;Boruželės;5325081841;Ne;5;0;0;5
11985;Vėjelis;Boruželės;5381588565;Ne;0;0;2;2
11986;Vėjelis;Boruželės;9037622738;Ne;7;5;0;12
11987;Vėjelis;Boruželės;1588345134;Ne;0;2;7;9
11988;Vėjelis;Boruželės;1429496839;Ne;0;0;3;3
11989;Vėjelis;Boruželės;1931659200;Ne;4;1;0;5
11990;Vėjelis;Boruželės;8666759391;Ne;3;0;0;3
11991;Vėjelis;Boruželės;3844131154;Ne;2;0;4;6
11992;Vėjelis;Boruželės;4747466651;Ne;0;1;0;1
11993;Vėjelis;Boruželės;3473416323;Ne;4;0;0;4
11994;Vėjelis;Boruželės;8141198449;Ne;0;5;2;7
11995;Vėjelis;Boruželės;8121537795;Ne;0;3;1;4
11996;Vėjelis;Boruželės;5517128872;Ne;0;2;2;4
11997;Vėjelis;Boruželės;8938491367;Ne;0;2;1;3
11998;Vėjelis;Boruželės;6108049183;Taip;0;8;0;8
11999;Vėjelis;Boruželės;1115802837;Ne;5;0;0;5
12000;Vėjelis;Boruželės;1494531065;Ne;0;6;0;6
12001;Vėjelis;Boruželės;9298789434;Ne;5;2;0;7
12002;Vėjelis;Boruželės;4132824111;Ne;1;9;0;10
12003;Vėjelis;Boruželės;2000277444;Ne;5;10;0;15
12004;Vėjelis;Boruželės;7752923796;Ne;6;0;6;12
12005;Vėtrungė;Debesėlių;3655025938;Ne;0;0;4;4
12006;Vėtrungė;Debesėlių;2825732654;Taip;0;1;0;1
12007;Vėtrungė;Debesėlių;6439014588;Ne;0;0;11;11
12008;Vėtrungė;Debesėlių;1191007983;Ne;0;4;0;4
12009;Vėtrungė;Debesėlių;3745680607;Ne;0;6;4;10
12010;Vėtrungė;Debesėlių;9359012317;Ne;6;0;0;6
12011;Vėtrungė;Debesėlių;1807742144;Taip;0;0;9;9
12012;Vėtrungė;Debesėlių;9893842192;Ne;12;0;1;13
12013;Vėtrungė;Debesėlių;3433811829;Ne;0;0;3;3
12014;Vėtrungė;Debesėlių;2447851565;Ne;0;7;0;7
12015;Vėtrungė;Debesėlių;2136966687;Ne;0;6;0;6
12016;Vėtrungė;Debesėlių;5836190044;Ne;0;0;2;2
12017;Vėtrungė;Debesėlių;5545581078;Ne;0;0;1;1
12018;Vėtrungė;Debesėlių;7185104341;Ne;2;9;0;11
12019;Vėtrungė;Debesėlių;6374739740;Taip;0;2;5;7
12020;Vėtrungė;Debesėlių;5939537473;Ne;0;1;0;1
12021;Vėtrungė;Debesėlių;1871358961;Ne;3;4;0;7
12022;Vėtrungė;Zuikių;9332362038;Ne;4;0;5;9
12023;Vėtrungė;Zuikių;9407558097;Ne;0;11;0;11
12024;Vėtrungė;Zuikių;2985829593;Ne;0;1;0;1
12025;Vėtrungė;Zuikių;4121886031;Ne;3;1;0;4
12026;Vėtrungė;Zuikių;7573021445;Ne;7;0;2;9
12027;Vėtrungė;Zuikių;3335047815;Ne;0;3;0;3
12028;Vėtrungė;Zuikių;8157356569;Ne;0;5;0;5
12029;Vėtrungė;Zuikių;9742099165;Ne;7;1;0;8
12030;Vėtrungė;Zuikių;1215953192;Ne;7;0;0;7
12031;Vėtrungė;Zuikių;3908259010;Ne;0;10;0;10
12032;Vėtrungė;Zuikių;1729819557;Ne;0;1;0;1
12033;Vėtrungė;Zuikių;4916692634;Ne;0;3;3;6
12034;Vėtrungė;Zuikių;6416245099;Ne;7;6;0;13
12035;Vėtrungė;Zuikių;4197321604;Ne;4;0;0;4
12036;Vėtrungė;Zuikių;1007578933;Ne;8;1;0;9
12037;Vėtrungė;Zuikių;7558548846;Ne;8;1;0;9
12038;Vėtrungė;Zuikių;8742161467;Ne;0;8;0;8
12039;Vėtrungė;Zuikių;2537221101;Ne;2;2;0;4
12040;Vėtrungė;Zuikių;7342250921;Ne;0;9;0;9
12041;Vėtrungė;Zuikių;9248113268;Ne;0;1;1;2
12042;Vėtrungė;Zuikių;7435005821;Ne;5;2;4;11
12043;Vėtrungė;Zuikių;1280823326;Ne;8;5;0;13
12044;Vėtrungė;Drugelių;5622109033;Ne;0;1;0;1
12045;Vėtrungė;Drugelių;7943682529;Ne;0;7;0;7
12046;Vėtrungė;Drugelių;2124476787;Ne;2;0;0;2
12047;Vėtrungė;Drugelių;2970067995;Ne;0;3;0;3
12048;Vėtrungė;Drugelių;8729505032;Ne;0;1;0;1
12049;Vėtrungė;Drugelių;5251308945;Taip;0;2;0;2
12050;Vėtrungė;Drugelių;8753387108;Ne;0;0;5;5
12051;Vėtrungė;Drugelių;3634995652;Ne;0;5;0;5
12052;Vėtrungė;Drugelių;2123410772;Ne;2;1;0;3
12053;Vėtrungė;Drugelių;3744377479;Ne;0;0;5;5
12054;Vėtrungė;Drugelių;8905533826;Ne;10;0;0;10
12055;Vėtrungė;Drugelių;7186353024;Ne;5;1;0;6
12056;Vėtrungė;Drugelių;2933312366;Ne;0;17;0;17
12057;Vėtrungė;Drugelių;2508501223;Ne;0;5;0;5
12058;Vėtrungė;Drugelių;6538402680;Ne;0;0;6;6
12059;Vėtrungė;Do-re-mi;9324733839;Ne;0;9;2;11
12060;Vėtrungė;Do-re-mi;2928868412;Ne;0;3;5;8
12061;Vėtrungė;Do-re-mi;2883254822;Ne;0;6;6;12
12062;Vėtrungė;Do-re-mi;9518734260;Ne;7;3;0;10
12063;Vėtrungė;Do-re-mi;7496582551;Ne;0;0;1;1
12064;Vėtrungė;Do-re-mi;5430818470;Ne;16;3;0;19
12065;Vėtrungė;Do-re-mi;5832298824;Ne;0;2;0;2
12066;Vėtrungė;Do-re-mi;7895027909;Ne;0;10;2;12
12067;Vėtrungė;Do-re-mi;7807708310;Ne;0;5;4;9
12068;Vėtrungė;Do-re-mi;3200251047;Ne;0;6;2;8
12069;Vėtrungė;Do-re-mi;3369970611;Ne;0;12;0;12
12070;Vėtrungė;Do-re-mi;1808699695;Ne;0;8;5;13
12071;Vėtrungė;Do-re-mi;9079483362;Ne;7;9;2;18
12072;Vėtrungė;Do-re-mi;9271869305;Ne;0;1;7;8
12073;Vėtrungė;Do-re-mi;4709068324;Ne;0;5;1;6
12074;Vėtrungė;Do-re-mi;5452337780;Ne;5;1;0;6
12075;Vėtrungė;Do-re-mi;8956375453;Ne;0;10;2;12
12076;Vėtrungė;Do-re-mi;9865628172;Ne;0;10;1;11
12077;Vėtrungė;Smalsučių;7803736567;Ne;6;3;0;9
12078;Vėtrungė;Smalsučių;3249689008;Ne;7;2;0;9
12079;Vėtrungė;Smalsučių;7295216791;Ne;0;5;0;5
12080;Vėtrungė;Smalsučių;7363490503;Ne;0;7;0;7
12081;Vėtrungė;Smalsučių;16216365941;Ne;5;0;6;11
12082;Vėtrungė;Smalsučių;2471926240;Ne;0;0;11;11
12083;Vėtrungė;Smalsučių;2440001662;Ne;0;14;0;14
12084;Vėtrungė;Smalsučių;4000379945;Ne;16;4;0;20
12085;Vėtrungė;Smalsučių;5367369908;Ne;0;7;0;7
12086;Vėtrungė;Smalsučių;4154712272;Ne;0;4;4;8
12087;Vėtrungė;Smalsučių;3278452234;Ne;0;1;0;1
12088;Vėtrungė;Smalsučių;7483624989;Taip;0;4;0;4
12089;Vėtrungė;Smalsučių;4394100006;Ne;5;1;0;6
12090;Vėtrungė;Smalsučių;7730716483;Ne;0;3;0;3
12091;Vėtrungė;Smalsučių;5786557195;Ne;0;6;0;6
12092;Vėtrungė;Gudručių;6732632515;Taip;0;2;0;2
12093;Vėtrungė;Gudručių;8721035192;Ne;0;9;0;9
12094;Vėtrungė;Gudručių;1970034012;Ne;0;11;0;11
12095;Vėtrungė;Gudručių;8897558066;Ne;0;9;0;9
12096;Vėtrungė;Gudručių;7921863675;Ne;0;10;0;10
12097;Vėtrungė;Gudručių;8154023892;Ne;2;10;0;12
12098;Vėtrungė;Gudručių;1522141057;Ne;0;2;0;2
12099;Vėtrungė;Gudručių;9962435598;Ne;2;2;0;4
12100;Vėtrungė;Gudručių;2864217098;Ne;0;1;0;1
12101;Vėtrungė;Gudručių;2482436192;Ne;0;7;0;7
12102;Vėtrungė;Gudručių;4092242233;Ne;0;1;0;1
12103;Vėtrungė;Gudručių;4091719904;Ne;0;5;0;5
12104;Vėtrungė;Gudručių;5994465833;Ne;2;2;3;7
12105;Vėtrungė;Gudručių;4347810256;Ne;3;1;0;4
12106;Vėtrungė;Gudručių;7704497739;Ne;0;2;1;3
12107;Vėtrungė;Gudručių;8643181832;Ne;0;0;2;2
12108;Vėtrungė;Gudručių;1520846063;Ne;0;2;5;7
12109;Vėtrungė;Kodėlčių;9172488122;Ne;0;12;0;12
12110;Vėtrungė;Kodėlčių;2739382736;Ne;5;9;6;20
12111;Vėtrungė;Kodėlčių;3903604247;Ne;7;0;3;10
12112;Vėtrungė;Kodėlčių;3500551575;Ne;8;0;0;8
12113;Vėtrungė;Kodėlčių;7872043253;Ne;2;5;0;7
12114;Vėtrungė;Kodėlčių;9852609222;Ne;0;1;0;1
12115;Vėtrungė;Kodėlčių;8465132902;Ne;0;11;0;11
12116;Vėtrungė;Kodėlčių;8859592174;Ne;9;0;0;9
12117;Vėtrungė;Kodėlčių;7862615352;Ne;0;5;0;5
12118;Vėtrungė;Kodėlčių;5385880910;Ne;0;4;0;4
12119;Vėtrungė;Kodėlčių;9211406129;Ne;0;2;0;2
12120;Vėtrungė;Kodėlčių;1032730549;Ne;0;7;0;7
12121;Vėtrungė;Kodėlčių;7511121411;Ne;0;8;0;8
12122;Vėtrungė;Kodėlčių;5830221727;Ne;0;5;0;5
12123;Vėtrungė;Kodėlčių;4756863295;Ne;22;7;0;29
12124;Vėtrungė;Kodėlčių;8985054558;Ne;0;1;0;1
12125;Vėtrungė;Kodėlčių;3922749661;Ne;0;13;0;13
12126;Vėtrungė;Kodėlčių;8013249618;Ne;0;14;0;14
12127;Vėtrungė;Kodėlčių;3887230224;Ne;7;0;0;7
12128;Vėtrungė;Kodėlčių;7740260264;Ne;0;3;0;3
12129;Vėtrungė;Kodėlčių;6807838878;Ne;13;2;0;15
12130;Vėtrungė;Kodėlčių;3638303693;Ne;0;2;3;5
12131;Vėtrungė;Paukštelių;6983172988;Ne;0;8;0;8
12132;Vėtrungė;Paukštelių;3957148270;Ne;0;6;0;6
12133;Vėtrungė;Paukštelių;3466149991;Ne;8;0;0;8
12134;Vėtrungė;Paukštelių;7258995031;Ne;6;2;0;8
12135;Vėtrungė;Paukštelių;5338424871;Ne;0;1;0;1
12136;Vėtrungė;Paukštelių;4805836717;Ne;6;2;0;8
12137;Vėtrungė;Paukštelių;6812588777;Ne;3;0;0;3
12138;Vėtrungė;Paukštelių;2798915063;Ne;5;6;0;11
12139;Vėtrungė;Paukštelių;2981610749;Ne;6;6;6;18
12140;Vėtrungė;Paukštelių;6146327857;Ne;15;0;0;15
12141;Vėtrungė;Paukštelių;8149563485;Ne;0;4;0;4
12142;Vėtrungė;Viščiukų;2725607774;Ne;10;0;0;10
12143;Vėtrungė;Viščiukų;5021830780;Ne;9;0;2;11
12144;Vėtrungė;Viščiukų;5808423634;Ne;6;6;0;12
12145;Vėtrungė;Viščiukų;6190900822;Ne;0;0;4;4
12146;Vėtrungė;Viščiukų;3834510410;Ne;0;8;5;13
12147;Vėtrungė;Viščiukų;4597361099;Ne;14;0;0;14
12148;Vėtrungė;Viščiukų;2490075899;Ne;0;5;0;5
12149;Vėtrungė;Viščiukų;4712052283;Ne;0;7;0;7
12150;Vėtrungė;Viščiukų;8761701511;Ne;8;0;0;8
12151;Vėtrungė;Viščiukų;3527585648;Ne;4;0;0;4
12152;Vėtrungė;Viščiukų;9684184905;Ne;6;9;1;16
12153;Vėtrungė;Viščiukų;4145172377;Ne;17;0;2;19
12154;Vėtrungė;Viščiukų;8577668542;Ne;11;0;1;12
12155;Vėtrungė;Nykštukų;9696984346;Ne;0;14;0;14
12156;Vėtrungė;Nykštukų;7819147751;Ne;0;8;0;8
12157;Vėtrungė;Nykštukų;6990506209;Ne;5;1;3;9
12158;Vėtrungė;Nykštukų;2348557463;Ne;0;10;2;12
12159;Vėtrungė;Nykštukų;7733472482;Ne;0;7;0;7
12160;Vėtrungė;Nykštukų;2309821873;Ne;2;0;0;2
12161;Vėtrungė;Nykštukų;2364156362;Ne;0;20;0;20
12162;Vėtrungė;Nykštukų;8059553343;Ne;0;4;0;4
12163;Vėtrungė;Nykštukų;4020987532;Ne;0;2;1;3
12164;Vėtrungė;Nykštukų;9569555731;Ne;7;2;0;9
12165;Vėtrungė;Nykštukų;7699392279;Ne;0;17;0;17
12166;Vėtrungė;Nykštukų;9773838651;Ne;0;8;0;8
12167;Vėtrungė;Nykštukų;6866720274;Ne;2;0;0;2
12168;Vėtrungė;Nykštukų;3869546285;Ne;0;1;0;1
12169;Vėtrungė;Nykštukų;6783756347;Ne;2;1;2;5
12170;Vėtrungė;Meškiukų;2510763357;Ne;2;1;0;3
12171;Vėtrungė;Meškiukų;4713420194;Ne;2;1;0;3
12172;Vėtrungė;Meškiukų;2226654309;Ne;0;2;0;2
12173;Vėtrungė;Meškiukų;3328447991;Ne;0;1;0;1
12174;Vėtrungė;Meškiukų;9685389270;Ne;0;9;0;9
12175;Vėtrungė;Meškiukų;9313438768;Ne;0;8;0;8
12176;Vėtrungė;Meškiukų;2520926439;Ne;2;1;0;3
12177;Vėtrungė;Meškiukų;7143997258;Ne;0;1;0;1
12178;Vėtrungė;Meškiukų;8961791293;Ne;0;15;0;15
12179;Vėtrungė;Meškiukų;2809555356;Ne;0;9;0;9
12180;Vėtrungė;Meškiukų;4624264759;Ne;0;5;0;5
12181;Vėtrungė;Meškiukų;1766599777;Ne;0;7;0;7
12182;Vėtrungė;Meškiukų;9642541034;Ne;0;1;3;4
12183;Vėtrungė;Meškiukų;8958748086;Ne;5;1;0;6
12184;Vėtrungė;Meškiukų;1480035015;Ne;4;0;0;4
12185;Vėtrungė;Ąžuoliukų;8775969909;Ne;4;0;1;5
12186;Vėtrungė;Ąžuoliukų;1034537691;Ne;0;0;5;5
12187;Vėtrungė;Ąžuoliukų;7568316390;Ne;5;0;2;7
12188;Vėtrungė;Ąžuoliukų;3938684888;Ne;6;0;4;10
12189;Vėtrungė;Ąžuoliukų;2977116563;Ne;5;0;0;5
12190;Vėtrungė;Ąžuoliukų;4925843510;Ne;15;0;3;18
12191;Vėtrungė;Ąžuoliukų;7096106273;Ne;0;0;11;11
12192;Vėtrungė;Ąžuoliukų;6476717645;Ne;5;0;6;11
12193;Vėtrungė;Ąžuoliukų;5167580818;Taip;7;0;0;7
12194;Vėtrungė;Ąžuoliukų;1169648551;Ne;2;0;3;5
12195;Vilnelė;Lakštutė;8843094480;Ne;6;2;1;9
12196;Vilnelė;Lakštutė;5786086401;Ne;2;8;0;10
12197;Vilnelė;Lakštutė;6249731759;Ne;0;13;0;13
12198;Vilnelė;Lakštutė;6837850601;Ne;0;3;0;3
12199;Vilnelė;Lakštutė;5554451335;Ne;10;4;0;14
12200;Vilnelė;Lakštutė;1762024490;Ne;7;0;0;7
12201;Vilnelė;Lakštutė;8201829887;Ne;0;5;0;5
12202;Vilnelė;Lakštutė;7702217893;Ne;0;0;2;2
12203;Vilnelė;Lakštutė;4427383755;Ne;0;6;0;6
12204;Vilnelė;Lakštutė;1547117566;Ne;0;6;0;6
12205;Vilnelė;Lakštutė;3231387543;Ne;9;1;0;10
12206;Vilnelė;Lakštutė;8837662451;Ne;0;4;0;4
12207;Vilnelė;Lakštutė;3900484348;Ne;0;3;0;3
12208;Vilnelė;Lakštutė;5498574366;Ne;0;6;0;6
12209;Vilnelė;Lakštutė;3032273912;Ne;0;9;0;9
12210;Vilnelė;Lakštutė;4017436910;Ne;2;2;2;6
12211;Vilnelė;Lakštutė;6156838553;Ne;3;10;1;14
12212;Vilnelė;Lakštutė;9843449060;Ne;10;0;1;11
12213;Vilnelė;Lakštutė;2803880424;Ne;0;2;2;4
12214;Vilnelė;Lakštutė;2418216191;Ne;9;0;0;9
12215;Vilnelė;Lakštutė;5913967803;Ne;24;0;0;24
12216;Vilnelė;Vyturėlis;5091272908;Ne;0;2;2;4
12217;Vilnelė;Vyturėlis;1133945467;Ne;0;2;2;4
12218;Vilnelė;Vyturėlis;3009064105;Ne;0;1;0;1
12219;Vilnelė;Vyturėlis;2131599015;Ne;0;6;0;6
12220;Vilnelė;Vyturėlis;18740103706;Ne;0;3;0;3
12221;Vilnelė;Vyturėlis;7057183482;Ne;7;0;1;8
12222;Vilnelė;Vyturėlis;8725191514;Ne;0;2;2;4
12223;Vilnelė;Vyturėlis;6308015852;Ne;3;4;0;7
12224;Vilnelė;Vyturėlis;7963783957;Ne;4;0;0;4
12225;Vilnelė;Vyturėlis;1545570307;Ne;0;0;1;1
12226;Vilnelė;Vyturėlis;5540359276;Ne;3;2;7;12
12227;Vilnelė;Vyturėlis;1966090625;Ne;5;1;0;6
12228;Vilnelė;Vyturėlis;8740717061;Ne;8;1;0;9
12229;Vilnelė;Vyturėlis;3772263873;Ne;1;2;1;4
12230;Vilnelė;Vyturėlis;9183391434;Ne;0;1;0;1
12231;Vilnelė;Vyturėlis;2159103903;Ne;0;6;0;6
12232;Vilnelė;Vyturėlis;9369955153;Ne;4;11;0;15
12233;Vilnelė;Vyturėlis;5558584030;Ne;0;2;2;4
12234;Vilnelė;Vyturėlis;1151879281;Ne;0;4;0;4
12235;Vilnelė;Vyturėlis;8820091584;Ne;0;0;3;3
12236;Vilnelė;Vyturėlis;8270866998;Ne;0;9;0;9
12237;Vilnelė;Vyturėlis;3454141069;Ne;0;7;0;7
12238;Vilnelė;Vyturėlis;28447690974;Ne;0;7;0;7
12239;Vilnelė;Vyturėlis;1462397783;Ne;0;7;0;7
12240;Vilnelė;Pagrandukas;5508759323;Ne;0;3;0;3
12241;Vilnelė;Pagrandukas;2144925171;Ne;0;1;10;11
12242;Vilnelė;Pagrandukas;4295816753;Ne;0;9;0;9
12243;Vilnelė;Pagrandukas;3844066232;Ne;0;10;0;10
12244;Vilnelė;Pagrandukas;6659537454;Ne;5;1;0;6
12245;Vilnelė;Pagrandukas;5953205533;Ne;0;22;0;22
12246;Vilnelė;Pagrandukas;4448413194;Ne;5;1;2;8
12247;Vilnelė;Pagrandukas;6830433856;Ne;6;1;0;7
12248;Vilnelė;Pagrandukas;4664946923;Ne;6;0;0;6
12249;Vilnelė;Pagrandukas;6982847450;Ne;0;2;1;3
12250;Vilnelė;Pagrandukas;7560124407;Ne;0;0;9;9
12251;Vilnelė;Pagrandukas;3685294539;Ne;8;0;0;8
12252;Vilnelė;Pagrandukas;4931943297;Ne;0;13;0;13
12253;Vilnelė;Pagrandukas;7882756938;Ne;0;4;0;4
12254;Vilnelė;Pagrandukas;7348404699;Ne;3;0;0;3
12255;Vilnelė;Pagrandukas;3323738649;Ne;0;1;0;1
12256;Vilnelė;Pagrandukas;8116613831;Ne;6;3;0;9
12257;Vilnelė;Pagrandukas;9489760844;Ne;0;6;0;6
12258;Vilnelė;Pagrandukas;6466321228;Ne;7;2;0;9
12259;Vilnelė;Pagrandukas;4478847902;Ne;8;4;0;12
12260;Vilnelė;Pagrandukas;9635159885;Ne;5;1;0;6
12261;Vilnelė;Pagrandukas;6448119003;Ne;0;3;0;3
12262;Vilnelė;Pagrandukas;2165389724;Ne;8;0;0;8
12263;Vilnelė;Bitutė;2121071276;Ne;0;0;1;1
12264;Vilnelė;Bitutė;7387394504;Ne;6;6;0;12
12265;Vilnelė;Bitutė;8593060923;Ne;3;3;0;6
12266;Vilnelė;Bitutė;1882520335;Ne;0;1;0;1
12267;Vilnelė;Bitutė;85074719873;Ne;0;0;1;1
12268;Vilnelė;Bitutė;2990112955;Ne;0;1;1;2
12269;Vilnelė;Bitutė;6318246517;Ne;0;7;0;7
12270;Vilnelė;Bitutė;1281521052;Ne;0;9;0;9
12271;Vilnelė;Bitutė;9058632601;Ne;0;10;0;10
12272;Vilnelė;Bitutė;8615257084;Ne;0;0;1;1
12273;Vilnelė;Bitutė;98028664140;Ne;9;0;0;9
12274;Vilnelė;Bitutė;1507865281;Ne;5;0;0;5
12275;Vilnelė;Bitutė;2130482375;Ne;0;2;0;2
12276;Vilnelė;Bitutė;7292043157;Ne;6;1;0;7
12277;Vilnelė;Bitutė;4480175299;Ne;0;5;0;5
12278;Vilnelė;Bitutė;39494954188;Ne;0;14;0;14
12279;Vilnelė;Bitutė;6327531229;Ne;0;0;2;2
12280;Vilnelė;Bitutė;42835212158;Ne;0;10;0;10
12281;Vilnelė;Bitutė;6146514112;Ne;9;0;0;9
12282;Vilnelė;Bitutė;5932200003;Ne;0;2;0;2
12283;Vilnelė;Bitutė;1783854203;Ne;3;0;0;3
12284;Vilnelė;Bitutė;9016832316;Ne;0;0;3;3
12285;Vilnelė;Bitutė;6155522893;Ne;8;0;0;8
12286;Vilnelė;Šaltinėlis;7752502124;Ne;21;0;0;21
12287;Vilnelė;Šaltinėlis;3064118212;Ne;2;0;1;3
12288;Vilnelė;Šaltinėlis;5813090771;Ne;7;0;0;7
12289;Vilnelė;Šaltinėlis;9317041585;Ne;17;0;1;18
12290;Vilnelė;Šaltinėlis;4817502971;Ne;7;0;3;10
12291;Vilnelė;Šaltinėlis;3712463891;Ne;20;0;0;20
12292;Vilnelė;Šaltinėlis;2343750614;Ne;0;0;2;2
12293;Vilnelė;Šaltinėlis;2700153185;Ne;0;0;4;4
12294;Vilnelė;Šaltinėlis;7698638698;Ne;0;0;2;2
12295;Vilnelė;Šaltinėlis;7231998656;Ne;22;0;0;22
12296;Vilnelė;Šaltinėlis;2683662906;Ne;0;0;1;1
12297;Vilnelė;Šaltinėlis;3142594542;Ne;0;1;0;1
12298;Vilnelė;Šaltinėlis;4982137749;Ne;5;0;0;5
12299;Vilnelė;Šaltinėlis;5487729159;Ne;20;0;0;20
12300;Vilnelė;Šaltinėlis;1108529953;Ne;17;0;0;17
12301;Vilnelė;Riešutėllis;1027463000;Ne;0;2;0;2
12302;Vilnelė;Riešutėllis;7020707723;Ne;11;10;0;21
12303;Vilnelė;Riešutėllis;4203549404;Ne;3;0;1;4
12304;Vilnelė;Riešutėllis;3290952017;Ne;0;3;0;3
12305;Vilnelė;Riešutėllis;8588430578;Ne;0;7;0;7
12306;Vilnelė;Riešutėllis;7957695470;Ne;0;7;1;8
12307;Vilnelė;Riešutėllis;8750705826;Ne;9;0;1;10
12308;Vilnelė;Riešutėllis;4780827432;Ne;2;2;1;5
12309;Vilnelė;Riešutėllis;4455099179;Ne;10;8;0;18
12310;Vilnelė;Riešutėllis;2367127222;Ne;11;1;0;12
12311;Vilnelė;Riešutėllis;5306723959;Ne;5;5;0;10
12312;Vilnelė;Riešutėllis;3670613082;Ne;0;4;13;17
12313;Vilnelė;Riešutėllis;6417545510;Ne;1;1;0;2
12314;Vilnelė;Riešutėllis;7085972543;Ne;5;0;0;5
12315;Vilnelė;Riešutėllis;3211657057;Ne;0;4;0;4
12316;Vilnelė;Riešutėllis;9016866597;Ne;11;9;0;20
12317;Vilnelė;Riešutėllis;7087798406;Ne;1;5;7;13
12318;Vilnelė;Riešutėllis;4254744025;Ne;7;16;0;23
12319;Vilnelė;Riešutėllis;3730997665;Ne;6;3;2;11
12320;Vilnelė;Riešutėllis;2706699572;Ne;9;0;0;9
12321;Vilnelė;Riešutėllis;8774842903;Ne;3;2;1;6
12322;Vilnelė;Nykštukas;4210511566;Taip;2;0;0;2
12323;Vilnelė;Nykštukas;2891787022;Ne;0;1;0;1
12324;Vilnelė;Nykštukas;4734511521;Ne;6;6;0;12
12325;Vilnelė;Nykštukas;6344134620;Ne;0;4;1;5
12326;Vilnelė;Nykštukas;4295630317;Ne;0;32;0;32
12327;Vilnelė;Nykštukas;1554473199;Ne;1;5;0;6
12328;Vilnelė;Nykštukas;1819154122;Ne;4;6;0;10
12329;Vilnelė;Nykštukas;4060927733;Ne;8;12;0;20
12330;Vilnelė;Nykštukas;2299381653;Ne;0;28;0;28
12331;Vilnelė;Nykštukas;5041031750;Ne;0;1;0;1
12332;Vilnelė;Nykštukas;2157793186;Ne;7;0;3;10
12333;Vilnelė;Nykštukas;4516818999;Ne;0;18;0;18
12334;Vilnelė;Nykštukas;8579294202;Ne;0;18;0;18
12335;Vilnelė;Nykštukas;7161529969;Ne;0;7;0;7
12336;Vilnelė;Nykštukas;3720979747;Ne;10;0;0;10
12337;Vilnelė;Nykštukas;8493390146;Ne;0;2;0;2
12338;Vilnelė;Nykštukas;6048991617;Ne;2;0;0;2
12339;Vilnelė;Nykštukas;6054488692;Ne;2;0;0;2
12340;Vilnelė;Nykštukas;8630048961;Ne;8;9;0;17
12341;Vilnelė;Nykštukas;7592040226;Ne;9;16;0;25
12342;Vilnelė;Nykštukas;1515873552;Ne;8;1;0;9
12343;Vilnelė;Nykštukas;5629086127;Ne;8;2;0;10
12344;Vilnelė;Pieštukas;9879688569;Ne;4;3;0;7
12345;Vilnelė;Pieštukas;5473379559;Ne;0;2;0;2
12346;Vilnelė;Pieštukas;3781595939;Ne;0;6;0;6
12347;Vilnelė;Pieštukas;9884955712;Ne;2;4;0;6
12348;Vilnelė;Pieštukas;2479090686;Ne;0;5;0;5
12349;Vilnelė;Pieštukas;3945921490;Ne;0;12;0;12
12350;Vilnelė;Pieštukas;1975954784;Ne;9;6;0;15
12351;Vilnelė;Pieštukas;1730149127;Ne;0;9;0;9
12352;Vilnelė;Pieštukas;5778176840;Ne;0;4;0;4
12353;Vilnelė;Pieštukas;6355912551;Ne;0;11;0;11
12354;Vilnelė;Pieštukas;7976798775;Ne;0;4;0;4
12355;Vilnelė;Pieštukas;3811289758;Ne;0;12;0;12
12356;Vilnelė;Pieštukas;3529718234;Ne;0;1;0;1
12357;Vilnelė;Pieštukas;1880318663;Ne;10;1;0;11
12358;Vilnelė;Pieštukas;9589410276;Ne;10;1;0;11
12359;Vilnelė;Pieštukas;4718994967;Ne;0;9;0;9
12360;Vilnelė;Pieštukas;8092642447;Ne;0;7;0;7
12361;Vilnelė;Pieštukas;3856917286;Ne;0;19;0;19
12362;Vilnelė;Pieštukas;6132739519;Ne;0;9;0;9
12363;Vilnelė;Pieštukas;8162191913;Ne;9;0;0;9
12364;Vilnelė;Pieštukas;3791258264;Ne;0;3;0;3
12365;Vilnelė;Voverytė;7536603663;Ne;0;2;4;6
12366;Vilnelė;Voverytė;3503461211;Ne;0;3;0;3
12367;Vilnelė;Voverytė;7388336851;Ne;0;7;0;7
12368;Vilnelė;Voverytė;8667403338;Ne;0;6;0;6
12369;Vilnelė;Voverytė;7883724600;Ne;0;7;0;7
12370;Vilnelė;Voverytė;1351798589;Ne;5;1;0;6
12371;Vilnelė;Voverytė;6342242777;Ne;0;4;0;4
12372;Vilnelė;Voverytė;3843064564;Ne;0;0;3;3
12373;Vilnelė;Voverytė;3558073399;Ne;0;0;1;1
12374;Vilnelė;Voverytė;2923012145;Ne;0;10;0;10
12375;Vilnelė;Voverytė;2841315531;Ne;0;0;6;6
12376;Vilnelė;Voverytė;9804772168;Ne;0;0;9;9
12377;Vilnelė;Voverytė;1596625263;Ne;0;0;1;1
12378;Vilnelė;Voverytė;7338573817;Ne;8;0;4;12
12379;Vilnelė;Voverytė;8121075430;Ne;0;3;0;3
12380;Vilnelė;Voverytė;1574809879;Ne;14;0;0;14
12381;Vilnelė;Voverytė;6083082959;Ne;0;1;0;1
12382;Vilnelė;Voverytė;2788449626;Ne;0;4;0;4
12383;Vilnelė;Kodėlčiukas;4642378600;Ne;15;0;0;15
12384;Vilnelė;Kodėlčiukas;6618109352;Ne;0;12;0;12
12385;Vilnelė;Kodėlčiukas;6715997340;Ne;10;1;0;11
12386;Vilnelė;Kodėlčiukas;9482133396;Ne;4;0;0;4
12387;Vilnelė;Kodėlčiukas;8620789304;Ne;12;0;0;12
12388;Vilnelė;Kodėlčiukas;8439505238;Ne;0;5;0;5
12389;Vilnelė;Kodėlčiukas;1580287517;Ne;0;4;0;4
12390;Vilnelė;Kodėlčiukas;5558378376;Ne;5;0;0;5
12391;Vilnelė;Kodėlčiukas;4328263940;Ne;14;3;0;17
12392;Vilnelė;Kodėlčiukas;3056845279;Ne;0;6;0;6
12393;Vilnelė;Kodėlčiukas;9537740492;Ne;10;0;0;10
12394;Vilnelė;Kodėlčiukas;9640330864;Ne;10;5;0;15
12395;Vilnelė;Kodėlčiukas;3848720970;Ne;5;0;7;12
12396;Vilnelė;Kodėlčiukas;7833531435;Ne;0;1;0;1
12397;Vilnelė;Kodėlčiukas;5961910077;Ne;8;0;0;8
12398;Vilnelė;Kodėlčiukas;3115242919;Ne;7;1;0;8
12399;Vilnelė;Kodėlčiukas;8543995029;Taip;0;12;0;12
12400;Vilnelė;Kodėlčiukas;1933660272;Ne;6;0;1;7
12401;Vilnelė;Kodėlčiukas;4986079102;Ne;5;0;0;5
12402;Vilnelė;Kodėlčiukas;5398303580;Ne;0;1;0;1
12403;Vilnelė;Kodėlčiukas;9418661965;Ne;6;2;1;9
12404;Vilnelė;Kodėlčiukas;5180951251;Ne;9;0;0;9
12405;Vilnelė;Žirniukas;2576381995;Ne;0;0;2;2
12406;Vilnelė;Žirniukas;3654833067;Ne;9;0;0;9
12407;Vilnelė;Žirniukas;4322462166;Ne;9;0;0;9
12408;Vilnelė;Žirniukas;9817054571;Ne;12;0;0;12
12409;Vilnelė;Žirniukas;9316933315;Ne;7;1;0;8
12410;Vilnelė;Žirniukas;1598555488;Ne;0;7;0;7
12411;Vilnelė;Žirniukas;5960725916;Ne;7;1;0;8
12412;Vilnelė;Žirniukas;8329253118;Ne;0;0;22;22
12413;Vilnelė;Žirniukas;9476510950;Ne;0;2;4;6
12414;Vilnelė;Žirniukas;3234028667;Ne;5;2;3;10
12415;Vilnelė;Žirniukas;7870509810;Taip;4;0;0;4
12416;Vilnelė;Žirniukas;6569980514;Ne;8;5;0;13
12417;Vilnelė;Žirniukas;6634526716;Ne;0;13;0;13
12418;Vilnelė;Žirniukas;8848138564;Ne;5;0;0;5
12419;Vilnelė;Žirniukas;5649725693;Ne;0;2;1;3
12420;Vilnelė;Žirniukas;7568755715;Ne;5;2;0;7
12421;Vilnelė;Žirniukas;1371066506;Ne;5;0;0;5
12422;Vilnelė;Žirniukas;4758117005;Taip;5;2;0;7
12423;Vilnelė;Pipiras;1414168531;Ne;4;0;0;4
12424;Vilnelė;Pipiras;3432602015;Ne;5;2;0;7
12425;Vilnelė;Pipiras;9660305163;Ne;0;6;0;6
12426;Vilnelė;Pipiras;2964672357;Ne;11;1;0;12
12427;Vilnelė;Pipiras;1566734465;Ne;0;5;0;5
12428;Vilnelė;Pipiras;9882766915;Ne;0;11;0;11
12429;Vilnelė;Pipiras;9016135318;Ne;7;0;0;7
12430;Vilnelė;Pipiras;8015908754;Ne;9;3;0;12
12431;Vilnelė;Pipiras;7968029402;Ne;13;0;0;13
12432;Vilnelė;Pipiras;7221712624;Ne;13;0;0;13
12433;Vilnelė;Pipiras;9950598582;Taip;0;1;6;7
12434;Vilnelė;Pipiras;5444967820;Ne;10;0;0;10
12435;Vilnelė;Pipiras;3828623778;Ne;10;0;0;10
12436;Vilnelė;Pipiras;5273665901;Ne;15;0;0;15
12437;Vilnelė;Pipiras;5173602064;Ne;0;1;0;1
12438;Vėrinėlis;GAIDELIAI;7069247393;Ne;5;0;0;5
12439;Vėrinėlis;GAIDELIAI;6162461750;Ne;5;0;0;5
12440;Vėrinėlis;GAIDELIAI;3500287869;Ne;25;0;0;25
12441;Vėrinėlis;GAIDELIAI;9370715798;Ne;0;5;0;5
12442;Vėrinėlis;GAIDELIAI;6500266853;Ne;12;0;2;14
12443;Vėrinėlis;GAIDELIAI;5891690000;Ne;12;0;1;13
12444;Vėrinėlis;GAIDELIAI;4401001009;Ne;5;6;0;11
12445;Vėrinėlis;GAIDELIAI;4498096701;Ne;10;0;0;10
12446;Vėrinėlis;GAIDELIAI;6055921178;Ne;0;9;0;9
12447;Vėrinėlis;GAIDELIAI;9144004655;Ne;7;0;0;7
12448;Vėrinėlis;GAIDELIAI;8272531606;Ne;6;0;0;6
12449;Vėrinėlis;GAIDELIAI;2114637828;Ne;0;1;0;1
12450;Vėrinėlis;GAIDELIAI;6159725406;Ne;6;0;1;7
12451;Vėrinėlis;GAIDELIAI;1844862699;Ne;0;0;1;1
12452;Vėrinėlis;GAIDELIAI;7455948332;Ne;0;8;0;8
12453;Vėrinėlis;GAIDELIAI;4965735537;Ne;0;0;7;7
12454;Vėrinėlis;SAULUTĖ;7224418233;Ne;12;0;1;13
12455;Vėrinėlis;SAULUTĖ;9612956692;Ne;0;4;0;4
12456;Vėrinėlis;SAULUTĖ;8238013636;Ne;5;0;0;5
12457;Vėrinėlis;SAULUTĖ;2337883071;Ne;9;0;5;14
12458;Vėrinėlis;SAULUTĖ;6913001318;Ne;0;2;0;2
12459;Vėrinėlis;SAULUTĖ;3882915774;Ne;0;14;0;14
12460;Vėrinėlis;SAULUTĖ;7440020169;Ne;10;6;0;16
12461;Vėrinėlis;SAULUTĖ;7913975075;Ne;0;9;0;9
12462;Vėrinėlis;SAULUTĖ;9967737864;Ne;0;2;0;2
12463;Vėrinėlis;SAULUTĖ;9009344779;Ne;0;14;0;14
12464;Vėrinėlis;SAULUTĖ;4059906525;Ne;6;0;0;6
12465;Vėrinėlis;SAULUTĖ;3832662507;Ne;0;1;0;1
12466;Vėrinėlis;SAULUTĖ;1007705906;Ne;8;1;0;9
12467;Vėrinėlis;SAULUTĖ;5942475043;Ne;0;7;0;7
12468;Vėrinėlis;SAULUTĖ;9310629340;Ne;0;0;1;1
12469;Vėrinėlis;SAULUTĖ;2369434537;Ne;0;4;0;4
12470;Vėrinėlis;NYKŠTUKAI;8755231814;Ne;0;0;10;10
12471;Vėrinėlis;NYKŠTUKAI;9604483237;Ne;0;0;3;3
12472;Vėrinėlis;NYKŠTUKAI;6220653152;Ne;0;4;0;4
12473;Vėrinėlis;NYKŠTUKAI;7981261038;Ne;0;2;0;2
12474;Vėrinėlis;NYKŠTUKAI;1395590011;Ne;10;2;3;15
12475;Vėrinėlis;NYKŠTUKAI;3975934329;Ne;0;7;2;9
12476;Vėrinėlis;NYKŠTUKAI;5511584499;Ne;0;3;2;5
12477;Vėrinėlis;NYKŠTUKAI;4958359640;Ne;11;0;0;11
12478;Vėrinėlis;NYKŠTUKAI;4089567420;Ne;0;0;1;1
12479;Vėrinėlis;NYKŠTUKAI;8579819581;Ne;0;9;0;9
12480;Vėrinėlis;NYKŠTUKAI;5209398043;Ne;0;8;0;8
12481;Vėrinėlis;NYKŠTUKAI;8824435889;Ne;6;0;3;9
12482;Vėrinėlis;BURATINAS;7093959212;Ne;0;11;0;11
12483;Vėrinėlis;BURATINAS;8100283579;Ne;0;7;0;7
12484;Vėrinėlis;BURATINAS;4666918175;Ne;0;9;0;9
12485;Vėrinėlis;BURATINAS;2774618380;Ne;0;7;0;7
12486;Vėrinėlis;BURATINAS;5429955166;Ne;0;16;0;16
12487;Vėrinėlis;BURATINAS;5429372946;Ne;0;10;0;10
12488;Vėrinėlis;BURATINAS;2467700639;Ne;5;25;0;30
12489;Vėrinėlis;BURATINAS;6136232912;Ne;0;18;0;18
12490;Vėrinėlis;BURATINAS;7092421890;Ne;0;3;0;3
12491;Vėrinėlis;BURATINAS;6058712578;Ne;0;9;0;9
12492;Vėrinėlis;BURATINAS;1164396960;Ne;2;6;0;8
12493;Vėrinėlis;BURATINAS;6413701823;Ne;0;1;0;1
12494;Vėrinėlis;BURATINAS;2364117224;Ne;0;14;0;14
12495;Vėrinėlis;BURATINAS;3947650381;Ne;0;26;0;26
12496;Vėrinėlis;GINTARĖLIAI;8372084728;Ne;12;3;0;15
12497;Vėrinėlis;GINTARĖLIAI;7432965615;Ne;3;1;1;5
12498;Vėrinėlis;GINTARĖLIAI;3457199716;Ne;3;2;2;7
12499;Vėrinėlis;GINTARĖLIAI;7743951577;Taip;11;0;1;12
12500;Vėrinėlis;GINTARĖLIAI;2006432327;Ne;3;0;0;3
12501;Vėrinėlis;GINTARĖLIAI;6785519869;Taip;7;0;0;7
12502;Vėrinėlis;GINTARĖLIAI;3363388500;Ne;3;8;0;11
12503;Vėrinėlis;GINTARĖLIAI;1872534206;Taip;0;4;0;4
12504;Vėrinėlis;GINTARĖLIAI;8545392429;Ne;8;0;2;10
12505;Vėrinėlis;GINTARĖLIAI;9171173116;Ne;5;2;0;7
12506;Vėrinėlis;GINTARĖLIAI;3192625484;Ne;0;0;1;1
12507;Vėrinėlis;GINTARĖLIAI;8343196405;Ne;19;2;2;23
12508;Vėrinėlis;GINTARĖLIAI;2284527544;Ne;2;3;0;5
12509;Vėrinėlis;GINTARĖLIAI;5644772729;Ne;0;2;2;4
12510;Vėrinėlis;GINTARĖLIAI;4034106321;Ne;5;0;0;5
12511;Vėrinėlis;RAMUNĖLĖS;8620836106;Ne;19;0;0;19
12512;Vėrinėlis;RAMUNĖLĖS;5003344894;Taip;0;1;0;1
12513;Vėrinėlis;RAMUNĖLĖS;5434506594;Ne;13;2;0;15
12514;Vėrinėlis;RAMUNĖLĖS;1047139776;Ne;0;3;0;3
12515;Vėrinėlis;RAMUNĖLĖS;3130841241;Taip;0;10;0;10
12516;Vėrinėlis;RAMUNĖLĖS;9798993200;Ne;0;1;0;1
12517;Vėrinėlis;RAMUNĖLĖS;4728119881;Ne;6;1;0;7
12518;Vėrinėlis;KODELČIUKŲ;7070058961;Ne;0;7;0;7
12519;Vėrinėlis;KODELČIUKŲ;3308843618;Ne;0;12;0;12
12520;Vėrinėlis;KODELČIUKŲ;1535567719;Ne;0;21;0;21
12521;Vėrinėlis;KODELČIUKŲ;8755941866;Ne;0;1;1;2
12522;Vėrinėlis;KODELČIUKŲ;9686481278;Ne;0;4;3;7
12523;Vėrinėlis;KODELČIUKŲ;42298331453;Ne;0;10;0;10
12524;Vėrinėlis;KODELČIUKŲ;8709714647;Ne;0;3;2;5
12525;Vėrinėlis;KODELČIUKŲ;6108187043;Ne;0;9;0;9
12526;Vėrinėlis;KODELČIUKŲ;9119967823;Ne;0;6;3;9
12527;Vėrinėlis;KODELČIUKŲ;4067153819;Ne;0;0;1;1
12528;Vėrinėlis;KODELČIUKŲ;5712568063;Ne;0;1;0;1
12529;Vėrinėlis;KODELČIUKŲ;1467899937;Ne;0;11;0;11
12530;Vėrinėlis;KODELČIUKŲ;8885866108;Ne;0;5;2;7
12531;Vėrinėlis;KODELČIUKŲ;7634939364;Ne;10;4;0;14
12532;Vėrinėlis;KODELČIUKŲ;3049346950;Ne;7;0;12;19
12533;Vėrinėlis;KODELČIUKŲ;8652292752;Ne;2;3;1;6
12534;Vėrinėlis;KODELČIUKŲ;3729926575;Ne;10;0;1;11
12535;Vėrinėlis;KODELČIUKŲ;7167034587;Ne;0;9;0;9
12536;Vėrinėlis;KODELČIUKŲ;3369668445;Ne;0;7;0;7
12537;Vėrinėlis;KODELČIUKŲ;8728166391;Ne;3;0;5;8
12538;Vėrinėlis;KODELČIUKŲ;5720076968;Ne;10;0;2;12
12539;Vėrinėlis;KODELČIUKŲ;8195455092;Ne;0;1;1;2
12540;Vėrinėlis;ŽIRNIUKAI;1769852084;Ne;10;0;2;12
12541;Vėrinėlis;ŽIRNIUKAI;8329989952;Ne;2;0;4;6
12542;Vėrinėlis;ŽIRNIUKAI;4752902173;Ne;0;3;0;3
12543;Vėrinėlis;ŽIRNIUKAI;7237945125;Ne;0;6;1;7
12544;Vėrinėlis;ŽIRNIUKAI;1736733257;Ne;0;0;4;4
12545;Vėrinėlis;ŽIRNIUKAI;2633143128;Ne;0;0;6;6
12546;Vėrinėlis;ŽIRNIUKAI;9419245081;Ne;0;1;3;4
12547;Vėrinėlis;ŽIRNIUKAI;7817387800;Ne;0;0;1;1
12548;Vėrinėlis;ŽIRNIUKAI;6377447141;Ne;6;0;7;13
12549;Vėrinėlis;ŽIRNIUKAI;7371908331;Ne;6;0;8;14
12550;Vėrinėlis;ŽIRNIUKAI;6392625405;Ne;0;9;4;13
12551;Vėrinėlis;ŽIRNIUKAI;1896980533;Ne;6;0;1;7
12552;Vėrinėlis;ŽIRNIUKAI;2732572235;Ne;0;0;2;2
12553;Vėrinėlis;ŽIRNIUKAI;8483525051;Ne;0;0;1;1
12554;Vėrinėlis;VARPELIAI;7416041207;Ne;0;1;0;1
12555;Vėrinėlis;VARPELIAI;8655158155;Ne;0;7;0;7
12556;Vėrinėlis;VARPELIAI;6177784856;Ne;0;4;0;4
12557;Vėrinėlis;VARPELIAI;9388153932;Ne;0;0;16;16
12558;Vėrinėlis;VARPELIAI;6362125404;Ne;0;3;0;3
12559;Vėrinėlis;VARPELIAI;9599724421;Ne;0;1;0;1
12560;Vėrinėlis;VARPELIAI;7216867683;Ne;0;7;0;7
12561;Vėrinėlis;VARPELIAI;8336694468;Ne;5;2;0;7
12562;Vėrinėlis;VARPELIAI;2731207996;Ne;6;0;4;10
12563;Vėrinėlis;VARPELIAI;9522506115;Ne;0;10;0;10
12564;Vėrinėlis;VARPELIAI;2625930005;Ne;4;0;3;7
12565;Vėrinėlis;VARPELIAI;2561255096;Ne;2;0;0;2
12566;Vėrinėlis;VARPELIAI;5821107898;Ne;11;0;1;12
12567;Vėrinėlis;VARPELIAI;3392458614;Ne;7;2;0;9
12568;Vėrinėlis;VARPELIAI;5447760434;Ne;0;2;0;2
12569;Vėrinėlis;BORUŽĖLĖS;8759487574;Ne;0;3;0;3
12570;Vėrinėlis;BORUŽĖLĖS;4819016753;Ne;0;3;0;3
12571;Vėrinėlis;BORUŽĖLĖS;1910385020;Ne;0;2;0;2
12572;Vėrinėlis;BORUŽĖLĖS;3934652683;Ne;17;0;0;17
12573;Vėrinėlis;BORUŽĖLĖS;6904733283;Ne;13;1;1;15
12574;Vėrinėlis;BORUŽĖLĖS;4446546335;Ne;7;0;0;7
12575;Vėrinėlis;BORUŽĖLĖS;3718510933;Ne;17;0;0;17
12576;Vėrinėlis;BORUŽĖLĖS;8904833339;Ne;0;6;0;6
12577;Vėrinėlis;BORUŽĖLĖS;3312501759;Ne;0;6;0;6
12578;Vėrinėlis;BORUŽĖLĖS;9217188911;Ne;10;8;0;18
12579;Vėrinėlis;BORUŽĖLĖS;7414937335;Ne;0;8;0;8
12580;Vėrinėlis;BORUŽĖLĖS;2574507205;Ne;0;8;0;8
12581;Vėrinėlis;BORUŽĖLĖS;4852563692;Ne;0;0;3;3
12582;Vėrinėlis;BORUŽĖLĖS;5865529907;Ne;5;0;1;6
12583;Vėrinėlis;BORUŽĖLĖS;9613642664;Ne;0;6;0;6
12584;Vėrinėlis;BORUŽĖLĖS;2467242845;Ne;0;9;0;9
12585;Vėrinėlis;SVEIKUOLIAI;1909742394;Ne;0;4;0;4
12586;Vėrinėlis;SVEIKUOLIAI;6176308531;Ne;10;0;0;10
12587;Vėrinėlis;SVEIKUOLIAI;3070965434;Ne;0;1;0;1
12588;Vėrinėlis;SVEIKUOLIAI;3563114419;Ne;8;0;0;8
12589;Vėrinėlis;SVEIKUOLIAI;3973272659;Ne;0;9;0;9
12590;Vėrinėlis;SVEIKUOLIAI;6504377326;Ne;0;1;0;1
12591;Vėrinėlis;SVEIKUOLIAI;8716965452;Ne;0;2;0;2
12592;Vėrinėlis;SVEIKUOLIAI;7584124339;Ne;8;1;0;9
12593;Vėrinėlis;SVEIKUOLIAI;9352630743;Ne;0;3;2;5
12594;Vėrinėlis;SVEIKUOLIAI;4859330774;Ne;0;1;0;1
12595;Vėrinėlis;SVEIKUOLIAI;8543081245;Ne;0;1;0;1
12596;Vėrinėlis;SVEIKUOLIAI;5614185158;Ne;0;1;2;3
12597;Vėrinėlis;SVEIKUOLIAI;5539714292;Taip;7;0;0;7
12598;Vėrinėlis;SVEIKUOLIAI;2516474825;Ne;2;0;1;3
12599;Vėrinėlis;SVEIKUOLIAI;9058127692;Ne;0;3;0;3
12600;Vėrinėlis;SVEIKUOLIAI;3084117432;Ne;3;0;0;3
12601;Vėrinėlis;SVEIKUOLIAI;2015928440;Ne;0;9;0;9
12602;Vėrinėlis;ŠIRDELĖS;7734163541;Ne;7;0;5;12
12603;Vėrinėlis;ŠIRDELĖS;7811024382;Ne;0;0;1;1
12604;Vėrinėlis;ŠIRDELĖS;4378592116;Ne;0;5;3;8
12605;Vėrinėlis;ŠIRDELĖS;7517113022;Ne;0;0;3;3
12606;Vėrinėlis;ŠIRDELĖS;1841277321;Ne;0;8;0;8
12607;Vėrinėlis;ŠIRDELĖS;5588658517;Ne;0;5;0;5
12608;Vėrinėlis;ŠIRDELĖS;5653635907;Ne;2;3;0;5
12609;Vėrinėlis;ŠIRDELĖS;1152010178;Ne;11;1;1;13
12610;Vėrinėlis;ŠIRDELĖS;2038169885;Ne;5;6;0;11
12611;Vėrinėlis;ŠIRDELĖS;9375922889;Ne;11;5;0;16
12612;Vėrinėlis;ŠIRDELĖS;5813009126;Ne;10;9;0;19
12613;Vėrinėlis;ŠIRDELĖS;3511809411;Ne;0;1;0;1
12614;Vėrinėlis;ŠIRDELĖS;3535652648;Ne;0;0;5;5
12615;Vėrinėlis;ŠIRDELĖS;9217815657;Ne;0;8;0;8
12616;Vėrinėlis;ŠIRDELĖS;4403875733;Ne;2;0;1;3
12617;Vėrinėlis;ŠIRDELĖS;1939318286;Ne;0;3;0;3
12618;Vėrinėlis;ŠIRDELĖS;3687250255;Ne;2;6;0;8
12619;Vėrinėlis;ŠIRDELĖS;2847839917;Ne;13;9;0;22
12620;Vėrinėlis;ŠIRDELĖS;7311740859;Ne;0;1;0;1
12621;Vėrinėlis;ŠIRDELĖS;6905591549;Ne;12;3;0;15
12622;Viltenė;Drugeliai;3625763429;Ne;5;0;0;5
12623;Viltenė;Drugeliai;2392304909;Ne;11;0;0;11
12624;Viltenė;Drugeliai;5781655552;Ne;0;4;0;4
12625;Viltenė;Drugeliai;2410868015;Ne;0;18;0;18
12626;Viltenė;Drugeliai;6810811656;Ne;0;1;0;1
12627;Viltenė;Drugeliai;3905014810;Ne;0;11;0;11
12628;Viltenė;Drugeliai;4121448859;Ne;4;0;0;4
12629;Viltenė;Drugeliai;9157616307;Ne;0;1;0;1
12630;Viltenė;Drugeliai;9476132305;Ne;3;1;0;4
12631;Viltenė;Drugeliai;3052677157;Ne;0;1;0;1
12632;Viltenė;Drugeliai;5522245968;Ne;0;3;0;3
12633;Viltenė;Drugeliai;5552217000;Ne;16;0;0;16
12634;Viltenė;Drugeliai;9756519374;Ne;6;0;0;6
12635;Viltenė;Drugeliai;7928894276;Ne;0;1;0;1
12636;Viltenė;Drugeliai;8527270437;Ne;0;10;0;10
12637;Viltenė;Drugeliai;4195708756;Ne;0;14;0;14
12638;Viltenė;Drugeliai;1267187553;Ne;0;5;0;5
12639;Viltenė;Drugeliai;1081603034;Ne;0;19;0;19
12640;Viltenė;Drugeliai;7500965165;Ne;0;7;0;7
12641;Viltenė;Bitučių;2846574130;Ne;17;6;0;23
12642;Viltenė;Bitučių;8336855920;Taip;9;6;0;15
12643;Viltenė;Bitučių;2656363650;Ne;3;0;0;3
12644;Viltenė;Bitučių;2841144656;Ne;3;0;0;3
12645;Viltenė;Bitučių;7810374329;Ne;0;7;0;7
12646;Viltenė;Bitučių;7717223673;Ne;18;0;0;18
12647;Viltenė;Bitučių;4001205912;Ne;0;3;0;3
12648;Viltenė;Bitučių;7266522399;Ne;0;4;0;4
12649;Viltenė;Bitučių;8141954391;Ne;0;1;0;1
12650;Viltenė;Bitučių;4379784712;Ne;0;10;0;10
12651;Viltenė;Bitučių;9095458948;Ne;15;0;0;15
12652;Viltenė;Bitučių;4661430937;Ne;0;0;5;5
12653;Viltenė;Bitučių;5241075224;Ne;0;2;0;2
12654;Viltenė;Boružėlių;6642790962;Ne;3;1;0;4
12655;Viltenė;Boružėlių;3738838707;Ne;0;1;0;1
12656;Viltenė;Boružėlių;8473588098;Ne;0;11;0;11
12657;Viltenė;Boružėlių;3995418079;Ne;0;11;0;11
12658;Viltenė;Boružėlių;1399653129;Ne;5;2;0;7
12659;Viltenė;Boružėlių;7526555727;Ne;5;0;0;5
12660;Viltenė;Boružėlių;1936628249;Ne;0;5;0;5
12661;Viltenė;Boružėlių;7912396297;Ne;0;7;0;7
12662;Viltenė;Boružėlių;4036109404;Ne;0;6;0;6
12663;Viltenė;Boružėlių;4604298036;Ne;0;10;0;10
12664;Viltenė;Boružėlių;9197007374;Ne;5;0;0;5
12665;Viltenė;Boružėlių;9242034622;Ne;0;2;0;2
12666;Viltenė;Boružėlių;6621273812;Ne;0;3;0;3
12667;Viltenė;Boružėlių;2383607612;Ne;0;8;0;8
12668;Viltenė;Boružėlių;9597857664;Ne;1;0;0;1
12669;Viltenė;Boružėlių;1496943250;Ne;0;2;0;2
12670;Viltenė;Gandriukų;6481491422;Ne;0;0;6;6
12671;Viltenė;Gandriukų;2884698447;Ne;0;1;0;1
12672;Viltenė;Gandriukų;6060648988;Ne;0;1;0;1
12673;Viltenė;Gandriukų;1840626621;Ne;0;4;0;4
12674;Viltenė;Gandriukų;7796422726;Ne;0;1;0;1
12675;Viltenė;Gandriukų;2815105107;Ne;0;1;0;1
12676;Viltenė;Gandriukų;6511850468;Ne;27;0;0;27
12677;Viltenė;Gandriukų;4945108189;Ne;0;2;0;2
12678;Viltenė;Gandriukų;5850652322;Ne;0;7;0;7
12679;Viltenė;Gandriukų;1243595112;Ne;0;1;0;1
12680;Viltenė;Gandriukų;3073228245;Ne;9;0;13;22
12681;Viltenė;Gandriukų;4468743044;Ne;10;0;2;12
12682;Viltenė;Gandriukų;6355857716;Ne;10;0;5;15
12683;Viltenė;Gandriukų;5929135840;Ne;2;0;0;2
12684;Viltenė;Gandriukų;8458769051;Ne;0;8;0;8
12685;Viltenė;Aitvariukai;5083515613;Ne;0;1;0;1
12686;Viltenė;Aitvariukai;2137929911;Ne;0;8;0;8
12687;Viltenė;Aitvariukai;2036902795;Ne;4;0;0;4
12688;Viltenė;Aitvariukai;5599943846;Ne;0;8;0;8
12689;Viltenė;Aitvariukai;6721689684;Ne;5;0;0;5
12690;Viltenė;Aitvariukai;6296509460;Ne;0;4;0;4
12691;Viltenė;Aitvariukai;3908574248;Ne;0;11;0;11
12692;Viltenė;Aitvariukai;2976705872;Ne;0;3;0;3
12693;Viltenė;Aitvariukai;2026654467;Ne;0;7;0;7
12694;Viltenė;Aitvariukai;4641365031;Ne;0;7;0;7
12695;Viltenė;Aitvariukai;7277455268;Ne;0;18;0;18
12696;Viltenė;Aitvariukai;2786572522;Ne;2;0;0;2
12697;Viltenė;Aitvariukai;6171399579;Ne;8;2;0;10
12698;Viltenė;Geniukų;1822220265;Ne;2;2;0;4
12699;Viltenė;Geniukų;1423254631;Ne;0;5;0;5
12700;Viltenė;Geniukų;3002690526;Ne;0;3;0;3
12701;Viltenė;Geniukų;1054469254;Ne;1;1;0;2
12702;Viltenė;Geniukų;6063181025;Ne;0;1;0;1
12703;Viltenė;Geniukų;1672091332;Ne;0;2;0;2
12704;Viltenė;Geniukų;3018271511;Ne;0;3;0;3
12705;Viltenė;Geniukų;49998813869;Ne;0;5;0;5
12706;Viltenė;Geniukų;3389110405;Ne;0;3;0;3
12707;Viltenė;Geniukų;4319685140;Ne;0;1;0;1
12708;Viltenė;Geniukų;8125023386;Ne;0;8;0;8
12709;Viltenė;Geniukų;9035687504;Ne;0;1;0;1
12710;Viltenė;Geniukų;3746923185;Ne;0;11;0;11
12711;Viltenė;Geniukų;1557503831;Ne;0;4;0;4
12712;Viltenė;Saulutės;2044754943;Ne;0;5;0;5
12713;Viltenė;Saulutės;1615415742;Ne;0;7;0;7
12714;Viltenė;Saulutės;6664059418;Ne;0;6;0;6
12715;Viltenė;Saulutės;2141002432;Ne;0;8;0;8
12716;Viltenė;Saulutės;5024192785;Ne;5;1;0;6
12717;Viltenė;Saulutės;1918867591;Ne;0;7;0;7
12718;Viltenė;Saulutės;7559243300;Ne;0;11;0;11
12719;Viltenė;Saulutės;3560474943;Ne;2;3;0;5
12720;Viltenė;Saulutės;2840208662;Ne;4;0;0;4
12721;Viltenė;Saulutės;1252657362;Ne;0;4;0;4
12722;Viltenė;Saulutės;2559945034;Ne;0;1;0;1
12723;Viltenė;Saulutės;9055821628;Ne;0;3;0;3
12724;Viltenė;Saulutės;9858998005;Ne;0;3;0;3
12725;Viltenė;Saulutės;7726650894;Ne;3;5;0;8
12726;Viltenė;Saulutės;3709362712;Ne;0;2;0;2
12727;Viltenė;Saulutės;1841732416;Ne;0;1;0;1
12728;Viltenė;Lapiukų;2034259692;Ne;0;7;0;7
12729;Viltenė;Lapiukų;3473533533;Ne;0;1;0;1
12730;Viltenė;Lapiukų;8696698257;Ne;3;1;0;4
12731;Viltenė;Lapiukų;8248514570;Ne;6;1;0;7
12732;Viltenė;Lapiukų;2878124826;Taip;5;1;1;7
12733;Viltenė;Lapiukų;2660622296;Ne;12;0;0;12
12734;Viltenė;Lapiukų;4550915388;Ne;0;16;0;16
12735;Viltenė;Lapiukų;8122878153;Ne;18;0;0;18
12736;Viltenė;Lapiukų;9573891616;Ne;0;7;0;7
12737;Viltenė;Lapiukų;4243501722;Ne;0;6;0;6
12738;Viltenė;Lapiukų;6429905246;Ne;4;0;0;4
12739;Viltenė;Lapiukų;6070264006;Ne;4;7;0;11
12740;Viltenė;Lapiukų;8187712849;Ne;0;3;0;3
12741;Viltenė;Lapiukų;3679704404;Ne;0;11;0;11
12742;Viltenė;Lapiukų;1507287948;Taip;0;5;0;5
12743;Viltenė;Lapiukų;9846205631;Ne;0;12;0;12
12744;Viltenė;Lapiukų;9063994291;Ne;0;1;0;1
12745;Viltenė;Voveriukai;6888346135;Ne;0;10;0;10
12746;Viltenė;Voveriukai;2936670828;Ne;4;0;0;4
12747;Viltenė;Voveriukai;5816623708;Ne;0;22;0;22
12748;Viltenė;Voveriukai;5611839058;Ne;6;0;0;6
12749;Viltenė;Voveriukai;4414192600;Ne;0;1;2;3
12750;Viltenė;Voveriukai;2483760198;Ne;5;7;1;13
12751;Viltenė;Voveriukai;8341211836;Ne;22;0;0;22
12752;Viltenė;Voveriukai;6954065006;Ne;22;0;0;22
12753;Viltenė;Voveriukai;6741521720;Ne;0;14;0;14
12754;Viltenė;Voveriukai;2642080849;Ne;4;0;0;4
12755;Viltenė;Voveriukai;6040634853;Ne;7;5;0;12
12756;Viltenė;Voveriukai;7322841332;Ne;7;2;0;9
12757;Viltenė;Voveriukai;1888167096;Ne;0;1;0;1
12758;Viltenė;Voveriukai;3291926243;Ne;0;10;0;10
12759;Viltenė;Voveriukai;2013415571;Ne;0;8;0;8
12760;Viltenė;Voveriukai;2894570917;Taip;0;3;0;3
12761;Viltenė;Voveriukai;7158824421;Ne;12;0;0;12
12762;Viltenė;Voveriukai;1890096287;Ne;1;1;0;2
12763;Viltenė;Kiškučiai;6595715908;Ne;12;0;0;12
12764;Viltenė;Kiškučiai;3347380524;Ne;9;2;0;11
12765;Viltenė;Kiškučiai;1641406030;Ne;1;5;0;6
12766;Viltenė;Kiškučiai;2192673126;Ne;4;0;4;8
12767;Viltenė;Kiškučiai;3157417614;Ne;10;1;0;11
12768;Viltenė;Kiškučiai;5974408492;Ne;4;1;0;5
12769;Viltenė;Kiškučiai;9578037239;Ne;7;0;0;7
12770;Viltenė;Kiškučiai;4615393852;Ne;0;2;0;2
12771;Viltenė;Kiškučiai;2903596382;Ne;4;1;0;5
12772;Viltenė;Kiškučiai;8091905944;Ne;0;10;0;10
12773;Viltenė;Kiškučiai;7314937470;Ne;9;0;0;9
12774;Viltenė;Kiškučiai;8150583354;Ne;7;0;0;7
12775;Viltenė;Kiškučiai;6021086235;Ne;16;0;0;16
12776;Viltenė;Kiškučiai;1760899500;Ne;1;5;0;6
12777;Viltenė;Kiškučiai;9862698928;Ne;11;0;0;11
12778;Viltenė;Kiškučiai;3501209955;Ne;14;0;0;14
12779;Viltenė;Nykštukų;7993258845;Ne;0;0;1;1
12780;Viltenė;Nykštukų;4981225829;Ne;10;2;0;12
12781;Viltenė;Nykštukų;3343045604;Ne;10;0;0;10
12782;Viltenė;Nykštukų;4537287677;Ne;15;0;0;15
12783;Viltenė;Nykštukų;3306285115;Ne;10;0;0;10
12784;Viltenė;Nykštukų;6992120038;Ne;0;10;0;10
12785;Viltenė;Nykštukų;7331321780;Ne;8;2;0;10
12786;Viltenė;Nykštukų;5707049797;Ne;0;0;1;1
12787;Viltenė;Nykštukų;2036857372;Ne;4;0;0;4
12788;Viltenė;Nykštukų;3853518656;Ne;5;0;0;5
12789;Viltenė;Nykštukų;9288406881;Ne;6;1;0;7
12790;Viltenė;Nykštukų;9263941853;Ne;17;0;0;17
12791;Viltenė;Nykštukų;9582577013;Ne;0;11;0;11
12792;Viltenė;Triušiukai;8346933997;Ne;0;0;1;1
12793;Viltenė;Triušiukai;8278572246;Ne;4;0;0;4
12794;Viltenė;Triušiukai;8258247750;Ne;2;12;0;14
12795;Viltenė;Triušiukai;6635474168;Ne;15;0;0;15
12796;Viltenė;Triušiukai;7754951374;Ne;2;0;0;2
12797;Viltenė;Triušiukai;7145240197;Ne;5;0;0;5
12798;Viltenė;Triušiukai;7058586628;Ne;0;0;1;1
12799;Viltenė;Triušiukai;7005219570;Ne;0;1;0;1
12800;Viltenė;Triušiukai;4552355700;Ne;0;2;0;2
12801;Viltenė;Triušiukai;2850146424;Ne;0;3;0;3
12802;Viltenė;Triušiukai;1318750938;Ne;0;5;0;5
12803;Viltenė;Triušiukai;1788524515;Ne;0;5;0;5
12804;Voveraitė;ŽVIRBLIUKŲ;6684234832;Ne;0;0;15;15
12805;Voveraitė;ŽVIRBLIUKŲ;8119493388;Ne;0;0;5;5
12806;Voveraitė;ŽVIRBLIUKŲ;5804351872;Ne;0;0;2;2
12807;Voveraitė;ŽVIRBLIUKŲ;6959751328;Ne;0;0;7;7
12808;Voveraitė;ŽVIRBLIUKŲ;8803052781;Ne;0;1;2;3
12809;Voveraitė;ŽVIRBLIUKŲ;1522307865;Ne;0;0;1;1
12810;Voveraitė;ŽVIRBLIUKŲ;3811230983;Ne;4;0;7;11
12811;Voveraitė;ŽVIRBLIUKŲ;2142507659;Ne;0;0;11;11
12812;Voveraitė;ŽVIRBLIUKŲ;5395915359;Ne;1;0;0;1
12813;Voveraitė;ŽVIRBLIUKŲ;3247101840;Ne;0;0;5;5
12814;Voveraitė;ŽVIRBLIUKŲ;6643600680;Ne;0;0;10;10
12815;Voveraitė;ŽVIRBLIUKŲ;3877673172;Ne;0;2;2;4
12816;Voveraitė;ŽVIRBLIUKŲ;9117809080;Taip;0;0;3;3
12817;Voveraitė;ŽVIRBLIUKŲ;7861722125;Ne;6;0;2;8
12818;Voveraitė;VOVERIUKŲ;1515087924;Ne;0;2;0;2
12819;Voveraitė;VOVERIUKŲ;9195700962;Ne;0;17;0;17
12820;Voveraitė;VOVERIUKŲ;5138855000;Ne;6;1;0;7
12821;Voveraitė;VOVERIUKŲ;1340379090;Ne;0;6;0;6
12822;Voveraitė;VOVERIUKŲ;1960385335;Taip;0;6;0;6
12823;Voveraitė;VOVERIUKŲ;2594535017;Ne;0;3;0;3
12824;Voveraitė;VOVERIUKŲ;8373093305;Ne;0;3;0;3
12825;Voveraitė;VOVERIUKŲ;9514425475;Ne;0;5;0;5
12826;Voveraitė;VOVERIUKŲ;6891841301;Ne;7;10;0;17
12827;Voveraitė;VOVERIUKŲ;5935777154;Ne;0;22;0;22
12828;Voveraitė;VOVERIUKŲ;6007396459;Ne;5;3;0;8
12829;Voveraitė;VOVERIUKŲ;4054841724;Ne;0;9;0;9
12830;Voveraitė;VOVERIUKŲ;5956830012;Ne;3;0;0;3
12831;Voveraitė;VOVERIUKŲ;8344323109;Ne;0;1;0;1
12832;Voveraitė;VOVERIUKŲ;1141304286;Ne;0;2;0;2
12833;Voveraitė;VOVERIUKŲ;1663784931;Ne;0;4;0;4
12834;Voveraitė;VOVERIUKŲ;3276295199;Ne;0;7;0;7
12835;Voveraitė;VOVERIUKŲ;6113913885;Ne;0;2;0;2
12836;Voveraitė;KIŠKUČIŲ;9537862791;Ne;4;0;0;4
12837;Voveraitė;KIŠKUČIŲ;4478984171;Ne;0;1;0;1
12838;Voveraitė;KIŠKUČIŲ;3736638759;Ne;0;4;0;4
12839;Voveraitė;KIŠKUČIŲ;9011096222;Ne;5;15;2;22
12840;Voveraitė;KIŠKUČIŲ;3058377539;Ne;0;6;0;6
12841;Voveraitė;KIŠKUČIŲ;6261152304;Ne;0;6;0;6
12842;Voveraitė;KIŠKUČIŲ;8220437514;Ne;0;1;0;1
12843;Voveraitė;KIŠKUČIŲ;5069929376;Ne;0;9;0;9
12844;Voveraitė;KIŠKUČIŲ;7379045686;Ne;0;4;0;4
12845;Voveraitė;KIŠKUČIŲ;1961699588;Ne;5;1;0;6
12846;Voveraitė;KIŠKUČIŲ;1979839656;Ne;0;2;0;2
12847;Voveraitė;KIŠKUČIŲ;9599137158;Ne;0;1;0;1
12848;Voveraitė;KIŠKUČIŲ;8121423914;Ne;0;1;0;1
12849;Voveraitė;KIŠKUČIŲ;4379372200;Ne;4;0;0;4
12850;Voveraitė;KIŠKUČIŲ;8528435385;Ne;0;1;0;1
12851;Voveraitė;KIŠKUČIŲ;8937070276;Ne;0;1;0;1
12852;Voveraitė;KODĖLČIUKŲ;3274422598;Ne;0;9;0;9
12853;Voveraitė;KODĖLČIUKŲ;8438808999;Ne;7;1;3;11
12854;Voveraitė;KODĖLČIUKŲ;8818603905;Ne;7;5;1;13
12855;Voveraitė;KODĖLČIUKŲ;9397887760;Ne;0;1;0;1
12856;Voveraitė;KODĖLČIUKŲ;4151144278;Ne;0;1;4;5
12857;Voveraitė;KODĖLČIUKŲ;1482908802;Ne;2;0;2;4
12858;Voveraitė;KODĖLČIUKŲ;9887747925;Ne;3;0;0;3
12859;Voveraitė;KODĖLČIUKŲ;7605427741;Ne;0;2;0;2
12860;Voveraitė;KODĖLČIUKŲ;3344886524;Taip;0;0;3;3
12861;Voveraitė;KODĖLČIUKŲ;3432886020;Ne;0;2;0;2
12862;Voveraitė;KODĖLČIUKŲ;8154347030;Ne;0;6;0;6
12863;Voveraitė;KODĖLČIUKŲ;2482908027;Ne;0;7;0;7
12864;Voveraitė;KODĖLČIUKŲ;8692155848;Ne;0;0;2;2
12865;Voveraitė;KODĖLČIUKŲ;1040007977;Ne;0;5;0;5
12866;Voveraitė;KODĖLČIUKŲ;3881039538;Ne;0;2;0;2
12867;Voveraitė;KODĖLČIUKŲ;7281753415;Ne;0;2;0;2
12868;Voveraitė;KODĖLČIUKŲ;8021563060;Ne;0;1;0;1
12869;Voveraitė;MEŠKIUKŲ;7253112849;Ne;3;0;0;3
12870;Voveraitė;MEŠKIUKŲ;3217609712;Ne;2;2;0;4
12871;Voveraitė;MEŠKIUKŲ;4207949414;Ne;0;6;0;6
12872;Voveraitė;MEŠKIUKŲ;4547087565;Ne;8;8;0;16
12873;Voveraitė;MEŠKIUKŲ;7474214701;Ne;13;1;0;14
12874;Voveraitė;MEŠKIUKŲ;6853358062;Ne;0;1;0;1
12875;Voveraitė;MEŠKIUKŲ;3539069705;Ne;2;1;0;3
12876;Voveraitė;MEŠKIUKŲ;6609235703;Taip;2;6;0;8
12877;Voveraitė;MEŠKIUKŲ;1528968162;Ne;10;0;0;10
12878;Voveraitė;MEŠKIUKŲ;3159659638;Ne;5;0;0;5
12879;Voveraitė;MEŠKIUKŲ;3532178114;Ne;5;0;0;5
12880;Voveraitė;MEŠKIUKŲ;8534405352;Ne;17;0;0;17
12881;Voveraitė;MEŠKIUKŲ;5018335921;Ne;0;5;0;5
12882;Voveraitė;BORUŽĖLIŲ;3703062195;Ne;0;0;1;1
12883;Voveraitė;BORUŽĖLIŲ;3381417855;Ne;0;1;0;1
12884;Voveraitė;BORUŽĖLIŲ;5437283673;Ne;0;3;0;3
12885;Voveraitė;BORUŽĖLIŲ;3029983180;Ne;0;11;0;11
12886;Voveraitė;BORUŽĖLIŲ;5576058454;Ne;2;0;0;2
12887;Voveraitė;BORUŽĖLIŲ;7797966139;Ne;0;0;6;6
12888;Voveraitė;BORUŽĖLIŲ;4079618555;Ne;0;1;0;1
12889;Voveraitė;BORUŽĖLIŲ;6886337758;Ne;0;11;0;11
12890;Voveraitė;BORUŽĖLIŲ;3987058753;Ne;0;7;0;7
12891;Voveraitė;BORUŽĖLIŲ;1592633500;Ne;0;2;0;2
12892;Voveraitė;BORUŽĖLIŲ;1629942114;Ne;0;3;0;3
12893;Voveraitė;BORUŽĖLIŲ;9933037872;Ne;0;2;0;2
12894;Voveraitė;BORUŽĖLIŲ;65926130735;Ne;0;0;3;3
12895;Voveraitė;BORUŽĖLIŲ;6277010268;Ne;0;0;1;1
12896;Voveraitė;BORUŽĖLIŲ;2831224400;Ne;2;0;12;14
12897;Voveraitė;BORUŽĖLIŲ;2763656717;Ne;7;0;6;13
12898;Voveraitė;PELĖDŽIUKŲ;1775800865;Ne;1;2;0;3
12899;Voveraitė;PELĖDŽIUKŲ;1959958256;Ne;5;0;12;17
12900;Voveraitė;PELĖDŽIUKŲ;6649068571;Ne;0;1;0;1
12901;Voveraitė;PELĖDŽIUKŲ;7069780513;Ne;7;0;0;7
12902;Voveraitė;PELĖDŽIUKŲ;6369860178;Ne;1;0;0;1
12903;Voveraitė;PELĖDŽIUKŲ;6433760749;Ne;0;2;1;3
12904;Voveraitė;PELĖDŽIUKŲ;6460834118;Ne;0;0;3;3
12905;Voveraitė;PELĖDŽIUKŲ;4338861332;Ne;0;4;0;4
12906;Voveraitė;PELĖDŽIUKŲ;7314148938;Ne;2;0;0;2
12907;Voveraitė;PELĖDŽIUKŲ;4511771924;Ne;2;1;0;3
12908;Voveraitė;PELĖDŽIUKŲ;602726070;Ne;0;2;1;3
12909;Voveraitė;PELĖDŽIUKŲ;4163635632;Ne;0;1;4;5
12910;Voveraitė;PELĖDŽIUKŲ;1397274691;Ne;0;3;1;4
12911;Voveraitė;DRUGELIŲ;1441921029;Ne;0;1;0;1
12912;Voveraitė;DRUGELIŲ;4300235743;Ne;4;0;4;8
12913;Voveraitė;DRUGELIŲ;1510853268;Ne;0;2;0;2
12914;Voveraitė;DRUGELIŲ;3388547792;Ne;0;4;0;4
12915;Voveraitė;DRUGELIŲ;3475601049;Ne;2;0;0;2
12916;Voveraitė;DRUGELIŲ;4017408873;Ne;0;5;2;7
12917;Voveraitė;DRUGELIŲ;7533728486;Ne;3;0;0;3
12918;Voveraitė;DRUGELIŲ;1550830434;Ne;0;2;0;2
12919;Voveraitė;DRUGELIŲ;5114768009;Ne;0;2;0;2
12920;Voveraitė;DRUGELIŲ;4605007814;Ne;2;1;0;3
12921;Voveraitė;DRUGELIŲ;4911291891;Ne;0;2;10;12
12922;Voveraitė;DRUGELIŲ;4782336282;Ne;9;2;0;11
12923;Voveraitė;DRUGELIŲ;6415024059;Taip;0;2;5;7
12924;Voveraitė;DRUGELIŲ;4350450125;Ne;0;8;2;10
12925;Voveraitė;DRUGELIŲ;8913940646;Ne;0;4;1;5
12926;Voveraitė;DRUGELIŲ;1201270622;Ne;0;10;2;12
12927;Voveraitė;DRUGELIŲ;7238482039;Ne;10;0;1;11
12928;Voveraitė;DRUGELIŲ;5605614222;Ne;0;5;3;8
12929;Voveraitė;NYKŠTUKŲ;6579193196;Taip;0;0;2;2
12930;Voveraitė;NYKŠTUKŲ;9332936763;Ne;5;3;0;8
12931;Voveraitė;NYKŠTUKŲ;6206817227;Ne;4;0;1;5
12932;Voveraitė;NYKŠTUKŲ;8206634977;Ne;5;0;0;5
12933;Voveraitė;NYKŠTUKŲ;3068683904;Ne;0;1;8;9
12934;Voveraitė;NYKŠTUKŲ;3600230896;Ne;0;8;1;9
12935;Voveraitė;NYKŠTUKŲ;1294012085;Ne;5;6;0;11
12936;Voveraitė;NYKŠTUKŲ;8217771158;Ne;3;2;0;5
12937;Voveraitė;NYKŠTUKŲ;3409709168;Ne;0;2;4;6
12938;Voveraitė;NYKŠTUKŲ;1045121363;Ne;3;6;0;9
12939;Voveraitė;NYKŠTUKŲ;4319786615;Ne;0;2;0;2
12940;Voveraitė;NYKŠTUKŲ;3261542931;Ne;7;1;2;10
12941;Voveraitė;GENIUKŲ;5296850349;Ne;0;0;14;14
12942;Voveraitė;GENIUKŲ;51213803814;Ne;0;1;0;1
12943;Voveraitė;GENIUKŲ;2304004487;Ne;0;0;3;3
12944;Voveraitė;GENIUKŲ;6819742525;Ne;0;6;0;6
12945;Voveraitė;GENIUKŲ;4468214107;Ne;0;0;1;1
12946;Voveraitė;GENIUKŲ;9431523085;Ne;0;1;0;1
12947;Voveraitė;GENIUKŲ;4045121781;Ne;0;2;0;2
12948;Voveraitė;GENIUKŲ;7786378018;Ne;0;2;0;2
12949;Voveraitė;GENIUKŲ;5449490074;Ne;2;2;3;7
12950;Voveraitė;GENIUKŲ;6361417566;Ne;0;8;0;8
12951;Voveraitė;GENIUKŲ;1772758517;Ne;4;1;0;5
12952;Voveraitė;LAPIUKŲ;5104290434;Ne;0;0;22;22
12953;Voveraitė;LAPIUKŲ;6648733729;Ne;0;22;0;22
12954;Voveraitė;LAPIUKŲ;2552772063;Ne;0;0;2;2
12955;Voveraitė;LAPIUKŲ;8152541593;Ne;13;0;3;16
12956;Voveraitė;LAPIUKŲ;4891757467;Ne;0;0;11;11
12957;Voveraitė;LAPIUKŲ;9218074631;Ne;5;0;2;7
12958;Voveraitė;LAPIUKŲ;1921260351;Ne;7;0;0;7
12959;Voveraitė;LAPIUKŲ;3452040361;Ne;0;4;0;4
12960;Voveraitė;LAPIUKŲ;8382950248;Ne;0;0;1;1
12961;Voveraitė;LAPIUKŲ;8695525951;Ne;4;0;0;4
12962;Voveraitė;LAPIUKŲ;6443288864;Ne;0;3;2;5
12963;Voveraitė;LAPIUKŲ;6650343917;Ne;0;3;0;3
12964;Voveraitė;LAPIUKŲ;8451803815;Ne;0;0;1;1
12965;Voveraitė;LAPIUKŲ;9327593792;Ne;14;0;4;18
12966;Voveraitė;LAPIUKŲ;4139239328;Ne;16;0;2;18
12967;Voveraitė;EŽIUKŲ;5420123208;Ne;0;2;0;2
12968;Voveraitė;EŽIUKŲ;7969862374;Ne;0;1;2;3
12969;Voveraitė;EŽIUKŲ;1692829228;Ne;5;0;0;5
12970;Voveraitė;EŽIUKŲ;4233627593;Ne;0;0;5;5
12971;Voveraitė;EŽIUKŲ;2761041681;Ne;3;0;0;3
12972;Voveraitė;EŽIUKŲ;8074808131;Ne;6;0;0;6
12973;Voveraitė;EŽIUKŲ;8675606844;Ne;0;0;1;1
12974;Voveraitė;EŽIUKŲ;8229145014;Ne;0;0;6;6
12975;Voveraitė;EŽIUKŲ;3168493145;Ne;0;0;1;1
12976;Voveraitė;EŽIUKŲ;3971484538;Ne;0;5;0;5
12977;Voveraitė;EŽIUKŲ;1542869765;Ne;0;0;5;5
12978;Voveraitė;EŽIUKŲ;2755043670;Ne;3;5;0;8
12979;Voveraitė;EŽIUKŲ;8627692360;Ne;0;5;0;5
12980;"Trakų Vokė";Voveriukų;1252962923;Ne;10;2;0;12
12981;"Trakų Vokė";Voveriukų;6076083379;Ne;0;5;0;5
12982;"Trakų Vokė";Voveriukų;7656305410;Ne;10;1;1;12
12983;"Trakų Vokė";Voveriukų;5626732539;Ne;0;5;1;6
12984;"Trakų Vokė";Voveriukų;7706665420;Ne;10;1;1;12
12985;"Trakų Vokė";Voveriukų;2318712376;Ne;0;3;4;7
12986;"Trakų Vokė";Voveriukų;2812442474;Ne;2;2;0;4
12987;"Trakų Vokė";Voveriukų;7671121106;Ne;0;7;9;16
12988;"Trakų Vokė";Voveriukų;9140597911;Ne;0;1;5;6
12989;"Trakų Vokė";Voveriukų;5741852704;Ne;13;5;0;18
12990;"Trakų Vokė";Voveriukų;8636196544;Ne;5;0;0;5
12991;"Trakų Vokė";Voveriukų;4516714702;Ne;15;2;0;17
12992;"Trakų Vokė";Voveriukų;7797516793;Ne;0;8;0;8
12993;"Trakų Vokė";Voveriukų;3445611475;Ne;20;3;1;24
12994;"Trakų Vokė";Voveriukų;3422308444;Ne;6;15;10;31
12995;"Trakų Vokė";KIŠKUČIŲ;2503382218;Ne;0;0;3;3
12996;"Trakų Vokė";KIŠKUČIŲ;8605461082;Ne;0;0;2;2
12997;"Trakų Vokė";KIŠKUČIŲ;4854440884;Ne;4;0;4;8
12998;"Trakų Vokė";KIŠKUČIŲ;2761614687;Ne;9;0;1;10
12999;"Trakų Vokė";KIŠKUČIŲ;9233090228;Ne;0;0;1;1
13000;"Trakų Vokė";KIŠKUČIŲ;6277305384;Ne;0;0;2;2
13001;"Trakų Vokė";KIŠKUČIŲ;1360046096;Ne;7;2;0;9
13002;"Trakų Vokė";KIŠKUČIŲ;3611639112;Ne;0;2;1;3
13003;"Trakų Vokė";KIŠKUČIŲ;3328527700;Ne;6;0;0;6
13004;"Trakų Vokė";KIŠKUČIŲ;5206616285;Ne;12;0;0;12
13005;"Trakų Vokė";KIŠKUČIŲ;2869217654;Ne;0;4;0;4
13006;"Trakų Vokė";KIŠKUČIŲ;4535167417;Ne;0;5;0;5
13007;"Trakų Vokė";KIŠKUČIŲ;2539647111;Ne;0;0;1;1
13008;"Trakų Vokė";KIŠKUČIŲ;6326568445;Ne;0;5;0;5
13009;"Trakų Vokė";KIŠKUČIŲ;3278842582;Ne;0;0;3;3
13010;"Trakų Vokė";KIŠKUČIŲ;2453791555;Ne;2;0;8;10
13011;"Trakų Vokė";KIŠKUČIŲ;9506008651;Ne;3;0;2;5
13012;"Trakų Vokė";BITUČIŲ;7632198751;Ne;0;0;4;4
13013;"Trakų Vokė";BITUČIŲ;3686108421;Ne;11;2;2;15
13014;"Trakų Vokė";BITUČIŲ;3333979364;Ne;11;1;0;12
13015;"Trakų Vokė";BITUČIŲ;5810595458;Ne;0;2;0;2
13016;"Trakų Vokė";BITUČIŲ;8783922678;Ne;0;9;1;10
13017;"Trakų Vokė";BITUČIŲ;5031669549;Ne;15;0;0;15
13018;"Trakų Vokė";BITUČIŲ;8703806519;Ne;17;0;5;22
13019;"Trakų Vokė";BITUČIŲ;4531294784;Ne;7;0;0;7
13020;"Trakų Vokė";BITUČIŲ;2133793458;Ne;0;5;0;5
13021;"Trakų Vokė";BITUČIŲ;5720994041;Ne;8;0;2;10
13022;"Trakų Vokė";BITUČIŲ;6428645462;Ne;9;0;0;9
13023;"Trakų Vokė";BITUČIŲ;7459132887;Ne;10;2;0;12
13024;"Trakų Vokė";BITUČIŲ;1808420447;Ne;0;4;0;4
13025;"Trakų Vokė";BITUČIŲ;6402002961;Ne;0;1;0;1
13026;"Trakų Vokė";BITUČIŲ;3536227018;Ne;6;2;0;8
13027;"Trakų Vokė";BITUČIŲ;3372734352;Ne;6;0;0;6
13028;"Trakų Vokė";BITUČIŲ;1000323267;Ne;7;0;1;8
13029;"Trakų Vokė";BITUČIŲ;1359519176;Ne;13;1;0;14
13030;"Trakų Vokė";BITUČIŲ;1039317931;Ne;12;0;9;21
13031;"Trakų Vokė";BITUČIŲ;4212617288;Ne;6;0;4;10
13032;Zylutė;Katerok;8749296671;Ne;0;0;1;1
13033;Zylutė;Katerok;4592825972;Ne;0;1;0;1
13034;Zylutė;Katerok;8747721198;Ne;11;5;0;16
13035;Zylutė;Katerok;8212030518;Ne;0;10;0;10
13036;Zylutė;Katerok;7706833089;Ne;0;10;0;10
13037;Zylutė;Katerok;3115223229;Ne;0;12;2;14
13038;Zylutė;Katerok;2968625045;Ne;0;0;6;6
13039;Zylutė;Katerok;1897871944;Ne;3;1;0;4
13040;Zylutė;Katerok;5687201052;Taip;0;1;0;1
13041;Zylutė;Katerok;2792217953;Ne;0;0;1;1
13042;Zylutė;Katerok;5948147748;Ne;0;11;0;11
13043;Zylutė;Katerok;7851423851;Ne;7;9;0;16
13044;Zylutė;Katerok;1423890598;Ne;21;0;0;21
13045;Zylutė;Katerok;2558354198;Ne;0;2;0;2
13046;Zylutė;Katerok;8618778936;Ne;0;5;0;5
13047;Zylutė;"Vesole misiaki";9162232979;Ne;0;3;0;3
13048;Zylutė;"Vesole misiaki";9737308076;Ne;0;8;0;8
13049;Zylutė;"Vesole misiaki";5589330186;Ne;5;0;0;5
13050;Zylutė;"Vesole misiaki";3848401615;Ne;0;2;0;2
13051;Zylutė;"Vesole misiaki";2913504349;Ne;4;7;0;11
13052;Zylutė;"Vesole misiaki";6601967273;Ne;11;0;0;11
13053;Zylutė;"Vesole misiaki";2501761963;Ne;0;4;0;4
13054;Zylutė;"Vesole misiaki";6833822248;Ne;5;12;0;17
13055;Zylutė;"Vesole misiaki";3976277394;Ne;0;2;0;2
13056;Zylutė;"Vesole misiaki";2489898107;Ne;0;4;0;4
13057;Zylutė;"Vesole misiaki";2313423907;Ne;0;8;0;8
13058;Zylutė;NYKŠTUKAI;3371202491;Taip;0;12;0;12
13059;Zylutė;NYKŠTUKAI;8820121776;Ne;0;1;0;1
13060;Zylutė;NYKŠTUKAI;1169490002;Ne;0;4;0;4
13061;Zylutė;NYKŠTUKAI;3994691080;Ne;10;1;0;11
13062;Zylutė;NYKŠTUKAI;4894611078;Ne;5;0;0;5
13063;Zylutė;NYKŠTUKAI;7648922403;Ne;4;0;0;4
13064;Zylutė;NYKŠTUKAI;2113594059;Ne;15;4;0;19
13065;Zylutė;NYKŠTUKAI;2604844156;Ne;0;6;0;6
13066;Zylutė;NYKŠTUKAI;2511658462;Ne;3;0;0;3
13067;Zylutė;NYKŠTUKAI;3035745273;Ne;14;0;0;14
13068;Zylutė;NYKŠTUKAI;2620903587;Ne;15;3;0;18
13069;Zylutė;NYKŠTUKAI;4706933533;Ne;12;0;0;12
13070;Zylutė;NYKŠTUKAI;9951774752;Ne;3;0;0;3
13071;Zylutė;Ručijok;5096881585;Ne;7;0;15;22
13072;Zylutė;Ručijok;3201966434;Ne;10;0;1;11
13073;Zylutė;Ručijok;9904758615;Ne;8;0;0;8
13074;Zylutė;Ručijok;4874246039;Ne;0;9;0;9
13075;Zylutė;Ručijok;2769424439;Ne;6;2;1;9
13076;Zylutė;Ručijok;1145229045;Ne;10;0;0;10
13077;Zylutė;Ručijok;3058040516;Ne;17;4;0;21
13078;Zylutė;Ručijok;2916622808;Ne;22;0;0;22
13079;Zylutė;Ručijok;5038936878;Ne;7;0;15;22
13080;Zylutė;Ručijok;2491905840;Taip;10;0;0;10
13081;Zylutė;Ručijok;7742044835;Ne;6;3;0;9
13082;Zylutė;Ručijok;6276017610;Ne;7;0;1;8
13083;Zylutė;Ručijok;3128535871;Ne;10;0;1;11
13084;Zylutė;Raduga;5408157164;Ne;0;0;13;13
13085;Zylutė;"Miki Maus";9159342804;Ne;6;5;0;11
13086;Zylutė;"Miki Maus";5369354390;Ne;17;1;0;18
13087;Zylutė;"Miki Maus";9507157625;Ne;0;7;0;7
13088;Zylutė;"Miki Maus";8101232865;Ne;0;1;0;1
13089;Zylutė;"Miki Maus";9018673580;Ne;12;0;0;12
13090;Zylutė;"Miki Maus";7762245887;Ne;2;0;0;2
13091;Zylutė;"Miki Maus";9213491152;Ne;0;3;0;3
13092;Zylutė;"Miki Maus";3928932787;Ne;0;6;0;6
13093;Zylutė;"Miki Maus";4057419108;Taip;0;10;0;10
13094;Zylutė;"Miki Maus";3668160578;Ne;0;13;0;13
13095;Zylutė;"Miki Maus";9093777086;Ne;0;7;0;7
13096;Zylutė;"Miki Maus";5975875502;Ne;0;2;0;2
13097;Zylutė;"Miki Maus";2201317313;Ne;8;0;0;8
13098;Zylutė;Solnyško;8379932761;Ne;10;0;0;10
13099;Zylutė;Solnyško;5556769710;Ne;0;0;1;1
13100;Zylutė;Solnyško;2088316489;Ne;0;8;0;8
13101;Zylutė;Solnyško;1076803315;Ne;0;8;1;9
13102;Zylutė;Solnyško;7616444695;Ne;0;1;0;1
13103;Zylutė;Solnyško;5234846079;Ne;5;0;1;6
13104;Zylutė;Solnyško;5939522435;Ne;0;5;0;5
13105;Zylutė;Solnyško;5826813410;Ne;0;3;0;3
13106;Zylutė;Solnyško;8033573972;Ne;0;10;0;10
13107;Zylutė;Solnyško;7447067072;Ne;0;5;0;5
13108;Zylutė;Solnyško;4669449744;Ne;0;0;2;2
13109;Zylutė;Solnyško;4478652694;Ne;0;0;1;1
13110;Zylutė;Solnyško;1969578486;Ne;6;0;2;8
13111;Zylutė;Solnyško;6573541087;Ne;8;0;0;8
13112;Zylutė;Solnyško;2520744071;Ne;7;0;1;8
13113;Zylutė;Motyliok;7241045507;Ne;6;0;6;12
13114;Zylutė;Motyliok;9913001904;Ne;0;0;1;1
13115;Zylutė;Motyliok;5891900062;Ne;4;10;0;14
13116;Zylutė;Motyliok;6112586092;Ne;0;0;2;2
13117;Zylutė;Motyliok;8178488164;Ne;0;0;4;4
13118;Zylutė;Motyliok;5045652581;Ne;9;8;0;17
13119;Zylutė;Motyliok;9586800176;Ne;15;0;0;15
13120;Zylutė;Motyliok;4497904128;Ne;0;11;0;11
13121;Zylutė;Motyliok;9995791665;Ne;3;2;0;5
13122;Zylutė;Motyliok;3455374127;Ne;15;1;0;16
13123;Zylutė;Motyliok;1632490481;Ne;6;0;0;6
13124;Zylutė;Motyliok;1726060015;Ne;8;0;0;8
13125;Zylutė;Motyliok;6051657134;Ne;0;0;3;3
13126;Zylutė;Motyliok;3271366684;Ne;10;0;0;10
13127;Zylutė;Motyliok;3633983359;Ne;9;0;0;9
13128;Zylutė;Motyliok;9155513221;Ne;4;0;0;4
13129;Zylutė;ŽVIRBLIUKAI;6282501549;Ne;0;0;7;7
13130;Zylutė;ŽVIRBLIUKAI;1319040747;Ne;9;0;5;14
13131;Zylutė;ŽVIRBLIUKAI;4394023057;Ne;0;0;1;1
13132;Zylutė;ŽVIRBLIUKAI;8326987895;Ne;0;12;0;12
13133;Zylutė;ŽVIRBLIUKAI;9330583784;Ne;10;0;0;10
13134;Zylutė;ŽVIRBLIUKAI;9150157724;Ne;7;0;0;7
13135;Zylutė;ŽVIRBLIUKAI;8268700439;Ne;0;0;14;14
13136;Zylutė;ŽVIRBLIUKAI;1220439948;Ne;0;9;0;9
13137;Zylutė;ŽVIRBLIUKAI;4646273830;Ne;3;0;2;5
13138;Zylutė;ŽVIRBLIUKAI;9580188426;Ne;7;0;0;7
13139;Zylutė;ŽVIRBLIUKAI;1797701777;Ne;0;6;0;6
13140;Zylutė;ŽVIRBLIUKAI;2966482773;Ne;0;4;0;4
13141;Zylutė;ŽVIRBLIUKAI;8262929231;Ne;3;5;1;9
13142;Zylutė;ŽVIRBLIUKAI;8152140523;Ne;0;7;0;7
13143;Zylutė;ŽVIRBLIUKAI;2061747513;Taip;5;0;1;6
13144;Zylutė;"DRUŽNYJE REBIATA";5332039406;Ne;7;5;0;12
13145;Zylutė;"DRUŽNYJE REBIATA";9039665233;Ne;0;10;0;10
13146;Zylutė;"DRUŽNYJE REBIATA";6075614020;Ne;0;14;0;14
13147;Zylutė;"DRUŽNYJE REBIATA";9518714240;Ne;5;0;0;5
13148;Zylutė;"DRUŽNYJE REBIATA";2693961315;Ne;13;2;0;15
13149;Zylutė;"DRUŽNYJE REBIATA";3372639449;Ne;14;0;0;14
13150;Zylutė;"DRUŽNYJE REBIATA";4916625058;Ne;12;0;0;12
13151;Zylutė;"DRUŽNYJE REBIATA";3447644735;Ne;3;1;0;4
13152;Zylutė;"DRUŽNYJE REBIATA";6848387941;Ne;0;7;4;11
13153;Zylutė;"DRUŽNYJE REBIATA";1404949829;Ne;10;0;0;10
13154;Zylutė;"DRUŽNYJE REBIATA";4548205666;Ne;0;1;0;1
13155;Zylutė;"DRUŽNYJE REBIATA";6962852787;Ne;0;1;0;1
13156;Zylutė;"DRUŽNYJE REBIATA";9220918504;Ne;0;1;0;1
13157;Zylutė;"DRUŽNYJE REBIATA";9193349264;Ne;15;2;0;17
13158;Zylutė;"DRUŽNYJE REBIATA";8130859512;Ne;0;7;0;7
13159;Zylutė;"DRUŽNYJE REBIATA";6281989117;Ne;0;3;0;3
13160;Zylutė;"DRUŽNYJE REBIATA";9769201088;Ne;5;5;0;10
13161;Zylutė;"DRUŽNYJE REBIATA";5233163416;Ne;5;0;0;5
13162;Zylutė;"DRUŽNYJE REBIATA";6784471792;Ne;17;1;0;18
13163;Zylutė;"DRUŽNYJE REBIATA";5126282685;Ne;0;1;0;1
13164;Zylutė;VIEVERSĖLIAI;2125519672;Ne;0;2;0;2
13165;Zylutė;VIEVERSĖLIAI;4505081448;Ne;5;1;0;6
13166;Zylutė;VIEVERSĖLIAI;72716975865;Ne;0;2;0;2
13167;Zylutė;VIEVERSĖLIAI;5172154642;Ne;0;5;0;5
13168;Zylutė;VIEVERSĖLIAI;2943888466;Ne;5;3;0;8
13169;Zylutė;VIEVERSĖLIAI;6907378757;Ne;2;1;0;3
13170;Zylutė;VIEVERSĖLIAI;6723650872;Ne;1;3;0;4
13171;Zylutė;VIEVERSĖLIAI;4016518230;Ne;0;6;0;6
13172;Zylutė;VIEVERSĖLIAI;9660898505;Ne;0;14;0;14
13173;Zylutė;VIEVERSĖLIAI;5544338521;Ne;0;5;0;5
13174;Zylutė;VIEVERSĖLIAI;27488840113;Ne;5;1;0;6
13175;Zylutė;VIEVERSĖLIAI;5162635301;Ne;15;3;0;18
13176;Zylutė;VIEVERSĖLIAI;1939618217;Ne;3;5;0;8
13177;Zylutė;VIEVERSĖLIAI;20569748356;Ne;0;2;0;2
13178;Zylutė;VIEVERSĖLIAI;1048279422;Ne;0;10;0;10
13179;Zylutė;VIEVERSĖLIAI;3919565034;Ne;0;2;0;2
13180;Zylutė;VIEVERSĖLIAI;6548786007;Ne;6;2;0;8
13181;Zylutė;VIEVERSĖLIAI;4154010905;Ne;0;4;0;4
13182;Zylutė;VIEVERSĖLIAI;3074954453;Ne;3;0;0;3
13183;Želmenėliai;Bitučių;3268310531;Ne;0;4;0;4
13184;Želmenėliai;Bitučių;2122665619;Ne;2;2;3;7
13185;Želmenėliai;Bitučių;2563117992;Ne;7;0;0;7
13186;Želmenėliai;Bitučių;6799702725;Ne;0;2;2;4
13187;Želmenėliai;Bitučių;9006406225;Ne;2;2;0;4
13188;Želmenėliai;Bitučių;4931835807;Ne;8;2;1;11
13189;Želmenėliai;Bitučių;6481952132;Ne;0;2;0;2
13190;Želmenėliai;Bitučių;9611741258;Ne;0;2;0;2
13191;Želmenėliai;Bitučių;1619143702;Ne;15;0;0;15
13192;Želmenėliai;Bitučių;9825545754;Ne;0;1;0;1
13193;Želmenėliai;Bitučių;5314438217;Ne;0;4;0;4
13194;Želmenėliai;Bitučių;4927030144;Ne;7;1;0;8
13195;Želmenėliai;Bitučių;8028761330;Ne;0;2;0;2
13196;Želmenėliai;Bitučių;2853659708;Ne;0;6;0;6
13197;Želmenėliai;Bitučių;9207984505;Ne;0;19;0;19
13198;Želmenėliai;Kačiukų;1292462938;Ne;1;0;1;2
13199;Želmenėliai;Kačiukų;2350936740;Ne;7;1;0;8
13200;Želmenėliai;Kačiukų;3063417708;Ne;0;13;0;13
13201;Želmenėliai;Kačiukų;2577850672;Ne;0;6;0;6
13202;Želmenėliai;Kačiukų;7197717698;Ne;12;7;0;19
13203;Želmenėliai;Kačiukų;7849682820;Ne;7;1;0;8
13204;Želmenėliai;Kačiukų;2111008869;Ne;0;0;12;12
13205;Želmenėliai;Kačiukų;4589396143;Ne;3;0;0;3
13206;Želmenėliai;Kačiukų;4198085732;Ne;4;3;0;7
13207;Želmenėliai;Kačiukų;6509783586;Ne;0;2;1;3
13208;Želmenėliai;Kačiukų;4126499046;Ne;0;1;0;1
13209;Želmenėliai;Kačiukų;4758240577;Ne;0;2;0;2
13210;Želmenėliai;Kačiukų;7094853897;Taip;14;0;0;14
13211;Želmenėliai;Kačiukų;9493581034;Ne;0;2;12;14
13212;Želmenėliai;Kačiukų;4931664953;Ne;5;6;0;11
13213;Želmenėliai;Kačiukų;4376978921;Ne;0;17;0;17
13214;Želmenėliai;Kačiukų;9313666706;Ne;0;2;6;8
13215;Želmenėliai;Kačiukų;8590129703;Ne;5;1;4;10
13216;Želmenėliai;Kačiukų;3959066963;Ne;0;0;2;2
13217;Želmenėliai;Kačiukų;6761848439;Ne;0;0;12;12
13218;Želmenėliai;Voveriukų;6343814445;Ne;0;2;0;2
13219;Želmenėliai;Voveriukų;5360157217;Ne;0;17;0;17
13220;Želmenėliai;Voveriukų;2545133678;Ne;0;1;2;3
13221;Želmenėliai;Voveriukų;7423900312;Ne;0;1;0;1
13222;Želmenėliai;Voveriukų;4968328834;Ne;0;1;0;1
13223;Želmenėliai;Voveriukų;2025424742;Ne;7;5;0;12
13224;Želmenėliai;Voveriukų;2924134152;Ne;21;0;0;21
13225;Želmenėliai;Voveriukų;5975166975;Ne;12;10;0;22
13226;Želmenėliai;Voveriukų;6857922902;Ne;0;3;1;4
13227;Želmenėliai;Voveriukų;9811131936;Ne;12;0;0;12
13228;Želmenėliai;Voveriukų;8968533318;Ne;0;11;0;11
13229;Želmenėliai;Voveriukų;6264955603;Ne;7;9;0;16
13230;Želmenėliai;Voveriukų;7345540758;Ne;10;0;0;10
13231;Želmenėliai;Voveriukų;9709599805;Ne;3;2;1;6
13232;Želmenėliai;Voveriukų;4248374729;Ne;0;2;0;2
13233;Želmenėliai;Voveriukų;9590177522;Ne;0;1;0;1
13234;Želmenėliai;Ežiukų;1652131150;Ne;0;1;0;1
13235;Želmenėliai;Ežiukų;5795735579;Ne;2;1;0;3
13236;Želmenėliai;Ežiukų;2311169187;Ne;8;0;2;10
13237;Želmenėliai;Ežiukų;3572462731;Ne;6;0;0;6
13238;Želmenėliai;Ežiukų;3353793939;Ne;0;3;0;3
13239;Želmenėliai;Ežiukų;7495157523;Ne;10;8;0;18
13240;Želmenėliai;Ežiukų;3972980949;Ne;0;13;0;13
13241;Želmenėliai;Ežiukų;6779746783;Ne;7;5;2;14
13242;Želmenėliai;Ežiukų;6876147546;Ne;0;18;0;18
13243;Želmenėliai;Ežiukų;9126715074;Ne;1;2;1;4
13244;Želmenėliai;Ežiukų;5638248652;Ne;3;8;0;11
13245;Želmenėliai;Ežiukų;8154713582;Ne;0;0;2;2
13246;Želmenėliai;Ežiukų;2296870749;Ne;0;2;3;5
13247;Želmenėliai;Ežiukų;6180553648;Ne;0;5;0;5
13248;Želmenėliai;Ežiukų;5171736943;Ne;0;3;0;3
13249;Želmenėliai;Ežiukų;7294722095;Ne;7;12;0;19
13250;Želmenėliai;Ežiukų;4120125150;Ne;0;4;4;8
13251;Želmenėliai;Ežiukų;5281861477;Ne;0;6;0;6
13252;Želmenėliai;Ežiukų;8987377791;Ne;0;4;0;4
13253;Želmenėliai;Ežiukų;7373892344;Ne;0;7;0;7
13254;Želmenėliai;Peledžiukų;8491797555;Ne;0;20;0;20
13255;Želmenėliai;Peledžiukų;7058759730;Ne;0;1;0;1
13256;Želmenėliai;Peledžiukų;4485249321;Ne;0;1;0;1
13257;Želmenėliai;Peledžiukų;3869372021;Ne;0;2;0;2
13258;Želmenėliai;Peledžiukų;4374898642;Ne;0;3;0;3
13259;Želmenėliai;Peledžiukų;7751609462;Ne;0;1;0;1
13260;Želmenėliai;Peledžiukų;5929410363;Ne;0;2;0;2
13261;Želmenėliai;Peledžiukų;5205425589;Ne;9;0;0;9
13262;Želmenėliai;Peledžiukų;5362390260;Ne;4;2;0;6
13263;Želmenėliai;Peledžiukų;1580370689;Ne;0;4;0;4
13264;Želmenėliai;Peledžiukų;7672980212;Ne;11;6;0;17
13265;Želmenėliai;Peledžiukų;6260153299;Ne;5;0;0;5
13266;Želmenėliai;Peledžiukų;6187661667;Ne;12;1;0;13
13267;Želmenėliai;Peledžiukų;6109546917;Ne;9;13;0;22
13268;Želmenėliai;Peledžiukų;8118696261;Ne;10;0;0;10
13269;Želmenėliai;Peledžiukų;4746898209;Ne;0;10;0;10
13270;Želmenėliai;Peledžiukų;9929149682;Taip;8;3;0;11
13271;Želmenėliai;Peledžiukų;3723155757;Ne;0;9;0;9
13272;Želmenėliai;Peledžiukų;5401466574;Ne;0;1;0;1
13273;Želmenėliai;Peledžiukų;6662439747;Ne;6;0;0;6
13274;Želmenėliai;Drugelių;7664430346;Ne;5;1;0;6
13275;Želmenėliai;Drugelių;3417538909;Ne;10;0;0;10
13276;Želmenėliai;Drugelių;3295852546;Ne;0;6;0;6
13277;Želmenėliai;Drugelių;3379266015;Ne;5;3;0;8
13278;Želmenėliai;Drugelių;1984105453;Ne;10;0;0;10
13279;Želmenėliai;Drugelių;4652412483;Ne;0;10;0;10
13280;Želmenėliai;Drugelių;1652949383;Ne;0;11;0;11
13281;Želmenėliai;Drugelių;5046836398;Ne;0;2;0;2
13282;Želmenėliai;Drugelių;9237611484;Ne;0;0;2;2
13283;Želmenėliai;Drugelių;13558387807;Ne;5;2;0;7
13284;Želmenėliai;Drugelių;5143554665;Ne;0;1;0;1
13285;Želmenėliai;Drugelių;7585159351;Ne;0;8;0;8
13286;Želmenėliai;Drugelių;4634346755;Ne;5;4;0;9
13287;Želmenėliai;Drugelių;4916436238;Ne;0;4;0;4
13288;Želmenėliai;Drugelių;5558795651;Ne;10;0;0;10
13289;Želmenėliai;Drugelių;7572597061;Ne;6;0;0;6
13290;Želmenėliai;Voriukų;4264751761;Ne;0;2;0;2
13291;Želmenėliai;Voriukų;1203343580;Ne;0;6;0;6
13292;Želmenėliai;Voriukų;9351650342;Ne;0;1;0;1
13293;Želmenėliai;Voriukų;6916426436;Ne;0;0;1;1
13294;Želmenėliai;Voriukų;7563461821;Ne;0;4;0;4
13295;Želmenėliai;Voriukų;4534946646;Ne;7;0;0;7
13296;Želmenėliai;Voriukų;4075533071;Ne;0;7;0;7
13297;Želmenėliai;Voriukų;4545012342;Ne;0;11;0;11
13298;Želmenėliai;Voriukų;7505996978;Ne;10;6;0;16
13299;Želmenėliai;Voriukų;2722619508;Ne;1;3;0;4
13300;Želmenėliai;Voriukų;5025345647;Ne;1;2;0;3
13301;Želmenėliai;Voriukų;8892137326;Ne;0;5;0;5
13302;Želmenėliai;Voriukų;7700521261;Ne;0;8;0;8
13303;Želmenėliai;Voriukų;1649724696;Ne;1;2;0;3
13304;Želmenėliai;Voriukų;5794346039;Ne;12;0;0;12
13305;Želmenėliai;Voriukų;8273301992;Ne;0;0;4;4
13306;Želmenėliai;Voriukų;8206979332;Ne;0;9;0;9
13307;Želmenėliai;Boružėlių;7792850272;Ne;4;5;0;9
13308;Želmenėliai;Boružėlių;1764468979;Ne;5;1;0;6
13309;Želmenėliai;Boružėlių;5161934903;Ne;0;4;0;4
13310;Želmenėliai;Boružėlių;8722573513;Ne;0;4;0;4
13311;Želmenėliai;Boružėlių;3516695805;Ne;0;5;0;5
13312;Želmenėliai;Boružėlių;5949535657;Ne;7;0;0;7
13313;Želmenėliai;Boružėlių;2262009049;Ne;0;1;0;1
13314;Želmenėliai;Boružėlių;7077832687;Ne;0;11;0;11
13315;Želmenėliai;Boružėlių;3896171121;Ne;4;12;0;16
13316;Želmenėliai;Boružėlių;2951719129;Ne;0;5;0;5
13317;Želmenėliai;Boružėlių;5207899503;Ne;7;6;0;13
13318;Želmenėliai;Boružėlių;2111705047;Ne;0;3;0;3
13319;Želmenėliai;Boružėlių;5514167627;Ne;0;22;0;22
13320;Želmenėliai;Boružėlių;2179165096;Ne;4;5;0;9
13321;Želmenėliai;Pūkuotukų;3258904017;Ne;0;1;0;1
13322;Želmenėliai;Pūkuotukų;8667865301;Ne;0;2;5;7
13323;Želmenėliai;Pūkuotukų;1952686295;Ne;5;1;0;6
13324;Želmenėliai;Pūkuotukų;5787772212;Ne;0;4;0;4
13325;Želmenėliai;Pūkuotukų;2727113833;Ne;0;4;0;4
13326;Želmenėliai;Pūkuotukų;9359070885;Ne;0;5;0;5
13327;Želmenėliai;Pūkuotukų;6816346946;Ne;0;4;0;4
13328;Želmenėliai;Pūkuotukų;37152467004;Ne;0;4;0;4
13329;Želmenėliai;Pūkuotukų;5842563754;Ne;0;5;0;5
13330;Želmenėliai;Pūkuotukų;1941723687;Ne;10;2;0;12
13331;Želmenėliai;Pūkuotukų;5616709457;Ne;0;2;9;11
13332;Želmenėliai;Pūkuotukų;1248541555;Ne;0;4;0;4
13333;Želmenėliai;Pūkuotukų;8300887366;Ne;0;6;0;6
13334;Želmenėliai;Pūkuotukų;7099039424;Ne;0;8;0;8
13335;Želmenėliai;Pūkuotukų;1582618217;Ne;0;5;0;5
13336;Želmenėliai;Ančiukų;4979494010;Ne;2;0;0;2
13337;Želmenėliai;Ančiukų;7925266303;Ne;2;0;0;2
13338;Želmenėliai;Ančiukų;9377359390;Ne;2;7;5;14
13339;Želmenėliai;Ančiukų;2578675950;Ne;8;0;0;8
13340;Želmenėliai;Ančiukų;8060048377;Ne;4;10;2;16
13341;Želmenėliai;Ančiukų;1606079948;Ne;4;11;0;15
13342;Želmenėliai;Ančiukų;9250666159;Ne;12;11;0;23
13343;Želmenėliai;Ančiukų;5569699398;Ne;12;11;0;23
13344;Želmenėliai;Ančiukų;3926238501;Ne;12;4;0;16
13345;Želmenėliai;Ančiukų;4207070475;Ne;0;8;0;8
13346;Želmenėliai;Ančiukų;8409831053;Ne;3;1;0;4
13347;Želmenėliai;Ančiukų;3608041516;Ne;0;2;1;3
13348;Želmenėliai;Ančiukų;5454656514;Ne;0;3;0;3
13349;Želmenėliai;Ančiukų;8165683014;Ne;15;15;0;30
13350;Želmenėliai;Ančiukų;3172645969;Ne;16;5;0;21
13351;Želmenėliai;Ančiukų;7128213908;Ne;0;9;0;9
13352;Želmenėliai;Nykštukų;6230010537;Ne;0;12;0;12
13353;Želmenėliai;Nykštukų;4722890143;Ne;0;4;0;4
13354;Želmenėliai;Nykštukų;5052052744;Ne;12;0;0;12
13355;Želmenėliai;Nykštukų;6764567873;Ne;0;11;0;11
13356;Želmenėliai;Nykštukų;1025894534;Ne;0;5;0;5
13357;Želmenėliai;Nykštukų;9901320882;Ne;2;6;0;8
13358;Želmenėliai;Nykštukų;4526936339;Ne;15;0;0;15
13359;Želmenėliai;Nykštukų;8276857357;Ne;0;3;1;4
13360;Želmenėliai;Nykštukų;3232996198;Ne;2;10;0;12
13361;Želmenėliai;Nykštukų;2878494111;Ne;0;13;0;13
13362;Želmenėliai;Nykštukų;5169813205;Ne;5;0;0;5
13363;Želmenėliai;Nykštukų;7341132501;Ne;2;0;0;2
13364;Želmenėliai;Nykštukų;9661692350;Ne;4;3;0;7
13365;Želmenėliai;Nykštukų;3003922213;Ne;10;0;0;10
13366;Želmenėliai;Nykštukų;7123290599;Ne;18;0;0;18
13367;Želmenėliai;Lašelių;4485851428;Ne;5;3;0;8
13368;Želmenėliai;Lašelių;3558547171;Ne;7;0;0;7
13369;Želmenėliai;Lašelių;4930868989;Ne;0;1;0;1
13370;Želmenėliai;Lašelių;2501163903;Ne;5;8;0;13
13371;Želmenėliai;Lašelių;9076874685;Ne;0;6;2;8
13372;Želmenėliai;Lašelių;3346680108;Ne;3;7;0;10
13373;Želmenėliai;Lašelių;4679930998;Ne;5;0;0;5
13374;Želmenėliai;Lašelių;3344426717;Ne;5;0;0;5
13375;Želmenėliai;Lašelių;9483665065;Ne;7;2;0;9
13376;Želmenėliai;Lašelių;1426080041;Ne;0;1;0;1
13377;Želmenėliai;Lašelių;9182208354;Ne;0;2;0;2
13378;Želmenėliai;Lašelių;8104790589;Ne;0;5;0;5
13379;Želmenėliai;Lašelių;3979635800;Ne;3;0;0;3
13380;Žemyna;Čiauškučiai;9985529041;Ne;6;0;10;16
13381;Žemyna;Čiauškučiai;9570187081;Ne;0;0;5;5
13382;Žemyna;Čiauškučiai;2547436771;Ne;0;6;0;6
13383;Žemyna;Čiauškučiai;6051208732;Ne;5;0;1;6
13384;Žemyna;Čiauškučiai;6346173832;Ne;4;0;0;4
13385;Žemyna;Čiauškučiai;8694608716;Ne;0;0;1;1
13386;Žemyna;Čiauškučiai;3074391266;Ne;6;0;0;6
13387;Žemyna;Čiauškučiai;1365045512;Ne;9;0;1;10
13388;Žemyna;Čiauškučiai;7620179886;Ne;0;9;1;10
13389;Žemyna;Čiauškučiai;7277970673;Ne;5;0;0;5
13390;Žemyna;Čiauškučiai;5069437469;Ne;12;1;0;13
13391;Žemyna;Čiauškučiai;7427119736;Ne;0;0;1;1
13392;Žemyna;Čiauškučiai;2354265632;Ne;5;0;1;6
13393;Žemyna;Čiauškučiai;2887459684;Ne;0;0;1;1
13394;Žemyna;Čiauškučiai;1654157342;Ne;0;1;0;1
13395;Žemyna;Čiauškučiai;4652384557;Ne;10;0;0;10
13396;Žemyna;Čiauškučiai;7352868453;Ne;8;0;0;8
13397;Žemyna;Čiauškučiai;4501408683;Ne;6;0;0;6
13398;Žemyna;Čiauškučiai;4613946229;Ne;0;0;3;3
13399;Žemyna;Čiauškučiai;7675699775;Ne;2;0;3;5
13400;Žemyna;Nykštukai;5114094924;Ne;0;2;0;2
13401;Žemyna;Nykštukai;2461700030;Ne;5;8;0;13
13402;Žemyna;Nykštukai;1725771976;Ne;0;0;6;6
13403;Žemyna;Nykštukai;3643594001;Ne;3;0;7;10
13404;Žemyna;Nykštukai;9182709647;Ne;0;4;0;4
13405;Žemyna;Nykštukai;4444870782;Ne;0;2;1;3
13406;Žemyna;Nykštukai;7781924111;Ne;0;0;7;7
13407;Žemyna;Nykštukai;4257096808;Ne;0;5;0;5
13408;Žemyna;Nykštukai;2860210906;Ne;0;0;15;15
13409;Žemyna;Nykštukai;7832066079;Ne;5;3;0;8
13410;Žemyna;Nykštukai;9653530823;Ne;11;3;0;14
13411;Žemyna;Nykštukai;7508491119;Ne;5;0;0;5
13412;Žemyna;Nykštukai;2928125522;Ne;0;1;0;1
13413;Žemyna;Nykštukai;4524929331;Ne;0;1;0;1
13414;Žemyna;Nykštukai;4759403487;Ne;0;6;0;6
13415;Žemyna;Voveriukai;9855080887;Ne;0;1;0;1
13416;Žemyna;Voveriukai;6912605631;Ne;3;0;0;3
13417;Žemyna;Voveriukai;8525229514;Ne;8;0;2;10
13418;Žemyna;Voveriukai;1846287760;Ne;0;0;12;12
13419;Žemyna;Voveriukai;8775518984;Ne;0;2;3;5
13420;Žemyna;Voveriukai;5337086029;Ne;6;0;1;7
13421;Žemyna;Voveriukai;8926045231;Ne;0;4;4;8
13422;Žemyna;Voveriukai;3860791215;Ne;0;4;0;4
13423;Žemyna;Voveriukai;8185243991;Ne;22;0;0;22
13424;Žemyna;Voveriukai;9471382383;Ne;0;0;4;4
13425;Žemyna;Voveriukai;4549562657;Ne;0;1;0;1
13426;Žemyna;Voveriukai;8882641275;Ne;0;8;0;8
13427;Žemyna;Voveriukai;8241038433;Ne;0;1;1;2
13428;Žemyna;Voveriukai;5189603013;Ne;7;0;1;8
13429;Žemyna;Voveriukai;3500358886;Ne;0;0;2;2
13430;Žemyna;Voveriukai;6592356004;Ne;7;0;1;8
13431;Žemyna;Kiškučiai;8622780639;Ne;0;0;1;1
13432;Žemyna;Kiškučiai;1575505075;Ne;0;0;2;2
13433;Žemyna;Kiškučiai;39916867354;Ne;0;1;0;1
13434;Žemyna;Kiškučiai;5258444578;Ne;0;0;4;4
13435;Žemyna;Kiškučiai;7785889259;Ne;0;0;2;2
13436;Žemyna;Kiškučiai;7676796264;Ne;0;2;0;2
13437;Žemyna;Kiškučiai;6536698798;Ne;8;3;0;11
13438;Žemyna;Kiškučiai;8139714064;Ne;0;0;1;1
13439;Žemyna;Kiškučiai;2090395417;Ne;0;7;0;7
13440;Žemyna;Kiškučiai;3895238312;Ne;0;0;1;1
13441;Žemyna;Kiškučiai;5056205809;Ne;0;0;2;2
13442;Žemyna;Kiškučiai;4519502372;Ne;0;0;14;14
13443;Žemyna;Kiškučiai;2137718635;Ne;0;0;1;1
13444;Žemyna;Kiškučiai;8018865138;Ne;0;4;0;4
13445;Žemyna;Kiškučiai;1717797530;Ne;2;0;1;3
13446;Žemyna;Kiškučiai;5233574060;Ne;2;2;0;4
13447;Žemyna;Kiškučiai;15110117571;Ne;0;6;0;6
13448;Žemyna;Kiškučiai;9219519029;Ne;0;4;1;5
13449;Žemyna;Kiškučiai;7638038269;Ne;0;2;0;2
13450;Žemyna;Vyturiukai;2526949655;Ne;6;0;1;7
13451;Žemyna;Vyturiukai;1417007895;Ne;0;0;10;10
13452;Žemyna;Vyturiukai;5355845891;Ne;0;0;2;2
13453;Žemyna;Vyturiukai;1481273689;Ne;0;0;2;2
13454;Žemyna;Vyturiukai;7781332622;Ne;13;3;0;16
13455;Žemyna;Vyturiukai;9366133892;Ne;0;7;0;7
13456;Žemyna;Vyturiukai;1031171460;Ne;0;0;6;6
13457;Žemyna;Vyturiukai;5204349188;Ne;8;0;0;8
13458;Žemyna;Vyturiukai;1345704379;Ne;0;0;1;1
13459;Žemyna;Vyturiukai;6097681172;Ne;0;8;0;8
13460;Žemyna;Vyturiukai;5133115712;Ne;0;1;0;1
13461;Žemyna;Vyturiukai;5416338054;Ne;0;1;0;1
13462;Žemyna;Vyturiukai;3446774478;Ne;0;11;0;11
13463;Žemyna;Vyturiukai;6271057561;Ne;0;4;0;4
13464;Žemyna;Vyturiukai;2304633263;Ne;0;5;5;10
13465;Žemyna;Vyturiukai;7300819771;Ne;3;0;1;4
13466;Žemyna;Vyturiukai;3679990879;Ne;0;0;5;5
13467;Žemyna;Vyturiukai;8461326396;Ne;0;0;7;7
13468;Žemyna;Vyturiukai;8681308720;Ne;0;1;0;1
13469;Žemyna;Vyturiukai;8577299116;Ne;7;0;5;12
13470;Žemyna;Vyturiukai;9646494715;Ne;7;11;0;18
13471;Žemyna;Vyturiukai;4863350801;Ne;10;0;4;14
13472;Žemyna;Vyturiukai;5655302107;Ne;0;14;0;14
13473;Žemyna;Pelėdžiukai;8040359407;Ne;0;0;11;11
13474;Žemyna;Pelėdžiukai;37570629861;Ne;9;4;0;13
13475;Žemyna;Pelėdžiukai;59506345859;Ne;0;4;1;5
13476;Žemyna;Pelėdžiukai;85135645557;Ne;6;0;0;6
13477;Žemyna;Pelėdžiukai;38769607968;Ne;6;0;0;6
13478;Žemyna;Pelėdžiukai;4235160760;Ne;2;0;1;3
13479;Žemyna;Pelėdžiukai;6618285685;Ne;0;0;3;3
13480;Žemyna;Pelėdžiukai;5306392307;Ne;0;4;4;8
13481;Žemyna;Pelėdžiukai;8096035110;Ne;0;0;1;1
13482;Žemyna;Pelėdžiukai;1687206394;Ne;5;0;1;6
13483;Žemyna;Pelėdžiukai;93423088394;Ne;0;10;0;10
13484;Žemyna;Pelėdžiukai;5506889213;Ne;0;0;1;1
13485;Žemyna;Pelėdžiukai;5815116293;Ne;4;0;0;4
13486;Žemyna;Pelėdžiukai;13242930752;Ne;2;0;0;2
13487;Žemyna;Pelėdžiukai;89787441782;Ne;0;1;0;1
13488;Žemyna;Pelėdžiukai;9224203811;Ne;1;0;3;4
13489;Žemyna;Pelėdžiukai;2527337934;Ne;6;1;0;7
13490;Žemyna;Pelėdžiukai;1867198805;Ne;0;6;0;6
13491;Žemyna;Vijurkai;8500642069;Ne;0;0;1;1
13492;Žemyna;Vijurkai;9148594407;Ne;0;0;3;3
13493;Žemyna;Vijurkai;6812823390;Ne;0;0;2;2
13494;Žemyna;Vijurkai;3938938667;Ne;1;0;1;2
13495;Žemyna;Vijurkai;7693278353;Ne;0;7;0;7
13496;Žemyna;Vijurkai;6430348135;Ne;0;3;0;3
13497;Žemyna;Vijurkai;3357339710;Ne;15;0;0;15
13498;Žemyna;Vijurkai;7925774308;Ne;4;0;4;8
13499;Žemyna;Vijurkai;1531980297;Ne;0;0;3;3
13500;Žemyna;Vijurkai;9866110744;Ne;0;0;3;3
13501;Žemyna;Vijurkai;2412956023;Ne;0;7;0;7
13502;Žemyna;Vijurkai;1118997229;Ne;0;1;0;1
13503;Žemyna;Vijurkai;5318574856;Ne;0;0;2;2
13504;Žemyna;Vijurkai;1264659113;Ne;0;6;0;6
13505;Žemyna;Vijurkai;4410293832;Ne;0;0;5;5
13506;Žemyna;Vijurkai;1652681820;Ne;0;0;1;1
13507;Žemyna;Šnekučiai;6735720135;Ne;2;2;7;11
13508;Žemyna;Šnekučiai;2006173745;Ne;5;0;0;5
13509;Žemyna;Šnekučiai;6116581655;Ne;3;0;0;3
13510;Žemyna;Šnekučiai;7280740926;Ne;5;1;0;6
13511;Žemyna;Šnekučiai;6419974691;Ne;2;1;2;5
13512;Žemyna;Šnekučiai;9818711030;Ne;6;4;0;10
13513;Žemyna;Šnekučiai;7764615445;Ne;3;1;0;4
13514;Žemyna;Šnekučiai;5868208651;Ne;0;1;0;1
13515;Žemyna;Šnekučiai;3992383447;Ne;10;0;2;12
13516;Žemyna;Šnekučiai;6856737270;Ne;3;1;0;4
13517;Žemyna;Šnekučiai;5188496664;Ne;5;0;0;5
13518;Žemyna;Šnekučiai;4872348199;Ne;10;0;0;10
13519;Žemyna;Šnekučiai;6878669773;Ne;0;9;1;10
13520;Žemyna;Šnekučiai;4502958166;Ne;0;7;0;7
13521;Žemyna;Šnekučiai;6728229865;Ne;5;9;0;14
13522;Žemyna;Šnekučiai;2710551760;Ne;0;7;0;7
13523;Žemyna;Šnekučiai;4612112289;Ne;0;2;2;4
13524;Žemyna;Šnekučiai;9568886284;Ne;22;0;0;22
13525;Žemyna;Šnekučiai;3982766622;Ne;0;7;0;7
13526;Žemyna;Pabiručiai;9827401825;Ne;0;4;0;4
13527;Žemyna;Pabiručiai;5743535463;Ne;0;7;0;7
13528;Žemyna;Pabiručiai;6958537154;Ne;0;1;0;1
13529;Žemyna;Pabiručiai;7005045961;Ne;0;9;0;9
13530;Žemyna;Pabiručiai;1745197274;Ne;0;7;0;7
13531;Žemyna;Pabiručiai;6041223291;Ne;0;2;3;5
13532;Žemyna;Pabiručiai;8248443265;Ne;5;0;0;5
13533;Žemyna;Pabiručiai;7122276019;Ne;3;2;0;5
13534;Žemyna;Pabiručiai;9094718595;Ne;5;4;0;9
13535;Žemyna;Pabiručiai;6208953341;Ne;0;4;0;4
13536;Žemyna;Pabiručiai;1656335765;Ne;0;4;0;4
13537;Žemyna;Pabiručiai;5127174926;Ne;0;8;0;8
13538;Žemyna;Pabiručiai;8559870965;Ne;0;2;0;2
13539;Žemyna;Pabiručiai;1850100203;Ne;5;0;0;5
13540;Žemyna;Pabiručiai;6450681255;Ne;9;0;0;9
13541;Žemyna;Pabiručiai;2414400761;Ne;0;8;0;8
13542;Žemyna;Pabiručiai;9511935264;Ne;0;2;0;2
13543;Žemyna;Pabiručiai;4176386795;Ne;3;7;0;10
13544;Žemyna;Pabiručiai;3393414493;Ne;11;0;0;11
13545;Žemyna;Pabiručiai;4960936366;Ne;17;0;4;21
13546;Žemyna;Drugeliai;7564693757;Ne;0;4;3;7
13547;Žemyna;Drugeliai;8302345911;Ne;4;0;0;4
13548;Žemyna;Drugeliai;3505551915;Ne;0;0;4;4
13549;Žemyna;Drugeliai;2231967652;Ne;0;0;8;8
13550;Žemyna;Drugeliai;9171823612;Ne;0;0;22;22
13551;Žemyna;Drugeliai;5518125715;Ne;0;0;5;5
13552;Žemyna;Drugeliai;9589582451;Ne;6;0;1;7
13553;Žemyna;Drugeliai;1279981170;Ne;0;0;3;3
13554;Žemyna;Drugeliai;2102920661;Ne;7;0;0;7
13555;Žemyna;Drugeliai;6575272457;Ne;0;0;2;2
13556;Žemyna;Drugeliai;6164541167;Ne;0;0;3;3
13557;Žemyna;Drugeliai;3390442637;Ne;0;1;2;3
13558;Žemyna;Drugeliai;2371069183;Ne;5;5;0;10
13559;Žemyna;Drugeliai;2139103576;Ne;0;0;1;1
13560;Žemyna;Drugeliai;7920398415;Ne;5;3;0;8
13561;Žemyna;Drugeliai;1695063377;Ne;7;0;0;7
13562;Žemyna;Drugeliai;7745383607;Ne;0;0;1;1
13563;Žemyna;Drugeliai;7661182825;Ne;0;0;1;1
13564;Žemyna;Drugeliai;8709792653;Ne;10;0;0;10
13565;Žemyna;"ŽIRNIUKAI ";4540472310;Ne;14;2;0;16
13566;Žemyna;"ŽIRNIUKAI ";9647706055;Ne;11;0;0;11
13567;Žemyna;"ŽIRNIUKAI ";2883862675;Ne;7;0;0;7
13568;Žemyna;"ŽIRNIUKAI ";8638419172;Ne;4;0;1;5
13569;Žemyna;"ŽIRNIUKAI ";7537145330;Ne;12;1;0;13
13570;Žemyna;"ŽIRNIUKAI ";7683443675;Ne;12;1;0;13
13571;Žemyna;"ŽIRNIUKAI ";5262196604;Ne;0;0;2;2
13572;Žemyna;"ŽIRNIUKAI ";9796331127;Ne;0;4;0;4
13573;Žemyna;"ŽIRNIUKAI ";3996577758;Ne;0;2;7;9
13574;Žemyna;"ŽIRNIUKAI ";6783675344;Ne;9;0;0;9
13575;Žemyna;"ŽIRNIUKAI ";9082375371;Ne;9;0;0;9
13576;Žemyna;"ŽIRNIUKAI ";1795919515;Ne;0;0;5;5
13577;Žemyna;"ŽIRNIUKAI ";3899901920;Ne;0;11;0;11
13578;Žemyna;"ŽIRNIUKAI ";7831778620;Ne;0;7;0;7
13579;Žemyna;"ŽIRNIUKAI ";9692952139;Taip;0;1;0;1
13580;Žemyna;"ŽIRNIUKAI ";3172071074;Ne;0;10;2;12
13581;Žemyna;"ŽIRNIUKAI ";8319442149;Ne;10;1;2;13
13582;Žemyna;"ŽIOGELIAI ";2039344248;Ne;5;1;1;7
13583;Žemyna;"ŽIOGELIAI ";5193466394;Ne;0;12;0;12
13584;Žemyna;"ŽIOGELIAI ";5968816137;Ne;2;0;0;2
13585;Žemyna;"ŽIOGELIAI ";4238528111;Ne;0;1;3;4
13586;Žemyna;"ŽIOGELIAI ";3741459808;Ne;0;1;3;4
13587;Žemyna;"ŽIOGELIAI ";3164469202;Ne;0;2;2;4
13588;Žemyna;"ŽIOGELIAI ";3870917221;Ne;0;8;0;8
13589;Žemyna;"ŽIOGELIAI ";6632827240;Ne;7;0;1;8
13590;Žemyna;"ŽIOGELIAI ";3935318882;Ne;9;0;0;9
13591;Žemyna;"ŽIOGELIAI ";2010676445;Ne;9;0;0;9
13592;Žemyna;"ŽIOGELIAI ";8365200813;Ne;0;0;1;1
13593;Žemyna;"ŽIOGELIAI ";1581399038;Ne;7;0;0;7
13594;Žemyna;"ŽIOGELIAI ";8611258788;Ne;3;0;2;5
13595;Žemyna;"ŽIOGELIAI ";9788890112;Ne;15;0;0;15
13596;Žemyna;"ŽIOGELIAI ";3324631994;Ne;0;0;1;1
13597;Žemuogėlė;Boružiukai;1350671777;Ne;7;1;0;8
13598;Žemuogėlė;Boružiukai;9344628661;Ne;15;1;0;16
13599;Žemuogėlė;Boružiukai;2158359435;Ne;4;7;2;13
13600;Žemuogėlė;Boružiukai;1639634300;Taip;14;6;0;20
13601;Žemuogėlė;Boružiukai;5521993938;Ne;2;6;7;15
13602;Žemuogėlė;Boružiukai;1267222057;Ne;5;1;0;6
13603;Žemuogėlė;Boružiukai;9562512849;Ne;9;12;0;21
13604;Žemuogėlė;Boružiukai;8661864424;Ne;4;0;0;4
13605;Žemuogėlė;Boružiukai;1150466286;Ne;7;8;0;15
13606;Žemuogėlė;Boružiukai;8040255583;Ne;0;13;1;14
13607;Žemuogėlė;Boružiukai;2190458676;Ne;10;9;0;19
13608;Žemuogėlė;Boružiukai;7328566035;Taip;15;5;0;20
13609;Žemuogėlė;Boružiukai;8557325116;Ne;7;0;0;7
13610;Žemuogėlė;Boružiukai;1350383125;Ne;4;15;0;19
13611;Žemuogėlė;Boružiukai;7050896262;Ne;7;9;6;22
13612;Žemuogėlė;Boružiukai;1187953952;Ne;6;1;0;7
13613;Žemuogėlė;Boružiukai;3677459716;Ne;2;11;0;13
13614;Žemuogėlė;Boružiukai;8426601160;Ne;5;1;0;6
13615;Žemuogėlė;Boružiukai;5911215640;Ne;7;11;4;22
13616;Žemuogėlė;Šviesuliukai;3837424301;Ne;0;12;0;12
13617;Žemuogėlė;Šviesuliukai;5499401648;Ne;0;2;0;2
13618;Žemuogėlė;Šviesuliukai;9599829363;Ne;0;5;0;5
13619;Žemuogėlė;Šviesuliukai;3746045950;Ne;0;26;0;26
13620;Žemuogėlė;Šviesuliukai;4663181188;Ne;0;8;0;8
13621;Žemuogėlė;Šviesuliukai;8492878852;Taip;7;0;1;8
13622;Žemuogėlė;Šviesuliukai;7603740057;Ne;16;5;0;21
13623;Žemuogėlė;Šviesuliukai;6755278376;Ne;0;1;1;2
13624;Žemuogėlė;Šviesuliukai;4506847669;Ne;3;6;0;9
13625;Žemuogėlė;Šviesuliukai;7837251012;Ne;2;6;0;8
13626;Žemuogėlė;Šviesuliukai;7189855370;Ne;7;11;0;18
13627;Žemuogėlė;Šviesuliukai;3801534195;Ne;15;13;0;28
13628;Žemuogėlė;Šviesuliukai;1341637008;Ne;3;0;0;3
13629;Žemuogėlė;Šviesuliukai;7288060676;Ne;22;10;0;32
13630;Žemuogėlė;Šviesuliukai;6086270618;Ne;0;10;0;10
13631;Žemuogėlė;Šviesuliukai;7551522580;Ne;0;10;0;10
13632;Žemuogėlė;Šviesuliukai;8890454460;Ne;0;4;0;4
13633;Žemuogėlė;Lašiukai;3190523750;Ne;15;10;0;25
13634;Žemuogėlė;Lašiukai;1251497003;Ne;0;7;0;7
13635;Žemuogėlė;Lašiukai;3706531223;Ne;9;9;0;18
13636;Žemuogėlė;Lašiukai;8029484123;Ne;12;7;0;19
13637;Žemuogėlė;Lašiukai;5992802843;Ne;6;5;0;11
13638;Žemuogėlė;Lašiukai;3753156044;Ne;6;10;0;16
13639;Žemuogėlė;Lašiukai;7592566602;Ne;0;4;3;7
13640;Žemuogėlė;Lašiukai;1555899448;Ne;7;1;0;8
13641;Žemuogėlė;Lašiukai;3546429231;Ne;0;16;0;16
13642;Žemuogėlė;Lašiukai;9579921777;Ne;10;0;0;10
13643;Žemuogėlė;Lašiukai;7137182934;Ne;0;0;2;2
13644;Žemuogėlė;Lašiukai;3073956225;Ne;12;4;0;16
13645;Žemuogėlė;Lašiukai;9693814425;Ne;6;1;1;8
13646;Žemuogėlė;Lašiukai;3825509486;Ne;5;12;0;17
13647;Žemuogėlė;Lašiukai;3059525247;Ne;5;9;0;14
13648;Žemuogėlė;Lašiukai;6747566307;Ne;0;5;0;5
13649;Žemuogėlė;Lašiukai;2115883173;Ne;4;10;7;21
13650;Žemuogėlė;Skambaliukai;54663750186;Ne;0;3;0;3
13651;Žemuogėlė;Skambaliukai;4231767115;Ne;0;7;0;7
13652;Žemuogėlė;Skambaliukai;3977351017;Ne;0;17;0;17
13653;Žemuogėlė;Skambaliukai;5147617128;Ne;7;18;0;25
13654;Žemuogėlė;Skambaliukai;1058207935;Ne;0;3;1;4
13655;Žemuogėlė;Skambaliukai;1628749648;Ne;1;2;0;3
13656;Žemuogėlė;Skambaliukai;6962103028;Ne;0;10;0;10
13657;Žemuogėlė;Skambaliukai;7714826773;Ne;0;11;0;11
13658;Žemuogėlė;Skambaliukai;3134493860;Ne;0;6;0;6
13659;Žemuogėlė;Skambaliukai;1907004376;Ne;0;1;0;1
13660;Žemuogėlė;Skambaliukai;38870047353;Ne;0;1;0;1
13661;Žemuogėlė;Skambaliukai;7403172794;Ne;0;5;1;6
13662;Žemuogėlė;Skambaliukai;9315711142;Ne;0;8;1;9
13663;Žemuogėlė;Skambaliukai;2102057496;Ne;0;16;0;16
13664;Žemuogėlė;Spinduliukai;9955429241;Ne;0;4;0;4
13665;Žemuogėlė;Spinduliukai;5971652934;Ne;0;17;0;17
13666;Žemuogėlė;Spinduliukai;4578291476;Ne;4;18;0;22
13667;Žemuogėlė;Spinduliukai;9534937419;Ne;5;10;0;15
13668;Žemuogėlė;Spinduliukai;6707522989;Ne;3;6;0;9
13669;Žemuogėlė;Spinduliukai;6059069293;Ne;0;16;0;16
13670;Žemuogėlė;Spinduliukai;3041461125;Ne;0;2;0;2
13671;Žemuogėlė;Spinduliukai;8675089149;Ne;0;7;0;7
13672;Žemuogėlė;Spinduliukai;4933948491;Ne;11;6;0;17
13673;Žemuogėlė;Perliukai;4629107942;Ne;17;10;0;27
13674;Žemuogėlė;Perliukai;1306065826;Ne;0;7;0;7
13675;Žemuogėlė;Perliukai;8106709288;Ne;0;3;2;5
13676;Žemuogėlė;Perliukai;2664267604;Ne;10;2;0;12
13677;Žemuogėlė;Perliukai;1060986850;Ne;2;0;0;2
13678;Žemuogėlė;Perliukai;7794377881;Ne;10;1;0;11
13679;Žemuogėlė;Perliukai;1658954821;Ne;0;10;0;10
13680;Žemuogėlė;Perliukai;4698671798;Ne;0;6;5;11
13681;Žemuogėlė;Perliukai;2922827304;Taip;14;6;0;20
13682;Žemuogėlė;Perliukai;7415364637;Ne;5;7;2;14
13683;Žemuogėlė;Perliukai;3710681463;Ne;11;5;0;16
13684;Žemuogėlė;Perliukai;1796489729;Ne;5;2;0;7
13685;Žemuogėlė;Perliukai;8215763877;Ne;3;3;1;7
13686;Žemuogėlė;Perliukai;2934225120;Ne;7;4;0;11
13687;Žemuogėlė;Perliukai;3426685084;Ne;5;11;2;18
13688;Žemuogėlė;Perliukai;9150335499;Ne;11;6;1;18
13689;Žemuogėlė;Perliukai;1079114347;Ne;10;2;0;12
13690;Žemuogėlė;Perliukai;5902241163;Ne;4;8;0;12
13691;Žemuogėlė;Perliukai;7879519193;Taip;0;14;0;14
13692;Žemuogėlė;Perliukai;2109195565;Ne;0;10;0;10
13693;Žemuogėlė;Drugeliai;2745609317;Ne;20;10;0;30
13694;Žemuogėlė;Drugeliai;9694133286;Ne;4;10;0;14
13695;Žemuogėlė;Drugeliai;5557409350;Ne;5;15;0;20
13696;Žemuogėlė;Drugeliai;7668200447;Ne;6;2;0;8
13697;Žemuogėlė;Drugeliai;7148244029;Ne;9;5;0;14
13698;Žemuogėlė;Drugeliai;1901423257;Ne;8;5;0;13
13699;Žemuogėlė;Drugeliai;4862145385;Ne;11;3;0;14
13700;Žemuogėlė;Drugeliai;4368183799;Taip;9;7;0;16
13701;Žemuogėlė;Drugeliai;9902953729;Ne;10;19;0;29
13702;Žemuogėlė;Drugeliai;9537297860;Ne;4;7;0;11
13703;Žemuogėlė;Drugeliai;5170205929;Ne;17;1;0;18
13704;Žemuogėlė;Drugeliai;2428043195;Ne;27;5;0;32
13705;Žemuogėlė;Drugeliai;1716114524;Taip;19;6;0;25
13706;Žemuogėlė;Drugeliai;8137567729;Ne;5;4;0;9
13707;Žemuogėlė;Drugeliai;8348185761;Ne;4;12;0;16
13708;Žemuogėlė;Drugeliai;7974688217;Ne;9;2;0;11
13709;Žemuogėlė;Drugeliai;9273896998;Ne;13;0;0;13
13710;Žemuogėlė;"VIEVERSIUKAI ";6520776378;Ne;5;0;0;5
13711;Žemuogėlė;"VIEVERSIUKAI ";8048818368;Ne;0;1;0;1
13712;Žemuogėlė;"VIEVERSIUKAI ";6577040746;Ne;10;8;0;18
13713;Žemuogėlė;"VIEVERSIUKAI ";9872387354;Ne;7;16;0;23
13714;Žemuogėlė;"VIEVERSIUKAI ";2674188340;Ne;4;0;0;4
13715;Žemuogėlė;"VIEVERSIUKAI ";5300388726;Ne;0;5;0;5
13716;Žemuogėlė;"VIEVERSIUKAI ";4172356209;Taip;7;4;0;11
13717;Žemuogėlė;"VIEVERSIUKAI ";6379837644;Ne;5;2;0;7
13718;Žemuogėlė;"VIEVERSIUKAI ";3104276726;Ne;0;7;2;9
13719;Žemuogėlė;"VIEVERSIUKAI ";3419907292;Ne;8;5;0;13
13720;Žemuogėlė;"VIEVERSIUKAI ";7323868051;Ne;0;3;0;3
13721;Žemuogėlė;"VIEVERSIUKAI ";2800160529;Ne;0;6;0;6
13722;Žemuogėlė;"VIEVERSIUKAI ";8934779062;Ne;22;10;0;32
13723;Žemuogėlė;"VIEVERSIUKAI ";3090630899;Ne;7;3;0;10
13724;Žemuogėlė;"VIEVERSIUKAI ";8091000121;Ne;7;5;0;12
13725;Žemuogėlė;"VIEVERSIUKAI ";2110963483;Ne;9;12;11;32
13726;Žemuogėlė;"VIEVERSIUKAI ";2574719380;Ne;13;8;0;21
13727;Žemuogėlė;"NYKŠTUKAI ";1002937953;Ne;2;0;0;2
13728;Žemuogėlė;"NYKŠTUKAI ";6504659145;Ne;6;2;1;9
13729;Žemuogėlė;"NYKŠTUKAI ";3505090532;Ne;21;0;0;21
13730;Žemuogėlė;"NYKŠTUKAI ";5208043522;Ne;14;0;0;14
13731;Žemuogėlė;"NYKŠTUKAI ";3740127955;Ne;0;2;13;15
13732;Žemuogėlė;"NYKŠTUKAI ";5614510812;Ne;10;2;0;12
13733;Žemuogėlė;"NYKŠTUKAI ";4089939292;Ne;3;0;0;3
13734;Žemuogėlė;"NYKŠTUKAI ";9584172565;Ne;4;8;0;12
13735;Žemuogėlė;"NYKŠTUKAI ";8706379207;Ne;11;4;0;15
13736;Žemuogėlė;"NYKŠTUKAI ";1790341419;Taip;0;1;1;2
13737;Žemuogėlė;"NYKŠTUKAI ";4998981337;Ne;5;7;0;12
13738;Žemuogėlė;"NYKŠTUKAI ";6045257180;Ne;0;0;4;4
13739;Žemuogėlė;"NYKŠTUKAI ";8301927361;Ne;3;7;0;10
13740;Žemuogėlė;"NYKŠTUKAI ";2496321184;Ne;9;2;1;12
13741;Žemuogėlė;"NYKŠTUKAI ";2139102266;Ne;23;0;0;23
13742;Žemuogėlė;"NYKŠTUKAI ";9735379466;Ne;2;7;2;11
13743;Žemuogėlė;KIŠKUČIAI;4654060157;Taip;2;1;1;4
13744;Žemuogėlė;KIŠKUČIAI;2652630375;Ne;9;0;0;9
13745;Žemuogėlė;KIŠKUČIAI;1250186598;Ne;21;0;0;21
13746;Žemuogėlė;KIŠKUČIAI;3287415964;Ne;0;5;0;5
13747;Žemuogėlė;KIŠKUČIAI;5094867109;Ne;0;2;4;6
13748;Žemuogėlė;KIŠKUČIAI;5186248897;Ne;15;10;0;25
13749;Žemuogėlė;KIŠKUČIAI;5125826172;Ne;0;8;0;8
13750;Žemuogėlė;KIŠKUČIAI;8262862183;Ne;7;8;2;17
13751;Žemuogėlė;KIŠKUČIAI;8798113318;Ne;6;2;0;8
13752;Žemuogėlė;KIŠKUČIAI;1280794094;Ne;0;4;1;5
13753;Žemuogėlė;KIŠKUČIAI;2251142510;Ne;15;8;0;23
13754;Žemuogėlė;KIŠKUČIAI;1417355297;Ne;12;2;0;14
13755;Žemuogėlė;KIŠKUČIAI;4974793430;Ne;10;4;3;17
13756;Žemuogėlė;KIŠKUČIAI;6659616731;Ne;12;2;0;14
13757;Žemuogėlė;KIŠKUČIAI;3459960812;Ne;20;2;0;22
13758;Žemuogėlė;Žiniukai;7804015060;Ne;0;7;0;7
13759;Žemuogėlė;Žiniukai;3765022476;Ne;5;14;1;20
13760;Žemuogėlė;Žiniukai;9476688736;Ne;0;4;0;4
13761;Žemuogėlė;Žiniukai;2001471529;Ne;0;7;0;7
13762;Žemuogėlė;Žiniukai;9519563708;Taip;0;1;0;1
13763;Žemuogėlė;Žiniukai;5266493632;Ne;2;2;0;4
13764;Žemuogėlė;Žiniukai;2841634296;Ne;9;5;1;15
13765;Žemuogėlė;Žiniukai;3237083654;Ne;3;7;1;11
13766;Žemuogėlė;Žiniukai;2259779058;Ne;0;5;0;5
13767;Žemuogėlė;Žiniukai;9693894254;Ne;4;2;0;6
13768;Žemuogėlė;Žiniukai;9378432383;Ne;0;2;0;2
13769;Žemuogėlė;Žiniukai;6073971598;Ne;0;5;0;5
13770;Žemuogėlė;Žiniukai;6913038845;Ne;2;3;0;5
13771;Žemuogėlė;Žiniukai;6581889641;Ne;7;11;6;24
13772;Žemuogėlė;Žiniukai;2555902309;Ne;0;23;0;23
13773;Žemuogėlė;Žiniukai;2132549536;Ne;0;6;0;6
13774;Žemuogėlė;Žiniukai;5532053268;Ne;6;0;0;6
13775;Žemuogėlė;Žiniukai;8496353410;Ne;0;1;0;1
13776;Žemuogėlė;Žiniukai;1733808230;Ne;0;8;0;8
13777;Žemuogėlė;Žiniukai;1469759840;Ne;0;4;0;4
13778;Žibutė;PELĖDŽIUKAI;3496675605;Ne;0;11;0;11
13779;Žibutė;PELĖDŽIUKAI;59824395612;Ne;0;6;0;6
13780;Žibutė;PELĖDŽIUKAI;2361682400;Ne;0;5;3;8
13781;Žibutė;PELĖDŽIUKAI;1826763192;Ne;0;4;2;6
13782;Žibutė;PELĖDŽIUKAI;1259481487;Ne;0;8;0;8
13783;Žibutė;PELĖDŽIUKAI;3826875107;Ne;0;2;0;2
13784;Žibutė;PELĖDŽIUKAI;3186792146;Ne;0;5;6;11
13785;Žibutė;PELĖDŽIUKAI;7344095020;Ne;0;2;4;6
13786;Žibutė;PELĖDŽIUKAI;1078105287;Ne;0;3;0;3
13787;Žibutė;PELĖDŽIUKAI;2152452830;Ne;0;2;5;7
13788;Žibutė;PELĖDŽIUKAI;1394895695;Ne;0;4;0;4
13789;Žibutė;PELĖDŽIUKAI;2236930916;Ne;10;0;0;10
13790;Žibutė;PELĖDŽIUKAI;7095870173;Ne;0;8;0;8
13791;Žibutė;PELĖDŽIUKAI;2840754631;Ne;0;10;2;12
13792;Žibutė;PELĖDŽIUKAI;6089325755;Ne;0;7;1;8
13793;Žibutė;PELĖDŽIUKAI;1274409680;Ne;8;10;0;18
13794;Žibutė;PELĖDŽIUKAI;8278928396;Ne;0;0;4;4
13795;Žibutė;PELĖDŽIUKAI;2957525481;Ne;5;13;4;22
13796;Žibutė;PELĖDŽIUKAI;3191351976;Ne;0;1;0;1
13797;Žibutė;PELĖDŽIUKAI;6495108202;Ne;0;3;6;9
13798;Žibutė;KREGŽDUTĖS;7036454359;Ne;0;7;3;10
13799;Žibutė;KREGŽDUTĖS;2406005105;Ne;0;4;1;5
13800;Žibutė;KREGŽDUTĖS;3555071718;Ne;0;10;9;19
13801;Žibutė;KREGŽDUTĖS;5412917352;Ne;5;0;0;5
13802;Žibutė;KREGŽDUTĖS;5187777741;Ne;0;3;0;3
13803;Žibutė;KREGŽDUTĖS;5190377896;Ne;3;7;3;13
13804;Žibutė;KREGŽDUTĖS;6013340521;Ne;0;5;2;7
13805;Žibutė;KREGŽDUTĖS;3574946816;Ne;3;0;0;3
13806;Žibutė;KREGŽDUTĖS;3777544301;Ne;0;3;0;3
13807;Žibutė;KREGŽDUTĖS;9923687090;Ne;22;10;0;32
13808;Žibutė;KREGŽDUTĖS;4847295068;Ne;5;10;12;27
13809;Žibutė;KREGŽDUTĖS;9700866512;Ne;0;3;0;3
13810;Žibutė;KREGŽDUTĖS;7774532200;Ne;0;6;0;6
13811;Žibutė;KREGŽDUTĖS;2607509585;Ne;0;5;0;5
13812;Žibutė;KREGŽDUTĖS;8944042589;Ne;0;4;0;4
13813;Žibutė;KREGŽDUTĖS;2438980348;Ne;0;1;1;2
13814;Žibutė;KREGŽDUTĖS;9918283923;Ne;0;5;0;5
13815;Žibutė;KREGŽDUTĖS;5126232169;Ne;12;10;2;24
13816;Žibutė;KREGŽDUTĖS;8792292819;Ne;18;10;0;28
13817;Žibutė;KREGŽDUTĖS;7668484415;Ne;0;12;0;12
13818;Žibutė;KREGŽDUTĖS;2516448580;Ne;0;22;0;22
13819;Žibutė;BORUŽĖLĖS;4278832423;Ne;9;0;0;9
13820;Žibutė;BORUŽĖLĖS;3066580779;Ne;5;0;0;5
13821;Žibutė;BORUŽĖLĖS;1786332689;Ne;0;0;7;7
13822;Žibutė;BORUŽĖLĖS;8879347884;Ne;0;0;5;5
13823;Žibutė;BORUŽĖLĖS;5186839413;Ne;0;1;0;1
13824;Žibutė;BORUŽĖLĖS;2374119662;Ne;7;3;0;10
13825;Žibutė;BORUŽĖLĖS;1381488132;Ne;0;0;2;2
13826;Žibutė;BORUŽĖLĖS;5591970907;Ne;0;2;0;2
13827;Žibutė;BORUŽĖLĖS;6672033757;Ne;0;10;0;10
13828;Žibutė;BORUŽĖLĖS;7481695788;Ne;2;5;0;7
13829;Žibutė;BORUŽĖLĖS;8155327668;Ne;2;1;0;3
13830;Žibutė;BORUŽĖLĖS;5632520305;Ne;0;0;2;2
13831;Žibutė;BORUŽĖLĖS;4622674814;Ne;0;1;5;6
13832;Žibutė;BORUŽĖLĖS;7805758264;Ne;4;1;0;5
13833;Žibutė;BORUŽĖLĖS;8640664660;Ne;22;0;0;22
13834;Žibutė;BORUŽĖLĖS;7608622330;Ne;0;0;4;4
13835;Žibutė;BITUTĖS;7023683517;Ne;0;13;0;13
13836;Žibutė;BITUTĖS;7853531467;Ne;0;14;0;14
13837;Žibutė;BITUTĖS;3687123871;Ne;3;6;0;9
13838;Žibutė;BITUTĖS;2312717334;Ne;0;15;0;15
13839;Žibutė;BITUTĖS;6361543454;Ne;8;1;0;9
13840;Žibutė;BITUTĖS;1297347740;Ne;0;11;0;11
13841;Žibutė;BITUTĖS;6934760468;Ne;5;3;0;8
13842;Žibutė;BITUTĖS;4455757640;Ne;0;8;7;15
13843;Žibutė;BITUTĖS;8797870379;Ne;3;3;0;6
13844;Žibutė;BITUTĖS;7792267540;Ne;0;9;3;12
13845;Žibutė;BITUTĖS;9221523836;Ne;6;20;0;26
13846;Žibutė;BITUTĖS;3632745935;Ne;0;13;0;13
13847;Žibutė;BITUTĖS;7611641692;Ne;0;5;0;5
13848;Žibutė;BITUTĖS;5112512917;Ne;0;16;7;23
13849;Žibutė;BITUTĖS;8276724226;Ne;6;8;0;14
13850;Žibutė;BITUTĖS;4685356158;Ne;0;4;0;4
13851;Žibutė;BITUTĖS;1515636796;Ne;0;10;1;11
13852;Žibutė;BITUTĖS;7872636200;Ne;5;8;0;13
13853;Žibutė;BITUTĖS;6833179680;Ne;3;10;1;14
13854;Žibutė;BITUTĖS;1614551884;Ne;10;12;2;24
13855;Žibutė;KAČIUKAI;6978977383;Ne;0;2;0;2
13856;Žibutė;KAČIUKAI;9634311146;Ne;0;1;1;2
13857;Žibutė;KAČIUKAI;9868621666;Ne;0;1;3;4
13858;Žibutė;KAČIUKAI;1366469428;Ne;0;12;1;13
13859;Žibutė;KAČIUKAI;4825064521;Ne;0;10;20;30
13860;Žibutė;KAČIUKAI;5826523148;Ne;0;7;2;9
13861;Žibutė;KAČIUKAI;3957898269;Ne;0;6;0;6
13862;Žibutė;KAČIUKAI;4382812297;Ne;0;5;2;7
13863;Žibutė;KAČIUKAI;5591698130;Ne;0;5;0;5
13864;Žibutė;KAČIUKAI;1004098038;Ne;4;10;0;14
13865;Žibutė;KAČIUKAI;7479437931;Ne;5;12;0;17
13866;Žibutė;KAČIUKAI;1362419302;Ne;3;5;0;8
13867;Žibutė;KAČIUKAI;7531027545;Ne;0;10;3;13
13868;Žibutė;KAČIUKAI;3645481894;Ne;0;0;2;2
13869;Žibutė;KAČIUKAI;8880329060;Ne;0;7;0;7
13870;Žibutė;KAČIUKAI;5009495840;Ne;3;0;2;5
13871;Žibutė;KAČIUKAI;7136145033;Ne;0;10;3;13
13872;Žibutė;KAČIUKAI;9498011134;Ne;0;9;0;9
13873;Žibutė;KAČIUKAI;5677389434;Ne;0;8;3;11
13874;Žibutė;KAČIUKAI;5416015554;Ne;4;10;8;22
13875;Žibutė;ZUIKIAI;4741505387;Ne;25;0;0;25
13876;Žibutė;ZUIKIAI;6209156111;Ne;8;6;0;14
13877;Žibutė;ZUIKIAI;2787326978;Ne;0;8;9;17
13878;Žibutė;ZUIKIAI;9856822557;Ne;2;0;0;2
13879;Žibutė;ZUIKIAI;4787010953;Ne;0;4;0;4
13880;Žibutė;ZUIKIAI;3875455223;Ne;4;5;0;9
13881;Žibutė;ZUIKIAI;3449188614;Ne;8;3;1;12
13882;Žibutė;ZUIKIAI;4434623264;Ne;0;8;0;8
13883;Žibutė;ZUIKIAI;9769180056;Ne;20;11;0;31
13884;Žibutė;ZUIKIAI;2013724729;Ne;12;18;0;30
13885;Žibutė;ZUIKIAI;3786933891;Ne;8;4;0;12
13886;Žibutė;ZUIKIAI;9379539151;Ne;2;2;0;4
13887;Žibutė;ZUIKIAI;9439026609;Ne;14;18;0;32
13888;Žibutė;ZUIKIAI;6234135622;Ne;4;13;0;17
13889;Žibutė;ZUIKIAI;8585964720;Ne;7;14;0;21
13890;Žibutė;ZUIKIAI;9793570682;Ne;0;5;0;5
13891;Žibutė;ZUIKIAI;6618315401;Ne;7;0;3;10
13892;Žiedas;Bitutės;4807479784;Ne;0;8;0;8
13893;Žiedas;Bitutės;5513311280;Ne;0;0;11;11
13894;Žiedas;Bitutės;1529988412;Ne;0;2;0;2
13895;Žiedas;Bitutės;1007894628;Ne;3;0;13;16
13896;Žiedas;Bitutės;1625009666;Ne;9;2;2;13
13897;Žiedas;Bitutės;9058688663;Ne;0;12;0;12
13898;Žiedas;Bitutės;7150433256;Ne;0;2;5;7
13899;Žiedas;Bitutės;3414702993;Ne;5;0;0;5
13900;Žiedas;Bitutės;1824692620;Ne;0;10;0;10
13901;Žiedas;Bitutės;2507543124;Ne;0;13;0;13
13902;Žiedas;Bitutės;88471315730;Ne;0;2;3;5
13903;Žiedas;Bitutės;34193530;Ne;0;0;4;4
13904;Žiedas;Bitutės;69485023219;Ne;0;2;0;2
13905;Žiedas;Bitutės;86877563124;Ne;0;0;13;13
13906;Žiedas;Bitutės;78720591915;Ne;0;1;1;2
13907;Žiedas;Bitutės;2026728639;Ne;0;1;0;1
13908;Žiedas;Bitutės;5108263139;Ne;0;2;0;2
13909;Žiedas;Bitutės;5885209631;Ne;0;0;6;6
13910;Žiedas;Bitutės;1048272199;Ne;0;2;0;2
13911;Žiedas;Bitutės;5007348884;Ne;12;0;0;12
13912;Žiedas;Varpeliai;7097790025;Taip;2;9;0;11
13913;Žiedas;Varpeliai;3230107921;Ne;3;2;1;6
13914;Žiedas;Varpeliai;3178778438;Ne;3;10;0;13
13915;Žiedas;Varpeliai;9602083568;Ne;7;0;3;10
13916;Žiedas;Varpeliai;5628720422;Ne;0;5;0;5
13917;Žiedas;Varpeliai;1582961378;Ne;0;1;0;1
13918;Žiedas;Varpeliai;1878050384;Ne;0;0;2;2
13919;Žiedas;Varpeliai;6882614465;Ne;5;4;0;9
13920;Žiedas;Varpeliai;5578227349;Ne;2;3;0;5
13921;Žiedas;Varpeliai;7771247056;Ne;0;1;0;1
13922;Žiedas;Varpeliai;6515510381;Ne;0;2;0;2
13923;Žiedas;Varpeliai;3842589827;Ne;9;0;1;10
13924;Žiedas;Varpeliai;5835309107;Ne;6;2;3;11
13925;Žiedas;Varpeliai;3178580610;Ne;0;8;0;8
13926;Žiedas;Varpeliai;5061575884;Ne;4;2;0;6
13927;Žiedas;Varpeliai;1333233100;Ne;12;2;0;14
13928;Žiedas;Varpeliai;9020540780;Ne;6;5;0;11
13929;Žiedas;Varpeliai;8148831014;Ne;0;0;1;1
13930;Žiedas;Varpeliai;9140396365;Ne;0;7;1;8
13931;Žiedas;Ramunėlės;1333555044;Ne;0;4;0;4
13932;Žiedas;Ramunėlės;5789261620;Ne;5;1;0;6
13933;Žiedas;Ramunėlės;8208331527;Ne;0;1;0;1
13934;Žiedas;Ramunėlės;9037835899;Ne;0;5;0;5
13935;Žiedas;Ramunėlės;5577339739;Ne;0;10;0;10
13936;Žiedas;Ramunėlės;6884933845;Ne;0;3;0;3
13937;Žiedas;Ramunėlės;7548653053;Ne;2;9;0;11
13938;Žiedas;Ramunėlės;1659873036;Ne;0;1;0;1
13939;Žiedas;Ramunėlės;2843328732;Ne;0;6;2;8
13940;Žiedas;Ramunėlės;1243169901;Ne;0;3;0;3
13941;Žiedas;Ramunėlės;1580781723;Ne;1;1;0;2
13942;Žiedas;Ramunėlės;4933650089;Ne;0;1;0;1
13943;Žiedas;Ramunėlės;4044156905;Ne;3;0;5;8
13944;Žiedas;Ramunėlės;4844442247;Ne;15;0;0;15
13945;Žiedas;Ramunėlės;7294671324;Ne;0;1;0;1
13946;Žiedas;Pakalnutės;7798930533;Ne;0;15;0;15
13947;Žiedas;Pakalnutės;1094506858;Ne;0;11;0;11
13948;Žiedas;Pakalnutės;9375048835;Ne;0;5;0;5
13949;Žiedas;Pakalnutės;5266048033;Ne;22;0;0;22
13950;Žiedas;Pakalnutės;5804334198;Ne;0;2;1;3
13951;Žiedas;Pakalnutės;1721956438;Ne;4;0;0;4
13952;Žiedas;Pakalnutės;3742949697;Ne;0;1;0;1
13953;Žiedas;Pakalnutės;6343634478;Taip;10;5;0;15
13954;Žiedas;Pakalnutės;8015880569;Ne;0;1;0;1
13955;Žiedas;Pakalnutės;8857150598;Ne;0;2;0;2
13956;Žiedas;Pakalnutės;2416234016;Ne;9;1;0;10
13957;Žiedas;Pakalnutės;9054709268;Ne;4;3;0;7
13958;Žiedas;Pakalnutės;9964883646;Ne;0;5;0;5
13959;Žiedas;Pakalnutės;4917324037;Ne;0;4;0;4
13960;Žiedas;Pakalnutės;4021189767;Ne;0;2;0;2
13961;Žiedas;Pakalnutės;1346658299;Ne;0;8;0;8
13962;Žiedas;Pakalnutės;4697477761;Ne;0;4;0;4
13963;Žiedas;Pakalnutės;7678333395;Ne;3;2;0;5
13964;Žiedas;Pakalnutės;9207945616;Ne;7;3;0;10
13965;Žiedas;Pakalnutės;2393112381;Ne;0;4;0;4
13966;Žiedas;Rožytės;8645771800;Ne;3;0;6;9
13967;Žiedas;Rožytės;7942276632;Ne;0;2;0;2
13968;Žiedas;Rožytės;7799489700;Ne;0;22;0;22
13969;Žiedas;Rožytės;8163645535;Ne;0;4;0;4
13970;Žiedas;Rožytės;8927034492;Ne;0;22;0;22
13971;Žiedas;Rožytės;8822472312;Ne;0;1;0;1
13972;Žiedas;Rožytės;9021286246;Ne;0;17;0;17
13973;Žiedas;Rožytės;6261847845;Ne;0;2;1;3
13974;Žiedas;Rožytės;5020148822;Ne;0;0;2;2
13975;Žiedas;Rožytės;1844621525;Ne;0;6;0;6
13976;Žiedas;Rožytės;6459679214;Ne;0;13;0;13
13977;Žiedas;Rožytės;6175213274;Ne;0;1;0;1
13978;Žiedas;Rožytės;3984607857;Ne;0;2;3;5
13979;Žiedas;Pumpurėliai;5830738378;Ne;2;0;0;2
13980;Žiedas;Pumpurėliai;2149342412;Ne;2;0;0;2
13981;Žiedas;Pumpurėliai;7780469974;Ne;16;0;0;16
13982;Žiedas;Pumpurėliai;9337317396;Ne;0;1;0;1
13983;Žiedas;Pumpurėliai;1086714229;Ne;16;4;0;20
13984;Žiedas;Pumpurėliai;2320411618;Ne;5;3;0;8
13985;Žiedas;Pumpurėliai;8861734370;Ne;14;4;0;18
13986;Žiedas;Pumpurėliai;7677595571;Ne;7;2;1;10
13987;Žiedas;Pumpurėliai;4699833757;Ne;0;1;0;1
13988;Žiedas;Pumpurėliai;2633676360;Ne;0;0;11;11
13989;Žiedas;Pumpurėliai;8797245208;Ne;0;0;1;1
13990;Žiedas;"Dobiliukai ";1612957739;Ne;0;0;6;6
13991;Žiedas;"Dobiliukai ";9413654318;Ne;7;0;0;7
13992;Žiedas;"Dobiliukai ";6066566242;Ne;0;1;8;9
13993;Žiedas;"Dobiliukai ";8436592169;Ne;0;1;0;1
13994;Žiedas;"Dobiliukai ";3654878543;Ne;5;0;0;5
13995;Žiedas;"Dobiliukai ";8794003030;Ne;2;10;0;12
13996;Žiedas;"Dobiliukai ";8444690698;Ne;22;0;0;22
13997;Žiedas;"Dobiliukai ";2715554681;Taip;10;1;4;15
13998;Žiedas;"Dobiliukai ";2132564079;Ne;16;0;1;17
13999;Žiedas;"Dobiliukai ";9586578606;Taip;0;13;0;13
14000;Žiedas;"Dobiliukai ";3940002957;Taip;10;0;0;10
14001;Žiedas;"Dobiliukai ";5353507617;Ne;6;2;2;10
14002;Žiedas;"Dobiliukai ";4087903129;Ne;0;1;0;1
14003;Žiedas;"Dobiliukai ";8185042446;Ne;0;0;1;1
14004;Žiedas;"Dobiliukai ";7049399327;Ne;9;0;2;11
14005;Žiedas;"Dobiliukai ";5788152675;Ne;2;0;1;3
14006;Žiedas;"Dobiliukai ";8388297947;Ne;0;5;0;5
14007;Žiedas;"Dobiliukai ";3011163947;Ne;0;6;0;6
14008;Žiedas;"Dobiliukai ";6748378606;Ne;5;2;0;7
14009;Žiedas;"Dobiliukai ";6795173519;Ne;0;2;0;2
14010;Žiedas;RŪTELĖS;2134466899;Ne;2;2;0;4
14011;Žiedas;RŪTELĖS;6822887260;Ne;0;4;0;4
14012;Žiedas;RŪTELĖS;5914428064;Ne;0;6;0;6
14013;Žiedas;RŪTELĖS;3857121753;Taip;0;2;3;5
14014;Žiedas;RŪTELĖS;6443633568;Ne;3;2;1;6
14015;Žiedas;RŪTELĖS;7491134119;Ne;2;1;0;3
14016;Žiedas;RŪTELĖS;5959899914;Ne;10;2;0;12
14017;Žiedas;RŪTELĖS;7333813704;Ne;0;2;3;5
14018;Žiedas;RŪTELĖS;6658762922;Ne;0;1;0;1
14019;Žiedas;RŪTELĖS;5703750436;Ne;0;10;0;10
14020;Žiedas;RŪTELĖS;5126173608;Ne;0;2;0;2
14021;Žiedas;RŪTELĖS;1738121071;Ne;0;13;0;13
14022;Žiedas;RŪTELĖS;1253833615;Ne;0;11;0;11
14023;Žiedas;RŪTELĖS;7172793351;Ne;0;1;0;1
14024;Žiedas;RŪTELĖS;9218388800;Ne;4;1;0;5
14025;Žiedas;RŪTELĖS;7072578987;Ne;0;2;4;6
14026;Žiedas;RŪTELĖS;3715928992;Ne;2;2;2;6
14027;Žiedas;RŪTELĖS;9352485926;Ne;2;0;4;6
14028;Žiedas;RŪTELĖS;7578964555;Ne;0;1;0;1
14029;Žiedas;RŪTELĖS;5647232875;Ne;0;4;0;4
14030;Žiedas;RŪTELĖS;5928377774;Ne;0;0;1;1
14031;Žiedas;SAULĖGRĄŽOS;1011602827;Ne;5;2;1;8
14032;Žiedas;SAULĖGRĄŽOS;8887021328;Ne;0;2;1;3
14033;Žiedas;SAULĖGRĄŽOS;2932857132;Ne;10;0;0;10
14034;Žiedas;SAULĖGRĄŽOS;5552786845;Ne;13;2;1;16
14035;Žiedas;SAULĖGRĄŽOS;5658235821;Ne;4;0;0;4
14036;Žiedas;SAULĖGRĄŽOS;4992446383;Ne;2;0;6;8
14037;Žiedas;SAULĖGRĄŽOS;9057761408;Ne;4;0;0;4
14038;Žiedas;SAULĖGRĄŽOS;1645402434;Ne;0;2;0;2
14039;Žiedas;SAULĖGRĄŽOS;2026540724;Ne;0;2;0;2
14040;Žiedas;SAULĖGRĄŽOS;4564268323;Ne;0;4;0;4
14041;Žiedas;SAULĖGRĄŽOS;8801900486;Ne;3;1;0;4
14042;Žiedas;SAULĖGRĄŽOS;1609487830;Ne;0;7;3;10
14043;Žiedas;SAULĖGRĄŽOS;3437651010;Ne;17;2;0;19
14044;Žiedas;SAULĖGRĄŽOS;3422053505;Ne;13;2;0;15
14045;Žiedas;SAULĖGRĄŽOS;5274845525;Ne;10;2;0;12
14046;Žiedas;SAULĖGRĄŽOS;9685152753;Ne;3;0;7;10
14047;Žiedas;SAULĖGRĄŽOS;8819018248;Ne;0;9;0;9
14048;Žiedas;SAULĖGRĄŽOS;3303581707;Ne;0;4;0;4
14049;Žiedas;RUGIAGĖLĖS;1035854293;Ne;0;0;1;1
14050;Žiedas;RUGIAGĖLĖS;1917085385;Ne;0;1;0;1
14051;Žiedas;RUGIAGĖLĖS;5987689515;Ne;6;0;2;8
14052;Žiedas;RUGIAGĖLĖS;1826599535;Ne;2;5;0;7
14053;Žiedas;RUGIAGĖLĖS;3477341028;Ne;0;12;0;12
14054;Žiedas;RUGIAGĖLĖS;2124086277;Ne;0;5;0;5
14055;Žiedas;RUGIAGĖLĖS;1093479755;Ne;1;0;0;1
14056;Žiedas;RUGIAGĖLĖS;7381658912;Ne;0;1;2;3
14057;Žiedas;RUGIAGĖLĖS;1975718197;Ne;0;0;3;3
14058;Žiedas;RUGIAGĖLĖS;2312361963;Ne;0;1;3;4
14059;Žiedas;RUGIAGĖLĖS;6859410675;Ne;7;0;0;7
14060;Žiedas;RUGIAGĖLĖS;2148027253;Taip;18;0;0;18
14061;Žiedas;RUGIAGĖLĖS;1758868055;Ne;0;0;4;4
14062;Žiedas;RUGIAGĖLĖS;2182340305;Taip;8;1;0;9
14063;Žiedas;RUGIAGĖLĖS;3099608553;Ne;13;1;0;14
14064;Žiedas;RUGIAGĖLĖS;1390431397;Ne;10;0;0;10
14065;Žiedas;RUGIAGĖLĖS;9393499257;Ne;5;0;0;5
14066;Žiedas;RUGIAGĖLĖS;2170318597;Ne;0;1;0;1
14067;Žiedas;RUGIAGĖLĖS;7584712202;Ne;0;1;0;1
14068;Žiedas;Boružėlės;4922560649;Ne;0;2;3;5
14069;Žiedas;Boružėlės;6703889237;Ne;0;0;2;2
14070;Žiedas;Boružėlės;2095655987;Ne;0;2;0;2
14071;Žiedas;Boružėlės;7814504623;Ne;2;0;1;3
14072;Žiedas;Boružėlės;9648580306;Ne;0;3;0;3
14073;Žiedas;Boružėlės;9699668892;Ne;0;4;0;4
14074;Žiedas;Boružėlės;5653785844;Ne;0;2;0;2
14075;Žiedas;Boružėlės;9247088735;Ne;10;0;3;13
14076;Žiedas;Boružėlės;7396006218;Ne;0;2;0;2
14077;Žiedas;Boružėlės;5588136738;Ne;0;6;0;6
14078;Žiedas;Boružėlės;6786526552;Ne;9;1;0;10
14079;Žiedas;Boružėlės;2511423525;Ne;0;0;1;1
14080;Žiedas;Boružėlės;6432090199;Ne;10;1;0;11
14081;Žiedas;Boružėlės;5626494892;Ne;9;1;0;10
14082;Žiedas;Boružėlės;7708360056;Ne;0;8;0;8
14083;Žiedas;Boružėlės;7954517383;Ne;0;11;1;12
14084;Žiedas;Boružėlės;1794393042;Ne;0;0;1;1
14085;Žiedas;Boružėlės;2849254119;Ne;5;2;6;13
14086;Žiedas;Boružėlės;9736967156;Ne;0;2;6;8
14087;Žiedas;Boružėlės;3586376571;Ne;0;2;0;2
14088;Žiedas;Boružėlės;1139186052;Ne;0;0;2;2
14089;Žiedas;Boružėlės;3704491209;Ne;10;5;0;15
14090;Žiedas;AGUONĖLĖS;1885623466;Ne;12;1;0;13
14091;Žiedas;AGUONĖLĖS;9464217926;Ne;8;1;0;9
14092;Žiedas;AGUONĖLĖS;9543860953;Ne;5;0;0;5
14093;Žiedas;AGUONĖLĖS;3247328978;Ne;11;1;0;12
14094;Žiedas;AGUONĖLĖS;4250009129;Ne;0;2;1;3
14095;Žiedas;AGUONĖLĖS;7399937598;Ne;10;1;0;11
14096;Žiedas;AGUONĖLĖS;9111149805;Ne;5;1;0;6
14097;Žiedas;AGUONĖLĖS;4695900874;Ne;5;1;0;6
14098;Žiedas;AGUONĖLĖS;3258241663;Ne;0;2;0;2
14099;Žiedas;AGUONĖLĖS;6700593422;Ne;19;1;0;20
14100;Žiedas;AGUONĖLĖS;3835714894;Ne;0;2;0;2
14101;Žiedas;AGUONĖLĖS;7535993061;Ne;0;2;0;2
14102;Žiedas;AGUONĖLĖS;1956219718;Ne;0;2;0;2
14103;Žiedas;AGUONĖLĖS;4809093267;Ne;19;1;0;20
14104;Žiedas;AGUONĖLĖS;1874460511;Ne;4;2;0;6
14105;Žiedas;AGUONĖLĖS;6245366671;Ne;1;3;0;4
14106;Žiedas;AGUONĖLĖS;6856477482;Ne;22;0;0;22
14107;Žiedas;ŽIBUTĖS;8638720939;Ne;6;10;1;17
14108;Žiedas;ŽIBUTĖS;3654749109;Ne;6;3;0;9
14109;Žiedas;ŽIBUTĖS;4039958043;Ne;6;1;0;7
14110;Žiedas;ŽIBUTĖS;1835893385;Ne;22;0;0;22
14111;Žiedas;ŽIBUTĖS;2913328259;Ne;12;2;0;14
14112;Žiedas;ŽIBUTĖS;4568189195;Ne;4;2;0;6
14113;Žiedas;ŽIBUTĖS;2097392327;Ne;0;0;5;5
14114;Žiedas;ŽIBUTĖS;9269909624;Ne;2;0;0;2
14115;Žiedas;ŽIBUTĖS;7114207461;Ne;0;2;0;2
14116;Žiedas;ŽIBUTĖS;5106427067;Taip;10;0;0;10
14117;Žiedas;ŽIBUTĖS;7613786936;Ne;0;17;0;17
14118;Žiedas;ŽIBUTĖS;3407247493;Ne;15;0;0;15
14119;Žiedas;ŽIBUTĖS;8084555994;Taip;9;0;1;10
14120;Žiedas;ŽIBUTĖS;7613786936;Ne;0;17;0;17
14121;Žiedas;ŽIBUTĖS;6923562927;Ne;21;0;0;21
14122;Žiedas;ŽIBUTĖS;1669599543;Taip;20;0;0;20
14123;Žiedas;ŽIBUTĖS;1509140770;Ne;0;2;3;5
14124;Žiedas;ŽIBUTĖS;7498211984;Ne;12;2;0;14
14125;Žiedas;ŽIBUTĖS;3948942801;Ne;0;4;0;4
14126;Žiedas;DRUGELIAI;8517250094;Ne;0;4;0;4
14127;Žiedas;DRUGELIAI;9894489800;Ne;3;0;0;3
14128;Žiedas;DRUGELIAI;2763469583;Ne;0;5;0;5
14129;Žiedas;DRUGELIAI;9757771445;Ne;0;5;0;5
14130;Žiedas;DRUGELIAI;4222689492;Ne;0;2;0;2
14131;Žiedas;DRUGELIAI;2763996098;Ne;8;1;0;9
14132;Žiedas;DRUGELIAI;4983852075;Ne;0;6;0;6
14133;Žiedas;DRUGELIAI;9129315784;Ne;0;12;0;12
14134;Žiedas;DRUGELIAI;7952899220;Taip;0;3;0;3
14135;Žiedas;DRUGELIAI;2679205188;Ne;0;0;1;1
14136;Žiedas;DRUGELIAI;4749655084;Ne;1;4;0;5
14137;Žiedas;DRUGELIAI;9415269410;Ne;10;2;0;12
14138;Žilvitis;ŽIOGELIAI;8776206514;Ne;10;0;0;10
14139;Žilvitis;ŽIOGELIAI;1494531594;Ne;10;0;0;10
14140;Žilvitis;ŽIOGELIAI;5113469572;Ne;10;0;0;10
14141;Žilvitis;ŽIOGELIAI;3753646163;Ne;4;0;0;4
14142;Žilvitis;KREGŽDUTĖS;9229475776;Ne;4;0;0;4
14143;Žilvitis;BORUŽĖLĖS;9983043090;Ne;11;0;0;11
14144;Žilvitis;BORUŽĖLĖS;1318203710;Ne;7;0;0;7
14145;Žilvitis;BITUČIŲ;2014284520;Ne;5;0;0;5
14146;Žilvitis;BITUČIŲ;1968616253;Ne;10;0;0;10
14147;Žilvitis;MEŠKIUKŲ;8176348935;Ne;15;0;0;15
14148;Žilvitis;MEŠKIUKŲ;3216967815;Ne;10;0;0;10
14149;Žilvitis;MEŠKIUKŲ;8973713770;Ne;4;0;0;4
14150;Žilvitis;MEŠKIUKŲ;2859364404;Ne;8;0;0;8
14151;Žilvitis;VOVERIUKAI;5404203018;Ne;10;0;0;10
14152;Žilvitis;VOVERIUKAI;6123846749;Ne;3;0;0;3
14153;Žilvitis;SVAJOKLIAI;7926884684;Ne;5;0;0;5
14154;Žilvitis;SVAJOKLIAI;9495417427;Ne;1;0;0;1
14155;Žilvitis;SVAJOKLIAI;1139159071;Ne;10;0;0;10
14156;Žilvitis;SVAJOKLIAI;3459612961;Ne;4;0;0;4
14157;Žilvitis;PELĖDŽIUKAI;2908294931;Ne;11;0;0;11
14158;Žilvitis;LAŠELIAI;3994140420;Ne;10;0;0;10
14159;Žilvitis;LAŠELIAI;7878844776;Ne;6;0;0;6
14160;Žilvitis;SKRUZDĖLIUKAI;4746730302;Ne;5;0;0;5
14161;Žilvitis;SKRUZDĖLIUKAI;9319247575;Ne;4;0;0;4
14162;Žilvitis;SKRUZDĖLIUKAI;5719080805;Ne;11;0;0;11
14163;Žilvitis;SKRUZDĖLIUKAI;7042232320;Ne;4;0;0;4
14164;Žilvinėlio;UOSIUKAI;4189079983;Ne;2;0;0;2
14165;Žilvinėlio;BANGELĖS;4321916674;Ne;10;0;0;10
14166;Žilvinėlio;BANGELĖS;5314171051;Ne;7;0;0;7
14167;Žilvinėlio;BANGELĖS;4994059828;Ne;8;0;0;8
14168;Žilvinėlio;RAMUNIUKAI;8923515452;Ne;8;0;0;8
14169;Žilvinėlio;RAMUNIUKAI;8118355164;Ne;8;0;0;8
14170;Žilvinėlio;RAMUNIUKAI;3778300288;Ne;9;0;0;9
14171;Žilvinėlio;ŽUVYČIŲ;8883902885;Ne;10;0;0;10
14172;Žilvinėlio;ŽUVYČIŲ;7135960933;Ne;8;0;0;8
14173;Žilvinėlio;EGLUTĖS;5874758363;Ne;5;0;0;5
14174;Žilvinėlio;EGLUTĖS;6273559641;Ne;15;0;0;15
14175;Žilvinėlio;GINTARĖLIAI;2799554227;Ne;5;0;0;5
14176;Žilvinėlio;GINTARĖLIAI;8731320943;Ne;13;0;0;13
14177;Žilvinėlio;GINTARĖLIAI;5870873341;Ne;4;0;0;4
14178;Žilvinėlio;PAUKŠTELIAI;3889484251;Ne;8;0;0;8
14179;Žilvinėlio;DREBULIUKAI;7816896487;Ne;5;0;0;5
14180;Žilvinėlio;DREBULIUKAI;4621511107;Ne;2;0;0;2
14181;Žilvinėlio;ĄŽUOLIUKAI;5714294914;Ne;8;0;0;8
14182;Žilvinėlio;ĄŽUOLIUKAI;8178628875;Ne;15;0;0;15
14183;Žilvinėlio;ĄŽUOLIUKAI;9472207355;Ne;5;0;0;5
14184;Žilvinėlio;ĄŽUOLIUKAI;3271936349;Ne;15;0;0;15
14185;Žilvinėlio;DRUGELIAI;7629852556;Ne;8;0;0;8
14186;Žiogelis;SKRUZDELYTĖS;2959983278;Ne;0;2;0;2
14187;Žiogelis;SKRUZDELYTĖS;6165380986;Ne;0;0;3;3
14188;Žiogelis;SKRUZDELYTĖS;5281321968;Ne;12;0;0;12
14189;Žiogelis;SKRUZDELYTĖS;3214640817;Ne;17;5;0;22
14190;Žiogelis;SKRUZDELYTĖS;1937740173;Ne;8;0;0;8
14191;Žiogelis;SKRUZDELYTĖS;4115425880;Ne;9;0;0;9
14192;Žiogelis;SKRUZDELYTĖS;5737326104;Ne;15;2;0;17
14193;Žiogelis;SKRUZDELYTĖS;7107814348;Ne;10;10;0;20
14194;Žiogelis;SKRUZDELYTĖS;9243862028;Ne;0;1;0;1
14195;Žiogelis;SKRUZDELYTĖS;7395901559;Ne;0;6;0;6
14196;Žiogelis;SKRUZDELYTĖS;9819352425;Ne;3;2;1;6
14197;Žiogelis;SKRUZDELYTĖS;8780773039;Ne;0;20;0;20
14198;Žiogelis;SKRUZDELYTĖS;7881734492;Ne;12;0;0;12
14199;Žiogelis;SKRUZDELYTĖS;2701091043;Ne;0;12;0;12
14200;Žiogelis;SKRUZDELYTĖS;9330018409;Ne;9;0;0;9
14201;Žiogelis;SKRUZDELYTĖS;9120836406;Ne;12;0;0;12
14202;Žiogelis;SKRUZDELYTĖS;6742462116;Ne;9;2;0;11
14203;Žiogelis;SKRUZDELYTĖS;8763533677;Ne;5;2;0;7
14204;Žiogelis;SKRUZDELYTĖS;6608146625;Ne;0;0;3;3
14205;Žiogelis;SKRUZDELYTĖS;9035254979;Ne;22;0;0;22
14206;Žiogelis;ŽIRNIUKAI;2348525913;Ne;5;15;0;20
14207;Žiogelis;ŽIRNIUKAI;2771911603;Ne;0;1;0;1
14208;Žiogelis;ŽIRNIUKAI;4561384361;Ne;11;0;4;15
14209;Žiogelis;ŽIRNIUKAI;6617995346;Ne;0;4;0;4
14210;Žiogelis;ŽIRNIUKAI;7936785905;Taip;3;0;0;3
14211;Žiogelis;ŽIRNIUKAI;9142952548;Ne;0;0;2;2
14212;Žiogelis;ŽIRNIUKAI;4450344120;Ne;0;0;5;5
14213;Žiogelis;ŽIRNIUKAI;8998694866;Ne;6;0;0;6
14214;Žiogelis;ŽIRNIUKAI;3472310047;Ne;8;0;1;9
14215;Žiogelis;ŽIRNIUKAI;8018943297;Ne;10;0;1;11
14216;Žiogelis;ŽIRNIUKAI;2463360858;Ne;0;0;1;1
14217;Žiogelis;ŽIRNIUKAI;1067136657;Ne;14;0;0;14
14218;Žiogelis;ŽIRNIUKAI;9672307977;Ne;0;5;2;7
14219;Žiogelis;ŽIRNIUKAI;5337641310;Ne;5;0;0;5
14220;Žiogelis;ŽIRNIUKAI;4755709634;Ne;7;0;1;8
14221;Žiogelis;ŽIRNIUKAI;2833768296;Ne;0;5;0;5
14222;Žiogelis;ŽIRNIUKAI;6857937795;Ne;11;0;0;11
14223;Žiogelis;ŽIRNIUKAI;9918493914;Ne;16;0;0;16
14224;Žiogelis;ŽIRNIUKAI;3516143432;Ne;7;0;0;7
14225;Žiogelis;ŽIRNIUKAI;3628571567;Ne;0;3;0;3
14226;Žiogelis;DOBILĖLIAI;8683148826;Ne;11;8;0;19
14227;Žiogelis;DOBILĖLIAI;3308563362;Ne;0;1;0;1
14228;Žiogelis;DOBILĖLIAI;2117192553;Ne;0;1;0;1
14229;Žiogelis;DOBILĖLIAI;1465027680;Ne;0;7;0;7
14230;Žiogelis;DOBILĖLIAI;6495456608;Ne;0;1;0;1
14231;Žiogelis;DOBILĖLIAI;5364996984;Ne;10;1;0;11
14232;Žiogelis;DOBILĖLIAI;9568208184;Ne;10;1;0;11
14233;Žiogelis;DOBILĖLIAI;6340620973;Ne;0;1;0;1
14234;Žiogelis;DOBILĖLIAI;5961630249;Ne;2;0;0;2
14235;Žiogelis;DOBILĖLIAI;6532218580;Ne;0;5;0;5
14236;Žiogelis;DOBILĖLIAI;5911231906;Ne;0;1;0;1
14237;Žiogelis;DOBILĖLIAI;9610249055;Ne;0;3;0;3
14238;Žiogelis;DOBILĖLIAI;6115834138;Ne;5;0;1;6
14239;Žiogelis;DOBILĖLIAI;3887222613;Ne;10;0;0;10
14240;Žiogelis;DOBILĖLIAI;7065052244;Ne;10;0;2;12
14241;Žiogelis;DOBILĖLIAI;4103035195;Ne;6;2;0;8
14242;Žiogelis;BORUŽĖLĖS;9295720241;Ne;0;5;0;5
14243;Žiogelis;BORUŽĖLĖS;24941867247;Ne;2;2;0;4
14244;Žiogelis;BORUŽĖLĖS;8819549855;Ne;0;11;0;11
14245;Žiogelis;BORUŽĖLĖS;3189872952;Ne;2;1;0;3
14246;Žiogelis;BORUŽĖLĖS;2883732914;Ne;2;1;0;3
14247;Žiogelis;BORUŽĖLĖS;3503872654;Ne;0;0;3;3
14248;Žiogelis;BORUŽĖLĖS;4445888917;Ne;0;1;0;1
14249;Žiogelis;BORUŽĖLĖS;7881358741;Ne;0;3;0;3
14250;Žiogelis;BORUŽĖLĖS;64865699245;Ne;0;3;0;3
14251;Žiogelis;BORUŽĖLĖS;8702710674;Ne;0;8;0;8
14252;Žiogelis;BORUŽĖLĖS;4671356872;Ne;4;0;1;5
14253;Žiogelis;BORUŽĖLĖS;3750023611;Ne;0;0;1;1
14254;Žiogelis;BORUŽĖLĖS;4343510173;Ne;0;12;0;12
14255;Žiogelis;BORUŽĖLĖS;6659086172;Ne;0;2;0;2
14256;Žiogelis;BORUŽĖLĖS;95713316600;Ne;0;0;4;4
14257;Žiogelis;BORUŽĖLĖS;3203359908;Ne;0;7;0;7
14258;Žiogelis;BORUŽĖLĖS;3320077143;Ne;0;1;0;1
14259;Žiogelis;BORUŽĖLĖS;60959051938;Ne;0;0;2;2
14260;Žiogelis;BORUŽĖLĖS;1609336147;Ne;5;0;0;5
14261;Žiogelis;BORUŽĖLĖS;6346503991;Ne;0;0;15;15
14262;Žiogelis;BORUŽĖLĖS;3560637865;Ne;0;8;0;8
14263;Žiogelis;BORUŽĖLĖS;3420228264;Ne;0;0;3;3
14264;Žiogelis;BORUŽĖLĖS;1996517542;Ne;0;3;0;3
14265;Žiogelis;BORUŽĖLĖS;6760074113;Ne;0;0;3;3
14266;Žiogelis;DRUGELIAI;2797078863;Ne;12;0;6;18
14267;Žiogelis;DRUGELIAI;3813592739;Ne;0;1;0;1
14268;Žiogelis;DRUGELIAI;3820406417;Ne;0;1;16;17
14269;Žiogelis;DRUGELIAI;9533670829;Ne;11;7;1;19
14270;Žiogelis;DRUGELIAI;1673279182;Ne;10;3;0;13
14271;Žiogelis;DRUGELIAI;9964121573;Ne;5;0;7;12
14272;Žiogelis;DRUGELIAI;5104952346;Ne;0;5;1;6
14273;Žiogelis;DRUGELIAI;2622354022;Ne;4;1;0;5
14274;Žiogelis;DRUGELIAI;7462316396;Ne;0;3;0;3
14275;Žiogelis;DRUGELIAI;2243541285;Ne;17;1;0;18
14276;Žiogelis;DRUGELIAI;3810309354;Ne;14;0;0;14
14277;Žiogelis;DRUGELIAI;2326799191;Ne;0;1;1;2
14278;Žiogelis;DRUGELIAI;7974212517;Ne;5;13;0;18
14279;Žiogelis;DRUGELIAI;9423979719;Ne;5;13;0;18
14280;Žiogelis;DRUGELIAI;1833992163;Ne;12;0;0;12
14281;Žiogelis;DRUGELIAI;2529171444;Ne;5;1;0;6
14282;Žiogelis;DRUGELIAI;4946802677;Ne;11;0;0;11
14283;Žiogelis;PELĖDŽIUKAI;7128248940;Ne;0;7;0;7
14284;Žiogelis;PELĖDŽIUKAI;7502572217;Ne;0;2;6;8
14285;Žiogelis;PELĖDŽIUKAI;1134384178;Ne;5;0;2;7
14286;Žiogelis;PELĖDŽIUKAI;5876904663;Ne;0;0;1;1
14287;Žiogelis;PELĖDŽIUKAI;8217782981;Ne;7;0;0;7
14288;Žiogelis;PELĖDŽIUKAI;7120126547;Ne;0;1;0;1
14289;Žiogelis;PELĖDŽIUKAI;9387048672;Ne;0;15;0;15
14290;Žiogelis;PELĖDŽIUKAI;4378941619;Ne;0;2;1;3
14291;Žiogelis;PELĖDŽIUKAI;3937261260;Ne;0;2;2;4
14292;Žiogelis;PELĖDŽIUKAI;8873231715;Ne;0;0;6;6
14293;Žiogelis;PELĖDŽIUKAI;8894068297;Ne;0;2;0;2
14294;Žiogelis;PELĖDŽIUKAI;2759766559;Ne;0;4;0;4
14295;Žiogelis;PELĖDŽIUKAI;7725494899;Ne;0;7;0;7
14296;Žiogelis;PELĖDŽIUKAI;1939672072;Ne;5;5;0;10
14297;Žiogelis;PELĖDŽIUKAI;8689074067;Ne;0;7;3;10
14298;Žiogelis;PELĖDŽIUKAI;1223396469;Ne;7;2;2;11
14299;Žiogelis;PELĖDŽIUKAI;3500076229;Ne;0;10;0;10
14300;Žiogelis;PELĖDŽIUKAI;8715501524;Ne;7;2;10;19
14301;Žiogelis;VARPELIAI;8262619320;Ne;0;11;0;11
14302;Žiogelis;VARPELIAI;3520393042;Ne;0;8;0;8
14303;Žiogelis;VARPELIAI;8983731310;Ne;0;5;0;5
14304;Žiogelis;VARPELIAI;1954544417;Ne;7;0;0;7
14305;Žiogelis;VARPELIAI;9385596579;Ne;3;3;0;6
14306;Žiogelis;VARPELIAI;1447349850;Ne;7;1;0;8
14307;Žiogelis;VARPELIAI;3752358694;Ne;0;14;0;14
14308;Žiogelis;VARPELIAI;6402784913;Ne;6;4;0;10
14309;Žiogelis;VARPELIAI;3502278745;Ne;0;3;0;3
14310;Žiogelis;VARPELIAI;4462189852;Ne;6;4;0;10
14311;Žiogelis;VARPELIAI;9470241656;Ne;17;0;0;17
14312;Žiogelis;VARPELIAI;8133583992;Ne;9;1;0;10
14313;Žiogelis;VARPELIAI;2346231162;Ne;0;5;0;5
14314;Žiogelis;VARPELIAI;6658457517;Ne;0;4;0;4
14315;Žiogelis;VARPELIAI;6650891980;Ne;10;1;0;11
14316;Žiogelis;VARPELIAI;5076511003;Ne;15;0;0;15
14317;Žiogelis;VARPELIAI;1139259000;Ne;11;3;0;14
14318;Žiogelis;VARPELIAI;7992701275;Ne;9;8;0;17
14319;Žiogelis;KREGŽDUTĖS;1309122110;Ne;0;1;0;1
14320;Žiogelis;KREGŽDUTĖS;7704256764;Ne;0;1;0;1
14321;Žiogelis;KREGŽDUTĖS;2028383677;Ne;0;3;0;3
14322;Žiogelis;KREGŽDUTĖS;3910954904;Ne;3;0;0;3
14323;Žiogelis;KREGŽDUTĖS;2233244282;Ne;0;4;0;4
14324;Žiogelis;KREGŽDUTĖS;9862582346;Ne;0;2;2;4
14325;Žiogelis;KREGŽDUTĖS;9406830518;Ne;0;1;0;1
14326;Žiogelis;KREGŽDUTĖS;1320651707;Ne;0;7;0;7
14327;Žiogelis;KREGŽDUTĖS;85437321236;Ne;0;0;1;1
14328;Žiogelis;KREGŽDUTĖS;1320126836;Ne;0;1;0;1
14329;Žiogelis;KREGŽDUTĖS;3310492752;Ne;0;4;0;4
14330;Žiogelis;KREGŽDUTĖS;2366095661;Ne;0;0;2;2
14331;Žiogelis;KREGŽDUTĖS;8675451323;Ne;0;2;0;2
14332;Žiogelis;KREGŽDUTĖS;7087781379;Ne;0;5;0;5
14333;Žiogelis;KREGŽDUTĖS;4015109974;Ne;0;5;0;5
14334;Žiogelis;KREGŽDUTĖS;14932261911;Ne;0;5;0;5
14335;Žiogelis;KREGŽDUTĖS;4713696984;Ne;0;6;0;6
14336;Žiogelis;KREGŽDUTĖS;1442866468;Ne;7;4;0;11
14337;Žiogelis;KREGŽDUTĖS;1660784232;Ne;0;5;6;11
14338;Žiogelis;KREGŽDUTĖS;5579709130;Ne;0;3;0;3
14339;Žiogelis;KREGŽDUTĖS;5340501392;Ne;12;1;0;13
14340;Žiogelis;KREGŽDUTĖS;8979747150;Ne;4;1;0;5
14341;Žiogelis;ŽVIRBLIUKAI;9769735869;Ne;4;0;0;4
14342;Žiogelis;ŽVIRBLIUKAI;1106149118;Ne;3;2;0;5
14343;Žiogelis;ŽVIRBLIUKAI;6284764694;Ne;2;1;0;3
14344;Žiogelis;ŽVIRBLIUKAI;9842311161;Ne;8;0;0;8
14345;Žiogelis;ŽVIRBLIUKAI;5475797764;Ne;7;0;0;7
14346;Žiogelis;ŽVIRBLIUKAI;2036243422;Ne;22;0;0;22
14347;Žiogelis;ŽVIRBLIUKAI;9634291623;Ne;12;1;0;13
14348;Žiogelis;ŽVIRBLIUKAI;7802165127;Ne;9;2;0;11
14349;Žiogelis;ŽVIRBLIUKAI;6491130711;Ne;2;0;1;3
14350;Žiogelis;ŽVIRBLIUKAI;9378236361;Ne;9;0;0;9
14351;Žiogelis;ŽVIRBLIUKAI;5445409452;Ne;9;0;0;9
14352;Žiogelis;ŽVIRBLIUKAI;4155916507;Ne;5;0;0;5
14353;Žiogelis;ŽVIRBLIUKAI;4623532521;Ne;14;2;0;16
14354;Žiogelis;ŽVIRBLIUKAI;6988180082;Ne;7;2;0;9
14355;Žiogelis;ŽVIRBLIUKAI;4677227753;Ne;7;2;0;9
14356;Žiogelis;ŽVIRBLIUKAI;9737574835;Ne;2;0;0;2
14357;Žiogelis;ŽVIRBLIUKAI;5996045442;Ne;5;3;0;8
14358;Žiogelis;BITUTĖS;3752355139;Ne;0;9;2;11
14359;Žiogelis;BITUTĖS;4605250897;Ne;5;0;0;5
14360;Žiogelis;BITUTĖS;2173494736;Ne;0;0;8;8
14361;Žiogelis;BITUTĖS;5042341085;Ne;9;0;0;9
14362;Žiogelis;BITUTĖS;6347738933;Ne;6;2;0;8
14363;Žiogelis;BITUTĖS;9627583831;Ne;0;1;0;1
14364;Žiogelis;BITUTĖS;3792114246;Ne;0;2;0;2
14365;Žiogelis;BITUTĖS;9981130790;Ne;9;3;0;12
14366;Žiogelis;BITUTĖS;3820534331;Ne;8;0;2;10
14367;Žiogelis;BITUTĖS;4630381709;Ne;3;3;0;6
14368;Žiogelis;BITUTĖS;9790463889;Ne;0;9;0;9
14369;Žiogelis;BITUTĖS;6024752960;Ne;0;8;0;8
14370;Žiogelis;BITUTĖS;8853905367;Ne;0;8;0;8
14371;Žiogelis;BITUTĖS;1397686161;Ne;0;6;0;6
14372;Žiogelis;BITUTĖS;2171351454;Ne;0;0;8;8
14373;Žiogelis;BITUTĖS;8835394030;Ne;0;4;0;4
14374;Žiogelis;BITUTĖS;4645245689;Ne;14;1;0;15
14375;Žiogelis;BITUTĖS;9874412804;Ne;0;3;0;3
14376;Žiogelis;BITUTĖS;5139645108;Ne;0;10;0;10
14377;Žiogelis;BITUTĖS;9766966628;Ne;0;15;0;15
14378;Žiogelis;RIEŠUTĖLIAI;8303283893;Ne;8;1;0;9
14379;Žiogelis;RIEŠUTĖLIAI;9863503924;Ne;0;4;0;4
14380;Žiogelis;RIEŠUTĖLIAI;6718866954;Ne;0;0;1;1
14381;Žiogelis;RIEŠUTĖLIAI;9144282935;Ne;0;0;1;1
14382;Žiogelis;RIEŠUTĖLIAI;6039409252;Ne;0;1;5;6
14383;Žiogelis;RIEŠUTĖLIAI;2275123126;Ne;3;2;0;5
14384;Žiogelis;RIEŠUTĖLIAI;4994053705;Ne;16;1;0;17
14385;Žiogelis;RIEŠUTĖLIAI;6048534817;Ne;0;0;7;7
14386;Žiogelis;RIEŠUTĖLIAI;5133034709;Ne;5;6;0;11
14387;Žiogelis;RIEŠUTĖLIAI;2724389716;Ne;9;0;0;9
14388;Žiogelis;RIEŠUTĖLIAI;7763941077;Ne;0;14;2;16
14389;Žiogelis;RIEŠUTĖLIAI;2518015116;Ne;5;0;0;5
14390;Žiogelis;RIEŠUTĖLIAI;5984496369;Ne;4;8;0;12
14391;Žiogelis;RIEŠUTĖLIAI;4587838884;Ne;0;17;0;17
14392;Žiogelis;PAKALNUTĖS;5054228916;Ne;0;5;1;6
14393;Žiogelis;PAKALNUTĖS;8712788346;Ne;10;2;2;14
14394;Žiogelis;PAKALNUTĖS;3428197871;Ne;7;0;0;7
14395;Žiogelis;PAKALNUTĖS;7535167450;Ne;2;0;3;5
14396;Žiogelis;PAKALNUTĖS;3361421852;Ne;0;1;0;1
14397;Žiogelis;PAKALNUTĖS;1268908081;Ne;0;1;2;3
14398;Žiogelis;PAKALNUTĖS;3856321373;Ne;0;9;0;9
14399;Žiogelis;PAKALNUTĖS;6378295945;Ne;6;2;1;9
14400;Žiogelis;PAKALNUTĖS;8959934210;Ne;0;2;0;2
14401;Žiogelis;PAKALNUTĖS;8591680136;Ne;0;7;0;7
14402;Žiogelis;PAKALNUTĖS;6980853713;Ne;0;5;0;5
14403;Žiogelis;PAKALNUTĖS;7340918175;Ne;8;1;0;9
14404;Žiogelis;PAKALNUTĖS;6866685213;Ne;0;1;5;6
14405;Žiogelis;PAKALNUTĖS;5487213418;Ne;0;1;0;1
14406;Žiogelis;PAKALNUTĖS;8058231095;Ne;11;1;0;12
14407;Žiogelis;PAKALNUTĖS;6593794147;Ne;3;4;1;8
14408;Žiogelis;PAKALNUTĖS;1650284820;Ne;10;0;0;10
14409;Žiogelis;PAKALNUTĖS;6515890056;Ne;2;0;0;2
14410;Žiogelis;PAKALNUTĖS;7310459638;Ne;0;2;0;2
14411;Žiogelis;PAKALNUTĖS;1763603533;Ne;19;0;0;19
14412;Žiogelis;PAKALNUTĖS;9813150014;Ne;5;2;0;7
14413;Žiogelis;PAKALNUTĖS;5454676924;Ne;9;0;0;9
14414;Žiogelis;PAKALNUTĖS;7702173581;Ne;6;2;1;9
14415;Žolynėlis;Spanguolėlė;8810441600;Ne;0;2;0;2
14416;Žolynėlis;Spanguolėlė;6440991320;Ne;23;0;4;27
14417;Žolynėlis;Spanguolėlė;3631138915;Ne;0;7;0;7
14418;Žolynėlis;Spanguolėlė;5218448120;Ne;10;0;0;10
14419;Žolynėlis;Spanguolėlė;4076450179;Ne;11;4;0;15
14420;Žolynėlis;Spanguolėlė;4494255525;Ne;0;1;0;1
14421;Žolynėlis;Spanguolėlė;2493633505;Ne;0;0;5;5
14422;Žolynėlis;Spanguolėlė;5438607463;Ne;4;1;1;6
14423;Žolynėlis;Spanguolėlė;5208585298;Ne;0;4;0;4
14424;Žolynėlis;Spanguolėlė;7451189254;Ne;0;0;1;1
14425;Žolynėlis;Spanguolėlė;9498369210;Ne;0;1;0;1
14426;Žolynėlis;Spanguolėlė;7260397656;Ne;0;1;0;1
14427;Žolynėlis;Spanguolėlė;2315947380;Ne;3;2;0;5
14428;Žolynėlis;Spanguolėlė;5074658392;Ne;3;2;0;5
14429;Žolynėlis;Spanguolėlė;1048782636;Ne;5;1;0;6
14430;Žolynėlis;"RŪTELĖ (spec)";4000928238;Ne;0;4;3;7
14431;Žolynėlis;"RŪTELĖ (spec)";5610113641;Ne;0;7;0;7
14432;Žolynėlis;"RŪTELĖ (spec)";9507509872;Ne;10;4;0;14
14433;Žolynėlis;"RŪTELĖ (spec)";2256262371;Ne;0;7;0;7
14434;Žolynėlis;"RŪTELĖ (spec)";1412336878;Ne;6;0;0;6
14435;Žolynėlis;"RŪTELĖ (spec)";8588753136;Ne;2;1;0;3
14436;Žolynėlis;"SAULUTĖ (spec)";9675783636;Ne;12;0;0;12
14437;Žolynėlis;"SAULUTĖ (spec)";7962304738;Ne;0;2;0;2
14438;Žolynėlis;"SAULUTĖ (spec)";6678697536;Ne;17;0;0;17
14439;Žolynėlis;"SAULUTĖ (spec)";6559029399;Ne;8;1;0;9
14440;Žolynėlis;"SAULUTĖ (spec)";3043560150;Ne;0;2;1;3
14441;Žolynėlis;"SAULUTĖ (spec)";3934182673;Ne;0;2;1;3
14442;Žolynėlis;"LINELIS (spec)";2665355759;Ne;0;2;9;11
14443;Žolynėlis;"LINELIS (spec)";2346018814;Ne;0;2;16;18
14444;Žolynėlis;"LINELIS (spec)";1916465295;Ne;0;1;0;1
14445;Žolynėlis;"LINELIS (spec)";3337602618;Ne;17;2;2;21
14446;Žolynėlis;"LINELIS (spec)";8930536051;Ne;0;1;0;1
14447;Žolynėlis;"LINELIS (spec)";2740906284;Ne;0;2;11;13
14448;Žolynėlis;"RASAKILA (spec)";6619551947;Ne;0;10;0;10
14449;Žolynėlis;"RASAKILA (spec)";4337084252;Ne;3;0;0;3
14450;Žolynėlis;"RASAKILA (spec)";8839037219;Ne;0;5;0;5
14451;Žolynėlis;"RASAKILA (spec)";4481343085;Ne;2;1;0;3
14452;Žolynėlis;"RAMUNĖLĖS (spec)";8552635547;Ne;0;2;0;2
14453;Žolynėlis;"RAMUNĖLĖS (spec)";4559404699;Ne;4;1;0;5
14454;Žolynėlis;"RAMUNĖLĖS (spec)";1703785525;Ne;5;1;0;6
14455;Žolynėlis;"RAMUNĖLĖS (spec)";2072569949;Ne;0;2;2;4
14456;Žolynėlis;"RAMUNĖLĖS (spec)";1090944316;Ne;5;2;5;12
14457;Žolynėlis;"RAMUNĖLĖS (spec)";5729519418;Ne;6;2;0;8
14458;Žolynėlis;Dobiliukai;2820649587;Ne;0;7;0;7
14459;Žolynėlis;Dobiliukai;7581436340;Ne;22;0;0;22
14460;Žolynėlis;Dobiliukai;3385748516;Ne;15;5;0;20
14461;Žolynėlis;Dobiliukai;2957426163;Ne;0;0;3;3
14462;Žolynėlis;Dobiliukai;5634886191;Ne;10;0;0;10
14463;Žolynėlis;Dobiliukai;3350246193;Ne;0;9;0;9
14464;Žolynėlis;Dobiliukai;5269388947;Ne;11;1;2;14
14465;Žolynėlis;Dobiliukai;1206144208;Ne;10;1;5;16
14466;Žolynėlis;Dobiliukai;1213384150;Ne;0;12;0;12
14467;Žolynėlis;Dobiliukai;7485033527;Ne;0;3;0;3
14468;Žolynėlis;Dobiliukai;4462289757;Ne;0;0;2;2
14469;Žolynėlis;Dobiliukai;7264446456;Ne;7;1;0;8
14470;Žolynėlis;Aguonėlė;3071570864;Ne;5;2;2;9
14471;Žolynėlis;Aguonėlė;1440666914;Ne;9;5;0;14
14472;Žolynėlis;Aguonėlė;1365534272;Ne;8;2;0;10
14473;Žolynėlis;Aguonėlė;2628636018;Ne;0;2;0;2
14474;Žolynėlis;Aguonėlė;6740105842;Ne;5;7;0;12
14475;Žolynėlis;Aguonėlė;3952731134;Ne;0;2;0;2
14476;Žolynėlis;Aguonėlė;9904373687;Ne;0;1;1;2
14477;Žolynėlis;Aguonėlė;9285539649;Ne;0;13;0;13
14478;Žolynėlis;Aguonėlė;5243624422;Ne;0;2;18;20
14479;Žolynėlis;Aguonėlė;1748987196;Ne;0;9;0;9
14480;Žolynėlis;Aguonėlė;3819863015;Ne;0;0;1;1
14481;Žolynėlis;Aguonėlė;4427274462;Ne;0;0;1;1
14482;Žolynėlis;Pienė;3520272555;Ne;0;1;0;1
14483;Žolynėlis;Pienė;2934361190;Ne;0;14;0;14
14484;Žolynėlis;Pienė;6763515483;Ne;4;1;0;5
14485;Žolynėlis;Pienė;1163753820;Ne;5;0;0;5
14486;Žolynėlis;Pienė;1879046798;Ne;0;2;0;2
14487;Žolynėlis;Pienė;9238832484;Ne;5;2;1;8
14488;Žolynėlis;Pienė;3877168024;Ne;0;4;3;7
14489;Žolynėlis;Pienė;6416217971;Ne;0;6;0;6
14490;Žolynėlis;Pienė;4618251201;Ne;0;3;0;3
14491;Žolynėlis;Pienė;5432464074;Ne;0;3;0;3
14492;Žolynėlis;Pienė;1264022895;Ne;3;2;0;5
14493;Žolynėlis;Pienė;8713225753;Ne;0;5;0;5
14494;Žolynėlis;Pienė;5332349177;Ne;0;10;2;12
14495;Žolynėlis;Pienė;5787331165;Ne;0;2;2;4
14496;Žolynėlis;Pienė;3091749692;Ne;0;4;0;4
14497;Žolynėlis;Pienė;2263679711;Ne;0;2;0;2
14498;Žolynėlis;Pienė;5149512625;Ne;0;1;0;1
14499;Žolynėlis;Pienė;5973298389;Ne;0;2;1;3
14500;Žolynėlis;Čiobreliai;6543503409;Ne;3;6;0;9
14501;Žolynėlis;Čiobreliai;8215427354;Ne;9;0;0;9
14502;Žolynėlis;Čiobreliai;7339496409;Ne;2;0;0;2
14503;Žolynėlis;Čiobreliai;2565770471;Ne;0;10;0;10
14504;Žolynėlis;Čiobreliai;6829144389;Ne;4;6;0;10
14505;Žolynėlis;Čiobreliai;4545601535;Ne;0;1;0;1
14506;Žolynėlis;Čiobreliai;7256502393;Ne;0;1;0;1
14507;Žolynėlis;Čiobreliai;1901979061;Ne;0;3;0;3
14508;Žolynėlis;Čiobreliai;8027151284;Ne;0;2;0;2
14509;Žolynėlis;Čiobreliai;1933377698;Ne;0;5;0;5
14510;Žolynėlis;Čiobreliai;2108221942;Ne;18;0;0;18
14511;Žolynėlis;Čiobreliai;2881461471;Ne;0;2;0;2
14512;Žolynėlis;Čiobreliai;7339110559;Ne;0;7;0;7
14513;Žolynėlis;Čiobreliai;2460982987;Ne;0;4;0;4
14514;Žolynėlis;Čiobreliai;3088932720;Ne;0;2;0;2
14515;Žolynėlis;Čiobreliai;4758738231;Ne;10;1;0;11
14516;Žolynėlis;Čiobreliai;1485195267;Ne;5;1;0;6
14517;Žolynėlis;Avietėlė;4277871671;Ne;3;0;0;3
14518;Žolynėlis;Avietėlė;9404844632;Ne;3;0;0;3
14519;Žolynėlis;Avietėlė;5873931225;Ne;5;2;0;7
14520;Žolynėlis;Avietėlė;6124252688;Ne;0;0;2;2
14521;Žolynėlis;Avietėlė;1266614631;Ne;10;2;0;12
14522;Žolynėlis;Avietėlė;9993230229;Ne;0;1;0;1
14523;Žolynėlis;Avietėlė;7855260478;Ne;0;5;0;5
14524;Žolynėlis;Avietėlė;2718255075;Ne;0;9;0;9
14525;Žolynėlis;Avietėlė;7201413203;Ne;5;0;0;5
14526;Žolynėlis;Avietėlė;6417150398;Taip;13;0;0;13
14527;Žolynėlis;Avietėlė;7517815798;Ne;2;0;0;2
14528;Žolynėlis;Avietėlė;4229530366;Ne;0;2;0;2
14529;Žolynėlis;Avietėlė;9163883190;Ne;22;0;0;22
14530;Žuvėdra;"JŪROS ŽVAIGŽDUTĖS";7272717439;Ne;0;12;0;12
14531;Žuvėdra;"JŪROS ŽVAIGŽDUTĖS";9230342970;Ne;7;0;1;8
14532;Žuvėdra;"JŪROS ŽVAIGŽDUTĖS";2092890028;Ne;0;2;0;2
14533;Žuvėdra;"JŪROS ŽVAIGŽDUTĖS";2334342995;Ne;9;0;0;9
14534;Žuvėdra;"JŪROS ŽVAIGŽDUTĖS";5049101816;Ne;0;6;0;6
14535;Žuvėdra;"JŪROS ŽVAIGŽDUTĖS";1164464390;Ne;0;3;0;3
14536;Žuvėdra;"JŪROS ŽVAIGŽDUTĖS";1200084485;Ne;0;13;0;13
14537;Žuvėdra;"JŪROS ŽVAIGŽDUTĖS";4177319374;Taip;0;13;0;13
14538;Žuvėdra;"JŪROS ŽVAIGŽDUTĖS";7121154799;Ne;6;12;0;18
14539;Žuvėdra;"JŪROS ŽVAIGŽDUTĖS";2858729034;Ne;0;9;0;9
14540;Žuvėdra;"JŪROS ŽVAIGŽDUTĖS";7958768355;Ne;0;8;0;8
14541;Žuvėdra;"JŪROS ŽVAIGŽDUTĖS";6672289932;Ne;12;0;0;12
14542;Žuvėdra;"JŪROS ŽVAIGŽDUTĖS";9733979816;Ne;12;0;3;15
14543;Žuvėdra;"JŪROS ŽVAIGŽDUTĖS";5571732399;Ne;0;0;8;8
14544;Žuvėdra;"JŪROS ŽVAIGŽDUTĖS";3620753237;Ne;10;2;0;12
14545;Žuvėdra;DELFINUKAI;5436158437;Ne;6;1;0;7
14546;Žuvėdra;DELFINUKAI;6952843736;Ne;0;1;0;1
14547;Žuvėdra;DELFINUKAI;2582404760;Ne;0;4;0;4
14548;Žuvėdra;DELFINUKAI;7235005234;Ne;0;1;0;1
14549;Žuvėdra;DELFINUKAI;5876618912;Ne;10;7;0;17
14550;Žuvėdra;DELFINUKAI;6989906913;Ne;0;3;0;3
14551;Žuvėdra;DELFINUKAI;4702627979;Ne;0;6;0;6
14552;Žuvėdra;DELFINUKAI;5002760763;Ne;12;0;0;12
14553;Žuvėdra;DELFINUKAI;7803397430;Ne;4;1;0;5
14554;Žuvėdra;DELFINUKAI;7705946236;Ne;14;1;0;15
14555;Žuvėdra;DELFINUKAI;1974766090;Ne;16;1;0;17
14556;Žuvėdra;DELFINUKAI;8869169590;Ne;8;0;0;8
14557;Žuvėdra;DELFINUKAI;3069506904;Ne;0;4;0;4
14558;Žuvėdra;DELFINUKAI;4146310547;Ne;0;1;0;1
14559;Žuvėdra;DELFINUKAI;5913580058;Ne;0;1;1;2
14560;Žuvėdra;DELFINUKAI;9651268462;Ne;0;3;1;4
14561;Žuvėdra;DELFINUKAI;2082128566;Ne;0;14;1;15
14562;Žuvėdra;OSMINOŽKI;1340241206;Ne;7;0;0;7
14563;Žuvėdra;OSMINOŽKI;5021263583;Ne;0;5;0;5
14564;Žuvėdra;OSMINOŽKI;63053155507;Ne;9;1;0;10
14565;Žuvėdra;OSMINOŽKI;6007871092;Ne;6;1;0;7
14566;Žuvėdra;OSMINOŽKI;2731016281;Ne;0;7;0;7
14567;Žuvėdra;OSMINOŽKI;6612880861;Ne;3;1;0;4
14568;Žuvėdra;OSMINOŽKI;14760907606;Ne;12;0;3;15
14569;Žuvėdra;OSMINOŽKI;5684848140;Ne;0;6;0;6
14570;Žuvėdra;OSMINOŽKI;5489757084;Ne;0;1;0;1
14571;Žuvėdra;OSMINOŽKI;8408371550;Ne;9;0;0;9
14572;Žuvėdra;OSMINOŽKI;5496071972;Ne;0;3;0;3
14573;Žuvėdra;OSMINOŽKI;5273726957;Ne;0;1;0;1
14574;Žuvėdra;OSMINOŽKI;7368183516;Ne;7;6;0;13
14575;Žuvėdra;OSMINOŽKI;3853045274;Ne;0;6;0;6
14576;Žuvėdra;OSMINOŽKI;3185158741;Ne;0;3;0;3
14577;Žuvėdra;OSMINOŽKI;8822952385;Ne;5;2;0;7
14578;Žuvėdra;OSMINOŽKI;5198825127;Ne;7;0;3;10
14579;Žuvėdra;RUSALAČKA;2849503557;Ne;0;1;0;1
14580;Žuvėdra;RUSALAČKA;8700802853;Ne;0;6;0;6
14581;Žuvėdra;RUSALAČKA;3613045982;Ne;4;1;0;5
14582;Žuvėdra;RUSALAČKA;5151984122;Ne;0;4;0;4
14583;Žuvėdra;RUSALAČKA;4715123063;Ne;0;1;0;1
14584;Žuvėdra;RUSALAČKA;6715416675;Ne;0;0;4;4
14585;Žuvėdra;RUSALAČKA;3349158713;Ne;22;0;0;22
14586;Žuvėdra;RUSALAČKA;8942228415;Ne;0;2;1;3
14587;Žuvėdra;RUSALAČKA;8670342549;Ne;0;3;0;3
14588;Žuvėdra;RUSALAČKA;1707519901;Ne;13;2;0;15
14589;Žuvėdra;RUSALAČKA;1810114962;Ne;0;1;0;1
14590;Žuvėdra;RUSALAČKA;1960306957;Ne;0;7;0;7
14591;Žuvėdra;RUSALAČKA;2640238143;Ne;0;11;0;11
14592;Žuvėdra;RUSALAČKA;2577280901;Ne;0;3;0;3
14593;Žuvėdra;RUSALAČKA;5481785360;Ne;0;0;1;1
14594;Žuvėdra;RUSALAČKA;6862766787;Ne;10;3;0;13
14595;Žuvėdra;RUSALAČKA;7387863175;Ne;0;6;0;6
14596;Žuvėdra;JANTARIKI;4893062971;Ne;0;0;2;2
14597;Žuvėdra;JANTARIKI;9200342856;Ne;0;6;0;6
14598;Žuvėdra;JANTARIKI;2197976174;Ne;5;0;0;5
14599;Žuvėdra;JANTARIKI;4881712317;Ne;2;20;0;22
14600;Žuvėdra;JANTARIKI;1929548863;Ne;6;0;0;6
14601;Žuvėdra;JANTARIKI;1072201019;Ne;5;0;0;5
14602;Žuvėdra;JANTARIKI;1993897043;Ne;6;0;0;6
14603;Žuvėdra;JANTARIKI;3058300342;Ne;0;1;0;1
14604;Žuvėdra;JANTARIKI;7227722516;Ne;12;0;0;12
14605;Žuvėdra;JANTARIKI;9256424331;Ne;3;6;0;9
14606;Žuvėdra;JANTARIKI;7908898376;Ne;12;7;0;19
14607;Žuvėdra;JANTARIKI;2789379055;Ne;0;1;0;1
14608;Žuvėdra;JANTARIKI;9838754800;Ne;5;1;0;6
14609;Žuvėdra;JANTARIKI;1039661177;Ne;0;10;0;10
14610;Žuvėdra;JANTARIKI;1604010000;Ne;0;5;0;5
14611;Žuvėdra;"AUKSINĖ ŽUVELĖ";6287034023;Ne;13;0;0;13
14612;Žuvėdra;"AUKSINĖ ŽUVELĖ";2844920302;Ne;0;3;0;3
14613;Žuvėdra;"AUKSINĖ ŽUVELĖ";9460887312;Ne;0;5;0;5
14614;Žuvėdra;"AUKSINĖ ŽUVELĖ";2323431685;Ne;0;3;0;3
14615;Žuvėdra;"AUKSINĖ ŽUVELĖ";5009153711;Taip;13;0;0;13
14616;Žuvėdra;"AUKSINĖ ŽUVELĖ";4739865462;Ne;0;0;1;1
14617;Žuvėdra;"AUKSINĖ ŽUVELĖ";7135848009;Ne;15;1;0;16
14618;Žuvėdra;"AUKSINĖ ŽUVELĖ";3781157324;Ne;12;0;8;20
14619;Žuvėdra;"AUKSINĖ ŽUVELĖ";9215777054;Taip;5;3;0;8
14620;Žvangutis;PELIUKŲ;7616874368;Ne;0;0;4;4
14621;Žvangutis;PELIUKŲ;3906808900;Ne;0;0;1;1
14622;Žvangutis;PELIUKŲ;7722153982;Ne;0;1;0;1
14623;Žvangutis;PELIUKŲ;4295016449;Ne;0;7;0;7
14624;Žvangutis;PELIUKŲ;9958554027;Ne;0;2;0;2
14625;Žvangutis;PELIUKŲ;8592522675;Ne;0;2;0;2
14626;Žvangutis;PELIUKŲ;3957064486;Ne;5;0;0;5
14627;Žvangutis;PELIUKŲ;5112520119;Ne;0;7;0;7
14628;Žvangutis;PELIUKŲ;5817402847;Ne;22;0;0;22
14629;Žvangutis;PELIUKŲ;4407484687;Ne;0;6;0;6
14630;Žvangutis;PELIUKŲ;6788355315;Ne;0;7;0;7
14631;Žvangutis;PELIUKŲ;8062689240;Ne;0;2;0;2
14632;Žvangutis;PELIUKŲ;3875906173;Ne;0;2;0;2
14633;Žvangutis;PELIUKŲ;1328464199;Ne;0;2;3;5
14634;Žvangutis;PELIUKŲ;3546672690;Ne;0;7;0;7
14635;Žvangutis;PELIUKŲ;4992231141;Ne;0;2;0;2
14636;Žvangutis;PELIUKŲ;8481666202;Ne;0;5;0;5
14637;Žvangutis;PELIUKŲ;4705131089;Ne;10;0;0;10
14638;Žvangutis;ANČIUKŲ;6579934222;Ne;0;0;1;1
14639;Žvangutis;ANČIUKŲ;9134683276;Ne;5;0;0;5
14640;Žvangutis;ANČIUKŲ;9145365865;Ne;0;6;0;6
14641;Žvangutis;ANČIUKŲ;3315858185;Ne;0;2;3;5
14642;Žvangutis;ANČIUKŲ;7320625500;Ne;0;1;0;1
14643;Žvangutis;ANČIUKŲ;6110958520;Ne;0;1;0;1
14644;Žvangutis;ANČIUKŲ;7202747419;Ne;4;1;0;5
14645;Žvangutis;ANČIUKŲ;3817258555;Ne;3;1;0;4
14646;Žvangutis;ANČIUKŲ;3775960571;Ne;13;5;0;18
14647;Žvangutis;ANČIUKŲ;7267340112;Ne;0;2;0;2
14648;Žvangutis;ANČIUKŲ;50889154641;Ne;0;0;1;1
14649;Žvangutis;ANČIUKŲ;1310113034;Ne;0;6;0;6
14650;Žvangutis;ANČIUKŲ;3513746926;Ne;0;1;0;1
14651;Žvangutis;ANČIUKŲ;4053450010;Ne;0;1;4;5
14652;Žvangutis;ANČIUKŲ;8511103595;Ne;0;1;3;4
14653;Žvangutis;ANČIUKŲ;6844824726;Ne;0;4;0;4
14654;Žvangutis;ANČIUKŲ;9408369641;Ne;0;3;0;3
14655;Žvangutis;PELĖDŽIUKŲ;1322688456;Ne;0;5;0;5
14656;Žvangutis;PELĖDŽIUKŲ;2570379643;Ne;0;1;0;1
14657;Žvangutis;PELĖDŽIUKŲ;2623107843;Ne;5;2;0;7
14658;Žvangutis;PELĖDŽIUKŲ;1185135525;Ne;0;3;0;3
14659;Žvangutis;PELĖDŽIUKŲ;2411307963;Ne;0;1;0;1
14660;Žvangutis;PELĖDŽIUKŲ;2922083476;Ne;0;10;0;10
14661;Žvangutis;PELĖDŽIUKŲ;1282567366;Ne;5;0;0;5
14662;Žvangutis;PELĖDŽIUKŲ;6068428687;Ne;0;1;0;1
14663;Žvangutis;PELĖDŽIUKŲ;9149037184;Ne;0;3;0;3
14664;Žvangutis;PELĖDŽIUKŲ;3665275100;Ne;0;5;0;5
14665;Žvangutis;PELĖDŽIUKŲ;5012996199;Ne;0;5;0;5
14666;Žvangutis;PELĖDŽIUKŲ;8295525284;Ne;0;2;0;2
14667;Žvangutis;PELĖDŽIUKŲ;3276065009;Ne;0;2;0;2
14668;Žvangutis;PELĖDŽIUKŲ;6040986672;Ne;5;1;0;6
14669;Žvangutis;PELĖDŽIUKŲ;2716216474;Ne;5;5;0;10
14670;Žvangutis;PELĖDŽIUKŲ;5723728310;Ne;3;1;0;4
14671;Žvangutis;PELĖDŽIUKŲ;1404378308;Ne;0;5;0;5
14672;Žvangutis;PELĖDŽIUKŲ;6207989105;Ne;0;2;0;2
14673;Žvangutis;KAČIUKŲ;7213349517;Ne;6;0;0;6
14674;Žvangutis;KAČIUKŲ;7581320158;Ne;4;1;0;5
14675;Žvangutis;KAČIUKŲ;2296360416;Ne;0;6;0;6
14676;Žvangutis;KAČIUKŲ;7721746116;Ne;0;6;0;6
14677;Žvangutis;KAČIUKŲ;2598842770;Ne;12;0;0;12
14678;Žvangutis;KAČIUKŲ;1142315595;Ne;0;2;0;2
14679;Žvangutis;KAČIUKŲ;4696437804;Ne;3;4;0;7
14680;Žvangutis;KAČIUKŲ;8492637734;Ne;0;3;0;3
14681;Žvangutis;KAČIUKŲ;2503355659;Ne;0;1;0;1
14682;Žvangutis;KAČIUKŲ;9235884407;Ne;0;14;0;14
14683;Žvangutis;KAČIUKŲ;8360356476;Ne;0;2;0;2
14684;Žvangutis;KAČIUKŲ;8863909185;Ne;0;4;0;4
14685;Žvangutis;KAČIUKŲ;3498584864;Taip;0;2;0;2
14686;Žvangutis;KAČIUKŲ;4408086513;Ne;0;12;0;12
14687;Žvangutis;KAČIUKŲ;1256264382;Ne;0;14;0;14
14688;Žvangutis;KAČIUKŲ;8030520477;Ne;0;1;10;11
14689;Žvangutis;KAČIUKŲ;5166614226;Ne;0;0;2;2
14690;Žvangutis;KAČIUKŲ;2740875969;Ne;0;0;5;5
14691;Žvangutis;KAČIUKŲ;8269992031;Ne;0;5;0;5
14692;Žvangutis;KAČIUKŲ;1224292338;Ne;0;0;2;2
14693;Žvangutis;MEŠKUČIŲ;8753815074;Taip;5;0;0;5
14694;Žvangutis;MEŠKUČIŲ;3781959962;Ne;0;1;0;1
14695;Žvangutis;MEŠKUČIŲ;8506809320;Ne;0;1;0;1
14696;Žvangutis;MEŠKUČIŲ;8376022173;Ne;5;0;1;6
14697;Žvangutis;MEŠKUČIŲ;6825952779;Ne;6;0;0;6
14698;Žvangutis;MEŠKUČIŲ;4920234186;Ne;3;0;0;3
14699;Žvangutis;MEŠKUČIŲ;1590704985;Ne;7;0;0;7
14700;Žvangutis;MEŠKUČIŲ;1352736819;Taip;9;0;0;9
14701;Žvangutis;MEŠKUČIŲ;5328547183;Ne;5;0;0;5
14702;Žvangutis;MEŠKUČIŲ;9523189658;Ne;11;0;0;11
14703;Žvangutis;MEŠKUČIŲ;9406190681;Ne;7;0;0;7
14704;Žvangutis;MEŠKUČIŲ;9883337991;Ne;2;0;0;2
14705;Žvangutis;MEŠKUČIŲ;8598396569;Ne;4;0;2;6
14706;Žvangutis;KIŠKUČIŲ;8906823569;Ne;0;5;0;5
14707;Žvangutis;KIŠKUČIŲ;2308726385;Ne;0;0;1;1
14708;Žvangutis;KIŠKUČIŲ;9711017196;Ne;10;0;1;11
14709;Žvangutis;KIŠKUČIŲ;7051007224;Ne;7;0;0;7
14710;Žvangutis;KIŠKUČIŲ;3940893168;Ne;4;0;1;5
14711;Žvangutis;KIŠKUČIŲ;1592158260;Ne;13;1;0;14
14712;Žvangutis;KIŠKUČIŲ;5022657156;Taip;0;0;1;1
14713;Žvangutis;KIŠKUČIŲ;7645908955;Ne;5;0;0;5
14714;Žvangutis;KIŠKUČIŲ;6741623841;Ne;0;7;0;7
14715;Žvangutis;KIŠKUČIŲ;3029382724;Ne;0;5;0;5
14716;Žvangutis;KIŠKUČIŲ;7844987649;Ne;0;0;1;1
14717;Žvangutis;KIŠKUČIŲ;7599491698;Ne;9;1;0;10
14718;Žvangutis;KIŠKUČIŲ;4128856598;Taip;2;0;1;3
14719;Žvangutis;KIŠKUČIŲ;4968365511;Ne;8;5;0;13
14720;Žirniukas;Boružiukų;5311746004;Ne;0;0;1;1
14721;Žirniukas;Boružiukų;6466220057;Ne;2;10;0;12
14722;Žirniukas;Boružiukų;2785102131;Ne;0;1;0;1
14723;Žirniukas;Boružiukų;6624263476;Ne;0;1;0;1
14724;Žirniukas;Boružiukų;8213507698;Ne;0;2;2;4
14725;Žirniukas;Boružiukų;2528905738;Ne;0;2;1;3
14726;Žirniukas;Boružiukų;6268788036;Ne;5;2;1;8
14727;Žirniukas;Boružiukų;6363169823;Ne;0;1;0;1
14728;Žirniukas;Boružiukų;2636634198;Ne;5;2;0;7
14729;Žirniukas;Boružiukų;8148254025;Ne;5;1;0;6
14730;Žirniukas;Boružiukų;6531175340;Ne;9;0;0;9
14731;Žirniukas;Boružiukų;9647374339;Ne;0;2;1;3
14732;Žirniukas;Boružiukų;6641200341;Ne;0;2;2;4
14733;Žirniukas;Boružiukų;3022672028;Ne;2;12;0;14
14734;Žirniukas;Boružiukų;3909152902;Ne;0;1;0;1
14735;Žirniukas;Boružiukų;8180092480;Ne;0;0;2;2
14736;Žirniukas;Boružiukų;9896989995;Ne;0;2;1;3
14737;Žirniukas;Boružiukų;5420360864;Ne;0;2;2;4
14738;Žirniukas;Boružiukų;1873446232;Ne;0;0;6;6
14739;Žirniukas;Boružiukų;8294569569;Ne;0;2;8;10
14740;Žirniukas;Boružiukų;7397202752;Ne;0;2;12;14
14741;Žirniukas;Boružiukų;7190628011;Ne;5;0;6;11
14742;Žirniukas;Smalsučiai;2557138057;Ne;0;14;0;14
14743;Žirniukas;Smalsučiai;8644938346;Ne;0;6;0;6
14744;Žirniukas;Smalsučiai;5761169841;Ne;10;0;0;10
14745;Žirniukas;Smalsučiai;5104110821;Ne;0;2;4;6
14746;Žirniukas;Smalsučiai;5471647472;Ne;0;2;0;2
14747;Žirniukas;Smalsučiai;2151329751;Ne;0;1;0;1
14748;Žirniukas;Smalsučiai;2049123663;Ne;0;0;4;4
14749;Žirniukas;Smalsučiai;3010062747;Ne;0;9;4;13
14750;Žirniukas;Smalsučiai;2162238771;Ne;0;2;0;2
14751;Žirniukas;Smalsučiai;1064894307;Ne;6;2;1;9
14752;Žirniukas;Smalsučiai;2029018108;Ne;0;4;1;5
14753;Žirniukas;Smalsučiai;2309995947;Ne;0;2;0;2
14754;Žirniukas;Smalsučiai;7644911127;Ne;0;2;5;7
14755;Žirniukas;Smalsučiai;1514504241;Ne;0;1;0;1
14756;Žirniukas;Smalsučiai;6180439078;Ne;0;2;3;5
14757;Žirniukas;Smalsučiai;5987510202;Ne;5;5;0;10
14758;Žirniukas;Smalsučiai;7975957714;Ne;0;2;3;5
14759;Žirniukas;Smalsučiai;3808838764;Ne;0;1;0;1
14760;Žirniukas;Smalsučiai;9896415564;Ne;0;2;0;2
14761;Žirniukas;Smalsučiai;9374080010;Ne;0;0;6;6
14762;Žirniukas;Smalsučiai;1678041002;Ne;0;2;4;6
14763;Žirniukas;Gėlyčių;2982628594;Ne;0;0;1;1
14764;Žirniukas;Gėlyčių;6121388208;Ne;7;0;0;7
14765;Žirniukas;Gėlyčių;6201949014;Ne;0;0;3;3
14766;Žirniukas;Gėlyčių;3370588608;Ne;0;0;1;1
14767;Žirniukas;Gėlyčių;7872611724;Ne;0;0;4;4
14768;Žirniukas;Gėlyčių;9497414375;Ne;0;0;6;6
14769;Žirniukas;Gėlyčių;5422282267;Ne;0;7;1;8
14770;Žirniukas;Gėlyčių;3189741449;Ne;0;1;0;1
14771;Žirniukas;Gėlyčių;5427116799;Ne;0;0;2;2
14772;Žirniukas;Gėlyčių;3214136760;Ne;0;3;0;3
14773;Žirniukas;Gėlyčių;6147030672;Ne;5;0;0;5
14774;Žirniukas;Nykštukų;2746074694;Ne;2;0;0;2
14775;Žirniukas;Nykštukų;4282344625;Ne;2;10;0;12
14776;Žirniukas;Nykštukų;3874713264;Ne;0;6;0;6
14777;Žirniukas;Nykštukų;1532129054;Ne;0;9;4;13
14778;Žirniukas;Nykštukų;7368124402;Ne;0;1;0;1
14779;Žirniukas;Nykštukų;1635353228;Ne;6;1;0;7
14780;Žirniukas;Nykštukų;2526769571;Ne;0;1;0;1
14781;Žirniukas;Nykštukų;2027344763;Ne;0;0;3;3
14782;Žirniukas;Nykštukų;4732089209;Ne;0;1;0;1
14783;Žirniukas;Nykštukų;9988669252;Ne;2;0;0;2
14784;Žirniukas;Nykštukų;8242086461;Ne;0;10;0;10
14785;Žirniukas;Nykštukų;8242086461;Ne;0;10;0;10
14786;Žirniukas;Nykštukų;8242086461;Ne;0;10;0;10
14787;Žirniukas;Nykštukų;6511802399;Ne;0;10;0;10
14788;Žirniukas;Nykštukų;6511802399;Ne;0;10;0;10
14789;Žirniukas;Nykštukų;6511802399;Ne;0;10;0;10
14790;Žirniukas;Saulytės;9649896460;Ne;0;15;0;15
14791;Žirniukas;Saulytės;5819443551;Ne;0;1;0;1
14792;Žirniukas;Saulytės;2733313392;Ne;0;3;0;3
14793;Žirniukas;Saulytės;7927815250;Ne;0;2;1;3
14794;Žirniukas;Saulytės;2325139043;Ne;0;2;2;4
14795;Žirniukas;Saulytės;6362626389;Ne;0;2;0;2
14796;Žirniukas;Saulytės;9656768968;Ne;7;1;0;8
14797;Žirniukas;Saulytės;4045432303;Ne;0;5;0;5
14798;Žirniukas;Saulytės;1074945082;Ne;0;6;2;8
14799;Žirniukas;Saulytės;4229687519;Ne;4;0;0;4
14800;Žirniukas;Saulytės;8599313527;Ne;0;3;2;5
14801;Žirniukas;Saulytės;4320686646;Ne;0;6;0;6
14802;Žirniukas;Saulytės;6096664609;Ne;0;2;0;2
14803;Žirniukas;Drugelių;6271194358;Ne;0;1;0;1
14804;Žirniukas;Drugelių;9232828844;Ne;0;2;0;2
14805;Žirniukas;Drugelių;5269074776;Ne;5;0;11;16
14806;Žirniukas;Drugelių;3509857181;Ne;0;0;2;2
14807;Žirniukas;Drugelių;2517524802;Ne;0;1;0;1
14808;Žirniukas;Drugelių;9901196251;Ne;2;0;3;5
14809;Žirniukas;Drugelių;4762596462;Ne;0;0;3;3
14810;Žirniukas;Drugelių;1826203483;Ne;0;1;6;7
14811;Žirniukas;Drugelių;4536071547;Ne;0;1;6;7
14812;Žirniukas;Drugelių;6501961029;Ne;1;1;1;3
14813;Žirniukas;Drugelių;3996393849;Ne;0;1;6;7
14814;Žirniukas;Drugelių;6300372863;Ne;0;3;0;3
14815;Žirniukas;Drugelių;5670489807;Ne;0;7;0;7
14816;Žirniukas;Drugelių;9794535841;Ne;5;0;3;8
14817;Žirniukas;Drugelių;1018506580;Ne;0;2;9;11
14818;Žirniukas;Drugelių;6993784924;Ne;0;0;2;2
14819;Žirniukas;Drugelių;9384464752;Ne;0;2;3;5
14820;Žirniukas;Pelėdžiukai;7889803840;Ne;0;1;0;1
14821;Žirniukas;Pelėdžiukai;2895924102;Ne;0;0;3;3
14822;Žirniukas;Pelėdžiukai;4347695841;Ne;4;0;6;10
14823;Žirniukas;Pelėdžiukai;4847093256;Ne;0;2;0;2
14824;Žirniukas;Pelėdžiukai;7356213150;Ne;0;16;0;16
14825;Žirniukas;Pelėdžiukai;7545458622;Ne;0;6;13;19
14826;Žirniukas;Pelėdžiukai;8354728917;Ne;0;2;0;2
14827;Žirniukas;Pelėdžiukai;5376080603;Ne;0;0;5;5
14828;Žirniukas;Pelėdžiukai;9511974432;Ne;0;0;7;7
14829;Žirniukas;Pelėdžiukai;7755938379;Ne;10;1;0;11
14830;Žirniukas;Pelėdžiukai;5470692657;Ne;12;2;5;19
14831;Žirniukas;Pelėdžiukai;8690042163;Ne;3;0;0;3
14832;Žirniukas;Pelėdžiukai;2332260494;Ne;5;0;0;5
14833;Žirniukas;Pelėdžiukai;6941160450;Ne;3;2;0;5
14834;Žirniukas;Pelėdžiukai;3907578167;Ne;14;0;0;14
14835;Žirniukas;Pelėdžiukai;4069128550;Ne;0;0;1;1
14836;Žirniukas;Pelėdžiukai;7767762079;Ne;6;5;0;11
14837;Žirniukas;ZUIKUČIAI;1345594362;Ne;0;2;2;4
14838;Žirniukas;ZUIKUČIAI;9847840127;Ne;0;1;0;1
14839;Žirniukas;ZUIKUČIAI;5212289551;Ne;0;0;3;3
14840;Žirniukas;ZUIKUČIAI;1005139737;Ne;12;0;0;12
14841;Žirniukas;ZUIKUČIAI;7968189099;Ne;7;2;4;13
14842;Žirniukas;ZUIKUČIAI;7081683726;Ne;5;5;0;10
14843;Žirniukas;ZUIKUČIAI;7021496832;Ne;0;0;2;2
14844;Žirniukas;ZUIKUČIAI;1449763041;Ne;2;2;5;9
14845;Žirniukas;ZUIKUČIAI;4860680720;Ne;0;7;0;7
14846;Žirniukas;ZUIKUČIAI;7269948694;Ne;0;2;2;4
14847;Žirniukas;ZUIKUČIAI;6594686128;Ne;5;3;0;8
14848;Žirniukas;ZUIKUČIAI;9993119353;Ne;0;3;0;3
14849;Žirniukas;ZUIKUČIAI;1679864330;Ne;3;0;0;3
14850;Žirniukas;ZUIKUČIAI;3438394768;Ne;0;9;0;9
14851;Žirniukas;ZUIKUČIAI;9569187800;Ne;22;0;0;22
14852;Žirniukas;ZUIKUČIAI;2302878611;Ne;0;1;0;1
14853;Aušra;Kodėlčiukai;2611563172;Taip;0;10;0;10
14854;Aušra;Kodėlčiukai;3420851059;Ne;6;1;0;7
14855;Aušra;Kodėlčiukai;2199083085;Ne;0;2;0;2
14856;Aušra;Kodėlčiukai;4720749995;Ne;0;7;0;7
14857;Aušra;Kodėlčiukai;5929538617;Ne;0;1;0;1
14858;Aušra;Kodėlčiukai;6139706771;Ne;5;2;0;7
14859;Aušra;Kodėlčiukai;7314273812;Ne;0;2;5;7
14860;Aušra;Kodėlčiukai;4540040693;Ne;18;0;0;18
14861;Aušra;Kodėlčiukai;1423840991;Ne;7;1;0;8
14862;Aušra;Kodėlčiukai;5013135853;Ne;16;0;0;16
14863;Aušra;Kodėlčiukai;9728140172;Taip;0;2;0;2
14864;Aušra;Kodėlčiukai;7765504789;Ne;5;3;0;8
14865;Aušra;Kodėlčiukai;8108663467;Ne;8;0;0;8
14866;Aušra;Kodėlčiukai;4824773027;Ne;5;0;0;5
14867;Aušra;Kodėlčiukai;1897365632;Ne;0;4;1;5
14868;Aušra;Kodėlčiukai;7469266085;Ne;0;19;0;19
14869;Aušra;Kodėlčiukai;1010721404;Ne;0;1;0;1
14870;Aušra;Kodėlčiukai;1883185016;Ne;0;13;0;13
14871;Aušra;Kodėlčiukai;1773343262;Ne;3;1;0;4
14872;Aušra;Kodėlčiukai;9437530221;Ne;12;1;1;14
14873;Aušra;Kodėlčiukai;3627487971;Ne;2;2;0;4
14874;Aušra;"4B klasė";92119607174;Ne;15;0;0;15
14875;Aušra;"4B klasė";22923377435;Ne;1;0;0;1
14876;Aušra;"4B klasė";41852924528;Ne;0;22;0;22
14877;Aušra;"4B klasė";58526614808;Ne;0;22;0;22
14878;Aušra;"4B klasė";41039525379;Ne;11;0;0;11
14879;Aušra;"4B klasė";37339481276;Ne;0;22;0;22
14880;Aušra;"4B klasė";45165946624;Ne;0;22;0;22
14881;Aušra;"4B klasė";59107169775;Ne;4;0;0;4
14882;Aušra;"4B klasė";48349819906;Ne;1;0;0;1
14883;Aušra;"4B klasė";71596384638;Ne;1;0;0;1
14884;Aušra;"4B klasė";52332096506;Ne;1;0;0;1
14885;Aušra;"4B klasė";35703433862;Ne;2;0;0;2
14886;Aušra;"4B klasė";6201728036;Ne;0;22;0;22
14887;Aušra;"4B klasė";36889923728;Ne;0;22;0;22
14888;Aušra;"4B klasė";39957179831;Ne;1;0;0;1
14889;Aušra;"4B klasė";52909474598;Ne;1;0;0;1
14890;Aušra;"4B klasė";8901585006;Ne;0;22;0;22
14891;Aušra;"4B klasė";64562667133;Ne;0;22;0;22
14892;Aušra;"4B klasė";95076478544;Ne;1;0;0;1
14893;Aušra;"4B klasė";36899257479;Ne;1;0;0;1
14894;Aušra;"4B klasė";57520886724;Ne;1;0;0;1
14895;Aušra;"4B klasė";75433637766;Ne;0;22;0;22
14896;Aušra;"4B klasė";83119050626;Ne;0;22;0;22
14897;Aušra;"4B klasė";83119050626;Ne;0;22;0;22
14898;Aušra;Smalsučiai;1450251779;Ne;0;15;0;15
14899;Aušra;Smalsučiai;5409157554;Ne;0;0;4;4
14900;Aušra;Smalsučiai;8176840834;Ne;0;7;0;7
14901;Aušra;Smalsučiai;3680329197;Ne;0;0;2;2
14902;Aušra;Smalsučiai;8740755922;Ne;0;0;3;3
14903;Aušra;Smalsučiai;3898178166;Ne;0;15;0;15
14904;Aušra;Smalsučiai;29499576216;Ne;0;0;2;2
14905;Aušra;Smalsučiai;4404047456;Ne;0;0;1;1
14906;Aušra;Smalsučiai;9702136789;Ne;0;2;1;3
14907;Aušra;Smalsučiai;8709340592;Ne;2;0;2;4
14908;Aušra;Smalsučiai;5673568541;Ne;0;0;9;9
14909;Aušra;Smalsučiai;5524681006;Ne;0;2;1;3
14910;Aušra;Smalsučiai;6384243597;Ne;0;3;0;3
14911;Aušra;Smalsučiai;19402768340;Ne;0;13;0;13
14912;Aušra;Smalsučiai;2523842161;Ne;0;0;7;7
14913;Aušra;Smalsučiai;1343532870;Ne;7;0;0;7
14914;Aušra;Smalsučiai;7043021721;Ne;0;10;0;10
14915;Aušra;Smalsučiai;1612662076;Ne;0;16;0;16
14916;Aušra;Smalsučiai;5777939563;Ne;0;2;0;2
14917;Aušra;Smalsučiai;7814902928;Ne;7;0;0;7
14918;Aušra;"1A klasė";3001784066;Ne;12;0;0;12
14919;Aušra;"1A klasė";84116863778;Ne;12;0;0;12
14920;Aušra;"1A klasė";2227238810;Ne;2;0;0;2
14921;Aušra;"1A klasė";59837942520;Ne;3;0;0;3
14922;Aušra;"1A klasė";11053850075;Ne;2;0;0;2
14923;Aušra;"1A klasė";23609052737;Ne;7;0;0;7
14924;Aušra;"1A klasė";41017803426;Ne;4;0;0;4
14925;Aušra;"1A klasė";21544489661;Ne;6;0;0;6
14926;Aušra;"1A klasė";24625925423;Ne;2;0;0;2
14927;Aušra;"1A klasė";62186117615;Ne;2;0;0;2
14928;Aušra;"1A klasė";3526237179;Ne;2;0;0;2
14929;Aušra;"1A klasė";1893586984;Ne;0;22;0;22
14930;Aušra;"1A klasė";8686777160;Ne;2;0;0;2
14931;Aušra;"1A klasė";15657824495;Ne;3;0;0;3
14932;Aušra;"1A klasė";5988529284;Ne;3;0;0;3
14933;Aušra;"1A klasė";79051821501;Ne;3;0;0;3
14934;Aušra;"1A klasė";2062470430;Ne;2;0;0;2
14935;Aušra;"1A klasė";5815377310;Ne;2;0;0;2
14936;Aušra;"1A klasė";58254707316;Ne;8;0;0;8
14937;Aušra;"1A klasė";1385844067;Ne;2;0;0;2
14938;Aušra;"1A klasė";2121418946;Ne;3;0;0;3
14939;Aušra;"1A klasė";1219257874;Ne;0;22;0;22
14940;Aušra;"1A klasė";4325224130;Ne;7;0;0;7
14941;Aušra;"1A klasė";59267104215;Ne;3;0;0;3
14942;Aušra;"1A klasė";1623803107;Taip;2;0;0;2
14943;Aušra;"1B klasė";1988459596;Ne;1;0;0;1
14944;Aušra;"1B klasė";4930807661;Ne;1;0;0;1
14945;Aušra;"1B klasė";86128256406;Ne;3;0;0;3
14946;Aušra;"1B klasė";50687988382;Ne;1;0;0;1
14947;Aušra;"1B klasė";1021183555;Ne;1;0;0;1
14948;Aušra;"1B klasė";41268510292;Ne;2;0;0;2
14949;Aušra;"1B klasė";8428069167;Ne;6;0;0;6
14950;Aušra;"1B klasė";3910688753;Ne;1;0;0;1
14951;Aušra;"1B klasė";4024898537;Ne;1;0;0;1
14952;Aušra;"1B klasė";1238171728;Ne;1;0;0;1
14953;Aušra;"1B klasė";4103951942;Ne;1;0;0;1
14954;Aušra;"1B klasė";46481555688;Ne;5;0;0;5
14955;Aušra;"1B klasė";1063755068;Ne;3;0;0;3
14956;Aušra;"1B klasė";70844824182;Ne;3;0;0;3
14957;Aušra;"1B klasė";17098859260;Ne;1;0;0;1
14958;Aušra;"1B klasė";9940683245;Ne;1;0;0;1
14959;Aušra;"1B klasė";2841526614;Ne;4;0;0;4
14960;Aušra;"1B klasė";8813044848;Ne;2;0;0;2
14961;Aušra;"1B klasė";58741201573;Ne;2;0;0;2
14962;Aušra;"1B klasė";2003368811;Ne;1;0;0;1
14963;Aušra;"1B klasė";65840410497;Ne;1;0;0;1
14964;Aušra;"1B klasė";1640356242;Ne;1;0;0;1
14965;Aušra;"1B klasė";90604001837;Ne;1;0;0;1
14966;Aušra;"1B klasė";7794899167;Ne;1;0;0;1
14967;Aušra;"2A klasė";5468993286;Ne;2;0;0;2
14968;Aušra;"2A klasė";1167565535;Ne;1;0;0;1
14969;Aušra;"2A klasė";75047415039;Ne;1;0;0;1
14970;Aušra;"2A klasė";85826303673;Ne;3;0;0;3
14971;Aušra;"2A klasė";1145863002;Ne;0;22;0;22
14972;Aušra;"2A klasė";77966124767;Ne;1;0;0;1
14973;Aušra;"2A klasė";1473962346;Ne;6;0;0;6
14974;Aušra;"2A klasė";1049364899;Ne;3;0;0;3
14975;Aušra;"2A klasė";1427235223;Ne;3;0;0;3
14976;Aušra;"2A klasė";97312326369;Ne;4;0;0;4
14977;Aušra;"2A klasė";2019480768;Ne;1;0;0;1
14978;Aušra;"2A klasė";48817619537;Ne;1;0;0;1
14979;Aušra;"2A klasė";55937499558;Ne;1;0;0;1
14980;Aušra;"2A klasė";35779814505;Ne;1;0;0;1
14981;Aušra;"2A klasė";76280361479;Ne;1;0;0;1
14982;Aušra;"2A klasė";2131349938;Ne;1;0;0;1
14983;Aušra;"2A klasė";36447115547;Ne;2;0;0;2
14984;Aušra;"2A klasė";1455625997;Ne;2;0;0;2
14985;Aušra;"2A klasė";1393006122;Ne;2;0;0;2
14986;Aušra;"2A klasė";7998332115;Ne;9;0;0;9
14987;Aušra;"2A klasė";14611425618;Ne;18;0;0;18
14988;Aušra;"2A klasė";31458685084;Ne;1;0;0;1
14989;Aušra;"2A klasė";9603569117;Ne;3;0;0;3
14990;Aušra;"2A klasė";1315930711;Ne;3;0;0;3
14991;Aušra;"2A klasė";42344686036;Ne;8;0;0;8
14992;Aušra;"2A klasė";2647629246;Ne;1;0;0;1
14993;Aušra;"2A klasė";95586246863;Ne;1;0;0;1
14994;Aušra;"2A klasė";4110537888;Ne;5;0;0;5
14995;Aušra;"3A klasė";8510995681;Ne;1;0;0;1
14996;Aušra;"3A klasė";9605206310;Ne;1;0;0;1
14997;Aušra;"3A klasė";3284383302;Ne;1;0;0;1
14998;Aušra;"3A klasė";13157844661;Ne;3;0;0;3
14999;Aušra;"3A klasė";14157070764;Ne;1;0;0;1
15000;Aušra;"3A klasė";99073448709;Ne;0;22;0;22
15001;Aušra;"3A klasė";68160889669;Ne;2;0;0;2
15002;Aušra;"3A klasė";1437126272;Ne;2;0;0;2
15003;Aušra;"3A klasė";15330844181;Ne;2;0;0;2
15004;Aušra;"3A klasė";39537089288;Ne;1;0;0;1
15005;Aušra;"3A klasė";2062775070;Ne;0;22;0;22
15006;Aušra;"3A klasė";3965445196;Ne;1;0;0;1
15007;Aušra;"3A klasė";85578471272;Ne;0;22;0;22
15008;Aušra;"3A klasė";88655846176;Ne;2;0;0;2
15009;Aušra;"3A klasė";73509864636;Ne;1;0;0;1
15010;Aušra;"3A klasė";27958163601;Ne;1;0;0;1
15011;Aušra;"3A klasė";40499781883;Ne;1;0;0;1
15012;Aušra;"3A klasė";68031503463;Ne;0;22;0;22
15013;Aušra;"3A klasė";81633973264;Ne;0;22;0;22
15014;Aušra;"3A klasė";70233681803;Ne;0;22;0;22
15015;Aušra;"3A klasė";1437385365;Ne;0;22;0;22
15016;Aušra;"3A klasė";51185323645;Ne;0;22;0;22
15017;Aušra;"3A klasė";52985512945;Ne;0;22;0;22
15018;Aušra;"3A klasė";97781409787;Ne;0;22;0;22
15019;Aušra;"3A klasė";474412140;Ne;1;0;0;1
15020;Aušra;"3A klasė";40714551025;Ne;1;0;0;1
15021;Aušra;"3A klasė";58699109274;Ne;3;0;0;3
15022;Aušra;"4A klasė";68481706412;Ne;0;22;0;22
15023;Aušra;"4A klasė";99886964420;Ne;0;22;0;22
15024;Aušra;"4A klasė";19920237804;Ne;2;0;0;2
15025;Aušra;"4A klasė";13361663464;Ne;5;0;0;5
15026;Aušra;"4A klasė";95948867937;Ne;0;22;0;22
15027;Aušra;"4A klasė";78030425432;Ne;3;0;0;3
15028;Aušra;"4A klasė";97596344387;Ne;0;22;0;22
15029;Aušra;"4A klasė";97596344387;Ne;0;22;0;22
15030;Aušra;"4A klasė";34795588283;Ne;0;22;0;22
15031;Aušra;"4A klasė";29636399665;Ne;0;22;0;22
15032;Aušra;"4A klasė";81428848455;Ne;0;22;0;22
15033;Aušra;"4A klasė";47725613978;Ne;0;22;0;22
15034;Aušra;"4A klasė";93365393803;Ne;0;22;0;22
15035;Aušra;"4A klasė";52864653926;Ne;5;0;0;5
15036;Aušra;"4A klasė";10272136932;Ne;2;0;0;2
15037;Aušra;"4A klasė";77425098448;Ne;0;21;0;21
15038;Aušra;"4A klasė";20550256232;Ne;0;22;0;22
15039;Aušra;"4A klasė";42015974556;Ne;3;0;0;3
15040;Aušra;"4A klasė";2113586354;Ne;3;0;0;3
15041;Aušra;"4A klasė";19718806057;Ne;0;22;0;22
15042;Aušra;"4A klasė";21856009403;Ne;0;22;0;22
15043;Aušra;"4A klasė";5166358753;Ne;2;0;0;2
15044;Aušra;Pabiručiai;7476662446;Ne;0;0;1;1
15045;Aušra;Pabiručiai;9466807067;Ne;0;0;4;4
15046;Aušra;Pabiručiai;6508435821;Ne;8;0;0;8
15047;Aušra;Pabiručiai;7926621700;Ne;0;2;0;2
15048;Aušra;Pabiručiai;8665364744;Ne;22;0;0;22
15049;Aušra;Pabiručiai;6555345047;Ne;0;3;1;4
15050;Aušra;Pabiručiai;7888891808;Ne;0;0;4;4
15051;Aušra;Pabiručiai;8769357172;Ne;0;1;0;1
15052;Aušra;Pabiručiai;1306616759;Ne;0;3;0;3
15053;Aušra;Pabiručiai;3275288747;Ne;0;8;3;11
15054;Aušra;Pabiručiai;5797692122;Ne;0;3;4;7
15055;Aušra;Pabiručiai;4071233786;Ne;3;0;0;3
15056;Aušra;Pabiručiai;4646215025;Ne;11;0;0;11
15057;Aušra;Pabiručiai;7199483890;Ne;5;2;2;9
15058;Aušra;Pabiručiai;3008573040;Ne;0;2;0;2
15059;Aušra;Pabiručiai;7944904281;Ne;0;1;0;1
15060;Aušra;Pabiručiai;3336605264;Ne;0;0;2;2
15061;Aušra;Pabiručiai;3553620602;Ne;3;5;0;8
15062;Aušra;Pabiručiai;3759593393;Ne;0;2;0;2
15063;Aušra;Pabiručiai;2904303784;Ne;0;1;1;2
15064;Aušra;Pabiručiai;6056923592;Ne;2;3;1;6
15065;Aušra;Pabiručiai;3953653896;Ne;2;7;0;9
15066;Aušra;Pabiručiai;2273160688;Ne;10;0;0;10
15067;Aušra;Pabiručiai;8462418277;Ne;0;2;1;3
15068;Aušra;Gudručiai;2271582954;Ne;7;0;0;7
15069;Aušra;Gudručiai;4564561993;Ne;4;0;0;4
15070;Aušra;Gudručiai;9614562473;Ne;0;1;0;1
15071;Aušra;Gudručiai;6658178519;Ne;5;2;0;7
15072;Aušra;Gudručiai;7921251819;Ne;2;0;0;2
15073;Aušra;Gudručiai;9628651723;Ne;21;0;0;21
15074;Aušra;Gudručiai;3343235857;Ne;3;0;0;3
15075;Aušra;Gudručiai;1337138547;Ne;0;1;0;1
15076;Aušra;Gudručiai;1933801749;Ne;0;1;0;1
15077;Aušra;Gudručiai;5955385407;Ne;4;2;0;6
15078;Aušra;Gudručiai;2243689816;Ne;0;7;0;7
15079;Aušra;Gudručiai;1693711284;Ne;0;7;0;7
15080;Aušra;Gudručiai;6935310711;Ne;0;2;2;4
15081;Aušra;Gudručiai;9079804366;Ne;0;1;0;1
15082;Aušra;Gudručiai;3498143162;Ne;0;1;0;1
15083;Aušra;Gudručiai;5053808615;Ne;5;2;0;7
15084;Aušra;Naminukai;5993984086;Ne;8;0;0;8
15085;Aušra;Naminukai;8884580599;Ne;5;2;0;7
15086;Aušra;Naminukai;6614027605;Ne;8;1;2;11
15087;Aušra;Naminukai;2039920706;Ne;6;1;0;7
15088;Aušra;Naminukai;6965081051;Ne;0;7;0;7
15089;Aušra;Naminukai;2768220823;Ne;9;5;6;20
15090;Aušra;Naminukai;5925213006;Ne;4;12;0;16
15091;Aušra;Naminukai;1630814772;Ne;12;1;0;13
15092;Aušra;Naminukai;9333701196;Ne;0;8;0;8
15093;Aušra;Naminukai;4010347313;Ne;22;0;0;22
15094;Aušra;Naminukai;3860755808;Ne;22;0;0;22
15095;Aušra;Naminukai;4339450816;Ne;3;1;0;4
15096;Aušra;Naminukai;4000881716;Ne;4;1;2;7
15097;Aušra;Naminukai;8021547491;Ne;0;1;0;1
15098;Aušra;Naminukai;5268479689;Ne;17;0;0;17
15099;Aušra;Naminukai;3526010606;Ne;10;0;0;10
15100;Aušra;Naminukai;4163605313;Ne;0;7;0;7
15101;Aušra;Naminukai;3468946868;Ne;5;2;2;9
15102;Aušra;Naminukai;7710131755;Ne;19;0;0;19
15103;Aušra;Naminukai;8584355573;Ne;2;2;3;7
15104;Aušra;Naminukai;2495610772;Ne;6;6;0;12
15105;Aušra;Naminukai;8489362814;Ne;0;2;0;2
15106;Aušra;Naminukai;3675175233;Ne;0;3;0;3
15107;Aušra;" 1C klasė";1426802917;Ne;3;0;0;3
15108;Aušra;" 1C klasė";26010333641;Ne;3;0;0;3
15109;Aušra;" 1C klasė";3133031845;Ne;3;0;0;3
15110;Aušra;" 1C klasė";11130172902;Ne;4;0;0;4
15111;Aušra;" 1C klasė";43737170074;Ne;1;0;0;1
15112;Aušra;" 1C klasė";1370336984;Ne;1;0;0;1
15113;Aušra;" 1C klasė";6483078840;Ne;1;0;0;1
15114;Aušra;" 1C klasė";1684481833;Ne;15;0;0;15
15115;Aušra;" 1C klasė";1198248619;Ne;2;0;0;2
15116;Aušra;" 1C klasė";4765125810;Ne;6;0;0;6
15117;Aušra;" 1C klasė";5704281727;Ne;2;0;0;2
15118;Aušra;" 1C klasė";1479311429;Ne;11;0;0;11
15119;Aušra;" 1C klasė";1542575012;Ne;2;0;0;2
15120;Aušra;" 1C klasė";1291782232;Ne;3;0;0;3
15121;Aušra;" 1C klasė";90520726029;Ne;6;0;0;6
15122;Aušra;" 1C klasė";1844632980;Ne;2;0;0;2
15123;Aušra;" 1C klasė";94478599707;Ne;1;0;0;1
15124;Aušra;" 1C klasė";78489473446;Ne;3;0;0;3
15125;Aušra;" 1C klasė";29328876924;Ne;5;0;0;5
15126;Aušra;" 1C klasė";7649832094;Ne;1;0;0;1
15127;Aušra;" 1C klasė";8225188274;Ne;4;0;0;4
15128;Aušra;" 1C klasė";1371282149;Ne;1;0;0;1
15129;Aušra;" 1C klasė";57559227292;Ne;1;0;0;1
15130;Berželis;PČIOLKI;6113571093;Ne;10;0;0;10
15131;Berželis;PČIOLKI;9024992452;Ne;0;2;3;5
15132;Berželis;PČIOLKI;1521982237;Ne;0;0;4;4
15133;Berželis;PČIOLKI;3298044639;Ne;0;4;1;5
15134;Berželis;PČIOLKI;2615440913;Ne;8;0;1;9
15135;Berželis;PČIOLKI;4013215941;Ne;2;0;0;2
15136;Berželis;PČIOLKI;3772780161;Ne;7;3;0;10
15137;Berželis;PČIOLKI;4563582416;Ne;12;0;0;12
15138;Berželis;PČIOLKI;1225018351;Ne;0;3;0;3
15139;Berželis;PČIOLKI;9894751274;Ne;0;0;1;1
15140;Berželis;PČIOLKI;7526006253;Ne;5;0;1;6
15141;Berželis;PČIOLKI;1036370516;Ne;0;0;1;1
15142;Berželis;PČIOLKI;2214171136;Ne;7;0;1;8
15143;Berželis;PČIOLKI;6473498471;Ne;5;0;2;7
15144;Berželis;PČIOLKI;97218091736;Ne;7;7;0;14
15145;Berželis;PČIOLKI;5798989689;Ne;5;0;0;5
15146;Berželis;PČIOLKI;2007064959;Ne;7;0;2;9
15147;Berželis;PČIOLKI;5084171353;Ne;10;2;0;12
15148;Berželis;PČIOLKI;4521372127;Ne;8;0;0;8
15149;Berželis;PČIOLKI;1067618571;Ne;7;0;0;7
15150;Berželis;PČIOLKI;7287552286;Ne;1;0;0;1
15151;Berželis;"BOŽJI KOROVKI";3162044236;Ne;0;5;0;5
15152;Berželis;"BOŽJI KOROVKI";7421059780;Ne;2;10;5;17
15153;Berželis;"BOŽJI KOROVKI";5739847580;Ne;8;0;0;8
15154;Berželis;"BOŽJI KOROVKI";4100740863;Ne;7;5;0;12
15155;Berželis;"BOŽJI KOROVKI";5953387226;Ne;0;8;0;8
15156;Berželis;"BOŽJI KOROVKI";3070917065;Ne;0;2;0;2
15157;Berželis;"BOŽJI KOROVKI";8118040960;Ne;0;1;0;1
15158;Berželis;"BOŽJI KOROVKI";5194480946;Ne;0;6;3;9
15159;Berželis;"BOŽJI KOROVKI";9848723402;Ne;16;3;0;19
15160;Berželis;"BOŽJI KOROVKI";5551459997;Ne;1;1;0;2
15161;Berželis;"BOŽJI KOROVKI";6651007152;Ne;17;2;1;20
15162;Berželis;"BOŽJI KOROVKI";8451877584;Ne;0;1;1;2
15163;Berželis;"BOŽJI KOROVKI";7080168105;Ne;0;2;0;2
15164;Berželis;"BOŽJI KOROVKI";1132252592;Ne;0;0;1;1
15165;Berželis;"BOŽJI KOROVKI";5550598069;Ne;8;0;0;8
15166;Berželis;"BOŽJI KOROVKI";1852964349;Ne;0;9;0;9
15167;Berželis;"BOŽJI KOROVKI";8871199713;Ne;0;0;4;4
15168;Berželis;"BOŽJI KOROVKI";1722262813;Ne;0;1;0;1
15169;Berželis;"BOŽJI KOROVKI";9466461910;Ne;15;0;0;15
15170;Berželis;SOLNYŠKO;1498165322;Ne;3;0;0;3
15171;Berželis;SOLNYŠKO;8737788279;Ne;0;8;3;11
15172;Berželis;SOLNYŠKO;2901168499;Ne;0;0;3;3
15173;Berželis;SOLNYŠKO;7411282628;Ne;4;0;1;5
15174;Berželis;SOLNYŠKO;8957312159;Ne;0;0;1;1
15175;Berželis;SOLNYŠKO;1167103292;Ne;0;5;0;5
15176;Berželis;SOLNYŠKO;5408368340;Ne;0;0;4;4
15177;Berželis;SOLNYŠKO;1070751052;Ne;7;0;0;7
15178;Berželis;SOLNYŠKO;5464385395;Ne;0;7;0;7
15179;Berželis;SOLNYŠKO;1424868444;Ne;0;5;0;5
15180;Berželis;SOLNYŠKO;1146976812;Ne;0;2;0;2
15181;Berželis;SOLNYŠKO;6774460279;Ne;22;0;0;22
15182;Berželis;SOLNYŠKO;9750863775;Ne;4;0;0;4
15183;Berželis;BABOČKI;4923631429;Ne;3;0;0;3
15184;Berželis;BABOČKI;2016194182;Ne;8;0;0;8
15185;Berželis;BABOČKI;2030770943;Ne;7;0;0;7
15186;Berželis;BABOČKI;7781031211;Ne;10;0;2;12
15187;Berželis;BABOČKI;5688897783;Ne;0;6;0;6
15188;Berželis;BABOČKI;6942559693;Ne;3;0;0;3
15189;Berželis;BABOČKI;6352635742;Ne;0;5;0;5
15190;Berželis;BABOČKI;3613459846;Ne;0;2;0;2
15191;Berželis;BABOČKI;5069322062;Ne;0;0;6;6
15192;Berželis;BABOČKI;2954451168;Ne;10;0;0;10
15193;Berželis;BABOČKI;9585609150;Ne;11;3;0;14
15194;Berželis;BABOČKI;9091691636;Ne;0;0;1;1
15195;Berželis;BABOČKI;7940591009;Ne;0;0;3;3
15196;Berželis;BABOČKI;4546285993;Ne;0;22;0;22
15197;Berželis;BABOČKI;6577232093;Ne;7;4;0;11
15198;Berželis;BABOČKI;6387242787;Ne;2;20;0;22
15199;Berželis;SOVUŠKI;5350402890;Ne;6;0;0;6
15200;Berželis;SOVUŠKI;8185887403;Ne;10;0;1;11
15201;Berželis;SOVUŠKI;8989621715;Ne;7;0;0;7
15202;Berželis;SOVUŠKI;1289333809;Ne;0;1;1;2
15203;Berželis;SOVUŠKI;8086074279;Ne;7;8;0;15
15204;Berželis;SOVUŠKI;1769470120;Ne;3;0;1;4
15205;Berželis;SOVUŠKI;6706273205;Ne;10;0;0;10
15206;Berželis;SOVUŠKI;2895332184;Ne;1;0;0;1
15207;Berželis;SOVUŠKI;1464998584;Ne;12;0;1;13
15208;Berželis;SOVUŠKI;2844736188;Ne;1;0;0;1
15209;Berželis;SOVUŠKI;3835273594;Ne;7;1;0;8
15210;Berželis;SOVUŠKI;2632535013;Ne;22;0;0;22
15211;Berželis;SOVUŠKI;6698849108;Ne;0;0;8;8
15212;Berželis;SOVUŠKI;1583268041;Ne;1;0;0;1
15213;Berželis;PODSOLNUŠKI;1044720859;Ne;0;0;2;2
15214;Berželis;PODSOLNUŠKI;3157906472;Ne;22;0;0;22
15215;Berželis;PODSOLNUŠKI;9945124824;Ne;14;0;0;14
15216;Berželis;PODSOLNUŠKI;5925726854;Ne;6;0;1;7
15217;Berželis;PODSOLNUŠKI;9072126286;Ne;2;0;0;2
15218;Berželis;PODSOLNUŠKI;8633724383;Ne;12;0;1;13
15219;Berželis;PODSOLNUŠKI;2259367998;Ne;5;0;0;5
15220;Berželis;PODSOLNUŠKI;3033042487;Ne;4;0;2;6
15221;Berželis;PODSOLNUŠKI;2136455625;Ne;13;0;1;14
15222;Berželis;PODSOLNUŠKI;1964320071;Ne;8;0;2;10
15223;Berželis;PODSOLNUŠKI;2615832804;Ne;7;4;0;11
15224;Berželis;PODSOLNUŠKI;9133988149;Ne;4;0;0;4
15225;Berželis;PODSOLNUŠKI;5795151632;Ne;0;10;0;10
15226;Berželis;PODSOLNUŠKI;6686248053;Ne;15;0;1;16
15227;Berželis;PODSOLNUŠKI;1081582842;Taip;4;3;0;7
15228;Berželis;PODSOLNUŠKI;5963915092;Ne;19;0;0;19
15229;Berželis;PODSOLNUŠKI;3378237475;Ne;19;0;0;19
15230;Berželis;LAPIUKAI;3813964138;Ne;0;1;0;1
15231;Berželis;LAPIUKAI;2144796691;Ne;18;0;0;18
15232;Berželis;LAPIUKAI;1834920753;Taip;0;0;1;1
15233;Berželis;LAPIUKAI;6384939601;Ne;2;0;0;2
15234;Berželis;LAPIUKAI;2410514408;Ne;0;5;0;5
15235;Berželis;LAPIUKAI;2794074071;Taip;0;0;3;3
15236;Berželis;LAPIUKAI;9681310544;Taip;0;8;0;8
15237;Berželis;LAPIUKAI;9543499205;Ne;0;2;0;2
15238;Berželis;LAPIUKAI;9749516260;Ne;0;1;0;1
15239;Berželis;LAPIUKAI;2947072348;Ne;0;9;0;9
15240;Berželis;LAPIUKAI;8994102218;Taip;0;8;2;10
15241;Berželis;LAPIUKAI;4854931959;Ne;0;0;2;2
15242;Berželis;MEŠKIUKAI;7902774064;Taip;10;0;0;10
15243;Berželis;MEŠKIUKAI;2062794406;Ne;0;0;1;1
15244;Berželis;MEŠKIUKAI;9459031158;Ne;8;0;0;8
15245;Berželis;MEŠKIUKAI;9178527605;Ne;5;0;2;7
15246;Berželis;MEŠKIUKAI;1235617054;Ne;13;1;0;14
15247;Berželis;MEŠKIUKAI;1178588907;Ne;5;0;1;6
15248;Berželis;MEŠKIUKAI;3535856504;Taip;8;0;0;8
15249;Berželis;MEŠKIUKAI;6186408090;Ne;12;0;0;12
15250;Berželis;MEŠKIUKAI;3936106342;Taip;6;0;0;6
15251;Berželis;MEŠKIUKAI;6689893827;Ne;5;0;0;5
15252;Berželis;MEŠKIUKAI;8251510865;Ne;4;0;2;6
15253;Berželis;MEŠKIUKAI;9182053246;Ne;3;0;0;3
15254;Berželis;MEŠKIUKAI;7535016799;Taip;12;10;0;22
15255;Berželis;ŽIEDELIAI;3786609012;Ne;0;1;0;1
15256;Berželis;ŽIEDELIAI;9805181733;Ne;0;0;1;1
15257;Berželis;ŽIEDELIAI;2016827207;Ne;0;0;1;1
15258;Berželis;ŽIEDELIAI;9979442772;Ne;10;0;0;10
15259;Berželis;ŽIEDELIAI;9881246268;Ne;10;0;0;10
15260;Berželis;ŽIEDELIAI;7042967329;Ne;0;10;0;10
15261;Berželis;ŽIEDELIAI;9925865228;Ne;0;0;1;1
15262;Berželis;ŽIEDELIAI;1402975280;Ne;10;4;0;14
15263;Berželis;ŽIEDELIAI;1535940949;Taip;0;14;4;18
15264;Berželis;ŽIEDELIAI;2030492491;Ne;0;0;2;2
15265;Berželis;ŽIEDELIAI;3351114197;Ne;0;0;6;6
15266;Berželis;ŽIEDELIAI;5248880873;Ne;9;0;2;11
15267;Berželis;ŽIEDELIAI;2262911854;Ne;8;0;2;10
15268;Berželis;ŽIEDELIAI;2508532190;Ne;7;0;1;8
15269;Berželis;ŽIEDELIAI;5649793735;Ne;0;8;0;8
15270;Berželis;ŽIEDELIAI;7807553847;Ne;0;0;1;1
15271;Berželis;ŽIEDELIAI;1456066646;Ne;0;0;1;1
15272;Berželis;NYKŠTUKAI;8148104183;Ne;0;0;5;5
15273;Berželis;NYKŠTUKAI;7935684899;Ne;0;0;19;19
15274;Berželis;NYKŠTUKAI;1403664386;Ne;12;0;0;12
15275;Berželis;NYKŠTUKAI;5637168259;Ne;5;0;1;6
15276;Berželis;NYKŠTUKAI;9666648116;Ne;0;0;4;4
15277;Berželis;NYKŠTUKAI;3559065542;Ne;0;0;15;15
15278;Berželis;NYKŠTUKAI;3556594755;Ne;3;0;5;8
15279;Berželis;NYKŠTUKAI;2933069798;Ne;0;0;3;3
15280;Berželis;NYKŠTUKAI;8430372047;Ne;0;0;7;7
15281;Berželis;NYKŠTUKAI;5099275362;Taip;0;10;0;10
15282;Berželis;NYKŠTUKAI;5101382213;Ne;10;0;1;11
15283;Berželis;NYKŠTUKAI;2425621326;Ne;5;0;7;12
15284;Berželis;NYKŠTUKAI;7676141462;Ne;7;5;0;12
15285;Berželis;NYKŠTUKAI;3852021563;Ne;2;0;6;8
15286;Berželis;NYKŠTUKAI;3379227410;Ne;13;0;0;13
15287;Berželis;NYKŠTUKAI;4032178538;Ne;5;0;2;7
15288;Berželis;NYKŠTUKAI;5839964720;Ne;0;7;0;7
15289;Berželis;UOGELĖS;6136155301;Ne;20;0;0;20
15290;Berželis;UOGELĖS;9950641759;Ne;0;0;3;3
15291;Berželis;UOGELĖS;9034464618;Ne;8;0;0;8
15292;Berželis;UOGELĖS;5851732944;Ne;0;8;6;14
15293;Berželis;UOGELĖS;2321608974;Ne;0;0;6;6
15294;Berželis;UOGELĖS;3229996417;Ne;0;0;5;5
15295;Berželis;UOGELĖS;7750905743;Ne;0;0;6;6
15296;Berželis;UOGELĖS;4607486516;Ne;0;5;3;8
15297;Berželis;UOGELĖS;8814953641;Ne;4;0;3;7
15298;Berželis;UOGELĖS;5197350105;Ne;0;4;0;4
15299;Berželis;KODĖLČIUKAI;5134372871;Ne;14;0;0;14
15300;Berželis;KODĖLČIUKAI;7852089381;Ne;0;0;2;2
15301;Berželis;KODĖLČIUKAI;5751995154;Ne;7;0;3;10
15302;Berželis;KODĖLČIUKAI;3589890886;Ne;7;4;0;11
15303;Berželis;KODĖLČIUKAI;7986744784;Ne;0;14;0;14
15304;Berželis;KODĖLČIUKAI;3951962738;Taip;8;0;0;8
15305;Berželis;KODĖLČIUKAI;2193392844;Taip;0;0;2;2
15306;Berželis;KODĖLČIUKAI;9696962207;Ne;12;0;0;12
15307;Berželis;KODĖLČIUKAI;8286301258;Ne;8;2;0;10
15308;Berželis;KODĖLČIUKAI;8875116641;Ne;10;0;0;10
15309;Berželis;KODĖLČIUKAI;6500588668;Ne;9;0;0;9
15310;Berželis;KODĖLČIUKAI;3327751482;Ne;2;0;2;4
15311;Berželis;KODĖLČIUKAI;6060490387;Ne;7;0;0;7
15312;Berželis;KODĖLČIUKAI;9418230816;Ne;12;5;5;22
15313;Berželis;KODĖLČIUKAI;4254592648;Ne;6;0;7;13
15314;"Vilniaus savivaldybės Grigiškių lopšelis-darželis „Pelėdžiukas“";Boružiukai;4717485711;Ne;11;0;0;11
15315;"Vilniaus savivaldybės Grigiškių lopšelis-darželis „Pelėdžiukas“";Boružiukai;4416321501;Ne;20;0;0;20
15316;"Vilniaus savivaldybės Grigiškių lopšelis-darželis „Pelėdžiukas“";Boružiukai;2648851441;Ne;4;0;0;4
15317;"Vilniaus savivaldybės Grigiškių lopšelis-darželis „Pelėdžiukas“";Bitutės;7055757795;Ne;12;0;0;12
15318;"Vilniaus savivaldybės Grigiškių lopšelis-darželis „Pelėdžiukas“";Bitutės;8809390531;Ne;22;0;0;22
15319;"Vilniaus savivaldybės Grigiškių lopšelis-darželis „Pelėdžiukas“";Šimtakojai;8981652451;Ne;15;0;0;15
15320;"Vilniaus savivaldybės Grigiškių lopšelis-darželis „Pelėdžiukas“";Šimtakojai;9540483835;Ne;5;0;0;5
15321;"Vilniaus savivaldybės Grigiškių lopšelis-darželis „Pelėdžiukas“";Šimtakojai;1414374293;Ne;4;0;0;4
15322;"Vilniaus savivaldybės Grigiškių lopšelis-darželis „Pelėdžiukas“";Šimtakojai;8509392550;Ne;8;0;0;8
15323;"Vilniaus savivaldybės Grigiškių lopšelis-darželis „Pelėdžiukas“";Voriukai;4531333251;Ne;3;0;0;3
15324;"Vilniaus savivaldybės Grigiškių lopšelis-darželis „Pelėdžiukas“";Voriukai;1302254685;Ne;7;0;0;7
15325;"Vilniaus savivaldybės Grigiškių lopšelis-darželis „Pelėdžiukas“";Voriukai;7939776178;Ne;11;0;0;11
15326;"Vilniaus savivaldybės Grigiškių lopšelis-darželis „Pelėdžiukas“";Voriukai;77721253337;Ne;8;0;0;8
15327;"Vilniaus savivaldybės Grigiškių lopšelis-darželis „Pelėdžiukas“";Žiogeliai;5382214547;Ne;5;0;0;5
15328;"Vilniaus savivaldybės Grigiškių lopšelis-darželis „Pelėdžiukas“";Žiogeliai;6943790883;Ne;3;0;0;3
15329;"Vilniaus savivaldybės Grigiškių lopšelis-darželis „Pelėdžiukas“";SKRUZDELIUKAI;3494244855;Ne;4;0;0;4
15330;"Vilniaus savivaldybės Grigiškių lopšelis-darželis „Pelėdžiukas“";SKRUZDELIUKAI;8473409188;Ne;14;0;0;14
15331;"Vilniaus savivaldybės Grigiškių lopšelis-darželis „Pelėdžiukas“";SKRUZDELIUKAI;4880175524;Ne;10;0;0;10
15332;"Vilniaus savivaldybės Grigiškių lopšelis-darželis „Pelėdžiukas“";SKRUZDELIUKAI;3012566838;Ne;15;0;0;15
15333;"Vilniaus savivaldybės Grigiškių lopšelis-darželis „Pelėdžiukas“";SKRUZDELIUKAI;5331504479;Ne;5;0;0;5
15334;"Vilniaus savivaldybės Grigiškių lopšelis-darželis „Pelėdžiukas“";DRUGELIAI;9733421507;Ne;9;0;0;9
15335;"Vilniaus savivaldybės Grigiškių lopšelis-darželis „Pelėdžiukas“";DRUGELIAI;6940865564;Ne;12;0;0;12
15336;"Vilniaus savivaldybės Grigiškių lopšelis-darželis „Pelėdžiukas“";DRUGELIAI;7919921890;Ne;2;0;0;2
15337;"Vilniaus savivaldybės Grigiškių lopšelis-darželis „Pelėdžiukas“";DRUGELIAI;8732447498;Ne;11;0;0;11
15338;"Vilniaus savivaldybės Grigiškių lopšelis-darželis „Pelėdžiukas“";DRUGELIAI;6229074697;Ne;5;0;0;5
15339;"Vilniaus savivaldybės Grigiškių lopšelis-darželis „Pelėdžiukas“";DRUGELIAI;7670521802;Ne;4;0;0;4
15340;"Vilniaus savivaldybės Grigiškių lopšelis-darželis „Pelėdžiukas“";LAUMŽIRGIAI;3989005936;Ne;5;0;0;5
15341;"Vilniaus savivaldybės Grigiškių lopšelis-darželis „Pelėdžiukas“";LAUMŽIRGIAI;6709604166;Ne;12;0;0;12
15342;Saulutė;Drugeliai;5987478379;Ne;6;0;0;6
15343;Saulutė;Drugeliai;5943795519;Ne;6;2;0;8
15344;Saulutė;Drugeliai;4453610732;Ne;9;0;0;9
15345;Saulutė;Drugeliai;4067009709;Ne;7;0;0;7
15346;Saulutė;Drugeliai;3991128892;Ne;8;0;5;13
15347;Saulutė;Drugeliai;7689842018;Ne;4;0;0;4
15348;Saulutė;Drugeliai;4288298305;Ne;6;2;7;15
15349;Saulutė;Drugeliai;9133269796;Ne;0;10;0;10
15350;Saulutė;Drugeliai;6057938367;Ne;15;2;0;17
15351;Saulutė;Drugeliai;1268204445;Ne;0;2;1;3
15352;Saulutė;Drugeliai;1585403702;Ne;5;0;3;8
15353;Saulutė;Drugeliai;4915192103;Ne;0;2;2;4
15354;Saulutė;Drugeliai;8003855875;Ne;6;0;0;6
15355;Saulutė;Drugeliai;2301903550;Ne;0;2;0;2
15356;Saulutė;Drugeliai;3265401334;Ne;1;6;0;7
15357;Saulutė;Drugeliai;6455593653;Ne;5;4;1;10
15358;Saulutė;Drugeliai;9410517602;Ne;0;6;0;6
15359;Saulutė;Drugeliai;1088813143;Ne;0;8;0;8
15360;Saulutė;Drugeliai;8409958782;Ne;0;2;2;4
15361;Saulutė;Drugeliai;6304028361;Ne;2;1;0;3
15362;Saulutė;"Saulės zuikučiai";8946107286;Ne;2;0;0;2
15363;Saulutė;"Saulės zuikučiai";2397257894;Ne;0;0;1;1
15364;Saulutė;"Saulės zuikučiai";5148542811;Ne;22;0;0;22
15365;Saulutė;"Saulės zuikučiai";2259917151;Ne;0;1;0;1
15366;Saulutė;"Saulės zuikučiai";8242602551;Ne;0;3;0;3
15367;Saulutė;"Saulės zuikučiai";5247769309;Ne;0;8;0;8
15368;Saulutė;"Saulės zuikučiai";2816806902;Ne;0;1;0;1
15369;Saulutė;"Saulės zuikučiai";2781003892;Ne;0;7;0;7
15370;Saulutė;"Saulės zuikučiai";9521155670;Ne;0;7;0;7
15371;Saulutė;"Saulės zuikučiai";3089541630;Ne;0;2;0;2
15372;Saulutė;"Saulės zuikučiai";5326279083;Ne;0;1;0;1
15373;Saulutė;"Saulės zuikučiai";1562393383;Ne;5;2;1;8
15374;Saulutė;"Saulės zuikučiai";3272296969;Taip;0;3;7;10
15375;Saulutė;"Saulės zuikučiai";4663795223;Ne;19;0;3;22
15376;Saulutė;"Saulės zuikučiai";5931269521;Ne;3;4;0;7
15377;Saulutė;"Saulės zuikučiai";7839168221;Ne;6;0;0;6
15378;Saulutė;"Saulės zuikučiai";4945943570;Ne;5;0;6;11
15379;Saulutė;"Saulės zuikučiai";3730442890;Ne;0;2;0;2
15380;Saulutė;Boružėlės;3295289082;Ne;0;0;1;1
15381;Saulutė;Boružėlės;1587328722;Ne;0;0;1;1
15382;Saulutė;Boružėlės;7576532632;Ne;10;0;6;16
15383;Saulutė;Boružėlės;2725491887;Ne;7;0;2;9
15384;Saulutė;Boružėlės;9314889468;Ne;0;0;1;1
15385;Saulutė;Boružėlės;7764493159;Ne;0;0;1;1
15386;Saulutė;Boružėlės;5811810714;Ne;0;0;2;2
15387;Saulutė;Boružėlės;8643975544;Ne;0;0;3;3
15388;Saulutė;Boružėlės;7081700501;Ne;0;0;2;2
15389;Saulutė;Boružėlės;7474989619;Ne;0;4;0;4
15390;Saulutė;Boružėlės;8619163154;Ne;3;0;2;5
15391;Saulutė;Boružėlės;7574225926;Ne;0;0;1;1
15392;Saulutė;Boružėlės;1803710557;Ne;8;0;4;12
15393;Saulutė;Boružėlės;9098663596;Ne;0;0;2;2
15394;Saulutė;Boružėlės;7425789805;Ne;0;25;0;25
15395;Saulutė;Boružėlės;1265174091;Ne;0;0;5;5
15396;Saulutė;Boružėlės;2527027536;Ne;0;0;2;2
15397;Saulutė;Boružėlės;3852862834;Ne;0;0;6;6
15398;Saulutė;Boružėlės;1275552038;Ne;0;7;4;11
15399;Saulutė;Nykštukai;2601822200;Ne;0;0;3;3
15400;Saulutė;Nykštukai;3244850673;Ne;10;4;0;14
15401;Saulutė;Nykštukai;9497439410;Ne;0;2;0;2
15402;Saulutė;Nykštukai;5607937410;Ne;0;4;0;4
15403;Saulutė;Nykštukai;3571751974;Ne;2;2;2;6
15404;Saulutė;Nykštukai;3221612665;Ne;0;0;4;4
15405;Saulutė;Nykštukai;2140277182;Ne;9;2;0;11
15406;Saulutė;Nykštukai;4510990261;Ne;12;0;6;18
15407;Saulutė;Nykštukai;4800144085;Ne;0;0;2;2
15408;Saulutė;Nykštukai;8257363228;Ne;0;11;0;11
15409;Saulutė;Nykštukai;9664809396;Ne;1;0;4;5
15410;Saulutė;Nykštukai;8984040932;Ne;9;3;0;12
15411;Saulutė;Nykštukai;3463428772;Ne;0;1;6;7
15412;Saulutė;Nykštukai;3363212754;Ne;0;3;0;3
15413;Saulutė;Nykštukai;5442075474;Ne;17;10;0;27
15414;Saulutė;Nykštukai;8722717930;Ne;0;0;22;22
15415;Saulutė;Nykštukai;9930330487;Ne;3;0;0;3
15416;Saulutė;Nykštukai;7158455528;Ne;5;0;0;5
15417;Saulutė;Nykštukai;2669711574;Ne;3;0;5;8
15418;Saulutė;Nykštukai;6982979199;Ne;0;0;3;3
15419;Saulutė;Meškiukai;8952893819;Ne;13;1;0;14
15420;Saulutė;Meškiukai;4222649372;Ne;0;22;0;22
15421;Saulutė;Meškiukai;1229624643;Ne;0;14;0;14
15422;Saulutė;Meškiukai;9572394489;Ne;0;0;12;12
15423;Saulutė;Meškiukai;9567511354;Ne;2;0;6;8
15424;Saulutė;Meškiukai;6579874077;Ne;0;5;0;5
15425;Saulutė;Meškiukai;6178908581;Ne;7;0;0;7
15426;Saulutė;Meškiukai;8472510151;Ne;2;0;0;2
15427;Saulutė;Meškiukai;6955061957;Ne;3;6;0;9
15428;Saulutė;Meškiukai;7478215328;Ne;9;0;1;10
15429;Saulutė;Meškiukai;9727366891;Ne;0;0;19;19
15430;Saulutė;Meškiukai;5219429911;Ne;0;11;0;11
15431;Saulutė;Meškiukai;3125186472;Ne;0;0;5;5
15432;Saulutė;Meškiukai;8919457259;Ne;0;0;3;3
15433;Saulutė;Meškiukai;5509365461;Ne;0;2;0;2
15434;Saulutė;Meškiukai;8787977881;Ne;0;0;2;2
15435;Saulutė;Meškiukai;8147755754;Ne;0;5;0;5
15436;Saulutė;Ežiukai;2813274509;Ne;22;0;0;22
15437;Saulutė;Ežiukai;2315812734;Ne;4;0;4;8
15438;Saulutė;Ežiukai;8736917541;Ne;7;5;1;13
15439;Saulutė;Ežiukai;4363210987;Ne;0;0;2;2
15440;Saulutė;Ežiukai;5972503001;Ne;0;0;7;7
15441;Saulutė;Ežiukai;6884472677;Ne;0;0;5;5
15442;Saulutė;Ežiukai;6219942114;Ne;0;7;0;7
15443;Saulutė;Ežiukai;4194586403;Ne;16;0;0;16
15444;Saulutė;Ežiukai;1853984777;Ne;0;0;4;4
15445;Saulutė;Ežiukai;1666301750;Ne;0;0;6;6
15446;Saulutė;Ežiukai;3133714991;Ne;0;4;0;4
15447;Saulutė;Ežiukai;4039065925;Ne;0;0;17;17
15448;Saulutė;Ežiukai;7967532537;Ne;5;0;5;10
15449;Saulutė;Ežiukai;5335820652;Ne;9;0;1;10
15450;Saulutė;Ežiukai;2728669975;Ne;0;5;0;5
15451;Saulutė;Ežiukai;9892855816;Ne;0;8;0;8
15452;Saulutė;Ežiukai;9398356470;Ne;0;0;13;13
15453;Saulutė;Ežiukai;6126870829;Ne;0;0;9;9
15454;Saulutė;Ežiukai;3565818383;Ne;2;0;0;2
15455;Saulutė;Bitutės;5448950324;Ne;13;0;0;13
15456;Saulutė;Bitutės;3948540247;Ne;3;0;0;3
15457;Saulutė;Bitutės;4130972647;Ne;0;0;1;1
15458;Saulutė;Bitutės;3242810449;Ne;4;15;0;19
15459;Saulutė;Bitutės;5897526863;Ne;12;0;1;13
15460;Saulutė;Bitutės;9110162513;Ne;0;0;3;3
15461;Saulutė;Bitutės;1648978545;Ne;0;4;0;4
15462;Saulutė;Bitutės;6927834443;Taip;0;15;0;15
15463;Saulutė;Bitutės;8714520840;Ne;0;15;2;17
15464;Saulutė;Bitutės;9726675673;Ne;7;8;2;17
15465;Saulutė;Bitutės;8520474896;Ne;7;8;2;17
15466;Saulutė;Bitutės;7132125341;Ne;0;0;2;2
15467;Saulutė;Bitutės;3215349379;Ne;6;0;13;19
15468;Saulutė;Bitutės;3259790911;Ne;5;0;1;6
15469;Saulutė;Bitutės;7311594119;Ne;0;0;12;12
15470;Saulutė;Pelėdžiukai;8512137633;Ne;7;0;0;7
15471;Saulutė;Pelėdžiukai;7139492238;Ne;3;0;0;3
15472;Saulutė;Pelėdžiukai;4211866191;Ne;6;0;2;8
15473;Saulutė;Pelėdžiukai;2373409300;Ne;0;0;8;8
15474;Saulutė;Pelėdžiukai;8405262902;Ne;2;0;2;4
15475;Saulutė;Pelėdžiukai;1745754752;Ne;0;0;1;1
15476;Saulutė;Pelėdžiukai;4123500930;Ne;0;0;5;5
15477;Saulutė;Pelėdžiukai;1056158093;Ne;6;0;3;9
15478;Saulutė;Pelėdžiukai;8371366346;Ne;0;4;0;4
15479;Saulutė;Pelėdžiukai;6842585310;Ne;10;0;5;15
15480;Saulutė;Pelėdžiukai;1776164273;Ne;8;0;4;12
15481;Saulutė;Pelėdžiukai;5850783789;Ne;5;6;0;11
15482;Saulutė;Pelėdžiukai;6608003946;Ne;8;6;0;14
15483;Saulutė;Pelėdžiukai;7243072252;Ne;0;0;5;5
15484;Saulutė;Pelėdžiukai;9903380188;Ne;9;0;0;9
15485;Saulutė;Pelėdžiukai;2450554594;Ne;10;0;0;10
15486;Saulutė;Pelėdžiukai;7620841597;Ne;11;0;0;11
15487;Saulutė;Pelėdžiukai;7640441297;Ne;3;0;0;3
15488;Saulutė;Pelėdžiukai;6046611248;Ne;8;3;0;11
15489;Saulutė;Pelėdžiukai;4301516165;Ne;21;0;0;21
15490;Saulutė;Pelėdžiukai;7258180835;Ne;0;22;0;22
15491;Saulutė;Pelėdžiukai;2566263680;Ne;0;0;21;21
15492;Saulutė;Pelėdžiukai;9106119465;Ne;5;0;2;7
15493;Saulutė;Zylutės;3228226715;Ne;17;0;0;17
15494;Saulutė;Zylutės;8040751073;Ne;0;8;2;10
15495;Saulutė;Zylutės;2074473832;Ne;0;0;1;1
15496;Saulutė;Zylutės;8041118115;Ne;0;22;0;22
15497;Saulutė;Zylutės;5198558993;Ne;0;22;0;22
15498;Saulutė;Zylutės;6109527712;Ne;2;0;0;2
15499;Saulutė;Zylutės;4686825392;Ne;5;0;2;7
15500;Saulutė;Zylutės;7446423510;Ne;7;0;2;9
15501;Saulutė;Zylutės;8717210130;Ne;3;4;0;7
15502;Saulutė;Zylutės;5264813819;Ne;8;0;2;10
15503;Saulutė;Zylutės;7844396402;Ne;0;2;1;3
15504;Saulutė;Zylutės;1324799653;Ne;0;4;0;4
15505;Saulutė;Zylutės;3691381351;Ne;0;2;0;2
15506;Saulutė;Zylutės;2010774109;Ne;0;4;0;4
15507;Saulutė;Zylutės;1546200973;Ne;0;0;7;7
15508;Saulutė;Zylutės;8379304869;Ne;0;2;7;9
15509;Saulutė;Zylutės;66108847230;Ne;0;8;0;8
15510;Saulutė;Zylutės;9947607411;Ne;0;2;1;3
15511;Saulutė;Zylutės;3408369823;Ne;0;0;1;1
15512;Saulutė;"1 klasė";1717909005;Ne;9;0;0;9
15513;Saulutė;"1 klasė";87814849917;Ne;8;0;0;8
15514;Saulutė;"1 klasė";84919478493;Ne;6;0;0;6
15515;Saulutė;"1 klasė";1320018338;Ne;11;0;0;11
15516;Saulutė;"1 klasė";8599199376;Ne;7;0;0;7
15517;Saulutė;"1 klasė";8944601874;Ne;9;0;0;9
15518;Saulutė;"1 klasė";3064199909;Ne;7;0;0;7
15519;Saulutė;"1 klasė";1556270046;Ne;8;0;0;8
15520;Saulutė;"1 klasė";4272320685;Ne;8;0;0;8
15521;Saulutė;"1 klasė";1291318940;Ne;7;0;0;7
15522;Saulutė;"1 klasė";1391904744;Ne;7;0;0;7
15523;Saulutė;"1 klasė";6096297366;Ne;8;0;0;8
15524;Saulutė;"1 klasė";1609952589;Ne;7;0;0;7
15525;Saulutė;"1 klasė";1513449225;Ne;8;0;0;8
15526;Saulutė;"1 klasė";7281873166;Ne;15;0;0;15
15527;Saulutė;"1 klasė";1911318708;Ne;10;0;0;10
15528;Saulutė;"1 klasė";28772515317;Ne;7;0;0;7
15529;Saulutė;"1 klasė";1786491396;Ne;8;0;0;8
15530;Saulutė;"1 klasė";1332002470;Ne;6;0;0;6
15531;Saulutė;"1 klasė";16622528829;Ne;8;0;0;8
15532;Saulutė;"1 klasė";61073095949;Ne;20;0;0;20
15533;Saulutė;"1 klasė";3505492809;Ne;14;0;0;14
15534;Saulutė;"1 klasė";8952155496;Ne;6;0;0;6
15535;Saulutė;"1 klasė";9235972927;Ne;10;0;0;10
15536;Saulutė;"1 klasė";2677995903;Ne;6;0;0;6
15537;Saulutė;"1 klasė";1386800520;Ne;12;0;0;12
15538;Saulutė;"1 klasė";89920419797;Ne;7;0;0;7
15539;Saulutė;"1 klasė";1910653135;Ne;7;0;0;7
15540;Saulutė;"2 klasė";45306237230;Ne;14;0;0;14
15541;Saulutė;"2 klasė";79438946697;Ne;12;0;0;12
15542;Saulutė;"2 klasė";79919438191;Ne;12;0;0;12
15543;Saulutė;"2 klasė";29074930927;Ne;8;0;0;8
15544;Saulutė;"2 klasė";8369703027;Ne;5;0;0;5
15545;Saulutė;"2 klasė";21605684303;Ne;6;0;0;6
15546;Saulutė;"2 klasė";31705050946;Ne;12;0;0;12
15547;Saulutė;"2 klasė";2622662153;Ne;7;0;0;7
15548;Saulutė;"2 klasė";9612975694;Ne;32;0;0;32
15549;Saulutė;"2 klasė";37315117916;Ne;8;0;0;8
15550;Saulutė;"2 klasė";3445723020;Ne;7;0;0;7
15551;Saulutė;"2 klasė";14195215027;Ne;9;0;0;9
15552;Saulutė;"2 klasė";2098990667;Ne;7;0;0;7
15553;Saulutė;"2 klasė";27386434894;Ne;6;0;0;6
15554;Saulutė;"2 klasė";77923802656;Ne;7;0;0;7
15555;Saulutė;"2 klasė";46280382280;Ne;9;0;0;9
15556;Saulutė;"2 klasė";1935503629;Ne;6;0;0;6
15557;Saulutė;"2 klasė";75405796772;Ne;6;0;0;6
15558;Saulutė;"2 klasė";1277263391;Ne;9;0;0;9
15559;Saulutė;"2 klasė";97145959022;Ne;21;0;0;21
15560;Saulutė;"2 klasė";64418469679;Ne;6;0;0;6
15561;Saulutė;"2 klasė";77170708225;Ne;11;0;0;11
15562;Saulutė;"2 klasė";4640909915;Ne;11;0;0;11
15563;Saulutė;"2 klasė";65492344097;Ne;6;0;0;6
15564;Saulutė;"2 klasė";1704733670;Ne;7;0;0;7
15565;Saulutė;"2 klasė";1534183935;Ne;14;0;0;14
15566;Saulutė;"2 klasė";5574049005;Ne;9;0;0;9
15567;Saulutė;"2 klasė";1510434265;Ne;6;0;0;6
15568;Saulutė;"3 klasė";1005459768;Ne;6;0;0;6
15569;Saulutė;"3 klasė";1804521229;Ne;9;0;0;9
15570;Saulutė;"3 klasė";76108591835;Ne;15;0;0;15
15571;Saulutė;"3 klasė";1475031090;Ne;7;0;0;7
15572;Saulutė;"3 klasė";3156830821;Ne;7;0;0;7
15573;Saulutė;"3 klasė";5741276602;Ne;5;0;0;5
15574;Saulutė;"3 klasė";3246485288;Ne;14;0;0;14
15575;Saulutė;"3 klasė";44452051978;Ne;14;0;0;14
15576;Saulutė;"3 klasė";78967475616;Ne;7;0;0;7
15577;Saulutė;"3 klasė";89710141573;Ne;6;0;0;6
15578;Saulutė;"3 klasė";25124975646;Ne;8;0;0;8
15579;Saulutė;"3 klasė";3450668814;Ne;6;0;0;6
15580;Saulutė;"3 klasė";8168961080;Ne;10;0;0;10
15581;Saulutė;"3 klasė";57283533169;Ne;6;0;0;6
15582;Saulutė;"3 klasė";76744652185;Ne;9;0;0;9
15583;Saulutė;"3 klasė";97296161595;Ne;9;0;0;9
15584;Saulutė;"3 klasė";87409240076;Ne;8;0;0;8
15585;Saulutė;"3 klasė";1205642335;Ne;7;0;0;7
15586;Saulutė;"3 klasė";2426509692;Ne;6;0;0;6
15587;Saulutė;"3 klasė";36414547943;Ne;6;0;0;6
15588;Saulutė;"3 klasė";99841176399;Ne;6;0;0;6
15589;Saulutė;"3 klasė";21703177024;Ne;6;0;0;6
15590;Saulutė;"3 klasė";1337654926;Ne;12;0;0;12
15591;Saulutė;"3 klasė";54950572289;Ne;7;0;0;7
15592;Saulutė;"3 klasė";13147367113;Ne;6;0;0;6
15593;Saulutė;"3 klasė";2216383015;Ne;12;0;0;12
15594;Saulutė;"3 klasė";1644704074;Ne;6;0;0;6
15595;Saulutė;"3 klasė";96497471950;Ne;9;0;0;9
15596;Saulutė;"3 klasė";6557918941;Ne;8;0;0;8
15597;Saulutė;"3 klasė";2787531476;Ne;7;0;0;7
15598;Saulutė;"4 klasė";5822529731;Ne;10;0;0;10
15599;Saulutė;"4 klasė";67739063665;Ne;9;0;0;9
15600;Saulutė;"4 klasė";13916981850;Ne;6;0;0;6
15601;Saulutė;"4 klasė";39606108938;Ne;9;0;0;9
15602;Saulutė;"4 klasė";81191097069;Ne;6;0;0;6
15603;Saulutė;"4 klasė";92198716772;Ne;14;0;0;14
15604;Saulutė;"4 klasė";16523279366;Ne;7;0;0;7
15605;Saulutė;"4 klasė";2262536579;Ne;12;0;0;12
15606;Saulutė;"4 klasė";2095347468;Ne;32;0;0;32
15607;Saulutė;"4 klasė";2819521168;Ne;7;0;0;7
15608;Saulutė;"4 klasė";37839378248;Ne;8;0;0;8
15609;Saulutė;"4 klasė";8308288099;Ne;9;0;0;9
15610;Saulutė;"4 klasė";30863736694;Ne;8;0;0;8
15611;Saulutė;"4 klasė";12964000357;Ne;10;0;0;10
15612;Saulutė;"4 klasė";54726632101;Ne;7;0;0;7
15613;Saulutė;"4 klasė";25720655179;Ne;8;0;0;8
15614;Saulutė;"4 klasė";45877127245;Ne;8;0;0;8
15615;Saulutė;"4 klasė";82106514982;Ne;8;0;0;8
15616;Saulutė;"4 klasė";61113930769;Ne;6;0;0;6
15617;Saulutė;"4 klasė";5213320470;Ne;12;0;0;12
15618;Saulutė;"4 klasė";90078805222;Ne;7;0;0;7
15619;Saulutė;"4 klasė";50110262859;Ne;10;0;0;10
15620;Saulutė;"4 klasė";42204884890;Ne;11;0;0;11
15621;Svaja;SAULĖGRĄŽA;4189290919;Ne;0;22;0;22
15622;Svaja;SAULĖGRĄŽA;4333001830;Ne;0;8;1;9
15623;Svaja;SAULĖGRĄŽA;3912426942;Ne;2;0;0;2
15624;Svaja;SAULĖGRĄŽA;9680766688;Ne;0;0;5;5
15625;Svaja;SAULĖGRĄŽA;4253831334;Ne;7;0;4;11
15626;Svaja;SAULĖGRĄŽA;3461282516;Ne;0;0;3;3
15627;Svaja;SAULĖGRĄŽA;9240037050;Ne;6;0;2;8
15628;Svaja;SAULĖGRĄŽA;7089640807;Ne;24;0;0;24
15629;Svaja;SAULĖGRĄŽA;6963684639;Ne;0;3;0;3
15630;Svaja;SAULĖGRĄŽA;4510147045;Ne;0;14;0;14
15631;Svaja;SAULĖGRĄŽA;6928763381;Ne;12;0;1;13
15632;Svaja;SAULĖGRĄŽA;3501620040;Ne;0;1;0;1
15633;Svaja;SAULĖGRĄŽA;7575922215;Ne;0;0;2;2
15634;Svaja;SAULĖGRĄŽA;7408966637;Ne;2;1;2;5
15635;Svaja;SAULĖGRĄŽA;7747251736;Ne;0;0;1;1
15636;Svaja;"STEBUKLINGAS ŽIBINTAS";9814969596;Ne;0;8;0;8
15637;Svaja;"STEBUKLINGAS ŽIBINTAS";2200408537;Ne;5;4;1;10
15638;Svaja;"STEBUKLINGAS ŽIBINTAS";3940123543;Ne;0;0;2;2
15639;Svaja;"STEBUKLINGAS ŽIBINTAS";8353427144;Ne;0;0;2;2
15640;Svaja;"STEBUKLINGAS ŽIBINTAS";9843726794;Ne;0;0;1;1
15641;Svaja;"STEBUKLINGAS ŽIBINTAS";4237592104;Ne;3;0;5;8
15642;Svaja;"STEBUKLINGAS ŽIBINTAS";1558093905;Ne;0;0;2;2
15643;Svaja;"STEBUKLINGAS ŽIBINTAS";8827421660;Ne;0;2;0;2
15644;Svaja;"STEBUKLINGAS ŽIBINTAS";7277217069;Ne;4;0;9;13
15645;Svaja;"STEBUKLINGAS ŽIBINTAS";9259478140;Ne;10;0;2;12
15646;Svaja;"STEBUKLINGAS ŽIBINTAS";1050291871;Ne;8;0;1;9
15647;Svaja;"STEBUKLINGAS ŽIBINTAS";2188430052;Ne;0;0;6;6
15648;Svaja;"STEBUKLINGAS ŽIBINTAS";1860076171;Ne;3;0;2;5
15649;Svaja;"STEBUKLINGAS ŽIBINTAS";8363418532;Ne;7;0;10;17
15650;Svaja;"STEBUKLINGAS ŽIBINTAS";8172396846;Ne;11;0;2;13
15651;Svaja;"STEBUKLINGAS ŽIBINTAS";9545690301;Ne;0;0;6;6
15652;Svaja;"STEBUKLINGAS ŽIBINTAS";4004383843;Ne;0;4;0;4
15653;Svaja;"STEBUKLINGAS ŽIBINTAS";6128350581;Ne;0;0;1;1
15654;Svaja;"STEBUKLINGAS ŽIBINTAS";1150040935;Ne;7;0;0;7
15655;Svaja;SAULUTĖ;50207734108;Ne;0;0;5;5
15656;Svaja;SAULUTĖ;20473739993;Ne;12;0;1;13
15657;Svaja;SAULUTĖ;30719991872;Ne;10;0;1;11
15658;Svaja;SAULUTĖ;4968201186;Ne;0;9;0;9
15659;Svaja;SAULUTĖ;8689706130;Ne;0;3;0;3
15660;Svaja;SAULUTĖ;6807834176;Ne;0;3;0;3
15661;Svaja;SAULUTĖ;3633996231;Ne;0;0;3;3
15662;Svaja;SAULUTĖ;2750615517;Ne;0;0;3;3
15663;Svaja;SAULUTĖ;3049808328;Ne;0;0;8;8
15664;Svaja;SAULUTĖ;1045300185;Ne;0;6;1;7
15665;Svaja;SAULUTĖ;4341042027;Ne;0;5;1;6
15666;Svaja;SAULUTĖ;3802996573;Ne;0;0;2;2
15667;Svaja;SAULUTĖ;4293339784;Ne;4;3;0;7
15668;Svaja;SAULUTĖ;9475971731;Ne;5;0;1;6
15669;Svaja;SAULUTĖ;5479482244;Ne;0;0;1;1
15670;Svaja;SAULUTĖ;7473493846;Ne;10;0;1;11
15671;Svaja;SAULUTĖ;5443682744;Ne;0;1;0;1
15672;Svaja;SAULUTĖ;9112198914;Ne;0;4;0;4
15673;Svaja;SAULUTĖ;3630922360;Ne;0;7;1;8
15674;Svaja;"AUKSINĖ ŽUVELĖ";4565097904;Ne;0;0;1;1
15675;Svaja;"AUKSINĖ ŽUVELĖ";9091970902;Ne;0;0;2;2
15676;Svaja;"AUKSINĖ ŽUVELĖ";9826552657;Ne;0;0;1;1
15677;Svaja;"AUKSINĖ ŽUVELĖ";6028471687;Ne;2;5;2;9
15678;Svaja;"AUKSINĖ ŽUVELĖ";1877749103;Ne;6;0;0;6
15679;Svaja;"AUKSINĖ ŽUVELĖ";5033214011;Ne;3;0;1;4
15680;Svaja;"AUKSINĖ ŽUVELĖ";5224855138;Ne;7;0;0;7
15681;Svaja;"AUKSINĖ ŽUVELĖ";5013548619;Ne;0;6;0;6
15682;Svaja;"AUKSINĖ ŽUVELĖ";5908440171;Ne;0;0;5;5
15683;Svaja;"AUKSINĖ ŽUVELĖ";5230444195;Ne;0;0;2;2
15684;Svaja;"AUKSINĖ ŽUVELĖ";1914129062;Ne;0;0;4;4
15685;Svaja;"AUKSINĖ ŽUVELĖ";3567924341;Ne;6;0;3;9
15686;Svaja;"AUKSINĖ ŽUVELĖ";2427918378;Ne;0;1;0;1
15687;Svaja;"AUKSINĖ ŽUVELĖ";7605002899;Ne;0;0;8;8
15688;Svaja;"AUKSINĖ ŽUVELĖ";5198482539;Ne;0;10;0;10
15689;Svaja;"AUKSINĖ ŽUVELĖ";7562678317;Ne;0;0;4;4
15690;Svaja;"AUKSINĖ ŽUVELĖ";2641473764;Ne;0;0;2;2
15691;Svaja;"AUKSINĖ ŽUVELĖ";7434898745;Ne;0;4;0;4
15692;Svaja;"PRIE ĮLANKOS";1633236289;Ne;2;0;0;2
15693;Svaja;"PRIE ĮLANKOS";9414846817;Ne;9;0;6;15
15694;Svaja;"PRIE ĮLANKOS";9311520300;Ne;1;0;0;1
15695;Svaja;"PRIE ĮLANKOS";9864664937;Ne;0;0;1;1
15696;Svaja;"PRIE ĮLANKOS";4014493868;Ne;0;3;0;3
15697;Svaja;"PRIE ĮLANKOS";6388514464;Ne;0;3;0;3
15698;Svaja;"PRIE ĮLANKOS";5862570666;Ne;4;0;1;5
15699;Svaja;"PRIE ĮLANKOS";3459060550;Ne;2;20;0;22
15700;Svaja;"PRIE ĮLANKOS";1617844709;Ne;5;0;10;15
15701;Svaja;"PRIE ĮLANKOS";3458374439;Ne;0;0;1;1
15702;Svaja;"PRIE ĮLANKOS";3102257512;Ne;5;0;2;7
15703;Svaja;"PRIE ĮLANKOS";4393041946;Ne;0;7;0;7
15704;Svaja;"PRIE ĮLANKOS";1044733634;Ne;0;0;1;1
15705;Svaja;"PRIE ĮLANKOS";6676145522;Ne;5;0;1;6
15706;Svaja;"PRIE ĮLANKOS";9950569499;Ne;0;0;3;3
15707;Svaja;"PRIE ĮLANKOS";3868254757;Ne;8;0;0;8
15708;Svaja;"PRIE ĮLANKOS";6361228838;Ne;3;0;1;4
15709;Svaja;"PRIE ĮLANKOS";7514587933;Ne;0;0;12;12
15710;Svaja;"1 B klasė";24863928147;Ne;0;1;0;1
15711;Svaja;"1 B klasė";1865658456;Ne;0;4;0;4
15712;Svaja;"1 B klasė";8279605005;Ne;0;22;0;22
15713;Svaja;"1 B klasė";55925058866;Ne;0;22;0;22
15714;Svaja;"1 B klasė";1437557657;Ne;0;15;0;15
15715;Svaja;"1 B klasė";25194696146;Ne;0;3;0;3
15716;Svaja;"1 B klasė";1704075006;Ne;0;1;0;1
15717;Svaja;"1 B klasė";8875237023;Ne;0;6;0;6
15718;Svaja;"1 B klasė";64196174690;Ne;12;10;0;22
15719;Svaja;"1 B klasė";8491275729;Ne;0;1;0;1
15720;Svaja;"1 B klasė";21871530266;Ne;0;4;0;4
15721;Svaja;"1 B klasė";7753488216;Ne;0;6;0;6
15722;Svaja;"1 B klasė";36505115395;Ne;0;22;0;22
15723;Svaja;"1 B klasė";7911488445;Ne;3;1;0;4
15724;Svaja;"1 B klasė";6593047776;Ne;0;1;0;1
15725;Svaja;"1 B klasė";15159708127;Ne;0;4;0;4
15726;Svaja;"1 B klasė";2985196852;Ne;0;5;0;5
15727;Svaja;"1 B klasė";9110985103;Ne;0;5;0;5
15728;Svaja;"1 B klasė";3562817807;Ne;3;0;0;3
15729;Svaja;"1 B klasė";2069150261;Ne;0;3;0;3
15730;Svaja;"1 B klasė";1191494598;Ne;0;6;0;6
15731;Svaja;"1 B klasė";11671380984;Ne;0;4;0;4
15732;Svaja;"1 B klasė";99183628764;Ne;0;6;0;6
15733;Svaja;"1 B klasė";1369637618;Ne;0;1;0;1
15734;Svaja;"1 B klasė";3660152224;Ne;0;1;0;1
15735;Svaja;"1 A klasė";5337604370;Ne;0;2;0;2
15736;Svaja;"1 A klasė";1046879533;Ne;0;2;0;2
15737;Svaja;"1 A klasė";2147266053;Ne;0;7;0;7
15738;Svaja;"1 A klasė";4846025153;Ne;0;2;0;2
15739;Svaja;"1 A klasė";1714711904;Ne;0;3;0;3
15740;Svaja;"1 A klasė";47457128214;Ne;0;6;0;6
15741;Svaja;"1 A klasė";65917456866;Ne;0;1;0;1
15742;Svaja;"1 A klasė";1197826066;Ne;0;2;0;2
15743;Svaja;"1 A klasė";73679997517;Ne;0;22;0;22
15744;Svaja;"1 A klasė";7669562010;Ne;0;4;0;4
15745;Svaja;"1 A klasė";5335776957;Ne;0;22;0;22
15746;Svaja;"1 A klasė";56117509354;Ne;0;2;0;2
15747;Svaja;"1 A klasė";27445299450;Ne;0;1;0;1
15748;Svaja;"1 A klasė";1576498450;Ne;0;1;0;1
15749;Svaja;"1 A klasė";43307670660;Ne;0;4;0;4
15750;Svaja;"1 A klasė";22702341083;Ne;8;2;0;10
15751;Svaja;"1 A klasė";70641067006;Ne;0;22;0;22
15752;Svaja;"1 A klasė";58102699652;Ne;0;4;0;4
15753;Svaja;"1 A klasė";2076060840;Ne;0;1;0;1
15754;Svaja;"1 A klasė";4900757614;Ne;0;1;0;1
15755;Svaja;"1 A klasė";1061894314;Ne;0;4;0;4
15756;Svaja;"1 A klasė";8697355813;Ne;0;10;0;10
15757;Svaja;"1 A klasė";193181908;Ne;0;1;0;1
15758;Svaja;"1 A klasė";193181908;Ne;0;1;0;1
15759;Svaja;"2 A klasė";9628146488;Ne;0;3;0;3
15760;Svaja;"2 A klasė";43223177664;Ne;5;1;0;6
15761;Svaja;"2 A klasė";1017471747;Ne;0;1;0;1
15762;Svaja;"2 A klasė";26500981786;Ne;0;3;0;3
15763;Svaja;"2 A klasė";5522433229;Ne;0;7;0;7
15764;Svaja;"2 A klasė";1400892707;Ne;0;6;0;6
15765;Svaja;"2 A klasė";30027404222;Ne;0;1;0;1
15766;Svaja;"2 A klasė";1297727288;Ne;0;22;0;22
15767;Svaja;"2 A klasė";1304775332;Ne;0;2;0;2
15768;Svaja;"2 A klasė";8198614500;Ne;0;4;0;4
15769;Svaja;"2 A klasė";67462299886;Ne;0;6;0;6
15770;Svaja;"2 A klasė";40856210635;Ne;0;1;0;1
15771;Svaja;"2 A klasė";18733824395;Ne;0;3;0;3
15772;Svaja;"2 A klasė";84508228457;Ne;5;0;0;5
15773;Svaja;"2 A klasė";2058827699;Ne;0;4;0;4
15774;Svaja;"2 A klasė";1660742385;Ne;5;1;0;6
15775;Svaja;"2 A klasė";89042677798;Ne;0;3;0;3
15776;Svaja;"2 A klasė";26902749194;Ne;0;2;0;2
15777;Svaja;"2 A klasė";3022690832;Ne;0;4;0;4
15778;Svaja;"2 A klasė";1943166503;Ne;0;3;0;3
15779;Svaja;"2 A klasė";1048576329;Ne;0;1;0;1
15780;Svaja;"2 B klasė";4804779327;Ne;21;1;0;22
15781;Svaja;"2 B klasė";7719185632;Ne;0;1;0;1
15782;Svaja;"2 B klasė";69028070656;Ne;0;5;0;5
15783;Svaja;"2 B klasė";30036722764;Ne;0;7;0;7
15784;Svaja;"2 B klasė";1509272327;Ne;0;7;0;7
15785;Svaja;"2 B klasė";89316574266;Ne;0;1;0;1
15786;Svaja;"2 B klasė";78293798850;Ne;13;0;0;13
15787;Svaja;"2 B klasė";40814723278;Ne;5;0;0;5
15788;Svaja;"2 B klasė";1967394949;Ne;0;1;0;1
15789;Svaja;"2 B klasė";19887874988;Ne;0;1;0;1
15790;Svaja;"2 B klasė";69413101571;Ne;0;4;0;4
15791;Svaja;"2 B klasė";57216954289;Ne;0;13;0;13
15792;Svaja;"2 B klasė";1655551042;Ne;0;1;0;1
15793;Svaja;"2 B klasė";44989143252;Ne;0;1;0;1
15794;Svaja;"2 B klasė";6056157113;Ne;0;3;0;3
15795;Svaja;"2 B klasė";30360097999;Ne;0;22;0;22
15796;Svaja;"3 A klasė";72752022712;Ne;0;3;0;3
15797;Svaja;"3 A klasė";8828911320;Ne;0;2;0;2
15798;Svaja;"3 A klasė";60448774566;Ne;0;5;0;5
15799;Svaja;"3 A klasė";75104768118;Ne;0;1;0;1
15800;Svaja;"3 A klasė";1649920341;Ne;0;2;0;2
15801;Svaja;"3 A klasė";30754812113;Ne;0;2;0;2
15802;Svaja;"3 A klasė";64487515384;Ne;0;22;0;22
15803;Svaja;"3 A klasė";34216516886;Ne;0;1;0;1
15804;Svaja;"3 A klasė";3474439050;Ne;0;6;0;6
15805;Svaja;"3 A klasė";63346231562;Ne;0;8;0;8
15806;Svaja;"3 A klasė";75296600945;Ne;0;2;0;2
15807;Svaja;"3 A klasė";6057524892;Ne;0;1;0;1
15808;Svaja;"3 A klasė";2321739150;Ne;0;3;0;3
15809;Svaja;"3 A klasė";4617061890;Ne;0;3;0;3
15810;Svaja;"3 A klasė";89695643588;Ne;0;5;0;5
15811;Svaja;"3 A klasė";3604946305;Ne;0;22;0;22
15812;Svaja;"3 A klasė";25578518444;Ne;0;1;0;1
15813;Svaja;"3 A klasė";1168637823;Ne;0;8;0;8
15814;Svaja;"3 A klasė";4906784415;Ne;0;3;0;3
15815;Svaja;"3 A klasė";15252353189;Ne;0;1;0;1
15816;Svaja;"3 B klasė";6905550313;Ne;0;3;0;3
15817;Svaja;"3 B klasė";62971657427;Ne;0;1;0;1
15818;Svaja;"3 B klasė";1367687415;Ne;0;1;0;1
15819;Svaja;"3 B klasė";4416877973;Ne;3;1;0;4
15820;Svaja;"3 B klasė";1847775266;Ne;0;22;0;22
15821;Svaja;"3 B klasė";17947580061;Ne;0;6;0;6
15822;Svaja;"3 B klasė";6969692916;Ne;0;6;0;6
15823;Svaja;"3 B klasė";44418402260;Ne;0;1;0;1
15824;Svaja;"3 B klasė";50649509868;Ne;0;1;0;1
15825;Svaja;"3 B klasė";73391331150;Ne;0;7;0;7
15826;Svaja;"3 B klasė";70507326327;Ne;0;22;0;22
15827;Svaja;"3 B klasė";80772711351;Ne;0;2;0;2
15828;Svaja;"3 B klasė";54328462992;Ne;0;22;0;22
15829;Svaja;"3 B klasė";1470843400;Ne;0;2;0;2
15830;Svaja;"3 B klasė";92044111261;Ne;0;1;0;1
15831;Svaja;"3 B klasė";11937575740;Ne;0;1;0;1
15832;Svaja;"3 B klasė";8011137572;Ne;0;5;0;5
15833;Svaja;"3 B klasė";71708072632;Ne;0;6;0;6
15834;Svaja;"3 B klasė";56506642672;Ne;0;2;0;2
15835;Svaja;"3 B klasė";3526873547;Ne;0;22;0;22
15836;Svaja;"3 B klasė";70506691027;Ne;0;22;0;22
15837;Svaja;"3 B klasė";4282243865;Ne;0;22;0;22
15838;Svaja;"4 A klasė";96680395594;Ne;0;3;0;3
15839;Svaja;"4 A klasė";31604152893;Ne;0;2;0;2
15840;Svaja;"4 A klasė";70513111186;Ne;0;3;0;3
15841;Svaja;"4 A klasė";72655912805;Ne;0;27;0;27
15842;Svaja;"4 A klasė";20363553383;Ne;6;1;0;7
15843;Svaja;"4 A klasė";8876971658;Ne;0;5;0;5
15844;Svaja;"4 A klasė";69928474471;Ne;0;27;0;27
15845;Svaja;"4 A klasė";49184638535;Ne;0;27;0;27
15846;Svaja;"4 A klasė";3775578708;Taip;0;12;0;12
15847;Svaja;"4 A klasė";58497063533;Ne;0;6;0;6
15848;Svaja;"4 A klasė";89075087937;Ne;0;4;0;4
15849;Svaja;"4 A klasė";99157757025;Ne;0;3;0;3
15850;Svaja;"4 A klasė";16955510836;Ne;0;4;0;4
15851;Svaja;"4 A klasė";24812635291;Ne;0;4;0;4
15852;Svaja;"4 A klasė";21534170175;Ne;0;2;0;2
15853;Svaja;"4 A klasė";28311552445;Ne;0;7;0;7
15854;Svaja;"4 A klasė";38781141060;Ne;0;2;0;2
15855;Svaja;"4 A klasė";88447528808;Ne;0;3;0;3
15856;Svaja;"4 A klasė";66507774550;Ne;0;4;0;4
15857;Svaja;"4 A klasė";76101749947;Ne;0;27;0;27
15858;Svaja;"4 A klasė";18432518932;Ne;0;6;0;6
15859;Svaja;"4 B klasė";61996055386;Ne;0;27;0;27
15860;Svaja;"4 B klasė";57983452414;Ne;0;27;0;27
15861;Svaja;"4 B klasė";30200636424;Ne;0;27;0;27
15862;Svaja;"4 B klasė";8802243719;Ne;0;27;0;27
15863;Svaja;"4 B klasė";7747921362;Ne;0;27;0;27
15864;Svaja;"4 B klasė";38464012322;Ne;0;2;0;2
15865;Svaja;"4 B klasė";5712106350;Ne;0;4;0;4
15866;Svaja;"4 B klasė";9401605132;Ne;0;2;0;2
15867;Svaja;"4 B klasė";27313057222;Ne;0;27;0;27
15868;Svaja;"4 B klasė";68894832324;Ne;0;27;0;27
15869;Svaja;"4 B klasė";29972474690;Ne;0;27;0;27
15870;Svaja;"4 B klasė";47441661801;Ne;0;4;0;4
15871;Svaja;"4 B klasė";62579722313;Ne;0;2;0;2
15872;Svaja;"4 B klasė";21035820496;Ne;0;27;0;27
15873;Svaja;"4 B klasė";71840791098;Ne;0;4;0;4
15874;Svaja;"4 B klasė";59707838958;Ne;0;27;0;27
15875;Svaja;"4 B klasė";71086654007;Ne;0;27;0;27
15876;Svaja;"4 B klasė";15871540340;Ne;6;21;0;27
15877;Svaja;"4 B klasė";97651620085;Ne;0;2;0;2
15878;Svaja;"4 B klasė";77796846388;Ne;0;27;0;27
15879;Svaja;"4 C klasė";79260508923;Ne;0;2;0;2
15880;Svaja;"4 C klasė";94437606762;Ne;0;27;0;27
15881;Svaja;"4 C klasė";73440582394;Ne;0;27;0;27
15882;Svaja;"4 C klasė";60982723867;Ne;0;27;0;27
15883;Svaja;"4 C klasė";70157518595;Ne;0;27;0;27
15884;Svaja;"4 C klasė";5975083034;Ne;8;19;0;27
15885;Svaja;"4 C klasė";76871144487;Ne;0;27;0;27
15886;Svaja;"4 C klasė";6613028133;Ne;0;5;0;5
15887;Svaja;"4 C klasė";48888360976;Ne;0;2;0;2
15888;Svaja;"4 C klasė";12226488343;Ne;0;27;0;27
15889;Svaja;"4 C klasė";3909240894;Ne;0;4;0;4
15890;Svaja;"4 C klasė";53352329988;Ne;0;9;0;9
15891;Svaja;"4 C klasė";59917024948;Ne;0;3;0;3
15892;Svaja;"4 C klasė";73691352138;Ne;0;3;0;3
15893;Svaja;"4 C klasė";66967032561;Ne;4;2;0;6
15894;Svaja;"4 C klasė";77712240909;Ne;0;2;0;2
15895;Svaja;"4 C klasė";82358174131;Ne;0;3;0;3
15896;Svaja;"4 C klasė";25585032766;Ne;0;27;0;27
15897;Svaja;"4 C klasė";79572045341;Ne;0;27;0;27
15898;Svaja;"3 C klasė";1848422504;Ne;0;1;0;1
15899;Svaja;"3 C klasė";3743948734;Ne;0;1;0;1
15900;Svaja;"3 C klasė";25934507261;Ne;0;2;0;2
15901;Svaja;"3 C klasė";89047123808;Ne;0;21;0;21
15902;Svaja;"3 C klasė";74904581010;Ne;0;22;0;22
15903;Svaja;"3 C klasė";50510924690;Ne;0;1;0;1
15904;Svaja;"3 C klasė";41183537732;Ne;2;7;0;9
15905;Svaja;"3 C klasė";70714898590;Ne;0;8;0;8
15906;Svaja;"3 C klasė";54852358913;Ne;0;4;0;4
15907;Svaja;"3 C klasė";57253216255;Ne;0;3;0;3
15908;Svaja;"3 C klasė";34995551069;Ne;0;22;0;22
15909;Svaja;"3 C klasė";1795682827;Ne;0;5;0;5
15910;Svaja;"3 C klasė";93651139102;Ne;0;1;0;1
15911;Svaja;"3 C klasė";1742951527;Ne;0;3;0;3
15912;Svaja;"3 C klasė";91855230473;Ne;0;7;0;7
15913;Svaja;"3 C klasė";1855559693;Ne;0;22;0;22
15914;Svaja;"3 C klasė";2165716699;Ne;0;22;0;22
15915;Svaja;"3 C klasė";31216445971;Ne;0;22;0;22
15916;Svaja;"3 C klasė";20342193231;Ne;0;9;0;9
15917;Svaja;"3 C klasė";54462393937;Ne;0;2;0;2
15918;Svaja;"3 C klasė";36001411632;Ne;0;1;0;1
15919;Svaja;"3 C klasė";94449039022;Ne;0;22;0;22
15920;Svaja;"3 C klasė";85150525696;Ne;0;2;0;2
15921;Svaja;"3 C klasė";91088224294;Ne;0;22;0;22
15922;Šilelis;PAUKŠTELIAI;6128379060;Ne;16;6;0;22
15923;Šilelis;PAUKŠTELIAI;9653439873;Ne;4;0;0;4
15924;Šilelis;PAUKŠTELIAI;2823486581;Ne;0;2;0;2
15925;Šilelis;PAUKŠTELIAI;6369443270;Ne;0;9;0;9
15926;Šilelis;PAUKŠTELIAI;7595774842;Ne;2;7;0;9
15927;Šilelis;PAUKŠTELIAI;6614686867;Ne;7;0;3;10
15928;Šilelis;PAUKŠTELIAI;3053443777;Ne;0;0;2;2
15929;Šilelis;PAUKŠTELIAI;4960501068;Ne;8;3;0;11
15930;Šilelis;PAUKŠTELIAI;7072057348;Ne;0;1;0;1
15931;Šilelis;PAUKŠTELIAI;5974537364;Ne;0;9;8;17
15932;Šilelis;PAUKŠTELIAI;8166061969;Ne;5;0;2;7
15933;Šilelis;PAUKŠTELIAI;1124854378;Ne;7;1;0;8
15934;Šilelis;PAUKŠTELIAI;4432542988;Ne;5;0;0;5
15935;Šilelis;PAUKŠTELIAI;6852463814;Ne;2;7;8;17
15936;Šilelis;PAUKŠTELIAI;9799198904;Ne;0;0;1;1
15937;Šilelis;PAUKŠTELIAI;5493811298;Ne;0;0;1;1
15938;Šilelis;SKRUZDELIUKAI;7502057552;Ne;0;0;2;2
15939;Šilelis;SKRUZDELIUKAI;6359318134;Ne;0;0;2;2
15940;Šilelis;SKRUZDELIUKAI;5598152793;Taip;11;0;1;12
15941;Šilelis;SKRUZDELIUKAI;8090773379;Ne;0;6;0;6
15942;Šilelis;SKRUZDELIUKAI;1200024379;Ne;0;0;6;6
15943;Šilelis;SKRUZDELIUKAI;7299084520;Ne;8;3;0;11
15944;Šilelis;SKRUZDELIUKAI;9589138527;Ne;6;10;0;16
15945;Šilelis;SKRUZDELIUKAI;3967932407;Ne;0;6;0;6
15946;Šilelis;SKRUZDELIUKAI;2972202874;Taip;7;11;0;18
15947;Šilelis;SKRUZDELIUKAI;9461117894;Ne;9;4;0;13
15948;Šilelis;SKRUZDELIUKAI;5817818596;Ne;7;0;8;15
15949;Šilelis;SKRUZDELIUKAI;6827855685;Ne;4;0;5;9
15950;Šilelis;SKRUZDELIUKAI;5091571136;Ne;0;5;0;5
15951;Šilelis;SKRUZDELIUKAI;8297975308;Ne;0;13;0;13
15952;Šilelis;SKRUZDELIUKAI;3381053227;Ne;12;2;0;14
15953;Šilelis;SKRUZDELIUKAI;9276607554;Taip;0;11;0;11
15954;Šilelis;SMERFY;3247333567;Ne;0;2;0;2
15955;Šilelis;SMERFY;9886134621;Ne;0;1;0;1
15956;Šilelis;SMERFY;6773906184;Ne;0;2;0;2
15957;Šilelis;SMERFY;3089270468;Ne;0;9;0;9
15958;Šilelis;SMERFY;7824279279;Ne;0;3;0;3
15959;Šilelis;SMERFY;6390855924;Ne;5;1;0;6
15960;Šilelis;SMERFY;4196893379;Ne;0;1;0;1
15961;Šilelis;SMERFY;5025956218;Ne;10;0;0;10
15962;Šilelis;EŽIUKAI;7074963804;Ne;0;8;0;8
15963;Šilelis;EŽIUKAI;4702068672;Ne;3;6;0;9
15964;Šilelis;EŽIUKAI;2295849333;Ne;0;3;0;3
15965;Šilelis;EŽIUKAI;5131051261;Ne;2;0;1;3
15966;Šilelis;EŽIUKAI;1883483049;Ne;0;2;0;2
15967;Šilelis;EŽIUKAI;6386996498;Ne;0;5;1;6
15968;Šilelis;NYKŠTUKAI;3046954717;Ne;0;0;1;1
15969;Šilelis;NYKŠTUKAI;3158708835;Ne;0;2;0;2
15970;Šilelis;NYKŠTUKAI;6195580698;Ne;0;0;3;3
15971;Šilelis;NYKŠTUKAI;6107771932;Ne;0;3;2;5
15972;Šilelis;NYKŠTUKAI;4323998445;Ne;0;0;9;9
15973;Šilelis;NYKŠTUKAI;2095572561;Taip;10;0;2;12
15974;Šilelis;NYKŠTUKAI;2161973782;Ne;0;3;0;3
15975;Šilelis;NYKŠTUKAI;4459114205;Ne;5;0;0;5
15976;Šilelis;NYKŠTUKAI;3728633100;Ne;0;1;4;5
15977;Šilelis;NYKŠTUKAI;3999426414;Ne;0;13;0;13
15978;Šilelis;NYKŠTUKAI;5745874033;Ne;0;8;0;8
15979;Šilelis;NYKŠTUKAI;9769483899;Ne;10;3;0;13
15980;Šilelis;NYKŠTUKAI;8944490184;Ne;0;2;1;3
15981;Šilelis;NYKŠTUKAI;3120671593;Ne;0;0;1;1
15982;Šilelis;NYKŠTUKAI;2908840424;Ne;0;0;2;2
15983;Šilelis;NYKŠTUKAI;6980045156;Ne;0;8;0;8
15984;Šilelis;NYKŠTUKAI;9685227636;Ne;0;15;0;15
15985;Šilelis;NYKŠTUKAI;4868465692;Ne;5;6;0;11
15986;Šilelis;NYKŠTUKAI;4754544277;Ne;17;5;0;22
15987;Šilelis;NYKŠTUKAI;1222028604;Ne;0;22;0;22
15988;Šilelis;NYKŠTUKAI;7480611069;Ne;0;3;0;3
15989;Šilelis;ANČIUKAI;1726944289;Ne;0;0;2;2
15990;Šilelis;ANČIUKAI;4336942500;Ne;5;0;0;5
15991;Šilelis;ANČIUKAI;9661578871;Ne;0;0;6;6
15992;Šilelis;ANČIUKAI;6616262730;Ne;7;5;1;13
15993;Šilelis;ANČIUKAI;4323750313;Ne;7;0;0;7
15994;Šilelis;ANČIUKAI;3221398692;Ne;8;0;0;8
15995;Šilelis;ANČIUKAI;6364741317;Ne;7;0;0;7
15996;Šilelis;ANČIUKAI;1325857464;Taip;3;0;3;6
15997;Šilelis;ANČIUKAI;9407916190;Ne;3;5;0;8
15998;Šilelis;ANČIUKAI;8188160849;Ne;2;0;0;2
15999;Šilelis;ANČIUKAI;8613748314;Ne;7;5;0;12
16000;Šilelis;ANČIUKAI;5381213051;Taip;0;0;4;4
16001;Šilelis;ANČIUKAI;2976607303;Ne;0;0;3;3
16002;Šilelis;ANČIUKAI;8807755852;Ne;0;5;0;5
16003;Šilelis;ANČIUKAI;4135383684;Ne;0;10;0;10
16004;Šilelis;ANČIUKAI;5926624138;Taip;0;0;2;2
16005;Šilelis;ANČIUKAI;8603589758;Ne;9;0;1;10
16006;Šilelis;KAČIUKAI;9899047136;Ne;20;0;0;20
16007;Šilelis;KAČIUKAI;3216168797;Ne;0;17;0;17
16008;Šilelis;KAČIUKAI;9848760151;Ne;0;1;0;1
16009;Šilelis;KAČIUKAI;4743459915;Ne;0;10;0;10
16010;Šilelis;KAČIUKAI;8387022157;Ne;0;9;0;9
16011;Šilelis;KAČIUKAI;3393466953;Ne;0;5;0;5
16012;Šilelis;KAČIUKAI;2111979474;Ne;1;0;0;1
16013;Šilelis;KAČIUKAI;8064905796;Ne;0;7;0;7
16014;Šilelis;KAČIUKAI;5176259940;Ne;0;0;2;2
16015;Šilelis;KAČIUKAI;7123048946;Ne;11;1;1;13
16016;Šilelis;KAČIUKAI;6479728064;Ne;0;6;0;6
16017;Šilelis;KAČIUKAI;2906501601;Ne;0;5;0;5
16018;Šilelis;KAČIUKAI;6510813364;Ne;0;13;0;13
16019;Šilelis;KAČIUKAI;8319185507;Ne;0;1;0;1
16020;Šilelis;KAČIUKAI;8504187981;Ne;0;0;3;3
16021;Šilelis;KAČIUKAI;6470073008;Ne;0;1;0;1
16022;Šilelis;KAČIUKAI;3419284228;Ne;7;1;2;10
16023;Šilelis;KAČIUKAI;3712001932;Ne;0;1;0;1
16024;Šilelis;KAČIUKAI;9106999969;Ne;0;3;0;3
16025;Šilelis;KAČIUKAI;5026203678;Ne;6;5;0;11
16026;Šilelis;KIŠKUČIAI;8632645047;Ne;0;0;2;2
16027;Šilelis;KIŠKUČIAI;8759694551;Ne;0;0;3;3
16028;Šilelis;KIŠKUČIAI;2209552706;Ne;12;10;0;22
16029;Šilelis;KIŠKUČIAI;4386065478;Ne;0;2;0;2
16030;Šilelis;KIŠKUČIAI;7043644521;Ne;8;0;2;10
16031;Šilelis;KIŠKUČIAI;8096868221;Ne;0;0;1;1
16032;Šilelis;KIŠKUČIAI;3395084186;Ne;6;0;0;6
16033;Šilelis;KIŠKUČIAI;2551747888;Ne;0;5;0;5
16034;Šilelis;KIŠKUČIAI;5815768693;Ne;3;0;0;3
16035;Šilelis;KIŠKUČIAI;8598321310;Ne;0;0;3;3
16036;Šilelis;KREGŽDUTĖS;1025643459;Ne;14;0;0;14
16037;Šilelis;KREGŽDUTĖS;2896605690;Ne;0;0;2;2
16038;Šilelis;KREGŽDUTĖS;8453070684;Ne;6;0;5;11
16039;Šilelis;KREGŽDUTĖS;1286082219;Ne;2;0;3;5
16040;Šilelis;KREGŽDUTĖS;3068950702;Ne;6;0;1;7
16041;Šilelis;KREGŽDUTĖS;8665357907;Ne;16;3;0;19
16042;Šilelis;KREGŽDUTĖS;1152159735;Taip;9;0;0;9
16043;Šilelis;KREGŽDUTĖS;6630114847;Taip;15;0;0;15
16044;Šilelis;KREGŽDUTĖS;3953114161;Taip;3;0;2;5
16045;Šilelis;KREGŽDUTĖS;2499322761;Ne;0;0;2;2
16046;Šilelis;KREGŽDUTĖS;8659845107;Ne;0;0;5;5
16047;Šilelis;KREGŽDUTĖS;5868594049;Ne;2;0;4;6
16048;Šilelis;KREGŽDUTĖS;8855625488;Ne;19;0;3;22
16049;Šilelis;KREGŽDUTĖS;1279361795;Taip;10;5;0;15
16050;Šilelis;KREGŽDUTĖS;9292761872;Ne;0;0;22;22
16051;Šilelis;KREGŽDUTĖS;9715544798;Ne;0;5;0;5
16052;Šilelis;PAGRANDUKAI;9922962130;Ne;5;3;0;8
16053;Šilelis;PAGRANDUKAI;4814863979;Ne;5;1;0;6
16054;Šilelis;PAGRANDUKAI;9670243727;Ne;0;3;0;3
16055;Šilelis;PAGRANDUKAI;8357287467;Ne;0;1;0;1
16056;Šilelis;PAGRANDUKAI;20525573092;Ne;0;6;0;6
16057;Šilelis;PAGRANDUKAI;2897196188;Ne;0;0;4;4
16058;Šilelis;PAGRANDUKAI;3583955729;Ne;0;1;0;1
16059;Šilelis;PAGRANDUKAI;9113098594;Ne;0;0;4;4
16060;Šilelis;PAGRANDUKAI;7623203279;Ne;0;0;12;12
16061;Šilelis;PAGRANDUKAI;4340856490;Ne;0;2;0;2
16062;Šilelis;PAGRANDUKAI;3807787648;Ne;0;0;8;8
16063;Šilelis;PAGRANDUKAI;8416126751;Ne;0;0;2;2
16064;Šilelis;PAGRANDUKAI;2397366916;Taip;0;5;0;5
16065;Šilelis;PAGRANDUKAI;7936978436;Ne;0;4;0;4
16066;Šilelis;PAGRANDUKAI;1747920772;Ne;0;2;1;3
16067;Šilelis;PAGRANDUKAI;3843999609;Ne;0;0;10;10
16068;Šilelis;PAGRANDUKAI;1898004894;Ne;0;4;0;4
16069;Šilelis;BITUTĖS;7512731255;Ne;4;6;0;10
16070;Šilelis;BITUTĖS;1268335563;Ne;12;0;3;15
16071;Šilelis;BITUTĖS;9035595952;Ne;0;0;1;1
16072;Šilelis;BITUTĖS;7814807923;Ne;12;7;0;19
16073;Šilelis;BITUTĖS;9071963194;Ne;14;1;2;17
16074;Šilelis;BITUTĖS;5843337891;Ne;5;0;0;5
16075;Šilelis;BITUTĖS;1960952604;Ne;5;2;1;8
16076;Šilelis;BITUTĖS;3954379433;Taip;9;9;0;18
16077;Šilelis;BITUTĖS;7350013139;Ne;0;10;0;10
16078;Šilelis;BITUTĖS;3879234745;Ne;0;0;2;2
16079;Šilelis;BITUTĖS;1390916076;Ne;5;6;2;13
16080;Šilelis;BITUTĖS;6143099736;Ne;0;8;0;8
16081;Šilelis;BITUTĖS;2667785768;Ne;12;0;0;12
16082;Šilelis;BITUTĖS;5375413045;Ne;0;12;0;12
16083;Šilelis;BITUTĖS;6297546907;Ne;7;0;0;7
16084;Šilelis;BITUTĖS;4682742121;Ne;2;0;0;2
16085;Šilelis;BITUTĖS;9234766553;Ne;0;0;2;2
16086;Šilelis;BITUTĖS;6830200578;Ne;2;5;0;7
16087;Šilelis;DRUGELIAI;2079073174;Ne;0;0;1;1
16088;Šilelis;DRUGELIAI;3598370884;Ne;0;2;1;3
16089;Šilelis;DRUGELIAI;1347150938;Ne;5;0;0;5
16090;Šilelis;DRUGELIAI;7636725161;Ne;12;0;0;12
16091;Šilelis;DRUGELIAI;1891388542;Ne;0;1;0;1
16092;Šilelis;DRUGELIAI;5759824196;Ne;0;11;0;11
16093;Šilelis;DRUGELIAI;4115738520;Ne;0;2;1;3
16094;Šilelis;DRUGELIAI;3824174896;Ne;0;2;1;3
16095;Šilelis;DRUGELIAI;8090765017;Ne;11;0;0;11
16096;Šilelis;DRUGELIAI;54633547799;Ne;0;1;0;1
16097;Šilelis;DRUGELIAI;9100047520;Ne;0;2;0;2
16098;Šilelis;DRUGELIAI;1019874215;Ne;0;0;1;1
16099;Šilelis;DRUGELIAI;1638362625;Ne;9;7;0;16
16100;Šilelis;DRUGELIAI;9482667810;Ne;10;0;4;14
16101;Šilelis;DRUGELIAI;5379171382;Ne;0;2;0;2
16102;Šilelis;DRUGELIAI;6230566495;Ne;0;2;0;2
16103;Šilelis;DRUGELIAI;6523676718;Ne;6;0;1;7
16104;Šilelis;DRUGELIAI;5766702969;Ne;0;6;0;6
16105;Šilelis;DRUGELIAI;8915228012;Ne;0;0;1;1
16106;Šilelis;DRUGELIAI;1984731000;Ne;0;2;0;2
16107;Šilelis;DRUGELIAI;6104538160;Ne;0;2;2;4
16108;Šilelis;DRUGELIAI;7542121945;Ne;0;1;0;1
16109;Vaduvos;PAGRANDUKAI;1431863758;Ne;7;1;0;8
16110;Vaduvos;PAGRANDUKAI;8408017356;Ne;0;11;0;11
16111;Vaduvos;PAGRANDUKAI;72724196791;Ne;0;10;5;15
16112;Vaduvos;PAGRANDUKAI;9371067563;Ne;0;1;0;1
16113;Vaduvos;PAGRANDUKAI;6425640531;Ne;0;1;0;1
16114;Vaduvos;PAGRANDUKAI;4029586203;Ne;3;1;0;4
16115;Vaduvos;PAGRANDUKAI;73800920781;Ne;0;5;0;5
16116;Vaduvos;PAGRANDUKAI;18035723255;Ne;0;1;0;1
16117;Vaduvos;PAGRANDUKAI;5954492368;Ne;0;12;0;12
16118;Vaduvos;PAGRANDUKAI;7397068779;Ne;0;3;0;3
16119;Vaduvos;PAGRANDUKAI;8875709110;Ne;8;4;0;12
16120;Vaduvos;PAGRANDUKAI;68848152670;Ne;3;5;0;8
16121;Vaduvos;PAGRANDUKAI;4105978403;Ne;0;3;0;3
16122;Vaduvos;PAGRANDUKAI;5428067167;Ne;0;2;0;2
16123;Vaduvos;PAGRANDUKAI;3699578284;Ne;0;7;0;7
16124;Vaduvos;PAGRANDUKAI;8299189235;Ne;21;0;0;21
16125;Vaduvos;PAGRANDUKAI;9540008495;Ne;0;2;0;2
16126;Vaduvos;PAGRANDUKAI;7493037613;Ne;0;6;0;6
16127;Vaduvos;PAGRANDUKAI;7163839896;Ne;0;6;0;6
16128;Vaduvos;KODĖLČIUKAI;3010510262;Ne;18;0;0;18
16129;Vaduvos;KODĖLČIUKAI;9429028460;Ne;9;0;0;9
16130;Vaduvos;KODĖLČIUKAI;6210729584;Ne;5;1;0;6
16131;Vaduvos;KODĖLČIUKAI;9606193112;Ne;0;2;0;2
16132;Vaduvos;KODĖLČIUKAI;4177935331;Ne;2;6;0;8
16133;Vaduvos;KODĖLČIUKAI;9983148737;Ne;0;1;0;1
16134;Vaduvos;KODĖLČIUKAI;9072097216;Ne;0;5;0;5
16135;Vaduvos;KODĖLČIUKAI;4270137614;Ne;10;0;0;10
16136;Vaduvos;KODĖLČIUKAI;5262165284;Ne;5;3;0;8
16137;Vaduvos;KODĖLČIUKAI;8603418399;Ne;8;5;0;13
16138;Vaduvos;KODĖLČIUKAI;3096104197;Ne;19;0;0;19
16139;Vaduvos;KODĖLČIUKAI;5761137540;Ne;0;2;0;2
16140;Vaduvos;KODĖLČIUKAI;9597857664;Ne;10;0;0;10
16141;Vaduvos;KODĖLČIUKAI;1054097622;Ne;10;0;0;10
16142;Vaduvos;KODĖLČIUKAI;6013737546;Ne;0;0;19;19
16143;Vaduvos;KODĖLČIUKAI;6991960029;Ne;0;5;0;5
16144;Vaduvos;KODĖLČIUKAI;4789480822;Ne;0;1;0;1
16145;Vaduvos;SMALSUČIAI;2184711783;Ne;2;1;0;3
16146;Vaduvos;SMALSUČIAI;7537754249;Ne;5;0;0;5
16147;Vaduvos;SMALSUČIAI;5573145836;Ne;0;10;1;11
16148;Vaduvos;SMALSUČIAI;7337663549;Ne;7;7;0;14
16149;Vaduvos;SMALSUČIAI;5055972872;Ne;4;2;0;6
16150;Vaduvos;SMALSUČIAI;3091707832;Ne;0;7;0;7
16151;Vaduvos;SMALSUČIAI;87008942241;Ne;0;2;0;2
16152;Vaduvos;SMALSUČIAI;7181151562;Ne;5;11;0;16
16153;Vaduvos;SMALSUČIAI;7431411663;Ne;1;1;0;2
16154;Vaduvos;SMALSUČIAI;6462126837;Ne;0;2;0;2
16155;Vaduvos;SMALSUČIAI;1265287458;Ne;5;5;0;10
16156;Vaduvos;SMALSUČIAI;1434871968;Ne;0;7;0;7
16157;Vaduvos;SMALSUČIAI;3948025914;Ne;8;4;0;12
16158;Vaduvos;SMALSUČIAI;6253552951;Ne;0;2;0;2
16159;Vaduvos;SMALSUČIAI;7508333714;Ne;7;0;0;7
16160;Vaduvos;SMALSUČIAI;3925021238;Taip;22;0;0;22
16161;Vaduvos;SMALSUČIAI;9384395948;Ne;5;6;0;11
16162;Vaduvos;GILIUKAI;1277811729;Ne;2;4;0;6
16163;Vaduvos;GILIUKAI;1969325922;Ne;0;7;0;7
16164;Vaduvos;GILIUKAI;6409466338;Ne;0;5;0;5
16165;Vaduvos;GILIUKAI;2835635250;Ne;2;0;0;2
16166;Vaduvos;GILIUKAI;2939561403;Ne;7;0;0;7
16167;Vaduvos;GILIUKAI;8188374113;Ne;0;6;0;6
16168;Vaduvos;GILIUKAI;6514406042;Ne;0;0;1;1
16169;Vaduvos;GILIUKAI;3057729267;Ne;0;2;0;2
16170;Vaduvos;GILIUKAI;6346625714;Ne;3;1;0;4
16171;Vaduvos;GILIUKAI;8580834401;Ne;0;5;0;5
16172;Vaduvos;GILIUKAI;9167796462;Ne;12;1;0;13
16173;Vaduvos;GILIUKAI;6276149710;Ne;14;3;0;17
16174;Vaduvos;GILIUKAI;6572776966;Ne;0;7;0;7
16175;Vaduvos;GILIUKAI;6676167440;Ne;2;2;0;4
16176;Vaduvos;GILIUKAI;2957685586;Ne;8;8;0;16
16177;Vaduvos;GILIUKAI;3540548094;Ne;7;0;0;7
16178;Vaduvos;GILIUKAI;8964194121;Ne;0;8;0;8
16179;Vaduvos;GILIUKAI;5297217576;Ne;5;1;0;6
16180;Vaduvos;GILIUKAI;5010914832;Ne;15;0;0;15
16181;Vaduvos;GILIUKAI;4030891958;Ne;4;4;0;8
16182;Vaduvos;GILIUKAI;7730737705;Ne;8;0;0;8
16183;Vaduvos;GILIUKAI;2011976336;Ne;0;6;0;6
16184;Vaduvos;BORUŽĖLĖS;2277525837;Ne;0;3;0;3
16185;Vaduvos;BORUŽĖLĖS;6439773886;Ne;10;1;0;11
16186;Vaduvos;BORUŽĖLĖS;5634252033;Ne;0;4;0;4
16187;Vaduvos;BORUŽĖLĖS;6593754016;Ne;10;9;0;19
16188;Vaduvos;BORUŽĖLĖS;7521846747;Ne;0;2;0;2
16189;Vaduvos;BORUŽĖLĖS;1422507884;Ne;0;5;0;5
16190;Vaduvos;BORUŽĖLĖS;8324927031;Ne;0;6;0;6
16191;Vaduvos;BORUŽĖLĖS;4465504676;Ne;4;4;0;8
16192;Vaduvos;BORUŽĖLĖS;2417613291;Ne;7;0;0;7
16193;Vaduvos;BORUŽĖLĖS;5717064754;Ne;2;2;0;4
16194;Vaduvos;BORUŽĖLĖS;8064111922;Ne;10;5;0;15
16195;Vaduvos;BORUŽĖLĖS;2923920649;Ne;0;2;0;2
16196;Vaduvos;BORUŽĖLĖS;3255011809;Ne;0;2;0;2
16197;Vaduvos;BORUŽĖLĖS;9188471756;Ne;0;11;0;11
16198;Vaduvos;BORUŽĖLĖS;7169054113;Ne;0;6;0;6
16199;Vaduvos;BORUŽĖLĖS;2366843609;Ne;0;8;0;8
16200;Vaduvos;BORUŽĖLĖS;1924714755;Ne;2;2;0;4
16201;Vaduvos;DRUGELIAI;4936598927;Ne;10;0;0;10
16202;Vaduvos;DRUGELIAI;2341467486;Ne;0;3;0;3
16203;Vaduvos;DRUGELIAI;5510687497;Ne;0;3;0;3
16204;Vaduvos;DRUGELIAI;9824469881;Ne;6;0;0;6
16205;Vaduvos;DRUGELIAI;5915272436;Ne;17;0;0;17
16206;Vaduvos;DRUGELIAI;4238942070;Ne;0;5;0;5
16207;Vaduvos;DRUGELIAI;1539465611;Ne;3;1;0;4
16208;Vaduvos;DRUGELIAI;8384302877;Ne;5;0;0;5
16209;Vaduvos;DRUGELIAI;6770559352;Ne;9;0;0;9
16210;Vaduvos;DRUGELIAI;4856601924;Ne;0;6;0;6
16211;Vaduvos;DRUGELIAI;3477273224;Ne;4;0;0;4
16212;Vaduvos;DRUGELIAI;2452309232;Taip;10;1;0;11
16213;Vaduvos;DRUGELIAI;6776150749;Ne;5;1;0;6
16214;Vaduvos;DRUGELIAI;4587836073;Ne;0;4;0;4
16215;Vaduvos;DRUGELIAI;9333495119;Ne;5;6;0;11
16216;Vaduvos;DRUGELIAI;7597268115;Ne;0;2;0;2
16217;Vaduvos;DRUGELIAI;8400344609;Ne;0;6;0;6
16218;Vaduvos;DRUGELIAI;1987969267;Ne;0;2;0;2
16219;Vaduvos;DRUGELIAI;8990472878;Ne;11;0;0;11
16220;Vaduvos;DRUGELIAI;2717887489;Ne;16;0;0;16
16221;Vaduvos;DRUGELIAI;5881009426;Ne;6;2;0;8
16222;Vaduvos;RIEŠUTĖLIAI;6611531526;Ne;6;0;0;6
16223;Vaduvos;RIEŠUTĖLIAI;1466282653;Ne;15;0;0;15
16224;Vaduvos;RIEŠUTĖLIAI;3206096414;Ne;9;13;0;22
16225;Vaduvos;RIEŠUTĖLIAI;8055108164;Ne;13;1;0;14
16226;Vaduvos;RIEŠUTĖLIAI;5509202519;Ne;0;2;0;2
16227;Vaduvos;RIEŠUTĖLIAI;3855900628;Ne;13;1;0;14
16228;Vaduvos;RIEŠUTĖLIAI;4576510280;Ne;17;0;0;17
16229;Vaduvos;RIEŠUTĖLIAI;5775152939;Ne;5;6;0;11
16230;Vaduvos;RIEŠUTĖLIAI;3060409258;Ne;10;0;0;10
16231;Vaduvos;RIEŠUTĖLIAI;8070494719;Ne;0;12;0;12
16232;Vaduvos;RIEŠUTĖLIAI;9232960362;Ne;12;10;0;22
16233;Vaduvos;RIEŠUTĖLIAI;7425991335;Ne;2;9;0;11
16234;Vaduvos;RIEŠUTĖLIAI;7592658267;Ne;0;11;0;11
16235;Vaduvos;RIEŠUTĖLIAI;8533315132;Ne;5;3;0;8
16236;Vaduvos;RIEŠUTĖLIAI;2508650990;Ne;9;2;0;11
16237;Vaduvos;RIEŠUTĖLIAI;6943057114;Ne;9;1;0;10
16238;Vaduvos;RIEŠUTĖLIAI;8669267296;Ne;10;2;0;12
16239;Vaduvos;RIEŠUTĖLIAI;1736248725;Ne;5;8;0;13
16240;Vaduvos;"1 klasė";3174998523;Ne;0;6;0;6
16241;Vaduvos;"1 klasė";1825188497;Ne;0;7;0;7
16242;Vaduvos;"1 klasė";3722349868;Ne;0;6;0;6
16243;Vaduvos;"1 klasė";13888236429;Ne;10;7;0;17
16244;Vaduvos;"1 klasė";5307128703;Ne;0;7;0;7
16245;Vaduvos;"1 klasė";6128582180;Ne;0;13;0;13
16246;Vaduvos;"1 klasė";62183976729;Ne;0;6;0;6
16247;Vaduvos;"1 klasė";93702732546;Ne;0;7;0;7
16248;Vaduvos;"1 klasė";15757662594;Ne;0;6;0;6
16249;Vaduvos;"1 klasė";41870343319;Ne;0;6;0;6
16250;Vaduvos;"1 klasė";4513707989;Ne;0;8;0;8
16251;Vaduvos;"1 klasė";68937983441;Ne;0;7;0;7
16252;Vaduvos;"1 klasė";59616893535;Ne;0;7;0;7
16253;Vaduvos;"1 klasė";22641388717;Ne;0;7;0;7
16254;Vaduvos;"1 klasė";21499108813;Ne;0;6;0;6
16255;Vaduvos;"1 klasė";79437154441;Ne;0;6;0;6
16256;Vaduvos;"1 klasė";46608435244;Ne;10;10;0;20
16257;Vaduvos;"1 klasė";61046090149;Ne;0;8;0;8
16258;Vaduvos;"1 klasė";56280470781;Ne;0;6;0;6
16259;Vaduvos;"1 klasė";11202010413;Ne;0;6;0;6
16260;Vaduvos;"1 klasė";1370696345;Ne;0;11;0;11
16261;Vaduvos;"1 klasė";4342471835;Ne;0;6;0;6
16262;Vaduvos;"1 klasė";9112649520;Ne;0;6;0;6
16263;Vaduvos;"1 klasė";1599595256;Ne;0;17;0;17
16264;Vaduvos;"1 klasė";5435336235;Ne;0;9;0;9
16265;Vaduvos;"1 klasė";1681367373;Ne;0;6;0;6
16266;Vaduvos;"3 klasė";97423576166;Ne;0;7;0;7
16267;Vaduvos;"3 klasė";38504924027;Ne;0;6;0;6
16268;Vaduvos;"3 klasė";96148085691;Ne;0;6;0;6
16269;Vaduvos;"3 klasė";12330772986;Ne;0;8;0;8
16270;Vaduvos;"3 klasė";33277362439;Ne;0;11;0;11
16271;Vaduvos;"3 klasė";32138087379;Ne;0;32;0;32
16272;Vaduvos;"3 klasė";67324784528;Ne;0;6;0;6
16273;Vaduvos;"3 klasė";4807104855;Ne;0;9;0;9
16274;Vaduvos;"3 klasė";2181614424;Ne;0;6;0;6
16275;Vaduvos;"3 klasė";2019573643;Ne;0;6;0;6
16276;Vaduvos;"3 klasė";27419094487;Ne;0;6;0;6
16277;Vaduvos;"3 klasė";89793734700;Ne;0;10;0;10
16278;Vaduvos;"3 klasė";17473821556;Ne;0;32;0;32
16279;Vaduvos;"3 klasė";53866301875;Ne;0;32;0;32
16280;Vaduvos;"3 klasė";7786986697;Ne;0;6;0;6
16281;Vaduvos;"3 klasė";9147332638;Ne;0;6;0;6
16282;Vaduvos;"3 klasė";1532675814;Ne;0;6;0;6
16283;Vaduvos;"3 klasė";98259624669;Ne;0;6;0;6
16284;Vaduvos;"3 klasė";36931517006;Ne;0;9;0;9
16285;Vaduvos;"3 klasė";61243424057;Ne;0;8;0;8
16286;Vaduvos;"3 klasė";30979103892;Ne;0;7;0;7
16287;Vaduvos;"3 klasė";78245732319;Ne;0;6;0;6
16288;Vaduvos;"3 klasė";48433447683;Ne;0;8;0;8
16289;Vaduvos;"3 klasė";85090873161;Ne;0;32;0;32
16290;Vaduvos;"3 klasė";41272273463;Ne;0;12;0;12
16291;Vaduvos;"4 klasė";96473212525;Ne;0;1;0;1
16292;Vaduvos;"4 klasė";75428164558;Ne;0;1;0;1
16293;Vaduvos;"4 klasė";63286903462;Ne;0;1;0;1
16294;Vaduvos;"4 klasė";13721939854;Ne;0;2;0;2
16295;Vaduvos;"4 klasė";1171210935;Ne;0;3;0;3
16296;Vaduvos;"4 klasė";7172286009;Ne;0;1;0;1
16297;Vaduvos;"4 klasė";6049882391;Ne;0;27;0;27
16298;Vaduvos;"4 klasė";38013859931;Ne;0;3;0;3
16299;Vaduvos;"4 klasė";4591744662;Ne;0;1;0;1
16300;Vaduvos;"4 klasė";9149523910;Ne;0;4;0;4
16301;Vaduvos;"4 klasė";76662161382;Ne;0;1;0;1
16302;Vaduvos;"4 klasė";26934740147;Ne;0;2;0;2
16303;Vaduvos;"4 klasė";18300713872;Ne;0;27;0;27
16304;Vaduvos;"4 klasė";768455288;Ne;0;7;0;7
16305;Vaduvos;"4 klasė";1768173501;Ne;0;3;0;3
16306;Vaduvos;"4 klasė";60531886576;Ne;0;1;0;1
16307;Vaduvos;"4 klasė";38462664426;Ne;0;2;0;2
16308;Vaduvos;"4 klasė";1821644443;Ne;0;2;0;2
16309;Vaduvos;"2 B klasė";95104294893;Ne;0;8;0;8
16310;Vaduvos;"2 B klasė";40872193458;Ne;0;7;0;7
16311;Vaduvos;"2 B klasė";6500567162;Ne;0;11;0;11
16312;Vaduvos;"2 B klasė";78931952732;Ne;0;6;0;6
16313;Vaduvos;"2 B klasė";1241148402;Ne;0;11;0;11
16314;Vaduvos;"2 B klasė";66359913774;Ne;0;9;0;9
16315;Vaduvos;"2 B klasė";24887196729;Ne;0;14;0;14
16316;Vaduvos;"2 B klasė";39687066893;Ne;0;6;0;6
16317;Vaduvos;"2 B klasė";64074141491;Ne;0;12;0;12
16318;Vaduvos;"2 B klasė";93924290247;Ne;0;8;0;8
16319;Vaduvos;"2 B klasė";47465933557;Ne;0;32;0;32
16320;Vaduvos;"2 B klasė";62521006557;Ne;0;7;0;7
16321;Vaduvos;"2 B klasė";16882774330;Ne;0;8;0;8
16322;Vaduvos;"2 B klasė";3259114583;Ne;0;16;0;16
16323;Vaduvos;"2 B klasė";87671358423;Ne;0;32;0;32
16324;Vaduvos;"2 B klasė";55138588393;Ne;0;6;0;6
16325;Vaduvos;"2 B klasė";3310156076;Ne;0;32;0;32
16326;Vaduvos;"2 B klasė";8782782031;Ne;0;12;0;12
16327;Vaduvos;"2 A klasė";6279678482;Ne;0;6;0;6
16328;Vaduvos;"2 A klasė";96892752634;Ne;0;6;0;6
16329;Vaduvos;"2 A klasė";61243200177;Ne;0;6;0;6
16330;Vaduvos;"2 A klasė";62703428759;Ne;0;6;0;6
16331;Vaduvos;"2 A klasė";68420568339;Ne;0;7;0;7
16332;Vaduvos;"2 A klasė";49738318631;Ne;0;6;0;6
16333;Vaduvos;"2 A klasė";65647119496;Ne;0;6;0;6
16334;Vaduvos;"2 A klasė";19390879176;Ne;0;6;0;6
16335;Vaduvos;"2 A klasė";6155494370;Ne;0;6;0;6
16336;Vaduvos;"2 A klasė";1139509471;Ne;0;32;0;32
16337;Vaduvos;"2 A klasė";70693742936;Ne;0;6;0;6
16338;Vaduvos;"2 A klasė";1010061503;Ne;0;8;0;8
16339;Vaduvos;"2 A klasė";1107557891;Ne;0;32;0;32
16340;Vaduvos;"2 A klasė";8802765960;Ne;0;6;0;6
16341;Vaduvos;"2 A klasė";3172047211;Ne;0;6;0;6
16342;Vilkpėdės;BORUŽĖLĖS;8002436634;Taip;7;0;2;9
16343;Vilkpėdės;BORUŽĖLĖS;1249504082;Ne;0;0;4;4
16344;Vilkpėdės;BORUŽĖLĖS;4052026470;Ne;0;0;5;5
16345;Vilkpėdės;BORUŽĖLĖS;4726171678;Ne;10;0;0;10
16346;Vilkpėdės;BORUŽĖLĖS;7519472444;Ne;2;6;0;8
16347;Vilkpėdės;BORUŽĖLĖS;3991785883;Ne;7;0;0;7
16348;Vilkpėdės;BORUŽĖLĖS;9334610111;Ne;7;0;3;10
16349;Vilkpėdės;BORUŽĖLĖS;7992484314;Ne;12;0;4;16
16350;Vilkpėdės;BORUŽĖLĖS;5050493757;Ne;3;2;0;5
16351;Vilkpėdės;BORUŽĖLĖS;8217972925;Ne;4;2;0;6
16352;Vilkpėdės;BORUŽĖLĖS;2232913117;Ne;0;0;14;14
16353;Vilkpėdės;BORUŽĖLĖS;7805866055;Ne;0;2;0;2
16354;Vilkpėdės;BORUŽĖLĖS;3994451071;Ne;6;0;0;6
16355;Vilkpėdės;BORUŽĖLĖS;2529188623;Ne;2;1;1;4
16356;Vilkpėdės;BORUŽĖLĖS;5569182344;Ne;0;2;0;2
16357;Vilkpėdės;BORUŽĖLĖS;5677284428;Ne;8;0;0;8
16358;Vilkpėdės;SKRUZDĖLIUKAI;4018140154;Ne;0;9;2;11
16359;Vilkpėdės;SKRUZDĖLIUKAI;2419661008;Ne;0;0;1;1
16360;Vilkpėdės;SKRUZDĖLIUKAI;7114183123;Ne;0;2;0;2
16361;Vilkpėdės;SKRUZDĖLIUKAI;2525399410;Ne;0;0;2;2
16362;Vilkpėdės;SKRUZDĖLIUKAI;4031175523;Ne;0;1;0;1
16363;Vilkpėdės;SKRUZDĖLIUKAI;6198736925;Ne;5;0;3;8
16364;Vilkpėdės;SKRUZDĖLIUKAI;5812430367;Ne;5;1;0;6
16365;Vilkpėdės;SKRUZDĖLIUKAI;1478022307;Ne;0;9;0;9
16366;Vilkpėdės;SKRUZDĖLIUKAI;2205143759;Ne;0;2;2;4
16367;Vilkpėdės;SKRUZDĖLIUKAI;6598572049;Ne;0;9;0;9
16368;Vilkpėdės;SKRUZDĖLIUKAI;2418313731;Ne;0;0;4;4
16369;Vilkpėdės;SKRUZDĖLIUKAI;1342167313;Ne;0;7;9;16
16370;Vilkpėdės;SKRUZDĖLIUKAI;5334238235;Ne;0;1;0;1
16371;Vilkpėdės;SKRUZDĖLIUKAI;2703704892;Ne;5;0;2;7
16372;Vilkpėdės;SKRUZDĖLIUKAI;8385974099;Ne;0;10;0;10
16373;Vilkpėdės;SKRUZDĖLIUKAI;6671311193;Ne;0;0;2;2
16374;Vilkpėdės;SKRUZDĖLIUKAI;1985540746;Ne;0;0;1;1
16375;Vilkpėdės;DRUGELIAI;1040357501;Ne;17;0;0;17
16376;Vilkpėdės;DRUGELIAI;6876470245;Ne;17;0;0;17
16377;Vilkpėdės;DRUGELIAI;8431620518;Ne;9;6;0;15
16378;Vilkpėdės;DRUGELIAI;1655396296;Ne;7;0;0;7
16379;Vilkpėdės;DRUGELIAI;5076206526;Ne;0;1;4;5
16380;Vilkpėdės;DRUGELIAI;3611416887;Ne;4;1;0;5
16381;Vilkpėdės;DRUGELIAI;7008659662;Ne;0;0;1;1
16382;Vilkpėdės;DRUGELIAI;4998396593;Ne;0;2;0;2
16383;Vilkpėdės;DRUGELIAI;6819447340;Ne;17;0;0;17
16384;Vilkpėdės;DRUGELIAI;1278300322;Ne;3;0;0;3
16385;Vilkpėdės;DRUGELIAI;9797550851;Ne;15;0;0;15
16386;Vilkpėdės;DRUGELIAI;2379571797;Ne;7;0;0;7
16387;Vilkpėdės;DRUGELIAI;2358685682;Ne;12;0;0;12
16388;Vilkpėdės;DRUGELIAI;7489143683;Ne;0;0;4;4
16389;Vilkpėdės;ŽIOGELIAI;5551822633;Ne;9;2;0;11
16390;Vilkpėdės;ŽIOGELIAI;1063740772;Ne;0;2;0;2
16391;Vilkpėdės;ŽIOGELIAI;3666145718;Ne;5;6;0;11
16392;Vilkpėdės;ŽIOGELIAI;5633014328;Ne;2;0;0;2
16393;Vilkpėdės;ŽIOGELIAI;5346798201;Ne;0;6;0;6
16394;Vilkpėdės;ŽIOGELIAI;1609823694;Ne;0;0;11;11
16395;Vilkpėdės;ŽIOGELIAI;6690742997;Ne;0;10;0;10
16396;Vilkpėdės;ŽIOGELIAI;3350784810;Ne;0;15;0;15
16397;Vilkpėdės;ŽIOGELIAI;1655985778;Ne;14;0;0;14
16398;Vilkpėdės;ŽIOGELIAI;3664125930;Ne;22;0;0;22
16399;Vilkpėdės;ŽIOGELIAI;3737265597;Ne;11;0;0;11
16400;Vilkpėdės;ŽIOGELIAI;1537270256;Ne;20;0;2;22
16401;Vilkpėdės;ŽIOGELIAI;3229559339;Ne;20;0;2;22
16402;Vilkpėdės;ŽIOGELIAI;8783790519;Ne;10;0;0;10
16403;Vilkpėdės;BITUTĖS;6418829930;Ne;2;10;0;12
16404;Vilkpėdės;BITUTĖS;1633942236;Ne;0;1;0;1
16405;Vilkpėdės;BITUTĖS;8484873068;Ne;0;0;4;4
16406;Vilkpėdės;BITUTĖS;2503128176;Ne;0;5;0;5
16407;Vilkpėdės;BITUTĖS;9570469277;Taip;9;2;0;11
16408;Vilkpėdės;BITUTĖS;5420512675;Ne;0;0;5;5
16409;Vilkpėdės;BITUTĖS;8613778606;Ne;18;0;0;18
16410;Vilkpėdės;BITUTĖS;6064336759;Ne;10;0;0;10
16411;Vilkpėdės;BITUTĖS;5577199802;Ne;1;6;1;8
16412;Vilkpėdės;BITUTĖS;3303872633;Ne;18;0;0;18
16413;Vilkpėdės;BITUTĖS;5972405023;Taip;4;4;0;8
16414;Vilkpėdės;BITUTĖS;4485811377;Ne;10;3;0;13
16415;Vilkpėdės;BITUTĖS;5274855225;Ne;16;0;0;16
16416;Vilkpėdės;BITUTĖS;8860791478;Ne;0;1;0;1
16417;Vilkpėdės;BITUTĖS;7829343719;Ne;0;17;1;18
16418;Vilkpėdės;"4 klasė";14499651046;Ne;0;5;0;5
16419;Vilkpėdės;"4 klasė";90217345315;Ne;0;5;0;5
16420;Vilkpėdės;"4 klasė";51286525404;Ne;0;6;0;6
16421;Vilkpėdės;"4 klasė";49513181091;Ne;4;8;0;12
16422;Vilkpėdės;"4 klasė";37450374921;Ne;0;7;0;7
16423;Vilkpėdės;"4 klasė";36704555745;Ne;0;5;0;5
16424;Vilkpėdės;"4 klasė";1024429836;Ne;0;6;0;6
16425;Vilkpėdės;"4 klasė";66356984763;Ne;0;19;0;19
16426;Vilkpėdės;"4 klasė";88279045901;Ne;0;9;0;9
16427;Vilkpėdės;"4 klasė";66451097025;Ne;0;10;0;10
16428;Vilkpėdės;"4 klasė";2806307083;Ne;0;11;0;11
16429;Vilkpėdės;"4 klasė";51799865091;Ne;0;5;0;5
16430;Vilkpėdės;"4 klasė";79269485254;Ne;0;10;0;10
16431;Vilkpėdės;"4 klasė";61833757576;Ne;0;5;0;5
16432;Vilkpėdės;"4 klasė";64216245300;Ne;0;5;0;5
16433;Vilkpėdės;GUDRUČIAI;1451102218;Ne;0;1;0;1
16434;Vilkpėdės;GUDRUČIAI;2181146968;Ne;0;16;4;20
16435;Vilkpėdės;GUDRUČIAI;4392760215;Ne;0;4;1;5
16436;Vilkpėdės;GUDRUČIAI;4515945951;Ne;0;5;0;5
16437;Vilkpėdės;GUDRUČIAI;2736368118;Ne;0;2;3;5
16438;Vilkpėdės;GUDRUČIAI;7527929277;Ne;0;2;1;3
16439;Vilkpėdės;GUDRUČIAI;46561435465;Ne;0;4;0;4
16440;Vilkpėdės;GUDRUČIAI;48059844727;Ne;0;2;0;2
16441;Vilkpėdės;GUDRUČIAI;7889480219;Ne;0;7;0;7
16442;Vilkpėdės;GUDRUČIAI;9867411687;Ne;0;2;0;2
16443;Vilkpėdės;GUDRUČIAI;2900581406;Ne;0;5;0;5
16444;Vilkpėdės;GUDRUČIAI;7875898177;Ne;0;7;0;7
16445;Vilkpėdės;GUDRUČIAI;9605399822;Ne;0;1;0;1
16446;Vilkpėdės;GUDRUČIAI;7634355147;Ne;0;2;0;2
16447;Vilkpėdės;GUDRUČIAI;4276158771;Ne;0;1;0;1
16448;Vilkpėdės;GUDRUČIAI;2604179994;Ne;0;2;1;3
16449;Vilkpėdės;GUDRUČIAI;3696611509;Ne;0;2;4;6
16450;Vilkpėdės;SMALSUČIAI;9294350205;Ne;0;1;0;1
16451;Vilkpėdės;SMALSUČIAI;5048931309;Ne;0;3;0;3
16452;Vilkpėdės;SMALSUČIAI;7698759895;Ne;0;7;0;7
16453;Vilkpėdės;SMALSUČIAI;1019057127;Ne;0;1;0;1
16454;Vilkpėdės;SMALSUČIAI;1217929358;Ne;3;0;0;3
16455;Vilkpėdės;SMALSUČIAI;1807884737;Ne;7;1;0;8
16456;Vilkpėdės;SMALSUČIAI;2251274741;Ne;12;5;0;17
16457;Vilkpėdės;SMALSUČIAI;6816745585;Ne;0;1;0;1
16458;Vilkpėdės;SMALSUČIAI;9460356725;Ne;10;0;0;10
16459;Vilkpėdės;SMALSUČIAI;8128254701;Ne;0;6;0;6
16460;Vilkpėdės;SMALSUČIAI;8015392054;Ne;0;2;0;2
16461;Vilkpėdės;SMALSUČIAI;2320350937;Ne;0;1;0;1
16462;Vilkpėdės;SMALSUČIAI;7747013579;Ne;0;1;0;1
16463;Vilkpėdės;SMALSUČIAI;7894766629;Ne;0;5;0;5
16464;Vilkpėdės;SMALSUČIAI;7010024061;Ne;0;7;0;7
16465;Vilkpėdės;SMALSUČIAI;6522707709;Ne;0;3;0;3
16466;Vilkpėdės;SMALSUČIAI;9795696242;Ne;1;16;0;17
16467;Vilkpėdės;SMALSUČIAI;8581661608;Ne;0;2;0;2
16468;Vilkpėdės;SMALSUČIAI;2420271759;Ne;11;4;0;15
16469;Vilkpėdės;KODĖLČIUKŲ;6283767445;Ne;0;5;0;5
16470;Vilkpėdės;KODĖLČIUKŲ;9605430333;Ne;4;5;0;9
16471;Vilkpėdės;KODĖLČIUKŲ;7745776486;Taip;0;5;0;5
16472;Vilkpėdės;KODĖLČIUKŲ;8969001990;Ne;6;1;0;7
16473;Vilkpėdės;KODĖLČIUKŲ;7158737372;Ne;3;2;0;5
16474;Vilkpėdės;KODĖLČIUKŲ;3785308006;Ne;4;0;0;4
16475;Vilkpėdės;KODĖLČIUKŲ;6744834487;Ne;4;2;0;6
16476;Vilkpėdės;KODĖLČIUKŲ;4166416292;Ne;3;10;0;13
16477;Vilkpėdės;KODĖLČIUKŲ;3888880306;Ne;0;7;0;7
16478;Vilkpėdės;KODĖLČIUKŲ;9601934563;Ne;0;1;0;1
16479;Vilkpėdės;KODĖLČIUKŲ;7401886306;Ne;0;5;1;6
16480;Vilkpėdės;KODĖLČIUKŲ;1528619779;Ne;0;3;0;3
16481;Vilkpėdės;KODĖLČIUKŲ;2359315281;Ne;5;3;0;8
16482;Vilkpėdės;KODĖLČIUKŲ;1571869318;Ne;0;7;0;7
16483;Vilkpėdės;KODĖLČIUKŲ;6820236577;Ne;2;0;0;2
16484;Vilkpėdės;KODĖLČIUKŲ;4255757333;Ne;3;2;0;5
16485;Vilkpėdės;KODĖLČIUKŲ;1063561954;Ne;2;0;0;2
16486;Vilkpėdės;KODĖLČIUKŲ;5053032081;Ne;4;0;0;4
16487;Vilkpėdės;KODĖLČIUKŲ;6778288398;Ne;0;10;0;10
16488;Vilkpėdės;KODĖLČIUKŲ;7284081203;Ne;2;0;0;2
16489;Žiburėlis;Nykštukai;7163594513;Ne;0;3;0;3
16490;Žiburėlis;Nykštukai;5408766721;Ne;10;0;0;10
16491;Žiburėlis;Nykštukai;7211961512;Ne;0;1;0;1
16492;Žiburėlis;Nykštukai;7862546963;Ne;6;1;0;7
16493;Žiburėlis;Nykštukai;8902837168;Ne;6;1;0;7
16494;Žiburėlis;Nykštukai;7465939429;Taip;4;2;0;6
16495;Žiburėlis;Nykštukai;4710995351;Ne;0;0;1;1
16496;Žiburėlis;Nykštukai;7633450988;Taip;0;0;2;2
16497;Žiburėlis;Nykštukai;2292895729;Ne;0;6;0;6
16498;Žiburėlis;Nykštukai;9806454408;Ne;0;14;0;14
16499;Žiburėlis;Nykštukai;1764592065;Ne;0;1;0;1
16500;Žiburėlis;Nykštukai;8480167191;Ne;0;14;0;14
16501;Žiburėlis;Nykštukai;1559091567;Ne;0;1;7;8
16502;Žiburėlis;Nykštukai;3750024153;Ne;0;1;5;6
16503;Žiburėlis;"Žiniukai ";5816890413;Ne;7;4;0;11
16504;Žiburėlis;"Žiniukai ";2928528630;Ne;0;1;0;1
16505;Žiburėlis;"Žiniukai ";2624326930;Ne;0;16;0;16
16506;Žiburėlis;"Žiniukai ";3033049328;Ne;0;7;0;7
16507;Žiburėlis;"Žiniukai ";3262856058;Ne;0;13;0;13
16508;Žiburėlis;"Žiniukai ";1720078356;Ne;5;11;0;16
16509;Žiburėlis;"Žiniukai ";7424129974;Ne;7;3;0;10
16510;Žiburėlis;"Žiniukai ";4187381976;Ne;0;9;0;9
16511;Žiburėlis;"Žiniukai ";5006361324;Ne;0;3;0;3
16512;Žiburėlis;"Žiniukai ";2999365435;Ne;0;8;0;8
16513;Žiburėlis;"Žiniukai ";7070952018;Ne;5;3;0;8
16514;Žiburėlis;"Žiniukai ";8438876806;Ne;0;8;0;8
16515;Žiburėlis;"Žiniukai ";3687703187;Ne;0;9;0;9
16516;Žiburėlis;"Žiniukai ";1543314096;Ne;5;10;0;15
16517;Žiburėlis;"Žiniukai ";1061646244;Ne;7;1;0;8
16518;Žiburėlis;"Žiniukai ";2741301903;Ne;0;2;0;2
16519;Žiburėlis;"Smalsiukai ";5438697081;Taip;13;7;0;20
16520;Žiburėlis;"Smalsiukai ";1126972447;Ne;3;6;0;9
16521;Žiburėlis;"Smalsiukai ";3936418539;Ne;8;1;0;9
16522;Žiburėlis;"Smalsiukai ";2072972990;Ne;0;6;0;6
16523;Žiburėlis;"Smalsiukai ";3835820013;Ne;0;4;0;4
16524;Žiburėlis;"Smalsiukai ";92490398630;Ne;1;4;0;5
16525;Žiburėlis;"Smalsiukai ";67168630669;Ne;0;4;0;4
16526;Žiburėlis;"Smalsiukai ";3867540155;Ne;0;8;0;8
16527;Žiburėlis;"Smalsiukai ";7578655857;Ne;7;1;0;8
16528;Žiburėlis;"Smalsiukai ";9253393819;Ne;0;4;0;4
16529;Žiburėlis;"Smalsiukai ";1599112927;Ne;0;15;0;15
16530;Žiburėlis;"Smalsiukai ";18739941845;Ne;0;10;0;10
16531;Žiburėlis;"Smalsiukai ";24639355056;Ne;0;6;0;6
16532;Žiburėlis;"Smalsiukai ";6519139977;Ne;0;32;0;32
16533;Žiburėlis;"Smalsiukai ";7861704875;Ne;0;12;0;12
16534;Žiburėlis;"Smalsiukai ";34873231652;Ne;0;16;0;16
16535;Žiburėlis;"Smalsiukai ";1125662904;Ne;0;2;0;2
16536;Žiburėlis;"Smalsiukai ";2175751377;Ne;2;3;0;5
16537;Žiburėlis;"Smalsiukai ";28985997205;Ne;0;19;0;19
16538;Žiburėlis;"Giliukai ";7310274376;Ne;3;0;0;3
16539;Žiburėlis;"Giliukai ";1090883494;Taip;15;0;0;15
16540;Žiburėlis;"Giliukai ";9215654134;Ne;12;0;0;12
16541;Žiburėlis;"Giliukai ";2866098551;Ne;9;0;0;9
16542;Žiburėlis;"Giliukai ";6918525245;Ne;3;1;0;4
16543;Žiburėlis;"Giliukai ";6946621147;Ne;9;1;0;10
16544;Žiburėlis;"Giliukai ";6733333096;Ne;8;1;0;9
16545;Žiburėlis;"Giliukai ";1943162133;Ne;7;0;0;7
16546;Žiburėlis;"Giliukai ";6232492947;Ne;7;0;0;7
16547;Žiburėlis;"Giliukai ";3807588865;Ne;22;0;0;22
16548;Žiburėlis;"Giliukai ";4091901597;Ne;0;9;0;9
16549;Žiburėlis;"Giliukai ";4016969144;Ne;0;3;0;3
16550;Žiburėlis;"Giliukai ";3776569251;Ne;6;0;0;6
16551;Žiburėlis;"Giliukai ";9494271740;Ne;12;0;0;12
16552;Žiburėlis;"Giliukai ";8440073413;Ne;0;7;0;7
16553;Žiburėlis;"Giliukai ";6121237159;Ne;0;7;0;7
16554;Žiburėlis;"Giliukai ";6289338466;Ne;12;0;0;12
16555;Žiburėlis;"Giliukai ";7977098545;Ne;8;0;0;8
16556;Žiburėlis;"Giliukai ";2990465012;Ne;18;0;0;18
16557;Žiburėlis;"Giliukai ";8697451319;Ne;9;0;0;9
16558;Žiburėlis;"Giliukai ";9731661697;Taip;7;1;0;8
16559;Žiburėlis;"1 klasė";93584914250;Ne;5;0;0;5
16560;Žiburėlis;Meškiukai;3593851196;Ne;0;2;0;2
16561;Žiburėlis;Meškiukai;9470154520;Ne;12;0;0;12
16562;Žiburėlis;Meškiukai;2285666668;Ne;2;0;1;3
16563;Žiburėlis;Meškiukai;2836519241;Ne;0;8;0;8
16564;Žiburėlis;Meškiukai;9321467329;Ne;0;1;0;1
16565;Žiburėlis;Meškiukai;2254407798;Ne;9;0;0;9
16566;Žiburėlis;Meškiukai;4887304311;Ne;0;2;1;3
16567;Žiburėlis;Meškiukai;1651713696;Ne;4;0;0;4
16568;Žiburėlis;Meškiukai;1105220246;Ne;2;0;0;2
16569;Žiburėlis;Meškiukai;8415647388;Ne;10;1;0;11
16570;Žiburėlis;Meškiukai;2371990135;Ne;0;0;1;1
16571;Žiburėlis;Meškiukai;6218255066;Ne;16;0;0;16
16572;Žiburėlis;Meškiukai;3522480911;Taip;5;1;2;8
16573;Žiburėlis;Meškiukai;5683969627;Ne;8;0;0;8
16574;Žiburėlis;Viščiukai;5115160061;Taip;22;0;0;22
16575;Žiburėlis;Viščiukai;7485768254;Taip;13;0;0;13
16576;Žiburėlis;Viščiukai;7364102991;Ne;24;0;0;24
16577;Žiburėlis;Viščiukai;7140031765;Taip;5;9;2;16
16578;Žiburėlis;Viščiukai;3323538690;Ne;10;0;0;10
16579;Žiburėlis;Viščiukai;1121755119;Ne;0;1;0;1
16580;Žiburėlis;Viščiukai;3738184802;Ne;3;0;0;3
16581;Žiburėlis;Viščiukai;8603154782;Ne;0;4;0;4
16582;Žiburėlis;Viščiukai;5213049603;Ne;8;0;0;8
16583;Žiburėlis;Viščiukai;4727673956;Ne;12;1;0;13
16584;Žiburėlis;Viščiukai;1606332622;Ne;0;2;1;3
16585;Žiburėlis;Viščiukai;8284913889;Ne;5;0;1;6
16586;Žiburėlis;Viščiukai;2851350451;Ne;8;1;3;12
16587;Žiburėlis;Viščiukai;6206770019;Ne;0;7;0;7
16588;Žiburėlis;Viščiukai;5314676261;Ne;4;1;0;5
16589;Žiburėlis;"Drambliukai ";5724506894;Ne;0;2;0;2
16590;Žiburėlis;"Drambliukai ";2102574423;Ne;0;2;0;2
16591;Žiburėlis;"Drambliukai ";4937518207;Ne;3;9;0;12
16592;Žiburėlis;"Drambliukai ";9041469393;Taip;0;4;0;4
16593;Žiburėlis;"Drambliukai ";8285987095;Ne;6;5;0;11
16594;Žiburėlis;"Drambliukai ";2805244671;Taip;0;1;0;1
16595;Žiburėlis;"Drambliukai ";5025452484;Taip;0;4;0;4
16596;Žiburėlis;"Drambliukai ";9344950711;Ne;5;2;0;7
16597;Žiburėlis;"Drambliukai ";8082088504;Taip;0;1;0;1
16598;Žiburėlis;"Drambliukai ";9771442035;Ne;0;7;0;7
16599;Žiburėlis;"Drambliukai ";5194593598;Ne;0;22;0;22
16600;Žiburėlis;"Drambliukai ";8752098051;Ne;0;2;0;2
16601;Žiburėlis;"Drambliukai ";8207315673;Taip;0;6;0;6
16602;Žiburėlis;"Drambliukai ";6751043071;Ne;8;0;0;8
16603;Žiburėlis;"Drambliukai ";1449541244;Taip;10;3;0;13
16604;Žiburėlis;BORUŽIUKAI;7895148630;Ne;22;0;0;22
16605;Žiburėlis;BORUŽIUKAI;8936912406;Ne;0;2;1;3
16606;Žiburėlis;BORUŽIUKAI;1422951221;Ne;0;2;1;3
16607;Žiburėlis;BORUŽIUKAI;4631232618;Ne;5;13;0;18
16608;Žiburėlis;BORUŽIUKAI;5793531526;Ne;8;0;0;8
16609;Žiburėlis;BORUŽIUKAI;4578828135;Ne;0;3;0;3
16610;Žiburėlis;BORUŽIUKAI;6128571259;Ne;4;0;0;4
16611;Žiburėlis;BORUŽIUKAI;3760039280;Ne;10;0;0;10
16612;Žiburėlis;BORUŽIUKAI;8373944614;Ne;11;0;0;11
16613;Žiburėlis;BORUŽIUKAI;9256751455;Ne;0;1;0;1
16614;Žiburėlis;BORUŽIUKAI;2077823704;Ne;7;1;0;8
16615;Žiburėlis;BORUŽIUKAI;9357376188;Ne;0;4;0;4
16616;Žiburėlis;BORUŽIUKAI;9029039015;Ne;0;0;1;1
16617;Žiburėlis;BORUŽIUKAI;7017574924;Ne;0;5;0;5
16618;Žiburėlis;BORUŽIUKAI;2527837980;Ne;21;0;0;21
16619;Žiburėlis;BORUŽIUKAI;5828514911;Ne;4;0;0;4
16620;Žiburėlis;SPINDULIUKAI;5002691930;Ne;0;1;0;1
16621;Žiburėlis;SPINDULIUKAI;2995697464;Ne;3;0;0;3
16622;Žiburėlis;SPINDULIUKAI;7856708616;Ne;0;2;0;2
16623;Žiburėlis;SPINDULIUKAI;5205959106;Ne;0;13;0;13
16624;Žiburėlis;SPINDULIUKAI;2491972986;Ne;0;7;0;7
16625;Žiburėlis;SPINDULIUKAI;1190058462;Ne;0;2;0;2
16626;Žiburėlis;SPINDULIUKAI;8970153523;Ne;0;2;0;2
16627;Žiburėlis;SPINDULIUKAI;5951659866;Ne;0;5;0;5
16628;Žiburėlis;SPINDULIUKAI;1775465307;Ne;0;7;0;7
16629;Žiburėlis;SPINDULIUKAI;8973307069;Ne;0;2;0;2
16630;Žiburėlis;SPINDULIUKAI;5098955523;Ne;0;14;0;14
16631;Žiburėlis;SPINDULIUKAI;5629404179;Ne;8;1;0;9
16632;Žiburėlis;SPINDULIUKAI;7825665451;Ne;2;4;0;6
16633;Žiburėlis;SPINDULIUKAI;2808361570;Ne;0;2;1;3
16634;Žiburėlis;KIŠKUČIAI;6492467281;Ne;8;6;0;14
16635;Žiburėlis;KIŠKUČIAI;3352845095;Ne;0;3;0;3
16636;Žiburėlis;KIŠKUČIAI;3296994981;Ne;0;9;0;9
16637;Žiburėlis;KIŠKUČIAI;6019278045;Ne;10;0;0;10
16638;Žiburėlis;KIŠKUČIAI;4079793067;Ne;0;4;2;6
16639;Žiburėlis;KIŠKUČIAI;5418413225;Ne;0;8;1;9
16640;Žiburėlis;KIŠKUČIAI;6044837042;Taip;0;7;3;10
16641;Žiburėlis;KIŠKUČIAI;1334695206;Ne;17;0;1;18
16642;Žiburėlis;KIŠKUČIAI;7597762608;Ne;0;2;1;3
16643;Žiburėlis;KIŠKUČIAI;6562748977;Ne;23;0;0;23
16644;Žiburėlis;KIŠKUČIAI;5145195661;Ne;0;2;0;2
16645;Žiburėlis;KIŠKUČIAI;4477396434;Ne;0;2;2;4
16646;Žiburėlis;KIŠKUČIAI;2712358146;Ne;2;6;1;9
16647;Žiburėlis;KIŠKUČIAI;5410394172;Ne;3;2;0;5
16648;Žiburėlis;KIŠKUČIAI;4003368130;Ne;19;0;2;21
16649;Žiburėlis;KIŠKUČIAI;2456703958;Ne;0;2;0;2
16650;Žiburėlis;KIŠKUČIAI;1868558773;Taip;5;1;0;6
16651;Žiburėlis;KIŠKUČIAI;2083500905;Ne;1;2;1;4
16652;Žiburėlis;DRUGELIAI;9783567484;Ne;5;1;0;6
16653;Žiburėlis;DRUGELIAI;4109288891;Taip;14;0;0;14
16654;Žiburėlis;DRUGELIAI;4387021429;Ne;0;4;0;4
16655;Žiburėlis;DRUGELIAI;8018718405;Ne;0;4;0;4
16656;Žiburėlis;DRUGELIAI;4910787530;Ne;0;14;0;14
16657;Žiburėlis;DRUGELIAI;5324852807;Ne;5;2;2;9
16658;Žiburėlis;DRUGELIAI;4916545915;Ne;8;3;0;11
16659;Žiburėlis;DRUGELIAI;8133371774;Ne;3;11;0;14
16660;Žiburėlis;DRUGELIAI;7278242428;Taip;0;0;1;1
16661;Žiburėlis;DRUGELIAI;5732540560;Ne;0;3;0;3
16662;Žiburėlis;DRUGELIAI;1833704617;Ne;0;1;0;1
16663;Žiburėlis;DRUGELIAI;1228806324;Ne;0;2;0;2
16664;Žiburėlis;DRUGELIAI;2163018032;Ne;0;9;0;9
16665;Žiburėlis;DRUGELIAI;4581800760;Ne;0;22;0;22
16666;Žiburėlis;DRUGELIAI;4168864882;Ne;0;1;0;1
16667;Justinukas;VARLIUKAI;7906186978;Ne;5;0;0;5
16668;Justinukas;PELEDŽIUKŲ;2009689031;Ne;10;0;0;10
16669;Justinukas;BORUŽIUKŲ;3788189462;Ne;5;0;0;5
16670;Justinukas;ŽVIRBLIUKAI;3921870527;Ne;5;0;0;5
16671;Justinukas;BITUTĖS;9721186766;Ne;10;0;0;10
16672;Justinukas;BITUTĖS;8450280075;Ne;5;0;0;5
16673;Justinukas;KAČIUKAI;8592318869;Ne;2;0;0;2
16674;Justinukas;KAČIUKAI;3485636044;Ne;5;0;0;5
16675;Bangelė;Aštuonkojai;6026399355;Ne;2;2;2;6
16676;Bangelė;Aštuonkojai;5476753511;Ne;0;0;1;1
16677;Bangelė;Aštuonkojai;9168310196;Ne;0;6;0;6
16678;Bangelė;Aštuonkojai;1351714626;Ne;15;0;1;16
16679;Bangelė;Aštuonkojai;1754002501;Ne;0;0;4;4
16680;Bangelė;Aštuonkojai;6953698592;Ne;0;0;1;1
16681;Bangelė;Aštuonkojai;3063439996;Ne;0;6;0;6
16682;Bangelė;Aštuonkojai;2156837975;Ne;0;3;0;3
16683;Bangelė;Aštuonkojai;9143945953;Ne;0;1;0;1
16684;Bangelė;Aštuonkojai;3022508446;Ne;0;0;2;2
16685;Bangelė;Aštuonkojai;5546256869;Ne;0;10;0;10
16686;Bangelė;Aštuonkojai;6980232224;Ne;0;0;3;3
16687;Bangelė;Aštuonkojai;6145050734;Ne;0;1;0;1
16688;Bangelė;Aštuonkojai;1390623903;Ne;0;9;0;9
16689;Bangelė;Aštuonkojai;9788923823;Ne;0;17;5;22
16690;Bangelė;Aštuonkojai;7136625230;Ne;0;7;0;7
16691;Bangelė;Aštuonkojai;6216334243;Ne;0;5;0;5
16692;Bangelė;Delfinukai,;3471355267;Ne;3;0;0;3
16693;Bangelė;Delfinukai,;7107685761;Ne;0;1;1;2
16694;Bangelė;Delfinukai,;6978215876;Ne;6;4;1;11
16695;Bangelė;Delfinukai,;7434358474;Ne;0;19;0;19
16696;Bangelė;Delfinukai,;2575806242;Ne;0;0;6;6
16697;Bangelė;Delfinukai,;9801978617;Ne;0;0;4;4
16698;Bangelė;Delfinukai,;5994720767;Ne;0;8;0;8
16699;Bangelė;Delfinukai,;4532810332;Ne;0;3;0;3
16700;Bangelė;Delfinukai,;4036461205;Ne;0;1;0;1
16701;Bangelė;Delfinukai,;3344441441;Ne;0;0;8;8
16702;Bangelė;Delfinukai,;2858929915;Ne;0;0;1;1
16703;Bangelė;Delfinukai,;7068305612;Ne;0;0;6;6
16704;Bangelė;Delfinukai,;4412780063;Ne;10;2;0;12
16705;Bangelė;Delfinukai,;4080993439;Ne;0;3;0;3
16706;Bangelė;"Saulės spindulėliai";55668308050;Ne;0;9;0;9
16707;Bangelė;"Saulės spindulėliai";9150185864;Ne;0;11;0;11
16708;Bangelė;"Saulės spindulėliai";9167286651;Ne;0;0;3;3
16709;Bangelė;"Saulės spindulėliai";43740476077;Ne;9;0;0;9
16710;Bangelė;"Saulės spindulėliai";9846780259;Ne;0;10;0;10
16711;Bangelė;"Saulės spindulėliai";1377734102;Ne;0;0;1;1
16712;Bangelė;"Saulės spindulėliai";5950451237;Ne;0;1;0;1
16713;Bangelė;"Saulės spindulėliai";1032881464;Ne;0;0;4;4
16714;Bangelė;"Saulės spindulėliai";9488932192;Ne;0;4;0;4
16715;Bangelė;"Saulės spindulėliai";1728085772;Ne;0;1;0;1
16716;Bangelė;"Saulės spindulėliai";1447396084;Ne;0;1;0;1
16717;Bangelė;"Saulės spindulėliai";6927540308;Ne;0;0;4;4
16718;Bangelė;"Saulės spindulėliai";9464115339;Ne;5;0;0;5
16719;Bangelė;"Saulės spindulėliai";4122927034;Ne;0;9;0;9
16720;Bangelė;"Saulės spindulėliai";3338203753;Ne;0;3;0;3
16721;Bangelė;"Saulės spindulėliai";3206495858;Ne;5;0;2;7
16722;Bangelė;"Saulės spindulėliai";7861208185;Ne;5;0;2;7
16723;Bangelė;"Saulės spindulėliai";2027892816;Ne;3;0;0;3
16724;Bangelė;"Saulės spindulėliai";2503946448;Ne;5;7;0;12
16725;Bangelė;"Saulės spindulėliai";2872188915;Ne;0;0;10;10
16726;Bangelė;"Saulės spindulėliai";3132827429;Ne;0;0;3;3
16727;Bangelė;"Pingvinukai ";9790680407;Taip;0;0;4;4
16728;Bangelė;"Pingvinukai ";9980881014;Ne;0;5;0;5
16729;Bangelė;"Pingvinukai ";4317054990;Ne;0;1;0;1
16730;Bangelė;"Pingvinukai ";8943721679;Ne;0;6;0;6
16731;Bangelė;"Pingvinukai ";6566277472;Ne;0;4;0;4
16732;Bangelė;"Pingvinukai ";7362196984;Ne;0;8;0;8
16733;Bangelė;"Pingvinukai ";4712616315;Ne;3;10;1;14
16734;Bangelė;"Pingvinukai ";4940247006;Ne;9;0;0;9
16735;Bangelė;"Pingvinukai ";8335931279;Ne;0;6;0;6
16736;Bangelė;"Pingvinukai ";9311379746;Ne;0;10;0;10
16737;Bangelė;"Pingvinukai ";4851593235;Ne;0;10;0;10
16738;Bangelė;"Pingvinukai ";2127734178;Ne;0;2;0;2
16739;Bangelė;"Pingvinukai ";2107766301;Ne;5;0;3;8
16740;Bangelė;"Pingvinukai ";5237434283;Ne;12;0;0;12
16741;Bangelė;"Pingvinukai ";4651237403;Ne;17;0;0;17
16742;Bangelė;"Pingvinukai ";8661284187;Ne;0;0;5;5
16743;Bangelė;"Pingvinukai ";1541525635;Ne;0;0;3;3
16744;Bangelė;"Jūros žvaigždutės ";5673493708;Ne;0;7;0;7
16745;Bangelė;"Jūros žvaigždutės ";9447145378;Ne;0;9;0;9
16746;Bangelė;"Jūros žvaigždutės ";4086446380;Ne;0;5;0;5
16747;Bangelė;"Jūros žvaigždutės ";8745595583;Ne;13;0;0;13
16748;Bangelė;"Jūros žvaigždutės ";9268294844;Ne;0;0;1;1
16749;Bangelė;"Jūros žvaigždutės ";4831656996;Ne;7;0;1;8
16750;Bangelė;"Jūros žvaigždutės ";9267349375;Taip;0;18;0;18
16751;Bangelė;"Jūros žvaigždutės ";3069288815;Ne;5;4;1;10
16752;Bangelė;"Jūros žvaigždutės ";9729929020;Ne;2;0;0;2
16753;Bangelė;"Jūros žvaigždutės ";6705583340;Ne;0;0;7;7
16754;Bangelė;"Jūros žvaigždutės ";1544311819;Ne;2;0;0;2
16755;Bangelė;"Jūros žvaigždutės ";6174617493;Ne;0;0;3;3
16756;Bangelė;"Jūros žvaigždutės ";9633372201;Ne;0;0;3;3
16757;Bangelė;"Jūros žvaigždutės ";8075810032;Ne;0;7;0;7
16758;Bangelė;"Jūros žvaigždutės ";3500097405;Taip;22;0;0;22
16759;Bangelė;Žuvytės;6496580354;Ne;0;0;14;14
16760;Bangelė;Žuvytės;6480681705;Ne;0;2;0;2
16761;Bangelė;Žuvytės;7142694888;Ne;0;0;3;3
16762;Bangelė;Žuvytės;8734511431;Ne;10;2;0;12
16763;Bangelė;Žuvytės;1895213200;Ne;0;0;1;1
16764;Bangelė;Žuvytės;9765268154;Ne;0;17;0;17
16765;Bangelė;Žuvytės;8495423628;Ne;22;0;0;22
16766;Bangelė;Žuvytės;7419016784;Ne;0;1;8;9
16767;Bangelė;Žuvytės;3991021350;Ne;0;1;5;6
16768;Bangelė;Žuvytės;9954762483;Ne;10;6;0;16
16769;Bangelė;Žuvytės;9493465898;Ne;7;0;3;10
16770;Bangelė;Žuvytės;5597329949;Ne;11;1;0;12
16771;Bangelė;Žuvytės;2134225414;Ne;10;0;0;10
16772;Bangelė;Žuvytės;4494049529;Ne;0;0;3;3
16773;Bangelė;Žuvytės;3334029244;Ne;0;8;0;8
16774;Bangelė;Žuvytės;6165322599;Ne;0;0;3;3
16775;Bangelė;Žuvytės;3016778137;Ne;0;2;0;2
16776;Bangelė;Žuvytės;1898671487;Ne;6;0;0;6
16777;Bangelė;Žuvytės;7174742281;Ne;21;3;0;24
16778;Bangelė;Žuvytės;6806911810;Ne;0;0;9;9
16779;Bangelė;Ruoniai;8149880453;Ne;0;6;0;6
16780;Bangelė;Ruoniai;8836861853;Ne;0;7;0;7
16781;Bangelė;Ruoniai;4571869439;Ne;0;3;0;3
16782;Bangelė;Ruoniai;9672505885;Ne;0;9;1;10
16783;Bangelė;Ruoniai;8990701154;Ne;11;0;0;11
16784;Bangelė;Ruoniai;9706351115;Ne;0;3;0;3
16785;Bangelė;Ruoniai;8758933649;Ne;0;0;8;8
16786;Bangelė;Ruoniai;1528387105;Ne;0;4;0;4
16787;Bangelė;Ruoniai;6712145066;Ne;0;0;2;2
16788;Bangelė;"Pagrandukai ";9561221619;Ne;0;2;0;2
16789;Bangelė;"Pagrandukai ";9128326823;Ne;4;0;2;6
16790;Bangelė;"Pagrandukai ";6415607960;Ne;0;0;7;7
16791;Bangelė;"Pagrandukai ";1182624046;Ne;0;13;0;13
16792;Bangelė;"Pagrandukai ";2730545639;Ne;0;0;1;1
16793;Bangelė;"Pagrandukai ";4041276015;Ne;0;11;0;11
16794;Bangelė;"Pagrandukai ";7503518328;Ne;0;0;5;5
16795;Bangelė;"Pagrandukai ";9010238689;Ne;0;6;0;6
16796;Bangelė;"Pagrandukai ";5829865386;Ne;4;0;4;8
16797;Bangelė;"Zuikučiai ";7364368699;Ne;0;4;0;4
16798;Bangelė;"Zuikučiai ";6400785821;Ne;0;3;0;3
16799;Bangelė;"Zuikučiai ";5961647252;Ne;0;1;0;1
16800;Bangelė;"Zuikučiai ";8493650050;Ne;0;2;0;2
16801;Bangelė;"Zuikučiai ";3851738513;Ne;0;1;0;1
16802;Bangelė;"Zuikučiai ";3452984649;Taip;22;0;0;22
16803;Bangelė;"Zuikučiai ";2362345363;Ne;5;0;1;6
16804;Bangelė;"Zuikučiai ";4891131242;Ne;15;1;0;16
16805;Bangelė;"Zuikučiai ";7445583512;Ne;0;6;0;6
16806;Bangelė;"Zuikučiai ";8931569423;Ne;6;0;0;6
16807;Bangelė;"Zuikučiai ";2382714949;Ne;10;0;0;10
16808;Bangelė;"Zuikučiai ";7755966282;Ne;0;10;0;10
16809;Bangelė;"Zuikučiai ";8765892966;Ne;0;2;0;2
16810;Bangelė;Vėžliukai;9142460659;Ne;0;6;4;10
16811;Bangelė;Vėžliukai;2405364948;Ne;16;0;0;16
16812;Bangelė;Vėžliukai;7862345122;Ne;1;0;3;4
16813;Bangelė;Vėžliukai;1869389013;Ne;10;2;0;12
16814;Bangelė;Vėžliukai;2630571748;Ne;7;0;0;7
16815;Bangelė;Vėžliukai;6003859569;Ne;6;0;0;6
16816;Bangelė;Vėžliukai;5779198855;Ne;0;1;0;1
16817;Bangelė;Vėžliukai;5746189515;Ne;0;2;0;2
16818;Bangelė;Vėžliukai;6312356331;Ne;0;1;0;1
16819;Bangelė;Vėžliukai;8454369872;Ne;8;0;0;8
16820;Bangelė;Vėžliukai;4927362383;Ne;0;0;2;2
16821;Gėlynas;PAKALNUTĖ;4557380282;Ne;0;9;0;9
16822;Gėlynas;PAKALNUTĖ;6884111634;Ne;7;0;0;7
16823;Gėlynas;PAKALNUTĖ;3470963396;Ne;0;14;0;14
16824;Gėlynas;PAKALNUTĖ;2171064300;Ne;9;0;1;10
16825;Gėlynas;PAKALNUTĖ;7504469409;Ne;5;5;0;10
16826;Gėlynas;PAKALNUTĖ;4366442459;Ne;16;0;0;16
16827;Gėlynas;PAKALNUTĖ;7064068912;Ne;0;13;0;13
16828;Gėlynas;PAKALNUTĖ;1822933936;Ne;0;5;0;5
16829;Gėlynas;PAKALNUTĖ;4668195919;Ne;0;7;0;7
16830;Gėlynas;PAKALNUTĖ;8555408466;Ne;0;8;0;8
16831;Gėlynas;PAKALNUTĖ;2377323648;Ne;8;0;0;8
16832;Gėlynas;PAKALNUTĖ;5382148888;Ne;5;0;0;5
16833;Gėlynas;PAKALNUTĖ;6296728638;Ne;0;1;0;1
16834;Gėlynas;PAKALNUTĖ;2273705177;Ne;14;0;5;19
16835;Gėlynas;PAKALNUTĖ;2520140743;Ne;0;0;2;2
16836;Gėlynas;VARPELIS;2769668641;Ne;4;6;0;10
16837;Gėlynas;VARPELIS;1004866224;Ne;0;5;0;5
16838;Gėlynas;VARPELIS;2417880374;Ne;0;0;9;9
16839;Gėlynas;VARPELIS;4382465307;Ne;0;8;0;8
16840;Gėlynas;VARPELIS;5135747448;Ne;0;0;3;3
16841;Gėlynas;VARPELIS;1754734306;Ne;0;5;0;5
16842;Gėlynas;VARPELIS;1774829898;Ne;10;0;0;10
16843;Gėlynas;VARPELIS;7562201835;Ne;3;0;4;7
16844;Gėlynas;VARPELIS;2132298690;Ne;7;0;0;7
16845;Gėlynas;VARPELIS;7877521812;Ne;0;0;1;1
16846;Gėlynas;VARPELIS;8464074679;Ne;3;0;4;7
16847;Gėlynas;VARPELIS;9911225363;Ne;0;0;4;4
16848;Gėlynas;VARPELIS;5395474698;Ne;0;9;0;9
16849;Gėlynas;VARPELIS;6898127005;Ne;0;2;0;2
16850;Gėlynas;VARPELIS;3365442661;Ne;6;0;2;8
16851;Gėlynas;VARPELIS;5145396320;Ne;0;10;0;10
16852;Gėlynas;VARPELIS;7814357385;Ne;0;2;0;2
16853;Gėlynas;VARPELIS;1674569569;Ne;0;2;0;2
16854;Gėlynas;VARPELIS;1036951275;Ne;8;0;3;11
16855;Gėlynas;VARPELIS;7808971151;Ne;0;0;9;9
16856;Gėlynas;VARPELIS;4916885450;Ne;16;0;1;17
16857;Gėlynas;RAKTAŽOLĖ;3491517766;Ne;0;5;0;5
16858;Gėlynas;RAKTAŽOLĖ;4505012978;Ne;16;1;0;17
16859;Gėlynas;RAKTAŽOLĖ;5124029118;Ne;0;7;0;7
16860;Gėlynas;RAKTAŽOLĖ;9508507084;Ne;0;22;0;22
16861;Gėlynas;RAKTAŽOLĖ;8458276300;Ne;0;1;0;1
16862;Gėlynas;RAKTAŽOLĖ;7730322729;Ne;0;3;0;3
16863;Gėlynas;RAKTAŽOLĖ;6528464599;Ne;2;6;0;8
16864;Gėlynas;RAKTAŽOLĖ;8615943743;Ne;0;2;0;2
16865;Gėlynas;RAKTAŽOLĖ;7389502638;Ne;0;11;0;11
16866;Gėlynas;RAKTAŽOLĖ;1590299264;Ne;0;1;0;1
16867;Gėlynas;RAKTAŽOLĖ;5751256561;Ne;10;0;1;11
16868;Gėlynas;RAKTAŽOLĖ;8080660097;Ne;5;0;0;5
16869;Gėlynas;RAKTAŽOLĖ;9252696260;Ne;0;7;0;7
16870;Gėlynas;RAKTAŽOLĖ;8444505017;Ne;0;7;0;7
16871;Gėlynas;SAULĖGRĄŽA;1505666690;Ne;0;0;1;1
16872;Gėlynas;SAULĖGRĄŽA;3492361041;Ne;0;2;0;2
16873;Gėlynas;SAULĖGRĄŽA;6451922757;Ne;0;3;2;5
16874;Gėlynas;SAULĖGRĄŽA;2742456983;Ne;10;0;0;10
16875;Gėlynas;SAULĖGRĄŽA;4983822000;Ne;0;0;6;6
16876;Gėlynas;SAULĖGRĄŽA;9305282699;Ne;10;3;0;13
16877;Gėlynas;SAULĖGRĄŽA;3606076029;Ne;0;9;0;9
16878;Gėlynas;SAULĖGRĄŽA;5964419627;Ne;10;0;0;10
16879;Gėlynas;SAULĖGRĄŽA;9330385153;Ne;4;6;0;10
16880;Gėlynas;SAULĖGRĄŽA;9462822190;Ne;5;0;0;5
16881;Gėlynas;SAULĖGRĄŽA;2784709117;Ne;2;0;1;3
16882;Gėlynas;SAULĖGRĄŽA;6114995335;Ne;7;0;3;10
16883;Gėlynas;SAULĖGRĄŽA;5291444399;Ne;8;0;0;8
16884;Gėlynas;SAULĖGRĄŽA;5320531856;Ne;7;1;0;8
16885;Gėlynas;SAULĖGRĄŽA;6244314445;Ne;5;1;0;6
16886;Gėlynas;RAMUNĖLĖ;1665668966;Ne;0;0;2;2
16887;Gėlynas;RAMUNĖLĖ;9707677931;Ne;7;0;0;7
16888;Gėlynas;RAMUNĖLĖ;9230984365;Ne;0;0;7;7
16889;Gėlynas;RAMUNĖLĖ;6221721945;Ne;0;15;0;15
16890;Gėlynas;RAMUNĖLĖ;1468588114;Ne;0;5;0;5
16891;Gėlynas;RAMUNĖLĖ;6790040590;Ne;0;0;1;1
16892;Gėlynas;RAMUNĖLĖ;4854709904;Ne;9;1;0;10
16893;Gėlynas;RAMUNĖLĖ;1570975863;Ne;0;0;5;5
16894;Gėlynas;RAMUNĖLĖ;9302757372;Ne;0;17;0;17
16895;Gėlynas;RAMUNĖLĖ;8550986498;Ne;0;0;13;13
16896;Gėlynas;RAMUNĖLĖ;6342888072;Ne;0;13;0;13
16897;Gėlynas;RAMUNĖLĖ;1681208354;Ne;0;0;6;6
16898;Gėlynas;RAMUNĖLĖ;1003739544;Ne;0;0;12;12
16899;Gėlynas;ŽIBUTĖ;4192292896;Ne;0;8;0;8
16900;Gėlynas;ŽIBUTĖ;8447789767;Ne;7;0;0;7
16901;Gėlynas;ŽIBUTĖ;1862266440;Ne;0;3;0;3
16902;Gėlynas;ŽIBUTĖ;3746597878;Ne;0;3;0;3
16903;Gėlynas;ŽIBUTĖ;9182072776;Ne;6;0;0;6
16904;Gėlynas;ŽIBUTĖ;4292724541;Ne;0;1;0;1
16905;Gėlynas;ŽIBUTĖ;8681345327;Ne;3;1;0;4
16906;Gėlynas;ŽIBUTĖ;7988094745;Ne;1;2;1;4
16907;Gėlynas;ŽIBUTĖ;9552677108;Ne;0;1;0;1
16908;Gėlynas;ŽIBUTĖ;2608369575;Ne;0;1;0;1
16909;Gėlynas;ŽIBUTĖ;1949260962;Ne;5;4;0;9
16910;Gėlynas;ŽIBUTĖ;6635004996;Ne;5;5;0;10
16911;Gėlynas;ŽIBUTĖ;1556683639;Ne;5;3;0;8
16912;Gėlynas;ŽIBUTĖ;5942466822;Ne;3;0;0;3
16913;Gėlynas;ŽIBUTĖ;2193861056;Ne;0;0;4;4
16914;Gėlynas;ŽIBUTĖ;8743722205;Ne;5;0;0;5
16915;Gėlynas;ŽIBUTĖ;2790269385;Ne;4;0;1;5
16916;Gėlynas;ŽIBUTĖ;2885148633;Ne;5;0;0;5
16917;Obelėlė;Gudručiai;2014314139;Ne;12;0;0;12
16918;Obelėlė;Gudručiai;9900484892;Ne;12;3;0;15
16919;Obelėlė;Gudručiai;6145113624;Ne;0;4;0;4
16920;Obelėlė;Gudručiai;9586720282;Ne;6;0;0;6
16921;Obelėlė;Gudručiai;9567704282;Ne;3;0;1;4
16922;Obelėlė;Gudručiai;5141585309;Ne;22;0;0;22
16923;Obelėlė;Gudručiai;9736557012;Ne;5;0;1;6
16924;Obelėlė;Gudručiai;2204293216;Ne;0;0;4;4
16925;Obelėlė;Gudručiai;1184082097;Ne;10;0;0;10
16926;Obelėlė;Gudručiai;2533715287;Ne;9;0;0;9
16927;Obelėlė;Gudručiai;1312484983;Ne;11;0;1;12
16928;Obelėlė;Gudručiai;1565630870;Ne;0;4;0;4
16929;Obelėlė;Gudručiai;1598785483;Ne;5;1;0;6
16930;Obelėlė;Pasakaitė;1695933896;Ne;0;0;6;6
16931;Obelėlė;Pasakaitė;1555780072;Ne;15;0;0;15
16932;Obelėlė;Pasakaitė;77743243622;Ne;0;0;4;4
16933;Obelėlė;Pasakaitė;79601449969;Ne;0;5;1;6
16934;Obelėlė;Pasakaitė;3330983614;Ne;0;0;1;1
16935;Obelėlė;Pasakaitė;4257479486;Ne;0;0;4;4
16936;Obelėlė;Pasakaitė;9527363918;Ne;0;5;3;8
16937;Obelėlė;Pasakaitė;10939948244;Ne;0;4;1;5
16938;Obelėlė;Pasakaitė;1141707374;Ne;0;2;0;2
16939;Obelėlė;Pasakaitė;6789881144;Ne;0;0;1;1
16940;Obelėlė;Pasakaitė;6036130112;Ne;13;0;0;13
16941;Obelėlė;Pasakaitė;7754276632;Ne;0;22;0;22
16942;Obelėlė;Pasakaitė;69055416041;Ne;0;0;1;1
16943;Obelėlė;Pasakaitė;3517342646;Ne;0;0;5;5
16944;Obelėlė;Pasakaitė;4220808775;Ne;0;2;2;4
16945;Obelėlė;Pasakaitė;1507072248;Ne;0;12;1;13
16946;Obelėlė;Pasakaitė;7934760271;Ne;0;0;1;1
16947;Obelėlė;Svajokliai;9981446556;Ne;5;0;0;5
16948;Obelėlė;Svajokliai;4849499826;Ne;12;0;1;13
16949;Obelėlė;Svajokliai;1469593267;Ne;5;0;2;7
16950;Obelėlė;Svajokliai;9819048265;Taip;0;0;1;1
16951;Obelėlė;Svajokliai;1010954005;Ne;0;0;2;2
16952;Obelėlė;Svajokliai;5620250331;Ne;8;0;0;8
16953;Obelėlė;Svajokliai;5588467580;Ne;20;0;2;22
16954;Obelėlė;Svajokliai;7094715237;Ne;0;0;6;6
16955;Obelėlė;Svajokliai;9070960601;Ne;0;0;1;1
16956;Obelėlė;Svajokliai;8231489868;Ne;0;0;1;1
16957;Obelėlė;Svajokliai;7003947655;Ne;0;2;0;2
16958;Obelėlė;Svajokliai;8918176312;Ne;0;0;1;1
16959;Obelėlė;Svajokliai;8604451971;Ne;0;12;1;13
16960;Obelėlė;Svajokliai;7794072582;Ne;0;0;1;1
16961;Obelėlė;Svajokliai;6785654280;Ne;0;0;5;5
16962;Obelėlė;Svajokliai;6311322617;Ne;0;0;2;2
16963;Obelėlė;Svajokliai;2813927086;Ne;2;0;0;2
16964;Obelėlė;Smalsučiai;6497584911;Ne;0;0;3;3
16965;Obelėlė;Smalsučiai;7687093936;Ne;0;0;1;1
16966;Obelėlė;Smalsučiai;1469375976;Ne;0;0;2;2
16967;Obelėlė;Smalsučiai;7108517080;Ne;0;0;1;1
16968;Obelėlė;Smalsučiai;6008839269;Taip;0;0;1;1
16969;Obelėlė;Smalsučiai;6020342761;Ne;0;0;2;2
16970;Obelėlė;Smalsučiai;4987747783;Ne;0;0;3;3
16971;Obelėlė;Smalsučiai;5085970254;Ne;2;0;0;2
16972;Obelėlė;Smalsučiai;8709758561;Ne;7;0;1;8
16973;Obelėlė;Smalsučiai;4318546408;Ne;0;6;0;6
16974;Obelėlė;Smalsučiai;5739522736;Ne;0;5;0;5
16975;Obelėlė;Smalsučiai;2631405243;Ne;0;12;0;12
16976;Obelėlė;Smalsučiai;8173307704;Ne;0;0;1;1
16977;Obelėlė;Smalsučiai;9796759067;Ne;4;3;0;7
16978;Obelėlė;Smalsučiai;6720808705;Ne;0;1;0;1
16979;Obelėlė;Smalsučiai;9084969712;Taip;3;0;0;3
16980;Obelėlė;Smalsučiai;6364101139;Ne;0;0;1;1
16981;Obelėlė;Smalsučiai;6064646690;Ne;0;0;7;7
16982;Obelėlė;Smalsučiai;8183287212;Ne;0;4;0;4
16983;Obelėlė;Smalsučiai;2574840626;Ne;0;2;0;2
16984;Obelėlė;Smalsučiai;8981403984;Ne;0;22;0;22
16985;Obelėlė;Pabiručiai;2035035265;Ne;7;0;0;7
16986;Obelėlė;Pabiručiai;5763713052;Taip;0;22;0;22
16987;Obelėlė;Pabiručiai;8579887226;Ne;5;0;2;7
16988;Obelėlė;Pabiručiai;6946457363;Ne;0;2;0;2
16989;Obelėlė;Pabiručiai;8948297718;Ne;0;0;1;1
16990;Obelėlė;Pabiručiai;3951816174;Ne;2;0;1;3
16991;Obelėlė;Pabiručiai;5599466885;Ne;5;0;7;12
16992;Obelėlė;Pabiručiai;9634414572;Ne;0;0;7;7
16993;Obelėlė;Pabiručiai;4851824672;Ne;0;0;2;2
16994;Obelėlė;Pabiručiai;3526079444;Ne;5;0;0;5
16995;Obelėlė;Pabiručiai;9731565368;Ne;0;6;0;6
16996;Obelėlė;Pabiručiai;8827515572;Ne;5;10;1;16
16997;Obelėlė;Pabiručiai;2399173200;Ne;0;0;5;5
16998;Obelėlė;Pabiručiai;8443192155;Ne;10;0;0;10
16999;Obelėlė;Pabiručiai;9627134967;Ne;0;0;5;5
17000;Obelėlė;Pabiručiai;5368376431;Ne;4;0;12;16
17001;Obelėlė;Strakaliukai;1706102918;Taip;0;0;3;3
17002;Obelėlė;Strakaliukai;8682794598;Ne;0;8;1;9
17003;Obelėlė;Strakaliukai;8754552660;Ne;0;0;12;12
17004;Obelėlė;Strakaliukai;8092024850;Ne;0;0;1;1
17005;Obelėlė;Strakaliukai;9716500560;Ne;3;0;0;3
17006;Obelėlė;Strakaliukai;4251418414;Ne;1;6;0;7
17007;Obelėlė;Strakaliukai;7128421330;Ne;2;0;2;4
17008;Obelėlė;Strakaliukai;5943314566;Ne;0;0;8;8
17009;Obelėlė;Strakaliukai;5741823041;Ne;0;10;2;12
17010;Obelėlė;Strakaliukai;8050551266;Ne;0;0;6;6
17011;Obelėlė;Strakaliukai;7468335279;Ne;6;6;1;13
17012;Obelėlė;Strakaliukai;1180508643;Ne;0;3;0;3
17013;Obelėlė;Strakaliukai;7124393375;Ne;2;0;8;10
17014;Obelėlė;Strakaliukai;5001844064;Ne;0;0;1;1
17015;Obelėlė;Strakaliukai;9976694313;Ne;0;0;8;8
17016;Obelėlė;Saulutė;2772753891;Taip;0;1;0;1
17017;Obelėlė;Saulutė;8486560892;Ne;0;3;0;3
17018;Obelėlė;Saulutė;1858251094;Ne;6;0;3;9
17019;Obelėlė;Saulutė;2893378990;Ne;2;0;4;6
17020;Obelėlė;Saulutė;6874039388;Ne;0;0;2;2
17021;Obelėlė;Saulutė;7491934262;Ne;8;3;1;12
17022;Obelėlė;Saulutė;9043542844;Ne;1;0;2;3
17023;Obelėlė;Saulutė;4209489251;Ne;0;0;3;3
17024;Obelėlė;Saulutė;4309622934;Ne;3;0;3;6
17025;Obelėlė;Saulutė;3590915973;Ne;4;0;0;4
17026;Obelėlė;Saulutė;6470533765;Ne;2;1;0;3
17027;Obelėlė;Saulutė;8223715886;Ne;2;1;0;3
17028;Obelėlė;Saulutė;8461505586;Ne;0;0;6;6
17029;Obelėlė;Saulutė;2730569223;Ne;10;0;0;10
17030;Obelėlė;Saulutė;4218895290;Ne;0;0;8;8
17031;Obelėlė;Saulutė;3460171136;Taip;0;0;7;7
17032;Obelėlė;Rieduliukai;9008900055;Ne;16;0;0;16
17033;Obelėlė;Rieduliukai;9332534001;Ne;16;0;0;16
17034;Obelėlė;Rieduliukai;2465101384;Ne;5;0;0;5
17035;Obelėlė;Rieduliukai;7403160073;Ne;10;0;7;17
17036;Obelėlė;Rieduliukai;2663004768;Ne;0;0;8;8
17037;Obelėlė;Rieduliukai;8060994250;Ne;13;0;1;14
17038;Obelėlė;Rieduliukai;1788880520;Ne;3;0;9;12
17039;Obelėlė;Rieduliukai;3452970142;Taip;11;0;2;13
17040;Obelėlė;Rieduliukai;4505857257;Ne;3;0;0;3
17041;Obelėlė;Rieduliukai;4707488292;Ne;0;22;0;22
17042;Obelėlė;Rieduliukai;5617103957;Ne;0;22;0;22
17043;Obelėlė;Rieduliukai;3646359565;Ne;9;1;2;12
17044;Obelėlė;Rieduliukai;5366112771;Ne;9;0;0;9
17045;Obelėlė;Rieduliukai;6945301927;Ne;0;10;0;10
17046;Obelėlė;Rieduliukai;5603904852;Ne;0;0;5;5
17047;Obelėlė;Rieduliukai;2031637374;Ne;7;0;0;7
17048;Obelėlė;Žirniukai;5209482838;Ne;22;0;0;22
17049;Obelėlė;Žirniukai;6133596410;Ne;0;0;3;3
17050;Obelėlė;Žirniukai;2702773541;Ne;5;0;2;7
17051;Obelėlė;Žirniukai;2769784741;Ne;0;0;4;4
17052;Obelėlė;Žirniukai;8982197866;Ne;1;0;1;2
17053;Obelėlė;Žirniukai;7813350634;Ne;0;5;1;6
17054;Obelėlė;Žirniukai;3568124213;Ne;0;0;1;1
17055;Obelėlė;Žirniukai;4223995429;Ne;0;0;1;1
17056;Obelėlė;Žirniukai;5073364608;Ne;0;12;0;12
17057;Obelėlė;Žirniukai;3287262204;Ne;0;0;1;1
17058;Obelėlė;Žirniukai;5192989376;Ne;0;0;9;9
17059;Obelėlė;Žirniukai;1799603610;Ne;0;22;0;22
17060;Obelėlė;Žirniukai;8794707243;Ne;0;0;1;1
17061;Obelėlė;Bičiuliai;3425736276;Ne;2;0;0;2
17062;Obelėlė;Bičiuliai;5776116844;Ne;0;0;5;5
17063;Obelėlė;Bičiuliai;8487088625;Ne;0;2;0;2
17064;Obelėlė;Bičiuliai;1630067014;Ne;0;9;0;9
17065;Obelėlė;Bičiuliai;1537769810;Ne;0;0;8;8
17066;Obelėlė;Bičiuliai;8371648703;Ne;0;0;1;1
17067;Obelėlė;Bičiuliai;2329734472;Ne;0;0;1;1
17068;Obelėlė;Bičiuliai;1419189517;Ne;0;0;1;1
17069;Obelėlė;Bičiuliai;4849175527;Ne;0;5;0;5
17070;Obelėlė;Bičiuliai;1362135757;Ne;0;0;2;2
17071;Obelėlė;Bičiuliai;3769993089;Ne;0;0;2;2
17072;Obelėlė;Bičiuliai;5374979248;Ne;0;0;3;3
17073;Obelėlė;Bičiuliai;2170134084;Ne;0;0;1;1
17074;Obelėlė;Kodėlčiukai;9960526051;Ne;5;0;1;6
17075;Obelėlė;Kodėlčiukai;1050919659;Ne;0;0;1;1
17076;Obelėlė;Kodėlčiukai;7014872044;Ne;4;0;0;4
17077;Obelėlė;Kodėlčiukai;3028107343;Ne;18;0;0;18
17078;Obelėlė;Kodėlčiukai;4717038536;Ne;0;5;4;9
17079;Obelėlė;Kodėlčiukai;4840134079;Ne;0;5;5;10
17080;Obelėlė;Kodėlčiukai;8762518354;Ne;0;0;2;2
17081;Obelėlė;Kodėlčiukai;3320493372;Ne;10;0;0;10
17082;Obelėlė;Kodėlčiukai;8366162313;Ne;2;0;0;2
17083;Obelėlė;Kodėlčiukai;6481365666;Ne;1;0;0;1
17084;Obelėlė;Kodėlčiukai;8818153952;Ne;9;5;0;14
17085;Obelėlė;Kodėlčiukai;4887103549;Ne;0;10;3;13
17086;Obelėlė;Kodėlčiukai;5221918341;Taip;6;0;8;14
17087;Obelėlė;Kodėlčiukai;7696478568;Taip;0;0;4;4
17088;Obelėlė;Kodėlčiukai;7422668691;Ne;8;0;0;8
17089;Obelėlė;Kodėlčiukai;5233321854;Ne;5;0;0;5
17090;Obelėlė;Kodėlčiukai;1472630240;Ne;4;0;2;6
17091;Obelėlė;Pagrandukai;7934967787;Ne;10;0;0;10
17092;Obelėlė;Pagrandukai;4673426170;Ne;15;2;0;17
17093;Obelėlė;Pagrandukai;6436061438;Ne;6;0;0;6
17094;Obelėlė;Pagrandukai;8711370875;Ne;0;0;2;2
17095;Obelėlė;Pagrandukai;6938326798;Ne;9;0;0;9
17096;Obelėlė;Pagrandukai;9258651395;Taip;15;4;0;19
17097;Obelėlė;Pagrandukai;4974008654;Ne;0;22;0;22
17098;Obelėlė;Pagrandukai;3563701047;Ne;15;0;0;15
17099;Obelėlė;Pagrandukai;8664564820;Taip;10;0;2;12
17100;Obelėlė;Pagrandukai;4862765923;Ne;12;0;0;12
17101;Obelėlė;Pagrandukai;9170515841;Ne;16;0;0;16
17102;Obelėlė;Pagrandukai;4930485327;Ne;14;0;0;14
17103;Obelėlė;Pagrandukai;8534759650;Ne;0;0;3;3
17104;Obelėlė;Pagrandukai;7368698046;Ne;13;0;0;13
17105;Obelėlė;Pagrandukai;3738932600;Taip;9;0;2;11
17106;Spygliukas;Bitutės;8272537768;Ne;9;2;0;11
17107;Spygliukas;Bitutės;8404929784;Ne;3;0;0;3
17108;Spygliukas;Bitutės;4835818382;Ne;9;2;0;11
17109;Spygliukas;Bitutės;9070219319;Ne;0;2;0;2
17110;Spygliukas;Bitutės;9413950200;Ne;0;4;0;4
17111;Spygliukas;Bitutės;1664878188;Ne;8;0;0;8
17112;Spygliukas;Bitutės;5134327772;Ne;0;1;0;1
17113;Spygliukas;Bitutės;8869320003;Ne;0;1;0;1
17114;Spygliukas;Bitutės;8476882854;Ne;9;6;0;15
17115;Spygliukas;Bitutės;1333556956;Ne;0;7;1;8
17116;Spygliukas;Bitutės;3761715811;Ne;0;12;8;20
17117;Spygliukas;Bitutės;8270525839;Ne;3;0;0;3
17118;Spygliukas;Bitutės;3697691132;Ne;3;1;2;6
17119;Spygliukas;Bitutės;1550737449;Ne;4;0;2;6
17120;Spygliukas;Bitutės;4053158210;Ne;0;3;0;3
17121;Spygliukas;Bitutės;2395961015;Ne;0;1;1;2
17122;Spygliukas;Bitutės;5180736358;Ne;15;0;1;16
17123;Spygliukas;Bitutės;9431217584;Ne;7;4;2;13
17124;Spygliukas;Bitutės;8289288541;Ne;12;0;1;13
17125;Spygliukas;Kiškučiai;1927028026;Ne;5;0;0;5
17126;Spygliukas;Kiškučiai;3094528907;Ne;3;1;0;4
17127;Spygliukas;Kiškučiai;8981549891;Ne;0;10;0;10
17128;Spygliukas;Kiškučiai;9813995933;Taip;0;8;0;8
17129;Spygliukas;Kiškučiai;4013601534;Ne;15;0;0;15
17130;Spygliukas;Kiškučiai;3959136555;Ne;4;0;0;4
17131;Spygliukas;Kiškučiai;6383264068;Ne;0;6;0;6
17132;Spygliukas;Kiškučiai;5369930705;Ne;5;0;0;5
17133;Spygliukas;Kiškučiai;6246925536;Taip;2;1;0;3
17134;Spygliukas;Kiškučiai;1037321774;Taip;0;6;0;6
17135;Spygliukas;Kiškučiai;5615854225;Ne;7;3;0;10
17136;Spygliukas;Kiškučiai;7261580644;Ne;11;3;0;14
17137;Spygliukas;Kiškučiai;1436452804;Ne;0;2;13;15
17138;Spygliukas;Kiškučiai;1330384915;Ne;11;0;0;11
17139;Spygliukas;Kiškučiai;8299276429;Ne;0;2;0;2
17140;Spygliukas;Boružėlės;3569857813;Ne;0;0;3;3
17141;Spygliukas;Boružėlės;5493599614;Ne;0;0;1;1
17142;Spygliukas;Boružėlės;9285259322;Ne;0;2;0;2
17143;Spygliukas;Boružėlės;1341333016;Ne;22;0;0;22
17144;Spygliukas;Boružėlės;5561426508;Ne;0;0;1;1
17145;Spygliukas;Boružėlės;8806126755;Taip;0;1;0;1
17146;Spygliukas;Boružėlės;4477402331;Ne;0;0;1;1
17147;Spygliukas;Boružėlės;2772801133;Ne;7;0;0;7
17148;Spygliukas;Boružėlės;3706443395;Ne;0;1;0;1
17149;Spygliukas;Boružėlės;5765106914;Ne;0;6;0;6
17150;Spygliukas;Boružėlės;3416275094;Ne;0;0;1;1
17151;Spygliukas;Boružėlės;1401951658;Ne;2;0;0;2
17152;Spygliukas;Boružėlės;6248409896;Ne;3;2;0;5
17153;Spygliukas;Boružėlės;8708083787;Ne;0;4;0;4
17154;Spygliukas;Boružėlės;8825264090;Taip;0;2;7;9
17155;Spygliukas;Boružėlės;4577592862;Ne;3;5;0;8
17156;Spygliukas;Boružėlės;6835488489;Ne;0;4;0;4
17157;Spygliukas;Boružėlės;7900652746;Ne;0;6;0;6
17158;Spygliukas;Ežiukai;2164549239;Ne;3;0;0;3
17159;Spygliukas;Ežiukai;4340767624;Ne;0;0;2;2
17160;Spygliukas;Ežiukai;1983112873;Taip;0;8;0;8
17161;Spygliukas;Ežiukai;4615217628;Ne;11;2;0;13
17162;Spygliukas;Ežiukai;5612894706;Ne;0;2;0;2
17163;Spygliukas;Ežiukai;6552944183;Ne;0;0;2;2
17164;Spygliukas;Ežiukai;6459076295;Ne;0;2;0;2
17165;Spygliukas;Ežiukai;7749937772;Ne;16;4;2;22
17166;Spygliukas;Ežiukai;5160835235;Ne;0;4;0;4
17167;Spygliukas;Ežiukai;2719100414;Ne;0;5;0;5
17168;Spygliukas;Ežiukai;1429613380;Ne;14;0;0;14
17169;Spygliukas;Ežiukai;4026252608;Ne;13;0;0;13
17170;Spygliukas;Ežiukai;4098112375;Ne;0;0;3;3
17171;Spygliukas;Ežiukai;9321493897;Ne;11;0;0;11
17172;Spygliukas;Ežiukai;7908419787;Taip;5;0;0;5
17173;Spygliukas;Ežiukai;5366783639;Ne;0;1;0;1
17174;Spygliukas;Ežiukai;7287543571;Ne;18;0;0;18
17175;Spygliukas;Geniukai;2713999021;Ne;12;1;0;13
17176;Spygliukas;Geniukai;5782501698;Ne;3;0;0;3
17177;Spygliukas;Geniukai;6700076900;Ne;9;0;3;12
17178;Spygliukas;Geniukai;8338260940;Ne;2;0;0;2
17179;Spygliukas;Geniukai;1863442354;Ne;10;4;0;14
17180;Spygliukas;Geniukai;9945315122;Ne;0;0;4;4
17181;Spygliukas;Geniukai;1291429206;Ne;0;4;0;4
17182;Spygliukas;Geniukai;7477731865;Ne;0;0;4;4
17183;Spygliukas;Geniukai;2950722789;Ne;0;6;0;6
17184;Spygliukas;Geniukai;8093949301;Ne;6;0;1;7
17185;Spygliukas;Geniukai;6363991196;Ne;2;3;0;5
17186;Spygliukas;Geniukai;8308394841;Ne;0;1;0;1
17187;Spygliukas;Geniukai;1127941700;Ne;3;0;0;3
17188;Spygliukas;Geniukai;9783154498;Ne;0;1;0;1
17189;Spygliukas;Geniukai;8581453160;Ne;0;10;0;10
17190;Spygliukas;Geniukai;7573756485;Ne;5;10;0;15
17191;Spygliukas;Geniukai;9770852356;Ne;9;0;0;9
17192;Spygliukas;Riešutėliai;29449834997;Ne;12;1;0;13
17193;Spygliukas;Riešutėliai;47977103711;Ne;10;0;0;10
17194;Spygliukas;Riešutėliai;1855897974;Taip;0;9;0;9
17195;Spygliukas;Riešutėliai;1940209166;Ne;0;4;0;4
17196;Spygliukas;Riešutėliai;1939828587;Ne;0;0;1;1
17197;Spygliukas;Riešutėliai;1238940921;Ne;5;6;0;11
17198;Spygliukas;Riešutėliai;4933577424;Ne;0;1;0;1
17199;Spygliukas;Riešutėliai;9797138740;Ne;0;7;0;7
17200;Spygliukas;Riešutėliai;9001243644;Ne;11;0;0;11
17201;Spygliukas;Riešutėliai;9975117461;Ne;0;0;1;1
17202;Spygliukas;Riešutėliai;5022615426;Ne;0;1;0;1
17203;Spygliukas;Riešutėliai;1228469923;Ne;0;2;0;2
17204;Spygliukas;Riešutėliai;4430242310;Ne;0;1;0;1
17205;Spygliukas;Riešutėliai;8103481313;Ne;0;1;0;1
17206;Spygliukas;Riešutėliai;5827455834;Ne;0;1;0;1
17207;Spygliukas;Riešutėliai;4653108810;Ne;0;3;0;3
17208;Spygliukas;Pelėdžiukai;1260920726;Ne;0;7;0;7
17209;Spygliukas;Pelėdžiukai;8686118262;Ne;0;6;0;6
17210;Spygliukas;Pelėdžiukai;8048474808;Ne;0;0;6;6
17211;Spygliukas;Pelėdžiukai;5778081118;Ne;8;0;1;9
17212;Spygliukas;Pelėdžiukai;4721066953;Ne;2;0;0;2
17213;Spygliukas;Pelėdžiukai;8331205164;Ne;0;0;7;7
17214;Spygliukas;Pelėdžiukai;4949371837;Ne;0;5;0;5
17215;Spygliukas;Pelėdžiukai;4650693672;Ne;0;0;2;2
17216;Spygliukas;Pelėdžiukai;3658613027;Ne;2;0;0;2
17217;Spygliukas;Pelėdžiukai;1662885055;Ne;3;0;0;3
17218;Spygliukas;Pelėdžiukai;50047868918;Ne;2;0;0;2
17219;Spygliukas;Pelėdžiukai;3365209400;Ne;0;0;2;2
17220;Spygliukas;Pelėdžiukai;6457632191;Ne;0;0;6;6
17221;Spygliukas;Pelėdžiukai;1691209405;Ne;6;2;0;8
17222;Spygliukas;Pelėdžiukai;9178184431;Ne;0;0;4;4
17223;Spygliukas;Pelėdžiukai;2739564216;Ne;0;0;2;2
17224;Spygliukas;Pelėdžiukai;4610504338;Ne;0;0;1;1
17225;Spygliukas;Pelėdžiukai;89044575245;Ne;0;6;6;12
17226;Spygliukas;Zylutės;9465470810;Ne;4;2;0;6
17227;Spygliukas;Zylutės;8366571422;Ne;0;7;1;8
17228;Spygliukas;Zylutės;4417471958;Ne;6;9;3;18
17229;Spygliukas;Zylutės;3811864870;Ne;5;0;0;5
17230;Spygliukas;Zylutės;4177369871;Taip;5;0;4;9
17231;Spygliukas;Zylutės;8105507156;Ne;9;3;0;12
17232;Spygliukas;Zylutės;6858338620;Ne;0;0;1;1
17233;Spygliukas;Zylutės;9601530981;Ne;3;0;0;3
17234;Spygliukas;Zylutės;3066293772;Ne;8;0;0;8
17235;Spygliukas;Zylutės;3988253265;Taip;0;5;0;5
17236;Spygliukas;Zylutės;3268222954;Ne;0;0;6;6
17237;Spygliukas;Zylutės;5006372835;Ne;3;0;2;5
17238;Spygliukas;Zylutės;1729199382;Ne;2;0;0;2
17239;Spygliukas;Zylutės;8408234202;Ne;7;0;0;7
17240;Spygliukas;Zylutės;3317395260;Ne;4;0;0;4
17241;Spygliukas;Zylutės;6343141973;Ne;2;0;0;2
17242;Spygliukas;Zylutės;5638595939;Ne;5;0;0;5
17243;Spygliukas;Skruzdėliukai;8246739374;Ne;11;0;2;13
17244;Spygliukas;Skruzdėliukai;5739075961;Ne;2;0;1;3
17245;Spygliukas;Skruzdėliukai;7324915516;Ne;7;1;0;8
17246;Spygliukas;Skruzdėliukai;6414439254;Ne;7;1;0;8
17247;Spygliukas;Skruzdėliukai;8426426785;Ne;4;2;0;6
17248;Spygliukas;Skruzdėliukai;1243647769;Ne;2;0;0;2
17249;Spygliukas;Skruzdėliukai;2955219028;Ne;16;1;0;17
17250;Spygliukas;Skruzdėliukai;1823720183;Ne;10;4;0;14
17251;Spygliukas;Skruzdėliukai;8565217488;Ne;0;1;11;12
17252;Spygliukas;Skruzdėliukai;2367685286;Ne;0;22;0;22
17253;Spygliukas;Skruzdėliukai;3065727701;Ne;9;0;0;9
17254;Spygliukas;Skruzdėliukai;1775612723;Ne;0;5;0;5
17255;Spygliukas;Skruzdėliukai;5043843336;Ne;9;0;0;9
17256;Spygliukas;Voveraitės;9112172144;Ne;7;0;4;11
17257;Spygliukas;Voveraitės;7897603878;Ne;0;2;0;2
17258;Spygliukas;Voveraitės;7741841634;Ne;5;3;0;8
17259;Spygliukas;Voveraitės;3077468722;Ne;0;0;4;4
17260;Spygliukas;Voveraitės;1177439438;Ne;0;7;0;7
17261;Spygliukas;Voveraitės;4948147941;Ne;0;0;2;2
17262;Spygliukas;Voveraitės;2272141731;Ne;0;0;2;2
17263;Spygliukas;Voveraitės;6587957213;Ne;0;6;0;6
17264;Spygliukas;Voveraitės;6758336405;Ne;3;0;0;3
17265;Spygliukas;Voveraitės;3668191959;Ne;6;0;0;6
17266;Spygliukas;Voveraitės;1426267001;Ne;0;0;2;2
17267;Spygliukas;Voveraitės;8189748611;Ne;3;0;0;3
17268;Spygliukas;Voveraitės;8877911083;Ne;0;1;1;2
17269;Spygliukas;Voveraitės;6405496193;Ne;0;10;2;12
17270;Spygliukas;Voveraitės;7113913750;Ne;0;0;3;3
17271;Spygliukas;Voveraitės;9231097598;Ne;1;7;0;8
17272;Spygliukas;Voveraitės;4681061579;Ne;9;0;2;11
17273;Spygliukas;Voveraitės;7313828707;Ne;3;0;0;3
17274;Spygliukas;Voveraitės;1234195733;Ne;0;5;0;5
17275;Spygliukas;Giliukų;1761340174;Ne;5;0;0;5
17276;Spygliukas;Giliukų;4854168938;Taip;5;0;3;8
17277;Spygliukas;Giliukų;7522567241;Ne;0;1;0;1
17278;Spygliukas;Giliukų;7460280684;Ne;7;0;0;7
17279;Spygliukas;Giliukų;4429961491;Ne;16;0;0;16
17280;Spygliukas;Giliukų;8821028259;Ne;0;5;2;7
17281;Spygliukas;Giliukų;6485350404;Ne;0;22;0;22
17282;Spygliukas;Giliukų;3237501537;Ne;5;0;0;5
17283;Spygliukas;Giliukų;8722863277;Ne;5;0;0;5
17284;Spygliukas;Giliukų;9025238241;Ne;0;2;0;2
17285;Spygliukas;Giliukų;3603606800;Ne;2;2;1;5
17286;Spygliukas;Giliukų;6290439938;Ne;2;2;0;4
17287;Spygliukas;Giliukų;7776811391;Ne;0;1;0;1
17288;Spygliukas;Giliukų;3777763305;Ne;0;6;0;6
17289;Spygliukas;Giliukų;4626877679;Ne;2;10;0;12
17290;Spygliukas;Giliukų;5255993275;Taip;0;0;20;20
17291;Spygliukas;Drugeliai;7271659513;Ne;0;8;0;8
17292;Spygliukas;Drugeliai;8604767396;Ne;4;0;0;4
17293;Spygliukas;Drugeliai;4634660174;Ne;5;1;0;6
17294;Spygliukas;Drugeliai;7924880159;Ne;11;2;3;16
17295;Spygliukas;Drugeliai;4368224847;Ne;12;2;0;14
17296;Spygliukas;Drugeliai;9316731983;Ne;0;0;3;3
17297;Spygliukas;Drugeliai;6630979640;Ne;6;0;0;6
17298;Spygliukas;Drugeliai;5012876830;Ne;0;8;0;8
17299;Spygliukas;Drugeliai;2315421636;Ne;5;2;1;8
17300;Spygliukas;Drugeliai;7125425492;Ne;0;1;1;2
17301;Spygliukas;Drugeliai;9052337501;Ne;2;2;2;6
17302;Spygliukas;Drugeliai;4505044604;Ne;7;4;0;11
17303;Spygliukas;Drugeliai;2989701249;Ne;0;1;0;1
17304;Spygliukas;Drugeliai;9086986643;Taip;0;1;0;1
17305;Spygliukas;Drugeliai;9392554576;Ne;5;0;0;5
17306;Spygliukas;Drugeliai;8646122773;Ne;6;2;0;8
17307;Vieversys;Žirniukai;5365334453;Ne;7;0;0;7
17308;Vieversys;Žirniukai;7029322013;Ne;0;5;0;5
17309;Vieversys;Žirniukai;2266222087;Ne;8;0;0;8
17310;Vieversys;Žirniukai;2869545222;Ne;11;0;3;14
17311;Vieversys;Žirniukai;7601876587;Ne;5;3;0;8
17312;Vieversys;Žirniukai;2024837493;Ne;5;0;3;8
17313;Vieversys;Žirniukai;8129566710;Ne;9;0;1;10
17314;Vieversys;Žirniukai;5576923685;Ne;8;0;0;8
17315;Vieversys;Žirniukai;6052943894;Ne;5;0;0;5
17316;Vieversys;Žirniukai;3295424711;Ne;5;0;1;6
17317;Vieversys;Žirniukai;7309040730;Ne;5;0;0;5
17318;Vieversys;Žirniukai;3575906273;Ne;6;0;0;6
17319;Vieversys;Žirniukai;1724543625;Ne;5;7;0;12
17320;Vieversys;Žirniukai;3533711179;Taip;0;2;0;2
17321;Vieversys;Varpelių;9463693741;Ne;3;0;0;3
17322;Vieversys;Varpelių;1924774817;Taip;0;4;0;4
17323;Vieversys;Varpelių;3595005599;Ne;21;0;0;21
17324;Vieversys;Varpelių;2635722489;Ne;0;1;2;3
17325;Vieversys;Varpelių;3262738994;Ne;10;0;0;10
17326;Vieversys;Varpelių;8350070741;Ne;0;0;2;2
17327;Vieversys;Varpelių;2805682329;Ne;4;1;0;5
17328;Vieversys;Varpelių;9453100342;Ne;0;0;2;2
17329;Vieversys;Varpelių;2956566201;Ne;0;2;4;6
17330;Vieversys;Varpelių;1727558984;Ne;10;0;10;20
17331;Vieversys;Varpelių;3297728501;Taip;0;2;1;3
17332;Vieversys;Varpelių;3780226431;Ne;5;0;2;7
17333;Vieversys;Varpelių;3572628491;Ne;15;0;0;15
17334;Vieversys;Varpelių;1128991679;Ne;4;0;0;4
17335;Vieversys;Varpelių;7611047781;Ne;0;7;0;7
17336;Vieversys;Varpelių;8079885165;Ne;11;0;0;11
17337;Vieversys;Kiškučių;5922485482;Ne;0;0;1;1
17338;Vieversys;Kiškučių;3917758713;Ne;5;0;2;7
17339;Vieversys;Kiškučių;9387421639;Ne;6;0;1;7
17340;Vieversys;Kiškučių;2383765752;Ne;0;7;0;7
17341;Vieversys;Kiškučių;1247565595;Ne;8;0;5;13
17342;Vieversys;Kiškučių;53977164888;Ne;0;7;0;7
17343;Vieversys;Kiškučių;5810605263;Ne;6;6;0;12
17344;Vieversys;Kiškučių;3205204176;Ne;0;3;3;6
17345;Vieversys;Kiškučių;82594887399;Ne;0;0;1;1
17346;Vieversys;Kiškučių;6787960120;Ne;0;0;3;3
17347;Vieversys;Kiškučių;9612415733;Ne;0;2;0;2
17348;Vieversys;Kiškučių;5286521728;Ne;0;0;6;6
17349;Vieversys;Kiškučių;1149316471;Ne;0;2;0;2
17350;Vieversys;Kiškučių;7500147648;Ne;5;1;0;6
17351;Vieversys;Kiškučių;95891054066;Ne;5;0;0;5
17352;Vieversys;Kiškučių;4313822180;Ne;4;7;0;11
17353;Vieversys;Kiškučių;8038341998;Ne;0;8;0;8
17354;Vieversys;Kiškučių;5917328379;Ne;0;1;0;1
17355;Vieversys;Kiškučių;6720355390;Ne;0;7;7;14
17356;Vieversys;Kiškučių;1933907389;Ne;0;9;1;10
17357;Vieversys;Pelėdžiukų;8421719030;Ne;0;0;2;2
17358;Vieversys;Pelėdžiukų;77272293257;Ne;0;0;3;3
17359;Vieversys;Pelėdžiukų;94463134058;Ne;0;1;0;1
17360;Vieversys;Pelėdžiukų;7578552471;Ne;5;0;2;7
17361;Vieversys;Pelėdžiukų;2193074123;Ne;0;0;4;4
17362;Vieversys;Pelėdžiukų;9499315463;Ne;0;1;0;1
17363;Vieversys;Pelėdžiukų;2521488728;Ne;5;0;1;6
17364;Vieversys;Pelėdžiukų;6473759470;Ne;0;4;0;4
17365;Vieversys;Pelėdžiukų;1273951001;Ne;0;7;1;8
17366;Vieversys;Pelėdžiukų;48430863473;Ne;0;7;3;10
17367;Vieversys;Pelėdžiukų;1027693153;Ne;0;6;0;6
17368;Vieversys;Pelėdžiukų;5871715452;Ne;0;0;1;1
17369;Vieversys;Pelėdžiukų;9659337657;Ne;0;1;1;2
17370;Vieversys;Pelėdžiukų;1361156816;Ne;4;0;0;4
17371;Vieversys;Pelėdžiukų;3755410640;Ne;0;2;0;2
17372;Vieversys;Saulučių;3164280186;Ne;0;6;7;13
17373;Vieversys;Saulučių;3405502715;Ne;0;0;2;2
17374;Vieversys;Saulučių;6127272124;Ne;0;0;1;1
17375;Vieversys;Saulučių;5654533451;Ne;0;0;3;3
17376;Vieversys;Saulučių;9972526744;Ne;5;0;0;5
17377;Vieversys;Saulučių;9308040716;Ne;4;0;0;4
17378;Vieversys;Saulučių;4741252829;Ne;5;0;0;5
17379;Vieversys;Saulučių;1748006118;Ne;0;5;0;5
17380;Vieversys;Saulučių;4690095102;Ne;0;0;2;2
17381;Vieversys;Saulučių;7048475906;Ne;0;0;7;7
17382;Vieversys;Saulučių;4072323869;Ne;0;0;1;1
17383;Vieversys;Saulučių;2663322242;Ne;4;0;0;4
17384;Vieversys;Saulučių;7596355010;Ne;0;0;17;17
17385;Vieversys;Saulučių;3360981720;Ne;4;0;2;6
17386;Vieversys;Saulučių;9322322737;Ne;10;0;0;10
17387;Vieversys;Kregždučių;3156245273;Ne;14;0;0;14
17388;Vieversys;Kregždučių;5645852451;Ne;5;0;0;5
17389;Vieversys;Kregždučių;9088171869;Ne;0;0;2;2
17390;Vieversys;Kregždučių;7998100115;Ne;0;1;1;2
17391;Vieversys;Kregždučių;9093088054;Ne;0;9;0;9
17392;Vieversys;Kregždučių;4870401841;Ne;15;0;0;15
17393;Vieversys;Kregždučių;2849852593;Ne;1;1;0;2
17394;Vieversys;Kregždučių;6808541662;Ne;5;6;0;11
17395;Vieversys;Kregždučių;2230503026;Ne;4;0;1;5
17396;Vieversys;Kregždučių;7568415178;Ne;3;0;0;3
17397;Vieversys;Kregždučių;8141710663;Ne;0;0;1;1
17398;Vieversys;Kregždučių;6157594693;Ne;0;3;0;3
17399;Vieversys;Kregždučių;9090281352;Ne;0;0;1;1
17400;Vieversys;Kregždučių;4308330177;Ne;10;0;5;15
17401;Vieversys;Kregždučių;4347494053;Ne;0;0;1;1
17402;Vieversys;Kregždučių;3122763958;Ne;4;5;0;9
17403;Vieversys;Kregždučių;2938302462;Ne;0;5;1;6
17404;Vieversys;Kregždučių;9577869269;Ne;0;0;2;2
17405;Vieversys;Boružėlių;6838828193;Ne;0;7;3;10
17406;Vieversys;Boružėlių;8587368497;Ne;0;1;0;1
17407;Vieversys;Boružėlių;5683183310;Ne;0;2;0;2
17408;Vieversys;Boružėlių;9884517851;Ne;0;2;0;2
17409;Vieversys;Boružėlių;7399326463;Ne;12;0;0;12
17410;Vieversys;Boružėlių;4088189914;Ne;8;0;0;8
17411;Vieversys;Boružėlių;7364582681;Ne;0;2;0;2
17412;Vieversys;Boružėlių;8084767846;Ne;0;5;0;5
17413;Vieversys;Boružėlių;9826657384;Ne;5;1;0;6
17414;Vieversys;Boružėlių;3731412573;Ne;0;6;0;6
17415;Vieversys;Boružėlių;7429565381;Ne;6;0;3;9
17416;Vieversys;Boružėlių;4297477514;Ne;0;2;7;9
17417;Vieversys;Boružėlių;8816714193;Ne;0;1;0;1
17418;Vieversys;Boružėlių;2701284187;Ne;0;2;0;2
17419;Vieversys;Boružėlių;6234199996;Ne;20;0;1;21
17420;Vieversys;Bitučių;9268459013;Ne;0;2;0;2
17421;Vieversys;Bitučių;8706336322;Ne;13;0;2;15
17422;Vieversys;Bitučių;5966170543;Ne;11;0;0;11
17423;Vieversys;Bitučių;9188208330;Ne;3;2;0;5
17424;Vieversys;Bitučių;9454017990;Ne;0;22;0;22
17425;Vieversys;Bitučių;9476611261;Ne;22;0;0;22
17426;Vieversys;Bitučių;6083402842;Ne;3;0;1;4
17427;Vieversys;Bitučių;4428101863;Ne;0;7;0;7
17428;Vieversys;Bitučių;9978867863;Ne;0;3;0;3
17429;Vieversys;Bitučių;9092693925;Ne;0;8;0;8
17430;Vieversys;Bitučių;2661027772;Taip;3;0;0;3
17431;Vieversys;Bitučių;3601928285;Ne;10;8;0;18
17432;Vieversys;Bitučių;8492908398;Ne;0;0;1;1
17433;Vieversys;Bitučių;5479620291;Taip;7;0;3;10
17434;Vieversys;Smalsučių;3681120339;Ne;0;22;0;22
17435;Vieversys;Smalsučių;9164615794;Ne;0;9;0;9
17436;Vieversys;Smalsučių;6563139211;Ne;0;1;1;2
17437;Vieversys;Smalsučių;4294676988;Ne;5;4;0;9
17438;Vieversys;Smalsučių;4835022593;Ne;3;0;1;4
17439;Vieversys;Smalsučių;3249717073;Ne;5;5;0;10
17440;Vieversys;Smalsučių;7120329258;Ne;0;1;0;1
17441;Vieversys;Smalsučių;8174124875;Taip;0;2;0;2
17442;Vieversys;Smalsučių;5769453869;Ne;0;4;0;4
17443;Vieversys;Smalsučių;5907903394;Ne;0;0;9;9
17444;Vieversys;Smalsučių;3946609345;Ne;0;0;14;14
17445;Vieversys;Smalsučių;4455039401;Ne;0;0;2;2
17446;Vieversys;Smalsučių;8129139979;Ne;12;5;0;17
17447;Vieversys;Smalsučių;9835682858;Ne;0;15;4;19
17448;Vieversys;Smalsučių;7007620994;Ne;0;0;10;10
17449;Vieversys;Smalsučių;9494957750;Ne;0;0;2;2
17450;Vieversys;Kodėlčiukų;9217208794;Ne;0;22;0;22
17451;Vieversys;Kodėlčiukų;5037806018;Ne;0;0;1;1
17452;Vieversys;Kodėlčiukų;1752359969;Taip;0;13;0;13
17453;Vieversys;Kodėlčiukų;6791121542;Ne;10;2;0;12
17454;Vieversys;Kodėlčiukų;5898422871;Ne;3;11;0;14
17455;Vieversys;Kodėlčiukų;6709556873;Ne;0;0;1;1
17456;Vieversys;Kodėlčiukų;4193031329;Ne;0;1;0;1
17457;Vieversys;Kodėlčiukų;7453156612;Ne;0;0;4;4
17458;Vieversys;Kodėlčiukų;1881076551;Ne;0;7;0;7
17459;Vieversys;Kodėlčiukų;1384388802;Ne;0;5;0;5
17460;Vieversys;Kodėlčiukų;2562413607;Ne;0;0;2;2
17461;Vieversys;Kodėlčiukų;9965162863;Ne;0;6;0;6
17462;Vieversys;Kodėlčiukų;4702339508;Taip;12;0;0;12
17463;Vieversys;Kodėlčiukų;4631238425;Ne;8;1;2;11
17464;Vieversys;Kodėlčiukų;8512643926;Ne;3;3;0;6
17465;Vieversys;Kodėlčiukų;7967372524;Ne;19;0;1;20
17466;Vieversys;Kodėlčiukų;4703696958;Ne;0;7;0;7
17467;Vieversys;NYKŠTUKAI;3332069842;Ne;0;0;2;2
17468;Vieversys;NYKŠTUKAI;2107000312;Ne;0;17;2;19
17469;Vieversys;NYKŠTUKAI;7539934804;Ne;12;0;0;12
17470;Vieversys;NYKŠTUKAI;1714096583;Ne;10;0;0;10
17471;Vieversys;NYKŠTUKAI;8371839883;Ne;6;0;0;6
17472;Vieversys;NYKŠTUKAI;6474334564;Ne;7;0;0;7
17473;Vieversys;NYKŠTUKAI;6631296204;Taip;0;6;2;8
17474;Vieversys;NYKŠTUKAI;5394635510;Ne;13;0;0;13
17475;Vieversys;NYKŠTUKAI;1160455554;Ne;8;0;0;8
17476;Vieversys;NYKŠTUKAI;8200432952;Ne;24;0;2;26
17477;Vieversys;NYKŠTUKAI;2535992834;Ne;7;0;2;9
17478;Vieversys;NYKŠTUKAI;4974924858;Ne;5;0;0;5
17479;Vieversys;NYKŠTUKAI;4087823915;Ne;8;0;1;9
17480;Vieversys;NYKŠTUKAI;7111551694;Ne;12;0;0;12
17481;Vieversys;NYKŠTUKAI;7778432049;Ne;6;0;0;6
17482;Vieversys;NYKŠTUKAI;4952182897;Ne;0;0;2;2
17483;Vieversys;DRUGELIAI;2638813853;Ne;7;0;2;9
17484;Vieversys;DRUGELIAI;9412299328;Ne;7;0;0;7
17485;Vieversys;DRUGELIAI;7508850558;Ne;0;0;1;1
17486;Vieversys;DRUGELIAI;1552959751;Ne;0;0;1;1
17487;Vieversys;DRUGELIAI;6669012722;Ne;17;0;0;17
17488;Vieversys;DRUGELIAI;6000875464;Ne;0;1;0;1
17489;Vieversys;DRUGELIAI;7708807923;Ne;0;0;1;1
17490;Vieversys;DRUGELIAI;5580265718;Taip;0;7;7;14
17491;Vieversys;DRUGELIAI;4129333932;Ne;0;22;0;22
17492;Vieversys;DRUGELIAI;8199984460;Ne;0;22;0;22
17493;Vieversys;DRUGELIAI;6581002790;Ne;6;0;0;6
17494;Vieversys;DRUGELIAI;9666764935;Ne;0;0;21;21
17495;Vieversys;DRUGELIAI;8966020793;Ne;14;0;1;15
17496;Vieversys;DRUGELIAI;1720061988;Taip;2;7;0;9
17497;Vieversys;DRUGELIAI;6014448044;Ne;10;3;0;13
17498;Žirmūnėliai;SAULUTĖS;5560694124;Ne;3;1;0;4
17499;Žirmūnėliai;SAULUTĖS;6116321928;Ne;0;3;0;3
17500;Žirmūnėliai;SAULUTĖS;2310523676;Ne;5;2;0;7
17501;Žirmūnėliai;SAULUTĖS;4763350308;Ne;0;0;5;5
17502;Žirmūnėliai;SAULUTĖS;5626711530;Ne;0;8;0;8
17503;Žirmūnėliai;SAULUTĖS;3902161368;Ne;0;1;0;1
17504;Žirmūnėliai;SAULUTĖS;4338673048;Ne;2;0;0;2
17505;Žirmūnėliai;SAULUTĖS;4793967980;Ne;0;1;0;1
17506;Žirmūnėliai;SAULUTĖS;8242112212;Ne;0;2;4;6
17507;Žirmūnėliai;SAULUTĖS;1940552890;Ne;0;2;0;2
17508;Žirmūnėliai;SAULUTĖS;2392106040;Ne;3;1;0;4
17509;Žirmūnėliai;SAULUTĖS;9145626116;Ne;0;1;21;22
17510;Žirmūnėliai;SAULUTĖS;7675488865;Ne;6;5;0;11
17511;Žirmūnėliai;SAULUTĖS;8345632807;Ne;0;5;0;5
17512;Žirmūnėliai;SAULUTĖS;8592714547;Ne;0;6;0;6
17513;Žirmūnėliai;GILIUKAI;6430944858;Ne;0;9;4;13
17514;Žirmūnėliai;GILIUKAI;3562689670;Ne;0;4;0;4
17515;Žirmūnėliai;GILIUKAI;5929166560;Ne;0;2;4;6
17516;Žirmūnėliai;GILIUKAI;3767421827;Ne;0;7;2;9
17517;Žirmūnėliai;GILIUKAI;4327504033;Ne;0;3;0;3
17518;Žirmūnėliai;GILIUKAI;5104310002;Ne;0;15;0;15
17519;Žirmūnėliai;GILIUKAI;1025809131;Taip;0;3;0;3
17520;Žirmūnėliai;GILIUKAI;6899109664;Ne;0;12;0;12
17521;Žirmūnėliai;GILIUKAI;1473482823;Ne;0;10;0;10
17522;Žirmūnėliai;GILIUKAI;7410921362;Ne;0;2;0;2
17523;Žirmūnėliai;GILIUKAI;8627403283;Ne;0;0;1;1
17524;Žirmūnėliai;GILIUKAI;5089884149;Ne;0;0;1;1
17525;Žirmūnėliai;GILIUKAI;1791977446;Ne;7;2;1;10
17526;Žirmūnėliai;GILIUKAI;6875484657;Ne;0;5;2;7
17527;Žirmūnėliai;GILIUKAI;9871163622;Ne;0;0;1;1
17528;Žirmūnėliai;GILIUKAI;3532895278;Ne;0;5;2;7
17529;Žirmūnėliai;GILIUKAI;8459217612;Ne;0;7;1;8
17530;Žirmūnėliai;GILIUKAI;2959090234;Ne;3;1;3;7
17531;Žirmūnėliai;GILIUKAI;5486475468;Ne;0;0;2;2
17532;Žirmūnėliai;GILIUKAI;8618410295;Ne;7;7;7;21
17533;Žirmūnėliai;GILIUKAI;1941509002;Ne;7;5;11;23
17534;Žirmūnėliai;DRUGELIAI;4218266688;Ne;0;0;2;2
17535;Žirmūnėliai;DRUGELIAI;5736502380;Ne;0;1;0;1
17536;Žirmūnėliai;DRUGELIAI;9378860669;Ne;0;3;0;3
17537;Žirmūnėliai;DRUGELIAI;8607934394;Ne;0;1;0;1
17538;Žirmūnėliai;DRUGELIAI;5723289396;Ne;0;2;1;3
17539;Žirmūnėliai;DRUGELIAI;7892626521;Ne;0;7;0;7
17540;Žirmūnėliai;DRUGELIAI;8999160836;Ne;0;1;0;1
17541;Žirmūnėliai;DRUGELIAI;8209309240;Ne;0;1;0;1
17542;Žirmūnėliai;DRUGELIAI;2837129621;Ne;0;7;0;7
17543;Žirmūnėliai;DRUGELIAI;1273684243;Ne;0;0;4;4
17544;Žirmūnėliai;DRUGELIAI;2971175236;Ne;0;1;0;1
17545;Žirmūnėliai;DRUGELIAI;6594728970;Ne;0;1;0;1
17546;Žirmūnėliai;DRUGELIAI;7422544482;Ne;0;1;3;4
17547;Žirmūnėliai;DRUGELIAI;9241738140;Ne;0;7;0;7
17548;Žirmūnėliai;DRUGELIAI;4778339658;Ne;0;4;0;4
17549;Žirmūnėliai;BORUŽIUKAI;52420072025;Ne;0;0;2;2
17550;Žirmūnėliai;BORUŽIUKAI;4796654075;Ne;2;0;2;4
17551;Žirmūnėliai;BORUŽIUKAI;1234956674;Ne;0;2;0;2
17552;Žirmūnėliai;BORUŽIUKAI;2739395691;Ne;0;6;0;6
17553;Žirmūnėliai;BORUŽIUKAI;3351861764;Ne;0;11;0;11
17554;Žirmūnėliai;BORUŽIUKAI;5611315994;Ne;0;11;0;11
17555;Žirmūnėliai;BORUŽIUKAI;7528704460;Ne;0;11;0;11
17556;Žirmūnėliai;BORUŽIUKAI;1618573494;Ne;10;2;0;12
17557;Žirmūnėliai;BORUŽIUKAI;31403739893;Ne;0;1;3;4
17558;Žirmūnėliai;BORUŽIUKAI;6647641423;Ne;4;0;0;4
17559;Žirmūnėliai;BORUŽIUKAI;5367009184;Ne;0;2;2;4
17560;Žirmūnėliai;BORUŽIUKAI;8623037038;Ne;0;5;0;5
17561;Žirmūnėliai;BORUŽIUKAI;3540307559;Ne;0;10;0;10
17562;Žirmūnėliai;BORUŽIUKAI;1865240339;Ne;12;2;1;15
17563;Žirmūnėliai;BORUŽIUKAI;5209700153;Ne;0;1;0;1
17564;Žirmūnėliai;BORUŽIUKAI;2033271165;Ne;0;1;1;2
17565;Žirmūnėliai;EŽIUKAI;7011701994;Ne;0;2;0;2
17566;Žirmūnėliai;EŽIUKAI;2661052835;Ne;0;5;0;5
17567;Žirmūnėliai;EŽIUKAI;1655437833;Ne;0;0;1;1
17568;Žirmūnėliai;EŽIUKAI;3640979388;Ne;2;2;0;4
17569;Žirmūnėliai;EŽIUKAI;6878528100;Ne;0;2;3;5
17570;Žirmūnėliai;EŽIUKAI;8440187348;Ne;10;4;0;14
17571;Žirmūnėliai;EŽIUKAI;4565479092;Ne;0;2;0;2
17572;Žirmūnėliai;EŽIUKAI;4968278870;Ne;5;7;2;14
17573;Žirmūnėliai;EŽIUKAI;2693415717;Ne;0;1;0;1
17574;Žirmūnėliai;EŽIUKAI;7953019230;Ne;0;15;0;15
17575;Žirmūnėliai;EŽIUKAI;1832367936;Ne;0;0;3;3
17576;Žirmūnėliai;EŽIUKAI;3180116136;Ne;5;0;0;5
17577;Žirmūnėliai;EŽIUKAI;9759491055;Ne;10;3;0;13
17578;Žirmūnėliai;EŽIUKAI;1127214387;Ne;9;2;3;14
17579;Žirmūnėliai;EŽIUKAI;4101748829;Ne;12;1;0;13
17580;Žirmūnėliai;EŽIUKAI;2379638934;Ne;0;28;0;28
17581;Žirmūnėliai;EŽIUKAI;6448582622;Ne;5;0;0;5
17582;Žirmūnėliai;EŽIUKAI;4710829908;Ne;0;11;0;11
17583;Žirmūnėliai;EŽIUKAI;7996709950;Ne;0;3;0;3
17584;Žirmūnėliai;EŽIUKAI;7580002502;Ne;7;0;2;9
17585;Žirmūnėliai;EŽIUKAI;4638575301;Ne;0;1;0;1
17586;Žirmūnėliai;EŽIUKAI;3310847619;Ne;0;0;4;4
17587;Žirmūnėliai;EŽIUKAI;1977798059;Ne;0;6;17;23
17588;Žirmūnėliai;ŽVIRBLIUKAI;6896145409;Ne;6;2;2;10
17589;Žirmūnėliai;ŽVIRBLIUKAI;8030469722;Ne;15;6;0;21
17590;Žirmūnėliai;ŽVIRBLIUKAI;4517290068;Ne;2;5;0;7
17591;Žirmūnėliai;ŽVIRBLIUKAI;1582563837;Ne;0;2;1;3
17592;Žirmūnėliai;ŽVIRBLIUKAI;1381923106;Ne;0;2;1;3
17593;Žirmūnėliai;ŽVIRBLIUKAI;1725143117;Ne;2;0;5;7
17594;Žirmūnėliai;ŽVIRBLIUKAI;5037669167;Ne;7;2;1;10
17595;Žirmūnėliai;ŽVIRBLIUKAI;1073135587;Ne;0;9;0;9
17596;Žirmūnėliai;ŽVIRBLIUKAI;4598761492;Ne;0;1;0;1
17597;Žirmūnėliai;ŽVIRBLIUKAI;1435743911;Ne;8;0;0;8
17598;Žirmūnėliai;ŽVIRBLIUKAI;2007790746;Ne;1;1;0;2
17599;Žirmūnėliai;ŽVIRBLIUKAI;8308074932;Ne;0;2;3;5
17600;Žirmūnėliai;ŽVIRBLIUKAI;1761284228;Ne;8;2;4;14
17601;Žirmūnėliai;ŽVIRBLIUKAI;41018224936;Ne;4;2;1;7
17602;Žirmūnėliai;ŽVIRBLIUKAI;1894070647;Ne;0;2;4;6
17603;Žirmūnėliai;SPALVELĖS;4815427530;Ne;6;0;0;6
17604;Žirmūnėliai;SPALVELĖS;6641667315;Ne;0;4;1;5
17605;Žirmūnėliai;SPALVELĖS;9936156579;Taip;0;1;0;1
17606;Žirmūnėliai;SPALVELĖS;2985092368;Ne;2;2;3;7
17607;Žirmūnėliai;SPALVELĖS;5154076629;Ne;0;1;0;1
17608;Žirmūnėliai;SPALVELĖS;1401001989;Ne;7;4;0;11
17609;Žirmūnėliai;SPALVELĖS;2841958534;Ne;0;6;0;6
17610;Žirmūnėliai;SPALVELĖS;6259368139;Ne;0;3;0;3
17611;Žirmūnėliai;SPALVELĖS;1356219744;Ne;0;14;0;14
17612;Žirmūnėliai;SPALVELĖS;8538773532;Ne;0;2;0;2
17613;Žirmūnėliai;SPALVELĖS;6934204209;Ne;10;0;2;12
17614;Žirmūnėliai;SPALVELĖS;3458810185;Ne;5;0;0;5
17615;Žirmūnėliai;SPALVELĖS;9306935083;Ne;0;10;0;10
17616;Žirmūnėliai;SPALVELĖS;5316869112;Ne;0;0;1;1
17617;Žirmūnėliai;SPALVELĖS;4807331877;Ne;2;0;2;4
17618;Žirmūnėliai;SPALVELĖS;8742911909;Ne;0;11;0;11
17619;Žirmūnėliai;SPALVELĖS;6817236579;Ne;8;0;0;8
17620;Žirmūnėliai;SPALVELĖS;9042509512;Ne;15;5;0;20
17621;Žirmūnėliai;SPALVELĖS;5076712824;Ne;3;3;0;6
17622;Žirmūnėliai;SPALVELĖS;8444883234;Ne;0;2;0;2
17623;Žirmūnėliai;DEBESĖLIAI;6908512961;Ne;0;11;0;11
17624;Žirmūnėliai;DEBESĖLIAI;1571242696;Ne;3;3;0;6
17625;Žirmūnėliai;DEBESĖLIAI;3431320961;Ne;0;6;0;6
17626;Žirmūnėliai;DEBESĖLIAI;7087770068;Ne;0;8;0;8
17627;Žirmūnėliai;DEBESĖLIAI;4347548125;Ne;12;0;0;12
17628;Žirmūnėliai;DEBESĖLIAI;3330603362;Ne;5;0;2;7
17629;Žirmūnėliai;DEBESĖLIAI;5440814849;Ne;0;2;0;2
17630;Žirmūnėliai;DEBESĖLIAI;7680479258;Ne;0;0;4;4
17631;Žirmūnėliai;DEBESĖLIAI;8136265008;Ne;1;19;0;20
17632;Žirmūnėliai;DEBESĖLIAI;7568228423;Ne;0;0;2;2
17633;Žirmūnėliai;DEBESĖLIAI;9813507899;Ne;7;0;4;11
17634;Žirmūnėliai;DEBESĖLIAI;8687642039;Ne;0;0;4;4
17635;Žirmūnėliai;DEBESĖLIAI;5982848146;Ne;9;0;0;9
17636;Žirmūnėliai;DEBESĖLIAI;3646039695;Ne;4;2;0;6
17637;Žirmūnėliai;DEBESĖLIAI;4653124134;Ne;5;5;0;10
17638;Žirmūnėliai;DEBESĖLIAI;4501490189;Ne;12;6;0;18
17639;Žirmūnėliai;DEBESĖLIAI;8239982682;Ne;0;0;1;1
17640;Žirmūnėliai;VIŠČIUKAI;2802717644;Ne;6;0;0;6
17641;Žirmūnėliai;VIŠČIUKAI;3029428022;Ne;9;0;1;10
17642;Žirmūnėliai;VIŠČIUKAI;9759504463;Ne;8;0;0;8
17643;Žirmūnėliai;VIŠČIUKAI;4134541560;Ne;11;0;0;11
17644;Žirmūnėliai;VIŠČIUKAI;8481357052;Ne;9;0;0;9
17645;Žirmūnėliai;VIŠČIUKAI;6892941066;Ne;3;8;2;13
17646;Žirmūnėliai;VIŠČIUKAI;9858198555;Ne;5;2;0;7
17647;Žirmūnėliai;VIŠČIUKAI;3641319043;Ne;7;2;1;10
17648;Žirmūnėliai;VIŠČIUKAI;6523502376;Ne;16;0;0;16
17649;Žirmūnėliai;VIŠČIUKAI;9280663182;Ne;0;2;0;2
17650;Žirmūnėliai;VIŠČIUKAI;5281338626;Ne;7;2;0;9
17651;Žirmūnėliai;VIŠČIUKAI;9688006040;Ne;22;0;0;22
17652;Žirmūnėliai;VIŠČIUKAI;5622319185;Ne;16;0;0;16
17653;Žirmūnėliai;VIŠČIUKAI;7053321410;Ne;9;0;1;10
17654;Žirmūnėliai;ZUIKUČIŲ;4291114238;Ne;0;1;0;1
17655;Žirmūnėliai;ZUIKUČIŲ;4836165731;Ne;4;0;0;4
17656;Žirmūnėliai;ZUIKUČIŲ;3762889366;Ne;1;3;0;4
17657;Žirmūnėliai;ZUIKUČIŲ;3977279181;Ne;6;0;0;6
17658;Žirmūnėliai;ZUIKUČIŲ;8002655555;Ne;0;14;0;14
17659;Žirmūnėliai;ZUIKUČIŲ;2736632324;Ne;0;2;2;4
17660;Žirmūnėliai;ZUIKUČIŲ;5892153807;Ne;0;2;4;6
17661;Žirmūnėliai;ZUIKUČIŲ;2870069039;Ne;0;1;0;1
17662;Žirmūnėliai;ZUIKUČIŲ;8271996884;Ne;0;5;0;5
17663;Žirmūnėliai;ZUIKUČIŲ;3012945005;Ne;2;0;0;2
17664;Žirmūnėliai;ZUIKUČIŲ;8782085662;Ne;0;2;2;4
17665;Žirmūnėliai;ZUIKUČIŲ;3174613910;Ne;0;1;0;1
17666;Žirmūnėliai;ZUIKUČIŲ;5668266601;Ne;4;0;0;4
17667;Žirmūnėliai;ZUIKUČIŲ;9472372819;Ne;2;1;0;3
17668;Žirmūnėliai;ZUIKUČIŲ;6812682361;Ne;0;0;4;4
17669;Žirmūnėliai;OBUOLIUKAI;4575123456;Ne;0;7;0;7
17670;Žirmūnėliai;OBUOLIUKAI;3795476732;Ne;5;0;1;6
17671;Žirmūnėliai;OBUOLIUKAI;1917500190;Ne;5;2;0;7
17672;Žirmūnėliai;OBUOLIUKAI;9002868728;Ne;0;2;2;4
17673;Žirmūnėliai;OBUOLIUKAI;2073922023;Ne;2;0;0;2
17674;Žirmūnėliai;OBUOLIUKAI;7059249540;Ne;6;6;0;12
17675;Žirmūnėliai;OBUOLIUKAI;4999561481;Ne;0;1;0;1
17676;Žirmūnėliai;OBUOLIUKAI;6358006462;Ne;0;7;0;7
17677;Žirmūnėliai;OBUOLIUKAI;2497258407;Ne;12;2;0;14
17678;Žirmūnėliai;OBUOLIUKAI;3949374730;Ne;7;1;0;8
17679;Žirmūnėliai;OBUOLIUKAI;6869102228;Ne;0;4;0;4
17680;Žirmūnėliai;OBUOLIUKAI;9367849317;Ne;0;10;0;10
17681;Žirmūnėliai;OBUOLIUKAI;9892620134;Ne;0;0;3;3
17682;Žirmūnėliai;OBUOLIUKAI;6450412481;Ne;0;1;0;1
17683;Žirmūnėliai;OBUOLIUKAI;1523231731;Ne;0;3;0;3
17684;Žirmūnėliai;OBUOLIUKAI;9225654910;Ne;0;8;0;8
17685;Žirmūnėliai;OBUOLIUKAI;5483418311;Ne;0;1;0;1
17686;Žirmūnėliai;OBUOLIUKAI;8823426998;Ne;0;1;0;1
17687;Žirmūnėliai;OBUOLIUKAI;2263820829;Ne;3;1;2;6
17688;Žirmūnėliai;OBUOLIUKAI;9732291476;Ne;0;1;1;2
17689;Žirmūnėliai;DAINORĖLIAI;1255294064;Ne;7;5;0;12
17690;Žirmūnėliai;DAINORĖLIAI;5616289290;Ne;8;15;0;23
17691;Žirmūnėliai;DAINORĖLIAI;3520677404;Ne;0;10;0;10
17692;Žirmūnėliai;DAINORĖLIAI;9978718231;Ne;0;7;0;7
17693;Žirmūnėliai;DAINORĖLIAI;6066212109;Ne;5;0;0;5
17694;Žirmūnėliai;DAINORĖLIAI;7589155099;Ne;2;0;0;2
17695;Žirmūnėliai;DAINORĖLIAI;4641264260;Ne;5;1;0;6
17696;Žirmūnėliai;DAINORĖLIAI;1724203157;Ne;0;0;3;3
17697;Žirmūnėliai;DAINORĖLIAI;5646794795;Ne;0;3;9;12
17698;Žirmūnėliai;DAINORĖLIAI;9908958250;Ne;0;9;0;9
17699;Žirmūnėliai;DAINORĖLIAI;1116572386;Ne;0;2;0;2
17700;Žirmūnėliai;DAINORĖLIAI;8615363279;Ne;0;8;1;9
17701;"Dainorėliai (Ankštoji g. 11)";VARPELIAI;87242570532;Ne;4;0;0;4
17702;"Dainorėliai (Ankštoji g. 11)";VARPELIAI;6176171443;Ne;5;2;0;7
17703;"Dainorėliai (Ankštoji g. 11)";VARPELIAI;88781762328;Ne;8;0;0;8
17704;"Dainorėliai (Ankštoji g. 11)";VARPELIAI;5693385617;Ne;0;3;2;5
17705;"Dainorėliai (Ankštoji g. 11)";VARPELIAI;5959380807;Ne;7;0;0;7
17706;"Dainorėliai (Ankštoji g. 11)";VARPELIAI;2938732886;Ne;0;1;5;6
17707;"Dainorėliai (Ankštoji g. 11)";VARPELIAI;3183793211;Ne;0;1;5;6
17708;"Dainorėliai (Ankštoji g. 11)";VARPELIAI;65467351140;Ne;0;2;1;3
17709;"Dainorėliai (Ankštoji g. 11)";VARPELIAI;8521878734;Ne;9;0;0;9
17710;"Dainorėliai (Ankštoji g. 11)";VARPELIAI;4269946363;Ne;0;1;1;2
17711;"Dainorėliai (Ankštoji g. 11)";VARPELIAI;1088248393;Ne;0;0;2;2
17712;"Dainorėliai (Ankštoji g. 11)";VARPELIAI;2070086316;Ne;0;1;0;1
17713;"Dainorėliai (Ankštoji g. 11)";VARPELIAI;2074070030;Ne;0;0;5;5
17714;"Dainorėliai (Ankštoji g. 11)";VARPELIAI;4591161640;Ne;0;1;1;2
17715;"Dainorėliai (Ankštoji g. 11)";VARPELIAI;6898685834;Ne;5;0;1;6
17716;"Dainorėliai (Ankštoji g. 11)";VARPELIAI;6909583023;Ne;0;3;0;3
17717;"Dainorėliai (Ankštoji g. 11)";VARPELIAI;9319771186;Ne;0;0;8;8
17718;"Dainorėliai (Ankštoji g. 11)";VARPELIAI;68134437706;Ne;2;1;0;3
17719;"Dainorėliai (Ankštoji g. 11)";ŽIOGELIAI;5591598390;Ne;3;0;0;3
17720;"Dainorėliai (Ankštoji g. 11)";ŽIOGELIAI;6481621329;Taip;3;2;1;6
17721;"Dainorėliai (Ankštoji g. 11)";ŽIOGELIAI;5715129088;Ne;4;0;2;6
17722;"Dainorėliai (Ankštoji g. 11)";ŽIOGELIAI;9132532505;Ne;0;1;0;1
17723;"Dainorėliai (Ankštoji g. 11)";ŽIOGELIAI;7591953671;Ne;0;0;12;12
17724;"Dainorėliai (Ankštoji g. 11)";ŽIOGELIAI;6169434322;Ne;0;2;1;3
17725;"Dainorėliai (Ankštoji g. 11)";ŽIOGELIAI;6659114730;Ne;12;0;5;17
17726;"Dainorėliai (Ankštoji g. 11)";ŽIOGELIAI;3887433142;Ne;7;0;0;7
17727;"Dainorėliai (Ankštoji g. 11)";ŽIOGELIAI;2541781620;Ne;0;2;1;3
17728;"Dainorėliai (Ankštoji g. 11)";ŽIOGELIAI;8239000041;Ne;0;5;0;5
17729;"Dainorėliai (Ankštoji g. 11)";ŽIOGELIAI;7984447187;Ne;0;0;2;2
17730;"Dainorėliai (Ankštoji g. 11)";ŽIOGELIAI;3897725337;Ne;4;0;0;4
17731;"Dainorėliai (Ankštoji g. 11)";ŽIOGELIAI;4307634491;Ne;2;0;0;2
17732;"Dainorėliai (Ankštoji g. 11)";ŽIOGELIAI;3598951899;Ne;6;0;0;6
17733;"Dainorėliai (Ankštoji g. 11)";ŽIOGELIAI;4973241539;Ne;11;0;1;12
17734;"Dainorėliai (Ankštoji g. 11)";ŽIOGELIAI;3592770633;Ne;3;0;0;3
17735;"Dainorėliai (Ankštoji g. 11)";ŽIOGELIAI;4969782237;Ne;0;1;0;1
17736;"Dainorėliai (Ankštoji g. 11)";DRUGELIAI;9592384914;Ne;7;0;4;11
17737;"Dainorėliai (Ankštoji g. 11)";DRUGELIAI;6403389248;Ne;0;1;0;1
17738;"Dainorėliai (Ankštoji g. 11)";DRUGELIAI;4900234806;Ne;1;0;0;1
17739;"Dainorėliai (Ankštoji g. 11)";DRUGELIAI;8962657389;Ne;0;2;0;2
17740;"Dainorėliai (Ankštoji g. 11)";DRUGELIAI;2703267758;Ne;7;0;0;7
17741;"Dainorėliai (Ankštoji g. 11)";DRUGELIAI;6899629612;Ne;10;1;0;11
17742;"Dainorėliai (Ankštoji g. 11)";DRUGELIAI;2605119306;Ne;0;1;0;1
17743;"Dainorėliai (Ankštoji g. 11)";DRUGELIAI;9976869100;Ne;0;8;0;8
17744;"Dainorėliai (Ankštoji g. 11)";DRUGELIAI;3063825996;Ne;0;1;0;1
17745;"Dainorėliai (Ankštoji g. 11)";DRUGELIAI;9303046800;Ne;4;0;0;4
17746;"Dainorėliai (Ankštoji g. 11)";DRUGELIAI;5854379630;Ne;0;2;0;2
17747;"Dainorėliai (Ankštoji g. 11)";DRUGELIAI;3711954197;Ne;8;0;0;8
17748;"Dainorėliai (Ankštoji g. 11)";DRUGELIAI;3573324654;Ne;0;2;0;2
17749;"Dainorėliai (Ankštoji g. 11)";DRUGELIAI;3741337791;Ne;0;1;0;1
17750;"Dainorėliai (Ankštoji g. 11)";DRUGELIAI;8088948564;Ne;4;0;0;4
17751;"Dainorėliai (Ankštoji g. 11)";DRUGELIAI;1718576253;Ne;17;1;0;18
17752;"Dainorėliai (Ankštoji g. 11)";DRUGELIAI;2803571247;Ne;3;2;2;7
17753;"Dainorėliai (Ankštoji g. 11)";DRUGELIAI;5084474142;Ne;0;7;0;7
17754;"Dainorėliai (Ankštoji g. 11)";DRUGELIAI;1332165159;Ne;17;2;0;19
17755;"Dainorėliai (Ankštoji g. 11)";DRUGELIAI;8684975630;Ne;0;8;0;8
17756;"Dainorėliai (Ankštoji g. 11)";DRUGELIAI;2740773904;Ne;5;0;0;5
17757;"Dainorėliai (Ankštoji g. 11)";DRUGELIAI;6460217912;Ne;5;7;0;12
17758;"Dainorėliai (Ankštoji g. 11)";"1 klasė";1626877066;Ne;1;0;0;1
17759;"Dainorėliai (Ankštoji g. 11)";"1 klasė";73386013083;Ne;7;0;0;7
17760;"Dainorėliai (Ankštoji g. 11)";"1 klasė";53935690864;Ne;5;0;0;5
17761;"Dainorėliai (Ankštoji g. 11)";"1 klasė";6411939690;Ne;5;0;0;5
17762;"Dainorėliai (Ankštoji g. 11)";"1 klasė";2287353933;Ne;15;0;0;15
17763;"Dainorėliai (Ankštoji g. 11)";"1 klasė";5479496104;Ne;1;0;0;1
17764;"Dainorėliai (Ankštoji g. 11)";"1 klasė";6404337541;Ne;1;0;0;1
17765;"Dainorėliai (Ankštoji g. 11)";"1 klasė";86187568203;Ne;4;0;0;4
17766;"Dainorėliai (Ankštoji g. 11)";"1 klasė";1015870220;Ne;1;0;0;1
17767;"Dainorėliai (Ankštoji g. 11)";"1 klasė";7114409929;Ne;1;0;0;1
17768;"Dainorėliai (Ankštoji g. 11)";"1 klasė";1120848949;Ne;1;0;0;1
17769;"Dainorėliai (Ankštoji g. 11)";"2 klasė";7569146994;Ne;6;0;0;6
17770;"Dainorėliai (Ankštoji g. 11)";"2 klasė";58071607976;Ne;7;0;0;7
17771;"Dainorėliai (Ankštoji g. 11)";"2 klasė";63211091321;Ne;5;0;0;5
17772;"Dainorėliai (Ankštoji g. 11)";"2 klasė";80499999855;Ne;1;0;0;1
17773;"Dainorėliai (Ankštoji g. 11)";"2 klasė";2531690903;Ne;5;0;0;5
17774;"Dainorėliai (Ankštoji g. 11)";"2 klasė";1121139222;Ne;3;0;0;3
17775;"Dainorėliai (Ankštoji g. 11)";"3 klasė";2045625141;Ne;5;0;0;5
17776;"Dainorėliai (Ankštoji g. 11)";"3 klasė";34219208558;Ne;3;0;0;3
17777;"Dainorėliai (Ankštoji g. 11)";"3 klasė";13138644060;Ne;1;0;0;1
17778;"Dainorėliai (Ankštoji g. 11)";"3 klasė";2441164154;Ne;2;0;0;2
17779;"Dainorėliai (Ankštoji g. 11)";"3 klasė";8244355193;Ne;2;0;0;2
17780;"Dainorėliai (Ankštoji g. 11)";"3 klasė";2142553899;Ne;1;0;0;1
17781;"Dainorėliai (Ankštoji g. 11)";"3 klasė";37660372564;Ne;1;0;0;1
17782;"Dainorėliai (Ankštoji g. 11)";"3 klasė";98830139164;Ne;2;0;0;2
17783;"Dainorėliai (Ankštoji g. 11)";"3 klasė";47323045857;Ne;3;0;0;3
17784;"Dainorėliai (Ankštoji g. 11)";"3 klasė";65118883315;Ne;2;0;0;2
17785;"Dainorėliai (Ankštoji g. 11)";"3 klasė";1209781483;Ne;5;0;0;5
17786;"Dainorėliai (Ankštoji g. 11)";"4 klasė";29726515194;Ne;3;0;0;3
17787;"Dainorėliai (Ankštoji g. 11)";"4 klasė";19292860218;Ne;1;0;0;1
17788;"Dainorėliai (Ankštoji g. 11)";"4 klasė";93738984644;Ne;2;0;0;2
17789;"Dainorėliai (Ankštoji g. 11)";"4 klasė";24048489264;Ne;2;0;0;2
17790;"Dainorėliai (Ankštoji g. 11)";"4 klasė";4773358825;Ne;1;0;0;1
17791;"Dainorėliai (Ankštoji g. 11)";"4 klasė";23144978287;Ne;1;0;0;1
17792;"Dainorėliai (Ankštoji g. 11)";"4 klasė";6203511535;Ne;2;0;0;2
17793;"Dainorėliai (Ankštoji g. 11)";"4 klasė";3018657993;Ne;3;0;0;3
17794;"Dainorėliai (Ankštoji g. 11)";"4 klasė";57618865048;Ne;5;0;0;5
17795;"Dainorėliai (Ankštoji g. 11)";"4 klasė";26315465923;Ne;1;2;0;3
17796;"Dainorėliai (Ankštoji g. 11)";SAULUTĖS;9130473411;Ne;2;0;1;3
17797;"Dainorėliai (Ankštoji g. 11)";SAULUTĖS;8857018998;Ne;0;2;0;2
17798;"Dainorėliai (Ankštoji g. 11)";SAULUTĖS;6704354150;Ne;0;6;0;6
17799;"Dainorėliai (Ankštoji g. 11)";SAULUTĖS;5632663846;Ne;2;1;1;4
17800;"Dainorėliai (Ankštoji g. 11)";SAULUTĖS;4307591123;Ne;0;7;0;7
17801;"Dainorėliai (Ankštoji g. 11)";SAULUTĖS;6385439136;Ne;0;3;0;3
17802;"Dainorėliai (Ankštoji g. 11)";SAULUTĖS;1552829080;Ne;0;3;0;3
17803;"Dainorėliai (Ankštoji g. 11)";SAULUTĖS;5410183494;Ne;4;0;0;4
17804;"Dainorėliai (Ankštoji g. 11)";SAULUTĖS;5587907483;Ne;5;2;2;9
17805;"Dainorėliai (Ankštoji g. 11)";SAULUTĖS;2064843848;Ne;0;2;0;2
17806;"Dainorėliai (Ankštoji g. 11)";SAULUTĖS;7804441689;Ne;1;0;0;1
17807;"Dainorėliai (Ankštoji g. 11)";SAULUTĖS;6090746954;Ne;0;4;0;4
17808;"Dainorėliai (Ankštoji g. 11)";SAULUTĖS;5102030168;Ne;0;5;0;5
17809;"Dainorėliai (Ankštoji g. 11)";SAULUTĖS;4798415786;Ne;0;3;0;3
17810;"Dainorėliai (Ankštoji g. 11)";SAULUTĖS;7118473669;Ne;5;10;0;15
17811;"Dainorėliai (Ankštoji g. 11)";SAULUTĖS;4431804759;Ne;0;2;0;2
17812;"Dainorėliai (Ankštoji g. 11)";SAULUTĖS;6697149560;Ne;0;5;0;5
17813;"Dainorėliai (Ankštoji g. 11)";SAULUTĖS;3762178533;Ne;1;2;0;3
17814;Lokiukas;BITUTĖS;3329205450;Ne;6;0;2;8
17815;Lokiukas;BITUTĖS;7920238202;Ne;0;5;3;8
17816;Lokiukas;BITUTĖS;1376124245;Ne;0;22;0;22
17817;Lokiukas;BITUTĖS;2181315008;Ne;18;0;0;18
17818;Lokiukas;BITUTĖS;3896883842;Ne;22;0;0;22
17819;Lokiukas;BITUTĖS;8656751314;Ne;0;0;10;10
17820;Lokiukas;BITUTĖS;4551069961;Ne;0;0;4;4
17821;Lokiukas;BITUTĖS;5794303981;Ne;0;0;6;6
17822;Lokiukas;BITUTĖS;2671053309;Taip;4;0;2;6
17823;Lokiukas;BITUTĖS;5217458476;Ne;0;0;2;2
17824;Lokiukas;BITUTĖS;6883994020;Ne;8;0;3;11
17825;Lokiukas;BITUTĖS;1647778939;Ne;0;0;2;2
17826;Lokiukas;BITUTĖS;9480025132;Ne;0;0;4;4
17827;Lokiukas;BITUTĖS;6260486656;Ne;0;6;0;6
17828;Lokiukas;BITUTĖS;8334800302;Ne;0;0;1;1
17829;Lokiukas;BITUTĖS;1987485885;Ne;7;0;0;7
17830;Lokiukas;BITUTĖS;8378138411;Ne;5;0;1;6
17831;Lokiukas;"1 B klasė";14605095801;Ne;1;0;0;1
17832;Lokiukas;"1 B klasė";8036643654;Ne;1;0;0;1
17833;Lokiukas;"1 B klasė";5879386524;Ne;1;0;0;1
17834;Lokiukas;"1 B klasė";9625041533;Ne;1;0;0;1
17835;Lokiukas;"1 B klasė";2476231041;Ne;7;0;0;7
17836;Lokiukas;"1 B klasė";2548712970;Ne;1;0;0;1
17837;Lokiukas;"1 B klasė";1570438208;Ne;22;0;0;22
17838;Lokiukas;"1 B klasė";2673522432;Ne;22;0;0;22
17839;Lokiukas;"1 B klasė";47399326083;Ne;1;0;0;1
17840;Lokiukas;"1 B klasė";7591418969;Ne;1;0;0;1
17841;Lokiukas;"1 B klasė";4569798381;Ne;22;0;0;22
17842;Lokiukas;"1 B klasė";8399364170;Ne;2;0;0;2
17843;Lokiukas;"1 B klasė";97284171512;Ne;4;0;0;4
17844;Lokiukas;"1 B klasė";5943583254;Ne;6;0;0;6
17845;Lokiukas;"1 B klasė";3070998871;Ne;1;0;0;1
17846;Lokiukas;"1 B klasė";5453470660;Ne;2;0;0;2
17847;Lokiukas;"1 B klasė";4427448272;Ne;22;0;0;22
17848;Lokiukas;"1 B klasė";20659573470;Ne;22;0;0;22
17849;Lokiukas;"1 B klasė";5437008837;Ne;1;0;0;1
17850;Lokiukas;"1 B klasė";4580716838;Ne;3;0;0;3
17851;Lokiukas;"1 B klasė";39975872119;Ne;1;0;0;1
17852;Lokiukas;"1 B klasė";8568285232;Ne;3;0;0;3
17853;Lokiukas;"1 B klasė";9501202273;Ne;2;0;0;2
17854;Lokiukas;"1 B klasė";8943496964;Ne;22;0;0;22
17855;Lokiukas;"1 A klasė";56069293343;Ne;12;0;0;12
17856;Lokiukas;"1 A klasė";69364831994;Ne;4;0;0;4
17857;Lokiukas;"1 A klasė";1230490562;Ne;5;0;0;5
17858;Lokiukas;"1 A klasė";8452600632;Ne;3;0;0;3
17859;Lokiukas;"1 A klasė";39222094073;Ne;3;0;0;3
17860;Lokiukas;"1 A klasė";74169282323;Ne;2;0;0;2
17861;Lokiukas;"1 A klasė";35890122494;Ne;2;0;0;2
17862;Lokiukas;"1 A klasė";1626698185;Ne;3;0;0;3
17863;Lokiukas;"1 A klasė";8455869600;Ne;2;0;0;2
17864;Lokiukas;"1 A klasė";1625137322;Ne;2;0;0;2
17865;Lokiukas;"1 A klasė";2170176922;Ne;5;0;0;5
17866;Lokiukas;"1 A klasė";8270572748;Ne;2;0;0;2
17867;Lokiukas;"1 A klasė";34800098950;Ne;3;0;0;3
17868;Lokiukas;"1 A klasė";3825101647;Ne;22;0;0;22
17869;Lokiukas;"1 A klasė";8618280811;Ne;22;0;0;22
17870;Lokiukas;"1 A klasė";8323172347;Ne;10;0;0;10
17871;Lokiukas;"1 A klasė";7844351275;Ne;5;0;0;5
17872;Lokiukas;"1 A klasė";2045735700;Ne;2;0;0;2
17873;Lokiukas;"1 A klasė";3981653153;Ne;2;0;0;2
17874;Lokiukas;"1 A klasė";6318538591;Ne;2;0;0;2
17875;Lokiukas;"1 A klasė";43500434912;Ne;6;0;0;6
17876;Lokiukas;"1 A klasė";25141529581;Ne;9;0;0;9
17877;Lokiukas;"1 A klasė";3369746590;Ne;3;0;0;3
17878;Lokiukas;"1 A klasė";3004895246;Ne;22;0;0;22
17879;Lokiukas;"1 A klasė";3061816821;Ne;2;0;0;2
17880;Lokiukas;"1 A klasė";4677444685;Ne;3;0;0;3
17881;Lokiukas;GUDRUČIAI;1604886863;Ne;0;0;1;1
17882;Lokiukas;GUDRUČIAI;3826815202;Ne;4;0;0;4
17883;Lokiukas;GUDRUČIAI;5446430319;Ne;0;0;1;1
17884;Lokiukas;GUDRUČIAI;5995034919;Ne;0;7;0;7
17885;Lokiukas;GUDRUČIAI;2354942164;Ne;9;1;0;10
17886;Lokiukas;GUDRUČIAI;1620856143;Ne;3;0;2;5
17887;Lokiukas;GUDRUČIAI;1733486244;Ne;0;0;2;2
17888;Lokiukas;GUDRUČIAI;3991821717;Ne;0;0;1;1
17889;Lokiukas;GUDRUČIAI;1606617694;Ne;0;5;0;5
17890;Lokiukas;GUDRUČIAI;8243342948;Ne;0;0;4;4
17891;Lokiukas;GUDRUČIAI;1210407640;Ne;0;3;0;3
17892;Lokiukas;BORUŽĖLĖS;2625981190;Ne;0;2;0;2
17893;Lokiukas;BORUŽĖLĖS;8576418875;Ne;0;20;0;20
17894;Lokiukas;BORUŽĖLĖS;6869785650;Ne;11;0;0;11
17895;Lokiukas;BORUŽĖLĖS;8630112458;Ne;0;8;0;8
17896;Lokiukas;BORUŽĖLĖS;3930463578;Ne;3;0;2;5
17897;Lokiukas;BORUŽĖLĖS;2660616022;Ne;0;1;0;1
17898;Lokiukas;BORUŽĖLĖS;9798351980;Ne;0;6;2;8
17899;Lokiukas;BORUŽĖLĖS;5401463671;Ne;0;3;0;3
17900;Lokiukas;BORUŽĖLĖS;9996442005;Ne;1;3;0;4
17901;Lokiukas;BORUŽĖLĖS;4317453894;Ne;4;0;0;4
17902;Lokiukas;BORUŽĖLĖS;1226376844;Ne;0;7;0;7
17903;Lokiukas;BORUŽĖLĖS;1724976098;Ne;6;5;0;11
17904;Lokiukas;BORUŽĖLĖS;7426579018;Ne;10;1;0;11
17905;Lokiukas;BORUŽĖLĖS;1974049743;Ne;2;4;0;6
17906;Lokiukas;BORUŽĖLĖS;3733581089;Ne;0;0;1;1
17907;Lokiukas;BORUŽĖLĖS;3876368364;Ne;12;1;0;13
17908;Lokiukas;BORUŽĖLĖS;9354491312;Ne;22;0;0;22
17909;Lokiukas;BORUŽĖLĖS;6091878190;Ne;0;2;0;2
17910;Lokiukas;BORUŽĖLĖS;1076719080;Ne;0;1;4;5
17911;Lokiukas;ANČIUKAI;5473316050;Ne;5;0;0;5
17912;Lokiukas;ANČIUKAI;5670185948;Ne;0;0;3;3
17913;Lokiukas;ANČIUKAI;5843699073;Ne;10;0;2;12
17914;Lokiukas;ANČIUKAI;8758248334;Ne;14;3;0;17
17915;Lokiukas;ANČIUKAI;3849212461;Ne;7;0;5;12
17916;Lokiukas;ANČIUKAI;1756658146;Ne;7;0;1;8
17917;Lokiukas;ANČIUKAI;3668903653;Ne;13;0;0;13
17918;Lokiukas;ANČIUKAI;7509043689;Ne;7;0;0;7
17919;Lokiukas;ANČIUKAI;9673257342;Ne;8;0;0;8
17920;Lokiukas;ANČIUKAI;2266747745;Ne;2;19;0;21
17921;Lokiukas;ANČIUKAI;4417116107;Ne;9;0;2;11
17922;Lokiukas;ANČIUKAI;5893844708;Ne;7;5;0;12
17923;Lokiukas;ANČIUKAI;3015119335;Ne;0;0;1;1
17924;Lokiukas;ANČIUKAI;1712365476;Taip;12;10;0;22
17925;Lokiukas;ANČIUKAI;6827710384;Ne;22;0;0;22
17926;Lokiukas;KODĖLČIUKAI;2642065594;Ne;0;8;0;8
17927;Lokiukas;KODĖLČIUKAI;5943412920;Ne;0;8;0;8
17928;Lokiukas;KODĖLČIUKAI;6758550653;Ne;5;0;4;9
17929;Lokiukas;KODĖLČIUKAI;6336140882;Ne;15;7;0;22
17930;Lokiukas;KODĖLČIUKAI;8796640190;Ne;0;2;1;3
17931;Lokiukas;KODĖLČIUKAI;8775608581;Ne;0;3;0;3
17932;Lokiukas;KODĖLČIUKAI;8915504279;Ne;0;1;0;1
17933;Lokiukas;KODĖLČIUKAI;3694653020;Ne;6;4;0;10
17934;Lokiukas;KODĖLČIUKAI;4060641736;Ne;7;2;0;9
17935;Lokiukas;KODĖLČIUKAI;1025576053;Ne;0;2;0;2
17936;Lokiukas;KODĖLČIUKAI;1040288021;Ne;0;5;3;8
17937;Lokiukas;KODĖLČIUKAI;7943213321;Ne;0;2;0;2
17938;Lokiukas;KODĖLČIUKAI;6069516217;Ne;7;1;0;8
17939;Lokiukas;KODĖLČIUKAI;1752784666;Ne;0;1;0;1
17940;Lokiukas;KODĖLČIUKAI;4007839265;Ne;0;1;0;1
17941;Lokiukas;KODĖLČIUKAI;5467387832;Ne;3;6;0;9
17942;Lokiukas;KODĖLČIUKAI;9307491947;Ne;7;2;0;9
17943;Lokiukas;KODĖLČIUKAI;3744484616;Ne;0;5;0;5
17944;Lokiukas;KODĖLČIUKAI;8286358519;Ne;0;2;1;3
17945;Lokiukas;KODĖLČIUKAI;1886540733;Ne;0;1;0;1
17946;Lokiukas;KODĖLČIUKAI;8902619265;Ne;0;0;3;3
17947;Lokiukas;DRUGELIAI;1170293017;Ne;0;11;0;11
17948;Lokiukas;DRUGELIAI;4442073527;Ne;0;1;0;1
17949;Lokiukas;DRUGELIAI;2021477393;Ne;0;3;0;3
17950;Lokiukas;DRUGELIAI;4206181176;Ne;0;1;0;1
17951;Lokiukas;DRUGELIAI;7006828256;Ne;0;8;0;8
17952;Lokiukas;DRUGELIAI;7532603655;Ne;0;15;0;15
17953;Lokiukas;DRUGELIAI;8329540746;Ne;0;1;0;1
17954;Lokiukas;DRUGELIAI;2782818158;Ne;0;2;0;2
17955;Lokiukas;DRUGELIAI;4197547631;Ne;0;5;0;5
17956;Lokiukas;DRUGELIAI;8596706753;Ne;0;4;0;4
17957;Lokiukas;DRUGELIAI;2374601283;Ne;0;5;0;5
17958;Lokiukas;DRUGELIAI;7195184433;Ne;8;0;0;8
17959;Lokiukas;DRUGELIAI;4919744559;Ne;21;0;0;21
17960;Lokiukas;DRUGELIAI;6226281752;Ne;5;8;0;13
17961;Lokiukas;DRUGELIAI;1390586527;Ne;16;0;1;17
17962;Lokiukas;DRUGELIAI;8266708371;Ne;7;0;0;7
17963;Lokiukas;DRUGELIAI;2093224908;Ne;0;11;0;11
17964;Lokiukas;DRUGELIAI;1341265560;Ne;0;8;0;8
17965;Lokiukas;DRUGELIAI;5131662172;Ne;8;2;0;10
17966;Lokiukas;DRUGELIAI;1913742619;Ne;3;2;0;5
17967;Lokiukas;DRUGELIAI;4284574166;Ne;0;12;0;12
17968;Lokiukas;"2 A klasė";1201125655;Ne;8;0;0;8
17969;Lokiukas;"2 A klasė";2502465398;Ne;2;0;0;2
17970;Lokiukas;"2 A klasė";67133709394;Ne;4;0;0;4
17971;Lokiukas;"2 A klasė";4989577303;Ne;12;0;0;12
17972;Lokiukas;"2 A klasė";73696992182;Ne;3;0;0;3
17973;Lokiukas;"2 A klasė";1056075876;Ne;2;0;0;2
17974;Lokiukas;"2 A klasė";9890308887;Ne;4;0;0;4
17975;Lokiukas;"2 A klasė";82025637099;Ne;9;0;0;9
17976;Lokiukas;"2 A klasė";8846527481;Ne;3;0;0;3
17977;Lokiukas;"2 A klasė";73515179103;Ne;6;0;0;6
17978;Lokiukas;"2 A klasė";36677665098;Ne;6;0;0;6
17979;Lokiukas;"2 A klasė";131300206;Ne;2;0;0;2
17980;Lokiukas;"2 A klasė";77512682081;Ne;3;0;0;3
17981;Lokiukas;"2 A klasė";66528256040;Ne;2;0;0;2
17982;Lokiukas;"2 A klasė";86120193313;Ne;4;0;0;4
17983;Lokiukas;"2 A klasė";45028887854;Ne;2;0;0;2
17984;Lokiukas;"2 A klasė";83528495608;Ne;3;0;0;3
17985;Lokiukas;"2 A klasė";51237034253;Ne;2;0;0;2
17986;Lokiukas;"2 A klasė";52940830874;Ne;5;0;0;5
17987;Lokiukas;"2 A klasė";8240261104;Ne;2;0;0;2
17988;Lokiukas;"2 A klasė";27403835292;Ne;2;0;0;2
17989;Lokiukas;"2 A klasė";5104259667;Ne;5;0;0;5
17990;Lokiukas;"2 A klasė";83086633109;Ne;8;0;0;8
17991;Lokiukas;"2 A klasė";38884246104;Ne;2;0;0;2
17992;Lokiukas;"2 B klasė";7235277422;Ne;8;0;0;8
17993;Lokiukas;"2 B klasė";1133294157;Ne;2;0;0;2
17994;Lokiukas;"2 B klasė";1072148409;Ne;2;0;0;2
17995;Lokiukas;"2 B klasė";92373834478;Ne;2;0;0;2
17996;Lokiukas;"2 B klasė";2054450461;Ne;4;0;0;4
17997;Lokiukas;"2 B klasė";3255141230;Ne;28;0;0;28
17998;Lokiukas;"2 B klasė";3255141230;Ne;28;0;0;28
17999;Lokiukas;"2 B klasė";14234831040;Ne;4;0;0;4
18000;Lokiukas;"2 B klasė";57505829630;Ne;2;0;0;2
18001;Lokiukas;"2 B klasė";7334971595;Ne;3;0;0;3
18002;Lokiukas;"2 B klasė";51059574159;Ne;22;0;0;22
18003;Lokiukas;"2 B klasė";4662981914;Ne;8;0;0;8
18004;Lokiukas;"2 B klasė";2959877846;Ne;22;0;0;22
18005;Lokiukas;"2 B klasė";6414861823;Ne;22;0;0;22
18006;Lokiukas;"2 B klasė";7130407913;Ne;22;0;0;22
18007;Lokiukas;"2 B klasė";98045145204;Ne;22;0;0;22
18008;Lokiukas;"2 B klasė";68390568000;Ne;6;0;0;6
18009;Lokiukas;"2 B klasė";8980902068;Ne;3;0;0;3
18010;Lokiukas;"2 B klasė";4164426360;Ne;3;0;0;3
18011;Lokiukas;"2 B klasė";14937983736;Ne;2;0;0;2
18012;Lokiukas;"2 B klasė";8996622650;Ne;3;0;0;3
18013;Lokiukas;"2 B klasė";61807094999;Ne;3;0;0;3
18014;Lokiukas;"2 B klasė";2078673522;Ne;4;0;0;4
18015;Lokiukas;"2 B klasė";40006848965;Ne;8;0;0;8
18016;Lokiukas;"2 B klasė";32714964224;Ne;4;0;0;4
18017;Lokiukas;"2 B klasė";8920359311;Ne;2;0;0;2
18018;Lokiukas;"2 B klasė";38001876942;Ne;2;0;0;2
18019;Lokiukas;"3 A klasė";25170045140;Ne;22;0;0;22
18020;Lokiukas;"3 A klasė";15406362908;Ne;5;0;0;5
18021;Lokiukas;"3 A klasė";45122233067;Ne;1;0;0;1
18022;Lokiukas;"3 A klasė";15685936471;Ne;3;0;0;3
18023;Lokiukas;"3 A klasė";10948160841;Ne;22;0;0;22
18024;Lokiukas;"3 A klasė";21802863853;Ne;3;0;0;3
18025;Lokiukas;"3 A klasė";29577495646;Ne;4;0;0;4
18026;Lokiukas;"3 A klasė";22979689191;Ne;3;0;0;3
18027;Lokiukas;"3 A klasė";80754592972;Ne;2;0;0;2
18028;Lokiukas;"3 A klasė";14903100496;Ne;2;0;0;2
18029;Lokiukas;"3 A klasė";97609897018;Ne;6;0;0;6
18030;Lokiukas;"3 A klasė";4608275224;Ne;5;0;0;5
18031;Lokiukas;"3 A klasė";99706061553;Ne;2;0;0;2
18032;Lokiukas;"3 A klasė";7785940412;Ne;1;0;0;1
18033;Lokiukas;"3 A klasė";24099693663;Ne;22;0;0;22
18034;Lokiukas;"3 A klasė";72092394330;Ne;2;0;0;2
18035;Lokiukas;"3 A klasė";35769782473;Ne;14;0;0;14
18036;Lokiukas;"3 A klasė";23688235312;Ne;1;0;0;1
18037;Lokiukas;"3 A klasė";43070670534;Ne;1;0;0;1
18038;Lokiukas;"3 A klasė";38531751377;Ne;4;0;0;4
18039;Lokiukas;"3 A klasė";15574258138;Ne;19;0;0;19
18040;Lokiukas;"3 A klasė";59840033826;Ne;3;0;0;3
18041;Lokiukas;"3 A klasė";24523198513;Ne;22;0;0;22
18042;Lokiukas;"3 A klasė";84273668685;Ne;2;0;0;2
18043;Lokiukas;"3 A klasė";9077016953;Ne;1;0;0;1
18044;Lokiukas;"3 A klasė";9747265775;Ne;22;0;0;22
18045;Lokiukas;"3 A klasė";5198408183;Ne;3;0;0;3
18046;Lokiukas;"3 A klasė";80793623068;Ne;6;0;0;6
18047;Lokiukas;"3 A klasė";93374754851;Ne;1;0;0;1
18048;Lokiukas;"3 B klasė";5311341721;Ne;22;0;0;22
18049;Lokiukas;"3 B klasė";61890775725;Ne;12;0;0;12
18050;Lokiukas;"3 B klasė";32506466236;Ne;5;0;0;5
18051;Lokiukas;"3 B klasė";24221829774;Ne;6;0;0;6
18052;Lokiukas;"3 B klasė";96046361641;Ne;3;0;0;3
18053;Lokiukas;"3 B klasė";7324496782;Ne;4;0;0;4
18054;Lokiukas;"3 B klasė";95910336503;Ne;22;0;0;22
18055;Lokiukas;"3 B klasė";58513885211;Ne;9;0;0;9
18056;Lokiukas;"3 B klasė";57958699478;Ne;2;0;0;2
18057;Lokiukas;"3 B klasė";10811780420;Ne;7;0;0;7
18058;Lokiukas;"3 B klasė";18646642032;Ne;2;0;0;2
18059;Lokiukas;"3 B klasė";79109699217;Ne;2;0;0;2
18060;Lokiukas;"3 B klasė";50713289266;Ne;22;0;0;22
18061;Lokiukas;"3 B klasė";20231469825;Ne;8;0;0;8
18062;Lokiukas;"3 B klasė";18336619115;Ne;3;0;0;3
18063;Lokiukas;"3 B klasė";2105377652;Ne;7;0;0;7
18064;Lokiukas;"3 B klasė";39867459515;Ne;4;0;0;4
18065;Lokiukas;"3 B klasė";1146878499;Ne;6;0;0;6
18066;Lokiukas;"3 B klasė";46587243900;Ne;2;0;0;2
18067;Lokiukas;"3 B klasė";62268017779;Ne;8;0;0;8
18068;Lokiukas;"3 B klasė";28796727185;Ne;22;0;0;22
18069;Lokiukas;"3 B klasė";88415635113;Ne;15;0;0;15
18070;Lokiukas;"3 B klasė";9141446821;Ne;6;0;0;6
18071;Lokiukas;"3 B klasė";7497324442;Ne;22;0;0;22
18072;Lokiukas;"3 B klasė";7903535850;Ne;5;0;0;5
18073;Lokiukas;"3 B klasė";75507005694;Ne;20;0;0;20
18074;Lokiukas;"3 B klasė";73426072972;Ne;15;0;0;15
18075;Lokiukas;"3 B klasė";59913848400;Ne;5;0;0;5
18076;Lokiukas;"3 B klasė";9516336072;Ne;3;0;0;3
18077;Lokiukas;"4 A klasė";67818191566;Ne;4;0;0;4
18078;Lokiukas;"4 A klasė";45280536946;Ne;22;0;0;22
18079;Lokiukas;"4 A klasė";53087036306;Ne;4;0;0;4
18080;Lokiukas;"4 A klasė";79223457439;Ne;4;0;0;4
18081;Lokiukas;"4 A klasė";75613665040;Ne;4;0;0;4
18082;Lokiukas;"4 A klasė";10240586503;Ne;22;0;0;22
18083;Lokiukas;"4 A klasė";86623153797;Ne;4;0;0;4
18084;Lokiukas;"4 A klasė";27050402360;Ne;4;0;0;4
18085;Lokiukas;"4 A klasė";43389930516;Ne;5;0;0;5
18086;Lokiukas;"4 A klasė";23222644824;Ne;5;0;0;5
18087;Lokiukas;"4 A klasė";52296454506;Ne;4;0;0;4
18088;Lokiukas;"4 A klasė";66999644935;Ne;22;0;0;22
18089;Lokiukas;"4 A klasė";72167964645;Ne;8;0;0;8
18090;Lokiukas;"4 A klasė";2143040924;Ne;22;0;0;22
18091;Lokiukas;"4 A klasė";3206276637;Ne;22;0;0;22
18092;Lokiukas;"4 A klasė";5775631777;Ne;3;0;0;3
18093;Lokiukas;"4 A klasė";3703002168;Ne;8;0;0;8
18094;Lokiukas;"4 A klasė";38636200254;Ne;4;0;0;4
18095;Lokiukas;"4 A klasė";47410036889;Ne;3;0;0;3
18096;Lokiukas;"4 A klasė";53544600623;Ne;4;0;0;4
18097;Lokiukas;"4 A klasė";6702448475;Ne;4;0;0;4
18098;Lokiukas;"4 A klasė";82966541165;Ne;9;0;0;9
18099;Lokiukas;"4 A klasė";42292408557;Ne;22;0;0;22
18100;Lokiukas;"4 B klasė";35018370441;Ne;2;0;0;2
18101;Lokiukas;"4 B klasė";60370754283;Ne;2;0;0;2
18102;Lokiukas;"4 B klasė";98289469398;Ne;3;0;0;3
18103;Lokiukas;"4 B klasė";15445053855;Ne;3;0;0;3
18104;Lokiukas;"4 B klasė";3262579895;Ne;2;0;0;2
18105;Lokiukas;"4 B klasė";51554951703;Ne;22;0;0;22
18106;Lokiukas;"4 B klasė";88947878548;Ne;3;0;0;3
18107;Lokiukas;"4 B klasė";29198900240;Ne;2;0;0;2
18108;Lokiukas;"4 B klasė";77441549037;Ne;4;0;0;4
18109;Lokiukas;"4 B klasė";79301547085;Ne;8;0;0;8
18110;Lokiukas;"4 B klasė";10897713744;Ne;3;0;0;3
18111;Lokiukas;"4 B klasė";16889795010;Ne;22;0;0;22
18112;Lokiukas;"4 B klasė";1424195731;Ne;22;0;0;22
18113;Lokiukas;"4 B klasė";1104333637;Ne;2;0;0;2
18114;Lokiukas;"4 B klasė";69089214980;Ne;2;0;0;2
18115;Lokiukas;"4 B klasė";69089214980;Ne;2;0;0;2
18116;Lokiukas;"4 B klasė";45735190114;Ne;22;0;0;22
18117;Lokiukas;"4 B klasė";2353550739;Ne;3;0;0;3
18118;Lokiukas;"4 B klasė";15004419516;Ne;2;0;0;2
18119;Lokiukas;"4 B klasė";2388111003;Ne;2;0;0;2
18120;Lokiukas;"4 B klasė";1245850082;Ne;22;0;0;22
18121;Lokiukas;"4 B klasė";5067673212;Ne;5;0;0;5
18122;Šaltinėlis;Ančiukų;3901200729;Ne;15;0;2;17
18123;Šaltinėlis;Ančiukų;1312785137;Ne;0;4;0;4
18124;Šaltinėlis;Ančiukų;9209105445;Ne;8;1;3;12
18125;Šaltinėlis;Ančiukų;9112527921;Ne;8;1;4;13
18126;Šaltinėlis;Ančiukų;2027779524;Ne;0;3;0;3
18127;Šaltinėlis;Ančiukų;5498764523;Ne;0;2;0;2
18128;Šaltinėlis;Ančiukų;4226929875;Ne;4;5;0;9
18129;Šaltinėlis;Ančiukų;1489377928;Ne;0;13;0;13
18130;Šaltinėlis;Ančiukų;5005394548;Ne;21;0;0;21
18131;Šaltinėlis;Ančiukų;1102861619;Taip;0;2;0;2
18132;Šaltinėlis;Ančiukų;1742421427;Ne;0;2;0;2
18133;Šaltinėlis;Ančiukų;9581384663;Ne;6;0;0;6
18134;Šaltinėlis;Ančiukų;9465174636;Ne;2;7;0;9
18135;Šaltinėlis;Ančiukų;5455997139;Ne;16;0;0;16
18136;Šaltinėlis;Ančiukų;9588260206;Ne;7;3;0;10
18137;Šaltinėlis;Ančiukų;8116985061;Ne;0;6;0;6
18138;Šaltinėlis;Bitučių;9983153464;Ne;11;2;0;13
18139;Šaltinėlis;Bitučių;6487378225;Ne;9;0;0;9
18140;Šaltinėlis;Bitučių;56396772538;Ne;0;3;0;3
18141;Šaltinėlis;Bitučių;5251390843;Ne;5;0;0;5
18142;Šaltinėlis;Bitučių;8500790262;Ne;8;0;0;8
18143;Šaltinėlis;Bitučių;4332884673;Ne;0;11;0;11
18144;Šaltinėlis;Bitučių;3493429067;Ne;0;1;0;1
18145;Šaltinėlis;Bitučių;9362495172;Ne;0;8;0;8
18146;Šaltinėlis;Bitučių;6462738640;Ne;0;1;0;1
18147;Šaltinėlis;Bitučių;77872075694;Ne;0;5;0;5
18148;Šaltinėlis;Bitučių;7133143923;Ne;0;7;0;7
18149;Šaltinėlis;Bitučių;6887838949;Ne;0;7;0;7
18150;Šaltinėlis;Bitučių;2630875135;Ne;10;0;0;10
18151;Šaltinėlis;Bitučių;9218883174;Ne;6;0;0;6
18152;Šaltinėlis;Bitučių;2973820849;Ne;6;3;0;9
18153;Šaltinėlis;Bitučių;9820788524;Ne;0;14;0;14
18154;Šaltinėlis;Bitučių;9769491789;Ne;0;3;0;3
18155;Šaltinėlis;Bitučių;9274165569;Ne;0;2;0;2
18156;Šaltinėlis;Bitučių;2084451705;Ne;9;0;0;9
18157;Šaltinėlis;Bitučių;8555517284;Ne;5;1;0;6
18158;Šaltinėlis;Bitučių;1543331408;Ne;0;1;0;1
18159;Šaltinėlis;Bitučių;7483928256;Ne;2;1;0;3
18160;Šaltinėlis;Bitučių;2646901307;Ne;12;2;0;14
18161;Šaltinėlis;Bitučių;7737797979;Ne;4;6;0;10
18162;Šaltinėlis;Bitučių;3017437426;Ne;0;4;0;4
18163;Šaltinėlis;Saulutės;7311831014;Ne;0;3;0;3
18164;Šaltinėlis;Saulutės;5854723120;Ne;0;6;0;6
18165;Šaltinėlis;Saulutės;5833136956;Ne;7;0;0;7
18166;Šaltinėlis;Saulutės;3483756240;Ne;5;9;0;14
18167;Šaltinėlis;Saulutės;6380346298;Ne;0;5;0;5
18168;Šaltinėlis;Saulutės;5799032398;Ne;7;9;0;16
18169;Šaltinėlis;Saulutės;5525740049;Ne;0;6;0;6
18170;Šaltinėlis;Saulutės;4743907195;Ne;12;0;0;12
18171;Šaltinėlis;Saulutės;5343279219;Ne;9;0;0;9
18172;Šaltinėlis;Saulutės;7118672118;Ne;4;0;0;4
18173;Šaltinėlis;Saulutės;2465009553;Ne;12;0;0;12
18174;Šaltinėlis;Saulutės;5345738219;Ne;11;1;0;12
18175;Šaltinėlis;Saulutės;6721510313;Ne;4;1;0;5
18176;Šaltinėlis;Saulutės;7650840990;Ne;11;1;0;12
18177;Šaltinėlis;Saulutės;1678450741;Ne;12;2;0;14
18178;Šaltinėlis;Saulutės;5774391181;Ne;0;2;0;2
18179;Šaltinėlis;Saulutės;4681460322;Ne;0;13;0;13
18180;Šaltinėlis;Saulutės;3968514430;Ne;0;4;0;4
18181;Šaltinėlis;Saulutės;8950694484;Ne;19;0;0;19
18182;Šaltinėlis;Saulutės;2499890317;Ne;3;3;0;6
18183;Šaltinėlis;Saulutės;3579974049;Ne;0;8;0;8
18184;Šaltinėlis;Meškiukų;6915625306;Ne;7;5;0;12
18185;Šaltinėlis;Meškiukų;6645807642;Ne;2;2;0;4
18186;Šaltinėlis;Meškiukų;9759912102;Ne;10;0;0;10
18187;Šaltinėlis;Meškiukų;4664741207;Ne;5;6;0;11
18188;Šaltinėlis;Meškiukų;1400918201;Ne;7;0;0;7
18189;Šaltinėlis;Meškiukų;5420067622;Ne;2;6;0;8
18190;Šaltinėlis;Meškiukų;1656674673;Ne;0;17;0;17
18191;Šaltinėlis;Meškiukų;4248763165;Ne;0;6;0;6
18192;Šaltinėlis;Meškiukų;5982018366;Ne;0;6;0;6
18193;Šaltinėlis;Meškiukų;9922223978;Ne;16;5;0;21
18194;Šaltinėlis;Meškiukų;8995077908;Ne;26;2;0;28
18195;Šaltinėlis;Meškiukų;5982188743;Ne;0;1;0;1
18196;Šaltinėlis;Meškiukų;6586783795;Ne;2;0;0;2
18197;Šaltinėlis;Meškiukų;7468640592;Ne;0;2;0;2
18198;Šaltinėlis;Meškiukų;4064231806;Ne;0;1;0;1
18199;Šaltinėlis;Meškiukų;6688536661;Ne;0;3;0;3
18200;Šaltinėlis;Meškiukų;8880659539;Ne;1;16;0;17
18201;Šaltinėlis;Meškiukų;3228788999;Ne;0;2;0;2
18202;Šaltinėlis;Meškiukų;5905345563;Ne;15;1;0;16
18203;Šaltinėlis;Meškiukų;2332065937;Ne;8;0;0;8
18204;Šaltinėlis;Nykštukai;9766640995;Ne;13;0;0;13
18205;Šaltinėlis;Nykštukai;3356138058;Ne;0;5;0;5
18206;Šaltinėlis;Nykštukai;5434349511;Ne;22;0;0;22
18207;Šaltinėlis;Nykštukai;4226068669;Ne;0;5;0;5
18208;Šaltinėlis;Nykštukai;2976773344;Ne;12;1;0;13
18209;Šaltinėlis;Nykštukai;3687243030;Ne;13;4;0;17
18210;Šaltinėlis;Nykštukai;9333013048;Ne;3;0;0;3
18211;Šaltinėlis;Nykštukai;6530797082;Ne;4;0;0;4
18212;Šaltinėlis;Nykštukai;7534585887;Ne;10;0;0;10
18213;Šaltinėlis;Nykštukai;8977029692;Ne;0;1;0;1
18214;Šaltinėlis;Nykštukai;7120592596;Ne;16;0;0;16
18215;Šaltinėlis;Nykštukai;6244924079;Ne;21;0;0;21
18216;Šaltinėlis;Nykštukai;3806267811;Ne;22;0;0;22
18217;Šaltinėlis;Nykštukai;3497881408;Ne;0;3;0;3
18218;Šaltinėlis;Nykštukai;6383844995;Ne;12;0;0;12
18219;Šaltinėlis;Perliukų;2825412170;Ne;0;1;0;1
18220;Šaltinėlis;Perliukų;1686009371;Ne;10;2;0;12
18221;Šaltinėlis;Perliukų;9075507649;Ne;0;0;1;1
18222;Šaltinėlis;Perliukų;7068058767;Ne;0;8;0;8
18223;Šaltinėlis;Perliukų;2189112609;Ne;17;1;0;18
18224;Šaltinėlis;Perliukų;8914777163;Ne;0;7;0;7
18225;Šaltinėlis;Perliukų;7387221265;Ne;5;2;1;8
18226;Šaltinėlis;Perliukų;9674923143;Ne;0;8;0;8
18227;Šaltinėlis;Perliukų;3073692882;Ne;0;14;0;14
18228;Šaltinėlis;Perliukų;5325974488;Ne;0;4;0;4
18229;Šaltinėlis;Perliukų;2126751248;Ne;11;0;0;11
18230;Šaltinėlis;Perliukų;3271931810;Ne;12;0;1;13
18231;Šaltinėlis;Perliukų;7955094634;Ne;0;5;1;6
18232;Šaltinėlis;Perliukų;1445108285;Ne;6;0;2;8
18233;Šaltinėlis;Perliukų;7133044918;Ne;21;0;0;21
18234;Šaltinėlis;Perliukų;2806453623;Ne;4;0;1;5
18235;Šaltinėlis;Perliukų;8695191968;Ne;0;1;0;1
18236;Šaltinėlis;Perliukų;4430546695;Ne;10;0;0;10
18237;Šaltinėlis;BORUŽĖLĖS;3505001330;Ne;19;0;0;19
18238;Šaltinėlis;BORUŽĖLĖS;8973369897;Ne;6;0;0;6
18239;Šaltinėlis;BORUŽĖLĖS;3780870805;Ne;9;0;0;9
18240;Šaltinėlis;BORUŽĖLĖS;2157520281;Ne;10;1;0;11
18241;Šaltinėlis;BORUŽĖLĖS;1441937630;Ne;3;0;0;3
18242;Šaltinėlis;BORUŽĖLĖS;8995954572;Ne;9;1;0;10
18243;Šaltinėlis;BORUŽĖLĖS;4742849747;Ne;10;1;0;11
18244;Šaltinėlis;BORUŽĖLĖS;5996579651;Ne;6;1;0;7
18245;Šaltinėlis;BORUŽĖLĖS;5331397179;Ne;10;1;0;11
18246;Šaltinėlis;BORUŽĖLĖS;9218436977;Ne;24;0;0;24
18247;Šaltinėlis;BORUŽĖLĖS;2353630084;Ne;6;0;0;6
18248;Šaltinėlis;BORUŽĖLĖS;5593692486;Ne;2;0;0;2
18249;Šaltinėlis;BORUŽĖLĖS;1496105338;Ne;6;1;0;7
18250;Šaltinėlis;1A;9188065549;Ne;0;1;0;1
18251;Šaltinėlis;1A;9305706589;Ne;0;1;0;1
18252;Šaltinėlis;1A;1580090516;Ne;0;1;0;1
18253;Šaltinėlis;1A;2034838765;Ne;0;5;0;5
18254;Šaltinėlis;1A;2105963102;Ne;0;6;0;6
18255;Šaltinėlis;1A;3582666579;Ne;0;7;0;7
18256;Šaltinėlis;1A;46569341613;Ne;0;7;0;7
18257;Šaltinėlis;1A;1091056386;Ne;0;5;0;5
18258;Šaltinėlis;1A;52142182972;Ne;0;22;0;22
18259;Šaltinėlis;1A;6880337593;Ne;0;2;0;2
18260;Šaltinėlis;1A;3516760367;Ne;0;5;0;5
18261;Šaltinėlis;1A;56542341895;Ne;0;1;0;1
18262;Šaltinėlis;1A;1910670134;Ne;0;1;0;1
18263;Šaltinėlis;1A;9595350871;Ne;0;8;0;8
18264;Šaltinėlis;1A;8902634958;Ne;0;10;0;10
18265;Šaltinėlis;1A;9757246434;Ne;0;15;0;15
18266;Šaltinėlis;1A;7262120071;Ne;0;2;0;2
18267;Šaltinėlis;1A;1004445904;Ne;0;5;0;5
18268;Šaltinėlis;"2A klasė";32264290873;Ne;0;2;0;2
18269;Šaltinėlis;"2A klasė";1767635282;Ne;0;6;0;6
18270;Šaltinėlis;"2A klasė";1390316465;Ne;0;2;0;2
18271;Šaltinėlis;"2A klasė";1658370782;Ne;0;9;0;9
18272;Šaltinėlis;"2A klasė";3455754351;Ne;0;22;0;22
18273;Šaltinėlis;"2A klasė";66575684640;Ne;0;1;0;1
18274;Šaltinėlis;"2A klasė";86592374576;Ne;0;22;0;22
18275;Šaltinėlis;"2A klasė";13808708760;Ne;0;10;0;10
18276;Šaltinėlis;"2A klasė";1614411921;Ne;0;5;0;5
18277;Šaltinėlis;"2A klasė";79406746980;Ne;0;6;0;6
18278;Šaltinėlis;"2A klasė";3577137327;Ne;0;6;0;6
18279;Šaltinėlis;"2A klasė";1224027643;Ne;0;1;0;1
18280;Šaltinėlis;"2A klasė";48525545812;Ne;0;7;0;7
18281;Šaltinėlis;"2A klasė";7073644279;Ne;0;4;0;4
18282;Šaltinėlis;"2A klasė";3022926855;Ne;0;2;0;2
18283;Šaltinėlis;"2A klasė";1190394855;Ne;0;1;0;1
18284;Šaltinėlis;"2A klasė";1456486363;Ne;0;3;0;3
18285;Šaltinėlis;"2A klasė";32949623652;Ne;0;6;0;6
18286;Šaltinėlis;"3A klasė";14213856824;Ne;0;1;0;1
18287;Šaltinėlis;"3A klasė";80649337160;Ne;0;3;0;3
18288;Šaltinėlis;"3A klasė";92958012146;Ne;0;1;0;1
18289;Šaltinėlis;"3A klasė";84656960510;Ne;0;22;0;22
18290;Šaltinėlis;"3A klasė";83621946293;Ne;0;22;0;22
18291;Šaltinėlis;"3A klasė";67808618878;Ne;0;22;0;22
18292;Šaltinėlis;"3A klasė";1278910777;Ne;0;3;0;3
18293;Šaltinėlis;"3A klasė";9647785988;Ne;0;22;0;22
18294;Šaltinėlis;"3A klasė";82671662416;Ne;0;1;0;1
18295;Šaltinėlis;"3A klasė";54025577281;Ne;0;2;0;2
18296;Šaltinėlis;"3A klasė";488285764;Ne;0;1;0;1
18297;Šaltinėlis;"3A klasė";54753218491;Ne;0;22;0;22
18298;Šaltinėlis;"3A klasė";86029472773;Ne;0;22;0;22
18299;Šaltinėlis;"3A klasė";64821172553;Ne;0;3;0;3
18300;Šaltinėlis;"3A klasė";5744976843;Ne;0;1;0;1
18301;Šaltinėlis;"3A klasė";25459069972;Ne;0;1;0;1
18302;Šaltinėlis;"3A klasė";6669392157;Ne;0;2;0;2
18303;Šaltinėlis;"3A klasė";89358384113;Ne;0;6;0;6
18304;Šaltinėlis;"3A klasė";28956971978;Ne;0;2;0;2
18305;Šaltinėlis;"3A klasė";4050444191;Ne;0;1;0;1
18306;Šaltinėlis;"3A klasė";89093437170;Ne;0;2;0;2
18307;Šaltinėlis;"3A klasė";51872331010;Ne;0;6;0;6
18308;Šaltinėlis;"4A klasė";83657465071;Ne;0;7;0;7
18309;Šaltinėlis;"4A klasė";86309198604;Ne;0;6;0;6
18310;Šaltinėlis;"4A klasė";9705941341;Ne;0;32;0;32
18311;Šaltinėlis;"4A klasė";38496350161;Ne;0;32;0;32
18312;Šaltinėlis;"4A klasė";62612067151;Ne;0;6;0;6
18313;Šaltinėlis;"4A klasė";96133834896;Ne;0;32;0;32
18314;Šaltinėlis;"4A klasė";73466313766;Ne;0;4;0;4
18315;Šaltinėlis;"4A klasė";2323456393;Ne;0;32;0;32
18316;Šaltinėlis;"4A klasė";56279691365;Ne;0;2;0;2
18317;Šaltinėlis;"4A klasė";4587186145;Ne;0;6;0;6
18318;Šaltinėlis;"4A klasė";70948186548;Ne;0;2;0;2
18319;Šaltinėlis;"4A klasė";47045578599;Ne;0;15;0;15
18320;Šaltinėlis;"4A klasė";36718328105;Ne;0;3;0;3
18321;Šaltinėlis;"4A klasė";86995081866;Ne;0;11;0;11
18322;Šaltinėlis;"4A klasė";7929809205;Ne;0;18;0;18
18323;Šaltinėlis;"4A klasė";29683761586;Ne;0;11;0;11
18324;Šaltinėlis;"4A klasė";9842958341;Ne;0;12;0;12
18325;Šaltinėlis;"4A klasė";40769315138;Ne;1;8;0;9
18326;Šaltinėlis;"4A klasė";7563879445;Ne;0;12;0;12
18327;Šaltinėlis;"4A klasė";66754907606;Ne;0;32;0;32
18328;Šaltinėlis;"4A klasė";35387543586;Ne;0;9;0;9
18329;Šaltinėlis;"4A klasė";6056572441;Ne;0;4;0;4
18330;Šaltinėlis;"4A klasė";9927833966;Ne;0;3;0;3
18331;Šaltinėlis;3B;93256161233;Ne;0;2;0;2
18332;Šaltinėlis;3B;83173349544;Ne;0;2;0;2
18333;Šaltinėlis;3B;39088869084;Ne;0;7;0;7
18334;Šaltinėlis;3B;1422035829;Ne;0;2;0;2
18335;Šaltinėlis;3B;7711903999;Ne;0;3;0;3
18336;Šaltinėlis;3B;95542489944;Ne;0;5;0;5
18337;Šaltinėlis;3B;3072314714;Ne;0;2;0;2
18338;Šaltinėlis;3B;1220687492;Ne;0;2;0;2
18339;Šaltinėlis;3B;74337710550;Ne;0;3;0;3
18340;Šaltinėlis;3B;35401075864;Ne;0;2;0;2
18341;Šaltinėlis;3B;19630605543;Ne;0;5;0;5
18342;Šaltinėlis;3B;84522552145;Ne;0;2;0;2
18343;Šaltinėlis;3B;3626545396;Ne;0;7;0;7
18344;Šaltinėlis;3B;6317111400;Ne;0;2;0;2
18345;Šaltinėlis;3B;4762756751;Ne;0;2;0;2
18346;Šaltinėlis;3B;72372808270;Ne;0;3;0;3
18347;Šaltinėlis;3B;1924418657;Ne;0;6;0;6
18348;Šaltinėlis;3B;77194317310;Ne;1;2;0;3
18349;Šaltinėlis;3B;57847832778;Ne;0;2;0;2
18350;Šaltinėlis;3B;2099800744;Ne;0;2;0;2
18351;Šaltinėlis;3B;70315400705;Ne;0;8;0;8
18352;Šaltinėlis;3B;81082410620;Ne;0;4;0;4
18353;Šaltinėlis;1B;6068980312;Ne;0;13;0;13
18354;Šaltinėlis;1B;9425353041;Ne;0;2;0;2
18355;Šaltinėlis;1B;17147527171;Ne;0;22;0;22
18356;Šaltinėlis;1B;1935762293;Ne;0;9;0;9
18357;Šaltinėlis;1B;2333071711;Ne;0;11;0;11
18358;Šaltinėlis;1B;52507085619;Ne;0;2;0;2
18359;Šaltinėlis;1B;1023238509;Ne;0;4;0;4
18360;Šaltinėlis;1B;526307704;Ne;0;3;0;3
18361;Šaltinėlis;1B;1958647188;Ne;0;7;0;7
18362;Šaltinėlis;1B;1583520894;Ne;0;22;0;22
18363;Šaltinėlis;1B;11083638216;Ne;0;5;0;5
18364;Šaltinėlis;PELĖDŽIUKAI;1367082230;Ne;0;0;6;6
18365;Šaltinėlis;PELĖDŽIUKAI;4387568448;Ne;0;5;6;11
18366;Šaltinėlis;PELĖDŽIUKAI;7723290276;Ne;0;1;0;1
18367;Šaltinėlis;PELĖDŽIUKAI;1348724947;Ne;0;22;0;22
18368;Šaltinėlis;PELĖDŽIUKAI;2658414287;Ne;2;1;0;3
18369;Šaltinėlis;PELĖDŽIUKAI;3638565578;Ne;0;2;0;2
18370;Šaltinėlis;PELĖDŽIUKAI;8721116918;Ne;9;0;0;9
18371;Šaltinėlis;PELĖDŽIUKAI;7211267255;Ne;0;0;2;2
18372;Šaltinėlis;PELĖDŽIUKAI;3660687688;Ne;0;5;0;5
18373;Šaltinėlis;PELĖDŽIUKAI;5869977541;Ne;5;0;0;5
18374;Šaltinėlis;PELĖDŽIUKAI;3609939325;Ne;2;0;0;2
18375;Šaltinėlis;PELĖDŽIUKAI;9108653045;Ne;6;4;0;10
18376;Šaltinėlis;PELĖDŽIUKAI;9762392403;Ne;0;1;0;1
18377;Šaltinėlis;PELĖDŽIUKAI;2230403251;Ne;5;0;1;6
18378;Šaltinėlis;PELĖDŽIUKAI;7918995181;Ne;7;0;1;8
18379;Šaltinėlis;PELĖDŽIUKAI;9673105905;Ne;0;0;4;4
18380;Šaltinėlis;PELĖDŽIUKAI;5099997904;Ne;0;0;5;5
18381;Gabijėlė;GANDRIUKŲ;4498088417;Ne;0;6;0;6
18382;Gabijėlė;GANDRIUKŲ;2277489032;Ne;0;0;1;1
18383;Gabijėlė;GANDRIUKŲ;8994076883;Ne;0;0;1;1
18384;Gabijėlė;GANDRIUKŲ;7087892822;Ne;1;0;0;1
18385;Gabijėlė;GANDRIUKŲ;5057272847;Ne;0;0;8;8
18386;Gabijėlė;GANDRIUKŲ;3548399391;Ne;0;0;4;4
18387;Gabijėlė;GANDRIUKŲ;3532989398;Ne;1;0;2;3
18388;Gabijėlė;GANDRIUKŲ;2215880644;Ne;5;0;2;7
18389;Gabijėlė;GANDRIUKŲ;9581539166;Ne;0;0;3;3
18390;Gabijėlė;GANDRIUKŲ;6004026516;Ne;5;4;0;9
18391;Gabijėlė;GANDRIUKŲ;4328252445;Ne;16;0;0;16
18392;Gabijėlė;GANDRIUKŲ;9706026832;Ne;0;2;0;2
18393;Gabijėlė;GANDRIUKŲ;2491503656;Ne;0;3;0;3
18394;Gabijėlė;GANDRIUKŲ;8904768332;Ne;0;0;1;1
18395;Gabijėlė;GANDRIUKŲ;5715645968;Ne;0;0;9;9
18396;Gabijėlė;GANDRIUKŲ;8572833698;Ne;3;7;1;11
18397;Gabijėlė;GANDRIUKŲ;8646572151;Ne;0;0;4;4
18398;Gabijėlė;GANDRIUKŲ;5054419205;Ne;20;2;0;22
18399;Gabijėlė;GANDRIUKŲ;7530976246;Ne;0;0;1;1
18400;Gabijėlė;GANDRIUKŲ;3920525584;Ne;0;2;0;2
18401;Gabijėlė;GANDRIUKŲ;2682112101;Ne;3;1;0;4
18402;Gabijėlė;LAKŠTINGALIUKŲ;7019425859;Ne;0;6;2;8
18403;Gabijėlė;LAKŠTINGALIUKŲ;1611004144;Ne;5;2;2;9
18404;Gabijėlė;LAKŠTINGALIUKŲ;5862882027;Ne;4;0;2;6
18405;Gabijėlė;LAKŠTINGALIUKŲ;8798786098;Ne;8;0;2;10
18406;Gabijėlė;LAKŠTINGALIUKŲ;8035360208;Ne;13;4;0;17
18407;Gabijėlė;LAKŠTINGALIUKŲ;2384469423;Ne;3;0;0;3
18408;Gabijėlė;LAKŠTINGALIUKŲ;8167646385;Ne;0;0;1;1
18409;Gabijėlė;LAKŠTINGALIUKŲ;8926268619;Ne;17;0;0;17
18410;Gabijėlė;LAKŠTINGALIUKŲ;9480021589;Ne;3;0;0;3
18411;Gabijėlė;LAKŠTINGALIUKŲ;3215569531;Ne;0;7;0;7
18412;Gabijėlė;LAKŠTINGALIUKŲ;5992403900;Ne;0;2;0;2
18413;Gabijėlė;LAKŠTINGALIUKŲ;9116943443;Ne;10;0;5;15
18414;Gabijėlė;LAKŠTINGALIUKŲ;8383489040;Ne;0;5;0;5
18415;Gabijėlė;LAKŠTINGALIUKŲ;6927730664;Ne;14;0;0;14
18416;Gabijėlė;LAKŠTINGALIUKŲ;7444385669;Ne;0;0;4;4
18417;Gabijėlė;LAKŠTINGALIUKŲ;9398722388;Ne;0;3;0;3
18418;Gabijėlė;LAKŠTINGALIUKŲ;9491327802;Ne;10;0;5;15
18419;Gabijėlė;LAKŠTINGALIUKŲ;6730947751;Ne;0;0;2;2
18420;Gabijėlė;LAKŠTINGALIUKŲ;2550300871;Ne;0;1;0;1
18421;Gabijėlė;LAKŠTINGALIUKŲ;9324498850;Ne;10;4;2;16
18422;Gabijėlė;LAKŠTINGALIUKŲ;8314088016;Ne;0;1;0;1
18423;Gabijėlė;LAKŠTINGALIUKŲ;6295299651;Ne;0;1;0;1
18424;Gabijėlė;LAKŠTINGALIUKŲ;9694544564;Ne;8;0;0;8
18425;Gabijėlė;LAKŠTINGALIUKŲ;4827797140;Ne;0;7;0;7
18426;Gabijėlė;LAKŠTINGALIUKŲ;6931780900;Ne;11;3;0;14
18427;Gabijėlė;LAKŠTINGALIUKŲ;2030555139;Ne;12;0;0;12
18428;Gabijėlė;ŽVIRBLIUKŲ;7043775905;Ne;3;2;1;6
18429;Gabijėlė;ŽVIRBLIUKŲ;4475530177;Ne;5;0;4;9
18430;Gabijėlė;ŽVIRBLIUKŲ;5743861607;Ne;7;2;3;12
18431;Gabijėlė;ŽVIRBLIUKŲ;7410541320;Ne;12;1;0;13
18432;Gabijėlė;ŽVIRBLIUKŲ;4493192224;Ne;0;10;0;10
18433;Gabijėlė;ŽVIRBLIUKŲ;9259964641;Ne;0;7;3;10
18434;Gabijėlė;ŽVIRBLIUKŲ;3268231136;Ne;0;11;0;11
18435;Gabijėlė;ŽVIRBLIUKŲ;5332825339;Ne;0;0;6;6
18436;Gabijėlė;ŽVIRBLIUKŲ;2264669298;Ne;11;3;1;15
18437;Gabijėlė;ŽVIRBLIUKŲ;5942625633;Ne;0;0;4;4
18438;Gabijėlė;ŽVIRBLIUKŲ;3155403180;Ne;0;11;6;17
18439;Gabijėlė;ŽVIRBLIUKŲ;1158461185;Ne;0;11;6;17
18440;Gabijėlė;ŽVIRBLIUKŲ;3218415151;Ne;2;2;5;9
18441;Gabijėlė;ŽVIRBLIUKŲ;8823299212;Ne;0;0;1;1
18442;Gabijėlė;ŽVIRBLIUKŲ;8879972953;Ne;0;6;0;6
18443;Gabijėlė;ŽVIRBLIUKŲ;9627906252;Ne;0;0;8;8
18444;Gabijėlė;ŽVIRBLIUKŲ;1725665169;Ne;5;0;0;5
18445;Gabijėlė;ŽVIRBLIUKŲ;8292463617;Ne;6;0;0;6
18446;Gabijėlė;ŽVIRBLIUKŲ;6674038058;Ne;6;0;7;13
18447;Gabijėlė;ŽVIRBLIUKŲ;4146051969;Ne;7;10;0;17
18448;Gabijėlė;ŽVIRBLIUKŲ;6604681536;Ne;0;12;0;12
18449;Gabijėlė;ŽVIRBLIUKŲ;1273722177;Ne;4;0;4;8
18450;Gabijėlė;ŽVIRBLIUKŲ;8384795164;Ne;2;0;0;2
18451;Gabijėlė;ŽVIRBLIUKŲ;3209491491;Ne;11;0;3;14
18452;Gabijėlė;GENIUKŲ;3445433386;Ne;0;13;0;13
18453;Gabijėlė;GENIUKŲ;1862655595;Ne;0;2;3;5
18454;Gabijėlė;GENIUKŲ;7312628876;Ne;0;12;0;12
18455;Gabijėlė;GENIUKŲ;1581688238;Ne;11;0;1;12
18456;Gabijėlė;GENIUKŲ;3176075887;Ne;0;6;0;6
18457;Gabijėlė;GENIUKŲ;9972967198;Ne;2;2;0;4
18458;Gabijėlė;GENIUKŲ;1589534853;Ne;5;1;0;6
18459;Gabijėlė;GENIUKŲ;6482824000;Ne;12;2;3;17
18460;Gabijėlė;GENIUKŲ;5962852108;Ne;6;0;3;9
18461;Gabijėlė;GENIUKŲ;7178676049;Ne;0;0;1;1
18462;Gabijėlė;GENIUKŲ;1974388885;Taip;0;19;0;19
18463;Gabijėlė;GENIUKŲ;2407507314;Ne;7;0;3;10
18464;Gabijėlė;GENIUKŲ;3827747057;Ne;6;0;0;6
18465;Gabijėlė;GENIUKŲ;8305098808;Ne;0;1;0;1
18466;Gabijėlė;GENIUKŲ;4234733280;Ne;8;1;0;9
18467;Gabijėlė;GENIUKŲ;6375754699;Ne;0;0;4;4
18468;Gabijėlė;GENIUKŲ;2009199650;Ne;0;0;4;4
18469;Gabijėlė;GENIUKŲ;6869951613;Ne;6;1;0;7
18470;Gabijėlė;GENIUKŲ;7173852168;Ne;11;4;0;15
18471;Gabijėlė;GENIUKŲ;8036572198;Ne;12;5;0;17
18472;Gabijėlė;DAGILIUKŲ;9348393550;Ne;9;2;0;11
18473;Gabijėlė;DAGILIUKŲ;4264925447;Ne;9;2;0;11
18474;Gabijėlė;DAGILIUKŲ;9120107749;Ne;0;0;2;2
18475;Gabijėlė;DAGILIUKŲ;9494313873;Ne;1;0;0;1
18476;Gabijėlė;DAGILIUKŲ;9783343968;Ne;0;0;4;4
18477;Gabijėlė;DAGILIUKŲ;3017939983;Ne;0;2;0;2
18478;Gabijėlė;DAGILIUKŲ;4462129182;Ne;5;0;0;5
18479;Gabijėlė;DAGILIUKŲ;9503639471;Ne;0;0;5;5
18480;Gabijėlė;DAGILIUKŲ;1988597157;Ne;21;0;0;21
18481;Gabijėlė;DAGILIUKŲ;9895518740;Ne;15;0;0;15
18482;Gabijėlė;DAGILIUKŲ;1286688629;Ne;7;0;3;10
18483;Gabijėlė;DAGILIUKŲ;1455856766;Ne;5;0;2;7
18484;Gabijėlė;DAGILIUKŲ;6438144206;Ne;0;1;6;7
18485;Gabijėlė;DAGILIUKŲ;8662914262;Ne;5;0;0;5
18486;Gabijėlė;DAGILIUKŲ;9280283478;Ne;10;0;2;12
18487;Gabijėlė;DAGILIUKŲ;2254104149;Ne;10;1;0;11
18488;Gabijėlė;DAGILIUKŲ;4490619514;Ne;5;0;2;7
18489;Gabijėlė;DAGILIUKŲ;2386980295;Ne;5;0;2;7
18490;Gabijėlė;DAGILIUKŲ;4664011011;Ne;10;0;0;10
18491;Gabijėlė;PELEDŽIUKŲ;4170105224;Ne;6;0;0;6
18492;Gabijėlė;PELEDŽIUKŲ;5675574534;Ne;4;1;0;5
18493;Gabijėlė;PELEDŽIUKŲ;1356830225;Ne;0;4;2;6
18494;Gabijėlė;PELEDŽIUKŲ;9265103627;Ne;9;0;0;9
18495;Gabijėlė;PELEDŽIUKŲ;2128428173;Ne;0;6;3;9
18496;Gabijėlė;PELEDŽIUKŲ;7028670164;Ne;0;0;5;5
18497;Gabijėlė;PELEDŽIUKŲ;2885913045;Ne;7;1;0;8
18498;Gabijėlė;PELEDŽIUKŲ;5869580147;Ne;5;5;2;12
18499;Gabijėlė;PELEDŽIUKŲ;7096789623;Ne;0;7;7;14
18500;Gabijėlė;PELEDŽIUKŲ;4724322463;Ne;2;3;0;5
18501;Gabijėlė;PELEDŽIUKŲ;1810898809;Taip;0;0;2;2
18502;Gabijėlė;PELEDŽIUKŲ;5801792404;Ne;22;0;0;22
18503;Gabijėlė;PELEDŽIUKŲ;8550877260;Ne;0;12;0;12
18504;Gabijėlė;PELEDŽIUKŲ;5579070948;Ne;0;0;8;8
18505;Gabijėlė;PELEDŽIUKŲ;1076369632;Ne;5;0;1;6
18506;Gabijėlė;PELEDŽIUKŲ;8549800358;Ne;22;0;0;22
18507;Gabijėlė;PELEDŽIUKŲ;8133131896;Ne;0;8;2;10
18508;Gabijėlė;PELEDŽIUKŲ;2048046055;Ne;0;0;3;3
18509;Gabijėlė;PELEDŽIUKŲ;8088806507;Ne;0;10;0;10
18510;Gabijėlė;PELEDŽIUKŲ;6728495961;Ne;10;10;0;20
18511;Gabijėlė;KREGZDŽIUKŲ;1759118326;Ne;0;3;0;3
18512;Gabijėlė;KREGZDŽIUKŲ;9533325351;Ne;0;6;0;6
18513;Gabijėlė;KREGZDŽIUKŲ;5407565441;Ne;9;0;1;10
18514;Gabijėlė;KREGZDŽIUKŲ;6845038692;Ne;0;3;0;3
18515;Gabijėlė;KREGZDŽIUKŲ;2357515455;Ne;7;0;0;7
18516;Gabijėlė;KREGZDŽIUKŲ;1574272380;Ne;0;4;0;4
18517;Gabijėlė;KREGZDŽIUKŲ;2634722171;Ne;0;1;0;1
18518;Gabijėlė;KREGZDŽIUKŲ;4317708029;Ne;0;11;0;11
18519;Gabijėlė;KREGZDŽIUKŲ;8555272917;Ne;0;4;0;4
18520;Gabijėlė;KREGZDŽIUKŲ;1142939183;Ne;0;6;0;6
18521;Gabijėlė;KREGZDŽIUKŲ;9676186208;Ne;0;7;0;7
18522;Gabijėlė;KREGZDŽIUKŲ;3584692524;Ne;0;2;5;7
18523;Gabijėlė;KREGZDŽIUKŲ;8613821848;Ne;10;0;1;11
18524;Gabijėlė;KREGZDŽIUKŲ;7038167942;Ne;0;10;0;10
18525;Gabijėlė;KREGZDŽIUKŲ;6570702235;Ne;0;12;0;12
18526;Gabijėlė;KREGZDŽIUKŲ;9528783892;Ne;0;8;0;8
18527;Gabijėlė;KREGZDŽIUKŲ;9030890792;Ne;6;10;1;17
18528;Gabijėlė;KREGZDŽIUKŲ;3031333199;Ne;0;10;4;14
18529;Gabijėlė;KREGZDŽIUKŲ;9116153981;Ne;10;1;1;12
18530;Gabijėlė;KREGZDŽIUKŲ;7447079902;Ne;3;0;1;4
18531;Gabijėlė;KREGZDŽIUKŲ;2289016022;Ne;8;0;1;9
18532;Gabijėlė;KREGZDŽIUKŲ;1230236612;Ne;18;0;4;22
18533;Gabijėlė;KREGZDŽIUKŲ;4575230225;Ne;10;1;0;11
18534;Gabijėlė;KREGZDŽIUKŲ;7224216275;Ne;10;0;2;12
18535;Gabijėlė;ZYLIUKŲ;6154378055;Ne;22;0;0;22
18536;Gabijėlė;ZYLIUKŲ;7700700293;Ne;0;7;5;12
18537;Gabijėlė;ZYLIUKŲ;6759447513;Ne;0;7;0;7
18538;Gabijėlė;ZYLIUKŲ;1090635644;Ne;0;15;0;15
18539;Gabijėlė;ZYLIUKŲ;9893869150;Ne;14;0;6;20
18540;Gabijėlė;ZYLIUKŲ;2764185879;Ne;0;0;1;1
18541;Gabijėlė;ZYLIUKŲ;6463161337;Ne;0;0;5;5
18542;Gabijėlė;ZYLIUKŲ;7921467223;Ne;0;0;1;1
18543;Gabijėlė;ZYLIUKŲ;7047606048;Ne;0;0;1;1
18544;Gabijėlė;ZYLIUKŲ;6983092888;Ne;4;0;3;7
18545;Gabijėlė;ZYLIUKŲ;2727329238;Ne;0;5;0;5
18546;Gabijėlė;ZYLIUKŲ;4267803371;Ne;0;0;5;5
18547;Gabijėlė;ZYLIUKŲ;9259673720;Ne;0;0;2;2
18548;Gabijėlė;ZYLIUKŲ;8362509831;Ne;0;0;1;1
18549;Gabijėlė;ZYLIUKŲ;4907669556;Ne;0;9;0;9
18550;Gabijėlė;ZYLIUKŲ;1947898190;Ne;0;11;0;11
18551;Gabijėlė;ZYLIUKŲ;2384174631;Ne;5;0;5;10
18552;Gabijėlė;ZYLIUKŲ;6393256426;Ne;15;0;6;21
18553;Gabijėlė;ZYLIUKŲ;4166561084;Ne;0;2;3;5
18554;Gabijėlė;ZYLIUKŲ;5736012194;Ne;8;0;2;10
18555;Gabijėlė;ZYLIUKŲ;1004297369;Ne;0;0;15;15
18556;Gabijėlė;ZYLIUKŲ;7180444215;Ne;5;0;5;10
18557;Gabijėlė;VOLUNGĖLIŲ;4000838897;Ne;11;1;1;13
18558;Gabijėlė;VOLUNGĖLIŲ;2099510027;Ne;0;15;0;15
18559;Gabijėlė;VOLUNGĖLIŲ;6842537434;Ne;0;1;0;1
18560;Gabijėlė;VOLUNGĖLIŲ;2227816651;Ne;0;2;0;2
18561;Gabijėlė;VOLUNGĖLIŲ;6956030813;Ne;6;1;0;7
18562;Gabijėlė;VOLUNGĖLIŲ;8733551230;Ne;2;8;0;10
18563;Gabijėlė;VOLUNGĖLIŲ;3763595874;Ne;8;0;0;8
18564;Gabijėlė;VOLUNGĖLIŲ;5360985745;Ne;6;0;0;6
18565;Gabijėlė;VOLUNGĖLIŲ;4580305437;Ne;0;2;0;2
18566;Gabijėlė;VOLUNGĖLIŲ;5737066080;Ne;7;1;0;8
18567;Gabijėlė;VOLUNGĖLIŲ;3972933727;Ne;12;6;0;18
18568;Gabijėlė;VOLUNGĖLIŲ;6643563560;Ne;0;3;0;3
18569;Gabijėlė;VOLUNGĖLIŲ;8312753333;Ne;3;3;0;6
18570;Gabijėlė;VOLUNGĖLIŲ;2523400466;Ne;5;7;0;12
18571;Gabijėlė;VOLUNGĖLIŲ;8569742033;Ne;13;0;1;14
18572;Gabijėlė;VOLUNGĖLIŲ;8327903800;Ne;2;1;0;3
18573;Gabijėlė;VOLUNGĖLIŲ;4160646449;Ne;0;5;0;5
18574;Gabijėlė;VOLUNGĖLIŲ;5060265729;Ne;2;1;3;6
18575;Gabijėlė;VOLUNGĖLIŲ;6960725029;Ne;22;0;0;22
18576;Gabijėlė;VOLUNGĖLIŲ;3098846537;Ne;0;1;0;1
18577;Gabijėlė;VOLUNGĖLIŲ;3995459990;Ne;8;0;0;8
18578;Gabijėlė;VOLUNGĖLIŲ;8320449381;Taip;0;1;0;1
18579;Gabijėlė;VOLUNGĖLIŲ;3267339129;Ne;0;2;1;3
18580;Gabijėlė;ANČIUKŲ;2036978425;Ne;0;9;0;9
18581;Gabijėlė;ANČIUKŲ;5219706067;Ne;0;1;7;8
18582;Gabijėlė;ANČIUKŲ;3454412432;Ne;0;1;0;1
18583;Gabijėlė;ANČIUKŲ;9822093084;Ne;0;9;0;9
18584;Gabijėlė;ANČIUKŲ;1415184607;Ne;5;0;1;6
18585;Gabijėlė;ANČIUKŲ;85836097485;Ne;0;0;3;3
18586;Gabijėlė;ANČIUKŲ;28017865889;Ne;0;3;0;3
18587;Gabijėlė;ANČIUKŲ;1917587420;Ne;7;0;0;7
18588;Gabijėlė;ANČIUKŲ;6198439092;Ne;0;5;0;5
18589;Gabijėlė;ANČIUKŲ;7948343328;Ne;0;10;0;10
18590;Gabijėlė;ANČIUKŲ;2052892422;Ne;5;0;1;6
18591;Gabijėlė;ANČIUKŲ;8111239476;Ne;0;3;0;3
18592;Gabijėlė;ANČIUKŲ;8778396292;Ne;5;0;1;6
18593;Gabijėlė;ANČIUKŲ;4085049535;Ne;0;5;0;5
18594;Gabijėlė;ANČIUKŲ;8893637755;Ne;0;5;0;5
18595;Gabijėlė;ANČIUKŲ;8874692591;Ne;0;0;6;6
18596;Gabijėlė;ANČIUKŲ;4752631976;Ne;0;0;3;3
18597;Gabijėlė;ANČIUKŲ;6766770793;Ne;0;0;2;2
18598;Gabijėlė;ANČIUKŲ;10796114623;Ne;0;9;0;9
18599;Gabijėlė;ANČIUKŲ;43123279348;Ne;0;8;0;8
18600;Gabijėlė;BALANDŽIUKŲ;6719097956;Ne;0;0;2;2
18601;Gabijėlė;BALANDŽIUKŲ;9157819780;Ne;0;8;0;8
18602;Gabijėlė;BALANDŽIUKŲ;1045338865;Ne;0;2;0;2
18603;Gabijėlė;BALANDŽIUKŲ;2097260657;Ne;0;2;1;3
18604;Gabijėlė;BALANDŽIUKŲ;8131229306;Ne;0;2;0;2
18605;Gabijėlė;BALANDŽIUKŲ;8525869648;Ne;3;5;0;8
18606;Gabijėlė;BALANDŽIUKŲ;2070050969;Ne;0;1;0;1
18607;Gabijėlė;BALANDŽIUKŲ;15049855022;Ne;0;6;0;6
18608;Gabijėlė;BALANDŽIUKŲ;2776579713;Ne;0;5;0;5
18609;Gabijėlė;BALANDŽIUKŲ;9197020006;Ne;0;3;0;3
18610;Gabijėlė;BALANDŽIUKŲ;1615940996;Ne;0;2;2;4
18611;Gabijėlė;BALANDŽIUKŲ;65735862964;Ne;5;1;0;6
18612;Gabijėlė;BALANDŽIUKŲ;6196322537;Ne;0;0;1;1
18613;Gabijėlė;BALANDŽIUKŲ;8746641978;Ne;0;2;0;2
18614;Gabijėlė;BALANDŽIUKŲ;56914218692;Ne;3;1;0;4
18615;Gabijėlė;BALANDŽIUKŲ;4330624300;Ne;0;0;1;1
18616;Gabijėlė;BALANDŽIUKŲ;2921208571;Ne;2;0;1;3
18617;Gabijėlė;BALANDŽIUKŲ;9501202207;Ne;5;1;0;6
18618;Gabijėlė;BALANDŽIUKŲ;6145720452;Ne;0;7;0;7
18619;Gabijėlė;BALANDŽIUKŲ;7563741123;Ne;0;9;0;9
18620;Gabijėlė;BALANDŽIUKŲ;3694447705;Ne;0;2;1;3
18621;Gabijėlė;BALANDŽIUKŲ;2189532651;Ne;0;1;0;1
18622;Gabijėlė;VYTURIUKŲ;6131649116;Ne;7;0;8;15
18623;Gabijėlė;VYTURIUKŲ;7894667201;Ne;12;1;0;13
18624;Gabijėlė;VYTURIUKŲ;3973977318;Ne;0;10;2;12
18625;Gabijėlė;VYTURIUKŲ;3454061135;Ne;0;0;1;1
18626;Gabijėlė;VYTURIUKŲ;9628900843;Ne;0;0;2;2
18627;Gabijėlė;VYTURIUKŲ;5652244967;Ne;6;1;3;10
18628;Gabijėlė;VYTURIUKŲ;3343196830;Ne;0;0;5;5
18629;Gabijėlė;VYTURIUKŲ;7295985579;Ne;17;0;0;17
18630;Gabijėlė;VYTURIUKŲ;6834871835;Ne;7;1;1;9
18631;Gabijėlė;VYTURIUKŲ;8749080961;Ne;0;0;7;7
18632;Gabijėlė;VYTURIUKŲ;1185216449;Ne;0;3;1;4
18633;Gabijėlė;VYTURIUKŲ;6107630313;Ne;1;0;0;1
18634;Gabijėlė;VYTURIUKŲ;5297866989;Ne;0;0;1;1
18635;Gabijėlė;VYTURIUKŲ;4278783863;Ne;2;0;0;2
18636;Gabijėlė;VYTURIUKŲ;7509112343;Ne;2;2;1;5
18637;Gabijėlė;VYTURIUKŲ;4248856615;Ne;7;0;0;7
18638;Gabijėlė;VYTURIUKŲ;6539078572;Ne;0;9;0;9
18639;Gabijėlė;VYTURIUKŲ;9657713903;Ne;22;0;0;22
18640;Gabijėlė;VYTURIUKŲ;5310270057;Ne;0;0;1;1
18641;Saulėgrąža;Bitutės;8660677159;Ne;0;3;1;4
18642;Saulėgrąža;Bitutės;9437387272;Ne;22;0;0;22
18643;Saulėgrąža;Bitutės;5940167166;Ne;0;0;3;3
18644;Saulėgrąža;Bitutės;6641588877;Ne;2;0;4;6
18645;Saulėgrąža;Bitutės;8505655534;Ne;0;9;2;11
18646;Saulėgrąža;Bitutės;2809788049;Ne;0;1;8;9
18647;Saulėgrąža;Bitutės;4733063461;Ne;0;0;5;5
18648;Saulėgrąža;Bitutės;1381240000;Ne;0;2;0;2
18649;Saulėgrąža;Bitutės;8766433391;Ne;0;3;0;3
18650;Saulėgrąža;Bitutės;7283302671;Ne;0;10;2;12
18651;Saulėgrąža;Bitutės;2042826101;Ne;0;2;2;4
18652;Saulėgrąža;Bitutės;8384708422;Ne;0;5;0;5
18653;Saulėgrąža;Bitutės;1345079291;Ne;0;10;0;10
18654;Saulėgrąža;Bitutės;3319538368;Taip;2;0;3;5
18655;Saulėgrąža;Bitutės;7387477589;Ne;7;0;0;7
18656;Saulėgrąža;Bitutės;5221286194;Ne;7;0;0;7
18657;Saulėgrąža;Šnekučiai;7094602327;Ne;10;0;0;10
18658;Saulėgrąža;Šnekučiai;7666307601;Taip;10;0;0;10
18659;Saulėgrąža;Skruzdėliukai;7636592904;Ne;0;2;5;7
18660;Saulėgrąža;Skruzdėliukai;87694187780;Ne;3;0;0;3
18661;Saulėgrąža;Skruzdėliukai;6036373745;Ne;0;0;1;1
18662;Saulėgrąža;Skruzdėliukai;4023911154;Ne;0;0;1;1
18663;Saulėgrąža;Skruzdėliukai;2029367287;Ne;0;2;0;2
18664;Saulėgrąža;Skruzdėliukai;4904157108;Ne;2;2;0;4
18665;Saulėgrąža;Skruzdėliukai;2453261741;Ne;0;15;1;16
18666;Saulėgrąža;Skruzdėliukai;6867062357;Ne;0;1;0;1
18667;Saulėgrąža;Skruzdėliukai;9701242161;Ne;0;0;1;1
18668;Saulėgrąža;Skruzdėliukai;2123441401;Ne;0;0;5;5
18669;Saulėgrąža;Skruzdėliukai;6373141401;Ne;0;3;0;3
18670;Saulėgrąža;Skruzdėliukai;5674402704;Ne;0;4;0;4
18671;Saulėgrąža;Skruzdėliukai;8140258691;Ne;0;1;0;1
18672;Saulėgrąža;Skruzdėliukai;3839880985;Ne;0;0;1;1
18673;Saulėgrąža;Skruzdėliukai;1397888834;Ne;0;0;14;14
18674;Saulėgrąža;Skruzdėliukai;4902990966;Ne;7;0;3;10
18675;Saulėgrąža;Gudručiai;1557512232;Ne;5;0;4;9
18676;Saulėgrąža;Gudručiai;3334830210;Ne;20;0;0;20
18677;Saulėgrąža;Gudručiai;3460944414;Ne;0;0;2;2
18678;Saulėgrąža;Gudručiai;8066720746;Ne;0;5;0;5
18679;Saulėgrąža;Gudručiai;6087243776;Ne;0;1;1;2
18680;Saulėgrąža;Gudručiai;4656827505;Ne;12;0;2;14
18681;Saulėgrąža;Gudručiai;2325641957;Ne;2;5;0;7
18682;Saulėgrąža;Gudručiai;2142393859;Ne;22;0;0;22
18683;Saulėgrąža;Gudručiai;9703861091;Ne;0;0;3;3
18684;Saulėgrąža;Gudručiai;5493928884;Ne;5;1;0;6
18685;Saulėgrąža;Gudručiai;6925730672;Ne;4;0;2;6
18686;Saulėgrąža;Gudručiai;4593109666;Ne;0;0;3;3
18687;Saulėgrąža;Gudručiai;3455052574;Ne;0;7;0;7
18688;Saulėgrąža;Gudručiai;6803731510;Ne;0;0;1;1
18689;Saulėgrąža;Gudručiai;9235493036;Ne;5;0;0;5
18690;Saulėgrąža;Gudručiai;5230565797;Ne;0;0;5;5
18691;Saulėgrąža;Gudručiai;7499997676;Ne;0;0;6;6
18692;Saulėgrąža;Gudručiai;2934189012;Ne;10;0;0;10
18693;Saulėgrąža;Smalsučiai;6415042057;Ne;4;0;1;5
18694;Saulėgrąža;Smalsučiai;9641357813;Ne;0;5;0;5
18695;Saulėgrąža;Smalsučiai;2405382490;Ne;0;0;1;1
18696;Saulėgrąža;Smalsučiai;4204112706;Ne;0;2;0;2
18697;Saulėgrąža;Smalsučiai;7804106261;Ne;10;0;0;10
18698;Saulėgrąža;Smalsučiai;6627868194;Ne;12;0;0;12
18699;Saulėgrąža;Smalsučiai;3574399274;Ne;0;5;0;5
18700;Saulėgrąža;Smalsučiai;12350048317;Ne;6;1;0;7
18701;Saulėgrąža;Smalsučiai;3214026239;Ne;3;0;0;3
18702;Saulėgrąža;Smalsučiai;1314754650;Ne;0;6;0;6
18703;Saulėgrąža;Smalsučiai;3517616785;Ne;0;0;1;1
18704;Saulėgrąža;Smalsučiai;4252425680;Ne;7;0;0;7
18705;Saulėgrąža;Smalsučiai;1563002207;Ne;0;8;0;8
18706;Saulėgrąža;Smalsučiai;3551146001;Ne;5;0;0;5
18707;Saulėgrąža;"Boruželės ";3889868838;Ne;11;0;3;14
18708;Saulėgrąža;"Boruželės ";1613110580;Ne;0;0;3;3
18709;Saulėgrąža;"Boruželės ";6802366478;Ne;0;0;2;2
18710;Saulėgrąža;"Boruželės ";9604238128;Ne;0;0;15;15
18711;Saulėgrąža;"Boruželės ";4587532777;Ne;3;0;5;8
18712;Saulėgrąža;"Boruželės ";1008547550;Ne;0;0;5;5
18713;Saulėgrąža;"Boruželės ";4930162914;Ne;0;0;4;4
18714;Saulėgrąža;"Boruželės ";8986368849;Ne;6;3;0;9
18715;Saulėgrąža;"Boruželės ";3080026762;Ne;12;0;0;12
18716;Saulėgrąža;"Boruželės ";9328524382;Taip;22;0;0;22
18717;Saulėgrąža;"Boruželės ";2598768766;Ne;16;0;1;17
18718;Saulėgrąža;"Boruželės ";5734857301;Ne;10;8;2;20
18719;Saulėgrąža;"Boruželės ";9658060059;Ne;11;0;5;16
18720;Saulėgrąža;"Boruželės ";3594593787;Ne;10;0;0;10
18721;Saulėgrąža;"Boruželės ";2455622343;Ne;7;0;0;7
18722;Saulėgrąža;Žiogeliai;7400016718;Ne;0;0;4;4
18723;Saulėgrąža;Žiogeliai;8518372931;Ne;0;0;2;2
18724;Saulėgrąža;Žiogeliai;3540590993;Ne;10;0;0;10
18725;Saulėgrąža;Žiogeliai;6909434851;Ne;0;9;0;9
18726;Saulėgrąža;Žiogeliai;7399313501;Ne;2;0;0;2
18727;Saulėgrąža;Žiogeliai;8649254574;Ne;0;0;7;7
18728;Saulėgrąža;Žiogeliai;2551242973;Taip;0;0;3;3
18729;Saulėgrąža;Žiogeliai;6332380237;Ne;0;0;3;3
18730;Saulėgrąža;Žiogeliai;7881751334;Ne;0;1;0;1
18731;Saulėgrąža;Žiogeliai;4332729441;Ne;2;0;0;2
18732;Saulėgrąža;Žiogeliai;6818436741;Ne;0;0;7;7
18733;Saulėgrąža;Žiogeliai;7807068772;Ne;0;0;12;12
18734;Saulėgrąža;Žiogeliai;5360973768;Ne;0;0;2;2
18735;Saulėgrąža;Žiogeliai;8769720021;Ne;0;0;1;1
18736;Saulėgrąža;Žiogeliai;5328915059;Ne;0;3;0;3
18737;Saulėgrąža;Žiogeliai;1533696548;Ne;9;0;2;11
18738;Saulėgrąža;Drugeliai;8155080474;Ne;8;7;0;15
18739;Saulėgrąža;Drugeliai;1955944355;Ne;0;7;0;7
18740;Saulėgrąža;Drugeliai;2680631642;Ne;0;0;3;3
18741;Saulėgrąža;Drugeliai;8337203952;Ne;0;3;4;7
18742;Saulėgrąža;Drugeliai;6127496900;Ne;0;9;1;10
18743;Saulėgrąža;Drugeliai;8841882983;Ne;12;0;2;14
18744;Saulėgrąža;Drugeliai;6608001857;Ne;0;4;0;4
18745;Saulėgrąža;Drugeliai;4663169787;Ne;5;0;5;10
18746;Saulėgrąža;Drugeliai;6981928727;Ne;3;0;5;8
18747;Saulėgrąža;Drugeliai;8873608939;Ne;0;1;0;1
18748;Saulėgrąža;Drugeliai;7281353368;Ne;0;2;5;7
18749;Saulėgrąža;Drugeliai;8138991066;Ne;7;0;0;7
18750;Saulėgrąža;Drugeliai;1379283244;Ne;0;0;6;6
18751;Saulėgrąža;Drugeliai;4767744537;Ne;0;0;7;7
18752;Saulėgrąža;Drugeliai;1564385864;Ne;0;0;3;3
18753;Saulėgrąža;Drugeliai;8882080945;Ne;0;0;9;9
18754;Saulėgrąža;Drugeliai;1080500584;Ne;0;1;1;2
18755;Saulėgrąža;Drugeliai;1386348080;Ne;0;0;2;2
18756;Saulėgrąža;Drugeliai;3318222372;Ne;7;2;0;9
18757;Saulėgrąža;Drugeliai;8148900529;Ne;0;0;2;2
18758;Saulėgrąža;Pabiručiai;2570007539;Ne;6;0;2;8
18759;Saulėgrąža;Pabiručiai;1193968905;Ne;5;0;2;7
18760;Saulėgrąža;Pabiručiai;6924492377;Ne;10;0;0;10
18761;Saulėgrąža;Pabiručiai;9812784697;Ne;14;0;1;15
18762;Saulėgrąža;Pabiručiai;1732823416;Ne;7;0;3;10
18763;Saulėgrąža;Pabiručiai;2063366170;Ne;6;9;0;15
18764;Saulėgrąža;Pabiručiai;5417303387;Ne;0;7;5;12
18765;Saulėgrąža;Pabiručiai;4687158499;Ne;2;0;1;3
18766;Saulėgrąža;Pabiručiai;4113866451;Ne;5;0;0;5
18767;Saulėgrąža;Pabiručiai;5759064166;Ne;5;0;0;5
18768;Saulėgrąža;Pabiručiai;3014850439;Ne;4;8;0;12
18769;Saulėgrąža;Pabiručiai;7563907981;Ne;17;0;3;20
18770;Saulėgrąža;Pabiručiai;7110805205;Ne;10;0;0;10
18771;Saulėgrąža;Pabiručiai;6489291407;Ne;17;0;0;17
18772;Saulėgrąža;Pabiručiai;5302001715;Ne;0;11;3;14
18773;Saulėgrąža;Pabiručiai;6846627257;Ne;8;0;0;8
18774;Saulėgrąža;Pabiručiai;4869924215;Ne;6;0;7;13
18775;Saulėgrąža;Žvirbliukai;4642639501;Ne;16;0;0;16
18776;Saulėgrąža;Žvirbliukai;7136064458;Taip;2;0;1;3
18777;Saulėgrąža;Žvirbliukai;6521035871;Ne;15;0;0;15
18778;Saulėgrąža;Žvirbliukai;7341460478;Ne;5;0;3;8
18779;Saulėgrąža;Žvirbliukai;4804554877;Ne;5;0;2;7
18780;Saulėgrąža;Žvirbliukai;7772718729;Ne;0;11;0;11
18781;Saulėgrąža;Žvirbliukai;2061821043;Ne;6;0;2;8
18782;Saulėgrąža;Žvirbliukai;4154566152;Ne;5;0;0;5
18783;Saulėgrąža;Žvirbliukai;5546123929;Ne;5;0;0;5
18784;Saulėgrąža;Pagrandukai;9226189126;Taip;6;0;0;6
18785;Saulėgrąža;Pagrandukai;7283179482;Ne;0;4;1;5
18786;Saulėgrąža;Pagrandukai;3060727219;Taip;0;0;10;10
18787;Saulėgrąža;Pagrandukai;4405035646;Ne;9;0;1;10
18788;Saulėgrąža;Pagrandukai;4017783391;Ne;12;0;0;12
18789;Saulėgrąža;Pagrandukai;3811142022;Ne;4;0;0;4
18790;Saulėgrąža;Pagrandukai;5584937620;Ne;6;0;1;7
18791;Saulėgrąža;Pagrandukai;3745791935;Ne;21;0;0;21
18792;Saulėgrąža;Pagrandukai;3785206644;Ne;0;7;1;8
18793;Saulėgrąža;Pagrandukai;2395186861;Ne;20;0;0;20
18794;Saulėgrąža;Pagrandukai;6130342214;Ne;0;0;2;2
18795;Saulėgrąža;Pagrandukai;3860139612;Ne;0;0;12;12
18796;Saulėgrąža;Pagrandukai;5633604322;Ne;0;0;6;6
18797;Saulėgrąža;Pagrandukai;2882565651;Ne;9;0;1;10
18798;Saulėgrąža;Pagrandukai;3270627153;Ne;0;0;2;2
18799;Saulėgrąža;Pagrandukai;3122607003;Ne;0;8;0;8
18800;Saulėgrąža;ŽIRNIUKAI;1865329102;Ne;0;3;5;8
18801;Saulėgrąža;ŽIRNIUKAI;1348059394;Ne;21;9;1;31
18802;Saulėgrąža;ŽIRNIUKAI;9048103711;Ne;0;9;4;13
18803;Saulėgrąža;ŽIRNIUKAI;7006151469;Ne;12;9;3;24
18804;Saulėgrąža;ŽIRNIUKAI;2639340053;Ne;0;0;1;1
18805;Saulėgrąža;ŽIRNIUKAI;8759207627;Ne;0;20;9;29
18806;Saulėgrąža;ŽIRNIUKAI;7224392042;Ne;5;0;0;5
18807;Saulėgrąža;ŽIRNIUKAI;7394519503;Ne;5;3;0;8
18808;Saulėgrąža;ŽIRNIUKAI;7639669608;Ne;0;0;2;2
18809;Saulėgrąža;ŽIRNIUKAI;3406939096;Ne;0;10;2;12
18810;Saulėgrąža;ŽIRNIUKAI;7556672566;Ne;0;5;0;5
18811;Saulėgrąža;ŽIRNIUKAI;2440413511;Ne;0;5;1;6
18812;Saulėgrąža;ŽIRNIUKAI;8100161189;Ne;0;0;1;1
18813;Saulėgrąža;ŽIRNIUKAI;5168679344;Ne;0;1;7;8
18814;Saulėgrąža;ŽIRNIUKAI;3467805481;Ne;0;0;3;3
18815;Saulėgrąža;ŽIRNIUKAI;3124081874;Ne;12;4;2;18
18816;Saulėgrąža;ŽIRNIUKAI;3898229402;Ne;4;0;0;4
18817;Saulėgrąža;ŽIRNIUKAI;1217899072;Ne;5;7;2;14
18818;Saulėgrąža;ŽIRNIUKAI;7795898798;Ne;6;12;0;18
18819;Saulėgrąža;ŽIRNIUKAI;5263977515;Ne;11;9;1;21
18820;Saulėgrąža;ŽIRNIUKAI;5054190103;Ne;0;0;3;3
18821;"Pilaitukas (I. Kanto al. 7A)";BITUTĖS;8169484415;Ne;0;5;0;5
18822;"Pilaitukas (I. Kanto al. 7A)";BITUTĖS;1253300093;Ne;7;2;0;9
18823;"Pilaitukas (I. Kanto al. 7A)";BITUTĖS;1729494874;Ne;0;1;0;1
18824;"Pilaitukas (I. Kanto al. 7A)";BITUTĖS;2242454299;Ne;0;2;0;2
18825;"Pilaitukas (I. Kanto al. 7A)";BITUTĖS;4082490488;Ne;5;2;0;7
18826;"Pilaitukas (I. Kanto al. 7A)";BITUTĖS;3345387791;Ne;0;3;2;5
18827;"Pilaitukas (I. Kanto al. 7A)";BITUTĖS;3913169122;Ne;0;2;0;2
18828;"Pilaitukas (I. Kanto al. 7A)";BITUTĖS;3541354283;Ne;0;5;1;6
18829;"Pilaitukas (I. Kanto al. 7A)";BITUTĖS;5740951665;Ne;2;3;5;10
18830;"Pilaitukas (I. Kanto al. 7A)";BITUTĖS;4591799893;Ne;11;2;0;13
18831;"Pilaitukas (I. Kanto al. 7A)";BITUTĖS;6308557885;Ne;9;1;0;10
18832;"Pilaitukas (I. Kanto al. 7A)";BITUTĖS;6514731102;Ne;9;1;0;10
18833;"Pilaitukas (I. Kanto al. 7A)";BITUTĖS;5988165204;Ne;4;0;0;4
18834;"Pilaitukas (I. Kanto al. 7A)";BITUTĖS;3037850837;Ne;2;1;0;3
18835;"Pilaitukas (I. Kanto al. 7A)";BITUTĖS;7438112270;Ne;6;0;0;6
18836;"Pilaitukas (I. Kanto al. 7A)";BITUTĖS;5331915157;Ne;0;1;4;5
18837;"Pilaitukas (I. Kanto al. 7A)";BITUTĖS;6099109886;Ne;3;0;0;3
18838;"Pilaitukas (I. Kanto al. 7A)";BITUTĖS;3159733673;Ne;7;2;0;9
18839;"Pilaitukas (I. Kanto al. 7A)";BITUTĖS;2122392982;Taip;0;6;0;6
18840;"Pilaitukas (I. Kanto al. 7A)";BITUTĖS;7082099968;Ne;10;3;0;13
18841;"Pilaitukas (I. Kanto al. 7A)";ZUIKUČIAI;8993885764;Ne;6;6;0;12
18842;"Pilaitukas (I. Kanto al. 7A)";ZUIKUČIAI;5206637809;Ne;0;0;3;3
18843;"Pilaitukas (I. Kanto al. 7A)";ZUIKUČIAI;8255398803;Ne;0;7;1;8
18844;"Pilaitukas (I. Kanto al. 7A)";ZUIKUČIAI;2862447956;Ne;5;0;0;5
18845;"Pilaitukas (I. Kanto al. 7A)";ZUIKUČIAI;8727175656;Ne;3;2;0;5
18846;"Pilaitukas (I. Kanto al. 7A)";ZUIKUČIAI;8207194955;Ne;0;7;1;8
18847;"Pilaitukas (I. Kanto al. 7A)";ZUIKUČIAI;5640802570;Ne;0;1;1;2
18848;"Pilaitukas (I. Kanto al. 7A)";ZUIKUČIAI;4623818227;Ne;3;0;2;5
18849;"Pilaitukas (I. Kanto al. 7A)";ZUIKUČIAI;9260893320;Ne;0;1;0;1
18850;"Pilaitukas (I. Kanto al. 7A)";ZUIKUČIAI;1607454890;Ne;0;1;0;1
18851;"Pilaitukas (I. Kanto al. 7A)";ZUIKUČIAI;9878890346;Ne;0;2;0;2
18852;"Pilaitukas (I. Kanto al. 7A)";ZUIKUČIAI;5710747769;Ne;15;1;0;16
18853;"Pilaitukas (I. Kanto al. 7A)";ZUIKUČIAI;7568744500;Ne;0;0;6;6
18854;"Pilaitukas (I. Kanto al. 7A)";ZUIKUČIAI;5407354218;Ne;6;3;0;9
18855;"Pilaitukas (I. Kanto al. 7A)";ZUIKUČIAI;1704055907;Ne;0;0;9;9
18856;"Pilaitukas (I. Kanto al. 7A)";ZUIKUČIAI;7853910193;Ne;1;0;8;9
18857;"Pilaitukas (I. Kanto al. 7A)";ZUIKUČIAI;6426415533;Ne;9;0;0;9
18858;"Pilaitukas (I. Kanto al. 7A)";ZUIKUČIAI;2705235576;Ne;0;1;18;19
18859;"Pilaitukas (I. Kanto al. 7A)";ZUIKUČIAI;9688421636;Ne;0;0;1;1
18860;"Pilaitukas (I. Kanto al. 7A)";ANČIUKAI;3357097410;Ne;3;2;0;5
18861;"Pilaitukas (I. Kanto al. 7A)";ANČIUKAI;7773318230;Ne;9;2;0;11
18862;"Pilaitukas (I. Kanto al. 7A)";ANČIUKAI;4097742120;Ne;0;7;0;7
18863;"Pilaitukas (I. Kanto al. 7A)";ANČIUKAI;2923272767;Ne;0;7;0;7
18864;"Pilaitukas (I. Kanto al. 7A)";ANČIUKAI;8620858011;Ne;7;0;0;7
18865;"Pilaitukas (I. Kanto al. 7A)";ANČIUKAI;4286388920;Ne;0;0;1;1
18866;"Pilaitukas (I. Kanto al. 7A)";ANČIUKAI;3761827714;Ne;0;1;3;4
18867;"Pilaitukas (I. Kanto al. 7A)";ANČIUKAI;8643066116;Ne;8;0;1;9
18868;"Pilaitukas (I. Kanto al. 7A)";ANČIUKAI;1120549352;Ne;6;0;1;7
18869;"Pilaitukas (I. Kanto al. 7A)";ANČIUKAI;6888607864;Ne;17;0;0;17
18870;"Pilaitukas (I. Kanto al. 7A)";ANČIUKAI;5490465905;Ne;5;1;0;6
18871;"Pilaitukas (I. Kanto al. 7A)";ANČIUKAI;7876850509;Ne;6;2;2;10
18872;"Pilaitukas (I. Kanto al. 7A)";ANČIUKAI;3035456834;Ne;3;1;0;4
18873;"Pilaitukas (I. Kanto al. 7A)";ANČIUKAI;2476942319;Ne;0;1;0;1
18874;"Pilaitukas (I. Kanto al. 7A)";ANČIUKAI;8033540052;Ne;10;2;1;13
18875;"Pilaitukas (I. Kanto al. 7A)";ANČIUKAI;1781762820;Ne;0;1;0;1
18876;"Pilaitukas (I. Kanto al. 7A)";ANČIUKAI;8787181006;Ne;9;0;0;9
18877;"Pilaitukas (I. Kanto al. 7A)";ANČIUKAI;7189824054;Ne;7;0;0;7
18878;"Pilaitukas (I. Kanto al. 7A)";ANČIUKAI;9332831979;Ne;0;0;1;1
18879;"Pilaitukas (I. Kanto al. 7A)";ANČIUKAI;5706918634;Ne;18;0;0;18
18880;"Pilaitukas (I. Kanto al. 7A)";ANČIUKAI;8954370321;Ne;0;0;4;4
18881;"Pilaitukas (I. Kanto al. 7A)";ANČIUKAI;1660462256;Ne;0;2;0;2
18882;"Pilaitukas (I. Kanto al. 7A)";MEŠKIUKAI;8577357264;Ne;0;2;0;2
18883;"Pilaitukas (I. Kanto al. 7A)";MEŠKIUKAI;5297214263;Ne;0;5;0;5
18884;"Pilaitukas (I. Kanto al. 7A)";MEŠKIUKAI;8268790017;Ne;3;1;0;4
18885;"Pilaitukas (I. Kanto al. 7A)";MEŠKIUKAI;2054626415;Ne;15;0;0;15
18886;"Pilaitukas (I. Kanto al. 7A)";MEŠKIUKAI;9742268665;Ne;0;22;0;22
18887;"Pilaitukas (I. Kanto al. 7A)";MEŠKIUKAI;8322980583;Ne;9;0;0;9
18888;"Pilaitukas (I. Kanto al. 7A)";MEŠKIUKAI;1610122884;Ne;1;0;0;1
18889;"Pilaitukas (I. Kanto al. 7A)";MEŠKIUKAI;3867660147;Ne;2;0;0;2
18890;"Pilaitukas (I. Kanto al. 7A)";MEŠKIUKAI;2365387089;Ne;0;0;2;2
18891;"Pilaitukas (I. Kanto al. 7A)";MEŠKIUKAI;9670329628;Ne;8;4;0;12
18892;"Pilaitukas (I. Kanto al. 7A)";MEŠKIUKAI;7750575554;Ne;11;0;0;11
18893;"Pilaitukas (I. Kanto al. 7A)";MEŠKIUKAI;9187961584;Ne;0;7;0;7
18894;"Pilaitukas (I. Kanto al. 7A)";MEŠKIUKAI;7781507786;Ne;0;0;1;1
18895;"Pilaitukas (I. Kanto al. 7A)";MEŠKIUKAI;4171896175;Ne;3;1;0;4
18896;"Pilaitukas (I. Kanto al. 7A)";MEŠKIUKAI;1362132769;Ne;0;2;0;2
18897;"Pilaitukas (I. Kanto al. 7A)";MEŠKIUKAI;3027792710;Ne;10;0;0;10
18898;"Pilaitukas (I. Kanto al. 7A)";MEŠKIUKAI;6807166920;Ne;0;2;0;2
18899;"Pilaitukas (I. Kanto al. 7A)";MEŠKIUKAI;1591276987;Ne;0;6;0;6
18900;"Pilaitukas (I. Kanto al. 7A)";MEŠKIUKAI;2830212921;Ne;8;3;0;11
18901;"Pilaitukas (I. Kanto al. 7A)";MEŠKIUKAI;9930306085;Ne;16;0;4;20
18902;"Pilaitukas (I. Kanto al. 7A)";MEŠKIUKAI;8279288250;Ne;12;0;0;12
18903;"Pilaitukas (I. Kanto al. 7A)";ŽUVYTĖS;48011638560;Ne;9;1;0;10
18904;"Pilaitukas (I. Kanto al. 7A)";ŽUVYTĖS;8109335587;Ne;0;4;0;4
18905;"Pilaitukas (I. Kanto al. 7A)";ŽUVYTĖS;9224653856;Ne;6;0;0;6
18906;"Pilaitukas (I. Kanto al. 7A)";ŽUVYTĖS;4694691187;Ne;4;0;0;4
18907;"Pilaitukas (I. Kanto al. 7A)";ŽUVYTĖS;2110458181;Ne;0;0;1;1
18908;"Pilaitukas (I. Kanto al. 7A)";ŽUVYTĖS;5252233127;Ne;0;4;0;4
18909;"Pilaitukas (I. Kanto al. 7A)";ŽUVYTĖS;5206439753;Ne;12;1;0;13
18910;"Pilaitukas (I. Kanto al. 7A)";ŽUVYTĖS;6222888898;Ne;0;5;1;6
18911;"Pilaitukas (I. Kanto al. 7A)";ŽUVYTĖS;5211988291;Ne;4;0;0;4
18912;"Pilaitukas (I. Kanto al. 7A)";ŽUVYTĖS;1512181401;Ne;7;0;0;7
18913;"Pilaitukas (I. Kanto al. 7A)";ŽUVYTĖS;2298935154;Ne;1;0;0;1
18914;"Pilaitukas (I. Kanto al. 7A)";ŽUVYTĖS;5949185075;Ne;1;1;0;2
18915;"Pilaitukas (I. Kanto al. 7A)";ŽUVYTĖS;79485847381;Ne;5;1;1;7
18916;"Pilaitukas (I. Kanto al. 7A)";ŽUVYTĖS;7909465673;Ne;2;0;0;2
18917;"Pilaitukas (I. Kanto al. 7A)";ŽUVYTĖS;58250008277;Ne;0;8;1;9
18918;"Pilaitukas (I. Kanto al. 7A)";ŽUVYTĖS;9724892897;Ne;1;0;0;1
18919;"Pilaitukas (I. Kanto al. 7A)";ŽUVYTĖS;3821748678;Ne;4;0;0;4
18920;"Pilaitukas (I. Kanto al. 7A)";ŽUVYTĖS;1114477688;Ne;5;6;0;11
18921;"Pilaitukas (I. Kanto al. 7A)";PAUKŠTELIAI;3325511140;Ne;0;4;0;4
18922;"Pilaitukas (I. Kanto al. 7A)";PAUKŠTELIAI;4505147961;Ne;0;0;1;1
18923;"Pilaitukas (I. Kanto al. 7A)";PAUKŠTELIAI;2736736697;Ne;0;2;0;2
18924;"Pilaitukas (I. Kanto al. 7A)";PAUKŠTELIAI;18466900688;Ne;0;2;0;2
18925;"Pilaitukas (I. Kanto al. 7A)";PAUKŠTELIAI;4038320896;Ne;4;1;0;5
18926;"Pilaitukas (I. Kanto al. 7A)";PAUKŠTELIAI;5689385925;Ne;6;2;1;9
18927;"Pilaitukas (I. Kanto al. 7A)";PAUKŠTELIAI;39600380611;Ne;4;1;0;5
18928;"Pilaitukas (I. Kanto al. 7A)";PAUKŠTELIAI;3214740183;Ne;5;0;0;5
18929;"Pilaitukas (I. Kanto al. 7A)";PAUKŠTELIAI;9924612250;Ne;0;0;7;7
18930;"Pilaitukas (I. Kanto al. 7A)";PAUKŠTELIAI;6117985788;Ne;5;0;0;5
18931;"Pilaitukas (I. Kanto al. 7A)";PAUKŠTELIAI;57931719105;Ne;0;2;0;2
18932;"Pilaitukas (I. Kanto al. 7A)";PAUKŠTELIAI;9618329726;Ne;0;3;0;3
18933;"Pilaitukas (I. Kanto al. 7A)";PAUKŠTELIAI;1003278169;Ne;0;1;2;3
18934;"Pilaitukas (I. Kanto al. 7A)";PAUKŠTELIAI;9450834035;Ne;0;2;0;2
18935;"Pilaitukas (I. Kanto al. 7A)";PAUKŠTELIAI;5604992163;Ne;0;2;0;2
18936;"Pilaitukas (I. Kanto al. 7A)";PAUKŠTELIAI;14554050141;Ne;0;7;0;7
18937;"Pilaitukas (I. Kanto al. 7A)";PAUKŠTELIAI;1693309238;Ne;0;1;0;1
18938;"Pilaitukas (I. Kanto al. 7A)";BORUŽĖLĖS;5984878126;Ne;0;10;2;12
18939;"Pilaitukas (I. Kanto al. 7A)";BORUŽĖLĖS;6024861998;Ne;2;0;0;2
18940;"Pilaitukas (I. Kanto al. 7A)";BORUŽĖLĖS;9898379569;Ne;0;0;1;1
18941;"Pilaitukas (I. Kanto al. 7A)";BORUŽĖLĖS;5324806808;Ne;0;0;3;3
18942;"Pilaitukas (I. Kanto al. 7A)";BORUŽĖLĖS;5185051301;Ne;0;0;2;2
18943;"Pilaitukas (I. Kanto al. 7A)";BORUŽĖLĖS;5326258755;Ne;0;15;2;17
18944;"Pilaitukas (I. Kanto al. 7A)";BORUŽĖLĖS;1731106179;Ne;0;10;0;10
18945;"Pilaitukas (I. Kanto al. 7A)";BORUŽĖLĖS;3784944532;Ne;0;0;12;12
18946;"Pilaitukas (I. Kanto al. 7A)";BORUŽĖLĖS;5186675623;Ne;22;0;0;22
18947;"Pilaitukas (I. Kanto al. 7A)";BORUŽĖLĖS;4317406707;Ne;0;0;1;1
18948;"Pilaitukas (I. Kanto al. 7A)";BORUŽĖLĖS;8380819975;Ne;0;2;0;2
18949;"Pilaitukas (I. Kanto al. 7A)";BORUŽĖLĖS;4589130143;Ne;0;0;1;1
18950;"Pilaitukas (I. Kanto al. 7A)";BORUŽĖLĖS;1944443723;Ne;7;0;3;10
18951;"Pilaitukas (I. Kanto al. 7A)";DRUGELIAI;1677962644;Ne;4;10;0;14
18952;"Pilaitukas (I. Kanto al. 7A)";DRUGELIAI;4745358362;Ne;4;10;0;14
18953;"Pilaitukas (I. Kanto al. 7A)";DRUGELIAI;2917197418;Ne;9;0;0;9
18954;"Pilaitukas (I. Kanto al. 7A)";DRUGELIAI;3298272815;Ne;15;0;1;16
18955;"Pilaitukas (I. Kanto al. 7A)";DRUGELIAI;4719223490;Ne;0;0;2;2
18956;"Pilaitukas (I. Kanto al. 7A)";DRUGELIAI;6280870972;Ne;10;0;3;13
18957;"Pilaitukas (I. Kanto al. 7A)";DRUGELIAI;9741985709;Ne;13;0;0;13
18958;"Pilaitukas (I. Kanto al. 7A)";DRUGELIAI;7807341574;Ne;16;0;0;16
18959;"Pilaitukas (I. Kanto al. 7A)";DRUGELIAI;5215800828;Ne;0;6;0;6
18960;"Pilaitukas (I. Kanto al. 7A)";DRUGELIAI;2414941263;Ne;9;0;4;13
18961;"Pilaitukas (I. Kanto al. 7A)";DRUGELIAI;2210253038;Taip;7;6;0;13
18962;"Pilaitukas (I. Kanto al. 7A)";DRUGELIAI;7222856683;Taip;2;2;0;4
18963;"Pilaitukas (I. Kanto al. 7A)";DRUGELIAI;8710069256;Ne;8;1;0;9
18964;"Pilaitukas (I. Kanto al. 7A)";DRUGELIAI;7830059468;Ne;5;5;0;10
18965;"Pilaitukas (I. Kanto al. 7A)";DRUGELIAI;7479542200;Taip;0;0;5;5
18966;"Pilaitukas (I. Kanto al. 7A)";DRUGELIAI;5901884512;Ne;3;0;0;3
18967;"Pilaitukas (I. Kanto al. 7A)";DRUGELIAI;1747834520;Ne;0;11;2;13
18968;"Pilaitukas (I. Kanto al. 7A)";PELIUKAI;9246925227;Ne;0;0;7;7
18969;"Pilaitukas (I. Kanto al. 7A)";PELIUKAI;7808204054;Ne;3;2;0;5
18970;"Pilaitukas (I. Kanto al. 7A)";PELIUKAI;4810825253;Ne;1;2;0;3
18971;"Pilaitukas (I. Kanto al. 7A)";PELIUKAI;8769116377;Ne;0;0;2;2
18972;"Pilaitukas (I. Kanto al. 7A)";PELIUKAI;8501376663;Ne;8;0;0;8
18973;"Pilaitukas (I. Kanto al. 7A)";PELIUKAI;3395656390;Ne;0;0;3;3
18974;"Pilaitukas (I. Kanto al. 7A)";PELIUKAI;5421602723;Ne;14;2;0;16
18975;"Pilaitukas (I. Kanto al. 7A)";PELIUKAI;6754825353;Ne;0;2;0;2
18976;"Pilaitukas (I. Kanto al. 7A)";PELIUKAI;8168228529;Ne;0;6;0;6
18977;"Pilaitukas (I. Kanto al. 7A)";PELIUKAI;4014329370;Ne;0;0;3;3
18978;"Pilaitukas (I. Kanto al. 7A)";PELIUKAI;6833933586;Ne;0;4;0;4
18979;"Pilaitukas (I. Kanto al. 7A)";PELIUKAI;8877142428;Ne;0;0;1;1
18980;"Pilaitukas (I. Kanto al. 7A)";PELIUKAI;2416277190;Ne;7;0;0;7
18981;"Pilaitukas (I. Kanto al. 7A)";PELIUKAI;9774222130;Ne;0;1;3;4
18982;"Pilaitukas (I. Kanto al. 7A)";PELIUKAI;7604004800;Ne;0;1;0;1
18983;"Pilaitukas (I. Kanto al. 7A)";PELIUKAI;3954210452;Ne;8;0;0;8
18984;"Pilaitukas (I. Kanto al. 7A)";PELIUKAI;5223336496;Ne;7;0;4;11
18985;"Pilaitukas (I. Kanto al. 7A)";PELIUKAI;3651140874;Ne;8;0;1;9
18986;"Pilaitukas (I. Kanto al. 7A)";PELIUKAI;7750936973;Ne;12;0;2;14
18987;"Pilaitukas (I. Kanto al. 7A)";KAČIUKAI;1585341963;Ne;9;1;0;10
18988;"Pilaitukas (I. Kanto al. 7A)";KAČIUKAI;7594484959;Ne;7;0;0;7
18989;"Pilaitukas (I. Kanto al. 7A)";KAČIUKAI;2463482642;Ne;2;9;2;13
18990;"Pilaitukas (I. Kanto al. 7A)";KAČIUKAI;3080014745;Ne;21;0;0;21
18991;"Pilaitukas (I. Kanto al. 7A)";KAČIUKAI;5353687011;Taip;2;6;0;8
18992;"Pilaitukas (I. Kanto al. 7A)";KAČIUKAI;8009040109;Ne;0;0;1;1
18993;"Pilaitukas (I. Kanto al. 7A)";KAČIUKAI;2105380328;Ne;9;0;0;9
18994;"Pilaitukas (I. Kanto al. 7A)";KAČIUKAI;5326689274;Ne;13;0;5;18
18995;"Pilaitukas (I. Kanto al. 7A)";KAČIUKAI;9653647227;Ne;13;0;5;18
18996;"Pilaitukas (I. Kanto al. 7A)";KAČIUKAI;4022543517;Ne;0;6;0;6
18997;"Pilaitukas (I. Kanto al. 7A)";KAČIUKAI;3825942473;Ne;0;14;0;14
18998;"Pilaitukas (I. Kanto al. 7A)";KAČIUKAI;1611371690;Ne;22;0;0;22
18999;"Pilaitukas (I. Kanto al. 7A)";KAČIUKAI;9247501721;Ne;12;0;0;12
19000;"Pilaitukas (I. Kanto al. 7A)";KAČIUKAI;6436694057;Ne;0;0;1;1
19001;"Pilaitukas (I. Kanto al. 7A)";KAČIUKAI;9974310580;Ne;8;0;0;8
19002;"Pilaitukas (I. Kanto al. 7A)";KAČIUKAI;6235375235;Ne;10;0;1;11
19003;"Pilaitukas (I. Kanto al. 7A)";KAČIUKAI;9914575692;Ne;1;0;0;1
19004;"Pilaitukas (I. Kanto al. 7A)";KAČIUKAI;4341157841;Ne;5;5;1;11
19005;"Pilaitukas (I. Kanto al. 7A)";SAULUTĖS;8047683859;Ne;6;2;0;8
19006;"Pilaitukas (I. Kanto al. 7A)";SAULUTĖS;8694369154;Ne;6;2;0;8
19007;"Pilaitukas (I. Kanto al. 7A)";SAULUTĖS;9405479859;Ne;6;0;0;6
19008;"Pilaitukas (I. Kanto al. 7A)";SAULUTĖS;1052452915;Ne;22;0;0;22
19009;"Pilaitukas (I. Kanto al. 7A)";SAULUTĖS;2336933998;Ne;27;0;0;27
19010;"Pilaitukas (I. Kanto al. 7A)";SAULUTĖS;1134083816;Ne;22;0;0;22
19011;"Pilaitukas (I. Kanto al. 7A)";SAULUTĖS;2110996493;Ne;5;0;2;7
19012;"Pilaitukas (I. Kanto al. 7A)";SAULUTĖS;1452645899;Ne;4;0;8;12
19013;"Pilaitukas (I. Kanto al. 7A)";SAULUTĖS;9587140991;Ne;0;2;0;2
19014;"Pilaitukas (I. Kanto al. 7A)";SAULUTĖS;8306015313;Ne;1;6;0;7
19015;"Pilaitukas (I. Kanto al. 7A)";SAULUTĖS;2215317686;Ne;0;6;0;6
19016;"Pilaitukas (I. Kanto al. 7A)";MENULIUKAI;6337917448;Ne;3;7;0;10
19017;"Pilaitukas (I. Kanto al. 7A)";MENULIUKAI;3636976107;Ne;3;8;0;11
19018;"Pilaitukas (I. Kanto al. 7A)";MENULIUKAI;5026344198;Ne;6;0;0;6
19019;"Pilaitukas (I. Kanto al. 7A)";MENULIUKAI;5564784922;Ne;8;2;0;10
19020;"Pilaitukas (I. Kanto al. 7A)";MENULIUKAI;1290017967;Ne;11;0;0;11
19021;"Pilaitukas (I. Kanto al. 7A)";MENULIUKAI;1841240800;Ne;6;0;0;6
19022;"Pilaitukas (I. Kanto al. 7A)";MENULIUKAI;4710865219;Ne;6;0;0;6
19023;"Pilaitukas (I. Kanto al. 7A)";MENULIUKAI;5691854235;Ne;10;0;0;10
19024;"Pilaitukas (I. Kanto al. 7A)";MENULIUKAI;6054821801;Ne;0;5;0;5
19025;"Pilaitukas (I. Kanto al. 7A)";MENULIUKAI;1620231835;Ne;8;1;0;9
19026;"Pilaitukas (I. Kanto al. 7A)";MENULIUKAI;8873155277;Ne;0;22;0;22
19027;"Pilaitukas (I. Kanto al. 7A)";MENULIUKAI;1532252453;Ne;13;1;0;14
19028;"Pilaitukas (I. Kanto al. 7A)";MENULIUKAI;8225571149;Ne;5;0;0;5
19029;"Pilaitukas (I. Kanto al. 7A)";MENULIUKAI;8207648026;Ne;12;0;0;12
19030;"Pilaitukas (I. Kanto al. 7A)";MENULIUKAI;3921932673;Ne;12;0;0;12
19031;"Pilaitukas (I. Kanto al. 7A)";MENULIUKAI;7855892595;Ne;5;0;0;5
19032;"Pilaitukas (I. Kanto al. 7A)";MENULIUKAI;8058057477;Ne;17;0;0;17
19033;"Pilaitukas (I. Kanto al. 7A)";MENULIUKAI;5682244165;Ne;11;0;0;11
19034;"Pilaitukas (I. Kanto al. 7A)";MENULIUKAI;3952708917;Ne;19;0;0;19
19035;"Pilaitukas (I. Kanto al. 7A)";ĖŽIUKAI;1568651642;Ne;0;0;9;9
19036;"Pilaitukas (I. Kanto al. 7A)";ĖŽIUKAI;2892275540;Ne;0;10;3;13
19037;"Pilaitukas (I. Kanto al. 7A)";ĖŽIUKAI;1746050808;Ne;10;0;0;10
19038;"Pilaitukas (I. Kanto al. 7A)";ĖŽIUKAI;2633256935;Ne;6;4;0;10
19039;"Pilaitukas (I. Kanto al. 7A)";ĖŽIUKAI;8747053041;Ne;6;4;0;10
19040;"Pilaitukas (I. Kanto al. 7A)";ĖŽIUKAI;7555601497;Ne;5;0;2;7
19041;"Pilaitukas (I. Kanto al. 7A)";ĖŽIUKAI;6019760696;Ne;9;0;2;11
19042;"Pilaitukas (I. Kanto al. 7A)";ĖŽIUKAI;5979852431;Ne;7;6;0;13
19043;"Pilaitukas (I. Kanto al. 7A)";ĖŽIUKAI;9950619644;Ne;12;0;2;14
19044;"Pilaitukas (I. Kanto al. 7A)";ĖŽIUKAI;8682279246;Taip;0;22;0;22
19045;"Pilaitukas (I. Kanto al. 7A)";ĖŽIUKAI;6271751691;Ne;11;0;0;11
19046;"Pilaitukas (I. Kanto al. 7A)";ĖŽIUKAI;9306169443;Ne;0;1;0;1
19047;"Pilaitukas (I. Kanto al. 7A)";ĖŽIUKAI;5155899628;Ne;9;0;0;9
19048;"Pilaitukas (I. Kanto al. 7A)";ĖŽIUKAI;5340877261;Ne;11;0;0;11
19049;"Pilaitukas (I. Kanto al. 7A)";ĖŽIUKAI;2342453729;Ne;10;0;0;10
19050;"Pilaitukas (I. Kanto al. 7A)";ĖŽIUKAI;6064545501;Ne;0;6;0;6
19051;"Pilaitukas (I. Kanto al. 7A)";ĖŽIUKAI;5904710385;Ne;12;0;0;12
19052;"Pilaitukas (I. Kanto al. 7A)";ĖŽIUKAI;1486895496;Ne;9;0;0;9
19053;"Pilaitukas (I. Kanto al. 7A)";ĖŽIUKAI;9441608677;Ne;7;0;1;8
19054;Vilija;NYKŠTUKAI;8248774222;Ne;8;0;0;8
19055;Vilija;NYKŠTUKAI;7009463901;Ne;0;10;0;10
19056;Vilija;NYKŠTUKAI;66817455759;Ne;0;2;0;2
19057;Vilija;NYKŠTUKAI;3201809038;Ne;14;0;0;14
19058;Vilija;NYKŠTUKAI;7469836390;Ne;0;6;0;6
19059;Vilija;NYKŠTUKAI;8364033602;Ne;0;3;0;3
19060;Vilija;NYKŠTUKAI;6136579994;Ne;12;5;0;17
19061;Vilija;NYKŠTUKAI;5563356449;Ne;0;5;0;5
19062;Vilija;NYKŠTUKAI;1717847351;Ne;2;5;0;7
19063;Vilija;NYKŠTUKAI;1751533938;Ne;0;7;0;7
19064;Vilija;ANČIUKAI;5643311237;Ne;0;4;0;4
19065;Vilija;ANČIUKAI;8073341597;Ne;0;2;0;2
19066;Vilija;ANČIUKAI;8493278100;Ne;0;17;0;17
19067;Vilija;ANČIUKAI;3556336263;Ne;11;0;0;11
19068;Vilija;ANČIUKAI;3552472323;Ne;0;12;0;12
19069;Vilija;ANČIUKAI;7012683174;Ne;6;0;0;6
19070;Vilija;ANČIUKAI;4400813531;Ne;0;1;0;1
19071;Vilija;ANČIUKAI;5454031929;Ne;0;8;0;8
19072;Vilija;ANČIUKAI;3677313088;Ne;0;9;0;9
19073;Vilija;ANČIUKAI;2371667380;Ne;0;7;0;7
19074;Vilija;DRUGELIAI;2205400512;Ne;6;0;0;6
19075;Vilija;DRUGELIAI;3131712783;Ne;5;2;0;7
19076;Vilija;DRUGELIAI;2807100092;Ne;0;2;0;2
19077;Vilija;DRUGELIAI;5340772605;Ne;9;0;0;9
19078;Vilija;DRUGELIAI;3667953591;Ne;2;0;0;2
19079;Vilija;DRUGELIAI;7836199284;Ne;0;3;0;3
19080;Vilija;DRUGELIAI;5455278072;Ne;0;9;0;9
19081;Vilija;DRUGELIAI;8420744276;Ne;0;8;0;8
19082;Vilija;SMERFAI;7927617851;Ne;6;2;0;8
19083;Vilija;SMERFAI;5508269515;Ne;0;3;0;3
19084;Vilija;SMERFAI;2164009051;Ne;0;4;0;4
19085;Vilija;SMERFAI;5617568215;Ne;6;0;0;6
19086;Vilija;SMERFAI;5056566642;Ne;2;2;0;4
19087;Vilija;SMERFAI;3058713381;Ne;0;5;0;5
19088;Vilija;SMERFAI;4297107641;Ne;0;8;0;8
19089;Vilija;SMERFAI;6165754839;Ne;1;0;0;1
19090;Vilija;SMERFAI;6937555692;Ne;9;0;0;9
19091;Vilija;SMERFAI;1580316618;Ne;5;0;0;5
19092;Vilija;SMERFAI;7606434084;Ne;2;0;0;2
19093;Vilija;SMERFAI;5825920843;Ne;0;1;0;1
19094;Vilija;SAULUTĖS;7749592467;Ne;4;0;0;4
19095;Vilija;SAULUTĖS;5653564054;Ne;5;0;0;5
19096;Vilija;SAULUTĖS;5561043797;Ne;4;0;0;4
19097;Vilija;SAULUTĖS;7673248841;Ne;0;7;0;7
19098;Vilija;SAULUTĖS;4481147539;Ne;7;5;0;12
19099;Vilija;SAULUTĖS;1290880830;Ne;1;0;0;1
19100;Vilija;SAULUTĖS;6792458439;Ne;5;0;0;5
19101;Vilija;SAULUTĖS;7603226092;Ne;0;1;0;1
19102;Vilija;SAULUTĖS;2551070326;Ne;3;0;0;3
19103;Vilija;ZUIKUČIAI;5128863532;Ne;6;0;0;6
19104;Vilija;ZUIKUČIAI;7194803557;Ne;0;4;0;4
19105;Vilija;ZUIKUČIAI;9726826566;Ne;6;1;0;7
19106;Vilija;ZUIKUČIAI;8586835095;Ne;6;0;0;6
19107;Vilija;ZUIKUČIAI;9414667437;Ne;0;8;0;8
19108;Vilija;ZUIKUČIAI;9264550987;Ne;8;0;0;8
19109;Vilija;ZUIKUČIAI;5381198018;Ne;0;4;0;4
19110;Vilija;ZUIKUČIAI;4355138593;Ne;11;1;0;12
19111;Vilija;ZUIKUČIAI;4902127595;Ne;5;0;0;5
19112;Vilija;ZUIKUČIAI;4444129040;Ne;0;2;0;2
19113;Vilija;ZUIKUČIAI;3168061557;Ne;5;0;0;5
19114;Vilija;ZUIKUČIAI;5492194393;Ne;6;1;0;7
19115;Vilija;ZUIKUČIAI;4818901769;Ne;7;0;0;7
19116;Vilija;ZUIKUČIAI;6759928420;Ne;2;0;0;2
19117;Vilija;ZUIKUČIAI;4839841253;Ne;0;2;0;2
19118;Vilija;BITUTĖS;4973314993;Ne;0;2;0;2
19119;Vilija;BITUTĖS;9419794080;Ne;1;0;0;1
19120;Vilija;BITUTĖS;1019420340;Ne;8;0;0;8
19121;Vilija;BITUTĖS;9174484523;Ne;5;0;0;5
19122;Vilija;BITUTĖS;5102754179;Ne;0;8;0;8
19123;Vilija;BITUTĖS;8220360728;Ne;2;0;0;2
19124;Vilija;BITUTĖS;8499318976;Ne;0;6;0;6
19125;Vilija;BITUTĖS;1804898751;Ne;12;0;0;12
19126;Vilija;BITUTĖS;9979578408;Ne;7;0;0;7
19127;Vilija;BITUTĖS;9250902486;Ne;7;0;0;7
19128;Vilija;BITUTĖS;6655890861;Ne;0;5;0;5
19129;Vilija;BITUTĖS;4137025486;Ne;1;1;0;2
19130;Vilija;BITUTĖS;7004389875;Ne;7;0;0;7
19131;Vilija;"Pingviniukai (Laisvės pr. 57)";2731415182;Ne;7;9;0;16
19132;Vilija;"Pingviniukai (Laisvės pr. 57)";4639407305;Ne;13;0;0;13
19133;Vilija;"Pingviniukai (Laisvės pr. 57)";2859663283;Ne;5;0;0;5
19134;Vilija;"Pingviniukai (Laisvės pr. 57)";2903151334;Ne;0;2;0;2
19135;Vilija;"Pingviniukai (Laisvės pr. 57)";7815069972;Ne;5;0;0;5
19136;Vilija;"Pingviniukai (Laisvės pr. 57)";6625339545;Ne;8;0;0;8
19137;Vilija;"Pingviniukai (Laisvės pr. 57)";4179106082;Ne;7;0;0;7
19138;Vilija;"Pingviniukai (Laisvės pr. 57)";2442272908;Ne;8;0;0;8
19139;Vilija;"Pingviniukai (Laisvės pr. 57)";1845561597;Ne;5;0;0;5
19140;Vilija;"Pingviniukai (Laisvės pr. 57)";1354769998;Ne;6;0;0;6
19141;Vilija;"Pingviniukai (Laisvės pr. 57)";2872066559;Ne;2;0;0;2
19142;Vilija;"Pingviniukai (Laisvės pr. 57)";7219010961;Ne;7;0;0;7
19143;Vilija;"Pingviniukai (Laisvės pr. 57)";5840005178;Ne;7;0;0;7
19144;Vilija;"Pingviniukai (Laisvės pr. 57)";6855296751;Ne;5;0;0;5
19145;Vilija;"Pingviniukai (Laisvės pr. 57)";2506766222;Ne;4;1;0;5
19146;Vilija;"Pingviniukai (Laisvės pr. 57)";2076388581;Ne;20;0;0;20
19147;Vilija;"Meškiukai (Laisvės pr. 57)";1337656706;Ne;13;0;0;13
19148;Vilija;"Meškiukai (Laisvės pr. 57)";7518841522;Ne;12;0;0;12
19149;Vilija;"Meškiukai (Laisvės pr. 57)";3700333490;Ne;10;0;0;10
19150;Vilija;"Meškiukai (Laisvės pr. 57)";2725051611;Ne;19;1;0;20
19151;Vilija;"Meškiukai (Laisvės pr. 57)";7889810385;Ne;17;0;0;17
19152;Vilija;"Meškiukai (Laisvės pr. 57)";1233653513;Ne;0;5;0;5
19153;Vilija;"Meškiukai (Laisvės pr. 57)";2294228885;Ne;16;0;0;16
19154;Vilija;"Meškiukai (Laisvės pr. 57)";7735728034;Ne;0;4;0;4
19155;Vilija;"Meškiukai (Laisvės pr. 57)";7947071463;Ne;12;0;0;12
19156;Vilija;"Meškiukai (Laisvės pr. 57)";4921409780;Ne;17;1;0;18
19157;Vilija;"Meškiukai (Laisvės pr. 57)";6557918266;Ne;5;0;0;5
19158;Vilija;"Meškiukai (Laisvės pr. 57)";9163803569;Ne;6;0;0;6
19159;Vilija;"Meškiukai (Laisvės pr. 57)";2501118611;Ne;4;0;0;4
19160;Vilija;"Meškiukai (Laisvės pr. 57)";7001209450;Ne;14;2;0;16
19161;Vilija;"Meškiukai (Laisvės pr. 57)";5166455649;Ne;11;0;0;11
19162;Vilija;"Ramunėlės (Laisvės pr. 57)";7707208780;Ne;7;4;0;11
19163;Vilija;"Ramunėlės (Laisvės pr. 57)";9261213181;Ne;10;0;0;10
19164;Vilija;"Ramunėlės (Laisvės pr. 57)";5034597412;Ne;12;3;0;15
19165;Vilija;"Ramunėlės (Laisvės pr. 57)";5999958057;Ne;10;0;0;10
19166;Vilija;"Ramunėlės (Laisvės pr. 57)";6142340523;Ne;12;0;0;12
19167;Vilija;"Ramunėlės (Laisvės pr. 57)";4798370162;Ne;15;2;0;17
19168;Vilija;"Ramunėlės (Laisvės pr. 57)";2036033312;Ne;0;8;0;8
19169;Vilija;"Ramunėlės (Laisvės pr. 57)";1902217772;Ne;17;0;0;17
19170;Vilija;"Ramunėlės (Laisvės pr. 57)";9377088075;Ne;10;0;0;10
19171;Vilija;"Ramunėlės (Laisvės pr. 57)";6177733291;Ne;12;0;0;12
19172;Vilija;"Ramunėlės (Laisvės pr. 57)";2455384784;Ne;6;1;0;7
19173;Vilija;"Ramunėlės (Laisvės pr. 57)";9278725667;Ne;0;5;0;5
19174;Vilija;"Varpeliai (Laisvės pr. 57)";5277217733;Ne;7;7;0;14
19175;Vilija;"Varpeliai (Laisvės pr. 57)";1502013942;Ne;15;0;0;15
19176;Vilija;"Varpeliai (Laisvės pr. 57)";4969561425;Ne;7;0;0;7
19177;Vilija;"Varpeliai (Laisvės pr. 57)";3589001032;Ne;22;0;0;22
19178;Vilija;"Varpeliai (Laisvės pr. 57)";4692443164;Ne;4;0;0;4
19179;Vilija;"Varpeliai (Laisvės pr. 57)";7426713153;Ne;10;0;0;10
19180;Vilija;"Varpeliai (Laisvės pr. 57)";3062594197;Ne;10;0;0;10
19181;Vilija;"Voveraitės (Laisvės pr. 57)";9640071277;Ne;5;0;0;5
19182;Vilija;"Voveraitės (Laisvės pr. 57)";7522129675;Ne;7;0;0;7
19183;Vilija;"Voveraitės (Laisvės pr. 57)";8923074604;Ne;0;3;0;3
19184;Vilija;"Voveraitės (Laisvės pr. 57)";3948140208;Ne;5;0;0;5
19185;Vilija;"Voveraitės (Laisvės pr. 57)";5229557734;Ne;16;0;0;16
19186;Vilija;"Voveraitės (Laisvės pr. 57)";8758253294;Ne;9;5;0;14
19187;Vilija;"Voveraitės (Laisvės pr. 57)";6496861835;Ne;9;5;0;14
19188;Vilija;"Voveraitės (Laisvės pr. 57)";6782229835;Ne;7;8;0;15
19189;Vilija;"Voveraitės (Laisvės pr. 57)";2910501252;Ne;14;0;0;14
19190;Vilija;"Voveraitės (Laisvės pr. 57)";4936982698;Ne;10;0;0;10
19191;Vilija;"Voveraitės (Laisvės pr. 57)";4873345183;Ne;9;0;0;9
19192;Vilija;"Voveraitės (Laisvės pr. 57)";3654655172;Ne;0;8;0;8
19193;Vilija;"Voveraitės (Laisvės pr. 57)";7184118489;Ne;11;0;0;11
19194;Vilija;"Voveraitės (Laisvės pr. 57)";3095065890;Ne;7;0;0;7
19195;Vilija;"Voveraitės (Laisvės pr. 57)";5450812526;Ne;5;0;0;5
19196;Vilija;"Voveraitės (Laisvės pr. 57)";7389324585;Ne;2;0;0;2
19197;Vilija;"Pelėdžiukai (Laisvės pr. 57)";7358925256;Ne;4;0;0;4
19198;Vilija;"Pelėdžiukai (Laisvės pr. 57)";2778931038;Ne;5;0;0;5
19199;Vilija;"Pelėdžiukai (Laisvės pr. 57)";8465864375;Ne;2;1;0;3
19200;Vilija;"Pelėdžiukai (Laisvės pr. 57)";4437786689;Ne;9;0;0;9
19201;Vilija;"Pelėdžiukai (Laisvės pr. 57)";1306244736;Ne;17;0;0;17
19202;Vilija;"Pelėdžiukai (Laisvės pr. 57)";9117896572;Ne;7;3;0;10
19203;Vilija;"Pelėdžiukai (Laisvės pr. 57)";5821077318;Ne;0;13;0;13
19204;Vilija;"Pelėdžiukai (Laisvės pr. 57)";8186421282;Ne;9;0;0;9
19205;Vilija;"Pelėdžiukai (Laisvės pr. 57)";8815055819;Ne;5;5;0;10
19206;Vilija;"Pelėdžiukai (Laisvės pr. 57)";9750688419;Ne;0;14;0;14
19207;Vilija;"Pelėdžiukai (Laisvės pr. 57)";1778722493;Ne;9;0;0;9
19208;Vilija;"Pelėdžiukai (Laisvės pr. 57)";6581404954;Ne;8;0;0;8
19209;Vilija;"Pelėdžiukai (Laisvės pr. 57)";7869675895;Ne;17;1;0;18
19210;Vilija;"1 B klasė";96636312334;Ne;15;0;0;15
19211;Švelnukas;Pelėdžiukai;8016531082;Ne;5;8;4;17
19212;Švelnukas;Pelėdžiukai;8219071968;Ne;0;2;3;5
19213;Švelnukas;Pelėdžiukai;9008722163;Ne;0;10;0;10
19214;Švelnukas;Pelėdžiukai;5699300764;Ne;5;0;0;5
19215;Švelnukas;Pelėdžiukai;1116279011;Ne;22;0;0;22
19216;Švelnukas;Pelėdžiukai;3892058023;Ne;22;0;0;22
19217;Švelnukas;Pelėdžiukai;5681611554;Ne;11;0;2;13
19218;Švelnukas;Pelėdžiukai;8589226595;Ne;7;1;0;8
19219;Švelnukas;Pelėdžiukai;9802064955;Ne;0;6;0;6
19220;Švelnukas;Pelėdžiukai;8650902343;Ne;1;0;1;2
19221;Švelnukas;Pelėdžiukai;1409803554;Ne;0;6;0;6
19222;Švelnukas;Pelėdžiukai;1991507109;Ne;6;3;0;9
19223;Švelnukas;Pelėdžiukai;9808833734;Ne;5;0;1;6
19224;Švelnukas;Pelėdžiukai;6069027553;Ne;22;0;0;22
19225;Švelnukas;Pelėdžiukai;9814032171;Ne;0;5;0;5
19226;Švelnukas;Ežiukai;64192510147;Ne;0;1;0;1
19227;Švelnukas;Ežiukai;25374873288;Ne;0;1;0;1
19228;Švelnukas;Ežiukai;8399963483;Ne;0;2;0;2
19229;Švelnukas;Ežiukai;4711482287;Ne;0;1;0;1
19230;Švelnukas;Ežiukai;4373567509;Ne;0;10;0;10
19231;Švelnukas;Ežiukai;2521009631;Ne;0;0;1;1
19232;Švelnukas;Ežiukai;1165172787;Ne;12;1;0;13
19233;Švelnukas;Ežiukai;2892176166;Ne;0;0;3;3
19234;Švelnukas;Ežiukai;7308701231;Ne;0;0;2;2
19235;Švelnukas;Ežiukai;6209334207;Ne;5;0;5;10
19236;Švelnukas;Ežiukai;2348752207;Ne;0;22;0;22
19237;Švelnukas;Ežiukai;1143579276;Ne;0;0;1;1
19238;Švelnukas;Ežiukai;5409130195;Ne;5;0;0;5
19239;Švelnukas;Ežiukai;3645855145;Ne;0;10;0;10
19240;Švelnukas;Ežiukai;9402567487;Ne;8;0;1;9
19241;Švelnukas;Ežiukai;8569985034;Ne;0;6;0;6
19242;Švelnukas;Švelnukai;4681584014;Ne;0;0;7;7
19243;Švelnukas;Švelnukai;6607578153;Ne;10;0;0;10
19244;Švelnukas;Švelnukai;8847738918;Ne;0;1;0;1
19245;Švelnukas;Švelnukai;1982267458;Ne;0;0;4;4
19246;Švelnukas;Švelnukai;9766734938;Ne;0;0;2;2
19247;Švelnukas;Švelnukai;3020524039;Ne;2;0;0;2
19248;Švelnukas;Švelnukai;9829912750;Ne;0;2;1;3
19249;Švelnukas;Švelnukai;5032829856;Ne;0;0;1;1
19250;Švelnukas;Švelnukai;5213589179;Ne;0;9;0;9
19251;Švelnukas;Švelnukai;4544791546;Ne;5;0;0;5
19252;Švelnukas;Švelnukai;1963518457;Ne;7;0;0;7
19253;Švelnukas;Švelnukai;4194249709;Ne;0;3;1;4
19254;Švelnukas;Švelnukai;5936821902;Ne;7;0;0;7
19255;Švelnukas;Švelnukai;7607215137;Ne;8;0;0;8
19256;Švelnukas;Švelnukai;4629757899;Ne;0;8;0;8
19257;Švelnukas;Švelnukai;6964997767;Ne;0;0;1;1
19258;Švelnukas;Švelnukai;8951810066;Ne;7;0;1;8
19259;Švelnukas;Švelnukai;2663990082;Ne;1;0;2;3
19260;Švelnukas;Švelnukai;6204286255;Ne;0;1;0;1
19261;Švelnukas;Švelnukai;5960966542;Ne;0;1;0;1
19262;Švelnukas;Boružiukai;3849957906;Ne;0;0;10;10
19263;Švelnukas;Boružiukai;5550841477;Ne;13;0;0;13
19264;Švelnukas;Boružiukai;1264256177;Ne;0;0;3;3
19265;Švelnukas;Boružiukai;1332533332;Ne;5;0;1;6
19266;Švelnukas;Boružiukai;8787505507;Ne;0;1;2;3
19267;Švelnukas;Boružiukai;8458233793;Ne;0;5;0;5
19268;Švelnukas;Boružiukai;7967996032;Ne;0;3;7;10
19269;Švelnukas;Boružiukai;8951980999;Ne;0;0;2;2
19270;Švelnukas;Boružiukai;4990399144;Ne;5;9;1;15
19271;Švelnukas;Boružiukai;9575767514;Ne;0;0;15;15
19272;Švelnukas;Boružiukai;6282137936;Ne;4;1;0;5
19273;Švelnukas;Boružiukai;9479536507;Ne;0;4;0;4
19274;Švelnukas;Boružiukai;2088128734;Ne;5;0;0;5
19275;Švelnukas;Boružiukai;2077614498;Ne;4;0;1;5
19276;Švelnukas;Boružiukai;3145935641;Ne;0;1;0;1
19277;Švelnukas;Boružiukai;4404904322;Ne;0;0;2;2
19278;Švelnukas;Boružiukai;3561920685;Ne;0;0;5;5
19279;Švelnukas;Boružiukai;8895028305;Ne;2;0;9;11
19280;Švelnukas;Boružiukai;4961854528;Ne;0;0;3;3
19281;Švelnukas;Smalsučiai;1661019352;Ne;0;3;0;3
19282;Švelnukas;Smalsučiai;5554625346;Ne;0;1;0;1
19283;Švelnukas;Smalsučiai;3282020958;Ne;0;1;0;1
19284;Švelnukas;Smalsučiai;5805289419;Ne;0;0;5;5
19285;Švelnukas;Smalsučiai;7987715134;Ne;0;0;1;1
19286;Švelnukas;Smalsučiai;3455801077;Ne;5;0;0;5
19287;Švelnukas;Smalsučiai;8193690277;Ne;0;1;2;3
19288;Švelnukas;Smalsučiai;9371102717;Ne;0;22;0;22
19289;Švelnukas;Smalsučiai;3472774028;Ne;6;0;3;9
19290;Švelnukas;Smalsučiai;5845744917;Ne;0;0;2;2
19291;Švelnukas;Smalsučiai;6764222588;Ne;0;0;16;16
19292;Švelnukas;Smalsučiai;1840752560;Ne;5;2;0;7
19293;Švelnukas;Smalsučiai;4467095100;Ne;0;0;2;2
19294;Švelnukas;Nykštukai;1293700097;Ne;0;0;4;4
19295;Švelnukas;Nykštukai;8221642452;Ne;0;0;3;3
19296;Švelnukas;Nykštukai;2141519946;Ne;0;1;0;1
19297;Švelnukas;Nykštukai;8771953161;Ne;5;0;3;8
19298;Švelnukas;Nykštukai;5327209876;Ne;0;2;0;2
19299;Švelnukas;Nykštukai;2282356211;Ne;2;1;0;3
19300;Švelnukas;Nykštukai;4697253853;Ne;0;0;6;6
19301;Švelnukas;Nykštukai;7387060610;Ne;0;2;0;2
19302;Švelnukas;Nykštukai;1762528313;Ne;0;0;3;3
19303;Švelnukas;Nykštukai;3370028567;Ne;5;1;0;6
19304;Švelnukas;Nykštukai;6633233824;Ne;0;0;1;1
19305;Švelnukas;Nykštukai;2106591525;Ne;0;0;1;1
19306;Švelnukas;Nykštukai;93497358197;Ne;0;14;0;14
19307;Švelnukas;Nykštukai;4302735157;Ne;0;0;2;2
19308;Švelnukas;Nykštukai;2785396019;Ne;0;0;9;9
19309;Boružėlė;"Nykštukai gudručiai";7736917485;Ne;0;22;0;22
19310;Boružėlė;"Nykštukai gudručiai";9520696660;Ne;0;1;3;4
19311;Boružėlė;"Nykštukai gudručiai";5691884576;Ne;5;2;0;7
19312;Boružėlė;"Nykštukai gudručiai";9193273478;Ne;10;0;0;10
19313;Boružėlė;"Nykštukai gudručiai";3237771499;Ne;2;4;0;6
19314;Boružėlė;"Nykštukai gudručiai";8359957290;Ne;0;9;0;9
19315;Boružėlė;"Nykštukai gudručiai";8141240094;Ne;0;0;9;9
19316;Boružėlė;"Nykštukai gudručiai";2349571778;Ne;0;2;0;2
19317;Boružėlė;"Nykštukai gudručiai";1894170218;Ne;8;0;0;8
19318;Boružėlė;"Nykštukai gudručiai";3509512899;Ne;17;0;0;17
19319;Boružėlė;"Nykštukai gudručiai";8888151470;Ne;18;1;0;19
19320;Boružėlė;"Nykštukai gudručiai";3430953692;Ne;3;1;0;4
19321;Boružėlė;"Nykštukai gudručiai";8365962523;Ne;0;1;2;3
19322;Boružėlė;"Nykštukai gudručiai";3592853535;Ne;0;6;0;6
19323;Boružėlė;"Nykštukai gudručiai";6876323023;Ne;0;1;0;1
19324;Boružėlė;"Nykštukai gudručiai";2744894565;Ne;0;15;0;15
19325;Boružėlė;"Nykštukai gudručiai";6590829182;Ne;2;2;3;7
19326;Boružėlė;"Nykštukai gudručiai";3129825206;Ne;0;10;0;10
19327;Boružėlė;"Nykštukai gudručiai";9771767352;Ne;0;6;0;6
19328;Boružėlė;"Nykštukai gudručiai";8789209196;Ne;0;10;0;10
19329;Boružėlė;"Nykštukai gudručiai";9078805020;Ne;0;6;0;6
19330;Boružėlė;"Saulės zuikučiai";4554260776;Ne;2;3;0;5
19331;Boružėlė;"Saulės zuikučiai";5298170118;Ne;0;4;0;4
19332;Boružėlė;"Saulės zuikučiai";1116012068;Ne;0;3;0;3
19333;Boružėlė;"Saulės zuikučiai";7256396576;Ne;0;1;0;1
19334;Boružėlė;"Saulės zuikučiai";2087238951;Ne;0;2;1;3
19335;Boružėlė;"Saulės zuikučiai";5516103398;Ne;0;0;7;7
19336;Boružėlė;"Saulės zuikučiai";8259586236;Ne;0;2;0;2
19337;Boružėlė;"Saulės zuikučiai";3955841578;Ne;0;1;0;1
19338;Boružėlė;"Saulės zuikučiai";1583223569;Ne;0;1;0;1
19339;Boružėlė;"Saulės zuikučiai";4433248526;Ne;0;0;2;2
19340;Boružėlė;"Saulės zuikučiai";1547802140;Ne;8;5;0;13
19341;Boružėlė;"Saulės zuikučiai";4020348640;Ne;0;0;1;1
19342;Boružėlė;"Saulės zuikučiai";2842256033;Ne;0;2;4;6
19343;Boružėlė;"Saulės zuikučiai";2561969142;Ne;0;2;4;6
19344;Boružėlė;"Saulės zuikučiai";7262515868;Ne;0;1;0;1
19345;Boružėlė;"Saulės zuikučiai";6527254253;Ne;0;3;0;3
19346;Boružėlė;"Saulės zuikučiai";7942043844;Ne;0;3;0;3
19347;Boružėlė;"Saulės zuikučiai";2515608520;Ne;5;2;0;7
19348;Boružėlė;Gėlytės;3288141024;Ne;4;3;0;7
19349;Boružėlė;Gėlytės;1166207929;Ne;0;2;1;3
19350;Boružėlė;Gėlytės;7956982615;Ne;0;2;2;4
19351;Boružėlė;Gėlytės;4637656311;Ne;2;5;0;7
19352;Boružėlė;Gėlytės;6070356395;Ne;5;4;0;9
19353;Boružėlė;Gėlytės;4180537253;Ne;5;2;0;7
19354;Boružėlė;Gėlytės;6722353853;Ne;12;1;0;13
19355;Boružėlė;Gėlytės;8376436755;Ne;0;2;0;2
19356;Boružėlė;Gėlytės;3354291446;Ne;6;0;0;6
19357;Boružėlė;Gėlytės;8520403894;Ne;7;0;0;7
19358;Boružėlė;Gėlytės;4268486154;Ne;0;0;1;1
19359;Boružėlė;Gėlytės;7614216150;Ne;0;2;1;3
19360;Boružėlė;Gėlytės;4448964310;Ne;0;0;3;3
19361;Boružėlė;Gėlytės;8205706322;Ne;0;2;6;8
19362;Boružėlė;Gėlytės;8834231529;Ne;10;11;0;21
19363;Boružėlė;Gėlytės;8929444125;Ne;0;0;6;6
19364;Boružėlė;Smalsutis;2086485441;Ne;0;10;0;10
19365;Boružėlė;Smalsutis;5129244830;Ne;0;8;0;8
19366;Boružėlė;Smalsutis;6927100979;Ne;0;6;0;6
19367;Boružėlė;Smalsutis;4947670606;Ne;0;6;3;9
19368;Boružėlė;Smalsutis;2917508421;Ne;4;0;1;5
19369;Boružėlė;Smalsutis;7263730692;Ne;0;2;0;2
19370;Boružėlė;Smalsutis;5708558321;Ne;0;2;2;4
19371;Boružėlė;Smalsutis;6484173786;Ne;0;1;0;1
19372;Boružėlė;Smalsutis;6742157071;Ne;0;0;2;2
19373;Boružėlė;Smalsutis;2132904457;Ne;0;2;0;2
19374;Boružėlė;Smalsutis;39553430808;Ne;0;5;3;8
19375;Boružėlė;Smalsutis;4958704459;Ne;0;5;0;5
19376;Boružėlė;Smalsutis;4283064680;Ne;0;14;3;17
19377;Boružėlė;Smalsutis;2447148171;Ne;3;2;1;6
19378;Boružėlė;Smalsutis;1391562352;Ne;3;0;0;3
19379;Boružėlė;Smalsutis;7386694567;Ne;0;3;0;3
19380;Boružėlė;Smalsutis;9634967237;Ne;0;1;0;1
19381;Boružėlė;Smalsutis;3592594142;Ne;0;3;0;3
19382;Boružėlė;Drugeliai;8357946299;Ne;11;11;0;22
19383;Boružėlė;Drugeliai;1130980139;Ne;0;6;0;6
19384;Boružėlė;Drugeliai;6463583187;Ne;0;2;0;2
19385;Boružėlė;Drugeliai;3136028536;Ne;0;7;0;7
19386;Boružėlė;Drugeliai;2211576663;Ne;0;6;0;6
19387;Boružėlė;Drugeliai;1559001916;Ne;0;2;0;2
19388;Boružėlė;Drugeliai;4233602822;Ne;0;1;0;1
19389;Boružėlė;Drugeliai;9463322491;Ne;0;2;0;2
19390;Boružėlė;Drugeliai;3108758436;Ne;7;0;0;7
19391;Boružėlė;Drugeliai;8482813204;Ne;1;1;0;2
19392;Boružėlė;Drugeliai;6369070055;Ne;2;0;0;2
19393;Boružėlė;Drugeliai;6902130914;Ne;0;6;4;10
19394;Boružėlė;Drugeliai;6980022864;Ne;2;0;0;2
19395;Boružėlė;Drugeliai;5726187445;Ne;0;1;0;1
19396;Boružėlė;Drugeliai;3405184929;Ne;0;0;5;5
19397;Boružėlė;Drugeliai;8213060214;Ne;7;0;0;7
19398;Boružėlė;Drugeliai;3331238309;Ne;0;0;7;7
19399;Boružėlė;Drugeliai;2783338563;Ne;0;2;0;2
19400;Boružėlė;Vyturėliai;1913540317;Ne;5;2;0;7
19401;Boružėlė;Vyturėliai;1950269258;Ne;0;3;0;3
19402;Boružėlė;Vyturėliai;1591582954;Ne;0;15;0;15
19403;Boružėlė;Vyturėliai;3322567969;Ne;7;2;0;9
19404;Boružėlė;Vyturėliai;8311383437;Ne;2;3;0;5
19405;Boružėlė;Vyturėliai;7534482245;Ne;12;4;0;16
19406;Boružėlė;Vyturėliai;3310676316;Ne;0;4;0;4
19407;Boružėlė;Vyturėliai;87834777247;Ne;0;8;0;8
19408;Boružėlė;Vyturėliai;50071056728;Ne;8;8;0;16
19409;Boružėlė;Vyturėliai;43300167107;Ne;0;1;0;1
19410;Boružėlė;Vyturėliai;2098408445;Ne;0;9;0;9
19411;Boružėlė;Vyturėliai;8146684259;Ne;0;9;0;9
19412;Boružėlė;Vyturėliai;8225622711;Ne;0;2;0;2
19413;Boružėlė;Vyturėliai;9150703371;Ne;0;18;0;18
19414;Boružėlė;Vyturėliai;5811751925;Ne;0;9;0;9
19415;Boružėlė;Vyturėliai;7136428795;Ne;0;5;0;5
19416;Boružėlė;Vyturėliai;9640681773;Ne;0;0;22;22
19417;Boružėlė;Vyturėliai;5576016171;Ne;0;2;1;3
19418;Boružėlė;Žvaigždutės;4990831292;Ne;5;2;0;7
19419;Boružėlė;Žvaigždutės;9838823214;Ne;0;5;0;5
19420;Boružėlė;Žvaigždutės;7901880926;Ne;0;0;1;1
19421;Boružėlė;Žvaigždutės;3489498503;Ne;3;10;0;13
19422;Boružėlė;Žvaigždutės;5274016839;Ne;0;1;0;1
19423;Boružėlė;Žvaigždutės;9720535449;Ne;0;6;0;6
19424;Boružėlė;Žvaigždutės;6435556131;Ne;0;6;0;6
19425;Boružėlė;Žvaigždutės;3140264242;Ne;0;5;0;5
19426;Boružėlė;Žvaigždutės;5307997577;Ne;10;10;0;20
19427;Boružėlė;Žvaigždutės;8916241914;Ne;0;7;0;7
19428;Boružėlė;Žvaigždutės;6724101421;Ne;6;2;0;8
19429;Boružėlė;Žvaigždutės;7078709057;Ne;0;6;0;6
19430;Boružėlė;Žvaigždutės;6972646373;Ne;0;7;0;7
19431;Boružėlė;Žvaigždutės;8820827882;Ne;5;9;1;15
19432;Boružėlė;Žvaigždutės;2857645329;Ne;3;7;0;10
19433;Boružėlė;Žvaigždutės;5242187638;Ne;8;3;0;11
19434;Boružėlė;Žvaigždutės;1799882790;Ne;0;9;0;9
19435;Boružėlė;Žvaigždutės;5420788580;Ne;0;7;0;7
19436;Boružėlė;Ąžuoliukai;5774358876;Ne;0;2;0;2
19437;Boružėlė;Ąžuoliukai;3040376382;Ne;0;2;3;5
19438;Boružėlė;Ąžuoliukai;3840860155;Ne;0;6;0;6
19439;Boružėlė;Ąžuoliukai;6954794465;Ne;0;2;4;6
19440;Boružėlė;Ąžuoliukai;3695411422;Ne;5;9;0;14
19441;Boružėlė;Ąžuoliukai;5148410392;Ne;0;0;3;3
19442;Boružėlė;Ąžuoliukai;76222777017;Ne;0;2;1;3
19443;Boružėlė;Ąžuoliukai;2077228543;Ne;0;0;17;17
19444;Boružėlė;Ąžuoliukai;6022191251;Ne;0;1;0;1
19445;Boružėlė;Ąžuoliukai;3869817904;Ne;0;1;0;1
19446;Boružėlė;Ąžuoliukai;9269501176;Ne;0;2;0;2
19447;Boružėlė;Ąžuoliukai;8683282162;Ne;2;5;0;7
19448;Boružėlė;Ąžuoliukai;9999252614;Ne;0;0;2;2
19449;Boružėlė;Saulutės;9492548829;Ne;9;7;0;16
19450;Boružėlė;Saulutės;5437943626;Ne;0;14;0;14
19451;Boružėlė;Saulutės;3503931241;Ne;7;7;0;14
19452;Boružėlė;Saulutės;8882070834;Ne;12;0;0;12
19453;Boružėlė;Saulutės;2999335505;Ne;0;0;1;1
19454;Boružėlė;Saulutės;6265279517;Ne;0;7;5;12
19455;Boružėlė;Saulutės;6275425512;Ne;8;0;1;9
19456;Boružėlė;Saulutės;2879726579;Ne;4;6;1;11
19457;Boružėlė;Saulutės;8804878419;Ne;10;0;0;10
19458;Boružėlė;Saulutės;3871593172;Ne;10;0;0;10
19459;Boružėlė;Saulutės;3953507461;Ne;0;15;1;16
19460;Boružėlė;Saulutės;1492091211;Ne;7;7;1;15
19461;Boružėlė;Saulutės;1830043506;Ne;11;2;1;14
19462;Boružėlė;Saulutės;5680510186;Ne;5;4;0;9
19463;Boružėlė;Saulutės;1152697871;Ne;0;22;0;22
19464;Boružėlė;Saulutės;7652740249;Ne;12;0;0;12
19465;Boružėlė;Saulutės;7260471712;Ne;0;3;0;3
19466;Boružėlė;Saulutės;5064892417;Ne;6;0;0;6
19467;Boružėlė;Saulutės;8577301586;Ne;0;9;1;10
19468;Boružėlė;Saulutės;8660954142;Ne;0;9;1;10
19469;Boružėlė;Ežiukai;9342498392;Ne;12;1;0;13
19470;Boružėlė;Ežiukai;8195442951;Ne;0;2;6;8
19471;Boružėlė;Ežiukai;6448688592;Ne;5;9;0;14
19472;Boružėlė;Ežiukai;2429696310;Ne;2;4;0;6
19473;Boružėlė;Ežiukai;9893643199;Ne;0;5;0;5
19474;Boružėlė;Ežiukai;3112016309;Ne;10;2;0;12
19475;Boružėlė;Ežiukai;5394149649;Ne;6;2;1;9
19476;Boružėlė;Ežiukai;9391811395;Ne;0;3;0;3
19477;Boružėlė;Ežiukai;8167376712;Ne;6;0;0;6
19478;Boružėlė;Ežiukai;9423458813;Ne;0;1;1;2
19479;Boružėlė;Ežiukai;5825164520;Ne;4;0;6;10
19480;Boružėlė;Ežiukai;7459531236;Ne;20;0;0;20
19481;Boružėlė;Ežiukai;8818358360;Ne;20;0;0;20
19482;Boružėlė;Ežiukai;1693082285;Ne;0;5;0;5
19483;Boružėlė;Ežiukai;2926620929;Ne;9;2;0;11
19484;Boružėlė;Ežiukai;6609156790;Ne;0;4;3;7
19485;Boružėlė;Ežiukai;5768415821;Ne;4;2;3;9
19486;Boružėlė;Ežiukai;8291389794;Ne;0;3;0;3
19487;Boružėlė;Ežiukai;2524469162;Ne;0;4;0;4
19488;Boružėlė;Ežiukai;5492228053;Ne;6;2;1;9
19489;Boružėlė;Ežiukai;6087811262;Ne;0;2;1;3
19490;Boružėlė;Boružiukai;7068409148;Ne;7;0;0;7
19491;Boružėlė;Boružiukai;8434178580;Ne;0;3;0;3
19492;Boružėlė;Boružiukai;8752343077;Ne;5;1;0;6
19493;Boružėlė;Boružiukai;8944790932;Ne;18;0;0;18
19494;Boružėlė;Boružiukai;4113917886;Ne;22;0;0;22
19495;Boružėlė;Boružiukai;1608652924;Ne;10;0;2;12
19496;Boružėlė;Boružiukai;7149439740;Ne;0;2;0;2
19497;Boružėlė;Boružiukai;3005601935;Ne;0;2;3;5
19498;Boružėlė;Boružiukai;4497753570;Ne;5;0;8;13
19499;Boružėlė;Boružiukai;1865891989;Ne;0;2;0;2
19500;Boružėlė;Boružiukai;2298750617;Ne;13;0;0;13
19501;Boružėlė;Boružiukai;8739264310;Ne;10;2;1;13
19502;Boružėlė;Boružiukai;3097874340;Ne;0;1;0;1
19503;Boružėlė;Boružiukai;1551933321;Ne;0;1;0;1
19504;Boružėlė;Boružiukai;3097217902;Ne;10;0;0;10
19505;Boružėlė;Boružiukai;4727351240;Ne;6;2;0;8
19506;Boružėlė;Nykštukai;9822629428;Ne;0;6;0;6
19507;Boružėlė;Nykštukai;9663535338;Ne;0;6;0;6
19508;Boružėlė;Nykštukai;1047419932;Ne;7;0;0;7
19509;Boružėlė;Nykštukai;2304719318;Ne;24;0;0;24
19510;Boružėlė;Nykštukai;2104101406;Ne;0;2;0;2
19511;Boružėlė;Nykštukai;8377410278;Ne;0;1;0;1
19512;Boružėlė;Nykštukai;4928818565;Ne;5;1;0;6
19513;Boružėlė;Nykštukai;5619719965;Ne;0;9;0;9
19514;Boružėlė;Nykštukai;6267999965;Ne;0;8;0;8
19515;Boružėlė;Nykštukai;8073918985;Ne;0;10;0;10
19516;Boružėlė;Nykštukai;3595998843;Ne;2;5;0;7
19517;Boružėlė;Nykštukai;4217116059;Ne;5;1;0;6
19518;Boružėlė;Nykštukai;8165748779;Ne;0;22;0;22
19519;Žaliakalnio;Drugeliai;6379145626;Ne;20;12;0;32
19520;Žaliakalnio;Drugeliai;7094914749;Ne;0;16;0;16
19521;Žaliakalnio;Drugeliai;7449949339;Ne;0;5;0;5
19522;Žaliakalnio;Drugeliai;2607433844;Ne;0;4;0;4
19523;Žaliakalnio;Drugeliai;1413563085;Ne;0;3;0;3
19524;Žaliakalnio;Drugeliai;2432935088;Ne;0;4;0;4
19525;Žaliakalnio;Drugeliai;4806478786;Ne;0;2;0;2
19526;Žaliakalnio;Drugeliai;1033910097;Ne;0;3;1;4
19527;Žaliakalnio;Drugeliai;9032003195;Ne;0;11;0;11
19528;Žaliakalnio;Drugeliai;7566429633;Ne;0;4;0;4
19529;Žaliakalnio;Drugeliai;3835667120;Ne;0;14;0;14
19530;Žaliakalnio;Drugeliai;6341640909;Ne;8;2;0;10
19531;Žaliakalnio;Drugeliai;4059753894;Ne;0;7;7;14
19532;Žaliakalnio;Drugeliai;2305496316;Ne;0;5;0;5
19533;Žaliakalnio;Drugeliai;9984857605;Taip;0;4;0;4
19534;Žaliakalnio;Drugeliai;5764128482;Ne;0;3;0;3
19535;Žaliakalnio;Drugeliai;4497938258;Ne;0;5;1;6
19536;Žaliakalnio;Drugeliai;1673321992;Ne;0;12;0;12
19537;Žaliakalnio;Boružėlių;5843020412;Ne;0;15;0;15
19538;Žaliakalnio;Boružėlių;9625531462;Ne;0;17;0;17
19539;Žaliakalnio;Boružėlių;6699373334;Ne;0;17;0;17
19540;Žaliakalnio;Boružėlių;7087535800;Ne;0;12;0;12
19541;Žaliakalnio;Boružėlių;1528111839;Ne;0;6;0;6
19542;Žaliakalnio;Boružėlių;7023886811;Ne;0;11;0;11
19543;Žaliakalnio;Boružėlių;2284465378;Ne;0;18;0;18
19544;Žaliakalnio;Boružėlių;2808776865;Ne;6;10;0;16
19545;Žaliakalnio;Boružėlių;2278681435;Ne;0;10;12;22
19546;Žaliakalnio;Boružėlių;9421259943;Ne;0;13;0;13
19547;Žaliakalnio;Boružėlių;3445649442;Ne;0;13;0;13
19548;Žaliakalnio;Boružėlių;3105500733;Ne;0;6;0;6
19549;Žaliakalnio;Boružėlių;1200844791;Ne;0;16;0;16
19550;Žaliakalnio;Boružėlių;8052539476;Ne;10;5;0;15
19551;Žaliakalnio;Boružėlių;6590016097;Ne;0;16;0;16
19552;Žaliakalnio;Boružėlių;8304431519;Ne;7;10;5;22
19553;Žaliakalnio;Boružėlių;5488964606;Ne;0;9;2;11
19554;Žaliakalnio;Boružėlių;8429135626;Ne;0;19;0;19
19555;Žaliakalnio;Boružėlių;8073554707;Ne;21;0;0;21
19556;Žaliakalnio;Boružėlių;8534973941;Ne;0;12;0;12
19557;Žaliakalnio;Boružėlių;2987217910;Ne;0;17;0;17
19558;Žaliakalnio;Zuikučiai;1592051491;Ne;0;11;0;11
19559;Žaliakalnio;Zuikučiai;6088333997;Ne;0;2;0;2
19560;Žaliakalnio;Zuikučiai;2673619031;Ne;0;2;0;2
19561;Žaliakalnio;Zuikučiai;5843314345;Ne;0;2;0;2
19562;Žaliakalnio;Zuikučiai;2180165053;Ne;0;5;0;5
19563;Žaliakalnio;Zuikučiai;6823528666;Ne;0;8;0;8
19564;Žaliakalnio;Zuikučiai;3509064089;Ne;0;8;0;8
19565;Žaliakalnio;Zuikučiai;7000429934;Ne;0;14;0;14
19566;Žaliakalnio;Zuikučiai;5730610895;Ne;0;14;0;14
19567;Žaliakalnio;Zuikučiai;6881070397;Ne;0;5;0;5
19568;Žaliakalnio;Zuikučiai;8209559343;Ne;9;0;2;11
19569;Žaliakalnio;Zuikučiai;9799056285;Taip;0;1;0;1
19570;Žaliakalnio;Zuikučiai;1321592040;Ne;0;1;0;1
19571;Žaliakalnio;Zuikučiai;8298313285;Ne;3;1;0;4
19572;Žaliakalnio;Zuikučiai;9331287916;Ne;0;3;0;3
19573;Žaliakalnio;Zuikučiai;6726832258;Ne;0;2;0;2
19574;Žaliakalnio;Zuikučiai;4607456527;Ne;0;3;0;3
19575;Žaliakalnio;Zuikučiai;9363615751;Ne;1;4;0;5
19576;Žaliakalnio;Zuikučiai;6727442688;Ne;5;6;0;11
19577;Žaliakalnio;Bitutė;5744370516;Ne;0;27;0;27
19578;Žaliakalnio;Bitutė;3619817569;Ne;8;7;0;15
19579;Žaliakalnio;Bitutė;3905448562;Ne;9;8;0;17
19580;Žaliakalnio;Bitutė;8481665290;Ne;13;3;0;16
19581;Žaliakalnio;Bitutė;8950583202;Ne;4;8;0;12
19582;Žaliakalnio;Bitutė;6324315523;Ne;7;6;0;13
19583;Žaliakalnio;Bitutė;6877235095;Ne;10;6;0;16
19584;Žaliakalnio;Bitutė;2280683252;Ne;13;0;0;13
19585;Žaliakalnio;Bitutė;7711347723;Ne;8;1;0;9
19586;Žaliakalnio;Bitutė;4561672875;Ne;13;2;0;15
19587;Žaliakalnio;Bitutė;7830692152;Ne;10;10;0;20
19588;Žaliakalnio;Bitutė;1423481154;Ne;4;13;0;17
19589;Žaliakalnio;Bitutė;4928400872;Ne;5;17;0;22
19590;Žaliakalnio;Bitutė;2613771302;Ne;0;11;0;11
19591;Žaliakalnio;Bitutė;3976548663;Ne;11;7;0;18
19592;Žaliakalnio;Bitutė;8599646291;Ne;5;3;0;8
19593;Žaliakalnio;Bitutė;1343293430;Ne;0;16;0;16
19594;Žaliakalnio;Bitutė;3721878250;Ne;18;10;0;28
19595;Žaliakalnio;Bitutė;6291287113;Taip;0;5;0;5
19596;Žaliakalnio;Bitutė;4412760433;Ne;5;3;0;8
19597;Žaliakalnio;Bitutė;7989372873;Ne;0;11;0;11
19598;Žaliakalnio;Bitutė;1173977434;Ne;22;10;0;32
19599;Žaliakalnio;Nykštukų;9069518153;Ne;12;13;0;25
19600;Žaliakalnio;Nykštukų;8142435757;Ne;7;11;0;18
19601;Žaliakalnio;Nykštukų;3446593135;Ne;0;7;3;10
19602;Žaliakalnio;Nykštukų;1064854294;Ne;0;21;0;21
19603;Žaliakalnio;Nykštukų;4891656355;Ne;5;5;0;10
19604;Žaliakalnio;Nykštukų;1632465983;Ne;8;6;0;14
19605;Žaliakalnio;Nykštukų;8472945857;Ne;0;5;0;5
19606;Žaliakalnio;Nykštukų;9521104462;Ne;7;10;0;17
19607;Žaliakalnio;Nykštukų;5565027085;Ne;5;3;0;8
19608;Žaliakalnio;Nykštukų;2242604156;Ne;0;12;0;12
19609;Žaliakalnio;Nykštukų;8852165484;Ne;8;9;2;19
19610;Žaliakalnio;Nykštukų;9801618806;Ne;0;10;0;10
19611;Žaliakalnio;Nykštukų;2225778044;Ne;0;9;1;10
19612;Žaliakalnio;Nykštukų;4255734788;Ne;12;10;0;22
19613;Žaliakalnio;Nykštukų;7793937917;Ne;0;24;0;24
19614;Žaliakalnio;Nykštukų;8117013474;Ne;0;3;0;3
19615;Žaliakalnio;Nykštukų;7205368281;Ne;5;0;0;5
19616;Žaliakalnio;Nykštukų;7495990953;Ne;19;6;0;25
19617;Žaliakalnio;Nykštukų;4036239701;Ne;0;12;0;12
19618;Žaliakalnio;Nykštukų;5258266970;Ne;12;4;0;16
19619;Žaliakalnio;Nykštukų;6166482260;Ne;9;17;0;26
19620;Žaliakalnio;ŽIOGELIAI;2426844621;Ne;0;6;0;6
19621;Žaliakalnio;ŽIOGELIAI;5752912101;Ne;0;8;0;8
19622;Žaliakalnio;ŽIOGELIAI;9967098834;Ne;0;11;0;11
19623;Žaliakalnio;ŽIOGELIAI;1133557422;Ne;0;12;0;12
19624;Žaliakalnio;ŽIOGELIAI;3464935314;Ne;0;13;0;13
19625;Žaliakalnio;ŽIOGELIAI;7648422668;Ne;5;16;0;21
19626;Žaliakalnio;ŽIOGELIAI;4702470511;Ne;0;2;0;2
19627;Žaliakalnio;ŽIOGELIAI;2272043654;Ne;0;4;0;4
19628;Žaliakalnio;ŽIOGELIAI;8518422934;Ne;0;9;0;9
19629;Žaliakalnio;ŽIOGELIAI;6674631040;Ne;0;13;4;17
19630;Žaliakalnio;ŽIOGELIAI;8245784590;Ne;22;10;0;32
19631;Žaliakalnio;ŽIOGELIAI;9485995178;Ne;0;10;0;10
19632;Žaliakalnio;ŽIOGELIAI;8179329874;Ne;5;6;0;11
19633;Žaliakalnio;ŽIOGELIAI;8383425712;Ne;0;6;7;13
19634;Žaliakalnio;ŽIOGELIAI;1309236035;Ne;22;10;0;32
19635;Žaliakalnio;ŽIOGELIAI;7025195076;Ne;0;1;0;1
19636;Žaliakalnio;ŽIOGELIAI;2514763739;Ne;0;9;0;9
19637;Žaliakalnio;ŽIOGELIAI;8891815592;Ne;0;0;1;1
19638;Žaliakalnio;ŽIOGELIAI;6294045755;Ne;0;14;0;14
19639;Žaliakalnio;ŽIOGELIAI;8232697563;Ne;0;18;0;18
19640;Žaliakalnio;ŽIOGELIAI;2694424532;Ne;2;13;0;15
19641;Žaliakalnio;ŽIOGELIAI;6136717862;Ne;0;4;3;7
19642;Žaliakalnio;ŽIOGELIAI;8316505307;Ne;0;12;0;12
19643;Žaliakalnio;SAULUTĖS;5602734465;Ne;0;17;0;17
19644;Žaliakalnio;SAULUTĖS;2328766492;Ne;0;2;0;2
19645;Žaliakalnio;SAULUTĖS;1253655689;Ne;0;10;0;10
19646;Žaliakalnio;SAULUTĖS;3016537413;Ne;5;7;0;12
19647;Žaliakalnio;SAULUTĖS;6795532166;Ne;10;1;0;11
19648;Žaliakalnio;SAULUTĖS;4154737541;Ne;0;11;0;11
19649;Žaliakalnio;SAULUTĖS;7913029369;Ne;0;18;0;18
19650;Žaliakalnio;SAULUTĖS;7793917852;Ne;11;8;1;20
19651;Žaliakalnio;SAULUTĖS;3018398546;Ne;0;16;0;16
19652;Žaliakalnio;SAULUTĖS;8765159796;Ne;15;8;1;24
19653;Žaliakalnio;SAULUTĖS;3028921540;Ne;0;8;0;8
19654;Žaliakalnio;SAULUTĖS;7636933790;Ne;0;32;0;32
19655;Žaliakalnio;SAULUTĖS;4355433666;Ne;0;20;0;20
19656;Žaliakalnio;SAULUTĖS;1975313368;Ne;22;10;0;32
19657;Žaliakalnio;SAULUTĖS;9016032548;Ne;0;6;0;6
19658;Žaliakalnio;SAULUTĖS;1715385224;Ne;16;4;0;20
19659;Žaliakalnio;SAULUTĖS;3304186400;Ne;10;14;0;24
19660;Žaliakalnio;SAULUTĖS;3434815790;Ne;0;1;0;1
19661;Žaliakalnio;SAULUTĖS;3832291926;Ne;6;5;0;11
19662;Žaliakalnio;SAULUTĖS;7071209465;Ne;22;3;0;25
19663;Žaliakalnio;SAULUTĖS;7543073516;Ne;3;16;0;19
19664;Žaliakalnio;SAULUTĖS;9379373983;Ne;17;6;0;23
19665;Žaliakalnio;SAULUTĖS;2806386840;Ne;21;7;0;28
19666;Volungė;Bitutės;6661730121;Ne;0;0;2;2
19667;Volungė;Bitutės;5791161943;Ne;0;0;5;5
19668;Volungė;Bitutės;3307326410;Ne;0;5;6;11
19669;Volungė;Bitutės;5300334761;Ne;0;0;4;4
19670;Volungė;Bitutės;6755366051;Ne;10;0;1;11
19671;Volungė;Bitutės;4013639324;Ne;0;12;4;16
19672;Volungė;Bitutės;2599441104;Ne;0;0;2;2
19673;Volungė;Bitutės;5892600735;Ne;3;0;9;12
19674;Volungė;Bitutės;1902122510;Ne;0;0;3;3
19675;Volungė;Bitutės;1752817125;Ne;4;0;12;16
19676;Volungė;Bitutės;3666364101;Ne;0;0;3;3
19677;Volungė;Bitutės;7151952679;Ne;0;0;2;2
19678;Volungė;Bitutės;5960027749;Ne;0;0;6;6
19679;Volungė;Bitutės;3106135598;Ne;0;0;2;2
19680;Volungė;Bitutės;9842009354;Ne;0;0;5;5
19681;Volungė;Bitutės;4437625791;Ne;0;0;2;2
19682;Volungė;Bitutės;9933980783;Ne;0;5;0;5
19683;Volungė;Bitutės;4685227759;Ne;0;5;0;5
19684;Volungė;Boružiukai;6431477042;Ne;0;0;1;1
19685;Volungė;Boružiukai;1137713075;Ne;0;0;6;6
19686;Volungė;Boružiukai;2322594823;Ne;0;9;0;9
19687;Volungė;Boružiukai;3746978206;Ne;0;0;1;1
19688;Volungė;Boružiukai;9188994935;Ne;0;0;7;7
19689;Volungė;Boružiukai;8285309230;Ne;0;0;2;2
19690;Volungė;Boružiukai;7149986415;Ne;0;0;2;2
19691;Volungė;Boružiukai;4598763851;Ne;5;0;0;5
19692;Volungė;Boružiukai;7867741556;Ne;0;0;8;8
19693;Volungė;Boružiukai;8459167833;Ne;0;8;0;8
19694;Volungė;Boružiukai;3832613221;Ne;0;7;1;8
19695;Volungė;Boružiukai;7971287899;Ne;0;0;4;4
19696;Volungė;Boružiukai;1974650443;Ne;0;0;5;5
19697;Volungė;Boružiukai;2068447339;Ne;0;22;0;22
19698;Volungė;Boružiukai;3528581949;Ne;0;0;2;2
19699;Volungė;Žvirbliukai;8414351815;Ne;0;0;2;2
19700;Volungė;Žvirbliukai;2051410463;Ne;0;0;5;5
19701;Volungė;Žvirbliukai;5074093178;Ne;0;15;0;15
19702;Volungė;Žvirbliukai;5750385275;Taip;12;0;8;20
19703;Volungė;Žvirbliukai;9575894080;Taip;0;8;1;9
19704;Volungė;Žvirbliukai;8927595898;Ne;5;0;6;11
19705;Volungė;Žvirbliukai;9384821249;Ne;13;0;0;13
19706;Volungė;Žvirbliukai;5361410157;Ne;4;0;1;5
19707;Volungė;Žvirbliukai;3028611395;Ne;6;0;4;10
19708;Volungė;Žvirbliukai;2949033093;Ne;0;0;1;1
19709;Volungė;Žvirbliukai;2159667991;Ne;13;0;1;14
19710;Volungė;Žvirbliukai;5470252589;Ne;0;0;12;12
19711;Volungė;Žvirbliukai;7923029388;Ne;0;0;3;3
19712;Volungė;Žiogeliai;6360834021;Ne;5;0;1;6
19713;Volungė;Žiogeliai;4856240879;Ne;0;0;5;5
19714;Volungė;Žiogeliai;4694016281;Ne;0;0;8;8
19715;Volungė;Žiogeliai;9816038480;Ne;4;0;3;7
19716;Volungė;Žiogeliai;8640511964;Ne;0;12;5;17
19717;Volungė;Žiogeliai;5170536566;Ne;4;0;1;5
19718;Volungė;Žiogeliai;8421730419;Ne;4;0;10;14
19719;Volungė;Žiogeliai;6532202782;Ne;0;0;6;6
19720;Volungė;Žiogeliai;2712034356;Ne;0;0;7;7
19721;Volungė;Žiogeliai;2246291631;Ne;0;0;1;1
19722;Volungė;Žiogeliai;2456643081;Ne;5;0;0;5
19723;Volungė;Žiogeliai;8299305464;Ne;0;0;22;22
19724;Volungė;Žiogeliai;1781838937;Ne;0;0;3;3
19725;Volungė;Žiogeliai;3091641738;Ne;0;0;4;4
19726;Volungė;Žiogeliai;8578521969;Ne;7;0;0;7
19727;Volungė;Žiogeliai;4839484528;Ne;2;0;1;3
19728;Volungė;Žiogeliai;5174427959;Ne;0;0;4;4
19729;Volungė;Žiogeliai;4726043862;Ne;0;0;2;2
19730;Volungė;Pelėdžiukai;2890377876;Ne;0;0;3;3
19731;Volungė;Pelėdžiukai;1099216923;Ne;0;0;16;16
19732;Volungė;Pelėdžiukai;3430719834;Ne;0;3;0;3
19733;Volungė;Pelėdžiukai;2566901599;Ne;12;0;0;12
19734;Volungė;Pelėdžiukai;2420242319;Ne;0;0;7;7
19735;Volungė;Pelėdžiukai;3356901662;Ne;0;0;6;6
19736;Volungė;Pelėdžiukai;1225378067;Ne;0;9;0;9
19737;Volungė;Pelėdžiukai;7281448136;Ne;0;0;6;6
19738;Volungė;Pelėdžiukai;9629567682;Ne;0;0;7;7
19739;Volungė;Pelėdžiukai;1120682487;Ne;0;0;1;1
19740;Volungė;Pelėdžiukai;9082860913;Ne;0;0;6;6
19741;Volungė;Pelėdžiukai;8174587725;Ne;0;0;8;8
19742;Volungė;Pelėdžiukai;9068889427;Ne;0;5;0;5
19743;Volungė;Pelėdžiukai;4123080241;Ne;0;0;5;5
19744;Volungė;Pelėdžiukai;8268202101;Ne;0;0;7;7
19745;Volungė;Pelėdžiukai;1366066359;Ne;0;8;0;8
19746;Volungė;Drugeliai;6280208510;Ne;1;6;0;7
19747;Volungė;Drugeliai;4032261812;Ne;4;0;8;12
19748;Volungė;Drugeliai;6488473384;Ne;7;0;2;9
19749;Volungė;Drugeliai;8045459660;Ne;12;0;0;12
19750;Volungė;Drugeliai;1402200673;Ne;12;0;0;12
19751;Volungė;Drugeliai;7574856429;Ne;11;0;0;11
19752;Volungė;Drugeliai;5284011092;Ne;0;2;2;4
19753;Volungė;Drugeliai;4427076715;Ne;9;0;0;9
19754;Volungė;Drugeliai;9729285419;Ne;0;0;12;12
19755;Volungė;Drugeliai;2686827560;Ne;8;0;2;10
19756;Volungė;Drugeliai;9973604148;Ne;11;0;2;13
19757;Volungė;Drugeliai;8905401944;Ne;8;0;2;10
19758;Volungė;Drugeliai;1164632050;Ne;0;0;1;1
19759;Volungė;Drugeliai;2923810441;Ne;0;0;1;1
19760;Volungė;Drugeliai;6782622442;Ne;5;0;3;8
19761;Volungė;Drugeliai;3020629341;Ne;0;0;4;4
19762;Volungė;Drugeliai;4252713086;Ne;0;0;1;1
19763;Volungė;Drugeliai;2530804242;Ne;0;0;1;1
19764;Volungė;Drugeliai;5354511593;Ne;2;0;0;2
19765;Volungė;Drugeliai;3150532451;Ne;7;0;1;8
19766;Volungė;Drugeliai;9343118795;Ne;0;0;9;9
19767;Volungė;Drugeliai;4745609424;Taip;0;0;1;1
19768;Volungė;Drugeliai;7584598377;Ne;10;0;0;10
19769;Volungė;"SKRUZDĖLIUKAI ";3394646139;Ne;21;1;0;22
19770;Volungė;"SKRUZDĖLIUKAI ";4223287277;Ne;0;6;0;6
19771;Volungė;"SKRUZDĖLIUKAI ";6464890465;Ne;2;0;3;5
19772;Volungė;"SKRUZDĖLIUKAI ";2493541457;Ne;0;0;3;3
19773;Volungė;"SKRUZDĖLIUKAI ";1101228927;Ne;2;0;0;2
19774;Volungė;"SKRUZDĖLIUKAI ";5332306628;Ne;9;0;5;14
19775;Volungė;"SKRUZDĖLIUKAI ";9319825151;Taip;0;8;0;8
19776;Volungė;"SKRUZDĖLIUKAI ";6370584522;Ne;0;9;0;9
19777;Volungė;"SKRUZDĖLIUKAI ";8168630107;Ne;0;5;3;8
19778;Volungė;"SKRUZDĖLIUKAI ";8992514683;Ne;2;2;1;5
19779;Volungė;"SKRUZDĖLIUKAI ";5833091791;Ne;0;5;1;6
19780;Volungė;"SKRUZDĖLIUKAI ";5994884455;Ne;7;10;0;17
19781;Volungė;"SKRUZDĖLIUKAI ";3818924175;Ne;9;0;0;9
19782;Volungė;"SKRUZDĖLIUKAI ";6110117105;Ne;0;0;1;1
19783;Volungė;"SKRUZDĖLIUKAI ";4944556574;Ne;0;5;0;5
19784;Volungė;"SKRUZDĖLIUKAI ";2212423676;Ne;0;2;0;2
19785;Volungė;"SKRUZDĖLIUKAI ";5942497397;Ne;2;0;5;7
19786;Volungė;"SKRUZDĖLIUKAI ";8613580206;Ne;5;0;1;6
19787;Volungė;Zylutės;4664635246;Ne;5;0;4;9
19788;Volungė;Zylutės;9382043452;Ne;3;0;1;4
19789;Volungė;Zylutės;1125730734;Ne;3;0;2;5
19790;Volungė;Zylutės;5650558154;Ne;12;0;1;13
19791;Volungė;Zylutės;1592634034;Ne;0;0;1;1
19792;Volungė;Zylutės;5588544003;Ne;0;2;1;3
19793;Volungė;Zylutės;3758750922;Ne;5;0;13;18
19794;Volungė;Zylutės;3460701723;Ne;0;0;9;9
19795;Volungė;Zylutės;9562426487;Ne;5;0;6;11
19796;Volungė;Zylutės;4136178027;Ne;0;2;0;2
19797;Volungė;Zylutės;5882826586;Ne;0;19;0;19
19798;Volungė;Zylutės;6969633765;Ne;5;0;1;6
19799;Volungė;Zylutės;6445614647;Ne;22;0;0;22
19800;Volungė;Zylutės;5561683986;Ne;0;0;9;9
19801;Volungė;Zylutės;5338942678;Ne;7;0;6;13
19802;Volungė;Zylutės;8987748481;Ne;4;0;3;7
19803;Giliukas;SMALSUČIAI;1710286878;Ne;2;0;7;9
19804;Giliukas;SMALSUČIAI;9134734376;Ne;0;0;1;1
19805;Giliukas;SMALSUČIAI;3728323646;Ne;20;0;0;20
19806;Giliukas;SMALSUČIAI;6742406486;Ne;0;5;0;5
19807;Giliukas;SMALSUČIAI;9556962586;Ne;0;10;1;11
19808;Giliukas;SMALSUČIAI;2840410579;Ne;0;7;2;9
19809;Giliukas;SMALSUČIAI;7316126011;Ne;0;5;1;6
19810;Giliukas;SMALSUČIAI;6489845832;Ne;22;10;0;32
19811;Giliukas;SMALSUČIAI;9704885611;Ne;0;2;0;2
19812;Giliukas;SMALSUČIAI;7993049824;Ne;6;7;3;16
19813;Giliukas;SMALSUČIAI;2700296404;Ne;0;0;1;1
19814;Giliukas;SMALSUČIAI;7412960823;Taip;2;0;0;2
19815;Giliukas;SMALSUČIAI;9160815037;Ne;16;1;0;17
19816;Giliukas;GUDRUČIAI;2335031800;Ne;0;2;0;2
19817;Giliukas;GUDRUČIAI;3847358328;Ne;0;9;0;9
19818;Giliukas;GUDRUČIAI;6165618131;Ne;6;15;0;21
19819;Giliukas;GUDRUČIAI;9608331265;Ne;0;14;0;14
19820;Giliukas;GUDRUČIAI;1870173947;Taip;0;5;4;9
19821;Giliukas;GUDRUČIAI;3983555939;Ne;0;4;0;4
19822;Giliukas;GUDRUČIAI;2951628295;Ne;2;3;0;5
19823;Giliukas;GUDRUČIAI;2003990493;Ne;5;6;0;11
19824;Giliukas;GUDRUČIAI;4960232685;Ne;0;6;0;6
19825;Giliukas;GUDRUČIAI;4916844983;Ne;4;2;0;6
19826;Giliukas;GUDRUČIAI;5787041097;Ne;14;8;0;22
19827;Giliukas;GUDRUČIAI;9458151965;Ne;0;0;1;1
19828;Giliukas;GUDRUČIAI;7159681896;Ne;0;2;1;3
19829;Giliukas;PABIRUČIAI;4183026763;Ne;9;0;2;11
19830;Giliukas;PABIRUČIAI;1221640023;Ne;11;0;0;11
19831;Giliukas;PABIRUČIAI;2362785562;Ne;1;6;0;7
19832;Giliukas;PABIRUČIAI;4247090684;Ne;0;0;1;1
19833;Giliukas;PABIRUČIAI;2379370477;Ne;5;0;0;5
19834;Giliukas;PABIRUČIAI;3054591644;Ne;5;0;0;5
19835;Giliukas;PABIRUČIAI;3870143024;Ne;7;0;5;12
19836;Giliukas;PABIRUČIAI;6914013230;Ne;5;0;3;8
19837;Giliukas;PABIRUČIAI;7013767174;Ne;1;10;0;11
19838;Giliukas;PABIRUČIAI;4810236703;Ne;7;0;1;8
19839;Giliukas;PABIRUČIAI;4105974682;Ne;7;0;0;7
19840;Giliukas;PABIRUČIAI;8874804636;Ne;0;0;2;2
19841;Giliukas;PABIRUČIAI;7012272912;Ne;0;0;5;5
19842;Giliukas;ŠVELNUKAI;9360994563;Ne;0;0;3;3
19843;Giliukas;ŠVELNUKAI;7402797271;Ne;14;0;0;14
19844;Giliukas;ŠVELNUKAI;3839624551;Taip;2;0;2;4
19845;Giliukas;ŠVELNUKAI;2012365132;Ne;10;0;2;12
19846;Giliukas;ŠVELNUKAI;9270743786;Ne;0;0;4;4
19847;Giliukas;ŠVELNUKAI;4565216956;Ne;0;0;9;9
19848;Giliukas;ŠVELNUKAI;1075275967;Ne;22;0;0;22
19849;Giliukas;ŠVELNUKAI;5834233526;Ne;0;0;1;1
19850;Giliukas;ŠVELNUKAI;8973584424;Ne;0;0;2;2
19851;Giliukas;ŠVELNUKAI;9679421414;Ne;7;0;0;7
19852;Giliukas;ŠVELNUKAI;2881704755;Ne;2;0;2;4
19853;Giliukas;ŠVELNUKAI;3238820351;Ne;2;10;0;12
19854;Giliukas;ŠVELNUKAI;4340602792;Ne;2;0;3;5
19855;Giliukas;ŠVELNUKAI;2229737837;Ne;5;0;7;12
19856;Giliukas;ŽINIUKAI;6422178450;Ne;0;1;0;1
19857;Giliukas;ŽINIUKAI;2502801547;Ne;3;2;3;8
19858;Giliukas;ŽINIUKAI;9617542456;Ne;0;1;0;1
19859;Giliukas;ŽINIUKAI;2562809633;Ne;0;2;1;3
19860;Giliukas;ŽINIUKAI;5326178821;Ne;7;5;0;12
19861;Giliukas;ŽINIUKAI;9152432124;Ne;2;6;0;8
19862;Giliukas;ŽINIUKAI;4854370266;Ne;0;1;0;1
19863;Giliukas;ŽINIUKAI;6703080106;Ne;0;6;0;6
19864;Giliukas;ŽINIUKAI;9274289812;Ne;0;5;0;5
19865;Giliukas;ŽINIUKAI;6956862865;Ne;0;2;2;4
19866;Giliukas;ŽINIUKAI;3150981084;Ne;7;3;0;10
19867;Giliukas;ŽINIUKAI;6134554678;Ne;0;4;5;9
19868;Giliukas;ŽINIUKAI;2064182165;Ne;17;0;0;17
19869;Giliukas;ŽINIUKAI;5201020765;Ne;7;4;0;11
19870;Giliukas;ŽINIUKAI;2042324002;Ne;0;2;0;2
19871;Giliukas;ŽINIUKAI;3137768675;Ne;2;1;0;3
19872;Giliukas;ŽINIUKAI;3718774263;Ne;17;5;0;22
19873;Giliukas;MYLIMUKAI;7205807049;Ne;10;1;0;11
19874;Giliukas;MYLIMUKAI;1165810193;Ne;0;1;9;10
19875;Giliukas;MYLIMUKAI;3055598917;Ne;0;1;0;1
19876;Giliukas;MYLIMUKAI;6953123617;Ne;0;2;0;2
19877;Giliukas;MYLIMUKAI;2742106493;Ne;0;7;0;7
19878;Giliukas;MYLIMUKAI;1916905497;Ne;0;1;0;1
19879;Giliukas;MYLIMUKAI;7053406257;Ne;3;2;1;6
19880;Giliukas;MYLIMUKAI;4581414740;Ne;0;8;6;14
19881;Giliukas;MYLIMUKAI;2226855971;Ne;0;19;3;22
19882;Giliukas;MYLIMUKAI;7431116067;Ne;0;5;3;8
19883;Giliukas;MYLIMUKAI;3726149759;Ne;0;2;0;2
19884;Giliukas;MYLIMUKAI;5625404051;Ne;0;5;0;5
19885;Giliukas;ČIAUŠKUČIAI;1762536884;Ne;2;0;5;7
19886;Giliukas;ČIAUŠKUČIAI;7646966187;Ne;0;0;1;1
19887;Giliukas;ČIAUŠKUČIAI;2801731379;Ne;5;2;5;12
19888;Giliukas;ČIAUŠKUČIAI;8499893356;Ne;0;12;0;12
19889;Giliukas;ČIAUŠKUČIAI;3720032249;Ne;3;0;1;4
19890;Giliukas;ČIAUŠKUČIAI;3659105022;Ne;0;2;0;2
19891;Giliukas;ČIAUŠKUČIAI;4940718205;Ne;0;1;0;1
19892;Giliukas;ČIAUŠKUČIAI;8491008130;Taip;5;2;13;20
19893;Giliukas;ČIAUŠKUČIAI;4163383707;Ne;0;0;2;2
19894;Giliukas;ČIAUŠKUČIAI;2612551188;Ne;8;0;0;8
19895;Giliukas;ČIAUŠKUČIAI;9366734581;Ne;2;2;1;5
19896;Giliukas;ČIAUŠKUČIAI;8106782330;Ne;0;2;2;4
19897;Giliukas;ČIAUŠKUČIAI;1332725572;Ne;0;6;0;6
19898;Giliukas;ČIAUŠKUČIAI;2787116787;Ne;0;7;0;7
19899;Giliukas;ŠNEKUČIAI;9229086918;Ne;0;1;0;1
19900;Giliukas;ŠNEKUČIAI;9287193955;Ne;0;9;5;14
19901;Giliukas;ŠNEKUČIAI;5527212334;Ne;5;0;2;7
19902;Giliukas;ŠNEKUČIAI;2099575372;Ne;0;0;1;1
19903;Giliukas;ŠNEKUČIAI;7195772641;Ne;0;5;0;5
19904;Giliukas;ŠNEKUČIAI;1439350058;Ne;0;1;0;1
19905;Giliukas;ŠNEKUČIAI;4843920452;Ne;10;10;0;20
19906;Giliukas;ŠNEKUČIAI;2004782696;Ne;6;7;1;14
19907;Giliukas;ŠNEKUČIAI;8147492951;Ne;2;0;3;5
19908;Giliukas;ŠNEKUČIAI;2349166172;Ne;0;11;2;13
19909;Giliukas;ŠNEKUČIAI;8241215831;Ne;10;5;4;19
19910;Giliukas;ŠNEKUČIAI;9475918013;Ne;0;1;4;5
19911;Giliukas;ŠNEKUČIAI;7944198886;Ne;21;0;1;22
19912;Giliukas;ŠNEKUČIAI;4347883309;Ne;0;7;0;7
19913;"Lazdynų mokykla (Žėručio g. 4)";RUPG;6038907328;Ne;5;0;0;5
19914;"Lazdynų mokykla (Žėručio g. 4)";RUPG;4086774324;Ne;0;22;0;22
19915;"Lazdynų mokykla (Žėručio g. 4)";RUPG;6070629454;Ne;0;22;0;22
19916;"Lazdynų mokykla (Žėručio g. 4)";RUPG;1118653070;Ne;7;3;0;10
19917;"Lazdynų mokykla (Žėručio g. 4)";RUPG;5806696915;Ne;0;0;2;2
19918;"Lazdynų mokykla (Žėručio g. 4)";RUPG;2209697834;Ne;0;22;0;22
19919;"Lazdynų mokykla (Žėručio g. 4)";RUPG;6638804854;Ne;0;22;0;22
19920;"Lazdynų mokykla (Žėručio g. 4)";RUPG;3634678954;Ne;5;0;0;5
19921;"Lazdynų mokykla (Žėručio g. 4)";RUPG;5982019255;Ne;0;5;0;5
19922;"Lazdynų mokykla (Žėručio g. 4)";RUPG;2160440145;Ne;11;0;0;11
19923;"Lazdynų mokykla (Žėručio g. 4)";RUPG;1025406111;Ne;0;4;0;4
19924;"Lazdynų mokykla (Žėručio g. 4)";RUPG;5095782784;Ne;0;0;1;1
19925;"Lazdynų mokykla (Žėručio g. 4)";LEPG;9656050113;Ne;3;0;0;3
19926;"Lazdynų mokykla (Žėručio g. 4)";LEPG;6822686126;Ne;0;0;2;2
19927;"Lazdynų mokykla (Žėručio g. 4)";LEPG;7059075747;Ne;7;0;0;7
19928;"Lazdynų mokykla (Žėručio g. 4)";LEPG;5438716880;Ne;0;0;1;1
19929;"Lazdynų mokykla (Žėručio g. 4)";LEPG;7487278074;Ne;0;0;2;2
19930;"Lazdynų mokykla (Žėručio g. 4)";LEPG;7320049068;Ne;0;0;7;7
19931;"Lazdynų mokykla (Žėručio g. 4)";LEPG;1396367371;Ne;3;0;4;7
19932;"Lazdynų mokykla (Žėručio g. 4)";LEPG;7324846434;Ne;2;3;1;6
19933;"Lazdynų mokykla (Žėručio g. 4)";LEPG;6794153377;Ne;0;0;10;10
19934;"Lazdynų mokykla (Žėručio g. 4)";LEPG;2825614921;Ne;8;0;0;8
19935;"Lazdynų mokykla (Žėručio g. 4)";LEPG;9592456683;Ne;11;0;0;11
19936;"Lazdynų mokykla (Žėručio g. 4)";LEPG;8324750958;Ne;0;0;3;3
19937;"Lazdynų mokykla (Žėručio g. 4)";LEPG;7659209862;Ne;6;0;0;6
19938;"Lazdynų mokykla (Žėručio g. 4)";RUPG;3631150576;Ne;0;5;4;9
19939;"Lazdynų mokykla (Žėručio g. 4)";RUPG;5015519090;Ne;0;0;6;6
19940;"Lazdynų mokykla (Žėručio g. 4)";RUPG;1745679183;Ne;0;0;2;2
19941;"Lazdynų mokykla (Žėručio g. 4)";RUPG;9255723192;Ne;0;0;2;2
19942;"Lazdynų mokykla (Žėručio g. 4)";RUPG;9639587601;Ne;0;0;1;1
19943;"Lazdynų mokykla (Žėručio g. 4)";RUPG;4087148273;Ne;0;0;3;3
19944;"Lazdynų mokykla (Žėručio g. 4)";RUPG;2700475528;Taip;0;0;1;1
19945;"Lazdynų mokykla (Žėručio g. 4)";RUPG;4023257875;Ne;0;0;4;4
19946;"Lazdynų mokykla (Žėručio g. 4)";RUPG;9123178095;Ne;0;9;0;9
19947;"Lazdynų mokykla (Žėručio g. 4)";RUPG;3000676765;Ne;5;0;1;6
19948;"Lazdynų mokykla (Žėručio g. 4)";RUPG;9968637187;Ne;2;0;1;3
19949;"Lazdynų mokykla (Žėručio g. 4)";RUPG;8886654664;Ne;15;0;1;16
19950;"Lazdynų mokykla (Žėručio g. 4)";RUPG;1910570858;Ne;0;3;0;3
19951;Santariškių;Serbentukai;2334347228;Ne;7;0;0;7
19952;Santariškių;Serbentukai;9976014841;Ne;2;0;0;2
19953;Santariškių;Serbentukai;6954955786;Ne;2;0;0;2
19954;Santariškių;Obuoliukai;2292488699;Ne;3;0;0;3
19955;Santariškių;Žirginėliai;9409374327;Ne;5;0;0;5
19956;Santariškių;Žirginėliai;8069534610;Ne;5;0;0;5
19957;Santariškių;Slyviukai;1851631810;Ne;12;0;0;12
19958;Santariškių;Kriaušiukai;5236914955;Ne;5;0;0;5
19959;Santariškių;Kriaušiukai;6894591909;Ne;3;0;0;3
19960;Santariškių;Giliukai;1376757822;Ne;13;0;0;13
19961;Santariškių;Giliukai;85809010374;Ne;3;0;0;3
19962;Santariškių;Šermukšniukai;7825266216;Ne;3;0;0;3
19963;Santariškių;Riešutukai;1018256373;Ne;5;0;0;5
19964;Santariškių;Avietėlės;4468637202;Ne;3;0;0;3
19965;Santariškių;Vyšniukai;9819079431;Ne;5;0;0;5
19966;Santariškių;Vyšniukai;8749265990;Ne;5;0;0;5
19967;Santariškių;Agrastukai;5952329323;Ne;9;0;0;9
19968;"„Atžalyno” mokykla-darželis";Giliukai;1209960122;Ne;1;0;2;3
19969;"„Atžalyno” mokykla-darželis";Giliukai;9655000018;Ne;0;0;1;1
19970;"„Atžalyno” mokykla-darželis";Giliukai;8826921260;Ne;1;0;1;2
19971;"„Atžalyno” mokykla-darželis";Giliukai;2773253032;Ne;0;0;2;2
19972;"„Atžalyno” mokykla-darželis";Giliukai;3170216428;Ne;0;0;3;3
19973;"„Atžalyno” mokykla-darželis";Giliukai;4345420422;Ne;15;0;0;15
19974;"„Atžalyno” mokykla-darželis";Giliukai;2772290605;Ne;0;0;2;2
19975;"„Atžalyno” mokykla-darželis";Giliukai;1958519966;Ne;0;0;6;6
19976;"„Atžalyno” mokykla-darželis";Giliukai;9806203065;Ne;0;0;2;2
19977;"„Atžalyno” mokykla-darželis";Giliukai;2601122166;Ne;4;0;0;4
19978;"„Atžalyno” mokykla-darželis";Giliukai;3529875728;Ne;0;0;1;1
19979;"„Atžalyno” mokykla-darželis";Giliukai;4427232735;Ne;0;0;6;6
19980;"„Atžalyno” mokykla-darželis";Giliukai;9013323901;Ne;4;0;1;5
19981;"„Atžalyno” mokykla-darželis";Giliukai;9215658103;Ne;0;0;1;1
19982;"„Atžalyno” mokykla-darželis";Giliukai;5030879885;Ne;0;0;3;3
19983;"„Atžalyno” mokykla-darželis";Giliukai;3484401937;Ne;8;0;2;10
19984;"„Atžalyno” mokykla-darželis";Riešutėliai;4360099345;Ne;17;0;0;17
19985;"„Atžalyno” mokykla-darželis";Riešutėliai;5947938371;Ne;0;0;12;12
19986;"„Atžalyno” mokykla-darželis";Riešutėliai;5384245347;Ne;0;8;0;8
19987;"„Atžalyno” mokykla-darželis";Riešutėliai;4246430352;Ne;15;2;0;17
19988;"„Atžalyno” mokykla-darželis";Riešutėliai;8574494664;Ne;10;6;0;16
19989;"„Atžalyno” mokykla-darželis";Riešutėliai;5815412814;Ne;0;1;0;1
19990;"„Atžalyno” mokykla-darželis";Riešutėliai;8942132574;Ne;6;4;0;10
19991;"„Atžalyno” mokykla-darželis";Riešutėliai;3564781987;Ne;0;9;0;9
19992;"„Atžalyno” mokykla-darželis";Riešutėliai;7368616441;Ne;6;0;5;11
19993;"„Atžalyno” mokykla-darželis";Riešutėliai;5242752663;Ne;10;0;0;10
19994;"„Atžalyno” mokykla-darželis";Riešutėliai;5709028342;Ne;10;2;0;12
19995;"„Atžalyno” mokykla-darželis";Riešutėliai;8803555426;Ne;5;1;0;6
19996;"„Atžalyno” mokykla-darželis";Riešutėliai;5994983369;Ne;0;3;0;3
19997;"„Atžalyno” mokykla-darželis";Riešutėliai;1041363325;Ne;0;0;12;12
19998;"„Atžalyno” mokykla-darželis";Riešutėliai;7676614240;Ne;8;0;0;8
19999;"„Atžalyno” mokykla-darželis";Riešutėliai;3751729666;Ne;7;0;0;7
20000;"„Atžalyno” mokykla-darželis";Riešutėliai;3441950153;Ne;1;2;0;3
20001;"„Atžalyno” mokykla-darželis";Riešutėliai;4223591454;Ne;0;0;2;2
20002;"„Atžalyno” mokykla-darželis";Žirniukai;6903825217;Ne;0;13;0;13
20003;"„Atžalyno” mokykla-darželis";Žirniukai;9101301819;Ne;6;0;5;11
20004;"„Atžalyno” mokykla-darželis";Žirniukai;7579781779;Ne;5;1;0;6
20005;"„Atžalyno” mokykla-darželis";Žirniukai;1915676392;Ne;10;0;2;12
20006;"„Atžalyno” mokykla-darželis";Žirniukai;7669725276;Ne;0;10;0;10
20007;"„Atžalyno” mokykla-darželis";Žirniukai;5986664970;Ne;0;4;0;4
20008;"„Atžalyno” mokykla-darželis";Žirniukai;9913048992;Ne;3;4;0;7
20009;"„Atžalyno” mokykla-darželis";Žirniukai;4616870552;Ne;0;0;1;1
20010;"„Atžalyno” mokykla-darželis";Žirniukai;4107946143;Ne;0;0;1;1
20011;"„Atžalyno” mokykla-darželis";Žirniukai;7883570492;Ne;0;5;0;5
20012;"„Atžalyno” mokykla-darželis";Žirniukai;8320161812;Ne;5;1;0;6
20013;"„Atžalyno” mokykla-darželis";Žirniukai;5335059675;Ne;0;3;0;3
20014;"„Atžalyno” mokykla-darželis";Žirniukai;6922776405;Ne;0;0;12;12
20015;"„Atžalyno” mokykla-darželis";Žirniukai;9690554753;Ne;11;0;0;11
20016;"„Atžalyno” mokykla-darželis";Žirniukai;8070499557;Ne;0;6;0;6
20017;"„Atžalyno” mokykla-darželis";Žirniukai;2446697763;Ne;0;0;1;1
20018;"„Atžalyno” mokykla-darželis";Žirniukai;2462839180;Ne;0;1;0;1
20019;"„Atžalyno” mokykla-darželis";Žirniukai;4784990018;Ne;0;5;0;5
20020;"„Atžalyno” mokykla-darželis";VYŠNIUKAI;6120955217;Ne;5;1;0;6
20021;"„Atžalyno” mokykla-darželis";VYŠNIUKAI;1787256844;Ne;15;1;0;16
20022;"„Atžalyno” mokykla-darželis";VYŠNIUKAI;2547003287;Ne;15;1;0;16
20023;"„Atžalyno” mokykla-darželis";VYŠNIUKAI;3664056583;Ne;7;8;1;16
20024;"„Atžalyno” mokykla-darželis";VYŠNIUKAI;5456248305;Ne;14;0;0;14
20025;"„Atžalyno” mokykla-darželis";VYŠNIUKAI;3719072139;Ne;8;0;1;9
20026;"„Atžalyno” mokykla-darželis";VYŠNIUKAI;9245994735;Ne;10;6;0;16
20027;"„Atžalyno” mokykla-darželis";VYŠNIUKAI;3770167696;Ne;0;0;7;7
20028;"„Atžalyno” mokykla-darželis";VYŠNIUKAI;2000352986;Ne;0;6;0;6
20029;"„Atžalyno” mokykla-darželis";VYŠNIUKAI;2177213062;Ne;0;0;2;2
20030;"„Atžalyno” mokykla-darželis";VYŠNIUKAI;4635394632;Ne;2;0;2;4
20031;"„Atžalyno” mokykla-darželis";VYŠNIUKAI;3524131672;Ne;11;0;0;11
20032;"„Atžalyno” mokykla-darželis";VYŠNIUKAI;4840490901;Ne;17;0;0;17
20033;"„Atžalyno” mokykla-darželis";VYŠNIUKAI;4796052680;Ne;16;0;0;16
20034;"„Atžalyno” mokykla-darželis";VYŠNIUKAI;3181675972;Ne;1;0;2;3
20035;"„Atžalyno” mokykla-darželis";VYŠNIUKAI;8163063211;Ne;8;0;0;8
20036;"„Atžalyno” mokykla-darželis";VYŠNIUKAI;4431437971;Ne;2;2;0;4
20037;"„Atžalyno” mokykla-darželis";PIPIRIUKAI;8357021249;Ne;0;6;0;6
20038;"„Atžalyno” mokykla-darželis";PIPIRIUKAI;4785607785;Ne;10;0;0;10
20039;"„Atžalyno” mokykla-darželis";PIPIRIUKAI;5615246040;Ne;12;0;2;14
20040;"„Atžalyno” mokykla-darželis";PIPIRIUKAI;1988657552;Ne;10;0;10;20
20041;"„Atžalyno” mokykla-darželis";PIPIRIUKAI;2921181385;Ne;9;0;0;9
20042;"„Atžalyno” mokykla-darželis";PIPIRIUKAI;2108706876;Ne;12;0;0;12
20043;"„Atžalyno” mokykla-darželis";PIPIRIUKAI;1228919159;Ne;10;4;0;14
20044;"„Atžalyno” mokykla-darželis";PIPIRIUKAI;3919301151;Ne;8;0;0;8
20045;"„Atžalyno” mokykla-darželis";PIPIRIUKAI;3624299098;Ne;0;8;0;8
20046;"„Atžalyno” mokykla-darželis";PIPIRIUKAI;2537063401;Ne;0;0;8;8
20047;"„Atžalyno” mokykla-darželis";PIPIRIUKAI;4166521512;Ne;10;2;2;14
20048;"„Atžalyno” mokykla-darželis";PIPIRIUKAI;8372179128;Ne;0;0;6;6
20049;"„Atžalyno” mokykla-darželis";PIPIRIUKAI;3204191459;Ne;7;4;0;11
20050;"„Atžalyno” mokykla-darželis";PIPIRIUKAI;5321475187;Ne;0;1;0;1
20051;"„Atžalyno” mokykla-darželis";PIPIRIUKAI;3015863723;Ne;5;1;0;6
20052;"„Atžalyno” mokykla-darželis";PIPIRIUKAI;3323233525;Ne;5;1;0;6
20053;"„Atžalyno” mokykla-darželis";PIPIRIUKAI;4596770586;Ne;5;0;1;6
20054;"„Atžalyno” mokykla-darželis";PIPIRIUKAI;7652421432;Ne;3;0;3;6
20055;"Vilniaus Naujininkų mokykla";"SAULĖS ZUIKUČIAI";1096474672;Ne;8;1;0;9
20056;"Vilniaus Naujininkų mokykla";"SAULĖS ZUIKUČIAI";9856315057;Taip;0;1;0;1
20057;"Vilniaus Naujininkų mokykla";"SAULĖS ZUIKUČIAI";9427388681;Ne;0;1;0;1
20058;"Vilniaus Naujininkų mokykla";"SAULĖS ZUIKUČIAI";5512321795;Ne;0;4;0;4
20059;"Vilniaus Naujininkų mokykla";"SAULĖS ZUIKUČIAI";9411054207;Ne;7;1;0;8
20060;"Vilniaus Naujininkų mokykla";"SAULĖS ZUIKUČIAI";3810550099;Ne;0;11;0;11
20061;"Vilniaus Naujininkų mokykla";"SAULĖS ZUIKUČIAI";8935072613;Ne;4;1;4;9
20062;"Vilniaus Naujininkų mokykla";"SAULĖS ZUIKUČIAI";9544088525;Ne;1;1;0;2
20063;"Vilniaus Naujininkų mokykla";"SAULĖS ZUIKUČIAI";9488762308;Ne;0;22;0;22
20064;"Vilniaus Naujininkų mokykla";"SAULĖS ZUIKUČIAI";5148002236;Taip;0;1;0;1
20065;"Vilniaus Naujininkų mokykla";"SAULĖS ZUIKUČIAI";8352550813;Ne;0;0;14;14
20066;"Vilniaus Naujininkų mokykla";SMALSUČIAI;79174984189;Ne;0;1;1;2
20067;"Vilniaus Naujininkų mokykla";SMALSUČIAI;1662993666;Ne;0;1;1;2
20068;"Vilniaus Naujininkų mokykla";SMALSUČIAI;7144596269;Ne;0;5;0;5
20069;"Vilniaus Naujininkų mokykla";SMALSUČIAI;6362889550;Ne;4;1;6;11
20070;"Vilniaus Naujininkų mokykla";SMALSUČIAI;1980755137;Ne;0;14;0;14
20071;"Vilniaus Naujininkų mokykla";SMALSUČIAI;1920917916;Ne;7;5;0;12
20072;"Vilniaus Naujininkų mokykla";SMALSUČIAI;5633127620;Ne;5;2;2;9
20073;"Vilniaus Naujininkų mokykla";SMALSUČIAI;3867799187;Ne;0;1;5;6
20074;"Vilniaus Naujininkų mokykla";SMALSUČIAI;1350744949;Ne;7;2;0;9
20075;"Vilniaus Naujininkų mokykla";SMALSUČIAI;63557632023;Ne;10;0;0;10
20076;"Vilniaus Naujininkų mokykla";SMALSUČIAI;8280826634;Ne;0;2;2;4
20077;"Vilniaus Naujininkų mokykla";SMALSUČIAI;5302103644;Ne;7;7;0;14
20078;"Vilniaus Naujininkų mokykla";SMALSUČIAI;5638817349;Ne;0;0;3;3
20079;"Vilniaus Naujininkų mokykla";SMALSUČIAI;1880254518;Ne;12;2;0;14
20080;"Vilniaus Naujininkų mokykla";SMALSUČIAI;2113295854;Ne;0;1;0;1
20081;"Vilniaus karaliaus Mindaugo mokykla";"PUG 2";8957131694;Ne;4;0;0;4
20082;"Vilniaus karaliaus Mindaugo mokykla";"PUG 2";1146561649;Ne;0;0;8;8
20083;"Vilniaus karaliaus Mindaugo mokykla";"PUG 2";1159232792;Ne;4;0;5;9
20084;"Vilniaus karaliaus Mindaugo mokykla";"PUG 2";2248658930;Ne;0;0;2;2
20085;"Vilniaus karaliaus Mindaugo mokykla";"PUG 2";47454787439;Ne;0;0;1;1
20086;"Vilniaus karaliaus Mindaugo mokykla";"PUG 2";2092637040;Ne;11;0;3;14
20087;"Vilniaus karaliaus Mindaugo mokykla";"PUG 2";5029631107;Ne;0;0;1;1
20088;"Vilniaus karaliaus Mindaugo mokykla";"PUG 2";6196554287;Ne;0;0;1;1
20089;"Vilniaus karaliaus Mindaugo mokykla";"PUG 2";4661051023;Ne;0;0;9;9
20090;"Vilniaus karaliaus Mindaugo mokykla";"PUG 2";1507200600;Ne;0;0;4;4
20091;"Vilniaus karaliaus Mindaugo mokykla";"PUG 2";7440474403;Ne;0;0;8;8
20092;"Vilniaus karaliaus Mindaugo mokykla";"PUG 2";8860314164;Ne;0;0;2;2
20093;"Vilniaus karaliaus Mindaugo mokykla";"PUG 2";4684525618;Ne;4;0;2;6
20094;"Vilniaus karaliaus Mindaugo mokykla";"PUG 2";2876837284;Ne;0;0;1;1
20095;"Vilniaus karaliaus Mindaugo mokykla";"PUG 1";8879549409;Ne;0;0;1;1
20096;"Vilniaus karaliaus Mindaugo mokykla";"PUG 1";1904462840;Ne;0;0;1;1
20097;"Vilniaus karaliaus Mindaugo mokykla";"PUG 1";1781442182;Ne;0;0;1;1
20098;"Vilniaus karaliaus Mindaugo mokykla";"PUG 1";6299298199;Ne;0;0;3;3
20099;"Vilniaus karaliaus Mindaugo mokykla";"PUG 1";35830862363;Ne;3;7;0;10
20100;"Vilniaus karaliaus Mindaugo mokykla";"PUG 1";1830572633;Ne;2;0;1;3
20101;"Vilniaus karaliaus Mindaugo mokykla";"PUG 1";4143153535;Ne;6;0;0;6
20102;"Vilniaus karaliaus Mindaugo mokykla";"PUG 1";9329518124;Ne;4;0;5;9
20103;"Vilniaus karaliaus Mindaugo mokykla";"PUG 1";1505918280;Ne;0;0;2;2
20104;"Vilniaus karaliaus Mindaugo mokykla";"PUG 1";1445657342;Ne;0;0;2;2
20105;"Vilniaus karaliaus Mindaugo mokykla";"PUG 1";9313380552;Ne;0;0;1;1
20106;"Vilniaus karaliaus Mindaugo mokykla";"PUG 1";7782678159;Ne;0;0;3;3
20107;"Vilniaus karaliaus Mindaugo mokykla";"PUG 1";14043704729;Ne;0;0;5;5
20108;"Vilniaus karaliaus Mindaugo mokykla";"PUG 1";7876029445;Ne;0;0;4;4
20109;"Vilniaus karaliaus Mindaugo mokykla";"PUG 1";4724383814;Ne;0;0;9;9
20110;"Vilniaus karaliaus Mindaugo mokykla";"PUG 1";1376514473;Ne;0;0;1;1
20111;"Vilniaus karaliaus Mindaugo mokykla";"PUG 3";3490705425;Ne;5;1;1;7
20112;"Vilniaus karaliaus Mindaugo mokykla";"PUG 3";7433354196;Ne;0;0;2;2
20113;"Vilniaus karaliaus Mindaugo mokykla";"PUG 3";2836206893;Ne;6;2;0;8
20114;"Vilniaus karaliaus Mindaugo mokykla";"PUG 3";38426234048;Ne;0;0;1;1
20115;"Vilniaus karaliaus Mindaugo mokykla";"PUG 3";1502213914;Ne;0;0;4;4
20116;"Vilniaus karaliaus Mindaugo mokykla";"PUG 3";1929838733;Ne;0;6;5;11
20117;"Vilniaus karaliaus Mindaugo mokykla";"PUG 3";9638976786;Ne;0;5;0;5
20118;"Vilniaus karaliaus Mindaugo mokykla";"PUG 3";4677405885;Ne;0;0;2;2
20119;"Vilniaus karaliaus Mindaugo mokykla";"PUG 3";6406285034;Ne;0;0;4;4
20120;"Vilniaus karaliaus Mindaugo mokykla";"PUG 3";7132574496;Ne;0;0;4;4
20121;"Vilniaus karaliaus Mindaugo mokykla";"PUG 3";2043786151;Ne;0;3;1;4
20122;Ąžuolas;Nykštukų;3500326530;Ne;3;0;0;3
20123;Ąžuolas;Nykštukų;7514774129;Ne;5;0;0;5
20124;Ąžuolas;Nykštukų;6774621338;Ne;10;0;0;10
20125;Ąžuolas;Boružiukų;4679706797;Ne;4;0;0;4
20126;Ąžuolas;Boružiukų;7318553736;Ne;5;0;0;5
20127;Ąžuolas;Boružiukų;9112345026;Ne;5;0;0;5
20128;Ąžuolas;Boružiukų;2204716407;Ne;5;0;0;5
20129;Ąžuolas;Boružiukų;8798283478;Ne;5;0;0;5
20130;Ąžuolas;Spinduliukų;5068122209;Ne;10;0;0;10
20131;Ąžuolas;Spinduliukų;7276934858;Ne;5;0;0;5
20132;Ąžuolas;Spinduliukų;4245840433;Ne;5;0;0;5
20133;Ąžuolas;Zuikučių;8615752261;Ne;3;0;0;3
20134;Ąžuolas;Zuikučių;7751329226;Ne;4;0;0;4
20135;Ąžuolas;Zuikučių;3758901408;Ne;2;0;0;2
20136;Ąžuolas;Zuikučių;9058138845;Ne;4;0;0;4
20137;Ąžuolas;Zuikučių;6802405421;Ne;4;0;0;4
20138;Ąžuolas;Drugelių;2929166765;Ne;3;0;0;3
20139;Ąžuolas;Žemuogėlių;9684318260;Ne;6;0;0;6
20140;Ąžuolas;Žemuogėlių;9747622991;Ne;2;0;0;2
20141;Ąžuolas;Paukštelių;8601254064;Ne;3;0;0;3
20142;Ąžuolas;Bitučių;1087056237;Ne;5;0;0;5
20143;Ąžuolas;Giliukų;3707386873;Ne;7;0;0;7
20144;Ąžuolas;Giliukų;2605495372;Ne;3;0;0;3
20145;"Vilniaus Levo Karsavino vidurinė mokykla";PELEDŽIUKAI;2149830021;Ne;5;0;1;6
20146;"Vilniaus Levo Karsavino vidurinė mokykla";PELEDŽIUKAI;2718046390;Ne;2;0;0;2
20147;"Vilniaus Levo Karsavino vidurinė mokykla";PELEDŽIUKAI;9094287056;Ne;0;6;0;6
20148;"Vilniaus Levo Karsavino vidurinė mokykla";PELEDŽIUKAI;8721423900;Ne;0;0;7;7
20149;"Vilniaus Levo Karsavino vidurinė mokykla";PELEDŽIUKAI;6917007871;Ne;0;0;11;11
20150;"Vilniaus Levo Karsavino vidurinė mokykla";PELEDŽIUKAI;3452236805;Ne;0;22;0;22
20151;"Vilniaus Levo Karsavino vidurinė mokykla";PELEDŽIUKAI;4066969586;Ne;0;0;14;14
20152;"Vilniaus Levo Karsavino vidurinė mokykla";PELEDŽIUKAI;1067737206;Ne;0;10;0;10
20153;"Vilniaus Levo Karsavino vidurinė mokykla";PELEDŽIUKAI;1288690113;Ne;0;9;0;9
20154;"Vilniaus Levo Karsavino vidurinė mokykla";PELEDŽIUKAI;55396452032;Ne;2;0;1;3
20155;"Vilniaus Levo Karsavino vidurinė mokykla";PELEDŽIUKAI;2276463136;Ne;11;0;0;11
20156;"Vilniaus Levo Karsavino vidurinė mokykla";PELEDŽIUKAI;43259107285;Ne;0;5;0;5
20157;"Vilniaus Levo Karsavino vidurinė mokykla";PELEDŽIUKAI;9947263640;Ne;5;0;5;10
20158;"Vilniaus Levo Karsavino vidurinė mokykla";PELEDŽIUKAI;3641595127;Ne;2;8;0;10
20159;"Vilniaus Levo Karsavino vidurinė mokykla";PELEDŽIUKAI;3254847545;Ne;0;22;0;22
20160;"Vilniaus Levo Karsavino vidurinė mokykla";PELEDŽIUKAI;3381954095;Ne;0;0;4;4
20161;"Vilniaus Levo Karsavino vidurinė mokykla";PELEDŽIUKAI;7227603702;Ne;0;0;1;1
20162;"Vilniaus Levo Karsavino vidurinė mokykla";PELEDŽIUKAI;57138305703;Ne;10;0;3;13
20163;"Vilniaus Levo Karsavino vidurinė mokykla";PELEDŽIUKAI;5768653399;Ne;0;0;4;4
20164;"Vilniaus Levo Karsavino vidurinė mokykla";Žiniukai;5452659798;Ne;0;2;0;2
20165;"Vilniaus Levo Karsavino vidurinė mokykla";Žiniukai;5803032683;Ne;0;0;1;1
20166;"Vilniaus Levo Karsavino vidurinė mokykla";Žiniukai;2306517891;Ne;0;21;0;21
20167;"Vilniaus Levo Karsavino vidurinė mokykla";Žiniukai;1428614163;Ne;4;0;1;5
20168;"Vilniaus Levo Karsavino vidurinė mokykla";Žiniukai;9801214344;Ne;0;21;0;21
20169;"Vilniaus Levo Karsavino vidurinė mokykla";Žiniukai;8180889070;Ne;4;0;1;5
20170;"Vilniaus Levo Karsavino vidurinė mokykla";Žiniukai;7023565057;Ne;0;0;2;2
20171;"Vilniaus Levo Karsavino vidurinė mokykla";Žiniukai;7804533930;Ne;0;0;1;1
20172;"Vilniaus Levo Karsavino vidurinė mokykla";Žiniukai;3379725202;Ne;8;0;0;8
20173;"Vilniaus Levo Karsavino vidurinė mokykla";Žiniukai;7298260831;Ne;4;0;0;4
20174;"Vilniaus Levo Karsavino vidurinė mokykla";Žiniukai;7920182730;Ne;7;0;1;8
20175;"Vilniaus Levo Karsavino vidurinė mokykla";Žiniukai;12377363480;Ne;4;0;0;4
20176;"Vilniaus Levo Karsavino vidurinė mokykla";Žiniukai;8199573104;Ne;4;0;10;14
20177;"Vilniaus Levo Karsavino vidurinė mokykla";Žiniukai;9589810356;Ne;10;0;0;10
20178;"Vilniaus Levo Karsavino vidurinė mokykla";Žiniukai;64214150955;Ne;5;0;0;5
20179;"Vilniaus Levo Karsavino vidurinė mokykla";Žiniukai;6340289012;Ne;0;0;5;5
20180;"Vilniaus Levo Karsavino vidurinė mokykla";Žiniukai;3680925050;Ne;4;0;0;4
20181;"Vilniaus Liepkalnio Pagrindinė Mokykla";Bitutės;5597152556;Ne;7;0;4;11
20182;"Vilniaus Liepkalnio Pagrindinė Mokykla";Bitutės;4115995882;Ne;0;0;11;11
20183;"Vilniaus Liepkalnio Pagrindinė Mokykla";Bitutės;6136792125;Ne;4;0;6;10
20184;"Vilniaus Liepkalnio Pagrindinė Mokykla";Bitutės;9293634828;Ne;7;0;6;13
20185;"Vilniaus Liepkalnio Pagrindinė Mokykla";Bitutės;8324581018;Ne;0;0;14;14
20186;"Vilniaus Liepkalnio Pagrindinė Mokykla";Bitutės;1599633295;Ne;0;0;6;6
20187;"Vilniaus Liepkalnio Pagrindinė Mokykla";Bitutės;9589525954;Ne;0;0;4;4
20188;"Vilniaus Liepkalnio Pagrindinė Mokykla";Bitutės;7052487356;Ne;10;0;8;18
20189;"Vilniaus Liepkalnio Pagrindinė Mokykla";Bitutės;2080390421;Ne;0;0;8;8
20190;"Vilniaus Liepkalnio Pagrindinė Mokykla";Bitutės;5323726165;Ne;8;0;5;13
20191;"Vilniaus Liepkalnio Pagrindinė Mokykla";Bitutės;7922755136;Ne;0;0;11;11
20192;"Vilniaus Liepkalnio Pagrindinė Mokykla";Bitutės;1578956182;Ne;0;0;5;5
20193;"Vilniaus Liepkalnio Pagrindinė Mokykla";Bitutės;3721504364;Ne;0;0;4;4
20194;"Vilniaus Liepkalnio Pagrindinė Mokykla";Bitutės;1795366502;Ne;0;0;15;15
20195;"Vilniaus Liepkalnio Pagrindinė Mokykla";Bitutės;4112888719;Ne;5;0;0;5
20196;"Vilniaus Liepkalnio Pagrindinė Mokykla";Bitutės;8809471063;Ne;6;0;0;6
20197;"Vilniaus Liepkalnio Pagrindinė Mokykla";Bitutės;5197037585;Ne;5;0;8;13
20198;"Vilniaus Liepkalnio Pagrindinė Mokykla";Bitutės;9771780358;Ne;0;0;17;17
20199;"Vilniaus Liepkalnio Pagrindinė Mokykla";Bitutės;4973569038;Ne;13;0;5;18
20200;"Vilniaus Pranciškaus Skorinos gimnazija";Saulytė;5194059497;Ne;5;0;4;9
20201;"Vilniaus Pranciškaus Skorinos gimnazija";Saulytė;5034268767;Ne;0;2;3;5
20202;"Vilniaus Pranciškaus Skorinos gimnazija";Saulytė;3036582121;Ne;0;1;0;1
20203;"Vilniaus Pranciškaus Skorinos gimnazija";Saulytė;5304082676;Ne;22;0;0;22
20204;"Vilniaus Pranciškaus Skorinos gimnazija";Saulytė;7055894770;Ne;0;11;0;11
20205;"Vilniaus Pranciškaus Skorinos gimnazija";Saulytė;6995285377;Ne;10;1;0;11
20206;"Vilniaus Pranciškaus Skorinos gimnazija";Saulytė;3984446381;Ne;8;2;0;10
20207;"Vilniaus Pranciškaus Skorinos gimnazija";Saulytė;8641919789;Ne;0;11;2;13
20208;"Vilniaus Pranciškaus Skorinos gimnazija";Saulytė;4501408366;Ne;0;2;0;2
20209;"Vilniaus Pranciškaus Skorinos gimnazija";Saulytė;4705514590;Ne;3;0;0;3
20210;"Vilniaus Pranciškaus Skorinos gimnazija";Saulytė;4165354124;Ne;0;2;0;2
20211;"Vilniaus Pranciškaus Skorinos gimnazija";Saulytė;6940231858;Ne;7;1;0;8
20212;"Vilniaus Pranciškaus Skorinos gimnazija";Saulytė;8572069816;Ne;0;1;0;1
20213;"Vilniaus Pranciškaus Skorinos gimnazija";Saulytė;4810459063;Ne;8;1;1;10
20214;"Vilniaus Pranciškaus Skorinos gimnazija";Saulytė;3354419392;Ne;0;22;0;22
20215;"Vilniaus Pranciškaus Skorinos gimnazija";Saulytė;9176198859;Ne;3;0;3;6
20216;"Vilniaus Pranciškaus Skorinos gimnazija";Saulytė;3234612149;Ne;8;3;0;11
20217;"Vilniaus Simono Konarskio mokykla";"1 GR.";1464992631;Ne;7;0;0;7
20218;"Vilniaus Simono Konarskio mokykla";"1 GR.";9822287576;Ne;5;0;0;5
20219;"Vilniaus Simono Konarskio mokykla";"1 GR.";7052198958;Ne;5;0;0;5
20220;"Vilniaus Simono Konarskio mokykla";"1 GR.";1048630061;Ne;11;0;0;11
20221;"Vilniaus Simono Konarskio mokykla";"1 GR.";9093492513;Ne;8;0;0;8
20222;"Vilniaus Trakų Vokės gimnazija";Priešmokyklinė;9386629495;Ne;9;0;0;9
20223;"Vilniaus Trakų Vokės gimnazija";Priešmokyklinė;6209271043;Ne;9;5;0;14
20224;"Vilniaus Trakų Vokės gimnazija";Priešmokyklinė;3406479364;Ne;0;6;3;9
20225;"Vilniaus Trakų Vokės gimnazija";Priešmokyklinė;1461337199;Ne;0;4;0;4
20226;"Vilniaus Trakų Vokės gimnazija";Priešmokyklinė;5526830430;Ne;0;2;1;3
20227;"Vilniaus Trakų Vokės gimnazija";Priešmokyklinė;4849992906;Ne;3;1;0;4
20228;"Vilniaus Trakų Vokės gimnazija";Priešmokyklinė;3098390989;Ne;0;1;0;1
20229;"Vilniaus Trakų Vokės gimnazija";Priešmokyklinė;50553766116;Ne;6;0;0;6
20230;"Vilniaus Trakų Vokės gimnazija";Priešmokyklinė;8542147751;Ne;7;6;0;13
20231;"Vilniaus Trakų Vokės gimnazija";Priešmokyklinė;2672165297;Ne;10;10;0;20
20232;"Vilniaus Trakų Vokės gimnazija";Priešmokyklinė;2955411131;Ne;4;2;0;6
20233;"Vilniaus Trakų Vokės gimnazija";Priešmokyklinė;4846130117;Ne;0;6;0;6
20234;"Vilniaus Trakų Vokės gimnazija";Priešmokyklinė;1433982328;Ne;0;2;2;4
20235;"Vilniaus Trakų Vokės gimnazija";Priešmokyklinė;8658085249;Ne;8;1;0;9
20236;"Vilniaus Trakų Vokės gimnazija";Priešmokyklinė;39255784762;Ne;2;2;4;8
20237;"Vilniaus Trakų Vokės gimnazija";Priešmokyklinė;4599632235;Ne;8;3;0;11
20238;"Vilniaus Trakų Vokės gimnazija";Priešmokyklinė;2839396687;Ne;6;5;2;13
20239;"Vilniaus Trakų Vokės gimnazija";Priešmokyklinė;8857529726;Ne;8;9;4;21
20240;"Vilniaus Trakų Vokės gimnazija";Priešmokyklinė;7566567901;Ne;0;6;1;7
20241;"Vilniaus Trakų Vokės gimnazija";"Priešmokyklinė 2";4362066941;Ne;0;14;0;14
20242;"Vilniaus Trakų Vokės gimnazija";"Priešmokyklinė 2";1074730366;Ne;0;1;3;4
20243;"Vilniaus Trakų Vokės gimnazija";"Priešmokyklinė 2";6593654477;Ne;5;2;0;7
20244;"Vilniaus Trakų Vokės gimnazija";"Priešmokyklinė 2";9582511053;Ne;0;12;0;12
20245;"Vilniaus Trakų Vokės gimnazija";"Priešmokyklinė 2";3775081619;Ne;0;9;0;9
20246;"Vilniaus Trakų Vokės gimnazija";"Priešmokyklinė 2";4615315809;Ne;1;0;9;10
20247;"Vilniaus Trakų Vokės gimnazija";"Priešmokyklinė 2";25106446270;Ne;10;3;0;13
20248;"Vilniaus Trakų Vokės gimnazija";"Priešmokyklinė 2";18963190527;Ne;0;2;0;2
20249;"Vilniaus Trakų Vokės gimnazija";"Priešmokyklinė 2";4914675622;Ne;0;5;3;8
20250;"Vilniaus Trakų Vokės gimnazija";"Priešmokyklinė 2";5251929660;Ne;0;14;0;14
20251;"Vilniaus Trakų Vokės gimnazija";"Priešmokyklinė 2";3690179876;Ne;0;0;13;13
20252;"Vilniaus Trakų Vokės gimnazija";"Priešmokyklinė 2";8218370873;Ne;0;12;0;12
20253;"Vilniaus Trakų Vokės gimnazija";"Priešmokyklinė 2";6615724604;Ne;0;11;1;12
20254;"Vilniaus Trakų Vokės gimnazija";"Priešmokyklinė 2";4720226790;Ne;0;4;4;8
20255;"Vilniaus Trakų Vokės gimnazija";"Priešmokyklinė 2";1057189769;Ne;0;14;1;15
20256;"Vilniaus Trakų Vokės gimnazija";"Priešmokyklinė 2";2149804129;Ne;0;1;2;3
20257;"Vilniaus Trakų Vokės gimnazija";"Priešmokyklinė 2";1590598232;Ne;0;3;3;6
20258;"Vilniaus Trakų Vokės gimnazija";"Priešmokyklinė 2";8168960897;Ne;0;11;0;11
20259;"Vilniaus Trakų Vokės gimnazija";"Priešmokyklinė 2";9039274775;Ne;0;0;4;4
20260;"Vilniaus Trakų Vokės gimnazija";"Priešmokyklinė 3";7547303829;Ne;7;2;4;13
20261;"Vilniaus Trakų Vokės gimnazija";"Priešmokyklinė 3";2301758912;Ne;0;7;0;7
20262;"Vilniaus Trakų Vokės gimnazija";"Priešmokyklinė 3";7792654474;Taip;0;1;1;2
20263;"Vilniaus Trakų Vokės gimnazija";"Priešmokyklinė 3";3449317958;Ne;2;1;0;3
20264;"Vilniaus Trakų Vokės gimnazija";"Priešmokyklinė 3";9268558715;Ne;0;0;2;2
20265;"Vilniaus Trakų Vokės gimnazija";"Priešmokyklinė 3";9668538340;Ne;0;8;0;8
20266;"Vilniaus Trakų Vokės gimnazija";"Priešmokyklinė 3";2469486746;Ne;3;5;5;13
20267;"Vilniaus Trakų Vokės gimnazija";"Priešmokyklinė 3";1053286928;Ne;0;2;0;2
20268;"Vilniaus Trakų Vokės gimnazija";"Priešmokyklinė 3";5115117246;Ne;7;0;10;17
20269;"Vilniaus Trakų Vokės gimnazija";"Priešmokyklinė 3";6765094662;Ne;10;2;0;12
20270;"Vilniaus Trakų Vokės gimnazija";"Priešmokyklinė 3";6835150864;Ne;0;3;0;3
20271;"Vilniaus Trakų Vokės gimnazija";"Priešmokyklinė 3";1940148622;Ne;0;0;6;6
20272;"Vilniaus Trakų Vokės gimnazija";"Priešmokyklinė 3";8929514493;Ne;0;4;0;4
20273;"Vilniaus Trakų Vokės gimnazija";"Priešmokyklinė 3";9051697544;Ne;0;10;6;16
20274;"Vilniaus Trakų Vokės gimnazija";"Priešmokyklinė 3";1398572100;Ne;0;10;1;11
20275;"Vilniaus Trakų Vokės gimnazija";"Priešmokyklinė 3";2730385281;Ne;8;6;0;14
20276;"Vilniaus Trakų Vokės gimnazija";"Priešmokyklinė 3";2906094725;Ne;0;3;0;3
20277;"Vilniaus Trakų Vokės gimnazija";"Priešmokyklinė 3";9819489467;Ne;0;3;0;3
20278;"Vilniaus Salininkų gimnazija";"Priešmokyklinė A";22167560908;Ne;0;1;0;1
20279;"Vilniaus Salininkų gimnazija";"Priešmokyklinė A";10335028421;Ne;0;2;0;2
20280;"Vilniaus Salininkų gimnazija";"Priešmokyklinė A";8683841956;Ne;8;1;0;9
20281;"Vilniaus Salininkų gimnazija";"Priešmokyklinė A";1180792335;Ne;0;3;0;3
20282;"Vilniaus Salininkų gimnazija";"Priešmokyklinė A";5063792784;Ne;5;3;0;8
20283;"Vilniaus Salininkų gimnazija";"Priešmokyklinė A";1704033440;Ne;4;0;0;4
20284;"Vilniaus Salininkų gimnazija";"Priešmokyklinė A";46867660097;Ne;0;2;0;2
20285;"Vilniaus Salininkų gimnazija";"Priešmokyklinė A";3692008687;Ne;8;5;0;13
20286;"Vilniaus Salininkų gimnazija";"Priešmokyklinė A";2292919406;Ne;0;3;0;3
20287;"Vilniaus Salininkų gimnazija";"Priešmokyklinė A";35611320012;Ne;6;1;0;7
20288;"Vilniaus Salininkų gimnazija";"Priešmokyklinė A";4269202761;Ne;0;3;0;3
20289;"Vilniaus Salininkų gimnazija";"Priešmokyklinė A";9375550172;Ne;2;1;0;3
20290;"Vilniaus Salininkų gimnazija";"Priešmokyklinė A";7160091629;Ne;0;13;0;13
20291;"Vilniaus Salininkų gimnazija";"Priešmokyklinė A";41023354439;Ne;0;2;0;2
20292;"Vilniaus Salininkų gimnazija";"Priešmokyklinė A";1642658060;Ne;0;1;0;1
20293;"Vilniaus Salininkų gimnazija";"Priešmokyklinė A";3848448401;Ne;5;1;0;6
20294;"Vilniaus Salininkų gimnazija";"Priešmokyklinė A";3737786832;Ne;7;0;0;7
20295;"Vilniaus Salininkų gimnazija";"Priešmokyklinė A";4939261324;Ne;9;1;0;10
20296;"Vilniaus Salininkų gimnazija";"Priešmokyklinė A";6738902611;Ne;0;22;0;22
20297;"Vilniaus Salininkų gimnazija";"Priešmokyklinė A";2989580886;Ne;0;2;0;2
20298;"Vilniaus Salininkų gimnazija";"Priešmokyklinė A";3661928980;Ne;0;2;0;2
20299;"Vilniaus Salininkų gimnazija";"PRIEŠMOKYKLINĖ B";7378039370;Ne;10;0;0;10
20300;"Vilniaus Salininkų gimnazija";"PRIEŠMOKYKLINĖ B";98941037508;Ne;0;22;0;22
20301;"Vilniaus Salininkų gimnazija";"PRIEŠMOKYKLINĖ B";8018093186;Ne;5;1;0;6
20302;"Vilniaus Salininkų gimnazija";"PRIEŠMOKYKLINĖ B";9216372353;Ne;3;1;0;4
20303;"Vilniaus Salininkų gimnazija";"PRIEŠMOKYKLINĖ B";3015424614;Taip;7;6;0;13
20304;"Vilniaus Salininkų gimnazija";"PRIEŠMOKYKLINĖ B";8488127476;Ne;3;0;0;3
20305;"Vilniaus Salininkų gimnazija";"PRIEŠMOKYKLINĖ B";8410624264;Ne;4;4;0;8
20306;"Vilniaus Salininkų gimnazija";"PRIEŠMOKYKLINĖ B";1544346282;Ne;4;0;0;4
20307;"Vilniaus Salininkų gimnazija";"PRIEŠMOKYKLINĖ B";2066091911;Ne;3;0;0;3
20308;"Vilniaus Salininkų gimnazija";"PRIEŠMOKYKLINĖ B";1723241116;Ne;2;0;0;2
20309;"Vilniaus Salininkų gimnazija";"PRIEŠMOKYKLINĖ B";30123603107;Ne;2;0;0;2
20310;"Vilniaus Salininkų gimnazija";"PRIEŠMOKYKLINĖ B";8288199783;Ne;5;0;0;5
20311;"Vilniaus Salininkų gimnazija";"PRIEŠMOKYKLINĖ B";1065549119;Ne;5;0;0;5
20312;"Vilniaus Salininkų gimnazija";"PRIEŠMOKYKLINĖ B";1460694577;Ne;0;22;0;22
20313;"Vilniaus Salininkų gimnazija";"PRIEŠMOKYKLINĖ B";2786775879;Ne;6;0;0;6
20314;"Vilniaus Salininkų gimnazija";"PRIEŠMOKYKLINĖ B";9026612929;Ne;0;22;0;22
20315;"Vilniaus Salininkų gimnazija";"PRIEŠMOKYKLINĖ B";4271670413;Ne;5;1;0;6
20316;"Vilniaus „Spindulio“ progimnazija";PM2;3093606855;Ne;6;0;0;6
20317;"Vilniaus „Spindulio“ progimnazija";PM2;5078945984;Ne;0;10;0;10
20318;"Vilniaus „Spindulio“ progimnazija";PM2;9099945815;Ne;0;1;0;1
20319;"Vilniaus „Spindulio“ progimnazija";PM2;75538036055;Ne;0;3;0;3
20320;"Vilniaus „Spindulio“ progimnazija";PM2;15583558585;Ne;5;5;2;12
20321;"Vilniaus „Spindulio“ progimnazija";PM2;2427349194;Ne;4;12;0;16
20322;"Vilniaus „Spindulio“ progimnazija";PM2;7445566160;Ne;7;4;0;11
20323;"Vilniaus „Spindulio“ progimnazija";PM2;8023936861;Ne;0;0;1;1
20324;"Vilniaus „Spindulio“ progimnazija";PM2;7277680544;Ne;3;0;0;3
20325;"Vilniaus „Spindulio“ progimnazija";PM2;6479094819;Ne;13;0;0;13
20326;"Vilniaus „Spindulio“ progimnazija";PM2;6016791282;Ne;0;5;1;6
20327;"Vilniaus „Spindulio“ progimnazija";PM2;2356833740;Ne;0;0;1;1
20328;"Vilniaus „Spindulio“ progimnazija";PM2;1338287524;Ne;0;2;0;2
20329;"Vilniaus „Spindulio“ progimnazija";PM2;9516852657;Ne;7;0;7;14
20330;"Vilniaus „Spindulio“ progimnazija";PM2;1364873935;Ne;0;7;2;9
20331;"Vilniaus „Spindulio“ progimnazija";PM2;7120717682;Ne;0;2;0;2
20332;"Vilniaus „Spindulio“ progimnazija";PM2;1183272346;Ne;0;0;1;1
20333;"Vilniaus „Spindulio“ progimnazija";PM2;6201567680;Ne;6;0;0;6
20334;"Vilniaus „Spindulio“ progimnazija";PM2;8012626513;Ne;5;0;0;5
20335;"Vilniaus „Spindulio“ progimnazija";PM2;4791752179;Ne;0;1;0;1
20336;"Vilniaus „Spindulio“ progimnazija";PM1;1948438336;Ne;0;2;2;4
20337;"Vilniaus „Spindulio“ progimnazija";PM1;43859975789;Ne;0;0;4;4
20338;"Vilniaus „Spindulio“ progimnazija";PM1;4701887030;Ne;0;1;0;1
20339;"Vilniaus „Spindulio“ progimnazija";PM1;60320557464;Ne;3;0;2;5
20340;"Vilniaus „Spindulio“ progimnazija";PM1;2531571615;Ne;0;2;0;2
20341;"Vilniaus „Spindulio“ progimnazija";PM1;3678131609;Ne;0;2;0;2
20342;"Vilniaus „Spindulio“ progimnazija";PM1;1194444282;Ne;0;1;0;1
20343;"Vilniaus „Spindulio“ progimnazija";PM1;56885383122;Ne;0;3;1;4
20344;"Vilniaus „Spindulio“ progimnazija";PM1;1338476746;Ne;0;2;0;2
20345;"Vilniaus „Spindulio“ progimnazija";PM1;1251961268;Ne;3;1;0;4
20346;"Vilniaus „Spindulio“ progimnazija";PM1;6700068320;Ne;0;3;0;3
20347;"Vilniaus „Spindulio“ progimnazija";PM1;9573336239;Ne;9;0;0;9
20348;"Vilniaus „Spindulio“ progimnazija";PM1;1325054642;Ne;0;2;0;2
20349;"Vilniaus „Spindulio“ progimnazija";PM1;1160537966;Ne;0;2;0;2
20350;"Vilniaus „Spindulio“ progimnazija";PM1;1789047913;Ne;0;8;0;8
20351;"Vilniaus Vladislavo Sirokomlės gimnazija";Nykštukai;1797237248;Ne;0;1;0;1
20352;"Vilniaus Vladislavo Sirokomlės gimnazija";Nykštukai;6031408197;Ne;0;0;2;2
20353;"Vilniaus Vladislavo Sirokomlės gimnazija";Nykštukai;1947403400;Ne;0;1;0;1
20354;"Vilniaus Vladislavo Sirokomlės gimnazija";Nykštukai;1499061139;Ne;2;15;0;17
20355;"Vilniaus Vladislavo Sirokomlės gimnazija";Nykštukai;2219712757;Ne;4;0;0;4
20356;"Vilniaus Vladislavo Sirokomlės gimnazija";Nykštukai;5544613599;Ne;0;10;0;10
20357;"Vilniaus Vladislavo Sirokomlės gimnazija";Nykštukai;25415760747;Ne;0;2;0;2
20358;"Vilniaus Vladislavo Sirokomlės gimnazija";Nykštukai;17201639406;Ne;0;2;0;2
20359;"Vilniaus Vladislavo Sirokomlės gimnazija";Nykštukai;8302624354;Ne;0;2;0;2
20360;"Vilniaus Vladislavo Sirokomlės gimnazija";Nykštukai;1492328724;Ne;0;3;0;3
20361;"Vilniaus Vladislavo Sirokomlės gimnazija";Nykštukai;1837566431;Ne;0;1;0;1
20362;"Vilniaus Vladislavo Sirokomlės gimnazija";Nykštukai;8016643568;Ne;0;1;0;1
20363;"Vilniaus Vladislavo Sirokomlės gimnazija";Nykštukai;4534828670;Ne;7;10;0;17
20364;"Vilniaus Vladislavo Sirokomlės gimnazija";Nykštukai;9391697537;Ne;0;1;0;1
20365;"Vilniaus Vladislavo Sirokomlės gimnazija";Nykštukai;5422289286;Taip;0;5;0;5
20366;"Vilniaus Vladislavo Sirokomlės gimnazija";Nykštukai;5625943720;Ne;0;10;0;10
20367;"Vilniaus Vladislavo Sirokomlės gimnazija";Nykštukai;2946297529;Ne;0;1;0;1
20368;"Vilniaus Vladislavo Sirokomlės gimnazija";Smurfai;5844437769;Ne;0;1;0;1
20369;"Vilniaus Vladislavo Sirokomlės gimnazija";Smurfai;9751494612;Ne;0;2;0;2
20370;"Vilniaus Vladislavo Sirokomlės gimnazija";Smurfai;4727265555;Ne;0;5;0;5
20371;"Vilniaus Vladislavo Sirokomlės gimnazija";Smurfai;7071043164;Ne;0;2;0;2
20372;"Vilniaus Vladislavo Sirokomlės gimnazija";Smurfai;1493604303;Ne;8;7;0;15
20373;"Vilniaus Vladislavo Sirokomlės gimnazija";Smurfai;4830374546;Ne;4;4;0;8
20374;"Vilniaus Vladislavo Sirokomlės gimnazija";Smurfai;4506651162;Ne;1;3;0;4
20375;"Vilniaus Vladislavo Sirokomlės gimnazija";Smurfai;1817869518;Ne;2;12;0;14
20376;"Vilniaus Vladislavo Sirokomlės gimnazija";Smurfai;1512245903;Ne;0;4;0;4
20377;"Vilniaus Vladislavo Sirokomlės gimnazija";Smurfai;7904983228;Ne;0;1;0;1
20378;"Vilniaus Vladislavo Sirokomlės gimnazija";Smurfai;1570206034;Ne;6;4;0;10
20379;"Vilniaus Vladislavo Sirokomlės gimnazija";Smurfai;1820583792;Ne;0;2;0;2
20380;"Vilniaus Vladislavo Sirokomlės gimnazija";Smurfai;2386927970;Ne;1;5;0;6
20381;"Vilniaus Vladislavo Sirokomlės gimnazija";Smurfai;92356998180;Ne;0;1;0;1
20382;"Vilniaus Vladislavo Sirokomlės gimnazija";Smurfai;4990982790;Ne;0;6;0;6
20383;"Vilniaus Vladislavo Sirokomlės gimnazija";Smurfai;3795927209;Ne;0;1;0;1
20384;"Vilniaus Vladislavo Sirokomlės gimnazija";Smurfai;3880578523;Ne;0;7;0;7
20385;"Vilniaus Vladislavo Sirokomlės gimnazija";Smurfai;9868386182;Ne;5;5;0;10
20386;"Vilniaus Vladislavo Sirokomlės gimnazija";Smurfai;1090204906;Ne;0;1;0;1
20387;"Vilniaus „Pelėdos” pradinė mokykla";Bitutės;2023718424;Ne;0;0;2;2
20388;"Vilniaus „Pelėdos” pradinė mokykla";Bitutės;13170636069;Ne;0;0;1;1
20389;"Vilniaus „Pelėdos” pradinė mokykla";Bitutės;7678062264;Ne;15;0;1;16
20390;"Vilniaus „Pelėdos” pradinė mokykla";Bitutės;20602164053;Ne;0;0;2;2
20391;"Vilniaus „Pelėdos” pradinė mokykla";Bitutės;6610166355;Ne;0;0;2;2
20392;"Vilniaus „Pelėdos” pradinė mokykla";Bitutės;4427123314;Ne;0;4;1;5
20393;"Vilniaus „Pelėdos” pradinė mokykla";Bitutės;5610993611;Ne;4;0;5;9
20394;"Vilniaus „Pelėdos” pradinė mokykla";Bitutės;1121936989;Ne;0;0;2;2
20395;"Vilniaus „Pelėdos” pradinė mokykla";Bitutės;9558483512;Ne;0;0;1;1
20396;"Vilniaus „Pelėdos” pradinė mokykla";Bitutės;9343761295;Ne;5;0;0;5
20397;"Vilniaus „Pelėdos” pradinė mokykla";Bitutės;7006338378;Ne;0;2;0;2
20398;"Vilniaus „Pelėdos” pradinė mokykla";Bitutės;3030820917;Ne;10;0;5;15
20399;"Vilniaus „Pelėdos” pradinė mokykla";Bitutės;3768735503;Ne;0;0;2;2
20400;"Vilniaus „Pelėdos” pradinė mokykla";Bitutės;6597383913;Ne;3;0;3;6
20401;"Vilniaus „Pelėdos” pradinė mokykla";Boružėlės;3284613284;Ne;17;0;0;17
20402;"Vilniaus „Pelėdos” pradinė mokykla";Boružėlės;1032549174;Ne;0;0;5;5
20403;"Vilniaus „Pelėdos” pradinė mokykla";Boružėlės;1314392095;Ne;5;0;0;5
20404;"Vilniaus „Pelėdos” pradinė mokykla";Boružėlės;1830060403;Ne;1;0;0;1
20405;"Vilniaus „Pelėdos” pradinė mokykla";Boružėlės;3970413055;Ne;1;0;0;1
20406;"Vilniaus „Pelėdos” pradinė mokykla";Boružėlės;1616324236;Ne;0;0;22;22
20407;"Vilniaus „Pelėdos” pradinė mokykla";Boružėlės;8370864547;Ne;0;5;0;5
20408;"Vilniaus „Pelėdos” pradinė mokykla";Boružėlės;5140876051;Ne;0;6;0;6
20409;"Vilniaus Joachimo Lelevelio inžinerijos mokykla";0A;57362664278;Ne;0;4;1;5
20410;"Vilniaus Joachimo Lelevelio inžinerijos mokykla";0A;1694423628;Ne;0;7;0;7
20411;"Vilniaus Joachimo Lelevelio inžinerijos mokykla";0A;19420482998;Ne;0;6;0;6
20412;"Vilniaus Joachimo Lelevelio inžinerijos mokykla";0A;1546251543;Ne;0;31;0;31
20413;"Vilniaus Joachimo Lelevelio inžinerijos mokykla";0A;9130637883;Ne;0;3;0;3
20414;"Vilniaus Joachimo Lelevelio inžinerijos mokykla";0A;6217540064;Ne;0;5;0;5
20415;"Vilniaus Joachimo Lelevelio inžinerijos mokykla";0A;7776071299;Ne;0;4;0;4
20416;"Vilniaus Joachimo Lelevelio inžinerijos mokykla";0A;9215070593;Ne;5;4;0;9
20417;"Vilniaus Joachimo Lelevelio inžinerijos mokykla";0A;3039980710;Ne;0;11;0;11
20418;"Vilniaus Joachimo Lelevelio inžinerijos mokykla";0A;1826015013;Ne;0;5;0;5
20419;"Vilniaus Joachimo Lelevelio inžinerijos mokykla";0A;5630659056;Ne;0;5;1;6
20420;"Vilniaus Joachimo Lelevelio inžinerijos mokykla";0A;9171690612;Ne;6;6;3;15
20421;"Vilniaus Joachimo Lelevelio inžinerijos mokykla";0A;3271832822;Ne;0;6;0;6
20422;"Vilniaus Joachimo Lelevelio inžinerijos mokykla";0A;2797443202;Ne;2;4;0;6
20423;"Vilniaus Joachimo Lelevelio inžinerijos mokykla";0B;6404064049;Ne;0;10;4;14
20424;"Vilniaus Joachimo Lelevelio inžinerijos mokykla";0B;2324578741;Ne;3;0;0;3
20425;"Vilniaus Joachimo Lelevelio inžinerijos mokykla";0B;64247830728;Ne;0;22;0;22
20426;"Vilniaus Joachimo Lelevelio inžinerijos mokykla";0B;2601103834;Ne;5;7;7;19
20427;"Vilniaus Joachimo Lelevelio inžinerijos mokykla";0B;65960895249;Ne;0;1;0;1
20428;"Vilniaus Joachimo Lelevelio inžinerijos mokykla";0B;5722934228;Ne;0;2;1;3
20429;"Vilniaus Joachimo Lelevelio inžinerijos mokykla";0B;4209118353;Ne;3;0;2;5
20430;"Vilniaus Joachimo Lelevelio inžinerijos mokykla";0B;9595277597;Ne;0;5;0;5
20431;"Vilniaus Joachimo Lelevelio inžinerijos mokykla";0B;2842587194;Ne;2;1;0;3
20432;"Vilniaus Joachimo Lelevelio inžinerijos mokykla";0B;8042807487;Ne;0;6;0;6
20433;"Vilniaus Joachimo Lelevelio inžinerijos mokykla";0B;6501930436;Ne;19;0;0;19
20434;"Vilniaus Joachimo Lelevelio inžinerijos mokykla";0B;71081903240;Ne;0;3;0;3
20435;"Vilniaus Juzefo Ignacijaus Kraševskio gimnazija";Priešmokyklinė;2201538495;Ne;0;9;0;9
20436;"Vilniaus Juzefo Ignacijaus Kraševskio gimnazija";Priešmokyklinė;9114472645;Ne;0;4;1;5
20437;"Vilniaus Juzefo Ignacijaus Kraševskio gimnazija";Priešmokyklinė;5255617339;Ne;7;0;1;8
20438;"Vilniaus Juzefo Ignacijaus Kraševskio gimnazija";Priešmokyklinė;1600495468;Ne;0;12;0;12
20439;"Vilniaus Juzefo Ignacijaus Kraševskio gimnazija";Priešmokyklinė;3733665122;Ne;0;8;0;8
20440;"Vilniaus Juzefo Ignacijaus Kraševskio gimnazija";Priešmokyklinė;2168987649;Ne;0;0;1;1
20441;"Vilniaus Juzefo Ignacijaus Kraševskio gimnazija";Priešmokyklinė;4499924331;Ne;2;1;0;3
20442;"Vilniaus Juzefo Ignacijaus Kraševskio gimnazija";Priešmokyklinė;9948555227;Ne;0;1;5;6
20443;"Vilniaus Juzefo Ignacijaus Kraševskio gimnazija";Priešmokyklinė;7993975989;Ne;0;7;0;7
20444;"Vilniaus Juzefo Ignacijaus Kraševskio gimnazija";Priešmokyklinė;2684151591;Ne;0;8;0;8
20445;"Vilniaus Juzefo Ignacijaus Kraševskio gimnazija";Priešmokyklinė;4864834075;Ne;0;4;0;4
20446;"Vilniaus Juzefo Ignacijaus Kraševskio gimnazija";Priešmokyklinė;1837140329;Ne;4;0;0;4
20447;"Vilniaus Juzefo Ignacijaus Kraševskio gimnazija";Priešmokyklinė;1460429651;Ne;0;2;0;2
20448;"Vilniaus Juzefo Ignacijaus Kraševskio gimnazija";Priešmokyklinė;9501262918;Ne;0;0;4;4
20449;"Vilniaus Juzefo Ignacijaus Kraševskio gimnazija";Priešmokyklinė;9333766622;Ne;5;11;0;16
20450;"Vilniaus Juzefo Ignacijaus Kraševskio gimnazija";Priešmokyklinė;3507672150;Ne;0;12;1;13
20451;"Vilniaus Juzefo Ignacijaus Kraševskio gimnazija";Priešmokyklinė;7305350540;Ne;0;7;0;7
20452;"Vilniaus Juzefo Ignacijaus Kraševskio gimnazija";Priešmokyklinė;3698808100;Ne;0;9;0;9
20453;"Vilniaus Juzefo Ignacijaus Kraševskio gimnazija";Priešmokyklinė;9754373141;Ne;0;0;17;17
20454;"Vilniaus Jono Pauliaus II progimnazija";Nykštukai;2055530718;Ne;7;0;0;7
20455;"Vilniaus Jono Pauliaus II progimnazija";Nykštukai;8703046661;Ne;4;6;0;10
20456;"Vilniaus Jono Pauliaus II progimnazija";Nykštukai;6724813553;Ne;0;1;0;1
20457;"Vilniaus Jono Pauliaus II progimnazija";Nykštukai;51629266891;Ne;1;0;0;1
20458;"Vilniaus Jono Pauliaus II progimnazija";Nykštukai;7268811782;Ne;0;3;0;3
20459;"Vilniaus Jono Pauliaus II progimnazija";Nykštukai;8998452731;Ne;0;1;0;1
20460;"Vilniaus Jono Pauliaus II progimnazija";Nykštukai;4071338645;Ne;0;3;0;3
20461;"Vilniaus Jono Pauliaus II progimnazija";Nykštukai;3637409607;Ne;0;3;0;3
20462;"Vilniaus Jono Pauliaus II progimnazija";Nykštukai;6988819614;Ne;0;1;0;1
20463;"Vilniaus Jono Pauliaus II progimnazija";Nykštukai;9672929606;Ne;0;0;4;4
20464;"Vilniaus Jono Pauliaus II progimnazija";Nykštukai;9457189905;Ne;0;0;4;4
20465;"Vilniaus Jono Pauliaus II progimnazija";Nykštukai;2013905907;Ne;0;4;0;4
20466;"Vilniaus Jono Pauliaus II progimnazija";Nykštukai;2095972347;Ne;0;1;0;1
20467;"Vilniaus Jono Pauliaus II progimnazija";Nykštukai;1624125024;Ne;13;0;0;13
20468;"Vilniaus Jono Pauliaus II progimnazija";Nykštukai;8796557675;Ne;1;0;0;1
20469;"Vilniaus Jono Pauliaus II progimnazija";Žiniukai;36350993825;Ne;9;2;0;11
20470;"Vilniaus Jono Pauliaus II progimnazija";Žiniukai;8607110629;Ne;0;0;2;2
20471;"Vilniaus Jono Pauliaus II progimnazija";Žiniukai;6779413882;Ne;8;1;1;10
20472;"Vilniaus Jono Pauliaus II progimnazija";Žiniukai;1897451825;Ne;4;5;0;9
20473;"Vilniaus Jono Pauliaus II progimnazija";Žiniukai;49110267692;Ne;0;0;2;2
20474;"Vilniaus Jono Pauliaus II progimnazija";Žiniukai;7947148051;Ne;0;1;0;1
20475;"Vilniaus Jono Pauliaus II progimnazija";Žiniukai;35673258175;Ne;0;0;2;2
20476;"Vilniaus Jono Pauliaus II progimnazija";Žiniukai;4472742569;Ne;12;0;0;12
20477;"Vilniaus Jono Pauliaus II progimnazija";Žiniukai;69245659818;Ne;0;4;0;4
20478;"Vilniaus Jono Pauliaus II progimnazija";Žiniukai;7838787153;Ne;10;0;0;10
20479;"Vilniaus Jono Pauliaus II progimnazija";Žiniukai;1429139157;Ne;6;1;0;7
20480;"Vilniaus Jono Pauliaus II progimnazija";Žiniukai;3042409414;Ne;0;0;1;1
20481;"Vilniaus Jono Pauliaus II progimnazija";Žiniukai;8245310502;Ne;10;0;0;10
20482;"Vilniaus Jono Pauliaus II progimnazija";Žiniukai;5593546668;Ne;4;0;0;4
20483;"Vilniaus Jono Pauliaus II progimnazija";Žiniukai;1460444785;Taip;0;5;0;5
20484;"Vilniaus Jono Pauliaus II progimnazija";Žiniukai;9262869284;Ne;3;2;2;7
20485;"Vilniaus Jono Pauliaus II progimnazija";Žiniukai;38456484551;Ne;0;4;0;4
20486;"Vilniaus Jono Pauliaus II progimnazija";Žiniukai;6646474196;Ne;11;0;0;11
20487;"Vilniaus Jono Pauliaus II progimnazija";Spindulėlis;1950514819;Ne;0;22;0;22
20488;"Vilniaus Jono Pauliaus II progimnazija";Spindulėlis;4034847901;Ne;0;2;0;2
20489;"Vilniaus Jono Pauliaus II progimnazija";Spindulėlis;1009453682;Ne;5;3;0;8
20490;"Vilniaus Jono Pauliaus II progimnazija";Spindulėlis;7136135394;Ne;0;1;0;1
20491;"Vilniaus Jono Pauliaus II progimnazija";Spindulėlis;1133359254;Ne;0;1;0;1
20492;"Vilniaus Jono Pauliaus II progimnazija";Spindulėlis;8336138549;Ne;0;10;0;10
20493;"Vilniaus Jono Pauliaus II progimnazija";Spindulėlis;5451923881;Ne;7;0;0;7
20494;"Vilniaus Jono Pauliaus II progimnazija";Spindulėlis;2445444641;Ne;3;0;0;3
20495;"Vilniaus Jono Pauliaus II progimnazija";Spindulėlis;9908198854;Ne;0;1;0;1
20496;"Vilniaus Verkių mokykla-daugiafunkcis centras";"&quot;MAŽIEJI VERKIUKAI&quot;";7942036741;Ne;0;1;0;1
20497;"Vilniaus Verkių mokykla-daugiafunkcis centras";"&quot;MAŽIEJI VERKIUKAI&quot;";5586925136;Ne;0;2;0;2
20498;"Vilniaus Verkių mokykla-daugiafunkcis centras";"1S, 3S, 3L, 4SK, 4LK klasė";5346078886;Ne;0;1;0;1
20499;"Vilniaus Verkių mokykla-daugiafunkcis centras";"1S, 3S, 3L, 4SK, 4LK klasė";1732370199;Ne;0;2;0;2
20500;"Vilniaus Verkių mokykla-daugiafunkcis centras";"1S, 3S, 3L, 4SK, 4LK klasė";4773060159;Ne;0;22;0;22
20501;"Vilniaus Verkių mokykla-daugiafunkcis centras";"1S, 3S, 3L, 4SK, 4LK klasė";2428312586;Ne;0;7;0;7
20502;"Vilniaus Verkių mokykla-daugiafunkcis centras";"1S, 3S, 3L, 4SK, 4LK klasė";4436123342;Ne;0;2;0;2
20503;"Vilniaus Verkių mokykla-daugiafunkcis centras";"1S, 3S, 3L, 4SK, 4LK klasė";3669076308;Ne;0;1;0;1
20504;"Vilniaus Verkių mokykla-daugiafunkcis centras";"1S, 3S, 3L, 4SK, 4LK klasė";67103811533;Ne;0;3;0;3
20505;"Vilniaus Verkių mokykla-daugiafunkcis centras";"1S, 3S, 3L, 4SK, 4LK klasė";9634174513;Ne;0;22;0;22
20506;"Vilniaus Verkių mokykla-daugiafunkcis centras";"1S, 3S, 3L, 4SK, 4LK klasė";1350580842;Ne;0;22;0;22
20507;"Vilniaus Verkių mokykla-daugiafunkcis centras";"1S, 2S, 2L, 3S, 4S, 4SK, 5L klasė ";6951842417;Ne;0;4;0;4
20508;"Vilniaus Verkių mokykla-daugiafunkcis centras";"1S, 2S, 2L, 3S, 4S, 4SK, 5L klasė ";1515290326;Ne;0;2;0;2
20509;"Vilniaus Verkių mokykla-daugiafunkcis centras";"1S, 2S, 2L, 3S, 4S, 4SK, 5L klasė ";4011623622;Ne;0;22;0;22
20510;"Vilniaus Verkių mokykla-daugiafunkcis centras";"1S, 2S, 2L, 3S, 4S, 4SK, 5L klasė ";8342540661;Ne;0;1;0;1
20511;"Vilniaus Verkių mokykla-daugiafunkcis centras";"1S, 2S, 2L, 3S, 4S, 4SK, 5L klasė ";24268622677;Ne;0;2;0;2
20512;"Vilniaus Verkių mokykla-daugiafunkcis centras";"1S, 2S, 2L, 3S, 4S, 4SK, 5L klasė ";24268622677;Ne;0;2;0;2
20513;"Vilniaus Verkių mokykla-daugiafunkcis centras";"1S, 2S, 2L, 3S, 4S, 4SK, 5L klasė ";24268622677;Ne;0;2;0;2
20514;"Vilniaus Verkių mokykla-daugiafunkcis centras";"1S, 2S, 2L, 3S, 4S, 4SK, 5L klasė ";24268622677;Ne;0;2;0;2
20515;"Vilniaus Verkių mokykla-daugiafunkcis centras";"1S, 2S, 2L, 3S, 4S, 4SK, 5L klasė ";37848550744;Ne;0;22;0;22
20516;"Vilniaus Verkių mokykla-daugiafunkcis centras";"1S, 2S, 2L, 3S, 4S, 4SK, 5L klasė ";7977250483;Ne;0;1;0;1
20517;"Vilniaus Verkių mokykla-daugiafunkcis centras";"1S, 2S, 2L, 3S, 4S, 4SK, 5L klasė ";2396841187;Ne;24;2;0;26
20518;"Vilniaus Verkių mokykla-daugiafunkcis centras";"1L, 4S, 4L, 6S, 6L, 6LK klasė";6813357731;Ne;0;7;0;7
20519;"Vilniaus Verkių mokykla-daugiafunkcis centras";"1L, 4S, 4L, 6S, 6L, 6LK klasė";7591511377;Ne;0;8;0;8
20520;"Vilniaus Verkių mokykla-daugiafunkcis centras";"1L, 4S, 4L, 6S, 6L, 6LK klasė";9355917461;Ne;0;3;0;3
20521;"Vilniaus Verkių mokykla-daugiafunkcis centras";"1L, 4S, 4L, 6S, 6L, 6LK klasė";4187084284;Ne;0;9;0;9
20522;"Vilniaus Verkių mokykla-daugiafunkcis centras";"1L, 4S, 4L, 6S, 6L, 6LK klasė";6868531249;Ne;0;6;0;6
20523;"Vilniaus Verkių mokykla-daugiafunkcis centras";"1L, 4S, 4L, 6S, 6L, 6LK klasė";6868531249;Ne;0;6;0;6
20524;"Vilniaus Verkių mokykla-daugiafunkcis centras";"1L, 4S, 4L, 6S, 6L, 6LK klasė";6868531249;Ne;0;6;0;6
20525;"Vilniaus Verkių mokykla-daugiafunkcis centras";"1L, 4S, 4L, 6S, 6L, 6LK klasė";6868531249;Ne;0;6;0;6
20526;"Vilniaus Verkių mokykla-daugiafunkcis centras";"1L, 4S, 4L, 6S, 6L, 6LK klasė";6868531249;Ne;0;6;0;6
20527;"Vilniaus Verkių mokykla-daugiafunkcis centras";"1L, 4S, 4L, 6S, 6L, 6LK klasė";6868531249;Ne;0;6;0;6
20528;"Vilniaus Verkių mokykla-daugiafunkcis centras";"1L, 4S, 4L, 6S, 6L, 6LK klasė";1989565075;Ne;0;22;0;22
20529;"Vilniaus Verkių mokykla-daugiafunkcis centras";"1L, 4S, 4L, 6S, 6L, 6LK klasė";9259642351;Ne;0;22;0;22
20530;"Vilniaus Verkių mokykla-daugiafunkcis centras";"5L, 6L, 6LK, 7L, 7LK klasė ";64637387481;Ne;0;2;0;2
20531;"Vilniaus Verkių mokykla-daugiafunkcis centras";"5L, 6L, 6LK, 7L, 7LK klasė ";64637387481;Ne;0;2;0;2
20532;"Vilniaus Verkių mokykla-daugiafunkcis centras";"5L, 6L, 6LK, 7L, 7LK klasė ";1503792026;Ne;0;16;0;16
20533;"Vilniaus Verkių mokykla-daugiafunkcis centras";"5L, 6L, 6LK, 7L, 7LK klasė ";4066377955;Ne;0;9;0;9
20534;"Vilniaus Verkių mokykla-daugiafunkcis centras";"5L, 6L, 6LK, 7L, 7LK klasė ";55421735777;Ne;0;2;0;2
20535;"Vilniaus Verkių mokykla-daugiafunkcis centras";"5L, 6L, 6LK, 7L, 7LK klasė ";44372408680;Ne;0;4;0;4
20536;"Vilniaus Verkių mokykla-daugiafunkcis centras";"6LK, 7S, 7SK klasė";8779088808;Ne;0;6;0;6
20537;"Vilniaus Verkių mokykla-daugiafunkcis centras";"6LK, 7S, 7SK klasė";3444507772;Ne;0;15;0;15
20538;"Vilniaus Verkių mokykla-daugiafunkcis centras";"6LK, 7S, 7SK klasė";1514869108;Ne;0;5;0;5
20539;"Vilniaus Verkių mokykla-daugiafunkcis centras";"6LK, 7S, 7SK klasė";3145397791;Ne;0;8;0;8
20540;"Vilniaus Verkių mokykla-daugiafunkcis centras";"6LK, 7S, 7SK klasė";3870610295;Ne;0;22;0;22
20541;"Vilniaus Verkių mokykla-daugiafunkcis centras";"6LK, 7S, 7SK klasė";2415067230;Ne;0;1;0;1
20542;"Vilniaus Verkių mokykla-daugiafunkcis centras";"5S, 5SK, 5L, 6S klasė";7438765543;Ne;0;6;0;6
20543;"Vilniaus Verkių mokykla-daugiafunkcis centras";"5S, 5SK, 5L, 6S klasė";9598385220;Ne;0;3;0;3
20544;"Vilniaus Verkių mokykla-daugiafunkcis centras";"5S, 5SK, 5L, 6S klasė";93185505974;Ne;0;10;0;10
20545;"Vilniaus Verkių mokykla-daugiafunkcis centras";"5S, 5SK, 5L, 6S klasė";13432910676;Ne;0;2;0;2
20546;"Vilniaus Verkių mokykla-daugiafunkcis centras";"5S, 5SK, 5L, 6S klasė";11657021053;Ne;0;1;0;1
20547;"Vilniaus Verkių mokykla-daugiafunkcis centras";"6L, 7L, 7LK klasė";37572425955;Ne;0;8;0;8
20548;"Vilniaus Verkių mokykla-daugiafunkcis centras";"6L, 7L, 7LK klasė";2261393560;Ne;0;14;0;14
20549;"Vilniaus Verkių mokykla-daugiafunkcis centras";"6L, 7L, 7LK klasė";5937487837;Ne;0;3;0;3
20550;"Vilniaus Verkių mokykla-daugiafunkcis centras";"8LK, 9L, 10L, 10LK klasė";1480378589;Ne;0;22;0;22
20551;"Vilniaus Verkių mokykla-daugiafunkcis centras";"8LK, 9L, 10L, 10LK klasė";3519068093;Ne;0;2;0;2
20552;"Vilniaus Verkių mokykla-daugiafunkcis centras";"8LK, 9L, 10L, 10LK klasė";2054806833;Ne;0;5;0;5
20553;"Vilniaus Verkių mokykla-daugiafunkcis centras";"8LK, 9L, 10L, 10LK klasė";7616694308;Ne;0;20;0;20
20554;"Vilniaus Verkių mokykla-daugiafunkcis centras";"8LK, 9L, 10L, 10LK klasė";1853931111;Ne;0;18;0;18
20555;"Vilniaus Verkių mokykla-daugiafunkcis centras";"8LK, 9L, 10L, 10LK klasė";7886245604;Ne;0;5;0;5
20556;"Vilniaus Verkių mokykla-daugiafunkcis centras";"8LK, 9L, 10L, 10LK klasė";6808441017;Ne;0;7;0;7
20557;"Vilniaus Verkių mokykla-daugiafunkcis centras";"8LK, 9L, 10L, 10LK klasė";9613466086;Ne;0;15;0;15
20558;"Vilniaus Verkių mokykla-daugiafunkcis centras";"8LK, 9L, 10L, 10LK klasė";9613466086;Ne;0;15;0;15
20559;"Vilniaus Verkių mokykla-daugiafunkcis centras";"10S, 10L klasė";6352988790;Ne;0;18;0;18
20560;"Vilniaus Verkių mokykla-daugiafunkcis centras";"10S, 10L klasė";3218545382;Ne;0;22;0;22
20561;"Vilniaus Verkių mokykla-daugiafunkcis centras";"10S, 10L klasė";3529185406;Ne;0;22;0;22
20562;"Vilniaus Verkių mokykla-daugiafunkcis centras";"10S, 10L klasė";3529185406;Ne;0;22;0;22
20563;"Vilniaus Verkių mokykla-daugiafunkcis centras";"10S, 10L klasė";3529185406;Ne;0;22;0;22
20564;"Vilniaus Verkių mokykla-daugiafunkcis centras";"10S, 10L klasė";2708620759;Ne;0;11;0;11
20565;"Vilniaus Verkių mokykla-daugiafunkcis centras";"6S, 8S, 9S, 9L, 10L klasė";1334357441;Ne;0;13;0;13
20566;"Vilniaus Verkių mokykla-daugiafunkcis centras";"6S, 8S, 9S, 9L, 10L klasė";3215674630;Ne;0;9;0;9
20567;"Vilniaus Verkių mokykla-daugiafunkcis centras";"6S, 8S, 9S, 9L, 10L klasė";5030855634;Ne;0;10;0;10
20568;"Vilniaus Verkių mokykla-daugiafunkcis centras";"6S, 8S, 9S, 9L, 10L klasė";7278736731;Ne;0;9;0;9
20569;"Vilniaus Verkių mokykla-daugiafunkcis centras";"6S, 8S, 9S, 9L, 10L klasė";2810286239;Ne;0;15;0;15
20570;"Vilniaus Verkių mokykla-daugiafunkcis centras";"10S, 10L, SĮUP I m.m. klasė ";3155197214;Ne;0;22;0;22
20571;"Vilniaus Verkių mokykla-daugiafunkcis centras";"10S, 10L, SĮUP I m.m. klasė ";1062601239;Ne;0;4;0;4
20572;"Vilniaus Verkių mokykla-daugiafunkcis centras";"10S, 10L, SĮUP I m.m. klasė ";6937513931;Ne;0;22;0;22
20573;"Vilniaus Verkių mokykla-daugiafunkcis centras";"10S, 10L, SĮUP I m.m. klasė ";2076640938;Ne;0;13;0;13
20574;"Vilniaus Verkių mokykla-daugiafunkcis centras";"10S, 10L, SĮUP I m.m. klasė ";2305478898;Ne;0;5;0;5
20575;"Vilniaus Verkių mokykla-daugiafunkcis centras";"10S, 10L, SĮUP I m.m. klasė ";2518928115;Ne;0;3;0;3
20576;"Vilniaus Verkių mokykla-daugiafunkcis centras";"10S, 10L, SĮUP I m.m. klasė ";1454746961;Ne;0;2;0;2
20577;"Vilniaus Verkių mokykla-daugiafunkcis centras";"SĮUP I m.m., SĮUP III m.m. klasė ";6301505187;Ne;0;2;0;2
20578;"Vilniaus Verkių mokykla-daugiafunkcis centras";"SĮUP I m.m., SĮUP III m.m. klasė ";8732243137;Ne;0;4;0;4
20579;"Vilniaus Verkių mokykla-daugiafunkcis centras";"SĮUP I m.m., SĮUP III m.m. klasė ";9975744237;Ne;0;3;0;3
20580;"Vilniaus Verkių mokykla-daugiafunkcis centras";"SĮUP I m.m., SĮUP III m.m. klasė ";1548000907;Ne;0;3;0;3
20581;"Vilniaus Verkių mokykla-daugiafunkcis centras";"SĮUP I m.m., SĮUP III m.m. klasė ";1283606579;Ne;0;4;0;4
20582;"Vilniaus Verkių mokykla-daugiafunkcis centras";"SĮUP I m.m., SĮUP III m.m. klasė ";9500247903;Ne;0;6;0;6
20583;"Vilniaus Verkių mokykla-daugiafunkcis centras";"SĮUP I m.m., SĮUP III m.m. klasė ";6966632177;Ne;0;2;0;2
20584;"Vilniaus Verkių mokykla-daugiafunkcis centras";"SĮUP I m.m., SĮUP III m.m. klasė ";9513501805;Ne;0;3;0;3
20585;"Vilniaus Verkių mokykla-daugiafunkcis centras";"SĮUP I m.m., SĮUP II m.m. klasė";4054448861;Ne;0;7;0;7
20586;"Vilniaus Verkių mokykla-daugiafunkcis centras";"SĮUP I m.m., SĮUP II m.m. klasė";4518835802;Ne;0;5;0;5
20587;"Vilniaus Verkių mokykla-daugiafunkcis centras";"SĮUP I m.m., SĮUP II m.m. klasė";9666721487;Ne;0;8;0;8
20588;"Vilniaus Verkių mokykla-daugiafunkcis centras";"SĮUP I m.m., SĮUP II m.m. klasė";7381890668;Ne;0;6;0;6
20589;"Vilniaus Verkių mokykla-daugiafunkcis centras";"SĮUP I m.m., SĮUP II m.m. klasė";8495267789;Ne;0;7;0;7
20590;"Vilniaus Verkių mokykla-daugiafunkcis centras";"SĮUP I m.m., SĮUP II m.m. klasė";2714397701;Ne;0;2;0;2
20591;"Vilniaus Verkių mokykla-daugiafunkcis centras";"SĮUP I m.m., SĮUP II m.m., SĮUP III m.m. klasė ";2608900779;Ne;0;2;0;2
20592;"Vilniaus Verkių mokykla-daugiafunkcis centras";"SĮUP I m.m., SĮUP II m.m., SĮUP III m.m. klasė ";4901307502;Ne;0;9;0;9
20593;"Vilniaus Verkių mokykla-daugiafunkcis centras";"8S, 8SK, 9S, 9SK klasė";7819002176;Ne;0;1;0;1
20594;"Vilniaus Verkių mokykla-daugiafunkcis centras";"8S, 8SK, 9S, 9SK klasė";6396691531;Ne;0;22;0;22
20595;"Vilniaus Verkių mokykla-daugiafunkcis centras";"8S, 8SK, 9S, 9SK klasė";9420292538;Ne;1;2;0;3
20596;"Vilniaus Verkių mokykla-daugiafunkcis centras";"8S, 8SK, 9S, 9SK klasė";1937996951;Ne;0;2;0;2
20597;"Vilniaus Verkių mokykla-daugiafunkcis centras";"8S, 8SK, 9S, 9SK klasė";7689301739;Ne;0;3;0;3
20598;"Vilniaus Verkių mokykla-daugiafunkcis centras";"8S, 8SK, 9S, 9SK klasė";8199430682;Ne;0;2;0;2
20599;Gluosnis;KIŠKUČIAI;8689557248;Ne;0;1;0;1
20600;Gluosnis;KIŠKUČIAI;2984134115;Ne;0;0;1;1
20601;Gluosnis;KIŠKUČIAI;6955695422;Ne;0;0;3;3
20602;Gluosnis;KIŠKUČIAI;1305651237;Ne;12;0;0;12
20603;Gluosnis;KIŠKUČIAI;4285562600;Ne;0;2;0;2
20604;Gluosnis;KIŠKUČIAI;5432102004;Ne;11;0;5;16
20605;Gluosnis;KIŠKUČIAI;8009719622;Ne;0;1;0;1
20606;Gluosnis;KIŠKUČIAI;6883663577;Ne;0;4;0;4
20607;Gluosnis;KIŠKUČIAI;1512855055;Ne;0;0;8;8
20608;Gluosnis;KIŠKUČIAI;8337313448;Ne;8;0;0;8
20609;Gluosnis;KIŠKUČIAI;4632419177;Ne;10;0;1;11
20610;Gluosnis;KIŠKUČIAI;6113153127;Ne;8;0;2;10
20611;Gluosnis;KIŠKUČIAI;7769522093;Ne;9;0;0;9
20612;Gluosnis;KIŠKUČIAI;8928597187;Ne;0;2;0;2
20613;Gluosnis;KIŠKUČIAI;9993638596;Ne;0;0;5;5
20614;Gluosnis;KIŠKUČIAI;6994005000;Ne;0;1;1;2
20615;Gluosnis;KIŠKUČIAI;9221983318;Ne;0;4;7;11
20616;Gluosnis;KIŠKUČIAI;2187312618;Ne;5;0;0;5
20617;Gluosnis;KIŠKUČIAI;5664156894;Ne;0;0;2;2
20618;Gluosnis;KIŠKUČIAI;7073637619;Ne;6;0;7;13
20619;Gluosnis;KIŠKUČIAI;1391404073;Ne;0;0;1;1
20620;Gluosnis;KIŠKUČIAI;4591550636;Ne;0;13;4;17
20621;Gluosnis;EŽIUKAI;4153713911;Ne;0;1;8;9
20622;Gluosnis;EŽIUKAI;4493877427;Ne;8;0;0;8
20623;Gluosnis;EŽIUKAI;1301904113;Ne;4;0;1;5
20624;Gluosnis;EŽIUKAI;5350702449;Ne;28;0;0;28
20625;Gluosnis;EŽIUKAI;6622415563;Ne;0;2;0;2
20626;Gluosnis;EŽIUKAI;3988305400;Ne;0;1;0;1
20627;Gluosnis;EŽIUKAI;9788278155;Ne;5;3;0;8
20628;Gluosnis;EŽIUKAI;7974944779;Ne;6;0;1;7
20629;Gluosnis;EŽIUKAI;7526020668;Ne;15;0;0;15
20630;Gluosnis;EŽIUKAI;5522411084;Ne;0;0;1;1
20631;Gluosnis;EŽIUKAI;5392759654;Ne;5;3;0;8
20632;Gluosnis;EŽIUKAI;6681653921;Ne;0;5;0;5
20633;Gluosnis;EŽIUKAI;4902627153;Taip;10;0;2;12
20634;Gluosnis;EŽIUKAI;2525780494;Ne;5;4;2;11
20635;Gluosnis;EŽIUKAI;9389736360;Ne;6;2;2;10
20636;Gluosnis;EŽIUKAI;2707855273;Ne;0;14;1;15
20637;Gluosnis;EŽIUKAI;7523459118;Ne;0;0;5;5
20638;Gluosnis;EŽIUKAI;2794163383;Ne;2;0;2;4
20639;Gluosnis;EŽIUKAI;7264550578;Ne;5;0;9;14
20640;Gluosnis;EŽIUKAI;5368171142;Ne;0;9;0;9
20641;Gluosnis;EŽIUKAI;6754799196;Ne;12;0;0;12
20642;Gluosnis;EŽIUKAI;9888037899;Ne;0;0;2;2
20643;Gluosnis;MEŠKIUKAI;8981904827;Ne;2;0;0;2
20644;Gluosnis;MEŠKIUKAI;8998776286;Ne;4;3;0;7
20645;Gluosnis;MEŠKIUKAI;1846499141;Ne;6;0;4;10
20646;Gluosnis;MEŠKIUKAI;7935750427;Ne;0;0;3;3
20647;Gluosnis;MEŠKIUKAI;1235091885;Ne;5;10;1;16
20648;Gluosnis;MEŠKIUKAI;1165636758;Ne;0;5;2;7
20649;Gluosnis;MEŠKIUKAI;8499748544;Ne;0;13;0;13
20650;Gluosnis;MEŠKIUKAI;9699577397;Ne;3;0;19;22
20651;Gluosnis;MEŠKIUKAI;4107344313;Ne;0;0;6;6
20652;Gluosnis;MEŠKIUKAI;1101472999;Ne;0;2;4;6
20653;Gluosnis;MEŠKIUKAI;1602556462;Ne;0;0;3;3
20654;Gluosnis;MEŠKIUKAI;4060859156;Ne;6;0;0;6
20655;Gluosnis;MEŠKIUKAI;6428753580;Ne;8;0;0;8
20656;Gluosnis;MEŠKIUKAI;3323237449;Ne;2;2;0;4
20657;Gluosnis;MEŠKIUKAI;6246512101;Ne;0;12;0;12
20658;Gluosnis;MEŠKIUKAI;3038732180;Ne;20;0;0;20
20659;Gluosnis;MEŠKIUKAI;1712795835;Ne;0;4;0;4
20660;Gluosnis;BORUŽĖLĖS;8840658383;Ne;12;7;0;19
20661;Gluosnis;BORUŽĖLĖS;1102935178;Ne;8;5;2;15
20662;Gluosnis;BORUŽĖLĖS;2167312808;Ne;11;5;0;16
20663;Gluosnis;BORUŽĖLĖS;4204797742;Ne;0;24;0;24
20664;Gluosnis;BORUŽĖLĖS;6302765948;Ne;10;1;1;12
20665;Gluosnis;BORUŽĖLĖS;9938235476;Ne;0;12;0;12
20666;Gluosnis;BORUŽĖLĖS;2945796648;Ne;2;7;0;9
20667;Gluosnis;BORUŽĖLĖS;2173191971;Ne;0;12;1;13
20668;Gluosnis;BORUŽĖLĖS;4237053702;Ne;12;10;0;22
20669;Gluosnis;BORUŽĖLĖS;6320411660;Ne;8;3;0;11
20670;Gluosnis;BORUŽĖLĖS;7731887361;Ne;11;0;0;11
20671;Gluosnis;BORUŽĖLĖS;8502947568;Ne;8;0;2;10
20672;Gluosnis;BORUŽĖLĖS;9664090375;Ne;10;8;0;18
20673;Gluosnis;BORUŽĖLĖS;1335152703;Ne;5;11;1;17
20674;Gluosnis;BORUŽĖLĖS;1314992969;Ne;7;10;6;23
20675;Gluosnis;BORUŽĖLĖS;7833136455;Ne;4;5;0;9
20676;Gluosnis;BORUŽĖLĖS;5556821953;Ne;0;6;0;6
20677;Gluosnis;BORUŽĖLĖS;2515646510;Ne;7;5;3;15
20678;Gluosnis;BORUŽĖLĖS;3212658311;Ne;0;4;4;8
20679;Gluosnis;BORUŽĖLĖS;2603201633;Ne;7;13;1;21
20680;Gluosnis;BORUŽĖLĖS;6086258054;Ne;7;6;0;13
20681;Gluosnis;BORUŽĖLĖS;1351519995;Ne;7;8;3;18
20682;Gluosnis;BORUŽĖLĖS;6960673767;Taip;6;5;0;11
20683;Gluosnis;LAPIUKAI;7025815772;Ne;5;0;0;5
20684;Gluosnis;LAPIUKAI;5266206726;Ne;9;1;1;11
20685;Gluosnis;LAPIUKAI;2968946946;Ne;0;3;0;3
20686;Gluosnis;LAPIUKAI;8976032500;Ne;0;0;1;1
20687;Gluosnis;LAPIUKAI;3190331209;Ne;8;0;3;11
20688;Gluosnis;LAPIUKAI;5376108804;Ne;9;0;1;10
20689;Gluosnis;LAPIUKAI;9386396460;Ne;5;1;0;6
20690;Gluosnis;LAPIUKAI;1664508998;Ne;11;0;2;13
20691;Gluosnis;LAPIUKAI;1296975213;Ne;8;0;2;10
20692;Gluosnis;LAPIUKAI;8227732558;Ne;5;0;0;5
20693;Gluosnis;LAPIUKAI;6518579198;Ne;12;0;0;12
20694;Gluosnis;LAPIUKAI;5633386146;Ne;2;0;4;6
20695;Gluosnis;LAPIUKAI;4146877525;Ne;0;11;1;12
20696;Gluosnis;LAPIUKAI;4616132460;Ne;4;0;0;4
20697;Gluosnis;LAPIUKAI;4280829038;Ne;7;0;0;7
20698;Gluosnis;LAPIUKAI;2889837198;Ne;0;0;2;2
20699;Gluosnis;PELĖDŽIUKAI;1933496033;Ne;0;1;0;1
20700;Gluosnis;PELĖDŽIUKAI;8259035822;Ne;9;7;0;16
20701;Gluosnis;PELĖDŽIUKAI;4960167173;Ne;5;1;0;6
20702;Gluosnis;PELĖDŽIUKAI;1671693932;Ne;0;0;1;1
20703;Gluosnis;PELĖDŽIUKAI;4005023841;Ne;2;0;6;8
20704;Gluosnis;PELĖDŽIUKAI;9497547057;Ne;0;1;0;1
20705;Gluosnis;PELĖDŽIUKAI;6865973084;Ne;0;7;0;7
20706;Gluosnis;PELĖDŽIUKAI;1298724775;Ne;0;2;0;2
20707;Gluosnis;PELĖDŽIUKAI;1185903576;Ne;0;0;7;7
20708;Gluosnis;PELĖDŽIUKAI;7537587118;Taip;0;0;6;6
20709;Gluosnis;PELĖDŽIUKAI;7075070566;Ne;0;1;0;1
20710;Gluosnis;PELĖDŽIUKAI;7761376910;Ne;0;0;7;7
20711;Gluosnis;PELĖDŽIUKAI;6944918504;Ne;0;5;1;6
20712;Gluosnis;PELĖDŽIUKAI;94487630173;Ne;11;0;0;11
20713;Gluosnis;PELĖDŽIUKAI;1076538028;Ne;3;2;0;5
20714;Gluosnis;VOVERIUKAI;3900322680;Ne;0;0;2;2
20715;Gluosnis;VOVERIUKAI;2423433989;Ne;8;0;0;8
20716;Gluosnis;VOVERIUKAI;1263019496;Ne;5;0;0;5
20717;Gluosnis;VOVERIUKAI;4564193030;Ne;5;2;3;10
20718;Gluosnis;VOVERIUKAI;4224637208;Ne;12;0;1;13
20719;Gluosnis;VOVERIUKAI;1144177849;Ne;0;3;2;5
20720;Gluosnis;VOVERIUKAI;6729016081;Ne;0;1;3;4
20721;Gluosnis;VOVERIUKAI;6119618742;Ne;7;0;1;8
20722;Gluosnis;VOVERIUKAI;2794080237;Ne;5;0;0;5
20723;Gluosnis;VOVERIUKAI;5623135790;Ne;0;2;3;5
20724;Gluosnis;VOVERIUKAI;2310874591;Ne;5;1;0;6
20725;Gluosnis;VOVERIUKAI;5210930032;Ne;1;0;3;4
20726;Gluosnis;VOVERIUKAI;5008836118;Ne;0;0;6;6
20727;Gluosnis;VOVERIUKAI;4361177196;Ne;11;0;2;13
20728;Gluosnis;VOVERIUKAI;9484423786;Ne;2;0;2;4
20729;Gluosnis;VOVERIUKAI;8109714321;Ne;9;0;0;9
20730;Gluosnis;DRUGELIAI;5949954525;Ne;7;10;0;17
20731;Gluosnis;DRUGELIAI;1716235604;Taip;0;12;0;12
20732;Gluosnis;DRUGELIAI;7642311375;Ne;10;0;0;10
20733;Gluosnis;DRUGELIAI;8430102757;Ne;15;1;0;16
20734;Gluosnis;DRUGELIAI;4125830926;Ne;8;16;0;24
20735;Gluosnis;DRUGELIAI;6358187113;Ne;2;10;5;17
20736;Gluosnis;DRUGELIAI;9084785666;Ne;3;5;0;8
20737;Gluosnis;DRUGELIAI;4940563623;Ne;6;4;3;13
20738;Gluosnis;DRUGELIAI;1113731535;Ne;0;9;0;9
20739;Gluosnis;DRUGELIAI;4653963373;Ne;7;12;0;19
20740;Gluosnis;DRUGELIAI;2458662117;Ne;9;5;0;14
20741;Gluosnis;DRUGELIAI;8314366921;Ne;2;10;0;12
20742;Gluosnis;DRUGELIAI;4220504133;Ne;0;1;1;2
20743;Gluosnis;DRUGELIAI;9931766935;Ne;2;13;1;16
20744;Gluosnis;DRUGELIAI;3527418865;Ne;7;8;0;15
20745;Gluosnis;DRUGELIAI;6914171069;Ne;12;6;0;18
20746;Gluosnis;DRUGELIAI;1848647593;Ne;2;23;0;25
20747;Gluosnis;DRUGELIAI;7756397778;Ne;8;0;0;8
20748;Gluosnis;DRUGELIAI;5943955268;Ne;0;5;19;24
20749;Gluosnis;DRUGELIAI;8690911930;Ne;6;7;1;14
20750;Gluosnis;DRUGELIAI;1543842220;Ne;0;15;2;17
20751;Gluosnis;DRUGELIAI;1787206205;Ne;0;19;0;19
20752;Gluosnis;DRUGELIAI;5264930854;Ne;0;10;0;10
20753;Gluosnis;BITUTĖS;4176300773;Ne;5;5;0;10
20754;Gluosnis;BITUTĖS;2554790908;Ne;4;6;1;11
20755;Gluosnis;BITUTĖS;8281499182;Ne;3;7;2;12
20756;Gluosnis;BITUTĖS;2403029153;Ne;7;5;0;12
20757;Gluosnis;BITUTĖS;6432475763;Ne;2;3;0;5
20758;Gluosnis;BITUTĖS;1966484574;Ne;0;11;0;11
20759;Gluosnis;BITUTĖS;5889360726;Ne;2;6;2;10
20760;Gluosnis;BITUTĖS;8035097045;Ne;0;7;2;9
20761;Gluosnis;BITUTĖS;3362089746;Ne;0;6;5;11
20762;Gluosnis;BITUTĖS;7390361159;Ne;6;1;2;9
20763;Gluosnis;BITUTĖS;8380310240;Ne;9;10;0;19
20764;Gluosnis;BITUTĖS;4481544177;Ne;8;6;1;15
20765;Gluosnis;BITUTĖS;3673702157;Ne;0;12;2;14
20766;Gluosnis;BITUTĖS;9098141563;Ne;2;1;0;3
20767;Gluosnis;BITUTĖS;9201769624;Ne;0;10;6;16
20768;Gluosnis;BITUTĖS;1306381382;Ne;3;0;2;5
20769;Gluosnis;BITUTĖS;6767500085;Ne;10;5;0;15
20770;Gluosnis;BITUTĖS;6001358241;Ne;2;1;0;3
20771;Gluosnis;BITUTĖS;5380755693;Ne;16;0;5;21
20772;Gluosnis;BITUTĖS;6197840105;Ne;13;5;1;19
20773;Gluosnis;BITUTĖS;5204445760;Ne;2;10;5;17
20774;"Vilniaus Saulėtekio mokykla-daugiafunkcinis centras";Priešmokyklinė;8760467524;Ne;15;0;0;15
20775;"Vilniaus Saulėtekio mokykla-daugiafunkcinis centras";Priešmokyklinė;6738279023;Ne;0;12;0;12
20776;"Vilniaus Saulėtekio mokykla-daugiafunkcinis centras";Priešmokyklinė;1739797553;Ne;0;3;0;3
20777;"Vilniaus Saulėtekio mokykla-daugiafunkcinis centras";Priešmokyklinė;2159833613;Ne;7;4;0;11
20778;"Vilniaus Saulėtekio mokykla-daugiafunkcinis centras";Priešmokyklinė;1193336600;Ne;0;8;0;8
20779;"Vilniaus Saulėtekio mokykla-daugiafunkcinis centras";Priešmokyklinė;5914721966;Ne;0;0;1;1
20780;"Vilniaus Saulėtekio mokykla-daugiafunkcinis centras";Priešmokyklinė;8852228006;Ne;0;0;22;22
20781;"Vilniaus Saulėtekio mokykla-daugiafunkcinis centras";Priešmokyklinė;4159716896;Ne;0;0;3;3
20782;"Vilniaus Saulėtekio mokykla-daugiafunkcinis centras";Priešmokyklinė;1667714484;Ne;0;0;15;15
20783;"Vilniaus Saulėtekio mokykla-daugiafunkcinis centras";Priešmokyklinė;3048310276;Ne;0;0;2;2
20784;"Vilniaus Saulėtekio mokykla-daugiafunkcinis centras";Priešmokyklinė;6991187086;Ne;4;0;1;5
20785;"Vilniaus Saulėtekio mokykla-daugiafunkcinis centras";Priešmokyklinė;1698381959;Ne;0;3;0;3
20786;"Vilniaus Saulėtekio mokykla-daugiafunkcinis centras";Priešmokyklinė;2074102166;Ne;0;0;3;3
20787;"Vilniaus Saulėtekio mokykla-daugiafunkcinis centras";Priešmokyklinė;2906786855;Ne;5;0;0;5
20788;"Vilniaus Saulėtekio mokykla-daugiafunkcinis centras";Priešmokyklinė;3108520221;Ne;0;15;0;15
20789;"Vilniaus Saulėtekio mokykla-daugiafunkcinis centras";Priešmokyklinė;8815534200;Ne;10;0;3;13
20790;"Vilniaus Saulėtekio mokykla-daugiafunkcinis centras";Priešmokyklinė;4751570183;Ne;10;0;0;10
20791;"Vilniaus Saulėtekio mokykla-daugiafunkcinis centras";Priešmokyklinė;9164075226;Ne;0;3;0;3
20792;"Vilniaus Saulėtekio mokykla-daugiafunkcinis centras";Priešmokyklinė;4787974814;Ne;4;0;5;9
20793;"Vilniaus Saulėtekio mokykla-daugiafunkcinis centras";Priešmokyklinė;6553762186;Ne;0;8;0;8
20794;"Vilniaus Saulėtekio mokykla-daugiafunkcinis centras";Priešmokyklinė;9057726203;Ne;17;1;0;18
20795;"Vilniaus Saulėtekio mokykla-daugiafunkcinis centras";Priešmokyklinė;4937714337;Ne;0;0;2;2
20796;"Vilniaus Saulėtekio mokykla-daugiafunkcinis centras";Priešmokyklinė;3745251439;Ne;0;0;2;2
20797;"Vilniaus Saulėtekio mokykla-daugiafunkcinis centras";"PRIEŠMOKYKLINĖ 2";9963290362;Ne;2;0;3;5
20798;"Vilniaus Saulėtekio mokykla-daugiafunkcinis centras";"PRIEŠMOKYKLINĖ 2";1342094235;Ne;0;0;1;1
20799;"Vilniaus Saulėtekio mokykla-daugiafunkcinis centras";"PRIEŠMOKYKLINĖ 2";2628936055;Ne;4;1;0;5
20800;"Vilniaus Saulėtekio mokykla-daugiafunkcinis centras";"PRIEŠMOKYKLINĖ 2";1224648193;Ne;0;0;3;3
20801;"Vilniaus Saulėtekio mokykla-daugiafunkcinis centras";"PRIEŠMOKYKLINĖ 2";4010917080;Ne;0;0;1;1
20802;"Vilniaus Saulėtekio mokykla-daugiafunkcinis centras";"PRIEŠMOKYKLINĖ 2";5927071864;Ne;0;0;1;1
20803;"Vilniaus Saulėtekio mokykla-daugiafunkcinis centras";"PRIEŠMOKYKLINĖ 2";4970499391;Ne;20;0;0;20
20804;"Vilniaus Saulėtekio mokykla-daugiafunkcinis centras";"PRIEŠMOKYKLINĖ 2";6593824471;Ne;11;0;1;12
20805;"Vilniaus Saulėtekio mokykla-daugiafunkcinis centras";"PRIEŠMOKYKLINĖ 2";8669346247;Ne;0;0;5;5
20806;"Vilniaus Saulėtekio mokykla-daugiafunkcinis centras";"PRIEŠMOKYKLINĖ 2";1924079984;Ne;0;0;1;1
20807;"Vilniaus Saulėtekio mokykla-daugiafunkcinis centras";"PRIEŠMOKYKLINĖ 2";5590376570;Ne;5;0;5;10
20808;"Vilniaus Saulėtekio mokykla-daugiafunkcinis centras";"PRIEŠMOKYKLINĖ 2";8766410254;Ne;4;0;0;4
20809;"Vilniaus Saulėtekio mokykla-daugiafunkcinis centras";"PRIEŠMOKYKLINĖ 2";1376656872;Ne;0;0;9;9
20810;"Vilniaus Saulėtekio mokykla-daugiafunkcinis centras";"PRIEŠMOKYKLINĖ 2";3639632543;Ne;0;2;0;2
20811;"Vilniaus Saulėtekio mokykla-daugiafunkcinis centras";"PRIEŠMOKYKLINĖ 2";6865962441;Ne;0;2;0;2
20812;"Vilniaus Saulėtekio mokykla-daugiafunkcinis centras";"PRIEŠMOKYKLINĖ 2";3982877012;Ne;14;0;5;19
20813;"Vilniaus Saulėtekio mokykla-daugiafunkcinis centras";"PRIEŠMOKYKLINĖ 2";1660650556;Ne;8;2;0;10
20814;"Vilniaus Saulėtekio mokykla-daugiafunkcinis centras";"PRIEŠMOKYKLINĖ 2";4890393582;Ne;0;0;3;3
20815;"Vilniaus Saulėtekio mokykla-daugiafunkcinis centras";"PRIEŠMOKYKLINĖ 2";5304096806;Ne;0;0;3;3
20816;"Vilniaus Saulėtekio mokykla-daugiafunkcinis centras";"PRIEŠMOKYKLINĖ 2";1648983304;Ne;17;0;0;17
20817;"Vilniaus Saulėtekio mokykla-daugiafunkcinis centras";"PRIEŠMOKYKLINĖ 2";1543123485;Ne;0;0;3;3
20818;"Vilniaus Saulėtekio mokykla-daugiafunkcinis centras";"PRIEŠMOKYKLINĖ 2";4176208765;Ne;5;6;3;14
20819;"Vilniaus Saulėtekio mokykla-daugiafunkcinis centras";"PRIEŠMOKYKLINĖ 2";8458361084;Ne;11;0;5;16
20820;Žolynas;Dobiliukai;7012568720;Ne;3;0;0;3
20821;Žolynas;Varpeliai;1820257436;Ne;4;0;0;4
20822;Žolynas;Žemuogėlės;9146502567;Ne;6;0;0;6
20823;Žolynas;Žemuogėlės;6140694933;Ne;4;0;0;4
20824;Žolynas;Žemuogėlės;2816866449;Ne;4;0;0;4
20825;Žolynas;Ramunėlės;8891438678;Ne;7;0;0;7
20826;Žolynas;Ramunėlės;6225625746;Ne;5;0;0;5
20827;Žolynas;Šlamučiai;9730317666;Ne;2;0;0;2
20828;Žolynas;Šlamučiai;8153606853;Taip;1;0;0;1
20829;Žolynas;Rugiagėlės;4628728628;Ne;4;0;0;4
20830;Žolynas;Rugiagėlės;2283289955;Ne;11;0;0;11
20831;Žolynas;Rugiagėlės;3249208907;Ne;10;0;0;10
20832;Žolynas;Čiobreliai;6722603438;Ne;4;0;0;4
20833;"Vilniaus „Genio“ progimnazija";NYKŠTUKAI;1666616466;Ne;0;7;0;7
20834;"Vilniaus „Genio“ progimnazija";NYKŠTUKAI;3008272979;Ne;3;1;0;4
20835;"Vilniaus „Genio“ progimnazija";NYKŠTUKAI;1807466584;Ne;5;1;0;6
20836;"Vilniaus „Genio“ progimnazija";NYKŠTUKAI;4680264973;Ne;0;2;0;2
20837;"Vilniaus „Genio“ progimnazija";NYKŠTUKAI;2176438968;Ne;0;1;0;1
20838;"Vilniaus „Genio“ progimnazija";NYKŠTUKAI;2593226897;Ne;4;0;0;4
20839;"Vilniaus „Genio“ progimnazija";NYKŠTUKAI;1089753966;Ne;0;2;0;2
20840;"Gintarėlis (Popieriaus g. 46A)";SKRUZDĖLIUKAI;6162836315;Ne;0;1;0;1
20841;"Gintarėlis (Popieriaus g. 46A)";SKRUZDĖLIUKAI;3825572125;Ne;2;2;3;7
20842;"Gintarėlis (Popieriaus g. 46A)";SKRUZDĖLIUKAI;5738933125;Ne;0;10;0;10
20843;"Gintarėlis (Popieriaus g. 46A)";SKRUZDĖLIUKAI;8223747534;Ne;10;1;1;12
20844;"Gintarėlis (Popieriaus g. 46A)";SKRUZDĖLIUKAI;1045355492;Ne;19;0;0;19
20845;"Gintarėlis (Popieriaus g. 46A)";SKRUZDĖLIUKAI;6193540660;Ne;3;2;2;7
20846;"Gintarėlis (Popieriaus g. 46A)";SKRUZDĖLIUKAI;7916257692;Ne;0;2;1;3
20847;"Gintarėlis (Popieriaus g. 46A)";SKRUZDĖLIUKAI;7510541192;Ne;0;2;0;2
20848;"Gintarėlis (Popieriaus g. 46A)";SKRUZDĖLIUKAI;9045108717;Ne;22;0;0;22
20849;"Gintarėlis (Popieriaus g. 46A)";SKRUZDĖLIUKAI;1955719034;Ne;0;2;8;10
20850;"Gintarėlis (Popieriaus g. 46A)";SKRUZDĖLIUKAI;1215549844;Ne;6;1;0;7
20851;"Gintarėlis (Popieriaus g. 46A)";SKRUZDĖLIUKAI;5379858630;Ne;0;0;15;15
20852;"Gintarėlis (Popieriaus g. 46A)";SKRUZDĖLIUKAI;5961603860;Ne;0;9;0;9
20853;"Gintarėlis (Popieriaus g. 46A)";SKRUZDĖLIUKAI;8068499156;Ne;0;1;0;1
20854;"Gintarėlis (Popieriaus g. 46A)";SKRUZDĖLIUKAI;5190355636;Ne;7;0;0;7
20855;"Gintarėlis (Popieriaus g. 46A)";SKRUZDĖLIUKAI;4290033336;Ne;0;1;0;1
20856;"Gintarėlis (Popieriaus g. 46A)";PELĖDŽIUKAI;6506180216;Ne;0;8;0;8
20857;"Gintarėlis (Popieriaus g. 46A)";PELĖDŽIUKAI;3254739432;Ne;0;0;2;2
20858;"Gintarėlis (Popieriaus g. 46A)";PELĖDŽIUKAI;1628276472;Ne;0;6;0;6
20859;"Gintarėlis (Popieriaus g. 46A)";PELĖDŽIUKAI;8792175474;Ne;15;0;0;15
20860;"Gintarėlis (Popieriaus g. 46A)";PELĖDŽIUKAI;3304191482;Ne;0;2;0;2
20861;"Gintarėlis (Popieriaus g. 46A)";PELĖDŽIUKAI;2731865977;Ne;0;1;0;1
20862;"Gintarėlis (Popieriaus g. 46A)";PELĖDŽIUKAI;4181430769;Ne;0;5;0;5
20863;"Gintarėlis (Popieriaus g. 46A)";PELĖDŽIUKAI;3202819190;Ne;0;0;3;3
20864;"Gintarėlis (Popieriaus g. 46A)";PELĖDŽIUKAI;9807784148;Ne;0;2;7;9
20865;"Gintarėlis (Popieriaus g. 46A)";PELĖDŽIUKAI;2546360134;Ne;0;1;0;1
20866;"Gintarėlis (Popieriaus g. 46A)";PELĖDŽIUKAI;2308673417;Ne;0;7;0;7
20867;"Gintarėlis (Popieriaus g. 46A)";PELĖDŽIUKAI;6883573289;Ne;0;2;6;8
20868;"Gintarėlis (Popieriaus g. 46A)";PELĖDŽIUKAI;3127881266;Ne;0;12;0;12
20869;"Gintarėlis (Popieriaus g. 46A)";PELĖDŽIUKAI;2052962147;Ne;10;0;2;12
20870;"Gintarėlis (Popieriaus g. 46A)";PELĖDŽIUKAI;8677500463;Taip;10;0;1;11
20871;"Gintarėlis (Popieriaus g. 46A)";PELĖDŽIUKAI;7031945895;Ne;0;7;0;7
20872;"Gintarėlis (Popieriaus g. 46A)";"LINKSMASIS AVILYS";7872515649;Ne;11;4;0;15
20873;"Gintarėlis (Popieriaus g. 46A)";"LINKSMASIS AVILYS";7256557310;Ne;0;4;0;4
20874;"Gintarėlis (Popieriaus g. 46A)";"LINKSMASIS AVILYS";6425840559;Ne;0;0;2;2
20875;"Gintarėlis (Popieriaus g. 46A)";"LINKSMASIS AVILYS";3572188688;Ne;5;1;3;9
20876;"Gintarėlis (Popieriaus g. 46A)";"LINKSMASIS AVILYS";7010430969;Ne;0;10;0;10
20877;"Gintarėlis (Popieriaus g. 46A)";"LINKSMASIS AVILYS";1070119148;Ne;0;7;0;7
20878;"Gintarėlis (Popieriaus g. 46A)";"LINKSMASIS AVILYS";3738678648;Ne;0;14;0;14
20879;"Gintarėlis (Popieriaus g. 46A)";"LINKSMASIS AVILYS";77906464117;Ne;0;0;1;1
20880;"Gintarėlis (Popieriaus g. 46A)";"LINKSMASIS AVILYS";8680339493;Ne;9;0;0;9
20881;"Gintarėlis (Popieriaus g. 46A)";"LINKSMASIS AVILYS";5223116373;Ne;14;0;0;14
20882;"Gintarėlis (Popieriaus g. 46A)";Varliukai;6821929306;Ne;0;13;0;13
20883;"Gintarėlis (Popieriaus g. 46A)";Varliukai;7274616480;Ne;0;2;0;2
20884;"Gintarėlis (Popieriaus g. 46A)";Varliukai;1362980885;Ne;0;16;0;16
20885;"Gintarėlis (Popieriaus g. 46A)";Varliukai;9762364250;Ne;0;6;0;6
20886;"Gintarėlis (Popieriaus g. 46A)";Varliukai;6849227110;Ne;6;0;0;6
20887;"Gintarėlis (Popieriaus g. 46A)";Varliukai;4263315669;Ne;12;0;0;12
20888;"Gintarėlis (Popieriaus g. 46A)";Varliukai;7206593645;Ne;0;0;8;8
20889;"Gintarėlis (Popieriaus g. 46A)";Varliukai;7400455090;Ne;0;4;0;4
20890;"Gintarėlis (Popieriaus g. 46A)";Varliukai;3702588434;Ne;0;0;4;4
20891;"Gintarėlis (Popieriaus g. 46A)";Varliukai;7413074674;Ne;0;8;4;12
20892;"Gintarėlis (Popieriaus g. 46A)";Varliukai;6514247750;Ne;3;1;0;4
20893;"Gintarėlis (Popieriaus g. 46A)";Varliukai;1166720069;Ne;9;0;0;9
20894;"Gintarėlis (Popieriaus g. 46A)";Varliukai;4556644354;Ne;15;0;0;15
20895;"Gintarėlis (Popieriaus g. 46A)";Varliukai;7510641510;Ne;10;1;0;11
20896;"Gintarėlis (Popieriaus g. 46A)";Varliukai;6534072038;Ne;9;0;2;11
20897;"Gintarėlis (Popieriaus g. 46A)";Varliukai;5478441530;Ne;16;1;0;17
20898;"Gintarėlis (Popieriaus g. 46A)";Varliukai;5771196440;Ne;0;0;1;1
20899;"Gintarėlis (Popieriaus g. 46A)";Varliukai;7783860076;Ne;0;5;0;5
20900;"Pušynėlis (A. Mickevičiaus g. 21)";DAIGIUKAI;5317547220;Ne;0;5;1;6
20901;"Pušynėlis (A. Mickevičiaus g. 21)";DAIGIUKAI;9025539389;Ne;1;0;10;11
20902;"Pušynėlis (A. Mickevičiaus g. 21)";DAIGIUKAI;5512586591;Ne;32;0;0;32
20903;"Pušynėlis (A. Mickevičiaus g. 21)";DAIGIUKAI;6594473055;Ne;0;6;0;6
20904;"Pušynėlis (A. Mickevičiaus g. 21)";DAIGIUKAI;8211464695;Ne;4;5;0;9
20905;"Pušynėlis (A. Mickevičiaus g. 21)";DAIGIUKAI;6321178561;Ne;17;0;0;17
20906;"Pušynėlis (A. Mickevičiaus g. 21)";DAIGIUKAI;6606436348;Ne;0;2;0;2
20907;"Pušynėlis (A. Mickevičiaus g. 21)";DAIGIUKAI;1057676386;Ne;0;2;7;9
20908;"Pušynėlis (A. Mickevičiaus g. 21)";DAIGIUKAI;8457384507;Ne;0;0;6;6
20909;"Pušynėlis (A. Mickevičiaus g. 21)";DAIGIUKAI;8668906624;Ne;5;1;0;6
20910;"Pušynėlis (A. Mickevičiaus g. 21)";DAIGIUKAI;1085678424;Taip;18;0;0;18
20911;"Pušynėlis (A. Mickevičiaus g. 21)";DAIGIUKAI;9710499937;Ne;12;1;0;13
20912;"Pušynėlis (A. Mickevičiaus g. 21)";DAIGIUKAI;4685125111;Ne;6;0;0;6
20913;"Pušynėlis (A. Mickevičiaus g. 21)";DAIGIUKAI;9717473430;Ne;9;0;0;9
20914;"Pušynėlis (A. Mickevičiaus g. 21)";DAIGIUKAI;2763762463;Ne;5;1;0;6
20915;"Pušynėlis (A. Mickevičiaus g. 21)";DAIGIUKAI;8268273217;Taip;12;0;0;12
20916;"Pušynėlis (A. Mickevičiaus g. 21)";DAIGIUKAI;6573189496;Ne;7;1;0;8
20917;"Pušynėlis (A. Mickevičiaus g. 21)";DAIGIUKAI;9835049161;Ne;8;4;5;17
20918;"Pušynėlis (A. Mickevičiaus g. 21)";NYKŠTUKAI;1050710006;Ne;0;2;1;3
20919;"Pušynėlis (A. Mickevičiaus g. 21)";NYKŠTUKAI;1758632291;Ne;4;3;1;8
20920;"Pušynėlis (A. Mickevičiaus g. 21)";NYKŠTUKAI;8699085292;Ne;0;4;1;5
20921;"Pušynėlis (A. Mickevičiaus g. 21)";NYKŠTUKAI;8327830781;Ne;7;0;1;8
20922;"Pušynėlis (A. Mickevičiaus g. 21)";NYKŠTUKAI;8820865805;Ne;0;22;0;22
20923;"Pušynėlis (A. Mickevičiaus g. 21)";NYKŠTUKAI;9520423020;Ne;6;3;0;9
20924;"Pušynėlis (A. Mickevičiaus g. 21)";NYKŠTUKAI;1177938753;Ne;4;0;0;4
20925;"Pušynėlis (A. Mickevičiaus g. 21)";NYKŠTUKAI;9450347140;Ne;0;3;0;3
20926;"Pušynėlis (A. Mickevičiaus g. 21)";NYKŠTUKAI;2222790161;Ne;17;0;0;17
20927;"Pušynėlis (A. Mickevičiaus g. 21)";NYKŠTUKAI;7596876368;Ne;12;2;1;15
20928;"Pušynėlis (A. Mickevičiaus g. 21)";NYKŠTUKAI;2892213973;Ne;0;2;5;7
20929;"Pušynėlis (A. Mickevičiaus g. 21)";NYKŠTUKAI;7429853563;Ne;10;3;0;13
20930;"Pušynėlis (A. Mickevičiaus g. 21)";NYKŠTUKAI;8464672994;Ne;16;0;0;16
20931;"Pušynėlis (A. Mickevičiaus g. 21)";NYKŠTUKAI;1904434730;Ne;12;0;0;12
20932;"Pušynėlis (A. Mickevičiaus g. 21)";NYKŠTUKAI;3362971538;Ne;8;0;0;8
20933;"Pušynėlis (A. Mickevičiaus g. 21)";NYKŠTUKAI;9055713601;Ne;0;0;5;5
20934;"Pušynėlis (A. Mickevičiaus g. 21)";NYKŠTUKAI;5364537212;Ne;6;2;0;8
20935;"Pušynėlis (A. Mickevičiaus g. 21)";NYKŠTUKAI;7172604103;Ne;0;0;1;1
20936;"Pušynėlis (A. Mickevičiaus g. 21)";NYKŠTUKAI;8839614928;Ne;0;4;2;6
20937;"Pušynėlis (A. Mickevičiaus g. 21)";NYKŠTUKAI;8512699165;Ne;0;4;7;11
20938;"Pušynėlis (A. Mickevičiaus g. 21)";GILIUKAI;9401101407;Ne;0;11;0;11
20939;"Pušynėlis (A. Mickevičiaus g. 21)";GILIUKAI;4997004998;Ne;7;1;0;8
20940;"Pušynėlis (A. Mickevičiaus g. 21)";GILIUKAI;9517319856;Ne;2;2;1;5
20941;"Pušynėlis (A. Mickevičiaus g. 21)";GILIUKAI;2825756894;Ne;22;0;0;22
20942;"Pušynėlis (A. Mickevičiaus g. 21)";GILIUKAI;1134325833;Ne;4;0;0;4
20943;"Pušynėlis (A. Mickevičiaus g. 21)";GILIUKAI;3158789663;Ne;0;1;0;1
20944;"Pušynėlis (A. Mickevičiaus g. 21)";GILIUKAI;5668765825;Ne;18;0;0;18
20945;"Pušynėlis (A. Mickevičiaus g. 21)";GILIUKAI;3954867816;Ne;0;10;1;11
20946;"Pušynėlis (A. Mickevičiaus g. 21)";GILIUKAI;7685809238;Ne;4;2;0;6
20947;"Pušynėlis (A. Mickevičiaus g. 21)";GILIUKAI;7011836009;Ne;10;0;0;10
20948;"Pušynėlis (A. Mickevičiaus g. 21)";GILIUKAI;3301741162;Ne;4;5;0;9
20949;"Pušynėlis (A. Mickevičiaus g. 21)";GILIUKAI;6735037523;Ne;0;2;0;2
20950;"Pušynėlis (A. Mickevičiaus g. 21)";GILIUKAI;7881263225;Ne;0;6;0;6
20951;"Pušynėlis (A. Mickevičiaus g. 21)";GILIUKAI;1612049897;Ne;5;3;1;9
20952;"Pušynėlis (A. Mickevičiaus g. 21)";GILIUKAI;9920959446;Ne;0;6;0;6
20953;"Pušynėlis (A. Mickevičiaus g. 21)";GILIUKAI;4898147530;Ne;3;0;0;3
20954;"Pušynėlis (A. Mickevičiaus g. 21)";GILIUKAI;2228682366;Ne;0;10;0;10
20955;"Pušynėlis (A. Mickevičiaus g. 21)";GILIUKAI;4464615995;Ne;0;2;0;2
20956;"Naminukas (Klinikų g. 5)";VARPELIAI;2089455192;Ne;0;1;0;1
20957;"Naminukas (Klinikų g. 5)";VARPELIAI;3281707263;Ne;0;0;2;2
20958;"Naminukas (Klinikų g. 5)";VARPELIAI;3683089217;Ne;0;12;0;12
20959;"Naminukas (Klinikų g. 5)";VARPELIAI;1828220049;Ne;2;0;2;4
20960;"Naminukas (Klinikų g. 5)";VARPELIAI;7328682222;Ne;2;0;6;8
20961;"Naminukas (Klinikų g. 5)";VARPELIAI;7772300667;Ne;13;0;1;14
20962;"Naminukas (Klinikų g. 5)";VARPELIAI;1086919259;Ne;20;0;0;20
20963;"Naminukas (Klinikų g. 5)";VARPELIAI;3497829075;Ne;10;0;0;10
20964;"Naminukas (Klinikų g. 5)";VARPELIAI;3938225198;Ne;0;0;1;1
20965;"Naminukas (Klinikų g. 5)";VARPELIAI;5991261279;Ne;12;0;0;12
20966;"Naminukas (Klinikų g. 5)";VARPELIAI;2576516583;Ne;15;2;0;17
20967;"Naminukas (Klinikų g. 5)";VARPELIAI;8694425584;Ne;4;0;2;6
20968;"Naminukas (Klinikų g. 5)";VARPELIAI;8782832803;Ne;10;2;0;12
20969;"Naminukas (Klinikų g. 5)";VARPELIAI;5172385044;Ne;7;0;3;10
20970;"Naminukas (Klinikų g. 5)";VARPELIAI;5465843371;Ne;7;1;0;8
20971;"Naminukas (Klinikų g. 5)";VARPELIAI;6515021073;Ne;0;5;15;20
20972;"Naminukas (Klinikų g. 5)";VARPELIAI;9894306360;Ne;18;0;0;18
20973;"Naminukas (Klinikų g. 5)";SAULUTĖS;9212800864;Ne;0;6;0;6
20974;"Naminukas (Klinikų g. 5)";SAULUTĖS;9215327479;Ne;7;0;0;7
20975;"Naminukas (Klinikų g. 5)";SAULUTĖS;7947598191;Ne;0;0;6;6
20976;"Naminukas (Klinikų g. 5)";SAULUTĖS;1635395128;Ne;0;0;3;3
20977;"Naminukas (Klinikų g. 5)";SAULUTĖS;3911352454;Ne;11;0;2;13
20978;"Naminukas (Klinikų g. 5)";SAULUTĖS;7107337857;Ne;0;0;16;16
20979;"Naminukas (Klinikų g. 5)";SAULUTĖS;3079900548;Ne;0;0;22;22
20980;"Naminukas (Klinikų g. 5)";SAULUTĖS;7301768930;Ne;0;0;3;3
20981;"Naminukas (Klinikų g. 5)";SAULUTĖS;2516513740;Ne;5;1;0;6
20982;"Naminukas (Klinikų g. 5)";SAULUTĖS;2336627398;Ne;8;0;0;8
20983;"Naminukas (Klinikų g. 5)";SAULUTĖS;1879925655;Ne;8;0;0;8
20984;"Naminukas (Klinikų g. 5)";SAULUTĖS;2881576194;Ne;5;0;4;9
20985;"Naminukas (Klinikų g. 5)";SAULUTĖS;4836599508;Ne;0;0;4;4
20986;"Naminukas (Klinikų g. 5)";SAULUTĖS;1563213488;Ne;4;0;1;5
20987;"Naminukas (Klinikų g. 5)";SAULUTĖS;6471277755;Ne;0;0;12;12
20988;"Naminukas (Klinikų g. 5)";SAULUTĖS;1932169696;Ne;14;0;0;14
20989;"Naminukas (Klinikų g. 5)";DRUGELIAI;2339599448;Ne;0;3;0;3
20990;"Naminukas (Klinikų g. 5)";DRUGELIAI;4077985773;Ne;9;0;0;9
20991;"Naminukas (Klinikų g. 5)";DRUGELIAI;3276656641;Ne;0;0;6;6
20992;"Naminukas (Klinikų g. 5)";DRUGELIAI;4116151797;Ne;0;0;3;3
20993;"Naminukas (Klinikų g. 5)";DRUGELIAI;7033053271;Ne;4;9;1;14
20994;"Naminukas (Klinikų g. 5)";DRUGELIAI;1454039572;Ne;6;0;1;7
20995;"Naminukas (Klinikų g. 5)";DRUGELIAI;9740815635;Ne;0;5;0;5
20996;"Naminukas (Klinikų g. 5)";DRUGELIAI;7184471307;Ne;0;1;0;1
20997;"Naminukas (Klinikų g. 5)";DRUGELIAI;6949857110;Ne;0;1;1;2
20998;"Naminukas (Klinikų g. 5)";DRUGELIAI;8039086094;Ne;7;0;0;7
20999;"Naminukas (Klinikų g. 5)";DRUGELIAI;4171789569;Ne;0;8;0;8
21000;"Naminukas (Klinikų g. 5)";DRUGELIAI;9835701381;Ne;3;0;1;4
21001;"Naminukas (Klinikų g. 5)";DRUGELIAI;2004615252;Ne;7;0;2;9
21002;"Naminukas (Klinikų g. 5)";BITUTĖS;21152690883;Ne;0;5;1;6
21003;"Naminukas (Klinikų g. 5)";BITUTĖS;1679106754;Ne;3;5;0;8
21004;"Naminukas (Klinikų g. 5)";BITUTĖS;1528496272;Ne;6;0;0;6
21005;"Naminukas (Klinikų g. 5)";BITUTĖS;92417802345;Ne;9;1;0;10
21006;"Naminukas (Klinikų g. 5)";BITUTĖS;1180176295;Ne;2;0;0;2
21007;"Naminukas (Klinikų g. 5)";BITUTĖS;9903990297;Ne;0;0;3;3
21008;"Naminukas (Klinikų g. 5)";BITUTĖS;6592057292;Ne;18;0;0;18
21009;"Naminukas (Klinikų g. 5)";BITUTĖS;5578151523;Ne;0;0;2;2
21010;"Naminukas (Klinikų g. 5)";BITUTĖS;4353031174;Ne;4;0;1;5
21011;"Naminukas (Klinikų g. 5)";BITUTĖS;9244494109;Ne;3;0;2;5
21012;"Naminukas (Klinikų g. 5)";BITUTĖS;8923393066;Ne;1;0;2;3
21013;"Naminukas (Klinikų g. 5)";BITUTĖS;9178907705;Ne;8;0;0;8
21014;"Naminukas (Klinikų g. 5)";BITUTĖS;5288557629;Ne;0;1;0;1
21015;"Naminukas (Klinikų g. 5)";BITUTĖS;5233044803;Ne;1;0;0;1
21016;"Naminukas (Klinikų g. 5)";BITUTĖS;1346035733;Ne;0;6;0;6
21017;"Naminukas (Klinikų g. 5)";BITUTĖS;1730248631;Ne;0;0;6;6
21018;"Naminukas (Klinikų g. 5)";BITUTĖS;3791118736;Ne;0;0;1;1
21019;"Naminukas (Klinikų g. 5)";BITUTĖS;1394918021;Ne;5;0;0;5
21020;"Naminukas (Klinikų g. 5)";BITUTĖS;7099787230;Ne;17;0;1;18
21021;"Naminukas (Klinikų g. 5)";BITUTĖS;3088386659;Ne;10;1;0;11
21022;"Gervelė (Stadiono g. 5)";BORUŽĖLĖS;6427072260;Ne;2;0;1;3
21023;"Gervelė (Stadiono g. 5)";BORUŽĖLĖS;9777308731;Ne;3;3;0;6
21024;"Gervelė (Stadiono g. 5)";BORUŽĖLĖS;5285868851;Ne;12;0;0;12
21025;"Gervelė (Stadiono g. 5)";BORUŽĖLĖS;2712133300;Ne;3;0;2;5
21026;"Gervelė (Stadiono g. 5)";BORUŽĖLĖS;2622183564;Ne;8;10;2;20
21027;"Gervelė (Stadiono g. 5)";BORUŽĖLĖS;1006720360;Ne;6;0;0;6
21028;"Gervelė (Stadiono g. 5)";BORUŽĖLĖS;8190190100;Ne;0;5;0;5
21029;"Gervelė (Stadiono g. 5)";BORUŽĖLĖS;6338612770;Taip;0;0;6;6
21030;"Gervelė (Stadiono g. 5)";BORUŽĖLĖS;6004269553;Ne;0;0;22;22
21031;"Gervelė (Stadiono g. 5)";BORUŽĖLĖS;6573919007;Ne;0;2;0;2
21032;"Gervelė (Stadiono g. 5)";BORUŽĖLĖS;8797608822;Ne;9;0;4;13
21033;"Gervelė (Stadiono g. 5)";PAUKŠTELIAI;8423813651;Ne;2;0;1;3
21034;"Gervelė (Stadiono g. 5)";PAUKŠTELIAI;2031118410;Ne;0;9;0;9
21035;"Gervelė (Stadiono g. 5)";PAUKŠTELIAI;5966215998;Ne;10;0;2;12
21036;"Gervelė (Stadiono g. 5)";PAUKŠTELIAI;7463376031;Ne;3;10;0;13
21037;"Gervelė (Stadiono g. 5)";PAUKŠTELIAI;1751440418;Ne;5;0;0;5
21038;"Gervelė (Stadiono g. 5)";PAUKŠTELIAI;3567687304;Ne;3;0;0;3
21039;"Gervelė (Stadiono g. 5)";PAUKŠTELIAI;6372245141;Ne;5;0;3;8
21040;"Gervelė (Stadiono g. 5)";PAUKŠTELIAI;2892214705;Ne;0;9;0;9
21041;"Gervelė (Stadiono g. 5)";PAUKŠTELIAI;7952102572;Ne;0;0;5;5
21042;"Gervelė (Stadiono g. 5)";PAUKŠTELIAI;9154032804;Ne;0;8;0;8
21043;"Gervelė (Stadiono g. 5)";PAUKŠTELIAI;3676856569;Ne;7;3;0;10
21044;"Gervelė (Stadiono g. 5)";PAUKŠTELIAI;4588890423;Ne;0;11;0;11
21045;"Gervelė (Stadiono g. 5)";SPINDULĖLIAI;4508176017;Taip;0;8;0;8
21046;"Gervelė (Stadiono g. 5)";SPINDULĖLIAI;5705915729;Ne;4;0;0;4
21047;"Gervelė (Stadiono g. 5)";SPINDULĖLIAI;6241611652;Ne;0;0;2;2
21048;"Gervelė (Stadiono g. 5)";SPINDULĖLIAI;2207041148;Taip;0;4;0;4
21049;"Gervelė (Stadiono g. 5)";SPINDULĖLIAI;1204513844;Ne;0;11;2;13
21050;"Gervelė (Stadiono g. 5)";SPINDULĖLIAI;7419432731;Taip;9;0;0;9
21051;"Gervelė (Stadiono g. 5)";SPINDULĖLIAI;1611114179;Taip;2;1;3;6
21052;"Gervelė (Stadiono g. 5)";SPINDULĖLIAI;8710469480;Ne;0;10;0;10
21053;"Gervelė (Stadiono g. 5)";GĖLYTĖS;6172016747;Ne;0;2;0;2
21054;"Gervelė (Stadiono g. 5)";GĖLYTĖS;3873345138;Ne;0;12;0;12
21055;"Gervelė (Stadiono g. 5)";GĖLYTĖS;5518309115;Ne;2;10;0;12
21056;"Gervelė (Stadiono g. 5)";GĖLYTĖS;2744433344;Ne;7;0;0;7
21057;"Gervelė (Stadiono g. 5)";GĖLYTĖS;4930308435;Ne;2;0;0;2
21058;"Gervelė (Stadiono g. 5)";GĖLYTĖS;4505873061;Ne;0;2;0;2
21059;"Gervelė (Stadiono g. 5)";GĖLYTĖS;9291855374;Ne;0;6;0;6
21060;"Gervelė (Stadiono g. 5)";GĖLYTĖS;7855598075;Ne;8;8;0;16
21061;"Gervelė (Stadiono g. 5)";GĖLYTĖS;8777858708;Ne;0;10;0;10
21062;"Gervelė (Stadiono g. 5)";GĖLYTĖS;6488139414;Ne;3;0;0;3
21063;"Gervelė (Stadiono g. 5)";GĖLYTĖS;3216423543;Ne;5;0;0;5
21064;"Kūlverstukas (Mindaugo g. 7)";GNOMIKI;1720671485;Ne;0;8;0;8
21065;"Kūlverstukas (Mindaugo g. 7)";GNOMIKI;2501327054;Ne;0;4;0;4
21066;"Kūlverstukas (Mindaugo g. 7)";GNOMIKI;2709547427;Taip;0;6;0;6
21067;"Kūlverstukas (Mindaugo g. 7)";GNOMIKI;5532063862;Ne;0;0;1;1
21068;"Kūlverstukas (Mindaugo g. 7)";GNOMIKI;5747277587;Ne;0;0;5;5
21069;"Kūlverstukas (Mindaugo g. 7)";GNOMIKI;1848018684;Ne;0;1;0;1
21070;"Kūlverstukas (Mindaugo g. 7)";GNOMIKI;1166429762;Ne;9;1;0;10
21071;"Kūlverstukas (Mindaugo g. 7)";GNOMIKI;6514730230;Ne;22;0;0;22
21072;"Kūlverstukas (Mindaugo g. 7)";GNOMIKI;5298776235;Ne;0;4;0;4
21073;"Kūlverstukas (Mindaugo g. 7)";GNOMIKI;1916522637;Ne;9;0;1;10
21074;"Kūlverstukas (Mindaugo g. 7)";GNOMIKI;3239566139;Ne;0;13;0;13
21075;"Kūlverstukas (Mindaugo g. 7)";GNOMIKI;5260820316;Ne;8;1;0;9
21076;"Kūlverstukas (Mindaugo g. 7)";ZAIČIATA;8994705290;Ne;0;15;0;15
21077;"Kūlverstukas (Mindaugo g. 7)";ZAIČIATA;7933156766;Ne;9;0;0;9
21078;"Kūlverstukas (Mindaugo g. 7)";ZAIČIATA;2494202134;Ne;0;2;0;2
21079;"Kūlverstukas (Mindaugo g. 7)";ZAIČIATA;2714297182;Ne;0;2;0;2
21080;"Kūlverstukas (Mindaugo g. 7)";ZAIČIATA;4998847820;Ne;5;0;2;7
21081;"Kūlverstukas (Mindaugo g. 7)";ZAIČIATA;3660002342;Ne;0;0;3;3
21082;"Kūlverstukas (Mindaugo g. 7)";ZAIČIATA;5079635330;Ne;8;2;0;10
21083;"Kūlverstukas (Mindaugo g. 7)";ZAIČIATA;5879283662;Ne;10;0;0;10
21084;"Kūlverstukas (Mindaugo g. 7)";ZAIČIATA;3067918179;Ne;5;1;0;6
21085;"Kūlverstukas (Mindaugo g. 7)";SVETLIAČKI;6219872984;Ne;0;0;3;3
21086;"Kūlverstukas (Mindaugo g. 7)";SVETLIAČKI;9098427210;Ne;0;0;10;10
21087;"Kūlverstukas (Mindaugo g. 7)";SVETLIAČKI;70033583066;Ne;0;0;1;1
21088;"Kūlverstukas (Mindaugo g. 7)";SVETLIAČKI;2154916232;Ne;0;0;4;4
21089;"Kūlverstukas (Mindaugo g. 7)";SVETLIAČKI;5794471794;Ne;0;0;1;1
21090;"Kūlverstukas (Mindaugo g. 7)";SVETLIAČKI;8577197481;Ne;15;1;5;21
21091;"Kūlverstukas (Mindaugo g. 7)";SVETLIAČKI;3449300504;Ne;0;0;4;4
21092;"Kūlverstukas (Mindaugo g. 7)";SVETLIAČKI;1102996499;Ne;0;2;0;2
21093;"Kūlverstukas (Mindaugo g. 7)";SVETLIAČKI;1635418112;Ne;0;5;5;10
21094;"Kūlverstukas (Mindaugo g. 7)";ZVONOČKI;1486878343;Ne;0;0;3;3
21095;"Kūlverstukas (Mindaugo g. 7)";ZVONOČKI;8835111916;Ne;0;2;5;7
21096;"Kūlverstukas (Mindaugo g. 7)";ZVONOČKI;5724787637;Ne;0;2;0;2
21097;"Kūlverstukas (Mindaugo g. 7)";ZVONOČKI;7898746258;Ne;0;1;2;3
21098;"Kūlverstukas (Mindaugo g. 7)";ZVONOČKI;9835391223;Ne;7;2;0;9
21099;"Kūlverstukas (Mindaugo g. 7)";ZVONOČKI;2429527586;Ne;0;0;5;5
21100;"Kūlverstukas (Mindaugo g. 7)";ZVONOČKI;5217751936;Ne;0;17;0;17
21101;"Kūlverstukas (Mindaugo g. 7)";ZVONOČKI;1566191212;Ne;0;2;0;2
21102;"Kūlverstukas (Mindaugo g. 7)";ZVONOČKI;9569296370;Ne;0;4;7;11
21103;"Kūlverstukas (Mindaugo g. 7)";ZVONOČKI;1047459617;Ne;0;2;0;2
21104;"Kūlverstukas (Mindaugo g. 7)";ZVONOČKI;1125206576;Ne;0;7;0;7
21105;"Kūlverstukas (Mindaugo g. 7)";ZVONOČKI;5938022496;Ne;8;1;0;9
21106;"Kūlverstukas (Mindaugo g. 7)";ZVONOČKI;2091204077;Ne;5;1;0;6
21107;"Vilniaus Pavilnio pagrindinė mokykla";"PRIEŠMOKYKLINĖ PL";2738553283;Ne;14;2;6;22
21108;"Vilniaus Pavilnio pagrindinė mokykla";"PRIEŠMOKYKLINĖ PL";2101902207;Ne;5;0;3;8
21109;"Vilniaus Pavilnio pagrindinė mokykla";"PRIEŠMOKYKLINĖ PL";1957926887;Ne;12;0;0;12
21110;"Vilniaus Pavilnio pagrindinė mokykla";"PRIEŠMOKYKLINĖ PL";1046606022;Ne;0;0;2;2
21111;"Vilniaus Pavilnio pagrindinė mokykla";"PRIEŠMOKYKLINĖ RU";4339607826;Ne;2;0;0;2
21112;"Vilniaus Pavilnio pagrindinė mokykla";"PRIEŠMOKYKLINĖ RU";1568915914;Ne;0;0;1;1
21113;"Vilniaus Pavilnio pagrindinė mokykla";"PRIEŠMOKYKLINĖ RU";5619763557;Ne;0;22;0;22
21114;"Vilniaus Pavilnio pagrindinė mokykla";"PRIEŠMOKYKLINĖ RU";9759761725;Ne;0;22;0;22
21115;"Vilniaus Pavilnio pagrindinė mokykla";"PRIEŠMOKYKLINĖ RU";9142513631;Ne;6;1;2;9
21116;"Vilniaus Pavilnio pagrindinė mokykla";"PRIEŠMOKYKLINĖ RU";5972567526;Ne;0;8;2;10
21117;"Vilniaus Pavilnio pagrindinė mokykla";"PRIEŠMOKYKLINĖ RU";2846917348;Ne;15;0;0;15
21118;"Vilniaus Pavilnio pagrindinė mokykla";"PRIEŠMOKYKLINĖ RU";6067622823;Ne;0;0;3;3
21119;"Vilniaus Pavilnio pagrindinė mokykla";"PRIEŠMOKYKLINĖ RU";3243226933;Ne;8;0;7;15
21120;"Vilniaus Pavilnio pagrindinė mokykla";"PRIEŠMOKYKLINĖ RU";7544963724;Ne;9;0;0;9
21121;"Vilniaus Pavilnio pagrindinė mokykla";"PRIEŠMOKYKLINĖ RU";7255617408;Ne;0;0;8;8
21122;"Lazdynų mokykla (Liudvinavo g.128)";DRUGELIAI;7524849851;Ne;6;1;0;7
21123;"Lazdynų mokykla (Liudvinavo g.128)";DRUGELIAI;8650496265;Ne;0;0;5;5
21124;"Lazdynų mokykla (Liudvinavo g.128)";DRUGELIAI;9309081745;Ne;0;1;0;1
21125;"Lazdynų mokykla (Liudvinavo g.128)";DRUGELIAI;1951041742;Ne;2;0;0;2
21126;"Lazdynų mokykla (Liudvinavo g.128)";DRUGELIAI;9196184984;Ne;7;2;0;9
21127;"Lazdynų mokykla (Liudvinavo g.128)";DRUGELIAI;2767732459;Ne;0;10;0;10
21128;"Lazdynų mokykla (Liudvinavo g.128)";DRUGELIAI;6394098306;Ne;6;0;6;12
21129;"Lazdynų mokykla (Liudvinavo g.128)";DRUGELIAI;6627809171;Ne;0;22;0;22
21130;"Lazdynų mokykla (Liudvinavo g.128)";DRUGELIAI;7074859809;Ne;7;0;5;12
21131;"Lazdynų mokykla (Liudvinavo g.128)";DRUGELIAI;4097980299;Ne;0;1;0;1
21132;"Lazdynų mokykla (Liudvinavo g.128)";DRUGELIAI;5902104981;Ne;0;3;0;3
21133;"Lazdynų mokykla (Liudvinavo g.128)";DRUGELIAI;7590111138;Ne;7;0;0;7
21134;"Lazdynų mokykla (Liudvinavo g.128)";DRUGELIAI;2027751624;Ne;0;2;0;2
21135;"Lazdynų mokykla (Liudvinavo g.128)";ZUIKUČIAI;7232402011;Ne;0;6;0;6
21136;"Lazdynų mokykla (Liudvinavo g.128)";ZUIKUČIAI;4166599533;Ne;0;0;7;7
21137;"Lazdynų mokykla (Liudvinavo g.128)";ZUIKUČIAI;3435025978;Ne;0;0;5;5
21138;"Lazdynų mokykla (Liudvinavo g.128)";ZUIKUČIAI;3715070791;Ne;10;0;3;13
21139;"Lazdynų mokykla (Liudvinavo g.128)";ZUIKUČIAI;3265099747;Ne;0;0;7;7
21140;"Lazdynų mokykla (Liudvinavo g.128)";ZUIKUČIAI;1336503878;Ne;1;2;1;4
21141;"Lazdynų mokykla (Liudvinavo g.128)";ZUIKUČIAI;3302443490;Ne;0;1;0;1
21142;"Lazdynų mokykla (Liudvinavo g.128)";ZUIKUČIAI;7000921682;Ne;0;1;0;1
21143;"Lazdynų mokykla (Liudvinavo g.128)";ZUIKUČIAI;3535244441;Ne;3;0;3;6
21144;"Lazdynų mokykla (Liudvinavo g.128)";ZUIKUČIAI;5465094647;Ne;3;4;0;7
21145;"Lazdynų mokykla (Liudvinavo g.128)";ZUIKUČIAI;1044630813;Ne;0;1;0;1
21146;"Lazdynų mokykla (Liudvinavo g.128)";ZUIKUČIAI;7229926614;Ne;0;0;2;2
21147;"Lazdynų mokykla (Liudvinavo g.128)";ZUIKUČIAI;8899186547;Ne;12;0;2;14
21148;"Lazdynų mokykla (Liudvinavo g.128)";ZUIKUČIAI;5181200460;Ne;0;0;4;4
21149;"Vilniaus Šilo mokykla";Boružėlės;7122041826;Ne;22;0;0;22
21150;"Vilniaus Šilo mokykla";Boružėlės;5962551687;Ne;1;0;0;1
21151;"Vilniaus Šilo mokykla";Boružėlės;1196172221;Ne;16;0;0;16
21152;"Vilniaus Šilo mokykla";Boružėlės;1538635985;Ne;17;0;0;17
21153;"Vilniaus Šilo mokykla";Boružėlės;6136087920;Ne;0;22;0;22
21154;"Vilniaus Šilo mokykla";Boružėlės;4544126354;Ne;13;0;0;13
21155;"Vilniaus Šilo mokykla";"1 spec.";1153167430;Ne;6;0;0;6
21156;"Vilniaus Šilo mokykla";"1 spec.";8863021708;Ne;11;0;0;11
21157;"Vilniaus Šilo mokykla";"1 spec.";4438939800;Ne;3;0;0;3
21158;"Vilniaus Šilo mokykla";"1 spec.";2290889395;Ne;1;0;0;1
21159;"Vilniaus Šilo mokykla";"1 spec.";1180183091;Ne;0;22;0;22
21160;"Vilniaus Šilo mokykla";"3-4 kl. RUS";34463714051;Ne;1;0;0;1
21161;"Vilniaus Šilo mokykla";"3-4 kl. RUS";4078721064;Ne;1;0;0;1
21162;"Vilniaus Šilo mokykla";"3-4 kl. RUS";9789373884;Ne;0;22;0;22
21163;"Vilniaus Šilo mokykla";"3-4 kl. RUS";3419495275;Taip;0;22;0;22
21164;"Vilniaus Šilo mokykla";"6 lav.";83007167743;Ne;1;0;0;1
21165;"Vilniaus Šilo mokykla";"6 lav.";67989956617;Ne;0;22;0;22
21166;"Vilniaus Šilo mokykla";"6 lav.";49892720109;Ne;7;0;0;7
21167;"Vilniaus Šilo mokykla";"6 lav.";9054390753;Ne;5;0;0;5
21168;"Vilniaus Šilo mokykla";"6 lav.";2862598950;Ne;5;0;0;5
21169;"Vilniaus Šilo mokykla";"6 lav.";3120638166;Ne;1;0;0;1
21170;"Vilniaus Šilo mokykla";"7-10 spec.";9944901942;Ne;10;0;0;10
21171;"Vilniaus Šilo mokykla";"7-10 spec.";3442250711;Ne;8;0;0;8
21172;"Vilniaus Šilo mokykla";"7-10 spec.";2672192094;Ne;5;0;0;5
21173;"Vilniaus Šilo mokykla";"7-10 spec.";2672192094;Ne;5;0;0;5
21174;"Vilniaus Šilo mokykla";"7-10 spec.";5083856935;Ne;16;0;0;16
21175;"Vilniaus Šilo mokykla";"7-10 spec.";3333634089;Ne;5;22;0;27
21176;"Vilniaus Šilo mokykla";"7-10 spec.";1726056983;Ne;6;0;0;6
21177;"Vilniaus Šilo mokykla";"7-10 spec.";5255365063;Ne;4;0;0;4
21178;"Vilniaus Šilo mokykla";"7-10 spec.";6452740859;Ne;3;0;0;3
21179;"Vilniaus Šilo mokykla";"SĮ A";6954467869;Ne;0;22;0;22
21180;"Vilniaus Šilo mokykla";"SĮ A";2755910347;Ne;7;0;0;7
21181;"Vilniaus Šilo mokykla";"SĮ A";9354191217;Ne;8;0;0;8
21182;"Vilniaus Šilo mokykla";"SĮ A";9471629029;Ne;1;0;0;1
21183;"Vilniaus Šilo mokykla";"SĮ A";6088433049;Ne;4;0;0;4
21184;"Vilniaus Šilo mokykla";"SĮ A";1819519275;Ne;3;0;0;3
21185;"Vilniaus Šilo mokykla";"SĮ A";9050305661;Ne;0;22;0;22
21186;"Vilniaus Šilo mokykla";"SĮ A";8625084837;Ne;0;22;0;22
21187;"Vilniaus Šilo mokykla";"SĮ A";9845575989;Ne;2;0;0;2
21188;"Vilniaus Šilo mokykla";"SĮ A";3308772529;Ne;8;0;0;8
21189;"Vilniaus Šilo mokykla";"SĮ C";8642665550;Ne;1;0;0;1
21190;"Vilniaus Šilo mokykla";"SĮ C";5309862220;Ne;0;22;0;22
21191;"Vilniaus Šilo mokykla";"SĮ C";8377829773;Ne;20;0;0;20
21192;"Vilniaus Šilo mokykla";"SĮ C";5138513395;Ne;13;0;0;13
21193;"Vilniaus Šilo mokykla";"SĮ C";1969540884;Ne;0;22;0;22
21194;"Vilniaus Šilo mokykla";"Priešmokyklinė grupė";5311183877;Ne;22;0;0;22
21195;"Vilniaus Šilo mokykla";"Priešmokyklinė grupė";1675384533;Ne;7;0;0;7
21196;"Vilniaus Šilo mokykla";"Priešmokyklinė grupė";2070454339;Ne;0;22;0;22
21197;"Vilniaus Šilo mokykla";"Priešmokyklinė grupė";9906750269;Ne;0;22;0;22
21198;"Vilniaus Šilo mokykla";"Priešmokyklinė grupė";8897729962;Ne;13;0;0;13
21199;Malūnėlis;BITUTĖS;1001575740;Ne;0;0;5;5
21200;Malūnėlis;BITUTĖS;8618778205;Ne;0;1;0;1
21201;Malūnėlis;BITUTĖS;2545930114;Ne;3;0;0;3
21202;Malūnėlis;BITUTĖS;3329510128;Ne;5;0;1;6
21203;Malūnėlis;BITUTĖS;5402027714;Ne;0;3;0;3
21204;Malūnėlis;BITUTĖS;6863437022;Ne;0;13;0;13
21205;Malūnėlis;BITUTĖS;5244586185;Ne;0;5;0;5
21206;Malūnėlis;BITUTĖS;7144098762;Ne;14;0;0;14
21207;Malūnėlis;BITUTĖS;1146723570;Ne;0;3;0;3
21208;Malūnėlis;BITUTĖS;9891418762;Ne;2;17;0;19
21209;Malūnėlis;BITUTĖS;8642960989;Ne;3;2;1;6
21210;Malūnėlis;BITUTĖS;5959610426;Taip;0;16;0;16
21211;Malūnėlis;BITUTĖS;4367009696;Ne;0;6;0;6
21212;Malūnėlis;BITUTĖS;5770511204;Ne;2;0;0;2
21213;Malūnėlis;BITUTĖS;9936144392;Ne;4;0;1;5
21214;Malūnėlis;BITUTĖS;1944670796;Ne;9;1;0;10
21215;Malūnėlis;BITUTĖS;5421090978;Ne;0;8;0;8
21216;Malūnėlis;BITUTĖS;8643210289;Taip;10;0;0;10
21217;Malūnėlis;BITUTĖS;8440160819;Ne;5;0;0;5
21218;Malūnėlis;BITUTĖS;1528972517;Ne;2;14;0;16
21219;Malūnėlis;BITUTĖS;8007350745;Ne;0;16;0;16
21220;Malūnėlis;BITUTĖS;9257812097;Ne;0;5;0;5
21221;Malūnėlis;BITUTĖS;3402561453;Ne;15;4;0;19
21222;Malūnėlis;VOVERIUKAI;3293082023;Ne;4;1;0;5
21223;Malūnėlis;VOVERIUKAI;6575258889;Taip;6;0;2;8
21224;Malūnėlis;VOVERIUKAI;1003043129;Ne;6;2;2;10
21225;Malūnėlis;VOVERIUKAI;3779723692;Ne;7;1;0;8
21226;Malūnėlis;VOVERIUKAI;7983537913;Ne;6;0;0;6
21227;Malūnėlis;VOVERIUKAI;9592117637;Ne;0;2;0;2
21228;Malūnėlis;VOVERIUKAI;9894452403;Ne;12;0;0;12
21229;Malūnėlis;VOVERIUKAI;2029506037;Ne;6;1;0;7
21230;Malūnėlis;VOVERIUKAI;9342720464;Ne;7;7;0;14
21231;Malūnėlis;VOVERIUKAI;2246526281;Ne;2;0;0;2
21232;Malūnėlis;VOVERIUKAI;2192305527;Ne;12;2;0;14
21233;Malūnėlis;VOVERIUKAI;6805587761;Ne;12;2;0;14
21234;Malūnėlis;VOVERIUKAI;3371260811;Ne;0;10;0;10
21235;Malūnėlis;VOVERIUKAI;5061720786;Ne;6;7;2;15
21236;Malūnėlis;VOVERIUKAI;5232728972;Ne;8;0;0;8
21237;Malūnėlis;VOVERIUKAI;2574604828;Ne;0;8;3;11
21238;Malūnėlis;VOVERIUKAI;3898518306;Ne;0;0;13;13
21239;Malūnėlis;VOVERIUKAI;1770049356;Ne;0;8;0;8
21240;Malūnėlis;VOVERIUKAI;5909022614;Taip;12;0;0;12
21241;Malūnėlis;VOVERIUKAI;6081634102;Ne;0;9;0;9
21242;Malūnėlis;VOVERIUKAI;5540120728;Ne;0;9;0;9
21243;Malūnėlis;BORUŽĖLĖS;7556990784;Ne;2;0;1;3
21244;Malūnėlis;BORUŽĖLĖS;1574941416;Ne;5;0;0;5
21245;Malūnėlis;BORUŽĖLĖS;2525923211;Ne;0;0;9;9
21246;Malūnėlis;BORUŽĖLĖS;6531364407;Ne;0;0;1;1
21247;Malūnėlis;BORUŽĖLĖS;2637299307;Ne;5;0;0;5
21248;Malūnėlis;BORUŽĖLĖS;8551271848;Ne;0;0;2;2
21249;Malūnėlis;BORUŽĖLĖS;8277245773;Ne;0;1;1;2
21250;Malūnėlis;BORUŽĖLĖS;5686301875;Ne;5;0;5;10
21251;Malūnėlis;BORUŽĖLĖS;4787212056;Ne;0;1;9;10
21252;Malūnėlis;BORUŽĖLĖS;9185138453;Ne;21;0;0;21
21253;Malūnėlis;BORUŽĖLĖS;5727725132;Ne;10;0;0;10
21254;Malūnėlis;BORUŽĖLĖS;9559372808;Ne;7;0;0;7
21255;Malūnėlis;Skruzdėliukų;2093908776;Ne;0;7;0;7
21256;Malūnėlis;Skruzdėliukų;9798968369;Ne;0;0;3;3
21257;Malūnėlis;Skruzdėliukų;4859886340;Ne;0;0;2;2
21258;Malūnėlis;Skruzdėliukų;1213476648;Ne;4;1;0;5
21259;Malūnėlis;Skruzdėliukų;9300944734;Ne;0;7;0;7
21260;Malūnėlis;Skruzdėliukų;5877882690;Ne;0;6;0;6
21261;Malūnėlis;Skruzdėliukų;9153589128;Ne;7;15;0;22
21262;Malūnėlis;Skruzdėliukų;5474437579;Ne;0;0;1;1
21263;Malūnėlis;Skruzdėliukų;1549241453;Ne;0;0;2;2
21264;Malūnėlis;Skruzdėliukų;5478561852;Ne;2;2;0;4
21265;Malūnėlis;Skruzdėliukų;4802771311;Ne;0;0;1;1
21266;Malūnėlis;Skruzdėliukų;9207327884;Ne;7;15;0;22
21267;Malūnėlis;Skruzdėliukų;6609446450;Ne;12;1;0;13
21268;Malūnėlis;Skruzdėliukų;8076487157;Ne;0;5;2;7
21269;Malūnėlis;Skruzdėliukų;2495112045;Ne;0;0;16;16
21270;Malūnėlis;Skruzdėliukų;3935474148;Ne;4;1;0;5
21271;Malūnėlis;Skruzdėliukų;8751365673;Ne;0;0;5;5
21272;Malūnėlis;Žirniukų;3791873303;Ne;15;2;0;17
21273;Malūnėlis;Žirniukų;3031849277;Ne;7;0;0;7
21274;Malūnėlis;Žirniukų;6747286787;Ne;0;1;4;5
21275;Malūnėlis;Žirniukų;4539998453;Ne;4;0;0;4
21276;Malūnėlis;Žirniukų;6943968536;Ne;4;1;1;6
21277;Malūnėlis;Žirniukų;4841028952;Ne;11;0;3;14
21278;Malūnėlis;Žirniukų;7097858329;Ne;3;1;0;4
21279;Malūnėlis;Žirniukų;5893575540;Ne;0;13;3;16
21280;Malūnėlis;Žirniukų;1398391534;Ne;0;1;1;2
21281;Malūnėlis;Žirniukų;2961972215;Ne;13;0;0;13
21282;Malūnėlis;Žirniukų;5622982984;Ne;0;7;1;8
21283;Malūnėlis;Žirniukų;3315571256;Ne;9;0;1;10
21284;Malūnėlis;Žirniukų;3315571256;Ne;9;0;1;10
21285;Malūnėlis;Žirniukų;3315571256;Ne;9;0;1;10
21286;Malūnėlis;Žirniukų;9941335615;Ne;0;13;0;13
21287;Malūnėlis;Žirniukų;3464224841;Ne;0;5;0;5
21288;Malūnėlis;Žirniukų;6047042736;Ne;7;6;0;13
21289;Malūnėlis;Žirniukų;4875859413;Ne;0;1;13;14
21290;"Dainorėliai (Goštauto g. 4)";PUMPURĖLIAI;8015545426;Ne;0;5;0;5
21291;"Dainorėliai (Goštauto g. 4)";PUMPURĖLIAI;5691833295;Taip;0;10;0;10
21292;"Dainorėliai (Goštauto g. 4)";PUMPURĖLIAI;6132543858;Ne;0;6;0;6
21293;"Dainorėliai (Goštauto g. 4)";PUMPURĖLIAI;4560328911;Ne;0;13;0;13
21294;"Dainorėliai (Goštauto g. 4)";PUMPURĖLIAI;4435310580;Ne;0;15;12;27
21295;"Dainorėliai (Goštauto g. 4)";PUMPURĖLIAI;7197089520;Ne;0;10;0;10
21296;"Dainorėliai (Goštauto g. 4)";PUMPURĖLIAI;3999214263;Ne;2;0;0;2
21297;"Dainorėliai (Goštauto g. 4)";PUMPURĖLIAI;6362265057;Ne;0;1;0;1
21298;"Dainorėliai (Goštauto g. 4)";PUMPURĖLIAI;2215481883;Ne;0;11;21;32
21299;"Dainorėliai (Goštauto g. 4)";PUMPURĖLIAI;1233029451;Ne;32;0;0;32
21300;"Dainorėliai (Goštauto g. 4)";PUMPURĖLIAI;3561729784;Ne;0;6;2;8
21301;"Dainorėliai (Goštauto g. 4)";PUMPURĖLIAI;5534783929;Ne;0;0;1;1
21302;"Dainorėliai (Goštauto g. 4)";PUMPURĖLIAI;3705286231;Ne;0;1;1;2
21303;"Dainorėliai (Goštauto g. 4)";PUMPURĖLIAI;4848146301;Ne;2;2;0;4
21304;"Dainorėliai (Goštauto g. 4)";DEBESĖLIŲ;6513417505;Ne;3;13;0;16
21305;"Dainorėliai (Goštauto g. 4)";DEBESĖLIŲ;5605084046;Ne;0;0;1;1
21306;"Dainorėliai (Goštauto g. 4)";DEBESĖLIŲ;1873415679;Ne;0;1;0;1
21307;"Dainorėliai (Goštauto g. 4)";DEBESĖLIŲ;4286864865;Ne;0;0;1;1
21308;"Dainorėliai (Goštauto g. 4)";DEBESĖLIŲ;1554081754;Ne;0;3;0;3
21309;"Dainorėliai (Goštauto g. 4)";DEBESĖLIŲ;6832582194;Ne;2;0;0;2
21310;"Dainorėliai (Goštauto g. 4)";DEBESĖLIŲ;2095914442;Ne;0;3;0;3
21311;"Dainorėliai (Goštauto g. 4)";DEBESĖLIŲ;4255893222;Ne;0;10;22;32
21312;"Dainorėliai (Goštauto g. 4)";DEBESĖLIŲ;3271090533;Ne;0;25;0;25
21313;"Dainorėliai (Goštauto g. 4)";DEBESĖLIŲ;4033317616;Ne;15;0;0;15
21314;"Dainorėliai (Goštauto g. 4)";DEBESĖLIŲ;6449332338;Ne;3;11;0;14
21315;"Dainorėliai (Goštauto g. 4)";DEBESĖLIŲ;9285865812;Ne;0;1;0;1
21316;"Dainorėliai (Goštauto g. 4)";DEBESĖLIŲ;6284140548;Ne;0;12;0;12
21317;"Dainorėliai (Goštauto g. 4)";DEBESĖLIŲ;5283566263;Ne;4;3;0;7
21318;"Krivūlė (Vokiečių g. 1)";PABIRUČIAI;9011102232;Ne;0;0;4;4
21319;"Krivūlė (Vokiečių g. 1)";PABIRUČIAI;5535822704;Ne;0;22;0;22
21320;"Krivūlė (Vokiečių g. 1)";PABIRUČIAI;3696403149;Ne;0;22;0;22
21321;"Krivūlė (Vokiečių g. 1)";PABIRUČIAI;5721252419;Ne;0;22;0;22
21322;"Krivūlė (Vokiečių g. 1)";PABIRUČIAI;4600688626;Ne;0;0;13;13
21323;"Krivūlė (Vokiečių g. 1)";PABIRUČIAI;4608957977;Ne;0;0;2;2
21324;"Krivūlė (Vokiečių g. 1)";PABIRUČIAI;7308968772;Ne;0;6;2;8
21325;"Krivūlė (Vokiečių g. 1)";PABIRUČIAI;4884789671;Ne;0;0;5;5
21326;"Krivūlė (Vokiečių g. 1)";PABIRUČIAI;8352493729;Ne;0;22;0;22
21327;"Krivūlė (Vokiečių g. 1)";PABIRUČIAI;8678565710;Ne;0;0;4;4
21328;"Krivūlė (Vokiečių g. 1)";PABIRUČIAI;9401191578;Ne;0;0;9;9
21329;"Krivūlė (Vokiečių g. 1)";PABIRUČIAI;2259139771;Ne;0;0;1;1
21330;"Krivūlė (Vokiečių g. 1)";PABIRUČIAI;3138555448;Ne;5;10;5;20
21331;"Krivūlė (Vokiečių g. 1)";PABIRUČIAI;2784118970;Ne;0;0;1;1
21332;"Krivūlė (Vokiečių g. 1)";PABIRUČIAI;3227555647;Ne;0;0;2;2
21333;"Krivūlė (Vokiečių g. 1)";PABIRUČIAI;4261770381;Ne;9;0;1;10
21334;"Krivūlė (Vokiečių g. 1)";SMALSUČIAI;5304221329;Ne;0;0;8;8
21335;"Krivūlė (Vokiečių g. 1)";SMALSUČIAI;7508079584;Ne;0;0;5;5
21336;"Krivūlė (Vokiečių g. 1)";SMALSUČIAI;5199600243;Ne;0;0;4;4
21337;"Krivūlė (Vokiečių g. 1)";SMALSUČIAI;4814488445;Ne;0;0;1;1
21338;"Krivūlė (Vokiečių g. 1)";SMALSUČIAI;3076382863;Ne;0;0;3;3
21339;"Krivūlė (Vokiečių g. 1)";SMALSUČIAI;7997564406;Ne;0;9;0;9
21340;"Krivūlė (Vokiečių g. 1)";SMALSUČIAI;8710938907;Ne;5;7;5;17
21341;"Krivūlė (Vokiečių g. 1)";SMALSUČIAI;4491462086;Taip;5;0;8;13
21342;"Krivūlė (Vokiečių g. 1)";SMALSUČIAI;4773564048;Ne;0;10;0;10
21343;"Krivūlė (Vokiečių g. 1)";SMALSUČIAI;3324090723;Ne;0;6;2;8
21344;"Krivūlė (Vokiečių g. 1)";SMALSUČIAI;9229817861;Ne;0;0;4;4
21345;"Krivūlė (Vokiečių g. 1)";SMALSUČIAI;8042469720;Ne;0;3;0;3
21346;"Krivūlė (Vokiečių g. 1)";SMALSUČIAI;4845066055;Ne;0;0;20;20
21347;"Krivūlė (Vokiečių g. 1)";SMALSUČIAI;1815336153;Ne;2;8;0;10
21348;"Krivūlė (Vokiečių g. 1)";SMALSUČIAI;7528273082;Ne;0;0;3;3
21349;"Krivūlė (Vokiečių g. 1)";SMALSUČIAI;6521798502;Ne;0;0;1;1
21350;"Krivūlė (Vokiečių g. 1)";SMALSUČIAI;5790418638;Ne;0;0;2;2
21351;"Krivūlė (Vokiečių g. 1)";SMALSUČIAI;1851097789;Ne;0;7;1;8
21352;"Krivūlė (Vokiečių g. 1)";GUDRUČIAI;4681543921;Ne;3;0;0;3
21353;"Krivūlė (Vokiečių g. 1)";GUDRUČIAI;8520470321;Ne;0;0;7;7
21354;"Krivūlė (Vokiečių g. 1)";GUDRUČIAI;5753204752;Ne;0;0;7;7
21355;"Krivūlė (Vokiečių g. 1)";GUDRUČIAI;2659604299;Ne;10;0;0;10
21356;"Krivūlė (Vokiečių g. 1)";GUDRUČIAI;2536472220;Ne;0;3;0;3
21357;"Krivūlė (Vokiečių g. 1)";GUDRUČIAI;1622495013;Ne;0;0;5;5
21358;"Krivūlė (Vokiečių g. 1)";GUDRUČIAI;7436569684;Ne;0;6;1;7
21359;"Krivūlė (Vokiečių g. 1)";GUDRUČIAI;7727246187;Ne;0;1;0;1
21360;"Krivūlė (Vokiečių g. 1)";GUDRUČIAI;6072261879;Ne;0;14;2;16
21361;"Krivūlė (Vokiečių g. 1)";GUDRUČIAI;5149419581;Ne;0;0;5;5
21362;"Krivūlė (Vokiečių g. 1)";GUDRUČIAI;7789605738;Ne;0;0;1;1
21363;"Krivūlė (Vokiečių g. 1)";GUDRUČIAI;9693693101;Ne;15;0;0;15
21364;"Krivūlė (Vokiečių g. 1)";GUDRUČIAI;5462491857;Ne;0;8;8;16
21365;"Krivūlė (Vokiečių g. 1)";GUDRUČIAI;8871794542;Ne;11;0;1;12
21366;"Pumpurėlis (Trinapolio g. 11)";GUDRUČIAI;7002569226;Ne;6;0;0;6
21367;"Pumpurėlis (Trinapolio g. 11)";GUDRUČIAI;9353403057;Ne;10;0;0;10
21368;"Pumpurėlis (Trinapolio g. 11)";GUDRUČIAI;9353403057;Ne;10;0;0;10
21369;"Pumpurėlis (Trinapolio g. 11)";GUDRUČIAI;6920353753;Ne;10;0;2;12
21370;"Pumpurėlis (Trinapolio g. 11)";GUDRUČIAI;6920353753;Ne;10;0;2;12
21371;"Pumpurėlis (Trinapolio g. 11)";GUDRUČIAI;1189960583;Ne;0;13;1;14
21372;"Pumpurėlis (Trinapolio g. 11)";GUDRUČIAI;3841134563;Ne;0;0;3;3
21373;"Pumpurėlis (Trinapolio g. 11)";GUDRUČIAI;3841134563;Ne;0;0;3;3
21374;"Pumpurėlis (Trinapolio g. 11)";GUDRUČIAI;3841134563;Ne;0;0;3;3
21375;"Pumpurėlis (Trinapolio g. 11)";GUDRUČIAI;5187890514;Ne;0;0;2;2
21376;"Pumpurėlis (Trinapolio g. 11)";GUDRUČIAI;3387386473;Ne;3;0;0;3
21377;"Pumpurėlis (Trinapolio g. 11)";GUDRUČIAI;7177681927;Ne;15;5;0;20
21378;"Pumpurėlis (Trinapolio g. 11)";GUDRUČIAI;2130008026;Ne;5;0;17;22
21379;"Pumpurėlis (Trinapolio g. 11)";GUDRUČIAI;8475215020;Ne;0;0;1;1
21380;"Pumpurėlis (Trinapolio g. 11)";GUDRUČIAI;3333547914;Ne;0;22;0;22
21381;"Pumpurėlis (Trinapolio g. 11)";GUDRUČIAI;9550967420;Ne;12;0;5;17
21382;"Pumpurėlis (Trinapolio g. 11)";GUDRUČIAI;1750311606;Ne;0;0;2;2
21383;"Pumpurėlis (Trinapolio g. 11)";PABIRUČIAI;9824315755;Ne;3;3;0;6
21384;"Pumpurėlis (Trinapolio g. 11)";PABIRUČIAI;4565317498;Ne;5;0;2;7
21385;"Pumpurėlis (Trinapolio g. 11)";PABIRUČIAI;7910361194;Ne;19;0;0;19
21386;"Pumpurėlis (Trinapolio g. 11)";PABIRUČIAI;5249717804;Ne;0;0;1;1
21387;"Pumpurėlis (Trinapolio g. 11)";PABIRUČIAI;5403012236;Ne;7;0;0;7
21388;"Pumpurėlis (Trinapolio g. 11)";PABIRUČIAI;7998027741;Ne;7;0;3;10
21389;"Pumpurėlis (Trinapolio g. 11)";PABIRUČIAI;4955734206;Ne;0;6;0;6
21390;"Pumpurėlis (Trinapolio g. 11)";PABIRUČIAI;8704865319;Ne;10;0;0;10
21391;"Pumpurėlis (Trinapolio g. 11)";PABIRUČIAI;8207951541;Ne;10;0;0;10
21392;"Pumpurėlis (Trinapolio g. 11)";PABIRUČIAI;4696006714;Ne;2;0;0;2
21393;"Pumpurėlis (Trinapolio g. 11)";PABIRUČIAI;9597889927;Ne;0;0;1;1
21394;"Pumpurėlis (Trinapolio g. 11)";PABIRUČIAI;2187090934;Ne;7;0;0;7
21395;"Pumpurėlis (Trinapolio g. 11)";PABIRUČIAI;1222204689;Ne;0;0;2;2
21396;"Pumpurėlis (Trinapolio g. 11)";PABIRUČIAI;9395698760;Ne;5;5;2;12
21397;"Gilužis (Įsruties g. 30)";"MEDYNĖLIO 1 GR.";8237963602;Ne;11;1;0;12
21398;"Gilužis (Įsruties g. 30)";"MEDYNĖLIO 1 GR.";9753512366;Ne;14;0;6;20
21399;"Gilužis (Įsruties g. 30)";"MEDYNĖLIO 1 GR.";6914566889;Ne;7;0;2;9
21400;"Gilužis (Įsruties g. 30)";"MEDYNĖLIO 1 GR.";1541283216;Ne;5;0;0;5
21401;"Gilužis (Įsruties g. 30)";"MEDYNĖLIO 1 GR.";5306278297;Ne;14;1;0;15
21402;"Gilužis (Įsruties g. 30)";"MEDYNĖLIO 1 GR.";1054809163;Ne;0;8;5;13
21403;"Gilužis (Įsruties g. 30)";"MEDYNĖLIO 1 GR.";7887970476;Ne;12;0;0;12
21404;"Gilužis (Įsruties g. 30)";"MEDYNĖLIO 1 GR.";6507021182;Ne;12;0;0;12
21405;"Gilužis (Įsruties g. 30)";"MEDYNĖLIO 1 GR.";4652281185;Ne;4;0;2;6
21406;"Gilužis (Įsruties g. 30)";"MEDYNĖLIO 1 GR.";2364391112;Ne;5;0;0;5
21407;"Gilužis (Įsruties g. 30)";"MEDYNĖLIO 1 GR.";6514483362;Ne;0;1;0;1
21408;"Gilužis (Įsruties g. 30)";"MEDYNĖLIO 1 GR.";7068801003;Ne;0;5;0;5
21409;"Gilužis (Įsruties g. 30)";"MEDYNĖLIO 1 GR.";3081351563;Ne;2;0;1;3
21410;"Gilužis (Įsruties g. 30)";"MEDYNĖLIO 2 GR.";7247606321;Ne;2;12;1;15
21411;"Gilužis (Įsruties g. 30)";"MEDYNĖLIO 2 GR.";5664892047;Ne;9;0;1;10
21412;"Gilužis (Įsruties g. 30)";"MEDYNĖLIO 2 GR.";3379889899;Ne;10;0;0;10
21413;"Gilužis (Įsruties g. 30)";"MEDYNĖLIO 2 GR.";2915024298;Ne;0;0;7;7
21414;"Gilužis (Įsruties g. 30)";"MEDYNĖLIO 2 GR.";2567788346;Ne;4;0;0;4
21415;"Gilužis (Įsruties g. 30)";"MEDYNĖLIO 2 GR.";5769955074;Taip;3;0;0;3
21416;"Gilužis (Įsruties g. 30)";"MEDYNĖLIO 2 GR.";7487731015;Ne;7;0;0;7
21417;"Gilužis (Įsruties g. 30)";"MEDYNĖLIO 2 GR.";5079154238;Ne;3;0;1;4
21418;"Gilužis (Įsruties g. 30)";"MEDYNĖLIO 2 GR.";5490128851;Ne;0;0;8;8
21419;"Gilužis (Įsruties g. 30)";"MEDYNĖLIO 2 GR.";5784201106;Ne;7;0;0;7
21420;"Gilužis (Įsruties g. 30)";"MEDYNĖLIO 2 GR.";8904873416;Ne;10;0;1;11
21421;"Gilužis (Įsruties g. 30)";"MEDYNĖLIO 2 GR.";2851682356;Ne;10;0;0;10
21422;"Gilužis (Įsruties g. 30)";"MEDYNĖLIO 2 GR.";3917385813;Taip;7;0;0;7
21423;"Gilužis (Įsruties g. 30)";"STRAZDELIO GR.";6485579727;Ne;0;0;2;2
21424;"Gilužis (Įsruties g. 30)";"STRAZDELIO GR.";8477445384;Ne;2;0;5;7
21425;"Gilužis (Įsruties g. 30)";"STRAZDELIO GR.";6766559505;Taip;4;0;0;4
21426;"Gilužis (Įsruties g. 30)";"STRAZDELIO GR.";3194397689;Ne;0;12;0;12
21427;"Gilužis (Įsruties g. 30)";"STRAZDELIO GR.";5737505086;Ne;0;22;0;22
21428;"Gilužis (Įsruties g. 30)";"STRAZDELIO GR.";3414489196;Ne;5;0;0;5
21429;"Gilužis (Įsruties g. 30)";"STRAZDELIO GR.";6586605929;Ne;15;5;2;22
21430;"Gilužis (Įsruties g. 30)";"STRAZDELIO GR.";3331616067;Ne;0;0;6;6
21431;"Gilužis (Įsruties g. 30)";"STRAZDELIO GR.";3729538163;Ne;5;0;4;9
21432;"Gilužis (Įsruties g. 30)";"STRAZDELIO GR.";4325300253;Ne;12;4;0;16
21433;"Gilužis (Įsruties g. 30)";"STRAZDELIO GR.";6207304860;Ne;5;0;0;5
21434;"Gilužis (Įsruties g. 30)";"STRAZDELIO GR.";5921538837;Ne;4;0;3;7
21435;"Gilužis (Įsruties g. 30)";"STRAZDELIO GR.";7053810996;Ne;5;0;0;5
21436;"Gilužis (Įsruties g. 30)";"STRAZDELIO GR.";9846916206;Ne;4;0;2;6
21437;"Gilužis (Įsruties g. 30)";"STRAZDELIO GR.";2398220397;Ne;11;2;1;14
21438;"Gilužis (Įsruties g. 30)";"STRAZDELIO GR.";3187000487;Ne;8;0;0;8
21439;"Gilužis (Įsruties g. 30)";"STRAZDELIO GR.";1826248450;Ne;2;0;0;2
21440;"Gilužis (Įsruties g. 30)";"STRAZDELIO GR.";9325927745;Ne;7;0;9;16
21441;"Gilužis (Įsruties g. 30)";"STRAZDELIO GR.";1758670627;Ne;5;0;3;8
21442;"Pilaitukas (Įsruties g. 27)";ŠNEKUČIAI;5118977299;Ne;13;0;0;13
21443;"Pilaitukas (Įsruties g. 27)";ŠNEKUČIAI;9940643503;Ne;2;0;0;2
21444;"Pilaitukas (Įsruties g. 27)";ŠNEKUČIAI;1445759374;Ne;8;0;0;8
21445;"Pilaitukas (Įsruties g. 27)";ŠNEKUČIAI;1859101624;Ne;4;10;0;14
21446;"Pilaitukas (Įsruties g. 27)";ŠNEKUČIAI;8479229073;Ne;6;0;0;6
21447;"Pilaitukas (Įsruties g. 27)";ŠNEKUČIAI;9731380502;Ne;0;3;2;5
21448;"Pilaitukas (Įsruties g. 27)";ŠNEKUČIAI;7224121082;Ne;22;0;0;22
21449;"Pilaitukas (Įsruties g. 27)";ŠNEKUČIAI;9115588495;Ne;6;0;0;6
21450;"Pilaitukas (Įsruties g. 27)";ŠNEKUČIAI;1082342063;Ne;6;0;1;7
21451;"Pilaitukas (Įsruties g. 27)";ŠNEKUČIAI;8801482035;Ne;15;0;0;15
21452;"Pilaitukas (Įsruties g. 27)";ŠNEKUČIAI;2894028512;Ne;7;0;0;7
21453;"Pilaitukas (Įsruties g. 27)";ŠNEKUČIAI;9622989196;Ne;17;0;0;17
21454;"Pilaitukas (Įsruties g. 27)";ŠNEKUČIAI;1356473379;Ne;0;22;0;22
21455;"Pilaitukas (Įsruties g. 27)";ŠNEKUČIAI;2883122532;Ne;0;2;3;5
21456;"Pilaitukas (Įsruties g. 27)";ŠNEKUČIAI;2883122532;Ne;0;2;3;5
21457;"Pilaitukas (Įsruties g. 27)";ŠNEKUČIAI;2883122532;Ne;0;2;3;5
21458;"Pilaitukas (Įsruties g. 27)";ŠNEKUČIAI;2939090118;Ne;1;0;0;1
21459;"Pilaitukas (Įsruties g. 27)";ŠNEKUČIAI;1309209771;Ne;12;0;0;12
21460;"Pilaitukas (Įsruties g. 27)";SMALSUČIAI;1815311248;Ne;6;0;0;6
21461;"Pilaitukas (Įsruties g. 27)";SMALSUČIAI;1414751236;Ne;1;0;6;7
21462;"Pilaitukas (Įsruties g. 27)";SMALSUČIAI;3215689222;Ne;2;5;1;8
21463;"Pilaitukas (Įsruties g. 27)";SMALSUČIAI;8755603496;Ne;2;6;0;8
21464;"Pilaitukas (Įsruties g. 27)";SMALSUČIAI;1974429718;Ne;5;2;0;7
21465;"Pilaitukas (Įsruties g. 27)";SMALSUČIAI;4544849086;Ne;0;0;5;5
21466;"Pilaitukas (Įsruties g. 27)";SMALSUČIAI;6934677745;Ne;7;0;1;8
21467;"Pilaitukas (Įsruties g. 27)";SMALSUČIAI;6496708020;Ne;0;0;3;3
21468;"Pilaitukas (Įsruties g. 27)";SMALSUČIAI;4608105047;Ne;13;0;0;13
21469;"Pilaitukas (Įsruties g. 27)";SMALSUČIAI;8698639192;Ne;0;6;2;8
21470;"Pilaitukas (Įsruties g. 27)";SMALSUČIAI;3501783231;Ne;2;0;3;5
21471;"Pilaitukas (Įsruties g. 27)";SMALSUČIAI;4898803794;Ne;9;0;0;9
21472;"Pilaitukas (Įsruties g. 27)";SMALSUČIAI;3544734838;Ne;2;0;2;4
21473;"Pilaitukas (Įsruties g. 27)";SMALSUČIAI;7034013577;Ne;5;0;0;5
21474;"Pilaitukas (Įsruties g. 27)";SMALSUČIAI;1793393776;Ne;3;1;8;12
21475;"Pilaitukas (Įsruties g. 27)";" GUDRUČIAI";87035008129;Ne;0;0;1;1
21476;"Pilaitukas (Įsruties g. 27)";" GUDRUČIAI";9921730735;Ne;0;0;1;1
21477;"Pilaitukas (Įsruties g. 27)";" GUDRUČIAI";3489297719;Ne;0;8;0;8
21478;"Pilaitukas (Įsruties g. 27)";" GUDRUČIAI";3068325053;Ne;0;0;1;1
21479;"Pilaitukas (Įsruties g. 27)";" GUDRUČIAI";1571691020;Ne;0;0;1;1
21480;"Pilaitukas (Įsruties g. 27)";" GUDRUČIAI";7904142328;Ne;0;0;1;1
21481;"Pilaitukas (Įsruties g. 27)";" GUDRUČIAI";9186679454;Ne;0;0;1;1
21482;"Pilaitukas (Įsruties g. 27)";" GUDRUČIAI";8584321345;Ne;0;0;2;2
21483;"Pilaitukas (Įsruties g. 27)";" GUDRUČIAI";3674481373;Ne;0;9;0;9
21484;"Pilaitukas (Įsruties g. 27)";" GUDRUČIAI";87760608710;Ne;0;8;1;9
21485;"Pilaitukas (Įsruties g. 27)";" GUDRUČIAI";93271260871;Ne;8;4;0;12
21486;"Pilaitukas (Įsruties g. 27)";" GUDRUČIAI";8928237970;Ne;9;0;0;9
21487;"Pilaitukas (Įsruties g. 27)";" GUDRUČIAI";2819283284;Ne;9;0;1;10
21488;"Pilaitukas (Įsruties g. 27)";" GUDRUČIAI";5574732283;Ne;0;0;1;1
21489;"Pilaitukas (Įsruties g. 27)";" GUDRUČIAI";7380303098;Ne;10;3;0;13
21490;"Pilaitukas (Įsruties g. 27)";" GUDRUČIAI";1430155044;Ne;0;0;1;1
21491;"Pilaitukas (Įsruties g. 27)";" GUDRUČIAI";3621245783;Ne;0;0;4;4
21492;"Pilaitukas (Įsruties g. 27)";" GUDRUČIAI";2682252810;Ne;6;0;0;6
21493;"Pilaitukas (Įsruties g. 27)";" GUDRUČIAI";7290732562;Ne;0;0;3;3
21494;"Pilaitukas (Įsruties g. 27)";" GUDRUČIAI";3927118900;Ne;5;0;0;5
