Nr.;"Darželio pavadinimas";"Grupės pavadinimas";"Vaiko Identifikacinis Nr.";"Deklaruotas mieste";"Pateisintos dėl ligos";"Pateisintos dėl kitų priežasčių";"Nepateisintos dienos";"Praleistos dienos Viso"
1;Aitvaras;"VIJURKAI (ALERG.)";1877245088;Ne;6;8;0;14
2;Aitvaras;"VIJURKAI (ALERG.)";6936031222;Taip;0;3;1;4
3;Aitvaras;"VIJURKAI (ALERG.)";6214880713;Taip;0;1;0;1
4;Aitvaras;"VIJURKAI (ALERG.)";2566375128;Taip;0;1;0;1
5;Aitvaras;"VIJURKAI (ALERG.)";1879540041;Taip;0;7;0;7
6;Aitvaras;"VIJURKAI (ALERG.)";8206046301;Taip;0;0;3;3
7;Aitvaras;"VIJURKAI (ALERG.)";1347364985;Taip;0;3;0;3
8;Aitvaras;"VIJURKAI (ALERG.)";9157794193;Taip;9;4;0;13
9;Aitvaras;"VIJURKAI (ALERG.)";9562494357;Taip;4;4;0;8
10;Aitvaras;"VIJURKAI (ALERG.)";6021342178;Taip;6;3;0;9
11;Aitvaras;"VIJURKAI (ALERG.)";2650483861;Taip;5;4;0;9
12;Aitvaras;"VIJURKAI (ALERG.)";4426643908;Taip;0;3;0;3
13;Aitvaras;"VIJURKAI (ALERG.)";2601983670;Taip;0;3;0;3
14;Aitvaras;"VIJURKAI (ALERG.)";2895663259;Taip;0;3;0;3
15;Aitvaras;"VIJURKAI (ALERG.)";3570820823;Taip;0;3;0;3
16;Aitvaras;"VIJURKAI (ALERG.)";6444377924;Taip;0;0;17;17
17;Aitvaras;"VIJURKAI (ALERG.)";4702400490;Taip;0;3;0;3
18;Aitvaras;"SMALSUČIAI (ALERG.)";4868552034;Taip;0;3;0;3
19;Aitvaras;"SMALSUČIAI (ALERG.)";6166757095;Taip;0;3;1;4
20;Aitvaras;"SMALSUČIAI (ALERG.)";4480921300;Taip;0;2;0;2
21;Aitvaras;"SMALSUČIAI (ALERG.)";1019661577;Taip;0;1;0;1
22;Aitvaras;"SMALSUČIAI (ALERG.)";5425259260;Taip;0;4;0;4
23;Aitvaras;"SMALSUČIAI (ALERG.)";6201118021;Taip;6;3;0;9
24;Aitvaras;"SMALSUČIAI (ALERG.)";5750154036;Taip;0;4;0;4
25;Aitvaras;"SMALSUČIAI (ALERG.)";1275561645;Taip;0;3;0;3
26;Aitvaras;"SMALSUČIAI (ALERG.)";6084096300;Taip;0;8;0;8
27;Aitvaras;"SMALSUČIAI (ALERG.)";2004112424;Taip;4;4;0;8
28;Aitvaras;"SMALSUČIAI (ALERG.)";5330618557;Taip;2;2;0;4
29;Aitvaras;"SMALSUČIAI (ALERG.)";3488467265;Taip;0;3;0;3
30;Aitvaras;"SMALSUČIAI (ALERG.)";9745864667;Taip;10;1;0;11
31;Aitvaras;"SMALSUČIAI (ALERG.)";9810370596;Taip;0;3;0;3
32;Aitvaras;"SMALSUČIAI (ALERG.)";1954364886;Taip;5;3;0;8
33;Aitvaras;"SMALSUČIAI (ALERG.)";3535659630;Taip;0;3;0;3
34;Aitvaras;"SMALSUČIAI (ALERG.)";4833313373;Taip;0;1;1;2
35;Aitvaras;"SMALSUČIAI (ALERG.)";24247118884;Taip;0;3;0;3
36;Aitvaras;"SMALSUČIAI (ALERG.)";5504431748;Taip;0;1;0;1
37;Aitvaras;"SMALSUČIAI (ALERG.)";5389627560;Taip;5;5;2;12
38;Aitvaras;"SMALSUČIAI (ALERG.)";2953536545;Taip;3;3;0;6
39;Aitvaras;"SMALSUČIAI (ALERG.)";1636794584;Taip;0;4;0;4
40;Aitvaras;"SMALSUČIAI (ALERG.)";5956333024;Taip;0;6;0;6
41;Aitvaras;"SMALSUČIAI (ALERG.)";5595233402;Taip;0;2;0;2
42;Aitvaras;PADAUŽIUKAI;1494094426;Taip;0;6;0;6
43;Aitvaras;PADAUŽIUKAI;9332771711;Taip;0;5;0;5
44;Aitvaras;PADAUŽIUKAI;6550426644;Taip;5;12;0;17
45;Aitvaras;PADAUŽIUKAI;5818794912;Taip;0;4;0;4
46;Aitvaras;PADAUŽIUKAI;58780461337;Ne;0;4;6;10
47;Aitvaras;PADAUŽIUKAI;2034293999;Taip;28;0;0;28
48;Aitvaras;PADAUŽIUKAI;1116271183;Taip;0;1;0;1
49;Aitvaras;PADAUŽIUKAI;44046627149;Taip;5;4;0;9
50;Aitvaras;PADAUŽIUKAI;43711349817;Taip;0;0;4;4
51;Aitvaras;PADAUŽIUKAI;2804106417;Taip;0;2;0;2
52;Aitvaras;PADAUŽIUKAI;2711888522;Taip;4;2;0;6
53;Aitvaras;PADAUŽIUKAI;1996524718;Taip;0;5;2;7
54;Aitvaras;PADAUŽIUKAI;4110585744;Taip;0;6;0;6
55;Aitvaras;PADAUŽIUKAI;7469656671;Taip;0;6;0;6
56;Aitvaras;PADAUŽIUKAI;6010324894;Taip;0;3;0;3
57;Aitvaras;PADAUŽIUKAI;2408952971;Taip;5;3;0;8
58;Aitvaras;PADAUŽIUKAI;2330782717;Taip;0;2;0;2
59;Aitvaras;PADAUŽIUKAI;47875842134;Taip;0;5;0;5
60;Aitvaras;PADAUŽIUKAI;40799643122;Taip;0;13;0;13
61;Aitvaras;PADAUŽIUKAI;8784628567;Taip;0;3;0;3
62;Aitvaras;PADAUŽIUKAI;9015675095;Taip;0;4;0;4
63;Aitvaras;PADAUŽIUKAI;8503279655;Taip;0;6;1;7
64;Aitvaras;PADAUŽIUKAI;8121858940;Taip;2;4;11;17
65;Aitvaras;PADAUŽIUKAI;6951219468;Taip;0;2;0;2
66;Aitvaras;"AITVARIUKAI (ALERG.)";3639102842;Taip;0;7;0;7
67;Aitvaras;"AITVARIUKAI (ALERG.)";7243387750;Taip;2;5;0;7
68;Aitvaras;"AITVARIUKAI (ALERG.)";6587437949;Taip;0;4;0;4
69;Aitvaras;"AITVARIUKAI (ALERG.)";7461284958;Taip;10;1;0;11
70;Aitvaras;"AITVARIUKAI (ALERG.)";3394251305;Taip;3;3;0;6
71;Aitvaras;"AITVARIUKAI (ALERG.)";6459307767;Taip;0;2;0;2
72;Aitvaras;"AITVARIUKAI (ALERG.)";5635576679;Taip;0;12;0;12
73;Aitvaras;"AITVARIUKAI (ALERG.)";7988247429;Taip;0;5;0;5
74;Aitvaras;"AITVARIUKAI (ALERG.)";8770777328;Taip;0;7;0;7
75;Aitvaras;"AITVARIUKAI (ALERG.)";3653879553;Taip;3;4;0;7
76;Aitvaras;"AITVARIUKAI (ALERG.)";9721273154;Taip;3;0;3;6
77;Aitvaras;"AITVARIUKAI (ALERG.)";5103105065;Taip;15;0;0;15
78;Aitvaras;"AITVARIUKAI (ALERG.)";1859647003;Taip;21;0;0;21
79;Aitvaras;"AITVARIUKAI (ALERG.)";4204923580;Taip;0;4;0;4
80;Aitvaras;"AITVARIUKAI (ALERG.)";4777266938;Taip;8;6;0;14
81;Aitvaras;"AITVARIUKAI (ALERG.)";7568388141;Taip;4;6;0;10
82;Aitvaras;"AITVARIUKAI (ALERG.)";3954840915;Taip;0;4;2;6
83;Aitvaras;"AITVARIUKAI (ALERG.)";2146963673;Taip;12;0;0;12
84;Aitvaras;"AITVARIUKAI (ALERG.)";9763502346;Taip;5;4;0;9
85;Aitvaras;"AITVARIUKAI (ALERG.)";9228736015;Taip;9;0;0;9
86;Aitvaras;"AITVARIUKAI (ALERG.)";3775634117;Taip;0;1;0;1
87;Aitvaras;"AITVARIUKAI (ALERG.)";2615576367;Ne;8;1;0;9
88;Aitvaras;"SAULĖS ZUIKUČIAI  (ALERG.)";5711324951;Taip;26;0;0;26
89;Aitvaras;"SAULĖS ZUIKUČIAI  (ALERG.)";5619137905;Taip;18;0;0;18
90;Aitvaras;"SAULĖS ZUIKUČIAI  (ALERG.)";4106097701;Taip;0;1;0;1
91;Aitvaras;"SAULĖS ZUIKUČIAI  (ALERG.)";2184231202;Taip;8;2;0;10
92;Aitvaras;"SAULĖS ZUIKUČIAI  (ALERG.)";2478737835;Taip;5;1;4;10
93;Aitvaras;"SAULĖS ZUIKUČIAI  (ALERG.)";1136438927;Taip;0;2;0;2
94;Aitvaras;"SAULĖS ZUIKUČIAI  (ALERG.)";8137900398;Taip;0;3;4;7
95;Aitvaras;"SAULĖS ZUIKUČIAI  (ALERG.)";9147954612;Taip;14;0;0;14
96;Aitvaras;"SAULĖS ZUIKUČIAI  (ALERG.)";2511844613;Taip;8;1;0;9
97;Aitvaras;"SAULĖS ZUIKUČIAI  (ALERG.)";7907357058;Taip;6;2;0;8
98;Aitvaras;"SAULĖS ZUIKUČIAI  (ALERG.)";9534206000;Taip;18;0;0;18
99;Aitvaras;"SAULĖS ZUIKUČIAI  (ALERG.)";3737054758;Taip;4;3;1;8
100;Aitvaras;"SAULĖS ZUIKUČIAI  (ALERG.)";4646876966;Taip;0;3;0;3
101;Aitvaras;"SAULĖS ZUIKUČIAI  (ALERG.)";9271534775;Taip;18;0;0;18
102;Aitvaras;"SAULĖS ZUIKUČIAI  (ALERG.)";8849563638;Taip;0;3;0;3
103;Aitvaras;"SAULĖS ZUIKUČIAI  (ALERG.)";6950820937;Taip;7;2;0;9
104;Aitvaras;"SAULĖS ZUIKUČIAI  (ALERG.)";5283056036;Taip;7;0;0;7
105;Aitvaras;"SAULĖS ZUIKUČIAI  (ALERG.)";5252728205;Taip;13;0;0;13
106;Aitvaras;"SAULĖS ZUIKUČIAI  (ALERG.)";2744696131;Taip;0;4;0;4
107;Aitvaras;"SAULĖS ZUIKUČIAI  (ALERG.)";2373509019;Taip;8;0;4;12
108;Aitvaras;"SAULĖS ZUIKUČIAI  (ALERG.)";2624566766;Taip;11;0;0;11
109;Aitvaras;"SAULĖS ZUIKUČIAI  (ALERG.)";3677551059;Ne;0;3;0;3
110;Aitvaras;"ŽEMYNUKAI (ALERG.)";8567255042;Ne;11;0;0;11
111;Aitvaras;"ŽEMYNUKAI (ALERG.)";6218019092;Taip;0;7;1;8
112;Aitvaras;"ŽEMYNUKAI (ALERG.)";7560642918;Taip;0;5;0;5
113;Aitvaras;"ŽEMYNUKAI (ALERG.)";3820930777;Taip;28;0;0;28
114;Aitvaras;"ŽEMYNUKAI (ALERG.)";6624986090;Taip;4;3;2;9
115;Aitvaras;"ŽEMYNUKAI (ALERG.)";4733627644;Taip;0;8;8;16
116;Aitvaras;"ŽEMYNUKAI (ALERG.)";3104109370;Taip;0;5;3;8
117;Aitvaras;"ŽEMYNUKAI (ALERG.)";7853714142;Taip;2;4;4;10
118;Aitvaras;"ŽEMYNUKAI (ALERG.)";1949144346;Taip;7;2;0;9
119;Aitvaras;"ŽEMYNUKAI (ALERG.)";8641433486;Taip;0;0;13;13
120;Aitvaras;"ŽEMYNUKAI (ALERG.)";3961423273;Taip;0;2;0;2
121;Aitvaras;"ŽEMYNUKAI (ALERG.)";9947610763;Taip;0;5;1;6
122;Aitvaras;"ŽEMYNUKAI (ALERG.)";7113016866;Taip;13;1;0;14
123;Aitvaras;"ŽEMYNUKAI (ALERG.)";4377666052;Taip;0;5;3;8
124;Aitvaras;"ŽEMYNUKAI (ALERG.)";8333823078;Taip;23;1;0;24
125;Aitvaras;"ŽEMYNUKAI (ALERG.)";5623106419;Taip;4;0;2;6
126;Aitvaras;"ŽEMYNUKAI (ALERG.)";5351333397;Taip;4;10;0;14
127;Aitvaras;"ŽEMYNUKAI (ALERG.)";2065988478;Taip;0;0;11;11
128;Aitvaras;"ŽEMYNUKAI (ALERG.)";3635354769;Taip;3;4;17;24
129;Aitvaras;"ŽEMYNUKAI (ALERG.)";3851322849;Taip;4;3;0;7
130;Aitvaras;"ŽEMYNUKAI (ALERG.)";7889947603;Taip;2;3;3;8
131;Aitvaras;"ŽEMYNUKAI (ALERG.)";1662289664;Taip;8;3;0;11
132;Aitvaras;"ŽEMYNUKAI (ALERG.)";2839442228;Taip;3;0;1;4
133;Aitvaras;"LINKSMUČIAI (ALERG.)";5238819066;Taip;0;2;0;2
134;Aitvaras;"LINKSMUČIAI (ALERG.)";7109001184;Taip;3;0;1;4
135;Aitvaras;"LINKSMUČIAI (ALERG.)";5378212904;Taip;21;0;0;21
136;Aitvaras;"LINKSMUČIAI (ALERG.)";3655710511;Taip;0;5;0;5
137;Aitvaras;"LINKSMUČIAI (ALERG.)";1091372798;Taip;1;6;1;8
138;Aitvaras;"LINKSMUČIAI (ALERG.)";8666824607;Taip;4;5;0;9
139;Aitvaras;"LINKSMUČIAI (ALERG.)";5612991255;Taip;0;4;0;4
140;Aitvaras;"LINKSMUČIAI (ALERG.)";7260577885;Taip;0;4;5;9
141;Aitvaras;"LINKSMUČIAI (ALERG.)";1599183050;Taip;3;0;4;7
142;Aitvaras;"LINKSMUČIAI (ALERG.)";1115202169;Taip;3;0;0;3
143;Aitvaras;"LINKSMUČIAI (ALERG.)";4613894944;Taip;0;2;3;5
144;Aitvaras;"LINKSMUČIAI (ALERG.)";2760970218;Taip;3;4;0;7
145;Aitvaras;"LINKSMUČIAI (ALERG.)";4120515569;Taip;10;10;2;22
146;Aitvaras;"LINKSMUČIAI (ALERG.)";9885781306;Taip;10;3;0;13
147;Aitvaras;"LINKSMUČIAI (ALERG.)";4564723798;Taip;5;0;5;10
148;Aitvaras;"LINKSMUČIAI (ALERG.)";4612994715;Taip;6;4;3;13
149;Aitvaras;"LINKSMUČIAI (ALERG.)";4176681907;Taip;0;17;0;17
150;Aitvaras;"LINKSMUČIAI (ALERG.)";6286268740;Taip;5;3;0;8
151;Aitvaras;"LINKSMUČIAI (ALERG.)";2547934790;Taip;6;6;0;12
152;Aitvaras;"LINKSMUČIAI (ALERG.)";2357399981;Taip;8;1;0;9
153;Aitvaras;"LINKSMUČIAI (ALERG.)";5572538840;Taip;15;3;0;18
154;Aitvaras;"LINKSMUČIAI (ALERG.)";4114397590;Taip;0;4;0;4
155;Aitvaras;NAMINUKAI;3053557807;Taip;7;4;0;11
156;Aitvaras;NAMINUKAI;6126913961;Taip;8;3;0;11
157;Aitvaras;NAMINUKAI;3347213578;Taip;0;4;3;7
158;Aitvaras;NAMINUKAI;9024245490;Taip;0;5;4;9
159;Aitvaras;NAMINUKAI;8512502118;Taip;0;3;0;3
160;Aitvaras;NAMINUKAI;1376605323;Taip;0;2;2;4
161;Aitvaras;NAMINUKAI;6060880045;Taip;0;2;2;4
162;Aitvaras;NAMINUKAI;9039303562;Taip;0;2;6;8
163;Aitvaras;NAMINUKAI;6080549524;Taip;0;2;6;8
164;Aitvaras;NAMINUKAI;6048701733;Taip;0;3;0;3
165;Aitvaras;NAMINUKAI;6110226958;Taip;0;0;4;4
166;Aitvaras;NAMINUKAI;4555281655;Taip;4;1;0;5
167;Aitvaras;NAMINUKAI;8043062737;Taip;0;5;0;5
168;Aitvaras;NAMINUKAI;3005447572;Taip;0;3;0;3
169;Aitvaras;NAMINUKAI;1549552392;Taip;5;3;0;8
170;Aitvaras;NAMINUKAI;4498792867;Taip;0;5;0;5
171;Aitvaras;NAMINUKAI;9490714865;Taip;0;7;0;7
172;Aitvaras;NAMINUKAI;1498630458;Taip;0;2;1;3
173;Aitvaras;NAMINUKAI;5967188507;Ne;0;2;4;6
174;Aitvaras;NAMINUKAI;5161069611;Taip;0;0;2;2
175;Aitvaras;NAMINUKAI;7934344218;Taip;0;2;1;3
176;Aitvaras;NAMINUKAI;6279152796;Taip;0;4;0;4
177;Aitvaras;ŠELMIAI;4984058405;Taip;0;14;0;14
178;Aitvaras;ŠELMIAI;9725401255;Taip;8;0;3;11
179;Aitvaras;ŠELMIAI;4547342872;Taip;1;3;0;4
180;Aitvaras;ŠELMIAI;5684526288;Taip;10;4;1;15
181;Aitvaras;ŠELMIAI;7764574135;Taip;5;1;0;6
182;Aitvaras;ŠELMIAI;5601517340;Taip;2;7;0;9
183;Aitvaras;ŠELMIAI;1019103539;Taip;5;6;0;11
184;Aitvaras;ŠELMIAI;2185746898;Taip;6;6;0;12
185;Aitvaras;ŠELMIAI;8756012613;Taip;0;3;0;3
186;Aitvaras;ŠELMIAI;1203732956;Taip;20;2;0;22
187;Aitvaras;ŠELMIAI;5782609781;Taip;11;2;1;14
188;Aitvaras;ŠELMIAI;7805819121;Taip;13;1;0;14
189;Aitvaras;ŠELMIAI;8558414510;Taip;11;0;0;11
190;Aitvaras;ŠELMIAI;4551774368;Taip;11;0;0;11
191;Aitvaras;ŠELMIAI;4158520145;Taip;0;1;0;1
192;Aitvaras;ŠELMIAI;7352233454;Taip;6;7;0;13
193;Aitvaras;ŠELMIAI;4812423010;Taip;0;8;2;10
194;Aitvaras;ŠELMIAI;8644983502;Taip;5;5;0;10
195;Aitvaras;ŠELMIAI;9295561516;Taip;0;5;0;5
196;Aitvaras;ŠELMIAI;6188186413;Taip;14;3;0;17
197;Aitvaras;ŠELMIAI;5886199823;Taip;0;0;1;1
198;Aitvaras;KODĖLČIUKAI;6214572150;Taip;18;4;0;22
199;Aitvaras;KODĖLČIUKAI;3323458595;Taip;0;3;1;4
200;Aitvaras;KODĖLČIUKAI;8065540507;Taip;4;6;4;14
201;Aitvaras;KODĖLČIUKAI;1288810999;Taip;9;0;1;10
202;Aitvaras;KODĖLČIUKAI;6501943902;Taip;0;9;0;9
203;Aitvaras;KODĖLČIUKAI;3101015381;Ne;0;0;2;2
204;Aitvaras;KODĖLČIUKAI;4350590529;Taip;0;7;0;7
205;Aitvaras;KODĖLČIUKAI;7777235021;Taip;8;2;1;11
206;Aitvaras;KODĖLČIUKAI;5641224483;Taip;0;4;0;4
207;Aitvaras;KODĖLČIUKAI;1830134108;Ne;0;11;1;12
208;Aitvaras;KODĖLČIUKAI;3178965623;Taip;0;4;0;4
209;Aitvaras;KODĖLČIUKAI;5905456814;Taip;0;2;0;2
210;Aitvaras;KODĖLČIUKAI;1761446849;Taip;3;0;0;3
211;Aitvaras;KODĖLČIUKAI;6739827530;Taip;9;0;2;11
212;Aitvaras;KODĖLČIUKAI;2807595769;Taip;6;3;0;9
213;Aitvaras;KODĖLČIUKAI;1252145346;Taip;0;0;8;8
214;Aitvaras;KODĖLČIUKAI;7455895024;Taip;0;1;0;1
215;Aitvaras;KODĖLČIUKAI;8439586875;Taip;5;5;2;12
216;Aitvaras;KODĖLČIUKAI;2328771385;Taip;18;4;0;22
217;Aitvaras;KODĖLČIUKAI;3735941659;Taip;0;0;1;1
218;Aitvaras;KODĖLČIUKAI;8360380303;Taip;0;2;1;3
219;Aitvaras;KODĖLČIUKAI;1594675221;Taip;0;2;5;7
220;Aitvaras;KODĖLČIUKAI;5922357091;Taip;5;5;0;10
221;Aitvaras;PABIRUČIAI;1495399113;Taip;9;2;0;11
222;Aitvaras;PABIRUČIAI;7136674662;Taip;0;3;0;3
223;Aitvaras;PABIRUČIAI;9949206639;Taip;13;0;0;13
224;Aitvaras;PABIRUČIAI;4613021421;Taip;4;1;0;5
225;Aitvaras;PABIRUČIAI;2887681961;Taip;4;10;0;14
226;Aitvaras;PABIRUČIAI;7922937851;Taip;6;1;0;7
227;Aitvaras;PABIRUČIAI;4085134058;Taip;7;2;0;9
228;Aitvaras;PABIRUČIAI;8746884740;Taip;13;0;0;13
229;Aitvaras;PABIRUČIAI;4163871634;Taip;0;5;0;5
230;Aitvaras;PABIRUČIAI;3988226974;Taip;0;5;0;5
231;Aitvaras;PABIRUČIAI;1070324386;Taip;3;0;0;3
232;Aitvaras;PABIRUČIAI;2239387580;Taip;2;2;1;5
233;Aitvaras;PABIRUČIAI;6119148164;Taip;0;2;9;11
234;Aitvaras;PABIRUČIAI;2892898328;Taip;9;4;0;13
235;Aitvaras;PABIRUČIAI;3749008647;Taip;0;2;1;3
236;Aitvaras;PABIRUČIAI;4760801928;Taip;14;0;0;14
237;Aitvaras;PABIRUČIAI;1599296739;Taip;3;1;9;13
238;Aitvaras;PABIRUČIAI;4987412561;Taip;9;0;0;9
239;Aitvaras;"SVAJOKLIAI  (ALERG.)";3429046261;Taip;3;1;0;4
240;Aitvaras;"SVAJOKLIAI  (ALERG.)";5659897032;Taip;18;0;0;18
241;Aitvaras;"SVAJOKLIAI  (ALERG.)";4618560397;Taip;0;2;0;2
242;Aitvaras;"SVAJOKLIAI  (ALERG.)";7745736525;Taip;3;0;1;4
243;Aitvaras;"SVAJOKLIAI  (ALERG.)";9209862610;Taip;15;0;1;16
244;Aitvaras;"SVAJOKLIAI  (ALERG.)";6191938291;Taip;7;0;3;10
245;Aitvaras;"SVAJOKLIAI  (ALERG.)";7006713502;Taip;9;3;0;12
246;Aitvaras;"SVAJOKLIAI  (ALERG.)";3923601422;Taip;5;5;1;11
247;Aitvaras;"SVAJOKLIAI  (ALERG.)";5790551266;Taip;0;5;1;6
248;Aitvaras;"SVAJOKLIAI  (ALERG.)";2975696317;Taip;15;0;0;15
249;Aitvaras;"SVAJOKLIAI  (ALERG.)";8965957442;Taip;0;0;13;13
250;Aitvaras;"SVAJOKLIAI  (ALERG.)";3891067128;Taip;5;3;1;9
251;Aitvaras;"SVAJOKLIAI  (ALERG.)";1030872812;Taip;10;4;0;14
252;Aitvaras;"SVAJOKLIAI  (ALERG.)";8352951885;Taip;11;0;0;11
253;Aitvaras;"SVAJOKLIAI  (ALERG.)";5255843693;Taip;8;0;0;8
254;Aitvaras;"SVAJOKLIAI  (ALERG.)";1448307414;Taip;5;0;1;6
255;Aitvaras;"SVAJOKLIAI  (ALERG.)";5593105541;Taip;6;3;0;9
256;Aitvaras;"SVAJOKLIAI  (ALERG.)";8963214183;Taip;11;0;0;11
257;Aitvaras;"SVAJOKLIAI  (ALERG.)";6319953077;Taip;5;1;0;6
258;Aitvaras;"SVAJOKLIAI  (ALERG.)";1131690624;Taip;10;2;0;12
259;Aitvaras;"SVAJOKLIAI  (ALERG.)";4801034095;Taip;6;4;0;10
260;Atžalėlės;Gėlytės;4284673729;Taip;0;11;7;18
261;Atžalėlės;Gėlytės;8695865604;Taip;10;3;0;13
262;Atžalėlės;Gėlytės;2385614957;Taip;6;3;0;9
263;Atžalėlės;Gėlytės;5432433423;Taip;0;11;0;11
264;Atžalėlės;Gėlytės;9715625283;Taip;0;3;0;3
265;Atžalėlės;Gėlytės;4682216852;Taip;0;0;3;3
266;Atžalėlės;Gėlytės;2131592139;Taip;5;4;0;9
267;Atžalėlės;Gėlytės;3191066669;Taip;12;0;0;12
268;Atžalėlės;Gėlytės;1500456945;Taip;0;0;7;7
269;Atžalėlės;Gėlytės;1722233272;Taip;0;10;0;10
270;Atžalėlės;Gėlytės;5310990513;Taip;0;3;0;3
271;Atžalėlės;Gėlytės;7702502252;Taip;4;8;0;12
272;Atžalėlės;Gėlytės;9189223222;Taip;0;11;0;11
273;Atžalėlės;Gėlytės;3283415814;Taip;0;5;0;5
274;Atžalėlės;Gėlytės;1146492807;Taip;0;0;9;9
275;Atžalėlės;Gėlytės;3870758086;Taip;0;0;3;3
276;Atžalėlės;Gėlytės;6202250600;Taip;0;0;6;6
277;Atžalėlės;Gėlytės;4098210138;Taip;0;0;3;3
278;Atžalėlės;Gėlytės;6177038838;Taip;0;4;0;4
279;Atžalėlės;Gėlytės;5742471497;Taip;0;5;2;7
280;Atžalėlės;Gėlytės;1137741059;Taip;10;0;3;13
281;Atžalėlės;Gėlytės;4238773173;Taip;0;3;3;6
282;Atžalėlės;Gėlytės;1036410428;Taip;5;2;0;7
283;Atžalėlės;Gėlytės;1450609695;Taip;0;5;0;5
284;Atžalėlės;Gėlytės;6597540627;Taip;0;0;5;5
285;Atžalėlės;Drugeliai;4643154006;Taip;0;3;0;3
286;Atžalėlės;Drugeliai;6903666624;Taip;5;3;0;8
287;Atžalėlės;Drugeliai;2315790531;Taip;4;3;0;7
288;Atžalėlės;Drugeliai;6782007470;Taip;0;13;0;13
289;Atžalėlės;Drugeliai;1805496887;Taip;5;3;3;11
290;Atžalėlės;Drugeliai;5417971068;Taip;0;5;0;5
291;Atžalėlės;Drugeliai;7953922166;Taip;7;3;0;10
292;Atžalėlės;Drugeliai;5147078840;Taip;0;6;0;6
293;Atžalėlės;Drugeliai;9222670655;Taip;0;5;0;5
294;Atžalėlės;Drugeliai;77261118958;Taip;0;4;3;7
295;Atžalėlės;Drugeliai;1429493246;Taip;0;6;0;6
296;Atžalėlės;Drugeliai;6114426973;Taip;0;12;0;12
297;Atžalėlės;Drugeliai;1456979448;Taip;0;10;0;10
298;Atžalėlės;Drugeliai;4032519781;Taip;0;8;0;8
299;Atžalėlės;Drugeliai;7756889911;Taip;0;3;0;3
300;Atžalėlės;Drugeliai;5063094678;Taip;0;3;0;3
301;Atžalėlės;Drugeliai;3422605135;Taip;0;3;0;3
302;Atžalėlės;Drugeliai;8718036014;Taip;13;3;0;16
303;Atžalėlės;Drugeliai;4884599397;Taip;13;3;0;16
304;Atžalėlės;Drugeliai;4902947406;Taip;0;3;2;5
305;Atžalėlės;Drugeliai;9463215947;Taip;0;2;0;2
306;Atžalėlės;Drugeliai;6570245757;Taip;0;2;3;5
307;Atžalėlės;Drugeliai;6695872204;Taip;0;7;0;7
308;Atžalėlės;Drugeliai;6393090675;Taip;0;4;0;4
309;Atžalėlės;Gandriukai;2083260403;Taip;0;7;0;7
310;Atžalėlės;Gandriukai;3692090073;Taip;8;0;1;9
311;Atžalėlės;Gandriukai;2078549599;Taip;0;0;4;4
312;Atžalėlės;Gandriukai;5119260525;Taip;0;0;4;4
313;Atžalėlės;Gandriukai;1024559742;Taip;3;0;0;3
314;Atžalėlės;Gandriukai;7510951079;Taip;0;7;0;7
315;Atžalėlės;Gandriukai;6594440062;Taip;18;0;0;18
316;Atžalėlės;Gandriukai;4293557144;Taip;0;14;0;14
317;Atžalėlės;Gandriukai;6211002805;Taip;0;0;1;1
318;Atžalėlės;Gandriukai;1305611902;Taip;0;0;4;4
319;Atžalėlės;Gandriukai;5102163688;Taip;15;0;0;15
320;Atžalėlės;Voveriukai;1865339755;Taip;0;3;0;3
321;Atžalėlės;Voveriukai;4467364336;Taip;0;3;2;5
322;Atžalėlės;Voveriukai;9699811980;Taip;5;0;1;6
323;Atžalėlės;Voveriukai;8847754477;Taip;0;12;0;12
324;Atžalėlės;Voveriukai;3795729265;Taip;0;0;3;3
325;Atžalėlės;Voveriukai;8201582382;Taip;0;3;3;6
326;Atžalėlės;Voveriukai;4362058013;Taip;0;3;3;6
327;Atžalėlės;Voveriukai;8819893830;Taip;0;3;9;12
328;Atžalėlės;Voveriukai;3069192413;Taip;5;0;4;9
329;Atžalėlės;Voveriukai;2067246260;Taip;0;3;9;12
330;Atžalėlės;Voveriukai;7532672266;Taip;0;3;6;9
331;Atžalėlės;Voveriukai;5705303891;Taip;0;9;0;9
332;Atžalėlės;Voveriukai;5650427433;Taip;0;3;0;3
333;Atžalėlės;Voveriukai;1316154666;Taip;0;3;1;4
334;Atžalėlės;Voveriukai;6975941393;Taip;0;2;1;3
335;Atžalėlės;Voveriukai;8138683218;Taip;5;0;0;5
336;Atžalėlės;Voveriukai;7689394485;Taip;0;3;2;5
337;Atžalėlės;Voveriukai;1804802235;Taip;0;3;0;3
338;Atžalėlės;Voveriukai;2662384275;Taip;0;1;0;1
339;Atžalėlės;Voveriukai;4996777116;Taip;0;3;0;3
340;Atžalėlės;Voveriukai;1426744251;Taip;0;5;0;5
341;Atžalėlės;Voveriukai;6684979914;Taip;7;3;1;11
342;Atžalėlės;Voveriukai;8470059012;Ne;0;3;4;7
343;Atžalėlės;Voveriukai;5767549779;Taip;0;1;1;2
344;Atžalėlės;Žirniukai;2374624441;Taip;5;3;0;8
345;Atžalėlės;Žirniukai;9707462467;Taip;5;0;3;8
346;Atžalėlės;Žirniukai;5584105084;Taip;3;0;2;5
347;Atžalėlės;Žirniukai;9677943321;Taip;0;0;3;3
348;Atžalėlės;Žirniukai;9967641617;Taip;10;3;0;13
349;Atžalėlės;Žirniukai;9508110719;Taip;0;0;3;3
350;Atžalėlės;Žirniukai;9085453655;Taip;5;5;0;10
351;Atžalėlės;Žirniukai;1538643591;Taip;0;14;4;18
352;Atžalėlės;Žirniukai;3143856911;Taip;0;10;0;10
353;Atžalėlės;Žirniukai;1212074068;Taip;12;4;0;16
354;Atžalėlės;Žirniukai;9736390705;Taip;7;0;0;7
355;Atžalėlės;Žirniukai;4661388894;Taip;15;0;1;16
356;Atžalėlės;Žirniukai;5319794176;Taip;4;0;1;5
357;Atžalėlės;Žirniukai;7196464328;Taip;0;6;0;6
358;Atžalėlės;Žirniukai;6723689098;Taip;0;3;0;3
359;Atžalėlės;Žirniukai;9281138840;Taip;0;7;0;7
360;Atžalėlės;Žirniukai;7018297883;Taip;0;2;2;4
361;Atžalėlės;Ežiukai;4227804985;Taip;0;5;0;5
362;Atžalėlės;Ežiukai;9053620501;Taip;9;0;1;10
363;Atžalėlės;Ežiukai;9054589111;Taip;9;3;0;12
364;Atžalėlės;Ežiukai;9346744866;Taip;4;7;0;11
365;Atžalėlės;Ežiukai;1505286928;Taip;13;4;0;17
366;Atžalėlės;Ežiukai;4148412941;Taip;8;0;6;14
367;Atžalėlės;Ežiukai;3333808381;Taip;7;0;0;7
368;Atžalėlės;Ežiukai;1710646812;Taip;4;2;3;9
369;Atžalėlės;Ežiukai;9481268935;Taip;5;0;1;6
370;Atžalėlės;Ežiukai;6447615639;Taip;8;3;0;11
371;Atžalėlės;Ežiukai;5972419628;Taip;8;3;0;11
372;Atžalėlės;Ežiukai;3738127350;Taip;0;3;4;7
373;Atžalėlės;Ežiukai;1423254771;Taip;13;0;2;15
374;Atžalėlės;Ežiukai;1614261572;Taip;0;7;0;7
375;Atžalėlės;Ežiukai;6665199013;Taip;0;4;0;4
376;Atžalėlės;Ežiukai;8145965849;Taip;6;0;0;6
377;Atžalėlės;Ežiukai;6108989129;Taip;4;0;0;4
378;Atžalėlės;Ežiukai;5174826594;Taip;3;0;0;3
379;Atžalėlės;Ežiukai;7501772398;Taip;1;0;6;7
380;Atžalėlės;Paukšteliai;7807313362;Taip;0;2;3;5
381;Atžalėlės;Paukšteliai;6537864486;Taip;3;6;0;9
382;Atžalėlės;Paukšteliai;8768704484;Taip;0;1;4;5
383;Atžalėlės;Paukšteliai;6675588261;Taip;4;1;2;7
384;Atžalėlės;Paukšteliai;8524244526;Taip;10;2;0;12
385;Atžalėlės;Paukšteliai;6873507667;Taip;0;3;0;3
386;Atžalėlės;Paukšteliai;7321516783;Taip;10;0;0;10
387;Atžalėlės;Paukšteliai;6265777690;Taip;0;4;0;4
388;Atžalėlės;Paukšteliai;1844980319;Taip;10;0;0;10
389;Atžalėlės;Paukšteliai;5997958773;Taip;0;1;0;1
390;Atžalėlės;Paukšteliai;8512283024;Taip;5;0;1;6
391;Atžalėlės;Paukšteliai;2078781673;Taip;5;1;2;8
392;Atžalėlės;Paukšteliai;1520206753;Taip;15;3;0;18
393;Atžalėlės;Paukšteliai;4790322154;Taip;9;6;0;15
394;Atžalėlės;Paukšteliai;4081717007;Taip;5;3;0;8
395;Atžalėlės;Paukšteliai;1089221288;Taip;5;0;0;5
396;Atžalėlės;Paukšteliai;7356877676;Taip;0;5;0;5
397;Atžalėlės;Paukšteliai;4392352210;Taip;3;0;2;5
398;Atžalėlės;Paukšteliai;1774212280;Taip;14;2;0;16
399;Atžalėlės;Meškiukai;8586739429;Taip;0;0;1;1
400;Atžalėlės;Meškiukai;9925178685;Taip;0;0;4;4
401;Atžalėlės;Meškiukai;2617568019;Taip;3;3;3;9
402;Atžalėlės;Meškiukai;4233689945;Taip;7;0;1;8
403;Atžalėlės;Meškiukai;8619613890;Taip;0;1;8;9
404;Atžalėlės;Meškiukai;3281114596;Taip;0;14;0;14
405;Atžalėlės;Meškiukai;5466374223;Taip;0;0;5;5
406;Atžalėlės;Meškiukai;2433029299;Taip;6;0;5;11
407;Atžalėlės;Meškiukai;5682652546;Taip;0;0;7;7
408;Atžalėlės;Meškiukai;9631336340;Taip;9;3;0;12
409;Atžalėlės;Meškiukai;2930612059;Ne;0;4;14;18
410;Atžalėlės;Meškiukai;6385777303;Ne;5;0;5;10
411;Atžalėlės;Meškiukai;2569491645;Taip;0;4;0;4
412;Atžalėlės;Meškiukai;1431197358;Taip;0;13;0;13
413;Atžalėlės;Meškiukai;4177753994;Taip;0;0;4;4
414;Atžalėlės;Meškiukai;3982090601;Taip;15;0;3;18
415;Atžalėlės;Meškiukai;3743308789;Taip;0;3;5;8
416;Atžalėlės;Meškiukai;2228759708;Taip;4;0;8;12
417;Atžalėlės;Meškiukai;7936991925;Taip;3;0;1;4
418;Atžalėlės;Meškiukai;8976815736;Taip;0;1;0;1
419;Atžalėlės;"BITUTĖS (MODULINĖ)";8707875125;Taip;18;0;0;18
420;Atžalėlės;"BITUTĖS (MODULINĖ)";8060332402;Taip;0;0;2;2
421;Atžalėlės;"BITUTĖS (MODULINĖ)";8396693160;Taip;0;2;1;3
422;Atžalėlės;"BITUTĖS (MODULINĖ)";6253257539;Taip;5;0;7;12
423;Atžalėlės;"BITUTĖS (MODULINĖ)";7052938312;Taip;0;3;1;4
424;Atžalėlės;"BITUTĖS (MODULINĖ)";3559977339;Taip;3;0;3;6
425;Atžalėlės;"BITUTĖS (MODULINĖ)";5593774275;Taip;10;3;2;15
426;Atžalėlės;"BITUTĖS (MODULINĖ)";8129858229;Taip;0;2;0;2
427;Atžalėlės;"BITUTĖS (MODULINĖ)";1939076303;Ne;5;0;1;6
428;Atžalėlės;"BITUTĖS (MODULINĖ)";2322329918;Taip;0;0;6;6
429;Atžalėlės;"BITUTĖS (MODULINĖ)";6368553568;Taip;0;4;0;4
430;Atžalėlės;"BITUTĖS (MODULINĖ)";5148142239;Taip;0;0;8;8
431;Atžalėlės;"ŠYPSENĖLĖS (MODULINĖ)";4071402757;Taip;8;0;0;8
432;Atžalėlės;"ŠYPSENĖLĖS (MODULINĖ)";1943349835;Taip;0;2;0;2
433;Atžalėlės;"ŠYPSENĖLĖS (MODULINĖ)";8564143904;Taip;5;0;10;15
434;Atžalėlės;"ŠYPSENĖLĖS (MODULINĖ)";2298114905;Taip;0;3;0;3
435;Atžalėlės;"ŠYPSENĖLĖS (MODULINĖ)";3299724612;Taip;4;2;0;6
436;Atžalėlės;"BORUŽIUKAI (MODULINĖ)";3198845538;Taip;0;1;0;1
437;Atžalėlės;"BORUŽIUKAI (MODULINĖ)";8681809797;Taip;11;0;0;11
438;Atžalėlės;"BORUŽIUKAI (MODULINĖ)";3590987364;Taip;13;0;0;13
439;Atžalėlės;"BORUŽIUKAI (MODULINĖ)";1383944713;Taip;8;0;1;9
440;Atžalėlės;"BORUŽIUKAI (MODULINĖ)";5582697993;Taip;8;3;0;11
441;Atžalėlės;"BORUŽIUKAI (MODULINĖ)";9201449702;Taip;9;0;3;12
442;Atžalėlės;"BORUŽIUKAI (MODULINĖ)";7980775632;Taip;3;13;0;16
443;Atžalėlės;"SAULUTĖS (MODULINĖ)";4268941401;Taip;0;0;17;17
444;Atžalėlės;"SAULUTĖS (MODULINĖ)";1797932125;Taip;2;3;0;5
445;Atžalėlės;"SAULUTĖS (MODULINĖ)";2306086573;Ne;0;0;2;2
446;Atžalėlės;"SAULUTĖS (MODULINĖ)";8385741531;Taip;17;0;1;18
447;Atžalėlės;"SAULUTĖS (MODULINĖ)";8460997063;Taip;5;3;0;8
448;Atžalėlės;"SAULUTĖS (MODULINĖ)";8490088667;Taip;5;0;1;6
449;Atžalėlės;"SAULUTĖS (MODULINĖ)";5490741021;Taip;3;3;0;6
450;Atžalėlės;"SAULUTĖS (MODULINĖ)";8208908249;Taip;10;3;1;14
451;Atžalėlės;"SAULUTĖS (MODULINĖ)";6048763811;Taip;11;0;5;16
452;Aušrelė;PASAKIUKAI;1659335142;Taip;0;6;0;6
453;Aušrelė;PASAKIUKAI;2974714806;Taip;0;3;0;3
454;Aušrelė;PASAKIUKAI;1327431679;Taip;3;3;0;6
455;Aušrelė;PASAKIUKAI;6037757548;Taip;3;3;1;7
456;Aušrelė;PASAKIUKAI;7682402576;Taip;0;3;0;3
457;Aušrelė;PASAKIUKAI;1408751702;Taip;0;6;0;6
458;Aušrelė;PASAKIUKAI;6995749373;Taip;0;3;0;3
459;Aušrelė;PASAKIUKAI;8372554796;Taip;0;3;0;3
460;Aušrelė;PASAKIUKAI;1502146844;Taip;0;5;0;5
461;Aušrelė;PASAKIUKAI;8341539501;Taip;0;3;0;3
462;Aušrelė;PASAKIUKAI;8230362307;Taip;0;3;1;4
463;Aušrelė;PASAKIUKAI;4306578299;Taip;4;4;0;8
464;Aušrelė;PASAKIUKAI;5777214701;Taip;0;6;0;6
465;Aušrelė;PASAKIUKAI;6277405405;Taip;0;9;0;9
466;Aušrelė;PASAKIUKAI;3682523696;Taip;0;2;0;2
467;Aušrelė;PASAKIUKAI;34891640909;Taip;13;5;0;18
468;Aušrelė;PASAKIUKAI;2125080379;Taip;0;3;0;3
469;Aušrelė;PASAKIUKAI;3165692699;Taip;0;3;0;3
470;Aušrelė;BORUŽĖLĖS;6673034329;Taip;0;5;0;5
471;Aušrelė;BORUŽĖLĖS;4957581753;Taip;0;5;0;5
472;Aušrelė;BORUŽĖLĖS;1928260563;Taip;0;8;0;8
473;Aušrelė;BORUŽĖLĖS;8243716759;Taip;0;5;2;7
474;Aušrelė;BORUŽĖLĖS;1549962200;Taip;0;5;0;5
475;Aušrelė;BORUŽĖLĖS;4505922394;Taip;0;3;2;5
476;Aušrelė;BORUŽĖLĖS;7190665397;Taip;0;3;2;5
477;Aušrelė;BORUŽĖLĖS;2991828434;Taip;0;1;0;1
478;Aušrelė;BORUŽĖLĖS;5358315970;Taip;5;3;0;8
479;Aušrelė;BORUŽĖLĖS;8030685444;Taip;3;5;0;8
480;Aušrelė;BORUŽĖLĖS;1814972981;Taip;5;4;2;11
481;Aušrelė;BORUŽĖLĖS;3397741232;Taip;0;11;0;11
482;Aušrelė;SMALSUČIAI;6761263775;Taip;6;4;0;10
483;Aušrelė;SMALSUČIAI;3015028879;Taip;0;18;0;18
484;Aušrelė;SMALSUČIAI;5935579452;Taip;0;4;0;4
485;Aušrelė;SMALSUČIAI;2863655361;Taip;0;4;0;4
486;Aušrelė;SMALSUČIAI;2390128933;Taip;0;3;0;3
487;Aušrelė;SMALSUČIAI;8503309819;Taip;0;1;0;1
488;Aušrelė;SMALSUČIAI;2827216981;Taip;0;3;0;3
489;Aušrelė;SMALSUČIAI;9443641849;Taip;0;4;0;4
490;Aušrelė;SMALSUČIAI;7930717076;Taip;5;3;0;8
491;Aušrelė;SMALSUČIAI;7609339123;Taip;8;3;0;11
492;Aušrelė;SMALSUČIAI;1556010005;Taip;0;3;0;3
493;Aušrelė;SMALSUČIAI;5478028396;Taip;0;5;0;5
494;Aušrelė;SMALSUČIAI;7070013052;Taip;11;1;0;12
495;Aušrelė;SMALSUČIAI;3581155949;Taip;0;5;1;6
496;Aušrelė;SMALSUČIAI;6507218940;Taip;0;4;0;4
497;Aušrelė;SMALSUČIAI;2266390402;Taip;0;5;4;9
498;Aušrelė;SMALSUČIAI;8032661062;Taip;0;3;2;5
499;Aušrelė;SMALSUČIAI;4262596104;Taip;0;3;0;3
500;Aušrelė;SMALSUČIAI;1976613166;Taip;0;3;0;3
501;Aušrelė;KODĖLČIUKAI;7723159748;Taip;3;3;0;6
502;Aušrelė;KODĖLČIUKAI;7367268748;Taip;0;4;0;4
503;Aušrelė;KODĖLČIUKAI;5712867880;Taip;5;1;0;6
504;Aušrelė;KODĖLČIUKAI;3623813061;Taip;0;8;0;8
505;Aušrelė;KODĖLČIUKAI;4288695809;Taip;0;3;0;3
506;Aušrelė;KODĖLČIUKAI;8693750994;Taip;0;5;0;5
507;Aušrelė;KODĖLČIUKAI;7327544406;Taip;0;3;0;3
508;Aušrelė;KODĖLČIUKAI;9566144610;Taip;0;3;0;3
509;Aušrelė;KODĖLČIUKAI;6308519574;Taip;0;2;0;2
510;Aušrelė;KODĖLČIUKAI;6186758486;Taip;0;7;1;8
511;Aušrelė;KODĖLČIUKAI;3320399046;Taip;10;4;0;14
512;Aušrelė;KODĖLČIUKAI;6911735462;Taip;29;0;0;29
513;Aušrelė;KODĖLČIUKAI;4248808572;Taip;6;18;0;24
514;Aušrelė;KODĖLČIUKAI;8338569001;Taip;0;5;3;8
515;Aušrelė;KODĖLČIUKAI;2766357229;Taip;4;3;0;7
516;Aušrelė;KODĖLČIUKAI;7515666888;Taip;0;3;0;3
517;Aušrelė;KODĖLČIUKAI;8862488358;Taip;7;3;0;10
518;Aušrelė;KODĖLČIUKAI;4882556718;Taip;0;1;0;1
519;Aušrelė;KODĖLČIUKAI;6321332888;Taip;0;4;1;5
520;Aušrelė;PELĖDŽIUKAI;6109859056;Taip;0;1;0;1
521;Aušrelė;PELĖDŽIUKAI;4725588671;Taip;5;3;0;8
522;Aušrelė;PELĖDŽIUKAI;3223092149;Taip;0;15;0;15
523;Aušrelė;PELĖDŽIUKAI;8580241126;Taip;0;1;0;1
524;Aušrelė;PELĖDŽIUKAI;2545065554;Taip;11;0;0;11
525;Aušrelė;PELĖDŽIUKAI;4227228548;Taip;0;1;0;1
526;Aušrelė;PELĖDŽIUKAI;8996445434;Taip;0;1;1;2
527;Aušrelė;PELĖDŽIUKAI;8411336992;Taip;0;2;7;9
528;Aušrelė;PELĖDŽIUKAI;8917907028;Taip;4;3;0;7
529;Aušrelė;PELĖDŽIUKAI;7494298336;Taip;0;4;0;4
530;Aušrelė;PELĖDŽIUKAI;4012186237;Taip;0;3;8;11
531;Aušrelė;PELĖDŽIUKAI;3738923947;Taip;4;0;0;4
532;Aušrelė;PELĖDŽIUKAI;5312189552;Taip;0;6;0;6
533;Aušrelė;PELĖDŽIUKAI;1642358593;Ne;0;3;0;3
534;Aušrelė;PELĖDŽIUKAI;2294224426;Taip;0;3;1;4
535;Aušrelė;AITVARIUKAI;6833654667;Taip;8;0;0;8
536;Aušrelė;AITVARIUKAI;8102749675;Taip;0;10;0;10
537;Aušrelė;AITVARIUKAI;4595435635;Taip;8;3;0;11
538;Aušrelė;AITVARIUKAI;9608444990;Taip;0;3;0;3
539;Aušrelė;AITVARIUKAI;6434548772;Taip;11;3;0;14
540;Aušrelė;AITVARIUKAI;9158248746;Taip;3;2;1;6
541;Aušrelė;AITVARIUKAI;7978186455;Taip;0;18;0;18
542;Aušrelė;AITVARIUKAI;5602774323;Taip;1;0;0;1
543;Aušrelė;AITVARIUKAI;5708459561;Taip;0;3;2;5
544;Aušrelė;AITVARIUKAI;1039180129;Taip;0;8;0;8
545;Aušrelė;AITVARIUKAI;5125295651;Taip;0;7;0;7
546;Aušrelė;AITVARIUKAI;3807967685;Taip;0;2;1;3
547;Aušrelė;AITVARIUKAI;6081100604;Taip;15;3;0;18
548;Aušrelė;AITVARIUKAI;7847650967;Taip;0;4;0;4
549;Aušrelė;AITVARIUKAI;5727081833;Taip;0;6;0;6
550;Aušrelė;AITVARIUKAI;8210698019;Taip;0;18;0;18
551;Aušrelė;AITVARIUKAI;4942168388;Taip;0;18;0;18
552;Aušrelė;AITVARIUKAI;7788139791;Taip;0;1;0;1
553;Aušrelė;BITUTĖS;1741716341;Taip;0;18;0;18
554;Aušrelė;BITUTĖS;4989544273;Taip;11;3;0;14
555;Aušrelė;BITUTĖS;9960201865;Taip;5;3;0;8
556;Aušrelė;BITUTĖS;2071674661;Ne;0;17;0;17
557;Aušrelė;BITUTĖS;1450827353;Taip;0;1;0;1
558;Aušrelė;BITUTĖS;5598494461;Taip;0;3;1;4
559;Aušrelė;BITUTĖS;4935192851;Ne;0;5;0;5
560;Aušrelė;BITUTĖS;9505496063;Ne;0;6;0;6
561;Aušrelė;BITUTĖS;1931955562;Taip;0;3;1;4
562;Aušrelė;BITUTĖS;5614774250;Ne;0;3;0;3
563;Aušrelė;BITUTĖS;6591538425;Taip;0;18;0;18
564;Aušrelė;BITUTĖS;8203256528;Taip;0;18;0;18
565;Aušrelė;BITUTĖS;5741252819;Taip;0;18;0;18
566;Aušrelė;BITUTĖS;1243825974;Taip;0;6;0;6
567;Aušrelė;BITUTĖS;2468245186;Taip;0;3;0;3
568;Aušrelė;BITUTĖS;5266959731;Taip;0;3;0;3
569;Aušrelė;ŽIRNIUKAI;1949809977;Taip;5;3;0;8
570;Aušrelė;ŽIRNIUKAI;9733877752;Taip;0;6;0;6
571;Aušrelė;ŽIRNIUKAI;8542012622;Taip;5;3;0;8
572;Aušrelė;ŽIRNIUKAI;2221714044;Taip;5;1;0;6
573;Aušrelė;ŽIRNIUKAI;1544869163;Taip;8;2;0;10
574;Aušrelė;ŽIRNIUKAI;6577540623;Taip;12;3;0;15
575;Aušrelė;ŽIRNIUKAI;5460833944;Taip;12;4;0;16
576;Aušrelė;ŽIRNIUKAI;6372004855;Taip;5;4;0;9
577;Aušrelė;ŽIRNIUKAI;3713528812;Taip;5;3;0;8
578;Aušrelė;ŽIRNIUKAI;2107898976;Taip;7;5;0;12
579;Aušrelė;ŽIRNIUKAI;1607338052;Taip;5;3;0;8
580;Aušrelė;ŽIRNIUKAI;8573348956;Taip;0;18;0;18
581;Aušrelė;ŽIRNIUKAI;6463141345;Taip;0;4;0;4
582;Aušrelė;ŽIRNIUKAI;1798478023;Ne;7;0;0;7
583;Aušrelė;ŽIRNIUKAI;1754138341;Taip;7;6;0;13
584;Aušrelė;ŽIRNIUKAI;6913824678;Taip;8;3;0;11
585;Aušrelė;ŽIRNIUKAI;8797157671;Taip;6;1;0;7
586;Aušrelė;ŽIRNIUKAI;4591518039;Taip;0;3;0;3
587;Aušrelė;GRYBUKAI;9938762910;Taip;4;1;0;5
588;Aušrelė;GRYBUKAI;1463724119;Taip;8;5;0;13
589;Aušrelė;GRYBUKAI;8438945369;Taip;0;14;0;14
590;Aušrelė;GRYBUKAI;6672975558;Taip;6;0;0;6
591;Aušrelė;GRYBUKAI;4565813136;Taip;3;3;0;6
592;Aušrelė;GRYBUKAI;9877307844;Taip;6;3;0;9
593;Aušrelė;GRYBUKAI;8947695521;Taip;5;3;0;8
594;Aušrelė;GRYBUKAI;7130040621;Taip;0;3;0;3
595;Aušrelė;GRYBUKAI;2311552230;Taip;0;3;0;3
596;Aušrelė;GRYBUKAI;1458580523;Taip;12;0;0;12
597;Aušrelė;GRYBUKAI;1871799626;Taip;15;3;0;18
598;Aušrelė;GRYBUKAI;5733298006;Taip;19;3;0;22
599;Aušrelė;GRYBUKAI;4924950592;Taip;5;2;3;10
600;Aušrelė;GRYBUKAI;8126701466;Taip;0;1;0;1
601;Aušrelė;GRYBUKAI;2466858636;Taip;11;7;0;18
602;Aušrelė;GRYBUKAI;2873845920;Taip;0;2;0;2
603;Aušrelė;GRYBUKAI;5904797250;Taip;18;0;0;18
604;Aušrelė;DRUGELIAI;9763241451;Ne;0;0;3;3
605;Aušrelė;DRUGELIAI;1209824814;Taip;0;3;0;3
606;Aušrelė;DRUGELIAI;7948024164;Taip;5;3;0;8
607;Aušrelė;DRUGELIAI;5429867368;Ne;0;6;0;6
608;Aušrelė;DRUGELIAI;3831695455;Ne;8;10;0;18
609;Aušrelė;DRUGELIAI;2737402297;Ne;7;3;0;10
610;Aušrelė;DRUGELIAI;4254737302;Taip;11;0;0;11
611;Aušrelė;DRUGELIAI;4464947621;Taip;10;3;1;14
612;Aušrelė;DRUGELIAI;9126040500;Taip;8;3;0;11
613;Aušrelė;DRUGELIAI;7286960315;Taip;5;8;1;14
614;Aušrelė;DRUGELIAI;8102293098;Taip;7;3;0;10
615;Aušrelė;DRUGELIAI;2266835623;Taip;11;3;0;14
616;Aušrelė;DRUGELIAI;1094141305;Taip;10;3;0;13
617;Aušrelė;DRUGELIAI;9514049590;Taip;0;3;4;7
618;Aušrelė;DRUGELIAI;5709799539;Taip;9;0;2;11
619;Aušrelė;DRUGELIAI;8724802289;Taip;5;0;1;6
620;Aušrelė;DRUGELIAI;5815844340;Ne;5;3;0;8
621;Aušrelė;NYKŠTUKAI;9914518299;Taip;3;3;0;6
622;Aušrelė;NYKŠTUKAI;8427699400;Taip;3;2;0;5
623;Aušrelė;NYKŠTUKAI;4297417711;Taip;6;3;0;9
624;Aušrelė;NYKŠTUKAI;4004600465;Taip;0;9;0;9
625;Aušrelė;NYKŠTUKAI;7964156691;Taip;0;9;0;9
626;Aušrelė;NYKŠTUKAI;7140465960;Taip;3;4;0;7
627;Aušrelė;NYKŠTUKAI;7937067384;Taip;0;1;0;1
628;Aušrelė;NYKŠTUKAI;8099338305;Taip;5;0;0;5
629;Aušrelė;NYKŠTUKAI;4282189556;Taip;0;9;0;9
630;Aušrelė;NYKŠTUKAI;8378225406;Taip;0;13;0;13
631;Aušrelė;NYKŠTUKAI;5018495543;Taip;5;0;0;5
632;Aušrelė;NYKŠTUKAI;3259828075;Taip;0;5;0;5
633;Aušrelė;NYKŠTUKAI;4952876188;Taip;3;0;0;3
634;Aušrelė;SPINDULIUKAI;8848358559;Taip;8;0;0;8
635;Aušrelė;SPINDULIUKAI;3194122285;Taip;0;18;0;18
636;Aušrelė;SPINDULIUKAI;5358736178;Taip;5;1;1;7
637;Aušrelė;SPINDULIUKAI;2857158437;Taip;0;8;0;8
638;Aušrelė;SPINDULIUKAI;5801943729;Taip;0;3;0;3
639;Aušrelė;SPINDULIUKAI;8801906679;Taip;0;3;5;8
640;Aušrelė;SPINDULIUKAI;7208341200;Ne;0;18;0;18
641;Aušrelė;SPINDULIUKAI;1446194971;Taip;0;8;0;8
642;Aušrelė;SPINDULIUKAI;9251919940;Taip;0;0;18;18
643;Aušrelė;SPINDULIUKAI;8997650487;Taip;0;3;2;5
644;Aušrelė;SPINDULIUKAI;1805615293;Taip;0;5;3;8
645;Aušrelė;SPINDULIUKAI;7966060521;Taip;0;5;0;5
646;Aušrelė;SPINDULIUKAI;6418762623;Taip;0;1;0;1
647;Aušrelė;SPINDULIUKAI;8835689988;Ne;3;9;0;12
648;Aušrelė;SPINDULIUKAI;5274919078;Taip;0;2;0;2
649;Aušrelė;SPINDULIUKAI;2981314491;Taip;0;5;0;5
650;Aušrelė;SPINDULIUKAI;2441221298;Taip;0;18;0;18
651;Beržynėlis;SVIRPLIUKAI;7360345539;Taip;4;0;0;4
652;Beržynėlis;SVIRPLIUKAI;4134371415;Taip;0;4;0;4
653;Beržynėlis;SVIRPLIUKAI;7278860816;Taip;0;4;0;4
654;Beržynėlis;SVIRPLIUKAI;4013099670;Taip;9;5;0;14
655;Beržynėlis;SVIRPLIUKAI;8404801225;Taip;0;1;0;1
656;Beržynėlis;SVIRPLIUKAI;8303684788;Taip;0;3;0;3
657;Beržynėlis;SVIRPLIUKAI;7953957525;Taip;0;5;0;5
658;Beržynėlis;SVIRPLIUKAI;3841363368;Taip;1;1;0;2
659;Beržynėlis;SVIRPLIUKAI;3418730586;Taip;0;3;0;3
660;Beržynėlis;SVIRPLIUKAI;1468551784;Taip;0;6;0;6
661;Beržynėlis;SVIRPLIUKAI;2221708263;Taip;4;3;0;7
662;Beržynėlis;SVIRPLIUKAI;8880151537;Taip;0;2;0;2
663;Beržynėlis;SVIRPLIUKAI;6516665294;Taip;0;3;0;3
664;Beržynėlis;SVIRPLIUKAI;9580286493;Taip;0;3;0;3
665;Beržynėlis;SVIRPLIUKAI;6673910279;Taip;7;0;0;7
666;Beržynėlis;SVIRPLIUKAI;8701990625;Taip;0;3;0;3
667;Beržynėlis;SVIRPLIUKAI;5027712732;Taip;4;3;0;7
668;Beržynėlis;SVIRPLIUKAI;7555487759;Taip;0;3;0;3
669;Beržynėlis;SVIRPLIUKAI;7788532819;Taip;17;0;0;17
670;Beržynėlis;SVIRPLIUKAI;3315079004;Taip;8;3;0;11
671;Beržynėlis;SVIRPLIUKAI;8533912024;Taip;15;3;0;18
672;Beržynėlis;PELEDŽIUKAI;3278699117;Taip;0;2;1;3
673;Beržynėlis;PELEDŽIUKAI;1516309509;Taip;0;5;0;5
674;Beržynėlis;PELEDŽIUKAI;1395819329;Taip;0;0;5;5
675;Beržynėlis;PELEDŽIUKAI;1838631438;Taip;0;0;3;3
676;Beržynėlis;PELEDŽIUKAI;1682929565;Taip;0;3;3;6
677;Beržynėlis;PELEDŽIUKAI;7248602510;Taip;0;2;2;4
678;Beržynėlis;PELEDŽIUKAI;2681482042;Taip;0;0;3;3
679;Beržynėlis;PELEDŽIUKAI;5196910604;Taip;0;2;0;2
680;Beržynėlis;PELEDŽIUKAI;7649359221;Taip;0;2;0;2
681;Beržynėlis;PELEDŽIUKAI;6395436937;Taip;0;4;0;4
682;Beržynėlis;PELEDŽIUKAI;3641421009;Taip;0;0;3;3
683;Beržynėlis;PELEDŽIUKAI;2791734213;Taip;1;2;1;4
684;Beržynėlis;PELEDŽIUKAI;1136091326;Taip;0;0;1;1
685;Beržynėlis;PELEDŽIUKAI;71505149611;Taip;0;13;0;13
686;Beržynėlis;PELEDŽIUKAI;1639928056;Taip;0;2;1;3
687;Beržynėlis;PELEDŽIUKAI;1176943273;Taip;0;3;0;3
688;Beržynėlis;PELEDŽIUKAI;7929997884;Taip;0;7;1;8
689;Beržynėlis;PELEDŽIUKAI;8688852668;Taip;0;3;0;3
690;Beržynėlis;ŽIOGELIAI;5308596559;Taip;0;4;0;4
691;Beržynėlis;ŽIOGELIAI;4035764376;Taip;0;3;0;3
692;Beržynėlis;ŽIOGELIAI;4970999989;Taip;0;1;0;1
693;Beržynėlis;ŽIOGELIAI;1325972861;Taip;6;3;5;14
694;Beržynėlis;ŽIOGELIAI;9088059487;Taip;1;3;0;4
695;Beržynėlis;ŽIOGELIAI;5473666098;Taip;0;3;0;3
696;Beržynėlis;ŽIOGELIAI;8591800387;Taip;0;4;0;4
697;Beržynėlis;ŽIOGELIAI;6739927917;Taip;0;5;0;5
698;Beržynėlis;ŽIOGELIAI;2971686368;Taip;0;3;0;3
699;Beržynėlis;ŽIOGELIAI;9409317403;Taip;9;3;0;12
700;Beržynėlis;ŽIOGELIAI;9305279614;Taip;0;3;3;6
701;Beržynėlis;ŽIOGELIAI;9511051386;Taip;8;3;0;11
702;Beržynėlis;ŽIOGELIAI;8114761925;Taip;3;3;0;6
703;Beržynėlis;ŽIOGELIAI;5856519538;Taip;0;6;0;6
704;Beržynėlis;ŽIOGELIAI;3339522259;Taip;0;3;0;3
705;Beržynėlis;ŽIOGELIAI;6337962165;Taip;0;3;0;3
706;Beržynėlis;ŽIOGELIAI;6864823739;Taip;0;5;9;14
707;Beržynėlis;ŽIOGELIAI;9896122318;Taip;0;3;1;4
708;Beržynėlis;ŽIOGELIAI;6837130893;Taip;0;0;9;9
709;Beržynėlis;ŽIOGELIAI;3484188772;Ne;2;5;0;7
710;Beržynėlis;ŽVIRBLIUKAI;2193460960;Taip;0;3;0;3
711;Beržynėlis;ŽVIRBLIUKAI;2482395208;Taip;0;3;0;3
712;Beržynėlis;ŽVIRBLIUKAI;7057284039;Taip;0;4;0;4
713;Beržynėlis;ŽVIRBLIUKAI;2892553878;Taip;0;2;1;3
714;Beržynėlis;ŽVIRBLIUKAI;4466393687;Taip;0;2;2;4
715;Beržynėlis;ŽVIRBLIUKAI;4774769217;Taip;0;3;1;4
716;Beržynėlis;ŽVIRBLIUKAI;9503352345;Taip;0;1;0;1
717;Beržynėlis;ŽVIRBLIUKAI;8881566865;Taip;0;0;13;13
718;Beržynėlis;ŽVIRBLIUKAI;8280378527;Taip;0;7;0;7
719;Beržynėlis;ŽVIRBLIUKAI;6713134631;Taip;0;1;0;1
720;Beržynėlis;ŽVIRBLIUKAI;9754455116;Taip;0;3;0;3
721;Beržynėlis;ŽVIRBLIUKAI;3334994408;Taip;0;5;0;5
722;Beržynėlis;ŽVIRBLIUKAI;9777841895;Taip;0;13;1;14
723;Beržynėlis;ŽVIRBLIUKAI;6293884233;Taip;7;1;0;8
724;Beržynėlis;ŽVIRBLIUKAI;4161974847;Taip;0;2;1;3
725;Beržynėlis;ŽVIRBLIUKAI;3209966996;Taip;0;5;0;5
726;Beržynėlis;ŽVIRBLIUKAI;5194416351;Taip;0;3;0;3
727;Beržynėlis;ŽVIRBLIUKAI;1228384088;Taip;5;1;1;7
728;Beržynėlis;ŽVIRBLIUKAI;5189335842;Taip;0;1;0;1
729;Beržynėlis;ŽIRNIUKAI;6932094459;Taip;0;6;0;6
730;Beržynėlis;ŽIRNIUKAI;5864265458;Taip;0;12;0;12
731;Beržynėlis;ŽIRNIUKAI;2583982025;Taip;0;4;0;4
732;Beržynėlis;ŽIRNIUKAI;7870888327;Taip;3;0;1;4
733;Beržynėlis;ŽIRNIUKAI;9603272698;Taip;18;0;0;18
734;Beržynėlis;ŽIRNIUKAI;9493489114;Taip;18;0;0;18
735;Beržynėlis;ŽIRNIUKAI;4786786104;Taip;0;8;0;8
736;Beržynėlis;ŽIRNIUKAI;4944466205;Taip;0;2;2;4
737;Beržynėlis;ŽIRNIUKAI;6392773584;Taip;3;1;0;4
738;Beržynėlis;ŽIRNIUKAI;2155662035;Taip;0;2;2;4
739;Beržynėlis;ŽIRNIUKAI;4978363316;Taip;9;1;0;10
740;Beržynėlis;ŽIRNIUKAI;6845342905;Taip;0;0;5;5
741;Beržynėlis;ŽIRNIUKAI;7806800327;Taip;18;0;0;18
742;Beržynėlis;VIŠČIUKAI;7903644161;Taip;4;3;0;7
743;Beržynėlis;VIŠČIUKAI;1707585750;Taip;13;0;0;13
744;Beržynėlis;VIŠČIUKAI;4382068779;Taip;3;0;0;3
745;Beržynėlis;VIŠČIUKAI;2272661119;Taip;11;3;0;14
746;Beržynėlis;VIŠČIUKAI;1831776326;Taip;7;0;0;7
747;Beržynėlis;VIŠČIUKAI;4369803044;Taip;4;2;4;10
748;Beržynėlis;VIŠČIUKAI;1503903200;Taip;10;0;8;18
749;Beržynėlis;VIŠČIUKAI;3593785967;Taip;5;0;0;5
750;Beržynėlis;VIŠČIUKAI;7972993168;Taip;7;2;1;10
751;Beržynėlis;VIŠČIUKAI;5049057730;Taip;10;0;0;10
752;Beržynėlis;VIŠČIUKAI;7084666673;Taip;1;3;0;4
753;Beržynėlis;VIŠČIUKAI;6592330036;Taip;0;3;0;3
754;Beržynėlis;VIŠČIUKAI;3100097647;Taip;3;0;10;13
755;Birutės;SKRUZDELIUKŲ;4968068043;Taip;0;0;1;1
756;Birutės;SKRUZDELIUKŲ;1761065941;Taip;0;4;0;4
757;Birutės;SKRUZDELIUKŲ;9610268046;Taip;0;0;2;2
758;Birutės;SKRUZDELIUKŲ;4027700332;Taip;2;2;2;6
759;Birutės;SKRUZDELIUKŲ;1105133326;Taip;15;3;0;18
760;Birutės;SKRUZDELIUKŲ;8636113039;Taip;0;5;0;5
761;Birutės;SKRUZDELIUKŲ;9411016611;Taip;0;6;1;7
762;Birutės;SKRUZDELIUKŲ;7119951690;Taip;0;6;0;6
763;Birutės;SKRUZDELIUKŲ;1945532852;Taip;0;3;0;3
764;Birutės;SKRUZDELIUKŲ;5154903444;Taip;0;3;0;3
765;Birutės;SKRUZDELIUKŲ;9541516589;Taip;0;0;5;5
766;Birutės;SKRUZDELIUKŲ;6815916679;Taip;0;3;0;3
767;Birutės;SKRUZDELIUKŲ;9187671201;Taip;5;1;4;10
768;Birutės;SKRUZDELIUKŲ;7404631298;Taip;2;3;3;8
769;Birutės;SKRUZDELIUKŲ;8432173636;Taip;0;4;0;4
770;Birutės;SKRUZDELIUKŲ;9904827482;Taip;0;3;2;5
771;Birutės;SKRUZDELIUKŲ;2140552221;Ne;0;3;2;5
772;Birutės;SKRUZDELIUKŲ;8413760872;Taip;0;3;0;3
773;Birutės;SKRUZDELIUKŲ;7940403585;Taip;4;5;0;9
774;Birutės;SKRUZDELIUKŲ;2859160609;Taip;0;3;0;3
775;Birutės;SKRUZDELIUKŲ;7251592439;Taip;11;0;0;11
776;Birutės;SKRUZDELIUKŲ;4375683234;Taip;0;3;2;5
777;Birutės;BITUČIŲ;1599159924;Ne;0;3;1;4
778;Birutės;BITUČIŲ;33770983649;Taip;9;5;0;14
779;Birutės;BITUČIŲ;87693588654;Taip;0;5;0;5
780;Birutės;BITUČIŲ;1234596925;Taip;0;1;0;1
781;Birutės;BITUČIŲ;2975442228;Taip;14;0;0;14
782;Birutės;BITUČIŲ;5770026060;Taip;3;3;0;6
783;Birutės;BITUČIŲ;98391790116;Taip;0;3;1;4
784;Birutės;BITUČIŲ;5947971037;Taip;0;6;0;6
785;Birutės;BITUČIŲ;3870702348;Taip;0;6;0;6
786;Birutės;BITUČIŲ;3436637062;Taip;3;2;0;5
787;Birutės;BITUČIŲ;8465645434;Taip;6;0;2;8
788;Birutės;BITUČIŲ;9722922540;Taip;6;3;0;9
789;Birutės;BITUČIŲ;3061210677;Taip;0;3;2;5
790;Birutės;BITUČIŲ;6431396285;Taip;5;3;0;8
791;Birutės;BITUČIŲ;6081472534;Taip;4;3;0;7
792;Birutės;BITUČIŲ;2674259453;Taip;5;3;3;11
793;Birutės;BITUČIŲ;17865476849;Taip;13;3;0;16
794;Birutės;BITUČIŲ;2329522074;Taip;4;3;0;7
795;Birutės;BITUČIŲ;5164196372;Taip;0;0;1;1
796;Birutės;BITUČIŲ;6006110601;Taip;0;1;0;1
797;Birutės;BITUČIŲ;1243603625;Taip;5;2;0;7
798;Birutės;BITUČIŲ;4253571334;Taip;0;3;1;4
799;Birutės;BITUČIŲ;1447494370;Taip;0;3;0;3
800;Birutės;BORUŽIUKAI;5893851353;Taip;5;3;0;8
801;Birutės;BORUŽIUKAI;5457357625;Taip;9;0;0;9
802;Birutės;BORUŽIUKAI;5869137292;Taip;13;0;0;13
803;Birutės;BORUŽIUKAI;5026442722;Taip;12;2;0;14
804;Birutės;BORUŽIUKAI;6977276295;Taip;5;9;2;16
805;Birutės;BORUŽIUKAI;9289922622;Taip;0;0;2;2
806;Birutės;BORUŽIUKAI;1776142202;Taip;10;0;1;11
807;Birutės;BORUŽIUKAI;4906874758;Taip;2;1;0;3
808;Birutės;BORUŽIUKAI;9263238557;Taip;0;7;0;7
809;Birutės;BORUŽIUKAI;4488481136;Taip;9;0;0;9
810;Birutės;BORUŽIUKAI;6460415179;Taip;10;0;1;11
811;Birutės;BORUŽIUKAI;6973898557;Taip;0;6;2;8
812;Birutės;BORUŽIUKAI;7033907787;Taip;12;0;3;15
813;Birutės;BORUŽIUKAI;5745377474;Taip;13;0;0;13
814;Birutės;BORUŽIUKAI;5897671273;Taip;0;0;16;16
815;Birutės;BORUŽIUKAI;2016711225;Taip;3;0;3;6
816;Birutės;BORUŽIUKAI;1400510886;Taip;7;0;1;8
817;Birutės;BORUŽIUKAI;7494879160;Taip;5;0;7;12
818;Birutės;BORUŽIUKAI;5875585426;Taip;5;0;0;5
819;Birutės;BORUŽIUKAI;7398022393;Taip;3;0;4;7
820;Birutės;BORUŽIUKAI;7712882120;Taip;10;1;0;11
821;Birutės;BORUŽIUKAI;7741922416;Taip;0;16;0;16
822;Birutės;BORUŽIUKAI;2681370776;Taip;0;0;2;2
823;Birutės;DRUGELIAI;8854957814;Taip;0;0;10;10
824;Birutės;DRUGELIAI;6263985683;Taip;10;3;0;13
825;Birutės;DRUGELIAI;4995437657;Ne;5;3;0;8
826;Birutės;DRUGELIAI;5957267018;Taip;3;3;5;11
827;Birutės;DRUGELIAI;1442496209;Taip;8;1;1;10
828;Birutės;DRUGELIAI;2318034045;Taip;16;0;0;16
829;Birutės;DRUGELIAI;9727836236;Ne;14;0;0;14
830;Birutės;DRUGELIAI;3516719248;Taip;0;3;1;4
831;Birutės;DRUGELIAI;5688633357;Ne;0;4;7;11
832;Birutės;DRUGELIAI;8559820030;Taip;0;3;9;12
833;Birutės;DRUGELIAI;9863681147;Taip;0;0;6;6
834;Birutės;DRUGELIAI;9307655828;Ne;0;3;7;10
835;Birutės;DRUGELIAI;3115571205;Taip;12;0;0;12
836;Birutės;DRUGELIAI;4674152995;Taip;0;3;0;3
837;Birutės;DRUGELIAI;5177528200;Taip;5;0;4;9
838;Birutės;DRUGELIAI;3391101786;Taip;0;3;0;3
839;Birutės;DRUGELIAI;7876057712;Taip;0;0;4;4
840;Birutės;DRUGELIAI;6765257633;Taip;10;0;0;10
841;Birutės;DRUGELIAI;2257683802;Taip;0;0;1;1
842;Birutės;DRUGELIAI;7336936451;Taip;0;15;0;15
843;Bitutė;Aitvariukų;4474600934;Taip;3;0;0;3
844;Bitutė;Aitvariukų;5606049201;Taip;14;1;0;15
845;Bitutė;Aitvariukų;6035394425;Taip;0;4;0;4
846;Bitutė;Aitvariukų;7132616264;Taip;0;7;0;7
847;Bitutė;Aitvariukų;8796728627;Taip;0;3;0;3
848;Bitutė;Aitvariukų;6030674568;Taip;0;3;1;4
849;Bitutė;Aitvariukų;9747786638;Taip;0;3;5;8
850;Bitutė;Aitvariukų;8259512455;Taip;0;3;4;7
851;Bitutė;Aitvariukų;9106644834;Taip;0;3;2;5
852;Bitutė;Aitvariukų;2899217019;Taip;6;3;0;9
853;Bitutė;Aitvariukų;8670124052;Taip;0;3;5;8
854;Bitutė;Aitvariukų;1340530611;Taip;0;0;5;5
855;Bitutė;Aitvariukų;6759511692;Taip;11;0;0;11
856;Bitutė;Aitvariukų;4164058783;Taip;0;3;7;10
857;Bitutė;Aitvariukų;8908052679;Taip;1;3;3;7
858;Bitutė;Aitvariukų;4924483609;Taip;0;5;0;5
859;Bitutė;Aitvariukų;7447624247;Taip;0;8;0;8
860;Bitutė;Aitvariukų;5880651175;Taip;8;1;0;9
861;Bitutė;Ežiukų;56287634684;Taip;0;3;1;4
862;Bitutė;Ežiukų;5126303823;Taip;7;0;3;10
863;Bitutė;Ežiukų;4764586168;Taip;0;3;1;4
864;Bitutė;Ežiukų;8905075899;Taip;3;0;1;4
865;Bitutė;Ežiukų;3600670185;Taip;0;0;4;4
866;Bitutė;Ežiukų;6341806464;Taip;0;4;4;8
867;Bitutė;Ežiukų;50869152455;Taip;0;3;0;3
868;Bitutė;Ežiukų;7456328992;Ne;0;5;0;5
869;Bitutė;Ežiukų;2812580726;Taip;0;1;5;6
870;Bitutė;Ežiukų;8186706520;Taip;0;18;0;18
871;Bitutė;Ežiukų;1904108612;Taip;0;3;0;3
872;Bitutė;Ežiukų;5378885117;Taip;0;3;0;3
873;Bitutė;Ežiukų;2122052883;Taip;0;0;4;4
874;Bitutė;Ežiukų;4444523140;Taip;4;3;0;7
875;Bitutė;Ežiukų;4024758152;Taip;0;3;0;3
876;Bitutė;Ežiukų;6194712643;Taip;0;3;0;3
877;Bitutė;Ežiukų;4468366941;Taip;10;0;4;14
878;Bitutė;Ežiukų;5188828679;Taip;0;4;0;4
879;Bitutė;Ežiukų;8109028957;Taip;0;4;0;4
880;Bitutė;Ežiukų;3156654672;Taip;0;3;3;6
881;Bitutė;Žvirbliukų;7047262367;Taip;4;3;0;7
882;Bitutė;Žvirbliukų;3804171750;Taip;0;6;0;6
883;Bitutė;Žvirbliukų;8545377054;Taip;0;4;0;4
884;Bitutė;Žvirbliukų;5406667195;Taip;0;4;4;8
885;Bitutė;Žvirbliukų;4458990772;Taip;0;4;4;8
886;Bitutė;Žvirbliukų;3723040682;Taip;0;6;0;6
887;Bitutė;Žvirbliukų;2190439190;Taip;0;4;0;4
888;Bitutė;Žvirbliukų;7113693496;Taip;8;0;2;10
889;Bitutė;Žvirbliukų;4177331531;Taip;0;0;4;4
890;Bitutė;Žvirbliukų;2483462846;Taip;0;12;0;12
891;Bitutė;Žvirbliukų;7678106084;Taip;0;3;0;3
892;Bitutė;Žvirbliukų;6044969600;Taip;0;6;0;6
893;Bitutė;Žvirbliukų;2444289145;Taip;0;3;0;3
894;Bitutė;Žvirbliukų;3517750478;Taip;0;16;0;16
895;Bitutė;Žvirbliukų;5291764696;Taip;4;6;0;10
896;Bitutė;Žvirbliukų;9523588597;Taip;0;4;2;6
897;Bitutė;Žvirbliukų;9166624750;Taip;0;4;5;9
898;Bitutė;Žvirbliukų;8373105196;Taip;5;4;2;11
899;Bitutė;Žvirbliukų;6014726741;Taip;0;5;0;5
900;Bitutė;Žvirbliukų;4527880105;Taip;0;6;3;9
901;Bitutė;Žvirbliukų;9834697190;Taip;6;0;0;6
902;Bitutė;Gandriukų;8519978626;Taip;0;3;11;14
903;Bitutė;Gandriukų;1809034174;Taip;0;5;6;11
904;Bitutė;Gandriukų;6586888742;Taip;9;4;6;19
905;Bitutė;Gandriukų;5783154071;Taip;0;8;0;8
906;Bitutė;Gandriukų;7387822939;Ne;0;4;0;4
907;Bitutė;Gandriukų;6052204491;Taip;2;6;0;8
908;Bitutė;Gandriukų;37105491775;Taip;0;8;0;8
909;Bitutė;Gandriukų;90943054285;Taip;4;10;0;14
910;Bitutė;Gandriukų;6659750060;Taip;5;4;0;9
911;Bitutė;Gandriukų;9683582019;Taip;0;5;1;6
912;Bitutė;Gandriukų;11567978993;Taip;5;12;0;17
913;Bitutė;Gandriukų;7352524951;Taip;0;4;0;4
914;Bitutė;Gandriukų;2350260809;Taip;0;3;3;6
915;Bitutė;Gandriukų;27144303911;Taip;0;6;0;6
916;Bitutė;Gandriukų;1942685472;Taip;0;3;0;3
917;Bitutė;Gandriukų;1307749129;Taip;0;3;0;3
918;Bitutė;Gandriukų;3980455738;Taip;0;3;0;3
919;Bitutė;Gandriukų;5653055907;Taip;3;10;0;13
920;Bitutė;Gandriukų;6678928989;Ne;7;11;0;18
921;Bitutė;Gandriukų;1802887869;Taip;5;7;0;12
922;Bitutė;Gandriukų;51054491845;Taip;0;3;0;3
923;Bitutė;Gandriukų;4574673585;Taip;0;6;2;8
924;Bitutė;Gandriukų;47316276655;Taip;0;4;0;4
925;Bitutė;Pelėdžiukai;3254061362;Taip;0;5;1;6
926;Bitutė;Pelėdžiukai;5455919343;Taip;0;6;0;6
927;Bitutė;Pelėdžiukai;8743734366;Taip;5;6;0;11
928;Bitutė;Pelėdžiukai;6674923740;Taip;0;3;0;3
929;Bitutė;Pelėdžiukai;2804203556;Taip;7;7;0;14
930;Bitutė;Pelėdžiukai;8394685672;Taip;0;5;0;5
931;Bitutė;Pelėdžiukai;7056737587;Taip;0;3;0;3
932;Bitutė;Pelėdžiukai;4985270536;Taip;0;26;0;26
933;Bitutė;Pelėdžiukai;1590501589;Taip;0;26;0;26
934;Bitutė;Pelėdžiukai;3796188100;Taip;0;6;0;6
935;Bitutė;Pelėdžiukai;1564763789;Taip;0;6;1;7
936;Bitutė;Pelėdžiukai;1846974702;Taip;5;4;0;9
937;Bitutė;Pelėdžiukai;5679397165;Taip;5;6;0;11
938;Bitutė;Pelėdžiukai;1162903905;Taip;0;3;0;3
939;Bitutė;Pelėdžiukai;3432065233;Taip;5;6;0;11
940;Bitutė;Pelėdžiukai;1560715159;Taip;0;6;0;6
941;Bitutė;Pelėdžiukai;6204566294;Taip;0;4;0;4
942;Bitutė;Pelėdžiukai;2518730247;Taip;3;9;4;16
943;Bitutė;Pelėdžiukai;5810344229;Taip;0;3;0;3
944;Bitutė;Pelėdžiukai;4315172747;Taip;5;3;0;8
945;Bitutė;Pelėdžiukai;9838379838;Taip;5;17;0;22
946;Bitutė;Pelėdžiukai;3227252972;Ne;0;4;0;4
947;Bitutė;Boružėlių;8276590981;Taip;17;0;0;17
948;Bitutė;Boružėlių;3026526421;Taip;0;0;4;4
949;Bitutė;Boružėlių;7503203424;Taip;7;0;4;11
950;Bitutė;Boružėlių;1711888057;Taip;5;0;1;6
951;Bitutė;Boružėlių;8355346371;Taip;11;0;0;11
952;Bitutė;Boružėlių;2583001947;Taip;9;0;2;11
953;Bitutė;Boružėlių;9545405359;Taip;0;0;5;5
954;Bitutė;Boružėlių;2129484313;Taip;3;10;0;13
955;Bitutė;Boružėlių;9691450767;Taip;7;0;6;13
956;Bitutė;Boružėlių;3170266155;Taip;15;0;0;15
957;Bitutė;Boružėlių;6455582149;Taip;13;0;0;13
958;Bitutė;Boružėlių;2144809294;Taip;7;0;5;12
959;Bitutė;Boružėlių;8011051470;Taip;0;0;15;15
960;Bitutė;Boružėlių;9521938997;Taip;0;6;0;6
961;Bitutė;Boružėlių;9668365838;Taip;3;7;0;10
962;Bitutė;Boružėlių;3870675531;Taip;4;0;2;6
963;Bitutė;Boružėlių;7095475821;Taip;0;0;1;1
964;Bitutė;Boružėlių;6255439813;Taip;8;0;4;12
965;Bitutė;Boružėlių;2623999429;Taip;14;0;0;14
966;Bitutė;Boružėlių;6840722112;Taip;0;7;3;10
967;Bitutė;Boružėlių;4884898917;Taip;8;1;0;9
968;Bitutė;Boružėlių;4869423833;Taip;5;0;3;8
969;Bitutė;Boružėlių;5071978105;Taip;6;0;4;10
970;Bitutė;Šokliukų;8211710975;Taip;4;11;0;15
971;Bitutė;Šokliukų;8872286273;Taip;4;5;1;10
972;Bitutė;Šokliukų;5169768042;Taip;0;8;0;8
973;Bitutė;Šokliukų;4917599786;Taip;4;4;0;8
974;Bitutė;Šokliukų;1348548294;Taip;0;8;0;8
975;Bitutė;Šokliukų;7318555933;Taip;0;4;0;4
976;Bitutė;Šokliukų;1012702386;Taip;0;0;4;4
977;Bitutė;Šokliukų;9924340801;Taip;0;7;0;7
978;Bitutė;Šokliukų;7979566741;Taip;0;3;1;4
979;Bitutė;Šokliukų;7165511381;Taip;6;3;1;10
980;Bitutė;Šokliukų;9465186207;Taip;0;8;0;8
981;Bitutė;Šokliukų;2853616585;Taip;0;4;8;12
982;Bitutė;Šokliukų;5109258680;Taip;0;3;0;3
983;Bitutė;Šokliukų;8439759353;Taip;0;2;0;2
984;Bitutė;Šokliukų;3417576747;Taip;8;1;0;9
985;Bitutė;Šokliukų;8422448947;Taip;0;6;0;6
986;Bitutė;Šokliukų;7926482326;Taip;0;9;0;9
987;Bitutė;Šokliukų;5876700984;Taip;0;4;0;4
988;Bitutė;Šokliukų;2177537591;Taip;0;3;2;5
989;Bitutė;Šokliukų;5759407291;Taip;0;3;0;3
990;Bitutė;Šokliukų;4471813998;Taip;0;5;0;5
991;Bitutė;Šokliukų;9234090775;Taip;3;5;1;9
992;Bitutė;Drugelių;9094567866;Taip;0;0;4;4
993;Bitutė;Drugelių;5759595005;Taip;0;0;3;3
994;Bitutė;Drugelių;2085899696;Taip;1;7;0;8
995;Bitutė;Drugelių;2029309955;Taip;0;10;0;10
996;Bitutė;Drugelių;7376746010;Taip;0;4;1;5
997;Bitutė;Drugelių;5845408472;Taip;12;3;0;15
998;Bitutė;Drugelių;3611348253;Taip;0;7;1;8
999;Bitutė;Drugelių;8727525320;Taip;13;4;0;17
1000;Bitutė;Drugelių;5796600501;Taip;0;3;0;3
1001;Bitutė;Drugelių;1558826102;Taip;0;2;0;2
1002;Bitutė;Drugelių;6325890676;Taip;18;0;7;25
1003;Bitutė;Drugelių;2748400429;Taip;14;10;0;24
1004;Bitutė;Drugelių;5146691157;Taip;0;0;3;3
1005;Bitutė;Drugelių;2848732083;Taip;0;6;0;6
1006;Bitutė;Drugelių;5278510767;Taip;0;5;0;5
1007;Bitutė;Drugelių;8962725357;Taip;0;3;0;3
1008;Bitutė;Drugelių;5471241132;Taip;0;4;2;6
1009;Bitutė;Drugelių;1218462939;Taip;0;8;0;8
1010;Bitutė;Drugelių;5081300818;Taip;14;3;0;17
1011;Bitutė;Drugelių;7013249141;Taip;0;0;4;4
1012;Bitutė;Drugelių;1397711778;Taip;5;5;1;11
1013;Bitutė;Drugelių;8008237092;Taip;0;14;2;16
1014;Bitutė;Drugelių;4545188971;Taip;19;4;0;23
1015;Bitutė;Kiškučių;9451529077;Taip;0;4;1;5
1016;Bitutė;Kiškučių;1907876695;Taip;0;4;0;4
1017;Bitutė;Kiškučių;7720798466;Taip;0;5;0;5
1018;Bitutė;Kiškučių;1662815358;Taip;0;6;0;6
1019;Bitutė;Kiškučių;1733189730;Taip;0;6;0;6
1020;Bitutė;Kiškučių;9966437881;Taip;0;4;0;4
1021;Bitutė;Kiškučių;8373296210;Taip;0;3;1;4
1022;Bitutė;Kiškučių;1985958540;Taip;0;9;0;9
1023;Bitutė;Kiškučių;8743960488;Taip;0;3;1;4
1024;Bitutė;Kiškučių;9337144831;Taip;12;5;0;17
1025;Bitutė;Kiškučių;4566919587;Taip;6;2;0;8
1026;Bitutė;Kiškučių;2806899030;Taip;3;11;0;14
1027;Bitutė;Kiškučių;5443722813;Taip;0;8;0;8
1028;Bitutė;Kiškučių;1241863345;Taip;0;1;0;1
1029;Bitutė;Kiškučių;8789574593;Taip;0;0;3;3
1030;Bitutė;Kiškučių;8799003374;Taip;0;17;0;17
1031;Bitutė;Kiškučių;4639968278;Taip;0;7;0;7
1032;Bitutė;Kiškučių;9217178863;Taip;4;4;0;8
1033;Bitutė;Kiškučių;5490753578;Ne;5;0;2;7
1034;Bitutė;"Viščiukų ";3603716923;Taip;21;1;0;22
1035;Bitutė;"Viščiukų ";5181958187;Taip;15;4;0;19
1036;Bitutė;"Viščiukų ";7694916340;Taip;0;26;0;26
1037;Bitutė;"Viščiukų ";8303932330;Taip;10;6;0;16
1038;Bitutė;"Viščiukų ";8642411661;Taip;3;2;0;5
1039;Bitutė;"Viščiukų ";1198024852;Taip;16;0;0;16
1040;Bitutė;"Viščiukų ";9909017070;Taip;15;0;0;15
1041;Bitutė;"Viščiukų ";3811028304;Taip;15;3;2;20
1042;Bitutė;"Viščiukų ";9592567172;Taip;5;2;0;7
1043;Bitutė;"Viščiukų ";7619112317;Taip;0;9;0;9
1044;Bitutė;"Viščiukų ";1715987321;Taip;5;0;2;7
1045;Bitutė;"Viščiukų ";4926289620;Taip;7;0;2;9
1046;Bitutė;"Viščiukų ";8130382253;Taip;2;8;0;10
1047;Bitutė;"Viščiukų ";5869737425;Taip;10;3;0;13
1048;Bitutė;"Viščiukų ";5220694242;Taip;0;4;0;4
1049;Bitutė;"Viščiukų ";7535583229;Taip;5;0;1;6
1050;Bitutė;"Viščiukų ";4480187618;Taip;5;0;0;5
1051;Bitutė;"Viščiukų ";5061164237;Taip;6;2;1;9
1052;Bitutė;"Skruzdėliukai ";5686278261;Taip;0;10;3;13
1053;Bitutė;"Skruzdėliukai ";1423694056;Taip;0;2;6;8
1054;Bitutė;"Skruzdėliukai ";5942493696;Taip;2;2;0;4
1055;Bitutė;"Skruzdėliukai ";6311396261;Taip;3;4;0;7
1056;Bitutė;"Skruzdėliukai ";7145036085;Taip;8;4;2;14
1057;Bitutė;"Skruzdėliukai ";2252157473;Taip;5;2;0;7
1058;Bitutė;"Skruzdėliukai ";6169426273;Taip;6;3;3;12
1059;Bitutė;"Skruzdėliukai ";4513783927;Taip;0;3;2;5
1060;Bitutė;"Skruzdėliukai ";8667259778;Taip;18;0;8;26
1061;Bitutė;"Skruzdėliukai ";8607718704;Taip;0;3;0;3
1062;Bitutė;"Skruzdėliukai ";4413880918;Taip;5;3;1;9
1063;Bitutė;"Skruzdėliukai ";9436414962;Taip;21;4;0;25
1064;Bitutė;"Skruzdėliukai ";9864771568;Taip;6;6;5;17
1065;Bitutė;"Skruzdėliukai ";6353690252;Taip;0;3;0;3
1066;Bitutė;"Skruzdėliukai ";2160735504;Taip;11;1;1;13
1067;Bitutė;"Skruzdėliukai ";1387310054;Taip;7;0;0;7
1068;Bitutė;"Skruzdėliukai ";7245807233;Taip;10;0;4;14
1069;Bitutė;"Skruzdėliukai ";4467090141;Taip;0;6;2;8
1070;Bitutė;"Skruzdėliukai ";5433617195;Taip;0;8;0;8
1071;Bitutė;"Skruzdėliukai ";2391170362;Taip;12;1;2;15
1072;Bitutė;"Nykštukų ";1290146001;Taip;12;0;1;13
1073;Bitutė;"Nykštukų ";3359918177;Taip;12;4;0;16
1074;Bitutė;"Nykštukų ";9352292654;Taip;5;0;7;12
1075;Bitutė;"Nykštukų ";5421744666;Taip;0;5;0;5
1076;Bitutė;"Nykštukų ";9780599803;Taip;10;4;0;14
1077;Bitutė;"Nykštukų ";7741454857;Taip;0;3;1;4
1078;Bitutė;"Nykštukų ";3860047703;Taip;0;0;1;1
1079;Bitutė;"Nykštukų ";6226996242;Taip;6;2;1;9
1080;Bitutė;"Nykštukų ";1460746240;Taip;7;2;0;9
1081;Bitutė;"Nykštukų ";8896842164;Taip;0;18;0;18
1082;Bitutė;"Nykštukų ";2819417600;Taip;6;4;1;11
1083;Bitutė;"Nykštukų ";8561037889;Taip;0;12;0;12
1084;Bitutė;"Nykštukų ";6091108131;Taip;18;4;0;22
1085;Bitutė;"Nykštukų ";5375847129;Taip;18;8;0;26
1086;Bitutė;"Nykštukų ";3528436838;Taip;3;4;0;7
1087;Bitutė;"Nykštukų ";8270270602;Taip;12;0;4;16
1088;Bitutė;"Nykštukų ";4617493676;Taip;9;0;2;11
1089;Bitutė;"Nykštukų ";3806852067;Taip;5;9;0;14
1090;Coliukė;DRUGELIAI;3151183436;Taip;0;3;0;3
1091;Coliukė;DRUGELIAI;6675290003;Taip;6;3;1;10
1092;Coliukė;DRUGELIAI;9890663421;Taip;0;5;0;5
1093;Coliukė;DRUGELIAI;7763035106;Taip;2;1;0;3
1094;Coliukė;DRUGELIAI;3628571567;Taip;0;9;0;9
1095;Coliukė;DRUGELIAI;9688432169;Taip;0;0;1;1
1096;Coliukė;DRUGELIAI;7513522378;Taip;8;1;0;9
1097;Coliukė;DRUGELIAI;8478006305;Taip;0;3;3;6
1098;Coliukė;DRUGELIAI;9352547729;Taip;0;1;0;1
1099;Coliukė;DRUGELIAI;3908791146;Taip;3;1;0;4
1100;Coliukė;DRUGELIAI;9750447455;Taip;6;7;0;13
1101;Coliukė;DRUGELIAI;3367789231;Taip;16;0;0;16
1102;Coliukė;DRUGELIAI;1220834062;Taip;0;4;0;4
1103;Coliukė;DRUGELIAI;3392367716;Taip;0;0;3;3
1104;Coliukė;DRUGELIAI;7621095517;Taip;0;0;3;3
1105;Coliukė;DRUGELIAI;4140716483;Taip;0;0;1;1
1106;Coliukė;DRUGELIAI;2385917598;Taip;8;0;0;8
1107;Coliukė;DRUGELIAI;1390751418;Taip;0;2;0;2
1108;Coliukė;DRUGELIAI;4881447596;Taip;0;5;0;5
1109;Coliukė;DRUGELIAI;7284465232;Taip;0;4;1;5
1110;Coliukė;DRUGELIAI;8756465257;Taip;5;4;0;9
1111;Coliukė;BITUTĖS;6725408547;Taip;9;0;1;10
1112;Coliukė;BITUTĖS;2167230398;Taip;0;6;0;6
1113;Coliukė;BITUTĖS;5349969025;Taip;5;0;0;5
1114;Coliukė;BITUTĖS;1960898805;Taip;0;10;0;10
1115;Coliukė;BITUTĖS;7920728387;Taip;0;4;0;4
1116;Coliukė;BITUTĖS;1968467455;Taip;0;2;0;2
1117;Coliukė;BITUTĖS;8457120425;Taip;2;2;0;4
1118;Coliukė;BITUTĖS;1240946719;Taip;0;5;0;5
1119;Coliukė;BITUTĖS;9331485675;Taip;0;4;0;4
1120;Coliukė;BITUTĖS;9311775782;Taip;0;3;0;3
1121;Coliukė;BITUTĖS;2275327607;Taip;0;2;0;2
1122;Coliukė;BITUTĖS;3346269598;Taip;0;2;0;2
1123;Coliukė;BITUTĖS;9879369365;Taip;5;3;0;8
1124;Coliukė;BITUTĖS;4845247006;Taip;5;5;0;10
1125;Coliukė;BITUTĖS;9885547263;Taip;14;0;0;14
1126;Coliukė;BITUTĖS;36554487034;Taip;5;3;0;8
1127;Coliukė;BITUTĖS;1458763954;Taip;0;5;0;5
1128;Coliukė;BITUTĖS;6860757091;Taip;5;3;0;8
1129;Coliukė;BITUTĖS;8517128464;Taip;0;3;0;3
1130;Coliukė;BITUTĖS;8149118599;Taip;5;4;0;9
1131;Coliukė;BITUTĖS;7345905007;Taip;5;0;0;5
1132;Coliukė;BITUTĖS;7358018315;Taip;0;3;3;6
1133;Coliukė;VABALIUKAI;1105879142;Taip;0;1;0;1
1134;Coliukė;VABALIUKAI;1537341012;Taip;1;0;2;3
1135;Coliukė;VABALIUKAI;6984254334;Taip;9;3;0;12
1136;Coliukė;VABALIUKAI;5835199087;Taip;7;5;0;12
1137;Coliukė;VABALIUKAI;4626722910;Taip;18;0;0;18
1138;Coliukė;VABALIUKAI;9526108197;Ne;4;7;0;11
1139;Coliukė;VABALIUKAI;1318558913;Taip;7;3;1;11
1140;Coliukė;VABALIUKAI;6475497234;Taip;0;1;6;7
1141;Coliukė;VABALIUKAI;5596775091;Taip;0;1;6;7
1142;Coliukė;VABALIUKAI;4172517506;Taip;0;3;0;3
1143;Coliukė;VABALIUKAI;4493314926;Taip;0;6;0;6
1144;Coliukė;VABALIUKAI;2469993058;Taip;0;8;0;8
1145;Coliukė;VABALIUKAI;4739310916;Taip;0;4;0;4
1146;Coliukė;VABALIUKAI;5541328815;Ne;13;1;0;14
1147;Coliukė;VABALIUKAI;4649987214;Taip;0;4;0;4
1148;Coliukė;VABALIUKAI;3905904092;Taip;8;1;1;10
1149;Coliukė;VABALIUKAI;9083546061;Taip;7;6;0;13
1150;Coliukė;VABALIUKAI;1476750428;Taip;10;3;0;13
1151;Coliukė;VABALIUKAI;8521846076;Taip;3;9;0;12
1152;Coliukė;VABALIUKAI;7622526793;Taip;0;4;0;4
1153;Coliukė;VABALIUKAI;1328505569;Ne;0;8;0;8
1154;Coliukė;VABALIUKAI;9268436167;Taip;0;3;0;3
1155;Coliukė;VABALIUKAI;9368334915;Taip;4;4;0;8
1156;Coliukė;VABALIUKAI;5108993131;Taip;0;4;1;5
1157;Coliukė;NYKŠTUKAI;6441253648;Taip;7;2;0;9
1158;Coliukė;NYKŠTUKAI;4537756081;Ne;5;6;0;11
1159;Coliukė;NYKŠTUKAI;4022408510;Taip;0;4;0;4
1160;Coliukė;NYKŠTUKAI;3719547522;Taip;0;1;3;4
1161;Coliukė;NYKŠTUKAI;6403149921;Taip;0;1;3;4
1162;Coliukė;NYKŠTUKAI;5450167562;Taip;5;4;1;10
1163;Coliukė;NYKŠTUKAI;9498557347;Taip;7;0;2;9
1164;Coliukė;NYKŠTUKAI;3384332079;Taip;5;1;0;6
1165;Coliukė;NYKŠTUKAI;1198781036;Ne;0;4;4;8
1166;Coliukė;NYKŠTUKAI;5283583324;Ne;0;3;0;3
1167;Coliukė;NYKŠTUKAI;9334564869;Taip;8;7;0;15
1168;Coliukė;NYKŠTUKAI;6781303455;Taip;0;3;0;3
1169;Coliukė;NYKŠTUKAI;3140659021;Ne;3;3;0;6
1170;Coliukė;NYKŠTUKAI;4845049639;Taip;5;3;1;9
1171;Coliukė;NYKŠTUKAI;3221157300;Taip;9;4;0;13
1172;Coliukė;NYKŠTUKAI;7870865302;Ne;0;12;0;12
1173;Coliukė;NYKŠTUKAI;1575061659;Taip;4;1;0;5
1174;Coliukė;NYKŠTUKAI;3678496820;Taip;0;0;1;1
1175;Coliukė;NYKŠTUKAI;2321127662;Taip;7;0;2;9
1176;Coliukė;NYKŠTUKAI;8715608220;Taip;0;1;0;1
1177;Coliukė;NYKŠTUKAI;7502911642;Taip;0;11;0;11
1178;Coliukė;NYKŠTUKAI;4635299740;Taip;0;13;0;13
1179;Coliukė;GĖLYTĖS;9442511803;Taip;3;3;5;11
1180;Coliukė;GĖLYTĖS;6781663126;Taip;2;3;6;11
1181;Coliukė;GĖLYTĖS;6611713551;Taip;6;3;0;9
1182;Coliukė;GĖLYTĖS;6755886435;Taip;0;0;3;3
1183;Coliukė;GĖLYTĖS;1220385522;Taip;6;0;1;7
1184;Coliukė;GĖLYTĖS;8601059431;Taip;0;3;5;8
1185;Coliukė;GĖLYTĖS;1452034828;Taip;8;2;0;10
1186;Coliukė;GĖLYTĖS;6816085304;Taip;0;8;0;8
1187;Coliukė;GĖLYTĖS;6941719947;Taip;3;3;0;6
1188;Coliukė;GĖLYTĖS;5347456579;Taip;5;3;0;8
1189;Coliukė;GĖLYTĖS;9834829829;Taip;0;3;2;5
1190;Coliukė;GĖLYTĖS;9107676840;Taip;1;0;1;2
1191;Coliukė;GĖLYTĖS;8606195508;Taip;5;11;0;16
1192;Coliukė;GĖLYTĖS;4880932369;Taip;4;3;3;10
1193;Coliukė;"BORUŽĖLĖS (SPEC.)";2080118127;Taip;0;5;2;7
1194;Coliukė;"BORUŽĖLĖS (SPEC.)";2617816991;Taip;4;4;0;8
1195;Coliukė;"BORUŽĖLĖS (SPEC.)";1233731506;Taip;5;5;0;10
1196;Coliukė;"BORUŽĖLĖS (SPEC.)";1644303265;Taip;0;1;0;1
1197;Coliukė;"BORUŽĖLĖS (SPEC.)";5706671963;Taip;5;5;1;11
1198;Coliukė;"BORUŽĖLĖS (SPEC.)";4961762841;Taip;5;0;2;7
1199;Coliukė;"BORUŽĖLĖS (SPEC.)";7826554599;Taip;6;0;3;9
1200;Coliukė;"BORUŽĖLĖS (SPEC.)";6920961967;Taip;0;5;0;5
1201;Coliukė;"BORUŽĖLĖS (SPEC.)";1134875499;Taip;5;0;0;5
1202;Coliukė;"BORUŽĖLĖS (SPEC.)";2351866339;Taip;8;3;0;11
1203;Coliukė;"BORUŽĖLĖS (SPEC.)";5756690199;Taip;12;0;0;12
1204;Coliukė;"BORUŽĖLĖS (SPEC.)";6972921877;Taip;9;0;0;9
1205;Coliukė;"BORUŽĖLĖS (SPEC.)";2947495861;Ne;11;0;2;13
1206;Coliukė;"BORUŽĖLĖS (SPEC.)";6246392335;Taip;3;0;0;3
1207;Coliukė;"BORUŽĖLĖS (SPEC.)";8347206534;Ne;0;1;1;2
1208;Coliukė;"BORUŽĖLĖS (SPEC.)";5008183731;Taip;17;0;0;17
1209;Čiauškutis;BITUTĖS;7893181156;Taip;2;0;1;3
1210;Čiauškutis;BITUTĖS;7976738303;Ne;11;0;0;11
1211;Čiauškutis;BITUTĖS;4026881335;Taip;0;0;5;5
1212;Čiauškutis;BITUTĖS;9753680961;Taip;10;1;2;13
1213;Čiauškutis;BITUTĖS;4852837431;Taip;0;0;4;4
1214;Čiauškutis;BITUTĖS;4652951382;Ne;1;13;4;18
1215;Čiauškutis;BITUTĖS;3837360101;Taip;3;0;1;4
1216;Čiauškutis;BITUTĖS;2319237497;Taip;2;0;4;6
1217;Čiauškutis;BITUTĖS;1765857419;Taip;5;4;0;9
1218;Čiauškutis;BITUTĖS;7282041196;Taip;0;18;0;18
1219;Čiauškutis;ŽVIRBLIUKAI;7654242839;Taip;0;3;0;3
1220;Čiauškutis;ŽVIRBLIUKAI;9565722619;Taip;0;6;12;18
1221;Čiauškutis;ŽVIRBLIUKAI;5125518366;Taip;13;0;0;13
1222;Čiauškutis;ŽVIRBLIUKAI;9294208012;Taip;5;0;2;7
1223;Čiauškutis;ŽVIRBLIUKAI;4962200863;Taip;1;0;5;6
1224;Čiauškutis;ŽVIRBLIUKAI;7468763527;Taip;0;0;3;3
1225;Čiauškutis;ŽVIRBLIUKAI;7324659239;Taip;0;0;4;4
1226;Čiauškutis;ŽVIRBLIUKAI;4216443034;Taip;5;0;0;5
1227;Čiauškutis;ŽVIRBLIUKAI;2096533965;Ne;9;2;3;14
1228;Čiauškutis;ŽVIRBLIUKAI;9759888353;Taip;5;0;7;12
1229;Čiauškutis;ŽVIRBLIUKAI;8297774828;Taip;13;2;1;16
1230;Čiauškutis;SAULUTĖS;98579606504;Taip;0;1;1;2
1231;Čiauškutis;SAULUTĖS;7027181377;Taip;12;6;0;18
1232;Čiauškutis;SAULUTĖS;43313173294;Taip;0;18;0;18
1233;Čiauškutis;SAULUTĖS;60265156684;Taip;12;6;0;18
1234;Čiauškutis;SAULUTĖS;9052859205;Taip;0;3;1;4
1235;Čiauškutis;SAULUTĖS;7367933940;Taip;4;0;0;4
1236;Čiauškutis;SAULUTĖS;4658994599;Taip;5;3;0;8
1237;Čiauškutis;SAULUTĖS;6115354862;Ne;0;1;1;2
1238;Čiauškutis;SAULUTĖS;5759367884;Taip;0;3;0;3
1239;Čiauškutis;SAULUTĖS;1313716840;Taip;0;1;2;3
1240;Čiauškutis;EŽIUKAI;7746580858;Taip;0;0;1;1
1241;Čiauškutis;EŽIUKAI;2686038029;Taip;0;0;7;7
1242;Čiauškutis;EŽIUKAI;1928404791;Taip;0;0;3;3
1243;Čiauškutis;EŽIUKAI;7489733038;Taip;5;0;4;9
1244;Čiauškutis;EŽIUKAI;5404165993;Taip;9;0;0;9
1245;Čiauškutis;EŽIUKAI;9959952114;Taip;0;0;1;1
1246;Čiauškutis;EŽIUKAI;1158816422;Taip;0;0;2;2
1247;Čiauškutis;EŽIUKAI;7239878097;Taip;13;0;1;14
1248;Čiauškutis;EŽIUKAI;5910818962;Ne;3;0;5;8
1249;Čiauškutis;EŽIUKAI;1234494170;Taip;2;0;1;3
1250;Čiauškutis;DRUGELIAI;7080320173;Taip;0;2;0;2
1251;Čiauškutis;DRUGELIAI;9072764004;Taip;0;3;0;3
1252;Čiauškutis;DRUGELIAI;1036358147;Taip;0;1;1;2
1253;Čiauškutis;DRUGELIAI;8346845876;Taip;0;3;0;3
1254;Čiauškutis;DRUGELIAI;3724324861;Taip;10;8;0;18
1255;Čiauškutis;DRUGELIAI;2237570705;Taip;2;0;2;4
1256;Čiauškutis;DRUGELIAI;9073514151;Taip;2;0;0;2
1257;Čiauškutis;DRUGELIAI;4681902267;Taip;0;3;1;4
1258;Čiauškutis;GENELIAI;7440425102;Ne;1;0;0;1
1259;Čiauškutis;GENELIAI;76449285846;Taip;0;9;0;9
1260;Čiauškutis;GENELIAI;6435287215;Taip;0;2;0;2
1261;Čiauškutis;GENELIAI;1456067541;Ne;0;3;0;3
1262;Čiauškutis;GENELIAI;1657452686;Taip;0;5;2;7
1263;Čiauškutis;GENELIAI;1739403100;Taip;0;17;1;18
1264;Čiauškutis;GENELIAI;6994301415;Taip;0;3;1;4
1265;Čiauškutis;GENELIAI;1224986101;Taip;10;0;2;12
1266;Čiauškutis;GENELIAI;1809511815;Taip;0;0;5;5
1267;Čiauškutis;LINKSMUČIAI;73016259669;Taip;0;9;0;9
1268;Čiauškutis;LINKSMUČIAI;7184626362;Taip;5;2;0;7
1269;Čiauškutis;LINKSMUČIAI;8689127061;Taip;0;18;0;18
1270;Čiauškutis;LINKSMUČIAI;9062135043;Taip;4;3;0;7
1271;Čiauškutis;LINKSMUČIAI;1533938659;Taip;0;3;1;4
1272;Čiauškutis;LINKSMUČIAI;3353905368;Taip;0;3;1;4
1273;Čiauškutis;LINKSMUČIAI;1306672095;Taip;10;4;0;14
1274;Čiauškutis;LINKSMUČIAI;2218793969;Taip;3;3;0;6
1275;Čiauškutis;LINKSMUČIAI;2672796261;Taip;2;1;1;4
1276;Čiauškutis;LINKSMUČIAI;8857039064;Taip;0;1;0;1
1277;Čiauškutis;KIŠKUČIAI;1900086424;Taip;0;3;4;7
1278;Čiauškutis;KIŠKUČIAI;1396093940;Taip;0;3;5;8
1279;Čiauškutis;KIŠKUČIAI;3465024013;Taip;5;1;3;9
1280;Čiauškutis;KIŠKUČIAI;9754417066;Taip;0;0;3;3
1281;Čiauškutis;KIŠKUČIAI;8580034134;Taip;0;3;3;6
1282;Čiauškutis;KIŠKUČIAI;3650541072;Taip;0;4;3;7
1283;Čiauškutis;KIŠKUČIAI;2445742257;Taip;0;2;4;6
1284;Čiauškutis;KIŠKUČIAI;6785604459;Taip;15;3;0;18
1285;Čiauškutis;LAPIUKAI;5052137859;Taip;0;14;4;18
1286;Čiauškutis;LAPIUKAI;7428833348;Taip;0;0;4;4
1287;Čiauškutis;LAPIUKAI;9897499968;Taip;6;11;1;18
1288;Čiauškutis;LAPIUKAI;2737503753;Taip;6;0;0;6
1289;Čiauškutis;LAPIUKAI;8876608072;Taip;0;0;5;5
1290;Čiauškutis;LAPIUKAI;4881821738;Taip;0;0;4;4
1291;Čiauškutis;LAPIUKAI;4881821738;Taip;0;0;4;4
1292;Čiauškutis;LAPIUKAI;6810906239;Taip;5;0;5;10
1293;Čiauškutis;LAPIUKAI;9460608737;Taip;0;0;5;5
1294;Čiauškutis;MEŠKUČIAI;7135435979;Ne;5;3;2;10
1295;Čiauškutis;MEŠKUČIAI;7274368180;Taip;0;0;2;2
1296;Čiauškutis;MEŠKUČIAI;6146321785;Taip;0;9;9;18
1297;Čiauškutis;MEŠKUČIAI;6434727608;Taip;9;9;0;18
1298;Čiauškutis;MEŠKUČIAI;7526975680;Taip;0;2;0;2
1299;Čiauškutis;MEŠKUČIAI;2172687454;Taip;12;0;0;12
1300;Čiauškutis;MEŠKUČIAI;3660195990;Taip;13;1;2;16
1301;Čiauškutis;PELĖDŽIUKAI;9228568063;Taip;0;0;3;3
1302;Čiauškutis;PELĖDŽIUKAI;1561833758;Taip;4;0;4;8
1303;Čiauškutis;PELĖDŽIUKAI;7931998640;Taip;0;0;3;3
1304;Čiauškutis;PELĖDŽIUKAI;3700692073;Taip;3;0;2;5
1305;Čiauškutis;PELĖDŽIUKAI;3833382641;Taip;0;0;3;3
1306;Čiauškutis;PELĖDŽIUKAI;6615319751;Taip;18;0;0;18
1307;Čiauškutis;PELĖDŽIUKAI;2377986721;Ne;5;0;0;5
1308;Čiauškutis;PELĖDŽIUKAI;8111541739;Taip;0;7;0;7
1309;Čiauškutis;NYKŠTUKAI;8948893335;Taip;5;3;2;10
1310;Čiauškutis;NYKŠTUKAI;4037117222;Taip;10;0;0;10
1311;Čiauškutis;NYKŠTUKAI;6726124641;Taip;0;7;0;7
1312;Čiauškutis;NYKŠTUKAI;6705934636;Taip;0;3;0;3
1313;Čiauškutis;NYKŠTUKAI;5957587644;Taip;13;0;5;18
1314;Čiauškutis;NYKŠTUKAI;1733251156;Taip;0;2;0;2
1315;Čiauškutis;NYKŠTUKAI;5575614158;Taip;9;0;0;9
1316;Čiauškutis;NYKŠTUKAI;2044220236;Taip;0;3;0;3
1317;Čiauškutis;NYKŠTUKAI;7335655769;Ne;0;3;0;3
1318;Daigelis;Bitutės;2252139639;Ne;4;0;0;4
1319;Daigelis;Bitutės;1639589842;Taip;2;0;0;2
1320;Daigelis;Bitutės;1201983358;Taip;13;0;0;13
1321;Daigelis;Bitutės;8855668502;Taip;15;0;0;15
1322;Daigelis;Bitutės;6285764348;Ne;9;0;0;9
1323;Daigelis;Bitutės;4624516876;Taip;5;0;0;5
1324;Daigelis;Bitutės;1333421528;Taip;11;0;0;11
1325;Daigelis;Bitutės;7503012332;Taip;5;0;0;5
1326;Daigelis;"VIEVERSĖLIAI (SPEC)";3744848906;Taip;8;0;0;8
1327;Daigelis;"VIEVERSĖLIAI (SPEC)";6181876938;Taip;6;0;0;6
1328;Daigelis;"VIEVERSĖLIAI (SPEC)";9392290289;Taip;6;0;0;6
1329;Daigelis;"VIEVERSĖLIAI (SPEC)";1427487116;Taip;5;0;0;5
1330;Daigelis;"VIEVERSĖLIAI (SPEC)";7903833413;Taip;3;0;0;3
1331;Daigelis;"VIEVERSĖLIAI (SPEC)";4402503971;Taip;3;0;0;3
1332;Daigelis;"SAULUTĖ (SPEC.sav.)";8817603885;Ne;15;0;0;15
1333;Daigelis;"SAULUTĖ (SPEC.sav.)";1991961132;Ne;15;0;0;15
1334;Daigelis;"SAULUTĖ (SPEC.sav.)";8973215240;Taip;3;0;0;3
1335;Daigelis;"SAULUTĖ (SPEC.sav.)";8020718571;Taip;3;0;0;3
1336;Daigelis;Spinduliukai;4730746531;Taip;6;0;0;6
1337;Daigelis;Spinduliukai;4715171946;Taip;10;0;0;10
1338;Daigelis;Spinduliukai;7955645490;Taip;3;0;0;3
1339;Daigelis;Spinduliukai;9944007915;Taip;17;0;0;17
1340;Daigelis;Spinduliukai;3333255527;Taip;19;0;0;19
1341;Daigelis;Spinduliukai;6384314661;Taip;5;0;0;5
1342;Daigelis;Spinduliukai;7367305924;Taip;8;0;0;8
1343;Daigelis;Pelėdžiukai;6718987671;Taip;1;0;0;1
1344;Daigelis;Pelėdžiukai;2431435960;Taip;25;0;0;25
1345;Daigelis;Pelėdžiukai;7936810346;Taip;24;0;0;24
1346;Daigelis;Pelėdžiukai;1429061018;Taip;8;0;0;8
1347;Daigelis;Pelėdžiukai;4215451069;Taip;1;0;0;1
1348;Daigelis;Pelėdžiukai;1041144226;Ne;7;0;0;7
1349;Daigelis;Žvaigždutės;7391024066;Taip;11;0;0;11
1350;Daigelis;Žvaigždutės;1987773024;Taip;6;0;0;6
1351;Daigelis;Žvaigždutės;5750485070;Ne;7;0;0;7
1352;Daigelis;Žvaigždutės;8477963582;Taip;5;0;0;5
1353;Daigelis;Žvaigždutės;9588934306;Taip;7;0;0;7
1354;Daigelis;Skruzdėliukai;4682302955;Taip;5;0;0;5
1355;Daigelis;Skruzdėliukai;3383805498;Taip;20;0;0;20
1356;Daigelis;Skruzdėliukai;8499408010;Taip;14;0;0;14
1357;Daigelis;Skruzdėliukai;2303781119;Taip;10;0;0;10
1358;Daigelis;Skruzdėliukai;9552228706;Taip;13;0;0;13
1359;Daigelis;Skruzdėliukai;8317879752;Taip;9;0;0;9
1360;Daigelis;Gėlytės;2112477899;Taip;11;0;0;11
1361;Daigelis;Gėlytės;2603945833;Taip;5;0;0;5
1362;Daigelis;Gėlytės;8372290030;Taip;7;0;0;7
1363;Daigelis;Gėlytės;8374822794;Taip;5;0;0;5
1364;Daigelis;Gėlytės;6074261354;Taip;10;0;0;10
1365;Daigelis;Gėlytės;5249108137;Taip;8;0;0;8
1366;Daigelis;Gėlytės;8338714756;Taip;5;0;0;5
1367;Daigelis;Gėlytės;8855198771;Taip;3;0;0;3
1368;Daigelis;Gėlytės;9987516903;Taip;7;0;0;7
1369;Daigelis;Funtiki;9724634409;Taip;1;0;0;1
1370;Daigelis;Funtiki;4162501269;Taip;10;0;0;10
1371;Daigelis;Funtiki;4177202295;Taip;8;0;0;8
1372;Daigelis;Funtiki;8802563390;Taip;9;0;0;9
1373;Daigelis;Nevaliaški;6518661502;Taip;8;0;0;8
1374;Delfinukas;Boružėlių;4196156707;Taip;0;0;2;2
1375;Delfinukas;Boružėlių;9184207705;Taip;0;2;3;5
1376;Delfinukas;Boružėlių;2819680099;Taip;0;3;0;3
1377;Delfinukas;Boružėlių;3205671100;Taip;0;0;5;5
1378;Delfinukas;Boružėlių;1119373532;Taip;6;0;4;10
1379;Delfinukas;Boružėlių;7737665102;Taip;2;2;0;4
1380;Delfinukas;Boružėlių;4985159933;Taip;0;4;0;4
1381;Delfinukas;Boružėlių;2163238846;Taip;15;0;0;15
1382;Delfinukas;Boružėlių;4567479900;Taip;10;0;1;11
1383;Delfinukas;Boružėlių;9747075687;Taip;0;4;0;4
1384;Delfinukas;Boružėlių;7312438969;Taip;7;0;0;7
1385;Delfinukas;Boružėlių;5585334518;Taip;0;5;0;5
1386;Delfinukas;Boružėlių;6071660741;Taip;10;3;0;13
1387;Delfinukas;Boružėlių;4327924499;Taip;4;2;2;8
1388;Delfinukas;Boružėlių;6693756145;Taip;3;4;0;7
1389;Delfinukas;Boružėlių;6301767635;Taip;0;13;0;13
1390;Delfinukas;Saulytės;8315269427;Taip;6;1;4;11
1391;Delfinukas;Saulytės;4215887291;Taip;0;2;4;6
1392;Delfinukas;Saulytės;3631520143;Taip;0;0;9;9
1393;Delfinukas;Saulytės;9424966984;Taip;0;0;10;10
1394;Delfinukas;Saulytės;6069600728;Taip;7;0;4;11
1395;Delfinukas;Saulytės;1404270345;Taip;5;0;3;8
1396;Delfinukas;Saulytės;3842160990;Taip;0;2;0;2
1397;Delfinukas;Saulytės;8402529296;Taip;9;3;0;12
1398;Delfinukas;Saulytės;5125346405;Taip;0;5;0;5
1399;Delfinukas;Saulytės;5642328792;Taip;0;1;3;4
1400;Delfinukas;Saulytės;8176576958;Taip;14;0;1;15
1401;Delfinukas;Saulytės;8275943176;Taip;7;1;3;11
1402;Delfinukas;Saulytės;8085530134;Taip;0;4;0;4
1403;Delfinukas;Saulytės;8148610460;Taip;10;1;0;11
1404;Delfinukas;Saulytės;6935992202;Taip;0;0;3;3
1405;Delfinukas;Saulytės;8186312409;Taip;12;3;0;15
1406;Delfinukas;Saulytės;7904803011;Taip;0;5;3;8
1407;Delfinukas;Saulytės;1873630966;Taip;0;3;0;3
1408;Delfinukas;Saulytės;5665463557;Taip;10;3;0;13
1409;Delfinukas;Saulytės;1296440609;Ne;4;0;5;9
1410;Delfinukas;Saulytės;5397241026;Taip;0;7;0;7
1411;Delfinukas;Pelėdžiukų;3940838205;Taip;6;0;0;6
1412;Delfinukas;Pelėdžiukų;8774145277;Taip;0;8;0;8
1413;Delfinukas;Pelėdžiukų;3770227955;Taip;8;0;0;8
1414;Delfinukas;Pelėdžiukų;6113662246;Taip;0;10;0;10
1415;Delfinukas;Pelėdžiukų;4710894128;Taip;10;1;0;11
1416;Delfinukas;Pelėdžiukų;1526129772;Taip;0;4;2;6
1417;Delfinukas;Pelėdžiukų;8659309242;Taip;0;3;0;3
1418;Delfinukas;Pelėdžiukų;8267992425;Taip;0;4;0;4
1419;Delfinukas;Pelėdžiukų;9319874239;Taip;8;0;0;8
1420;Delfinukas;Pelėdžiukų;2809947323;Ne;0;3;0;3
1421;Delfinukas;Pelėdžiukų;3465186420;Taip;3;1;3;7
1422;Delfinukas;Pelėdžiukų;4096274346;Taip;8;1;0;9
1423;Delfinukas;Pelėdžiukų;5246300518;Taip;0;1;9;10
1424;Delfinukas;Pelėdžiukų;3702341009;Taip;0;3;0;3
1425;Delfinukas;Pelėdžiukų;2420308954;Taip;0;1;0;1
1426;Delfinukas;Pelėdžiukų;6286748047;Taip;0;7;0;7
1427;Delfinukas;Pelėdžiukų;8432654056;Taip;0;1;6;7
1428;Delfinukas;Pelėdžiukų;1575125658;Taip;0;5;0;5
1429;Delfinukas;Pelėdžiukų;4384995354;Taip;8;0;0;8
1430;Delfinukas;Pelėdžiukų;3633392440;Taip;10;1;0;11
1431;Delfinukas;Varliukų;4949220786;Taip;8;4;0;12
1432;Delfinukas;Varliukų;2792051636;Taip;8;2;4;14
1433;Delfinukas;Varliukų;4780352568;Taip;5;0;0;5
1434;Delfinukas;Varliukų;3577180085;Taip;15;0;2;17
1435;Delfinukas;Varliukų;6115370195;Taip;0;0;4;4
1436;Delfinukas;Varliukų;3050258185;Taip;18;0;0;18
1437;Delfinukas;Varliukų;7976681530;Taip;0;0;3;3
1438;Delfinukas;Varliukų;4338259551;Taip;12;0;3;15
1439;Delfinukas;Varliukų;9360553910;Taip;13;1;0;14
1440;Delfinukas;Varliukų;6301601832;Taip;5;3;0;8
1441;Delfinukas;Varliukų;5095713834;Taip;13;1;0;14
1442;Delfinukas;Varliukų;5964021733;Taip;10;5;0;15
1443;Delfinukas;Varliukų;5821591959;Taip;5;7;0;12
1444;Delfinukas;Varliukų;9095895182;Taip;0;0;2;2
1445;Delfinukas;Varliukų;5138840297;Ne;11;2;0;13
1446;Delfinukas;Varliukų;7072060541;Taip;10;1;2;13
1447;Delfinukas;Varliukų;3797355501;Taip;7;2;1;10
1448;Delfinukas;Varliukų;4751611934;Taip;0;0;5;5
1449;Delfinukas;Varliukų;4254414928;Taip;6;1;3;10
1450;Delfinukas;Varliukų;7359531377;Taip;10;0;0;10
1451;Delfinukas;Varpelių;5123666058;Taip;10;3;0;13
1452;Delfinukas;Varpelių;8913681176;Taip;3;3;0;6
1453;Delfinukas;Varpelių;9514189769;Taip;0;5;0;5
1454;Delfinukas;Varpelių;4713803167;Taip;7;3;0;10
1455;Delfinukas;Varpelių;8936645508;Taip;0;6;0;6
1456;Delfinukas;Varpelių;6047881184;Taip;13;0;0;13
1457;Delfinukas;Varpelių;3818558339;Taip;5;0;5;10
1458;Delfinukas;Varpelių;1484123788;Taip;0;4;2;6
1459;Delfinukas;Varpelių;4877757730;Taip;1;2;0;3
1460;Delfinukas;Varpelių;7973858761;Taip;1;2;0;3
1461;Delfinukas;Varpelių;9218154624;Ne;6;0;0;6
1462;Delfinukas;Varpelių;8950528288;Taip;7;0;1;8
1463;Delfinukas;Varpelių;8829835426;Taip;0;0;3;3
1464;Delfinukas;Varpelių;4500756171;Taip;3;3;0;6
1465;Delfinukas;Varpelių;8953230752;Ne;7;3;0;10
1466;Delfinukas;Varpelių;7780893730;Taip;0;1;6;7
1467;Delfinukas;Varpelių;9898427089;Taip;5;0;0;5
1468;Delfinukas;Varpelių;2730512600;Taip;7;2;0;9
1469;Delfinukas;Varpelių;6008032738;Taip;0;2;0;2
1470;Delfinukas;Varpelių;8911433659;Taip;10;0;0;10
1471;Delfinukas;Drugeliai;7615519932;Taip;0;0;4;4
1472;Delfinukas;Drugeliai;6604115681;Taip;4;2;0;6
1473;Delfinukas;Drugeliai;5990192934;Taip;5;4;0;9
1474;Delfinukas;Drugeliai;9635669748;Taip;0;2;3;5
1475;Delfinukas;Drugeliai;8526813977;Taip;0;2;3;5
1476;Delfinukas;Drugeliai;6873181103;Taip;3;2;0;5
1477;Delfinukas;Drugeliai;4484804360;Taip;0;5;1;6
1478;Delfinukas;Drugeliai;8328481987;Taip;0;4;0;4
1479;Delfinukas;Drugeliai;6992505341;Taip;18;0;0;18
1480;Delfinukas;Drugeliai;8129592398;Taip;1;1;0;2
1481;Delfinukas;Drugeliai;8606989493;Taip;0;2;0;2
1482;Delfinukas;Drugeliai;9927854348;Taip;3;0;0;3
1483;Delfinukas;Drugeliai;2756574162;Taip;0;2;0;2
1484;Delfinukas;Drugeliai;2985669766;Taip;11;0;3;14
1485;Delfinukas;Drugeliai;7609115506;Taip;0;3;0;3
1486;Delfinukas;Drugeliai;6457042338;Taip;10;2;0;12
1487;Delfinukas;Drugeliai;5060445169;Taip;0;4;0;4
1488;Delfinukas;Drugeliai;3134897964;Taip;0;4;0;4
1489;Delfinukas;Drugeliai;8411289299;Taip;4;4;0;8
1490;Delfinukas;Drugeliai;2683746435;Taip;0;0;4;4
1491;Delfinukas;Drugeliai;6623617856;Taip;0;3;0;3
1492;Delfinukas;Žuvytės;8160982025;Taip;12;3;0;15
1493;Delfinukas;Žuvytės;6578506861;Taip;7;0;0;7
1494;Delfinukas;Žuvytės;9934325492;Taip;0;6;0;6
1495;Delfinukas;Žuvytės;6322255194;Taip;0;1;2;3
1496;Delfinukas;Žuvytės;6572690788;Taip;0;5;0;5
1497;Delfinukas;Žuvytės;7873373923;Taip;5;0;3;8
1498;Delfinukas;Žuvytės;9898412288;Taip;11;2;4;17
1499;Delfinukas;Žuvytės;3397350274;Taip;0;3;0;3
1500;Delfinukas;Žuvytės;9520598359;Taip;0;6;0;6
1501;Delfinukas;Žuvytės;3804996594;Taip;6;3;0;9
1502;Delfinukas;Žuvytės;2066127119;Taip;0;3;0;3
1503;Delfinukas;Žuvytės;7487111570;Taip;0;4;0;4
1504;Delfinukas;Žuvytės;8702718951;Taip;0;3;0;3
1505;Delfinukas;Žuvytės;6844500395;Taip;5;3;0;8
1506;Delfinukas;Žuvytės;6445868759;Taip;0;4;0;4
1507;Delfinukas;Žuvytės;9074294473;Taip;0;0;7;7
1508;Delfinukas;Žuvytės;4678970810;Taip;9;0;0;9
1509;Delfinukas;Žuvytės;6478152041;Taip;0;4;0;4
1510;Delfinukas;Delfinai;2890469172;Taip;0;0;9;9
1511;Delfinukas;Delfinai;9628317328;Ne;0;5;0;5
1512;Delfinukas;Delfinai;5797308373;Taip;4;3;0;7
1513;Delfinukas;Delfinai;5241426445;Taip;0;4;0;4
1514;Delfinukas;Delfinai;8099120371;Taip;0;3;3;6
1515;Delfinukas;Delfinai;3108430680;Taip;10;0;0;10
1516;Delfinukas;Delfinai;2382077576;Taip;0;5;0;5
1517;Delfinukas;Delfinai;1200205376;Taip;2;4;0;6
1518;Delfinukas;Delfinai;7629622746;Taip;5;3;0;8
1519;Delfinukas;Delfinai;4347116918;Taip;0;10;3;13
1520;Delfinukas;Delfinai;1922513830;Taip;0;4;0;4
1521;Delfinukas;Delfinai;6270012707;Taip;0;7;0;7
1522;Delfinukas;Delfinai;8085481968;Taip;7;4;0;11
1523;Delfinukas;Delfinai;9605756229;Taip;3;0;1;4
1524;Delfinukas;Delfinai;3407321091;Taip;4;3;0;7
1525;Delfinukas;Delfinai;7354837777;Taip;18;0;0;18
1526;Delfinukas;Delfinai;9903010418;Taip;0;5;3;8
1527;Delfinukas;Delfinai;6522639028;Taip;1;0;5;6
1528;Delfinukas;Delfinai;9253061888;Ne;6;0;0;6
1529;Delfinukas;Paukšteliai;7366145460;Taip;10;0;0;10
1530;Delfinukas;Paukšteliai;5278689745;Taip;15;3;0;18
1531;Delfinukas;Paukšteliai;6002086491;Taip;8;0;0;8
1532;Delfinukas;Paukšteliai;1164720538;Taip;10;3;0;13
1533;Delfinukas;Paukšteliai;9351906710;Taip;7;0;0;7
1534;Delfinukas;Paukšteliai;9629225917;Taip;4;0;0;4
1535;Delfinukas;Paukšteliai;9332794060;Taip;8;1;0;9
1536;Delfinukas;Paukšteliai;5368435217;Taip;18;0;0;18
1537;Delfinukas;Paukšteliai;6650725760;Taip;0;0;18;18
1538;Delfinukas;Paukšteliai;7968869585;Taip;18;0;0;18
1539;Delfinukas;Paukšteliai;5164599763;Taip;18;0;0;18
1540;Delfinukas;Paukšteliai;9776618488;Taip;5;3;1;9
1541;Delfinukas;Paukšteliai;9586646352;Taip;6;3;1;10
1542;Delfinukas;Paukšteliai;4561911078;Taip;9;0;1;10
1543;Delfinukas;Paukšteliai;4755699845;Taip;12;0;6;18
1544;Delfinukas;Kiškučiai;4119370256;Taip;0;1;0;1
1545;Delfinukas;Kiškučiai;9602317911;Taip;0;5;0;5
1546;Delfinukas;Kiškučiai;8625023976;Taip;0;3;0;3
1547;Delfinukas;Kiškučiai;6352250868;Taip;0;1;0;1
1548;Delfinukas;Kiškučiai;3284212595;Taip;0;3;0;3
1549;Delfinukas;Kiškučiai;6531930806;Taip;0;2;0;2
1550;Delfinukas;Kiškučiai;8439204095;Taip;0;1;2;3
1551;Delfinukas;Kiškučiai;5783537897;Taip;0;0;1;1
1552;Delfinukas;Kiškučiai;2010703982;Taip;1;1;0;2
1553;Delfinukas;Kiškučiai;8728791932;Taip;0;3;0;3
1554;Delfinukas;Kiškučiai;7365398150;Ne;0;0;3;3
1555;Delfinukas;Kiškučiai;2883959240;Taip;18;0;0;18
1556;Delfinukas;Kiškučiai;4179507316;Taip;5;3;0;8
1557;Delfinukas;Kiškučiai;8440546956;Taip;7;3;0;10
1558;Delfinukas;Kiškučiai;1030958414;Taip;0;3;0;3
1559;Delfinukas;Kiškučiai;7638190553;Taip;0;1;0;1
1560;Delfinukas;Kiškučiai;6577214344;Taip;3;11;0;14
1561;Delfinukas;Kiškučiai;2537442505;Taip;8;0;1;9
1562;Delfinukas;BITUTĖS;9719348837;Taip;10;0;4;14
1563;Delfinukas;BITUTĖS;6211076154;Taip;9;0;0;9
1564;Delfinukas;BITUTĖS;6601922746;Taip;12;3;0;15
1565;Delfinukas;BITUTĖS;8896957908;Taip;13;0;0;13
1566;Delfinukas;BITUTĖS;3239635507;Taip;0;0;4;4
1567;Delfinukas;BITUTĖS;5339993544;Taip;8;0;0;8
1568;Delfinukas;BITUTĖS;6929926768;Taip;11;0;3;14
1569;Delfinukas;BITUTĖS;5557399916;Taip;5;0;1;6
1570;Delfinukas;BITUTĖS;8937594052;Taip;5;4;0;9
1571;Delfinukas;BITUTĖS;5179080544;Taip;8;3;0;11
1572;Delfinukas;BITUTĖS;7727263761;Taip;0;2;2;4
1573;Delfinukas;BITUTĖS;9941631164;Taip;11;0;0;11
1574;Delfinukas;BITUTĖS;4198261848;Taip;5;2;2;9
1575;Delfinukas;BITUTĖS;8081895401;Taip;14;0;0;14
1576;Delfinukas;BITUTĖS;5600320855;Taip;8;1;0;9
1577;Delfinukas;BITUTĖS;9195828884;Taip;5;0;0;5
1578;Delfinukas;BITUTĖS;2377204734;Taip;6;3;0;9
1579;Delfinukas;BITUTĖS;6243471374;Taip;10;2;0;12
1580;Delfinukas;BITUTĖS;4303234827;Taip;14;0;0;14
1581;Delfinukas;BITUTĖS;6325092903;Taip;9;2;0;11
1582;Drevinukas;ZUIKUČIAI;5500759834;Taip;0;0;3;3
1583;Drevinukas;ZUIKUČIAI;9817317105;Taip;0;0;2;2
1584;Drevinukas;ZUIKUČIAI;1595081335;Taip;3;0;3;6
1585;Drevinukas;ZUIKUČIAI;2646799484;Taip;0;0;3;3
1586;Drevinukas;ZUIKUČIAI;2772424629;Taip;15;3;0;18
1587;Drevinukas;ZUIKUČIAI;5928234487;Taip;0;3;0;3
1588;Drevinukas;ZUIKUČIAI;8873060121;Taip;3;0;3;6
1589;Drevinukas;ZUIKUČIAI;1567790084;Taip;0;0;2;2
1590;Drevinukas;ZUIKUČIAI;3293457412;Taip;5;3;3;11
1591;Drevinukas;ZUIKUČIAI;6243097297;Taip;8;3;1;12
1592;Drevinukas;ZUIKUČIAI;5704489483;Taip;0;0;3;3
1593;Drevinukas;ZUIKUČIAI;7054681115;Taip;0;2;0;2
1594;Drevinukas;ZUIKUČIAI;5887233286;Taip;0;0;3;3
1595;Drevinukas;ZUIKUČIAI;3381363132;Taip;3;3;0;6
1596;Drevinukas;ZUIKUČIAI;6462582301;Taip;11;0;0;11
1597;Drevinukas;ZUIKUČIAI;3070518153;Taip;0;0;3;3
1598;Drevinukas;ZUIKUČIAI;9174977150;Taip;0;0;1;1
1599;Drevinukas;ZUIKUČIAI;4243045398;Taip;4;3;0;7
1600;Drevinukas;ZUIKUČIAI;4309475233;Taip;4;3;0;7
1601;Drevinukas;AŽUOLIUKŲ;1644656704;Taip;11;4;1;16
1602;Drevinukas;AŽUOLIUKŲ;5721031754;Taip;0;0;3;3
1603;Drevinukas;AŽUOLIUKŲ;4714478955;Taip;0;2;1;3
1604;Drevinukas;AŽUOLIUKŲ;8701250912;Taip;8;0;1;9
1605;Drevinukas;AŽUOLIUKŲ;8143614891;Taip;6;10;0;16
1606;Drevinukas;AŽUOLIUKŲ;4213259879;Taip;0;8;0;8
1607;Drevinukas;AŽUOLIUKŲ;5673244101;Taip;0;3;0;3
1608;Drevinukas;AŽUOLIUKŲ;3643007998;Ne;0;7;0;7
1609;Drevinukas;AŽUOLIUKŲ;4262951360;Taip;0;3;0;3
1610;Drevinukas;AŽUOLIUKŲ;5959004452;Taip;0;1;1;2
1611;Drevinukas;AŽUOLIUKŲ;7689145214;Taip;0;4;1;5
1612;Drevinukas;AŽUOLIUKŲ;4572837478;Taip;5;0;3;8
1613;Drevinukas;AŽUOLIUKŲ;1564065835;Taip;0;7;0;7
1614;Drevinukas;AŽUOLIUKŲ;9289471118;Taip;0;1;2;3
1615;Drevinukas;AŽUOLIUKŲ;9915130747;Ne;13;3;0;16
1616;Drevinukas;AŽUOLIUKŲ;6891793135;Taip;5;4;2;11
1617;Drevinukas;AŽUOLIUKŲ;1058927778;Taip;0;3;0;3
1618;Drevinukas;AŽUOLIUKŲ;9534007163;Ne;9;1;0;10
1619;Drevinukas;AŽUOLIUKŲ;2300338724;Taip;11;0;0;11
1620;Drevinukas;AŽUOLIUKŲ;3725760478;Taip;0;3;0;3
1621;Drevinukas;AŽUOLIUKŲ;9513405583;Taip;0;3;0;3
1622;Drevinukas;AŽUOLIUKŲ;5436821826;Taip;0;3;0;3
1623;Drevinukas;AŽUOLIUKŲ;8896207423;Taip;8;0;0;8
1624;Drevinukas;PELĖDŽIUKAI;1123115847;Taip;0;3;6;9
1625;Drevinukas;PELĖDŽIUKAI;1987939679;Taip;0;3;0;3
1626;Drevinukas;PELĖDŽIUKAI;9336227821;Taip;0;3;5;8
1627;Drevinukas;PELĖDŽIUKAI;4784716615;Taip;0;3;5;8
1628;Drevinukas;PELĖDŽIUKAI;2070374746;Taip;0;3;0;3
1629;Drevinukas;PELĖDŽIUKAI;8661862777;Taip;0;3;0;3
1630;Drevinukas;PELĖDŽIUKAI;9803670483;Taip;0;3;2;5
1631;Drevinukas;PELĖDŽIUKAI;7519369167;Taip;0;1;0;1
1632;Drevinukas;PELĖDŽIUKAI;16952164778;Taip;0;3;1;4
1633;Drevinukas;PELĖDŽIUKAI;3657451903;Taip;0;6;0;6
1634;Drevinukas;PELĖDŽIUKAI;8180027849;Taip;0;3;3;6
1635;Drevinukas;PELĖDŽIUKAI;4332606643;Taip;0;3;0;3
1636;Drevinukas;PELĖDŽIUKAI;7632515230;Taip;0;3;0;3
1637;Drevinukas;PELĖDŽIUKAI;6304169257;Taip;0;3;0;3
1638;Drevinukas;PELĖDŽIUKAI;5686116320;Taip;3;1;0;4
1639;Drevinukas;PELĖDŽIUKAI;56028675283;Taip;0;3;2;5
1640;Drevinukas;PELĖDŽIUKAI;85288014888;Taip;0;1;0;1
1641;Drevinukas;PELĖDŽIUKAI;1019214451;Taip;5;3;1;9
1642;Drevinukas;PELĖDŽIUKAI;3086451968;Taip;0;3;0;3
1643;Drevinukas;PELĖDŽIUKAI;2857797268;Taip;3;1;0;4
1644;Drevinukas;PELĖDŽIUKAI;6833120798;Taip;0;3;3;6
1645;Drevinukas;PELĖDŽIUKAI;7607135647;Taip;0;3;0;3
1646;Drevinukas;BORUŽĖLĖS;3046196006;Taip;0;3;0;3
1647;Drevinukas;BORUŽĖLĖS;4134729710;Taip;0;0;3;3
1648;Drevinukas;BORUŽĖLĖS;5236292764;Taip;0;0;2;2
1649;Drevinukas;BORUŽĖLĖS;3032536983;Taip;0;0;4;4
1650;Drevinukas;BORUŽĖLĖS;3392249574;Taip;0;3;0;3
1651;Drevinukas;BORUŽĖLĖS;5524567803;Taip;0;0;8;8
1652;Drevinukas;BORUŽĖLĖS;9016985238;Taip;0;0;1;1
1653;Drevinukas;BORUŽĖLĖS;2929598743;Taip;0;5;0;5
1654;Drevinukas;BORUŽĖLĖS;4076576850;Taip;0;0;9;9
1655;Drevinukas;BORUŽĖLĖS;6373230526;Taip;13;0;4;17
1656;Drevinukas;BORUŽĖLĖS;4312429104;Taip;8;0;2;10
1657;Drevinukas;BORUŽĖLĖS;6316000019;Taip;2;0;3;5
1658;Drevinukas;BORUŽĖLĖS;4404254932;Taip;0;0;4;4
1659;Drevinukas;BORUŽĖLĖS;2378493422;Taip;10;3;1;14
1660;Drevinukas;BORUŽĖLĖS;1859208322;Taip;0;0;6;6
1661;Drevinukas;BORUŽĖLĖS;8984653958;Taip;0;4;0;4
1662;Drevinukas;BORUŽĖLĖS;5620887702;Taip;0;3;0;3
1663;Drevinukas;BORUŽĖLĖS;2281463885;Taip;0;3;0;3
1664;Drevinukas;BORUŽĖLĖS;4662426451;Taip;0;3;0;3
1665;Drevinukas;BORUŽĖLĖS;6582186497;Ne;0;0;4;4
1666;Drevinukas;BORUŽĖLĖS;7218201733;Taip;0;0;6;6
1667;Drevinukas;BITUTĖS;3981507849;Taip;0;3;0;3
1668;Drevinukas;BITUTĖS;7753238387;Taip;0;3;4;7
1669;Drevinukas;BITUTĖS;3617570755;Taip;0;3;1;4
1670;Drevinukas;BITUTĖS;5679723776;Taip;0;7;0;7
1671;Drevinukas;BITUTĖS;1720464417;Taip;0;5;0;5
1672;Drevinukas;BITUTĖS;6095020718;Taip;0;1;0;1
1673;Drevinukas;BITUTĖS;1099462840;Taip;0;0;5;5
1674;Drevinukas;BITUTĖS;1152161183;Taip;3;2;1;6
1675;Drevinukas;BITUTĖS;8611131264;Taip;0;13;0;13
1676;Drevinukas;BITUTĖS;8936058501;Taip;8;3;0;11
1677;Drevinukas;BITUTĖS;9772484901;Taip;0;3;1;4
1678;Drevinukas;BITUTĖS;5348609358;Taip;0;0;3;3
1679;Drevinukas;BITUTĖS;1098647410;Taip;5;0;2;7
1680;Drevinukas;BITUTĖS;2312241894;Taip;0;1;8;9
1681;Drevinukas;BITUTĖS;5394143000;Taip;5;3;3;11
1682;Drevinukas;BITUTĖS;3871506691;Taip;0;1;3;4
1683;Drevinukas;BITUTĖS;6914111231;Taip;0;1;3;4
1684;Drevinukas;BITUTĖS;3377957769;Taip;2;1;2;5
1685;Drevinukas;BITUTĖS;2423143170;Taip;0;0;3;3
1686;Drevinukas;BITUTĖS;1343431478;Taip;0;0;4;4
1687;Drevinukas;BITUTĖS;1829421385;Taip;5;3;0;8
1688;Drevinukas;BITUTĖS;8262224710;Taip;0;5;3;8
1689;Drevinukas;BITUTĖS;8479979176;Taip;0;3;0;3
1690;Drevinukas;BITUTĖS;2531207946;Taip;0;3;0;3
1691;Drevinukas;NYKŠTUKAI;8385750920;Taip;0;2;0;2
1692;Drevinukas;NYKŠTUKAI;6165662595;Taip;0;2;0;2
1693;Drevinukas;NYKŠTUKAI;4147987057;Taip;4;5;0;9
1694;Drevinukas;NYKŠTUKAI;6645506336;Taip;10;2;0;12
1695;Drevinukas;NYKŠTUKAI;3240313747;Taip;6;0;3;9
1696;Drevinukas;NYKŠTUKAI;8940838262;Taip;0;1;1;2
1697;Drevinukas;NYKŠTUKAI;8719022482;Taip;0;1;1;2
1698;Drevinukas;NYKŠTUKAI;9695419813;Taip;13;0;4;17
1699;Drevinukas;NYKŠTUKAI;9517560132;Taip;5;3;0;8
1700;Drevinukas;NYKŠTUKAI;6895472558;Taip;0;0;6;6
1701;Drevinukas;NYKŠTUKAI;2039086829;Taip;0;3;0;3
1702;Drevinukas;NYKŠTUKAI;2571295179;Taip;0;9;0;9
1703;Drevinukas;NYKŠTUKAI;2820241608;Taip;0;3;0;3
1704;Drevinukas;NYKŠTUKAI;5999370094;Taip;0;0;4;4
1705;Drevinukas;NYKŠTUKAI;5860361695;Taip;0;0;3;3
1706;Drevinukas;NYKŠTUKAI;9845207619;Taip;18;0;0;18
1707;Drevinukas;NYKŠTUKAI;8694887879;Taip;0;0;2;2
1708;Drevinukas;NYKŠTUKAI;6680003214;Taip;0;0;3;3
1709;Drevinukas;NYKŠTUKAI;3192583690;Ne;0;1;0;1
1710;Drevinukas;NYKŠTUKAI;6659263391;Ne;0;1;0;1
1711;Drevinukas;NYKŠTUKAI;4588368596;Ne;0;0;4;4
1712;Drevinukas;SMALSUČIAI;4242944055;Taip;0;0;6;6
1713;Drevinukas;SMALSUČIAI;1094428951;Taip;0;3;2;5
1714;Drevinukas;SMALSUČIAI;2179736991;Taip;3;8;0;11
1715;Drevinukas;SMALSUČIAI;9105675010;Taip;0;0;4;4
1716;Drevinukas;SMALSUČIAI;9004568476;Taip;0;0;7;7
1717;Drevinukas;SMALSUČIAI;9283862598;Taip;0;0;6;6
1718;Drevinukas;SMALSUČIAI;8578579808;Taip;12;0;0;12
1719;Drevinukas;SMALSUČIAI;3611870655;Taip;5;0;4;9
1720;Drevinukas;SMALSUČIAI;7241671439;Taip;21;0;0;21
1721;Drevinukas;SMALSUČIAI;2246885419;Taip;15;0;1;16
1722;Drevinukas;SMALSUČIAI;4089351543;Taip;10;5;0;15
1723;Drevinukas;SMALSUČIAI;2201342382;Taip;5;0;3;8
1724;Drevinukas;SMALSUČIAI;4759293403;Taip;12;0;0;12
1725;Drevinukas;SMALSUČIAI;7863529560;Taip;0;0;3;3
1726;Drevinukas;SMALSUČIAI;9715586195;Taip;5;0;3;8
1727;Drevinukas;SMALSUČIAI;1368495173;Taip;0;10;0;10
1728;Drevinukas;SMALSUČIAI;8284025903;Taip;5;4;1;10
1729;Drevinukas;SMALSUČIAI;6492987985;Taip;2;0;4;6
1730;Drevinukas;ŽVIRBLIUKAI;7252955092;Taip;0;5;8;13
1731;Drevinukas;ŽVIRBLIUKAI;8654858364;Taip;13;0;1;14
1732;Drevinukas;ŽVIRBLIUKAI;5445104383;Taip;7;0;0;7
1733;Drevinukas;ŽVIRBLIUKAI;2662147175;Taip;11;3;0;14
1734;Drevinukas;ŽVIRBLIUKAI;7801920518;Taip;0;3;15;18
1735;Drevinukas;ŽVIRBLIUKAI;1570356979;Taip;16;0;0;16
1736;Drevinukas;ŽVIRBLIUKAI;9123131368;Taip;8;0;0;8
1737;Drevinukas;ŽVIRBLIUKAI;8877080179;Taip;0;0;1;1
1738;Drevinukas;ŽVIRBLIUKAI;6492711565;Taip;2;0;3;5
1739;Drevinukas;ŽVIRBLIUKAI;2274377462;Taip;0;0;4;4
1740;Drevinukas;ŽVIRBLIUKAI;7316996793;Taip;0;3;0;3
1741;Drevinukas;ŽVIRBLIUKAI;3408981880;Taip;5;0;3;8
1742;Drevinukas;ŽVIRBLIUKAI;8953871512;Taip;8;0;3;11
1743;Drevinukas;ŽVIRBLIUKAI;3983656958;Taip;0;6;0;6
1744;Drevinukas;ŽVIRBLIUKAI;1957961770;Taip;0;0;6;6
1745;Drugelis;NYKŠTUKŲ;9316073597;Taip;0;4;0;4
1746;Drugelis;NYKŠTUKŲ;3551095669;Taip;0;5;0;5
1747;Drugelis;NYKŠTUKŲ;1785724340;Taip;0;5;0;5
1748;Drugelis;NYKŠTUKŲ;6632884258;Taip;4;5;1;10
1749;Drugelis;NYKŠTUKŲ;7447519502;Taip;7;3;0;10
1750;Drugelis;NYKŠTUKŲ;4523513611;Taip;0;3;0;3
1751;Drugelis;NYKŠTUKŲ;6594452094;Taip;0;6;0;6
1752;Drugelis;NYKŠTUKŲ;5122256823;Taip;5;1;0;6
1753;Drugelis;NYKŠTUKŲ;4825232236;Taip;5;2;1;8
1754;Drugelis;NYKŠTUKŲ;7477547789;Taip;0;2;0;2
1755;Drugelis;NYKŠTUKŲ;8717445483;Taip;10;3;0;13
1756;Drugelis;NYKŠTUKŲ;4471405682;Taip;5;0;2;7
1757;Drugelis;NYKŠTUKŲ;4867387611;Taip;8;7;0;15
1758;Drugelis;NYKŠTUKŲ;7609530453;Taip;5;1;5;11
1759;Drugelis;NYKŠTUKŲ;8070030439;Taip;0;4;0;4
1760;Drugelis;NYKŠTUKŲ;3061896520;Taip;0;4;0;4
1761;Drugelis;NYKŠTUKŲ;4927896706;Taip;3;1;0;4
1762;Drugelis;NYKŠTUKŲ;5692743298;Taip;0;1;7;8
1763;Drugelis;NYKŠTUKŲ;6452921695;Taip;0;1;7;8
1764;Drugelis;NYKŠTUKŲ;5902687211;Taip;0;0;3;3
1765;Drugelis;NYKŠTUKŲ;8591548746;Taip;0;6;0;6
1766;Drugelis;SMALSUČIŲ;5121351234;Taip;18;0;0;18
1767;Drugelis;SMALSUČIŲ;5000965458;Taip;26;0;0;26
1768;Drugelis;SMALSUČIŲ;9683350741;Taip;18;0;0;18
1769;Drugelis;SMALSUČIŲ;1617833459;Taip;7;0;0;7
1770;Drugelis;SMALSUČIŲ;4058293462;Taip;0;2;0;2
1771;Drugelis;SMALSUČIŲ;6533325098;Taip;0;3;1;4
1772;Drugelis;SMALSUČIŲ;4805858183;Taip;13;0;0;13
1773;Drugelis;SMALSUČIŲ;9650052415;Taip;9;0;1;10
1774;Drugelis;SMALSUČIŲ;5533529267;Taip;0;4;0;4
1775;Drugelis;SMALSUČIŲ;3733097479;Taip;8;0;1;9
1776;Drugelis;SMALSUČIŲ;2196445523;Taip;5;4;0;9
1777;Drugelis;SMALSUČIŲ;3645668411;Taip;15;1;0;16
1778;Drugelis;SMALSUČIŲ;3261462674;Taip;5;4;0;9
1779;Drugelis;SMALSUČIŲ;8186338261;Taip;0;1;0;1
1780;Drugelis;SMALSUČIŲ;3372145698;Taip;0;1;2;3
1781;Drugelis;SMALSUČIŲ;2644563881;Taip;0;3;0;3
1782;Drugelis;SMALSUČIŲ;6613520046;Taip;6;0;1;7
1783;Drugelis;SMALSUČIŲ;6890441262;Taip;0;6;0;6
1784;Drugelis;MUMINUKŲ;3311620018;Taip;8;0;0;8
1785;Drugelis;MUMINUKŲ;8812550811;Taip;0;5;1;6
1786;Drugelis;MUMINUKŲ;5661335344;Taip;0;4;0;4
1787;Drugelis;MUMINUKŲ;6038184222;Taip;0;3;0;3
1788;Drugelis;MUMINUKŲ;9851124145;Taip;4;3;0;7
1789;Drugelis;MUMINUKŲ;7253876812;Taip;3;0;0;3
1790;Drugelis;MUMINUKŲ;1816845006;Taip;3;3;0;6
1791;Drugelis;MUMINUKŲ;1666992752;Taip;13;3;0;16
1792;Drugelis;MUMINUKŲ;9510744779;Taip;5;3;0;8
1793;Drugelis;MUMINUKŲ;9029137302;Taip;4;3;0;7
1794;Drugelis;MUMINUKŲ;9907121223;Taip;8;3;0;11
1795;Drugelis;MUMINUKŲ;8500348389;Taip;0;2;2;4
1796;Drugelis;MUMINUKŲ;1858504360;Taip;17;0;0;17
1797;Drugelis;MUMINUKŲ;8366330478;Taip;0;6;0;6
1798;Drugelis;MUMINUKŲ;8107970910;Taip;0;3;1;4
1799;Drugelis;MUMINUKŲ;5515894973;Taip;6;3;0;9
1800;Drugelis;MUMINUKŲ;8282807535;Taip;0;3;0;3
1801;Drugelis;MUMINUKŲ;3293212749;Taip;0;3;0;3
1802;Drugelis;MUMINUKŲ;2256221485;Taip;7;2;0;9
1803;Drugelis;MUMINUKŲ;9588931333;Taip;14;0;0;14
1804;Drugelis;MUMINUKŲ;3176174057;Taip;0;1;0;1
1805;Drugelis;MUMINUKŲ;1761596625;Taip;17;0;0;17
1806;Drugelis;PŪKUOTUKAI;9149748841;Taip;0;5;3;8
1807;Drugelis;PŪKUOTUKAI;1217635751;Taip;0;3;8;11
1808;Drugelis;PŪKUOTUKAI;9612696781;Taip;2;8;0;10
1809;Drugelis;PŪKUOTUKAI;1888002607;Taip;0;5;0;5
1810;Drugelis;PŪKUOTUKAI;27569805506;Taip;0;8;0;8
1811;Drugelis;PŪKUOTUKAI;1961898730;Taip;0;3;0;3
1812;Drugelis;PŪKUOTUKAI;7406396614;Taip;0;2;0;2
1813;Drugelis;PŪKUOTUKAI;1901608445;Taip;0;9;0;9
1814;Drugelis;PŪKUOTUKAI;1506988472;Taip;0;3;0;3
1815;Drugelis;PŪKUOTUKAI;1991420008;Taip;0;3;0;3
1816;Drugelis;PŪKUOTUKAI;1255124184;Taip;0;3;1;4
1817;Drugelis;PŪKUOTUKAI;1856912386;Taip;0;7;0;7
1818;Drugelis;PŪKUOTUKAI;1576853049;Taip;2;3;1;6
1819;Drugelis;PŪKUOTUKAI;68223183150;Taip;0;5;0;5
1820;Drugelis;PŪKUOTUKAI;3202149560;Taip;0;5;0;5
1821;Drugelis;PŪKUOTUKAI;1421438458;Taip;0;7;0;7
1822;Drugelis;PŪKUOTUKAI;5954059321;Taip;10;3;0;13
1823;Drugelis;PŪKUOTUKAI;1541276266;Taip;0;3;1;4
1824;Drugelis;PŪKUOTUKAI;53874036107;Taip;0;3;0;3
1825;Drugelis;PŪKUOTUKAI;4788423265;Taip;0;2;0;2
1826;Drugelis;PŪKUOTUKAI;3096906506;Taip;0;4;0;4
1827;Drugelis;SPINDULIUKAI;3081918342;Taip;0;0;9;9
1828;Drugelis;SPINDULIUKAI;3560294703;Taip;18;0;1;19
1829;Drugelis;SPINDULIUKAI;1215586620;Taip;0;0;3;3
1830;Drugelis;SPINDULIUKAI;9005448398;Taip;18;0;0;18
1831;Drugelis;SPINDULIUKAI;2926662708;Taip;4;0;0;4
1832;Drugelis;SPINDULIUKAI;6504082488;Taip;0;4;0;4
1833;Drugelis;SPINDULIUKAI;7321544601;Taip;3;2;2;7
1834;Drugelis;SPINDULIUKAI;9296067137;Taip;13;5;0;18
1835;Drugelis;SPINDULIUKAI;9855121078;Taip;18;0;0;18
1836;Drugelis;SPINDULIUKAI;6068102133;Taip;3;6;0;9
1837;Drugelis;SPINDULIUKAI;7825151440;Taip;5;1;0;6
1838;Drugelis;SPINDULIUKAI;4812322553;Taip;6;7;0;13
1839;Drugelis;SPINDULIUKAI;6032568621;Taip;0;5;3;8
1840;Drugelis;SPINDULIUKAI;4580456500;Taip;9;0;0;9
1841;Drugelis;SPINDULIUKAI;8259051898;Taip;13;2;0;15
1842;Drugelis;SPINDULIUKAI;3567930528;Taip;13;2;0;15
1843;Drugelis;SPINDULIUKAI;2573357635;Taip;5;0;5;10
1844;Drugelis;KIŠKUČIAI;3603051567;Taip;1;0;0;1
1845;Drugelis;KIŠKUČIAI;4628926113;Taip;2;6;0;8
1846;Drugelis;KIŠKUČIAI;7307032077;Taip;0;7;0;7
1847;Drugelis;KIŠKUČIAI;1213610973;Taip;8;1;2;11
1848;Drugelis;KIŠKUČIAI;9211760307;Taip;3;0;2;5
1849;Drugelis;KIŠKUČIAI;6071997970;Taip;15;3;0;18
1850;Drugelis;KIŠKUČIAI;8819853863;Taip;10;3;0;13
1851;Drugelis;KIŠKUČIAI;5950704328;Taip;0;3;0;3
1852;Drugelis;KIŠKUČIAI;9900296726;Taip;9;0;1;10
1853;Drugelis;KIŠKUČIAI;4898099506;Taip;0;1;0;1
1854;Drugelis;KIŠKUČIAI;6997707085;Taip;0;2;0;2
1855;Drugelis;KIŠKUČIAI;1375535260;Taip;0;0;1;1
1856;Drugelis;KIŠKUČIAI;5857726963;Taip;0;4;1;5
1857;Drugelis;KIŠKUČIAI;1817932444;Taip;5;0;5;10
1858;Drugelis;KIŠKUČIAI;8891228382;Taip;0;0;1;1
1859;"Du gaideliai";Uodelių;8896316882;Taip;1;1;0;2
1860;"Du gaideliai";Uodelių;6704167983;Taip;7;2;0;9
1861;"Du gaideliai";Uodelių;6942798420;Taip;0;8;0;8
1862;"Du gaideliai";Uodelių;8420400705;Taip;3;5;0;8
1863;"Du gaideliai";Uodelių;2826490663;Taip;0;0;3;3
1864;"Du gaideliai";Uodelių;4157021754;Taip;0;0;7;7
1865;"Du gaideliai";Uodelių;7193151965;Taip;3;8;0;11
1866;"Du gaideliai";Uodelių;1968978650;Taip;0;0;3;3
1867;"Du gaideliai";Uodelių;2564259600;Taip;0;0;2;2
1868;"Du gaideliai";Uodelių;6132405512;Taip;0;10;0;10
1869;"Du gaideliai";Uodelių;2756525592;Taip;0;3;0;3
1870;"Du gaideliai";Uodelių;7563789811;Taip;2;0;0;2
1871;"Du gaideliai";Uodelių;9126780620;Taip;0;2;0;2
1872;"Du gaideliai";Uodelių;9374869616;Taip;0;1;0;1
1873;"Du gaideliai";Uodelių;5726096980;Taip;9;0;3;12
1874;"Du gaideliai";Uodelių;4408537397;Taip;0;3;0;3
1875;"Du gaideliai";Uodelių;1527839162;Taip;13;3;0;16
1876;"Du gaideliai";Uodelių;5809089345;Taip;0;4;0;4
1877;"Du gaideliai";Uodelių;8174023197;Taip;5;5;0;10
1878;"Du gaideliai";Uodelių;7372149799;Taip;4;5;0;9
1879;"Du gaideliai";Uodelių;5291934919;Taip;6;10;0;16
1880;"Du gaideliai";OŽIUKŲ;8744467866;Taip;10;0;2;12
1881;"Du gaideliai";OŽIUKŲ;7033276798;Taip;0;5;0;5
1882;"Du gaideliai";OŽIUKŲ;5788923258;Taip;0;10;0;10
1883;"Du gaideliai";OŽIUKŲ;8042203623;Taip;0;15;0;15
1884;"Du gaideliai";OŽIUKŲ;2100449108;Taip;6;0;3;9
1885;"Du gaideliai";OŽIUKŲ;7575534590;Taip;0;7;0;7
1886;"Du gaideliai";OŽIUKŲ;3019797369;Taip;11;1;0;12
1887;"Du gaideliai";OŽIUKŲ;9356275460;Taip;8;4;5;17
1888;"Du gaideliai";OŽIUKŲ;6204233540;Taip;0;16;0;16
1889;"Du gaideliai";OŽIUKŲ;2845145754;Taip;10;9;0;19
1890;"Du gaideliai";OŽIUKŲ;7726490359;Taip;5;4;2;11
1891;"Du gaideliai";OŽIUKŲ;6762171696;Taip;5;3;0;8
1892;"Du gaideliai";OŽIUKŲ;5728374219;Taip;0;5;0;5
1893;"Du gaideliai";OŽIUKŲ;5611102395;Ne;7;8;0;15
1894;"Du gaideliai";OŽIUKŲ;8410547195;Taip;0;6;0;6
1895;"Du gaideliai";OŽIUKŲ;2905083899;Taip;19;0;0;19
1896;"Du gaideliai";OŽIUKŲ;9585785202;Taip;5;18;0;23
1897;"Du gaideliai";OŽIUKŲ;2151825222;Taip;0;10;0;10
1898;"Du gaideliai";OŽIUKŲ;8043896286;Taip;10;0;2;12
1899;"Du gaideliai";OŽIUKŲ;6053941133;Taip;5;4;0;9
1900;"Du gaideliai";OŽIUKŲ;6120647567;Taip;10;3;0;13
1901;"Du gaideliai";OŽIUKŲ;5668878259;Taip;1;5;0;6
1902;"Du gaideliai";Vištyčių;3370029981;Taip;0;3;0;3
1903;"Du gaideliai";Vištyčių;2240947701;Taip;5;4;0;9
1904;"Du gaideliai";Vištyčių;3507387826;Taip;0;6;0;6
1905;"Du gaideliai";Vištyčių;4144269068;Taip;10;5;0;15
1906;"Du gaideliai";Vištyčių;1785976627;Taip;0;0;5;5
1907;"Du gaideliai";Vištyčių;8047413507;Taip;0;4;0;4
1908;"Du gaideliai";Vištyčių;9568647033;Taip;0;3;1;4
1909;"Du gaideliai";Vištyčių;5894974508;Taip;0;7;0;7
1910;"Du gaideliai";Vištyčių;5998344519;Taip;7;3;0;10
1911;"Du gaideliai";Vištyčių;6247706405;Taip;5;0;1;6
1912;"Du gaideliai";Vištyčių;1751328192;Taip;4;4;0;8
1913;"Du gaideliai";Vištyčių;5652662610;Taip;0;3;1;4
1914;"Du gaideliai";Vištyčių;6870356241;Taip;12;0;0;12
1915;"Du gaideliai";Vištyčių;5103483956;Taip;8;0;0;8
1916;"Du gaideliai";Vištyčių;6348951959;Taip;10;0;0;10
1917;"Du gaideliai";Vištyčių;1268479215;Taip;0;2;0;2
1918;"Du gaideliai";Vištyčių;3854355215;Taip;0;0;16;16
1919;"Du gaideliai";Vištyčių;3849899284;Taip;0;3;0;3
1920;"Du gaideliai";Vištyčių;2262425557;Taip;7;0;0;7
1921;"Du gaideliai";GAIDŽIUKŲ;1758546983;Taip;4;8;0;12
1922;"Du gaideliai";GAIDŽIUKŲ;7783203480;Taip;0;3;0;3
1923;"Du gaideliai";GAIDŽIUKŲ;94639433266;Taip;0;7;0;7
1924;"Du gaideliai";GAIDŽIUKŲ;9324740716;Taip;0;5;0;5
1925;"Du gaideliai";GAIDŽIUKŲ;6715434585;Taip;5;5;1;11
1926;"Du gaideliai";GAIDŽIUKŲ;7084763712;Taip;0;3;0;3
1927;"Du gaideliai";GAIDŽIUKŲ;1500684755;Taip;0;7;0;7
1928;"Du gaideliai";GAIDŽIUKŲ;6750787450;Taip;0;7;0;7
1929;"Du gaideliai";GAIDŽIUKŲ;5430986033;Taip;0;3;1;4
1930;"Du gaideliai";GAIDŽIUKŲ;27733314504;Taip;0;6;0;6
1931;"Du gaideliai";GAIDŽIUKŲ;1074783418;Taip;5;0;0;5
1932;"Du gaideliai";GAIDŽIUKŲ;5167460184;Taip;0;5;0;5
1933;"Du gaideliai";GAIDŽIUKŲ;1549762923;Taip;0;2;0;2
1934;"Du gaideliai";GAIDŽIUKŲ;3771563320;Taip;4;3;0;7
1935;"Du gaideliai";GAIDŽIUKŲ;6203383711;Taip;3;3;0;6
1936;"Du gaideliai";GAIDŽIUKŲ;6170362846;Taip;5;0;0;5
1937;"Du gaideliai";GAIDŽIUKŲ;1962859229;Taip;0;4;0;4
1938;"Du gaideliai";GAIDŽIUKŲ;7373413569;Taip;0;10;0;10
1939;"Du gaideliai";GAIDŽIUKŲ;1557413692;Taip;0;3;0;3
1940;"Du gaideliai";GAIDŽIUKŲ;3273574176;Taip;0;3;0;3
1941;"Du gaideliai";GAIDŽIUKŲ;7471332824;Taip;0;13;0;13
1942;"Du gaideliai";GAIDŽIUKŲ;4378924981;Taip;5;4;0;9
1943;"Du gaideliai";Musyčių;9506572113;Taip;0;4;0;4
1944;"Du gaideliai";Musyčių;6224116229;Taip;12;0;1;13
1945;"Du gaideliai";Musyčių;6630053388;Taip;0;0;11;11
1946;"Du gaideliai";Musyčių;5867716168;Taip;9;1;0;10
1947;"Du gaideliai";Musyčių;3654057453;Taip;7;2;0;9
1948;"Du gaideliai";Musyčių;8921985681;Taip;0;14;4;18
1949;"Du gaideliai";Musyčių;1882241729;Taip;14;0;1;15
1950;"Du gaideliai";Musyčių;5225949099;Taip;5;1;3;9
1951;"Du gaideliai";Musyčių;4204930257;Taip;5;0;1;6
1952;"Du gaideliai";Musyčių;3206388799;Taip;6;6;0;12
1953;"Du gaideliai";Musyčių;2616106413;Taip;7;3;0;10
1954;"Du gaideliai";Musyčių;2084660815;Taip;5;0;0;5
1955;"Du gaideliai";Musyčių;9934568135;Taip;14;7;0;21
1956;"Du gaideliai";Musyčių;4799107717;Taip;0;5;0;5
1957;"Du gaideliai";Musyčių;8624394105;Taip;8;14;4;26
1958;"Du gaideliai";Musyčių;2122841302;Taip;5;10;3;18
1959;"Du gaideliai";Musyčių;7153424410;Taip;0;6;0;6
1960;"Du gaideliai";Musyčių;4557902728;Taip;1;0;9;10
1961;"Du gaideliai";Musyčių;5514521078;Taip;0;10;0;10
1962;"Du gaideliai";MALŪNO;9561040908;Taip;8;0;0;8
1963;"Du gaideliai";MALŪNO;1048130675;Taip;10;4;2;16
1964;"Du gaideliai";MALŪNO;3601150560;Taip;0;8;0;8
1965;"Du gaideliai";MALŪNO;1777283565;Taip;15;0;1;16
1966;"Du gaideliai";MALŪNO;1940981083;Taip;7;0;4;11
1967;"Du gaideliai";MALŪNO;5113352673;Taip;5;3;2;10
1968;"Du gaideliai";MALŪNO;9477645505;Taip;9;0;4;13
1969;"Du gaideliai";MALŪNO;5142411841;Taip;5;0;1;6
1970;"Du gaideliai";MALŪNO;7855653537;Taip;0;3;0;3
1971;"Du gaideliai";MALŪNO;9832883242;Taip;8;0;6;14
1972;"Du gaideliai";MALŪNO;9619723983;Taip;5;0;0;5
1973;"Du gaideliai";MALŪNO;5016914497;Taip;8;0;3;11
1974;"Du gaideliai";MALŪNO;5060904810;Taip;10;0;0;10
1975;"Du gaideliai";MALŪNO;4759244471;Taip;8;0;0;8
1976;"Du gaideliai";MALŪNO;6054058539;Taip;8;4;0;12
1977;Eglutė;RAMUNĖ;1422631723;Taip;5;12;0;17
1978;Eglutė;RAMUNĖ;6709551046;Taip;0;3;0;3
1979;Eglutė;RAMUNĖ;6093932811;Taip;0;4;2;6
1980;Eglutė;RAMUNĖ;2651867769;Taip;0;6;2;8
1981;Eglutė;RAMUNĖ;3473388722;Taip;0;3;0;3
1982;Eglutė;RAMUNĖ;2597978713;Taip;0;9;0;9
1983;Eglutė;RAMUNĖ;4451772812;Taip;0;0;4;4
1984;Eglutė;RAMUNĖ;8493750509;Taip;4;0;3;7
1985;Eglutė;RAMUNĖ;9929681000;Taip;0;0;5;5
1986;Eglutė;RAMUNĖ;6105927493;Taip;6;0;1;7
1987;Eglutė;RAMUNĖ;1048451048;Taip;0;3;0;3
1988;Eglutė;RAMUNĖ;6142326330;Ne;0;12;0;12
1989;Eglutė;RAMUNĖ;9728550000;Taip;0;0;4;4
1990;Eglutė;RAMUNĖ;1534556744;Taip;6;2;1;9
1991;Eglutė;RAMUNĖ;4047404616;Taip;0;3;0;3
1992;Eglutė;RAMUNĖ;4230594049;Taip;5;1;2;8
1993;Eglutė;RAMUNĖ;2998190195;Taip;0;3;0;3
1994;Eglutė;RAMUNĖ;9402686801;Taip;0;0;8;8
1995;Eglutė;RAMUNĖ;6279703448;Ne;0;12;0;12
1996;Eglutė;RAMUNĖ;7598993411;Taip;0;3;0;3
1997;Eglutė;PELĖDŽIUKAI;7149060118;Taip;0;4;0;4
1998;Eglutė;PELĖDŽIUKAI;8606991706;Taip;6;3;0;9
1999;Eglutė;PELĖDŽIUKAI;6518497374;Taip;5;5;0;10
2000;Eglutė;PELĖDŽIUKAI;3203786388;Taip;0;3;0;3
2001;Eglutė;PELĖDŽIUKAI;8033370429;Taip;10;3;0;13
2002;Eglutė;PELĖDŽIUKAI;3178489517;Taip;0;3;12;15
2003;Eglutė;PELĖDŽIUKAI;3393414294;Taip;0;3;0;3
2004;Eglutė;PELĖDŽIUKAI;1510706652;Taip;0;3;1;4
2005;Eglutė;PELĖDŽIUKAI;1695732622;Taip;7;3;1;11
2006;Eglutė;PELĖDŽIUKAI;9333028072;Taip;0;3;1;4
2007;Eglutė;PELĖDŽIUKAI;5856250605;Taip;0;5;0;5
2008;Eglutė;PELĖDŽIUKAI;2638807860;Taip;0;3;0;3
2009;Eglutė;PELĖDŽIUKAI;2082716398;Taip;0;5;1;6
2010;Eglutė;PELĖDŽIUKAI;3616979217;Taip;0;4;0;4
2011;Eglutė;PELĖDŽIUKAI;9950953029;Taip;0;5;0;5
2012;Eglutė;PELĖDŽIUKAI;6835296034;Taip;0;5;0;5
2013;Eglutė;PELĖDŽIUKAI;7148210944;Taip;0;7;0;7
2014;Eglutė;PELĖDŽIUKAI;1324622835;Taip;5;3;3;11
2015;Eglutė;PELĖDŽIUKAI;1209962222;Taip;0;1;0;1
2016;Eglutė;PELĖDŽIUKAI;3275796441;Taip;0;3;3;6
2017;Eglutė;PELĖDŽIUKAI;3390360525;Taip;0;3;0;3
2018;Eglutė;PELĖDŽIUKAI;6544877723;Taip;0;3;0;3
2019;Eglutė;KODĖLČIUKAI;4490295754;Ne;0;4;0;4
2020;Eglutė;KODĖLČIUKAI;1932785408;Taip;0;3;0;3
2021;Eglutė;KODĖLČIUKAI;3883122650;Taip;0;7;0;7
2022;Eglutė;KODĖLČIUKAI;7859815752;Taip;0;3;0;3
2023;Eglutė;KODĖLČIUKAI;4176597208;Taip;0;4;0;4
2024;Eglutė;KODĖLČIUKAI;7758643349;Taip;0;3;1;4
2025;Eglutė;KODĖLČIUKAI;6483580751;Taip;0;8;0;8
2026;Eglutė;KODĖLČIUKAI;5924994736;Taip;0;3;0;3
2027;Eglutė;KODĖLČIUKAI;1759383841;Taip;0;8;0;8
2028;Eglutė;KODĖLČIUKAI;6597261061;Taip;0;13;0;13
2029;Eglutė;KODĖLČIUKAI;9046652370;Taip;0;3;4;7
2030;Eglutė;KODĖLČIUKAI;9356785605;Taip;0;9;0;9
2031;Eglutė;KODĖLČIUKAI;8943684351;Taip;7;3;0;10
2032;Eglutė;KODĖLČIUKAI;8165126017;Taip;0;3;0;3
2033;Eglutė;KODĖLČIUKAI;9967488317;Taip;0;3;0;3
2034;Eglutė;KODĖLČIUKAI;3584247594;Taip;0;5;0;5
2035;Eglutė;KODĖLČIUKAI;9758104910;Ne;0;18;0;18
2036;Eglutė;KODĖLČIUKAI;1531942494;Taip;0;6;0;6
2037;Eglutė;KODĖLČIUKAI;4635123721;Taip;0;3;0;3
2038;Eglutė;KODĖLČIUKAI;9515238936;Taip;5;3;0;8
2039;Eglutė;KODĖLČIUKAI;5840014240;Taip;0;6;0;6
2040;Eglutė;KODĖLČIUKAI;5678727198;Taip;0;4;2;6
2041;Eglutė;OBUOLIUKAI;3799824061;Taip;0;7;0;7
2042;Eglutė;OBUOLIUKAI;1744942011;Taip;0;8;0;8
2043;Eglutė;OBUOLIUKAI;7027121333;Taip;0;3;0;3
2044;Eglutė;OBUOLIUKAI;6679186715;Taip;9;0;2;11
2045;Eglutė;OBUOLIUKAI;8655425408;Taip;9;1;0;10
2046;Eglutė;OBUOLIUKAI;3387392137;Taip;0;1;0;1
2047;Eglutė;OBUOLIUKAI;8384141923;Taip;0;3;0;3
2048;Eglutė;OBUOLIUKAI;3112281182;Ne;0;2;12;14
2049;Eglutė;OBUOLIUKAI;1432716037;Taip;0;4;0;4
2050;Eglutė;OBUOLIUKAI;4876032787;Taip;0;1;0;1
2051;Eglutė;OBUOLIUKAI;9542684993;Taip;0;2;0;2
2052;Eglutė;OBUOLIUKAI;6967074765;Taip;5;4;0;9
2053;Eglutė;OBUOLIUKAI;9054104040;Taip;7;3;0;10
2054;Eglutė;OBUOLIUKAI;9193920390;Taip;0;5;0;5
2055;Eglutė;OBUOLIUKAI;8246870069;Taip;0;5;3;8
2056;Eglutė;OBUOLIUKAI;1380219881;Taip;0;3;0;3
2057;Eglutė;OBUOLIUKAI;8721209423;Taip;7;4;0;11
2058;Eglutė;OBUOLIUKAI;1774538642;Taip;0;0;3;3
2059;Eglutė;OBUOLIUKAI;3903612086;Taip;0;4;0;4
2060;Eglutė;OBUOLIUKAI;7789753835;Taip;6;2;0;8
2061;Eglutė;KAŠTONAS;4099257155;Taip;3;3;3;9
2062;Eglutė;KAŠTONAS;6009794480;Taip;0;6;0;6
2063;Eglutė;KAŠTONAS;6539887315;Taip;0;4;0;4
2064;Eglutė;KAŠTONAS;7234851379;Taip;0;6;0;6
2065;Eglutė;KAŠTONAS;5636437290;Taip;0;2;1;3
2066;Eglutė;KAŠTONAS;5190045146;Taip;0;3;0;3
2067;Eglutė;KAŠTONAS;1842517164;Taip;7;0;5;12
2068;Eglutė;KAŠTONAS;7703290039;Taip;0;2;0;2
2069;Eglutė;KAŠTONAS;7530638623;Taip;0;6;0;6
2070;Eglutė;KAŠTONAS;2121177107;Taip;0;0;2;2
2071;Eglutė;KAŠTONAS;2357276888;Taip;0;0;6;6
2072;Eglutė;KAŠTONAS;2816913563;Taip;0;2;0;2
2073;Eglutė;KAŠTONAS;7098548563;Taip;8;0;0;8
2074;Eglutė;KAŠTONAS;6146679388;Taip;4;5;0;9
2075;Eglutė;KAŠTONAS;5166183300;Taip;0;7;0;7
2076;Eglutė;KAŠTONAS;7984911632;Taip;13;6;0;19
2077;Eglutė;KAŠTONAS;7811667336;Taip;0;2;0;2
2078;Eglutė;EŽIUKAI;7491022301;Taip;0;3;0;3
2079;Eglutė;EŽIUKAI;5943856319;Taip;0;5;0;5
2080;Eglutė;EŽIUKAI;1050313582;Taip;6;1;0;7
2081;Eglutė;EŽIUKAI;1436966647;Taip;0;4;3;7
2082;Eglutė;EŽIUKAI;6891834971;Taip;0;5;0;5
2083;Eglutė;EŽIUKAI;7307564177;Taip;0;7;1;8
2084;Eglutė;EŽIUKAI;7823828202;Taip;0;2;0;2
2085;Eglutė;EŽIUKAI;7354260503;Ne;0;3;0;3
2086;Eglutė;EŽIUKAI;9439309687;Taip;0;5;1;6
2087;Eglutė;EŽIUKAI;1122308715;Taip;0;3;1;4
2088;Eglutė;EŽIUKAI;8523618773;Ne;0;11;0;11
2089;Eglutė;EŽIUKAI;3856651647;Taip;0;5;0;5
2090;Eglutė;EŽIUKAI;8421062747;Taip;6;4;0;10
2091;Eglutė;EŽIUKAI;9992438336;Taip;0;4;0;4
2092;Eglutė;EŽIUKAI;5731355126;Taip;0;4;1;5
2093;Eglutė;EŽIUKAI;8364693548;Taip;0;7;0;7
2094;Eglutė;EŽIUKAI;3081691175;Taip;0;2;0;2
2095;Eglutė;EŽIUKAI;1265463853;Taip;0;3;0;3
2096;Eglutė;EŽIUKAI;1908835124;Ne;0;3;0;3
2097;Eglutė;EŽIUKAI;1321901982;Taip;0;6;0;6
2098;Eglutė;EŽIUKAI;9527732584;Taip;0;3;0;3
2099;Eglutė;EŽIUKAI;8162972897;Taip;0;5;0;5
2100;Eglutė;EŽIUKAI;4348313801;Taip;0;7;2;9
2101;Eglutė;EŽIUKAI;9042793284;Taip;0;4;0;4
2102;Eglutė;GILĖ;1550045866;Taip;0;6;2;8
2103;Eglutė;GILĖ;8325288373;Taip;0;7;2;9
2104;Eglutė;GILĖ;6272115803;Taip;0;1;0;1
2105;Eglutė;GILĖ;6550999480;Taip;0;8;0;8
2106;Eglutė;GILĖ;2857760751;Taip;0;0;1;1
2107;Eglutė;GILĖ;5650957826;Taip;0;2;1;3
2108;Eglutė;GILĖ;8129230197;Taip;0;7;0;7
2109;Eglutė;GILĖ;1835565594;Taip;0;3;0;3
2110;Eglutė;GILĖ;1393626624;Taip;0;4;1;5
2111;Eglutė;GILĖ;3740322448;Taip;0;4;0;4
2112;Eglutė;GILĖ;9746021019;Taip;0;5;0;5
2113;Eglutė;GILĖ;1814323427;Taip;5;0;9;14
2114;Eglutė;GILĖ;5013664843;Taip;0;2;3;5
2115;Eglutė;GILĖ;2276311106;Taip;0;5;0;5
2116;Eglutė;GILĖ;6924344686;Taip;0;2;0;2
2117;Eglutė;GILĖ;5645197324;Taip;0;3;0;3
2118;Eglutė;GILĖ;7800243796;Taip;0;0;5;5
2119;Eglutė;GILĖ;9098132159;Taip;0;3;1;4
2120;Eglutė;GILĖ;2615824395;Taip;4;3;0;7
2121;Eglutė;GILĖ;1899379269;Taip;5;1;2;8
2122;Eglutė;GILĖ;3605053253;Taip;10;3;0;13
2123;Eglutė;SAULUTĖ;9741776217;Taip;0;7;0;7
2124;Eglutė;SAULUTĖ;5285593057;Taip;0;3;0;3
2125;Eglutė;SAULUTĖ;3091324735;Taip;0;3;0;3
2126;Eglutė;SAULUTĖ;8739346084;Taip;0;13;0;13
2127;Eglutė;SAULUTĖ;5518570006;Taip;0;9;0;9
2128;Eglutė;SAULUTĖ;5805450838;Taip;0;2;3;5
2129;Eglutė;SAULUTĖ;9084576953;Ne;5;3;9;17
2130;Eglutė;SAULUTĖ;6309529738;Taip;2;3;0;5
2131;Eglutė;SAULUTĖ;2259077568;Ne;0;3;0;3
2132;Eglutė;SAULUTĖ;4489150480;Taip;12;2;0;14
2133;Eglutė;SAULUTĖ;2425927050;Ne;5;13;0;18
2134;Eglutė;SAULUTĖ;3006381069;Taip;0;3;0;3
2135;Eglutė;SAULUTĖ;5918429438;Taip;5;0;3;8
2136;Eglutė;SAULUTĖ;5006042568;Taip;0;3;0;3
2137;Eglutė;SAULUTĖ;5275306818;Taip;0;0;9;9
2138;Eglutė;SAULUTĖ;2621445549;Taip;5;3;0;8
2139;Eglutė;SAULUTĖ;6328900251;Taip;0;3;0;3
2140;Eglutė;SAULUTĖ;9661883776;Taip;0;2;0;2
2141;Eglutė;SAULUTĖ;5505398901;Taip;0;3;0;3
2142;Eglutė;SAULUTĖ;8799063905;Taip;0;5;0;5
2143;Eglutė;SAULUTĖ;5108928996;Taip;0;3;2;5
2144;Eglutė;SAULUTĖ;6572235324;Taip;0;9;0;9
2145;Eglutė;SAULUTĖ;1923176808;Ne;0;3;0;3
2146;Eglutė;SAULUTĖ;2872597971;Taip;13;3;0;16
2147;Eglutė;SAULUTĖ;6424893248;Taip;0;5;0;5
2148;Eglutė;SAULUTĖ;3690266358;Taip;10;3;0;13
2149;Eglutė;ŠARKELĖ;7831541089;Taip;8;1;0;9
2150;Eglutė;ŠARKELĖ;3430016771;Taip;13;4;0;17
2151;Eglutė;ŠARKELĖ;6382927775;Taip;4;5;0;9
2152;Eglutė;ŠARKELĖ;7919553451;Taip;0;3;0;3
2153;Eglutė;ŠARKELĖ;7658345479;Taip;0;6;0;6
2154;Eglutė;ŠARKELĖ;7229612001;Ne;5;3;1;9
2155;Eglutė;ŠARKELĖ;4932945207;Taip;0;10;8;18
2156;Eglutė;ŠARKELĖ;5407757245;Taip;3;3;0;6
2157;Eglutė;ŠARKELĖ;3237476593;Taip;0;4;0;4
2158;Eglutė;ŠARKELĖ;9542103745;Taip;0;0;4;4
2159;Eglutė;ŠARKELĖ;3848175048;Taip;0;1;0;1
2160;Eglutė;ŠARKELĖ;1122907387;Taip;0;1;2;3
2161;Eglutė;ŠARKELĖ;9686836846;Taip;0;1;0;1
2162;Eglutė;ŠARKELĖ;7735192219;Taip;0;5;0;5
2163;Eglutė;ŠARKELĖ;5779671024;Taip;0;0;4;4
2164;Eglutė;ŠARKELĖ;5783776734;Taip;0;10;0;10
2165;Eglutė;ŠARKELĖ;4490541539;Taip;14;0;2;16
2166;Eglutė;ŠARKELĖ;3719202688;Taip;0;1;0;1
2167;Eglutė;ŠARKELĖ;6653111225;Taip;10;0;1;11
2168;Eglutė;NYKŠTUKAI;3011330968;Taip;0;4;0;4
2169;Eglutė;NYKŠTUKAI;8037564034;Taip;0;11;0;11
2170;Eglutė;NYKŠTUKAI;3368734808;Taip;8;0;0;8
2171;Eglutė;NYKŠTUKAI;8749425471;Taip;0;6;0;6
2172;Eglutė;NYKŠTUKAI;4151258155;Taip;0;0;10;10
2173;Eglutė;NYKŠTUKAI;6965837585;Taip;0;0;3;3
2174;Eglutė;NYKŠTUKAI;5103022009;Taip;0;4;0;4
2175;Eglutė;NYKŠTUKAI;8542684582;Taip;0;0;14;14
2176;Eglutė;NYKŠTUKAI;3091697091;Taip;0;3;1;4
2177;Eglutė;NYKŠTUKAI;4823811890;Taip;4;5;0;9
2178;Eglutė;NYKŠTUKAI;9292940501;Taip;5;3;3;11
2179;Eglutė;NYKŠTUKAI;3210398495;Taip;6;3;0;9
2180;Eglutė;NYKŠTUKAI;7313013331;Taip;0;0;3;3
2181;Eglutė;NYKŠTUKAI;3051637136;Taip;0;1;0;1
2182;Eglutė;NYKŠTUKAI;4056836413;Taip;0;1;0;1
2183;Eglutė;NYKŠTUKAI;5810733285;Taip;11;0;0;11
2184;Eglutė;NYKŠTUKAI;3089527202;Taip;0;0;3;3
2185;Eglutė;NYKŠTUKAI;2669400743;Taip;3;3;0;6
2186;Eglutė;NYKŠTUKAI;9845413768;Taip;0;0;15;15
2187;Eglutė;NYKŠTUKAI;1460628870;Taip;0;0;3;3
2188;Eglutė;NYKŠTUKAI;4427853197;Taip;0;2;0;2
2189;Eglutė;ŽIRNIUKAI;3706904006;Taip;0;5;0;5
2190;Eglutė;ŽIRNIUKAI;8698242107;Taip;0;18;0;18
2191;Eglutė;ŽIRNIUKAI;2666894761;Taip;0;3;0;3
2192;Eglutė;ŽIRNIUKAI;4465995209;Taip;0;2;0;2
2193;Eglutė;ŽIRNIUKAI;9795027066;Ne;0;9;2;11
2194;Eglutė;ŽIRNIUKAI;4539946535;Taip;2;0;7;9
2195;Eglutė;ŽIRNIUKAI;4697026463;Taip;11;3;0;14
2196;Eglutė;ŽIRNIUKAI;3974970972;Taip;0;4;0;4
2197;Eglutė;ŽIRNIUKAI;9381529574;Taip;12;3;0;15
2198;Eglutė;ŽIRNIUKAI;7256251859;Taip;0;4;0;4
2199;Eglutė;ŽIRNIUKAI;1630732306;Ne;0;3;1;4
2200;Eglutė;BORUŽIUKAI;5592515139;Taip;6;0;0;6
2201;Eglutė;BORUŽIUKAI;9964146295;Taip;0;1;0;1
2202;Eglutė;BORUŽIUKAI;1630903587;Taip;0;12;0;12
2203;Eglutė;BORUŽIUKAI;7254436716;Taip;0;8;0;8
2204;Eglutė;BORUŽIUKAI;5982037450;Taip;3;0;0;3
2205;Eglutė;BORUŽIUKAI;7994301287;Taip;0;5;0;5
2206;Eglutė;BORUŽIUKAI;9300315869;Taip;11;0;2;13
2207;Eglutė;BORUŽIUKAI;7231828805;Taip;0;15;0;15
2208;Eglutė;BORUŽIUKAI;5704418881;Taip;21;0;0;21
2209;Eglutė;BORUŽIUKAI;8410302338;Taip;13;0;0;13
2210;Eglutė;BORUŽIUKAI;1667851586;Taip;12;0;0;12
2211;Eglutė;BORUŽIUKAI;1715411901;Taip;10;3;5;18
2212;Eglutė;BORUŽIUKAI;9875724921;Taip;0;0;4;4
2213;Eglutė;BORUŽIUKAI;7564179845;Taip;0;3;0;3
2214;Eglutė;BORUŽIUKAI;9178835404;Taip;0;0;18;18
2215;Eglutė;BORUŽIUKAI;5146804510;Taip;1;2;2;5
2216;Eglutė;BORUŽIUKAI;7618937988;Taip;0;5;0;5
2217;Eglutė;BORUŽIUKAI;6805213753;Taip;11;0;0;11
2218;Eglutė;BORUŽIUKAI;6773894090;Taip;0;0;3;3
2219;"Geniukų kalvė";SAULUTĖS;9557055841;Taip;4;3;0;7
2220;"Geniukų kalvė";SAULUTĖS;4329782598;Taip;0;5;0;5
2221;"Geniukų kalvė";SAULUTĖS;8932671578;Taip;0;6;2;8
2222;"Geniukų kalvė";SAULUTĖS;9711047774;Taip;0;0;4;4
2223;"Geniukų kalvė";SAULUTĖS;1910363787;Taip;10;3;0;13
2224;"Geniukų kalvė";SAULUTĖS;9522911738;Taip;0;9;1;10
2225;"Geniukų kalvė";SAULUTĖS;5348211316;Taip;0;10;0;10
2226;"Geniukų kalvė";SAULUTĖS;7886553419;Taip;0;3;0;3
2227;"Geniukų kalvė";SAULUTĖS;6384832317;Taip;6;3;7;16
2228;"Geniukų kalvė";SAULUTĖS;4946218794;Taip;0;8;0;8
2229;"Geniukų kalvė";SAULUTĖS;4525874796;Taip;0;0;2;2
2230;"Geniukų kalvė";SAULUTĖS;4745451344;Taip;5;3;0;8
2231;"Geniukų kalvė";SAULUTĖS;9768077014;Taip;2;3;0;5
2232;"Geniukų kalvė";SAULUTĖS;3889643236;Taip;0;7;0;7
2233;"Geniukų kalvė";SAULUTĖS;6102906310;Taip;0;3;0;3
2234;"Geniukų kalvė";SAULUTĖS;6016735700;Taip;0;0;5;5
2235;"Geniukų kalvė";SAULUTĖS;9976423099;Taip;14;3;0;17
2236;"Geniukų kalvė";SAULUTĖS;5180240547;Ne;5;3;0;8
2237;"Geniukų kalvė";BITUTĖS;5587035951;Taip;7;3;0;10
2238;"Geniukų kalvė";BITUTĖS;9323779212;Taip;8;0;0;8
2239;"Geniukų kalvė";BITUTĖS;4908674542;Taip;0;0;1;1
2240;"Geniukų kalvė";BITUTĖS;2110578252;Taip;5;1;1;7
2241;"Geniukų kalvė";BITUTĖS;8577323715;Taip;0;3;2;5
2242;"Geniukų kalvė";BITUTĖS;7453065865;Taip;8;0;0;8
2243;"Geniukų kalvė";BITUTĖS;8570015975;Taip;2;2;0;4
2244;"Geniukų kalvė";BITUTĖS;9455124402;Taip;0;0;2;2
2245;"Geniukų kalvė";BITUTĖS;4633553106;Taip;8;0;0;8
2246;"Geniukų kalvė";BITUTĖS;3669378459;Taip;13;0;0;13
2247;"Geniukų kalvė";BITUTĖS;4201333532;Taip;6;3;0;9
2248;"Geniukų kalvė";BITUTĖS;5102325807;Taip;10;4;0;14
2249;"Geniukų kalvė";BITUTĖS;1492140432;Taip;16;0;0;16
2250;"Geniukų kalvė";BITUTĖS;1426555835;Taip;0;3;0;3
2251;"Geniukų kalvė";BITUTĖS;6138451393;Taip;0;5;0;5
2252;"Geniukų kalvė";BITUTĖS;7747615302;Taip;0;9;0;9
2253;"Geniukų kalvė";BITUTĖS;4691978116;Taip;0;15;0;15
2254;"Geniukų kalvė";BITUTĖS;6111168227;Taip;13;0;0;13
2255;"Geniukų kalvė";BITUTĖS;7744441981;Taip;0;0;3;3
2256;"Geniukų kalvė";BITUTĖS;1209268848;Taip;0;0;7;7
2257;"Geniukų kalvė";BITUTĖS;6351861630;Taip;7;4;0;11
2258;"Geniukų kalvė";BITUTĖS;6214681079;Taip;0;4;0;4
2259;"Geniukų kalvė";BITUTĖS;3221034847;Taip;4;7;3;14
2260;"Geniukų kalvė";KIŠKUČIAI;5253380852;Taip;0;0;5;5
2261;"Geniukų kalvė";KIŠKUČIAI;2684344984;Taip;0;1;5;6
2262;"Geniukų kalvė";KIŠKUČIAI;5824747638;Taip;20;0;0;20
2263;"Geniukų kalvė";KIŠKUČIAI;9075192344;Taip;4;10;0;14
2264;"Geniukų kalvė";KIŠKUČIAI;5078771341;Taip;4;0;3;7
2265;"Geniukų kalvė";KIŠKUČIAI;4849740486;Ne;7;0;3;10
2266;"Geniukų kalvė";KIŠKUČIAI;9730758999;Taip;9;0;3;12
2267;"Geniukų kalvė";KIŠKUČIAI;9579750299;Taip;0;0;4;4
2268;"Geniukų kalvė";KIŠKUČIAI;9543553237;Taip;0;0;3;3
2269;"Geniukų kalvė";KIŠKUČIAI;2032408983;Taip;0;0;3;3
2270;"Geniukų kalvė";KIŠKUČIAI;4639389587;Taip;7;4;0;11
2271;"Geniukų kalvė";KIŠKUČIAI;4507631652;Taip;0;1;0;1
2272;"Geniukų kalvė";KIŠKUČIAI;9386761753;Taip;0;5;1;6
2273;"Geniukų kalvė";KIŠKUČIAI;4864216994;Taip;11;0;3;14
2274;"Geniukų kalvė";KIŠKUČIAI;5604315555;Taip;7;0;0;7
2275;"Geniukų kalvė";KIŠKUČIAI;7784155503;Taip;7;0;0;7
2276;"Geniukų kalvė";KIŠKUČIAI;6188518268;Taip;0;0;3;3
2277;"Geniukų kalvė";KIŠKUČIAI;1945456486;Taip;7;0;2;9
2278;"Geniukų kalvė";KIŠKUČIAI;3887137828;Taip;15;0;0;15
2279;"Geniukų kalvė";KIŠKUČIAI;2396085192;Taip;10;0;0;10
2280;"Geniukų kalvė";VYTURĖLIAI;5945583960;Taip;0;3;1;4
2281;"Geniukų kalvė";VYTURĖLIAI;1568133009;Taip;4;5;0;9
2282;"Geniukų kalvė";VYTURĖLIAI;8939171238;Taip;0;4;0;4
2283;"Geniukų kalvė";VYTURĖLIAI;2337226175;Taip;0;4;0;4
2284;"Geniukų kalvė";VYTURĖLIAI;2140334255;Ne;2;5;0;7
2285;"Geniukų kalvė";VYTURĖLIAI;7664689396;Taip;6;2;1;9
2286;"Geniukų kalvė";VYTURĖLIAI;4844734556;Taip;0;3;0;3
2287;"Geniukų kalvė";VYTURĖLIAI;8635708009;Taip;11;0;0;11
2288;"Geniukų kalvė";VYTURĖLIAI;4758435835;Taip;0;6;0;6
2289;"Geniukų kalvė";VYTURĖLIAI;2729442911;Taip;0;3;0;3
2290;"Geniukų kalvė";VYTURĖLIAI;23023070502;Taip;0;2;0;2
2291;"Geniukų kalvė";VYTURĖLIAI;9081596975;Taip;1;4;0;5
2292;"Geniukų kalvė";VYTURĖLIAI;8668696743;Ne;4;2;0;6
2293;"Geniukų kalvė";VYTURĖLIAI;2262014110;Taip;0;3;0;3
2294;"Geniukų kalvė";VYTURĖLIAI;2890934301;Taip;7;4;0;11
2295;"Geniukų kalvė";VYTURĖLIAI;2904091819;Taip;0;4;0;4
2296;"Geniukų kalvė";VYTURĖLIAI;43097490633;Taip;3;5;0;8
2297;"Geniukų kalvė";VYTURĖLIAI;1460456166;Taip;0;3;0;3
2298;"Geniukų kalvė";VYTURĖLIAI;30932565379;Taip;18;0;0;18
2299;"Geniukų kalvė";VYTURĖLIAI;3826265557;Taip;5;4;0;9
2300;"Geniukų kalvė";VYTURĖLIAI;5756909142;Taip;0;3;0;3
2301;"Geniukų kalvė";DRUGELIAI;9676782662;Taip;5;3;0;8
2302;"Geniukų kalvė";DRUGELIAI;7745656622;Taip;0;1;0;1
2303;"Geniukų kalvė";DRUGELIAI;6520429663;Taip;5;3;0;8
2304;"Geniukų kalvė";DRUGELIAI;5542539934;Taip;0;4;0;4
2305;"Geniukų kalvė";DRUGELIAI;9666918437;Taip;0;1;0;1
2306;"Geniukų kalvė";DRUGELIAI;6466912385;Taip;0;3;1;4
2307;"Geniukų kalvė";DRUGELIAI;2718961466;Taip;6;5;1;12
2308;"Geniukų kalvė";DRUGELIAI;2016254460;Taip;0;4;0;4
2309;"Geniukų kalvė";DRUGELIAI;3984265624;Taip;0;10;0;10
2310;"Geniukų kalvė";DRUGELIAI;4813232640;Taip;0;3;0;3
2311;"Geniukų kalvė";DRUGELIAI;7081093742;Taip;4;1;0;5
2312;"Geniukų kalvė";DRUGELIAI;5776314197;Taip;0;1;0;1
2313;"Geniukų kalvė";DRUGELIAI;1897809684;Taip;0;3;0;3
2314;"Geniukų kalvė";DRUGELIAI;8872900558;Taip;2;4;0;6
2315;"Geniukų kalvė";DRUGELIAI;2031800114;Taip;0;3;0;3
2316;"Geniukų kalvė";DRUGELIAI;1451190239;Taip;0;4;1;5
2317;"Geniukų kalvė";DRUGELIAI;6511955882;Taip;0;3;0;3
2318;"Geniukų kalvė";DRUGELIAI;2233161242;Taip;0;4;0;4
2319;"Geniukų kalvė";DRUGELIAI;6500641378;Taip;0;2;0;2
2320;"Geniukų kalvė";DRUGELIAI;2143334688;Taip;0;3;0;3
2321;"Geniukų kalvė";DRUGELIAI;6498149304;Taip;0;2;0;2
2322;"Geniukų kalvė";DRUGELIAI;9990243525;Taip;0;2;0;2
2323;"Geniukų kalvė";DRUGELIAI;48818906299;Taip;0;3;0;3
2324;"Geniukų kalvė";DRUGELIAI;4105170344;Taip;0;3;0;3
2325;"Geniukų kalvė";"SAULĖS ZUIKUČIAI";7033628178;Taip;3;0;0;3
2326;"Geniukų kalvė";"SAULĖS ZUIKUČIAI";7082945033;Taip;10;3;0;13
2327;"Geniukų kalvė";"SAULĖS ZUIKUČIAI";2313382307;Taip;0;3;0;3
2328;"Geniukų kalvė";"SAULĖS ZUIKUČIAI";8309953586;Taip;4;3;0;7
2329;"Geniukų kalvė";"SAULĖS ZUIKUČIAI";1443348537;Taip;0;0;3;3
2330;"Geniukų kalvė";"SAULĖS ZUIKUČIAI";2783285969;Taip;15;0;0;15
2331;"Geniukų kalvė";"SAULĖS ZUIKUČIAI";7500079028;Taip;0;17;0;17
2332;"Geniukų kalvė";"SAULĖS ZUIKUČIAI";8071493871;Taip;10;3;1;14
2333;"Geniukų kalvė";"SAULĖS ZUIKUČIAI";1718428600;Taip;0;0;1;1
2334;"Geniukų kalvė";"SAULĖS ZUIKUČIAI";8914605154;Taip;7;1;0;8
2335;"Geniukų kalvė";"SAULĖS ZUIKUČIAI";6016585056;Taip;4;0;1;5
2336;"Geniukų kalvė";"SAULĖS ZUIKUČIAI";2816691996;Taip;0;4;1;5
2337;"Geniukų kalvė";"SAULĖS ZUIKUČIAI";5512172533;Taip;4;6;0;10
2338;"Geniukų kalvė";"SAULĖS ZUIKUČIAI";1375674317;Taip;0;4;0;4
2339;"Geniukų kalvė";"SAULĖS ZUIKUČIAI";4722801116;Taip;3;6;0;9
2340;"Geniukų kalvė";"SAULĖS ZUIKUČIAI";5763009912;Taip;0;4;0;4
2341;"Geniukų kalvė";"SAULĖS ZUIKUČIAI";5245434552;Taip;0;3;0;3
2342;"Geniukų kalvė";"SAULĖS ZUIKUČIAI";5725034297;Taip;0;8;0;8
2343;"Geniukų kalvė";"SAULĖS ZUIKUČIAI";1499735818;Taip;18;0;0;18
2344;"Geniukų kalvė";"SAULĖS ZUIKUČIAI";4186376527;Taip;4;3;1;8
2345;"Geniukų kalvė";"SAULĖS ZUIKUČIAI";5161600326;Taip;0;0;3;3
2346;"Geniukų kalvė";SMALSUČIAI;2499796674;Taip;8;0;0;8
2347;"Geniukų kalvė";SMALSUČIAI;5974481787;Taip;13;0;0;13
2348;"Geniukų kalvė";SMALSUČIAI;7915720190;Taip;9;0;1;10
2349;"Geniukų kalvė";SMALSUČIAI;7384802397;Taip;0;0;1;1
2350;"Geniukų kalvė";SMALSUČIAI;5993223458;Taip;0;0;1;1
2351;"Geniukų kalvė";SMALSUČIAI;8985466295;Taip;0;3;0;3
2352;"Geniukų kalvė";SMALSUČIAI;5129841490;Taip;3;3;1;7
2353;"Geniukų kalvė";SMALSUČIAI;5705917381;Taip;13;3;0;16
2354;"Geniukų kalvė";SMALSUČIAI;4231659246;Taip;0;2;1;3
2355;"Geniukų kalvė";SMALSUČIAI;2300947427;Taip;0;8;4;12
2356;"Geniukų kalvė";SMALSUČIAI;1028242614;Taip;2;2;0;4
2357;"Geniukų kalvė";SMALSUČIAI;2596680448;Taip;8;2;0;10
2358;"Geniukų kalvė";SMALSUČIAI;6730270449;Taip;8;0;0;8
2359;"Geniukų kalvė";SMALSUČIAI;4405381922;Taip;0;5;0;5
2360;"Geniukų kalvė";SMALSUČIAI;6473724074;Taip;5;1;0;6
2361;"Geniukų kalvė";SMALSUČIAI;3627418555;Taip;6;5;0;11
2362;"Geniukų kalvė";SMALSUČIAI;9155681194;Taip;6;1;2;9
2363;"Geniukų kalvė";SMALSUČIAI;7440029486;Taip;0;2;3;5
2364;"Geniukų kalvė";SMALSUČIAI;7140298387;Taip;2;0;8;10
2365;"Geniukų kalvė";SMALSUČIAI;6168422514;Taip;18;0;0;18
2366;"Geniukų kalvė";SMALSUČIAI;6514696294;Taip;3;0;0;3
2367;"Geniukų kalvė";SMALSUČIAI;6757580298;Taip;3;0;3;6
2368;"Geniukų kalvė";RUDNOSIUKAI;7079072084;Taip;4;3;0;7
2369;"Geniukų kalvė";RUDNOSIUKAI;6060825704;Taip;0;1;6;7
2370;"Geniukų kalvė";RUDNOSIUKAI;6149037133;Taip;0;7;0;7
2371;"Geniukų kalvė";RUDNOSIUKAI;5883913787;Taip;0;3;0;3
2372;"Geniukų kalvė";RUDNOSIUKAI;9696452101;Taip;0;0;1;1
2373;"Geniukų kalvė";RUDNOSIUKAI;2426186771;Taip;0;0;4;4
2374;"Geniukų kalvė";RUDNOSIUKAI;5205178173;Taip;0;2;7;9
2375;"Geniukų kalvė";RUDNOSIUKAI;2836282651;Taip;6;2;0;8
2376;"Geniukų kalvė";RUDNOSIUKAI;9847003556;Taip;0;2;0;2
2377;"Geniukų kalvė";RUDNOSIUKAI;5443596677;Taip;0;1;0;1
2378;"Geniukų kalvė";RUDNOSIUKAI;7300853810;Taip;0;4;2;6
2379;"Geniukų kalvė";RUDNOSIUKAI;2839299179;Taip;3;0;0;3
2380;"Geniukų kalvė";RUDNOSIUKAI;4664026888;Taip;1;0;0;1
2381;"Geniukų kalvė";RUDNOSIUKAI;3852896932;Taip;0;1;5;6
2382;"Geniukų kalvė";RUDNOSIUKAI;2165793561;Taip;0;1;0;1
2383;"Geniukų kalvė";RUDNOSIUKAI;8973285553;Taip;0;0;3;3
2384;"Geniukų kalvė";RUDNOSIUKAI;5559324196;Taip;0;0;2;2
2385;"Geniukų kalvė";RUDNOSIUKAI;4985606198;Taip;14;0;0;14
2386;"Geniukų kalvė";RUDNOSIUKAI;3631181701;Taip;0;3;0;3
2387;"Geniukų kalvė";RUDNOSIUKAI;3152130511;Taip;7;1;0;8
2388;"Geniukų kalvė";RUDNOSIUKAI;2798750158;Taip;6;4;0;10
2389;"Geniukų kalvė";RUDNOSIUKAI;6373989816;Taip;8;3;0;11
2390;"Geniukų kalvė";PELĖDŽIUKAI;2217221922;Taip;0;0;8;8
2391;"Geniukų kalvė";PELĖDŽIUKAI;8271041553;Taip;0;3;0;3
2392;"Geniukų kalvė";PELĖDŽIUKAI;1237228692;Taip;0;3;0;3
2393;"Geniukų kalvė";PELĖDŽIUKAI;2938446054;Taip;5;3;0;8
2394;"Geniukų kalvė";PELĖDŽIUKAI;3055777730;Taip;0;3;2;5
2395;"Geniukų kalvė";PELĖDŽIUKAI;6070945557;Taip;13;0;0;13
2396;"Geniukų kalvė";PELĖDŽIUKAI;1051563985;Taip;0;7;0;7
2397;"Geniukų kalvė";PELĖDŽIUKAI;6174114461;Taip;11;0;6;17
2398;"Geniukų kalvė";PELĖDŽIUKAI;2659298240;Taip;0;3;0;3
2399;"Geniukų kalvė";PELĖDŽIUKAI;6737863183;Taip;0;4;1;5
2400;"Geniukų kalvė";PELĖDŽIUKAI;5704223824;Taip;0;3;0;3
2401;"Geniukų kalvė";PELĖDŽIUKAI;1811866428;Ne;5;0;1;6
2402;"Geniukų kalvė";PELĖDŽIUKAI;6410008429;Taip;0;1;0;1
2403;"Geniukų kalvė";PELĖDŽIUKAI;4843411757;Taip;0;2;0;2
2404;"Geniukų kalvė";PELĖDŽIUKAI;8770345339;Taip;2;0;4;6
2405;"Geniukų kalvė";PELĖDŽIUKAI;5146141771;Taip;8;0;0;8
2406;"Geniukų kalvė";PELĖDŽIUKAI;1611845627;Taip;8;0;0;8
2407;"Geniukų kalvė";PELĖDŽIUKAI;9677583445;Taip;0;2;3;5
2408;"Geniukų kalvė";PELĖDŽIUKAI;6237208661;Taip;0;0;3;3
2409;"Geniukų kalvė";PELĖDŽIUKAI;9921191336;Taip;0;3;0;3
2410;"Geniukų kalvė";BORUŽĖLĖS;9613720001;Taip;0;4;4;8
2411;"Geniukų kalvė";BORUŽĖLĖS;4958738745;Taip;5;4;0;9
2412;"Geniukų kalvė";BORUŽĖLĖS;9069256760;Taip;9;0;3;12
2413;"Geniukų kalvė";BORUŽĖLĖS;5161535756;Taip;0;5;0;5
2414;"Geniukų kalvė";BORUŽĖLĖS;3493492581;Taip;0;3;0;3
2415;"Geniukų kalvė";BORUŽĖLĖS;3085228868;Taip;0;4;0;4
2416;"Geniukų kalvė";BORUŽĖLĖS;6794151223;Taip;9;4;0;13
2417;"Geniukų kalvė";BORUŽĖLĖS;4777155321;Taip;3;4;0;7
2418;"Geniukų kalvė";BORUŽĖLĖS;1037854104;Taip;2;0;0;2
2419;"Geniukų kalvė";BORUŽĖLĖS;2180860623;Ne;0;3;0;3
2420;"Geniukų kalvė";BORUŽĖLĖS;2205515766;Taip;0;1;0;1
2421;"Geniukų kalvė";BORUŽĖLĖS;8769761434;Taip;5;0;3;8
2422;"Geniukų kalvė";BORUŽĖLĖS;1891205998;Taip;0;3;0;3
2423;"Geniukų kalvė";BORUŽĖLĖS;9643242164;Taip;0;4;0;4
2424;"Geniukų kalvė";BORUŽĖLĖS;2665955524;Taip;0;4;0;4
2425;"Geniukų kalvė";BORUŽĖLĖS;4872435715;Taip;0;0;3;3
2426;"Geniukų kalvė";BORUŽĖLĖS;3297360222;Taip;13;1;0;14
2427;"Geniukų kalvė";BORUŽĖLĖS;6828079735;Taip;11;0;0;11
2428;"Geniukų kalvė";BORUŽĖLĖS;2710207578;Taip;0;3;0;3
2429;"Geniukų kalvė";BORUŽĖLĖS;1046406910;Taip;9;0;0;9
2430;"Geniukų kalvė";BORUŽĖLĖS;1454724752;Taip;0;3;0;3
2431;"Geniukų kalvė";BORUŽĖLĖS;8052276633;Taip;0;4;0;4
2432;"Geniukų kalvė";BORUŽĖLĖS;3193006249;Taip;0;1;0;1
2433;"Geniukų kalvė";PAGRANDUKAI;1844495906;Taip;6;3;0;9
2434;"Geniukų kalvė";PAGRANDUKAI;7234620406;Taip;0;0;1;1
2435;"Geniukų kalvė";PAGRANDUKAI;6953313909;Taip;0;2;0;2
2436;"Geniukų kalvė";PAGRANDUKAI;4890413509;Taip;16;0;0;16
2437;"Geniukų kalvė";PAGRANDUKAI;2490231586;Taip;0;5;0;5
2438;"Geniukų kalvė";PAGRANDUKAI;9319251542;Taip;18;0;0;18
2439;"Geniukų kalvė";PAGRANDUKAI;7310171451;Taip;12;5;0;17
2440;"Geniukų kalvė";PAGRANDUKAI;8653679467;Taip;0;2;1;3
2441;"Geniukų kalvė";PAGRANDUKAI;9820642056;Taip;0;4;1;5
2442;"Geniukų kalvė";PAGRANDUKAI;6783296167;Taip;6;3;1;10
2443;"Geniukų kalvė";PAGRANDUKAI;8525540366;Taip;15;0;0;15
2444;"Geniukų kalvė";PAGRANDUKAI;5744371590;Taip;0;0;1;1
2445;"Geniukų kalvė";PAGRANDUKAI;5847488152;Taip;13;1;0;14
2446;"Geniukų kalvė";PAGRANDUKAI;3676717541;Taip;0;3;2;5
2447;"Geniukų kalvė";NYKŠTUKAI;7561521903;Taip;5;0;6;11
2448;"Geniukų kalvė";NYKŠTUKAI;2312298671;Taip;5;3;10;18
2449;"Geniukų kalvė";NYKŠTUKAI;8217855034;Taip;0;11;0;11
2450;"Geniukų kalvė";NYKŠTUKAI;1068112116;Taip;6;0;0;6
2451;"Geniukų kalvė";NYKŠTUKAI;1421857914;Taip;12;0;0;12
2452;"Geniukų kalvė";NYKŠTUKAI;1558977259;Taip;8;0;0;8
2453;"Geniukų kalvė";NYKŠTUKAI;4805806745;Taip;7;0;0;7
2454;"Geniukų kalvė";NYKŠTUKAI;1383717352;Taip;7;0;0;7
2455;"Geniukų kalvė";NYKŠTUKAI;3071724778;Taip;7;1;0;8
2456;"Geniukų kalvė";NYKŠTUKAI;2302465593;Taip;11;0;0;11
2457;"Geniukų kalvė";NYKŠTUKAI;3024701779;Taip;0;8;0;8
2458;"Geniukų kalvė";NYKŠTUKAI;1822730314;Taip;4;0;0;4
2459;"Geniukų kalvė";NYKŠTUKAI;3015544833;Taip;18;0;0;18
2460;"Geniukų kalvė";NYKŠTUKAI;6680434763;Taip;0;4;0;4
2461;"Geniukų kalvė";NYKŠTUKAI;7736527608;Taip;2;6;1;9
2462;"Geniukų kalvė";NYKŠTUKAI;6860580488;Taip;0;1;0;1
2463;Gelvonėlis;ĄŽUOLIUKAI;2329699993;Taip;0;4;0;4
2464;Gelvonėlis;ĄŽUOLIUKAI;9058956012;Taip;0;14;0;14
2465;Gelvonėlis;ĄŽUOLIUKAI;4111774915;Taip;2;4;0;6
2466;Gelvonėlis;ĄŽUOLIUKAI;3677100165;Taip;0;7;0;7
2467;Gelvonėlis;ĄŽUOLIUKAI;7449710008;Taip;0;11;0;11
2468;Gelvonėlis;ĄŽUOLIUKAI;9492898584;Taip;0;13;0;13
2469;Gelvonėlis;ĄŽUOLIUKAI;8163855482;Taip;3;0;0;3
2470;Gelvonėlis;ĄŽUOLIUKAI;7070038335;Taip;0;1;0;1
2471;Gelvonėlis;ĄŽUOLIUKAI;3942630720;Taip;0;13;0;13
2472;Gelvonėlis;ĄŽUOLIUKAI;1453271708;Taip;0;8;0;8
2473;Gelvonėlis;ĄŽUOLIUKAI;9756155028;Taip;0;10;0;10
2474;Gelvonėlis;ĄŽUOLIUKAI;8206816148;Taip;4;3;0;7
2475;Gelvonėlis;ĄŽUOLIUKAI;3165015754;Taip;5;4;0;9
2476;Gelvonėlis;ĄŽUOLIUKAI;1274119900;Taip;0;5;0;5
2477;Gelvonėlis;ĄŽUOLIUKAI;5901499708;Taip;11;2;0;13
2478;Gelvonėlis;ĄŽUOLIUKAI;1403890893;Taip;4;5;0;9
2479;Gelvonėlis;ŽVIRBLIUKAI;6604992169;Taip;0;4;0;4
2480;Gelvonėlis;ŽVIRBLIUKAI;6556472766;Taip;10;0;7;17
2481;Gelvonėlis;ŽVIRBLIUKAI;7182180008;Taip;0;3;0;3
2482;Gelvonėlis;ŽVIRBLIUKAI;8885088900;Taip;2;3;3;8
2483;Gelvonėlis;ŽVIRBLIUKAI;2400289466;Taip;0;3;3;6
2484;Gelvonėlis;ŽVIRBLIUKAI;9493536517;Taip;3;0;0;3
2485;Gelvonėlis;ŽVIRBLIUKAI;9059244134;Taip;0;1;1;2
2486;Gelvonėlis;ŽVIRBLIUKAI;1987204544;Taip;0;6;0;6
2487;Gelvonėlis;ŽVIRBLIUKAI;2288951845;Taip;0;0;4;4
2488;Gelvonėlis;ŽVIRBLIUKAI;2515471132;Taip;5;0;4;9
2489;Gelvonėlis;ŽVIRBLIUKAI;1085845218;Taip;0;0;2;2
2490;Gelvonėlis;ŽVIRBLIUKAI;6319058542;Taip;0;0;5;5
2491;Gelvonėlis;ŽVIRBLIUKAI;9538571448;Taip;4;0;1;5
2492;Gelvonėlis;ŽVIRBLIUKAI;9147186080;Taip;0;5;0;5
2493;Gelvonėlis;ŽVIRBLIUKAI;7620280474;Ne;0;0;1;1
2494;Gelvonėlis;ŽVIRBLIUKAI;7195164378;Taip;0;3;0;3
2495;Gelvonėlis;ŽVIRBLIUKAI;6598178467;Taip;0;5;0;5
2496;Gelvonėlis;ŽVIRBLIUKAI;6068473734;Taip;0;0;1;1
2497;Gelvonėlis;ŽVIRBLIUKAI;4913415466;Taip;0;0;3;3
2498;Gelvonėlis;ŽVIRBLIUKAI;8508450500;Taip;0;4;0;4
2499;Gelvonėlis;ŽVIRBLIUKAI;8704971956;Taip;18;0;0;18
2500;Gelvonėlis;ŽVIRBLIUKAI;4281431471;Taip;5;0;0;5
2501;Gelvonėlis;ŽVIRBLIUKAI;8976258838;Ne;1;1;0;2
2502;Gelvonėlis;RASELĖS;9667024635;Taip;5;3;3;11
2503;Gelvonėlis;RASELĖS;9369121356;Taip;3;0;0;3
2504;Gelvonėlis;RASELĖS;2119550116;Taip;7;3;2;12
2505;Gelvonėlis;RASELĖS;3788522708;Taip;0;3;2;5
2506;Gelvonėlis;RASELĖS;6317822775;Taip;5;3;0;8
2507;Gelvonėlis;RASELĖS;5047022305;Taip;1;3;3;7
2508;Gelvonėlis;RASELĖS;6189110767;Taip;15;3;0;18
2509;Gelvonėlis;RASELĖS;7983982378;Taip;0;5;0;5
2510;Gelvonėlis;RASELĖS;2108690954;Taip;3;0;0;3
2511;Gelvonėlis;RASELĖS;1753617545;Taip;3;4;0;7
2512;Gelvonėlis;RASELĖS;7759317220;Taip;0;5;0;5
2513;Gelvonėlis;RASELĖS;5721858659;Taip;9;0;0;9
2514;Gelvonėlis;RASELĖS;1399518471;Taip;0;3;0;3
2515;Gelvonėlis;RASELĖS;5283207520;Taip;3;0;1;4
2516;Gelvonėlis;RASELĖS;3059903126;Taip;0;3;1;4
2517;Gelvonėlis;RASELĖS;6226970200;Taip;0;2;3;5
2518;Gelvonėlis;RASELĖS;1246591538;Taip;0;3;2;5
2519;Gelvonėlis;RASELĖS;6256962184;Taip;5;3;5;13
2520;Gelvonėlis;RASELĖS;91441127098;Taip;0;3;0;3
2521;Gelvonėlis;RASELĖS;1610362831;Taip;5;3;0;8
2522;Gelvonėlis;RASELĖS;9387523651;Ne;0;10;0;10
2523;Gelvonėlis;RASELĖS;75676389361;Taip;0;3;0;3
2524;Gelvonėlis;RASELĖS;4120103012;Ne;3;3;2;8
2525;Gelvonėlis;SAULUTĖ;9396676137;Taip;1;0;0;1
2526;Gelvonėlis;SAULUTĖ;9353066785;Taip;1;0;0;1
2527;Gelvonėlis;SAULUTĖ;3121251271;Taip;0;10;0;10
2528;Gelvonėlis;SAULUTĖ;7429739147;Taip;12;2;0;14
2529;Gelvonėlis;SAULUTĖ;7392743619;Taip;14;0;0;14
2530;Gelvonėlis;SAULUTĖ;8228796927;Taip;5;3;0;8
2531;Gelvonėlis;SAULUTĖ;4550077609;Taip;0;3;0;3
2532;Gelvonėlis;SAULUTĖ;1734685590;Taip;6;4;0;10
2533;Gelvonėlis;SAULUTĖ;7936622964;Taip;7;5;0;12
2534;Gelvonėlis;SAULUTĖ;3719670896;Taip;0;5;0;5
2535;Gelvonėlis;SAULUTĖ;1672409070;Ne;0;3;0;3
2536;Gelvonėlis;SAULUTĖ;3771796903;Taip;8;0;0;8
2537;Gelvonėlis;SAULUTĖ;8022270555;Taip;7;4;0;11
2538;Gelvonėlis;SAULUTĖ;4268590631;Taip;0;3;0;3
2539;Gelvonėlis;SAULUTĖ;5598186460;Taip;11;3;0;14
2540;Gelvonėlis;SAULUTĖ;9767254134;Taip;16;0;0;16
2541;Gelvonėlis;SAULUTĖ;2452711535;Taip;0;8;0;8
2542;Gelvonėlis;SAULUTĖ;7977651492;Ne;8;0;0;8
2543;Gelvonėlis;PELĖDŽIUKAI;3830940009;Taip;0;3;0;3
2544;Gelvonėlis;PELĖDŽIUKAI;2742000725;Taip;2;3;0;5
2545;Gelvonėlis;PELĖDŽIUKAI;3147489259;Taip;0;4;0;4
2546;Gelvonėlis;PELĖDŽIUKAI;1284359362;Taip;0;3;0;3
2547;Gelvonėlis;PELĖDŽIUKAI;9798684265;Taip;0;3;0;3
2548;Gelvonėlis;PELĖDŽIUKAI;4855800131;Taip;0;3;2;5
2549;Gelvonėlis;PELĖDŽIUKAI;8775661719;Taip;0;2;2;4
2550;Gelvonėlis;PELĖDŽIUKAI;21684706944;Taip;0;3;1;4
2551;Gelvonėlis;PELĖDŽIUKAI;3089755141;Taip;0;3;2;5
2552;Gelvonėlis;PELĖDŽIUKAI;1408313697;Taip;0;2;3;5
2553;Gelvonėlis;PELĖDŽIUKAI;3670612781;Taip;0;3;0;3
2554;Gelvonėlis;PELĖDŽIUKAI;69073786634;Taip;0;3;0;3
2555;Gelvonėlis;PELĖDŽIUKAI;29928181395;Taip;0;4;1;5
2556;Gelvonėlis;PELĖDŽIUKAI;6255253658;Taip;0;3;4;7
2557;Gelvonėlis;PELĖDŽIUKAI;9323579468;Taip;0;3;0;3
2558;Gelvonėlis;PELĖDŽIUKAI;7919814808;Taip;0;3;6;9
2559;Gelvonėlis;PELĖDŽIUKAI;1355742622;Taip;0;4;0;4
2560;Gelvonėlis;PELĖDŽIUKAI;5798439412;Taip;0;2;0;2
2561;Gelvonėlis;DRUGELIAI;3371560338;Taip;8;5;0;13
2562;Gelvonėlis;DRUGELIAI;2407650243;Taip;13;0;0;13
2563;Gelvonėlis;DRUGELIAI;2896360160;Taip;0;3;0;3
2564;Gelvonėlis;DRUGELIAI;8365647638;Taip;0;7;0;7
2565;Gelvonėlis;DRUGELIAI;3618681535;Taip;3;1;0;4
2566;Gelvonėlis;DRUGELIAI;9386056584;Taip;0;2;0;2
2567;Gelvonėlis;DRUGELIAI;2114734415;Taip;15;1;0;16
2568;Gelvonėlis;DRUGELIAI;5882430535;Taip;0;4;0;4
2569;Gelvonėlis;DRUGELIAI;9140900868;Taip;10;3;0;13
2570;Gelvonėlis;DRUGELIAI;2645337382;Taip;13;0;0;13
2571;Gelvonėlis;DRUGELIAI;3813000890;Taip;0;7;0;7
2572;Gelvonėlis;DRUGELIAI;6662081736;Taip;5;0;0;5
2573;Gelvonėlis;DRUGELIAI;5379820728;Taip;8;0;0;8
2574;Gelvonėlis;DRUGELIAI;7938324572;Taip;18;0;0;18
2575;Gelvonėlis;DRUGELIAI;4162701876;Taip;0;7;0;7
2576;Gelvonėlis;DRUGELIAI;2407650243;Taip;13;0;0;13
2577;Gelvonėlis;VARPELIAI;9149117970;Taip;0;6;0;6
2578;Gelvonėlis;VARPELIAI;6451557430;Taip;0;1;0;1
2579;Gelvonėlis;VARPELIAI;6225854165;Taip;13;0;0;13
2580;Gelvonėlis;VARPELIAI;2791652988;Taip;2;3;0;5
2581;Gelvonėlis;VARPELIAI;2638430817;Taip;0;0;6;6
2582;Gelvonėlis;VARPELIAI;9600526942;Taip;0;15;0;15
2583;Gelvonėlis;VARPELIAI;1387948936;Taip;0;4;0;4
2584;Gelvonėlis;VARPELIAI;9650922918;Taip;0;1;0;1
2585;Gelvonėlis;VARPELIAI;1462716950;Taip;10;4;0;14
2586;Gelvonėlis;VARPELIAI;6949090250;Taip;7;0;0;7
2587;Gelvonėlis;VARPELIAI;9622818893;Taip;4;0;5;9
2588;Gelvonėlis;VARPELIAI;6869418701;Taip;0;0;1;1
2589;Gelvonėlis;VARPELIAI;5207153784;Taip;0;1;2;3
2590;Gelvonėlis;VARPELIAI;9963769327;Taip;0;2;0;2
2591;Gelvonėlis;VARPELIAI;3192542909;Taip;3;3;1;7
2592;Gelvonėlis;VARPELIAI;1802520150;Taip;0;1;1;2
2593;Gelvonėlis;BORUŽĖLĖS;8209225630;Taip;4;3;1;8
2594;Gelvonėlis;BORUŽĖLĖS;6554989142;Ne;0;4;1;5
2595;Gelvonėlis;BORUŽĖLĖS;8056058298;Taip;0;4;1;5
2596;Gelvonėlis;BORUŽĖLĖS;2434789595;Taip;0;0;1;1
2597;Gelvonėlis;BORUŽĖLĖS;2698853686;Taip;0;2;0;2
2598;Gelvonėlis;BORUŽĖLĖS;4112607183;Taip;6;4;2;12
2599;Gelvonėlis;BORUŽĖLĖS;6243360625;Taip;0;10;0;10
2600;Gelvonėlis;BORUŽĖLĖS;5790038422;Taip;7;0;0;7
2601;Gelvonėlis;BORUŽĖLĖS;8515746171;Taip;5;0;0;5
2602;Gelvonėlis;BORUŽĖLĖS;1712926391;Taip;0;3;8;11
2603;Gelvonėlis;BORUŽĖLĖS;6647585785;Taip;11;0;3;14
2604;Gelvonėlis;BORUŽĖLĖS;1539850989;Taip;0;0;1;1
2605;Gelvonėlis;BORUŽĖLĖS;1107633909;Ne;0;7;0;7
2606;Gelvonėlis;BORUŽĖLĖS;8973272332;Taip;0;7;0;7
2607;Gelvonėlis;BORUŽĖLĖS;9849765037;Taip;0;3;0;3
2608;Gelvonėlis;BORUŽĖLĖS;3846916445;Taip;0;8;0;8
2609;Gelvonėlis;BORUŽĖLĖS;4749071286;Taip;0;4;0;4
2610;Gelvonėlis;BORUŽĖLĖS;8806934077;Taip;0;0;17;17
2611;Gelvonėlis;BORUŽĖLĖS;3926733474;Taip;0;0;6;6
2612;Gelvonėlis;BORUŽĖLĖS;4620517551;Taip;0;0;9;9
2613;Gelvonėlis;BORUŽĖLĖS;6598688551;Taip;18;0;0;18
2614;Gelvonėlis;NYKŠTUKAI;8987012601;Taip;14;0;0;14
2615;Gelvonėlis;NYKŠTUKAI;7632523330;Taip;0;1;0;1
2616;Gelvonėlis;NYKŠTUKAI;1112841066;Taip;21;1;0;22
2617;Gelvonėlis;NYKŠTUKAI;8003522011;Taip;0;4;0;4
2618;Gelvonėlis;NYKŠTUKAI;5713586282;Taip;0;3;1;4
2619;Gelvonėlis;NYKŠTUKAI;3217646353;Taip;0;4;0;4
2620;Gelvonėlis;NYKŠTUKAI;8560940316;Taip;3;5;2;10
2621;Gelvonėlis;NYKŠTUKAI;8540204705;Taip;0;5;0;5
2622;Gelvonėlis;NYKŠTUKAI;8124516993;Taip;11;0;0;11
2623;Gelvonėlis;NYKŠTUKAI;9751580494;Taip;0;0;2;2
2624;Gelvonėlis;NYKŠTUKAI;4156493586;Taip;6;2;0;8
2625;Gelvonėlis;NYKŠTUKAI;5124211917;Taip;0;4;0;4
2626;Gelvonėlis;NYKŠTUKAI;5305480599;Taip;0;0;2;2
2627;Gelvonėlis;NYKŠTUKAI;5874473596;Taip;5;1;0;6
2628;Gelvonėlis;NYKŠTUKAI;9900244859;Taip;0;0;8;8
2629;Gelvonėlis;NYKŠTUKAI;9597033956;Taip;3;0;1;4
2630;Gelvonėlis;BITUTĖS;6534527571;Taip;0;11;0;11
2631;Gelvonėlis;BITUTĖS;1105838340;Taip;5;0;4;9
2632;Gelvonėlis;BITUTĖS;5865866507;Taip;0;0;18;18
2633;Gelvonėlis;BITUTĖS;5444127599;Taip;14;0;0;14
2634;Gelvonėlis;BITUTĖS;1980703633;Taip;5;1;0;6
2635;Gelvonėlis;BITUTĖS;5633162524;Taip;0;1;0;1
2636;Gelvonėlis;BITUTĖS;6330751030;Taip;0;0;1;1
2637;Gelvonėlis;BITUTĖS;6710189985;Taip;5;2;0;7
2638;Gelvonėlis;BITUTĖS;5281400074;Taip;5;0;11;16
2639;Gelvonėlis;BITUTĖS;3514762919;Taip;0;0;8;8
2640;Gelvonėlis;BITUTĖS;8792171281;Taip;3;0;2;5
2641;Gelvonėlis;BITUTĖS;7850553299;Taip;9;0;2;11
2642;Gelvonėlis;BITUTĖS;1730718430;Ne;12;0;3;15
2643;Gelvonėlis;BITUTĖS;8480138654;Taip;0;0;11;11
2644;Gelvonėlis;BITUTĖS;7725313260;Taip;11;0;8;19
2645;Gelvonėlis;BITUTĖS;5816373550;Taip;6;3;1;10
2646;Gelvonėlis;BITUTĖS;4380468764;Taip;13;2;0;15
2647;Gelvonėlis;RAMUNĖLĖS;1104204810;Taip;6;6;0;12
2648;Gelvonėlis;RAMUNĖLĖS;1355774181;Taip;12;0;0;12
2649;Gelvonėlis;RAMUNĖLĖS;2774170680;Taip;12;0;0;12
2650;Gelvonėlis;RAMUNĖLĖS;3269417874;Taip;8;0;0;8
2651;Gelvonėlis;RAMUNĖLĖS;9403505858;Taip;15;0;0;15
2652;Gelvonėlis;RAMUNĖLĖS;7686930719;Taip;3;0;0;3
2653;Gelvonėlis;RAMUNĖLĖS;4450990418;Taip;16;0;0;16
2654;Gelvonėlis;RAMUNĖLĖS;7419947442;Taip;7;0;0;7
2655;Gelvonėlis;RAMUNĖLĖS;6883156109;Taip;13;3;0;16
2656;Gelvonėlis;RAMUNĖLĖS;1562829157;Taip;6;3;0;9
2657;Gelvonėlis;RAMUNĖLĖS;4211228746;Taip;10;0;0;10
2658;Gelvonėlis;RAMUNĖLĖS;6365451610;Taip;0;2;0;2
2659;Gelvonėlis;RAMUNĖLĖS;1661034338;Taip;0;0;1;1
2660;Gelvonėlis;RAMUNĖLĖS;6851036864;Taip;13;0;0;13
2661;Gelvonėlis;RAMUNĖLĖS;2821485779;Taip;14;0;0;14
2662;Gelvonėlis;RAMUNĖLĖS;6518583809;Taip;18;0;0;18
2663;Gelvonėlis;RAMUNĖLĖS;2818319130;Taip;5;0;0;5
2664;Gelvonėlis;RIEŠUTĖLIAI;3368423382;Taip;0;2;0;2
2665;Gelvonėlis;RIEŠUTĖLIAI;3973248307;Taip;0;2;0;2
2666;Gelvonėlis;RIEŠUTĖLIAI;5461812139;Taip;1;4;0;5
2667;Gelvonėlis;RIEŠUTĖLIAI;5986018609;Taip;12;0;0;12
2668;Gelvonėlis;RIEŠUTĖLIAI;4208103106;Taip;6;1;3;10
2669;Gelvonėlis;RIEŠUTĖLIAI;8766702456;Taip;5;3;1;9
2670;Gelvonėlis;RIEŠUTĖLIAI;6305084811;Taip;8;0;4;12
2671;Gelvonėlis;RIEŠUTĖLIAI;2005647155;Taip;0;3;1;4
2672;Gelvonėlis;RIEŠUTĖLIAI;1266479895;Taip;0;5;0;5
2673;Gelvonėlis;RIEŠUTĖLIAI;5934077931;Taip;0;8;0;8
2674;Gelvonėlis;RIEŠUTĖLIAI;4280463938;Taip;0;4;0;4
2675;Gelvonėlis;RIEŠUTĖLIAI;6471921512;Taip;0;4;0;4
2676;Gelvonėlis;RIEŠUTĖLIAI;3448444552;Taip;7;4;0;11
2677;Gelvonėlis;RIEŠUTĖLIAI;4832167372;Taip;14;0;0;14
2678;Gelvonėlis;RIEŠUTĖLIAI;9301814935;Taip;0;9;0;9
2679;Gelvonėlis;RIEŠUTĖLIAI;1466616814;Taip;9;0;1;10
2680;Gelvonėlis;RIEŠUTĖLIAI;2015807805;Taip;17;0;0;17
2681;Gelvonėlis;RIEŠUTĖLIAI;9323228591;Taip;4;6;1;11
2682;Gelvonėlis;RIEŠUTĖLIAI;2360728722;Taip;9;3;1;13
2683;Gelvonėlis;RIEŠUTĖLIAI;9132529216;Taip;0;11;0;11
2684;"Gervelė (Dzūkų g. 32)";ŽIRNIUKAI;2523056808;Taip;0;7;5;12
2685;"Gervelė (Dzūkų g. 32)";ŽIRNIUKAI;8533480337;Taip;0;5;0;5
2686;"Gervelė (Dzūkų g. 32)";ŽIRNIUKAI;6895415337;Taip;0;3;0;3
2687;"Gervelė (Dzūkų g. 32)";ŽIRNIUKAI;6227091658;Taip;0;3;0;3
2688;"Gervelė (Dzūkų g. 32)";ŽIRNIUKAI;8439479958;Taip;10;6;0;16
2689;"Gervelė (Dzūkų g. 32)";ŽIRNIUKAI;6844406500;Ne;0;12;0;12
2690;"Gervelė (Dzūkų g. 32)";ŽIRNIUKAI;2359854614;Taip;0;3;0;3
2691;"Gervelė (Dzūkų g. 32)";ŽIRNIUKAI;8811086908;Taip;0;8;0;8
2692;"Gervelė (Dzūkų g. 32)";ŽIRNIUKAI;1573560581;Taip;7;0;4;11
2693;"Gervelė (Dzūkų g. 32)";ŽIRNIUKAI;9133101055;Taip;10;3;0;13
2694;"Gervelė (Dzūkų g. 32)";ŽIRNIUKAI;7192663882;Taip;6;0;1;7
2695;"Gervelė (Dzūkų g. 32)";ŽIRNIUKAI;1783612448;Taip;6;0;4;10
2696;"Gervelė (Dzūkų g. 32)";ŽIRNIUKAI;2563081304;Taip;9;2;1;12
2697;"Gervelė (Dzūkų g. 32)";ŽIRNIUKAI;1101877666;Ne;18;0;0;18
2698;"Gervelė (Dzūkų g. 32)";ŽIRNIUKAI;3164744527;Taip;0;14;0;14
2699;"Gervelė (Dzūkų g. 32)";ŽIRNIUKAI;2046282471;Taip;18;0;0;18
2700;"Gervelė (Dzūkų g. 32)";ŽIRNIUKAI;1024397071;Ne;0;0;8;8
2701;"Gervelė (Dzūkų g. 32)";ŽIRNIUKAI;7040713170;Ne;0;0;4;4
2702;"Gervelė (Dzūkų g. 32)";ŽIRNIUKAI;4075328330;Taip;0;0;14;14
2703;"Gervelė (Dzūkų g. 32)";LAŠIUKAI;3702908570;Taip;0;0;3;3
2704;"Gervelė (Dzūkų g. 32)";LAŠIUKAI;3647044817;Taip;0;0;7;7
2705;"Gervelė (Dzūkų g. 32)";LAŠIUKAI;6431701403;Taip;0;0;8;8
2706;"Gervelė (Dzūkų g. 32)";LAŠIUKAI;7721421570;Taip;0;3;0;3
2707;"Gervelė (Dzūkų g. 32)";LAŠIUKAI;2413995770;Taip;13;4;0;17
2708;"Gervelė (Dzūkų g. 32)";LAŠIUKAI;1637204236;Taip;7;3;3;13
2709;"Gervelė (Dzūkų g. 32)";LAŠIUKAI;8157865822;Taip;0;7;0;7
2710;"Gervelė (Dzūkų g. 32)";LAŠIUKAI;7924884022;Taip;0;10;0;10
2711;"Gervelė (Dzūkų g. 32)";LAŠIUKAI;6834663627;Taip;2;11;0;13
2712;"Gervelė (Dzūkų g. 32)";LAŠIUKAI;1323074335;Taip;10;0;0;10
2713;"Gervelė (Dzūkų g. 32)";LAŠIUKAI;6058944385;Taip;0;7;0;7
2714;"Gervelė (Dzūkų g. 32)";LAŠIUKAI;2446758975;Taip;5;5;0;10
2715;"Gervelė (Dzūkų g. 32)";LAŠIUKAI;1353920541;Taip;5;4;0;9
2716;"Gervelė (Dzūkų g. 32)";LAŠIUKAI;5799823801;Taip;0;0;4;4
2717;"Gervelė (Dzūkų g. 32)";LAŠIUKAI;4899690598;Ne;7;0;4;11
2718;"Gervelė (Dzūkų g. 32)";PABIRUČIAI;7317091881;Taip;11;0;0;11
2719;"Gervelė (Dzūkų g. 32)";PABIRUČIAI;7020599764;Taip;5;3;0;8
2720;"Gervelė (Dzūkų g. 32)";PABIRUČIAI;6951455424;Taip;0;0;5;5
2721;"Gervelė (Dzūkų g. 32)";PABIRUČIAI;1112844296;Taip;0;0;6;6
2722;"Gervelė (Dzūkų g. 32)";PABIRUČIAI;6287806975;Taip;0;5;0;5
2723;"Gervelė (Dzūkų g. 32)";PABIRUČIAI;6228025635;Taip;8;0;4;12
2724;"Gervelė (Dzūkų g. 32)";PABIRUČIAI;9977349707;Taip;0;3;0;3
2725;"Gervelė (Dzūkų g. 32)";PABIRUČIAI;6155979185;Taip;6;5;0;11
2726;"Gervelė (Dzūkų g. 32)";PABIRUČIAI;3333885493;Taip;5;4;0;9
2727;"Gervelė (Dzūkų g. 32)";PABIRUČIAI;4295743997;Taip;0;1;2;3
2728;"Gervelė (Dzūkų g. 32)";PABIRUČIAI;7935059565;Taip;9;1;1;11
2729;"Gervelė (Dzūkų g. 32)";PABIRUČIAI;5267617723;Taip;0;2;0;2
2730;"Gervelė (Dzūkų g. 32)";PABIRUČIAI;5953552777;Taip;0;6;0;6
2731;"Gervelė (Dzūkų g. 32)";PABIRUČIAI;4038179503;Taip;15;3;1;19
2732;"Gervelė (Dzūkų g. 32)";PABIRUČIAI;1160084928;Taip;6;0;7;13
2733;"Gervelė (Dzūkų g. 32)";PABIRUČIAI;6987657237;Taip;4;0;2;6
2734;"Gervelė (Dzūkų g. 32)";PABIRUČIAI;8016341646;Taip;8;0;1;9
2735;"Gervelė (Dzūkų g. 32)";PABIRUČIAI;5685222621;Taip;16;0;1;17
2736;"Gervelė (Dzūkų g. 32)";PABIRUČIAI;4294916559;Taip;4;1;0;5
2737;"Gervelė (Dzūkų g. 32)";PABIRUČIAI;3449674095;Ne;0;4;0;4
2738;"Gervelė (Dzūkų g. 32)";BITUTĖS;6448855055;Taip;0;2;0;2
2739;"Gervelė (Dzūkų g. 32)";BITUTĖS;6090290046;Taip;1;2;3;6
2740;"Gervelė (Dzūkų g. 32)";BITUTĖS;75080308291;Taip;0;7;0;7
2741;"Gervelė (Dzūkų g. 32)";BITUTĖS;6737174004;Taip;0;7;0;7
2742;"Gervelė (Dzūkų g. 32)";BITUTĖS;1616949023;Taip;0;4;0;4
2743;"Gervelė (Dzūkų g. 32)";BITUTĖS;3427400844;Taip;0;9;0;9
2744;"Gervelė (Dzūkų g. 32)";BITUTĖS;8152446576;Taip;5;4;1;10
2745;"Gervelė (Dzūkų g. 32)";BITUTĖS;7302238728;Taip;0;4;0;4
2746;"Gervelė (Dzūkų g. 32)";BITUTĖS;1400044294;Taip;0;3;1;4
2747;"Gervelė (Dzūkų g. 32)";BITUTĖS;8062089041;Taip;2;14;0;16
2748;"Gervelė (Dzūkų g. 32)";BITUTĖS;7697761552;Taip;0;3;1;4
2749;"Gervelė (Dzūkų g. 32)";BITUTĖS;5989713844;Taip;4;1;0;5
2750;"Gervelė (Dzūkų g. 32)";BITUTĖS;4560752068;Taip;0;5;0;5
2751;"Gervelė (Dzūkų g. 32)";BITUTĖS;89076506192;Taip;0;5;0;5
2752;"Gervelė (Dzūkų g. 32)";BITUTĖS;87619285504;Taip;0;3;4;7
2753;"Gervelė (Dzūkų g. 32)";BITUTĖS;1991238577;Taip;0;7;0;7
2754;"Gervelė (Dzūkų g. 32)";BITUTĖS;2167744244;Taip;5;5;0;10
2755;"Gervelė (Dzūkų g. 32)";BITUTĖS;3525060645;Taip;18;0;0;18
2756;"Gervelė (Dzūkų g. 32)";BITUTĖS;7162551366;Taip;0;18;0;18
2757;"Gervelė (Dzūkų g. 32)";BITUTĖS;9970293084;Taip;0;6;0;6
2758;"Gervelė (Dzūkų g. 32)";BURATINO;3946391650;Taip;6;2;0;8
2759;"Gervelė (Dzūkų g. 32)";BURATINO;7620764911;Taip;0;12;0;12
2760;"Gervelė (Dzūkų g. 32)";BURATINO;9239897472;Taip;9;3;0;12
2761;"Gervelė (Dzūkų g. 32)";BURATINO;8997525194;Taip;10;5;0;15
2762;"Gervelė (Dzūkų g. 32)";BURATINO;3359793310;Ne;0;3;6;9
2763;"Gervelė (Dzūkų g. 32)";BURATINO;9982951468;Taip;13;5;0;18
2764;"Gervelė (Dzūkų g. 32)";BURATINO;5900623823;Taip;5;6;0;11
2765;"Gervelė (Dzūkų g. 32)";BURATINO;4775822341;Taip;5;7;0;12
2766;"Gervelė (Dzūkų g. 32)";BURATINO;8012122042;Taip;2;6;0;8
2767;"Gervelė (Dzūkų g. 32)";BURATINO;2541771432;Ne;8;4;0;12
2768;"Gervelė (Dzūkų g. 32)";BURATINO;2913622440;Taip;18;0;0;18
2769;"Gervelė (Dzūkų g. 32)";BURATINO;3912789554;Ne;10;3;0;13
2770;"Gervelė (Dzūkų g. 32)";BURATINO;4434618210;Taip;3;3;0;6
2771;"Gervelė (Dzūkų g. 32)";BURATINO;1108744283;Taip;0;6;0;6
2772;"Gervelė (Dzūkų g. 32)";BURATINO;6166476760;Ne;10;0;0;10
2773;"Gervelė (Dzūkų g. 32)";BURATINO;4516538272;Taip;6;3;0;9
2774;"Gervelė (Dzūkų g. 32)";BURATINO;9256422807;Taip;11;3;0;14
2775;"Gervelė (Dzūkų g. 32)";BURATINO;3723783633;Taip;12;0;0;12
2776;"Gervelė (Dzūkų g. 32)";BURATINO;9997346812;Taip;5;0;0;5
2777;"Gervelė (Dzūkų g. 32)";VIŠČIUKŲ;1020706652;Taip;0;0;1;1
2778;"Gervelė (Dzūkų g. 32)";VIŠČIUKŲ;9532470407;Taip;3;0;1;4
2779;"Gervelė (Dzūkų g. 32)";VIŠČIUKŲ;8792240321;Taip;0;0;4;4
2780;"Gervelė (Dzūkų g. 32)";VIŠČIUKŲ;7205673717;Taip;0;3;0;3
2781;"Gervelė (Dzūkų g. 32)";VIŠČIUKŲ;7140356352;Taip;12;0;0;12
2782;"Gervelė (Dzūkų g. 32)";VIŠČIUKŲ;8598429197;Taip;0;0;6;6
2783;"Gervelė (Dzūkų g. 32)";VIŠČIUKŲ;9294388176;Taip;4;0;1;5
2784;"Gervelė (Dzūkų g. 32)";VIŠČIUKŲ;3230279203;Taip;6;0;1;7
2785;"Gervelė (Dzūkų g. 32)";VIŠČIUKŲ;8392147716;Taip;23;0;2;25
2786;"Gervelė (Dzūkų g. 32)";VIŠČIUKŲ;5608916470;Taip;6;0;0;6
2787;"Gervelė (Dzūkų g. 32)";VIŠČIUKŲ;8098158634;Taip;4;0;1;5
2788;"Gervelė (Dzūkų g. 32)";VIŠČIUKŲ;3554640994;Taip;6;0;0;6
2789;"Gervelė (Dzūkų g. 32)";VIŠČIUKŲ;9478720027;Taip;13;0;2;15
2790;"Gervelė (Dzūkų g. 32)";VIŠČIUKŲ;4552290778;Taip;14;0;0;14
2791;"Gervelė (Dzūkų g. 32)";VIŠČIUKŲ;3170062234;Taip;7;0;3;10
2792;"Gervelė (Dzūkų g. 32)";VIŠČIUKŲ;1226130732;Taip;9;0;1;10
2793;"Gervelė (Dzūkų g. 32)";VIŠČIUKŲ;8983236945;Taip;0;0;9;9
2794;"Gilužis (Vydūno g. 11A)";Skruzdėliukų;35511006307;Taip;5;4;0;9
2795;"Gilužis (Vydūno g. 11A)";Skruzdėliukų;1671692484;Taip;0;3;0;3
2796;"Gilužis (Vydūno g. 11A)";Skruzdėliukų;1615293331;Taip;0;4;0;4
2797;"Gilužis (Vydūno g. 11A)";Skruzdėliukų;9474400084;Taip;0;3;0;3
2798;"Gilužis (Vydūno g. 11A)";Skruzdėliukų;5161095299;Taip;0;3;0;3
2799;"Gilužis (Vydūno g. 11A)";Skruzdėliukų;70959404439;Taip;0;4;0;4
2800;"Gilužis (Vydūno g. 11A)";Skruzdėliukų;8120898865;Taip;0;8;0;8
2801;"Gilužis (Vydūno g. 11A)";Skruzdėliukų;8840822243;Taip;10;3;0;13
2802;"Gilužis (Vydūno g. 11A)";Skruzdėliukų;4611735601;Taip;7;5;1;13
2803;"Gilužis (Vydūno g. 11A)";Skruzdėliukų;4747769984;Taip;0;5;0;5
2804;"Gilužis (Vydūno g. 11A)";Skruzdėliukų;5920357223;Taip;4;3;0;7
2805;"Gilužis (Vydūno g. 11A)";Skruzdėliukų;8595541498;Taip;5;6;0;11
2806;"Gilužis (Vydūno g. 11A)";Skruzdėliukų;5365582271;Taip;12;4;0;16
2807;"Gilužis (Vydūno g. 11A)";Skruzdėliukų;7364297673;Taip;7;3;0;10
2808;"Gilužis (Vydūno g. 11A)";Skruzdėliukų;4362244070;Taip;2;2;0;4
2809;"Gilužis (Vydūno g. 11A)";Skruzdėliukų;2042514241;Taip;0;3;1;4
2810;"Gilužis (Vydūno g. 11A)";Skruzdėliukų;3216004438;Taip;0;3;0;3
2811;"Gilužis (Vydūno g. 11A)";Skruzdėliukų;7766747590;Taip;0;0;1;1
2812;"Gilužis (Vydūno g. 11A)";Skruzdėliukų;48365991937;Taip;10;3;0;13
2813;"Gilužis (Vydūno g. 11A)";Skruzdėliukų;1452016675;Taip;10;1;0;11
2814;"Gilužis (Vydūno g. 11A)";Skruzdėliukų;29586826889;Taip;8;4;0;12
2815;"Gilužis (Vydūno g. 11A)";Skruzdėliukų;3071312399;Taip;1;5;0;6
2816;"Gilužis (Vydūno g. 11A)";Skruzdėliukų;6233020671;Taip;5;4;0;9
2817;"Gilužis (Vydūno g. 11A)";Nykštukų;3132445117;Taip;0;3;0;3
2818;"Gilužis (Vydūno g. 11A)";Nykštukų;4147821853;Taip;0;4;0;4
2819;"Gilužis (Vydūno g. 11A)";Nykštukų;7937643339;Taip;3;4;0;7
2820;"Gilužis (Vydūno g. 11A)";Nykštukų;3473889426;Taip;5;2;0;7
2821;"Gilužis (Vydūno g. 11A)";Nykštukų;9362581908;Taip;5;2;0;7
2822;"Gilužis (Vydūno g. 11A)";Nykštukų;8899557365;Taip;15;0;0;15
2823;"Gilužis (Vydūno g. 11A)";Nykštukų;2661894041;Taip;14;0;0;14
2824;"Gilužis (Vydūno g. 11A)";Nykštukų;5109935385;Taip;2;3;0;5
2825;"Gilužis (Vydūno g. 11A)";Nykštukų;7228498662;Taip;5;1;0;6
2826;"Gilužis (Vydūno g. 11A)";Nykštukų;3335512812;Taip;10;8;0;18
2827;"Gilužis (Vydūno g. 11A)";Nykštukų;1459273692;Taip;12;3;0;15
2828;"Gilužis (Vydūno g. 11A)";Nykštukų;4156613717;Taip;0;12;1;13
2829;"Gilužis (Vydūno g. 11A)";Nykštukų;5713786735;Taip;10;0;0;10
2830;"Gilužis (Vydūno g. 11A)";Nykštukų;4956685016;Taip;2;2;0;4
2831;"Gilužis (Vydūno g. 11A)";Nykštukų;6315155554;Taip;6;1;0;7
2832;"Gilužis (Vydūno g. 11A)";Nykštukų;9332056404;Taip;6;0;3;9
2833;"Gilužis (Vydūno g. 11A)";Nykštukų;4541291716;Taip;5;3;0;8
2834;"Gilužis (Vydūno g. 11A)";Nykštukų;8522552650;Taip;0;11;0;11
2835;"Gilužis (Vydūno g. 11A)";Nykštukų;3176305306;Taip;0;7;0;7
2836;"Gilužis (Vydūno g. 11A)";Nykštukų;4795108770;Ne;8;1;0;9
2837;"Gilužis (Vydūno g. 11A)";Nykštukų;4094486541;Taip;2;7;3;12
2838;"Gilužis (Vydūno g. 11A)";Nykštukų;6493142538;Taip;5;2;0;7
2839;"Gilužis (Vydūno g. 11A)";Nykštukų;5088561405;Taip;5;5;0;10
2840;"Gilužis (Vydūno g. 11A)";Bitučių;4841014668;Taip;5;3;0;8
2841;"Gilužis (Vydūno g. 11A)";Bitučių;3399162399;Taip;0;2;0;2
2842;"Gilužis (Vydūno g. 11A)";Bitučių;5973671038;Taip;0;2;0;2
2843;"Gilužis (Vydūno g. 11A)";Bitučių;1634295583;Taip;0;2;1;3
2844;"Gilužis (Vydūno g. 11A)";Bitučių;4360261750;Taip;0;2;2;4
2845;"Gilužis (Vydūno g. 11A)";Bitučių;5728341732;Taip;2;2;1;5
2846;"Gilužis (Vydūno g. 11A)";Bitučių;2780710383;Taip;3;0;0;3
2847;"Gilužis (Vydūno g. 11A)";Bitučių;6931726275;Taip;0;2;5;7
2848;"Gilužis (Vydūno g. 11A)";Bitučių;1867185320;Taip;7;3;0;10
2849;"Gilužis (Vydūno g. 11A)";Bitučių;3429435736;Taip;5;0;5;10
2850;"Gilužis (Vydūno g. 11A)";Bitučių;8539946703;Taip;0;18;0;18
2851;"Gilužis (Vydūno g. 11A)";Bitučių;9000351000;Taip;1;5;0;6
2852;"Gilužis (Vydūno g. 11A)";Bitučių;5366174839;Taip;0;8;0;8
2853;"Gilužis (Vydūno g. 11A)";Bitučių;5162397237;Taip;0;6;0;6
2854;"Gilužis (Vydūno g. 11A)";Bitučių;7250617867;Taip;0;6;0;6
2855;"Gilužis (Vydūno g. 11A)";Bitučių;9053608903;Taip;7;7;0;14
2856;"Gilužis (Vydūno g. 11A)";Bitučių;6115776872;Taip;13;0;1;14
2857;"Gilužis (Vydūno g. 11A)";Bitučių;5651799121;Taip;9;0;3;12
2858;"Gilužis (Vydūno g. 11A)";Bitučių;1334619137;Taip;5;1;2;8
2859;"Gilužis (Vydūno g. 11A)";Bitučių;2950813185;Taip;8;3;0;11
2860;"Gilužis (Vydūno g. 11A)";Bitučių;6515525848;Taip;10;4;0;14
2861;"Gilužis (Vydūno g. 11A)";Bitučių;2345403784;Taip;2;0;2;4
2862;"Gilužis (Vydūno g. 11A)";Kačiukų;1273655212;Taip;0;3;0;3
2863;"Gilužis (Vydūno g. 11A)";Kačiukų;4978922821;Taip;5;5;0;10
2864;"Gilužis (Vydūno g. 11A)";Kačiukų;2945406185;Taip;0;5;0;5
2865;"Gilužis (Vydūno g. 11A)";Kačiukų;1582241363;Taip;5;3;0;8
2866;"Gilužis (Vydūno g. 11A)";Kačiukų;7330938312;Taip;7;0;0;7
2867;"Gilužis (Vydūno g. 11A)";Kačiukų;6571132974;Taip;0;18;0;18
2868;"Gilužis (Vydūno g. 11A)";Kačiukų;7001112696;Taip;0;3;1;4
2869;"Gilužis (Vydūno g. 11A)";Kačiukų;9034842169;Taip;0;0;2;2
2870;"Gilužis (Vydūno g. 11A)";Kačiukų;6966795180;Taip;6;0;4;10
2871;"Gilužis (Vydūno g. 11A)";Kačiukų;5128383851;Taip;5;3;1;9
2872;"Gilužis (Vydūno g. 11A)";Kačiukų;8318405114;Taip;4;3;0;7
2873;"Gilužis (Vydūno g. 11A)";Kačiukų;7826015897;Taip;18;0;0;18
2874;"Gilužis (Vydūno g. 11A)";Kačiukų;4403218878;Taip;5;2;1;8
2875;"Gilužis (Vydūno g. 11A)";Kačiukų;9186274541;Taip;5;3;0;8
2876;"Gilužis (Vydūno g. 11A)";Kačiukų;3419281756;Taip;2;3;0;5
2877;"Gilužis (Vydūno g. 11A)";Kačiukų;1862524255;Taip;0;3;0;3
2878;"Gilužis (Vydūno g. 11A)";Kačiukų;9421351780;Taip;0;3;0;3
2879;"Gilužis (Vydūno g. 11A)";Kačiukų;6404411477;Taip;0;6;0;6
2880;"Gilužis (Vydūno g. 11A)";Kačiukų;4128387076;Taip;0;0;5;5
2881;"Gilužis (Vydūno g. 11A)";Kačiukų;7042664923;Taip;0;3;1;4
2882;"Gilužis (Vydūno g. 11A)";Kačiukų;9097165155;Taip;14;0;0;14
2883;"Gilužis (Vydūno g. 11A)";Kačiukų;8762534617;Taip;0;3;0;3
2884;"Gilužis (Vydūno g. 11A)";Pelėdžiukų;5217748032;Taip;0;6;0;6
2885;"Gilužis (Vydūno g. 11A)";Pelėdžiukų;5989314494;Taip;14;3;0;17
2886;"Gilužis (Vydūno g. 11A)";Pelėdžiukų;7998695149;Taip;12;1;0;13
2887;"Gilužis (Vydūno g. 11A)";Pelėdžiukų;7742783427;Taip;12;1;0;13
2888;"Gilužis (Vydūno g. 11A)";Pelėdžiukų;7358572344;Taip;6;3;0;9
2889;"Gilužis (Vydūno g. 11A)";Pelėdžiukų;4617259961;Taip;0;2;0;2
2890;"Gilužis (Vydūno g. 11A)";Pelėdžiukų;1222370750;Taip;0;4;0;4
2891;"Gilužis (Vydūno g. 11A)";Pelėdžiukų;9503516686;Taip;0;4;0;4
2892;"Gilužis (Vydūno g. 11A)";Pelėdžiukų;9833451628;Taip;0;5;0;5
2893;"Gilužis (Vydūno g. 11A)";Pelėdžiukų;6270071724;Taip;0;3;0;3
2894;"Gilužis (Vydūno g. 11A)";Pelėdžiukų;7505729606;Taip;9;1;0;10
2895;"Gilužis (Vydūno g. 11A)";Pelėdžiukų;4051726208;Taip;0;5;0;5
2896;"Gilužis (Vydūno g. 11A)";Pelėdžiukų;7092060789;Taip;0;3;0;3
2897;"Gilužis (Vydūno g. 11A)";Pelėdžiukų;4435227217;Taip;2;0;1;3
2898;"Gilužis (Vydūno g. 11A)";Pelėdžiukų;1804218972;Taip;0;3;0;3
2899;"Gilužis (Vydūno g. 11A)";Pelėdžiukų;2434419240;Taip;8;0;0;8
2900;"Gilužis (Vydūno g. 11A)";Pelėdžiukų;1832039250;Taip;11;3;0;14
2901;"Gilužis (Vydūno g. 11A)";Pelėdžiukų;3166161973;Taip;5;3;0;8
2902;"Gilužis (Vydūno g. 11A)";Pelėdžiukų;5070988982;Taip;0;5;0;5
2903;"Gilužis (Vydūno g. 11A)";Pelėdžiukų;7899274495;Taip;8;0;5;13
2904;"Gilužis (Vydūno g. 11A)";Pelėdžiukų;6093514885;Taip;1;3;3;7
2905;"Gilužis (Vydūno g. 11A)";Pelėdžiukų;2869506388;Taip;6;7;0;13
2906;"Gilužis (Vydūno g. 11A)";Pelėdžiukų;9520409342;Taip;0;2;1;3
2907;"Gilužis (Vydūno g. 11A)";Drugelių;6121625070;Taip;5;3;1;9
2908;"Gilužis (Vydūno g. 11A)";Drugelių;1770064694;Taip;7;6;0;13
2909;"Gilužis (Vydūno g. 11A)";Drugelių;9591229878;Taip;0;3;1;4
2910;"Gilužis (Vydūno g. 11A)";Drugelių;9092013248;Taip;10;4;0;14
2911;"Gilužis (Vydūno g. 11A)";Drugelių;9109883577;Taip;6;1;4;11
2912;"Gilužis (Vydūno g. 11A)";Drugelių;8006465211;Taip;1;1;4;6
2913;"Gilužis (Vydūno g. 11A)";Drugelių;5118401707;Taip;5;2;0;7
2914;"Gilužis (Vydūno g. 11A)";Drugelių;3190597262;Taip;5;3;3;11
2915;"Gilužis (Vydūno g. 11A)";Drugelių;2988856911;Taip;0;5;0;5
2916;"Gilužis (Vydūno g. 11A)";Drugelių;3532863024;Taip;0;18;0;18
2917;"Gilužis (Vydūno g. 11A)";Drugelių;1376645277;Taip;5;3;0;8
2918;"Gilužis (Vydūno g. 11A)";Drugelių;1410870589;Taip;0;13;0;13
2919;"Gilužis (Vydūno g. 11A)";Drugelių;6786334223;Taip;5;1;3;9
2920;"Gilužis (Vydūno g. 11A)";Drugelių;9112993465;Taip;10;0;6;16
2921;"Gilužis (Vydūno g. 11A)";Drugelių;4909329417;Taip;4;5;0;9
2922;"Gilužis (Vydūno g. 11A)";Drugelių;8244385001;Taip;2;6;0;8
2923;"Gilužis (Vydūno g. 11A)";Drugelių;6429142049;Taip;8;0;3;11
2924;"Gilužis (Vydūno g. 11A)";Drugelių;7731169885;Taip;2;6;0;8
2925;"Gilužis (Vydūno g. 11A)";Drugelių;1093643746;Taip;0;3;0;3
2926;"Gilužis (Vydūno g. 11A)";Drugelių;3902713866;Taip;5;0;0;5
2927;"Gilužis (Vydūno g. 11A)";Drugelių;6950139609;Taip;6;3;2;11
2928;"Gilužis (Vydūno g. 11A)";Drugelių;2397231165;Taip;8;1;2;11
2929;"Gilužis (Vydūno g. 11A)";Saulučių;17896774143;Taip;6;3;1;10
2930;"Gilužis (Vydūno g. 11A)";Saulučių;9918995545;Taip;0;3;0;3
2931;"Gilužis (Vydūno g. 11A)";Saulučių;4209000927;Taip;0;3;1;4
2932;"Gilužis (Vydūno g. 11A)";Saulučių;8595551150;Taip;0;5;1;6
2933;"Gilužis (Vydūno g. 11A)";Saulučių;4575619425;Taip;0;3;0;3
2934;"Gilužis (Vydūno g. 11A)";Saulučių;4473810097;Taip;0;6;0;6
2935;"Gilužis (Vydūno g. 11A)";Saulučių;1649256496;Taip;0;3;0;3
2936;"Gilužis (Vydūno g. 11A)";Saulučių;96550272401;Taip;8;3;1;12
2937;"Gilužis (Vydūno g. 11A)";Saulučių;69504888193;Taip;0;2;0;2
2938;"Gilužis (Vydūno g. 11A)";Saulučių;2391630554;Taip;5;3;0;8
2939;"Gilužis (Vydūno g. 11A)";Saulučių;18997894859;Taip;10;3;0;13
2940;"Gilužis (Vydūno g. 11A)";Saulučių;7744997250;Taip;15;3;0;18
2941;"Gilužis (Vydūno g. 11A)";Saulučių;32730847948;Taip;12;0;0;12
2942;"Gilužis (Vydūno g. 11A)";Saulučių;3181765606;Taip;0;3;0;3
2943;"Gilužis (Vydūno g. 11A)";Saulučių;5905237803;Taip;3;3;1;7
2944;"Gilužis (Vydūno g. 11A)";Saulučių;79805583046;Taip;0;3;1;4
2945;"Gilužis (Vydūno g. 11A)";Saulučių;2872439079;Taip;0;3;2;5
2946;"Gilužis (Vydūno g. 11A)";Saulučių;87425898496;Taip;0;3;0;3
2947;"Gilužis (Vydūno g. 11A)";Saulučių;35650138667;Taip;14;3;0;17
2948;"Gilužis (Vydūno g. 11A)";Saulučių;9367673896;Taip;17;0;0;17
2949;"Gilužis (Vydūno g. 11A)";Saulučių;1453976300;Taip;0;3;0;3
2950;"Gilužis (Vydūno g. 11A)";Saulučių;1211233315;Taip;0;3;2;5
2951;"Gilužis (Vydūno g. 11A)";Saulučių;5621912516;Taip;0;10;0;10
2952;"Gilužis (Vydūno g. 11A)";Paukštelių;46597815116;Taip;5;3;0;8
2953;"Gilužis (Vydūno g. 11A)";Paukštelių;1877467761;Taip;4;3;4;11
2954;"Gilužis (Vydūno g. 11A)";Paukštelių;1146713023;Taip;0;2;0;2
2955;"Gilužis (Vydūno g. 11A)";Paukštelių;1980250599;Taip;0;3;1;4
2956;"Gilužis (Vydūno g. 11A)";Paukštelių;1962914764;Taip;0;3;1;4
2957;"Gilužis (Vydūno g. 11A)";Paukštelių;7636249706;Taip;0;4;0;4
2958;"Gilužis (Vydūno g. 11A)";Paukštelių;2508958685;Taip;0;3;10;13
2959;"Gilužis (Vydūno g. 11A)";Paukštelių;72738770293;Taip;0;2;0;2
2960;"Gilužis (Vydūno g. 11A)";Paukštelių;8875479631;Taip;10;5;0;15
2961;"Gilužis (Vydūno g. 11A)";Paukštelių;5759145600;Taip;0;18;0;18
2962;"Gilužis (Vydūno g. 11A)";Paukštelių;8662424856;Taip;5;3;0;8
2963;"Gilužis (Vydūno g. 11A)";Paukštelių;2436416327;Taip;0;3;0;3
2964;"Gilužis (Vydūno g. 11A)";Paukštelių;6218943275;Taip;0;4;0;4
2965;"Gilužis (Vydūno g. 11A)";Paukštelių;2754594238;Taip;0;3;0;3
2966;"Gilužis (Vydūno g. 11A)";Paukštelių;8110869130;Taip;1;3;0;4
2967;"Gilužis (Vydūno g. 11A)";Paukštelių;1344240019;Taip;0;1;0;1
2968;"Gilužis (Vydūno g. 11A)";Paukštelių;4297300799;Taip;0;4;2;6
2969;"Gilužis (Vydūno g. 11A)";Paukštelių;8531121002;Taip;0;4;0;4
2970;"Gilužis (Vydūno g. 11A)";Paukštelių;9314893329;Taip;5;3;0;8
2971;"Gilužis (Vydūno g. 11A)";Paukštelių;46276990963;Taip;0;3;2;5
2972;"Gilužis (Vydūno g. 11A)";Paukštelių;5303511810;Taip;15;3;0;18
2973;"Gilužis (Vydūno g. 11A)";Obuoliukų;8201769917;Taip;0;7;0;7
2974;"Gilužis (Vydūno g. 11A)";Obuoliukų;9892608223;Taip;0;8;0;8
2975;"Gilužis (Vydūno g. 11A)";Obuoliukų;4058698645;Taip;0;4;0;4
2976;"Gilužis (Vydūno g. 11A)";Obuoliukų;1540018160;Taip;0;4;0;4
2977;"Gilužis (Vydūno g. 11A)";Obuoliukų;7716908903;Taip;6;0;0;6
2978;"Gilužis (Vydūno g. 11A)";Obuoliukų;3131597174;Taip;0;7;0;7
2979;"Gilužis (Vydūno g. 11A)";Obuoliukų;6239369861;Taip;6;3;1;10
2980;"Gilužis (Vydūno g. 11A)";Obuoliukų;6172360933;Taip;4;3;0;7
2981;"Gilužis (Vydūno g. 11A)";Obuoliukų;7398446674;Taip;0;4;0;4
2982;"Gilužis (Vydūno g. 11A)";Obuoliukų;4592380105;Taip;14;4;0;18
2983;"Gilužis (Vydūno g. 11A)";Obuoliukų;4242362889;Taip;0;4;0;4
2984;"Gilužis (Vydūno g. 11A)";Obuoliukų;7560732216;Taip;0;4;0;4
2985;"Gilužis (Vydūno g. 11A)";Obuoliukų;5476140202;Taip;5;3;0;8
2986;"Gilužis (Vydūno g. 11A)";Obuoliukų;8194444043;Taip;1;1;0;2
2987;"Gilužis (Vydūno g. 11A)";Obuoliukų;7606394325;Taip;18;0;0;18
2988;"Gilužis (Vydūno g. 11A)";Obuoliukų;6737884137;Taip;0;8;0;8
2989;"Gilužis (Vydūno g. 11A)";Obuoliukų;6825745985;Taip;0;5;0;5
2990;"Gilužis (Vydūno g. 11A)";Obuoliukų;3458957423;Taip;4;3;0;7
2991;"Gilužis (Vydūno g. 11A)";Obuoliukų;8900414658;Taip;8;1;0;9
2992;"Gilužis (Vydūno g. 11A)";Obuoliukų;3219101391;Taip;1;7;0;8
2993;"Gilužis (Vydūno g. 11A)";Obuoliukų;4528131001;Taip;3;7;0;10
2994;"Gilužis (Vydūno g. 11A)";Obuoliukų;5895659747;Taip;8;6;0;14
2995;"Gilužis (Vydūno g. 11A)";KIŠKUČIŲ;5744027226;Taip;2;3;0;5
2996;"Gilužis (Vydūno g. 11A)";KIŠKUČIŲ;8639633038;Taip;0;3;4;7
2997;"Gilužis (Vydūno g. 11A)";KIŠKUČIŲ;9484221435;Taip;0;0;1;1
2998;"Gilužis (Vydūno g. 11A)";KIŠKUČIŲ;6323747855;Taip;0;0;2;2
2999;"Gilužis (Vydūno g. 11A)";KIŠKUČIŲ;2680643896;Taip;0;5;0;5
3000;"Gilužis (Vydūno g. 11A)";KIŠKUČIŲ;5685074731;Taip;6;0;4;10
3001;"Gilužis (Vydūno g. 11A)";KIŠKUČIŲ;7632771776;Taip;8;0;0;8
3002;"Gilužis (Vydūno g. 11A)";KIŠKUČIŲ;7477282548;Taip;5;3;0;8
3003;"Gilužis (Vydūno g. 11A)";KIŠKUČIŲ;9061835019;Taip;0;0;4;4
3004;"Gilužis (Vydūno g. 11A)";KIŠKUČIŲ;7560574633;Taip;13;0;0;13
3005;"Gilužis (Vydūno g. 11A)";KIŠKUČIŲ;4199633620;Taip;0;2;2;4
3006;"Gilužis (Vydūno g. 11A)";KIŠKUČIŲ;9851612698;Taip;5;8;0;13
3007;"Gilužis (Vydūno g. 11A)";KIŠKUČIŲ;1391410955;Taip;0;18;0;18
3008;"Gilužis (Vydūno g. 11A)";KIŠKUČIŲ;6383469680;Taip;5;9;0;14
3009;"Gilužis (Vydūno g. 11A)";KIŠKUČIŲ;8341597766;Taip;9;0;0;9
3010;"Gilužis (Vydūno g. 11A)";KIŠKUČIŲ;3171560628;Taip;0;7;0;7
3011;"Gilužis (Vydūno g. 11A)";KIŠKUČIŲ;4347319425;Taip;6;0;0;6
3012;"Gilužis (Vydūno g. 11A)";KIŠKUČIŲ;8591741716;Taip;11;3;0;14
3013;"Gilužis (Vydūno g. 11A)";KIŠKUČIŲ;8877445672;Taip;10;0;3;13
3014;"Gilužis (Vydūno g. 11A)";KIŠKUČIŲ;9489594782;Taip;0;5;0;5
3015;"Gilužis (Vydūno g. 11A)";KIŠKUČIŲ;6185954940;Taip;5;0;2;7
3016;"Gilužis (Vydūno g. 11A)";Meškučių;7263432152;Taip;5;3;0;8
3017;"Gilužis (Vydūno g. 11A)";Meškučių;4655266106;Taip;7;1;0;8
3018;"Gilužis (Vydūno g. 11A)";Meškučių;3800593189;Taip;5;9;0;14
3019;"Gilužis (Vydūno g. 11A)";Meškučių;4174307847;Taip;9;1;0;10
3020;"Gilužis (Vydūno g. 11A)";Meškučių;8393554697;Taip;10;16;0;26
3021;"Gilužis (Vydūno g. 11A)";Meškučių;8301535013;Taip;5;1;0;6
3022;"Gilužis (Vydūno g. 11A)";Meškučių;2939982311;Taip;10;5;0;15
3023;"Gilužis (Vydūno g. 11A)";Meškučių;3365778697;Taip;0;12;0;12
3024;"Gilužis (Vydūno g. 11A)";Meškučių;7912093880;Taip;0;8;0;8
3025;"Gilužis (Vydūno g. 11A)";Meškučių;2389277783;Taip;0;5;0;5
3026;"Gilužis (Vydūno g. 11A)";Meškučių;2500949029;Taip;0;7;0;7
3027;"Gilužis (Vydūno g. 11A)";Meškučių;4741129495;Taip;2;9;0;11
3028;"Gilužis (Vydūno g. 11A)";Meškučių;7992750316;Taip;0;8;0;8
3029;"Gilužis (Vydūno g. 11A)";Meškučių;5505153657;Taip;0;3;1;4
3030;"Gilužis (Vydūno g. 11A)";Meškučių;2577554894;Taip;9;3;0;12
3031;"Gilužis (Vydūno g. 11A)";Meškučių;6303770262;Taip;14;0;0;14
3032;"Gilužis (Vydūno g. 11A)";Meškučių;3148477315;Taip;0;3;3;6
3033;"Gilužis (Vydūno g. 11A)";Meškučių;1068375927;Taip;11;3;0;14
3034;"Gilužis (Vydūno g. 11A)";Meškučių;8476240141;Taip;6;2;0;8
3035;"Gilužis (Vydūno g. 11A)";Meškučių;8780573054;Taip;3;3;0;6
3036;"Gilužis (Vydūno g. 11A)";Meškučių;6185280967;Taip;5;3;0;8
3037;"Gilužis (Vydūno g. 11A)";Meškučių;5177805719;Taip;5;4;0;9
3038;"Gilužis (Vydūno g. 11A)";Meškučių;7045940267;Taip;0;4;0;4
3039;"Gilužis (Vydūno g. 11A)";Pagrandukai;6884146146;Taip;0;18;0;18
3040;"Gilužis (Vydūno g. 11A)";Pagrandukai;6920910054;Taip;18;0;0;18
3041;"Gilužis (Vydūno g. 11A)";Pagrandukai;5705945483;Taip;6;0;0;6
3042;"Gilužis (Vydūno g. 11A)";Pagrandukai;6501973647;Taip;5;2;0;7
3043;"Gilužis (Vydūno g. 11A)";Pagrandukai;5397975739;Taip;5;2;0;7
3044;"Gilužis (Vydūno g. 11A)";Pagrandukai;6109205159;Taip;0;1;0;1
3045;"Gilužis (Vydūno g. 11A)";Pagrandukai;2328338059;Taip;0;1;0;1
3046;"Gilužis (Vydūno g. 11A)";Pagrandukai;5376639182;Taip;0;10;0;10
3047;"Gilužis (Vydūno g. 11A)";Pagrandukai;5378701300;Taip;0;2;0;2
3048;"Gilužis (Vydūno g. 11A)";Pagrandukai;3366788027;Taip;0;2;0;2
3049;"Gilužis (Vydūno g. 11A)";Pagrandukai;9676661005;Ne;13;2;0;15
3050;"Gilužis (Vydūno g. 11A)";Pagrandukai;1306757860;Ne;13;2;0;15
3051;"Gilužis (Vydūno g. 11A)";Pagrandukai;2706629834;Taip;2;6;0;8
3052;"Gilužis (Vydūno g. 11A)";Pagrandukai;1604096952;Taip;2;3;0;5
3053;"Gilužis (Vydūno g. 11A)";Pagrandukai;5184511012;Taip;11;1;0;12
3054;"Gilužis (Vydūno g. 11A)";Pagrandukai;9587502317;Taip;11;1;0;12
3055;"Gilužis (Vydūno g. 11A)";Pagrandukai;4266998302;Taip;3;4;0;7
3056;"Gilužis (Vydūno g. 11A)";Pagrandukai;5334441484;Taip;14;1;0;15
3057;"Gilužis (Vydūno g. 11A)";Pagrandukai;6831107153;Taip;9;1;0;10
3058;"Gilužis (Vydūno g. 11A)";Pagrandukai;8852862161;Taip;9;1;0;10
3059;"Gilužis (Vydūno g. 11A)";Pagrandukai;2955779117;Taip;9;1;0;10
3060;"Gilužis (Vydūno g. 11A)";Boružėlių;5497242500;Taip;0;4;0;4
3061;"Gilužis (Vydūno g. 11A)";Boružėlių;2516315604;Taip;2;0;4;6
3062;"Gilužis (Vydūno g. 11A)";Boružėlių;9783700319;Taip;1;4;0;5
3063;"Gilužis (Vydūno g. 11A)";Boružėlių;5394693502;Taip;13;0;0;13
3064;"Gilužis (Vydūno g. 11A)";Boružėlių;4455977087;Taip;18;0;0;18
3065;"Gilužis (Vydūno g. 11A)";Boružėlių;4876074981;Taip;0;13;0;13
3066;"Gilužis (Vydūno g. 11A)";Boružėlių;2633680406;Taip;7;4;0;11
3067;"Gilužis (Vydūno g. 11A)";Boružėlių;2221786284;Taip;0;5;0;5
3068;"Gilužis (Vydūno g. 11A)";Boružėlių;3002266577;Taip;18;0;0;18
3069;"Gilužis (Vydūno g. 11A)";Boružėlių;5190752112;Ne;16;2;0;18
3070;"Gilužis (Vydūno g. 11A)";Boružėlių;2440762487;Ne;16;2;0;18
3071;"Gilužis (Vydūno g. 11A)";Boružėlių;4509741536;Taip;5;5;0;10
3072;"Gilužis (Vydūno g. 11A)";Boružėlių;9707968228;Taip;4;0;0;4
3073;"Gilužis (Vydūno g. 11A)";Boružėlių;8628253655;Taip;8;7;0;15
3074;"Gilužis (Vydūno g. 11A)";Boružėlių;9104005195;Taip;0;2;0;2
3075;"Gilužis (Vydūno g. 11A)";Boružėlių;5581417252;Taip;0;18;0;18
3076;"Gilužis (Vydūno g. 11A)";Boružėlių;4106792355;Taip;0;4;0;4
3077;"Gilužis (Vydūno g. 11A)";Boružėlių;4475698906;Taip;5;3;0;8
3078;"Gilužis (Vydūno g. 11A)";Boružėlių;1085130813;Taip;0;4;0;4
3079;"Gintarėlis (Didlaukio g. 35)";PAPŪGĖLĖS;8498936096;Taip;0;5;1;6
3080;"Gintarėlis (Didlaukio g. 35)";PAPŪGĖLĖS;8913652291;Taip;7;0;5;12
3081;"Gintarėlis (Didlaukio g. 35)";PAPŪGĖLĖS;2485750596;Taip;6;3;0;9
3082;"Gintarėlis (Didlaukio g. 35)";PAPŪGĖLĖS;1033624080;Taip;1;2;4;7
3083;"Gintarėlis (Didlaukio g. 35)";PAPŪGĖLĖS;2919700367;Ne;10;4;0;14
3084;"Gintarėlis (Didlaukio g. 35)";PAPŪGĖLĖS;1768789948;Taip;7;0;2;9
3085;"Gintarėlis (Didlaukio g. 35)";PAPŪGĖLĖS;2595566032;Taip;8;3;0;11
3086;"Gintarėlis (Didlaukio g. 35)";PAPŪGĖLĖS;9141438560;Taip;6;4;0;10
3087;"Gintarėlis (Didlaukio g. 35)";PAPŪGĖLĖS;2235045173;Taip;0;0;5;5
3088;"Gintarėlis (Didlaukio g. 35)";PAPŪGĖLĖS;9494521554;Taip;5;8;0;13
3089;"Gintarėlis (Didlaukio g. 35)";PAPŪGĖLĖS;7494884360;Taip;0;3;0;3
3090;"Gintarėlis (Didlaukio g. 35)";PAPŪGĖLĖS;7147842224;Taip;0;3;0;3
3091;"Gintarėlis (Didlaukio g. 35)";PAPŪGĖLĖS;5783939567;Taip;0;5;1;6
3092;"Gintarėlis (Didlaukio g. 35)";PAPŪGĖLĖS;7674351459;Taip;5;5;0;10
3093;"Gintarėlis (Didlaukio g. 35)";PAPŪGĖLĖS;6292664833;Taip;5;0;4;9
3094;"Gintarėlis (Didlaukio g. 35)";PAPŪGĖLĖS;8610886062;Taip;0;4;0;4
3095;"Gintarėlis (Didlaukio g. 35)";PAPŪGĖLĖS;5811396263;Taip;5;3;0;8
3096;"Gintarėlis (Didlaukio g. 35)";PAPŪGĖLĖS;1648843117;Taip;4;1;0;5
3097;"Gintarėlis (Didlaukio g. 35)";PAPŪGĖLĖS;1861324153;Taip;0;13;0;13
3098;"Gintarėlis (Didlaukio g. 35)";PAPŪGĖLĖS;3457974670;Taip;4;2;3;9
3099;"Gintarėlis (Didlaukio g. 35)";PAPŪGĖLĖS;1511718436;Ne;0;2;2;4
3100;"Gintarėlis (Didlaukio g. 35)";PAPŪGĖLĖS;4484711857;Taip;0;3;7;10
3101;"Gintarėlis (Didlaukio g. 35)";PAPŪGĖLĖS;6080108998;Taip;13;1;0;14
3102;"Gintarėlis (Didlaukio g. 35)";PAPŪGĖLĖS;6655645997;Taip;13;1;0;14
3103;"Gintarėlis (Didlaukio g. 35)";SPINDULIUKAI;9303448709;Taip;0;3;0;3
3104;"Gintarėlis (Didlaukio g. 35)";SPINDULIUKAI;3600181974;Taip;0;3;0;3
3105;"Gintarėlis (Didlaukio g. 35)";SPINDULIUKAI;6091264509;Taip;0;7;0;7
3106;"Gintarėlis (Didlaukio g. 35)";SPINDULIUKAI;56124970238;Taip;0;4;0;4
3107;"Gintarėlis (Didlaukio g. 35)";SPINDULIUKAI;4902086873;Taip;15;1;0;16
3108;"Gintarėlis (Didlaukio g. 35)";SPINDULIUKAI;22394648690;Ne;0;3;0;3
3109;"Gintarėlis (Didlaukio g. 35)";SPINDULIUKAI;34606130829;Taip;0;8;0;8
3110;"Gintarėlis (Didlaukio g. 35)";SPINDULIUKAI;21658913551;Taip;0;4;0;4
3111;"Gintarėlis (Didlaukio g. 35)";SPINDULIUKAI;8405210216;Ne;0;5;0;5
3112;"Gintarėlis (Didlaukio g. 35)";SPINDULIUKAI;18715625324;Taip;0;7;0;7
3113;"Gintarėlis (Didlaukio g. 35)";SPINDULIUKAI;2721386855;Taip;0;4;0;4
3114;"Gintarėlis (Didlaukio g. 35)";SPINDULIUKAI;2914156353;Taip;0;3;2;5
3115;"Gintarėlis (Didlaukio g. 35)";SPINDULIUKAI;4612041848;Taip;0;1;2;3
3116;"Gintarėlis (Didlaukio g. 35)";SPINDULIUKAI;5916948150;Taip;0;3;0;3
3117;"Gintarėlis (Didlaukio g. 35)";SPINDULIUKAI;45480802894;Taip;0;5;2;7
3118;"Gintarėlis (Didlaukio g. 35)";SPINDULIUKAI;3978892232;Taip;0;1;0;1
3119;"Gintarėlis (Didlaukio g. 35)";SPINDULIUKAI;1770479969;Taip;5;4;0;9
3120;"Gintarėlis (Didlaukio g. 35)";SPINDULIUKAI;1441282039;Taip;0;4;0;4
3121;"Gintarėlis (Didlaukio g. 35)";SPINDULIUKAI;8206947475;Taip;0;3;0;3
3122;"Gintarėlis (Didlaukio g. 35)";SPINDULIUKAI;9539570835;Taip;0;7;0;7
3123;"Gintarėlis (Didlaukio g. 35)";SPINDULIUKAI;7878911379;Taip;0;6;0;6
3124;"Gintarėlis (Didlaukio g. 35)";LAŠIUKAI;6142819210;Taip;0;2;1;3
3125;"Gintarėlis (Didlaukio g. 35)";LAŠIUKAI;7971810025;Taip;3;1;0;4
3126;"Gintarėlis (Didlaukio g. 35)";LAŠIUKAI;28704617970;Taip;0;3;0;3
3127;"Gintarėlis (Didlaukio g. 35)";LAŠIUKAI;5577759167;Taip;9;4;0;13
3128;"Gintarėlis (Didlaukio g. 35)";LAŠIUKAI;4498326942;Taip;0;4;0;4
3129;"Gintarėlis (Didlaukio g. 35)";LAŠIUKAI;4641943773;Taip;6;4;0;10
3130;"Gintarėlis (Didlaukio g. 35)";LAŠIUKAI;6288086420;Taip;0;1;0;1
3131;"Gintarėlis (Didlaukio g. 35)";LAŠIUKAI;1655837441;Taip;0;5;0;5
3132;"Gintarėlis (Didlaukio g. 35)";LAŠIUKAI;1690400583;Taip;15;3;0;18
3133;"Gintarėlis (Didlaukio g. 35)";LAŠIUKAI;8186804032;Taip;0;2;0;2
3134;"Gintarėlis (Didlaukio g. 35)";LAŠIUKAI;1826743229;Taip;0;3;0;3
3135;"Gintarėlis (Didlaukio g. 35)";LAŠIUKAI;9560190761;Taip;0;3;0;3
3136;"Gintarėlis (Didlaukio g. 35)";LAŠIUKAI;5434952733;Taip;3;5;0;8
3137;"Gintarėlis (Didlaukio g. 35)";LAŠIUKAI;5018151097;Taip;3;3;0;6
3138;"Gintarėlis (Didlaukio g. 35)";LAŠIUKAI;9230924100;Taip;0;2;5;7
3139;"Gintarėlis (Didlaukio g. 35)";LAŠIUKAI;4333780287;Taip;0;11;0;11
3140;"Gintarėlis (Didlaukio g. 35)";LAŠIUKAI;7286562743;Taip;0;5;1;6
3141;"Gintarėlis (Didlaukio g. 35)";LAŠIUKAI;1675553097;Taip;2;3;1;6
3142;"Gintarėlis (Didlaukio g. 35)";LAŠIUKAI;8000297636;Taip;10;5;0;15
3143;"Gintarėlis (Didlaukio g. 35)";LAŠIUKAI;3359584322;Taip;4;3;0;7
3144;"Gintarėlis (Didlaukio g. 35)";LAŠIUKAI;6377674849;Taip;4;0;1;5
3145;"Gintarėlis (Didlaukio g. 35)";LAŠIUKAI;3820683506;Taip;0;2;0;2
3146;"Gintarėlis (Didlaukio g. 35)";MEŠKUČIAI;2926488239;Taip;0;3;0;3
3147;"Gintarėlis (Didlaukio g. 35)";MEŠKUČIAI;6618240550;Taip;0;3;0;3
3148;"Gintarėlis (Didlaukio g. 35)";MEŠKUČIAI;8790078624;Taip;5;2;1;8
3149;"Gintarėlis (Didlaukio g. 35)";MEŠKUČIAI;2518840573;Taip;10;2;0;12
3150;"Gintarėlis (Didlaukio g. 35)";MEŠKUČIAI;5187894822;Taip;0;3;0;3
3151;"Gintarėlis (Didlaukio g. 35)";MEŠKUČIAI;3630567294;Taip;0;5;0;5
3152;"Gintarėlis (Didlaukio g. 35)";MEŠKUČIAI;5181872438;Taip;0;5;0;5
3153;"Gintarėlis (Didlaukio g. 35)";MEŠKUČIAI;1565802953;Taip;0;18;0;18
3154;"Gintarėlis (Didlaukio g. 35)";MEŠKUČIAI;2072435242;Taip;18;0;0;18
3155;"Gintarėlis (Didlaukio g. 35)";MEŠKUČIAI;7989239799;Taip;0;3;0;3
3156;"Gintarėlis (Didlaukio g. 35)";MEŠKUČIAI;4356211536;Taip;13;0;0;13
3157;"Gintarėlis (Didlaukio g. 35)";MEŠKUČIAI;1502740714;Taip;10;3;0;13
3158;"Gintarėlis (Didlaukio g. 35)";MEŠKUČIAI;6636835034;Taip;0;8;0;8
3159;"Gintarėlis (Didlaukio g. 35)";MEŠKUČIAI;3830154353;Taip;0;1;1;2
3160;"Gintarėlis (Didlaukio g. 35)";MEŠKUČIAI;3947405446;Taip;5;1;2;8
3161;"Gintarėlis (Didlaukio g. 35)";MEŠKUČIAI;7948438165;Taip;0;3;0;3
3162;"Gintarėlis (Didlaukio g. 35)";MEŠKUČIAI;4642142931;Taip;15;0;0;15
3163;"Gintarėlis (Didlaukio g. 35)";MEŠKUČIAI;6711753930;Taip;0;3;0;3
3164;"Gintarėlis (Didlaukio g. 35)";MEŠKUČIAI;8375475174;Taip;0;7;0;7
3165;"Gintarėlis (Didlaukio g. 35)";MEŠKUČIAI;7029401386;Taip;10;1;0;11
3166;"Gintarėlis (Didlaukio g. 35)";MEŠKUČIAI;1790629500;Taip;10;0;1;11
3167;"Gintarėlis (Didlaukio g. 35)";MEŠKUČIAI;7320085613;Taip;9;3;0;12
3168;"Gintarėlis (Didlaukio g. 35)";DRUGELIAI;1462949250;Taip;0;1;0;1
3169;"Gintarėlis (Didlaukio g. 35)";DRUGELIAI;9737200226;Taip;0;1;0;1
3170;"Gintarėlis (Didlaukio g. 35)";DRUGELIAI;6655809299;Taip;8;2;0;10
3171;"Gintarėlis (Didlaukio g. 35)";DRUGELIAI;2614258442;Taip;0;6;0;6
3172;"Gintarėlis (Didlaukio g. 35)";DRUGELIAI;1452402931;Taip;0;3;0;3
3173;"Gintarėlis (Didlaukio g. 35)";DRUGELIAI;4217329880;Taip;0;3;0;3
3174;"Gintarėlis (Didlaukio g. 35)";DRUGELIAI;7571352126;Taip;0;3;2;5
3175;"Gintarėlis (Didlaukio g. 35)";DRUGELIAI;9687974376;Taip;0;8;0;8
3176;"Gintarėlis (Didlaukio g. 35)";DRUGELIAI;8419453060;Taip;0;3;1;4
3177;"Gintarėlis (Didlaukio g. 35)";DRUGELIAI;7449437199;Taip;5;4;0;9
3178;"Gintarėlis (Didlaukio g. 35)";DRUGELIAI;2016067859;Taip;0;3;0;3
3179;"Gintarėlis (Didlaukio g. 35)";DRUGELIAI;9579497944;Taip;0;1;0;1
3180;"Gintarėlis (Didlaukio g. 35)";DRUGELIAI;3341850450;Taip;0;3;1;4
3181;"Gintarėlis (Didlaukio g. 35)";DRUGELIAI;1759218238;Taip;0;4;0;4
3182;"Gintarėlis (Didlaukio g. 35)";DRUGELIAI;1248017244;Taip;3;4;0;7
3183;"Gintarėlis (Didlaukio g. 35)";DRUGELIAI;2792618575;Taip;0;7;0;7
3184;"Gintarėlis (Didlaukio g. 35)";DRUGELIAI;8171192401;Taip;8;4;0;12
3185;"Gintarėlis (Didlaukio g. 35)";DRUGELIAI;7694587246;Taip;0;1;0;1
3186;"Gintarėlis (Didlaukio g. 35)";DRUGELIAI;4904966263;Taip;0;5;0;5
3187;"Gintarėlis (Didlaukio g. 35)";KAČIUKAI;5569843168;Taip;0;4;0;4
3188;"Gintarėlis (Didlaukio g. 35)";KAČIUKAI;3665764153;Taip;0;4;5;9
3189;"Gintarėlis (Didlaukio g. 35)";KAČIUKAI;9774056578;Taip;0;4;5;9
3190;"Gintarėlis (Didlaukio g. 35)";KAČIUKAI;2212296954;Taip;0;0;1;1
3191;"Gintarėlis (Didlaukio g. 35)";KAČIUKAI;3825700024;Taip;0;2;2;4
3192;"Gintarėlis (Didlaukio g. 35)";KAČIUKAI;7057877483;Taip;0;2;2;4
3193;"Gintarėlis (Didlaukio g. 35)";KAČIUKAI;9825811100;Taip;5;0;3;8
3194;"Gintarėlis (Didlaukio g. 35)";KAČIUKAI;7875981690;Taip;0;9;0;9
3195;"Gintarėlis (Didlaukio g. 35)";KAČIUKAI;2544338275;Taip;0;9;0;9
3196;"Gintarėlis (Didlaukio g. 35)";KAČIUKAI;7182964126;Taip;11;2;0;13
3197;"Gintarėlis (Didlaukio g. 35)";KAČIUKAI;4754929282;Taip;0;3;0;3
3198;"Gintarėlis (Didlaukio g. 35)";KAČIUKAI;5214984111;Taip;0;1;0;1
3199;"Gintarėlis (Didlaukio g. 35)";KAČIUKAI;1011749698;Taip;4;5;8;17
3200;"Gintarėlis (Didlaukio g. 35)";KAČIUKAI;8261770154;Taip;4;9;0;13
3201;"Gintarėlis (Didlaukio g. 35)";KAČIUKAI;7061545258;Taip;0;3;0;3
3202;"Gintarėlis (Didlaukio g. 35)";KAČIUKAI;5436695400;Ne;0;4;0;4
3203;"Gintarėlis (Didlaukio g. 35)";KAČIUKAI;5921751507;Taip;0;3;0;3
3204;"Gintarėlis (Didlaukio g. 35)";KAČIUKAI;9450900915;Taip;3;0;1;4
3205;"Gintarėlis (Didlaukio g. 35)";KAČIUKAI;5153948767;Taip;0;5;0;5
3206;"Gintarėlis (Didlaukio g. 35)";KAČIUKAI;3814485627;Taip;0;5;0;5
3207;"Gintarėlis (Didlaukio g. 35)";KAČIUKAI;1571260478;Ne;4;5;0;9
3208;"Gintarėlis (Didlaukio g. 35)";KAČIUKAI;9244715396;Taip;5;3;0;8
3209;"Gintarėlis (Didlaukio g. 35)";KAČIUKAI;3015327416;Taip;5;4;0;9
3210;"Gintarėlis (Didlaukio g. 35)";KIŠKUČIAI;9279399214;Taip;18;0;0;18
3211;"Gintarėlis (Didlaukio g. 35)";KIŠKUČIAI;3921015919;Taip;18;0;0;18
3212;"Gintarėlis (Didlaukio g. 35)";KIŠKUČIAI;2814569415;Taip;8;6;2;16
3213;"Gintarėlis (Didlaukio g. 35)";KIŠKUČIAI;7143014339;Taip;11;1;0;12
3214;"Gintarėlis (Didlaukio g. 35)";KIŠKUČIAI;5796729245;Taip;8;7;0;15
3215;"Gintarėlis (Didlaukio g. 35)";KIŠKUČIAI;9915887420;Taip;8;7;0;15
3216;"Gintarėlis (Didlaukio g. 35)";KIŠKUČIAI;8287685690;Taip;0;10;0;10
3217;"Gintarėlis (Didlaukio g. 35)";KIŠKUČIAI;7815317644;Taip;0;5;0;5
3218;"Gintarėlis (Didlaukio g. 35)";KIŠKUČIAI;2165332442;Taip;0;1;0;1
3219;"Gintarėlis (Didlaukio g. 35)";KIŠKUČIAI;6914904213;Taip;14;0;0;14
3220;"Gintarėlis (Didlaukio g. 35)";KIŠKUČIAI;1696337909;Taip;14;0;0;14
3221;"Gintarėlis (Didlaukio g. 35)";KIŠKUČIAI;6862629244;Taip;0;7;0;7
3222;"Gintarėlis (Didlaukio g. 35)";KIŠKUČIAI;3398936974;Taip;12;1;0;13
3223;"Gintarėlis (Didlaukio g. 35)";KIŠKUČIAI;1918879534;Taip;15;0;0;15
3224;"Gintarėlis (Didlaukio g. 35)";KIŠKUČIAI;7509100750;Taip;8;3;0;11
3225;"Gintarėlis (Didlaukio g. 35)";KIŠKUČIAI;6991746305;Taip;9;1;0;10
3226;"Gintarėlis (Didlaukio g. 35)";KIŠKUČIAI;3792697409;Taip;17;0;0;17
3227;"Gintarėlis (Didlaukio g. 35)";KIŠKUČIAI;6239242631;Taip;13;1;0;14
3228;"Gintarėlis (Didlaukio g. 35)";KIŠKUČIAI;4623909811;Taip;9;2;1;12
3229;"Gintarėlis (Didlaukio g. 35)";KIŠKUČIAI;3357866319;Taip;0;7;1;8
3230;"Gintarėlis (Didlaukio g. 35)";KIŠKUČIAI;8116557698;Taip;0;6;0;6
3231;"Gintarėlis (Didlaukio g. 35)";KIŠKUČIAI;8704248985;Taip;0;4;0;4
3232;"Gintarėlis (Didlaukio g. 35)";KIŠKUČIAI;5355691986;Taip;0;5;0;5
3233;"Gintarėlis (Didlaukio g. 35)";KIŠKUČIAI;5919205817;Taip;0;3;0;3
3234;"Gintarėlis (Didlaukio g. 35)";VYTURIUKAI;8768094601;Taip;8;4;0;12
3235;"Gintarėlis (Didlaukio g. 35)";VYTURIUKAI;5834772263;Taip;0;7;0;7
3236;"Gintarėlis (Didlaukio g. 35)";VYTURIUKAI;9533972547;Taip;4;0;6;10
3237;"Gintarėlis (Didlaukio g. 35)";VYTURIUKAI;4915783145;Taip;0;0;8;8
3238;"Gintarėlis (Didlaukio g. 35)";BORUŽĖLĖS;6402043654;Taip;0;2;4;6
3239;"Gintarėlis (Didlaukio g. 35)";BORUŽĖLĖS;6558614008;Taip;14;0;0;14
3240;"Gintarėlis (Didlaukio g. 35)";BORUŽĖLĖS;4348245746;Taip;5;3;0;8
3241;"Gintarėlis (Didlaukio g. 35)";BORUŽĖLĖS;3091731769;Taip;0;7;0;7
3242;"Gintarėlis (Didlaukio g. 35)";BORUŽĖLĖS;6484966941;Taip;0;7;2;9
3243;"Gintarėlis (Didlaukio g. 35)";BORUŽĖLĖS;9004590065;Taip;9;2;0;11
3244;"Gintarėlis (Didlaukio g. 35)";BORUŽĖLĖS;2624469768;Taip;0;2;3;5
3245;"Gintarėlis (Didlaukio g. 35)";BORUŽĖLĖS;8784796186;Taip;6;4;0;10
3246;"Gintarėlis (Didlaukio g. 35)";BORUŽĖLĖS;3538300416;Taip;5;1;0;6
3247;"Gintarėlis (Didlaukio g. 35)";BORUŽĖLĖS;8516817506;Taip;0;6;0;6
3248;"Gintarėlis (Didlaukio g. 35)";BORUŽĖLĖS;3235154374;Taip;0;18;0;18
3249;"Gintarėlis (Didlaukio g. 35)";BORUŽĖLĖS;4809352525;Taip;0;4;0;4
3250;"Gintarėlis (Didlaukio g. 35)";BORUŽĖLĖS;7059730814;Taip;5;1;0;6
3251;"Gintarėlis (Didlaukio g. 35)";BORUŽĖLĖS;5965570522;Taip;0;2;0;2
3252;"Gintarėlis (Didlaukio g. 35)";BORUŽĖLĖS;9179216093;Taip;0;2;0;2
3253;"Gintarėlis (Didlaukio g. 35)";BORUŽĖLĖS;9970786396;Taip;3;5;0;8
3254;"Gintarėlis (Didlaukio g. 35)";BORUŽĖLĖS;7118758040;Taip;0;3;0;3
3255;"Gintarėlis (Didlaukio g. 35)";BORUŽĖLĖS;9622824643;Taip;7;0;5;12
3256;"Gintarėlis (Didlaukio g. 35)";BORUŽĖLĖS;9476258741;Taip;10;0;0;10
3257;"Gintarėlis (Didlaukio g. 35)";BORUŽĖLĖS;1400817076;Taip;10;0;2;12
3258;"Gintarėlis (Didlaukio g. 35)";BORUŽĖLĖS;1371258551;Taip;12;2;1;15
3259;"Gintarėlis (Didlaukio g. 35)";BORUŽĖLĖS;4334349824;Taip;0;4;0;4
3260;"Gintarėlis (Didlaukio g. 35)";BORUŽĖLĖS;8410642485;Taip;7;0;0;7
3261;"Gintarėlis (Didlaukio g. 35)";BORUŽĖLĖS;9501012756;Taip;14;0;0;14
3262;"Gintarėlis (Didlaukio g. 35)";EŽIUKAI;4676321193;Taip;0;4;0;4
3263;"Gintarėlis (Didlaukio g. 35)";EŽIUKAI;4487346983;Taip;0;8;0;8
3264;"Gintarėlis (Didlaukio g. 35)";EŽIUKAI;2263102527;Taip;5;4;2;11
3265;"Gintarėlis (Didlaukio g. 35)";EŽIUKAI;7919771693;Taip;0;5;1;6
3266;"Gintarėlis (Didlaukio g. 35)";EŽIUKAI;9040480798;Taip;0;3;0;3
3267;"Gintarėlis (Didlaukio g. 35)";EŽIUKAI;8055928882;Taip;0;9;0;9
3268;"Gintarėlis (Didlaukio g. 35)";EŽIUKAI;5024727902;Taip;0;5;1;6
3269;"Gintarėlis (Didlaukio g. 35)";EŽIUKAI;2088008759;Taip;0;4;0;4
3270;"Gintarėlis (Didlaukio g. 35)";EŽIUKAI;3799412062;Taip;0;5;1;6
3271;"Gintarėlis (Didlaukio g. 35)";EŽIUKAI;6457288028;Taip;0;3;0;3
3272;"Gintarėlis (Didlaukio g. 35)";EŽIUKAI;4660854883;Taip;0;2;0;2
3273;"Gintarėlis (Didlaukio g. 35)";EŽIUKAI;94354056029;Taip;0;6;0;6
3274;"Gintarėlis (Didlaukio g. 35)";EŽIUKAI;1002155392;Taip;0;3;0;3
3275;"Gintarėlis (Didlaukio g. 35)";EŽIUKAI;9130659549;Taip;0;3;0;3
3276;"Gintarėlis (Didlaukio g. 35)";EŽIUKAI;2036488789;Taip;0;3;0;3
3277;"Gintarėlis (Didlaukio g. 35)";EŽIUKAI;7644607132;Taip;0;3;0;3
3278;"Gintarėlis (Didlaukio g. 35)";EŽIUKAI;78359050717;Taip;0;2;0;2
3279;"Gintarėlis (Didlaukio g. 35)";EŽIUKAI;7192722296;Taip;0;2;0;2
3280;"Gintarėlis (Didlaukio g. 35)";EŽIUKAI;2970527490;Ne;0;4;0;4
3281;"Gintarėlis (Didlaukio g. 35)";EŽIUKAI;1028456578;Taip;0;1;0;1
3282;"Gintarėlis (Didlaukio g. 35)";EŽIUKAI;1066741732;Taip;0;3;3;6
3283;"Gintarėlis (Didlaukio g. 35)";EŽIUKAI;1778573935;Taip;5;3;0;8
3284;"Gintarėlis (Didlaukio g. 35)";EŽIUKAI;9917367735;Taip;0;3;0;3
3285;"Gintarėlis (Didlaukio g. 35)";EŽIUKAI;4514340634;Taip;0;3;0;3
3286;"Gintarėlis (Didlaukio g. 35)";VIŠČIUKAI;1981825456;Taip;9;1;0;10
3287;"Gintarėlis (Didlaukio g. 35)";VIŠČIUKAI;3973889495;Taip;1;2;3;6
3288;"Gintarėlis (Didlaukio g. 35)";VIŠČIUKAI;4749559606;Taip;11;1;0;12
3289;"Gintarėlis (Didlaukio g. 35)";VIŠČIUKAI;4458703839;Ne;10;4;0;14
3290;"Gintarėlis (Didlaukio g. 35)";VIŠČIUKAI;2178808286;Taip;3;12;0;15
3291;"Gintarėlis (Didlaukio g. 35)";VIŠČIUKAI;9073499040;Taip;10;5;0;15
3292;"Gintarėlis (Didlaukio g. 35)";VIŠČIUKAI;6547060300;Taip;10;1;0;11
3293;"Gintarėlis (Didlaukio g. 35)";VIŠČIUKAI;5930354746;Taip;0;4;0;4
3294;"Gintarėlis (Didlaukio g. 35)";VIŠČIUKAI;4535071342;Taip;18;2;0;20
3295;"Gintarėlis (Didlaukio g. 35)";VIŠČIUKAI;8448725884;Taip;11;2;0;13
3296;"Gintarėlis (Didlaukio g. 35)";VIŠČIUKAI;6251670953;Taip;0;5;0;5
3297;"Gintarėlis (Didlaukio g. 35)";VIŠČIUKAI;8805356168;Taip;0;9;0;9
3298;"Gintarėlis (Didlaukio g. 35)";VIŠČIUKAI;4751066825;Taip;6;4;0;10
3299;"Gintarėlis (Didlaukio g. 35)";VIŠČIUKAI;1039098192;Taip;15;3;0;18
3300;"Gintarėlis (Didlaukio g. 35)";VIŠČIUKAI;6042885133;Taip;13;2;3;18
3301;"Gintarėlis (Didlaukio g. 35)";VIŠČIUKAI;7418672923;Taip;9;2;1;12
3302;"Gintarėlis (Didlaukio g. 35)";VIŠČIUKAI;7562170082;Taip;6;10;0;16
3303;"Gintarėlis (Didlaukio g. 35)";VIŠČIUKAI;1367305617;Taip;8;1;0;9
3304;"Gintarėlis (Didlaukio g. 35)";VIŠČIUKAI;6711773127;Taip;0;5;0;5
3305;"Gintarėlis (Didlaukio g. 35)";VIŠČIUKAI;7537009709;Taip;0;2;8;10
3306;"Gintarėlis (Didlaukio g. 35)";VIŠČIUKAI;9191264261;Taip;5;3;0;8
3307;"Gintarėlis (Didlaukio g. 35)";VIŠČIUKAI;2920734274;Taip;9;0;1;10
3308;"Gintarėlis (Didlaukio g. 35)";VIŠČIUKAI;3232990779;Taip;4;4;0;8
3309;"Gintarėlis (Didlaukio g. 35)";"SAULĖS ZUIKUČIAI";9915228593;Taip;0;3;0;3
3310;"Gintarėlis (Didlaukio g. 35)";"SAULĖS ZUIKUČIAI";2499727321;Taip;10;5;0;15
3311;"Gintarėlis (Didlaukio g. 35)";"SAULĖS ZUIKUČIAI";2949035147;Taip;5;3;0;8
3312;"Gintarėlis (Didlaukio g. 35)";"SAULĖS ZUIKUČIAI";3839660368;Taip;13;3;0;16
3313;"Gintarėlis (Didlaukio g. 35)";"SAULĖS ZUIKUČIAI";5991638696;Taip;8;2;0;10
3314;"Gintarėlis (Didlaukio g. 35)";"SAULĖS ZUIKUČIAI";6563281778;Taip;0;7;4;11
3315;"Gintarėlis (Didlaukio g. 35)";"SAULĖS ZUIKUČIAI";6133476137;Taip;16;1;0;17
3316;"Gintarėlis (Didlaukio g. 35)";"SAULĖS ZUIKUČIAI";6751822184;Taip;0;4;0;4
3317;"Gintarėlis (Didlaukio g. 35)";"SAULĖS ZUIKUČIAI";8721340357;Taip;0;0;3;3
3318;"Gintarėlis (Didlaukio g. 35)";"SAULĖS ZUIKUČIAI";3876016666;Taip;0;0;1;1
3319;"Gintarėlis (Didlaukio g. 35)";"SAULĖS ZUIKUČIAI";8403881160;Taip;18;0;0;18
3320;"Gintarėlis (Didlaukio g. 35)";"SAULĖS ZUIKUČIAI";5336654560;Taip;3;4;1;8
3321;"Gintarėlis (Didlaukio g. 35)";"SAULĖS ZUIKUČIAI";3732252177;Taip;3;4;1;8
3322;"Gintarėlis (Didlaukio g. 35)";"SAULĖS ZUIKUČIAI";4087751760;Taip;8;0;4;12
3323;"Gintarėlis (Didlaukio g. 35)";"SAULĖS ZUIKUČIAI";4462515146;Taip;0;6;0;6
3324;"Gintarėlis (Didlaukio g. 35)";"SAULĖS ZUIKUČIAI";6138593853;Taip;0;3;0;3
3325;"Gintarėlis (Didlaukio g. 35)";"SAULĖS ZUIKUČIAI";5338409090;Taip;0;1;0;1
3326;"Gintarėlis (Didlaukio g. 35)";"SAULĖS ZUIKUČIAI";7004430575;Taip;4;2;0;6
3327;"Gintarėlis (Didlaukio g. 35)";"SAULĖS ZUIKUČIAI";5509394003;Taip;1;0;4;5
3328;"Gintarėlis (Didlaukio g. 35)";"SAULĖS ZUIKUČIAI";1482227839;Taip;15;3;0;18
3329;"Gintarėlis (Didlaukio g. 35)";Pabiručiai;8286814809;Taip;6;2;0;8
3330;"Gintarėlis (Didlaukio g. 35)";Pabiručiai;4757160835;Taip;0;0;3;3
3331;"Gintarėlis (Didlaukio g. 35)";Pabiručiai;1158055621;Taip;0;3;0;3
3332;"Gintarėlis (Didlaukio g. 35)";Pabiručiai;1474802737;Taip;4;4;0;8
3333;"Gintarėlis (Didlaukio g. 35)";Pabiručiai;6578588403;Taip;2;6;0;8
3334;"Gintarėlis (Didlaukio g. 35)";Šypsenėlės;3575375401;Taip;0;2;7;9
3335;"Gintarėlis (Didlaukio g. 35)";Šypsenėlės;3575375401;Taip;0;2;7;9
3336;"Gintarėlis (Didlaukio g. 35)";Šypsenėlės;3575375401;Taip;0;2;7;9
3337;"Gintarėlis (Didlaukio g. 35)";Šypsenėlės;9020619501;Taip;0;2;8;10
3338;"Gintarėlis (Didlaukio g. 35)";Šypsenėlės;2904118045;Taip;8;0;0;8
3339;"Gintarėlis (Didlaukio g. 35)";Šypsenėlės;5120761293;Taip;0;3;0;3
3340;"Gintarėlis (Didlaukio g. 35)";Šypsenėlės;9413836091;Taip;0;5;5;10
3341;"Gintarėlis (Didlaukio g. 35)";Šypsenėlės;1567290856;Taip;3;0;1;4
3342;"Gintarėlis (Didlaukio g. 35)";Šypsenėlės;7661638176;Taip;0;7;0;7
3343;"Gintarėlis (Didlaukio g. 35)";Šypsenėlės;9477018713;Taip;3;1;0;4
3344;"Gintarėlis (Didlaukio g. 35)";Šypsenėlės;9477018713;Taip;3;1;0;4
3345;"Gintarėlis (Didlaukio g. 35)";Šypsenėlės;9477018713;Taip;3;1;0;4
3346;"Gintarėlis (Didlaukio g. 35)";Šypsenėlės;3088663209;Taip;0;3;0;3
3347;"Gintarėlis (Didlaukio g. 35)";Šypsenėlės;3794027499;Taip;0;5;0;5
3348;"Gintarėlis (Didlaukio g. 35)";Šypsenėlės;7813187438;Taip;0;5;0;5
3349;"Gintarėlis (Didlaukio g. 35)";Šypsenėlės;9234476307;Taip;0;2;6;8
3350;"Gintarėlis (Didlaukio g. 35)";Šypsenėlės;6561070982;Taip;0;4;0;4
3351;"Gintarėlis (Didlaukio g. 35)";Šypsenėlės;2203238888;Taip;0;4;0;4
3352;"Gintarėlis (Didlaukio g. 35)";Šypsenėlės;3484172382;Taip;0;3;0;3
3353;"Gintarėlis (Didlaukio g. 35)";Šypsenėlės;2256002308;Taip;0;2;0;2
3354;"Gintarėlis (Didlaukio g. 35)";Šypsenėlės;6607854244;Taip;0;2;3;5
3355;"Gintarėlis (Didlaukio g. 35)";Šypsenėlės;1327681704;Taip;0;3;0;3
3356;"Gintarėlis (Didlaukio g. 35)";Šypsenėlės;3987801707;Taip;2;2;2;6
3357;"Gintarėlis (Didlaukio g. 35)";Šypsenėlės;7123016029;Taip;0;2;1;3
3358;"Gintarėlis (Didlaukio g. 35)";Šypsenėlės;3000371147;Taip;0;3;0;3
3359;"Gintarėlis (Didlaukio g. 35)";Šypsenėlės;5717123412;Taip;0;9;0;9
3360;"Gintarėlis (Didlaukio g. 35)";Šypsenėlės;1480486900;Taip;8;0;0;8
3361;"Gintarėlis (Didlaukio g. 35)";Smalsučiai;7486822380;Taip;5;2;0;7
3362;"Gintarėlis (Didlaukio g. 35)";Smalsučiai;8387819754;Taip;0;4;0;4
3363;"Gintarėlis (Didlaukio g. 35)";Smalsučiai;8292698645;Taip;5;4;2;11
3364;"Gintarėlis (Didlaukio g. 35)";Smalsučiai;1876292168;Taip;5;4;0;9
3365;"Gintarėlis (Didlaukio g. 35)";Smalsučiai;9980747501;Taip;5;0;4;9
3366;"Gintarėlis (Didlaukio g. 35)";Smalsučiai;8754068506;Taip;0;1;0;1
3367;"Gintarėlis (Didlaukio g. 35)";Smalsučiai;7690748176;Taip;2;0;1;3
3368;"Gintarėlis (Didlaukio g. 35)";Smalsučiai;8355089218;Taip;5;2;1;8
3369;"Gintarėlis (Didlaukio g. 35)";Kodėlčiukai;7976989629;Taip;12;0;0;12
3370;"Gintarėlis (Didlaukio g. 35)";Kodėlčiukai;8982034601;Taip;0;0;4;4
3371;"Gintarėlis (Didlaukio g. 35)";Kodėlčiukai;2234295991;Taip;0;3;0;3
3372;"Gintarėlis (Didlaukio g. 35)";Kodėlčiukai;6545866812;Taip;5;1;2;8
3373;"Gintarėlis (Didlaukio g. 35)";Kodėlčiukai;5467958458;Taip;0;3;0;3
3374;"Gintarėlis (Didlaukio g. 35)";Kodėlčiukai;5824210469;Taip;3;0;0;3
3375;"Gintarėlis (Didlaukio g. 35)";Kodėlčiukai;5202442681;Taip;4;1;0;5
3376;"Gintarėlis (Didlaukio g. 35)";Gintariukai;2809388552;Ne;0;0;3;3
3377;"Gintarėlis (Didlaukio g. 35)";Gintariukai;9374716095;Taip;5;0;4;9
3378;"Gintarėlis (Didlaukio g. 35)";Gintariukai;8815001033;Ne;5;4;0;9
3379;Giraitė;Aviliukas;4292730355;Taip;5;3;0;8
3380;Giraitė;Aviliukas;7001163828;Taip;8;0;0;8
3381;Giraitė;Aviliukas;5456658087;Ne;7;3;0;10
3382;Giraitė;Aviliukas;6159650070;Taip;0;3;0;3
3383;Giraitė;Aviliukas;5275912609;Taip;10;3;4;17
3384;Giraitė;Aviliukas;4758750245;Taip;8;0;2;10
3385;Giraitė;Aviliukas;2219854347;Taip;23;0;0;23
3386;Giraitė;Aviliukas;6315990604;Taip;15;0;0;15
3387;Giraitė;Aviliukas;2338867192;Taip;14;0;0;14
3388;Giraitė;Aviliukas;3719285343;Taip;8;3;0;11
3389;Giraitė;Aviliukas;3085107071;Taip;14;0;2;16
3390;Giraitė;Aviliukas;7807844145;Taip;5;0;2;7
3391;Giraitė;Aviliukas;3757900478;Taip;3;0;0;3
3392;Giraitė;Aviliukas;7876457529;Taip;0;1;7;8
3393;Giraitė;Aviliukas;3992069614;Taip;5;4;0;9
3394;Giraitė;Aviliukas;6121586335;Taip;15;0;0;15
3395;Giraitė;Aviliukas;4440444700;Taip;6;0;4;10
3396;Giraitė;Aviliukas;6296485105;Taip;6;0;3;9
3397;Giraitė;Aviliukas;5356944812;Taip;21;0;0;21
3398;Giraitė;Aviliukas;4554565631;Ne;14;0;0;14
3399;Giraitė;Aviliukas;2340866110;Taip;15;0;3;18
3400;Giraitė;LapiukaI;6141730004;Taip;7;0;0;7
3401;Giraitė;LapiukaI;6325909670;Taip;18;0;0;18
3402;Giraitė;LapiukaI;7831526566;Taip;10;0;1;11
3403;Giraitė;LapiukaI;2740656695;Taip;0;4;0;4
3404;Giraitė;LapiukaI;5030697729;Taip;10;0;0;10
3405;Giraitė;LapiukaI;1921430434;Taip;12;4;0;16
3406;Giraitė;LapiukaI;5006156109;Taip;0;3;0;3
3407;Giraitė;LapiukaI;4663343304;Taip;1;1;0;2
3408;Giraitė;LapiukaI;5382004098;Taip;3;1;0;4
3409;Giraitė;LapiukaI;4811513778;Taip;11;0;0;11
3410;Giraitė;LapiukaI;4296449093;Taip;3;3;0;6
3411;Giraitė;LapiukaI;1974159110;Taip;3;0;0;3
3412;Giraitė;LapiukaI;5532639133;Taip;8;0;1;9
3413;Giraitė;LapiukaI;4076402180;Taip;0;4;0;4
3414;Giraitė;LapiukaI;5902161665;Taip;0;6;0;6
3415;Giraitė;LapiukaI;4955786826;Taip;0;3;0;3
3416;Giraitė;LapiukaI;4260343903;Taip;18;0;0;18
3417;Giraitė;LapiukaI;9088123796;Taip;8;3;0;11
3418;Giraitė;LapiukaI;7772177095;Taip;0;3;0;3
3419;Giraitė;LapiukaI;8492822889;Ne;8;1;0;9
3420;Giraitė;LapiukaI;2880342138;Taip;5;1;0;6
3421;Giraitė;Voveriukai;7354834895;Taip;0;3;0;3
3422;Giraitė;Voveriukai;4387282125;Taip;0;3;0;3
3423;Giraitė;Voveriukai;6265908751;Taip;0;3;0;3
3424;Giraitė;Voveriukai;4822168634;Taip;3;1;0;4
3425;Giraitė;Voveriukai;2074303013;Taip;0;3;0;3
3426;Giraitė;Voveriukai;2088867630;Taip;0;3;0;3
3427;Giraitė;Voveriukai;3875214088;Taip;0;5;0;5
3428;Giraitė;Voveriukai;5202562049;Taip;0;3;0;3
3429;Giraitė;Voveriukai;7441871219;Taip;0;3;0;3
3430;Giraitė;Voveriukai;7481895278;Taip;16;0;0;16
3431;Giraitė;Voveriukai;3607198556;Taip;0;4;0;4
3432;Giraitė;Voveriukai;1945918102;Taip;5;3;1;9
3433;Giraitė;Voveriukai;8799195526;Taip;0;3;2;5
3434;Giraitė;Voveriukai;6225092500;Taip;0;3;0;3
3435;Giraitė;Voveriukai;4137699629;Taip;11;0;0;11
3436;Giraitė;Voveriukai;4932174149;Taip;0;2;0;2
3437;Giraitė;Voveriukai;3896789232;Taip;0;1;0;1
3438;Giraitė;Voveriukai;7919088987;Taip;0;3;0;3
3439;Giraitė;Voveriukai;5616242311;Taip;8;0;0;8
3440;Giraitė;Voveriukai;7739516049;Taip;1;3;0;4
3441;Giraitė;Voveriukai;4773517160;Taip;0;3;2;5
3442;Giraitė;Voveriukai;2177856916;Taip;5;4;0;9
3443;Giraitė;Grybukai;2990968206;Taip;4;0;0;4
3444;Giraitė;Grybukai;1312761239;Taip;0;3;1;4
3445;Giraitė;Grybukai;5721669627;Taip;0;3;0;3
3446;Giraitė;Grybukai;5892950503;Taip;0;2;0;2
3447;Giraitė;Grybukai;4839351300;Taip;9;4;0;13
3448;Giraitė;Grybukai;9495968363;Taip;0;3;0;3
3449;Giraitė;Grybukai;1253151830;Taip;0;3;0;3
3450;Giraitė;Grybukai;4336519836;Taip;7;2;1;10
3451;Giraitė;Grybukai;9224845723;Taip;3;4;1;8
3452;Giraitė;Grybukai;4687228561;Taip;8;0;0;8
3453;Giraitė;Grybukai;9882372025;Taip;0;1;0;1
3454;Giraitė;Grybukai;9918028862;Taip;5;4;0;9
3455;Giraitė;Grybukai;5167002022;Taip;5;4;0;9
3456;Giraitė;Grybukai;4785524898;Taip;0;3;0;3
3457;Giraitė;Grybukai;8596389737;Taip;5;3;1;9
3458;Giraitė;Grybukai;1111614295;Taip;1;5;0;6
3459;Giraitė;Grybukai;5029839281;Ne;0;3;1;4
3460;Giraitė;Grybukai;8869728241;Taip;0;3;2;5
3461;Giraitė;Grybukai;3683700626;Taip;1;1;0;2
3462;Giraitė;Grybukai;9026736929;Taip;0;4;0;4
3463;Giraitė;Riešutėliai;5365264259;Taip;10;0;2;12
3464;Giraitė;Riešutėliai;7179656901;Ne;8;0;0;8
3465;Giraitė;Riešutėliai;3158451613;Taip;5;1;0;6
3466;Giraitė;Riešutėliai;7910736839;Taip;16;0;0;16
3467;Giraitė;Riešutėliai;3308792461;Taip;16;0;0;16
3468;Giraitė;Riešutėliai;7423115504;Taip;10;0;0;10
3469;Giraitė;Riešutėliai;7580600719;Taip;10;0;0;10
3470;Giraitė;Riešutėliai;3116241918;Taip;2;0;1;3
3471;Giraitė;Riešutėliai;6838184704;Taip;13;4;0;17
3472;Giraitė;Riešutėliai;5161383686;Taip;7;1;0;8
3473;Giraitė;Riešutėliai;5148257412;Taip;4;0;3;7
3474;Giraitė;Riešutėliai;7566944002;Taip;2;5;0;7
3475;Giraitė;Riešutėliai;3839432744;Taip;0;1;2;3
3476;Giraitė;Riešutėliai;7803047658;Taip;4;5;0;9
3477;Giraitė;Riešutėliai;7113991095;Taip;6;0;0;6
3478;Giraitė;Riešutėliai;9144465313;Taip;0;3;1;4
3479;Giraitė;Riešutėliai;6288016799;Taip;12;0;0;12
3480;Giraitė;Riešutėliai;3278871662;Taip;3;0;0;3
3481;Giraitė;Riešutėliai;4168934880;Taip;0;3;0;3
3482;Giraitė;Riešutėliai;6337090583;Taip;7;0;5;12
3483;Giraitė;Riešutėliai;3843211767;Taip;0;5;4;9
3484;Giraitė;Meškiukai;27501094616;Taip;7;5;0;12
3485;Giraitė;Meškiukai;2513312448;Taip;0;4;0;4
3486;Giraitė;Meškiukai;5367392810;Taip;0;1;0;1
3487;Giraitė;Meškiukai;1608876140;Taip;0;4;0;4
3488;Giraitė;Meškiukai;5461837332;Taip;0;4;0;4
3489;Giraitė;Meškiukai;1355594003;Taip;0;4;0;4
3490;Giraitė;Meškiukai;1560868105;Taip;0;3;0;3
3491;Giraitė;Meškiukai;1050699551;Taip;0;3;0;3
3492;Giraitė;Meškiukai;1876815077;Taip;0;3;0;3
3493;Giraitė;Meškiukai;1318214394;Taip;7;1;0;8
3494;Giraitė;Meškiukai;9195735923;Taip;7;1;0;8
3495;Giraitė;Meškiukai;65251975467;Taip;5;3;0;8
3496;Giraitė;Meškiukai;1704154980;Taip;1;2;1;4
3497;Giraitė;Meškiukai;1819657811;Taip;0;3;0;3
3498;Giraitė;Meškiukai;1512384599;Taip;4;0;0;4
3499;Giraitė;Meškiukai;2571892050;Taip;0;3;1;4
3500;Giraitė;Meškiukai;6156715234;Taip;0;3;2;5
3501;Giraitė;Meškiukai;1594965200;Taip;0;4;2;6
3502;Giraitė;Meškiukai;9723242940;Taip;2;3;0;5
3503;Giraitė;Meškiukai;5726182600;Taip;0;4;0;4
3504;Giraitė;Meškiukai;1772790396;Ne;0;0;1;1
3505;Giraitė;Meškiukai;2551280794;Taip;0;9;0;9
3506;Giraitė;Uogelės;8908602761;Taip;0;3;0;3
3507;Giraitė;Uogelės;4717851198;Taip;0;3;1;4
3508;Giraitė;Uogelės;1729871315;Taip;4;5;0;9
3509;Giraitė;Uogelės;9503157590;Taip;0;3;0;3
3510;Giraitė;Uogelės;4317544803;Taip;5;3;0;8
3511;Giraitė;Uogelės;9927102264;Taip;13;0;0;13
3512;Giraitė;Uogelės;4121361794;Taip;0;4;0;4
3513;Giraitė;Uogelės;4843415587;Taip;0;12;1;13
3514;Giraitė;Uogelės;5471577047;Taip;0;3;1;4
3515;Giraitė;Uogelės;2732715332;Taip;0;5;0;5
3516;Giraitė;Uogelės;2307307454;Taip;0;3;0;3
3517;Giraitė;Uogelės;2102237550;Taip;0;1;0;1
3518;Giraitė;Uogelės;5255040944;Taip;10;0;0;10
3519;Giraitė;Uogelės;7094750784;Taip;0;2;0;2
3520;Giraitė;Uogelės;1583733838;Taip;0;2;0;2
3521;Giraitė;Uogelės;1356340471;Taip;4;4;3;11
3522;Giraitė;Uogelės;7377939409;Ne;11;4;1;16
3523;Giraitė;Uogelės;4288937528;Taip;9;1;0;10
3524;Giraitė;Uogelės;6293111179;Taip;11;4;0;15
3525;Giraitė;Uogelės;7390702355;Taip;0;4;0;4
3526;Giraitė;Šaltinėlis;5876711899;Taip;8;0;0;8
3527;Giraitė;Šaltinėlis;8427713392;Taip;8;0;1;9
3528;Giraitė;Šaltinėlis;3612494313;Taip;0;0;3;3
3529;Giraitė;Šaltinėlis;2076989836;Taip;18;0;0;18
3530;Giraitė;Šaltinėlis;9589760939;Taip;14;0;0;14
3531;Giraitė;Šaltinėlis;4500393769;Taip;0;10;0;10
3532;Giraitė;Šaltinėlis;3144724475;Taip;9;0;2;11
3533;Giraitė;Šaltinėlis;5525538498;Taip;5;0;3;8
3534;Giraitė;Šaltinėlis;4681342624;Taip;6;0;4;10
3535;Giraitė;Šaltinėlis;4431964254;Taip;0;0;3;3
3536;Giraitė;Šaltinėlis;4946664007;Taip;6;0;1;7
3537;Giraitė;Šaltinėlis;1170698327;Taip;5;1;0;6
3538;Giraitė;Šaltinėlis;6865072274;Taip;16;0;0;16
3539;Giraitė;Šaltinėlis;3108521607;Taip;6;0;5;11
3540;Giraitė;Šaltinėlis;8139743188;Taip;4;1;0;5
3541;Giraitė;Šaltinėlis;2867735227;Ne;3;0;7;10
3542;Giraitė;Šaltinėlis;9669849051;Taip;1;0;5;6
3543;Giraitė;Boružėlės;6378362980;Taip;4;0;1;5
3544;Giraitė;Boružėlės;8612554184;Taip;11;0;0;11
3545;Giraitė;Boružėlės;1436302175;Taip;3;3;0;6
3546;Giraitė;Boružėlės;2064019596;Taip;0;3;0;3
3547;Giraitė;Boružėlės;3346193393;Taip;19;0;2;21
3548;Giraitė;Boružėlės;7260229442;Taip;0;0;4;4
3549;Giraitė;Boružėlės;1126576745;Taip;12;0;1;13
3550;Giraitė;Boružėlės;1772997796;Taip;6;0;0;6
3551;Giraitė;Boružėlės;9281071794;Taip;16;0;0;16
3552;Giraitė;Boružėlės;9386943162;Taip;3;1;0;4
3553;Giraitė;Boružėlės;4749790368;Taip;0;3;1;4
3554;Giraitė;Boružėlės;3039445733;Taip;4;0;2;6
3555;Giraitė;Boružėlės;4719547384;Taip;19;3;0;22
3556;Giraitė;Boružėlės;4008393576;Taip;6;2;1;9
3557;Giraitė;Boružėlės;9766107773;Taip;11;0;0;11
3558;Giraitė;Gandriukai;4680913596;Taip;8;0;0;8
3559;Giraitė;Gandriukai;7384795349;Taip;0;0;5;5
3560;Giraitė;Gandriukai;3643426944;Taip;0;0;1;1
3561;Giraitė;Gandriukai;8525380061;Taip;1;5;0;6
3562;Giraitė;Gandriukai;4851987149;Ne;7;0;0;7
3563;Giraitė;Gandriukai;2205108811;Taip;12;0;0;12
3564;Giraitė;Gandriukai;7008670489;Taip;0;3;0;3
3565;Giraitė;Gandriukai;6277788515;Taip;0;2;0;2
3566;Giraitė;Gandriukai;7767820565;Taip;6;0;1;7
3567;Giraitė;Gandriukai;8819218663;Taip;0;3;0;3
3568;Giraitė;Gandriukai;7269074498;Taip;0;3;0;3
3569;Giraitė;Gandriukai;1490748887;Ne;5;0;1;6
3570;Giraitė;Gandriukai;7789414361;Taip;11;3;0;14
3571;Giraitė;Gandriukai;9850432917;Taip;18;0;0;18
3572;Giraitė;Gandriukai;2313273738;Taip;3;3;0;6
3573;Giraitė;Gandriukai;8101302584;Taip;22;0;0;22
3574;Giraitė;Gandriukai;9307640828;Taip;0;0;1;1
3575;Giraitė;Gandriukai;3027761044;Taip;0;3;0;3
3576;Giraitė;Gandriukai;1125863541;Taip;0;3;0;3
3577;Giraitė;Gandriukai;4371263826;Taip;0;3;0;3
3578;Giraitė;ŽVIRBLIUKAI;6715354865;Taip;1;0;2;3
3579;Giraitė;ŽVIRBLIUKAI;8461725999;Taip;5;0;4;9
3580;Giraitė;ŽVIRBLIUKAI;7395332578;Taip;10;0;2;12
3581;Giraitė;ŽVIRBLIUKAI;5086296808;Taip;0;5;0;5
3582;Giraitė;ŽVIRBLIUKAI;9669916418;Taip;8;0;3;11
3583;Giraitė;ŽVIRBLIUKAI;3481695682;Taip;0;0;1;1
3584;Giraitė;ŽVIRBLIUKAI;6677278422;Taip;0;0;3;3
3585;Giraitė;ŽVIRBLIUKAI;7230351549;Taip;6;0;4;10
3586;Giraitė;ŽVIRBLIUKAI;9114364139;Taip;0;3;0;3
3587;Giraitė;ŽVIRBLIUKAI;9392127689;Taip;0;0;4;4
3588;Giraitė;ŽVIRBLIUKAI;2416162886;Taip;1;0;3;4
3589;Giraitė;ŽVIRBLIUKAI;7543605905;Taip;7;3;0;10
3590;Giraitė;ŽVIRBLIUKAI;8128401630;Taip;0;0;3;3
3591;Giraitė;ŽVIRBLIUKAI;4233170371;Taip;0;0;3;3
3592;Giraitė;ŽVIRBLIUKAI;8871979627;Taip;0;1;0;1
3593;Giraitė;ŽVIRBLIUKAI;3214528809;Taip;7;0;3;10
3594;Giraitė;ŽVIRBLIUKAI;5548434439;Taip;4;0;2;6
3595;Giraitė;ŽVIRBLIUKAI;4450822125;Taip;0;0;2;2
3596;Giraitė;ŽVIRBLIUKAI;6474975269;Taip;0;0;3;3
3597;Giraitė;Kiškeliai;1227555563;Taip;10;0;4;14
3598;Giraitė;Kiškeliai;3613828494;Taip;18;0;0;18
3599;Giraitė;Kiškeliai;5447466102;Taip;0;5;1;6
3600;Giraitė;Kiškeliai;2686885139;Taip;0;0;1;1
3601;Giraitė;Kiškeliai;9764802294;Taip;3;0;0;3
3602;Giraitė;Kiškeliai;5574589536;Taip;11;0;0;11
3603;Giraitė;Kiškeliai;2726766768;Taip;2;0;4;6
3604;Giraitė;Kiškeliai;4927582548;Taip;0;0;1;1
3605;Giraitė;Kiškeliai;6565165993;Ne;5;0;2;7
3606;Giraitė;Kiškeliai;1456726379;Ne;0;2;6;8
3607;Giraitė;Kiškeliai;7392324344;Taip;14;0;1;15
3608;Giraitė;Kiškeliai;7744101334;Ne;6;0;1;7
3609;Giraitė;Kiškeliai;9751078590;Taip;1;0;2;3
3610;Gudrutis;Gandriukų;2197278086;Taip;8;7;0;15
3611;Gudrutis;Gandriukų;6358318238;Taip;0;2;2;4
3612;Gudrutis;Gandriukų;7942601528;Taip;4;2;1;7
3613;Gudrutis;Gandriukų;1701035039;Taip;0;3;0;3
3614;Gudrutis;Gandriukų;4844838728;Taip;5;2;2;9
3615;Gudrutis;Gandriukų;1685531183;Taip;0;0;4;4
3616;Gudrutis;Gandriukų;9253468183;Taip;3;2;1;6
3617;Gudrutis;Gandriukų;1051407930;Taip;4;2;0;6
3618;Gudrutis;Gandriukų;7755882832;Taip;0;2;1;3
3619;Gudrutis;Gandriukų;2487363252;Taip;3;0;0;3
3620;Gudrutis;Gandriukų;7663746093;Taip;4;1;1;6
3621;Gudrutis;Gandriukų;1012579870;Taip;0;2;1;3
3622;Gudrutis;Gandriukų;8512130106;Taip;5;6;0;11
3623;Gudrutis;Gandriukų;3919786807;Taip;0;1;6;7
3624;Gudrutis;Gandriukų;2630768189;Taip;0;0;9;9
3625;Gudrutis;Gandriukų;8165828215;Taip;0;3;0;3
3626;Gudrutis;Gandriukų;1485530468;Taip;11;0;3;14
3627;Gudrutis;Gandriukų;5508723821;Taip;11;11;0;22
3628;Gudrutis;Gandriukų;9044566825;Taip;18;0;0;18
3629;Gudrutis;Gandriukų;8774935740;Taip;8;1;5;14
3630;Gudrutis;Gandriukų;9297898193;Taip;0;18;0;18
3631;Gudrutis;Gandriukų;9784116399;Taip;9;2;0;11
3632;Gudrutis;"Saulės zuikučių";7934673005;Taip;5;0;0;5
3633;Gudrutis;"Saulės zuikučių";2199222671;Taip;5;0;1;6
3634;Gudrutis;"Saulės zuikučių";1587454709;Taip;0;3;0;3
3635;Gudrutis;"Saulės zuikučių";1670550212;Taip;3;1;0;4
3636;Gudrutis;"Saulės zuikučių";1225698076;Taip;0;1;0;1
3637;Gudrutis;"Saulės zuikučių";8500911420;Taip;0;2;4;6
3638;Gudrutis;"Saulės zuikučių";5408444872;Taip;3;0;3;6
3639;Gudrutis;"Saulės zuikučių";5728436444;Taip;0;3;0;3
3640;Gudrutis;"Saulės zuikučių";9041133527;Taip;0;11;0;11
3641;Gudrutis;"Saulės zuikučių";8621229735;Taip;0;3;0;3
3642;Gudrutis;"Saulės zuikučių";8240340213;Taip;0;3;0;3
3643;Gudrutis;"Saulės zuikučių";9697445037;Taip;0;0;1;1
3644;Gudrutis;"Saulės zuikučių";6846653547;Taip;0;0;3;3
3645;Gudrutis;"Saulės zuikučių";3281890659;Taip;0;10;0;10
3646;Gudrutis;"Saulės zuikučių";2291393238;Taip;3;0;0;3
3647;Gudrutis;"Saulės zuikučių";9752360809;Taip;0;0;5;5
3648;Gudrutis;"Saulės zuikučių";5585248878;Ne;0;0;4;4
3649;Gudrutis;"Saulės zuikučių";1384696362;Taip;0;3;0;3
3650;Gudrutis;"Saulės zuikučių";2666772437;Taip;3;0;0;3
3651;Gudrutis;"Saulės zuikučių";2994309084;Ne;0;3;8;11
3652;Gudrutis;"Saulės zuikučių";3743529726;Taip;0;0;3;3
3653;Gudrutis;Pelėdžiukų;2293472716;Taip;0;0;4;4
3654;Gudrutis;Pelėdžiukų;6835038962;Taip;0;0;13;13
3655;Gudrutis;Pelėdžiukų;6731806925;Taip;0;3;1;4
3656;Gudrutis;Pelėdžiukų;2118727861;Taip;0;0;7;7
3657;Gudrutis;Pelėdžiukų;9701111916;Taip;6;0;2;8
3658;Gudrutis;Pelėdžiukų;1725920873;Taip;5;3;1;9
3659;Gudrutis;Pelėdžiukų;1901358996;Taip;6;0;0;6
3660;Gudrutis;Pelėdžiukų;7664517480;Taip;5;0;1;6
3661;Gudrutis;Pelėdžiukų;9847597133;Taip;0;8;0;8
3662;Gudrutis;Pelėdžiukų;6198012431;Taip;4;3;0;7
3663;Gudrutis;Pelėdžiukų;3646335609;Taip;0;0;5;5
3664;Gudrutis;Pelėdžiukų;7871991275;Taip;0;0;4;4
3665;Gudrutis;Pelėdžiukų;5580618896;Taip;0;0;4;4
3666;Gudrutis;Pelėdžiukų;2468434676;Taip;0;0;2;2
3667;Gudrutis;Pelėdžiukų;3625838131;Taip;0;3;0;3
3668;Gudrutis;Pelėdžiukų;2337493193;Taip;0;4;0;4
3669;Gudrutis;Pelėdžiukų;2408038213;Taip;0;3;1;4
3670;Gudrutis;Pelėdžiukų;2764843216;Taip;0;4;0;4
3671;Gudrutis;Pelėdžiukų;7955353991;Taip;0;3;0;3
3672;Gudrutis;BITUČIŲ;6742455931;Ne;0;3;0;3
3673;Gudrutis;BITUČIŲ;4193661251;Taip;4;2;3;9
3674;Gudrutis;BITUČIŲ;7443277768;Taip;9;5;0;14
3675;Gudrutis;BITUČIŲ;9797417587;Taip;0;3;0;3
3676;Gudrutis;BITUČIŲ;5574287734;Taip;0;3;2;5
3677;Gudrutis;BITUČIŲ;2431077357;Taip;0;3;0;3
3678;Gudrutis;BITUČIŲ;7116979528;Taip;0;5;0;5
3679;Gudrutis;BITUČIŲ;1228190677;Taip;0;3;6;9
3680;Gudrutis;BITUČIŲ;6700254479;Taip;0;3;0;3
3681;Gudrutis;BITUČIŲ;1693306014;Taip;0;3;3;6
3682;Gudrutis;BITUČIŲ;8398961969;Taip;0;5;1;6
3683;Gudrutis;BITUČIŲ;2074151024;Taip;14;3;0;17
3684;Gudrutis;BITUČIŲ;1991658503;Taip;0;3;0;3
3685;Gudrutis;BITUČIŲ;2592224860;Taip;0;7;0;7
3686;Gudrutis;BITUČIŲ;9841172472;Taip;5;3;0;8
3687;Gudrutis;BITUČIŲ;3359028602;Taip;0;4;0;4
3688;Gudrutis;BITUČIŲ;4945755164;Taip;0;3;2;5
3689;Gudrutis;BITUČIŲ;6443631536;Taip;0;4;0;4
3690;Gudrutis;BITUČIŲ;3363824185;Taip;8;3;0;11
3691;Gudrutis;BITUČIŲ;7773150642;Taip;0;3;0;3
3692;Gudrutis;Boružėlių;2497248749;Taip;0;0;14;14
3693;Gudrutis;Boružėlių;6284712576;Taip;5;1;0;6
3694;Gudrutis;Boružėlių;9096764346;Taip;0;3;0;3
3695;Gudrutis;Boružėlių;5306281458;Taip;0;0;5;5
3696;Gudrutis;Boružėlių;8783180638;Taip;0;0;5;5
3697;Gudrutis;Boružėlių;8525851058;Taip;14;0;0;14
3698;Gudrutis;Boružėlių;8080976400;Taip;18;0;0;18
3699;Gudrutis;Boružėlių;9808350750;Taip;0;3;0;3
3700;Gudrutis;Boružėlių;6101410750;Taip;0;2;1;3
3701;Gudrutis;Boružėlių;5710348070;Taip;0;0;9;9
3702;Gudrutis;Boružėlių;8843761360;Taip;0;0;9;9
3703;Gudrutis;Boružėlių;5590297232;Taip;0;0;3;3
3704;Gudrutis;Boružėlių;2145834885;Taip;0;0;11;11
3705;Gudrutis;Boružėlių;2827279258;Taip;4;3;2;9
3706;Gudrutis;Boružėlių;5093267385;Taip;5;4;0;9
3707;Gudrutis;Boružėlių;1364145110;Taip;5;3;1;9
3708;Gudrutis;Boružėlių;1737001982;Taip;9;4;0;13
3709;Gudrutis;Drugeliai;7930414623;Taip;0;5;0;5
3710;Gudrutis;Drugeliai;6458053920;Taip;0;3;1;4
3711;Gudrutis;Drugeliai;5498218329;Taip;8;7;0;15
3712;Gudrutis;Drugeliai;4600814480;Taip;10;3;0;13
3713;Gudrutis;Drugeliai;9454206104;Taip;5;2;1;8
3714;Gudrutis;Drugeliai;5054363773;Taip;0;13;0;13
3715;Gudrutis;Drugeliai;7531077386;Taip;2;8;0;10
3716;Gudrutis;Drugeliai;5931281687;Taip;10;2;0;12
3717;Gudrutis;Drugeliai;3264829331;Taip;6;2;0;8
3718;Gudrutis;Drugeliai;7143849852;Ne;0;1;3;4
3719;Gudrutis;Drugeliai;3760014407;Taip;8;0;0;8
3720;Gudrutis;Drugeliai;1588396018;Taip;5;4;0;9
3721;Gudrutis;Drugeliai;3316297441;Taip;8;2;2;12
3722;Gudrutis;Drugeliai;6307643172;Taip;5;0;1;6
3723;Gudrutis;Drugeliai;2256458624;Taip;0;1;0;1
3724;Gudrutis;Drugeliai;2278368966;Taip;0;0;6;6
3725;Gudrutis;Drugeliai;5911423362;Taip;7;0;0;7
3726;Gudrutis;Drugeliai;2784392885;Taip;0;16;0;16
3727;Gudrutis;Drugeliai;1170008457;Taip;5;0;3;8
3728;Jovarėlis;MEŠKUČIAI;8285597164;Taip;3;0;0;3
3729;Jovarėlis;MEŠKUČIAI;1991693486;Taip;5;0;0;5
3730;Jovarėlis;PELĖDŽIUKAI;2723487680;Taip;13;0;0;13
3731;Jovarėlis;PELĖDŽIUKAI;6406866195;Taip;3;0;0;3
3732;Jurginėlis;Ąžuoliukai;7309052653;Taip;2;0;10;12
3733;Jurginėlis;Ąžuoliukai;2501462080;Taip;0;0;1;1
3734;Jurginėlis;Ąžuoliukai;8571054905;Taip;10;0;1;11
3735;Jurginėlis;Ąžuoliukai;6168508647;Taip;3;0;6;9
3736;Jurginėlis;Ąžuoliukai;5861832676;Taip;5;0;2;7
3737;Jurginėlis;Ąžuoliukai;3933113321;Taip;0;12;0;12
3738;Jurginėlis;Ąžuoliukai;5861418459;Taip;0;8;0;8
3739;Jurginėlis;Ąžuoliukai;5869170503;Taip;0;0;8;8
3740;Jurginėlis;Ąžuoliukai;3562210465;Taip;0;6;0;6
3741;Jurginėlis;Ąžuoliukai;6202225321;Taip;0;0;3;3
3742;Jurginėlis;Ąžuoliukai;7081618073;Taip;0;1;4;5
3743;Jurginėlis;Ąžuoliukai;6851855147;Taip;5;1;2;8
3744;Jurginėlis;Ąžuoliukai;9029587175;Taip;0;2;0;2
3745;Jurginėlis;Ąžuoliukai;9889620429;Taip;0;2;0;2
3746;Jurginėlis;Ąžuoliukai;3324811458;Taip;5;2;0;7
3747;Jurginėlis;Ąžuoliukai;6153432639;Taip;7;1;0;8
3748;Jurginėlis;Ąžuoliukai;9850874714;Taip;5;3;0;8
3749;Jurginėlis;Ąžuoliukai;8174251359;Ne;0;3;3;6
3750;Jurginėlis;Ąžuoliukai;2447025385;Taip;2;0;8;10
3751;Jurginėlis;Ąžuoliukai;5313627252;Taip;0;0;8;8
3752;Jurginėlis;Žiogeliai;8159210242;Taip;7;6;0;13
3753;Jurginėlis;Žiogeliai;9934831745;Taip;7;3;0;10
3754;Jurginėlis;Žiogeliai;7251598691;Taip;0;2;0;2
3755;Jurginėlis;Žiogeliai;3083045137;Taip;3;0;0;3
3756;Jurginėlis;Žiogeliai;6906225772;Taip;5;4;0;9
3757;Jurginėlis;Žiogeliai;7010130915;Taip;0;0;3;3
3758;Jurginėlis;Žiogeliai;7907096012;Taip;6;4;0;10
3759;Jurginėlis;Žiogeliai;7250246853;Taip;0;8;0;8
3760;Jurginėlis;Žiogeliai;4110053674;Ne;14;0;0;14
3761;Jurginėlis;Žiogeliai;5160581631;Ne;10;1;0;11
3762;Jurginėlis;Žiogeliai;6438669072;Taip;13;0;0;13
3763;Jurginėlis;Žiogeliai;5037980414;Taip;0;5;5;10
3764;Jurginėlis;Žiogeliai;7300018733;Taip;0;6;0;6
3765;Jurginėlis;Žiogeliai;4674128568;Taip;0;6;0;6
3766;Jurginėlis;Žiogeliai;9305884152;Taip;0;2;3;5
3767;Jurginėlis;Žiogeliai;9716328349;Taip;0;18;0;18
3768;Jurginėlis;Žiogeliai;4441183185;Taip;0;4;0;4
3769;Jurginėlis;Žiogeliai;4502564783;Taip;0;6;0;6
3770;Jurginėlis;Žiogeliai;1937927553;Ne;0;0;2;2
3771;Jurginėlis;Žiogeliai;7527178332;Taip;0;4;0;4
3772;Jurginėlis;Žiogeliai;4682125116;Taip;0;4;0;4
3773;Jurginėlis;Žiogeliai;3920971621;Taip;7;3;0;10
3774;Jurginėlis;Pelėdžiukų;9882919290;Taip;0;1;0;1
3775;Jurginėlis;Pelėdžiukų;5984893389;Taip;0;4;0;4
3776;Jurginėlis;Pelėdžiukų;3079495897;Ne;0;9;0;9
3777;Jurginėlis;Pelėdžiukų;8727844649;Taip;0;3;6;9
3778;Jurginėlis;Pelėdžiukų;1455749921;Taip;0;8;0;8
3779;Jurginėlis;Pelėdžiukų;7809274980;Taip;0;3;1;4
3780;Jurginėlis;Pelėdžiukų;2417314519;Taip;0;5;2;7
3781;Jurginėlis;Pelėdžiukų;6968528293;Taip;0;3;0;3
3782;Jurginėlis;Pelėdžiukų;4292932046;Taip;10;3;0;13
3783;Jurginėlis;Pelėdžiukų;9507571301;Taip;0;1;0;1
3784;Jurginėlis;Pelėdžiukų;8779807396;Taip;0;4;0;4
3785;Jurginėlis;Pelėdžiukų;8443412187;Taip;4;1;0;5
3786;Jurginėlis;Pelėdžiukų;4967548277;Taip;0;7;0;7
3787;Jurginėlis;Pelėdžiukų;2925253653;Taip;9;1;0;10
3788;Jurginėlis;Pelėdžiukų;1340689348;Taip;5;4;0;9
3789;Jurginėlis;Pelėdžiukų;2221708420;Taip;0;3;0;3
3790;Jurginėlis;Pelėdžiukų;6181547354;Taip;5;5;0;10
3791;Jurginėlis;Pelėdžiukų;2490875633;Taip;11;2;0;13
3792;Jurginėlis;Pelėdžiukų;9760394658;Taip;2;3;4;9
3793;Jurginėlis;Pelėdžiukų;3786379532;Ne;3;2;0;5
3794;Jurginėlis;Boružėlių;4295285885;Taip;0;4;0;4
3795;Jurginėlis;Boružėlių;8920304044;Taip;0;6;0;6
3796;Jurginėlis;Boružėlių;2171115974;Taip;0;4;0;4
3797;Jurginėlis;Boružėlių;3027573572;Taip;0;7;0;7
3798;Jurginėlis;Boružėlių;8338173095;Taip;5;3;0;8
3799;Jurginėlis;Boružėlių;1758862051;Taip;0;11;0;11
3800;Jurginėlis;Boružėlių;1467200002;Taip;2;4;0;6
3801;Jurginėlis;Boružėlių;4851923549;Taip;0;3;0;3
3802;Jurginėlis;Boružėlių;6111863896;Taip;0;10;0;10
3803;Jurginėlis;Boružėlių;1701720412;Taip;10;1;0;11
3804;Jurginėlis;Boružėlių;1563317396;Taip;0;4;0;4
3805;Jurginėlis;Boružėlių;2133447073;Taip;0;3;0;3
3806;Jurginėlis;Boružėlių;47243459592;Taip;5;1;0;6
3807;Jurginėlis;Boružėlių;8784076886;Taip;0;6;0;6
3808;Jurginėlis;Boružėlių;2446630485;Taip;3;2;0;5
3809;Jurginėlis;Boružėlių;1829089083;Taip;10;3;0;13
3810;Jurginėlis;Boružėlių;1361108271;Taip;5;3;0;8
3811;Jurginėlis;Boružėlių;5386710069;Taip;10;3;0;13
3812;Jurginėlis;Boružėlių;8972814655;Taip;5;2;0;7
3813;Jurginėlis;Boružėlių;4852619394;Taip;5;6;0;11
3814;Jurginėlis;Boružėlių;7753784918;Taip;0;18;0;18
3815;Jurginėlis;Bitučių;9589394406;Ne;0;3;0;3
3816;Jurginėlis;Bitučių;1927843089;Taip;6;3;2;11
3817;Jurginėlis;Bitučių;3708774681;Taip;6;8;0;14
3818;Jurginėlis;Bitučių;6413324051;Taip;0;4;0;4
3819;Jurginėlis;Bitučių;2639125463;Taip;0;3;2;5
3820;Jurginėlis;Bitučių;1787311340;Taip;0;4;0;4
3821;Jurginėlis;Bitučių;7297672386;Taip;0;3;1;4
3822;Jurginėlis;Bitučių;1586599624;Taip;0;3;2;5
3823;Jurginėlis;Bitučių;2710889915;Taip;0;5;0;5
3824;Jurginėlis;Bitučių;1983924909;Taip;0;2;0;2
3825;Jurginėlis;Bitučių;1175441410;Taip;0;6;0;6
3826;Jurginėlis;Bitučių;1082593212;Taip;3;1;0;4
3827;Jurginėlis;Bitučių;4806248290;Taip;0;2;0;2
3828;Jurginėlis;Bitučių;903039398;Taip;0;3;0;3
3829;Jurginėlis;Bitučių;9646318532;Taip;2;4;0;6
3830;Jurginėlis;Bitučių;8227660508;Taip;7;2;0;9
3831;Jurginėlis;Bitučių;77480957625;Taip;0;3;0;3
3832;Jurginėlis;Bitučių;1547101731;Taip;0;3;2;5
3833;Jurginėlis;Bitučių;2624313807;Taip;10;3;0;13
3834;Jurginėlis;Bitučių;7928799065;Taip;0;1;1;2
3835;Jurginėlis;Bitučių;5892180334;Taip;0;4;0;4
3836;Jurginėlis;Bitučių;3018576350;Ne;0;2;2;4
3837;Jurginėlis;Skruzdeliukų;1351306981;Taip;7;2;0;9
3838;Jurginėlis;Skruzdeliukų;9146039217;Taip;5;0;0;5
3839;Jurginėlis;Skruzdeliukų;1885598986;Ne;7;1;0;8
3840;Jurginėlis;Skruzdeliukų;3558752347;Taip;0;10;0;10
3841;Jurginėlis;Skruzdeliukų;5734506036;Ne;5;5;0;10
3842;Jurginėlis;Skruzdeliukų;3699180485;Taip;0;13;0;13
3843;Jurginėlis;Skruzdeliukų;1634502874;Taip;0;0;3;3
3844;Jurginėlis;Skruzdeliukų;2441840949;Taip;12;0;0;12
3845;Jurginėlis;Skruzdeliukų;4981043400;Taip;2;0;0;2
3846;Jurginėlis;Skruzdeliukų;1763849354;Taip;8;0;2;10
3847;Jurginėlis;Skruzdeliukų;4944292549;Taip;9;6;0;15
3848;Jurginėlis;Skruzdeliukų;9506129699;Taip;13;0;0;13
3849;Jurginėlis;Skruzdeliukų;9550110246;Taip;9;3;0;12
3850;Jurginėlis;Skruzdeliukų;3822916547;Taip;9;0;0;9
3851;Jurginėlis;Skruzdeliukų;3541542063;Taip;6;0;3;9
3852;Jurginėlis;Skruzdeliukų;1204999684;Taip;8;3;0;11
3853;Jurginėlis;Skruzdeliukų;9937405742;Taip;8;5;0;13
3854;Jurginėlis;Skruzdeliukų;1726968598;Taip;7;10;0;17
3855;Jurginėlis;Skruzdeliukų;2332714713;Taip;18;0;0;18
3856;Jurginėlis;Skruzdeliukų;9961083854;Taip;0;11;0;11
3857;Jurginėlis;Skruzdeliukų;6542567172;Taip;13;3;0;16
3858;Jurginėlis;Drugelių;2025403481;Taip;0;0;3;3
3859;Jurginėlis;Drugelių;9065349248;Taip;9;0;0;9
3860;Jurginėlis;Drugelių;8341951659;Taip;13;3;0;16
3861;Jurginėlis;Drugelių;7795042485;Taip;10;3;0;13
3862;Jurginėlis;Drugelių;5138832895;Taip;5;0;2;7
3863;Jurginėlis;Drugelių;5751977493;Taip;16;0;0;16
3864;Jurginėlis;Drugelių;6068645621;Taip;0;9;0;9
3865;Jurginėlis;Drugelių;4276237094;Taip;12;0;0;12
3866;Jurginėlis;Drugelių;2689492215;Taip;0;0;3;3
3867;Jurginėlis;Drugelių;3527520303;Taip;0;0;3;3
3868;Jurginėlis;Drugelių;9736737788;Taip;0;5;1;6
3869;Jurginėlis;Drugelių;1208882528;Taip;8;3;0;11
3870;Jurginėlis;Drugelių;5874949368;Taip;0;18;0;18
3871;Jurginėlis;Drugelių;7349309693;Taip;5;2;0;7
3872;Jurginėlis;Drugelių;3063084253;Taip;7;0;0;7
3873;Jurginėlis;Drugelių;7409019574;Taip;10;6;0;16
3874;Jurginėlis;Žibučių;4979618298;Taip;13;0;0;13
3875;Jurginėlis;Žibučių;6636147085;Taip;9;4;0;13
3876;Jurginėlis;Žibučių;1438159631;Taip;6;5;0;11
3877;Jurginėlis;Žibučių;1336429135;Taip;20;3;0;23
3878;Jurginėlis;Žibučių;6948834218;Taip;0;4;13;17
3879;Jurginėlis;Žibučių;7721612113;Taip;0;0;4;4
3880;Jurginėlis;Žibučių;6988386438;Taip;17;0;0;17
3881;Jurginėlis;Žibučių;8111158692;Taip;6;0;0;6
3882;Jurginėlis;Žibučių;5936508522;Taip;0;20;0;20
3883;Jurginėlis;Žibučių;6717892969;Taip;15;3;0;18
3884;Jurginėlis;Žibučių;7977676733;Taip;10;3;0;13
3885;Jurginėlis;Žibučių;7530846375;Taip;7;3;0;10
3886;Jurginėlis;Žibučių;3899526893;Taip;4;1;0;5
3887;Jurginėlis;Žibučių;3861311860;Taip;17;3;0;20
3888;Jurginėlis;Žibučių;1263601087;Taip;4;3;0;7
3889;Jurginėlis;Žibučių;5549766339;Taip;10;4;0;14
3890;Jurginėlis;Žibučių;4429780802;Taip;17;1;0;18
3891;Jurginėlis;Žibučių;8968718021;Taip;12;3;0;15
3892;Jurginėlis;Žibučių;2782553941;Taip;10;0;11;21
3893;Jurginėlis;Žibučių;6259461257;Taip;3;0;5;8
3894;Jurginėlis;Žibučių;7252041334;Taip;9;0;0;9
3895;Jurginėlis;Zuikučių;5958832413;Taip;5;2;0;7
3896;Jurginėlis;Zuikučių;4432849717;Taip;0;9;0;9
3897;Jurginėlis;Zuikučių;6587382160;Taip;12;1;1;14
3898;Jurginėlis;Zuikučių;8097652962;Taip;5;4;0;9
3899;Jurginėlis;Zuikučių;4763313715;Taip;17;0;0;17
3900;Jurginėlis;Zuikučių;6671759364;Taip;0;0;2;2
3901;Jurginėlis;Zuikučių;6197396872;Taip;4;0;3;7
3902;Jurginėlis;Zuikučių;8937404520;Taip;5;1;4;10
3903;Jurginėlis;Zuikučių;2820249307;Taip;0;3;2;5
3904;Jurginėlis;Zuikučių;8823175066;Taip;8;3;0;11
3905;Jurginėlis;Zuikučių;8161347781;Taip;9;2;0;11
3906;Jurginėlis;Zuikučių;7283697595;Taip;3;0;4;7
3907;Jurginėlis;Zuikučių;4113264904;Taip;6;0;1;7
3908;Jurginėlis;Zuikučių;8117563141;Taip;5;0;3;8
3909;Jurginėlis;Zuikučių;5652597514;Taip;0;3;5;8
3910;Jurginėlis;Zuikučių;6341896288;Taip;0;0;5;5
3911;Jurginėlis;Zuikučių;4180071775;Taip;0;0;2;2
3912;Jurginėlis;Zuikučių;2536744421;Taip;0;6;0;6
3913;Jurginėlis;Viščiukų;7193314762;Taip;0;0;6;6
3914;Jurginėlis;Viščiukų;6306274502;Taip;0;0;8;8
3915;Jurginėlis;Viščiukų;4506484183;Taip;0;4;0;4
3916;Jurginėlis;Viščiukų;3741447134;Taip;0;0;2;2
3917;Jurginėlis;Viščiukų;2595002682;Taip;3;0;0;3
3918;Jurginėlis;Viščiukų;5866358319;Taip;5;0;2;7
3919;Jurginėlis;Viščiukų;4648875524;Taip;0;4;0;4
3920;Jurginėlis;Viščiukų;1598578487;Taip;0;0;5;5
3921;Jurginėlis;Viščiukų;4644476606;Taip;4;0;4;8
3922;Jurginėlis;Viščiukų;3622183526;Taip;0;0;2;2
3923;Jurginėlis;Viščiukų;3230200231;Taip;0;6;0;6
3924;Jurginėlis;Viščiukų;7636442845;Taip;8;0;2;10
3925;Jurginėlis;Viščiukų;1286603999;Taip;0;0;3;3
3926;Jurginėlis;Viščiukų;4617952912;Taip;13;0;0;13
3927;Jurginėlis;Viščiukų;9603380131;Taip;0;18;0;18
3928;Jurginėlis;Viščiukų;2870716390;Taip;0;8;0;8
3929;Jurginėlis;Meškiukų;8844614653;Taip;2;4;1;7
3930;Jurginėlis;Meškiukų;1303323955;Taip;5;0;4;9
3931;Jurginėlis;Meškiukų;4466955830;Taip;7;4;0;11
3932;Jurginėlis;Meškiukų;3675820817;Taip;8;3;0;11
3933;Jurginėlis;Meškiukų;6285599044;Taip;0;4;13;17
3934;Jurginėlis;Meškiukų;5043815909;Taip;0;0;3;3
3935;Jurginėlis;Meškiukų;9901171406;Taip;8;0;1;9
3936;Jurginėlis;Meškiukų;2982526236;Taip;10;2;0;12
3937;Jurginėlis;Meškiukų;4233910766;Taip;7;3;0;10
3938;Jurginėlis;Meškiukų;1537710974;Taip;0;7;0;7
3939;Jurginėlis;Meškiukų;6594025023;Taip;0;7;0;7
3940;Jurginėlis;Meškiukų;6648657850;Taip;3;3;0;6
3941;Jurginėlis;Meškiukų;6856023398;Taip;0;0;6;6
3942;Jurginėlis;Meškiukų;6124147401;Taip;0;3;3;6
3943;Jurginėlis;Gandriukų;8017976529;Taip;2;5;0;7
3944;Jurginėlis;Gandriukų;3530906368;Ne;10;4;0;14
3945;Jurginėlis;Gandriukų;6806704355;Taip;15;1;1;17
3946;Jurginėlis;Gandriukų;9288380246;Taip;0;3;3;6
3947;Jurginėlis;Gandriukų;2548920722;Taip;15;3;0;18
3948;Jurginėlis;Gandriukų;7288921301;Taip;17;3;0;20
3949;Jurginėlis;Gandriukų;4827340942;Taip;7;2;1;10
3950;Jurginėlis;Gandriukų;4463258777;Taip;0;2;0;2
3951;Jurginėlis;Gandriukų;1414888906;Taip;0;3;0;3
3952;Jurginėlis;Gandriukų;2225892248;Taip;0;0;5;5
3953;Jurginėlis;Gandriukų;6579565337;Taip;5;2;1;8
3954;Jurginėlis;Gandriukų;7990015623;Taip;0;9;0;9
3955;Jurginėlis;Gandriukų;4158502752;Taip;0;3;0;3
3956;Jurginėlis;Gandriukų;2214809186;Taip;11;0;1;12
3957;Jurginėlis;Gandriukų;3284464951;Taip;5;15;0;20
3958;Jurginėlis;Gandriukų;2263818210;Taip;0;6;0;6
3959;Jurginėlis;Gandriukų;3091019969;Taip;2;0;0;2
3960;Jurginėlis;Gandriukų;2837099502;Taip;0;0;1;1
3961;Jurginėlis;Gandriukų;3462969423;Taip;0;10;0;10
3962;Jurginėlis;Gandriukų;7486778826;Taip;0;6;0;6
3963;Jurginėlis;Gandriukų;5242359650;Taip;0;7;0;7
3964;Jurginėlis;Gandriukų;8144038013;Taip;0;12;0;12
3965;Karusėlė;PAGRANDUKAS;1621482372;Taip;4;6;0;10
3966;Karusėlė;PAGRANDUKAS;3330374479;Taip;8;4;0;12
3967;Karusėlė;PAGRANDUKAS;6183785840;Taip;0;10;0;10
3968;Karusėlė;PAGRANDUKAS;3984262482;Taip;7;0;3;10
3969;Karusėlė;PAGRANDUKAS;9130534156;Taip;7;0;1;8
3970;Karusėlė;PAGRANDUKAS;3660843696;Taip;0;1;3;4
3971;Karusėlė;PAGRANDUKAS;5132581245;Taip;9;5;0;14
3972;Karusėlė;PAGRANDUKAS;2412418335;Taip;0;4;0;4
3973;Karusėlė;PAGRANDUKAS;7393434659;Taip;0;0;1;1
3974;Karusėlė;PAGRANDUKAS;5695697634;Taip;0;6;0;6
3975;Karusėlė;PAGRANDUKAS;7013765804;Taip;0;11;0;11
3976;Karusėlė;PAGRANDUKAS;3429495073;Taip;0;4;0;4
3977;Karusėlė;PAGRANDUKAS;6252613489;Taip;0;9;0;9
3978;Karusėlė;PAGRANDUKAS;5595950213;Taip;6;2;1;9
3979;Karusėlė;PAGRANDUKAS;6004882312;Taip;0;6;0;6
3980;Karusėlė;PAGRANDUKAS;6856800484;Taip;0;3;0;3
3981;Karusėlė;PAGRANDUKAS;5028265234;Taip;13;5;0;18
3982;Karusėlė;PAGRANDUKAS;3972815393;Taip;0;7;0;7
3983;Karusėlė;PAGRANDUKAS;8157193503;Taip;12;1;0;13
3984;Karusėlė;PAGRANDUKAS;8656806219;Taip;0;8;0;8
3985;Karusėlė;PAGRANDUKAS;9651192437;Taip;0;0;1;1
3986;Karusėlė;NYKŠTUKAS;4966362343;Taip;7;0;3;10
3987;Karusėlė;NYKŠTUKAS;9997776739;Taip;5;0;0;5
3988;Karusėlė;NYKŠTUKAS;4445214427;Taip;0;10;0;10
3989;Karusėlė;NYKŠTUKAS;9354431582;Taip;0;6;0;6
3990;Karusėlė;NYKŠTUKAS;5216815933;Taip;0;2;0;2
3991;Karusėlė;NYKŠTUKAS;7817417459;Taip;0;9;0;9
3992;Karusėlė;NYKŠTUKAS;3418266059;Taip;1;2;0;3
3993;Karusėlė;NYKŠTUKAS;9654804545;Taip;0;5;0;5
3994;Karusėlė;NYKŠTUKAS;6581798125;Taip;0;4;3;7
3995;Karusėlė;NYKŠTUKAS;1486577955;Taip;7;2;0;9
3996;Karusėlė;NYKŠTUKAS;5697305819;Ne;4;1;0;5
3997;Karusėlė;NYKŠTUKAS;8007341411;Taip;18;0;0;18
3998;Karusėlė;NYKŠTUKAS;4296509304;Taip;0;1;0;1
3999;Karusėlė;NYKŠTUKAS;9243932017;Taip;7;2;0;9
4000;Karusėlė;NYKŠTUKAS;5986973796;Taip;11;0;0;11
4001;Karusėlė;NYKŠTUKAS;4856589410;Taip;9;0;0;9
4002;Karusėlė;NYKŠTUKAS;9999461542;Taip;10;0;0;10
4003;Karusėlė;NYKŠTUKAS;9385698812;Taip;0;10;0;10
4004;Karusėlė;NYKŠTUKAS;5328762735;Taip;4;0;0;4
4005;Karusėlė;NYKŠTUKAS;1078396181;Taip;0;6;3;9
4006;Karusėlė;BITUTĖ;1593728369;Taip;5;4;0;9
4007;Karusėlė;BITUTĖ;6417699445;Taip;0;2;0;2
4008;Karusėlė;BITUTĖ;2426822679;Taip;0;6;0;6
4009;Karusėlė;BITUTĖ;1205498782;Taip;7;5;0;12
4010;Karusėlė;BITUTĖ;7824913364;Ne;8;3;0;11
4011;Karusėlė;BITUTĖ;5651238035;Taip;0;3;0;3
4012;Karusėlė;BITUTĖ;5960946826;Taip;0;5;0;5
4013;Karusėlė;BITUTĖ;8175498192;Taip;9;4;0;13
4014;Karusėlė;BITUTĖ;5951045233;Taip;10;3;0;13
4015;Karusėlė;BITUTĖ;1487641646;Taip;0;6;0;6
4016;Karusėlė;BITUTĖ;6692345915;Taip;0;6;0;6
4017;Karusėlė;BITUTĖ;1211005513;Taip;0;2;2;4
4018;Karusėlė;BITUTĖ;2160071272;Taip;9;3;0;12
4019;Karusėlė;BITUTĖ;1691769088;Taip;0;4;0;4
4020;Karusėlė;BITUTĖ;7167895711;Taip;0;5;0;5
4021;Karusėlė;BITUTĖ;3116403256;Taip;0;10;0;10
4022;Karusėlė;BITUTĖ;7977133699;Taip;0;10;0;10
4023;Karusėlė;BITUTĖ;6165548450;Taip;0;3;0;3
4024;Karusėlė;BITUTĖ;1204919995;Taip;14;3;0;17
4025;Karusėlė;BITUTĖ;4435125556;Taip;0;4;0;4
4026;Karusėlė;BITUTĖ;3049506194;Taip;0;6;0;6
4027;Karusėlė;BORUŽĖLĖ;1705790474;Taip;6;5;0;11
4028;Karusėlė;BORUŽĖLĖ;8608177987;Taip;0;3;0;3
4029;Karusėlė;BORUŽĖLĖ;1311907441;Ne;4;4;0;8
4030;Karusėlė;BORUŽĖLĖ;6313010762;Taip;0;4;0;4
4031;Karusėlė;BORUŽĖLĖ;5859827168;Taip;5;2;0;7
4032;Karusėlė;BORUŽĖLĖ;37349219339;Taip;0;5;0;5
4033;Karusėlė;BORUŽĖLĖ;6811862463;Taip;0;8;0;8
4034;Karusėlė;BORUŽĖLĖ;5471989295;Taip;10;3;0;13
4035;Karusėlė;BORUŽĖLĖ;9753876554;Taip;1;3;3;7
4036;Karusėlė;BORUŽĖLĖ;8717484092;Taip;6;6;0;12
4037;Karusėlė;BORUŽĖLĖ;1994682683;Taip;0;5;1;6
4038;Karusėlė;BORUŽĖLĖ;5632697184;Taip;0;5;0;5
4039;Karusėlė;BORUŽĖLĖ;2247913568;Taip;0;4;0;4
4040;Karusėlė;BORUŽĖLĖ;4262640017;Taip;7;4;0;11
4041;Karusėlė;BORUŽĖLĖ;4845558814;Ne;5;9;0;14
4042;Karusėlė;BORUŽĖLĖ;8406462155;Taip;9;3;0;12
4043;Karusėlė;BORUŽĖLĖ;6495631086;Taip;0;5;1;6
4044;Karusėlė;BORUŽĖLĖ;1183484176;Taip;7;0;0;7
4045;Karusėlė;BORUŽĖLĖ;2287979864;Taip;10;2;0;12
4046;Karusėlė;BORUŽĖLĖ;3389843421;Taip;0;7;0;7
4047;Karusėlė;BORUŽĖLĖ;4818655110;Taip;18;0;0;18
4048;Karusėlė;UOGELĖ;9805481603;Taip;7;2;0;9
4049;Karusėlė;UOGELĖ;8182071103;Taip;10;1;0;11
4050;Karusėlė;UOGELĖ;9992989896;Taip;0;7;0;7
4051;Karusėlė;UOGELĖ;2084276906;Taip;11;1;0;12
4052;Karusėlė;UOGELĖ;8665314366;Taip;0;10;0;10
4053;Karusėlė;UOGELĖ;8316147204;Taip;0;4;0;4
4054;Karusėlė;UOGELĖ;5504719953;Taip;0;13;0;13
4055;Karusėlė;UOGELĖ;5919009583;Taip;8;8;0;16
4056;Karusėlė;UOGELĖ;4199597984;Taip;0;7;0;7
4057;Karusėlė;UOGELĖ;2383023280;Taip;0;9;0;9
4058;Karusėlė;UOGELĖ;1575408822;Taip;0;9;0;9
4059;Karusėlė;UOGELĖ;3917113787;Taip;5;3;0;8
4060;Karusėlė;UOGELĖ;4638918427;Taip;0;3;0;3
4061;Karusėlė;UOGELĖ;3615957761;Taip;0;6;0;6
4062;Karusėlė;UOGELĖ;3514026443;Taip;0;3;0;3
4063;Karusėlė;UOGELĖ;1891147022;Taip;0;2;4;6
4064;Karusėlė;UOGELĖ;9389017016;Taip;5;3;0;8
4065;Karusėlė;UOGELĖ;3872322338;Ne;0;2;2;4
4066;Karusėlė;UOGELĖ;3963576314;Taip;0;1;6;7
4067;Karusėlė;GINTARĖLIS;3773170060;Taip;3;3;1;7
4068;Karusėlė;GINTARĖLIS;3904453423;Taip;8;0;0;8
4069;Karusėlė;GINTARĖLIS;7489136297;Taip;12;0;0;12
4070;Karusėlė;GINTARĖLIS;3534074990;Taip;7;3;0;10
4071;Karusėlė;GINTARĖLIS;7540323186;Taip;12;3;0;15
4072;Karusėlė;GINTARĖLIS;1019322763;Taip;10;0;0;10
4073;Karusėlė;GINTARĖLIS;8481143199;Taip;8;0;2;10
4074;Karusėlė;GINTARĖLIS;3157893936;Taip;10;0;0;10
4075;Karusėlė;GINTARĖLIS;8409412605;Taip;12;0;0;12
4076;Karusėlė;GINTARĖLIS;3136606610;Taip;8;3;0;11
4077;Karusėlė;GINTARĖLIS;7599328323;Taip;0;3;0;3
4078;Karusėlė;GINTARĖLIS;2688863117;Taip;0;5;2;7
4079;Karusėlė;GINTARĖLIS;7439791054;Taip;8;0;0;8
4080;Karusėlė;GINTARĖLIS;3696384277;Taip;8;0;2;10
4081;Karusėlė;GINTARĖLIS;2945027875;Taip;9;3;0;12
4082;Karusėlė;GINTARĖLIS;8855096080;Taip;7;0;0;7
4083;Karusėlė;GINTARĖLIS;9116238924;Taip;10;2;0;12
4084;Karusėlė;GINTARĖLIS;6433987745;Ne;6;0;3;9
4085;Karusėlė;GINTARĖLIS;9763326660;Taip;8;0;0;8
4086;Karusėlė;GINTARĖLIS;9479962436;Taip;14;0;0;14
4087;Karusėlė;GINTARĖLIS;6232570825;Taip;6;0;0;6
4088;Karusėlė;SAULUTĖ;5627583683;Taip;11;2;0;13
4089;Karusėlė;SAULUTĖ;5985915835;Taip;7;0;0;7
4090;Karusėlė;SAULUTĖ;2242659064;Taip;0;5;2;7
4091;Karusėlė;SAULUTĖ;5704218177;Taip;0;5;5;10
4092;Karusėlė;SAULUTĖ;5146709341;Taip;0;4;0;4
4093;Karusėlė;SAULUTĖ;7814525717;Taip;6;4;1;11
4094;Karusėlė;SAULUTĖ;9996567374;Taip;0;11;0;11
4095;Karusėlė;SAULUTĖ;8331985564;Taip;0;3;0;3
4096;Karusėlė;SAULUTĖ;9400171357;Taip;13;0;0;13
4097;Karusėlė;SAULUTĖ;9656723409;Taip;10;2;0;12
4098;Karusėlė;SAULUTĖ;5766390337;Taip;0;6;0;6
4099;Karusėlė;SAULUTĖ;4879654321;Taip;0;6;0;6
4100;Karusėlė;SAULUTĖ;5803808409;Taip;4;4;0;8
4101;Karusėlė;SAULUTĖ;2269840705;Taip;2;3;0;5
4102;Karusėlė;SAULUTĖ;3149575456;Taip;5;3;2;10
4103;Karusėlė;SAULUTĖ;5640656442;Taip;5;2;0;7
4104;Karusėlė;SAULUTĖ;9451789237;Taip;0;3;2;5
4105;Karusėlė;SAULUTĖ;9450841251;Taip;6;1;4;11
4106;Karusėlė;SAULUTĖ;6338379641;Taip;5;3;0;8
4107;Karusėlė;SAULUTĖ;8830559511;Taip;5;3;1;9
4108;Karusėlė;SAULUTĖ;3228100488;Taip;14;0;0;14
4109;Karusėlė;TIGRIUKAS;8946147763;Taip;0;5;0;5
4110;Karusėlė;TIGRIUKAS;8076851284;Taip;9;0;0;9
4111;Karusėlė;TIGRIUKAS;4426462711;Taip;0;3;1;4
4112;Karusėlė;TIGRIUKAS;9484773068;Taip;5;0;0;5
4113;Karusėlė;TIGRIUKAS;8678437720;Taip;0;3;0;3
4114;Karusėlė;TIGRIUKAS;1698478530;Taip;10;1;0;11
4115;Karusėlė;TIGRIUKAS;9561892809;Taip;6;0;0;6
4116;Karusėlė;TIGRIUKAS;9726299722;Taip;0;6;0;6
4117;Karusėlė;TIGRIUKAS;1576201225;Taip;17;0;0;17
4118;Karusėlė;TIGRIUKAS;9344514262;Taip;15;0;0;15
4119;Karusėlė;TIGRIUKAS;9065247151;Taip;5;5;1;11
4120;Karusėlė;TIGRIUKAS;7131255599;Taip;13;3;0;16
4121;Karusėlė;TIGRIUKAS;4180604225;Taip;13;3;0;16
4122;Karusėlė;TIGRIUKAS;2397938004;Taip;10;3;0;13
4123;Karusėlė;TIGRIUKAS;3605966015;Taip;12;0;0;12
4124;Karusėlė;TIGRIUKAS;9633656827;Taip;3;0;0;3
4125;Karusėlė;TIGRIUKAS;9252093125;Taip;0;5;2;7
4126;Karusėlė;TIGRIUKAS;9736020767;Taip;7;0;1;8
4127;Karusėlė;TIGRIUKAS;5176597751;Taip;9;0;0;9
4128;Karusėlė;TIGRIUKAS;6656808100;Taip;5;3;0;8
4129;Karusėlė;VAIVORYKŠTĖ;1289442716;Taip;7;0;0;7
4130;Karusėlė;VAIVORYKŠTĖ;9855242602;Taip;7;3;0;10
4131;Karusėlė;VAIVORYKŠTĖ;6546648346;Taip;0;3;0;3
4132;Karusėlė;VAIVORYKŠTĖ;8063412271;Taip;6;4;0;10
4133;Karusėlė;VAIVORYKŠTĖ;9408843254;Taip;3;0;0;3
4134;Karusėlė;VAIVORYKŠTĖ;3514315636;Taip;13;0;0;13
4135;Karusėlė;VAIVORYKŠTĖ;8085919723;Taip;13;0;0;13
4136;Karusėlė;VAIVORYKŠTĖ;5444753290;Taip;0;12;0;12
4137;Karusėlė;VAIVORYKŠTĖ;1581504806;Taip;18;0;0;18
4138;Karusėlė;VAIVORYKŠTĖ;2215367063;Taip;6;4;0;10
4139;Karusėlė;VAIVORYKŠTĖ;6424622497;Taip;12;4;0;16
4140;Karusėlė;VAIVORYKŠTĖ;5855430678;Taip;6;1;0;7
4141;Karusėlė;VAIVORYKŠTĖ;5128774216;Taip;6;4;0;10
4142;Karusėlė;VAIVORYKŠTĖ;1604997207;Ne;0;3;0;3
4143;Karusėlė;VAIVORYKŠTĖ;2757263085;Taip;0;7;2;9
4144;Karusėlė;VAIVORYKŠTĖ;4110024673;Taip;0;5;0;5
4145;Karusėlė;VAIVORYKŠTĖ;6444553698;Ne;6;0;0;6
4146;Karusėlė;VAIVORYKŠTĖ;9400856559;Taip;17;1;0;18
4147;Karusėlė;VAIVORYKŠTĖ;1083786182;Taip;17;1;0;18
4148;Karusėlė;VAIVORYKŠTĖ;5998868204;Taip;0;3;0;3
4149;Karusėlė;VAIVORYKŠTĖ;6734936247;Taip;0;8;0;8
4150;Karusėlė;VAIVORYKŠTĖ;3082636224;Taip;7;3;0;10
4151;Karusėlė;"AUKSINĖ ŽUVELĖ";2993499990;Taip;6;0;0;6
4152;Karusėlė;"AUKSINĖ ŽUVELĖ";3622914118;Taip;0;3;0;3
4153;Karusėlė;"AUKSINĖ ŽUVELĖ";8671884362;Taip;0;4;0;4
4154;Karusėlė;"AUKSINĖ ŽUVELĖ";6341570221;Taip;0;0;4;4
4155;Karusėlė;"AUKSINĖ ŽUVELĖ";2135332292;Taip;7;2;0;9
4156;Karusėlė;"AUKSINĖ ŽUVELĖ";8441520423;Taip;1;0;0;1
4157;Karusėlė;"AUKSINĖ ŽUVELĖ";9463553056;Taip;0;9;0;9
4158;Karusėlė;"AUKSINĖ ŽUVELĖ";4566201460;Taip;0;0;5;5
4159;Karusėlė;"AUKSINĖ ŽUVELĖ";3551143062;Taip;0;1;0;1
4160;Karusėlė;"AUKSINĖ ŽUVELĖ";8257771271;Taip;5;6;0;11
4161;Karusėlė;"AUKSINĖ ŽUVELĖ";7749015193;Taip;0;9;0;9
4162;Karusėlė;"AUKSINĖ ŽUVELĖ";1008205490;Taip;6;0;7;13
4163;Karusėlė;"AUKSINĖ ŽUVELĖ";2450390957;Taip;0;6;0;6
4164;Karusėlė;"AUKSINĖ ŽUVELĖ";4871960780;Taip;16;0;0;16
4165;Karusėlė;"AUKSINĖ ŽUVELĖ";8848085495;Ne;0;13;0;13
4166;Karusėlė;RAMUNĖ;8362740639;Taip;9;2;0;11
4167;Karusėlė;RAMUNĖ;4302662341;Taip;0;13;0;13
4168;Karusėlė;RAMUNĖ;9415377698;Taip;0;4;2;6
4169;Karusėlė;RAMUNĖ;8474027736;Taip;0;11;0;11
4170;Karusėlė;RAMUNĖ;9394220081;Taip;0;4;0;4
4171;Karusėlė;RAMUNĖ;7535451590;Taip;0;4;4;8
4172;Karusėlė;RAMUNĖ;4865727149;Taip;8;5;0;13
4173;Karusėlė;RAMUNĖ;2842034472;Taip;0;2;1;3
4174;Karusėlė;RAMUNĖ;8531556390;Taip;0;4;1;5
4175;Karusėlė;RAMUNĖ;8952114853;Ne;0;4;3;7
4176;Karusėlė;RAMUNĖ;4757820179;Taip;0;4;2;6
4177;Karusėlė;RAMUNĖ;9649615834;Taip;6;3;1;10
4178;Karusėlė;RAMUNĖ;3885475525;Taip;14;3;0;17
4179;Karusėlė;RAMUNĖ;6678283260;Taip;10;2;0;12
4180;Karusėlė;RAMUNĖ;4196250786;Taip;5;1;0;6
4181;Karusėlė;RAMUNĖ;2260731421;Taip;0;4;0;4
4182;Karusėlė;VILKELIS;1412890120;Taip;14;2;0;16
4183;Karusėlė;VILKELIS;4951249625;Taip;0;0;7;7
4184;Karusėlė;VILKELIS;5135054911;Taip;5;0;5;10
4185;Karusėlė;VILKELIS;4130693235;Taip;18;0;0;18
4186;Karusėlė;VILKELIS;8012963667;Taip;0;4;0;4
4187;Karusėlė;VILKELIS;9340167973;Taip;0;2;5;7
4188;Karusėlė;VILKELIS;9985033530;Taip;0;0;3;3
4189;Karusėlė;VILKELIS;6826455161;Taip;0;2;1;3
4190;Karusėlė;VILKELIS;3661917922;Taip;2;0;2;4
4191;Karusėlė;VILKELIS;4211688032;Taip;7;2;0;9
4192;Karusėlė;VILKELIS;2727440190;Taip;0;0;2;2
4193;Karusėlė;VILKELIS;9304912028;Taip;0;0;4;4
4194;Karusėlė;VILKELIS;5802996641;Taip;3;1;3;7
4195;Karusėlė;VILKELIS;2306922755;Taip;0;5;2;7
4196;Karusėlė;VILKELIS;4103816990;Taip;1;0;4;5
4197;Karusėlė;VILKELIS;4325959483;Taip;0;7;0;7
4198;Karusėlė;VILKELIS;3271464159;Taip;13;0;1;14
4199;Karusėlė;VILKELIS;6062361348;Ne;0;7;1;8
4200;Karusėlė;VILKELIS;7501323454;Taip;0;0;3;3
4201;Karusėlė;VILKELIS;3968719760;Taip;0;2;2;4
4202;Karusėlė;VILKELIS;6785226197;Ne;0;2;0;2
4203;Kaštonas;NYKŠTUKAI;7703842464;Taip;5;1;1;7
4204;Kaštonas;NYKŠTUKAI;1262404954;Taip;0;4;0;4
4205;Kaštonas;NYKŠTUKAI;6254250706;Taip;0;4;0;4
4206;Kaštonas;NYKŠTUKAI;8867446698;Taip;11;0;0;11
4207;Kaštonas;NYKŠTUKAI;8775608339;Taip;0;7;0;7
4208;Kaštonas;NYKŠTUKAI;6613837801;Ne;0;3;0;3
4209;Kaštonas;NYKŠTUKAI;6934262510;Taip;0;7;0;7
4210;Kaštonas;NYKŠTUKAI;6589898580;Taip;0;3;0;3
4211;Kaštonas;NYKŠTUKAI;4824511567;Taip;0;4;1;5
4212;Kaštonas;NYKŠTUKAI;4384907654;Taip;0;10;0;10
4213;Kaštonas;NYKŠTUKAI;3961661158;Taip;0;15;0;15
4214;Kaštonas;NYKŠTUKAI;8318869054;Taip;0;7;0;7
4215;Kaštonas;NYKŠTUKAI;2434765663;Taip;3;3;0;6
4216;Kaštonas;NYKŠTUKAI;2178971789;Taip;0;3;0;3
4217;Kaštonas;NYKŠTUKAI;4444087861;Taip;6;0;1;7
4218;Kaštonas;NYKŠTUKAI;9379171183;Taip;5;0;1;6
4219;Kaštonas;NYKŠTUKAI;9014726465;Taip;0;10;0;10
4220;Kaštonas;NYKŠTUKAI;2361839733;Taip;6;10;0;16
4221;Kaštonas;NYKŠTUKAI;3383390078;Taip;0;1;0;1
4222;Kaštonas;DRUGELIAI;8486955652;Taip;0;3;0;3
4223;Kaštonas;DRUGELIAI;2106924435;Taip;0;5;0;5
4224;Kaštonas;DRUGELIAI;8483888152;Taip;0;4;0;4
4225;Kaštonas;DRUGELIAI;7408901858;Taip;5;3;0;8
4226;Kaštonas;DRUGELIAI;5099098185;Taip;0;2;0;2
4227;Kaštonas;DRUGELIAI;8582453109;Taip;0;10;0;10
4228;Kaštonas;DRUGELIAI;2832688622;Ne;7;5;0;12
4229;Kaštonas;DRUGELIAI;9061158412;Ne;7;5;0;12
4230;Kaštonas;DRUGELIAI;9168456496;Taip;0;4;0;4
4231;Kaštonas;DRUGELIAI;5884427036;Taip;0;6;0;6
4232;Kaštonas;DRUGELIAI;1141693073;Taip;0;5;0;5
4233;Kaštonas;DRUGELIAI;6251564828;Taip;0;5;0;5
4234;Kaštonas;DRUGELIAI;1249299633;Taip;0;7;0;7
4235;Kaštonas;DRUGELIAI;5969052108;Taip;6;0;0;6
4236;Kaštonas;DRUGELIAI;8166925991;Taip;0;11;0;11
4237;Kaštonas;DRUGELIAI;4215759647;Taip;2;10;0;12
4238;Kaštonas;DRUGELIAI;6114301692;Taip;0;6;0;6
4239;Kaštonas;DRUGELIAI;5307755844;Taip;0;4;0;4
4240;Kaštonas;DRUGELIAI;9985164505;Taip;0;3;0;3
4241;Kaštonas;DRUGELIAI;2417951642;Taip;0;3;0;3
4242;Kaštonas;DRUGELIAI;8257643251;Taip;5;13;0;18
4243;Kaštonas;KIŠKUČIAI;2020612346;Taip;0;4;0;4
4244;Kaštonas;KIŠKUČIAI;6585977073;Taip;12;3;0;15
4245;Kaštonas;KIŠKUČIAI;1761520786;Taip;5;3;0;8
4246;Kaštonas;KIŠKUČIAI;9298372326;Ne;8;0;0;8
4247;Kaštonas;KIŠKUČIAI;9778140363;Ne;5;6;0;11
4248;Kaštonas;KIŠKUČIAI;8250964197;Taip;0;6;0;6
4249;Kaštonas;KIŠKUČIAI;7290414209;Taip;0;10;0;10
4250;Kaštonas;KIŠKUČIAI;9356018629;Taip;0;1;0;1
4251;Kaštonas;KIŠKUČIAI;4115242811;Taip;13;3;0;16
4252;Kaštonas;KIŠKUČIAI;1684641447;Taip;5;3;0;8
4253;Kaštonas;KIŠKUČIAI;1207372235;Ne;6;4;0;10
4254;Kaštonas;KIŠKUČIAI;4570064071;Taip;5;2;0;7
4255;Kaštonas;KIŠKUČIAI;4020980625;Taip;5;1;0;6
4256;Kaštonas;KIŠKUČIAI;2898327157;Taip;0;1;0;1
4257;Kaštonas;KIŠKUČIAI;9320223622;Taip;2;6;0;8
4258;Kaštonas;KIŠKUČIAI;3544696101;Taip;0;7;0;7
4259;Kaštonas;BITUTĖS;7946379086;Taip;0;0;1;1
4260;Kaštonas;BITUTĖS;9285927858;Taip;0;7;0;7
4261;Kaštonas;BITUTĖS;5328263421;Taip;3;0;0;3
4262;Kaštonas;BITUTĖS;4033866425;Taip;0;6;0;6
4263;Kaštonas;BITUTĖS;8275673303;Taip;0;4;0;4
4264;Kaštonas;BITUTĖS;1614180834;Taip;3;3;2;8
4265;Kaštonas;BITUTĖS;6711295699;Taip;5;3;0;8
4266;Kaštonas;BITUTĖS;2877124424;Taip;0;7;0;7
4267;Kaštonas;BITUTĖS;1031628633;Taip;0;1;0;1
4268;Kaštonas;BITUTĖS;4551111709;Taip;0;1;0;1
4269;Kaštonas;BITUTĖS;7508357392;Taip;0;3;0;3
4270;Kaštonas;BITUTĖS;8906976150;Taip;0;5;0;5
4271;Kaštonas;BITUTĖS;8151333699;Taip;0;5;0;5
4272;Kaštonas;BITUTĖS;3649329598;Taip;0;10;0;10
4273;Kaštonas;BITUTĖS;8214699601;Taip;0;7;0;7
4274;Kaštonas;BITUTĖS;8152577445;Taip;0;2;2;4
4275;Kaštonas;BITUTĖS;7291448857;Taip;2;5;0;7
4276;Kaštonas;BITUTĖS;4837002666;Taip;10;3;0;13
4277;Kaštonas;BITUTĖS;2701042709;Taip;5;5;0;10
4278;Kaštonas;BITUTĖS;6175014441;Taip;4;2;0;6
4279;Kaštonas;BITUTĖS;1748975865;Taip;6;2;0;8
4280;Kaštonas;MEŠKIUKAI;5350239917;Taip;0;11;0;11
4281;Kaštonas;MEŠKIUKAI;7956422880;Taip;0;3;0;3
4282;Kaštonas;MEŠKIUKAI;3554337770;Taip;0;2;1;3
4283;Kaštonas;MEŠKIUKAI;7911007041;Taip;0;10;0;10
4284;Kaštonas;MEŠKIUKAI;2125410714;Taip;0;3;0;3
4285;Kaštonas;MEŠKIUKAI;6289073634;Taip;0;1;0;1
4286;Kaštonas;MEŠKIUKAI;7553024183;Taip;0;6;0;6
4287;Kaštonas;MEŠKIUKAI;4616084852;Taip;0;3;0;3
4288;Kaštonas;MEŠKIUKAI;1801371129;Taip;0;3;0;3
4289;Kaštonas;MEŠKIUKAI;5157500600;Ne;4;4;0;8
4290;Kaštonas;MEŠKIUKAI;6606094891;Taip;8;2;0;10
4291;Kaštonas;MEŠKIUKAI;1364391105;Taip;0;6;0;6
4292;Kaštonas;MEŠKIUKAI;6967725663;Taip;0;8;0;8
4293;Kaštonas;MEŠKIUKAI;5153948802;Ne;0;3;0;3
4294;Kaštonas;MEŠKIUKAI;4308169582;Taip;0;3;1;4
4295;Kaštonas;MEŠKIUKAI;8797584508;Taip;10;1;0;11
4296;Kaštonas;MEŠKIUKAI;9965517774;Taip;0;8;0;8
4297;Kaštonas;MEŠKIUKAI;7138581709;Taip;0;8;0;8
4298;Kaštonas;MEŠKIUKAI;8446233414;Taip;11;5;0;16
4299;Kaštonas;MEŠKIUKAI;1196590128;Taip;28;0;0;28
4300;Kaštonas;BORUŽĖLĖS;1501441973;Ne;7;3;0;10
4301;Kaštonas;BORUŽĖLĖS;1612086010;Taip;18;0;0;18
4302;Kaštonas;BORUŽĖLĖS;9034859988;Taip;8;3;0;11
4303;Kaštonas;BORUŽĖLĖS;9249007247;Taip;5;5;0;10
4304;Kaštonas;BORUŽĖLĖS;2057499534;Taip;13;0;0;13
4305;Kaštonas;BORUŽĖLĖS;6896372095;Taip;0;4;0;4
4306;Kaštonas;BORUŽĖLĖS;1976138680;Taip;0;4;0;4
4307;Kaštonas;BORUŽĖLĖS;9807554365;Taip;0;10;0;10
4308;Kaštonas;BORUŽĖLĖS;4708114402;Taip;0;5;0;5
4309;Kaštonas;BORUŽĖLĖS;7992154554;Taip;5;4;0;9
4310;Kaštonas;BORUŽĖLĖS;4641535612;Taip;0;9;0;9
4311;Kaštonas;BORUŽĖLĖS;7383219978;Taip;0;4;0;4
4312;Kaštonas;BORUŽĖLĖS;3251132542;Taip;5;3;0;8
4313;Kaštonas;BORUŽĖLĖS;6425908247;Taip;5;2;0;7
4314;Kaštonas;BORUŽĖLĖS;3860613494;Taip;13;0;0;13
4315;Kaštonas;BORUŽĖLĖS;9317649996;Taip;13;2;0;15
4316;Kaštonas;BORUŽĖLĖS;5948707303;Taip;16;0;0;16
4317;Kaštonas;BORUŽĖLĖS;7698074598;Taip;16;0;0;16
4318;Kaštonas;BORUŽĖLĖS;6749679348;Taip;7;3;0;10
4319;Kaštonas;BORUŽĖLĖS;5060824071;Taip;0;1;0;1
4320;"Krivūlė (Lydos g. 5)";SPINDULIUKAI;3233000497;Taip;6;0;4;10
4321;"Krivūlė (Lydos g. 5)";SPINDULIUKAI;2191720088;Taip;6;0;4;10
4322;"Krivūlė (Lydos g. 5)";SPINDULIUKAI;3913058095;Taip;0;0;4;4
4323;"Krivūlė (Lydos g. 5)";SPINDULIUKAI;1840809151;Taip;6;0;3;9
4324;"Krivūlė (Lydos g. 5)";SPINDULIUKAI;7335245963;Taip;3;0;3;6
4325;"Krivūlė (Lydos g. 5)";SPINDULIUKAI;5802739148;Taip;0;9;2;11
4326;"Krivūlė (Lydos g. 5)";SPINDULIUKAI;5667934115;Taip;5;3;0;8
4327;"Krivūlė (Lydos g. 5)";SPINDULIUKAI;8348288864;Taip;0;0;3;3
4328;"Krivūlė (Lydos g. 5)";SPINDULIUKAI;7155162698;Taip;0;3;9;12
4329;"Krivūlė (Lydos g. 5)";SPINDULIUKAI;1151179495;Taip;0;0;3;3
4330;"Krivūlė (Lydos g. 5)";SPINDULIUKAI;9320613086;Taip;10;0;7;17
4331;"Krivūlė (Lydos g. 5)";SPINDULIUKAI;6632875947;Taip;1;4;0;5
4332;"Krivūlė (Lydos g. 5)";SPINDULIUKAI;4750075323;Taip;2;0;2;4
4333;"Krivūlė (Lydos g. 5)";SPINDULIUKAI;7199431924;Taip;0;1;1;2
4334;"Krivūlė (Lydos g. 5)";SPINDULIUKAI;3852793979;Taip;0;6;4;10
4335;"Krivūlė (Lydos g. 5)";SPINDULIUKAI;3184820008;Taip;0;0;10;10
4336;"Krivūlė (Lydos g. 5)";SPINDULIUKAI;7149268223;Taip;0;0;7;7
4337;"Krivūlė (Lydos g. 5)";BORUŽĖLĖS;3605506478;Taip;0;7;1;8
4338;"Krivūlė (Lydos g. 5)";BORUŽĖLĖS;4896656209;Taip;0;7;1;8
4339;"Krivūlė (Lydos g. 5)";BORUŽĖLĖS;4845515196;Taip;0;4;0;4
4340;"Krivūlė (Lydos g. 5)";BORUŽĖLĖS;5676562063;Taip;4;0;4;8
4341;"Krivūlė (Lydos g. 5)";BORUŽĖLĖS;6935969502;Taip;0;0;5;5
4342;"Krivūlė (Lydos g. 5)";BORUŽĖLĖS;4972360440;Taip;0;0;1;1
4343;"Krivūlė (Lydos g. 5)";BORUŽĖLĖS;7318064702;Taip;0;3;0;3
4344;"Krivūlė (Lydos g. 5)";BORUŽĖLĖS;3912620138;Taip;0;0;4;4
4345;"Krivūlė (Lydos g. 5)";BORUŽĖLĖS;3246787504;Taip;0;0;3;3
4346;"Krivūlė (Lydos g. 5)";BORUŽĖLĖS;5531566792;Taip;0;7;3;10
4347;"Krivūlė (Lydos g. 5)";BORUŽĖLĖS;2386053480;Taip;18;0;0;18
4348;"Krivūlė (Lydos g. 5)";BORUŽĖLĖS;8586287004;Taip;7;0;0;7
4349;"Krivūlė (Lydos g. 5)";BORUŽĖLĖS;4540069843;Taip;0;3;4;7
4350;"Krivūlė (Lydos g. 5)";BORUŽĖLĖS;4297876008;Taip;0;3;6;9
4351;"Krivūlė (Lydos g. 5)";BORUŽĖLĖS;2138125571;Taip;0;3;0;3
4352;"Krivūlė (Lydos g. 5)";BORUŽĖLĖS;4177660973;Taip;0;4;0;4
4353;"Krivūlė (Lydos g. 5)";BORUŽĖLĖS;2711010212;Taip;4;14;0;18
4354;"Krivūlė (Lydos g. 5)";BORUŽĖLĖS;4025821636;Taip;0;0;1;1
4355;"Krivūlė (Lydos g. 5)";BORUŽĖLĖS;7781918674;Taip;0;3;0;3
4356;"Krivūlė (Lydos g. 5)";BORUŽĖLĖS;1987255206;Taip;0;0;3;3
4357;"Krivūlė (Lydos g. 5)";BORUŽĖLĖS;7025398689;Taip;11;0;0;11
4358;"Krivūlė (Lydos g. 5)";DRUGELIŲ;5966543639;Taip;0;0;3;3
4359;"Krivūlė (Lydos g. 5)";DRUGELIŲ;6004925249;Taip;0;3;0;3
4360;"Krivūlė (Lydos g. 5)";DRUGELIŲ;5818988913;Taip;10;7;0;17
4361;"Krivūlė (Lydos g. 5)";DRUGELIŲ;7873123757;Taip;0;4;1;5
4362;"Krivūlė (Lydos g. 5)";DRUGELIŲ;19674882649;Taip;0;3;1;4
4363;"Krivūlė (Lydos g. 5)";DRUGELIŲ;2903062788;Taip;0;0;4;4
4364;"Krivūlė (Lydos g. 5)";DRUGELIŲ;10005041572;Taip;0;3;0;3
4365;"Krivūlė (Lydos g. 5)";DRUGELIŲ;37502093836;Taip;0;3;1;4
4366;"Krivūlė (Lydos g. 5)";DRUGELIŲ;83840444975;Taip;0;3;1;4
4367;"Krivūlė (Lydos g. 5)";DRUGELIŲ;2654066358;Taip;5;3;1;9
4368;"Krivūlė (Lydos g. 5)";DRUGELIŲ;2109315338;Taip;0;0;6;6
4369;"Krivūlė (Lydos g. 5)";DRUGELIŲ;6861483854;Taip;14;0;0;14
4370;"Krivūlė (Lydos g. 5)";DRUGELIŲ;1515185307;Taip;0;4;2;6
4371;"Krivūlė (Lydos g. 5)";DRUGELIŲ;97398901468;Taip;0;0;2;2
4372;"Krivūlė (Lydos g. 5)";DRUGELIŲ;9267414141;Taip;3;3;0;6
4373;"Krivūlė (Lydos g. 5)";DRUGELIŲ;1217856292;Taip;3;0;3;6
4374;"Krivūlė (Lydos g. 5)";DRUGELIŲ;9311270695;Taip;0;1;1;2
4375;"Krivūlė (Lydos g. 5)";DRUGELIŲ;73760357378;Taip;0;3;0;3
4376;"Krivūlė (Lydos g. 5)";DRUGELIŲ;6753080815;Taip;0;3;2;5
4377;"Krivūlė (Lydos g. 5)";DRUGELIŲ;4261133734;Taip;0;3;0;3
4378;"Krivūlė (Lydos g. 5)";DRUGELIŲ;6429160371;Taip;0;0;5;5
4379;"Krivūlė (Lydos g. 5)";DRUGELIŲ;3924127476;Taip;0;4;0;4
4380;"Krivūlė (Lydos g. 5)";"BITUTĖS (VALDOFRO)";18486357195;Taip;0;3;1;4
4381;"Krivūlė (Lydos g. 5)";"BITUTĖS (VALDOFRO)";3769812444;Taip;5;3;0;8
4382;"Krivūlė (Lydos g. 5)";"BITUTĖS (VALDOFRO)";5128760019;Taip;5;3;0;8
4383;"Krivūlė (Lydos g. 5)";"BITUTĖS (VALDOFRO)";1851097789;Taip;6;0;0;6
4384;"Krivūlė (Lydos g. 5)";"BITUTĖS (VALDOFRO)";7789248863;Taip;0;3;0;3
4385;"Krivūlė (Lydos g. 5)";"BITUTĖS (VALDOFRO)";2647149927;Taip;0;3;0;3
4386;"Krivūlė (Lydos g. 5)";"BITUTĖS (VALDOFRO)";5113297248;Taip;0;3;6;9
4387;"Krivūlė (Lydos g. 5)";"BITUTĖS (VALDOFRO)";9632352765;Taip;0;3;0;3
4388;"Krivūlė (Lydos g. 5)";"BITUTĖS (VALDOFRO)";5405660104;Taip;3;3;0;6
4389;"Krivūlė (Lydos g. 5)";"BITUTĖS (VALDOFRO)";8834855616;Taip;0;5;2;7
4390;"Krivūlė (Lydos g. 5)";"BITUTĖS (VALDOFRO)";3655576855;Taip;0;3;1;4
4391;"Krivūlė (Lydos g. 5)";"BITUTĖS (VALDOFRO)";1561180871;Taip;0;9;0;9
4392;"Krivūlė (Lydos g. 5)";"BITUTĖS (VALDOFRO)";9702372816;Taip;4;3;0;7
4393;"Krivūlė (Lydos g. 5)";"BITUTĖS (VALDOFRO)";4619224314;Taip;0;18;0;18
4394;"Krivūlė (Lydos g. 5)";"BITUTĖS (VALDOFRO)";8105688948;Taip;0;0;5;5
4395;"Krivūlė (Lydos g. 5)";"BITUTĖS (VALDOFRO)";1932209134;Taip;0;0;7;7
4396;"Krivūlė (Lydos g. 5)";"BITUTĖS (VALDOFRO)";7768827505;Taip;0;0;5;5
4397;"Krivūlė (Lydos g. 5)";"BITUTĖS (VALDOFRO)";7714519095;Taip;5;3;0;8
4398;"Krivūlė (Lydos g. 5)";"BITUTĖS (VALDOFRO)";9409899522;Taip;0;0;1;1
4399;"Krivūlė (Lydos g. 5)";"BITUTĖS (VALDOFRO)";6365743037;Taip;0;3;3;6
4400;"Krivūlė (Lydos g. 5)";"BITUTĖS (VALDOFRO)";6217494808;Taip;0;4;2;6
4401;"Krivūlė (Lydos g. 5)";"BITUTĖS (VALDOFRO)";8748668583;Taip;0;0;5;5
4402;"Krivūlė (Lydos g. 5)";EŽIUKAI;8042185027;Taip;6;0;1;7
4403;"Krivūlė (Lydos g. 5)";EŽIUKAI;1256819206;Taip;0;0;4;4
4404;"Krivūlė (Lydos g. 5)";EŽIUKAI;3616024832;Taip;0;1;0;1
4405;"Krivūlė (Lydos g. 5)";EŽIUKAI;7242596817;Taip;3;0;0;3
4406;"Krivūlė (Lydos g. 5)";EŽIUKAI;5369083173;Taip;14;0;4;18
4407;"Krivūlė (Lydos g. 5)";EŽIUKAI;9051038248;Taip;4;0;3;7
4408;"Krivūlė (Lydos g. 5)";EŽIUKAI;3144577262;Taip;5;0;6;11
4409;"Krivūlė (Lydos g. 5)";EŽIUKAI;1898389557;Taip;7;0;5;12
4410;"Krivūlė (Lydos g. 5)";EŽIUKAI;2607716072;Taip;5;0;4;9
4411;"Krivūlė (Lydos g. 5)";EŽIUKAI;6830712749;Taip;0;0;6;6
4412;"Krivūlė (Lydos g. 5)";EŽIUKAI;3836712448;Taip;0;0;2;2
4413;"Krivūlė (Lydos g. 5)";EŽIUKAI;8873132189;Taip;0;0;6;6
4414;"Krivūlė (Lydos g. 5)";EŽIUKAI;2430372719;Taip;0;1;0;1
4415;"Krivūlė (Lydos g. 5)";EŽIUKAI;1622229289;Taip;0;3;6;9
4416;"Krivūlė (Lydos g. 5)";EŽIUKAI;2157856704;Taip;0;0;4;4
4417;"Krivūlė (Lydos g. 5)";NYKŠTUKAI;9820383193;Taip;0;3;0;3
4418;"Krivūlė (Lydos g. 5)";NYKŠTUKAI;2742783991;Taip;0;18;0;18
4419;"Krivūlė (Lydos g. 5)";NYKŠTUKAI;9401810791;Taip;7;0;0;7
4420;"Krivūlė (Lydos g. 5)";NYKŠTUKAI;8713384668;Taip;12;0;6;18
4421;"Krivūlė (Lydos g. 5)";NYKŠTUKAI;9678890051;Taip;0;0;2;2
4422;"Krivūlė (Lydos g. 5)";NYKŠTUKAI;9553953446;Taip;0;0;7;7
4423;"Krivūlė (Lydos g. 5)";NYKŠTUKAI;5268832682;Taip;8;0;1;9
4424;"Krivūlė (Lydos g. 5)";NYKŠTUKAI;8767554721;Taip;0;1;1;2
4425;"Krivūlė (Lydos g. 5)";NYKŠTUKAI;9529242858;Taip;3;0;3;6
4426;"Krivūlė (Lydos g. 5)";NYKŠTUKAI;8898023612;Taip;11;0;0;11
4427;"Krivūlė (Lydos g. 5)";NYKŠTUKAI;5768244312;Taip;0;2;4;6
4428;"Krivūlė (Lydos g. 5)";NYKŠTUKAI;5870153336;Taip;0;3;4;7
4429;"Krivūlė (Lydos g. 5)";NYKŠTUKAI;7540940063;Taip;0;3;0;3
4430;"Krivūlė (Lydos g. 5)";NYKŠTUKAI;7262017017;Taip;0;1;1;2
4431;"Krivūlė (Lydos g. 5)";NYKŠTUKAI;9773092651;Taip;1;0;2;3
4432;"Krivūlė (Lydos g. 5)";NYKŠTUKAI;6548893885;Taip;0;3;2;5
4433;"Krivūlė (Lydos g. 5)";NYKŠTUKAI;8674468359;Taip;0;18;0;18
4434;"Krivūlė (Lydos g. 5)";NYKŠTUKAI;8047735389;Taip;0;2;0;2
4435;Kodėlčiukas;Saulutės;6517880481;Taip;0;0;1;1
4436;Kodėlčiukas;Saulutės;1725624698;Taip;7;3;1;11
4437;Kodėlčiukas;Saulutės;8393893311;Taip;0;3;1;4
4438;Kodėlčiukas;Saulutės;7509476161;Taip;3;0;0;3
4439;Kodėlčiukas;Saulutės;7327247516;Taip;5;0;0;5
4440;Kodėlčiukas;Saulutės;1645680526;Taip;6;5;0;11
4441;Kodėlčiukas;Saulutės;8992265000;Taip;6;0;0;6
4442;Kodėlčiukas;Saulutės;6285018663;Taip;0;5;0;5
4443;Kodėlčiukas;Saulutės;1033969800;Taip;0;4;0;4
4444;Kodėlčiukas;Saulutės;2433094435;Ne;0;0;1;1
4445;Kodėlčiukas;Saulutės;9042404309;Taip;10;3;5;18
4446;Kodėlčiukas;Saulutės;3276075664;Taip;0;0;1;1
4447;Kodėlčiukas;Saulutės;7611485881;Taip;0;4;0;4
4448;Kodėlčiukas;Saulutės;7561763602;Taip;7;0;4;11
4449;Kodėlčiukas;Saulutės;2289687766;Taip;0;0;7;7
4450;Kodėlčiukas;Saulutės;6476445296;Taip;0;3;1;4
4451;Kodėlčiukas;Saulutės;1992569595;Ne;5;3;1;9
4452;Kodėlčiukas;Saulutės;9527296531;Taip;0;0;8;8
4453;Kodėlčiukas;Saulutės;8070400563;Taip;0;0;4;4
4454;Kodėlčiukas;Saulutės;8447045958;Taip;0;0;6;6
4455;Kodėlčiukas;Saulutės;2542104903;Taip;0;6;0;6
4456;Kodėlčiukas;Nežiniukai;6045564826;Taip;0;4;0;4
4457;Kodėlčiukas;Nežiniukai;7282579315;Taip;13;0;0;13
4458;Kodėlčiukas;Nežiniukai;6905424567;Taip;0;0;4;4
4459;Kodėlčiukas;Nežiniukai;5443377251;Taip;0;3;1;4
4460;Kodėlčiukas;Nežiniukai;3150006441;Taip;0;0;3;3
4461;Kodėlčiukas;Nežiniukai;7626940433;Taip;0;4;0;4
4462;Kodėlčiukas;Nežiniukai;9803206596;Taip;0;0;6;6
4463;Kodėlčiukas;Nežiniukai;4917910801;Ne;0;3;0;3
4464;Kodėlčiukas;Nežiniukai;3473981974;Taip;0;0;1;1
4465;Kodėlčiukas;Nežiniukai;4038168647;Taip;0;3;1;4
4466;Kodėlčiukas;Nežiniukai;8378295683;Taip;7;0;5;12
4467;Kodėlčiukas;Nežiniukai;6000831611;Taip;0;3;1;4
4468;Kodėlčiukas;Nežiniukai;7286497455;Taip;0;0;8;8
4469;Kodėlčiukas;Nežiniukai;1603752483;Taip;0;0;6;6
4470;Kodėlčiukas;Nežiniukai;6074758814;Ne;8;4;0;12
4471;Kodėlčiukas;Nežiniukai;1699358514;Ne;2;2;0;4
4472;Kodėlčiukas;Nežiniukai;1302383608;Taip;0;0;5;5
4473;Kodėlčiukas;Nežiniukai;1160612316;Taip;0;0;7;7
4474;Kodėlčiukas;Nežiniukai;3470151604;Taip;0;0;6;6
4475;Kodėlčiukas;Nežiniukai;5729391456;Taip;0;13;4;17
4476;Kodėlčiukas;Gintarėliai;2560864315;Taip;3;3;0;6
4477;Kodėlčiukas;Gintarėliai;58406224468;Taip;0;3;4;7
4478;Kodėlčiukas;Gintarėliai;1485012710;Taip;0;0;1;1
4479;Kodėlčiukas;Gintarėliai;20084022099;Taip;4;0;1;5
4480;Kodėlčiukas;Gintarėliai;9686497547;Taip;0;3;0;3
4481;Kodėlčiukas;Gintarėliai;4884104023;Taip;0;3;0;3
4482;Kodėlčiukas;Gintarėliai;1632458573;Taip;0;3;0;3
4483;Kodėlčiukas;Gintarėliai;9332136116;Taip;0;3;0;3
4484;Kodėlčiukas;Gintarėliai;4944791330;Taip;0;2;0;2
4485;Kodėlčiukas;Gintarėliai;8219424737;Taip;0;2;1;3
4486;Kodėlčiukas;Gintarėliai;4849314647;Taip;0;3;0;3
4487;Kodėlčiukas;Gintarėliai;5202375085;Taip;0;0;1;1
4488;Kodėlčiukas;Gintarėliai;3758606327;Taip;0;3;2;5
4489;Kodėlčiukas;Gintarėliai;5093139270;Taip;0;3;2;5
4490;Kodėlčiukas;Gintarėliai;4738357524;Taip;0;3;0;3
4491;Kodėlčiukas;Gintarėliai;8873629130;Taip;10;3;0;13
4492;Kodėlčiukas;Gintarėliai;1190408818;Taip;0;3;3;6
4493;Kodėlčiukas;Gintarėliai;2162480212;Taip;0;1;0;1
4494;Kodėlčiukas;Gintarėliai;6764015170;Taip;7;6;0;13
4495;Kodėlčiukas;Gintarėliai;6248137523;Taip;0;3;0;3
4496;Kodėlčiukas;Gintarėliai;8606551477;Taip;7;0;0;7
4497;Kodėlčiukas;Šnekučiai;1844016431;Taip;0;3;0;3
4498;Kodėlčiukas;Šnekučiai;1550915654;Taip;0;5;1;6
4499;Kodėlčiukas;Šnekučiai;1935757837;Taip;5;0;0;5
4500;Kodėlčiukas;Šnekučiai;41123326737;Taip;0;3;0;3
4501;Kodėlčiukas;Šnekučiai;8114859362;Taip;0;16;0;16
4502;Kodėlčiukas;Šnekučiai;1666743304;Taip;0;2;0;2
4503;Kodėlčiukas;Šnekučiai;1432342305;Taip;0;3;1;4
4504;Kodėlčiukas;Šnekučiai;9178209049;Taip;8;0;0;8
4505;Kodėlčiukas;Šnekučiai;5988863934;Taip;0;7;0;7
4506;Kodėlčiukas;Šnekučiai;76164689333;Taip;0;2;2;4
4507;Kodėlčiukas;Šnekučiai;5386820408;Taip;0;4;0;4
4508;Kodėlčiukas;Šnekučiai;6194726931;Taip;0;7;0;7
4509;Kodėlčiukas;Šnekučiai;7074381835;Taip;0;4;0;4
4510;Kodėlčiukas;Šnekučiai;2988674717;Ne;0;4;3;7
4511;Kodėlčiukas;Šnekučiai;4273202718;Taip;0;3;1;4
4512;Kodėlčiukas;Šnekučiai;2244326972;Taip;4;0;0;4
4513;Kodėlčiukas;Šnekučiai;6761903865;Ne;0;4;0;4
4514;Kodėlčiukas;Šnekučiai;3778271049;Taip;0;5;1;6
4515;Kodėlčiukas;Šnekučiai;7647582987;Ne;0;3;0;3
4516;Kodėlčiukas;Šnekučiai;7510273691;Taip;0;4;1;5
4517;Kodėlčiukas;Pabiručiai;9278139998;Taip;0;2;0;2
4518;Kodėlčiukas;Pabiručiai;6008027505;Taip;0;3;1;4
4519;Kodėlčiukas;Pabiručiai;5894631257;Ne;3;0;0;3
4520;Kodėlčiukas;Pabiručiai;6065858518;Taip;2;1;0;3
4521;Kodėlčiukas;Pabiručiai;9480926599;Taip;1;3;0;4
4522;Kodėlčiukas;Pabiručiai;9511144369;Taip;0;0;7;7
4523;Kodėlčiukas;Pabiručiai;7246943802;Taip;0;3;1;4
4524;Kodėlčiukas;Pabiručiai;8189938439;Taip;0;0;1;1
4525;Kodėlčiukas;Pabiručiai;5587200800;Taip;5;0;5;10
4526;Kodėlčiukas;Pabiručiai;1433623973;Taip;4;5;0;9
4527;Kodėlčiukas;Pabiručiai;1087808091;Ne;0;3;0;3
4528;Kodėlčiukas;Pabiručiai;7570122834;Taip;0;3;0;3
4529;Kodėlčiukas;Pabiručiai;5359866071;Taip;0;7;0;7
4530;Kodėlčiukas;Pabiručiai;5801430256;Taip;0;7;0;7
4531;Kodėlčiukas;Pabiručiai;7455949617;Taip;0;2;0;2
4532;Kodėlčiukas;Pabiručiai;1039982141;Taip;3;0;0;3
4533;Kodėlčiukas;Pabiručiai;4507928289;Taip;0;0;1;1
4534;Kodėlčiukas;Pabiručiai;9830842598;Taip;0;0;8;8
4535;Kodėlčiukas;Pabiručiai;3882838712;Taip;0;0;3;3
4536;Kodėlčiukas;Pabiručiai;8635107742;Taip;0;0;3;3
4537;Kodėlčiukas;Smalsučiai;7630180473;Taip;0;4;4;8
4538;Kodėlčiukas;Smalsučiai;8140940288;Taip;5;2;0;7
4539;Kodėlčiukas;Smalsučiai;7246243975;Taip;0;4;0;4
4540;Kodėlčiukas;Smalsučiai;1600501494;Taip;0;4;0;4
4541;Kodėlčiukas;Smalsučiai;3880019350;Taip;12;0;0;12
4542;Kodėlčiukas;Smalsučiai;4818678923;Taip;5;3;1;9
4543;Kodėlčiukas;Smalsučiai;9589692031;Taip;15;3;0;18
4544;Kodėlčiukas;Smalsučiai;1906128091;Taip;7;3;0;10
4545;Kodėlčiukas;Smalsučiai;8302606312;Taip;6;2;0;8
4546;Kodėlčiukas;Smalsučiai;9460792167;Taip;0;3;0;3
4547;Kodėlčiukas;Smalsučiai;7324303899;Taip;0;3;0;3
4548;Kodėlčiukas;Smalsučiai;9794875862;Taip;0;3;6;9
4549;Kodėlčiukas;Smalsučiai;9528997865;Taip;0;7;0;7
4550;Kodėlčiukas;Smalsučiai;1919722425;Taip;0;3;2;5
4551;Kodėlčiukas;Smalsučiai;8879977943;Taip;0;5;0;5
4552;Kodėlčiukas;Smalsučiai;8647609373;Taip;0;9;0;9
4553;Kodėlčiukas;Smalsučiai;2062878300;Taip;3;3;1;7
4554;Kodėlčiukas;Smalsučiai;6950802941;Taip;5;3;0;8
4555;Kodėlčiukas;Smalsučiai;1233880820;Taip;0;3;0;3
4556;Kodėlčiukas;Giliukai;9754425363;Taip;0;3;1;4
4557;Kodėlčiukas;Giliukai;5587782917;Taip;6;3;0;9
4558;Kodėlčiukas;Giliukai;8100861190;Taip;0;7;0;7
4559;Kodėlčiukas;Giliukai;7639341503;Taip;0;3;0;3
4560;Kodėlčiukas;Giliukai;8017465692;Taip;0;4;0;4
4561;Kodėlčiukas;Giliukai;7937365710;Taip;13;0;0;13
4562;Kodėlčiukas;Giliukai;1937181137;Taip;0;0;2;2
4563;Kodėlčiukas;Giliukai;9733831323;Taip;0;0;3;3
4564;Kodėlčiukas;Giliukai;7007386353;Taip;7;4;0;11
4565;Kodėlčiukas;Giliukai;9721353724;Taip;5;3;0;8
4566;Kodėlčiukas;Giliukai;2943146610;Taip;0;0;3;3
4567;Kodėlčiukas;Giliukai;5573845415;Taip;0;0;1;1
4568;Kodėlčiukas;Giliukai;2122779530;Taip;0;3;0;3
4569;Kodėlčiukas;Giliukai;8785157050;Taip;9;7;0;16
4570;Kodėlčiukas;Giliukai;5770748359;Taip;0;6;0;6
4571;Kodėlčiukas;Giliukai;9992204262;Taip;5;0;3;8
4572;Kodėlčiukas;Giliukai;6643473339;Taip;0;5;0;5
4573;Kodėlčiukas;Giliukai;8107869258;Taip;0;0;2;2
4574;Kodėlčiukas;Giliukai;5909222351;Taip;0;0;1;1
4575;Kodėlčiukas;Giliukai;3130715310;Taip;0;7;0;7
4576;Kodėlčiukas;Giliukai;3686259290;Taip;0;0;6;6
4577;Kodėlčiukas;Gudručiai;1191430672;Taip;3;1;0;4
4578;Kodėlčiukas;Gudručiai;6988515253;Taip;0;10;0;10
4579;Kodėlčiukas;Gudručiai;3385551650;Taip;3;3;2;8
4580;Kodėlčiukas;Gudručiai;7318908956;Taip;5;1;1;7
4581;Kodėlčiukas;Gudručiai;9865803714;Taip;0;0;1;1
4582;Kodėlčiukas;Gudručiai;7430239198;Taip;0;0;3;3
4583;Kodėlčiukas;Gudručiai;8400610717;Taip;5;0;6;11
4584;Kodėlčiukas;Gudručiai;7326475644;Taip;4;0;0;4
4585;Kodėlčiukas;Gudručiai;1801366890;Taip;3;0;2;5
4586;Kodėlčiukas;Gudručiai;9483378853;Taip;0;7;0;7
4587;Kodėlčiukas;Gudručiai;8890987483;Taip;0;0;3;3
4588;Kodėlčiukas;Gudručiai;4687333060;Taip;3;5;0;8
4589;Kodėlčiukas;Gudručiai;1491160730;Taip;0;0;1;1
4590;Kodėlčiukas;Gudručiai;4543838852;Taip;3;0;4;7
4591;Kodėlčiukas;Gudručiai;2216791610;Taip;7;0;1;8
4592;Kodėlčiukas;Gudručiai;2987907651;Taip;0;3;0;3
4593;Kodėlčiukas;Gudručiai;9028856983;Taip;10;0;4;14
4594;Kodėlčiukas;Gudručiai;1588132166;Taip;0;3;0;3
4595;Kodėlčiukas;Gudručiai;6014084915;Taip;0;10;1;11
4596;Kodėlčiukas;Gudručiai;3068084704;Taip;5;4;0;9
4597;Kodėlčiukas;Gudručiai;6985788287;Taip;0;0;3;3
4598;Kodėlčiukas;Gudručiai;3427610168;Taip;0;0;5;5
4599;Kodėlčiukas;Žirniukai;2402290604;Taip;12;0;3;15
4600;Kodėlčiukas;Žirniukai;6522019070;Taip;11;0;1;12
4601;Kodėlčiukas;Žirniukai;1050905569;Taip;0;0;1;1
4602;Kodėlčiukas;Žirniukai;3053949510;Taip;18;0;0;18
4603;Kodėlčiukas;Žirniukai;8429572505;Taip;0;0;1;1
4604;Kodėlčiukas;Žirniukai;4321485862;Taip;15;0;0;15
4605;Kodėlčiukas;Žirniukai;1550287298;Taip;5;2;0;7
4606;Kodėlčiukas;Žirniukai;9045733092;Taip;13;0;0;13
4607;Kodėlčiukas;Žirniukai;4597473929;Taip;11;0;2;13
4608;Kodėlčiukas;Žirniukai;4969181023;Taip;18;0;0;18
4609;Kodėlčiukas;Žirniukai;9702236745;Taip;8;0;6;14
4610;Kodėlčiukas;Žirniukai;2002468844;Taip;13;0;4;17
4611;Kodėlčiukas;Katinėliai;4730433849;Taip;0;0;1;1
4612;Kodėlčiukas;Katinėliai;6474867237;Taip;0;0;3;3
4613;Kodėlčiukas;Katinėliai;4995538090;Taip;3;0;0;3
4614;Kodėlčiukas;Katinėliai;8045906704;Taip;3;1;0;4
4615;Kodėlčiukas;Katinėliai;7306085848;Taip;0;3;0;3
4616;Kodėlčiukas;Katinėliai;6576466300;Taip;1;2;0;3
4617;Kodėlčiukas;Katinėliai;5650077893;Taip;0;3;5;8
4618;Kodėlčiukas;Katinėliai;3239314295;Taip;16;0;2;18
4619;Kodėlčiukas;Katinėliai;9221561862;Taip;6;1;0;7
4620;Kodėlčiukas;Katinėliai;2147517344;Taip;5;3;1;9
4621;Kodėlčiukas;Katinėliai;2119041584;Taip;0;3;1;4
4622;Kodėlčiukas;Katinėliai;9826174805;Taip;0;0;2;2
4623;Kodėlčiukas;Katinėliai;1570599010;Taip;3;6;0;9
4624;Kodėlčiukas;Katinėliai;9670055064;Taip;3;1;0;4
4625;Kodėlčiukas;Katinėliai;4727546035;Taip;0;3;3;6
4626;Kodėlčiukas;Nykštukai;6670171992;Taip;6;3;0;9
4627;Kodėlčiukas;Nykštukai;6935233288;Taip;0;0;1;1
4628;Kodėlčiukas;Nykštukai;8823086730;Taip;18;0;0;18
4629;Kodėlčiukas;Nykštukai;7686420784;Taip;0;0;6;6
4630;Kodėlčiukas;Nykštukai;8348024909;Taip;0;0;2;2
4631;Kodėlčiukas;Nykštukai;8759498015;Ne;0;3;0;3
4632;Kodėlčiukas;Nykštukai;9418778626;Taip;10;0;0;10
4633;Kodėlčiukas;Nykštukai;8911944991;Taip;9;0;2;11
4634;Kodėlčiukas;Nykštukai;4293763647;Taip;3;0;3;6
4635;Kodėlčiukas;Nykštukai;3878358193;Taip;0;0;3;3
4636;Kodėlčiukas;Nykštukai;6097922310;Taip;5;0;0;5
4637;Kodėlčiukas;Nykštukai;1835522972;Taip;10;0;1;11
4638;Kodėlčiukas;Nykštukai;2802895479;Taip;0;6;0;6
4639;Kodėlčiukas;Nykštukai;9914565606;Taip;2;0;5;7
4640;Kodėlčiukas;ŽIOGELIAI;8769409404;Taip;0;0;5;5
4641;Kodėlčiukas;ŽIOGELIAI;5189091564;Taip;0;0;3;3
4642;Kodėlčiukas;ŽIOGELIAI;6745245907;Taip;0;0;6;6
4643;Kodėlčiukas;ŽIOGELIAI;9055399463;Taip;3;0;0;3
4644;Kodėlčiukas;ŽIOGELIAI;4672108384;Taip;13;0;0;13
4645;Kodėlčiukas;ŽIOGELIAI;2081199093;Taip;0;0;18;18
4646;Kodėlčiukas;ŽIOGELIAI;4779994281;Taip;10;0;4;14
4647;Kodėlčiukas;ŽIOGELIAI;5115939251;Taip;9;0;2;11
4648;Kodėlčiukas;ŽIOGELIAI;3223461282;Taip;4;0;5;9
4649;Kodėlčiukas;ŽIOGELIAI;3603781385;Taip;0;6;0;6
4650;Kodėlčiukas;ŽIOGELIAI;6916032116;Taip;0;0;4;4
4651;Kodėlčiukas;ŽIOGELIAI;6749972956;Taip;10;0;0;10
4652;Kodėlčiukas;ŽIOGELIAI;2189949450;Taip;0;2;2;4
4653;Kodėlčiukas;ŽIOGELIAI;7497358286;Taip;0;0;18;18
4654;Kodėlčiukas;ŽIOGELIAI;2990546939;Taip;0;0;8;8
4655;Kodėlčiukas;ŽIOGELIAI;4089558399;Taip;0;0;13;13
4656;Kodėlčiukas;ŽIOGELIAI;6843492891;Taip;1;0;3;4
4657;Kodėlčiukas;ŽIOGELIAI;2933909503;Taip;7;3;0;10
4658;Kodėlčiukas;BITUTĖS;2313607716;Taip;7;0;0;7
4659;Kodėlčiukas;BITUTĖS;2438891967;Taip;3;0;1;4
4660;Kodėlčiukas;BITUTĖS;3985455729;Taip;0;0;5;5
4661;Kodėlčiukas;BITUTĖS;8144034996;Taip;0;0;4;4
4662;Kodėlčiukas;BITUTĖS;3156788328;Taip;6;0;0;6
4663;Kodėlčiukas;BITUTĖS;7910205296;Taip;2;0;7;9
4664;Kodėlčiukas;BITUTĖS;9736751250;Taip;0;0;3;3
4665;Kodėlčiukas;BITUTĖS;8037386529;Taip;0;9;0;9
4666;Kodėlčiukas;BITUTĖS;1047209628;Taip;14;0;4;18
4667;Kodėlčiukas;BITUTĖS;5068611716;Taip;0;0;3;3
4668;Kodėlčiukas;BITUTĖS;8932472612;Taip;0;0;8;8
4669;Kodėlčiukas;BITUTĖS;7186835214;Taip;3;0;0;3
4670;Kodėlčiukas;BITUTĖS;4529565626;Taip;8;0;0;8
4671;Kodėlčiukas;BITUTĖS;7227149646;Taip;0;0;2;2
4672;Kodėlčiukas;BITUTĖS;1568628843;Taip;0;5;0;5
4673;Kodėlčiukas;BITUTĖS;9209671311;Ne;15;0;0;15
4674;Kodėlčiukas;BITUTĖS;6726383331;Ne;7;0;2;9
4675;Kodėlčiukas;VYŠNIUKAI;7705057116;Taip;5;0;2;7
4676;Kodėlčiukas;VYŠNIUKAI;7643398934;Taip;2;3;1;6
4677;Kodėlčiukas;VYŠNIUKAI;8799798070;Taip;0;0;4;4
4678;Kodėlčiukas;VYŠNIUKAI;7119815662;Taip;0;5;3;8
4679;Kodėlčiukas;VYŠNIUKAI;9398732476;Taip;0;0;9;9
4680;Kodėlčiukas;VYŠNIUKAI;2720748563;Taip;3;0;1;4
4681;Kodėlčiukas;VYŠNIUKAI;2871111867;Taip;3;1;0;4
4682;Kodėlčiukas;VYŠNIUKAI;9914322177;Taip;2;0;1;3
4683;Kodėlčiukas;VYŠNIUKAI;7242653444;Taip;5;0;1;6
4684;Kodėlčiukas;VYŠNIUKAI;2298734536;Taip;0;7;0;7
4685;Kodėlčiukas;VYŠNIUKAI;6261333618;Taip;3;3;0;6
4686;Kodėlčiukas;VYŠNIUKAI;2549153581;Taip;11;3;2;16
4687;Kodėlčiukas;VYŠNIUKAI;1808211253;Taip;0;4;1;5
4688;Kodėlčiukas;VYŠNIUKAI;5178305435;Taip;3;0;4;7
4689;Kodėlčiukas;VYŠNIUKAI;5061852590;Taip;1;1;1;3
4690;Kodėlčiukas;VYŠNIUKAI;4782931414;Taip;0;7;0;7
4691;Kodėlčiukas;VYŠNIUKAI;1803320085;Taip;0;0;6;6
4692;Kodėlčiukas;VYŠNIUKAI;3938536446;Taip;0;0;6;6
4693;Kodėlčiukas;VYŠNIUKAI;5752818911;Ne;0;6;0;6
4694;Kodėlčiukas;BORUŽĖLĖS;9109362006;Taip;0;7;0;7
4695;Kodėlčiukas;BORUŽĖLĖS;9169500252;Taip;0;6;0;6
4696;Kodėlčiukas;BORUŽĖLĖS;9724373368;Taip;5;5;0;10
4697;Kodėlčiukas;BORUŽĖLĖS;5075801618;Taip;6;3;0;9
4698;Kodėlčiukas;BORUŽĖLĖS;2819860331;Taip;3;0;1;4
4699;Kodėlčiukas;BORUŽĖLĖS;4941186694;Taip;0;3;0;3
4700;Kodėlčiukas;BORUŽĖLĖS;4866089623;Taip;0;1;2;3
4701;Kodėlčiukas;BORUŽĖLĖS;5952121209;Taip;6;4;0;10
4702;Kodėlčiukas;BORUŽĖLĖS;4230906452;Taip;0;2;0;2
4703;Kodėlčiukas;BORUŽĖLĖS;6505671642;Taip;0;0;1;1
4704;Kodėlčiukas;BORUŽĖLĖS;8779350309;Taip;0;0;1;1
4705;Kodėlčiukas;BORUŽĖLĖS;9208137169;Ne;5;4;1;10
4706;Kodėlčiukas;BORUŽĖLĖS;5876187643;Taip;11;0;0;11
4707;Kodėlčiukas;BORUŽĖLĖS;1206798597;Taip;0;7;0;7
4708;Kodėlčiukas;BORUŽĖLĖS;6587593805;Taip;0;0;5;5
4709;Kodėlčiukas;BORUŽĖLĖS;1827752731;Taip;10;3;0;13
4710;Kodėlčiukas;BORUŽĖLĖS;1005178052;Taip;7;3;0;10
4711;Kodėlčiukas;BORUŽĖLĖS;9252478832;Taip;0;3;0;3
4712;Kodėlčiukas;BORUŽĖLĖS;4490196764;Taip;0;3;0;3
4713;Kodėlčiukas;BORUŽĖLĖS;1074477043;Taip;0;1;1;2
4714;Kodėlčiukas;BORUŽĖLĖS;2351468626;Taip;0;3;0;3
4715;Kodėlčiukas;BORUŽĖLĖS;3403889915;Taip;0;2;0;2
4716;Kodėlčiukas;VYTURĖLIAI;6714818379;Taip;0;10;0;10
4717;Kodėlčiukas;VYTURĖLIAI;4218096561;Taip;0;5;0;5
4718;Kodėlčiukas;VYTURĖLIAI;4514764005;Taip;0;1;0;1
4719;Kodėlčiukas;VYTURĖLIAI;2169307879;Taip;8;2;0;10
4720;Kodėlčiukas;VYTURĖLIAI;2448536092;Taip;0;3;0;3
4721;Kodėlčiukas;VYTURĖLIAI;4585226357;Taip;0;0;7;7
4722;Kodėlčiukas;VYTURĖLIAI;8263945732;Taip;5;0;6;11
4723;Kodėlčiukas;VYTURĖLIAI;7612531087;Taip;0;3;0;3
4724;Kodėlčiukas;VYTURĖLIAI;4937929385;Taip;1;0;0;1
4725;Kodėlčiukas;VYTURĖLIAI;2904858964;Taip;0;3;2;5
4726;Kodėlčiukas;VYTURĖLIAI;3413659259;Taip;0;3;1;4
4727;Kodėlčiukas;VYTURĖLIAI;9673271313;Taip;3;0;0;3
4728;Kodėlčiukas;VYTURĖLIAI;5710301153;Taip;0;0;7;7
4729;Kodėlčiukas;VYTURĖLIAI;1746835627;Taip;11;0;1;12
4730;Kodėlčiukas;VYTURĖLIAI;5474125905;Taip;13;2;0;15
4731;Kodėlčiukas;VYTURĖLIAI;2298099102;Taip;10;5;0;15
4732;Kodėlčiukas;VYTURĖLIAI;8427457478;Taip;0;7;0;7
4733;Kodėlčiukas;VYTURĖLIAI;5181211722;Taip;1;0;5;6
4734;Kodėlčiukas;VYTURĖLIAI;3472862544;Taip;4;0;2;6
4735;Kodėlčiukas;VYTURĖLIAI;5921714669;Taip;10;0;0;10
4736;Kodėlčiukas;VYTURĖLIAI;7778188733;Taip;11;3;0;14
4737;Kodėlčiukas;DRUGELIAI;4165123345;Taip;5;0;3;8
4738;Kodėlčiukas;DRUGELIAI;5772071707;Taip;0;0;3;3
4739;Kodėlčiukas;DRUGELIAI;1149682376;Taip;0;5;0;5
4740;Kodėlčiukas;DRUGELIAI;7587203481;Taip;0;3;1;4
4741;Kodėlčiukas;DRUGELIAI;2353960861;Taip;0;1;2;3
4742;Kodėlčiukas;DRUGELIAI;6103959702;Taip;0;0;3;3
4743;Kodėlčiukas;DRUGELIAI;3267687337;Taip;7;3;0;10
4744;Kodėlčiukas;DRUGELIAI;5505788210;Taip;0;0;7;7
4745;Kodėlčiukas;DRUGELIAI;5577154148;Taip;1;3;0;4
4746;Kodėlčiukas;DRUGELIAI;8547039654;Taip;0;0;4;4
4747;Kodėlčiukas;DRUGELIAI;4202423480;Taip;0;8;1;9
4748;Kodėlčiukas;DRUGELIAI;9979034031;Taip;0;9;0;9
4749;Kodėlčiukas;DRUGELIAI;3240221130;Ne;0;3;0;3
4750;Kodėlčiukas;DRUGELIAI;7714816675;Taip;10;3;0;13
4751;Kodėlčiukas;DRUGELIAI;9139424911;Taip;0;0;3;3
4752;Kodėlčiukas;DRUGELIAI;9664432781;Taip;0;3;2;5
4753;Kodėlčiukas;DRUGELIAI;5197946954;Taip;0;0;6;6
4754;Kodėlčiukas;DRUGELIAI;8315176054;Taip;11;0;0;11
4755;Kodėlčiukas;DRUGELIAI;3651073383;Taip;0;2;0;2
4756;Kodėlčiukas;DRUGELIAI;3854719881;Taip;2;0;3;5
4757;Kodėlčiukas;DRUGELIAI;7908217415;Taip;12;0;5;17
4758;Kodėlčiukas;OBUOLIUKAI;8784531004;Taip;0;3;0;3
4759;Kodėlčiukas;OBUOLIUKAI;1289342844;Taip;0;7;0;7
4760;Kodėlčiukas;OBUOLIUKAI;7318196860;Taip;3;3;0;6
4761;Kodėlčiukas;OBUOLIUKAI;8208448849;Taip;0;5;0;5
4762;Kodėlčiukas;OBUOLIUKAI;1683506414;Taip;0;0;2;2
4763;Kodėlčiukas;OBUOLIUKAI;3315862631;Taip;0;0;2;2
4764;Kodėlčiukas;OBUOLIUKAI;5896726125;Taip;0;0;2;2
4765;Kodėlčiukas;OBUOLIUKAI;3168418461;Taip;5;3;1;9
4766;Kodėlčiukas;OBUOLIUKAI;9645987751;Taip;9;5;0;14
4767;Kodėlčiukas;OBUOLIUKAI;5860975805;Taip;0;0;3;3
4768;Kodėlčiukas;OBUOLIUKAI;8782155591;Taip;0;3;2;5
4769;Kodėlčiukas;OBUOLIUKAI;8104220950;Taip;0;13;0;13
4770;Kodėlčiukas;OBUOLIUKAI;2005453189;Taip;0;0;5;5
4771;Kodėlčiukas;OBUOLIUKAI;1180399735;Taip;0;4;0;4
4772;Kodėlčiukas;OBUOLIUKAI;5173730926;Taip;5;7;0;12
4773;Kodėlčiukas;OBUOLIUKAI;3442449482;Taip;0;0;5;5
4774;Kodėlčiukas;OBUOLIUKAI;7946010973;Taip;0;7;0;7
4775;Kodėlčiukas;OBUOLIUKAI;5342852235;Taip;5;0;7;12
4776;Kodėlčiukas;OBUOLIUKAI;8563412043;Taip;12;0;0;12
4777;Kodėlčiukas;OBUOLIUKAI;4026784012;Taip;2;3;3;8
4778;Kodėlčiukas;OBUOLIUKAI;2114176689;Taip;0;18;0;18
4779;Kodėlčiukas;OBUOLIUKAI;3033687110;Taip;0;3;0;3
4780;Kurpaitė;Viščiukų;4657523142;Taip;0;4;0;4
4781;Kurpaitė;Viščiukų;2157581956;Taip;0;14;0;14
4782;Kurpaitė;Viščiukų;3481813493;Taip;3;4;0;7
4783;Kurpaitė;Viščiukų;8402747029;Taip;0;6;0;6
4784;Kurpaitė;Viščiukų;2373582223;Taip;0;18;0;18
4785;Kurpaitė;Viščiukų;7194351335;Taip;15;0;0;15
4786;Kurpaitė;Viščiukų;5701318496;Taip;0;3;0;3
4787;Kurpaitė;Viščiukų;2744439309;Ne;0;9;0;9
4788;Kurpaitė;Viščiukų;5557028481;Taip;4;3;0;7
4789;Kurpaitė;Viščiukų;5447826458;Taip;0;1;0;1
4790;Kurpaitė;Viščiukų;9825971721;Taip;0;3;0;3
4791;Kurpaitė;Viščiukų;2867842844;Taip;21;0;0;21
4792;Kurpaitė;Viščiukų;6859316204;Taip;7;0;0;7
4793;Kurpaitė;Gėlyčių;9922582884;Ne;3;5;0;8
4794;Kurpaitė;Gėlyčių;6466518987;Taip;0;5;0;5
4795;Kurpaitė;Gėlyčių;5745448950;Taip;12;3;0;15
4796;Kurpaitė;Gėlyčių;3989274600;Taip;0;5;0;5
4797;Kurpaitė;Gėlyčių;3139272175;Taip;0;5;0;5
4798;Kurpaitė;Gėlyčių;1927773278;Taip;0;12;0;12
4799;Kurpaitė;Gėlyčių;9221882007;Taip;0;5;0;5
4800;Kurpaitė;Gėlyčių;3456815576;Taip;0;15;0;15
4801;Kurpaitė;Gėlyčių;8361612709;Taip;0;9;0;9
4802;Kurpaitė;Gėlyčių;4754807319;Taip;3;1;0;4
4803;Kurpaitė;Gėlyčių;4607835570;Taip;7;0;0;7
4804;Kurpaitė;Gėlyčių;1964193512;Ne;0;4;0;4
4805;Kurpaitė;Drugelių;5609161523;Taip;0;1;0;1
4806;Kurpaitė;Drugelių;3003517700;Taip;0;2;0;2
4807;Kurpaitė;Drugelių;9200404698;Ne;0;6;0;6
4808;Kurpaitė;Drugelių;3502355847;Taip;0;4;0;4
4809;Kurpaitė;Drugelių;4592795281;Taip;0;15;0;15
4810;Kurpaitė;Drugelių;9480290430;Taip;0;2;0;2
4811;Kurpaitė;Drugelių;8868415451;Taip;0;3;0;3
4812;Kurpaitė;Drugelių;2290343066;Taip;0;12;0;12
4813;Kurpaitė;Drugelių;4188925256;Taip;5;6;0;11
4814;Kurpaitė;Drugelių;1273426668;Taip;0;7;0;7
4815;Kurpaitė;Drugelių;1413326858;Ne;5;0;0;5
4816;Kurpaitė;Drugelių;3634641300;Taip;0;4;0;4
4817;Kurpaitė;Drugelių;4602268315;Taip;7;0;0;7
4818;Kurpaitė;Drugelių;6568580994;Taip;0;9;0;9
4819;Kurpaitė;Pelyčių;4964063637;Taip;0;3;0;3
4820;Kurpaitė;Pelyčių;7546409044;Taip;0;10;0;10
4821;Kurpaitė;Pelyčių;7249931704;Taip;3;1;0;4
4822;Kurpaitė;Pelyčių;1218040871;Taip;0;9;0;9
4823;Kurpaitė;Pelyčių;1209441106;Taip;0;1;0;1
4824;Kurpaitė;Pelyčių;1505783589;Taip;0;5;0;5
4825;Kurpaitė;Pelyčių;2359555461;Taip;0;1;0;1
4826;Kurpaitė;Pelyčių;65434834152;Taip;0;3;0;3
4827;Kurpaitė;Pelyčių;9063294667;Taip;0;2;0;2
4828;Kurpaitė;Pelyčių;4312062240;Taip;9;1;0;10
4829;Kurpaitė;Pelyčių;2827617670;Taip;4;9;0;13
4830;Kurpaitė;Pelyčių;1457318954;Taip;0;4;0;4
4831;Kurpaitė;Pelyčių;7897713994;Taip;0;3;0;3
4832;Kurpaitė;Pelyčių;4168882748;Taip;0;5;0;5
4833;Kurpaitė;Pelyčių;72710210157;Taip;0;2;1;3
4834;Kurpaitė;Pelyčių;1094620507;Taip;0;2;2;4
4835;Kurpaitė;Pelyčių;58127430940;Taip;0;9;0;9
4836;Kurpaitė;Pelyčių;2116580903;Taip;0;4;0;4
4837;Kurpaitė;Pelyčių;24410351286;Taip;0;9;0;9
4838;Kurpaitė;Pelyčių;7180555146;Taip;0;1;0;1
4839;"Kūlverstukas (Suvalkų g. 6)";Saulutės;7449993309;Taip;7;5;0;12
4840;"Kūlverstukas (Suvalkų g. 6)";Saulutės;2450625415;Taip;1;6;0;7
4841;"Kūlverstukas (Suvalkų g. 6)";Saulutės;2101490038;Taip;1;6;0;7
4842;"Kūlverstukas (Suvalkų g. 6)";Saulutės;9096819614;Taip;0;7;0;7
4843;"Kūlverstukas (Suvalkų g. 6)";Saulutės;7118949795;Taip;0;4;0;4
4844;"Kūlverstukas (Suvalkų g. 6)";Saulutės;4173514390;Taip;0;6;0;6
4845;"Kūlverstukas (Suvalkų g. 6)";Saulutės;2762230590;Taip;0;14;0;14
4846;"Kūlverstukas (Suvalkų g. 6)";Saulutės;5103259175;Taip;18;0;0;18
4847;"Kūlverstukas (Suvalkų g. 6)";Saulutės;9167460438;Taip;0;10;0;10
4848;"Kūlverstukas (Suvalkų g. 6)";Saulutės;8319255735;Taip;9;2;0;11
4849;"Kūlverstukas (Suvalkų g. 6)";Saulutės;4846324136;Taip;0;5;0;5
4850;"Kūlverstukas (Suvalkų g. 6)";Saulutės;7505926208;Taip;0;5;0;5
4851;"Kūlverstukas (Suvalkų g. 6)";Saulutės;1014630718;Taip;0;5;0;5
4852;"Kūlverstukas (Suvalkų g. 6)";Saulutės;1795306946;Taip;3;4;0;7
4853;"Kūlverstukas (Suvalkų g. 6)";Saulutės;1898905623;Taip;3;0;0;3
4854;"Kūlverstukas (Suvalkų g. 6)";Saulutės;5340239466;Taip;3;3;0;6
4855;"Kūlverstukas (Suvalkų g. 6)";Saulutės;3448880105;Taip;8;5;0;13
4856;"Kūlverstukas (Suvalkų g. 6)";Saulutės;8294873714;Taip;9;1;0;10
4857;"Kūlverstukas (Suvalkų g. 6)";Saulutės;7970898546;Ne;10;0;0;10
4858;"Kūlverstukas (Suvalkų g. 6)";Saulutės;4532151103;Taip;2;6;0;8
4859;"Kūlverstukas (Suvalkų g. 6)";Peledžiukai;5488011852;Taip;3;2;3;8
4860;"Kūlverstukas (Suvalkų g. 6)";Peledžiukai;3937419139;Taip;0;3;1;4
4861;"Kūlverstukas (Suvalkų g. 6)";Peledžiukai;6975324309;Taip;0;3;0;3
4862;"Kūlverstukas (Suvalkų g. 6)";Peledžiukai;1452422691;Taip;0;2;0;2
4863;"Kūlverstukas (Suvalkų g. 6)";Peledžiukai;5372936730;Ne;0;3;0;3
4864;"Kūlverstukas (Suvalkų g. 6)";Peledžiukai;4396230034;Taip;0;2;1;3
4865;"Kūlverstukas (Suvalkų g. 6)";Peledžiukai;7359354944;Taip;5;0;0;5
4866;"Kūlverstukas (Suvalkų g. 6)";Peledžiukai;8853848991;Taip;0;1;0;1
4867;"Kūlverstukas (Suvalkų g. 6)";Peledžiukai;6287636806;Taip;0;1;2;3
4868;"Kūlverstukas (Suvalkų g. 6)";Peledžiukai;4073233921;Taip;0;0;2;2
4869;"Kūlverstukas (Suvalkų g. 6)";Peledžiukai;8092104136;Taip;4;4;3;11
4870;"Kūlverstukas (Suvalkų g. 6)";Peledžiukai;3238807604;Taip;4;3;0;7
4871;"Kūlverstukas (Suvalkų g. 6)";Peledžiukai;9655585527;Taip;1;1;1;3
4872;"Kūlverstukas (Suvalkų g. 6)";Peledžiukai;5488852698;Taip;0;3;0;3
4873;"Kūlverstukas (Suvalkų g. 6)";Peledžiukai;7480593611;Ne;0;3;1;4
4874;"Kūlverstukas (Suvalkų g. 6)";Peledžiukai;5345423038;Taip;0;7;0;7
4875;"Kūlverstukas (Suvalkų g. 6)";Peledžiukai;3270176280;Taip;0;3;5;8
4876;"Kūlverstukas (Suvalkų g. 6)";Peledžiukai;4285624305;Taip;4;3;0;7
4877;"Kūlverstukas (Suvalkų g. 6)";Gelytės;8353856412;Taip;0;18;0;18
4878;"Kūlverstukas (Suvalkų g. 6)";Gelytės;3811616695;Taip;0;18;0;18
4879;"Kūlverstukas (Suvalkų g. 6)";Gelytės;3162808486;Taip;0;3;0;3
4880;"Kūlverstukas (Suvalkų g. 6)";Gelytės;8346712630;Taip;0;3;0;3
4881;"Kūlverstukas (Suvalkų g. 6)";Gelytės;1939668692;Taip;0;8;0;8
4882;"Kūlverstukas (Suvalkų g. 6)";Gelytės;3196099819;Taip;0;1;0;1
4883;"Kūlverstukas (Suvalkų g. 6)";Gelytės;4651091340;Taip;0;18;0;18
4884;"Kūlverstukas (Suvalkų g. 6)";Gelytės;7112217569;Taip;0;14;0;14
4885;"Kūlverstukas (Suvalkų g. 6)";Gelytės;5391554530;Taip;0;8;0;8
4886;"Kūlverstukas (Suvalkų g. 6)";Gelytės;8701405518;Taip;0;2;0;2
4887;"Kūlverstukas (Suvalkų g. 6)";Gelytės;4111966910;Taip;0;8;0;8
4888;"Kūlverstukas (Suvalkų g. 6)";Gelytės;8964753108;Taip;5;8;0;13
4889;"Kūlverstukas (Suvalkų g. 6)";Gelytės;2389231051;Taip;0;8;0;8
4890;"Kūlverstukas (Suvalkų g. 6)";Gelytės;1067182820;Taip;0;1;0;1
4891;"Kūlverstukas (Suvalkų g. 6)";Gelytės;2316978273;Taip;0;18;0;18
4892;"Kūlverstukas (Suvalkų g. 6)";Gelytės;1967837561;Taip;0;3;0;3
4893;"Kūlverstukas (Suvalkų g. 6)";Gelytės;8333084277;Taip;0;5;0;5
4894;"Kūlverstukas (Suvalkų g. 6)";Gelytės;6710735721;Taip;0;7;0;7
4895;"Kūlverstukas (Suvalkų g. 6)";Gelytės;8618967238;Taip;0;7;0;7
4896;"Kūlverstukas (Suvalkų g. 6)";Bitutės;1679412281;Taip;0;1;0;1
4897;"Kūlverstukas (Suvalkų g. 6)";Bitutės;3790418633;Taip;0;1;0;1
4898;"Kūlverstukas (Suvalkų g. 6)";Bitutės;9777005699;Taip;5;13;0;18
4899;"Kūlverstukas (Suvalkų g. 6)";Bitutės;8599785196;Taip;7;3;0;10
4900;"Kūlverstukas (Suvalkų g. 6)";Bitutės;2082087440;Taip;4;0;0;4
4901;"Kūlverstukas (Suvalkų g. 6)";Bitutės;9976311692;Taip;0;10;0;10
4902;"Kūlverstukas (Suvalkų g. 6)";Bitutės;6319075079;Taip;17;1;0;18
4903;"Kūlverstukas (Suvalkų g. 6)";Bitutės;1062604474;Taip;0;4;0;4
4904;"Kūlverstukas (Suvalkų g. 6)";Bitutės;3712773480;Taip;0;10;0;10
4905;"Kūlverstukas (Suvalkų g. 6)";Bitutės;1985177751;Taip;8;16;0;24
4906;"Kūlverstukas (Suvalkų g. 6)";Bitutės;2924333435;Taip;5;0;0;5
4907;"Kūlverstukas (Suvalkų g. 6)";Bitutės;9787833724;Taip;3;3;0;6
4908;"Kūlverstukas (Suvalkų g. 6)";Bitutės;3370339665;Taip;0;1;0;1
4909;"Kūlverstukas (Suvalkų g. 6)";Bitutės;6916013898;Taip;4;0;0;4
4910;Lakštingala;Saulutės;2156571482;Taip;9;4;0;13
4911;Lakštingala;Saulutės;4651600682;Taip;15;0;0;15
4912;Lakštingala;Saulutės;2084960114;Ne;0;3;5;8
4913;Lakštingala;Saulutės;3911509979;Taip;0;4;0;4
4914;Lakštingala;Saulutės;1598639284;Taip;5;2;0;7
4915;Lakštingala;Saulutės;3723986383;Taip;4;0;1;5
4916;Lakštingala;Saulutės;2742489026;Taip;7;3;0;10
4917;Lakštingala;Saulutės;1243254166;Taip;5;5;0;10
4918;Lakštingala;Saulutės;9628476764;Taip;14;2;0;16
4919;Lakštingala;Saulutės;4344553248;Taip;0;3;5;8
4920;Lakštingala;Saulutės;9457533516;Taip;2;3;0;5
4921;Lakštingala;Saulutės;6567480562;Taip;13;0;0;13
4922;Lakštingala;Saulutės;9495341480;Taip;0;8;0;8
4923;Lakštingala;Saulutės;2543779273;Taip;8;1;0;9
4924;Lakštingala;Saulutės;2093953744;Taip;0;3;0;3
4925;Lakštingala;Saulutės;1074616528;Taip;0;4;0;4
4926;Lakštingala;Saulutės;2626498928;Taip;8;0;0;8
4927;Lakštingala;Saulutės;9441296489;Taip;0;6;0;6
4928;Lakštingala;Saulutės;6369696598;Taip;10;0;0;10
4929;Lakštingala;Saulutės;3618452008;Taip;5;3;0;8
4930;Lakštingala;Saulutės;9297542026;Taip;0;9;0;9
4931;Lakštingala;Saulutės;9899997020;Taip;12;0;0;12
4932;Lakštingala;Saulutės;8130468345;Taip;0;4;0;4
4933;Lakštingala;Nykštukai;9725851433;Taip;0;0;4;4
4934;Lakštingala;Nykštukai;8217315818;Taip;0;0;7;7
4935;Lakštingala;Nykštukai;2769474812;Ne;0;3;4;7
4936;Lakštingala;Nykštukai;9879064676;Taip;0;3;3;6
4937;Lakštingala;Nykštukai;2941128360;Taip;0;3;0;3
4938;Lakštingala;Nykštukai;9912622093;Taip;0;0;2;2
4939;Lakštingala;Nykštukai;3509165175;Taip;0;0;5;5
4940;Lakštingala;Nykštukai;3993759015;Taip;0;17;0;17
4941;Lakštingala;Nykštukai;5445945319;Taip;0;8;0;8
4942;Lakštingala;Nykštukai;6332498461;Taip;5;0;3;8
4943;Lakštingala;Nykštukai;1655202909;Taip;0;5;0;5
4944;Lakštingala;Nykštukai;6009631424;Taip;1;4;0;5
4945;Lakštingala;Nykštukai;5162605666;Taip;0;4;1;5
4946;Lakštingala;Nykštukai;2073818724;Taip;0;0;5;5
4947;Lakštingala;Nykštukai;7994475429;Taip;0;3;0;3
4948;Lakštingala;Nykštukai;1863034132;Taip;0;0;18;18
4949;Lakštingala;Nykštukai;6292331193;Taip;0;0;1;1
4950;Lakštingala;Nykštukai;9489982241;Taip;0;3;1;4
4951;Lakštingala;Nykštukai;4032030375;Taip;0;6;0;6
4952;Lakštingala;Nykštukai;2652305131;Taip;6;0;4;10
4953;Lakštingala;Nykštukai;7963839249;Taip;0;0;8;8
4954;Lakštingala;Nykštukai;9375002191;Taip;0;0;7;7
4955;Lakštingala;Nykštukai;4179366572;Taip;6;0;5;11
4956;Lakštingala;Nykštukai;4857448665;Taip;0;0;3;3
4957;Lakštingala;Bitutės;8890852891;Taip;0;5;0;5
4958;Lakštingala;Bitutės;5851957031;Ne;0;4;0;4
4959;Lakštingala;Bitutės;7918688955;Taip;0;3;1;4
4960;Lakštingala;Bitutės;9395512638;Taip;0;3;0;3
4961;Lakštingala;Bitutės;1832608585;Taip;2;3;0;5
4962;Lakštingala;Bitutės;9958821769;Taip;5;3;0;8
4963;Lakštingala;Bitutės;7953724873;Taip;0;4;0;4
4964;Lakštingala;Bitutės;7900597697;Taip;0;5;0;5
4965;Lakštingala;Bitutės;8470575927;Taip;0;4;0;4
4966;Lakštingala;Bitutės;9497327995;Taip;0;4;6;10
4967;Lakštingala;Bitutės;1411121466;Taip;0;3;0;3
4968;Lakštingala;Bitutės;8944088082;Taip;5;5;0;10
4969;Lakštingala;Bitutės;9897713625;Taip;0;4;0;4
4970;Lakštingala;Bitutės;2104150466;Taip;0;3;0;3
4971;Lakštingala;Bitutės;70798601578;Taip;5;3;0;8
4972;Lakštingala;Bitutės;1265027238;Taip;4;3;0;7
4973;Lakštingala;Bitutės;1736130324;Taip;0;3;0;3
4974;Lakštingala;Bitutės;2039579203;Taip;0;3;0;3
4975;Lakštingala;Bitutės;5672932116;Ne;9;3;0;12
4976;Lakštingala;Bitutės;5598711072;Taip;0;4;0;4
4977;Lakštingala;Bitutės;9346986726;Taip;0;4;0;4
4978;Lakštingala;Bitutės;3872205876;Taip;0;3;0;3
4979;Lakštingala;Bitutės;5920907667;Taip;8;5;0;13
4980;Lakštingala;Bitutės;8679582358;Taip;5;1;0;6
4981;Lakštingala;Bitutės;2266870318;Taip;0;3;0;3
4982;Lakštingala;Pūkeliai;9774836470;Taip;13;0;0;13
4983;Lakštingala;Pūkeliai;1958696382;Taip;2;0;1;3
4984;Lakštingala;Pūkeliai;4542992319;Taip;4;3;0;7
4985;Lakštingala;Pūkeliai;2593030897;Taip;12;0;0;12
4986;Lakštingala;Pūkeliai;6908873466;Taip;0;3;0;3
4987;Lakštingala;Pūkeliai;7929034243;Taip;5;3;0;8
4988;Lakštingala;Pūkeliai;5854794141;Taip;0;3;0;3
4989;Lakštingala;Pūkeliai;2130192341;Taip;10;1;0;11
4990;Lakštingala;Pūkeliai;8165998647;Taip;18;0;0;18
4991;Lakštingala;Pūkeliai;1458348357;Taip;14;0;0;14
4992;Lakštingala;Pūkeliai;4465752871;Taip;5;0;4;9
4993;Lakštingala;Pūkeliai;5379344261;Taip;5;0;0;5
4994;Lakštingala;Pūkeliai;4722328994;Taip;1;3;1;5
4995;Lakštingala;Pūkeliai;7272454093;Taip;0;5;1;6
4996;Lakštingala;Pūkeliai;1587899391;Taip;8;0;0;8
4997;Lakštingala;Pūkeliai;6234559044;Taip;10;0;1;11
4998;Lakštingala;Pūkeliai;5727308039;Taip;0;7;0;7
4999;Lakštingala;Pūkeliai;5051773825;Taip;8;0;1;9
5000;Lakštingala;Pūkeliai;9390342572;Taip;8;0;0;8
5001;Lakštingala;Pūkeliai;5949665703;Taip;0;0;1;1
5002;Lakštingala;Pūkeliai;6565318145;Taip;5;3;0;8
5003;Lakštingala;Pūkeliai;4384468922;Taip;2;4;4;10
5004;Lakštingala;Pūkeliai;2423761155;Taip;0;4;4;8
5005;Lakštingala;Pūkeliai;8171357606;Taip;0;10;0;10
5006;Lakštingala;Aitvariukai;1474796466;Taip;0;2;0;2
5007;Lakštingala;Aitvariukai;9629855134;Taip;0;4;0;4
5008;Lakštingala;Aitvariukai;4546036762;Taip;8;0;0;8
5009;Lakštingala;Aitvariukai;6219896499;Taip;7;0;0;7
5010;Lakštingala;Aitvariukai;7876311404;Taip;0;1;1;2
5011;Lakštingala;Aitvariukai;1248909711;Taip;0;2;3;5
5012;Lakštingala;Aitvariukai;9676872125;Taip;0;5;0;5
5013;Lakštingala;Aitvariukai;9083753159;Taip;0;0;3;3
5014;Lakštingala;Aitvariukai;7879280198;Taip;3;4;0;7
5015;Lakštingala;Aitvariukai;4403673558;Taip;8;3;0;11
5016;Lakštingala;Aitvariukai;5693413287;Taip;0;1;11;12
5017;Lakštingala;Aitvariukai;7240426529;Taip;13;0;0;13
5018;Lakštingala;Aitvariukai;8558000223;Taip;7;1;0;8
5019;Lakštingala;Aitvariukai;5244646855;Taip;0;0;3;3
5020;Lakštingala;Aitvariukai;5602079341;Taip;10;0;0;10
5021;Lakštingala;Aitvariukai;7404386777;Taip;0;4;0;4
5022;Lakštingala;Aitvariukai;3166474163;Taip;3;6;0;9
5023;Lakštingala;Aitvariukai;8609822839;Taip;11;0;0;11
5024;Lakštingala;Aitvariukai;6180443056;Taip;8;0;0;8
5025;Lakštingala;Aitvariukai;3113050690;Taip;0;2;0;2
5026;Lakštingala;Boružiukai;9795993812;Taip;0;2;0;2
5027;Lakštingala;Boružiukai;9004336424;Ne;0;11;0;11
5028;Lakštingala;Boružiukai;87470014156;Taip;0;3;1;4
5029;Lakštingala;Boružiukai;8820053026;Taip;5;3;0;8
5030;Lakštingala;Boružiukai;2072883878;Taip;0;3;0;3
5031;Lakštingala;Boružiukai;4811759034;Taip;9;3;0;12
5032;Lakštingala;Boružiukai;1898853302;Taip;0;4;0;4
5033;Lakštingala;Boružiukai;7443563000;Taip;0;3;1;4
5034;Lakštingala;Boružiukai;55720630870;Taip;0;3;0;3
5035;Lakštingala;Boružiukai;4818524423;Taip;11;3;0;14
5036;Lakštingala;Boružiukai;1444534032;Taip;0;5;1;6
5037;Lakštingala;Boružiukai;9724531753;Taip;4;5;0;9
5038;Lakštingala;Boružiukai;1783776913;Taip;0;5;2;7
5039;Lakštingala;Boružiukai;1106475925;Ne;0;3;3;6
5040;Lakštingala;Boružiukai;1667277983;Taip;0;9;0;9
5041;Lakštingala;Boružiukai;6947565845;Taip;0;7;0;7
5042;Lakštingala;Boružiukai;3009692491;Taip;0;3;0;3
5043;Lakštingala;Boružiukai;1800927281;Taip;8;3;0;11
5044;Lakštingala;Boružiukai;9998322501;Taip;18;0;0;18
5045;Lakštingala;Boružiukai;2304340938;Taip;0;4;6;10
5046;Lakštingala;Boružiukai;8284565948;Taip;0;6;0;6
5047;Lakštingala;Boružiukai;2423651716;Taip;4;3;0;7
5048;Lakštingala;Boružiukai;9445476887;Taip;0;4;0;4
5049;Lakštingala;Boružiukai;8899572475;Taip;0;5;1;6
5050;Lakštingala;Boružiukai;9492056071;Taip;0;5;0;5
5051;Lakštingala;Žiogeliai;5048686136;Taip;10;0;4;14
5052;Lakštingala;Žiogeliai;8404025659;Taip;0;2;12;14
5053;Lakštingala;Žiogeliai;4113993067;Taip;0;7;0;7
5054;Lakštingala;Žiogeliai;6981178960;Taip;0;5;10;15
5055;Lakštingala;Žiogeliai;3908175786;Taip;18;0;0;18
5056;Lakštingala;Žiogeliai;9860169528;Taip;8;2;1;11
5057;Lakštingala;Žiogeliai;4935753482;Taip;8;6;0;14
5058;Lakštingala;Žiogeliai;5008933316;Taip;11;0;5;16
5059;Lakštingala;Žiogeliai;3439681068;Taip;0;9;0;9
5060;Lakštingala;Žiogeliai;3766986041;Taip;8;0;10;18
5061;Lakštingala;Žiogeliai;1974950823;Taip;5;1;2;8
5062;Lakštingala;Žiogeliai;6561743084;Taip;0;5;0;5
5063;Lakštingala;Žiogeliai;1226908540;Taip;0;0;9;9
5064;Lakštingala;Žiogeliai;3951057865;Taip;5;0;10;15
5065;Lakštingala;Žiogeliai;1494530289;Taip;0;5;0;5
5066;Lakštingala;Žiogeliai;7661973162;Taip;10;3;0;13
5067;Lakštingala;Žiogeliai;7104398627;Taip;0;5;3;8
5068;Lakštingala;Žiogeliai;7361353346;Taip;0;0;2;2
5069;Lakštingala;Žiogeliai;4790291839;Taip;2;1;0;3
5070;Lakštingala;Žiogeliai;8351970017;Taip;3;0;1;4
5071;Lakštingala;Žiogeliai;8333832673;Taip;5;2;5;12
5072;Lakštingala;Žiogeliai;6872095965;Taip;0;2;9;11
5073;Lakštingala;SPINDULIUKAI;4365413054;Taip;0;0;8;8
5074;Lakštingala;SPINDULIUKAI;9762500668;Taip;0;0;3;3
5075;Lakštingala;SPINDULIUKAI;7640007392;Taip;0;10;0;10
5076;Lakštingala;SPINDULIUKAI;4784677514;Taip;1;4;0;5
5077;Lakštingala;SPINDULIUKAI;1619201521;Taip;0;0;1;1
5078;Lakštingala;SPINDULIUKAI;2022621678;Taip;0;1;5;6
5079;Lakštingala;SPINDULIUKAI;8429523368;Taip;0;5;1;6
5080;Lakštingala;SPINDULIUKAI;6668075753;Taip;5;0;3;8
5081;Lakštingala;SPINDULIUKAI;9081653166;Taip;3;4;0;7
5082;Lakštingala;SPINDULIUKAI;6780591792;Taip;0;3;0;3
5083;Lakštingala;SPINDULIUKAI;4698879435;Taip;0;3;0;3
5084;Lakštingala;SPINDULIUKAI;8722490845;Taip;0;0;8;8
5085;Lakštingala;SPINDULIUKAI;1220858944;Taip;6;4;0;10
5086;Lakštingala;SPINDULIUKAI;3823860988;Taip;0;0;9;9
5087;Lakštingala;SPINDULIUKAI;7141840160;Taip;0;3;0;3
5088;Lakštingala;SPINDULIUKAI;3282771613;Taip;0;13;0;13
5089;Lakštingala;SPINDULIUKAI;2795341401;Taip;3;3;0;6
5090;Lakštingala;SPINDULIUKAI;5815240975;Taip;0;0;3;3
5091;Lakštingala;SPINDULIUKAI;9052256710;Taip;0;1;0;1
5092;Lakštingala;SPINDULIUKAI;1633544390;Taip;3;0;3;6
5093;Lakštingala;Pėledžiukai;5258588961;Taip;0;2;1;3
5094;Lakštingala;Pėledžiukai;6135103377;Taip;0;4;2;6
5095;Lakštingala;Pėledžiukai;4774354751;Taip;0;4;9;13
5096;Lakštingala;Pėledžiukai;3369263112;Taip;0;4;0;4
5097;Lakštingala;Pėledžiukai;8375506323;Taip;0;13;0;13
5098;Lakštingala;Pėledžiukai;2738882466;Taip;0;1;0;1
5099;Lakštingala;Pėledžiukai;8717764626;Taip;0;3;2;5
5100;Lakštingala;Pėledžiukai;8075192528;Taip;0;7;0;7
5101;Lakštingala;Pėledžiukai;3766779594;Taip;5;3;0;8
5102;Lakštingala;Pėledžiukai;4270513515;Taip;0;5;2;7
5103;Lakštingala;Pėledžiukai;2514377385;Taip;0;5;2;7
5104;Lakštingala;Pėledžiukai;6161860331;Taip;0;3;2;5
5105;Lakštingala;Pėledžiukai;6866935290;Taip;0;8;10;18
5106;Lakštingala;Pėledžiukai;8787118512;Taip;2;4;0;6
5107;Lakštingala;Pėledžiukai;6805882038;Taip;0;5;1;6
5108;Lakštingala;Pėledžiukai;7139669240;Taip;0;5;0;5
5109;Lakštingala;Pėledžiukai;9502994399;Taip;5;0;0;5
5110;Lakštingala;Pėledžiukai;9431022632;Taip;5;3;2;10
5111;Lakštingala;Pėledžiukai;9856189053;Taip;5;6;0;11
5112;Lakštingala;Pėledžiukai;5391954600;Taip;5;3;0;8
5113;Lakštingala;Pėledžiukai;4608719006;Ne;0;3;0;3
5114;Lakštingala;Katinėliai;8861428074;Taip;0;3;2;5
5115;Lakštingala;Katinėliai;2346497467;Taip;14;0;0;14
5116;Lakštingala;Katinėliai;9894103692;Taip;4;5;0;9
5117;Lakštingala;Katinėliai;8800538473;Taip;15;0;0;15
5118;Lakštingala;Katinėliai;9093654437;Taip;0;3;3;6
5119;Lakštingala;Katinėliai;6011421835;Taip;7;0;1;8
5120;Lakštingala;Katinėliai;2673030043;Taip;0;0;2;2
5121;Lakštingala;Katinėliai;2010478542;Taip;18;0;0;18
5122;Lakštingala;Katinėliai;1371422364;Taip;11;3;0;14
5123;Lakštingala;Katinėliai;6285766353;Taip;9;0;0;9
5124;Lakštingala;Katinėliai;3877448215;Taip;0;1;0;1
5125;Lakštingala;Katinėliai;6148942052;Taip;0;0;1;1
5126;Lakštingala;Katinėliai;7623917384;Taip;0;0;3;3
5127;Lakštingala;Katinėliai;1903292595;Taip;5;6;0;11
5128;Lakštingala;Katinėliai;6764453371;Taip;0;3;0;3
5129;Lakštingala;Katinėliai;4184814075;Taip;0;4;0;4
5130;Lakštingala;Deimantėliai;8310446552;Taip;8;3;0;11
5131;Lakštingala;Deimantėliai;8063735934;Taip;0;3;0;3
5132;Lakštingala;Deimantėliai;7396235662;Taip;0;5;0;5
5133;Lakštingala;Deimantėliai;3863174791;Taip;0;3;0;3
5134;Lakštingala;Deimantėliai;2969366008;Taip;9;5;0;14
5135;Lakštingala;Deimantėliai;9800669350;Taip;8;5;1;14
5136;Lakštingala;Deimantėliai;4725848201;Taip;3;3;1;7
5137;Lakštingala;Deimantėliai;6930466455;Taip;4;4;1;9
5138;Lakštingala;Deimantėliai;2165808562;Taip;0;13;3;16
5139;Lakštingala;Deimantėliai;3352073562;Taip;0;3;13;16
5140;Lakštingala;Deimantėliai;5539054769;Taip;0;4;0;4
5141;Lakštingala;Deimantėliai;8421786788;Taip;0;9;0;9
5142;Lakštingala;Deimantėliai;6974936332;Taip;13;0;0;13
5143;Lakštingala;Deimantėliai;8764728846;Taip;11;3;0;14
5144;Lakštingala;Deimantėliai;8663938939;Taip;10;3;0;13
5145;Lakštingala;Deimantėliai;6231045485;Taip;10;1;0;11
5146;Lakštingala;Deimantėliai;5165517709;Taip;11;1;0;12
5147;Lakštingala;Deimantėliai;5965026791;Taip;9;2;0;11
5148;Lakštingala;KIŠKUČIAI;6520436055;Taip;7;3;0;10
5149;Lakštingala;KIŠKUČIAI;3208321841;Taip;10;3;1;14
5150;Lakštingala;KIŠKUČIAI;5464460112;Taip;0;2;2;4
5151;Lakštingala;KIŠKUČIAI;6970022417;Taip;8;0;2;10
5152;Lakštingala;KIŠKUČIAI;5730122965;Taip;0;4;4;8
5153;Lakštingala;KIŠKUČIAI;4140403601;Taip;0;0;4;4
5154;Lakštingala;KIŠKUČIAI;5119365443;Taip;0;2;2;4
5155;Lakštingala;KIŠKUČIAI;6689018476;Taip;0;5;0;5
5156;Lakštingala;KIŠKUČIAI;7017047366;Taip;8;0;4;12
5157;Lakštingala;KIŠKUČIAI;9539081376;Taip;0;0;17;17
5158;Lakštingala;KIŠKUČIAI;4854843534;Taip;10;2;3;15
5159;Lakštingala;KIŠKUČIAI;9162902701;Taip;16;0;1;17
5160;Lakštingala;KIŠKUČIAI;5455119187;Taip;0;7;0;7
5161;Lakštingala;KIŠKUČIAI;1113674539;Taip;0;1;12;13
5162;Lakštingala;KIŠKUČIAI;4370431439;Taip;6;0;3;9
5163;Lakštingala;KIŠKUČIAI;1898108870;Taip;18;0;0;18
5164;Lakštingala;KIŠKUČIAI;6652822827;Taip;5;0;4;9
5165;Lakštingala;KIŠKUČIAI;2998581623;Taip;18;0;0;18
5166;Lakštingala;KIŠKUČIAI;8414220381;Taip;0;0;6;6
5167;Lakštingala;KIŠKUČIAI;7817830649;Taip;18;0;0;18
5168;Lašelis;VIŠČIUKAI;6477439886;Taip;5;3;0;8
5169;Lašelis;VIŠČIUKAI;6912802425;Taip;20;0;0;20
5170;Lašelis;VIŠČIUKAI;6857428142;Taip;0;5;0;5
5171;Lašelis;VIŠČIUKAI;5759317067;Ne;10;4;0;14
5172;Lašelis;VIŠČIUKAI;9884946783;Taip;18;0;0;18
5173;Lašelis;VIŠČIUKAI;1367955273;Ne;0;10;1;11
5174;Lašelis;VIŠČIUKAI;2702582486;Taip;6;3;0;9
5175;Lašelis;VIŠČIUKAI;2824852871;Taip;17;0;0;17
5176;Lašelis;VIŠČIUKAI;1517104634;Taip;0;3;0;3
5177;Lašelis;VIŠČIUKAI;1294930990;Taip;6;4;0;10
5178;Lašelis;VIŠČIUKAI;9440665009;Ne;6;1;0;7
5179;Lašelis;VIŠČIUKAI;2121080776;Taip;17;0;0;17
5180;Lašelis;VIŠČIUKAI;3003679103;Taip;0;3;1;4
5181;Lašelis;VIŠČIUKAI;4427263877;Taip;15;0;0;15
5182;Lašelis;VIŠČIUKAI;1168408482;Taip;5;3;0;8
5183;Lašelis;VIŠČIUKAI;4748156580;Taip;6;4;0;10
5184;Lašelis;VIŠČIUKAI;4860925464;Ne;9;0;1;10
5185;Lašelis;ŠYPSENA;7137348151;Taip;0;0;3;3
5186;Lašelis;ŠYPSENA;1808067249;Ne;5;5;0;10
5187;Lašelis;ŠYPSENA;4933598046;Taip;10;0;0;10
5188;Lašelis;ŠYPSENA;1060784180;Taip;6;1;0;7
5189;Lašelis;ŠYPSENA;2509469243;Taip;0;3;7;10
5190;Lašelis;ŠYPSENA;4832223461;Taip;3;0;3;6
5191;Lašelis;ŠYPSENA;5416590600;Taip;0;3;1;4
5192;Lašelis;ŠYPSENA;1490179832;Ne;0;7;0;7
5193;Lašelis;ŠYPSENA;6836452490;Taip;7;0;2;9
5194;Lašelis;ŠYPSENA;1983312896;Taip;0;3;0;3
5195;Lašelis;ŠYPSENA;1279052767;Ne;8;1;1;10
5196;Lašelis;ŠYPSENA;8906479495;Taip;0;0;2;2
5197;Lašelis;ŠYPSENA;2593126568;Taip;12;0;2;14
5198;Lašelis;ŠYPSENA;3995905195;Taip;0;18;0;18
5199;Lašelis;ŠYPSENA;6137626795;Taip;6;0;3;9
5200;Lašelis;ŠYPSENA;1635921119;Ne;7;4;0;11
5201;Lašelis;ŠYPSENA;9664015801;Taip;0;3;0;3
5202;Lašelis;ŠYPSENA;2210915728;Ne;2;0;1;3
5203;Lašelis;ŠYPSENA;2306501498;Taip;0;0;5;5
5204;Lašelis;ŠYPSENA;2606193652;Ne;0;0;5;5
5205;Lašelis;ŠYPSENA;9434932943;Taip;0;12;0;12
5206;Lašelis;NYKŠTUKAI;4508779926;Taip;9;4;0;13
5207;Lašelis;NYKŠTUKAI;5931015581;Taip;9;0;0;9
5208;Lašelis;NYKŠTUKAI;1175045927;Taip;0;1;0;1
5209;Lašelis;NYKŠTUKAI;8132517365;Taip;0;4;0;4
5210;Lašelis;NYKŠTUKAI;1244168190;Taip;0;4;7;11
5211;Lašelis;NYKŠTUKAI;1035888733;Taip;0;8;0;8
5212;Lašelis;NYKŠTUKAI;1926439959;Taip;0;3;5;8
5213;Lašelis;NYKŠTUKAI;8318512396;Taip;5;4;0;9
5214;Lašelis;NYKŠTUKAI;2886967297;Taip;0;4;0;4
5215;Lašelis;NYKŠTUKAI;3805049682;Taip;10;6;0;16
5216;Lašelis;NYKŠTUKAI;2401058384;Ne;0;3;0;3
5217;Lašelis;NYKŠTUKAI;1042560186;Taip;0;3;3;6
5218;Lašelis;NYKŠTUKAI;8814796010;Taip;13;3;0;16
5219;Lašelis;NYKŠTUKAI;2223293390;Taip;24;0;0;24
5220;Lašelis;NYKŠTUKAI;3675606390;Taip;18;0;0;18
5221;Lašelis;SAULUTĖ;3144718477;Taip;8;3;0;11
5222;Lašelis;SAULUTĖ;1777442316;Taip;4;0;0;4
5223;Lašelis;SAULUTĖ;7998812497;Taip;0;6;0;6
5224;Lašelis;SAULUTĖ;6669130831;Taip;1;0;0;1
5225;Lašelis;SAULUTĖ;7351939034;Taip;0;0;1;1
5226;Lašelis;SAULUTĖ;3239288878;Taip;0;0;5;5
5227;Lašelis;SAULUTĖ;6829438486;Taip;8;5;1;14
5228;Lašelis;SAULUTĖ;6080664872;Taip;17;0;0;17
5229;Lašelis;SAULUTĖ;2204859014;Taip;6;2;0;8
5230;Lašelis;SAULUTĖ;1515920896;Taip;7;0;1;8
5231;Lašelis;SAULUTĖ;1085400709;Taip;0;7;5;12
5232;Lašelis;SAULUTĖ;8889959782;Taip;0;3;1;4
5233;Lašelis;SAULUTĖ;1646912457;Taip;3;2;0;5
5234;Lašelis;SAULUTĖ;1816377082;Taip;0;5;1;6
5235;Lašelis;SAULUTĖ;2034007263;Taip;8;0;0;8
5236;Lašelis;SAULUTĖ;3495676199;Taip;8;1;0;9
5237;Lašelis;SAULUTĖ;5731394231;Taip;6;0;7;13
5238;Lašelis;SAULUTĖ;1085950130;Taip;3;0;0;3
5239;Lašelis;BORUŽĖLĖS;1343964112;Taip;3;0;0;3
5240;Lašelis;BORUŽĖLĖS;7502668870;Taip;9;0;0;9
5241;Lašelis;BORUŽĖLĖS;1511922965;Taip;0;1;0;1
5242;Lašelis;BORUŽĖLĖS;5634517740;Ne;1;0;5;6
5243;Lašelis;BORUŽĖLĖS;7418586100;Taip;5;3;2;10
5244;Lašelis;BORUŽĖLĖS;1429188137;Taip;1;0;1;2
5245;Lašelis;BORUŽĖLĖS;8394290574;Taip;0;6;0;6
5246;Lašelis;BORUŽĖLĖS;7811809908;Taip;11;0;0;11
5247;Lašelis;BORUŽĖLĖS;4893073148;Taip;0;4;0;4
5248;Lašelis;BORUŽĖLĖS;4113842551;Taip;8;2;0;10
5249;Lašelis;BORUŽĖLĖS;1882188961;Taip;11;0;0;11
5250;Lašelis;BORUŽĖLĖS;6317716501;Taip;0;3;0;3
5251;Lašelis;BORUŽĖLĖS;2991487552;Taip;6;0;1;7
5252;Lašelis;BORUŽĖLĖS;2210081848;Taip;7;0;0;7
5253;Lašelis;BORUŽĖLĖS;1131591230;Taip;20;3;0;23
5254;Lašelis;BORUŽĖLĖS;4051058266;Taip;0;3;0;3
5255;Lašelis;BORUŽĖLĖS;7784416134;Taip;0;3;0;3
5256;Lašelis;SKRUZDELIUKAI;8212250478;Taip;0;5;0;5
5257;Lašelis;SKRUZDELIUKAI;8571325340;Taip;14;0;0;14
5258;Lašelis;SKRUZDELIUKAI;5000188106;Ne;5;5;0;10
5259;Lašelis;SKRUZDELIUKAI;6203027620;Taip;18;0;0;18
5260;Lašelis;SKRUZDELIUKAI;9954809499;Taip;15;0;0;15
5261;Lašelis;SKRUZDELIUKAI;6770694679;Taip;12;0;0;12
5262;Lašelis;SKRUZDELIUKAI;6158377421;Ne;7;7;0;14
5263;Lašelis;SKRUZDELIUKAI;3130271837;Taip;5;4;0;9
5264;Lašelis;SKRUZDELIUKAI;2871149756;Taip;18;0;0;18
5265;Lašelis;SKRUZDELIUKAI;7920615797;Ne;1;2;1;4
5266;Lašelis;SKRUZDELIUKAI;3146611814;Taip;0;6;0;6
5267;Lašelis;SKRUZDELIUKAI;7619426839;Ne;13;0;0;13
5268;Lašelis;SKRUZDELIUKAI;8718481664;Taip;13;0;0;13
5269;Lazdynėlis;BITUTĖS;4881322530;Taip;3;0;0;3
5270;Lazdynėlis;BITUTĖS;1748260780;Taip;0;3;4;7
5271;Lazdynėlis;BITUTĖS;4462819848;Taip;0;3;5;8
5272;Lazdynėlis;BITUTĖS;1574847460;Taip;0;3;0;3
5273;Lazdynėlis;BITUTĖS;5030400578;Taip;0;3;2;5
5274;Lazdynėlis;BITUTĖS;8159928299;Taip;0;0;3;3
5275;Lazdynėlis;BITUTĖS;9761942869;Taip;3;0;1;4
5276;Lazdynėlis;BITUTĖS;7911328294;Taip;5;3;0;8
5277;Lazdynėlis;BITUTĖS;1450181711;Taip;0;3;0;3
5278;Lazdynėlis;BITUTĖS;2044188250;Taip;0;4;1;5
5279;Lazdynėlis;BITUTĖS;4142277927;Taip;7;0;0;7
5280;Lazdynėlis;BITUTĖS;2032759165;Taip;0;1;0;1
5281;Lazdynėlis;BITUTĖS;4826167852;Taip;0;0;2;2
5282;Lazdynėlis;BITUTĖS;2802505435;Taip;0;5;0;5
5283;Lazdynėlis;BITUTĖS;2586187455;Taip;5;5;0;10
5284;Lazdynėlis;BITUTĖS;2013752858;Taip;0;3;2;5
5285;Lazdynėlis;BITUTĖS;4545757725;Taip;8;3;0;11
5286;Lazdynėlis;BITUTĖS;5562900372;Taip;0;18;0;18
5287;Lazdynėlis;BITUTĖS;3650483589;Taip;0;0;4;4
5288;Lazdynėlis;BITUTĖS;6963058612;Taip;5;0;2;7
5289;Lazdynėlis;BITUTĖS;6920441303;Taip;3;3;2;8
5290;Lazdynėlis;BITUTĖS;4153294595;Taip;0;5;0;5
5291;Lazdynėlis;BITUTĖS;7910561870;Taip;0;18;0;18
5292;Lazdynėlis;BITUTĖS;4809829190;Taip;0;5;0;5
5293;Lazdynėlis;EŽIUKAI;1039874409;Taip;0;2;0;2
5294;Lazdynėlis;EŽIUKAI;9362249595;Taip;0;3;4;7
5295;Lazdynėlis;EŽIUKAI;7135087818;Taip;0;3;2;5
5296;Lazdynėlis;EŽIUKAI;6814362584;Taip;0;3;5;8
5297;Lazdynėlis;EŽIUKAI;9219327706;Taip;0;5;0;5
5298;Lazdynėlis;EŽIUKAI;8229454863;Taip;6;0;0;6
5299;Lazdynėlis;EŽIUKAI;4747688220;Taip;2;3;0;5
5300;Lazdynėlis;EŽIUKAI;1312649234;Taip;0;3;1;4
5301;Lazdynėlis;EŽIUKAI;3097254722;Taip;0;3;5;8
5302;Lazdynėlis;EŽIUKAI;3040417651;Taip;0;3;2;5
5303;Lazdynėlis;EŽIUKAI;2354549025;Taip;3;0;0;3
5304;Lazdynėlis;EŽIUKAI;5407785006;Taip;0;2;2;4
5305;Lazdynėlis;EŽIUKAI;7208223612;Taip;0;0;4;4
5306;Lazdynėlis;EŽIUKAI;8627994583;Taip;8;3;2;13
5307;Lazdynėlis;EŽIUKAI;4293473176;Taip;0;18;0;18
5308;Lazdynėlis;EŽIUKAI;2723284353;Taip;0;1;0;1
5309;Lazdynėlis;EŽIUKAI;9548653584;Taip;0;1;0;1
5310;Lazdynėlis;EŽIUKAI;6008610525;Taip;5;0;0;5
5311;Lazdynėlis;EŽIUKAI;3879017767;Taip;5;3;3;11
5312;Lazdynėlis;EŽIUKAI;4031719765;Taip;9;4;0;13
5313;Lazdynėlis;BORUŽIUKAI;8337458289;Taip;0;18;0;18
5314;Lazdynėlis;BORUŽIUKAI;2592852361;Taip;0;18;0;18
5315;Lazdynėlis;BORUŽIUKAI;7692056055;Taip;7;3;1;11
5316;Lazdynėlis;BORUŽIUKAI;6394994841;Taip;0;2;1;3
5317;Lazdynėlis;BORUŽIUKAI;2009941344;Taip;3;3;2;8
5318;Lazdynėlis;BORUŽIUKAI;1653216959;Taip;0;3;1;4
5319;Lazdynėlis;BORUŽIUKAI;4190852647;Taip;5;3;0;8
5320;Lazdynėlis;BORUŽIUKAI;2058909635;Taip;0;3;3;6
5321;Lazdynėlis;BORUŽIUKAI;3105363578;Taip;0;18;0;18
5322;Lazdynėlis;BORUŽIUKAI;5622254334;Taip;15;3;0;18
5323;Lazdynėlis;BORUŽIUKAI;7587041613;Taip;5;2;1;8
5324;Lazdynėlis;BORUŽIUKAI;2380881303;Taip;1;3;0;4
5325;Lazdynėlis;BORUŽIUKAI;2632078843;Taip;18;0;0;18
5326;Lazdynėlis;BORUŽIUKAI;5756228709;Taip;0;3;2;5
5327;Lazdynėlis;BORUŽIUKAI;6824473598;Taip;0;3;0;3
5328;Lazdynėlis;BORUŽIUKAI;1707231039;Taip;0;18;0;18
5329;Lazdynėlis;BORUŽIUKAI;6413861274;Taip;3;2;0;5
5330;Lazdynėlis;BORUŽIUKAI;8030743153;Taip;0;2;0;2
5331;Lazdynėlis;BORUŽIUKAI;4642875037;Taip;0;7;0;7
5332;Lazdynėlis;BORUŽIUKAI;1722503577;Taip;7;6;0;13
5333;Lazdynėlis;BORUŽIUKAI;4595080695;Taip;0;18;0;18
5334;Lazdynėlis;BORUŽIUKAI;4958640516;Taip;0;18;0;18
5335;Lazdynėlis;BORUŽIUKAI;3351966091;Taip;0;18;0;18
5336;Lazdynėlis;BORUŽIUKAI;9548866880;Taip;6;5;1;12
5337;Lazdynėlis;KAČIUKAI;5888646355;Taip;0;3;0;3
5338;Lazdynėlis;KAČIUKAI;3678422730;Taip;0;3;0;3
5339;Lazdynėlis;KAČIUKAI;5708643953;Taip;2;2;0;4
5340;Lazdynėlis;KAČIUKAI;8295967906;Taip;12;3;0;15
5341;Lazdynėlis;KAČIUKAI;7076664657;Taip;0;3;0;3
5342;Lazdynėlis;KAČIUKAI;7864896721;Taip;0;7;2;9
5343;Lazdynėlis;KAČIUKAI;1424382629;Taip;21;0;0;21
5344;Lazdynėlis;KAČIUKAI;6787228086;Taip;0;2;0;2
5345;Lazdynėlis;KAČIUKAI;7313399153;Taip;0;3;0;3
5346;Lazdynėlis;KAČIUKAI;4842228703;Taip;3;0;0;3
5347;Lazdynėlis;KAČIUKAI;6542840562;Taip;0;4;1;5
5348;Lazdynėlis;KAČIUKAI;1265404063;Taip;2;3;0;5
5349;Lazdynėlis;KAČIUKAI;6086766393;Taip;0;3;1;4
5350;Lazdynėlis;KAČIUKAI;5301460250;Taip;0;3;0;3
5351;Lazdynėlis;KAČIUKAI;73057057862;Taip;0;3;5;8
5352;Lazdynėlis;KAČIUKAI;7455989945;Taip;7;3;0;10
5353;Lazdynėlis;KAČIUKAI;1817075429;Taip;8;2;0;10
5354;Lazdynėlis;KAČIUKAI;5030460904;Ne;0;3;0;3
5355;Lazdynėlis;KAČIUKAI;2164717183;Taip;0;3;5;8
5356;Lazdynėlis;KAČIUKAI;5504180016;Ne;0;15;0;15
5357;Lazdynėlis;KAČIUKAI;5031826548;Taip;5;3;0;8
5358;Lazdynėlis;KAČIUKAI;7237629135;Taip;0;3;4;7
5359;Lazdynėlis;KAČIUKAI;6657174602;Taip;0;3;0;3
5360;Lazdynėlis;VOVERIUKAI;6994408527;Taip;0;2;0;2
5361;Lazdynėlis;VOVERIUKAI;8159724466;Taip;2;5;0;7
5362;Lazdynėlis;VOVERIUKAI;5051632567;Ne;10;2;0;12
5363;Lazdynėlis;VOVERIUKAI;6276697479;Taip;2;3;0;5
5364;Lazdynėlis;VOVERIUKAI;1335000592;Taip;0;1;0;1
5365;Lazdynėlis;VOVERIUKAI;2514035189;Taip;10;3;2;15
5366;Lazdynėlis;VOVERIUKAI;9477491360;Taip;0;3;0;3
5367;Lazdynėlis;VOVERIUKAI;5256157552;Ne;15;0;0;15
5368;Lazdynėlis;VOVERIUKAI;5889772626;Taip;5;2;0;7
5369;Lazdynėlis;VOVERIUKAI;6559543013;Taip;10;3;0;13
5370;Lazdynėlis;VOVERIUKAI;9231049001;Taip;0;1;0;1
5371;Lazdynėlis;VOVERIUKAI;9886856760;Taip;11;0;0;11
5372;Lazdynėlis;VOVERIUKAI;2998606948;Taip;7;0;0;7
5373;Lazdynėlis;VOVERIUKAI;6164180360;Taip;4;5;2;11
5374;Lazdynėlis;VOVERIUKAI;6415858184;Taip;0;0;8;8
5375;Lazdynėlis;VOVERIUKAI;5796381191;Ne;4;4;1;9
5376;Lazdynėlis;VOVERIUKAI;3062408541;Taip;8;7;0;15
5377;Lazdynėlis;VOVERIUKAI;5557752248;Taip;0;1;0;1
5378;Lazdynėlis;VOVERIUKAI;3779983775;Taip;0;4;0;4
5379;Lazdynėlis;VOVERIUKAI;4550819172;Taip;7;1;0;8
5380;Lazdynėlis;VOVERIUKAI;4771173060;Taip;0;16;0;16
5381;Lazdynėlis;VOVERIUKAI;8314002741;Taip;5;0;0;5
5382;Lazdynėlis;VOVERIUKAI;3365726271;Taip;0;2;0;2
5383;Lazdynėlis;VOVERIUKAI;1355954767;Taip;5;0;0;5
5384;Lazdynėlis;VOVERIUKAI;7941793866;Taip;0;7;5;12
5385;Lazdynėlis;RIEŠUTĖLIAI;3086059608;Taip;2;6;1;9
5386;Lazdynėlis;RIEŠUTĖLIAI;9693153118;Taip;0;4;0;4
5387;Lazdynėlis;RIEŠUTĖLIAI;6056618348;Taip;0;18;0;18
5388;Lazdynėlis;RIEŠUTĖLIAI;2478218103;Taip;0;3;0;3
5389;Lazdynėlis;RIEŠUTĖLIAI;5987500024;Taip;0;3;2;5
5390;Lazdynėlis;RIEŠUTĖLIAI;2453740823;Taip;0;4;0;4
5391;Lazdynėlis;RIEŠUTĖLIAI;4552505857;Taip;2;4;1;7
5392;Lazdynėlis;RIEŠUTĖLIAI;7545621720;Taip;0;4;2;6
5393;Lazdynėlis;RIEŠUTĖLIAI;7464997080;Taip;0;3;2;5
5394;Lazdynėlis;RIEŠUTĖLIAI;9810842975;Taip;0;3;0;3
5395;Lazdynėlis;RIEŠUTĖLIAI;8179584161;Taip;0;2;0;2
5396;Lazdynėlis;RIEŠUTĖLIAI;3239107488;Ne;3;6;0;9
5397;Lazdynėlis;RIEŠUTĖLIAI;4055450300;Taip;0;3;0;3
5398;Lazdynėlis;RIEŠUTĖLIAI;8942906327;Taip;2;15;0;17
5399;Lazdynėlis;RIEŠUTĖLIAI;3362193379;Taip;0;3;0;3
5400;Lazdynėlis;RIEŠUTĖLIAI;9582702244;Taip;2;3;0;5
5401;Lazdynėlis;RIEŠUTĖLIAI;3062924645;Taip;0;4;1;5
5402;Lazdynėlis;RIEŠUTĖLIAI;3667994076;Taip;6;4;0;10
5403;Lazdynėlis;RIEŠUTĖLIAI;1668899344;Taip;0;6;0;6
5404;Lazdynėlis;RIEŠUTĖLIAI;4092363029;Taip;4;4;0;8
5405;Lazdynėlis;RIEŠUTĖLIAI;3250913116;Taip;0;3;1;4
5406;Lazdynėlis;RIEŠUTĖLIAI;8529192130;Taip;5;3;0;8
5407;Lazdynėlis;RIEŠUTĖLIAI;7719697394;Taip;5;3;1;9
5408;Lazdynėlis;ANČIUKAI;9519409694;Taip;3;0;0;3
5409;Lazdynėlis;ANČIUKAI;2526260625;Taip;3;0;0;3
5410;Lazdynėlis;ANČIUKAI;8340712398;Taip;0;3;0;3
5411;Lazdynėlis;ANČIUKAI;6031442797;Taip;5;7;0;12
5412;Lazdynėlis;ANČIUKAI;7552873109;Taip;19;0;0;19
5413;Lazdynėlis;ANČIUKAI;7655218276;Taip;6;1;0;7
5414;Lazdynėlis;ANČIUKAI;7561833526;Taip;0;3;4;7
5415;Lazdynėlis;ANČIUKAI;6817162699;Taip;4;3;0;7
5416;Lazdynėlis;ANČIUKAI;2294873565;Taip;10;0;1;11
5417;Lazdynėlis;ANČIUKAI;1499729462;Taip;1;3;0;4
5418;Lazdynėlis;ANČIUKAI;4745610579;Taip;0;4;0;4
5419;Lazdynėlis;ANČIUKAI;8530159773;Taip;0;3;0;3
5420;Lazdynėlis;ANČIUKAI;3036055537;Taip;0;3;0;3
5421;Lazdynėlis;ANČIUKAI;2933025284;Taip;4;0;0;4
5422;Lazdynėlis;ANČIUKAI;5832624944;Taip;0;1;2;3
5423;Lazdynėlis;ANČIUKAI;1168433014;Taip;5;4;3;12
5424;Lazdynėlis;ANČIUKAI;3764854654;Taip;0;1;3;4
5425;Lazdynėlis;ANČIUKAI;1961540377;Taip;18;0;0;18
5426;Lazdynėlis;GUDRUČIAI;4425724586;Taip;4;1;0;5
5427;Lazdynėlis;GUDRUČIAI;4928593615;Taip;0;3;0;3
5428;Lazdynėlis;GUDRUČIAI;6684940385;Taip;0;3;0;3
5429;Lazdynėlis;GUDRUČIAI;9187681789;Taip;0;3;9;12
5430;Lazdynėlis;GUDRUČIAI;6307407620;Taip;0;3;0;3
5431;Lazdynėlis;GUDRUČIAI;24978945607;Taip;3;1;0;4
5432;Lazdynėlis;GUDRUČIAI;18498032472;Taip;0;1;2;3
5433;Lazdynėlis;GUDRUČIAI;158059657;Taip;0;3;0;3
5434;Lazdynėlis;GUDRUČIAI;1852865534;Taip;3;0;0;3
5435;Lazdynėlis;GUDRUČIAI;2587142646;Taip;0;1;0;1
5436;Lazdynėlis;GUDRUČIAI;7789345652;Taip;6;1;2;9
5437;Lazdynėlis;GUDRUČIAI;3902772678;Taip;0;4;0;4
5438;Lazdynėlis;GUDRUČIAI;8822378464;Taip;2;1;1;4
5439;Lazdynėlis;GUDRUČIAI;2441835588;Taip;1;3;0;4
5440;Lazdynėlis;GUDRUČIAI;1386686123;Taip;0;3;0;3
5441;Lazdynėlis;GUDRUČIAI;2603427970;Taip;0;18;0;18
5442;Lazdynėlis;GUDRUČIAI;7965433882;Taip;0;3;0;3
5443;Lazdynėlis;GUDRUČIAI;6762216509;Taip;0;1;0;1
5444;Lazdynėlis;GUDRUČIAI;6863715428;Taip;5;3;0;8
5445;Lazdynėlis;GUDRUČIAI;44510351979;Taip;0;13;3;16
5446;Lazdynėlis;GUDRUČIAI;3043350186;Taip;0;2;0;2
5447;Lazdynėlis;GUDRUČIAI;5182241318;Taip;0;1;0;1
5448;Lazdynėlis;GUDRUČIAI;8008332680;Taip;0;3;0;3
5449;Lazdynėlis;MEŠKIUKAI;4094713096;Taip;0;3;3;6
5450;Lazdynėlis;MEŠKIUKAI;4267469349;Taip;0;3;0;3
5451;Lazdynėlis;MEŠKIUKAI;5354852979;Taip;0;18;0;18
5452;Lazdynėlis;MEŠKIUKAI;3427972329;Taip;7;3;0;10
5453;Lazdynėlis;MEŠKIUKAI;6941986839;Taip;8;3;1;12
5454;Lazdynėlis;MEŠKIUKAI;3697808826;Taip;5;3;0;8
5455;Lazdynėlis;MEŠKIUKAI;2812633983;Taip;4;3;0;7
5456;Lazdynėlis;MEŠKIUKAI;9590507486;Taip;0;3;1;4
5457;Lazdynėlis;MEŠKIUKAI;1488371861;Taip;0;3;5;8
5458;Lazdynėlis;MEŠKIUKAI;5982766841;Taip;0;18;0;18
5459;Lazdynėlis;MEŠKIUKAI;1984546310;Taip;4;8;0;12
5460;Lazdynėlis;MEŠKIUKAI;4408660083;Taip;0;18;0;18
5461;Lazdynėlis;MEŠKIUKAI;9930553716;Taip;0;3;0;3
5462;Lazdynėlis;MEŠKIUKAI;6831456807;Taip;0;3;1;4
5463;Lazdynėlis;MEŠKIUKAI;4795464133;Taip;0;3;0;3
5464;Lazdynėlis;MEŠKIUKAI;8567304224;Taip;8;0;1;9
5465;Lazdynėlis;MEŠKIUKAI;7754329238;Taip;8;3;0;11
5466;Lazdynėlis;MEŠKIUKAI;4366502064;Taip;0;3;0;3
5467;Lazdynėlis;MEŠKIUKAI;1331380925;Taip;0;18;0;18
5468;Liepsnelė;Ramunėlės;6566895135;Taip;7;0;0;7
5469;Liepsnelė;Ramunėlės;6294010142;Taip;3;0;0;3
5470;Liepsnelė;Ramunėlės;2522846125;Taip;5;0;0;5
5471;Liepsnelė;Ramunėlės;5037883064;Taip;5;0;0;5
5472;Liepsnelė;Ramunėlės;3467086136;Taip;7;0;0;7
5473;Liepsnelė;Ramunėlės;5448328929;Taip;18;0;0;18
5474;Liepsnelė;Ramunėlės;9350715010;Taip;10;0;0;10
5475;Liepsnelė;Ramunėlės;1214516126;Taip;21;0;0;21
5476;Liepsnelė;Ramunėlės;3982153133;Taip;8;0;0;8
5477;Liepsnelė;Zuikučiai;4798353152;Taip;14;0;0;14
5478;Liepsnelė;Zuikučiai;1125190558;Taip;8;0;0;8
5479;Liepsnelė;Zuikučiai;1132758499;Taip;17;0;0;17
5480;Liepsnelė;Zuikučiai;9463386166;Taip;12;0;0;12
5481;Liepsnelė;Zuikučiai;3774949481;Taip;9;0;0;9
5482;Liepsnelė;Nykštukai;2495718547;Taip;5;0;0;5
5483;Liepsnelė;Nykštukai;3654667879;Taip;6;0;0;6
5484;Liepsnelė;Nykštukai;9993335478;Taip;21;0;0;21
5485;Liepsnelė;Nykštukai;6417648753;Taip;5;0;0;5
5486;Liepsnelė;Nykštukai;4070825932;Taip;6;0;0;6
5487;Liepsnelė;Nykštukai;9950106412;Taip;6;0;0;6
5488;Liepsnelė;Nykštukai;5909672361;Ne;14;0;0;14
5489;Liepsnelė;Žvirbliukai;8080492986;Taip;12;0;0;12
5490;Liepsnelė;Žvirbliukai;7735063486;Taip;2;0;0;2
5491;Liepsnelė;Žvirbliukai;4234425668;Taip;5;0;0;5
5492;Liepsnelė;Žvirbliukai;5532685692;Taip;7;0;0;7
5493;Liepsnelė;Žvirbliukai;7555183487;Taip;7;0;0;7
5494;Liepsnelė;Žvirbliukai;1625321820;Taip;12;0;0;12
5495;Liepsnelė;Žvirbliukai;2080374597;Taip;10;0;0;10
5496;Liepsnelė;Meškiukai;4211555762;Taip;4;0;0;4
5497;Liepsnelė;Meškiukai;5138923652;Taip;10;0;0;10
5498;Liepsnelė;Meškiukai;8357286679;Taip;8;0;0;8
5499;Liepsnelė;Meškiukai;7007685622;Taip;9;0;0;9
5500;Liepsnelė;Meškiukai;1860301365;Taip;10;0;0;10
5501;Liepsnelė;Meškiukai;4080298620;Taip;8;0;0;8
5502;Liepsnelė;Meškiukai;2326664705;Taip;8;0;0;8
5503;Liepsnelė;Meškiukai;6568963048;Taip;9;0;0;9
5504;Liepsnelė;SAULUTĖ;1055874233;Taip;3;0;0;3
5505;Liepsnelė;SAULUTĖ;7853574888;Taip;5;0;0;5
5506;Liepsnelė;SAULUTĖ;9864646484;Taip;13;0;0;13
5507;Liepsnelė;SAULUTĖ;8598242099;Taip;1;0;0;1
5508;Liepsnelė;Varpeliai;1487219062;Taip;11;0;0;11
5509;Liepsnelė;Varpeliai;7241069517;Taip;21;0;0;21
5510;"Lokiuko giraitė";Drugelių;8091538511;Taip;4;0;0;4
5511;"Lokiuko giraitė";BORUŽĖLIŲ;3670756949;Taip;6;0;0;6
5512;Markučiai;Žirniukų;3525681034;Taip;0;1;6;7
5513;Markučiai;Žirniukų;7312533881;Taip;0;1;6;7
5514;Markučiai;Žirniukų;8679791696;Taip;5;0;2;7
5515;Markučiai;Žirniukų;5269411010;Taip;19;0;0;19
5516;Markučiai;Žirniukų;5250815223;Taip;10;0;2;12
5517;Markučiai;Žirniukų;8934965409;Taip;0;2;1;3
5518;Markučiai;Žirniukų;8360526946;Taip;10;12;0;22
5519;Markučiai;Žirniukų;7244815252;Taip;4;0;0;4
5520;Markučiai;Žirniukų;2096169972;Taip;0;0;3;3
5521;Markučiai;Žirniukų;3073404128;Taip;0;4;1;5
5522;Markučiai;Žirniukų;6674351628;Taip;4;0;2;6
5523;Markučiai;Žirniukų;5614488534;Taip;3;2;4;9
5524;Markučiai;Žirniukų;2367999201;Taip;2;0;7;9
5525;Markučiai;Žirniukų;4242575616;Taip;3;0;3;6
5526;Markučiai;Žirniukų;4223653505;Taip;9;3;2;14
5527;Markučiai;Žirniukų;3802897432;Taip;0;0;12;12
5528;Markučiai;Žirniukų;2099285475;Taip;0;3;16;19
5529;Markučiai;Žirniukų;2344252204;Ne;8;1;11;20
5530;Markučiai;Žirniukų;9576412366;Taip;7;2;0;9
5531;Markučiai;Žirniukų;1395241501;Taip;16;0;4;20
5532;Markučiai;Nykštukų;7507551844;Taip;0;1;0;1
5533;Markučiai;Nykštukų;9545967631;Taip;5;1;0;6
5534;Markučiai;Nykštukų;6121911851;Taip;7;0;0;7
5535;Markučiai;Nykštukų;6898055631;Taip;6;1;1;8
5536;Markučiai;Nykštukų;3378749042;Taip;15;3;0;18
5537;Markučiai;Nykštukų;1884388847;Taip;0;1;0;1
5538;Markučiai;Nykštukų;2170380827;Taip;0;5;2;7
5539;Markučiai;Nykštukų;4485929800;Taip;0;0;5;5
5540;Markučiai;Nykštukų;5183244346;Taip;0;2;0;2
5541;Markučiai;Nykštukų;7624913025;Taip;0;9;0;9
5542;Markučiai;Nykštukų;4679710493;Taip;0;0;3;3
5543;Markučiai;Nykštukų;2994895532;Taip;3;3;1;7
5544;Markučiai;Nykštukų;4150956779;Taip;4;4;0;8
5545;Markučiai;Nykštukų;7680126946;Taip;5;0;6;11
5546;Markučiai;Nykštukų;4222017733;Taip;9;0;1;10
5547;Markučiai;Nykštukų;3414015064;Taip;8;0;3;11
5548;Markučiai;Nykštukų;7642401516;Taip;0;0;3;3
5549;Markučiai;Nykštukų;8055783293;Taip;5;0;5;10
5550;Markučiai;Pelėdžiukų;9180404247;Taip;0;0;7;7
5551;Markučiai;Pelėdžiukų;3386071459;Taip;0;9;0;9
5552;Markučiai;Pelėdžiukų;4653663237;Taip;8;0;0;8
5553;Markučiai;Pelėdžiukų;5727655114;Taip;0;0;5;5
5554;Markučiai;Pelėdžiukų;6740434675;Taip;0;0;2;2
5555;Markučiai;Pelėdžiukų;6707310242;Taip;0;0;8;8
5556;Markučiai;Pelėdžiukų;7947287013;Taip;5;3;0;8
5557;Markučiai;Pelėdžiukų;2543313198;Taip;0;3;1;4
5558;Markučiai;Pelėdžiukų;4418580273;Taip;8;0;0;8
5559;Markučiai;Pelėdžiukų;5522654429;Taip;4;5;2;11
5560;Markučiai;Pelėdžiukų;9219710045;Taip;0;0;1;1
5561;Markučiai;Pelėdžiukų;7539605426;Taip;3;0;3;6
5562;Markučiai;Pelėdžiukų;8888538915;Taip;7;0;1;8
5563;Markučiai;Pelėdžiukų;1799946177;Taip;4;0;0;4
5564;Markučiai;Pelėdžiukų;7809719827;Taip;3;0;3;6
5565;Markučiai;Pelėdžiukų;4860961508;Taip;3;0;0;3
5566;Markučiai;Pelėdžiukų;6260010822;Taip;7;0;2;9
5567;Markučiai;Pelėdžiukų;6569807889;Taip;0;6;0;6
5568;Markučiai;Boružėlių;1171899107;Taip;5;3;0;8
5569;Markučiai;Boružėlių;8078777204;Taip;5;3;0;8
5570;Markučiai;Boružėlių;8244065962;Taip;3;3;0;6
5571;Markučiai;Boružėlių;5902165968;Taip;18;0;0;18
5572;Markučiai;Boružėlių;5981692282;Taip;0;4;0;4
5573;Markučiai;Boružėlių;3739566642;Taip;5;4;0;9
5574;Markučiai;Boružėlių;6868394315;Taip;0;2;0;2
5575;Markučiai;Boružėlių;7634475536;Ne;0;0;3;3
5576;Markučiai;Boružėlių;5663147778;Taip;0;3;9;12
5577;Markučiai;Boružėlių;8271830626;Taip;0;3;3;6
5578;Markučiai;Boružėlių;8046320044;Ne;10;3;0;13
5579;Markučiai;Boružėlių;4244217571;Taip;15;0;1;16
5580;Markučiai;Boružėlių;3315824027;Taip;0;12;1;13
5581;Markučiai;Boružėlių;2060024771;Taip;3;0;1;4
5582;Markučiai;Boružėlių;2539486337;Taip;0;3;2;5
5583;Markučiai;Boružėlių;5562960498;Ne;7;2;0;9
5584;Markučiai;Boružėlių;3296423510;Taip;0;0;2;2
5585;Markučiai;Boružėlių;2526619144;Taip;0;0;2;2
5586;Markučiai;Bitučių;1720541082;Taip;4;4;3;11
5587;Markučiai;Bitučių;8792524832;Taip;0;6;0;6
5588;Markučiai;Bitučių;1717624510;Taip;0;0;1;1
5589;Markučiai;Bitučių;9518247571;Taip;0;4;4;8
5590;Markučiai;Bitučių;4836298058;Taip;0;0;9;9
5591;Markučiai;Bitučių;9027071539;Taip;5;2;0;7
5592;Markučiai;Bitučių;8748794886;Taip;0;0;26;26
5593;Markučiai;Bitučių;7387460586;Taip;0;4;0;4
5594;Markučiai;Bitučių;8950442843;Taip;5;0;13;18
5595;Markučiai;Bitučių;2840564082;Taip;0;1;0;1
5596;Markučiai;Bitučių;3926993383;Taip;2;6;7;15
5597;Markučiai;Bitučių;6530101961;Taip;0;3;6;9
5598;Markučiai;Bitučių;1908302738;Taip;4;1;7;12
5599;Markučiai;Bitučių;7056367646;Taip;11;4;2;17
5600;Markučiai;Bitučių;8195584468;Taip;0;0;2;2
5601;Markučiai;Bitučių;2049497686;Taip;0;3;5;8
5602;Markučiai;Bitučių;8541042547;Taip;0;0;2;2
5603;Markučiai;Bitučių;1447116821;Taip;0;0;7;7
5604;Markučiai;Bitučių;2931958829;Taip;0;4;2;6
5605;Markučiai;Drugelių;2537459830;Taip;0;3;0;3
5606;Markučiai;Drugelių;3544565354;Taip;12;0;1;13
5607;Markučiai;Drugelių;6992161129;Taip;0;0;1;1
5608;Markučiai;Drugelių;5024860112;Taip;0;1;1;2
5609;Markučiai;Drugelių;9412129807;Taip;2;5;0;7
5610;Markučiai;Drugelių;6979218594;Taip;5;0;3;8
5611;Markučiai;Drugelių;3491734422;Taip;0;0;6;6
5612;Markučiai;Drugelių;3491734422;Taip;0;0;6;6
5613;Markučiai;Drugelių;3491734422;Taip;0;0;6;6
5614;Markučiai;Drugelių;3832641521;Taip;5;3;4;12
5615;Markučiai;Drugelių;4520724770;Taip;3;0;5;8
5616;Markučiai;Drugelių;8050852518;Taip;0;0;1;1
5617;Markučiai;Drugelių;9391866085;Taip;0;0;9;9
5618;Markučiai;Drugelių;9073616238;Taip;1;0;2;3
5619;Markučiai;Drugelių;4918717178;Taip;13;0;1;14
5620;Markučiai;Drugelių;2967726802;Taip;0;0;10;10
5621;Markučiai;Drugelių;6684544229;Taip;0;0;3;3
5622;Markučiai;Skruzdėliukų;5566529492;Taip;5;3;0;8
5623;Markučiai;Skruzdėliukų;8105747904;Taip;6;1;3;10
5624;Markučiai;Skruzdėliukų;6617799980;Taip;0;8;0;8
5625;Markučiai;Skruzdėliukų;4369408254;Taip;10;0;0;10
5626;Markučiai;Skruzdėliukų;7580249913;Taip;11;0;0;11
5627;Markučiai;Skruzdėliukų;2246646548;Taip;18;0;0;18
5628;Markučiai;Skruzdėliukų;9921530582;Taip;4;0;3;7
5629;Markučiai;Skruzdėliukų;6759427415;Taip;6;0;1;7
5630;Markučiai;Skruzdėliukų;4820576711;Taip;6;8;1;15
5631;Markučiai;Skruzdėliukų;1527620947;Taip;8;7;0;15
5632;Markučiai;Skruzdėliukų;8774323234;Taip;6;0;0;6
5633;Markučiai;Skruzdėliukų;7881183912;Taip;15;0;0;15
5634;Markučiai;Skruzdėliukų;9338996275;Taip;7;0;0;7
5635;Markučiai;Skruzdėliukų;5180034556;Taip;4;0;1;5
5636;Markučiai;Skruzdėliukų;4383128686;Taip;14;0;0;14
5637;Markučiai;ZUIKUČIŲ;4861535057;Taip;0;4;0;4
5638;Markučiai;ZUIKUČIŲ;11751635395;Taip;0;7;0;7
5639;Markučiai;ZUIKUČIŲ;1184908076;Taip;0;4;3;7
5640;Markučiai;ZUIKUČIŲ;7729045227;Taip;5;11;0;16
5641;Markučiai;ZUIKUČIŲ;8061880631;Taip;0;4;0;4
5642;Markučiai;ZUIKUČIŲ;1392582514;Taip;11;5;0;16
5643;Markučiai;ZUIKUČIŲ;7691410556;Taip;0;17;0;17
5644;Markučiai;ZUIKUČIŲ;6453095915;Taip;3;3;3;9
5645;Markučiai;ZUIKUČIŲ;6808291628;Taip;4;13;0;17
5646;Markučiai;ZUIKUČIŲ;5387571295;Taip;5;4;0;9
5647;Markučiai;ZUIKUČIŲ;3794643964;Taip;0;3;0;3
5648;Markučiai;ZUIKUČIŲ;91228262895;Taip;3;4;2;9
5649;Markučiai;ZUIKUČIŲ;5749873170;Taip;0;4;1;5
5650;Markučiai;ZUIKUČIŲ;8605357678;Taip;0;4;1;5
5651;Markučiai;ZUIKUČIŲ;6055058096;Taip;10;1;0;11
5652;Markučiai;ZUIKUČIŲ;1956224017;Taip;0;0;2;2
5653;Markučiai;ŽIOGELIŲ;3163226803;Taip;11;3;0;14
5654;Markučiai;ŽIOGELIŲ;1244026489;Taip;0;4;0;4
5655;Markučiai;ŽIOGELIŲ;76025616287;Ne;0;4;0;4
5656;Markučiai;ŽIOGELIŲ;54892037118;Taip;0;6;1;7
5657;Markučiai;ŽIOGELIŲ;1054802708;Taip;3;3;0;6
5658;Markučiai;ŽIOGELIŲ;67074776419;Taip;0;4;0;4
5659;Markučiai;ŽIOGELIŲ;1007919702;Taip;0;9;0;9
5660;Markučiai;ŽIOGELIŲ;1923521405;Taip;0;4;0;4
5661;Markučiai;ŽIOGELIŲ;1164386108;Taip;0;4;0;4
5662;Markučiai;ŽIOGELIŲ;7850311496;Ne;0;8;0;8
5663;Markučiai;ŽIOGELIŲ;2169583290;Ne;0;9;0;9
5664;Markučiai;ŽIOGELIŲ;3340385503;Taip;0;3;2;5
5665;Markučiai;ŽIOGELIŲ;4152184290;Taip;3;3;0;6
5666;Markučiai;ŽIOGELIŲ;1742944578;Taip;0;3;0;3
5667;Markučiai;ŽIOGELIŲ;23267867195;Taip;0;0;1;1
5668;Markučiai;ŽIOGELIŲ;7481923902;Taip;0;4;0;4
5669;Markučiai;ŽIOGELIŲ;4324776209;Ne;0;4;4;8
5670;Markučiai;ŽIOGELIŲ;3893711315;Taip;0;3;0;3
5671;Markučiai;Ežiukių;1827829954;Taip;0;3;0;3
5672;Markučiai;Ežiukių;4925856706;Taip;0;8;0;8
5673;Markučiai;Ežiukių;6570638672;Taip;0;5;0;5
5674;Markučiai;Ežiukių;5975331223;Taip;0;3;0;3
5675;Markučiai;Ežiukių;2687320408;Taip;0;3;0;3
5676;Markučiai;Ežiukių;8990923872;Taip;0;13;0;13
5677;Markučiai;Ežiukių;5246980173;Taip;0;1;0;1
5678;Markučiai;Ežiukių;6308368050;Taip;0;3;3;6
5679;Markučiai;Ežiukių;4249158803;Taip;5;4;0;9
5680;Markučiai;Ežiukių;5958705106;Taip;4;2;0;6
5681;Markučiai;Ežiukių;7791500322;Taip;0;3;0;3
5682;Markučiai;Ežiukių;9059302464;Taip;2;1;1;4
5683;Markučiai;Ežiukių;2962530721;Taip;0;3;0;3
5684;Markučiai;Ežiukių;6574037877;Taip;5;2;0;7
5685;Markučiai;Ežiukių;5752762229;Taip;0;4;0;4
5686;Markučiai;Ežiukių;4383421917;Taip;0;2;0;2
5687;Markučiai;Ežiukių;9789274040;Taip;0;8;0;8
5688;Mažylis;"4 PRIEŠMOKYKLINĖ GR.";9411559447;Taip;0;0;7;7
5689;Mažylis;"4 PRIEŠMOKYKLINĖ GR.";4252408251;Taip;2;0;3;5
5690;Mažylis;"4 PRIEŠMOKYKLINĖ GR.";4503734408;Taip;0;0;7;7
5691;Mažylis;"4 PRIEŠMOKYKLINĖ GR.";8352202912;Taip;0;3;0;3
5692;Mažylis;"4 PRIEŠMOKYKLINĖ GR.";38277640135;Taip;8;0;5;13
5693;Mažylis;"4 PRIEŠMOKYKLINĖ GR.";1663347167;Taip;0;1;8;9
5694;Mažylis;"4 PRIEŠMOKYKLINĖ GR.";6854350717;Taip;0;0;4;4
5695;Mažylis;"4 PRIEŠMOKYKLINĖ GR.";6920129837;Taip;0;0;4;4
5696;Mažylis;"4 PRIEŠMOKYKLINĖ GR.";4104052524;Taip;1;0;4;5
5697;Mažylis;"4 PRIEŠMOKYKLINĖ GR.";1460572347;Taip;0;3;0;3
5698;Mažylis;"4 PRIEŠMOKYKLINĖ GR.";3860760654;Taip;0;3;0;3
5699;Mažylis;"4 PRIEŠMOKYKLINĖ GR.";7185347381;Taip;0;3;4;7
5700;Mažylis;"4 PRIEŠMOKYKLINĖ GR.";3344476309;Taip;0;0;3;3
5701;Mažylis;"4 PRIEŠMOKYKLINĖ GR.";6851169340;Taip;0;0;5;5
5702;Mažylis;"4 PRIEŠMOKYKLINĖ GR.";4486742281;Taip;0;0;1;1
5703;Mažylis;"4 PRIEŠMOKYKLINĖ GR.";3217527771;Taip;0;3;1;4
5704;Mažylis;"4 PRIEŠMOKYKLINĖ GR.";7416381505;Taip;2;0;4;6
5705;Mažylis;"4 PRIEŠMOKYKLINĖ GR.";1514640197;Taip;0;0;4;4
5706;Mažylis;"4 PRIEŠMOKYKLINĖ GR.";1002832487;Taip;0;0;3;3
5707;Mažylis;"4 PRIEŠMOKYKLINĖ GR.";9608529135;Taip;0;0;7;7
5708;Mažylis;"4 PRIEŠMOKYKLINĖ GR.";4645411379;Taip;0;3;0;3
5709;Mažylis;"3 DARŽELIO GR.";3081814579;Taip;2;3;2;7
5710;Mažylis;"3 DARŽELIO GR.";6100650710;Taip;0;0;3;3
5711;Mažylis;"3 DARŽELIO GR.";9401388775;Taip;0;0;8;8
5712;Mažylis;"3 DARŽELIO GR.";4817146074;Taip;3;3;0;6
5713;Mažylis;"3 DARŽELIO GR.";7106648054;Taip;0;0;3;3
5714;Mažylis;"3 DARŽELIO GR.";6809320247;Taip;0;3;0;3
5715;Mažylis;"3 DARŽELIO GR.";7652390515;Taip;12;0;3;15
5716;Mažylis;"3 DARŽELIO GR.";8639480781;Taip;0;6;0;6
5717;Mažylis;"3 DARŽELIO GR.";9341935211;Taip;0;0;7;7
5718;Mažylis;"3 DARŽELIO GR.";2989562406;Taip;0;0;6;6
5719;Mažylis;"3 DARŽELIO GR.";1151737098;Taip;0;3;1;4
5720;Mažylis;"3 DARŽELIO GR.";7642914458;Taip;0;6;0;6
5721;Mažylis;"3 DARŽELIO GR.";5938312001;Taip;12;0;0;12
5722;Mažylis;"3 DARŽELIO GR.";2119733659;Taip;5;0;3;8
5723;Mažylis;"3 DARŽELIO GR.";3126627913;Taip;1;3;6;10
5724;Mažylis;"3 DARŽELIO GR.";6904083734;Taip;0;0;3;3
5725;Mažylis;"3 DARŽELIO GR.";1420913875;Taip;0;0;1;1
5726;Mažylis;"3 DARŽELIO GR.";2319506343;Taip;11;3;1;15
5727;Mažylis;"3 DARŽELIO GR.";9416161833;Taip;0;0;5;5
5728;Mažylis;"6 DARŽELIO GR.";5388105083;Taip;0;0;6;6
5729;Mažylis;"6 DARŽELIO GR.";3641990617;Taip;0;0;4;4
5730;Mažylis;"6 DARŽELIO GR.";1892136590;Taip;0;3;0;3
5731;Mažylis;"6 DARŽELIO GR.";9479398581;Taip;0;3;0;3
5732;Mažylis;"6 DARŽELIO GR.";1381828313;Taip;0;0;9;9
5733;Mažylis;"6 DARŽELIO GR.";7725286603;Taip;0;1;9;10
5734;Mažylis;"6 DARŽELIO GR.";7754956214;Taip;0;0;6;6
5735;Mažylis;"6 DARŽELIO GR.";3615636349;Taip;0;0;5;5
5736;Mažylis;"6 DARŽELIO GR.";9894955253;Taip;9;0;4;13
5737;Mažylis;"6 DARŽELIO GR.";3400122626;Taip;0;0;3;3
5738;Mažylis;"6 DARŽELIO GR.";6270840529;Taip;8;0;5;13
5739;Mažylis;"6 DARŽELIO GR.";4100492642;Taip;5;0;9;14
5740;Mažylis;"6 DARŽELIO GR.";5569913242;Taip;0;0;5;5
5741;Mažylis;"6 DARŽELIO GR.";7841955949;Taip;5;0;10;15
5742;Mažylis;"6 DARŽELIO GR.";6492768766;Ne;0;0;3;3
5743;Mažylis;"6 DARŽELIO GR.";6423910850;Taip;0;11;5;16
5744;Mažylis;"6 DARŽELIO GR.";1555305826;Taip;0;3;0;3
5745;Mažylis;"6 DARŽELIO GR.";5977423702;Taip;0;0;5;5
5746;Mažylis;"6 DARŽELIO GR.";9562863405;Taip;5;0;4;9
5747;Mažylis;"6 DARŽELIO GR.";5990843024;Taip;9;0;3;12
5748;Mažylis;"6 DARŽELIO GR.";9981751097;Taip;0;0;7;7
5749;Mažylis;"1 NAUJA (LOPŠELIS)";7037435201;Taip;1;0;3;4
5750;Mažylis;"1 NAUJA (LOPŠELIS)";4985161657;Taip;15;0;0;15
5751;Mažylis;"1 NAUJA (LOPŠELIS)";5297935198;Taip;12;1;0;13
5752;Mažylis;"1 NAUJA (LOPŠELIS)";1993916098;Taip;5;0;4;9
5753;Mažylis;"1 NAUJA (LOPŠELIS)";4309902086;Taip;0;0;6;6
5754;Mažylis;"1 NAUJA (LOPŠELIS)";5727207294;Taip;0;0;6;6
5755;Mažylis;"1 NAUJA (LOPŠELIS)";3064367996;Taip;7;4;0;11
5756;Mažylis;"1 NAUJA (LOPŠELIS)";2110320072;Taip;0;0;3;3
5757;Mažylis;"1 NAUJA (LOPŠELIS)";7810360699;Taip;0;0;6;6
5758;Mažylis;"1 NAUJA (LOPŠELIS)";3911343193;Taip;0;0;5;5
5759;Mažylis;"1 NAUJA (LOPŠELIS)";5225388496;Taip;0;3;3;6
5760;Mažylis;"1 NAUJA (LOPŠELIS)";8259994523;Taip;0;0;1;1
5761;Mažylis;"1 NAUJA (LOPŠELIS)";6500577246;Taip;0;3;1;4
5762;Mažylis;"1 NAUJA (LOPŠELIS)";3098913589;Taip;0;0;3;3
5763;Mažylis;"1 NAUJA (LOPŠELIS)";4201114033;Taip;6;0;3;9
5764;Mažylis;"1 NAUJA (LOPŠELIS)";9025867358;Taip;0;0;4;4
5765;Mažylis;"1 NAUJA (LOPŠELIS)";8871998701;Taip;0;3;6;9
5766;Mažylis;"5 DARŽELIO GR.";2935175014;Taip;11;0;4;15
5767;Mažylis;"5 DARŽELIO GR.";2979849055;Taip;0;0;1;1
5768;Mažylis;"5 DARŽELIO GR.";6162880220;Taip;0;3;1;4
5769;Mažylis;"5 DARŽELIO GR.";1762105763;Taip;0;2;0;2
5770;Mažylis;"5 DARŽELIO GR.";2672500259;Taip;0;0;3;3
5771;Mažylis;"5 DARŽELIO GR.";8135596731;Taip;0;0;5;5
5772;Mažylis;"5 DARŽELIO GR.";8866980930;Taip;0;1;1;2
5773;Mažylis;"5 DARŽELIO GR.";2704741847;Ne;5;3;0;8
5774;Mažylis;"5 DARŽELIO GR.";3327673298;Taip;0;3;1;4
5775;Mažylis;"5 DARŽELIO GR.";4280547746;Taip;0;3;0;3
5776;Mažylis;"5 DARŽELIO GR.";9447747294;Taip;0;0;12;12
5777;Mažylis;"5 DARŽELIO GR.";4542742002;Taip;7;0;2;9
5778;Mažylis;"5 DARŽELIO GR.";2126108232;Taip;0;4;2;6
5779;Mažylis;"5 DARŽELIO GR.";8297427176;Taip;0;0;4;4
5780;Mažylis;"5 DARŽELIO GR.";6009637985;Taip;0;0;1;1
5781;Mažylis;"5 DARŽELIO GR.";5685988186;Taip;0;0;3;3
5782;Mažylis;"5 DARŽELIO GR.";5870983755;Taip;0;3;2;5
5783;Mažylis;"5 DARŽELIO GR.";8999239172;Taip;0;3;0;3
5784;Mažylis;"5 DARŽELIO GR.";3365026025;Taip;0;0;3;3
5785;Mažylis;"DARŽELIS 2 GR.";2795618410;Taip;6;3;2;11
5786;Mažylis;"DARŽELIS 2 GR.";9727982334;Taip;18;0;0;18
5787;Mažylis;"DARŽELIS 2 GR.";8655053217;Taip;10;3;1;14
5788;Mažylis;"DARŽELIS 2 GR.";7414398772;Taip;5;0;0;5
5789;Mažylis;"DARŽELIS 2 GR.";1058725505;Taip;13;5;0;18
5790;Mažylis;"DARŽELIS 2 GR.";4880415881;Taip;0;0;1;1
5791;Mažylis;"DARŽELIS 2 GR.";1219174313;Taip;4;0;3;7
5792;Mažylis;"DARŽELIS 2 GR.";9111101357;Taip;14;0;2;16
5793;Mažylis;"DARŽELIS 2 GR.";1533948576;Taip;0;8;2;10
5794;Mažylis;"DARŽELIS 2 GR.";6728351360;Taip;8;0;3;11
5795;Mažylis;"DARŽELIS 2 GR.";6272047137;Taip;0;0;4;4
5796;Mažylis;"DARŽELIS 2 GR.";7255856938;Taip;3;2;5;10
5797;Mažylis;"DARŽELIS 2 GR.";4987487972;Taip;17;0;1;18
5798;Mažylis;"DARŽELIS 2 GR.";9555408203;Taip;0;0;4;4
5799;Mažylis;"DARŽELIS 2 GR.";5165268747;Taip;2;0;4;6
5800;Mažylis;"DARŽELIS 2 GR.";2425437724;Taip;0;0;7;7
5801;Mažylis;"DARŽELIS 2 GR.";2723677422;Taip;0;0;13;13
5802;Mažylis;"DARŽELIS 2 GR.";9875575387;Ne;6;3;0;9
5803;Mažylis;"DARŽELIS 2 GR.";5658868407;Taip;0;0;7;7
5804;Mažylis;"DARŽELIS 2 GR.";5137132420;Taip;8;3;0;11
5805;Medynėlis;BITUTĖS;6238256156;Ne;0;4;0;4
5806;Medynėlis;BITUTĖS;8711567312;Taip;0;0;7;7
5807;Medynėlis;BITUTĖS;2993705115;Taip;0;4;2;6
5808;Medynėlis;BITUTĖS;1504612730;Taip;6;1;2;9
5809;Medynėlis;BITUTĖS;5522261530;Taip;0;4;1;5
5810;Medynėlis;BITUTĖS;6576401514;Taip;5;0;0;5
5811;Medynėlis;BITUTĖS;4107846958;Taip;5;4;1;10
5812;Medynėlis;BITUTĖS;7296044569;Taip;11;3;0;14
5813;Medynėlis;BITUTĖS;4418330478;Taip;11;0;0;11
5814;Medynėlis;BITUTĖS;7042766873;Taip;0;0;4;4
5815;Medynėlis;BITUTĖS;6074296305;Taip;0;3;0;3
5816;Medynėlis;BITUTĖS;6815521895;Taip;9;0;3;12
5817;Medynėlis;BITUTĖS;4374464298;Taip;9;0;2;11
5818;Medynėlis;BITUTĖS;8107171123;Taip;11;4;0;15
5819;Medynėlis;BITUTĖS;4545707752;Taip;11;3;0;14
5820;Medynėlis;BITUTĖS;4419503239;Taip;4;0;4;8
5821;Medynėlis;BITUTĖS;7870261906;Taip;0;3;0;3
5822;Medynėlis;BITUTĖS;6466874318;Taip;0;5;0;5
5823;Medynėlis;BITUTĖS;2798305000;Taip;9;1;0;10
5824;Medynėlis;BITUTĖS;5440233814;Taip;0;5;4;9
5825;Medynėlis;BITUTĖS;4598267411;Taip;6;1;1;8
5826;Medynėlis;BITUTĖS;5194220650;Taip;0;0;1;1
5827;Medynėlis;DRUGELIAI;8987139302;Taip;0;3;0;3
5828;Medynėlis;DRUGELIAI;7886801955;Taip;0;1;0;1
5829;Medynėlis;DRUGELIAI;6127747445;Taip;0;1;0;1
5830;Medynėlis;DRUGELIAI;33981260502;Taip;0;3;0;3
5831;Medynėlis;DRUGELIAI;4581683292;Taip;2;5;0;7
5832;Medynėlis;DRUGELIAI;7633674694;Taip;0;3;0;3
5833;Medynėlis;DRUGELIAI;5530782065;Taip;5;3;0;8
5834;Medynėlis;DRUGELIAI;6343851636;Taip;0;4;0;4
5835;Medynėlis;DRUGELIAI;8948133343;Taip;0;3;0;3
5836;Medynėlis;DRUGELIAI;9413309043;Taip;0;3;0;3
5837;Medynėlis;DRUGELIAI;3773215372;Taip;6;3;0;9
5838;Medynėlis;DRUGELIAI;1795479738;Taip;5;6;0;11
5839;Medynėlis;DRUGELIAI;4024866819;Taip;5;3;0;8
5840;Medynėlis;DRUGELIAI;7244497661;Taip;2;3;0;5
5841;Medynėlis;DRUGELIAI;8775219704;Taip;0;1;0;1
5842;Medynėlis;DRUGELIAI;5269927048;Taip;0;4;0;4
5843;Medynėlis;DRUGELIAI;1827495325;Taip;0;3;0;3
5844;Medynėlis;DRUGELIAI;2540325264;Taip;1;3;0;4
5845;Medynėlis;DRUGELIAI;3870665108;Ne;0;5;0;5
5846;Medynėlis;DRUGELIAI;9670396828;Taip;3;2;0;5
5847;Medynėlis;DRUGELIAI;5551121950;Taip;0;3;0;3
5848;Medynėlis;DRUGELIAI;2627421550;Taip;0;3;0;3
5849;Medynėlis;DRUGELIAI;2794274146;Taip;0;5;0;5
5850;Medynėlis;SKRUZDĖLIUKAI;4783894465;Taip;0;0;7;7
5851;Medynėlis;SKRUZDĖLIUKAI;3905440176;Taip;0;0;3;3
5852;Medynėlis;SKRUZDĖLIUKAI;1142044361;Taip;3;3;0;6
5853;Medynėlis;SKRUZDĖLIUKAI;6802308420;Taip;5;0;0;5
5854;Medynėlis;SKRUZDĖLIUKAI;4645171858;Taip;5;3;0;8
5855;Medynėlis;SKRUZDĖLIUKAI;3947494044;Taip;0;5;2;7
5856;Medynėlis;SKRUZDĖLIUKAI;3295727210;Taip;0;5;0;5
5857;Medynėlis;SKRUZDĖLIUKAI;8441629302;Taip;0;5;0;5
5858;Medynėlis;SKRUZDĖLIUKAI;3761140697;Taip;12;1;1;14
5859;Medynėlis;SKRUZDĖLIUKAI;5330900656;Taip;5;0;4;9
5860;Medynėlis;SKRUZDĖLIUKAI;4897227188;Taip;10;4;1;15
5861;Medynėlis;SKRUZDĖLIUKAI;2339692406;Taip;1;0;5;6
5862;Medynėlis;SKRUZDĖLIUKAI;2433997383;Taip;15;1;0;16
5863;Medynėlis;SKRUZDĖLIUKAI;9873696787;Taip;16;0;0;16
5864;Medynėlis;VOVERIUKAI;6107849795;Taip;5;0;5;10
5865;Medynėlis;VOVERIUKAI;6826790492;Taip;0;3;1;4
5866;Medynėlis;VOVERIUKAI;2627655353;Taip;0;5;6;11
5867;Medynėlis;VOVERIUKAI;5267128750;Taip;0;3;1;4
5868;Medynėlis;VOVERIUKAI;7638618099;Taip;0;1;5;6
5869;Medynėlis;VOVERIUKAI;4488439037;Taip;6;3;0;9
5870;Medynėlis;VOVERIUKAI;4100792567;Taip;0;1;0;1
5871;Medynėlis;VOVERIUKAI;6101613567;Taip;0;0;1;1
5872;Medynėlis;VOVERIUKAI;1056744101;Taip;0;3;6;9
5873;Medynėlis;VOVERIUKAI;6485314750;Taip;0;3;0;3
5874;Medynėlis;VOVERIUKAI;7455041214;Ne;9;1;3;13
5875;Medynėlis;VOVERIUKAI;2234994999;Taip;0;3;0;3
5876;Medynėlis;VOVERIUKAI;3761845905;Taip;0;0;8;8
5877;Medynėlis;VOVERIUKAI;4217263449;Taip;0;0;5;5
5878;Medynėlis;VOVERIUKAI;9825580191;Taip;0;3;0;3
5879;Medynėlis;VOVERIUKAI;3554823424;Taip;0;3;0;3
5880;Medynėlis;VOVERIUKAI;7272017225;Taip;0;9;0;9
5881;Medynėlis;VOVERIUKAI;4092824377;Taip;8;6;0;14
5882;Medynėlis;VOVERIUKAI;1475701065;Taip;0;4;0;4
5883;Medynėlis;VOVERIUKAI;3674134340;Taip;0;6;3;9
5884;Medynėlis;VOVERIUKAI;5028189785;Taip;6;0;0;6
5885;Medynėlis;VOVERIUKAI;3235523199;Taip;18;0;0;18
5886;Medynėlis;VOVERIUKAI;2784942324;Taip;0;3;0;3
5887;Medynėlis;MEŠKIUKAI;2086963376;Taip;0;3;0;3
5888;Medynėlis;MEŠKIUKAI;7740591575;Taip;0;7;0;7
5889;Medynėlis;MEŠKIUKAI;9304002459;Taip;0;1;1;2
5890;Medynėlis;MEŠKIUKAI;5586407412;Taip;0;1;0;1
5891;Medynėlis;MEŠKIUKAI;90556319090;Taip;5;4;0;9
5892;Medynėlis;MEŠKIUKAI;2834559432;Taip;10;3;2;15
5893;Medynėlis;MEŠKIUKAI;9800678364;Taip;12;3;0;15
5894;Medynėlis;MEŠKIUKAI;2057309788;Taip;0;1;1;2
5895;Medynėlis;MEŠKIUKAI;5982453884;Taip;0;3;0;3
5896;Medynėlis;MEŠKIUKAI;2310200034;Taip;0;4;0;4
5897;Medynėlis;MEŠKIUKAI;1750775033;Taip;10;3;0;13
5898;Medynėlis;MEŠKIUKAI;8441104709;Taip;0;3;2;5
5899;Medynėlis;MEŠKIUKAI;9123873119;Taip;0;7;0;7
5900;Medynėlis;MEŠKIUKAI;2335108073;Taip;5;1;0;6
5901;Medynėlis;MEŠKIUKAI;1237589979;Taip;10;3;0;13
5902;Medynėlis;MEŠKIUKAI;1820113382;Taip;0;3;0;3
5903;Medynėlis;MEŠKIUKAI;6406459222;Taip;5;3;6;14
5904;Medynėlis;MEŠKIUKAI;1173510831;Taip;0;3;0;3
5905;Medynėlis;MEŠKIUKAI;4985243068;Taip;15;3;0;18
5906;Medynėlis;MEŠKIUKAI;7108619017;Taip;3;0;3;6
5907;Medynėlis;MEŠKIUKAI;6999562417;Taip;15;3;0;18
5908;Medynėlis;MEŠKIUKAI;7140184593;Taip;9;3;0;12
5909;Medynėlis;MEŠKIUKAI;3141225891;Taip;5;3;1;9
5910;Medynėlis;PELĖDŽIUKAI;2932544910;Taip;0;3;0;3
5911;Medynėlis;PELĖDŽIUKAI;9079900803;Taip;7;3;1;11
5912;Medynėlis;PELĖDŽIUKAI;5571641847;Taip;0;1;1;2
5913;Medynėlis;PELĖDŽIUKAI;2103255454;Taip;0;5;0;5
5914;Medynėlis;PELĖDŽIUKAI;9355165862;Taip;5;1;2;8
5915;Medynėlis;PELĖDŽIUKAI;9184868565;Taip;5;0;1;6
5916;Medynėlis;PELĖDŽIUKAI;6706028300;Taip;0;3;0;3
5917;Medynėlis;PELĖDŽIUKAI;6955467123;Taip;5;3;0;8
5918;Medynėlis;PELĖDŽIUKAI;6073797962;Taip;8;3;0;11
5919;Medynėlis;PELĖDŽIUKAI;5785463517;Taip;0;0;3;3
5920;Medynėlis;PELĖDŽIUKAI;4222917765;Taip;0;3;2;5
5921;Medynėlis;PELĖDŽIUKAI;1621499650;Taip;10;3;0;13
5922;Medynėlis;PELĖDŽIUKAI;6681155625;Taip;0;3;0;3
5923;Medynėlis;PELĖDŽIUKAI;9438854582;Taip;0;3;2;5
5924;Medynėlis;PELĖDŽIUKAI;1901805808;Taip;0;4;4;8
5925;Medynėlis;PELĖDŽIUKAI;5784691118;Taip;0;4;5;9
5926;Medynėlis;PELĖDŽIUKAI;3856908872;Taip;0;3;0;3
5927;Medynėlis;PELĖDŽIUKAI;4468967036;Taip;0;3;0;3
5928;Medynėlis;PELĖDŽIUKAI;2702814930;Taip;0;3;1;4
5929;Medynėlis;PELĖDŽIUKAI;6113913885;Taip;0;6;1;7
5930;Medynėlis;BORUŽIUKAI;3787172254;Taip;8;3;0;11
5931;Medynėlis;BORUŽIUKAI;7232396755;Taip;3;1;1;5
5932;Medynėlis;BORUŽIUKAI;7651663404;Taip;3;3;3;9
5933;Medynėlis;BORUŽIUKAI;1463263793;Taip;0;11;0;11
5934;Medynėlis;BORUŽIUKAI;1406029765;Taip;5;0;1;6
5935;Medynėlis;BORUŽIUKAI;9764215406;Taip;0;3;0;3
5936;Medynėlis;BORUŽIUKAI;8271170887;Taip;0;3;0;3
5937;Medynėlis;BORUŽIUKAI;5532880670;Taip;5;3;4;12
5938;Medynėlis;BORUŽIUKAI;1525185037;Taip;0;5;0;5
5939;Medynėlis;BORUŽIUKAI;1333848517;Taip;0;3;0;3
5940;Medynėlis;BORUŽIUKAI;9919108302;Taip;0;6;0;6
5941;Medynėlis;BORUŽIUKAI;1162859552;Ne;0;6;0;6
5942;Medynėlis;BORUŽIUKAI;6032067904;Taip;0;1;0;1
5943;Medynėlis;BORUŽIUKAI;4315717555;Taip;2;3;0;5
5944;Medynėlis;BORUŽIUKAI;8276864168;Taip;13;0;0;13
5945;Medynėlis;BORUŽIUKAI;5544663829;Taip;0;4;0;4
5946;Medynėlis;BORUŽIUKAI;2701448160;Taip;2;1;0;3
5947;Medynėlis;BORUŽIUKAI;1658457155;Taip;8;3;1;12
5948;Medynėlis;BORUŽIUKAI;8074251036;Taip;0;3;0;3
5949;Medynėlis;BORUŽIUKAI;5158507933;Taip;18;0;0;18
5950;Medynėlis;BORUŽIUKAI;7501831333;Taip;0;3;0;3
5951;Medynėlis;BORUŽIUKAI;2097758483;Taip;0;4;0;4
5952;Medynėlis;BORUŽIUKAI;4267654911;Taip;7;1;0;8
5953;Medynėlis;EŽIUKAI;9729505759;Taip;10;6;0;16
5954;Medynėlis;EŽIUKAI;8125271445;Taip;0;10;0;10
5955;Medynėlis;EŽIUKAI;9847006679;Taip;7;4;0;11
5956;Medynėlis;EŽIUKAI;7317307957;Taip;0;0;7;7
5957;Medynėlis;EŽIUKAI;7860869675;Taip;3;3;2;8
5958;Medynėlis;EŽIUKAI;4471168173;Taip;5;3;0;8
5959;Medynėlis;EŽIUKAI;1062269215;Taip;6;5;3;14
5960;Medynėlis;EŽIUKAI;5197757730;Taip;7;3;0;10
5961;Medynėlis;EŽIUKAI;5333502849;Taip;0;1;3;4
5962;Medynėlis;EŽIUKAI;6536626390;Taip;12;0;0;12
5963;Medynėlis;EŽIUKAI;8953622684;Taip;0;0;4;4
5964;Medynėlis;EŽIUKAI;3230747109;Taip;0;3;3;6
5965;Medynėlis;EŽIUKAI;9175884049;Taip;0;0;2;2
5966;Medynėlis;EŽIUKAI;8609650186;Taip;0;3;3;6
5967;Medynėlis;EŽIUKAI;6826409129;Taip;0;0;3;3
5968;Medynėlis;EŽIUKAI;2929100410;Taip;0;3;0;3
5969;Medynėlis;EŽIUKAI;6359536923;Taip;8;3;0;11
5970;Medynėlis;EŽIUKAI;2676262920;Taip;0;0;6;6
5971;Medynėlis;EŽIUKAI;5339084041;Taip;0;3;1;4
5972;Medynėlis;EŽIUKAI;5766492584;Taip;5;3;0;8
5973;Medynėlis;EŽIUKAI;6561927001;Taip;0;3;0;3
5974;Medynėlis;EŽIUKAI;8838774666;Taip;18;0;0;18
5975;Medynėlis;EŽIUKAI;6349817783;Taip;5;0;0;5
5976;Medynėlis;ZUIKUČIAI;6614028601;Taip;12;0;0;12
5977;Medynėlis;ZUIKUČIAI;8439619837;Taip;6;0;1;7
5978;Medynėlis;ZUIKUČIAI;5389909872;Taip;0;4;0;4
5979;Medynėlis;ZUIKUČIAI;9352391583;Taip;10;0;0;10
5980;Medynėlis;ZUIKUČIAI;4941353702;Taip;0;5;6;11
5981;Medynėlis;ZUIKUČIAI;3709984586;Taip;1;0;0;1
5982;Medynėlis;ZUIKUČIAI;4040542730;Taip;2;0;4;6
5983;Medynėlis;ZUIKUČIAI;6989524053;Taip;7;0;5;12
5984;Medynėlis;ZUIKUČIAI;9774213537;Taip;8;0;0;8
5985;Medynėlis;ZUIKUČIAI;7129951535;Taip;0;4;0;4
5986;Medynėlis;ZUIKUČIAI;9977590259;Taip;0;1;7;8
5987;Medynėlis;ZUIKUČIAI;7170801214;Taip;5;0;4;9
5988;Medynėlis;ZUIKUČIAI;9373849916;Taip;18;0;0;18
5989;Medynėlis;ZUIKUČIAI;8678054784;Taip;0;3;0;3
5990;Medynėlis;ZUIKUČIAI;6462589513;Taip;0;3;0;3
5991;Medynėlis;ZUIKUČIAI;4204366008;Taip;0;4;0;4
5992;Medynėlis;ZUIKUČIAI;2523474347;Taip;18;0;0;18
5993;Medynėlis;KAČIUKAI;8275097931;Taip;10;3;2;15
5994;Medynėlis;KAČIUKAI;5302122600;Taip;8;0;0;8
5995;Medynėlis;KAČIUKAI;6609111216;Taip;0;0;4;4
5996;Medynėlis;KAČIUKAI;6624835214;Taip;4;0;3;7
5997;Medynėlis;KAČIUKAI;2160081492;Taip;0;6;1;7
5998;Medynėlis;KAČIUKAI;4035587227;Taip;18;0;0;18
5999;Medynėlis;KAČIUKAI;8162771849;Taip;6;0;4;10
6000;Medynėlis;KAČIUKAI;9725019515;Taip;5;0;2;7
6001;Medynėlis;KAČIUKAI;3185760752;Taip;3;0;4;7
6002;Medynėlis;KAČIUKAI;5610660982;Taip;5;0;3;8
6003;Medynėlis;KAČIUKAI;6282113738;Taip;0;0;8;8
6004;Medynėlis;KAČIUKAI;4153545500;Taip;4;5;0;9
6005;Medynėlis;KAČIUKAI;8299034970;Taip;0;0;3;3
6006;Medynėlis;KAČIUKAI;7675101600;Taip;0;3;1;4
6007;Medynėlis;KAČIUKAI;1668143166;Taip;0;3;3;6
6008;Medynėlis;KAČIUKAI;4010058673;Taip;12;1;0;13
6009;Medynėlis;KAČIUKAI;6502531749;Taip;0;0;6;6
6010;Medynėlis;KAČIUKAI;9076139419;Taip;0;7;3;10
6011;Medynėlis;KAČIUKAI;1608019909;Taip;6;4;0;10
6012;Medynėlis;KAČIUKAI;1026253778;Taip;0;0;6;6
6013;Medynėlis;KAČIUKAI;1404831377;Ne;2;0;5;7
6014;Medynėlis;PELIUKAI;6622963662;Taip;1;0;2;3
6015;Medynėlis;PELIUKAI;3638155321;Taip;11;0;3;14
6016;Medynėlis;PELIUKAI;4243521511;Taip;0;0;8;8
6017;Medynėlis;PELIUKAI;9290099536;Taip;2;4;0;6
6018;Medynėlis;PELIUKAI;1500986498;Taip;0;4;2;6
6019;Medynėlis;PELIUKAI;6924524346;Taip;9;0;0;9
6020;Medynėlis;PELIUKAI;2379829985;Taip;7;3;0;10
6021;Medynėlis;PELIUKAI;6926408544;Taip;0;0;3;3
6022;Medynėlis;PELIUKAI;5391199861;Taip;0;0;9;9
6023;Medynėlis;PELIUKAI;9485498942;Taip;0;3;0;3
6024;Medynėlis;PELIUKAI;6095795724;Taip;3;0;0;3
6025;Medynėlis;PELIUKAI;7695626630;Taip;0;4;0;4
6026;Medynėlis;PELIUKAI;3538656650;Taip;0;11;0;11
6027;Medynėlis;PELIUKAI;6993176904;Taip;0;0;3;3
6028;Medynėlis;PELIUKAI;2877881247;Taip;0;3;0;3
6029;Medynėlis;PELIUKAI;4145591997;Taip;6;0;0;6
6030;Medynėlis;PELIUKAI;8382537735;Taip;4;0;4;8
6031;Medynėlis;PELIUKAI;6470879334;Ne;5;0;4;9
6032;Medynėlis;PELIUKAI;2816510180;Taip;4;0;4;8
6033;Medynėlis;ANČIUKAI;9857514451;Taip;16;0;1;17
6034;Medynėlis;ANČIUKAI;6730475188;Taip;5;2;0;7
6035;Medynėlis;ANČIUKAI;6824842361;Taip;8;0;1;9
6036;Medynėlis;ANČIUKAI;5677747582;Taip;2;0;3;5
6037;Medynėlis;ANČIUKAI;4498233742;Taip;5;0;5;10
6038;Medynėlis;ANČIUKAI;5049081242;Taip;6;0;1;7
6039;Medynėlis;ANČIUKAI;4910857912;Taip;10;0;1;11
6040;Medynėlis;ANČIUKAI;4817353132;Taip;2;1;3;6
6041;Medynėlis;ANČIUKAI;7613699868;Taip;10;0;0;10
6042;Medynėlis;ANČIUKAI;9336656351;Taip;5;1;3;9
6043;Medynėlis;ANČIUKAI;7085226543;Taip;1;0;4;5
6044;Medynėlis;ANČIUKAI;1283602655;Taip;5;0;4;9
6045;Medynėlis;ANČIUKAI;3556203620;Taip;12;0;0;12
6046;Medynėlis;ANČIUKAI;2896713695;Taip;0;3;1;4
6047;Medynėlis;ANČIUKAI;8887092965;Taip;16;0;0;16
6048;Medynėlis;ANČIUKAI;4626655069;Taip;0;3;0;3
6049;Medynėlis;ANČIUKAI;5456045449;Taip;0;2;0;2
6050;Medynėlis;ANČIUKAI;8667441678;Taip;0;2;0;2
6051;Medynėlis;ANČIUKAI;6896823412;Taip;0;2;0;2
6052;Molinukas;NYKŠTUKAI;6353165459;Taip;0;2;0;2
6053;Molinukas;NYKŠTUKAI;5876669121;Taip;0;3;0;3
6054;Molinukas;NYKŠTUKAI;6087698882;Taip;0;3;0;3
6055;Molinukas;NYKŠTUKAI;2211909678;Taip;7;1;1;9
6056;Molinukas;NYKŠTUKAI;2348120316;Taip;0;2;0;2
6057;Molinukas;NYKŠTUKAI;8053608348;Taip;0;3;1;4
6058;Molinukas;NYKŠTUKAI;6014990150;Taip;0;3;0;3
6059;Molinukas;NYKŠTUKAI;7623051674;Taip;0;5;0;5
6060;Molinukas;NYKŠTUKAI;9448910819;Taip;5;0;0;5
6061;Molinukas;NYKŠTUKAI;1651650182;Taip;0;3;0;3
6062;Molinukas;NYKŠTUKAI;5580968328;Taip;7;1;0;8
6063;Molinukas;NYKŠTUKAI;8536615996;Taip;0;0;3;3
6064;Molinukas;NYKŠTUKAI;7602239077;Taip;0;3;0;3
6065;Molinukas;NYKŠTUKAI;1849018608;Taip;0;4;0;4
6066;Molinukas;NYKŠTUKAI;4171978721;Taip;0;2;1;3
6067;Molinukas;NYKŠTUKAI;7134802574;Taip;0;3;0;3
6068;Molinukas;NYKŠTUKAI;8260101075;Taip;0;3;0;3
6069;Molinukas;NYKŠTUKAI;9293819449;Taip;0;3;0;3
6070;Molinukas;NYKŠTUKAI;5525772579;Taip;0;5;0;5
6071;Molinukas;NYKŠTUKAI;4475594896;Taip;0;9;0;9
6072;Molinukas;NYKŠTUKAI;7248705010;Taip;0;7;0;7
6073;Molinukas;NYKŠTUKAI;4101644021;Taip;0;8;0;8
6074;Molinukas;NYKŠTUKAI;6681397435;Taip;7;0;2;9
6075;Molinukas;ZUIKUČIŲ;9203375647;Taip;5;6;0;11
6076;Molinukas;ZUIKUČIŲ;2982968605;Taip;6;3;1;10
6077;Molinukas;ZUIKUČIŲ;8479427729;Taip;0;2;3;5
6078;Molinukas;ZUIKUČIŲ;4225457772;Taip;5;0;3;8
6079;Molinukas;ZUIKUČIŲ;8114735116;Taip;0;4;0;4
6080;Molinukas;ZUIKUČIŲ;5597119459;Taip;10;3;0;13
6081;Molinukas;ZUIKUČIŲ;8582985479;Taip;11;0;0;11
6082;Molinukas;ZUIKUČIŲ;8490020853;Taip;11;0;0;11
6083;Molinukas;ZUIKUČIŲ;2651732418;Taip;8;1;0;9
6084;Molinukas;ZUIKUČIŲ;8988478990;Taip;0;0;2;2
6085;Molinukas;ZUIKUČIŲ;1059002689;Taip;0;14;4;18
6086;Molinukas;ZUIKUČIŲ;5302191209;Taip;13;0;4;17
6087;Molinukas;ZUIKUČIŲ;1605039166;Taip;5;0;4;9
6088;Molinukas;ZUIKUČIŲ;6804127471;Taip;5;0;4;9
6089;Molinukas;ZUIKUČIŲ;2878262979;Taip;0;3;2;5
6090;Molinukas;ZUIKUČIŲ;7441251480;Taip;0;0;3;3
6091;Molinukas;ZUIKUČIŲ;4733315902;Taip;0;0;4;4
6092;Molinukas;ZUIKUČIŲ;2595941277;Taip;0;0;2;2
6093;Molinukas;ZUIKUČIŲ;2706981559;Taip;4;3;0;7
6094;Molinukas;ZUIKUČIŲ;6638634402;Taip;0;0;1;1
6095;Molinukas;ZUIKUČIŲ;3516132254;Taip;0;0;1;1
6096;Molinukas;ZUIKUČIŲ;4718396549;Taip;13;0;0;13
6097;Molinukas;ZUIKUČIŲ;3577613732;Taip;5;0;6;11
6098;Molinukas;ZUIKUČIŲ;9972204424;Taip;2;0;0;2
6099;Molinukas;ZUIKUČIŲ;3419958136;Taip;5;0;2;7
6100;Molinukas;ZUIKUČIŲ;2789279432;Taip;1;3;0;4
6101;Molinukas;SRAIGIUKŲ;8416644024;Taip;0;3;2;5
6102;Molinukas;SRAIGIUKŲ;1686122652;Taip;0;3;0;3
6103;Molinukas;SRAIGIUKŲ;9948685221;Taip;0;3;2;5
6104;Molinukas;SRAIGIUKŲ;6326031969;Taip;0;3;3;6
6105;Molinukas;SRAIGIUKŲ;8393217418;Taip;0;3;1;4
6106;Molinukas;SRAIGIUKŲ;6636118069;Taip;0;3;1;4
6107;Molinukas;SRAIGIUKŲ;1469884686;Taip;0;3;2;5
6108;Molinukas;SRAIGIUKŲ;1856269656;Taip;0;3;1;4
6109;Molinukas;SRAIGIUKŲ;4766547534;Taip;0;1;0;1
6110;Molinukas;SRAIGIUKŲ;7377137582;Taip;0;3;0;3
6111;Molinukas;SRAIGIUKŲ;6084682084;Taip;5;1;0;6
6112;Molinukas;SRAIGIUKŲ;8913137310;Ne;0;2;4;6
6113;Molinukas;SRAIGIUKŲ;5387818175;Taip;0;2;0;2
6114;Molinukas;SRAIGIUKŲ;1138255845;Taip;0;3;0;3
6115;Molinukas;SRAIGIUKŲ;8604288346;Taip;0;3;0;3
6116;Molinukas;SRAIGIUKŲ;4806350914;Taip;0;3;2;5
6117;Molinukas;SRAIGIUKŲ;8617979245;Taip;7;0;3;10
6118;Molinukas;SRAIGIUKŲ;2757744826;Taip;9;0;1;10
6119;Molinukas;SRAIGIUKŲ;4534279257;Taip;0;3;1;4
6120;Molinukas;SRAIGIUKŲ;4918181437;Taip;0;3;2;5
6121;Molinukas;SRAIGIUKŲ;7451224160;Taip;0;3;1;4
6122;Molinukas;SRAIGIUKŲ;8688180482;Taip;0;3;0;3
6123;Molinukas;SRAIGIUKŲ;3917187380;Taip;0;3;0;3
6124;Molinukas;VOVERIUKAI;3469196411;Taip;0;4;1;5
6125;Molinukas;VOVERIUKAI;8541456847;Taip;0;5;3;8
6126;Molinukas;VOVERIUKAI;2286586693;Taip;0;3;1;4
6127;Molinukas;VOVERIUKAI;9413396859;Taip;0;0;1;1
6128;Molinukas;VOVERIUKAI;6898958282;Taip;11;0;1;12
6129;Molinukas;VOVERIUKAI;4000190261;Taip;0;0;3;3
6130;Molinukas;VOVERIUKAI;5685582215;Taip;9;5;1;15
6131;Molinukas;VOVERIUKAI;2356814145;Taip;0;0;2;2
6132;Molinukas;VOVERIUKAI;7446607510;Taip;5;5;1;11
6133;Molinukas;VOVERIUKAI;9667704959;Taip;2;4;5;11
6134;Molinukas;VOVERIUKAI;8516451290;Taip;0;0;1;1
6135;Molinukas;VOVERIUKAI;3030169626;Taip;0;3;0;3
6136;Molinukas;VOVERIUKAI;3207373459;Taip;1;0;7;8
6137;Molinukas;VOVERIUKAI;1865748733;Taip;0;1;4;5
6138;Molinukas;VOVERIUKAI;4209143136;Taip;8;0;0;8
6139;Molinukas;VOVERIUKAI;5648861702;Taip;8;0;0;8
6140;Molinukas;VOVERIUKAI;4957226547;Taip;0;3;0;3
6141;Molinukas;VOVERIUKAI;8865966572;Taip;0;3;5;8
6142;Molinukas;VOVERIUKAI;4950808381;Taip;0;9;4;13
6143;Molinukas;VOVERIUKAI;7378643086;Taip;0;3;0;3
6144;Molinukas;VOVERIUKAI;2779700726;Taip;3;0;18;21
6145;Molinukas;VOVERIUKAI;6832647220;Taip;0;0;6;6
6146;Molinukas;VOVERIUKAI;9318837973;Taip;10;1;0;11
6147;Molinukas;VOVERIUKAI;8247270556;Taip;4;1;0;5
6148;Molinukas;ŽVIRBLIUKŲ;2935945686;Taip;6;1;2;9
6149;Molinukas;ŽVIRBLIUKŲ;7825545164;Taip;0;3;4;7
6150;Molinukas;ŽVIRBLIUKŲ;6190443233;Taip;5;3;0;8
6151;Molinukas;ŽVIRBLIUKŲ;1831078544;Taip;8;0;0;8
6152;Molinukas;ŽVIRBLIUKŲ;6531106368;Taip;3;0;5;8
6153;Molinukas;ŽVIRBLIUKŲ;4122429163;Taip;0;3;0;3
6154;Molinukas;ŽVIRBLIUKŲ;8660958288;Taip;0;6;0;6
6155;Molinukas;ŽVIRBLIUKŲ;2862680065;Taip;0;6;0;6
6156;Molinukas;ŽVIRBLIUKŲ;3382913312;Taip;0;0;6;6
6157;Molinukas;ŽVIRBLIUKŲ;3331982964;Taip;0;0;3;3
6158;Molinukas;ŽVIRBLIUKŲ;2448588784;Taip;17;0;0;17
6159;Molinukas;ŽVIRBLIUKŲ;2842168450;Taip;8;0;0;8
6160;Molinukas;KAČIUKŲ;4992887072;Taip;0;3;0;3
6161;Molinukas;KAČIUKŲ;1907287249;Taip;0;0;3;3
6162;Molinukas;KAČIUKŲ;1292778118;Taip;0;0;2;2
6163;Molinukas;KAČIUKŲ;8769667823;Taip;0;3;0;3
6164;Molinukas;KAČIUKŲ;8313486714;Taip;7;3;0;10
6165;Molinukas;KAČIUKŲ;3043679624;Taip;5;0;3;8
6166;Molinukas;KAČIUKŲ;2030429825;Taip;8;3;0;11
6167;Molinukas;KAČIUKŲ;4974513900;Taip;4;2;0;6
6168;Molinukas;KAČIUKŲ;1826463800;Taip;0;0;3;3
6169;Molinukas;KAČIUKŲ;6947938890;Taip;18;0;0;18
6170;Molinukas;KAČIUKŲ;1970929144;Taip;5;0;0;5
6171;Molinukas;KAČIUKŲ;3510936830;Taip;0;0;6;6
6172;Molinukas;KAČIUKŲ;8608465121;Taip;15;0;3;18
6173;Molinukas;KAČIUKŲ;1651103318;Taip;4;5;0;9
6174;Molinukas;KAČIUKŲ;8973341322;Taip;0;0;3;3
6175;"Naminukas (Smėlio g. 13)";Drugeliai;6776805494;Taip;0;3;0;3
6176;"Naminukas (Smėlio g. 13)";Drugeliai;2395070574;Taip;5;3;0;8
6177;"Naminukas (Smėlio g. 13)";Drugeliai;5534073614;Taip;0;3;0;3
6178;"Naminukas (Smėlio g. 13)";Drugeliai;2132345627;Taip;2;3;3;8
6179;"Naminukas (Smėlio g. 13)";Drugeliai;1302119260;Taip;0;5;0;5
6180;"Naminukas (Smėlio g. 13)";Drugeliai;2864905392;Taip;3;9;0;12
6181;"Naminukas (Smėlio g. 13)";Drugeliai;7406775925;Taip;1;3;0;4
6182;"Naminukas (Smėlio g. 13)";Drugeliai;1333462200;Taip;6;0;1;7
6183;"Naminukas (Smėlio g. 13)";Drugeliai;5468218968;Taip;0;3;0;3
6184;"Naminukas (Smėlio g. 13)";Drugeliai;5713661641;Taip;6;3;0;9
6185;"Naminukas (Smėlio g. 13)";Drugeliai;6581925461;Taip;0;3;0;3
6186;"Naminukas (Smėlio g. 13)";Drugeliai;3320805432;Taip;0;4;0;4
6187;"Naminukas (Smėlio g. 13)";Drugeliai;9689866363;Taip;0;1;0;1
6188;"Naminukas (Smėlio g. 13)";Drugeliai;2198493034;Taip;3;5;0;8
6189;"Naminukas (Smėlio g. 13)";Drugeliai;8141324449;Taip;0;3;5;8
6190;"Naminukas (Smėlio g. 13)";Drugeliai;8564586014;Taip;0;5;0;5
6191;"Naminukas (Smėlio g. 13)";Drugeliai;3236525642;Taip;4;3;0;7
6192;"Naminukas (Smėlio g. 13)";Drugeliai;7347998152;Taip;0;5;0;5
6193;"Naminukas (Smėlio g. 13)";Drugeliai;7272465847;Taip;5;0;3;8
6194;"Naminukas (Smėlio g. 13)";Bitutės;4419568254;Taip;0;3;1;4
6195;"Naminukas (Smėlio g. 13)";Bitutės;1956749138;Taip;0;3;2;5
6196;"Naminukas (Smėlio g. 13)";Bitutės;6503569633;Taip;0;4;6;10
6197;"Naminukas (Smėlio g. 13)";Bitutės;3192885665;Taip;8;0;2;10
6198;"Naminukas (Smėlio g. 13)";Bitutės;9530232649;Taip;0;2;0;2
6199;"Naminukas (Smėlio g. 13)";Bitutės;8131328042;Taip;5;3;2;10
6200;"Naminukas (Smėlio g. 13)";Bitutės;7888950723;Taip;0;13;0;13
6201;"Naminukas (Smėlio g. 13)";Bitutės;1710002948;Taip;8;3;0;11
6202;"Naminukas (Smėlio g. 13)";Bitutės;3994190066;Taip;0;3;0;3
6203;"Naminukas (Smėlio g. 13)";Bitutės;5195078101;Taip;0;3;0;3
6204;"Naminukas (Smėlio g. 13)";Bitutės;9541388086;Taip;0;3;4;7
6205;"Naminukas (Smėlio g. 13)";Bitutės;2424412518;Taip;18;0;0;18
6206;"Naminukas (Smėlio g. 13)";Bitutės;41538301616;Taip;0;3;0;3
6207;"Naminukas (Smėlio g. 13)";Bitutės;5493709688;Taip;0;3;6;9
6208;"Naminukas (Smėlio g. 13)";Bitutės;2769848640;Taip;0;3;0;3
6209;"Naminukas (Smėlio g. 13)";Bitutės;9821244713;Ne;0;3;3;6
6210;"Naminukas (Smėlio g. 13)";Bitutės;1480152104;Taip;0;1;0;1
6211;"Naminukas (Smėlio g. 13)";Bitutės;4331408714;Taip;2;1;0;3
6212;"Naminukas (Smėlio g. 13)";Paukšteliai;3501921619;Taip;0;5;0;5
6213;"Naminukas (Smėlio g. 13)";Paukšteliai;7297661383;Taip;0;2;0;2
6214;"Naminukas (Smėlio g. 13)";Paukšteliai;5056487802;Taip;6;3;0;9
6215;"Naminukas (Smėlio g. 13)";Paukšteliai;3438010199;Taip;0;0;10;10
6216;"Naminukas (Smėlio g. 13)";Paukšteliai;4998565160;Taip;0;12;0;12
6217;"Naminukas (Smėlio g. 13)";Paukšteliai;9405784626;Taip;0;3;10;13
6218;"Naminukas (Smėlio g. 13)";Paukšteliai;2583886896;Taip;10;3;0;13
6219;"Naminukas (Smėlio g. 13)";Paukšteliai;4778385421;Taip;0;5;0;5
6220;"Naminukas (Smėlio g. 13)";Paukšteliai;6178500478;Ne;0;3;1;4
6221;"Naminukas (Smėlio g. 13)";Paukšteliai;9440685520;Taip;5;1;0;6
6222;"Naminukas (Smėlio g. 13)";Paukšteliai;1406418130;Taip;0;0;3;3
6223;"Naminukas (Smėlio g. 13)";Paukšteliai;9891722891;Taip;0;6;0;6
6224;"Naminukas (Smėlio g. 13)";Paukšteliai;2012656186;Ne;0;0;8;8
6225;"Naminukas (Smėlio g. 13)";Paukšteliai;8470716196;Taip;2;0;1;3
6226;"Naminukas (Smėlio g. 13)";Paukšteliai;3727828033;Ne;0;4;0;4
6227;"Naminukas (Smėlio g. 13)";Paukšteliai;9657786543;Ne;8;0;1;9
6228;"Naminukas (Smėlio g. 13)";"NYKŠTUKAI ";5849662446;Taip;9;0;0;9
6229;"Naminukas (Smėlio g. 13)";"NYKŠTUKAI ";7646186458;Taip;0;3;0;3
6230;"Naminukas (Smėlio g. 13)";"NYKŠTUKAI ";5519447152;Taip;11;2;0;13
6231;"Naminukas (Smėlio g. 13)";"NYKŠTUKAI ";5741698937;Taip;6;4;0;10
6232;"Naminukas (Smėlio g. 13)";"NYKŠTUKAI ";1286329245;Taip;15;0;0;15
6233;"Naminukas (Smėlio g. 13)";"NYKŠTUKAI ";1618802271;Taip;10;3;4;17
6234;"Naminukas (Smėlio g. 13)";"NYKŠTUKAI ";1591540165;Taip;5;1;4;10
6235;"Naminukas (Smėlio g. 13)";"NYKŠTUKAI ";9537360943;Taip;8;8;0;16
6236;"Naminukas (Smėlio g. 13)";"NYKŠTUKAI ";1118193598;Ne;1;0;1;2
6237;"Naminukas (Smėlio g. 13)";"NYKŠTUKAI ";8102805098;Taip;18;0;0;18
6238;"Naminukas (Smėlio g. 13)";"NYKŠTUKAI ";3996950390;Taip;10;0;0;10
6239;"Naminukas (Smėlio g. 13)";"NYKŠTUKAI ";9357758815;Taip;0;0;8;8
6240;"Naminukas (Smėlio g. 13)";"NYKŠTUKAI ";5280419144;Taip;0;0;2;2
6241;Nykštukas;SMAGURIAI;8120626738;Taip;0;4;0;4
6242;Nykštukas;SMAGURIAI;9842748132;Ne;7;4;0;11
6243;Nykštukas;SMAGURIAI;4830484167;Taip;0;3;0;3
6244;Nykštukas;SMAGURIAI;1902253981;Taip;0;3;0;3
6245;Nykštukas;SMAGURIAI;4949895196;Taip;6;4;0;10
6246;Nykštukas;SMAGURIAI;9713859038;Ne;6;3;0;9
6247;Nykštukas;SMAGURIAI;7954996421;Taip;0;11;0;11
6248;Nykštukas;SMAGURIAI;4771072061;Taip;0;3;0;3
6249;Nykštukas;SMAGURIAI;6139988523;Taip;4;4;0;8
6250;Nykštukas;SMAGURIAI;5190754451;Taip;3;4;0;7
6251;Nykštukas;SMAGURIAI;8310484267;Taip;3;3;0;6
6252;Nykštukas;SMAGURIAI;1707956308;Taip;8;3;0;11
6253;Nykštukas;SMAGURIAI;8635571067;Taip;5;3;0;8
6254;Nykštukas;SMAGURIAI;9326131725;Taip;0;5;0;5
6255;Nykštukas;SMAGURIAI;2000207070;Taip;0;1;0;1
6256;Nykštukas;SMAGURIAI;2826079911;Taip;0;5;0;5
6257;Nykštukas;SMAGURIAI;7911842707;Taip;0;8;0;8
6258;Nykštukas;SMAGURIAI;6102907953;Taip;6;4;0;10
6259;Nykštukas;SMAGURIAI;7529677915;Taip;0;4;0;4
6260;Nykštukas;SMAGURIAI;4994727422;Taip;0;5;0;5
6261;Nykštukas;SMAGURIAI;3007541327;Taip;6;8;0;14
6262;Nykštukas;SMAGURIAI;3370000872;Taip;0;4;0;4
6263;Nykštukas;SMALSIUKAI;5121027981;Taip;10;3;0;13
6264;Nykštukas;SMALSIUKAI;6958596223;Taip;0;4;1;5
6265;Nykštukas;SMALSIUKAI;3002966681;Taip;0;5;0;5
6266;Nykštukas;SMALSIUKAI;4612171029;Taip;0;3;0;3
6267;Nykštukas;SMALSIUKAI;3120577264;Taip;10;8;0;18
6268;Nykštukas;SMALSIUKAI;1386798219;Taip;0;3;0;3
6269;Nykštukas;SMALSIUKAI;3852057722;Taip;0;3;0;3
6270;Nykštukas;SMALSIUKAI;2696384135;Taip;4;4;0;8
6271;Nykštukas;SMALSIUKAI;9532956150;Taip;0;3;0;3
6272;Nykštukas;SMALSIUKAI;3273579005;Taip;0;3;0;3
6273;Nykštukas;SMALSIUKAI;3985610575;Taip;0;9;0;9
6274;Nykštukas;SMALSIUKAI;8948554271;Taip;3;2;0;5
6275;Nykštukas;SMALSIUKAI;1102555964;Taip;0;3;0;3
6276;Nykštukas;SMALSIUKAI;6112448299;Taip;5;3;0;8
6277;Nykštukas;SMALSIUKAI;1930357859;Taip;0;3;0;3
6278;Nykštukas;SMALSIUKAI;9100510105;Taip;4;5;0;9
6279;Nykštukas;SMALSIUKAI;2143857296;Taip;0;4;0;4
6280;Nykštukas;SMALSIUKAI;9303832542;Taip;0;3;0;3
6281;Nykštukas;SMALSIUKAI;9779645295;Taip;0;3;0;3
6282;Nykštukas;SMALSIUKAI;2571249434;Taip;0;14;0;14
6283;Nykštukas;SMALSIUKAI;3694497590;Taip;8;4;0;12
6284;Nykštukas;AITVARIUKAI;6923345088;Taip;0;5;1;6
6285;Nykštukas;AITVARIUKAI;8580777381;Taip;5;0;0;5
6286;Nykštukas;AITVARIUKAI;9216544103;Taip;0;5;0;5
6287;Nykštukas;AITVARIUKAI;9319066179;Taip;0;6;0;6
6288;Nykštukas;AITVARIUKAI;2177539882;Taip;0;5;1;6
6289;Nykštukas;AITVARIUKAI;9595654681;Taip;8;0;0;8
6290;Nykštukas;AITVARIUKAI;9894698453;Taip;0;1;0;1
6291;Nykštukas;AITVARIUKAI;6351178752;Taip;0;5;0;5
6292;Nykštukas;AITVARIUKAI;2232317366;Taip;3;0;0;3
6293;Nykštukas;AITVARIUKAI;7332769878;Taip;0;4;0;4
6294;Nykštukas;AITVARIUKAI;7896338372;Taip;5;3;0;8
6295;Nykštukas;AITVARIUKAI;2208319289;Taip;13;2;0;15
6296;Nykštukas;AITVARIUKAI;8548820023;Taip;9;3;0;12
6297;Nykštukas;AITVARIUKAI;9545178064;Taip;7;0;0;7
6298;Nykštukas;AITVARIUKAI;3561627809;Taip;0;1;0;1
6299;Nykštukas;AITVARIUKAI;5972246871;Ne;0;7;0;7
6300;Nykštukas;AITVARIUKAI;5538446312;Ne;0;0;14;14
6301;Nykštukas;AITVARIUKAI;4822304386;Taip;0;0;5;5
6302;Nykštukas;AITVARIUKAI;4177690371;Taip;6;0;4;10
6303;Nykštukas;AITVARIUKAI;5292127770;Taip;0;3;0;3
6304;Nykštukas;DAINORĖLIAI;7526936193;Ne;11;0;2;13
6305;Nykštukas;DAINORĖLIAI;7730918105;Taip;8;0;3;11
6306;Nykštukas;DAINORĖLIAI;8475127245;Taip;5;0;5;10
6307;Nykštukas;DAINORĖLIAI;5434220008;Taip;0;0;2;2
6308;Nykštukas;DAINORĖLIAI;1122600949;Taip;7;0;0;7
6309;Nykštukas;DAINORĖLIAI;3853935568;Taip;11;0;0;11
6310;Nykštukas;DAINORĖLIAI;9776630115;Taip;0;10;1;11
6311;Nykštukas;DAINORĖLIAI;9524639831;Ne;0;3;0;3
6312;Nykštukas;DAINORĖLIAI;3367348573;Taip;0;7;0;7
6313;Nykštukas;DAINORĖLIAI;5961945345;Taip;18;0;0;18
6314;Nykštukas;DAINORĖLIAI;6561696818;Taip;13;0;0;13
6315;Nykštukas;DAINORĖLIAI;1283453188;Taip;4;0;0;4
6316;Nykštukas;DAINORĖLIAI;1167614164;Taip;0;4;1;5
6317;Nykštukas;DAINORĖLIAI;7473124310;Taip;0;0;1;1
6318;Nykštukas;DAINORĖLIAI;1174618721;Taip;0;7;0;7
6319;Nykštukas;DAINORĖLIAI;8681884252;Taip;0;5;0;5
6320;Nykštukas;DAINORĖLIAI;9027355399;Taip;5;7;0;12
6321;Nykštukas;DAINORĖLIAI;4893494144;Taip;1;5;0;6
6322;Nykštukas;DAINORĖLIAI;8318089070;Taip;4;0;6;10
6323;Nykštukas;DAINORĖLIAI;2727074729;Taip;0;6;0;6
6324;Nykštukas;POKŠTUKAI;7382271765;Ne;0;5;0;5
6325;Nykštukas;POKŠTUKAI;1655428422;Taip;0;12;0;12
6326;Nykštukas;POKŠTUKAI;2649916049;Taip;8;8;0;16
6327;Nykštukas;POKŠTUKAI;1796016501;Taip;0;15;0;15
6328;Nykštukas;POKŠTUKAI;5958711585;Taip;0;3;0;3
6329;Nykštukas;POKŠTUKAI;3999004312;Taip;0;6;0;6
6330;Nykštukas;POKŠTUKAI;6719999304;Taip;0;8;0;8
6331;Nykštukas;POKŠTUKAI;8148163137;Taip;0;10;0;10
6332;Nykštukas;POKŠTUKAI;8708184278;Taip;2;4;0;6
6333;Nykštukas;POKŠTUKAI;5699671696;Taip;12;0;0;12
6334;Nykštukas;POKŠTUKAI;3843163586;Taip;0;5;0;5
6335;Nykštukas;POKŠTUKAI;1316018865;Taip;0;5;0;5
6336;Nykštukas;POKŠTUKAI;3507649457;Taip;0;3;0;3
6337;Nykštukas;POKŠTUKAI;3428031037;Taip;0;7;0;7
6338;Nykštukas;POKŠTUKAI;4508625009;Taip;0;4;0;4
6339;Nykštukas;POKŠTUKAI;6698622575;Taip;0;9;0;9
6340;Nykštukas;POKŠTUKAI;2982662650;Taip;0;7;0;7
6341;Nykštukas;POKŠTUKAI;2627736026;Taip;13;5;0;18
6342;Nykštukas;POKŠTUKAI;4401103119;Taip;0;12;0;12
6343;Nykštukas;POKŠTUKAI;5287713634;Taip;0;4;0;4
6344;Nykštukas;KODĖLČIUKAI;8168579152;Taip;14;0;0;14
6345;Nykštukas;KODĖLČIUKAI;9285820767;Taip;13;0;0;13
6346;Nykštukas;KODĖLČIUKAI;2685400939;Ne;8;6;0;14
6347;Nykštukas;KODĖLČIUKAI;3278960733;Ne;7;0;1;8
6348;Nykštukas;KODĖLČIUKAI;5934979528;Taip;3;0;0;3
6349;Nykštukas;KODĖLČIUKAI;3760617860;Ne;0;8;0;8
6350;Nykštukas;KODĖLČIUKAI;6927545099;Taip;3;0;1;4
6351;Nykštukas;KODĖLČIUKAI;8042479133;Taip;9;0;0;9
6352;Nykštukas;KODĖLČIUKAI;6999380958;Taip;12;0;2;14
6353;Nykštukas;KODĖLČIUKAI;6794885966;Taip;7;0;2;9
6354;Nykštukas;KODĖLČIUKAI;7616459970;Taip;0;6;0;6
6355;Nykštukas;KODĖLČIUKAI;2623254163;Taip;18;0;0;18
6356;Nykštukas;KODĖLČIUKAI;9296449928;Taip;3;0;0;3
6357;Nykštukas;KODĖLČIUKAI;2992219360;Taip;7;0;0;7
6358;Nykštukas;KODĖLČIUKAI;4667303597;Taip;4;0;0;4
6359;Nykštukas;KODĖLČIUKAI;8804969886;Taip;4;0;0;4
6360;Nykštukas;KODĖLČIUKAI;3552386621;Taip;18;0;0;18
6361;Nykštukas;KODĖLČIUKAI;3990260342;Taip;11;0;0;11
6362;Nykštukas;KODĖLČIUKAI;2692551262;Ne;0;2;0;2
6363;Nykštukas;PASAKORIAI;2661110617;Taip;0;13;0;13
6364;Nykštukas;PASAKORIAI;3040001373;Taip;0;0;3;3
6365;Nykštukas;PASAKORIAI;1855278809;Taip;0;5;0;5
6366;Nykštukas;PASAKORIAI;8640715657;Taip;5;2;0;7
6367;Nykštukas;PASAKORIAI;5504584349;Taip;2;4;0;6
6368;Nykštukas;PASAKORIAI;7990462246;Taip;2;4;0;6
6369;Nykštukas;PASAKORIAI;1379378120;Taip;2;0;3;5
6370;Nykštukas;PASAKORIAI;9413198245;Taip;6;0;1;7
6371;Nykštukas;PASAKORIAI;2518342041;Taip;0;3;0;3
6372;Nykštukas;PASAKORIAI;7828733135;Taip;8;0;4;12
6373;Nykštukas;PASAKORIAI;4480184458;Taip;0;3;0;3
6374;Nykštukas;PASAKORIAI;4090494707;Taip;8;1;0;9
6375;Nykštukas;PASAKORIAI;3026598985;Taip;2;2;0;4
6376;Nykštukas;PASAKORIAI;9714310539;Taip;6;3;0;9
6377;Nykštukas;PASAKORIAI;4795301170;Taip;10;1;0;11
6378;Nykštukas;PASAKORIAI;1579064341;Taip;0;0;3;3
6379;Nykštukas;PASAKORIAI;4992654449;Taip;4;0;6;10
6380;Nykštukas;PASAKORIAI;5337728911;Taip;10;1;0;11
6381;Nykštukas;PASAKORIAI;9509051946;Taip;0;9;0;9
6382;Nykštukas;PASAKORIAI;2231375994;Taip;10;5;0;15
6383;Nykštukas;PASAKORIAI;8371081106;Taip;5;8;0;13
6384;Nykštukas;PASAKORIAI;3496434361;Taip;0;3;0;3
6385;Nykštukas;GUDRUČIAI;9871410323;Taip;4;1;0;5
6386;Nykštukas;GUDRUČIAI;4559818614;Taip;0;4;0;4
6387;Nykštukas;GUDRUČIAI;9250827058;Taip;0;3;0;3
6388;Nykštukas;GUDRUČIAI;7447202642;Taip;5;4;0;9
6389;Nykštukas;GUDRUČIAI;1714708754;Taip;0;3;0;3
6390;Nykštukas;GUDRUČIAI;4325369395;Taip;6;3;2;11
6391;Nykštukas;GUDRUČIAI;6630804505;Taip;0;8;0;8
6392;Nykštukas;GUDRUČIAI;8363202198;Taip;0;3;0;3
6393;Nykštukas;GUDRUČIAI;7326535810;Taip;0;4;0;4
6394;Nykštukas;GUDRUČIAI;9712596180;Taip;3;2;0;5
6395;Nykštukas;GUDRUČIAI;9941937734;Taip;9;3;0;12
6396;Nykštukas;GUDRUČIAI;2494482185;Taip;0;2;0;2
6397;Nykštukas;GUDRUČIAI;3619459404;Taip;0;1;0;1
6398;Nykštukas;GUDRUČIAI;1934596739;Taip;0;3;0;3
6399;Nykštukas;GUDRUČIAI;7604740418;Taip;0;4;0;4
6400;Nykštukas;GUDRUČIAI;2970293467;Taip;11;3;0;14
6401;Nykštukas;GUDRUČIAI;2881323571;Ne;12;0;0;12
6402;Nykštukas;GUDRUČIAI;9437700329;Taip;0;3;0;3
6403;Nykštukas;GUDRUČIAI;2872277381;Taip;10;0;0;10
6404;Nykštukas;GUDRUČIAI;9940519259;Ne;6;3;0;9
6405;Nykštukas;NAMINUKAI;7456007276;Taip;0;6;0;6
6406;Nykštukas;NAMINUKAI;7176519994;Taip;1;1;0;2
6407;Nykštukas;NAMINUKAI;2440574056;Taip;1;1;0;2
6408;Nykštukas;NAMINUKAI;4064016871;Taip;2;8;0;10
6409;Nykštukas;NAMINUKAI;9054070492;Taip;0;3;0;3
6410;Nykštukas;NAMINUKAI;6519078450;Taip;5;0;0;5
6411;Nykštukas;NAMINUKAI;6106373554;Ne;0;3;0;3
6412;Nykštukas;NAMINUKAI;5032283848;Taip;3;3;2;8
6413;Nykštukas;NAMINUKAI;7494444468;Taip;7;0;0;7
6414;Nykštukas;NAMINUKAI;3925958632;Taip;7;0;0;7
6415;Nykštukas;NAMINUKAI;6338717583;Taip;5;9;0;14
6416;Nykštukas;NAMINUKAI;7976689381;Taip;0;3;0;3
6417;Nykštukas;NAMINUKAI;9686815141;Taip;0;12;0;12
6418;Nykštukas;NAMINUKAI;9575291096;Taip;4;3;0;7
6419;Nykštukas;NAMINUKAI;4503830456;Taip;0;7;0;7
6420;Nykštukas;NAMINUKAI;4040123876;Taip;0;7;0;7
6421;Nykštukas;NAMINUKAI;1088633575;Taip;0;2;0;2
6422;Nykštukas;NAMINUKAI;5088668786;Taip;0;4;0;4
6423;Nykštukas;NAMINUKAI;8874850019;Taip;4;4;0;8
6424;Nykštukas;NAMINUKAI;1510338621;Taip;11;3;0;14
6425;Nykštukas;NAMINUKAI;9067774103;Ne;8;8;0;16
6426;Nykštukas;NAMINUKAI;3405633312;Taip;0;5;0;5
6427;Nykštukas;KŪLVERSTUKAI;8827094160;Taip;3;4;0;7
6428;Nykštukas;KŪLVERSTUKAI;6786896381;Taip;10;2;0;12
6429;Nykštukas;KŪLVERSTUKAI;6883272732;Ne;8;0;0;8
6430;Nykštukas;KŪLVERSTUKAI;8919778025;Taip;11;0;0;11
6431;Nykštukas;KŪLVERSTUKAI;6337924089;Taip;3;3;1;7
6432;Nykštukas;KŪLVERSTUKAI;4323166473;Taip;0;3;0;3
6433;Nykštukas;KŪLVERSTUKAI;4490310109;Ne;0;5;0;5
6434;Nykštukas;KŪLVERSTUKAI;2947976429;Taip;7;0;0;7
6435;Nykštukas;KŪLVERSTUKAI;1102203704;Taip;0;1;0;1
6436;Nykštukas;KŪLVERSTUKAI;2763268154;Ne;0;4;4;8
6437;Nykštukas;KŪLVERSTUKAI;9887096503;Taip;4;3;0;7
6438;Nykštukas;TREPSIUKAI;2052451745;Taip;7;0;2;9
6439;Nykštukas;TREPSIUKAI;4955003100;Taip;0;3;0;3
6440;Nykštukas;TREPSIUKAI;5103512898;Taip;2;0;0;2
6441;Nykštukas;TREPSIUKAI;7603500691;Taip;10;3;0;13
6442;Nykštukas;TREPSIUKAI;7266550834;Taip;8;0;0;8
6443;Nykštukas;TREPSIUKAI;6563871327;Taip;0;9;0;9
6444;Nykštukas;TREPSIUKAI;5085577592;Taip;0;1;0;1
6445;Nykštukas;TREPSIUKAI;8819485547;Taip;10;0;0;10
6446;Nykštukas;TREPSIUKAI;5718555692;Taip;5;4;1;10
6447;Nykštukas;TREPSIUKAI;4499337321;Taip;11;0;0;11
6448;Nykštukas;TREPSIUKAI;4622095064;Taip;1;1;0;2
6449;Nykštukas;TREPSIUKAI;8667489439;Taip;0;3;0;3
6450;Nykštukas;TREPSIUKAI;5010715255;Taip;0;5;0;5
6451;Nykštukas;TREPSIUKAI;8047072198;Taip;7;4;0;11
6452;Nykštukas;TREPSIUKAI;9790322329;Taip;0;4;0;4
6453;Nykštukas;TREPSIUKAI;8695794490;Taip;8;3;0;11
6454;Nykštukas;ŽIRNIUKAI;9661862689;Taip;12;0;0;12
6455;Nykštukas;ŽIRNIUKAI;1594734231;Taip;0;6;0;6
6456;Nykštukas;ŽIRNIUKAI;1671340074;Taip;9;1;0;10
6457;Nykštukas;ŽIRNIUKAI;3339707558;Taip;0;3;0;3
6458;Nykštukas;ŽIRNIUKAI;7908029688;Taip;0;4;0;4
6459;Nykštukas;ŽIRNIUKAI;7299329150;Taip;3;3;0;6
6460;Nykštukas;ŽIRNIUKAI;9174636607;Taip;0;2;0;2
6461;Nykštukas;ŽIRNIUKAI;1218443707;Taip;0;5;2;7
6462;Nykštukas;ŽIRNIUKAI;7535385367;Taip;0;4;0;4
6463;Nykštukas;ŽIRNIUKAI;6709760898;Taip;0;3;0;3
6464;Nykštukas;ŽIRNIUKAI;2670682135;Taip;0;4;0;4
6465;Nykštukas;ŽIRNIUKAI;1202614927;Taip;0;3;0;3
6466;Nykštukas;ŽIRNIUKAI;1366524995;Taip;0;5;0;5
6467;Nykštukas;ŽIRNIUKAI;2800783215;Taip;0;18;0;18
6468;Nykštukas;ŽIRNIUKAI;2620150024;Taip;0;3;11;14
6469;Nykštukas;ŽIRNIUKAI;3032028847;Taip;11;4;0;15
6470;Nykštukas;ŽIRNIUKAI;4144437365;Taip;0;5;0;5
6471;Nykštukas;ŽIRNIUKAI;6884714823;Taip;1;2;0;3
6472;Nykštukas;ŽIRNIUKAI;1616644404;Taip;0;4;3;7
6473;Nykštukas;ŽIRNIUKAI;9270615518;Taip;0;9;0;9
6474;Nykštukas;ŽIRNIUKAI;2078586374;Taip;0;3;0;3
6475;Ozas;Smalsučiai;2641398988;Taip;0;4;0;4
6476;Ozas;Smalsučiai;9227939420;Ne;0;3;0;3
6477;Ozas;Smalsučiai;87218067796;Taip;5;3;0;8
6478;Ozas;Smalsučiai;4397034031;Taip;0;3;0;3
6479;Ozas;Smalsučiai;1974320330;Taip;0;3;0;3
6480;Ozas;Smalsučiai;1173284700;Taip;0;3;0;3
6481;Ozas;Smalsučiai;67987032400;Taip;0;1;2;3
6482;Ozas;Smalsučiai;71695973592;Ne;0;3;2;5
6483;Ozas;Smalsučiai;57069047630;Taip;0;3;3;6
6484;Ozas;Smalsučiai;3326395879;Taip;0;1;0;1
6485;Ozas;Smalsučiai;5150746885;Taip;0;7;0;7
6486;Ozas;Smalsučiai;1893257809;Taip;0;1;0;1
6487;Ozas;Smalsučiai;6540803077;Taip;0;3;0;3
6488;Ozas;Smalsučiai;8072802467;Taip;0;1;0;1
6489;Ozas;Smalsučiai;1248092034;Ne;0;3;0;3
6490;Ozas;Smalsučiai;43381497677;Taip;6;3;0;9
6491;Ozas;Smalsučiai;7351651916;Taip;0;4;2;6
6492;Ozas;Smalsučiai;3286170280;Taip;0;3;0;3
6493;Ozas;Smalsučiai;9521048381;Taip;0;3;0;3
6494;Ozas;Smalsučiai;2053832360;Taip;0;3;1;4
6495;Ozas;Smalsučiai;9905575489;Taip;4;2;0;6
6496;Ozas;Smalsučiai;5342394742;Taip;0;3;2;5
6497;Ozas;Drugeliai;7802699257;Taip;0;2;0;2
6498;Ozas;Drugeliai;6668470892;Taip;0;4;0;4
6499;Ozas;Drugeliai;2302999759;Taip;0;3;0;3
6500;Ozas;Drugeliai;8088330187;Taip;0;12;0;12
6501;Ozas;Drugeliai;9073973849;Taip;0;3;2;5
6502;Ozas;Drugeliai;9322806566;Taip;5;4;0;9
6503;Ozas;Drugeliai;2676747542;Taip;10;3;5;18
6504;Ozas;Drugeliai;2812687451;Taip;0;3;2;5
6505;Ozas;Drugeliai;8289643065;Taip;0;3;0;3
6506;Ozas;Drugeliai;4726019355;Taip;0;4;0;4
6507;Ozas;Drugeliai;9987863302;Taip;0;5;0;5
6508;Ozas;Drugeliai;2980799420;Taip;0;4;0;4
6509;Ozas;Drugeliai;1793692289;Taip;0;3;0;3
6510;Ozas;Drugeliai;8318380547;Taip;0;6;0;6
6511;Ozas;Drugeliai;4884054504;Taip;0;2;1;3
6512;Ozas;Drugeliai;43660054250;Taip;0;15;0;15
6513;Ozas;Drugeliai;7565002863;Taip;0;1;0;1
6514;Ozas;Drugeliai;1871542885;Taip;0;1;0;1
6515;Ozas;Drugeliai;15262583232;Taip;0;13;0;13
6516;Ozas;Drugeliai;1103685699;Taip;0;4;0;4
6517;Ozas;Drugeliai;1335655483;Taip;0;3;0;3
6518;Ozas;Drugeliai;4207160323;Taip;0;3;0;3
6519;Ozas;Drugeliai;1837947633;Taip;0;1;0;1
6520;Ozas;Boružėlės;1348960421;Ne;0;3;4;7
6521;Ozas;Boružėlės;1375643969;Ne;0;3;4;7
6522;Ozas;Boružėlės;63852147122;Taip;0;4;0;4
6523;Ozas;Boružėlės;8190314087;Taip;0;4;0;4
6524;Ozas;Boružėlės;3803998816;Taip;0;3;0;3
6525;Ozas;Boružėlės;1212358423;Taip;8;4;0;12
6526;Ozas;Boružėlės;7615907271;Ne;0;2;1;3
6527;Ozas;Boružėlės;1560342499;Taip;0;3;0;3
6528;Ozas;Boružėlės;8529654920;Taip;0;4;0;4
6529;Ozas;Boružėlės;2527574646;Taip;0;9;0;9
6530;Ozas;Boružėlės;9773251894;Taip;0;3;8;11
6531;Ozas;Boružėlės;36523514229;Taip;7;0;0;7
6532;Ozas;Boružėlės;1367050160;Taip;0;3;3;6
6533;Ozas;Boružėlės;2678629892;Taip;0;3;1;4
6534;Ozas;Boružėlės;1826499734;Taip;0;4;1;5
6535;Ozas;Boružėlės;6432357144;Taip;0;3;1;4
6536;Ozas;Boružėlės;1498656201;Taip;0;3;0;3
6537;Ozas;Boružėlės;9130645878;Taip;2;3;7;12
6538;Ozas;Boružėlės;60194872867;Taip;0;6;0;6
6539;Ozas;Boružėlės;7172573921;Taip;0;4;0;4
6540;Ozas;Boružėlės;1109113859;Taip;0;3;0;3
6541;Ozas;Boružėlės;1682529482;Taip;0;3;0;3
6542;Ozas;Boružėlės;68364031736;Taip;0;3;2;5
6543;Ozas;Žiogeliai;7461521320;Taip;0;5;0;5
6544;Ozas;Žiogeliai;6257625501;Taip;0;3;0;3
6545;Ozas;Žiogeliai;7402290524;Taip;0;3;2;5
6546;Ozas;Žiogeliai;1562277866;Taip;0;0;3;3
6547;Ozas;Žiogeliai;4571583671;Taip;0;3;1;4
6548;Ozas;Žiogeliai;5682027094;Taip;0;5;12;17
6549;Ozas;Žiogeliai;4966355020;Taip;0;3;0;3
6550;Ozas;Žiogeliai;3770045761;Taip;0;0;1;1
6551;Ozas;Žiogeliai;9324647606;Taip;0;1;2;3
6552;Ozas;Žiogeliai;9392526836;Taip;0;1;0;1
6553;Ozas;Žiogeliai;4942550213;Taip;13;0;0;13
6554;Ozas;Žiogeliai;8676986286;Taip;0;2;3;5
6555;Ozas;Žiogeliai;2345112767;Taip;3;4;0;7
6556;Ozas;Žiogeliai;5420952391;Taip;5;6;0;11
6557;Ozas;Žiogeliai;9929822317;Taip;0;2;0;2
6558;Ozas;Žiogeliai;2837228320;Taip;0;5;0;5
6559;Ozas;Žiogeliai;5156383727;Taip;0;5;0;5
6560;Ozas;Žiogeliai;2617258206;Ne;0;12;2;14
6561;Ozas;Žiogeliai;9768754737;Ne;0;7;0;7
6562;Ozas;Žiogeliai;7264789334;Taip;0;4;0;4
6563;Ozas;Bitutės;4220780257;Taip;0;3;5;8
6564;Ozas;Bitutės;1161776624;Taip;3;3;1;7
6565;Ozas;Bitutės;4227555342;Taip;4;0;0;4
6566;Ozas;Bitutės;7499756171;Taip;0;16;0;16
6567;Ozas;Bitutės;2705294874;Taip;0;4;0;4
6568;Ozas;Bitutės;2369544599;Taip;0;3;0;3
6569;Ozas;Bitutės;3329391600;Taip;0;3;0;3
6570;Ozas;Bitutės;4254601638;Taip;0;0;3;3
6571;Ozas;Bitutės;4699369567;Taip;0;0;3;3
6572;Ozas;Bitutės;8304671844;Taip;0;7;0;7
6573;Ozas;Bitutės;5968428143;Taip;1;3;0;4
6574;Ozas;Bitutės;9772085405;Taip;0;6;0;6
6575;Ozas;Bitutės;7051699003;Taip;9;0;0;9
6576;Ozas;Bitutės;5383877034;Taip;0;3;3;6
6577;Ozas;Bitutės;1117208248;Taip;2;4;0;6
6578;Ozas;Bitutės;6811181735;Taip;6;5;0;11
6579;Ozas;Bitutės;8622621570;Taip;3;0;1;4
6580;Ozas;Bitutės;4260123123;Taip;0;0;3;3
6581;Ozas;Bitutės;7494307084;Taip;0;2;5;7
6582;Ozas;Bitutės;1475005204;Taip;0;0;1;1
6583;Ozas;Bitutės;1895519949;Taip;0;0;3;3
6584;Ozas;Aitvarėliai;1144679735;Taip;13;0;0;13
6585;Ozas;Aitvarėliai;2773182934;Taip;16;0;1;17
6586;Ozas;Aitvarėliai;4357737538;Taip;6;0;0;6
6587;Ozas;Aitvarėliai;5642468671;Taip;0;3;0;3
6588;Ozas;Aitvarėliai;1045890394;Taip;8;3;1;12
6589;Ozas;Aitvarėliai;7686706482;Taip;0;4;2;6
6590;Ozas;Aitvarėliai;2395567376;Taip;4;3;1;8
6591;Ozas;Aitvarėliai;2922370952;Taip;2;1;1;4
6592;Ozas;Aitvarėliai;5383739203;Taip;7;0;1;8
6593;Ozas;Aitvarėliai;4583818638;Taip;9;0;0;9
6594;Ozas;Aitvarėliai;1543683077;Taip;2;0;0;2
6595;Ozas;Aitvarėliai;2165291778;Taip;10;6;0;16
6596;Ozas;Aitvarėliai;8754244281;Taip;17;0;0;17
6597;Ozas;Aitvarėliai;6646671212;Taip;3;0;1;4
6598;Ozas;Aitvarėliai;9443843603;Taip;5;3;1;9
6599;Ozas;Aitvarėliai;3238019756;Taip;4;4;0;8
6600;Ozas;Aitvarėliai;8987796218;Taip;9;8;0;17
6601;Ozas;Aitvarėliai;2544858937;Taip;0;3;1;4
6602;Ozas;Aitvarėliai;3783477511;Taip;7;5;0;12
6603;Ozas;Aitvarėliai;6778987483;Taip;7;0;1;8
6604;Ozas;Aitvarėliai;9813020279;Taip;6;0;0;6
6605;Ozas;Aitvarėliai;4891451748;Ne;6;0;1;7
6606;Ozas;Aitvarėliai;7009893338;Taip;6;0;1;7
6607;Ozas;Voveraitės;8178298861;Taip;0;0;3;3
6608;Ozas;Voveraitės;6263062055;Taip;7;1;0;8
6609;Ozas;Voveraitės;9195536968;Taip;0;5;3;8
6610;Ozas;Voveraitės;2991511872;Taip;0;5;1;6
6611;Ozas;Voveraitės;5016547315;Taip;8;0;0;8
6612;Ozas;Voveraitės;1564826076;Taip;0;4;0;4
6613;Ozas;Voveraitės;2511477658;Taip;0;3;1;4
6614;Ozas;Voveraitės;1240233169;Taip;0;3;0;3
6615;Ozas;Voveraitės;6088757991;Taip;0;5;2;7
6616;Ozas;Voveraitės;5822871838;Taip;0;3;0;3
6617;Ozas;Voveraitės;2635045515;Taip;0;2;0;2
6618;Ozas;Voveraitės;6499549095;Taip;0;4;2;6
6619;Ozas;Voveraitės;6666591428;Taip;0;6;0;6
6620;Ozas;Voveraitės;2297650260;Taip;0;5;0;5
6621;Ozas;Voveraitės;7908028909;Taip;6;3;0;9
6622;Ozas;Voveraitės;9762737217;Taip;0;5;0;5
6623;Ozas;Voveraitės;7421484648;Taip;11;0;7;18
6624;Ozas;Voveraitės;1997125531;Taip;0;5;2;7
6625;Ozas;Voveraitės;6053885086;Taip;3;3;0;6
6626;Ozas;Voveraitės;7978092840;Taip;0;4;0;4
6627;Ozas;Voveraitės;5751808248;Taip;5;0;3;8
6628;Ozas;Voveraitės;4556076744;Taip;4;0;6;10
6629;Ozas;Voveraitės;8503041003;Taip;0;0;1;1
6630;Ozas;Kodelčiukai;8743467101;Taip;7;3;0;10
6631;Ozas;Kodelčiukai;2964318343;Taip;4;3;0;7
6632;Ozas;Kodelčiukai;8696127374;Taip;0;0;3;3
6633;Ozas;Kodelčiukai;3704303636;Taip;12;0;0;12
6634;Ozas;Kodelčiukai;2573702751;Taip;8;0;0;8
6635;Ozas;Kodelčiukai;3412369198;Taip;12;0;0;12
6636;Ozas;Kodelčiukai;2951875705;Taip;4;1;0;5
6637;Ozas;Kodelčiukai;7305274617;Taip;2;4;0;6
6638;Ozas;Kodelčiukai;9306887706;Taip;13;0;0;13
6639;Ozas;Kodelčiukai;9084187344;Taip;4;3;0;7
6640;Ozas;Kodelčiukai;1348751454;Taip;12;0;0;12
6641;Ozas;Kodelčiukai;9322080266;Taip;9;3;0;12
6642;Ozas;Kodelčiukai;6809992664;Taip;13;1;0;14
6643;Ozas;Kodelčiukai;4516291572;Taip;5;3;0;8
6644;Ozas;Kodelčiukai;4287719751;Taip;7;3;0;10
6645;Ozas;Kodelčiukai;9620747099;Taip;16;0;0;16
6646;Ozas;Kodelčiukai;5216695220;Taip;12;3;0;15
6647;Ozas;Kodelčiukai;8779047802;Taip;12;0;0;12
6648;Ozas;Kodelčiukai;6783755555;Taip;5;3;0;8
6649;Ozas;Kodelčiukai;8222112564;Taip;0;4;0;4
6650;Ozas;Pelėdžiukai;4640897674;Taip;0;3;0;3
6651;Ozas;Pelėdžiukai;9277208213;Taip;0;2;0;2
6652;Ozas;Pelėdžiukai;2281337233;Taip;3;3;0;6
6653;Ozas;Pelėdžiukai;8040293681;Taip;4;0;1;5
6654;Ozas;Pelėdžiukai;1856258542;Taip;0;3;2;5
6655;Ozas;Pelėdžiukai;5922569280;Taip;0;6;4;10
6656;Ozas;Pelėdžiukai;7640409923;Taip;5;2;0;7
6657;Ozas;Pelėdžiukai;4601869799;Taip;4;3;0;7
6658;Ozas;Pelėdžiukai;5958055645;Ne;0;3;2;5
6659;Ozas;Pelėdžiukai;7125754645;Taip;0;3;1;4
6660;Ozas;Pelėdžiukai;2824133388;Taip;11;1;0;12
6661;Ozas;Pelėdžiukai;2637531106;Taip;0;2;0;2
6662;Ozas;Pelėdžiukai;7287989663;Taip;5;3;0;8
6663;Ozas;Pelėdžiukai;6819000895;Taip;0;3;0;3
6664;Ozas;Pelėdžiukai;4247941696;Taip;2;0;0;2
6665;Ozas;Pelėdžiukai;5950860889;Taip;4;4;0;8
6666;Ozas;Pelėdžiukai;4886045470;Taip;3;4;0;7
6667;Ozas;Pelėdžiukai;3212050416;Taip;9;3;0;12
6668;Ozas;Pelėdžiukai;3725141591;Taip;2;3;0;5
6669;Ozas;Pelėdžiukai;3711403511;Taip;1;3;3;7
6670;Ozas;Pelėdžiukai;5392929222;Taip;17;0;0;17
6671;Ozas;Pelėdžiukai;7038928164;Taip;0;3;3;6
6672;Ozas;Pelėdžiukai;8131525146;Taip;10;3;0;13
6673;Ozas;"Kačiukai ";7776754188;Taip;10;0;3;13
6674;Ozas;"Kačiukai ";5097380041;Taip;11;0;2;13
6675;Ozas;"Kačiukai ";2522810593;Taip;6;0;0;6
6676;Ozas;"Kačiukai ";3109261153;Taip;10;3;0;13
6677;Ozas;"Kačiukai ";9781398468;Taip;14;0;0;14
6678;Ozas;"Kačiukai ";8488500486;Taip;7;0;1;8
6679;Ozas;"Kačiukai ";7803356246;Taip;0;0;15;15
6680;Ozas;"Kačiukai ";2512535949;Taip;18;0;0;18
6681;Ozas;"Kačiukai ";4595986358;Taip;0;3;0;3
6682;Ozas;"Kačiukai ";5421245991;Taip;7;0;0;7
6683;Ozas;"Kačiukai ";9781527964;Taip;8;6;0;14
6684;Ozas;"Kačiukai ";6456146804;Taip;3;0;0;3
6685;Ozas;"Kačiukai ";9496746778;Taip;11;0;1;12
6686;Ozas;"Kačiukai ";4514798132;Taip;0;4;2;6
6687;Ozas;"Kačiukai ";9655492678;Taip;11;0;6;17
6688;Ozas;Ančiukų;3037323341;Taip;9;3;0;12
6689;Ozas;Ančiukų;5926100815;Taip;18;0;0;18
6690;Ozas;Ančiukų;2248812743;Taip;0;0;8;8
6691;Ozas;Ančiukų;2454569369;Taip;11;2;0;13
6692;Ozas;Ančiukų;3133776891;Taip;4;0;3;7
6693;Ozas;Ančiukų;2139224651;Taip;7;5;0;12
6694;Ozas;Ančiukų;2819545359;Taip;16;0;0;16
6695;Ozas;Ančiukų;5172367556;Taip;10;4;0;14
6696;Ozas;Ančiukų;5677543279;Taip;4;0;1;5
6697;Ozas;Ančiukų;8923372952;Taip;5;3;0;8
6698;Ozas;Ančiukų;7617839839;Taip;7;4;0;11
6699;Ozas;Ančiukų;9506090620;Taip;9;3;0;12
6700;Ozas;Nykškukų;7585213159;Taip;8;2;3;13
6701;Ozas;Nykškukų;6392066805;Taip;14;0;0;14
6702;Ozas;Nykškukų;6346123124;Taip;0;18;0;18
6703;Ozas;Nykškukų;3902722274;Taip;5;0;0;5
6704;Ozas;Nykškukų;7922667688;Taip;12;1;3;16
6705;Ozas;Nykškukų;8781771299;Taip;7;0;0;7
6706;Ozas;Nykškukų;3817138493;Taip;8;0;0;8
6707;Ozas;Nykškukų;8371368881;Taip;9;0;0;9
6708;Ozas;Nykškukų;6476147361;Taip;0;2;2;4
6709;Ozas;Nykškukų;4994121247;Taip;11;3;0;14
6710;Ozas;Nykškukų;6315443248;Taip;18;0;0;18
6711;Ozas;Nykškukų;6318419889;Taip;6;0;5;11
6712;Ozas;Nykškukų;6186850614;Taip;0;3;5;8
6713;Ozas;Nykškukų;5182160089;Taip;9;0;0;9
6714;Ozas;Nykškukų;1536889312;Taip;13;0;1;14
6715;Pabiručiai;Voveriukų;4539246865;Taip;0;0;3;3
6716;Pabiručiai;Voveriukų;1498738549;Taip;0;0;3;3
6717;Pabiručiai;Voveriukų;2349337471;Taip;0;4;0;4
6718;Pabiručiai;Voveriukų;9564303781;Taip;0;0;6;6
6719;Pabiručiai;Voveriukų;4312364951;Taip;2;3;0;5
6720;Pabiručiai;Voveriukų;3756731363;Taip;0;0;8;8
6721;Pabiručiai;Voveriukų;7985360502;Taip;7;0;0;7
6722;Pabiručiai;Voveriukų;3936426174;Taip;0;0;4;4
6723;Pabiručiai;Voveriukų;4069564285;Taip;0;5;0;5
6724;Pabiručiai;Voveriukų;7403996266;Taip;14;0;0;14
6725;Pabiručiai;Voveriukų;7278334800;Taip;0;0;4;4
6726;Pabiručiai;Voveriukų;9468698553;Taip;6;3;0;9
6727;Pabiručiai;Voveriukų;5232678556;Taip;11;0;0;11
6728;Pabiručiai;Voveriukų;7066037017;Taip;3;3;0;6
6729;Pabiručiai;Voveriukų;5549851164;Taip;0;3;0;3
6730;Pabiručiai;Voveriukų;4040533883;Taip;0;5;0;5
6731;Pabiručiai;Voveriukų;2514312233;Taip;0;3;0;3
6732;Pabiručiai;Voveriukų;7606274875;Taip;0;3;0;3
6733;Pabiručiai;Voveriukų;9356327400;Taip;2;3;0;5
6734;Pabiručiai;Voveriukų;4813206044;Taip;14;5;0;19
6735;Pabiručiai;Voveriukų;7846758352;Taip;0;2;0;2
6736;Pabiručiai;Boružiukų;6401188653;Taip;0;1;0;1
6737;Pabiručiai;Boružiukų;1673473814;Taip;0;3;0;3
6738;Pabiručiai;Boružiukų;5686769648;Taip;15;3;0;18
6739;Pabiručiai;Boružiukų;7524993271;Taip;0;3;5;8
6740;Pabiručiai;Boružiukų;4006783343;Ne;7;0;0;7
6741;Pabiručiai;Boružiukų;7046122545;Taip;0;2;0;2
6742;Pabiručiai;Boružiukų;3096466200;Taip;5;4;0;9
6743;Pabiručiai;Boružiukų;4301904533;Taip;1;3;0;4
6744;Pabiručiai;Boružiukų;8175565139;Taip;0;3;0;3
6745;Pabiručiai;Boružiukų;8236964683;Taip;0;7;0;7
6746;Pabiručiai;Boružiukų;1240057541;Taip;18;0;0;18
6747;Pabiručiai;Boružiukų;1671027282;Taip;10;7;0;17
6748;Pabiručiai;Boružiukų;3759350345;Taip;11;1;0;12
6749;Pabiručiai;Boružiukų;3151360288;Taip;0;5;0;5
6750;Pabiručiai;Boružiukų;9299393363;Taip;5;4;0;9
6751;Pabiručiai;Boružiukų;1484291546;Taip;0;3;1;4
6752;Pabiručiai;Boružiukų;2771769336;Taip;3;4;0;7
6753;Pabiručiai;Boružiukų;2607840684;Taip;0;5;0;5
6754;Pabiručiai;Boružiukų;4681771534;Taip;0;3;0;3
6755;Pabiručiai;Boružiukų;7050339198;Taip;6;10;0;16
6756;Pabiručiai;Boružiukų;4798503931;Taip;0;3;1;4
6757;Pabiručiai;Katinėlių;8284711578;Taip;12;1;0;13
6758;Pabiručiai;Katinėlių;8710389714;Taip;3;6;0;9
6759;Pabiručiai;Katinėlių;1670938208;Taip;4;3;0;7
6760;Pabiručiai;Katinėlių;3756365293;Taip;1;3;0;4
6761;Pabiručiai;Katinėlių;6283372742;Taip;7;3;1;11
6762;Pabiručiai;Katinėlių;4205107384;Taip;0;2;0;2
6763;Pabiručiai;Katinėlių;4501176225;Taip;0;8;0;8
6764;Pabiručiai;Katinėlių;1749155319;Ne;5;4;3;12
6765;Pabiručiai;Katinėlių;2572570925;Taip;11;7;0;18
6766;Pabiručiai;Katinėlių;34883375155;Taip;9;2;0;11
6767;Pabiručiai;Katinėlių;8306688649;Ne;8;2;0;10
6768;Pabiručiai;Katinėlių;1705085006;Taip;12;0;0;12
6769;Pabiručiai;Katinėlių;58112415466;Taip;0;3;3;6
6770;Pabiručiai;Katinėlių;95695057362;Taip;0;9;0;9
6771;Pabiručiai;Katinėlių;42877891797;Taip;0;4;0;4
6772;Pabiručiai;Katinėlių;6285940478;Taip;0;3;0;3
6773;Pabiručiai;Katinėlių;1122183123;Taip;0;3;9;12
6774;Pabiručiai;Žiogelių;6548776238;Taip;0;3;2;5
6775;Pabiručiai;Žiogelių;3272576627;Taip;0;3;0;3
6776;Pabiručiai;Žiogelių;5522447437;Taip;0;3;2;5
6777;Pabiručiai;Žiogelių;3585198013;Taip;0;1;0;1
6778;Pabiručiai;Žiogelių;7974345478;Taip;12;4;0;16
6779;Pabiručiai;Žiogelių;3206962828;Taip;2;3;3;8
6780;Pabiručiai;Žiogelių;3355875364;Taip;0;4;0;4
6781;Pabiručiai;Žiogelių;5311762824;Taip;6;3;1;10
6782;Pabiručiai;Žiogelių;1587905929;Taip;0;13;5;18
6783;Pabiručiai;Žiogelių;4667769378;Taip;1;1;0;2
6784;Pabiručiai;Žiogelių;7085036701;Taip;0;9;0;9
6785;Pabiručiai;Žiogelių;8367889753;Taip;0;3;0;3
6786;Pabiručiai;Žiogelių;8736658575;Taip;0;3;2;5
6787;Pabiručiai;Žiogelių;8106446562;Taip;0;9;0;9
6788;Pabiručiai;Žiogelių;8421025940;Taip;0;3;1;4
6789;Pabiručiai;Žiogelių;1311650644;Taip;0;4;0;4
6790;Pabiručiai;Žiogelių;3028063887;Taip;0;3;0;3
6791;Pabiručiai;Smalsiukai;2869383175;Taip;5;0;1;6
6792;Pabiručiai;Smalsiukai;7677235214;Taip;0;0;1;1
6793;Pabiručiai;Smalsiukai;9676561758;Taip;1;3;0;4
6794;Pabiručiai;Smalsiukai;7632969321;Ne;1;0;5;6
6795;Pabiručiai;Smalsiukai;7090116276;Taip;4;1;1;6
6796;Pabiručiai;Smalsiukai;4408666547;Taip;10;0;3;13
6797;Pabiručiai;Smalsiukai;9093137227;Taip;3;0;0;3
6798;Pabiručiai;Smalsiukai;6935913132;Ne;7;2;0;9
6799;Pabiručiai;Smalsiukai;7663581089;Taip;0;8;0;8
6800;Pabiručiai;Smalsiukai;7248314871;Taip;0;0;5;5
6801;Pabiručiai;Smalsiukai;9610623364;Taip;1;3;0;4
6802;Pabiručiai;Smalsiukai;8897462614;Taip;0;3;0;3
6803;Pabiručiai;Smalsiukai;2332338995;Taip;24;0;0;24
6804;Pabiručiai;Smalsiukai;4258226042;Ne;5;2;0;7
6805;Pabiručiai;Smalsiukai;3511851810;Taip;5;3;0;8
6806;Pabiručiai;Smalsiukai;6686039601;Taip;0;0;18;18
6807;Pabiručiai;Smalsiukai;5420231066;Ne;7;0;0;7
6808;Pabiručiai;Smalsiukai;8840885039;Taip;7;3;1;11
6809;Pabiručiai;Smalsiukai;9779260044;Taip;5;0;1;6
6810;Pabiručiai;Smalsiukai;2771891999;Taip;12;0;1;13
6811;Pabiručiai;Smalsiukai;7295052694;Ne;0;4;0;4
6812;Pabiručiai;Kiškučiai;3368607302;Taip;0;8;0;8
6813;Pabiručiai;Kiškučiai;9589005897;Taip;5;13;0;18
6814;Pabiručiai;Kiškučiai;6648966721;Taip;0;3;0;3
6815;Pabiručiai;Kiškučiai;9353062804;Taip;8;4;0;12
6816;Pabiručiai;Kiškučiai;1582754284;Taip;0;7;0;7
6817;Pabiručiai;Kiškučiai;4462744848;Ne;0;13;0;13
6818;Pabiručiai;Kiškučiai;5621183663;Taip;5;4;0;9
6819;Pabiručiai;Kiškučiai;5497318373;Taip;0;3;0;3
6820;Pabiručiai;Kiškučiai;9417138573;Taip;0;1;0;1
6821;Pabiručiai;Kiškučiai;1515270273;Taip;5;3;0;8
6822;Pabiručiai;Kiškučiai;2688728915;Taip;10;3;0;13
6823;Pabiručiai;Kiškučiai;5166525832;Taip;3;0;0;3
6824;Pabiručiai;Kiškučiai;8409455566;Taip;0;8;0;8
6825;Pabiručiai;Kiškučiai;1028312285;Taip;0;4;0;4
6826;Pabiručiai;Kiškučiai;5346249456;Taip;18;0;0;18
6827;Pabiručiai;Kiškučiai;5717534175;Taip;7;7;0;14
6828;Pabiručiai;Kiškučiai;3408518493;Taip;0;9;0;9
6829;Pabiručiai;Kiškučiai;7653129291;Taip;1;4;0;5
6830;Pabiručiai;Kiškučiai;7073230645;Taip;12;4;0;16
6831;Pabiručiai;Kiškučiai;8820585407;Taip;3;3;0;6
6832;Pabiručiai;Kiškučiai;7572077461;Taip;0;4;0;4
6833;Pabiručiai;Kiškučiai;5767879226;Taip;4;5;0;9
6834;Pabiručiai;"Pėledžiukai ";9834824219;Taip;11;5;0;16
6835;Pabiručiai;"Pėledžiukai ";2507088490;Taip;0;13;0;13
6836;Pabiručiai;"Pėledžiukai ";6831569546;Taip;11;0;1;12
6837;Pabiručiai;"Pėledžiukai ";1683369842;Ne;5;3;0;8
6838;Pabiručiai;"Pėledžiukai ";7478484190;Taip;0;4;0;4
6839;Pabiručiai;"Pėledžiukai ";7961879916;Taip;8;5;0;13
6840;Pabiručiai;"Pėledžiukai ";9050994322;Taip;13;0;0;13
6841;Pabiručiai;"Pėledžiukai ";1049154287;Taip;18;0;0;18
6842;Pabiručiai;"Pėledžiukai ";6697518151;Taip;6;2;0;8
6843;Pabiručiai;"Pėledžiukai ";2596301235;Taip;9;1;2;12
6844;Pabiručiai;"Pėledžiukai ";4333645528;Taip;0;4;0;4
6845;Pabiručiai;"Pėledžiukai ";6289025538;Taip;0;9;0;9
6846;Pabiručiai;"Pėledžiukai ";2812291058;Taip;10;0;0;10
6847;Pabiručiai;"Pėledžiukai ";2343561322;Taip;0;4;0;4
6848;Pabiručiai;"Pėledžiukai ";3674583662;Taip;6;3;0;9
6849;Pabiručiai;"Pėledžiukai ";8268101318;Taip;0;11;0;11
6850;Pabiručiai;"Pėledžiukai ";2147165934;Taip;10;0;3;13
6851;Pabiručiai;"Pėledžiukai ";7385149524;Taip;8;2;0;10
6852;Pabiručiai;"Pėledžiukai ";7203091216;Taip;0;0;5;5
6853;Pabiručiai;"Pėledžiukai ";3224195892;Taip;14;0;0;14
6854;Pabiručiai;"Kodelčiūkai ";5950654594;Taip;0;6;0;6
6855;Pabiručiai;"Kodelčiūkai ";8775727677;Taip;0;0;3;3
6856;Pabiručiai;"Kodelčiūkai ";4317656984;Taip;5;0;0;5
6857;Pabiručiai;"Kodelčiūkai ";4785878572;Taip;0;10;0;10
6858;Pabiručiai;"Kodelčiūkai ";2295503584;Ne;0;12;0;12
6859;Pabiručiai;"Kodelčiūkai ";4595458527;Taip;3;3;0;6
6860;Pabiručiai;"Kodelčiūkai ";8716879106;Taip;4;1;0;5
6861;Pabiručiai;"Kodelčiūkai ";9067653417;Taip;0;3;3;6
6862;Pabiručiai;"Kodelčiūkai ";5247780866;Taip;12;0;0;12
6863;Pabiručiai;"Kodelčiūkai ";3433419710;Taip;10;0;1;11
6864;Pabiručiai;"Kodelčiūkai ";6386335808;Taip;10;0;5;15
6865;Pabiručiai;"Kodelčiūkai ";5010271037;Taip;0;5;0;5
6866;Pabiručiai;"Kodelčiūkai ";9538339883;Taip;0;3;1;4
6867;Pabiručiai;"Kodelčiūkai ";8149732126;Taip;0;3;1;4
6868;Pabiručiai;"Kodelčiūkai ";7289131864;Taip;4;1;0;5
6869;Pabiručiai;"Kodelčiūkai ";6209553290;Taip;18;0;0;18
6870;Pabiručiai;"Kodelčiūkai ";5913022147;Taip;5;3;1;9
6871;Pabiručiai;"Kodelčiūkai ";3748657353;Taip;6;0;1;7
6872;Pabiručiai;"Kodelčiūkai ";3497466298;Taip;0;3;0;3
6873;Pabiručiai;"Kodelčiūkai ";8179285338;Taip;8;7;0;15
6874;Pabiručiai;"Kodelčiūkai ";1234230729;Taip;5;0;5;10
6875;Pabiručiai;"Peliukų ";4894380231;Taip;3;0;1;4
6876;Pabiručiai;"Peliukų ";1947729077;Taip;4;0;0;4
6877;Pabiručiai;"Peliukų ";6678717039;Taip;0;5;2;7
6878;Pabiručiai;"Peliukų ";7182565608;Taip;5;7;0;12
6879;Pabiručiai;"Peliukų ";1776325000;Taip;13;0;0;13
6880;Pabiručiai;"Peliukų ";1099080685;Taip;0;12;0;12
6881;Pabiručiai;"Peliukų ";5990497129;Taip;0;5;0;5
6882;Pabiručiai;"Peliukų ";9890225918;Taip;11;0;0;11
6883;Pabiručiai;"Peliukų ";3826505104;Taip;3;0;3;6
6884;Pabiručiai;"Peliukų ";1971996148;Taip;4;2;0;6
6885;Pabiručiai;"Peliukų ";4852287574;Taip;5;3;4;12
6886;Pabiručiai;"Peliukų ";1206012259;Taip;0;6;0;6
6887;Pabiručiai;"Peliukų ";9790360371;Taip;3;0;3;6
6888;Pabiručiai;"Peliukų ";7980170279;Taip;0;5;0;5
6889;Pabiručiai;"Peliukų ";9806520732;Taip;9;8;0;17
6890;Pabiručiai;"Peliukų ";5923385276;Taip;0;3;8;11
6891;Pabiručiai;"Viščiukų ";6247495021;Taip;0;5;0;5
6892;Pabiručiai;"Viščiukų ";8254676845;Ne;11;6;0;17
6893;Pabiručiai;"Viščiukų ";6742744014;Taip;10;5;0;15
6894;Pabiručiai;"Viščiukų ";7339565412;Taip;5;0;4;9
6895;Pabiručiai;"Viščiukų ";4880717493;Taip;18;0;0;18
6896;Pabiručiai;"Viščiukų ";1138743823;Taip;0;8;0;8
6897;Pabiručiai;"Viščiukų ";3011601512;Taip;0;0;6;6
6898;Pabiručiai;"Viščiukų ";7798837336;Taip;2;3;1;6
6899;Pabiručiai;"Viščiukų ";7914642744;Taip;5;0;4;9
6900;Pabiručiai;"Viščiukų ";5737214746;Taip;20;3;1;24
6901;Pabiručiai;"Viščiukų ";2141365015;Taip;14;0;1;15
6902;Pabiručiai;"Viščiukų ";6361966325;Taip;0;0;5;5
6903;Pabiručiai;"Viščiukų ";6508093808;Ne;10;4;0;14
6904;Pabiručiai;"Viščiukų ";4929129093;Ne;8;6;0;14
6905;Pabiručiai;"Drugelių ";9890868992;Ne;14;0;0;14
6906;Pabiručiai;"Drugelių ";3491721002;Ne;9;0;0;9
6907;Pabiručiai;"Drugelių ";2556330147;Taip;10;4;0;14
6908;Pabiručiai;"Drugelių ";5050966784;Taip;8;5;0;13
6909;Pabiručiai;"Drugelių ";5019580409;Taip;10;3;0;13
6910;Pabiručiai;"Drugelių ";3531292373;Taip;0;6;0;6
6911;Pabiručiai;"Drugelių ";8668524776;Taip;0;6;0;6
6912;Pabiručiai;"Drugelių ";9878655387;Taip;1;3;0;4
6913;Pabiručiai;"Drugelių ";4876140467;Taip;8;1;0;9
6914;Pabiručiai;"Drugelių ";6481162347;Taip;0;0;7;7
6915;Pabiručiai;"Drugelių ";4012537474;Taip;4;3;1;8
6916;Pabiručiai;"Drugelių ";4701982784;Taip;5;0;1;6
6917;Pabiručiai;"Drugelių ";5147367745;Taip;8;0;1;9
6918;Pabiručiai;ŽIRNIUKŲ;5704073222;Taip;10;2;0;12
6919;Pabiručiai;ŽIRNIUKŲ;2924005478;Taip;3;0;4;7
6920;Pabiručiai;ŽIRNIUKŲ;1247522345;Taip;5;3;3;11
6921;Pabiručiai;ŽIRNIUKŲ;1852744763;Taip;0;3;10;13
6922;Pabiručiai;ŽIRNIUKŲ;4851108740;Ne;0;0;1;1
6923;Pabiručiai;ŽIRNIUKŲ;6513943228;Ne;5;8;0;13
6924;Pabiručiai;ŽIRNIUKŲ;2794484633;Ne;18;1;1;20
6925;Pabiručiai;ŽIRNIUKŲ;8870657682;Ne;12;3;0;15
6926;Pabiručiai;ŽIRNIUKŲ;4096412988;Taip;8;1;0;9
6927;Pabiručiai;ŽIRNIUKŲ;3262687187;Taip;0;2;0;2
6928;Pabiručiai;ŽIRNIUKŲ;8092886420;Ne;12;4;0;16
6929;Pabiručiai;ŽIRNIUKŲ;7873575929;Ne;5;8;0;13
6930;Pabiručiai;ŽIRNIUKŲ;5862643827;Ne;5;3;3;11
6931;Pabiručiai;ŽIRNIUKŲ;5184688482;Taip;14;0;0;14
6932;Pabiručiai;ŽIRNIUKŲ;4755427277;Taip;0;3;2;5
6933;Pabiručiai;ŽIRNIUKŲ;9507212682;Taip;0;4;0;4
6934;Pabiručiai;ŽIRNIUKŲ;9651695086;Taip;0;0;2;2
6935;Pabiručiai;ŽIRNIUKŲ;5899880680;Taip;14;0;1;15
6936;Pagrandukas;Saulytės;6915087488;Taip;0;3;0;3
6937;Pagrandukas;Saulytės;7605508460;Taip;6;3;0;9
6938;Pagrandukas;Saulytės;6349387692;Taip;0;3;0;3
6939;Pagrandukas;Saulytės;8186092469;Taip;0;6;0;6
6940;Pagrandukas;Saulytės;2934300533;Taip;8;1;0;9
6941;Pagrandukas;Saulytės;1548697124;Taip;0;6;0;6
6942;Pagrandukas;Saulytės;6711830251;Taip;6;1;0;7
6943;Pagrandukas;Saulytės;7146697128;Taip;0;3;1;4
6944;Pagrandukas;Saulytės;3157676207;Taip;0;6;0;6
6945;Pagrandukas;Saulytės;7511097160;Taip;0;11;0;11
6946;Pagrandukas;Saulytės;3783160018;Taip;4;2;0;6
6947;Pagrandukas;Saulytės;7454863899;Taip;5;0;0;5
6948;Pagrandukas;Saulytės;5560372136;Taip;0;4;0;4
6949;Pagrandukas;Saulytės;1766912463;Taip;6;1;0;7
6950;Pagrandukas;Saulytės;9849054467;Taip;3;8;0;11
6951;Pagrandukas;Saulytės;8024910647;Taip;13;3;0;16
6952;Pagrandukas;Saulytės;8481502330;Taip;0;8;0;8
6953;Pagrandukas;Saulytės;7160305478;Taip;0;3;0;3
6954;Pagrandukas;Saulytės;3008997793;Taip;0;6;0;6
6955;Pagrandukas;Saulytės;6388805960;Taip;0;0;18;18
6956;Pagrandukas;Saulytės;3050207849;Taip;0;4;0;4
6957;Pagrandukas;Saulytės;8836178193;Taip;0;8;0;8
6958;Pagrandukas;Saulytės;7157549179;Taip;0;6;0;6
6959;Pagrandukas;Zuikučiai;7834436515;Taip;0;3;0;3
6960;Pagrandukas;Zuikučiai;7435609306;Taip;0;0;3;3
6961;Pagrandukas;Zuikučiai;5903416384;Taip;0;3;6;9
6962;Pagrandukas;Zuikučiai;2439891231;Taip;0;1;4;5
6963;Pagrandukas;Zuikučiai;6710887776;Taip;0;1;4;5
6964;Pagrandukas;Zuikučiai;7665811353;Taip;0;0;3;3
6965;Pagrandukas;Zuikučiai;2212787835;Taip;5;4;0;9
6966;Pagrandukas;Zuikučiai;2711590019;Taip;0;0;3;3
6967;Pagrandukas;Zuikučiai;6449029299;Taip;0;4;0;4
6968;Pagrandukas;Zuikučiai;1405820070;Taip;13;1;0;14
6969;Pagrandukas;Zuikučiai;1054107640;Taip;0;13;0;13
6970;Pagrandukas;Zuikučiai;1885539883;Taip;0;4;0;4
6971;Pagrandukas;Zuikučiai;1795582354;Taip;8;3;0;11
6972;Pagrandukas;Zuikučiai;2822538227;Taip;0;0;4;4
6973;Pagrandukas;Zuikučiai;1587839122;Taip;26;0;0;26
6974;Pagrandukas;Zuikučiai;2101505576;Taip;0;0;9;9
6975;Pagrandukas;Zuikučiai;6765346578;Taip;0;0;3;3
6976;Pagrandukas;Zuikučiai;5922595170;Taip;0;3;0;3
6977;Pagrandukas;Zuikučiai;5030928303;Taip;0;8;0;8
6978;Pagrandukas;Zuikučiai;9139212151;Taip;0;3;7;10
6979;Pagrandukas;Zuikučiai;8643993939;Taip;0;0;4;4
6980;Pagrandukas;Zuikučiai;5021106231;Taip;0;3;0;3
6981;Pagrandukas;Zuikučiai;3494047045;Taip;0;7;0;7
6982;Pagrandukas;Boružėlių;3888408459;Taip;0;3;0;3
6983;Pagrandukas;Boružėlių;3398225200;Taip;0;7;0;7
6984;Pagrandukas;Boružėlių;5752454925;Taip;0;5;2;7
6985;Pagrandukas;Boružėlių;3587941684;Taip;6;3;0;9
6986;Pagrandukas;Boružėlių;5946007985;Taip;0;3;0;3
6987;Pagrandukas;Boružėlių;7770852445;Taip;5;3;0;8
6988;Pagrandukas;Boružėlių;6304701617;Taip;0;3;0;3
6989;Pagrandukas;Boružėlių;3953844737;Taip;0;8;0;8
6990;Pagrandukas;Boružėlių;7271589727;Taip;0;7;0;7
6991;Pagrandukas;Boružėlių;7064391685;Taip;0;0;3;3
6992;Pagrandukas;Boružėlių;5640182548;Taip;0;2;0;2
6993;Pagrandukas;Boružėlių;1403569615;Taip;0;1;2;3
6994;Pagrandukas;Boružėlių;1998073387;Taip;0;3;0;3
6995;Pagrandukas;Boružėlių;5511396314;Taip;0;12;0;12
6996;Pagrandukas;Boružėlių;5648658237;Taip;0;4;0;4
6997;Pagrandukas;Boružėlių;9651789217;Taip;0;8;0;8
6998;Pagrandukas;Boružėlių;6911951786;Taip;0;8;0;8
6999;Pagrandukas;Boružėlių;2926077771;Taip;0;5;0;5
7000;Pagrandukas;Boružėlių;2361829423;Taip;0;1;7;8
7001;Pagrandukas;Boružėlių;8286183393;Taip;0;4;4;8
7002;Pagrandukas;Boružėlių;2549704540;Taip;0;2;3;5
7003;Pagrandukas;Boružėlių;9790803767;Ne;0;4;0;4
7004;Pagrandukas;Boružėlių;7043125057;Ne;0;5;1;6
7005;Pagrandukas;Bitutės;6044667668;Taip;0;4;2;6
7006;Pagrandukas;Bitutės;8529974367;Taip;0;5;3;8
7007;Pagrandukas;Bitutės;1938604743;Taip;0;2;0;2
7008;Pagrandukas;Bitutės;4079711515;Taip;0;5;0;5
7009;Pagrandukas;Bitutės;8625382465;Taip;0;3;0;3
7010;Pagrandukas;Bitutės;9188382746;Taip;0;0;3;3
7011;Pagrandukas;Bitutės;4603185679;Taip;0;3;0;3
7012;Pagrandukas;Bitutės;5613442667;Taip;0;0;10;10
7013;Pagrandukas;Bitutės;2923517578;Taip;0;14;0;14
7014;Pagrandukas;Bitutės;4322675634;Taip;0;3;0;3
7015;Pagrandukas;Bitutės;3875062228;Taip;1;3;2;6
7016;Pagrandukas;Bitutės;4405567649;Taip;0;5;0;5
7017;Pagrandukas;Bitutės;1583104760;Taip;5;2;0;7
7018;Pagrandukas;Bitutės;5649084353;Taip;0;2;1;3
7019;Pagrandukas;Bitutės;8719834064;Taip;8;3;0;11
7020;Pagrandukas;Bitutės;5821945401;Taip;0;0;3;3
7021;Pagrandukas;Bitutės;7675694987;Taip;11;3;0;14
7022;Pagrandukas;Bitutės;3709131197;Taip;0;7;5;12
7023;Pagrandukas;Bitutės;2098182423;Taip;0;3;0;3
7024;Pagrandukas;Bitutės;8280877177;Taip;6;1;3;10
7025;Pagrandukas;Bitutės;2764732768;Taip;6;0;5;11
7026;Pagrandukas;Pelėdžiukai;1714449109;Taip;0;3;0;3
7027;Pagrandukas;Pelėdžiukai;3160109801;Taip;7;5;0;12
7028;Pagrandukas;Pelėdžiukai;8633116370;Taip;5;0;0;5
7029;Pagrandukas;Pelėdžiukai;2877401332;Taip;1;5;1;7
7030;Pagrandukas;Pelėdžiukai;8167118045;Taip;10;1;0;11
7031;Pagrandukas;Pelėdžiukai;3390664086;Taip;6;3;0;9
7032;Pagrandukas;Pelėdžiukai;1733723373;Taip;0;3;0;3
7033;Pagrandukas;Pelėdžiukai;1077792535;Taip;0;3;1;4
7034;Pagrandukas;Pelėdžiukai;9583471280;Taip;0;3;1;4
7035;Pagrandukas;Pelėdžiukai;2481532396;Taip;0;2;2;4
7036;Pagrandukas;Pelėdžiukai;4398016119;Taip;0;2;1;3
7037;Pagrandukas;Pelėdžiukai;4910151924;Taip;6;3;2;11
7038;Pagrandukas;Pelėdžiukai;9431513632;Taip;4;1;2;7
7039;Pagrandukas;Pelėdžiukai;1977974235;Taip;0;5;1;6
7040;Pagrandukas;Pelėdžiukai;7238694532;Taip;0;7;2;9
7041;Pagrandukas;ŠYPSENĖLIŲ;4627387596;Taip;0;0;7;7
7042;Pagrandukas;ŠYPSENĖLIŲ;7173561328;Taip;8;0;0;8
7043;Pagrandukas;ŠYPSENĖLIŲ;1101989969;Taip;0;8;0;8
7044;Pagrandukas;ŠYPSENĖLIŲ;5701479990;Taip;0;3;1;4
7045;Pagrandukas;ŠYPSENĖLIŲ;9981610798;Taip;0;0;6;6
7046;Pagrandukas;ŠYPSENĖLIŲ;6248684084;Taip;9;0;1;10
7047;Pagrandukas;ŠYPSENĖLIŲ;2904880156;Taip;9;0;0;9
7048;Pagrandukas;ŠYPSENĖLIŲ;5173633710;Taip;0;0;8;8
7049;Pagrandukas;ŠYPSENĖLIŲ;6057078416;Taip;9;0;4;13
7050;Pagrandukas;ŠYPSENĖLIŲ;1855833141;Taip;3;4;0;7
7051;Pagrandukas;ŠYPSENĖLIŲ;8475724797;Taip;0;0;6;6
7052;Pagrandukas;ŠYPSENĖLIŲ;5272914210;Taip;11;0;0;11
7053;Pagrandukas;ŠYPSENĖLIŲ;6517393406;Taip;0;0;4;4
7054;Pagrandukas;ŠYPSENĖLIŲ;4094086585;Taip;5;3;0;8
7055;Pagrandukas;ŠYPSENĖLIŲ;6306635507;Taip;4;0;1;5
7056;Pakalnutė;Pagrandukai;7475119623;Taip;0;13;0;13
7057;Pakalnutė;Pagrandukai;9677810607;Taip;0;18;0;18
7058;Pakalnutė;Pagrandukai;2015778005;Taip;6;3;0;9
7059;Pakalnutė;Pagrandukai;5275833872;Taip;2;10;0;12
7060;Pakalnutė;Pagrandukai;5943686565;Taip;2;3;0;5
7061;Pakalnutė;Pagrandukai;2296079246;Taip;10;3;0;13
7062;Pakalnutė;Pagrandukai;9313588621;Taip;0;3;0;3
7063;Pakalnutė;Pagrandukai;7962849592;Taip;0;3;0;3
7064;Pakalnutė;Pagrandukai;5180015882;Taip;5;5;0;10
7065;Pakalnutė;Pagrandukai;3794283102;Taip;1;4;0;5
7066;Pakalnutė;Pagrandukai;3070652992;Taip;0;3;0;3
7067;Pakalnutė;Pagrandukai;7477188659;Taip;10;3;0;13
7068;Pakalnutė;Pagrandukai;8522585063;Taip;5;3;0;8
7069;Pakalnutė;Pagrandukai;4390444128;Taip;7;3;0;10
7070;Pakalnutė;Pagrandukai;2642359967;Taip;0;4;0;4
7071;Pakalnutė;Pagrandukai;1614993691;Taip;0;3;0;3
7072;Pakalnutė;Pagrandukai;7417131378;Taip;10;3;0;13
7073;Pakalnutė;Pagrandukai;6396963609;Taip;10;3;0;13
7074;Pakalnutė;Pagrandukai;6708041407;Taip;4;2;1;7
7075;Pakalnutė;Pagrandukai;1883500676;Taip;0;7;0;7
7076;Pakalnutė;"Pelėdžiukų ";7110858765;Taip;4;0;1;5
7077;Pakalnutė;"Pelėdžiukų ";8553182620;Taip;10;0;3;13
7078;Pakalnutė;"Pelėdžiukų ";3840499737;Ne;3;2;1;6
7079;Pakalnutė;"Pelėdžiukų ";4523766424;Taip;9;0;0;9
7080;Pakalnutė;"Pelėdžiukų ";6577255841;Taip;0;18;0;18
7081;Pakalnutė;"Pelėdžiukų ";7151877991;Taip;5;0;4;9
7082;Pakalnutė;"Pelėdžiukų ";2992768162;Taip;7;4;0;11
7083;Pakalnutė;"Pelėdžiukų ";9505524183;Taip;13;0;0;13
7084;Pakalnutė;"Pelėdžiukų ";8823232039;Taip;10;0;3;13
7085;Pakalnutė;"Pelėdžiukų ";8900756351;Taip;3;0;1;4
7086;Pakalnutė;"Pelėdžiukų ";2035060922;Taip;5;0;5;10
7087;Pakalnutė;"Pelėdžiukų ";7325137583;Taip;0;3;0;3
7088;Pakalnutė;"Pelėdžiukų ";4220368864;Taip;0;5;3;8
7089;Pakalnutė;"Pelėdžiukų ";1330092247;Taip;15;0;0;15
7090;Pakalnutė;"Pelėdžiukų ";3267680599;Ne;0;10;0;10
7091;Pakalnutė;"Pelėdžiukų ";4452372238;Taip;0;0;7;7
7092;Pakalnutė;"Pelėdžiukų ";4353883274;Ne;0;0;4;4
7093;Pakalnutė;Ežiukai;5058727058;Taip;0;4;1;5
7094;Pakalnutė;Ežiukai;4052166895;Taip;13;0;3;16
7095;Pakalnutė;Ežiukai;1070172991;Taip;0;1;0;1
7096;Pakalnutė;Ežiukai;9323200833;Taip;0;5;0;5
7097;Pakalnutė;Ežiukai;9781993614;Taip;9;0;0;9
7098;Pakalnutė;Ežiukai;9256219647;Taip;5;3;0;8
7099;Pakalnutė;Ežiukai;7853479591;Taip;0;4;0;4
7100;Pakalnutė;Ežiukai;4317305712;Taip;5;0;2;7
7101;Pakalnutė;Ežiukai;6029905101;Taip;0;0;1;1
7102;Pakalnutė;Ežiukai;7734657452;Taip;5;2;3;10
7103;Pakalnutė;Ežiukai;8081932074;Taip;18;0;0;18
7104;Pakalnutė;Ežiukai;9706455707;Taip;0;0;2;2
7105;Pakalnutė;Ežiukai;7881545979;Ne;0;4;0;4
7106;Pakalnutė;Ežiukai;8080989574;Taip;6;2;0;8
7107;Pakalnutė;Ežiukai;5911381706;Taip;4;3;0;7
7108;Pakalnutė;Ežiukai;2755412687;Taip;5;0;5;10
7109;Pakalnutė;Ežiukai;8236718590;Taip;6;4;0;10
7110;Pakalnutė;Skruzdėliukų;4033813807;Taip;15;3;0;18
7111;Pakalnutė;Skruzdėliukų;7503936754;Taip;1;3;0;4
7112;Pakalnutė;Skruzdėliukų;5409476517;Taip;5;11;0;16
7113;Pakalnutė;Skruzdėliukų;2670302354;Taip;0;2;0;2
7114;Pakalnutė;Skruzdėliukų;7105369111;Taip;0;3;0;3
7115;Pakalnutė;Skruzdėliukų;6944726166;Taip;5;3;2;10
7116;Pakalnutė;Skruzdėliukų;1195872320;Taip;0;4;0;4
7117;Pakalnutė;Skruzdėliukų;3211633472;Taip;0;3;0;3
7118;Pakalnutė;Skruzdėliukų;4423348418;Taip;0;5;0;5
7119;Pakalnutė;Skruzdėliukų;6055727963;Taip;0;3;0;3
7120;Pakalnutė;Skruzdėliukų;5619262190;Taip;0;3;0;3
7121;Pakalnutė;Skruzdėliukų;3215438452;Taip;0;3;0;3
7122;Pakalnutė;Skruzdėliukų;9681515221;Taip;0;3;0;3
7123;Pakalnutė;Skruzdėliukų;8496839980;Taip;0;3;0;3
7124;Pakalnutė;Skruzdėliukų;9336711927;Taip;0;3;0;3
7125;Pakalnutė;Skruzdėliukų;5356902834;Taip;0;1;0;1
7126;Pakalnutė;Skruzdėliukų;3288449407;Taip;1;3;0;4
7127;Pakalnutė;Bitučių;2993145079;Taip;0;3;0;3
7128;Pakalnutė;Bitučių;8461220770;Ne;0;3;0;3
7129;Pakalnutė;Bitučių;2367683002;Taip;0;3;0;3
7130;Pakalnutė;Bitučių;2765220889;Taip;0;5;0;5
7131;Pakalnutė;Bitučių;9445909071;Taip;0;2;0;2
7132;Pakalnutė;Bitučių;5532458706;Taip;0;12;0;12
7133;Pakalnutė;Bitučių;7526989580;Taip;0;4;0;4
7134;Pakalnutė;Bitučių;5941955322;Taip;1;2;0;3
7135;Pakalnutė;Bitučių;3306334576;Taip;0;3;0;3
7136;Pakalnutė;Bitučių;2095540372;Taip;0;3;0;3
7137;Pakalnutė;Bitučių;5342592825;Taip;0;8;0;8
7138;Pakalnutė;Bitučių;2932205226;Taip;3;2;0;5
7139;Pakalnutė;Bitučių;5464143742;Taip;18;0;0;18
7140;Pakalnutė;Bitučių;6351193702;Taip;0;4;0;4
7141;Pakalnutė;Bitučių;2070744110;Taip;0;3;1;4
7142;Pakalnutė;Bitučių;3965390135;Taip;0;3;5;8
7143;Pakalnutė;Bitučių;5355198213;Taip;1;4;1;6
7144;Pakalnutė;Bitučių;4533467194;Ne;10;2;0;12
7145;Pakalnutė;Bitučių;3583094831;Taip;5;2;0;7
7146;Pakalnutė;Boružiukų;5120176374;Taip;0;5;0;5
7147;Pakalnutė;Boružiukų;6798939288;Taip;1;6;0;7
7148;Pakalnutė;Boružiukų;7357431226;Taip;0;6;0;6
7149;Pakalnutė;Boružiukų;4934095931;Taip;0;3;0;3
7150;Pakalnutė;Boružiukų;5039000154;Taip;0;3;0;3
7151;Pakalnutė;Boružiukų;6575909478;Taip;0;3;0;3
7152;Pakalnutė;Boružiukų;7223747714;Taip;5;0;0;5
7153;Pakalnutė;Boružiukų;2835611316;Taip;0;3;0;3
7154;Pakalnutė;Boružiukų;7672252382;Taip;0;4;0;4
7155;Pakalnutė;Boružiukų;4950195858;Taip;0;3;0;3
7156;Pakalnutė;Boružiukų;4927086034;Taip;13;3;0;16
7157;Pakalnutė;Boružiukų;6557165567;Taip;2;3;0;5
7158;Pakalnutė;Boružiukų;3677709759;Taip;0;3;2;5
7159;Pakalnutė;Boružiukų;2597900983;Taip;6;5;0;11
7160;Pakalnutė;Boružiukų;2062721289;Taip;0;5;0;5
7161;Pakalnutė;Boružiukų;1340022702;Taip;0;6;0;6
7162;Pakalnutė;Boružiukų;6228196996;Taip;10;3;0;13
7163;Pakalnutė;Boružiukų;7563201788;Taip;0;2;0;2
7164;Pakalnutė;Meškiukų;2666441234;Taip;3;0;0;3
7165;Pakalnutė;Meškiukų;4256222944;Taip;6;15;0;21
7166;Pakalnutė;Meškiukų;2101821362;Taip;7;5;0;12
7167;Pakalnutė;Meškiukų;4069910346;Ne;5;0;0;5
7168;Pakalnutė;Meškiukų;4313652059;Taip;5;5;0;10
7169;Pakalnutė;Meškiukų;7084798190;Taip;0;3;0;3
7170;Pakalnutė;Meškiukų;6133481935;Taip;0;5;0;5
7171;Pakalnutė;Meškiukų;3693337607;Taip;3;0;0;3
7172;Pakalnutė;Meškiukų;2923698853;Taip;4;12;0;16
7173;Pakalnutė;Meškiukų;1369906621;Taip;6;0;2;8
7174;Pakalnutė;Nykštukai;9918277117;Taip;2;1;3;6
7175;Pakalnutė;Nykštukai;6633585181;Taip;18;0;0;18
7176;Pakalnutė;Nykštukai;3870628774;Taip;0;1;3;4
7177;Pakalnutė;Nykštukai;8324219868;Ne;0;18;0;18
7178;Pakalnutė;Nykštukai;1864990681;Taip;0;1;2;3
7179;Pakalnutė;Nykštukai;1236187157;Taip;0;2;4;6
7180;Pakalnutė;Nykštukai;2063766287;Taip;5;4;0;9
7181;Pakalnutė;Nykštukai;6528913736;Taip;7;2;0;9
7182;Pakalnutė;Nykštukai;8217779439;Taip;0;5;0;5
7183;Pakalnutė;Nykštukai;6206296685;Taip;0;18;0;18
7184;Pakalnutė;Nykštukai;8855237588;Taip;0;14;0;14
7185;Pakalnutė;Nykštukai;1561411767;Taip;0;1;2;3
7186;Pakalnutė;Nykštukai;9443826616;Taip;4;0;0;4
7187;Pakalnutė;Nykštukai;7024440142;Taip;5;3;0;8
7188;Pakalnutė;Nykštukai;2578170222;Taip;6;1;6;13
7189;Pakalnutė;Nykštukai;3967515235;Taip;5;3;0;8
7190;Pakalnutė;Nykštukai;5377715404;Taip;18;0;0;18
7191;Pakalnutė;Nykštukai;3938091521;Taip;18;0;0;18
7192;Pakalnutė;Nykštukai;4971065032;Taip;16;0;0;16
7193;Pakalnutė;"Zuikučių ";1198230323;Taip;0;3;0;3
7194;Pakalnutė;"Zuikučių ";3609982613;Taip;0;3;0;3
7195;Pakalnutė;"Zuikučių ";5958653847;Taip;0;4;1;5
7196;Pakalnutė;"Zuikučių ";1147843795;Taip;0;4;0;4
7197;Pakalnutė;"Zuikučių ";3555822605;Taip;0;3;0;3
7198;Pakalnutė;"Zuikučių ";1583462733;Taip;2;3;0;5
7199;Pakalnutė;"Zuikučių ";6377564215;Taip;0;3;0;3
7200;Pakalnutė;"Zuikučių ";8813262660;Taip;0;3;0;3
7201;Pakalnutė;"Zuikučių ";7949588551;Taip;0;3;0;3
7202;Pakalnutė;"Zuikučių ";81578522887;Taip;0;4;0;4
7203;Pakalnutė;"Zuikučių ";2002555659;Taip;3;3;1;7
7204;Pakalnutė;"Zuikučių ";4681267749;Taip;10;4;0;14
7205;Pakalnutė;"Zuikučių ";6884488772;Taip;4;3;0;7
7206;Pakalnutė;"Zuikučių ";9934596750;Taip;0;1;0;1
7207;Pakalnutė;"Zuikučių ";5912904296;Taip;0;3;0;3
7208;Pakalnutė;"Drugelių ";5441477374;Ne;5;1;0;6
7209;Pakalnutė;"Drugelių ";7369661890;Taip;5;3;0;8
7210;Pakalnutė;"Drugelių ";5135811550;Taip;10;3;0;13
7211;Pakalnutė;"Drugelių ";7766653114;Taip;0;3;0;3
7212;Pakalnutė;"Drugelių ";7709684372;Taip;4;2;0;6
7213;Pakalnutė;"Drugelių ";9620000116;Taip;0;3;0;3
7214;Pakalnutė;"Drugelių ";5502444590;Taip;0;3;0;3
7215;Pakalnutė;"Drugelių ";3730712580;Taip;0;3;1;4
7216;Pakalnutė;"Drugelių ";1824418095;Taip;0;3;0;3
7217;Pakalnutė;"Drugelių ";9461133636;Taip;0;3;0;3
7218;Pakalnutė;"Drugelių ";4220406978;Ne;0;0;1;1
7219;Pakalnutė;"Drugelių ";5069038636;Taip;0;0;1;1
7220;Pakalnutė;"Drugelių ";7047587606;Taip;11;4;0;15
7221;Pakalnutė;"Drugelių ";2653667596;Taip;0;2;0;2
7222;Pakalnutė;"Drugelių ";2197533802;Taip;0;3;0;3
7223;Pakalnutė;"Drugelių ";1791607977;Taip;5;3;0;8
7224;Pakalnutė;"Drugelių ";4127500142;Taip;10;3;0;13
7225;Pakalnutė;"Drugelių ";9295709508;Taip;18;0;0;18
7226;Pakalnutė;"Drugelių ";6924023022;Taip;13;0;0;13
7227;Pakalnutė;Žvirbliukų;8329725085;Taip;0;2;3;5
7228;Pakalnutė;Žvirbliukų;3190067149;Taip;0;0;4;4
7229;Pakalnutė;Žvirbliukų;7548659665;Taip;0;2;4;6
7230;Pakalnutė;Žvirbliukų;8010667913;Taip;10;0;6;16
7231;Pakalnutė;Žvirbliukų;1662773049;Taip;0;2;2;4
7232;Pakalnutė;Žvirbliukų;5531209454;Taip;0;3;9;12
7233;Pakalnutė;Žvirbliukų;3342793992;Taip;0;0;4;4
7234;Pakalnutė;Žvirbliukų;7258417347;Taip;18;0;0;18
7235;Pakalnutė;Žvirbliukų;4961361687;Taip;1;2;0;3
7236;Pakalnutė;Žvirbliukų;5878352514;Taip;0;0;6;6
7237;Pakalnutė;Žvirbliukų;5685361033;Taip;0;2;4;6
7238;Pakalnutė;Žvirbliukų;7547661599;Taip;0;2;4;6
7239;Pakalnutė;Žvirbliukų;4469974699;Taip;10;2;0;12
7240;Pakalnutė;Žvirbliukų;6159955311;Taip;5;2;2;9
7241;Pakalnutė;Žvirbliukų;3903972025;Taip;10;2;1;13
7242;Pakalnutė;Žvirbliukų;8567965305;Taip;0;0;5;5
7243;Panerių;Rūtelė;3438863665;Taip;0;5;0;5
7244;Panerių;Rūtelė;4689913361;Taip;0;0;5;5
7245;Panerių;Rūtelė;2195332401;Taip;0;0;6;6
7246;Panerių;Rūtelė;2571561865;Taip;0;3;0;3
7247;Panerių;Rūtelė;6908487075;Taip;0;2;3;5
7248;Panerių;Rūtelė;2643410976;Ne;5;3;1;9
7249;Panerių;Rūtelė;8771264170;Ne;0;0;3;3
7250;Panerių;Rūtelė;2189532651;Taip;0;2;0;2
7251;Panerių;Rūtelė;3346395516;Taip;0;2;0;2
7252;Panerių;Rūtelė;7805429137;Taip;7;0;11;18
7253;Panerių;Rūtelė;9268618414;Taip;10;0;3;13
7254;Panerių;Rūtelė;6411372006;Taip;18;3;1;22
7255;Panerių;Rūtelė;1419817211;Ne;12;5;1;18
7256;Panerių;Rūtelė;2333355325;Taip;0;0;1;1
7257;Panerių;Rūtelė;3913395809;Taip;15;0;0;15
7258;Panerių;Rūtelė;4867297993;Taip;0;1;0;1
7259;Panerių;Rūtelė;2235123048;Taip;0;0;6;6
7260;Panerių;Rūtelė;9631684972;Taip;0;3;0;3
7261;Panerių;Rūtelė;3190117304;Taip;0;7;0;7
7262;Panerių;Rūtelė;8693113275;Taip;9;0;3;12
7263;Panerių;Rūtelė;6468190149;Taip;0;0;3;3
7264;Panerių;Rūtelė;9630302749;Taip;0;3;1;4
7265;Panerių;Rūtelė;3057714143;Taip;0;1;1;2
7266;Panerių;Gėlytės;3550194241;Taip;0;1;0;1
7267;Panerių;Gėlytės;8514805919;Taip;0;0;1;1
7268;Panerių;Gėlytės;1339256258;Taip;4;0;1;5
7269;Panerių;Gėlytės;9729731866;Taip;0;2;0;2
7270;Panerių;Gėlytės;6583134855;Taip;0;1;1;2
7271;Panerių;Gėlytės;3948776877;Taip;0;0;9;9
7272;Panerių;Gėlytės;2751334281;Taip;6;3;0;9
7273;Panerių;Gėlytės;9432171719;Taip;8;3;0;11
7274;Panerių;Gėlytės;5452996791;Taip;0;3;0;3
7275;Panerių;Gėlytės;1717129076;Ne;21;0;0;21
7276;Panerių;Gėlytės;2035822976;Taip;7;0;1;8
7277;Panerių;Gėlytės;8447920373;Taip;5;0;0;5
7278;Panerių;Gėlytės;4161189870;Taip;7;3;0;10
7279;Panerių;Gėlytės;9004310393;Taip;11;0;0;11
7280;Panerių;Gėlytės;3112608087;Taip;0;0;3;3
7281;Panerių;Gėlytės;5100874548;Taip;7;0;0;7
7282;Panerių;Gėlytės;9955613696;Taip;0;4;0;4
7283;Panerių;Gėlytės;3882802840;Taip;0;4;0;4
7284;Panerių;Gėlytės;6304387432;Taip;0;3;2;5
7285;Panerių;Gėlytės;7166964095;Taip;0;0;2;2
7286;Panerių;Gėlytės;8109366029;Ne;6;0;2;8
7287;Panerių;Boružė;7657860513;Taip;0;9;0;9
7288;Panerių;Boružė;9014387764;Taip;7;0;0;7
7289;Panerių;Boružė;4369979548;Taip;5;0;0;5
7290;Panerių;Boružė;3273655606;Ne;8;0;1;9
7291;Panerių;Boružė;8067240250;Ne;0;0;9;9
7292;Panerių;Boružė;3526636673;Taip;3;5;0;8
7293;Panerių;Boružė;8407995549;Taip;0;0;1;1
7294;Panerių;Boružė;3502494751;Taip;5;3;5;13
7295;Panerių;Boružė;6653710644;Taip;0;3;0;3
7296;Panerių;Boružė;7227118885;Ne;1;0;2;3
7297;Panerių;Boružė;9288515724;Ne;18;0;0;18
7298;Panerių;Boružė;7976634590;Taip;11;0;1;12
7299;Panerių;Boružė;4716214117;Taip;5;4;0;9
7300;Panerių;Boružė;4957564440;Taip;0;0;3;3
7301;Panerių;Boružė;1985780685;Ne;0;0;5;5
7302;Papartis;ZUIKUČIAI;8874222586;Taip;4;0;2;6
7303;Papartis;ZUIKUČIAI;2446379598;Taip;0;0;1;1
7304;Papartis;ZUIKUČIAI;3054883426;Taip;18;0;0;18
7305;Papartis;ZUIKUČIAI;1191546794;Taip;6;0;0;6
7306;Papartis;ZUIKUČIAI;7619963429;Taip;0;2;0;2
7307;Papartis;ZUIKUČIAI;8958880558;Taip;3;7;0;10
7308;Papartis;ZUIKUČIAI;4380030213;Taip;5;0;0;5
7309;Papartis;ZUIKUČIAI;4906248064;Taip;0;4;2;6
7310;Papartis;ZUIKUČIAI;8447326505;Taip;0;3;0;3
7311;Papartis;ZUIKUČIAI;1919362027;Taip;5;1;1;7
7312;Papartis;ZUIKUČIAI;4640068595;Taip;5;0;0;5
7313;Papartis;ZUIKUČIAI;5361925390;Taip;0;0;3;3
7314;Papartis;ZUIKUČIAI;5796928317;Taip;9;0;0;9
7315;Papartis;ZUIKUČIAI;9375751990;Taip;0;12;0;12
7316;Papartis;ZUIKUČIAI;6266095782;Taip;0;0;3;3
7317;Papartis;ZUIKUČIAI;5786648402;Taip;6;0;0;6
7318;Papartis;ZUIKUČIAI;5776038830;Taip;3;0;4;7
7319;Papartis;ZUIKUČIAI;5579899922;Taip;0;0;3;3
7320;Papartis;ZUIKUČIAI;8808902528;Taip;2;3;0;5
7321;Papartis;ZUIKUČIAI;9358310527;Taip;5;6;0;11
7322;Papartis;ZUIKUČIAI;5363926529;Taip;0;9;0;9
7323;Papartis;ZUIKUČIAI;1722192450;Taip;10;0;0;10
7324;Papartis;DRUGELIAI;8005876431;Taip;16;0;0;16
7325;Papartis;DRUGELIAI;7384518191;Taip;0;10;5;15
7326;Papartis;DRUGELIAI;6664178454;Taip;6;1;1;8
7327;Papartis;DRUGELIAI;2432516496;Taip;9;1;3;13
7328;Papartis;DRUGELIAI;7742769931;Taip;11;0;3;14
7329;Papartis;DRUGELIAI;8305560946;Ne;7;0;4;11
7330;Papartis;DRUGELIAI;4778327620;Taip;8;4;0;12
7331;Papartis;DRUGELIAI;7486667034;Taip;8;0;0;8
7332;Papartis;DRUGELIAI;7331682622;Taip;7;3;0;10
7333;Papartis;DRUGELIAI;2824078830;Taip;4;3;1;8
7334;Papartis;DRUGELIAI;8782882575;Taip;0;11;0;11
7335;Papartis;DRUGELIAI;1405767603;Taip;0;4;0;4
7336;Papartis;DRUGELIAI;6435625940;Taip;6;4;0;10
7337;Papartis;DRUGELIAI;7187797639;Taip;5;0;6;11
7338;Papartis;DRUGELIAI;3411472740;Taip;15;0;0;15
7339;Papartis;DRUGELIAI;3209105694;Taip;8;0;0;8
7340;Papartis;DRUGELIAI;8277830926;Taip;6;0;0;6
7341;Papartis;DRUGELIAI;1759982543;Taip;0;4;0;4
7342;Papartis;DRUGELIAI;4689046394;Taip;6;0;0;6
7343;Papartis;DRUGELIAI;5430993785;Taip;18;0;0;18
7344;Papartis;ŽVIRBLIUKAI;7590170146;Taip;5;4;3;12
7345;Papartis;ŽVIRBLIUKAI;42803013754;Taip;0;4;0;4
7346;Papartis;ŽVIRBLIUKAI;3408756311;Taip;4;4;3;11
7347;Papartis;ŽVIRBLIUKAI;4935694347;Taip;0;6;1;7
7348;Papartis;ŽVIRBLIUKAI;7067369268;Taip;0;4;4;8
7349;Papartis;ŽVIRBLIUKAI;1836914270;Taip;3;4;0;7
7350;Papartis;ŽVIRBLIUKAI;4508053349;Taip;0;4;0;4
7351;Papartis;ŽVIRBLIUKAI;2778629398;Taip;0;3;9;12
7352;Papartis;ŽVIRBLIUKAI;2535412635;Taip;7;0;0;7
7353;Papartis;ŽVIRBLIUKAI;7102350653;Taip;0;4;0;4
7354;Papartis;ŽVIRBLIUKAI;1205854439;Taip;0;4;3;7
7355;Papartis;ŽVIRBLIUKAI;1672028156;Taip;0;5;2;7
7356;Papartis;ŽVIRBLIUKAI;8148483438;Taip;5;6;0;11
7357;Papartis;ŽVIRBLIUKAI;3295731801;Taip;3;4;3;10
7358;Papartis;ŽVIRBLIUKAI;6797687614;Taip;6;5;3;14
7359;Papartis;ŽVIRBLIUKAI;3475745012;Taip;13;5;0;18
7360;Papartis;ŽVIRBLIUKAI;4634683589;Taip;12;3;4;19
7361;Papartis;ŽVIRBLIUKAI;3267416367;Taip;0;3;0;3
7362;Papartis;ŽVIRBLIUKAI;3243869451;Taip;1;1;0;2
7363;Papartis;ŽVIRBLIUKAI;5265293240;Taip;0;4;2;6
7364;Papartis;ŽVIRBLIUKAI;9134335737;Taip;0;4;2;6
7365;Papartis;ŽVIRBLIUKAI;7387281720;Taip;0;8;2;10
7366;Papartis;PELĖDŽIUKAI;7606939822;Taip;5;3;0;8
7367;Papartis;PELĖDŽIUKAI;2447926422;Taip;0;8;0;8
7368;Papartis;PELĖDŽIUKAI;1260151691;Taip;0;2;0;2
7369;Papartis;PELĖDŽIUKAI;4346817695;Taip;0;3;2;5
7370;Papartis;PELĖDŽIUKAI;1527263538;Taip;0;3;1;4
7371;Papartis;PELĖDŽIUKAI;1219140467;Taip;0;5;0;5
7372;Papartis;PELĖDŽIUKAI;5410369044;Ne;1;8;0;9
7373;Papartis;PELĖDŽIUKAI;1065128993;Taip;0;4;0;4
7374;Papartis;PELĖDŽIUKAI;6126912448;Taip;0;6;0;6
7375;Papartis;PELĖDŽIUKAI;8952917454;Ne;0;3;4;7
7376;Papartis;PELĖDŽIUKAI;3182457453;Taip;0;3;2;5
7377;Papartis;PELĖDŽIUKAI;5675537250;Taip;0;3;0;3
7378;Papartis;PELĖDŽIUKAI;72182866449;Taip;6;3;0;9
7379;Papartis;PELĖDŽIUKAI;4992305227;Taip;0;5;0;5
7380;Papartis;PELĖDŽIUKAI;7703070601;Taip;0;3;1;4
7381;Papartis;PELĖDŽIUKAI;7902130389;Taip;0;3;0;3
7382;Papartis;PELĖDŽIUKAI;4279580382;Taip;0;1;0;1
7383;Papartis;PELĖDŽIUKAI;1974159967;Taip;0;3;1;4
7384;Papartis;PELĖDŽIUKAI;5732853976;Taip;0;3;3;6
7385;Papartis;PELĖDŽIUKAI;1554777403;Taip;3;3;0;6
7386;Papartis;PELĖDŽIUKAI;3107106078;Taip;0;2;0;2
7387;Papartis;SAULUTĖS;5538433120;Taip;0;0;5;5
7388;Papartis;SAULUTĖS;2669085057;Ne;0;0;15;15
7389;Papartis;SAULUTĖS;6585372451;Taip;10;0;0;10
7390;Papartis;SAULUTĖS;6734567714;Taip;0;7;0;7
7391;Papartis;SAULUTĖS;4570512336;Taip;5;4;0;9
7392;Papartis;SAULUTĖS;1231594320;Taip;0;2;2;4
7393;Papartis;SAULUTĖS;3539507686;Taip;9;0;0;9
7394;Papartis;SAULUTĖS;3595627659;Taip;13;0;0;13
7395;Papartis;SAULUTĖS;6977513472;Taip;0;3;3;6
7396;Papartis;SAULUTĖS;5070767260;Taip;7;3;2;12
7397;Papartis;SAULUTĖS;9380951144;Taip;9;0;5;14
7398;Papartis;SAULUTĖS;4016297254;Taip;18;0;0;18
7399;Papartis;SAULUTĖS;5323875279;Taip;0;7;0;7
7400;Papartis;SAULUTĖS;5465955537;Taip;15;0;0;15
7401;Papartis;SAULUTĖS;2812347963;Taip;7;0;1;8
7402;Papartis;SAULUTĖS;4597039190;Taip;5;2;0;7
7403;Papartis;SAULUTĖS;8420752169;Taip;0;0;12;12
7404;Papartis;SAULUTĖS;6346776139;Taip;15;0;0;15
7405;Papartis;SAULUTĖS;1352401881;Taip;0;6;0;6
7406;Papartis;SAULUTĖS;3685642787;Taip;9;0;0;9
7407;Papartis;SAULUTĖS;6136213985;Taip;3;2;5;10
7408;Papartis;SAULUTĖS;7107692314;Taip;3;2;5;10
7409;Papartis;GANDRIUKAI;4878190663;Taip;0;5;2;7
7410;Papartis;GANDRIUKAI;9900023788;Taip;0;3;0;3
7411;Papartis;GANDRIUKAI;8946678515;Taip;3;0;3;6
7412;Papartis;GANDRIUKAI;2783708905;Taip;0;0;6;6
7413;Papartis;GANDRIUKAI;6883101103;Taip;0;3;0;3
7414;Papartis;GANDRIUKAI;2868899342;Taip;4;3;0;7
7415;Papartis;GANDRIUKAI;7768672610;Taip;1;4;1;6
7416;Papartis;GANDRIUKAI;9384670351;Taip;5;3;0;8
7417;Papartis;GANDRIUKAI;9968072478;Taip;0;0;10;10
7418;Papartis;GANDRIUKAI;2215846642;Taip;5;3;0;8
7419;Papartis;GANDRIUKAI;3320524073;Taip;0;4;1;5
7420;Papartis;GANDRIUKAI;9704930584;Taip;0;3;0;3
7421;Papartis;GANDRIUKAI;9804863902;Taip;2;4;0;6
7422;Papartis;GANDRIUKAI;9072635586;Ne;6;2;1;9
7423;Papartis;GANDRIUKAI;7859096984;Taip;10;3;0;13
7424;Papartis;GANDRIUKAI;1442806517;Taip;0;2;0;2
7425;Papartis;GANDRIUKAI;7252265838;Taip;0;3;3;6
7426;Papartis;GANDRIUKAI;9978625382;Taip;15;0;0;15
7427;Papartis;GANDRIUKAI;5883751305;Ne;0;2;0;2
7428;Papartis;GANDRIUKAI;4509843536;Taip;18;0;0;18
7429;Papartis;GANDRIUKAI;8768526171;Taip;14;0;0;14
7430;Papartis;AITVARELIAI;8891856856;Taip;0;4;0;4
7431;Papartis;AITVARELIAI;6889782462;Taip;0;3;4;7
7432;Papartis;AITVARELIAI;5736456872;Taip;10;3;0;13
7433;Papartis;AITVARELIAI;3040269026;Taip;10;3;0;13
7434;Papartis;AITVARELIAI;8532558577;Taip;0;6;0;6
7435;Papartis;AITVARELIAI;4918854899;Taip;0;6;2;8
7436;Papartis;AITVARELIAI;5252947502;Taip;0;7;0;7
7437;Papartis;AITVARELIAI;1916222143;Taip;0;3;0;3
7438;Papartis;AITVARELIAI;7018190169;Taip;0;2;0;2
7439;Papartis;AITVARELIAI;7803854703;Taip;0;3;0;3
7440;Papartis;AITVARELIAI;4261270064;Taip;6;1;0;7
7441;Papartis;AITVARELIAI;6416605464;Taip;0;3;1;4
7442;Papartis;AITVARELIAI;1266338760;Taip;5;1;1;7
7443;Papartis;AITVARELIAI;7504793827;Taip;8;0;0;8
7444;Papartis;AITVARELIAI;7156767639;Taip;5;0;6;11
7445;Papartis;AITVARELIAI;5268226380;Taip;0;0;2;2
7446;Papartis;AITVARELIAI;8626682787;Taip;0;0;4;4
7447;Papartis;AITVARELIAI;2116140075;Taip;0;7;0;7
7448;Papartis;AITVARELIAI;3896803048;Taip;0;6;0;6
7449;Papartis;AITVARELIAI;4138926711;Taip;0;3;3;6
7450;Papartis;AITVARELIAI;8989172483;Taip;0;0;13;13
7451;Papartis;AITVARELIAI;9384475270;Taip;5;8;0;13
7452;Papartis;SMALSUČIAI;7856148436;Taip;18;0;0;18
7453;Papartis;SMALSUČIAI;4969807705;Taip;7;0;1;8
7454;Papartis;SMALSUČIAI;5383936595;Taip;0;6;0;6
7455;Papartis;SMALSUČIAI;1698871014;Taip;10;3;0;13
7456;Papartis;SMALSUČIAI;6274608449;Taip;3;3;0;6
7457;Papartis;SMALSUČIAI;6664773988;Taip;4;5;0;9
7458;Papartis;SMALSUČIAI;8875490564;Taip;15;0;0;15
7459;Papartis;SMALSUČIAI;2921187615;Taip;15;3;0;18
7460;Papartis;SMALSUČIAI;5128663521;Taip;0;3;0;3
7461;Papartis;SMALSUČIAI;4500675679;Taip;6;2;0;8
7462;Papartis;SMALSUČIAI;7203919287;Taip;0;2;0;2
7463;Papartis;SMALSUČIAI;1486770896;Ne;0;4;0;4
7464;Papartis;SMALSUČIAI;5132031416;Taip;15;2;0;17
7465;Papartis;SMALSUČIAI;3395306653;Taip;10;3;0;13
7466;Papartis;SMALSUČIAI;5964232886;Taip;0;2;1;3
7467;Papartis;SMALSUČIAI;7149853209;Taip;3;3;1;7
7468;Papartis;SMALSUČIAI;4483401826;Taip;5;0;0;5
7469;Papartis;SMALSUČIAI;1616537800;Taip;10;4;0;14
7470;Papartis;"ŽIRNIUKAI ";8897061283;Taip;9;0;0;9
7471;Papartis;"ŽIRNIUKAI ";3310893254;Taip;0;0;6;6
7472;Papartis;"ŽIRNIUKAI ";1073755384;Taip;2;0;7;9
7473;Papartis;"ŽIRNIUKAI ";7647225316;Taip;10;3;0;13
7474;Papartis;"ŽIRNIUKAI ";1210592579;Taip;4;3;0;7
7475;Papartis;"ŽIRNIUKAI ";1519815331;Taip;0;1;0;1
7476;Papartis;"ŽIRNIUKAI ";4158525314;Taip;7;2;0;9
7477;Papartis;"ŽIRNIUKAI ";4978398085;Taip;0;9;1;10
7478;Papartis;"ŽIRNIUKAI ";9746397380;Taip;5;0;4;9
7479;Papartis;"ŽIRNIUKAI ";4952279543;Taip;0;9;0;9
7480;Papartis;"ŽIRNIUKAI ";5276806556;Taip;0;0;3;3
7481;Papartis;"ŽIRNIUKAI ";2521609574;Taip;8;0;0;8
7482;Papartis;"ŽIRNIUKAI ";7617558492;Taip;0;3;13;16
7483;Papartis;"ŽIRNIUKAI ";8412962815;Ne;3;0;3;6
7484;Papartis;"ŽIRNIUKAI ";1267981238;Taip;0;13;5;18
7485;Papartis;"ŽIRNIUKAI ";2772758899;Taip;5;3;2;10
7486;Papartis;"ŽIRNIUKAI ";1183123161;Taip;0;0;3;3
7487;Papartis;"ŽIRNIUKAI ";1150772988;Ne;0;2;0;2
7488;Papartis;"ŽIRNIUKAI ";9518392031;Taip;5;0;3;8
7489;Papartis;"ŽIRNIUKAI ";6615368741;Taip;9;3;1;13
7490;Papartis;"ŽIRNIUKAI ";7108606229;Ne;12;0;6;18
7491;Papartis;"ŽIRNIUKAI ";1614261572;Taip;0;2;0;2
7492;Papartis;"ŽIRNIUKAI ";8834463589;Taip;0;4;0;4
7493;Papartis;BORUŽĖLĖS;3576856223;Taip;0;5;0;5
7494;Papartis;BORUŽĖLĖS;7492923318;Taip;11;4;0;15
7495;Papartis;BORUŽĖLĖS;1157298413;Taip;0;5;0;5
7496;Papartis;BORUŽĖLĖS;2079105902;Taip;0;4;1;5
7497;Papartis;BORUŽĖLĖS;1159418157;Taip;7;0;0;7
7498;Papartis;BORUŽĖLĖS;3490370261;Taip;13;0;0;13
7499;Papartis;BORUŽĖLĖS;3107245976;Ne;10;0;0;10
7500;Papartis;BORUŽĖLĖS;1566259150;Ne;0;1;0;1
7501;Papartis;BORUŽĖLĖS;1381195839;Taip;3;1;0;4
7502;Papartis;BORUŽĖLĖS;6107558090;Taip;10;1;0;11
7503;Papartis;BORUŽĖLĖS;6776383676;Taip;10;5;0;15
7504;Papartis;BORUŽĖLĖS;9838432144;Taip;0;6;0;6
7505;Papartis;BORUŽĖLĖS;9884399306;Taip;0;6;0;6
7506;Papartis;BORUŽĖLĖS;1511111597;Taip;1;4;0;5
7507;Papartis;BORUŽĖLĖS;8055310718;Taip;8;0;0;8
7508;Papartis;BORUŽĖLĖS;5259754395;Taip;0;7;0;7
7509;Papartis;BORUŽĖLĖS;5959006739;Taip;5;6;0;11
7510;Papartis;VARPELIAI;7260304487;Taip;14;0;0;14
7511;Papartis;VARPELIAI;9581159294;Taip;0;3;15;18
7512;Papartis;VARPELIAI;2956950308;Taip;3;0;0;3
7513;Papartis;VARPELIAI;6710049689;Taip;7;0;0;7
7514;Papartis;VARPELIAI;2777359899;Taip;14;0;0;14
7515;Papartis;VARPELIAI;1993893368;Taip;0;1;7;8
7516;Papartis;VARPELIAI;3345085436;Taip;0;1;0;1
7517;Papartis;VARPELIAI;7189999679;Taip;6;0;0;6
7518;Papartis;VARPELIAI;4256878733;Taip;5;3;0;8
7519;Papartis;VARPELIAI;8443731277;Taip;0;0;6;6
7520;Papartis;VARPELIAI;3419374226;Taip;0;0;7;7
7521;Papartis;VARPELIAI;2600724041;Taip;6;2;0;8
7522;Papartis;VARPELIAI;2053568874;Taip;5;11;0;16
7523;Papartis;VARPELIAI;3173271837;Taip;9;0;0;9
7524;Papartis;VARPELIAI;4952700737;Taip;14;0;0;14
7525;Papartis;VARPELIAI;6146264193;Taip;15;0;0;15
7526;Papartis;VARPELIAI;8642079824;Taip;0;3;6;9
7527;Papartis;VARPELIAI;2421158534;Taip;0;0;1;1
7528;Papartis;VARPELIAI;8872914372;Taip;4;3;1;8
7529;Papartis;NYKŠTUKAI;1566011843;Taip;7;0;1;8
7530;Papartis;NYKŠTUKAI;5652769035;Taip;7;2;0;9
7531;Papartis;NYKŠTUKAI;5942160584;Taip;9;0;0;9
7532;Papartis;NYKŠTUKAI;9922091482;Taip;18;0;0;18
7533;Papartis;NYKŠTUKAI;1680412204;Taip;15;0;0;15
7534;Papartis;NYKŠTUKAI;9285319899;Taip;7;0;5;12
7535;Papartis;NYKŠTUKAI;9502229005;Taip;5;3;0;8
7536;Papartis;NYKŠTUKAI;6949120693;Taip;4;6;0;10
7537;Papartis;NYKŠTUKAI;6794076631;Taip;6;4;0;10
7538;Papartis;NYKŠTUKAI;5957889361;Taip;5;3;0;8
7539;Papartis;NYKŠTUKAI;5608868738;Ne;0;8;0;8
7540;Papartis;NYKŠTUKAI;4203241118;Taip;7;3;0;10
7541;Papartis;NYKŠTUKAI;4806652727;Taip;0;3;0;3
7542;Papartis;NYKŠTUKAI;9939850340;Taip;4;3;0;7
7543;Papartis;NYKŠTUKAI;3324647852;Taip;6;3;0;9
7544;Papartis;NYKŠTUKAI;6423401656;Taip;11;0;0;11
7545;Papartis;NYKŠTUKAI;8932290803;Taip;9;0;0;9
7546;Papartis;NYKŠTUKAI;5652560002;Taip;5;3;0;8
7547;Papartis;NYKŠTUKAI;1559196767;Taip;0;7;1;8
7548;Papartis;NYKŠTUKAI;6360881137;Taip;0;1;0;1
7549;Papartis;NYKŠTUKAI;6941978169;Taip;9;0;0;9
7550;Papartis;NYKŠTUKAI;7080578299;Taip;13;0;0;13
7551;Pasaka;Drugelių;5665758011;Taip;5;4;0;9
7552;Pasaka;Drugelių;3092993659;Taip;0;3;0;3
7553;Pasaka;Drugelių;5027755073;Taip;0;5;2;7
7554;Pasaka;Drugelių;1300996831;Taip;0;3;0;3
7555;Pasaka;Drugelių;1313576071;Taip;3;3;0;6
7556;Pasaka;Drugelių;2621046003;Taip;0;2;0;2
7557;Pasaka;Drugelių;7040953491;Taip;0;4;0;4
7558;Pasaka;Drugelių;7455544922;Taip;0;5;0;5
7559;Pasaka;Drugelių;8963465320;Taip;0;4;0;4
7560;Pasaka;Drugelių;4743331873;Taip;0;11;0;11
7561;Pasaka;Drugelių;1583090840;Taip;0;5;0;5
7562;Pasaka;Drugelių;2774371800;Taip;5;4;2;11
7563;Pasaka;Drugelių;5547931812;Taip;5;3;0;8
7564;Pasaka;Drugelių;7685589423;Taip;5;4;0;9
7565;Pasaka;Drugelių;3088081091;Taip;0;3;0;3
7566;Pasaka;Drugelių;9060396476;Taip;0;4;0;4
7567;Pasaka;Drugelių;7078492847;Taip;0;4;3;7
7568;Pasaka;Nykštukų;7546205285;Taip;0;3;0;3
7569;Pasaka;Nykštukų;5687494160;Taip;1;5;0;6
7570;Pasaka;Nykštukų;3151916774;Taip;0;6;0;6
7571;Pasaka;Nykštukų;4773893970;Taip;0;6;0;6
7572;Pasaka;Nykštukų;4082752808;Taip;10;0;3;13
7573;Pasaka;Nykštukų;6788771605;Taip;0;3;0;3
7574;Pasaka;Nykštukų;1813068555;Taip;0;4;0;4
7575;Pasaka;Nykštukų;9567521319;Taip;1;0;0;1
7576;Pasaka;Nykštukų;8400549247;Taip;1;0;2;3
7577;Pasaka;Nykštukų;6326056771;Taip;0;4;0;4
7578;Pasaka;Nykštukų;4175157894;Taip;0;7;4;11
7579;Pasaka;Nykštukų;5768958388;Taip;0;3;7;10
7580;Pasaka;Nykštukų;2797217440;Taip;0;3;0;3
7581;Pasaka;Nykštukų;7292437626;Taip;0;4;0;4
7582;Pasaka;Montesori;16974081144;Taip;5;3;1;9
7583;Pasaka;Montesori;1514381003;Taip;0;3;2;5
7584;Pasaka;Montesori;5812041166;Taip;0;3;2;5
7585;Pasaka;Montesori;4305485747;Taip;5;0;2;7
7586;Pasaka;Montesori;7837662446;Taip;5;0;3;8
7587;Pasaka;Montesori;5240642967;Taip;0;0;1;1
7588;Pasaka;Montesori;3047931231;Taip;0;0;5;5
7589;Pasaka;Montesori;3195380938;Taip;0;0;1;1
7590;Pasaka;Montesori;5031538468;Taip;0;3;0;3
7591;Pasaka;Montesori;6625690696;Taip;7;0;2;9
7592;Pasaka;Montesori;4548601585;Taip;6;5;0;11
7593;Pasaka;Montesori;7887326763;Taip;0;3;0;3
7594;Pasaka;Montesori;4366930715;Taip;0;0;5;5
7595;Pasaka;Montesori;9850592463;Taip;5;3;0;8
7596;Pasaka;Montesori;2995831258;Taip;5;0;3;8
7597;Pasaka;Montesori;1216568014;Taip;0;3;0;3
7598;Pasaka;Montesori;6248810027;Taip;10;0;3;13
7599;Pasaka;Montesori;3620395122;Taip;2;0;2;4
7600;Pasaka;Montesori;5689164477;Taip;5;0;1;6
7601;Pasaka;Montesori;6484610418;Taip;0;0;3;3
7602;Pasaka;Montesori;8873248505;Taip;18;0;0;18
7603;Pasaka;Žirniukų;9867183480;Taip;0;0;10;10
7604;Pasaka;Žirniukų;2815348652;Taip;0;0;4;4
7605;Pasaka;Žirniukų;5651025350;Taip;0;3;0;3
7606;Pasaka;Žirniukų;2422958320;Taip;0;3;0;3
7607;Pasaka;Žirniukų;9438006825;Taip;0;0;1;1
7608;Pasaka;Žirniukų;9136524816;Taip;0;3;4;7
7609;Pasaka;Žirniukų;9766432049;Taip;1;0;7;8
7610;Pasaka;Žirniukų;6387972576;Taip;5;2;1;8
7611;Pasaka;Žirniukų;4948174745;Taip;15;0;0;15
7612;Pasaka;Žirniukų;2144975281;Taip;0;0;2;2
7613;Pasaka;Žirniukų;4629119214;Taip;1;3;4;8
7614;Pasaka;Žirniukų;2086919906;Taip;15;0;3;18
7615;Pasaka;Žirniukų;8519108324;Taip;5;3;0;8
7616;Pasaka;Žirniukų;9950979894;Taip;0;0;1;1
7617;Pasaka;Žirniukų;9654507441;Taip;10;0;7;17
7618;Pasaka;Žirniukų;9654507441;Taip;10;0;7;17
7619;Pasaka;Žirniukų;9654507441;Taip;10;0;7;17
7620;Pasaka;Žirniukų;5921553817;Taip;0;0;5;5
7621;Pasaka;Žirniukų;2569560383;Taip;0;7;0;7
7622;Pasaka;"Voveriukų ";3606141216;Taip;9;13;0;22
7623;Pasaka;"Voveriukų ";5217688848;Taip;9;13;0;22
7624;Pasaka;"Voveriukų ";4171004263;Taip;5;3;0;8
7625;Pasaka;"Voveriukų ";8504575043;Taip;3;0;3;6
7626;Pasaka;"Voveriukų ";1488711275;Taip;0;3;0;3
7627;Pasaka;"Voveriukų ";2854919649;Taip;0;0;2;2
7628;Pasaka;"Voveriukų ";1950145441;Taip;0;3;3;6
7629;Pasaka;"Voveriukų ";4466963221;Taip;0;3;6;9
7630;Pasaka;"Voveriukų ";9588247759;Taip;0;2;6;8
7631;Pasaka;"Voveriukų ";3536862796;Ne;0;0;2;2
7632;Pasaka;"Voveriukų ";8899289832;Ne;0;0;3;3
7633;Pasaka;"Voveriukų ";4915357646;Taip;0;0;6;6
7634;Pasaka;"Voveriukų ";7176272684;Taip;0;8;0;8
7635;Pasaka;"Voveriukų ";9687385445;Taip;0;2;1;3
7636;Pasaka;"Voveriukų ";4799036184;Taip;0;0;4;4
7637;Pasaka;"Voveriukų ";6684234474;Taip;5;2;3;10
7638;Pasaka;"Voveriukų ";9003508760;Taip;5;3;0;8
7639;Pasaka;"Voveriukų ";6925961600;Taip;5;0;1;6
7640;Pasaka;"Voveriukų ";8421404290;Taip;0;2;1;3
7641;Pasaka;"Voveriukų ";1745181416;Taip;0;9;2;11
7642;Pasaka;"Voveriukų ";9780490338;Taip;14;3;0;17
7643;Pasaka;"Voveriukų ";6315362421;Taip;0;3;0;3
7644;Pasaka;"Voveriukų ";6315362421;Taip;0;3;0;3
7645;Pasaka;"VALDOFRO 12";7010681103;Taip;0;9;2;11
7646;Pasaka;"VALDOFRO 12";56766427323;Taip;0;3;2;5
7647;Pasaka;"VALDOFRO 12";4680456848;Taip;0;3;0;3
7648;Pasaka;"VALDOFRO 12";5141156728;Taip;0;3;9;12
7649;Pasaka;"VALDOFRO 12";2268625523;Taip;8;0;0;8
7650;Pasaka;"VALDOFRO 12";8976424908;Taip;0;3;3;6
7651;Pasaka;"VALDOFRO 12";8701112181;Taip;3;3;2;8
7652;Pasaka;"VALDOFRO 12";1305541319;Taip;0;6;1;7
7653;Pasaka;"VALDOFRO 12";7682903999;Taip;3;3;2;8
7654;Pasaka;"VALDOFRO 12";4325198579;Taip;0;3;0;3
7655;Pasaka;"VALDOFRO 12";6448940090;Taip;0;0;1;1
7656;Pasaka;"VALDOFRO 12";8411025450;Taip;5;3;0;8
7657;Pasaka;"VALDOFRO 12";1756831961;Taip;0;3;0;3
7658;Pasaka;"VALDOFRO 12";3840053722;Ne;0;9;2;11
7659;Pasaka;"VALDOFRO 12";8995205555;Taip;0;0;2;2
7660;Pasaka;"VALDOFRO 12";4548945364;Taip;0;3;3;6
7661;Pasaka;"VALDOFRO 12";8912822936;Taip;0;3;0;3
7662;Pasaka;"VALDOFRO 12";4301573328;Taip;0;0;4;4
7663;Pasaka;"VALDOFRO 12";5244582148;Taip;0;0;4;4
7664;Pasaka;"VALDOFRO 12";2650797982;Taip;0;3;0;3
7665;Pasaka;"VALDOFRO 12";9065016148;Taip;0;0;4;4
7666;Pasaka;"VALDOFRO 12";9809498406;Taip;0;3;0;3
7667;Pasaka;"VALDOFRO 12";5040348350;Taip;0;0;7;7
7668;Pasaka;"VALDORFO 2";71365777764;Taip;3;3;0;6
7669;Pasaka;"VALDORFO 2";77904202630;Taip;0;3;0;3
7670;Pasaka;"VALDORFO 2";4752117533;Taip;0;1;3;4
7671;Pasaka;"VALDORFO 2";7950962252;Taip;8;3;3;14
7672;Pasaka;"VALDORFO 2";8590385693;Taip;0;0;7;7
7673;Pasaka;"VALDORFO 2";4620573687;Taip;0;5;3;8
7674;Pasaka;"VALDORFO 2";4825373152;Taip;0;3;2;5
7675;Pasaka;"VALDORFO 2";9462745431;Taip;0;0;7;7
7676;Pasaka;"VALDORFO 2";5399148997;Taip;0;3;0;3
7677;Pasaka;"VALDORFO 2";1799326151;Taip;2;3;1;6
7678;Pasaka;"VALDORFO 2";2273629510;Taip;2;3;1;6
7679;Pasaka;"VALDORFO 2";5903270845;Taip;0;3;0;3
7680;Pasaka;"VALDORFO 2";3778182691;Taip;0;5;3;8
7681;Pasaka;"VALDORFO 2";8947139321;Taip;0;5;0;5
7682;Pasaka;"VALDORFO 2";5742479853;Taip;2;3;4;9
7683;Pasaka;"VALDORFO 2";3049361712;Taip;0;3;2;5
7684;Pasaka;"VALDORFO 2";6497042042;Taip;5;0;3;8
7685;Pasaka;"VALDORFO 2";9150761761;Taip;5;0;0;5
7686;Pasaka;"VALDORFO 2";9821858308;Taip;5;0;3;8
7687;Pasaka;"VALDORFO 2";1648043715;Taip;0;0;6;6
7688;Pasaka;"VALDORFO 2";8855436141;Taip;0;0;4;4
7689;Pasaka;Gudručiai;6253266504;Taip;5;0;0;5
7690;Pasaka;Gudručiai;4137222204;Taip;5;3;0;8
7691;Pasaka;Gudručiai;7103485358;Taip;0;4;0;4
7692;Pasaka;Gudručiai;7648503006;Taip;0;0;8;8
7693;Pasaka;Gudručiai;2400455036;Taip;0;3;0;3
7694;Pasaka;Gudručiai;9722435751;Taip;0;4;0;4
7695;Pasaka;Gudručiai;73703706115;Taip;0;3;2;5
7696;Pasaka;Gudručiai;79170702319;Taip;4;3;1;8
7697;Pasaka;Gudručiai;5965121999;Taip;0;0;3;3
7698;Pasaka;Gudručiai;7286419663;Taip;0;2;0;2
7699;Pasaka;Gudručiai;5973028582;Taip;0;3;0;3
7700;Pasaka;Gudručiai;2788679885;Taip;5;4;1;10
7701;Pasaka;Gudručiai;7445696309;Taip;0;3;0;3
7702;Pasaka;Gudručiai;1565873178;Taip;0;5;1;6
7703;Pasaka;Gudručiai;2697014098;Taip;0;3;0;3
7704;Pasaka;Gudručiai;5651452381;Taip;5;4;0;9
7705;Pasaka;Gudručiai;6441884677;Taip;4;4;0;8
7706;Pasaka;Gudručiai;2018620389;Taip;0;3;0;3
7707;Pasaka;Gudručiai;2671403814;Taip;8;4;1;13
7708;Pasaka;Gudručiai;42548487389;Taip;0;0;5;5
7709;Pasaka;Gudručiai;8448558788;Taip;0;3;2;5
7710;Pasaka;Bitelių;5351364328;Taip;0;3;5;8
7711;Pasaka;Bitelių;4635912654;Taip;0;3;5;8
7712;Pasaka;Bitelių;7248640367;Taip;0;6;0;6
7713;Pasaka;Bitelių;8277245475;Taip;0;3;5;8
7714;Pasaka;Bitelių;6868519179;Taip;1;0;2;3
7715;Pasaka;Bitelių;6759415053;Taip;0;0;3;3
7716;Pasaka;Bitelių;5723970763;Taip;0;3;3;6
7717;Pasaka;Bitelių;9136521759;Taip;0;3;3;6
7718;Pasaka;Bitelių;9737445077;Taip;0;3;0;3
7719;Pasaka;Bitelių;2638182985;Taip;0;3;0;3
7720;Pasaka;Bitelių;2293613528;Taip;0;2;0;2
7721;Pasaka;Bitelių;3367346582;Taip;5;3;0;8
7722;Pasaka;Bitelių;3351338617;Taip;0;1;0;1
7723;Pasaka;Bitelių;5371046207;Taip;0;3;2;5
7724;Pasaka;Bitelių;6139825302;Taip;9;4;0;13
7725;Pasaka;Bitelių;4970812899;Taip;0;3;0;3
7726;Pasaka;Bitelių;8873115041;Taip;5;0;3;8
7727;Pasaka;Bitelių;1720511696;Taip;14;0;0;14
7728;Pasaka;Bitelių;2963373430;Taip;5;0;1;6
7729;Pasaka;"Pabiručių ";4846146925;Taip;2;0;3;5
7730;Pasaka;"Pabiručių ";9770811826;Taip;0;0;3;3
7731;Pasaka;"Pabiručių ";5230621839;Taip;5;3;1;9
7732;Pasaka;"Pabiručių ";9471447977;Taip;0;2;3;5
7733;Pasaka;"Pabiručių ";7751618911;Taip;0;0;9;9
7734;Pasaka;"Pabiručių ";7696383564;Taip;0;0;5;5
7735;Pasaka;"Pabiručių ";3796844193;Taip;4;0;4;8
7736;Pasaka;"Pabiručių ";4910817298;Taip;3;0;3;6
7737;Pasaka;"Pabiručių ";7127138831;Taip;3;0;5;8
7738;Pasaka;"Pabiručių ";9813397639;Taip;3;0;5;8
7739;Pasaka;"Pabiručių ";4994426702;Taip;0;0;2;2
7740;Pasaka;"Pabiručių ";8289010515;Taip;0;0;2;2
7741;Pasaka;"Pabiručių ";5111195289;Taip;15;0;2;17
7742;Pasaka;"Pabiručių ";6182223896;Taip;15;0;2;17
7743;Pasaka;"Pabiručių ";8558563996;Taip;5;1;3;9
7744;Pasaka;"Pabiručių ";3557547656;Taip;12;3;3;18
7745;Pasaka;Šnekučių;3709664132;Taip;0;1;0;1
7746;Pasaka;Šnekučių;1512874567;Taip;0;3;0;3
7747;Pasaka;Šnekučių;1793176485;Taip;2;4;0;6
7748;Pasaka;Šnekučių;4296539838;Taip;0;0;6;6
7749;Pasaka;Šnekučių;1590306118;Taip;5;3;0;8
7750;Pasaka;Šnekučių;6795580569;Taip;0;2;1;3
7751;Pasaka;Šnekučių;3240292756;Taip;0;2;1;3
7752;Pasaka;Šnekučių;4215568107;Taip;5;3;0;8
7753;Pasaka;Šnekučių;8365256755;Taip;0;3;0;3
7754;Pasaka;Šnekučių;4816441219;Taip;5;0;3;8
7755;Pasaka;Šnekučių;1795497567;Taip;0;3;1;4
7756;Pasaka;Šnekučių;8347051587;Taip;5;2;0;7
7757;Pasaka;Šnekučių;8841669113;Taip;0;2;0;2
7758;Pasaka;Šnekučių;4975045894;Taip;8;0;0;8
7759;Pasaka;Šnekučių;3588073618;Taip;11;3;0;14
7760;Pasaka;Šnekučių;1194745876;Taip;0;0;7;7
7761;Pasaka;Šnekučių;1749821746;Taip;12;2;0;14
7762;Pasaka;Šnekučių;1723076060;Taip;4;2;3;9
7763;Pasaka;Šnekučių;8475365713;Taip;0;2;9;11
7764;Paslaptis;MONTIKI;4683384309;Taip;3;5;0;8
7765;Paslaptis;MONTIKI;9929877115;Taip;5;6;0;11
7766;Paslaptis;MONTIKI;6860366087;Taip;0;2;1;3
7767;Paslaptis;MONTIKI;9445405671;Taip;0;0;4;4
7768;Paslaptis;MONTIKI;3572102816;Taip;11;0;0;11
7769;Paslaptis;MONTIKI;2927014406;Taip;13;1;0;14
7770;Paslaptis;MONTIKI;8453213193;Taip;0;1;0;1
7771;Paslaptis;MONTIKI;7053452493;Taip;7;1;0;8
7772;Paslaptis;MONTIKI;3963816472;Taip;4;0;3;7
7773;Paslaptis;MONTIKI;5809630456;Taip;0;1;0;1
7774;Paslaptis;MONTIKI;6764142182;Taip;13;0;0;13
7775;Paslaptis;MONTIKI;3241323665;Taip;9;1;0;10
7776;Paslaptis;MONTIKI;9299390190;Taip;3;0;3;6
7777;Paslaptis;MONTIKI;9497654214;Taip;0;3;0;3
7778;Paslaptis;MONTIKI;5480407965;Taip;4;4;0;8
7779;Paslaptis;FRUTIKI;9100003209;Ne;0;12;0;12
7780;Paslaptis;FRUTIKI;4130010071;Taip;0;4;3;7
7781;Paslaptis;FRUTIKI;3984799090;Taip;0;4;1;5
7782;Paslaptis;FRUTIKI;5886364670;Taip;3;1;0;4
7783;Paslaptis;FRUTIKI;9066462355;Taip;0;1;0;1
7784;Paslaptis;FRUTIKI;5406800599;Taip;11;2;0;13
7785;Paslaptis;FRUTIKI;2675089401;Taip;0;3;0;3
7786;Paslaptis;FRUTIKI;1557783684;Taip;5;7;0;12
7787;Paslaptis;FRUTIKI;5206529350;Taip;3;3;0;6
7788;Paslaptis;FRUTIKI;2105441745;Taip;8;0;0;8
7789;Paslaptis;FRUTIKI;6686352764;Taip;0;0;6;6
7790;Paslaptis;FRUTIKI;5456011928;Taip;0;6;0;6
7791;Paslaptis;FRUTIKI;8717111488;Taip;0;7;0;7
7792;Paslaptis;FRUTIKI;5756338103;Taip;5;2;0;7
7793;Paslaptis;FRUTIKI;5646806136;Taip;2;4;0;6
7794;Paslaptis;FRUTIKI;4810686225;Taip;0;4;0;4
7795;Paslaptis;FRUTIKI;8296575784;Ne;9;0;0;9
7796;Paslaptis;FRUTIKI;1754621741;Taip;21;0;0;21
7797;Paslaptis;FRUTIKI;7638521198;Taip;0;3;0;3
7798;Paslaptis;KALAMBURIKI;1029321312;Taip;0;4;0;4
7799;Paslaptis;KALAMBURIKI;3093280943;Taip;0;3;0;3
7800;Paslaptis;KALAMBURIKI;9559318660;Taip;0;3;0;3
7801;Paslaptis;KALAMBURIKI;2705751628;Taip;0;0;1;1
7802;Paslaptis;KALAMBURIKI;2879752620;Taip;0;7;0;7
7803;Paslaptis;KALAMBURIKI;8280740387;Taip;0;4;0;4
7804;Paslaptis;KALAMBURIKI;5852939221;Taip;1;5;0;6
7805;Paslaptis;KALAMBURIKI;2693910134;Ne;4;3;0;7
7806;Paslaptis;KALAMBURIKI;2891547963;Taip;0;4;0;4
7807;Paslaptis;KALAMBURIKI;3104525540;Taip;15;3;0;18
7808;Paslaptis;KALAMBURIKI;1186681520;Taip;0;3;0;3
7809;Paslaptis;KALAMBURIKI;3415869190;Taip;10;3;0;13
7810;Paslaptis;KALAMBURIKI;1983773762;Taip;0;3;0;3
7811;Paslaptis;KALAMBURIKI;5557019619;Taip;0;3;0;3
7812;Paslaptis;KALAMBURIKI;3549998192;Taip;7;4;0;11
7813;Paslaptis;KALAMBURIKI;1782398974;Taip;0;4;0;4
7814;Paslaptis;KALAMBURIKI;8146824196;Taip;0;3;1;4
7815;Paslaptis;KALAMBURIKI;4109288950;Taip;0;3;0;3
7816;Paslaptis;KALAMBURIKI;3398729758;Taip;0;4;0;4
7817;Paslaptis;KALAMBURIKI;8083478190;Taip;0;3;6;9
7818;Paslaptis;KALAMBURIKI;2089780119;Taip;0;10;0;10
7819;Pasakaitė;Vieversėlių;7685647972;Taip;6;0;0;6
7820;Pasakaitė;Vieversėlių;6459145539;Taip;8;3;0;11
7821;Pasakaitė;Vieversėlių;2194313054;Taip;0;8;0;8
7822;Pasakaitė;Vieversėlių;9587489514;Taip;0;0;1;1
7823;Pasakaitė;Vieversėlių;3444442287;Taip;10;0;4;14
7824;Pasakaitė;Vieversėlių;5485965486;Taip;1;0;0;1
7825;Pasakaitė;Vieversėlių;2563725297;Taip;7;0;0;7
7826;Pasakaitė;Vieversėlių;2849753418;Taip;0;3;2;5
7827;Pasakaitė;Vieversėlių;7963057831;Taip;0;5;0;5
7828;Pasakaitė;Vieversėlių;9543991684;Taip;0;10;0;10
7829;Pasakaitė;Vieversėlių;3680596008;Taip;0;3;0;3
7830;Pasakaitė;Vieversėlių;4882856664;Taip;0;3;5;8
7831;Pasakaitė;Vieversėlių;5953162958;Ne;3;0;0;3
7832;Pasakaitė;Vieversėlių;5948958906;Taip;5;3;0;8
7833;Pasakaitė;Vieversėlių;1060914693;Taip;0;4;0;4
7834;Pasakaitė;Vieversėlių;7761162338;Ne;5;1;0;6
7835;Pasakaitė;Vieversėlių;8463220257;Taip;0;2;0;2
7836;Pasakaitė;Vieversėlių;9018830962;Taip;15;3;0;18
7837;Pasakaitė;Vieversėlių;6736879757;Taip;5;0;4;9
7838;Pasakaitė;Vieversėlių;4191875802;Taip;10;0;4;14
7839;Pasakaitė;Vieversėlių;5020801150;Taip;5;3;0;8
7840;Pasakaitė;Spindulėlių;1962693480;Taip;5;0;2;7
7841;Pasakaitė;Spindulėlių;4758073190;Taip;6;0;0;6
7842;Pasakaitė;Spindulėlių;6714500298;Taip;6;3;0;9
7843;Pasakaitė;Spindulėlių;1697755753;Taip;0;11;0;11
7844;Pasakaitė;Spindulėlių;1056358241;Taip;4;3;0;7
7845;Pasakaitė;Spindulėlių;8105641645;Taip;7;5;0;12
7846;Pasakaitė;Spindulėlių;5791927811;Taip;11;15;0;26
7847;Pasakaitė;Spindulėlių;5094404397;Taip;11;15;0;26
7848;Pasakaitė;Spindulėlių;9870015737;Ne;8;8;0;16
7849;Pasakaitė;Spindulėlių;1449037968;Taip;16;1;0;17
7850;Pasakaitė;Spindulėlių;7474100735;Taip;11;1;0;12
7851;Pasakaitė;Spindulėlių;6015360076;Taip;0;20;0;20
7852;Pasakaitė;Spindulėlių;2733800758;Taip;5;0;0;5
7853;Pasakaitė;Spindulėlių;6256000265;Taip;5;4;0;9
7854;Pasakaitė;Spindulėlių;2891089579;Taip;5;4;0;9
7855;Pasakaitė;Spindulėlių;3381303531;Taip;0;3;0;3
7856;Pasakaitė;Spindulėlių;3652896053;Taip;5;3;0;8
7857;Pasakaitė;Spindulėlių;7265623955;Taip;9;0;0;9
7858;Pasakaitė;Spindulėlių;1564611671;Taip;10;6;0;16
7859;Pasakaitė;Spindulėlių;3283593388;Taip;15;0;0;15
7860;Pasakaitė;Spindulėlių;2652882309;Ne;4;4;0;8
7861;Pasakaitė;Spindulėlių;4268438476;Taip;5;4;1;10
7862;Pasakaitė;Pasagėlių;2810892060;Taip;4;3;3;10
7863;Pasakaitė;Pasagėlių;9895144528;Taip;5;0;4;9
7864;Pasakaitė;Pasagėlių;6609127382;Taip;0;0;6;6
7865;Pasakaitė;Pasagėlių;9409907631;Taip;18;0;0;18
7866;Pasakaitė;Pasagėlių;5589440439;Taip;9;0;1;10
7867;Pasakaitė;Pasagėlių;3355268509;Taip;5;4;0;9
7868;Pasakaitė;Pasagėlių;1959599606;Taip;0;6;0;6
7869;Pasakaitė;Pasagėlių;7440327561;Taip;0;4;0;4
7870;Pasakaitė;Pasagėlių;6325408070;Taip;10;3;0;13
7871;Pasakaitė;Pasagėlių;9238905834;Taip;5;8;0;13
7872;Pasakaitė;Pasagėlių;5970146724;Taip;0;0;16;16
7873;Pasakaitė;Pasagėlių;4826492004;Taip;0;3;0;3
7874;Pasakaitė;Pasagėlių;7666033916;Taip;10;0;1;11
7875;Pasakaitė;Pasagėlių;5540251866;Taip;1;3;0;4
7876;Pasakaitė;Pasagėlių;7219080600;Ne;0;5;0;5
7877;Pasakaitė;Pasagėlių;8264189678;Taip;0;3;0;3
7878;Pasakaitė;Pasagėlių;2341175137;Taip;5;3;1;9
7879;Pasakaitė;Pasagėlių;8905681529;Taip;5;3;0;8
7880;Pasakaitė;Pasagėlių;8165055476;Taip;0;3;0;3
7881;Pasakaitė;Pasagėlių;7360801624;Taip;0;2;1;3
7882;Pasakaitė;Pasagėlių;5617173998;Taip;5;1;0;6
7883;Pasakaitė;Pasagėlių;5034077389;Taip;0;3;2;5
7884;Pasakaitė;Švyturėlių;7702359586;Taip;0;4;0;4
7885;Pasakaitė;Švyturėlių;2721048424;Taip;5;0;0;5
7886;Pasakaitė;Švyturėlių;6847782430;Taip;0;12;0;12
7887;Pasakaitė;Švyturėlių;1533259056;Taip;3;3;2;8
7888;Pasakaitė;Švyturėlių;4728731352;Taip;10;0;1;11
7889;Pasakaitė;Švyturėlių;2404448954;Taip;5;0;0;5
7890;Pasakaitė;Švyturėlių;9821617981;Taip;10;0;4;14
7891;Pasakaitė;Švyturėlių;1619513932;Taip;0;2;1;3
7892;Pasakaitė;Švyturėlių;1184513606;Taip;0;0;8;8
7893;Pasakaitė;Švyturėlių;2751828639;Taip;0;3;0;3
7894;Pasakaitė;Švyturėlių;4864779439;Taip;0;3;0;3
7895;Pasakaitė;Švyturėlių;8223662339;Taip;12;3;0;15
7896;Pasakaitė;Švyturėlių;3710143250;Taip;7;0;7;14
7897;Pasakaitė;Švyturėlių;2329827275;Taip;0;0;7;7
7898;Pasakaitė;Švyturėlių;2933474317;Taip;13;0;0;13
7899;Pasakaitė;Švyturėlių;5498393070;Taip;0;0;13;13
7900;Pasakaitė;Švyturėlių;9012098645;Taip;0;0;14;14
7901;Pasakaitė;Švyturėlių;4604843442;Taip;0;5;0;5
7902;Pasakaitė;Švyturėlių;3417077517;Taip;6;0;4;10
7903;Pasakaitė;Švyturėlių;1793453325;Taip;7;3;0;10
7904;Pasakaitė;Švyturėlių;1384552110;Taip;5;0;0;5
7905;Pasakaitė;Švyturėlių;4694818333;Taip;0;3;3;6
7906;Pasakaitė;Kodėlčiukų;8662488739;Taip;5;0;1;6
7907;Pasakaitė;Kodėlčiukų;9972985920;Taip;0;0;3;3
7908;Pasakaitė;Kodėlčiukų;5699688792;Taip;18;0;0;18
7909;Pasakaitė;Kodėlčiukų;9441990175;Taip;4;0;5;9
7910;Pasakaitė;Kodėlčiukų;1588525307;Taip;7;0;0;7
7911;Pasakaitė;Kodėlčiukų;4485053261;Taip;6;3;0;9
7912;Pasakaitė;Kodėlčiukų;9351971114;Taip;3;0;5;8
7913;Pasakaitė;Kodėlčiukų;2303884875;Taip;7;1;0;8
7914;Pasakaitė;Kodėlčiukų;9543262464;Taip;7;0;3;10
7915;Pasakaitė;Kodėlčiukų;4878562841;Taip;5;0;4;9
7916;Pasakaitė;Kodėlčiukų;2994653871;Taip;12;0;0;12
7917;Pasakaitė;Kodėlčiukų;4328440534;Taip;6;0;5;11
7918;Pasakaitė;Kodėlčiukų;4881361200;Taip;10;0;1;11
7919;Pasakaitė;Kodėlčiukų;2389832646;Taip;5;0;3;8
7920;Pasakaitė;Kodėlčiukų;7138417196;Taip;17;0;0;17
7921;Pasakaitė;Kodėlčiukų;5581264184;Taip;8;2;0;10
7922;Pasakaitė;Kodėlčiukų;8037316673;Taip;18;0;0;18
7923;Pasakaitė;Kodėlčiukų;5732009054;Taip;1;8;0;9
7924;Pasakaitė;Kodėlčiukų;2407824666;Taip;0;3;5;8
7925;Pasakaitė;Kodėlčiukų;6755983130;Taip;18;0;0;18
7926;Pasakaitė;Kodėlčiukų;2476010561;Taip;0;6;1;7
7927;Pasakaitė;Kodėlčiukų;3925034196;Taip;6;1;0;7
7928;Pasakaitė;Gudručių;6568538767;Ne;10;3;0;13
7929;Pasakaitė;Gudručių;1523034176;Taip;0;3;1;4
7930;Pasakaitė;Gudručių;5369558652;Taip;5;3;0;8
7931;Pasakaitė;Gudručių;1019010454;Taip;5;3;0;8
7932;Pasakaitė;Gudručių;4703375416;Taip;8;3;0;11
7933;Pasakaitė;Gudručių;1707428977;Taip;15;3;0;18
7934;Pasakaitė;Gudručių;9680682204;Taip;0;3;0;3
7935;Pasakaitė;Gudručių;3345955615;Taip;3;1;1;5
7936;Pasakaitė;Gudručių;1791015854;Taip;0;3;1;4
7937;Pasakaitė;Gudručių;39853246609;Taip;7;3;0;10
7938;Pasakaitė;Gudručių;67374677045;Taip;8;3;0;11
7939;Pasakaitė;Gudručių;4959175420;Taip;0;6;0;6
7940;Pasakaitė;Gudručių;6839399035;Taip;4;0;1;5
7941;Pasakaitė;Gudručių;3778906698;Taip;0;3;2;5
7942;Pasakaitė;Gudručių;1940545723;Taip;9;3;0;12
7943;Pasakaitė;Gudručių;9506178305;Taip;5;1;0;6
7944;Pasakaitė;Gudručių;1809383469;Taip;10;3;0;13
7945;Pasakaitė;Gudručių;1592521766;Taip;6;0;0;6
7946;Pasakaitė;Gudručių;4008826950;Taip;13;0;0;13
7947;Pasakaitė;Gudručių;9031690002;Taip;0;4;4;8
7948;Pasakaitė;Gudručių;2742595829;Taip;0;3;0;3
7949;Pasakaitė;Gudručių;1513903341;Taip;5;5;0;10
7950;Pasakaitė;Gudručių;8390366303;Taip;0;3;1;4
7951;Pasakaitė;Gudručių;3231283338;Taip;0;1;3;4
7952;Pasakaitė;Čiulbonėlių;4680949976;Taip;7;4;0;11
7953;Pasakaitė;Čiulbonėlių;7152349570;Taip;8;5;0;13
7954;Pasakaitė;Čiulbonėlių;1458338379;Taip;6;7;0;13
7955;Pasakaitė;Čiulbonėlių;7526264241;Taip;0;3;2;5
7956;Pasakaitė;Čiulbonėlių;3541877287;Taip;0;3;0;3
7957;Pasakaitė;Čiulbonėlių;4974486850;Ne;5;3;1;9
7958;Pasakaitė;Čiulbonėlių;7607522887;Taip;0;5;0;5
7959;Pasakaitė;Čiulbonėlių;3606601644;Taip;0;7;0;7
7960;Pasakaitė;Čiulbonėlių;5313360864;Taip;15;0;0;15
7961;Pasakaitė;Čiulbonėlių;3579498202;Taip;0;8;0;8
7962;Pasakaitė;Čiulbonėlių;1220619991;Taip;0;0;3;3
7963;Pasakaitė;Čiulbonėlių;7790937149;Taip;0;3;0;3
7964;Pasakaitė;Čiulbonėlių;3400305768;Taip;0;3;0;3
7965;Pasakaitė;Čiulbonėlių;3165658822;Taip;0;4;0;4
7966;Pasakaitė;Čiulbonėlių;83018133588;Taip;0;3;0;3
7967;Pasakaitė;Čiulbonėlių;4013900094;Taip;0;3;0;3
7968;Pasakaitė;Čiulbonėlių;5605619860;Taip;9;3;1;13
7969;Pasakaitė;Čiulbonėlių;61230317080;Ne;0;5;0;5
7970;Pasakaitė;Čiulbonėlių;8466086339;Taip;4;5;0;9
7971;Pasakaitė;Čiulbonėlių;5467179333;Taip;0;3;1;4
7972;Pasakaitė;Čiulbonėlių;1740419218;Taip;10;4;0;14
7973;Pasakaitė;Čiulbonėlių;8469043564;Taip;9;3;1;13
7974;Pasakaitė;"Verpstelių ";7621306769;Taip;0;6;0;6
7975;Pasakaitė;"Verpstelių ";4946855684;Taip;6;8;0;14
7976;Pasakaitė;"Verpstelių ";5556362727;Taip;5;0;4;9
7977;Pasakaitė;"Verpstelių ";7451624229;Ne;4;0;4;8
7978;Pasakaitė;"Verpstelių ";7759051761;Taip;5;5;0;10
7979;Pasakaitė;"Verpstelių ";8315840473;Taip;0;0;7;7
7980;Pasakaitė;"Verpstelių ";1744216870;Taip;0;11;0;11
7981;Pasakaitė;"Verpstelių ";1425166722;Taip;5;0;4;9
7982;Pasakaitė;"Verpstelių ";7813221735;Taip;5;8;1;14
7983;Pasakaitė;"Verpstelių ";9166649594;Taip;0;4;0;4
7984;Pasakaitė;"Verpstelių ";4246461594;Taip;18;0;8;26
7985;Pasakaitė;"Verpstelių ";1963102227;Taip;0;7;1;8
7986;Pasakaitė;"Verpstelių ";8267725352;Taip;8;0;3;11
7987;Pasakaitė;"Verpstelių ";5866092980;Taip;8;0;0;8
7988;Pasakaitė;"Verpstelių ";8562284745;Taip;0;7;0;7
7989;Pasakaitė;"Verpstelių ";1041405418;Taip;0;11;0;11
7990;Pasakaitė;"Verpstelių ";7976921380;Taip;5;4;0;9
7991;Pasakaitė;"Verpstelių ";2505815026;Taip;9;3;13;25
7992;Pasakaitė;"Verpstelių ";5413457806;Taip;0;6;0;6
7993;Pasakaitė;"Verpstelių ";1115383380;Taip;15;0;0;15
7994;Pasakaitė;"Verpstelių ";2714905466;Taip;5;0;6;11
7995;Pasakaitė;"Verpstelių ";9226989209;Taip;0;1;0;1
7996;Pasakaitė;"Verpstelių ";8927014508;Taip;8;0;1;9
7997;Pasakaitė;Smalsučiai;7539851375;Taip;3;0;1;4
7998;Pasakaitė;Smalsučiai;9114337491;Taip;6;0;1;7
7999;Pasakaitė;Smalsučiai;2278658674;Taip;15;0;0;15
8000;Pasakaitė;Smalsučiai;7557414266;Taip;0;3;0;3
8001;Pasakaitė;Smalsučiai;6522727154;Taip;11;3;0;14
8002;Pasakaitė;Smalsučiai;8711237946;Taip;14;0;0;14
8003;Pasakaitė;Smalsučiai;1122248122;Taip;13;0;0;13
8004;Pasakaitė;Smalsučiai;9982451343;Taip;7;5;0;12
8005;Pasakaitė;Smalsučiai;4977052991;Taip;6;0;5;11
8006;Pasakaitė;Smalsučiai;7604996145;Taip;15;3;0;18
8007;Pasakaitė;Smalsučiai;4144569088;Taip;4;0;0;4
8008;Pasakaitė;Smalsučiai;4307883488;Taip;0;10;0;10
8009;Pasakaitė;Smalsučiai;2546550685;Taip;8;0;0;8
8010;Pasakaitė;Smalsučiai;7994712153;Taip;0;0;8;8
8011;Pasakaitė;"Čiauškučiai ";7399335037;Taip;0;3;0;3
8012;Pasakaitė;"Čiauškučiai ";4098119950;Taip;8;3;0;11
8013;Pasakaitė;"Čiauškučiai ";9512782063;Taip;0;5;3;8
8014;Pasakaitė;"Čiauškučiai ";6229020982;Taip;4;3;0;7
8015;Pasakaitė;"Čiauškučiai ";5279719152;Taip;7;2;0;9
8016;Pasakaitė;"Čiauškučiai ";6160327808;Taip;3;0;3;6
8017;Pasakaitė;"Čiauškučiai ";1705913604;Taip;1;3;0;4
8018;Pasakaitė;"Čiauškučiai ";4898974534;Taip;10;0;0;10
8019;Pasakaitė;"Čiauškučiai ";3691817711;Taip;0;6;0;6
8020;Pasakaitė;"Čiauškučiai ";3659371923;Taip;10;0;2;12
8021;Pasakaitė;"Čiauškučiai ";7885958426;Taip;7;0;3;10
8022;Pasakaitė;"Čiauškučiai ";2902368705;Taip;6;10;0;16
8023;Pasakaitė;"Čiauškučiai ";2041179927;Taip;15;0;0;15
8024;Pasakaitė;"Čiauškučiai ";6745120294;Taip;5;4;0;9
8025;Pasakaitė;"Čiauškučiai ";4120765793;Taip;0;5;0;5
8026;Pasakaitė;Pabiručiai;5180059311;Taip;0;18;0;18
8027;Pasakaitė;Pabiručiai;5162170061;Taip;0;0;1;1
8028;Pasakaitė;Pabiručiai;8478538959;Taip;0;0;5;5
8029;Pasakaitė;Pabiručiai;5058070480;Taip;18;0;0;18
8030;Pasakaitė;Pabiručiai;1453976284;Taip;0;5;13;18
8031;Pasakaitė;Pabiručiai;8559244062;Taip;10;0;6;16
8032;Pasakaitė;Pabiručiai;9790988677;Taip;0;14;4;18
8033;Pasakaitė;Pabiručiai;5439936572;Taip;8;7;3;18
8034;Pasakaitė;Pabiručiai;4316883215;Taip;14;0;0;14
8035;Pasakaitė;Pabiručiai;6682010485;Taip;5;8;0;13
8036;Pasakaitė;Pabiručiai;3466308130;Taip;0;0;11;11
8037;Pasakaitė;Pabiručiai;9402238675;Taip;18;0;0;18
8038;Pasakaitė;Pabiručiai;9311649698;Taip;7;3;0;10
8039;Pasakaitė;Pabiručiai;5499373802;Taip;4;0;0;4
8040;Pasakaitė;Linksmučiai;7965916747;Taip;7;0;1;8
8041;Pasakaitė;Linksmučiai;1279728451;Taip;7;0;0;7
8042;Pasakaitė;Linksmučiai;2584717150;Taip;8;0;0;8
8043;Pasakaitė;Linksmučiai;4397797616;Taip;8;0;0;8
8044;Pasakaitė;Linksmučiai;4659277297;Taip;1;0;3;4
8045;Pasakaitė;Linksmučiai;8381083251;Taip;7;0;0;7
8046;Pasakaitė;Linksmučiai;8252123824;Taip;0;0;5;5
8047;Pasakaitė;Linksmučiai;4444725869;Taip;0;0;15;15
8048;Pasakaitė;Linksmučiai;2801785334;Taip;0;0;6;6
8049;Pasakaitė;Linksmučiai;4369400507;Taip;18;0;0;18
8050;Pasakaitė;Linksmučiai;9606533767;Taip;9;0;3;12
8051;Pasakaitė;Linksmučiai;8160163060;Taip;0;0;13;13
8052;Pasakaitė;Linksmučiai;8350808883;Taip;10;0;2;12
8053;Pasakaitė;Linksmučiai;5745073940;Taip;13;0;3;16
8054;Pelėda;ĄŽUOLIUKAI;2035408478;Taip;14;0;0;14
8055;Pelėda;BORUŽIUKŲ;2600073553;Taip;5;0;0;5
8056;Pelėda;SMALSUČIAI;9464415942;Taip;2;0;0;2
8057;Pelėda;SMALSUČIAI;7629444214;Taip;21;0;0;21
8058;Pelenė;Varpelis;2647876561;Taip;0;3;0;3
8059;Pelenė;Varpelis;8807342148;Taip;3;4;0;7
8060;Pelenė;Varpelis;5697826755;Taip;0;2;0;2
8061;Pelenė;Varpelis;8239650471;Taip;0;0;1;1
8062;Pelenė;Varpelis;4004975235;Taip;5;2;0;7
8063;Pelenė;Varpelis;8790613872;Taip;5;2;0;7
8064;Pelenė;Varpelis;2487632125;Taip;2;3;2;7
8065;Pelenė;Varpelis;5228983908;Taip;0;2;0;2
8066;Pelenė;Varpelis;3174009848;Taip;3;3;0;6
8067;Pelenė;Varpelis;6524101295;Taip;0;3;2;5
8068;Pelenė;Varpelis;4373886054;Taip;0;8;0;8
8069;Pelenė;Varpelis;8038559319;Taip;0;1;0;1
8070;Pelenė;Varpelis;7578318198;Taip;0;6;0;6
8071;Pelenė;Varpelis;7164790060;Taip;0;1;0;1
8072;Pelenė;Varpelis;4376033711;Taip;0;1;0;1
8073;Pelenė;Varpelis;1080017906;Taip;0;2;0;2
8074;Pelenė;Varpelis;4777496709;Taip;8;3;0;11
8075;Pelenė;Varpelis;9447223913;Taip;0;3;5;8
8076;Pelenė;Varpelis;6894978459;Taip;0;8;0;8
8077;Pelenė;Varpelis;4321705575;Taip;0;14;0;14
8078;Pelenė;Varpelis;6864263698;Taip;6;0;7;13
8079;Pelenė;Varpelis;4521556853;Taip;3;1;2;6
8080;Pelenė;Saulutės;7880284433;Taip;0;5;1;6
8081;Pelenė;Saulutės;1468658102;Taip;15;0;0;15
8082;Pelenė;Saulutės;2737277656;Taip;3;0;1;4
8083;Pelenė;Saulutės;1775717256;Taip;4;3;0;7
8084;Pelenė;Saulutės;4315677064;Taip;0;3;1;4
8085;Pelenė;Saulutės;7587887488;Taip;0;9;0;9
8086;Pelenė;Saulutės;5389865440;Taip;0;3;1;4
8087;Pelenė;Saulutės;8716395810;Taip;0;2;0;2
8088;Pelenė;Saulutės;6191899254;Taip;0;4;0;4
8089;Pelenė;Saulutės;6481466282;Taip;0;2;3;5
8090;Pelenė;Saulutės;6707167720;Taip;0;1;1;2
8091;Pelenė;Saulutės;8466974910;Taip;5;2;0;7
8092;Pelenė;Saulutės;2393964666;Taip;0;6;0;6
8093;Pelenė;Saulutės;5780697554;Taip;9;3;0;12
8094;Pelenė;Saulutės;4989239822;Taip;4;3;0;7
8095;Pelenė;Saulutės;1278011268;Taip;0;3;0;3
8096;Pelenė;Saulutės;2426412323;Taip;0;3;0;3
8097;Pelenė;Saulutės;6267178572;Taip;0;13;0;13
8098;Pelenė;Raktelis;9195113444;Taip;5;7;0;12
8099;Pelenė;Raktelis;9075193730;Taip;0;1;1;2
8100;Pelenė;Raktelis;4591637887;Taip;0;11;0;11
8101;Pelenė;Raktelis;7088493729;Taip;0;1;0;1
8102;Pelenė;Raktelis;4090532624;Ne;0;1;0;1
8103;Pelenė;Raktelis;8123162647;Taip;0;4;0;4
8104;Pelenė;Raktelis;3573543545;Taip;0;7;0;7
8105;Pelenė;Raktelis;7659625628;Taip;0;2;1;3
8106;Pelenė;Raktelis;6375060159;Taip;5;7;0;12
8107;Pelenė;Raktelis;2210314952;Taip;0;3;0;3
8108;Pelenė;Raktelis;6419661741;Taip;0;5;0;5
8109;Pelenė;Raktelis;4089199552;Taip;0;3;4;7
8110;Pelenė;Raktelis;6038229659;Taip;0;3;5;8
8111;Pelenė;Raktelis;1060619471;Taip;4;0;0;4
8112;Pelenė;Raktelis;5749399210;Taip;11;3;0;14
8113;Pelenė;Raktelis;5333802902;Taip;0;11;0;11
8114;Pelenė;Raktelis;8517226350;Taip;10;3;2;15
8115;Pelenė;Raktelis;1049199372;Taip;0;3;0;3
8116;Pelenė;Raktelis;2241816838;Taip;4;1;1;6
8117;Pelenė;Raktelis;5063098703;Taip;0;4;0;4
8118;Pelenė;Žvaigždutės;9473901831;Taip;0;3;2;5
8119;Pelenė;Žvaigždutės;2476080951;Taip;0;1;2;3
8120;Pelenė;Žvaigždutės;5587759166;Taip;4;3;0;7
8121;Pelenė;Žvaigždutės;5548367924;Taip;8;0;0;8
8122;Pelenė;Žvaigždutės;5031778158;Taip;0;7;0;7
8123;Pelenė;Žvaigždutės;6014571367;Ne;0;3;0;3
8124;Pelenė;Žvaigždutės;4602503400;Taip;0;3;0;3
8125;Pelenė;Žvaigždutės;2555464779;Taip;6;2;0;8
8126;Pelenė;Žvaigždutės;9530531472;Ne;0;1;0;1
8127;Pelenė;Žvaigždutės;2040256240;Taip;0;3;4;7
8128;Pelenė;Žvaigždutės;4870187198;Taip;0;3;0;3
8129;Pelenė;Žvaigždutės;7640768043;Taip;16;0;0;16
8130;Pelenė;Žvaigždutės;7614130590;Taip;5;0;0;5
8131;Pelenė;Žvaigždutės;4856039707;Taip;0;2;0;2
8132;Pelenė;Žvaigždutės;5894429453;Taip;0;3;5;8
8133;Pelenė;Žvaigždutės;4737217659;Taip;0;3;0;3
8134;Pelenė;Žvaigždutės;4109516555;Taip;0;16;0;16
8135;Pelenė;Nykštukas;4541391191;Taip;0;3;3;6
8136;Pelenė;Nykštukas;9584503078;Taip;0;3;4;7
8137;Pelenė;Nykštukas;8770771520;Taip;0;3;0;3
8138;Pelenė;Nykštukas;10457480694;Taip;0;1;1;2
8139;Pelenė;Nykštukas;7254981715;Taip;0;4;0;4
8140;Pelenė;Nykštukas;6579504852;Taip;0;8;0;8
8141;Pelenė;Nykštukas;6021833025;Taip;0;14;0;14
8142;Pelenė;Nykštukas;1978481168;Taip;0;3;0;3
8143;Pelenė;Nykštukas;3596386480;Taip;0;3;0;3
8144;Pelenė;Nykštukas;7205437280;Taip;0;3;0;3
8145;Pelenė;Nykštukas;3385568839;Taip;0;3;0;3
8146;Pelenė;Nykštukas;7589978427;Taip;9;5;0;14
8147;Pelenė;Nykštukas;3189305906;Taip;0;2;0;2
8148;Pelenė;Nykštukas;1750366978;Taip;0;2;5;7
8149;Pelenė;Nykštukas;2092775878;Taip;0;7;0;7
8150;Pelenė;Nykštukas;8675348688;Taip;0;3;1;4
8151;Pelenė;Nykštukas;1142014148;Ne;0;3;2;5
8152;Pelenė;Nykštukas;1605794833;Taip;0;4;0;4
8153;Pelenė;Nykštukas;9063588699;Taip;0;9;0;9
8154;Pelenė;Nykštukas;9621197758;Taip;0;5;0;5
8155;Pelenė;Nykštukas;3296147024;Taip;0;10;0;10
8156;Pelenė;Žirniukai;8529178313;Taip;0;3;0;3
8157;Pelenė;Žirniukai;6046921077;Taip;0;3;0;3
8158;Pelenė;Žirniukai;9601582419;Taip;3;3;0;6
8159;Pelenė;Žirniukai;7057752202;Taip;0;1;1;2
8160;Pelenė;Žirniukai;7399112026;Taip;0;3;1;4
8161;Pelenė;Žirniukai;2443906444;Taip;0;3;1;4
8162;Pelenė;Žirniukai;5922348478;Taip;6;3;0;9
8163;Pelenė;Žirniukai;1313425695;Taip;8;3;0;11
8164;Pelenė;Žirniukai;5211115955;Taip;5;3;0;8
8165;Pelenė;Žirniukai;1595627222;Taip;0;11;0;11
8166;Pelenė;Žirniukai;2438266396;Taip;0;6;0;6
8167;Pelenė;Žirniukai;2590035984;Taip;0;3;0;3
8168;Pelenė;Žirniukai;3863839750;Taip;0;3;2;5
8169;Pelenė;Žirniukai;5686182866;Ne;0;1;3;4
8170;Pelenė;Žirniukai;7383544475;Taip;0;17;0;17
8171;Pelenė;Žirniukai;6661371876;Taip;5;2;0;7
8172;Pelenė;Žirniukai;2270989478;Taip;0;17;0;17
8173;Pelenė;Žirniukai;8617997163;Taip;15;3;0;18
8174;Pelenė;Žirniukai;7959433937;Taip;3;0;2;5
8175;Pelenė;Žirniukai;4703442187;Ne;0;1;0;1
8176;Pelenė;Lašeliai;7017031073;Taip;4;0;0;4
8177;Pelenė;Lašeliai;9018211726;Taip;0;1;0;1
8178;Pelenė;Lašeliai;9313153383;Taip;0;7;0;7
8179;Pelenė;Lašeliai;5836118223;Taip;10;3;0;13
8180;Pelenė;Lašeliai;6316640679;Taip;0;3;3;6
8181;Pelenė;Lašeliai;1711603372;Taip;0;9;0;9
8182;Pelenė;Lašeliai;1944933777;Taip;0;9;0;9
8183;Pelenė;Lašeliai;2303618074;Taip;0;3;1;4
8184;Pelenė;Lašeliai;6167965418;Taip;5;1;0;6
8185;Pelenė;Lašeliai;2765650058;Taip;4;0;0;4
8186;Pelenė;Lašeliai;8841183816;Taip;0;3;0;3
8187;Pelenė;Lašeliai;4431474395;Taip;0;4;0;4
8188;Pelenė;Lašeliai;9097123374;Taip;0;4;0;4
8189;Pelenė;Lašeliai;9162252512;Ne;0;3;3;6
8190;Pelenė;Lašeliai;4695104609;Taip;0;10;0;10
8191;Pelenė;Lašeliai;7148956863;Taip;0;8;0;8
8192;Pelenė;Lašeliai;3663288138;Taip;0;3;0;3
8193;Pelenė;Lašeliai;4148108151;Taip;0;1;0;1
8194;Pelenė;Lašeliai;1303066945;Taip;3;5;0;8
8195;Pelenė;Lašeliai;3563882751;Taip;5;5;0;10
8196;Pelenė;Grūdelis;4624325473;Ne;0;8;0;8
8197;Pelenė;Grūdelis;1868951268;Taip;6;3;0;9
8198;Pelenė;Grūdelis;1902314385;Taip;0;3;0;3
8199;Pelenė;Grūdelis;1140030742;Taip;0;3;0;3
8200;Pelenė;Grūdelis;69721118552;Taip;0;1;0;1
8201;Pelenė;Grūdelis;1336431888;Taip;8;0;0;8
8202;Pelenė;Grūdelis;6632188229;Taip;0;2;0;2
8203;Pelenė;Grūdelis;39705461573;Ne;0;4;0;4
8204;Pelenė;Grūdelis;1781704945;Taip;5;2;0;7
8205;Pelenė;Grūdelis;2154553741;Taip;0;6;0;6
8206;Pelenė;Grūdelis;3497915398;Taip;0;6;0;6
8207;Pelenė;Grūdelis;8598498275;Taip;0;5;0;5
8208;Pelenė;Grūdelis;8404317146;Taip;0;3;0;3
8209;Pelenė;Grūdelis;4307283949;Taip;0;3;1;4
8210;Pelenė;Grūdelis;9009271610;Ne;5;7;0;12
8211;Pelenė;Grūdelis;1710249888;Taip;0;2;2;4
8212;Pelenė;Grūdelis;5325176433;Taip;0;6;0;6
8213;Pelenė;Grūdelis;1114786936;Taip;0;1;0;1
8214;Pelenė;Grūdelis;1245955282;Taip;0;5;0;5
8215;Pelenė;Grūdelis;6790396551;Ne;0;3;0;3
8216;Pelenė;Braškytė;7602432318;Taip;0;13;0;13
8217;Pelenė;Braškytė;2689903631;Taip;0;9;0;9
8218;Pelenė;Braškytė;4982869687;Taip;0;1;0;1
8219;Pelenė;Braškytė;3499827987;Taip;4;2;2;8
8220;Pelenė;Braškytė;8165766331;Taip;0;5;0;5
8221;Pelenė;Braškytė;1384382692;Taip;10;3;0;13
8222;Pelenė;Braškytė;5944620142;Taip;6;1;1;8
8223;Pelenė;Braškytė;4734502322;Taip;8;0;3;11
8224;Pelenė;Braškytė;8504675439;Taip;0;12;0;12
8225;Pelenė;Braškytė;2407328091;Taip;0;6;0;6
8226;Pelenė;Braškytė;8861981715;Taip;0;3;3;6
8227;Pelenė;Braškytė;6306403720;Taip;17;0;0;17
8228;Pelenė;Braškytė;9490816122;Taip;10;0;0;10
8229;Pelenė;Braškytė;2096373376;Taip;10;5;0;15
8230;Pelenė;Boružėlės;4961852594;Taip;0;3;1;4
8231;Pelenė;Boružėlės;1975574464;Taip;20;0;0;20
8232;Pelenė;Boružėlės;3549088727;Taip;18;0;0;18
8233;Pelenė;Boružėlės;5024793693;Taip;3;0;0;3
8234;Pelenė;Boružėlės;6567413229;Taip;18;0;0;18
8235;Pelenė;Boružėlės;6231387335;Taip;0;17;0;17
8236;Pelenė;Boružėlės;3700618977;Taip;1;0;3;4
8237;Pelenė;Boružėlės;5872711862;Taip;6;1;4;11
8238;Pelenė;Boružėlės;6081335781;Taip;0;3;0;3
8239;Pelenė;Boružėlės;3060502977;Taip;0;0;4;4
8240;Pelenė;Boružėlės;2083848693;Taip;12;0;1;13
8241;Pelenė;Boružėlės;1268615831;Taip;4;0;3;7
8242;Pelenė;Boružėlės;4396011355;Taip;14;0;0;14
8243;Pelenė;Boružėlės;6304818782;Taip;8;1;0;9
8244;Pelenė;Boružėlės;8718308575;Taip;0;18;0;18
8245;Pelenė;Boružėlės;5743530682;Taip;0;0;5;5
8246;Pelenė;Boružėlės;7341814322;Taip;0;0;3;3
8247;Pelenė;Saldainiukai;5028095861;Taip;3;0;2;5
8248;Pelenė;Saldainiukai;9505945890;Taip;0;3;1;4
8249;Pelenė;Saldainiukai;8202196292;Taip;0;0;1;1
8250;Pelenė;Saldainiukai;5066227318;Taip;0;1;0;1
8251;Pelenė;Saldainiukai;7926586349;Taip;3;1;0;4
8252;Pelenė;Saldainiukai;4305733824;Taip;6;3;0;9
8253;Pelenė;Saldainiukai;4051874126;Taip;0;7;0;7
8254;Pelenė;Saldainiukai;4660385383;Taip;4;0;2;6
8255;Pelenė;Saldainiukai;8862429244;Taip;5;1;3;9
8256;Pelenė;Saldainiukai;9969975097;Ne;0;3;1;4
8257;Pelenė;Saldainiukai;5762403752;Taip;0;6;0;6
8258;Pelenė;Saldainiukai;5926700157;Taip;2;0;0;2
8259;Pelenė;Saldainiukai;8961082265;Taip;0;3;0;3
8260;Pelenė;Saldainiukai;2882716674;Taip;0;3;2;5
8261;Pelenė;Saldainiukai;4859437855;Taip;0;2;1;3
8262;Pelenė;Saldainiukai;4023923887;Taip;0;3;0;3
8263;Pelenė;Drugeliai;2540405047;Taip;0;3;4;7
8264;Pelenė;Drugeliai;3603352172;Taip;0;1;1;2
8265;Pelenė;Drugeliai;5084452088;Ne;0;5;0;5
8266;Pelenė;Drugeliai;9218868317;Taip;0;3;0;3
8267;Pelenė;Drugeliai;2628676128;Taip;5;0;1;6
8268;Pelenė;Drugeliai;6834792589;Taip;1;0;0;1
8269;Pelenė;Drugeliai;9810123679;Taip;0;3;0;3
8270;Pelenė;Drugeliai;1048899958;Taip;0;3;0;3
8271;Pelenė;Drugeliai;3327213856;Taip;5;3;0;8
8272;Pelenė;Drugeliai;6252972353;Taip;0;1;3;4
8273;Pelenė;Drugeliai;1274729537;Taip;0;3;0;3
8274;Pelenė;Drugeliai;1584256570;Taip;0;3;1;4
8275;Pelenė;Drugeliai;3205331614;Taip;0;3;0;3
8276;Pelenė;Drugeliai;5631629419;Ne;7;6;0;13
8277;Pelenė;Drugeliai;2163737781;Taip;0;7;0;7
8278;Pelenė;Drugeliai;9004080625;Ne;12;3;0;15
8279;Pelenė;Drugeliai;7565331966;Taip;8;3;0;11
8280;Pelenė;Drugeliai;5074054534;Taip;0;3;0;3
8281;Pelenė;Drugeliai;8194354176;Ne;5;0;0;5
8282;Pelenė;Drugeliai;5579900958;Taip;7;3;0;10
8283;Pipiras;EŽIUKAI;1876870081;Taip;6;3;1;10
8284;Pipiras;EŽIUKAI;9275905384;Taip;5;13;0;18
8285;Pipiras;EŽIUKAI;41585818819;Taip;0;11;0;11
8286;Pipiras;EŽIUKAI;6153579332;Taip;12;3;0;15
8287;Pipiras;EŽIUKAI;1391958633;Taip;0;4;0;4
8288;Pipiras;EŽIUKAI;5637557921;Taip;0;1;0;1
8289;Pipiras;EŽIUKAI;7799786844;Taip;5;3;0;8
8290;Pipiras;EŽIUKAI;5014457985;Taip;0;5;0;5
8291;Pipiras;EŽIUKAI;1050430252;Ne;0;4;0;4
8292;Pipiras;EŽIUKAI;4927845000;Taip;0;2;0;2
8293;Pipiras;EŽIUKAI;1904376366;Taip;0;3;0;3
8294;Pipiras;EŽIUKAI;3008358842;Ne;8;3;0;11
8295;Pipiras;EŽIUKAI;2024777430;Taip;0;4;0;4
8296;Pipiras;EŽIUKAI;2402351134;Taip;8;3;0;11
8297;Pipiras;EŽIUKAI;2255644686;Taip;0;5;7;12
8298;Pipiras;EŽIUKAI;7736031786;Taip;8;4;0;12
8299;Pipiras;EŽIUKAI;4959823035;Taip;6;3;0;9
8300;Pipiras;EŽIUKAI;1128674099;Taip;0;5;3;8
8301;Pipiras;EŽIUKAI;6339186940;Taip;5;4;0;9
8302;Pipiras;EŽIUKAI;3422170541;Taip;1;8;0;9
8303;Pipiras;EŽIUKAI;3314276870;Taip;0;3;1;4
8304;Pipiras;EŽIUKAI;7784343130;Taip;0;3;0;3
8305;Pipiras;BITUTĖS;3851239592;Taip;5;4;1;10
8306;Pipiras;BITUTĖS;7891664385;Taip;0;11;0;11
8307;Pipiras;BITUTĖS;9050423801;Taip;0;13;0;13
8308;Pipiras;BITUTĖS;3794537946;Taip;8;0;0;8
8309;Pipiras;BITUTĖS;5047070127;Taip;13;0;0;13
8310;Pipiras;BITUTĖS;2645772675;Taip;4;5;0;9
8311;Pipiras;BITUTĖS;9394456452;Taip;15;0;0;15
8312;Pipiras;BITUTĖS;9610070604;Taip;0;5;0;5
8313;Pipiras;BITUTĖS;7009194986;Taip;9;0;0;9
8314;Pipiras;BITUTĖS;6362968454;Taip;11;4;0;15
8315;Pipiras;BITUTĖS;6273958740;Taip;5;2;0;7
8316;Pipiras;BITUTĖS;2887703782;Taip;8;2;0;10
8317;Pipiras;BITUTĖS;9950318827;Taip;0;3;0;3
8318;Pipiras;NYKŠTUKAI;6696824728;Taip;7;1;0;8
8319;Pipiras;NYKŠTUKAI;2016718354;Taip;0;3;0;3
8320;Pipiras;NYKŠTUKAI;1169481984;Taip;11;3;0;14
8321;Pipiras;NYKŠTUKAI;4198534687;Taip;0;7;0;7
8322;Pipiras;NYKŠTUKAI;4458730479;Taip;8;4;0;12
8323;Pipiras;NYKŠTUKAI;4510888337;Taip;9;3;0;12
8324;Pipiras;NYKŠTUKAI;3980950261;Taip;4;0;0;4
8325;Pipiras;NYKŠTUKAI;7828638329;Taip;0;4;0;4
8326;Pipiras;NYKŠTUKAI;6775489564;Taip;6;0;5;11
8327;Pipiras;NYKŠTUKAI;8689174023;Taip;4;5;0;9
8328;Pipiras;NYKŠTUKAI;7747049622;Taip;10;0;0;10
8329;Pipiras;NYKŠTUKAI;9892201598;Taip;8;5;0;13
8330;Pipiras;NYKŠTUKAI;7371386368;Taip;3;3;0;6
8331;Pipiras;NYKŠTUKAI;1019753152;Taip;0;5;0;5
8332;Pipiras;NYKŠTUKAI;9499869533;Taip;4;0;0;4
8333;Pipiras;NYKŠTUKAI;5141447649;Taip;0;2;0;2
8334;Pipiras;NYKŠTUKAI;9877682150;Taip;0;2;1;3
8335;Pipiras;NYKŠTUKAI;9248925267;Taip;0;5;0;5
8336;Pipiras;NYKŠTUKAI;9711147855;Taip;0;0;5;5
8337;Pipiras;PELĖDŽIUKAI;6342044341;Ne;4;3;0;7
8338;Pipiras;PELĖDŽIUKAI;3852848863;Taip;0;3;0;3
8339;Pipiras;PELĖDŽIUKAI;3882437376;Taip;5;1;0;6
8340;Pipiras;PELĖDŽIUKAI;9157870634;Taip;0;3;0;3
8341;Pipiras;PELĖDŽIUKAI;5235868332;Taip;3;4;0;7
8342;Pipiras;PELĖDŽIUKAI;3554786173;Taip;0;1;0;1
8343;Pipiras;PELĖDŽIUKAI;1034182352;Taip;0;8;0;8
8344;Pipiras;PELĖDŽIUKAI;2075041950;Taip;3;8;0;11
8345;Pipiras;PELĖDŽIUKAI;6792777396;Taip;0;4;0;4
8346;Pipiras;PELĖDŽIUKAI;6780333972;Taip;0;2;0;2
8347;Pipiras;PELĖDŽIUKAI;5622119207;Taip;0;4;0;4
8348;Pipiras;PELĖDŽIUKAI;7934365114;Taip;5;0;0;5
8349;Pipiras;PELĖDŽIUKAI;6523189501;Taip;5;13;0;18
8350;Pipiras;PELĖDŽIUKAI;7161727352;Taip;0;3;0;3
8351;Pipiras;PELĖDŽIUKAI;9770780973;Taip;11;1;0;12
8352;Pipiras;PELĖDŽIUKAI;5845498558;Taip;0;2;0;2
8353;Pipiras;PELĖDŽIUKAI;9840040112;Ne;16;0;0;16
8354;Pipiras;PELĖDŽIUKAI;1784839485;Taip;0;8;0;8
8355;Pipiras;PELĖDŽIUKAI;3775916247;Ne;0;4;0;4
8356;Pipiras;PELĖDŽIUKAI;7350131214;Taip;3;4;0;7
8357;Pipiras;DRUGELIAI;5908707752;Ne;0;3;1;4
8358;Pipiras;DRUGELIAI;1957338631;Taip;7;3;0;10
8359;Pipiras;DRUGELIAI;5856735452;Taip;5;3;0;8
8360;Pipiras;DRUGELIAI;2267192782;Taip;0;7;0;7
8361;Pipiras;DRUGELIAI;1045583136;Taip;5;1;0;6
8362;Pipiras;DRUGELIAI;1711168196;Taip;3;4;0;7
8363;Pipiras;DRUGELIAI;7425654504;Taip;1;11;0;12
8364;Pipiras;DRUGELIAI;9479697733;Taip;0;4;2;6
8365;Pipiras;DRUGELIAI;4017042461;Taip;0;9;0;9
8366;Pipiras;DRUGELIAI;4725221169;Taip;0;10;0;10
8367;Pipiras;DRUGELIAI;5059203266;Taip;6;2;0;8
8368;Pipiras;DRUGELIAI;8140314304;Taip;8;4;0;12
8369;Pipiras;DRUGELIAI;8422419380;Taip;3;3;0;6
8370;Pipiras;DRUGELIAI;6791495556;Taip;4;4;0;8
8371;Pipiras;DRUGELIAI;4811029230;Taip;3;2;3;8
8372;Pipiras;DRUGELIAI;6363349541;Taip;0;4;0;4
8373;Pipiras;DRUGELIAI;6685567970;Taip;0;5;1;6
8374;Pipiras;DRUGELIAI;1353114929;Taip;0;3;0;3
8375;Pipiras;DRUGELIAI;4426479971;Taip;0;3;0;3
8376;Pipiras;DRUGELIAI;7551948603;Ne;0;7;0;7
8377;Pipiras;GĖLYTĖS;9670710691;Taip;0;3;0;3
8378;Pipiras;GĖLYTĖS;8965139441;Taip;5;7;0;12
8379;Pipiras;GĖLYTĖS;2095794125;Taip;0;0;1;1
8380;Pipiras;GĖLYTĖS;8675473349;Taip;3;1;0;4
8381;Pipiras;GĖLYTĖS;4945164161;Taip;14;3;0;17
8382;Pipiras;GĖLYTĖS;7362002646;Taip;0;4;0;4
8383;Pipiras;GĖLYTĖS;5150723052;Taip;0;2;0;2
8384;Pipiras;GĖLYTĖS;3755824911;Taip;14;2;0;16
8385;Pipiras;GĖLYTĖS;6453274205;Taip;5;1;0;6
8386;Pipiras;GĖLYTĖS;4559954910;Taip;0;10;0;10
8387;Pipiras;GĖLYTĖS;7157187063;Taip;10;8;0;18
8388;Pipiras;GĖLYTĖS;4021613243;Taip;5;5;0;10
8389;Pipiras;GĖLYTĖS;1611488078;Taip;0;1;0;1
8390;Pipiras;GĖLYTĖS;4236597883;Taip;0;3;2;5
8391;Pipiras;GĖLYTĖS;4289497197;Taip;0;3;0;3
8392;Pipiras;GĖLYTĖS;2474548836;Taip;0;4;0;4
8393;Pipiras;GĖLYTĖS;8553422709;Taip;0;3;0;3
8394;Pipiras;GĖLYTĖS;5738334591;Taip;0;7;0;7
8395;Pipiras;GĖLYTĖS;6428525902;Taip;8;4;0;12
8396;Pipiras;GĖLYTĖS;8354158722;Taip;0;3;1;4
8397;Pipiras;BORUŽĖLĖS;4707794599;Taip;5;3;0;8
8398;Pipiras;BORUŽĖLĖS;8673271201;Taip;5;3;0;8
8399;Pipiras;BORUŽĖLĖS;5968015502;Taip;0;13;0;13
8400;Pipiras;BORUŽĖLĖS;4086728233;Taip;0;4;0;4
8401;Pipiras;BORUŽĖLĖS;8508292428;Taip;0;4;0;4
8402;Pipiras;BORUŽĖLĖS;1210940213;Taip;0;3;0;3
8403;Pipiras;BORUŽĖLĖS;8260680662;Taip;0;3;0;3
8404;Pipiras;BORUŽĖLĖS;1548928533;Taip;6;0;0;6
8405;Pipiras;BORUŽĖLĖS;9097987789;Taip;0;10;0;10
8406;Pipiras;BORUŽĖLĖS;8959946514;Taip;0;0;1;1
8407;Pipiras;BORUŽĖLĖS;9396979045;Taip;3;0;0;3
8408;Pipiras;BORUŽĖLĖS;8443786510;Taip;0;3;1;4
8409;Pipiras;BORUŽĖLĖS;1146369304;Taip;0;4;0;4
8410;Pipiras;BORUŽĖLĖS;9970587185;Taip;10;3;0;13
8411;Pipiras;BORUŽĖLĖS;6034298583;Taip;5;6;0;11
8412;Pipiras;BORUŽĖLĖS;6344932171;Taip;8;8;0;16
8413;Pipiras;BORUŽĖLĖS;1550959705;Taip;9;0;0;9
8414;Pipiras;SKRUZDĖLIUKAI;7969837759;Taip;0;10;0;10
8415;Pipiras;SKRUZDĖLIUKAI;2483867901;Taip;0;1;0;1
8416;Pipiras;SKRUZDĖLIUKAI;1315372873;Taip;0;7;0;7
8417;Pipiras;SKRUZDĖLIUKAI;9372109848;Taip;6;0;0;6
8418;Pipiras;SKRUZDĖLIUKAI;8296425777;Taip;2;3;0;5
8419;Pipiras;SKRUZDĖLIUKAI;9968182443;Ne;0;4;0;4
8420;Pipiras;SKRUZDĖLIUKAI;2296702730;Taip;0;0;6;6
8421;Pipiras;SKRUZDĖLIUKAI;8819018248;Taip;0;4;0;4
8422;Pipiras;SKRUZDĖLIUKAI;3768825314;Taip;0;0;12;12
8423;Pipiras;SKRUZDĖLIUKAI;5888429623;Taip;5;4;0;9
8424;Pipiras;SKRUZDĖLIUKAI;4309096743;Taip;5;0;5;10
8425;Pipiras;SKRUZDĖLIUKAI;2399588759;Taip;0;2;0;2
8426;Pipiras;SKRUZDĖLIUKAI;3935474148;Taip;2;0;0;2
8427;Pipiras;SKRUZDĖLIUKAI;8081343184;Taip;0;13;0;13
8428;Pipiras;SKRUZDĖLIUKAI;9852475056;Taip;15;0;0;15
8429;Pipiras;SKRUZDĖLIUKAI;6176818802;Taip;6;0;1;7
8430;Pipiras;SKRUZDĖLIUKAI;6570068615;Taip;0;2;0;2
8431;Pipiras;SKRUZDĖLIUKAI;1215623527;Taip;0;7;0;7
8432;Pipiras;SKRUZDĖLIUKAI;1998249512;Taip;0;3;0;3
8433;Pipiras;SKRUZDĖLIUKAI;9625933545;Taip;0;5;0;5
8434;Pipiras;SKRUZDĖLIUKAI;7211189491;Taip;5;0;0;5
8435;Pipiras;ŽVIRBLIUKŲ;6340323302;Taip;0;3;0;3
8436;Pipiras;ŽVIRBLIUKŲ;5445858240;Taip;10;3;0;13
8437;Pipiras;ŽVIRBLIUKŲ;1242260242;Taip;5;3;0;8
8438;Pipiras;ŽVIRBLIUKŲ;4266424785;Taip;0;3;0;3
8439;Pipiras;ŽVIRBLIUKŲ;3421769229;Taip;2;5;2;9
8440;Pipiras;ŽVIRBLIUKŲ;8520454289;Taip;0;5;0;5
8441;Pipiras;ŽVIRBLIUKŲ;5422547144;Taip;0;5;0;5
8442;Pipiras;ŽVIRBLIUKŲ;6136423200;Taip;0;7;0;7
8443;Pipiras;ŽVIRBLIUKŲ;1144813356;Taip;0;1;1;2
8444;Pipiras;ŽVIRBLIUKŲ;6694920607;Taip;0;11;0;11
8445;Pipiras;ŽVIRBLIUKŲ;7912217889;Taip;0;3;0;3
8446;Pipiras;ŽVIRBLIUKŲ;3141822820;Taip;0;7;0;7
8447;Pipiras;ŽVIRBLIUKŲ;7870521230;Taip;3;4;2;9
8448;Pipiras;ŽVIRBLIUKŲ;4428216634;Taip;0;3;0;3
8449;Pipiras;ŽVIRBLIUKŲ;5502001191;Taip;0;3;0;3
8450;Pipiras;ŽVIRBLIUKŲ;5778300856;Taip;0;3;0;3
8451;Pipiras;ŽVIRBLIUKŲ;3888552150;Taip;0;1;0;1
8452;Pipiras;ŽVIRBLIUKŲ;2240865490;Taip;0;4;0;4
8453;Pipiras;ŽVIRBLIUKŲ;2044498561;Taip;0;3;0;3
8454;Pipiras;ŽVIRBLIUKŲ;7026118693;Taip;0;7;2;9
8455;Pipiras;ŽVIRBLIUKŲ;1391682850;Taip;0;4;0;4
8456;Pipiras;ŽVIRBLIUKŲ;87924002679;Taip;7;4;0;11
8457;Pipiras;ŽVIRBLIUKŲ;4456861303;Taip;0;9;0;9
8458;Pipiras;ŽVIRBLIUKŲ;4496076326;Taip;0;2;0;2
8459;Pipiras;ZUIKUČIŲ;3641496225;Taip;15;0;0;15
8460;Pipiras;ZUIKUČIŲ;6925577945;Taip;8;0;0;8
8461;Pipiras;ZUIKUČIŲ;9639609431;Taip;5;4;0;9
8462;Pipiras;ZUIKUČIŲ;1682281017;Taip;5;7;0;12
8463;Pipiras;ZUIKUČIŲ;9665655075;Taip;5;7;0;12
8464;Pipiras;ZUIKUČIŲ;2159315426;Taip;8;4;0;12
8465;Pipiras;ZUIKUČIŲ;8404246568;Taip;0;5;0;5
8466;Pipiras;ZUIKUČIŲ;2599175140;Taip;11;6;0;17
8467;Pipiras;ZUIKUČIŲ;7200147039;Taip;16;2;0;18
8468;Pipiras;ZUIKUČIŲ;5035593032;Taip;10;3;0;13
8469;Pipiras;ZUIKUČIŲ;6361544649;Taip;4;0;0;4
8470;Pipiras;ZUIKUČIŲ;1079088070;Taip;4;0;0;4
8471;Pipiras;ZUIKUČIŲ;4743474665;Taip;8;5;0;13
8472;Pipiras;ZUIKUČIŲ;9422467047;Ne;10;0;0;10
8473;Pipiras;ZUIKUČIŲ;4991725638;Taip;5;0;1;6
8474;Pipiras;VARLIUKŲ;7446225835;Taip;5;2;1;8
8475;Pipiras;VARLIUKŲ;8800890503;Taip;3;4;0;7
8476;Pipiras;VARLIUKŲ;6184943213;Taip;5;3;0;8
8477;Pipiras;VARLIUKŲ;8028360748;Taip;3;3;0;6
8478;Pipiras;VARLIUKŲ;1238280105;Taip;5;6;1;12
8479;Pipiras;VARLIUKŲ;3299099535;Taip;5;2;0;7
8480;Pipiras;VARLIUKŲ;8364783015;Taip;5;5;8;18
8481;Pipiras;VARLIUKŲ;5502186385;Taip;5;2;0;7
8482;Pipiras;VARLIUKŲ;8707560610;Taip;8;0;0;8
8483;Pipiras;VARLIUKŲ;4940053409;Taip;13;0;0;13
8484;Pipiras;VARLIUKŲ;2588075386;Taip;10;0;0;10
8485;Pipiras;VARLIUKŲ;6666112357;Taip;11;0;0;11
8486;Pipiras;VARLIUKŲ;9473056714;Taip;0;18;0;18
8487;Pipiras;VARLIUKŲ;4282267631;Taip;8;0;0;8
8488;Pipiras;ŽIOGELIŲ;7510719254;Taip;10;0;0;10
8489;Pipiras;ŽIOGELIŲ;7802812858;Taip;0;3;2;5
8490;Pipiras;ŽIOGELIŲ;8697732892;Taip;6;0;8;14
8491;Pipiras;ŽIOGELIŲ;1466527534;Taip;0;1;0;1
8492;Pipiras;ŽIOGELIŲ;1172225661;Taip;0;3;0;3
8493;Pipiras;ŽIOGELIŲ;3825960148;Taip;11;0;0;11
8494;Pipiras;ŽIOGELIŲ;9747219629;Taip;10;0;7;17
8495;Pipiras;ŽIOGELIŲ;1074913909;Taip;0;0;17;17
8496;Pipiras;ŽIOGELIŲ;4229548366;Taip;8;0;2;10
8497;Pipiras;ŽIOGELIŲ;8666908143;Taip;0;3;5;8
8498;Pipiras;ŽIOGELIŲ;4083110785;Taip;0;0;3;3
8499;Pipiras;ŽIOGELIŲ;7011969610;Taip;3;3;0;6
8500;Pipiras;ŽIOGELIŲ;2784222529;Taip;0;0;6;6
8501;"Prie pasakų parko";ZUIKUČIAI;8493622886;Taip;3;0;1;4
8502;"Prie pasakų parko";ZUIKUČIAI;3998970024;Taip;0;3;0;3
8503;"Prie pasakų parko";ZUIKUČIAI;3907016976;Taip;10;0;4;14
8504;"Prie pasakų parko";ZUIKUČIAI;9770819792;Taip;9;0;0;9
8505;"Prie pasakų parko";ZUIKUČIAI;4904562817;Taip;8;0;0;8
8506;"Prie pasakų parko";ZUIKUČIAI;6662531456;Taip;8;0;0;8
8507;"Prie pasakų parko";ZUIKUČIAI;9659710840;Taip;3;1;0;4
8508;"Prie pasakų parko";ZUIKUČIAI;8781483295;Ne;3;0;3;6
8509;"Prie pasakų parko";ZUIKUČIAI;5394554484;Taip;0;2;0;2
8510;"Prie pasakų parko";ZUIKUČIAI;9707694441;Taip;5;3;0;8
8511;"Prie pasakų parko";ZUIKUČIAI;7220229641;Ne;11;0;0;11
8512;"Prie pasakų parko";ZUIKUČIAI;8616467675;Taip;2;0;4;6
8513;"Prie pasakų parko";ZUIKUČIAI;8215496569;Ne;3;0;0;3
8514;"Prie pasakų parko";ZUIKUČIAI;9742058853;Taip;0;0;1;1
8515;"Prie pasakų parko";PAUKŠČIUKŲ;4860316199;Ne;1;0;4;5
8516;"Prie pasakų parko";PAUKŠČIUKŲ;3907578461;Taip;12;0;2;14
8517;"Prie pasakų parko";PAUKŠČIUKŲ;7359935733;Taip;14;0;0;14
8518;"Prie pasakų parko";PAUKŠČIUKŲ;7330033315;Taip;8;0;1;9
8519;"Prie pasakų parko";PAUKŠČIUKŲ;9061639276;Taip;15;0;0;15
8520;"Prie pasakų parko";PAUKŠČIUKŲ;1476515947;Ne;5;3;0;8
8521;"Prie pasakų parko";PAUKŠČIUKŲ;6601363351;Ne;6;2;0;8
8522;"Prie pasakų parko";PAUKŠČIUKŲ;9784398441;Taip;14;0;1;15
8523;"Prie pasakų parko";PAUKŠČIUKŲ;4891232161;Taip;10;0;1;11
8524;"Prie pasakų parko";PAUKŠČIUKŲ;9550985822;Taip;6;2;1;9
8525;"Prie pasakų parko";PAUKŠČIUKŲ;5737517940;Taip;5;2;4;11
8526;"Prie pasakų parko";PAUKŠČIUKŲ;7693728136;Taip;11;0;0;11
8527;"Prie pasakų parko";PAUKŠČIUKŲ;2088585478;Taip;0;0;18;18
8528;"Prie pasakų parko";"LINKSMOJI ŠEIMYNĖLĖ (SPEC)";2820889357;Ne;10;4;0;14
8529;"Prie pasakų parko";"LINKSMOJI ŠEIMYNĖLĖ (SPEC)";29445903073;Taip;0;2;0;2
8530;"Prie pasakų parko";"LINKSMOJI ŠEIMYNĖLĖ (SPEC)";1549137154;Taip;7;3;0;10
8531;"Prie pasakų parko";"LINKSMOJI ŠEIMYNĖLĖ (SPEC)";6245610875;Taip;2;3;1;6
8532;"Prie pasakų parko";"LINKSMOJI ŠEIMYNĖLĖ (SPEC)";9469871636;Ne;8;3;1;12
8533;"Prie pasakų parko";"LINKSMOJI ŠEIMYNĖLĖ (SPEC)";5641148690;Taip;5;5;0;10
8534;"Prie pasakų parko";"LINKSMOJI ŠEIMYNĖLĖ (SPEC)";9594976173;Ne;5;3;0;8
8535;"Prie pasakų parko";"LINKSMOJI ŠEIMYNĖLĖ (SPEC)";1828638638;Taip;11;3;0;14
8536;"Prie pasakų parko";"LINKSMOJI ŠEIMYNĖLĖ (SPEC)";5356005675;Taip;0;3;2;5
8537;"Prie pasakų parko";"LINKSMOJI ŠEIMYNĖLĖ (SPEC)";9789977863;Taip;6;1;0;7
8538;"Prie pasakų parko";NYKŠTUKŲ;2287711014;Taip;15;0;0;15
8539;"Prie pasakų parko";NYKŠTUKŲ;6491435655;Taip;10;5;0;15
8540;"Prie pasakų parko";NYKŠTUKŲ;1743429440;Taip;12;5;0;17
8541;"Prie pasakų parko";NYKŠTUKŲ;1811994592;Taip;5;0;3;8
8542;"Prie pasakų parko";NYKŠTUKŲ;7739970115;Taip;13;0;1;14
8543;"Prie pasakų parko";NYKŠTUKŲ;6700916147;Taip;7;0;0;7
8544;"Prie pasakų parko";NYKŠTUKŲ;6733793491;Taip;13;0;0;13
8545;"Prie pasakų parko";NYKŠTUKŲ;4674683653;Taip;0;0;2;2
8546;"Prie pasakų parko";NYKŠTUKŲ;2515928623;Taip;7;2;2;11
8547;"Prie pasakų parko";NYKŠTUKŲ;4726737519;Taip;17;0;0;17
8548;"Prie pasakų parko";NYKŠTUKŲ;1316127369;Taip;3;0;3;6
8549;"Prie pasakų parko";NYKŠTUKŲ;2654978735;Taip;10;0;7;17
8550;"Prie pasakų parko";NYKŠTUKŲ;2661900328;Taip;0;0;1;1
8551;"Prie pasakų parko";NYKŠTUKŲ;9225775914;Taip;0;1;1;2
8552;"Prie pasakų parko";NYKŠTUKŲ;4457827262;Taip;8;0;0;8
8553;"Prie pasakų parko";LAŠELIŲ;6865751947;Taip;0;3;0;3
8554;"Prie pasakų parko";LAŠELIŲ;6992830082;Taip;9;0;0;9
8555;"Prie pasakų parko";LAŠELIŲ;1588062393;Taip;0;0;5;5
8556;"Prie pasakų parko";LAŠELIŲ;1278065349;Taip;9;0;0;9
8557;"Prie pasakų parko";LAŠELIŲ;8574432191;Taip;0;3;0;3
8558;"Prie pasakų parko";LAŠELIŲ;4181676762;Taip;0;3;0;3
8559;"Prie pasakų parko";LAŠELIŲ;4548803933;Taip;0;0;3;3
8560;"Prie pasakų parko";LAŠELIŲ;6250610187;Taip;0;3;0;3
8561;"Prie pasakų parko";LAŠELIŲ;3504938510;Taip;0;2;0;2
8562;"Prie pasakų parko";LAŠELIŲ;9190379838;Taip;7;2;4;13
8563;"Prie pasakų parko";LAŠELIŲ;8189217660;Taip;0;4;0;4
8564;"Prie pasakų parko";LAŠELIŲ;8215830508;Ne;6;5;0;11
8565;"Prie pasakų parko";LAŠELIŲ;2216634402;Taip;3;0;0;3
8566;"Prie pasakų parko";LAŠELIŲ;8849417734;Taip;3;1;0;4
8567;"Prie pasakų parko";LAŠELIŲ;7545372781;Ne;8;3;0;11
8568;"Prie pasakų parko";LAŠELIŲ;2731544174;Taip;9;0;0;9
8569;"Prie pasakų parko";LAŠELIŲ;6361878877;Taip;0;1;0;1
8570;"Prie pasakų parko";LAŠELIŲ;5494350183;Taip;0;10;2;12
8571;"Prie pasakų parko";LAŠELIŲ;5102718403;Taip;0;0;8;8
8572;"Prie pasakų parko";"KAČIUKAI (SPEC)";6772736175;Taip;5;0;1;6
8573;"Prie pasakų parko";"KAČIUKAI (SPEC)";5847625697;Taip;0;0;9;9
8574;"Prie pasakų parko";"KAČIUKAI (SPEC)";2590693851;Taip;0;0;1;1
8575;"Prie pasakų parko";"KAČIUKAI (SPEC)";3949671257;Taip;0;0;3;3
8576;"Prie pasakų parko";"ŽVAIGŽDUTĖS  (SPEC)";7216751216;Taip;0;0;1;1
8577;"Prie pasakų parko";"ŽVAIGŽDUTĖS  (SPEC)";4037594669;Taip;11;0;0;11
8578;"Prie pasakų parko";"ŽVAIGŽDUTĖS  (SPEC)";9072312203;Taip;0;3;0;3
8579;"Prie pasakų parko";"ŽVAIGŽDUTĖS  (SPEC)";5006152810;Taip;15;0;0;15
8580;"Prie pasakų parko";"ŽVAIGŽDUTĖS  (SPEC)";6989235061;Taip;0;0;7;7
8581;"Prie pasakų parko";"ŽVAIGŽDUTĖS  (SPEC)";5009168398;Ne;0;2;1;3
8582;"Prie pasakų parko";"ŽVAIGŽDUTĖS  (SPEC)";6585504578;Taip;18;0;0;18
8583;"Prie pasakų parko";"ŽVAIGŽDUTĖS  (SPEC)";1621710265;Ne;5;0;2;7
8584;"Prie pasakų parko";"ANČIUKAI (SPEC)";8339335908;Taip;0;0;7;7
8585;"Prie pasakų parko";"ANČIUKAI (SPEC)";6802898184;Taip;0;0;1;1
8586;"Prie pasakų parko";"ANČIUKAI (SPEC)";9529949992;Taip;13;0;4;17
8587;"Prie pasakų parko";"ANČIUKAI (SPEC)";6431918357;Taip;15;3;0;18
8588;"Prie pasakų parko";"ANČIUKAI (SPEC)";1190509858;Taip;15;3;0;18
8589;"Prie pasakų parko";"ANČIUKAI (SPEC)";4309482351;Taip;6;2;0;8
8590;"Prie pasakų parko";"ANČIUKAI (SPEC)";2263419475;Taip;0;3;3;6
8591;"Prie pasakų parko";"ANČIUKAI (SPEC)";7200571639;Taip;14;0;3;17
8592;"Prie pasakų parko";TIGRIUKAI;7858530013;Taip;0;8;0;8
8593;"Prie pasakų parko";TIGRIUKAI;3918269702;Taip;15;3;0;18
8594;"Prie pasakų parko";TIGRIUKAI;6446562388;Taip;0;4;0;4
8595;"Prie pasakų parko";TIGRIUKAI;2168919559;Taip;0;3;0;3
8596;"Prie pasakų parko";TIGRIUKAI;8899375521;Ne;0;3;1;4
8597;"Prie pasakų parko";TIGRIUKAI;6561145380;Taip;0;0;1;1
8598;"Prie pasakų parko";TIGRIUKAI;9476448601;Taip;0;0;3;3
8599;"Prie pasakų parko";TIGRIUKAI;8029428034;Taip;7;2;0;9
8600;"Prie pasakų parko";TIGRIUKAI;8715851643;Taip;0;3;2;5
8601;"Prie pasakų parko";TIGRIUKAI;3617673265;Taip;0;0;5;5
8602;"Prie pasakų parko";TIGRIUKAI;1704679306;Taip;0;3;0;3
8603;"Prie pasakų parko";TIGRIUKAI;7776961789;Taip;0;2;0;2
8604;"Prie pasakų parko";TIGRIUKAI;8285260113;Taip;0;4;0;4
8605;"Prie pasakų parko";TIGRIUKAI;3373275644;Taip;0;7;0;7
8606;"Prie pasakų parko";TIGRIUKAI;5518041213;Taip;0;0;1;1
8607;"Prie pasakų parko";TIGRIUKAI;8406002339;Taip;0;3;1;4
8608;"Prie pasakų parko";"EŽIUKŲ (SPEC)";7851357992;Ne;18;0;0;18
8609;"Prie pasakų parko";"EŽIUKŲ (SPEC)";7115825217;Taip;10;0;4;14
8610;"Prie pasakų parko";"EŽIUKŲ (SPEC)";2952868428;Taip;11;0;4;15
8611;"Prie pasakų parko";"EŽIUKŲ (SPEC)";5159105661;Taip;0;0;2;2
8612;"Prie pasakų parko";"EŽIUKŲ (SPEC)";9632354317;Taip;0;0;2;2
8613;"Prie pasakų parko";"EŽIUKŲ (SPEC)";5944113879;Ne;15;0;0;15
8614;"Prie pasakų parko";"EŽIUKŲ (SPEC)";4950143153;Ne;7;0;3;10
8615;"Prie pasakų parko";"EŽIUKŲ (SPEC)";4799789212;Taip;0;0;1;1
8616;"Prie pasakų parko";"BORUŽIUKŲ (SPEC)";9715586563;Ne;10;2;3;15
8617;"Prie pasakų parko";"BORUŽIUKŲ (SPEC)";28574450739;Taip;3;1;0;4
8618;"Prie pasakų parko";"BORUŽIUKŲ (SPEC)";6215345468;Ne;0;3;0;3
8619;"Prie pasakų parko";"BORUŽIUKŲ (SPEC)";7000191099;Taip;10;2;0;12
8620;"Prie pasakų parko";SAULYTĖS;6762267582;Taip;9;0;5;14
8621;"Prie pasakų parko";SAULYTĖS;7459673719;Taip;1;3;6;10
8622;"Prie pasakų parko";SAULYTĖS;4351705573;Taip;9;0;0;9
8623;"Prie pasakų parko";SAULYTĖS;7390391804;Taip;0;0;1;1
8624;"Prie pasakų parko";SAULYTĖS;8685140364;Taip;10;6;0;16
8625;"Prie pasakų parko";SAULYTĖS;6606867989;Taip;4;0;0;4
8626;"Prie pasakų parko";SAULYTĖS;2206221105;Taip;12;0;2;14
8627;"Prie pasakų parko";SAULYTĖS;2201317313;Taip;9;0;1;10
8628;"Prie pasakų parko";SAULYTĖS;3038164555;Taip;11;0;0;11
8629;"Prie pasakų parko";SAULYTĖS;4183640714;Taip;0;0;10;10
8630;"Prie pasakų parko";SAULYTĖS;1738732866;Taip;0;7;0;7
8631;"Pumpurėlis (Kalvarijų g. 186)";RAMUNĖLIŲ;7610949816;Taip;0;2;0;2
8632;"Pumpurėlis (Kalvarijų g. 186)";RAMUNĖLIŲ;6165833101;Taip;0;0;4;4
8633;"Pumpurėlis (Kalvarijų g. 186)";RAMUNĖLIŲ;6977710645;Taip;0;0;5;5
8634;"Pumpurėlis (Kalvarijų g. 186)";RAMUNĖLIŲ;9431295796;Taip;0;0;12;12
8635;"Pumpurėlis (Kalvarijų g. 186)";RAMUNĖLIŲ;1395380236;Taip;0;0;9;9
8636;"Pumpurėlis (Kalvarijų g. 186)";RAMUNĖLIŲ;9424449290;Taip;0;9;0;9
8637;"Pumpurėlis (Kalvarijų g. 186)";RAMUNĖLIŲ;6955168163;Taip;0;3;1;4
8638;"Pumpurėlis (Kalvarijų g. 186)";RAMUNĖLIŲ;5171198109;Taip;0;3;1;4
8639;"Pumpurėlis (Kalvarijų g. 186)";RAMUNĖLIŲ;9726028397;Taip;0;0;2;2
8640;"Pumpurėlis (Kalvarijų g. 186)";RAMUNĖLIŲ;7229289985;Taip;0;0;3;3
8641;"Pumpurėlis (Kalvarijų g. 186)";RAMUNĖLIŲ;2969734731;Taip;2;0;1;3
8642;"Pumpurėlis (Kalvarijų g. 186)";RAMUNĖLIŲ;7559071945;Taip;0;5;0;5
8643;"Pumpurėlis (Kalvarijų g. 186)";RAMUNĖLIŲ;6574415196;Taip;0;1;0;1
8644;"Pumpurėlis (Kalvarijų g. 186)";RAMUNĖLIŲ;3953103488;Taip;0;0;7;7
8645;"Pumpurėlis (Kalvarijų g. 186)";RAMUNĖLIŲ;6511527480;Taip;4;5;4;13
8646;"Pumpurėlis (Kalvarijų g. 186)";RAMUNĖLIŲ;3838705973;Taip;18;0;0;18
8647;"Pumpurėlis (Kalvarijų g. 186)";RAMUNĖLIŲ;6726875853;Taip;0;4;0;4
8648;"Pumpurėlis (Kalvarijų g. 186)";RAMUNĖLIŲ;8667762689;Taip;5;4;0;9
8649;"Pumpurėlis (Kalvarijų g. 186)";RAMUNĖLIŲ;3874188848;Taip;0;0;16;16
8650;"Pumpurėlis (Kalvarijų g. 186)";RAMUNĖLIŲ;7619709360;Ne;0;0;3;3
8651;"Pumpurėlis (Kalvarijų g. 186)";VARPELIŲ;3101133244;Taip;12;0;0;12
8652;"Pumpurėlis (Kalvarijų g. 186)";VARPELIŲ;3893768713;Taip;0;5;0;5
8653;"Pumpurėlis (Kalvarijų g. 186)";VARPELIŲ;5023658988;Taip;0;3;0;3
8654;"Pumpurėlis (Kalvarijų g. 186)";VARPELIŲ;2668855786;Taip;3;3;0;6
8655;"Pumpurėlis (Kalvarijų g. 186)";VARPELIŲ;8258560345;Taip;5;3;0;8
8656;"Pumpurėlis (Kalvarijų g. 186)";VARPELIŲ;9612924972;Taip;0;5;1;6
8657;"Pumpurėlis (Kalvarijų g. 186)";VARPELIŲ;9884099545;Taip;5;4;2;11
8658;"Pumpurėlis (Kalvarijų g. 186)";VARPELIŲ;3733509497;Taip;0;0;4;4
8659;"Pumpurėlis (Kalvarijų g. 186)";VARPELIŲ;4508966729;Taip;0;0;2;2
8660;"Pumpurėlis (Kalvarijų g. 186)";VARPELIŲ;9552913910;Taip;0;3;1;4
8661;"Pumpurėlis (Kalvarijų g. 186)";VARPELIŲ;5196733185;Taip;2;3;0;5
8662;"Pumpurėlis (Kalvarijų g. 186)";VARPELIŲ;4928495108;Taip;0;3;1;4
8663;"Pumpurėlis (Kalvarijų g. 186)";VARPELIŲ;8886730333;Taip;3;5;0;8
8664;"Pumpurėlis (Kalvarijų g. 186)";VARPELIŲ;2247300456;Taip;3;3;0;6
8665;"Pumpurėlis (Kalvarijų g. 186)";VARPELIŲ;5564680653;Taip;0;0;8;8
8666;"Pumpurėlis (Kalvarijų g. 186)";VARPELIŲ;1411232443;Taip;0;0;3;3
8667;"Pumpurėlis (Kalvarijų g. 186)";VARPELIŲ;8525537588;Ne;0;0;2;2
8668;"Pumpurėlis (Kalvarijų g. 186)";VARPELIŲ;2103139845;Taip;11;0;1;12
8669;"Pumpurėlis (Kalvarijų g. 186)";VARPELIŲ;6780042929;Taip;5;8;0;13
8670;"Pumpurėlis (Kalvarijų g. 186)";VARPELIŲ;7182107790;Taip;9;0;0;9
8671;"Pumpurėlis (Kalvarijų g. 186)";VARPELIŲ;4629544683;Taip;0;4;0;4
8672;"Pumpurėlis (Kalvarijų g. 186)";VARPELIŲ;9224879966;Taip;0;0;5;5
8673;"Pumpurėlis (Kalvarijų g. 186)";DRUGELIŲ;5928552565;Taip;9;0;0;9
8674;"Pumpurėlis (Kalvarijų g. 186)";DRUGELIŲ;5897036076;Taip;5;3;0;8
8675;"Pumpurėlis (Kalvarijų g. 186)";DRUGELIŲ;7055989095;Taip;0;16;0;16
8676;"Pumpurėlis (Kalvarijų g. 186)";DRUGELIŲ;7078621340;Taip;6;0;0;6
8677;"Pumpurėlis (Kalvarijų g. 186)";DRUGELIŲ;1538548768;Taip;0;0;5;5
8678;"Pumpurėlis (Kalvarijų g. 186)";DRUGELIŲ;2368226822;Taip;10;3;0;13
8679;"Pumpurėlis (Kalvarijų g. 186)";DRUGELIŲ;3088476130;Taip;0;0;1;1
8680;"Pumpurėlis (Kalvarijų g. 186)";DRUGELIŲ;9640790401;Taip;4;3;1;8
8681;"Pumpurėlis (Kalvarijų g. 186)";DRUGELIŲ;8320987208;Taip;0;0;5;5
8682;"Pumpurėlis (Kalvarijų g. 186)";DRUGELIŲ;7832408524;Taip;5;3;0;8
8683;"Pumpurėlis (Kalvarijų g. 186)";DRUGELIŲ;8644853849;Taip;9;8;0;17
8684;"Pumpurėlis (Kalvarijų g. 186)";DRUGELIŲ;9417688597;Taip;0;3;2;5
8685;"Pumpurėlis (Kalvarijų g. 186)";DRUGELIŲ;9032255874;Taip;11;3;1;15
8686;"Pumpurėlis (Kalvarijų g. 186)";DRUGELIŲ;9996789041;Taip;0;0;4;4
8687;"Pumpurėlis (Kalvarijų g. 186)";DRUGELIŲ;2684592319;Taip;6;0;1;7
8688;"Pumpurėlis (Kalvarijų g. 186)";DRUGELIŲ;5835115428;Taip;7;3;0;10
8689;"Pumpurėlis (Kalvarijų g. 186)";DRUGELIŲ;2132563531;Taip;0;3;2;5
8690;"Pumpurėlis (Kalvarijų g. 186)";DRUGELIŲ;4506063812;Taip;0;3;4;7
8691;"Pumpurėlis (Kalvarijų g. 186)";DRUGELIŲ;2165141865;Taip;0;0;8;8
8692;"Pumpurėlis (Kalvarijų g. 186)";DRUGELIŲ;8671697745;Taip;0;0;4;4
8693;"Pumpurėlis (Kalvarijų g. 186)";KODĖLČIUKŲ;8214602054;Taip;0;0;8;8
8694;"Pumpurėlis (Kalvarijų g. 186)";KODĖLČIUKŲ;2789026451;Taip;14;0;1;15
8695;"Pumpurėlis (Kalvarijų g. 186)";KODĖLČIUKŲ;9654958302;Taip;0;2;1;3
8696;"Pumpurėlis (Kalvarijų g. 186)";KODĖLČIUKŲ;5564844211;Taip;1;0;6;7
8697;"Pumpurėlis (Kalvarijų g. 186)";KODĖLČIUKŲ;1215117598;Taip;0;8;0;8
8698;"Pumpurėlis (Kalvarijų g. 186)";KODĖLČIUKŲ;6978091765;Taip;11;0;1;12
8699;"Pumpurėlis (Kalvarijų g. 186)";KODĖLČIUKŲ;6433757421;Taip;6;0;3;9
8700;"Pumpurėlis (Kalvarijų g. 186)";KODĖLČIUKŲ;3328647987;Taip;0;4;2;6
8701;"Pumpurėlis (Kalvarijų g. 186)";KODĖLČIUKŲ;3748601124;Taip;3;0;1;4
8702;"Pumpurėlis (Kalvarijų g. 186)";KODĖLČIUKŲ;6004234378;Taip;0;4;1;5
8703;"Pumpurėlis (Kalvarijų g. 186)";KODĖLČIUKŲ;4196409137;Ne;9;3;3;15
8704;"Pumpurėlis (Kalvarijų g. 186)";KODĖLČIUKŲ;6117720533;Taip;8;3;1;12
8705;"Pumpurėlis (Kalvarijų g. 186)";KODĖLČIUKŲ;8070486897;Taip;5;5;3;13
8706;"Pumpurėlis (Kalvarijų g. 186)";KODĖLČIUKŲ;3534133061;Taip;0;0;3;3
8707;"Pumpurėlis (Kalvarijų g. 186)";KODĖLČIUKŲ;2611141763;Taip;0;0;1;1
8708;"Pumpurėlis (Kalvarijų g. 186)";KODĖLČIUKŲ;2307819108;Taip;1;5;0;6
8709;"Pumpurėlis (Kalvarijų g. 186)";KODĖLČIUKŲ;9650395309;Taip;0;4;0;4
8710;"Pumpurėlis (Kalvarijų g. 186)";KODĖLČIUKŲ;3563609848;Taip;6;0;3;9
8711;"Pumpurėlis (Kalvarijų g. 186)";KODĖLČIUKŲ;6702744879;Taip;0;0;1;1
8712;"Pumpurėlis (Kalvarijų g. 186)";KODĖLČIUKŲ;2890596967;Taip;6;0;3;9
8713;"Pumpurėlis (Kalvarijų g. 186)";KODĖLČIUKŲ;9839285886;Taip;0;0;9;9
8714;"Pumpurėlis (Kalvarijų g. 186)";LINELIS;1017483419;Taip;3;1;0;4
8715;"Pumpurėlis (Kalvarijų g. 186)";LINELIS;6957047759;Taip;3;1;0;4
8716;"Pumpurėlis (Kalvarijų g. 186)";LINELIS;2468796972;Taip;0;6;0;6
8717;"Pumpurėlis (Kalvarijų g. 186)";LINELIS;1492810528;Taip;10;4;0;14
8718;"Pumpurėlis (Kalvarijų g. 186)";LINELIS;9138883172;Taip;0;5;0;5
8719;"Pumpurėlis (Kalvarijų g. 186)";LINELIS;1835168438;Taip;2;6;0;8
8720;"Pumpurėlis (Kalvarijų g. 186)";LINELIS;4344595328;Taip;0;7;0;7
8721;"Pumpurėlis (Kalvarijų g. 186)";LINELIS;1188314397;Taip;0;4;0;4
8722;"Pumpurėlis (Kalvarijų g. 186)";LINELIS;7566451857;Ne;7;3;0;10
8723;"Pumpurėlis (Kalvarijų g. 186)";LINELIS;9583257172;Taip;14;3;0;17
8724;"Pumpurėlis (Kalvarijų g. 186)";LINELIS;13952236905;Taip;0;4;0;4
8725;"Pumpurėlis (Kalvarijų g. 186)";LINELIS;7533555059;Taip;3;6;0;9
8726;"Pumpurėlis (Kalvarijų g. 186)";LINELIS;5615260965;Taip;5;3;0;8
8727;"Pumpurėlis (Kalvarijų g. 186)";LINELIS;6669327226;Taip;5;3;0;8
8728;"Pumpurėlis (Kalvarijų g. 186)";LINELIS;3298821054;Taip;0;3;2;5
8729;"Pumpurėlis (Kalvarijų g. 186)";LINELIS;8830261792;Taip;5;3;0;8
8730;"Pumpurėlis (Kalvarijų g. 186)";LINELIS;87061817106;Taip;0;2;0;2
8731;"Pumpurėlis (Kalvarijų g. 186)";LINELIS;8806961007;Taip;10;3;0;13
8732;"Pumpurėlis (Kalvarijų g. 186)";LINELIS;18928851032;Taip;0;3;0;3
8733;"Pumpurėlis (Kalvarijų g. 186)";LINELIS;8747439652;Taip;0;3;2;5
8734;"Pumpurėlis (Kalvarijų g. 186)";LINELIS;2629702959;Taip;6;3;0;9
8735;"Pumpurėlis (Kalvarijų g. 186)";LINELIS;5964953923;Taip;0;3;1;4
8736;"Pumpurėlis (Kalvarijų g. 186)";SAULUTĖS;3751769136;Taip;0;3;0;3
8737;"Pumpurėlis (Kalvarijų g. 186)";SAULUTĖS;5013491568;Taip;0;3;1;4
8738;"Pumpurėlis (Kalvarijų g. 186)";SAULUTĖS;7488342792;Taip;0;3;1;4
8739;"Pumpurėlis (Kalvarijų g. 186)";SAULUTĖS;6412442729;Taip;6;3;4;13
8740;"Pumpurėlis (Kalvarijų g. 186)";SAULUTĖS;2129779614;Taip;0;3;5;8
8741;"Pumpurėlis (Kalvarijų g. 186)";SAULUTĖS;1053338730;Taip;5;3;0;8
8742;"Pumpurėlis (Kalvarijų g. 186)";SAULUTĖS;7123915287;Taip;0;3;3;6
8743;"Pumpurėlis (Kalvarijų g. 186)";SAULUTĖS;83388662869;Taip;0;3;0;3
8744;"Pumpurėlis (Kalvarijų g. 186)";SAULUTĖS;1690424790;Taip;0;4;2;6
8745;"Pumpurėlis (Kalvarijų g. 186)";SAULUTĖS;1397924008;Taip;0;3;2;5
8746;"Pumpurėlis (Kalvarijų g. 186)";SAULUTĖS;6230500803;Taip;0;3;2;5
8747;"Pumpurėlis (Kalvarijų g. 186)";SAULUTĖS;1306102772;Taip;0;3;1;4
8748;"Pumpurėlis (Kalvarijų g. 186)";SAULUTĖS;1230058211;Ne;0;3;0;3
8749;"Pumpurėlis (Kalvarijų g. 186)";SAULUTĖS;25029630023;Taip;0;3;0;3
8750;"Pumpurėlis (Kalvarijų g. 186)";SAULUTĖS;6535398274;Ne;2;3;1;6
8751;"Pumpurėlis (Kalvarijų g. 186)";SAULUTĖS;8262886949;Taip;0;5;0;5
8752;"Pumpurėlis (Kalvarijų g. 186)";SAULUTĖS;1261919194;Taip;0;3;1;4
8753;"Pumpurėlis (Kalvarijų g. 186)";SAULUTĖS;9733380187;Taip;0;3;0;3
8754;"Pumpurėlis (Kalvarijų g. 186)";SAULUTĖS;2102427499;Taip;0;3;0;3
8755;"Pumpurėlis (Kalvarijų g. 186)";SAULUTĖS;1225377038;Taip;0;3;0;3
8756;"Pumpurėlis (Kalvarijų g. 186)";SAULUTĖS;9317495169;Taip;0;4;0;4
8757;"Pumpurėlis (Kalvarijų g. 186)";BITUTĖS;4419940231;Taip;0;12;0;12
8758;"Pumpurėlis (Kalvarijų g. 186)";BITUTĖS;4985045047;Taip;5;3;0;8
8759;"Pumpurėlis (Kalvarijų g. 186)";BITUTĖS;2651037375;Ne;6;0;3;9
8760;"Pumpurėlis (Kalvarijų g. 186)";BITUTĖS;1768239820;Taip;0;0;2;2
8761;"Pumpurėlis (Kalvarijų g. 186)";BITUTĖS;2566557351;Taip;15;3;0;18
8762;"Pumpurėlis (Kalvarijų g. 186)";BITUTĖS;4426697956;Taip;0;0;4;4
8763;"Pumpurėlis (Kalvarijų g. 186)";BITUTĖS;7363814444;Taip;0;9;0;9
8764;"Pumpurėlis (Kalvarijų g. 186)";BITUTĖS;3405169131;Taip;0;3;1;4
8765;"Pumpurėlis (Kalvarijų g. 186)";BITUTĖS;3951445693;Taip;0;6;0;6
8766;"Pumpurėlis (Kalvarijų g. 186)";BITUTĖS;9612924316;Taip;0;9;0;9
8767;"Pumpurėlis (Kalvarijų g. 186)";BITUTĖS;5194285627;Taip;0;4;0;4
8768;"Pumpurėlis (Kalvarijų g. 186)";BITUTĖS;1714440337;Taip;0;0;3;3
8769;"Pumpurėlis (Kalvarijų g. 186)";BITUTĖS;8655389224;Taip;4;0;1;5
8770;"Pumpurėlis (Kalvarijų g. 186)";BITUTĖS;1674341906;Taip;0;3;0;3
8771;"Pumpurėlis (Kalvarijų g. 186)";BITUTĖS;3842632260;Taip;0;3;0;3
8772;"Pumpurėlis (Kalvarijų g. 186)";BITUTĖS;1933502038;Taip;2;3;0;5
8773;"Pumpurėlis (Kalvarijų g. 186)";BITUTĖS;2230191718;Taip;0;3;0;3
8774;"Pumpurėlis (Kalvarijų g. 186)";BITUTĖS;7062090879;Taip;5;0;3;8
8775;"Pumpurėlis (Kalvarijų g. 186)";BITUTĖS;9245739052;Ne;0;0;4;4
8776;"Pumpurėlis (Kalvarijų g. 186)";BITUTĖS;8470433743;Taip;5;0;5;10
8777;"Pumpurėlis (Kalvarijų g. 186)";DOBILIUKAI;1839505206;Taip;0;6;0;6
8778;"Pumpurėlis (Kalvarijų g. 186)";DOBILIUKAI;3970253545;Taip;0;0;5;5
8779;"Pumpurėlis (Kalvarijų g. 186)";DOBILIUKAI;1808734330;Taip;10;3;0;13
8780;"Pumpurėlis (Kalvarijų g. 186)";DOBILIUKAI;6968264923;Taip;2;10;0;12
8781;"Pumpurėlis (Kalvarijų g. 186)";DOBILIUKAI;2700017433;Taip;0;2;1;3
8782;"Pumpurėlis (Kalvarijų g. 186)";DOBILIUKAI;7038597556;Taip;0;13;0;13
8783;"Pumpurėlis (Kalvarijų g. 186)";DOBILIUKAI;4130539703;Taip;0;4;0;4
8784;"Pumpurėlis (Kalvarijų g. 186)";DOBILIUKAI;6307988067;Taip;0;3;0;3
8785;"Pumpurėlis (Kalvarijų g. 186)";DOBILIUKAI;3374174445;Taip;0;5;0;5
8786;"Pumpurėlis (Kalvarijų g. 186)";DOBILIUKAI;3398517047;Taip;0;3;0;3
8787;"Pumpurėlis (Kalvarijų g. 186)";DOBILIUKAI;1961282282;Taip;3;0;0;3
8788;"Pumpurėlis (Kalvarijų g. 186)";DOBILIUKAI;7276322999;Taip;2;3;0;5
8789;"Pumpurėlis (Kalvarijų g. 186)";DOBILIUKAI;5587118874;Taip;0;0;2;2
8790;"Pumpurėlis (Kalvarijų g. 186)";DOBILIUKAI;9058493247;Taip;2;1;4;7
8791;"Pumpurėlis (Kalvarijų g. 186)";DOBILIUKAI;3214652626;Taip;0;0;3;3
8792;"Pumpurėlis (Kalvarijų g. 186)";DOBILIUKAI;2028068230;Taip;4;0;1;5
8793;"Pumpurėlis (Kalvarijų g. 186)";DOBILIUKAI;5444879430;Taip;0;0;3;3
8794;"Pumpurėlis (Kalvarijų g. 186)";DOBILIUKAI;7825190756;Taip;7;0;3;10
8795;"Pumpurėlis (Kalvarijų g. 186)";DOBILIUKAI;1438740562;Taip;2;3;0;5
8796;"Pumpurėlis (Kalvarijų g. 186)";DOBILIUKAI;9740660699;Taip;0;12;0;12
8797;"Pumpurėlis (Kalvarijų g. 186)";PUPYČIŲ;7652642088;Taip;5;0;4;9
8798;"Pumpurėlis (Kalvarijų g. 186)";PUPYČIŲ;9317274035;Taip;11;0;0;11
8799;"Pumpurėlis (Kalvarijų g. 186)";PUPYČIŲ;1555441484;Taip;11;0;0;11
8800;"Pumpurėlis (Kalvarijų g. 186)";PUPYČIŲ;9052267552;Taip;3;0;3;6
8801;"Pumpurėlis (Kalvarijų g. 186)";PUPYČIŲ;9372725707;Taip;3;2;2;7
8802;"Pumpurėlis (Kalvarijų g. 186)";PUPYČIŲ;4249039048;Taip;0;2;7;9
8803;"Pumpurėlis (Kalvarijų g. 186)";PUPYČIŲ;1082775039;Taip;8;0;4;12
8804;"Pumpurėlis (Kalvarijų g. 186)";PUPYČIŲ;6982600785;Taip;13;3;0;16
8805;"Pumpurėlis (Kalvarijų g. 186)";PUPYČIŲ;1667602636;Taip;10;0;3;13
8806;"Pumpurėlis (Kalvarijų g. 186)";PUPYČIŲ;8212403350;Taip;0;0;5;5
8807;"Pumpurėlis (Kalvarijų g. 186)";PUPYČIŲ;1448399754;Taip;10;3;0;13
8808;"Pumpurėlis (Kalvarijų g. 186)";PUPYČIŲ;6795405194;Taip;8;0;5;13
8809;"Pumpurėlis (Kalvarijų g. 186)";PUPYČIŲ;7443152469;Taip;0;0;16;16
8810;"Pumpurėlis (Kalvarijų g. 186)";PUPYČIŲ;9306426978;Taip;0;0;9;9
8811;"Pumpurėlis (Kalvarijų g. 186)";PUPYČIŲ;3259416263;Taip;0;0;15;15
8812;"Pumpurėlis (Kalvarijų g. 186)";PUPYČIŲ;6939412463;Taip;0;0;3;3
8813;"Pumpurėlis (Kalvarijų g. 186)";PUPYČIŲ;2715059752;Taip;0;0;3;3
8814;"Pumpurėlis (Kalvarijų g. 186)";PUPYČIŲ;8458676611;Taip;0;0;8;8
8815;"Pumpurėlis (Kalvarijų g. 186)";ŽIRNIUKŲ;9903981454;Taip;7;1;1;9
8816;"Pumpurėlis (Kalvarijų g. 186)";ŽIRNIUKŲ;3537534154;Taip;0;4;0;4
8817;"Pumpurėlis (Kalvarijų g. 186)";ŽIRNIUKŲ;1782842327;Taip;10;3;0;13
8818;"Pumpurėlis (Kalvarijų g. 186)";ŽIRNIUKŲ;9478685443;Taip;3;0;3;6
8819;"Pumpurėlis (Kalvarijų g. 186)";ŽIRNIUKŲ;6647331393;Taip;8;0;6;14
8820;"Pumpurėlis (Kalvarijų g. 186)";ŽIRNIUKŲ;3001331278;Taip;4;0;1;5
8821;"Pumpurėlis (Kalvarijų g. 186)";ŽIRNIUKŲ;9735493140;Taip;0;0;3;3
8822;"Pumpurėlis (Kalvarijų g. 186)";ŽIRNIUKŲ;3964441086;Taip;0;2;0;2
8823;"Pumpurėlis (Kalvarijų g. 186)";ŽIRNIUKŲ;8550119831;Taip;4;0;2;6
8824;"Pumpurėlis (Kalvarijų g. 186)";ŽIRNIUKŲ;4245270154;Taip;0;0;6;6
8825;"Pumpurėlis (Kalvarijų g. 186)";ŽIRNIUKŲ;6860128064;Taip;0;0;11;11
8826;"Pumpurėlis (Kalvarijų g. 186)";ŽIRNIUKŲ;2282966743;Taip;0;0;2;2
8827;"Pumpurėlis (Kalvarijų g. 186)";ŽIRNIUKŲ;5968577443;Taip;5;0;4;9
8828;"Pumpurėlis (Kalvarijų g. 186)";ŽIRNIUKŲ;8083674991;Taip;4;0;0;4
8829;"Pumpurėlis (Kalvarijų g. 186)";ŽIRNIUKŲ;9750242149;Taip;5;3;1;9
8830;"Pumpurėlis (Kalvarijų g. 186)";ŽIRNIUKŲ;5420222684;Taip;3;1;1;5
8831;"Pumpurėlis (Kalvarijų g. 186)";ŽIRNIUKŲ;4198532140;Taip;12;0;0;12
8832;"Pumpurėlis (Kalvarijų g. 186)";ŽIRNIUKŲ;6422203618;Taip;0;0;3;3
8833;"Pumpurėlis (Kalvarijų g. 186)";BORUŽĖLIŲ;2269864490;Taip;5;0;3;8
8834;"Pumpurėlis (Kalvarijų g. 186)";BORUŽĖLIŲ;6223338814;Taip;0;3;0;3
8835;"Pumpurėlis (Kalvarijų g. 186)";BORUŽĖLIŲ;5659508302;Taip;0;3;3;6
8836;"Pumpurėlis (Kalvarijų g. 186)";BORUŽĖLIŲ;5998858670;Ne;7;4;2;13
8837;"Pumpurėlis (Kalvarijų g. 186)";BORUŽĖLIŲ;7398363498;Taip;0;7;3;10
8838;"Pumpurėlis (Kalvarijų g. 186)";BORUŽĖLIŲ;5835545051;Taip;0;6;0;6
8839;"Pumpurėlis (Kalvarijų g. 186)";BORUŽĖLIŲ;4188020534;Taip;0;0;3;3
8840;"Pumpurėlis (Kalvarijų g. 186)";BORUŽĖLIŲ;6256781298;Taip;0;6;0;6
8841;"Pumpurėlis (Kalvarijų g. 186)";BORUŽĖLIŲ;9136771401;Taip;8;2;2;12
8842;"Pumpurėlis (Kalvarijų g. 186)";BORUŽĖLIŲ;7045349032;Taip;3;0;7;10
8843;"Pumpurėlis (Kalvarijų g. 186)";BORUŽĖLIŲ;1017838338;Taip;7;1;0;8
8844;"Pumpurėlis (Kalvarijų g. 186)";BORUŽĖLIŲ;1648249689;Taip;0;3;0;3
8845;"Pumpurėlis (Kalvarijų g. 186)";BORUŽĖLIŲ;7535098093;Taip;5;0;2;7
8846;"Pumpurėlis (Kalvarijų g. 186)";BORUŽĖLIŲ;7843280418;Taip;10;0;0;10
8847;"Pumpurėlis (Kalvarijų g. 186)";BORUŽĖLIŲ;3531862496;Taip;4;3;1;8
8848;"Pumpurėlis (Kalvarijų g. 186)";BORUŽĖLIŲ;1441993078;Ne;16;0;0;16
8849;"Pumpurėlis (Kalvarijų g. 186)";BORUŽĖLIŲ;2768082342;Taip;5;0;8;13
8850;"Pumpurėlis (Kalvarijų g. 186)";SMALSUČIŲ;6212212516;Taip;10;0;0;10
8851;"Pumpurėlis (Kalvarijų g. 186)";SMALSUČIŲ;6604801631;Taip;0;0;6;6
8852;"Pumpurėlis (Kalvarijų g. 186)";SMALSUČIŲ;6988369637;Taip;0;0;2;2
8853;"Pumpurėlis (Kalvarijų g. 186)";SMALSUČIŲ;9363610488;Taip;0;4;0;4
8854;"Pumpurėlis (Kalvarijų g. 186)";SMALSUČIŲ;8380689261;Taip;0;0;2;2
8855;"Pumpurėlis (Kalvarijų g. 186)";SMALSUČIŲ;6483338028;Taip;4;0;4;8
8856;"Pumpurėlis (Kalvarijų g. 186)";SMALSUČIŲ;3492977569;Taip;0;0;3;3
8857;"Pumpurėlis (Kalvarijų g. 186)";SMALSUČIŲ;6959214331;Taip;0;5;0;5
8858;"Pumpurėlis (Kalvarijų g. 186)";SMALSUČIŲ;3085309902;Taip;5;0;2;7
8859;"Pumpurėlis (Kalvarijų g. 186)";SMALSUČIŲ;4964949574;Taip;7;0;4;11
8860;"Pumpurėlis (Kalvarijų g. 186)";SMALSUČIŲ;2905797053;Taip;1;3;0;4
8861;"Pumpurėlis (Kalvarijų g. 186)";SMALSUČIŲ;2026021360;Taip;5;0;0;5
8862;"Pumpurėlis (Kalvarijų g. 186)";SMALSUČIŲ;3871151401;Taip;0;0;6;6
8863;"Pumpurėlis (Kalvarijų g. 186)";SMALSUČIŲ;6557857672;Taip;5;3;0;8
8864;"Pumpurėlis (Kalvarijų g. 186)";SMALSUČIŲ;5212827184;Taip;6;3;0;9
8865;"Pumpurėlis (Kalvarijų g. 186)";SMALSUČIŲ;6614797909;Taip;0;2;1;3
8866;"Pumpurėlis (Kalvarijų g. 186)";SMALSUČIŲ;7813696919;Taip;0;3;3;6
8867;"Pumpurėlis (Kalvarijų g. 186)";SMALSUČIŲ;5278250113;Taip;2;0;4;6
8868;"Pumpurėlis (Kalvarijų g. 186)";SMALSUČIŲ;5456922203;Taip;4;3;0;7
8869;Puriena;Ančiukų;1658720269;Taip;3;0;0;3
8870;Puriena;Ančiukų;6158842119;Taip;18;0;0;18
8871;Puriena;Ančiukų;3557013127;Taip;0;4;0;4
8872;Puriena;Ančiukų;4100466337;Taip;0;0;7;7
8873;Puriena;Ančiukų;9251058353;Taip;0;2;0;2
8874;Puriena;Ančiukų;3681811493;Taip;6;2;0;8
8875;Puriena;Ančiukų;4060087185;Taip;9;1;0;10
8876;Puriena;Ančiukų;6280465748;Taip;0;2;1;3
8877;Puriena;Ančiukų;3033562627;Taip;0;10;0;10
8878;Puriena;Ančiukų;5777076971;Taip;0;10;0;10
8879;Puriena;Ančiukų;8310231540;Taip;13;1;0;14
8880;Puriena;Ančiukų;4460575818;Taip;0;7;0;7
8881;Puriena;Ančiukų;8120597514;Taip;0;4;0;4
8882;Puriena;Ančiukų;7967288875;Taip;0;0;8;8
8883;Puriena;Ančiukų;5336923102;Taip;0;3;0;3
8884;Puriena;Ančiukų;1907429094;Taip;5;3;0;8
8885;Puriena;Ančiukų;4605662701;Ne;3;5;0;8
8886;Puriena;Ančiukų;4776745276;Taip;0;2;1;3
8887;Puriena;Ančiukų;6496291933;Taip;9;0;0;9
8888;Puriena;Ančiukų;7769252165;Taip;10;4;0;14
8889;Puriena;Ančiukų;2170025682;Taip;9;0;0;9
8890;Puriena;Ančiukų;3772941726;Taip;0;4;0;4
8891;Puriena;Ančiukų;1428098802;Taip;0;4;0;4
8892;Puriena;Drugeliai;2966464432;Taip;0;3;0;3
8893;Puriena;Drugeliai;4760827000;Taip;0;0;3;3
8894;Puriena;Drugeliai;4812271011;Taip;0;18;0;18
8895;Puriena;Drugeliai;1521955898;Taip;0;2;1;3
8896;Puriena;Drugeliai;8881337164;Taip;15;0;0;15
8897;Puriena;Drugeliai;5478026060;Taip;0;0;1;1
8898;Puriena;Drugeliai;6914613438;Taip;0;1;0;1
8899;Puriena;Drugeliai;8159342676;Taip;3;0;0;3
8900;Puriena;Drugeliai;1121312813;Taip;0;2;1;3
8901;Puriena;Drugeliai;2321753665;Taip;2;0;3;5
8902;Puriena;Drugeliai;7021756459;Taip;5;2;1;8
8903;Puriena;Drugeliai;1564155036;Taip;0;1;2;3
8904;Puriena;Drugeliai;9098291788;Taip;0;3;0;3
8905;Puriena;Drugeliai;6613654824;Taip;0;4;2;6
8906;Puriena;Drugeliai;3738277048;Ne;0;4;0;4
8907;Puriena;Drugeliai;7562458336;Taip;0;0;4;4
8908;Puriena;Drugeliai;3579008577;Taip;3;0;5;8
8909;Puriena;Drugeliai;4248701232;Taip;5;4;1;10
8910;Puriena;Drugeliai;7477278612;Taip;0;9;0;9
8911;Puriena;Drugeliai;9847768390;Taip;0;0;8;8
8912;Puriena;Drugeliai;1455237224;Taip;0;1;3;4
8913;Puriena;Drugeliai;6212693015;Taip;16;2;0;18
8914;Puriena;Drugeliai;5593526943;Ne;3;4;1;8
8915;Puriena;Pelėdžiukai;2013783668;Taip;0;3;0;3
8916;Puriena;Pelėdžiukai;8874823029;Taip;0;0;4;4
8917;Puriena;Pelėdžiukai;3149718901;Taip;0;5;2;7
8918;Puriena;Pelėdžiukai;9041388275;Taip;0;1;2;3
8919;Puriena;Pelėdžiukai;3175917649;Ne;0;0;3;3
8920;Puriena;Pelėdžiukai;5619637663;Taip;0;0;2;2
8921;Puriena;Pelėdžiukai;8061605125;Taip;0;3;0;3
8922;Puriena;Pelėdžiukai;2579402981;Taip;0;3;4;7
8923;Puriena;Pelėdžiukai;3671297035;Taip;0;0;7;7
8924;Puriena;Pelėdžiukai;2701942325;Taip;0;6;0;6
8925;Puriena;Pelėdžiukai;2267225709;Taip;0;1;2;3
8926;Puriena;Pelėdžiukai;6413337915;Taip;5;0;4;9
8927;Puriena;Pelėdžiukai;4858971990;Taip;0;2;0;2
8928;Puriena;Pelėdžiukai;1417566073;Taip;8;0;0;8
8929;Puriena;Pelėdžiukai;6463129806;Taip;0;4;1;5
8930;Puriena;Pelėdžiukai;4501239330;Taip;0;1;0;1
8931;Puriena;Pelėdžiukai;5341228269;Taip;0;18;0;18
8932;Puriena;Pelėdžiukai;6352605894;Ne;0;0;3;3
8933;Puriena;Pelėdžiukai;6786694796;Taip;0;0;4;4
8934;Puriena;Pelėdžiukai;8952508230;Taip;0;0;3;3
8935;Puriena;Pelėdžiukai;5080805225;Taip;4;0;3;7
8936;Puriena;Pelėdžiukai;1158768017;Taip;0;3;0;3
8937;Puriena;Voveriukai;3826282438;Taip;0;3;3;6
8938;Puriena;Voveriukai;9453994213;Taip;5;3;0;8
8939;Puriena;Voveriukai;8497070167;Taip;15;3;0;18
8940;Puriena;Voveriukai;4517020977;Taip;0;3;0;3
8941;Puriena;Voveriukai;4283608124;Taip;0;4;0;4
8942;Puriena;Voveriukai;8144488922;Taip;0;8;1;9
8943;Puriena;Voveriukai;8476986855;Taip;0;6;0;6
8944;Puriena;Voveriukai;3627403517;Taip;0;3;1;4
8945;Puriena;Voveriukai;8130975863;Taip;0;3;0;3
8946;Puriena;Voveriukai;2813562677;Taip;4;3;1;8
8947;Puriena;Voveriukai;7120683581;Taip;0;3;2;5
8948;Puriena;Voveriukai;4653085762;Taip;0;11;0;11
8949;Puriena;Voveriukai;3542374463;Taip;3;4;0;7
8950;Puriena;Voveriukai;1933733714;Taip;4;3;0;7
8951;Puriena;Voveriukai;6150437624;Taip;0;4;1;5
8952;Puriena;Voveriukai;8772936125;Taip;0;0;11;11
8953;Puriena;Voveriukai;6428413592;Ne;5;0;6;11
8954;Puriena;Voveriukai;8242140541;Taip;0;0;5;5
8955;Puriena;Voveriukai;4498919764;Taip;0;8;5;13
8956;Puriena;Voveriukai;9729644429;Ne;8;3;1;12
8957;Puriena;Voveriukai;6140294839;Taip;7;0;0;7
8958;Puriena;Voveriukai;3455291312;Taip;14;0;0;14
8959;Puriena;Voveriukai;7066959314;Taip;0;0;1;1
8960;Puriena;Bitučių;9413672989;Taip;0;0;10;10
8961;Puriena;Bitučių;5224135638;Taip;13;0;0;13
8962;Puriena;Bitučių;1175665781;Taip;0;3;0;3
8963;Puriena;Bitučių;6853706997;Taip;5;2;0;7
8964;Puriena;Bitučių;9962011647;Taip;9;0;3;12
8965;Puriena;Bitučių;1339162214;Taip;0;4;5;9
8966;Puriena;Bitučių;9543884311;Taip;10;4;0;14
8967;Puriena;Bitučių;6656013805;Taip;0;0;2;2
8968;Puriena;Bitučių;8022809059;Taip;13;0;0;13
8969;Puriena;Bitučių;5395382717;Taip;0;4;0;4
8970;Puriena;Bitučių;8237149969;Taip;11;1;0;12
8971;Puriena;Bitučių;7481642656;Taip;0;18;0;18
8972;Puriena;Bitučių;8512814466;Taip;0;6;0;6
8973;Puriena;Bitučių;7622407056;Taip;8;5;0;13
8974;Puriena;Bitučių;4017644414;Taip;12;1;0;13
8975;Puriena;Bitučių;1295692895;Taip;12;0;0;12
8976;Puriena;Bitučių;8416003733;Taip;7;2;2;11
8977;Puriena;Bitučių;8199607793;Taip;8;0;3;11
8978;Puriena;Bitučių;9854244405;Taip;0;2;1;3
8979;Puriena;Bitučių;6780164845;Taip;15;0;0;15
8980;Puriena;Zylutės;7337038503;Taip;0;5;0;5
8981;Puriena;Zylutės;5891404983;Taip;4;3;0;7
8982;Puriena;Zylutės;63196502622;Taip;0;3;0;3
8983;Puriena;Zylutės;9239618299;Taip;0;13;0;13
8984;Puriena;Zylutės;2083071198;Taip;0;4;0;4
8985;Puriena;Zylutės;20286870431;Taip;5;4;0;9
8986;Puriena;Zylutės;8618298134;Taip;10;3;0;13
8987;Puriena;Zylutės;1748337587;Taip;2;3;2;7
8988;Puriena;Zylutės;1820719083;Taip;7;0;0;7
8989;Puriena;Zylutės;2089174669;Taip;0;3;0;3
8990;Puriena;Zylutės;11497629767;Taip;5;4;0;9
8991;Puriena;Zylutės;2146036332;Taip;0;3;0;3
8992;Puriena;Zylutės;2378865002;Taip;0;5;0;5
8993;Puriena;Zylutės;2131343339;Taip;0;1;0;1
8994;Puriena;Zylutės;8213725698;Taip;0;3;0;3
8995;Puriena;Zylutės;8707076857;Taip;2;3;0;5
8996;Puriena;Zylutės;48468411549;Taip;4;4;0;8
8997;Puriena;Zylutės;1703078658;Taip;15;3;0;18
8998;Puriena;Zylutės;1756611673;Taip;0;3;0;3
8999;Puriena;Zylutės;6416145396;Ne;3;3;0;6
9000;Puriena;Zylutės;3031725530;Taip;8;0;0;8
9001;Puriena;Zylutės;6813480086;Taip;0;5;0;5
9002;Puriena;Meškučių;6234132927;Taip;11;0;0;11
9003;Puriena;Meškučių;4563681164;Taip;0;2;1;3
9004;Puriena;Meškučių;3153330970;Taip;0;2;1;3
9005;Puriena;Meškučių;9500729561;Taip;0;4;0;4
9006;Puriena;Meškučių;1238475246;Taip;0;2;2;4
9007;Puriena;Meškučių;5591189546;Taip;0;2;4;6
9008;Puriena;Meškučių;5323549829;Taip;0;2;0;2
9009;Puriena;Meškučių;7466163131;Taip;0;0;1;1
9010;Puriena;Meškučių;8359978283;Taip;0;18;0;18
9011;Puriena;Meškučių;2466609635;Taip;0;2;7;9
9012;Puriena;Meškučių;3309219271;Taip;5;2;0;7
9013;Puriena;Meškučių;9509041179;Taip;5;0;5;10
9014;Puriena;Meškučių;5176663365;Taip;0;2;2;4
9015;Puriena;Meškučių;9961074983;Taip;0;2;2;4
9016;Puriena;Meškučių;3011629747;Taip;0;0;12;12
9017;Puriena;Meškučių;2029981617;Taip;0;4;0;4
9018;Puriena;Meškučių;6185080390;Taip;13;0;0;13
9019;Puriena;Meškučių;3526684967;Taip;5;2;1;8
9020;Puriena;Meškučių;1513909923;Taip;5;0;7;12
9021;Puriena;Meškučių;7556975480;Taip;0;5;5;10
9022;Puriena;Meškučių;2711642252;Taip;0;1;0;1
9023;Puriena;Meškučių;8093664167;Taip;0;1;0;1
9024;Puriena;Nykštukų;1053386081;Taip;0;0;6;6
9025;Puriena;Nykštukų;5469827031;Taip;11;0;3;14
9026;Puriena;Nykštukų;7649596096;Taip;3;0;7;10
9027;Puriena;Nykštukų;2762325241;Taip;5;0;13;18
9028;Puriena;Nykštukų;9907142348;Taip;0;0;5;5
9029;Puriena;Nykštukų;9369786639;Taip;11;0;0;11
9030;Puriena;Nykštukų;4728991133;Taip;0;0;3;3
9031;Puriena;Nykštukų;2344061847;Taip;10;0;3;13
9032;Puriena;Nykštukų;3630564604;Taip;0;3;0;3
9033;Puriena;Nykštukų;9438604106;Taip;0;3;2;5
9034;Puriena;Nykštukų;9379314578;Taip;5;0;7;12
9035;Puriena;Nykštukų;4211784186;Taip;3;0;2;5
9036;Puriena;Nykštukų;1610219365;Taip;0;8;0;8
9037;Puriena;Nykštukų;2146727759;Taip;0;2;1;3
9038;Puriena;Nykštukų;1988826809;Taip;0;3;2;5
9039;Puriena;Nykštukų;6605817147;Taip;0;0;1;1
9040;Puriena;Nykštukų;6271951373;Taip;0;2;1;3
9041;Puriena;Nykštukų;7869104640;Taip;5;2;0;7
9042;Puriena;Ežiukai;6451492815;Taip;3;0;0;3
9043;Puriena;Ežiukai;6612468095;Taip;7;2;1;10
9044;Puriena;Ežiukai;7913847170;Taip;14;0;0;14
9045;Puriena;Ežiukai;8089081251;Taip;5;8;0;13
9046;Puriena;Ežiukai;2830409862;Ne;0;12;0;12
9047;Puriena;Ežiukai;5550321808;Taip;0;2;3;5
9048;Puriena;Ežiukai;8038573068;Taip;12;1;0;13
9049;Puriena;Ežiukai;2624283930;Taip;4;2;0;6
9050;Puriena;Ežiukai;6001659356;Taip;11;1;0;12
9051;Puriena;Ežiukai;5539708916;Taip;4;0;0;4
9052;Puriena;Ežiukai;7335537384;Taip;3;0;0;3
9053;Puriena;Ežiukai;3204824116;Taip;0;0;2;2
9054;Puriena;Ežiukai;4954787474;Taip;18;0;0;18
9055;Puriena;Ežiukai;7720549981;Taip;18;0;0;18
9056;Puriena;Ežiukai;5555076926;Taip;12;0;0;12
9057;Puriena;Ežiukai;2312297583;Taip;0;0;4;4
9058;Puriena;Ežiukai;3232981406;Taip;18;0;0;18
9059;Puriena;Ežiukai;9228372078;Taip;5;0;4;9
9060;Puriena;Ežiukai;5374864513;Taip;5;0;4;9
9061;Puriena;Ežiukai;1737249860;Taip;6;4;0;10
9062;Puriena;Ežiukai;4608801156;Taip;0;1;0;1
9063;Puriena;Ežiukai;6991740430;Taip;1;2;0;3
9064;Puriena;"Boružiukų ";9600515308;Taip;4;0;2;6
9065;Puriena;"Boružiukų ";7985332838;Taip;0;18;0;18
9066;Puriena;"Boružiukų ";9671916745;Taip;3;3;0;6
9067;Puriena;"Boružiukų ";8195902319;Taip;0;1;4;5
9068;Puriena;"Boružiukų ";4587892949;Taip;0;0;4;4
9069;Puriena;"Boružiukų ";9497287421;Taip;0;18;0;18
9070;Puriena;"Boružiukų ";2818282875;Taip;0;1;6;7
9071;Puriena;"Boružiukų ";3215364967;Taip;3;0;2;5
9072;Puriena;"Boružiukų ";7016498639;Taip;5;0;3;8
9073;Puriena;"Boružiukų ";5797970231;Taip;5;4;0;9
9074;Puriena;"Boružiukų ";3382737176;Taip;10;0;0;10
9075;Puriena;"Boružiukų ";8110665629;Taip;0;4;0;4
9076;Puriena;"Boružiukų ";4006267650;Taip;4;11;0;15
9077;Puriena;"Boružiukų ";3440488785;Taip;5;0;3;8
9078;Puriena;"Boružiukų ";4016228982;Taip;5;0;8;13
9079;Puriena;"Boružiukų ";1796123753;Taip;3;0;6;9
9080;Puriena;"Boružiukų ";5277351784;Taip;0;3;0;3
9081;Puriena;"Boružiukų ";9931397038;Taip;10;0;5;15
9082;Puriena;"Zuikučių ";3252190329;Taip;0;3;0;3
9083;Puriena;"Zuikučių ";9907972536;Taip;5;1;2;8
9084;Puriena;"Zuikučių ";4165800035;Taip;0;0;6;6
9085;Puriena;"Zuikučių ";7634536770;Taip;0;0;3;3
9086;Puriena;"Zuikučių ";9423229931;Taip;7;5;1;13
9087;Puriena;"Zuikučių ";8284860687;Taip;0;3;0;3
9088;Puriena;"Zuikučių ";9176303276;Taip;4;5;6;15
9089;Puriena;"Zuikučių ";6941251095;Taip;18;0;0;18
9090;Puriena;"Zuikučių ";4193710604;Taip;0;1;2;3
9091;Puriena;"Zuikučių ";8474426340;Taip;8;0;0;8
9092;Puriena;"Zuikučių ";6227990580;Taip;0;5;0;5
9093;Puriena;"Zuikučių ";2172109284;Taip;3;1;0;4
9094;Puriena;"Zuikučių ";8239919265;Taip;0;0;3;3
9095;Puriena;"Zuikučių ";3094722037;Taip;0;3;0;3
9096;Puriena;"Zuikučių ";6308393533;Taip;7;5;0;12
9097;Puriena;"Zuikučių ";5927216569;Taip;2;0;1;3
9098;Puriena;Skruzdėliukai;2203259310;Taip;0;3;1;4
9099;Puriena;Skruzdėliukai;8478901457;Taip;0;8;0;8
9100;Puriena;Skruzdėliukai;4647433927;Taip;0;18;0;18
9101;Puriena;Skruzdėliukai;5257713434;Taip;0;18;0;18
9102;Puriena;Skruzdėliukai;9106525954;Taip;0;3;0;3
9103;Puriena;Skruzdėliukai;11242620566;Taip;0;2;0;2
9104;Puriena;Skruzdėliukai;6285846517;Taip;0;3;0;3
9105;Puriena;Skruzdėliukai;6053657231;Taip;0;3;0;3
9106;Puriena;Skruzdėliukai;5999564879;Taip;0;2;5;7
9107;Puriena;Skruzdėliukai;9139110598;Taip;0;0;3;3
9108;Puriena;Skruzdėliukai;5501308683;Taip;0;4;0;4
9109;Puriena;Skruzdėliukai;2663832596;Taip;0;4;0;4
9110;Puriena;Skruzdėliukai;6057477307;Taip;5;0;0;5
9111;Puriena;Skruzdėliukai;4966293604;Taip;0;3;0;3
9112;Puriena;Skruzdėliukai;92604925140;Taip;0;2;0;2
9113;Puriena;Skruzdėliukai;1381379515;Taip;0;5;0;5
9114;Puriena;Skruzdėliukai;1290962809;Taip;0;5;1;6
9115;Puriena;Skruzdėliukai;23746358787;Taip;3;1;0;4
9116;Puriena;Skruzdėliukai;1263637124;Taip;0;3;0;3
9117;Puriena;Skruzdėliukai;1290933817;Taip;6;3;0;9
9118;Puriena;Skruzdėliukai;8112003551;Taip;0;2;0;2
9119;Pušaitė;Kodėlčiukai;8702361596;Taip;3;6;0;9
9120;Pušaitė;Kodėlčiukai;3832434608;Taip;0;0;4;4
9121;Pušaitė;Kodėlčiukai;4838345510;Taip;0;1;1;2
9122;Pušaitė;Kodėlčiukai;7068451014;Taip;0;5;0;5
9123;Pušaitė;Kodėlčiukai;6275090953;Taip;0;2;1;3
9124;Pušaitė;Kodėlčiukai;8750774616;Taip;0;5;1;6
9125;Pušaitė;Kodėlčiukai;4198571222;Taip;0;5;1;6
9126;Pušaitė;Kodėlčiukai;4743105731;Taip;0;0;2;2
9127;Pušaitė;Kodėlčiukai;9391350218;Taip;0;6;0;6
9128;Pušaitė;Kodėlčiukai;2793941689;Taip;10;3;0;13
9129;Pušaitė;Kodėlčiukai;9364887123;Taip;6;4;0;10
9130;Pušaitė;Kodėlčiukai;4326967247;Taip;5;3;5;13
9131;Pušaitė;Kodėlčiukai;5922053969;Taip;0;0;2;2
9132;Pušaitė;Kodėlčiukai;4473930703;Taip;0;5;3;8
9133;Pušaitė;Kodėlčiukai;6775428321;Taip;0;1;0;1
9134;Pušaitė;Kodėlčiukai;4615270419;Taip;0;5;0;5
9135;Pušaitė;Kodėlčiukai;7117784038;Taip;6;7;1;14
9136;Pušaitė;Kodėlčiukai;2253477550;Taip;0;7;0;7
9137;Pušaitė;Kodėlčiukai;6186545163;Taip;0;3;0;3
9138;Pušaitė;Saulutės;4511258460;Taip;5;3;0;8
9139;Pušaitė;Saulutės;5422616450;Taip;0;0;3;3
9140;Pušaitė;Saulutės;7237345427;Taip;0;0;3;3
9141;Pušaitė;Saulutės;5819186055;Taip;0;0;1;1
9142;Pušaitė;Saulutės;5981944481;Taip;0;1;0;1
9143;Pušaitė;Saulutės;2254269292;Taip;8;0;0;8
9144;Pušaitė;Saulutės;5306237557;Taip;18;0;0;18
9145;Pušaitė;Saulutės;4234318548;Taip;0;3;0;3
9146;Pušaitė;Saulutės;4883211957;Taip;0;18;0;18
9147;Pušaitė;Saulutės;1384820994;Taip;0;18;0;18
9148;Pušaitė;Saulutės;7480846917;Taip;3;0;3;6
9149;Pušaitė;Saulutės;8355083823;Taip;5;0;3;8
9150;Pušaitė;Saulutės;7291412329;Taip;6;0;1;7
9151;Pušaitė;Saulutės;2543188867;Taip;0;0;2;2
9152;Pušaitė;Saulutės;9577925438;Taip;0;0;4;4
9153;Pušaitė;Saulutės;8914668904;Taip;6;0;0;6
9154;Pušaitė;Zuikučiai;2115591523;Taip;0;1;0;1
9155;Pušaitė;Zuikučiai;8738827821;Taip;0;3;0;3
9156;Pušaitė;Zuikučiai;7477429922;Taip;0;10;0;10
9157;Pušaitė;Zuikučiai;6306133416;Taip;0;3;0;3
9158;Pušaitė;Zuikučiai;2099169654;Taip;0;2;2;4
9159;Pušaitė;Zuikučiai;6355379926;Taip;5;5;0;10
9160;Pušaitė;Zuikučiai;80743691769;Taip;5;0;0;5
9161;Pušaitė;Zuikučiai;1296700534;Taip;0;3;0;3
9162;Pušaitė;Zuikučiai;51500717235;Taip;5;1;0;6
9163;Pušaitė;Zuikučiai;2125574493;Taip;0;4;1;5
9164;Pušaitė;Zuikučiai;5398532705;Taip;0;1;3;4
9165;Pušaitė;Zuikučiai;4881689337;Taip;5;2;0;7
9166;Pušaitė;Zuikučiai;3718196299;Taip;0;3;0;3
9167;Pušaitė;Zuikučiai;1295203136;Taip;0;3;0;3
9168;Pušaitė;Zuikučiai;6259961070;Taip;2;3;0;5
9169;Pušaitė;Zuikučiai;2944418714;Taip;15;3;0;18
9170;Pušaitė;Zuikučiai;3813761666;Taip;10;3;0;13
9171;Pušaitė;Zuikučiai;4762094720;Taip;0;3;0;3
9172;Pušaitė;Zuikučiai;6600314608;Taip;10;3;0;13
9173;Pušaitė;Zuikučiai;2130767942;Taip;0;7;4;11
9174;Pušaitė;Zuikučiai;9179757395;Taip;5;3;0;8
9175;Pušaitė;Zuikučiai;8592426606;Taip;0;3;1;4
9176;Pušaitė;Zuikučiai;7251064118;Taip;0;3;4;7
9177;Pušaitė;Vėžliukai;8412276797;Taip;9;1;0;10
9178;Pušaitė;Vėžliukai;1326581025;Taip;0;7;0;7
9179;Pušaitė;Vėžliukai;8135552679;Taip;0;1;0;1
9180;Pušaitė;Vėžliukai;5161142520;Taip;5;3;0;8
9181;Pušaitė;Vėžliukai;3485234259;Taip;9;3;0;12
9182;Pušaitė;Vėžliukai;3014867515;Taip;0;0;4;4
9183;Pušaitė;Vėžliukai;9414554800;Taip;7;1;0;8
9184;Pušaitė;Vėžliukai;9470667227;Taip;0;4;0;4
9185;Pušaitė;Vėžliukai;6739253961;Taip;0;12;0;12
9186;Pušaitė;Vėžliukai;3014180020;Ne;0;0;5;5
9187;Pušaitė;Vėžliukai;7890577174;Taip;0;4;0;4
9188;Pušaitė;Vėžliukai;7652706756;Taip;0;3;0;3
9189;Pušaitė;Vėžliukai;5318602924;Taip;0;4;0;4
9190;Pušaitė;Vėžliukai;6794867560;Taip;0;0;3;3
9191;Pušaitė;Vėžliukai;6180888008;Taip;0;3;0;3
9192;Pušaitė;Vėžliukai;5296435012;Taip;0;1;0;1
9193;Pušaitė;Vėžliukai;6833083982;Taip;3;0;0;3
9194;Pušaitė;Vėžliukai;5512786073;Taip;6;3;0;9
9195;Pušaitė;Vėžliukai;8399589954;Taip;0;7;0;7
9196;Pušaitė;Vėžliukai;4281125486;Taip;0;8;0;8
9197;Pušaitė;Vėžliukai;2777222076;Taip;10;1;0;11
9198;Pušaitė;Vėžliukai;8459530338;Taip;0;2;0;2
9199;Pušaitė;"Linksmieji nykštukai";9265357004;Taip;0;1;0;1
9200;Pušaitė;"Linksmieji nykštukai";3150144924;Taip;3;4;0;7
9201;Pušaitė;"Linksmieji nykštukai";7520393710;Taip;5;0;1;6
9202;Pušaitė;"Linksmieji nykštukai";4517181474;Taip;0;5;0;5
9203;Pušaitė;"Linksmieji nykštukai";9033615485;Ne;0;2;0;2
9204;Pušaitė;"Linksmieji nykštukai";3130824742;Taip;0;3;0;3
9205;Pušaitė;"Linksmieji nykštukai";4605161267;Taip;8;5;0;13
9206;Pušaitė;"Linksmieji nykštukai";1781601521;Taip;0;3;0;3
9207;Pušaitė;"Linksmieji nykštukai";1024996364;Taip;0;3;3;6
9208;Pušaitė;"Linksmieji nykštukai";4662871524;Taip;0;6;0;6
9209;Pušaitė;"Linksmieji nykštukai";8438652029;Taip;0;0;3;3
9210;Pušaitė;"Linksmieji nykštukai";6578483902;Taip;7;0;4;11
9211;Pušaitė;"Linksmieji nykštukai";3350461304;Taip;8;1;0;9
9212;Pušaitė;"Linksmieji nykštukai";9327636862;Taip;0;0;1;1
9213;Pušaitė;"Linksmieji nykštukai";4175909754;Taip;0;0;4;4
9214;Pušaitė;"Linksmieji nykštukai";3788392895;Taip;8;2;1;11
9215;Pušaitė;"Linksmieji nykštukai";3195191374;Taip;2;3;0;5
9216;Pušaitė;"Linksmieji nykštukai";9127444013;Taip;0;4;0;4
9217;Pušaitė;"Linksmieji nykštukai";5422784898;Taip;0;3;0;3
9218;Pušaitė;"Linksmieji nykštukai";5104111840;Taip;3;3;0;6
9219;Pušaitė;"Linksmieji nykštukai";9866431097;Taip;0;5;2;7
9220;Pušaitė;"Linksmieji nykštukai";4564478833;Taip;8;3;0;11
9221;Pušaitė;"Linksmieji nykštukai";4374232593;Taip;5;3;0;8
9222;Pušaitė;"Linksmieji nykštukai";8378313810;Taip;10;3;0;13
9223;Pušaitė;"Kačiukų trobelė";3695016765;Taip;6;0;0;6
9224;Pušaitė;"Kačiukų trobelė";5415680731;Taip;0;5;0;5
9225;Pušaitė;"Kačiukų trobelė";7983115812;Taip;0;3;0;3
9226;Pušaitė;"Kačiukų trobelė";1122112207;Taip;0;5;0;5
9227;Pušaitė;"Kačiukų trobelė";1635528919;Taip;0;0;3;3
9228;Pušaitė;"Kačiukų trobelė";2837439334;Taip;13;0;0;13
9229;Pušaitė;"Kačiukų trobelė";7014914682;Taip;0;7;0;7
9230;Pušaitė;"Kačiukų trobelė";1624587173;Taip;0;3;0;3
9231;Pušaitė;"Kačiukų trobelė";8793102437;Taip;4;8;0;12
9232;Pušaitė;"Kačiukų trobelė";9056933586;Taip;1;7;2;10
9233;Pušaitė;"Kačiukų trobelė";7898355721;Taip;0;0;3;3
9234;Pušaitė;"Kačiukų trobelė";6323180798;Taip;0;1;4;5
9235;Pušaitė;"Kačiukų trobelė";5191894075;Taip;0;1;0;1
9236;Pušaitė;"Kačiukų trobelė";1161519408;Taip;0;1;0;1
9237;Pušaitė;"Kačiukų trobelė";8822285103;Taip;0;5;0;5
9238;Pušaitė;"Kačiukų trobelė";9313564235;Taip;8;6;0;14
9239;Pušaitė;"Kačiukų trobelė";2865062081;Taip;0;0;2;2
9240;Pušaitė;"Kačiukų trobelė";2430891944;Taip;5;2;0;7
9241;Pušaitė;"Kačiukų trobelė";1978339054;Taip;0;4;0;4
9242;Pušaitė;"Kačiukų trobelė";6189116357;Taip;6;3;0;9
9243;Pušaitė;Ežiukai;2090143259;Taip;0;2;0;2
9244;Pušaitė;Ežiukai;2951618391;Taip;0;3;0;3
9245;Pušaitė;Ežiukai;9524002395;Taip;0;5;1;6
9246;Pušaitė;Ežiukai;1111143593;Taip;0;3;0;3
9247;Pušaitė;Ežiukai;5394378197;Taip;0;10;1;11
9248;Pušaitė;Ežiukai;15270671089;Taip;0;5;3;8
9249;Pušaitė;Ežiukai;69869396094;Taip;0;5;0;5
9250;Pušaitė;Ežiukai;3359574190;Taip;0;4;0;4
9251;Pušaitė;Ežiukai;1143122778;Taip;0;3;0;3
9252;Pušaitė;Ežiukai;9461292576;Taip;5;3;0;8
9253;Pušaitė;Ežiukai;5185787803;Taip;0;3;0;3
9254;Pušaitė;Ežiukai;4671293211;Taip;0;4;0;4
9255;Pušaitė;Ežiukai;4101326122;Taip;0;3;1;4
9256;Pušaitė;Ežiukai;8958364766;Taip;0;5;0;5
9257;Pušaitė;Ežiukai;2983890410;Taip;0;3;0;3
9258;Pušaitė;Ežiukai;7575143890;Taip;0;3;2;5
9259;Pušaitė;Ežiukai;7808186865;Taip;0;8;0;8
9260;Pušaitė;Ežiukai;4842783897;Taip;5;3;0;8
9261;Pušaitė;Ežiukai;5436168234;Taip;0;3;0;3
9262;Pušaitė;Ežiukai;6472169278;Taip;0;3;0;3
9263;Pušaitė;Ežiukai;8021494509;Taip;5;3;1;9
9264;Pušaitė;Ežiukai;2172342063;Taip;15;3;0;18
9265;Pušaitė;Ežiukai;8309000712;Taip;5;3;0;8
9266;Pušaitė;"Gudručių šalis";8763667682;Taip;0;3;5;8
9267;Pušaitė;"Gudručių šalis";2321256048;Taip;5;3;0;8
9268;Pušaitė;"Gudručių šalis";5488507646;Taip;12;0;0;12
9269;Pušaitė;"Gudručių šalis";1305526154;Taip;3;2;1;6
9270;Pušaitė;"Gudručių šalis";6205900423;Taip;0;18;0;18
9271;Pušaitė;"Gudručių šalis";2078734161;Taip;0;0;5;5
9272;Pušaitė;"Gudručių šalis";8790959900;Taip;0;1;0;1
9273;Pušaitė;"Gudručių šalis";2397106198;Taip;0;3;0;3
9274;Pušaitė;"Gudručių šalis";3694667637;Taip;9;0;3;12
9275;Pušaitė;"Gudručių šalis";8343949011;Taip;9;0;0;9
9276;Pušaitė;"Gudručių šalis";4101285889;Taip;0;0;11;11
9277;Pušaitė;"Gudručių šalis";3959838346;Taip;10;0;0;10
9278;Pušaitė;"Gudručių šalis";5563772495;Taip;0;3;7;10
9279;Pušaitė;"Gudručių šalis";6356263503;Taip;0;0;3;3
9280;Pušaitė;"Gudručių šalis";2333176054;Ne;0;1;0;1
9281;Pušaitė;"Gudručių šalis";7066207306;Taip;0;3;5;8
9282;Pušaitė;"Gudručių šalis";4918124423;Taip;0;0;4;4
9283;Pušaitė;"Gudručių šalis";6734504906;Taip;9;0;0;9
9284;Pušaitė;"Gudručių šalis";7992567219;Taip;4;0;1;5
9285;Pušaitė;"Gudručių šalis";1807432967;Taip;6;0;0;6
9286;Pušaitė;"Gudručių šalis";3380836598;Taip;9;0;1;10
9287;Pušaitė;"Lapučių mokyklėlė";9337726482;Taip;5;1;0;6
9288;Pušaitė;"Lapučių mokyklėlė";5139525557;Taip;2;4;0;6
9289;Pušaitė;"Lapučių mokyklėlė";2666541612;Taip;0;5;3;8
9290;Pušaitė;"Lapučių mokyklėlė";8343225451;Taip;0;8;0;8
9291;Pušaitė;"Lapučių mokyklėlė";8218991320;Taip;0;3;0;3
9292;Pušaitė;"Lapučių mokyklėlė";1994898058;Taip;0;18;0;18
9293;Pušaitė;"Lapučių mokyklėlė";8551426938;Taip;10;2;5;17
9294;Pušaitė;"Lapučių mokyklėlė";4444972517;Taip;5;4;0;9
9295;Pušaitė;"Lapučių mokyklėlė";7615253880;Taip;17;1;0;18
9296;Pušaitė;"Lapučių mokyklėlė";4508356130;Taip;10;4;0;14
9297;Pušaitė;"Lapučių mokyklėlė";4857214952;Taip;0;8;0;8
9298;Pušaitė;"Lapučių mokyklėlė";4138386134;Taip;4;3;0;7
9299;Pušaitė;"Lapučių mokyklėlė";4103149433;Taip;0;1;0;1
9300;Pušaitė;"Lapučių mokyklėlė";4747611989;Taip;0;2;0;2
9301;Pušaitė;"Lapučių mokyklėlė";3387165403;Taip;0;5;0;5
9302;Pušaitė;"Lapučių mokyklėlė";5281161835;Taip;3;2;0;5
9303;Pušaitė;"Lapučių mokyklėlė";5339878948;Ne;0;7;0;7
9304;Pušaitė;"Lapučių mokyklėlė";3610256789;Taip;12;5;0;17
9305;Pušaitė;"Lapučių mokyklėlė";6576647982;Taip;5;3;0;8
9306;Pušaitė;"Lapučių mokyklėlė";1395577340;Taip;0;3;0;3
9307;Pušaitė;"Lapučių mokyklėlė";1534764228;Taip;0;7;0;7
9308;Pušaitė;"Lapučių mokyklėlė";5328083339;Taip;0;4;1;5
9309;Pušaitė;"Lapučių mokyklėlė";3200968850;Taip;5;10;0;15
9310;Pušaitė;"VOVERIUKAI ";7891007708;Taip;0;4;0;4
9311;Pušaitė;"VOVERIUKAI ";6767281906;Taip;2;5;0;7
9312;Pušaitė;"VOVERIUKAI ";3732377309;Taip;13;1;0;14
9313;Pušaitė;"VOVERIUKAI ";5270528758;Taip;3;5;0;8
9314;Pušaitė;"VOVERIUKAI ";4344634837;Taip;0;18;0;18
9315;Pušaitė;"VOVERIUKAI ";1665030028;Taip;8;4;0;12
9316;Pušaitė;"VOVERIUKAI ";5013833636;Taip;0;12;2;14
9317;Pušaitė;"VOVERIUKAI ";4769806128;Taip;13;0;0;13
9318;Pušaitė;"VOVERIUKAI ";6742576615;Taip;0;3;1;4
9319;Pušaitė;"VOVERIUKAI ";6511940816;Taip;0;18;0;18
9320;Pušaitė;"VOVERIUKAI ";4818407739;Taip;0;18;0;18
9321;Pušaitė;"VOVERIUKAI ";8876092901;Taip;11;0;1;12
9322;Pušaitė;"VOVERIUKAI ";9546541248;Taip;0;0;3;3
9323;Pušaitė;"VOVERIUKAI ";4767321724;Taip;0;18;0;18
9324;Pušaitė;"VOVERIUKAI ";1542239525;Taip;4;2;0;6
9325;Pušaitė;"VOVERIUKAI ";4529006786;Taip;9;1;1;11
9326;Pušaitė;MEŠKUČIAI;5002710062;Taip;0;18;0;18
9327;Pušaitė;MEŠKUČIAI;3052743933;Taip;0;18;0;18
9328;Pušaitė;MEŠKUČIAI;3646346787;Taip;0;18;0;18
9329;Pušaitė;MEŠKUČIAI;6754402783;Taip;0;18;0;18
9330;Pušaitė;MEŠKUČIAI;9180309936;Taip;10;0;0;10
9331;Pušaitė;MEŠKUČIAI;4754791489;Taip;9;5;0;14
9332;Pušaitė;MEŠKUČIAI;2264047794;Taip;6;8;0;14
9333;Pušaitė;MEŠKUČIAI;4278699624;Taip;0;18;0;18
9334;Pušaitė;MEŠKUČIAI;8244793037;Taip;10;2;3;15
9335;Pušaitė;MEŠKUČIAI;3508664946;Taip;0;3;0;3
9336;Pušaitė;MEŠKUČIAI;3239486674;Taip;7;0;0;7
9337;Pušaitė;MEŠKUČIAI;9339706754;Taip;12;0;0;12
9338;Pušaitė;MEŠKUČIAI;2887576870;Taip;9;0;0;9
9339;Pušaitė;MEŠKUČIAI;7583243031;Taip;9;0;1;10
9340;Pušaitė;MEŠKUČIAI;9418440677;Taip;0;18;0;18
9341;Pušaitė;MEŠKUČIAI;4082173648;Taip;0;8;0;8
9342;Pušaitė;PELIUKAI;7103772753;Taip;0;1;0;1
9343;Pušaitė;PELIUKAI;9177861202;Taip;13;3;0;16
9344;Pušaitė;PELIUKAI;9164927041;Taip;18;0;0;18
9345;Pušaitė;PELIUKAI;2454348536;Taip;7;0;2;9
9346;Pušaitė;PELIUKAI;6645711171;Taip;18;0;0;18
9347;Pušaitė;PELIUKAI;9867041220;Taip;5;0;3;8
9348;Pušaitė;PELIUKAI;9031289300;Taip;5;0;1;6
9349;Pušaitė;PELIUKAI;7210529114;Taip;12;3;0;15
9350;Pušaitė;PELIUKAI;2758026755;Taip;0;2;0;2
9351;Pušaitė;PELIUKAI;6851908671;Taip;0;1;2;3
9352;Pušaitė;PELIUKAI;7737524017;Taip;12;0;0;12
9353;Pušaitė;PELIUKAI;2618038364;Taip;0;18;0;18
9354;Pušaitė;PELIUKAI;1180343204;Taip;0;11;0;11
9355;Pušaitė;PELIUKAI;1069369636;Taip;0;12;0;12
9356;Pušaitė;PELIUKAI;5112517007;Taip;0;18;0;18
9357;Pušaitė;PELIUKAI;9261546370;Taip;0;2;2;4
9358;Pušaitė;PELIUKAI;6059415475;Taip;6;3;0;9
9359;"Pušynėlis (Miglos g. 53)";PUMPURĖLIAI;5725602894;Taip;0;7;10;17
9360;"Pušynėlis (Miglos g. 53)";PUMPURĖLIAI;2718421498;Taip;5;14;0;19
9361;"Pušynėlis (Miglos g. 53)";PUMPURĖLIAI;3882064516;Taip;0;3;0;3
9362;"Pušynėlis (Miglos g. 53)";PUMPURĖLIAI;9081582524;Taip;0;3;0;3
9363;"Pušynėlis (Miglos g. 53)";PUMPURĖLIAI;7787646910;Taip;0;3;0;3
9364;"Pušynėlis (Miglos g. 53)";PUMPURĖLIAI;8218331977;Taip;0;5;0;5
9365;"Pušynėlis (Miglos g. 53)";PUMPURĖLIAI;4526807309;Taip;0;4;0;4
9366;"Pušynėlis (Miglos g. 53)";PUMPURĖLIAI;5568838550;Taip;5;14;2;21
9367;"Pušynėlis (Miglos g. 53)";PUMPURĖLIAI;2553444832;Taip;0;0;1;1
9368;"Pušynėlis (Miglos g. 53)";PUMPURĖLIAI;2744665477;Taip;18;0;0;18
9369;"Pušynėlis (Miglos g. 53)";PUMPURĖLIAI;2509111066;Taip;0;3;1;4
9370;"Pušynėlis (Miglos g. 53)";PUMPURĖLIAI;8902047615;Taip;0;3;3;6
9371;"Pušynėlis (Miglos g. 53)";PUMPURĖLIAI;3483639540;Taip;0;2;0;2
9372;"Pušynėlis (Miglos g. 53)";PUMPURĖLIAI;2861000826;Taip;0;5;0;5
9373;"Pušynėlis (Miglos g. 53)";PUMPURĖLIAI;8845728723;Taip;0;3;0;3
9374;"Pušynėlis (Miglos g. 53)";PUMPURĖLIAI;5802582694;Taip;0;4;6;10
9375;"Pušynėlis (Miglos g. 53)";PUMPURĖLIAI;9465619945;Taip;0;3;5;8
9376;"Pušynėlis (Miglos g. 53)";PUMPURĖLIAI;9883505094;Taip;9;8;0;17
9377;"Pušynėlis (Miglos g. 53)";PUMPURĖLIAI;7438923710;Taip;14;0;0;14
9378;"Pušynėlis (Miglos g. 53)";PUMPURĖLIAI;4962270317;Taip;5;3;0;8
9379;"Pušynėlis (Miglos g. 53)";PUMPURĖLIAI;8803766149;Taip;6;3;1;10
9380;"Pušynėlis (Miglos g. 53)";PUMPURĖLIAI;8462742834;Taip;0;14;0;14
9381;"Pušynėlis (Miglos g. 53)";PUMPURĖLIAI;6962705842;Taip;0;0;18;18
9382;"Pušynėlis (Miglos g. 53)";PUMPURĖLIAI;6110878898;Taip;10;3;0;13
9383;"Pušynėlis (Miglos g. 53)";SAULUTĖS;3483007385;Taip;0;13;0;13
9384;"Pušynėlis (Miglos g. 53)";SAULUTĖS;1891728904;Taip;0;2;0;2
9385;"Pušynėlis (Miglos g. 53)";SAULUTĖS;2508640229;Taip;3;0;0;3
9386;"Pušynėlis (Miglos g. 53)";SAULUTĖS;5236219294;Taip;0;3;0;3
9387;"Pušynėlis (Miglos g. 53)";SAULUTĖS;4052132379;Taip;0;3;0;3
9388;"Pušynėlis (Miglos g. 53)";SAULUTĖS;1102029570;Taip;0;3;0;3
9389;"Pušynėlis (Miglos g. 53)";SAULUTĖS;9483417104;Taip;2;0;1;3
9390;"Pušynėlis (Miglos g. 53)";SAULUTĖS;4052365035;Taip;0;0;2;2
9391;"Pušynėlis (Miglos g. 53)";SAULUTĖS;7401066252;Taip;0;0;2;2
9392;"Pušynėlis (Miglos g. 53)";SAULUTĖS;6036296660;Taip;6;4;2;12
9393;"Pušynėlis (Miglos g. 53)";SAULUTĖS;1164201286;Taip;0;4;0;4
9394;"Pušynėlis (Miglos g. 53)";SAULUTĖS;1251787066;Taip;0;0;18;18
9395;"Pušynėlis (Miglos g. 53)";SAULUTĖS;6709692748;Taip;7;0;0;7
9396;"Pušynėlis (Miglos g. 53)";SAULUTĖS;5318223378;Taip;0;2;3;5
9397;"Pušynėlis (Miglos g. 53)";SAULUTĖS;3100230874;Taip;0;18;0;18
9398;"Pušynėlis (Miglos g. 53)";SAULUTĖS;7896617995;Taip;10;0;3;13
9399;"Pušynėlis (Miglos g. 53)";SAULUTĖS;5897839636;Taip;0;4;0;4
9400;"Pušynėlis (Miglos g. 53)";SAULUTĖS;1034336110;Taip;0;5;0;5
9401;"Pušynėlis (Miglos g. 53)";SAULUTĖS;8799095053;Taip;8;3;0;11
9402;"Pušynėlis (Miglos g. 53)";SAULUTĖS;8451160808;Taip;1;3;1;5
9403;"Pušynėlis (Miglos g. 53)";SAULUTĖS;5501281051;Taip;0;0;4;4
9404;"Pušynėlis (Miglos g. 53)";PRIEŠMOKYKLINĖ;25261143142;Taip;0;3;0;3
9405;"Pušynėlis (Miglos g. 53)";PRIEŠMOKYKLINĖ;8742287326;Taip;0;3;0;3
9406;"Pušynėlis (Miglos g. 53)";PRIEŠMOKYKLINĖ;6549217377;Taip;0;3;1;4
9407;"Pušynėlis (Miglos g. 53)";PRIEŠMOKYKLINĖ;2012089695;Taip;0;7;0;7
9408;"Pušynėlis (Miglos g. 53)";PRIEŠMOKYKLINĖ;35538053975;Taip;0;3;0;3
9409;"Pušynėlis (Miglos g. 53)";PRIEŠMOKYKLINĖ;76597184985;Taip;0;3;1;4
9410;"Pušynėlis (Miglos g. 53)";PRIEŠMOKYKLINĖ;7729392498;Taip;5;3;0;8
9411;"Pušynėlis (Miglos g. 53)";PRIEŠMOKYKLINĖ;9192206804;Taip;0;3;0;3
9412;"Pušynėlis (Miglos g. 53)";PRIEŠMOKYKLINĖ;6077698697;Taip;0;3;2;5
9413;"Pušynėlis (Miglos g. 53)";PRIEŠMOKYKLINĖ;4668634909;Taip;0;3;0;3
9414;"Pušynėlis (Miglos g. 53)";PRIEŠMOKYKLINĖ;6560054869;Taip;0;10;0;10
9415;"Pušynėlis (Miglos g. 53)";PRIEŠMOKYKLINĖ;3037031809;Taip;3;3;0;6
9416;"Pušynėlis (Miglos g. 53)";PRIEŠMOKYKLINĖ;4030500100;Taip;0;3;0;3
9417;"Pušynėlis (Miglos g. 53)";PRIEŠMOKYKLINĖ;8172450090;Taip;0;3;0;3
9418;"Pušynėlis (Miglos g. 53)";PRIEŠMOKYKLINĖ;2019210609;Taip;0;2;0;2
9419;"Pušynėlis (Miglos g. 53)";PRIEŠMOKYKLINĖ;2793982816;Taip;0;3;0;3
9420;"Pušynėlis (Miglos g. 53)";PRIEŠMOKYKLINĖ;7046421581;Taip;0;3;0;3
9421;"Pušynėlis (Miglos g. 53)";PRIEŠMOKYKLINĖ;9466109315;Ne;0;3;0;3
9422;"Pušynėlis (Miglos g. 53)";PRIEŠMOKYKLINĖ;9154108688;Taip;0;2;2;4
9423;"Pušynėlis (Miglos g. 53)";PRIEŠMOKYKLINĖ;1573574250;Taip;0;3;0;3
9424;"Pušynėlis (Miglos g. 53)";PRIEŠMOKYKLINĖ;3510202379;Taip;0;3;4;7
9425;"Pušynėlis (Miglos g. 53)";PRIEŠMOKYKLINĖ;2765869141;Taip;0;3;1;4
9426;"Pušynėlis (Miglos g. 53)";"TREPSIUKAI (2018.09)";7732546085;Taip;0;0;2;2
9427;"Pušynėlis (Miglos g. 53)";"TREPSIUKAI (2018.09)";4449613959;Taip;0;0;18;18
9428;"Pušynėlis (Miglos g. 53)";"TREPSIUKAI (2018.09)";8933840402;Taip;5;0;5;10
9429;"Pušynėlis (Miglos g. 53)";"TREPSIUKAI (2018.09)";5488832089;Taip;0;3;0;3
9430;"Pušynėlis (Miglos g. 53)";"TREPSIUKAI (2018.09)";6414064067;Taip;0;4;0;4
9431;"Pušynėlis (Miglos g. 53)";"TREPSIUKAI (2018.09)";5670094788;Taip;0;3;8;11
9432;"Pušynėlis (Miglos g. 53)";"TREPSIUKAI (2018.09)";5264481173;Taip;6;3;0;9
9433;"Pušynėlis (Miglos g. 53)";"TREPSIUKAI (2018.09)";4468698630;Taip;0;1;6;7
9434;"Pušynėlis (Miglos g. 53)";"TREPSIUKAI (2018.09)";1240222214;Taip;5;3;0;8
9435;"Pušynėlis (Miglos g. 53)";"TREPSIUKAI (2018.09)";6318952845;Taip;0;3;0;3
9436;"Pušynėlis (Miglos g. 53)";"TREPSIUKAI (2018.09)";1508282873;Taip;0;0;5;5
9437;"Pušynėlis (Miglos g. 53)";"TREPSIUKAI (2018.09)";7745507151;Taip;0;0;4;4
9438;"Pušynėlis (Miglos g. 53)";"TREPSIUKAI (2018.09)";8372033449;Taip;6;6;0;12
9439;"Pušynėlis (Miglos g. 53)";"TREPSIUKAI (2018.09)";7964828070;Taip;0;3;15;18
9440;"Pušynėlis (Miglos g. 53)";"TREPSIUKAI (2018.09)";4603625624;Taip;6;3;2;11
9441;"Pušynėlis (Miglos g. 53)";"TREPSIUKAI (2018.09)";3682719098;Taip;2;0;3;5
9442;"Pušynėlis (Miglos g. 53)";"TREPSIUKAI (2018.09)";5038740377;Taip;0;6;0;6
9443;Raktelis;LAŠIUKAI;5031703240;Taip;0;5;0;5
9444;Raktelis;LAŠIUKAI;4671391106;Taip;0;1;0;1
9445;Raktelis;LAŠIUKAI;9313156299;Taip;0;5;0;5
9446;Raktelis;LAŠIUKAI;8117871963;Taip;0;10;0;10
9447;Raktelis;LAŠIUKAI;1192775994;Taip;0;4;0;4
9448;Raktelis;LAŠIUKAI;6854111162;Taip;0;4;0;4
9449;Raktelis;LAŠIUKAI;9230053040;Ne;15;3;0;18
9450;Raktelis;LAŠIUKAI;3713386556;Taip;0;6;0;6
9451;Raktelis;LAŠIUKAI;5818899732;Taip;5;3;0;8
9452;Raktelis;LAŠIUKAI;7487507324;Taip;0;4;0;4
9453;Raktelis;LAŠIUKAI;9584164290;Taip;10;4;0;14
9454;Raktelis;LAŠIUKAI;6049420030;Ne;0;3;2;5
9455;Raktelis;LAŠIUKAI;3345708690;Taip;8;1;0;9
9456;Raktelis;LAŠIUKAI;2303286473;Taip;0;3;0;3
9457;Raktelis;LAŠIUKAI;54221331553;Taip;0;4;0;4
9458;Raktelis;LAŠIUKAI;5802689482;Taip;0;8;0;8
9459;Raktelis;LAŠIUKAI;5000264125;Taip;6;4;0;10
9460;Raktelis;LAŠIUKAI;1457880868;Taip;4;3;0;7
9461;Raktelis;LAŠIUKAI;5711863758;Taip;4;4;0;8
9462;Raktelis;LAŠIUKAI;53034039807;Taip;6;5;0;11
9463;Raktelis;LAŠIUKAI;7248631013;Taip;2;3;0;5
9464;Raktelis;LAŠIUKAI;8559758812;Taip;0;7;0;7
9465;Raktelis;LAŠIUKAI;9210856228;Taip;0;0;1;1
9466;Raktelis;BITUTĖS;7265543701;Taip;0;2;2;4
9467;Raktelis;BITUTĖS;5627179884;Taip;16;0;0;16
9468;Raktelis;BITUTĖS;5405322552;Taip;13;0;0;13
9469;Raktelis;BITUTĖS;5492437864;Ne;0;5;1;6
9470;Raktelis;BITUTĖS;9139322116;Taip;9;3;3;15
9471;Raktelis;BITUTĖS;6929358401;Taip;0;4;0;4
9472;Raktelis;BITUTĖS;9965855682;Taip;5;3;0;8
9473;Raktelis;BITUTĖS;4319176525;Taip;0;2;2;4
9474;Raktelis;BITUTĖS;4317705126;Taip;0;3;0;3
9475;Raktelis;BITUTĖS;4187804340;Ne;0;0;3;3
9476;Raktelis;BITUTĖS;5820028619;Taip;10;3;0;13
9477;Raktelis;BITUTĖS;2652125338;Taip;1;0;8;9
9478;Raktelis;BITUTĖS;3821849812;Taip;7;2;0;9
9479;Raktelis;BITUTĖS;3308623522;Ne;8;3;0;11
9480;Raktelis;BITUTĖS;4059286631;Taip;13;0;0;13
9481;Raktelis;BITUTĖS;5913060415;Taip;0;5;0;5
9482;Raktelis;BITUTĖS;6974263764;Taip;5;7;0;12
9483;Raktelis;BITUTĖS;6932820066;Taip;2;3;1;6
9484;Raktelis;BITUTĖS;2410682193;Taip;10;0;3;13
9485;Raktelis;BITUTĖS;5705825231;Taip;5;0;3;8
9486;Raktelis;BITUTĖS;4615337759;Taip;10;4;0;14
9487;Raktelis;BITUTĖS;4962251215;Taip;0;7;0;7
9488;Raktelis;BITUTĖS;8282429202;Taip;5;3;0;8
9489;Raktelis;BORUŽĖLĖS;7068061170;Taip;18;0;0;18
9490;Raktelis;BORUŽĖLĖS;2361477092;Taip;0;8;0;8
9491;Raktelis;BORUŽĖLĖS;4226277600;Ne;5;9;0;14
9492;Raktelis;BORUŽĖLĖS;2599670832;Taip;10;3;0;13
9493;Raktelis;BORUŽĖLĖS;1757601091;Taip;0;6;0;6
9494;Raktelis;BORUŽĖLĖS;5865484633;Ne;4;6;0;10
9495;Raktelis;BORUŽĖLĖS;4529213150;Taip;3;3;0;6
9496;Raktelis;BORUŽĖLĖS;4936637343;Taip;4;4;0;8
9497;Raktelis;BORUŽĖLĖS;4333191842;Taip;7;3;0;10
9498;Raktelis;BORUŽĖLĖS;9529797517;Taip;0;8;0;8
9499;Raktelis;BORUŽĖLĖS;1618225282;Taip;3;0;0;3
9500;Raktelis;BORUŽĖLĖS;4442395100;Taip;6;4;0;10
9501;Raktelis;BORUŽĖLĖS;5150954686;Taip;18;0;0;18
9502;Raktelis;BORUŽĖLĖS;3490428062;Taip;5;6;0;11
9503;Raktelis;BORUŽĖLĖS;5404673733;Taip;0;2;0;2
9504;Raktelis;BORUŽĖLĖS;1314972335;Taip;0;9;0;9
9505;Raktelis;BORUŽĖLĖS;3343352568;Taip;0;9;0;9
9506;Raktelis;BORUŽĖLĖS;2698820718;Taip;2;3;0;5
9507;Raktelis;BORUŽĖLĖS;7990626447;Taip;0;5;0;5
9508;Raktelis;BORUŽĖLĖS;7459272209;Taip;0;3;0;3
9509;Raktelis;BORUŽĖLĖS;1141447274;Taip;2;8;0;10
9510;Raktelis;BORUŽĖLĖS;3456093273;Taip;10;3;0;13
9511;Raktelis;BORUŽĖLĖS;5576511314;Taip;1;3;3;7
9512;Raktelis;KAČIUKAI;5270430511;Taip;15;0;0;15
9513;Raktelis;KAČIUKAI;4622683599;Taip;0;3;0;3
9514;Raktelis;KAČIUKAI;8600632097;Taip;0;7;0;7
9515;Raktelis;KAČIUKAI;7630501672;Taip;11;1;0;12
9516;Raktelis;KAČIUKAI;6007823584;Taip;5;1;0;6
9517;Raktelis;KAČIUKAI;3733786043;Taip;0;3;0;3
9518;Raktelis;KAČIUKAI;4676213966;Taip;0;3;0;3
9519;Raktelis;KAČIUKAI;4631375439;Taip;0;13;0;13
9520;Raktelis;KAČIUKAI;6265489540;Taip;0;10;0;10
9521;Raktelis;KAČIUKAI;4160091258;Taip;11;0;0;11
9522;Raktelis;KAČIUKAI;6550851582;Taip;0;3;0;3
9523;Raktelis;KAČIUKAI;4009105487;Taip;2;3;0;5
9524;Raktelis;KAČIUKAI;1843086151;Ne;1;3;0;4
9525;Raktelis;KAČIUKAI;2295251060;Taip;7;0;0;7
9526;Raktelis;KAČIUKAI;1983808547;Taip;0;1;0;1
9527;Raktelis;KAČIUKAI;5042538956;Taip;0;2;0;2
9528;Raktelis;KAČIUKAI;7260767942;Taip;8;0;0;8
9529;Raktelis;KAČIUKAI;6323223256;Taip;0;6;0;6
9530;Raktelis;KAČIUKAI;1123693990;Taip;4;6;0;10
9531;Raktelis;KAČIUKAI;4979657165;Taip;4;0;0;4
9532;Raktelis;KAČIUKAI;2700148968;Taip;0;3;0;3
9533;Raktelis;KIŠKUČIAI;9390692206;Taip;16;0;0;16
9534;Raktelis;KIŠKUČIAI;7847787737;Taip;5;3;0;8
9535;Raktelis;KIŠKUČIAI;7046291082;Taip;2;5;1;8
9536;Raktelis;KIŠKUČIAI;2278227649;Taip;11;3;0;14
9537;Raktelis;KIŠKUČIAI;8992797384;Taip;0;5;0;5
9538;Raktelis;KIŠKUČIAI;9803505110;Taip;6;4;0;10
9539;Raktelis;KIŠKUČIAI;6473692639;Taip;5;0;0;5
9540;Raktelis;KIŠKUČIAI;1668164327;Taip;5;0;0;5
9541;Raktelis;KIŠKUČIAI;6587878165;Taip;0;7;0;7
9542;Raktelis;KIŠKUČIAI;9169797346;Taip;14;1;1;16
9543;Raktelis;KIŠKUČIAI;2262854947;Taip;18;0;0;18
9544;Raktelis;KIŠKUČIAI;3493159224;Taip;10;0;0;10
9545;Raktelis;KIŠKUČIAI;1810732707;Taip;0;0;2;2
9546;Raktelis;KIŠKUČIAI;5293558630;Taip;3;0;0;3
9547;Raktelis;KIŠKUČIAI;7605822626;Taip;6;0;0;6
9548;Raktelis;NYKŠTUKAI;7865593006;Ne;8;0;0;8
9549;Raktelis;NYKŠTUKAI;4252867688;Taip;0;2;1;3
9550;Raktelis;NYKŠTUKAI;7058612493;Taip;0;0;2;2
9551;Raktelis;NYKŠTUKAI;8817859592;Taip;0;3;2;5
9552;Raktelis;NYKŠTUKAI;4578445282;Taip;0;6;0;6
9553;Raktelis;NYKŠTUKAI;3890474241;Taip;0;1;0;1
9554;Raktelis;NYKŠTUKAI;9164539135;Taip;11;3;0;14
9555;Raktelis;NYKŠTUKAI;4147382341;Taip;11;0;0;11
9556;Raktelis;NYKŠTUKAI;3968555691;Taip;0;12;0;12
9557;Raktelis;NYKŠTUKAI;2234892629;Taip;0;1;1;2
9558;Raktelis;NYKŠTUKAI;8507551381;Taip;0;1;1;2
9559;Raktelis;NYKŠTUKAI;4764915486;Taip;7;3;1;11
9560;Raktelis;NYKŠTUKAI;4765483387;Taip;4;1;0;5
9561;Raktelis;NYKŠTUKAI;9114203596;Ne;0;12;0;12
9562;Raktelis;NYKŠTUKAI;2803146830;Taip;18;0;0;18
9563;Raktelis;NYKŠTUKAI;1002851704;Taip;0;4;0;4
9564;Raktelis;NYKŠTUKAI;7202523804;Taip;0;8;0;8
9565;Raktelis;NYKŠTUKAI;6718159439;Taip;7;6;0;13
9566;Raktelis;PELIUKAI;9599034285;Taip;7;2;3;12
9567;Raktelis;PELIUKAI;1604357851;Taip;11;0;0;11
9568;Raktelis;PELIUKAI;6393143566;Taip;5;2;0;7
9569;Raktelis;PELIUKAI;4014822452;Taip;0;7;0;7
9570;Raktelis;PELIUKAI;5758873229;Taip;10;0;0;10
9571;Raktelis;PELIUKAI;2141128125;Taip;8;0;0;8
9572;Raktelis;PELIUKAI;4502236264;Taip;9;2;0;11
9573;Raktelis;PELIUKAI;2754009962;Taip;8;0;0;8
9574;Raktelis;PELIUKAI;3311870918;Taip;5;2;2;9
9575;Raktelis;PELIUKAI;6826993779;Taip;5;2;2;9
9576;Raktelis;PELIUKAI;8698736569;Taip;0;9;0;9
9577;Raktelis;PELIUKAI;2044812301;Taip;4;4;0;8
9578;Raktelis;PELIUKAI;2301442262;Taip;8;0;0;8
9579;Raktelis;PELIUKAI;6853881405;Taip;0;3;0;3
9580;Raktelis;PELIUKAI;1120263625;Taip;0;2;0;2
9581;Raktelis;PELIUKAI;9983004779;Taip;0;1;0;1
9582;Raktelis;PELIUKAI;7389910330;Taip;10;0;0;10
9583;Raktelis;AGUONOS;6102196040;Taip;5;3;0;8
9584;Raktelis;AGUONOS;1622504968;Taip;0;3;0;3
9585;Raktelis;AGUONOS;6199212999;Taip;4;6;0;10
9586;Raktelis;AGUONOS;7334310944;Taip;0;5;0;5
9587;Raktelis;AGUONOS;6281687751;Taip;0;4;0;4
9588;Raktelis;AGUONOS;1975411457;Taip;8;1;0;9
9589;Raktelis;AGUONOS;6367875352;Taip;10;0;4;14
9590;Raktelis;AGUONOS;7170546710;Taip;13;3;0;16
9591;Raktelis;AGUONOS;4905982507;Taip;0;3;0;3
9592;Raktelis;AGUONOS;9779789133;Taip;5;3;0;8
9593;Raktelis;AGUONOS;9593639791;Taip;5;7;0;12
9594;Raktelis;AGUONOS;1392036584;Taip;0;14;0;14
9595;Raktelis;AGUONOS;6608224825;Taip;0;11;0;11
9596;Raktelis;AGUONOS;4658530212;Taip;0;3;0;3
9597;Raktelis;AGUONOS;4335378625;Taip;0;3;0;3
9598;Raktelis;AGUONOS;8873203690;Taip;3;9;0;12
9599;Raktelis;AGUONOS;9357757604;Taip;0;10;0;10
9600;Raktelis;AGUONOS;8459980712;Taip;0;5;0;5
9601;Raktelis;AGUONOS;7973137015;Taip;10;1;0;11
9602;Raktelis;AGUONOS;9591285702;Taip;8;0;0;8
9603;Raktelis;AGUONOS;8767785444;Taip;0;3;1;4
9604;Raktelis;AGUONOS;9355380341;Taip;0;3;3;6
9605;Raktelis;AGUONOS;3687735991;Taip;0;1;0;1
9606;Raktelis;LAPIUKŲ;6894769625;Taip;18;0;0;18
9607;Raktelis;LAPIUKŲ;9048412613;Taip;0;1;0;1
9608;Raktelis;LAPIUKŲ;7142823740;Taip;0;3;0;3
9609;Raktelis;LAPIUKŲ;3395720463;Taip;0;10;0;10
9610;Raktelis;LAPIUKŲ;4167194960;Taip;0;8;0;8
9611;Raktelis;LAPIUKŲ;2809458453;Taip;0;4;0;4
9612;Raktelis;LAPIUKŲ;5487606214;Taip;0;1;0;1
9613;Raktelis;LAPIUKŲ;2967941870;Taip;0;10;0;10
9614;Raktelis;LAPIUKŲ;6892006495;Taip;0;7;0;7
9615;Raktelis;LAPIUKŲ;3884068578;Taip;0;6;0;6
9616;Raktelis;LAPIUKŲ;4755892641;Taip;0;9;0;9
9617;Raktelis;LAPIUKŲ;7440866459;Taip;0;3;0;3
9618;Raktelis;LAPIUKŲ;3517484891;Taip;7;4;0;11
9619;Raktelis;LAPIUKŲ;5688795147;Taip;0;5;0;5
9620;Raktelis;LAPIUKŲ;6822021176;Taip;15;0;0;15
9621;Raktelis;LAPIUKŲ;8146076115;Taip;0;5;0;5
9622;Raktelis;LAPIUKŲ;4353473162;Taip;0;3;0;3
9623;Raktelis;LAPIUKŲ;8700012974;Taip;0;1;1;2
9624;Raktelis;LAPIUKŲ;1263150004;Taip;10;3;0;13
9625;Raktelis;LAPIUKŲ;1445359221;Taip;2;0;0;2
9626;Raktelis;LAPIUKŲ;9497620710;Taip;7;0;0;7
9627;Raktelis;PELĖDŽIUKAI;5275588088;Taip;5;4;0;9
9628;Raktelis;PELĖDŽIUKAI;3602722744;Taip;0;0;1;1
9629;Raktelis;PELĖDŽIUKAI;54341630847;Taip;10;4;0;14
9630;Raktelis;PELĖDŽIUKAI;4583377785;Taip;5;3;0;8
9631;Raktelis;PELĖDŽIUKAI;8320696048;Taip;0;3;0;3
9632;Raktelis;PELĖDŽIUKAI;67304194087;Taip;6;3;0;9
9633;Raktelis;PELĖDŽIUKAI;2753402906;Taip;0;7;0;7
9634;Raktelis;PELĖDŽIUKAI;5768653399;Taip;6;3;1;10
9635;Raktelis;PELĖDŽIUKAI;7962509432;Taip;0;8;0;8
9636;Raktelis;PELĖDŽIUKAI;67972824332;Taip;0;4;0;4
9637;Raktelis;PELĖDŽIUKAI;9053427316;Taip;3;2;0;5
9638;Raktelis;PELĖDŽIUKAI;3423529085;Taip;8;0;0;8
9639;Raktelis;PELĖDŽIUKAI;9716191639;Taip;0;4;4;8
9640;Raktelis;PELĖDŽIUKAI;1322912585;Taip;15;1;0;16
9641;Raktelis;PELĖDŽIUKAI;6877934219;Taip;10;3;0;13
9642;Raktelis;PELĖDŽIUKAI;9130613710;Taip;0;9;0;9
9643;Raktelis;PELĖDŽIUKAI;9151796053;Taip;10;0;0;10
9644;Raktelis;PELĖDŽIUKAI;2282754345;Taip;0;4;0;4
9645;Raktelis;PELĖDŽIUKAI;8207675881;Taip;2;5;3;10
9646;Raktelis;PELĖDŽIUKAI;6385127914;Taip;0;3;2;5
9647;Raktelis;PELĖDŽIUKAI;5925441742;Taip;13;0;0;13
9648;Raktelis;PELĖDŽIUKAI;5082785025;Taip;10;0;3;13
9649;Raktelis;MEŠKIUKAI;6703168910;Taip;13;0;0;13
9650;Raktelis;MEŠKIUKAI;8851021346;Taip;3;0;1;4
9651;Raktelis;MEŠKIUKAI;4185763817;Taip;9;0;0;9
9652;Raktelis;MEŠKIUKAI;6685891017;Taip;0;3;2;5
9653;Raktelis;MEŠKIUKAI;3484991718;Taip;4;2;1;7
9654;Raktelis;MEŠKIUKAI;6855863189;Taip;6;2;1;9
9655;Raktelis;MEŠKIUKAI;1026592738;Taip;0;5;1;6
9656;Raktelis;MEŠKIUKAI;7900644404;Taip;18;0;0;18
9657;Raktelis;MEŠKIUKAI;5718804414;Taip;4;0;1;5
9658;Raktelis;MEŠKIUKAI;9718355271;Taip;10;0;0;10
9659;Raktelis;MEŠKIUKAI;2171952119;Taip;12;0;0;12
9660;Raktelis;MEŠKIUKAI;6358227532;Taip;0;9;0;9
9661;Raktelis;MEŠKIUKAI;8341026400;Taip;1;4;0;5
9662;Raktelis;MEŠKIUKAI;8608093349;Taip;0;8;0;8
9663;Rasa;Nykštukai;5176175108;Taip;0;6;2;8
9664;Rasa;Nykštukai;3979273111;Taip;5;6;0;11
9665;Rasa;Nykštukai;4847544355;Taip;8;5;0;13
9666;Rasa;Nykštukai;9723040721;Taip;0;6;0;6
9667;Rasa;Nykštukai;7004232909;Taip;0;5;0;5
9668;Rasa;Nykštukai;1223962374;Taip;0;0;10;10
9669;Rasa;Nykštukai;3200377629;Taip;0;8;3;11
9670;Rasa;Nykštukai;1336291828;Taip;0;10;0;10
9671;Rasa;Nykštukai;5861229664;Taip;0;4;0;4
9672;Rasa;Nykštukai;1386880644;Taip;5;4;0;9
9673;Rasa;Nykštukai;7228037580;Taip;0;5;0;5
9674;Rasa;Nykštukai;2093263887;Taip;0;0;3;3
9675;Rasa;Nykštukai;2540124793;Taip;4;4;0;8
9676;Rasa;Nykštukai;5363748728;Taip;0;3;0;3
9677;Rasa;Nykštukai;2977737634;Taip;0;3;0;3
9678;Rasa;Nykštukai;8310400946;Taip;0;5;0;5
9679;Rasa;Nykštukai;7520665472;Taip;0;11;0;11
9680;Rasa;Nykštukai;7534306402;Taip;0;6;0;6
9681;Rasa;Nykštukai;7326816081;Ne;0;12;7;19
9682;Rasa;Nykštukai;5864894208;Ne;0;12;7;19
9683;Rasa;Nykštukai;3755794133;Taip;0;4;0;4
9684;Rasa;Meškiukai;8378755600;Taip;0;11;0;11
9685;Rasa;Meškiukai;3073804713;Taip;0;0;1;1
9686;Rasa;Meškiukai;6691161322;Taip;0;3;1;4
9687;Rasa;Meškiukai;8740659600;Taip;0;18;0;18
9688;Rasa;Meškiukai;6874601830;Taip;1;16;0;17
9689;Rasa;Meškiukai;4127921417;Taip;0;4;3;7
9690;Rasa;Meškiukai;7357915584;Taip;5;6;0;11
9691;Rasa;Meškiukai;8314522373;Taip;1;7;0;8
9692;Rasa;Meškiukai;3548008659;Taip;0;18;0;18
9693;Rasa;Meškiukai;3773600344;Taip;12;0;1;13
9694;Rasa;Meškiukai;2371282781;Taip;12;0;1;13
9695;Rasa;Meškiukai;2555108465;Taip;0;13;0;13
9696;Rasa;Meškiukai;1992726664;Taip;0;0;1;1
9697;Rasa;Meškiukai;7843789214;Taip;5;0;0;5
9698;Rasa;Meškiukai;5165588335;Taip;3;4;0;7
9699;Rasa;Meškiukai;7637404588;Taip;0;3;2;5
9700;Rasa;Meškiukai;7502435359;Taip;0;3;0;3
9701;Rasa;Meškiukai;6853285570;Taip;11;3;0;14
9702;Rasa;Meškiukai;8674133653;Taip;0;18;0;18
9703;Rasa;Meškiukai;2840437821;Taip;0;13;0;13
9704;Rasa;Sauliukai;72772661373;Taip;0;3;0;3
9705;Rasa;Sauliukai;6879558965;Taip;5;3;0;8
9706;Rasa;Sauliukai;6356448094;Taip;0;3;0;3
9707;Rasa;Sauliukai;2683897055;Taip;4;7;0;11
9708;Rasa;Sauliukai;2982016133;Taip;0;5;0;5
9709;Rasa;Sauliukai;8052120247;Taip;0;3;0;3
9710;Rasa;Sauliukai;7534548604;Taip;0;5;0;5
9711;Rasa;Sauliukai;3567565920;Taip;3;5;0;8
9712;Rasa;Sauliukai;7565880116;Taip;0;2;0;2
9713;Rasa;Sauliukai;4790859112;Taip;0;3;1;4
9714;Rasa;Sauliukai;2110008545;Taip;0;3;0;3
9715;Rasa;Sauliukai;5932187584;Taip;0;3;0;3
9716;Rasa;Sauliukai;4837280374;Ne;0;4;0;4
9717;Rasa;Sauliukai;4260142706;Taip;3;4;0;7
9718;Rasa;Sauliukai;5145978804;Taip;14;3;0;17
9719;Rasa;Sauliukai;8818450386;Taip;0;5;0;5
9720;Rasa;Sauliukai;6734478649;Taip;0;7;1;8
9721;Rasa;Sauliukai;5606722133;Taip;0;4;0;4
9722;Rasa;Sauliukai;63673920646;Taip;3;5;0;8
9723;Rasa;Sauliukai;8953448462;Taip;10;6;0;16
9724;Rasa;Smalsučiai;5599182715;Taip;0;5;0;5
9725;Rasa;Smalsučiai;9648034081;Taip;0;3;0;3
9726;Rasa;Smalsučiai;2626361958;Taip;0;5;0;5
9727;Rasa;Smalsučiai;7065597550;Taip;0;1;0;1
9728;Rasa;Smalsučiai;2132535297;Taip;0;3;1;4
9729;Rasa;Smalsučiai;8866896989;Taip;0;6;0;6
9730;Rasa;Smalsučiai;9938280570;Taip;0;4;0;4
9731;Rasa;Smalsučiai;1690518970;Taip;0;3;0;3
9732;Rasa;Smalsučiai;3023088027;Taip;0;8;0;8
9733;Rasa;Smalsučiai;4758605343;Taip;0;5;1;6
9734;Rasa;Smalsučiai;3091012313;Taip;8;5;2;15
9735;Rasa;Smalsučiai;7558966891;Taip;4;4;1;9
9736;Rasa;Smalsučiai;6345614521;Taip;0;3;0;3
9737;Rasa;Smalsučiai;1651905746;Taip;0;3;0;3
9738;Rasa;Smalsučiai;1823276800;Taip;0;3;0;3
9739;Rasa;Smalsučiai;6773004268;Taip;9;1;0;10
9740;Rasa;Smalsučiai;1457384318;Taip;0;4;0;4
9741;Rasa;Smalsučiai;5325275053;Ne;5;3;0;8
9742;Rasa;Smalsučiai;2121070882;Taip;0;6;0;6
9743;Rasa;Smalsučiai;6704162447;Taip;0;3;0;3
9744;Rasa;Smalsučiai;4603188598;Taip;0;1;0;1
9745;Rasa;"Pelėdžiukai ";3387615841;Taip;7;8;0;15
9746;Rasa;"Pelėdžiukai ";8816116600;Taip;10;3;0;13
9747;Rasa;"Pelėdžiukai ";8455168346;Taip;10;0;0;10
9748;Rasa;"Pelėdžiukai ";9056416308;Taip;4;0;3;7
9749;Rasa;"Pelėdžiukai ";5141906920;Taip;0;8;0;8
9750;Rasa;"Pelėdžiukai ";3381468321;Taip;5;5;0;10
9751;Rasa;"Pelėdžiukai ";1261868339;Taip;0;0;7;7
9752;Rasa;"Pelėdžiukai ";6553479199;Taip;12;0;0;12
9753;Rasa;"Pelėdžiukai ";4947382314;Taip;7;0;1;8
9754;Rasa;"Pelėdžiukai ";2968464121;Taip;4;4;0;8
9755;Rasa;"Pelėdžiukai ";5816940902;Taip;6;0;1;7
9756;Rasa;"Pelėdžiukai ";4389917247;Taip;13;0;5;18
9757;Rasa;"Pelėdžiukai ";2123838514;Taip;15;0;0;15
9758;Rasa;"Pelėdžiukai ";1288177637;Taip;3;10;3;16
9759;Rasa;"Pelėdžiukai ";8403268732;Taip;5;3;1;9
9760;Rasa;Katinėliai;5885520521;Taip;0;1;0;1
9761;Rasa;Katinėliai;5426981046;Taip;5;3;0;8
9762;Rasa;Katinėliai;3657956842;Ne;7;0;0;7
9763;Rasa;Katinėliai;6891623055;Ne;16;0;0;16
9764;Rasa;Katinėliai;9010812748;Taip;0;4;0;4
9765;Rasa;Katinėliai;7220007488;Taip;0;3;0;3
9766;Rasa;Katinėliai;8235869241;Taip;0;5;1;6
9767;Rasa;Katinėliai;4913483444;Taip;0;3;1;4
9768;Rasa;Katinėliai;4734775151;Ne;0;6;0;6
9769;Rasa;Katinėliai;4758138905;Taip;8;2;0;10
9770;Rasa;Katinėliai;9447346901;Taip;3;3;0;6
9771;Rasa;Katinėliai;3631124501;Taip;14;0;0;14
9772;Rasa;Katinėliai;9343039995;Taip;3;5;0;8
9773;Rasa;Katinėliai;4084236196;Taip;0;4;0;4
9774;Rasa;Katinėliai;4498966097;Taip;0;5;1;6
9775;Rasa;Katinėliai;3428261829;Taip;0;4;0;4
9776;Rasa;Katinėliai;2477057223;Taip;6;3;0;9
9777;Rasa;Katinėliai;5134342817;Taip;7;1;0;8
9778;Rasa;Katinėliai;9220749889;Taip;0;4;0;4
9779;Rasa;Ančiukai;6755131948;Taip;0;5;0;5
9780;Rasa;Ančiukai;1477018184;Taip;12;0;1;13
9781;Rasa;Ančiukai;4018241056;Taip;14;0;0;14
9782;Rasa;Ančiukai;1736903037;Taip;11;3;0;14
9783;Rasa;Ančiukai;4762348187;Taip;0;1;0;1
9784;Rasa;Ančiukai;7568880413;Taip;9;3;0;12
9785;Rasa;Ančiukai;8622210603;Taip;4;3;3;10
9786;Rasa;Ančiukai;1521328997;Taip;0;0;2;2
9787;Rasa;Ančiukai;3884782148;Taip;14;1;0;15
9788;Rasa;Ančiukai;9230334839;Taip;0;0;1;1
9789;Rasa;Ančiukai;8574946856;Taip;0;3;0;3
9790;Rasa;Ančiukai;6442933249;Taip;0;5;0;5
9791;Rasa;Ančiukai;4979105526;Taip;0;1;1;2
9792;Rasa;"Vyturiukai ";7028605422;Taip;0;1;4;5
9793;Rasa;"Vyturiukai ";9599510902;Taip;0;3;1;4
9794;Rasa;"Vyturiukai ";2800420481;Taip;0;3;0;3
9795;Rasa;"Vyturiukai ";5869253167;Taip;9;0;3;12
9796;Rasa;"Vyturiukai ";7037958994;Taip;2;3;0;5
9797;Rasa;"Vyturiukai ";8236785255;Taip;1;5;5;11
9798;Rasa;"Vyturiukai ";6887471189;Taip;0;0;9;9
9799;Rasa;"Vyturiukai ";4694111253;Taip;0;3;2;5
9800;Rasa;"Vyturiukai ";2347639286;Taip;0;1;4;5
9801;Rasa;"Vyturiukai ";1206005039;Taip;7;3;0;10
9802;Rasa;"Vyturiukai ";9788282861;Taip;5;3;0;8
9803;Rasa;"Vyturiukai ";2711923397;Taip;4;0;3;7
9804;Rasa;"Vyturiukai ";2769096357;Taip;17;0;0;17
9805;Rasa;"Vyturiukai ";6883073764;Taip;3;3;2;8
9806;Rasa;"Vyturiukai ";9706428782;Ne;0;9;3;12
9807;Rasa;"Vyturiukai ";7043271718;Ne;0;0;6;6
9808;Rasa;"Vyturiukai ";6575864256;Taip;16;0;0;16
9809;Rasa;Voveriukai;4111850024;Taip;0;3;0;3
9810;Rasa;Voveriukai;2190948879;Taip;8;4;0;12
9811;Rasa;Voveriukai;1978999728;Ne;0;0;7;7
9812;Rasa;Voveriukai;3546684695;Taip;4;3;1;8
9813;Rasa;Voveriukai;4010262461;Taip;14;0;0;14
9814;Rasa;Voveriukai;5740754301;Taip;0;0;5;5
9815;Rasa;Voveriukai;5977524939;Taip;0;0;6;6
9816;Rasa;Voveriukai;1592174114;Taip;1;0;9;10
9817;Rasa;Voveriukai;1564194649;Taip;7;0;0;7
9818;Rasa;Voveriukai;1764959761;Taip;0;0;7;7
9819;Rasa;Voveriukai;1765617605;Taip;0;3;1;4
9820;Rasa;Voveriukai;1733179752;Taip;0;1;0;1
9821;Rasa;Voveriukai;2895124729;Taip;13;0;0;13
9822;Rasa;Voveriukai;8469342353;Taip;0;0;2;2
9823;Rasa;Voveriukai;1679709767;Taip;0;3;3;6
9824;Rasa;Voveriukai;5622110823;Taip;5;6;0;11
9825;Rasa;Voveriukai;6221754830;Taip;25;0;0;25
9826;Rasa;Voveriukai;7218250981;Taip;5;0;6;11
9827;Rasa;"DRUGELIAI ";6621628020;Taip;18;0;0;18
9828;Rasa;"DRUGELIAI ";9959160342;Taip;0;7;11;18
9829;Rasa;"DRUGELIAI ";5761013588;Taip;0;18;0;18
9830;Rasa;"DRUGELIAI ";7220103314;Taip;0;0;2;2
9831;Rasa;"DRUGELIAI ";5517138335;Taip;10;3;0;13
9832;Rasa;"DRUGELIAI ";9506388242;Taip;29;0;0;29
9833;Rasa;"DRUGELIAI ";4188303400;Taip;0;0;2;2
9834;Rasa;"DRUGELIAI ";5483943978;Taip;3;2;1;6
9835;Rasa;"DRUGELIAI ";7251815682;Taip;18;0;0;18
9836;Rasa;"DRUGELIAI ";8702962863;Taip;0;2;0;2
9837;Rasa;"DRUGELIAI ";4183378344;Taip;10;0;3;13
9838;Rasa;"DRUGELIAI ";6314411900;Taip;10;0;3;13
9839;Rasa;Zuikučiai;7265752821;Taip;0;0;7;7
9840;Rasa;Zuikučiai;2804115700;Taip;5;1;0;6
9841;Rasa;Zuikučiai;8841534992;Taip;0;1;0;1
9842;Rasa;Zuikučiai;8027532547;Taip;8;4;4;16
9843;Rasa;Zuikučiai;3470054190;Taip;4;0;2;6
9844;Rasa;Zuikučiai;8180141204;Taip;0;6;0;6
9845;Rasa;Zuikučiai;7253736220;Taip;9;4;0;13
9846;Rasa;Zuikučiai;4940758709;Taip;5;6;0;11
9847;Rasa;Zuikučiai;7091899236;Taip;7;5;0;12
9848;Rasa;Zuikučiai;6574998939;Taip;0;12;0;12
9849;Rasa;Zuikučiai;7556723960;Taip;13;0;10;23
9850;Rasa;Zuikučiai;4212798846;Taip;2;7;0;9
9851;Rasa;Zuikučiai;7585566403;Taip;0;1;1;2
9852;Rasa;Zuikučiai;6505001743;Taip;1;3;7;11
9853;Rasa;Zuikučiai;6780996150;Taip;2;1;2;5
9854;Rasa;Zuikučiai;8159411349;Taip;8;0;1;9
9855;Rasa;Širdelė;8424049317;Taip;0;2;3;5
9856;Rasa;Širdelė;8236464670;Taip;5;0;0;5
9857;Rasa;Širdelė;6976298054;Taip;0;1;0;1
9858;Rasa;Širdelė;3668598028;Taip;0;1;0;1
9859;Rasa;Širdelė;2333938367;Taip;0;1;0;1
9860;Rasa;Širdelė;5719253028;Taip;1;2;3;6
9861;Rasa;Širdelė;9140875020;Ne;0;3;0;3
9862;Rasa;Širdelė;4694382836;Taip;0;2;0;2
9863;Rasa;Širdelė;1796573723;Taip;0;1;0;1
9864;Rasa;Širdelė;3535655117;Taip;5;0;0;5
9865;Rasa;Širdelė;4361959446;Taip;0;1;0;1
9866;Rasa;Širdelė;3215464914;Taip;6;0;0;6
9867;Rasa;Širdelė;5523764310;Taip;6;0;0;6
9868;Rasa;Širdelė;6760723624;Taip;0;1;2;3
9869;Rasa;Širdelė;1447258806;Taip;8;0;0;8
9870;Rasa;Širdelė;1627996663;Taip;10;0;0;10
9871;Riešutėlis;Viščiukų;7666200219;Taip;0;18;0;18
9872;Riešutėlis;Viščiukų;7071757771;Taip;5;0;0;5
9873;Riešutėlis;Viščiukų;6626441225;Taip;5;3;2;10
9874;Riešutėlis;Viščiukų;5013456470;Taip;7;0;0;7
9875;Riešutėlis;Viščiukų;6906373822;Taip;18;0;0;18
9876;Riešutėlis;Viščiukų;4636191548;Taip;0;0;8;8
9877;Riešutėlis;Viščiukų;2734001106;Taip;10;0;0;10
9878;Riešutėlis;Viščiukų;2493171003;Taip;8;2;0;10
9879;Riešutėlis;Viščiukų;5133625078;Taip;5;7;1;13
9880;Riešutėlis;Viščiukų;2235912189;Taip;0;0;2;2
9881;Riešutėlis;Viščiukų;9864636983;Taip;12;2;1;15
9882;Riešutėlis;Viščiukų;4429903561;Taip;0;0;18;18
9883;Riešutėlis;Viščiukų;5317904812;Taip;11;0;3;14
9884;Riešutėlis;Viščiukų;8235524536;Taip;11;1;0;12
9885;Riešutėlis;Viščiukų;7795124495;Taip;0;0;18;18
9886;Riešutėlis;Viščiukų;2832538856;Taip;0;0;18;18
9887;Riešutėlis;Viščiukų;3730909181;Taip;14;0;1;15
9888;Riešutėlis;Viščiukų;4426750525;Taip;1;0;6;7
9889;Riešutėlis;"Riešutėliai ";3800733442;Taip;9;0;0;9
9890;Riešutėlis;"Riešutėliai ";2117939721;Taip;5;0;3;8
9891;Riešutėlis;"Riešutėliai ";1343776985;Taip;8;0;4;12
9892;Riešutėlis;"Riešutėliai ";5915019363;Taip;5;8;0;13
9893;Riešutėlis;"Riešutėliai ";2207907790;Taip;8;2;0;10
9894;Riešutėlis;"Riešutėliai ";9699503472;Taip;0;0;10;10
9895;Riešutėlis;"Riešutėliai ";2098369052;Taip;7;0;0;7
9896;Riešutėlis;"Riešutėliai ";1426700414;Taip;3;1;3;7
9897;Riešutėlis;"Riešutėliai ";8539906445;Taip;2;2;2;6
9898;Riešutėlis;"Riešutėliai ";5873443383;Taip;0;0;2;2
9899;Riešutėlis;"Riešutėliai ";2301247729;Taip;0;7;0;7
9900;Riešutėlis;"Riešutėliai ";3602707130;Taip;10;2;2;14
9901;Riešutėlis;"Riešutėliai ";8991963843;Taip;10;2;0;12
9902;Riešutėlis;"Riešutėliai ";9318640304;Taip;0;0;5;5
9903;Riešutėlis;"Riešutėliai ";4293402095;Taip;10;8;0;18
9904;Riešutėlis;"Riešutėliai ";8917451081;Taip;9;3;0;12
9905;Riešutėlis;"Riešutėliai ";4698338374;Taip;2;4;0;6
9906;Riešutėlis;"Riešutėliai ";3345064565;Taip;5;2;0;7
9907;Riešutėlis;"Riešutėliai ";2560507294;Taip;9;1;0;10
9908;Riešutėlis;"Riešutėliai ";9078282526;Taip;0;1;4;5
9909;Riešutėlis;"Riešutėliai ";6762306583;Taip;0;8;0;8
9910;Riešutėlis;Ežiukai;7030346495;Taip;10;6;0;16
9911;Riešutėlis;Ežiukai;9750713954;Taip;0;5;0;5
9912;Riešutėlis;Ežiukai;7601776182;Taip;0;2;0;2
9913;Riešutėlis;Ežiukai;7381623086;Taip;6;2;0;8
9914;Riešutėlis;Ežiukai;9964688413;Taip;3;0;4;7
9915;Riešutėlis;Ežiukai;1548585448;Taip;0;2;0;2
9916;Riešutėlis;Ežiukai;8954127616;Taip;0;1;9;10
9917;Riešutėlis;Ežiukai;2092933906;Taip;3;10;0;13
9918;Riešutėlis;Ežiukai;6813024366;Taip;5;3;1;9
9919;Riešutėlis;Ežiukai;7913381005;Taip;0;7;0;7
9920;Riešutėlis;Ežiukai;3460145784;Taip;0;4;0;4
9921;Riešutėlis;Ežiukai;8480059272;Taip;0;6;0;6
9922;Riešutėlis;Ežiukai;5728858361;Taip;1;2;4;7
9923;Riešutėlis;Ežiukai;5327627748;Taip;5;8;1;14
9924;Riešutėlis;Ežiukai;6259158270;Taip;0;0;1;1
9925;Riešutėlis;Ežiukai;6194259707;Taip;0;3;0;3
9926;Riešutėlis;Ežiukai;2837471235;Taip;5;8;0;13
9927;Riešutėlis;Ežiukai;2699984170;Taip;6;2;0;8
9928;Riešutėlis;Ežiukai;7050440691;Taip;7;1;0;8
9929;Riešutėlis;Ežiukai;8066712255;Ne;0;0;1;1
9930;Riešutėlis;Ežiukai;3577669231;Taip;0;5;0;5
9931;Riešutėlis;Ežiukai;9670912357;Taip;6;0;0;6
9932;Riešutėlis;Ežiukai;1818130297;Taip;0;3;0;3
9933;Riešutėlis;Ežiukai;6284614328;Taip;0;1;8;9
9934;Riešutėlis;Pelėdžiukai;3975540383;Taip;0;0;3;3
9935;Riešutėlis;Pelėdžiukai;1705599429;Taip;4;3;4;11
9936;Riešutėlis;Pelėdžiukai;4116506453;Taip;4;0;3;7
9937;Riešutėlis;Pelėdžiukai;2467739101;Taip;0;3;0;3
9938;Riešutėlis;Pelėdžiukai;2587460110;Taip;17;0;4;21
9939;Riešutėlis;Pelėdžiukai;6147780439;Taip;12;0;0;12
9940;Riešutėlis;Pelėdžiukai;3287685792;Taip;5;3;0;8
9941;Riešutėlis;Pelėdžiukai;1811701628;Taip;8;0;14;22
9942;Riešutėlis;Pelėdžiukai;5183264581;Taip;0;2;1;3
9943;Riešutėlis;Pelėdžiukai;4866613045;Taip;0;3;7;10
9944;Riešutėlis;Pelėdžiukai;6121386391;Taip;6;3;1;10
9945;Riešutėlis;Pelėdžiukai;4448024452;Taip;2;0;3;5
9946;Riešutėlis;Pelėdžiukai;3251066115;Taip;5;4;0;9
9947;Riešutėlis;Pelėdžiukai;4808684145;Taip;0;5;1;6
9948;Riešutėlis;Pelėdžiukai;4897581681;Taip;14;0;0;14
9949;Riešutėlis;Pelėdžiukai;7256075146;Taip;8;4;0;12
9950;Riešutėlis;Pelėdžiukai;5443448616;Taip;11;2;0;13
9951;Riešutėlis;Pelėdžiukai;9598824163;Taip;3;2;0;5
9952;Riešutėlis;Pelėdžiukai;8839482370;Taip;9;0;0;9
9953;Riešutėlis;Pelėdžiukai;4692384639;Ne;0;0;5;5
9954;Riešutėlis;Meškiukai;5537309549;Taip;0;3;0;3
9955;Riešutėlis;Meškiukai;1091941952;Taip;0;4;0;4
9956;Riešutėlis;Meškiukai;8271632629;Taip;4;3;0;7
9957;Riešutėlis;Meškiukai;4898775561;Taip;0;1;0;1
9958;Riešutėlis;Meškiukai;2097580659;Taip;0;3;1;4
9959;Riešutėlis;Meškiukai;7987368969;Taip;5;5;0;10
9960;Riešutėlis;Meškiukai;65873300738;Taip;0;5;0;5
9961;Riešutėlis;Meškiukai;26781529460;Taip;2;3;2;7
9962;Riešutėlis;Meškiukai;1936519033;Taip;0;5;1;6
9963;Riešutėlis;Meškiukai;4131218911;Taip;0;8;0;8
9964;Riešutėlis;Meškiukai;4276034784;Taip;0;2;0;2
9965;Riešutėlis;Meškiukai;5097410462;Taip;0;3;0;3
9966;Riešutėlis;Meškiukai;4344185375;Taip;0;4;0;4
9967;Riešutėlis;Meškiukai;6594928740;Ne;0;8;0;8
9968;Riešutėlis;Meškiukai;1623681835;Taip;3;5;0;8
9969;Riešutėlis;Meškiukai;2566084613;Taip;6;3;0;9
9970;Riešutėlis;Meškiukai;1640383686;Taip;0;3;0;3
9971;Riešutėlis;Meškiukai;8087180983;Taip;0;3;2;5
9972;Riešutėlis;Meškiukai;16561622902;Taip;0;5;3;8
9973;Riešutėlis;Meškiukai;2611705234;Taip;2;4;0;6
9974;Riešutėlis;Meškiukai;4404544549;Taip;0;18;0;18
9975;Riešutėlis;Meškiukai;1455509576;Taip;3;5;0;8
9976;Riešutėlis;Meškiukai;1709857621;Taip;0;4;1;5
9977;Riešutėlis;Kiškučiai;9297835044;Taip;8;0;0;8
9978;Riešutėlis;Kiškučiai;9086474785;Taip;7;0;0;7
9979;Riešutėlis;Kiškučiai;3363757821;Ne;10;3;0;13
9980;Riešutėlis;Kiškučiai;2581250615;Taip;0;1;3;4
9981;Riešutėlis;Kiškučiai;8445984114;Taip;13;3;2;18
9982;Riešutėlis;Kiškučiai;5266946070;Taip;0;0;7;7
9983;Riešutėlis;Kiškučiai;9357375649;Taip;10;3;0;13
9984;Riešutėlis;Kiškučiai;9548551553;Taip;7;0;0;7
9985;Riešutėlis;Kiškučiai;9500744921;Ne;0;2;2;4
9986;Riešutėlis;Kiškučiai;4851336076;Taip;0;8;0;8
9987;Riešutėlis;Kiškučiai;6705754238;Taip;0;12;2;14
9988;Riešutėlis;Kiškučiai;1111543507;Ne;0;4;0;4
9989;Riešutėlis;Kiškučiai;9964105252;Taip;8;2;0;10
9990;Riešutėlis;Kiškučiai;6693197006;Taip;3;0;1;4
9991;Riešutėlis;Kiškučiai;5846061115;Taip;0;1;0;1
9992;Riešutėlis;Kiškučiai;2618556733;Taip;6;6;0;12
9993;Riešutėlis;Kiškučiai;2674972275;Taip;12;0;0;12
9994;Riešutėlis;Kiškučiai;9995814717;Taip;4;0;2;6
9995;Riešutėlis;Voveriukų;5995176001;Taip;0;3;0;3
9996;Riešutėlis;Voveriukų;5598052531;Taip;4;3;0;7
9997;Riešutėlis;Voveriukų;8751571852;Taip;5;2;1;8
9998;Riešutėlis;Voveriukų;5282039544;Taip;0;3;0;3
9999;Riešutėlis;Voveriukų;6303767779;Taip;0;3;0;3
10000;Riešutėlis;Voveriukų;6405116059;Taip;13;0;0;13
10001;Riešutėlis;Voveriukų;2430518637;Taip;18;0;0;18
10002;Riešutėlis;Voveriukų;1457008581;Taip;0;5;0;5
10003;Riešutėlis;Voveriukų;1638021880;Taip;0;6;0;6
10004;Riešutėlis;Voveriukų;7225365172;Taip;11;1;0;12
10005;Riešutėlis;Voveriukų;8750531305;Taip;0;3;0;3
10006;Riešutėlis;Voveriukų;5479780116;Taip;0;4;0;4
10007;Riešutėlis;Voveriukų;9839084885;Taip;0;3;0;3
10008;Riešutėlis;Voveriukų;4451419273;Ne;7;9;0;16
10009;Riešutėlis;Voveriukų;8018914251;Taip;4;4;0;8
10010;Riešutėlis;Voveriukų;9040123535;Taip;0;3;0;3
10011;Riešutėlis;Voveriukų;6928558714;Taip;6;0;0;6
10012;Riešutėlis;Voveriukų;3970874098;Taip;0;3;0;3
10013;Riešutėlis;Voveriukų;8012201566;Taip;5;3;0;8
10014;Riešutėlis;Voveriukų;7198434243;Taip;0;3;0;3
10015;Riešutėlis;Voveriukų;4581184004;Taip;5;3;1;9
10016;Riešutėlis;Voveriukų;1941869661;Taip;0;3;0;3
10017;Riešutėlis;Voveriukų;9023304543;Taip;0;5;0;5
10018;Riešutėlis;Saulutės;4004669930;Taip;0;5;2;7
10019;Riešutėlis;Saulutės;7177632315;Taip;0;4;0;4
10020;Riešutėlis;Saulutės;6721758785;Taip;0;12;2;14
10021;Riešutėlis;Saulutės;3694146893;Taip;0;5;1;6
10022;Riešutėlis;Saulutės;1748151109;Taip;0;6;0;6
10023;Riešutėlis;Saulutės;8504832383;Taip;0;3;0;3
10024;Riešutėlis;Saulutės;6292679662;Taip;0;3;0;3
10025;Riešutėlis;Saulutės;8738716660;Taip;0;5;1;6
10026;Riešutėlis;Saulutės;4828635362;Taip;0;2;0;2
10027;Riešutėlis;Saulutės;6635909614;Taip;6;3;0;9
10028;Riešutėlis;Saulutės;1196740726;Taip;0;5;3;8
10029;Riešutėlis;Saulutės;8415858895;Taip;5;1;4;10
10030;Riešutėlis;Saulutės;4498718519;Taip;3;1;5;9
10031;Riešutėlis;Saulutės;5753609922;Taip;18;0;0;18
10032;Riešutėlis;Saulutės;1860995033;Taip;0;8;10;18
10033;Riešutėlis;Saulutės;5013754772;Taip;3;3;0;6
10034;Riešutėlis;Saulutės;6468871352;Taip;0;0;2;2
10035;Riešutėlis;Saulutės;7154361660;Taip;7;8;0;15
10036;Riešutėlis;Saulutės;8677172126;Taip;0;0;5;5
10037;Riešutėlis;Saulutės;2395391926;Taip;0;0;6;6
10038;Riešutėlis;Saulutės;2572642260;Taip;5;0;3;8
10039;Riešutėlis;Saulutės;3544780386;Taip;0;0;9;9
10040;Riešutėlis;"Boruželės ";4118652467;Taip;0;18;0;18
10041;Riešutėlis;"Boruželės ";5662911204;Taip;0;18;0;18
10042;Riešutėlis;"Boruželės ";7663823906;Taip;14;0;0;14
10043;Riešutėlis;"Boruželės ";5336618381;Taip;5;4;0;9
10044;Riešutėlis;"Boruželės ";7327578507;Taip;4;0;0;4
10045;Riešutėlis;"Boruželės ";6368610810;Taip;13;1;0;14
10046;Riešutėlis;"Boruželės ";7313602281;Taip;3;3;0;6
10047;Riešutėlis;"Boruželės ";9815988800;Taip;11;0;0;11
10048;Riešutėlis;"Boruželės ";9296178632;Taip;9;4;0;13
10049;Riešutėlis;"Boruželės ";6681930005;Taip;13;0;0;13
10050;Riešutėlis;"Boruželės ";2352984379;Taip;0;6;0;6
10051;Riešutėlis;"Boruželės ";3152100512;Taip;0;3;3;6
10052;Riešutėlis;"Boruželės ";2238641969;Taip;0;5;2;7
10053;Riešutėlis;"Boruželės ";6217500325;Taip;0;18;0;18
10054;Riešutėlis;"Boruželės ";1058206787;Taip;11;0;2;13
10055;Riešutėlis;"Boruželės ";9198289423;Taip;4;2;2;8
10056;Riešutėlis;"Boruželės ";1282121190;Taip;0;5;2;7
10057;Riešutėlis;"Boruželės ";7259198785;Ne;6;0;0;6
10058;Riešutėlis;"Boruželės ";2875416610;Taip;0;7;0;7
10059;Riešutėlis;"Bitutės ";8498902448;Taip;0;2;1;3
10060;Riešutėlis;"Bitutės ";2498093110;Taip;5;3;0;8
10061;Riešutėlis;"Bitutės ";2459494071;Taip;0;0;1;1
10062;Riešutėlis;"Bitutės ";3931422170;Taip;1;1;8;10
10063;Riešutėlis;"Bitutės ";8265627960;Taip;0;0;3;3
10064;Riešutėlis;"Bitutės ";4591910912;Taip;0;2;1;3
10065;Riešutėlis;"Bitutės ";9285782325;Taip;6;2;3;11
10066;Riešutėlis;"Bitutės ";7473054556;Taip;0;2;4;6
10067;Riešutėlis;"Bitutės ";8996456595;Taip;0;3;0;3
10068;Riešutėlis;"Bitutės ";3475897400;Taip;0;0;1;1
10069;Riešutėlis;"Bitutės ";3592271009;Taip;13;2;3;18
10070;Riešutėlis;"Bitutės ";6815804556;Taip;0;1;0;1
10071;Riešutėlis;"Bitutės ";1626888090;Taip;0;4;1;5
10072;Riešutėlis;"Bitutės ";3348517050;Taip;0;2;2;4
10073;Riešutėlis;"Bitutės ";4358354602;Taip;0;2;1;3
10074;Riešutėlis;Drugelių;8266735624;Taip;0;4;0;4
10075;Riešutėlis;Drugelių;4776231497;Taip;0;4;0;4
10076;Riešutėlis;Drugelių;8578903763;Taip;0;9;0;9
10077;Riešutėlis;Drugelių;7769079730;Taip;0;2;2;4
10078;Riešutėlis;Drugelių;5811657782;Taip;0;0;1;1
10079;Riešutėlis;Drugelių;4221375847;Taip;0;3;0;3
10080;Riešutėlis;Drugelių;1942944625;Taip;0;3;0;3
10081;Riešutėlis;Drugelių;8845709386;Taip;0;12;0;12
10082;Riešutėlis;Drugelių;8352146446;Taip;0;3;0;3
10083;Riešutėlis;Drugelių;8180618419;Taip;0;3;0;3
10084;Riešutėlis;Drugelių;5412882446;Taip;0;3;0;3
10085;Riešutėlis;Drugelių;8020533200;Taip;0;5;0;5
10086;Riešutėlis;Drugelių;1164273595;Taip;3;0;0;3
10087;Riešutėlis;Drugelių;8918753084;Taip;0;1;3;4
10088;Riešutėlis;Drugelių;3836374000;Taip;0;5;0;5
10089;Riešutėlis;Drugelių;8016820352;Taip;0;1;0;1
10090;Riešutėlis;Drugelių;3975091711;Taip;0;3;0;3
10091;Riešutėlis;Drugelių;3071643137;Taip;2;3;0;5
10092;Riešutėlis;Drugelių;2599147931;Taip;0;4;0;4
10093;Riešutėlis;Drugelių;3151689985;Taip;0;3;0;3
10094;Riešutėlis;Drugelių;4845447863;Taip;6;0;6;12
10095;Riešutėlis;Nykštukų;1858791074;Taip;12;0;0;12
10096;Riešutėlis;Nykštukų;1006119133;Taip;0;1;2;3
10097;Riešutėlis;Nykštukų;3759837057;Taip;0;12;6;18
10098;Riešutėlis;Nykštukų;4740516426;Taip;8;0;4;12
10099;Riešutėlis;Nykštukų;3150141050;Taip;0;3;1;4
10100;Riešutėlis;Nykštukų;6580050526;Taip;8;0;3;11
10101;Riešutėlis;Nykštukų;4810919435;Taip;0;1;5;6
10102;Riešutėlis;Nykštukų;2736824231;Taip;10;0;3;13
10103;Riešutėlis;Nykštukų;2378301886;Taip;17;1;0;18
10104;Riešutėlis;Nykštukų;2483793992;Taip;6;0;0;6
10105;Riešutėlis;Nykštukų;5262881964;Taip;7;0;3;10
10106;Riešutėlis;Nykštukų;4328166135;Taip;10;0;0;10
10107;Riešutėlis;Nykštukų;9052991215;Taip;0;8;5;13
10108;Riešutėlis;Nykštukų;6582898708;Taip;2;3;1;6
10109;Riešutėlis;Nykštukų;6318150385;Taip;0;0;4;4
10110;Riešutėlis;Nykštukų;4042719626;Ne;8;0;2;10
10111;Riešutėlis;Nykštukų;5078051087;Taip;0;3;0;3
10112;Riešutėlis;Nykštukų;3249196007;Taip;5;0;2;7
10113;Rytas;Geniukų;4435466932;Taip;10;0;0;10
10114;Rytas;Geniukų;4319176891;Taip;3;0;0;3
10115;Rytas;Svirpliukų;1481377422;Taip;19;0;0;19
10116;Rytas;Svirpliukų;4720782276;Taip;3;0;0;3
10117;Rytas;Boružėlių;9765188299;Taip;5;0;0;5
10118;Rytas;Drugelių;6901439310;Taip;11;0;0;11
10119;Rytas;Drugelių;16308059025;Taip;12;0;0;12
10120;Rytas;Ežiukų;5237693162;Taip;8;0;0;8
10121;Rytas;Žirniukų;1404583064;Taip;4;0;0;4
10122;Rytas;Skruzdeliukų;9989457634;Taip;6;0;0;6
10123;Rytas;Skruzdeliukų;1354041961;Taip;5;0;0;5
10124;Rytas;Pelėdžiukų;1103411068;Taip;7;0;0;7
10125;Rytas;Vyturėlių;1803237458;Taip;7;0;0;7
10126;Rytas;Voveriukų;5410353706;Taip;10;0;0;10
10127;Ramunėlė;SAULUTĖS;3852734401;Taip;0;3;0;3
10128;Ramunėlė;SAULUTĖS;1192743154;Taip;0;5;0;5
10129;Ramunėlė;SAULUTĖS;5714771643;Taip;0;5;0;5
10130;Ramunėlė;SAULUTĖS;1483391590;Taip;0;3;0;3
10131;Ramunėlė;SAULUTĖS;4209191105;Taip;0;3;0;3
10132;Ramunėlė;SAULUTĖS;9927068798;Taip;4;1;0;5
10133;Ramunėlė;SAULUTĖS;8929122197;Taip;0;1;0;1
10134;Ramunėlė;SAULUTĖS;7219400182;Taip;0;3;0;3
10135;Ramunėlė;SAULUTĖS;3779769727;Taip;0;6;0;6
10136;Ramunėlė;SAULUTĖS;5605444408;Taip;0;3;0;3
10137;Ramunėlė;SAULUTĖS;8912978935;Taip;3;3;0;6
10138;Ramunėlė;SAULUTĖS;1618282165;Taip;6;0;0;6
10139;Ramunėlė;SAULUTĖS;9533155706;Taip;1;2;0;3
10140;Ramunėlė;SAULUTĖS;6595858698;Taip;0;2;0;2
10141;Ramunėlė;SAULUTĖS;3109623760;Taip;15;0;0;15
10142;Ramunėlė;ŽIBUTĖ;4715809064;Taip;0;5;0;5
10143;Ramunėlė;ŽIBUTĖ;5315953299;Taip;0;5;0;5
10144;Ramunėlė;ŽIBUTĖ;2173425836;Taip;0;2;0;2
10145;Ramunėlė;ŽIBUTĖ;2686455030;Taip;0;2;0;2
10146;Ramunėlė;ŽIBUTĖ;5650659504;Taip;0;11;0;11
10147;Ramunėlė;ŽIBUTĖ;6627399830;Taip;5;2;4;11
10148;Ramunėlė;ŽIBUTĖ;8726443989;Taip;0;7;0;7
10149;Ramunėlė;ŽIBUTĖ;5801760033;Taip;4;3;0;7
10150;Ramunėlė;ŽIBUTĖ;6389008823;Taip;0;7;0;7
10151;Ramunėlė;ŽIBUTĖ;9136437288;Taip;0;1;0;1
10152;Ramunėlė;ŽIBUTĖ;6040461460;Taip;5;5;0;10
10153;Ramunėlė;ŽIBUTĖ;2605941371;Taip;6;2;0;8
10154;Ramunėlė;ŽIBUTĖ;7010828978;Taip;6;0;0;6
10155;Ramunėlė;ŽIBUTĖ;3879563193;Taip;10;4;0;14
10156;Ramunėlė;ŽIBUTĖ;2591052434;Taip;0;2;0;2
10157;Ramunėlė;ŽIBUTĖ;2446375037;Taip;5;6;0;11
10158;Ramunėlė;ŽIBUTĖ;1671759939;Taip;14;0;0;14
10159;Ramunėlė;ŽIBUTĖ;6606802660;Taip;0;3;0;3
10160;Ramunėlė;ŽIBUTĖ;5304803880;Taip;0;2;0;2
10161;Ramunėlė;ŽIBUTĖ;3525444906;Taip;0;10;0;10
10162;Ramunėlė;ŽIBUTĖ;8055844166;Taip;0;9;0;9
10163;Ramunėlė;ŽIRNIUKAI;8942483792;Taip;10;0;5;15
10164;Ramunėlė;ŽIRNIUKAI;9994445948;Taip;0;2;1;3
10165;Ramunėlė;ŽIRNIUKAI;6674467484;Taip;0;15;0;15
10166;Ramunėlė;ŽIRNIUKAI;7593855877;Taip;13;1;0;14
10167;Ramunėlė;ŽIRNIUKAI;2177200537;Taip;8;2;0;10
10168;Ramunėlė;ŽIRNIUKAI;7026935746;Taip;0;0;1;1
10169;Ramunėlė;ŽIRNIUKAI;5581693652;Ne;3;5;1;9
10170;Ramunėlė;ŽIRNIUKAI;4269170508;Taip;14;0;0;14
10171;Ramunėlė;ŽIRNIUKAI;7263195574;Taip;0;0;9;9
10172;Ramunėlė;ŽIRNIUKAI;4076525701;Taip;0;0;4;4
10173;Ramunėlė;ŽIRNIUKAI;4139935502;Taip;5;0;4;9
10174;Ramunėlė;ŽIRNIUKAI;1833069020;Taip;11;1;6;18
10175;Ramunėlė;ŽIRNIUKAI;4875011312;Taip;10;0;2;12
10176;Ramunėlė;ŽIRNIUKAI;4084046207;Taip;18;0;0;18
10177;Ramunėlė;ŽIRNIUKAI;2276657044;Taip;0;0;4;4
10178;Ramunėlė;ŽIRNIUKAI;5017020616;Taip;0;5;0;5
10179;Ramunėlė;ŽIRNIUKAI;6458458913;Taip;0;5;0;5
10180;Ramunėlė;ŽIRNIUKAI;6225605784;Taip;5;2;7;14
10181;Ramunėlė;ŽIRNIUKAI;4805808663;Ne;3;0;8;11
10182;Ramunėlė;BITUTĖS;8098492540;Taip;0;8;0;8
10183;Ramunėlė;BITUTĖS;6329943991;Taip;0;12;0;12
10184;Ramunėlė;BITUTĖS;7307307882;Taip;8;9;0;17
10185;Ramunėlė;BITUTĖS;2225787182;Taip;0;4;0;4
10186;Ramunėlė;BITUTĖS;6166192468;Taip;0;10;0;10
10187;Ramunėlė;BITUTĖS;5865482869;Taip;0;16;0;16
10188;Ramunėlė;BITUTĖS;8940763540;Taip;0;11;0;11
10189;Ramunėlė;BITUTĖS;6843262303;Taip;0;0;3;3
10190;Ramunėlė;BITUTĖS;7692958269;Taip;0;0;5;5
10191;Ramunėlė;BITUTĖS;8086994543;Taip;0;2;0;2
10192;Ramunėlė;BITUTĖS;5822045625;Taip;0;3;0;3
10193;Ramunėlė;BITUTĖS;9789690425;Taip;0;10;0;10
10194;Ramunėlė;BITUTĖS;1182350830;Taip;5;5;0;10
10195;Ramunėlė;BITUTĖS;6342801407;Taip;8;0;1;9
10196;Ramunėlė;BITUTĖS;4022818032;Taip;7;3;0;10
10197;Ramunėlė;BITUTĖS;7220407572;Taip;0;7;0;7
10198;Ramunėlė;BITUTĖS;1916520056;Taip;0;9;0;9
10199;Ramunėlė;BITUTĖS;2245564567;Taip;0;2;1;3
10200;Ramunėlė;BITUTĖS;6870110390;Taip;0;2;1;3
10201;Ramunėlė;BITUTĖS;6892481929;Taip;0;9;0;9
10202;Ramunėlė;BITUTĖS;2558296296;Taip;13;0;0;13
10203;Ramunėlė;BITUTĖS;6881228078;Taip;0;4;0;4
10204;Ramunėlė;DRUGELIAI;9584620339;Taip;0;3;0;3
10205;Ramunėlė;DRUGELIAI;6930505887;Taip;0;4;0;4
10206;Ramunėlė;DRUGELIAI;8402889872;Taip;0;5;0;5
10207;Ramunėlė;DRUGELIAI;7228065409;Taip;0;6;0;6
10208;Ramunėlė;DRUGELIAI;5170325023;Taip;2;5;0;7
10209;Ramunėlė;DRUGELIAI;3617897977;Taip;0;1;0;1
10210;Ramunėlė;DRUGELIAI;8768539595;Taip;0;7;0;7
10211;Ramunėlė;DRUGELIAI;1078618047;Taip;17;0;0;17
10212;Ramunėlė;DRUGELIAI;9984243153;Taip;0;4;0;4
10213;Ramunėlė;DRUGELIAI;1199673371;Taip;0;1;0;1
10214;Ramunėlė;DRUGELIAI;4392309015;Taip;0;0;3;3
10215;Ramunėlė;DRUGELIAI;5049415445;Taip;6;0;2;8
10216;Ramunėlė;DRUGELIAI;8460527225;Taip;0;5;0;5
10217;Ramunėlė;DRUGELIAI;8205893352;Taip;0;4;0;4
10218;Ramunėlė;DRUGELIAI;6809164145;Taip;4;3;0;7
10219;Ramunėlė;DRUGELIAI;6837877393;Ne;2;5;0;7
10220;Ramunėlė;NEUŽMIRŠTUOLĖS;1797997937;Taip;0;3;0;3
10221;Ramunėlė;NEUŽMIRŠTUOLĖS;9326288662;Taip;0;2;0;2
10222;Ramunėlė;NEUŽMIRŠTUOLĖS;9928703066;Taip;0;3;0;3
10223;Ramunėlė;NEUŽMIRŠTUOLĖS;4756689520;Taip;3;2;1;6
10224;Ramunėlė;NEUŽMIRŠTUOLĖS;2070729684;Taip;6;3;0;9
10225;Ramunėlė;NEUŽMIRŠTUOLĖS;4329292281;Taip;0;2;6;8
10226;Ramunėlė;NEUŽMIRŠTUOLĖS;6613469006;Taip;6;10;0;16
10227;Ramunėlė;NEUŽMIRŠTUOLĖS;3742982547;Taip;0;3;0;3
10228;Ramunėlė;NEUŽMIRŠTUOLĖS;3106987206;Taip;0;0;1;1
10229;Ramunėlė;NEUŽMIRŠTUOLĖS;2281370785;Taip;0;0;2;2
10230;Ramunėlė;NEUŽMIRŠTUOLĖS;8643188779;Taip;18;0;0;18
10231;Ramunėlė;NEUŽMIRŠTUOLĖS;9012749913;Taip;6;3;0;9
10232;Ramunėlė;NEUŽMIRŠTUOLĖS;1728034615;Taip;3;4;0;7
10233;Ramunėlė;NEUŽMIRŠTUOLĖS;1579527330;Taip;0;15;0;15
10234;Ramunėlė;NEUŽMIRŠTUOLĖS;7519551613;Taip;0;5;0;5
10235;Ramunėlė;NEUŽMIRŠTUOLĖS;2880352109;Taip;19;0;0;19
10236;Ramunėlė;NEUŽMIRŠTUOLĖS;3949246652;Taip;15;0;0;15
10237;Ramunėlė;NEUŽMIRŠTUOLĖS;3045477012;Taip;0;6;0;6
10238;Ramunėlė;NEUŽMIRŠTUOLĖS;5267145991;Ne;0;8;0;8
10239;Ramunėlė;NEUŽMIRŠTUOLĖS;1181787182;Taip;12;0;0;12
10240;Ramunėlė;OBUOLIUKAI;7364976547;Taip;0;2;2;4
10241;Ramunėlė;OBUOLIUKAI;6156792400;Taip;0;8;0;8
10242;Ramunėlė;OBUOLIUKAI;4233978236;Taip;8;6;0;14
10243;Ramunėlė;OBUOLIUKAI;2983986428;Taip;0;14;0;14
10244;Ramunėlė;OBUOLIUKAI;5548358138;Taip;0;2;0;2
10245;Ramunėlė;OBUOLIUKAI;2427399083;Ne;10;3;0;13
10246;Ramunėlė;OBUOLIUKAI;2422656007;Taip;0;3;3;6
10247;Ramunėlė;OBUOLIUKAI;7829765488;Taip;0;2;0;2
10248;Ramunėlė;OBUOLIUKAI;8623311748;Taip;5;0;2;7
10249;Ramunėlė;OBUOLIUKAI;6849205606;Taip;6;0;4;10
10250;Ramunėlė;OBUOLIUKAI;6604244856;Taip;0;3;5;8
10251;Ramunėlė;OBUOLIUKAI;8617271247;Taip;0;7;0;7
10252;Ramunėlė;OBUOLIUKAI;6413888803;Taip;0;5;0;5
10253;Ramunėlė;OBUOLIUKAI;5610672420;Ne;6;2;2;10
10254;Ramunėlė;OBUOLIUKAI;4400154355;Taip;4;0;3;7
10255;Ramunėlė;OBUOLIUKAI;7250951221;Taip;0;4;0;4
10256;Ramunėlė;OBUOLIUKAI;3802924434;Taip;1;5;0;6
10257;Ramunėlė;OBUOLIUKAI;6981729247;Ne;2;5;0;7
10258;Ramunėlė;SAULĖGRĄŽA;7836959157;Taip;0;0;5;5
10259;Ramunėlė;SAULĖGRĄŽA;2458101652;Taip;0;0;3;3
10260;Ramunėlė;SAULĖGRĄŽA;9663304288;Taip;0;0;8;8
10261;Ramunėlė;SAULĖGRĄŽA;5398069413;Taip;0;0;4;4
10262;Ramunėlė;SAULĖGRĄŽA;7873462803;Taip;0;0;3;3
10263;Ramunėlė;SAULĖGRĄŽA;3793779715;Taip;0;0;3;3
10264;Ramunėlė;SAULĖGRĄŽA;6775947111;Taip;0;0;2;2
10265;Ramunėlė;SAULĖGRĄŽA;1102946363;Taip;0;0;4;4
10266;Ramunėlė;SAULĖGRĄŽA;3603956795;Taip;0;4;0;4
10267;Ramunėlė;SAULĖGRĄŽA;4902056654;Taip;0;4;0;4
10268;Ramunėlė;SAULĖGRĄŽA;7563892184;Taip;0;4;0;4
10269;Ramunėlė;SAULĖGRĄŽA;3801952385;Taip;0;3;0;3
10270;Ramunėlė;SAULĖGRĄŽA;4376812983;Taip;0;0;2;2
10271;Ramunėlė;SAULĖGRĄŽA;9120142666;Taip;1;0;5;6
10272;Ramunėlė;SAULĖGRĄŽA;6942789511;Taip;0;5;3;8
10273;Ramunėlė;SAULĖGRĄŽA;6226329879;Taip;0;16;0;16
10274;Ramunėlė;SAULĖGRĄŽA;2415377154;Taip;0;5;3;8
10275;Ramunėlė;BORUŽĖLĖS;7825538259;Taip;0;5;0;5
10276;Ramunėlė;BORUŽĖLĖS;8496322672;Taip;0;4;5;9
10277;Ramunėlė;BORUŽĖLĖS;6695672297;Taip;0;2;0;2
10278;Ramunėlė;BORUŽĖLĖS;7295041630;Taip;0;11;0;11
10279;Ramunėlė;BORUŽĖLĖS;58028743912;Taip;5;4;0;9
10280;Ramunėlė;BORUŽĖLĖS;7750405604;Taip;0;3;0;3
10281;Ramunėlė;BORUŽĖLĖS;1216101539;Taip;0;5;0;5
10282;Ramunėlė;BORUŽĖLĖS;2499280049;Taip;0;3;0;3
10283;Ramunėlė;BORUŽĖLĖS;4677819736;Taip;0;3;1;4
10284;Ramunėlė;BORUŽĖLĖS;4349250416;Taip;0;6;0;6
10285;Ramunėlė;BORUŽĖLĖS;1303053333;Taip;7;0;0;7
10286;Ramunėlė;BORUŽĖLĖS;3554787356;Taip;0;3;0;3
10287;Ramunėlė;BORUŽĖLĖS;6310921755;Taip;0;3;0;3
10288;Ramunėlė;BORUŽĖLĖS;3685786758;Taip;0;5;0;5
10289;Ramunėlė;BORUŽĖLĖS;3566074517;Taip;0;3;3;6
10290;Ramunėlė;BORUŽĖLĖS;6837072361;Taip;0;6;0;6
10291;Ramunėlė;BORUŽĖLĖS;1534723406;Taip;3;4;1;8
10292;Ramunėlė;BORUŽĖLĖS;8323020864;Taip;0;3;0;3
10293;Ramunėlė;BORUŽĖLĖS;10704826206;Taip;5;4;0;9
10294;Ramunėlė;BORUŽĖLĖS;3065727741;Taip;8;0;0;8
10295;Ramunėlė;BORUŽĖLĖS;9924675250;Taip;0;4;0;4
10296;Ramunėlė;BORUŽĖLĖS;6251432968;Taip;0;5;0;5
10297;Ramunėlė;NYKŠTUKAS;3166386231;Taip;2;3;0;5
10298;Ramunėlė;NYKŠTUKAS;8045080504;Taip;2;2;0;4
10299;Ramunėlė;NYKŠTUKAS;7955197522;Taip;0;2;0;2
10300;Ramunėlė;NYKŠTUKAS;6983139076;Taip;0;0;1;1
10301;Ramunėlė;NYKŠTUKAS;7639613472;Taip;0;14;0;14
10302;Ramunėlė;NYKŠTUKAS;4642590173;Taip;6;1;0;7
10303;Ramunėlė;NYKŠTUKAS;9549605315;Taip;3;0;0;3
10304;Ramunėlė;NYKŠTUKAS;4491147309;Taip;12;0;0;12
10305;Ramunėlė;NYKŠTUKAS;4040520907;Taip;0;8;0;8
10306;Ramunėlė;NYKŠTUKAS;7542328641;Taip;5;1;0;6
10307;Ramunėlė;NYKŠTUKAS;1277413234;Taip;2;4;0;6
10308;Ramunėlė;NYKŠTUKAS;1215510902;Taip;10;1;0;11
10309;Ramunėlė;NYKŠTUKAS;8218201930;Taip;0;2;0;2
10310;Ramunėlė;NYKŠTUKAS;2760710235;Taip;0;3;0;3
10311;Ramunėlė;NYKŠTUKAS;5573083546;Taip;15;0;0;15
10312;Ramunėlė;UOGELĖ;6294697776;Taip;0;8;0;8
10313;Ramunėlė;UOGELĖ;7005354909;Taip;0;7;0;7
10314;Ramunėlė;UOGELĖ;5665429647;Taip;0;2;6;8
10315;Ramunėlė;UOGELĖ;4946797276;Taip;0;3;0;3
10316;Ramunėlė;UOGELĖ;9180197156;Taip;0;5;2;7
10317;Ramunėlė;UOGELĖ;5108864184;Taip;0;5;2;7
10318;Ramunėlė;UOGELĖ;4321527067;Taip;10;5;0;15
10319;Ramunėlė;UOGELĖ;2202879286;Taip;6;2;0;8
10320;Ramunėlė;UOGELĖ;7896711579;Taip;8;1;0;9
10321;Ramunėlė;UOGELĖ;5726947811;Taip;0;4;0;4
10322;Ramunėlė;UOGELĖ;4171905362;Taip;0;5;0;5
10323;Ramunėlė;UOGELĖ;1729152997;Taip;13;0;1;14
10324;Ramunėlė;UOGELĖ;8764042799;Taip;1;3;0;4
10325;Ramunėlė;UOGELĖ;7926168752;Taip;8;0;0;8
10326;Ramunėlė;UOGELĖ;5498856861;Taip;12;0;0;12
10327;Ramunėlė;UOGELĖ;3024065664;Taip;0;10;0;10
10328;Ramunėlė;UOGELĖ;1666033483;Taip;6;2;0;8
10329;Ramunėlė;UOGELĖ;9994601365;Taip;12;0;2;14
10330;Ramunėlė;UOGELĖ;2620747378;Taip;6;0;1;7
10331;Ramunėlė;VARPELIAI;1159457001;Taip;5;3;0;8
10332;Ramunėlė;VARPELIAI;6606966969;Taip;10;0;1;11
10333;Ramunėlė;VARPELIAI;9292235402;Taip;5;0;1;6
10334;Ramunėlė;VARPELIAI;1811931985;Taip;0;6;0;6
10335;Ramunėlė;VARPELIAI;1818513881;Taip;0;3;0;3
10336;Ramunėlė;VARPELIAI;4581826404;Taip;0;0;4;4
10337;Ramunėlė;VARPELIAI;8310875815;Taip;0;5;0;5
10338;Ramunėlė;VARPELIAI;1491688322;Taip;5;5;1;11
10339;Ramunėlė;VARPELIAI;5703289545;Taip;0;0;4;4
10340;Ramunėlė;VARPELIAI;9934852622;Taip;0;7;0;7
10341;Ramunėlė;VARPELIAI;4968998913;Taip;0;3;2;5
10342;Ramunėlė;VARPELIAI;3996453947;Taip;0;5;0;5
10343;Ramunėlė;VARPELIAI;3461269451;Taip;0;6;0;6
10344;Ramunėlė;VARPELIAI;3474578046;Taip;4;5;0;9
10345;Ramunėlė;VARPELIAI;7544671346;Taip;2;5;0;7
10346;Ramunėlė;VARPELIAI;5544992493;Taip;5;2;0;7
10347;Ramunėlė;VARPELIAI;6433856416;Taip;0;5;0;5
10348;Ramunėlė;VARPELIAI;3542912372;Taip;16;2;0;18
10349;Ramunėlė;VARPELIAI;3735308599;Taip;2;4;0;6
10350;Ramunėlė;VARPELIAI;3272747656;Taip;4;2;1;7
10351;Ramunėlė;VARPELIAI;6347893013;Taip;7;1;0;8
10352;Rūta;SMALSUČIAI;7649756034;Taip;0;0;1;1
10353;Rūta;SMALSUČIAI;5899860543;Taip;0;14;0;14
10354;Rūta;SMALSUČIAI;1346124133;Taip;0;0;1;1
10355;Rūta;SMALSUČIAI;4728904136;Taip;0;4;0;4
10356;Rūta;SMALSUČIAI;9791861646;Taip;8;2;1;11
10357;Rūta;SMALSUČIAI;2928803089;Taip;0;3;0;3
10358;Rūta;SMALSUČIAI;8378318357;Taip;0;4;0;4
10359;Rūta;SMALSUČIAI;1951202550;Taip;0;0;3;3
10360;Rūta;SMALSUČIAI;3875136625;Taip;0;4;0;4
10361;Rūta;SMALSUČIAI;9603105651;Taip;0;0;6;6
10362;Rūta;SMALSUČIAI;9911151238;Taip;0;5;2;7
10363;Rūta;SMALSUČIAI;3843325181;Ne;0;0;4;4
10364;Rūta;SMALSUČIAI;6316768460;Taip;0;0;9;9
10365;Rūta;SMALSUČIAI;8182243701;Taip;0;4;3;7
10366;Rūta;SMALSUČIAI;9386595365;Taip;0;0;2;2
10367;Rūta;SMALSUČIAI;7680605199;Taip;10;5;0;15
10368;Rūta;SMALSUČIAI;6075632046;Taip;0;3;1;4
10369;Rūta;SMALSUČIAI;1035527190;Taip;0;0;6;6
10370;Rūta;KŪLVERSTUKAI;4423305209;Taip;0;6;0;6
10371;Rūta;KŪLVERSTUKAI;9736567509;Taip;0;3;0;3
10372;Rūta;KŪLVERSTUKAI;7222494215;Taip;0;4;0;4
10373;Rūta;KŪLVERSTUKAI;7519931138;Taip;8;3;0;11
10374;Rūta;KŪLVERSTUKAI;4880804625;Taip;0;0;3;3
10375;Rūta;KŪLVERSTUKAI;3055345528;Taip;0;0;3;3
10376;Rūta;KŪLVERSTUKAI;3499727608;Taip;0;4;0;4
10377;Rūta;KŪLVERSTUKAI;9765301038;Taip;0;4;0;4
10378;Rūta;KŪLVERSTUKAI;9638495757;Taip;8;0;0;8
10379;Rūta;KŪLVERSTUKAI;1962172243;Taip;5;3;0;8
10380;Rūta;KŪLVERSTUKAI;8605070655;Taip;0;3;1;4
10381;Rūta;KŪLVERSTUKAI;7553844890;Taip;0;10;0;10
10382;Rūta;KŪLVERSTUKAI;3964922552;Taip;9;4;0;13
10383;Rūta;KŪLVERSTUKAI;9400586178;Taip;0;3;5;8
10384;Rūta;KŪLVERSTUKAI;3956912957;Taip;0;4;0;4
10385;Rūta;KŪLVERSTUKAI;2890569107;Taip;0;3;5;8
10386;Rūta;KŪLVERSTUKAI;2474991135;Taip;0;5;2;7
10387;Rūta;KŪLVERSTUKAI;1216786487;Taip;0;5;0;5
10388;Rūta;KŪLVERSTUKAI;9245618776;Taip;10;5;0;15
10389;Rūta;KŪLVERSTUKAI;5109138407;Taip;0;3;0;3
10390;Rūta;KŪLVERSTUKAI;6096664609;Ne;0;3;1;4
10391;Rūta;KODĖLČIUKAI;5962981130;Taip;0;0;5;5
10392;Rūta;KODĖLČIUKAI;3736279705;Taip;5;0;3;8
10393;Rūta;KODĖLČIUKAI;8416455711;Taip;0;0;1;1
10394;Rūta;KODĖLČIUKAI;8668510009;Taip;0;3;0;3
10395;Rūta;KODĖLČIUKAI;2547849837;Taip;6;0;3;9
10396;Rūta;KODĖLČIUKAI;9501101073;Taip;3;0;1;4
10397;Rūta;KODĖLČIUKAI;8883578144;Taip;0;0;2;2
10398;Rūta;KODĖLČIUKAI;4546082355;Taip;0;5;0;5
10399;Rūta;KODĖLČIUKAI;1000645885;Taip;0;5;0;5
10400;Rūta;KODĖLČIUKAI;5766392854;Taip;0;6;0;6
10401;Rūta;KODĖLČIUKAI;4944413811;Taip;0;0;1;1
10402;Rūta;KODĖLČIUKAI;9916296056;Taip;0;0;5;5
10403;Rūta;KODĖLČIUKAI;4656138649;Taip;0;0;3;3
10404;Rūta;KODĖLČIUKAI;1605412505;Taip;8;0;3;11
10405;Rūta;BORUŽĖLĖS;7712500278;Ne;0;3;6;9
10406;Rūta;BORUŽĖLĖS;3898579878;Taip;6;0;3;9
10407;Rūta;BORUŽĖLĖS;8945868791;Taip;0;0;6;6
10408;Rūta;BORUŽĖLĖS;8023404173;Taip;0;0;5;5
10409;Rūta;BORUŽĖLĖS;3348066709;Taip;3;0;7;10
10410;Rūta;BORUŽĖLĖS;4279367893;Taip;6;0;3;9
10411;Rūta;BORUŽĖLĖS;5141290453;Taip;10;5;0;15
10412;Rūta;BORUŽĖLĖS;7006165453;Taip;13;3;0;16
10413;Rūta;BORUŽĖLĖS;6587625933;Taip;0;1;0;1
10414;Rūta;BORUŽĖLĖS;8303314520;Taip;0;14;0;14
10415;Rūta;BORUŽĖLĖS;3470052541;Taip;12;3;2;17
10416;Rūta;BORUŽĖLĖS;2625691851;Taip;0;0;6;6
10417;Rūta;BORUŽĖLĖS;1804222979;Taip;0;0;3;3
10418;Rūta;BORUŽĖLĖS;5624054621;Taip;6;0;3;9
10419;Rūta;VYTURĖLIAI;1967141665;Taip;0;3;2;5
10420;Rūta;VYTURĖLIAI;3873876608;Taip;0;4;0;4
10421;Rūta;VYTURĖLIAI;8851591109;Ne;0;3;0;3
10422;Rūta;VYTURĖLIAI;1180144866;Taip;0;3;0;3
10423;Rūta;VYTURĖLIAI;3478456813;Taip;0;3;0;3
10424;Rūta;VYTURĖLIAI;1276704331;Taip;0;2;4;6
10425;Rūta;VYTURĖLIAI;6207902435;Taip;2;3;0;5
10426;Rūta;VYTURĖLIAI;8889388348;Taip;0;3;1;4
10427;Rūta;VYTURĖLIAI;1346367896;Taip;0;1;0;1
10428;Rūta;VYTURĖLIAI;4363571135;Taip;5;5;0;10
10429;Rūta;VYTURĖLIAI;6006094035;Taip;4;1;0;5
10430;Rūta;VYTURĖLIAI;1521231573;Taip;0;3;2;5
10431;Rūta;VYTURĖLIAI;7552644990;Ne;0;3;5;8
10432;Rūta;VYTURĖLIAI;1092908255;Taip;0;4;0;4
10433;Rūta;VYTURĖLIAI;8673942478;Taip;0;4;0;4
10434;Rūta;VYTURĖLIAI;4754142240;Taip;5;4;0;9
10435;Rūta;VYTURĖLIAI;6136733410;Taip;0;2;1;3
10436;Rūta;VYTURĖLIAI;1565896222;Taip;3;4;0;7
10437;Rūta;VYTURĖLIAI;8704594038;Taip;0;3;0;3
10438;Rūta;VYTURĖLIAI;7631229177;Taip;5;1;1;7
10439;Rūta;"PABIRUČIAI (LOGOPEDINĖ)";6221528830;Taip;18;0;0;18
10440;Rūta;"PABIRUČIAI (LOGOPEDINĖ)";4911219947;Taip;0;0;1;1
10441;Rūta;"PABIRUČIAI (LOGOPEDINĖ)";8763382361;Taip;0;3;15;18
10442;Rūta;"PABIRUČIAI (LOGOPEDINĖ)";9171781646;Taip;0;5;0;5
10443;Rūta;"PABIRUČIAI (LOGOPEDINĖ)";5871960113;Taip;0;3;2;5
10444;Rūta;"PABIRUČIAI (LOGOPEDINĖ)";5211104903;Taip;0;2;0;2
10445;Rūta;"PABIRUČIAI (LOGOPEDINĖ)";1029871210;Taip;0;0;1;1
10446;Rūta;"PABIRUČIAI (LOGOPEDINĖ)";6572172779;Taip;0;0;1;1
10447;Rūta;"PABIRUČIAI (LOGOPEDINĖ)";3814794448;Taip;0;0;3;3
10448;Rūta;GUDRUČIAI;4044349935;Taip;0;0;3;3
10449;Rūta;GUDRUČIAI;3998791775;Taip;11;0;0;11
10450;Rūta;GUDRUČIAI;3043164521;Taip;0;5;0;5
10451;Rūta;GUDRUČIAI;3462986405;Taip;6;1;3;10
10452;Rūta;GUDRUČIAI;8548089843;Taip;0;4;1;5
10453;Rūta;GUDRUČIAI;4293920701;Taip;0;3;0;3
10454;Rūta;GUDRUČIAI;4473591998;Taip;0;6;0;6
10455;Rūta;GUDRUČIAI;9419809946;Taip;0;3;0;3
10456;Rūta;GUDRUČIAI;9589117921;Taip;0;10;0;10
10457;Rūta;GUDRUČIAI;3044976169;Taip;0;2;3;5
10458;Rūta;GUDRUČIAI;2546023973;Taip;2;2;3;7
10459;Rūta;GUDRUČIAI;8273644943;Taip;0;5;0;5
10460;Rūta;GUDRUČIAI;8963959004;Taip;0;7;0;7
10461;Rūta;GUDRUČIAI;3454881685;Taip;0;3;0;3
10462;Rūta;GUDRUČIAI;1811055786;Taip;0;5;0;5
10463;Rūta;GUDRUČIAI;1510268514;Taip;5;3;0;8
10464;Rūta;GUDRUČIAI;6814051598;Taip;4;3;0;7
10465;Rūta;GUDRUČIAI;2702537976;Taip;5;4;0;9
10466;Rūta;GUDRUČIAI;2772130413;Taip;0;6;0;6
10467;Rūta;GUDRUČIAI;1623968580;Taip;0;0;1;1
10468;Rūta;GUDRUČIAI;8592528906;Taip;4;0;2;6
10469;Rūta;GUDRUČIAI;1182222976;Taip;0;3;11;14
10470;Rūta;SEKLYTĖLĖ;4823677957;Taip;0;3;0;3
10471;Rūta;SEKLYTĖLĖ;1301573542;Taip;9;0;0;9
10472;Rūta;SEKLYTĖLĖ;5009619812;Taip;0;3;0;3
10473;Rūta;SEKLYTĖLĖ;3567273206;Taip;0;8;0;8
10474;Rūta;SEKLYTĖLĖ;1671913833;Taip;0;3;0;3
10475;Rūta;SEKLYTĖLĖ;1186493111;Taip;0;9;0;9
10476;Rūta;SEKLYTĖLĖ;9675482322;Taip;10;1;0;11
10477;Rūta;SEKLYTĖLĖ;3820689725;Taip;0;1;0;1
10478;Rūta;SEKLYTĖLĖ;1415664888;Taip;0;8;0;8
10479;Rūta;SEKLYTĖLĖ;4426456302;Taip;0;3;0;3
10480;Rūta;SEKLYTĖLĖ;5114985659;Taip;0;3;0;3
10481;Rūta;SEKLYTĖLĖ;4282074540;Taip;0;6;0;6
10482;Rūta;SEKLYTĖLĖ;8607455403;Taip;0;7;0;7
10483;Rūta;SEKLYTĖLĖ;4168356825;Taip;0;0;1;1
10484;Rūta;SEKLYTĖLĖ;9569447586;Taip;0;3;0;3
10485;Rūta;SEKLYTĖLĖ;1579573872;Taip;0;1;0;1
10486;Rūta;SEKLYTĖLĖ;2677062861;Taip;2;3;0;5
10487;Rūta;SEKLYTĖLĖ;1390207547;Taip;0;3;0;3
10488;Rūta;SEKLYTĖLĖ;32004750783;Taip;0;7;0;7
10489;Rūta;SEKLYTĖLĖ;1368317570;Taip;0;2;0;2
10490;Rūta;SEKLYTĖLĖ;5866619097;Taip;0;3;0;3
10491;Rūta;SEKLYTĖLĖ;2912054049;Taip;0;1;0;1
10492;Rūta;"VARPELIAI (LOGOPEDINĖ)";3055294324;Taip;0;3;1;4
10493;Rūta;"VARPELIAI (LOGOPEDINĖ)";3810636967;Taip;15;3;0;18
10494;Rūta;"VARPELIAI (LOGOPEDINĖ)";8992775168;Taip;0;3;1;4
10495;Rūta;"VARPELIAI (LOGOPEDINĖ)";8026402652;Ne;3;3;0;6
10496;Rūta;"VARPELIAI (LOGOPEDINĖ)";2584812163;Ne;5;5;1;11
10497;Rūta;"VARPELIAI (LOGOPEDINĖ)";6032985748;Taip;0;12;0;12
10498;Rūta;"VARPELIAI (LOGOPEDINĖ)";6891385410;Taip;0;5;0;5
10499;Rūta;"VARPELIAI (LOGOPEDINĖ)";4858914868;Taip;5;4;1;10
10500;Rūta;KIŠKUČIŲ;7837861265;Taip;0;3;2;5
10501;Rūta;KIŠKUČIŲ;2601011765;Taip;8;0;9;17
10502;Rūta;KIŠKUČIŲ;5579794648;Taip;0;3;13;16
10503;Rūta;KIŠKUČIŲ;4165080541;Taip;4;0;6;10
10504;Rūta;KIŠKUČIŲ;3877807687;Taip;0;0;12;12
10505;Rūta;KIŠKUČIŲ;9429856388;Taip;3;0;9;12
10506;Rūta;KIŠKUČIŲ;8483916287;Taip;10;3;2;15
10507;Rūta;KIŠKUČIŲ;7724451685;Taip;5;0;4;9
10508;Rūta;KIŠKUČIŲ;8138816581;Taip;0;10;8;18
10509;Rūta;KIŠKUČIŲ;2733932207;Taip;4;4;0;8
10510;Rūta;KIŠKUČIŲ;5902965224;Taip;0;3;3;6
10511;Rūta;KIŠKUČIŲ;9471291067;Taip;8;6;0;14
10512;Rūta;KIŠKUČIŲ;8012225409;Taip;0;0;2;2
10513;Rūta;KIŠKUČIŲ;1290867375;Taip;0;0;3;3
10514;Rūta;KIŠKUČIŲ;2084935094;Taip;3;0;5;8
10515;Rūta;KIŠKUČIŲ;6088978998;Taip;0;0;9;9
10516;Rūta;KIŠKUČIŲ;8320791295;Taip;0;3;0;3
10517;Rūta;KIŠKUČIŲ;3109709043;Taip;11;0;4;15
10518;Rūta;KIŠKUČIŲ;2830990163;Taip;6;0;5;11
10519;Rūta;KIŠKUČIŲ;4780828296;Taip;0;0;1;1
10520;Rūta;ŽVIRBLIUKAI;3352007694;Taip;0;2;2;4
10521;Rūta;ŽVIRBLIUKAI;9243332756;Taip;8;0;0;8
10522;Rūta;ŽVIRBLIUKAI;1059126758;Taip;0;13;0;13
10523;Rūta;ŽVIRBLIUKAI;6417693659;Taip;0;3;4;7
10524;Rūta;ŽVIRBLIUKAI;4090915728;Taip;0;5;0;5
10525;Rūta;ŽVIRBLIUKAI;4466522924;Taip;10;3;5;18
10526;Rūta;ŽVIRBLIUKAI;7905893575;Taip;15;3;0;18
10527;Rūta;ŽVIRBLIUKAI;4436482805;Taip;0;5;0;5
10528;Rūta;ŽVIRBLIUKAI;1260386759;Taip;5;7;0;12
10529;Rūta;ŽVIRBLIUKAI;8935780480;Taip;0;0;4;4
10530;Rūta;ŽVIRBLIUKAI;4208678278;Taip;3;4;0;7
10531;Rūta;ŽVIRBLIUKAI;6044060646;Taip;5;3;0;8
10532;Rūta;ŽVIRBLIUKAI;3081348981;Taip;0;1;0;1
10533;Rūta;ŽVIRBLIUKAI;4776631890;Taip;0;0;4;4
10534;Rūta;ŽVIRBLIUKAI;4440148328;Taip;11;0;0;11
10535;Rūta;ŽVIRBLIUKAI;1671179652;Taip;5;3;3;11
10536;Rūta;ŽVIRBLIUKAI;1152453609;Taip;5;4;0;9
10537;Rūta;ŽVIRBLIUKAI;9012256437;Taip;9;4;0;13
10538;Rūta;SAULUTĖS;6869693434;Taip;0;0;2;2
10539;Rūta;SAULUTĖS;6585842434;Taip;2;3;1;6
10540;Rūta;SAULUTĖS;6620957022;Taip;5;0;0;5
10541;Rūta;SAULUTĖS;8806743371;Taip;0;0;2;2
10542;Rūta;SAULUTĖS;2391120026;Taip;6;0;0;6
10543;Rūta;SAULUTĖS;3765741047;Taip;7;0;0;7
10544;Rūta;SAULUTĖS;7762509383;Taip;0;4;2;6
10545;Rūta;SAULUTĖS;2685515977;Taip;18;0;0;18
10546;Rūta;SAULUTĖS;5512946296;Taip;0;3;0;3
10547;Rūta;SAULUTĖS;9308127402;Taip;0;0;18;18
10548;Rūta;SAULUTĖS;7422059414;Taip;5;7;0;12
10549;Rūta;SAULUTĖS;8571905994;Ne;6;3;2;11
10550;Rūta;SAULUTĖS;8479424939;Taip;18;0;0;18
10551;Rūta;SAULUTĖS;9014433476;Taip;5;7;0;12
10552;Rūta;SAULUTĖS;1207463357;Taip;9;0;0;9
10553;Rūta;SAULUTĖS;1131910047;Taip;15;3;0;18
10554;Sadutė;Kiškučiai;6645848193;Taip;0;3;0;3
10555;Sadutė;Kiškučiai;1589424708;Taip;0;4;0;4
10556;Sadutė;Kiškučiai;5992865266;Taip;0;4;1;5
10557;Sadutė;Kiškučiai;3568132830;Taip;0;18;0;18
10558;Sadutė;Kiškučiai;2340908210;Taip;15;1;0;16
10559;Sadutė;Kiškučiai;2087489114;Taip;3;3;1;7
10560;Sadutė;Kiškučiai;6652070415;Taip;7;0;2;9
10561;Sadutė;Kiškučiai;4360361866;Taip;9;0;0;9
10562;Sadutė;Kiškučiai;6493110772;Taip;0;3;2;5
10563;Sadutė;Kiškučiai;8397295024;Taip;0;4;0;4
10564;Sadutė;Kiškučiai;4075714061;Taip;7;3;0;10
10565;Sadutė;Kiškučiai;3285448692;Taip;0;3;0;3
10566;Sadutė;Kiškučiai;2845125335;Taip;0;3;0;3
10567;Sadutė;Kiškučiai;4135398332;Taip;0;6;0;6
10568;Sadutė;Kiškučiai;3954151590;Taip;8;0;0;8
10569;Sadutė;Kiškučiai;5326000400;Taip;0;18;0;18
10570;Sadutė;Kiškučiai;1860645542;Taip;9;1;1;11
10571;Sadutė;Boružėlės;9115304973;Taip;0;4;0;4
10572;Sadutė;Boružėlės;8442967732;Taip;4;3;0;7
10573;Sadutė;Boružėlės;1273355194;Taip;9;6;0;15
10574;Sadutė;Boružėlės;3119547420;Taip;9;6;0;15
10575;Sadutė;Boružėlės;8987528237;Taip;0;4;0;4
10576;Sadutė;Boružėlės;6994383907;Taip;0;1;3;4
10577;Sadutė;Boružėlės;8914509685;Taip;0;0;1;1
10578;Sadutė;Boružėlės;7242188081;Taip;0;3;1;4
10579;Sadutė;Boružėlės;3244211391;Taip;0;3;0;3
10580;Sadutė;Boružėlės;3875265137;Taip;0;3;5;8
10581;Sadutė;Boružėlės;5992119777;Taip;7;2;1;10
10582;Sadutė;Boružėlės;5682745869;Taip;0;2;3;5
10583;Sadutė;Boružėlės;7072437339;Taip;0;1;0;1
10584;Sadutė;Boružėlės;5579040052;Taip;9;3;0;12
10585;Sadutė;Boružėlės;3362830536;Taip;0;4;0;4
10586;Sadutė;Boružėlės;5395676303;Taip;0;4;0;4
10587;Sadutė;Boružėlės;1923014145;Taip;0;3;0;3
10588;Sadutė;Boružėlės;5698462283;Taip;0;0;1;1
10589;Sadutė;Boružėlės;3845369333;Taip;0;0;10;10
10590;Sadutė;Boružėlės;8200891038;Taip;1;0;3;4
10591;Sadutė;Boružėlės;4696990344;Ne;0;3;0;3
10592;Sadutė;Bitutės;1759479328;Taip;5;3;0;8
10593;Sadutė;Bitutės;1975767401;Taip;0;2;0;2
10594;Sadutė;Bitutės;4245873513;Taip;0;3;0;3
10595;Sadutė;Bitutės;1873928395;Taip;10;3;0;13
10596;Sadutė;Bitutės;5866461096;Taip;6;3;0;9
10597;Sadutė;Bitutės;4883934480;Taip;8;0;0;8
10598;Sadutė;Bitutės;7097653016;Taip;0;8;0;8
10599;Sadutė;Bitutės;4479315578;Taip;0;3;0;3
10600;Sadutė;Bitutės;2020766695;Taip;0;18;0;18
10601;Sadutė;Bitutės;5011320850;Taip;5;4;1;10
10602;Sadutė;Bitutės;4161502667;Taip;0;3;0;3
10603;Sadutė;Bitutės;5973513916;Taip;0;8;0;8
10604;Sadutė;Bitutės;5169694660;Taip;0;3;0;3
10605;Sadutė;Bitutės;3361904803;Taip;9;0;2;11
10606;Sadutė;Bitutės;1231048342;Taip;5;3;0;8
10607;Sadutė;Bitutės;2355177889;Taip;5;3;1;9
10608;Sadutė;Bitutės;8556086501;Taip;7;3;0;10
10609;Sadutė;Bitutės;6066145909;Taip;21;2;0;23
10610;Sadutė;Bitutės;5142566738;Taip;3;4;2;9
10611;Sadutė;Bitutės;8662375739;Taip;5;5;0;10
10612;Sadutė;Bitutės;9692905987;Taip;9;0;0;9
10613;Sadutė;Bitutės;9107727583;Taip;0;3;1;4
10614;Sadutė;Bitutės;6138604955;Taip;3;4;0;7
10615;Sadutė;Drugeliai;9090754149;Taip;0;3;0;3
10616;Sadutė;Drugeliai;1552350084;Taip;2;3;0;5
10617;Sadutė;Drugeliai;7910380894;Taip;0;3;0;3
10618;Sadutė;Drugeliai;4402558234;Taip;0;5;0;5
10619;Sadutė;Drugeliai;8713575864;Taip;0;3;0;3
10620;Sadutė;Drugeliai;6994547344;Taip;0;2;0;2
10621;Sadutė;Drugeliai;1782594187;Taip;0;4;0;4
10622;Sadutė;Drugeliai;5816844295;Taip;0;3;3;6
10623;Sadutė;Drugeliai;8803249656;Taip;7;1;2;10
10624;Sadutė;Drugeliai;4901634532;Taip;5;1;0;6
10625;Sadutė;Drugeliai;6196282159;Taip;5;3;2;10
10626;Sadutė;Drugeliai;5139219626;Taip;3;3;0;6
10627;Sadutė;Drugeliai;1735450955;Taip;0;3;0;3
10628;Sadutė;Drugeliai;2064784580;Taip;0;3;0;3
10629;Sadutė;Drugeliai;2883991326;Taip;0;3;0;3
10630;Sadutė;Drugeliai;7731164484;Taip;0;3;0;3
10631;Sadutė;Drugeliai;6124376554;Taip;0;3;0;3
10632;Sadutė;Drugeliai;36769610742;Taip;8;3;1;12
10633;Sadutė;Drugeliai;4623727349;Taip;0;3;1;4
10634;Sadutė;Drugeliai;7940706717;Taip;0;3;2;5
10635;Sadutė;Drugeliai;3457375001;Ne;0;3;4;7
10636;Sadutė;Pėledžiukai;9136727429;Taip;0;0;1;1
10637;Sadutė;Pėledžiukai;5616756293;Taip;8;0;0;8
10638;Sadutė;Pėledžiukai;2705458480;Taip;10;0;1;11
10639;Sadutė;Pėledžiukai;6314488650;Taip;0;0;3;3
10640;Sadutė;Pėledžiukai;6126235707;Taip;13;0;0;13
10641;Sadutė;Pėledžiukai;1537482438;Taip;0;0;4;4
10642;Sadutė;Pėledžiukai;6716550703;Taip;1;2;0;3
10643;Sadutė;Pėledžiukai;7730645448;Taip;0;0;1;1
10644;Sadutė;Pėledžiukai;4013188468;Taip;15;0;2;17
10645;Sadutė;Pėledžiukai;7551299839;Taip;15;0;0;15
10646;Sadutė;Pėledžiukai;8914706717;Taip;15;0;0;15
10647;Sadutė;Pėledžiukai;6379705269;Taip;4;0;0;4
10648;Sadutė;Pėledžiukai;5385678913;Taip;3;3;0;6
10649;Sadutė;Pėledžiukai;2055127699;Taip;11;0;1;12
10650;Sadutė;Pėledžiukai;2747256989;Taip;0;3;3;6
10651;Sadutė;Pėledžiukai;3277826759;Taip;4;0;1;5
10652;Sadutė;Kačiukų;1507052440;Taip;0;12;0;12
10653;Sadutė;Kačiukų;1903961488;Taip;0;3;0;3
10654;Sadutė;Kačiukų;2890916313;Taip;0;3;0;3
10655;Sadutė;Kačiukų;2733633163;Taip;4;6;0;10
10656;Sadutė;Kačiukų;3993181500;Taip;0;3;2;5
10657;Sadutė;Kačiukų;8835627470;Taip;5;3;0;8
10658;Sadutė;Kačiukų;2532626934;Taip;0;4;0;4
10659;Sadutė;Kačiukų;2466024649;Taip;8;0;0;8
10660;Sadutė;Kačiukų;6253351299;Taip;5;3;0;8
10661;Sadutė;Kačiukų;2426974464;Taip;0;3;2;5
10662;Sadutė;Kačiukų;5438448926;Taip;0;1;2;3
10663;Sadutė;Kačiukų;8974374101;Taip;0;3;2;5
10664;Sadutė;Kačiukų;4401870028;Taip;0;3;1;4
10665;Sadutė;Kačiukų;8714168144;Taip;7;0;0;7
10666;Sadutė;Kačiukų;3927044011;Taip;5;4;0;9
10667;Sadutė;Kačiukų;8974225608;Taip;8;0;0;8
10668;Sadutė;Kačiukų;8770727233;Taip;0;1;2;3
10669;Sadutė;Kačiukų;8556218971;Taip;10;4;0;14
10670;Sadutė;Kačiukų;5267093203;Taip;11;3;0;14
10671;Sadutė;Kačiukų;6538356822;Taip;0;1;1;2
10672;Sadutė;Kačiukų;5614758320;Taip;0;12;0;12
10673;Sadutė;Kačiukų;2194387139;Taip;6;3;0;9
10674;Sakalėlis;GIRINUKŲ;9566176151;Taip;9;0;0;9
10675;Sakalėlis;GIRINUKŲ;8606714134;Taip;9;0;2;11
10676;Sakalėlis;GIRINUKŲ;5405669698;Taip;0;3;0;3
10677;Sakalėlis;GIRINUKŲ;2474164013;Taip;0;3;0;3
10678;Sakalėlis;GIRINUKŲ;9493905856;Taip;0;0;4;4
10679;Sakalėlis;GIRINUKŲ;5496044442;Taip;2;0;4;6
10680;Sakalėlis;GIRINUKŲ;3165387995;Taip;0;0;2;2
10681;Sakalėlis;GIRINUKŲ;6603105354;Taip;0;0;5;5
10682;Sakalėlis;GIRINUKŲ;3418702674;Taip;0;3;1;4
10683;Sakalėlis;GIRINUKŲ;3748865437;Taip;5;0;1;6
10684;Sakalėlis;GIRINUKŲ;6700169944;Taip;0;0;4;4
10685;Sakalėlis;GIRINUKŲ;3333037807;Taip;0;3;1;4
10686;Sakalėlis;GIRINUKŲ;8667155756;Taip;0;3;0;3
10687;Sakalėlis;GIRINUKŲ;4596727938;Taip;0;3;0;3
10688;Sakalėlis;GIRINUKŲ;8790189865;Taip;0;5;0;5
10689;Sakalėlis;GIRINUKŲ;4458071075;Taip;0;0;3;3
10690;Sakalėlis;GIRINUKŲ;4209146744;Taip;0;5;0;5
10691;Sakalėlis;GIRINUKŲ;2780141413;Taip;0;6;0;6
10692;Sakalėlis;GIRINUKŲ;1347171934;Taip;0;3;0;3
10693;Sakalėlis;GIRINUKŲ;9250470549;Ne;0;4;0;4
10694;Sakalėlis;GIRINUKŲ;3691879468;Taip;0;0;3;3
10695;Sakalėlis;VYTURIUKŲ;3927487265;Taip;7;0;3;10
10696;Sakalėlis;VYTURIUKŲ;2352118061;Taip;3;3;0;6
10697;Sakalėlis;VYTURIUKŲ;3680732318;Taip;0;10;0;10
10698;Sakalėlis;VYTURIUKŲ;4862004373;Taip;5;4;0;9
10699;Sakalėlis;VYTURIUKŲ;8422299669;Ne;0;0;3;3
10700;Sakalėlis;VYTURIUKŲ;6579827280;Taip;0;0;3;3
10701;Sakalėlis;VYTURIUKŲ;8381310908;Taip;2;0;1;3
10702;Sakalėlis;VYTURIUKŲ;6840368824;Taip;5;0;0;5
10703;Sakalėlis;VYTURIUKŲ;7285833058;Taip;0;0;1;1
10704;Sakalėlis;VYTURIUKŲ;1742362136;Taip;6;0;0;6
10705;Sakalėlis;VYTURIUKŲ;5795250727;Taip;0;3;1;4
10706;Sakalėlis;VYTURIUKŲ;2985239904;Taip;6;3;0;9
10707;Sakalėlis;VYTURIUKŲ;3351218789;Taip;0;0;1;1
10708;Sakalėlis;VYTURIUKŲ;9120873899;Ne;0;0;6;6
10709;Sakalėlis;VYTURIUKŲ;4136266629;Taip;5;0;3;8
10710;Sakalėlis;VYTURIUKŲ;5991029760;Taip;5;0;8;13
10711;Sakalėlis;VYTURIUKŲ;6378711142;Taip;5;0;3;8
10712;Sakalėlis;VYTURIUKŲ;1736303381;Taip;0;3;5;8
10713;Sakalėlis;VYTURIUKŲ;1200252225;Taip;5;0;0;5
10714;Sakalėlis;VYTURIUKŲ;7280513854;Taip;10;0;0;10
10715;Sakalėlis;DRUGELIŲ;8095359035;Taip;0;2;4;6
10716;Sakalėlis;DRUGELIŲ;6515519140;Ne;0;3;1;4
10717;Sakalėlis;DRUGELIŲ;7706606275;Taip;5;0;4;9
10718;Sakalėlis;DRUGELIŲ;5911341542;Taip;0;0;1;1
10719;Sakalėlis;DRUGELIŲ;9272347788;Taip;0;0;1;1
10720;Sakalėlis;DRUGELIŲ;9416737436;Taip;0;0;1;1
10721;Sakalėlis;DRUGELIŲ;8331612396;Taip;0;5;3;8
10722;Sakalėlis;DRUGELIŲ;2898006208;Taip;0;0;3;3
10723;Sakalėlis;DRUGELIŲ;7542322748;Taip;2;0;4;6
10724;Sakalėlis;DRUGELIŲ;4918228191;Taip;0;0;1;1
10725;Sakalėlis;DRUGELIŲ;1201086815;Taip;8;3;1;12
10726;Sakalėlis;DRUGELIŲ;3934295338;Taip;0;4;1;5
10727;Sakalėlis;DRUGELIŲ;1117800518;Taip;0;0;1;1
10728;Sakalėlis;DRUGELIŲ;2515169899;Taip;0;3;1;4
10729;Sakalėlis;DRUGELIŲ;8160589611;Taip;7;3;0;10
10730;Sakalėlis;DRUGELIŲ;9836193857;Taip;0;1;4;5
10731;Sakalėlis;DRUGELIŲ;4004006771;Taip;0;3;1;4
10732;Sakalėlis;DRUGELIŲ;1833573491;Taip;0;0;3;3
10733;Sakalėlis;DRUGELIŲ;8713298648;Taip;0;8;0;8
10734;Sakalėlis;DRUGELIŲ;2889638745;Taip;0;0;3;3
10735;Sakalėlis;DRUGELIŲ;3329244758;Taip;0;0;4;4
10736;Sakalėlis;DRUGELIŲ;7540098033;Taip;0;0;5;5
10737;Sakalėlis;GENIUKŲ;4763858893;Taip;0;3;1;4
10738;Sakalėlis;GENIUKŲ;3337299648;Taip;0;3;7;10
10739;Sakalėlis;GENIUKŲ;9830907922;Taip;0;1;0;1
10740;Sakalėlis;GENIUKŲ;43677485606;Taip;0;3;2;5
10741;Sakalėlis;GENIUKŲ;5717022080;Taip;2;3;0;5
10742;Sakalėlis;GENIUKŲ;4515180509;Taip;0;3;1;4
10743;Sakalėlis;GENIUKŲ;1027765680;Taip;0;7;0;7
10744;Sakalėlis;GENIUKŲ;81681433432;Taip;2;3;0;5
10745;Sakalėlis;GENIUKŲ;96053733139;Taip;0;3;0;3
10746;Sakalėlis;GENIUKŲ;4612388683;Taip;0;3;0;3
10747;Sakalėlis;GENIUKŲ;7159705304;Taip;0;3;0;3
10748;Sakalėlis;GENIUKŲ;4775685174;Taip;0;1;0;1
10749;Sakalėlis;GENIUKŲ;69916351348;Taip;10;3;0;13
10750;Sakalėlis;GENIUKŲ;8936933971;Taip;4;3;0;7
10751;Sakalėlis;GENIUKŲ;2829386777;Taip;3;3;0;6
10752;Sakalėlis;GENIUKŲ;3371763993;Taip;5;3;0;8
10753;Sakalėlis;GENIUKŲ;7085108710;Taip;3;3;0;6
10754;Sakalėlis;GENIUKŲ;2902195855;Taip;0;3;2;5
10755;Sakalėlis;GENIUKŲ;36670171187;Taip;0;2;1;3
10756;Sakalėlis;GENIUKŲ;6301366135;Taip;0;3;2;5
10757;Sakalėlis;GENIUKŲ;4364341933;Taip;0;3;0;3
10758;Sakalėlis;VOVERIUKŲ;5172421763;Taip;0;0;5;5
10759;Sakalėlis;VOVERIUKŲ;5233697077;Taip;5;3;0;8
10760;Sakalėlis;VOVERIUKŲ;6414564366;Taip;9;0;3;12
10761;Sakalėlis;VOVERIUKŲ;1953356983;Taip;10;0;3;13
10762;Sakalėlis;VOVERIUKŲ;4358313171;Taip;0;0;3;3
10763;Sakalėlis;VOVERIUKŲ;1873392718;Taip;0;0;1;1
10764;Sakalėlis;VOVERIUKŲ;6806170544;Taip;0;0;4;4
10765;Sakalėlis;VOVERIUKŲ;2557089391;Taip;0;2;3;5
10766;Sakalėlis;VOVERIUKŲ;8133985842;Taip;3;0;0;3
10767;Sakalėlis;VOVERIUKŲ;3574956316;Taip;0;3;0;3
10768;Sakalėlis;VOVERIUKŲ;1403384561;Taip;8;0;3;11
10769;Sakalėlis;VOVERIUKŲ;3927363997;Taip;0;4;0;4
10770;Sakalėlis;VOVERIUKŲ;6293226507;Taip;5;3;2;10
10771;Sakalėlis;VOVERIUKŲ;2699844937;Taip;5;0;0;5
10772;Sakalėlis;VOVERIUKŲ;1273843302;Taip;0;2;2;4
10773;Sakalėlis;VOVERIUKŲ;6217643065;Taip;0;0;7;7
10774;Sakalėlis;VOVERIUKŲ;1669610397;Taip;0;0;4;4
10775;Sakalėlis;VOVERIUKŲ;4344537391;Taip;0;0;3;3
10776;Sakalėlis;VOVERIUKŲ;6016854405;Taip;3;0;0;3
10777;Sakalėlis;VOVERIUKŲ;2531146677;Taip;0;3;1;4
10778;Sakalėlis;VOVERIUKŲ;2575873447;Taip;4;0;0;4
10779;Sakalėlis;VOVERIUKŲ;9592852011;Taip;0;3;0;3
10780;Sakalėlis;VOVERIUKŲ;4968216193;Taip;4;0;0;4
10781;Sakalėlis;PĖLEDŽIUKŲ;1133377117;Taip;0;3;0;3
10782;Sakalėlis;PĖLEDŽIUKŲ;6190741162;Taip;0;5;0;5
10783;Sakalėlis;PĖLEDŽIUKŲ;4430763418;Taip;0;4;0;4
10784;Sakalėlis;PĖLEDŽIUKŲ;1104881142;Taip;0;3;0;3
10785;Sakalėlis;PĖLEDŽIUKŲ;6321575268;Taip;0;1;3;4
10786;Sakalėlis;PĖLEDŽIUKŲ;1702964714;Taip;0;3;1;4
10787;Sakalėlis;PĖLEDŽIUKŲ;30987215315;Taip;0;3;0;3
10788;Sakalėlis;PĖLEDŽIUKŲ;2796230671;Taip;2;3;2;7
10789;Sakalėlis;PĖLEDŽIUKŲ;1912068116;Taip;0;3;0;3
10790;Sakalėlis;PĖLEDŽIUKŲ;34464485043;Taip;0;0;1;1
10791;Sakalėlis;PĖLEDŽIUKŲ;46629941288;Taip;0;3;0;3
10792;Sakalėlis;PĖLEDŽIUKŲ;5782214279;Taip;0;3;0;3
10793;Sakalėlis;PĖLEDŽIUKŲ;8852001037;Taip;0;3;6;9
10794;Sakalėlis;PĖLEDŽIUKŲ;6180987643;Taip;0;8;1;9
10795;Sakalėlis;PĖLEDŽIUKŲ;3678172501;Taip;5;6;0;11
10796;Sakalėlis;PĖLEDŽIUKŲ;7567476424;Taip;0;3;0;3
10797;Sakalėlis;PĖLEDŽIUKŲ;2055710873;Taip;0;0;1;1
10798;Sakalėlis;PĖLEDŽIUKŲ;1839096675;Taip;4;3;0;7
10799;Sakalėlis;PĖLEDŽIUKŲ;1339314644;Taip;0;3;0;3
10800;Sakalėlis;PĖLEDŽIUKŲ;5884781964;Taip;5;3;0;8
10801;Sakalėlis;PĖLEDŽIUKŲ;4495453007;Taip;0;3;0;3
10802;Sakalėlis;"BITUČIŲ (LOGOPEDINĖ)";7241416465;Taip;0;3;1;4
10803;Sakalėlis;"BITUČIŲ (LOGOPEDINĖ)";4857211754;Taip;0;3;2;5
10804;Sakalėlis;"BITUČIŲ (LOGOPEDINĖ)";8610668395;Taip;6;4;1;11
10805;Sakalėlis;"BITUČIŲ (LOGOPEDINĖ)";4986131090;Taip;3;0;0;3
10806;Sakalėlis;"BITUČIŲ (LOGOPEDINĖ)";6259640492;Taip;3;0;0;3
10807;Sakalėlis;"BITUČIŲ (LOGOPEDINĖ)";1723436498;Taip;0;11;0;11
10808;Sakalėlis;"BITUČIŲ (LOGOPEDINĖ)";3938470708;Taip;11;0;0;11
10809;Sakalėlis;"BITUČIŲ (LOGOPEDINĖ)";4931253729;Taip;0;0;4;4
10810;Sakalėlis;"BITUČIŲ (LOGOPEDINĖ)";5376872141;Taip;2;0;1;3
10811;Sakalėlis;"BITUČIŲ (LOGOPEDINĖ)";4303490614;Taip;0;4;0;4
10812;Sakalėlis;"BORUŽIUKŲ (LOGOPEDINĖ)";4514546151;Taip;0;3;0;3
10813;Sakalėlis;"BORUŽIUKŲ (LOGOPEDINĖ)";3972897839;Taip;0;3;2;5
10814;Sakalėlis;"BORUŽIUKŲ (LOGOPEDINĖ)";2124857941;Taip;13;1;0;14
10815;Sakalėlis;"BORUŽIUKŲ (LOGOPEDINĖ)";1806698668;Taip;0;3;1;4
10816;Sakalėlis;"BORUŽIUKŲ (LOGOPEDINĖ)";9823633774;Taip;0;3;0;3
10817;Sakalėlis;"BORUŽIUKŲ (LOGOPEDINĖ)";6727251397;Taip;0;5;0;5
10818;Sakalėlis;"BORUŽIUKŲ (LOGOPEDINĖ)";6250400609;Taip;5;0;1;6
10819;Sakalėlis;"BORUŽIUKŲ (LOGOPEDINĖ)";6222204020;Taip;9;0;3;12
10820;Sakalėlis;"BORUŽIUKŲ (LOGOPEDINĖ)";7602249339;Taip;0;0;2;2
10821;Sakalėlis;"BORUŽIUKŲ (LOGOPEDINĖ)";8263169658;Taip;4;3;1;8
10822;Sakalėlis;MEŠKUČIŲ;9546779717;Taip;8;4;0;12
10823;Sakalėlis;MEŠKUČIŲ;8535457018;Taip;10;3;0;13
10824;Sakalėlis;MEŠKUČIŲ;4813561523;Taip;3;0;0;3
10825;Sakalėlis;MEŠKUČIŲ;7154383856;Taip;12;0;0;12
10826;Sakalėlis;MEŠKUČIŲ;5082756444;Taip;0;0;7;7
10827;Sakalėlis;MEŠKUČIŲ;7839893402;Taip;0;0;2;2
10828;Sakalėlis;MEŠKUČIŲ;3092760315;Taip;0;9;0;9
10829;Sakalėlis;MEŠKUČIŲ;3524545708;Taip;0;6;0;6
10830;Sakalėlis;MEŠKUČIŲ;5961861760;Taip;0;0;1;1
10831;Sakalėlis;MEŠKUČIŲ;5677280944;Taip;0;0;5;5
10832;Sakalėlis;MEŠKUČIŲ;2389541483;Taip;0;6;0;6
10833;Sakalėlis;MEŠKUČIŲ;4063074948;Taip;0;0;3;3
10834;Sakalėlis;MEŠKUČIŲ;8108456923;Taip;0;0;1;1
10835;Sakalėlis;MEŠKUČIŲ;7285230768;Taip;0;8;0;8
10836;Sakalėlis;MEŠKUČIŲ;8888784168;Taip;0;3;0;3
10837;Sakalėlis;MEŠKUČIŲ;2090313887;Ne;7;0;0;7
10838;Sakalėlis;MEŠKUČIŲ;9794245922;Taip;14;0;1;15
10839;Sakalėlis;MEŠKUČIŲ;8106231242;Taip;3;3;1;7
10840;Sakalėlis;MEŠKUČIŲ;4520212128;Taip;5;3;0;8
10841;Sakalėlis;MEŠKUČIŲ;7228559861;Taip;0;10;4;14
10842;Sakalėlis;MEŠKUČIŲ;1208798798;Taip;12;0;0;12
10843;Sakalėlis;KIŠKUČIŲ;2505477059;Taip;5;0;8;13
10844;Sakalėlis;KIŠKUČIŲ;1004062550;Taip;2;0;0;2
10845;Sakalėlis;KIŠKUČIŲ;5865993835;Taip;5;0;2;7
10846;Sakalėlis;KIŠKUČIŲ;2003090775;Taip;3;0;0;3
10847;Sakalėlis;KIŠKUČIŲ;8228039819;Taip;0;0;3;3
10848;Sakalėlis;KIŠKUČIŲ;7006304327;Taip;0;0;1;1
10849;Sakalėlis;KIŠKUČIŲ;6029443196;Taip;18;0;0;18
10850;Sakalėlis;KIŠKUČIŲ;4633296169;Taip;0;0;1;1
10851;Sakalėlis;KIŠKUČIŲ;4611384179;Taip;0;10;2;12
10852;Sakalėlis;KIŠKUČIŲ;4490632523;Taip;8;3;1;12
10853;Sakalėlis;KIŠKUČIŲ;8015985605;Taip;5;4;0;9
10854;Sakalėlis;KIŠKUČIŲ;5052638078;Taip;14;0;0;14
10855;Sakalėlis;KIŠKUČIŲ;5327382009;Taip;14;0;0;14
10856;Sakalėlis;KIŠKUČIŲ;6897550418;Taip;7;0;4;11
10857;Sakalėlis;KIŠKUČIŲ;9642519454;Taip;10;0;1;11
10858;Sakalėlis;KIŠKUČIŲ;5387119771;Taip;18;0;0;18
10859;Sakalėlis;KIŠKUČIŲ;6328924318;Taip;0;3;2;5
10860;Sakalėlis;KIŠKUČIŲ;8868588637;Taip;5;3;3;11
10861;Sakalėlis;SVIRPLIUKŲ;6597274376;Taip;15;3;0;18
10862;Sakalėlis;SVIRPLIUKŲ;5500248048;Taip;0;3;0;3
10863;Sakalėlis;SVIRPLIUKŲ;8562164673;Taip;0;3;0;3
10864;Sakalėlis;SVIRPLIUKŲ;2537030533;Taip;8;0;3;11
10865;Sakalėlis;SVIRPLIUKŲ;3719351129;Taip;5;3;0;8
10866;Sakalėlis;SVIRPLIUKŲ;3570413330;Taip;4;0;3;7
10867;Sakalėlis;SVIRPLIUKŲ;6889888573;Taip;0;0;3;3
10868;Sakalėlis;SVIRPLIUKŲ;7852255204;Taip;7;0;3;10
10869;Sakalėlis;SVIRPLIUKŲ;9926328835;Taip;10;2;3;15
10870;Sakalėlis;SVIRPLIUKŲ;1253452975;Taip;0;0;5;5
10871;Sakalėlis;SVIRPLIUKŲ;8328069876;Taip;8;0;0;8
10872;Sakalėlis;SVIRPLIUKŲ;7480286509;Taip;0;3;0;3
10873;Sakalėlis;SVIRPLIUKŲ;2250828607;Taip;5;3;3;11
10874;Sakalėlis;SVIRPLIUKŲ;2672429406;Taip;5;3;3;11
10875;Sakalėlis;SVIRPLIUKŲ;6851247779;Taip;0;3;0;3
10876;Sakalėlis;SVIRPLIUKŲ;9776767584;Taip;18;0;0;18
10877;Sakalėlis;SVIRPLIUKŲ;8501785305;Taip;0;0;3;3
10878;Sakalėlis;SVIRPLIUKŲ;1121818878;Taip;2;1;1;4
10879;Sakalėlis;SVIRPLIUKŲ;5465596207;Taip;17;0;0;17
10880;Sakalėlis;SVIRPLIUKŲ;2233966176;Taip;6;3;4;13
10881;Sakalėlis;SVIRPLIUKŲ;7079300418;Taip;11;0;1;12
10882;Sakalėlis;SVIRPLIUKŲ;8659925528;Taip;5;0;4;9
10883;Sakalėlis;GANDRIUKŲ;8502289806;Taip;0;6;0;6
10884;Sakalėlis;GANDRIUKŲ;5292978341;Taip;1;3;0;4
10885;Sakalėlis;GANDRIUKŲ;9368758708;Ne;11;0;0;11
10886;Sakalėlis;GANDRIUKŲ;8326977226;Taip;9;0;5;14
10887;Sakalėlis;GANDRIUKŲ;7384400795;Taip;5;8;0;13
10888;Sakalėlis;GANDRIUKŲ;3644413861;Taip;7;3;0;10
10889;Sakalėlis;GANDRIUKŲ;4576495786;Taip;0;3;2;5
10890;Sakalėlis;GANDRIUKŲ;4230762388;Taip;7;0;3;10
10891;Sakalėlis;GANDRIUKŲ;3228617971;Taip;0;5;2;7
10892;Sakalėlis;GANDRIUKŲ;1545323439;Taip;0;10;1;11
10893;Sakalėlis;GANDRIUKŲ;5748438461;Taip;0;7;0;7
10894;Sakalėlis;GANDRIUKŲ;2734462553;Taip;0;0;3;3
10895;Sakalėlis;GANDRIUKŲ;2481285439;Taip;0;2;2;4
10896;Sakalėlis;GANDRIUKŲ;7345113972;Taip;0;1;3;4
10897;Sakalėlis;GANDRIUKŲ;6069544792;Taip;5;0;4;9
10898;Sakalėlis;GANDRIUKŲ;8869621812;Taip;9;0;1;10
10899;Sakalėlis;GANDRIUKŲ;5460619168;Taip;5;0;3;8
10900;Sakalėlis;GANDRIUKŲ;1560077883;Taip;0;7;0;7
10901;Salininkų;BORUŽIUKAI;8329495685;Taip;13;1;0;14
10902;Salininkų;BORUŽIUKAI;1005025619;Taip;8;7;0;15
10903;Salininkų;BORUŽIUKAI;3925860408;Taip;4;1;0;5
10904;Salininkų;BORUŽIUKAI;2146404021;Taip;0;2;1;3
10905;Salininkų;BORUŽIUKAI;8718514114;Taip;13;0;0;13
10906;Salininkų;BORUŽIUKAI;8930622266;Taip;0;4;0;4
10907;Salininkų;BORUŽIUKAI;5447236646;Taip;6;5;0;11
10908;Salininkų;BORUŽIUKAI;2208793412;Taip;0;3;0;3
10909;Salininkų;BORUŽIUKAI;5045064069;Taip;0;0;1;1
10910;Salininkų;BORUŽIUKAI;1647401700;Taip;5;5;0;10
10911;Salininkų;BORUŽIUKAI;9817285587;Taip;18;0;0;18
10912;Salininkų;BORUŽIUKAI;8823595510;Taip;0;7;0;7
10913;Salininkų;BORUŽIUKAI;9416926474;Taip;3;5;0;8
10914;Salininkų;BORUŽIUKAI;5671229613;Taip;0;3;0;3
10915;Salininkų;BORUŽIUKAI;1254843449;Taip;0;9;0;9
10916;Salininkų;BORUŽIUKAI;3231379271;Taip;0;18;0;18
10917;Salininkų;BORUŽIUKAI;1346133493;Taip;14;3;0;17
10918;Salininkų;BORUŽIUKAI;2273407270;Taip;14;3;0;17
10919;Salininkų;BORUŽIUKAI;9855014750;Taip;0;0;1;1
10920;Salininkų;BORUŽIUKAI;8911016037;Taip;13;0;0;13
10921;Salininkų;GĖLYTĖS;8602489420;Taip;11;4;0;15
10922;Salininkų;GĖLYTĖS;2895782373;Taip;4;12;0;16
10923;Salininkų;GĖLYTĖS;4971070998;Taip;0;0;1;1
10924;Salininkų;GĖLYTĖS;9893985732;Taip;5;5;0;10
10925;Salininkų;GĖLYTĖS;3686372180;Taip;8;0;3;11
10926;Salininkų;GĖLYTĖS;9892443649;Taip;0;2;0;2
10927;Salininkų;GĖLYTĖS;3703729963;Taip;2;2;1;5
10928;Salininkų;GĖLYTĖS;3338213592;Taip;0;7;0;7
10929;Salininkų;GĖLYTĖS;6506819265;Taip;6;1;0;7
10930;Salininkų;GĖLYTĖS;6510096414;Taip;5;6;0;11
10931;Salininkų;GĖLYTĖS;9482632726;Taip;0;1;0;1
10932;Salininkų;GĖLYTĖS;2491796874;Taip;0;0;1;1
10933;Salininkų;GĖLYTĖS;3464228778;Taip;8;2;0;10
10934;Salininkų;GĖLYTĖS;8141168894;Taip;12;1;0;13
10935;Salininkų;GĖLYTĖS;2440831687;Taip;3;7;0;10
10936;Salininkų;GĖLYTĖS;1284909139;Taip;3;5;0;8
10937;Salininkų;GĖLYTĖS;5164367382;Taip;12;0;0;12
10938;Salininkų;GĖLYTĖS;2798153926;Taip;0;3;0;3
10939;Salininkų;GĖLYTĖS;2726813574;Taip;13;1;0;14
10940;Salininkų;GĖLYTĖS;1453214735;Taip;4;4;0;8
10941;Salininkų;DRUGELIAI;2684868661;Taip;8;0;0;8
10942;Salininkų;DRUGELIAI;8063397588;Taip;0;0;2;2
10943;Salininkų;DRUGELIAI;4333027447;Taip;5;3;0;8
10944;Salininkų;DRUGELIAI;3115232507;Taip;8;0;0;8
10945;Salininkų;DRUGELIAI;2009246885;Taip;0;3;1;4
10946;Salininkų;DRUGELIAI;3420217477;Taip;15;0;0;15
10947;Salininkų;DRUGELIAI;3890914603;Taip;14;5;0;19
10948;Salininkų;DRUGELIAI;3181932118;Taip;6;10;1;17
10949;Salininkų;DRUGELIAI;5017068344;Taip;4;3;0;7
10950;Salininkų;DRUGELIAI;3761217912;Taip;0;5;0;5
10951;Salininkų;DRUGELIAI;2208607684;Taip;0;8;0;8
10952;Salininkų;DRUGELIAI;3963410827;Taip;5;0;0;5
10953;Salininkų;DRUGELIAI;5539560359;Taip;5;4;6;15
10954;Salininkų;DRUGELIAI;5587577036;Taip;8;0;2;10
10955;Salininkų;DRUGELIAI;5375668400;Taip;0;6;0;6
10956;Salininkų;DRUGELIAI;4529253958;Taip;8;1;1;10
10957;Salininkų;DRUGELIAI;5583804491;Taip;13;1;0;14
10958;Salininkų;DRUGELIAI;7063718023;Taip;5;0;3;8
10959;Salininkų;DRUGELIAI;9018366347;Taip;13;0;0;13
10960;Salininkų;ŽIRNIUKAI;7643665643;Taip;2;4;0;6
10961;Salininkų;ŽIRNIUKAI;9198411540;Taip;9;3;0;12
10962;Salininkų;ŽIRNIUKAI;6885580632;Taip;0;8;0;8
10963;Salininkų;ŽIRNIUKAI;7409604480;Taip;0;8;0;8
10964;Salininkų;ŽIRNIUKAI;3677558828;Taip;0;3;0;3
10965;Salininkų;ŽIRNIUKAI;8095820690;Taip;6;0;0;6
10966;Salininkų;ŽIRNIUKAI;6482437251;Taip;0;5;2;7
10967;Salininkų;ŽIRNIUKAI;1380797788;Taip;3;9;0;12
10968;Salininkų;ŽIRNIUKAI;2495782496;Taip;0;5;1;6
10969;Salininkų;ŽIRNIUKAI;9896357816;Taip;3;5;3;11
10970;Salininkų;ŽIRNIUKAI;4568462071;Taip;11;0;0;11
10971;Salininkų;ŽIRNIUKAI;9137783249;Taip;22;0;0;22
10972;Salininkų;ŽIRNIUKAI;8524400656;Taip;7;1;0;8
10973;Salininkų;ŽIRNIUKAI;7463713798;Taip;0;10;0;10
10974;Salininkų;ŽIRNIUKAI;9617873735;Taip;3;1;0;4
10975;Salininkų;ŽIRNIUKAI;1111197633;Taip;0;3;2;5
10976;Salininkų;ŽIRNIUKAI;6143967744;Taip;0;3;1;4
10977;Salininkų;ŽIRNIUKAI;8552427446;Taip;0;0;6;6
10978;Salininkų;ŽIRNIUKAI;6586988786;Taip;0;1;0;1
10979;Salininkų;ŽIRNIUKAI;1587485662;Taip;0;3;0;3
10980;Salininkų;PAUKŠČIUKAI;8047582970;Taip;0;0;2;2
10981;Salininkų;PAUKŠČIUKAI;5427013789;Taip;0;3;0;3
10982;Salininkų;PAUKŠČIUKAI;3100499807;Taip;0;3;0;3
10983;Salininkų;PAUKŠČIUKAI;6850925495;Taip;0;3;0;3
10984;Salininkų;PAUKŠČIUKAI;5867676844;Taip;7;0;5;12
10985;Salininkų;PAUKŠČIUKAI;3585435095;Taip;5;2;0;7
10986;Salininkų;PAUKŠČIUKAI;2760231414;Taip;0;8;0;8
10987;Salininkų;PAUKŠČIUKAI;7665409499;Taip;13;0;0;13
10988;Salininkų;PAUKŠČIUKAI;9724367035;Taip;17;3;0;20
10989;Salininkų;PAUKŠČIUKAI;1658695150;Taip;5;3;2;10
10990;Salininkų;PAUKŠČIUKAI;7383557807;Taip;0;11;0;11
10991;Salininkų;PAUKŠČIUKAI;9344614003;Taip;0;3;0;3
10992;Salininkų;PAUKŠČIUKAI;2808778763;Taip;4;10;0;14
10993;Salininkų;PAUKŠČIUKAI;6656578271;Taip;0;5;0;5
10994;Salininkų;PAUKŠČIUKAI;7737045952;Taip;0;3;0;3
10995;Salininkų;PAUKŠČIUKAI;9890660815;Taip;0;4;0;4
10996;Salininkų;PAUKŠČIUKAI;8995565864;Taip;6;6;0;12
10997;Salininkų;PAUKŠČIUKAI;7782972361;Taip;0;4;0;4
10998;Salininkų;PAUKŠČIUKAI;8394582546;Taip;0;11;0;11
10999;Salininkų;PAUKŠČIUKAI;6327046935;Taip;0;5;1;6
11000;Salininkų;PAUKŠČIUKAI;4425748908;Taip;0;5;0;5
11001;Salininkų;PAUKŠČIUKAI;4323257798;Taip;0;3;0;3
11002;Salininkų;PAUKŠČIUKAI;6266609965;Taip;0;6;0;6
11003;Salininkų;PAUKŠČIUKAI;3737834032;Taip;0;0;3;3
11004;Salininkų;PAUKŠČIUKAI;9813360176;Taip;0;2;1;3
11005;Salininkų;BITUTĖS;3252151974;Taip;12;0;1;13
11006;Salininkų;BITUTĖS;6845471044;Taip;0;0;4;4
11007;Salininkų;BITUTĖS;7253347059;Taip;6;0;3;9
11008;Salininkų;BITUTĖS;2467926286;Taip;0;4;0;4
11009;Salininkų;BITUTĖS;8774984357;Taip;0;0;8;8
11010;Salininkų;BITUTĖS;9902751686;Taip;0;1;0;1
11011;Salininkų;BITUTĖS;6125152143;Taip;3;1;0;4
11012;Salininkų;BITUTĖS;2095952937;Taip;2;1;0;3
11013;Salininkų;BITUTĖS;6551489987;Taip;0;6;0;6
11014;Salininkų;BITUTĖS;6979816464;Taip;0;3;0;3
11015;Salininkų;BITUTĖS;1928897962;Taip;5;1;0;6
11016;Salininkų;BITUTĖS;3527495230;Taip;0;3;0;3
11017;Salininkų;BITUTĖS;5582091833;Taip;4;1;0;5
11018;Salininkų;BITUTĖS;2073939432;Taip;2;0;4;6
11019;Salininkų;BITUTĖS;9996809930;Taip;0;0;7;7
11020;Salininkų;BITUTĖS;8992580214;Taip;0;14;0;14
11021;Salininkų;BITUTĖS;3915336062;Taip;11;0;0;11
11022;Salininkų;BITUTĖS;6577237672;Taip;4;3;1;8
11023;Salininkų;BITUTĖS;7115888747;Taip;5;0;3;8
11024;Salininkų;BITUTĖS;7639362434;Taip;0;3;3;6
11025;Salininkų;BITUTĖS;2370778977;Taip;0;0;6;6
11026;Salininkų;BITUTĖS;1020073382;Taip;0;0;6;6
11027;Salininkų;BITUTĖS;4480303856;Taip;0;3;5;8
11028;Salvija;Daigelis(šatil);1062662192;Taip;5;0;1;6
11029;Salvija;Daigelis(šatil);4577248630;Taip;0;12;0;12
11030;Salvija;Daigelis(šatil);9978634888;Taip;0;0;18;18
11031;Salvija;Daigelis(šatil);1676795179;Taip;0;0;3;3
11032;Salvija;Daigelis(šatil);6509829735;Taip;0;0;1;1
11033;Salvija;Daigelis(šatil);4665919836;Taip;8;0;0;8
11034;Salvija;Daigelis(šatil);1511271658;Taip;0;2;1;3
11035;Salvija;Daigelis(šatil);3345231579;Taip;0;12;1;13
11036;Salvija;Daigelis(šatil);3640213912;Taip;0;0;4;4
11037;Salvija;Daigelis(šatil);1509182157;Taip;0;0;2;2
11038;Salvija;Daigelis(šatil);8337554678;Taip;0;1;1;2
11039;Salvija;Daigelis(šatil);5327735648;Taip;3;5;5;13
11040;Salvija;Daigelis(šatil);5805537864;Taip;0;2;0;2
11041;Salvija;Daigelis(šatil);6323383244;Taip;0;13;0;13
11042;Salvija;Daigelis(šatil);1043297837;Taip;10;0;8;18
11043;Salvija;Daigelis(šatil);3857916185;Taip;0;0;6;6
11044;Salvija;Daigelis(šatil);4719344565;Taip;0;0;4;4
11045;Salvija;Daigelis(šatil);5554431690;Taip;18;0;0;18
11046;Salvija;Daigelis(šatil);1065575041;Taip;18;0;0;18
11047;Salvija;Daigelis(šatil);1168900211;Taip;0;0;1;1
11048;Salvija;Daigelis(šatil);7410091250;Taip;9;0;1;10
11049;Salvija;"Pienė (savjon)";5494438837;Taip;0;3;0;3
11050;Salvija;"Pienė (savjon)";8023422294;Taip;5;0;1;6
11051;Salvija;"Pienė (savjon)";4152602039;Taip;6;0;3;9
11052;Salvija;"Pienė (savjon)";8981331532;Taip;0;3;3;6
11053;Salvija;"Pienė (savjon)";7455466649;Taip;1;0;0;1
11054;Salvija;"Pienė (savjon)";8306404275;Taip;0;3;4;7
11055;Salvija;"Pienė (savjon)";8013023311;Taip;0;3;1;4
11056;Salvija;"Pienė (savjon)";1653831148;Taip;0;5;0;5
11057;Salvija;"Pienė (savjon)";4325636377;Taip;0;3;3;6
11058;Salvija;"Pienė (savjon)";1625197280;Taip;0;0;1;1
11059;Salvija;"Pienė (savjon)";8892646200;Taip;0;3;5;8
11060;Salvija;"Pienė (savjon)";7477171133;Taip;0;0;11;11
11061;Salvija;"Pienė (savjon)";6706565915;Taip;0;0;1;1
11062;Salvija;"Pienė (savjon)";8853389268;Taip;0;3;0;3
11063;Salvija;"Pienė (savjon)";3856351749;Taip;0;0;4;4
11064;Salvija;"Pienė (savjon)";8158680641;Taip;0;0;2;2
11065;Salvija;"Pienė (savjon)";7862619996;Ne;6;3;0;9
11066;Salvija;"Pienė (savjon)";3487446998;Taip;0;0;3;3
11067;Salvija;"Pienė (savjon)";4373711097;Taip;0;0;2;2
11068;Salvija;"Pienė (savjon)";5816893736;Taip;0;0;1;1
11069;Salvija;"Pienė (savjon)";1975032693;Taip;0;0;5;5
11070;Saulėtekis;BERŽELIS;3493175211;Taip;0;4;0;4
11071;Saulėtekis;BERŽELIS;8023603198;Taip;11;0;0;11
11072;Saulėtekis;BERŽELIS;8086451893;Taip;11;0;0;11
11073;Saulėtekis;BERŽELIS;9351122147;Taip;13;0;0;13
11074;Saulėtekis;BERŽELIS;6667804855;Taip;2;3;1;6
11075;Saulėtekis;BERŽELIS;1852180633;Taip;8;0;1;9
11076;Saulėtekis;BERŽELIS;5468364505;Taip;0;0;4;4
11077;Saulėtekis;BERŽELIS;4704426104;Taip;7;0;2;9
11078;Saulėtekis;BERŽELIS;7407540257;Taip;5;0;1;6
11079;Saulėtekis;BERŽELIS;6920619390;Taip;0;0;2;2
11080;Saulėtekis;BERŽELIS;7698241758;Taip;8;0;0;8
11081;Saulėtekis;BERŽELIS;5194925689;Taip;0;1;0;1
11082;Saulėtekis;BERŽELIS;7494641077;Taip;2;4;0;6
11083;Saulėtekis;BERŽELIS;1577609727;Taip;2;4;0;6
11084;Saulėtekis;BERŽELIS;2672108464;Taip;6;0;1;7
11085;Saulėtekis;BERŽELIS;9579088485;Taip;0;3;0;3
11086;Saulėtekis;BERŽELIS;2568544418;Taip;8;0;0;8
11087;Saulėtekis;BERŽELIS;8927598999;Taip;13;0;0;13
11088;Saulėtekis;BERŽELIS;9734188792;Taip;6;3;0;9
11089;Saulėtekis;BERŽELIS;6983324115;Taip;0;3;0;3
11090;Saulėtekis;BERŽELIS;8061477303;Taip;5;3;0;8
11091;Saulėtekis;BERŽELIS;7436158953;Taip;0;3;2;5
11092;Saulėtekis;ŠYPSENA;1720125332;Ne;0;1;0;1
11093;Saulėtekis;ŠYPSENA;9972687066;Taip;2;4;0;6
11094;Saulėtekis;ŠYPSENA;7346852524;Taip;9;2;0;11
11095;Saulėtekis;ŠYPSENA;6072030240;Taip;7;3;0;10
11096;Saulėtekis;ŠYPSENA;7893982893;Taip;0;6;1;7
11097;Saulėtekis;ŠYPSENA;7505040675;Taip;0;4;1;5
11098;Saulėtekis;ŠYPSENA;9791926936;Taip;7;0;0;7
11099;Saulėtekis;ŠYPSENA;8620689981;Taip;0;3;0;3
11100;Saulėtekis;ŠYPSENA;8143793642;Taip;0;4;0;4
11101;Saulėtekis;ŠYPSENA;7673965242;Taip;16;0;0;16
11102;Saulėtekis;ŠYPSENA;3166959569;Taip;0;0;2;2
11103;Saulėtekis;ŠYPSENA;9383567339;Taip;10;0;1;11
11104;Saulėtekis;ŠYPSENA;6608831217;Taip;5;3;0;8
11105;Saulėtekis;ŠYPSENA;7730889108;Taip;0;3;8;11
11106;Saulėtekis;ŠYPSENA;7435424899;Taip;0;3;2;5
11107;Saulėtekis;ŠYPSENA;7803735686;Taip;0;1;0;1
11108;Saulėtekis;ŠYPSENA;9694119292;Taip;15;0;3;18
11109;Saulėtekis;ŠYPSENA;8881524909;Taip;1;3;0;4
11110;Saulėtekis;ŠYPSENA;5518726567;Taip;2;2;0;4
11111;Saulėtekis;ŠYPSENA;2555073719;Ne;9;0;0;9
11112;Saulėtekis;ŠYPSENA;2177470008;Taip;0;0;6;6
11113;Saulėtekis;ŠYPSENA;4250589212;Taip;1;0;9;10
11114;Saulėtekis;NYKŠTUKAI;1896847801;Taip;0;2;0;2
11115;Saulėtekis;NYKŠTUKAI;7849181976;Taip;8;0;0;8
11116;Saulėtekis;NYKŠTUKAI;5748816813;Taip;3;4;0;7
11117;Saulėtekis;NYKŠTUKAI;7555273745;Taip;9;0;0;9
11118;Saulėtekis;NYKŠTUKAI;1416983683;Taip;6;1;0;7
11119;Saulėtekis;NYKŠTUKAI;4758423356;Taip;2;7;0;9
11120;Saulėtekis;NYKŠTUKAI;9270109327;Taip;3;3;0;6
11121;Saulėtekis;NYKŠTUKAI;8273890475;Taip;8;4;0;12
11122;Saulėtekis;NYKŠTUKAI;5183297420;Taip;3;4;0;7
11123;Saulėtekis;NYKŠTUKAI;8007704080;Taip;12;0;0;12
11124;Saulėtekis;NYKŠTUKAI;8683571534;Taip;15;0;0;15
11125;Saulėtekis;NYKŠTUKAI;9481578412;Taip;18;0;0;18
11126;Saulėtekis;NYKŠTUKAI;8167740525;Taip;9;0;0;9
11127;Saulėtekis;NYKŠTUKAI;3371045145;Taip;11;3;0;14
11128;Saulėtekis;NYKŠTUKAI;9818660340;Taip;0;3;2;5
11129;Saulėtekis;NYKŠTUKAI;3729811521;Taip;0;1;0;1
11130;Saulėtekis;NYKŠTUKAI;5888979911;Taip;0;6;0;6
11131;Saulėtekis;NYKŠTUKAI;9787534807;Taip;0;2;0;2
11132;Saulėtekis;NYKŠTUKAI;8090571664;Taip;9;0;0;9
11133;Saulėtekis;NYKŠTUKAI;9104549419;Ne;13;0;0;13
11134;Saulėtekis;NYKŠTUKAI;3957655772;Taip;12;3;0;15
11135;Saulėtekis;NYKŠTUKAI;3270283626;Taip;16;0;0;16
11136;Saulėtekis;PAGRANDUKAS;8102360466;Taip;6;3;2;11
11137;Saulėtekis;PAGRANDUKAS;2371396923;Taip;4;3;0;7
11138;Saulėtekis;PAGRANDUKAS;4152255439;Taip;0;3;0;3
11139;Saulėtekis;PAGRANDUKAS;2209156661;Taip;0;3;5;8
11140;Saulėtekis;PAGRANDUKAS;5552614092;Ne;0;3;0;3
11141;Saulėtekis;PAGRANDUKAS;9497129509;Taip;0;0;2;2
11142;Saulėtekis;PAGRANDUKAS;7186085219;Taip;0;3;4;7
11143;Saulėtekis;PAGRANDUKAS;1020209414;Taip;5;3;1;9
11144;Saulėtekis;PAGRANDUKAS;8745921541;Taip;9;3;0;12
11145;Saulėtekis;PAGRANDUKAS;2728836108;Taip;3;3;2;8
11146;Saulėtekis;PAGRANDUKAS;7164579375;Ne;0;3;0;3
11147;Saulėtekis;PAGRANDUKAS;8574702901;Taip;6;3;0;9
11148;Saulėtekis;PAGRANDUKAS;9941731250;Taip;0;0;4;4
11149;Saulėtekis;PAGRANDUKAS;4038684284;Taip;3;0;0;3
11150;Saulėtekis;PAGRANDUKAS;2935641362;Taip;0;0;3;3
11151;Saulėtekis;PAGRANDUKAS;4676218435;Taip;0;3;1;4
11152;Saulėtekis;PAGRANDUKAS;7598254324;Taip;15;0;0;15
11153;Saulėtekis;PAGRANDUKAS;6026600803;Taip;0;3;0;3
11154;Saulėtekis;PAGRANDUKAS;9737568538;Taip;0;2;1;3
11155;Saulėtekis;PAGRANDUKAS;8468491266;Taip;1;3;0;4
11156;Saulėtekis;PAGRANDUKAS;6181992249;Taip;9;0;0;9
11157;Saulėtekis;PAGRANDUKAS;8390615573;Taip;0;0;1;1
11158;Saulėtekis;PAGRANDUKAS;3366064429;Taip;0;3;0;3
11159;Saulėtekis;PAGRANDUKAS;5824537129;Taip;0;0;14;14
11160;Saulėtekis;RAMUNĖLIŲ;8739919774;Taip;9;0;0;9
11161;Saulėtekis;RAMUNĖLIŲ;4681031693;Taip;4;1;1;6
11162;Saulėtekis;RAMUNĖLIŲ;2316817605;Taip;0;3;0;3
11163;Saulėtekis;RAMUNĖLIŲ;3987535802;Taip;6;0;0;6
11164;Saulėtekis;RAMUNĖLIŲ;5297650157;Taip;0;3;0;3
11165;Saulėtekis;RAMUNĖLIŲ;6979741482;Taip;0;0;1;1
11166;Saulėtekis;RAMUNĖLIŲ;8348456528;Taip;8;0;1;9
11167;Saulėtekis;RAMUNĖLIŲ;3430209353;Taip;0;7;0;7
11168;Saulėtekis;RAMUNĖLIŲ;5980690239;Taip;5;3;0;8
11169;Saulėtekis;RAMUNĖLIŲ;2786112846;Taip;12;0;0;12
11170;Saulėtekis;RAMUNĖLIŲ;8876580678;Taip;12;0;0;12
11171;Saulėtekis;RAMUNĖLIŲ;1427323748;Taip;2;0;9;11
11172;Saulėtekis;RAMUNĖLIŲ;3224110585;Taip;11;5;0;16
11173;Saulėtekis;RAMUNĖLIŲ;2002180753;Taip;14;0;0;14
11174;Saulėtekis;RAMUNĖLIŲ;5685176596;Taip;0;2;0;2
11175;Saulėtekis;RAMUNĖLIŲ;9668125862;Taip;0;0;4;4
11176;Saulėtekis;RAMUNĖLIŲ;4736430248;Taip;0;8;0;8
11177;Saulėtekis;RAMUNĖLIŲ;1108736588;Taip;0;0;3;3
11178;Saulėtekis;RAMUNĖLIŲ;3680199463;Taip;4;3;3;10
11179;Saulėtekis;RAMUNĖLIŲ;2383861394;Taip;0;3;0;3
11180;Saulėtekis;RAMUNĖLIŲ;2872732978;Taip;8;6;0;14
11181;Saulėtekis;PASAKAITĖ;8033763960;Taip;5;0;0;5
11182;Saulėtekis;PASAKAITĖ;9428709415;Taip;0;0;1;1
11183;Saulėtekis;PASAKAITĖ;5086871001;Taip;11;0;0;11
11184;Saulėtekis;PASAKAITĖ;2446282019;Taip;0;5;0;5
11185;Saulėtekis;PASAKAITĖ;8572701238;Taip;3;4;0;7
11186;Saulėtekis;PASAKAITĖ;6063956790;Taip;7;5;0;12
11187;Saulėtekis;PASAKAITĖ;4437540996;Taip;9;3;0;12
11188;Saulėtekis;PASAKAITĖ;7407451018;Taip;0;7;0;7
11189;Saulėtekis;PASAKAITĖ;9226317303;Taip;4;4;0;8
11190;Saulėtekis;PASAKAITĖ;9267790598;Taip;5;2;0;7
11191;Saulėtekis;PASAKAITĖ;6670590135;Taip;3;0;0;3
11192;Saulėtekis;PASAKAITĖ;6720758829;Taip;5;1;0;6
11193;Saulėtekis;PASAKAITĖ;7966714585;Taip;12;0;0;12
11194;Saulėtekis;PASAKAITĖ;3224883243;Taip;4;13;0;17
11195;Saulėtekis;PASAKAITĖ;9382031144;Taip;0;6;0;6
11196;Saulėtekis;PASAKAITĖ;3371914339;Taip;7;3;0;10
11197;Saulėtekis;PASAKAITĖ;6214539956;Taip;13;1;0;14
11198;Saulėtekis;PASAKAITĖ;9584556476;Taip;8;2;0;10
11199;Saulėtekis;PASAKAITĖ;9799880235;Taip;5;3;0;8
11200;Saulėtekis;PASAKAITĖ;2469458604;Taip;0;2;0;2
11201;Saulėtekis;PASAKAITĖ;3499575148;Taip;0;2;0;2
11202;Saulėtekis;PASAKAITĖ;2206038658;Taip;9;3;0;12
11203;Saulėtekis;VARPELIAI;3303064486;Taip;11;3;3;17
11204;Saulėtekis;VARPELIAI;1355354514;Taip;6;2;0;8
11205;Saulėtekis;VARPELIAI;8195320453;Taip;0;0;7;7
11206;Saulėtekis;VARPELIAI;6534433593;Taip;2;0;2;4
11207;Saulėtekis;VARPELIAI;5997903066;Taip;0;0;10;10
11208;Saulėtekis;VARPELIAI;7338301696;Taip;7;0;3;10
11209;Saulėtekis;VARPELIAI;9383203972;Taip;5;0;1;6
11210;Saulėtekis;VARPELIAI;5870177112;Taip;0;3;2;5
11211;Saulėtekis;VARPELIAI;7171550857;Taip;7;0;4;11
11212;Saulėtekis;VARPELIAI;3157110037;Taip;15;3;0;18
11213;Saulėtekis;VARPELIAI;8331659142;Taip;6;2;0;8
11214;Saulėtekis;VARPELIAI;3832717108;Taip;15;0;0;15
11215;Saulėtekis;VARPELIAI;1198692142;Taip;9;0;1;10
11216;Saulėtekis;VARPELIAI;1240595768;Taip;0;0;2;2
11217;Saulėtekis;VARPELIAI;9246555859;Taip;0;0;5;5
11218;Saulėtekis;VARPELIAI;1479530265;Taip;8;3;1;12
11219;Saulėtekis;VARPELIAI;1164913351;Taip;0;3;4;7
11220;Saulėtekis;VARPELIAI;3499215193;Taip;5;0;1;6
11221;Saulėtekis;GRŪDELIS;1864236745;Taip;0;3;3;6
11222;Saulėtekis;GRŪDELIS;7171048750;Taip;0;0;2;2
11223;Saulėtekis;GRŪDELIS;6535620172;Taip;4;0;3;7
11224;Saulėtekis;GRŪDELIS;8252953405;Taip;0;3;4;7
11225;Saulėtekis;GRŪDELIS;8219644557;Taip;0;0;4;4
11226;Saulėtekis;GRŪDELIS;5218345414;Taip;5;0;0;5
11227;Saulėtekis;GRŪDELIS;9646060606;Taip;5;0;0;5
11228;Saulėtekis;GRŪDELIS;1934900185;Ne;9;4;0;13
11229;Saulėtekis;GRŪDELIS;1331793286;Taip;13;0;3;16
11230;Saulėtekis;GRŪDELIS;9995919137;Taip;9;3;0;12
11231;Saulėtekis;GRŪDELIS;6928825133;Taip;7;0;0;7
11232;Saulėtekis;GRŪDELIS;8138047893;Taip;13;0;0;13
11233;Saulėtekis;GRŪDELIS;3953501167;Taip;4;0;2;6
11234;Saulėtekis;GRŪDELIS;2799966199;Taip;0;13;0;13
11235;Saulėtekis;GRŪDELIS;2646213073;Taip;0;6;0;6
11236;Saulėtekis;GRŪDELIS;6482182524;Taip;0;0;2;2
11237;Saulėtekis;GRŪDELIS;6779891385;Taip;0;3;1;4
11238;Saulėtekis;GRŪDELIS;9743690247;Taip;13;0;0;13
11239;Saulėtekis;GRŪDELIS;7666624373;Taip;3;0;2;5
11240;Saulėtekis;JONVABALIS;1715634399;Taip;5;4;0;9
11241;Saulėtekis;JONVABALIS;7227802003;Taip;0;4;0;4
11242;Saulėtekis;JONVABALIS;4613040294;Taip;10;3;0;13
11243;Saulėtekis;JONVABALIS;1655720839;Taip;8;3;0;11
11244;Saulėtekis;JONVABALIS;3166181835;Taip;3;4;0;7
11245;Saulėtekis;JONVABALIS;6599452886;Taip;0;1;0;1
11246;Saulėtekis;JONVABALIS;8896065807;Taip;6;4;0;10
11247;Saulėtekis;JONVABALIS;3207128776;Taip;1;3;0;4
11248;Saulėtekis;JONVABALIS;2311184444;Taip;0;6;0;6
11249;Saulėtekis;JONVABALIS;9618342480;Taip;0;5;0;5
11250;Saulėtekis;JONVABALIS;1516164123;Taip;0;2;0;2
11251;Saulėtekis;JONVABALIS;60462712074;Taip;0;3;0;3
11252;Saulėtekis;JONVABALIS;1902333363;Taip;4;4;0;8
11253;Saulėtekis;JONVABALIS;4610536784;Ne;0;4;0;4
11254;Saulėtekis;JONVABALIS;8239855620;Taip;7;4;0;11
11255;Saulėtekis;JONVABALIS;6501250875;Taip;9;3;0;12
11256;Saulėtekis;JONVABALIS;8231869593;Taip;0;12;0;12
11257;Saulėtekis;JONVABALIS;8603952810;Taip;0;5;0;5
11258;Saulėtekis;JONVABALIS;9657195627;Taip;0;7;0;7
11259;Saulėtekis;JONVABALIS;3541535891;Taip;10;5;0;15
11260;Saulėtekis;JONVABALIS;4663268649;Taip;2;4;0;6
11261;Saulėtekis;JONVABALIS;25199011812;Taip;0;3;0;3
11262;Saulėtekis;SMALSUČIAI;2474900044;Taip;0;3;0;3
11263;Saulėtekis;SMALSUČIAI;7051608858;Taip;5;3;0;8
11264;Saulėtekis;SMALSUČIAI;2021901593;Taip;0;3;0;3
11265;Saulėtekis;SMALSUČIAI;5954194843;Taip;0;2;0;2
11266;Saulėtekis;SMALSUČIAI;2546789906;Taip;2;1;0;3
11267;Saulėtekis;SMALSUČIAI;8002806189;Taip;0;1;0;1
11268;Saulėtekis;SMALSUČIAI;4832534190;Taip;6;3;0;9
11269;Saulėtekis;SMALSUČIAI;2238947856;Taip;0;4;2;6
11270;Saulėtekis;SMALSUČIAI;5678858566;Taip;0;4;0;4
11271;Saulėtekis;SMALSUČIAI;2407911405;Taip;0;2;0;2
11272;Saulėtekis;SMALSUČIAI;9634949452;Taip;0;3;1;4
11273;Saulėtekis;SMALSUČIAI;3450907715;Ne;7;8;0;15
11274;Saulėtekis;SMALSUČIAI;4338502152;Taip;0;1;0;1
11275;Saulėtekis;SMALSUČIAI;81153273188;Taip;0;2;0;2
11276;Saulėtekis;SMALSUČIAI;6102064617;Taip;0;4;0;4
11277;Saulėtekis;SMALSUČIAI;7842280836;Taip;0;5;1;6
11278;Saulėtekis;SMALSUČIAI;9945647968;Taip;0;4;0;4
11279;Saulėtekis;SMALSUČIAI;9983577817;Taip;0;3;1;4
11280;Saulėtekis;SMALSUČIAI;84982517658;Taip;0;1;2;3
11281;Saulėtekis;SMALSUČIAI;5487547105;Ne;0;18;0;18
11282;Saulėtekis;SMALSUČIAI;1922979974;Taip;4;3;0;7
11283;Saulėtekis;BITUTĖS;7766084857;Taip;0;3;3;6
11284;Saulėtekis;BITUTĖS;4537254306;Taip;0;3;0;3
11285;Saulėtekis;BITUTĖS;1699576940;Taip;0;3;0;3
11286;Saulėtekis;BITUTĖS;1481503733;Taip;0;3;0;3
11287;Saulėtekis;BITUTĖS;8302260087;Taip;5;3;0;8
11288;Saulėtekis;BITUTĖS;2593106154;Taip;7;1;1;9
11289;Saulėtekis;BITUTĖS;2813949848;Taip;10;3;0;13
11290;Saulėtekis;BITUTĖS;6643388548;Taip;5;3;1;9
11291;Saulėtekis;BITUTĖS;3058991890;Taip;10;3;0;13
11292;Saulėtekis;BITUTĖS;7986712728;Taip;6;5;0;11
11293;Saulėtekis;BITUTĖS;6087170055;Taip;2;3;5;10
11294;Saulėtekis;BITUTĖS;7758268674;Taip;10;3;0;13
11295;Saulėtekis;BITUTĖS;2077976415;Taip;0;3;3;6
11296;Saulėtekis;BITUTĖS;7075757274;Taip;0;3;6;9
11297;Saulėtekis;BITUTĖS;9870595577;Taip;0;2;1;3
11298;Saulėtekis;BITUTĖS;2154590089;Taip;0;3;0;3
11299;Saulėtekis;BITUTĖS;3220993253;Taip;3;4;0;7
11300;Saulėtekis;BITUTĖS;9918219913;Taip;0;3;3;6
11301;Saulėtekis;BITUTĖS;2698535938;Taip;0;3;0;3
11302;Saulėtekis;BITUTĖS;8517049464;Taip;0;3;0;3
11303;Saulėtekis;BITUTĖS;2656659133;Taip;3;4;2;9
11304;Saulėtekis;BITUTĖS;7027103276;Taip;10;3;1;14
11305;Saulėtekis;BITUTĖS;9605052795;Taip;5;3;2;10
11306;Saulėtekis;RIEŠUTĖLIAI;8767786444;Taip;13;0;1;14
11307;Saulėtekis;RIEŠUTĖLIAI;2224626144;Taip;10;0;0;10
11308;Saulėtekis;RIEŠUTĖLIAI;9270231819;Taip;0;0;2;2
11309;Saulėtekis;RIEŠUTĖLIAI;5898051775;Taip;3;0;0;3
11310;Saulėtekis;RIEŠUTĖLIAI;7898928446;Taip;3;3;0;6
11311;Saulėtekis;RIEŠUTĖLIAI;3356705340;Taip;18;0;0;18
11312;Saulėtekis;RIEŠUTĖLIAI;2849915655;Taip;10;0;0;10
11313;Saulėtekis;RIEŠUTĖLIAI;7824492464;Taip;7;0;1;8
11314;Saulėtekis;RIEŠUTĖLIAI;3935935671;Taip;2;0;0;2
11315;Saulėtekis;RIEŠUTĖLIAI;7807096583;Taip;11;0;0;11
11316;Saulėtekis;RIEŠUTĖLIAI;2548612572;Taip;13;0;0;13
11317;Saulėtekis;RIEŠUTĖLIAI;2908714227;Taip;15;0;0;15
11318;Saulėtekis;RIEŠUTĖLIAI;7305619721;Taip;0;14;0;14
11319;Saulėtekis;RIEŠUTĖLIAI;9516841263;Taip;1;0;4;5
11320;Saulėtekis;RIEŠUTĖLIAI;6557482092;Taip;3;0;0;3
11321;Saulėtekis;RIEŠUTĖLIAI;6183384994;Taip;13;0;0;13
11322;Saulėtekis;RIEŠUTĖLIAI;1540848694;Taip;0;6;0;6
11323;Saulėtekis;RIEŠUTĖLIAI;3559882322;Taip;3;0;1;4
11324;Saulėtekis;RIEŠUTĖLIAI;4767842376;Taip;7;0;3;10
11325;Skroblinukas;SVIRPLIUKŲ;5433647187;Taip;4;5;0;9
11326;Skroblinukas;SVIRPLIUKŲ;2195112297;Taip;15;1;2;18
11327;Skroblinukas;SVIRPLIUKŲ;4198512202;Taip;0;0;18;18
11328;Skroblinukas;SVIRPLIUKŲ;7750501815;Taip;16;0;0;16
11329;Skroblinukas;SVIRPLIUKŲ;4960825597;Taip;0;3;0;3
11330;Skroblinukas;SVIRPLIUKŲ;1544598440;Taip;10;3;0;13
11331;Skroblinukas;SVIRPLIUKŲ;6574558658;Taip;0;1;3;4
11332;Skroblinukas;SVIRPLIUKŲ;4861971439;Taip;8;0;7;15
11333;Skroblinukas;SVIRPLIUKŲ;7817632987;Taip;3;4;0;7
11334;Skroblinukas;SVIRPLIUKŲ;7675772872;Taip;0;0;4;4
11335;Skroblinukas;SVIRPLIUKŲ;4266945644;Taip;5;0;3;8
11336;Skroblinukas;SVIRPLIUKŲ;9003855190;Taip;0;14;1;15
11337;Skroblinukas;SVIRPLIUKŲ;7216760382;Taip;13;0;0;13
11338;Skroblinukas;SVIRPLIUKŲ;5154111867;Taip;10;3;0;13
11339;Skroblinukas;SVIRPLIUKŲ;8622930871;Taip;13;1;4;18
11340;Skroblinukas;SVIRPLIUKŲ;9661609284;Taip;0;0;3;3
11341;Skroblinukas;SVIRPLIUKŲ;3260267388;Taip;0;0;8;8
11342;Skroblinukas;SVIRPLIUKŲ;7761972818;Taip;0;1;0;1
11343;Skroblinukas;SVIRPLIUKŲ;9629502585;Taip;8;2;0;10
11344;Skroblinukas;SVIRPLIUKŲ;6461678336;Taip;0;3;4;7
11345;Skroblinukas;SVIRPLIUKŲ;8283516422;Taip;7;0;1;8
11346;Skroblinukas;GANDRIUKŲ;2197158518;Taip;0;3;0;3
11347;Skroblinukas;GANDRIUKŲ;2406619611;Taip;0;3;0;3
11348;Skroblinukas;GANDRIUKŲ;9572912046;Taip;0;18;0;18
11349;Skroblinukas;GANDRIUKŲ;5646847921;Taip;10;3;0;13
11350;Skroblinukas;GANDRIUKŲ;1851920334;Taip;5;6;2;13
11351;Skroblinukas;GANDRIUKŲ;9377215921;Taip;10;2;1;13
11352;Skroblinukas;GANDRIUKŲ;6235844690;Taip;0;1;1;2
11353;Skroblinukas;GANDRIUKŲ;6489976163;Taip;10;1;1;12
11354;Skroblinukas;GANDRIUKŲ;1159546580;Taip;0;4;0;4
11355;Skroblinukas;GANDRIUKŲ;2630699296;Taip;0;3;0;3
11356;Skroblinukas;GANDRIUKŲ;2310750833;Taip;0;5;0;5
11357;Skroblinukas;GANDRIUKŲ;9888115079;Ne;0;3;3;6
11358;Skroblinukas;GANDRIUKŲ;9475514959;Ne;0;5;0;5
11359;Skroblinukas;GANDRIUKŲ;9031598603;Taip;8;2;1;11
11360;Skroblinukas;GANDRIUKŲ;5251903769;Ne;5;9;0;14
11361;Skroblinukas;GANDRIUKŲ;7385271438;Taip;0;1;2;3
11362;Skroblinukas;VYTURIUKŲ;3954228349;Taip;7;0;2;9
11363;Skroblinukas;VYTURIUKŲ;6879979868;Taip;0;3;1;4
11364;Skroblinukas;VYTURIUKŲ;4560580022;Taip;0;3;0;3
11365;Skroblinukas;VYTURIUKŲ;2330232287;Taip;0;0;2;2
11366;Skroblinukas;VYTURIUKŲ;3065235192;Taip;0;2;2;4
11367;Skroblinukas;VYTURIUKŲ;5902713448;Taip;0;4;0;4
11368;Skroblinukas;VYTURIUKŲ;3594000419;Taip;0;7;0;7
11369;Skroblinukas;VYTURIUKŲ;3512297435;Taip;0;7;0;7
11370;Skroblinukas;VYTURIUKŲ;2481980627;Taip;9;3;0;12
11371;Skroblinukas;VYTURIUKŲ;6293879765;Taip;0;0;3;3
11372;Skroblinukas;VYTURIUKŲ;9725125130;Taip;0;3;0;3
11373;Skroblinukas;VYTURIUKŲ;2978284436;Taip;0;0;4;4
11374;Skroblinukas;VYTURIUKŲ;7068452970;Taip;0;0;2;2
11375;Skroblinukas;VYTURIUKŲ;3292517112;Taip;0;2;0;2
11376;Skroblinukas;VYTURIUKŲ;3461165182;Taip;9;0;3;12
11377;Skroblinukas;VYTURIUKŲ;4129726208;Taip;4;0;1;5
11378;Skroblinukas;VYTURIUKŲ;3351309750;Taip;3;0;1;4
11379;Skroblinukas;VYTURIUKŲ;5101136022;Ne;0;16;0;16
11380;Skroblinukas;VYTURIUKŲ;9828486832;Taip;0;3;5;8
11381;Skroblinukas;GENIUKŲ;48655837755;Taip;0;3;0;3
11382;Skroblinukas;GENIUKŲ;2323980730;Taip;0;3;0;3
11383;Skroblinukas;GENIUKŲ;1325903217;Taip;0;6;0;6
11384;Skroblinukas;GENIUKŲ;8380073853;Taip;0;8;0;8
11385;Skroblinukas;GENIUKŲ;4436698905;Taip;0;7;0;7
11386;Skroblinukas;GENIUKŲ;1905085978;Taip;0;2;1;3
11387;Skroblinukas;GENIUKŲ;1557733803;Taip;4;4;0;8
11388;Skroblinukas;GENIUKŲ;9433465007;Taip;8;3;0;11
11389;Skroblinukas;GENIUKŲ;1395950886;Ne;0;3;0;3
11390;Skroblinukas;GENIUKŲ;1696303051;Taip;0;3;0;3
11391;Skroblinukas;GENIUKŲ;9846569195;Taip;0;3;0;3
11392;Skroblinukas;GENIUKŲ;4773576465;Taip;0;7;0;7
11393;Skroblinukas;GENIUKŲ;2704157855;Taip;0;3;0;3
11394;Skroblinukas;GENIUKŲ;9564385215;Taip;0;10;0;10
11395;Skroblinukas;GENIUKŲ;6129591146;Taip;0;4;0;4
11396;Skroblinukas;GENIUKŲ;3128337104;Taip;0;4;2;6
11397;Skroblinukas;GENIUKŲ;4272941994;Taip;11;3;1;15
11398;Skroblinukas;GENIUKŲ;3864043251;Taip;0;3;0;3
11399;Skroblinukas;GENIUKŲ;1064449916;Taip;0;3;2;5
11400;Skroblinukas;GENIUKŲ;2071447940;Taip;0;5;0;5
11401;Skroblinukas;BITUČIŲ;1255323441;Taip;0;4;1;5
11402;Skroblinukas;BITUČIŲ;1934804499;Taip;5;4;0;9
11403;Skroblinukas;BITUČIŲ;2134821488;Taip;5;3;0;8
11404;Skroblinukas;BITUČIŲ;6604496585;Taip;0;3;0;3
11405;Skroblinukas;BITUČIŲ;3736883850;Taip;0;2;0;2
11406;Skroblinukas;BITUČIŲ;7191689856;Taip;5;6;0;11
11407;Skroblinukas;BITUČIŲ;8778072326;Taip;0;3;0;3
11408;Skroblinukas;BITUČIŲ;2032621707;Taip;0;4;5;9
11409;Skroblinukas;BITUČIŲ;8277152812;Taip;0;2;0;2
11410;Skroblinukas;BITUČIŲ;8374103872;Taip;0;4;0;4
11411;Skroblinukas;BITUČIŲ;8618587013;Taip;0;3;0;3
11412;Skroblinukas;BITUČIŲ;4945107862;Ne;0;2;0;2
11413;Skroblinukas;BITUČIŲ;9594078223;Taip;0;4;0;4
11414;Skroblinukas;BITUČIŲ;1688990637;Taip;10;3;0;13
11415;Skroblinukas;BITUČIŲ;1957488412;Taip;0;5;1;6
11416;Skroblinukas;BITUČIŲ;1000804920;Taip;0;3;0;3
11417;Skroblinukas;BITUČIŲ;1711568129;Ne;0;3;3;6
11418;Skroblinukas;BITUČIŲ;1293348150;Taip;0;2;1;3
11419;Skroblinukas;BITUČIŲ;9664357125;Taip;0;3;1;4
11420;Skroblinukas;BITUČIŲ;5001921323;Taip;10;2;0;12
11421;Skroblinukas;BITUČIŲ;6227583229;Taip;0;5;0;5
11422;Skroblinukas;BORUŽĖLIŲ;8715188878;Taip;0;15;2;17
11423;Skroblinukas;BORUŽĖLIŲ;4688496560;Taip;0;1;0;1
11424;Skroblinukas;BORUŽĖLIŲ;7407601996;Taip;0;1;0;1
11425;Skroblinukas;BORUŽĖLIŲ;7255510731;Taip;6;0;2;8
11426;Skroblinukas;BORUŽĖLIŲ;5841866621;Taip;5;0;2;7
11427;Skroblinukas;BORUŽĖLIŲ;9341501143;Taip;11;0;0;11
11428;Skroblinukas;BORUŽĖLIŲ;2523742608;Taip;10;3;0;13
11429;Skroblinukas;BORUŽĖLIŲ;2311459579;Taip;10;3;0;13
11430;Skroblinukas;BORUŽĖLIŲ;3490684777;Taip;19;0;0;19
11431;Skroblinukas;BORUŽĖLIŲ;2717586232;Taip;0;9;1;10
11432;Skroblinukas;BORUŽĖLIŲ;4840767748;Taip;8;0;0;8
11433;Skroblinukas;BORUŽĖLIŲ;5694105568;Taip;8;0;5;13
11434;Skroblinukas;BORUŽĖLIŲ;7771969055;Taip;0;3;4;7
11435;Skroblinukas;BORUŽĖLIŲ;4631657273;Taip;13;0;0;13
11436;Skroblinukas;BORUŽĖLIŲ;8711201474;Ne;0;11;0;11
11437;Skroblinukas;SKRUZDĖLIUKŲ;5688453546;Taip;0;5;1;6
11438;Skroblinukas;SKRUZDĖLIUKŲ;6890306112;Taip;0;12;0;12
11439;Skroblinukas;SKRUZDĖLIUKŲ;6445065388;Taip;0;10;0;10
11440;Skroblinukas;SKRUZDĖLIUKŲ;3006521657;Taip;0;3;0;3
11441;Skroblinukas;SKRUZDĖLIUKŲ;9448253468;Taip;6;0;0;6
11442;Skroblinukas;SKRUZDĖLIUKŲ;3771045336;Taip;0;2;0;2
11443;Skroblinukas;SKRUZDĖLIUKŲ;4424763028;Taip;0;3;0;3
11444;Skroblinukas;SKRUZDĖLIUKŲ;9353353289;Taip;0;5;0;5
11445;Skroblinukas;SKRUZDĖLIUKŲ;5252389111;Taip;8;4;0;12
11446;Skroblinukas;SKRUZDĖLIUKŲ;2883593274;Taip;8;2;1;11
11447;Skroblinukas;SKRUZDĖLIUKŲ;7493915017;Taip;0;3;2;5
11448;Skroblinukas;SKRUZDĖLIUKŲ;5157913924;Taip;0;8;0;8
11449;Skroblinukas;SKRUZDĖLIUKŲ;9368764758;Taip;0;3;0;3
11450;Skroblinukas;SKRUZDĖLIUKŲ;9958188318;Taip;0;8;0;8
11451;Skroblinukas;SKRUZDĖLIUKŲ;8576448571;Taip;6;4;0;10
11452;Skroblinukas;SKRUZDĖLIUKŲ;1002570367;Ne;0;4;0;4
11453;Skroblinukas;SKRUZDĖLIUKŲ;3290115134;Taip;0;3;2;5
11454;Skroblinukas;SKRUZDĖLIUKŲ;9813249677;Taip;0;4;0;4
11455;Skroblinukas;SKRUZDĖLIUKŲ;2101748012;Taip;0;3;0;3
11456;Skroblinukas;SKRUZDĖLIUKŲ;2706526326;Ne;0;0;1;1
11457;Skroblinukas;SKRUZDĖLIUKŲ;5915278745;Taip;0;2;0;2
11458;Skroblinukas;SKRUZDĖLIUKŲ;6640062847;Ne;3;5;0;8
11459;Skroblinukas;ŽVIRBLIUKŲ;9162582460;Taip;0;0;5;5
11460;Skroblinukas;ŽVIRBLIUKŲ;7955574061;Taip;7;0;0;7
11461;Skroblinukas;ŽVIRBLIUKŲ;7489143683;Taip;0;2;2;4
11462;Skroblinukas;ŽVIRBLIUKŲ;6717008836;Taip;5;0;2;7
11463;Skroblinukas;ŽVIRBLIUKŲ;1232121301;Ne;8;1;1;10
11464;Skroblinukas;ŽVIRBLIUKŲ;1014993354;Taip;5;5;0;10
11465;Skroblinukas;ŽVIRBLIUKŲ;1167332689;Taip;5;0;0;5
11466;Skroblinukas;ŽVIRBLIUKŲ;7527177120;Taip;0;9;4;13
11467;Skroblinukas;ŽVIRBLIUKŲ;4002729040;Taip;10;0;0;10
11468;Skroblinukas;ŽVIRBLIUKŲ;4197050176;Taip;5;6;0;11
11469;Skroblinukas;ŽVIRBLIUKŲ;4390614970;Taip;11;0;0;11
11470;Skroblinukas;ŽVIRBLIUKŲ;6070633607;Taip;7;0;0;7
11471;Skroblinukas;ŽVIRBLIUKŲ;6135412007;Taip;16;0;0;16
11472;Skroblinukas;ŽVIRBLIUKŲ;2312400921;Taip;16;0;0;16
11473;Skroblinukas;ŽVIRBLIUKŲ;4491947846;Taip;5;8;2;15
11474;Skroblinukas;ŽIOGELIŲ;2885814517;Taip;0;9;0;9
11475;Skroblinukas;ŽIOGELIŲ;2363368201;Taip;0;3;2;5
11476;Skroblinukas;ŽIOGELIŲ;4639384934;Taip;7;0;4;11
11477;Skroblinukas;ŽIOGELIŲ;5206925237;Taip;16;0;1;17
11478;Skroblinukas;ŽIOGELIŲ;7581372511;Taip;0;0;8;8
11479;Skroblinukas;ŽIOGELIŲ;8998236911;Taip;7;3;0;10
11480;Skroblinukas;ŽIOGELIŲ;6791969485;Taip;0;5;7;12
11481;Skroblinukas;ŽIOGELIŲ;9737310101;Taip;0;0;10;10
11482;Skroblinukas;ŽIOGELIŲ;8680329175;Taip;3;0;4;7
11483;Skroblinukas;ŽIOGELIŲ;8118284793;Taip;0;0;4;4
11484;Skroblinukas;ŽIOGELIŲ;1844211217;Taip;5;0;2;7
11485;Skroblinukas;ŽIOGELIŲ;5354832150;Taip;0;4;0;4
11486;Skroblinukas;ŽIOGELIŲ;3689247672;Taip;9;0;0;9
11487;Skroblinukas;STRAZDELIŲ;1820748152;Taip;9;8;0;17
11488;Skroblinukas;STRAZDELIŲ;5946356374;Taip;5;0;3;8
11489;Skroblinukas;STRAZDELIŲ;5274898590;Taip;0;4;0;4
11490;Skroblinukas;STRAZDELIŲ;8629189405;Taip;0;0;2;2
11491;Skroblinukas;STRAZDELIŲ;4091852305;Taip;0;2;0;2
11492;Skroblinukas;STRAZDELIŲ;9809817630;Taip;18;0;0;18
11493;Skroblinukas;STRAZDELIŲ;6475609065;Taip;3;0;0;3
11494;Skroblinukas;STRAZDELIŲ;1762416639;Taip;5;0;0;5
11495;Skroblinukas;STRAZDELIŲ;3705638869;Taip;0;0;3;3
11496;Skroblinukas;STRAZDELIŲ;2511496284;Taip;6;0;1;7
11497;Skroblinukas;STRAZDELIŲ;7153774246;Ne;0;0;6;6
11498;Skroblinukas;STRAZDELIŲ;7045587415;Taip;5;0;2;7
11499;Skroblinukas;STRAZDELIŲ;8734405028;Taip;0;4;2;6
11500;Skroblinukas;STRAZDELIŲ;3885884265;Taip;0;0;4;4
11501;Skroblinukas;STRAZDELIŲ;6011466024;Ne;0;3;0;3
11502;Skroblinukas;DRUGELIŲ;8305867345;Taip;0;1;1;2
11503;Skroblinukas;DRUGELIŲ;7400908711;Ne;5;8;0;13
11504;Skroblinukas;DRUGELIŲ;3889890374;Taip;0;1;0;1
11505;Skroblinukas;DRUGELIŲ;9481718833;Taip;3;0;5;8
11506;Skroblinukas;DRUGELIŲ;2772360168;Taip;0;3;0;3
11507;Skroblinukas;DRUGELIŲ;3624518310;Taip;8;1;1;10
11508;Skroblinukas;DRUGELIŲ;4831370981;Taip;0;1;0;1
11509;Skroblinukas;DRUGELIŲ;5957417413;Taip;10;3;0;13
11510;Skroblinukas;DRUGELIŲ;3226115050;Taip;0;2;0;2
11511;Skroblinukas;DRUGELIŲ;2887161771;Taip;0;3;0;3
11512;Skroblinukas;DRUGELIŲ;4737605061;Ne;5;9;1;15
11513;Skroblinukas;DRUGELIŲ;3046542264;Taip;0;3;0;3
11514;Skroblinukas;DRUGELIŲ;8390240445;Taip;0;0;4;4
11515;Skroblinukas;DRUGELIŲ;2948231687;Taip;10;0;0;10
11516;Skroblinukas;DRUGELIŲ;5912771080;Taip;7;2;0;9
11517;Skroblinukas;DRUGELIŲ;7528824951;Taip;0;0;3;3
11518;Skroblinukas;DRUGELIŲ;2987938909;Taip;7;4;0;11
11519;Skroblinukas;DRUGELIŲ;8286842648;Taip;10;0;0;10
11520;Skroblinukas;DRUGELIŲ;1453029732;Taip;0;6;0;6
11521;Skroblinukas;PELĖDŽIUKŲ;8953844650;Taip;3;1;1;5
11522;Skroblinukas;PELĖDŽIUKŲ;5813075721;Taip;0;0;1;1
11523;Skroblinukas;PELĖDŽIUKŲ;3646325903;Taip;3;8;0;11
11524;Skroblinukas;PELĖDŽIUKŲ;9292990596;Taip;15;0;0;15
11525;Skroblinukas;PELĖDŽIUKŲ;8202855376;Taip;4;1;1;6
11526;Skroblinukas;PELĖDŽIUKŲ;8312341293;Taip;0;0;1;1
11527;Skroblinukas;PELĖDŽIUKŲ;3658815079;Taip;10;0;0;10
11528;Skroblinukas;PELĖDŽIUKŲ;5418212729;Taip;0;4;0;4
11529;Skroblinukas;PELĖDŽIUKŲ;4168542339;Taip;0;8;0;8
11530;Skroblinukas;PELĖDŽIUKŲ;8958893525;Taip;0;0;1;1
11531;Skroblinukas;PELĖDŽIUKŲ;6675716937;Taip;0;0;10;10
11532;Skroblinukas;PELĖDŽIUKŲ;1009065470;Taip;0;4;2;6
11533;Skroblinukas;PELĖDŽIUKŲ;9699407871;Taip;0;2;5;7
11534;Skroblinukas;PELĖDŽIUKŲ;9553242594;Taip;0;11;0;11
11535;Skroblinukas;PELĖDŽIUKŲ;4802801867;Taip;5;1;3;9
11536;Skroblinukas;PELĖDŽIUKŲ;3532258904;Taip;6;1;1;8
11537;Skroblinukas;PELĖDŽIUKŲ;1758987652;Taip;0;0;2;2
11538;Skroblinukas;PELĖDŽIUKŲ;8465074037;Taip;0;0;7;7
11539;Skroblinukas;PELĖDŽIUKŲ;2071093890;Taip;0;4;1;5
11540;Skroblinukas;PELĖDŽIUKŲ;9523720873;Taip;13;0;3;16
11541;Skroblinukas;PELĖDŽIUKŲ;7920117036;Taip;7;1;4;12
11542;Skroblinukas;PELĖDŽIUKŲ;2215428081;Taip;0;9;0;9
11543;Smalsučiai;Žibuoklės;6535494814;Taip;5;0;1;6
11544;Smalsučiai;Žibuoklės;3309134310;Taip;0;4;0;4
11545;Smalsučiai;Žibuoklės;2326167599;Taip;1;1;0;2
11546;Smalsučiai;Žibuoklės;4094037708;Taip;9;0;0;9
11547;Smalsučiai;Žibuoklės;5893045664;Taip;0;3;0;3
11548;Smalsučiai;Žibuoklės;5482692473;Taip;5;1;0;6
11549;Smalsučiai;Žibuoklės;2742992400;Taip;8;0;4;12
11550;Smalsučiai;Žibuoklės;6299355505;Taip;7;4;0;11
11551;Smalsučiai;Žibuoklės;3877274360;Taip;0;3;0;3
11552;Smalsučiai;Žibuoklės;7726086066;Taip;0;3;0;3
11553;Smalsučiai;Žibuoklės;9988599126;Taip;0;0;2;2
11554;Smalsučiai;Žibuoklės;5489140006;Taip;0;3;0;3
11555;Smalsučiai;Žibuoklės;5900294530;Taip;0;5;2;7
11556;Smalsučiai;Žibuoklės;8644849194;Taip;0;4;0;4
11557;Smalsučiai;Žibuoklės;4506058735;Taip;0;8;1;9
11558;Smalsučiai;Žibuoklės;6931092874;Taip;9;3;1;13
11559;Smalsučiai;Žibuoklės;3071594259;Taip;0;3;0;3
11560;Smalsučiai;Žibuoklės;7107126092;Taip;0;3;0;3
11561;Smalsučiai;Žibuoklės;7070240693;Taip;0;6;0;6
11562;Smalsučiai;Aitvarų;3349726106;Taip;2;2;0;4
11563;Smalsučiai;Aitvarų;9305837033;Taip;5;0;1;6
11564;Smalsučiai;Aitvarų;9305837033;Taip;5;0;1;6
11565;Smalsučiai;Aitvarų;9305837033;Taip;5;0;1;6
11566;Smalsučiai;Aitvarų;8877566394;Taip;5;3;0;8
11567;Smalsučiai;Aitvarų;8284740122;Taip;7;3;4;14
11568;Smalsučiai;Aitvarų;1309254661;Taip;0;3;4;7
11569;Smalsučiai;Aitvarų;4154327720;Taip;0;6;0;6
11570;Smalsučiai;Aitvarų;8985656809;Taip;9;1;2;12
11571;Smalsučiai;Aitvarų;6032887449;Taip;5;4;0;9
11572;Smalsučiai;Aitvarų;9821259659;Taip;0;8;0;8
11573;Smalsučiai;Aitvarų;4054278651;Ne;10;0;1;11
11574;Smalsučiai;Aitvarų;6232068532;Taip;7;4;1;12
11575;Smalsučiai;Aitvarų;3157534923;Taip;5;3;4;12
11576;Smalsučiai;Aitvarų;6825499095;Taip;5;1;2;8
11577;Smalsučiai;Aitvarų;4832292565;Taip;0;2;0;2
11578;Smalsučiai;Aitvarų;2835117069;Taip;0;3;0;3
11579;Smalsučiai;Aitvarų;2610753472;Taip;0;3;0;3
11580;Smalsučiai;Aitvarų;6090244401;Taip;0;0;1;1
11581;Smalsučiai;Aitvarų;4168864882;Taip;0;0;2;2
11582;Smalsučiai;Sraigiukų;7933302912;Taip;0;2;0;2
11583;Smalsučiai;Sraigiukų;1471941426;Taip;0;5;1;6
11584;Smalsučiai;Sraigiukų;1458544456;Taip;0;8;0;8
11585;Smalsučiai;Sraigiukų;5406430393;Taip;8;3;0;11
11586;Smalsučiai;Sraigiukų;9582225178;Taip;0;5;0;5
11587;Smalsučiai;Sraigiukų;9604182559;Taip;0;11;0;11
11588;Smalsučiai;Sraigiukų;6469604093;Taip;0;2;2;4
11589;Smalsučiai;Sraigiukų;4364810458;Taip;0;3;0;3
11590;Smalsučiai;Sraigiukų;4566816316;Taip;0;4;0;4
11591;Smalsučiai;Sraigiukų;5184903287;Taip;0;3;0;3
11592;Smalsučiai;Sraigiukų;4629526320;Taip;0;3;0;3
11593;Smalsučiai;Sraigiukų;4134975456;Taip;7;3;0;10
11594;Smalsučiai;Sraigiukų;7396172351;Taip;0;3;0;3
11595;Smalsučiai;Sraigiukų;6358800570;Taip;0;3;0;3
11596;Smalsučiai;Sraigiukų;2327930850;Taip;0;6;0;6
11597;Smalsučiai;Sraigiukų;3787937467;Taip;10;3;0;13
11598;Smalsučiai;Sraigiukų;4824786207;Taip;0;5;0;5
11599;Smalsučiai;Sraigiukų;3399798448;Taip;0;3;2;5
11600;Smalsučiai;Sraigiukų;1997966082;Taip;0;10;0;10
11601;Smalsučiai;Sraigiukų;4585930202;Taip;0;11;0;11
11602;Smalsučiai;Sraigiukų;8193410963;Taip;0;3;0;3
11603;Smalsučiai;Sraigiukų;9155011285;Taip;0;3;0;3
11604;Smalsučiai;Saulučių;1776385691;Taip;0;0;2;2
11605;Smalsučiai;Saulučių;2259361924;Taip;0;0;2;2
11606;Smalsučiai;Saulučių;1162964613;Taip;8;0;3;11
11607;Smalsučiai;Saulučių;9934952886;Taip;5;5;2;12
11608;Smalsučiai;Saulučių;9556433086;Taip;0;8;0;8
11609;Smalsučiai;Saulučių;1904973393;Taip;0;3;0;3
11610;Smalsučiai;Saulučių;3252901131;Taip;0;0;4;4
11611;Smalsučiai;Saulučių;9743116843;Taip;0;0;1;1
11612;Smalsučiai;Saulučių;2392217952;Taip;3;0;1;4
11613;Smalsučiai;Saulučių;1447512509;Taip;0;0;18;18
11614;Smalsučiai;Saulučių;7774766882;Taip;0;0;1;1
11615;Smalsučiai;Saulučių;2034284973;Taip;2;3;0;5
11616;Smalsučiai;Saulučių;7423419934;Taip;0;0;1;1
11617;Smalsučiai;Saulučių;7049101015;Taip;0;0;4;4
11618;Smalsučiai;Saulučių;9183519167;Taip;4;0;3;7
11619;Smalsučiai;Saulučių;5708986552;Taip;11;0;3;14
11620;Smalsučiai;Saulučių;4889923629;Taip;0;2;2;4
11621;Smalsučiai;Saulučių;8630411244;Taip;5;3;0;8
11622;Smalsučiai;Saulučių;5541908981;Taip;0;0;3;3
11623;Smalsučiai;Viščiukų;6006832443;Taip;0;3;0;3
11624;Smalsučiai;Viščiukų;9864518144;Taip;0;4;0;4
11625;Smalsučiai;Viščiukų;8128348060;Taip;8;3;1;12
11626;Smalsučiai;Viščiukų;6415906523;Taip;5;3;0;8
11627;Smalsučiai;Viščiukų;4425714802;Taip;0;1;0;1
11628;Smalsučiai;Viščiukų;9732075162;Taip;4;0;1;5
11629;Smalsučiai;Viščiukų;6090391818;Taip;15;3;0;18
11630;Smalsučiai;Viščiukų;7023531176;Taip;0;3;1;4
11631;Smalsučiai;Viščiukų;8259056296;Taip;0;0;4;4
11632;Smalsučiai;Viščiukų;9637877396;Taip;3;3;3;9
11633;Smalsučiai;Viščiukų;7137550663;Taip;0;2;0;2
11634;Smalsučiai;Viščiukų;2958335372;Taip;0;1;0;1
11635;Smalsučiai;Viščiukų;3582805599;Taip;0;3;0;3
11636;Smalsučiai;Viščiukų;3757955200;Taip;4;4;2;10
11637;Smalsučiai;Viščiukų;4288788194;Taip;5;3;0;8
11638;Smalsučiai;Viščiukų;7874635165;Taip;0;3;1;4
11639;Smalsučiai;Viščiukų;5098291946;Ne;4;2;0;6
11640;Smalsučiai;Viščiukų;8578693978;Taip;0;7;0;7
11641;Smalsučiai;Viščiukų;4379645417;Taip;0;6;0;6
11642;Smalsučiai;Viščiukų;5536697307;Taip;12;3;1;16
11643;Smalsučiai;Boružėlių;9426629964;Taip;0;3;0;3
11644;Smalsučiai;Boružėlių;1703679877;Taip;0;2;0;2
11645;Smalsučiai;Boružėlių;2208462326;Taip;0;9;0;9
11646;Smalsučiai;Boružėlių;6643253926;Taip;0;6;0;6
11647;Smalsučiai;Boružėlių;1473016908;Taip;0;2;0;2
11648;Smalsučiai;Boružėlių;7226242747;Taip;0;3;0;3
11649;Smalsučiai;Boružėlių;6085020049;Taip;0;4;0;4
11650;Smalsučiai;Boružėlių;8340768848;Taip;1;4;0;5
11651;Smalsučiai;Boružėlių;6578328053;Taip;0;1;0;1
11652;Smalsučiai;Boružėlių;69450514879;Taip;6;3;0;9
11653;Smalsučiai;Boružėlių;4740303929;Taip;0;5;0;5
11654;Smalsučiai;Boružėlių;4046718551;Taip;0;2;0;2
11655;Smalsučiai;Boružėlių;2694575252;Taip;0;2;0;2
11656;Smalsučiai;Boružėlių;3063127699;Taip;5;8;0;13
11657;Smalsučiai;Boružėlių;2737886714;Taip;0;9;0;9
11658;Smalsučiai;Boružėlių;8523742213;Taip;0;3;2;5
11659;Smalsučiai;Boružėlių;2034790691;Taip;0;2;0;2
11660;Smalsučiai;Boružėlių;5325706638;Taip;0;5;0;5
11661;Smalsučiai;Boružėlių;9314811354;Taip;0;7;0;7
11662;Smalsučiai;Boružėlių;9196634595;Taip;0;3;0;3
11663;Smalsučiai;Boružėlių;6899040199;Taip;1;3;0;4
11664;Smalsučiai;Zuikių;2802867649;Taip;0;3;0;3
11665;Smalsučiai;Zuikių;96002139110;Taip;0;3;0;3
11666;Smalsučiai;Zuikių;2953239027;Taip;0;7;0;7
11667;Smalsučiai;Zuikių;2638709634;Taip;0;4;1;5
11668;Smalsučiai;Zuikių;5441966713;Taip;0;3;0;3
11669;Smalsučiai;Zuikių;9632022271;Taip;0;3;0;3
11670;Smalsučiai;Zuikių;8306946163;Taip;0;6;0;6
11671;Smalsučiai;Zuikių;6469044880;Taip;0;4;0;4
11672;Smalsučiai;Zuikių;99467576480;Taip;0;3;0;3
11673;Smalsučiai;Zuikių;2136420967;Taip;2;3;0;5
11674;Smalsučiai;Zuikių;2059832436;Ne;0;5;0;5
11675;Smalsučiai;Zuikių;1316590100;Taip;0;3;0;3
11676;Smalsučiai;Zuikių;1372591510;Taip;8;6;0;14
11677;Smalsučiai;Zuikių;8810690546;Taip;0;4;0;4
11678;Smalsučiai;Zuikių;9703726869;Taip;0;3;0;3
11679;Smalsučiai;Zuikių;2365835087;Taip;0;2;0;2
11680;Smalsučiai;Zuikių;9481692900;Taip;0;6;0;6
11681;Smalsučiai;Zuikių;4909226602;Taip;5;3;2;10
11682;Smalsučiai;Zuikių;6536165801;Taip;0;3;0;3
11683;Smalsučiai;Zuikių;3644256220;Taip;0;5;0;5
11684;Smalsučiai;Nykštukų;9181601713;Taip;0;3;0;3
11685;Smalsučiai;Nykštukų;7637630200;Taip;4;0;3;7
11686;Smalsučiai;Nykštukų;1247774684;Taip;3;1;0;4
11687;Smalsučiai;Nykštukų;2375360937;Taip;4;3;0;7
11688;Smalsučiai;Nykštukų;2015172985;Taip;0;4;0;4
11689;Smalsučiai;Nykštukų;8893480054;Taip;0;4;0;4
11690;Smalsučiai;Nykštukų;6996192450;Taip;4;4;0;8
11691;Smalsučiai;Nykštukų;9378696084;Taip;5;0;0;5
11692;Smalsučiai;Nykštukų;7267389695;Taip;10;3;0;13
11693;Smalsučiai;Nykštukų;6996901033;Taip;0;2;0;2
11694;Smalsučiai;Nykštukų;4847212069;Taip;0;1;2;3
11695;Smalsučiai;Nykštukų;1344461213;Taip;0;0;4;4
11696;Smalsučiai;Nykštukų;1224857159;Taip;0;4;0;4
11697;Smalsučiai;Nykštukų;8690626891;Taip;0;5;0;5
11698;Smalsučiai;Nykštukų;5719056997;Taip;3;4;0;7
11699;Smalsučiai;Nykštukų;3646740184;Taip;5;1;4;10
11700;Smalsučiai;Nykštukų;6642882883;Taip;0;0;8;8
11701;Smalsučiai;Nykštukų;7143824796;Taip;0;0;1;1
11702;Smalsučiai;Katinėlių;4760366724;Taip;5;3;0;8
11703;Smalsučiai;Katinėlių;2045283348;Taip;7;3;0;10
11704;Smalsučiai;Katinėlių;9710944054;Taip;5;3;0;8
11705;Smalsučiai;Katinėlių;5213319192;Taip;5;3;0;8
11706;Smalsučiai;Katinėlių;3782502443;Taip;0;3;0;3
11707;Smalsučiai;Katinėlių;6358968221;Taip;0;7;0;7
11708;Smalsučiai;Katinėlių;9984878984;Taip;1;6;0;7
11709;Smalsučiai;Katinėlių;2369569130;Taip;0;3;0;3
11710;Smalsučiai;Katinėlių;5535858303;Taip;1;3;4;8
11711;Smalsučiai;Katinėlių;8724759192;Taip;0;3;0;3
11712;Smalsučiai;Katinėlių;2662588310;Taip;7;4;0;11
11713;Smalsučiai;Katinėlių;2668720481;Taip;0;5;0;5
11714;Smalsučiai;Katinėlių;4030955447;Ne;1;3;0;4
11715;Smalsučiai;Katinėlių;4075656060;Taip;0;3;0;3
11716;Smalsučiai;Katinėlių;2926560092;Taip;5;3;0;8
11717;Smalsučiai;Katinėlių;8210141253;Taip;0;7;0;7
11718;Smalsučiai;Katinėlių;5828514911;Taip;1;0;0;1
11719;Smalsučiai;Katinėlių;6131743288;Taip;3;0;2;5
11720;Smalsučiai;Katinėlių;7318218997;Taip;5;1;0;6
11721;Smalsučiai;PELĖDŽIUKAI;1668692281;Taip;0;3;2;5
11722;Smalsučiai;PELĖDŽIUKAI;7794541741;Taip;6;3;0;9
11723;Smalsučiai;PELĖDŽIUKAI;1181574676;Taip;0;3;0;3
11724;Smalsučiai;PELĖDŽIUKAI;1599488035;Taip;0;5;0;5
11725;Smalsučiai;PELĖDŽIUKAI;4727475042;Taip;7;0;1;8
11726;Smalsučiai;PELĖDŽIUKAI;8520753848;Taip;0;3;0;3
11727;Smalsučiai;PELĖDŽIUKAI;22791221635;Taip;0;3;0;3
11728;Smalsučiai;PELĖDŽIUKAI;3607226859;Taip;0;10;0;10
11729;Smalsučiai;PELĖDŽIUKAI;1467603676;Taip;0;5;0;5
11730;Smalsučiai;PELĖDŽIUKAI;5159799570;Taip;0;10;0;10
11731;Smalsučiai;PELĖDŽIUKAI;19592364606;Taip;0;13;0;13
11732;Smalsučiai;PELĖDŽIUKAI;1824321380;Taip;0;3;0;3
11733;Smalsučiai;PELĖDŽIUKAI;6207026048;Taip;5;3;0;8
11734;Smalsučiai;PELĖDŽIUKAI;4145769042;Taip;0;3;0;3
11735;Smalsučiai;PELĖDŽIUKAI;6529889121;Taip;0;3;0;3
11736;Smalsučiai;PELĖDŽIUKAI;2618753095;Taip;0;2;1;3
11737;Smalsučiai;PELĖDŽIUKAI;1673246147;Taip;0;9;0;9
11738;Smalsučiai;PELĖDŽIUKAI;7713078413;Taip;0;3;0;3
11739;Smalsučiai;PELĖDŽIUKAI;3627324317;Taip;0;11;0;11
11740;Smalsučiai;PELĖDŽIUKAI;5730866119;Taip;0;3;0;3
11741;Smalsučiai;PELĖDŽIUKAI;5611487967;Taip;0;3;0;3
11742;Smalsučiai;Pingvinukai;1305808180;Taip;0;4;0;4
11743;Smalsučiai;Pingvinukai;9222858199;Taip;4;0;2;6
11744;Smalsučiai;Pingvinukai;1909797307;Taip;4;0;6;10
11745;Smalsučiai;Pingvinukai;7400990599;Taip;5;0;7;12
11746;Smalsučiai;Pingvinukai;2673224420;Taip;18;0;0;18
11747;Smalsučiai;Pingvinukai;9771532192;Taip;0;16;0;16
11748;Smalsučiai;Pingvinukai;8402519872;Taip;0;3;0;3
11749;Smalsučiai;Pingvinukai;3746193901;Taip;5;4;1;10
11750;Smalsučiai;Pingvinukai;8499612926;Taip;3;0;1;4
11751;Smalsučiai;Pingvinukai;3625628040;Taip;10;3;0;13
11752;Smalsučiai;Pingvinukai;6128134712;Taip;0;0;3;3
11753;Smalsučiai;Pingvinukai;3045521655;Taip;8;0;10;18
11754;Smalsučiai;Pingvinukai;8615789381;Taip;5;0;3;8
11755;Smalsučiai;Voverikų;4811022648;Taip;0;4;0;4
11756;Smalsučiai;Voverikų;4973651632;Taip;0;3;3;6
11757;Smalsučiai;Voverikų;3509573985;Taip;5;7;3;15
11758;Smalsučiai;Voverikų;2878060759;Taip;2;3;0;5
11759;Smalsučiai;Voverikų;1485450504;Taip;3;1;0;4
11760;Smalsučiai;Voverikų;3042578767;Taip;6;3;0;9
11761;Smalsučiai;Voverikų;2070248478;Taip;16;0;0;16
11762;Smalsučiai;Voverikų;7205498813;Taip;0;4;0;4
11763;Smalsučiai;Voverikų;2612579099;Taip;0;17;0;17
11764;Smalsučiai;Voverikų;1559069582;Taip;0;3;0;3
11765;Smalsučiai;Voverikų;2885279828;Taip;5;2;0;7
11766;Smalsučiai;Voverikų;1162035522;Taip;10;3;2;15
11767;Smalsučiai;Voverikų;5964344820;Taip;10;3;0;13
11768;Smalsučiai;Voverikų;4105866680;Taip;18;0;0;18
11769;Spragtukas;NYKŠTUKAI;4527798635;Taip;0;3;0;3
11770;Spragtukas;NYKŠTUKAI;8551195766;Taip;14;0;0;14
11771;Spragtukas;NYKŠTUKAI;2943832694;Taip;4;5;0;9
11772;Spragtukas;NYKŠTUKAI;8297700739;Taip;10;3;0;13
11773;Spragtukas;NYKŠTUKAI;9595221494;Taip;0;2;0;2
11774;Spragtukas;NYKŠTUKAI;6185016824;Taip;0;7;0;7
11775;Spragtukas;NYKŠTUKAI;8715073512;Taip;0;1;0;1
11776;Spragtukas;NYKŠTUKAI;1710184531;Taip;5;1;0;6
11777;Spragtukas;NYKŠTUKAI;2076126173;Ne;18;0;0;18
11778;Spragtukas;NYKŠTUKAI;3012345413;Ne;5;6;0;11
11779;Spragtukas;NYKŠTUKAI;8698492694;Taip;5;6;0;11
11780;Spragtukas;NYKŠTUKAI;1150002524;Taip;0;5;0;5
11781;Spragtukas;NYKŠTUKAI;4493810276;Taip;5;1;0;6
11782;Spragtukas;NYKŠTUKAI;8288793522;Taip;10;14;0;24
11783;Spragtukas;NYKŠTUKAI;6986034864;Taip;13;1;0;14
11784;Spragtukas;NYKŠTUKAI;9665371858;Ne;0;3;0;3
11785;Spragtukas;SAULUTĖ;3337355440;Taip;0;4;0;4
11786;Spragtukas;SAULUTĖ;4669257062;Taip;9;3;0;12
11787;Spragtukas;SAULUTĖ;3692960591;Taip;5;4;0;9
11788;Spragtukas;SAULUTĖ;6192381779;Taip;0;3;1;4
11789;Spragtukas;SAULUTĖ;4586034709;Taip;0;2;1;3
11790;Spragtukas;SAULUTĖ;2305568596;Taip;0;3;4;7
11791;Spragtukas;SAULUTĖ;3968434618;Taip;0;4;0;4
11792;Spragtukas;SAULUTĖ;1150727381;Taip;0;17;0;17
11793;Spragtukas;SAULUTĖ;9191831532;Taip;0;3;0;3
11794;Spragtukas;SAULUTĖ;3948232692;Taip;5;3;0;8
11795;Spragtukas;SAULUTĖ;9149954373;Taip;8;5;0;13
11796;Spragtukas;SAULUTĖ;7511680722;Taip;0;5;0;5
11797;Spragtukas;SAULUTĖ;8235791891;Taip;5;3;0;8
11798;Spragtukas;SAULUTĖ;2987638580;Taip;3;3;0;6
11799;Spragtukas;SAULUTĖ;5687853390;Taip;7;1;0;8
11800;Spragtukas;SAULUTĖ;6679886985;Taip;0;4;0;4
11801;Spragtukas;SAULUTĖ;2879077913;Ne;0;4;0;4
11802;Spragtukas;SAULUTĖ;1998148708;Taip;10;5;0;15
11803;Spragtukas;SAULUTĖ;8227086854;Taip;0;8;0;8
11804;Spragtukas;SAULUTĖ;5697451914;Taip;0;5;0;5
11805;Spragtukas;SAULUTĖ;3086399458;Taip;11;3;1;15
11806;Spragtukas;SAULUTĖ;2879614195;Taip;0;11;0;11
11807;Spragtukas;SPINDULĖLIAI;4675031453;Taip;0;2;4;6
11808;Spragtukas;SPINDULĖLIAI;9781727236;Taip;1;3;4;8
11809;Spragtukas;SPINDULĖLIAI;1029392579;Taip;0;2;1;3
11810;Spragtukas;SPINDULĖLIAI;6417098461;Taip;0;4;0;4
11811;Spragtukas;SPINDULĖLIAI;4485715299;Taip;0;5;0;5
11812;Spragtukas;SPINDULĖLIAI;4224693184;Taip;0;1;0;1
11813;Spragtukas;SPINDULĖLIAI;2493749424;Taip;0;2;3;5
11814;Spragtukas;SPINDULĖLIAI;3411349574;Taip;2;3;0;5
11815;Spragtukas;SPINDULĖLIAI;1323065222;Taip;0;9;1;10
11816;Spragtukas;SPINDULĖLIAI;1827458781;Taip;0;2;0;2
11817;Spragtukas;SPINDULĖLIAI;4764295850;Taip;0;3;3;6
11818;Spragtukas;SPINDULĖLIAI;8912031554;Taip;7;0;7;14
11819;Spragtukas;SPINDULĖLIAI;3798118695;Taip;5;2;0;7
11820;Spragtukas;SPINDULĖLIAI;6634972088;Ne;0;18;0;18
11821;Spragtukas;GINTARĖLIAI;8339926929;Taip;0;6;0;6
11822;Spragtukas;GINTARĖLIAI;1525489137;Taip;0;1;0;1
11823;Spragtukas;GINTARĖLIAI;5724874569;Taip;8;1;0;9
11824;Spragtukas;GINTARĖLIAI;1430632638;Taip;0;4;0;4
11825;Spragtukas;GINTARĖLIAI;8625143071;Taip;0;2;0;2
11826;Spragtukas;GINTARĖLIAI;2255007161;Taip;0;7;0;7
11827;Spragtukas;GINTARĖLIAI;6493380877;Taip;0;2;2;4
11828;Spragtukas;GINTARĖLIAI;9664130733;Taip;13;0;0;13
11829;Spragtukas;GINTARĖLIAI;2316071393;Taip;0;3;1;4
11830;Spragtukas;GINTARĖLIAI;8698469979;Taip;0;5;0;5
11831;Spragtukas;GINTARĖLIAI;1747417905;Taip;0;0;2;2
11832;Spragtukas;GINTARĖLIAI;6388163866;Taip;0;3;8;11
11833;Spragtukas;GINTARĖLIAI;8191270443;Taip;0;3;0;3
11834;Spragtukas;GINTARĖLIAI;8893190073;Taip;0;3;0;3
11835;Spragtukas;GINTARĖLIAI;3684183344;Taip;0;6;0;6
11836;Spragtukas;GINTARĖLIAI;7806145224;Taip;0;5;0;5
11837;Spragtukas;GINTARĖLIAI;3170388518;Taip;0;0;18;18
11838;Spragtukas;GINTARĖLIAI;2992201984;Taip;11;3;0;14
11839;Spragtukas;GINTARĖLIAI;2217627240;Taip;5;8;0;13
11840;Spragtukas;ČIPOLINO;2371848091;Taip;9;0;0;9
11841;Spragtukas;ČIPOLINO;6582680700;Taip;0;3;5;8
11842;Spragtukas;ČIPOLINO;1599958343;Taip;0;3;3;6
11843;Spragtukas;ČIPOLINO;1547670082;Taip;0;8;0;8
11844;Spragtukas;ČIPOLINO;7504632314;Taip;0;5;0;5
11845;Spragtukas;ČIPOLINO;1597988501;Taip;9;0;0;9
11846;Spragtukas;ČIPOLINO;6526633051;Taip;0;8;0;8
11847;Spragtukas;ČIPOLINO;1058970799;Taip;0;2;2;4
11848;Spragtukas;ČIPOLINO;45661532130;Taip;0;3;0;3
11849;Spragtukas;ČIPOLINO;3045382299;Taip;0;3;1;4
11850;Spragtukas;ČIPOLINO;7640805299;Taip;5;8;0;13
11851;Spragtukas;ČIPOLINO;1365907314;Taip;0;3;1;4
11852;Spragtukas;ČIPOLINO;4941531443;Taip;0;3;3;6
11853;Spragtukas;ČIPOLINO;3566797064;Taip;0;3;5;8
11854;Spragtukas;ČIPOLINO;2902550587;Taip;6;3;1;10
11855;Spragtukas;ČIPOLINO;69114720307;Taip;0;3;2;5
11856;Spragtukas;ČIPOLINO;1044112039;Taip;3;8;0;11
11857;Spragtukas;ČIPOLINO;5707084920;Taip;8;0;3;11
11858;Spragtukas;ČIPOLINO;1482803930;Taip;0;8;0;8
11859;Spragtukas;ČIPOLINO;3356307067;Taip;5;6;0;11
11860;Spragtukas;ČIPOLINO;2691004546;Taip;0;18;0;18
11861;Spragtukas;BORUŽĖLĖS;8614890958;Taip;13;1;0;14
11862;Spragtukas;BORUŽĖLĖS;6548270099;Taip;13;2;0;15
11863;Spragtukas;BORUŽĖLĖS;2356476212;Taip;0;3;5;8
11864;Spragtukas;BORUŽĖLĖS;8287102733;Taip;20;1;0;21
11865;Spragtukas;BORUŽĖLĖS;6584145176;Taip;0;12;0;12
11866;Spragtukas;BORUŽĖLĖS;9965087132;Taip;18;2;0;20
11867;Spragtukas;BORUŽĖLĖS;5150028968;Taip;11;2;0;13
11868;Spragtukas;BORUŽĖLĖS;9754594384;Taip;15;2;0;17
11869;Spragtukas;BORUŽĖLĖS;6824861247;Taip;0;4;0;4
11870;Spragtukas;BORUŽĖLĖS;7264683147;Taip;6;3;3;12
11871;Spragtukas;BORUŽĖLĖS;5556920140;Taip;0;3;2;5
11872;Spragtukas;BORUŽĖLĖS;6547167325;Taip;0;3;1;4
11873;Spragtukas;BORUŽĖLĖS;4347275614;Taip;3;3;0;6
11874;Spragtukas;BORUŽĖLĖS;7073092344;Taip;25;0;1;26
11875;Spragtukas;BORUŽĖLĖS;7042345781;Taip;0;3;1;4
11876;Spragtukas;BORUŽĖLĖS;1046613540;Taip;0;10;0;10
11877;Spragtukas;DRUGELIAI;1336973131;Taip;5;2;0;7
11878;Spragtukas;DRUGELIAI;1514277186;Taip;22;3;0;25
11879;Spragtukas;DRUGELIAI;1326603216;Taip;6;3;0;9
11880;Spragtukas;DRUGELIAI;5306883933;Taip;0;3;0;3
11881;Spragtukas;DRUGELIAI;6322121173;Taip;0;3;0;3
11882;Spragtukas;DRUGELIAI;6573750143;Taip;0;4;0;4
11883;Spragtukas;DRUGELIAI;6800727630;Taip;0;3;0;3
11884;Spragtukas;DRUGELIAI;72636559695;Taip;7;3;1;11
11885;Spragtukas;DRUGELIAI;1384812263;Taip;0;3;0;3
11886;Spragtukas;DRUGELIAI;1849644444;Taip;0;3;0;3
11887;Spragtukas;DRUGELIAI;3654640843;Taip;0;3;0;3
11888;Spragtukas;DRUGELIAI;4929866385;Taip;0;3;0;3
11889;Spragtukas;DRUGELIAI;8246512283;Taip;0;3;0;3
11890;Spragtukas;DRUGELIAI;9045185920;Taip;0;3;1;4
11891;Spragtukas;DRUGELIAI;1627243902;Taip;0;3;0;3
11892;Spragtukas;DRUGELIAI;3113106252;Taip;0;3;0;3
11893;Spragtukas;DRUGELIAI;4131998934;Taip;1;3;0;4
11894;Spragtukas;DRUGELIAI;8463747761;Taip;0;3;0;3
11895;Spragtukas;DRUGELIAI;5477997543;Taip;0;3;0;3
11896;Spragtukas;DRUGELIAI;70413855110;Taip;5;2;2;9
11897;Spragtukas;GAIDELIAI;2541126095;Taip;15;0;0;15
11898;Spragtukas;GAIDELIAI;4097458544;Taip;0;2;3;5
11899;Spragtukas;GAIDELIAI;8957903306;Taip;0;3;4;7
11900;Spragtukas;GAIDELIAI;1326714513;Taip;9;2;8;19
11901;Spragtukas;GAIDELIAI;4676052255;Taip;0;10;0;10
11902;Spragtukas;GAIDELIAI;7108640957;Taip;0;1;0;1
11903;Spragtukas;GAIDELIAI;6370760287;Taip;0;2;1;3
11904;Spragtukas;GAIDELIAI;7911124524;Taip;0;2;0;2
11905;Spragtukas;GAIDELIAI;9509296936;Taip;7;8;0;15
11906;Spragtukas;GAIDELIAI;3216796441;Taip;8;14;0;22
11907;Spragtukas;GAIDELIAI;8440836721;Taip;0;14;0;14
11908;Spragtukas;GAIDELIAI;4535021524;Taip;0;3;2;5
11909;Spragtukas;GAIDELIAI;2679834328;Taip;5;1;0;6
11910;Spragtukas;ŽUVELĖS;9078163633;Taip;0;2;0;2
11911;Spragtukas;ŽUVELĖS;8652973900;Taip;0;3;0;3
11912;Spragtukas;ŽUVELĖS;3261213140;Taip;0;3;0;3
11913;Spragtukas;ŽUVELĖS;5689392663;Taip;0;5;0;5
11914;Spragtukas;ŽUVELĖS;9592271053;Taip;0;3;0;3
11915;Spragtukas;ŽUVELĖS;1272075883;Taip;5;3;0;8
11916;Spragtukas;ŽUVELĖS;6465991136;Taip;0;3;0;3
11917;Spragtukas;ŽUVELĖS;9282940430;Taip;0;5;0;5
11918;Spragtukas;ŽUVELĖS;6503842956;Taip;2;4;0;6
11919;Spragtukas;ŽUVELĖS;2578400770;Taip;0;3;0;3
11920;Spragtukas;ŽUVELĖS;3139748724;Taip;8;3;2;13
11921;Spragtukas;ŽUVELĖS;8640877497;Taip;17;0;0;17
11922;Spragtukas;ŽUVELĖS;2025314314;Taip;12;0;0;12
11923;Spragtukas;ŽUVELĖS;4848647219;Taip;11;0;0;11
11924;Spragtukas;ŽUVELĖS;3491418162;Taip;0;3;0;3
11925;Spragtukas;ŽUVELĖS;5836788916;Taip;8;3;0;11
11926;Spragtukas;ŽUVELĖS;5704941595;Taip;3;6;0;9
11927;Spragtukas;ŽUVELĖS;3286456855;Taip;0;3;2;5
11928;Spragtukas;ŽUVELĖS;9662188102;Taip;4;4;4;12
11929;Spragtukas;ŽUVELĖS;2539660577;Taip;4;4;0;8
11930;Spragtukas;ŽUVELĖS;6836232179;Taip;0;4;0;4
11931;Spragtukas;ŽUVELĖS;6757604305;Taip;0;3;0;3
11932;Spragtukas;RIEŠUTĖLIAI;3187815703;Taip;0;3;0;3
11933;Spragtukas;RIEŠUTĖLIAI;8684246143;Taip;5;4;0;9
11934;Spragtukas;RIEŠUTĖLIAI;1407611561;Taip;7;1;0;8
11935;Spragtukas;RIEŠUTĖLIAI;8773952377;Taip;0;6;0;6
11936;Spragtukas;RIEŠUTĖLIAI;1977526177;Taip;4;1;0;5
11937;Spragtukas;RIEŠUTĖLIAI;7615522850;Taip;3;1;0;4
11938;Spragtukas;RIEŠUTĖLIAI;6797841737;Taip;0;3;0;3
11939;Spragtukas;RIEŠUTĖLIAI;9204569123;Taip;0;3;0;3
11940;Spragtukas;RIEŠUTĖLIAI;1992850470;Taip;0;3;0;3
11941;Spragtukas;RIEŠUTĖLIAI;6158327941;Taip;0;3;0;3
11942;Spragtukas;RIEŠUTĖLIAI;4134127256;Taip;0;3;0;3
11943;Spragtukas;RIEŠUTĖLIAI;1946493379;Taip;18;0;0;18
11944;Spragtukas;RIEŠUTĖLIAI;3009567338;Taip;0;3;0;3
11945;Spragtukas;RIEŠUTĖLIAI;2648358901;Taip;3;12;0;15
11946;Spragtukas;RIEŠUTĖLIAI;3822599790;Taip;0;10;0;10
11947;Spragtukas;RIEŠUTĖLIAI;7767940027;Taip;0;4;0;4
11948;Spragtukas;RIEŠUTĖLIAI;4625065223;Taip;0;3;0;3
11949;Spragtukas;RIEŠUTĖLIAI;6963190259;Taip;5;1;0;6
11950;Spragtukas;RIEŠUTĖLIAI;8732886749;Taip;5;1;0;6
11951;Spragtukas;RIEŠUTĖLIAI;9975308171;Taip;9;0;0;9
11952;Spragtukas;VIŠČIUKAI;8473814776;Taip;3;1;0;4
11953;Spragtukas;VIŠČIUKAI;9951226210;Taip;8;5;0;13
11954;Spragtukas;VIŠČIUKAI;9294770557;Taip;17;1;0;18
11955;Spragtukas;VIŠČIUKAI;9443091032;Taip;12;5;0;17
11956;Spragtukas;VIŠČIUKAI;4461217748;Taip;0;3;0;3
11957;Spragtukas;VIŠČIUKAI;7412489884;Taip;18;0;0;18
11958;Spragtukas;VIŠČIUKAI;2087416420;Taip;0;7;0;7
11959;Spragtukas;VIŠČIUKAI;1545887575;Taip;4;3;0;7
11960;Spragtukas;VIŠČIUKAI;5948139350;Taip;5;2;0;7
11961;Spragtukas;VIŠČIUKAI;8110631015;Taip;0;5;1;6
11962;Spragtukas;VIŠČIUKAI;7522592685;Taip;4;3;0;7
11963;Spragtukas;MEŠKIUKAI;5440632023;Taip;11;1;0;12
11964;Spragtukas;MEŠKIUKAI;7271482702;Taip;5;5;2;12
11965;Spragtukas;MEŠKIUKAI;9099921999;Taip;9;3;0;12
11966;Spragtukas;MEŠKIUKAI;8307801987;Taip;3;1;0;4
11967;Spragtukas;MEŠKIUKAI;1493711333;Ne;0;3;3;6
11968;Spragtukas;MEŠKIUKAI;4742132709;Taip;0;12;0;12
11969;Spragtukas;MEŠKIUKAI;7256772984;Taip;0;4;0;4
11970;Spragtukas;MEŠKIUKAI;5225669850;Taip;11;0;2;13
11971;Spragtukas;MEŠKIUKAI;8109894184;Taip;4;4;0;8
11972;Spragtukas;MEŠKIUKAI;8396134652;Taip;14;0;0;14
11973;Spragtukas;MEŠKIUKAI;1784758799;Taip;5;3;1;9
11974;Spragtukas;MEŠKIUKAI;4441290823;Taip;3;0;1;4
11975;Spragtukas;MEŠKIUKAI;9310818975;Taip;3;5;0;8
11976;Spragtukas;MEŠKIUKAI;8486415968;Taip;6;1;0;7
11977;Spragtukas;MEŠKIUKAI;1083785206;Taip;0;6;0;6
11978;Spragtukas;MEŠKIUKAI;2026249018;Taip;6;1;0;7
11979;Spragtukas;MEŠKIUKAI;3423699840;Taip;0;3;2;5
11980;Strazdelis;Žiogelių;5346485534;Taip;0;2;0;2
11981;Strazdelis;Žiogelių;9933042249;Taip;0;9;0;9
11982;Strazdelis;Žiogelių;8581533423;Taip;0;5;0;5
11983;Strazdelis;Žiogelių;8209625399;Taip;9;5;0;14
11984;Strazdelis;Žiogelių;1141752802;Taip;4;3;4;11
11985;Strazdelis;Žiogelių;1228651165;Taip;0;5;3;8
11986;Strazdelis;Žiogelių;7768700192;Taip;0;4;0;4
11987;Strazdelis;Žiogelių;3596394112;Taip;0;5;6;11
11988;Strazdelis;Žiogelių;8493572399;Taip;0;0;11;11
11989;Strazdelis;Žiogelių;4563247013;Taip;12;0;1;13
11990;Strazdelis;Žiogelių;6437928004;Taip;0;5;4;9
11991;Strazdelis;Žiogelių;5600979545;Taip;1;9;0;10
11992;Strazdelis;Žiogelių;8971395173;Taip;13;0;0;13
11993;Strazdelis;Žiogelių;4955907851;Taip;10;0;3;13
11994;Strazdelis;Žiogelių;7425818775;Taip;0;4;0;4
11995;Strazdelis;Žiogelių;9567476872;Taip;0;2;3;5
11996;Strazdelis;Žiogelių;4516288199;Taip;0;3;0;3
11997;Strazdelis;Žiogelių;3028208428;Taip;5;0;3;8
11998;Strazdelis;Žiogelių;2753635198;Taip;0;5;3;8
11999;Strazdelis;Žiogelių;1194918926;Taip;0;3;6;9
12000;Strazdelis;Žiogelių;6651360492;Taip;0;10;0;10
12001;Strazdelis;Žiogelių;8686828982;Taip;1;8;0;9
12002;Strazdelis;Žiogelių;7913526787;Taip;18;0;0;18
12003;Strazdelis;Šeimynėlės;6570504154;Taip;13;3;0;16
12004;Strazdelis;Šeimynėlės;3848288765;Taip;10;3;0;13
12005;Strazdelis;Šeimynėlės;5033799225;Taip;10;3;0;13
12006;Strazdelis;Šeimynėlės;1683900907;Taip;0;1;0;1
12007;Strazdelis;Šeimynėlės;3897248010;Taip;10;3;0;13
12008;Strazdelis;Šeimynėlės;2990771887;Taip;5;8;0;13
12009;Strazdelis;Šeimynėlės;2185364583;Taip;2;3;0;5
12010;Strazdelis;Šeimynėlės;7905687363;Taip;5;4;0;9
12011;Strazdelis;Šeimynėlės;4501391298;Taip;0;9;0;9
12012;Strazdelis;Šeimynėlės;9057914477;Taip;6;6;0;12
12013;Strazdelis;Šeimynėlės;1277844969;Taip;0;3;0;3
12014;Strazdelis;Šeimynėlės;1012692326;Taip;8;4;0;12
12015;Strazdelis;Šeimynėlės;8899530711;Taip;8;4;0;12
12016;Strazdelis;Šeimynėlės;8336759173;Taip;13;0;0;13
12017;Strazdelis;Šeimynėlės;5784406335;Taip;0;3;0;3
12018;Strazdelis;Šeimynėlės;2068793184;Taip;1;5;0;6
12019;Strazdelis;Šeimynėlės;5296218650;Taip;11;3;0;14
12020;Strazdelis;Šeimynėlės;1754106518;Taip;0;3;0;3
12021;Strazdelis;Šeimynėlės;9806107189;Taip;10;4;0;14
12022;Strazdelis;Šeimynėlės;9209201954;Taip;9;0;0;9
12023;Strazdelis;Šeimynėlės;5924324241;Taip;5;6;2;13
12024;Strazdelis;Šeimynėlės;8295035233;Taip;0;2;1;3
12025;Strazdelis;Šeimynėlės;1553329770;Taip;4;1;0;5
12026;Strazdelis;Genelio;8277333786;Taip;0;8;0;8
12027;Strazdelis;Genelio;9586256979;Taip;0;3;0;3
12028;Strazdelis;Genelio;3084249678;Taip;0;8;0;8
12029;Strazdelis;Genelio;5499310072;Taip;0;4;0;4
12030;Strazdelis;Genelio;8333151969;Taip;0;2;0;2
12031;Strazdelis;Genelio;7083940713;Taip;0;5;1;6
12032;Strazdelis;Genelio;6271193831;Taip;0;1;0;1
12033;Strazdelis;Genelio;6480803618;Taip;10;4;0;14
12034;Strazdelis;Genelio;9490861272;Taip;5;5;0;10
12035;Strazdelis;Genelio;6071502600;Taip;1;5;1;7
12036;Strazdelis;Genelio;3713797440;Taip;1;5;1;7
12037;Strazdelis;Genelio;3456287323;Taip;0;6;0;6
12038;Strazdelis;Genelio;1034497200;Taip;0;1;0;1
12039;Strazdelis;Genelio;2459718449;Taip;0;5;0;5
12040;Strazdelis;Genelio;2483283363;Taip;0;4;0;4
12041;Strazdelis;Genelio;5714581201;Taip;4;5;0;9
12042;Strazdelis;Genelio;8956634754;Taip;1;1;0;2
12043;Strazdelis;Genelio;8762859576;Taip;0;3;5;8
12044;Strazdelis;Genelio;2306665561;Taip;0;3;0;3
12045;Strazdelis;Genelio;7680242840;Taip;0;3;0;3
12046;Strazdelis;Genelio;4545538133;Taip;0;1;0;1
12047;Strazdelis;Genelio;5742215922;Taip;11;5;0;16
12048;Strazdelis;Vikruolių;2078150337;Taip;0;4;0;4
12049;Strazdelis;Vikruolių;8182994112;Taip;5;0;0;5
12050;Strazdelis;Vikruolių;1362428967;Taip;0;3;0;3
12051;Strazdelis;Vikruolių;2871673641;Taip;0;4;0;4
12052;Strazdelis;Vikruolių;4655931716;Taip;0;5;1;6
12053;Strazdelis;Vikruolių;8754275576;Taip;2;4;0;6
12054;Strazdelis;Vikruolių;8634815556;Taip;0;3;0;3
12055;Strazdelis;Vikruolių;6147183190;Taip;6;9;0;15
12056;Strazdelis;Vikruolių;7216768880;Taip;9;1;0;10
12057;Strazdelis;Vikruolių;7823110477;Taip;0;6;0;6
12058;Strazdelis;Vikruolių;1187534672;Taip;0;3;2;5
12059;Strazdelis;Vikruolių;9904719582;Taip;5;6;0;11
12060;Strazdelis;Vikruolių;7308925265;Taip;8;6;0;14
12061;Strazdelis;Vikruolių;50350281905;Taip;10;4;0;14
12062;Strazdelis;Vikruolių;8038163444;Taip;0;4;0;4
12063;Strazdelis;Vikruolių;1540973269;Taip;0;1;1;2
12064;Strazdelis;Vikruolių;8801420992;Taip;0;3;0;3
12065;Strazdelis;Vikruolių;5580738386;Taip;0;3;0;3
12066;Strazdelis;Vikruolių;3955783379;Taip;4;2;0;6
12067;Strazdelis;Vikruolių;4430183106;Ne;5;3;1;9
12068;Strazdelis;Vikruolių;4076266466;Taip;18;0;0;18
12069;Strazdelis;Vyturėlių;4929828091;Taip;0;2;0;2
12070;Strazdelis;Vyturėlių;4454199703;Taip;6;3;0;9
12071;Strazdelis;Vyturėlių;3662217925;Ne;0;7;0;7
12072;Strazdelis;Vyturėlių;4698566091;Taip;0;3;0;3
12073;Strazdelis;Vyturėlių;8274897977;Taip;7;1;0;8
12074;Strazdelis;Vyturėlių;1665134387;Taip;15;0;0;15
12075;Strazdelis;Vyturėlių;45083023033;Taip;0;3;0;3
12076;Strazdelis;Vyturėlių;5698472204;Taip;0;3;0;3
12077;Strazdelis;Vyturėlių;43314069648;Taip;0;3;0;3
12078;Strazdelis;Vyturėlių;1481671624;Taip;0;3;5;8
12079;Strazdelis;Vyturėlių;4697537943;Taip;0;12;0;12
12080;Strazdelis;Vyturėlių;6014213362;Taip;0;5;0;5
12081;Strazdelis;Vyturėlių;7900362267;Taip;0;3;2;5
12082;Strazdelis;Vyturėlių;9835716116;Taip;0;3;0;3
12083;Strazdelis;Vyturėlių;3943578036;Taip;9;4;0;13
12084;Strazdelis;Vyturėlių;2802486859;Taip;5;1;0;6
12085;Strazdelis;Vyturėlių;3482802557;Taip;5;2;1;8
12086;Strazdelis;Vyturėlių;5749300013;Taip;3;3;0;6
12087;Strazdelis;Vyturėlių;7215063033;Taip;1;3;1;5
12088;Strazdelis;Vyturėlių;7149827850;Taip;18;0;0;18
12089;Strazdelis;Vyturėlių;5834348507;Taip;13;0;0;13
12090;Strazdelis;Vyturėlių;2238875354;Taip;0;4;0;4
12091;Strazdelis;Varpelio;4159072583;Taip;3;5;0;8
12092;Strazdelis;Varpelio;2662549392;Taip;0;4;0;4
12093;Strazdelis;Varpelio;9502341478;Taip;0;6;0;6
12094;Strazdelis;Varpelio;6311710825;Taip;0;3;0;3
12095;Strazdelis;Varpelio;1955166372;Taip;5;0;0;5
12096;Strazdelis;Varpelio;4873707286;Taip;0;1;0;1
12097;Strazdelis;Varpelio;6527855940;Taip;0;8;0;8
12098;Strazdelis;Varpelio;2824416350;Taip;0;3;0;3
12099;Strazdelis;Varpelio;3610250359;Taip;5;6;0;11
12100;Strazdelis;Varpelio;2766970956;Taip;0;8;0;8
12101;Strazdelis;Varpelio;1173067724;Taip;0;4;0;4
12102;Strazdelis;Varpelio;1021364759;Taip;0;11;0;11
12103;Strazdelis;Varpelio;7469848482;Taip;0;6;0;6
12104;Strazdelis;Varpelio;1841285441;Taip;2;4;0;6
12105;Strazdelis;Varpelio;7393083827;Taip;5;10;0;15
12106;Strazdelis;Varpelio;6555803164;Ne;0;5;0;5
12107;Strazdelis;Varpelio;1706026100;Taip;0;3;0;3
12108;Strazdelis;Varpelio;8035603341;Taip;0;3;0;3
12109;Strazdelis;Varpelio;2789987994;Taip;0;3;0;3
12110;Strazdelis;Varpelio;2251157025;Taip;0;6;0;6
12111;Strazdelis;Varpelio;5904388732;Taip;0;9;0;9
12112;Strazdelis;Varpelio;3460993302;Taip;0;4;0;4
12113;Strazdelis;Varpelio;9776075027;Taip;0;9;0;9
12114;Strazdelis;Pelėdžiukų;5892430004;Taip;4;6;0;10
12115;Strazdelis;Pelėdžiukų;8637386316;Taip;0;3;0;3
12116;Strazdelis;Pelėdžiukų;1704292727;Taip;5;7;0;12
12117;Strazdelis;Pelėdžiukų;8371999002;Taip;0;3;0;3
12118;Strazdelis;Pelėdžiukų;6046139859;Taip;0;3;0;3
12119;Strazdelis;Pelėdžiukų;8287554571;Taip;0;3;0;3
12120;Strazdelis;Pelėdžiukų;4448556404;Taip;5;6;0;11
12121;Strazdelis;Pelėdžiukų;8854150040;Taip;0;3;1;4
12122;Strazdelis;Pelėdžiukų;4004930488;Taip;0;3;3;6
12123;Strazdelis;Pelėdžiukų;5768674837;Taip;8;0;0;8
12124;Strazdelis;Pelėdžiukų;9761595867;Taip;0;7;0;7
12125;Strazdelis;Pelėdžiukų;7876385010;Taip;0;3;4;7
12126;Strazdelis;Pelėdžiukų;2848984531;Taip;0;3;0;3
12127;Strazdelis;Pelėdžiukų;1420438624;Taip;0;4;0;4
12128;Strazdelis;Pelėdžiukų;1901641517;Taip;3;3;0;6
12129;Strazdelis;Pelėdžiukų;4617237063;Taip;0;12;0;12
12130;Strazdelis;Pelėdžiukų;3036380561;Taip;0;12;0;12
12131;Strazdelis;Pelėdžiukų;7471890377;Taip;0;7;1;8
12132;Strazdelis;Pelėdžiukų;7349106795;Taip;0;5;4;9
12133;Strazdelis;Pelėdžiukų;2852253325;Taip;0;4;0;4
12134;Strazdelis;Pelėdžiukų;8938997208;Taip;0;3;0;3
12135;Strazdelis;Pelėdžiukų;4562530311;Taip;0;4;2;6
12136;Strazdelis;Saulutės;27177757900;Taip;0;4;0;4
12137;Strazdelis;Saulutės;40932140069;Taip;0;3;0;3
12138;Strazdelis;Saulutės;1523471662;Taip;5;4;0;9
12139;Strazdelis;Saulutės;2854642875;Taip;0;3;0;3
12140;Strazdelis;Saulutės;7578229276;Taip;0;3;0;3
12141;Strazdelis;Saulutės;8710848483;Taip;0;3;0;3
12142;Strazdelis;Saulutės;6614184499;Taip;0;3;0;3
12143;Strazdelis;Saulutės;4129957131;Taip;0;5;0;5
12144;Strazdelis;Saulutės;3425430317;Taip;4;5;0;9
12145;Strazdelis;Saulutės;7081517417;Taip;0;3;0;3
12146;Strazdelis;Saulutės;67641340859;Taip;0;3;0;3
12147;Strazdelis;Saulutės;15298412755;Taip;0;5;0;5
12148;Strazdelis;Saulutės;1802092125;Taip;0;3;0;3
12149;Strazdelis;Saulutės;1391009140;Taip;0;5;2;7
12150;Strazdelis;Saulutės;8808299050;Taip;0;3;0;3
12151;Strazdelis;Saulutės;3270413614;Taip;5;3;0;8
12152;Strazdelis;Saulutės;3316451889;Taip;0;3;0;3
12153;Strazdelis;Saulutės;12713270671;Taip;0;3;0;3
12154;Strazdelis;Saulutės;6113491562;Taip;0;8;0;8
12155;Strazdelis;Saulutės;3753612757;Taip;0;3;0;3
12156;Strazdelis;Saulutės;1474503932;Taip;5;3;0;8
12157;Strazdelis;Saulutės;6779352728;Taip;5;2;0;7
12158;Strazdelis;Saulutės;9662566992;Taip;0;5;0;5
12159;Strazdelis;Bitutės;8485509145;Taip;0;5;0;5
12160;Strazdelis;Bitutės;6508933324;Taip;8;4;0;12
12161;Strazdelis;Bitutės;4020547762;Taip;0;4;0;4
12162;Strazdelis;Bitutės;8753316532;Taip;0;8;0;8
12163;Strazdelis;Bitutės;5232064496;Taip;0;3;0;3
12164;Strazdelis;Bitutės;9435593972;Taip;0;4;0;4
12165;Strazdelis;Bitutės;9555240419;Taip;0;12;0;12
12166;Strazdelis;Bitutės;3043580835;Taip;0;2;0;2
12167;Strazdelis;Bitutės;1539984888;Taip;0;3;0;3
12168;Strazdelis;Bitutės;4400849922;Taip;0;3;0;3
12169;Strazdelis;Bitutės;7890064837;Taip;5;0;1;6
12170;Strazdelis;Bitutės;1881071425;Taip;5;3;0;8
12171;Strazdelis;Bitutės;2908567982;Taip;6;3;0;9
12172;Strazdelis;Bitutės;9548465554;Taip;0;6;0;6
12173;Strazdelis;Bitutės;7466648222;Taip;8;2;0;10
12174;Strazdelis;Bitutės;4463378251;Taip;6;3;0;9
12175;Strazdelis;Bitutės;2963535523;Taip;0;2;1;3
12176;Strazdelis;Bitutės;4369569609;Taip;0;6;0;6
12177;Strazdelis;Bitutės;1005082012;Taip;0;4;0;4
12178;Strazdelis;Bitutės;2589303722;Taip;0;2;1;3
12179;Strazdelis;Bitutės;3149930355;Taip;6;0;0;6
12180;Strazdelis;Bitutės;2081538505;Taip;0;6;0;6
12181;Strazdelis;Bitutės;4784401449;Taip;1;0;0;1
12182;Strazdelis;Mažylių;9357195019;Taip;5;1;0;6
12183;Strazdelis;Mažylių;5256750516;Taip;12;3;0;15
12184;Strazdelis;Mažylių;4965049621;Taip;4;3;0;7
12185;Strazdelis;Mažylių;2378910473;Taip;0;14;0;14
12186;Strazdelis;Mažylių;4699373769;Taip;0;5;0;5
12187;Strazdelis;Mažylių;3648883435;Taip;13;0;0;13
12188;Strazdelis;Mažylių;6788732053;Taip;1;3;0;4
12189;Strazdelis;Mažylių;2764495554;Taip;1;3;0;4
12190;Strazdelis;Mažylių;7039347901;Taip;0;1;3;4
12191;Strazdelis;Mažylių;4904388387;Taip;0;4;0;4
12192;Strazdelis;Mažylių;3082900425;Taip;6;4;0;10
12193;Strazdelis;Mažylių;1265557971;Taip;0;4;0;4
12194;Strazdelis;Mažylių;3900225484;Taip;5;4;0;9
12195;Strazdelis;Mažylių;8734458997;Taip;5;5;1;11
12196;Strazdelis;Mažylių;3561551193;Taip;0;7;0;7
12197;Strazdelis;Mažylių;1932428439;Taip;3;4;0;7
12198;Strazdelis;Mažylių;2871841427;Taip;10;0;0;10
12199;Strazdelis;Mažylių;3572665646;Taip;2;3;0;5
12200;Strazdelis;Mažylių;8699020650;Taip;9;1;0;10
12201;Strazdelis;Pabiručių;7087235151;Taip;7;3;1;11
12202;Strazdelis;Pabiručių;3030445367;Taip;3;5;0;8
12203;Strazdelis;Pabiručių;4966668662;Taip;0;2;0;2
12204;Strazdelis;Pabiručių;8484672456;Ne;7;1;0;8
12205;Strazdelis;Pabiručių;8953577585;Taip;15;0;0;15
12206;Strazdelis;Pabiručių;1823053560;Taip;16;0;0;16
12207;Strazdelis;Pabiručių;8677659019;Taip;0;1;0;1
12208;Strazdelis;Pabiručių;7716476995;Taip;10;0;0;10
12209;Strazdelis;Pabiručių;4174940099;Taip;8;10;0;18
12210;Strazdelis;Pabiručių;8554043784;Taip;10;2;0;12
12211;Strazdelis;Pabiručių;1952086370;Taip;14;0;0;14
12212;Strazdelis;Pabiručių;7802337169;Taip;0;3;0;3
12213;Strazdelis;Pabiručių;4461728361;Taip;0;1;0;1
12214;Strazdelis;Pabiručių;8356680705;Taip;0;4;0;4
12215;Strazdelis;Pabiručių;6457478289;Ne;7;1;0;8
12216;Strazdelis;Pabiručių;3426039979;Taip;17;0;0;17
12217;Strazdelis;Pabiručių;4715198107;Taip;0;3;0;3
12218;Strazdelis;Pabiručių;4334385271;Taip;5;3;0;8
12219;Sveikuolis;Saulutė;5406563941;Taip;3;0;0;3
12220;Sveikuolis;Gintarėlis;4166776211;Taip;13;0;0;13
12221;Sveikuolis;ŽVAIGŽDUTĖ;6461929579;Taip;3;0;0;3
12222;Šermukšnėlė;MOLINUKAI;9746313951;Taip;5;3;0;8
12223;Šermukšnėlė;MOLINUKAI;4638109666;Taip;0;0;4;4
12224;Šermukšnėlė;MOLINUKAI;9329824053;Taip;0;8;0;8
12225;Šermukšnėlė;MOLINUKAI;2714018690;Taip;10;0;2;12
12226;Šermukšnėlė;MOLINUKAI;5262882873;Taip;5;1;0;6
12227;Šermukšnėlė;MOLINUKAI;2985284699;Taip;0;3;0;3
12228;Šermukšnėlė;MOLINUKAI;4983510683;Taip;0;3;0;3
12229;Šermukšnėlė;MOLINUKAI;7385114026;Taip;11;0;0;11
12230;Šermukšnėlė;MOLINUKAI;2784732759;Taip;0;3;4;7
12231;Šermukšnėlė;MOLINUKAI;3342919832;Taip;0;3;2;5
12232;Šermukšnėlė;MOLINUKAI;9337047371;Taip;10;3;0;13
12233;Šermukšnėlė;MOLINUKAI;2098090763;Taip;1;3;0;4
12234;Šermukšnėlė;MOLINUKAI;5835100042;Taip;0;0;5;5
12235;Šermukšnėlė;MOLINUKAI;8000479161;Taip;0;3;1;4
12236;Šermukšnėlė;MOLINUKAI;4952285322;Taip;0;3;0;3
12237;Šermukšnėlė;MOLINUKAI;5733048755;Taip;0;0;3;3
12238;Šermukšnėlė;MOLINUKAI;6608458145;Taip;0;0;3;3
12239;Šermukšnėlė;MOLINUKAI;8104182167;Taip;15;0;3;18
12240;Šermukšnėlė;MOLINUKAI;6988120570;Taip;6;8;0;14
12241;Šermukšnėlė;MOLINUKAI;8728441474;Taip;0;3;0;3
12242;Šermukšnėlė;MOLINUKAI;4075151928;Taip;0;0;4;4
12243;Šermukšnėlė;MOLINUKAI;9527382390;Taip;0;0;2;2
12244;Šermukšnėlė;MOLINUKAI;4968522498;Taip;9;3;0;12
12245;Šermukšnėlė;ŠIAUDINUKAI;7249568196;Taip;0;2;0;2
12246;Šermukšnėlė;ŠIAUDINUKAI;3451361097;Taip;0;0;3;3
12247;Šermukšnėlė;ŠIAUDINUKAI;7002917737;Taip;5;0;4;9
12248;Šermukšnėlė;ŠIAUDINUKAI;7785671936;Taip;3;0;0;3
12249;Šermukšnėlė;ŠIAUDINUKAI;3637882900;Taip;0;4;0;4
12250;Šermukšnėlė;ŠIAUDINUKAI;1159472154;Taip;0;3;2;5
12251;Šermukšnėlė;ŠIAUDINUKAI;4956414941;Taip;12;3;0;15
12252;Šermukšnėlė;ŠIAUDINUKAI;3499394539;Taip;10;6;0;16
12253;Šermukšnėlė;ŠIAUDINUKAI;1157979179;Taip;0;5;0;5
12254;Šermukšnėlė;ŠIAUDINUKAI;3701053997;Taip;10;3;1;14
12255;Šermukšnėlė;ŠIAUDINUKAI;7917101921;Taip;10;3;0;13
12256;Šermukšnėlė;ŠIAUDINUKAI;3082272196;Taip;6;0;0;6
12257;Šermukšnėlė;ŠIAUDINUKAI;9903310024;Taip;0;1;0;1
12258;Šermukšnėlė;ŠIAUDINUKAI;6993702887;Taip;2;3;0;5
12259;Šermukšnėlė;ŠIAUDINUKAI;9012757607;Taip;0;3;2;5
12260;Šermukšnėlė;ŠIAUDINUKAI;5627334876;Taip;6;0;0;6
12261;Šermukšnėlė;ŠIAUDINUKAI;3550736579;Taip;13;0;0;13
12262;Šermukšnėlė;ŠIAUDINUKAI;5993599994;Taip;9;0;0;9
12263;Šermukšnėlė;ŠIAUDINUKAI;3522028983;Taip;10;0;0;10
12264;Šermukšnėlė;ŠIAUDINUKAI;6077798297;Taip;0;3;0;3
12265;Šermukšnėlė;ŠIAUDINUKAI;2351386211;Taip;11;0;0;11
12266;Šermukšnėlė;ŠIAUDINUKAI;1437314920;Taip;0;5;0;5
12267;Šermukšnėlė;TOŠINUKAI;2160616078;Taip;0;3;0;3
12268;Šermukšnėlė;TOŠINUKAI;1661977128;Taip;10;0;1;11
12269;Šermukšnėlė;TOŠINUKAI;3994316729;Taip;0;3;1;4
12270;Šermukšnėlė;TOŠINUKAI;1459253197;Taip;0;6;1;7
12271;Šermukšnėlė;TOŠINUKAI;5140264695;Taip;6;0;0;6
12272;Šermukšnėlė;TOŠINUKAI;78341448188;Taip;5;3;0;8
12273;Šermukšnėlė;TOŠINUKAI;8279692394;Taip;0;3;3;6
12274;Šermukšnėlė;TOŠINUKAI;5096946133;Taip;0;3;1;4
12275;Šermukšnėlė;TOŠINUKAI;2380988728;Ne;0;12;0;12
12276;Šermukšnėlė;TOŠINUKAI;8956573129;Taip;0;3;0;3
12277;Šermukšnėlė;TOŠINUKAI;4981204674;Taip;0;5;0;5
12278;Šermukšnėlė;TOŠINUKAI;7229632099;Taip;6;3;0;9
12279;Šermukšnėlė;TOŠINUKAI;2529526401;Taip;0;3;1;4
12280;Šermukšnėlė;TOŠINUKAI;7038705221;Taip;0;3;0;3
12281;Šermukšnėlė;TOŠINUKAI;6413821285;Taip;0;7;0;7
12282;Šermukšnėlė;TOŠINUKAI;9035625467;Taip;8;0;1;9
12283;Šermukšnėlė;TOŠINUKAI;3081548524;Taip;5;3;0;8
12284;Šermukšnėlė;TOŠINUKAI;5832072195;Taip;0;12;0;12
12285;Šermukšnėlė;TOŠINUKAI;3222466449;Taip;3;3;1;7
12286;Šermukšnėlė;TOŠINUKAI;1753169856;Taip;3;2;0;5
12287;Šermukšnėlė;TOŠINUKAI;6430627501;Taip;5;3;0;8
12288;Šermukšnėlė;TOŠINUKAI;9442514813;Taip;0;3;0;3
12289;Šermukšnėlė;TOŠINUKAI;1569084597;Taip;0;3;2;5
12290;Šermukšnėlė;ODINUKAI;4422415026;Taip;10;3;1;14
12291;Šermukšnėlė;ODINUKAI;5545018656;Taip;0;3;0;3
12292;Šermukšnėlė;ODINUKAI;2176788727;Taip;0;0;2;2
12293;Šermukšnėlė;ODINUKAI;5575518612;Taip;3;0;1;4
12294;Šermukšnėlė;ODINUKAI;5733540837;Taip;0;3;0;3
12295;Šermukšnėlė;ODINUKAI;7262199284;Taip;0;3;0;3
12296;Šermukšnėlė;ODINUKAI;5159461963;Taip;0;3;1;4
12297;Šermukšnėlė;ODINUKAI;5354978646;Taip;0;4;2;6
12298;Šermukšnėlė;ODINUKAI;1882432812;Taip;0;4;2;6
12299;Šermukšnėlė;ODINUKAI;3949629658;Taip;0;0;1;1
12300;Šermukšnėlė;ODINUKAI;4201283154;Taip;0;3;0;3
12301;Šermukšnėlė;ODINUKAI;6105915822;Taip;0;3;0;3
12302;Šermukšnėlė;ODINUKAI;9742208172;Taip;0;3;0;3
12303;Šermukšnėlė;ODINUKAI;7667114310;Taip;8;3;0;11
12304;Šermukšnėlė;ODINUKAI;7245206247;Taip;0;0;7;7
12305;Šermukšnėlė;ODINUKAI;5397385093;Taip;0;3;4;7
12306;Šermukšnėlė;ODINUKAI;4331948700;Taip;0;0;1;1
12307;Šermukšnėlė;ODINUKAI;6718242890;Taip;0;3;1;4
12308;Šermukšnėlė;ODINUKAI;9664249364;Taip;4;0;0;4
12309;Šermukšnėlė;ODINUKAI;1064222922;Taip;15;0;1;16
12310;Šermukšnėlė;ODINUKAI;7770630580;Taip;0;0;2;2
12311;Šermukšnėlė;ODINUKAI;6194188831;Taip;0;3;0;3
12312;Šermukšnėlė;KRIAUKLELĖS;3613456202;Taip;0;0;8;8
12313;Šermukšnėlė;KRIAUKLELĖS;8541743148;Taip;2;3;0;5
12314;Šermukšnėlė;KRIAUKLELĖS;8709426669;Taip;0;9;0;9
12315;Šermukšnėlė;KRIAUKLELĖS;6585484701;Taip;0;1;4;5
12316;Šermukšnėlė;KRIAUKLELĖS;6599779539;Taip;0;6;0;6
12317;Šermukšnėlė;KRIAUKLELĖS;9876533442;Taip;0;0;3;3
12318;Šermukšnėlė;KRIAUKLELĖS;3653792683;Taip;0;3;2;5
12319;Šermukšnėlė;KRIAUKLELĖS;2506945279;Taip;0;2;0;2
12320;Šermukšnėlė;KRIAUKLELĖS;7266947985;Taip;0;0;2;2
12321;Šermukšnėlė;KRIAUKLELĖS;8117261716;Taip;5;3;1;9
12322;Šermukšnėlė;KRIAUKLELĖS;7458930634;Taip;5;0;1;6
12323;Šermukšnėlė;KRIAUKLELĖS;3245643086;Taip;6;5;0;11
12324;Šermukšnėlė;KRIAUKLELĖS;6946711443;Taip;0;0;3;3
12325;Šermukšnėlė;KRIAUKLELĖS;9908568127;Taip;0;5;0;5
12326;Šermukšnėlė;KRIAUKLELĖS;9783673534;Taip;1;1;0;2
12327;Šermukšnėlė;KRIAUKLELĖS;3002999054;Taip;0;0;1;1
12328;Šermukšnėlė;KRIAUKLELĖS;8748166398;Taip;0;0;3;3
12329;Šermukšnėlė;KRIAUKLELĖS;5408843906;Taip;5;5;0;10
12330;Šermukšnėlė;VYTINUKAI;1523361932;Taip;0;3;1;4
12331;Šermukšnėlė;VYTINUKAI;8531953934;Taip;1;3;0;4
12332;Šermukšnėlė;VYTINUKAI;25189813939;Taip;4;3;1;8
12333;Šermukšnėlė;VYTINUKAI;83123267733;Taip;0;3;1;4
12334;Šermukšnėlė;VYTINUKAI;20028832329;Taip;0;4;0;4
12335;Šermukšnėlė;VYTINUKAI;3959795064;Taip;0;3;0;3
12336;Šermukšnėlė;VYTINUKAI;8498288021;Taip;0;2;0;2
12337;Šermukšnėlė;VYTINUKAI;6291531570;Taip;0;1;0;1
12338;Šermukšnėlė;VYTINUKAI;1244964311;Taip;0;3;1;4
12339;Šermukšnėlė;VYTINUKAI;83882579952;Taip;0;3;0;3
12340;Šermukšnėlė;VYTINUKAI;60840526220;Taip;0;3;0;3
12341;Šermukšnėlė;VYTINUKAI;1025787925;Taip;0;3;1;4
12342;Šermukšnėlė;VYTINUKAI;1519623099;Taip;0;3;1;4
12343;Šermukšnėlė;VYTINUKAI;9654198217;Taip;5;1;3;9
12344;Šermukšnėlė;VYTINUKAI;1670047548;Taip;0;12;0;12
12345;Šermukšnėlė;VYTINUKAI;5281637612;Taip;0;8;1;9
12346;Šermukšnėlė;VYTINUKAI;1685592290;Taip;0;3;0;3
12347;Šermukšnėlė;VYTINUKAI;8123096990;Taip;7;3;0;10
12348;Šermukšnėlė;VYTINUKAI;8511421692;Taip;0;3;3;6
12349;Šermukšnėlė;VYTINUKAI;3883861823;Taip;0;10;0;10
12350;Šermukšnėlė;VYTINUKAI;2163955454;Taip;0;0;3;3
12351;Šermukšnėlė;VYTINUKAI;5225263863;Taip;0;3;0;3
12352;Šermukšnėlė;GINTARĖLIAI;5069572637;Taip;6;3;0;9
12353;Šermukšnėlė;GINTARĖLIAI;8249749948;Taip;0;3;1;4
12354;Šermukšnėlė;GINTARĖLIAI;2989011150;Taip;10;3;0;13
12355;Šermukšnėlė;GINTARĖLIAI;3747531232;Ne;0;12;0;12
12356;Šermukšnėlė;GINTARĖLIAI;1996859146;Taip;0;3;1;4
12357;Šermukšnėlė;GINTARĖLIAI;4176986876;Taip;0;9;0;9
12358;Šermukšnėlė;GINTARĖLIAI;7036078780;Taip;10;3;0;13
12359;Šermukšnėlė;GINTARĖLIAI;1994737857;Taip;8;6;0;14
12360;Šermukšnėlė;GINTARĖLIAI;4619811264;Taip;0;3;0;3
12361;Šermukšnėlė;GINTARĖLIAI;5886893562;Taip;18;0;0;18
12362;Šermukšnėlė;GINTARĖLIAI;4783726095;Taip;5;5;0;10
12363;Šermukšnėlė;GINTARĖLIAI;9714566919;Taip;0;5;0;5
12364;Šermukšnėlė;GINTARĖLIAI;5172187141;Taip;0;7;0;7
12365;Šermukšnėlė;GINTARĖLIAI;3688946505;Taip;0;0;7;7
12366;Šermukšnėlė;GINTARĖLIAI;5905330617;Taip;4;0;2;6
12367;Šermukšnėlė;GINTARĖLIAI;1636944853;Taip;0;8;0;8
12368;Šermukšnėlė;GINTARĖLIAI;7053319091;Taip;0;3;0;3
12369;Šermukšnėlė;GINTARĖLIAI;6351841889;Taip;7;0;1;8
12370;Šermukšnėlė;GINTARĖLIAI;7305013368;Taip;0;2;0;2
12371;Šermukšnėlė;GINTARĖLIAI;6698650179;Taip;5;3;1;9
12372;Šermukšnėlė;GINTARĖLIAI;7106405983;Taip;11;0;0;11
12373;Šermukšnėlė;GINTARĖLIAI;8639470631;Taip;0;0;1;1
12374;Šermukšnėlė;AKMENUKAI;3543061360;Taip;2;5;0;7
12375;Šermukšnėlė;AKMENUKAI;7564745299;Taip;0;11;0;11
12376;Šermukšnėlė;AKMENUKAI;9617044855;Taip;0;9;0;9
12377;Šermukšnėlė;AKMENUKAI;1856012121;Taip;15;0;1;16
12378;Šermukšnėlė;AKMENUKAI;8407947566;Taip;2;0;0;2
12379;Šermukšnėlė;AKMENUKAI;8859731179;Taip;0;3;1;4
12380;Šermukšnėlė;AKMENUKAI;1902848560;Taip;0;7;0;7
12381;Šermukšnėlė;AKMENUKAI;3513568460;Taip;0;3;2;5
12382;Šermukšnėlė;AKMENUKAI;6896990721;Taip;0;3;1;4
12383;Šermukšnėlė;AKMENUKAI;4230698872;Taip;0;0;1;1
12384;Šermukšnėlė;AKMENUKAI;8669676262;Taip;7;3;0;10
12385;Šermukšnėlė;AKMENUKAI;3148857617;Taip;0;9;0;9
12386;Šermukšnėlė;AKMENUKAI;4965640386;Taip;10;0;1;11
12387;Šermukšnėlė;AKMENUKAI;3639954786;Taip;0;0;16;16
12388;Šermukšnėlė;AKMENUKAI;7843128263;Taip;0;7;0;7
12389;Šermukšnėlė;AKMENUKAI;9805841777;Taip;12;0;0;12
12390;Šermukšnėlė;AKMENUKAI;5660238634;Taip;11;0;1;12
12391;Šermukšnėlė;AKMENUKAI;6067298318;Taip;0;5;0;5
12392;Šermukšnėlė;AKMENUKAI;5678559268;Taip;10;0;4;14
12393;Šermukšnėlė;AKMENUKAI;8479230675;Taip;0;9;0;9
12394;Šermukšnėlė;AKMENUKAI;6162830167;Taip;12;0;0;12
12395;Šermukšnėlė;SIŪLINUKAI;4619600451;Taip;0;0;5;5
12396;Šermukšnėlė;SIŪLINUKAI;2967000352;Taip;15;0;0;15
12397;Šermukšnėlė;SIŪLINUKAI;4528448735;Taip;8;0;3;11
12398;Šermukšnėlė;SIŪLINUKAI;2740644605;Taip;4;3;0;7
12399;Šermukšnėlė;SIŪLINUKAI;8454298610;Taip;8;0;2;10
12400;Šermukšnėlė;SIŪLINUKAI;6429038861;Taip;10;0;2;12
12401;Šermukšnėlė;SIŪLINUKAI;6429038861;Taip;10;0;2;12
12402;Šermukšnėlė;SIŪLINUKAI;6429038861;Taip;10;0;2;12
12403;Šermukšnėlė;SIŪLINUKAI;6429038861;Taip;10;0;2;12
12404;Šermukšnėlė;SIŪLINUKAI;1819553019;Taip;9;0;0;9
12405;Šermukšnėlė;SIŪLINUKAI;7568969509;Taip;8;0;1;9
12406;Šermukšnėlė;SIŪLINUKAI;7758886713;Taip;9;4;0;13
12407;Šermukšnėlė;SIŪLINUKAI;4390650081;Taip;7;0;0;7
12408;Šermukšnėlė;SIŪLINUKAI;5072021867;Taip;8;0;0;8
12409;Šermukšnėlė;SIŪLINUKAI;7934772640;Taip;0;5;0;5
12410;Šermukšnėlė;SIŪLINUKAI;3994075596;Ne;8;0;0;8
12411;Šermukšnėlė;SIŪLINUKAI;3098629992;Taip;5;1;0;6
12412;Šermukšnėlė;SIŪLINUKAI;6231057889;Taip;5;1;1;7
12413;Šermukšnėlė;SIŪLINUKAI;3106890807;Taip;5;0;0;5
12414;Šermukšnėlė;SIŪLINUKAI;3979766151;Taip;6;0;0;6
12415;Šermukšnėlė;SIŪLINUKAI;9534316724;Taip;0;8;1;9
12416;Šermukšnėlė;SIŪLINUKAI;2705569653;Taip;5;0;3;8
12417;Šermukšnėlė;MEDINUKAi;8558117857;Taip;0;18;0;18
12418;Šermukšnėlė;MEDINUKAi;1318170904;Taip;9;0;0;9
12419;Šermukšnėlė;MEDINUKAi;6149973884;Taip;5;0;3;8
12420;Šermukšnėlė;MEDINUKAi;5874725607;Taip;4;0;2;6
12421;Šermukšnėlė;MEDINUKAi;7532979465;Taip;12;0;4;16
12422;Šermukšnėlė;MEDINUKAi;7834844175;Taip;7;0;0;7
12423;Šermukšnėlė;MEDINUKAi;7211488009;Taip;6;0;3;9
12424;Šermukšnėlė;MEDINUKAi;3359398381;Taip;8;4;0;12
12425;Šermukšnėlė;MEDINUKAi;6928863055;Taip;3;0;1;4
12426;Šermukšnėlė;MEDINUKAi;6531113007;Taip;5;0;0;5
12427;Šermukšnėlė;MEDINUKAi;8437052600;Taip;0;8;0;8
12428;Šermukšnėlė;MEDINUKAi;8200175951;Taip;14;3;0;17
12429;Šermukšnėlė;MEDINUKAi;7546040491;Taip;8;0;0;8
12430;Šermukšnėlė;MEDINUKAi;9872479998;Taip;5;0;2;7
12431;Šermukšnėlė;MEDINUKAi;8587108797;Taip;18;0;0;18
12432;Šermukšnėlė;MEDINUKAi;5605191023;Taip;7;0;3;10
12433;Šermukšnėlė;MEDINUKAi;2698741674;Taip;5;2;0;7
12434;Šermukšnėlė;SKUDURINUKAI;7523588943;Taip;5;3;0;8
12435;Šermukšnėlė;SKUDURINUKAI;2235123503;Taip;0;0;4;4
12436;Šermukšnėlė;SKUDURINUKAI;9535836301;Taip;11;0;0;11
12437;Šermukšnėlė;SKUDURINUKAI;3138507073;Taip;5;0;0;5
12438;Šermukšnėlė;SKUDURINUKAI;5162694179;Taip;4;3;1;8
12439;Šermukšnėlė;SKUDURINUKAI;9247356229;Taip;13;4;0;17
12440;Šermukšnėlė;SKUDURINUKAI;3206222470;Taip;18;0;0;18
12441;Šermukšnėlė;SKUDURINUKAI;5751303170;Taip;10;3;0;13
12442;Šermukšnėlė;SKUDURINUKAI;2810624440;Taip;0;5;0;5
12443;Šermukšnėlė;SKUDURINUKAI;3955219247;Taip;12;0;0;12
12444;Šermukšnėlė;SKUDURINUKAI;5564759354;Taip;11;0;3;14
12445;Šermukšnėlė;SKUDURINUKAI;1931894084;Taip;3;1;3;7
12446;Šermukšnėlė;SKUDURINUKAI;6778901855;Taip;0;3;4;7
12447;Šermukšnėlė;SKUDURINUKAI;1502704170;Taip;8;3;0;11
12448;Šermukšnėlė;SKUDURINUKAI;6524173015;Taip;0;0;1;1
12449;Šermukšnėlė;SKUDURINUKAI;4323596263;Taip;3;0;1;4
12450;Šermukšnėlė;PAGRANDUKAI;8802335133;Taip;0;3;0;3
12451;Šermukšnėlė;PAGRANDUKAI;6797936390;Taip;0;7;0;7
12452;Šermukšnėlė;PAGRANDUKAI;1312471779;Taip;9;3;1;13
12453;Šermukšnėlė;PAGRANDUKAI;6286235756;Taip;8;3;0;11
12454;Šermukšnėlė;PAGRANDUKAI;4337084152;Taip;4;0;6;10
12455;Šermukšnėlė;PAGRANDUKAI;8710910167;Taip;8;0;1;9
12456;Šermukšnėlė;PAGRANDUKAI;8092422909;Taip;18;0;0;18
12457;Šermukšnėlė;PAGRANDUKAI;9246072554;Taip;5;0;1;6
12458;Šermukšnėlė;PAGRANDUKAI;6185588116;Taip;7;0;0;7
12459;Šermukšnėlė;PAGRANDUKAI;1209135668;Taip;18;0;0;18
12460;Šermukšnėlė;PAGRANDUKAI;9080074486;Taip;0;3;8;11
12461;Šermukšnėlė;PAGRANDUKAI;7098953763;Taip;0;0;5;5
12462;Šermukšnėlė;PAGRANDUKAI;5081685546;Taip;12;3;0;15
12463;Šermukšnėlė;PAGRANDUKAI;5456669766;Taip;5;1;0;6
12464;Šermukšnėlė;PAGRANDUKAI;8641098720;Taip;10;0;3;13
12465;Šermukšnėlė;PAGRANDUKAI;4810571143;Taip;0;4;0;4
12466;Šypsena;NYKŠTUKAI;8913058656;Taip;7;1;6;14
12467;Šypsena;NYKŠTUKAI;8508569167;Taip;3;3;0;6
12468;Šypsena;NYKŠTUKAI;5818211923;Taip;6;0;0;6
12469;Šypsena;NYKŠTUKAI;8665786789;Taip;13;4;1;18
12470;Šypsena;NYKŠTUKAI;1716274053;Ne;0;4;3;7
12471;Šypsena;NYKŠTUKAI;6724776618;Taip;0;13;3;16
12472;Šypsena;NYKŠTUKAI;2790906806;Ne;0;7;0;7
12473;Šypsena;NYKŠTUKAI;9363618080;Taip;5;2;4;11
12474;Šypsena;NYKŠTUKAI;9702364620;Ne;0;12;0;12
12475;Šypsena;NYKŠTUKAI;3733757483;Taip;5;3;0;8
12476;Šypsena;NYKŠTUKAI;2179657619;Ne;2;9;0;11
12477;Šypsena;NYKŠTUKAI;2900195046;Taip;14;3;0;17
12478;Šypsena;NYKŠTUKAI;3724645162;Taip;5;3;0;8
12479;Šypsena;NYKŠTUKAI;3003901966;Taip;16;8;0;24
12480;Šypsena;NYKŠTUKAI;2182189246;Taip;0;3;1;4
12481;Šypsena;NYKŠTUKAI;1431850136;Taip;0;11;0;11
12482;Šypsena;NYKŠTUKAI;5142969776;Taip;19;0;1;20
12483;Šypsena;NYKŠTUKAI;8439694239;Taip;11;5;0;16
12484;Šypsena;NYKŠTUKAI;6377979434;Taip;1;6;5;12
12485;Šypsena;NYKŠTUKAI;7332307199;Taip;7;0;3;10
12486;Šypsena;NYKŠTUKAI;7074211876;Taip;0;2;5;7
12487;Šypsena;SPINDULIUKAI;7898387398;Taip;5;4;0;9
12488;Šypsena;SPINDULIUKAI;1324902555;Taip;10;4;0;14
12489;Šypsena;SPINDULIUKAI;5222603743;Taip;1;3;0;4
12490;Šypsena;SPINDULIUKAI;7120597034;Taip;0;3;0;3
12491;Šypsena;SPINDULIUKAI;5879506651;Taip;0;3;0;3
12492;Šypsena;SPINDULIUKAI;3823623458;Ne;0;3;0;3
12493;Šypsena;SPINDULIUKAI;4695547847;Taip;0;3;0;3
12494;Šypsena;SPINDULIUKAI;6713182218;Taip;0;4;0;4
12495;Šypsena;SPINDULIUKAI;1287205292;Taip;11;0;0;11
12496;Šypsena;SPINDULIUKAI;8215278033;Taip;0;3;0;3
12497;Šypsena;SPINDULIUKAI;7537442618;Taip;1;4;0;5
12498;Šypsena;SPINDULIUKAI;2584574423;Taip;9;2;0;11
12499;Šypsena;SPINDULIUKAI;9704350208;Ne;6;5;0;11
12500;Šypsena;SPINDULIUKAI;5906001927;Taip;9;0;0;9
12501;Šypsena;SPINDULIUKAI;6951845385;Taip;0;3;3;6
12502;Šypsena;SPINDULIUKAI;7877396588;Taip;0;9;0;9
12503;Šypsena;SPINDULIUKAI;4520148322;Taip;0;2;0;2
12504;Šypsena;SPINDULIUKAI;3901424559;Taip;0;3;3;6
12505;Šypsena;SPINDULIUKAI;8765509994;Taip;0;5;3;8
12506;Šypsena;SPINDULIUKAI;3429836513;Taip;0;3;15;18
12507;Šypsena;SPINDULIUKAI;8566236342;Taip;0;3;8;11
12508;Šypsena;SKRUZDELIUKAI;5611440056;Ne;5;3;0;8
12509;Šypsena;SKRUZDELIUKAI;1114341518;Taip;6;0;0;6
12510;Šypsena;SKRUZDELIUKAI;1558614852;Taip;2;5;0;7
12511;Šypsena;SKRUZDELIUKAI;1897176871;Taip;1;6;0;7
12512;Šypsena;SKRUZDELIUKAI;8715718525;Taip;0;0;1;1
12513;Šypsena;SKRUZDELIUKAI;2312828770;Taip;0;2;0;2
12514;Šypsena;SKRUZDELIUKAI;1181590127;Taip;0;9;0;9
12515;Šypsena;SKRUZDELIUKAI;4808041625;Taip;0;3;3;6
12516;Šypsena;SKRUZDELIUKAI;1422418997;Taip;0;4;0;4
12517;Šypsena;SKRUZDELIUKAI;4038279267;Taip;0;6;1;7
12518;Šypsena;SKRUZDELIUKAI;5834057370;Taip;0;8;0;8
12519;Šypsena;SKRUZDELIUKAI;1515803985;Taip;0;6;0;6
12520;Šypsena;SKRUZDELIUKAI;3809171499;Taip;4;3;0;7
12521;Šypsena;SKRUZDELIUKAI;4344780723;Taip;3;3;8;14
12522;Šypsena;SKRUZDELIUKAI;5928432220;Taip;0;3;0;3
12523;Šypsena;SKRUZDELIUKAI;5504570516;Taip;0;3;1;4
12524;Šypsena;SKRUZDELIUKAI;1063834589;Taip;8;3;0;11
12525;Šypsena;SKRUZDELIUKAI;5369445077;Taip;0;3;0;3
12526;Šypsena;SKRUZDELIUKAI;2798819321;Taip;6;6;0;12
12527;Šypsena;SKRUZDELIUKAI;3506046076;Ne;5;3;1;9
12528;Šypsena;SKRUZDELIUKAI;4450146424;Taip;0;3;0;3
12529;Šypsena;SKRUZDELIUKAI;7519967594;Taip;8;0;1;9
12530;Šypsena;Bitutės;1796837022;Taip;0;3;0;3
12531;Šypsena;Bitutės;6158973964;Taip;1;3;0;4
12532;Šypsena;Bitutės;6590285866;Taip;0;3;0;3
12533;Šypsena;Bitutės;4766170132;Ne;0;3;0;3
12534;Šypsena;Bitutės;7569495879;Taip;0;3;0;3
12535;Šypsena;Bitutės;6832433711;Taip;0;3;0;3
12536;Šypsena;Bitutės;2995753269;Taip;0;3;1;4
12537;Šypsena;Bitutės;2248628927;Taip;5;4;0;9
12538;Šypsena;Bitutės;2706678026;Ne;0;1;0;1
12539;Šypsena;Bitutės;7413098580;Ne;9;4;0;13
12540;Šypsena;Bitutės;3063226692;Ne;0;3;1;4
12541;Šypsena;Bitutės;5985974927;Taip;0;3;0;3
12542;Šypsena;Bitutės;3387625466;Taip;0;3;3;6
12543;Šypsena;Bitutės;1669768648;Ne;7;3;0;10
12544;Šypsena;Bitutės;1575413188;Taip;0;6;0;6
12545;Šypsena;Bitutės;6511231991;Ne;0;3;0;3
12546;Šypsena;Bitutės;2005543016;Ne;0;3;0;3
12547;Šypsena;Bitutės;5568502083;Taip;0;2;0;2
12548;Šypsena;MEŠKIUKAI;9696633725;Taip;8;0;2;10
12549;Šypsena;MEŠKIUKAI;7876871684;Taip;5;2;1;8
12550;Šypsena;MEŠKIUKAI;6055482561;Ne;10;0;0;10
12551;Šypsena;MEŠKIUKAI;6028006499;Taip;4;3;2;9
12552;Šypsena;MEŠKIUKAI;3724483762;Ne;4;3;0;7
12553;Šypsena;MEŠKIUKAI;7817486488;Taip;14;3;1;18
12554;Šypsena;MEŠKIUKAI;9862387726;Taip;0;3;1;4
12555;Šypsena;MEŠKIUKAI;8001187137;Ne;0;3;0;3
12556;Šypsena;MEŠKIUKAI;3663446767;Taip;0;3;3;6
12557;Šypsena;MEŠKIUKAI;8094166916;Taip;0;3;3;6
12558;Šypsena;MEŠKIUKAI;5446516798;Taip;0;3;0;3
12559;Šypsena;MEŠKIUKAI;5094556499;Taip;0;3;5;8
12560;Šypsena;MEŠKIUKAI;4496704989;Taip;4;4;0;8
12561;Šypsena;MEŠKIUKAI;7471913547;Taip;0;3;1;4
12562;Šypsena;MEŠKIUKAI;7174068697;Taip;4;2;0;6
12563;Šypsena;BORUŽĖLĖS;6738149077;Taip;8;5;2;15
12564;Šypsena;BORUŽĖLĖS;7905089772;Taip;1;3;2;6
12565;Šypsena;BORUŽĖLĖS;4011596895;Taip;4;3;2;9
12566;Šypsena;BORUŽĖLĖS;7234904026;Ne;5;4;0;9
12567;Šypsena;BORUŽĖLĖS;8963484558;Ne;13;3;0;16
12568;Šypsena;BORUŽĖLĖS;3951000812;Taip;8;9;0;17
12569;Šypsena;BORUŽĖLĖS;2177181171;Taip;9;3;0;12
12570;Šypsena;BORUŽĖLĖS;7960872132;Ne;12;3;0;15
12571;Šypsena;BORUŽĖLĖS;4260693029;Ne;9;4;0;13
12572;Šypsena;BORUŽĖLĖS;1657019248;Taip;4;3;2;9
12573;Šypsena;BORUŽĖLĖS;8756079118;Taip;4;8;0;12
12574;Šypsena;BORUŽĖLĖS;6859531936;Ne;9;3;0;12
12575;Šnekutis;DRUGELIŲ;1504945841;Taip;0;9;0;9
12576;Šnekutis;DRUGELIŲ;6305168453;Taip;0;0;6;6
12577;Šnekutis;DRUGELIŲ;9543014297;Taip;0;1;3;4
12578;Šnekutis;DRUGELIŲ;3096125224;Taip;10;0;0;10
12579;Šnekutis;DRUGELIŲ;3386995244;Taip;12;0;0;12
12580;Šnekutis;DRUGELIŲ;2131948397;Taip;10;0;0;10
12581;Šnekutis;DRUGELIŲ;1902486846;Taip;6;0;1;7
12582;Šnekutis;DRUGELIŲ;8984597121;Taip;9;0;1;10
12583;Šnekutis;DRUGELIŲ;8810371475;Taip;0;0;5;5
12584;Šnekutis;DRUGELIŲ;7680962037;Taip;8;0;3;11
12585;Šnekutis;DRUGELIŲ;7089148766;Taip;10;2;0;12
12586;Šnekutis;DRUGELIŲ;3611064172;Taip;2;3;2;7
12587;Šnekutis;DRUGELIŲ;3079202929;Taip;6;0;3;9
12588;Šnekutis;DRUGELIŲ;8209686459;Taip;0;4;0;4
12589;Šnekutis;DRUGELIŲ;8036600501;Taip;9;4;0;13
12590;Šnekutis;DRUGELIŲ;6071004512;Taip;11;0;0;11
12591;Šnekutis;DRUGELIŲ;8570372260;Taip;6;0;0;6
12592;Šnekutis;DRUGELIŲ;1556960616;Taip;7;5;0;12
12593;Šnekutis;DRUGELIŲ;3177449195;Taip;6;6;0;12
12594;Šnekutis;DRUGELIŲ;4380966487;Taip;17;0;0;17
12595;Šnekutis;DRUGELIŲ;7954240439;Taip;7;0;3;10
12596;Šnekutis;DRUGELIŲ;6330033887;Taip;4;0;3;7
12597;Šnekutis;Kačiukų;3281475303;Taip;0;8;1;9
12598;Šnekutis;Kačiukų;9670205249;Taip;0;3;3;6
12599;Šnekutis;Kačiukų;7615716438;Taip;4;5;0;9
12600;Šnekutis;Kačiukų;9780684867;Taip;0;3;0;3
12601;Šnekutis;Kačiukų;3271262071;Taip;7;2;2;11
12602;Šnekutis;Kačiukų;3166309530;Taip;0;3;0;3
12603;Šnekutis;Kačiukų;4143844589;Taip;0;2;0;2
12604;Šnekutis;Kačiukų;9312935803;Taip;0;3;7;10
12605;Šnekutis;Kačiukų;7236658561;Taip;0;3;0;3
12606;Šnekutis;Kačiukų;4992188525;Taip;0;3;0;3
12607;Šnekutis;Kačiukų;7638626055;Taip;0;0;11;11
12608;Šnekutis;Kačiukų;9157136735;Ne;0;4;0;4
12609;Šnekutis;Kačiukų;4920263429;Taip;0;3;0;3
12610;Šnekutis;Kačiukų;5909584565;Taip;0;4;0;4
12611;Šnekutis;Kačiukų;6234943180;Taip;0;4;0;4
12612;Šnekutis;Kačiukų;2914145045;Ne;13;0;0;13
12613;Šnekutis;Kačiukų;8340697546;Taip;9;0;0;9
12614;Šnekutis;Kačiukų;9896249776;Taip;0;3;9;12
12615;Šnekutis;Kačiukų;2656152037;Taip;0;5;0;5
12616;Šnekutis;Kačiukų;9051956302;Taip;10;3;5;18
12617;Šnekutis;Kačiukų;5521822696;Ne;0;5;0;5
12618;Šnekutis;Kačiukų;9942669058;Taip;0;3;0;3
12619;Šnekutis;Kačiukų;2144568225;Taip;5;0;0;5
12620;Šnekutis;Kačiukų;4624075875;Taip;0;3;6;9
12621;Šnekutis;Pėlėdžiukų;5188035949;Taip;0;3;0;3
12622;Šnekutis;Pėlėdžiukų;3068754741;Taip;0;3;0;3
12623;Šnekutis;Pėlėdžiukų;4334155280;Taip;0;3;0;3
12624;Šnekutis;Pėlėdžiukų;77534335117;Taip;0;3;2;5
12625;Šnekutis;Pėlėdžiukų;3312928478;Taip;0;3;0;3
12626;Šnekutis;Pėlėdžiukų;8866360301;Taip;5;3;0;8
12627;Šnekutis;Pėlėdžiukų;8745465796;Taip;14;4;0;18
12628;Šnekutis;Pėlėdžiukų;3170928052;Taip;6;1;0;7
12629;Šnekutis;Pėlėdžiukų;3578045341;Taip;0;5;1;6
12630;Šnekutis;Pėlėdžiukų;5117544317;Taip;0;3;0;3
12631;Šnekutis;Pėlėdžiukų;5615869149;Taip;4;5;0;9
12632;Šnekutis;Pėlėdžiukų;1329958641;Taip;0;4;3;7
12633;Šnekutis;Pėlėdžiukų;9511116249;Taip;0;4;0;4
12634;Šnekutis;Pėlėdžiukų;1369660223;Taip;0;3;0;3
12635;Šnekutis;Pėlėdžiukų;1682748852;Taip;0;3;1;4
12636;Šnekutis;Pėlėdžiukų;2525115674;Taip;7;3;0;10
12637;Šnekutis;Pėlėdžiukų;9601932777;Taip;17;0;0;17
12638;Šnekutis;Pėlėdžiukų;4302555600;Taip;17;0;0;17
12639;Šnekutis;Pėlėdžiukų;7507857415;Taip;0;4;0;4
12640;Šnekutis;Pėlėdžiukų;7514753023;Taip;10;3;0;13
12641;Šnekutis;Pėlėdžiukų;54532738133;Taip;0;1;0;1
12642;Šnekutis;Boružėlių;4835202527;Taip;5;3;0;8
12643;Šnekutis;Boružėlių;9326455786;Taip;9;0;1;10
12644;Šnekutis;Boružėlių;9054899440;Taip;0;3;0;3
12645;Šnekutis;Boružėlių;9862362744;Taip;0;0;3;3
12646;Šnekutis;Boružėlių;5597629090;Taip;0;2;0;2
12647;Šnekutis;Boružėlių;7089000987;Taip;0;1;0;1
12648;Šnekutis;Boružėlių;2843483435;Taip;0;0;1;1
12649;Šnekutis;Boružėlių;5906320006;Taip;0;3;0;3
12650;Šnekutis;Boružėlių;6405894763;Ne;16;2;0;18
12651;Šnekutis;Boružėlių;3889176018;Taip;1;8;3;12
12652;Šnekutis;Boružėlių;6749848086;Taip;11;0;0;11
12653;Šnekutis;Boružėlių;6146988521;Taip;0;5;0;5
12654;Šnekutis;Boružėlių;5519015388;Taip;8;0;2;10
12655;Šnekutis;Boružėlių;3628210526;Taip;0;3;1;4
12656;Šnekutis;Boružėlių;7344776758;Taip;0;2;1;3
12657;Šnekutis;Boružėlių;5970951526;Taip;0;0;1;1
12658;Šnekutis;Boružėlių;3344425033;Ne;12;1;5;18
12659;Šnekutis;Boružėlių;3937465849;Taip;0;3;0;3
12660;Šnekutis;Boružėlių;8219465079;Taip;8;5;0;13
12661;Šnekutis;Boružėlių;6015384795;Ne;0;0;3;3
12662;Šnekutis;Boružėlių;7307895397;Taip;0;0;5;5
12663;Šnekutis;Boružėlių;3371393656;Taip;14;0;0;14
12664;Šnekutis;Boružėlių;2779793970;Taip;28;0;0;28
12665;Šnekutis;Meškučių;2852111627;Taip;13;0;0;13
12666;Šnekutis;Meškučių;3214549246;Taip;13;0;0;13
12667;Šnekutis;Meškučių;6306269165;Taip;4;0;2;6
12668;Šnekutis;Meškučių;2626247219;Taip;7;3;0;10
12669;Šnekutis;Meškučių;7707897830;Taip;11;0;0;11
12670;Šnekutis;Meškučių;2042842873;Taip;5;3;0;8
12671;Šnekutis;Meškučių;2140099519;Taip;9;1;0;10
12672;Šnekutis;Meškučių;9709701441;Taip;10;0;1;11
12673;Šnekutis;Meškučių;2761479685;Taip;2;0;0;2
12674;Šnekutis;Meškučių;1219175855;Taip;16;0;1;17
12675;Šnekutis;Meškučių;9574210410;Taip;3;3;0;6
12676;Šnekutis;Meškučių;7980166125;Taip;14;0;0;14
12677;Šnekutis;Meškučių;8456957469;Taip;10;0;0;10
12678;Šnekutis;Meškučių;3572114463;Taip;5;11;0;16
12679;Šnekutis;Meškučių;8417485561;Taip;5;3;0;8
12680;Šnekutis;Meškučių;2312968654;Taip;10;0;0;10
12681;Šnekutis;Meškučių;1475304511;Taip;7;0;1;8
12682;Šnekutis;Viščiukų;9790241725;Taip;0;0;3;3
12683;Šnekutis;Viščiukų;9322106995;Taip;5;0;3;8
12684;Šnekutis;Viščiukų;3842436406;Taip;17;0;0;17
12685;Šnekutis;Viščiukų;3115675798;Taip;14;0;0;14
12686;Šnekutis;Viščiukų;9385583890;Taip;0;0;13;13
12687;Šnekutis;Viščiukų;5934631354;Taip;6;0;2;8
12688;Šnekutis;Viščiukų;4848437026;Taip;14;0;0;14
12689;Šnekutis;Viščiukų;9772257715;Taip;0;3;0;3
12690;Šnekutis;Viščiukų;3593766968;Taip;2;3;1;6
12691;Šnekutis;Viščiukų;1833392181;Taip;9;0;0;9
12692;Šnekutis;Viščiukų;1805259980;Taip;4;0;0;4
12693;Šnekutis;Viščiukų;3588737003;Taip;0;0;15;15
12694;Šnekutis;Viščiukų;7200356364;Taip;1;0;5;6
12695;Šnekutis;Viščiukų;1248466603;Taip;10;4;0;14
12696;Šnekutis;Viščiukų;9007182019;Taip;13;0;0;13
12697;Šnekutis;Viščiukų;7006343288;Taip;14;0;0;14
12698;Šnekutis;Viščiukų;5919317274;Taip;5;0;0;5
12699;Užupiukas;VYTURĖLIŲ;5116564840;Taip;0;3;1;4
12700;Užupiukas;VYTURĖLIŲ;7443013255;Taip;3;0;4;7
12701;Užupiukas;VYTURĖLIŲ;3656400244;Taip;0;12;0;12
12702;Užupiukas;VYTURĖLIŲ;3829013911;Taip;0;3;5;8
12703;Užupiukas;VYTURĖLIŲ;9212428150;Taip;0;3;4;7
12704;Užupiukas;VYTURĖLIŲ;8001099421;Taip;14;0;0;14
12705;Užupiukas;VYTURĖLIŲ;4401569800;Taip;0;3;0;3
12706;Užupiukas;VYTURĖLIŲ;1391826582;Taip;0;0;5;5
12707;Užupiukas;VYTURĖLIŲ;5021163099;Taip;0;3;0;3
12708;Užupiukas;VYTURĖLIŲ;8960813016;Taip;0;0;6;6
12709;Užupiukas;VYTURĖLIŲ;9132605734;Taip;0;0;11;11
12710;Užupiukas;VYTURĖLIŲ;8245876832;Ne;5;4;0;9
12711;Užupiukas;VYTURĖLIŲ;7532497390;Taip;3;0;3;6
12712;Užupiukas;VYTURĖLIŲ;5168946019;Taip;0;0;5;5
12713;Užupiukas;VYTURĖLIŲ;5718382826;Taip;0;4;5;9
12714;Užupiukas;VYTURĖLIŲ;9209209113;Taip;0;0;6;6
12715;Užupiukas;VYTURĖLIŲ;9070732925;Taip;0;0;3;3
12716;Užupiukas;VYTURĖLIŲ;1146968021;Taip;0;3;2;5
12717;Užupiukas;VYTURĖLIŲ;1647271985;Taip;0;0;4;4
12718;Užupiukas;VYTURĖLIŲ;8347350503;Taip;11;3;0;14
12719;Užupiukas;VYTURĖLIŲ;2580733127;Taip;0;3;0;3
12720;Užupiukas;KAČIUKŲ;3905448176;Taip;4;0;0;4
12721;Užupiukas;KAČIUKŲ;3567963511;Taip;0;3;5;8
12722;Užupiukas;KAČIUKŲ;9991552624;Taip;0;3;0;3
12723;Užupiukas;KAČIUKŲ;3048959458;Taip;0;3;0;3
12724;Užupiukas;KAČIUKŲ;3080668107;Taip;5;5;0;10
12725;Užupiukas;KAČIUKŲ;1809036046;Taip;0;7;0;7
12726;Užupiukas;KAČIUKŲ;1102468034;Taip;0;4;0;4
12727;Užupiukas;KAČIUKŲ;1464016943;Taip;3;3;1;7
12728;Užupiukas;KAČIUKŲ;4485435274;Taip;0;0;2;2
12729;Užupiukas;KAČIUKŲ;1102293237;Taip;0;7;3;10
12730;Užupiukas;KAČIUKŲ;9386211193;Taip;0;3;2;5
12731;Užupiukas;KAČIUKŲ;7048114101;Taip;0;0;6;6
12732;Užupiukas;KAČIUKŲ;1388346927;Taip;0;0;1;1
12733;Užupiukas;KAČIUKŲ;9333587467;Taip;0;3;0;3
12734;Užupiukas;KAČIUKŲ;7574528186;Taip;0;8;0;8
12735;Užupiukas;KAČIUKŲ;7092857844;Taip;0;3;1;4
12736;Užupiukas;KAČIUKŲ;2606742144;Taip;0;3;0;3
12737;Užupiukas;KAČIUKŲ;5233447872;Taip;0;0;18;18
12738;Užupiukas;KAČIUKŲ;9719845726;Taip;0;3;0;3
12739;Užupiukas;KAČIUKŲ;3543913063;Taip;0;7;9;16
12740;Užupiukas;KAČIUKŲ;4920190785;Taip;0;15;1;16
12741;Užupiukas;DRUGELIŲ;8876174256;Taip;17;0;0;17
12742;Užupiukas;DRUGELIŲ;5239006321;Taip;0;0;6;6
12743;Užupiukas;DRUGELIŲ;7581152903;Taip;9;3;5;17
12744;Užupiukas;DRUGELIŲ;5361599156;Taip;5;8;0;13
12745;Užupiukas;DRUGELIŲ;4680027403;Taip;0;0;4;4
12746;Užupiukas;DRUGELIŲ;6698907535;Taip;5;0;2;7
12747;Užupiukas;DRUGELIŲ;9577167600;Taip;7;1;3;11
12748;Užupiukas;DRUGELIŲ;3419182422;Taip;1;0;1;2
12749;Užupiukas;DRUGELIŲ;4854016957;Taip;18;0;0;18
12750;Užupiukas;DRUGELIŲ;8692826414;Taip;5;0;1;6
12751;Užupiukas;DRUGELIŲ;7169272175;Taip;0;0;18;18
12752;Užupiukas;DRUGELIŲ;1156471313;Taip;9;0;3;12
12753;Užupiukas;DRUGELIŲ;4595291532;Taip;0;0;7;7
12754;Užupiukas;DRUGELIŲ;3383643388;Taip;5;0;7;12
12755;Užupiukas;DRUGELIŲ;3961733676;Taip;15;0;2;17
12756;Užupiukas;DRUGELIŲ;5006880916;Taip;14;0;0;14
12757;Užupiukas;DRUGELIŲ;4075611307;Taip;0;3;1;4
12758;Užupiukas;DRUGELIŲ;9715624372;Taip;0;0;4;4
12759;Užupiukas;DRUGELIŲ;1108429907;Taip;10;0;8;18
12760;Užupiukas;DRUGELIŲ;9295230331;Taip;6;0;3;9
12761;Užupiukas;DRUGELIŲ;3940029893;Taip;5;0;3;8
12762;Užupiukas;DRUGELIŲ;3575209839;Taip;6;3;0;9
12763;Užupiukas;EŽIUKŲ;1526296386;Taip;7;0;4;11
12764;Užupiukas;EŽIUKŲ;9774124589;Ne;0;13;0;13
12765;Užupiukas;EŽIUKŲ;2724216446;Taip;18;0;0;18
12766;Užupiukas;EŽIUKŲ;9446562736;Taip;0;0;3;3
12767;Užupiukas;EŽIUKŲ;5072363435;Taip;0;0;3;3
12768;Užupiukas;EŽIUKŲ;1651249962;Taip;0;2;0;2
12769;Užupiukas;EŽIUKŲ;1100574872;Taip;0;6;1;7
12770;Užupiukas;EŽIUKŲ;5204808398;Taip;0;3;0;3
12771;Užupiukas;EŽIUKŲ;3171528288;Taip;9;0;3;12
12772;Užupiukas;EŽIUKŲ;7860601571;Taip;5;3;0;8
12773;Užupiukas;EŽIUKŲ;3611922301;Taip;3;3;0;6
12774;Užupiukas;EŽIUKŲ;8020138690;Taip;0;0;3;3
12775;Užupiukas;EŽIUKŲ;6823724962;Taip;4;6;0;10
12776;Užupiukas;EŽIUKŲ;3057147440;Taip;0;3;0;3
12777;Užupiukas;EŽIUKŲ;6370918943;Taip;0;3;2;5
12778;Užupiukas;EŽIUKŲ;9357101972;Taip;0;0;3;3
12779;Užupiukas;EŽIUKŲ;6512355340;Taip;0;0;3;3
12780;Užupiukas;EŽIUKŲ;4356736070;Taip;0;0;4;4
12781;Užupiukas;EŽIUKŲ;9906475253;Taip;4;3;2;9
12782;Užupiukas;EŽIUKŲ;8127218866;Taip;0;4;0;4
12783;Užupiukas;EŽIUKŲ;8720638097;Taip;3;3;3;9
12784;Užupiukas;BORUŽĖLIŲ;4781598862;Taip;0;3;3;6
12785;Užupiukas;BORUŽĖLIŲ;7861121290;Taip;0;0;2;2
12786;Užupiukas;BORUŽĖLIŲ;12787288319;Taip;2;0;3;5
12787;Užupiukas;BORUŽĖLIŲ;6526550727;Taip;0;0;2;2
12788;Užupiukas;BORUŽĖLIŲ;9735462228;Taip;0;3;0;3
12789;Užupiukas;BORUŽĖLIŲ;9791681813;Taip;0;3;2;5
12790;Užupiukas;BORUŽĖLIŲ;1503714343;Taip;3;3;0;6
12791;Užupiukas;BORUŽĖLIŲ;8313812681;Taip;5;3;0;8
12792;Užupiukas;BORUŽĖLIŲ;9677572224;Taip;0;3;0;3
12793;Užupiukas;BORUŽĖLIŲ;2445335267;Taip;3;0;0;3
12794;Užupiukas;BORUŽĖLIŲ;1514268763;Taip;0;1;0;1
12795;Užupiukas;BORUŽĖLIŲ;7555702944;Taip;0;2;0;2
12796;Užupiukas;BORUŽĖLIŲ;2307600884;Taip;5;3;1;9
12797;Užupiukas;BORUŽĖLIŲ;6073039842;Taip;0;3;2;5
12798;Užupiukas;BORUŽĖLIŲ;3038973312;Taip;0;1;0;1
12799;Užupiukas;BORUŽĖLIŲ;6601099182;Ne;0;5;0;5
12800;Užupiukas;BORUŽĖLIŲ;3940264504;Taip;0;3;1;4
12801;Užupiukas;BORUŽĖLIŲ;2704243085;Taip;0;0;2;2
12802;Užupiukas;BORUŽĖLIŲ;5517458323;Taip;0;0;8;8
12803;Užupiukas;BORUŽĖLIŲ;7427702848;Taip;5;3;0;8
12804;Užupiukas;SPINDULIUKŲ;5889162375;Taip;3;8;0;11
12805;Užupiukas;SPINDULIUKŲ;1718518621;Taip;0;3;2;5
12806;Užupiukas;SPINDULIUKŲ;7140606152;Taip;0;1;3;4
12807;Užupiukas;SPINDULIUKŲ;1679324943;Taip;6;3;0;9
12808;Užupiukas;SPINDULIUKŲ;7298322865;Taip;4;3;0;7
12809;Užupiukas;SPINDULIUKŲ;8734960045;Taip;0;3;2;5
12810;Užupiukas;SPINDULIUKŲ;9863097416;Taip;0;2;2;4
12811;Užupiukas;SPINDULIUKŲ;3579499796;Taip;0;2;0;2
12812;Užupiukas;SPINDULIUKŲ;1772019951;Taip;0;3;0;3
12813;Užupiukas;SPINDULIUKŲ;3298267311;Taip;0;3;0;3
12814;Užupiukas;SPINDULIUKŲ;9617597828;Taip;0;2;0;2
12815;Užupiukas;SPINDULIUKŲ;8915159672;Taip;0;3;0;3
12816;Užupiukas;SPINDULIUKŲ;2348243399;Taip;0;1;0;1
12817;Užupiukas;SPINDULIUKŲ;1554333137;Taip;0;3;13;16
12818;Užupiukas;SPINDULIUKŲ;9723966502;Taip;0;3;5;8
12819;Užupiukas;SPINDULIUKŲ;9655636851;Taip;0;3;3;6
12820;Užupiukas;SPINDULIUKŲ;8724566014;Taip;10;3;2;15
12821;Užupiukas;SPINDULIUKŲ;8870229834;Taip;0;3;2;5
12822;Užupiukas;SPINDULIUKŲ;14139543365;Taip;0;3;2;5
12823;Užupiukas;SPINDULIUKŲ;9096157655;Taip;0;3;7;10
12824;Užupiukas;SPINDULIUKŲ;9782972949;Taip;0;3;0;3
12825;Užupiukas;SPINDULIUKŲ;3958071677;Taip;0;3;0;3
12826;Užupiukas;SPINDULIUKŲ;3231001225;Taip;0;3;2;5
12827;Užupiukas;SPINDULIUKŲ;5406866873;Taip;0;3;2;5
12828;Užupiukas;ŽVIRBLIUKŲ;8519118225;Taip;0;3;0;3
12829;Užupiukas;ŽVIRBLIUKŲ;7549628277;Taip;0;3;0;3
12830;Užupiukas;ŽVIRBLIUKŲ;5085660507;Taip;0;8;0;8
12831;Užupiukas;ŽVIRBLIUKŲ;2273766308;Taip;6;2;0;8
12832;Užupiukas;ŽVIRBLIUKŲ;7530856195;Taip;0;4;0;4
12833;Užupiukas;ŽVIRBLIUKŲ;9925592494;Taip;0;2;1;3
12834;Užupiukas;ŽVIRBLIUKŲ;7345579721;Taip;0;2;6;8
12835;Užupiukas;ŽVIRBLIUKŲ;4710910251;Taip;0;9;3;12
12836;Užupiukas;ŽVIRBLIUKŲ;9428884149;Taip;0;3;0;3
12837;Užupiukas;ŽVIRBLIUKŲ;4054724625;Taip;5;13;0;18
12838;Užupiukas;ŽVIRBLIUKŲ;2210437775;Taip;0;7;0;7
12839;Užupiukas;ŽVIRBLIUKŲ;1995228207;Taip;0;8;0;8
12840;Užupiukas;ŽVIRBLIUKŲ;1496541880;Taip;0;13;0;13
12841;Užupiukas;ŽVIRBLIUKŲ;1684901495;Taip;0;3;0;3
12842;Užupiukas;ŽVIRBLIUKŲ;2390955083;Taip;0;5;0;5
12843;Užupiukas;ŽVIRBLIUKŲ;6001766518;Taip;0;3;0;3
12844;Užupiukas;ŽVIRBLIUKŲ;3768945773;Taip;0;4;0;4
12845;Užupiukas;ŽVIRBLIUKŲ;3224193396;Taip;0;3;0;3
12846;Užupiukas;ŽVIRBLIUKŲ;1843171673;Taip;0;3;0;3
12847;Užupiukas;ŽVIRBLIUKŲ;4785494419;Taip;10;6;0;16
12848;Užupiukas;ŽVIRBLIUKŲ;8119142600;Taip;0;4;2;6
12849;Užupiukas;ŽVIRBLIUKŲ;2362568676;Taip;10;4;0;14
12850;Užupiukas;PELĖDŽIUKŲ;2938276316;Taip;0;3;1;4
12851;Užupiukas;PELĖDŽIUKŲ;5320544400;Taip;0;3;1;4
12852;Užupiukas;PELĖDŽIUKŲ;40704768956;Taip;0;3;0;3
12853;Užupiukas;PELĖDŽIUKŲ;5665323444;Ne;0;3;8;11
12854;Užupiukas;PELĖDŽIUKŲ;4880828482;Taip;0;3;6;9
12855;Užupiukas;PELĖDŽIUKŲ;6478702476;Taip;0;3;4;7
12856;Užupiukas;PELĖDŽIUKŲ;6110869303;Taip;0;3;1;4
12857;Užupiukas;PELĖDŽIUKŲ;3205769002;Taip;5;3;2;10
12858;Užupiukas;PELĖDŽIUKŲ;79442829922;Taip;0;3;0;3
12859;Užupiukas;PELĖDŽIUKŲ;4247280316;Taip;0;3;0;3
12860;Užupiukas;PELĖDŽIUKŲ;4608233152;Taip;0;3;0;3
12861;Užupiukas;PELĖDŽIUKŲ;5498369850;Taip;0;3;2;5
12862;Užupiukas;PELĖDŽIUKŲ;2821350355;Taip;0;2;2;4
12863;Užupiukas;PELĖDŽIUKŲ;3309195572;Taip;0;3;9;12
12864;Užupiukas;PELĖDŽIUKŲ;4132760111;Ne;0;5;0;5
12865;Užupiukas;PELĖDŽIUKŲ;22401995674;Taip;5;3;0;8
12866;Užupiukas;PELĖDŽIUKŲ;53412835151;Taip;0;2;1;3
12867;Užupiukas;PELĖDŽIUKŲ;6236652118;Taip;0;2;1;3
12868;Užupiukas;PELĖDŽIUKŲ;3774364829;Taip;0;3;0;3
12869;Užupiukas;PELĖDŽIUKŲ;9197242545;Taip;0;3;5;8
12870;Užupiukas;PELĖDŽIUKŲ;5357731534;Ne;0;0;3;3
12871;Užupiukas;PELĖDŽIUKŲ;5046355276;Taip;0;1;0;1
12872;Užupiukas;PELĖDŽIUKŲ;1091861376;Taip;0;0;1;1
12873;Užupiukas;VARPELIŲ;7107441792;Taip;3;0;1;4
12874;Užupiukas;VARPELIŲ;8881187663;Taip;0;0;3;3
12875;Užupiukas;VARPELIŲ;7895825571;Taip;0;0;3;3
12876;Užupiukas;VARPELIŲ;8518137669;Taip;0;3;2;5
12877;Užupiukas;VARPELIŲ;7919242126;Taip;0;0;3;3
12878;Užupiukas;VARPELIŲ;9310238442;Taip;3;0;2;5
12879;Užupiukas;VARPELIŲ;2769924857;Taip;3;0;1;4
12880;Užupiukas;VARPELIŲ;5941280824;Taip;0;0;9;9
12881;Užupiukas;VARPELIŲ;7105857162;Taip;5;13;0;18
12882;Užupiukas;VARPELIŲ;2485426055;Taip;14;0;0;14
12883;Užupiukas;VARPELIŲ;7314085267;Taip;2;0;3;5
12884;Užupiukas;VARPELIŲ;2752139377;Taip;3;0;0;3
12885;Užupiukas;VARPELIŲ;4106614478;Taip;3;0;4;7
12886;Užupiukas;VARPELIŲ;1407429980;Taip;0;3;0;3
12887;Užupiukas;VARPELIŲ;4811619739;Taip;0;1;0;1
12888;Užupiukas;VARPELIŲ;2767523129;Taip;0;2;0;2
12889;Užupiukas;VARPELIŲ;9523512906;Taip;12;0;0;12
12890;Užupiukas;VARPELIŲ;3745080560;Taip;3;0;2;5
12891;Užupiukas;VARPELIŲ;9815421737;Taip;0;0;7;7
12892;Užupiukas;SAULUČIŲ;5704945892;Taip;5;3;2;10
12893;Užupiukas;SAULUČIŲ;2681679016;Taip;0;0;4;4
12894;Užupiukas;SAULUČIŲ;3684774901;Taip;0;3;4;7
12895;Užupiukas;SAULUČIŲ;8163092636;Taip;5;0;5;10
12896;Užupiukas;SAULUČIŲ;1976775494;Taip;0;0;6;6
12897;Užupiukas;SAULUČIŲ;5874450724;Taip;0;0;6;6
12898;Užupiukas;SAULUČIŲ;3341292382;Taip;0;0;9;9
12899;Užupiukas;SAULUČIŲ;2211595125;Taip;10;3;0;13
12900;Užupiukas;SAULUČIŲ;7450368045;Taip;5;3;1;9
12901;Užupiukas;SAULUČIŲ;5570569874;Taip;1;0;4;5
12902;Užupiukas;SAULUČIŲ;7643286183;Taip;0;0;6;6
12903;Užupiukas;SAULUČIŲ;2814556305;Taip;0;0;9;9
12904;Užupiukas;SAULUČIŲ;7209853233;Taip;0;0;3;3
12905;Užupiukas;SAULUČIŲ;9953994943;Taip;5;5;0;10
12906;Užupiukas;SAULUČIŲ;6849149197;Ne;0;0;1;1
12907;Užupiukas;SAULUČIŲ;7956550754;Taip;17;0;1;18
12908;Užupiukas;SAULUČIŲ;5469735455;Taip;0;3;4;7
12909;Užupiukas;SAULUČIŲ;8489545569;Taip;3;0;5;8
12910;Užupiukas;SAULUČIŲ;7990479988;Taip;0;0;8;8
12911;Užupiukas;SAULUČIŲ;4691413468;Taip;12;0;0;12
12912;Užupiukas;SAULUČIŲ;7423292334;Taip;11;0;0;11
12913;Užupiukas;SAULUČIŲ;9216626936;Taip;0;3;2;5
12914;Užupiukas;SAULUČIŲ;9962455415;Taip;0;0;5;5
12915;Užupiukas;LAPIUKŲ;9833934299;Taip;7;5;0;12
12916;Užupiukas;LAPIUKŲ;4963679583;Taip;10;0;3;13
12917;Užupiukas;LAPIUKŲ;2679915982;Taip;1;1;1;3
12918;Užupiukas;LAPIUKŲ;6004467875;Taip;0;2;0;2
12919;Užupiukas;LAPIUKŲ;1718048938;Taip;8;1;0;9
12920;Užupiukas;LAPIUKŲ;7986962850;Taip;6;0;0;6
12921;Užupiukas;LAPIUKŲ;2517606394;Taip;6;0;5;11
12922;Užupiukas;LAPIUKŲ;7487174943;Taip;0;2;1;3
12923;Užupiukas;LAPIUKŲ;5965564175;Taip;0;1;3;4
12924;Užupiukas;LAPIUKŲ;5680350014;Taip;0;4;0;4
12925;Užupiukas;LAPIUKŲ;7161001771;Taip;3;1;0;4
12926;Užupiukas;LAPIUKŲ;1886792898;Taip;0;3;0;3
12927;Užupiukas;LAPIUKŲ;6967184410;Taip;0;3;0;3
12928;Užupiukas;LAPIUKŲ;4900699267;Taip;0;1;3;4
12929;Užupiukas;LAPIUKŲ;1178152392;Taip;5;4;0;9
12930;Užupiukas;LAPIUKŲ;7029091978;Taip;0;15;0;15
12931;Užupiukas;LAPIUKŲ;3311694266;Taip;0;1;0;1
12932;Užupiukas;LAPIUKŲ;1041972540;Taip;0;4;0;4
12933;Užupiukas;LAPIUKŲ;4467470795;Taip;0;5;0;5
12934;Užupiukas;LAPIUKŲ;8252575784;Taip;5;3;0;8
12935;Užupiukas;LAPIUKŲ;3333547785;Taip;5;1;1;7
12936;Užupiukas;LAPIUKŲ;8529259340;Taip;0;4;0;4
12937;Užupiukas;NYKŠTUKŲ;4895744524;Taip;18;0;0;18
12938;Užupiukas;NYKŠTUKŲ;3811750547;Taip;5;0;4;9
12939;Užupiukas;NYKŠTUKŲ;2158976125;Taip;9;0;0;9
12940;Užupiukas;NYKŠTUKŲ;6857321547;Taip;15;0;0;15
12941;Užupiukas;NYKŠTUKŲ;5381329362;Taip;0;3;2;5
12942;Užupiukas;NYKŠTUKŲ;6206118484;Taip;0;3;1;4
12943;Užupiukas;NYKŠTUKŲ;1399112659;Taip;18;0;0;18
12944;Užupiukas;NYKŠTUKŲ;9785674147;Taip;0;0;3;3
12945;Užupiukas;NYKŠTUKŲ;9714322911;Taip;2;3;1;6
12946;Užupiukas;NYKŠTUKŲ;3014087333;Taip;0;3;1;4
12947;Užupiukas;NYKŠTUKŲ;7589905741;Taip;5;0;5;10
12948;Užupiukas;NYKŠTUKŲ;1891855020;Taip;0;0;4;4
12949;Užupiukas;NYKŠTUKŲ;1473606331;Taip;4;0;3;7
12950;Užupiukas;NYKŠTUKŲ;4570457987;Taip;0;3;4;7
12951;Užupiukas;NYKŠTUKŲ;9312234251;Taip;0;3;0;3
12952;Vaidilutė;Žiogelis;7779630805;Taip;1;0;3;4
12953;Vaidilutė;Žiogelis;9876388990;Taip;0;0;1;1
12954;Vaidilutė;Žiogelis;3990013866;Taip;0;3;0;3
12955;Vaidilutė;Žiogelis;45949026707;Taip;0;1;0;1
12956;Vaidilutė;Žiogelis;1853463568;Taip;4;0;1;5
12957;Vaidilutė;Žiogelis;5620009051;Taip;0;0;3;3
12958;Vaidilutė;Žiogelis;5203062837;Taip;0;3;0;3
12959;Vaidilutė;Žiogelis;3112025222;Taip;8;0;0;8
12960;Vaidilutė;Žiogelis;4334934114;Taip;0;3;3;6
12961;Vaidilutė;Žiogelis;7843388119;Taip;0;5;0;5
12962;Vaidilutė;Žiogelis;2041126370;Taip;3;0;4;7
12963;Vaidilutė;Žiogelis;3152118407;Taip;0;0;3;3
12964;Vaidilutė;Žiogelis;5991149222;Taip;0;6;5;11
12965;Vaidilutė;Žiogelis;1786022030;Taip;2;3;1;6
12966;Vaidilutė;Žiogelis;1266927367;Taip;4;3;4;11
12967;Vaidilutė;Žiogelis;1430802591;Taip;0;3;0;3
12968;Vaidilutė;Žiogelis;4259585225;Taip;0;3;0;3
12969;Vaidilutė;Žiogelis;9556632708;Taip;0;3;0;3
12970;Vaidilutė;Žiogelis;1769926207;Taip;0;0;3;3
12971;Vaidilutė;Rūtelė;2131127298;Taip;0;4;0;4
12972;Vaidilutė;Rūtelė;8789527552;Taip;0;5;0;5
12973;Vaidilutė;Rūtelė;7319037375;Taip;0;2;5;7
12974;Vaidilutė;Rūtelė;4838951446;Taip;3;2;0;5
12975;Vaidilutė;Rūtelė;7494818866;Ne;0;5;0;5
12976;Vaidilutė;Rūtelė;5500950179;Taip;3;0;0;3
12977;Vaidilutė;Rūtelė;1140011879;Taip;0;5;0;5
12978;Vaidilutė;Rūtelė;9652684068;Taip;0;1;2;3
12979;Vaidilutė;Rūtelė;2024078532;Taip;0;1;1;2
12980;Vaidilutė;Rūtelė;5482030284;Taip;0;3;2;5
12981;Vaidilutė;Rūtelė;8505156287;Taip;7;2;0;9
12982;Vaidilutė;Rūtelė;9568450630;Taip;3;2;0;5
12983;Vaidilutė;Rūtelė;7306768961;Taip;3;1;2;6
12984;Vaidilutė;Rūtelė;7532115462;Taip;0;2;4;6
12985;Vaidilutė;Rūtelė;6896047075;Taip;3;2;0;5
12986;Vaidilutė;Rūtelė;3059654988;Taip;3;5;1;9
12987;Vaidilutė;Rūtelė;1341696594;Taip;0;2;2;4
12988;Vaidilutė;Rūtelė;1141947715;Taip;0;5;2;7
12989;Vaidilutė;Rūtelė;9437865610;Taip;0;4;0;4
12990;Vaidilutė;Rūtelė;2014160468;Ne;0;1;3;4
12991;Vaidilutė;Voveraitė;1608646909;Taip;17;0;0;17
12992;Vaidilutė;Voveraitė;9429544108;Taip;0;0;3;3
12993;Vaidilutė;Voveraitė;8377824920;Taip;0;16;0;16
12994;Vaidilutė;Voveraitė;5296146822;Taip;0;1;2;3
12995;Vaidilutė;Voveraitė;3299081380;Taip;5;0;0;5
12996;Vaidilutė;Voveraitė;3634285869;Taip;0;0;12;12
12997;Vaidilutė;Voveraitė;7703578508;Taip;10;0;4;14
12998;Vaidilutė;Voveraitė;3150642420;Taip;7;0;2;9
12999;Vaidilutė;Voveraitė;5855762068;Taip;0;0;3;3
13000;Vaidilutė;Voveraitė;8177787790;Taip;0;0;4;4
13001;Vaidilutė;Voveraitė;7327131165;Taip;10;3;1;14
13002;Vaidilutė;Voveraitė;2318578603;Taip;8;0;4;12
13003;Vaidilutė;Voveraitė;9372280434;Taip;0;0;5;5
13004;Vaidilutė;Voveraitė;1372767364;Ne;0;3;1;4
13005;Vaidilutė;Voveraitė;7478943531;Taip;0;3;0;3
13006;Vaidilutė;Voveraitė;4738318120;Taip;0;10;0;10
13007;Vaidilutė;Voveraitė;3319615121;Taip;0;0;3;3
13008;Vaidilutė;Voveraitė;6299324271;Ne;0;0;3;3
13009;Vaidilutė;Voveraitė;4186708502;Taip;10;0;3;13
13010;Vaidilutė;Voveraitė;2855672500;Taip;8;9;0;17
13011;Vaidilutė;Voveraitė;8053548602;Taip;0;0;18;18
13012;Vaidilutė;Saulutė;8492055287;Taip;3;6;1;10
13013;Vaidilutė;Saulutė;6844372910;Taip;10;0;0;10
13014;Vaidilutė;Saulutė;4972645715;Taip;0;0;7;7
13015;Vaidilutė;Saulutė;1355005114;Taip;0;1;0;1
13016;Vaidilutė;Saulutė;4680645841;Taip;0;0;3;3
13017;Vaidilutė;Saulutė;2662468804;Taip;2;5;1;8
13018;Vaidilutė;Saulutė;5217609332;Taip;0;5;0;5
13019;Vaidilutė;Saulutė;2864731541;Taip;16;0;0;16
13020;Vaidilutė;Saulutė;1998872078;Taip;0;3;0;3
13021;Vaidilutė;Saulutė;2468220275;Taip;0;3;2;5
13022;Vaidilutė;Saulutė;1610262589;Taip;3;0;1;4
13023;Vaidilutė;Saulutė;2356037175;Taip;0;0;1;1
13024;Vaidilutė;Saulutė;5054640268;Taip;7;0;0;7
13025;Vaidilutė;Saulutė;6885473308;Taip;0;3;0;3
13026;Vaidilutė;Saulutė;7826111890;Taip;5;0;0;5
13027;Vaidilutė;Saulutė;9870763434;Taip;11;0;1;12
13028;Vaidilutė;Saulutė;5945744595;Taip;6;6;0;12
13029;Vaidilutė;Saulutė;6674238265;Ne;0;3;2;5
13030;Vaidilutė;Saulutė;2495112045;Taip;0;0;1;1
13031;Vaidilutė;Saulutė;1092821241;Taip;5;3;0;8
13032;Vaidilutė;Saulutė;2294802783;Taip;2;6;0;8
13033;Vaidilutė;Žibutė;5668493994;Taip;13;0;0;13
13034;Vaidilutė;Žibutė;4085959509;Taip;4;0;2;6
13035;Vaidilutė;Žibutė;1001320466;Taip;0;3;0;3
13036;Vaidilutė;Žibutė;3051006765;Taip;0;0;1;1
13037;Vaidilutė;Žibutė;9189713003;Taip;4;0;2;6
13038;Vaidilutė;Žibutė;7903242996;Taip;12;0;1;13
13039;Vaidilutė;Žibutė;7400197367;Taip;2;3;0;5
13040;Vaidilutė;Žibutė;5236154349;Taip;5;0;0;5
13041;Vaidilutė;Žibutė;3980894528;Taip;1;5;1;7
13042;Vaidilutė;Žibutė;1362256314;Taip;0;6;0;6
13043;Vaidilutė;Žibutė;7940581813;Taip;10;0;0;10
13044;Vaidilutė;Žibutė;2767482145;Taip;5;0;5;10
13045;Vaidilutė;Žibutė;7765298370;Taip;0;0;1;1
13046;Vaidilutė;Žibutė;8769601956;Taip;4;0;2;6
13047;Vaidilutė;Žibutė;1726638921;Taip;4;4;1;9
13048;Vaidilutė;Žibutė;5415279154;Taip;13;0;0;13
13049;Vaidilutė;Žibutė;1377015807;Taip;8;0;0;8
13050;Vaidilutė;Žibutė;4124217264;Taip;6;0;1;7
13051;Vaidilutė;Žibutė;7429825620;Taip;11;0;0;11
13052;Vaidilutė;Žibutė;3087959868;Taip;9;0;0;9
13053;Vaidilutė;Žibutė;7690470762;Taip;10;0;0;10
13054;Vaidilutė;"Ąžuoliukas ";3463112472;Taip;4;0;2;6
13055;Vaidilutė;"Ąžuoliukas ";3730573432;Taip;7;2;0;9
13056;Vaidilutė;"Ąžuoliukas ";6586072228;Taip;0;2;0;2
13057;Vaidilutė;"Ąžuoliukas ";5988376676;Taip;0;5;3;8
13058;Vaidilutė;"Ąžuoliukas ";1305478052;Taip;0;0;6;6
13059;Vaidilutė;"Ąžuoliukas ";4954285515;Ne;0;3;0;3
13060;Vaidilutė;"Ąžuoliukas ";5556351358;Taip;0;3;0;3
13061;Vaidilutė;"Ąžuoliukas ";5439973183;Taip;0;3;0;3
13062;Vaidilutė;"Ąžuoliukas ";3381544575;Taip;0;0;3;3
13063;Vaidilutė;"Ąžuoliukas ";5307486959;Taip;0;3;0;3
13064;Vaidilutė;"Ąžuoliukas ";1653497170;Taip;0;3;0;3
13065;Vaidilutė;"Ąžuoliukas ";1440819171;Taip;0;3;2;5
13066;Vaidilutė;"Ąžuoliukas ";2668758195;Taip;0;3;1;4
13067;Vaidilutė;"Ąžuoliukas ";4901387311;Taip;0;5;0;5
13068;Vaidilutė;"Ąžuoliukas ";9811981645;Taip;0;3;0;3
13069;Vaidilutė;"Ąžuoliukas ";2997948252;Taip;0;3;1;4
13070;Vaidilutė;"Ąžuoliukas ";9723156071;Taip;0;0;4;4
13071;Vaidilutė;"Ąžuoliukas ";4193108560;Ne;0;3;0;3
13072;Vaidilutė;"Ąžuoliukas ";3782651091;Taip;17;0;0;17
13073;Vaidilutė;"Ąžuoliukas ";6637224510;Taip;0;0;3;3
13074;Vaidilutė;"Ąžuoliukas ";6067801976;Taip;8;0;4;12
13075;Vaidilutė;"Žemuogėlė ";1993403692;Taip;0;2;4;6
13076;Vaidilutė;"Žemuogėlė ";42503303158;Taip;0;3;1;4
13077;Vaidilutė;"Žemuogėlė ";9869134464;Taip;0;2;0;2
13078;Vaidilutė;"Žemuogėlė ";29153363263;Taip;3;0;0;3
13079;Vaidilutė;"Žemuogėlė ";3069613102;Taip;0;4;0;4
13080;Vaidilutė;"Žemuogėlė ";1297817018;Taip;0;2;0;2
13081;Vaidilutė;"Žemuogėlė ";5177060346;Taip;0;3;0;3
13082;Vaidilutė;"Žemuogėlė ";4671287016;Taip;0;3;2;5
13083;Vaidilutė;"Žemuogėlė ";9124975928;Taip;0;3;0;3
13084;Vaidilutė;"Žemuogėlė ";7419525100;Taip;0;3;0;3
13085;Vaidilutė;"Žemuogėlė ";1363913645;Taip;7;5;1;13
13086;Vaidilutė;"Žemuogėlė ";5252637701;Taip;0;3;0;3
13087;Vaidilutė;"Žemuogėlė ";3202508790;Taip;0;0;2;2
13088;Vaidilutė;"Žemuogėlė ";1320999237;Taip;0;4;2;6
13089;Vaidilutė;"Žemuogėlė ";9769645272;Taip;0;0;3;3
13090;Vaidilutė;"Žemuogėlė ";1691407801;Taip;0;3;0;3
13091;Vaidilutė;"Žemuogėlė ";1315347184;Taip;0;3;0;3
13092;Vaidilutė;"Žemuogėlė ";1704155743;Taip;0;3;0;3
13093;Vaidilutė;"Žemuogėlė ";1139332221;Taip;0;3;0;3
13094;Vaidilutė;"Žemuogėlė ";5276088687;Taip;0;3;0;3
13095;Vaidilutė;"Žemuogėlė ";1477508451;Taip;0;3;3;6
13096;Vaidilutė;"Vyturėlis ";3121914268;Taip;0;3;0;3
13097;Vaidilutė;"Vyturėlis ";5050251048;Taip;7;3;0;10
13098;Vaidilutė;"Vyturėlis ";7106410219;Taip;4;0;0;4
13099;Vaidilutė;"Vyturėlis ";9558983004;Taip;8;0;0;8
13100;Vaidilutė;"Vyturėlis ";5326935037;Taip;13;3;0;16
13101;Vaidilutė;"Vyturėlis ";2189753894;Taip;0;6;0;6
13102;Vaidilutė;"Vyturėlis ";9689388330;Taip;0;3;0;3
13103;Vaidilutė;"Vyturėlis ";9584702487;Taip;0;4;0;4
13104;Vaidilutė;"Vyturėlis ";2081959307;Taip;3;3;2;8
13105;Vaidilutė;"Vyturėlis ";8882402632;Ne;0;5;0;5
13106;Vaidilutė;"Vyturėlis ";1539700521;Taip;0;3;0;3
13107;Vaidilutė;"Vyturėlis ";4230076320;Taip;0;3;0;3
13108;Vaidilutė;"Vyturėlis ";2058071219;Taip;0;3;1;4
13109;Vaidilutė;"Vyturėlis ";4388069915;Taip;0;1;0;1
13110;Vaidilutė;"Vyturėlis ";1401180999;Taip;7;1;0;8
13111;Vaidilutė;"Vyturėlis ";1417828163;Taip;0;3;0;3
13112;Vaidilutė;"Vyturėlis ";5651628204;Ne;0;3;0;3
13113;Vaidilutė;"Vyturėlis ";2251608691;Taip;8;0;0;8
13114;Vaidilutė;"Vyturėlis ";7914006128;Taip;1;0;1;2
13115;Vaidilutė;"Vyturėlis ";2194984060;Taip;0;3;1;4
13116;Vaidilutė;"Vyturėlis ";3351968717;Taip;0;4;0;4
13117;Vaidilutė;"Varpelis ";6250831269;Taip;0;2;0;2
13118;Vaidilutė;"Varpelis ";2763266518;Taip;0;2;0;2
13119;Vaidilutė;"Varpelis ";6037349527;Taip;0;3;3;6
13120;Vaidilutė;"Varpelis ";5867501558;Taip;0;3;0;3
13121;Vaidilutė;"Varpelis ";3832349858;Taip;0;0;3;3
13122;Vaidilutė;"Varpelis ";9317774960;Taip;0;1;2;3
13123;Vaidilutė;"Varpelis ";5448014291;Taip;0;3;2;5
13124;Vaidilutė;"Varpelis ";3497795848;Taip;0;3;1;4
13125;Vaidilutė;"Varpelis ";4280822951;Taip;0;0;3;3
13126;Vaidilutė;"Varpelis ";6107554047;Taip;5;0;0;5
13127;Vaidilutė;"Varpelis ";3453045619;Taip;0;0;5;5
13128;Vaidilutė;"Varpelis ";6022130248;Taip;3;0;1;4
13129;Vaidilutė;"Varpelis ";5101104226;Taip;0;0;1;1
13130;Vaidilutė;"Varpelis ";5594121340;Taip;0;0;3;3
13131;Vaidilutė;"Varpelis ";1882829340;Taip;0;4;0;4
13132;Vaidilutė;"Varpelis ";3353827105;Taip;0;0;8;8
13133;Vaidilutė;"Varpelis ";4362797606;Taip;0;4;0;4
13134;Vaidilutė;"Varpelis ";6322986820;Taip;0;3;3;6
13135;Vaidilutė;"Varpelis ";2941550026;Taip;0;3;1;4
13136;Vaidilutė;"Boružėlių ";6928815317;Taip;12;0;0;12
13137;Vaidilutė;"Boružėlių ";2164241264;Taip;13;0;0;13
13138;Vaidilutė;"Boružėlių ";4648985217;Taip;0;4;0;4
13139;Vaidilutė;"Boružėlių ";4348206726;Taip;18;0;0;18
13140;Vaidilutė;"Boružėlių ";5405461987;Taip;5;0;1;6
13141;Vaidilutė;"Boružėlių ";1283676263;Taip;0;0;1;1
13142;Vaidilutė;"Boružėlių ";8629789128;Taip;6;0;0;6
13143;Vaidilutė;"Boružėlių ";2315322608;Taip;6;3;0;9
13144;Vaidilutė;"Boružėlių ";7019245743;Taip;5;3;0;8
13145;Vaidilutė;"Boružėlių ";7075509397;Taip;0;3;0;3
13146;Vaidilutė;"Boružėlių ";8012451263;Taip;18;0;0;18
13147;Vaidilutė;"Boružėlių ";5205356977;Taip;0;3;0;3
13148;Vaidilutė;"Boružėlių ";5095161432;Taip;11;0;0;11
13149;Vaidilutė;"Malūnelis ";4887753072;Taip;6;3;0;9
13150;Vaidilutė;"Malūnelis ";2876157676;Taip;2;2;0;4
13151;Vaidilutė;"Malūnelis ";8444010416;Taip;9;3;0;12
13152;Vaidilutė;"Malūnelis ";4568108299;Taip;0;3;0;3
13153;Vaidilutė;"Malūnelis ";1998966302;Taip;0;1;2;3
13154;Vaidilutė;"Malūnelis ";5026620305;Taip;0;3;0;3
13155;Vaidilutė;"Malūnelis ";3826303389;Taip;0;3;1;4
13156;Vaidilutė;"Malūnelis ";4469754560;Taip;7;0;0;7
13157;Vaidilutė;"Malūnelis ";8433116520;Taip;5;0;0;5
13158;Vaidilutė;"Malūnelis ";5918039529;Taip;18;0;0;18
13159;Vaidilutė;"Malūnelis ";3850868701;Taip;0;3;0;3
13160;Vaidilutė;"Malūnelis ";7660273021;Taip;2;5;0;7
13161;Vaidilutė;"Riešutėlis ";3605988018;Taip;0;3;0;3
13162;Vaidilutė;"Riešutėlis ";1161455376;Taip;5;0;6;11
13163;Vaidilutė;"Riešutėlis ";4518002596;Taip;8;0;3;11
13164;Vaidilutė;"Riešutėlis ";4657952465;Taip;0;0;2;2
13165;Vaidilutė;"Riešutėlis ";8756807918;Taip;0;0;4;4
13166;Vaidilutė;"Riešutėlis ";9782176726;Taip;3;0;1;4
13167;Vaidilutė;"Riešutėlis ";1206696843;Taip;0;3;3;6
13168;Vaidilutė;"Riešutėlis ";9872915544;Taip;6;3;0;9
13169;Vaidilutė;"Riešutėlis ";2976615414;Taip;0;0;10;10
13170;Vaidilutė;"Riešutėlis ";4709977896;Taip;8;3;0;11
13171;Vaidilutė;"Riešutėlis ";2409760986;Taip;0;3;8;11
13172;Vaidilutė;"Riešutėlis ";4051575845;Taip;8;0;0;8
13173;Vaidilutė;"Riešutėlis ";9025469107;Taip;0;0;8;8
13174;Vaidilutė;"Riešutėlis ";9567786222;Taip;0;0;2;2
13175;Vaidilutė;"Riešutėlis ";3321127541;Taip;0;0;3;3
13176;Vaidilutė;"Riešutėlis ";7713772984;Taip;0;0;18;18
13177;Vaidilutė;"Riešutėlis ";3064988592;Taip;0;0;5;5
13178;Vaidilutė;"Riešutėlis ";7043895152;Taip;0;0;1;1
13179;Vaidilutė;"Riešutėlis ";8296567629;Taip;5;0;0;5
13180;Vaidilutė;"Riešutėlis ";7871629009;Taip;0;0;12;12
13181;Vandenis;ŽUVĖDRŲ;5362078687;Taip;5;2;0;7
13182;Vandenis;ŽUVĖDRŲ;6784010746;Taip;11;1;0;12
13183;Vandenis;ŽUVĖDRŲ;2238926097;Taip;0;3;0;3
13184;Vandenis;ŽUVĖDRŲ;9334958945;Taip;9;1;0;10
13185;Vandenis;ŽUVĖDRŲ;7447487403;Taip;0;1;0;1
13186;Vandenis;ŽUVĖDRŲ;7646133208;Taip;0;3;0;3
13187;Vandenis;ŽUVĖDRŲ;4303303483;Taip;0;3;0;3
13188;Vandenis;ŽUVĖDRŲ;2325465812;Taip;0;5;0;5
13189;Vandenis;ŽUVĖDRŲ;2649542586;Taip;0;9;0;9
13190;Vandenis;ŽUVĖDRŲ;1144490168;Taip;3;3;0;6
13191;Vandenis;ŽUVĖDRŲ;7948161881;Taip;5;0;2;7
13192;Vandenis;ŽUVĖDRŲ;7391206543;Taip;0;3;0;3
13193;Vandenis;ŽUVĖDRŲ;9335319713;Taip;0;7;2;9
13194;Vandenis;ŽUVĖDRŲ;6068154206;Taip;0;6;0;6
13195;Vandenis;ŽUVĖDRŲ;7296608892;Taip;5;5;0;10
13196;Vandenis;ŽUVĖDRŲ;4117091634;Taip;0;3;0;3
13197;Vandenis;ŽUVĖDRŲ;5408971428;Taip;0;1;0;1
13198;Vandenis;ŽUVĖDRŲ;2276497021;Taip;3;4;0;7
13199;Vandenis;ŽUVĖDRŲ;6063181697;Taip;0;3;0;3
13200;Vandenis;ŽUVĖDRŲ;6661117114;Taip;10;3;0;13
13201;Vandenis;ŽUVĖDRŲ;6456557095;Taip;4;0;1;5
13202;Vandenis;ŽUVĖDRŲ;3342147138;Taip;15;0;0;15
13203;Vandenis;ŽUVĖDRŲ;5112768778;Taip;0;9;0;9
13204;Vandenis;RUONIUKŲ;2422642232;Taip;0;9;3;12
13205;Vandenis;RUONIUKŲ;1051281257;Taip;0;9;3;12
13206;Vandenis;RUONIUKŲ;7565308536;Taip;0;4;0;4
13207;Vandenis;RUONIUKŲ;1120907086;Taip;0;7;0;7
13208;Vandenis;RUONIUKŲ;1563710105;Taip;0;4;0;4
13209;Vandenis;RUONIUKŲ;7702272913;Taip;3;0;3;6
13210;Vandenis;RUONIUKŲ;6476051751;Taip;0;9;0;9
13211;Vandenis;RUONIUKŲ;9162936403;Taip;0;4;0;4
13212;Vandenis;RUONIUKŲ;4713395766;Taip;0;4;0;4
13213;Vandenis;RUONIUKŲ;6986724058;Taip;0;5;0;5
13214;Vandenis;RUONIUKŲ;7754158588;Taip;0;0;5;5
13215;Vandenis;RUONIUKŲ;9731729915;Taip;1;2;0;3
13216;Vandenis;RUONIUKŲ;9527253920;Taip;10;4;0;14
13217;Vandenis;RUONIUKŲ;8971291182;Taip;4;0;3;7
13218;Vandenis;RUONIUKŲ;6330187732;Taip;0;8;0;8
13219;Vandenis;RUONIUKŲ;9688954631;Taip;0;6;0;6
13220;Vandenis;RUONIUKŲ;8729351613;Taip;0;3;0;3
13221;Vandenis;RUONIUKŲ;4971165639;Taip;0;4;0;4
13222;Vandenis;RUONIUKŲ;6158299885;Taip;0;0;4;4
13223;Vandenis;RUONIUKŲ;3664560833;Taip;0;2;0;2
13224;Vandenis;RUONIUKŲ;5535901447;Taip;0;4;0;4
13225;Vandenis;ŽUVYČIŲ;55421695186;Taip;0;3;0;3
13226;Vandenis;ŽUVYČIŲ;43933878402;Taip;0;5;1;6
13227;Vandenis;ŽUVYČIŲ;9608871155;Taip;0;3;0;3
13228;Vandenis;ŽUVYČIŲ;7381695975;Taip;3;3;0;6
13229;Vandenis;ŽUVYČIŲ;8430706407;Taip;9;1;0;10
13230;Vandenis;ŽUVYČIŲ;8689134931;Taip;0;3;0;3
13231;Vandenis;ŽUVYČIŲ;4085256182;Taip;0;4;0;4
13232;Vandenis;ŽUVYČIŲ;6828175620;Taip;0;7;0;7
13233;Vandenis;ŽUVYČIŲ;1535450614;Taip;0;3;1;4
13234;Vandenis;ŽUVYČIŲ;7408758565;Taip;0;2;0;2
13235;Vandenis;ŽUVYČIŲ;1568158992;Taip;0;1;0;1
13236;Vandenis;ŽUVYČIŲ;1598122777;Taip;0;4;0;4
13237;Vandenis;ŽUVYČIŲ;18336904438;Taip;0;3;0;3
13238;Vandenis;ŽUVYČIŲ;1815765498;Taip;0;3;0;3
13239;Vandenis;ŽUVYČIŲ;5549292096;Taip;0;5;0;5
13240;Vandenis;ŽUVYČIŲ;8705188652;Taip;9;3;0;12
13241;Vandenis;ŽUVYČIŲ;71513217054;Taip;0;1;0;1
13242;Vandenis;ŽUVYČIŲ;24217366528;Taip;0;5;0;5
13243;Vandenis;ŽUVYČIŲ;9994373029;Taip;0;3;0;3
13244;Vandenis;ŽUVYČIŲ;3544717790;Taip;0;3;0;3
13245;Vandenis;ŽUVYČIŲ;4643267945;Taip;0;7;0;7
13246;Vandenis;ŽUVYČIŲ;27409922803;Taip;5;3;0;8
13247;Vandenis;ŽUVYČIŲ;9518434896;Taip;0;7;0;7
13248;Vandenis;ŽUVYČIŲ;2638433939;Taip;0;3;0;3
13249;Vandenis;PERLIUKŲ;8678508812;Taip;0;6;0;6
13250;Vandenis;PERLIUKŲ;2645775090;Taip;0;4;1;5
13251;Vandenis;PERLIUKŲ;5844576485;Taip;0;3;0;3
13252;Vandenis;PERLIUKŲ;6295009202;Taip;0;5;0;5
13253;Vandenis;PERLIUKŲ;7598257845;Taip;4;3;0;7
13254;Vandenis;PERLIUKŲ;7473692892;Taip;0;2;1;3
13255;Vandenis;PERLIUKŲ;5323428164;Taip;0;7;0;7
13256;Vandenis;PERLIUKŲ;6073002418;Taip;0;3;0;3
13257;Vandenis;PERLIUKŲ;5565147603;Taip;9;2;0;11
13258;Vandenis;PERLIUKŲ;2690536940;Taip;0;1;0;1
13259;Vandenis;PERLIUKŲ;2576575249;Taip;8;5;1;14
13260;Vandenis;PERLIUKŲ;7832674282;Taip;0;3;0;3
13261;Vandenis;PERLIUKŲ;9798192239;Taip;0;2;0;2
13262;Vandenis;PERLIUKŲ;1975385430;Taip;0;7;0;7
13263;Vandenis;PERLIUKŲ;3061606138;Taip;0;5;0;5
13264;Vandenis;PERLIUKŲ;8117385209;Taip;0;0;2;2
13265;Vandenis;PERLIUKŲ;5613067534;Taip;0;5;5;10
13266;Vandenis;PERLIUKŲ;2321919298;Taip;0;8;0;8
13267;Vandenis;PERLIUKŲ;5963181638;Taip;0;1;0;1
13268;Vandenis;PERLIUKŲ;5609737826;Taip;0;0;8;8
13269;Vandenis;PERLIUKŲ;3239754791;Taip;0;10;0;10
13270;Vandenis;PERLIUKŲ;5129492284;Taip;0;6;0;6
13271;Vandenis;ANČIUKŲ;4607196473;Taip;4;3;1;8
13272;Vandenis;ANČIUKŲ;6189862061;Taip;0;7;1;8
13273;Vandenis;ANČIUKŲ;4345021061;Taip;0;7;1;8
13274;Vandenis;ANČIUKŲ;9763300020;Taip;13;1;0;14
13275;Vandenis;ANČIUKŲ;9968877035;Taip;0;2;0;2
13276;Vandenis;ANČIUKŲ;3639160500;Taip;0;3;0;3
13277;Vandenis;ANČIUKŲ;9458613523;Taip;0;3;2;5
13278;Vandenis;ANČIUKŲ;1213743099;Taip;0;3;0;3
13279;Vandenis;ANČIUKŲ;4954121871;Taip;0;3;0;3
13280;Vandenis;ANČIUKŲ;8751355814;Taip;0;2;1;3
13281;Vandenis;ANČIUKŲ;4983424940;Taip;0;1;0;1
13282;Vandenis;ANČIUKŲ;4978712442;Taip;8;6;0;14
13283;Vandenis;ANČIUKŲ;7581114286;Taip;0;3;0;3
13284;Vandenis;ANČIUKŲ;9679010239;Taip;2;2;0;4
13285;Vandenis;ANČIUKŲ;9314410776;Taip;0;4;10;14
13286;Vandenis;ANČIUKŲ;1132534461;Taip;0;3;0;3
13287;Vandenis;ANČIUKŲ;9498231306;Taip;0;3;0;3
13288;Vandenis;ANČIUKŲ;2647966131;Taip;0;3;0;3
13289;Vandenis;ANČIUKŲ;3544764716;Taip;0;4;5;9
13290;Vandenis;ANČIUKŲ;4530824157;Taip;5;1;3;9
13291;Vandenis;VĖŽLIUKŲ;2309166304;Taip;10;0;0;10
13292;Vandenis;VĖŽLIUKŲ;2872343656;Taip;0;3;0;3
13293;Vandenis;VĖŽLIUKŲ;5454049563;Taip;6;3;0;9
13294;Vandenis;VĖŽLIUKŲ;9805578141;Taip;6;3;0;9
13295;Vandenis;VĖŽLIUKŲ;8921666108;Taip;0;5;0;5
13296;Vandenis;VĖŽLIUKŲ;8116532445;Taip;8;1;0;9
13297;Vandenis;VĖŽLIUKŲ;7069369080;Taip;0;3;0;3
13298;Vandenis;VĖŽLIUKŲ;7924399684;Taip;0;7;0;7
13299;Vandenis;VĖŽLIUKŲ;1187395353;Taip;0;8;0;8
13300;Vandenis;VĖŽLIUKŲ;7091356848;Taip;0;3;0;3
13301;Vandenis;VĖŽLIUKŲ;5126732658;Taip;0;3;0;3
13302;Vandenis;VĖŽLIUKŲ;7059385610;Taip;0;8;0;8
13303;Vandenis;VĖŽLIUKŲ;9158541919;Taip;0;4;0;4
13304;Vandenis;VĖŽLIUKŲ;5959181898;Taip;0;4;0;4
13305;Vandenis;VĖŽLIUKŲ;1707354287;Taip;0;10;0;10
13306;Vandenis;VĖŽLIUKŲ;4413648496;Taip;0;3;0;3
13307;Vandenis;VĖŽLIUKŲ;9704394568;Taip;10;3;0;13
13308;Vandenis;VĖŽLIUKŲ;4177166475;Taip;0;6;0;6
13309;Vandenis;VĖŽLIUKŲ;5218101579;Taip;0;3;0;3
13310;Vandenis;VĖŽLIUKŲ;8416839037;Taip;0;3;0;3
13311;Vandenis;VĖŽLIUKŲ;2936885357;Taip;3;0;0;3
13312;Vandenis;VĖŽLIUKŲ;8879608849;Taip;0;9;0;9
13313;Vandenis;AŠTUNKOJŲ;2077783219;Taip;0;5;1;6
13314;Vandenis;AŠTUNKOJŲ;8511948282;Taip;10;3;0;13
13315;Vandenis;AŠTUNKOJŲ;2096950367;Taip;0;4;0;4
13316;Vandenis;AŠTUNKOJŲ;71786730314;Taip;0;3;1;4
13317;Vandenis;AŠTUNKOJŲ;6181866272;Taip;0;6;0;6
13318;Vandenis;AŠTUNKOJŲ;5395847317;Taip;0;3;0;3
13319;Vandenis;AŠTUNKOJŲ;33317650043;Taip;0;3;0;3
13320;Vandenis;AŠTUNKOJŲ;7522472652;Taip;0;3;0;3
13321;Vandenis;AŠTUNKOJŲ;3243079651;Taip;0;3;0;3
13322;Vandenis;AŠTUNKOJŲ;3067868099;Taip;0;3;0;3
13323;Vandenis;AŠTUNKOJŲ;3578947540;Taip;0;4;0;4
13324;Vandenis;AŠTUNKOJŲ;61120985165;Taip;0;12;0;12
13325;Vandenis;AŠTUNKOJŲ;1222539247;Taip;0;3;0;3
13326;Vandenis;AŠTUNKOJŲ;8251169901;Taip;0;6;0;6
13327;Vandenis;AŠTUNKOJŲ;4750141780;Taip;5;5;0;10
13328;Vandenis;AŠTUNKOJŲ;1621481561;Taip;0;3;0;3
13329;Vandenis;AŠTUNKOJŲ;1314724267;Taip;0;5;0;5
13330;Vandenis;AŠTUNKOJŲ;1282499654;Taip;0;3;0;3
13331;Vandenis;AŠTUNKOJŲ;1739780612;Taip;0;15;0;15
13332;Vandenis;AŠTUNKOJŲ;8233407105;Taip;0;3;0;3
13333;Vandenis;AŠTUNKOJŲ;7168910452;Taip;0;5;0;5
13334;Vandenis;AŠTUNKOJŲ;2489776665;Taip;0;3;2;5
13335;Vandenis;AŠTUNKOJŲ;3938359901;Taip;0;4;0;4
13336;Vandenis;AŠTUNKOJŲ;33782837791;Taip;5;3;0;8
13337;Vandenis;AŠTUNKOJŲ;1633589144;Taip;0;3;0;3
13338;Vandenis;GANDRIUKŲ;4753416316;Taip;9;5;0;14
13339;Vandenis;GANDRIUKŲ;8264797886;Taip;0;3;3;6
13340;Vandenis;GANDRIUKŲ;9936940067;Ne;5;0;0;5
13341;Vandenis;GANDRIUKŲ;6153669587;Taip;0;0;3;3
13342;Vandenis;GANDRIUKŲ;6260893699;Taip;7;6;0;13
13343;Vandenis;GANDRIUKŲ;1919577714;Taip;5;2;3;10
13344;Vandenis;GANDRIUKŲ;7019646962;Taip;0;4;0;4
13345;Vandenis;GANDRIUKŲ;2078767085;Taip;0;5;1;6
13346;Vandenis;GANDRIUKŲ;2976505868;Taip;15;3;0;18
13347;Vandenis;GANDRIUKŲ;6558155968;Taip;0;8;0;8
13348;Vandenis;GANDRIUKŲ;6691874473;Taip;0;3;4;7
13349;Vandenis;GANDRIUKŲ;6483030616;Taip;4;3;0;7
13350;Vandenis;GANDRIUKŲ;8144830789;Taip;13;0;1;14
13351;Vandenis;GANDRIUKŲ;2381566229;Taip;7;0;0;7
13352;Vandenis;GANDRIUKŲ;5899846599;Taip;14;0;0;14
13353;Vandenis;GANDRIUKŲ;8127873607;Taip;6;1;4;11
13354;Vandenis;GANDRIUKŲ;1606103904;Taip;9;3;0;12
13355;Vandenis;GANDRIUKŲ;1753180703;Taip;10;3;1;14
13356;Vandenis;GANDRIUKŲ;7303512055;Taip;7;3;2;12
13357;Vandenis;GANDRIUKŲ;3231434944;Taip;0;0;18;18
13358;Vandenis;GANDRIUKŲ;6327478049;Taip;11;0;1;12
13359;Vandenis;GANDRIUKŲ;7311677107;Taip;4;0;0;4
13360;Vandenis;GANDRIUKŲ;6586215199;Taip;0;5;0;5
13361;Vandenis;ŽĄSIUKAI;8034690071;Taip;6;3;0;9
13362;Vandenis;ŽĄSIUKAI;9937317687;Taip;3;0;0;3
13363;Vandenis;ŽĄSIUKAI;2004158593;Taip;0;10;0;10
13364;Vandenis;ŽĄSIUKAI;4984723792;Taip;5;0;0;5
13365;Vandenis;ŽĄSIUKAI;8014569725;Taip;2;1;0;3
13366;Vandenis;ŽĄSIUKAI;1333381525;Taip;0;3;0;3
13367;Vandenis;ŽĄSIUKAI;7071349847;Taip;0;7;0;7
13368;Vandenis;ŽĄSIUKAI;7070234429;Taip;0;4;0;4
13369;Vandenis;ŽĄSIUKAI;4072405890;Taip;0;7;0;7
13370;Vandenis;ŽĄSIUKAI;5684262347;Taip;8;0;0;8
13371;Vandenis;ŽĄSIUKAI;4349464804;Taip;0;5;0;5
13372;Vandenis;ŽĄSIUKAI;7596199296;Taip;0;4;0;4
13373;Vandenis;ŽĄSIUKAI;6876019354;Taip;0;3;0;3
13374;Vandenis;ŽĄSIUKAI;5607412408;Taip;10;1;0;11
13375;Vandenis;ŽĄSIUKAI;1925178245;Taip;0;4;0;4
13376;Vandenis;ŽĄSIUKAI;5641929490;Taip;3;8;0;11
13377;Vandenis;ŽĄSIUKAI;1850352131;Taip;11;0;0;11
13378;Vandenis;ŽĄSIUKAI;2454959791;Taip;5;0;4;9
13379;Vandenis;ŽĄSIUKAI;4565893472;Taip;11;0;0;11
13380;Vandenis;ŽĄSIUKAI;1200834211;Taip;6;0;0;6
13381;Vandenis;ŽĄSIUKAI;9801593009;Taip;1;7;1;9
13382;Vandenis;PURIENŲ;6851178154;Taip;0;10;0;10
13383;Vandenis;PURIENŲ;5440027798;Taip;8;2;1;11
13384;Vandenis;PURIENŲ;4455886780;Taip;7;0;0;7
13385;Vandenis;PURIENŲ;1031451445;Taip;0;1;0;1
13386;Vandenis;PURIENŲ;4815210197;Taip;0;3;0;3
13387;Vandenis;PURIENŲ;3337286021;Taip;10;3;0;13
13388;Vandenis;PURIENŲ;7020534318;Taip;3;2;1;6
13389;Vandenis;PURIENŲ;6027680514;Taip;5;3;0;8
13390;Vandenis;PURIENŲ;2960005490;Taip;0;4;2;6
13391;Vandenis;PURIENŲ;1180322026;Taip;0;4;2;6
13392;Vandenis;PURIENŲ;3633805607;Taip;0;3;0;3
13393;Vandenis;PURIENŲ;7959438279;Taip;5;3;0;8
13394;Vandenis;PURIENŲ;1788652447;Taip;0;3;0;3
13395;Vandenis;PURIENŲ;6332179750;Taip;1;2;0;3
13396;Vandenis;PURIENŲ;2315167746;Taip;0;1;0;1
13397;Vandenis;PURIENŲ;5540306590;Taip;0;3;0;3
13398;Vandenis;PURIENŲ;2719678617;Taip;0;3;0;3
13399;Vandenis;PURIENŲ;7171302906;Taip;5;4;0;9
13400;Vandenis;PURIENŲ;8085633453;Taip;5;4;0;9
13401;Vandenis;PURIENŲ;2614561762;Taip;0;4;0;4
13402;Vandenis;PURIENŲ;5764809162;Taip;0;3;0;3
13403;Vandenis;PURIENŲ;1244502945;Taip;5;4;0;9
13404;Vandenis;VARLIUKAI;6907717590;Taip;4;0;0;4
13405;Vandenis;VARLIUKAI;2661339448;Taip;7;0;0;7
13406;Vandenis;VARLIUKAI;2451901210;Taip;10;4;0;14
13407;Vandenis;VARLIUKAI;1786146371;Taip;0;6;0;6
13408;Vandenis;VARLIUKAI;3393306645;Taip;9;0;0;9
13409;Vandenis;VARLIUKAI;2506411643;Taip;12;0;0;12
13410;Vandenis;VARLIUKAI;8841954633;Taip;8;5;0;13
13411;Vandenis;VARLIUKAI;7001613448;Taip;8;5;0;13
13412;Vandenis;VARLIUKAI;1983972864;Taip;0;5;0;5
13413;Vandenis;VARLIUKAI;6067408982;Taip;8;2;0;10
13414;Vandenis;VARLIUKAI;8239664149;Taip;11;3;0;14
13415;Vandenis;VARLIUKAI;9380306986;Taip;9;2;0;11
13416;Vandenis;VARLIUKAI;1953052452;Taip;0;3;0;3
13417;Vandenis;VARLIUKAI;1799139825;Taip;0;7;0;7
13418;Vandenis;VARLIUKAI;3038533882;Taip;10;3;0;13
13419;Vandenis;VARLIUKAI;3173213991;Taip;15;3;0;18
13420;Vandenis;VARLIUKAI;5675840354;Taip;6;2;0;8
13421;Vandenis;VARLIUKAI;6570331247;Taip;0;2;4;6
13422;Vandenis;VARLIUKAI;2883058280;Taip;0;3;0;3
13423;Vandenis;PINGVINAI;9856199548;Taip;1;2;2;5
13424;Vandenis;PINGVINAI;2209513000;Taip;0;8;1;9
13425;Vandenis;PINGVINAI;2665865704;Taip;14;3;0;17
13426;Vandenis;PINGVINAI;8755050997;Taip;0;5;8;13
13427;Vandenis;PINGVINAI;1780124964;Taip;0;5;0;5
13428;Vandenis;PINGVINAI;9609168578;Taip;0;8;0;8
13429;Vandenis;PINGVINAI;2156775779;Taip;5;3;0;8
13430;Vandenis;PINGVINAI;3360623444;Taip;0;5;0;5
13431;Vandenis;PINGVINAI;5191604973;Taip;15;0;0;15
13432;Vandenis;PINGVINAI;2757376962;Taip;0;2;0;2
13433;Vandenis;PINGVINAI;6992750701;Taip;0;9;5;14
13434;Vandenis;PINGVINAI;6731336385;Taip;6;2;0;8
13435;Vandenis;PINGVINAI;3933306911;Taip;5;15;0;20
13436;Vandenis;PINGVINAI;2534991705;Taip;0;3;0;3
13437;Vandenis;PINGVINAI;4347489809;Taip;0;0;9;9
13438;Vandenis;PINGVINAI;7267965471;Taip;0;0;4;4
13439;Vandenis;PINGVINAI;5632082019;Taip;8;3;0;11
13440;Vandenis;PINGVINAI;9717294497;Taip;0;7;0;7
13441;Vandenis;PINGVINAI;7770227772;Taip;7;11;0;18
13442;Vandenis;PINGVINAI;8560123112;Taip;12;0;0;12
13443;Varpelis;NYKŠTUKAI;5322766823;Taip;1;0;0;1
13444;Varpelis;AITVARIUKŲ;9719340432;Taip;7;0;0;7
13445;Varpelis;BITUTĖS;1005905322;Taip;0;0;5;5
13446;Varpelis;BITUTĖS;8224083250;Taip;0;7;0;7
13447;Varpelis;BITUTĖS;7639156840;Taip;0;3;1;4
13448;Varpelis;BITUTĖS;7894929066;Taip;0;3;1;4
13449;Varpelis;BITUTĖS;6004580752;Taip;0;0;4;4
13450;Varpelis;BITUTĖS;3225870950;Taip;5;3;0;8
13451;Varpelis;BITUTĖS;2975306188;Taip;0;0;2;2
13452;Varpelis;BITUTĖS;3216171217;Taip;0;3;1;4
13453;Varpelis;BITUTĖS;9795677397;Taip;1;3;5;9
13454;Varpelis;BITUTĖS;9025614369;Taip;6;0;4;10
13455;Varpelis;BITUTĖS;7137400798;Taip;5;0;0;5
13456;Varpelis;BITUTĖS;6272649584;Taip;5;0;2;7
13457;Varpelis;BITUTĖS;7497169351;Taip;5;3;0;8
13458;Varpelis;BITUTĖS;6325113387;Taip;0;16;2;18
13459;Varpelis;BITUTĖS;8910195286;Taip;0;0;1;1
13460;Varpelis;BITUTĖS;3557362927;Taip;0;0;7;7
13461;Varpelis;BITUTĖS;5994436441;Taip;0;0;3;3
13462;Varpelis;BITUTĖS;9295853884;Taip;0;3;0;3
13463;Varpelis;BITUTĖS;7462297990;Taip;5;0;1;6
13464;Varpelis;BITUTĖS;4811186406;Taip;0;0;9;9
13465;Varpelis;BITUTĖS;9598844152;Taip;10;0;4;14
13466;Varpelis;BITUTĖS;3315895028;Taip;0;3;0;3
13467;Varpelis;BITUTĖS;9539132116;Taip;8;0;0;8
13468;Vėjelis;Pumpurėliai;2541077369;Taip;8;0;0;8
13469;Vėjelis;Pumpurėliai;3125815427;Taip;4;0;0;4
13470;Vėjelis;Pumpurėliai;5516672613;Taip;0;3;0;3
13471;Vėjelis;Pumpurėliai;2866394056;Taip;0;3;0;3
13472;Vėjelis;Pumpurėliai;1084415930;Taip;0;0;1;1
13473;Vėjelis;Pumpurėliai;9071878406;Taip;0;1;1;2
13474;Vėjelis;Pumpurėliai;3206025676;Taip;3;0;2;5
13475;Vėjelis;Pumpurėliai;5611813359;Taip;3;1;0;4
13476;Vėjelis;Pumpurėliai;1057586168;Taip;18;0;0;18
13477;Vėjelis;Pumpurėliai;9583495324;Taip;0;3;0;3
13478;Vėjelis;Pumpurėliai;7539681314;Taip;6;0;0;6
13479;Vėjelis;Pumpurėliai;3081923183;Taip;5;0;2;7
13480;Vėjelis;Pumpurėliai;9003601108;Taip;0;0;2;2
13481;Vėjelis;Pumpurėliai;6168648640;Taip;8;0;0;8
13482;Vėjelis;Pumpurėliai;1876663813;Taip;0;9;0;9
13483;Vėjelis;Pumpurėliai;6840643273;Ne;13;0;0;13
13484;Vėjelis;Pumpurėliai;9824130744;Taip;0;4;0;4
13485;Vėjelis;Pumpurėliai;1842552329;Taip;0;1;3;4
13486;Vėjelis;Pumpurėliai;9986867356;Ne;0;4;0;4
13487;Vėjelis;Pumpurėliai;8467887788;Taip;2;9;0;11
13488;Vėjelis;Pumpurėliai;9274287800;Taip;0;4;0;4
13489;Vėjelis;Pumpurėliai;5619026707;Taip;5;0;0;5
13490;Vėjelis;Pumpurėliai;8994680698;Taip;7;5;0;12
13491;Vėjelis;Pumpurėliai;2656895893;Taip;7;0;0;7
13492;Vėjelis;Drugeliai;4746932126;Taip;18;0;0;18
13493;Vėjelis;Drugeliai;1978952781;Taip;0;3;0;3
13494;Vėjelis;Drugeliai;8353084814;Taip;0;3;1;4
13495;Vėjelis;Drugeliai;2416832899;Taip;0;3;1;4
13496;Vėjelis;Drugeliai;2734024890;Taip;5;7;0;12
13497;Vėjelis;Drugeliai;7981032872;Taip;0;18;0;18
13498;Vėjelis;Drugeliai;7594586198;Taip;0;3;3;6
13499;Vėjelis;Drugeliai;7697394469;Taip;5;3;3;11
13500;Vėjelis;Drugeliai;4066956765;Taip;0;5;0;5
13501;Vėjelis;Drugeliai;2788205363;Taip;10;3;1;14
13502;Vėjelis;Drugeliai;1331334220;Taip;0;5;0;5
13503;Vėjelis;Drugeliai;2151737048;Taip;10;5;0;15
13504;Vėjelis;Drugeliai;1862173525;Taip;0;3;2;5
13505;Vėjelis;Drugeliai;3982318250;Taip;4;4;0;8
13506;Vėjelis;Drugeliai;4473677352;Taip;0;3;0;3
13507;Vėjelis;Drugeliai;4506243333;Taip;0;3;1;4
13508;Vėjelis;Drugeliai;3524350131;Taip;0;3;4;7
13509;Vėjelis;Drugeliai;6061966626;Taip;9;0;0;9
13510;Vėjelis;Drugeliai;6891260701;Taip;0;5;0;5
13511;Vėjelis;Malūnėlis;1994035417;Ne;9;1;0;10
13512;Vėjelis;Malūnėlis;7097474285;Taip;0;3;0;3
13513;Vėjelis;Malūnėlis;1448699738;Taip;7;1;3;11
13514;Vėjelis;Malūnėlis;3275186042;Taip;6;1;0;7
13515;Vėjelis;Malūnėlis;1882750621;Taip;10;3;0;13
13516;Vėjelis;Malūnėlis;5109441799;Taip;0;3;0;3
13517;Vėjelis;Malūnėlis;4171024976;Taip;15;0;0;15
13518;Vėjelis;Malūnėlis;1871467392;Taip;11;0;3;14
13519;Vėjelis;Malūnėlis;1342200813;Taip;0;0;1;1
13520;Vėjelis;Malūnėlis;8221349174;Taip;0;5;0;5
13521;Vėjelis;Malūnėlis;6600504736;Taip;8;3;0;11
13522;Vėjelis;Malūnėlis;8063276082;Taip;5;2;0;7
13523;Vėjelis;Malūnėlis;6244227830;Taip;13;0;1;14
13524;Vėjelis;Malūnėlis;1417987860;Taip;7;5;0;12
13525;Vėjelis;Malūnėlis;9636946669;Taip;0;18;0;18
13526;Vėjelis;Malūnėlis;5066748621;Taip;7;0;0;7
13527;Vėjelis;Malūnėlis;8822873586;Taip;6;0;2;8
13528;Vėjelis;Žvaigždutės;9492690970;Taip;0;3;0;3
13529;Vėjelis;Žvaigždutės;1436893015;Taip;3;1;0;4
13530;Vėjelis;Žvaigždutės;2117924725;Taip;5;0;0;5
13531;Vėjelis;Žvaigždutės;8866974952;Taip;0;4;0;4
13532;Vėjelis;Žvaigždutės;1549518622;Taip;0;14;0;14
13533;Vėjelis;Žvaigždutės;6386092350;Taip;8;8;0;16
13534;Vėjelis;Žvaigždutės;6844704326;Taip;0;1;3;4
13535;Vėjelis;Žvaigždutės;4353239658;Taip;0;1;4;5
13536;Vėjelis;Žvaigždutės;3315240387;Taip;0;13;0;13
13537;Vėjelis;Žvaigždutės;9557135813;Taip;2;0;1;3
13538;Vėjelis;Žvaigždutės;2132551615;Taip;7;0;5;12
13539;Vėjelis;Žvaigždutės;2522750651;Taip;3;1;0;4
13540;Vėjelis;Žvaigždutės;6777528441;Taip;0;1;2;3
13541;Vėjelis;Žvaigždutės;4868574574;Taip;0;1;2;3
13542;Vėjelis;Žvaigždutės;9135807341;Taip;13;3;0;16
13543;Vėjelis;Žvaigždutės;4101161670;Taip;0;3;0;3
13544;Vėjelis;Žvaigždutės;7247057946;Taip;0;3;8;11
13545;Vėjelis;Žvaigždutės;7046938604;Taip;0;8;0;8
13546;Vėjelis;Žvaigždutės;3495322620;Taip;0;7;0;7
13547;Vėjelis;Žvaigždutės;1956418258;Taip;0;3;0;3
13548;Vėjelis;Žvaigždutės;7203026860;Taip;10;3;0;13
13549;Vėjelis;Žvaigždutės;8300497094;Taip;11;1;2;14
13550;Vėjelis;Varpeliai;7274745807;Taip;0;2;7;9
13551;Vėjelis;Varpeliai;5931553549;Taip;0;2;1;3
13552;Vėjelis;Varpeliai;9926991259;Taip;0;2;5;7
13553;Vėjelis;Varpeliai;6608657740;Taip;9;2;1;12
13554;Vėjelis;Varpeliai;2794205377;Taip;2;2;2;6
13555;Vėjelis;Varpeliai;7507448059;Taip;5;6;0;11
13556;Vėjelis;Varpeliai;2363974247;Taip;0;2;3;5
13557;Vėjelis;Varpeliai;8379298947;Taip;0;2;3;5
13558;Vėjelis;Varpeliai;1205392813;Taip;3;8;0;11
13559;Vėjelis;Varpeliai;98588113289;Taip;0;4;0;4
13560;Vėjelis;Varpeliai;5396347620;Taip;0;4;0;4
13561;Vėjelis;Varpeliai;5031781196;Taip;14;0;0;14
13562;Vėjelis;Varpeliai;4219672982;Taip;9;0;0;9
13563;Vėjelis;Varpeliai;50124109589;Taip;0;3;0;3
13564;Vėjelis;Varpeliai;4853650350;Taip;0;5;0;5
13565;Vėjelis;Varpeliai;4521161684;Taip;0;8;0;8
13566;Vėjelis;Varpeliai;60890519853;Taip;3;2;2;7
13567;Vėjelis;Varpeliai;8684461171;Taip;0;5;0;5
13568;Vėjelis;Varpeliai;7133454882;Taip;0;4;0;4
13569;Vėjelis;Varpeliai;1863210064;Taip;8;2;1;11
13570;Vėjelis;Varpeliai;6221257045;Taip;5;2;2;9
13571;Vėjelis;Varpeliai;1534169381;Taip;0;4;0;4
13572;Vėjelis;Varpeliai;2957105835;Ne;0;0;5;5
13573;Vėjelis;Pelėdžiukų;3067215309;Taip;0;1;0;1
13574;Vėjelis;Pelėdžiukų;7211756910;Taip;0;5;0;5
13575;Vėjelis;Pelėdžiukų;2302652824;Taip;0;1;3;4
13576;Vėjelis;Pelėdžiukų;4852532740;Taip;0;18;0;18
13577;Vėjelis;Pelėdžiukų;4450739919;Taip;0;0;2;2
13578;Vėjelis;Pelėdžiukų;9202471939;Taip;4;2;0;6
13579;Vėjelis;Pelėdžiukų;1615837863;Taip;4;2;0;6
13580;Vėjelis;Pelėdžiukų;9852892338;Taip;11;0;0;11
13581;Vėjelis;Pelėdžiukų;8433853523;Taip;0;3;0;3
13582;Vėjelis;Pelėdžiukų;4746355716;Taip;0;3;0;3
13583;Vėjelis;Pelėdžiukų;5507017221;Taip;6;5;0;11
13584;Vėjelis;Pelėdžiukų;1259743374;Taip;15;0;0;15
13585;Vėjelis;Pelėdžiukų;6226234271;Taip;0;18;0;18
13586;Vėjelis;Pelėdžiukų;7559733997;Taip;0;7;0;7
13587;Vėjelis;Pelėdžiukų;3764096742;Taip;3;0;0;3
13588;Vėjelis;Pelėdžiukų;8153021028;Taip;10;0;0;10
13589;Vėjelis;Pelėdžiukų;8067153728;Taip;0;7;0;7
13590;Vėjelis;Pelėdžiukų;2283628712;Taip;11;0;0;11
13591;Vėjelis;Pelėdžiukų;2729246397;Taip;18;0;0;18
13592;Vėjelis;Pelėdžiukų;9769871497;Taip;6;0;0;6
13593;Vėjelis;Pelėdžiukų;4318295503;Taip;0;3;0;3
13594;Vėjelis;Pelėdžiukų;9867392835;Taip;0;0;7;7
13595;Vėjelis;Skruzdeliukų;2167025998;Taip;0;2;0;2
13596;Vėjelis;Skruzdeliukų;2467377103;Taip;0;4;0;4
13597;Vėjelis;Skruzdeliukų;8470977526;Taip;0;6;0;6
13598;Vėjelis;Skruzdeliukų;9434737088;Taip;0;3;0;3
13599;Vėjelis;Skruzdeliukų;1952141664;Taip;6;3;0;9
13600;Vėjelis;Skruzdeliukų;3264153232;Taip;0;3;0;3
13601;Vėjelis;Skruzdeliukų;4992783345;Taip;0;9;0;9
13602;Vėjelis;Skruzdeliukų;4997987762;Taip;0;3;0;3
13603;Vėjelis;Skruzdeliukų;4412135676;Taip;0;3;0;3
13604;Vėjelis;Skruzdeliukų;8356715925;Ne;0;2;0;2
13605;Vėjelis;Skruzdeliukų;4946988585;Taip;0;1;0;1
13606;Vėjelis;Skruzdeliukų;6408918277;Taip;6;3;1;10
13607;Vėjelis;Skruzdeliukų;7240155487;Taip;0;3;3;6
13608;Vėjelis;Skruzdeliukų;7695719991;Ne;0;4;3;7
13609;Vėjelis;Skruzdeliukų;6618114389;Taip;0;5;1;6
13610;Vėjelis;Skruzdeliukų;1381923971;Taip;0;7;0;7
13611;Vėjelis;Skruzdeliukų;8630131152;Taip;0;3;2;5
13612;Vėjelis;Skruzdeliukų;6431589805;Ne;0;5;0;5
13613;Vėjelis;Skruzdeliukų;9177137585;Taip;0;3;0;3
13614;Vėjelis;Skruzdeliukų;4906958328;Taip;0;3;0;3
13615;Vėjelis;Skruzdeliukų;4080198912;Taip;0;3;5;8
13616;Vėjelis;Skruzdeliukų;1555270425;Taip;0;1;0;1
13617;Vėjelis;Skruzdeliukų;7400967836;Taip;8;4;0;12
13618;Vėjelis;Skruzdeliukų;1467023330;Taip;0;3;0;3
13619;Vėjelis;Pieštukų;8995478684;Taip;3;0;1;4
13620;Vėjelis;Pieštukų;7860576967;Taip;0;0;1;1
13621;Vėjelis;Pieštukų;4884057836;Taip;0;0;2;2
13622;Vėjelis;Pieštukų;3898751303;Taip;9;9;0;18
13623;Vėjelis;Pieštukų;5662728912;Taip;10;2;1;13
13624;Vėjelis;Pieštukų;8281508498;Taip;0;1;5;6
13625;Vėjelis;Pieštukų;7748975870;Taip;2;0;0;2
13626;Vėjelis;Pieštukų;1075188861;Taip;6;0;1;7
13627;Vėjelis;Pieštukų;6823103188;Taip;18;0;0;18
13628;Vėjelis;Pieštukų;7854614677;Taip;0;2;3;5
13629;Vėjelis;Pieštukų;9451358807;Taip;18;0;0;18
13630;Vėjelis;Pieštukų;6453605110;Taip;0;11;0;11
13631;Vėjelis;Pieštukų;2734891342;Taip;1;5;0;6
13632;Vėjelis;Pieštukų;7101585528;Taip;0;1;6;7
13633;Vėjelis;Ramunėlių;5987294293;Taip;0;5;0;5
13634;Vėjelis;Ramunėlių;8047799576;Taip;8;2;0;10
13635;Vėjelis;Ramunėlių;7178844364;Taip;5;5;0;10
13636;Vėjelis;Ramunėlių;6996900411;Taip;4;1;0;5
13637;Vėjelis;Ramunėlių;4733227215;Taip;9;0;0;9
13638;Vėjelis;Ramunėlių;5909697341;Taip;0;4;0;4
13639;Vėjelis;Ramunėlių;6451722893;Taip;0;9;0;9
13640;Vėjelis;Ramunėlių;3584347608;Taip;3;3;0;6
13641;Vėjelis;Ramunėlių;1381191703;Taip;0;4;2;6
13642;Vėjelis;Ramunėlių;9042329808;Taip;2;2;0;4
13643;Vėjelis;Ramunėlių;6660799519;Taip;0;1;0;1
13644;Vėjelis;Ramunėlių;6889825160;Taip;4;0;0;4
13645;Vėjelis;Ramunėlių;4433799070;Taip;0;2;0;2
13646;Vėjelis;Ramunėlių;1235788079;Taip;7;3;0;10
13647;Vėjelis;Ramunėlių;4745262277;Taip;0;5;0;5
13648;Vėjelis;Ramunėlių;7790713917;Taip;13;1;0;14
13649;Vėjelis;Ramunėlių;8054114720;Taip;13;1;0;14
13650;Vėjelis;Ramunėlių;8986581196;Taip;0;4;0;4
13651;Vėjelis;Nykštukai;6741600874;Taip;15;0;0;15
13652;Vėjelis;Nykštukai;9957614551;Taip;0;5;0;5
13653;Vėjelis;Nykštukai;7233448544;Taip;0;5;0;5
13654;Vėjelis;Nykštukai;5339200991;Taip;0;2;0;2
13655;Vėjelis;Nykštukai;6602964509;Taip;0;4;0;4
13656;Vėjelis;Nykštukai;2573683778;Taip;2;4;0;6
13657;Vėjelis;Nykštukai;3843601190;Taip;10;0;2;12
13658;Vėjelis;Nykštukai;3574432129;Taip;2;2;0;4
13659;Vėjelis;Nykštukai;4713754452;Taip;5;5;0;10
13660;Vėjelis;Nykštukai;7889625599;Taip;12;3;0;15
13661;Vėjelis;Nykštukai;7763996061;Taip;5;3;0;8
13662;Vėjelis;Nykštukai;3813509637;Taip;0;4;0;4
13663;Vėjelis;Nykštukai;8755889077;Taip;4;0;0;4
13664;Vėjelis;Nykštukai;2763569936;Taip;5;3;0;8
13665;Vėjelis;Nykštukai;9979979480;Taip;14;0;0;14
13666;Vėjelis;Nykštukai;4063795811;Taip;0;3;1;4
13667;Vėjelis;BITUTĖS;6824919005;Taip;0;3;0;3
13668;Vėjelis;BITUTĖS;4276237884;Taip;7;3;0;10
13669;Vėjelis;BITUTĖS;3772706363;Taip;9;1;0;10
13670;Vėjelis;BITUTĖS;1834203833;Taip;8;2;1;11
13671;Vėjelis;BITUTĖS;8452132066;Taip;0;18;0;18
13672;Vėjelis;BITUTĖS;6283428333;Taip;11;0;1;12
13673;Vėjelis;BITUTĖS;1112394040;Taip;9;1;0;10
13674;Vėjelis;BITUTĖS;3767625080;Taip;0;2;2;4
13675;Vėjelis;BITUTĖS;6569848405;Taip;0;5;0;5
13676;Vėjelis;BITUTĖS;1457373815;Taip;14;0;0;14
13677;Vėjelis;BITUTĖS;8571757635;Taip;11;4;0;15
13678;Vėjelis;BITUTĖS;1022888418;Taip;4;5;0;9
13679;Vėjelis;BITUTĖS;9625857378;Taip;13;1;0;14
13680;Vėjelis;BITUTĖS;1116238331;Taip;0;12;0;12
13681;Vėjelis;BITUTĖS;8286070405;Taip;0;9;0;9
13682;Vėjelis;BITUTĖS;1674810054;Taip;9;0;0;9
13683;Vėjelis;BITUTĖS;6581265682;Taip;0;4;0;4
13684;Vėjelis;BITUTĖS;1070853175;Taip;7;0;1;8
13685;Vėjelis;BITUTĖS;4348246825;Taip;0;1;4;5
13686;Vėjelis;Boruželės;2199680661;Taip;0;4;0;4
13687;Vėjelis;Boruželės;5325081841;Taip;1;4;0;5
13688;Vėjelis;Boruželės;5381588565;Taip;5;3;0;8
13689;Vėjelis;Boruželės;9037622738;Taip;0;3;0;3
13690;Vėjelis;Boruželės;1588345134;Taip;0;3;7;10
13691;Vėjelis;Boruželės;1429496839;Taip;0;4;3;7
13692;Vėjelis;Boruželės;1931659200;Taip;0;7;0;7
13693;Vėjelis;Boruželės;8666759391;Taip;0;3;0;3
13694;Vėjelis;Boruželės;3844131154;Taip;1;3;0;4
13695;Vėjelis;Boruželės;4747466651;Taip;5;3;0;8
13696;Vėjelis;Boruželės;3473416323;Taip;5;3;0;8
13697;Vėjelis;Boruželės;8141198449;Taip;5;4;0;9
13698;Vėjelis;Boruželės;8121537795;Taip;1;7;0;8
13699;Vėjelis;Boruželės;5517128872;Taip;0;4;0;4
13700;Vėjelis;Boruželės;8938491367;Taip;10;2;0;12
13701;Vėjelis;Boruželės;6108049183;Taip;4;7;0;11
13702;Vėjelis;Boruželės;1115802837;Taip;1;3;0;4
13703;Vėjelis;Boruželės;1494531065;Taip;0;3;2;5
13704;Vėjelis;Boruželės;3276062426;Taip;0;2;6;8
13705;Vėjelis;Boruželės;9298789434;Taip;0;3;0;3
13706;Vėjelis;Boruželės;4132824111;Taip;0;4;0;4
13707;Vėjelis;Boruželės;2000277444;Taip;0;3;0;3
13708;Vėjelis;Boruželės;7752923796;Taip;0;3;2;5
13709;Vėtrungė;Debesėlių;3655025938;Taip;13;0;0;13
13710;Vėtrungė;Debesėlių;7863176604;Taip;0;5;0;5
13711;Vėtrungė;Debesėlių;3179715496;Taip;0;5;0;5
13712;Vėtrungė;Debesėlių;6439014588;Taip;4;4;0;8
13713;Vėtrungė;Debesėlių;9423361592;Taip;6;3;0;9
13714;Vėtrungė;Debesėlių;1191007983;Taip;0;6;0;6
13715;Vėtrungė;Debesėlių;3745680607;Taip;0;5;2;7
13716;Vėtrungė;Debesėlių;9359012317;Taip;0;3;0;3
13717;Vėtrungė;Debesėlių;1807742144;Taip;8;3;5;16
13718;Vėtrungė;Debesėlių;9893842192;Taip;8;9;0;17
13719;Vėtrungė;Debesėlių;3433811829;Taip;0;13;4;17
13720;Vėtrungė;Debesėlių;2447851565;Taip;0;6;0;6
13721;Vėtrungė;Debesėlių;2136966687;Taip;0;10;0;10
13722;Vėtrungė;Debesėlių;5246813735;Taip;0;1;0;1
13723;Vėtrungė;Debesėlių;5836190044;Taip;0;0;7;7
13724;Vėtrungė;Debesėlių;8957071345;Taip;5;1;2;8
13725;Vėtrungė;Debesėlių;5545581078;Taip;0;8;0;8
13726;Vėtrungė;Debesėlių;7185104341;Taip;3;4;5;12
13727;Vėtrungė;Debesėlių;6374739740;Taip;0;5;1;6
13728;Vėtrungė;Debesėlių;5939537473;Taip;3;3;0;6
13729;Vėtrungė;Debesėlių;1871358961;Taip;0;0;3;3
13730;Vėtrungė;Zuikių;9332362038;Taip;0;0;1;1
13731;Vėtrungė;Zuikių;9407558097;Taip;0;7;0;7
13732;Vėtrungė;Zuikių;2985829593;Taip;0;3;1;4
13733;Vėtrungė;Zuikių;4121886031;Taip;5;11;0;16
13734;Vėtrungė;Zuikių;7573021445;Taip;0;9;0;9
13735;Vėtrungė;Zuikių;3335047815;Ne;0;3;0;3
13736;Vėtrungė;Zuikių;8157356569;Ne;0;3;0;3
13737;Vėtrungė;Zuikių;9742099165;Taip;1;0;0;1
13738;Vėtrungė;Zuikių;1215953192;Taip;0;3;1;4
13739;Vėtrungė;Zuikių;3908259010;Ne;0;3;0;3
13740;Vėtrungė;Zuikių;1729819557;Taip;12;2;0;14
13741;Vėtrungė;Zuikių;4916692634;Taip;0;6;0;6
13742;Vėtrungė;Zuikių;6416245099;Ne;0;5;0;5
13743;Vėtrungė;Zuikių;4197321604;Taip;0;4;0;4
13744;Vėtrungė;Zuikių;1007578933;Taip;0;4;0;4
13745;Vėtrungė;Zuikių;7558548846;Taip;0;4;0;4
13746;Vėtrungė;Zuikių;8742161467;Taip;5;4;0;9
13747;Vėtrungė;Zuikių;2537221101;Taip;23;0;0;23
13748;Vėtrungė;Zuikių;7342250921;Taip;1;2;4;7
13749;Vėtrungė;Zuikių;9248113268;Taip;0;0;1;1
13750;Vėtrungė;Zuikių;7435005821;Ne;2;3;0;5
13751;Vėtrungė;Zuikių;1280823326;Ne;9;1;1;11
13752;Vėtrungė;Drugelių;5366256528;Ne;0;0;4;4
13753;Vėtrungė;Drugelių;5622109033;Taip;0;3;2;5
13754;Vėtrungė;Drugelių;7943682529;Taip;0;8;1;9
13755;Vėtrungė;Drugelių;7476984763;Taip;13;0;0;13
13756;Vėtrungė;Drugelių;9090873546;Taip;3;0;1;4
13757;Vėtrungė;Drugelių;2124476787;Taip;6;1;0;7
13758;Vėtrungė;Drugelių;2970067995;Taip;10;3;0;13
13759;Vėtrungė;Drugelių;4578835070;Taip;20;0;0;20
13760;Vėtrungė;Drugelių;8729505032;Taip;0;0;1;1
13761;Vėtrungė;Drugelių;5251308945;Taip;0;3;0;3
13762;Vėtrungė;Drugelių;9812496068;Taip;0;3;0;3
13763;Vėtrungė;Drugelių;8753387108;Taip;0;0;10;10
13764;Vėtrungė;Drugelių;3634995652;Taip;0;7;0;7
13765;Vėtrungė;Drugelių;2123410772;Taip;0;1;0;1
13766;Vėtrungė;Drugelių;3744377479;Taip;0;0;2;2
13767;Vėtrungė;Drugelių;8905533826;Taip;8;0;0;8
13768;Vėtrungė;Drugelių;7186353024;Taip;0;3;0;3
13769;Vėtrungė;Drugelių;2933312366;Taip;0;12;0;12
13770;Vėtrungė;Drugelių;2508501223;Taip;0;5;0;5
13771;Vėtrungė;Drugelių;3638303693;Ne;0;0;7;7
13772;Vėtrungė;Do-re-mi;6449124019;Taip;0;0;2;2
13773;Vėtrungė;Do-re-mi;9324733839;Taip;0;3;0;3
13774;Vėtrungė;Do-re-mi;2287044278;Taip;0;12;0;12
13775;Vėtrungė;Do-re-mi;2928868412;Taip;5;6;1;12
13776;Vėtrungė;Do-re-mi;2883254822;Taip;4;2;0;6
13777;Vėtrungė;Do-re-mi;9518734260;Taip;5;3;4;12
13778;Vėtrungė;Do-re-mi;7496582551;Taip;0;0;1;1
13779;Vėtrungė;Do-re-mi;5430818470;Taip;0;10;0;10
13780;Vėtrungė;Do-re-mi;5832298824;Ne;0;3;0;3
13781;Vėtrungė;Do-re-mi;7895027909;Taip;0;2;6;8
13782;Vėtrungė;Do-re-mi;7807708310;Taip;0;0;9;9
13783;Vėtrungė;Do-re-mi;3200251047;Taip;4;0;4;8
13784;Vėtrungė;Do-re-mi;3369970611;Taip;0;13;0;13
13785;Vėtrungė;Do-re-mi;1808699695;Taip;0;4;10;14
13786;Vėtrungė;Do-re-mi;9079483362;Taip;21;0;1;22
13787;Vėtrungė;Do-re-mi;9271869305;Taip;0;0;9;9
13788;Vėtrungė;Do-re-mi;4709068324;Taip;0;4;1;5
13789;Vėtrungė;Do-re-mi;5452337780;Taip;0;0;6;6
13790;Vėtrungė;Do-re-mi;8956375453;Taip;5;0;8;13
13791;Vėtrungė;Do-re-mi;9865628172;Taip;5;4;0;9
13792;Vėtrungė;Smalsučių;7803736567;Taip;0;3;0;3
13793;Vėtrungė;Smalsučių;6599281163;Taip;0;2;0;2
13794;Vėtrungė;Smalsučių;3249689008;Taip;8;9;0;17
13795;Vėtrungė;Smalsučių;7129180154;Taip;0;3;0;3
13796;Vėtrungė;Smalsučių;7295216791;Taip;0;4;0;4
13797;Vėtrungė;Smalsučių;9795630131;Taip;0;3;0;3
13798;Vėtrungė;Smalsučių;2636219826;Taip;5;4;0;9
13799;Vėtrungė;Smalsučių;7363490503;Taip;0;5;0;5
13800;Vėtrungė;Smalsučių;16216365941;Taip;0;1;0;1
13801;Vėtrungė;Smalsučių;2471926240;Taip;0;1;0;1
13802;Vėtrungė;Smalsučių;7813907852;Taip;0;3;0;3
13803;Vėtrungė;Smalsučių;2440001662;Taip;0;3;0;3
13804;Vėtrungė;Smalsučių;4000379945;Taip;0;7;0;7
13805;Vėtrungė;Smalsučių;5367369908;Taip;0;6;0;6
13806;Vėtrungė;Smalsučių;4154712272;Taip;5;3;0;8
13807;Vėtrungė;Smalsučių;3278452234;Taip;0;7;0;7
13808;Vėtrungė;Smalsučių;7483624989;Taip;5;5;0;10
13809;Vėtrungė;Smalsučių;4394100006;Taip;9;5;0;14
13810;Vėtrungė;Smalsučių;7730716483;Taip;0;5;0;5
13811;Vėtrungė;Smalsučių;5786557195;Taip;0;3;0;3
13812;Vėtrungė;Gudručių;6732632515;Taip;0;3;0;3
13813;Vėtrungė;Gudručių;8721035192;Taip;9;5;0;14
13814;Vėtrungė;Gudručių;1970034012;Ne;0;9;0;9
13815;Vėtrungė;Gudručių;3404120492;Taip;0;1;0;1
13816;Vėtrungė;Gudručių;8897558066;Taip;0;1;0;1
13817;Vėtrungė;Gudručių;7921863675;Taip;0;7;0;7
13818;Vėtrungė;Gudručių;8154023892;Ne;6;5;0;11
13819;Vėtrungė;Gudručių;1522141057;Taip;0;10;0;10
13820;Vėtrungė;Gudručių;9962435598;Taip;16;3;0;19
13821;Vėtrungė;Gudručių;2864217098;Taip;5;4;0;9
13822;Vėtrungė;Gudručių;2482436192;Taip;5;4;0;9
13823;Vėtrungė;Gudručių;4092242233;Taip;0;3;3;6
13824;Vėtrungė;Gudručių;1551989977;Taip;5;3;0;8
13825;Vėtrungė;Gudručių;4091719904;Taip;0;7;0;7
13826;Vėtrungė;Gudručių;5994465833;Taip;0;1;0;1
13827;Vėtrungė;Gudručių;4347810256;Taip;5;1;0;6
13828;Vėtrungė;Gudručių;7704497739;Taip;0;3;0;3
13829;Vėtrungė;Gudručių;8643181832;Taip;0;3;4;7
13830;Vėtrungė;Gudručių;1520846063;Taip;5;3;2;10
13831;Vėtrungė;Kodėlčių;9172488122;Taip;0;4;0;4
13832;Vėtrungė;Kodėlčių;2739382736;Taip;0;7;0;7
13833;Vėtrungė;Kodėlčių;3903604247;Taip;5;0;2;7
13834;Vėtrungė;Kodėlčių;3500551575;Taip;0;2;0;2
13835;Vėtrungė;Kodėlčių;7872043253;Taip;4;5;0;9
13836;Vėtrungė;Kodėlčių;9852609222;Taip;5;0;0;5
13837;Vėtrungė;Kodėlčių;8859592174;Taip;0;1;0;1
13838;Vėtrungė;Kodėlčių;5385880910;Taip;9;0;0;9
13839;Vėtrungė;Kodėlčių;4756863295;Taip;12;0;0;12
13840;Vėtrungė;Kodėlčių;3922749661;Taip;9;3;0;12
13841;Vėtrungė;Kodėlčių;8013249618;Taip;0;6;0;6
13842;Vėtrungė;Kodėlčių;6807838878;Taip;4;1;0;5
13843;Vėtrungė;Paukštelių;6983172988;Taip;10;1;3;14
13844;Vėtrungė;Paukštelių;8744205170;Taip;12;1;0;13
13845;Vėtrungė;Paukštelių;3957148270;Taip;18;0;0;18
13846;Vėtrungė;Paukštelių;3466149991;Taip;5;3;0;8
13847;Vėtrungė;Paukštelių;7258995031;Taip;0;1;4;5
13848;Vėtrungė;Paukštelių;5338424871;Taip;5;8;5;18
13849;Vėtrungė;Paukštelių;4805836717;Taip;8;0;1;9
13850;Vėtrungė;Paukštelių;6812588777;Taip;14;0;0;14
13851;Vėtrungė;Paukštelių;2798915063;Taip;5;0;4;9
13852;Vėtrungė;Paukštelių;2981610749;Taip;5;0;4;9
13853;Vėtrungė;Paukštelių;6146327857;Taip;5;0;1;6
13854;Vėtrungė;Paukštelių;8149563485;Taip;11;0;0;11
13855;Vėtrungė;Viščiukų;2725607774;Taip;0;3;0;3
13856;Vėtrungė;Viščiukų;5021830780;Taip;5;0;2;7
13857;Vėtrungė;Viščiukų;5808423634;Taip;7;0;1;8
13858;Vėtrungė;Viščiukų;6190900822;Taip;6;3;2;11
13859;Vėtrungė;Viščiukų;3834510410;Taip;7;0;4;11
13860;Vėtrungė;Viščiukų;4597361099;Taip;0;0;10;10
13861;Vėtrungė;Viščiukų;2490075899;Taip;0;4;1;5
13862;Vėtrungė;Viščiukų;4712052283;Ne;4;3;0;7
13863;Vėtrungė;Viščiukų;8761701511;Taip;8;6;0;14
13864;Vėtrungė;Viščiukų;3527585648;Taip;8;0;1;9
13865;Vėtrungė;Viščiukų;9684184905;Ne;5;0;3;8
13866;Vėtrungė;Viščiukų;4145172377;Taip;0;4;1;5
13867;Vėtrungė;Viščiukų;1568598938;Taip;5;1;1;7
13868;Vėtrungė;Viščiukų;8577668542;Taip;3;0;5;8
13869;Vėtrungė;Viščiukų;4740985408;Taip;0;0;3;3
13870;Vėtrungė;Nykštukų;9696984346;Taip;0;9;0;9
13871;Vėtrungė;Nykštukų;7819147751;Taip;5;1;0;6
13872;Vėtrungė;Nykštukų;6990506209;Taip;0;3;0;3
13873;Vėtrungė;Nykštukų;2348557463;Taip;9;0;0;9
13874;Vėtrungė;Nykštukų;7733472482;Taip;8;0;0;8
13875;Vėtrungė;Nykštukų;2309821873;Taip;4;1;0;5
13876;Vėtrungė;Nykštukų;2364156362;Taip;0;7;0;7
13877;Vėtrungė;Nykštukų;8059553343;Taip;0;11;0;11
13878;Vėtrungė;Nykštukų;4020987532;Taip;2;1;1;4
13879;Vėtrungė;Nykštukų;7699392279;Taip;0;15;0;15
13880;Vėtrungė;Nykštukų;9773838651;Taip;6;3;0;9
13881;Vėtrungė;Nykštukų;6866720274;Taip;0;3;0;3
13882;Vėtrungė;Nykštukų;3869546285;Taip;3;0;0;3
13883;Vėtrungė;Nykštukų;6783756347;Taip;4;2;0;6
13884;Vėtrungė;Nykštukų;4289435509;Taip;0;3;0;3
13885;Vėtrungė;Meškiukų;2510763357;Taip;3;0;0;3
13886;Vėtrungė;Meškiukų;4713420194;Taip;3;0;0;3
13887;Vėtrungė;Meškiukų;2226654309;Taip;0;5;0;5
13888;Vėtrungė;Meškiukų;9207846866;Taip;1;0;0;1
13889;Vėtrungė;Meškiukų;9065848425;Taip;0;8;0;8
13890;Vėtrungė;Meškiukų;3328447991;Taip;0;1;0;1
13891;Vėtrungė;Meškiukų;9685389270;Ne;0;5;0;5
13892;Vėtrungė;Meškiukų;9313438768;Taip;0;6;0;6
13893;Vėtrungė;Meškiukų;2520926439;Taip;3;0;0;3
13894;Vėtrungė;Meškiukų;7143997258;Taip;6;0;0;6
13895;Vėtrungė;Meškiukų;8961791293;Taip;3;3;0;6
13896;Vėtrungė;Meškiukų;2809555356;Taip;0;3;0;3
13897;Vėtrungė;Meškiukų;1766599777;Ne;0;2;2;4
13898;Vėtrungė;Meškiukų;9642541034;Taip;0;2;0;2
13899;Vėtrungė;Meškiukų;8958748086;Taip;2;1;0;3
13900;Vėtrungė;Meškiukų;1480035015;Taip;7;0;0;7
13901;Vėtrungė;Ąžuoliukų;8775969909;Taip;11;0;2;13
13902;Vėtrungė;Ąžuoliukų;1034537691;Taip;4;0;0;4
13903;Vėtrungė;Ąžuoliukų;7568316390;Taip;0;3;0;3
13904;Vėtrungė;Ąžuoliukų;6363761237;Taip;2;4;0;6
13905;Vėtrungė;Ąžuoliukų;8913748584;Taip;8;3;0;11
13906;Vėtrungė;Ąžuoliukų;3073965379;Taip;11;3;0;14
13907;Vėtrungė;Ąžuoliukų;3938684888;Taip;10;0;0;10
13908;Vėtrungė;Ąžuoliukų;6073563461;Taip;10;3;0;13
13909;Vėtrungė;Ąžuoliukų;2977116563;Taip;11;0;0;11
13910;Vėtrungė;Ąžuoliukų;4925843510;Taip;14;0;0;14
13911;Vėtrungė;Ąžuoliukų;8867794275;Taip;5;3;0;8
13912;Vėtrungė;Ąžuoliukų;7096106273;Taip;16;0;2;18
13913;Vėtrungė;Ąžuoliukų;8026065367;Taip;5;2;0;7
13914;Vėtrungė;Ąžuoliukų;6476717645;Taip;9;0;0;9
13915;Vėtrungė;Ąžuoliukų;5167580818;Taip;18;0;0;18
13916;Vėtrungė;Ąžuoliukų;1169648551;Ne;4;3;0;7
13917;Vilnelė;Lakštutė;8843094480;Taip;1;4;0;5
13918;Vilnelė;Lakštutė;5786086401;Taip;9;0;0;9
13919;Vilnelė;Lakštutė;6249731759;Taip;0;13;0;13
13920;Vilnelė;Lakštutė;6837850601;Taip;7;1;0;8
13921;Vilnelė;Lakštutė;5554451335;Taip;5;2;0;7
13922;Vilnelė;Lakštutė;1762024490;Taip;7;2;3;12
13923;Vilnelė;Lakštutė;8201829887;Taip;0;7;0;7
13924;Vilnelė;Lakštutė;7702217893;Taip;2;0;2;4
13925;Vilnelė;Lakštutė;4427383755;Taip;0;7;0;7
13926;Vilnelė;Lakštutė;1547117566;Taip;0;7;0;7
13927;Vilnelė;Lakštutė;3231387543;Taip;0;4;0;4
13928;Vilnelė;Lakštutė;1734277231;Taip;0;5;0;5
13929;Vilnelė;Lakštutė;8837662451;Taip;0;14;0;14
13930;Vilnelė;Lakštutė;3900484348;Taip;0;2;1;3
13931;Vilnelė;Lakštutė;5498574366;Taip;18;0;0;18
13932;Vilnelė;Lakštutė;6686896190;Taip;0;5;3;8
13933;Vilnelė;Lakštutė;3032273912;Taip;9;5;0;14
13934;Vilnelė;Lakštutė;4017436910;Taip;5;1;2;8
13935;Vilnelė;Lakštutė;6156838553;Taip;5;3;0;8
13936;Vilnelė;Lakštutė;9843449060;Taip;6;1;3;10
13937;Vilnelė;Lakštutė;2803880424;Taip;0;2;3;5
13938;Vilnelė;Lakštutė;2418216191;Taip;0;0;4;4
13939;Vilnelė;Vyturėlis;5091272908;Taip;0;3;0;3
13940;Vilnelė;Vyturėlis;1133945467;Taip;0;3;0;3
13941;Vilnelė;Vyturėlis;3009064105;Taip;1;1;0;2
13942;Vilnelė;Vyturėlis;3743740372;Taip;0;5;0;5
13943;Vilnelė;Vyturėlis;2131599015;Taip;0;11;0;11
13944;Vilnelė;Vyturėlis;18740103706;Taip;5;6;0;11
13945;Vilnelė;Vyturėlis;7057183482;Taip;2;4;2;8
13946;Vilnelė;Vyturėlis;8725191514;Taip;0;3;0;3
13947;Vilnelė;Vyturėlis;6308015852;Taip;0;6;0;6
13948;Vilnelė;Vyturėlis;1545570307;Taip;0;3;0;3
13949;Vilnelė;Vyturėlis;5540359276;Taip;6;2;0;8
13950;Vilnelė;Vyturėlis;1966090625;Taip;0;5;0;5
13951;Vilnelė;Vyturėlis;8740717061;Taip;0;5;0;5
13952;Vilnelė;Vyturėlis;3772263873;Taip;0;3;1;4
13953;Vilnelė;Vyturėlis;9183391434;Taip;0;8;0;8
13954;Vilnelė;Vyturėlis;9369955153;Taip;0;3;0;3
13955;Vilnelė;Vyturėlis;5558584030;Taip;0;4;0;4
13956;Vilnelė;Vyturėlis;1151879281;Taip;0;5;0;5
13957;Vilnelė;Vyturėlis;8820091584;Taip;3;4;0;7
13958;Vilnelė;Vyturėlis;8270866998;Taip;8;7;0;15
13959;Vilnelė;Vyturėlis;28447690974;Taip;0;3;0;3
13960;Vilnelė;Vyturėlis;1462397783;Taip;6;4;0;10
13961;Vilnelė;Pagrandukas;5508759323;Taip;8;2;0;10
13962;Vilnelė;Pagrandukas;2144925171;Taip;11;0;0;11
13963;Vilnelė;Pagrandukas;4295816753;Taip;0;7;0;7
13964;Vilnelė;Pagrandukas;3844066232;Ne;0;6;0;6
13965;Vilnelė;Pagrandukas;6659537454;Taip;0;8;0;8
13966;Vilnelė;Pagrandukas;5953205533;Taip;0;9;0;9
13967;Vilnelė;Pagrandukas;4448413194;Taip;0;1;0;1
13968;Vilnelė;Pagrandukas;6830433856;Taip;0;2;5;7
13969;Vilnelė;Pagrandukas;4664946923;Taip;0;0;3;3
13970;Vilnelė;Pagrandukas;6982847450;Taip;0;5;0;5
13971;Vilnelė;Pagrandukas;7560124407;Taip;4;5;3;12
13972;Vilnelė;Pagrandukas;3685294539;Taip;0;1;0;1
13973;Vilnelė;Pagrandukas;4931943297;Taip;0;4;0;4
13974;Vilnelė;Pagrandukas;7882756938;Taip;4;5;0;9
13975;Vilnelė;Pagrandukas;7348404699;Taip;0;2;0;2
13976;Vilnelė;Pagrandukas;3323738649;Taip;0;2;2;4
13977;Vilnelė;Pagrandukas;8116613831;Taip;0;2;0;2
13978;Vilnelė;Pagrandukas;9489760844;Taip;8;1;4;13
13979;Vilnelė;Pagrandukas;6466321228;Taip;0;11;0;11
13980;Vilnelė;Pagrandukas;4478847902;Taip;0;0;3;3
13981;Vilnelė;Pagrandukas;9635159885;Taip;0;2;6;8
13982;Vilnelė;Pagrandukas;6448119003;Taip;0;1;0;1
13983;Vilnelė;Pagrandukas;2165389724;Taip;0;0;5;5
13984;Vilnelė;Bitutė;1720695615;Taip;0;3;0;3
13985;Vilnelė;Bitutė;2121071276;Taip;0;3;0;3
13986;Vilnelė;Bitutė;7387394504;Taip;7;2;0;9
13987;Vilnelė;Bitutė;8593060923;Taip;10;0;7;17
13988;Vilnelė;Bitutė;1882520335;Taip;0;1;0;1
13989;Vilnelė;Bitutė;85074719873;Taip;0;3;0;3
13990;Vilnelė;Bitutė;2990112955;Taip;0;3;5;8
13991;Vilnelė;Bitutė;6318246517;Taip;3;0;2;5
13992;Vilnelė;Bitutė;1281521052;Taip;10;5;0;15
13993;Vilnelė;Bitutė;9058632601;Taip;0;3;0;3
13994;Vilnelė;Bitutė;8615257084;Taip;10;0;0;10
13995;Vilnelė;Bitutė;98028664140;Taip;5;4;0;9
13996;Vilnelė;Bitutė;1507865281;Taip;0;3;0;3
13997;Vilnelė;Bitutė;2130482375;Taip;0;4;0;4
13998;Vilnelė;Bitutė;7292043157;Taip;0;5;0;5
13999;Vilnelė;Bitutė;4480175299;Taip;0;7;0;7
14000;Vilnelė;Bitutė;39494954188;Taip;0;8;0;8
14001;Vilnelė;Bitutė;6327531229;Taip;0;3;0;3
14002;Vilnelė;Bitutė;42835212158;Taip;0;9;0;9
14003;Vilnelė;Bitutė;6146514112;Taip;18;0;0;18
14004;Vilnelė;Bitutė;5013418313;Taip;0;4;0;4
14005;Vilnelė;Bitutė;5932200003;Taip;0;0;3;3
14006;Vilnelė;Bitutė;1783854203;Taip;0;1;0;1
14007;Vilnelė;Bitutė;9016832316;Taip;0;0;1;1
14008;Vilnelė;Šaltinėlis;7752502124;Taip;16;0;0;16
14009;Vilnelė;Šaltinėlis;3064118212;Taip;2;3;3;8
14010;Vilnelė;Šaltinėlis;5813090771;Taip;15;0;0;15
14011;Vilnelė;Šaltinėlis;1234033852;Taip;2;0;0;2
14012;Vilnelė;Šaltinėlis;9317041585;Taip;13;0;0;13
14013;Vilnelė;Šaltinėlis;4670933970;Taip;3;0;1;4
14014;Vilnelė;Šaltinėlis;4817502971;Taip;5;0;6;11
14015;Vilnelė;Šaltinėlis;3712463891;Taip;11;0;2;13
14016;Vilnelė;Šaltinėlis;2343750614;Taip;0;0;6;6
14017;Vilnelė;Šaltinėlis;2700153185;Taip;5;0;5;10
14018;Vilnelė;Šaltinėlis;7698638698;Taip;0;0;1;1
14019;Vilnelė;Šaltinėlis;7231998656;Taip;13;0;1;14
14020;Vilnelė;Šaltinėlis;2683662906;Taip;0;0;2;2
14021;Vilnelė;Šaltinėlis;3142594542;Taip;2;2;0;4
14022;Vilnelė;Šaltinėlis;1108529953;Taip;1;0;0;1
14023;Vilnelė;Šaltinėlis;4982137749;Taip;0;1;0;1
14024;Vilnelė;Riešutėllis;1027463000;Taip;6;2;0;8
14025;Vilnelė;Riešutėllis;7020707723;Taip;0;9;0;9
14026;Vilnelė;Riešutėllis;1960860528;Taip;0;0;3;3
14027;Vilnelė;Riešutėllis;4203549404;Taip;5;3;0;8
14028;Vilnelė;Riešutėllis;3290952017;Taip;5;2;0;7
14029;Vilnelė;Riešutėllis;8588430578;Taip;0;10;0;10
14030;Vilnelė;Riešutėllis;7957695470;Taip;0;0;4;4
14031;Vilnelė;Riešutėllis;8750705826;Taip;3;0;0;3
14032;Vilnelė;Riešutėllis;4780827432;Taip;0;5;0;5
14033;Vilnelė;Riešutėllis;4455099179;Taip;0;3;0;3
14034;Vilnelė;Riešutėllis;5306723959;Taip;0;0;3;3
14035;Vilnelė;Riešutėllis;3670613082;Taip;10;5;0;15
14036;Vilnelė;Riešutėllis;6417545510;Taip;5;1;0;6
14037;Vilnelė;Riešutėllis;3211657057;Taip;0;5;0;5
14038;Vilnelė;Riešutėllis;9016866597;Taip;3;5;0;8
14039;Vilnelė;Riešutėllis;7087798406;Taip;3;2;0;5
14040;Vilnelė;Riešutėllis;4254744025;Ne;0;12;0;12
14041;Vilnelė;Riešutėllis;3730997665;Taip;0;2;2;4
14042;Vilnelė;Riešutėllis;2706699572;Taip;6;2;0;8
14043;Vilnelė;Riešutėllis;8774842903;Taip;5;0;6;11
14044;Vilnelė;Riešutėllis;3031790547;Ne;0;2;0;2
14045;Vilnelė;Nykštukas;4210511566;Taip;8;0;0;8
14046;Vilnelė;Nykštukas;2891787022;Taip;13;0;0;13
14047;Vilnelė;Nykštukas;4734511521;Taip;8;3;0;11
14048;Vilnelė;Nykštukas;6344134620;Taip;0;6;0;6
14049;Vilnelė;Nykštukas;4295630317;Taip;14;10;0;24
14050;Vilnelė;Nykštukas;1554473199;Taip;15;2;0;17
14051;Vilnelė;Nykštukas;1819154122;Taip;0;3;0;3
14052;Vilnelė;Nykštukas;4060927733;Taip;15;0;0;15
14053;Vilnelė;Nykštukas;2299381653;Taip;0;24;0;24
14054;Vilnelė;Nykštukas;5041031750;Taip;0;5;0;5
14055;Vilnelė;Nykštukas;2157793186;Taip;6;1;0;7
14056;Vilnelė;Nykštukas;4516818999;Taip;12;6;0;18
14057;Vilnelė;Nykštukas;8579294202;Taip;0;16;0;16
14058;Vilnelė;Nykštukas;7161529969;Taip;0;4;0;4
14059;Vilnelė;Nykštukas;3720979747;Taip;0;1;0;1
14060;Vilnelė;Nykštukas;8493390146;Taip;0;1;0;1
14061;Vilnelė;Nykštukas;6048991617;Taip;0;8;0;8
14062;Vilnelė;Nykštukas;6054488692;Taip;3;5;0;8
14063;Vilnelė;Nykštukas;8630048961;Ne;3;5;0;8
14064;Vilnelė;Nykštukas;7592040226;Taip;14;5;0;19
14065;Vilnelė;Nykštukas;1515873552;Taip;6;1;0;7
14066;Vilnelė;Nykštukas;5629086127;Taip;5;2;0;7
14067;Vilnelė;Pieštukas;9879688569;Taip;0;5;0;5
14068;Vilnelė;Pieštukas;5473379559;Taip;0;4;0;4
14069;Vilnelė;Pieštukas;3781595939;Taip;0;9;0;9
14070;Vilnelė;Pieštukas;9884955712;Taip;0;3;0;3
14071;Vilnelė;Pieštukas;2479090686;Taip;5;5;0;10
14072;Vilnelė;Pieštukas;3945921490;Taip;0;17;0;17
14073;Vilnelė;Pieštukas;1975954784;Ne;0;6;0;6
14074;Vilnelė;Pieštukas;7199490431;Taip;0;3;0;3
14075;Vilnelė;Pieštukas;1730149127;Taip;6;4;0;10
14076;Vilnelė;Pieštukas;5778176840;Taip;0;3;0;3
14077;Vilnelė;Pieštukas;6355912551;Taip;0;3;0;3
14078;Vilnelė;Pieštukas;7976798775;Taip;10;3;0;13
14079;Vilnelė;Pieštukas;3811289758;Taip;8;2;0;10
14080;Vilnelė;Pieštukas;3529718234;Taip;0;5;0;5
14081;Vilnelė;Pieštukas;1880318663;Taip;0;9;0;9
14082;Vilnelė;Pieštukas;9589410276;Taip;0;9;0;9
14083;Vilnelė;Pieštukas;4718994967;Taip;0;11;0;11
14084;Vilnelė;Pieštukas;8092642447;Ne;0;1;0;1
14085;Vilnelė;Pieštukas;3856917286;Taip;9;5;0;14
14086;Vilnelė;Pieštukas;6132739519;Ne;7;9;0;16
14087;Vilnelė;Pieštukas;8162191913;Ne;0;3;0;3
14088;Vilnelė;Pieštukas;3791258264;Taip;0;2;2;4
14089;Vilnelė;Voverytė;7536603663;Ne;0;5;3;8
14090;Vilnelė;Voverytė;3503461211;Taip;8;3;0;11
14091;Vilnelė;Voverytė;3993826389;Taip;2;0;2;4
14092;Vilnelė;Voverytė;7388336851;Taip;0;8;0;8
14093;Vilnelė;Voverytė;8667403338;Taip;5;3;0;8
14094;Vilnelė;Voverytė;7883724600;Taip;5;3;0;8
14095;Vilnelė;Voverytė;4166351390;Taip;10;0;0;10
14096;Vilnelė;Voverytė;1351798589;Taip;0;3;0;3
14097;Vilnelė;Voverytė;9162681538;Taip;0;2;0;2
14098;Vilnelė;Voverytė;3075681823;Taip;0;2;0;2
14099;Vilnelė;Voverytė;6342242777;Taip;0;3;0;3
14100;Vilnelė;Voverytė;3843064564;Taip;0;3;0;3
14101;Vilnelė;Voverytė;3558073399;Taip;0;5;0;5
14102;Vilnelė;Voverytė;2923012145;Taip;2;2;1;5
14103;Vilnelė;Voverytė;2841315531;Taip;0;0;9;9
14104;Vilnelė;Voverytė;9804772168;Taip;0;1;1;2
14105;Vilnelė;Voverytė;1596625263;Taip;0;3;0;3
14106;Vilnelė;Voverytė;7338573817;Taip;0;0;6;6
14107;Vilnelė;Voverytė;8121075430;Taip;0;2;0;2
14108;Vilnelė;Voverytė;1574809879;Taip;8;1;0;9
14109;Vilnelė;Voverytė;6083082959;Taip;0;3;0;3
14110;Vilnelė;Voverytė;2788449626;Taip;0;5;0;5
14111;Vilnelė;Kodėlčiukas;4642378600;Taip;5;3;0;8
14112;Vilnelė;Kodėlčiukas;6618109352;Taip;6;13;0;19
14113;Vilnelė;Kodėlčiukas;6715997340;Taip;10;2;1;13
14114;Vilnelė;Kodėlčiukas;8439505238;Taip;10;2;0;12
14115;Vilnelė;Kodėlčiukas;1580287517;Taip;0;5;0;5
14116;Vilnelė;Kodėlčiukas;4328263940;Taip;12;6;0;18
14117;Vilnelė;Kodėlčiukas;3056845279;Taip;0;7;0;7
14118;Vilnelė;Kodėlčiukas;9537740492;Taip;0;5;3;8
14119;Vilnelė;Kodėlčiukas;9640330864;Taip;7;2;1;10
14120;Vilnelė;Kodėlčiukas;3848720970;Taip;0;2;4;6
14121;Vilnelė;Kodėlčiukas;7833531435;Taip;5;5;0;10
14122;Vilnelė;Kodėlčiukas;5961910077;Taip;8;2;2;12
14123;Vilnelė;Kodėlčiukas;3115242919;Taip;2;0;0;2
14124;Vilnelė;Kodėlčiukas;8543995029;Taip;6;8;0;14
14125;Vilnelė;Kodėlčiukas;1933660272;Taip;0;0;8;8
14126;Vilnelė;Kodėlčiukas;4986079102;Taip;10;0;0;10
14127;Vilnelė;Kodėlčiukas;5398303580;Taip;0;1;1;2
14128;Vilnelė;Kodėlčiukas;9418661965;Taip;7;0;0;7
14129;Vilnelė;Kodėlčiukas;5180951251;Taip;5;2;2;9
14130;Vilnelė;Žirniukas;5612501291;Taip;0;0;3;3
14131;Vilnelė;Žirniukas;3654833067;Taip;0;2;9;11
14132;Vilnelė;Žirniukas;4322462166;Taip;0;2;9;11
14133;Vilnelė;Žirniukas;9817054571;Taip;0;4;0;4
14134;Vilnelė;Žirniukas;9316933315;Taip;0;9;0;9
14135;Vilnelė;Žirniukas;1598555488;Taip;11;2;3;16
14136;Vilnelė;Žirniukas;5960725916;Taip;0;12;0;12
14137;Vilnelė;Žirniukas;8329253118;Taip;13;0;0;13
14138;Vilnelė;Žirniukas;9476510950;Taip;0;2;6;8
14139;Vilnelė;Žirniukas;7870509810;Taip;5;0;1;6
14140;Vilnelė;Žirniukas;6569980514;Taip;10;1;0;11
14141;Vilnelė;Žirniukas;6634526716;Taip;0;6;0;6
14142;Vilnelė;Žirniukas;8848138564;Taip;0;8;0;8
14143;Vilnelė;Žirniukas;5649725693;Taip;0;7;0;7
14144;Vilnelė;Žirniukas;7568755715;Taip;5;0;7;12
14145;Vilnelė;Žirniukas;1371066506;Taip;0;5;0;5
14146;Vilnelė;Žirniukas;4758117005;Taip;10;1;0;11
14147;Vilnelė;Pipiras;1414168531;Taip;0;0;1;1
14148;Vilnelė;Pipiras;2918624119;Taip;0;0;1;1
14149;Vilnelė;Pipiras;3432602015;Taip;0;2;1;3
14150;Vilnelė;Pipiras;9660305163;Taip;0;4;0;4
14151;Vilnelė;Pipiras;2964672357;Taip;5;8;0;13
14152;Vilnelė;Pipiras;1566734465;Taip;7;0;1;8
14153;Vilnelė;Pipiras;9882766915;Taip;12;6;0;18
14154;Vilnelė;Pipiras;8015908754;Taip;18;0;0;18
14155;Vilnelė;Pipiras;7968029402;Taip;5;2;1;8
14156;Vilnelė;Pipiras;7221712624;Taip;5;2;1;8
14157;Vilnelė;Pipiras;6966791665;Taip;0;1;0;1
14158;Vilnelė;Pipiras;7293735126;Taip;0;1;0;1
14159;Vilnelė;Pipiras;9950598582;Taip;10;0;3;13
14160;Vilnelė;Pipiras;5444967820;Taip;13;0;0;13
14161;Vilnelė;Pipiras;3828623778;Taip;2;9;0;11
14162;Vilnelė;Pipiras;5273665901;Taip;1;2;0;3
14163;Vilnelė;Pipiras;5173602064;Taip;0;2;0;2
14164;Vėrinėlis;GAIDELIAI;7069247393;Taip;0;0;2;2
14165;Vėrinėlis;GAIDELIAI;6162461750;Taip;11;0;0;11
14166;Vėrinėlis;GAIDELIAI;3500287869;Taip;0;2;3;5
14167;Vėrinėlis;GAIDELIAI;9370715798;Taip;12;0;2;14
14168;Vėrinėlis;GAIDELIAI;6500266853;Taip;21;0;0;21
14169;Vėrinėlis;GAIDELIAI;5891690000;Taip;17;0;1;18
14170;Vėrinėlis;GAIDELIAI;4401001009;Taip;28;0;0;28
14171;Vėrinėlis;GAIDELIAI;4498096701;Taip;5;1;0;6
14172;Vėrinėlis;GAIDELIAI;6055921178;Taip;6;9;0;15
14173;Vėrinėlis;GAIDELIAI;9144004655;Taip;15;0;0;15
14174;Vėrinėlis;GAIDELIAI;8272531606;Taip;15;0;0;15
14175;Vėrinėlis;GAIDELIAI;6159725406;Taip;1;5;1;7
14176;Vėrinėlis;GAIDELIAI;1844862699;Taip;7;0;1;8
14177;Vėrinėlis;GAIDELIAI;7455948332;Taip;7;16;0;23
14178;Vėrinėlis;GAIDELIAI;4965735537;Taip;15;0;1;16
14179;Vėrinėlis;SAULUTĖ;7224418233;Taip;12;0;0;12
14180;Vėrinėlis;SAULUTĖ;9612956692;Taip;6;6;0;12
14181;Vėrinėlis;SAULUTĖ;8238013636;Taip;13;0;0;13
14182;Vėrinėlis;SAULUTĖ;7273090217;Taip;0;3;0;3
14183;Vėrinėlis;SAULUTĖ;2337883071;Taip;0;0;4;4
14184;Vėrinėlis;SAULUTĖ;6913001318;Taip;0;3;0;3
14185;Vėrinėlis;SAULUTĖ;3882915774;Taip;0;13;0;13
14186;Vėrinėlis;SAULUTĖ;7440020169;Taip;0;6;0;6
14187;Vėrinėlis;SAULUTĖ;7913975075;Taip;13;1;0;14
14188;Vėrinėlis;SAULUTĖ;9967737864;Taip;8;2;0;10
14189;Vėrinėlis;SAULUTĖ;7364698713;Taip;13;0;0;13
14190;Vėrinėlis;SAULUTĖ;9009344779;Taip;0;3;0;3
14191;Vėrinėlis;SAULUTĖ;4059906525;Taip;3;0;0;3
14192;Vėrinėlis;SAULUTĖ;3832662507;Taip;8;0;0;8
14193;Vėrinėlis;SAULUTĖ;3291922401;Taip;5;3;1;9
14194;Vėrinėlis;SAULUTĖ;1007705906;Taip;0;9;0;9
14195;Vėrinėlis;SAULUTĖ;9289003583;Taip;8;1;0;9
14196;Vėrinėlis;SAULUTĖ;1684203955;Taip;8;1;0;9
14197;Vėrinėlis;SAULUTĖ;5942475043;Taip;5;2;0;7
14198;Vėrinėlis;SAULUTĖ;9310629340;Taip;13;0;0;13
14199;Vėrinėlis;SAULUTĖ;2369434537;Taip;0;5;1;6
14200;Vėrinėlis;NYKŠTUKAI;1865151493;Taip;0;3;0;3
14201;Vėrinėlis;NYKŠTUKAI;8755231814;Taip;4;3;2;9
14202;Vėrinėlis;NYKŠTUKAI;9604483237;Taip;0;3;3;6
14203;Vėrinėlis;NYKŠTUKAI;6220653152;Taip;10;2;0;12
14204;Vėrinėlis;NYKŠTUKAI;6644892686;Taip;4;2;0;6
14205;Vėrinėlis;NYKŠTUKAI;7981261038;Taip;0;5;0;5
14206;Vėrinėlis;NYKŠTUKAI;6278738058;Taip;3;3;0;6
14207;Vėrinėlis;NYKŠTUKAI;19865450007;Taip;0;0;1;1
14208;Vėrinėlis;NYKŠTUKAI;3975934329;Taip;0;3;1;4
14209;Vėrinėlis;NYKŠTUKAI;5511584499;Taip;0;3;1;4
14210;Vėrinėlis;NYKŠTUKAI;4958359640;Taip;0;2;0;2
14211;Vėrinėlis;NYKŠTUKAI;3562371502;Taip;8;3;0;11
14212;Vėrinėlis;NYKŠTUKAI;9751037428;Taip;6;6;0;12
14213;Vėrinėlis;NYKŠTUKAI;4089567420;Taip;0;3;0;3
14214;Vėrinėlis;NYKŠTUKAI;8579819581;Taip;0;8;0;8
14215;Vėrinėlis;NYKŠTUKAI;5209398043;Taip;0;5;0;5
14216;Vėrinėlis;NYKŠTUKAI;3074835599;Taip;8;1;0;9
14217;Vėrinėlis;NYKŠTUKAI;6779005350;Taip;0;3;0;3
14218;Vėrinėlis;NYKŠTUKAI;8824435889;Taip;0;3;0;3
14219;Vėrinėlis;BURATINAS;7093959212;Taip;0;1;0;1
14220;Vėrinėlis;BURATINAS;8100283579;Taip;0;3;0;3
14221;Vėrinėlis;BURATINAS;7078114492;Taip;0;0;3;3
14222;Vėrinėlis;BURATINAS;6280508974;Taip;0;0;3;3
14223;Vėrinėlis;BURATINAS;4666918175;Taip;0;0;1;1
14224;Vėrinėlis;BURATINAS;2774618380;Taip;0;7;0;7
14225;Vėrinėlis;BURATINAS;2857591912;Taip;0;9;0;9
14226;Vėrinėlis;BURATINAS;5429955166;Taip;0;0;4;4
14227;Vėrinėlis;BURATINAS;5429372946;Taip;13;0;0;13
14228;Vėrinėlis;BURATINAS;4183077476;Taip;3;12;0;15
14229;Vėrinėlis;BURATINAS;2529641529;Taip;0;5;0;5
14230;Vėrinėlis;BURATINAS;2467700639;Taip;17;0;0;17
14231;Vėrinėlis;BURATINAS;6136232912;Taip;0;8;0;8
14232;Vėrinėlis;BURATINAS;7092421890;Taip;0;2;0;2
14233;Vėrinėlis;BURATINAS;6058712578;Taip;0;4;0;4
14234;Vėrinėlis;BURATINAS;1164396960;Taip;0;0;1;1
14235;Vėrinėlis;BURATINAS;6413701823;Taip;5;0;3;8
14236;Vėrinėlis;BURATINAS;2364117224;Taip;0;6;0;6
14237;Vėrinėlis;BURATINAS;5206206080;Taip;7;3;10;20
14238;Vėrinėlis;BURATINAS;3947650381;Taip;5;0;2;7
14239;Vėrinėlis;GINTARĖLIAI;5987029334;Taip;18;0;0;18
14240;Vėrinėlis;GINTARĖLIAI;8372084728;Taip;18;0;0;18
14241;Vėrinėlis;GINTARĖLIAI;6054398276;Taip;6;0;0;6
14242;Vėrinėlis;GINTARĖLIAI;7432965615;Taip;14;4;0;18
14243;Vėrinėlis;GINTARĖLIAI;3457199716;Taip;17;0;0;17
14244;Vėrinėlis;GINTARĖLIAI;7743951577;Taip;13;0;0;13
14245;Vėrinėlis;GINTARĖLIAI;2006432327;Taip;15;3;0;18
14246;Vėrinėlis;GINTARĖLIAI;6785519869;Taip;18;0;0;18
14247;Vėrinėlis;GINTARĖLIAI;3363388500;Taip;14;3;0;17
14248;Vėrinėlis;GINTARĖLIAI;1872534206;Taip;5;1;0;6
14249;Vėrinėlis;GINTARĖLIAI;8545392429;Taip;8;0;0;8
14250;Vėrinėlis;GINTARĖLIAI;9171173116;Taip;14;3;0;17
14251;Vėrinėlis;GINTARĖLIAI;8343196405;Taip;13;1;0;14
14252;Vėrinėlis;GINTARĖLIAI;2284527544;Taip;1;0;0;1
14253;Vėrinėlis;GINTARĖLIAI;5644772729;Taip;0;4;0;4
14254;Vėrinėlis;GINTARĖLIAI;4034106321;Taip;1;2;0;3
14255;Vėrinėlis;RAMUNĖLĖS;4415030161;Taip;0;4;0;4
14256;Vėrinėlis;RAMUNĖLĖS;8620836106;Taip;2;3;3;8
14257;Vėrinėlis;RAMUNĖLĖS;5003344894;Taip;10;1;0;11
14258;Vėrinėlis;RAMUNĖLĖS;8922728881;Taip;0;1;2;3
14259;Vėrinėlis;RAMUNĖLĖS;5434506594;Taip;0;8;0;8
14260;Vėrinėlis;RAMUNĖLĖS;5041189990;Taip;0;3;0;3
14261;Vėrinėlis;RAMUNĖLĖS;1047139776;Taip;0;5;0;5
14262;Vėrinėlis;RAMUNĖLĖS;3130841241;Taip;0;4;0;4
14263;Vėrinėlis;RAMUNĖLĖS;9798993200;Taip;0;4;0;4
14264;Vėrinėlis;RAMUNĖLĖS;6435612222;Taip;0;3;0;3
14265;Vėrinėlis;RAMUNĖLĖS;6866592245;Taip;0;4;0;4
14266;Vėrinėlis;RAMUNĖLĖS;4728119881;Taip;0;3;0;3
14267;Vėrinėlis;RAMUNĖLĖS;3316897176;Taip;0;6;0;6
14268;Vėrinėlis;RAMUNĖLĖS;1386916991;Taip;0;3;0;3
14269;Vėrinėlis;RAMUNĖLĖS;2090334618;Taip;0;4;0;4
14270;Vėrinėlis;RAMUNĖLĖS;3810261864;Taip;0;1;1;2
14271;Vėrinėlis;RAMUNĖLĖS;4191386053;Taip;0;6;0;6
14272;Vėrinėlis;KODELČIUKŲ;7070058961;Taip;0;4;0;4
14273;Vėrinėlis;KODELČIUKŲ;3308843618;Taip;0;4;0;4
14274;Vėrinėlis;KODELČIUKŲ;1535567719;Taip;10;4;0;14
14275;Vėrinėlis;KODELČIUKŲ;8755941866;Taip;5;3;0;8
14276;Vėrinėlis;KODELČIUKŲ;9686481278;Taip;0;2;0;2
14277;Vėrinėlis;KODELČIUKŲ;42298331453;Taip;0;2;0;2
14278;Vėrinėlis;KODELČIUKŲ;8709714647;Taip;0;5;0;5
14279;Vėrinėlis;KODELČIUKŲ;6108187043;Taip;0;4;0;4
14280;Vėrinėlis;KODELČIUKŲ;9119967823;Taip;0;1;1;2
14281;Vėrinėlis;KODELČIUKŲ;4067153819;Taip;0;3;8;11
14282;Vėrinėlis;KODELČIUKŲ;5712568063;Taip;8;3;1;12
14283;Vėrinėlis;KODELČIUKŲ;1467899937;Taip;0;3;4;7
14284;Vėrinėlis;KODELČIUKŲ;8885866108;Taip;0;1;3;4
14285;Vėrinėlis;KODELČIUKŲ;7634939364;Taip;0;4;0;4
14286;Vėrinėlis;KODELČIUKŲ;3049346950;Taip;8;3;5;16
14287;Vėrinėlis;KODELČIUKŲ;8652292752;Taip;0;3;3;6
14288;Vėrinėlis;KODELČIUKŲ;4039903678;Taip;5;3;5;13
14289;Vėrinėlis;KODELČIUKŲ;3729926575;Taip;0;3;6;9
14290;Vėrinėlis;KODELČIUKŲ;7167034587;Taip;11;1;0;12
14291;Vėrinėlis;KODELČIUKŲ;9511678036;Taip;0;3;0;3
14292;Vėrinėlis;KODELČIUKŲ;3369668445;Taip;0;2;0;2
14293;Vėrinėlis;KODELČIUKŲ;8728166391;Taip;0;3;0;3
14294;Vėrinėlis;KODELČIUKŲ;5720076968;Taip;0;3;5;8
14295;Vėrinėlis;KODELČIUKŲ;8195455092;Taip;5;2;0;7
14296;Vėrinėlis;ŽIRNIUKAI;1769852084;Taip;10;4;0;14
14297;Vėrinėlis;ŽIRNIUKAI;4981127515;Taip;0;3;0;3
14298;Vėrinėlis;ŽIRNIUKAI;8329989952;Taip;10;0;3;13
14299;Vėrinėlis;ŽIRNIUKAI;3202518504;Taip;5;0;5;10
14300;Vėrinėlis;ŽIRNIUKAI;4752902173;Taip;0;5;0;5
14301;Vėrinėlis;ŽIRNIUKAI;7237945125;Taip;0;0;4;4
14302;Vėrinėlis;ŽIRNIUKAI;5600815908;Taip;8;0;3;11
14303;Vėrinėlis;ŽIRNIUKAI;7367485961;Taip;0;2;0;2
14304;Vėrinėlis;ŽIRNIUKAI;1736733257;Taip;10;0;1;11
14305;Vėrinėlis;ŽIRNIUKAI;2687583764;Taip;6;0;0;6
14306;Vėrinėlis;ŽIRNIUKAI;2633143128;Taip;5;0;3;8
14307;Vėrinėlis;ŽIRNIUKAI;9419245081;Taip;0;3;1;4
14308;Vėrinėlis;ŽIRNIUKAI;7817387800;Taip;8;0;5;13
14309;Vėrinėlis;ŽIRNIUKAI;6377447141;Ne;4;0;5;9
14310;Vėrinėlis;ŽIRNIUKAI;7371908331;Taip;5;0;5;10
14311;Vėrinėlis;ŽIRNIUKAI;2087129236;Taip;4;0;2;6
14312;Vėrinėlis;ŽIRNIUKAI;6392625405;Ne;8;3;0;11
14313;Vėrinėlis;ŽIRNIUKAI;1896980533;Taip;10;0;3;13
14314;Vėrinėlis;ŽIRNIUKAI;2732572235;Taip;10;0;2;12
14315;Vėrinėlis;ŽIRNIUKAI;8483525051;Taip;0;0;3;3
14316;Vėrinėlis;ŽIRNIUKAI;8397025332;Taip;5;0;1;6
14317;Vėrinėlis;ŽIRNIUKAI;6576726481;Taip;5;0;1;6
14318;Vėrinėlis;VARPELIAI;7416041207;Taip;0;4;0;4
14319;Vėrinėlis;VARPELIAI;8655158155;Taip;0;5;0;5
14320;Vėrinėlis;VARPELIAI;3829146401;Taip;4;1;0;5
14321;Vėrinėlis;VARPELIAI;6177784856;Taip;1;3;0;4
14322;Vėrinėlis;VARPELIAI;9388153932;Taip;15;0;3;18
14323;Vėrinėlis;VARPELIAI;6362125404;Ne;0;8;0;8
14324;Vėrinėlis;VARPELIAI;9599724421;Taip;0;3;0;3
14325;Vėrinėlis;VARPELIAI;7216867683;Taip;0;6;0;6
14326;Vėrinėlis;VARPELIAI;8336694468;Taip;2;2;0;4
14327;Vėrinėlis;VARPELIAI;2731207996;Taip;0;3;6;9
14328;Vėrinėlis;VARPELIAI;9522506115;Taip;0;12;0;12
14329;Vėrinėlis;VARPELIAI;2625930005;Taip;9;0;1;10
14330;Vėrinėlis;VARPELIAI;1026312967;Taip;0;3;0;3
14331;Vėrinėlis;VARPELIAI;2561255096;Taip;17;0;0;17
14332;Vėrinėlis;VARPELIAI;5821107898;Taip;13;0;0;13
14333;Vėrinėlis;VARPELIAI;9351658311;Taip;0;11;0;11
14334;Vėrinėlis;VARPELIAI;3392458614;Taip;0;2;2;4
14335;Vėrinėlis;BORUŽĖLĖS;8759487574;Taip;0;7;0;7
14336;Vėrinėlis;BORUŽĖLĖS;4819016753;Taip;2;0;0;2
14337;Vėrinėlis;BORUŽĖLĖS;1910385020;Taip;0;6;0;6
14338;Vėrinėlis;BORUŽĖLĖS;2078857084;Taip;8;0;3;11
14339;Vėrinėlis;BORUŽĖLĖS;3934652683;Taip;5;0;4;9
14340;Vėrinėlis;BORUŽĖLĖS;6904733283;Taip;4;0;8;12
14341;Vėrinėlis;BORUŽĖLĖS;4446546335;Taip;0;3;5;8
14342;Vėrinėlis;BORUŽĖLĖS;3718510933;Taip;0;1;0;1
14343;Vėrinėlis;BORUŽĖLĖS;2501287529;Taip;0;3;0;3
14344;Vėrinėlis;BORUŽĖLĖS;8904833339;Taip;3;4;0;7
14345;Vėrinėlis;BORUŽĖLĖS;3312501759;Taip;3;4;0;7
14346;Vėrinėlis;BORUŽĖLĖS;9217188911;Taip;6;8;0;14
14347;Vėrinėlis;BORUŽĖLĖS;7414937335;Taip;15;3;0;18
14348;Vėrinėlis;BORUŽĖLĖS;2574507205;Taip;7;8;0;15
14349;Vėrinėlis;BORUŽĖLĖS;6671382987;Taip;7;0;0;7
14350;Vėrinėlis;BORUŽĖLĖS;3200007674;Taip;0;0;2;2
14351;Vėrinėlis;BORUŽĖLĖS;4852563692;Taip;0;3;5;8
14352;Vėrinėlis;BORUŽĖLĖS;7953446502;Taip;0;14;0;14
14353;Vėrinėlis;BORUŽĖLĖS;5865529907;Taip;10;0;1;11
14354;Vėrinėlis;BORUŽĖLĖS;9613642664;Taip;0;4;0;4
14355;Vėrinėlis;BORUŽĖLĖS;2467242845;Taip;0;7;0;7
14356;Vėrinėlis;SVEIKUOLIAI;1909742394;Taip;14;0;0;14
14357;Vėrinėlis;SVEIKUOLIAI;6176308531;Taip;0;3;0;3
14358;Vėrinėlis;SVEIKUOLIAI;3070965434;Taip;4;4;0;8
14359;Vėrinėlis;SVEIKUOLIAI;3563114419;Taip;12;3;0;15
14360;Vėrinėlis;SVEIKUOLIAI;3973272659;Taip;2;4;2;8
14361;Vėrinėlis;SVEIKUOLIAI;8032396191;Taip;4;0;1;5
14362;Vėrinėlis;SVEIKUOLIAI;6504377326;Taip;0;1;0;1
14363;Vėrinėlis;SVEIKUOLIAI;8716965452;Taip;15;3;0;18
14364;Vėrinėlis;SVEIKUOLIAI;7584124339;Taip;0;6;0;6
14365;Vėrinėlis;SVEIKUOLIAI;9352630743;Taip;0;1;3;4
14366;Vėrinėlis;SVEIKUOLIAI;4859330774;Taip;13;1;0;14
14367;Vėrinėlis;SVEIKUOLIAI;8543081245;Taip;10;3;0;13
14368;Vėrinėlis;SVEIKUOLIAI;1800434426;Taip;0;3;0;3
14369;Vėrinėlis;SVEIKUOLIAI;3958551159;Taip;0;0;1;1
14370;Vėrinėlis;SVEIKUOLIAI;5614185158;Taip;0;4;3;7
14371;Vėrinėlis;SVEIKUOLIAI;5539714292;Taip;5;4;0;9
14372;Vėrinėlis;SVEIKUOLIAI;2516474825;Taip;14;0;0;14
14373;Vėrinėlis;SVEIKUOLIAI;9058127692;Taip;0;5;0;5
14374;Vėrinėlis;SVEIKUOLIAI;1278914183;Taip;6;0;6;12
14375;Vėrinėlis;SVEIKUOLIAI;7573209012;Taip;11;1;0;12
14376;Vėrinėlis;SVEIKUOLIAI;3084117432;Taip;0;2;0;2
14377;Vėrinėlis;SVEIKUOLIAI;2015928440;Taip;4;4;1;9
14378;Vėrinėlis;ŠIRDELĖS;7734163541;Taip;7;0;2;9
14379;Vėrinėlis;ŠIRDELĖS;7811024382;Taip;9;0;0;9
14380;Vėrinėlis;ŠIRDELĖS;4378592116;Taip;9;0;2;11
14381;Vėrinėlis;ŠIRDELĖS;7517113022;Taip;8;0;1;9
14382;Vėrinėlis;ŠIRDELĖS;1841277321;Taip;10;1;0;11
14383;Vėrinėlis;ŠIRDELĖS;5588658517;Taip;13;0;0;13
14384;Vėrinėlis;ŠIRDELĖS;5653635907;Taip;8;4;0;12
14385;Vėrinėlis;ŠIRDELĖS;1152010178;Taip;0;3;4;7
14386;Vėrinėlis;ŠIRDELĖS;2038169885;Taip;10;8;0;18
14387;Vėrinėlis;ŠIRDELĖS;9375922889;Taip;17;1;0;18
14388;Vėrinėlis;ŠIRDELĖS;5813009126;Taip;12;3;0;15
14389;Vėrinėlis;ŠIRDELĖS;3511809411;Taip;7;4;0;11
14390;Vėrinėlis;ŠIRDELĖS;3535652648;Taip;10;7;0;17
14391;Vėrinėlis;ŠIRDELĖS;9217815657;Taip;4;3;0;7
14392;Vėrinėlis;ŠIRDELĖS;4403875733;Taip;5;0;1;6
14393;Vėrinėlis;ŠIRDELĖS;4700093328;Taip;15;0;0;15
14394;Vėrinėlis;ŠIRDELĖS;1339847370;Taip;5;0;1;6
14395;Vėrinėlis;ŠIRDELĖS;1939318286;Taip;0;4;0;4
14396;Vėrinėlis;ŠIRDELĖS;3687250255;Taip;6;1;3;10
14397;Vėrinėlis;ŠIRDELĖS;7361319518;Taip;5;0;2;7
14398;Vėrinėlis;ŠIRDELĖS;2847839917;Taip;12;0;2;14
14399;Vėrinėlis;ŠIRDELĖS;7311740859;Taip;3;7;0;10
14400;Vėrinėlis;ŠIRDELĖS;6905591549;Taip;6;3;1;10
14401;Viltenė;Drugeliai;3625763429;Taip;0;4;0;4
14402;Viltenė;Drugeliai;2392304909;Taip;4;2;0;6
14403;Viltenė;Drugeliai;5781655552;Taip;8;3;0;11
14404;Viltenė;Drugeliai;2410868015;Taip;0;14;0;14
14405;Viltenė;Drugeliai;8679787688;Taip;9;0;0;9
14406;Viltenė;Drugeliai;4616047113;Ne;2;5;0;7
14407;Viltenė;Drugeliai;6810811656;Taip;0;3;0;3
14408;Viltenė;Drugeliai;9228677568;Taip;0;3;0;3
14409;Viltenė;Drugeliai;3905014810;Taip;0;11;0;11
14410;Viltenė;Drugeliai;4121448859;Taip;5;2;0;7
14411;Viltenė;Drugeliai;9157616307;Taip;0;3;0;3
14412;Viltenė;Drugeliai;9476132305;Taip;0;4;0;4
14413;Viltenė;Drugeliai;3052677157;Taip;0;8;0;8
14414;Viltenė;Drugeliai;5522245968;Taip;0;3;0;3
14415;Viltenė;Drugeliai;9820462941;Taip;0;1;0;1
14416;Viltenė;Drugeliai;5552217000;Taip;0;5;0;5
14417;Viltenė;Drugeliai;9756519374;Taip;0;2;0;2
14418;Viltenė;Drugeliai;7928894276;Taip;0;5;0;5
14419;Viltenė;Drugeliai;8527270437;Taip;0;6;0;6
14420;Viltenė;Drugeliai;4195708756;Taip;7;3;0;10
14421;Viltenė;Drugeliai;1267187553;Taip;0;2;0;2
14422;Viltenė;Drugeliai;1081603034;Taip;0;5;0;5
14423;Viltenė;Drugeliai;7500965165;Taip;0;10;0;10
14424;Viltenė;Bitučių;7158824421;Taip;23;0;0;23
14425;Viltenė;Bitučių;2846574130;Taip;0;16;0;16
14426;Viltenė;Bitučių;8336855920;Taip;0;9;0;9
14427;Viltenė;Bitučių;2841144656;Taip;11;1;0;12
14428;Viltenė;Bitučių;7810374329;Taip;3;11;0;14
14429;Viltenė;Bitučių;4724382069;Taip;7;3;0;10
14430;Viltenė;Bitučių;4001205912;Taip;5;4;0;9
14431;Viltenė;Bitučių;8141954391;Taip;0;1;0;1
14432;Viltenė;Bitučių;4379784712;Taip;0;10;0;10
14433;Viltenė;Bitučių;9095458948;Taip;14;0;0;14
14434;Viltenė;Bitučių;4661430937;Taip;8;1;0;9
14435;Viltenė;Bitučių;5241075224;Taip;3;1;0;4
14436;Viltenė;Boružėlių;6642790962;Taip;6;1;0;7
14437;Viltenė;Boružėlių;9572407405;Taip;2;2;0;4
14438;Viltenė;Boružėlių;3738838707;Taip;0;3;0;3
14439;Viltenė;Boružėlių;8473588098;Taip;0;8;0;8
14440;Viltenė;Boružėlių;3995418079;Taip;0;3;0;3
14441;Viltenė;Boružėlių;1399653129;Taip;0;5;0;5
14442;Viltenė;Boružėlių;7526555727;Ne;0;5;0;5
14443;Viltenė;Boružėlių;5379804362;Taip;0;3;0;3
14444;Viltenė;Boružėlių;1936628249;Taip;0;3;0;3
14445;Viltenė;Boružėlių;4003018966;Taip;0;1;0;1
14446;Viltenė;Boružėlių;7912396297;Taip;0;4;0;4
14447;Viltenė;Boružėlių;4036109404;Taip;3;4;0;7
14448;Viltenė;Boružėlių;4604298036;Taip;0;11;0;11
14449;Viltenė;Boružėlių;9242034622;Taip;4;3;0;7
14450;Viltenė;Boružėlių;6621273812;Taip;3;4;0;7
14451;Viltenė;Boružėlių;2383607612;Taip;6;5;0;11
14452;Viltenė;Boružėlių;1496943250;Taip;0;1;0;1
14453;Viltenė;Gandriukų;6481491422;Taip;4;3;4;11
14454;Viltenė;Gandriukų;2452782594;Taip;0;3;0;3
14455;Viltenė;Gandriukų;1126409020;Taip;0;3;0;3
14456;Viltenė;Gandriukų;2884698447;Taip;0;4;0;4
14457;Viltenė;Gandriukų;6060648988;Taip;6;3;0;9
14458;Viltenė;Gandriukų;1840626621;Taip;0;10;0;10
14459;Viltenė;Gandriukų;8549631247;Taip;0;5;0;5
14460;Viltenė;Gandriukų;7796422726;Taip;0;3;0;3
14461;Viltenė;Gandriukų;2815105107;Taip;0;3;0;3
14462;Viltenė;Gandriukų;6511850468;Taip;14;0;0;14
14463;Viltenė;Gandriukų;4945108189;Taip;0;4;0;4
14464;Viltenė;Gandriukų;5850652322;Taip;0;3;0;3
14465;Viltenė;Gandriukų;8110413064;Taip;0;3;0;3
14466;Viltenė;Gandriukų;1243595112;Taip;0;6;0;6
14467;Viltenė;Gandriukų;3073228245;Ne;7;3;3;13
14468;Viltenė;Gandriukų;4468743044;Taip;0;5;0;5
14469;Viltenė;Gandriukų;6355857716;Taip;0;1;0;1
14470;Viltenė;Gandriukų;5929135840;Taip;0;3;1;4
14471;Viltenė;Gandriukų;6473925760;Taip;7;0;0;7
14472;Viltenė;Gandriukų;8458769051;Taip;0;3;5;8
14473;Viltenė;Aitvariukai;5083515613;Ne;0;5;0;5
14474;Viltenė;Aitvariukai;2137929911;Taip;0;4;0;4
14475;Viltenė;Aitvariukai;9185054066;Taip;0;6;0;6
14476;Viltenė;Aitvariukai;2036902795;Taip;6;4;0;10
14477;Viltenė;Aitvariukai;5599943846;Taip;0;2;0;2
14478;Viltenė;Aitvariukai;6721689684;Taip;10;1;0;11
14479;Viltenė;Aitvariukai;6296509460;Taip;0;6;0;6
14480;Viltenė;Aitvariukai;9101795131;Taip;0;6;0;6
14481;Viltenė;Aitvariukai;3908574248;Taip;0;3;0;3
14482;Viltenė;Aitvariukai;8439859449;Taip;18;0;0;18
14483;Viltenė;Aitvariukai;2976705872;Taip;0;7;0;7
14484;Viltenė;Aitvariukai;2192086488;Taip;0;6;0;6
14485;Viltenė;Aitvariukai;2026654467;Ne;0;5;0;5
14486;Viltenė;Aitvariukai;4641365031;Taip;3;10;0;13
14487;Viltenė;Aitvariukai;7277455268;Taip;0;10;0;10
14488;Viltenė;Aitvariukai;3245284852;Taip;5;3;0;8
14489;Viltenė;Aitvariukai;2786572522;Taip;0;7;0;7
14490;Viltenė;Aitvariukai;6171399579;Taip;0;5;0;5
14491;Viltenė;Geniukų;5604263567;Taip;10;0;0;10
14492;Viltenė;Geniukų;1822220265;Taip;6;3;0;9
14493;Viltenė;Geniukų;6349032936;Taip;0;3;0;3
14494;Viltenė;Geniukų;1423254631;Taip;0;2;0;2
14495;Viltenė;Geniukų;3002690526;Taip;10;4;0;14
14496;Viltenė;Geniukų;6276349499;Taip;0;5;0;5
14497;Viltenė;Geniukų;1054469254;Taip;0;3;0;3
14498;Viltenė;Geniukų;6063181025;Taip;0;6;0;6
14499;Viltenė;Geniukų;1672091332;Taip;0;1;0;1
14500;Viltenė;Geniukų;3018271511;Taip;2;3;0;5
14501;Viltenė;Geniukų;49998813869;Taip;0;7;0;7
14502;Viltenė;Geniukų;3389110405;Taip;6;4;0;10
14503;Viltenė;Geniukų;4319685140;Taip;0;4;0;4
14504;Viltenė;Geniukų;8125023386;Taip;0;4;0;4
14505;Viltenė;Geniukų;9035687504;Taip;0;4;0;4
14506;Viltenė;Geniukų;1629377078;Taip;0;3;0;3
14507;Viltenė;Geniukų;3746923185;Taip;0;6;0;6
14508;Viltenė;Geniukų;1557503831;Taip;6;4;0;10
14509;Viltenė;Saulutės;2044754943;Taip;0;1;0;1
14510;Viltenė;Saulutės;6848403057;Taip;0;4;0;4
14511;Viltenė;Saulutės;1615415742;Taip;0;3;0;3
14512;Viltenė;Saulutės;7994367286;Taip;8;0;0;8
14513;Viltenė;Saulutės;9935236068;Taip;0;3;0;3
14514;Viltenė;Saulutės;6664059418;Taip;5;4;0;9
14515;Viltenė;Saulutės;2141002432;Taip;0;9;0;9
14516;Viltenė;Saulutės;1362308882;Taip;3;2;0;5
14517;Viltenė;Saulutės;8920533673;Taip;6;5;0;11
14518;Viltenė;Saulutės;5024192785;Taip;0;6;0;6
14519;Viltenė;Saulutės;1918867591;Taip;0;8;0;8
14520;Viltenė;Saulutės;7559243300;Taip;23;0;0;23
14521;Viltenė;Saulutės;8512665706;Taip;7;3;0;10
14522;Viltenė;Saulutės;3560474943;Taip;0;6;0;6
14523;Viltenė;Saulutės;2840208662;Taip;12;1;0;13
14524;Viltenė;Saulutės;1252657362;Taip;7;2;0;9
14525;Viltenė;Saulutės;2559945034;Taip;0;4;0;4
14526;Viltenė;Saulutės;9055821628;Taip;0;5;0;5
14527;Viltenė;Saulutės;9858998005;Taip;0;5;0;5
14528;Viltenė;Saulutės;7726650894;Taip;3;6;0;9
14529;Viltenė;Saulutės;3709362712;Taip;0;3;0;3
14530;Viltenė;Saulutės;1841732416;Taip;0;2;0;2
14531;Viltenė;Lapiukų;2034259692;Taip;0;4;0;4
14532;Viltenė;Lapiukų;3473533533;Taip;0;3;0;3
14533;Viltenė;Lapiukų;8696698257;Taip;0;3;0;3
14534;Viltenė;Lapiukų;8248514570;Taip;0;3;0;3
14535;Viltenė;Lapiukų;2878124826;Taip;13;3;0;16
14536;Viltenė;Lapiukų;2660622296;Taip;10;3;0;13
14537;Viltenė;Lapiukų;4550915388;Taip;13;3;0;16
14538;Viltenė;Lapiukų;8122878153;Taip;10;3;0;13
14539;Viltenė;Lapiukų;9573891616;Taip;0;6;0;6
14540;Viltenė;Lapiukų;4243501722;Taip;0;3;0;3
14541;Viltenė;Lapiukų;5818645490;Taip;0;1;0;1
14542;Viltenė;Lapiukų;6429905246;Taip;0;7;0;7
14543;Viltenė;Lapiukų;6070264006;Taip;5;2;0;7
14544;Viltenė;Lapiukų;8187712849;Taip;0;5;0;5
14545;Viltenė;Lapiukų;3679704404;Taip;0;3;0;3
14546;Viltenė;Lapiukų;1507287948;Taip;0;4;0;4
14547;Viltenė;Lapiukų;9846205631;Taip;0;6;0;6
14548;Viltenė;Lapiukų;9063994291;Taip;0;2;0;2
14549;Viltenė;Voveriukai;6888346135;Taip;0;12;0;12
14550;Viltenė;Voveriukai;2936670828;Ne;0;4;0;4
14551;Viltenė;Voveriukai;5816623708;Taip;8;4;6;18
14552;Viltenė;Voveriukai;5611839058;Taip;0;4;0;4
14553;Viltenė;Voveriukai;4414192600;Taip;0;4;6;10
14554;Viltenė;Voveriukai;2483760198;Ne;0;3;0;3
14555;Viltenė;Voveriukai;8341211836;Taip;0;3;2;5
14556;Viltenė;Voveriukai;6954065006;Taip;0;3;2;5
14557;Viltenė;Voveriukai;6741521720;Taip;0;10;0;10
14558;Viltenė;Voveriukai;2642080849;Taip;0;4;6;10
14559;Viltenė;Voveriukai;6040634853;Taip;0;2;1;3
14560;Viltenė;Voveriukai;7322841332;Taip;8;3;0;11
14561;Viltenė;Voveriukai;1888167096;Taip;0;4;0;4
14562;Viltenė;Voveriukai;3291926243;Taip;0;8;0;8
14563;Viltenė;Voveriukai;2013415571;Taip;0;4;0;4
14564;Viltenė;Voveriukai;2894570917;Taip;0;2;0;2
14565;Viltenė;Voveriukai;1890096287;Taip;0;3;0;3
14566;Viltenė;Kiškučiai;6595715908;Taip;0;3;0;3
14567;Viltenė;Kiškučiai;3347380524;Taip;2;4;0;6
14568;Viltenė;Kiškučiai;1641406030;Taip;0;2;0;2
14569;Viltenė;Kiškučiai;2192673126;Taip;10;2;0;12
14570;Viltenė;Kiškučiai;3157417614;Taip;6;3;0;9
14571;Viltenė;Kiškučiai;5974408492;Taip;0;2;0;2
14572;Viltenė;Kiškučiai;9578037239;Taip;10;1;0;11
14573;Viltenė;Kiškučiai;4615393852;Taip;0;4;0;4
14574;Viltenė;Kiškučiai;2903596382;Taip;5;3;0;8
14575;Viltenė;Kiškučiai;7314937470;Taip;0;1;0;1
14576;Viltenė;Kiškučiai;8150583354;Ne;10;1;0;11
14577;Viltenė;Kiškučiai;9760364123;Taip;2;0;0;2
14578;Viltenė;Kiškučiai;6021086235;Taip;8;3;0;11
14579;Viltenė;Kiškučiai;1760899500;Taip;0;1;0;1
14580;Viltenė;Nykštukų;7993258845;Ne;0;1;0;1
14581;Viltenė;Nykštukų;4981225829;Taip;0;8;0;8
14582;Viltenė;Nykštukų;9424773418;Taip;0;1;0;1
14583;Viltenė;Nykštukų;3343045604;Taip;0;1;0;1
14584;Viltenė;Nykštukų;4537287677;Taip;2;1;0;3
14585;Viltenė;Nykštukų;3306285115;Taip;0;3;0;3
14586;Viltenė;Nykštukų;6992120038;Taip;0;4;0;4
14587;Viltenė;Nykštukų;7331321780;Taip;14;0;0;14
14588;Viltenė;Nykštukų;8958374098;Taip;0;2;1;3
14589;Viltenė;Nykštukų;5707049797;Taip;0;2;2;4
14590;Viltenė;Nykštukų;8950410446;Taip;0;3;2;5
14591;Viltenė;Nykštukų;2036857372;Taip;0;3;2;5
14592;Viltenė;Nykštukų;3853518656;Taip;0;4;0;4
14593;Viltenė;Nykštukų;8588903828;Taip;0;3;0;3
14594;Viltenė;Nykštukų;9288406881;Taip;6;0;0;6
14595;Viltenė;Nykštukų;7370710652;Taip;0;8;0;8
14596;Viltenė;Nykštukų;9582577013;Taip;5;1;0;6
14597;Viltenė;Triušiukai;8346933997;Taip;0;2;0;2
14598;Viltenė;Triušiukai;8278572246;Taip;0;2;0;2
14599;Viltenė;Triušiukai;1587868835;Taip;3;3;0;6
14600;Viltenė;Triušiukai;9819729046;Taip;0;10;0;10
14601;Viltenė;Triušiukai;8258247750;Taip;7;4;0;11
14602;Viltenė;Triušiukai;6635474168;Taip;21;0;0;21
14603;Viltenė;Triušiukai;7754951374;Taip;3;6;0;9
14604;Viltenė;Triušiukai;7145240197;Taip;5;1;0;6
14605;Viltenė;Triušiukai;7058586628;Taip;18;0;0;18
14606;Viltenė;Triušiukai;7005219570;Taip;6;0;0;6
14607;Viltenė;Triušiukai;4552355700;Taip;0;3;1;4
14608;Viltenė;Triušiukai;2850146424;Taip;0;12;0;12
14609;Viltenė;Triušiukai;1318750938;Taip;0;2;0;2
14610;Viltenė;Triušiukai;1788524515;Taip;0;6;0;6
14611;Voveraitė;ŽVIRBLIUKŲ;6684234832;Taip;0;10;5;15
14612;Voveraitė;ŽVIRBLIUKŲ;8119493388;Taip;0;2;1;3
14613;Voveraitė;ŽVIRBLIUKŲ;9715405072;Taip;3;3;0;6
14614;Voveraitė;ŽVIRBLIUKŲ;5804351872;Taip;0;0;6;6
14615;Voveraitė;ŽVIRBLIUKŲ;8925151080;Taip;0;2;1;3
14616;Voveraitė;ŽVIRBLIUKŲ;5510544648;Taip;0;0;4;4
14617;Voveraitė;ŽVIRBLIUKŲ;6959751328;Taip;0;3;3;6
14618;Voveraitė;ŽVIRBLIUKŲ;8803052781;Taip;0;2;3;5
14619;Voveraitė;ŽVIRBLIUKŲ;8257748589;Taip;0;0;4;4
14620;Voveraitė;ŽVIRBLIUKŲ;1522307865;Taip;0;0;4;4
14621;Voveraitė;ŽVIRBLIUKŲ;3811230983;Taip;3;3;11;17
14622;Voveraitė;ŽVIRBLIUKŲ;2142507659;Taip;0;0;3;3
14623;Voveraitė;ŽVIRBLIUKŲ;5395915359;Taip;7;0;1;8
14624;Voveraitė;ŽVIRBLIUKŲ;3247101840;Taip;0;0;11;11
14625;Voveraitė;ŽVIRBLIUKŲ;6643600680;Taip;3;0;4;7
14626;Voveraitė;ŽVIRBLIUKŲ;4460047281;Taip;0;0;6;6
14627;Voveraitė;ŽVIRBLIUKŲ;3877673172;Taip;9;0;4;13
14628;Voveraitė;ŽVIRBLIUKŲ;7008576999;Taip;0;3;0;3
14629;Voveraitė;ŽVIRBLIUKŲ;2716400502;Taip;0;3;0;3
14630;Voveraitė;ŽVIRBLIUKŲ;9117809080;Taip;0;3;1;4
14631;Voveraitė;ŽVIRBLIUKŲ;7861722125;Taip;10;0;7;17
14632;Voveraitė;ŽVIRBLIUKŲ;6994680282;Taip;0;3;0;3
14633;Voveraitė;VOVERIUKŲ;1515087924;Taip;5;2;0;7
14634;Voveraitė;VOVERIUKŲ;9195700962;Taip;18;0;0;18
14635;Voveraitė;VOVERIUKŲ;5138855000;Taip;5;3;0;8
14636;Voveraitė;VOVERIUKŲ;1340379090;Taip;14;1;0;15
14637;Voveraitė;VOVERIUKŲ;9912862474;Taip;0;5;0;5
14638;Voveraitė;VOVERIUKŲ;1960385335;Taip;10;1;0;11
14639;Voveraitė;VOVERIUKŲ;2594535017;Taip;0;4;0;4
14640;Voveraitė;VOVERIUKŲ;4563198733;Taip;0;9;0;9
14641;Voveraitė;VOVERIUKŲ;8373093305;Taip;0;2;0;2
14642;Voveraitė;VOVERIUKŲ;9514425475;Taip;0;3;0;3
14643;Voveraitė;VOVERIUKŲ;6017698476;Taip;0;3;0;3
14644;Voveraitė;VOVERIUKŲ;6891841301;Taip;2;5;0;7
14645;Voveraitė;VOVERIUKŲ;5935777154;Taip;4;0;0;4
14646;Voveraitė;VOVERIUKŲ;6007396459;Taip;0;5;0;5
14647;Voveraitė;VOVERIUKŲ;4054841724;Taip;14;0;0;14
14648;Voveraitė;VOVERIUKŲ;2304604061;Taip;15;1;0;16
14649;Voveraitė;VOVERIUKŲ;5956830012;Taip;1;3;0;4
14650;Voveraitė;VOVERIUKŲ;8344323109;Taip;10;3;0;13
14651;Voveraitė;VOVERIUKŲ;1141304286;Taip;3;3;0;6
14652;Voveraitė;VOVERIUKŲ;1663784931;Taip;1;3;0;4
14653;Voveraitė;VOVERIUKŲ;3276295199;Taip;7;3;0;10
14654;Voveraitė;VOVERIUKŲ;7744504020;Taip;0;3;0;3
14655;Voveraitė;KIŠKUČIŲ;9537862791;Taip;0;2;0;2
14656;Voveraitė;KIŠKUČIŲ;4478984171;Taip;6;0;0;6
14657;Voveraitė;KIŠKUČIŲ;3736638759;Taip;0;3;0;3
14658;Voveraitė;KIŠKUČIŲ;9011096222;Taip;18;0;0;18
14659;Voveraitė;KIŠKUČIŲ;3058377539;Taip;0;3;0;3
14660;Voveraitė;KIŠKUČIŲ;8507818993;Taip;5;1;0;6
14661;Voveraitė;KIŠKUČIŲ;8746008166;Taip;0;2;0;2
14662;Voveraitė;KIŠKUČIŲ;8084986328;Taip;0;3;0;3
14663;Voveraitė;KIŠKUČIŲ;6261152304;Taip;0;3;0;3
14664;Voveraitė;KIŠKUČIŲ;8220437514;Taip;0;3;0;3
14665;Voveraitė;KIŠKUČIŲ;4060906360;Taip;0;4;0;4
14666;Voveraitė;KIŠKUČIŲ;5069929376;Taip;8;0;0;8
14667;Voveraitė;KIŠKUČIŲ;7379045686;Taip;8;3;0;11
14668;Voveraitė;KIŠKUČIŲ;1961699588;Taip;11;3;0;14
14669;Voveraitė;KIŠKUČIŲ;1979839656;Taip;3;0;0;3
14670;Voveraitė;KIŠKUČIŲ;9599137158;Taip;14;1;0;15
14671;Voveraitė;KIŠKUČIŲ;8121423914;Taip;8;4;0;12
14672;Voveraitė;KIŠKUČIŲ;4379372200;Taip;4;4;0;8
14673;Voveraitė;KIŠKUČIŲ;1322927329;Taip;4;1;0;5
14674;Voveraitė;KIŠKUČIŲ;8528435385;Taip;7;3;0;10
14675;Voveraitė;KIŠKUČIŲ;8937070276;Taip;12;0;0;12
14676;Voveraitė;KIŠKUČIŲ;3859125174;Taip;12;0;0;12
14677;Voveraitė;KODĖLČIUKŲ;7868415893;Taip;0;1;0;1
14678;Voveraitė;KODĖLČIUKŲ;3274422598;Taip;0;1;0;1
14679;Voveraitė;KODĖLČIUKŲ;8438808999;Taip;1;1;2;4
14680;Voveraitė;KODĖLČIUKŲ;8818603905;Taip;18;0;0;18
14681;Voveraitė;KODĖLČIUKŲ;9397887760;Taip;0;4;0;4
14682;Voveraitė;KODĖLČIUKŲ;4151144278;Taip;5;0;0;5
14683;Voveraitė;KODĖLČIUKŲ;5598685365;Taip;5;11;0;16
14684;Voveraitė;KODĖLČIUKŲ;1482908802;Taip;9;0;1;10
14685;Voveraitė;KODĖLČIUKŲ;3384268786;Taip;0;3;0;3
14686;Voveraitė;KODĖLČIUKŲ;9887747925;Taip;0;4;0;4
14687;Voveraitė;KODĖLČIUKŲ;7605427741;Taip;0;6;0;6
14688;Voveraitė;KODĖLČIUKŲ;3344886524;Taip;8;0;3;11
14689;Voveraitė;KODĖLČIUKŲ;1046297151;Taip;14;0;0;14
14690;Voveraitė;KODĖLČIUKŲ;4996778855;Taip;14;0;0;14
14691;Voveraitė;KODĖLČIUKŲ;3432886020;Taip;5;2;3;10
14692;Voveraitė;KODĖLČIUKŲ;8154347030;Taip;0;4;0;4
14693;Voveraitė;KODĖLČIUKŲ;2482908027;Taip;0;11;0;11
14694;Voveraitė;KODĖLČIUKŲ;8692155848;Taip;0;0;4;4
14695;Voveraitė;KODĖLČIUKŲ;1040007977;Taip;1;6;0;7
14696;Voveraitė;KODĖLČIUKŲ;3881039538;Taip;7;1;0;8
14697;Voveraitė;KODĖLČIUKŲ;7281753415;Taip;6;1;0;7
14698;Voveraitė;KODĖLČIUKŲ;8021563060;Taip;0;4;4;8
14699;Voveraitė;KODĖLČIUKŲ;9816971493;Taip;0;1;7;8
14700;Voveraitė;MEŠKIUKŲ;8881070477;Taip;7;0;0;7
14701;Voveraitė;MEŠKIUKŲ;7253112849;Taip;8;2;0;10
14702;Voveraitė;MEŠKIUKŲ;7499150201;Taip;7;0;0;7
14703;Voveraitė;MEŠKIUKŲ;3217609712;Taip;6;6;0;12
14704;Voveraitė;MEŠKIUKŲ;3088866739;Taip;5;3;0;8
14705;Voveraitė;MEŠKIUKŲ;4207949414;Taip;0;1;0;1
14706;Voveraitė;MEŠKIUKŲ;4547087565;Taip;0;3;0;3
14707;Voveraitė;MEŠKIUKŲ;7474214701;Taip;5;6;0;11
14708;Voveraitė;MEŠKIUKŲ;9729735431;Taip;0;2;0;2
14709;Voveraitė;MEŠKIUKŲ;6853358062;Taip;5;0;0;5
14710;Voveraitė;MEŠKIUKŲ;3539069705;Taip;0;8;0;8
14711;Voveraitė;MEŠKIUKŲ;9544043839;Taip;0;5;0;5
14712;Voveraitė;MEŠKIUKŲ;6609235703;Taip;4;5;0;9
14713;Voveraitė;MEŠKIUKŲ;1528968162;Taip;7;1;0;8
14714;Voveraitė;MEŠKIUKŲ;3159659638;Taip;0;4;0;4
14715;Voveraitė;MEŠKIUKŲ;3532178114;Taip;0;4;0;4
14716;Voveraitė;MEŠKIUKŲ;5196036817;Taip;0;4;0;4
14717;Voveraitė;MEŠKIUKŲ;1813440087;Taip;0;4;0;4
14718;Voveraitė;MEŠKIUKŲ;8534405352;Taip;12;0;0;12
14719;Voveraitė;MEŠKIUKŲ;5018335921;Taip;8;0;0;8
14720;Voveraitė;BORUŽĖLIŲ;3703062195;Taip;1;3;0;4
14721;Voveraitė;BORUŽĖLIŲ;3381417855;Taip;0;3;0;3
14722;Voveraitė;BORUŽĖLIŲ;5437283673;Taip;0;3;0;3
14723;Voveraitė;BORUŽĖLIŲ;3029983180;Taip;0;9;0;9
14724;Voveraitė;BORUŽĖLIŲ;5576058454;Taip;6;3;0;9
14725;Voveraitė;BORUŽĖLIŲ;7797966139;Taip;5;3;0;8
14726;Voveraitė;BORUŽĖLIŲ;4079618555;Taip;0;5;0;5
14727;Voveraitė;BORUŽĖLIŲ;6886337758;Taip;0;12;0;12
14728;Voveraitė;BORUŽĖLIŲ;3987058753;Taip;0;3;0;3
14729;Voveraitė;BORUŽĖLIŲ;1592633500;Taip;0;4;0;4
14730;Voveraitė;BORUŽĖLIŲ;1629942114;Taip;3;7;1;11
14731;Voveraitė;BORUŽĖLIŲ;1058273156;Taip;1;3;1;5
14732;Voveraitė;BORUŽĖLIŲ;3113780055;Taip;0;2;0;2
14733;Voveraitė;BORUŽĖLIŲ;9933037872;Ne;0;5;0;5
14734;Voveraitė;BORUŽĖLIŲ;3615729576;Taip;0;3;0;3
14735;Voveraitė;BORUŽĖLIŲ;65926130735;Taip;0;3;0;3
14736;Voveraitė;BORUŽĖLIŲ;6277010268;Taip;5;3;0;8
14737;Voveraitė;BORUŽĖLIŲ;2831224400;Taip;0;3;5;8
14738;Voveraitė;BORUŽĖLIŲ;2763656717;Taip;0;3;11;14
14739;Voveraitė;PELĖDŽIUKŲ;9491132884;Taip;3;2;0;5
14740;Voveraitė;PELĖDŽIUKŲ;1775800865;Taip;0;4;0;4
14741;Voveraitė;PELĖDŽIUKŲ;1959958256;Ne;0;3;7;10
14742;Voveraitė;PELĖDŽIUKŲ;6649068571;Taip;0;3;0;3
14743;Voveraitė;PELĖDŽIUKŲ;9231751171;Taip;0;4;0;4
14744;Voveraitė;PELĖDŽIUKŲ;54408671673;Taip;8;3;0;11
14745;Voveraitė;PELĖDŽIUKŲ;72154318379;Taip;5;3;0;8
14746;Voveraitė;PELĖDŽIUKŲ;9007031372;Taip;5;3;0;8
14747;Voveraitė;PELĖDŽIUKŲ;7069780513;Taip;0;3;0;3
14748;Voveraitė;PELĖDŽIUKŲ;6369860178;Taip;0;2;0;2
14749;Voveraitė;PELĖDŽIUKŲ;6433760749;Taip;0;5;0;5
14750;Voveraitė;PELĖDŽIUKŲ;6460834118;Taip;0;3;6;9
14751;Voveraitė;PELĖDŽIUKŲ;4338861332;Taip;3;4;0;7
14752;Voveraitė;PELĖDŽIUKŲ;7314148938;Taip;0;3;0;3
14753;Voveraitė;PELĖDŽIUKŲ;4511771924;Taip;0;3;0;3
14754;Voveraitė;PELĖDŽIUKŲ;602726070;Taip;5;3;0;8
14755;Voveraitė;PELĖDŽIUKŲ;4163635632;Taip;0;4;5;9
14756;Voveraitė;PELĖDŽIUKŲ;1397274691;Taip;0;4;0;4
14757;Voveraitė;DRUGELIŲ;1441921029;Taip;0;3;0;3
14758;Voveraitė;DRUGELIŲ;7531020548;Taip;5;4;0;9
14759;Voveraitė;DRUGELIŲ;4300235743;Taip;17;0;0;17
14760;Voveraitė;DRUGELIŲ;1510853268;Taip;0;2;0;2
14761;Voveraitė;DRUGELIŲ;3388547792;Taip;0;2;0;2
14762;Voveraitė;DRUGELIŲ;8719547570;Taip;5;2;2;9
14763;Voveraitė;DRUGELIŲ;3475601049;Taip;0;0;3;3
14764;Voveraitė;DRUGELIŲ;4017408873;Taip;0;0;3;3
14765;Voveraitė;DRUGELIŲ;7533728486;Taip;0;8;0;8
14766;Voveraitė;DRUGELIŲ;1550830434;Taip;0;7;0;7
14767;Voveraitė;DRUGELIŲ;5114768009;Taip;0;6;0;6
14768;Voveraitė;DRUGELIŲ;1045204378;Taip;0;2;0;2
14769;Voveraitė;DRUGELIŲ;4605007814;Taip;0;0;1;1
14770;Voveraitė;DRUGELIŲ;4911291891;Taip;0;10;1;11
14771;Voveraitė;DRUGELIŲ;4782336282;Taip;0;4;0;4
14772;Voveraitė;DRUGELIŲ;6415024059;Taip;10;2;1;13
14773;Voveraitė;DRUGELIŲ;4350450125;Taip;5;5;0;10
14774;Voveraitė;DRUGELIŲ;8913940646;Taip;0;2;12;14
14775;Voveraitė;DRUGELIŲ;1201270622;Taip;0;2;12;14
14776;Voveraitė;DRUGELIŲ;7238482039;Taip;12;0;0;12
14777;Voveraitė;DRUGELIŲ;5605614222;Taip;0;0;3;3
14778;Voveraitė;NYKŠTUKŲ;6579193196;Taip;0;0;3;3
14779;Voveraitė;NYKŠTUKŲ;8940421826;Taip;0;3;0;3
14780;Voveraitė;NYKŠTUKŲ;9332936763;Taip;8;0;2;10
14781;Voveraitė;NYKŠTUKŲ;6206817227;Taip;0;0;6;6
14782;Voveraitė;NYKŠTUKŲ;8206634977;Taip;8;0;0;8
14783;Voveraitė;NYKŠTUKŲ;3068683904;Taip;5;0;6;11
14784;Voveraitė;NYKŠTUKŲ;3600230896;Taip;0;0;3;3
14785;Voveraitė;NYKŠTUKŲ;1294012085;Ne;0;6;0;6
14786;Voveraitė;NYKŠTUKŲ;9363490578;Taip;5;4;0;9
14787;Voveraitė;NYKŠTUKŲ;8217771158;Taip;5;10;0;15
14788;Voveraitė;NYKŠTUKŲ;3409709168;Taip;0;3;0;3
14789;Voveraitė;NYKŠTUKŲ;1045121363;Taip;3;0;1;4
14790;Voveraitė;NYKŠTUKŲ;4319786615;Taip;1;2;1;4
14791;Voveraitė;NYKŠTUKŲ;4430631207;Ne;0;2;1;3
14792;Voveraitė;NYKŠTUKŲ;6092848276;Taip;8;0;1;9
14793;Voveraitė;NYKŠTUKŲ;4533816630;Taip;8;0;0;8
14794;Voveraitė;NYKŠTUKŲ;1237440400;Ne;0;2;1;3
14795;Voveraitė;NYKŠTUKŲ;8664568879;Taip;0;4;0;4
14796;Voveraitė;NYKŠTUKŲ;3261542931;Taip;5;3;2;10
14797;Voveraitė;GENIUKŲ;5467979968;Taip;9;3;0;12
14798;Voveraitė;GENIUKŲ;5296850349;Taip;0;3;11;14
14799;Voveraitė;GENIUKŲ;51213803814;Taip;3;4;0;7
14800;Voveraitė;GENIUKŲ;2304004487;Taip;0;3;0;3
14801;Voveraitė;GENIUKŲ;36749754999;Taip;0;5;0;5
14802;Voveraitė;GENIUKŲ;6819742525;Taip;0;10;0;10
14803;Voveraitė;GENIUKŲ;46205148458;Taip;0;3;0;3
14804;Voveraitė;GENIUKŲ;4468214107;Taip;5;3;0;8
14805;Voveraitė;GENIUKŲ;9921313716;Taip;0;7;0;7
14806;Voveraitė;GENIUKŲ;9431523085;Taip;0;5;0;5
14807;Voveraitė;GENIUKŲ;4045121781;Taip;0;8;0;8
14808;Voveraitė;GENIUKŲ;7786378018;Taip;0;4;0;4
14809;Voveraitė;GENIUKŲ;5449490074;Taip;0;5;1;6
14810;Voveraitė;GENIUKŲ;6361417566;Taip;10;3;0;13
14811;Voveraitė;GENIUKŲ;6690309946;Taip;0;4;0;4
14812;Voveraitė;GENIUKŲ;6653141009;Taip;0;3;0;3
14813;Voveraitė;GENIUKŲ;2208396431;Taip;0;6;0;6
14814;Voveraitė;GENIUKŲ;1772758517;Taip;9;3;0;12
14815;Voveraitė;LAPIUKŲ;5104290434;Taip;4;3;2;9
14816;Voveraitė;LAPIUKŲ;8405238812;Taip;6;0;2;8
14817;Voveraitė;LAPIUKŲ;2552772063;Ne;7;0;0;7
14818;Voveraitė;LAPIUKŲ;8152541593;Taip;6;0;1;7
14819;Voveraitė;LAPIUKŲ;4891757467;Taip;0;0;8;8
14820;Voveraitė;LAPIUKŲ;9218074631;Taip;8;0;1;9
14821;Voveraitė;LAPIUKŲ;1921260351;Taip;9;0;0;9
14822;Voveraitė;LAPIUKŲ;3452040361;Taip;6;4;0;10
14823;Voveraitė;LAPIUKŲ;8382950248;Taip;0;3;5;8
14824;Voveraitė;LAPIUKŲ;8695525951;Taip;6;3;0;9
14825;Voveraitė;LAPIUKŲ;6443288864;Taip;4;0;2;6
14826;Voveraitė;LAPIUKŲ;6650343917;Taip;5;5;0;10
14827;Voveraitė;LAPIUKŲ;8451803815;Taip;0;3;3;6
14828;Voveraitė;EŽIUKŲ;5420123208;Taip;0;0;3;3
14829;Voveraitė;EŽIUKŲ;7969862374;Taip;0;3;3;6
14830;Voveraitė;EŽIUKŲ;1692829228;Taip;7;0;0;7
14831;Voveraitė;EŽIUKŲ;4233627593;Taip;0;0;5;5
14832;Voveraitė;EŽIUKŲ;2446269570;Taip;0;3;0;3
14833;Voveraitė;EŽIUKŲ;2761041681;Taip;4;0;3;7
14834;Voveraitė;EŽIUKŲ;8074808131;Taip;13;0;0;13
14835;Voveraitė;EŽIUKŲ;8675606844;Taip;0;2;0;2
14836;Voveraitė;EŽIUKŲ;8229145014;Ne;11;0;3;14
14837;Voveraitė;EŽIUKŲ;3168493145;Taip;0;0;5;5
14838;Voveraitė;EŽIUKŲ;2118244290;Taip;0;0;1;1
14839;Voveraitė;EŽIUKŲ;3971484538;Taip;8;0;2;10
14840;Voveraitė;EŽIUKŲ;1542869765;Taip;0;0;3;3
14841;Voveraitė;EŽIUKŲ;2755043670;Taip;0;6;3;9
14842;Voveraitė;EŽIUKŲ;3408126903;Taip;6;1;2;9
14843;Voveraitė;EŽIUKŲ;8627692360;Taip;1;0;1;2
14844;"Trakų Vokė";Voveriukų;1252962923;Taip;4;3;0;7
14845;"Trakų Vokė";Voveriukų;6076083379;Taip;3;3;0;6
14846;"Trakų Vokė";Voveriukų;7656305410;Taip;10;0;4;14
14847;"Trakų Vokė";Voveriukų;5626732539;Taip;0;3;0;3
14848;"Trakų Vokė";Voveriukų;2163756512;Taip;11;0;0;11
14849;"Trakų Vokė";Voveriukų;7706665420;Taip;8;3;0;11
14850;"Trakų Vokė";Voveriukų;7346128036;Taip;8;2;1;11
14851;"Trakų Vokė";Voveriukų;2318712376;Taip;0;0;3;3
14852;"Trakų Vokė";Voveriukų;2812442474;Taip;1;0;0;1
14853;"Trakų Vokė";Voveriukų;7671121106;Taip;0;3;6;9
14854;"Trakų Vokė";Voveriukų;9140597911;Taip;7;0;2;9
14855;"Trakų Vokė";Voveriukų;5741852704;Taip;14;0;0;14
14856;"Trakų Vokė";Voveriukų;8636196544;Taip;0;3;3;6
14857;"Trakų Vokė";Voveriukų;1157451579;Taip;18;0;0;18
14858;"Trakų Vokė";Voveriukų;4516714702;Taip;6;0;3;9
14859;"Trakų Vokė";Voveriukų;7797516793;Taip;7;3;0;10
14860;"Trakų Vokė";Voveriukų;3445611475;Taip;0;0;11;11
14861;"Trakų Vokė";Boružėlių;3319243283;Taip;0;0;2;2
14862;"Trakų Vokė";Boružėlių;1039690987;Taip;0;3;0;3
14863;"Trakų Vokė";Boružėlių;2516219363;Taip;0;0;1;1
14864;"Trakų Vokė";Boružėlių;7858812338;Taip;0;0;2;2
14865;"Trakų Vokė";Boružėlių;1088928094;Taip;0;0;3;3
14866;"Trakų Vokė";Boružėlių;6908913934;Taip;0;0;3;3
14867;"Trakų Vokė";Boružėlių;7909596435;Taip;0;4;0;4
14868;"Trakų Vokė";Boružėlių;6751625456;Taip;4;0;1;5
14869;"Trakų Vokė";Boružėlių;7752786907;Taip;10;0;1;11
14870;"Trakų Vokė";Boružėlių;2475068032;Ne;0;0;6;6
14871;"Trakų Vokė";Boružėlių;4601374629;Ne;11;3;0;14
14872;"Trakų Vokė";Boružėlių;4438127190;Ne;0;0;5;5
14873;"Trakų Vokė";Boružėlių;2388817616;Taip;6;0;0;6
14874;"Trakų Vokė";Boružėlių;9453317084;Taip;0;0;3;3
14875;"Trakų Vokė";Boružėlių;1080300137;Taip;0;3;0;3
14876;"Trakų Vokė";Boružėlių;2469340933;Taip;0;0;2;2
14877;"Trakų Vokė";Boružėlių;7318458282;Taip;0;3;1;4
14878;"Trakų Vokė";Boružėlių;3209594216;Ne;0;0;2;2
14879;"Trakų Vokė";Boružėlių;6732422645;Taip;0;3;2;5
14880;"Trakų Vokė";Boružėlių;5338798362;Taip;8;0;2;10
14881;"Trakų Vokė";Boružėlių;3913623741;Taip;0;0;6;6
14882;"Trakų Vokė";Boružėlių;4014027030;Taip;0;0;3;3
14883;"Trakų Vokė";Boružėlių;7660240598;Taip;0;10;0;10
14884;"Trakų Vokė";KIŠKUČIŲ;9094930495;Taip;7;0;0;7
14885;"Trakų Vokė";KIŠKUČIŲ;9483709021;Taip;0;0;3;3
14886;"Trakų Vokė";KIŠKUČIŲ;2503382218;Taip;3;0;0;3
14887;"Trakų Vokė";KIŠKUČIŲ;8605461082;Taip;0;3;3;6
14888;"Trakų Vokė";KIŠKUČIŲ;6369848950;Taip;3;0;6;9
14889;"Trakų Vokė";KIŠKUČIŲ;4854440884;Taip;12;0;0;12
14890;"Trakų Vokė";KIŠKUČIŲ;2761614687;Taip;8;0;0;8
14891;"Trakų Vokė";KIŠKUČIŲ;9233090228;Taip;0;0;6;6
14892;"Trakų Vokė";KIŠKUČIŲ;6277305384;Taip;0;0;4;4
14893;"Trakų Vokė";KIŠKUČIŲ;2880299812;Taip;4;0;0;4
14894;"Trakų Vokė";KIŠKUČIŲ;1360046096;Taip;5;6;0;11
14895;"Trakų Vokė";KIŠKUČIŲ;3611639112;Taip;4;3;1;8
14896;"Trakų Vokė";KIŠKUČIŲ;3328527700;Taip;11;0;1;12
14897;"Trakų Vokė";KIŠKUČIŲ;5206616285;Taip;5;3;0;8
14898;"Trakų Vokė";KIŠKUČIŲ;2869217654;Taip;0;3;0;3
14899;"Trakų Vokė";KIŠKUČIŲ;4535167417;Taip;0;7;0;7
14900;"Trakų Vokė";KIŠKUČIŲ;2539647111;Taip;9;0;0;9
14901;"Trakų Vokė";KIŠKUČIŲ;6326568445;Taip;0;4;1;5
14902;"Trakų Vokė";KIŠKUČIŲ;3278842582;Ne;1;0;2;3
14903;"Trakų Vokė";KIŠKUČIŲ;8874384610;Taip;13;3;1;17
14904;"Trakų Vokė";KIŠKUČIŲ;2453791555;Taip;6;0;2;8
14905;"Trakų Vokė";KIŠKUČIŲ;9506008651;Taip;9;0;0;9
14906;"Trakų Vokė";BITUČIŲ;7632198751;Taip;0;0;3;3
14907;"Trakų Vokė";BITUČIŲ;3686108421;Taip;0;0;1;1
14908;"Trakų Vokė";BITUČIŲ;3333979364;Taip;0;4;0;4
14909;"Trakų Vokė";BITUČIŲ;5810595458;Taip;0;5;0;5
14910;"Trakų Vokė";BITUČIŲ;8783922678;Taip;15;3;0;18
14911;"Trakų Vokė";BITUČIŲ;5031669549;Taip;4;0;4;8
14912;"Trakų Vokė";BITUČIŲ;8703806519;Taip;0;3;15;18
14913;"Trakų Vokė";BITUČIŲ;4531294784;Taip;0;0;5;5
14914;"Trakų Vokė";BITUČIŲ;2133793458;Taip;0;0;2;2
14915;"Trakų Vokė";BITUČIŲ;5720994041;Taip;3;0;2;5
14916;"Trakų Vokė";BITUČIŲ;6428645462;Taip;0;0;1;1
14917;"Trakų Vokė";BITUČIŲ;7459132887;Taip;0;0;4;4
14918;"Trakų Vokė";BITUČIŲ;1808420447;Taip;0;1;0;1
14919;"Trakų Vokė";BITUČIŲ;6402002961;Taip;7;3;1;11
14920;"Trakų Vokė";BITUČIŲ;3536227018;Taip;3;0;1;4
14921;"Trakų Vokė";BITUČIŲ;6787506848;Taip;7;0;0;7
14922;"Trakų Vokė";BITUČIŲ;3372734352;Taip;3;0;1;4
14923;"Trakų Vokė";BITUČIŲ;1000323267;Taip;0;0;2;2
14924;"Trakų Vokė";BITUČIŲ;1359519176;Taip;5;3;0;8
14925;"Trakų Vokė";BITUČIŲ;1039317931;Taip;5;0;7;12
14926;Zylutė;Katerok;8749296671;Taip;6;3;0;9
14927;Zylutė;Katerok;4592825972;Taip;0;7;0;7
14928;Zylutė;Katerok;8747721198;Taip;8;1;0;9
14929;Zylutė;Katerok;8212030518;Taip;0;7;0;7
14930;Zylutė;Katerok;7706833089;Taip;5;7;0;12
14931;Zylutė;Katerok;3115223229;Taip;0;0;12;12
14932;Zylutė;Katerok;2968625045;Taip;5;0;1;6
14933;Zylutė;Katerok;1897871944;Taip;0;4;0;4
14934;Zylutė;Katerok;5687201052;Taip;0;3;0;3
14935;Zylutė;Katerok;3055559237;Taip;6;1;0;7
14936;Zylutė;Katerok;2792217953;Taip;0;5;0;5
14937;Zylutė;Katerok;5948147748;Taip;0;1;4;5
14938;Zylutė;Katerok;7851423851;Taip;8;4;0;12
14939;Zylutė;Katerok;2945894661;Taip;0;0;3;3
14940;Zylutė;Katerok;9986289837;Taip;0;3;0;3
14941;Zylutė;Katerok;1164530815;Taip;6;0;0;6
14942;Zylutė;Katerok;1423890598;Taip;8;0;1;9
14943;Zylutė;Katerok;2558354198;Taip;5;3;0;8
14944;Zylutė;Katerok;8618778936;Taip;5;1;0;6
14945;Zylutė;"Vesole misiaki";3332865242;Taip;0;11;0;11
14946;Zylutė;"Vesole misiaki";9162232979;Taip;8;0;0;8
14947;Zylutė;"Vesole misiaki";4715704693;Taip;2;3;0;5
14948;Zylutė;"Vesole misiaki";9457457032;Taip;5;4;0;9
14949;Zylutė;"Vesole misiaki";4543822765;Taip;1;4;0;5
14950;Zylutė;"Vesole misiaki";4566817285;Taip;6;1;0;7
14951;Zylutė;"Vesole misiaki";9737308076;Taip;0;12;0;12
14952;Zylutė;"Vesole misiaki";2999425729;Taip;3;4;0;7
14953;Zylutė;"Vesole misiaki";1290248125;Ne;0;3;0;3
14954;Zylutė;"Vesole misiaki";5027134228;Taip;3;8;0;11
14955;Zylutė;"Vesole misiaki";5589330186;Taip;18;0;0;18
14956;Zylutė;"Vesole misiaki";3848401615;Taip;0;7;0;7
14957;Zylutė;"Vesole misiaki";5522089327;Taip;0;1;0;1
14958;Zylutė;"Vesole misiaki";2913504349;Taip;0;10;0;10
14959;Zylutė;"Vesole misiaki";6601967273;Taip;0;3;0;3
14960;Zylutė;"Vesole misiaki";2501761963;Taip;0;8;0;8
14961;Zylutė;"Vesole misiaki";6833822248;Taip;3;3;0;6
14962;Zylutė;"Vesole misiaki";3976277394;Ne;0;2;0;2
14963;Zylutė;"Vesole misiaki";2489898107;Taip;0;4;0;4
14964;Zylutė;"Vesole misiaki";2313423907;Taip;0;7;0;7
14965;Zylutė;NYKŠTUKAI;3371202491;Taip;0;3;2;5
14966;Zylutė;NYKŠTUKAI;8820121776;Taip;0;3;0;3
14967;Zylutė;NYKŠTUKAI;4611555689;Taip;0;7;0;7
14968;Zylutė;NYKŠTUKAI;1169490002;Taip;0;14;0;14
14969;Zylutė;NYKŠTUKAI;3994691080;Taip;8;4;0;12
14970;Zylutė;NYKŠTUKAI;4894611078;Taip;0;2;0;2
14971;Zylutė;NYKŠTUKAI;7648922403;Ne;0;4;0;4
14972;Zylutė;NYKŠTUKAI;2113594059;Taip;3;10;0;13
14973;Zylutė;NYKŠTUKAI;9615779237;Taip;0;7;0;7
14974;Zylutė;NYKŠTUKAI;2604844156;Taip;0;6;0;6
14975;Zylutė;NYKŠTUKAI;2511658462;Ne;5;3;0;8
14976;Zylutė;NYKŠTUKAI;3035745273;Taip;5;0;0;5
14977;Zylutė;NYKŠTUKAI;2620903587;Ne;14;0;0;14
14978;Zylutė;Ručijok;5096881585;Ne;10;3;0;13
14979;Zylutė;Ručijok;3201966434;Taip;7;0;2;9
14980;Zylutė;Ručijok;4874246039;Taip;0;7;0;7
14981;Zylutė;Ručijok;1145229045;Taip;0;0;1;1
14982;Zylutė;Ručijok;3058040516;Taip;0;4;0;4
14983;Zylutė;Ručijok;2916622808;Taip;14;0;2;16
14984;Zylutė;Ručijok;5038936878;Taip;13;0;0;13
14985;Zylutė;Ručijok;2491905840;Taip;7;0;0;7
14986;Zylutė;Ručijok;7742044835;Taip;0;7;0;7
14987;Zylutė;Ručijok;5956114459;Taip;0;5;0;5
14988;Zylutė;Ručijok;6276017610;Taip;8;0;1;9
14989;Zylutė;Ručijok;3128535871;Taip;9;0;3;12
14990;Zylutė;Raduga;9325387975;Taip;0;9;0;9
14991;Zylutė;Raduga;6569135467;Taip;1;4;0;5
14992;Zylutė;Raduga;3117948118;Taip;0;0;5;5
14993;Zylutė;Raduga;3943002728;Taip;6;2;0;8
14994;Zylutė;Raduga;4043810535;Taip;0;4;0;4
14995;Zylutė;Raduga;2107123106;Ne;5;9;0;14
14996;Zylutė;Raduga;7482740111;Taip;0;3;1;4
14997;Zylutė;Raduga;7824348276;Taip;15;3;0;18
14998;Zylutė;Raduga;4811667497;Ne;10;4;0;14
14999;Zylutė;Raduga;2681013154;Taip;9;1;2;12
15000;Zylutė;Raduga;6391999153;Taip;0;0;1;1
15001;Zylutė;Raduga;6833030749;Taip;5;0;0;5
15002;Zylutė;Raduga;4493469560;Taip;0;0;5;5
15003;Zylutė;Raduga;3608920051;Taip;0;5;0;5
15004;Zylutė;Raduga;3059970035;Taip;7;3;0;10
15005;Zylutė;Raduga;5408157164;Taip;0;1;6;7
15006;Zylutė;Raduga;3780475392;Taip;0;9;0;9
15007;Zylutė;"Miki Maus";9159342804;Taip;13;3;0;16
15008;Zylutė;"Miki Maus";8023418946;Taip;3;6;0;9
15009;Zylutė;"Miki Maus";5369354390;Taip;5;12;0;17
15010;Zylutė;"Miki Maus";8121814945;Taip;9;0;0;9
15011;Zylutė;"Miki Maus";9507157625;Taip;8;2;0;10
15012;Zylutė;"Miki Maus";8101232865;Taip;8;0;0;8
15013;Zylutė;"Miki Maus";9018673580;Taip;14;0;0;14
15014;Zylutė;"Miki Maus";7762245887;Taip;10;3;0;13
15015;Zylutė;"Miki Maus";9213491152;Taip;13;0;0;13
15016;Zylutė;"Miki Maus";3928932787;Taip;6;0;1;7
15017;Zylutė;"Miki Maus";4057419108;Ne;0;14;0;14
15018;Zylutė;"Miki Maus";3668160578;Taip;11;5;0;16
15019;Zylutė;"Miki Maus";9093777086;Taip;6;1;0;7
15020;Zylutė;"Miki Maus";7123399601;Ne;6;3;0;9
15021;Zylutė;"Miki Maus";5975875502;Ne;10;2;0;12
15022;Zylutė;Solnyško;8379932761;Taip;11;4;0;15
15023;Zylutė;Solnyško;5556769710;Taip;2;5;0;7
15024;Zylutė;Solnyško;2088316489;Taip;0;4;0;4
15025;Zylutė;Solnyško;1076803315;Taip;0;5;0;5
15026;Zylutė;Solnyško;7616444695;Taip;25;0;0;25
15027;Zylutė;Solnyško;5234846079;Taip;0;3;0;3
15028;Zylutė;Solnyško;5939522435;Taip;5;4;0;9
15029;Zylutė;Solnyško;2117820453;Taip;7;0;1;8
15030;Zylutė;Solnyško;3111739911;Ne;0;0;1;1
15031;Zylutė;Solnyško;5826813410;Taip;0;7;0;7
15032;Zylutė;Solnyško;8033573972;Ne;4;0;0;4
15033;Zylutė;Solnyško;7447067072;Taip;1;9;1;11
15034;Zylutė;Solnyško;1386683435;Taip;0;2;2;4
15035;Zylutė;Solnyško;4669449744;Taip;0;5;0;5
15036;Zylutė;Solnyško;4478652694;Ne;0;11;0;11
15037;Zylutė;Solnyško;1969578486;Taip;8;0;1;9
15038;Zylutė;Solnyško;6573541087;Taip;13;0;0;13
15039;Zylutė;Solnyško;2520744071;Taip;0;0;4;4
15040;Zylutė;Solnyško;3894885445;Taip;0;0;5;5
15041;Zylutė;Motyliok;7241045507;Taip;9;0;0;9
15042;Zylutė;Motyliok;9913001904;Ne;6;3;0;9
15043;Zylutė;Motyliok;5891900062;Taip;0;7;0;7
15044;Zylutė;Motyliok;6112586092;Taip;0;5;0;5
15045;Zylutė;Motyliok;8178488164;Taip;0;3;0;3
15046;Zylutė;Motyliok;3547185618;Taip;0;3;0;3
15047;Zylutė;Motyliok;5045652581;Taip;8;8;0;16
15048;Zylutė;Motyliok;9586800176;Taip;0;3;0;3
15049;Zylutė;Motyliok;4497904128;Taip;0;4;0;4
15050;Zylutė;Motyliok;3355159275;Taip;0;2;0;2
15051;Zylutė;Motyliok;9995791665;Taip;0;3;0;3
15052;Zylutė;Motyliok;1455822427;Taip;8;0;0;8
15053;Zylutė;Motyliok;2654373943;Taip;5;2;0;7
15054;Zylutė;Motyliok;3455374127;Taip;0;9;0;9
15055;Zylutė;Motyliok;1632490481;Taip;4;4;0;8
15056;Zylutė;Motyliok;3084870481;Taip;8;0;0;8
15057;Zylutė;Motyliok;6051657134;Taip;8;0;0;8
15058;Zylutė;Motyliok;3271366684;Taip;10;3;0;13
15059;Zylutė;Motyliok;3633983359;Taip;18;0;0;18
15060;Zylutė;Motyliok;9155513221;Ne;15;0;0;15
15061;Zylutė;ŽVIRBLIUKAI;6282501549;Taip;10;0;0;10
15062;Zylutė;ŽVIRBLIUKAI;1319040747;Taip;0;3;7;10
15063;Zylutė;ŽVIRBLIUKAI;4394023057;Taip;3;0;0;3
15064;Zylutė;ŽVIRBLIUKAI;8326987895;Taip;0;5;0;5
15065;Zylutė;ŽVIRBLIUKAI;9330583784;Taip;8;0;3;11
15066;Zylutė;ŽVIRBLIUKAI;9150157724;Ne;8;0;0;8
15067;Zylutė;ŽVIRBLIUKAI;8268700439;Taip;0;3;5;8
15068;Zylutė;ŽVIRBLIUKAI;1220439948;Taip;1;7;0;8
15069;Zylutė;ŽVIRBLIUKAI;4646273830;Ne;0;2;0;2
15070;Zylutė;ŽVIRBLIUKAI;9580188426;Ne;5;0;0;5
15071;Zylutė;ŽVIRBLIUKAI;1797701777;Taip;0;3;0;3
15072;Zylutė;ŽVIRBLIUKAI;2966482773;Taip;0;4;0;4
15073;Zylutė;ŽVIRBLIUKAI;2697867000;Ne;5;3;3;11
15074;Zylutė;ŽVIRBLIUKAI;8262929231;Taip;2;1;0;3
15075;Zylutė;ŽVIRBLIUKAI;8152140523;Taip;3;0;0;3
15076;Zylutė;ŽVIRBLIUKAI;8346794629;Taip;8;0;0;8
15077;Zylutė;ŽVIRBLIUKAI;2061747513;Taip;10;0;2;12
15078;Zylutė;"DRUŽNYJE REBIATA";5332039406;Taip;18;0;0;18
15079;Zylutė;"DRUŽNYJE REBIATA";9039665233;Taip;0;3;0;3
15080;Zylutė;"DRUŽNYJE REBIATA";6075614020;Taip;7;8;0;15
15081;Zylutė;"DRUŽNYJE REBIATA";9518714240;Taip;0;5;0;5
15082;Zylutė;"DRUŽNYJE REBIATA";2693961315;Taip;9;0;0;9
15083;Zylutė;"DRUŽNYJE REBIATA";3372639449;Taip;2;0;2;4
15084;Zylutė;"DRUŽNYJE REBIATA";4916625058;Taip;7;3;0;10
15085;Zylutė;"DRUŽNYJE REBIATA";3447644735;Taip;0;10;0;10
15086;Zylutė;"DRUŽNYJE REBIATA";3174042441;Taip;0;4;0;4
15087;Zylutė;"DRUŽNYJE REBIATA";6848387941;Taip;5;1;0;6
15088;Zylutė;"DRUŽNYJE REBIATA";1404949829;Taip;12;3;0;15
15089;Zylutė;"DRUŽNYJE REBIATA";4548205666;Taip;0;3;0;3
15090;Zylutė;"DRUŽNYJE REBIATA";6962852787;Taip;0;3;0;3
15091;Zylutė;"DRUŽNYJE REBIATA";9220918504;Taip;0;3;0;3
15092;Zylutė;"DRUŽNYJE REBIATA";9193349264;Taip;8;0;0;8
15093;Zylutė;"DRUŽNYJE REBIATA";2444440430;Taip;4;1;0;5
15094;Zylutė;"DRUŽNYJE REBIATA";8204885376;Taip;0;3;5;8
15095;Zylutė;"DRUŽNYJE REBIATA";8130859512;Taip;4;3;0;7
15096;Zylutė;"DRUŽNYJE REBIATA";6281989117;Taip;8;5;0;13
15097;Zylutė;"DRUŽNYJE REBIATA";9769201088;Ne;0;11;0;11
15098;Zylutė;"DRUŽNYJE REBIATA";5233163416;Taip;7;3;0;10
15099;Zylutė;"DRUŽNYJE REBIATA";6784471792;Taip;0;8;0;8
15100;Zylutė;"DRUŽNYJE REBIATA";5126282685;Taip;8;0;0;8
15101;Zylutė;VIEVERSĖLIAI;2125519672;Taip;0;1;0;1
15102;Zylutė;VIEVERSĖLIAI;4505081448;Taip;16;3;0;19
15103;Zylutė;VIEVERSĖLIAI;72716975865;Taip;0;3;0;3
15104;Zylutė;VIEVERSĖLIAI;6275164528;Taip;0;3;0;3
15105;Zylutė;VIEVERSĖLIAI;5172154642;Taip;0;10;0;10
15106;Zylutė;VIEVERSĖLIAI;2943888466;Taip;0;9;0;9
15107;Zylutė;VIEVERSĖLIAI;6907378757;Taip;0;5;0;5
15108;Zylutė;VIEVERSĖLIAI;6723650872;Taip;5;3;0;8
15109;Zylutė;VIEVERSĖLIAI;4016518230;Taip;0;6;0;6
15110;Zylutė;VIEVERSĖLIAI;9660898505;Taip;0;11;0;11
15111;Zylutė;VIEVERSĖLIAI;5544338521;Taip;0;6;0;6
15112;Zylutė;VIEVERSĖLIAI;3246229837;Taip;5;2;0;7
15113;Zylutė;VIEVERSĖLIAI;27488840113;Taip;2;4;0;6
15114;Zylutė;VIEVERSĖLIAI;5162635301;Taip;10;0;0;10
15115;Zylutė;VIEVERSĖLIAI;1939618217;Taip;5;3;0;8
15116;Zylutė;VIEVERSĖLIAI;20569748356;Taip;5;3;0;8
15117;Zylutė;VIEVERSĖLIAI;1048279422;Taip;1;7;0;8
15118;Zylutė;VIEVERSĖLIAI;3919565034;Taip;0;5;0;5
15119;Zylutė;VIEVERSĖLIAI;6548786007;Ne;5;4;0;9
15120;Zylutė;VIEVERSĖLIAI;3074954453;Taip;0;5;0;5
15121;Zylutė;VIEVERSĖLIAI;2364890732;Taip;0;0;16;16
15122;Želmenėliai;Bitučių;4681686872;Taip;0;1;0;1
15123;Želmenėliai;Bitučių;3268310531;Taip;6;4;0;10
15124;Želmenėliai;Bitučių;2122665619;Taip;0;5;0;5
15125;Želmenėliai;Bitučių;2563117992;Taip;8;1;0;9
15126;Želmenėliai;Bitučių;6799702725;Taip;0;6;0;6
15127;Želmenėliai;Bitučių;8358780570;Taip;0;3;0;3
15128;Želmenėliai;Bitučių;9006406225;Taip;0;5;0;5
15129;Želmenėliai;Bitučių;2102401372;Taip;0;3;0;3
15130;Želmenėliai;Bitučių;4931835807;Taip;4;2;0;6
15131;Želmenėliai;Bitučių;5147895081;Taip;4;7;0;11
15132;Želmenėliai;Bitučių;6481952132;Taip;8;5;0;13
15133;Želmenėliai;Bitučių;9611741258;Taip;5;3;0;8
15134;Želmenėliai;Bitučių;1619143702;Taip;5;0;1;6
15135;Želmenėliai;Bitučių;9825545754;Taip;18;0;0;18
15136;Želmenėliai;Bitučių;5314438217;Taip;5;3;0;8
15137;Želmenėliai;Bitučių;4927030144;Taip;0;4;0;4
15138;Želmenėliai;Bitučių;3739751121;Taip;9;0;0;9
15139;Želmenėliai;Bitučių;2853659708;Taip;0;10;0;10
15140;Želmenėliai;Bitučių;9207984505;Taip;0;6;0;6
15141;Želmenėliai;Kačiukų;1292462938;Taip;0;0;1;1
15142;Želmenėliai;Kačiukų;2350936740;Taip;20;2;0;22
15143;Želmenėliai;Kačiukų;3063417708;Taip;8;7;0;15
15144;Želmenėliai;Kačiukų;2570248893;Taip;4;2;0;6
15145;Želmenėliai;Kačiukų;2577850672;Taip;8;4;0;12
15146;Želmenėliai;Kačiukų;7197717698;Taip;12;0;0;12
15147;Želmenėliai;Kačiukų;7849682820;Taip;14;1;0;15
15148;Želmenėliai;Kačiukų;2111008869;Taip;0;4;9;13
15149;Želmenėliai;Kačiukų;4589396143;Taip;4;3;0;7
15150;Želmenėliai;Kačiukų;4198085732;Taip;7;0;4;11
15151;Želmenėliai;Kačiukų;6509783586;Taip;6;1;0;7
15152;Želmenėliai;Kačiukų;4126499046;Taip;0;2;1;3
15153;Želmenėliai;Kačiukų;4758240577;Taip;10;2;0;12
15154;Želmenėliai;Kačiukų;7094853897;Taip;15;2;1;18
15155;Želmenėliai;Kačiukų;9493581034;Taip;0;7;6;13
15156;Želmenėliai;Kačiukų;4931664953;Ne;8;1;0;9
15157;Želmenėliai;Kačiukų;4376978921;Taip;3;16;0;19
15158;Želmenėliai;Kačiukų;9313666706;Taip;12;0;0;12
15159;Želmenėliai;Kačiukų;8590129703;Taip;3;0;12;15
15160;Želmenėliai;Kačiukų;3959066963;Taip;0;7;3;10
15161;Želmenėliai;Kačiukų;6761848439;Taip;0;0;8;8
15162;Želmenėliai;Voveriukų;6343814445;Taip;0;7;0;7
15163;Želmenėliai;Voveriukų;7833143421;Taip;5;0;0;5
15164;Želmenėliai;Voveriukų;8418427863;Taip;4;4;0;8
15165;Želmenėliai;Voveriukų;5360157217;Taip;29;0;0;29
15166;Želmenėliai;Voveriukų;7423900312;Taip;0;5;0;5
15167;Želmenėliai;Voveriukų;2025424742;Taip;12;0;0;12
15168;Želmenėliai;Voveriukų;2924134152;Taip;13;1;0;14
15169;Želmenėliai;Voveriukų;6857922902;Taip;8;0;0;8
15170;Želmenėliai;Voveriukų;9811131936;Taip;7;0;0;7
15171;Želmenėliai;Voveriukų;8968533318;Taip;0;13;0;13
15172;Želmenėliai;Voveriukų;6264955603;Taip;1;5;0;6
15173;Želmenėliai;Voveriukų;8952421941;Taip;0;2;0;2
15174;Želmenėliai;Voveriukų;7345540758;Taip;5;0;0;5
15175;Želmenėliai;Voveriukų;9709599805;Taip;14;1;0;15
15176;Želmenėliai;Voveriukų;4248374729;Taip;0;3;0;3
15177;Želmenėliai;Ežiukų;5795735579;Taip;7;0;0;7
15178;Želmenėliai;Ežiukų;3572462731;Taip;7;2;0;9
15179;Želmenėliai;Ežiukų;3353793939;Taip;14;0;0;14
15180;Želmenėliai;Ežiukų;7495157523;Taip;7;5;0;12
15181;Želmenėliai;Ežiukų;3972980949;Taip;4;1;0;5
15182;Želmenėliai;Ežiukų;6779746783;Taip;6;0;1;7
15183;Želmenėliai;Ežiukų;6876147546;Taip;0;9;0;9
15184;Želmenėliai;Ežiukų;9126715074;Taip;0;4;0;4
15185;Želmenėliai;Ežiukų;1260607572;Taip;0;2;0;2
15186;Želmenėliai;Ežiukų;5638248652;Taip;6;1;0;7
15187;Želmenėliai;Ežiukų;8154713582;Taip;10;3;1;14
15188;Želmenėliai;Ežiukų;2296870749;Taip;7;0;1;8
15189;Želmenėliai;Ežiukų;6180553648;Taip;6;5;0;11
15190;Želmenėliai;Ežiukų;5171736943;Taip;4;3;0;7
15191;Želmenėliai;Ežiukų;7294722095;Taip;10;7;0;17
15192;Želmenėliai;Ežiukų;4120125150;Taip;13;1;0;14
15193;Želmenėliai;Ežiukų;5281861477;Taip;7;5;0;12
15194;Želmenėliai;Ežiukų;8987377791;Taip;0;5;0;5
15195;Želmenėliai;Ežiukų;7373892344;Taip;11;1;0;12
15196;Želmenėliai;Peledžiukų;8491797555;Taip;6;6;0;12
15197;Želmenėliai;Peledžiukų;7058759730;Ne;5;5;0;10
15198;Želmenėliai;Peledžiukų;4485249321;Taip;0;6;0;6
15199;Želmenėliai;Peledžiukų;3869372021;Taip;0;7;0;7
15200;Želmenėliai;Peledžiukų;4374898642;Taip;0;5;0;5
15201;Želmenėliai;Peledžiukų;7751609462;Taip;0;2;0;2
15202;Želmenėliai;Peledžiukų;5929410363;Taip;13;0;0;13
15203;Želmenėliai;Peledžiukų;5205425589;Taip;5;7;0;12
15204;Želmenėliai;Peledžiukų;5362390260;Taip;0;4;0;4
15205;Želmenėliai;Peledžiukų;1580370689;Taip;0;4;0;4
15206;Želmenėliai;Peledžiukų;1983575576;Taip;3;0;0;3
15207;Želmenėliai;Peledžiukų;7672980212;Taip;5;3;0;8
15208;Želmenėliai;Peledžiukų;6260153299;Taip;5;1;0;6
15209;Želmenėliai;Peledžiukų;6187661667;Taip;9;3;0;12
15210;Želmenėliai;Peledžiukų;6109546917;Taip;2;7;0;9
15211;Želmenėliai;Peledžiukų;8118696261;Taip;9;0;0;9
15212;Želmenėliai;Peledžiukų;4746898209;Taip;0;8;0;8
15213;Želmenėliai;Peledžiukų;9929149682;Taip;13;0;0;13
15214;Želmenėliai;Peledžiukų;3723155757;Taip;9;8;0;17
15215;Želmenėliai;Peledžiukų;5401466574;Taip;8;0;0;8
15216;Želmenėliai;Peledžiukų;6662439747;Taip;8;1;0;9
15217;Želmenėliai;Drugelių;7664430346;Taip;14;4;0;18
15218;Želmenėliai;Drugelių;3417538909;Taip;10;4;0;14
15219;Želmenėliai;Drugelių;3295852546;Taip;8;1;0;9
15220;Želmenėliai;Drugelių;3379266015;Taip;13;7;0;20
15221;Želmenėliai;Drugelių;1984105453;Taip;12;3;0;15
15222;Želmenėliai;Drugelių;4652412483;Taip;0;11;0;11
15223;Želmenėliai;Drugelių;1652949383;Taip;8;3;0;11
15224;Želmenėliai;Drugelių;5046836398;Taip;11;5;0;16
15225;Želmenėliai;Drugelių;9237611484;Taip;0;4;4;8
15226;Želmenėliai;Drugelių;13558387807;Taip;0;3;0;3
15227;Želmenėliai;Drugelių;5143554665;Taip;7;9;0;16
15228;Želmenėliai;Drugelių;7585159351;Taip;6;4;0;10
15229;Želmenėliai;Drugelių;4634346755;Taip;3;6;0;9
15230;Želmenėliai;Drugelių;4916436238;Taip;5;1;0;6
15231;Želmenėliai;Drugelių;5558795651;Taip;15;3;0;18
15232;Želmenėliai;Drugelių;8504963337;Taip;0;2;0;2
15233;Želmenėliai;Drugelių;7572597061;Ne;0;1;0;1
15234;Želmenėliai;Voriukų;4264751761;Taip;0;2;0;2
15235;Želmenėliai;Voriukų;1203343580;Taip;8;4;0;12
15236;Želmenėliai;Voriukų;9351650342;Ne;4;5;0;9
15237;Želmenėliai;Voriukų;6916426436;Taip;0;2;4;6
15238;Želmenėliai;Voriukų;7563461821;Taip;0;4;0;4
15239;Želmenėliai;Voriukų;4534946646;Taip;10;3;0;13
15240;Želmenėliai;Voriukų;4075533071;Taip;0;9;0;9
15241;Želmenėliai;Voriukų;4545012342;Taip;0;3;0;3
15242;Želmenėliai;Voriukų;7505996978;Taip;0;10;0;10
15243;Želmenėliai;Voriukų;2722619508;Taip;6;5;0;11
15244;Želmenėliai;Voriukų;5025345647;Taip;6;5;0;11
15245;Želmenėliai;Voriukų;8892137326;Taip;0;6;0;6
15246;Želmenėliai;Voriukų;7700521261;Taip;0;8;0;8
15247;Želmenėliai;Voriukų;1649724696;Ne;0;4;0;4
15248;Želmenėliai;Voriukų;8273301992;Taip;11;0;2;13
15249;Želmenėliai;Voriukų;8206979332;Taip;7;1;0;8
15250;Želmenėliai;Boružėlių;7792850272;Taip;5;2;0;7
15251;Želmenėliai;Boružėlių;1764468979;Taip;14;4;0;18
15252;Želmenėliai;Boružėlių;5161934903;Taip;0;6;0;6
15253;Želmenėliai;Boružėlių;8722573513;Taip;0;6;0;6
15254;Želmenėliai;Boružėlių;3516695805;Taip;0;10;0;10
15255;Želmenėliai;Boružėlių;5949535657;Taip;0;3;0;3
15256;Želmenėliai;Boružėlių;2262009049;Taip;5;3;0;8
15257;Želmenėliai;Boružėlių;7077832687;Taip;0;6;0;6
15258;Želmenėliai;Boružėlių;3896171121;Taip;0;6;0;6
15259;Želmenėliai;Boružėlių;2951719129;Taip;18;0;0;18
15260;Želmenėliai;Boružėlių;2066439950;Taip;0;3;0;3
15261;Želmenėliai;Boružėlių;5207899503;Taip;0;6;0;6
15262;Želmenėliai;Boružėlių;2111705047;Taip;0;5;0;5
15263;Želmenėliai;Boružėlių;5514167627;Taip;0;5;0;5
15264;Želmenėliai;Boružėlių;8474210476;Taip;7;1;0;8
15265;Želmenėliai;Boružėlių;2179165096;Taip;10;2;0;12
15266;Želmenėliai;Pūkuotukų;3258904017;Taip;0;4;0;4
15267;Želmenėliai;Pūkuotukų;8667865301;Taip;0;2;5;7
15268;Želmenėliai;Pūkuotukų;1952686295;Taip;0;4;0;4
15269;Želmenėliai;Pūkuotukų;5787772212;Taip;0;3;0;3
15270;Želmenėliai;Pūkuotukų;2727113833;Taip;7;3;0;10
15271;Želmenėliai;Pūkuotukų;9359070885;Taip;0;2;0;2
15272;Želmenėliai;Pūkuotukų;6816346946;Taip;7;3;0;10
15273;Želmenėliai;Pūkuotukų;37152467004;Taip;0;5;0;5
15274;Želmenėliai;Pūkuotukų;5842563754;Taip;0;3;0;3
15275;Želmenėliai;Pūkuotukų;1941723687;Taip;7;3;0;10
15276;Želmenėliai;Pūkuotukų;1239398642;Taip;0;3;0;3
15277;Želmenėliai;Pūkuotukų;5616709457;Taip;7;4;0;11
15278;Želmenėliai;Pūkuotukų;4206128805;Taip;0;3;0;3
15279;Želmenėliai;Pūkuotukų;1248541555;Taip;4;8;0;12
15280;Želmenėliai;Pūkuotukų;8300887366;Taip;0;9;0;9
15281;Želmenėliai;Pūkuotukų;7099039424;Taip;0;1;0;1
15282;Želmenėliai;Pūkuotukų;1582618217;Taip;5;3;0;8
15283;Želmenėliai;Ančiukų;4979494010;Taip;11;2;1;14
15284;Želmenėliai;Ančiukų;7925266303;Taip;11;2;1;14
15285;Želmenėliai;Ančiukų;2578675950;Taip;4;0;1;5
15286;Želmenėliai;Ančiukų;8060048377;Taip;27;0;0;27
15287;Želmenėliai;Ančiukų;1606079948;Taip;9;1;0;10
15288;Želmenėliai;Ančiukų;9250666159;Taip;20;0;0;20
15289;Želmenėliai;Ančiukų;5569699398;Taip;20;0;0;20
15290;Želmenėliai;Ančiukų;3926238501;Taip;7;3;0;10
15291;Želmenėliai;Ančiukų;4207070475;Taip;3;3;0;6
15292;Želmenėliai;Ančiukų;8409831053;Taip;4;3;0;7
15293;Želmenėliai;Ančiukų;3608041516;Taip;3;1;0;4
15294;Želmenėliai;Ančiukų;5454656514;Taip;0;8;2;10
15295;Želmenėliai;Ančiukų;8165683014;Taip;2;3;0;5
15296;Želmenėliai;Ančiukų;3172645969;Taip;16;4;0;20
15297;Želmenėliai;Ančiukų;7128213908;Taip;0;15;0;15
15298;Želmenėliai;Nykštukų;6230010537;Taip;11;0;0;11
15299;Želmenėliai;Nykštukų;4722890143;Taip;10;0;0;10
15300;Želmenėliai;Nykštukų;5052052744;Taip;15;1;0;16
15301;Želmenėliai;Nykštukų;6764567873;Taip;0;11;0;11
15302;Želmenėliai;Nykštukų;9901320882;Taip;8;0;1;9
15303;Želmenėliai;Nykštukų;4526936339;Taip;10;1;0;11
15304;Želmenėliai;Nykštukų;3232996198;Taip;0;3;0;3
15305;Želmenėliai;Nykštukų;2878494111;Taip;10;1;0;11
15306;Želmenėliai;Nykštukų;5169813205;Taip;8;0;0;8
15307;Želmenėliai;Nykštukų;7341132501;Taip;5;2;0;7
15308;Želmenėliai;Nykštukų;9661692350;Taip;10;4;0;14
15309;Želmenėliai;Nykštukų;3003922213;Taip;0;4;8;12
15310;Želmenėliai;Nykštukų;7123290599;Taip;10;1;2;13
15311;Želmenėliai;Lašelių;8654298177;Taip;0;5;1;6
15312;Želmenėliai;Lašelių;4451798870;Taip;0;4;0;4
15313;Želmenėliai;Lašelių;4485851428;Taip;0;4;0;4
15314;Želmenėliai;Lašelių;3558547171;Taip;0;2;0;2
15315;Želmenėliai;Lašelių;4930868989;Taip;0;2;0;2
15316;Želmenėliai;Lašelių;2501163903;Taip;0;3;0;3
15317;Želmenėliai;Lašelių;9076874685;Taip;5;4;0;9
15318;Želmenėliai;Lašelių;3346680108;Taip;8;8;0;16
15319;Želmenėliai;Lašelių;4679930998;Taip;16;0;0;16
15320;Želmenėliai;Lašelių;3344426717;Taip;0;3;0;3
15321;Želmenėliai;Lašelių;9483665065;Taip;6;3;1;10
15322;Želmenėliai;Lašelių;1426080041;Taip;0;3;0;3
15323;Želmenėliai;Lašelių;9182208354;Taip;0;3;0;3
15324;Želmenėliai;Lašelių;8104790589;Taip;6;5;0;11
15325;Želmenėliai;Lašelių;9544233589;Taip;13;0;0;13
15326;Želmenėliai;Lašelių;3979635800;Taip;0;3;0;3
15327;Žemyna;Čiauškučiai;9985529041;Taip;13;0;0;13
15328;Žemyna;Čiauškučiai;9570187081;Taip;0;5;0;5
15329;Žemyna;Čiauškučiai;2547436771;Taip;0;5;0;5
15330;Žemyna;Čiauškučiai;6051208732;Taip;3;3;0;6
15331;Žemyna;Čiauškučiai;6346173832;Taip;5;0;3;8
15332;Žemyna;Čiauškučiai;8694608716;Taip;0;3;1;4
15333;Žemyna;Čiauškučiai;3074391266;Taip;0;0;5;5
15334;Žemyna;Čiauškučiai;1365045512;Taip;0;0;1;1
15335;Žemyna;Čiauškučiai;7620179886;Taip;0;0;6;6
15336;Žemyna;Čiauškučiai;2792702536;Taip;0;2;4;6
15337;Žemyna;Čiauškučiai;7376806308;Taip;0;2;0;2
15338;Žemyna;Čiauškučiai;7277970673;Taip;0;3;5;8
15339;Žemyna;Čiauškučiai;5069437469;Taip;0;3;0;3
15340;Žemyna;Čiauškučiai;7427119736;Taip;0;3;0;3
15341;Žemyna;Čiauškučiai;4642600915;Taip;0;3;0;3
15342;Žemyna;Čiauškučiai;2354265632;Taip;5;3;0;8
15343;Žemyna;Čiauškučiai;2887459684;Taip;0;3;1;4
15344;Žemyna;Čiauškučiai;1654157342;Taip;0;0;3;3
15345;Žemyna;Čiauškučiai;4652384557;Taip;3;0;2;5
15346;Žemyna;Čiauškučiai;7352868453;Taip;0;3;0;3
15347;Žemyna;Čiauškučiai;4501408683;Taip;0;0;3;3
15348;Žemyna;Čiauškučiai;4613946229;Taip;0;4;2;6
15349;Žemyna;Čiauškučiai;7675699775;Taip;3;3;1;7
15350;Žemyna;Nykštukai;5114094924;Taip;0;3;1;4
15351;Žemyna;Nykštukai;3874855308;Taip;0;0;5;5
15352;Žemyna;Nykštukai;2461700030;Taip;0;5;0;5
15353;Žemyna;Nykštukai;1725771976;Taip;0;0;6;6
15354;Žemyna;Nykštukai;3643594001;Taip;0;3;0;3
15355;Žemyna;Nykštukai;9182709647;Taip;0;4;0;4
15356;Žemyna;Nykštukai;7121742098;Taip;0;5;0;5
15357;Žemyna;Nykštukai;3519840747;Taip;0;2;0;2
15358;Žemyna;Nykštukai;4265606762;Taip;0;1;0;1
15359;Žemyna;Nykštukai;4821941126;Taip;0;1;0;1
15360;Žemyna;Nykštukai;1468040559;Ne;0;3;0;3
15361;Žemyna;Nykštukai;4322192775;Taip;0;4;1;5
15362;Žemyna;Nykštukai;4444870782;Taip;0;5;0;5
15363;Žemyna;Nykštukai;7781924111;Taip;0;2;0;2
15364;Žemyna;Nykštukai;4257096808;Taip;0;5;0;5
15365;Žemyna;Nykštukai;2860210906;Taip;0;0;16;16
15366;Žemyna;Nykštukai;7832066079;Taip;0;4;0;4
15367;Žemyna;Nykštukai;9653530823;Taip;6;0;0;6
15368;Žemyna;Nykštukai;7508491119;Taip;0;4;1;5
15369;Žemyna;Nykštukai;2928125522;Taip;0;4;0;4
15370;Žemyna;Nykštukai;4524929331;Taip;0;3;0;3
15371;Žemyna;Nykštukai;4759403487;Taip;0;4;0;4
15372;Žemyna;Voveriukai;5448623202;Taip;0;1;2;3
15373;Žemyna;Voveriukai;9855080887;Taip;8;0;0;8
15374;Žemyna;Voveriukai;6912605631;Taip;0;3;0;3
15375;Žemyna;Voveriukai;8525229514;Taip;8;1;0;9
15376;Žemyna;Voveriukai;1846287760;Ne;0;3;3;6
15377;Žemyna;Voveriukai;8775518984;Taip;0;1;2;3
15378;Žemyna;Voveriukai;8926045231;Taip;14;0;0;14
15379;Žemyna;Voveriukai;3860791215;Taip;0;6;0;6
15380;Žemyna;Voveriukai;8185243991;Taip;0;4;2;6
15381;Žemyna;Voveriukai;9471382383;Taip;0;4;0;4
15382;Žemyna;Voveriukai;4549562657;Taip;9;3;0;12
15383;Žemyna;Voveriukai;8882641275;Taip;0;8;0;8
15384;Žemyna;Voveriukai;7121061078;Taip;0;3;0;3
15385;Žemyna;Voveriukai;4900914346;Taip;0;6;0;6
15386;Žemyna;Voveriukai;8241038433;Taip;0;5;0;5
15387;Žemyna;Voveriukai;5450351549;Taip;0;3;0;3
15388;Žemyna;Voveriukai;5189603013;Taip;0;1;2;3
15389;Žemyna;Voveriukai;3500358886;Taip;3;4;0;7
15390;Žemyna;Kiškučiai;8622780639;Taip;5;3;0;8
15391;Žemyna;Kiškučiai;1575505075;Taip;0;1;5;6
15392;Žemyna;Kiškučiai;7917100888;Taip;0;3;0;3
15393;Žemyna;Kiškučiai;39916867354;Taip;0;3;0;3
15394;Žemyna;Kiškučiai;4317779866;Taip;0;0;6;6
15395;Žemyna;Kiškučiai;5258444578;Taip;0;3;2;5
15396;Žemyna;Kiškučiai;7785889259;Taip;10;3;0;13
15397;Žemyna;Kiškučiai;7676796264;Taip;0;3;0;3
15398;Žemyna;Kiškučiai;6536698798;Taip;1;6;0;7
15399;Žemyna;Kiškučiai;8139714064;Taip;0;3;1;4
15400;Žemyna;Kiškučiai;2090395417;Taip;0;6;0;6
15401;Žemyna;Kiškučiai;3895238312;Taip;5;3;1;9
15402;Žemyna;Kiškučiai;5056205809;Taip;0;1;2;3
15403;Žemyna;Kiškučiai;4519502372;Taip;0;3;5;8
15404;Žemyna;Kiškučiai;2137718635;Taip;0;3;0;3
15405;Žemyna;Kiškučiai;8018865138;Taip;0;3;0;3
15406;Žemyna;Kiškučiai;1717797530;Taip;0;3;2;5
15407;Žemyna;Kiškučiai;1058705875;Taip;0;3;0;3
15408;Žemyna;Kiškučiai;5233574060;Taip;7;3;0;10
15409;Žemyna;Kiškučiai;15110117571;Taip;0;3;1;4
15410;Žemyna;Kiškučiai;9219519029;Taip;0;11;0;11
15411;Žemyna;Kiškučiai;3875204515;Taip;4;3;0;7
15412;Žemyna;Kiškučiai;7638038269;Taip;0;3;0;3
15413;Žemyna;Vyturiukai;2526949655;Taip;4;2;0;6
15414;Žemyna;Vyturiukai;1417007895;Taip;0;3;0;3
15415;Žemyna;Vyturiukai;5355845891;Taip;5;3;0;8
15416;Žemyna;Vyturiukai;1481273689;Taip;10;0;0;10
15417;Žemyna;Vyturiukai;7781332622;Taip;2;5;0;7
15418;Žemyna;Vyturiukai;9366133892;Taip;0;8;0;8
15419;Žemyna;Vyturiukai;1031171460;Taip;16;0;0;16
15420;Žemyna;Vyturiukai;5204349188;Taip;15;0;0;15
15421;Žemyna;Vyturiukai;1345704379;Taip;1;3;1;5
15422;Žemyna;Vyturiukai;6097681172;Taip;0;5;0;5
15423;Žemyna;Vyturiukai;5133115712;Taip;4;3;0;7
15424;Žemyna;Vyturiukai;5416338054;Taip;4;3;0;7
15425;Žemyna;Vyturiukai;3446774478;Taip;0;8;0;8
15426;Žemyna;Vyturiukai;6271057561;Taip;0;6;0;6
15427;Žemyna;Vyturiukai;2304633263;Taip;0;5;1;6
15428;Žemyna;Vyturiukai;7300819771;Taip;0;4;0;4
15429;Žemyna;Vyturiukai;3679990879;Taip;0;0;6;6
15430;Žemyna;Vyturiukai;8461326396;Taip;5;0;9;14
15431;Žemyna;Vyturiukai;8681308720;Taip;0;3;0;3
15432;Žemyna;Vyturiukai;8577299116;Taip;12;3;1;16
15433;Žemyna;Vyturiukai;9646494715;Taip;0;7;0;7
15434;Žemyna;Vyturiukai;4863350801;Taip;1;0;11;12
15435;Žemyna;Vyturiukai;6372465987;Taip;0;3;1;4
15436;Žemyna;Vyturiukai;5655302107;Taip;6;0;4;10
15437;Žemyna;Pelėdžiukai;8040359407;Ne;0;3;2;5
15438;Žemyna;Pelėdžiukai;37570629861;Taip;0;11;0;11
15439;Žemyna;Pelėdžiukai;55161890341;Taip;0;3;0;3
15440;Žemyna;Pelėdžiukai;59506345859;Taip;0;9;0;9
15441;Žemyna;Pelėdžiukai;85135645557;Taip;0;3;0;3
15442;Žemyna;Pelėdžiukai;38769607968;Taip;0;3;1;4
15443;Žemyna;Pelėdžiukai;4235160760;Taip;0;5;0;5
15444;Žemyna;Pelėdžiukai;3622634119;Taip;0;6;0;6
15445;Žemyna;Pelėdžiukai;6618285685;Taip;0;3;1;4
15446;Žemyna;Pelėdžiukai;5306392307;Taip;0;3;0;3
15447;Žemyna;Pelėdžiukai;5508251792;Taip;0;3;0;3
15448;Žemyna;Pelėdžiukai;9018138289;Taip;0;2;0;2
15449;Žemyna;Pelėdžiukai;8096035110;Taip;0;3;1;4
15450;Žemyna;Pelėdžiukai;1687206394;Taip;0;3;0;3
15451;Žemyna;Pelėdžiukai;93423088394;Taip;0;1;0;1
15452;Žemyna;Pelėdžiukai;5933910526;Taip;0;3;2;5
15453;Žemyna;Pelėdžiukai;5506889213;Taip;0;1;0;1
15454;Žemyna;Pelėdžiukai;5815116293;Taip;0;3;1;4
15455;Žemyna;Pelėdžiukai;13242930752;Taip;0;3;0;3
15456;Žemyna;Pelėdžiukai;89787441782;Taip;0;4;0;4
15457;Žemyna;Pelėdžiukai;9224203811;Taip;6;3;2;11
15458;Žemyna;Pelėdžiukai;2527337934;Taip;4;3;0;7
15459;Žemyna;Pelėdžiukai;1867198805;Taip;0;3;0;3
15460;Žemyna;Vijurkai;8500642069;Taip;0;3;0;3
15461;Žemyna;Vijurkai;9148594407;Taip;0;3;2;5
15462;Žemyna;Vijurkai;6812823390;Taip;0;3;0;3
15463;Žemyna;Vijurkai;6701717634;Taip;0;1;0;1
15464;Žemyna;Vijurkai;3938938667;Taip;0;3;1;4
15465;Žemyna;Vijurkai;7125026803;Taip;0;3;0;3
15466;Žemyna;Vijurkai;7693278353;Taip;0;9;0;9
15467;Žemyna;Vijurkai;6430348135;Taip;0;4;0;4
15468;Žemyna;Vijurkai;2976467316;Taip;0;3;0;3
15469;Žemyna;Vijurkai;3357339710;Taip;16;0;0;16
15470;Žemyna;Vijurkai;7341750699;Taip;0;1;2;3
15471;Žemyna;Vijurkai;7925774308;Taip;0;3;0;3
15472;Žemyna;Vijurkai;9958040413;Taip;0;3;1;4
15473;Žemyna;Vijurkai;1531980297;Taip;0;3;2;5
15474;Žemyna;Vijurkai;9866110744;Taip;4;2;1;7
15475;Žemyna;Vijurkai;2412956023;Taip;0;3;0;3
15476;Žemyna;Vijurkai;1118997229;Taip;0;4;0;4
15477;Žemyna;Vijurkai;1114714466;Taip;0;3;7;10
15478;Žemyna;Vijurkai;5318574856;Ne;0;3;2;5
15479;Žemyna;Vijurkai;1264659113;Taip;0;4;0;4
15480;Žemyna;Vijurkai;4410293832;Taip;0;3;2;5
15481;Žemyna;Vijurkai;1652681820;Taip;0;4;1;5
15482;Žemyna;Šnekučiai;9501126807;Taip;12;0;0;12
15483;Žemyna;Šnekučiai;6735720135;Taip;0;13;0;13
15484;Žemyna;Šnekučiai;9912869400;Taip;0;0;3;3
15485;Žemyna;Šnekučiai;2006173745;Taip;0;4;1;5
15486;Žemyna;Šnekučiai;6116581655;Taip;0;0;3;3
15487;Žemyna;Šnekučiai;7280740926;Taip;0;1;4;5
15488;Žemyna;Šnekučiai;6419974691;Taip;0;4;5;9
15489;Žemyna;Šnekučiai;9818711030;Taip;0;4;0;4
15490;Žemyna;Šnekučiai;7764615445;Taip;0;3;1;4
15491;Žemyna;Šnekučiai;5868208651;Taip;0;1;3;4
15492;Žemyna;Šnekučiai;3992383447;Taip;13;0;0;13
15493;Žemyna;Šnekučiai;9668975591;Taip;0;3;0;3
15494;Žemyna;Šnekučiai;6856737270;Taip;0;3;1;4
15495;Žemyna;Šnekučiai;5188496664;Taip;0;3;0;3
15496;Žemyna;Šnekučiai;4872348199;Taip;0;7;0;7
15497;Žemyna;Šnekučiai;6878669773;Taip;0;4;0;4
15498;Žemyna;Šnekučiai;4502958166;Taip;18;0;0;18
15499;Žemyna;Šnekučiai;6728229865;Taip;0;5;0;5
15500;Žemyna;Šnekučiai;2710551760;Taip;0;2;0;2
15501;Žemyna;Šnekučiai;4612112289;Taip;0;3;1;4
15502;Žemyna;Šnekučiai;9568886284;Taip;12;0;1;13
15503;Žemyna;Šnekučiai;3982766622;Taip;0;4;3;7
15504;Žemyna;Pabiručiai;9827401825;Taip;2;6;0;8
15505;Žemyna;Pabiručiai;5743535463;Taip;0;14;0;14
15506;Žemyna;Pabiručiai;6958537154;Taip;0;4;0;4
15507;Žemyna;Pabiručiai;7005045961;Taip;0;3;0;3
15508;Žemyna;Pabiručiai;1745197274;Taip;0;6;0;6
15509;Žemyna;Pabiručiai;6041223291;Taip;18;4;0;22
15510;Žemyna;Pabiručiai;8248443265;Taip;0;2;0;2
15511;Žemyna;Pabiručiai;7122276019;Taip;1;4;0;5
15512;Žemyna;Pabiručiai;9094718595;Taip;0;4;0;4
15513;Žemyna;Pabiručiai;6208953341;Taip;1;5;0;6
15514;Žemyna;Pabiručiai;1656335765;Taip;4;3;0;7
15515;Žemyna;Pabiručiai;5127174926;Taip;5;3;0;8
15516;Žemyna;Pabiručiai;8559870965;Taip;5;4;0;9
15517;Žemyna;Pabiručiai;1850100203;Taip;0;3;0;3
15518;Žemyna;Pabiručiai;6450681255;Taip;9;3;0;12
15519;Žemyna;Pabiručiai;2860232791;Taip;17;1;0;18
15520;Žemyna;Pabiručiai;4237778022;Taip;6;3;0;9
15521;Žemyna;Pabiručiai;2414400761;Taip;3;7;0;10
15522;Žemyna;Pabiručiai;9511935264;Taip;0;9;0;9
15523;Žemyna;Pabiručiai;4176386795;Taip;0;3;0;3
15524;Žemyna;Pabiručiai;3393414493;Taip;2;4;1;7
15525;Žemyna;Pabiručiai;4960936366;Taip;12;3;0;15
15526;Žemyna;Pabiručiai;2495616844;Taip;0;5;0;5
15527;Žemyna;Drugeliai;7564693757;Taip;10;3;0;13
15528;Žemyna;Drugeliai;8302345911;Taip;0;3;0;3
15529;Žemyna;Drugeliai;3505551915;Taip;3;0;1;4
15530;Žemyna;Drugeliai;2231967652;Taip;5;0;6;11
15531;Žemyna;Drugeliai;3755964840;Taip;1;3;0;4
15532;Žemyna;Drugeliai;9171823612;Taip;0;0;18;18
15533;Žemyna;Drugeliai;5518125715;Taip;0;0;3;3
15534;Žemyna;Drugeliai;9589582451;Taip;0;0;5;5
15535;Žemyna;Drugeliai;3872427931;Taip;3;0;1;4
15536;Žemyna;Drugeliai;1279981170;Taip;7;0;6;13
15537;Žemyna;Drugeliai;2102920661;Taip;7;0;3;10
15538;Žemyna;Drugeliai;6575272457;Taip;17;0;0;17
15539;Žemyna;Drugeliai;6164541167;Taip;1;3;1;5
15540;Žemyna;Drugeliai;7461187735;Taip;0;0;3;3
15541;Žemyna;Drugeliai;3390442637;Taip;0;2;2;4
15542;Žemyna;Drugeliai;2371069183;Taip;4;0;2;6
15543;Žemyna;Drugeliai;2139103576;Taip;2;0;3;5
15544;Žemyna;Drugeliai;7920398415;Taip;0;4;0;4
15545;Žemyna;Drugeliai;1695063377;Taip;6;0;3;9
15546;Žemyna;Drugeliai;7745383607;Taip;1;0;3;4
15547;Žemyna;Drugeliai;7661182825;Taip;0;3;0;3
15548;Žemyna;Drugeliai;4861799571;Taip;0;3;0;3
15549;Žemyna;Drugeliai;8709792653;Taip;0;2;1;3
15550;Žemyna;"ŽIRNIUKAI ";4540472310;Taip;15;1;0;16
15551;Žemyna;"ŽIRNIUKAI ";9647706055;Taip;5;3;0;8
15552;Žemyna;"ŽIRNIUKAI ";7537145330;Taip;6;4;0;10
15553;Žemyna;"ŽIRNIUKAI ";7683443675;Taip;14;0;0;14
15554;Žemyna;"ŽIRNIUKAI ";9796331127;Taip;5;3;0;8
15555;Žemyna;"ŽIRNIUKAI ";3996577758;Taip;0;13;0;13
15556;Žemyna;"ŽIRNIUKAI ";6783675344;Taip;15;0;0;15
15557;Žemyna;"ŽIRNIUKAI ";9082375371;Taip;15;0;0;15
15558;Žemyna;"ŽIRNIUKAI ";1795919515;Taip;5;3;0;8
15559;Žemyna;"ŽIRNIUKAI ";3899901920;Taip;0;4;0;4
15560;Žemyna;"ŽIRNIUKAI ";7831778620;Taip;18;0;0;18
15561;Žemyna;"ŽIRNIUKAI ";9692952139;Taip;0;1;0;1
15562;Žemyna;"ŽIOGELIAI ";2039344248;Taip;0;0;4;4
15563;Žemyna;"ŽIOGELIAI ";5968816137;Taip;0;0;3;3
15564;Žemyna;"ŽIOGELIAI ";4238528111;Taip;3;0;3;6
15565;Žemyna;"ŽIOGELIAI ";3741459808;Taip;3;0;3;6
15566;Žemyna;"ŽIOGELIAI ";3164469202;Taip;0;3;0;3
15567;Žemyna;"ŽIOGELIAI ";3870917221;Taip;3;0;5;8
15568;Žemyna;"ŽIOGELIAI ";6571952468;Taip;0;0;3;3
15569;Žemyna;"ŽIOGELIAI ";6632827240;Taip;18;0;0;18
15570;Žemyna;"ŽIOGELIAI ";3935318882;Taip;0;0;3;3
15571;Žemyna;"ŽIOGELIAI ";2010676445;Taip;0;0;3;3
15572;Žemyna;"ŽIOGELIAI ";1581399038;Taip;0;0;1;1
15573;Žemyna;"ŽIOGELIAI ";8611258788;Taip;0;0;4;4
15574;Žemyna;"ŽIOGELIAI ";6592356004;Taip;18;0;0;18
15575;Žemyna;"ŽIOGELIAI ";9788890112;Taip;18;0;0;18
15576;Žemuogėlė;Boružiukai;1350671777;Taip;1;5;5;11
15577;Žemuogėlė;Boružiukai;9344628661;Taip;0;6;0;6
15578;Žemuogėlė;Boružiukai;2158359435;Ne;10;4;1;15
15579;Žemuogėlė;Boružiukai;1639634300;Taip;11;3;0;14
15580;Žemuogėlė;Boružiukai;5521993938;Ne;0;2;5;7
15581;Žemuogėlė;Boružiukai;1267222057;Taip;0;5;0;5
15582;Žemuogėlė;Boružiukai;9562512849;Taip;17;5;0;22
15583;Žemuogėlė;Boružiukai;8661864424;Taip;0;4;0;4
15584;Žemuogėlė;Boružiukai;5427045039;Taip;21;0;0;21
15585;Žemuogėlė;Boružiukai;1150466286;Taip;0;6;0;6
15586;Žemuogėlė;Boružiukai;8040255583;Taip;0;3;0;3
15587;Žemuogėlė;Boružiukai;2190458676;Taip;7;3;0;10
15588;Žemuogėlė;Boružiukai;6073591450;Taip;5;3;0;8
15589;Žemuogėlė;Boružiukai;7328566035;Taip;0;3;2;5
15590;Žemuogėlė;Boružiukai;8557325116;Taip;0;2;0;2
15591;Žemuogėlė;Boružiukai;1350383125;Taip;0;3;5;8
15592;Žemuogėlė;Boružiukai;7050896262;Taip;0;6;0;6
15593;Žemuogėlė;Boružiukai;3413805578;Taip;2;3;2;7
15594;Žemuogėlė;Boružiukai;1187953952;Taip;0;3;4;7
15595;Žemuogėlė;Boružiukai;3677459716;Taip;10;3;1;14
15596;Žemuogėlė;Boružiukai;8426601160;Taip;3;2;2;7
15597;Žemuogėlė;Boružiukai;5911215640;Taip;7;2;4;13
15598;Žemuogėlė;Šviesuliukai;3837424301;Taip;4;7;0;11
15599;Žemuogėlė;Šviesuliukai;5499401648;Taip;3;4;0;7
15600;Žemuogėlė;Šviesuliukai;3746045950;Taip;0;19;0;19
15601;Žemuogėlė;Šviesuliukai;4663181188;Taip;2;1;1;4
15602;Žemuogėlė;Šviesuliukai;8492878852;Taip;8;2;1;11
15603;Žemuogėlė;Šviesuliukai;7603740057;Taip;4;7;1;12
15604;Žemuogėlė;Šviesuliukai;6755278376;Ne;4;6;0;10
15605;Žemuogėlė;Šviesuliukai;4506847669;Taip;0;2;0;2
15606;Žemuogėlė;Šviesuliukai;7708949381;Taip;0;5;0;5
15607;Žemuogėlė;Šviesuliukai;7837251012;Taip;11;0;0;11
15608;Žemuogėlė;Šviesuliukai;7189855370;Taip;0;9;0;9
15609;Žemuogėlė;Šviesuliukai;3801534195;Taip;26;0;0;26
15610;Žemuogėlė;Šviesuliukai;1341637008;Taip;1;0;1;2
15611;Žemuogėlė;Šviesuliukai;8890454460;Taip;9;0;0;9
15612;Žemuogėlė;Šviesuliukai;7288060676;Taip;26;0;0;26
15613;Žemuogėlė;Šviesuliukai;6086270618;Taip;9;6;0;15
15614;Žemuogėlė;Lašiukai;1251497003;Taip;0;5;2;7
15615;Žemuogėlė;Lašiukai;3706531223;Taip;0;4;0;4
15616;Žemuogėlė;Lašiukai;8029484123;Taip;11;1;0;12
15617;Žemuogėlė;Lašiukai;5992802843;Taip;3;3;0;6
15618;Žemuogėlė;Lašiukai;3753156044;Taip;0;4;0;4
15619;Žemuogėlė;Lašiukai;7592566602;Taip;0;4;1;5
15620;Žemuogėlė;Lašiukai;1555899448;Taip;0;4;0;4
15621;Žemuogėlė;Lašiukai;1953538445;Taip;17;0;0;17
15622;Žemuogėlė;Lašiukai;3546429231;Taip;4;8;0;12
15623;Žemuogėlė;Lašiukai;9579921777;Taip;11;0;1;12
15624;Žemuogėlė;Lašiukai;3073956225;Taip;16;1;0;17
15625;Žemuogėlė;Lašiukai;9693814425;Taip;6;0;0;6
15626;Žemuogėlė;Lašiukai;3825509486;Taip;13;0;1;14
15627;Žemuogėlė;Lašiukai;3059525247;Taip;0;6;1;7
15628;Žemuogėlė;Lašiukai;6747566307;Taip;2;4;0;6
15629;Žemuogėlė;Lašiukai;2115883173;Taip;22;0;2;24
15630;Žemuogėlė;Skambaliukai;54663750186;Taip;0;6;0;6
15631;Žemuogėlė;Skambaliukai;4231767115;Taip;0;2;0;2
15632;Žemuogėlė;Skambaliukai;3977351017;Taip;0;2;0;2
15633;Žemuogėlė;Skambaliukai;3854265246;Ne;0;2;0;2
15634;Žemuogėlė;Skambaliukai;5147617128;Taip;0;15;0;15
15635;Žemuogėlė;Skambaliukai;1058207935;Taip;7;3;0;10
15636;Žemuogėlė;Skambaliukai;1628749648;Taip;10;1;0;11
15637;Žemuogėlė;Skambaliukai;6962103028;Taip;0;7;0;7
15638;Žemuogėlė;Skambaliukai;7714826773;Taip;0;5;3;8
15639;Žemuogėlė;Skambaliukai;3134493860;Taip;0;8;0;8
15640;Žemuogėlė;Skambaliukai;1907004376;Taip;5;1;0;6
15641;Žemuogėlė;Skambaliukai;38870047353;Taip;0;1;0;1
15642;Žemuogėlė;Skambaliukai;7403172794;Taip;0;4;0;4
15643;Žemuogėlė;Skambaliukai;9315711142;Taip;0;7;0;7
15644;Žemuogėlė;Skambaliukai;2102057496;Taip;0;8;0;8
15645;Žemuogėlė;Skambaliukai;4421397490;Taip;0;6;3;9
15646;Žemuogėlė;Skambaliukai;94792383091;Taip;5;15;0;20
15647;Žemuogėlė;Spinduliukai;3411390558;Taip;7;2;0;9
15648;Žemuogėlė;Spinduliukai;9955429241;Taip;0;0;7;7
15649;Žemuogėlė;Spinduliukai;5971652934;Taip;5;11;0;16
15650;Žemuogėlė;Spinduliukai;5127370193;Taip;0;0;5;5
15651;Žemuogėlė;Spinduliukai;1049009199;Taip;0;6;0;6
15652;Žemuogėlė;Spinduliukai;4578291476;Taip;10;13;0;23
15653;Žemuogėlė;Spinduliukai;5126348190;Taip;4;3;0;7
15654;Žemuogėlė;Spinduliukai;9534937419;Taip;0;8;0;8
15655;Žemuogėlė;Spinduliukai;2481547868;Taip;0;3;0;3
15656;Žemuogėlė;Spinduliukai;3612833383;Taip;17;1;0;18
15657;Žemuogėlė;Spinduliukai;9689082202;Taip;8;3;0;11
15658;Žemuogėlė;Spinduliukai;6707522989;Taip;4;7;0;11
15659;Žemuogėlė;Spinduliukai;6059069293;Taip;0;18;0;18
15660;Žemuogėlė;Spinduliukai;5770044886;Taip;6;11;0;17
15661;Žemuogėlė;Spinduliukai;7669457695;Ne;0;1;3;4
15662;Žemuogėlė;Spinduliukai;3041461125;Taip;0;6;2;8
15663;Žemuogėlė;Spinduliukai;8675089149;Taip;0;2;0;2
15664;Žemuogėlė;Spinduliukai;4933948491;Taip;3;2;6;11
15665;Žemuogėlė;Perliukai;4629107942;Ne;15;6;0;21
15666;Žemuogėlė;Perliukai;1306065826;Taip;0;2;0;2
15667;Žemuogėlė;Perliukai;8106709288;Taip;9;3;0;12
15668;Žemuogėlė;Perliukai;2664267604;Taip;10;7;0;17
15669;Žemuogėlė;Perliukai;1060986850;Taip;7;1;0;8
15670;Žemuogėlė;Perliukai;7794377881;Taip;12;2;0;14
15671;Žemuogėlė;Perliukai;1658954821;Taip;5;3;0;8
15672;Žemuogėlė;Perliukai;4698671798;Taip;5;1;1;7
15673;Žemuogėlė;Perliukai;2922827304;Taip;5;4;0;9
15674;Žemuogėlė;Perliukai;7415364637;Taip;0;4;0;4
15675;Žemuogėlė;Perliukai;3710681463;Taip;0;1;0;1
15676;Žemuogėlė;Perliukai;1796489729;Taip;10;2;0;12
15677;Žemuogėlė;Perliukai;8215763877;Taip;6;3;0;9
15678;Žemuogėlė;Perliukai;2934225120;Taip;5;5;1;11
15679;Žemuogėlė;Perliukai;3426685084;Taip;13;1;3;17
15680;Žemuogėlė;Perliukai;9150335499;Taip;17;4;0;21
15681;Žemuogėlė;Perliukai;1079114347;Taip;11;4;0;15
15682;Žemuogėlė;Perliukai;5902241163;Ne;0;1;0;1
15683;Žemuogėlė;Perliukai;7879519193;Taip;9;4;0;13
15684;Žemuogėlė;Perliukai;2109195565;Taip;13;3;0;16
15685;Žemuogėlė;Drugeliai;2745609317;Taip;2;0;0;2
15686;Žemuogėlė;Drugeliai;9694133286;Taip;0;3;0;3
15687;Žemuogėlė;Drugeliai;5557409350;Taip;2;11;0;13
15688;Žemuogėlė;Drugeliai;7668200447;Taip;0;3;0;3
15689;Žemuogėlė;Drugeliai;7148244029;Taip;0;4;0;4
15690;Žemuogėlė;Drugeliai;1901423257;Taip;0;4;0;4
15691;Žemuogėlė;Drugeliai;4862145385;Taip;6;6;0;12
15692;Žemuogėlė;Drugeliai;4368183799;Taip;3;2;0;5
15693;Žemuogėlė;Drugeliai;9902953729;Taip;9;8;0;17
15694;Žemuogėlė;Drugeliai;9537297860;Taip;8;3;0;11
15695;Žemuogėlė;Drugeliai;5170205929;Taip;0;9;0;9
15696;Žemuogėlė;Drugeliai;2428043195;Taip;3;0;0;3
15697;Žemuogėlė;Drugeliai;1716114524;Taip;20;0;0;20
15698;Žemuogėlė;Drugeliai;8137567729;Taip;11;1;0;12
15699;Žemuogėlė;Drugeliai;8348185761;Taip;16;6;0;22
15700;Žemuogėlė;Drugeliai;9273896998;Taip;19;0;0;19
15701;Žemuogėlė;"VIEVERSIUKAI ";8048818368;Taip;4;0;0;4
15702;Žemuogėlė;"VIEVERSIUKAI ";6577040746;Taip;3;5;0;8
15703;Žemuogėlė;"VIEVERSIUKAI ";9872387354;Taip;8;0;0;8
15704;Žemuogėlė;"VIEVERSIUKAI ";2674188340;Taip;8;4;0;12
15705;Žemuogėlė;"VIEVERSIUKAI ";5300388726;Taip;0;2;0;2
15706;Žemuogėlė;"VIEVERSIUKAI ";7823828526;Taip;7;0;1;8
15707;Žemuogėlė;"VIEVERSIUKAI ";4172356209;Taip;13;1;0;14
15708;Žemuogėlė;"VIEVERSIUKAI ";6379837644;Taip;3;3;0;6
15709;Žemuogėlė;"VIEVERSIUKAI ";3104276726;Taip;8;3;1;12
15710;Žemuogėlė;"VIEVERSIUKAI ";3419907292;Taip;26;0;0;26
15711;Žemuogėlė;"VIEVERSIUKAI ";7323868051;Taip;0;6;0;6
15712;Žemuogėlė;"VIEVERSIUKAI ";2800160529;Taip;13;4;0;17
15713;Žemuogėlė;"VIEVERSIUKAI ";8934779062;Taip;21;0;0;21
15714;Žemuogėlė;"VIEVERSIUKAI ";3090630899;Taip;11;0;0;11
15715;Žemuogėlė;"VIEVERSIUKAI ";8091000121;Taip;0;7;0;7
15716;Žemuogėlė;"VIEVERSIUKAI ";2110963483;Taip;26;0;0;26
15717;Žemuogėlė;"NYKŠTUKAI ";1002937953;Taip;4;0;0;4
15718;Žemuogėlė;"NYKŠTUKAI ";6504659145;Ne;9;0;0;9
15719;Žemuogėlė;"NYKŠTUKAI ";3505090532;Taip;8;0;1;9
15720;Žemuogėlė;"NYKŠTUKAI ";5208043522;Ne;4;0;0;4
15721;Žemuogėlė;"NYKŠTUKAI ";3740127955;Taip;7;0;0;7
15722;Žemuogėlė;"NYKŠTUKAI ";5614510812;Taip;12;0;0;12
15723;Žemuogėlė;"NYKŠTUKAI ";4089939292;Taip;3;0;0;3
15724;Žemuogėlė;"NYKŠTUKAI ";9584172565;Ne;10;7;2;19
15725;Žemuogėlė;"NYKŠTUKAI ";8706379207;Taip;10;0;0;10
15726;Žemuogėlė;"NYKŠTUKAI ";1790341419;Taip;5;3;3;11
15727;Žemuogėlė;"NYKŠTUKAI ";4998981337;Taip;5;0;0;5
15728;Žemuogėlė;"NYKŠTUKAI ";6045257180;Taip;3;0;1;4
15729;Žemuogėlė;"NYKŠTUKAI ";8301927361;Taip;11;0;0;11
15730;Žemuogėlė;"NYKŠTUKAI ";2496321184;Taip;10;3;0;13
15731;Žemuogėlė;"NYKŠTUKAI ";8490643028;Taip;27;0;0;27
15732;Žemuogėlė;"NYKŠTUKAI ";2139102266;Taip;8;4;1;13
15733;Žemuogėlė;"NYKŠTUKAI ";9735379466;Taip;21;0;0;21
15734;Žemuogėlė;KIŠKUČIAI;4654060157;Taip;0;4;7;11
15735;Žemuogėlė;KIŠKUČIAI;2652630375;Taip;3;3;3;9
15736;Žemuogėlė;KIŠKUČIAI;1250186598;Taip;12;5;0;17
15737;Žemuogėlė;KIŠKUČIAI;3287415964;Ne;8;4;0;12
15738;Žemuogėlė;KIŠKUČIAI;5094867109;Taip;0;3;1;4
15739;Žemuogėlė;KIŠKUČIAI;5186248897;Taip;22;4;0;26
15740;Žemuogėlė;KIŠKUČIAI;5125826172;Taip;0;10;0;10
15741;Žemuogėlė;KIŠKUČIAI;8262862183;Taip;12;5;0;17
15742;Žemuogėlė;KIŠKUČIAI;8798113318;Taip;0;2;1;3
15743;Žemuogėlė;KIŠKUČIAI;1280794094;Taip;0;5;0;5
15744;Žemuogėlė;KIŠKUČIAI;2251142510;Taip;11;1;0;12
15745;Žemuogėlė;KIŠKUČIAI;4974793430;Taip;3;3;5;11
15746;Žemuogėlė;KIŠKUČIAI;6659616731;Taip;7;5;0;12
15747;Žemuogėlė;KIŠKUČIAI;3459960812;Taip;3;3;0;6
15748;Žemuogėlė;Žiniukai;7804015060;Taip;0;8;0;8
15749;Žemuogėlė;Žiniukai;3765022476;Taip;3;4;0;7
15750;Žemuogėlė;Žiniukai;9476688736;Taip;5;4;2;11
15751;Žemuogėlė;Žiniukai;2001471529;Taip;0;3;0;3
15752;Žemuogėlė;Žiniukai;9519563708;Taip;0;7;0;7
15753;Žemuogėlė;Žiniukai;5266493632;Taip;5;3;0;8
15754;Žemuogėlė;Žiniukai;2841634296;Taip;0;5;0;5
15755;Žemuogėlė;Žiniukai;3237083654;Taip;7;5;0;12
15756;Žemuogėlė;Žiniukai;2259779058;Taip;0;6;0;6
15757;Žemuogėlė;Žiniukai;9693894254;Ne;11;7;0;18
15758;Žemuogėlė;Žiniukai;9378432383;Taip;5;4;0;9
15759;Žemuogėlė;Žiniukai;6073971598;Taip;0;5;1;6
15760;Žemuogėlė;Žiniukai;6913038845;Taip;0;8;0;8
15761;Žemuogėlė;Žiniukai;6581889641;Taip;0;6;1;7
15762;Žemuogėlė;Žiniukai;2555902309;Taip;10;5;0;15
15763;Žemuogėlė;Žiniukai;8757701456;Taip;8;6;0;14
15764;Žemuogėlė;Žiniukai;2132549536;Taip;0;9;0;9
15765;Žemuogėlė;Žiniukai;5532053268;Taip;2;4;0;6
15766;Žemuogėlė;Žiniukai;8496353410;Taip;0;14;0;14
15767;Žemuogėlė;Žiniukai;1733808230;Taip;0;8;0;8
15768;Žemuogėlė;Žiniukai;4660479216;Taip;7;3;1;11
15769;Žemuogėlė;Žiniukai;1469759840;Taip;4;1;0;5
15770;Žibutė;PELĖDŽIUKAI;3496675605;Taip;8;4;0;12
15771;Žibutė;PELĖDŽIUKAI;59824395612;Taip;5;3;1;9
15772;Žibutė;PELĖDŽIUKAI;2361682400;Taip;0;3;2;5
15773;Žibutė;PELĖDŽIUKAI;1826763192;Taip;3;0;0;3
15774;Žibutė;PELĖDŽIUKAI;1259481487;Taip;0;3;0;3
15775;Žibutė;PELĖDŽIUKAI;3826875107;Taip;7;5;0;12
15776;Žibutė;PELĖDŽIUKAI;3186792146;Taip;5;3;1;9
15777;Žibutė;PELĖDŽIUKAI;7344095020;Taip;4;3;0;7
15778;Žibutė;PELĖDŽIUKAI;1078105287;Taip;0;4;0;4
15779;Žibutė;PELĖDŽIUKAI;2152452830;Taip;3;1;5;9
15780;Žibutė;PELĖDŽIUKAI;1394895695;Taip;0;3;0;3
15781;Žibutė;PELĖDŽIUKAI;2236930916;Taip;0;3;6;9
15782;Žibutė;PELĖDŽIUKAI;7095870173;Taip;5;4;0;9
15783;Žibutė;PELĖDŽIUKAI;2840754631;Taip;4;3;0;7
15784;Žibutė;PELĖDŽIUKAI;6089325755;Taip;6;0;2;8
15785;Žibutė;PELĖDŽIUKAI;1274409680;Taip;5;3;4;12
15786;Žibutė;PELĖDŽIUKAI;8278928396;Taip;2;3;3;8
15787;Žibutė;PELĖDŽIUKAI;2957525481;Taip;14;0;0;14
15788;Žibutė;PELĖDŽIUKAI;3191351976;Taip;0;3;2;5
15789;Žibutė;PELĖDŽIUKAI;6495108202;Taip;0;3;0;3
15790;Žibutė;KREGŽDUTĖS;7036454359;Taip;4;0;3;7
15791;Žibutė;KREGŽDUTĖS;2406005105;Taip;0;0;5;5
15792;Žibutė;KREGŽDUTĖS;3555071718;Taip;0;0;4;4
15793;Žibutė;KREGŽDUTĖS;5412917352;Taip;3;0;3;6
15794;Žibutė;KREGŽDUTĖS;5187777741;Taip;0;0;2;2
15795;Žibutė;KREGŽDUTĖS;5190377896;Taip;18;0;0;18
15796;Žibutė;KREGŽDUTĖS;6013340521;Taip;0;0;1;1
15797;Žibutė;KREGŽDUTĖS;3574946816;Taip;0;3;0;3
15798;Žibutė;KREGŽDUTĖS;6194464236;Taip;0;0;8;8
15799;Žibutė;KREGŽDUTĖS;3777544301;Taip;0;8;0;8
15800;Žibutė;KREGŽDUTĖS;9923687090;Taip;0;0;14;14
15801;Žibutė;KREGŽDUTĖS;4847295068;Taip;0;0;7;7
15802;Žibutė;KREGŽDUTĖS;9700866512;Taip;0;4;0;4
15803;Žibutė;KREGŽDUTĖS;7774532200;Taip;0;7;0;7
15804;Žibutė;KREGŽDUTĖS;2607509585;Taip;0;3;0;3
15805;Žibutė;KREGŽDUTĖS;8944042589;Taip;0;0;5;5
15806;Žibutė;KREGŽDUTĖS;2438980348;Taip;0;3;1;4
15807;Žibutė;KREGŽDUTĖS;9918283923;Taip;1;0;0;1
15808;Žibutė;KREGŽDUTĖS;5126232169;Taip;0;3;10;13
15809;Žibutė;KREGŽDUTĖS;8792292819;Taip;18;0;0;18
15810;Žibutė;KREGŽDUTĖS;7668484415;Taip;7;8;0;15
15811;Žibutė;KREGŽDUTĖS;2516448580;Taip;0;0;6;6
15812;Žibutė;BORUŽĖLĖS;4278832423;Taip;0;3;0;3
15813;Žibutė;BORUŽĖLĖS;3066580779;Taip;8;3;0;11
15814;Žibutė;BORUŽĖLĖS;1786332689;Taip;3;0;5;8
15815;Žibutė;BORUŽĖLĖS;2910188022;Taip;0;0;3;3
15816;Žibutė;BORUŽĖLĖS;8879347884;Taip;0;0;9;9
15817;Žibutė;BORUŽĖLĖS;7764376193;Taip;0;0;3;3
15818;Žibutė;BORUŽĖLĖS;3618347199;Taip;2;4;0;6
15819;Žibutė;BORUŽĖLĖS;5186839413;Taip;0;2;2;4
15820;Žibutė;BORUŽĖLĖS;2374119662;Taip;0;7;0;7
15821;Žibutė;BORUŽĖLĖS;1381488132;Taip;0;0;5;5
15822;Žibutė;BORUŽĖLĖS;5591970907;Taip;6;3;0;9
15823;Žibutė;BORUŽĖLĖS;6672033757;Taip;0;4;0;4
15824;Žibutė;BORUŽĖLĖS;7481695788;Taip;4;0;1;5
15825;Žibutė;BORUŽĖLĖS;1112295932;Taip;5;5;0;10
15826;Žibutė;BORUŽĖLĖS;8155327668;Taip;10;3;0;13
15827;Žibutė;BORUŽĖLĖS;5632520305;Taip;9;0;2;11
15828;Žibutė;BORUŽĖLĖS;4622674814;Taip;7;0;3;10
15829;Žibutė;BORUŽĖLĖS;7805758264;Taip;0;4;0;4
15830;Žibutė;BORUŽĖLĖS;8640664660;Taip;5;0;0;5
15831;Žibutė;BITUTĖS;7023683517;Taip;4;1;0;5
15832;Žibutė;BITUTĖS;7853531467;Taip;0;3;0;3
15833;Žibutė;BITUTĖS;3687123871;Taip;9;0;0;9
15834;Žibutė;BITUTĖS;2312717334;Taip;2;3;0;5
15835;Žibutė;BITUTĖS;6361543454;Taip;17;0;0;17
15836;Žibutė;BITUTĖS;1297347740;Taip;0;3;0;3
15837;Žibutė;BITUTĖS;6934760468;Taip;9;4;0;13
15838;Žibutė;BITUTĖS;4455757640;Taip;0;1;4;5
15839;Žibutė;BITUTĖS;8797870379;Taip;4;0;0;4
15840;Žibutė;BITUTĖS;7792267540;Taip;0;2;1;3
15841;Žibutė;BITUTĖS;9221523836;Taip;14;2;0;16
15842;Žibutė;BITUTĖS;3632745935;Taip;8;4;0;12
15843;Žibutė;BITUTĖS;7611641692;Taip;0;5;0;5
15844;Žibutė;BITUTĖS;5112512917;Taip;0;2;1;3
15845;Žibutė;BITUTĖS;8276724226;Taip;13;0;0;13
15846;Žibutė;BITUTĖS;4685356158;Taip;0;0;4;4
15847;Žibutė;BITUTĖS;1515636796;Taip;0;4;0;4
15848;Žibutė;BITUTĖS;7872636200;Taip;12;1;0;13
15849;Žibutė;BITUTĖS;6833179680;Taip;0;15;3;18
15850;Žibutė;BITUTĖS;1614551884;Taip;7;2;2;11
15851;Žibutė;KAČIUKAI;6978977383;Taip;0;3;0;3
15852;Žibutė;KAČIUKAI;9634311146;Taip;0;3;0;3
15853;Žibutė;KAČIUKAI;9868621666;Ne;0;0;4;4
15854;Žibutė;KAČIUKAI;1366469428;Taip;3;1;0;4
15855;Žibutė;KAČIUKAI;4825064521;Taip;0;0;11;11
15856;Žibutė;KAČIUKAI;5826523148;Taip;0;1;3;4
15857;Žibutė;KAČIUKAI;4382812297;Taip;0;0;3;3
15858;Žibutė;KAČIUKAI;5591698130;Taip;0;3;1;4
15859;Žibutė;KAČIUKAI;1004098038;Taip;0;0;1;1
15860;Žibutė;KAČIUKAI;2880593326;Taip;0;0;1;1
15861;Žibutė;KAČIUKAI;7479437931;Taip;0;7;0;7
15862;Žibutė;KAČIUKAI;1362419302;Taip;0;2;2;4
15863;Žibutė;KAČIUKAI;7531027545;Taip;6;0;2;8
15864;Žibutė;KAČIUKAI;3645481894;Taip;1;3;0;4
15865;Žibutė;KAČIUKAI;8880329060;Taip;0;3;1;4
15866;Žibutė;KAČIUKAI;5009495840;Taip;0;3;0;3
15867;Žibutė;KAČIUKAI;7136145033;Taip;8;0;1;9
15868;Žibutė;KAČIUKAI;9498011134;Taip;0;5;0;5
15869;Žibutė;KAČIUKAI;5677389434;Taip;0;4;0;4
15870;Žibutė;KAČIUKAI;5416015554;Taip;0;0;6;6
15871;Žibutė;KAČIUKAI;6074488747;Taip;0;0;1;1
15872;Žibutė;ZUIKIAI;4741505387;Taip;19;0;0;19
15873;Žibutė;ZUIKIAI;6209156111;Taip;0;8;0;8
15874;Žibutė;ZUIKIAI;2787326978;Taip;1;0;13;14
15875;Žibutė;ZUIKIAI;9856822557;Taip;9;1;0;10
15876;Žibutė;ZUIKIAI;4787010953;Taip;4;2;3;9
15877;Žibutė;ZUIKIAI;3875455223;Taip;8;5;0;13
15878;Žibutė;ZUIKIAI;3449188614;Taip;11;0;2;13
15879;Žibutė;ZUIKIAI;4434623264;Taip;4;8;0;12
15880;Žibutė;ZUIKIAI;9769180056;Taip;6;0;0;6
15881;Žibutė;ZUIKIAI;2013724729;Taip;12;0;0;12
15882;Žibutė;ZUIKIAI;3786933891;Taip;9;1;0;10
15883;Žibutė;ZUIKIAI;9379539151;Taip;1;1;0;2
15884;Žibutė;ZUIKIAI;9439026609;Taip;11;9;0;20
15885;Žibutė;ZUIKIAI;6234135622;Taip;11;1;0;12
15886;Žiedas;Bitutės;1484464986;Taip;0;3;5;8
15887;Žiedas;Bitutės;4807479784;Taip;0;5;0;5
15888;Žiedas;Bitutės;6945326867;Taip;0;3;2;5
15889;Žiedas;Bitutės;5513311280;Taip;0;3;2;5
15890;Žiedas;Bitutės;1529988412;Taip;0;3;0;3
15891;Žiedas;Bitutės;1007894628;Taip;0;7;1;8
15892;Žiedas;Bitutės;1625009666;Taip;0;3;0;3
15893;Žiedas;Bitutės;1550350520;Taip;5;4;0;9
15894;Žiedas;Bitutės;9058688663;Taip;0;9;0;9
15895;Žiedas;Bitutės;7150433256;Taip;0;3;4;7
15896;Žiedas;Bitutės;3414702993;Taip;0;6;0;6
15897;Žiedas;Bitutės;1824692620;Taip;5;3;0;8
15898;Žiedas;Bitutės;2507543124;Taip;5;11;0;16
15899;Žiedas;Bitutės;88471315730;Taip;0;3;0;3
15900;Žiedas;Bitutės;34193530;Taip;0;4;0;4
15901;Žiedas;Bitutės;69485023219;Taip;0;3;0;3
15902;Žiedas;Bitutės;86877563124;Taip;5;3;1;9
15903;Žiedas;Bitutės;78720591915;Taip;0;3;0;3
15904;Žiedas;Bitutės;2026728639;Taip;0;1;0;1
15905;Žiedas;Bitutės;5108263139;Taip;4;3;0;7
15906;Žiedas;Bitutės;5885209631;Taip;0;3;5;8
15907;Žiedas;Bitutės;1737296046;Taip;0;3;1;4
15908;Žiedas;Bitutės;1048272199;Taip;0;8;0;8
15909;Žiedas;Bitutės;5007348884;Ne;0;4;0;4
15910;Žiedas;Varpeliai;7097790025;Taip;0;4;1;5
15911;Žiedas;Varpeliai;3230107921;Taip;0;3;0;3
15912;Žiedas;Varpeliai;3178778438;Taip;8;3;1;12
15913;Žiedas;Varpeliai;9602083568;Taip;11;3;0;14
15914;Žiedas;Varpeliai;5628720422;Taip;0;1;0;1
15915;Žiedas;Varpeliai;1582961378;Taip;7;3;0;10
15916;Žiedas;Varpeliai;1878050384;Ne;0;3;0;3
15917;Žiedas;Varpeliai;6882614465;Taip;0;4;0;4
15918;Žiedas;Varpeliai;5578227349;Taip;2;3;0;5
15919;Žiedas;Varpeliai;6914059680;Taip;5;3;0;8
15920;Žiedas;Varpeliai;7771247056;Taip;0;3;0;3
15921;Žiedas;Varpeliai;6515510381;Taip;5;1;0;6
15922;Žiedas;Varpeliai;3842589827;Taip;5;3;3;11
15923;Žiedas;Varpeliai;5835309107;Taip;0;5;2;7
15924;Žiedas;Varpeliai;3387263016;Taip;5;5;1;11
15925;Žiedas;Varpeliai;3178580610;Taip;0;4;1;5
15926;Žiedas;Varpeliai;1043230748;Taip;0;3;2;5
15927;Žiedas;Varpeliai;5061575884;Taip;0;7;0;7
15928;Žiedas;Varpeliai;1333233100;Taip;1;3;1;5
15929;Žiedas;Varpeliai;9020540780;Taip;0;2;1;3
15930;Žiedas;Varpeliai;8148831014;Taip;0;3;3;6
15931;Žiedas;Varpeliai;9140396365;Taip;0;2;1;3
15932;Žiedas;Ramunėlės;3055218791;Taip;1;4;0;5
15933;Žiedas;Ramunėlės;1333555044;Taip;4;3;0;7
15934;Žiedas;Ramunėlės;2092319455;Taip;2;9;0;11
15935;Žiedas;Ramunėlės;5789261620;Taip;8;1;0;9
15936;Žiedas;Ramunėlės;8753972322;Taip;0;4;0;4
15937;Žiedas;Ramunėlės;3900091129;Ne;0;3;0;3
15938;Žiedas;Ramunėlės;2515028280;Taip;0;8;0;8
15939;Žiedas;Ramunėlės;1583038469;Taip;0;8;0;8
15940;Žiedas;Ramunėlės;8208331527;Taip;10;4;0;14
15941;Žiedas;Ramunėlės;9037835899;Taip;4;3;0;7
15942;Žiedas;Ramunėlės;5577339739;Taip;12;3;0;15
15943;Žiedas;Ramunėlės;6884933845;Taip;0;3;0;3
15944;Žiedas;Ramunėlės;7548653053;Taip;6;4;0;10
15945;Žiedas;Ramunėlės;1659873036;Taip;7;4;0;11
15946;Žiedas;Ramunėlės;2843328732;Taip;4;0;3;7
15947;Žiedas;Ramunėlės;1243169901;Taip;6;1;0;7
15948;Žiedas;Ramunėlės;1580781723;Taip;8;5;0;13
15949;Žiedas;Ramunėlės;5920211041;Ne;0;3;0;3
15950;Žiedas;Ramunėlės;4933650089;Taip;0;6;0;6
15951;Žiedas;Ramunėlės;4044156905;Taip;8;3;1;12
15952;Žiedas;Ramunėlės;4844442247;Taip;5;7;0;12
15953;Žiedas;Ramunėlės;7294671324;Taip;0;3;0;3
15954;Žiedas;Ramunėlės;8812316692;Taip;5;4;0;9
15955;Žiedas;Pakalnutės;7798930533;Taip;5;6;0;11
15956;Žiedas;Pakalnutės;1094506858;Taip;0;6;0;6
15957;Žiedas;Pakalnutės;9375048835;Taip;0;7;0;7
15958;Žiedas;Pakalnutės;5266048033;Taip;9;4;0;13
15959;Žiedas;Pakalnutės;5804334198;Taip;0;2;3;5
15960;Žiedas;Pakalnutės;1721956438;Ne;9;2;0;11
15961;Žiedas;Pakalnutės;4808020243;Taip;0;5;0;5
15962;Žiedas;Pakalnutės;3742949697;Taip;10;3;0;13
15963;Žiedas;Pakalnutės;6343634478;Taip;5;4;0;9
15964;Žiedas;Pakalnutės;8015880569;Taip;9;2;0;11
15965;Žiedas;Pakalnutės;8857150598;Taip;11;3;0;14
15966;Žiedas;Pakalnutės;2416234016;Taip;10;4;0;14
15967;Žiedas;Pakalnutės;9054709268;Taip;0;1;0;1
15968;Žiedas;Pakalnutės;9964883646;Taip;2;4;0;6
15969;Žiedas;Pakalnutės;4917324037;Taip;5;6;0;11
15970;Žiedas;Pakalnutės;4021189767;Taip;6;4;0;10
15971;Žiedas;Pakalnutės;1346658299;Taip;10;4;0;14
15972;Žiedas;Pakalnutės;4663390744;Taip;5;3;0;8
15973;Žiedas;Pakalnutės;4697477761;Taip;8;3;0;11
15974;Žiedas;Pakalnutės;7678333395;Taip;0;5;0;5
15975;Žiedas;Pakalnutės;9207945616;Taip;10;3;0;13
15976;Žiedas;Pakalnutės;7221702677;Taip;0;6;0;6
15977;Žiedas;Pakalnutės;2393112381;Taip;0;6;0;6
15978;Žiedas;Rožytės;8645771800;Taip;14;1;0;15
15979;Žiedas;Rožytės;7942276632;Taip;6;3;0;9
15980;Žiedas;Rožytės;7799489700;Taip;0;16;0;16
15981;Žiedas;Rožytės;8163645535;Taip;10;2;0;12
15982;Žiedas;Rožytės;8927034492;Taip;0;3;15;18
15983;Žiedas;Rožytės;2182381160;Taip;0;4;0;4
15984;Žiedas;Rožytės;8822472312;Taip;0;7;0;7
15985;Žiedas;Rožytės;9021286246;Taip;0;3;0;3
15986;Žiedas;Rožytės;6261847845;Taip;0;5;0;5
15987;Žiedas;Rožytės;5020148822;Taip;0;3;0;3
15988;Žiedas;Rožytės;1777501190;Taip;9;0;0;9
15989;Žiedas;Rožytės;1844621525;Ne;0;2;0;2
15990;Žiedas;Rožytės;1219634640;Taip;0;3;0;3
15991;Žiedas;Rožytės;6459679214;Taip;10;4;0;14
15992;Žiedas;Rožytės;7672879525;Taip;0;3;0;3
15993;Žiedas;Rožytės;6175213274;Taip;0;3;0;3
15994;Žiedas;Rožytės;3984607857;Taip;0;5;1;6
15995;Žiedas;Rožytės;6041919197;Taip;0;3;0;3
15996;Žiedas;Pumpurėliai;5830738378;Taip;0;3;0;3
15997;Žiedas;Pumpurėliai;2320543511;Taip;0;5;0;5
15998;Žiedas;Pumpurėliai;4360175072;Taip;8;3;5;16
15999;Žiedas;Pumpurėliai;9238553024;Taip;0;5;0;5
16000;Žiedas;Pumpurėliai;7780469974;Taip;8;4;0;12
16001;Žiedas;Pumpurėliai;8056265378;Taip;0;3;15;18
16002;Žiedas;Pumpurėliai;9337317396;Taip;2;4;0;6
16003;Žiedas;Pumpurėliai;8088806507;Taip;0;1;0;1
16004;Žiedas;Pumpurėliai;1086714229;Taip;18;0;0;18
16005;Žiedas;Pumpurėliai;2320411618;Taip;0;5;0;5
16006;Žiedas;Pumpurėliai;5635958124;Taip;0;10;0;10
16007;Žiedas;Pumpurėliai;7677595571;Taip;18;0;0;18
16008;Žiedas;Pumpurėliai;4699833757;Taip;9;1;0;10
16009;Žiedas;Pumpurėliai;2633676360;Taip;0;3;1;4
16010;Žiedas;Pumpurėliai;8797245208;Ne;6;3;1;10
16011;Žiedas;"Dobiliukai ";6066566242;Taip;5;4;0;9
16012;Žiedas;"Dobiliukai ";8436592169;Taip;0;3;0;3
16013;Žiedas;"Dobiliukai ";3654878543;Taip;5;5;0;10
16014;Žiedas;"Dobiliukai ";8794003030;Taip;0;2;0;2
16015;Žiedas;"Dobiliukai ";8444690698;Taip;15;3;0;18
16016;Žiedas;"Dobiliukai ";2715554681;Taip;18;0;0;18
16017;Žiedas;"Dobiliukai ";2132564079;Taip;10;3;0;13
16018;Žiedas;"Dobiliukai ";9586578606;Taip;0;10;0;10
16019;Žiedas;"Dobiliukai ";3940002957;Taip;0;3;0;3
16020;Žiedas;"Dobiliukai ";5353507617;Taip;0;5;3;8
16021;Žiedas;"Dobiliukai ";4087903129;Taip;0;2;0;2
16022;Žiedas;"Dobiliukai ";8185042446;Taip;0;3;2;5
16023;Žiedas;"Dobiliukai ";7049399327;Taip;0;3;0;3
16024;Žiedas;"Dobiliukai ";5788152675;Taip;8;0;0;8
16025;Žiedas;"Dobiliukai ";2462497997;Taip;0;3;0;3
16026;Žiedas;"Dobiliukai ";8388297947;Taip;0;4;0;4
16027;Žiedas;"Dobiliukai ";3011163947;Taip;0;1;2;3
16028;Žiedas;"Dobiliukai ";6748378606;Taip;5;4;0;9
16029;Žiedas;"Dobiliukai ";7558307454;Taip;5;3;0;8
16030;Žiedas;"Dobiliukai ";6795173519;Taip;0;3;1;4
16031;Žiedas;RŪTELĖS;2134466899;Taip;5;3;0;8
16032;Žiedas;RŪTELĖS;6822887260;Taip;0;6;0;6
16033;Žiedas;RŪTELĖS;5914428064;Taip;5;6;0;11
16034;Žiedas;RŪTELĖS;3857121753;Taip;6;5;0;11
16035;Žiedas;RŪTELĖS;6443633568;Taip;0;5;0;5
16036;Žiedas;RŪTELĖS;7491134119;Taip;0;2;0;2
16037;Žiedas;RŪTELĖS;5959899914;Taip;0;7;0;7
16038;Žiedas;RŪTELĖS;7333813704;Taip;0;5;1;6
16039;Žiedas;RŪTELĖS;6658762922;Taip;0;3;0;3
16040;Žiedas;RŪTELĖS;5703750436;Taip;0;3;0;3
16041;Žiedas;RŪTELĖS;5126173608;Taip;4;5;0;9
16042;Žiedas;RŪTELĖS;1738121071;Taip;0;13;0;13
16043;Žiedas;RŪTELĖS;5420327672;Taip;0;7;0;7
16044;Žiedas;RŪTELĖS;1253833615;Taip;0;12;0;12
16045;Žiedas;RŪTELĖS;7172793351;Taip;0;3;0;3
16046;Žiedas;RŪTELĖS;4497634040;Taip;0;6;0;6
16047;Žiedas;RŪTELĖS;9218388800;Taip;9;4;0;13
16048;Žiedas;RŪTELĖS;7072578987;Taip;0;5;0;5
16049;Žiedas;RŪTELĖS;3715928992;Taip;3;4;1;8
16050;Žiedas;RŪTELĖS;9352485926;Taip;0;3;0;3
16051;Žiedas;RŪTELĖS;7578964555;Taip;0;5;0;5
16052;Žiedas;RŪTELĖS;5647232875;Taip;7;3;0;10
16053;Žiedas;RŪTELĖS;5928377774;Taip;8;3;0;11
16054;Žiedas;SAULĖGRĄŽOS;1011602827;Taip;0;2;0;2
16055;Žiedas;SAULĖGRĄŽOS;2932857132;Taip;4;3;1;8
16056;Žiedas;SAULĖGRĄŽOS;5552786845;Taip;0;5;2;7
16057;Žiedas;SAULĖGRĄŽOS;8833895006;Taip;0;8;0;8
16058;Žiedas;SAULĖGRĄŽOS;5658235821;Taip;8;3;0;11
16059;Žiedas;SAULĖGRĄŽOS;4992446383;Taip;5;3;0;8
16060;Žiedas;SAULĖGRĄŽOS;9057761408;Taip;0;3;0;3
16061;Žiedas;SAULĖGRĄŽOS;1645402434;Taip;0;3;0;3
16062;Žiedas;SAULĖGRĄŽOS;2026540724;Taip;0;5;0;5
16063;Žiedas;SAULĖGRĄŽOS;4564268323;Taip;0;12;0;12
16064;Žiedas;SAULĖGRĄŽOS;8801900486;Taip;0;3;6;9
16065;Žiedas;SAULĖGRĄŽOS;1609487830;Taip;0;4;0;4
16066;Žiedas;SAULĖGRĄŽOS;3437651010;Taip;0;3;3;6
16067;Žiedas;SAULĖGRĄŽOS;3422053505;Taip;0;2;0;2
16068;Žiedas;SAULĖGRĄŽOS;5274845525;Taip;0;5;1;6
16069;Žiedas;SAULĖGRĄŽOS;6053010050;Taip;0;5;1;6
16070;Žiedas;SAULĖGRĄŽOS;7057747531;Taip;0;1;0;1
16071;Žiedas;SAULĖGRĄŽOS;9685152753;Taip;0;3;5;8
16072;Žiedas;SAULĖGRĄŽOS;8819018248;Taip;0;4;0;4
16073;Žiedas;SAULĖGRĄŽOS;7604200899;Taip;0;3;0;3
16074;Žiedas;SAULĖGRĄŽOS;3303581707;Taip;0;4;0;4
16075;Žiedas;RUGIAGĖLĖS;1035854293;Taip;0;3;2;5
16076;Žiedas;RUGIAGĖLĖS;1917085385;Taip;0;3;0;3
16077;Žiedas;RUGIAGĖLĖS;5987689515;Taip;15;0;0;15
16078;Žiedas;RUGIAGĖLĖS;1826599535;Taip;0;3;0;3
16079;Žiedas;RUGIAGĖLĖS;2124086277;Taip;0;4;1;5
16080;Žiedas;RUGIAGĖLĖS;2642760082;Taip;0;7;0;7
16081;Žiedas;RUGIAGĖLĖS;1093479755;Taip;6;3;0;9
16082;Žiedas;RUGIAGĖLĖS;7381658912;Taip;0;4;1;5
16083;Žiedas;RUGIAGĖLĖS;2964286644;Ne;0;0;18;18
16084;Žiedas;RUGIAGĖLĖS;7228139235;Taip;0;3;1;4
16085;Žiedas;RUGIAGĖLĖS;2347857813;Taip;0;18;0;18
16086;Žiedas;RUGIAGĖLĖS;1975718197;Taip;0;3;0;3
16087;Žiedas;RUGIAGĖLĖS;2312361963;Taip;0;0;18;18
16088;Žiedas;RUGIAGĖLĖS;6859410675;Taip;12;1;0;13
16089;Žiedas;RUGIAGĖLĖS;2148027253;Taip;0;3;1;4
16090;Žiedas;RUGIAGĖLĖS;1758868055;Taip;0;3;0;3
16091;Žiedas;RUGIAGĖLĖS;2182340305;Taip;0;3;0;3
16092;Žiedas;RUGIAGĖLĖS;1958481432;Taip;0;3;1;4
16093;Žiedas;RUGIAGĖLĖS;3099608553;Taip;13;1;0;14
16094;Žiedas;RUGIAGĖLĖS;1390431397;Taip;0;1;0;1
16095;Žiedas;RUGIAGĖLĖS;9393499257;Taip;5;3;0;8
16096;Žiedas;RUGIAGĖLĖS;2170318597;Taip;0;5;0;5
16097;Žiedas;RUGIAGĖLĖS;8276022676;Taip;0;2;1;3
16098;Žiedas;RUGIAGĖLĖS;7584712202;Taip;11;0;0;11
16099;Žiedas;Boružėlės;7016509405;Taip;5;1;2;8
16100;Žiedas;Boružėlės;4922560649;Taip;5;3;0;8
16101;Žiedas;Boružėlės;6703889237;Taip;0;3;0;3
16102;Žiedas;Boružėlės;2095655987;Taip;5;0;0;5
16103;Žiedas;Boružėlės;7814504623;Taip;0;3;1;4
16104;Žiedas;Boružėlės;9648580306;Taip;0;5;0;5
16105;Žiedas;Boružėlės;9699668892;Taip;0;4;0;4
16106;Žiedas;Boružėlės;5653785844;Taip;0;4;0;4
16107;Žiedas;Boružėlės;9247088735;Taip;9;0;0;9
16108;Žiedas;Boružėlės;7396006218;Taip;0;5;0;5
16109;Žiedas;Boružėlės;5588136738;Taip;0;6;0;6
16110;Žiedas;Boružėlės;6786526552;Taip;11;3;0;14
16111;Žiedas;Boružėlės;2511423525;Taip;0;3;3;6
16112;Žiedas;Boružėlės;6432090199;Taip;0;4;0;4
16113;Žiedas;Boružėlės;5626494892;Taip;10;5;0;15
16114;Žiedas;Boružėlės;7708360056;Taip;0;3;4;7
16115;Žiedas;Boružėlės;7954517383;Taip;6;10;0;16
16116;Žiedas;Boružėlės;3702078720;Taip;12;3;0;15
16117;Žiedas;Boružėlės;2849254119;Taip;6;5;2;13
16118;Žiedas;Boružėlės;9736967156;Taip;0;5;1;6
16119;Žiedas;Boružėlės;3586376571;Taip;0;10;1;11
16120;Žiedas;Boružėlės;1139186052;Taip;0;3;2;5
16121;Žiedas;Boružėlės;3704491209;Taip;0;3;4;7
16122;Žiedas;AGUONĖLĖS;1885623466;Taip;11;3;0;14
16123;Žiedas;AGUONĖLĖS;9464217926;Taip;11;3;0;14
16124;Žiedas;AGUONĖLĖS;9543860953;Taip;8;3;0;11
16125;Žiedas;AGUONĖLĖS;3247328978;Taip;5;8;0;13
16126;Žiedas;AGUONĖLĖS;4250009129;Taip;9;3;0;12
16127;Žiedas;AGUONĖLĖS;7399937598;Taip;0;5;0;5
16128;Žiedas;AGUONĖLĖS;1325715061;Taip;0;3;0;3
16129;Žiedas;AGUONĖLĖS;9111149805;Taip;0;3;0;3
16130;Žiedas;AGUONĖLĖS;4695900874;Taip;0;3;0;3
16131;Žiedas;AGUONĖLĖS;3258241663;Taip;14;3;0;17
16132;Žiedas;AGUONĖLĖS;6700593422;Taip;10;5;0;15
16133;Žiedas;AGUONĖLĖS;3835714894;Taip;6;5;0;11
16134;Žiedas;AGUONĖLĖS;7535993061;Taip;4;2;0;6
16135;Žiedas;AGUONĖLĖS;1956219718;Taip;4;4;0;8
16136;Žiedas;AGUONĖLĖS;4809093267;Taip;4;5;0;9
16137;Žiedas;AGUONĖLĖS;1874460511;Taip;11;3;0;14
16138;Žiedas;AGUONĖLĖS;6245366671;Taip;0;5;0;5
16139;Žiedas;AGUONĖLĖS;6856477482;Taip;15;3;0;18
16140;Žiedas;ŽIBUTĖS;8638720939;Taip;5;3;0;8
16141;Žiedas;ŽIBUTĖS;3654749109;Taip;4;3;0;7
16142;Žiedas;ŽIBUTĖS;1835893385;Taip;10;3;0;13
16143;Žiedas;ŽIBUTĖS;2913328259;Taip;10;0;0;10
16144;Žiedas;ŽIBUTĖS;7418985667;Taip;12;3;0;15
16145;Žiedas;ŽIBUTĖS;4568189195;Taip;0;1;0;1
16146;Žiedas;ŽIBUTĖS;2097392327;Taip;0;3;2;5
16147;Žiedas;ŽIBUTĖS;9269909624;Taip;0;4;0;4
16148;Žiedas;ŽIBUTĖS;7114207461;Taip;5;3;3;11
16149;Žiedas;ŽIBUTĖS;5106427067;Taip;0;2;0;2
16150;Žiedas;ŽIBUTĖS;3407247493;Taip;18;0;0;18
16151;Žiedas;ŽIBUTĖS;8084555994;Taip;15;0;0;15
16152;Žiedas;ŽIBUTĖS;7613786936;Taip;10;3;5;18
16153;Žiedas;ŽIBUTĖS;6923562927;Taip;10;3;5;18
16154;Žiedas;ŽIBUTĖS;1669599543;Taip;15;3;0;18
16155;Žiedas;ŽIBUTĖS;1509140770;Taip;0;4;0;4
16156;Žiedas;ŽIBUTĖS;7498211984;Taip;10;3;0;13
16157;Žiedas;ŽIBUTĖS;3948942801;Taip;0;7;0;7
16158;Žiedas;DRUGELIAI;8517250094;Taip;0;8;0;8
16159;Žiedas;DRUGELIAI;9894489800;Taip;0;2;0;2
16160;Žiedas;DRUGELIAI;2763469583;Taip;0;4;0;4
16161;Žiedas;DRUGELIAI;9757771445;Taip;9;3;0;12
16162;Žiedas;DRUGELIAI;4222689492;Taip;0;3;0;3
16163;Žiedas;DRUGELIAI;2763996098;Taip;9;4;0;13
16164;Žiedas;DRUGELIAI;4983852075;Taip;0;3;0;3
16165;Žiedas;DRUGELIAI;9129315784;Taip;0;11;0;11
16166;Žiedas;DRUGELIAI;7952899220;Taip;0;4;0;4
16167;Žiedas;DRUGELIAI;2679205188;Ne;0;4;1;5
16168;Žiedas;DRUGELIAI;2026462074;Taip;1;3;0;4
16169;Žiedas;DRUGELIAI;4749655084;Taip;0;6;1;7
16170;Žiedas;DRUGELIAI;9587581470;Taip;0;3;0;3
16171;Žiedas;DRUGELIAI;9415269410;Taip;0;4;0;4
16172;Žilvitis;KREGŽDUTĖS;2340002881;Taip;3;0;0;3
16173;Žilvitis;BITUČIŲ;7054808979;Ne;6;0;0;6
16174;Žilvitis;SKRUZDĖLIUKAI;5152056691;Taip;4;0;0;4
16175;Žilvinėlio;PAUKŠTELIAI;2921485707;Taip;8;0;0;8
16176;Žilvinėlio;DREBULIUKAI;4621511107;Taip;10;0;0;10
16177;Žiogelis;SKRUZDELYTĖS;2959983278;Taip;11;2;0;13
16178;Žiogelis;SKRUZDELYTĖS;4677024422;Taip;0;1;3;4
16179;Žiogelis;SKRUZDELYTĖS;6165380986;Taip;0;3;0;3
16180;Žiogelis;SKRUZDELYTĖS;5281321968;Taip;0;3;0;3
16181;Žiogelis;SKRUZDELYTĖS;8410428124;Taip;8;0;0;8
16182;Žiogelis;SKRUZDELYTĖS;3214640817;Taip;0;13;0;13
16183;Žiogelis;SKRUZDELYTĖS;1937740173;Taip;0;10;0;10
16184;Žiogelis;SKRUZDELYTĖS;4115425880;Taip;0;4;0;4
16185;Žiogelis;SKRUZDELYTĖS;5737326104;Taip;9;0;0;9
16186;Žiogelis;SKRUZDELYTĖS;2614574694;Taip;0;4;0;4
16187;Žiogelis;SKRUZDELYTĖS;7107814348;Taip;5;7;0;12
16188;Žiogelis;SKRUZDELYTĖS;9243862028;Taip;0;6;0;6
16189;Žiogelis;SKRUZDELYTĖS;7395901559;Taip;0;3;8;11
16190;Žiogelis;SKRUZDELYTĖS;9819352425;Taip;7;3;1;11
16191;Žiogelis;SKRUZDELYTĖS;8780773039;Taip;0;11;0;11
16192;Žiogelis;SKRUZDELYTĖS;7881734492;Taip;0;0;2;2
16193;Žiogelis;SKRUZDELYTĖS;2701091043;Taip;0;6;0;6
16194;Žiogelis;SKRUZDELYTĖS;9120836406;Taip;0;3;2;5
16195;Žiogelis;SKRUZDELYTĖS;6742462116;Taip;6;3;0;9
16196;Žiogelis;SKRUZDELYTĖS;8763533677;Taip;12;0;0;12
16197;Žiogelis;SKRUZDELYTĖS;6608146625;Taip;11;0;0;11
16198;Žiogelis;SKRUZDELYTĖS;9035254979;Taip;7;3;1;11
16199;Žiogelis;ŽIRNIUKAI;2348525913;Taip;8;0;0;8
16200;Žiogelis;ŽIRNIUKAI;2771911603;Taip;3;1;0;4
16201;Žiogelis;ŽIRNIUKAI;4561384361;Taip;0;1;1;2
16202;Žiogelis;ŽIRNIUKAI;6617995346;Taip;0;3;0;3
16203;Žiogelis;ŽIRNIUKAI;7936785905;Taip;1;2;0;3
16204;Žiogelis;ŽIRNIUKAI;9142952548;Taip;8;1;0;9
16205;Žiogelis;ŽIRNIUKAI;4450344120;Taip;6;0;0;6
16206;Žiogelis;ŽIRNIUKAI;8998694866;Taip;0;3;2;5
16207;Žiogelis;ŽIRNIUKAI;3472310047;Taip;0;3;0;3
16208;Žiogelis;ŽIRNIUKAI;8018943297;Taip;0;1;2;3
16209;Žiogelis;ŽIRNIUKAI;8038242532;Taip;13;0;0;13
16210;Žiogelis;ŽIRNIUKAI;9421670525;Taip;5;6;0;11
16211;Žiogelis;ŽIRNIUKAI;2463360858;Taip;0;0;2;2
16212;Žiogelis;ŽIRNIUKAI;1067136657;Taip;10;0;0;10
16213;Žiogelis;ŽIRNIUKAI;9672307977;Taip;0;0;4;4
16214;Žiogelis;ŽIRNIUKAI;5337641310;Taip;4;3;0;7
16215;Žiogelis;ŽIRNIUKAI;4755709634;Taip;0;2;0;2
16216;Žiogelis;ŽIRNIUKAI;2833768296;Taip;0;1;3;4
16217;Žiogelis;ŽIRNIUKAI;6857937795;Taip;10;3;0;13
16218;Žiogelis;ŽIRNIUKAI;9918493914;Taip;0;3;3;6
16219;Žiogelis;ŽIRNIUKAI;3516143432;Taip;6;3;1;10
16220;Žiogelis;ŽIRNIUKAI;5223426277;Taip;6;0;0;6
16221;Žiogelis;DOBILĖLIAI;8683148826;Taip;0;12;0;12
16222;Žiogelis;DOBILĖLIAI;3308563362;Taip;6;0;0;6
16223;Žiogelis;DOBILĖLIAI;2117192553;Taip;1;3;0;4
16224;Žiogelis;DOBILĖLIAI;1190395481;Taip;0;2;0;2
16225;Žiogelis;DOBILĖLIAI;6495456608;Taip;0;4;0;4
16226;Žiogelis;DOBILĖLIAI;5364996984;Taip;7;0;0;7
16227;Žiogelis;DOBILĖLIAI;9568208184;Taip;7;0;0;7
16228;Žiogelis;DOBILĖLIAI;6340620973;Ne;0;7;0;7
16229;Žiogelis;DOBILĖLIAI;5961630249;Taip;0;3;0;3
16230;Žiogelis;DOBILĖLIAI;6532218580;Taip;0;2;1;3
16231;Žiogelis;DOBILĖLIAI;1763070523;Taip;0;3;0;3
16232;Žiogelis;DOBILĖLIAI;5911231906;Taip;0;3;0;3
16233;Žiogelis;DOBILĖLIAI;9610249055;Taip;0;3;0;3
16234;Žiogelis;DOBILĖLIAI;6115834138;Taip;7;0;0;7
16235;Žiogelis;DOBILĖLIAI;3887222613;Taip;4;0;0;4
16236;Žiogelis;DOBILĖLIAI;8485067381;Taip;1;0;0;1
16237;Žiogelis;DOBILĖLIAI;7065052244;Taip;7;0;0;7
16238;Žiogelis;DOBILĖLIAI;3427704550;Ne;0;3;0;3
16239;Žiogelis;DOBILĖLIAI;4103035195;Taip;2;3;0;5
16240;Žiogelis;DOBILĖLIAI;3392582853;Taip;9;1;0;10
16241;Žiogelis;DOBILĖLIAI;5557800297;Taip;9;1;0;10
16242;Žiogelis;BORUŽĖLĖS;9295720241;Taip;6;3;0;9
16243;Žiogelis;BORUŽĖLĖS;24941867247;Taip;0;3;0;3
16244;Žiogelis;BORUŽĖLĖS;8819549855;Ne;0;6;0;6
16245;Žiogelis;BORUŽĖLĖS;3189872952;Taip;0;6;0;6
16246;Žiogelis;BORUŽĖLĖS;2883732914;Taip;0;6;0;6
16247;Žiogelis;BORUŽĖLĖS;3503872654;Taip;0;3;3;6
16248;Žiogelis;BORUŽĖLĖS;4445888917;Taip;0;3;0;3
16249;Žiogelis;BORUŽĖLĖS;7881358741;Taip;0;3;0;3
16250;Žiogelis;BORUŽĖLĖS;64865699245;Taip;7;0;0;7
16251;Žiogelis;BORUŽĖLĖS;8702710674;Taip;0;7;0;7
16252;Žiogelis;BORUŽĖLĖS;4671356872;Taip;5;4;0;9
16253;Žiogelis;BORUŽĖLĖS;18018505301;Taip;0;1;0;1
16254;Žiogelis;BORUŽĖLĖS;3750023611;Taip;5;8;0;13
16255;Žiogelis;BORUŽĖLĖS;4343510173;Taip;0;10;0;10
16256;Žiogelis;BORUŽĖLĖS;6659086172;Taip;0;4;0;4
16257;Žiogelis;BORUŽĖLĖS;95713316600;Taip;0;3;0;3
16258;Žiogelis;BORUŽĖLĖS;3203359908;Taip;0;6;0;6
16259;Žiogelis;BORUŽĖLĖS;3320077143;Taip;0;2;0;2
16260;Žiogelis;BORUŽĖLĖS;1160064257;Taip;0;3;0;3
16261;Žiogelis;BORUŽĖLĖS;60959051938;Taip;0;3;0;3
16262;Žiogelis;BORUŽĖLĖS;6346503991;Taip;0;8;3;11
16263;Žiogelis;BORUŽĖLĖS;3560637865;Taip;0;11;0;11
16264;Žiogelis;BORUŽĖLĖS;3420228264;Taip;3;3;0;6
16265;Žiogelis;BORUŽĖLĖS;1996517542;Taip;0;4;0;4
16266;Žiogelis;BORUŽĖLĖS;6760074113;Taip;6;3;0;9
16267;Žiogelis;DRUGELIAI;4080391074;Ne;0;0;7;7
16268;Žiogelis;DRUGELIAI;2797078863;Taip;15;3;0;18
16269;Žiogelis;DRUGELIAI;3813592739;Taip;0;4;3;7
16270;Žiogelis;DRUGELIAI;3820406417;Taip;0;4;4;8
16271;Žiogelis;DRUGELIAI;9533670829;Taip;0;3;2;5
16272;Žiogelis;DRUGELIAI;1673279182;Taip;15;2;0;17
16273;Žiogelis;DRUGELIAI;9964121573;Taip;0;3;6;9
16274;Žiogelis;DRUGELIAI;5104952346;Taip;0;3;2;5
16275;Žiogelis;DRUGELIAI;9431525960;Taip;0;3;4;7
16276;Žiogelis;DRUGELIAI;9717527407;Taip;0;3;3;6
16277;Žiogelis;DRUGELIAI;2622354022;Taip;0;4;0;4
16278;Žiogelis;DRUGELIAI;7462316396;Taip;5;5;0;10
16279;Žiogelis;DRUGELIAI;2243541285;Taip;13;3;0;16
16280;Žiogelis;DRUGELIAI;3810309354;Taip;0;2;0;2
16281;Žiogelis;DRUGELIAI;2326799191;Taip;0;1;0;1
16282;Žiogelis;DRUGELIAI;7974212517;Taip;8;0;0;8
16283;Žiogelis;DRUGELIAI;9423979719;Taip;8;0;0;8
16284;Žiogelis;DRUGELIAI;1833992163;Taip;10;0;0;10
16285;Žiogelis;PELĖDŽIUKAI;4156736676;Taip;2;1;0;3
16286;Žiogelis;PELĖDŽIUKAI;7128248940;Taip;5;2;0;7
16287;Žiogelis;PELĖDŽIUKAI;6709029770;Taip;6;3;0;9
16288;Žiogelis;PELĖDŽIUKAI;7502572217;Taip;8;3;1;12
16289;Žiogelis;PELĖDŽIUKAI;1134384178;Taip;0;0;1;1
16290;Žiogelis;PELĖDŽIUKAI;5876904663;Taip;0;3;1;4
16291;Žiogelis;PELĖDŽIUKAI;8217782981;Taip;0;5;0;5
16292;Žiogelis;PELĖDŽIUKAI;7120126547;Taip;0;3;0;3
16293;Žiogelis;PELĖDŽIUKAI;9387048672;Taip;0;10;0;10
16294;Žiogelis;PELĖDŽIUKAI;4378941619;Taip;0;1;0;1
16295;Žiogelis;PELĖDŽIUKAI;3937261260;Taip;0;5;0;5
16296;Žiogelis;PELĖDŽIUKAI;8873231715;Taip;8;0;0;8
16297;Žiogelis;PELĖDŽIUKAI;4609861306;Taip;0;0;1;1
16298;Žiogelis;PELĖDŽIUKAI;2759766559;Taip;5;10;0;15
16299;Žiogelis;PELĖDŽIUKAI;2160862681;Taip;0;4;0;4
16300;Žiogelis;PELĖDŽIUKAI;7725494899;Taip;0;6;0;6
16301;Žiogelis;PELĖDŽIUKAI;1939672072;Taip;0;3;1;4
16302;Žiogelis;PELĖDŽIUKAI;8689074067;Taip;0;6;0;6
16303;Žiogelis;PELĖDŽIUKAI;4565342104;Taip;0;3;0;3
16304;Žiogelis;PELĖDŽIUKAI;1223396469;Taip;10;3;0;13
16305;Žiogelis;PELĖDŽIUKAI;3500076229;Taip;0;2;0;2
16306;Žiogelis;PELĖDŽIUKAI;8715501524;Taip;7;2;0;9
16307;Žiogelis;VARPELIAI;7888873296;Taip;0;9;0;9
16308;Žiogelis;VARPELIAI;3520393042;Taip;9;3;0;12
16309;Žiogelis;VARPELIAI;8983731310;Taip;0;6;0;6
16310;Žiogelis;VARPELIAI;1954544417;Ne;0;3;0;3
16311;Žiogelis;VARPELIAI;6716558946;Taip;0;4;0;4
16312;Žiogelis;VARPELIAI;1035890284;Ne;6;3;0;9
16313;Žiogelis;VARPELIAI;9385596579;Taip;4;0;0;4
16314;Žiogelis;VARPELIAI;1447349850;Taip;0;5;0;5
16315;Žiogelis;VARPELIAI;3752358694;Taip;0;2;0;2
16316;Žiogelis;VARPELIAI;6402784913;Ne;11;0;0;11
16317;Žiogelis;VARPELIAI;3502278745;Taip;0;3;0;3
16318;Žiogelis;VARPELIAI;4462189852;Taip;0;1;0;1
16319;Žiogelis;VARPELIAI;9470241656;Taip;18;0;0;18
16320;Žiogelis;VARPELIAI;8133583992;Ne;0;4;0;4
16321;Žiogelis;VARPELIAI;2346231162;Ne;4;2;0;6
16322;Žiogelis;VARPELIAI;5899326215;Ne;13;0;0;13
16323;Žiogelis;VARPELIAI;6658457517;Ne;6;2;0;8
16324;Žiogelis;VARPELIAI;6650891980;Ne;11;0;0;11
16325;Žiogelis;VARPELIAI;5076511003;Ne;6;1;0;7
16326;Žiogelis;VARPELIAI;1139259000;Taip;16;0;0;16
16327;Žiogelis;VARPELIAI;7992701275;Taip;12;1;0;13
16328;Žiogelis;VARPELIAI;3838714439;Ne;6;0;0;6
16329;Žiogelis;KREGŽDUTĖS;1309122110;Taip;0;4;0;4
16330;Žiogelis;KREGŽDUTĖS;7704256764;Taip;4;5;1;10
16331;Žiogelis;KREGŽDUTĖS;1235203700;Taip;0;4;0;4
16332;Žiogelis;KREGŽDUTĖS;6701809272;Taip;0;4;0;4
16333;Žiogelis;KREGŽDUTĖS;6697117406;Taip;10;3;0;13
16334;Žiogelis;KREGŽDUTĖS;2028383677;Taip;0;4;0;4
16335;Žiogelis;KREGŽDUTĖS;3910954904;Taip;0;2;2;4
16336;Žiogelis;KREGŽDUTĖS;2233244282;Taip;0;3;0;3
16337;Žiogelis;KREGŽDUTĖS;9862582346;Taip;0;5;0;5
16338;Žiogelis;KREGŽDUTĖS;9406830518;Taip;0;5;0;5
16339;Žiogelis;KREGŽDUTĖS;1320651707;Taip;5;6;0;11
16340;Žiogelis;KREGŽDUTĖS;85437321236;Taip;0;2;1;3
16341;Žiogelis;KREGŽDUTĖS;1320126836;Taip;0;5;0;5
16342;Žiogelis;KREGŽDUTĖS;3310492752;Taip;5;5;0;10
16343;Žiogelis;KREGŽDUTĖS;2366095661;Taip;0;1;0;1
16344;Žiogelis;KREGŽDUTĖS;8675451323;Taip;0;3;0;3
16345;Žiogelis;KREGŽDUTĖS;7087781379;Taip;0;3;0;3
16346;Žiogelis;KREGŽDUTĖS;4015109974;Taip;0;3;0;3
16347;Žiogelis;KREGŽDUTĖS;14932261911;Taip;3;5;0;8
16348;Žiogelis;KREGŽDUTĖS;4713696984;Taip;0;6;0;6
16349;Žiogelis;KREGŽDUTĖS;1442866468;Taip;6;3;0;9
16350;Žiogelis;KREGŽDUTĖS;1660784232;Taip;14;0;0;14
16351;Žiogelis;KREGŽDUTĖS;5579709130;Taip;0;4;0;4
16352;Žiogelis;KREGŽDUTĖS;9128728457;Taip;0;5;0;5
16353;Žiogelis;KREGŽDUTĖS;5340501392;Taip;0;8;0;8
16354;Žiogelis;KREGŽDUTĖS;8979747150;Taip;5;4;0;9
16355;Žiogelis;ŽVIRBLIUKAI;9769735869;Taip;0;3;0;3
16356;Žiogelis;ŽVIRBLIUKAI;1106149118;Taip;0;5;0;5
16357;Žiogelis;ŽVIRBLIUKAI;6284764694;Taip;0;8;0;8
16358;Žiogelis;ŽVIRBLIUKAI;9842311161;Taip;9;3;0;12
16359;Žiogelis;ŽVIRBLIUKAI;5475797764;Taip;18;0;0;18
16360;Žiogelis;ŽVIRBLIUKAI;2036243422;Taip;10;0;0;10
16361;Žiogelis;ŽVIRBLIUKAI;9634291623;Taip;13;1;0;14
16362;Žiogelis;ŽVIRBLIUKAI;7802165127;Taip;0;3;0;3
16363;Žiogelis;ŽVIRBLIUKAI;6491130711;Taip;0;0;1;1
16364;Žiogelis;ŽVIRBLIUKAI;9378236361;Taip;14;0;0;14
16365;Žiogelis;ŽVIRBLIUKAI;5445409452;Taip;14;0;0;14
16366;Žiogelis;ŽVIRBLIUKAI;4155916507;Taip;5;1;0;6
16367;Žiogelis;ŽVIRBLIUKAI;4623532521;Taip;0;1;0;1
16368;Žiogelis;ŽVIRBLIUKAI;6988180082;Taip;18;0;0;18
16369;Žiogelis;ŽVIRBLIUKAI;4677227753;Taip;18;0;0;18
16370;Žiogelis;ŽVIRBLIUKAI;9737574835;Taip;0;2;0;2
16371;Žiogelis;ŽVIRBLIUKAI;5996045442;Taip;3;2;0;5
16372;Žiogelis;BITUTĖS;4814936645;Taip;3;0;0;3
16373;Žiogelis;BITUTĖS;3752355139;Taip;5;1;0;6
16374;Žiogelis;BITUTĖS;4605250897;Taip;0;3;0;3
16375;Žiogelis;BITUTĖS;2173494736;Taip;0;3;5;8
16376;Žiogelis;BITUTĖS;5042341085;Taip;0;3;2;5
16377;Žiogelis;BITUTĖS;6347738933;Taip;7;3;0;10
16378;Žiogelis;BITUTĖS;9627583831;Taip;0;2;0;2
16379;Žiogelis;BITUTĖS;3296450902;Taip;0;3;0;3
16380;Žiogelis;BITUTĖS;3792114246;Taip;8;3;0;11
16381;Žiogelis;BITUTĖS;9981130790;Taip;0;6;0;6
16382;Žiogelis;BITUTĖS;3820534331;Taip;0;3;0;3
16383;Žiogelis;BITUTĖS;4630381709;Taip;0;3;0;3
16384;Žiogelis;BITUTĖS;9790463889;Ne;0;7;0;7
16385;Žiogelis;BITUTĖS;6024752960;Taip;0;6;0;6
16386;Žiogelis;BITUTĖS;8853905367;Taip;0;6;0;6
16387;Žiogelis;BITUTĖS;1397686161;Taip;0;13;0;13
16388;Žiogelis;BITUTĖS;2171351454;Taip;0;5;1;6
16389;Žiogelis;BITUTĖS;8835394030;Taip;0;5;0;5
16390;Žiogelis;BITUTĖS;4645245689;Taip;0;3;0;3
16391;Žiogelis;BITUTĖS;9874412804;Taip;4;2;0;6
16392;Žiogelis;BITUTĖS;5139645108;Taip;0;11;0;11
16393;Žiogelis;BITUTĖS;9766966628;Taip;0;9;0;9
16394;Žiogelis;RIEŠUTĖLIAI;8303283893;Taip;12;1;0;13
16395;Žiogelis;RIEŠUTĖLIAI;9863503924;Taip;0;3;1;4
16396;Žiogelis;RIEŠUTĖLIAI;6718866954;Taip;7;0;3;10
16397;Žiogelis;RIEŠUTĖLIAI;9144282935;Taip;7;1;0;8
16398;Žiogelis;RIEŠUTĖLIAI;8485973974;Taip;0;0;4;4
16399;Žiogelis;RIEŠUTĖLIAI;6039409252;Taip;3;5;2;10
16400;Žiogelis;RIEŠUTĖLIAI;2275123126;Taip;0;2;0;2
16401;Žiogelis;RIEŠUTĖLIAI;6048534817;Taip;0;3;3;6
16402;Žiogelis;RIEŠUTĖLIAI;5133034709;Taip;13;0;0;13
16403;Žiogelis;RIEŠUTĖLIAI;4147132498;Taip;5;0;0;5
16404;Žiogelis;RIEŠUTĖLIAI;2724389716;Taip;0;0;4;4
16405;Žiogelis;RIEŠUTĖLIAI;7763941077;Taip;0;3;1;4
16406;Žiogelis;RIEŠUTĖLIAI;4946802677;Taip;17;0;0;17
16407;Žiogelis;RIEŠUTĖLIAI;7008807839;Taip;3;0;0;3
16408;Žiogelis;RIEŠUTĖLIAI;2518015116;Taip;0;3;0;3
16409;Žiogelis;RIEŠUTĖLIAI;5984496369;Taip;10;3;0;13
16410;Žiogelis;PAKALNUTĖS;1618384759;Taip;0;3;0;3
16411;Žiogelis;PAKALNUTĖS;5054228916;Taip;0;0;1;1
16412;Žiogelis;PAKALNUTĖS;8712788346;Taip;6;4;0;10
16413;Žiogelis;PAKALNUTĖS;3428197871;Taip;0;5;0;5
16414;Žiogelis;PAKALNUTĖS;7535167450;Taip;17;0;0;17
16415;Žiogelis;PAKALNUTĖS;3361421852;Taip;0;3;0;3
16416;Žiogelis;PAKALNUTĖS;1268908081;Taip;0;4;0;4
16417;Žiogelis;PAKALNUTĖS;3856321373;Taip;10;1;0;11
16418;Žiogelis;PAKALNUTĖS;6378295945;Taip;7;1;0;8
16419;Žiogelis;PAKALNUTĖS;8959934210;Taip;0;2;0;2
16420;Žiogelis;PAKALNUTĖS;8591680136;Taip;0;4;0;4
16421;Žiogelis;PAKALNUTĖS;6980853713;Taip;6;1;1;8
16422;Žiogelis;PAKALNUTĖS;7340918175;Taip;7;0;3;10
16423;Žiogelis;PAKALNUTĖS;6866685213;Taip;5;8;0;13
16424;Žiogelis;PAKALNUTĖS;5487213418;Taip;0;5;0;5
16425;Žiogelis;PAKALNUTĖS;8058231095;Taip;5;1;2;8
16426;Žiogelis;PAKALNUTĖS;1650284820;Taip;5;0;0;5
16427;Žiogelis;PAKALNUTĖS;6515890056;Taip;2;5;0;7
16428;Žiogelis;PAKALNUTĖS;7310459638;Taip;5;1;0;6
16429;Žiogelis;PAKALNUTĖS;1763603533;Taip;18;0;0;18
16430;Žiogelis;PAKALNUTĖS;9813150014;Taip;0;4;0;4
16431;Žiogelis;PAKALNUTĖS;5454676924;Taip;12;1;0;13
16432;Žiogelis;PAKALNUTĖS;7702173581;Taip;0;3;0;3
16433;Žolynėlis;Spanguolėlė;8810441600;Taip;0;3;0;3
16434;Žolynėlis;Spanguolėlė;6440991320;Taip;10;5;0;15
16435;Žolynėlis;Spanguolėlė;3631138915;Taip;0;3;0;3
16436;Žolynėlis;Spanguolėlė;5218448120;Taip;0;11;0;11
16437;Žolynėlis;Spanguolėlė;4076450179;Taip;10;4;0;14
16438;Žolynėlis;Spanguolėlė;4494255525;Taip;0;9;0;9
16439;Žolynėlis;Spanguolėlė;2493633505;Taip;0;1;3;4
16440;Žolynėlis;Spanguolėlė;5438607463;Taip;13;0;0;13
16441;Žolynėlis;Spanguolėlė;5208585298;Taip;0;9;0;9
16442;Žolynėlis;Spanguolėlė;7451189254;Taip;6;3;0;9
16443;Žolynėlis;Spanguolėlė;3498596516;Taip;3;8;0;11
16444;Žolynėlis;Spanguolėlė;9498369210;Taip;18;0;0;18
16445;Žolynėlis;Spanguolėlė;7260397656;Taip;7;4;3;14
16446;Žolynėlis;Spanguolėlė;2315947380;Taip;10;3;0;13
16447;Žolynėlis;Spanguolėlė;5074658392;Taip;10;3;0;13
16448;Žolynėlis;Spanguolėlė;6288526291;Taip;4;5;0;9
16449;Žolynėlis;Spanguolėlė;7234022613;Ne;0;3;0;3
16450;Žolynėlis;"RŪTELĖ (spec)";1540454207;Taip;0;3;0;3
16451;Žolynėlis;"RŪTELĖ (spec)";4000928238;Taip;1;5;0;6
16452;Žolynėlis;"RŪTELĖ (spec)";5610113641;Taip;6;2;0;8
16453;Žolynėlis;"RŪTELĖ (spec)";9507509872;Taip;4;7;0;11
16454;Žolynėlis;"RŪTELĖ (spec)";2256262371;Taip;5;6;0;11
16455;Žolynėlis;"RŪTELĖ (spec)";1412336878;Taip;2;4;0;6
16456;Žolynėlis;"RŪTELĖ (spec)";8588753136;Taip;18;0;0;18
16457;Žolynėlis;"SAULUTĖ (spec)";9675783636;Taip;0;5;0;5
16458;Žolynėlis;"SAULUTĖ (spec)";7962304738;Taip;0;2;0;2
16459;Žolynėlis;"SAULUTĖ (spec)";6678697536;Taip;16;0;0;16
16460;Žolynėlis;"SAULUTĖ (spec)";6559029399;Taip;13;0;0;13
16461;Žolynėlis;"SAULUTĖ (spec)";3043560150;Taip;4;1;0;5
16462;Žolynėlis;"SAULUTĖ (spec)";3934182673;Taip;0;2;5;7
16463;Žolynėlis;"LINELIS (spec)";2665355759;Taip;5;5;0;10
16464;Žolynėlis;"LINELIS (spec)";2346018814;Taip;0;1;10;11
16465;Žolynėlis;"LINELIS (spec)";1916465295;Taip;0;2;0;2
16466;Žolynėlis;"LINELIS (spec)";3337602618;Ne;0;2;13;15
16467;Žolynėlis;"LINELIS (spec)";2740906284;Taip;0;1;0;1
16468;Žolynėlis;"RASAKILA (spec)";4971887781;Taip;0;1;0;1
16469;Žolynėlis;"RASAKILA (spec)";6619551947;Taip;0;1;0;1
16470;Žolynėlis;"RASAKILA (spec)";8839037219;Ne;2;0;0;2
16471;Žolynėlis;"RASAKILA (spec)";4481343085;Ne;5;5;0;10
16472;Žolynėlis;"RAMUNĖLĖS (spec)";8552635547;Taip;0;1;0;1
16473;Žolynėlis;"RAMUNĖLĖS (spec)";4559404699;Taip;5;1;0;6
16474;Žolynėlis;"RAMUNĖLĖS (spec)";1703785525;Taip;4;5;0;9
16475;Žolynėlis;"RAMUNĖLĖS (spec)";2072569949;Taip;0;3;0;3
16476;Žolynėlis;"RAMUNĖLĖS (spec)";1090944316;Taip;4;1;2;7
16477;Žolynėlis;Dobiliukai;2005661306;Taip;4;7;0;11
16478;Žolynėlis;Dobiliukai;2820649587;Taip;1;0;0;1
16479;Žolynėlis;Dobiliukai;7581436340;Taip;3;0;0;3
16480;Žolynėlis;Dobiliukai;6204102296;Taip;10;0;0;10
16481;Žolynėlis;Dobiliukai;3385748516;Taip;9;5;0;14
16482;Žolynėlis;Dobiliukai;4151633786;Taip;6;0;0;6
16483;Žolynėlis;Dobiliukai;2957426163;Taip;0;3;0;3
16484;Žolynėlis;Dobiliukai;5456771327;Taip;14;0;0;14
16485;Žolynėlis;Dobiliukai;8341730420;Taip;8;1;0;9
16486;Žolynėlis;Dobiliukai;5634886191;Taip;5;0;0;5
16487;Žolynėlis;Dobiliukai;3350246193;Taip;4;0;1;5
16488;Žolynėlis;Dobiliukai;5269388947;Taip;13;0;0;13
16489;Žolynėlis;Dobiliukai;1206144208;Taip;0;6;0;6
16490;Žolynėlis;Dobiliukai;1213384150;Taip;0;4;0;4
16491;Žolynėlis;Dobiliukai;7485033527;Taip;5;4;1;10
16492;Žolynėlis;Aguonėlė;3071570864;Taip;0;4;0;4
16493;Žolynėlis;Aguonėlė;1440666914;Taip;0;4;0;4
16494;Žolynėlis;Aguonėlė;1365534272;Taip;4;1;0;5
16495;Žolynėlis;Aguonėlė;2628636018;Taip;0;8;0;8
16496;Žolynėlis;Aguonėlė;6740105842;Taip;0;3;0;3
16497;Žolynėlis;Aguonėlė;6554864184;Taip;5;2;6;13
16498;Žolynėlis;Aguonėlė;9904373687;Taip;0;1;0;1
16499;Žolynėlis;Aguonėlė;9285539649;Taip;0;6;0;6
16500;Žolynėlis;Aguonėlė;5243624422;Taip;18;0;0;18
16501;Žolynėlis;Aguonėlė;4761054847;Taip;0;1;0;1
16502;Žolynėlis;Aguonėlė;6354832415;Taip;0;3;0;3
16503;Žolynėlis;Aguonėlė;9120786116;Taip;0;4;0;4
16504;Žolynėlis;Aguonėlė;1748987196;Ne;0;7;0;7
16505;Žolynėlis;Aguonėlė;4427274462;Taip;3;0;0;3
16506;Žolynėlis;Aguonėlė;3819863015;Taip;2;0;1;3
16507;Žolynėlis;Pienė;3520272555;Taip;0;9;0;9
16508;Žolynėlis;Pienė;2934361190;Taip;0;4;0;4
16509;Žolynėlis;Pienė;6763515483;Taip;0;5;0;5
16510;Žolynėlis;Pienė;1163753820;Taip;4;5;1;10
16511;Žolynėlis;Pienė;9106152447;Taip;0;5;3;8
16512;Žolynėlis;Pienė;1879046798;Taip;0;3;0;3
16513;Žolynėlis;Pienė;9238832484;Taip;0;5;0;5
16514;Žolynėlis;Pienė;3877168024;Taip;0;4;0;4
16515;Žolynėlis;Pienė;6416217971;Taip;0;5;0;5
16516;Žolynėlis;Pienė;4618251201;Taip;3;4;1;8
16517;Žolynėlis;Pienė;5432464074;Taip;5;7;2;14
16518;Žolynėlis;Pienė;8510764089;Ne;0;2;1;3
16519;Žolynėlis;Pienė;1264022895;Ne;0;5;2;7
16520;Žolynėlis;Pienė;8697184617;Taip;2;5;0;7
16521;Žolynėlis;Pienė;8713225753;Taip;1;3;0;4
16522;Žolynėlis;Pienė;5332349177;Taip;0;5;0;5
16523;Žolynėlis;Pienė;5787331165;Taip;0;18;0;18
16524;Žolynėlis;Pienė;3091749692;Taip;4;2;0;6
16525;Žolynėlis;Pienė;2263679711;Taip;0;4;0;4
16526;Žolynėlis;Pienė;5149512625;Taip;0;2;0;2
16527;Žolynėlis;Pienė;5973298389;Taip;0;3;0;3
16528;Žolynėlis;Čiobreliai;5564338170;Taip;0;3;0;3
16529;Žolynėlis;Čiobreliai;6543503409;Taip;0;10;0;10
16530;Žolynėlis;Čiobreliai;8215427354;Taip;5;0;0;5
16531;Žolynėlis;Čiobreliai;8700231970;Taip;3;0;0;3
16532;Žolynėlis;Čiobreliai;7339496409;Taip;2;1;0;3
16533;Žolynėlis;Čiobreliai;2565770471;Taip;0;1;0;1
16534;Žolynėlis;Čiobreliai;3198470147;Taip;0;3;0;3
16535;Žolynėlis;Čiobreliai;6829144389;Taip;0;4;0;4
16536;Žolynėlis;Čiobreliai;4545601535;Taip;0;3;0;3
16537;Žolynėlis;Čiobreliai;7256502393;Taip;0;3;0;3
16538;Žolynėlis;Čiobreliai;1901979061;Taip;5;3;0;8
16539;Žolynėlis;Čiobreliai;8027151284;Taip;10;3;0;13
16540;Žolynėlis;Čiobreliai;5717038791;Taip;0;5;0;5
16541;Žolynėlis;Čiobreliai;1933377698;Taip;0;9;0;9
16542;Žolynėlis;Čiobreliai;2108221942;Taip;0;6;0;6
16543;Žolynėlis;Čiobreliai;2881461471;Taip;0;10;0;10
16544;Žolynėlis;Čiobreliai;7339110559;Taip;5;1;0;6
16545;Žolynėlis;Čiobreliai;2460982987;Taip;16;0;0;16
16546;Žolynėlis;Čiobreliai;7980206574;Taip;3;3;0;6
16547;Žolynėlis;Čiobreliai;3088932720;Taip;3;7;0;10
16548;Žolynėlis;Čiobreliai;4758738231;Taip;11;3;0;14
16549;Žolynėlis;Čiobreliai;6024288147;Taip;0;3;0;3
16550;Žolynėlis;Čiobreliai;1485195267;Taip;8;3;0;11
16551;Žolynėlis;Avietėlė;4277871671;Taip;3;0;0;3
16552;Žolynėlis;Avietėlė;9404844632;Taip;3;0;0;3
16553;Žolynėlis;Avietėlė;5873931225;Ne;17;0;0;17
16554;Žolynėlis;Avietėlė;6124252688;Taip;3;0;0;3
16555;Žolynėlis;Avietėlė;3293250169;Taip;10;0;0;10
16556;Žolynėlis;Avietėlė;1266614631;Taip;8;4;0;12
16557;Žolynėlis;Avietėlė;2727273826;Taip;0;18;0;18
16558;Žolynėlis;Avietėlė;2718255075;Taip;0;11;0;11
16559;Žolynėlis;Avietėlė;7517815798;Taip;3;0;0;3
16560;Žolynėlis;Avietėlė;4094173207;Taip;0;7;0;7
16561;Žolynėlis;Avietėlė;4229530366;Taip;15;1;0;16
16562;Žuvėdra;"JŪROS ŽVAIGŽDUTĖS";7272717439;Taip;0;1;0;1
16563;Žuvėdra;"JŪROS ŽVAIGŽDUTĖS";9230342970;Taip;6;0;1;7
16564;Žuvėdra;"JŪROS ŽVAIGŽDUTĖS";1938808693;Taip;3;0;0;3
16565;Žuvėdra;"JŪROS ŽVAIGŽDUTĖS";2660909247;Taip;0;1;3;4
16566;Žuvėdra;"JŪROS ŽVAIGŽDUTĖS";2092890028;Taip;0;1;2;3
16567;Žuvėdra;"JŪROS ŽVAIGŽDUTĖS";2334342995;Taip;0;2;0;2
16568;Žuvėdra;"JŪROS ŽVAIGŽDUTĖS";5049101816;Taip;0;4;0;4
16569;Žuvėdra;"JŪROS ŽVAIGŽDUTĖS";4011849839;Taip;0;7;0;7
16570;Žuvėdra;"JŪROS ŽVAIGŽDUTĖS";1164464390;Taip;0;4;0;4
16571;Žuvėdra;"JŪROS ŽVAIGŽDUTĖS";1200084485;Taip;0;6;0;6
16572;Žuvėdra;"JŪROS ŽVAIGŽDUTĖS";4177319374;Taip;0;7;0;7
16573;Žuvėdra;"JŪROS ŽVAIGŽDUTĖS";7121154799;Taip;5;4;0;9
16574;Žuvėdra;"JŪROS ŽVAIGŽDUTĖS";7710853637;Taip;0;0;1;1
16575;Žuvėdra;"JŪROS ŽVAIGŽDUTĖS";2858729034;Taip;8;2;1;11
16576;Žuvėdra;"JŪROS ŽVAIGŽDUTĖS";7958768355;Ne;0;0;1;1
16577;Žuvėdra;"JŪROS ŽVAIGŽDUTĖS";6672289932;Taip;0;0;1;1
16578;Žuvėdra;"JŪROS ŽVAIGŽDUTĖS";9733979816;Ne;3;0;1;4
16579;Žuvėdra;"JŪROS ŽVAIGŽDUTĖS";5571732399;Taip;0;0;2;2
16580;Žuvėdra;"JŪROS ŽVAIGŽDUTĖS";3620753237;Taip;0;2;0;2
16581;Žuvėdra;DELFINUKAI;5436158437;Taip;0;4;0;4
16582;Žuvėdra;DELFINUKAI;6952843736;Taip;0;3;0;3
16583;Žuvėdra;DELFINUKAI;2582404760;Taip;0;4;0;4
16584;Žuvėdra;DELFINUKAI;5818639448;Taip;0;1;1;2
16585;Žuvėdra;DELFINUKAI;1171751803;Taip;0;0;1;1
16586;Žuvėdra;DELFINUKAI;7235005234;Taip;0;1;3;4
16587;Žuvėdra;DELFINUKAI;5876618912;Taip;10;0;2;12
16588;Žuvėdra;DELFINUKAI;6989906913;Taip;0;1;0;1
16589;Žuvėdra;DELFINUKAI;4702627979;Taip;0;3;0;3
16590;Žuvėdra;DELFINUKAI;5002760763;Taip;0;2;0;2
16591;Žuvėdra;DELFINUKAI;6327915228;Taip;5;0;1;6
16592;Žuvėdra;DELFINUKAI;7803397430;Taip;3;1;3;7
16593;Žuvėdra;DELFINUKAI;7705946236;Taip;18;0;0;18
16594;Žuvėdra;DELFINUKAI;1974766090;Taip;3;6;0;9
16595;Žuvėdra;DELFINUKAI;8869169590;Taip;4;1;0;5
16596;Žuvėdra;DELFINUKAI;3069506904;Taip;0;10;0;10
16597;Žuvėdra;DELFINUKAI;4146310547;Taip;0;1;0;1
16598;Žuvėdra;DELFINUKAI;5913580058;Taip;4;1;0;5
16599;Žuvėdra;DELFINUKAI;9651268462;Taip;0;0;1;1
16600;Žuvėdra;DELFINUKAI;2082128566;Taip;0;4;5;9
16601;Žuvėdra;OSMINOŽKI;1340241206;Taip;4;2;0;6
16602;Žuvėdra;OSMINOŽKI;5021263583;Taip;0;5;0;5
16603;Žuvėdra;OSMINOŽKI;63053155507;Taip;0;3;0;3
16604;Žuvėdra;OSMINOŽKI;1941428466;Taip;0;1;0;1
16605;Žuvėdra;OSMINOŽKI;6007871092;Taip;0;2;0;2
16606;Žuvėdra;OSMINOŽKI;2731016281;Taip;5;2;0;7
16607;Žuvėdra;OSMINOŽKI;75901332720;Taip;2;3;0;5
16608;Žuvėdra;OSMINOŽKI;14760907606;Taip;15;2;0;17
16609;Žuvėdra;OSMINOŽKI;5684848140;Taip;10;4;0;14
16610;Žuvėdra;OSMINOŽKI;5489757084;Taip;0;5;0;5
16611;Žuvėdra;OSMINOŽKI;8408371550;Taip;0;3;0;3
16612;Žuvėdra;OSMINOŽKI;5496071972;Taip;0;5;0;5
16613;Žuvėdra;OSMINOŽKI;5273726957;Taip;1;3;0;4
16614;Žuvėdra;OSMINOŽKI;6537464526;Taip;5;4;0;9
16615;Žuvėdra;OSMINOŽKI;5674529681;Taip;5;1;0;6
16616;Žuvėdra;OSMINOŽKI;7368183516;Taip;0;8;0;8
16617;Žuvėdra;OSMINOŽKI;3853045274;Taip;10;2;0;12
16618;Žuvėdra;OSMINOŽKI;3185158741;Taip;0;3;0;3
16619;Žuvėdra;OSMINOŽKI;8822952385;Ne;18;0;0;18
16620;Žuvėdra;OSMINOŽKI;5198825127;Taip;18;0;0;18
16621;Žuvėdra;OSMINOŽKI;5561903903;Taip;0;3;0;3
16622;Žuvėdra;RUSALAČKA;8700802853;Taip;0;15;0;15
16623;Žuvėdra;RUSALAČKA;1509519996;Taip;0;9;0;9
16624;Žuvėdra;RUSALAČKA;4907571967;Taip;8;0;0;8
16625;Žuvėdra;RUSALAČKA;3613045982;Taip;5;2;0;7
16626;Žuvėdra;RUSALAČKA;7467154866;Ne;0;2;0;2
16627;Žuvėdra;RUSALAČKA;5151984122;Taip;0;3;0;3
16628;Žuvėdra;RUSALAČKA;4715123063;Taip;0;3;0;3
16629;Žuvėdra;RUSALAČKA;6715416675;Taip;0;2;4;6
16630;Žuvėdra;RUSALAČKA;8308610070;Taip;1;2;0;3
16631;Žuvėdra;RUSALAČKA;3349158713;Taip;5;2;0;7
16632;Žuvėdra;RUSALAČKA;8942228415;Taip;0;2;1;3
16633;Žuvėdra;RUSALAČKA;8670342549;Taip;0;3;3;6
16634;Žuvėdra;RUSALAČKA;1707519901;Taip;0;1;0;1
16635;Žuvėdra;RUSALAČKA;1810114962;Taip;0;3;0;3
16636;Žuvėdra;RUSALAČKA;1960306957;Taip;0;2;0;2
16637;Žuvėdra;RUSALAČKA;2640238143;Taip;0;9;0;9
16638;Žuvėdra;RUSALAČKA;2577280901;Taip;11;2;0;13
16639;Žuvėdra;RUSALAČKA;5481785360;Taip;12;1;0;13
16640;Žuvėdra;RUSALAČKA;6862766787;Ne;7;3;3;13
16641;Žuvėdra;RUSALAČKA;9011276878;Taip;0;5;0;5
16642;Žuvėdra;RUSALAČKA;7387863175;Taip;0;10;0;10
16643;Žuvėdra;JANTARIKI;4893062971;Taip;0;0;2;2
16644;Žuvėdra;JANTARIKI;1219808187;Taip;0;2;0;2
16645;Žuvėdra;JANTARIKI;9200342856;Taip;0;3;0;3
16646;Žuvėdra;JANTARIKI;2197976174;Taip;18;0;0;18
16647;Žuvėdra;JANTARIKI;4881712317;Taip;18;0;0;18
16648;Žuvėdra;JANTARIKI;7464494386;Taip;0;3;0;3
16649;Žuvėdra;JANTARIKI;1072201019;Taip;0;4;1;5
16650;Žuvėdra;JANTARIKI;1993897043;Taip;6;0;0;6
16651;Žuvėdra;JANTARIKI;3058300342;Taip;0;2;2;4
16652;Žuvėdra;JANTARIKI;7227722516;Ne;9;2;0;11
16653;Žuvėdra;JANTARIKI;9256424331;Taip;8;5;0;13
16654;Žuvėdra;JANTARIKI;7908898376;Taip;0;4;0;4
16655;Žuvėdra;JANTARIKI;2789379055;Taip;4;5;0;9
16656;Žuvėdra;JANTARIKI;9838754800;Taip;0;1;0;1
16657;Žuvėdra;JANTARIKI;1039661177;Taip;3;1;1;5
16658;Žuvėdra;JANTARIKI;1604010000;Taip;8;1;0;9
16659;Žuvėdra;"AUKSINĖ ŽUVELĖ";9914814198;Taip;0;0;2;2
16660;Žuvėdra;"AUKSINĖ ŽUVELĖ";6287034023;Taip;16;0;0;16
16661;Žuvėdra;"AUKSINĖ ŽUVELĖ";2844920302;Taip;9;0;0;9
16662;Žuvėdra;"AUKSINĖ ŽUVELĖ";9460887312;Taip;9;2;1;12
16663;Žuvėdra;"AUKSINĖ ŽUVELĖ";9382616403;Taip;0;1;0;1
16664;Žuvėdra;"AUKSINĖ ŽUVELĖ";2323431685;Taip;6;1;0;7
16665;Žuvėdra;"AUKSINĖ ŽUVELĖ";4888533074;Taip;8;5;0;13
16666;Žuvėdra;"AUKSINĖ ŽUVELĖ";5009153711;Taip;14;1;2;17
16667;Žuvėdra;"AUKSINĖ ŽUVELĖ";7258677907;Taip;5;0;0;5
16668;Žuvėdra;"AUKSINĖ ŽUVELĖ";4739865462;Taip;13;0;0;13
16669;Žuvėdra;"AUKSINĖ ŽUVELĖ";7135848009;Taip;8;0;1;9
16670;Žuvėdra;"AUKSINĖ ŽUVELĖ";3781157324;Taip;14;3;0;17
16671;Žuvėdra;"AUKSINĖ ŽUVELĖ";7164457313;Taip;0;1;0;1
16672;Žuvėdra;"AUKSINĖ ŽUVELĖ";9215777054;Taip;8;0;2;10
16673;Žvangutis;PELIUKŲ;7616874368;Taip;8;0;6;14
16674;Žvangutis;PELIUKŲ;3906808900;Taip;0;4;4;8
16675;Žvangutis;PELIUKŲ;7722153982;Taip;1;6;1;8
16676;Žvangutis;PELIUKŲ;4295016449;Taip;9;3;0;12
16677;Žvangutis;PELIUKŲ;9958554027;Taip;5;3;0;8
16678;Žvangutis;PELIUKŲ;8592522675;Taip;0;3;0;3
16679;Žvangutis;PELIUKŲ;3957064486;Taip;0;2;0;2
16680;Žvangutis;PELIUKŲ;5112520119;Taip;5;5;0;10
16681;Žvangutis;PELIUKŲ;5817402847;Taip;10;5;0;15
16682;Žvangutis;PELIUKŲ;4407484687;Taip;12;6;0;18
16683;Žvangutis;PELIUKŲ;5638068914;Taip;0;17;0;17
16684;Žvangutis;PELIUKŲ;4337928288;Taip;9;4;0;13
16685;Žvangutis;PELIUKŲ;6788355315;Taip;10;3;0;13
16686;Žvangutis;PELIUKŲ;8062689240;Taip;9;0;0;9
16687;Žvangutis;PELIUKŲ;3875906173;Taip;8;3;0;11
16688;Žvangutis;PELIUKŲ;1328464199;Taip;0;5;0;5
16689;Žvangutis;PELIUKŲ;3546672690;Taip;6;2;1;9
16690;Žvangutis;PELIUKŲ;4992231141;Taip;9;1;4;14
16691;Žvangutis;PELIUKŲ;3408933802;Taip;8;0;1;9
16692;Žvangutis;PELIUKŲ;8481666202;Taip;0;0;4;4
16693;Žvangutis;PELIUKŲ;4705131089;Taip;0;4;0;4
16694;Žvangutis;ANČIUKŲ;6579934222;Taip;0;1;0;1
16695;Žvangutis;ANČIUKŲ;9134683276;Taip;0;3;0;3
16696;Žvangutis;ANČIUKŲ;9145365865;Taip;7;4;0;11
16697;Žvangutis;ANČIUKŲ;6701947168;Taip;0;3;0;3
16698;Žvangutis;ANČIUKŲ;3315858185;Taip;9;3;0;12
16699;Žvangutis;ANČIUKŲ;7320625500;Taip;0;4;1;5
16700;Žvangutis;ANČIUKŲ;6110958520;Taip;0;4;2;6
16701;Žvangutis;ANČIUKŲ;6989839997;Taip;0;4;0;4
16702;Žvangutis;ANČIUKŲ;7202747419;Taip;13;3;0;16
16703;Žvangutis;ANČIUKŲ;3817258555;Taip;0;1;0;1
16704;Žvangutis;ANČIUKŲ;3775960571;Taip;5;4;1;10
16705;Žvangutis;ANČIUKŲ;7267340112;Ne;0;3;0;3
16706;Žvangutis;ANČIUKŲ;50889154641;Taip;0;3;0;3
16707;Žvangutis;ANČIUKŲ;1310113034;Taip;0;3;1;4
16708;Žvangutis;ANČIUKŲ;3513746926;Taip;0;4;0;4
16709;Žvangutis;ANČIUKŲ;4053450010;Taip;0;4;0;4
16710;Žvangutis;ANČIUKŲ;8511103595;Taip;0;3;0;3
16711;Žvangutis;ANČIUKŲ;6815104137;Taip;0;4;0;4
16712;Žvangutis;ANČIUKŲ;6844824726;Taip;0;3;0;3
16713;Žvangutis;ANČIUKŲ;9408369641;Taip;0;3;0;3
16714;Žvangutis;ANČIUKŲ;2600596320;Ne;0;3;0;3
16715;Žvangutis;ANČIUKŲ;1339151674;Taip;0;4;2;6
16716;Žvangutis;PELĖDŽIUKŲ;2755838558;Taip;0;3;0;3
16717;Žvangutis;PELĖDŽIUKŲ;1322688456;Taip;0;5;0;5
16718;Žvangutis;PELĖDŽIUKŲ;2570379643;Taip;0;3;0;3
16719;Žvangutis;PELĖDŽIUKŲ;2623107843;Taip;0;2;0;2
16720;Žvangutis;PELĖDŽIUKŲ;1185135525;Taip;0;5;0;5
16721;Žvangutis;PELĖDŽIUKŲ;2411307963;Taip;3;3;0;6
16722;Žvangutis;PELĖDŽIUKŲ;9468660351;Taip;0;3;0;3
16723;Žvangutis;PELĖDŽIUKŲ;1324948757;Taip;8;3;0;11
16724;Žvangutis;PELĖDŽIUKŲ;2922083476;Taip;0;7;0;7
16725;Žvangutis;PELĖDŽIUKŲ;1282567366;Taip;0;1;0;1
16726;Žvangutis;PELĖDŽIUKŲ;6068428687;Taip;0;3;0;3
16727;Žvangutis;PELĖDŽIUKŲ;9149037184;Taip;0;11;0;11
16728;Žvangutis;PELĖDŽIUKŲ;5012996199;Taip;0;5;0;5
16729;Žvangutis;PELĖDŽIUKŲ;8295525284;Taip;0;3;0;3
16730;Žvangutis;PELĖDŽIUKŲ;3276065009;Taip;5;3;0;8
16731;Žvangutis;PELĖDŽIUKŲ;6040986672;Taip;0;5;0;5
16732;Žvangutis;PELĖDŽIUKŲ;2716216474;Taip;6;3;0;9
16733;Žvangutis;PELĖDŽIUKŲ;5723728310;Taip;0;3;0;3
16734;Žvangutis;PELĖDŽIUKŲ;1404378308;Taip;0;7;0;7
16735;Žvangutis;PELĖDŽIUKŲ;6207989105;Taip;5;4;0;9
16736;Žvangutis;PELĖDŽIUKŲ;5539992579;Taip;0;4;0;4
16737;Žvangutis;KAČIUKŲ;7213349517;Taip;0;5;0;5
16738;Žvangutis;KAČIUKŲ;7581320158;Ne;0;2;1;3
16739;Žvangutis;KAČIUKŲ;2296360416;Taip;18;0;0;18
16740;Žvangutis;KAČIUKŲ;7721746116;Taip;0;5;0;5
16741;Žvangutis;KAČIUKŲ;2598842770;Taip;0;4;0;4
16742;Žvangutis;KAČIUKŲ;1142315595;Taip;0;5;1;6
16743;Žvangutis;KAČIUKŲ;9239279639;Taip;0;5;0;5
16744;Žvangutis;KAČIUKŲ;4696437804;Taip;0;7;0;7
16745;Žvangutis;KAČIUKŲ;8492637734;Taip;0;7;0;7
16746;Žvangutis;KAČIUKŲ;2503355659;Taip;0;2;0;2
16747;Žvangutis;KAČIUKŲ;9235884407;Taip;0;9;0;9
16748;Žvangutis;KAČIUKŲ;8360356476;Taip;0;0;2;2
16749;Žvangutis;KAČIUKŲ;8863909185;Taip;0;9;0;9
16750;Žvangutis;KAČIUKŲ;3498584864;Taip;0;4;0;4
16751;Žvangutis;KAČIUKŲ;4408086513;Taip;0;11;0;11
16752;Žvangutis;KAČIUKŲ;1256264382;Taip;0;8;0;8
16753;Žvangutis;KAČIUKŲ;8030520477;Taip;0;3;0;3
16754;Žvangutis;KAČIUKŲ;5166614226;Taip;0;0;1;1
16755;Žvangutis;KAČIUKŲ;8810739982;Taip;0;3;1;4
16756;Žvangutis;KAČIUKŲ;2740875969;Taip;4;0;3;7
16757;Žvangutis;KAČIUKŲ;8269992031;Ne;0;5;2;7
16758;Žvangutis;KAČIUKŲ;1224292338;Taip;5;0;5;10
16759;Žvangutis;KAČIUKŲ;1634651749;Taip;0;0;2;2
16760;Žvangutis;MEŠKUČIŲ;3781959962;Taip;6;3;0;9
16761;Žvangutis;MEŠKUČIŲ;8506809320;Taip;5;3;0;8
16762;Žvangutis;MEŠKUČIŲ;8376022173;Taip;9;0;0;9
16763;Žvangutis;MEŠKUČIŲ;6825952779;Taip;0;4;0;4
16764;Žvangutis;MEŠKUČIŲ;4920234186;Taip;10;0;0;10
16765;Žvangutis;MEŠKUČIŲ;1590704985;Taip;0;0;2;2
16766;Žvangutis;MEŠKUČIŲ;9306755042;Taip;0;0;1;1
16767;Žvangutis;MEŠKUČIŲ;1352736819;Taip;0;3;0;3
16768;Žvangutis;MEŠKUČIŲ;5328547183;Taip;0;17;0;17
16769;Žvangutis;MEŠKUČIŲ;2298103025;Taip;0;3;0;3
16770;Žvangutis;MEŠKUČIŲ;9523189658;Taip;9;0;0;9
16771;Žvangutis;MEŠKUČIŲ;9406190681;Taip;3;1;0;4
16772;Žvangutis;MEŠKUČIŲ;5126809299;Taip;7;0;1;8
16773;Žvangutis;MEŠKUČIŲ;6511539983;Taip;5;0;0;5
16774;Žvangutis;MEŠKUČIŲ;9883337991;Taip;0;2;0;2
16775;Žvangutis;MEŠKUČIŲ;8598396569;Taip;6;4;0;10
16776;Žvangutis;KIŠKUČIŲ;8906823569;Taip;11;0;3;14
16777;Žvangutis;KIŠKUČIŲ;6094686500;Taip;0;0;3;3
16778;Žvangutis;KIŠKUČIŲ;2049990751;Taip;0;0;2;2
16779;Žvangutis;KIŠKUČIŲ;2308726385;Taip;0;0;2;2
16780;Žvangutis;KIŠKUČIŲ;9711017196;Taip;0;0;4;4
16781;Žvangutis;KIŠKUČIŲ;7051007224;Taip;0;0;3;3
16782;Žvangutis;KIŠKUČIŲ;3940893168;Taip;0;0;6;6
16783;Žvangutis;KIŠKUČIŲ;1592158260;Taip;13;0;0;13
16784;Žvangutis;KIŠKUČIŲ;5022657156;Taip;0;0;1;1
16785;Žvangutis;KIŠKUČIŲ;7645908955;Taip;18;0;0;18
16786;Žvangutis;KIŠKUČIŲ;6741623841;Taip;0;0;1;1
16787;Žvangutis;KIŠKUČIŲ;3029382724;Taip;9;0;2;11
16788;Žvangutis;KIŠKUČIŲ;4514606021;Taip;0;6;0;6
16789;Žvangutis;KIŠKUČIŲ;7844987649;Taip;0;0;3;3
16790;Žvangutis;KIŠKUČIŲ;7599491698;Taip;8;0;0;8
16791;Žvangutis;KIŠKUČIŲ;4128856598;Taip;0;4;0;4
16792;Žirniukas;Boružiukų;5311746004;Taip;8;0;5;13
16793;Žirniukas;Boružiukų;6466220057;Taip;0;2;1;3
16794;Žirniukas;Boružiukų;2476906136;Taip;0;2;5;7
16795;Žirniukas;Boružiukų;2785102131;Taip;0;2;1;3
16796;Žirniukas;Boružiukų;6624263476;Taip;0;2;0;2
16797;Žirniukas;Boružiukų;8213507698;Taip;0;3;0;3
16798;Žirniukas;Boružiukų;2528905738;Taip;0;2;3;5
16799;Žirniukas;Boružiukų;6268788036;Taip;0;3;0;3
16800;Žirniukas;Boružiukų;6363169823;Taip;0;9;0;9
16801;Žirniukas;Boružiukų;2636634198;Taip;0;3;0;3
16802;Žirniukas;Boružiukų;8148254025;Taip;5;4;0;9
16803;Žirniukas;Boružiukų;6531175340;Taip;4;3;0;7
16804;Žirniukas;Boružiukų;9647374339;Taip;0;6;0;6
16805;Žirniukas;Boružiukų;6641200341;Taip;0;2;0;2
16806;Žirniukas;Boružiukų;3022672028;Taip;8;9;0;17
16807;Žirniukas;Boružiukų;3909152902;Taip;3;3;0;6
16808;Žirniukas;Boružiukų;8180092480;Ne;5;0;1;6
16809;Žirniukas;Boružiukų;9896989995;Taip;0;2;1;3
16810;Žirniukas;Boružiukų;5420360864;Taip;0;4;0;4
16811;Žirniukas;Boružiukų;1873446232;Taip;0;0;6;6
16812;Žirniukas;Boružiukų;8294569569;Taip;0;7;4;11
16813;Žirniukas;Boružiukų;7397202752;Taip;0;5;1;6
16814;Žirniukas;Boružiukų;7190628011;Taip;2;0;6;8
16815;Žirniukas;Smalsučiai;2132625724;Taip;0;1;0;1
16816;Žirniukas;Smalsučiai;2557138057;Taip;0;4;7;11
16817;Žirniukas;Smalsučiai;5761169841;Taip;4;2;1;7
16818;Žirniukas;Smalsučiai;5104110821;Taip;0;3;6;9
16819;Žirniukas;Smalsučiai;5471647472;Taip;0;1;0;1
16820;Žirniukas;Smalsučiai;2151329751;Taip;0;3;0;3
16821;Žirniukas;Smalsučiai;5939918015;Taip;10;3;0;13
16822;Žirniukas;Smalsučiai;2049123663;Taip;0;3;4;7
16823;Žirniukas;Smalsučiai;3010062747;Taip;5;2;4;11
16824;Žirniukas;Smalsučiai;2162238771;Taip;0;3;3;6
16825;Žirniukas;Smalsučiai;1064894307;Taip;5;4;0;9
16826;Žirniukas;Smalsučiai;4378877068;Taip;2;4;4;10
16827;Žirniukas;Smalsučiai;2029018108;Taip;5;3;0;8
16828;Žirniukas;Smalsučiai;2309995947;Taip;8;4;3;15
16829;Žirniukas;Smalsučiai;1162904969;Taip;0;3;0;3
16830;Žirniukas;Smalsučiai;7644911127;Taip;0;3;0;3
16831;Žirniukas;Smalsučiai;1514504241;Taip;2;5;0;7
16832;Žirniukas;Smalsučiai;6180439078;Taip;0;1;3;4
16833;Žirniukas;Smalsučiai;5987510202;Taip;7;4;0;11
16834;Žirniukas;Smalsučiai;1944169398;Taip;0;5;1;6
16835;Žirniukas;Smalsučiai;7975957714;Taip;4;3;0;7
16836;Žirniukas;Smalsučiai;3808838764;Taip;0;4;0;4
16837;Žirniukas;Smalsučiai;9374080010;Taip;6;3;0;9
16838;Žirniukas;Smalsučiai;1678041002;Taip;4;2;4;10
16839;Žirniukas;Gėlyčių;2982628594;Taip;0;3;0;3
16840;Žirniukas;Gėlyčių;6121388208;Taip;2;0;2;4
16841;Žirniukas;Gėlyčių;6201949014;Taip;12;0;0;12
16842;Žirniukas;Gėlyčių;5103440019;Taip;13;0;0;13
16843;Žirniukas;Gėlyčių;3370588608;Taip;1;0;0;1
16844;Žirniukas;Gėlyčių;7872611724;Taip;0;1;1;2
16845;Žirniukas;Gėlyčių;9497414375;Taip;7;4;0;11
16846;Žirniukas;Gėlyčių;5422282267;Taip;0;0;5;5
16847;Žirniukas;Gėlyčių;3189741449;Taip;8;1;0;9
16848;Žirniukas;Gėlyčių;5427116799;Taip;3;6;0;9
16849;Žirniukas;Gėlyčių;3214136760;Taip;10;2;0;12
16850;Žirniukas;Nykštukų;2489070480;Taip;5;5;0;10
16851;Žirniukas;Nykštukų;5734197350;Taip;0;1;2;3
16852;Žirniukas;Nykštukų;2746074694;Taip;0;0;4;4
16853;Žirniukas;Nykštukų;4282344625;Taip;0;1;2;3
16854;Žirniukas;Nykštukų;3874713264;Taip;0;3;0;3
16855;Žirniukas;Nykštukų;1532129054;Taip;10;1;1;12
16856;Žirniukas;Nykštukų;7368124402;Taip;0;1;2;3
16857;Žirniukas;Nykštukų;1635353228;Taip;0;1;1;2
16858;Žirniukas;Nykštukų;2526769571;Taip;0;1;2;3
16859;Žirniukas;Nykštukų;2027344763;Taip;3;3;0;6
16860;Žirniukas;Nykštukų;9730269905;Taip;3;0;1;4
16861;Žirniukas;Nykštukų;9478756666;Taip;0;1;1;2
16862;Žirniukas;Nykštukų;4704879073;Taip;0;3;0;3
16863;Žirniukas;Nykštukų;4732089209;Taip;0;4;0;4
16864;Žirniukas;Nykštukų;9988669252;Ne;2;0;1;3
16865;Žirniukas;Nykštukų;8242086461;Taip;4;1;2;7
16866;Žirniukas;Nykštukų;8242086461;Taip;4;1;2;7
16867;Žirniukas;Nykštukų;8242086461;Taip;4;1;2;7
16868;Žirniukas;Nykštukų;6511802399;Taip;5;1;2;8
16869;Žirniukas;Nykštukų;6511802399;Taip;5;1;2;8
16870;Žirniukas;Nykštukų;6511802399;Taip;5;1;2;8
16871;Žirniukas;Saulytės;9649896460;Taip;7;1;2;10
16872;Žirniukas;Saulytės;5819443551;Taip;0;1;2;3
16873;Žirniukas;Saulytės;2733313392;Taip;0;4;0;4
16874;Žirniukas;Saulytės;9707776533;Taip;0;2;0;2
16875;Žirniukas;Saulytės;7278153529;Taip;0;2;0;2
16876;Žirniukas;Saulytės;7927815250;Taip;0;4;0;4
16877;Žirniukas;Saulytės;2325139043;Taip;12;3;0;15
16878;Žirniukas;Saulytės;4527367786;Taip;0;2;0;2
16879;Žirniukas;Saulytės;3610402086;Taip;0;3;0;3
16880;Žirniukas;Saulytės;6362626389;Taip;0;3;0;3
16881;Žirniukas;Saulytės;9961947583;Taip;0;5;0;5
16882;Žirniukas;Saulytės;9656768968;Taip;0;1;7;8
16883;Žirniukas;Saulytės;4045432303;Taip;4;5;0;9
16884;Žirniukas;Saulytės;1074945082;Taip;14;3;0;17
16885;Žirniukas;Saulytės;1594735501;Taip;0;1;0;1
16886;Žirniukas;Saulytės;4433579937;Taip;0;1;3;4
16887;Žirniukas;Saulytės;4229687519;Taip;0;3;0;3
16888;Žirniukas;Saulytės;8151071354;Taip;0;1;0;1
16889;Žirniukas;Saulytės;8599313527;Taip;0;5;1;6
16890;Žirniukas;Drugelių;6271194358;Taip;5;8;0;13
16891;Žirniukas;Drugelių;9232828844;Taip;0;4;0;4
16892;Žirniukas;Drugelių;5269074776;Taip;0;0;3;3
16893;Žirniukas;Drugelių;3509857181;Taip;5;3;0;8
16894;Žirniukas;Drugelių;2517524802;Taip;0;2;0;2
16895;Žirniukas;Drugelių;9901196251;Taip;7;0;4;11
16896;Žirniukas;Drugelių;2555959199;Taip;0;0;3;3
16897;Žirniukas;Drugelių;4762596462;Taip;0;0;2;2
16898;Žirniukas;Drugelių;5046469974;Taip;3;3;0;6
16899;Žirniukas;Drugelių;1826203483;Taip;5;3;0;8
16900;Žirniukas;Drugelių;4536071547;Taip;0;4;0;4
16901;Žirniukas;Drugelių;6501961029;Taip;0;3;0;3
16902;Žirniukas;Drugelių;3996393849;Taip;0;1;4;5
16903;Žirniukas;Drugelių;7240364379;Taip;0;0;3;3
16904;Žirniukas;Drugelių;6300372863;Taip;0;8;0;8
16905;Žirniukas;Drugelių;9794535841;Taip;15;0;0;15
16906;Žirniukas;Drugelių;1018506580;Taip;10;3;3;16
16907;Žirniukas;Drugelių;6993784924;Taip;0;0;2;2
16908;Žirniukas;Drugelių;9384464752;Taip;14;3;0;17
16909;Žirniukas;Pelėdžiukai;7889803840;Taip;5;3;0;8
16910;Žirniukas;Pelėdžiukai;2895924102;Taip;0;4;0;4
16911;Žirniukas;Pelėdžiukai;4347695841;Taip;5;0;2;7
16912;Žirniukas;Pelėdžiukai;9381704756;Taip;5;0;1;6
16913;Žirniukas;Pelėdžiukai;4847093256;Taip;6;2;0;8
16914;Žirniukas;Pelėdžiukai;7356213150;Taip;8;3;0;11
16915;Žirniukas;Pelėdžiukai;7545458622;Taip;6;1;0;7
16916;Žirniukas;Pelėdžiukai;8354728917;Taip;7;0;0;7
16917;Žirniukas;Pelėdžiukai;5376080603;Taip;7;0;1;8
16918;Žirniukas;Pelėdžiukai;9511974432;Taip;6;1;0;7
16919;Žirniukas;Pelėdžiukai;7755938379;Taip;0;2;8;10
16920;Žirniukas;Pelėdžiukai;5470692657;Taip;14;0;0;14
16921;Žirniukas;Pelėdžiukai;8690042163;Taip;6;2;0;8
16922;Žirniukas;Pelėdžiukai;8808445761;Taip;8;4;0;12
16923;Žirniukas;Pelėdžiukai;2332260494;Taip;0;3;0;3
16924;Žirniukas;Pelėdžiukai;6941160450;Taip;10;2;0;12
16925;Žirniukas;Pelėdžiukai;4464151713;Taip;5;0;1;6
16926;Žirniukas;Pelėdžiukai;3907578167;Taip;0;2;1;3
16927;Žirniukas;Pelėdžiukai;4069128550;Taip;13;0;1;14
16928;Žirniukas;Pelėdžiukai;2489163786;Taip;8;0;2;10
16929;Žirniukas;Pelėdžiukai;7767762079;Taip;0;3;0;3
16930;Žirniukas;ZUIKUČIAI;5613818351;Taip;10;1;0;11
16931;Žirniukas;ZUIKUČIAI;1345594362;Taip;0;4;0;4
16932;Žirniukas;ZUIKUČIAI;5212289551;Taip;0;0;1;1
16933;Žirniukas;ZUIKUČIAI;1005139737;Taip;7;0;0;7
16934;Žirniukas;ZUIKUČIAI;7968189099;Taip;0;2;6;8
16935;Žirniukas;ZUIKUČIAI;7081683726;Taip;5;5;0;10
16936;Žirniukas;ZUIKUČIAI;7021496832;Taip;0;0;3;3
16937;Žirniukas;ZUIKUČIAI;1449763041;Taip;0;2;2;4
16938;Žirniukas;ZUIKUČIAI;4860680720;Taip;0;8;0;8
16939;Žirniukas;ZUIKUČIAI;7269948694;Taip;0;2;1;3
16940;Žirniukas;ZUIKUČIAI;6594686128;Taip;5;2;0;7
16941;Žirniukas;ZUIKUČIAI;9993119353;Taip;0;4;0;4
16942;Žirniukas;ZUIKUČIAI;1679864330;Taip;12;3;0;15
16943;Žirniukas;ZUIKUČIAI;3438394768;Taip;0;0;3;3
16944;Žirniukas;ZUIKUČIAI;9569187800;Taip;10;2;0;12
16945;Žirniukas;ZUIKUČIAI;2302878611;Taip;8;0;0;8
16946;Aušra;Kodėlčiukai;2611563172;Taip;0;4;0;4
16947;Aušra;Kodėlčiukai;3420851059;Taip;18;0;0;18
16948;Aušra;Kodėlčiukai;2199083085;Taip;0;2;0;2
16949;Aušra;Kodėlčiukai;4720749995;Taip;0;3;0;3
16950;Aušra;Kodėlčiukai;5929538617;Taip;0;1;0;1
16951;Aušra;Kodėlčiukai;6139706771;Taip;3;3;0;6
16952;Aušra;Kodėlčiukai;7314273812;Taip;3;3;0;6
16953;Aušra;Kodėlčiukai;5046439805;Taip;0;2;0;2
16954;Aušra;Kodėlčiukai;4540040693;Taip;9;1;0;10
16955;Aušra;Kodėlčiukai;1423840991;Ne;13;0;0;13
16956;Aušra;Kodėlčiukai;5013135853;Taip;13;0;0;13
16957;Aušra;Kodėlčiukai;9728140172;Taip;0;3;0;3
16958;Aušra;Kodėlčiukai;7765504789;Taip;0;5;0;5
16959;Aušra;Kodėlčiukai;8108663467;Taip;0;5;0;5
16960;Aušra;Kodėlčiukai;4824773027;Taip;8;5;0;13
16961;Aušra;Kodėlčiukai;1897365632;Taip;0;3;0;3
16962;Aušra;Kodėlčiukai;7469266085;Taip;0;14;0;14
16963;Aušra;Kodėlčiukai;1010721404;Taip;0;7;0;7
16964;Aušra;Kodėlčiukai;1883185016;Taip;0;6;0;6
16965;Aušra;Kodėlčiukai;1773343262;Taip;0;4;0;4
16966;Aušra;Kodėlčiukai;9437530221;Taip;9;3;1;13
16967;Aušra;Kodėlčiukai;7367602247;Taip;0;5;0;5
16968;Aušra;Kodėlčiukai;3627487971;Taip;0;4;0;4
16969;Aušra;"4B klasė";92119607174;Taip;10;3;0;13
16970;Aušra;"4B klasė";22923377435;Taip;5;3;0;8
16971;Aušra;"4B klasė";41852924528;Taip;0;18;0;18
16972;Aušra;"4B klasė";58526614808;Taip;0;18;0;18
16973;Aušra;"4B klasė";41039525379;Taip;5;3;0;8
16974;Aušra;"4B klasė";37339481276;Taip;2;3;0;5
16975;Aušra;"4B klasė";45165946624;Taip;0;18;0;18
16976;Aušra;"4B klasė";59107169775;Taip;0;3;0;3
16977;Aušra;"4B klasė";48349819906;Taip;0;3;0;3
16978;Aušra;"4B klasė";71596384638;Taip;0;3;0;3
16979;Aušra;"4B klasė";52332096506;Taip;0;3;0;3
16980;Aušra;"4B klasė";35703433862;Taip;0;3;0;3
16981;Aušra;"4B klasė";6201728036;Taip;0;18;0;18
16982;Aušra;"4B klasė";36889923728;Taip;6;3;0;9
16983;Aušra;"4B klasė";39957179831;Taip;0;3;0;3
16984;Aušra;"4B klasė";52909474598;Taip;2;3;0;5
16985;Aušra;"4B klasė";8901585006;Taip;0;18;0;18
16986;Aušra;"4B klasė";64562667133;Taip;0;18;0;18
16987;Aušra;"4B klasė";95076478544;Ne;0;3;0;3
16988;Aušra;"4B klasė";36899257479;Ne;4;3;0;7
16989;Aušra;"4B klasė";57520886724;Taip;12;3;0;15
16990;Aušra;"4B klasė";1815771421;Taip;0;3;0;3
16991;Aušra;"4B klasė";75433637766;Taip;0;18;0;18
16992;Aušra;"4B klasė";83119050626;Taip;0;18;0;18
16993;Aušra;Smalsučiai;1450251779;Taip;0;6;0;6
16994;Aušra;Smalsučiai;5409157554;Taip;0;3;5;8
16995;Aušra;Smalsučiai;8176840834;Taip;0;5;0;5
16996;Aušra;Smalsučiai;3680329197;Taip;0;3;4;7
16997;Aušra;Smalsučiai;8740755922;Taip;2;3;1;6
16998;Aušra;Smalsučiai;3898178166;Taip;0;7;0;7
16999;Aušra;Smalsučiai;29499576216;Taip;0;3;1;4
17000;Aušra;Smalsučiai;1940882109;Taip;0;4;0;4
17001;Aušra;Smalsučiai;4404047456;Taip;0;3;2;5
17002;Aušra;Smalsučiai;97102749430;Taip;0;3;0;3
17003;Aušra;Smalsučiai;9702136789;Taip;0;9;1;10
17004;Aušra;Smalsučiai;8709340592;Taip;0;3;2;5
17005;Aušra;Smalsučiai;5673568541;Taip;0;3;5;8
17006;Aušra;Smalsučiai;5524681006;Taip;0;5;0;5
17007;Aušra;Smalsučiai;6384243597;Taip;0;5;0;5
17008;Aušra;Smalsučiai;19402768340;Taip;0;11;0;11
17009;Aušra;Smalsučiai;2523842161;Taip;0;3;0;3
17010;Aušra;Smalsučiai;1343532870;Taip;0;4;0;4
17011;Aušra;Smalsučiai;7043021721;Taip;0;12;0;12
17012;Aušra;Smalsučiai;1612662076;Taip;0;7;0;7
17013;Aušra;Smalsučiai;1387254053;Taip;6;4;2;12
17014;Aušra;Smalsučiai;1575761029;Taip;13;3;0;16
17015;Aušra;Smalsučiai;5777939563;Taip;1;3;0;4
17016;Aušra;Smalsučiai;7814902928;Taip;0;4;0;4
17017;Aušra;"1A klasė";3001784066;Taip;2;3;0;5
17018;Aušra;"1A klasė";84116863778;Taip;0;3;0;3
17019;Aušra;"1A klasė";2227238810;Taip;0;3;0;3
17020;Aušra;"1A klasė";59837942520;Taip;0;3;0;3
17021;Aušra;"1A klasė";11053850075;Taip;1;3;0;4
17022;Aušra;"1A klasė";23609052737;Taip;0;3;0;3
17023;Aušra;"1A klasė";41017803426;Taip;0;3;0;3
17024;Aušra;"1A klasė";21544489661;Taip;2;3;0;5
17025;Aušra;"1A klasė";24625925423;Taip;1;3;0;4
17026;Aušra;"1A klasė";62186117615;Taip;1;3;0;4
17027;Aušra;"1A klasė";3526237179;Ne;1;3;0;4
17028;Aušra;"1A klasė";1893586984;Taip;0;18;0;18
17029;Aušra;"1A klasė";8686777160;Taip;0;3;0;3
17030;Aušra;"1A klasė";15657824495;Taip;0;3;0;3
17031;Aušra;"1A klasė";5988529284;Taip;1;3;0;4
17032;Aušra;"1A klasė";79051821501;Taip;0;3;0;3
17033;Aušra;"1A klasė";2062470430;Taip;6;3;0;9
17034;Aušra;"1A klasė";5815377310;Taip;0;3;0;3
17035;Aušra;"1A klasė";58254707316;Taip;1;3;0;4
17036;Aušra;"1A klasė";1385844067;Taip;2;3;0;5
17037;Aušra;"1A klasė";2121418946;Taip;0;3;0;3
17038;Aušra;"1A klasė";1219257874;Taip;0;18;0;18
17039;Aušra;"1A klasė";4325224130;Taip;0;3;0;3
17040;Aušra;"1A klasė";59267104215;Taip;0;3;0;3
17041;Aušra;"1A klasė";1623803107;Taip;0;3;0;3
17042;Aušra;"1B klasė";1988459596;Taip;0;3;0;3
17043;Aušra;"1B klasė";4930807661;Taip;0;3;0;3
17044;Aušra;"1B klasė";86128256406;Taip;0;3;0;3
17045;Aušra;"1B klasė";50687988382;Taip;0;3;0;3
17046;Aušra;"1B klasė";1021183555;Taip;0;3;0;3
17047;Aušra;"1B klasė";41268510292;Taip;1;3;0;4
17048;Aušra;"1B klasė";8428069167;Taip;1;3;0;4
17049;Aušra;"1B klasė";3910688753;Taip;2;3;0;5
17050;Aušra;"1B klasė";4024898537;Taip;0;3;0;3
17051;Aušra;"1B klasė";1238171728;Taip;7;3;0;10
17052;Aušra;"1B klasė";4103951942;Taip;0;3;0;3
17053;Aušra;"1B klasė";46481555688;Taip;5;3;0;8
17054;Aušra;"1B klasė";1063755068;Taip;1;3;0;4
17055;Aušra;"1B klasė";70844824182;Taip;5;3;0;8
17056;Aušra;"1B klasė";17098859260;Taip;0;3;0;3
17057;Aušra;"1B klasė";9940683245;Taip;0;3;0;3
17058;Aušra;"1B klasė";2841526614;Ne;4;3;0;7
17059;Aušra;"1B klasė";8813044848;Taip;8;3;0;11
17060;Aušra;"1B klasė";58741201573;Taip;0;3;0;3
17061;Aušra;"1B klasė";2003368811;Taip;0;3;0;3
17062;Aušra;"1B klasė";65840410497;Ne;0;3;0;3
17063;Aušra;"1B klasė";1640356242;Taip;0;3;0;3
17064;Aušra;"1B klasė";90604001837;Taip;2;3;0;5
17065;Aušra;"1B klasė";7794899167;Taip;0;3;0;3
17066;Aušra;"2A klasė";5468993286;Taip;2;3;0;5
17067;Aušra;"2A klasė";1167565535;Ne;0;3;0;3
17068;Aušra;"2A klasė";75047415039;Taip;0;3;0;3
17069;Aušra;"2A klasė";85826303673;Taip;5;3;0;8
17070;Aušra;"2A klasė";1145863002;Taip;0;18;0;18
17071;Aušra;"2A klasė";77966124767;Taip;2;3;0;5
17072;Aušra;"2A klasė";1473962346;Taip;0;3;0;3
17073;Aušra;"2A klasė";1049364899;Taip;6;3;0;9
17074;Aušra;"2A klasė";1427235223;Taip;0;3;0;3
17075;Aušra;"2A klasė";97312326369;Taip;1;3;0;4
17076;Aušra;"2A klasė";2019480768;Taip;0;3;0;3
17077;Aušra;"2A klasė";48817619537;Taip;2;3;0;5
17078;Aušra;"2A klasė";55937499558;Taip;0;3;0;3
17079;Aušra;"2A klasė";35779814505;Taip;0;3;0;3
17080;Aušra;"2A klasė";76280361479;Taip;0;3;0;3
17081;Aušra;"2A klasė";2131349938;Taip;1;3;0;4
17082;Aušra;"2A klasė";36447115547;Taip;0;3;0;3
17083;Aušra;"2A klasė";1455625997;Taip;0;3;0;3
17084;Aušra;"2A klasė";1393006122;Taip;1;3;0;4
17085;Aušra;"2A klasė";7998332115;Taip;2;3;0;5
17086;Aušra;"2A klasė";14611425618;Taip;0;3;0;3
17087;Aušra;"2A klasė";31458685084;Taip;2;3;0;5
17088;Aušra;"2A klasė";9603569117;Taip;0;3;0;3
17089;Aušra;"2A klasė";1315930711;Taip;4;3;0;7
17090;Aušra;"2A klasė";42344686036;Taip;0;3;0;3
17091;Aušra;"2A klasė";2647629246;Taip;0;3;0;3
17092;Aušra;"2A klasė";95586246863;Taip;0;3;0;3
17093;Aušra;"2A klasė";4110537888;Taip;4;3;0;7
17094;Aušra;"3A klasė";8510995681;Taip;0;3;0;3
17095;Aušra;"3A klasė";9605206310;Taip;4;3;0;7
17096;Aušra;"3A klasė";3284383302;Taip;0;3;0;3
17097;Aušra;"3A klasė";13157844661;Taip;0;3;0;3
17098;Aušra;"3A klasė";14157070764;Taip;0;3;0;3
17099;Aušra;"3A klasė";99073448709;Taip;0;18;0;18
17100;Aušra;"3A klasė";68160889669;Taip;0;3;0;3
17101;Aušra;"3A klasė";1437126272;Taip;1;3;0;4
17102;Aušra;"3A klasė";15330844181;Taip;0;3;0;3
17103;Aušra;"3A klasė";39537089288;Taip;0;3;0;3
17104;Aušra;"3A klasė";2062775070;Taip;0;18;0;18
17105;Aušra;"3A klasė";3965445196;Taip;0;3;0;3
17106;Aušra;"3A klasė";85578471272;Taip;0;3;0;3
17107;Aušra;"3A klasė";88655846176;Taip;1;3;0;4
17108;Aušra;"3A klasė";73509864636;Ne;1;3;0;4
17109;Aušra;"3A klasė";27958163601;Taip;1;3;0;4
17110;Aušra;"3A klasė";40499781883;Taip;0;3;0;3
17111;Aušra;"3A klasė";68031503463;Taip;0;3;0;3
17112;Aušra;"3A klasė";81633973264;Taip;0;18;0;18
17113;Aušra;"3A klasė";70233681803;Taip;0;18;0;18
17114;Aušra;"3A klasė";1437385365;Taip;0;18;0;18
17115;Aušra;"3A klasė";51185323645;Taip;0;18;0;18
17116;Aušra;"3A klasė";52985512945;Taip;0;18;0;18
17117;Aušra;"3A klasė";97781409787;Taip;0;18;0;18
17118;Aušra;"3A klasė";474412140;Taip;0;3;0;3
17119;Aušra;"3A klasė";40714551025;Taip;0;3;0;3
17120;Aušra;"3A klasė";58699109274;Taip;1;3;0;4
17121;Aušra;"4A klasė";68481706412;Taip;0;18;0;18
17122;Aušra;"4A klasė";99886964420;Taip;0;18;0;18
17123;Aušra;"4A klasė";19920237804;Taip;7;3;0;10
17124;Aušra;"4A klasė";13361663464;Taip;7;3;0;10
17125;Aušra;"4A klasė";95948867937;Taip;0;3;0;3
17126;Aušra;"4A klasė";78030425432;Taip;0;3;0;3
17127;Aušra;"4A klasė";97596344387;Taip;10;3;0;13
17128;Aušra;"4A klasė";97596344387;Taip;10;3;0;13
17129;Aušra;"4A klasė";34795588283;Ne;0;18;0;18
17130;Aušra;"4A klasė";29636399665;Taip;0;3;0;3
17131;Aušra;"4A klasė";81428848455;Taip;0;3;0;3
17132;Aušra;"4A klasė";47725613978;Taip;0;3;0;3
17133;Aušra;"4A klasė";93365393803;Taip;0;18;0;18
17134;Aušra;"4A klasė";52864653926;Taip;1;3;0;4
17135;Aušra;"4A klasė";10272136932;Ne;0;3;0;3
17136;Aušra;"4A klasė";77425098448;Taip;1;3;0;4
17137;Aušra;"4A klasė";20550256232;Taip;3;3;0;6
17138;Aušra;"4A klasė";42015974556;Taip;4;3;0;7
17139;Aušra;"4A klasė";2113586354;Taip;0;3;0;3
17140;Aušra;"4A klasė";19718806057;Taip;0;18;0;18
17141;Aušra;"4A klasė";21856009403;Taip;0;18;0;18
17142;Aušra;"4A klasė";5166358753;Taip;0;3;0;3
17143;Aušra;Pabiručiai;7542690501;Taip;0;3;0;3
17144;Aušra;Pabiručiai;7476662446;Taip;2;2;0;4
17145;Aušra;Pabiručiai;9466807067;Taip;3;3;3;9
17146;Aušra;Pabiručiai;6508435821;Taip;0;5;0;5
17147;Aušra;Pabiručiai;7926621700;Taip;0;11;0;11
17148;Aušra;Pabiručiai;8665364744;Taip;18;0;0;18
17149;Aušra;Pabiručiai;6555345047;Taip;0;10;0;10
17150;Aušra;Pabiručiai;7888891808;Taip;0;3;1;4
17151;Aušra;Pabiručiai;8769357172;Taip;9;3;0;12
17152;Aušra;Pabiručiai;1306616759;Taip;0;7;0;7
17153;Aušra;Pabiručiai;3275288747;Taip;0;3;2;5
17154;Aušra;Pabiručiai;5797692122;Taip;0;6;2;8
17155;Aušra;Pabiručiai;4071233786;Taip;5;2;3;10
17156;Aušra;Pabiručiai;4646215025;Taip;0;3;1;4
17157;Aušra;Pabiručiai;7199483890;Taip;0;4;0;4
17158;Aušra;Pabiručiai;3008573040;Taip;0;3;0;3
17159;Aušra;Pabiručiai;7944904281;Taip;5;5;0;10
17160;Aušra;Pabiručiai;3336605264;Taip;0;1;1;2
17161;Aušra;Pabiručiai;7159809546;Taip;0;4;0;4
17162;Aušra;Pabiručiai;3553620602;Taip;2;5;0;7
17163;Aušra;Pabiručiai;3759593393;Taip;0;3;0;3
17164;Aušra;Pabiručiai;2904303784;Taip;0;3;0;3
17165;Aušra;Pabiručiai;6056923592;Taip;0;3;0;3
17166;Aušra;Pabiručiai;3953653896;Taip;0;8;0;8
17167;Aušra;Pabiručiai;2273160688;Taip;0;5;1;6
17168;Aušra;Pabiručiai;8462418277;Taip;0;3;0;3
17169;Aušra;Gudručiai;2271582954;Taip;4;1;1;6
17170;Aušra;Gudručiai;4564561993;Taip;0;3;0;3
17171;Aušra;Gudručiai;8715912139;Taip;0;3;0;3
17172;Aušra;Gudručiai;7783006852;Taip;0;2;0;2
17173;Aušra;Gudručiai;9614562473;Taip;0;4;0;4
17174;Aušra;Gudručiai;6658178519;Taip;0;4;0;4
17175;Aušra;Gudručiai;7921251819;Taip;14;0;0;14
17176;Aušra;Gudručiai;9628651723;Taip;4;7;2;13
17177;Aušra;Gudručiai;3343235857;Taip;5;3;0;8
17178;Aušra;Gudručiai;1337138547;Taip;5;5;0;10
17179;Aušra;Gudručiai;3530905126;Taip;0;0;18;18
17180;Aušra;Gudručiai;1429548355;Taip;0;8;0;8
17181;Aušra;Gudručiai;1933801749;Taip;8;2;0;10
17182;Aušra;Gudručiai;5955385407;Taip;10;4;0;14
17183;Aušra;Gudručiai;2243689816;Taip;0;5;0;5
17184;Aušra;Gudručiai;1693711284;Taip;0;1;0;1
17185;Aušra;Gudručiai;6935310711;Taip;0;3;0;3
17186;Aušra;Gudručiai;3698868934;Taip;5;3;0;8
17187;Aušra;Gudručiai;9079804366;Taip;6;2;0;8
17188;Aušra;Gudručiai;3498143162;Taip;6;2;0;8
17189;Aušra;Gudručiai;5053808615;Taip;0;4;0;4
17190;Aušra;Naminukai;5993984086;Taip;18;0;1;19
17191;Aušra;Naminukai;8884580599;Taip;7;0;0;7
17192;Aušra;Naminukai;6614027605;Taip;4;2;0;6
17193;Aušra;Naminukai;2039920706;Taip;0;5;0;5
17194;Aušra;Naminukai;6965081051;Taip;0;3;0;3
17195;Aušra;Naminukai;2768220823;Taip;5;3;2;10
17196;Aušra;Naminukai;5925213006;Taip;5;4;0;9
17197;Aušra;Naminukai;1630814772;Taip;0;4;0;4
17198;Aušra;Naminukai;9333701196;Taip;10;3;0;13
17199;Aušra;Naminukai;4010347313;Taip;18;0;0;18
17200;Aušra;Naminukai;3860755808;Taip;6;0;7;13
17201;Aušra;Naminukai;4339450816;Taip;0;3;0;3
17202;Aušra;Naminukai;4000881716;Taip;9;3;1;13
17203;Aušra;Naminukai;8021547491;Taip;4;4;0;8
17204;Aušra;Naminukai;5268479689;Taip;3;0;1;4
17205;Aušra;Naminukai;3526010606;Taip;0;2;0;2
17206;Aušra;Naminukai;4163605313;Taip;0;7;0;7
17207;Aušra;Naminukai;3468946868;Taip;18;0;0;18
17208;Aušra;Naminukai;7710131755;Taip;6;1;3;10
17209;Aušra;Naminukai;8584355573;Taip;0;3;4;7
17210;Aušra;Naminukai;2495610772;Taip;0;5;0;5
17211;Aušra;Naminukai;8489362814;Taip;0;0;3;3
17212;Aušra;Naminukai;3675175233;Taip;5;3;0;8
17213;Aušra;" 1C klasė";1426802917;Taip;1;3;0;4
17214;Aušra;" 1C klasė";26010333641;Taip;0;3;0;3
17215;Aušra;" 1C klasė";3133031845;Taip;8;3;0;11
17216;Aušra;" 1C klasė";11130172902;Ne;0;3;0;3
17217;Aušra;" 1C klasė";43737170074;Taip;0;3;0;3
17218;Aušra;" 1C klasė";1370336984;Taip;0;3;0;3
17219;Aušra;" 1C klasė";6483078840;Taip;0;3;0;3
17220;Aušra;" 1C klasė";1684481833;Taip;4;3;0;7
17221;Aušra;" 1C klasė";1198248619;Taip;0;3;0;3
17222;Aušra;" 1C klasė";4765125810;Taip;0;3;0;3
17223;Aušra;" 1C klasė";5704281727;Taip;1;3;0;4
17224;Aušra;" 1C klasė";1479311429;Taip;0;3;0;3
17225;Aušra;" 1C klasė";1542575012;Taip;1;3;0;4
17226;Aušra;" 1C klasė";1291782232;Taip;0;3;0;3
17227;Aušra;" 1C klasė";90520726029;Taip;5;3;0;8
17228;Aušra;" 1C klasė";1844632980;Ne;0;3;0;3
17229;Aušra;" 1C klasė";94478599707;Taip;0;3;0;3
17230;Aušra;" 1C klasė";78489473446;Taip;0;3;0;3
17231;Aušra;" 1C klasė";29328876924;Taip;3;3;0;6
17232;Aušra;" 1C klasė";7649832094;Taip;0;3;0;3
17233;Aušra;" 1C klasė";8225188274;Taip;2;3;0;5
17234;Aušra;" 1C klasė";1371282149;Taip;0;3;0;3
17235;Aušra;" 1C klasė";57559227292;Taip;0;3;0;3
17236;Berželis;PČIOLKI;6113571093;Taip;0;3;0;3
17237;Berželis;PČIOLKI;9024992452;Taip;0;3;0;3
17238;Berželis;PČIOLKI;1521982237;Taip;0;3;0;3
17239;Berželis;PČIOLKI;3437712794;Taip;4;3;0;7
17240;Berželis;PČIOLKI;3298044639;Taip;0;3;0;3
17241;Berželis;PČIOLKI;2615440913;Taip;10;3;0;13
17242;Berželis;PČIOLKI;4013215941;Taip;0;3;0;3
17243;Berželis;PČIOLKI;3772780161;Taip;10;4;0;14
17244;Berželis;PČIOLKI;4563582416;Taip;10;4;0;14
17245;Berželis;PČIOLKI;1225018351;Taip;0;3;0;3
17246;Berželis;PČIOLKI;9894751274;Taip;0;3;0;3
17247;Berželis;PČIOLKI;7526006253;Taip;10;3;0;13
17248;Berželis;PČIOLKI;1036370516;Taip;0;3;0;3
17249;Berželis;PČIOLKI;9644196870;Taip;0;3;0;3
17250;Berželis;PČIOLKI;2214171136;Taip;0;3;0;3
17251;Berželis;PČIOLKI;6473498471;Taip;2;3;0;5
17252;Berželis;PČIOLKI;97218091736;Taip;0;3;0;3
17253;Berželis;PČIOLKI;5798989689;Taip;0;3;0;3
17254;Berželis;PČIOLKI;2007064959;Taip;0;3;0;3
17255;Berželis;PČIOLKI;5084171353;Taip;0;3;0;3
17256;Berželis;PČIOLKI;4521372127;Taip;0;4;0;4
17257;Berželis;PČIOLKI;1067618571;Taip;10;0;0;10
17258;Berželis;PČIOLKI;7287552286;Taip;8;3;0;11
17259;Berželis;"BOŽJI KOROVKI";3162044236;Taip;0;1;0;1
17260;Berželis;"BOŽJI KOROVKI";9132058594;Taip;0;3;0;3
17261;Berželis;"BOŽJI KOROVKI";7421059780;Taip;0;3;0;3
17262;Berželis;"BOŽJI KOROVKI";5739847580;Taip;9;1;0;10
17263;Berželis;"BOŽJI KOROVKI";4100740863;Taip;0;14;0;14
17264;Berželis;"BOŽJI KOROVKI";1750209600;Taip;4;2;0;6
17265;Berželis;"BOŽJI KOROVKI";5953387226;Taip;0;9;0;9
17266;Berželis;"BOŽJI KOROVKI";3070917065;Taip;5;3;0;8
17267;Berželis;"BOŽJI KOROVKI";8118040960;Taip;0;1;0;1
17268;Berželis;"BOŽJI KOROVKI";2005082089;Taip;0;1;0;1
17269;Berželis;"BOŽJI KOROVKI";5692603837;Taip;8;3;0;11
17270;Berželis;"BOŽJI KOROVKI";5194480946;Taip;8;1;0;9
17271;Berželis;"BOŽJI KOROVKI";9848723402;Taip;0;2;2;4
17272;Berželis;"BOŽJI KOROVKI";5551459997;Taip;0;3;0;3
17273;Berželis;"BOŽJI KOROVKI";6651007152;Taip;8;0;0;8
17274;Berželis;"BOŽJI KOROVKI";8451877584;Taip;6;3;0;9
17275;Berželis;"BOŽJI KOROVKI";7080168105;Taip;8;1;0;9
17276;Berželis;"BOŽJI KOROVKI";9438498834;Ne;0;5;0;5
17277;Berželis;"BOŽJI KOROVKI";1132252592;Taip;11;3;0;14
17278;Berželis;"BOŽJI KOROVKI";5550598069;Taip;5;4;0;9
17279;Berželis;"BOŽJI KOROVKI";1852964349;Taip;4;0;2;6
17280;Berželis;"BOŽJI KOROVKI";8871199713;Taip;10;3;0;13
17281;Berželis;"BOŽJI KOROVKI";1722262813;Taip;4;3;0;7
17282;Berželis;"BOŽJI KOROVKI";9466461910;Taip;8;0;0;8
17283;Berželis;SOLNYŠKO;1498165322;Taip;0;0;3;3
17284;Berželis;SOLNYŠKO;8737788279;Taip;6;0;7;13
17285;Berželis;SOLNYŠKO;2901168499;Taip;5;0;3;8
17286;Berželis;SOLNYŠKO;7411282628;Taip;6;12;0;18
17287;Berželis;SOLNYŠKO;8957312159;Taip;7;0;3;10
17288;Berželis;SOLNYŠKO;4910899296;Taip;0;0;18;18
17289;Berželis;SOLNYŠKO;1167103292;Taip;6;0;5;11
17290;Berželis;SOLNYŠKO;5408368340;Taip;0;0;5;5
17291;Berželis;SOLNYŠKO;1070751052;Taip;3;0;2;5
17292;Berželis;SOLNYŠKO;5464385395;Taip;8;3;0;11
17293;Berželis;SOLNYŠKO;6422037185;Taip;6;0;0;6
17294;Berželis;SOLNYŠKO;1424868444;Taip;0;11;0;11
17295;Berželis;SOLNYŠKO;1146976812;Ne;3;3;0;6
17296;Berželis;SOLNYŠKO;6774460279;Taip;15;3;0;18
17297;Berželis;BABOČKI;4923631429;Taip;3;0;2;5
17298;Berželis;BABOČKI;2016194182;Taip;0;3;1;4
17299;Berželis;BABOČKI;2030770943;Taip;0;3;1;4
17300;Berželis;BABOČKI;2667957070;Taip;0;3;0;3
17301;Berželis;BABOČKI;7781031211;Taip;0;7;0;7
17302;Berželis;BABOČKI;2493612905;Taip;0;3;3;6
17303;Berželis;BABOČKI;5688897783;Taip;0;8;0;8
17304;Berželis;BABOČKI;6942559693;Taip;5;3;1;9
17305;Berželis;BABOČKI;9245706377;Taip;0;2;0;2
17306;Berželis;BABOČKI;6352635742;Taip;0;4;0;4
17307;Berželis;BABOČKI;3613459846;Taip;4;1;0;5
17308;Berželis;BABOČKI;8448872491;Taip;6;1;0;7
17309;Berželis;BABOČKI;5069322062;Taip;1;3;1;5
17310;Berželis;BABOČKI;2954451168;Taip;0;2;0;2
17311;Berželis;BABOČKI;9585609150;Taip;5;7;0;12
17312;Berželis;BABOČKI;9091691636;Taip;0;0;1;1
17313;Berželis;BABOČKI;7940591009;Taip;0;0;6;6
17314;Berželis;BABOČKI;4546285993;Taip;0;18;0;18
17315;Berželis;BABOČKI;5876182759;Taip;0;6;0;6
17316;Berželis;BABOČKI;9568910880;Taip;0;7;0;7
17317;Berželis;BABOČKI;6577232093;Taip;5;0;4;9
17318;Berželis;SOVUŠKI;5350402890;Taip;0;3;1;4
17319;Berželis;SOVUŠKI;8185887403;Taip;10;2;0;12
17320;Berželis;SOVUŠKI;8989621715;Taip;3;2;0;5
17321;Berželis;SOVUŠKI;1289333809;Taip;5;4;0;9
17322;Berželis;SOVUŠKI;8086074279;Taip;11;3;0;14
17323;Berželis;SOVUŠKI;9273819928;Taip;0;4;0;4
17324;Berželis;SOVUŠKI;9750863775;Taip;0;7;0;7
17325;Berželis;SOVUŠKI;1769470120;Taip;0;3;0;3
17326;Berželis;SOVUŠKI;3885474466;Taip;6;0;0;6
17327;Berželis;SOVUŠKI;1825910306;Taip;5;1;0;6
17328;Berželis;SOVUŠKI;6706273205;Taip;0;1;0;1
17329;Berželis;SOVUŠKI;2895332184;Ne;3;0;0;3
17330;Berželis;SOVUŠKI;1464998584;Taip;0;4;0;4
17331;Berželis;SOVUŠKI;2844736188;Taip;0;0;2;2
17332;Berželis;SOVUŠKI;3835273594;Taip;0;6;0;6
17333;Berželis;SOVUŠKI;2632535013;Taip;0;4;0;4
17334;Berželis;SOVUŠKI;6698849108;Taip;0;0;2;2
17335;Berželis;SOVUŠKI;1583268041;Taip;2;3;0;5
17336;Berželis;PODSOLNUŠKI;1044720859;Taip;4;0;5;9
17337;Berželis;PODSOLNUŠKI;3157906472;Taip;0;0;4;4
17338;Berželis;PODSOLNUŠKI;9945124824;Taip;13;0;0;13
17339;Berželis;PODSOLNUŠKI;5925726854;Taip;8;0;0;8
17340;Berželis;PODSOLNUŠKI;9072126286;Taip;0;0;6;6
17341;Berželis;PODSOLNUŠKI;8633724383;Taip;7;3;2;12
17342;Berželis;PODSOLNUŠKI;2259367998;Taip;0;0;2;2
17343;Berželis;PODSOLNUŠKI;3033042487;Taip;16;0;0;16
17344;Berželis;PODSOLNUŠKI;2136455625;Taip;0;0;4;4
17345;Berželis;PODSOLNUŠKI;1964320071;Taip;5;3;1;9
17346;Berželis;PODSOLNUŠKI;2615832804;Taip;10;0;0;10
17347;Berželis;PODSOLNUŠKI;9133988149;Taip;0;3;2;5
17348;Berželis;PODSOLNUŠKI;5795151632;Taip;0;0;3;3
17349;Berželis;PODSOLNUŠKI;6686248053;Taip;0;0;4;4
17350;Berželis;PODSOLNUŠKI;1081582842;Taip;5;3;0;8
17351;Berželis;PODSOLNUŠKI;5963915092;Taip;8;0;0;8
17352;Berželis;PODSOLNUŠKI;3378237475;Taip;8;0;0;8
17353;Berželis;LAPIUKAI;2539824027;Taip;0;0;2;2
17354;Berželis;LAPIUKAI;2971765753;Taip;3;0;11;14
17355;Berželis;LAPIUKAI;3813964138;Taip;0;3;0;3
17356;Berželis;LAPIUKAI;7947225506;Taip;0;2;3;5
17357;Berželis;LAPIUKAI;2144796691;Taip;17;0;0;17
17358;Berželis;LAPIUKAI;1834920753;Taip;0;0;3;3
17359;Berželis;LAPIUKAI;6384939601;Taip;0;0;2;2
17360;Berželis;LAPIUKAI;2410514408;Taip;0;0;2;2
17361;Berželis;LAPIUKAI;2794074071;Taip;5;0;1;6
17362;Berželis;LAPIUKAI;9681310544;Taip;0;0;3;3
17363;Berželis;LAPIUKAI;4254592648;Taip;0;0;10;10
17364;Berželis;LAPIUKAI;9749516260;Taip;10;3;1;14
17365;Berželis;LAPIUKAI;2947072348;Ne;0;0;3;3
17366;Berželis;MEŠKIUKAI;8994102218;Taip;5;8;0;13
17367;Berželis;MEŠKIUKAI;4854931959;Taip;0;0;3;3
17368;Berželis;MEŠKIUKAI;7902774064;Taip;9;0;0;9
17369;Berželis;MEŠKIUKAI;2062794406;Taip;0;0;1;1
17370;Berželis;MEŠKIUKAI;9459031158;Taip;7;3;0;10
17371;Berželis;MEŠKIUKAI;4243086262;Taip;0;0;2;2
17372;Berželis;MEŠKIUKAI;9178527605;Taip;0;2;0;2
17373;Berželis;MEŠKIUKAI;1235617054;Taip;5;4;0;9
17374;Berželis;MEŠKIUKAI;1178588907;Taip;3;3;0;6
17375;Berželis;MEŠKIUKAI;5100214127;Ne;0;1;1;2
17376;Berželis;MEŠKIUKAI;3535856504;Taip;3;0;0;3
17377;Berželis;MEŠKIUKAI;6186408090;Taip;8;0;1;9
17378;Berželis;MEŠKIUKAI;1673524685;Taip;0;0;1;1
17379;Berželis;MEŠKIUKAI;2762946143;Taip;0;11;0;11
17380;Berželis;ŽIEDELIAI;3786609012;Taip;2;1;0;3
17381;Berželis;ŽIEDELIAI;9805181733;Taip;5;0;5;10
17382;Berželis;ŽIEDELIAI;1165300871;Taip;0;0;15;15
17383;Berželis;ŽIEDELIAI;2016827207;Ne;0;0;3;3
17384;Berželis;ŽIEDELIAI;9979442772;Ne;0;0;6;6
17385;Berželis;ŽIEDELIAI;9881246268;Taip;0;3;0;3
17386;Berželis;ŽIEDELIAI;7042967329;Taip;19;0;0;19
17387;Berželis;ŽIEDELIAI;9925865228;Taip;0;7;8;15
17388;Berželis;ŽIEDELIAI;1402975280;Taip;0;4;0;4
17389;Berželis;ŽIEDELIAI;1535940949;Taip;0;9;0;9
17390;Berželis;ŽIEDELIAI;2030492491;Taip;6;0;0;6
17391;Berželis;ŽIEDELIAI;3351114197;Taip;0;3;5;8
17392;Berželis;ŽIEDELIAI;5248880873;Taip;1;0;10;11
17393;Berželis;ŽIEDELIAI;2508532190;Taip;4;0;0;4
17394;Berželis;ŽIEDELIAI;5649793735;Taip;0;1;0;1
17395;Berželis;NYKŠTUKAI;8148104183;Ne;0;0;4;4
17396;Berželis;NYKŠTUKAI;7935684899;Ne;7;0;6;13
17397;Berželis;NYKŠTUKAI;1403664386;Taip;10;3;0;13
17398;Berželis;NYKŠTUKAI;5637168259;Taip;8;3;0;11
17399;Berželis;NYKŠTUKAI;9666648116;Taip;0;0;9;9
17400;Berželis;NYKŠTUKAI;3559065542;Ne;0;3;11;14
17401;Berželis;NYKŠTUKAI;3556594755;Taip;4;3;2;9
17402;Berželis;NYKŠTUKAI;2933069798;Taip;6;0;2;8
17403;Berželis;NYKŠTUKAI;8430372047;Taip;10;3;0;13
17404;Berželis;NYKŠTUKAI;5099275362;Taip;5;3;0;8
17405;Berželis;NYKŠTUKAI;2425621326;Ne;14;0;3;17
17406;Berželis;NYKŠTUKAI;7676141462;Ne;0;7;0;7
17407;Berželis;NYKŠTUKAI;3852021563;Taip;3;3;2;8
17408;Berželis;NYKŠTUKAI;3379227410;Taip;5;0;6;11
17409;Berželis;NYKŠTUKAI;4032178538;Taip;0;1;0;1
17410;Berželis;NYKŠTUKAI;5839964720;Taip;6;3;0;9
17411;Berželis;UOGELĖS;8164697203;Taip;0;3;0;3
17412;Berželis;UOGELĖS;5304917030;Taip;0;12;0;12
17413;Berželis;UOGELĖS;8907020701;Taip;3;0;0;3
17414;Berželis;UOGELĖS;6136155301;Taip;17;0;0;17
17415;Berželis;UOGELĖS;9950641759;Taip;21;0;2;23
17416;Berželis;UOGELĖS;9034464618;Taip;10;0;3;13
17417;Berželis;UOGELĖS;5851732944;Taip;12;0;3;15
17418;Berželis;UOGELĖS;2321608974;Ne;0;0;1;1
17419;Berželis;UOGELĖS;3229996417;Taip;7;0;2;9
17420;Berželis;UOGELĖS;6773760208;Ne;7;0;5;12
17421;Berželis;UOGELĖS;7750905743;Taip;5;6;0;11
17422;Berželis;UOGELĖS;4607486516;Ne;15;0;1;16
17423;Berželis;UOGELĖS;8814953641;Ne;5;0;3;8
17424;Berželis;UOGELĖS;5197350105;Taip;0;5;0;5
17425;Berželis;KODĖLČIUKAI;5786052354;Ne;0;0;1;1
17426;Berželis;KODĖLČIUKAI;5134372871;Ne;3;3;0;6
17427;Berželis;KODĖLČIUKAI;7852089381;Taip;0;0;1;1
17428;Berželis;KODĖLČIUKAI;5751995154;Ne;7;2;2;11
17429;Berželis;KODĖLČIUKAI;3589890886;Taip;0;3;0;3
17430;Berželis;KODĖLČIUKAI;7986744784;Ne;4;3;0;7
17431;Berželis;KODĖLČIUKAI;1127524998;Taip;0;9;0;9
17432;Berželis;KODĖLČIUKAI;3951962738;Taip;3;2;0;5
17433;Berželis;KODĖLČIUKAI;2193392844;Taip;10;0;3;13
17434;Berželis;KODĖLČIUKAI;9696962207;Taip;3;0;2;5
17435;Berželis;KODĖLČIUKAI;8286301258;Taip;5;5;0;10
17436;Berželis;KODĖLČIUKAI;8875116641;Taip;10;0;1;11
17437;Berželis;KODĖLČIUKAI;9282593781;Taip;0;11;0;11
17438;Berželis;KODĖLČIUKAI;6500588668;Taip;2;3;0;5
17439;Berželis;KODĖLČIUKAI;3327751482;Ne;5;3;0;8
17440;Berželis;KODĖLČIUKAI;6060490387;Taip;0;0;2;2
17441;Pelėdžiukas;Boružiukai;5736036224;Taip;2;0;0;2
17442;Pelėdžiukas;Šimtakojai;9540483835;Ne;19;0;0;19
17443;Pelėdžiukas;Žiogeliai;6271697959;Taip;11;0;0;11
17444;Pelėdžiukas;SKRUZDELIUKAI;3037312244;Taip;4;0;0;4
17445;Saulutė;Drugeliai;5987478379;Taip;0;0;2;2
17446;Saulutė;Drugeliai;5943795519;Taip;13;0;0;13
17447;Saulutė;Drugeliai;4453610732;Taip;0;0;3;3
17448;Saulutė;Drugeliai;4067009709;Taip;0;4;0;4
17449;Saulutė;Drugeliai;3991128892;Taip;14;0;0;14
17450;Saulutė;Drugeliai;4781756849;Taip;0;18;0;18
17451;Saulutė;Drugeliai;7689842018;Taip;3;0;0;3
17452;Saulutė;Drugeliai;4288298305;Taip;0;1;5;6
17453;Saulutė;Drugeliai;9133269796;Taip;8;1;0;9
17454;Saulutė;Drugeliai;6057938367;Taip;18;0;0;18
17455;Saulutė;Drugeliai;1268204445;Taip;1;1;2;4
17456;Saulutė;Drugeliai;1585403702;Taip;4;0;3;7
17457;Saulutė;Drugeliai;8003855875;Taip;3;0;3;6
17458;Saulutė;Drugeliai;2301903550;Taip;7;4;0;11
17459;Saulutė;Drugeliai;3265401334;Taip;3;0;0;3
17460;Saulutė;Drugeliai;2337702344;Taip;0;10;0;10
17461;Saulutė;Drugeliai;3662919521;Taip;0;3;0;3
17462;Saulutė;Drugeliai;6455593653;Taip;0;3;0;3
17463;Saulutė;Drugeliai;9410517602;Taip;0;0;2;2
17464;Saulutė;Drugeliai;1088813143;Taip;0;0;7;7
17465;Saulutė;Drugeliai;8409958782;Taip;11;0;0;11
17466;Saulutė;Drugeliai;6304028361;Taip;13;0;0;13
17467;Saulutė;"Saulės zuikučiai";8946107286;Taip;0;5;0;5
17468;Saulutė;"Saulės zuikučiai";2397257894;Taip;0;6;0;6
17469;Saulutė;"Saulės zuikučiai";5148542811;Taip;18;0;0;18
17470;Saulutė;"Saulės zuikučiai";2259917151;Taip;0;3;0;3
17471;Saulutė;"Saulės zuikučiai";3749374270;Taip;0;3;0;3
17472;Saulutė;"Saulės zuikučiai";8242602551;Ne;0;5;0;5
17473;Saulutė;"Saulės zuikučiai";5247769309;Taip;5;4;0;9
17474;Saulutė;"Saulės zuikučiai";2816806902;Taip;2;3;0;5
17475;Saulutė;"Saulės zuikučiai";2781003892;Taip;0;3;0;3
17476;Saulutė;"Saulės zuikučiai";7888435573;Taip;0;2;0;2
17477;Saulutė;"Saulės zuikučiai";9521155670;Taip;0;1;0;1
17478;Saulutė;"Saulės zuikučiai";3089541630;Taip;0;2;0;2
17479;Saulutė;"Saulės zuikučiai";5326279083;Taip;0;1;0;1
17480;Saulutė;"Saulės zuikučiai";1562393383;Taip;0;3;1;4
17481;Saulutė;"Saulės zuikučiai";3272296969;Taip;10;3;0;13
17482;Saulutė;"Saulės zuikučiai";6924891265;Taip;0;3;0;3
17483;Saulutė;"Saulės zuikučiai";4663795223;Taip;10;3;1;14
17484;Saulutė;"Saulės zuikučiai";5931269521;Taip;9;5;0;14
17485;Saulutė;"Saulės zuikučiai";7839168221;Taip;0;0;3;3
17486;Saulutė;"Saulės zuikučiai";4945943570;Ne;7;3;0;10
17487;Saulutė;"Saulės zuikučiai";3730442890;Taip;0;6;0;6
17488;Saulutė;"Saulės zuikučiai";3620722907;Taip;0;3;0;3
17489;Saulutė;Boružėlės;3295289082;Taip;0;7;0;7
17490;Saulutė;Boružėlės;1587328722;Taip;0;3;0;3
17491;Saulutė;Boružėlės;8390767549;Taip;0;3;2;5
17492;Saulutė;Boružėlės;7576532632;Taip;5;0;4;9
17493;Saulutė;Boružėlės;2725491887;Taip;18;0;0;18
17494;Saulutė;Boružėlės;9314889468;Taip;0;3;0;3
17495;Saulutė;Boružėlės;7764493159;Taip;5;3;0;8
17496;Saulutė;Boružėlės;5565832676;Taip;5;3;0;8
17497;Saulutė;Boružėlės;5811810714;Taip;10;3;0;13
17498;Saulutė;Boružėlės;8643975544;Taip;0;0;5;5
17499;Saulutė;Boružėlės;7081700501;Taip;7;0;3;10
17500;Saulutė;Boružėlės;7474989619;Taip;0;3;5;8
17501;Saulutė;Boružėlės;8619163154;Ne;0;0;8;8
17502;Saulutė;Boružėlės;7574225926;Taip;0;1;1;2
17503;Saulutė;Boružėlės;1803710557;Taip;4;0;4;8
17504;Saulutė;Boružėlės;9173336078;Taip;0;1;0;1
17505;Saulutė;Boružėlės;9098663596;Taip;0;0;5;5
17506;Saulutė;Boružėlės;7425789805;Taip;0;3;0;3
17507;Saulutė;Boružėlės;1265174091;Taip;0;0;4;4
17508;Saulutė;Boružėlės;2527027536;Taip;10;8;0;18
17509;Saulutė;Boružėlės;2988010963;Taip;5;13;0;18
17510;Saulutė;Boružėlės;3852862834;Taip;0;0;12;12
17511;Saulutė;Boružėlės;1275552038;Taip;0;0;8;8
17512;Saulutė;Nykštukai;2601822200;Taip;0;2;6;8
17513;Saulutė;Nykštukai;3244850673;Taip;0;5;0;5
17514;Saulutė;Nykštukai;9497439410;Taip;0;4;0;4
17515;Saulutė;Nykštukai;5607937410;Taip;3;4;0;7
17516;Saulutė;Nykštukai;3571751974;Taip;5;0;4;9
17517;Saulutė;Nykštukai;3221612665;Ne;10;1;2;13
17518;Saulutė;Nykštukai;2140277182;Taip;8;1;0;9
17519;Saulutė;Nykštukai;4510990261;Taip;0;4;1;5
17520;Saulutė;Nykštukai;4800144085;Taip;5;0;4;9
17521;Saulutė;Nykštukai;8257363228;Taip;0;3;2;5
17522;Saulutė;Nykštukai;9664809396;Taip;3;0;0;3
17523;Saulutė;Nykštukai;8984040932;Taip;5;8;0;13
17524;Saulutė;Nykštukai;3463428772;Taip;1;5;0;6
17525;Saulutė;Nykštukai;4390098560;Taip;4;4;0;8
17526;Saulutė;Nykštukai;3363212754;Taip;0;8;0;8
17527;Saulutė;Nykštukai;5442075474;Taip;4;0;5;9
17528;Saulutė;Nykštukai;4298556244;Taip;0;0;1;1
17529;Saulutė;Nykštukai;8722717930;Taip;0;18;0;18
17530;Saulutė;Nykštukai;9930330487;Taip;8;3;0;11
17531;Saulutė;Nykštukai;7158455528;Taip;10;4;0;14
17532;Saulutė;Nykštukai;2669711574;Taip;0;0;3;3
17533;Saulutė;Nykštukai;6982979199;Taip;0;0;8;8
17534;Saulutė;Meškiukai;8952893819;Taip;0;18;0;18
17535;Saulutė;Meškiukai;4222649372;Ne;9;0;0;9
17536;Saulutė;Meškiukai;1229624643;Taip;0;5;0;5
17537;Saulutė;Meškiukai;9572394489;Taip;5;3;2;10
17538;Saulutė;Meškiukai;9567511354;Taip;5;0;2;7
17539;Saulutė;Meškiukai;6126870829;Taip;15;3;0;18
17540;Saulutė;Meškiukai;6579874077;Taip;0;8;0;8
17541;Saulutė;Meškiukai;6178908581;Taip;0;3;1;4
17542;Saulutė;Meškiukai;8472510151;Taip;5;3;2;10
17543;Saulutė;Meškiukai;6955061957;Taip;12;5;0;17
17544;Saulutė;Meškiukai;7478215328;Taip;3;3;2;8
17545;Saulutė;Meškiukai;9727366891;Taip;15;0;0;15
17546;Saulutė;Meškiukai;3565818383;Taip;16;0;0;16
17547;Saulutė;Meškiukai;5219429911;Taip;0;18;0;18
17548;Saulutė;Meškiukai;3125186472;Taip;5;0;1;6
17549;Saulutė;Meškiukai;8919457259;Taip;0;0;11;11
17550;Saulutė;Meškiukai;5509365461;Taip;3;0;3;6
17551;Saulutė;Meškiukai;8787977881;Ne;8;0;1;9
17552;Saulutė;Ežiukai;2813274509;Taip;5;0;3;8
17553;Saulutė;Ežiukai;3410606033;Taip;7;4;0;11
17554;Saulutė;Ežiukai;2315812734;Taip;14;0;0;14
17555;Saulutė;Ežiukai;2059342403;Ne;6;0;3;9
17556;Saulutė;Ežiukai;8736917541;Taip;8;0;0;8
17557;Saulutė;Ežiukai;5999318972;Taip;3;0;0;3
17558;Saulutė;Ežiukai;4363210987;Taip;5;4;0;9
17559;Saulutė;Ežiukai;5972503001;Taip;18;0;0;18
17560;Saulutė;Ežiukai;6884472677;Taip;6;0;1;7
17561;Saulutė;Ežiukai;6219942114;Taip;0;0;3;3
17562;Saulutė;Ežiukai;4194586403;Taip;0;0;4;4
17563;Saulutė;Ežiukai;1853984777;Taip;10;0;1;11
17564;Saulutė;Ežiukai;1666301750;Ne;8;0;2;10
17565;Saulutė;Ežiukai;3133714991;Taip;9;0;0;9
17566;Saulutė;Ežiukai;4039065925;Taip;8;0;2;10
17567;Saulutė;Ežiukai;7967532537;Taip;0;0;3;3
17568;Saulutė;Ežiukai;5335820652;Taip;0;0;5;5
17569;Saulutė;Ežiukai;2728669975;Taip;5;2;0;7
17570;Saulutė;Ežiukai;9892855816;Taip;1;0;0;1
17571;Saulutė;Ežiukai;9398356470;Taip;0;0;6;6
17572;Saulutė;Bitutės;5200638523;Taip;3;3;0;6
17573;Saulutė;Bitutės;5448950324;Taip;18;0;0;18
17574;Saulutė;Bitutės;3948540247;Taip;2;2;0;4
17575;Saulutė;Bitutės;4130972647;Taip;7;0;1;8
17576;Saulutė;Bitutės;3242810449;Taip;8;9;0;17
17577;Saulutė;Bitutės;7032417938;Taip;0;3;0;3
17578;Saulutė;Bitutės;5897526863;Taip;8;3;0;11
17579;Saulutė;Bitutės;9110162513;Taip;0;3;0;3
17580;Saulutė;Bitutės;1648978545;Taip;3;15;0;18
17581;Saulutė;Bitutės;6927834443;Taip;0;16;0;16
17582;Saulutė;Bitutės;8714520840;Taip;15;3;0;18
17583;Saulutė;Bitutės;9726675673;Taip;18;0;0;18
17584;Saulutė;Bitutės;8520474896;Taip;18;0;0;18
17585;Saulutė;Bitutės;6189637986;Taip;3;3;0;6
17586;Saulutė;Bitutės;7132125341;Taip;0;1;2;3
17587;Saulutė;Bitutės;3215349379;Taip;0;4;8;12
17588;Saulutė;Bitutės;3259790911;Taip;18;0;0;18
17589;Saulutė;Bitutės;7311594119;Taip;10;0;0;10
17590;Saulutė;Pelėdžiukai;8512137633;Taip;6;0;3;9
17591;Saulutė;Pelėdžiukai;7139492238;Taip;0;0;2;2
17592;Saulutė;Pelėdžiukai;4211866191;Taip;0;0;2;2
17593;Saulutė;Pelėdžiukai;2373409300;Taip;0;0;9;9
17594;Saulutė;Pelėdžiukai;8405262902;Taip;5;0;2;7
17595;Saulutė;Pelėdžiukai;1745754752;Taip;0;1;1;2
17596;Saulutė;Pelėdžiukai;4123500930;Ne;0;5;0;5
17597;Saulutė;Pelėdžiukai;1056158093;Taip;0;0;2;2
17598;Saulutė;Pelėdžiukai;8371366346;Taip;0;0;7;7
17599;Saulutė;Pelėdžiukai;6842585310;Taip;0;2;4;6
17600;Saulutė;Pelėdžiukai;1776164273;Taip;0;2;6;8
17601;Saulutė;Pelėdžiukai;5850783789;Taip;5;3;0;8
17602;Saulutė;Pelėdžiukai;6608003946;Taip;0;18;0;18
17603;Saulutė;Pelėdžiukai;7243072252;Taip;0;3;0;3
17604;Saulutė;Pelėdžiukai;9903380188;Taip;5;0;3;8
17605;Saulutė;Pelėdžiukai;2450554594;Taip;0;3;0;3
17606;Saulutė;Pelėdžiukai;7620841597;Taip;5;0;3;8
17607;Saulutė;Pelėdžiukai;7640441297;Taip;0;0;3;3
17608;Saulutė;Pelėdžiukai;6046611248;Taip;0;8;0;8
17609;Saulutė;Pelėdžiukai;4301516165;Taip;0;18;0;18
17610;Saulutė;Pelėdžiukai;7258180835;Ne;0;2;5;7
17611;Saulutė;Pelėdžiukai;2566263680;Ne;0;2;8;10
17612;Saulutė;Pelėdžiukai;9106119465;Ne;0;0;3;3
17613;Saulutė;Zylutės;3228226715;Taip;5;4;2;11
17614;Saulutė;Zylutės;8040751073;Taip;0;3;1;4
17615;Saulutė;Zylutės;2074473832;Taip;0;2;0;2
17616;Saulutė;Zylutės;8041118115;Taip;0;18;0;18
17617;Saulutė;Zylutės;5198558993;Taip;18;0;0;18
17618;Saulutė;Zylutės;6109527712;Ne;0;3;0;3
17619;Saulutė;Zylutės;4686825392;Taip;8;0;0;8
17620;Saulutė;Zylutės;7446423510;Taip;0;3;0;3
17621;Saulutė;Zylutės;8717210130;Taip;4;2;7;13
17622;Saulutė;Zylutės;5264813819;Taip;0;0;5;5
17623;Saulutė;Zylutės;2885398200;Taip;5;3;0;8
17624;Saulutė;Zylutės;7844396402;Taip;0;1;0;1
17625;Saulutė;Zylutės;7351477901;Taip;0;3;0;3
17626;Saulutė;Zylutės;9146298505;Ne;0;2;0;2
17627;Saulutė;Zylutės;1324799653;Taip;0;9;0;9
17628;Saulutė;Zylutės;3691381351;Taip;0;3;0;3
17629;Saulutė;Zylutės;2010774109;Taip;1;3;0;4
17630;Saulutė;Zylutės;1546200973;Taip;8;0;0;8
17631;Saulutė;Zylutės;8379304869;Ne;5;3;0;8
17632;Saulutė;Zylutės;66108847230;Taip;0;5;0;5
17633;Saulutė;Zylutės;95439358242;Ne;0;3;0;3
17634;Saulutė;Zylutės;9947607411;Ne;4;3;0;7
17635;Saulutė;Zylutės;3408369823;Taip;0;3;5;8
17636;Saulutė;"1 klasė";1717909005;Taip;1;4;0;5
17637;Saulutė;"1 klasė";87814849917;Taip;5;4;0;9
17638;Saulutė;"1 klasė";84919478493;Taip;5;4;0;9
17639;Saulutė;"1 klasė";1320018338;Taip;3;4;0;7
17640;Saulutė;"1 klasė";8599199376;Taip;0;4;0;4
17641;Saulutė;"1 klasė";8944601874;Taip;2;4;0;6
17642;Saulutė;"1 klasė";3064199909;Taip;3;4;0;7
17643;Saulutė;"1 klasė";1556270046;Taip;0;4;0;4
17644;Saulutė;"1 klasė";4272320685;Taip;2;4;0;6
17645;Saulutė;"1 klasė";1291318940;Taip;0;4;0;4
17646;Saulutė;"1 klasė";1391904744;Taip;1;4;0;5
17647;Saulutė;"1 klasė";6096297366;Ne;10;4;0;14
17648;Saulutė;"1 klasė";1609952589;Taip;0;4;0;4
17649;Saulutė;"1 klasė";1513449225;Taip;2;4;0;6
17650;Saulutė;"1 klasė";7281873166;Taip;5;4;0;9
17651;Saulutė;"1 klasė";1911318708;Taip;0;4;0;4
17652;Saulutė;"1 klasė";28772515317;Taip;0;4;0;4
17653;Saulutė;"1 klasė";1786491396;Taip;0;4;0;4
17654;Saulutė;"1 klasė";1332002470;Taip;0;4;0;4
17655;Saulutė;"1 klasė";16622528829;Taip;0;4;0;4
17656;Saulutė;"1 klasė";61073095949;Taip;0;4;0;4
17657;Saulutė;"1 klasė";3505492809;Taip;0;4;0;4
17658;Saulutė;"1 klasė";8952155496;Ne;0;4;0;4
17659;Saulutė;"1 klasė";9235972927;Taip;0;4;0;4
17660;Saulutė;"1 klasė";2677995903;Taip;0;4;0;4
17661;Saulutė;"1 klasė";1386800520;Taip;3;4;0;7
17662;Saulutė;"1 klasė";89920419797;Taip;0;4;0;4
17663;Saulutė;"2 klasė";45306237230;Taip;3;4;0;7
17664;Saulutė;"2 klasė";79438946697;Taip;3;4;0;7
17665;Saulutė;"2 klasė";79919438191;Ne;0;4;0;4
17666;Saulutė;"2 klasė";29074930927;Taip;1;4;0;5
17667;Saulutė;"2 klasė";8369703027;Taip;0;4;0;4
17668;Saulutė;"2 klasė";21605684303;Taip;0;4;0;4
17669;Saulutė;"2 klasė";31705050946;Taip;0;4;0;4
17670;Saulutė;"2 klasė";2622662153;Taip;7;4;0;11
17671;Saulutė;"2 klasė";9612975694;Taip;3;4;0;7
17672;Saulutė;"2 klasė";37315117916;Taip;0;4;0;4
17673;Saulutė;"2 klasė";3445723020;Ne;0;4;0;4
17674;Saulutė;"2 klasė";14195215027;Taip;0;4;0;4
17675;Saulutė;"2 klasė";2098990667;Taip;1;4;0;5
17676;Saulutė;"2 klasė";27386434894;Taip;0;4;0;4
17677;Saulutė;"2 klasė";77923802656;Taip;0;4;0;4
17678;Saulutė;"2 klasė";46280382280;Taip;1;4;0;5
17679;Saulutė;"2 klasė";1935503629;Taip;0;4;0;4
17680;Saulutė;"2 klasė";75405796772;Taip;6;4;0;10
17681;Saulutė;"2 klasė";1277263391;Taip;3;4;0;7
17682;Saulutė;"2 klasė";97145959022;Taip;3;4;0;7
17683;Saulutė;"2 klasė";64418469679;Taip;1;4;0;5
17684;Saulutė;"2 klasė";77170708225;Taip;0;4;0;4
17685;Saulutė;"2 klasė";4640909915;Ne;0;4;0;4
17686;Saulutė;"2 klasė";65492344097;Taip;0;4;0;4
17687;Saulutė;"2 klasė";1704733670;Ne;0;4;0;4
17688;Saulutė;"2 klasė";1534183935;Taip;0;4;0;4
17689;Saulutė;"2 klasė";5574049005;Taip;3;4;0;7
17690;Saulutė;"2 klasė";1510434265;Taip;5;4;0;9
17691;Saulutė;"3 klasė";1005459768;Taip;4;4;0;8
17692;Saulutė;"3 klasė";1804521229;Taip;1;4;0;5
17693;Saulutė;"3 klasė";76108591835;Taip;0;4;0;4
17694;Saulutė;"3 klasė";1475031090;Taip;1;4;0;5
17695;Saulutė;"3 klasė";3156830821;Taip;0;4;0;4
17696;Saulutė;"3 klasė";5741276602;Taip;0;4;0;4
17697;Saulutė;"3 klasė";3246485288;Taip;3;4;0;7
17698;Saulutė;"3 klasė";44452051978;Ne;3;4;0;7
17699;Saulutė;"3 klasė";78967475616;Ne;2;4;0;6
17700;Saulutė;"3 klasė";89710141573;Taip;2;4;0;6
17701;Saulutė;"3 klasė";25124975646;Taip;0;4;0;4
17702;Saulutė;"3 klasė";3450668814;Taip;4;4;0;8
17703;Saulutė;"3 klasė";8168961080;Ne;2;4;0;6
17704;Saulutė;"3 klasė";57283533169;Taip;0;4;0;4
17705;Saulutė;"3 klasė";76744652185;Taip;1;4;0;5
17706;Saulutė;"3 klasė";97296161595;Taip;1;4;0;5
17707;Saulutė;"3 klasė";87409240076;Taip;3;4;0;7
17708;Saulutė;"3 klasė";1205642335;Taip;5;4;0;9
17709;Saulutė;"3 klasė";2426509692;Taip;2;4;0;6
17710;Saulutė;"3 klasė";36414547943;Taip;1;4;0;5
17711;Saulutė;"3 klasė";99841176399;Taip;2;4;0;6
17712;Saulutė;"3 klasė";21703177024;Taip;0;4;0;4
17713;Saulutė;"3 klasė";1337654926;Taip;0;4;0;4
17714;Saulutė;"3 klasė";54950572289;Taip;4;4;0;8
17715;Saulutė;"3 klasė";13147367113;Taip;0;4;0;4
17716;Saulutė;"3 klasė";2216383015;Taip;5;4;0;9
17717;Saulutė;"3 klasė";1644704074;Taip;0;4;0;4
17718;Saulutė;"3 klasė";96497471950;Taip;1;4;0;5
17719;Saulutė;"3 klasė";6557918941;Ne;0;4;0;4
17720;Saulutė;"3 klasė";2787531476;Ne;5;4;0;9
17721;Saulutė;"4 klasė";5822529731;Taip;1;4;0;5
17722;Saulutė;"4 klasė";67739063665;Ne;1;4;0;5
17723;Saulutė;"4 klasė";13916981850;Taip;2;4;0;6
17724;Saulutė;"4 klasė";39606108938;Ne;0;4;0;4
17725;Saulutė;"4 klasė";81191097069;Taip;1;4;0;5
17726;Saulutė;"4 klasė";92198716772;Taip;6;4;0;10
17727;Saulutė;"4 klasė";16523279366;Taip;0;4;0;4
17728;Saulutė;"4 klasė";2262536579;Taip;5;4;0;9
17729;Saulutė;"4 klasė";2095347468;Ne;0;4;0;4
17730;Saulutė;"4 klasė";2819521168;Taip;0;4;0;4
17731;Saulutė;"4 klasė";37839378248;Taip;1;4;0;5
17732;Saulutė;"4 klasė";8308288099;Ne;0;4;0;4
17733;Saulutė;"4 klasė";30863736694;Taip;0;4;0;4
17734;Saulutė;"4 klasė";12964000357;Taip;0;4;0;4
17735;Saulutė;"4 klasė";54726632101;Taip;2;4;0;6
17736;Saulutė;"4 klasė";25720655179;Taip;1;4;0;5
17737;Saulutė;"4 klasė";45877127245;Taip;2;4;0;6
17738;Saulutė;"4 klasė";82106514982;Taip;10;4;0;14
17739;Saulutė;"4 klasė";61113930769;Taip;2;4;0;6
17740;Saulutė;"4 klasė";5213320470;Ne;5;4;0;9
17741;Saulutė;"4 klasė";90078805222;Taip;0;4;0;4
17742;Saulutė;"4 klasė";50110262859;Taip;3;4;0;7
17743;Saulutė;"4 klasė";42204884890;Ne;2;4;0;6
17744;Svaja;SAULĖGRĄŽA;4189290919;Taip;0;18;0;18
17745;Svaja;SAULĖGRĄŽA;4333001830;Taip;0;0;1;1
17746;Svaja;SAULĖGRĄŽA;6980866050;Taip;0;0;3;3
17747;Svaja;SAULĖGRĄŽA;3912426942;Taip;0;3;0;3
17748;Svaja;SAULĖGRĄŽA;9680766688;Taip;0;3;3;6
17749;Svaja;SAULĖGRĄŽA;3809817617;Ne;0;3;1;4
17750;Svaja;SAULĖGRĄŽA;3792660330;Taip;5;4;0;9
17751;Svaja;SAULĖGRĄŽA;4253831334;Taip;0;7;0;7
17752;Svaja;SAULĖGRĄŽA;3461282516;Taip;7;0;1;8
17753;Svaja;SAULĖGRĄŽA;9240037050;Taip;0;6;0;6
17754;Svaja;SAULĖGRĄŽA;7089640807;Taip;0;6;0;6
17755;Svaja;SAULĖGRĄŽA;6963684639;Taip;0;4;0;4
17756;Svaja;SAULĖGRĄŽA;4510147045;Taip;12;8;0;20
17757;Svaja;SAULĖGRĄŽA;6928763381;Taip;8;0;3;11
17758;Svaja;SAULĖGRĄŽA;3501620040;Taip;7;3;0;10
17759;Svaja;SAULĖGRĄŽA;7575922215;Taip;0;3;0;3
17760;Svaja;SAULĖGRĄŽA;7408966637;Taip;0;8;0;8
17761;Svaja;SAULĖGRĄŽA;7747251736;Taip;0;3;1;4
17762;Svaja;"STEBUKLINGAS ŽIBINTAS";9814969596;Taip;2;4;0;6
17763;Svaja;"STEBUKLINGAS ŽIBINTAS";2200408537;Taip;0;3;1;4
17764;Svaja;"STEBUKLINGAS ŽIBINTAS";9086270220;Taip;5;0;2;7
17765;Svaja;"STEBUKLINGAS ŽIBINTAS";3940123543;Taip;18;0;0;18
17766;Svaja;"STEBUKLINGAS ŽIBINTAS";8353427144;Taip;0;3;0;3
17767;Svaja;"STEBUKLINGAS ŽIBINTAS";9843726794;Taip;0;3;0;3
17768;Svaja;"STEBUKLINGAS ŽIBINTAS";4237592104;Ne;1;0;3;4
17769;Svaja;"STEBUKLINGAS ŽIBINTAS";2658828200;Taip;0;3;1;4
17770;Svaja;"STEBUKLINGAS ŽIBINTAS";4290716676;Taip;12;0;0;12
17771;Svaja;"STEBUKLINGAS ŽIBINTAS";1558093905;Taip;0;2;0;2
17772;Svaja;"STEBUKLINGAS ŽIBINTAS";9102872020;Taip;7;0;0;7
17773;Svaja;"STEBUKLINGAS ŽIBINTAS";8827421660;Taip;0;4;0;4
17774;Svaja;"STEBUKLINGAS ŽIBINTAS";7277217069;Taip;0;3;2;5
17775;Svaja;"STEBUKLINGAS ŽIBINTAS";9259478140;Taip;0;0;3;3
17776;Svaja;"STEBUKLINGAS ŽIBINTAS";1050291871;Taip;7;3;1;11
17777;Svaja;"STEBUKLINGAS ŽIBINTAS";2188430052;Taip;0;3;5;8
17778;Svaja;"STEBUKLINGAS ŽIBINTAS";1860076171;Taip;3;0;4;7
17779;Svaja;"STEBUKLINGAS ŽIBINTAS";8363418532;Taip;0;0;7;7
17780;Svaja;"STEBUKLINGAS ŽIBINTAS";8172396846;Taip;8;5;0;13
17781;Svaja;"STEBUKLINGAS ŽIBINTAS";9545690301;Taip;4;11;0;15
17782;Svaja;"STEBUKLINGAS ŽIBINTAS";4004383843;Taip;0;4;0;4
17783;Svaja;"STEBUKLINGAS ŽIBINTAS";6128350581;Taip;5;3;3;11
17784;Svaja;"STEBUKLINGAS ŽIBINTAS";1150040935;Taip;6;3;0;9
17785;Svaja;SAULUTĖ;50207734108;Ne;0;3;1;4
17786;Svaja;SAULUTĖ;20473739993;Taip;7;2;3;12
17787;Svaja;SAULUTĖ;30719991872;Taip;15;0;0;15
17788;Svaja;SAULUTĖ;6665752307;Taip;0;3;3;6
17789;Svaja;SAULUTĖ;4968201186;Taip;0;4;0;4
17790;Svaja;SAULUTĖ;8689706130;Taip;0;4;0;4
17791;Svaja;SAULUTĖ;6807834176;Taip;0;2;1;3
17792;Svaja;SAULUTĖ;7020342969;Taip;2;5;0;7
17793;Svaja;SAULUTĖ;3633996231;Taip;0;0;7;7
17794;Svaja;SAULUTĖ;2750615517;Taip;6;0;0;6
17795;Svaja;SAULUTĖ;3049808328;Taip;8;0;0;8
17796;Svaja;SAULUTĖ;1045300185;Taip;0;3;1;4
17797;Svaja;SAULUTĖ;4341042027;Taip;4;0;0;4
17798;Svaja;SAULUTĖ;3802996573;Taip;12;0;0;12
17799;Svaja;SAULUTĖ;7936765752;Taip;0;3;3;6
17800;Svaja;SAULUTĖ;4293339784;Taip;4;2;0;6
17801;Svaja;SAULUTĖ;9475971731;Taip;0;3;0;3
17802;Svaja;SAULUTĖ;5479482244;Ne;8;0;0;8
17803;Svaja;SAULUTĖ;7473493846;Taip;11;0;0;11
17804;Svaja;SAULUTĖ;5443682744;Taip;2;1;0;3
17805;Svaja;SAULUTĖ;9112198914;Taip;0;3;0;3
17806;Svaja;SAULUTĖ;2166382346;Ne;0;3;0;3
17807;Svaja;SAULUTĖ;8656417794;Taip;4;3;3;10
17808;Svaja;SAULUTĖ;3630922360;Taip;5;0;3;8
17809;Svaja;SAULUTĖ;1377813636;Taip;0;0;1;1
17810;Svaja;"AUKSINĖ ŽUVELĖ";9091970902;Taip;10;0;0;10
17811;Svaja;"AUKSINĖ ŽUVELĖ";9826552657;Taip;5;3;0;8
17812;Svaja;"AUKSINĖ ŽUVELĖ";6028471687;Taip;11;0;1;12
17813;Svaja;"AUKSINĖ ŽUVELĖ";1877749103;Taip;17;0;0;17
17814;Svaja;"AUKSINĖ ŽUVELĖ";5033214011;Taip;5;3;1;9
17815;Svaja;"AUKSINĖ ŽUVELĖ";5224855138;Taip;0;3;1;4
17816;Svaja;"AUKSINĖ ŽUVELĖ";5013548619;Taip;7;1;0;8
17817;Svaja;"AUKSINĖ ŽUVELĖ";5908440171;Taip;0;0;4;4
17818;Svaja;"AUKSINĖ ŽUVELĖ";5230444195;Taip;11;0;1;12
17819;Svaja;"AUKSINĖ ŽUVELĖ";1914129062;Taip;18;0;0;18
17820;Svaja;"AUKSINĖ ŽUVELĖ";3567924341;Taip;7;1;5;13
17821;Svaja;"AUKSINĖ ŽUVELĖ";2427918378;Taip;5;0;0;5
17822;Svaja;"AUKSINĖ ŽUVELĖ";3377044908;Taip;12;0;0;12
17823;Svaja;"AUKSINĖ ŽUVELĖ";7605002899;Taip;0;3;5;8
17824;Svaja;"AUKSINĖ ŽUVELĖ";5198482539;Taip;0;7;5;12
17825;Svaja;"AUKSINĖ ŽUVELĖ";7562678317;Taip;18;0;0;18
17826;Svaja;"AUKSINĖ ŽUVELĖ";2641473764;Taip;11;0;0;11
17827;Svaja;"AUKSINĖ ŽUVELĖ";7434898745;Taip;0;3;0;3
17828;Svaja;"PRIE ĮLANKOS";5595087767;Taip;5;3;0;8
17829;Svaja;"PRIE ĮLANKOS";8503177793;Taip;3;0;2;5
17830;Svaja;"PRIE ĮLANKOS";1633236289;Taip;8;5;0;13
17831;Svaja;"PRIE ĮLANKOS";9414846817;Taip;6;0;5;11
17832;Svaja;"PRIE ĮLANKOS";9311520300;Taip;0;3;0;3
17833;Svaja;"PRIE ĮLANKOS";9864664937;Taip;0;5;0;5
17834;Svaja;"PRIE ĮLANKOS";4014493868;Taip;0;5;0;5
17835;Svaja;"PRIE ĮLANKOS";6388514464;Taip;9;4;0;13
17836;Svaja;"PRIE ĮLANKOS";5862570666;Taip;4;0;4;8
17837;Svaja;"PRIE ĮLANKOS";2018689468;Taip;3;3;1;7
17838;Svaja;"PRIE ĮLANKOS";3459060550;Taip;12;0;0;12
17839;Svaja;"PRIE ĮLANKOS";1392455608;Taip;0;3;0;3
17840;Svaja;"PRIE ĮLANKOS";1617844709;Taip;13;0;0;13
17841;Svaja;"PRIE ĮLANKOS";3458374439;Taip;0;0;2;2
17842;Svaja;"PRIE ĮLANKOS";3102257512;Taip;0;0;2;2
17843;Svaja;"PRIE ĮLANKOS";4393041946;Taip;5;3;2;10
17844;Svaja;"PRIE ĮLANKOS";1044733634;Taip;0;1;0;1
17845;Svaja;"PRIE ĮLANKOS";6676145522;Taip;0;3;1;4
17846;Svaja;"PRIE ĮLANKOS";1671495181;Taip;1;3;0;4
17847;Svaja;"PRIE ĮLANKOS";9950569499;Taip;9;0;0;9
17848;Svaja;"PRIE ĮLANKOS";4284157599;Taip;9;0;0;9
17849;Svaja;"PRIE ĮLANKOS";3868254757;Taip;0;3;0;3
17850;Svaja;"PRIE ĮLANKOS";6361228838;Taip;0;0;7;7
17851;Svaja;"PRIE ĮLANKOS";7514587933;Ne;0;10;0;10
17852;Svaja;"1 B klasė";24863928147;Taip;0;6;0;6
17853;Svaja;"1 B klasė";1865658456;Taip;0;6;0;6
17854;Svaja;"1 B klasė";8279605005;Taip;0;18;0;18
17855;Svaja;"1 B klasė";55925058866;Taip;0;18;0;18
17856;Svaja;"1 B klasė";1437557657;Taip;0;17;0;17
17857;Svaja;"1 B klasė";25194696146;Taip;0;5;0;5
17858;Svaja;"1 B klasė";1704075006;Taip;6;3;0;9
17859;Svaja;"1 B klasė";8875237023;Taip;0;4;0;4
17860;Svaja;"1 B klasė";64196174690;Taip;7;18;0;25
17861;Svaja;"1 B klasė";8491275729;Taip;0;3;0;3
17862;Svaja;"1 B klasė";21871530266;Taip;0;5;0;5
17863;Svaja;"1 B klasė";7753488216;Taip;0;4;0;4
17864;Svaja;"1 B klasė";36505115395;Taip;0;18;0;18
17865;Svaja;"1 B klasė";7911488445;Taip;0;4;0;4
17866;Svaja;"1 B klasė";6593047776;Taip;0;3;0;3
17867;Svaja;"1 B klasė";15159708127;Taip;0;4;0;4
17868;Svaja;"1 B klasė";2985196852;Taip;0;5;0;5
17869;Svaja;"1 B klasė";9110985103;Taip;0;3;0;3
17870;Svaja;"1 B klasė";3562817807;Taip;0;5;0;5
17871;Svaja;"1 B klasė";2069150261;Taip;0;4;0;4
17872;Svaja;"1 B klasė";1191494598;Taip;0;3;0;3
17873;Svaja;"1 B klasė";11671380984;Taip;0;11;0;11
17874;Svaja;"1 B klasė";99183628764;Taip;0;4;0;4
17875;Svaja;"1 B klasė";1369637618;Taip;0;3;0;3
17876;Svaja;"1 B klasė";3660152224;Taip;0;4;0;4
17877;Svaja;"1 A klasė";5337604370;Taip;0;3;0;3
17878;Svaja;"1 A klasė";1046879533;Taip;0;3;0;3
17879;Svaja;"1 A klasė";2147266053;Taip;0;9;0;9
17880;Svaja;"1 A klasė";4846025153;Taip;0;3;0;3
17881;Svaja;"1 A klasė";1714711904;Taip;0;3;0;3
17882;Svaja;"1 A klasė";47457128214;Taip;0;7;0;7
17883;Svaja;"1 A klasė";65917456866;Taip;0;3;0;3
17884;Svaja;"1 A klasė";1197826066;Taip;0;3;0;3
17885;Svaja;"1 A klasė";73679997517;Taip;0;18;0;18
17886;Svaja;"1 A klasė";7669562010;Ne;0;10;0;10
17887;Svaja;"1 A klasė";5335776957;Taip;0;18;0;18
17888;Svaja;"1 A klasė";56117509354;Taip;0;3;0;3
17889;Svaja;"1 A klasė";27445299450;Taip;0;3;0;3
17890;Svaja;"1 A klasė";1576498450;Taip;0;3;0;3
17891;Svaja;"1 A klasė";43307670660;Taip;0;18;0;18
17892;Svaja;"1 A klasė";22702341083;Taip;0;8;0;8
17893;Svaja;"1 A klasė";70641067006;Taip;0;18;0;18
17894;Svaja;"1 A klasė";58102699652;Taip;0;4;0;4
17895;Svaja;"1 A klasė";2076060840;Taip;0;5;0;5
17896;Svaja;"1 A klasė";4900757614;Taip;0;3;0;3
17897;Svaja;"1 A klasė";1061894314;Taip;0;3;0;3
17898;Svaja;"1 A klasė";8697355813;Taip;0;3;0;3
17899;Svaja;"1 A klasė";193181908;Ne;0;3;0;3
17900;Svaja;"1 A klasė";193181908;Ne;0;3;0;3
17901;Svaja;"2 A klasė";9628146488;Ne;0;3;0;3
17902;Svaja;"2 A klasė";1562041360;Taip;0;5;0;5
17903;Svaja;"2 A klasė";43223177664;Taip;0;3;0;3
17904;Svaja;"2 A klasė";1017471747;Taip;0;3;0;3
17905;Svaja;"2 A klasė";26500981786;Taip;0;4;0;4
17906;Svaja;"2 A klasė";5522433229;Taip;0;3;0;3
17907;Svaja;"2 A klasė";1400892707;Taip;0;3;0;3
17908;Svaja;"2 A klasė";30027404222;Taip;0;3;0;3
17909;Svaja;"2 A klasė";23112873505;Taip;0;3;0;3
17910;Svaja;"2 A klasė";15246943974;Taip;0;3;0;3
17911;Svaja;"2 A klasė";1297727288;Taip;0;3;0;3
17912;Svaja;"2 A klasė";1304775332;Taip;0;3;0;3
17913;Svaja;"2 A klasė";8198614500;Taip;0;3;0;3
17914;Svaja;"2 A klasė";67462299886;Taip;0;3;0;3
17915;Svaja;"2 A klasė";40856210635;Taip;0;3;0;3
17916;Svaja;"2 A klasė";18733824395;Taip;0;3;0;3
17917;Svaja;"2 A klasė";84508228457;Taip;0;3;0;3
17918;Svaja;"2 A klasė";2058827699;Taip;0;3;0;3
17919;Svaja;"2 A klasė";1352488176;Taip;0;3;0;3
17920;Svaja;"2 A klasė";1660742385;Taip;0;3;0;3
17921;Svaja;"2 A klasė";89042677798;Taip;0;3;0;3
17922;Svaja;"2 A klasė";26902749194;Taip;0;3;0;3
17923;Svaja;"2 A klasė";3022690832;Taip;0;3;0;3
17924;Svaja;"2 A klasė";1943166503;Taip;0;8;0;8
17925;Svaja;"2 A klasė";1048576329;Taip;0;3;0;3
17926;Svaja;"2 B klasė";4804779327;Taip;3;18;0;21
17927;Svaja;"2 B klasė";7719185632;Taip;0;3;0;3
17928;Svaja;"2 B klasė";69028070656;Taip;0;7;0;7
17929;Svaja;"2 B klasė";54745410330;Taip;0;3;0;3
17930;Svaja;"2 B klasė";30036722764;Taip;0;7;0;7
17931;Svaja;"2 B klasė";1509272327;Taip;0;3;0;3
17932;Svaja;"2 B klasė";1601648171;Taip;0;7;0;7
17933;Svaja;"2 B klasė";89316574266;Taip;0;4;0;4
17934;Svaja;"2 B klasė";78293798850;Taip;0;4;0;4
17935;Svaja;"2 B klasė";40814723278;Taip;0;3;0;3
17936;Svaja;"2 B klasė";1967394949;Taip;0;3;0;3
17937;Svaja;"2 B klasė";4881476441;Taip;0;3;0;3
17938;Svaja;"2 B klasė";87432529423;Taip;0;3;0;3
17939;Svaja;"2 B klasė";19887874988;Ne;0;3;0;3
17940;Svaja;"2 B klasė";69413101571;Taip;0;3;0;3
17941;Svaja;"2 B klasė";57216954289;Taip;0;3;0;3
17942;Svaja;"2 B klasė";1655551042;Taip;0;3;0;3
17943;Svaja;"2 B klasė";76618850202;Taip;0;3;0;3
17944;Svaja;"2 B klasė";21608020858;Taip;0;3;0;3
17945;Svaja;"2 B klasė";3077814152;Taip;0;3;0;3
17946;Svaja;"2 B klasė";809734624;Taip;0;3;0;3
17947;Svaja;"2 B klasė";44989143252;Taip;0;3;0;3
17948;Svaja;"2 B klasė";6056157113;Taip;0;3;0;3
17949;Svaja;"2 B klasė";30360097999;Taip;0;3;0;3
17950;Svaja;"2 B klasė";1378219785;Taip;0;3;0;3
17951;Svaja;"3 A klasė";72752022712;Taip;0;3;0;3
17952;Svaja;"3 A klasė";8828911320;Taip;0;3;0;3
17953;Svaja;"3 A klasė";60448774566;Taip;0;6;0;6
17954;Svaja;"3 A klasė";75104768118;Taip;0;3;0;3
17955;Svaja;"3 A klasė";1649920341;Taip;0;3;0;3
17956;Svaja;"3 A klasė";30754812113;Taip;0;3;0;3
17957;Svaja;"3 A klasė";64487515384;Taip;0;18;0;18
17958;Svaja;"3 A klasė";34216516886;Taip;0;4;0;4
17959;Svaja;"3 A klasė";3474439050;Taip;0;9;0;9
17960;Svaja;"3 A klasė";63346231562;Taip;0;18;0;18
17961;Svaja;"3 A klasė";75296600945;Ne;0;6;0;6
17962;Svaja;"3 A klasė";6057524892;Taip;0;18;0;18
17963;Svaja;"3 A klasė";2321739150;Ne;0;4;0;4
17964;Svaja;"3 A klasė";4617061890;Taip;0;9;0;9
17965;Svaja;"3 A klasė";89695643588;Taip;0;6;0;6
17966;Svaja;"3 A klasė";3604946305;Taip;0;18;0;18
17967;Svaja;"3 A klasė";25578518444;Taip;0;3;0;3
17968;Svaja;"3 A klasė";1168637823;Taip;0;4;0;4
17969;Svaja;"3 A klasė";4906784415;Taip;0;6;0;6
17970;Svaja;"3 A klasė";15252353189;Taip;0;3;0;3
17971;Svaja;"3 B klasė";6905550313;Ne;0;18;0;18
17972;Svaja;"3 B klasė";62971657427;Taip;0;4;0;4
17973;Svaja;"3 B klasė";1367687415;Taip;0;4;0;4
17974;Svaja;"3 B klasė";4416877973;Taip;0;4;0;4
17975;Svaja;"3 B klasė";1847775266;Taip;0;18;0;18
17976;Svaja;"3 B klasė";17947580061;Taip;3;9;0;12
17977;Svaja;"3 B klasė";6969692916;Taip;0;4;0;4
17978;Svaja;"3 B klasė";44418402260;Taip;0;4;0;4
17979;Svaja;"3 B klasė";50649509868;Taip;0;4;0;4
17980;Svaja;"3 B klasė";73391331150;Taip;0;5;0;5
17981;Svaja;"3 B klasė";70507326327;Taip;0;18;0;18
17982;Svaja;"3 B klasė";80772711351;Taip;0;4;0;4
17983;Svaja;"3 B klasė";54328462992;Taip;0;18;0;18
17984;Svaja;"3 B klasė";1470843400;Taip;0;4;0;4
17985;Svaja;"3 B klasė";92044111261;Taip;0;4;0;4
17986;Svaja;"3 B klasė";11937575740;Taip;0;5;0;5
17987;Svaja;"3 B klasė";8011137572;Taip;0;4;0;4
17988;Svaja;"3 B klasė";71708072632;Taip;0;6;0;6
17989;Svaja;"3 B klasė";56506642672;Taip;0;5;0;5
17990;Svaja;"3 B klasė";3526873547;Taip;0;18;0;18
17991;Svaja;"3 B klasė";70506691027;Taip;0;18;0;18
17992;Svaja;"3 B klasė";4282243865;Taip;0;18;0;18
17993;Svaja;"4 A klasė";96680395594;Taip;0;3;0;3
17994;Svaja;"4 A klasė";31604152893;Taip;0;3;0;3
17995;Svaja;"4 A klasė";70513111186;Ne;0;4;0;4
17996;Svaja;"4 A klasė";72655912805;Taip;0;18;0;18
17997;Svaja;"4 A klasė";20363553383;Taip;0;8;0;8
17998;Svaja;"4 A klasė";8876971658;Taip;0;4;0;4
17999;Svaja;"4 A klasė";69928474471;Taip;0;18;0;18
18000;Svaja;"4 A klasė";49184638535;Taip;0;18;0;18
18001;Svaja;"4 A klasė";3775578708;Taip;0;5;0;5
18002;Svaja;"4 A klasė";58497063533;Taip;0;10;0;10
18003;Svaja;"4 A klasė";89075087937;Taip;0;18;0;18
18004;Svaja;"4 A klasė";99157757025;Ne;0;4;0;4
18005;Svaja;"4 A klasė";16955510836;Taip;0;7;0;7
18006;Svaja;"4 A klasė";24812635291;Taip;0;5;0;5
18007;Svaja;"4 A klasė";21534170175;Taip;0;4;0;4
18008;Svaja;"4 A klasė";28311552445;Taip;0;4;0;4
18009;Svaja;"4 A klasė";38781141060;Taip;0;4;0;4
18010;Svaja;"4 A klasė";88447528808;Taip;0;4;0;4
18011;Svaja;"4 A klasė";66507774550;Taip;0;4;0;4
18012;Svaja;"4 A klasė";76101749947;Taip;0;18;0;18
18013;Svaja;"4 A klasė";18432518932;Taip;0;6;0;6
18014;Svaja;"4 B klasė";61996055386;Taip;0;18;0;18
18015;Svaja;"4 B klasė";57983452414;Taip;0;18;0;18
18016;Svaja;"4 B klasė";30200636424;Ne;0;18;0;18
18017;Svaja;"4 B klasė";8802243719;Taip;0;18;0;18
18018;Svaja;"4 B klasė";7747921362;Taip;0;18;0;18
18019;Svaja;"4 B klasė";38464012322;Taip;0;4;0;4
18020;Svaja;"4 B klasė";5712106350;Taip;0;4;0;4
18021;Svaja;"4 B klasė";9401605132;Taip;0;6;0;6
18022;Svaja;"4 B klasė";27313057222;Ne;0;18;0;18
18023;Svaja;"4 B klasė";68894832324;Taip;0;18;0;18
18024;Svaja;"4 B klasė";29972474690;Taip;0;18;0;18
18025;Svaja;"4 B klasė";47441661801;Ne;0;4;0;4
18026;Svaja;"4 B klasė";62579722313;Taip;0;4;0;4
18027;Svaja;"4 B klasė";21035820496;Taip;0;18;0;18
18028;Svaja;"4 B klasė";71840791098;Taip;0;4;0;4
18029;Svaja;"4 B klasė";59707838958;Taip;0;18;0;18
18030;Svaja;"4 B klasė";71086654007;Taip;0;18;0;18
18031;Svaja;"4 B klasė";15871540340;Taip;0;18;0;18
18032;Svaja;"4 B klasė";97651620085;Taip;0;4;0;4
18033;Svaja;"4 B klasė";77796846388;Taip;0;18;0;18
18034;Svaja;"4 C klasė";79260508923;Taip;0;3;0;3
18035;Svaja;"4 C klasė";94437606762;Taip;0;18;0;18
18036;Svaja;"4 C klasė";73440582394;Taip;0;18;0;18
18037;Svaja;"4 C klasė";60982723867;Taip;0;18;0;18
18038;Svaja;"4 C klasė";70157518595;Taip;0;18;0;18
18039;Svaja;"4 C klasė";5975083034;Taip;3;18;0;21
18040;Svaja;"4 C klasė";76871144487;Taip;0;18;0;18
18041;Svaja;"4 C klasė";6613028133;Taip;0;4;0;4
18042;Svaja;"4 C klasė";48888360976;Taip;0;4;0;4
18043;Svaja;"4 C klasė";12226488343;Taip;0;18;0;18
18044;Svaja;"4 C klasė";3909240894;Taip;0;4;0;4
18045;Svaja;"4 C klasė";53352329988;Taip;0;4;0;4
18046;Svaja;"4 C klasė";59917024948;Taip;0;4;0;4
18047;Svaja;"4 C klasė";73691352138;Ne;0;4;0;4
18048;Svaja;"4 C klasė";66967032561;Taip;2;4;0;6
18049;Svaja;"4 C klasė";77712240909;Taip;0;3;0;3
18050;Svaja;"4 C klasė";82358174131;Taip;0;3;0;3
18051;Svaja;"4 C klasė";25585032766;Taip;0;18;0;18
18052;Svaja;"4 C klasė";79572045341;Taip;0;18;0;18
18053;Svaja;"3 C klasė";1848422504;Taip;0;9;0;9
18054;Svaja;"3 C klasė";3743948734;Taip;0;11;0;11
18055;Svaja;"3 C klasė";25934507261;Taip;0;4;0;4
18056;Svaja;"3 C klasė";89047123808;Taip;0;12;0;12
18057;Svaja;"3 C klasė";74904581010;Taip;0;18;0;18
18058;Svaja;"3 C klasė";50510924690;Taip;0;4;0;4
18059;Svaja;"3 C klasė";41183537732;Taip;5;10;0;15
18060;Svaja;"3 C klasė";70714898590;Taip;0;4;0;4
18061;Svaja;"3 C klasė";54852358913;Taip;0;18;0;18
18062;Svaja;"3 C klasė";57253216255;Taip;0;4;0;4
18063;Svaja;"3 C klasė";34995551069;Taip;0;18;0;18
18064;Svaja;"3 C klasė";1795682827;Taip;0;4;0;4
18065;Svaja;"3 C klasė";93651139102;Taip;0;4;0;4
18066;Svaja;"3 C klasė";1742951527;Taip;0;6;0;6
18067;Svaja;"3 C klasė";91855230473;Taip;0;15;0;15
18068;Svaja;"3 C klasė";1855559693;Taip;0;18;0;18
18069;Svaja;"3 C klasė";2165716699;Taip;0;4;0;4
18070;Svaja;"3 C klasė";31216445971;Ne;0;18;0;18
18071;Svaja;"3 C klasė";20342193231;Taip;0;3;0;3
18072;Svaja;"3 C klasė";54462393937;Taip;0;3;0;3
18073;Svaja;"3 C klasė";36001411632;Taip;0;6;0;6
18074;Svaja;"3 C klasė";94449039022;Taip;0;18;0;18
18075;Svaja;"3 C klasė";85150525696;Taip;0;4;0;4
18076;Svaja;"3 C klasė";91088224294;Taip;0;5;0;5
18077;Šilelis;PAUKŠTELIAI;6128379060;Taip;6;8;0;14
18078;Šilelis;PAUKŠTELIAI;9653439873;Taip;4;3;0;7
18079;Šilelis;PAUKŠTELIAI;2823486581;Taip;0;7;0;7
18080;Šilelis;PAUKŠTELIAI;6369443270;Taip;0;4;0;4
18081;Šilelis;PAUKŠTELIAI;7595774842;Taip;5;3;0;8
18082;Šilelis;PAUKŠTELIAI;6614686867;Taip;14;0;0;14
18083;Šilelis;PAUKŠTELIAI;3053443777;Taip;0;3;2;5
18084;Šilelis;PAUKŠTELIAI;4960501068;Taip;2;8;0;10
18085;Šilelis;PAUKŠTELIAI;7072057348;Taip;10;3;0;13
18086;Šilelis;PAUKŠTELIAI;5974537364;Taip;0;11;6;17
18087;Šilelis;PAUKŠTELIAI;8166061969;Taip;0;3;0;3
18088;Šilelis;PAUKŠTELIAI;2051644210;Taip;2;1;2;5
18089;Šilelis;PAUKŠTELIAI;1124854378;Taip;5;2;0;7
18090;Šilelis;PAUKŠTELIAI;8184170908;Taip;13;0;0;13
18091;Šilelis;PAUKŠTELIAI;7197420388;Ne;10;5;0;15
18092;Šilelis;PAUKŠTELIAI;9107920165;Ne;10;5;0;15
18093;Šilelis;PAUKŠTELIAI;4432542988;Taip;18;0;0;18
18094;Šilelis;PAUKŠTELIAI;6852463814;Ne;6;7;0;13
18095;Šilelis;PAUKŠTELIAI;9799198904;Taip;0;3;3;6
18096;Šilelis;PAUKŠTELIAI;5493811298;Taip;0;3;3;6
18097;Šilelis;SKRUZDELIUKAI;7502057552;Taip;0;3;0;3
18098;Šilelis;SKRUZDELIUKAI;6099940488;Taip;10;3;1;14
18099;Šilelis;SKRUZDELIUKAI;6139976105;Taip;0;6;0;6
18100;Šilelis;SKRUZDELIUKAI;3823958567;Taip;0;10;0;10
18101;Šilelis;SKRUZDELIUKAI;1887013803;Taip;0;3;1;4
18102;Šilelis;SKRUZDELIUKAI;6359318134;Taip;0;4;1;5
18103;Šilelis;SKRUZDELIUKAI;5598152793;Taip;14;0;0;14
18104;Šilelis;SKRUZDELIUKAI;8090773379;Taip;7;4;0;11
18105;Šilelis;SKRUZDELIUKAI;1200024379;Ne;0;0;2;2
18106;Šilelis;SKRUZDELIUKAI;7299084520;Taip;0;6;0;6
18107;Šilelis;SKRUZDELIUKAI;8578620603;Taip;0;3;0;3
18108;Šilelis;SKRUZDELIUKAI;9589138527;Taip;9;3;0;12
18109;Šilelis;SKRUZDELIUKAI;3967932407;Taip;0;4;0;4
18110;Šilelis;SKRUZDELIUKAI;4629917226;Taip;0;3;0;3
18111;Šilelis;SKRUZDELIUKAI;2972202874;Taip;13;2;0;15
18112;Šilelis;SKRUZDELIUKAI;9461117894;Taip;13;2;0;15
18113;Šilelis;SKRUZDELIUKAI;5817818596;Taip;3;13;1;17
18114;Šilelis;SKRUZDELIUKAI;6827855685;Taip;0;1;0;1
18115;Šilelis;SKRUZDELIUKAI;5091571136;Ne;0;8;0;8
18116;Šilelis;SKRUZDELIUKAI;8297975308;Taip;0;9;0;9
18117;Šilelis;SKRUZDELIUKAI;3381053227;Taip;0;6;0;6
18118;Šilelis;SKRUZDELIUKAI;9276607554;Taip;0;9;0;9
18119;Šilelis;SMERFY;3247333567;Taip;0;6;0;6
18120;Šilelis;SMERFY;6999088222;Taip;0;1;0;1
18121;Šilelis;SMERFY;9886134621;Ne;4;1;0;5
18122;Šilelis;SMERFY;3089270468;Taip;0;8;0;8
18123;Šilelis;SMERFY;7824279279;Ne;5;6;0;11
18124;Šilelis;SMERFY;4504627601;Taip;8;3;0;11
18125;Šilelis;SMERFY;7534468539;Taip;0;3;9;12
18126;Šilelis;SMERFY;6390855924;Taip;0;4;0;4
18127;Šilelis;SMERFY;1821827154;Taip;2;3;0;5
18128;Šilelis;SMERFY;1890114622;Taip;11;3;1;15
18129;Šilelis;SMERFY;5025956218;Taip;0;1;3;4
18130;Šilelis;EŽIUKAI;9266061396;Taip;2;1;0;3
18131;Šilelis;EŽIUKAI;4494932923;Taip;0;3;2;5
18132;Šilelis;EŽIUKAI;7074963804;Taip;0;7;0;7
18133;Šilelis;EŽIUKAI;1165219272;Taip;0;4;0;4
18134;Šilelis;EŽIUKAI;4702068672;Taip;0;4;0;4
18135;Šilelis;EŽIUKAI;5020209473;Taip;0;2;0;2
18136;Šilelis;EŽIUKAI;2295849333;Taip;0;5;0;5
18137;Šilelis;EŽIUKAI;5131051261;Taip;4;3;0;7
18138;Šilelis;EŽIUKAI;1883483049;Taip;0;3;0;3
18139;Šilelis;EŽIUKAI;6854997486;Taip;0;3;0;3
18140;Šilelis;EŽIUKAI;6386996498;Taip;0;3;2;5
18141;Šilelis;EŽIUKAI;4822495270;Taip;0;3;0;3
18142;Šilelis;EŽIUKAI;3211649292;Taip;0;3;0;3
18143;Šilelis;EŽIUKAI;2681063256;Taip;0;1;3;4
18144;Šilelis;EŽIUKAI;7208757038;Taip;0;3;4;7
18145;Šilelis;NYKŠTUKAI;3046954717;Taip;0;4;0;4
18146;Šilelis;NYKŠTUKAI;2862894359;Taip;0;1;0;1
18147;Šilelis;NYKŠTUKAI;3158708835;Taip;0;3;0;3
18148;Šilelis;NYKŠTUKAI;6195580698;Taip;0;1;0;1
18149;Šilelis;NYKŠTUKAI;6107771932;Taip;0;3;1;4
18150;Šilelis;NYKŠTUKAI;4323998445;Taip;0;3;2;5
18151;Šilelis;NYKŠTUKAI;2095572561;Taip;7;3;2;12
18152;Šilelis;NYKŠTUKAI;2161973782;Taip;6;3;0;9
18153;Šilelis;NYKŠTUKAI;4459114205;Taip;0;3;0;3
18154;Šilelis;NYKŠTUKAI;3728633100;Taip;0;3;0;3
18155;Šilelis;NYKŠTUKAI;3999426414;Taip;0;4;0;4
18156;Šilelis;NYKŠTUKAI;5745874033;Taip;0;3;0;3
18157;Šilelis;NYKŠTUKAI;9769483899;Taip;2;3;0;5
18158;Šilelis;NYKŠTUKAI;8944490184;Taip;0;1;0;1
18159;Šilelis;NYKŠTUKAI;3120671593;Taip;0;1;0;1
18160;Šilelis;NYKŠTUKAI;2908840424;Taip;0;9;2;11
18161;Šilelis;NYKŠTUKAI;6980045156;Taip;0;10;0;10
18162;Šilelis;NYKŠTUKAI;9685227636;Taip;0;8;0;8
18163;Šilelis;NYKŠTUKAI;4868465692;Taip;0;8;0;8
18164;Šilelis;NYKŠTUKAI;4754544277;Taip;1;6;0;7
18165;Šilelis;NYKŠTUKAI;7480611069;Ne;0;1;0;1
18166;Šilelis;ANČIUKAI;1726944289;Taip;15;0;3;18
18167;Šilelis;ANČIUKAI;4336942500;Taip;0;1;0;1
18168;Šilelis;ANČIUKAI;9661578871;Taip;9;1;3;13
18169;Šilelis;ANČIUKAI;6616262730;Taip;0;3;0;3
18170;Šilelis;ANČIUKAI;4323750313;Taip;10;3;4;17
18171;Šilelis;ANČIUKAI;3221398692;Taip;0;3;0;3
18172;Šilelis;ANČIUKAI;6364741317;Taip;10;3;0;13
18173;Šilelis;ANČIUKAI;1325857464;Taip;8;0;0;8
18174;Šilelis;ANČIUKAI;9407916190;Taip;0;8;0;8
18175;Šilelis;ANČIUKAI;8188160849;Taip;2;3;0;5
18176;Šilelis;ANČIUKAI;7128670936;Taip;12;0;0;12
18177;Šilelis;ANČIUKAI;8613748314;Taip;5;4;0;9
18178;Šilelis;ANČIUKAI;5381213051;Taip;10;3;0;13
18179;Šilelis;ANČIUKAI;8807755852;Taip;0;1;0;1
18180;Šilelis;ANČIUKAI;4135383684;Taip;0;3;0;3
18181;Šilelis;ANČIUKAI;8603589758;Taip;5;5;0;10
18182;Šilelis;KAČIUKAI;3216168797;Taip;0;0;5;5
18183;Šilelis;KAČIUKAI;9848760151;Taip;0;5;0;5
18184;Šilelis;KAČIUKAI;4743459915;Taip;0;3;0;3
18185;Šilelis;KAČIUKAI;8387022157;Taip;0;4;0;4
18186;Šilelis;KAČIUKAI;3393466953;Taip;0;4;0;4
18187;Šilelis;KAČIUKAI;2111979474;Taip;0;1;2;3
18188;Šilelis;KAČIUKAI;8064905796;Taip;0;7;0;7
18189;Šilelis;KAČIUKAI;5176259940;Ne;0;0;6;6
18190;Šilelis;KAČIUKAI;5589764935;Taip;14;0;0;14
18191;Šilelis;KAČIUKAI;7123048946;Taip;8;0;0;8
18192;Šilelis;KAČIUKAI;6479728064;Taip;0;10;0;10
18193;Šilelis;KAČIUKAI;3686287802;Ne;0;2;1;3
18194;Šilelis;KAČIUKAI;2906501601;Taip;0;5;0;5
18195;Šilelis;KAČIUKAI;6510813364;Taip;0;3;0;3
18196;Šilelis;KAČIUKAI;8319185507;Taip;0;2;0;2
18197;Šilelis;KAČIUKAI;8504187981;Taip;0;4;4;8
18198;Šilelis;KAČIUKAI;6470073008;Taip;0;4;0;4
18199;Šilelis;KAČIUKAI;3419284228;Taip;8;0;0;8
18200;Šilelis;KAČIUKAI;3712001932;Taip;0;4;0;4
18201;Šilelis;KAČIUKAI;9106999969;Taip;0;3;0;3
18202;Šilelis;KAČIUKAI;5030871828;Taip;0;1;8;9
18203;Šilelis;KAČIUKAI;6894466509;Taip;0;0;10;10
18204;Šilelis;KAČIUKAI;5026203678;Taip;0;8;0;8
18205;Šilelis;KIŠKUČIAI;8759694551;Taip;0;1;0;1
18206;Šilelis;KIŠKUČIAI;2209552706;Taip;0;3;3;6
18207;Šilelis;KIŠKUČIAI;4386065478;Taip;0;1;0;1
18208;Šilelis;KIŠKUČIAI;7043644521;Taip;13;0;5;18
18209;Šilelis;KIŠKUČIAI;8096868221;Taip;0;1;0;1
18210;Šilelis;KIŠKUČIAI;3395084186;Taip;0;0;1;1
18211;Šilelis;KIŠKUČIAI;3382252131;Taip;0;3;0;3
18212;Šilelis;KIŠKUČIAI;9746722034;Taip;0;0;1;1
18213;Šilelis;KIŠKUČIAI;5815768693;Taip;0;2;0;2
18214;Šilelis;KIŠKUČIAI;8598321310;Taip;0;3;6;9
18215;Šilelis;KREGŽDUTĖS;9715544798;Taip;6;6;0;12
18216;Šilelis;KREGŽDUTĖS;1025643459;Taip;5;0;0;5
18217;Šilelis;KREGŽDUTĖS;8453070684;Taip;8;0;0;8
18218;Šilelis;KREGŽDUTĖS;1286082219;Taip;3;3;1;7
18219;Šilelis;KREGŽDUTĖS;3068950702;Taip;16;0;0;16
18220;Šilelis;KREGŽDUTĖS;8665357907;Taip;5;5;0;10
18221;Šilelis;KREGŽDUTĖS;1152159735;Taip;12;0;0;12
18222;Šilelis;KREGŽDUTĖS;6630114847;Taip;3;0;5;8
18223;Šilelis;KREGŽDUTĖS;3953114161;Taip;0;3;2;5
18224;Šilelis;KREGŽDUTĖS;2499322761;Taip;17;0;0;17
18225;Šilelis;KREGŽDUTĖS;8659845107;Taip;0;3;4;7
18226;Šilelis;KREGŽDUTĖS;5868594049;Taip;5;3;2;10
18227;Šilelis;KREGŽDUTĖS;3235890717;Taip;16;0;0;16
18228;Šilelis;KREGŽDUTĖS;5223262925;Taip;5;3;0;8
18229;Šilelis;KREGŽDUTĖS;1279361795;Taip;4;0;0;4
18230;Šilelis;KREGŽDUTĖS;9292761872;Taip;16;0;0;16
18231;Šilelis;PAGRANDUKAI;9922962130;Taip;0;3;0;3
18232;Šilelis;PAGRANDUKAI;4814863979;Taip;6;3;0;9
18233;Šilelis;PAGRANDUKAI;9670243727;Taip;0;1;0;1
18234;Šilelis;PAGRANDUKAI;8357287467;Taip;0;6;0;6
18235;Šilelis;PAGRANDUKAI;20525573092;Taip;0;3;0;3
18236;Šilelis;PAGRANDUKAI;2897196188;Taip;5;0;0;5
18237;Šilelis;PAGRANDUKAI;3583955729;Taip;0;6;0;6
18238;Šilelis;PAGRANDUKAI;9113098594;Taip;0;0;2;2
18239;Šilelis;PAGRANDUKAI;7623203279;Taip;0;3;1;4
18240;Šilelis;PAGRANDUKAI;4340856490;Taip;0;1;0;1
18241;Šilelis;PAGRANDUKAI;3807787648;Taip;0;3;1;4
18242;Šilelis;PAGRANDUKAI;6276408187;Taip;0;3;1;4
18243;Šilelis;PAGRANDUKAI;8416126751;Taip;0;3;1;4
18244;Šilelis;PAGRANDUKAI;2397366916;Taip;0;5;0;5
18245;Šilelis;PAGRANDUKAI;7936978436;Taip;0;7;0;7
18246;Šilelis;PAGRANDUKAI;1747920772;Taip;0;6;0;6
18247;Šilelis;PAGRANDUKAI;3843999609;Taip;0;7;0;7
18248;Šilelis;PAGRANDUKAI;1898004894;Taip;2;3;0;5
18249;Šilelis;BITUTĖS;2948291866;Taip;0;4;0;4
18250;Šilelis;BITUTĖS;5835209357;Taip;0;3;0;3
18251;Šilelis;BITUTĖS;7512731255;Taip;0;3;1;4
18252;Šilelis;BITUTĖS;1268335563;Taip;0;1;0;1
18253;Šilelis;BITUTĖS;9035595952;Taip;0;0;3;3
18254;Šilelis;BITUTĖS;7814807923;Taip;10;4;0;14
18255;Šilelis;BITUTĖS;5305660046;Taip;0;3;0;3
18256;Šilelis;BITUTĖS;9071963194;Taip;0;4;1;5
18257;Šilelis;BITUTĖS;5843337891;Taip;0;2;0;2
18258;Šilelis;BITUTĖS;1960952604;Taip;4;4;2;10
18259;Šilelis;BITUTĖS;3954379433;Taip;10;6;0;16
18260;Šilelis;BITUTĖS;7350013139;Taip;0;4;0;4
18261;Šilelis;BITUTĖS;3879234745;Taip;0;0;2;2
18262;Šilelis;BITUTĖS;1390916076;Taip;8;0;0;8
18263;Šilelis;BITUTĖS;6143099736;Taip;0;3;0;3
18264;Šilelis;BITUTĖS;2667785768;Taip;15;3;0;18
18265;Šilelis;BITUTĖS;2023309512;Ne;0;0;2;2
18266;Šilelis;BITUTĖS;5210301367;Taip;4;0;2;6
18267;Šilelis;BITUTĖS;5375413045;Taip;0;6;0;6
18268;Šilelis;BITUTĖS;6297546907;Taip;9;3;3;15
18269;Šilelis;BITUTĖS;4682742121;Taip;0;3;0;3
18270;Šilelis;BITUTĖS;9234766553;Taip;0;0;2;2
18271;Šilelis;DRUGELIAI;2079073174;Taip;0;2;0;2
18272;Šilelis;DRUGELIAI;3598370884;Taip;8;3;0;11
18273;Šilelis;DRUGELIAI;1347150938;Taip;0;3;0;3
18274;Šilelis;DRUGELIAI;7636725161;Taip;5;3;0;8
18275;Šilelis;DRUGELIAI;9256656029;Taip;0;3;0;3
18276;Šilelis;DRUGELIAI;1891388542;Taip;0;3;0;3
18277;Šilelis;DRUGELIAI;5759824196;Taip;0;3;0;3
18278;Šilelis;DRUGELIAI;31906089315;Taip;0;2;0;2
18279;Šilelis;DRUGELIAI;4115738520;Taip;0;4;0;4
18280;Šilelis;DRUGELIAI;3824174896;Taip;0;4;0;4
18281;Šilelis;DRUGELIAI;8090765017;Taip;0;4;0;4
18282;Šilelis;DRUGELIAI;54633547799;Taip;0;5;1;6
18283;Šilelis;DRUGELIAI;9100047520;Taip;0;3;0;3
18284;Šilelis;DRUGELIAI;1019874215;Ne;0;1;0;1
18285;Šilelis;DRUGELIAI;1638362625;Taip;0;3;0;3
18286;Šilelis;DRUGELIAI;9482667810;Taip;0;8;3;11
18287;Šilelis;DRUGELIAI;5379171382;Taip;5;0;0;5
18288;Šilelis;DRUGELIAI;6230566495;Taip;8;3;0;11
18289;Šilelis;DRUGELIAI;6523676718;Taip;0;1;0;1
18290;Šilelis;DRUGELIAI;5766702969;Taip;0;3;0;3
18291;Šilelis;DRUGELIAI;8915228012;Taip;0;2;1;3
18292;Šilelis;DRUGELIAI;1984731000;Taip;0;3;0;3
18293;Šilelis;DRUGELIAI;6104538160;Taip;0;4;0;4
18294;Šilelis;DRUGELIAI;7542121945;Taip;0;3;1;4
18295;Vaivorykštė;Vasilki;3636826798;Taip;5;0;0;5
18296;Vaivorykštė;Smorodinki;6660558274;Taip;3;0;0;3
18297;Vaivorykštė;1C;6291387032;Taip;6;0;0;6
18298;Vaduvos;PAGRANDUKAI;1431863758;Taip;0;3;0;3
18299;Vaduvos;PAGRANDUKAI;8408017356;Taip;0;12;0;12
18300;Vaduvos;PAGRANDUKAI;72724196791;Taip;4;13;0;17
18301;Vaduvos;PAGRANDUKAI;9371067563;Taip;0;3;0;3
18302;Vaduvos;PAGRANDUKAI;6425640531;Taip;0;2;0;2
18303;Vaduvos;PAGRANDUKAI;4029586203;Taip;0;3;0;3
18304;Vaduvos;PAGRANDUKAI;73800920781;Taip;0;3;1;4
18305;Vaduvos;PAGRANDUKAI;18035723255;Taip;7;1;0;8
18306;Vaduvos;PAGRANDUKAI;5954492368;Taip;0;6;0;6
18307;Vaduvos;PAGRANDUKAI;7397068779;Ne;0;5;0;5
18308;Vaduvos;PAGRANDUKAI;8875709110;Taip;0;7;0;7
18309;Vaduvos;PAGRANDUKAI;7305111076;Taip;0;4;1;5
18310;Vaduvos;PAGRANDUKAI;2897226343;Taip;0;3;0;3
18311;Vaduvos;PAGRANDUKAI;68848152670;Taip;0;11;0;11
18312;Vaduvos;PAGRANDUKAI;4105978403;Taip;0;5;0;5
18313;Vaduvos;PAGRANDUKAI;5428067167;Taip;0;3;4;7
18314;Vaduvos;PAGRANDUKAI;3699578284;Taip;0;6;0;6
18315;Vaduvos;PAGRANDUKAI;8299189235;Taip;18;0;0;18
18316;Vaduvos;PAGRANDUKAI;9540008495;Taip;5;3;0;8
18317;Vaduvos;KODĖLČIUKAI;3010510262;Taip;0;8;0;8
18318;Vaduvos;KODĖLČIUKAI;9429028460;Taip;0;3;0;3
18319;Vaduvos;KODĖLČIUKAI;6210729584;Taip;4;9;0;13
18320;Vaduvos;KODĖLČIUKAI;9606193112;Taip;0;2;0;2
18321;Vaduvos;KODĖLČIUKAI;4177935331;Taip;0;6;0;6
18322;Vaduvos;KODĖLČIUKAI;9983148737;Taip;0;1;0;1
18323;Vaduvos;KODĖLČIUKAI;9072097216;Taip;0;0;2;2
18324;Vaduvos;KODĖLČIUKAI;6810198013;Taip;2;4;0;6
18325;Vaduvos;KODĖLČIUKAI;3641822841;Taip;4;0;7;11
18326;Vaduvos;KODĖLČIUKAI;4270137614;Taip;0;4;0;4
18327;Vaduvos;KODĖLČIUKAI;3682708061;Taip;0;1;0;1
18328;Vaduvos;KODĖLČIUKAI;5262165284;Taip;0;3;1;4
18329;Vaduvos;KODĖLČIUKAI;8603418399;Taip;21;0;0;21
18330;Vaduvos;KODĖLČIUKAI;3096104197;Taip;12;0;0;12
18331;Vaduvos;KODĖLČIUKAI;5761137540;Taip;0;6;0;6
18332;Vaduvos;KODĖLČIUKAI;9597857664;Taip;1;0;3;4
18333;Vaduvos;KODĖLČIUKAI;1054097622;Taip;8;0;1;9
18334;Vaduvos;KODĖLČIUKAI;6013737546;Taip;0;0;13;13
18335;Vaduvos;KODĖLČIUKAI;6991960029;Ne;7;5;0;12
18336;Vaduvos;KODĖLČIUKAI;4789480822;Taip;5;3;0;8
18337;Vaduvos;SMALSUČIAI;3555513755;Taip;0;10;1;11
18338;Vaduvos;SMALSUČIAI;2184711783;Taip;0;1;0;1
18339;Vaduvos;SMALSUČIAI;7537754249;Taip;0;3;0;3
18340;Vaduvos;SMALSUČIAI;5573145836;Taip;0;3;2;5
18341;Vaduvos;SMALSUČIAI;7337663549;Taip;0;3;0;3
18342;Vaduvos;SMALSUČIAI;5055972872;Taip;3;4;0;7
18343;Vaduvos;SMALSUČIAI;1423148023;Taip;0;6;0;6
18344;Vaduvos;SMALSUČIAI;3091707832;Ne;5;3;0;8
18345;Vaduvos;SMALSUČIAI;87008942241;Taip;0;3;4;7
18346;Vaduvos;SMALSUČIAI;7181151562;Taip;5;3;1;9
18347;Vaduvos;SMALSUČIAI;7431411663;Taip;0;5;0;5
18348;Vaduvos;SMALSUČIAI;2257135127;Taip;3;0;9;12
18349;Vaduvos;SMALSUČIAI;6462126837;Taip;2;2;0;4
18350;Vaduvos;SMALSUČIAI;6213672547;Taip;0;1;3;4
18351;Vaduvos;SMALSUČIAI;1265287458;Taip;0;0;3;3
18352;Vaduvos;SMALSUČIAI;1434871968;Taip;4;0;4;8
18353;Vaduvos;SMALSUČIAI;3948025914;Taip;0;0;11;11
18354;Vaduvos;SMALSUČIAI;6253552951;Taip;0;6;1;7
18355;Vaduvos;SMALSUČIAI;7508333714;Ne;5;3;0;8
18356;Vaduvos;SMALSUČIAI;3925021238;Taip;3;0;4;7
18357;Vaduvos;GILIUKAI;1277811729;Taip;9;4;0;13
18358;Vaduvos;GILIUKAI;1969325922;Taip;0;4;0;4
18359;Vaduvos;GILIUKAI;5376707663;Taip;0;3;0;3
18360;Vaduvos;GILIUKAI;2835635250;Taip;0;0;4;4
18361;Vaduvos;GILIUKAI;2939561403;Taip;0;0;5;5
18362;Vaduvos;GILIUKAI;8188374113;Taip;7;3;0;10
18363;Vaduvos;GILIUKAI;6514406042;Taip;0;0;3;3
18364;Vaduvos;GILIUKAI;3057729267;Taip;16;0;0;16
18365;Vaduvos;GILIUKAI;6346625714;Taip;0;0;6;6
18366;Vaduvos;GILIUKAI;8580834401;Taip;0;0;1;1
18367;Vaduvos;GILIUKAI;9167796462;Taip;0;3;1;4
18368;Vaduvos;GILIUKAI;6276149710;Taip;12;0;3;15
18369;Vaduvos;GILIUKAI;6572776966;Taip;7;3;1;11
18370;Vaduvos;GILIUKAI;2957685586;Taip;7;0;4;11
18371;Vaduvos;GILIUKAI;3540548094;Taip;5;0;0;5
18372;Vaduvos;GILIUKAI;8964194121;Taip;5;0;4;9
18373;Vaduvos;GILIUKAI;5297217576;Taip;11;2;0;13
18374;Vaduvos;GILIUKAI;5010914832;Taip;0;10;3;13
18375;Vaduvos;GILIUKAI;4030891958;Taip;0;3;0;3
18376;Vaduvos;GILIUKAI;7730737705;Taip;6;4;0;10
18377;Vaduvos;GILIUKAI;2011976336;Taip;7;0;2;9
18378;Vaduvos;BORUŽĖLĖS;2277525837;Taip;0;2;0;2
18379;Vaduvos;BORUŽĖLĖS;6439773886;Taip;0;9;0;9
18380;Vaduvos;BORUŽĖLĖS;5634252033;Taip;0;3;0;3
18381;Vaduvos;BORUŽĖLĖS;6593754016;Taip;15;3;0;18
18382;Vaduvos;BORUŽĖLĖS;7521846747;Taip;0;7;0;7
18383;Vaduvos;BORUŽĖLĖS;1422507884;Taip;11;5;0;16
18384;Vaduvos;BORUŽĖLĖS;3461756429;Taip;0;8;0;8
18385;Vaduvos;BORUŽĖLĖS;8324927031;Taip;5;5;0;10
18386;Vaduvos;BORUŽĖLĖS;4465504676;Taip;3;4;0;7
18387;Vaduvos;BORUŽĖLĖS;7904713344;Taip;0;3;0;3
18388;Vaduvos;BORUŽĖLĖS;2417613291;Taip;0;0;8;8
18389;Vaduvos;BORUŽĖLĖS;5717064754;Ne;0;5;1;6
18390;Vaduvos;BORUŽĖLĖS;8064111922;Taip;0;6;5;11
18391;Vaduvos;BORUŽĖLĖS;2923920649;Taip;0;0;1;1
18392;Vaduvos;BORUŽĖLĖS;6552763746;Taip;0;3;0;3
18393;Vaduvos;BORUŽĖLĖS;3255011809;Taip;0;6;0;6
18394;Vaduvos;BORUŽĖLĖS;8946940285;Taip;0;4;0;4
18395;Vaduvos;BORUŽĖLĖS;9188471756;Taip;0;3;0;3
18396;Vaduvos;BORUŽĖLĖS;7169054113;Taip;0;5;0;5
18397;Vaduvos;BORUŽĖLĖS;2366843609;Taip;0;4;0;4
18398;Vaduvos;BORUŽĖLĖS;1924714755;Taip;5;0;2;7
18399;Vaduvos;DRUGELIAI;4936598927;Taip;0;3;3;6
18400;Vaduvos;DRUGELIAI;2341467486;Taip;0;0;2;2
18401;Vaduvos;DRUGELIAI;5510687497;Ne;0;7;0;7
18402;Vaduvos;DRUGELIAI;9824469881;Taip;3;0;2;5
18403;Vaduvos;DRUGELIAI;5915272436;Taip;5;0;3;8
18404;Vaduvos;DRUGELIAI;4238942070;Taip;0;3;0;3
18405;Vaduvos;DRUGELIAI;1539465611;Taip;10;0;1;11
18406;Vaduvos;DRUGELIAI;8384302877;Taip;13;0;0;13
18407;Vaduvos;DRUGELIAI;6770559352;Taip;1;3;2;6
18408;Vaduvos;DRUGELIAI;4856601924;Taip;3;7;0;10
18409;Vaduvos;DRUGELIAI;3477273224;Taip;8;3;0;11
18410;Vaduvos;DRUGELIAI;2452309232;Taip;0;1;0;1
18411;Vaduvos;DRUGELIAI;6776150749;Taip;0;0;4;4
18412;Vaduvos;DRUGELIAI;4587836073;Taip;0;7;0;7
18413;Vaduvos;DRUGELIAI;9333495119;Taip;0;8;0;8
18414;Vaduvos;DRUGELIAI;7597268115;Taip;10;0;3;13
18415;Vaduvos;DRUGELIAI;8400344609;Taip;3;0;1;4
18416;Vaduvos;DRUGELIAI;2789503381;Taip;0;3;0;3
18417;Vaduvos;DRUGELIAI;1987969267;Taip;18;0;0;18
18418;Vaduvos;DRUGELIAI;8990472878;Taip;18;0;0;18
18419;Vaduvos;DRUGELIAI;2717887489;Taip;18;0;0;18
18420;Vaduvos;DRUGELIAI;5881009426;Taip;0;0;1;1
18421;Vaduvos;RIEŠUTĖLIAI;6611531526;Taip;18;0;0;18
18422;Vaduvos;RIEŠUTĖLIAI;1466282653;Taip;5;0;4;9
18423;Vaduvos;RIEŠUTĖLIAI;3206096414;Ne;13;0;0;13
18424;Vaduvos;RIEŠUTĖLIAI;8055108164;Taip;8;3;0;11
18425;Vaduvos;RIEŠUTĖLIAI;5509202519;Taip;0;1;3;4
18426;Vaduvos;RIEŠUTĖLIAI;3855900628;Taip;6;2;1;9
18427;Vaduvos;RIEŠUTĖLIAI;5775152939;Taip;11;0;3;14
18428;Vaduvos;RIEŠUTĖLIAI;3060409258;Taip;6;2;1;9
18429;Vaduvos;RIEŠUTĖLIAI;8070494719;Taip;0;0;6;6
18430;Vaduvos;RIEŠUTĖLIAI;9232960362;Taip;11;0;0;11
18431;Vaduvos;RIEŠUTĖLIAI;7425991335;Taip;0;0;12;12
18432;Vaduvos;RIEŠUTĖLIAI;7592658267;Taip;0;0;7;7
18433;Vaduvos;RIEŠUTĖLIAI;8533315132;Taip;0;8;0;8
18434;Vaduvos;RIEŠUTĖLIAI;2508650990;Taip;0;8;0;8
18435;Vaduvos;RIEŠUTĖLIAI;6943057114;Taip;11;0;0;11
18436;Vaduvos;RIEŠUTĖLIAI;8669267296;Taip;18;0;0;18
18437;Vaduvos;RIEŠUTĖLIAI;1736248725;Taip;0;10;0;10
18438;Vaduvos;"1 klasė";3174998523;Taip;0;3;0;3
18439;Vaduvos;"1 klasė";1825188497;Ne;0;3;0;3
18440;Vaduvos;"1 klasė";3722349868;Taip;0;3;0;3
18441;Vaduvos;"1 klasė";13888236429;Taip;0;7;0;7
18442;Vaduvos;"1 klasė";5307128703;Taip;0;3;0;3
18443;Vaduvos;"1 klasė";6128582180;Taip;0;5;0;5
18444;Vaduvos;"1 klasė";62183976729;Taip;0;7;0;7
18445;Vaduvos;"1 klasė";93702732546;Taip;0;4;0;4
18446;Vaduvos;"1 klasė";15757662594;Taip;0;3;0;3
18447;Vaduvos;"1 klasė";41870343319;Taip;0;3;0;3
18448;Vaduvos;"1 klasė";4513707989;Ne;0;3;0;3
18449;Vaduvos;"1 klasė";68937983441;Taip;0;3;0;3
18450;Vaduvos;"1 klasė";59616893535;Taip;0;3;0;3
18451;Vaduvos;"1 klasė";22641388717;Taip;0;3;0;3
18452;Vaduvos;"1 klasė";21499108813;Taip;0;8;0;8
18453;Vaduvos;"1 klasė";79437154441;Taip;0;3;0;3
18454;Vaduvos;"1 klasė";46608435244;Taip;0;8;0;8
18455;Vaduvos;"1 klasė";61046090149;Taip;0;3;0;3
18456;Vaduvos;"1 klasė";56280470781;Taip;0;9;0;9
18457;Vaduvos;"1 klasė";11202010413;Taip;0;18;0;18
18458;Vaduvos;"1 klasė";1370696345;Taip;0;4;0;4
18459;Vaduvos;"1 klasė";4342471835;Taip;0;3;0;3
18460;Vaduvos;"1 klasė";9112649520;Taip;0;3;0;3
18461;Vaduvos;"1 klasė";1599595256;Taip;0;3;0;3
18462;Vaduvos;"1 klasė";5435336235;Taip;0;3;0;3
18463;Vaduvos;"1 klasė";1681367373;Taip;0;10;0;10
18464;Vaduvos;"3 klasė";97423576166;Taip;0;4;0;4
18465;Vaduvos;"3 klasė";38504924027;Taip;0;9;0;9
18466;Vaduvos;"3 klasė";96148085691;Taip;0;4;0;4
18467;Vaduvos;"3 klasė";12330772986;Taip;0;9;0;9
18468;Vaduvos;"3 klasė";33277362439;Ne;0;4;0;4
18469;Vaduvos;"3 klasė";32138087379;Taip;0;18;0;18
18470;Vaduvos;"3 klasė";67324784528;Taip;0;6;0;6
18471;Vaduvos;"3 klasė";4807104855;Taip;0;4;0;4
18472;Vaduvos;"3 klasė";2181614424;Taip;0;4;0;4
18473;Vaduvos;"3 klasė";2019573643;Taip;0;4;0;4
18474;Vaduvos;"3 klasė";27419094487;Taip;0;4;0;4
18475;Vaduvos;"3 klasė";89793734700;Taip;0;4;0;4
18476;Vaduvos;"3 klasė";17473821556;Taip;0;18;0;18
18477;Vaduvos;"3 klasė";53866301875;Ne;0;18;0;18
18478;Vaduvos;"3 klasė";7786986697;Taip;0;4;0;4
18479;Vaduvos;"3 klasė";9147332638;Taip;0;4;0;4
18480;Vaduvos;"3 klasė";1532675814;Taip;0;9;0;9
18481;Vaduvos;"3 klasė";98259624669;Taip;0;4;0;4
18482;Vaduvos;"3 klasė";36931517006;Taip;0;7;0;7
18483;Vaduvos;"3 klasė";61243424057;Taip;0;6;0;6
18484;Vaduvos;"3 klasė";30979103892;Taip;0;4;0;4
18485;Vaduvos;"3 klasė";78245732319;Taip;0;4;0;4
18486;Vaduvos;"3 klasė";48433447683;Taip;0;4;0;4
18487;Vaduvos;"3 klasė";85090873161;Taip;0;18;0;18
18488;Vaduvos;"3 klasė";41272273463;Ne;0;4;0;4
18489;Vaduvos;"4 klasė";96473212525;Taip;0;7;0;7
18490;Vaduvos;"4 klasė";75428164558;Taip;0;3;0;3
18491;Vaduvos;"4 klasė";63286903462;Taip;0;3;0;3
18492;Vaduvos;"4 klasė";13721939854;Taip;0;3;0;3
18493;Vaduvos;"4 klasė";1171210935;Taip;0;3;0;3
18494;Vaduvos;"4 klasė";7172286009;Taip;0;7;0;7
18495;Vaduvos;"4 klasė";6049882391;Ne;0;18;0;18
18496;Vaduvos;"4 klasė";38013859931;Taip;0;5;0;5
18497;Vaduvos;"4 klasė";4591744662;Taip;0;4;0;4
18498;Vaduvos;"4 klasė";9149523910;Taip;0;4;0;4
18499;Vaduvos;"4 klasė";76662161382;Taip;0;3;0;3
18500;Vaduvos;"4 klasė";26934740147;Taip;0;3;0;3
18501;Vaduvos;"4 klasė";18300713872;Taip;0;18;0;18
18502;Vaduvos;"4 klasė";768455288;Taip;0;3;0;3
18503;Vaduvos;"4 klasė";1768173501;Taip;0;3;0;3
18504;Vaduvos;"4 klasė";60531886576;Taip;0;5;0;5
18505;Vaduvos;"4 klasė";38462664426;Ne;0;4;0;4
18506;Vaduvos;"4 klasė";1821644443;Ne;0;4;0;4
18507;Vaduvos;"2 B klasė";95104294893;Taip;6;6;0;12
18508;Vaduvos;"2 B klasė";40872193458;Taip;0;5;0;5
18509;Vaduvos;"2 B klasė";6500567162;Taip;0;3;0;3
18510;Vaduvos;"2 B klasė";78931952732;Ne;0;4;0;4
18511;Vaduvos;"2 B klasė";1241148402;Taip;0;6;0;6
18512;Vaduvos;"2 B klasė";66359913774;Taip;0;4;0;4
18513;Vaduvos;"2 B klasė";24887196729;Taip;0;5;0;5
18514;Vaduvos;"2 B klasė";39687066893;Taip;0;8;0;8
18515;Vaduvos;"2 B klasė";64074141491;Taip;0;3;0;3
18516;Vaduvos;"2 B klasė";93924290247;Taip;0;3;0;3
18517;Vaduvos;"2 B klasė";47465933557;Taip;0;18;0;18
18518;Vaduvos;"2 B klasė";62521006557;Taip;0;5;0;5
18519;Vaduvos;"2 B klasė";16882774330;Taip;0;3;0;3
18520;Vaduvos;"2 B klasė";3259114583;Taip;0;3;0;3
18521;Vaduvos;"2 B klasė";87671358423;Taip;0;18;0;18
18522;Vaduvos;"2 B klasė";55138588393;Taip;0;3;0;3
18523;Vaduvos;"2 B klasė";3310156076;Ne;0;3;0;3
18524;Vaduvos;"2 A klasė";6279678482;Ne;0;3;0;3
18525;Vaduvos;"2 A klasė";96892752634;Taip;0;3;0;3
18526;Vaduvos;"2 A klasė";61243200177;Taip;0;3;0;3
18527;Vaduvos;"2 A klasė";62703428759;Taip;0;4;0;4
18528;Vaduvos;"2 A klasė";68420568339;Taip;0;6;0;6
18529;Vaduvos;"2 A klasė";49738318631;Taip;0;4;0;4
18530;Vaduvos;"2 A klasė";65647119496;Taip;0;3;0;3
18531;Vaduvos;"2 A klasė";19390879176;Taip;0;3;0;3
18532;Vaduvos;"2 A klasė";6155494370;Ne;0;3;0;3
18533;Vaduvos;"2 A klasė";1139509471;Taip;0;18;0;18
18534;Vaduvos;"2 A klasė";70693742936;Taip;0;4;0;4
18535;Vaduvos;"2 A klasė";1010061503;Taip;0;9;0;9
18536;Vaduvos;"2 A klasė";1107557891;Taip;0;18;0;18
18537;Vaduvos;"2 A klasė";8802765960;Taip;0;3;0;3
18538;Vaduvos;"2 A klasė";3172047211;Taip;0;3;0;3
18539;Vilkpėdės;BORUŽĖLĖS;8002436634;Taip;6;0;0;6
18540;Vilkpėdės;BORUŽĖLĖS;1249504082;Taip;12;0;1;13
18541;Vilkpėdės;BORUŽĖLĖS;4052026470;Taip;4;3;4;11
18542;Vilkpėdės;BORUŽĖLĖS;4726171678;Taip;5;3;0;8
18543;Vilkpėdės;BORUŽĖLĖS;7519472444;Taip;3;3;0;6
18544;Vilkpėdės;BORUŽĖLĖS;3991785883;Taip;1;1;3;5
18545;Vilkpėdės;BORUŽĖLĖS;9334610111;Taip;11;0;0;11
18546;Vilkpėdės;BORUŽĖLĖS;7992484314;Taip;2;2;2;6
18547;Vilkpėdės;BORUŽĖLĖS;5050493757;Taip;6;3;1;10
18548;Vilkpėdės;BORUŽĖLĖS;8217972925;Taip;1;7;0;8
18549;Vilkpėdės;BORUŽĖLĖS;3994451071;Taip;14;0;0;14
18550;Vilkpėdės;BORUŽĖLĖS;2529188623;Taip;5;3;0;8
18551;Vilkpėdės;BORUŽĖLĖS;5569182344;Taip;4;3;0;7
18552;Vilkpėdės;BORUŽĖLĖS;5677284428;Taip;3;3;0;6
18553;Vilkpėdės;SKRUZDĖLIUKAI;7661268641;Taip;0;5;0;5
18554;Vilkpėdės;SKRUZDĖLIUKAI;4018140154;Taip;8;4;0;12
18555;Vilkpėdės;SKRUZDĖLIUKAI;2419661008;Taip;0;3;0;3
18556;Vilkpėdės;SKRUZDĖLIUKAI;7114183123;Taip;0;3;0;3
18557;Vilkpėdės;SKRUZDĖLIUKAI;8804335248;Taip;0;3;1;4
18558;Vilkpėdės;SKRUZDĖLIUKAI;2525399410;Taip;0;3;0;3
18559;Vilkpėdės;SKRUZDĖLIUKAI;4031175523;Taip;0;1;0;1
18560;Vilkpėdės;SKRUZDĖLIUKAI;6198736925;Taip;0;1;0;1
18561;Vilkpėdės;SKRUZDĖLIUKAI;5812430367;Taip;11;0;0;11
18562;Vilkpėdės;SKRUZDĖLIUKAI;1478022307;Taip;5;5;0;10
18563;Vilkpėdės;SKRUZDĖLIUKAI;2205143759;Taip;0;3;1;4
18564;Vilkpėdės;SKRUZDĖLIUKAI;6598572049;Taip;4;1;0;5
18565;Vilkpėdės;SKRUZDĖLIUKAI;7931496783;Taip;0;3;0;3
18566;Vilkpėdės;SKRUZDĖLIUKAI;2418313731;Taip;11;3;0;14
18567;Vilkpėdės;SKRUZDĖLIUKAI;1342167313;Taip;0;11;0;11
18568;Vilkpėdės;SKRUZDĖLIUKAI;1838974989;Taip;3;8;0;11
18569;Vilkpėdės;SKRUZDĖLIUKAI;5334238235;Taip;0;3;2;5
18570;Vilkpėdės;SKRUZDĖLIUKAI;2703704892;Ne;0;3;2;5
18571;Vilkpėdės;SKRUZDĖLIUKAI;8385974099;Taip;0;3;1;4
18572;Vilkpėdės;SKRUZDĖLIUKAI;6671311193;Taip;0;3;2;5
18573;Vilkpėdės;SKRUZDĖLIUKAI;1985540746;Taip;0;3;11;14
18574;Vilkpėdės;DRUGELIAI;1040357501;Taip;8;3;0;11
18575;Vilkpėdės;DRUGELIAI;6876470245;Taip;8;3;0;11
18576;Vilkpėdės;DRUGELIAI;8431620518;Taip;4;0;1;5
18577;Vilkpėdės;DRUGELIAI;1655396296;Taip;11;0;0;11
18578;Vilkpėdės;DRUGELIAI;5076206526;Taip;0;1;2;3
18579;Vilkpėdės;DRUGELIAI;3611416887;Taip;0;1;2;3
18580;Vilkpėdės;DRUGELIAI;7008659662;Taip;0;1;0;1
18581;Vilkpėdės;DRUGELIAI;9501254301;Taip;0;1;2;3
18582;Vilkpėdės;DRUGELIAI;4998396593;Taip;14;0;0;14
18583;Vilkpėdės;DRUGELIAI;1278300322;Taip;0;4;0;4
18584;Vilkpėdės;DRUGELIAI;9797550851;Taip;18;0;0;18
18585;Vilkpėdės;DRUGELIAI;2379571797;Taip;2;0;0;2
18586;Vilkpėdės;ŽIOGELIAI;1396827668;Taip;5;0;0;5
18587;Vilkpėdės;ŽIOGELIAI;5551822633;Taip;14;0;0;14
18588;Vilkpėdės;ŽIOGELIAI;1063740772;Taip;0;3;0;3
18589;Vilkpėdės;ŽIOGELIAI;3666145718;Taip;0;6;0;6
18590;Vilkpėdės;ŽIOGELIAI;5633014328;Taip;11;1;0;12
18591;Vilkpėdės;ŽIOGELIAI;5422061533;Taip;8;0;0;8
18592;Vilkpėdės;ŽIOGELIAI;4311938034;Taip;0;3;0;3
18593;Vilkpėdės;ŽIOGELIAI;5346798201;Taip;0;4;0;4
18594;Vilkpėdės;ŽIOGELIAI;3720639726;Taip;0;0;2;2
18595;Vilkpėdės;ŽIOGELIAI;1609823694;Taip;0;0;1;1
18596;Vilkpėdės;ŽIOGELIAI;7634076203;Taip;10;0;0;10
18597;Vilkpėdės;ŽIOGELIAI;6690742997;Taip;0;5;0;5
18598;Vilkpėdės;ŽIOGELIAI;3350784810;Taip;5;3;0;8
18599;Vilkpėdės;ŽIOGELIAI;1655985778;Taip;10;1;0;11
18600;Vilkpėdės;ŽIOGELIAI;3664125930;Ne;18;0;0;18
18601;Vilkpėdės;ŽIOGELIAI;3737265597;Taip;0;3;0;3
18602;Vilkpėdės;ŽIOGELIAI;2241104719;Taip;1;3;2;6
18603;Vilkpėdės;ŽIOGELIAI;8423972962;Taip;0;3;0;3
18604;Vilkpėdės;ŽIOGELIAI;1537270256;Taip;15;3;0;18
18605;Vilkpėdės;ŽIOGELIAI;3229559339;Taip;15;3;0;18
18606;Vilkpėdės;ŽIOGELIAI;8783790519;Taip;0;6;0;6
18607;Vilkpėdės;BITUTĖS;6418829930;Taip;10;4;0;14
18608;Vilkpėdės;BITUTĖS;1633942236;Taip;4;4;0;8
18609;Vilkpėdės;BITUTĖS;8484873068;Taip;7;0;3;10
18610;Vilkpėdės;BITUTĖS;2503128176;Taip;4;1;0;5
18611;Vilkpėdės;BITUTĖS;9570469277;Taip;7;3;0;10
18612;Vilkpėdės;BITUTĖS;5420512675;Taip;15;0;1;16
18613;Vilkpėdės;BITUTĖS;8613778606;Taip;18;0;0;18
18614;Vilkpėdės;BITUTĖS;7991758361;Taip;0;5;0;5
18615;Vilkpėdės;BITUTĖS;2736318576;Taip;0;0;4;4
18616;Vilkpėdės;BITUTĖS;6064336759;Taip;10;3;0;13
18617;Vilkpėdės;BITUTĖS;8930504912;Taip;0;8;6;14
18618;Vilkpėdės;BITUTĖS;3303872633;Taip;17;1;0;18
18619;Vilkpėdės;BITUTĖS;5972405023;Taip;15;3;0;18
18620;Vilkpėdės;BITUTĖS;4485811377;Ne;0;7;0;7
18621;Vilkpėdės;BITUTĖS;5274855225;Taip;9;0;1;10
18622;Vilkpėdės;BITUTĖS;8860791478;Taip;2;2;0;4
18623;Vilkpėdės;BITUTĖS;7829343719;Taip;18;0;0;18
18624;Vilkpėdės;"4 klasė";14499651046;Ne;0;7;0;7
18625;Vilkpėdės;"4 klasė";90217345315;Taip;0;4;0;4
18626;Vilkpėdės;"4 klasė";51286525404;Taip;0;5;0;5
18627;Vilkpėdės;"4 klasė";49513181091;Taip;5;8;0;13
18628;Vilkpėdės;"4 klasė";37450374921;Taip;10;5;0;15
18629;Vilkpėdės;"4 klasė";36704555745;Taip;3;4;0;7
18630;Vilkpėdės;"4 klasė";1024429836;Taip;1;4;0;5
18631;Vilkpėdės;"4 klasė";66356984763;Taip;0;6;0;6
18632;Vilkpėdės;"4 klasė";88279045901;Taip;1;9;0;10
18633;Vilkpėdės;"4 klasė";66451097025;Taip;3;4;0;7
18634;Vilkpėdės;"4 klasė";2806307083;Taip;0;6;0;6
18635;Vilkpėdės;"4 klasė";51799865091;Taip;8;4;0;12
18636;Vilkpėdės;"4 klasė";79269485254;Taip;0;6;0;6
18637;Vilkpėdės;"4 klasė";61833757576;Taip;0;6;0;6
18638;Vilkpėdės;"4 klasė";64216245300;Taip;0;4;0;4
18639;Vilkpėdės;GUDRUČIAI;1527272055;Taip;0;3;0;3
18640;Vilkpėdės;GUDRUČIAI;1451102218;Taip;0;4;0;4
18641;Vilkpėdės;GUDRUČIAI;2065010940;Taip;0;4;0;4
18642;Vilkpėdės;GUDRUČIAI;2181146968;Taip;0;5;4;9
18643;Vilkpėdės;GUDRUČIAI;4392760215;Taip;7;3;0;10
18644;Vilkpėdės;GUDRUČIAI;4515945951;Taip;0;3;1;4
18645;Vilkpėdės;GUDRUČIAI;2736368118;Taip;0;8;1;9
18646;Vilkpėdės;GUDRUČIAI;7527929277;Taip;6;3;0;9
18647;Vilkpėdės;GUDRUČIAI;46561435465;Taip;0;5;0;5
18648;Vilkpėdės;GUDRUČIAI;48059844727;Taip;0;3;0;3
18649;Vilkpėdės;GUDRUČIAI;8865545376;Taip;0;5;0;5
18650;Vilkpėdės;GUDRUČIAI;4735164204;Taip;0;3;0;3
18651;Vilkpėdės;GUDRUČIAI;7889480219;Ne;0;3;0;3
18652;Vilkpėdės;GUDRUČIAI;9867411687;Taip;0;4;0;4
18653;Vilkpėdės;GUDRUČIAI;2900581406;Taip;0;9;0;9
18654;Vilkpėdės;GUDRUČIAI;7875898177;Taip;0;18;0;18
18655;Vilkpėdės;GUDRUČIAI;1195392132;Taip;0;3;0;3
18656;Vilkpėdės;GUDRUČIAI;9605399822;Taip;0;4;0;4
18657;Vilkpėdės;GUDRUČIAI;7634355147;Taip;0;3;0;3
18658;Vilkpėdės;GUDRUČIAI;4276158771;Taip;0;4;0;4
18659;Vilkpėdės;GUDRUČIAI;2604179994;Taip;0;4;0;4
18660;Vilkpėdės;GUDRUČIAI;3696611509;Taip;4;4;2;10
18661;Vilkpėdės;SMALSUČIAI;9294350205;Taip;0;12;0;12
18662;Vilkpėdės;SMALSUČIAI;4095366279;Taip;0;4;0;4
18663;Vilkpėdės;SMALSUČIAI;5048931309;Taip;15;3;0;18
18664;Vilkpėdės;SMALSUČIAI;7698759895;Taip;0;7;0;7
18665;Vilkpėdės;SMALSUČIAI;1019057127;Taip;0;4;0;4
18666;Vilkpėdės;SMALSUČIAI;1217929358;Taip;0;5;0;5
18667;Vilkpėdės;SMALSUČIAI;1807884737;Taip;4;8;0;12
18668;Vilkpėdės;SMALSUČIAI;2251274741;Taip;18;0;0;18
18669;Vilkpėdės;SMALSUČIAI;6816745585;Taip;0;3;0;3
18670;Vilkpėdės;SMALSUČIAI;9460356725;Taip;0;3;0;3
18671;Vilkpėdės;SMALSUČIAI;8128254701;Taip;0;3;0;3
18672;Vilkpėdės;SMALSUČIAI;8015392054;Taip;0;1;0;1
18673;Vilkpėdės;SMALSUČIAI;2320350937;Taip;0;2;0;2
18674;Vilkpėdės;SMALSUČIAI;7747013579;Taip;0;4;0;4
18675;Vilkpėdės;SMALSUČIAI;7894766629;Taip;0;9;0;9
18676;Vilkpėdės;SMALSUČIAI;3987021185;Taip;5;3;0;8
18677;Vilkpėdės;SMALSUČIAI;7010024061;Taip;0;9;0;9
18678;Vilkpėdės;SMALSUČIAI;7908813288;Taip;0;3;0;3
18679;Vilkpėdės;SMALSUČIAI;6522707709;Taip;10;3;0;13
18680;Vilkpėdės;SMALSUČIAI;9795696242;Taip;2;4;0;6
18681;Vilkpėdės;SMALSUČIAI;8581661608;Taip;0;3;0;3
18682;Vilkpėdės;SMALSUČIAI;6261547304;Taip;0;1;0;1
18683;Vilkpėdės;SMALSUČIAI;2420271759;Taip;0;13;0;13
18684;Vilkpėdės;KODĖLČIUKŲ;6283767445;Taip;4;4;0;8
18685;Vilkpėdės;KODĖLČIUKŲ;9605430333;Taip;13;3;0;16
18686;Vilkpėdės;KODĖLČIUKŲ;7745776486;Taip;2;2;0;4
18687;Vilkpėdės;KODĖLČIUKŲ;8969001990;Taip;1;3;0;4
18688;Vilkpėdės;KODĖLČIUKŲ;7158737372;Taip;15;1;0;16
18689;Vilkpėdės;KODĖLČIUKŲ;3785308006;Taip;4;3;1;8
18690;Vilkpėdės;KODĖLČIUKŲ;6744834487;Taip;6;3;0;9
18691;Vilkpėdės;KODĖLČIUKŲ;4166416292;Taip;0;6;0;6
18692;Vilkpėdės;KODĖLČIUKŲ;3888880306;Taip;0;7;0;7
18693;Vilkpėdės;KODĖLČIUKŲ;9601934563;Taip;0;3;0;3
18694;Vilkpėdės;KODĖLČIUKŲ;7401886306;Taip;10;4;0;14
18695;Vilkpėdės;KODĖLČIUKŲ;1528619779;Taip;0;4;0;4
18696;Vilkpėdės;KODĖLČIUKŲ;2359315281;Taip;5;4;0;9
18697;Vilkpėdės;KODĖLČIUKŲ;1571869318;Ne;0;4;0;4
18698;Vilkpėdės;KODĖLČIUKŲ;4255757333;Ne;6;3;0;9
18699;Vilkpėdės;KODĖLČIUKŲ;1063561954;Taip;4;3;0;7
18700;Vilkpėdės;KODĖLČIUKŲ;5053032081;Taip;1;2;0;3
18701;Vilkpėdės;KODĖLČIUKŲ;6778288398;Taip;5;2;0;7
18702;Vilkpėdės;KODĖLČIUKŲ;7284081203;Taip;1;3;0;4
18703;Žiburėlis;Nykštukai;6696156248;Taip;0;3;0;3
18704;Žiburėlis;Nykštukai;7163594513;Taip;3;3;0;6
18705;Žiburėlis;Nykštukai;5174211773;Taip;5;6;0;11
18706;Žiburėlis;Nykštukai;5408766721;Taip;10;3;0;13
18707;Žiburėlis;Nykštukai;3646988912;Taip;0;3;0;3
18708;Žiburėlis;Nykštukai;7211961512;Taip;0;3;0;3
18709;Žiburėlis;Nykštukai;7862546963;Taip;3;3;0;6
18710;Žiburėlis;Nykštukai;8902837168;Taip;3;3;0;6
18711;Žiburėlis;Nykštukai;7465939429;Taip;0;5;0;5
18712;Žiburėlis;Nykštukai;7307386173;Taip;11;3;0;14
18713;Žiburėlis;Nykštukai;8215816053;Taip;0;5;0;5
18714;Žiburėlis;Nykštukai;4710995351;Taip;6;7;0;13
18715;Žiburėlis;Nykštukai;7633450988;Taip;5;4;0;9
18716;Žiburėlis;Nykštukai;2292895729;Taip;0;10;0;10
18717;Žiburėlis;Nykštukai;7273838695;Taip;0;6;0;6
18718;Žiburėlis;Nykštukai;9806454408;Ne;1;12;0;13
18719;Žiburėlis;Nykštukai;1764592065;Taip;6;3;0;9
18720;Žiburėlis;Nykštukai;3938379566;Taip;6;3;0;9
18721;Žiburėlis;Nykštukai;9932264675;Taip;5;3;0;8
18722;Žiburėlis;Nykštukai;2253167147;Taip;5;4;0;9
18723;Žiburėlis;Nykštukai;8480167191;Taip;0;15;0;15
18724;Žiburėlis;Nykštukai;1559091567;Taip;0;5;0;5
18725;Žiburėlis;Nykštukai;3750024153;Taip;0;5;0;5
18726;Žiburėlis;"Žiniukai ";5816890413;Taip;4;3;0;7
18727;Žiburėlis;"Žiniukai ";2928528630;Taip;4;3;0;7
18728;Žiburėlis;"Žiniukai ";2624326930;Taip;6;7;0;13
18729;Žiburėlis;"Žiniukai ";6300247811;Taip;4;4;0;8
18730;Žiburėlis;"Žiniukai ";3033049328;Taip;4;3;0;7
18731;Žiburėlis;"Žiniukai ";3262856058;Taip;11;3;0;14
18732;Žiburėlis;"Žiniukai ";1720078356;Taip;0;4;0;4
18733;Žiburėlis;"Žiniukai ";7424129974;Taip;0;4;0;4
18734;Žiburėlis;"Žiniukai ";4187381976;Taip;0;5;0;5
18735;Žiburėlis;"Žiniukai ";5006361324;Taip;0;3;0;3
18736;Žiburėlis;"Žiniukai ";2956339420;Taip;0;6;0;6
18737;Žiburėlis;"Žiniukai ";2999365435;Ne;0;3;0;3
18738;Žiburėlis;"Žiniukai ";7070952018;Taip;0;9;0;9
18739;Žiburėlis;"Žiniukai ";8438876806;Taip;0;9;0;9
18740;Žiburėlis;"Žiniukai ";3687703187;Ne;0;5;0;5
18741;Žiburėlis;"Žiniukai ";8535429783;Taip;0;3;0;3
18742;Žiburėlis;"Žiniukai ";1543314096;Taip;0;3;0;3
18743;Žiburėlis;"Žiniukai ";1061646244;Ne;0;4;0;4
18744;Žiburėlis;"Žiniukai ";2741301903;Taip;0;4;0;4
18745;Žiburėlis;"Smalsiukai ";5438697081;Taip;0;5;2;7
18746;Žiburėlis;"Smalsiukai ";1126972447;Ne;0;3;0;3
18747;Žiburėlis;"Smalsiukai ";5114554577;Taip;0;7;0;7
18748;Žiburėlis;"Smalsiukai ";3936418539;Taip;0;3;0;3
18749;Žiburėlis;"Smalsiukai ";2072972990;Taip;8;4;0;12
18750;Žiburėlis;"Smalsiukai ";3835820013;Taip;0;4;0;4
18751;Žiburėlis;"Smalsiukai ";4355778076;Taip;5;4;0;9
18752;Žiburėlis;"Smalsiukai ";92490398630;Taip;0;3;0;3
18753;Žiburėlis;"Smalsiukai ";67168630669;Taip;0;6;0;6
18754;Žiburėlis;"Smalsiukai ";3867540155;Taip;0;3;4;7
18755;Žiburėlis;"Smalsiukai ";9253393819;Taip;0;5;1;6
18756;Žiburėlis;"Smalsiukai ";1599112927;Taip;0;5;0;5
18757;Žiburėlis;"Smalsiukai ";2796489509;Taip;0;3;0;3
18758;Žiburėlis;"Smalsiukai ";18739941845;Taip;0;3;0;3
18759;Žiburėlis;"Smalsiukai ";24639355056;Taip;0;6;0;6
18760;Žiburėlis;"Smalsiukai ";6519139977;Taip;0;14;0;14
18761;Žiburėlis;"Smalsiukai ";7861704875;Taip;0;4;0;4
18762;Žiburėlis;"Smalsiukai ";34873231652;Taip;0;4;0;4
18763;Žiburėlis;"Smalsiukai ";1125662904;Taip;0;8;0;8
18764;Žiburėlis;"Smalsiukai ";2175751377;Taip;0;4;0;4
18765;Žiburėlis;"Smalsiukai ";28985997205;Taip;7;3;0;10
18766;Žiburėlis;"Giliukai ";1090883494;Taip;13;0;0;13
18767;Žiburėlis;"Giliukai ";9215654134;Taip;1;3;0;4
18768;Žiburėlis;"Giliukai ";2866098551;Taip;5;4;0;9
18769;Žiburėlis;"Giliukai ";6918525245;Taip;2;2;0;4
18770;Žiburėlis;"Giliukai ";6946621147;Taip;0;6;0;6
18771;Žiburėlis;"Giliukai ";5148264064;Taip;5;6;0;11
18772;Žiburėlis;"Giliukai ";6733333096;Taip;1;3;0;4
18773;Žiburėlis;"Giliukai ";1943162133;Taip;0;2;0;2
18774;Žiburėlis;"Giliukai ";6232492947;Taip;0;1;0;1
18775;Žiburėlis;"Giliukai ";3807588865;Taip;5;4;0;9
18776;Žiburėlis;"Giliukai ";4091901597;Taip;0;3;0;3
18777;Žiburėlis;"Giliukai ";4016969144;Taip;2;8;0;10
18778;Žiburėlis;"Giliukai ";3776569251;Taip;18;0;0;18
18779;Žiburėlis;"Giliukai ";9494271740;Taip;1;5;0;6
18780;Žiburėlis;"Giliukai ";3992503848;Taip;4;5;0;9
18781;Žiburėlis;"Giliukai ";8440073413;Taip;11;0;0;11
18782;Žiburėlis;"Giliukai ";6121237159;Taip;11;0;0;11
18783;Žiburėlis;"Giliukai ";6289338466;Taip;4;1;0;5
18784;Žiburėlis;"Giliukai ";7977098545;Taip;3;0;0;3
18785;Žiburėlis;"Giliukai ";2990465012;Taip;2;3;0;5
18786;Žiburėlis;"Giliukai ";8697451319;Taip;2;0;0;2
18787;Žiburėlis;Meškiukai;3593851196;Taip;2;3;0;5
18788;Žiburėlis;Meškiukai;9470154520;Taip;0;6;0;6
18789;Žiburėlis;Meškiukai;2285666668;Ne;0;3;2;5
18790;Žiburėlis;Meškiukai;2836519241;Taip;0;1;1;2
18791;Žiburėlis;Meškiukai;9731661697;Taip;0;1;0;1
18792;Žiburėlis;Meškiukai;2186032732;Taip;3;3;0;6
18793;Žiburėlis;Meškiukai;9321467329;Taip;5;1;0;6
18794;Žiburėlis;Meškiukai;2254407798;Taip;0;4;0;4
18795;Žiburėlis;Meškiukai;4887304311;Taip;0;2;0;2
18796;Žiburėlis;Meškiukai;1651713696;Taip;0;3;1;4
18797;Žiburėlis;Meškiukai;1105220246;Taip;0;4;0;4
18798;Žiburėlis;Meškiukai;8415647388;Taip;0;3;0;3
18799;Žiburėlis;Meškiukai;2371990135;Taip;0;3;1;4
18800;Žiburėlis;Meškiukai;8883542394;Ne;0;1;0;1
18801;Žiburėlis;Meškiukai;6218255066;Taip;0;3;0;3
18802;Žiburėlis;Meškiukai;3522480911;Taip;8;0;0;8
18803;Žiburėlis;Meškiukai;5683969627;Taip;18;0;0;18
18804;Žiburėlis;Meškiukai;4667559315;Taip;5;3;0;8
18805;Žiburėlis;Viščiukai;7485768254;Taip;10;0;1;11
18806;Žiburėlis;Viščiukai;7364102991;Taip;13;0;0;13
18807;Žiburėlis;Viščiukai;2506620539;Taip;10;0;0;10
18808;Žiburėlis;Viščiukai;9553194981;Taip;10;0;0;10
18809;Žiburėlis;Viščiukai;8179414341;Taip;8;0;0;8
18810;Žiburėlis;Viščiukai;7140031765;Taip;4;0;1;5
18811;Žiburėlis;Viščiukai;1758251348;Taip;6;1;0;7
18812;Žiburėlis;Viščiukai;1121755119;Taip;3;0;1;4
18813;Žiburėlis;Viščiukai;3738184802;Taip;8;2;1;11
18814;Žiburėlis;Viščiukai;8603154782;Taip;17;0;0;17
18815;Žiburėlis;Viščiukai;4727673956;Taip;12;0;0;12
18816;Žiburėlis;Viščiukai;1606332622;Taip;8;0;0;8
18817;Žiburėlis;Viščiukai;8284913889;Taip;17;0;0;17
18818;Žiburėlis;Viščiukai;2851350451;Taip;5;2;1;8
18819;Žiburėlis;Viščiukai;6206770019;Taip;3;0;1;4
18820;Žiburėlis;Viščiukai;5314676261;Taip;2;1;0;3
18821;Žiburėlis;"Drambliukai ";5724506894;Taip;0;4;0;4
18822;Žiburėlis;"Drambliukai ";2102574423;Taip;5;3;0;8
18823;Žiburėlis;"Drambliukai ";4937518207;Taip;9;0;0;9
18824;Žiburėlis;"Drambliukai ";2383554216;Taip;0;1;0;1
18825;Žiburėlis;"Drambliukai ";9041469393;Taip;8;1;0;9
18826;Žiburėlis;"Drambliukai ";8285987095;Taip;28;0;0;28
18827;Žiburėlis;"Drambliukai ";2805244671;Taip;0;8;0;8
18828;Žiburėlis;"Drambliukai ";5025452484;Taip;2;6;0;8
18829;Žiburėlis;"Drambliukai ";9344950711;Taip;3;3;0;6
18830;Žiburėlis;"Drambliukai ";8082088504;Taip;6;3;0;9
18831;Žiburėlis;"Drambliukai ";4656467260;Taip;0;6;0;6
18832;Žiburėlis;"Drambliukai ";9771442035;Taip;5;7;0;12
18833;Žiburėlis;"Drambliukai ";6274583813;Taip;18;0;0;18
18834;Žiburėlis;"Drambliukai ";5194593598;Taip;28;0;0;28
18835;Žiburėlis;"Drambliukai ";3821663597;Taip;28;0;0;28
18836;Žiburėlis;"Drambliukai ";8752098051;Taip;8;3;0;11
18837;Žiburėlis;"Drambliukai ";8207315673;Taip;7;2;0;9
18838;Žiburėlis;"Drambliukai ";6751043071;Taip;25;0;0;25
18839;Žiburėlis;"Drambliukai ";1449541244;Taip;18;0;0;18
18840;Žiburėlis;BORUŽIUKAI;3723613593;Taip;10;3;0;13
18841;Žiburėlis;BORUŽIUKAI;9964255985;Taip;0;5;0;5
18842;Žiburėlis;BORUŽIUKAI;7895148630;Taip;0;0;18;18
18843;Žiburėlis;BORUŽIUKAI;8936912406;Taip;13;0;0;13
18844;Žiburėlis;BORUŽIUKAI;1422951221;Ne;0;3;0;3
18845;Žiburėlis;BORUŽIUKAI;4631232618;Taip;8;3;0;11
18846;Žiburėlis;BORUŽIUKAI;5793531526;Taip;0;3;0;3
18847;Žiburėlis;BORUŽIUKAI;4578828135;Taip;0;3;0;3
18848;Žiburėlis;BORUŽIUKAI;6128571259;Taip;0;3;3;6
18849;Žiburėlis;BORUŽIUKAI;3760039280;Taip;0;7;0;7
18850;Žiburėlis;BORUŽIUKAI;5799439634;Taip;0;5;0;5
18851;Žiburėlis;BORUŽIUKAI;4229040996;Taip;5;3;0;8
18852;Žiburėlis;BORUŽIUKAI;8373944614;Taip;1;3;6;10
18853;Žiburėlis;BORUŽIUKAI;9256751455;Taip;6;3;0;9
18854;Žiburėlis;BORUŽIUKAI;2077823704;Taip;5;3;0;8
18855;Žiburėlis;BORUŽIUKAI;9357376188;Taip;0;3;0;3
18856;Žiburėlis;BORUŽIUKAI;4233222771;Taip;0;3;0;3
18857;Žiburėlis;BORUŽIUKAI;9029039015;Taip;0;3;3;6
18858;Žiburėlis;BORUŽIUKAI;7017574924;Taip;0;0;8;8
18859;Žiburėlis;BORUŽIUKAI;1661456806;Taip;0;3;0;3
18860;Žiburėlis;BORUŽIUKAI;2527837980;Taip;13;0;0;13
18861;Žiburėlis;SPINDULIUKAI;5002691930;Taip;1;5;0;6
18862;Žiburėlis;SPINDULIUKAI;2995697464;Taip;2;3;0;5
18863;Žiburėlis;SPINDULIUKAI;7856708616;Taip;8;3;0;11
18864;Žiburėlis;SPINDULIUKAI;5205959106;Taip;13;3;0;16
18865;Žiburėlis;SPINDULIUKAI;2491972986;Taip;0;6;0;6
18866;Žiburėlis;SPINDULIUKAI;1190058462;Taip;0;6;0;6
18867;Žiburėlis;SPINDULIUKAI;8970153523;Taip;1;5;0;6
18868;Žiburėlis;SPINDULIUKAI;7402647048;Taip;4;3;0;7
18869;Žiburėlis;SPINDULIUKAI;9352485231;Taip;0;2;0;2
18870;Žiburėlis;SPINDULIUKAI;5951659866;Taip;5;1;0;6
18871;Žiburėlis;SPINDULIUKAI;8346571253;Taip;0;3;0;3
18872;Žiburėlis;SPINDULIUKAI;4720567144;Taip;0;4;0;4
18873;Žiburėlis;SPINDULIUKAI;8973307069;Taip;8;3;0;11
18874;Žiburėlis;SPINDULIUKAI;5098955523;Taip;0;9;0;9
18875;Žiburėlis;SPINDULIUKAI;5629404179;Taip;0;7;0;7
18876;Žiburėlis;SPINDULIUKAI;6647598068;Taip;0;3;0;3
18877;Žiburėlis;SPINDULIUKAI;8686565770;Taip;3;3;0;6
18878;Žiburėlis;SPINDULIUKAI;7111530833;Taip;0;3;0;3
18879;Žiburėlis;SPINDULIUKAI;7825665451;Taip;0;8;0;8
18880;Žiburėlis;SPINDULIUKAI;5556807335;Taip;5;3;0;8
18881;Žiburėlis;SPINDULIUKAI;2808361570;Taip;0;8;0;8
18882;Žiburėlis;KIŠKUČIAI;6492467281;Taip;1;3;0;4
18883;Žiburėlis;KIŠKUČIAI;3352845095;Taip;2;3;1;6
18884;Žiburėlis;KIŠKUČIAI;1004953300;Taip;0;4;0;4
18885;Žiburėlis;KIŠKUČIAI;3296994981;Taip;10;3;0;13
18886;Žiburėlis;KIŠKUČIAI;1887550130;Taip;10;5;3;18
18887;Žiburėlis;KIŠKUČIAI;6019278045;Taip;5;2;0;7
18888;Žiburėlis;KIŠKUČIAI;4079793067;Taip;0;4;0;4
18889;Žiburėlis;KIŠKUČIAI;5418413225;Taip;0;3;0;3
18890;Žiburėlis;KIŠKUČIAI;6044837042;Taip;0;5;3;8
18891;Žiburėlis;KIŠKUČIAI;1334695206;Taip;0;5;10;15
18892;Žiburėlis;KIŠKUČIAI;7597762608;Taip;7;5;1;13
18893;Žiburėlis;KIŠKUČIAI;6562748977;Ne;4;5;0;9
18894;Žiburėlis;KIŠKUČIAI;5145195661;Taip;0;4;3;7
18895;Žiburėlis;KIŠKUČIAI;4477396434;Ne;8;6;0;14
18896;Žiburėlis;KIŠKUČIAI;2712358146;Taip;4;5;1;10
18897;Žiburėlis;KIŠKUČIAI;5410394172;Taip;5;3;0;8
18898;Žiburėlis;KIŠKUČIAI;2117995780;Taip;10;3;0;13
18899;Žiburėlis;KIŠKUČIAI;4003368130;Taip;8;5;0;13
18900;Žiburėlis;KIŠKUČIAI;2456703958;Taip;10;3;0;13
18901;Žiburėlis;KIŠKUČIAI;1868558773;Taip;0;6;0;6
18902;Žiburėlis;KIŠKUČIAI;2083500905;Taip;0;7;0;7
18903;Žiburėlis;KIŠKUČIAI;6577061306;Taip;9;3;0;12
18904;Žiburėlis;DRUGELIAI;9783567484;Taip;0;6;0;6
18905;Žiburėlis;DRUGELIAI;4109288891;Taip;0;4;7;11
18906;Žiburėlis;DRUGELIAI;1015624216;Taip;5;3;0;8
18907;Žiburėlis;DRUGELIAI;9526477121;Taip;5;4;0;9
18908;Žiburėlis;DRUGELIAI;4387021429;Taip;0;6;0;6
18909;Žiburėlis;DRUGELIAI;8018718405;Taip;0;4;0;4
18910;Žiburėlis;DRUGELIAI;4910787530;Taip;0;6;0;6
18911;Žiburėlis;DRUGELIAI;5324852807;Ne;1;5;0;6
18912;Žiburėlis;DRUGELIAI;4916545915;Taip;0;6;0;6
18913;Žiburėlis;DRUGELIAI;8133371774;Taip;0;13;0;13
18914;Žiburėlis;DRUGELIAI;7278242428;Taip;5;3;1;9
18915;Žiburėlis;DRUGELIAI;5732540560;Ne;0;6;0;6
18916;Žiburėlis;DRUGELIAI;1833704617;Ne;3;4;0;7
18917;Žiburėlis;DRUGELIAI;1228806324;Taip;0;5;0;5
18918;Žiburėlis;DRUGELIAI;2163018032;Taip;1;10;0;11
18919;Žiburėlis;DRUGELIAI;4581800760;Taip;2;3;0;5
18920;Žiburėlis;DRUGELIAI;8493950205;Taip;0;3;0;3
18921;Justinukas;SKRUZDĖLIUKAI;3068758593;Taip;5;0;0;5
18922;Bangelė;Aštuonkojai;6026399355;Taip;8;0;2;10
18923;Bangelė;Aštuonkojai;5476753511;Taip;0;3;1;4
18924;Bangelė;Aštuonkojai;9168310196;Taip;3;3;0;6
18925;Bangelė;Aštuonkojai;1351714626;Taip;0;4;1;5
18926;Bangelė;Aštuonkojai;1754002501;Taip;0;0;8;8
18927;Bangelė;Aštuonkojai;8875703109;Taip;0;4;0;4
18928;Bangelė;Aštuonkojai;6953698592;Ne;0;1;0;1
18929;Bangelė;Aštuonkojai;3063439996;Taip;11;1;0;12
18930;Bangelė;Aštuonkojai;2156837975;Taip;5;0;5;10
18931;Bangelė;Aštuonkojai;9143945953;Taip;8;3;0;11
18932;Bangelė;Aštuonkojai;3022508446;Taip;4;3;1;8
18933;Bangelė;Aštuonkojai;5546256869;Taip;0;0;1;1
18934;Bangelė;Aštuonkojai;6980232224;Ne;2;1;0;3
18935;Bangelė;Aštuonkojai;6145050734;Taip;5;2;0;7
18936;Bangelė;Aštuonkojai;1390623903;Taip;0;5;0;5
18937;Bangelė;Aštuonkojai;9788923823;Taip;9;7;2;18
18938;Bangelė;Aštuonkojai;7136625230;Taip;0;3;0;3
18939;Bangelė;Aštuonkojai;2491928697;Taip;0;3;0;3
18940;Bangelė;Aštuonkojai;6216334243;Taip;0;1;0;1
18941;Bangelė;Delfinukai,;3471355267;Taip;0;4;0;4
18942;Bangelė;Delfinukai,;7107685761;Taip;7;1;0;8
18943;Bangelė;Delfinukai,;6978215876;Taip;5;0;6;11
18944;Bangelė;Delfinukai,;7434358474;Taip;0;14;1;15
18945;Bangelė;Delfinukai,;2575806242;Taip;0;1;4;5
18946;Bangelė;Delfinukai,;9801978617;Taip;0;3;1;4
18947;Bangelė;Delfinukai,;7434879947;Taip;4;0;1;5
18948;Bangelė;Delfinukai,;5994720767;Taip;0;7;0;7
18949;Bangelė;Delfinukai,;4532810332;Taip;8;3;3;14
18950;Bangelė;Delfinukai,;8575020060;Taip;0;8;0;8
18951;Bangelė;Delfinukai,;4036461205;Taip;6;5;0;11
18952;Bangelė;Delfinukai,;3344441441;Taip;10;3;0;13
18953;Bangelė;Delfinukai,;2858929915;Taip;0;5;3;8
18954;Bangelė;Delfinukai,;7068305612;Taip;11;0;0;11
18955;Bangelė;Delfinukai,;4412780063;Taip;13;1;0;14
18956;Bangelė;Delfinukai,;9608900293;Taip;6;0;1;7
18957;Bangelė;Delfinukai,;4080993439;Taip;9;4;0;13
18958;Bangelė;"Saulės spindulėliai";55668308050;Taip;5;6;0;11
18959;Bangelė;"Saulės spindulėliai";9150185864;Taip;6;3;2;11
18960;Bangelė;"Saulės spindulėliai";2863118434;Ne;0;4;0;4
18961;Bangelė;"Saulės spindulėliai";9167286651;Taip;0;3;9;12
18962;Bangelė;"Saulės spindulėliai";43740476077;Taip;0;8;0;8
18963;Bangelė;"Saulės spindulėliai";9846780259;Ne;0;9;0;9
18964;Bangelė;"Saulės spindulėliai";1377734102;Taip;1;3;0;4
18965;Bangelė;"Saulės spindulėliai";5950451237;Taip;0;4;0;4
18966;Bangelė;"Saulės spindulėliai";9488932192;Taip;6;7;0;13
18967;Bangelė;"Saulės spindulėliai";1728085772;Ne;0;1;0;1
18968;Bangelė;"Saulės spindulėliai";1447396084;Taip;0;2;1;3
18969;Bangelė;"Saulės spindulėliai";6173470021;Taip;0;2;1;3
18970;Bangelė;"Saulės spindulėliai";6927540308;Taip;0;3;2;5
18971;Bangelė;"Saulės spindulėliai";9464115339;Taip;0;4;0;4
18972;Bangelė;"Saulės spindulėliai";4401389067;Taip;0;7;0;7
18973;Bangelė;"Saulės spindulėliai";3338203753;Taip;0;6;0;6
18974;Bangelė;"Saulės spindulėliai";3206495858;Taip;0;2;0;2
18975;Bangelė;"Saulės spindulėliai";7861208185;Taip;0;2;0;2
18976;Bangelė;"Saulės spindulėliai";2027892816;Taip;5;2;0;7
18977;Bangelė;"Saulės spindulėliai";2503946448;Taip;5;4;0;9
18978;Bangelė;"Saulės spindulėliai";2872188915;Taip;0;3;3;6
18979;Bangelė;"Saulės spindulėliai";3132827429;Taip;0;3;0;3
18980;Bangelė;"Pingvinukai ";2518820268;Ne;5;0;0;5
18981;Bangelė;"Pingvinukai ";9980881014;Taip;0;8;0;8
18982;Bangelė;"Pingvinukai ";4317054990;Taip;3;3;0;6
18983;Bangelė;"Pingvinukai ";8943721679;Taip;6;0;0;6
18984;Bangelė;"Pingvinukai ";6566277472;Taip;0;0;7;7
18985;Bangelė;"Pingvinukai ";7362196984;Ne;10;0;1;11
18986;Bangelė;"Pingvinukai ";4712616315;Taip;10;0;0;10
18987;Bangelė;"Pingvinukai ";4940247006;Taip;18;0;0;18
18988;Bangelė;"Pingvinukai ";8335931279;Taip;18;0;0;18
18989;Bangelė;"Pingvinukai ";9311379746;Taip;18;0;0;18
18990;Bangelė;"Pingvinukai ";9955097720;Taip;10;1;0;11
18991;Bangelė;"Pingvinukai ";4851593235;Taip;8;0;4;12
18992;Bangelė;"Pingvinukai ";8998648968;Taip;6;0;1;7
18993;Bangelė;"Pingvinukai ";7016039389;Taip;7;3;0;10
18994;Bangelė;"Pingvinukai ";2127734178;Taip;3;5;0;8
18995;Bangelė;"Pingvinukai ";2107766301;Taip;10;0;0;10
18996;Bangelė;"Pingvinukai ";5237434283;Taip;14;0;0;14
18997;Bangelė;"Pingvinukai ";4651237403;Taip;20;0;0;20
18998;Bangelė;"Pingvinukai ";8661284187;Taip;5;0;2;7
18999;Bangelė;"Pingvinukai ";1541525635;Taip;0;3;1;4
19000;Bangelė;"Jūros žvaigždutės ";5673493708;Taip;5;5;0;10
19001;Bangelė;"Jūros žvaigždutės ";9447145378;Taip;0;3;0;3
19002;Bangelė;"Jūros žvaigždutės ";4086446380;Taip;0;5;0;5
19003;Bangelė;"Jūros žvaigždutės ";8745595583;Taip;12;0;0;12
19004;Bangelė;"Jūros žvaigždutės ";5229147553;Taip;11;0;0;11
19005;Bangelė;"Jūros žvaigždutės ";4831656996;Taip;0;0;3;3
19006;Bangelė;"Jūros žvaigždutės ";9267349375;Taip;8;6;0;14
19007;Bangelė;"Jūros žvaigždutės ";3069288815;Taip;3;0;2;5
19008;Bangelė;"Jūros žvaigždutės ";9729929020;Taip;3;0;1;4
19009;Bangelė;"Jūros žvaigždutės ";8563674709;Taip;0;2;0;2
19010;Bangelė;"Jūros žvaigždutės ";3946690047;Taip;0;0;1;1
19011;Bangelė;"Jūros žvaigždutės ";6705583340;Taip;0;0;5;5
19012;Bangelė;"Jūros žvaigždutės ";1544311819;Ne;0;2;0;2
19013;Bangelė;"Jūros žvaigždutės ";2662758502;Taip;14;0;0;14
19014;Bangelė;"Jūros žvaigždutės ";6174617493;Taip;0;0;6;6
19015;Bangelė;"Jūros žvaigždutės ";9633372201;Ne;0;9;0;9
19016;Bangelė;"Jūros žvaigždutės ";8075810032;Taip;0;5;0;5
19017;Bangelė;"Jūros žvaigždutės ";3500097405;Taip;18;0;0;18
19018;Bangelė;Žuvytės;9009809585;Ne;1;6;0;7
19019;Bangelė;Žuvytės;6496580354;Taip;10;0;6;16
19020;Bangelė;Žuvytės;6480681705;Taip;0;2;0;2
19021;Bangelė;Žuvytės;7142694888;Ne;0;0;6;6
19022;Bangelė;Žuvytės;8734511431;Taip;0;3;0;3
19023;Bangelė;Žuvytės;1895213200;Taip;0;0;2;2
19024;Bangelė;Žuvytės;9765268154;Taip;0;13;0;13
19025;Bangelė;Žuvytės;8495423628;Taip;18;0;0;18
19026;Bangelė;Žuvytės;7419016784;Ne;7;4;0;11
19027;Bangelė;Žuvytės;5190563034;Taip;7;0;3;10
19028;Bangelė;Žuvytės;3991021350;Ne;6;3;0;9
19029;Bangelė;Žuvytės;9954762483;Taip;5;6;0;11
19030;Bangelė;Žuvytės;9493465898;Ne;7;2;0;9
19031;Bangelė;Žuvytės;5597329949;Taip;0;6;0;6
19032;Bangelė;Žuvytės;2134225414;Taip;5;0;1;6
19033;Bangelė;Žuvytės;4494049529;Taip;0;4;3;7
19034;Bangelė;Žuvytės;3334029244;Taip;2;4;0;6
19035;Bangelė;Žuvytės;6165322599;Taip;0;9;0;9
19036;Bangelė;Žuvytės;1898671487;Taip;5;3;0;8
19037;Bangelė;Žuvytės;7174742281;Taip;18;0;0;18
19038;Bangelė;Žuvytės;6806911810;Taip;20;0;3;23
19039;Bangelė;Ruoniai;8149880453;Taip;0;7;0;7
19040;Bangelė;Ruoniai;8836861853;Taip;0;2;0;2
19041;Bangelė;Ruoniai;4571869439;Taip;0;3;0;3
19042;Bangelė;Ruoniai;9672505885;Taip;0;3;2;5
19043;Bangelė;Ruoniai;2017886238;Taip;0;2;0;2
19044;Bangelė;Ruoniai;8990701154;Taip;12;0;3;15
19045;Bangelė;Ruoniai;6861123988;Taip;8;0;0;8
19046;Bangelė;Ruoniai;7233139048;Taip;5;3;0;8
19047;Bangelė;Ruoniai;6044653707;Taip;0;6;0;6
19048;Bangelė;Ruoniai;1915827035;Taip;0;6;0;6
19049;Bangelė;Ruoniai;9041585534;Taip;0;1;0;1
19050;Bangelė;Ruoniai;9706351115;Taip;0;2;0;2
19051;Bangelė;Ruoniai;2764009011;Taip;6;0;0;6
19052;Bangelė;Ruoniai;4338067260;Taip;0;0;10;10
19053;Bangelė;Ruoniai;8758933649;Taip;1;3;3;7
19054;Bangelė;Ruoniai;3900236858;Taip;0;4;0;4
19055;Bangelė;Ruoniai;7230987338;Taip;0;3;0;3
19056;Bangelė;Ruoniai;7337449523;Taip;0;0;3;3
19057;Bangelė;Ruoniai;1528387105;Taip;0;4;0;4
19058;Bangelė;Ruoniai;6712145066;Taip;5;1;5;11
19059;Bangelė;"Pagrandukai ";9561221619;Taip;6;5;0;11
19060;Bangelė;"Pagrandukai ";9128326823;Taip;3;4;2;9
19061;Bangelė;"Pagrandukai ";6415607960;Taip;7;0;2;9
19062;Bangelė;"Pagrandukai ";1182624046;Taip;0;3;0;3
19063;Bangelė;"Pagrandukai ";9355348960;Taip;0;0;5;5
19064;Bangelė;"Pagrandukai ";1467390411;Taip;8;0;0;8
19065;Bangelė;"Pagrandukai ";2730545639;Taip;12;2;0;14
19066;Bangelė;"Pagrandukai ";4041276015;Taip;5;0;1;6
19067;Bangelė;"Pagrandukai ";7503518328;Taip;2;1;1;4
19068;Bangelė;"Pagrandukai ";9010238689;Taip;4;9;0;13
19069;Bangelė;"Pagrandukai ";5829865386;Taip;18;0;0;18
19070;Bangelė;"Zuikučiai ";9705672732;Taip;0;5;0;5
19071;Bangelė;"Zuikučiai ";7364368699;Taip;0;3;0;3
19072;Bangelė;"Zuikučiai ";6400785821;Taip;0;5;0;5
19073;Bangelė;"Zuikučiai ";5961647252;Taip;8;0;2;10
19074;Bangelė;"Zuikučiai ";8493650050;Taip;18;0;0;18
19075;Bangelė;"Zuikučiai ";3851738513;Taip;0;3;0;3
19076;Bangelė;"Zuikučiai ";3452984649;Taip;18;0;0;18
19077;Bangelė;"Zuikučiai ";2362345363;Taip;5;0;2;7
19078;Bangelė;"Zuikučiai ";4891131242;Taip;18;0;0;18
19079;Bangelė;"Zuikučiai ";7445583512;Ne;6;3;0;9
19080;Bangelė;"Zuikučiai ";8931569423;Ne;12;0;0;12
19081;Bangelė;"Zuikučiai ";2382714949;Ne;10;0;3;13
19082;Bangelė;"Zuikučiai ";7755966282;Taip;0;1;3;4
19083;Bangelė;"Zuikučiai ";4480762963;Taip;0;3;0;3
19084;Bangelė;"Zuikučiai ";8765892966;Taip;8;4;0;12
19085;Bangelė;Vėžliukai;9142460659;Taip;13;0;1;14
19086;Bangelė;Vėžliukai;7862345122;Taip;0;0;8;8
19087;Bangelė;Vėžliukai;1869389013;Taip;18;0;0;18
19088;Bangelė;Vėžliukai;2630571748;Taip;0;4;0;4
19089;Bangelė;Vėžliukai;6003859569;Taip;6;10;1;17
19090;Bangelė;Vėžliukai;3978683237;Taip;0;2;0;2
19091;Bangelė;Vėžliukai;5779198855;Taip;0;5;0;5
19092;Bangelė;Vėžliukai;5746189515;Ne;5;0;0;5
19093;Bangelė;Vėžliukai;6312356331;Taip;13;1;0;14
19094;Bangelė;Vėžliukai;8454369872;Taip;0;3;1;4
19095;Gėlynas;PAKALNUTĖ;4557380282;Taip;0;4;0;4
19096;Gėlynas;PAKALNUTĖ;6884111634;Taip;7;1;3;11
19097;Gėlynas;PAKALNUTĖ;1548317086;Taip;5;0;0;5
19098;Gėlynas;PAKALNUTĖ;3470963396;Taip;0;12;0;12
19099;Gėlynas;PAKALNUTĖ;6053841081;Taip;0;3;0;3
19100;Gėlynas;PAKALNUTĖ;2171064300;Taip;9;0;0;9
19101;Gėlynas;PAKALNUTĖ;2404562144;Taip;0;2;0;2
19102;Gėlynas;PAKALNUTĖ;7504469409;Taip;4;2;0;6
19103;Gėlynas;PAKALNUTĖ;8693415786;Taip;0;1;0;1
19104;Gėlynas;PAKALNUTĖ;4366442459;Taip;5;3;0;8
19105;Gėlynas;PAKALNUTĖ;1463783538;Taip;0;0;3;3
19106;Gėlynas;PAKALNUTĖ;7064068912;Taip;0;11;0;11
19107;Gėlynas;PAKALNUTĖ;1822933936;Taip;4;1;0;5
19108;Gėlynas;PAKALNUTĖ;4668195919;Taip;0;3;0;3
19109;Gėlynas;PAKALNUTĖ;8555408466;Taip;3;7;0;10
19110;Gėlynas;PAKALNUTĖ;2377323648;Taip;0;1;0;1
19111;Gėlynas;PAKALNUTĖ;5382148888;Taip;9;3;0;12
19112;Gėlynas;PAKALNUTĖ;6296728638;Taip;0;5;0;5
19113;Gėlynas;PAKALNUTĖ;2273705177;Taip;0;10;0;10
19114;Gėlynas;PAKALNUTĖ;2520140743;Taip;0;0;3;3
19115;Gėlynas;VARPELIS;2769668641;Taip;5;3;0;8
19116;Gėlynas;VARPELIS;1004866224;Taip;3;11;1;15
19117;Gėlynas;VARPELIS;2417880374;Taip;6;3;0;9
19118;Gėlynas;VARPELIS;4382465307;Taip;0;6;0;6
19119;Gėlynas;VARPELIS;5135747448;Taip;0;3;0;3
19120;Gėlynas;VARPELIS;1754734306;Taip;0;3;0;3
19121;Gėlynas;VARPELIS;1774829898;Taip;3;1;0;4
19122;Gėlynas;VARPELIS;7562201835;Taip;0;3;1;4
19123;Gėlynas;VARPELIS;4445250490;Taip;2;3;0;5
19124;Gėlynas;VARPELIS;2132298690;Taip;10;2;0;12
19125;Gėlynas;VARPELIS;8464074679;Taip;0;3;2;5
19126;Gėlynas;VARPELIS;9911225363;Taip;4;3;1;8
19127;Gėlynas;VARPELIS;5395474698;Ne;0;12;0;12
19128;Gėlynas;VARPELIS;1257113113;Taip;4;2;1;7
19129;Gėlynas;VARPELIS;6898127005;Taip;4;3;0;7
19130;Gėlynas;VARPELIS;3365442661;Taip;5;3;3;11
19131;Gėlynas;VARPELIS;5145396320;Taip;0;10;0;10
19132;Gėlynas;VARPELIS;90046802421;Taip;4;0;0;4
19133;Gėlynas;VARPELIS;7814357385;Taip;0;3;0;3
19134;Gėlynas;VARPELIS;1674569569;Taip;3;4;0;7
19135;Gėlynas;VARPELIS;1036951275;Taip;0;3;2;5
19136;Gėlynas;VARPELIS;7808971151;Taip;3;3;3;9
19137;Gėlynas;VARPELIS;4916885450;Taip;10;3;0;13
19138;Gėlynas;RAKTAŽOLĖ;3572020585;Taip;0;2;0;2
19139;Gėlynas;RAKTAŽOLĖ;5634213306;Taip;3;3;0;6
19140;Gėlynas;RAKTAŽOLĖ;3491517766;Taip;0;4;0;4
19141;Gėlynas;RAKTAŽOLĖ;4505012978;Taip;5;5;0;10
19142;Gėlynas;RAKTAŽOLĖ;5541707540;Taip;5;1;0;6
19143;Gėlynas;RAKTAŽOLĖ;5124029118;Taip;8;3;0;11
19144;Gėlynas;RAKTAŽOLĖ;9508507084;Taip;0;5;0;5
19145;Gėlynas;RAKTAŽOLĖ;8999346908;Taip;0;5;0;5
19146;Gėlynas;RAKTAŽOLĖ;8458276300;Taip;0;1;0;1
19147;Gėlynas;RAKTAŽOLĖ;9382160515;Ne;0;1;0;1
19148;Gėlynas;RAKTAŽOLĖ;7730322729;Taip;0;10;0;10
19149;Gėlynas;RAKTAŽOLĖ;2348787949;Taip;0;3;0;3
19150;Gėlynas;RAKTAŽOLĖ;6528464599;Taip;0;3;0;3
19151;Gėlynas;RAKTAŽOLĖ;8615943743;Taip;0;6;0;6
19152;Gėlynas;RAKTAŽOLĖ;7389502638;Taip;10;3;0;13
19153;Gėlynas;RAKTAŽOLĖ;1590299264;Taip;0;8;0;8
19154;Gėlynas;RAKTAŽOLĖ;5751256561;Taip;8;3;0;11
19155;Gėlynas;RAKTAŽOLĖ;8080660097;Taip;5;3;0;8
19156;Gėlynas;RAKTAŽOLĖ;1015554617;Taip;0;3;0;3
19157;Gėlynas;RAKTAŽOLĖ;6875794958;Taip;6;2;0;8
19158;Gėlynas;RAKTAŽOLĖ;8444505017;Taip;10;3;0;13
19159;Gėlynas;RAKTAŽOLĖ;5695333666;Taip;0;8;0;8
19160;Gėlynas;SAULĖGRĄŽA;7150367866;Taip;0;0;3;3
19161;Gėlynas;SAULĖGRĄŽA;5898582218;Taip;0;4;0;4
19162;Gėlynas;SAULĖGRĄŽA;1505666690;Taip;1;7;2;10
19163;Gėlynas;SAULĖGRĄŽA;3492361041;Taip;0;3;0;3
19164;Gėlynas;SAULĖGRĄŽA;6451922757;Taip;5;0;2;7
19165;Gėlynas;SAULĖGRĄŽA;2141722631;Taip;0;3;0;3
19166;Gėlynas;SAULĖGRĄŽA;2742456983;Taip;0;3;1;4
19167;Gėlynas;SAULĖGRĄŽA;4983822000;Taip;0;0;3;3
19168;Gėlynas;SAULĖGRĄŽA;3549079170;Taip;0;6;0;6
19169;Gėlynas;SAULĖGRĄŽA;9305282699;Taip;0;3;0;3
19170;Gėlynas;SAULĖGRĄŽA;6815740588;Taip;5;3;0;8
19171;Gėlynas;SAULĖGRĄŽA;3606076029;Taip;0;8;0;8
19172;Gėlynas;SAULĖGRĄŽA;5964419627;Taip;0;0;2;2
19173;Gėlynas;SAULĖGRĄŽA;4824667762;Taip;0;3;0;3
19174;Gėlynas;SAULĖGRĄŽA;9330385153;Taip;6;3;0;9
19175;Gėlynas;SAULĖGRĄŽA;9724668402;Taip;0;3;0;3
19176;Gėlynas;SAULĖGRĄŽA;9462822190;Taip;1;1;0;2
19177;Gėlynas;SAULĖGRĄŽA;2784709117;Taip;0;0;5;5
19178;Gėlynas;SAULĖGRĄŽA;6114995335;Taip;6;3;0;9
19179;Gėlynas;SAULĖGRĄŽA;5291444399;Taip;0;0;2;2
19180;Gėlynas;SAULĖGRĄŽA;5320531856;Taip;0;1;0;1
19181;Gėlynas;SAULĖGRĄŽA;7998013477;Taip;4;3;2;9
19182;Gėlynas;SAULĖGRĄŽA;6244314445;Taip;11;0;0;11
19183;Gėlynas;RAMUNĖLĖ;1665668966;Taip;5;0;3;8
19184;Gėlynas;RAMUNĖLĖ;9707677931;Taip;8;0;0;8
19185;Gėlynas;RAMUNĖLĖ;1235384604;Taip;0;11;0;11
19186;Gėlynas;RAMUNĖLĖ;9230984365;Taip;3;0;3;6
19187;Gėlynas;RAMUNĖLĖ;5813156578;Taip;11;3;0;14
19188;Gėlynas;RAMUNĖLĖ;6221721945;Taip;3;0;5;8
19189;Gėlynas;RAMUNĖLĖ;7005278902;Taip;0;0;6;6
19190;Gėlynas;RAMUNĖLĖ;1468588114;Taip;0;9;0;9
19191;Gėlynas;RAMUNĖLĖ;6790040590;Taip;0;0;3;3
19192;Gėlynas;RAMUNĖLĖ;4854709904;Taip;0;5;0;5
19193;Gėlynas;RAMUNĖLĖ;2434552926;Taip;2;0;4;6
19194;Gėlynas;RAMUNĖLĖ;1570975863;Taip;2;0;3;5
19195;Gėlynas;RAMUNĖLĖ;8550986498;Taip;6;0;0;6
19196;Gėlynas;RAMUNĖLĖ;6342888072;Taip;3;8;0;11
19197;Gėlynas;RAMUNĖLĖ;9973824348;Taip;0;0;10;10
19198;Gėlynas;RAMUNĖLĖ;1681208354;Taip;0;0;8;8
19199;Gėlynas;ŽIBUTĖ;4192292896;Taip;0;9;0;9
19200;Gėlynas;ŽIBUTĖ;6826311903;Taip;0;12;0;12
19201;Gėlynas;ŽIBUTĖ;8447789767;Taip;0;10;0;10
19202;Gėlynas;ŽIBUTĖ;1862266440;Taip;1;0;5;6
19203;Gėlynas;ŽIBUTĖ;3746597878;Taip;0;5;0;5
19204;Gėlynas;ŽIBUTĖ;9182072776;Taip;5;3;2;10
19205;Gėlynas;ŽIBUTĖ;4292724541;Taip;1;3;0;4
19206;Gėlynas;ŽIBUTĖ;7988094745;Taip;0;0;3;3
19207;Gėlynas;ŽIBUTĖ;9552677108;Taip;1;6;0;7
19208;Gėlynas;ŽIBUTĖ;2608369575;Taip;1;6;0;7
19209;Gėlynas;ŽIBUTĖ;1949260962;Taip;0;3;0;3
19210;Gėlynas;ŽIBUTĖ;6635004996;Taip;0;3;0;3
19211;Gėlynas;ŽIBUTĖ;1556683639;Taip;1;2;0;3
19212;Gėlynas;ŽIBUTĖ;5942466822;Taip;8;0;3;11
19213;Gėlynas;ŽIBUTĖ;2193861056;Taip;0;0;2;2
19214;Gėlynas;ŽIBUTĖ;8743722205;Taip;5;0;0;5
19215;Gėlynas;ŽIBUTĖ;2790269385;Taip;0;3;2;5
19216;Gėlynas;ŽIBUTĖ;2885148633;Taip;5;0;0;5
19217;Obelėlė;Gudručiai;2014314139;Ne;5;0;0;5
19218;Obelėlė;Gudručiai;9900484892;Taip;6;3;2;11
19219;Obelėlė;Gudručiai;6145113624;Taip;0;3;0;3
19220;Obelėlė;Gudručiai;9586720282;Taip;0;3;3;6
19221;Obelėlė;Gudručiai;9567704282;Taip;9;0;0;9
19222;Obelėlė;Gudručiai;4015702815;Taip;0;8;0;8
19223;Obelėlė;Gudručiai;4309139638;Taip;0;0;1;1
19224;Obelėlė;Gudručiai;5141585309;Taip;5;3;0;8
19225;Obelėlė;Gudručiai;9736557012;Taip;0;4;2;6
19226;Obelėlė;Gudručiai;6720058972;Taip;0;4;0;4
19227;Obelėlė;Gudručiai;4451814487;Taip;0;0;1;1
19228;Obelėlė;Gudručiai;2053807216;Taip;18;0;0;18
19229;Obelėlė;Gudručiai;2204293216;Ne;0;18;0;18
19230;Obelėlė;Gudručiai;1184082097;Taip;11;5;0;16
19231;Obelėlė;Gudručiai;2533715287;Taip;0;3;0;3
19232;Obelėlė;Gudručiai;1312484983;Taip;12;0;2;14
19233;Obelėlė;Gudručiai;1565630870;Taip;0;8;0;8
19234;Obelėlė;Gudručiai;1598785483;Taip;0;3;0;3
19235;Obelėlė;Pasakaitė;1695933896;Ne;0;3;4;7
19236;Obelėlė;Pasakaitė;1555780072;Taip;2;8;0;10
19237;Obelėlė;Pasakaitė;77743243622;Taip;0;3;0;3
19238;Obelėlė;Pasakaitė;1543298097;Taip;0;1;0;1
19239;Obelėlė;Pasakaitė;79601449969;Taip;10;1;0;11
19240;Obelėlė;Pasakaitė;3330983614;Taip;3;3;1;7
19241;Obelėlė;Pasakaitė;4257479486;Taip;0;3;0;3
19242;Obelėlė;Pasakaitė;8394566707;Taip;0;3;0;3
19243;Obelėlė;Pasakaitė;9527363918;Taip;0;3;0;3
19244;Obelėlė;Pasakaitė;10939948244;Taip;0;2;0;2
19245;Obelėlė;Pasakaitė;1707652145;Taip;0;3;0;3
19246;Obelėlė;Pasakaitė;1141707374;Taip;0;2;1;3
19247;Obelėlė;Pasakaitė;6789881144;Taip;2;3;0;5
19248;Obelėlė;Pasakaitė;6036130112;Taip;0;2;0;2
19249;Obelėlė;Pasakaitė;1893470952;Taip;0;3;12;15
19250;Obelėlė;Pasakaitė;7754276632;Taip;0;18;0;18
19251;Obelėlė;Pasakaitė;69055416041;Taip;6;3;1;10
19252;Obelėlė;Pasakaitė;3517342646;Taip;2;2;3;7
19253;Obelėlė;Pasakaitė;4220808775;Taip;0;3;0;3
19254;Obelėlė;Pasakaitė;1507072248;Taip;0;3;0;3
19255;Obelėlė;Pasakaitė;7934760271;Taip;0;3;5;8
19256;Obelėlė;Svajokliai;9981446556;Taip;3;3;1;7
19257;Obelėlė;Svajokliai;4849499826;Taip;5;0;0;5
19258;Obelėlė;Svajokliai;1469593267;Taip;0;3;7;10
19259;Obelėlė;Svajokliai;9819048265;Taip;7;0;2;9
19260;Obelėlė;Svajokliai;1010954005;Taip;7;0;0;7
19261;Obelėlė;Svajokliai;4489212434;Taip;4;0;4;8
19262;Obelėlė;Svajokliai;5620250331;Taip;4;0;0;4
19263;Obelėlė;Svajokliai;5588467580;Taip;6;3;7;16
19264;Obelėlė;Svajokliai;7094715237;Taip;13;0;0;13
19265;Obelėlė;Svajokliai;9070960601;Taip;6;0;0;6
19266;Obelėlė;Svajokliai;8231489868;Taip;10;0;0;10
19267;Obelėlė;Svajokliai;3986892111;Taip;0;3;0;3
19268;Obelėlė;Svajokliai;7003947655;Taip;0;2;3;5
19269;Obelėlė;Svajokliai;9641297002;Taip;0;3;0;3
19270;Obelėlė;Svajokliai;8918176312;Taip;0;3;2;5
19271;Obelėlė;Svajokliai;8604451971;Taip;3;0;2;5
19272;Obelėlė;Svajokliai;7794072582;Taip;6;0;1;7
19273;Obelėlė;Svajokliai;6785654280;Taip;0;0;3;3
19274;Obelėlė;Svajokliai;6311322617;Taip;9;3;0;12
19275;Obelėlė;Svajokliai;2813927086;Taip;0;3;2;5
19276;Obelėlė;Smalsučiai;6497584911;Taip;0;2;5;7
19277;Obelėlė;Smalsučiai;7687093936;Taip;12;0;0;12
19278;Obelėlė;Smalsučiai;1469375976;Taip;6;0;3;9
19279;Obelėlė;Smalsučiai;7108517080;Taip;5;0;3;8
19280;Obelėlė;Smalsučiai;6020342761;Taip;0;0;1;1
19281;Obelėlė;Smalsučiai;4987747783;Taip;0;0;4;4
19282;Obelėlė;Smalsučiai;5085970254;Taip;0;0;2;2
19283;Obelėlė;Smalsučiai;8709758561;Taip;11;0;0;11
19284;Obelėlė;Smalsučiai;4318546408;Taip;8;1;0;9
19285;Obelėlė;Smalsučiai;5739522736;Taip;0;3;2;5
19286;Obelėlė;Smalsučiai;2631405243;Taip;0;8;3;11
19287;Obelėlė;Smalsučiai;8173307704;Taip;5;0;5;10
19288;Obelėlė;Smalsučiai;9796759067;Taip;10;3;0;13
19289;Obelėlė;Smalsučiai;6720808705;Taip;4;3;1;8
19290;Obelėlė;Smalsučiai;7850656031;Taip;7;0;0;7
19291;Obelėlė;Smalsučiai;9084969712;Taip;0;0;4;4
19292;Obelėlė;Smalsučiai;6364101139;Taip;11;3;0;14
19293;Obelėlė;Smalsučiai;6064646690;Taip;5;3;5;13
19294;Obelėlė;Smalsučiai;8183287212;Taip;0;3;0;3
19295;Obelėlė;Smalsučiai;2574840626;Taip;16;2;0;18
19296;Obelėlė;Smalsučiai;8981403984;Taip;15;0;3;18
19297;Obelėlė;Pabiručiai;2035035265;Taip;0;0;3;3
19298;Obelėlė;Pabiručiai;5763713052;Taip;0;18;0;18
19299;Obelėlė;Pabiručiai;7667966704;Taip;0;0;1;1
19300;Obelėlė;Pabiručiai;1819480590;Taip;0;0;1;1
19301;Obelėlė;Pabiručiai;6946457363;Taip;6;0;3;9
19302;Obelėlė;Pabiručiai;8948297718;Taip;0;0;5;5
19303;Obelėlė;Pabiručiai;3951816174;Taip;3;0;2;5
19304;Obelėlė;Pabiručiai;5599466885;Taip;0;3;3;6
19305;Obelėlė;Pabiručiai;9634414572;Taip;0;0;8;8
19306;Obelėlė;Pabiručiai;2262107831;Taip;0;0;4;4
19307;Obelėlė;Pabiručiai;4851824672;Taip;0;0;8;8
19308;Obelėlė;Pabiručiai;3526079444;Ne;5;0;3;8
19309;Obelėlė;Pabiručiai;9731565368;Taip;9;8;0;17
19310;Obelėlė;Pabiručiai;8827515572;Taip;3;0;1;4
19311;Obelėlė;Pabiručiai;2399173200;Taip;0;0;3;3
19312;Obelėlė;Pabiručiai;9627134967;Taip;0;14;0;14
19313;Obelėlė;Pabiručiai;5368376431;Ne;0;0;5;5
19314;Obelėlė;Strakaliukai;1706102918;Taip;0;0;3;3
19315;Obelėlė;Strakaliukai;2770477678;Taip;0;3;0;3
19316;Obelėlė;Strakaliukai;8682794598;Taip;0;14;0;14
19317;Obelėlė;Strakaliukai;8754552660;Taip;0;0;4;4
19318;Obelėlė;Strakaliukai;8092024850;Taip;2;0;0;2
19319;Obelėlė;Strakaliukai;9716500560;Taip;2;3;0;5
19320;Obelėlė;Strakaliukai;4251418414;Taip;5;0;2;7
19321;Obelėlė;Strakaliukai;7128421330;Taip;0;5;3;8
19322;Obelėlė;Strakaliukai;5943314566;Taip;18;0;0;18
19323;Obelėlė;Strakaliukai;3116100694;Taip;10;1;0;11
19324;Obelėlė;Strakaliukai;5741823041;Taip;0;3;0;3
19325;Obelėlė;Strakaliukai;8050551266;Taip;5;3;0;8
19326;Obelėlė;Strakaliukai;7468335279;Taip;10;0;2;12
19327;Obelėlė;Strakaliukai;1180508643;Taip;0;8;0;8
19328;Obelėlė;Strakaliukai;7124393375;Taip;9;0;3;12
19329;Obelėlė;Strakaliukai;5001844064;Taip;5;3;0;8
19330;Obelėlė;Strakaliukai;9976694313;Taip;5;3;5;13
19331;Obelėlė;Saulutė;2772753891;Taip;7;0;2;9
19332;Obelėlė;Saulutė;8486560892;Taip;8;2;0;10
19333;Obelėlė;Saulutė;1858251094;Taip;0;0;9;9
19334;Obelėlė;Saulutė;2893378990;Taip;9;0;0;9
19335;Obelėlė;Saulutė;6874039388;Taip;0;0;5;5
19336;Obelėlė;Saulutė;7491934262;Taip;0;4;2;6
19337;Obelėlė;Saulutė;9043542844;Taip;0;0;4;4
19338;Obelėlė;Saulutė;4321210604;Taip;0;0;1;1
19339;Obelėlė;Saulutė;4209489251;Taip;0;0;4;4
19340;Obelėlė;Saulutė;4309622934;Taip;3;0;4;7
19341;Obelėlė;Saulutė;3590915973;Taip;0;0;3;3
19342;Obelėlė;Saulutė;6470533765;Taip;4;5;0;9
19343;Obelėlė;Saulutė;8223715886;Taip;4;5;0;9
19344;Obelėlė;Saulutė;8461505586;Taip;0;0;2;2
19345;Obelėlė;Saulutė;2730569223;Taip;0;0;11;11
19346;Obelėlė;Saulutė;4218895290;Taip;10;0;1;11
19347;Obelėlė;Saulutė;3460171136;Taip;6;0;1;7
19348;Obelėlė;Rieduliukai;9008900055;Taip;15;0;0;15
19349;Obelėlė;Rieduliukai;9332534001;Taip;15;0;0;15
19350;Obelėlė;Rieduliukai;2465101384;Ne;1;3;0;4
19351;Obelėlė;Rieduliukai;7403160073;Taip;0;0;7;7
19352;Obelėlė;Rieduliukai;2663004768;Taip;0;0;10;10
19353;Obelėlė;Rieduliukai;8060994250;Taip;18;0;0;18
19354;Obelėlė;Rieduliukai;1788880520;Taip;0;0;8;8
19355;Obelėlė;Rieduliukai;3452970142;Taip;0;3;1;4
19356;Obelėlė;Rieduliukai;4505857257;Taip;9;0;0;9
19357;Obelėlė;Rieduliukai;9995891955;Taip;7;0;0;7
19358;Obelėlė;Rieduliukai;4707488292;Taip;12;0;3;15
19359;Obelėlė;Rieduliukai;5617103957;Taip;16;0;0;16
19360;Obelėlė;Rieduliukai;3646359565;Taip;18;0;0;18
19361;Obelėlė;Rieduliukai;5366112771;Taip;3;1;2;6
19362;Obelėlė;Rieduliukai;6945301927;Taip;0;0;4;4
19363;Obelėlė;Rieduliukai;5603904852;Taip;0;0;5;5
19364;Obelėlė;Rieduliukai;2031637374;Taip;8;0;5;13
19365;Obelėlė;Rieduliukai;4678269928;Taip;0;0;4;4
19366;Obelėlė;Žirniukai;5209482838;Taip;18;0;0;18
19367;Obelėlė;Žirniukai;8422696011;Taip;0;3;1;4
19368;Obelėlė;Žirniukai;5503843905;Ne;5;3;4;12
19369;Obelėlė;Žirniukai;6133596410;Taip;12;0;1;13
19370;Obelėlė;Žirniukai;2702773541;Taip;7;0;2;9
19371;Obelėlė;Žirniukai;2769784741;Taip;0;0;3;3
19372;Obelėlė;Žirniukai;8982197866;Taip;0;0;5;5
19373;Obelėlė;Žirniukai;1222183008;Taip;0;0;1;1
19374;Obelėlė;Žirniukai;7813350634;Taip;0;0;4;4
19375;Obelėlė;Žirniukai;3568124213;Taip;11;0;0;11
19376;Obelėlė;Žirniukai;5478392319;Taip;2;3;0;5
19377;Obelėlė;Žirniukai;4223995429;Taip;3;3;0;6
19378;Obelėlė;Žirniukai;5073364608;Taip;10;0;3;13
19379;Obelėlė;Žirniukai;3287262204;Taip;1;3;3;7
19380;Obelėlė;Žirniukai;9005520809;Taip;5;0;3;8
19381;Obelėlė;Žirniukai;5192989376;Taip;18;0;0;18
19382;Obelėlė;Žirniukai;1799603610;Taip;18;0;0;18
19383;Obelėlė;Bičiuliai;3425736276;Taip;0;4;0;4
19384;Obelėlė;Bičiuliai;5776116844;Taip;0;4;3;7
19385;Obelėlė;Bičiuliai;8487088625;Taip;0;2;3;5
19386;Obelėlė;Bičiuliai;1630067014;Taip;0;0;3;3
19387;Obelėlė;Bičiuliai;1537769810;Taip;0;0;3;3
19388;Obelėlė;Bičiuliai;8371648703;Taip;1;0;1;2
19389;Obelėlė;Bičiuliai;2329734472;Taip;3;0;1;4
19390;Obelėlė;Bičiuliai;1419189517;Taip;3;0;0;3
19391;Obelėlė;Bičiuliai;8155712451;Taip;0;3;1;4
19392;Obelėlė;Bičiuliai;4849175527;Ne;5;3;0;8
19393;Obelėlė;Bičiuliai;1362135757;Taip;4;3;0;7
19394;Obelėlė;Bičiuliai;3769993089;Taip;0;0;1;1
19395;Obelėlė;Bičiuliai;5374979248;Taip;0;0;2;2
19396;Obelėlė;Bičiuliai;2170134084;Taip;0;3;0;3
19397;Obelėlė;Bičiuliai;1909459236;Taip;0;3;0;3
19398;Obelėlė;Bičiuliai;8757731600;Taip;6;0;2;8
19399;Obelėlė;Kodėlčiukai;9960526051;Taip;5;0;3;8
19400;Obelėlė;Kodėlčiukai;1050919659;Taip;0;3;0;3
19401;Obelėlė;Kodėlčiukai;7014872044;Taip;0;0;1;1
19402;Obelėlė;Kodėlčiukai;3028107343;Taip;13;3;0;16
19403;Obelėlė;Kodėlčiukai;4840134079;Taip;0;0;1;1
19404;Obelėlė;Kodėlčiukai;8762518354;Taip;5;0;1;6
19405;Obelėlė;Kodėlčiukai;3320493372;Taip;0;10;8;18
19406;Obelėlė;Kodėlčiukai;8366162313;Taip;3;3;0;6
19407;Obelėlė;Kodėlčiukai;7901070568;Taip;0;0;1;1
19408;Obelėlė;Kodėlčiukai;2227383487;Taip;15;0;2;17
19409;Obelėlė;Kodėlčiukai;8818153952;Taip;6;0;1;7
19410;Obelėlė;Kodėlčiukai;4887103549;Taip;18;0;0;18
19411;Obelėlė;Kodėlčiukai;5221918341;Taip;8;0;4;12
19412;Obelėlė;Kodėlčiukai;3748406335;Taip;0;3;0;3
19413;Obelėlė;Kodėlčiukai;7696478568;Taip;0;0;3;3
19414;Obelėlė;Kodėlčiukai;7422668691;Ne;5;0;4;9
19415;Obelėlė;Kodėlčiukai;5233321854;Ne;3;0;1;4
19416;Obelėlė;Kodėlčiukai;1472630240;Taip;5;0;3;8
19417;Obelėlė;Pagrandukai;7934967787;Taip;21;0;0;21
19418;Obelėlė;Pagrandukai;4673426170;Taip;5;8;3;16
19419;Obelėlė;Pagrandukai;6436061438;Taip;8;0;0;8
19420;Obelėlė;Pagrandukai;8711370875;Taip;18;0;0;18
19421;Obelėlė;Pagrandukai;6938326798;Taip;0;18;0;18
19422;Obelėlė;Pagrandukai;9258651395;Taip;0;0;4;4
19423;Obelėlė;Pagrandukai;4974008654;Taip;0;18;0;18
19424;Obelėlė;Pagrandukai;3563701047;Taip;11;0;0;11
19425;Obelėlė;Pagrandukai;8664564820;Taip;0;0;6;6
19426;Obelėlė;Pagrandukai;9170515841;Taip;0;18;0;18
19427;Obelėlė;Pagrandukai;9514739912;Taip;0;0;5;5
19428;Obelėlė;Pagrandukai;8534759650;Ne;4;0;6;10
19429;Obelėlė;Pagrandukai;7368698046;Taip;10;0;0;10
19430;Obelėlė;Pagrandukai;3738932600;Taip;0;0;2;2
19431;Spygliukas;Bitutės;8272537768;Ne;0;2;0;2
19432;Spygliukas;Bitutės;9444569348;Taip;8;4;0;12
19433;Spygliukas;Bitutės;8404929784;Taip;0;3;0;3
19434;Spygliukas;Bitutės;4835818382;Taip;0;5;1;6
19435;Spygliukas;Bitutės;3041184642;Taip;0;3;2;5
19436;Spygliukas;Bitutės;9070219319;Taip;0;3;0;3
19437;Spygliukas;Bitutės;9413950200;Taip;9;3;0;12
19438;Spygliukas;Bitutės;1664878188;Taip;5;4;0;9
19439;Spygliukas;Bitutės;5134327772;Taip;0;1;3;4
19440;Spygliukas;Bitutės;8869320003;Taip;0;1;4;5
19441;Spygliukas;Bitutės;8476882854;Taip;0;8;0;8
19442;Spygliukas;Bitutės;1333556956;Ne;0;4;3;7
19443;Spygliukas;Bitutės;3761715811;Taip;0;3;0;3
19444;Spygliukas;Bitutės;8270525839;Taip;14;4;0;18
19445;Spygliukas;Bitutės;3697691132;Taip;8;1;0;9
19446;Spygliukas;Bitutės;1550737449;Taip;8;3;0;11
19447;Spygliukas;Bitutės;4053158210;Taip;0;2;0;2
19448;Spygliukas;Bitutės;2395961015;Taip;0;13;0;13
19449;Spygliukas;Bitutės;5180736358;Taip;9;0;2;11
19450;Spygliukas;Bitutės;9431217584;Taip;0;5;0;5
19451;Spygliukas;Kiškučiai;6195903792;Taip;0;0;3;3
19452;Spygliukas;Kiškučiai;1927028026;Taip;7;1;0;8
19453;Spygliukas;Kiškučiai;3094528907;Taip;8;1;1;10
19454;Spygliukas;Kiškučiai;8981549891;Taip;0;0;4;4
19455;Spygliukas;Kiškučiai;9813995933;Taip;0;10;0;10
19456;Spygliukas;Kiškučiai;4013601534;Taip;15;0;0;15
19457;Spygliukas;Kiškučiai;3959136555;Taip;10;0;0;10
19458;Spygliukas;Kiškučiai;6383264068;Taip;8;1;0;9
19459;Spygliukas;Kiškučiai;5369930705;Taip;5;3;1;9
19460;Spygliukas;Kiškučiai;6246925536;Taip;17;0;0;17
19461;Spygliukas;Kiškučiai;1037321774;Taip;0;4;1;5
19462;Spygliukas;Kiškučiai;5615854225;Taip;6;4;0;10
19463;Spygliukas;Kiškučiai;7261580644;Taip;0;6;0;6
19464;Spygliukas;Kiškučiai;7243104877;Taip;10;0;0;10
19465;Spygliukas;Kiškučiai;1436452804;Taip;17;1;2;20
19466;Spygliukas;Kiškučiai;1330384915;Taip;13;0;0;13
19467;Spygliukas;Kiškučiai;8299276429;Taip;11;0;0;11
19468;Spygliukas;Boružėlės;3569857813;Taip;0;0;4;4
19469;Spygliukas;Boružėlės;5493599614;Taip;3;0;3;6
19470;Spygliukas;Boružėlės;6931145017;Taip;12;0;0;12
19471;Spygliukas;Boružėlės;8802722601;Taip;0;11;0;11
19472;Spygliukas;Boružėlės;9285259322;Taip;0;6;0;6
19473;Spygliukas;Boružėlės;1341333016;Taip;18;0;0;18
19474;Spygliukas;Boružėlės;5561426508;Taip;10;0;0;10
19475;Spygliukas;Boružėlės;8806126755;Taip;0;4;0;4
19476;Spygliukas;Boružėlės;4477402331;Taip;0;0;1;1
19477;Spygliukas;Boružėlės;2772801133;Taip;0;3;0;3
19478;Spygliukas;Boružėlės;6332646009;Taip;5;3;0;8
19479;Spygliukas;Boružėlės;3706443395;Taip;0;3;0;3
19480;Spygliukas;Boružėlės;5765106914;Taip;0;1;7;8
19481;Spygliukas;Boružėlės;3416275094;Taip;10;0;4;14
19482;Spygliukas;Boružėlės;1401951658;Taip;0;1;0;1
19483;Spygliukas;Boružėlės;6248409896;Taip;0;4;1;5
19484;Spygliukas;Boružėlės;8708083787;Taip;5;7;0;12
19485;Spygliukas;Boružėlės;8825264090;Taip;0;0;8;8
19486;Spygliukas;Boružėlės;3919560072;Taip;0;0;2;2
19487;Spygliukas;Boružėlės;4577592862;Taip;3;5;0;8
19488;Spygliukas;Boružėlės;6835488489;Taip;8;1;0;9
19489;Spygliukas;Boružėlės;7900652746;Taip;0;4;0;4
19490;Spygliukas;Ežiukai;2164549239;Taip;0;0;4;4
19491;Spygliukas;Ežiukai;4340767624;Taip;3;0;6;9
19492;Spygliukas;Ežiukai;1983112873;Taip;3;1;0;4
19493;Spygliukas;Ežiukai;4615217628;Taip;5;3;0;8
19494;Spygliukas;Ežiukai;2184487073;Taip;2;1;0;3
19495;Spygliukas;Ežiukai;5612894706;Taip;0;5;1;6
19496;Spygliukas;Ežiukai;6552944183;Taip;16;0;0;16
19497;Spygliukas;Ežiukai;1353217998;Taip;13;0;0;13
19498;Spygliukas;Ežiukai;6459076295;Taip;6;1;0;7
19499;Spygliukas;Ežiukai;7749937772;Taip;0;16;1;17
19500;Spygliukas;Ežiukai;5160835235;Taip;0;4;0;4
19501;Spygliukas;Ežiukai;2719100414;Taip;6;2;0;8
19502;Spygliukas;Ežiukai;1429613380;Taip;0;2;1;3
19503;Spygliukas;Ežiukai;4026252608;Taip;0;3;1;4
19504;Spygliukas;Ežiukai;4098112375;Taip;4;0;1;5
19505;Spygliukas;Ežiukai;9321493897;Ne;7;1;0;8
19506;Spygliukas;Ežiukai;7908419787;Taip;0;0;5;5
19507;Spygliukas;Ežiukai;5366783639;Taip;0;5;2;7
19508;Spygliukas;Ežiukai;3088387895;Taip;0;4;0;4
19509;Spygliukas;Ežiukai;7287543571;Taip;14;0;2;16
19510;Spygliukas;Geniukai;8821434815;Taip;14;0;1;15
19511;Spygliukas;Geniukai;2713999021;Taip;8;0;0;8
19512;Spygliukas;Geniukai;5782501698;Taip;7;1;1;9
19513;Spygliukas;Geniukai;6700076900;Taip;0;0;6;6
19514;Spygliukas;Geniukai;8338260940;Taip;0;8;1;9
19515;Spygliukas;Geniukai;1863442354;Taip;0;3;1;4
19516;Spygliukas;Geniukai;9945315122;Taip;0;8;0;8
19517;Spygliukas;Geniukai;1291429206;Taip;0;4;0;4
19518;Spygliukas;Geniukai;7477731865;Taip;0;1;3;4
19519;Spygliukas;Geniukai;7561072315;Taip;0;0;4;4
19520;Spygliukas;Geniukai;2950722789;Taip;1;0;1;2
19521;Spygliukas;Geniukai;8093949301;Taip;8;0;0;8
19522;Spygliukas;Geniukai;9141146733;Taip;10;0;0;10
19523;Spygliukas;Geniukai;6363991196;Taip;2;0;5;7
19524;Spygliukas;Geniukai;8308394841;Taip;0;0;1;1
19525;Spygliukas;Geniukai;1127941700;Taip;0;3;0;3
19526;Spygliukas;Geniukai;9783154498;Taip;0;1;3;4
19527;Spygliukas;Geniukai;8581453160;Taip;5;0;3;8
19528;Spygliukas;Geniukai;7573756485;Taip;0;1;4;5
19529;Spygliukas;Geniukai;1283097421;Taip;7;0;0;7
19530;Spygliukas;Riešutėliai;29449834997;Taip;0;3;1;4
19531;Spygliukas;Riešutėliai;47977103711;Taip;0;3;1;4
19532;Spygliukas;Riešutėliai;1855897974;Taip;0;3;0;3
19533;Spygliukas;Riešutėliai;1940209166;Taip;0;3;0;3
19534;Spygliukas;Riešutėliai;8992822256;Taip;0;1;0;1
19535;Spygliukas;Riešutėliai;1939828587;Taip;0;3;1;4
19536;Spygliukas;Riešutėliai;1238940921;Taip;0;2;1;3
19537;Spygliukas;Riešutėliai;4933577424;Taip;0;1;0;1
19538;Spygliukas;Riešutėliai;9797138740;Taip;0;3;4;7
19539;Spygliukas;Riešutėliai;9001243644;Taip;6;4;2;12
19540;Spygliukas;Riešutėliai;1679263120;Taip;6;0;0;6
19541;Spygliukas;Riešutėliai;7250958367;Taip;7;3;0;10
19542;Spygliukas;Riešutėliai;9975117461;Taip;0;2;0;2
19543;Spygliukas;Riešutėliai;5022615426;Taip;0;1;0;1
19544;Spygliukas;Riešutėliai;1228469923;Taip;0;1;0;1
19545;Spygliukas;Riešutėliai;7114613140;Taip;0;3;0;3
19546;Spygliukas;Riešutėliai;4430242310;Taip;13;0;0;13
19547;Spygliukas;Riešutėliai;8103481313;Taip;0;8;0;8
19548;Spygliukas;Riešutėliai;7421000718;Taip;4;1;1;6
19549;Spygliukas;Riešutėliai;2980459339;Taip;0;3;0;3
19550;Spygliukas;Riešutėliai;5827455834;Taip;0;2;1;3
19551;Spygliukas;Riešutėliai;4653108810;Taip;0;6;0;6
19552;Spygliukas;Riešutėliai;16828631895;Taip;0;3;3;6
19553;Spygliukas;Pelėdžiukai;1260920726;Taip;18;0;0;18
19554;Spygliukas;Pelėdžiukai;4355472423;Taip;0;3;0;3
19555;Spygliukas;Pelėdžiukai;8686118262;Taip;0;7;0;7
19556;Spygliukas;Pelėdžiukai;6242194100;Taip;7;0;0;7
19557;Spygliukas;Pelėdžiukai;8048474808;Taip;0;3;1;4
19558;Spygliukas;Pelėdžiukai;5778081118;Taip;8;0;3;11
19559;Spygliukas;Pelėdžiukai;4721066953;Taip;0;8;0;8
19560;Spygliukas;Pelėdžiukai;8331205164;Taip;13;1;0;14
19561;Spygliukas;Pelėdžiukai;4949371837;Taip;0;8;0;8
19562;Spygliukas;Pelėdžiukai;4650693672;Taip;0;1;1;2
19563;Spygliukas;Pelėdžiukai;3658613027;Ne;0;2;2;4
19564;Spygliukas;Pelėdžiukai;1662885055;Taip;2;3;0;5
19565;Spygliukas;Pelėdžiukai;50047868918;Taip;0;4;0;4
19566;Spygliukas;Pelėdžiukai;3365209400;Taip;0;3;0;3
19567;Spygliukas;Pelėdžiukai;6457632191;Taip;0;4;0;4
19568;Spygliukas;Pelėdžiukai;1691209405;Taip;0;3;1;4
19569;Spygliukas;Pelėdžiukai;9178184431;Taip;0;2;3;5
19570;Spygliukas;Pelėdžiukai;5962360012;Taip;0;3;0;3
19571;Spygliukas;Pelėdžiukai;2739564216;Taip;3;3;0;6
19572;Spygliukas;Pelėdžiukai;4610504338;Taip;0;5;0;5
19573;Spygliukas;Pelėdžiukai;89044575245;Taip;0;4;0;4
19574;Spygliukas;Zylutės;9465470810;Taip;13;0;0;13
19575;Spygliukas;Zylutės;8366571422;Taip;0;0;2;2
19576;Spygliukas;Zylutės;4417471958;Taip;10;4;0;14
19577;Spygliukas;Zylutės;3811864870;Taip;0;0;5;5
19578;Spygliukas;Zylutės;4177369871;Taip;0;7;1;8
19579;Spygliukas;Zylutės;8105507156;Taip;2;4;0;6
19580;Spygliukas;Zylutės;6858338620;Taip;0;0;3;3
19581;Spygliukas;Zylutės;9601530981;Taip;4;0;2;6
19582;Spygliukas;Zylutės;3066293772;Ne;14;0;0;14
19583;Spygliukas;Zylutės;3988253265;Taip;1;0;1;2
19584;Spygliukas;Zylutės;3268222954;Taip;0;3;0;3
19585;Spygliukas;Zylutės;5006372835;Taip;7;0;0;7
19586;Spygliukas;Zylutės;1729199382;Taip;0;18;0;18
19587;Spygliukas;Zylutės;8408234202;Taip;7;0;3;10
19588;Spygliukas;Zylutės;3317395260;Taip;0;3;0;3
19589;Spygliukas;Zylutės;6343141973;Taip;4;0;3;7
19590;Spygliukas;Zylutės;2632672131;Taip;4;2;0;6
19591;Spygliukas;Zylutės;5638595939;Taip;18;0;0;18
19592;Spygliukas;Skruzdėliukai;8246739374;Taip;6;0;0;6
19593;Spygliukas;Skruzdėliukai;8509447147;Taip;18;0;0;18
19594;Spygliukas;Skruzdėliukai;5739075961;Taip;11;0;0;11
19595;Spygliukas;Skruzdėliukai;7324915516;Taip;8;0;0;8
19596;Spygliukas;Skruzdėliukai;6414439254;Taip;8;0;0;8
19597;Spygliukas;Skruzdėliukai;7663839690;Taip;4;0;3;7
19598;Spygliukas;Skruzdėliukai;2738766977;Taip;3;3;0;6
19599;Spygliukas;Skruzdėliukai;8426426785;Taip;2;0;4;6
19600;Spygliukas;Skruzdėliukai;1243647769;Taip;7;0;0;7
19601;Spygliukas;Skruzdėliukai;6680699873;Taip;2;0;9;11
19602;Spygliukas;Skruzdėliukai;2955219028;Ne;18;0;0;18
19603;Spygliukas;Skruzdėliukai;1823720183;Taip;14;1;2;17
19604;Spygliukas;Skruzdėliukai;8565217488;Taip;6;0;9;15
19605;Spygliukas;Skruzdėliukai;2367685286;Taip;9;0;3;12
19606;Spygliukas;Skruzdėliukai;3065727701;Ne;18;0;0;18
19607;Spygliukas;Skruzdėliukai;1775612723;Taip;10;0;1;11
19608;Spygliukas;Voveraitės;9112172144;Taip;6;2;2;10
19609;Spygliukas;Voveraitės;7897603878;Taip;0;9;0;9
19610;Spygliukas;Voveraitės;7741841634;Taip;6;3;0;9
19611;Spygliukas;Voveraitės;3077468722;Taip;4;3;0;7
19612;Spygliukas;Voveraitės;1177439438;Taip;0;3;0;3
19613;Spygliukas;Voveraitės;4948147941;Taip;0;0;3;3
19614;Spygliukas;Voveraitės;2272141731;Taip;0;1;1;2
19615;Spygliukas;Voveraitės;6587957213;Taip;0;7;0;7
19616;Spygliukas;Voveraitės;6758336405;Taip;0;0;3;3
19617;Spygliukas;Voveraitės;3668191959;Taip;0;4;0;4
19618;Spygliukas;Voveraitės;1426267001;Taip;0;1;1;2
19619;Spygliukas;Voveraitės;8189748611;Taip;18;0;0;18
19620;Spygliukas;Voveraitės;8877911083;Taip;4;8;0;12
19621;Spygliukas;Voveraitės;6405496193;Taip;0;3;0;3
19622;Spygliukas;Voveraitės;7113913750;Ne;0;3;1;4
19623;Spygliukas;Voveraitės;9231097598;Taip;5;3;0;8
19624;Spygliukas;Voveraitės;4681061579;Taip;0;3;6;9
19625;Spygliukas;Voveraitės;7313828707;Taip;5;0;0;5
19626;Spygliukas;Voveraitės;1234195733;Taip;0;3;0;3
19627;Spygliukas;Voveraitės;4508351101;Taip;0;0;7;7
19628;Spygliukas;Giliukų;6015646417;Taip;0;18;0;18
19629;Spygliukas;Giliukų;1761340174;Taip;10;3;0;13
19630;Spygliukas;Giliukų;4854168938;Taip;0;18;0;18
19631;Spygliukas;Giliukų;7460280684;Taip;11;0;2;13
19632;Spygliukas;Giliukų;4429961491;Taip;25;0;1;26
19633;Spygliukas;Giliukų;8821028259;Taip;4;3;6;13
19634;Spygliukas;Giliukų;6485350404;Taip;0;18;0;18
19635;Spygliukas;Giliukų;3237501537;Taip;2;3;3;8
19636;Spygliukas;Giliukų;8722863277;Taip;0;3;4;7
19637;Spygliukas;Giliukų;9025238241;Taip;5;5;0;10
19638;Spygliukas;Giliukų;3603606800;Taip;0;18;0;18
19639;Spygliukas;Giliukų;6290439938;Taip;0;18;0;18
19640;Spygliukas;Giliukų;7776811391;Taip;4;1;0;5
19641;Spygliukas;Giliukų;3777763305;Taip;14;0;0;14
19642;Spygliukas;Giliukų;4626877679;Taip;0;18;0;18
19643;Spygliukas;Giliukų;5255993275;Taip;11;0;1;12
19644;Spygliukas;Drugeliai;7271659513;Taip;0;6;0;6
19645;Spygliukas;Drugeliai;8604767396;Taip;0;2;0;2
19646;Spygliukas;Drugeliai;4634660174;Taip;10;0;2;12
19647;Spygliukas;Drugeliai;7924880159;Taip;7;1;0;8
19648;Spygliukas;Drugeliai;4368224847;Taip;13;0;1;14
19649;Spygliukas;Drugeliai;9316731983;Taip;0;0;5;5
19650;Spygliukas;Drugeliai;6630979640;Taip;5;0;0;5
19651;Spygliukas;Drugeliai;5012876830;Taip;0;2;0;2
19652;Spygliukas;Drugeliai;2315421636;Taip;0;3;2;5
19653;Spygliukas;Drugeliai;7125425492;Taip;0;3;0;3
19654;Spygliukas;Drugeliai;5214431060;Ne;0;3;0;3
19655;Spygliukas;Drugeliai;7928675053;Taip;6;0;0;6
19656;Spygliukas;Drugeliai;9052337501;Taip;1;3;2;6
19657;Spygliukas;Drugeliai;1974541155;Taip;0;1;2;3
19658;Spygliukas;Drugeliai;4505044604;Taip;5;5;0;10
19659;Spygliukas;Drugeliai;2989701249;Taip;4;0;3;7
19660;Spygliukas;Drugeliai;9086986643;Taip;0;2;0;2
19661;Spygliukas;Drugeliai;9392554576;Taip;0;5;0;5
19662;Spygliukas;Drugeliai;8646122773;Taip;5;4;0;9
19663;Vieversys;Žirniukai;5365334453;Taip;0;0;5;5
19664;Vieversys;Žirniukai;7029322013;Taip;5;0;0;5
19665;Vieversys;Žirniukai;2266222087;Taip;8;0;1;9
19666;Vieversys;Žirniukai;2869545222;Taip;14;0;0;14
19667;Vieversys;Žirniukai;7601876587;Taip;6;3;0;9
19668;Vieversys;Žirniukai;2024837493;Taip;12;0;0;12
19669;Vieversys;Žirniukai;8129566710;Taip;0;3;0;3
19670;Vieversys;Žirniukai;5576923685;Taip;10;2;0;12
19671;Vieversys;Žirniukai;3295424711;Taip;3;0;0;3
19672;Vieversys;Žirniukai;3575906273;Taip;1;0;1;2
19673;Vieversys;Žirniukai;9856798869;Taip;0;18;0;18
19674;Vieversys;Žirniukai;6530685517;Taip;0;1;0;1
19675;Vieversys;Žirniukai;3533711179;Taip;3;3;0;6
19676;Vieversys;Žirniukai;2242368843;Taip;0;0;4;4
19677;Vieversys;Varpelių;5150986489;Taip;10;0;0;10
19678;Vieversys;Varpelių;9463693741;Taip;8;0;1;9
19679;Vieversys;Varpelių;1924774817;Taip;3;6;0;9
19680;Vieversys;Varpelių;3595005599;Taip;8;0;2;10
19681;Vieversys;Varpelių;9155896981;Taip;0;3;0;3
19682;Vieversys;Varpelių;5160814541;Taip;0;6;0;6
19683;Vieversys;Varpelių;9580031042;Taip;5;3;0;8
19684;Vieversys;Varpelių;2635722489;Taip;0;1;4;5
19685;Vieversys;Varpelių;3262738994;Taip;5;7;0;12
19686;Vieversys;Varpelių;8350070741;Taip;8;0;3;11
19687;Vieversys;Varpelių;2805682329;Taip;0;2;0;2
19688;Vieversys;Varpelių;9453100342;Taip;0;0;1;1
19689;Vieversys;Varpelių;2956566201;Taip;0;4;0;4
19690;Vieversys;Varpelių;1727558984;Taip;0;0;12;12
19691;Vieversys;Varpelių;3297728501;Taip;0;1;0;1
19692;Vieversys;Varpelių;3780226431;Taip;0;9;0;9
19693;Vieversys;Varpelių;3572628491;Taip;0;0;3;3
19694;Vieversys;Varpelių;1128991679;Taip;2;0;1;3
19695;Vieversys;Kiškučių;5922485482;Taip;0;3;1;4
19696;Vieversys;Kiškučių;3917758713;Taip;9;3;1;13
19697;Vieversys;Kiškučių;9387421639;Taip;13;3;0;16
19698;Vieversys;Kiškučių;2383765752;Taip;0;4;1;5
19699;Vieversys;Kiškučių;1247565595;Taip;0;8;0;8
19700;Vieversys;Kiškučių;7812227428;Taip;0;3;1;4
19701;Vieversys;Kiškučių;53977164888;Taip;0;9;0;9
19702;Vieversys;Kiškučių;5810605263;Taip;0;3;4;7
19703;Vieversys;Kiškučių;3205204176;Taip;4;2;2;8
19704;Vieversys;Kiškučių;82594887399;Taip;0;3;2;5
19705;Vieversys;Kiškučių;6787960120;Ne;0;3;2;5
19706;Vieversys;Kiškučių;9612415733;Taip;0;3;0;3
19707;Vieversys;Kiškučių;1728554204;Taip;0;3;0;3
19708;Vieversys;Kiškučių;5286521728;Ne;6;3;1;10
19709;Vieversys;Kiškučių;1149316471;Taip;0;7;0;7
19710;Vieversys;Kiškučių;7500147648;Taip;0;3;0;3
19711;Vieversys;Kiškučių;4313822180;Taip;0;3;0;3
19712;Vieversys;Kiškučių;8038341998;Taip;7;4;0;11
19713;Vieversys;Kiškučių;5917328379;Taip;0;3;0;3
19714;Vieversys;Kiškučių;6720355390;Taip;0;4;5;9
19715;Vieversys;Kiškučių;1933907389;Taip;0;4;2;6
19716;Vieversys;Pelėdžiukų;8421719030;Taip;0;3;0;3
19717;Vieversys;Pelėdžiukų;77272293257;Taip;13;2;0;15
19718;Vieversys;Pelėdžiukų;94463134058;Taip;0;3;0;3
19719;Vieversys;Pelėdžiukų;7578552471;Taip;0;1;0;1
19720;Vieversys;Pelėdžiukų;2193074123;Taip;0;3;4;7
19721;Vieversys;Pelėdžiukų;9499315463;Taip;0;4;0;4
19722;Vieversys;Pelėdžiukų;9774365819;Taip;0;3;0;3
19723;Vieversys;Pelėdžiukų;2521488728;Taip;3;3;1;7
19724;Vieversys;Pelėdžiukų;6473759470;Taip;0;5;0;5
19725;Vieversys;Pelėdžiukų;1273951001;Taip;0;5;0;5
19726;Vieversys;Pelėdžiukų;48430863473;Taip;4;3;0;7
19727;Vieversys;Pelėdžiukų;50181034746;Taip;0;3;0;3
19728;Vieversys;Pelėdžiukų;1027693153;Taip;0;1;0;1
19729;Vieversys;Pelėdžiukų;5871715452;Taip;0;3;1;4
19730;Vieversys;Pelėdžiukų;9659337657;Taip;3;3;0;6
19731;Vieversys;Pelėdžiukų;3458399180;Taip;0;3;0;3
19732;Vieversys;Pelėdžiukų;1361156816;Taip;0;4;0;4
19733;Vieversys;Pelėdžiukų;4216521988;Taip;0;3;3;6
19734;Vieversys;Pelėdžiukų;3755410640;Taip;0;9;0;9
19735;Vieversys;Pelėdžiukų;1322495361;Taip;0;3;1;4
19736;Vieversys;Saulučių;3164280186;Taip;0;0;7;7
19737;Vieversys;Saulučių;3405502715;Taip;0;3;0;3
19738;Vieversys;Saulučių;6127272124;Taip;0;3;1;4
19739;Vieversys;Saulučių;5654533451;Taip;0;3;0;3
19740;Vieversys;Saulučių;9972526744;Taip;0;0;3;3
19741;Vieversys;Saulučių;9985374057;Taip;11;0;0;11
19742;Vieversys;Saulučių;9308040716;Taip;0;0;1;1
19743;Vieversys;Saulučių;4741252829;Taip;0;0;1;1
19744;Vieversys;Saulučių;2140887757;Taip;2;0;3;5
19745;Vieversys;Saulučių;1748006118;Taip;12;0;0;12
19746;Vieversys;Saulučių;4690095102;Taip;0;3;0;3
19747;Vieversys;Saulučių;7048475906;Taip;7;0;3;10
19748;Vieversys;Saulučių;4072323869;Taip;0;3;0;3
19749;Vieversys;Saulučių;7596355010;Taip;0;0;6;6
19750;Vieversys;Saulučių;3360981720;Taip;3;0;3;6
19751;Vieversys;Saulučių;9322322737;Taip;0;3;1;4
19752;Vieversys;Kregždučių;3156245273;Taip;0;3;2;5
19753;Vieversys;Kregždučių;5645852451;Taip;0;3;0;3
19754;Vieversys;Kregždučių;9088171869;Taip;3;0;0;3
19755;Vieversys;Kregždučių;7998100115;Taip;0;3;0;3
19756;Vieversys;Kregždučių;9093088054;Taip;0;7;0;7
19757;Vieversys;Kregždučių;4870401841;Taip;0;0;3;3
19758;Vieversys;Kregždučių;2849852593;Taip;0;3;5;8
19759;Vieversys;Kregždučių;6808541662;Taip;1;3;0;4
19760;Vieversys;Kregždučių;2529690060;Taip;0;3;0;3
19761;Vieversys;Kregždučių;2230503026;Taip;0;3;0;3
19762;Vieversys;Kregždučių;7568415178;Taip;0;3;0;3
19763;Vieversys;Kregždučių;8141710663;Taip;0;3;0;3
19764;Vieversys;Kregždučių;6157594693;Taip;5;7;0;12
19765;Vieversys;Kregždučių;1322953831;Taip;0;4;0;4
19766;Vieversys;Kregždučių;9090281352;Taip;7;0;3;10
19767;Vieversys;Kregždučių;4308330177;Taip;0;3;4;7
19768;Vieversys;Kregždučių;4347494053;Taip;0;0;5;5
19769;Vieversys;Kregždučių;3122763958;Taip;0;11;0;11
19770;Vieversys;Kregždučių;2938302462;Taip;3;0;0;3
19771;Vieversys;Kregždučių;9577869269;Taip;3;0;1;4
19772;Vieversys;Boružėlių;6838828193;Taip;0;3;0;3
19773;Vieversys;Boružėlių;8587368497;Taip;0;3;0;3
19774;Vieversys;Boružėlių;5683183310;Taip;2;4;0;6
19775;Vieversys;Boružėlių;9884517851;Taip;0;3;0;3
19776;Vieversys;Boružėlių;4565799599;Taip;0;3;0;3
19777;Vieversys;Boružėlių;7399326463;Taip;18;0;0;18
19778;Vieversys;Boružėlių;4088189914;Taip;5;3;0;8
19779;Vieversys;Boružėlių;7364582681;Taip;10;3;0;13
19780;Vieversys;Boružėlių;8084767846;Taip;0;4;0;4
19781;Vieversys;Boružėlių;9826657384;Taip;0;0;6;6
19782;Vieversys;Boružėlių;3731412573;Taip;0;1;2;3
19783;Vieversys;Boružėlių;9255292099;Taip;0;3;0;3
19784;Vieversys;Boružėlių;7429565381;Taip;7;4;0;11
19785;Vieversys;Boružėlių;4297477514;Taip;13;0;0;13
19786;Vieversys;Boružėlių;8816714193;Taip;13;0;3;16
19787;Vieversys;Boružėlių;6148482625;Taip;3;5;0;8
19788;Vieversys;Boružėlių;2701284187;Taip;13;2;0;15
19789;Vieversys;Boružėlių;9911792407;Taip;18;0;0;18
19790;Vieversys;Boružėlių;6234199996;Taip;12;0;0;12
19791;Vieversys;Bitučių;9268459013;Taip;4;0;0;4
19792;Vieversys;Bitučių;8706336322;Taip;3;0;0;3
19793;Vieversys;Bitučių;5966170543;Taip;0;3;0;3
19794;Vieversys;Bitučių;5210732072;Taip;18;0;0;18
19795;Vieversys;Bitučių;9188208330;Taip;0;0;2;2
19796;Vieversys;Bitučių;2072413459;Taip;0;3;0;3
19797;Vieversys;Bitučių;9454017990;Taip;18;0;0;18
19798;Vieversys;Bitučių;9476611261;Taip;18;0;0;18
19799;Vieversys;Bitučių;6083402842;Taip;0;3;0;3
19800;Vieversys;Bitučių;4428101863;Taip;0;2;1;3
19801;Vieversys;Bitučių;4335653911;Taip;0;3;0;3
19802;Vieversys;Bitučių;6839896363;Taip;0;0;1;1
19803;Vieversys;Bitučių;9978867863;Taip;6;0;0;6
19804;Vieversys;Bitučių;9092693925;Taip;0;3;0;3
19805;Vieversys;Bitučių;2661027772;Taip;5;3;1;9
19806;Vieversys;Bitučių;3601928285;Ne;3;0;0;3
19807;Vieversys;Bitučių;8492908398;Taip;3;0;0;3
19808;Vieversys;Bitučių;5479620291;Taip;12;3;1;16
19809;Vieversys;Bitučių;2931875387;Taip;0;0;1;1
19810;Vieversys;Bitučių;6983906287;Taip;0;0;1;1
19811;Vieversys;Bitučių;5417413393;Taip;5;3;0;8
19812;Vieversys;Smalsučių;3681120339;Taip;0;11;0;11
19813;Vieversys;Smalsučių;9164615794;Taip;5;4;0;9
19814;Vieversys;Smalsučių;3684937630;Taip;5;0;3;8
19815;Vieversys;Smalsučių;6563139211;Taip;0;7;0;7
19816;Vieversys;Smalsučių;4294676988;Taip;3;3;1;7
19817;Vieversys;Smalsučių;4835022593;Taip;5;0;5;10
19818;Vieversys;Smalsučių;3249717073;Taip;2;5;0;7
19819;Vieversys;Smalsučių;7120329258;Taip;1;1;0;2
19820;Vieversys;Smalsučių;8174124875;Taip;1;2;0;3
19821;Vieversys;Smalsučių;5769453869;Taip;5;3;0;8
19822;Vieversys;Smalsučių;5907903394;Taip;0;5;0;5
19823;Vieversys;Smalsučių;3946609345;Taip;1;3;2;6
19824;Vieversys;Smalsučių;9686787125;Taip;0;5;0;5
19825;Vieversys;Smalsučių;4455039401;Taip;0;4;0;4
19826;Vieversys;Smalsučių;8129139979;Taip;0;0;6;6
19827;Vieversys;Smalsučių;9835682858;Taip;0;12;0;12
19828;Vieversys;Smalsučių;6486852268;Ne;0;15;0;15
19829;Vieversys;Smalsučių;7007620994;Taip;3;0;0;3
19830;Vieversys;Smalsučių;9494957750;Taip;0;3;0;3
19831;Vieversys;Kodėlčiukų;9217208794;Taip;0;18;0;18
19832;Vieversys;Kodėlčiukų;5037806018;Taip;5;0;3;8
19833;Vieversys;Kodėlčiukų;1752359969;Taip;0;6;0;6
19834;Vieversys;Kodėlčiukų;6791121542;Taip;11;3;0;14
19835;Vieversys;Kodėlčiukų;5898422871;Taip;8;3;0;11
19836;Vieversys;Kodėlčiukų;6709556873;Taip;0;0;1;1
19837;Vieversys;Kodėlčiukų;4193031329;Taip;0;0;1;1
19838;Vieversys;Kodėlčiukų;7453156612;Taip;0;0;3;3
19839;Vieversys;Kodėlčiukų;6926960486;Taip;0;2;0;2
19840;Vieversys;Kodėlčiukų;3180687885;Taip;0;3;4;7
19841;Vieversys;Kodėlčiukų;1881076551;Taip;3;1;1;5
19842;Vieversys;Kodėlčiukų;1384388802;Taip;7;7;0;14
19843;Vieversys;Kodėlčiukų;2562413607;Taip;0;0;4;4
19844;Vieversys;Kodėlčiukų;9965162863;Taip;0;2;0;2
19845;Vieversys;Kodėlčiukų;4702339508;Taip;2;0;5;7
19846;Vieversys;Kodėlčiukų;4631238425;Taip;0;5;1;6
19847;Vieversys;Kodėlčiukų;8512643926;Taip;12;0;0;12
19848;Vieversys;Kodėlčiukų;7967372524;Ne;18;0;0;18
19849;Vieversys;Kodėlčiukų;4703696958;Taip;5;1;3;9
19850;Vieversys;NYKŠTUKAI;3332069842;Taip;0;3;0;3
19851;Vieversys;NYKŠTUKAI;2107000312;Taip;0;5;0;5
19852;Vieversys;NYKŠTUKAI;1963481567;Taip;0;5;4;9
19853;Vieversys;NYKŠTUKAI;1714096583;Taip;7;0;0;7
19854;Vieversys;NYKŠTUKAI;8371839883;Taip;7;0;0;7
19855;Vieversys;NYKŠTUKAI;6474334564;Taip;3;2;0;5
19856;Vieversys;NYKŠTUKAI;2092872414;Taip;6;0;1;7
19857;Vieversys;NYKŠTUKAI;5394635510;Taip;0;0;3;3
19858;Vieversys;NYKŠTUKAI;1160455554;Taip;3;0;1;4
19859;Vieversys;NYKŠTUKAI;8200432952;Taip;0;3;0;3
19860;Vieversys;NYKŠTUKAI;2535992834;Taip;0;0;2;2
19861;Vieversys;NYKŠTUKAI;4974924858;Taip;0;3;0;3
19862;Vieversys;NYKŠTUKAI;4087823915;Taip;7;0;0;7
19863;Vieversys;NYKŠTUKAI;7111551694;Taip;5;0;0;5
19864;Vieversys;DRUGELIAI;9412299328;Taip;4;0;0;4
19865;Vieversys;DRUGELIAI;1552959751;Taip;0;0;1;1
19866;Vieversys;DRUGELIAI;5384977888;Taip;7;0;0;7
19867;Vieversys;DRUGELIAI;6000875464;Taip;0;3;0;3
19868;Vieversys;DRUGELIAI;7708807923;Taip;0;0;3;3
19869;Vieversys;DRUGELIAI;5580265718;Taip;4;0;3;7
19870;Vieversys;DRUGELIAI;8199984460;Taip;0;0;4;4
19871;Vieversys;DRUGELIAI;6581002790;Taip;3;0;3;6
19872;Vieversys;DRUGELIAI;9666764935;Taip;7;0;0;7
19873;Vieversys;DRUGELIAI;8966020793;Taip;0;0;3;3
19874;Vieversys;DRUGELIAI;5164567779;Taip;0;0;1;1
19875;Žirmūnėliai;SAULUTĖS;5560694124;Taip;8;1;2;11
19876;Žirmūnėliai;SAULUTĖS;2310523676;Taip;0;15;0;15
19877;Žirmūnėliai;SAULUTĖS;4922028935;Taip;13;0;0;13
19878;Žirmūnėliai;SAULUTĖS;1948299433;Taip;7;2;5;14
19879;Žirmūnėliai;SAULUTĖS;4763350308;Taip;0;0;1;1
19880;Žirmūnėliai;SAULUTĖS;5626711530;Taip;0;12;0;12
19881;Žirmūnėliai;SAULUTĖS;3902161368;Taip;0;4;0;4
19882;Žirmūnėliai;SAULUTĖS;6072407337;Taip;0;3;0;3
19883;Žirmūnėliai;SAULUTĖS;4338673048;Taip;6;0;2;8
19884;Žirmūnėliai;SAULUTĖS;4793967980;Taip;0;3;0;3
19885;Žirmūnėliai;SAULUTĖS;6177408775;Taip;0;3;0;3
19886;Žirmūnėliai;SAULUTĖS;8242112212;Taip;0;4;5;9
19887;Žirmūnėliai;SAULUTĖS;1940552890;Taip;0;3;0;3
19888;Žirmūnėliai;SAULUTĖS;2392106040;Taip;0;3;0;3
19889;Žirmūnėliai;SAULUTĖS;4343419766;Taip;0;4;1;5
19890;Žirmūnėliai;SAULUTĖS;9145626116;Taip;8;4;1;13
19891;Žirmūnėliai;SAULUTĖS;7675488865;Taip;5;3;0;8
19892;Žirmūnėliai;SAULUTĖS;8345632807;Taip;0;6;0;6
19893;Žirmūnėliai;SAULUTĖS;8592714547;Taip;7;5;4;16
19894;Žirmūnėliai;GILIUKAI;6430944858;Taip;8;0;2;10
19895;Žirmūnėliai;GILIUKAI;3562689670;Taip;0;6;0;6
19896;Žirmūnėliai;GILIUKAI;5929166560;Taip;2;2;0;4
19897;Žirmūnėliai;GILIUKAI;3767421827;Taip;0;2;6;8
19898;Žirmūnėliai;GILIUKAI;4327504033;Taip;5;2;0;7
19899;Žirmūnėliai;GILIUKAI;5104310002;Taip;17;0;0;17
19900;Žirmūnėliai;GILIUKAI;1025809131;Taip;4;3;0;7
19901;Žirmūnėliai;GILIUKAI;6899109664;Taip;5;5;4;14
19902;Žirmūnėliai;GILIUKAI;1473482823;Ne;0;0;5;5
19903;Žirmūnėliai;GILIUKAI;7410921362;Taip;0;3;0;3
19904;Žirmūnėliai;GILIUKAI;6597451758;Taip;2;3;0;5
19905;Žirmūnėliai;GILIUKAI;8627403283;Taip;0;0;6;6
19906;Žirmūnėliai;GILIUKAI;5089884149;Taip;0;0;3;3
19907;Žirmūnėliai;GILIUKAI;1791977446;Taip;8;2;0;10
19908;Žirmūnėliai;GILIUKAI;6875484657;Taip;0;3;5;8
19909;Žirmūnėliai;GILIUKAI;9871163622;Taip;13;0;0;13
19910;Žirmūnėliai;GILIUKAI;3532895278;Taip;0;2;5;7
19911;Žirmūnėliai;GILIUKAI;8459217612;Taip;6;0;3;9
19912;Žirmūnėliai;GILIUKAI;2959090234;Taip;0;0;6;6
19913;Žirmūnėliai;GILIUKAI;5486475468;Taip;0;1;1;2
19914;Žirmūnėliai;GILIUKAI;8618410295;Taip;18;4;0;22
19915;Žirmūnėliai;GILIUKAI;1941509002;Taip;5;7;3;15
19916;Žirmūnėliai;DRUGELIAI;4218266688;Taip;0;3;0;3
19917;Žirmūnėliai;DRUGELIAI;7020486370;Taip;0;6;0;6
19918;Žirmūnėliai;DRUGELIAI;3449815783;Taip;0;3;0;3
19919;Žirmūnėliai;DRUGELIAI;9541122034;Taip;0;3;0;3
19920;Žirmūnėliai;DRUGELIAI;5736502380;Taip;5;5;5;15
19921;Žirmūnėliai;DRUGELIAI;9154874729;Taip;6;3;0;9
19922;Žirmūnėliai;DRUGELIAI;9378860669;Taip;0;4;0;4
19923;Žirmūnėliai;DRUGELIAI;8607934394;Taip;0;4;0;4
19924;Žirmūnėliai;DRUGELIAI;5723289396;Taip;8;3;2;13
19925;Žirmūnėliai;DRUGELIAI;7892626521;Taip;0;5;0;5
19926;Žirmūnėliai;DRUGELIAI;8999160836;Taip;0;3;0;3
19927;Žirmūnėliai;DRUGELIAI;8209309240;Taip;0;7;0;7
19928;Žirmūnėliai;DRUGELIAI;2837129621;Taip;8;1;0;9
19929;Žirmūnėliai;DRUGELIAI;1273684243;Taip;5;0;4;9
19930;Žirmūnėliai;DRUGELIAI;2971175236;Taip;0;4;0;4
19931;Žirmūnėliai;DRUGELIAI;6594728970;Taip;0;2;0;2
19932;Žirmūnėliai;DRUGELIAI;7422544482;Taip;0;14;0;14
19933;Žirmūnėliai;DRUGELIAI;4336415033;Taip;0;1;4;5
19934;Žirmūnėliai;DRUGELIAI;9241738140;Taip;0;4;0;4
19935;Žirmūnėliai;DRUGELIAI;4778339658;Taip;0;14;0;14
19936;Žirmūnėliai;BORUŽIUKAI;52420072025;Taip;0;3;5;8
19937;Žirmūnėliai;BORUŽIUKAI;4796654075;Taip;10;3;1;14
19938;Žirmūnėliai;BORUŽIUKAI;1234956674;Taip;0;4;0;4
19939;Žirmūnėliai;BORUŽIUKAI;9926432375;Taip;0;3;0;3
19940;Žirmūnėliai;BORUŽIUKAI;3351861764;Taip;0;6;0;6
19941;Žirmūnėliai;BORUŽIUKAI;6161223611;Taip;0;4;0;4
19942;Žirmūnėliai;BORUŽIUKAI;5611315994;Taip;0;3;0;3
19943;Žirmūnėliai;BORUŽIUKAI;7528704460;Taip;0;3;0;3
19944;Žirmūnėliai;BORUŽIUKAI;1618573494;Taip;5;8;0;13
19945;Žirmūnėliai;BORUŽIUKAI;31403739893;Taip;10;0;0;10
19946;Žirmūnėliai;BORUŽIUKAI;6647641423;Taip;6;3;0;9
19947;Žirmūnėliai;BORUŽIUKAI;5367009184;Taip;0;3;0;3
19948;Žirmūnėliai;BORUŽIUKAI;8623037038;Taip;0;3;1;4
19949;Žirmūnėliai;BORUŽIUKAI;3540307559;Taip;0;4;0;4
19950;Žirmūnėliai;BORUŽIUKAI;5125341440;Taip;0;3;0;3
19951;Žirmūnėliai;BORUŽIUKAI;1885292520;Taip;0;3;0;3
19952;Žirmūnėliai;BORUŽIUKAI;1865240339;Taip;0;4;0;4
19953;Žirmūnėliai;BORUŽIUKAI;6337036947;Taip;0;0;3;3
19954;Žirmūnėliai;BORUŽIUKAI;3274576752;Taip;12;0;0;12
19955;Žirmūnėliai;BORUŽIUKAI;8339819296;Taip;0;3;0;3
19956;Žirmūnėliai;BORUŽIUKAI;2033271165;Taip;0;4;1;5
19957;Žirmūnėliai;EŽIUKAI;7011701994;Taip;5;8;0;13
19958;Žirmūnėliai;EŽIUKAI;2661052835;Taip;0;16;0;16
19959;Žirmūnėliai;EŽIUKAI;1655437833;Taip;3;3;0;6
19960;Žirmūnėliai;EŽIUKAI;3640979388;Taip;0;4;0;4
19961;Žirmūnėliai;EŽIUKAI;6878528100;Taip;0;3;2;5
19962;Žirmūnėliai;EŽIUKAI;8440187348;Taip;13;2;0;15
19963;Žirmūnėliai;EŽIUKAI;4565479092;Taip;0;3;0;3
19964;Žirmūnėliai;EŽIUKAI;4968278870;Taip;10;3;0;13
19965;Žirmūnėliai;EŽIUKAI;2693415717;Taip;0;5;0;5
19966;Žirmūnėliai;EŽIUKAI;7953019230;Taip;0;11;0;11
19967;Žirmūnėliai;EŽIUKAI;1832367936;Taip;0;3;0;3
19968;Žirmūnėliai;EŽIUKAI;3180116136;Taip;0;14;0;14
19969;Žirmūnėliai;EŽIUKAI;9759491055;Taip;7;4;1;12
19970;Žirmūnėliai;EŽIUKAI;1127214387;Taip;0;6;2;8
19971;Žirmūnėliai;EŽIUKAI;4101748829;Taip;0;12;0;12
19972;Žirmūnėliai;EŽIUKAI;2379638934;Taip;0;8;0;8
19973;Žirmūnėliai;EŽIUKAI;6448582622;Taip;8;5;0;13
19974;Žirmūnėliai;EŽIUKAI;4710829908;Taip;0;6;0;6
19975;Žirmūnėliai;EŽIUKAI;7996709950;Taip;0;1;0;1
19976;Žirmūnėliai;EŽIUKAI;7580002502;Taip;9;0;1;10
19977;Žirmūnėliai;EŽIUKAI;4638575301;Taip;0;4;0;4
19978;Žirmūnėliai;EŽIUKAI;3310847619;Taip;0;3;3;6
19979;Žirmūnėliai;EŽIUKAI;1977798059;Taip;0;6;3;9
19980;Žirmūnėliai;ŽVIRBLIUKAI;6896145409;Taip;0;3;0;3
19981;Žirmūnėliai;ŽVIRBLIUKAI;1255857051;Taip;0;5;0;5
19982;Žirmūnėliai;ŽVIRBLIUKAI;1347664230;Taip;0;3;2;5
19983;Žirmūnėliai;ŽVIRBLIUKAI;8030469722;Taip;0;3;3;6
19984;Žirmūnėliai;ŽVIRBLIUKAI;3166454638;Taip;0;3;0;3
19985;Žirmūnėliai;ŽVIRBLIUKAI;4517290068;Taip;5;3;0;8
19986;Žirmūnėliai;ŽVIRBLIUKAI;1582563837;Taip;5;1;0;6
19987;Žirmūnėliai;ŽVIRBLIUKAI;1381923106;Taip;0;5;3;8
19988;Žirmūnėliai;ŽVIRBLIUKAI;1725143117;Taip;0;4;0;4
19989;Žirmūnėliai;ŽVIRBLIUKAI;1478039469;Taip;13;3;0;16
19990;Žirmūnėliai;ŽVIRBLIUKAI;5037669167;Taip;4;2;0;6
19991;Žirmūnėliai;ŽVIRBLIUKAI;1073135587;Taip;0;6;0;6
19992;Žirmūnėliai;ŽVIRBLIUKAI;4598761492;Taip;4;4;0;8
19993;Žirmūnėliai;ŽVIRBLIUKAI;1435743911;Taip;0;3;0;3
19994;Žirmūnėliai;ŽVIRBLIUKAI;2007790746;Taip;0;4;0;4
19995;Žirmūnėliai;ŽVIRBLIUKAI;8308074932;Taip;0;5;1;6
19996;Žirmūnėliai;ŽVIRBLIUKAI;1761284228;Taip;5;5;0;10
19997;Žirmūnėliai;ŽVIRBLIUKAI;41018224936;Taip;0;14;0;14
19998;Žirmūnėliai;ŽVIRBLIUKAI;1894070647;Taip;4;5;0;9
19999;Žirmūnėliai;ŽVIRBLIUKAI;7062967491;Taip;0;5;0;5
20000;Žirmūnėliai;ŽVIRBLIUKAI;9482910388;Taip;0;7;0;7
20001;Žirmūnėliai;ŽVIRBLIUKAI;1569772948;Ne;0;3;2;5
20002;Žirmūnėliai;SPALVELĖS;4815427530;Taip;0;0;8;8
20003;Žirmūnėliai;SPALVELĖS;6641667315;Taip;0;7;1;8
20004;Žirmūnėliai;SPALVELĖS;9936156579;Taip;0;2;4;6
20005;Žirmūnėliai;SPALVELĖS;2985092368;Taip;0;2;4;6
20006;Žirmūnėliai;SPALVELĖS;5154076629;Taip;0;0;3;3
20007;Žirmūnėliai;SPALVELĖS;1401001989;Taip;0;5;1;6
20008;Žirmūnėliai;SPALVELĖS;2841958534;Taip;4;3;0;7
20009;Žirmūnėliai;SPALVELĖS;6259368139;Taip;8;6;0;14
20010;Žirmūnėliai;SPALVELĖS;1356219744;Taip;7;5;0;12
20011;Žirmūnėliai;SPALVELĖS;8538773532;Taip;0;6;0;6
20012;Žirmūnėliai;SPALVELĖS;3051025147;Ne;0;0;5;5
20013;Žirmūnėliai;SPALVELĖS;6934204209;Taip;6;0;1;7
20014;Žirmūnėliai;SPALVELĖS;3458810185;Taip;8;0;3;11
20015;Žirmūnėliai;SPALVELĖS;9306935083;Taip;7;4;0;11
20016;Žirmūnėliai;SPALVELĖS;5316869112;Taip;0;0;3;3
20017;Žirmūnėliai;SPALVELĖS;4807331877;Taip;0;0;9;9
20018;Žirmūnėliai;SPALVELĖS;8742911909;Taip;0;9;0;9
20019;Žirmūnėliai;SPALVELĖS;6817236579;Taip;0;4;0;4
20020;Žirmūnėliai;SPALVELĖS;9042509512;Taip;0;11;0;11
20021;Žirmūnėliai;SPALVELĖS;5076712824;Taip;4;7;0;11
20022;Žirmūnėliai;SPALVELĖS;8444883234;Ne;15;0;0;15
20023;Žirmūnėliai;DEBESĖLIAI;6908512961;Taip;0;24;0;24
20024;Žirmūnėliai;DEBESĖLIAI;1571242696;Taip;0;2;0;2
20025;Žirmūnėliai;DEBESĖLIAI;2866010286;Taip;0;3;0;3
20026;Žirmūnėliai;DEBESĖLIAI;2904787614;Taip;1;3;0;4
20027;Žirmūnėliai;DEBESĖLIAI;3431320961;Taip;7;4;0;11
20028;Žirmūnėliai;DEBESĖLIAI;4347548125;Taip;22;0;0;22
20029;Žirmūnėliai;DEBESĖLIAI;3330603362;Taip;12;4;0;16
20030;Žirmūnėliai;DEBESĖLIAI;5440814849;Taip;3;5;4;12
20031;Žirmūnėliai;DEBESĖLIAI;7680479258;Taip;10;0;10;20
20032;Žirmūnėliai;DEBESĖLIAI;8136265008;Taip;0;18;0;18
20033;Žirmūnėliai;DEBESĖLIAI;7568228423;Taip;0;0;9;9
20034;Žirmūnėliai;DEBESĖLIAI;9813507899;Taip;5;0;4;9
20035;Žirmūnėliai;DEBESĖLIAI;8687642039;Taip;12;1;4;17
20036;Žirmūnėliai;DEBESĖLIAI;5982848146;Taip;6;3;4;13
20037;Žirmūnėliai;DEBESĖLIAI;3646039695;Taip;0;2;0;2
20038;Žirmūnėliai;DEBESĖLIAI;4653124134;Taip;18;0;1;19
20039;Žirmūnėliai;DEBESĖLIAI;4501490189;Ne;5;6;4;15
20040;Žirmūnėliai;DEBESĖLIAI;8239982682;Taip;5;0;3;8
20041;Žirmūnėliai;VIŠČIUKAI;2270868598;Taip;9;0;0;9
20042;Žirmūnėliai;VIŠČIUKAI;2802717644;Taip;8;0;0;8
20043;Žirmūnėliai;VIŠČIUKAI;3029428022;Taip;3;0;0;3
20044;Žirmūnėliai;VIŠČIUKAI;9759504463;Taip;7;0;0;7
20045;Žirmūnėliai;VIŠČIUKAI;4134541560;Taip;8;0;0;8
20046;Žirmūnėliai;VIŠČIUKAI;8481357052;Taip;13;0;0;13
20047;Žirmūnėliai;VIŠČIUKAI;6892941066;Taip;9;0;1;10
20048;Žirmūnėliai;VIŠČIUKAI;9858198555;Taip;5;0;2;7
20049;Žirmūnėliai;VIŠČIUKAI;3641319043;Taip;3;2;0;5
20050;Žirmūnėliai;VIŠČIUKAI;6523502376;Taip;8;0;0;8
20051;Žirmūnėliai;VIŠČIUKAI;9280663182;Taip;4;4;0;8
20052;Žirmūnėliai;VIŠČIUKAI;5281338626;Taip;12;2;0;14
20053;Žirmūnėliai;VIŠČIUKAI;9688006040;Taip;18;0;0;18
20054;Žirmūnėliai;VIŠČIUKAI;5622319185;Taip;15;0;0;15
20055;Žirmūnėliai;VIŠČIUKAI;7053321410;Taip;8;0;0;8
20056;Žirmūnėliai;VIŠČIUKAI;4512970900;Taip;5;0;1;6
20057;Žirmūnėliai;ZUIKUČIŲ;4291114238;Taip;0;4;0;4
20058;Žirmūnėliai;ZUIKUČIŲ;4836165731;Taip;8;0;4;12
20059;Žirmūnėliai;ZUIKUČIŲ;3762889366;Taip;8;3;0;11
20060;Žirmūnėliai;ZUIKUČIŲ;3977279181;Taip;0;4;0;4
20061;Žirmūnėliai;ZUIKUČIŲ;8002655555;Taip;5;9;0;14
20062;Žirmūnėliai;ZUIKUČIŲ;6427861912;Taip;0;0;3;3
20063;Žirmūnėliai;ZUIKUČIŲ;2736632324;Taip;2;2;0;4
20064;Žirmūnėliai;ZUIKUČIŲ;5892153807;Taip;0;1;3;4
20065;Žirmūnėliai;ZUIKUČIŲ;2870069039;Taip;0;1;3;4
20066;Žirmūnėliai;ZUIKUČIŲ;6543834058;Taip;0;0;6;6
20067;Žirmūnėliai;ZUIKUČIŲ;8271996884;Taip;0;9;2;11
20068;Žirmūnėliai;ZUIKUČIŲ;3012945005;Taip;3;1;0;4
20069;Žirmūnėliai;ZUIKUČIŲ;8782085662;Taip;16;0;0;16
20070;Žirmūnėliai;ZUIKUČIŲ;3174613910;Taip;3;1;0;4
20071;Žirmūnėliai;ZUIKUČIŲ;5668266601;Taip;5;0;3;8
20072;Žirmūnėliai;ZUIKUČIŲ;9472372819;Taip;0;2;1;3
20073;Žirmūnėliai;ZUIKUČIŲ;6812682361;Taip;7;0;4;11
20074;Žirmūnėliai;OBUOLIUKAI;4575123456;Taip;13;0;0;13
20075;Žirmūnėliai;OBUOLIUKAI;3795476732;Ne;13;0;0;13
20076;Žirmūnėliai;OBUOLIUKAI;1917500190;Taip;0;7;0;7
20077;Žirmūnėliai;OBUOLIUKAI;9002868728;Taip;0;5;0;5
20078;Žirmūnėliai;OBUOLIUKAI;2073922023;Taip;3;0;0;3
20079;Žirmūnėliai;OBUOLIUKAI;7059249540;Taip;0;3;0;3
20080;Žirmūnėliai;OBUOLIUKAI;4999561481;Taip;5;0;0;5
20081;Žirmūnėliai;OBUOLIUKAI;6358006462;Taip;3;3;0;6
20082;Žirmūnėliai;OBUOLIUKAI;2497258407;Taip;0;3;0;3
20083;Žirmūnėliai;OBUOLIUKAI;3949374730;Taip;4;0;0;4
20084;Žirmūnėliai;OBUOLIUKAI;6869102228;Taip;0;6;0;6
20085;Žirmūnėliai;OBUOLIUKAI;9367849317;Taip;0;3;0;3
20086;Žirmūnėliai;OBUOLIUKAI;9892620134;Taip;0;3;1;4
20087;Žirmūnėliai;OBUOLIUKAI;6450412481;Taip;0;4;0;4
20088;Žirmūnėliai;OBUOLIUKAI;1523231731;Taip;3;3;0;6
20089;Žirmūnėliai;OBUOLIUKAI;9225654910;Taip;2;4;0;6
20090;Žirmūnėliai;OBUOLIUKAI;5483418311;Taip;0;3;0;3
20091;Žirmūnėliai;OBUOLIUKAI;7945713337;Taip;0;3;0;3
20092;Žirmūnėliai;OBUOLIUKAI;8823426998;Taip;0;10;0;10
20093;Žirmūnėliai;DAINORĖLIAI;1255294064;Taip;0;1;9;10
20094;Žirmūnėliai;DAINORĖLIAI;5616289290;Taip;14;4;0;18
20095;Žirmūnėliai;DAINORĖLIAI;3520677404;Taip;10;3;0;13
20096;Žirmūnėliai;DAINORĖLIAI;9978718231;Taip;0;1;1;2
20097;Žirmūnėliai;DAINORĖLIAI;6066212109;Taip;7;1;2;10
20098;Žirmūnėliai;DAINORĖLIAI;7589155099;Taip;12;0;0;12
20099;Žirmūnėliai;DAINORĖLIAI;4641264260;Taip;7;1;1;9
20100;Žirmūnėliai;DAINORĖLIAI;8794707243;Taip;0;2;4;6
20101;Žirmūnėliai;DAINORĖLIAI;3546787595;Taip;0;2;0;2
20102;Žirmūnėliai;DAINORĖLIAI;1724203157;Taip;1;0;0;1
20103;Žirmūnėliai;DAINORĖLIAI;5646794795;Taip;0;0;7;7
20104;Žirmūnėliai;DAINORĖLIAI;5901940160;Taip;3;3;0;6
20105;Žirmūnėliai;DAINORĖLIAI;9908958250;Taip;16;0;0;16
20106;Žirmūnėliai;DAINORĖLIAI;1116572386;Taip;7;1;2;10
20107;Žirmūnėliai;DAINORĖLIAI;6991062262;Taip;8;0;0;8
20108;"Dainorėliai (Ankštoji g. 11)";VARPELIAI;87242570532;Taip;0;3;0;3
20109;"Dainorėliai (Ankštoji g. 11)";VARPELIAI;18233813290;Taip;0;3;0;3
20110;"Dainorėliai (Ankštoji g. 11)";VARPELIAI;6176171443;Taip;0;4;0;4
20111;"Dainorėliai (Ankštoji g. 11)";VARPELIAI;88781762328;Taip;0;4;0;4
20112;"Dainorėliai (Ankštoji g. 11)";VARPELIAI;7822546498;Taip;0;4;0;4
20113;"Dainorėliai (Ankštoji g. 11)";VARPELIAI;5693385617;Taip;0;3;0;3
20114;"Dainorėliai (Ankštoji g. 11)";VARPELIAI;8267213392;Taip;0;3;0;3
20115;"Dainorėliai (Ankštoji g. 11)";VARPELIAI;5959380807;Taip;0;5;0;5
20116;"Dainorėliai (Ankštoji g. 11)";VARPELIAI;2938732886;Taip;0;3;0;3
20117;"Dainorėliai (Ankštoji g. 11)";VARPELIAI;3183793211;Taip;3;3;0;6
20118;"Dainorėliai (Ankštoji g. 11)";VARPELIAI;65467351140;Taip;0;5;0;5
20119;"Dainorėliai (Ankštoji g. 11)";VARPELIAI;8521878734;Taip;0;4;0;4
20120;"Dainorėliai (Ankštoji g. 11)";VARPELIAI;1928369859;Taip;5;3;0;8
20121;"Dainorėliai (Ankštoji g. 11)";VARPELIAI;6430425182;Taip;0;3;0;3
20122;"Dainorėliai (Ankštoji g. 11)";VARPELIAI;4269946363;Taip;0;4;0;4
20123;"Dainorėliai (Ankštoji g. 11)";VARPELIAI;1088248393;Taip;0;4;0;4
20124;"Dainorėliai (Ankštoji g. 11)";VARPELIAI;2070086316;Taip;0;4;0;4
20125;"Dainorėliai (Ankštoji g. 11)";VARPELIAI;2074070030;Taip;3;3;0;6
20126;"Dainorėliai (Ankštoji g. 11)";VARPELIAI;4591161640;Taip;0;3;0;3
20127;"Dainorėliai (Ankštoji g. 11)";VARPELIAI;6898685834;Taip;7;3;0;10
20128;"Dainorėliai (Ankštoji g. 11)";VARPELIAI;6909583023;Taip;0;1;0;1
20129;"Dainorėliai (Ankštoji g. 11)";VARPELIAI;9319771186;Taip;0;4;5;9
20130;"Dainorėliai (Ankštoji g. 11)";VARPELIAI;68134437706;Taip;0;4;0;4
20131;"Dainorėliai (Ankštoji g. 11)";ŽIOGELIAI;5591598390;Taip;0;4;0;4
20132;"Dainorėliai (Ankštoji g. 11)";ŽIOGELIAI;6481621329;Ne;0;2;0;2
20133;"Dainorėliai (Ankštoji g. 11)";ŽIOGELIAI;5715129088;Taip;8;0;1;9
20134;"Dainorėliai (Ankštoji g. 11)";ŽIOGELIAI;9132532505;Taip;7;3;1;11
20135;"Dainorėliai (Ankštoji g. 11)";ŽIOGELIAI;2450726148;Taip;4;2;0;6
20136;"Dainorėliai (Ankštoji g. 11)";ŽIOGELIAI;5793828922;Taip;5;4;0;9
20137;"Dainorėliai (Ankštoji g. 11)";ŽIOGELIAI;7591953671;Taip;0;18;0;18
20138;"Dainorėliai (Ankštoji g. 11)";ŽIOGELIAI;6169434322;Taip;0;4;0;4
20139;"Dainorėliai (Ankštoji g. 11)";ŽIOGELIAI;2094849111;Taip;8;6;0;14
20140;"Dainorėliai (Ankštoji g. 11)";ŽIOGELIAI;6659114730;Taip;0;6;0;6
20141;"Dainorėliai (Ankštoji g. 11)";ŽIOGELIAI;3887433142;Taip;11;3;0;14
20142;"Dainorėliai (Ankštoji g. 11)";ŽIOGELIAI;2541781620;Taip;0;5;0;5
20143;"Dainorėliai (Ankštoji g. 11)";ŽIOGELIAI;8239000041;Taip;0;6;0;6
20144;"Dainorėliai (Ankštoji g. 11)";ŽIOGELIAI;7984447187;Taip;7;0;0;7
20145;"Dainorėliai (Ankštoji g. 11)";ŽIOGELIAI;3897725337;Taip;5;0;0;5
20146;"Dainorėliai (Ankštoji g. 11)";ŽIOGELIAI;3598951899;Taip;0;4;0;4
20147;"Dainorėliai (Ankštoji g. 11)";ŽIOGELIAI;4973241539;Taip;3;4;3;10
20148;"Dainorėliai (Ankštoji g. 11)";ŽIOGELIAI;3592770633;Taip;0;1;0;1
20149;"Dainorėliai (Ankštoji g. 11)";ŽIOGELIAI;4969782237;Taip;0;3;0;3
20150;"Dainorėliai (Ankštoji g. 11)";DRUGELIAI;9592384914;Taip;0;10;3;13
20151;"Dainorėliai (Ankštoji g. 11)";DRUGELIAI;6403389248;Taip;0;4;0;4
20152;"Dainorėliai (Ankštoji g. 11)";DRUGELIAI;4900234806;Taip;5;0;2;7
20153;"Dainorėliai (Ankštoji g. 11)";DRUGELIAI;8962657389;Taip;0;4;0;4
20154;"Dainorėliai (Ankštoji g. 11)";DRUGELIAI;2703267758;Taip;0;3;0;3
20155;"Dainorėliai (Ankštoji g. 11)";DRUGELIAI;6899629612;Taip;0;1;0;1
20156;"Dainorėliai (Ankštoji g. 11)";DRUGELIAI;2605119306;Taip;4;3;0;7
20157;"Dainorėliai (Ankštoji g. 11)";DRUGELIAI;9976869100;Taip;3;0;1;4
20158;"Dainorėliai (Ankštoji g. 11)";DRUGELIAI;3063825996;Taip;0;4;5;9
20159;"Dainorėliai (Ankštoji g. 11)";DRUGELIAI;9303046800;Taip;3;3;0;6
20160;"Dainorėliai (Ankštoji g. 11)";DRUGELIAI;5854379630;Taip;0;4;0;4
20161;"Dainorėliai (Ankštoji g. 11)";DRUGELIAI;3711954197;Taip;10;0;0;10
20162;"Dainorėliai (Ankštoji g. 11)";DRUGELIAI;3573324654;Taip;0;3;0;3
20163;"Dainorėliai (Ankštoji g. 11)";DRUGELIAI;3741337791;Taip;0;3;0;3
20164;"Dainorėliai (Ankštoji g. 11)";DRUGELIAI;8088948564;Taip;0;1;0;1
20165;"Dainorėliai (Ankštoji g. 11)";DRUGELIAI;1718576253;Taip;0;5;0;5
20166;"Dainorėliai (Ankštoji g. 11)";DRUGELIAI;2803571247;Taip;0;6;0;6
20167;"Dainorėliai (Ankštoji g. 11)";DRUGELIAI;5084474142;Taip;0;3;0;3
20168;"Dainorėliai (Ankštoji g. 11)";DRUGELIAI;1332165159;Taip;15;0;0;15
20169;"Dainorėliai (Ankštoji g. 11)";DRUGELIAI;8684975630;Taip;0;4;3;7
20170;"Dainorėliai (Ankštoji g. 11)";DRUGELIAI;2740773904;Taip;0;3;0;3
20171;"Dainorėliai (Ankštoji g. 11)";DRUGELIAI;6460217912;Taip;0;5;2;7
20172;"Dainorėliai (Ankštoji g. 11)";"1 klasė";2520667095;Taip;0;3;0;3
20173;"Dainorėliai (Ankštoji g. 11)";"1 klasė";1333499160;Taip;0;3;0;3
20174;"Dainorėliai (Ankštoji g. 11)";"1 klasė";50432354832;Taip;0;3;0;3
20175;"Dainorėliai (Ankštoji g. 11)";"1 klasė";1626877066;Taip;5;3;0;8
20176;"Dainorėliai (Ankštoji g. 11)";"1 klasė";1158895670;Taip;0;3;0;3
20177;"Dainorėliai (Ankštoji g. 11)";"1 klasė";73649870571;Taip;0;3;0;3
20178;"Dainorėliai (Ankštoji g. 11)";"1 klasė";19286303769;Taip;0;3;0;3
20179;"Dainorėliai (Ankštoji g. 11)";"1 klasė";73386013083;Taip;6;3;0;9
20180;"Dainorėliai (Ankštoji g. 11)";"1 klasė";27521381629;Taip;1;3;0;4
20181;"Dainorėliai (Ankštoji g. 11)";"1 klasė";53935690864;Taip;0;3;0;3
20182;"Dainorėliai (Ankštoji g. 11)";"1 klasė";6411939690;Taip;0;3;0;3
20183;"Dainorėliai (Ankštoji g. 11)";"1 klasė";2287353933;Taip;4;3;0;7
20184;"Dainorėliai (Ankštoji g. 11)";"1 klasė";36313982965;Taip;1;3;0;4
20185;"Dainorėliai (Ankštoji g. 11)";"1 klasė";86659723162;Taip;0;3;0;3
20186;"Dainorėliai (Ankštoji g. 11)";"1 klasė";5479496104;Taip;3;3;0;6
20187;"Dainorėliai (Ankštoji g. 11)";"1 klasė";94480397292;Ne;0;3;0;3
20188;"Dainorėliai (Ankštoji g. 11)";"1 klasė";6404337541;Taip;1;3;0;4
20189;"Dainorėliai (Ankštoji g. 11)";"1 klasė";49483881135;Taip;2;3;0;5
20190;"Dainorėliai (Ankštoji g. 11)";"1 klasė";86187568203;Taip;1;3;0;4
20191;"Dainorėliai (Ankštoji g. 11)";"1 klasė";1015870220;Taip;0;3;0;3
20192;"Dainorėliai (Ankštoji g. 11)";"1 klasė";7114409929;Taip;1;3;0;4
20193;"Dainorėliai (Ankštoji g. 11)";"1 klasė";1084400276;Taip;0;3;0;3
20194;"Dainorėliai (Ankštoji g. 11)";"1 klasė";1531362555;Ne;7;3;0;10
20195;"Dainorėliai (Ankštoji g. 11)";"1 klasė";6195426672;Taip;0;3;0;3
20196;"Dainorėliai (Ankštoji g. 11)";"2 klasė";67124516230;Ne;5;3;0;8
20197;"Dainorėliai (Ankštoji g. 11)";"2 klasė";7506194777;Taip;0;3;0;3
20198;"Dainorėliai (Ankštoji g. 11)";"2 klasė";1829858221;Taip;1;3;0;4
20199;"Dainorėliai (Ankštoji g. 11)";"2 klasė";1470784692;Taip;0;3;0;3
20200;"Dainorėliai (Ankštoji g. 11)";"2 klasė";7569146994;Taip;0;3;0;3
20201;"Dainorėliai (Ankštoji g. 11)";"2 klasė";45577031767;Taip;0;3;0;3
20202;"Dainorėliai (Ankštoji g. 11)";"2 klasė";58071607976;Taip;0;3;0;3
20203;"Dainorėliai (Ankštoji g. 11)";"2 klasė";1646521870;Taip;0;3;0;3
20204;"Dainorėliai (Ankštoji g. 11)";"2 klasė";29132059636;Taip;0;3;0;3
20205;"Dainorėliai (Ankštoji g. 11)";"2 klasė";32573583030;Taip;0;3;0;3
20206;"Dainorėliai (Ankštoji g. 11)";"2 klasė";97947842490;Taip;0;3;0;3
20207;"Dainorėliai (Ankštoji g. 11)";"2 klasė";63211091321;Taip;2;3;0;5
20208;"Dainorėliai (Ankštoji g. 11)";"2 klasė";87717571411;Taip;0;3;0;3
20209;"Dainorėliai (Ankštoji g. 11)";"2 klasė";18936645521;Ne;0;3;0;3
20210;"Dainorėliai (Ankštoji g. 11)";"2 klasė";80499999855;Ne;0;3;0;3
20211;"Dainorėliai (Ankštoji g. 11)";"2 klasė";6948863728;Taip;0;3;0;3
20212;"Dainorėliai (Ankštoji g. 11)";"2 klasė";2531690903;Taip;8;3;0;11
20213;"Dainorėliai (Ankštoji g. 11)";"2 klasė";35134511946;Taip;0;3;0;3
20214;"Dainorėliai (Ankštoji g. 11)";"2 klasė";1121139222;Taip;2;3;0;5
20215;"Dainorėliai (Ankštoji g. 11)";"2 klasė";99597416067;Taip;0;3;0;3
20216;"Dainorėliai (Ankštoji g. 11)";"2 klasė";77718940253;Taip;0;3;0;3
20217;"Dainorėliai (Ankštoji g. 11)";"2 klasė";5236797727;Taip;0;3;0;3
20218;"Dainorėliai (Ankštoji g. 11)";"3 klasė";2045625141;Taip;0;3;0;3
20219;"Dainorėliai (Ankštoji g. 11)";"3 klasė";84084897419;Taip;0;3;0;3
20220;"Dainorėliai (Ankštoji g. 11)";"3 klasė";34219208558;Taip;0;3;0;3
20221;"Dainorėliai (Ankštoji g. 11)";"3 klasė";13138644060;Taip;0;3;0;3
20222;"Dainorėliai (Ankštoji g. 11)";"3 klasė";49342277188;Taip;0;3;0;3
20223;"Dainorėliai (Ankštoji g. 11)";"3 klasė";42402953271;Taip;5;3;0;8
20224;"Dainorėliai (Ankštoji g. 11)";"3 klasė";2441164154;Taip;1;3;0;4
20225;"Dainorėliai (Ankštoji g. 11)";"3 klasė";69556449215;Taip;0;3;0;3
20226;"Dainorėliai (Ankštoji g. 11)";"3 klasė";8244355193;Taip;0;3;0;3
20227;"Dainorėliai (Ankštoji g. 11)";"3 klasė";2142553899;Taip;1;3;0;4
20228;"Dainorėliai (Ankštoji g. 11)";"3 klasė";37660372564;Taip;0;3;0;3
20229;"Dainorėliai (Ankštoji g. 11)";"3 klasė";1889037823;Taip;6;3;0;9
20230;"Dainorėliai (Ankštoji g. 11)";"3 klasė";98796240124;Taip;3;3;0;6
20231;"Dainorėliai (Ankštoji g. 11)";"3 klasė";98830139164;Taip;0;3;0;3
20232;"Dainorėliai (Ankštoji g. 11)";"3 klasė";37708779599;Taip;0;3;0;3
20233;"Dainorėliai (Ankštoji g. 11)";"3 klasė";18741625569;Taip;0;3;0;3
20234;"Dainorėliai (Ankštoji g. 11)";"3 klasė";84424772471;Taip;0;3;0;3
20235;"Dainorėliai (Ankštoji g. 11)";"3 klasė";34686211072;Taip;0;3;0;3
20236;"Dainorėliai (Ankštoji g. 11)";"3 klasė";79461209783;Taip;0;3;0;3
20237;"Dainorėliai (Ankštoji g. 11)";"3 klasė";47323045857;Taip;2;3;0;5
20238;"Dainorėliai (Ankštoji g. 11)";"3 klasė";10679627657;Taip;1;3;0;4
20239;"Dainorėliai (Ankštoji g. 11)";"3 klasė";25073134850;Taip;2;3;0;5
20240;"Dainorėliai (Ankštoji g. 11)";"3 klasė";65118883315;Taip;0;3;0;3
20241;"Dainorėliai (Ankštoji g. 11)";"3 klasė";84999972369;Taip;2;3;0;5
20242;"Dainorėliai (Ankštoji g. 11)";"3 klasė";1209781483;Taip;0;3;0;3
20243;"Dainorėliai (Ankštoji g. 11)";"3 klasė";69732047046;Taip;4;3;0;7
20244;"Dainorėliai (Ankštoji g. 11)";"4 klasė";29726515194;Taip;4;3;0;7
20245;"Dainorėliai (Ankštoji g. 11)";"4 klasė";8562371599;Taip;0;3;0;3
20246;"Dainorėliai (Ankštoji g. 11)";"4 klasė";19292860218;Taip;0;3;0;3
20247;"Dainorėliai (Ankštoji g. 11)";"4 klasė";97182565649;Taip;0;3;0;3
20248;"Dainorėliai (Ankštoji g. 11)";"4 klasė";65982869126;Taip;2;3;0;5
20249;"Dainorėliai (Ankštoji g. 11)";"4 klasė";93738984644;Taip;1;3;0;4
20250;"Dainorėliai (Ankštoji g. 11)";"4 klasė";69409530494;Taip;0;3;0;3
20251;"Dainorėliai (Ankštoji g. 11)";"4 klasė";57179351170;Taip;0;3;0;3
20252;"Dainorėliai (Ankštoji g. 11)";"4 klasė";77907054102;Taip;2;3;0;5
20253;"Dainorėliai (Ankštoji g. 11)";"4 klasė";24048489264;Taip;1;3;0;4
20254;"Dainorėliai (Ankštoji g. 11)";"4 klasė";4773358825;Taip;0;3;0;3
20255;"Dainorėliai (Ankštoji g. 11)";"4 klasė";91457137356;Taip;0;3;0;3
20256;"Dainorėliai (Ankštoji g. 11)";"4 klasė";5010994621;Taip;0;3;0;3
20257;"Dainorėliai (Ankštoji g. 11)";"4 klasė";13846131820;Taip;0;3;0;3
20258;"Dainorėliai (Ankštoji g. 11)";"4 klasė";23144978287;Taip;1;3;0;4
20259;"Dainorėliai (Ankštoji g. 11)";"4 klasė";6203511535;Taip;0;3;0;3
20260;"Dainorėliai (Ankštoji g. 11)";"4 klasė";81956978417;Taip;0;3;0;3
20261;"Dainorėliai (Ankštoji g. 11)";"4 klasė";3018657993;Taip;0;3;0;3
20262;"Dainorėliai (Ankštoji g. 11)";"4 klasė";48245075123;Taip;2;3;0;5
20263;"Dainorėliai (Ankštoji g. 11)";"4 klasė";57618865048;Taip;2;3;0;5
20264;"Dainorėliai (Ankštoji g. 11)";"4 klasė";84749521489;Taip;0;3;0;3
20265;"Dainorėliai (Ankštoji g. 11)";"4 klasė";26315465923;Taip;0;3;0;3
20266;Lokiukas;BITUTĖS;3329205450;Taip;10;3;1;14
20267;Lokiukas;BITUTĖS;7920238202;Taip;0;1;2;3
20268;Lokiukas;BITUTĖS;1376124245;Taip;0;18;0;18
20269;Lokiukas;BITUTĖS;2181315008;Taip;0;1;3;4
20270;Lokiukas;BITUTĖS;3896883842;Taip;8;0;1;9
20271;Lokiukas;BITUTĖS;8656751314;Taip;10;0;2;12
20272;Lokiukas;BITUTĖS;4551069961;Taip;3;3;0;6
20273;Lokiukas;BITUTĖS;5794303981;Taip;10;3;1;14
20274;Lokiukas;BITUTĖS;2671053309;Taip;0;7;0;7
20275;Lokiukas;BITUTĖS;5217458476;Taip;4;3;2;9
20276;Lokiukas;BITUTĖS;6883994020;Taip;8;0;0;8
20277;Lokiukas;BITUTĖS;8209165996;Taip;14;0;0;14
20278;Lokiukas;BITUTĖS;1647778939;Taip;0;3;6;9
20279;Lokiukas;BITUTĖS;9480025132;Taip;10;1;0;11
20280;Lokiukas;BITUTĖS;6260486656;Taip;0;9;1;10
20281;Lokiukas;BITUTĖS;2126391728;Taip;0;1;1;2
20282;Lokiukas;BITUTĖS;8334800302;Taip;0;3;0;3
20283;Lokiukas;BITUTĖS;1987485885;Ne;4;3;2;9
20284;Lokiukas;BITUTĖS;8378138411;Taip;10;1;0;11
20285;Lokiukas;BITUTĖS;3397999534;Taip;0;2;3;5
20286;Lokiukas;BITUTĖS;8059759103;Taip;6;1;0;7
20287;Lokiukas;BITUTĖS;8994257898;Taip;0;2;2;4
20288;Lokiukas;"1 B klasė";14605095801;Taip;0;3;0;3
20289;Lokiukas;"1 B klasė";8036643654;Taip;3;3;0;6
20290;Lokiukas;"1 B klasė";5879386524;Taip;1;3;0;4
20291;Lokiukas;"1 B klasė";9625041533;Ne;0;3;0;3
20292;Lokiukas;"1 B klasė";2476231041;Ne;1;3;0;4
20293;Lokiukas;"1 B klasė";2548712970;Taip;11;3;0;14
20294;Lokiukas;"1 B klasė";1570438208;Taip;18;0;0;18
20295;Lokiukas;"1 B klasė";2673522432;Taip;18;0;0;18
20296;Lokiukas;"1 B klasė";47399326083;Taip;0;3;0;3
20297;Lokiukas;"1 B klasė";7591418969;Taip;1;3;0;4
20298;Lokiukas;"1 B klasė";4569798381;Taip;18;0;0;18
20299;Lokiukas;"1 B klasė";8399364170;Taip;1;3;0;4
20300;Lokiukas;"1 B klasė";97284171512;Taip;0;3;0;3
20301;Lokiukas;"1 B klasė";5943583254;Taip;0;3;0;3
20302;Lokiukas;"1 B klasė";3070998871;Taip;1;3;0;4
20303;Lokiukas;"1 B klasė";5453470660;Taip;2;3;0;5
20304;Lokiukas;"1 B klasė";4427448272;Taip;18;0;0;18
20305;Lokiukas;"1 B klasė";20659573470;Taip;18;0;0;18
20306;Lokiukas;"1 B klasė";5437008837;Taip;0;3;0;3
20307;Lokiukas;"1 B klasė";4580716838;Taip;2;3;0;5
20308;Lokiukas;"1 B klasė";39975872119;Taip;0;3;0;3
20309;Lokiukas;"1 B klasė";8568285232;Taip;3;3;0;6
20310;Lokiukas;"1 B klasė";9501202273;Taip;2;3;0;5
20311;Lokiukas;"1 B klasė";8943496964;Ne;18;0;0;18
20312;Lokiukas;"1 A klasė";56069293343;Taip;4;0;0;4
20313;Lokiukas;"1 A klasė";69364831994;Ne;0;3;0;3
20314;Lokiukas;"1 A klasė";1230490562;Ne;11;0;0;11
20315;Lokiukas;"1 A klasė";8452600632;Taip;12;0;0;12
20316;Lokiukas;"1 A klasė";39222094073;Taip;18;0;0;18
20317;Lokiukas;"1 A klasė";74169282323;Taip;2;3;0;5
20318;Lokiukas;"1 A klasė";35890122494;Taip;4;0;0;4
20319;Lokiukas;"1 A klasė";1626698185;Taip;7;3;0;10
20320;Lokiukas;"1 A klasė";8455869600;Taip;2;3;0;5
20321;Lokiukas;"1 A klasė";1625137322;Taip;6;3;0;9
20322;Lokiukas;"1 A klasė";2170176922;Ne;0;3;0;3
20323;Lokiukas;"1 A klasė";8270572748;Ne;3;3;0;6
20324;Lokiukas;"1 A klasė";34800098950;Taip;4;0;0;4
20325;Lokiukas;"1 A klasė";3825101647;Ne;15;3;0;18
20326;Lokiukas;"1 A klasė";8618280811;Taip;15;3;0;18
20327;Lokiukas;"1 A klasė";8323172347;Taip;5;0;0;5
20328;Lokiukas;"1 A klasė";7844351275;Taip;0;3;0;3
20329;Lokiukas;"1 A klasė";2045735700;Taip;1;3;0;4
20330;Lokiukas;"1 A klasė";3981653153;Ne;0;3;0;3
20331;Lokiukas;"1 A klasė";6318538591;Taip;4;0;0;4
20332;Lokiukas;"1 A klasė";43500434912;Taip;2;3;0;5
20333;Lokiukas;"1 A klasė";25141529581;Taip;0;3;0;3
20334;Lokiukas;"1 A klasė";3369746590;Taip;2;3;0;5
20335;Lokiukas;"1 A klasė";3004895246;Ne;15;3;0;18
20336;Lokiukas;"1 A klasė";3061816821;Ne;1;3;0;4
20337;Lokiukas;GUDRUČIAI;1604886863;Ne;0;3;2;5
20338;Lokiukas;GUDRUČIAI;3826815202;Taip;0;3;0;3
20339;Lokiukas;GUDRUČIAI;8687864179;Taip;4;3;1;8
20340;Lokiukas;GUDRUČIAI;5446430319;Taip;4;3;0;7
20341;Lokiukas;GUDRUČIAI;5995034919;Taip;0;9;0;9
20342;Lokiukas;GUDRUČIAI;2354942164;Taip;0;3;1;4
20343;Lokiukas;GUDRUČIAI;35364823312;Taip;0;3;1;4
20344;Lokiukas;GUDRUČIAI;5076773045;Taip;0;3;3;6
20345;Lokiukas;GUDRUČIAI;1188049956;Taip;0;3;0;3
20346;Lokiukas;GUDRUČIAI;1620856143;Ne;1;3;0;4
20347;Lokiukas;GUDRUČIAI;1733486244;Taip;0;3;0;3
20348;Lokiukas;GUDRUČIAI;4633366779;Taip;0;8;0;8
20349;Lokiukas;GUDRUČIAI;3485639108;Taip;0;3;0;3
20350;Lokiukas;GUDRUČIAI;3991821717;Taip;0;3;0;3
20351;Lokiukas;GUDRUČIAI;1606617694;Taip;10;4;0;14
20352;Lokiukas;GUDRUČIAI;8243342948;Taip;0;3;0;3
20353;Lokiukas;GUDRUČIAI;1210407640;Taip;0;18;0;18
20354;Lokiukas;BORUŽĖLĖS;4849031542;Taip;0;3;0;3
20355;Lokiukas;BORUŽĖLĖS;2625981190;Taip;5;1;1;7
20356;Lokiukas;BORUŽĖLĖS;4585621105;Taip;0;3;0;3
20357;Lokiukas;BORUŽĖLĖS;8576418875;Taip;0;11;0;11
20358;Lokiukas;BORUŽĖLĖS;4617372387;Taip;0;3;0;3
20359;Lokiukas;BORUŽĖLĖS;6869785650;Taip;0;4;0;4
20360;Lokiukas;BORUŽĖLĖS;8630112458;Taip;10;3;0;13
20361;Lokiukas;BORUŽĖLĖS;3930463578;Taip;0;3;2;5
20362;Lokiukas;BORUŽĖLĖS;6277388612;Taip;0;3;1;4
20363;Lokiukas;BORUŽĖLĖS;2660616022;Taip;0;1;0;1
20364;Lokiukas;BORUŽĖLĖS;9798351980;Taip;0;1;7;8
20365;Lokiukas;BORUŽĖLĖS;5401463671;Ne;0;2;3;5
20366;Lokiukas;BORUŽĖLĖS;9996442005;Ne;0;2;3;5
20367;Lokiukas;BORUŽĖLĖS;4317453894;Taip;0;3;0;3
20368;Lokiukas;BORUŽĖLĖS;1226376844;Taip;0;3;0;3
20369;Lokiukas;BORUŽĖLĖS;4840187188;Taip;12;3;0;15
20370;Lokiukas;BORUŽĖLĖS;1724976098;Taip;0;14;0;14
20371;Lokiukas;BORUŽĖLĖS;7426579018;Taip;12;3;0;15
20372;Lokiukas;BORUŽĖLĖS;1974049743;Taip;0;4;4;8
20373;Lokiukas;BORUŽĖLĖS;3733581089;Taip;0;4;1;5
20374;Lokiukas;BORUŽĖLĖS;3876368364;Taip;13;3;0;16
20375;Lokiukas;BORUŽĖLĖS;9354491312;Taip;15;3;0;18
20376;Lokiukas;BORUŽĖLĖS;6091878190;Taip;0;1;0;1
20377;Lokiukas;BORUŽĖLĖS;1076719080;Taip;13;3;0;16
20378;Lokiukas;ANČIUKAI;5473316050;Taip;0;3;0;3
20379;Lokiukas;ANČIUKAI;5670185948;Ne;0;3;3;6
20380;Lokiukas;ANČIUKAI;5843699073;Taip;0;3;3;6
20381;Lokiukas;ANČIUKAI;4788062781;Taip;1;3;0;4
20382;Lokiukas;ANČIUKAI;8758248334;Taip;2;3;2;7
20383;Lokiukas;ANČIUKAI;2466354050;Taip;0;1;0;1
20384;Lokiukas;ANČIUKAI;3849212461;Taip;5;1;2;8
20385;Lokiukas;ANČIUKAI;1756658146;Taip;6;3;1;10
20386;Lokiukas;ANČIUKAI;3668903653;Taip;10;2;1;13
20387;Lokiukas;ANČIUKAI;7509043689;Taip;8;3;0;11
20388;Lokiukas;ANČIUKAI;9673257342;Taip;0;1;0;1
20389;Lokiukas;ANČIUKAI;2266747745;Taip;18;0;0;18
20390;Lokiukas;ANČIUKAI;4417116107;Taip;0;7;1;8
20391;Lokiukas;ANČIUKAI;5893844708;Taip;0;3;3;6
20392;Lokiukas;ANČIUKAI;3015119335;Taip;0;3;0;3
20393;Lokiukas;ANČIUKAI;1712365476;Taip;0;18;0;18
20394;Lokiukas;ANČIUKAI;6827710384;Taip;0;18;0;18
20395;Lokiukas;KODĖLČIUKAI;2642065594;Taip;3;4;0;7
20396;Lokiukas;KODĖLČIUKAI;5943412920;Taip;3;3;0;6
20397;Lokiukas;KODĖLČIUKAI;6758550653;Taip;12;3;0;15
20398;Lokiukas;KODĖLČIUKAI;6336140882;Taip;0;8;2;10
20399;Lokiukas;KODĖLČIUKAI;8796640190;Taip;10;3;0;13
20400;Lokiukas;KODĖLČIUKAI;8775608581;Taip;0;1;0;1
20401;Lokiukas;KODĖLČIUKAI;8915504279;Taip;0;9;0;9
20402;Lokiukas;KODĖLČIUKAI;4379238557;Taip;0;4;0;4
20403;Lokiukas;KODĖLČIUKAI;3694653020;Ne;2;6;0;8
20404;Lokiukas;KODĖLČIUKAI;4060641736;Ne;0;10;0;10
20405;Lokiukas;KODĖLČIUKAI;1025576053;Taip;0;3;0;3
20406;Lokiukas;KODĖLČIUKAI;1040288021;Taip;0;3;0;3
20407;Lokiukas;KODĖLČIUKAI;34546519642;Taip;0;2;0;2
20408;Lokiukas;KODĖLČIUKAI;7943213321;Taip;0;5;0;5
20409;Lokiukas;KODĖLČIUKAI;6069516217;Taip;0;10;0;10
20410;Lokiukas;KODĖLČIUKAI;1752784666;Taip;0;4;0;4
20411;Lokiukas;KODĖLČIUKAI;4007839265;Taip;0;3;0;3
20412;Lokiukas;KODĖLČIUKAI;5467387832;Taip;4;3;0;7
20413;Lokiukas;KODĖLČIUKAI;9307491947;Taip;5;3;0;8
20414;Lokiukas;KODĖLČIUKAI;3744484616;Taip;0;5;0;5
20415;Lokiukas;KODĖLČIUKAI;8286358519;Taip;0;3;1;4
20416;Lokiukas;KODĖLČIUKAI;1886540733;Taip;0;3;0;3
20417;Lokiukas;KODĖLČIUKAI;8902619265;Taip;0;1;0;1
20418;Lokiukas;DRUGELIAI;1170293017;Taip;3;3;1;7
20419;Lokiukas;DRUGELIAI;4442073527;Taip;0;3;0;3
20420;Lokiukas;DRUGELIAI;2021477393;Taip;3;4;0;7
20421;Lokiukas;DRUGELIAI;4206181176;Taip;0;3;0;3
20422;Lokiukas;DRUGELIAI;7006828256;Taip;0;1;0;1
20423;Lokiukas;DRUGELIAI;7532603655;Taip;0;5;0;5
20424;Lokiukas;DRUGELIAI;4858829710;Taip;6;1;1;8
20425;Lokiukas;DRUGELIAI;8329540746;Taip;0;1;0;1
20426;Lokiukas;DRUGELIAI;2782818158;Ne;0;2;1;3
20427;Lokiukas;DRUGELIAI;4197547631;Taip;0;2;1;3
20428;Lokiukas;DRUGELIAI;8596706753;Taip;0;4;0;4
20429;Lokiukas;DRUGELIAI;4272205822;Taip;0;3;0;3
20430;Lokiukas;DRUGELIAI;2374601283;Taip;0;3;1;4
20431;Lokiukas;DRUGELIAI;7195184433;Taip;6;4;0;10
20432;Lokiukas;DRUGELIAI;4919744559;Taip;15;3;0;18
20433;Lokiukas;DRUGELIAI;6226281752;Taip;3;3;0;6
20434;Lokiukas;DRUGELIAI;1390586527;Taip;5;3;2;10
20435;Lokiukas;DRUGELIAI;8266708371;Taip;0;1;0;1
20436;Lokiukas;DRUGELIAI;2093224908;Taip;0;7;0;7
20437;Lokiukas;DRUGELIAI;1341265560;Taip;0;5;0;5
20438;Lokiukas;DRUGELIAI;5131662172;Ne;4;2;0;6
20439;Lokiukas;DRUGELIAI;1913742619;Ne;0;4;0;4
20440;Lokiukas;DRUGELIAI;4284574166;Ne;4;3;1;8
20441;Lokiukas;"2 A klasė";1201125655;Taip;2;3;0;5
20442;Lokiukas;"2 A klasė";2502465398;Taip;1;3;0;4
20443;Lokiukas;"2 A klasė";67133709394;Taip;1;3;0;4
20444;Lokiukas;"2 A klasė";73696992182;Taip;1;3;0;4
20445;Lokiukas;"2 A klasė";1056075876;Taip;5;3;0;8
20446;Lokiukas;"2 A klasė";9890308887;Taip;6;3;0;9
20447;Lokiukas;"2 A klasė";82025637099;Ne;3;3;0;6
20448;Lokiukas;"2 A klasė";8846527481;Taip;0;3;0;3
20449;Lokiukas;"2 A klasė";4353695640;Ne;10;0;0;10
20450;Lokiukas;"2 A klasė";73515179103;Taip;6;0;0;6
20451;Lokiukas;"2 A klasė";36677665098;Taip;5;3;0;8
20452;Lokiukas;"2 A klasė";131300206;Taip;4;0;0;4
20453;Lokiukas;"2 A klasė";77512682081;Taip;4;0;0;4
20454;Lokiukas;"2 A klasė";66528256040;Taip;4;0;0;4
20455;Lokiukas;"2 A klasė";86120193313;Taip;4;0;0;4
20456;Lokiukas;"2 A klasė";45028887854;Taip;4;0;0;4
20457;Lokiukas;"2 A klasė";83528495608;Taip;1;3;0;4
20458;Lokiukas;"2 A klasė";51237034253;Taip;4;0;0;4
20459;Lokiukas;"2 A klasė";52940830874;Taip;4;0;0;4
20460;Lokiukas;"2 A klasė";8240261104;Taip;4;0;0;4
20461;Lokiukas;"2 A klasė";27403835292;Taip;4;0;0;4
20462;Lokiukas;"2 A klasė";83086633109;Taip;3;1;0;4
20463;Lokiukas;"2 A klasė";38884246104;Taip;7;0;0;7
20464;Lokiukas;"2 B klasė";7235277422;Taip;3;3;0;6
20465;Lokiukas;"2 B klasė";1133294157;Taip;0;3;0;3
20466;Lokiukas;"2 B klasė";1072148409;Taip;0;3;0;3
20467;Lokiukas;"2 B klasė";92373834478;Ne;0;3;0;3
20468;Lokiukas;"2 B klasė";2054450461;Taip;5;3;0;8
20469;Lokiukas;"2 B klasė";3255141230;Taip;18;0;0;18
20470;Lokiukas;"2 B klasė";3255141230;Taip;18;0;0;18
20471;Lokiukas;"2 B klasė";14234831040;Taip;4;3;0;7
20472;Lokiukas;"2 B klasė";57505829630;Taip;0;3;0;3
20473;Lokiukas;"2 B klasė";7334971595;Taip;1;3;0;4
20474;Lokiukas;"2 B klasė";51059574159;Taip;0;3;0;3
20475;Lokiukas;"2 B klasė";4662981914;Taip;0;3;0;3
20476;Lokiukas;"2 B klasė";2959877846;Taip;18;0;0;18
20477;Lokiukas;"2 B klasė";6414861823;Taip;18;0;0;18
20478;Lokiukas;"2 B klasė";7130407913;Taip;18;0;0;18
20479;Lokiukas;"2 B klasė";98045145204;Taip;2;3;0;5
20480;Lokiukas;"2 B klasė";68390568000;Taip;0;3;0;3
20481;Lokiukas;"2 B klasė";8980902068;Taip;3;3;0;6
20482;Lokiukas;"2 B klasė";4164426360;Taip;0;3;0;3
20483;Lokiukas;"2 B klasė";14937983736;Taip;0;3;0;3
20484;Lokiukas;"2 B klasė";8996622650;Taip;0;3;0;3
20485;Lokiukas;"2 B klasė";61807094999;Taip;0;3;0;3
20486;Lokiukas;"2 B klasė";2078673522;Taip;1;3;0;4
20487;Lokiukas;"2 B klasė";40006848965;Taip;0;3;0;3
20488;Lokiukas;"2 B klasė";32714964224;Taip;0;3;0;3
20489;Lokiukas;"2 B klasė";8920359311;Taip;0;3;0;3
20490;Lokiukas;"2 B klasė";38001876942;Taip;1;3;0;4
20491;Lokiukas;"3 A klasė";25170045140;Taip;18;0;0;18
20492;Lokiukas;"3 A klasė";15406362908;Taip;8;0;0;8
20493;Lokiukas;"3 A klasė";45122233067;Taip;0;3;0;3
20494;Lokiukas;"3 A klasė";15685936471;Taip;3;3;0;6
20495;Lokiukas;"3 A klasė";10948160841;Taip;18;0;0;18
20496;Lokiukas;"3 A klasė";21802863853;Taip;2;3;0;5
20497;Lokiukas;"3 A klasė";29577495646;Taip;1;3;0;4
20498;Lokiukas;"3 A klasė";22979689191;Taip;4;3;0;7
20499;Lokiukas;"3 A klasė";80754592972;Taip;3;3;0;6
20500;Lokiukas;"3 A klasė";14903100496;Taip;1;3;0;4
20501;Lokiukas;"3 A klasė";97609897018;Taip;1;3;0;4
20502;Lokiukas;"3 A klasė";4608275224;Taip;2;3;0;5
20503;Lokiukas;"3 A klasė";99706061553;Taip;3;3;0;6
20504;Lokiukas;"3 A klasė";7785940412;Taip;1;3;0;4
20505;Lokiukas;"3 A klasė";24099693663;Taip;2;3;0;5
20506;Lokiukas;"3 A klasė";72092394330;Taip;6;3;0;9
20507;Lokiukas;"3 A klasė";35769782473;Taip;5;3;0;8
20508;Lokiukas;"3 A klasė";23688235312;Taip;0;3;0;3
20509;Lokiukas;"3 A klasė";43070670534;Taip;0;3;0;3
20510;Lokiukas;"3 A klasė";38531751377;Taip;1;3;0;4
20511;Lokiukas;"3 A klasė";15574258138;Taip;0;3;0;3
20512;Lokiukas;"3 A klasė";59840033826;Taip;0;3;0;3
20513;Lokiukas;"3 A klasė";24523198513;Taip;18;0;0;18
20514;Lokiukas;"3 A klasė";84273668685;Taip;0;3;0;3
20515;Lokiukas;"3 A klasė";9077016953;Taip;5;3;0;8
20516;Lokiukas;"3 A klasė";9747265775;Taip;18;0;0;18
20517;Lokiukas;"3 A klasė";5198408183;Taip;5;3;0;8
20518;Lokiukas;"3 A klasė";80793623068;Ne;3;3;0;6
20519;Lokiukas;"3 A klasė";93374754851;Taip;1;3;0;4
20520;Lokiukas;"3 B klasė";5311341721;Taip;18;0;0;18
20521;Lokiukas;"3 B klasė";61890775725;Taip;4;3;0;7
20522;Lokiukas;"3 B klasė";32506466236;Taip;3;3;0;6
20523;Lokiukas;"3 B klasė";24221829774;Taip;12;3;0;15
20524;Lokiukas;"3 B klasė";96046361641;Taip;3;3;0;6
20525;Lokiukas;"3 B klasė";7324496782;Taip;2;3;0;5
20526;Lokiukas;"3 B klasė";95910336503;Taip;6;3;0;9
20527;Lokiukas;"3 B klasė";58513885211;Taip;4;3;0;7
20528;Lokiukas;"3 B klasė";57958699478;Taip;3;3;0;6
20529;Lokiukas;"3 B klasė";10811780420;Taip;3;3;0;6
20530;Lokiukas;"3 B klasė";18646642032;Taip;1;3;0;4
20531;Lokiukas;"3 B klasė";79109699217;Taip;2;3;0;5
20532;Lokiukas;"3 B klasė";50713289266;Taip;18;0;0;18
20533;Lokiukas;"3 B klasė";20231469825;Taip;3;3;0;6
20534;Lokiukas;"3 B klasė";18336619115;Taip;0;3;0;3
20535;Lokiukas;"3 B klasė";2105377652;Taip;1;3;0;4
20536;Lokiukas;"3 B klasė";39867459515;Taip;4;3;0;7
20537;Lokiukas;"3 B klasė";1146878499;Taip;2;3;0;5
20538;Lokiukas;"3 B klasė";46587243900;Taip;1;3;0;4
20539;Lokiukas;"3 B klasė";62268017779;Taip;2;3;0;5
20540;Lokiukas;"3 B klasė";28796727185;Taip;17;0;0;17
20541;Lokiukas;"3 B klasė";88415635113;Taip;8;3;0;11
20542;Lokiukas;"3 B klasė";9141446821;Taip;6;3;0;9
20543;Lokiukas;"3 B klasė";7497324442;Taip;18;0;0;18
20544;Lokiukas;"3 B klasė";7903535850;Taip;5;3;0;8
20545;Lokiukas;"3 B klasė";75507005694;Taip;3;3;0;6
20546;Lokiukas;"3 B klasė";73426072972;Taip;3;3;0;6
20547;Lokiukas;"3 B klasė";59913848400;Taip;3;3;0;6
20548;Lokiukas;"4 A klasė";67818191566;Taip;4;0;0;4
20549;Lokiukas;"4 A klasė";45280536946;Taip;18;0;0;18
20550;Lokiukas;"4 A klasė";53087036306;Taip;0;3;0;3
20551;Lokiukas;"4 A klasė";79223457439;Taip;5;3;0;8
20552;Lokiukas;"4 A klasė";75613665040;Taip;0;3;0;3
20553;Lokiukas;"4 A klasė";10240586503;Taip;0;3;0;3
20554;Lokiukas;"4 A klasė";86623153797;Taip;2;3;0;5
20555;Lokiukas;"4 A klasė";27050402360;Taip;0;3;0;3
20556;Lokiukas;"4 A klasė";43389930516;Taip;1;3;0;4
20557;Lokiukas;"4 A klasė";23222644824;Taip;1;3;0;4
20558;Lokiukas;"4 A klasė";52296454506;Taip;0;3;0;3
20559;Lokiukas;"4 A klasė";66999644935;Taip;18;0;0;18
20560;Lokiukas;"4 A klasė";72167964645;Taip;2;3;0;5
20561;Lokiukas;"4 A klasė";2143040924;Taip;18;0;0;18
20562;Lokiukas;"4 A klasė";3206276637;Ne;18;0;0;18
20563;Lokiukas;"4 A klasė";5775631777;Taip;4;3;0;7
20564;Lokiukas;"4 A klasė";3703002168;Taip;1;3;0;4
20565;Lokiukas;"4 A klasė";38636200254;Taip;1;3;0;4
20566;Lokiukas;"4 A klasė";47410036889;Taip;0;3;0;3
20567;Lokiukas;"4 A klasė";53544600623;Taip;5;3;0;8
20568;Lokiukas;"4 A klasė";6702448475;Taip;0;3;0;3
20569;Lokiukas;"4 A klasė";82966541165;Taip;1;3;0;4
20570;Lokiukas;"4 A klasė";42292408557;Taip;18;0;0;18
20571;Lokiukas;"4 B klasė";35018370441;Taip;0;3;0;3
20572;Lokiukas;"4 B klasė";60370754283;Taip;0;3;0;3
20573;Lokiukas;"4 B klasė";98289469398;Taip;2;3;0;5
20574;Lokiukas;"4 B klasė";15445053855;Taip;4;3;0;7
20575;Lokiukas;"4 B klasė";3262579895;Taip;2;3;0;5
20576;Lokiukas;"4 B klasė";51554951703;Taip;18;0;0;18
20577;Lokiukas;"4 B klasė";88947878548;Taip;4;3;0;7
20578;Lokiukas;"4 B klasė";29198900240;Taip;2;3;0;5
20579;Lokiukas;"4 B klasė";77441549037;Taip;5;3;0;8
20580;Lokiukas;"4 B klasė";79301547085;Taip;1;3;0;4
20581;Lokiukas;"4 B klasė";10897713744;Taip;0;3;0;3
20582;Lokiukas;"4 B klasė";16889795010;Taip;18;0;0;18
20583;Lokiukas;"4 B klasė";5067673212;Taip;0;3;0;3
20584;Lokiukas;"4 B klasė";1424195731;Taip;18;0;0;18
20585;Lokiukas;"4 B klasė";1104333637;Taip;2;3;0;5
20586;Lokiukas;"4 B klasė";69089214980;Taip;1;3;0;4
20587;Lokiukas;"4 B klasė";45735190114;Taip;18;0;0;18
20588;Lokiukas;"4 B klasė";2353550739;Taip;0;3;0;3
20589;Lokiukas;"4 B klasė";15004419516;Taip;1;3;0;4
20590;Lokiukas;"4 B klasė";2388111003;Taip;0;3;0;3
20591;Lokiukas;"4 B klasė";1245850082;Taip;20;0;0;20
20592;Šaltinėlis;Ančiukų;3901200729;Taip;5;0;0;5
20593;Šaltinėlis;Ančiukų;1312785137;Taip;8;2;0;10
20594;Šaltinėlis;Ančiukų;9209105445;Taip;10;2;0;12
20595;Šaltinėlis;Ančiukų;9112527921;Taip;11;0;0;11
20596;Šaltinėlis;Ančiukų;9398488555;Taip;6;0;0;6
20597;Šaltinėlis;Ančiukų;2027779524;Taip;7;3;0;10
20598;Šaltinėlis;Ančiukų;5498764523;Taip;11;0;0;11
20599;Šaltinėlis;Ančiukų;4226929875;Taip;7;1;0;8
20600;Šaltinėlis;Ančiukų;1489377928;Taip;19;1;0;20
20601;Šaltinėlis;Ančiukų;7325258256;Ne;7;13;0;20
20602;Šaltinėlis;Ančiukų;5005394548;Taip;16;7;0;23
20603;Šaltinėlis;Ančiukų;1102861619;Taip;0;3;0;3
20604;Šaltinėlis;Ančiukų;1928794692;Taip;10;1;0;11
20605;Šaltinėlis;Ančiukų;1742421427;Taip;5;1;1;7
20606;Šaltinėlis;Ančiukų;9581384663;Taip;13;0;0;13
20607;Šaltinėlis;Ančiukų;9465174636;Taip;0;8;0;8
20608;Šaltinėlis;Ančiukų;8034195267;Taip;7;0;0;7
20609;Šaltinėlis;Ančiukų;5455997139;Taip;0;4;0;4
20610;Šaltinėlis;Ančiukų;9588260206;Taip;7;1;0;8
20611;Šaltinėlis;Ančiukų;8116985061;Ne;7;1;0;8
20612;Šaltinėlis;Bitučių;9983153464;Taip;2;3;0;5
20613;Šaltinėlis;Bitučių;6487378225;Taip;5;0;0;5
20614;Šaltinėlis;Bitučių;56396772538;Taip;7;2;0;9
20615;Šaltinėlis;Bitučių;5251390843;Taip;0;4;2;6
20616;Šaltinėlis;Bitučių;8500790262;Taip;11;3;0;14
20617;Šaltinėlis;Bitučių;4332884673;Taip;0;4;0;4
20618;Šaltinėlis;Bitučių;3493429067;Taip;0;4;0;4
20619;Šaltinėlis;Bitučių;9362495172;Taip;0;3;0;3
20620;Šaltinėlis;Bitučių;6462738640;Taip;0;4;0;4
20621;Šaltinėlis;Bitučių;77872075694;Taip;0;3;0;3
20622;Šaltinėlis;Bitučių;7133143923;Taip;0;7;0;7
20623;Šaltinėlis;Bitučių;6887838949;Taip;0;7;0;7
20624;Šaltinėlis;Bitučių;2630875135;Taip;1;3;0;4
20625;Šaltinėlis;Bitučių;9218883174;Taip;12;0;0;12
20626;Šaltinėlis;Bitučių;2973820849;Taip;3;4;0;7
20627;Šaltinėlis;Bitučių;9820788524;Taip;0;4;0;4
20628;Šaltinėlis;Bitučių;9769491789;Taip;0;3;0;3
20629;Šaltinėlis;Bitučių;9274165569;Taip;0;5;0;5
20630;Šaltinėlis;Bitučių;3691635011;Taip;0;2;0;2
20631;Šaltinėlis;Bitučių;2084451705;Taip;16;3;0;19
20632;Šaltinėlis;Bitučių;8555517284;Taip;8;1;0;9
20633;Šaltinėlis;Bitučių;1543331408;Taip;0;4;0;4
20634;Šaltinėlis;Bitučių;7483928256;Taip;14;0;0;14
20635;Šaltinėlis;Bitučių;2646901307;Taip;5;2;0;7
20636;Šaltinėlis;Bitučių;7737797979;Taip;0;3;0;3
20637;Šaltinėlis;Bitučių;3017437426;Taip;7;3;0;10
20638;Šaltinėlis;Saulutės;7311831014;Taip;7;3;0;10
20639;Šaltinėlis;Saulutės;5854723120;Taip;0;11;0;11
20640;Šaltinėlis;Saulutės;5833136956;Taip;0;3;0;3
20641;Šaltinėlis;Saulutės;3483756240;Taip;5;1;0;6
20642;Šaltinėlis;Saulutės;6380346298;Taip;0;3;0;3
20643;Šaltinėlis;Saulutės;5799032398;Taip;6;2;0;8
20644;Šaltinėlis;Saulutės;5525740049;Taip;5;3;0;8
20645;Šaltinėlis;Saulutės;5382567842;Taip;0;4;0;4
20646;Šaltinėlis;Saulutės;1978469605;Ne;0;3;0;3
20647;Šaltinėlis;Saulutės;4743907195;Taip;0;6;0;6
20648;Šaltinėlis;Saulutės;5343279219;Taip;0;7;0;7
20649;Šaltinėlis;Saulutės;7118672118;Taip;0;4;0;4
20650;Šaltinėlis;Saulutės;2465009553;Taip;7;0;0;7
20651;Šaltinėlis;Saulutės;5345738219;Taip;18;0;0;18
20652;Šaltinėlis;Saulutės;6721510313;Taip;8;3;0;11
20653;Šaltinėlis;Saulutės;7650840990;Taip;17;0;0;17
20654;Šaltinėlis;Saulutės;3507180650;Taip;0;2;0;2
20655;Šaltinėlis;Saulutės;1678450741;Taip;6;5;0;11
20656;Šaltinėlis;Saulutės;5774391181;Ne;0;4;0;4
20657;Šaltinėlis;Saulutės;4681460322;Taip;0;6;0;6
20658;Šaltinėlis;Saulutės;3968514430;Taip;0;4;0;4
20659;Šaltinėlis;Saulutės;8950694484;Taip;0;4;0;4
20660;Šaltinėlis;Saulutės;2499890317;Taip;12;2;0;14
20661;Šaltinėlis;Saulutės;3579974049;Taip;17;0;0;17
20662;Šaltinėlis;Meškiukų;6915625306;Taip;5;6;0;11
20663;Šaltinėlis;Meškiukų;6645807642;Taip;0;4;0;4
20664;Šaltinėlis;Meškiukų;9759912102;Ne;0;1;0;1
20665;Šaltinėlis;Meškiukų;4664741207;Taip;8;1;0;9
20666;Šaltinėlis;Meškiukų;1400918201;Ne;18;0;0;18
20667;Šaltinėlis;Meškiukų;5420067622;Taip;0;6;0;6
20668;Šaltinėlis;Meškiukų;1656674673;Taip;0;5;0;5
20669;Šaltinėlis;Meškiukų;4248763165;Taip;9;0;0;9
20670;Šaltinėlis;Meškiukų;5982018366;Taip;12;5;0;17
20671;Šaltinėlis;Meškiukų;9922223978;Taip;16;3;0;19
20672;Šaltinėlis;Meškiukų;8995077908;Taip;0;9;0;9
20673;Šaltinėlis;Meškiukų;5982188743;Ne;3;4;0;7
20674;Šaltinėlis;Meškiukų;6586783795;Taip;3;4;0;7
20675;Šaltinėlis;Meškiukų;7468640592;Taip;5;3;0;8
20676;Šaltinėlis;Meškiukų;4064231806;Taip;7;3;0;10
20677;Šaltinėlis;Meškiukų;4159654434;Taip;3;0;0;3
20678;Šaltinėlis;Meškiukų;6688536661;Taip;10;0;0;10
20679;Šaltinėlis;Meškiukų;8880659539;Taip;3;7;0;10
20680;Šaltinėlis;Meškiukų;3228788999;Taip;3;3;0;6
20681;Šaltinėlis;Meškiukų;5905345563;Taip;0;10;0;10
20682;Šaltinėlis;Meškiukų;2332065937;Taip;3;1;1;5
20683;Šaltinėlis;Nykštukai;9766640995;Ne;18;0;0;18
20684;Šaltinėlis;Nykštukai;3356138058;Taip;9;0;0;9
20685;Šaltinėlis;Nykštukai;5434349511;Taip;18;0;0;18
20686;Šaltinėlis;Nykštukai;4226068669;Taip;16;0;0;16
20687;Šaltinėlis;Nykštukai;2976773344;Ne;0;5;0;5
20688;Šaltinėlis;Nykštukai;3687243030;Taip;10;5;0;15
20689;Šaltinėlis;Nykštukai;4364256563;Taip;13;1;0;14
20690;Šaltinėlis;Nykštukai;9333013048;Taip;8;0;0;8
20691;Šaltinėlis;Nykštukai;4029616063;Taip;8;3;0;11
20692;Šaltinėlis;Nykštukai;6530797082;Taip;4;0;0;4
20693;Šaltinėlis;Nykštukai;7534585887;Taip;8;0;0;8
20694;Šaltinėlis;Nykštukai;8977029692;Taip;11;3;0;14
20695;Šaltinėlis;Nykštukai;7120592596;Taip;13;3;0;16
20696;Šaltinėlis;Nykštukai;6244924079;Taip;7;1;0;8
20697;Šaltinėlis;Nykštukai;3806267811;Taip;14;0;0;14
20698;Šaltinėlis;Nykštukai;3497881408;Ne;3;7;0;10
20699;Šaltinėlis;Nykštukai;6383844995;Taip;18;0;0;18
20700;Šaltinėlis;Perliukų;2825412170;Taip;7;3;0;10
20701;Šaltinėlis;Perliukų;1686009371;Taip;17;0;0;17
20702;Šaltinėlis;Perliukų;9522524163;Taip;1;9;0;10
20703;Šaltinėlis;Perliukų;9075507649;Taip;5;0;0;5
20704;Šaltinėlis;Perliukų;7068058767;Taip;0;5;2;7
20705;Šaltinėlis;Perliukų;2189112609;Taip;0;5;3;8
20706;Šaltinėlis;Perliukų;8914777163;Taip;3;5;0;8
20707;Šaltinėlis;Perliukų;7387221265;Taip;2;5;0;7
20708;Šaltinėlis;Perliukų;9674923143;Taip;0;6;0;6
20709;Šaltinėlis;Perliukų;1823048790;Taip;3;0;0;3
20710;Šaltinėlis;Perliukų;3073692882;Taip;0;15;0;15
20711;Šaltinėlis;Perliukų;5325974488;Taip;5;0;2;7
20712;Šaltinėlis;Perliukų;2022956307;Ne;0;4;0;4
20713;Šaltinėlis;Perliukų;2126751248;Taip;10;0;0;10
20714;Šaltinėlis;Perliukų;3271931810;Taip;5;3;0;8
20715;Šaltinėlis;Perliukų;7955094634;Taip;0;6;0;6
20716;Šaltinėlis;Perliukų;1445108285;Taip;5;5;0;10
20717;Šaltinėlis;Perliukų;7133044918;Taip;5;0;1;6
20718;Šaltinėlis;Perliukų;2806453623;Taip;4;0;0;4
20719;Šaltinėlis;Perliukų;9691993251;Taip;0;2;0;2
20720;Šaltinėlis;Perliukų;8695191968;Taip;0;7;0;7
20721;Šaltinėlis;Perliukų;4430546695;Taip;11;3;0;14
20722;Šaltinėlis;Perliukų;8506287076;Taip;0;3;0;3
20723;Šaltinėlis;BORUŽĖLĖS;9613234759;Taip;7;3;0;10
20724;Šaltinėlis;BORUŽĖLĖS;3505001330;Taip;8;2;0;10
20725;Šaltinėlis;BORUŽĖLĖS;8973369897;Taip;0;6;0;6
20726;Šaltinėlis;BORUŽĖLĖS;3780870805;Taip;12;0;0;12
20727;Šaltinėlis;BORUŽĖLĖS;2157520281;Taip;5;4;0;9
20728;Šaltinėlis;BORUŽĖLĖS;1441937630;Taip;0;3;0;3
20729;Šaltinėlis;BORUŽĖLĖS;8995954572;Taip;12;0;0;12
20730;Šaltinėlis;BORUŽĖLĖS;4742849747;Taip;3;6;0;9
20731;Šaltinėlis;BORUŽĖLĖS;5996579651;Taip;7;4;0;11
20732;Šaltinėlis;BORUŽĖLĖS;5331397179;Ne;11;0;0;11
20733;Šaltinėlis;BORUŽĖLĖS;1238867065;Taip;15;0;0;15
20734;Šaltinėlis;BORUŽĖLĖS;9218436977;Taip;8;4;0;12
20735;Šaltinėlis;BORUŽĖLĖS;2353630084;Taip;0;4;0;4
20736;Šaltinėlis;BORUŽĖLĖS;5593692486;Taip;17;0;0;17
20737;Šaltinėlis;BORUŽĖLĖS;1496105338;Taip;0;6;0;6
20738;Šaltinėlis;1A;9188065549;Ne;0;10;0;10
20739;Šaltinėlis;1A;9305706589;Ne;0;4;0;4
20740;Šaltinėlis;1A;1580090516;Taip;0;9;0;9
20741;Šaltinėlis;1A;2034838765;Taip;0;4;0;4
20742;Šaltinėlis;1A;2105963102;Taip;0;5;0;5
20743;Šaltinėlis;1A;3582666579;Taip;0;5;0;5
20744;Šaltinėlis;1A;46569341613;Taip;5;4;0;9
20745;Šaltinėlis;1A;2801321116;Taip;0;4;0;4
20746;Šaltinėlis;1A;1091056386;Taip;0;4;0;4
20747;Šaltinėlis;1A;52142182972;Taip;0;4;0;4
20748;Šaltinėlis;1A;6880337593;Ne;0;5;0;5
20749;Šaltinėlis;1A;3516760367;Taip;0;4;0;4
20750;Šaltinėlis;1A;56542341895;Ne;0;5;0;5
20751;Šaltinėlis;1A;1910670134;Taip;0;4;0;4
20752;Šaltinėlis;1A;9595350871;Taip;0;4;0;4
20753;Šaltinėlis;1A;15925823621;Taip;0;4;0;4
20754;Šaltinėlis;1A;8902634958;Taip;0;8;0;8
20755;Šaltinėlis;1A;9757246434;Taip;0;15;0;15
20756;Šaltinėlis;1A;7262120071;Ne;0;4;0;4
20757;Šaltinėlis;1A;1004445904;Taip;0;4;0;4
20758;Šaltinėlis;"2A klasė";32264290873;Taip;0;7;0;7
20759;Šaltinėlis;"2A klasė";1767635282;Taip;0;5;0;5
20760;Šaltinėlis;"2A klasė";1390316465;Taip;0;4;0;4
20761;Šaltinėlis;"2A klasė";5442943843;Taip;0;4;0;4
20762;Šaltinėlis;"2A klasė";6764006747;Taip;0;4;0;4
20763;Šaltinėlis;"2A klasė";1658370782;Taip;0;4;0;4
20764;Šaltinėlis;"2A klasė";10918276041;Taip;0;5;0;5
20765;Šaltinėlis;"2A klasė";3455754351;Taip;0;18;0;18
20766;Šaltinėlis;"2A klasė";66575684640;Taip;0;9;0;9
20767;Šaltinėlis;"2A klasė";86592374576;Taip;0;18;0;18
20768;Šaltinėlis;"2A klasė";13808708760;Taip;0;5;0;5
20769;Šaltinėlis;"2A klasė";1614411921;Ne;0;8;0;8
20770;Šaltinėlis;"2A klasė";79406746980;Taip;0;4;0;4
20771;Šaltinėlis;"2A klasė";3577137327;Taip;8;4;0;12
20772;Šaltinėlis;"2A klasė";1224027643;Taip;0;10;0;10
20773;Šaltinėlis;"2A klasė";48525545812;Taip;0;6;0;6
20774;Šaltinėlis;"2A klasė";7073644279;Taip;0;5;0;5
20775;Šaltinėlis;"2A klasė";3022926855;Taip;0;4;0;4
20776;Šaltinėlis;"2A klasė";1190394855;Taip;8;8;0;16
20777;Šaltinėlis;"2A klasė";40186714037;Taip;0;4;0;4
20778;Šaltinėlis;"2A klasė";1456486363;Taip;0;5;0;5
20779;Šaltinėlis;"2A klasė";32949623652;Taip;0;4;0;4
20780;Šaltinėlis;"3A klasė";14213856824;Taip;0;3;0;3
20781;Šaltinėlis;"3A klasė";80649337160;Taip;0;6;0;6
20782;Šaltinėlis;"3A klasė";92958012146;Taip;0;5;0;5
20783;Šaltinėlis;"3A klasė";84656960510;Taip;0;6;0;6
20784;Šaltinėlis;"3A klasė";83621946293;Taip;0;18;0;18
20785;Šaltinėlis;"3A klasė";67808618878;Ne;0;18;0;18
20786;Šaltinėlis;"3A klasė";1278910777;Taip;0;8;0;8
20787;Šaltinėlis;"3A klasė";9647785988;Taip;3;18;0;21
20788;Šaltinėlis;"3A klasė";82671662416;Taip;0;7;0;7
20789;Šaltinėlis;"3A klasė";54025577281;Taip;5;4;0;9
20790;Šaltinėlis;"3A klasė";488285764;Taip;0;4;0;4
20791;Šaltinėlis;"3A klasė";29482180151;Taip;0;6;0;6
20792;Šaltinėlis;"3A klasė";54753218491;Taip;0;18;0;18
20793;Šaltinėlis;"3A klasė";86029472773;Taip;0;18;0;18
20794;Šaltinėlis;"3A klasė";64821172553;Taip;0;7;0;7
20795;Šaltinėlis;"3A klasė";5744976843;Taip;0;6;0;6
20796;Šaltinėlis;"3A klasė";25459069972;Ne;0;5;0;5
20797;Šaltinėlis;"3A klasė";6669392157;Taip;0;5;0;5
20798;Šaltinėlis;"3A klasė";89358384113;Taip;0;7;0;7
20799;Šaltinėlis;"3A klasė";28956971978;Taip;0;9;0;9
20800;Šaltinėlis;"3A klasė";4050444191;Taip;0;10;0;10
20801;Šaltinėlis;"3A klasė";89093437170;Taip;0;9;0;9
20802;Šaltinėlis;"3A klasė";51872331010;Taip;0;7;0;7
20803;Šaltinėlis;"4A klasė";83657465071;Taip;4;4;0;8
20804;Šaltinėlis;"4A klasė";86309198604;Taip;0;8;0;8
20805;Šaltinėlis;"4A klasė";9705941341;Taip;0;18;0;18
20806;Šaltinėlis;"4A klasė";38496350161;Taip;0;18;0;18
20807;Šaltinėlis;"4A klasė";62612067151;Taip;0;6;0;6
20808;Šaltinėlis;"4A klasė";96133834896;Taip;0;18;0;18
20809;Šaltinėlis;"4A klasė";73466313766;Taip;0;5;0;5
20810;Šaltinėlis;"4A klasė";2323456393;Taip;0;18;0;18
20811;Šaltinėlis;"4A klasė";56279691365;Taip;0;3;0;3
20812;Šaltinėlis;"4A klasė";4587186145;Taip;0;3;0;3
20813;Šaltinėlis;"4A klasė";70948186548;Taip;2;3;0;5
20814;Šaltinėlis;"4A klasė";47045578599;Taip;0;3;0;3
20815;Šaltinėlis;"4A klasė";36718328105;Taip;0;3;0;3
20816;Šaltinėlis;"4A klasė";86995081866;Taip;0;3;0;3
20817;Šaltinėlis;"4A klasė";7929809205;Ne;0;3;0;3
20818;Šaltinėlis;"4A klasė";29683761586;Ne;0;4;0;4
20819;Šaltinėlis;"4A klasė";9842958341;Ne;0;3;0;3
20820;Šaltinėlis;"4A klasė";40769315138;Taip;0;4;0;4
20821;Šaltinėlis;"4A klasė";7563879445;Taip;0;3;0;3
20822;Šaltinėlis;"4A klasė";66754907606;Ne;0;18;0;18
20823;Šaltinėlis;"4A klasė";35387543586;Taip;0;5;0;5
20824;Šaltinėlis;"4A klasė";6056572441;Ne;0;3;0;3
20825;Šaltinėlis;"4A klasė";9927833966;Ne;0;3;0;3
20826;Šaltinėlis;3B;93256161233;Taip;0;5;0;5
20827;Šaltinėlis;3B;83173349544;Taip;0;6;0;6
20828;Šaltinėlis;3B;39088869084;Taip;0;5;0;5
20829;Šaltinėlis;3B;1422035829;Taip;0;7;0;7
20830;Šaltinėlis;3B;7711903999;Ne;0;11;0;11
20831;Šaltinėlis;3B;95542489944;Taip;0;5;0;5
20832;Šaltinėlis;3B;3072314714;Taip;0;6;0;6
20833;Šaltinėlis;3B;1220687492;Taip;0;5;0;5
20834;Šaltinėlis;3B;74337710550;Taip;0;5;0;5
20835;Šaltinėlis;3B;35401075864;Taip;0;5;0;5
20836;Šaltinėlis;3B;19630605543;Taip;0;14;0;14
20837;Šaltinėlis;3B;84522552145;Taip;0;5;0;5
20838;Šaltinėlis;3B;3626545396;Ne;0;8;0;8
20839;Šaltinėlis;3B;6317111400;Taip;0;5;0;5
20840;Šaltinėlis;3B;4762756751;Ne;0;5;0;5
20841;Šaltinėlis;3B;72372808270;Taip;0;6;0;6
20842;Šaltinėlis;3B;1924418657;Taip;0;8;0;8
20843;Šaltinėlis;3B;77194317310;Taip;0;5;0;5
20844;Šaltinėlis;3B;57847832778;Taip;0;5;0;5
20845;Šaltinėlis;3B;2099800744;Taip;0;6;0;6
20846;Šaltinėlis;3B;70315400705;Taip;0;10;0;10
20847;Šaltinėlis;3B;81082410620;Taip;0;9;0;9
20848;Šaltinėlis;1B;84494627465;Taip;0;3;0;3
20849;Šaltinėlis;1B;2146141461;Taip;0;3;0;3
20850;Šaltinėlis;1B;6068980312;Taip;0;5;0;5
20851;Šaltinėlis;1B;9425353041;Taip;0;6;0;6
20852;Šaltinėlis;1B;17147527171;Taip;0;18;0;18
20853;Šaltinėlis;1B;1935762293;Taip;0;5;0;5
20854;Šaltinėlis;1B;1716801722;Taip;0;4;0;4
20855;Šaltinėlis;1B;2333071711;Taip;0;8;0;8
20856;Šaltinėlis;1B;23301579810;Taip;0;4;0;4
20857;Šaltinėlis;1B;52507085619;Taip;0;4;0;4
20858;Šaltinėlis;1B;1023238509;Taip;0;4;0;4
20859;Šaltinėlis;1B;526307704;Taip;0;6;0;6
20860;Šaltinėlis;1B;1958647188;Taip;0;6;0;6
20861;Šaltinėlis;1B;1583520894;Taip;0;18;0;18
20862;Šaltinėlis;1B;11083638216;Taip;0;6;0;6
20863;Šaltinėlis;PELĖDŽIUKAI;8973208195;Taip;0;3;1;4
20864;Šaltinėlis;PELĖDŽIUKAI;1367082230;Taip;0;5;0;5
20865;Šaltinėlis;PELĖDŽIUKAI;4387568448;Taip;0;4;0;4
20866;Šaltinėlis;PELĖDŽIUKAI;7723290276;Taip;0;4;0;4
20867;Šaltinėlis;PELĖDŽIUKAI;1348724947;Taip;0;18;0;18
20868;Šaltinėlis;PELĖDŽIUKAI;2658414287;Taip;0;5;0;5
20869;Šaltinėlis;PELĖDŽIUKAI;3638565578;Taip;0;3;0;3
20870;Šaltinėlis;PELĖDŽIUKAI;8721116918;Taip;0;3;0;3
20871;Šaltinėlis;PELĖDŽIUKAI;7211267255;Taip;0;3;0;3
20872;Šaltinėlis;PELĖDŽIUKAI;1040333590;Taip;0;3;0;3
20873;Šaltinėlis;PELĖDŽIUKAI;3660687688;Taip;5;7;0;12
20874;Šaltinėlis;PELĖDŽIUKAI;5869977541;Ne;5;3;1;9
20875;Šaltinėlis;PELĖDŽIUKAI;3609939325;Ne;0;3;0;3
20876;Šaltinėlis;PELĖDŽIUKAI;9108653045;Taip;0;5;0;5
20877;Šaltinėlis;PELĖDŽIUKAI;9762392403;Taip;0;4;0;4
20878;Šaltinėlis;PELĖDŽIUKAI;2230403251;Ne;0;3;0;3
20879;Šaltinėlis;PELĖDŽIUKAI;7918995181;Taip;2;3;2;7
20880;Šaltinėlis;PELĖDŽIUKAI;9673105905;Ne;6;3;3;12
20881;Šaltinėlis;PELĖDŽIUKAI;5099997904;Taip;0;4;0;4
20882;Gabijėlė;GANDRIUKŲ;4498088417;Taip;5;4;0;9
20883;Gabijėlė;GANDRIUKŲ;2277489032;Ne;0;3;1;4
20884;Gabijėlė;GANDRIUKŲ;8994076883;Ne;0;3;2;5
20885;Gabijėlė;GANDRIUKŲ;7087892822;Taip;13;3;0;16
20886;Gabijėlė;GANDRIUKŲ;5057272847;Taip;0;7;6;13
20887;Gabijėlė;GANDRIUKŲ;3548399391;Taip;0;4;2;6
20888;Gabijėlė;GANDRIUKŲ;3532989398;Taip;2;3;0;5
20889;Gabijėlė;GANDRIUKŲ;2215880644;Taip;0;3;6;9
20890;Gabijėlė;GANDRIUKŲ;3799003783;Taip;5;4;2;11
20891;Gabijėlė;GANDRIUKŲ;5513530983;Taip;0;2;0;2
20892;Gabijėlė;GANDRIUKŲ;9581539166;Taip;7;3;0;10
20893;Gabijėlė;GANDRIUKŲ;6004026516;Taip;0;7;1;8
20894;Gabijėlė;GANDRIUKŲ;4634029418;Taip;8;3;0;11
20895;Gabijėlė;GANDRIUKŲ;4328252445;Taip;12;3;0;15
20896;Gabijėlė;GANDRIUKŲ;9706026832;Taip;0;5;0;5
20897;Gabijėlė;GANDRIUKŲ;2491503656;Taip;0;9;0;9
20898;Gabijėlė;GANDRIUKŲ;8904768332;Taip;0;4;3;7
20899;Gabijėlė;GANDRIUKŲ;5715645968;Taip;0;1;3;4
20900;Gabijėlė;GANDRIUKŲ;8572833698;Taip;0;0;1;1
20901;Gabijėlė;GANDRIUKŲ;7433142478;Taip;0;3;0;3
20902;Gabijėlė;GANDRIUKŲ;8646572151;Taip;0;3;0;3
20903;Gabijėlė;GANDRIUKŲ;5054419205;Taip;0;7;0;7
20904;Gabijėlė;GANDRIUKŲ;7530976246;Taip;2;3;2;7
20905;Gabijėlė;GANDRIUKŲ;3920525584;Taip;3;3;0;6
20906;Gabijėlė;GANDRIUKŲ;2682112101;Taip;0;5;0;5
20907;Gabijėlė;LAKŠTINGALIUKŲ;7019425859;Taip;0;3;0;3
20908;Gabijėlė;LAKŠTINGALIUKŲ;1611004144;Taip;3;3;0;6
20909;Gabijėlė;LAKŠTINGALIUKŲ;5862882027;Taip;0;3;6;9
20910;Gabijėlė;LAKŠTINGALIUKŲ;8798786098;Taip;15;3;0;18
20911;Gabijėlė;LAKŠTINGALIUKŲ;8035360208;Taip;0;8;0;8
20912;Gabijėlė;LAKŠTINGALIUKŲ;2384469423;Taip;10;3;0;13
20913;Gabijėlė;LAKŠTINGALIUKŲ;8167646385;Taip;10;3;0;13
20914;Gabijėlė;LAKŠTINGALIUKŲ;8926268619;Taip;5;3;4;12
20915;Gabijėlė;LAKŠTINGALIUKŲ;9480021589;Taip;0;5;0;5
20916;Gabijėlė;LAKŠTINGALIUKŲ;3215569531;Taip;0;3;2;5
20917;Gabijėlė;LAKŠTINGALIUKŲ;5992403900;Taip;10;3;0;13
20918;Gabijėlė;LAKŠTINGALIUKŲ;9116943443;Taip;9;3;3;15
20919;Gabijėlė;LAKŠTINGALIUKŲ;8383489040;Taip;0;4;0;4
20920;Gabijėlė;LAKŠTINGALIUKŲ;6927730664;Taip;11;0;0;11
20921;Gabijėlė;LAKŠTINGALIUKŲ;7444385669;Taip;8;3;0;11
20922;Gabijėlė;LAKŠTINGALIUKŲ;9398722388;Taip;8;4;0;12
20923;Gabijėlė;LAKŠTINGALIUKŲ;9491327802;Taip;0;3;8;11
20924;Gabijėlė;LAKŠTINGALIUKŲ;6730947751;Taip;0;3;5;8
20925;Gabijėlė;LAKŠTINGALIUKŲ;2550300871;Taip;6;3;0;9
20926;Gabijėlė;LAKŠTINGALIUKŲ;9324498850;Taip;15;3;0;18
20927;Gabijėlė;LAKŠTINGALIUKŲ;8314088016;Taip;6;1;0;7
20928;Gabijėlė;LAKŠTINGALIUKŲ;6295299651;Taip;6;1;0;7
20929;Gabijėlė;LAKŠTINGALIUKŲ;9694544564;Taip;7;3;2;12
20930;Gabijėlė;LAKŠTINGALIUKŲ;4827797140;Taip;4;10;0;14
20931;Gabijėlė;LAKŠTINGALIUKŲ;6931780900;Taip;0;10;0;10
20932;Gabijėlė;LAKŠTINGALIUKŲ;2030555139;Taip;2;3;0;5
20933;Gabijėlė;ŽVIRBLIUKŲ;7043775905;Taip;9;4;2;15
20934;Gabijėlė;ŽVIRBLIUKŲ;4475530177;Taip;0;3;0;3
20935;Gabijėlė;ŽVIRBLIUKŲ;5743861607;Taip;0;3;3;6
20936;Gabijėlė;ŽVIRBLIUKŲ;7410541320;Taip;0;8;0;8
20937;Gabijėlė;ŽVIRBLIUKŲ;4493192224;Taip;0;4;2;6
20938;Gabijėlė;ŽVIRBLIUKŲ;9259964641;Taip;0;3;0;3
20939;Gabijėlė;ŽVIRBLIUKŲ;3268231136;Taip;0;15;0;15
20940;Gabijėlė;ŽVIRBLIUKŲ;5332825339;Taip;0;3;4;7
20941;Gabijėlė;ŽVIRBLIUKŲ;2264669298;Taip;2;5;0;7
20942;Gabijėlė;ŽVIRBLIUKŲ;5942625633;Taip;0;3;6;9
20943;Gabijėlė;ŽVIRBLIUKŲ;3155403180;Taip;14;0;0;14
20944;Gabijėlė;ŽVIRBLIUKŲ;1158461185;Taip;14;0;0;14
20945;Gabijėlė;ŽVIRBLIUKŲ;3218415151;Taip;0;3;6;9
20946;Gabijėlė;ŽVIRBLIUKŲ;8823299212;Taip;0;3;5;8
20947;Gabijėlė;ŽVIRBLIUKŲ;8879972953;Taip;0;9;0;9
20948;Gabijėlė;ŽVIRBLIUKŲ;9627906252;Taip;0;2;1;3
20949;Gabijėlė;ŽVIRBLIUKŲ;1725665169;Taip;0;3;0;3
20950;Gabijėlė;ŽVIRBLIUKŲ;8292463617;Taip;2;3;1;6
20951;Gabijėlė;ŽVIRBLIUKŲ;6674038058;Taip;0;3;0;3
20952;Gabijėlė;ŽVIRBLIUKŲ;4146051969;Taip;0;4;0;4
20953;Gabijėlė;ŽVIRBLIUKŲ;6604681536;Taip;0;5;0;5
20954;Gabijėlė;ŽVIRBLIUKŲ;1273722177;Taip;0;3;2;5
20955;Gabijėlė;ŽVIRBLIUKŲ;6310234092;Taip;0;3;1;4
20956;Gabijėlė;ŽVIRBLIUKŲ;8384795164;Taip;0;3;0;3
20957;Gabijėlė;ŽVIRBLIUKŲ;3209491491;Taip;0;10;0;10
20958;Gabijėlė;GENIUKŲ;3445433386;Taip;0;10;0;10
20959;Gabijėlė;GENIUKŲ;2980295345;Taip;4;3;2;9
20960;Gabijėlė;GENIUKŲ;1862655595;Taip;0;3;0;3
20961;Gabijėlė;GENIUKŲ;7312628876;Taip;0;14;0;14
20962;Gabijėlė;GENIUKŲ;1581688238;Taip;0;3;2;5
20963;Gabijėlė;GENIUKŲ;5301905117;Taip;0;13;0;13
20964;Gabijėlė;GENIUKŲ;3176075887;Taip;0;3;0;3
20965;Gabijėlė;GENIUKŲ;9972967198;Taip;0;3;0;3
20966;Gabijėlė;GENIUKŲ;1589534853;Taip;0;3;0;3
20967;Gabijėlė;GENIUKŲ;6482824000;Taip;0;3;1;4
20968;Gabijėlė;GENIUKŲ;5962852108;Taip;8;2;3;13
20969;Gabijėlė;GENIUKŲ;7178676049;Taip;0;3;0;3
20970;Gabijėlė;GENIUKŲ;1974388885;Taip;0;7;3;10
20971;Gabijėlė;GENIUKŲ;2407507314;Taip;8;3;1;12
20972;Gabijėlė;GENIUKŲ;3827747057;Taip;0;3;0;3
20973;Gabijėlė;GENIUKŲ;8305098808;Taip;0;3;0;3
20974;Gabijėlė;GENIUKŲ;4234733280;Taip;0;2;0;2
20975;Gabijėlė;GENIUKŲ;6375754699;Ne;9;1;0;10
20976;Gabijėlė;GENIUKŲ;2009199650;Taip;0;2;0;2
20977;Gabijėlė;GENIUKŲ;6869951613;Taip;0;4;0;4
20978;Gabijėlė;GENIUKŲ;7173852168;Taip;0;4;0;4
20979;Gabijėlė;GENIUKŲ;8036572198;Taip;0;8;0;8
20980;Gabijėlė;DAGILIUKŲ;9348393550;Taip;0;3;0;3
20981;Gabijėlė;DAGILIUKŲ;4264925447;Taip;0;3;0;3
20982;Gabijėlė;DAGILIUKŲ;9120107749;Taip;0;2;2;4
20983;Gabijėlė;DAGILIUKŲ;9494313873;Taip;2;3;0;5
20984;Gabijėlė;DAGILIUKŲ;9783343968;Taip;0;3;1;4
20985;Gabijėlė;DAGILIUKŲ;3017939983;Taip;0;3;0;3
20986;Gabijėlė;DAGILIUKŲ;4462129182;Taip;0;4;0;4
20987;Gabijėlė;DAGILIUKŲ;9503639471;Taip;0;0;1;1
20988;Gabijėlė;DAGILIUKŲ;1988597157;Taip;10;0;0;10
20989;Gabijėlė;DAGILIUKŲ;9895518740;Taip;9;0;0;9
20990;Gabijėlė;DAGILIUKŲ;9449023766;Taip;0;3;0;3
20991;Gabijėlė;DAGILIUKŲ;1286688629;Taip;2;3;3;8
20992;Gabijėlė;DAGILIUKŲ;8864190314;Taip;2;0;0;2
20993;Gabijėlė;DAGILIUKŲ;1455856766;Ne;5;3;1;9
20994;Gabijėlė;DAGILIUKŲ;3700639354;Taip;0;2;0;2
20995;Gabijėlė;DAGILIUKŲ;6438144206;Taip;0;0;5;5
20996;Gabijėlė;DAGILIUKŲ;8662914262;Taip;0;10;0;10
20997;Gabijėlė;DAGILIUKŲ;9280283478;Taip;3;0;0;3
20998;Gabijėlė;DAGILIUKŲ;2254104149;Taip;1;4;0;5
20999;Gabijėlė;DAGILIUKŲ;8078326688;Taip;6;2;0;8
21000;Gabijėlė;DAGILIUKŲ;4490619514;Taip;0;1;0;1
21001;Gabijėlė;DAGILIUKŲ;2386980295;Taip;0;3;4;7
21002;Gabijėlė;DAGILIUKŲ;4664011011;Taip;18;0;0;18
21003;Gabijėlė;PELEDŽIUKŲ;6794056622;Taip;8;3;0;11
21004;Gabijėlė;PELEDŽIUKŲ;4170105224;Taip;1;4;1;6
21005;Gabijėlė;PELEDŽIUKŲ;5675574534;Taip;0;3;1;4
21006;Gabijėlė;PELEDŽIUKŲ;5163460269;Taip;17;0;1;18
21007;Gabijėlė;PELEDŽIUKŲ;1356830225;Taip;0;3;3;6
21008;Gabijėlė;PELEDŽIUKŲ;9265103627;Taip;0;3;1;4
21009;Gabijėlė;PELEDŽIUKŲ;9451897367;Taip;4;0;1;5
21010;Gabijėlė;PELEDŽIUKŲ;1583034900;Taip;0;3;3;6
21011;Gabijėlė;PELEDŽIUKŲ;2128428173;Taip;8;0;0;8
21012;Gabijėlė;PELEDŽIUKŲ;7028670164;Taip;10;3;2;15
21013;Gabijėlė;PELEDŽIUKŲ;5481472116;Taip;7;3;0;10
21014;Gabijėlė;PELEDŽIUKŲ;2885913045;Taip;0;6;0;6
21015;Gabijėlė;PELEDŽIUKŲ;5869580147;Taip;3;0;1;4
21016;Gabijėlė;PELEDŽIUKŲ;7096789623;Taip;8;1;0;9
21017;Gabijėlė;PELEDŽIUKŲ;4724322463;Taip;8;4;0;12
21018;Gabijėlė;PELEDŽIUKŲ;1810898809;Taip;0;3;1;4
21019;Gabijėlė;PELEDŽIUKŲ;5801792404;Taip;0;3;1;4
21020;Gabijėlė;PELEDŽIUKŲ;8550877260;Taip;3;7;0;10
21021;Gabijėlė;PELEDŽIUKŲ;5579070948;Taip;4;0;4;8
21022;Gabijėlė;PELEDŽIUKŲ;1076369632;Taip;0;3;2;5
21023;Gabijėlė;PELEDŽIUKŲ;8549800358;Taip;10;2;0;12
21024;Gabijėlė;PELEDŽIUKŲ;8133131896;Taip;0;3;0;3
21025;Gabijėlė;PELEDŽIUKŲ;2048046055;Taip;18;0;0;18
21026;Gabijėlė;PELEDŽIUKŲ;7261932151;Taip;0;3;0;3
21027;Gabijėlė;PELEDŽIUKŲ;8088806507;Taip;3;0;0;3
21028;Gabijėlė;KREGZDŽIUKŲ;1759118326;Taip;7;7;0;14
21029;Gabijėlė;KREGZDŽIUKŲ;9533325351;Taip;8;7;0;15
21030;Gabijėlė;KREGZDŽIUKŲ;5407565441;Taip;15;0;0;15
21031;Gabijėlė;KREGZDŽIUKŲ;6845038692;Taip;7;3;0;10
21032;Gabijėlė;KREGZDŽIUKŲ;9683202312;Taip;5;3;3;11
21033;Gabijėlė;KREGZDŽIUKŲ;2357515455;Taip;0;1;0;1
21034;Gabijėlė;KREGZDŽIUKŲ;1574272380;Taip;0;18;0;18
21035;Gabijėlė;KREGZDŽIUKŲ;9675186834;Taip;0;3;0;3
21036;Gabijėlė;KREGZDŽIUKŲ;2634722171;Taip;7;4;0;11
21037;Gabijėlė;KREGZDŽIUKŲ;4317708029;Taip;0;15;0;15
21038;Gabijėlė;KREGZDŽIUKŲ;8555272917;Taip;0;3;2;5
21039;Gabijėlė;KREGZDŽIUKŲ;1142939183;Taip;0;5;0;5
21040;Gabijėlė;KREGZDŽIUKŲ;9676186208;Taip;0;4;0;4
21041;Gabijėlė;KREGZDŽIUKŲ;3584692524;Taip;0;3;0;3
21042;Gabijėlė;KREGZDŽIUKŲ;8613821848;Taip;4;0;0;4
21043;Gabijėlė;KREGZDŽIUKŲ;7038167942;Taip;0;7;0;7
21044;Gabijėlė;KREGZDŽIUKŲ;6570702235;Taip;0;3;0;3
21045;Gabijėlė;KREGZDŽIUKŲ;9528783892;Taip;0;12;0;12
21046;Gabijėlė;KREGZDŽIUKŲ;9358478209;Taip;10;1;0;11
21047;Gabijėlė;KREGZDŽIUKŲ;9030890792;Taip;2;3;0;5
21048;Gabijėlė;KREGZDŽIUKŲ;3031333199;Taip;2;3;0;5
21049;Gabijėlė;KREGZDŽIUKŲ;9116153981;Taip;3;0;0;3
21050;Gabijėlė;KREGZDŽIUKŲ;7447079902;Taip;10;0;1;11
21051;Gabijėlė;KREGZDŽIUKŲ;2289016022;Taip;10;3;5;18
21052;Gabijėlė;KREGZDŽIUKŲ;1230236612;Taip;10;1;1;12
21053;Gabijėlė;KREGZDŽIUKŲ;4575230225;Taip;4;0;2;6
21054;Gabijėlė;ZYLIUKŲ;6154378055;Taip;18;0;0;18
21055;Gabijėlė;ZYLIUKŲ;7700700293;Taip;15;3;0;18
21056;Gabijėlė;ZYLIUKŲ;6759447513;Taip;0;5;0;5
21057;Gabijėlė;ZYLIUKŲ;1090635644;Taip;13;0;2;15
21058;Gabijėlė;ZYLIUKŲ;9893869150;Taip;0;3;2;5
21059;Gabijėlė;ZYLIUKŲ;2764185879;Taip;0;3;0;3
21060;Gabijėlė;ZYLIUKŲ;6463161337;Taip;0;3;0;3
21061;Gabijėlė;ZYLIUKŲ;7921467223;Taip;0;3;0;3
21062;Gabijėlė;ZYLIUKŲ;6446842432;Taip;0;3;1;4
21063;Gabijėlė;ZYLIUKŲ;6562965816;Taip;0;3;1;4
21064;Gabijėlė;ZYLIUKŲ;4376486874;Taip;5;3;0;8
21065;Gabijėlė;ZYLIUKŲ;7047606048;Taip;0;3;0;3
21066;Gabijėlė;ZYLIUKŲ;6983092888;Taip;0;3;7;10
21067;Gabijėlė;ZYLIUKŲ;2727329238;Taip;7;1;0;8
21068;Gabijėlė;ZYLIUKŲ;4267803371;Taip;0;0;2;2
21069;Gabijėlė;ZYLIUKŲ;9259673720;Taip;3;0;2;5
21070;Gabijėlė;ZYLIUKŲ;8362509831;Taip;4;2;3;9
21071;Gabijėlė;ZYLIUKŲ;4907669556;Taip;0;8;0;8
21072;Gabijėlė;ZYLIUKŲ;1947898190;Taip;0;3;0;3
21073;Gabijėlė;ZYLIUKŲ;2384174631;Taip;6;3;1;10
21074;Gabijėlė;ZYLIUKŲ;6393256426;Taip;0;3;2;5
21075;Gabijėlė;ZYLIUKŲ;4166561084;Taip;0;2;0;2
21076;Gabijėlė;ZYLIUKŲ;5736012194;Taip;0;3;15;18
21077;Gabijėlė;ZYLIUKŲ;4712780337;Taip;5;3;0;8
21078;Gabijėlė;ZYLIUKŲ;1004297369;Taip;0;3;10;13
21079;Gabijėlė;ZYLIUKŲ;7180444215;Taip;0;3;3;6
21080;Gabijėlė;VOLUNGĖLIŲ;4000838897;Ne;1;4;1;6
21081;Gabijėlė;VOLUNGĖLIŲ;2099510027;Taip;10;0;2;12
21082;Gabijėlė;VOLUNGĖLIŲ;6842537434;Taip;0;9;0;9
21083;Gabijėlė;VOLUNGĖLIŲ;2227816651;Taip;0;4;0;4
21084;Gabijėlė;VOLUNGĖLIŲ;6956030813;Taip;18;0;0;18
21085;Gabijėlė;VOLUNGĖLIŲ;3902737481;Taip;0;6;0;6
21086;Gabijėlė;VOLUNGĖLIŲ;8733551230;Taip;0;4;5;9
21087;Gabijėlė;VOLUNGĖLIŲ;3763595874;Taip;0;4;1;5
21088;Gabijėlė;VOLUNGĖLIŲ;5360985745;Taip;5;4;0;9
21089;Gabijėlė;VOLUNGĖLIŲ;4580305437;Taip;0;14;0;14
21090;Gabijėlė;VOLUNGĖLIŲ;5737066080;Taip;0;4;0;4
21091;Gabijėlė;VOLUNGĖLIŲ;5972136800;Taip;1;3;0;4
21092;Gabijėlė;VOLUNGĖLIŲ;3972933727;Taip;7;4;0;11
21093;Gabijėlė;VOLUNGĖLIŲ;6643563560;Taip;0;4;0;4
21094;Gabijėlė;VOLUNGĖLIŲ;8312753333;Taip;0;6;0;6
21095;Gabijėlė;VOLUNGĖLIŲ;8569742033;Taip;0;4;0;4
21096;Gabijėlė;VOLUNGĖLIŲ;8327903800;Taip;3;4;0;7
21097;Gabijėlė;VOLUNGĖLIŲ;4160646449;Taip;0;8;0;8
21098;Gabijėlė;VOLUNGĖLIŲ;5060265729;Taip;0;4;0;4
21099;Gabijėlė;VOLUNGĖLIŲ;6960725029;Taip;18;0;0;18
21100;Gabijėlė;VOLUNGĖLIŲ;3098846537;Taip;8;3;0;11
21101;Gabijėlė;VOLUNGĖLIŲ;3995459990;Taip;0;6;0;6
21102;Gabijėlė;VOLUNGĖLIŲ;8320449381;Taip;0;5;0;5
21103;Gabijėlė;ANČIUKŲ;2036978425;Taip;0;11;0;11
21104;Gabijėlė;ANČIUKŲ;5219706067;Taip;0;5;0;5
21105;Gabijėlė;ANČIUKŲ;3454412432;Taip;0;3;0;3
21106;Gabijėlė;ANČIUKŲ;9822093084;Taip;0;10;0;10
21107;Gabijėlė;ANČIUKŲ;1415184607;Taip;0;3;4;7
21108;Gabijėlė;ANČIUKŲ;85836097485;Taip;0;3;6;9
21109;Gabijėlė;ANČIUKŲ;28017865889;Taip;0;8;0;8
21110;Gabijėlė;ANČIUKŲ;1917587420;Taip;2;16;0;18
21111;Gabijėlė;ANČIUKŲ;1465584524;Taip;10;3;0;13
21112;Gabijėlė;ANČIUKŲ;6198439092;Taip;0;6;0;6
21113;Gabijėlė;ANČIUKŲ;7948343328;Taip;0;5;0;5
21114;Gabijėlė;ANČIUKŲ;2052892422;Taip;0;3;0;3
21115;Gabijėlė;ANČIUKŲ;8111239476;Taip;0;5;0;5
21116;Gabijėlė;ANČIUKŲ;8778396292;Taip;0;3;6;9
21117;Gabijėlė;ANČIUKŲ;4085049535;Taip;0;4;0;4
21118;Gabijėlė;ANČIUKŲ;8893637755;Taip;0;4;0;4
21119;Gabijėlė;ANČIUKŲ;8874692591;Taip;5;3;0;8
21120;Gabijėlė;ANČIUKŲ;4752631976;Taip;5;2;2;9
21121;Gabijėlė;ANČIUKŲ;5783373671;Taip;0;3;0;3
21122;Gabijėlė;ANČIUKŲ;6766770793;Taip;5;3;0;8
21123;Gabijėlė;ANČIUKŲ;10796114623;Taip;0;7;0;7
21124;Gabijėlė;ANČIUKŲ;43123279348;Taip;0;3;0;3
21125;Gabijėlė;BALANDŽIUKŲ;6719097956;Taip;0;3;1;4
21126;Gabijėlė;BALANDŽIUKŲ;9157819780;Taip;0;8;0;8
21127;Gabijėlė;BALANDŽIUKŲ;1045338865;Taip;0;3;0;3
21128;Gabijėlė;BALANDŽIUKŲ;2097260657;Taip;0;4;0;4
21129;Gabijėlė;BALANDŽIUKŲ;8131229306;Taip;0;1;2;3
21130;Gabijėlė;BALANDŽIUKŲ;8525869648;Taip;0;8;0;8
21131;Gabijėlė;BALANDŽIUKŲ;2070050969;Taip;0;3;0;3
21132;Gabijėlė;BALANDŽIUKŲ;15049855022;Taip;0;4;0;4
21133;Gabijėlė;BALANDŽIUKŲ;2776579713;Taip;0;4;0;4
21134;Gabijėlė;BALANDŽIUKŲ;7977751362;Taip;0;1;0;1
21135;Gabijėlė;BALANDŽIUKŲ;5906952432;Taip;0;1;0;1
21136;Gabijėlė;BALANDŽIUKŲ;9197020006;Taip;0;8;0;8
21137;Gabijėlė;BALANDŽIUKŲ;1615940996;Taip;0;4;0;4
21138;Gabijėlė;BALANDŽIUKŲ;65735862964;Taip;0;3;0;3
21139;Gabijėlė;BALANDŽIUKŲ;6196322537;Taip;0;2;0;2
21140;Gabijėlė;BALANDŽIUKŲ;8746641978;Taip;0;5;2;7
21141;Gabijėlė;BALANDŽIUKŲ;56914218692;Taip;0;1;0;1
21142;Gabijėlė;BALANDŽIUKŲ;4330624300;Taip;0;3;2;5
21143;Gabijėlė;BALANDŽIUKŲ;2921208571;Taip;0;3;1;4
21144;Gabijėlė;BALANDŽIUKŲ;9501202207;Taip;10;7;0;17
21145;Gabijėlė;BALANDŽIUKŲ;6145720452;Taip;5;7;0;12
21146;Gabijėlė;BALANDŽIUKŲ;7563741123;Taip;7;4;0;11
21147;Gabijėlė;BALANDŽIUKŲ;3694447705;Taip;0;4;4;8
21148;Gabijėlė;VYTURIUKŲ;6131649116;Taip;10;0;0;10
21149;Gabijėlė;VYTURIUKŲ;8461048184;Taip;3;0;0;3
21150;Gabijėlė;VYTURIUKŲ;7894667201;Taip;11;0;0;11
21151;Gabijėlė;VYTURIUKŲ;3960795412;Taip;5;0;0;5
21152;Gabijėlė;VYTURIUKŲ;3973977318;Taip;13;0;0;13
21153;Gabijėlė;VYTURIUKŲ;3454061135;Taip;0;0;1;1
21154;Gabijėlė;VYTURIUKŲ;5652244967;Taip;10;4;0;14
21155;Gabijėlė;VYTURIUKŲ;6013482554;Taip;0;3;4;7
21156;Gabijėlė;VYTURIUKŲ;3343196830;Taip;0;0;1;1
21157;Gabijėlė;VYTURIUKŲ;9021225516;Taip;0;3;0;3
21158;Gabijėlė;VYTURIUKŲ;1523190444;Taip;0;1;0;1
21159;Gabijėlė;VYTURIUKŲ;7295985579;Taip;14;0;0;14
21160;Gabijėlė;VYTURIUKŲ;6834871835;Taip;0;3;0;3
21161;Gabijėlė;VYTURIUKŲ;8749080961;Taip;5;1;1;7
21162;Gabijėlė;VYTURIUKŲ;1185216449;Taip;0;5;0;5
21163;Gabijėlė;VYTURIUKŲ;6107630313;Taip;0;4;0;4
21164;Gabijėlė;VYTURIUKŲ;5297866989;Taip;5;0;2;7
21165;Gabijėlė;VYTURIUKŲ;4278783863;Taip;0;2;0;2
21166;Gabijėlė;VYTURIUKŲ;7509112343;Taip;0;5;1;6
21167;Gabijėlė;VYTURIUKŲ;4248856615;Taip;0;3;0;3
21168;Gabijėlė;VYTURIUKŲ;6539078572;Taip;0;7;0;7
21169;Saulėgrąža;Bitutės;8660677159;Taip;8;0;3;11
21170;Saulėgrąža;Bitutės;9437387272;Taip;6;0;0;6
21171;Saulėgrąža;Bitutės;5940167166;Taip;0;0;15;15
21172;Saulėgrąža;Bitutės;4380287979;Taip;0;0;3;3
21173;Saulėgrąža;Bitutės;6641588877;Taip;0;3;4;7
21174;Saulėgrąža;Bitutės;8505655534;Taip;0;0;3;3
21175;Saulėgrąža;Bitutės;2809788049;Taip;11;0;1;12
21176;Saulėgrąža;Bitutės;4733063461;Taip;2;3;0;5
21177;Saulėgrąža;Bitutės;3899237871;Taip;0;4;0;4
21178;Saulėgrąža;Bitutės;1381240000;Taip;0;0;5;5
21179;Saulėgrąža;Bitutės;8766433391;Taip;0;4;0;4
21180;Saulėgrąža;Bitutės;7283302671;Taip;0;3;0;3
21181;Saulėgrąža;Bitutės;4265356484;Taip;0;0;3;3
21182;Saulėgrąža;Bitutės;2042826101;Taip;0;0;4;4
21183;Saulėgrąža;Bitutės;8384708422;Taip;5;0;4;9
21184;Saulėgrąža;Bitutės;1345079291;Taip;0;11;1;12
21185;Saulėgrąža;Bitutės;3319538368;Taip;5;3;4;12
21186;Saulėgrąža;Bitutės;8597567633;Taip;0;7;0;7
21187;Saulėgrąža;Bitutės;7387477589;Taip;10;3;0;13
21188;Saulėgrąža;Bitutės;5221286194;Taip;5;3;0;8
21189;Saulėgrąža;Bitutės;9481319116;Taip;0;3;2;5
21190;Saulėgrąža;Bitutės;8531862400;Taip;0;0;5;5
21191;Saulėgrąža;Šnekučiai;4943974662;Taip;0;5;0;5
21192;Saulėgrąža;Skruzdėliukai;7211562324;Taip;0;3;1;4
21193;Saulėgrąža;Skruzdėliukai;7636592904;Taip;5;3;0;8
21194;Saulėgrąža;Skruzdėliukai;87694187780;Taip;0;3;0;3
21195;Saulėgrąža;Skruzdėliukai;8550558301;Taip;0;1;0;1
21196;Saulėgrąža;Skruzdėliukai;6036373745;Taip;0;4;0;4
21197;Saulėgrąža;Skruzdėliukai;4023911154;Taip;0;3;1;4
21198;Saulėgrąža;Skruzdėliukai;4768918795;Taip;0;1;0;1
21199;Saulėgrąža;Skruzdėliukai;2029367287;Taip;0;3;0;3
21200;Saulėgrąža;Skruzdėliukai;4904157108;Taip;0;3;4;7
21201;Saulėgrąža;Skruzdėliukai;2453261741;Taip;0;8;2;10
21202;Saulėgrąža;Skruzdėliukai;6867062357;Taip;0;4;0;4
21203;Saulėgrąža;Skruzdėliukai;9701242161;Taip;0;0;4;4
21204;Saulėgrąža;Skruzdėliukai;2123441401;Taip;0;0;10;10
21205;Saulėgrąža;Skruzdėliukai;6373141401;Taip;0;0;2;2
21206;Saulėgrąža;Skruzdėliukai;5674402704;Taip;0;5;0;5
21207;Saulėgrąža;Skruzdėliukai;8140258691;Taip;0;3;0;3
21208;Saulėgrąža;Skruzdėliukai;5336463701;Taip;0;0;1;1
21209;Saulėgrąža;Skruzdėliukai;3839880985;Taip;0;0;3;3
21210;Saulėgrąža;Skruzdėliukai;1397888834;Taip;0;0;9;9
21211;Saulėgrąža;Skruzdėliukai;4902990966;Taip;0;0;8;8
21212;Saulėgrąža;"Boruželės ";3889868838;Taip;5;0;7;12
21213;Saulėgrąža;"Boruželės ";1613110580;Taip;0;0;5;5
21214;Saulėgrąža;"Boruželės ";6802366478;Taip;0;0;7;7
21215;Saulėgrąža;"Boruželės ";9604238128;Taip;0;0;5;5
21216;Saulėgrąža;"Boruželės ";4587532777;Ne;0;0;7;7
21217;Saulėgrąža;"Boruželės ";1008547550;Taip;7;0;2;9
21218;Saulėgrąža;"Boruželės ";4930162914;Taip;0;0;9;9
21219;Saulėgrąža;"Boruželės ";8986368849;Taip;5;0;4;9
21220;Saulėgrąža;"Boruželės ";3080026762;Taip;9;0;0;9
21221;Saulėgrąža;"Boruželės ";9328524382;Taip;13;0;0;13
21222;Saulėgrąža;"Boruželės ";2598768766;Taip;16;0;0;16
21223;Saulėgrąža;"Boruželės ";5734857301;Taip;7;0;3;10
21224;Saulėgrąža;"Boruželės ";9658060059;Taip;15;0;1;16
21225;Saulėgrąža;"Boruželės ";3594593787;Taip;9;0;0;9
21226;Saulėgrąža;"Boruželės ";2455622343;Taip;0;0;3;3
21227;Saulėgrąža;"Boruželės ";3178867955;Taip;6;0;3;9
21228;Saulėgrąža;"Boruželės ";2934189012;Taip;9;0;0;9
21229;Saulėgrąža;Drugeliai;8155080474;Taip;8;0;3;11
21230;Saulėgrąža;Drugeliai;1955944355;Taip;0;0;3;3
21231;Saulėgrąža;Drugeliai;2680631642;Taip;0;0;2;2
21232;Saulėgrąža;Drugeliai;8337203952;Taip;0;0;8;8
21233;Saulėgrąža;Drugeliai;6127496900;Taip;2;0;3;5
21234;Saulėgrąža;Drugeliai;7267854768;Taip;5;3;0;8
21235;Saulėgrąža;Drugeliai;8841882983;Taip;15;3;0;18
21236;Saulėgrąža;Drugeliai;6608001857;Taip;0;5;1;6
21237;Saulėgrąža;Drugeliai;4663169787;Taip;0;0;6;6
21238;Saulėgrąža;Drugeliai;6981928727;Taip;10;0;4;14
21239;Saulėgrąža;Drugeliai;8873608939;Taip;8;3;1;12
21240;Saulėgrąža;Drugeliai;7281353368;Taip;3;0;0;3
21241;Saulėgrąža;Drugeliai;8138991066;Taip;3;0;1;4
21242;Saulėgrąža;Drugeliai;1379283244;Taip;0;5;0;5
21243;Saulėgrąža;Drugeliai;4767744537;Taip;5;0;6;11
21244;Saulėgrąža;Drugeliai;1564385864;Taip;0;0;3;3
21245;Saulėgrąža;Drugeliai;4361365993;Taip;0;7;5;12
21246;Saulėgrąža;Drugeliai;8882080945;Taip;3;0;8;11
21247;Saulėgrąža;Drugeliai;1080500584;Taip;9;3;0;12
21248;Saulėgrąža;Drugeliai;1386348080;Taip;0;0;15;15
21249;Saulėgrąža;Drugeliai;3318222372;Taip;5;3;0;8
21250;Saulėgrąža;Drugeliai;8148900529;Taip;0;0;1;1
21251;Saulėgrąža;Drugeliai;3988854847;Taip;0;0;5;5
21252;Saulėgrąža;Pabiručiai;1193968905;Taip;0;0;3;3
21253;Saulėgrąža;Pabiručiai;6924492377;Taip;0;0;3;3
21254;Saulėgrąža;Pabiručiai;9812784697;Taip;5;0;3;8
21255;Saulėgrąža;Pabiručiai;1732823416;Taip;5;0;6;11
21256;Saulėgrąža;Pabiručiai;2063366170;Taip;0;0;3;3
21257;Saulėgrąža;Pabiručiai;5417303387;Taip;0;0;4;4
21258;Saulėgrąža;Pabiručiai;4113866451;Taip;0;0;4;4
21259;Saulėgrąža;Pabiručiai;5759064166;Taip;0;3;0;3
21260;Saulėgrąža;Pabiručiai;3014850439;Taip;0;0;15;15
21261;Saulėgrąža;Pabiručiai;7563907981;Taip;11;3;3;17
21262;Saulėgrąža;Pabiručiai;7110805205;Taip;16;0;0;16
21263;Saulėgrąža;Pabiručiai;6489291407;Ne;0;0;4;4
21264;Saulėgrąža;Pabiručiai;5302001715;Taip;0;0;5;5
21265;Saulėgrąža;Pabiručiai;6846627257;Taip;0;0;6;6
21266;Saulėgrąža;Pabiručiai;4869924215;Taip;6;0;3;9
21267;Saulėgrąža;Pagrandukai;9226189126;Taip;3;3;1;7
21268;Saulėgrąža;Pagrandukai;7283179482;Taip;10;4;1;15
21269;Saulėgrąža;Pagrandukai;3060727219;Taip;0;0;18;18
21270;Saulėgrąža;Pagrandukai;4405035646;Taip;0;7;1;8
21271;Saulėgrąža;Pagrandukai;4017783391;Taip;3;0;0;3
21272;Saulėgrąža;Pagrandukai;3811142022;Taip;0;0;3;3
21273;Saulėgrąža;Pagrandukai;5584937620;Taip;9;0;2;11
21274;Saulėgrąža;Pagrandukai;3745791935;Taip;13;0;0;13
21275;Saulėgrąža;Pagrandukai;3785206644;Taip;12;0;0;12
21276;Saulėgrąža;Pagrandukai;2395186861;Ne;14;0;0;14
21277;Saulėgrąža;Pagrandukai;6130342214;Taip;0;0;13;13
21278;Saulėgrąža;Pagrandukai;3860139612;Taip;0;0;14;14
21279;Saulėgrąža;Pagrandukai;7545277683;Taip;12;0;0;12
21280;Saulėgrąža;Pagrandukai;5633604322;Taip;18;0;0;18
21281;Saulėgrąža;Pagrandukai;2882565651;Taip;5;0;4;9
21282;Saulėgrąža;Pagrandukai;3270627153;Taip;5;0;5;10
21283;Saulėgrąža;Pagrandukai;3122607003;Taip;3;0;3;6
21284;"Pilaitukas (I. Kanto al. 7A)";BITUTĖS;3519198814;Taip;0;3;0;3
21285;"Pilaitukas (I. Kanto al. 7A)";BITUTĖS;8169484415;Taip;2;6;0;8
21286;"Pilaitukas (I. Kanto al. 7A)";BITUTĖS;1253300093;Taip;0;4;0;4
21287;"Pilaitukas (I. Kanto al. 7A)";BITUTĖS;1729494874;Taip;0;3;0;3
21288;"Pilaitukas (I. Kanto al. 7A)";BITUTĖS;2242454299;Taip;0;4;0;4
21289;"Pilaitukas (I. Kanto al. 7A)";BITUTĖS;9793278788;Taip;0;3;0;3
21290;"Pilaitukas (I. Kanto al. 7A)";BITUTĖS;4082490488;Taip;0;3;0;3
21291;"Pilaitukas (I. Kanto al. 7A)";BITUTĖS;3345387791;Taip;7;0;0;7
21292;"Pilaitukas (I. Kanto al. 7A)";BITUTĖS;3913169122;Taip;0;3;0;3
21293;"Pilaitukas (I. Kanto al. 7A)";BITUTĖS;3541354283;Taip;0;1;3;4
21294;"Pilaitukas (I. Kanto al. 7A)";BITUTĖS;5740951665;Taip;0;3;4;7
21295;"Pilaitukas (I. Kanto al. 7A)";BITUTĖS;4591799893;Taip;18;0;0;18
21296;"Pilaitukas (I. Kanto al. 7A)";BITUTĖS;6308557885;Taip;11;0;0;11
21297;"Pilaitukas (I. Kanto al. 7A)";BITUTĖS;6514731102;Taip;11;0;0;11
21298;"Pilaitukas (I. Kanto al. 7A)";BITUTĖS;5988165204;Taip;0;0;1;1
21299;"Pilaitukas (I. Kanto al. 7A)";BITUTĖS;3037850837;Taip;0;5;0;5
21300;"Pilaitukas (I. Kanto al. 7A)";BITUTĖS;9126553732;Taip;6;2;2;10
21301;"Pilaitukas (I. Kanto al. 7A)";BITUTĖS;7438112270;Taip;1;0;4;5
21302;"Pilaitukas (I. Kanto al. 7A)";BITUTĖS;1295215465;Taip;4;4;0;8
21303;"Pilaitukas (I. Kanto al. 7A)";BITUTĖS;5331915157;Taip;0;3;0;3
21304;"Pilaitukas (I. Kanto al. 7A)";BITUTĖS;6099109886;Taip;0;3;0;3
21305;"Pilaitukas (I. Kanto al. 7A)";BITUTĖS;3159733673;Taip;0;9;0;9
21306;"Pilaitukas (I. Kanto al. 7A)";BITUTĖS;2122392982;Taip;0;11;0;11
21307;"Pilaitukas (I. Kanto al. 7A)";BITUTĖS;7082099968;Taip;8;3;2;13
21308;"Pilaitukas (I. Kanto al. 7A)";ZUIKUČIAI;8993885764;Taip;0;4;0;4
21309;"Pilaitukas (I. Kanto al. 7A)";ZUIKUČIAI;5206637809;Taip;3;4;1;8
21310;"Pilaitukas (I. Kanto al. 7A)";ZUIKUČIAI;5288784331;Taip;0;1;2;3
21311;"Pilaitukas (I. Kanto al. 7A)";ZUIKUČIAI;8255398803;Taip;9;4;0;13
21312;"Pilaitukas (I. Kanto al. 7A)";ZUIKUČIAI;2862447956;Taip;0;3;0;3
21313;"Pilaitukas (I. Kanto al. 7A)";ZUIKUČIAI;8727175656;Taip;0;3;0;3
21314;"Pilaitukas (I. Kanto al. 7A)";ZUIKUČIAI;8207194955;Taip;1;0;9;10
21315;"Pilaitukas (I. Kanto al. 7A)";ZUIKUČIAI;5640802570;Taip;13;3;0;16
21316;"Pilaitukas (I. Kanto al. 7A)";ZUIKUČIAI;4623818227;Taip;0;3;0;3
21317;"Pilaitukas (I. Kanto al. 7A)";ZUIKUČIAI;9260893320;Taip;0;5;0;5
21318;"Pilaitukas (I. Kanto al. 7A)";ZUIKUČIAI;9988041515;Taip;8;0;0;8
21319;"Pilaitukas (I. Kanto al. 7A)";ZUIKUČIAI;9108428738;Taip;8;0;0;8
21320;"Pilaitukas (I. Kanto al. 7A)";ZUIKUČIAI;1607454890;Taip;0;0;2;2
21321;"Pilaitukas (I. Kanto al. 7A)";ZUIKUČIAI;9878890346;Taip;0;3;0;3
21322;"Pilaitukas (I. Kanto al. 7A)";ZUIKUČIAI;5710747769;Taip;3;0;0;3
21323;"Pilaitukas (I. Kanto al. 7A)";ZUIKUČIAI;7568744500;Taip;6;3;1;10
21324;"Pilaitukas (I. Kanto al. 7A)";ZUIKUČIAI;5407354218;Taip;0;7;0;7
21325;"Pilaitukas (I. Kanto al. 7A)";ZUIKUČIAI;1704055907;Taip;0;3;5;8
21326;"Pilaitukas (I. Kanto al. 7A)";ZUIKUČIAI;7853910193;Taip;5;0;3;8
21327;"Pilaitukas (I. Kanto al. 7A)";ZUIKUČIAI;6426415533;Taip;0;3;0;3
21328;"Pilaitukas (I. Kanto al. 7A)";ZUIKUČIAI;9735358433;Taip;0;2;1;3
21329;"Pilaitukas (I. Kanto al. 7A)";ZUIKUČIAI;2705235576;Taip;0;10;0;10
21330;"Pilaitukas (I. Kanto al. 7A)";ZUIKUČIAI;9688421636;Taip;0;3;0;3
21331;"Pilaitukas (I. Kanto al. 7A)";ANČIUKAI;3357097410;Taip;5;1;0;6
21332;"Pilaitukas (I. Kanto al. 7A)";ANČIUKAI;7773318230;Taip;0;14;0;14
21333;"Pilaitukas (I. Kanto al. 7A)";ANČIUKAI;4097742120;Taip;0;4;0;4
21334;"Pilaitukas (I. Kanto al. 7A)";ANČIUKAI;2923272767;Taip;0;4;0;4
21335;"Pilaitukas (I. Kanto al. 7A)";ANČIUKAI;8620858011;Taip;0;5;0;5
21336;"Pilaitukas (I. Kanto al. 7A)";ANČIUKAI;4286388920;Taip;0;0;1;1
21337;"Pilaitukas (I. Kanto al. 7A)";ANČIUKAI;3761827714;Taip;0;1;3;4
21338;"Pilaitukas (I. Kanto al. 7A)";ANČIUKAI;8643066116;Taip;0;3;1;4
21339;"Pilaitukas (I. Kanto al. 7A)";ANČIUKAI;1120549352;Taip;5;0;3;8
21340;"Pilaitukas (I. Kanto al. 7A)";ANČIUKAI;6888607864;Taip;9;6;0;15
21341;"Pilaitukas (I. Kanto al. 7A)";ANČIUKAI;7876850509;Taip;0;8;1;9
21342;"Pilaitukas (I. Kanto al. 7A)";ANČIUKAI;3035456834;Taip;4;2;0;6
21343;"Pilaitukas (I. Kanto al. 7A)";ANČIUKAI;2476942319;Taip;4;2;0;6
21344;"Pilaitukas (I. Kanto al. 7A)";ANČIUKAI;8033540052;Taip;13;0;0;13
21345;"Pilaitukas (I. Kanto al. 7A)";ANČIUKAI;1781762820;Taip;5;6;0;11
21346;"Pilaitukas (I. Kanto al. 7A)";ANČIUKAI;3005101776;Taip;0;0;4;4
21347;"Pilaitukas (I. Kanto al. 7A)";ANČIUKAI;8787181006;Taip;5;0;0;5
21348;"Pilaitukas (I. Kanto al. 7A)";ANČIUKAI;7189824054;Taip;0;2;4;6
21349;"Pilaitukas (I. Kanto al. 7A)";ANČIUKAI;9332831979;Taip;3;3;0;6
21350;"Pilaitukas (I. Kanto al. 7A)";ANČIUKAI;5706918634;Taip;12;0;1;13
21351;"Pilaitukas (I. Kanto al. 7A)";ANČIUKAI;8954370321;Taip;6;0;4;10
21352;"Pilaitukas (I. Kanto al. 7A)";ANČIUKAI;1660462256;Taip;0;12;0;12
21353;"Pilaitukas (I. Kanto al. 7A)";MEŠKIUKAI;8577357264;Taip;8;3;0;11
21354;"Pilaitukas (I. Kanto al. 7A)";MEŠKIUKAI;5297214263;Taip;0;8;0;8
21355;"Pilaitukas (I. Kanto al. 7A)";MEŠKIUKAI;8268790017;Taip;0;3;0;3
21356;"Pilaitukas (I. Kanto al. 7A)";MEŠKIUKAI;2054626415;Taip;15;3;0;18
21357;"Pilaitukas (I. Kanto al. 7A)";MEŠKIUKAI;9742268665;Taip;7;0;0;7
21358;"Pilaitukas (I. Kanto al. 7A)";MEŠKIUKAI;8322980583;Taip;5;3;0;8
21359;"Pilaitukas (I. Kanto al. 7A)";MEŠKIUKAI;1610122884;Taip;8;0;0;8
21360;"Pilaitukas (I. Kanto al. 7A)";MEŠKIUKAI;3867660147;Taip;8;0;0;8
21361;"Pilaitukas (I. Kanto al. 7A)";MEŠKIUKAI;2365387089;Taip;1;1;0;2
21362;"Pilaitukas (I. Kanto al. 7A)";MEŠKIUKAI;9670329628;Taip;18;0;0;18
21363;"Pilaitukas (I. Kanto al. 7A)";MEŠKIUKAI;7750575554;Taip;15;0;0;15
21364;"Pilaitukas (I. Kanto al. 7A)";MEŠKIUKAI;9397435605;Taip;5;0;0;5
21365;"Pilaitukas (I. Kanto al. 7A)";MEŠKIUKAI;9187961584;Taip;4;0;0;4
21366;"Pilaitukas (I. Kanto al. 7A)";MEŠKIUKAI;7781507786;Taip;0;3;0;3
21367;"Pilaitukas (I. Kanto al. 7A)";MEŠKIUKAI;4171896175;Taip;6;0;0;6
21368;"Pilaitukas (I. Kanto al. 7A)";MEŠKIUKAI;1362132769;Taip;5;0;0;5
21369;"Pilaitukas (I. Kanto al. 7A)";MEŠKIUKAI;3027792710;Taip;6;0;0;6
21370;"Pilaitukas (I. Kanto al. 7A)";MEŠKIUKAI;6807166920;Taip;0;7;0;7
21371;"Pilaitukas (I. Kanto al. 7A)";MEŠKIUKAI;1591276987;Taip;3;0;0;3
21372;"Pilaitukas (I. Kanto al. 7A)";MEŠKIUKAI;2830212921;Taip;0;3;0;3
21373;"Pilaitukas (I. Kanto al. 7A)";MEŠKIUKAI;9930306085;Taip;17;0;0;17
21374;"Pilaitukas (I. Kanto al. 7A)";MEŠKIUKAI;8279288250;Taip;0;4;0;4
21375;"Pilaitukas (I. Kanto al. 7A)";ŽUVYTĖS;48011638560;Taip;0;3;0;3
21376;"Pilaitukas (I. Kanto al. 7A)";ŽUVYTĖS;8109335587;Taip;0;3;0;3
21377;"Pilaitukas (I. Kanto al. 7A)";ŽUVYTĖS;8319676743;Taip;1;3;0;4
21378;"Pilaitukas (I. Kanto al. 7A)";ŽUVYTĖS;36338976218;Taip;9;1;0;10
21379;"Pilaitukas (I. Kanto al. 7A)";ŽUVYTĖS;9224653856;Taip;8;3;0;11
21380;"Pilaitukas (I. Kanto al. 7A)";ŽUVYTĖS;4694691187;Taip;5;3;0;8
21381;"Pilaitukas (I. Kanto al. 7A)";ŽUVYTĖS;2110458181;Taip;0;3;0;3
21382;"Pilaitukas (I. Kanto al. 7A)";ŽUVYTĖS;5252233127;Taip;9;6;0;15
21383;"Pilaitukas (I. Kanto al. 7A)";ŽUVYTĖS;5206439753;Taip;0;6;0;6
21384;"Pilaitukas (I. Kanto al. 7A)";ŽUVYTĖS;6222888898;Taip;3;5;0;8
21385;"Pilaitukas (I. Kanto al. 7A)";ŽUVYTĖS;5211988291;Taip;1;3;0;4
21386;"Pilaitukas (I. Kanto al. 7A)";ŽUVYTĖS;1512181401;Taip;6;3;0;9
21387;"Pilaitukas (I. Kanto al. 7A)";ŽUVYTĖS;2298935154;Taip;2;3;0;5
21388;"Pilaitukas (I. Kanto al. 7A)";ŽUVYTĖS;5949185075;Taip;0;3;0;3
21389;"Pilaitukas (I. Kanto al. 7A)";ŽUVYTĖS;2117570444;Taip;4;2;0;6
21390;"Pilaitukas (I. Kanto al. 7A)";ŽUVYTĖS;79485847381;Taip;0;3;0;3
21391;"Pilaitukas (I. Kanto al. 7A)";ŽUVYTĖS;7909465673;Taip;2;3;0;5
21392;"Pilaitukas (I. Kanto al. 7A)";ŽUVYTĖS;92108889661;Taip;2;3;0;5
21393;"Pilaitukas (I. Kanto al. 7A)";ŽUVYTĖS;4505384039;Taip;6;3;0;9
21394;"Pilaitukas (I. Kanto al. 7A)";ŽUVYTĖS;58250008277;Taip;3;3;0;6
21395;"Pilaitukas (I. Kanto al. 7A)";ŽUVYTĖS;1618432877;Taip;0;2;0;2
21396;"Pilaitukas (I. Kanto al. 7A)";ŽUVYTĖS;9724892897;Taip;5;3;0;8
21397;"Pilaitukas (I. Kanto al. 7A)";ŽUVYTĖS;3821748678;Taip;0;3;0;3
21398;"Pilaitukas (I. Kanto al. 7A)";ŽUVYTĖS;1114477688;Taip;0;4;0;4
21399;"Pilaitukas (I. Kanto al. 7A)";PAUKŠTELIAI;3325511140;Taip;1;5;0;6
21400;"Pilaitukas (I. Kanto al. 7A)";PAUKŠTELIAI;6514784647;Taip;0;3;0;3
21401;"Pilaitukas (I. Kanto al. 7A)";PAUKŠTELIAI;4505147961;Taip;1;3;0;4
21402;"Pilaitukas (I. Kanto al. 7A)";PAUKŠTELIAI;2736736697;Taip;5;1;0;6
21403;"Pilaitukas (I. Kanto al. 7A)";PAUKŠTELIAI;1135880899;Taip;10;3;0;13
21404;"Pilaitukas (I. Kanto al. 7A)";PAUKŠTELIAI;18466900688;Taip;8;4;0;12
21405;"Pilaitukas (I. Kanto al. 7A)";PAUKŠTELIAI;4038320896;Taip;1;3;0;4
21406;"Pilaitukas (I. Kanto al. 7A)";PAUKŠTELIAI;3794882532;Taip;10;3;0;13
21407;"Pilaitukas (I. Kanto al. 7A)";PAUKŠTELIAI;5689385925;Taip;0;5;0;5
21408;"Pilaitukas (I. Kanto al. 7A)";PAUKŠTELIAI;5405252621;Taip;8;3;0;11
21409;"Pilaitukas (I. Kanto al. 7A)";PAUKŠTELIAI;5939557073;Taip;0;3;0;3
21410;"Pilaitukas (I. Kanto al. 7A)";PAUKŠTELIAI;39600380611;Taip;5;2;0;7
21411;"Pilaitukas (I. Kanto al. 7A)";PAUKŠTELIAI;3214740183;Taip;4;4;0;8
21412;"Pilaitukas (I. Kanto al. 7A)";PAUKŠTELIAI;2929868229;Taip;2;3;0;5
21413;"Pilaitukas (I. Kanto al. 7A)";PAUKŠTELIAI;9924612250;Taip;7;3;0;10
21414;"Pilaitukas (I. Kanto al. 7A)";PAUKŠTELIAI;6117985788;Taip;0;3;0;3
21415;"Pilaitukas (I. Kanto al. 7A)";PAUKŠTELIAI;57931719105;Taip;4;1;0;5
21416;"Pilaitukas (I. Kanto al. 7A)";PAUKŠTELIAI;9618329726;Taip;2;3;0;5
21417;"Pilaitukas (I. Kanto al. 7A)";PAUKŠTELIAI;1003278169;Taip;0;3;0;3
21418;"Pilaitukas (I. Kanto al. 7A)";PAUKŠTELIAI;9450834035;Taip;8;3;0;11
21419;"Pilaitukas (I. Kanto al. 7A)";PAUKŠTELIAI;5604992163;Taip;8;3;0;11
21420;"Pilaitukas (I. Kanto al. 7A)";PAUKŠTELIAI;1693309238;Taip;0;3;0;3
21421;"Pilaitukas (I. Kanto al. 7A)";BORUŽĖLĖS;8364902911;Taip;0;3;0;3
21422;"Pilaitukas (I. Kanto al. 7A)";BORUŽĖLĖS;5984878126;Taip;0;8;1;9
21423;"Pilaitukas (I. Kanto al. 7A)";BORUŽĖLĖS;6024861998;Taip;0;0;1;1
21424;"Pilaitukas (I. Kanto al. 7A)";BORUŽĖLĖS;9898379569;Taip;0;3;3;6
21425;"Pilaitukas (I. Kanto al. 7A)";BORUŽĖLĖS;5324806808;Taip;0;0;6;6
21426;"Pilaitukas (I. Kanto al. 7A)";BORUŽĖLĖS;5185051301;Taip;0;3;1;4
21427;"Pilaitukas (I. Kanto al. 7A)";BORUŽĖLĖS;5326258755;Taip;2;6;1;9
21428;"Pilaitukas (I. Kanto al. 7A)";BORUŽĖLĖS;6838035491;Taip;0;0;3;3
21429;"Pilaitukas (I. Kanto al. 7A)";BORUŽĖLĖS;1731106179;Taip;0;10;5;15
21430;"Pilaitukas (I. Kanto al. 7A)";BORUŽĖLĖS;3784944532;Taip;5;0;9;14
21431;"Pilaitukas (I. Kanto al. 7A)";BORUŽĖLĖS;5186675623;Taip;0;0;1;1
21432;"Pilaitukas (I. Kanto al. 7A)";BORUŽĖLĖS;4317406707;Taip;0;0;3;3
21433;"Pilaitukas (I. Kanto al. 7A)";BORUŽĖLĖS;8380819975;Taip;5;3;0;8
21434;"Pilaitukas (I. Kanto al. 7A)";BORUŽĖLĖS;4589130143;Taip;7;0;3;10
21435;"Pilaitukas (I. Kanto al. 7A)";BORUŽĖLĖS;1944443723;Taip;3;0;3;6
21436;"Pilaitukas (I. Kanto al. 7A)";DRUGELIAI;1677962644;Ne;0;6;0;6
21437;"Pilaitukas (I. Kanto al. 7A)";DRUGELIAI;4745358362;Ne;0;6;0;6
21438;"Pilaitukas (I. Kanto al. 7A)";DRUGELIAI;2917197418;Ne;1;9;2;12
21439;"Pilaitukas (I. Kanto al. 7A)";DRUGELIAI;6712878938;Taip;12;0;1;13
21440;"Pilaitukas (I. Kanto al. 7A)";DRUGELIAI;3298272815;Taip;8;0;1;9
21441;"Pilaitukas (I. Kanto al. 7A)";DRUGELIAI;3772830210;Taip;5;0;2;7
21442;"Pilaitukas (I. Kanto al. 7A)";DRUGELIAI;4719223490;Taip;0;0;4;4
21443;"Pilaitukas (I. Kanto al. 7A)";DRUGELIAI;9414051187;Taip;0;2;4;6
21444;"Pilaitukas (I. Kanto al. 7A)";DRUGELIAI;6280870972;Taip;18;0;0;18
21445;"Pilaitukas (I. Kanto al. 7A)";DRUGELIAI;9741985709;Ne;6;0;6;12
21446;"Pilaitukas (I. Kanto al. 7A)";DRUGELIAI;7807341574;Taip;7;1;0;8
21447;"Pilaitukas (I. Kanto al. 7A)";DRUGELIAI;5215800828;Taip;0;6;0;6
21448;"Pilaitukas (I. Kanto al. 7A)";DRUGELIAI;2414941263;Ne;0;0;1;1
21449;"Pilaitukas (I. Kanto al. 7A)";DRUGELIAI;2210253038;Taip;7;6;0;13
21450;"Pilaitukas (I. Kanto al. 7A)";DRUGELIAI;7222856683;Taip;6;2;0;8
21451;"Pilaitukas (I. Kanto al. 7A)";DRUGELIAI;8710069256;Taip;4;6;2;12
21452;"Pilaitukas (I. Kanto al. 7A)";DRUGELIAI;7830059468;Taip;12;0;1;13
21453;"Pilaitukas (I. Kanto al. 7A)";DRUGELIAI;7479542200;Taip;8;0;5;13
21454;"Pilaitukas (I. Kanto al. 7A)";DRUGELIAI;5901884512;Taip;0;3;0;3
21455;"Pilaitukas (I. Kanto al. 7A)";DRUGELIAI;1747834520;Taip;0;9;1;10
21456;"Pilaitukas (I. Kanto al. 7A)";PELIUKAI;9246925227;Taip;3;0;3;6
21457;"Pilaitukas (I. Kanto al. 7A)";PELIUKAI;7808204054;Taip;3;0;2;5
21458;"Pilaitukas (I. Kanto al. 7A)";PELIUKAI;4810825253;Taip;3;4;0;7
21459;"Pilaitukas (I. Kanto al. 7A)";PELIUKAI;8769116377;Taip;0;0;7;7
21460;"Pilaitukas (I. Kanto al. 7A)";PELIUKAI;8501376663;Taip;0;3;0;3
21461;"Pilaitukas (I. Kanto al. 7A)";PELIUKAI;3395656390;Taip;0;0;3;3
21462;"Pilaitukas (I. Kanto al. 7A)";PELIUKAI;5421602723;Ne;0;5;0;5
21463;"Pilaitukas (I. Kanto al. 7A)";PELIUKAI;6754825353;Taip;4;1;0;5
21464;"Pilaitukas (I. Kanto al. 7A)";PELIUKAI;8168228529;Taip;0;7;0;7
21465;"Pilaitukas (I. Kanto al. 7A)";PELIUKAI;4014329370;Taip;0;0;3;3
21466;"Pilaitukas (I. Kanto al. 7A)";PELIUKAI;6833933586;Taip;0;6;0;6
21467;"Pilaitukas (I. Kanto al. 7A)";PELIUKAI;8877142428;Taip;0;0;5;5
21468;"Pilaitukas (I. Kanto al. 7A)";PELIUKAI;2416277190;Taip;0;4;3;7
21469;"Pilaitukas (I. Kanto al. 7A)";PELIUKAI;9774222130;Taip;0;2;6;8
21470;"Pilaitukas (I. Kanto al. 7A)";PELIUKAI;1270365948;Taip;0;4;2;6
21471;"Pilaitukas (I. Kanto al. 7A)";PELIUKAI;7604004800;Taip;0;4;1;5
21472;"Pilaitukas (I. Kanto al. 7A)";PELIUKAI;9556421129;Taip;10;0;0;10
21473;"Pilaitukas (I. Kanto al. 7A)";PELIUKAI;3954210452;Ne;7;0;0;7
21474;"Pilaitukas (I. Kanto al. 7A)";PELIUKAI;5223336496;Taip;4;0;2;6
21475;"Pilaitukas (I. Kanto al. 7A)";PELIUKAI;3651140874;Taip;2;3;0;5
21476;"Pilaitukas (I. Kanto al. 7A)";PELIUKAI;2823859128;Taip;0;0;4;4
21477;"Pilaitukas (I. Kanto al. 7A)";PELIUKAI;7750936973;Taip;11;0;0;11
21478;"Pilaitukas (I. Kanto al. 7A)";KAČIUKAI;2406183145;Taip;4;5;0;9
21479;"Pilaitukas (I. Kanto al. 7A)";KAČIUKAI;2379660463;Taip;4;5;0;9
21480;"Pilaitukas (I. Kanto al. 7A)";KAČIUKAI;1585341963;Taip;0;1;0;1
21481;"Pilaitukas (I. Kanto al. 7A)";KAČIUKAI;9038324313;Taip;0;3;0;3
21482;"Pilaitukas (I. Kanto al. 7A)";KAČIUKAI;7594484959;Taip;6;3;0;9
21483;"Pilaitukas (I. Kanto al. 7A)";KAČIUKAI;2463482642;Taip;0;4;0;4
21484;"Pilaitukas (I. Kanto al. 7A)";KAČIUKAI;3080014745;Taip;2;7;0;9
21485;"Pilaitukas (I. Kanto al. 7A)";KAČIUKAI;5353687011;Taip;0;10;0;10
21486;"Pilaitukas (I. Kanto al. 7A)";KAČIUKAI;6525191057;Taip;0;1;2;3
21487;"Pilaitukas (I. Kanto al. 7A)";KAČIUKAI;8009040109;Taip;0;3;1;4
21488;"Pilaitukas (I. Kanto al. 7A)";KAČIUKAI;2105380328;Taip;7;0;2;9
21489;"Pilaitukas (I. Kanto al. 7A)";KAČIUKAI;5326689274;Taip;3;3;1;7
21490;"Pilaitukas (I. Kanto al. 7A)";KAČIUKAI;9653647227;Taip;3;3;1;7
21491;"Pilaitukas (I. Kanto al. 7A)";KAČIUKAI;4022543517;Taip;0;3;0;3
21492;"Pilaitukas (I. Kanto al. 7A)";KAČIUKAI;1999942175;Taip;5;3;2;10
21493;"Pilaitukas (I. Kanto al. 7A)";KAČIUKAI;3825942473;Taip;1;9;0;10
21494;"Pilaitukas (I. Kanto al. 7A)";KAČIUKAI;1611371690;Taip;18;0;0;18
21495;"Pilaitukas (I. Kanto al. 7A)";KAČIUKAI;9247501721;Taip;0;1;2;3
21496;"Pilaitukas (I. Kanto al. 7A)";KAČIUKAI;6436694057;Taip;3;3;0;6
21497;"Pilaitukas (I. Kanto al. 7A)";KAČIUKAI;9974310580;Taip;17;0;0;17
21498;"Pilaitukas (I. Kanto al. 7A)";KAČIUKAI;6235375235;Taip;7;0;1;8
21499;"Pilaitukas (I. Kanto al. 7A)";KAČIUKAI;9914575692;Taip;10;0;0;10
21500;"Pilaitukas (I. Kanto al. 7A)";KAČIUKAI;4341157841;Taip;0;1;0;1
21501;"Pilaitukas (I. Kanto al. 7A)";SAULUTĖS;8047683859;Taip;5;4;0;9
21502;"Pilaitukas (I. Kanto al. 7A)";SAULUTĖS;8694369154;Taip;5;4;0;9
21503;"Pilaitukas (I. Kanto al. 7A)";SAULUTĖS;9405479859;Taip;3;0;0;3
21504;"Pilaitukas (I. Kanto al. 7A)";SAULUTĖS;1052452915;Taip;15;0;0;15
21505;"Pilaitukas (I. Kanto al. 7A)";SAULUTĖS;2336933998;Taip;15;0;0;15
21506;"Pilaitukas (I. Kanto al. 7A)";SAULUTĖS;1134083816;Taip;9;0;0;9
21507;"Pilaitukas (I. Kanto al. 7A)";SAULUTĖS;2110996493;Taip;7;0;1;8
21508;"Pilaitukas (I. Kanto al. 7A)";SAULUTĖS;1452645899;Taip;7;0;0;7
21509;"Pilaitukas (I. Kanto al. 7A)";SAULUTĖS;9587140991;Taip;0;18;0;18
21510;"Pilaitukas (I. Kanto al. 7A)";SAULUTĖS;8306015313;Taip;0;18;0;18
21511;"Pilaitukas (I. Kanto al. 7A)";SAULUTĖS;2215317686;Taip;4;0;0;4
21512;"Pilaitukas (I. Kanto al. 7A)";MENULIUKAI;6337917448;Taip;0;5;0;5
21513;"Pilaitukas (I. Kanto al. 7A)";MENULIUKAI;3636976107;Taip;0;5;0;5
21514;"Pilaitukas (I. Kanto al. 7A)";MENULIUKAI;5026344198;Taip;2;3;0;5
21515;"Pilaitukas (I. Kanto al. 7A)";MENULIUKAI;5564784922;Taip;0;3;0;3
21516;"Pilaitukas (I. Kanto al. 7A)";MENULIUKAI;1290017967;Taip;0;3;0;3
21517;"Pilaitukas (I. Kanto al. 7A)";MENULIUKAI;1841240800;Taip;0;3;0;3
21518;"Pilaitukas (I. Kanto al. 7A)";MENULIUKAI;4710865219;Taip;0;3;0;3
21519;"Pilaitukas (I. Kanto al. 7A)";MENULIUKAI;5691854235;Taip;0;4;0;4
21520;"Pilaitukas (I. Kanto al. 7A)";MENULIUKAI;6054821801;Taip;0;2;0;2
21521;"Pilaitukas (I. Kanto al. 7A)";MENULIUKAI;1620231835;Taip;14;0;0;14
21522;"Pilaitukas (I. Kanto al. 7A)";MENULIUKAI;1532252453;Taip;23;1;0;24
21523;"Pilaitukas (I. Kanto al. 7A)";MENULIUKAI;8225571149;Taip;0;18;0;18
21524;"Pilaitukas (I. Kanto al. 7A)";MENULIUKAI;8207648026;Taip;5;3;0;8
21525;"Pilaitukas (I. Kanto al. 7A)";MENULIUKAI;3921932673;Taip;5;3;0;8
21526;"Pilaitukas (I. Kanto al. 7A)";MENULIUKAI;7855892595;Taip;0;18;0;18
21527;"Pilaitukas (I. Kanto al. 7A)";MENULIUKAI;5682244165;Taip;0;3;0;3
21528;"Pilaitukas (I. Kanto al. 7A)";MENULIUKAI;3952708917;Taip;9;3;0;12
21529;"Pilaitukas (I. Kanto al. 7A)";ĖŽIUKAI;1568651642;Taip;5;0;7;12
21530;"Pilaitukas (I. Kanto al. 7A)";ĖŽIUKAI;2892275540;Taip;0;4;0;4
21531;"Pilaitukas (I. Kanto al. 7A)";ĖŽIUKAI;1746050808;Taip;0;3;0;3
21532;"Pilaitukas (I. Kanto al. 7A)";ĖŽIUKAI;2633256935;Taip;14;0;0;14
21533;"Pilaitukas (I. Kanto al. 7A)";ĖŽIUKAI;8747053041;Taip;14;0;0;14
21534;"Pilaitukas (I. Kanto al. 7A)";ĖŽIUKAI;7555601497;Taip;8;0;3;11
21535;"Pilaitukas (I. Kanto al. 7A)";ĖŽIUKAI;6019760696;Taip;2;3;5;10
21536;"Pilaitukas (I. Kanto al. 7A)";ĖŽIUKAI;5979852431;Taip;18;0;0;18
21537;"Pilaitukas (I. Kanto al. 7A)";ĖŽIUKAI;6271751691;Taip;9;0;2;11
21538;"Pilaitukas (I. Kanto al. 7A)";ĖŽIUKAI;9306169443;Taip;0;4;1;5
21539;"Pilaitukas (I. Kanto al. 7A)";ĖŽIUKAI;5155899628;Taip;7;0;0;7
21540;"Pilaitukas (I. Kanto al. 7A)";ĖŽIUKAI;5340877261;Taip;7;0;0;7
21541;"Pilaitukas (I. Kanto al. 7A)";ĖŽIUKAI;2342453729;Taip;8;2;0;10
21542;"Pilaitukas (I. Kanto al. 7A)";ĖŽIUKAI;6064545501;Taip;5;5;0;10
21543;"Pilaitukas (I. Kanto al. 7A)";ĖŽIUKAI;5904710385;Taip;10;3;0;13
21544;"Pilaitukas (I. Kanto al. 7A)";ĖŽIUKAI;1486895496;Taip;11;3;0;14
21545;"Pilaitukas (I. Kanto al. 7A)";ĖŽIUKAI;9441608677;Taip;8;0;1;9
21546;Vilija;BORUŽĖLĖS;6611278346;Taip;0;0;9;9
21547;Vilija;BORUŽĖLĖS;5979446899;Taip;8;0;5;13
21548;Vilija;BORUŽĖLĖS;3386809866;Taip;13;0;0;13
21549;Vilija;BORUŽĖLĖS;7980759563;Taip;0;0;5;5
21550;Vilija;BORUŽĖLĖS;3301367418;Taip;0;3;0;3
21551;Vilija;BORUŽĖLĖS;6115055683;Taip;4;4;0;8
21552;Vilija;BORUŽĖLĖS;8995800590;Taip;13;0;0;13
21553;Vilija;BORUŽĖLĖS;4577389098;Taip;0;0;1;1
21554;Vilija;BORUŽĖLĖS;9806725516;Taip;7;0;1;8
21555;Vilija;BORUŽĖLĖS;6665382535;Taip;0;3;0;3
21556;Vilija;BORUŽĖLĖS;4791053946;Taip;5;3;1;9
21557;Vilija;BORUŽĖLĖS;4755512150;Taip;0;6;0;6
21558;Vilija;BORUŽĖLĖS;7464020972;Taip;6;3;0;9
21559;Vilija;NYKŠTUKAI;8248774222;Taip;5;3;2;10
21560;Vilija;NYKŠTUKAI;7009463901;Taip;0;4;0;4
21561;Vilija;NYKŠTUKAI;66817455759;Taip;0;3;1;4
21562;Vilija;NYKŠTUKAI;3201809038;Taip;0;3;1;4
21563;Vilija;NYKŠTUKAI;7469836390;Taip;0;6;0;6
21564;Vilija;NYKŠTUKAI;8364033602;Taip;5;3;1;9
21565;Vilija;NYKŠTUKAI;3544848804;Taip;0;3;0;3
21566;Vilija;NYKŠTUKAI;6136579994;Taip;10;3;0;13
21567;Vilija;NYKŠTUKAI;1116822936;Taip;0;3;0;3
21568;Vilija;NYKŠTUKAI;5563356449;Taip;0;3;0;3
21569;Vilija;NYKŠTUKAI;8756465854;Taip;0;3;5;8
21570;Vilija;NYKŠTUKAI;1717847351;Taip;0;3;1;4
21571;Vilija;NYKŠTUKAI;1751533938;Taip;0;3;0;3
21572;Vilija;NYKŠTUKAI;2532658333;Taip;5;3;1;9
21573;Vilija;ANČIUKAI;5776170550;Taip;0;3;3;6
21574;Vilija;ANČIUKAI;5643311237;Taip;4;3;0;7
21575;Vilija;ANČIUKAI;9176710135;Taip;3;3;0;6
21576;Vilija;ANČIUKAI;8073341597;Taip;6;3;0;9
21577;Vilija;ANČIUKAI;8493278100;Taip;10;4;0;14
21578;Vilija;ANČIUKAI;3556336263;Taip;0;0;3;3
21579;Vilija;ANČIUKAI;4291690659;Taip;5;3;0;8
21580;Vilija;ANČIUKAI;3857271014;Taip;0;0;3;3
21581;Vilija;ANČIUKAI;3552472323;Taip;0;8;0;8
21582;Vilija;ANČIUKAI;5683016588;Taip;5;0;1;6
21583;Vilija;ANČIUKAI;3489127587;Taip;0;14;0;14
21584;Vilija;ANČIUKAI;4780760918;Taip;3;3;0;6
21585;Vilija;ANČIUKAI;7012683174;Taip;7;0;0;7
21586;Vilija;ANČIUKAI;4412011292;Taip;10;0;1;11
21587;Vilija;ANČIUKAI;6385918522;Taip;0;9;0;9
21588;Vilija;ANČIUKAI;9531574134;Taip;0;3;0;3
21589;Vilija;ANČIUKAI;4400813531;Taip;6;4;0;10
21590;Vilija;ANČIUKAI;5454031929;Taip;18;0;0;18
21591;Vilija;ANČIUKAI;4858617162;Taip;0;9;0;9
21592;Vilija;ANČIUKAI;8318388772;Taip;0;9;0;9
21593;Vilija;ANČIUKAI;3677313088;Taip;0;7;0;7
21594;Vilija;ANČIUKAI;6815408748;Taip;10;0;0;10
21595;Vilija;ANČIUKAI;2371667380;Taip;0;3;1;4
21596;Vilija;DRUGELIAI;2205400512;Taip;0;3;1;4
21597;Vilija;DRUGELIAI;2309358870;Taip;3;0;1;4
21598;Vilija;DRUGELIAI;5530078264;Taip;0;3;2;5
21599;Vilija;DRUGELIAI;3131712783;Taip;0;4;0;4
21600;Vilija;DRUGELIAI;2807100092;Taip;0;11;1;12
21601;Vilija;DRUGELIAI;5340772605;Taip;3;3;0;6
21602;Vilija;DRUGELIAI;8429923120;Taip;6;3;4;13
21603;Vilija;DRUGELIAI;7418104659;Taip;1;0;5;6
21604;Vilija;DRUGELIAI;3667953591;Taip;0;0;2;2
21605;Vilija;DRUGELIAI;9740915508;Taip;0;0;4;4
21606;Vilija;DRUGELIAI;7836199284;Taip;0;3;0;3
21607;Vilija;DRUGELIAI;7482818685;Taip;3;0;2;5
21608;Vilija;DRUGELIAI;5455278072;Taip;0;0;4;4
21609;Vilija;DRUGELIAI;3349199472;Taip;0;13;0;13
21610;Vilija;DRUGELIAI;6057668143;Taip;0;3;2;5
21611;Vilija;DRUGELIAI;8420744276;Taip;0;9;0;9
21612;Vilija;SMERFAI;7927617851;Taip;0;3;0;3
21613;Vilija;SMERFAI;5508269515;Taip;0;3;0;3
21614;Vilija;SMERFAI;1270627404;Taip;0;1;0;1
21615;Vilija;SMERFAI;2575398136;Taip;0;1;0;1
21616;Vilija;SMERFAI;2164009051;Taip;0;2;0;2
21617;Vilija;SMERFAI;3021504467;Taip;3;3;0;6
21618;Vilija;SMERFAI;5617568215;Taip;0;5;0;5
21619;Vilija;SMERFAI;5056566642;Taip;0;7;0;7
21620;Vilija;SMERFAI;3058713381;Taip;0;3;1;4
21621;Vilija;SMERFAI;4297107641;Taip;0;3;2;5
21622;Vilija;SMERFAI;6165754839;Taip;0;3;1;4
21623;Vilija;SMERFAI;6477644899;Taip;0;4;0;4
21624;Vilija;SMERFAI;25857686522;Taip;5;3;0;8
21625;Vilija;SMERFAI;6937555692;Taip;0;3;4;7
21626;Vilija;SMERFAI;1580316618;Taip;0;3;0;3
21627;Vilija;SMERFAI;5976988338;Ne;0;3;0;3
21628;Vilija;SMERFAI;7606434084;Taip;0;3;0;3
21629;Vilija;SMERFAI;5825920843;Taip;6;5;0;11
21630;Vilija;SAULUTĖS;1442878380;Taip;3;3;0;6
21631;Vilija;SAULUTĖS;7052024709;Ne;0;3;1;4
21632;Vilija;SAULUTĖS;5075219269;Taip;0;3;0;3
21633;Vilija;SAULUTĖS;1161738361;Taip;3;3;0;6
21634;Vilija;SAULUTĖS;7749592467;Ne;0;3;0;3
21635;Vilija;SAULUTĖS;5653564054;Taip;0;3;0;3
21636;Vilija;SAULUTĖS;6706924324;Taip;0;3;0;3
21637;Vilija;SAULUTĖS;5561043797;Taip;9;3;0;12
21638;Vilija;SAULUTĖS;6825500779;Taip;0;3;0;3
21639;Vilija;SAULUTĖS;7860102120;Taip;0;3;2;5
21640;Vilija;SAULUTĖS;7673248841;Ne;0;5;0;5
21641;Vilija;SAULUTĖS;4481147539;Taip;0;9;0;9
21642;Vilija;SAULUTĖS;7915451529;Taip;7;3;0;10
21643;Vilija;SAULUTĖS;4253910558;Taip;5;3;0;8
21644;Vilija;SAULUTĖS;1290880830;Taip;6;3;0;9
21645;Vilija;SAULUTĖS;7880863171;Taip;0;3;2;5
21646;Vilija;SAULUTĖS;6792458439;Taip;5;3;0;8
21647;Vilija;SAULUTĖS;7603226092;Taip;0;4;0;4
21648;Vilija;SAULUTĖS;2551070326;Taip;0;3;1;4
21649;Vilija;SAULUTĖS;3363035704;Ne;0;3;4;7
21650;Vilija;ZUIKUČIAI;5128863532;Taip;8;0;2;10
21651;Vilija;ZUIKUČIAI;7194803557;Taip;0;6;0;6
21652;Vilija;ZUIKUČIAI;9726826566;Taip;0;9;0;9
21653;Vilija;ZUIKUČIAI;6857688873;Taip;0;3;0;3
21654;Vilija;ZUIKUČIAI;8586835095;Taip;9;0;1;10
21655;Vilija;ZUIKUČIAI;4985952177;Taip;8;0;1;9
21656;Vilija;ZUIKUČIAI;4774836050;Taip;9;0;0;9
21657;Vilija;ZUIKUČIAI;9414667437;Taip;8;5;0;13
21658;Vilija;ZUIKUČIAI;9264550987;Taip;10;0;2;12
21659;Vilija;ZUIKUČIAI;5381198018;Taip;0;4;0;4
21660;Vilija;ZUIKUČIAI;4355138593;Taip;3;4;0;7
21661;Vilija;ZUIKUČIAI;5735417577;Taip;0;0;5;5
21662;Vilija;ZUIKUČIAI;9370046849;Taip;0;3;1;4
21663;Vilija;ZUIKUČIAI;7109895494;Taip;9;0;0;9
21664;Vilija;ZUIKUČIAI;4902127595;Taip;0;0;4;4
21665;Vilija;ZUIKUČIAI;4444129040;Taip;0;2;0;2
21666;Vilija;ZUIKUČIAI;3168061557;Taip;0;3;4;7
21667;Vilija;ZUIKUČIAI;7813580782;Taip;3;0;5;8
21668;Vilija;ZUIKUČIAI;6469187290;Ne;0;3;3;6
21669;Vilija;ZUIKUČIAI;5492194393;Taip;3;5;0;8
21670;Vilija;ZUIKUČIAI;4818901769;Taip;1;6;0;7
21671;Vilija;ZUIKUČIAI;6759928420;Taip;0;3;6;9
21672;Vilija;ZUIKUČIAI;4839841253;Taip;5;3;1;9
21673;Vilija;ZUIKUČIAI;8590755333;Taip;0;0;18;18
21674;Vilija;BITUTĖS;4973314993;Taip;0;3;3;6
21675;Vilija;BITUTĖS;4897301808;Taip;0;3;0;3
21676;Vilija;BITUTĖS;9419794080;Taip;1;3;3;7
21677;Vilija;BITUTĖS;1019420340;Taip;5;0;0;5
21678;Vilija;BITUTĖS;5132828941;Taip;13;3;0;16
21679;Vilija;BITUTĖS;9218278301;Taip;0;3;0;3
21680;Vilija;BITUTĖS;7570776491;Taip;4;1;0;5
21681;Vilija;BITUTĖS;9174484523;Taip;0;3;4;7
21682;Vilija;BITUTĖS;5102754179;Taip;0;0;5;5
21683;Vilija;BITUTĖS;4743123463;Taip;0;4;0;4
21684;Vilija;BITUTĖS;3371817727;Taip;0;1;0;1
21685;Vilija;BITUTĖS;8220360728;Taip;0;3;0;3
21686;Vilija;BITUTĖS;3432349973;Taip;0;3;0;3
21687;Vilija;BITUTĖS;8499318976;Taip;0;5;0;5
21688;Vilija;BITUTĖS;8426011190;Taip;0;3;3;6
21689;Vilija;BITUTĖS;8173954240;Taip;0;0;2;2
21690;Vilija;BITUTĖS;9177756107;Ne;0;0;4;4
21691;Vilija;BITUTĖS;1804898751;Taip;5;3;0;8
21692;Vilija;BITUTĖS;9979578408;Taip;9;0;0;9
21693;Vilija;BITUTĖS;5651708105;Taip;9;3;0;12
21694;Vilija;BITUTĖS;9250902486;Taip;3;3;0;6
21695;Vilija;BITUTĖS;6655890861;Taip;0;5;0;5
21696;Vilija;BITUTĖS;4137025486;Taip;0;3;0;3
21697;Vilija;BITUTĖS;7004389875;Taip;5;8;0;13
21698;Vilija;"Pingviniukai (Laisvės pr. 57)";2731415182;Taip;5;0;3;8
21699;Vilija;"Pingviniukai (Laisvės pr. 57)";7015909066;Taip;0;3;0;3
21700;Vilija;"Pingviniukai (Laisvės pr. 57)";4639407305;Taip;15;0;0;15
21701;Vilija;"Pingviniukai (Laisvės pr. 57)";2859663283;Taip;7;0;1;8
21702;Vilija;"Pingviniukai (Laisvės pr. 57)";2903151334;Taip;0;4;2;6
21703;Vilija;"Pingviniukai (Laisvės pr. 57)";7815069972;Taip;0;3;1;4
21704;Vilija;"Pingviniukai (Laisvės pr. 57)";6625339545;Taip;10;0;0;10
21705;Vilija;"Pingviniukai (Laisvės pr. 57)";1840182282;Taip;5;1;0;6
21706;Vilija;"Pingviniukai (Laisvės pr. 57)";4179106082;Taip;0;0;17;17
21707;Vilija;"Pingviniukai (Laisvės pr. 57)";2442272908;Taip;11;0;1;12
21708;Vilija;"Pingviniukai (Laisvės pr. 57)";1845561597;Taip;0;3;4;7
21709;Vilija;"Pingviniukai (Laisvės pr. 57)";1354769998;Taip;2;3;0;5
21710;Vilija;"Pingviniukai (Laisvės pr. 57)";2872066559;Taip;3;0;0;3
21711;Vilija;"Pingviniukai (Laisvės pr. 57)";7219010961;Taip;3;3;0;6
21712;Vilija;"Pingviniukai (Laisvės pr. 57)";5840005178;Taip;10;0;1;11
21713;Vilija;"Pingviniukai (Laisvės pr. 57)";2012412360;Taip;9;0;1;10
21714;Vilija;"Pingviniukai (Laisvės pr. 57)";6855296751;Taip;3;0;1;4
21715;Vilija;"Pingviniukai (Laisvės pr. 57)";2506766222;Taip;5;3;0;8
21716;Vilija;"Pingviniukai (Laisvės pr. 57)";2076388581;Taip;7;3;0;10
21717;Vilija;"Meškiukai (Laisvės pr. 57)";1337656706;Ne;14;0;0;14
21718;Vilija;"Meškiukai (Laisvės pr. 57)";7518841522;Ne;14;0;0;14
21719;Vilija;"Meškiukai (Laisvės pr. 57)";3225442553;Taip;0;3;4;7
21720;Vilija;"Meškiukai (Laisvės pr. 57)";3700333490;Taip;16;0;2;18
21721;Vilija;"Meškiukai (Laisvės pr. 57)";2725051611;Taip;6;6;0;12
21722;Vilija;"Meškiukai (Laisvės pr. 57)";7889810385;Taip;4;0;0;4
21723;Vilija;"Meškiukai (Laisvės pr. 57)";1233653513;Taip;0;2;1;3
21724;Vilija;"Meškiukai (Laisvės pr. 57)";2294228885;Taip;13;0;0;13
21725;Vilija;"Meškiukai (Laisvės pr. 57)";7735728034;Taip;6;0;0;6
21726;Vilija;"Meškiukai (Laisvės pr. 57)";7947071463;Taip;15;0;0;15
21727;Vilija;"Meškiukai (Laisvės pr. 57)";4921409780;Taip;10;1;0;11
21728;Vilija;"Meškiukai (Laisvės pr. 57)";6557918266;Taip;3;0;1;4
21729;Vilija;"Meškiukai (Laisvės pr. 57)";5698897949;Taip;8;0;0;8
21730;Vilija;"Meškiukai (Laisvės pr. 57)";8165784270;Taip;3;0;4;7
21731;Vilija;"Meškiukai (Laisvės pr. 57)";9163803569;Taip;16;0;0;16
21732;Vilija;"Meškiukai (Laisvės pr. 57)";2501118611;Ne;0;3;6;9
21733;Vilija;"Meškiukai (Laisvės pr. 57)";7001209450;Ne;0;8;2;10
21734;Vilija;"Meškiukai (Laisvės pr. 57)";5166455649;Taip;0;3;0;3
21735;Vilija;"Ramunėlės (Laisvės pr. 57)";7707208780;Taip;3;6;0;9
21736;Vilija;"Ramunėlės (Laisvės pr. 57)";7226615203;Taip;7;0;4;11
21737;Vilija;"Ramunėlės (Laisvės pr. 57)";9261213181;Taip;0;3;0;3
21738;Vilija;"Ramunėlės (Laisvės pr. 57)";5034597412;Taip;0;7;0;7
21739;Vilija;"Ramunėlės (Laisvės pr. 57)";6439233139;Taip;3;0;0;3
21740;Vilija;"Ramunėlės (Laisvės pr. 57)";5999958057;Taip;5;6;0;11
21741;Vilija;"Ramunėlės (Laisvės pr. 57)";6142340523;Taip;12;0;0;12
21742;Vilija;"Ramunėlės (Laisvės pr. 57)";4798370162;Taip;17;1;0;18
21743;Vilija;"Ramunėlės (Laisvės pr. 57)";2036033312;Taip;0;0;3;3
21744;Vilija;"Ramunėlės (Laisvės pr. 57)";1902217772;Taip;0;0;1;1
21745;Vilija;"Ramunėlės (Laisvės pr. 57)";9377088075;Taip;5;0;4;9
21746;Vilija;"Ramunėlės (Laisvės pr. 57)";6177733291;Taip;3;0;0;3
21747;Vilija;"Ramunėlės (Laisvės pr. 57)";2455384784;Taip;7;2;0;9
21748;Vilija;"Ramunėlės (Laisvės pr. 57)";1760083113;Taip;12;0;0;12
21749;Vilija;"Ramunėlės (Laisvės pr. 57)";9278725667;Taip;6;0;1;7
21750;Vilija;"Ramunėlės (Laisvės pr. 57)";7288035130;Taip;6;0;4;10
21751;Vilija;"Varpeliai (Laisvės pr. 57)";6742119549;Taip;0;8;2;10
21752;Vilija;"Varpeliai (Laisvės pr. 57)";9641020899;Taip;5;3;0;8
21753;Vilija;"Varpeliai (Laisvės pr. 57)";2948716989;Taip;1;5;0;6
21754;Vilija;"Varpeliai (Laisvės pr. 57)";6525761466;Taip;0;4;0;4
21755;Vilija;"Varpeliai (Laisvės pr. 57)";5277217733;Taip;4;5;0;9
21756;Vilija;"Varpeliai (Laisvės pr. 57)";3346154143;Taip;5;6;0;11
21757;Vilija;"Varpeliai (Laisvės pr. 57)";1502013942;Taip;18;0;0;18
21758;Vilija;"Varpeliai (Laisvės pr. 57)";2190583964;Taip;11;0;0;11
21759;Vilija;"Varpeliai (Laisvės pr. 57)";3920229653;Taip;0;5;1;6
21760;Vilija;"Varpeliai (Laisvės pr. 57)";4969561425;Taip;15;0;0;15
21761;Vilija;"Varpeliai (Laisvės pr. 57)";8092890260;Taip;0;3;0;3
21762;Vilija;"Varpeliai (Laisvės pr. 57)";3998988004;Taip;0;3;2;5
21763;Vilija;"Varpeliai (Laisvės pr. 57)";6756184787;Taip;5;3;1;9
21764;Vilija;"Varpeliai (Laisvės pr. 57)";5768470608;Taip;7;0;1;8
21765;Vilija;"Varpeliai (Laisvės pr. 57)";3589001032;Taip;0;5;4;9
21766;Vilija;"Varpeliai (Laisvės pr. 57)";4692443164;Taip;8;4;0;12
21767;Vilija;"Varpeliai (Laisvės pr. 57)";7426713153;Ne;0;3;4;7
21768;Vilija;"Varpeliai (Laisvės pr. 57)";5734602455;Taip;9;0;1;10
21769;Vilija;"Varpeliai (Laisvės pr. 57)";1440531672;Ne;0;5;0;5
21770;Vilija;"Varpeliai (Laisvės pr. 57)";4562536818;Taip;0;0;6;6
21771;Vilija;"Varpeliai (Laisvės pr. 57)";6226967695;Ne;0;3;0;3
21772;Vilija;"Varpeliai (Laisvės pr. 57)";3062594197;Taip;0;0;4;4
21773;Vilija;"Varpeliai (Laisvės pr. 57)";9226214856;Taip;2;0;3;5
21774;Vilija;"Voveraitės (Laisvės pr. 57)";9640071277;Taip;0;4;0;4
21775;Vilija;"Voveraitės (Laisvės pr. 57)";7522129675;Taip;6;8;0;14
21776;Vilija;"Voveraitės (Laisvės pr. 57)";1807028630;Taip;3;0;0;3
21777;Vilija;"Voveraitės (Laisvės pr. 57)";8923074604;Taip;12;2;0;14
21778;Vilija;"Voveraitės (Laisvės pr. 57)";3948140208;Taip;0;0;4;4
21779;Vilija;"Voveraitės (Laisvės pr. 57)";9809985578;Taip;7;0;2;9
21780;Vilija;"Voveraitės (Laisvės pr. 57)";3464990457;Taip;0;3;0;3
21781;Vilija;"Voveraitės (Laisvės pr. 57)";5229557734;Taip;10;3;0;13
21782;Vilija;"Voveraitės (Laisvės pr. 57)";8758253294;Taip;5;8;0;13
21783;Vilija;"Voveraitės (Laisvės pr. 57)";5694927471;Taip;0;3;0;3
21784;Vilija;"Voveraitės (Laisvės pr. 57)";6496861835;Taip;0;0;5;5
21785;Vilija;"Voveraitės (Laisvės pr. 57)";6782229835;Taip;0;6;0;6
21786;Vilija;"Voveraitės (Laisvės pr. 57)";2910501252;Taip;0;0;4;4
21787;Vilija;"Voveraitės (Laisvės pr. 57)";3899016982;Taip;5;0;0;5
21788;Vilija;"Voveraitės (Laisvės pr. 57)";4936982698;Taip;0;3;1;4
21789;Vilija;"Voveraitės (Laisvės pr. 57)";4873345183;Taip;4;0;0;4
21790;Vilija;"Voveraitės (Laisvės pr. 57)";9638268554;Taip;0;0;4;4
21791;Vilija;"Voveraitės (Laisvės pr. 57)";3654655172;Taip;0;7;0;7
21792;Vilija;"Voveraitės (Laisvės pr. 57)";7184118489;Taip;11;3;0;14
21793;Vilija;"Voveraitės (Laisvės pr. 57)";3095065890;Taip;11;5;0;16
21794;Vilija;"Voveraitės (Laisvės pr. 57)";5450812526;Taip;10;3;0;13
21795;Vilija;"Voveraitės (Laisvės pr. 57)";7389324585;Taip;2;0;3;5
21796;Vilija;"Pelėdžiukai (Laisvės pr. 57)";3269357241;Taip;11;0;2;13
21797;Vilija;"Pelėdžiukai (Laisvės pr. 57)";2055282010;Taip;0;3;5;8
21798;Vilija;"Pelėdžiukai (Laisvės pr. 57)";7358925256;Taip;7;0;0;7
21799;Vilija;"Pelėdžiukai (Laisvės pr. 57)";2778931038;Taip;6;0;6;12
21800;Vilija;"Pelėdžiukai (Laisvės pr. 57)";8465864375;Taip;3;0;0;3
21801;Vilija;"Pelėdžiukai (Laisvės pr. 57)";7784329873;Taip;10;3;1;14
21802;Vilija;"Pelėdžiukai (Laisvės pr. 57)";4437786689;Taip;7;0;5;12
21803;Vilija;"Pelėdžiukai (Laisvės pr. 57)";5043122065;Taip;0;0;5;5
21804;Vilija;"Pelėdžiukai (Laisvės pr. 57)";3581180895;Taip;0;3;0;3
21805;Vilija;"Pelėdžiukai (Laisvės pr. 57)";1306244736;Taip;13;0;0;13
21806;Vilija;"Pelėdžiukai (Laisvės pr. 57)";8608907350;Taip;10;0;1;11
21807;Vilija;"Pelėdžiukai (Laisvės pr. 57)";9117896572;Taip;0;7;0;7
21808;Vilija;"Pelėdžiukai (Laisvės pr. 57)";5821077318;Taip;0;9;0;9
21809;Vilija;"Pelėdžiukai (Laisvės pr. 57)";9471287834;Taip;0;0;6;6
21810;Vilija;"Pelėdžiukai (Laisvės pr. 57)";8186421282;Taip;6;0;4;10
21811;Vilija;"Pelėdžiukai (Laisvės pr. 57)";8815055819;Taip;0;6;0;6
21812;Vilija;"Pelėdžiukai (Laisvės pr. 57)";9750688419;Taip;0;11;0;11
21813;Vilija;"Pelėdžiukai (Laisvės pr. 57)";1778722493;Taip;7;0;1;8
21814;Vilija;"Pelėdžiukai (Laisvės pr. 57)";9915113607;Taip;10;0;0;10
21815;Vilija;"Pelėdžiukai (Laisvės pr. 57)";6581404954;Taip;0;3;1;4
21816;Vilija;"Pelėdžiukai (Laisvės pr. 57)";7869675895;Taip;10;1;0;11
21817;Vilija;"Pelėdžiukai (Laisvės pr. 57)";7697727530;Taip;0;0;5;5
21818;Vilija;"2 A klasė";38068336379;Taip;8;0;0;8
21819;Vilija;"2 A klasė";38068336379;Taip;8;0;0;8
21820;Vilija;"3 B klasė";1497044775;Taip;0;0;3;3
21821;Vilija;"3 B klasė";1497044775;Taip;0;0;3;3
21822;Vilija;"4 B klasė";30837537401;Taip;0;0;3;3
21823;Švelnukas;Pelėdžiukai;8016531082;Taip;13;4;1;18
21824;Švelnukas;Pelėdžiukai;8219071968;Taip;5;3;3;11
21825;Švelnukas;Pelėdžiukai;3235768013;Taip;0;3;1;4
21826;Švelnukas;Pelėdžiukai;9008722163;Taip;10;3;0;13
21827;Švelnukas;Pelėdžiukai;5699300764;Taip;3;0;0;3
21828;Švelnukas;Pelėdžiukai;1116279011;Ne;0;3;0;3
21829;Švelnukas;Pelėdžiukai;3892058023;Ne;0;5;0;5
21830;Švelnukas;Pelėdžiukai;5681611554;Taip;0;0;2;2
21831;Švelnukas;Pelėdžiukai;8589226595;Taip;1;0;6;7
21832;Švelnukas;Pelėdžiukai;9802064955;Taip;0;5;0;5
21833;Švelnukas;Pelėdžiukai;5041138716;Taip;0;0;3;3
21834;Švelnukas;Pelėdžiukai;3804532959;Taip;0;7;0;7
21835;Švelnukas;Pelėdžiukai;1462620951;Taip;0;1;0;1
21836;Švelnukas;Pelėdžiukai;8650902343;Taip;0;2;2;4
21837;Švelnukas;Pelėdžiukai;1409803554;Taip;0;1;0;1
21838;Švelnukas;Pelėdžiukai;1991507109;Ne;9;3;0;12
21839;Švelnukas;Pelėdžiukai;9808833734;Taip;5;0;7;12
21840;Švelnukas;Pelėdžiukai;6318581157;Taip;0;0;4;4
21841;Švelnukas;Pelėdžiukai;6069027553;Taip;8;3;1;12
21842;Švelnukas;Pelėdžiukai;9814032171;Taip;0;3;0;3
21843;Švelnukas;Ežiukai;64192510147;Taip;0;3;0;3
21844;Švelnukas;Ežiukai;25374873288;Taip;0;3;1;4
21845;Švelnukas;Ežiukai;6282389058;Taip;0;3;0;3
21846;Švelnukas;Ežiukai;23795609183;Taip;0;3;0;3
21847;Švelnukas;Ežiukai;8399963483;Taip;0;3;0;3
21848;Švelnukas;Ežiukai;4711482287;Taip;0;2;0;2
21849;Švelnukas;Ežiukai;8681264696;Taip;4;5;0;9
21850;Švelnukas;Ežiukai;4373567509;Taip;0;3;1;4
21851;Švelnukas;Ežiukai;2521009631;Taip;0;3;0;3
21852;Švelnukas;Ežiukai;2892176166;Taip;0;2;0;2
21853;Švelnukas;Ežiukai;7308701231;Taip;6;0;0;6
21854;Švelnukas;Ežiukai;2400781175;Taip;0;4;2;6
21855;Švelnukas;Ežiukai;6209334207;Taip;5;0;4;9
21856;Švelnukas;Ežiukai;1201550386;Taip;0;0;4;4
21857;Švelnukas;Ežiukai;7266255326;Taip;0;3;2;5
21858;Švelnukas;Ežiukai;2348752207;Taip;0;18;0;18
21859;Švelnukas;Ežiukai;1143579276;Taip;0;0;2;2
21860;Švelnukas;Ežiukai;5409130195;Taip;9;0;0;9
21861;Švelnukas;Ežiukai;3645855145;Taip;0;3;1;4
21862;Švelnukas;Ežiukai;9402567487;Taip;10;0;1;11
21863;Švelnukas;Ežiukai;8569985034;Taip;0;3;2;5
21864;Švelnukas;Švelnukai;4681584014;Taip;5;0;6;11
21865;Švelnukas;Švelnukai;6607578153;Taip;5;0;0;5
21866;Švelnukas;Švelnukai;8847738918;Taip;0;1;0;1
21867;Švelnukas;Švelnukai;1982267458;Taip;0;1;1;2
21868;Švelnukas;Švelnukai;9766734938;Taip;0;3;3;6
21869;Švelnukas;Švelnukai;3020524039;Taip;0;3;10;13
21870;Švelnukas;Švelnukai;9829912750;Taip;0;0;3;3
21871;Švelnukas;Švelnukai;1411710913;Taip;0;3;0;3
21872;Švelnukas;Švelnukai;2464467471;Taip;0;3;0;3
21873;Švelnukas;Švelnukai;5032829856;Taip;0;3;1;4
21874;Švelnukas;Švelnukai;5213589179;Taip;9;5;0;14
21875;Švelnukas;Švelnukai;4544791546;Taip;0;3;1;4
21876;Švelnukas;Švelnukai;1963518457;Taip;0;3;1;4
21877;Švelnukas;Švelnukai;4194249709;Taip;0;3;1;4
21878;Švelnukas;Švelnukai;5936821902;Taip;0;0;3;3
21879;Švelnukas;Švelnukai;3228293160;Taip;0;0;5;5
21880;Švelnukas;Švelnukai;7607215137;Taip;0;3;0;3
21881;Švelnukas;Švelnukai;4629757899;Taip;5;7;0;12
21882;Švelnukas;Švelnukai;6964997767;Taip;0;3;3;6
21883;Švelnukas;Švelnukai;8951810066;Taip;0;0;5;5
21884;Švelnukas;Švelnukai;2663990082;Taip;0;3;0;3
21885;Švelnukas;Švelnukai;6204286255;Taip;0;0;5;5
21886;Švelnukas;Švelnukai;5960966542;Taip;0;3;1;4
21887;Švelnukas;Boružiukai;1951447127;Taip;0;0;5;5
21888;Švelnukas;Boružiukai;3849957906;Taip;0;0;6;6
21889;Švelnukas;Boružiukai;5550841477;Taip;0;3;1;4
21890;Švelnukas;Boružiukai;9722532034;Taip;0;3;0;3
21891;Švelnukas;Boružiukai;1264256177;Taip;0;3;1;4
21892;Švelnukas;Boružiukai;1332533332;Taip;5;0;5;10
21893;Švelnukas;Boružiukai;8787505507;Taip;0;3;0;3
21894;Švelnukas;Boružiukai;4134678301;Taip;0;0;1;1
21895;Švelnukas;Boružiukai;8458233793;Taip;0;3;2;5
21896;Švelnukas;Boružiukai;7967996032;Taip;0;0;4;4
21897;Švelnukas;Boružiukai;4990399144;Taip;0;6;0;6
21898;Švelnukas;Boružiukai;9575767514;Taip;0;0;9;9
21899;Švelnukas;Boružiukai;6282137936;Taip;0;8;0;8
21900;Švelnukas;Boružiukai;9479536507;Taip;0;0;1;1
21901;Švelnukas;Boružiukai;2088128734;Taip;0;0;2;2
21902;Švelnukas;Boružiukai;2077614498;Taip;3;2;0;5
21903;Švelnukas;Boružiukai;3145935641;Taip;0;7;0;7
21904;Švelnukas;Boružiukai;4404904322;Taip;0;0;6;6
21905;Švelnukas;Boružiukai;3561920685;Taip;0;3;0;3
21906;Švelnukas;Boružiukai;8895028305;Taip;0;3;0;3
21907;Švelnukas;Boružiukai;4961854528;Taip;5;3;0;8
21908;Švelnukas;Boružiukai;4823928859;Taip;0;3;0;3
21909;Švelnukas;Smalsučiai;9558811523;Taip;0;0;9;9
21910;Švelnukas;Smalsučiai;5085517759;Taip;0;3;0;3
21911;Švelnukas;Smalsučiai;1661019352;Taip;0;7;0;7
21912;Švelnukas;Smalsučiai;5554625346;Taip;0;0;3;3
21913;Švelnukas;Smalsučiai;3282020958;Taip;0;0;3;3
21914;Švelnukas;Smalsučiai;2730288544;Taip;2;0;1;3
21915;Švelnukas;Smalsučiai;5805289419;Taip;0;0;4;4
21916;Švelnukas;Smalsučiai;1415899173;Taip;0;3;1;4
21917;Švelnukas;Smalsučiai;7987715134;Taip;7;4;0;11
21918;Švelnukas;Smalsučiai;3455801077;Taip;0;18;0;18
21919;Švelnukas;Smalsučiai;8193690277;Taip;3;3;1;7
21920;Švelnukas;Smalsučiai;9371102717;Taip;0;18;0;18
21921;Švelnukas;Smalsučiai;3472774028;Taip;12;1;0;13
21922;Švelnukas;Smalsučiai;5845744917;Taip;0;3;3;6
21923;Švelnukas;Smalsučiai;6764222588;Taip;0;3;12;15
21924;Švelnukas;Smalsučiai;1840752560;Taip;0;10;0;10
21925;Švelnukas;Smalsučiai;8268391509;Taip;0;0;3;3
21926;Švelnukas;Smalsučiai;4467095100;Taip;0;0;5;5
21927;Švelnukas;Nykštukai;5518267134;Taip;0;3;0;3
21928;Švelnukas;Nykštukai;1293700097;Taip;0;3;3;6
21929;Švelnukas;Nykštukai;8221642452;Taip;0;3;0;3
21930;Švelnukas;Nykštukai;2141519946;Taip;0;7;0;7
21931;Švelnukas;Nykštukai;8771953161;Taip;6;3;1;10
21932;Švelnukas;Nykštukai;5327209876;Taip;8;3;0;11
21933;Švelnukas;Nykštukai;2282356211;Taip;0;3;0;3
21934;Švelnukas;Nykštukai;4697253853;Taip;0;3;0;3
21935;Švelnukas;Nykštukai;7387060610;Taip;0;3;0;3
21936;Švelnukas;Nykštukai;1762528313;Taip;0;3;0;3
21937;Švelnukas;Nykštukai;7380948648;Taip;0;3;0;3
21938;Švelnukas;Nykštukai;3473146893;Taip;0;3;0;3
21939;Švelnukas;Nykštukai;3370028567;Taip;0;10;0;10
21940;Švelnukas;Nykštukai;62969317035;Taip;0;3;0;3
21941;Švelnukas;Nykštukai;6633233824;Taip;5;3;1;9
21942;Švelnukas;Nykštukai;2106591525;Taip;3;1;1;5
21943;Švelnukas;Nykštukai;93497358197;Taip;0;5;0;5
21944;Švelnukas;Nykštukai;2971380970;Taip;3;3;0;6
21945;Švelnukas;Nykštukai;3389897065;Taip;2;3;0;5
21946;Švelnukas;Nykštukai;4302735157;Taip;0;3;1;4
21947;Švelnukas;Nykštukai;2785396019;Taip;5;3;3;11
21948;Švelnukas;Nykštukai;6195335543;Taip;0;3;1;4
21949;Boružėlė;"Nykštukai gudručiai";3340082011;Taip;3;2;0;5
21950;Boružėlė;"Nykštukai gudručiai";7736917485;Taip;5;5;1;11
21951;Boružėlė;"Nykštukai gudručiai";9520696660;Taip;0;3;0;3
21952;Boružėlė;"Nykštukai gudručiai";5691884576;Taip;0;1;0;1
21953;Boružėlė;"Nykštukai gudručiai";9193273478;Taip;10;0;2;12
21954;Boružėlė;"Nykštukai gudručiai";3237771499;Taip;15;3;0;18
21955;Boružėlė;"Nykštukai gudručiai";8359957290;Ne;0;5;10;15
21956;Boružėlė;"Nykštukai gudručiai";8141240094;Taip;0;2;5;7
21957;Boružėlė;"Nykštukai gudručiai";2349571778;Taip;0;2;0;2
21958;Boružėlė;"Nykštukai gudručiai";1894170218;Taip;2;1;3;6
21959;Boružėlė;"Nykštukai gudručiai";3509512899;Taip;7;2;2;11
21960;Boružėlė;"Nykštukai gudručiai";8888151470;Taip;7;2;2;11
21961;Boružėlė;"Nykštukai gudručiai";3430953692;Taip;2;5;0;7
21962;Boružėlė;"Nykštukai gudručiai";8365962523;Taip;0;5;2;7
21963;Boružėlė;"Nykštukai gudručiai";3592853535;Taip;0;3;0;3
21964;Boružėlė;"Nykštukai gudručiai";6876323023;Taip;0;4;0;4
21965;Boružėlė;"Nykštukai gudručiai";2744894565;Taip;0;5;0;5
21966;Boružėlė;"Nykštukai gudručiai";6590829182;Ne;0;3;5;8
21967;Boružėlė;"Nykštukai gudručiai";3129825206;Ne;0;4;0;4
21968;Boružėlė;"Nykštukai gudručiai";9771767352;Taip;6;5;0;11
21969;Boružėlė;"Nykštukai gudručiai";8789209196;Taip;15;3;0;18
21970;Boružėlė;"Nykštukai gudručiai";2571360077;Taip;0;5;0;5
21971;Boružėlė;"Nykštukai gudručiai";9078805020;Taip;0;4;1;5
21972;Boružėlė;"Saulės zuikučiai";4554260776;Taip;5;3;0;8
21973;Boružėlė;"Saulės zuikučiai";5298170118;Taip;0;4;0;4
21974;Boružėlė;"Saulės zuikučiai";2133849514;Taip;3;4;0;7
21975;Boružėlė;"Saulės zuikučiai";1116012068;Taip;5;2;1;8
21976;Boružėlė;"Saulės zuikučiai";1292298259;Taip;0;3;0;3
21977;Boružėlė;"Saulės zuikučiai";3130977416;Taip;0;2;0;2
21978;Boružėlė;"Saulės zuikučiai";7256396576;Taip;0;2;1;3
21979;Boružėlė;"Saulės zuikučiai";4323998138;Taip;0;0;4;4
21980;Boružėlė;"Saulės zuikučiai";2087238951;Taip;0;4;0;4
21981;Boružėlė;"Saulės zuikučiai";4509233532;Taip;0;1;0;1
21982;Boružėlė;"Saulės zuikučiai";3952645542;Taip;0;3;0;3
21983;Boružėlė;"Saulės zuikučiai";5516103398;Taip;0;0;3;3
21984;Boružėlė;"Saulės zuikučiai";8259586236;Taip;0;4;0;4
21985;Boružėlė;"Saulės zuikučiai";3955841578;Taip;0;3;0;3
21986;Boružėlė;"Saulės zuikučiai";1583223569;Taip;0;3;0;3
21987;Boružėlė;"Saulės zuikučiai";4433248526;Taip;0;0;3;3
21988;Boružėlė;"Saulės zuikučiai";1547802140;Taip;0;0;3;3
21989;Boružėlė;"Saulės zuikučiai";4020348640;Taip;3;0;4;7
21990;Boružėlė;"Saulės zuikučiai";2842256033;Taip;0;2;1;3
21991;Boružėlė;"Saulės zuikučiai";2561969142;Taip;0;0;11;11
21992;Boružėlė;"Saulės zuikučiai";7262515868;Taip;6;4;0;10
21993;Boružėlė;"Saulės zuikučiai";6527254253;Taip;0;5;0;5
21994;Boružėlė;"Saulės zuikučiai";7942043844;Taip;0;5;0;5
21995;Boružėlė;Gėlytės;1146297996;Taip;0;3;0;3
21996;Boružėlė;Gėlytės;3288141024;Taip;0;5;0;5
21997;Boružėlė;Gėlytės;1166207929;Taip;0;4;0;4
21998;Boružėlė;Gėlytės;7956982615;Taip;9;3;0;12
21999;Boružėlė;Gėlytės;4637656311;Taip;5;3;0;8
22000;Boružėlė;Gėlytės;3226733236;Taip;0;3;0;3
22001;Boružėlė;Gėlytės;6070356395;Taip;0;6;0;6
22002;Boružėlė;Gėlytės;4180537253;Taip;0;3;0;3
22003;Boružėlė;Gėlytės;6722353853;Taip;18;0;0;18
22004;Boružėlė;Gėlytės;8376436755;Taip;29;0;0;29
22005;Boružėlė;Gėlytės;3300678477;Taip;1;3;0;4
22006;Boružėlė;Gėlytės;7763958937;Taip;0;3;3;6
22007;Boružėlė;Gėlytės;9855354210;Taip;0;1;0;1
22008;Boružėlė;Gėlytės;2515608520;Taip;18;0;0;18
22009;Boružėlė;Gėlytės;8520403894;Taip;5;4;0;9
22010;Boružėlė;Gėlytės;4268486154;Ne;4;2;0;6
22011;Boružėlė;Gėlytės;7614216150;Taip;0;3;1;4
22012;Boružėlė;Gėlytės;4448964310;Taip;0;1;8;9
22013;Boružėlė;Gėlytės;8205706322;Taip;18;0;0;18
22014;Boružėlė;Gėlytės;8834231529;Taip;0;13;0;13
22015;Boružėlė;Gėlytės;8929444125;Taip;2;3;0;5
22016;Boružėlė;Smalsutis;2086485441;Taip;0;3;0;3
22017;Boružėlė;Smalsutis;5129244830;Taip;0;2;0;2
22018;Boružėlė;Smalsutis;6927100979;Taip;0;3;0;3
22019;Boružėlė;Smalsutis;4947670606;Taip;0;3;9;12
22020;Boružėlė;Smalsutis;2917508421;Taip;0;3;1;4
22021;Boružėlė;Smalsutis;7263730692;Taip;0;3;0;3
22022;Boružėlė;Smalsutis;5708558321;Taip;0;5;0;5
22023;Boružėlė;Smalsutis;6484173786;Taip;0;3;0;3
22024;Boružėlė;Smalsutis;6742157071;Taip;0;3;1;4
22025;Boružėlė;Smalsutis;77513300382;Taip;0;3;0;3
22026;Boružėlė;Smalsutis;39553430808;Taip;0;2;3;5
22027;Boružėlė;Smalsutis;4958704459;Taip;0;9;0;9
22028;Boružėlė;Smalsutis;5618586722;Taip;0;3;0;3
22029;Boružėlė;Smalsutis;8493908653;Taip;0;3;0;3
22030;Boružėlė;Smalsutis;4283064680;Taip;0;3;9;12
22031;Boružėlė;Smalsutis;2447148171;Taip;0;4;0;4
22032;Boružėlė;Smalsutis;1391562352;Taip;0;0;2;2
22033;Boružėlė;Smalsutis;7386694567;Taip;0;2;2;4
22034;Boružėlė;Smalsutis;9634967237;Taip;0;3;0;3
22035;Boružėlė;Smalsutis;3592594142;Taip;0;3;0;3
22036;Boružėlė;Drugeliai;8357946299;Taip;0;3;0;3
22037;Boružėlė;Drugeliai;1130980139;Taip;0;3;0;3
22038;Boružėlė;Drugeliai;6463583187;Taip;0;5;3;8
22039;Boružėlė;Drugeliai;3136028536;Taip;6;0;0;6
22040;Boružėlė;Drugeliai;2211576663;Taip;0;6;0;6
22041;Boružėlė;Drugeliai;1559001916;Taip;8;5;0;13
22042;Boružėlė;Drugeliai;4233602822;Taip;0;3;0;3
22043;Boružėlė;Drugeliai;9463322491;Taip;0;4;0;4
22044;Boružėlė;Drugeliai;3108758436;Taip;0;0;4;4
22045;Boružėlė;Drugeliai;8482813204;Taip;0;3;0;3
22046;Boružėlė;Drugeliai;6369070055;Taip;0;3;0;3
22047;Boružėlė;Drugeliai;6902130914;Taip;0;4;2;6
22048;Boružėlė;Drugeliai;3459207879;Taip;3;0;0;3
22049;Boružėlė;Drugeliai;6980022864;Taip;0;4;0;4
22050;Boružėlė;Drugeliai;7756929745;Taip;0;3;0;3
22051;Boružėlė;Drugeliai;5726187445;Taip;0;3;0;3
22052;Boružėlė;Drugeliai;2308405580;Taip;0;2;10;12
22053;Boružėlė;Drugeliai;6049501362;Taip;0;2;0;2
22054;Boružėlė;Drugeliai;3405184929;Taip;0;0;4;4
22055;Boružėlė;Drugeliai;8213060214;Taip;0;3;0;3
22056;Boružėlė;Drugeliai;3331238309;Taip;0;3;2;5
22057;Boružėlė;Drugeliai;2783338563;Taip;0;4;0;4
22058;Boružėlė;Vyturėliai;1913540317;Taip;0;5;0;5
22059;Boružėlė;Vyturėliai;1950269258;Taip;10;3;0;13
22060;Boružėlė;Vyturėliai;1591582954;Taip;1;6;0;7
22061;Boružėlė;Vyturėliai;9180459278;Taip;0;3;3;6
22062;Boružėlė;Vyturėliai;3322567969;Taip;0;3;5;8
22063;Boružėlė;Vyturėliai;8311383437;Taip;0;5;5;10
22064;Boružėlė;Vyturėliai;7534482245;Taip;15;3;0;18
22065;Boružėlė;Vyturėliai;3310676316;Taip;0;3;0;3
22066;Boružėlė;Vyturėliai;87834777247;Taip;0;3;0;3
22067;Boružėlė;Vyturėliai;50071056728;Taip;0;11;0;11
22068;Boružėlė;Vyturėliai;43300167107;Taip;0;1;0;1
22069;Boružėlė;Vyturėliai;2098408445;Taip;0;5;0;5
22070;Boružėlė;Vyturėliai;8706461730;Ne;0;3;0;3
22071;Boružėlė;Vyturėliai;5337704114;Taip;0;4;0;4
22072;Boružėlė;Vyturėliai;8146684259;Taip;0;3;0;3
22073;Boružėlė;Vyturėliai;8225622711;Taip;0;3;0;3
22074;Boružėlė;Vyturėliai;67504667512;Taip;0;5;0;5
22075;Boružėlė;Vyturėliai;9150703371;Taip;6;5;0;11
22076;Boružėlė;Vyturėliai;5811751925;Taip;0;5;0;5
22077;Boružėlė;Vyturėliai;7136428795;Taip;5;3;0;8
22078;Boružėlė;Vyturėliai;6978158667;Taip;0;5;0;5
22079;Boružėlė;Vyturėliai;9640681773;Taip;0;3;12;15
22080;Boružėlė;Vyturėliai;5576016171;Taip;0;5;1;6
22081;Boružėlė;Žvaigždutės;4990831292;Taip;2;5;0;7
22082;Boružėlė;Žvaigždutės;9838823214;Taip;3;3;0;6
22083;Boružėlė;Žvaigždutės;7825636053;Taip;0;3;0;3
22084;Boružėlė;Žvaigždutės;7901880926;Taip;1;3;2;6
22085;Boružėlė;Žvaigždutės;6242220139;Taip;1;3;0;4
22086;Boružėlė;Žvaigždutės;3489498503;Taip;6;7;0;13
22087;Boružėlė;Žvaigždutės;5274016839;Taip;0;3;0;3
22088;Boružėlė;Žvaigždutės;9720535449;Taip;0;3;0;3
22089;Boružėlė;Žvaigždutės;6435556131;Taip;0;3;0;3
22090;Boružėlė;Žvaigždutės;3140264242;Taip;0;3;0;3
22091;Boružėlė;Žvaigždutės;5307997577;Taip;4;3;6;13
22092;Boružėlė;Žvaigždutės;8916241914;Taip;0;3;0;3
22093;Boružėlė;Žvaigždutės;6724101421;Taip;0;5;0;5
22094;Boružėlė;Žvaigždutės;7078709057;Taip;0;3;0;3
22095;Boružėlė;Žvaigždutės;6972646373;Taip;0;4;0;4
22096;Boružėlė;Žvaigždutės;8820827882;Taip;4;5;0;9
22097;Boružėlė;Žvaigždutės;2857645329;Taip;0;3;0;3
22098;Boružėlė;Žvaigždutės;5242187638;Taip;0;4;0;4
22099;Boružėlė;Žvaigždutės;1799882790;Taip;0;6;0;6
22100;Boružėlė;Žvaigždutės;5420788580;Taip;0;3;2;5
22101;Boružėlė;Žvaigždutės;6130634131;Taip;2;3;0;5
22102;Boružėlė;Ąžuoliukai;5774358876;Taip;0;4;0;4
22103;Boružėlė;Ąžuoliukai;4519645340;Taip;0;4;0;4
22104;Boružėlė;Ąžuoliukai;24315678618;Taip;8;2;0;10
22105;Boružėlė;Ąžuoliukai;5138737297;Taip;0;3;0;3
22106;Boružėlė;Ąžuoliukai;6439902117;Taip;3;6;0;9
22107;Boružėlė;Ąžuoliukai;3040376382;Taip;4;3;0;7
22108;Boružėlė;Ąžuoliukai;3912668735;Taip;0;1;0;1
22109;Boružėlė;Ąžuoliukai;3840860155;Taip;3;4;0;7
22110;Boružėlė;Ąžuoliukai;7722277859;Taip;6;1;1;8
22111;Boružėlė;Ąžuoliukai;6954794465;Taip;0;3;2;5
22112;Boružėlė;Ąžuoliukai;5832223872;Taip;0;3;0;3
22113;Boružėlė;Ąžuoliukai;3695411422;Taip;13;3;0;16
22114;Boružėlė;Ąžuoliukai;5148410392;Taip;8;3;0;11
22115;Boružėlė;Ąžuoliukai;76222777017;Taip;0;4;0;4
22116;Boružėlė;Ąžuoliukai;45181369655;Taip;7;3;0;10
22117;Boružėlė;Ąžuoliukai;2077228543;Taip;0;1;12;13
22118;Boružėlė;Ąžuoliukai;6022191251;Taip;0;3;1;4
22119;Boružėlė;Ąžuoliukai;3869817904;Taip;5;3;0;8
22120;Boružėlė;Ąžuoliukai;9269501176;Taip;0;3;0;3
22121;Boružėlė;Ąžuoliukai;8029389952;Taip;7;5;0;12
22122;Boružėlė;Ąžuoliukai;8683282162;Taip;3;0;0;3
22123;Boružėlė;Ąžuoliukai;9999252614;Taip;12;3;0;15
22124;Boružėlė;Saulutės;9492548829;Taip;0;9;0;9
22125;Boružėlė;Saulutės;5437943626;Taip;9;3;0;12
22126;Boružėlė;Saulutės;3503931241;Taip;9;3;0;12
22127;Boružėlė;Saulutės;8882070834;Taip;13;0;0;13
22128;Boružėlė;Saulutės;2999335505;Taip;0;3;5;8
22129;Boružėlė;Saulutės;7882386455;Taip;2;5;0;7
22130;Boružėlė;Saulutės;6265279517;Taip;12;3;0;15
22131;Boružėlė;Saulutės;6275425512;Taip;1;3;0;4
22132;Boružėlė;Saulutės;2879726579;Taip;3;3;0;6
22133;Boružėlė;Saulutės;8804878419;Taip;1;6;0;7
22134;Boružėlė;Saulutės;3871593172;Taip;1;6;0;7
22135;Boružėlė;Saulutės;3953507461;Taip;6;2;0;8
22136;Boružėlė;Saulutės;1492091211;Taip;8;1;0;9
22137;Boružėlė;Saulutės;1830043506;Taip;18;0;0;18
22138;Boružėlė;Saulutės;5680510186;Taip;4;0;0;4
22139;Boružėlė;Saulutės;1152697871;Taip;0;4;0;4
22140;Boružėlė;Saulutės;1779839709;Taip;3;5;0;8
22141;Boružėlė;Saulutės;7652740249;Taip;8;0;0;8
22142;Boružėlė;Saulutės;5508064424;Taip;18;0;0;18
22143;Boružėlė;Saulutės;7260471712;Taip;0;4;0;4
22144;Boružėlė;Saulutės;5064892417;Taip;10;3;0;13
22145;Boružėlė;Saulutės;8577301586;Taip;0;6;0;6
22146;Boružėlė;Saulutės;8660954142;Taip;0;5;0;5
22147;Boružėlė;Ežiukai;9342498392;Taip;8;0;0;8
22148;Boružėlė;Ežiukai;8195442951;Taip;0;5;1;6
22149;Boružėlė;Ežiukai;6448688592;Taip;9;0;0;9
22150;Boružėlė;Ežiukai;2429696310;Taip;5;3;0;8
22151;Boružėlė;Ežiukai;9893643199;Taip;8;4;0;12
22152;Boružėlė;Ežiukai;3112016309;Taip;6;0;0;6
22153;Boružėlė;Ežiukai;5394149649;Taip;6;1;0;7
22154;Boružėlė;Ežiukai;9391811395;Taip;0;7;0;7
22155;Boružėlė;Ežiukai;8167376712;Taip;13;3;0;16
22156;Boružėlė;Ežiukai;1784594085;Taip;4;5;0;9
22157;Boružėlė;Ežiukai;9423458813;Taip;0;2;1;3
22158;Boružėlė;Ežiukai;5825164520;Taip;0;0;12;12
22159;Boružėlė;Ežiukai;7190980006;Taip;5;1;0;6
22160;Boružėlė;Ežiukai;7459531236;Taip;12;0;0;12
22161;Boružėlė;Ežiukai;8818358360;Taip;12;0;0;12
22162;Boružėlė;Ežiukai;1693082285;Taip;0;1;0;1
22163;Boružėlė;Ežiukai;2926620929;Taip;3;3;0;6
22164;Boružėlė;Ežiukai;6609156790;Taip;0;5;0;5
22165;Boružėlė;Ežiukai;5768415821;Taip;6;3;0;9
22166;Boružėlė;Ežiukai;8291389794;Taip;0;3;0;3
22167;Boružėlė;Ežiukai;2524469162;Taip;6;2;0;8
22168;Boružėlė;Ežiukai;5492228053;Taip;7;1;0;8
22169;Boružėlė;Ežiukai;6087811262;Taip;15;3;0;18
22170;Boružėlė;Boružiukai;7068409148;Taip;0;2;1;3
22171;Boružėlė;Boružiukai;8434178580;Taip;10;0;0;10
22172;Boružėlė;Boružiukai;8752343077;Taip;0;5;0;5
22173;Boružėlė;Boružiukai;8944790932;Taip;0;2;0;2
22174;Boružėlė;Boružiukai;7065907155;Taip;0;4;0;4
22175;Boružėlė;Boružiukai;4113917886;Taip;8;0;0;8
22176;Boružėlė;Boružiukai;7149439740;Taip;4;7;0;11
22177;Boružėlė;Boružiukai;3005601935;Taip;0;5;0;5
22178;Boružėlė;Boružiukai;4497753570;Taip;4;0;3;7
22179;Boružėlė;Boružiukai;1865891989;Taip;0;2;2;4
22180;Boružėlė;Boružiukai;2298750617;Taip;8;0;0;8
22181;Boružėlė;Boružiukai;8739264310;Taip;0;6;0;6
22182;Boružėlė;Boružiukai;3097874340;Taip;6;1;0;7
22183;Boružėlė;Boružiukai;1551933321;Taip;6;1;0;7
22184;Boružėlė;Boružiukai;3097217902;Taip;0;4;0;4
22185;Boružėlė;Boružiukai;2084361709;Taip;0;2;2;4
22186;Boružėlė;Boružiukai;4727351240;Taip;1;5;2;8
22187;Boružėlė;Nykštukai;1047419932;Taip;1;3;0;4
22188;Boružėlė;Nykštukai;2104101406;Taip;0;2;0;2
22189;Boružėlė;Nykštukai;8377410278;Taip;2;1;2;5
22190;Boružėlė;Nykštukai;4928818565;Taip;0;3;0;3
22191;Boružėlė;Nykštukai;5619719965;Taip;0;6;0;6
22192;Boružėlė;Nykštukai;1966066642;Taip;0;3;0;3
22193;Boružėlė;Nykštukai;6267999965;Taip;5;7;0;12
22194;Boružėlė;Nykštukai;8073918985;Taip;10;1;0;11
22195;Boružėlė;Nykštukai;3595998843;Taip;5;2;0;7
22196;Boružėlė;Nykštukai;1929202434;Taip;0;3;2;5
22197;Boružėlė;Nykštukai;4217116059;Taip;0;2;1;3
22198;Boružėlė;Nykštukai;8165748779;Taip;5;1;1;7
22199;Žaliakalnio;Drugeliai;6379145626;Ne;0;5;3;8
22200;Žaliakalnio;Drugeliai;7094914749;Taip;0;11;0;11
22201;Žaliakalnio;Drugeliai;7449949339;Ne;0;3;1;4
22202;Žaliakalnio;Drugeliai;2607433844;Taip;0;2;0;2
22203;Žaliakalnio;Drugeliai;1413563085;Ne;0;4;0;4
22204;Žaliakalnio;Drugeliai;2432935088;Ne;0;3;0;3
22205;Žaliakalnio;Drugeliai;4806478786;Taip;0;3;0;3
22206;Žaliakalnio;Drugeliai;1033910097;Taip;0;3;0;3
22207;Žaliakalnio;Drugeliai;9032003195;Ne;10;2;0;12
22208;Žaliakalnio;Drugeliai;7566429633;Taip;0;7;0;7
22209;Žaliakalnio;Drugeliai;3835667120;Taip;0;7;0;7
22210;Žaliakalnio;Drugeliai;6341640909;Taip;0;5;0;5
22211;Žaliakalnio;Drugeliai;2305496316;Ne;0;4;0;4
22212;Žaliakalnio;Drugeliai;9984857605;Taip;2;3;0;5
22213;Žaliakalnio;Drugeliai;5764128482;Taip;0;3;0;3
22214;Žaliakalnio;Drugeliai;4497938258;Taip;0;2;0;2
22215;Žaliakalnio;Drugeliai;1673321992;Taip;0;7;0;7
22216;Žaliakalnio;Boružėlių;5843020412;Taip;0;7;0;7
22217;Žaliakalnio;Boružėlių;9625531462;Taip;0;14;0;14
22218;Žaliakalnio;Boružėlių;6699373334;Taip;0;14;0;14
22219;Žaliakalnio;Boružėlių;7087535800;Taip;9;2;0;11
22220;Žaliakalnio;Boružėlių;1528111839;Taip;0;1;0;1
22221;Žaliakalnio;Boružėlių;7023886811;Taip;0;8;0;8
22222;Žaliakalnio;Boružėlių;2284465378;Taip;14;0;0;14
22223;Žaliakalnio;Boružėlių;7977009681;Taip;5;5;0;10
22224;Žaliakalnio;Boružėlių;2808776865;Taip;8;0;0;8
22225;Žaliakalnio;Boružėlių;2278681435;Taip;0;1;3;4
22226;Žaliakalnio;Boružėlių;9421259943;Taip;7;0;0;7
22227;Žaliakalnio;Boružėlių;3445649442;Taip;0;7;0;7
22228;Žaliakalnio;Boružėlių;3105500733;Taip;5;3;3;11
22229;Žaliakalnio;Boružėlių;1200844791;Taip;0;5;0;5
22230;Žaliakalnio;Boružėlių;8052539476;Taip;15;0;3;18
22231;Žaliakalnio;Boružėlių;6590016097;Ne;3;6;0;9
22232;Žaliakalnio;Boružėlių;8304431519;Taip;13;0;0;13
22233;Žaliakalnio;Boružėlių;5488964606;Taip;0;1;0;1
22234;Žaliakalnio;Boružėlių;8429135626;Taip;5;9;0;14
22235;Žaliakalnio;Boružėlių;8073554707;Taip;14;0;0;14
22236;Žaliakalnio;Boružėlių;8534973941;Taip;18;0;0;18
22237;Žaliakalnio;Boružėlių;2987217910;Taip;5;8;0;13
22238;Žaliakalnio;Boružėlių;5157814568;Taip;0;3;3;6
22239;Žaliakalnio;Zuikučiai;1592051491;Taip;0;4;0;4
22240;Žaliakalnio;Zuikučiai;6088333997;Taip;0;4;0;4
22241;Žaliakalnio;Zuikučiai;2673619031;Taip;0;4;0;4
22242;Žaliakalnio;Zuikučiai;5843314345;Taip;0;4;0;4
22243;Žaliakalnio;Zuikučiai;2180165053;Taip;5;4;0;9
22244;Žaliakalnio;Zuikučiai;6823528666;Taip;0;4;0;4
22245;Žaliakalnio;Zuikučiai;3509064089;Taip;0;4;0;4
22246;Žaliakalnio;Zuikučiai;7000429934;Taip;0;6;0;6
22247;Žaliakalnio;Zuikučiai;5730610895;Taip;0;5;0;5
22248;Žaliakalnio;Zuikučiai;6881070397;Taip;0;6;0;6
22249;Žaliakalnio;Zuikučiai;8209559343;Taip;1;3;0;4
22250;Žaliakalnio;Zuikučiai;9799056285;Taip;0;7;0;7
22251;Žaliakalnio;Zuikučiai;1321592040;Ne;0;7;0;7
22252;Žaliakalnio;Zuikučiai;8298313285;Taip;0;3;0;3
22253;Žaliakalnio;Zuikučiai;9331287916;Taip;3;4;0;7
22254;Žaliakalnio;Zuikučiai;6726832258;Ne;0;2;0;2
22255;Žaliakalnio;Zuikučiai;4607456527;Taip;0;5;0;5
22256;Žaliakalnio;Zuikučiai;9363615751;Taip;0;5;0;5
22257;Žaliakalnio;Zuikučiai;6727442688;Ne;0;3;0;3
22258;Žaliakalnio;Bitutė;5744370516;Taip;0;3;0;3
22259;Žaliakalnio;Bitutė;3619817569;Taip;0;3;0;3
22260;Žaliakalnio;Bitutė;3905448562;Taip;12;1;1;14
22261;Žaliakalnio;Bitutė;8481665290;Taip;0;4;0;4
22262;Žaliakalnio;Bitutė;8950583202;Taip;0;2;5;7
22263;Žaliakalnio;Bitutė;6324315523;Taip;0;4;0;4
22264;Žaliakalnio;Bitutė;6877235095;Taip;8;4;0;12
22265;Žaliakalnio;Bitutė;2280683252;Ne;0;3;0;3
22266;Žaliakalnio;Bitutė;7711347723;Taip;0;3;1;4
22267;Žaliakalnio;Bitutė;4561672875;Taip;0;8;0;8
22268;Žaliakalnio;Bitutė;8185190219;Taip;5;2;0;7
22269;Žaliakalnio;Bitutė;7830692152;Taip;0;6;0;6
22270;Žaliakalnio;Bitutė;1423481154;Taip;4;4;0;8
22271;Žaliakalnio;Bitutė;4928400872;Taip;0;9;0;9
22272;Žaliakalnio;Bitutė;2613771302;Taip;0;3;0;3
22273;Žaliakalnio;Bitutė;3976548663;Taip;8;2;0;10
22274;Žaliakalnio;Bitutė;8599646291;Taip;0;2;1;3
22275;Žaliakalnio;Bitutė;1343293430;Taip;0;4;0;4
22276;Žaliakalnio;Bitutė;3721878250;Ne;10;4;0;14
22277;Žaliakalnio;Bitutė;6291287113;Taip;0;3;3;6
22278;Žaliakalnio;Bitutė;4412760433;Taip;0;3;3;6
22279;Žaliakalnio;Bitutė;7989372873;Ne;0;10;0;10
22280;Žaliakalnio;Bitutė;1173977434;Taip;6;4;0;10
22281;Žaliakalnio;Nykštukų;9069518153;Taip;5;7;0;12
22282;Žaliakalnio;Nykštukų;8142435757;Taip;10;0;0;10
22283;Žaliakalnio;Nykštukų;3446593135;Taip;9;1;3;13
22284;Žaliakalnio;Nykštukų;1064854294;Taip;2;9;0;11
22285;Žaliakalnio;Nykštukų;4891656355;Ne;12;3;0;15
22286;Žaliakalnio;Nykštukų;1632465983;Taip;8;3;0;11
22287;Žaliakalnio;Nykštukų;8472945857;Taip;0;2;0;2
22288;Žaliakalnio;Nykštukų;9521104462;Taip;10;3;0;13
22289;Žaliakalnio;Nykštukų;5565027085;Ne;0;1;0;1
22290;Žaliakalnio;Nykštukų;2242604156;Ne;11;5;0;16
22291;Žaliakalnio;Nykštukų;8852165484;Taip;0;1;6;7
22292;Žaliakalnio;Nykštukų;9801618806;Taip;0;10;0;10
22293;Žaliakalnio;Nykštukų;2225778044;Taip;6;1;5;12
22294;Žaliakalnio;Nykštukų;4255734788;Taip;6;2;2;10
22295;Žaliakalnio;Nykštukų;7793937917;Taip;6;4;0;10
22296;Žaliakalnio;Nykštukų;8117013474;Ne;5;3;0;8
22297;Žaliakalnio;Nykštukų;7205368281;Taip;5;1;0;6
22298;Žaliakalnio;Nykštukų;8360480591;Taip;0;1;13;14
22299;Žaliakalnio;Nykštukų;4036239701;Taip;6;4;0;10
22300;Žaliakalnio;Nykštukų;5258266970;Taip;10;1;1;12
22301;Žaliakalnio;Nykštukų;6166482260;Taip;14;3;0;17
22302;Žaliakalnio;Nykštukų;3041002600;Taip;0;1;0;1
22303;Žaliakalnio;ŽIOGELIAI;2426844621;Ne;0;2;0;2
22304;Žaliakalnio;ŽIOGELIAI;5752912101;Ne;0;2;0;2
22305;Žaliakalnio;ŽIOGELIAI;9967098834;Ne;0;3;0;3
22306;Žaliakalnio;ŽIOGELIAI;1133557422;Taip;0;3;0;3
22307;Žaliakalnio;ŽIOGELIAI;3464935314;Taip;0;6;0;6
22308;Žaliakalnio;ŽIOGELIAI;7648422668;Ne;9;4;0;13
22309;Žaliakalnio;ŽIOGELIAI;4702470511;Taip;0;3;0;3
22310;Žaliakalnio;ŽIOGELIAI;2272043654;Taip;0;4;0;4
22311;Žaliakalnio;ŽIOGELIAI;8518422934;Taip;0;7;0;7
22312;Žaliakalnio;ŽIOGELIAI;6674631040;Taip;3;0;2;5
22313;Žaliakalnio;ŽIOGELIAI;8245784590;Taip;18;0;0;18
22314;Žaliakalnio;ŽIOGELIAI;8179329874;Ne;4;0;0;4
22315;Žaliakalnio;ŽIOGELIAI;8383425712;Ne;0;3;2;5
22316;Žaliakalnio;ŽIOGELIAI;1309236035;Ne;12;0;0;12
22317;Žaliakalnio;ŽIOGELIAI;2514763739;Ne;0;3;0;3
22318;Žaliakalnio;ŽIOGELIAI;8891815592;Ne;6;0;0;6
22319;Žaliakalnio;ŽIOGELIAI;6294045755;Taip;0;3;0;3
22320;Žaliakalnio;ŽIOGELIAI;8232697563;Taip;0;7;0;7
22321;Žaliakalnio;ŽIOGELIAI;2694424532;Taip;11;2;0;13
22322;Žaliakalnio;ŽIOGELIAI;6136717862;Ne;0;3;1;4
22323;Žaliakalnio;ŽIOGELIAI;8316505307;Taip;0;3;1;4
22324;Žaliakalnio;SAULUTĖS;5602734465;Taip;0;13;0;13
22325;Žaliakalnio;SAULUTĖS;2328766492;Taip;0;3;0;3
22326;Žaliakalnio;SAULUTĖS;1253655689;Taip;0;4;0;4
22327;Žaliakalnio;SAULUTĖS;3016537413;Taip;5;2;0;7
22328;Žaliakalnio;SAULUTĖS;6795532166;Taip;11;0;0;11
22329;Žaliakalnio;SAULUTĖS;4154737541;Taip;11;7;0;18
22330;Žaliakalnio;SAULUTĖS;7913029369;Taip;14;0;0;14
22331;Žaliakalnio;SAULUTĖS;7793917852;Taip;0;5;1;6
22332;Žaliakalnio;SAULUTĖS;3018398546;Taip;11;2;0;13
22333;Žaliakalnio;SAULUTĖS;8765159796;Taip;17;0;0;17
22334;Žaliakalnio;SAULUTĖS;3028921540;Taip;0;4;0;4
22335;Žaliakalnio;SAULUTĖS;7636933790;Taip;5;10;0;15
22336;Žaliakalnio;SAULUTĖS;4355433666;Taip;7;5;0;12
22337;Žaliakalnio;SAULUTĖS;1975313368;Taip;0;4;9;13
22338;Žaliakalnio;SAULUTĖS;9016032548;Taip;0;2;0;2
22339;Žaliakalnio;SAULUTĖS;1715385224;Taip;10;4;0;14
22340;Žaliakalnio;SAULUTĖS;3304186400;Taip;11;3;0;14
22341;Žaliakalnio;SAULUTĖS;3434815790;Taip;6;1;0;7
22342;Žaliakalnio;SAULUTĖS;3832291926;Taip;11;1;0;12
22343;Žaliakalnio;SAULUTĖS;7071209465;Taip;8;1;0;9
22344;Žaliakalnio;SAULUTĖS;7543073516;Taip;10;2;0;12
22345;Žaliakalnio;SAULUTĖS;9379373983;Taip;5;3;0;8
22346;Žaliakalnio;SAULUTĖS;2806386840;Taip;9;3;0;12
22347;Volungė;Bitutės;5791161943;Taip;0;0;3;3
22348;Volungė;Bitutės;3307326410;Taip;9;0;2;11
22349;Volungė;Bitutės;5300334761;Taip;0;3;0;3
22350;Volungė;Bitutės;6755366051;Taip;5;0;4;9
22351;Volungė;Bitutės;4013639324;Taip;0;0;5;5
22352;Volungė;Bitutės;2599441104;Taip;0;0;5;5
22353;Volungė;Bitutės;5892600735;Taip;10;0;4;14
22354;Volungė;Bitutės;1902122510;Taip;0;3;7;10
22355;Volungė;Bitutės;1752817125;Taip;0;0;18;18
22356;Volungė;Bitutės;3515725398;Taip;7;3;1;11
22357;Volungė;Bitutės;3666364101;Taip;5;3;6;14
22358;Volungė;Bitutės;7151952679;Taip;0;0;5;5
22359;Volungė;Bitutės;5960027749;Taip;0;0;12;12
22360;Volungė;Bitutės;5149291935;Taip;0;3;1;4
22361;Volungė;Bitutės;8166517073;Taip;1;3;1;5
22362;Volungė;Bitutės;3106135598;Taip;5;0;2;7
22363;Volungė;Bitutės;9842009354;Taip;5;0;8;13
22364;Volungė;Bitutės;4437625791;Taip;8;3;0;11
22365;Volungė;Boružiukai;6431477042;Taip;0;0;4;4
22366;Volungė;Boružiukai;1137713075;Taip;0;7;0;7
22367;Volungė;Boružiukai;2322594823;Taip;0;11;0;11
22368;Volungė;Boružiukai;7965601199;Taip;0;3;0;3
22369;Volungė;Boružiukai;3746978206;Taip;0;0;5;5
22370;Volungė;Boružiukai;1528289101;Taip;0;3;0;3
22371;Volungė;Boružiukai;9188994935;Taip;0;14;0;14
22372;Volungė;Boružiukai;8285309230;Taip;0;3;8;11
22373;Volungė;Boružiukai;7149986415;Taip;0;3;1;4
22374;Volungė;Boružiukai;4598763851;Taip;0;3;0;3
22375;Volungė;Boružiukai;7867741556;Taip;12;1;0;13
22376;Volungė;Boružiukai;8459167833;Taip;0;0;4;4
22377;Volungė;Boružiukai;6028582927;Taip;0;3;0;3
22378;Volungė;Boružiukai;3832613221;Taip;5;3;2;10
22379;Volungė;Boružiukai;1757041481;Taip;5;3;0;8
22380;Volungė;Boružiukai;7971287899;Ne;0;4;0;4
22381;Volungė;Boružiukai;2627555750;Taip;11;0;3;14
22382;Volungė;Boružiukai;1974650443;Taip;0;0;3;3
22383;Volungė;Boružiukai;9677732243;Taip;0;0;3;3
22384;Volungė;Boružiukai;2068447339;Taip;0;18;0;18
22385;Volungė;Boružiukai;3528581949;Taip;0;0;6;6
22386;Volungė;Žvirbliukai;2360026330;Taip;0;0;4;4
22387;Volungė;Žvirbliukai;8414351815;Taip;9;0;15;24
22388;Volungė;Žvirbliukai;2051410463;Taip;8;0;4;12
22389;Volungė;Žvirbliukai;9575894080;Taip;0;0;6;6
22390;Volungė;Žvirbliukai;8927595898;Taip;8;0;0;8
22391;Volungė;Žvirbliukai;9384821249;Taip;0;0;10;10
22392;Volungė;Žvirbliukai;5361410157;Taip;0;0;7;7
22393;Volungė;Žvirbliukai;3499045731;Taip;0;0;3;3
22394;Volungė;Žvirbliukai;4235842588;Taip;0;6;0;6
22395;Volungė;Žvirbliukai;3028611395;Taip;15;0;3;18
22396;Volungė;Žvirbliukai;2949033093;Ne;8;0;4;12
22397;Volungė;Žvirbliukai;2159667991;Taip;0;0;15;15
22398;Volungė;Žvirbliukai;3282765504;Taip;0;0;16;16
22399;Volungė;Žvirbliukai;5470252589;Taip;0;3;3;6
22400;Volungė;Žvirbliukai;7923029388;Taip;8;0;3;11
22401;Volungė;Žiogeliai;6360834021;Taip;5;0;2;7
22402;Volungė;Žiogeliai;4856240879;Taip;0;0;5;5
22403;Volungė;Žiogeliai;4694016281;Taip;0;0;7;7
22404;Volungė;Žiogeliai;9816038480;Taip;3;0;8;11
22405;Volungė;Žiogeliai;8640511964;Taip;0;0;7;7
22406;Volungė;Žiogeliai;5170536566;Taip;4;3;1;8
22407;Volungė;Žiogeliai;8421730419;Taip;5;0;7;12
22408;Volungė;Žiogeliai;6532202782;Taip;5;0;6;11
22409;Volungė;Žiogeliai;2712034356;Taip;0;3;4;7
22410;Volungė;Žiogeliai;2246291631;Taip;0;0;3;3
22411;Volungė;Žiogeliai;2456643081;Taip;2;3;2;7
22412;Volungė;Žiogeliai;6920821813;Taip;5;0;3;8
22413;Volungė;Žiogeliai;8299305464;Taip;9;0;1;10
22414;Volungė;Žiogeliai;1781838937;Taip;0;12;0;12
22415;Volungė;Žiogeliai;7859381467;Taip;0;18;0;18
22416;Volungė;Žiogeliai;1988082807;Taip;0;3;0;3
22417;Volungė;Žiogeliai;3091641738;Ne;0;0;5;5
22418;Volungė;Žiogeliai;8578521969;Taip;10;0;0;10
22419;Volungė;Žiogeliai;5710662590;Taip;0;0;6;6
22420;Volungė;Žiogeliai;4839484528;Taip;15;3;0;18
22421;Volungė;Žiogeliai;5174427959;Taip;3;0;1;4
22422;Volungė;Žiogeliai;4726043862;Taip;5;0;2;7
22423;Volungė;Pelėdžiukai;2890377876;Taip;0;3;2;5
22424;Volungė;Pelėdžiukai;1099216923;Taip;0;3;6;9
22425;Volungė;Pelėdžiukai;3430719834;Taip;0;3;2;5
22426;Volungė;Pelėdžiukai;2566901599;Taip;0;2;10;12
22427;Volungė;Pelėdžiukai;2420242319;Taip;0;3;4;7
22428;Volungė;Pelėdžiukai;7973680488;Taip;0;3;1;4
22429;Volungė;Pelėdžiukai;3356901662;Taip;0;3;6;9
22430;Volungė;Pelėdžiukai;1225378067;Taip;0;4;5;9
22431;Volungė;Pelėdžiukai;7281448136;Taip;0;3;1;4
22432;Volungė;Pelėdžiukai;3215314804;Taip;0;3;2;5
22433;Volungė;Pelėdžiukai;9629567682;Taip;0;3;6;9
22434;Volungė;Pelėdžiukai;1120682487;Taip;0;3;2;5
22435;Volungė;Pelėdžiukai;9082860913;Taip;0;3;0;3
22436;Volungė;Pelėdžiukai;8174587725;Taip;0;8;2;10
22437;Volungė;Pelėdžiukai;17534618616;Taip;0;2;0;2
22438;Volungė;Pelėdžiukai;2187800215;Taip;0;1;0;1
22439;Volungė;Pelėdžiukai;7521910384;Taip;0;3;1;4
22440;Volungė;Pelėdžiukai;6565522808;Taip;0;3;3;6
22441;Volungė;Pelėdžiukai;9068889427;Taip;0;3;2;5
22442;Volungė;Pelėdžiukai;4123080241;Taip;0;3;6;9
22443;Volungė;Pelėdžiukai;8268202101;Taip;0;3;6;9
22444;Volungė;Pelėdžiukai;1366066359;Taip;0;3;1;4
22445;Volungė;Drugeliai;6280208510;Taip;4;0;7;11
22446;Volungė;Drugeliai;4032261812;Taip;7;3;0;10
22447;Volungė;Drugeliai;6488473384;Taip;0;5;1;6
22448;Volungė;Drugeliai;8045459660;Taip;10;0;3;13
22449;Volungė;Drugeliai;1402200673;Taip;10;0;3;13
22450;Volungė;Drugeliai;7574856429;Taip;18;0;0;18
22451;Volungė;Drugeliai;5284011092;Taip;0;0;4;4
22452;Volungė;Drugeliai;9729285419;Ne;0;3;3;6
22453;Volungė;Drugeliai;2686827560;Taip;0;0;5;5
22454;Volungė;Drugeliai;9973604148;Taip;0;0;6;6
22455;Volungė;Drugeliai;8905401944;Taip;18;0;0;18
22456;Volungė;Drugeliai;1164632050;Taip;0;2;0;2
22457;Volungė;Drugeliai;2923810441;Ne;3;3;5;11
22458;Volungė;Drugeliai;6782622442;Taip;0;0;10;10
22459;Volungė;Drugeliai;3020629341;Taip;3;0;0;3
22460;Volungė;Drugeliai;4252713086;Taip;2;3;0;5
22461;Volungė;Drugeliai;2530804242;Taip;0;2;0;2
22462;Volungė;Drugeliai;5354511593;Taip;10;0;3;13
22463;Volungė;Drugeliai;3150532451;Taip;0;6;3;9
22464;Volungė;Drugeliai;9343118795;Taip;1;0;1;2
22465;Volungė;Drugeliai;4745609424;Taip;18;0;0;18
22466;Volungė;Drugeliai;7584598377;Taip;5;3;0;8
22467;Volungė;"SKRUZDĖLIUKAI ";3394646139;Taip;5;5;0;10
22468;Volungė;"SKRUZDĖLIUKAI ";4223287277;Taip;0;0;1;1
22469;Volungė;"SKRUZDĖLIUKAI ";6464890465;Taip;12;0;0;12
22470;Volungė;"SKRUZDĖLIUKAI ";2493541457;Taip;5;0;9;14
22471;Volungė;"SKRUZDĖLIUKAI ";1948015523;Taip;0;1;1;2
22472;Volungė;"SKRUZDĖLIUKAI ";1101228927;Taip;0;3;1;4
22473;Volungė;"SKRUZDĖLIUKAI ";5332306628;Taip;13;2;0;15
22474;Volungė;"SKRUZDĖLIUKAI ";9319825151;Taip;0;4;5;9
22475;Volungė;"SKRUZDĖLIUKAI ";6370584522;Taip;0;9;0;9
22476;Volungė;"SKRUZDĖLIUKAI ";8168630107;Taip;0;5;3;8
22477;Volungė;"SKRUZDĖLIUKAI ";8992514683;Taip;5;3;2;10
22478;Volungė;"SKRUZDĖLIUKAI ";5833091791;Taip;0;0;6;6
22479;Volungė;"SKRUZDĖLIUKAI ";5994884455;Taip;0;0;4;4
22480;Volungė;"SKRUZDĖLIUKAI ";3818924175;Taip;0;3;3;6
22481;Volungė;"SKRUZDĖLIUKAI ";8244731771;Taip;0;3;3;6
22482;Volungė;"SKRUZDĖLIUKAI ";6110117105;Taip;0;0;12;12
22483;Volungė;"SKRUZDĖLIUKAI ";4944556574;Taip;8;3;1;12
22484;Volungė;"SKRUZDĖLIUKAI ";2212423676;Taip;0;0;8;8
22485;Volungė;"SKRUZDĖLIUKAI ";5942497397;Taip;17;1;0;18
22486;Volungė;"SKRUZDĖLIUKAI ";4991465781;Taip;0;0;1;1
22487;Volungė;"SKRUZDĖLIUKAI ";8613580206;Taip;6;3;0;9
22488;Volungė;Zylutės;6127398531;Taip;3;3;2;8
22489;Volungė;Zylutės;4664635246;Taip;4;0;0;4
22490;Volungė;Zylutės;9382043452;Taip;2;0;4;6
22491;Volungė;Zylutės;1125730734;Taip;0;5;3;8
22492;Volungė;Zylutės;5650558154;Taip;5;0;4;9
22493;Volungė;Zylutės;5588544003;Taip;3;3;0;6
22494;Volungė;Zylutės;3758750922;Taip;5;3;10;18
22495;Volungė;Zylutės;2663288986;Taip;0;0;3;3
22496;Volungė;Zylutės;3460701723;Taip;1;0;2;3
22497;Volungė;Zylutės;9562426487;Taip;4;0;2;6
22498;Volungė;Zylutės;4136178027;Taip;2;3;3;8
22499;Volungė;Zylutės;5882826586;Taip;0;11;0;11
22500;Volungė;Zylutės;6969633765;Taip;4;0;0;4
22501;Volungė;Zylutės;6445614647;Taip;11;0;0;11
22502;Volungė;Zylutės;5561683986;Taip;10;3;1;14
22503;Volungė;Zylutės;5338942678;Taip;5;0;4;9
22504;Volungė;Zylutės;8987748481;Taip;5;0;8;13
22505;Giliukas;SMALSUČIAI;9134734376;Taip;1;0;1;2
22506;Giliukas;SMALSUČIAI;3728323646;Taip;10;0;1;11
22507;Giliukas;SMALSUČIAI;6742406486;Taip;5;0;0;5
22508;Giliukas;SMALSUČIAI;9556962586;Ne;1;0;1;2
22509;Giliukas;SMALSUČIAI;2840410579;Taip;2;0;0;2
22510;Giliukas;SMALSUČIAI;2378721717;Taip;0;0;2;2
22511;Giliukas;SMALSUČIAI;7316126011;Taip;0;0;3;3
22512;Giliukas;SMALSUČIAI;6489845832;Taip;5;6;1;12
22513;Giliukas;SMALSUČIAI;6203352124;Taip;13;0;0;13
22514;Giliukas;SMALSUČIAI;9704885611;Taip;0;4;0;4
22515;Giliukas;SMALSUČIAI;7993049824;Taip;0;5;0;5
22516;Giliukas;SMALSUČIAI;2700296404;Taip;3;0;1;4
22517;Giliukas;SMALSUČIAI;9160815037;Taip;0;0;1;1
22518;Giliukas;SMALSUČIAI;5452941895;Taip;12;0;0;12
22519;Giliukas;SMALSUČIAI;3819765572;Taip;15;3;0;18
22520;Giliukas;SMALSUČIAI;8701216181;Taip;8;4;0;12
22521;Giliukas;GUDRUČIAI;2335031800;Taip;3;1;0;4
22522;Giliukas;GUDRUČIAI;3847358328;Taip;0;5;0;5
22523;Giliukas;GUDRUČIAI;6165618131;Ne;0;8;0;8
22524;Giliukas;GUDRUČIAI;9608331265;Taip;0;5;0;5
22525;Giliukas;GUDRUČIAI;3691791222;Taip;0;3;0;3
22526;Giliukas;GUDRUČIAI;1870173947;Taip;0;2;6;8
22527;Giliukas;GUDRUČIAI;9644050818;Taip;15;3;0;18
22528;Giliukas;GUDRUČIAI;3252419072;Taip;1;0;0;1
22529;Giliukas;GUDRUČIAI;3983555939;Taip;0;4;0;4
22530;Giliukas;GUDRUČIAI;2951628295;Taip;0;5;0;5
22531;Giliukas;GUDRUČIAI;9408948207;Taip;0;5;0;5
22532;Giliukas;GUDRUČIAI;2003990493;Taip;0;4;0;4
22533;Giliukas;GUDRUČIAI;4960232685;Taip;0;4;0;4
22534;Giliukas;GUDRUČIAI;4916844983;Taip;0;3;2;5
22535;Giliukas;GUDRUČIAI;5787041097;Taip;9;5;0;14
22536;Giliukas;GUDRUČIAI;9458151965;Taip;5;3;3;11
22537;Giliukas;GUDRUČIAI;7159681896;Taip;0;2;2;4
22538;Giliukas;PABIRUČIAI;4183026763;Taip;11;3;0;14
22539;Giliukas;PABIRUČIAI;1221640023;Taip;12;2;0;14
22540;Giliukas;PABIRUČIAI;2362785562;Ne;9;0;0;9
22541;Giliukas;PABIRUČIAI;4247090684;Taip;13;0;0;13
22542;Giliukas;PABIRUČIAI;9824315755;Taip;0;1;12;13
22543;Giliukas;PABIRUČIAI;2379370477;Taip;5;2;0;7
22544;Giliukas;PABIRUČIAI;3870143024;Taip;5;1;7;13
22545;Giliukas;PABIRUČIAI;6914013230;Taip;11;0;2;13
22546;Giliukas;PABIRUČIAI;2512831288;Taip;10;0;5;15
22547;Giliukas;PABIRUČIAI;7013767174;Taip;6;1;0;7
22548;Giliukas;PABIRUČIAI;4810236703;Taip;12;0;0;12
22549;Giliukas;PABIRUČIAI;4105974682;Taip;5;0;2;7
22550;Giliukas;PABIRUČIAI;8874804636;Taip;0;5;0;5
22551;Giliukas;ŠVELNUKAI;7402797271;Taip;18;0;0;18
22552;Giliukas;ŠVELNUKAI;3839624551;Taip;1;0;1;2
22553;Giliukas;ŠVELNUKAI;2012365132;Taip;0;0;3;3
22554;Giliukas;ŠVELNUKAI;9270743786;Taip;0;0;2;2
22555;Giliukas;ŠVELNUKAI;1710286878;Taip;3;0;7;10
22556;Giliukas;ŠVELNUKAI;4565216956;Taip;0;0;5;5
22557;Giliukas;ŠVELNUKAI;5834233526;Taip;5;0;3;8
22558;Giliukas;ŠVELNUKAI;5000654626;Taip;0;0;1;1
22559;Giliukas;ŠVELNUKAI;8973584424;Taip;4;0;2;6
22560;Giliukas;ŠVELNUKAI;9679421414;Taip;3;0;3;6
22561;Giliukas;ŠVELNUKAI;2881704755;Taip;5;0;0;5
22562;Giliukas;ŠVELNUKAI;3238820351;Taip;0;0;3;3
22563;Giliukas;ŠVELNUKAI;4340602792;Taip;0;0;7;7
22564;Giliukas;ŠVELNUKAI;2229737837;Taip;18;0;0;18
22565;Giliukas;ŽINIUKAI;6422178450;Taip;0;3;0;3
22566;Giliukas;ŽINIUKAI;2502801547;Taip;0;5;0;5
22567;Giliukas;ŽINIUKAI;9617542456;Taip;8;1;0;9
22568;Giliukas;ŽINIUKAI;2562809633;Taip;4;5;0;9
22569;Giliukas;ŽINIUKAI;5326178821;Ne;0;7;0;7
22570;Giliukas;ŽINIUKAI;2692141913;Taip;11;3;1;15
22571;Giliukas;ŽINIUKAI;9152432124;Taip;15;0;0;15
22572;Giliukas;ŽINIUKAI;4854370266;Taip;0;4;0;4
22573;Giliukas;ŽINIUKAI;6703080106;Taip;7;2;0;9
22574;Giliukas;ŽINIUKAI;6942029629;Taip;0;4;0;4
22575;Giliukas;ŽINIUKAI;9274289812;Taip;0;3;0;3
22576;Giliukas;ŽINIUKAI;6956862865;Taip;0;2;4;6
22577;Giliukas;ŽINIUKAI;3150981084;Taip;9;3;0;12
22578;Giliukas;ŽINIUKAI;6134554678;Taip;0;7;0;7
22579;Giliukas;ŽINIUKAI;6338583515;Taip;3;5;1;9
22580;Giliukas;ŽINIUKAI;2064182165;Taip;5;0;1;6
22581;Giliukas;ŽINIUKAI;5201020765;Taip;5;8;0;13
22582;Giliukas;ŽINIUKAI;2042324002;Taip;0;3;0;3
22583;Giliukas;ŽINIUKAI;3137768675;Taip;5;4;0;9
22584;Giliukas;ŽINIUKAI;3718774263;Taip;15;3;0;18
22585;Giliukas;MYLIMUKAI;7205807049;Taip;7;2;4;13
22586;Giliukas;MYLIMUKAI;1165810193;Taip;0;2;7;9
22587;Giliukas;MYLIMUKAI;3055598917;Taip;0;4;0;4
22588;Giliukas;MYLIMUKAI;6953123617;Taip;0;6;0;6
22589;Giliukas;MYLIMUKAI;4207939009;Taip;0;0;4;4
22590;Giliukas;MYLIMUKAI;2742106493;Taip;0;7;0;7
22591;Giliukas;MYLIMUKAI;1916905497;Taip;0;3;3;6
22592;Giliukas;MYLIMUKAI;7053406257;Taip;11;2;1;14
22593;Giliukas;MYLIMUKAI;5222092567;Taip;6;3;0;9
22594;Giliukas;MYLIMUKAI;4581414740;Taip;4;2;1;7
22595;Giliukas;MYLIMUKAI;2226855971;Taip;0;8;3;11
22596;Giliukas;MYLIMUKAI;7431116067;Taip;13;0;0;13
22597;Giliukas;MYLIMUKAI;6748766233;Taip;5;0;0;5
22598;Giliukas;MYLIMUKAI;5298822890;Taip;0;2;3;5
22599;Giliukas;MYLIMUKAI;3726149759;Taip;0;8;2;10
22600;Giliukas;MYLIMUKAI;5300517567;Taip;0;8;0;8
22601;Giliukas;MYLIMUKAI;5625404051;Taip;0;0;4;4
22602;Giliukas;MYLIMUKAI;9224387185;Taip;0;18;0;18
22603;Giliukas;ČIAUŠKUČIAI;1762536884;Taip;0;5;6;11
22604;Giliukas;ČIAUŠKUČIAI;7646966187;Taip;5;4;0;9
22605;Giliukas;ČIAUŠKUČIAI;2801731379;Taip;0;5;5;10
22606;Giliukas;ČIAUŠKUČIAI;8499893356;Ne;0;8;0;8
22607;Giliukas;ČIAUŠKUČIAI;9205911152;Taip;5;0;1;6
22608;Giliukas;ČIAUŠKUČIAI;3720032249;Taip;0;0;4;4
22609;Giliukas;ČIAUŠKUČIAI;3659105022;Taip;0;4;0;4
22610;Giliukas;ČIAUŠKUČIAI;4940718205;Taip;4;2;1;7
22611;Giliukas;ČIAUŠKUČIAI;8491008130;Taip;0;5;3;8
22612;Giliukas;ČIAUŠKUČIAI;4163383707;Taip;8;1;1;10
22613;Giliukas;ČIAUŠKUČIAI;2612551188;Taip;15;0;0;15
22614;Giliukas;ČIAUŠKUČIAI;9366734581;Taip;7;1;0;8
22615;Giliukas;ČIAUŠKUČIAI;9462634699;Taip;3;0;3;6
22616;Giliukas;ČIAUŠKUČIAI;8106782330;Taip;0;0;18;18
22617;Giliukas;ČIAUŠKUČIAI;1332725572;Taip;5;4;0;9
22618;Giliukas;ČIAUŠKUČIAI;4347883309;Taip;0;2;0;2
22619;Giliukas;ČIAUŠKUČIAI;2787116787;Taip;0;4;0;4
22620;Giliukas;ŠNEKUČIAI;9229086918;Taip;8;1;0;9
22621;Giliukas;ŠNEKUČIAI;3274313536;Taip;0;1;0;1
22622;Giliukas;ŠNEKUČIAI;9287193955;Taip;0;6;0;6
22623;Giliukas;ŠNEKUČIAI;5527212334;Taip;5;0;5;10
22624;Giliukas;ŠNEKUČIAI;9499591494;Taip;0;0;3;3
22625;Giliukas;ŠNEKUČIAI;2099575372;Taip;4;0;2;6
22626;Giliukas;ŠNEKUČIAI;7195772641;Taip;0;0;4;4
22627;Giliukas;ŠNEKUČIAI;4258921446;Taip;0;0;2;2
22628;Giliukas;ŠNEKUČIAI;1439350058;Taip;0;0;4;4
22629;Giliukas;ŠNEKUČIAI;4843920452;Taip;9;0;3;12
22630;Giliukas;ŠNEKUČIAI;2004782696;Taip;3;0;1;4
22631;Giliukas;ŠNEKUČIAI;8977247073;Taip;0;0;5;5
22632;Giliukas;ŠNEKUČIAI;8147492951;Taip;5;0;0;5
22633;Giliukas;ŠNEKUČIAI;2349166172;Taip;7;0;3;10
22634;Giliukas;ŠNEKUČIAI;8241215831;Taip;11;0;0;11
22635;Giliukas;ŠNEKUČIAI;9475918013;Taip;8;0;2;10
22636;Giliukas;ŠNEKUČIAI;7944198886;Taip;18;0;0;18
22637;"Lazdynų mokykla (Žėručio g. 4)";Drugeliai;4520091712;Taip;0;3;0;3
22638;"Lazdynų mokykla (Žėručio g. 4)";Drugeliai;8472834181;Taip;0;5;0;5
22639;"Lazdynų mokykla (Žėručio g. 4)";Drugeliai;9196184984;Taip;11;2;0;13
22640;"Lazdynų mokykla (Žėručio g. 4)";Drugeliai;6394098306;Taip;0;2;7;9
22641;"Lazdynų mokykla (Žėručio g. 4)";Drugeliai;2027751624;Taip;0;8;2;10
22642;"Lazdynų mokykla (Žėručio g. 4)";Drugeliai;2767732459;Ne;0;5;0;5
22643;"Lazdynų mokykla (Žėručio g. 4)";Drugeliai;5902104981;Taip;0;12;0;12
22644;"Lazdynų mokykla (Žėručio g. 4)";Drugeliai;7590111138;Taip;0;5;0;5
22645;"Lazdynų mokykla (Žėručio g. 4)";Drugeliai;7524849851;Taip;7;4;0;11
22646;"Lazdynų mokykla (Žėručio g. 4)";Drugeliai;1951041742;Ne;3;5;0;8
22647;"Lazdynų mokykla (Žėručio g. 4)";Drugeliai;9309081745;Taip;0;0;1;1
22648;"Lazdynų mokykla (Žėručio g. 4)";Drugeliai;8650496265;Taip;0;2;1;3
22649;"Lazdynų mokykla (Žėručio g. 4)";Drugeliai;8001610972;Ne;0;2;0;2
22650;"Lazdynų mokykla (Žėručio g. 4)";Drugeliai;4684618253;Taip;15;0;0;15
22651;"Lazdynų mokykla (Žėručio g. 4)";Drugeliai;6658025277;Ne;3;0;0;3
22652;"Lazdynų mokykla (Žėručio g. 4)";Drugeliai;7074859809;Taip;10;2;3;15
22653;"Lazdynų mokykla (Žėručio g. 4)";Drugeliai;4097980299;Ne;0;2;0;2
22654;"Lazdynų mokykla (Žėručio g. 4)";Drugeliai;1365362641;Taip;0;9;0;9
22655;"Lazdynų mokykla (Žėručio g. 4)";Zuikučiai;3435025978;Taip;10;0;2;12
22656;"Lazdynų mokykla (Žėručio g. 4)";Zuikučiai;8899186547;Taip;9;0;2;11
22657;"Lazdynų mokykla (Žėručio g. 4)";Zuikučiai;5465094647;Taip;0;6;0;6
22658;"Lazdynų mokykla (Žėručio g. 4)";Zuikučiai;1044630813;Taip;0;3;0;3
22659;"Lazdynų mokykla (Žėručio g. 4)";Zuikučiai;3268305561;Taip;0;1;0;1
22660;"Lazdynų mokykla (Žėručio g. 4)";Zuikučiai;3535244441;Taip;11;0;0;11
22661;"Lazdynų mokykla (Žėručio g. 4)";Zuikučiai;3265099747;Taip;0;0;2;2
22662;"Lazdynų mokykla (Žėručio g. 4)";Zuikučiai;1336503878;Taip;7;0;0;7
22663;"Lazdynų mokykla (Žėručio g. 4)";Zuikučiai;5181200460;Taip;7;0;0;7
22664;"Lazdynų mokykla (Žėručio g. 4)";Zuikučiai;8669630986;Taip;8;0;0;8
22665;"Lazdynų mokykla (Žėručio g. 4)";Zuikučiai;4166599533;Taip;0;0;2;2
22666;"Lazdynų mokykla (Žėručio g. 4)";Zuikučiai;3715070791;Taip;0;2;0;2
22667;"Lazdynų mokykla (Žėručio g. 4)";Zuikučiai;7232402011;Taip;8;3;0;11
22668;"Lazdynų mokykla (Žėručio g. 4)";Zuikučiai;3302443490;Taip;8;2;1;11
22669;"Lazdynų mokykla (Žėručio g. 4)";Zuikučiai;7000921682;Taip;0;2;1;3
22670;"Lazdynų mokykla (Žėručio g. 4)";Zuikučiai;7594978836;Taip;7;0;0;7
22671;"Lazdynų mokykla (Žėručio g. 4)";Zuikučiai;7229926614;Taip;3;0;0;3
22672;"Lazdynų mokykla (Žėručio g. 4)";RUPG;5095782784;Taip;0;1;0;1
22673;"Lazdynų mokykla (Žėručio g. 4)";RUPG;6038907328;Taip;3;3;0;6
22674;"Lazdynų mokykla (Žėručio g. 4)";RUPG;4086774324;Taip;0;18;0;18
22675;"Lazdynų mokykla (Žėručio g. 4)";RUPG;6070629454;Taip;0;18;0;18
22676;"Lazdynų mokykla (Žėručio g. 4)";RUPG;1118653070;Ne;8;5;0;13
22677;"Lazdynų mokykla (Žėručio g. 4)";RUPG;3367804873;Taip;7;3;2;12
22678;"Lazdynų mokykla (Žėručio g. 4)";RUPG;5806696915;Taip;0;3;1;4
22679;"Lazdynų mokykla (Žėručio g. 4)";RUPG;2209697834;Taip;0;18;0;18
22680;"Lazdynų mokykla (Žėručio g. 4)";RUPG;6638804854;Taip;0;18;0;18
22681;"Lazdynų mokykla (Žėručio g. 4)";RUPG;3634678954;Taip;9;3;0;12
22682;"Lazdynų mokykla (Žėručio g. 4)";RUPG;1910570858;Taip;0;7;0;7
22683;"Lazdynų mokykla (Žėručio g. 4)";RUPG;8318567916;Taip;0;3;1;4
22684;"Lazdynų mokykla (Žėručio g. 4)";RUPG;5982019255;Taip;5;3;0;8
22685;"Lazdynų mokykla (Žėručio g. 4)";RUPG;2160440145;Taip;0;3;0;3
22686;"Lazdynų mokykla (Žėručio g. 4)";RUPG;1025406111;Taip;0;3;1;4
22687;"Lazdynų mokykla (Žėručio g. 4)";RUPG;5095782784;Taip;5;3;0;8
22688;"Lazdynų mokykla (Žėručio g. 4)";LEPG;9656050113;Taip;0;4;0;4
22689;"Lazdynų mokykla (Žėručio g. 4)";LEPG;6822686126;Taip;5;3;0;8
22690;"Lazdynų mokykla (Žėručio g. 4)";LEPG;2070196225;Taip;5;4;0;9
22691;"Lazdynų mokykla (Žėručio g. 4)";LEPG;2613078582;Taip;5;5;0;10
22692;"Lazdynų mokykla (Žėručio g. 4)";LEPG;7059075747;Taip;6;4;1;11
22693;"Lazdynų mokykla (Žėručio g. 4)";LEPG;5438716880;Taip;0;4;1;5
22694;"Lazdynų mokykla (Žėručio g. 4)";LEPG;7487278074;Taip;0;4;0;4
22695;"Lazdynų mokykla (Žėručio g. 4)";LEPG;7320049068;Taip;0;4;0;4
22696;"Lazdynų mokykla (Žėručio g. 4)";LEPG;1396367371;Taip;3;3;1;7
22697;"Lazdynų mokykla (Žėručio g. 4)";LEPG;7324846434;Taip;0;4;0;4
22698;"Lazdynų mokykla (Žėručio g. 4)";LEPG;1532248269;Taip;2;4;2;8
22699;"Lazdynų mokykla (Žėručio g. 4)";LEPG;3675401775;Taip;6;4;1;11
22700;"Lazdynų mokykla (Žėručio g. 4)";LEPG;6794153377;Taip;1;3;5;9
22701;"Lazdynų mokykla (Žėručio g. 4)";LEPG;2825614921;Taip;10;3;0;13
22702;"Lazdynų mokykla (Žėručio g. 4)";LEPG;9592456683;Taip;0;4;1;5
22703;"Lazdynų mokykla (Žėručio g. 4)";LEPG;6117542654;Taip;0;4;0;4
22704;"Lazdynų mokykla (Žėručio g. 4)";LEPG;4149212470;Taip;0;4;3;7
22705;"Lazdynų mokykla (Žėručio g. 4)";LEPG;8324750958;Ne;9;3;0;12
22706;"Lazdynų mokykla (Žėručio g. 4)";LEPG;7659209862;Taip;8;3;1;12
22707;"Lazdynų mokykla (Žėručio g. 4)";LEPG;9654428418;Taip;0;4;0;4
22708;"Lazdynų mokykla (Žėručio g. 4)";RUPG;3631150576;Taip;0;3;3;6
22709;"Lazdynų mokykla (Žėručio g. 4)";RUPG;5015519090;Taip;3;3;0;6
22710;"Lazdynų mokykla (Žėručio g. 4)";RUPG;1745679183;Taip;0;4;0;4
22711;"Lazdynų mokykla (Žėručio g. 4)";RUPG;9255723192;Taip;2;3;2;7
22712;"Lazdynų mokykla (Žėručio g. 4)";RUPG;9639587601;Taip;0;3;1;4
22713;"Lazdynų mokykla (Žėručio g. 4)";RUPG;4087148273;Taip;5;3;0;8
22714;"Lazdynų mokykla (Žėručio g. 4)";RUPG;2740942924;Taip;0;3;0;3
22715;"Lazdynų mokykla (Žėručio g. 4)";RUPG;2700475528;Taip;0;3;0;3
22716;"Lazdynų mokykla (Žėručio g. 4)";RUPG;7180617984;Taip;5;3;0;8
22717;"Lazdynų mokykla (Žėručio g. 4)";RUPG;4023257875;Taip;3;3;0;6
22718;"Lazdynų mokykla (Žėručio g. 4)";RUPG;2308739823;Taip;2;3;1;6
22719;"Lazdynų mokykla (Žėručio g. 4)";RUPG;9123178095;Taip;5;4;0;9
22720;"Lazdynų mokykla (Žėručio g. 4)";RUPG;3000676765;Taip;6;3;0;9
22721;"Lazdynų mokykla (Žėručio g. 4)";RUPG;9968637187;Taip;6;3;0;9
22722;"Lazdynų mokykla (Žėručio g. 4)";RUPG;8886654664;Taip;7;3;0;10
22723;Santariškių;Giliukai;8969667023;Taip;10;0;0;10
22724;Santariškių;Avietėlės;2938170758;Taip;8;0;0;8
22725;Santariškių;Vyšniukai;9819079431;Taip;10;0;0;10
22726;Santariškių;Vyšniukai;8749265990;Taip;10;0;0;10
22727;"Vilnios pagrindinė mokykla";EŽIUKAI;5939264188;Taip;13;0;0;13
22728;"„Atžalyno” mokykla-darželis";Giliukai;1209960122;Taip;3;3;2;8
22729;"„Atžalyno” mokykla-darželis";Giliukai;1579954367;Taip;0;4;0;4
22730;"„Atžalyno” mokykla-darželis";Giliukai;9655000018;Taip;0;4;0;4
22731;"„Atžalyno” mokykla-darželis";Giliukai;8826921260;Ne;8;4;0;12
22732;"„Atžalyno” mokykla-darželis";Giliukai;2773253032;Taip;2;4;1;7
22733;"„Atžalyno” mokykla-darželis";Giliukai;3170216428;Taip;0;4;1;5
22734;"„Atžalyno” mokykla-darželis";Giliukai;4345420422;Taip;0;3;1;4
22735;"„Atžalyno” mokykla-darželis";Giliukai;2772290605;Taip;0;4;0;4
22736;"„Atžalyno” mokykla-darželis";Giliukai;4422345256;Taip;0;1;1;2
22737;"„Atžalyno” mokykla-darželis";Giliukai;5596753512;Taip;1;2;0;3
22738;"„Atžalyno” mokykla-darželis";Giliukai;1958519966;Taip;15;0;0;15
22739;"„Atžalyno” mokykla-darželis";Giliukai;9806203065;Taip;0;4;2;6
22740;"„Atžalyno” mokykla-darželis";Giliukai;8688627865;Taip;0;4;1;5
22741;"„Atžalyno” mokykla-darželis";Giliukai;2601122166;Taip;10;4;0;14
22742;"„Atžalyno” mokykla-darželis";Giliukai;3529875728;Taip;0;3;1;4
22743;"„Atžalyno” mokykla-darželis";Giliukai;1311162040;Taip;8;4;0;12
22744;"„Atžalyno” mokykla-darželis";Giliukai;4427232735;Taip;0;4;8;12
22745;"„Atžalyno” mokykla-darželis";Giliukai;9013323901;Taip;5;4;2;11
22746;"„Atžalyno” mokykla-darželis";Giliukai;5503766544;Taip;0;4;0;4
22747;"„Atžalyno” mokykla-darželis";Giliukai;8254801574;Taip;2;4;0;6
22748;"„Atžalyno” mokykla-darželis";Giliukai;9215658103;Taip;2;2;0;4
22749;"„Atžalyno” mokykla-darželis";Giliukai;5030879885;Taip;2;4;5;11
22750;"„Atžalyno” mokykla-darželis";Giliukai;3484401937;Taip;3;4;4;11
22751;"„Atžalyno” mokykla-darželis";Riešutėliai;4360099345;Taip;8;1;0;9
22752;"„Atžalyno” mokykla-darželis";Riešutėliai;5947938371;Ne;16;0;2;18
22753;"„Atžalyno” mokykla-darželis";Riešutėliai;5384245347;Taip;0;4;0;4
22754;"„Atžalyno” mokykla-darželis";Riešutėliai;4246430352;Taip;5;0;5;10
22755;"„Atžalyno” mokykla-darželis";Riešutėliai;8574494664;Ne;8;1;0;9
22756;"„Atžalyno” mokykla-darželis";Riešutėliai;5815412814;Taip;3;4;0;7
22757;"„Atžalyno” mokykla-darželis";Riešutėliai;4161658496;Ne;5;3;0;8
22758;"„Atžalyno” mokykla-darželis";Riešutėliai;8942132574;Taip;10;1;0;11
22759;"„Atžalyno” mokykla-darželis";Riešutėliai;7109850241;Taip;5;4;0;9
22760;"„Atžalyno” mokykla-darželis";Riešutėliai;7368616441;Taip;2;0;10;12
22761;"„Atžalyno” mokykla-darželis";Riešutėliai;5242752663;Taip;0;0;4;4
22762;"„Atžalyno” mokykla-darželis";Riešutėliai;5709028342;Taip;10;5;0;15
22763;"„Atžalyno” mokykla-darželis";Riešutėliai;8803555426;Taip;0;1;2;3
22764;"„Atžalyno” mokykla-darželis";Riešutėliai;5994983369;Ne;0;4;0;4
22765;"„Atžalyno” mokykla-darželis";Riešutėliai;1041363325;Taip;0;3;10;13
22766;"„Atžalyno” mokykla-darželis";Riešutėliai;7676614240;Taip;0;0;2;2
22767;"„Atžalyno” mokykla-darželis";Riešutėliai;3751729666;Taip;0;0;6;6
22768;"„Atžalyno” mokykla-darželis";Riešutėliai;3441950153;Taip;7;0;4;11
22769;"„Atžalyno” mokykla-darželis";Riešutėliai;4223591454;Taip;0;3;1;4
22770;"„Atžalyno” mokykla-darželis";Žirniukai;6903825217;Taip;6;10;3;19
22771;"„Atžalyno” mokykla-darželis";Žirniukai;9101301819;Ne;0;0;9;9
22772;"„Atžalyno” mokykla-darželis";Žirniukai;6602037942;Taip;0;2;0;2
22773;"„Atžalyno” mokykla-darželis";Žirniukai;7579781779;Taip;8;2;0;10
22774;"„Atžalyno” mokykla-darželis";Žirniukai;1915676392;Ne;0;0;4;4
22775;"„Atžalyno” mokykla-darželis";Žirniukai;7669725276;Taip;0;15;1;16
22776;"„Atžalyno” mokykla-darželis";Žirniukai;5986664970;Taip;0;13;4;17
22777;"„Atžalyno” mokykla-darželis";Žirniukai;9913048992;Taip;7;9;0;16
22778;"„Atžalyno” mokykla-darželis";Žirniukai;4616870552;Taip;0;4;0;4
22779;"„Atžalyno” mokykla-darželis";Žirniukai;4107946143;Taip;5;1;3;9
22780;"„Atžalyno” mokykla-darželis";Žirniukai;7883570492;Ne;6;6;0;12
22781;"„Atžalyno” mokykla-darželis";Žirniukai;8320161812;Taip;3;6;0;9
22782;"„Atžalyno” mokykla-darželis";Žirniukai;5335059675;Taip;8;4;0;12
22783;"„Atžalyno” mokykla-darželis";Žirniukai;6922776405;Taip;0;3;20;23
22784;"„Atžalyno” mokykla-darželis";Žirniukai;9690554753;Taip;5;0;12;17
22785;"„Atžalyno” mokykla-darželis";Žirniukai;1961428224;Ne;23;0;0;23
22786;"„Atžalyno” mokykla-darželis";Žirniukai;8070499557;Taip;0;7;1;8
22787;"„Atžalyno” mokykla-darželis";Žirniukai;2446697763;Taip;0;0;11;11
22788;"„Atžalyno” mokykla-darželis";Žirniukai;2462839180;Taip;6;1;2;9
22789;"„Atžalyno” mokykla-darželis";Žirniukai;4784990018;Taip;12;8;1;21
22790;"„Atžalyno” mokykla-darželis";VYŠNIUKAI;6120955217;Taip;4;3;1;8
22791;"„Atžalyno” mokykla-darželis";VYŠNIUKAI;1787256844;Ne;15;1;2;18
22792;"„Atžalyno” mokykla-darželis";VYŠNIUKAI;2547003287;Ne;15;1;2;18
22793;"„Atžalyno” mokykla-darželis";VYŠNIUKAI;4503448206;Taip;14;0;0;14
22794;"„Atžalyno” mokykla-darželis";VYŠNIUKAI;3664056583;Taip;6;6;0;12
22795;"„Atžalyno” mokykla-darželis";VYŠNIUKAI;5456248305;Taip;15;1;0;16
22796;"„Atžalyno” mokykla-darželis";VYŠNIUKAI;3719072139;Taip;12;3;2;17
22797;"„Atžalyno” mokykla-darželis";VYŠNIUKAI;9245994735;Taip;16;9;0;25
22798;"„Atžalyno” mokykla-darželis";VYŠNIUKAI;3770167696;Taip;28;0;0;28
22799;"„Atžalyno” mokykla-darželis";VYŠNIUKAI;2000352986;Taip;14;0;0;14
22800;"„Atžalyno” mokykla-darželis";VYŠNIUKAI;2177213062;Taip;2;1;1;4
22801;"„Atžalyno” mokykla-darželis";VYŠNIUKAI;4635394632;Ne;7;3;4;14
22802;"„Atžalyno” mokykla-darželis";VYŠNIUKAI;3524131672;Taip;14;0;0;14
22803;"„Atžalyno” mokykla-darželis";VYŠNIUKAI;4840490901;Taip;9;4;4;17
22804;"„Atžalyno” mokykla-darželis";VYŠNIUKAI;4796052680;Taip;12;0;0;12
22805;"„Atžalyno” mokykla-darželis";VYŠNIUKAI;3181675972;Taip;7;0;5;12
22806;"„Atžalyno” mokykla-darželis";VYŠNIUKAI;8163063211;Taip;16;0;0;16
22807;"„Atžalyno” mokykla-darželis";VYŠNIUKAI;4431437971;Taip;11;4;4;19
22808;"„Atžalyno” mokykla-darželis";PIPIRIUKAI;8357021249;Taip;10;9;0;19
22809;"„Atžalyno” mokykla-darželis";PIPIRIUKAI;4582284727;Taip;2;4;1;7
22810;"„Atžalyno” mokykla-darželis";PIPIRIUKAI;4785607785;Taip;5;0;5;10
22811;"„Atžalyno” mokykla-darželis";PIPIRIUKAI;5615246040;Taip;0;4;6;10
22812;"„Atžalyno” mokykla-darželis";PIPIRIUKAI;1988657552;Taip;19;0;3;22
22813;"„Atžalyno” mokykla-darželis";PIPIRIUKAI;6721771665;Ne;15;4;0;19
22814;"„Atžalyno” mokykla-darželis";PIPIRIUKAI;7946139474;Taip;4;7;5;16
22815;"„Atžalyno” mokykla-darželis";PIPIRIUKAI;2921181385;Ne;5;0;7;12
22816;"„Atžalyno” mokykla-darželis";PIPIRIUKAI;2108706876;Taip;0;8;12;20
22817;"„Atžalyno” mokykla-darželis";PIPIRIUKAI;1228919159;Taip;8;11;0;19
22818;"„Atžalyno” mokykla-darželis";PIPIRIUKAI;3919301151;Taip;5;0;8;13
22819;"„Atžalyno” mokykla-darželis";PIPIRIUKAI;3624299098;Taip;0;5;0;5
22820;"„Atžalyno” mokykla-darželis";PIPIRIUKAI;2537063401;Taip;0;4;12;16
22821;"„Atžalyno” mokykla-darželis";PIPIRIUKAI;4166521512;Taip;10;5;1;16
22822;"„Atžalyno” mokykla-darželis";PIPIRIUKAI;8372179128;Taip;0;0;5;5
22823;"„Atžalyno” mokykla-darželis";PIPIRIUKAI;3204191459;Taip;11;9;0;20
22824;"„Atžalyno” mokykla-darželis";PIPIRIUKAI;5321475187;Taip;7;1;2;10
22825;"„Atžalyno” mokykla-darželis";PIPIRIUKAI;3015863723;Taip;21;0;0;21
22826;"„Atžalyno” mokykla-darželis";PIPIRIUKAI;3323233525;Taip;13;7;0;20
22827;"„Atžalyno” mokykla-darželis";PIPIRIUKAI;4596770586;Taip;10;5;3;18
22828;"„Atžalyno” mokykla-darželis";PIPIRIUKAI;7652421432;Taip;12;1;1;14
22829;"Vilniaus Naujininkų mokykla";"SAULĖS ZUIKUČIAI";1096474672;Taip;3;4;1;8
22830;"Vilniaus Naujininkų mokykla";"SAULĖS ZUIKUČIAI";9856315057;Taip;0;3;0;3
22831;"Vilniaus Naujininkų mokykla";"SAULĖS ZUIKUČIAI";1901250406;Ne;0;6;0;6
22832;"Vilniaus Naujininkų mokykla";"SAULĖS ZUIKUČIAI";9427388681;Taip;5;1;0;6
22833;"Vilniaus Naujininkų mokykla";"SAULĖS ZUIKUČIAI";5512321795;Taip;0;4;0;4
22834;"Vilniaus Naujininkų mokykla";"SAULĖS ZUIKUČIAI";9411054207;Ne;3;7;0;10
22835;"Vilniaus Naujininkų mokykla";"SAULĖS ZUIKUČIAI";3810550099;Taip;0;8;0;8
22836;"Vilniaus Naujininkų mokykla";"SAULĖS ZUIKUČIAI";7692387379;Taip;0;1;1;2
22837;"Vilniaus Naujininkų mokykla";"SAULĖS ZUIKUČIAI";8935072613;Ne;9;3;0;12
22838;"Vilniaus Naujininkų mokykla";"SAULĖS ZUIKUČIAI";9544088525;Ne;0;3;1;4
22839;"Vilniaus Naujininkų mokykla";"SAULĖS ZUIKUČIAI";9488762308;Taip;16;0;11;27
22840;"Vilniaus Naujininkų mokykla";"SAULĖS ZUIKUČIAI";2437553321;Ne;0;0;18;18
22841;"Vilniaus Naujininkų mokykla";"SAULĖS ZUIKUČIAI";5148002236;Taip;0;4;1;5
22842;"Vilniaus Naujininkų mokykla";"SAULĖS ZUIKUČIAI";5005674409;Ne;0;0;5;5
22843;"Vilniaus Naujininkų mokykla";SMALSUČIAI;2428447892;Taip;6;4;0;10
22844;"Vilniaus Naujininkų mokykla";SMALSUČIAI;1224054771;Taip;0;4;0;4
22845;"Vilniaus Naujininkų mokykla";SMALSUČIAI;79174984189;Taip;0;1;0;1
22846;"Vilniaus Naujininkų mokykla";SMALSUČIAI;1662993666;Taip;0;4;2;6
22847;"Vilniaus Naujininkų mokykla";SMALSUČIAI;7144596269;Ne;9;4;2;15
22848;"Vilniaus Naujininkų mokykla";SMALSUČIAI;6362889550;Taip;5;5;4;14
22849;"Vilniaus Naujininkų mokykla";SMALSUČIAI;1980755137;Taip;0;10;0;10
22850;"Vilniaus Naujininkų mokykla";SMALSUČIAI;1920917916;Taip;5;6;0;11
22851;"Vilniaus Naujininkų mokykla";SMALSUČIAI;8828658544;Ne;1;4;1;6
22852;"Vilniaus Naujininkų mokykla";SMALSUČIAI;5633127620;Taip;5;4;10;19
22853;"Vilniaus Naujininkų mokykla";SMALSUČIAI;3867799187;Taip;0;4;3;7
22854;"Vilniaus Naujininkų mokykla";SMALSUČIAI;1350744949;Taip;5;4;14;23
22855;"Vilniaus Naujininkų mokykla";SMALSUČIAI;63557632023;Taip;6;5;0;11
22856;"Vilniaus Naujininkų mokykla";SMALSUČIAI;8280826634;Ne;0;4;2;6
22857;"Vilniaus Naujininkų mokykla";SMALSUČIAI;5302103644;Ne;0;16;0;16
22858;"Vilniaus Naujininkų mokykla";SMALSUČIAI;5638817349;Taip;0;4;5;9
22859;"Vilniaus Naujininkų mokykla";SMALSUČIAI;1880254518;Taip;6;4;0;10
22860;"Vilniaus Karaliaus Mindaugo pagrindinė mokykla";"PUG 2";8957131694;Taip;15;0;0;15
22861;"Vilniaus Karaliaus Mindaugo pagrindinė mokykla";"PUG 2";1146561649;Taip;5;2;1;8
22862;"Vilniaus Karaliaus Mindaugo pagrindinė mokykla";"PUG 2";1159232792;Taip;5;0;0;5
22863;"Vilniaus Karaliaus Mindaugo pagrindinė mokykla";"PUG 2";1835450318;Taip;0;11;0;11
22864;"Vilniaus Karaliaus Mindaugo pagrindinė mokykla";"PUG 2";6754580614;Taip;0;11;0;11
22865;"Vilniaus Karaliaus Mindaugo pagrindinė mokykla";"PUG 2";2248658930;Taip;14;0;0;14
22866;"Vilniaus Karaliaus Mindaugo pagrindinė mokykla";"PUG 2";2092637040;Taip;10;0;3;13
22867;"Vilniaus Karaliaus Mindaugo pagrindinė mokykla";"PUG 2";5029631107;Taip;0;0;6;6
22868;"Vilniaus Karaliaus Mindaugo pagrindinė mokykla";"PUG 2";6196554287;Taip;0;3;0;3
22869;"Vilniaus Karaliaus Mindaugo pagrindinė mokykla";"PUG 2";4661051023;Taip;11;3;0;14
22870;"Vilniaus Karaliaus Mindaugo pagrindinė mokykla";"PUG 2";1507200600;Taip;5;3;1;9
22871;"Vilniaus Karaliaus Mindaugo pagrindinė mokykla";"PUG 2";7440474403;Taip;0;0;9;9
22872;"Vilniaus Karaliaus Mindaugo pagrindinė mokykla";"PUG 2";8860314164;Taip;0;5;1;6
22873;"Vilniaus Karaliaus Mindaugo pagrindinė mokykla";"PUG 2";4684525618;Taip;10;0;0;10
22874;"Vilniaus Karaliaus Mindaugo pagrindinė mokykla";"PUG 1";8879549409;Taip;0;0;3;3
22875;"Vilniaus Karaliaus Mindaugo pagrindinė mokykla";"PUG 1";3860781857;Taip;0;0;3;3
22876;"Vilniaus Karaliaus Mindaugo pagrindinė mokykla";"PUG 1";24287759126;Taip;0;0;2;2
22877;"Vilniaus Karaliaus Mindaugo pagrindinė mokykla";"PUG 1";1781442182;Taip;0;0;1;1
22878;"Vilniaus Karaliaus Mindaugo pagrindinė mokykla";"PUG 1";6299298199;Taip;0;0;3;3
22879;"Vilniaus Karaliaus Mindaugo pagrindinė mokykla";"PUG 1";35830862363;Taip;0;4;0;4
22880;"Vilniaus Karaliaus Mindaugo pagrindinė mokykla";"PUG 1";1830572633;Taip;0;0;3;3
22881;"Vilniaus Karaliaus Mindaugo pagrindinė mokykla";"PUG 1";4143153535;Taip;2;3;0;5
22882;"Vilniaus Karaliaus Mindaugo pagrindinė mokykla";"PUG 1";9329518124;Taip;0;0;1;1
22883;"Vilniaus Karaliaus Mindaugo pagrindinė mokykla";"PUG 1";1505918280;Taip;0;0;4;4
22884;"Vilniaus Karaliaus Mindaugo pagrindinė mokykla";"PUG 1";1445657342;Taip;0;3;3;6
22885;"Vilniaus Karaliaus Mindaugo pagrindinė mokykla";"PUG 1";9313380552;Taip;1;3;4;8
22886;"Vilniaus Karaliaus Mindaugo pagrindinė mokykla";"PUG 1";7782678159;Taip;0;3;1;4
22887;"Vilniaus Karaliaus Mindaugo pagrindinė mokykla";"PUG 1";14043704729;Taip;0;3;0;3
22888;"Vilniaus Karaliaus Mindaugo pagrindinė mokykla";"PUG 1";7876029445;Taip;0;0;1;1
22889;"Vilniaus Karaliaus Mindaugo pagrindinė mokykla";"PUG 1";4724383814;Taip;0;0;1;1
22890;"Vilniaus Karaliaus Mindaugo pagrindinė mokykla";"PUG 1";1376514473;Taip;0;4;0;4
22891;"Vilniaus Karaliaus Mindaugo pagrindinė mokykla";"PUG 1";7543795007;Taip;0;0;1;1
22892;"Vilniaus Karaliaus Mindaugo pagrindinė mokykla";"PUG 1";9522269582;Taip;0;3;0;3
22893;"Vilniaus Karaliaus Mindaugo pagrindinė mokykla";"PUG 3";23638266708;Taip;11;0;0;11
22894;"Vilniaus Karaliaus Mindaugo pagrindinė mokykla";"PUG 3";1799477959;Taip;0;3;0;3
22895;"Vilniaus Karaliaus Mindaugo pagrindinė mokykla";"PUG 3";3490705425;Taip;0;3;1;4
22896;"Vilniaus Karaliaus Mindaugo pagrindinė mokykla";"PUG 3";7433354196;Ne;0;0;3;3
22897;"Vilniaus Karaliaus Mindaugo pagrindinė mokykla";"PUG 3";2836206893;Taip;2;0;2;4
22898;"Vilniaus Karaliaus Mindaugo pagrindinė mokykla";"PUG 3";38426234048;Taip;5;0;7;12
22899;"Vilniaus Karaliaus Mindaugo pagrindinė mokykla";"PUG 3";1502213914;Taip;4;0;2;6
22900;"Vilniaus Karaliaus Mindaugo pagrindinė mokykla";"PUG 3";1929838733;Taip;0;0;4;4
22901;"Vilniaus Karaliaus Mindaugo pagrindinė mokykla";"PUG 3";3344717003;Taip;2;0;3;5
22902;"Vilniaus Karaliaus Mindaugo pagrindinė mokykla";"PUG 3";9638976786;Taip;0;0;5;5
22903;"Vilniaus Karaliaus Mindaugo pagrindinė mokykla";"PUG 3";4677405885;Taip;0;0;2;2
22904;"Vilniaus Karaliaus Mindaugo pagrindinė mokykla";"PUG 3";6406285034;Taip;0;0;6;6
22905;"Vilniaus Karaliaus Mindaugo pagrindinė mokykla";"PUG 3";7132574496;Taip;3;0;2;5
22906;Ąžuolas;Boružiukų;1551807768;Taip;0;7;0;7
22907;Ąžuolas;Žemuogėlių;6041698323;Taip;6;0;0;6
22908;Ąžuolas;Giliukų;3395238839;Taip;7;0;0;7
22909;"Vilniaus Levo Karsavino vidurinė mokykla";PELEDŽIUKAI;2149830021;Taip;0;3;2;5
22910;"Vilniaus Levo Karsavino vidurinė mokykla";PELEDŽIUKAI;2718046390;Taip;0;3;1;4
22911;"Vilniaus Levo Karsavino vidurinė mokykla";PELEDŽIUKAI;9094287056;Taip;0;3;2;5
22912;"Vilniaus Levo Karsavino vidurinė mokykla";PELEDŽIUKAI;8721423900;Taip;0;3;1;4
22913;"Vilniaus Levo Karsavino vidurinė mokykla";PELEDŽIUKAI;6917007871;Taip;6;3;3;12
22914;"Vilniaus Levo Karsavino vidurinė mokykla";PELEDŽIUKAI;3452236805;Taip;0;18;0;18
22915;"Vilniaus Levo Karsavino vidurinė mokykla";PELEDŽIUKAI;4066969586;Taip;7;3;1;11
22916;"Vilniaus Levo Karsavino vidurinė mokykla";PELEDŽIUKAI;8564433463;Ne;5;3;0;8
22917;"Vilniaus Levo Karsavino vidurinė mokykla";PELEDŽIUKAI;1067737206;Taip;0;8;0;8
22918;"Vilniaus Levo Karsavino vidurinė mokykla";PELEDŽIUKAI;1288690113;Taip;0;10;0;10
22919;"Vilniaus Levo Karsavino vidurinė mokykla";PELEDŽIUKAI;55396452032;Taip;4;3;0;7
22920;"Vilniaus Levo Karsavino vidurinė mokykla";PELEDŽIUKAI;2276463136;Taip;0;3;0;3
22921;"Vilniaus Levo Karsavino vidurinė mokykla";PELEDŽIUKAI;43259107285;Taip;0;4;0;4
22922;"Vilniaus Levo Karsavino vidurinė mokykla";PELEDŽIUKAI;9947263640;Taip;0;3;4;7
22923;"Vilniaus Levo Karsavino vidurinė mokykla";PELEDŽIUKAI;3641595127;Taip;0;3;0;3
22924;"Vilniaus Levo Karsavino vidurinė mokykla";PELEDŽIUKAI;3254847545;Taip;0;18;0;18
22925;"Vilniaus Levo Karsavino vidurinė mokykla";PELEDŽIUKAI;3381954095;Taip;0;8;1;9
22926;"Vilniaus Levo Karsavino vidurinė mokykla";PELEDŽIUKAI;7227603702;Taip;0;3;0;3
22927;"Vilniaus Levo Karsavino vidurinė mokykla";PELEDŽIUKAI;57138305703;Taip;5;3;1;9
22928;"Vilniaus Levo Karsavino vidurinė mokykla";Žiniukai;3333990952;Taip;0;3;0;3
22929;"Vilniaus Levo Karsavino vidurinė mokykla";Žiniukai;5548875714;Taip;0;3;0;3
22930;"Vilniaus Levo Karsavino vidurinė mokykla";Žiniukai;5452659798;Taip;0;3;0;3
22931;"Vilniaus Levo Karsavino vidurinė mokykla";Žiniukai;5803032683;Taip;10;3;0;13
22932;"Vilniaus Levo Karsavino vidurinė mokykla";Žiniukai;2306517891;Taip;0;18;0;18
22933;"Vilniaus Levo Karsavino vidurinė mokykla";Žiniukai;1428614163;Taip;0;3;5;8
22934;"Vilniaus Levo Karsavino vidurinė mokykla";Žiniukai;9801214344;Ne;0;18;0;18
22935;"Vilniaus Levo Karsavino vidurinė mokykla";Žiniukai;8180889070;Taip;0;3;0;3
22936;"Vilniaus Levo Karsavino vidurinė mokykla";Žiniukai;7023565057;Taip;0;3;0;3
22937;"Vilniaus Levo Karsavino vidurinė mokykla";Žiniukai;2157398751;Taip;0;3;1;4
22938;"Vilniaus Levo Karsavino vidurinė mokykla";Žiniukai;7804533930;Taip;0;3;1;4
22939;"Vilniaus Levo Karsavino vidurinė mokykla";Žiniukai;3379725202;Taip;0;3;0;3
22940;"Vilniaus Levo Karsavino vidurinė mokykla";Žiniukai;7298260831;Taip;0;3;1;4
22941;"Vilniaus Levo Karsavino vidurinė mokykla";Žiniukai;4302751308;Taip;3;3;0;6
22942;"Vilniaus Levo Karsavino vidurinė mokykla";Žiniukai;7920182730;Taip;0;3;1;4
22943;"Vilniaus Levo Karsavino vidurinė mokykla";Žiniukai;12377363480;Taip;0;3;1;4
22944;"Vilniaus Levo Karsavino vidurinė mokykla";Žiniukai;8199573104;Taip;4;3;0;7
22945;"Vilniaus Levo Karsavino vidurinė mokykla";Žiniukai;9589810356;Taip;0;3;0;3
22946;"Vilniaus Levo Karsavino vidurinė mokykla";Žiniukai;64214150955;Taip;0;3;0;3
22947;"Vilniaus Levo Karsavino vidurinė mokykla";Žiniukai;6340289012;Ne;0;3;1;4
22948;"Vilniaus Liepkalnio Pagrindinė Mokykla";Bitutės;5597152556;Taip;7;4;2;13
22949;"Vilniaus Liepkalnio Pagrindinė Mokykla";Bitutės;4115995882;Ne;0;4;7;11
22950;"Vilniaus Liepkalnio Pagrindinė Mokykla";Bitutės;6136792125;Taip;0;11;0;11
22951;"Vilniaus Liepkalnio Pagrindinė Mokykla";Bitutės;9293634828;Taip;10;4;1;15
22952;"Vilniaus Liepkalnio Pagrindinė Mokykla";Bitutės;8324581018;Ne;0;4;7;11
22953;"Vilniaus Liepkalnio Pagrindinė Mokykla";Bitutės;1599633295;Taip;0;4;4;8
22954;"Vilniaus Liepkalnio Pagrindinė Mokykla";Bitutės;9589525954;Taip;3;4;1;8
22955;"Vilniaus Liepkalnio Pagrindinė Mokykla";Bitutės;7052487356;Taip;0;4;5;9
22956;"Vilniaus Liepkalnio Pagrindinė Mokykla";Bitutės;2080390421;Ne;13;4;3;20
22957;"Vilniaus Liepkalnio Pagrindinė Mokykla";Bitutės;5323726165;Taip;0;4;0;4
22958;"Vilniaus Liepkalnio Pagrindinė Mokykla";Bitutės;7922755136;Taip;5;4;2;11
22959;"Vilniaus Liepkalnio Pagrindinė Mokykla";Bitutės;1578956182;Taip;0;4;0;4
22960;"Vilniaus Liepkalnio Pagrindinė Mokykla";Bitutės;3721504364;Taip;0;4;3;7
22961;"Vilniaus Liepkalnio Pagrindinė Mokykla";Bitutės;1795366502;Taip;0;4;12;16
22962;"Vilniaus Liepkalnio Pagrindinė Mokykla";Bitutės;9211966929;Taip;0;4;8;12
22963;"Vilniaus Liepkalnio Pagrindinė Mokykla";Bitutės;4112888719;Taip;0;4;1;5
22964;"Vilniaus Liepkalnio Pagrindinė Mokykla";Bitutės;8809471063;Taip;5;4;4;13
22965;"Vilniaus Liepkalnio Pagrindinė Mokykla";Bitutės;5197037585;Taip;3;4;2;9
22966;"Vilniaus Liepkalnio Pagrindinė Mokykla";Bitutės;9771780358;Taip;0;4;8;12
22967;"Vilniaus Liepkalnio Pagrindinė Mokykla";Bitutės;4973569038;Taip;0;4;3;7
22968;"Vilniaus Pranciškaus Skorinos gimnazija";Saulytė;5194059497;Taip;5;7;3;15
22969;"Vilniaus Pranciškaus Skorinos gimnazija";Saulytė;5034268767;Taip;3;6;3;12
22970;"Vilniaus Pranciškaus Skorinos gimnazija";Saulytė;3036582121;Taip;0;7;0;7
22971;"Vilniaus Pranciškaus Skorinos gimnazija";Saulytė;5304082676;Ne;5;8;1;14
22972;"Vilniaus Pranciškaus Skorinos gimnazija";Saulytė;7055894770;Taip;5;7;0;12
22973;"Vilniaus Pranciškaus Skorinos gimnazija";Saulytė;6995285377;Ne;0;9;0;9
22974;"Vilniaus Pranciškaus Skorinos gimnazija";Saulytė;6336168033;Taip;0;5;0;5
22975;"Vilniaus Pranciškaus Skorinos gimnazija";Saulytė;3984446381;Taip;4;9;1;14
22976;"Vilniaus Pranciškaus Skorinos gimnazija";Saulytė;8641919789;Ne;10;7;1;18
22977;"Vilniaus Pranciškaus Skorinos gimnazija";Saulytė;5733610359;Taip;13;6;2;21
22978;"Vilniaus Pranciškaus Skorinos gimnazija";Saulytė;4501408366;Taip;15;5;0;20
22979;"Vilniaus Pranciškaus Skorinos gimnazija";Saulytė;4705514590;Taip;0;8;0;8
22980;"Vilniaus Pranciškaus Skorinos gimnazija";Saulytė;4165354124;Taip;0;7;0;7
22981;"Vilniaus Pranciškaus Skorinos gimnazija";Saulytė;6940231858;Ne;0;9;0;9
22982;"Vilniaus Pranciškaus Skorinos gimnazija";Saulytė;8572069816;Taip;8;5;0;13
22983;"Vilniaus Pranciškaus Skorinos gimnazija";Saulytė;4810459063;Taip;0;5;0;5
22984;"Vilniaus Pranciškaus Skorinos gimnazija";Saulytė;3354419392;Taip;0;28;0;28
22985;"Vilniaus Pranciškaus Skorinos gimnazija";Saulytė;9176198859;Ne;0;5;1;6
22986;"Vilniaus Pranciškaus Skorinos gimnazija";Saulytė;3234612149;Taip;18;7;0;25
22987;"Vilniaus Pranciškaus Skorinos gimnazija";Saulytė;6233673622;Taip;10;7;0;17
22988;"Vilniaus Simono Konarskio mokykla";"1 GR.";1464992631;Taip;10;3;0;13
22989;"Vilniaus Simono Konarskio mokykla";"1 GR.";7375004714;Taip;0;3;0;3
22990;"Vilniaus Simono Konarskio mokykla";"1 GR.";9822287576;Taip;0;3;0;3
22991;"Vilniaus Simono Konarskio mokykla";"1 GR.";7052198958;Taip;5;3;0;8
22992;"Vilniaus Simono Konarskio mokykla";"1 GR.";1498329448;Taip;0;3;0;3
22993;"Vilniaus Simono Konarskio mokykla";"1 GR.";3593323270;Taip;0;3;0;3
22994;"Vilniaus Simono Konarskio mokykla";"1 GR.";4463822099;Ne;0;3;0;3
22995;"Vilniaus Simono Konarskio mokykla";"1 GR.";9079781265;Taip;7;3;0;10
22996;"Vilniaus Simono Konarskio mokykla";"1 GR.";1048630061;Taip;2;3;0;5
22997;"Vilniaus Simono Konarskio mokykla";"1 GR.";4286223155;Taip;0;3;0;3
22998;"Vilniaus Simono Konarskio mokykla";"1 GR.";5073378325;Taip;0;3;0;3
22999;"Vilniaus Simono Konarskio mokykla";"1 GR.";8552079735;Ne;0;3;0;3
23000;"Vilniaus Simono Konarskio mokykla";"1 GR.";9093492513;Ne;0;3;0;3
23001;"Vilniaus Simono Konarskio mokykla";"1 GR.";7701956270;Taip;0;3;0;3
23002;"Vilniaus Trakų Vokės gimnazija";Priešmokyklinė;5299428924;Taip;0;2;0;2
23003;"Vilniaus Trakų Vokės gimnazija";Priešmokyklinė;9386629495;Taip;5;6;0;11
23004;"Vilniaus Trakų Vokės gimnazija";Priešmokyklinė;6209271043;Taip;0;4;5;9
23005;"Vilniaus Trakų Vokės gimnazija";Priešmokyklinė;3406479364;Taip;0;3;2;5
23006;"Vilniaus Trakų Vokės gimnazija";Priešmokyklinė;1461337199;Taip;0;0;1;1
23007;"Vilniaus Trakų Vokės gimnazija";Priešmokyklinė;5526830430;Taip;3;1;0;4
23008;"Vilniaus Trakų Vokės gimnazija";Priešmokyklinė;4849992906;Taip;9;5;0;14
23009;"Vilniaus Trakų Vokės gimnazija";Priešmokyklinė;3098390989;Taip;1;4;0;5
23010;"Vilniaus Trakų Vokės gimnazija";Priešmokyklinė;50553766116;Taip;0;3;0;3
23011;"Vilniaus Trakų Vokės gimnazija";Priešmokyklinė;2672165297;Taip;5;3;0;8
23012;"Vilniaus Trakų Vokės gimnazija";Priešmokyklinė;2955411131;Taip;0;2;1;3
23013;"Vilniaus Trakų Vokės gimnazija";Priešmokyklinė;4846130117;Taip;0;3;2;5
23014;"Vilniaus Trakų Vokės gimnazija";Priešmokyklinė;1433982328;Taip;0;5;0;5
23015;"Vilniaus Trakų Vokės gimnazija";Priešmokyklinė;8658085249;Taip;0;6;0;6
23016;"Vilniaus Trakų Vokės gimnazija";Priešmokyklinė;39255784762;Taip;0;3;1;4
23017;"Vilniaus Trakų Vokės gimnazija";Priešmokyklinė;4599632235;Taip;0;4;0;4
23018;"Vilniaus Trakų Vokės gimnazija";Priešmokyklinė;2839396687;Taip;0;4;0;4
23019;"Vilniaus Trakų Vokės gimnazija";Priešmokyklinė;8857529726;Taip;0;3;0;3
23020;"Vilniaus Trakų Vokės gimnazija";Priešmokyklinė;7566567901;Taip;5;3;4;12
23021;"Vilniaus Trakų Vokės gimnazija";"Priešmokyklinė 2";4362066941;Taip;0;13;0;13
23022;"Vilniaus Trakų Vokės gimnazija";"Priešmokyklinė 2";1074730366;Ne;0;5;3;8
23023;"Vilniaus Trakų Vokės gimnazija";"Priešmokyklinė 2";6593654477;Taip;7;4;2;13
23024;"Vilniaus Trakų Vokės gimnazija";"Priešmokyklinė 2";9582511053;Taip;0;14;0;14
23025;"Vilniaus Trakų Vokės gimnazija";"Priešmokyklinė 2";3775081619;Taip;0;4;0;4
23026;"Vilniaus Trakų Vokės gimnazija";"Priešmokyklinė 2";4615315809;Taip;5;6;4;15
23027;"Vilniaus Trakų Vokės gimnazija";"Priešmokyklinė 2";25106446270;Taip;0;7;0;7
23028;"Vilniaus Trakų Vokės gimnazija";"Priešmokyklinė 2";18963190527;Taip;0;4;0;4
23029;"Vilniaus Trakų Vokės gimnazija";"Priešmokyklinė 2";4914675622;Taip;0;5;1;6
23030;"Vilniaus Trakų Vokės gimnazija";"Priešmokyklinė 2";5251929660;Taip;0;8;0;8
23031;"Vilniaus Trakų Vokės gimnazija";"Priešmokyklinė 2";3690179876;Taip;5;4;4;13
23032;"Vilniaus Trakų Vokės gimnazija";"Priešmokyklinė 2";8218370873;Ne;0;7;2;9
23033;"Vilniaus Trakų Vokės gimnazija";"Priešmokyklinė 2";6615724604;Taip;0;11;0;11
23034;"Vilniaus Trakų Vokės gimnazija";"Priešmokyklinė 2";4720226790;Taip;0;4;4;8
23035;"Vilniaus Trakų Vokės gimnazija";"Priešmokyklinė 2";1057189769;Taip;0;4;9;13
23036;"Vilniaus Trakų Vokės gimnazija";"Priešmokyklinė 2";2149804129;Taip;0;5;0;5
23037;"Vilniaus Trakų Vokės gimnazija";"Priešmokyklinė 2";1590598232;Taip;0;4;11;15
23038;"Vilniaus Trakų Vokės gimnazija";"Priešmokyklinė 2";8168960897;Taip;3;12;0;15
23039;"Vilniaus Trakų Vokės gimnazija";"Priešmokyklinė 2";9960520926;Ne;0;4;0;4
23040;"Vilniaus Trakų Vokės gimnazija";"Priešmokyklinė 2";9039274775;Taip;5;4;0;9
23041;"Vilniaus Trakų Vokės gimnazija";"Priešmokyklinė 3";7547303829;Taip;10;4;5;19
23042;"Vilniaus Trakų Vokės gimnazija";"Priešmokyklinė 3";2301758912;Taip;0;7;1;8
23043;"Vilniaus Trakų Vokės gimnazija";"Priešmokyklinė 3";7792654474;Taip;8;4;2;14
23044;"Vilniaus Trakų Vokės gimnazija";"Priešmokyklinė 3";3449317958;Taip;7;0;2;9
23045;"Vilniaus Trakų Vokės gimnazija";"Priešmokyklinė 3";9268558715;Taip;0;4;6;10
23046;"Vilniaus Trakų Vokės gimnazija";"Priešmokyklinė 3";9668538340;Taip;0;5;6;11
23047;"Vilniaus Trakų Vokės gimnazija";"Priešmokyklinė 3";2469486746;Taip;0;4;4;8
23048;"Vilniaus Trakų Vokės gimnazija";"Priešmokyklinė 3";95320712086;Taip;0;0;1;1
23049;"Vilniaus Trakų Vokės gimnazija";"Priešmokyklinė 3";1053286928;Taip;0;6;6;12
23050;"Vilniaus Trakų Vokės gimnazija";"Priešmokyklinė 3";5115117246;Ne;0;4;24;28
23051;"Vilniaus Trakų Vokės gimnazija";"Priešmokyklinė 3";6765094662;Taip;0;3;1;4
23052;"Vilniaus Trakų Vokės gimnazija";"Priešmokyklinė 3";6835150864;Taip;0;5;4;9
23053;"Vilniaus Trakų Vokės gimnazija";"Priešmokyklinė 3";1940148622;Taip;3;4;7;14
23054;"Vilniaus Trakų Vokės gimnazija";"Priešmokyklinė 3";8929514493;Taip;0;2;0;2
23055;"Vilniaus Trakų Vokės gimnazija";"Priešmokyklinė 3";9051697544;Ne;9;0;1;10
23056;"Vilniaus Trakų Vokės gimnazija";"Priešmokyklinė 3";1398572100;Taip;3;5;3;11
23057;"Vilniaus Trakų Vokės gimnazija";"Priešmokyklinė 3";2730385281;Taip;4;0;1;5
23058;"Vilniaus Trakų Vokės gimnazija";"Priešmokyklinė 3";2906094725;Ne;0;0;8;8
23059;"Vilniaus Trakų Vokės gimnazija";"Priešmokyklinė 3";9819489467;Ne;0;0;8;8
23060;"Vilniaus Salininkų gimnazija";"Priešmokyklinė A";22167560908;Taip;0;3;0;3
23061;"Vilniaus Salininkų gimnazija";"Priešmokyklinė A";10335028421;Taip;0;8;0;8
23062;"Vilniaus Salininkų gimnazija";"Priešmokyklinė A";8683841956;Taip;0;3;0;3
23063;"Vilniaus Salininkų gimnazija";"Priešmokyklinė A";1180792335;Taip;0;3;0;3
23064;"Vilniaus Salininkų gimnazija";"Priešmokyklinė A";5063792784;Taip;0;3;0;3
23065;"Vilniaus Salininkų gimnazija";"Priešmokyklinė A";1704033440;Taip;5;3;0;8
23066;"Vilniaus Salininkų gimnazija";"Priešmokyklinė A";46867660097;Taip;0;4;0;4
23067;"Vilniaus Salininkų gimnazija";"Priešmokyklinė A";3692008687;Taip;0;8;0;8
23068;"Vilniaus Salininkų gimnazija";"Priešmokyklinė A";2292919406;Taip;10;4;0;14
23069;"Vilniaus Salininkų gimnazija";"Priešmokyklinė A";35611320012;Taip;0;3;0;3
23070;"Vilniaus Salininkų gimnazija";"Priešmokyklinė A";4269202761;Taip;5;5;0;10
23071;"Vilniaus Salininkų gimnazija";"Priešmokyklinė A";9375550172;Taip;1;3;0;4
23072;"Vilniaus Salininkų gimnazija";"Priešmokyklinė A";7160091629;Taip;5;4;0;9
23073;"Vilniaus Salininkų gimnazija";"Priešmokyklinė A";41023354439;Taip;0;3;0;3
23074;"Vilniaus Salininkų gimnazija";"Priešmokyklinė A";1642658060;Taip;0;4;0;4
23075;"Vilniaus Salininkų gimnazija";"Priešmokyklinė A";3848448401;Taip;0;3;0;3
23076;"Vilniaus Salininkų gimnazija";"Priešmokyklinė A";3737786832;Taip;0;4;0;4
23077;"Vilniaus Salininkų gimnazija";"Priešmokyklinė A";8025611655;Taip;0;3;0;3
23078;"Vilniaus Salininkų gimnazija";"Priešmokyklinė A";4939261324;Taip;0;4;0;4
23079;"Vilniaus Salininkų gimnazija";"Priešmokyklinė A";6738902611;Taip;0;18;0;18
23080;"Vilniaus Salininkų gimnazija";"Priešmokyklinė A";2989580886;Taip;0;3;0;3
23081;"Vilniaus Salininkų gimnazija";"Priešmokyklinė A";3661928980;Taip;0;4;0;4
23082;"Vilniaus Salininkų gimnazija";"PRIEŠMOKYKLINĖ B";7378039370;Taip;3;3;0;6
23083;"Vilniaus Salininkų gimnazija";"PRIEŠMOKYKLINĖ B";98941037508;Taip;0;18;0;18
23084;"Vilniaus Salininkų gimnazija";"PRIEŠMOKYKLINĖ B";1355032282;Taip;0;3;0;3
23085;"Vilniaus Salininkų gimnazija";"PRIEŠMOKYKLINĖ B";8018093186;Ne;0;3;0;3
23086;"Vilniaus Salininkų gimnazija";"PRIEŠMOKYKLINĖ B";9216372353;Taip;4;3;0;7
23087;"Vilniaus Salininkų gimnazija";"PRIEŠMOKYKLINĖ B";3015424614;Taip;2;3;0;5
23088;"Vilniaus Salininkų gimnazija";"PRIEŠMOKYKLINĖ B";8488127476;Taip;5;3;0;8
23089;"Vilniaus Salininkų gimnazija";"PRIEŠMOKYKLINĖ B";8410624264;Taip;9;4;0;13
23090;"Vilniaus Salininkų gimnazija";"PRIEŠMOKYKLINĖ B";1544346282;Taip;0;3;0;3
23091;"Vilniaus Salininkų gimnazija";"PRIEŠMOKYKLINĖ B";2066091911;Taip;5;3;0;8
23092;"Vilniaus Salininkų gimnazija";"PRIEŠMOKYKLINĖ B";1723241116;Taip;11;3;0;14
23093;"Vilniaus Salininkų gimnazija";"PRIEŠMOKYKLINĖ B";30123603107;Taip;1;3;0;4
23094;"Vilniaus Salininkų gimnazija";"PRIEŠMOKYKLINĖ B";8659656902;Taip;0;3;0;3
23095;"Vilniaus Salininkų gimnazija";"PRIEŠMOKYKLINĖ B";8288199783;Taip;0;3;0;3
23096;"Vilniaus Salininkų gimnazija";"PRIEŠMOKYKLINĖ B";1065549119;Taip;5;3;0;8
23097;"Vilniaus Salininkų gimnazija";"PRIEŠMOKYKLINĖ B";1460694577;Taip;0;3;0;3
23098;"Vilniaus Salininkų gimnazija";"PRIEŠMOKYKLINĖ B";2786775879;Taip;1;3;0;4
23099;"Vilniaus Salininkų gimnazija";"PRIEŠMOKYKLINĖ B";5689344488;Taip;1;3;0;4
23100;"Vilniaus Salininkų gimnazija";"PRIEŠMOKYKLINĖ B";9513785510;Taip;3;3;0;6
23101;"Vilniaus Salininkų gimnazija";"PRIEŠMOKYKLINĖ B";91859774311;Taip;3;3;0;6
23102;"Vilniaus Salininkų gimnazija";"PRIEŠMOKYKLINĖ B";9026612929;Taip;2;3;0;5
23103;"Vilniaus Salininkų gimnazija";"PRIEŠMOKYKLINĖ B";4271670413;Taip;1;3;0;4
23104;"Vilniaus „Spindulio“ progimnazija";PM2;3093606855;Taip;5;3;0;8
23105;"Vilniaus „Spindulio“ progimnazija";PM2;6304295422;Taip;0;3;1;4
23106;"Vilniaus „Spindulio“ progimnazija";PM2;5078945984;Taip;0;4;0;4
23107;"Vilniaus „Spindulio“ progimnazija";PM2;9099945815;Taip;8;4;0;12
23108;"Vilniaus „Spindulio“ progimnazija";PM2;75538036055;Taip;0;3;0;3
23109;"Vilniaus „Spindulio“ progimnazija";PM2;15583558585;Taip;10;3;0;13
23110;"Vilniaus „Spindulio“ progimnazija";PM2;2427349194;Ne;0;4;0;4
23111;"Vilniaus „Spindulio“ progimnazija";PM2;7445566160;Taip;0;4;0;4
23112;"Vilniaus „Spindulio“ progimnazija";PM2;6561536457;Taip;0;3;0;3
23113;"Vilniaus „Spindulio“ progimnazija";PM2;8023936861;Taip;1;3;0;4
23114;"Vilniaus „Spindulio“ progimnazija";PM2;7277680544;Taip;1;4;3;8
23115;"Vilniaus „Spindulio“ progimnazija";PM2;6479094819;Taip;0;4;0;4
23116;"Vilniaus „Spindulio“ progimnazija";PM2;6016791282;Taip;0;3;0;3
23117;"Vilniaus „Spindulio“ progimnazija";PM2;2356833740;Taip;7;0;0;7
23118;"Vilniaus „Spindulio“ progimnazija";PM2;1338287524;Taip;0;3;0;3
23119;"Vilniaus „Spindulio“ progimnazija";PM2;9516852657;Taip;0;3;0;3
23120;"Vilniaus „Spindulio“ progimnazija";PM2;1364873935;Taip;0;3;3;6
23121;"Vilniaus „Spindulio“ progimnazija";PM2;7528505426;Taip;5;3;0;8
23122;"Vilniaus „Spindulio“ progimnazija";PM2;7120717682;Taip;5;3;0;8
23123;"Vilniaus „Spindulio“ progimnazija";PM2;1183272346;Taip;0;3;1;4
23124;"Vilniaus „Spindulio“ progimnazija";PM2;6201567680;Taip;0;3;2;5
23125;"Vilniaus „Spindulio“ progimnazija";PM2;8012626513;Taip;0;3;0;3
23126;"Vilniaus „Spindulio“ progimnazija";PM2;52216192635;Taip;10;3;0;13
23127;"Vilniaus „Spindulio“ progimnazija";PM2;4791752179;Taip;0;4;1;5
23128;"Vilniaus „Spindulio“ progimnazija";PM1;1948438336;Taip;6;3;0;9
23129;"Vilniaus „Spindulio“ progimnazija";PM1;43859975789;Taip;5;3;2;10
23130;"Vilniaus „Spindulio“ progimnazija";PM1;4701887030;Taip;10;5;0;15
23131;"Vilniaus „Spindulio“ progimnazija";PM1;60320557464;Taip;0;3;0;3
23132;"Vilniaus „Spindulio“ progimnazija";PM1;2531571615;Taip;0;7;2;9
23133;"Vilniaus „Spindulio“ progimnazija";PM1;1421633312;Taip;0;3;0;3
23134;"Vilniaus „Spindulio“ progimnazija";PM1;3678131609;Taip;0;3;0;3
23135;"Vilniaus „Spindulio“ progimnazija";PM1;1194444282;Taip;0;3;0;3
23136;"Vilniaus „Spindulio“ progimnazija";PM1;56885383122;Taip;0;5;0;5
23137;"Vilniaus „Spindulio“ progimnazija";PM1;1338476746;Taip;0;10;0;10
23138;"Vilniaus „Spindulio“ progimnazija";PM1;1251961268;Taip;6;3;0;9
23139;"Vilniaus „Spindulio“ progimnazija";PM1;2402204674;Taip;5;5;1;11
23140;"Vilniaus „Spindulio“ progimnazija";PM1;6700068320;Taip;5;5;0;10
23141;"Vilniaus „Spindulio“ progimnazija";PM1;9347513042;Taip;0;4;0;4
23142;"Vilniaus „Spindulio“ progimnazija";PM1;1153333591;Taip;0;3;0;3
23143;"Vilniaus „Spindulio“ progimnazija";PM1;1650166115;Taip;0;4;0;4
23144;"Vilniaus „Spindulio“ progimnazija";PM1;9573336239;Taip;5;3;0;8
23145;"Vilniaus „Spindulio“ progimnazija";PM1;4239224971;Taip;5;3;1;9
23146;"Vilniaus „Spindulio“ progimnazija";PM1;9502789660;Taip;4;3;0;7
23147;"Vilniaus „Spindulio“ progimnazija";PM1;1454101129;Taip;0;5;0;5
23148;"Vilniaus „Spindulio“ progimnazija";PM1;1325054642;Taip;0;6;0;6
23149;"Vilniaus „Spindulio“ progimnazija";PM1;1160537966;Taip;5;5;0;10
23150;"Vilniaus „Spindulio“ progimnazija";PM1;91028452879;Taip;0;3;0;3
23151;"Vilniaus „Spindulio“ progimnazija";PM1;1789047913;Taip;0;4;0;4
23152;"Vilniaus Vladislavo Sirokomlės gimnazija";Nykštukai;1797237248;Taip;0;6;0;6
23153;"Vilniaus Vladislavo Sirokomlės gimnazija";Nykštukai;6031408197;Taip;5;6;6;17
23154;"Vilniaus Vladislavo Sirokomlės gimnazija";Nykštukai;1947403400;Taip;0;7;0;7
23155;"Vilniaus Vladislavo Sirokomlės gimnazija";Nykštukai;1499061139;Taip;0;28;0;28
23156;"Vilniaus Vladislavo Sirokomlės gimnazija";Nykštukai;2219712757;Taip;8;7;0;15
23157;"Vilniaus Vladislavo Sirokomlės gimnazija";Nykštukai;5544613599;Taip;0;8;0;8
23158;"Vilniaus Vladislavo Sirokomlės gimnazija";Nykštukai;25415760747;Taip;0;7;0;7
23159;"Vilniaus Vladislavo Sirokomlės gimnazija";Nykštukai;17201639406;Taip;0;16;0;16
23160;"Vilniaus Vladislavo Sirokomlės gimnazija";Nykštukai;8302624354;Taip;5;6;0;11
23161;"Vilniaus Vladislavo Sirokomlės gimnazija";Nykštukai;1492328724;Taip;2;6;0;8
23162;"Vilniaus Vladislavo Sirokomlės gimnazija";Nykštukai;4436165764;Taip;7;6;0;13
23163;"Vilniaus Vladislavo Sirokomlės gimnazija";Nykštukai;1837566431;Ne;0;7;0;7
23164;"Vilniaus Vladislavo Sirokomlės gimnazija";Nykštukai;8016643568;Taip;0;6;0;6
23165;"Vilniaus Vladislavo Sirokomlės gimnazija";Nykštukai;4534828670;Taip;0;28;0;28
23166;"Vilniaus Vladislavo Sirokomlės gimnazija";Nykštukai;4069044269;Taip;0;6;0;6
23167;"Vilniaus Vladislavo Sirokomlės gimnazija";Nykštukai;9391697537;Taip;9;7;3;19
23168;"Vilniaus Vladislavo Sirokomlės gimnazija";Nykštukai;5422289286;Taip;0;7;1;8
23169;"Vilniaus Vladislavo Sirokomlės gimnazija";Nykštukai;5625943720;Taip;4;6;2;12
23170;"Vilniaus Vladislavo Sirokomlės gimnazija";Nykštukai;2946297529;Taip;0;6;0;6
23171;"Vilniaus Vladislavo Sirokomlės gimnazija";Smurfai;5844437769;Taip;8;7;0;15
23172;"Vilniaus Vladislavo Sirokomlės gimnazija";Smurfai;9751494612;Taip;4;10;0;14
23173;"Vilniaus Vladislavo Sirokomlės gimnazija";Smurfai;4727265555;Taip;0;12;0;12
23174;"Vilniaus Vladislavo Sirokomlės gimnazija";Smurfai;7071043164;Taip;0;6;0;6
23175;"Vilniaus Vladislavo Sirokomlės gimnazija";Smurfai;1493604303;Taip;0;8;0;8
23176;"Vilniaus Vladislavo Sirokomlės gimnazija";Smurfai;4830374546;Taip;1;11;0;12
23177;"Vilniaus Vladislavo Sirokomlės gimnazija";Smurfai;4506651162;Taip;0;11;0;11
23178;"Vilniaus Vladislavo Sirokomlės gimnazija";Smurfai;1817869518;Taip;5;8;0;13
23179;"Vilniaus Vladislavo Sirokomlės gimnazija";Smurfai;1512245903;Taip;0;7;0;7
23180;"Vilniaus Vladislavo Sirokomlės gimnazija";Smurfai;7904983228;Ne;0;8;0;8
23181;"Vilniaus Vladislavo Sirokomlės gimnazija";Smurfai;1570206034;Ne;4;8;0;12
23182;"Vilniaus Vladislavo Sirokomlės gimnazija";Smurfai;1820583792;Taip;8;8;0;16
23183;"Vilniaus Vladislavo Sirokomlės gimnazija";Smurfai;2386927970;Taip;6;7;0;13
23184;"Vilniaus Vladislavo Sirokomlės gimnazija";Smurfai;92356998180;Taip;6;9;0;15
23185;"Vilniaus Vladislavo Sirokomlės gimnazija";Smurfai;4990982790;Taip;0;7;0;7
23186;"Vilniaus Vladislavo Sirokomlės gimnazija";Smurfai;3795927209;Taip;1;8;0;9
23187;"Vilniaus Vladislavo Sirokomlės gimnazija";Smurfai;3880578523;Taip;0;9;0;9
23188;"Vilniaus Vladislavo Sirokomlės gimnazija";Smurfai;9868386182;Taip;0;7;0;7
23189;"Vilniaus Vladislavo Sirokomlės gimnazija";Smurfai;1090204906;Taip;9;7;0;16
23190;"Vilniaus „Pelėdos” pradinė mokykla";Bitutės;3131930907;Taip;4;2;0;6
23191;"Vilniaus „Pelėdos” pradinė mokykla";Bitutės;2023718424;Taip;0;2;1;3
23192;"Vilniaus „Pelėdos” pradinė mokykla";Bitutės;13170636069;Taip;0;2;1;3
23193;"Vilniaus „Pelėdos” pradinė mokykla";Bitutės;1627717901;Taip;0;2;0;2
23194;"Vilniaus „Pelėdos” pradinė mokykla";Bitutės;49343952061;Taip;0;2;1;3
23195;"Vilniaus „Pelėdos” pradinė mokykla";Bitutės;8281005516;Taip;4;0;0;4
23196;"Vilniaus „Pelėdos” pradinė mokykla";Bitutės;7678062264;Taip;10;2;0;12
23197;"Vilniaus „Pelėdos” pradinė mokykla";Bitutės;20602164053;Taip;1;2;0;3
23198;"Vilniaus „Pelėdos” pradinė mokykla";Bitutės;5282345380;Taip;0;1;0;1
23199;"Vilniaus „Pelėdos” pradinė mokykla";Bitutės;4427123314;Taip;0;2;0;2
23200;"Vilniaus „Pelėdos” pradinė mokykla";Bitutės;5610993611;Taip;2;2;0;4
23201;"Vilniaus „Pelėdos” pradinė mokykla";Bitutės;1121936989;Taip;0;2;0;2
23202;"Vilniaus „Pelėdos” pradinė mokykla";Bitutės;4268531240;Taip;0;2;0;2
23203;"Vilniaus „Pelėdos” pradinė mokykla";Bitutės;3312575449;Taip;2;2;0;4
23204;"Vilniaus „Pelėdos” pradinė mokykla";Bitutės;7907026349;Taip;0;1;0;1
23205;"Vilniaus „Pelėdos” pradinė mokykla";Bitutės;9343761295;Taip;5;2;0;7
23206;"Vilniaus „Pelėdos” pradinė mokykla";Bitutės;7006338378;Taip;1;2;0;3
23207;"Vilniaus „Pelėdos” pradinė mokykla";Bitutės;3030820917;Taip;7;2;0;9
23208;"Vilniaus „Pelėdos” pradinė mokykla";Bitutės;3768735503;Taip;2;1;0;3
23209;"Vilniaus „Pelėdos” pradinė mokykla";Bitutės;6597383913;Taip;0;7;0;7
23210;"Vilniaus „Pelėdos” pradinė mokykla";Bitutės;7972395014;Taip;2;2;0;4
23211;"Vilniaus „Pelėdos” pradinė mokykla";Boružėlės;3284613284;Taip;0;3;0;3
23212;"Vilniaus „Pelėdos” pradinė mokykla";Boružėlės;1032549174;Taip;0;3;0;3
23213;"Vilniaus „Pelėdos” pradinė mokykla";Boružėlės;1314392095;Ne;5;3;0;8
23214;"Vilniaus „Pelėdos” pradinė mokykla";Boružėlės;1398976932;Taip;0;3;0;3
23215;"Vilniaus „Pelėdos” pradinė mokykla";Boružėlės;1249227477;Taip;0;3;5;8
23216;"Vilniaus „Pelėdos” pradinė mokykla";Boružėlės;5169736542;Taip;0;2;0;2
23217;"Vilniaus „Pelėdos” pradinė mokykla";Boružėlės;1830060403;Taip;0;3;0;3
23218;"Vilniaus „Pelėdos” pradinė mokykla";Boružėlės;4347647695;Taip;0;3;0;3
23219;"Vilniaus „Pelėdos” pradinė mokykla";Boružėlės;9823188609;Taip;0;3;0;3
23220;"Vilniaus „Pelėdos” pradinė mokykla";Boružėlės;1153781469;Taip;0;3;3;6
23221;"Vilniaus „Pelėdos” pradinė mokykla";Boružėlės;93600065957;Taip;0;3;0;3
23222;"Vilniaus „Pelėdos” pradinė mokykla";Boružėlės;3970413055;Taip;0;3;0;3
23223;"Vilniaus „Pelėdos” pradinė mokykla";Boružėlės;9279913053;Ne;0;3;0;3
23224;"Vilniaus „Pelėdos” pradinė mokykla";Boružėlės;1616324236;Taip;0;3;0;3
23225;"Vilniaus „Pelėdos” pradinė mokykla";Boružėlės;1704933971;Taip;0;3;0;3
23226;"Vilniaus „Pelėdos” pradinė mokykla";Boružėlės;8370864547;Taip;0;3;0;3
23227;"Vilniaus „Pelėdos” pradinė mokykla";Boružėlės;3790209561;Taip;0;3;0;3
23228;"Vilniaus „Pelėdos” pradinė mokykla";Boružėlės;6623852620;Ne;0;3;0;3
23229;"Vilniaus „Pelėdos” pradinė mokykla";Boružėlės;3118698712;Taip;9;3;0;12
23230;"Vilniaus „Pelėdos” pradinė mokykla";Boružėlės;5140876051;Ne;0;8;0;8
23231;"Vilniaus „Pelėdos” pradinė mokykla";Boružėlės;8086378912;Taip;0;1;0;1
23232;"Vilniaus „Pelėdos” pradinė mokykla";1a;1206482166;Taip;1;0;0;1
23233;"Vilniaus „Pelėdos” pradinė mokykla";1c;1585412975;Taip;5;0;0;5
23234;"Vilniaus Joachimo Lelevelio inžinerijos mokykla";0A;57362664278;Taip;0;3;0;3
23235;"Vilniaus Joachimo Lelevelio inžinerijos mokykla";0A;1694423628;Taip;0;4;0;4
23236;"Vilniaus Joachimo Lelevelio inžinerijos mokykla";0A;19420482998;Taip;0;4;0;4
23237;"Vilniaus Joachimo Lelevelio inžinerijos mokykla";0A;1546251543;Taip;0;18;0;18
23238;"Vilniaus Joachimo Lelevelio inžinerijos mokykla";0A;9130637883;Taip;0;6;0;6
23239;"Vilniaus Joachimo Lelevelio inžinerijos mokykla";0A;6217540064;Taip;0;3;0;3
23240;"Vilniaus Joachimo Lelevelio inžinerijos mokykla";0A;1954888655;Taip;0;3;2;5
23241;"Vilniaus Joachimo Lelevelio inžinerijos mokykla";0A;7776071299;Taip;0;3;0;3
23242;"Vilniaus Joachimo Lelevelio inžinerijos mokykla";0A;9215070593;Taip;0;3;1;4
23243;"Vilniaus Joachimo Lelevelio inžinerijos mokykla";0A;3039980710;Taip;0;6;0;6
23244;"Vilniaus Joachimo Lelevelio inžinerijos mokykla";0A;1826015013;Taip;5;3;0;8
23245;"Vilniaus Joachimo Lelevelio inžinerijos mokykla";0A;5630659056;Taip;0;5;0;5
23246;"Vilniaus Joachimo Lelevelio inžinerijos mokykla";0A;9171690612;Taip;0;5;1;6
23247;"Vilniaus Joachimo Lelevelio inžinerijos mokykla";0A;3271832822;Taip;0;3;0;3
23248;"Vilniaus Joachimo Lelevelio inžinerijos mokykla";0A;2797443202;Taip;0;3;0;3
23249;"Vilniaus Joachimo Lelevelio inžinerijos mokykla";0B;6404064049;Taip;2;4;0;6
23250;"Vilniaus Joachimo Lelevelio inžinerijos mokykla";0B;2324578741;Taip;2;4;0;6
23251;"Vilniaus Joachimo Lelevelio inžinerijos mokykla";0B;6132569107;Taip;1;4;0;5
23252;"Vilniaus Joachimo Lelevelio inžinerijos mokykla";0B;64247830728;Taip;0;23;0;23
23253;"Vilniaus Joachimo Lelevelio inžinerijos mokykla";0B;2601103834;Taip;0;18;0;18
23254;"Vilniaus Joachimo Lelevelio inžinerijos mokykla";0B;65960895249;Taip;0;6;0;6
23255;"Vilniaus Joachimo Lelevelio inžinerijos mokykla";0B;5722934228;Taip;0;7;0;7
23256;"Vilniaus Joachimo Lelevelio inžinerijos mokykla";0B;1385352925;Taip;0;6;0;6
23257;"Vilniaus Joachimo Lelevelio inžinerijos mokykla";0B;4209118353;Taip;0;5;0;5
23258;"Vilniaus Joachimo Lelevelio inžinerijos mokykla";0B;6883982889;Taip;11;4;0;15
23259;"Vilniaus Joachimo Lelevelio inžinerijos mokykla";0B;9595277597;Taip;0;5;0;5
23260;"Vilniaus Joachimo Lelevelio inžinerijos mokykla";0B;2842587194;Taip;0;6;0;6
23261;"Vilniaus Joachimo Lelevelio inžinerijos mokykla";0B;8042807487;Taip;2;6;0;8
23262;"Vilniaus Joachimo Lelevelio inžinerijos mokykla";0B;6501930436;Taip;2;4;0;6
23263;"Vilniaus Joachimo Lelevelio inžinerijos mokykla";0B;71081903240;Taip;0;5;0;5
23264;"Vilniaus Juzefo Ignacijaus Kraševskio gimnazija";Priešmokyklinė;2201538495;Taip;0;3;1;4
23265;"Vilniaus Juzefo Ignacijaus Kraševskio gimnazija";Priešmokyklinė;9114472645;Ne;5;7;1;13
23266;"Vilniaus Juzefo Ignacijaus Kraševskio gimnazija";Priešmokyklinė;5261769707;Taip;0;3;0;3
23267;"Vilniaus Juzefo Ignacijaus Kraševskio gimnazija";Priešmokyklinė;5255617339;Ne;5;3;4;12
23268;"Vilniaus Juzefo Ignacijaus Kraševskio gimnazija";Priešmokyklinė;1600495468;Taip;0;8;0;8
23269;"Vilniaus Juzefo Ignacijaus Kraševskio gimnazija";Priešmokyklinė;3733665122;Taip;3;9;2;14
23270;"Vilniaus Juzefo Ignacijaus Kraševskio gimnazija";Priešmokyklinė;2168987649;Taip;0;3;0;3
23271;"Vilniaus Juzefo Ignacijaus Kraševskio gimnazija";Priešmokyklinė;4499924331;Taip;4;3;0;7
23272;"Vilniaus Juzefo Ignacijaus Kraševskio gimnazija";Priešmokyklinė;6048337545;Taip;0;3;0;3
23273;"Vilniaus Juzefo Ignacijaus Kraševskio gimnazija";Priešmokyklinė;9948555227;Taip;7;3;2;12
23274;"Vilniaus Juzefo Ignacijaus Kraševskio gimnazija";Priešmokyklinė;7993975989;Taip;0;7;0;7
23275;"Vilniaus Juzefo Ignacijaus Kraševskio gimnazija";Priešmokyklinė;2684151591;Taip;5;5;0;10
23276;"Vilniaus Juzefo Ignacijaus Kraševskio gimnazija";Priešmokyklinė;7670166244;Taip;3;3;0;6
23277;"Vilniaus Juzefo Ignacijaus Kraševskio gimnazija";Priešmokyklinė;4864834075;Taip;0;7;0;7
23278;"Vilniaus Juzefo Ignacijaus Kraševskio gimnazija";Priešmokyklinė;1837140329;Ne;2;3;1;6
23279;"Vilniaus Juzefo Ignacijaus Kraševskio gimnazija";Priešmokyklinė;1460429651;Taip;0;4;0;4
23280;"Vilniaus Juzefo Ignacijaus Kraševskio gimnazija";Priešmokyklinė;9501262918;Taip;0;3;5;8
23281;"Vilniaus Juzefo Ignacijaus Kraševskio gimnazija";Priešmokyklinė;9333766622;Ne;0;9;2;11
23282;"Vilniaus Juzefo Ignacijaus Kraševskio gimnazija";Priešmokyklinė;3507672150;Taip;6;5;0;11
23283;"Vilniaus Juzefo Ignacijaus Kraševskio gimnazija";Priešmokyklinė;7305350540;Taip;0;7;0;7
23284;"Vilniaus Juzefo Ignacijaus Kraševskio gimnazija";Priešmokyklinė;3698808100;Taip;0;5;0;5
23285;"Vilniaus Juzefo Ignacijaus Kraševskio gimnazija";Priešmokyklinė;9754373141;Taip;5;3;4;12
23286;"Vilniaus Jono Pauliaus II progimnazija";Nykštukai;2055530718;Taip;5;3;1;9
23287;"Vilniaus Jono Pauliaus II progimnazija";Nykštukai;7140223126;Taip;0;3;4;7
23288;"Vilniaus Jono Pauliaus II progimnazija";Nykštukai;48694326383;Taip;0;4;0;4
23289;"Vilniaus Jono Pauliaus II progimnazija";Nykštukai;4831426440;Taip;0;3;3;6
23290;"Vilniaus Jono Pauliaus II progimnazija";Nykštukai;3762141936;Taip;0;3;0;3
23291;"Vilniaus Jono Pauliaus II progimnazija";Nykštukai;8703046661;Taip;0;5;0;5
23292;"Vilniaus Jono Pauliaus II progimnazija";Nykštukai;6724813553;Taip;0;7;0;7
23293;"Vilniaus Jono Pauliaus II progimnazija";Nykštukai;51629266891;Taip;4;3;1;8
23294;"Vilniaus Jono Pauliaus II progimnazija";Nykštukai;7268811782;Taip;0;5;0;5
23295;"Vilniaus Jono Pauliaus II progimnazija";Nykštukai;8998452731;Taip;1;3;0;4
23296;"Vilniaus Jono Pauliaus II progimnazija";Nykštukai;4071338645;Taip;0;7;0;7
23297;"Vilniaus Jono Pauliaus II progimnazija";Nykštukai;3637409607;Taip;0;7;0;7
23298;"Vilniaus Jono Pauliaus II progimnazija";Nykštukai;6988819614;Taip;0;3;0;3
23299;"Vilniaus Jono Pauliaus II progimnazija";Nykštukai;9672929606;Taip;0;3;4;7
23300;"Vilniaus Jono Pauliaus II progimnazija";Nykštukai;9457189905;Taip;5;3;1;9
23301;"Vilniaus Jono Pauliaus II progimnazija";Nykštukai;2013905907;Taip;0;7;0;7
23302;"Vilniaus Jono Pauliaus II progimnazija";Nykštukai;2095972347;Taip;0;4;0;4
23303;"Vilniaus Jono Pauliaus II progimnazija";Nykštukai;1624125024;Taip;0;3;2;5
23304;"Vilniaus Jono Pauliaus II progimnazija";Nykštukai;8796557675;Taip;5;7;0;12
23305;"Vilniaus Jono Pauliaus II progimnazija";Nykštukai;5902455219;Taip;4;6;0;10
23306;"Vilniaus Jono Pauliaus II progimnazija";Žiniukai;36350993825;Taip;2;5;0;7
23307;"Vilniaus Jono Pauliaus II progimnazija";Žiniukai;8607110629;Taip;5;5;2;12
23308;"Vilniaus Jono Pauliaus II progimnazija";Žiniukai;6779413882;Taip;7;5;2;14
23309;"Vilniaus Jono Pauliaus II progimnazija";Žiniukai;1897451825;Taip;0;8;0;8
23310;"Vilniaus Jono Pauliaus II progimnazija";Žiniukai;49110267692;Taip;0;4;6;10
23311;"Vilniaus Jono Pauliaus II progimnazija";Žiniukai;7947148051;Taip;0;8;0;8
23312;"Vilniaus Jono Pauliaus II progimnazija";Žiniukai;9246391309;Taip;0;8;0;8
23313;"Vilniaus Jono Pauliaus II progimnazija";Žiniukai;35673258175;Taip;0;4;2;6
23314;"Vilniaus Jono Pauliaus II progimnazija";Žiniukai;4472742569;Taip;0;5;0;5
23315;"Vilniaus Jono Pauliaus II progimnazija";Žiniukai;69245659818;Taip;0;11;0;11
23316;"Vilniaus Jono Pauliaus II progimnazija";Žiniukai;9664467134;Taip;0;5;0;5
23317;"Vilniaus Jono Pauliaus II progimnazija";Žiniukai;7838787153;Taip;0;5;0;5
23318;"Vilniaus Jono Pauliaus II progimnazija";Žiniukai;8922195998;Taip;0;5;1;6
23319;"Vilniaus Jono Pauliaus II progimnazija";Žiniukai;1429139157;Taip;7;4;8;19
23320;"Vilniaus Jono Pauliaus II progimnazija";Žiniukai;3042409414;Taip;0;14;0;14
23321;"Vilniaus Jono Pauliaus II progimnazija";Žiniukai;8245310502;Taip;0;6;0;6
23322;"Vilniaus Jono Pauliaus II progimnazija";Žiniukai;5593546668;Taip;0;11;1;12
23323;"Vilniaus Jono Pauliaus II progimnazija";Žiniukai;1460444785;Taip;5;10;0;15
23324;"Vilniaus Jono Pauliaus II progimnazija";Žiniukai;9262869284;Taip;0;5;5;10
23325;"Vilniaus Jono Pauliaus II progimnazija";Žiniukai;38456484551;Taip;0;6;0;6
23326;"Vilniaus Jono Pauliaus II progimnazija";Žiniukai;6646474196;Taip;12;4;1;17
23327;"Vilniaus Jono Pauliaus II progimnazija";Spindulėlis;2391924358;Taip;0;5;0;5
23328;"Vilniaus Jono Pauliaus II progimnazija";Spindulėlis;9953834483;Taip;0;4;0;4
23329;"Vilniaus Jono Pauliaus II progimnazija";Spindulėlis;1950514819;Taip;0;27;0;27
23330;"Vilniaus Jono Pauliaus II progimnazija";Spindulėlis;1298127839;Taip;3;5;1;9
23331;"Vilniaus Jono Pauliaus II progimnazija";Spindulėlis;4034847901;Taip;5;4;0;9
23332;"Vilniaus Jono Pauliaus II progimnazija";Spindulėlis;8980788109;Taip;0;6;0;6
23333;"Vilniaus Jono Pauliaus II progimnazija";Spindulėlis;1009453682;Taip;0;5;0;5
23334;"Vilniaus Jono Pauliaus II progimnazija";Spindulėlis;4579700769;Taip;0;5;0;5
23335;"Vilniaus Jono Pauliaus II progimnazija";Spindulėlis;7136135394;Taip;0;6;0;6
23336;"Vilniaus Jono Pauliaus II progimnazija";Spindulėlis;2244921301;Taip;0;4;0;4
23337;"Vilniaus Jono Pauliaus II progimnazija";Spindulėlis;1133359254;Taip;6;4;0;10
23338;"Vilniaus Jono Pauliaus II progimnazija";Spindulėlis;8336138549;Taip;0;5;0;5
23339;"Vilniaus Jono Pauliaus II progimnazija";Spindulėlis;1831094707;Taip;5;4;0;9
23340;"Vilniaus Jono Pauliaus II progimnazija";Spindulėlis;5036549574;Taip;2;5;0;7
23341;"Vilniaus Jono Pauliaus II progimnazija";Spindulėlis;5451923881;Taip;12;4;0;16
23342;"Vilniaus Jono Pauliaus II progimnazija";Spindulėlis;8100789958;Taip;0;7;0;7
23343;"Vilniaus Jono Pauliaus II progimnazija";Spindulėlis;6964047214;Taip;10;4;0;14
23344;"Vilniaus Jono Pauliaus II progimnazija";Spindulėlis;2445444641;Taip;6;5;0;11
23345;"Vilniaus Jono Pauliaus II progimnazija";Spindulėlis;5079107907;Taip;0;5;1;6
23346;"Vilniaus Jono Pauliaus II progimnazija";Spindulėlis;9908198854;Taip;0;6;0;6
23347;"Vilniaus Jono Pauliaus II progimnazija";Spindulėlis;6595165722;Taip;0;4;0;4
23348;"Vilniaus Sausio 13-osios mokykla";GUDRUČIAI;2086546195;Taip;4;0;0;4
23349;"Vilniaus Sausio 13-osios mokykla";SMALSUČIAI;1874574001;Taip;3;0;0;3
23350;"Vilniaus Sausio 13-osios mokykla";SMALSUČIAI;5960204860;Taip;8;0;0;8
23351;"Vilniaus savivaldybės Grigiškių gimnazija";"Priešmokyklinio ugdymo (lenkų kalba)";9259436243;Taip;3;0;0;3
23352;Gluosnis;KIŠKUČIAI;8689557248;Taip;0;1;0;1
23353;Gluosnis;KIŠKUČIAI;2984134115;Taip;0;0;5;5
23354;Gluosnis;KIŠKUČIAI;6955695422;Taip;0;0;5;5
23355;Gluosnis;KIŠKUČIAI;1305651237;Taip;2;0;1;3
23356;Gluosnis;KIŠKUČIAI;4285562600;Taip;0;5;3;8
23357;Gluosnis;KIŠKUČIAI;5432102004;Taip;5;0;5;10
23358;Gluosnis;KIŠKUČIAI;8009719622;Taip;0;1;4;5
23359;Gluosnis;KIŠKUČIAI;6883663577;Taip;2;3;0;5
23360;Gluosnis;KIŠKUČIAI;1512855055;Taip;0;8;0;8
23361;Gluosnis;KIŠKUČIAI;8337313448;Taip;0;3;1;4
23362;Gluosnis;KIŠKUČIAI;4632419177;Taip;0;1;2;3
23363;Gluosnis;KIŠKUČIAI;6113153127;Taip;7;0;2;9
23364;Gluosnis;KIŠKUČIAI;7769522093;Taip;5;0;8;13
23365;Gluosnis;KIŠKUČIAI;8928597187;Taip;0;0;4;4
23366;Gluosnis;KIŠKUČIAI;9993638596;Taip;0;0;6;6
23367;Gluosnis;KIŠKUČIAI;6994005000;Taip;0;3;1;4
23368;Gluosnis;KIŠKUČIAI;9221983318;Taip;0;3;1;4
23369;Gluosnis;KIŠKUČIAI;2187312618;Taip;0;0;8;8
23370;Gluosnis;KIŠKUČIAI;5664156894;Taip;0;0;4;4
23371;Gluosnis;KIŠKUČIAI;7073637619;Taip;0;0;8;8
23372;Gluosnis;KIŠKUČIAI;1391404073;Taip;8;0;0;8
23373;Gluosnis;KIŠKUČIAI;4591550636;Taip;0;6;0;6
23374;Gluosnis;EŽIUKAI;4153713911;Taip;18;0;0;18
23375;Gluosnis;EŽIUKAI;1301904113;Taip;0;2;2;4
23376;Gluosnis;EŽIUKAI;5350702449;Taip;0;0;3;3
23377;Gluosnis;EŽIUKAI;8577271806;Taip;0;3;0;3
23378;Gluosnis;EŽIUKAI;6622415563;Taip;0;5;0;5
23379;Gluosnis;EŽIUKAI;3988305400;Taip;0;3;0;3
23380;Gluosnis;EŽIUKAI;9788278155;Taip;10;2;0;12
23381;Gluosnis;EŽIUKAI;7974944779;Taip;3;0;0;3
23382;Gluosnis;EŽIUKAI;7526020668;Taip;0;2;5;7
23383;Gluosnis;EŽIUKAI;5522411084;Taip;0;3;4;7
23384;Gluosnis;EŽIUKAI;5392759654;Taip;8;0;1;9
23385;Gluosnis;EŽIUKAI;6681653921;Taip;5;3;0;8
23386;Gluosnis;EŽIUKAI;4902627153;Taip;5;3;0;8
23387;Gluosnis;EŽIUKAI;2525780494;Taip;0;2;0;2
23388;Gluosnis;EŽIUKAI;9389736360;Taip;4;4;0;8
23389;Gluosnis;EŽIUKAI;2707855273;Taip;0;5;3;8
23390;Gluosnis;EŽIUKAI;7523459118;Taip;0;0;9;9
23391;Gluosnis;EŽIUKAI;2794163383;Taip;4;2;4;10
23392;Gluosnis;EŽIUKAI;7264550578;Taip;0;3;6;9
23393;Gluosnis;EŽIUKAI;5368171142;Taip;0;9;0;9
23394;Gluosnis;EŽIUKAI;6754799196;Taip;3;0;0;3
23395;Gluosnis;EŽIUKAI;9888037899;Taip;0;0;10;10
23396;Gluosnis;MEŠKIUKAI;8981904827;Taip;0;0;7;7
23397;Gluosnis;MEŠKIUKAI;8998776286;Taip;6;1;1;8
23398;Gluosnis;MEŠKIUKAI;1846499141;Taip;15;0;0;15
23399;Gluosnis;MEŠKIUKAI;7935750427;Taip;0;3;1;4
23400;Gluosnis;MEŠKIUKAI;4905002832;Taip;5;3;0;8
23401;Gluosnis;MEŠKIUKAI;9102081648;Taip;3;0;4;7
23402;Gluosnis;MEŠKIUKAI;4498429439;Taip;10;0;1;11
23403;Gluosnis;MEŠKIUKAI;1235091885;Taip;0;8;0;8
23404;Gluosnis;MEŠKIUKAI;1165636758;Taip;5;0;1;6
23405;Gluosnis;MEŠKIUKAI;8499748544;Taip;0;2;0;2
23406;Gluosnis;MEŠKIUKAI;9699577397;Taip;13;0;2;15
23407;Gluosnis;MEŠKIUKAI;4107344313;Taip;0;0;7;7
23408;Gluosnis;MEŠKIUKAI;1101472999;Taip;0;1;1;2
23409;Gluosnis;MEŠKIUKAI;7995558671;Taip;0;3;0;3
23410;Gluosnis;MEŠKIUKAI;1602556462;Taip;9;0;1;10
23411;Gluosnis;MEŠKIUKAI;8842139496;Taip;4;0;3;7
23412;Gluosnis;MEŠKIUKAI;4060859156;Taip;0;3;0;3
23413;Gluosnis;MEŠKIUKAI;6428753580;Taip;6;0;2;8
23414;Gluosnis;MEŠKIUKAI;3323237449;Taip;5;3;0;8
23415;Gluosnis;MEŠKIUKAI;6246512101;Taip;6;0;5;11
23416;Gluosnis;MEŠKIUKAI;3038732180;Taip;10;3;1;14
23417;Gluosnis;MEŠKIUKAI;1712795835;Taip;0;3;0;3
23418;Gluosnis;BORUŽĖLĖS;8840658383;Taip;6;9;0;15
23419;Gluosnis;BORUŽĖLĖS;1102935178;Taip;0;0;6;6
23420;Gluosnis;BORUŽĖLĖS;2167312808;Taip;0;3;1;4
23421;Gluosnis;BORUŽĖLĖS;4204797742;Taip;0;5;0;5
23422;Gluosnis;BORUŽĖLĖS;6302765948;Taip;0;3;2;5
23423;Gluosnis;BORUŽĖLĖS;9938235476;Taip;0;2;0;2
23424;Gluosnis;BORUŽĖLĖS;2945796648;Taip;3;0;0;3
23425;Gluosnis;BORUŽĖLĖS;2173191971;Taip;0;0;2;2
23426;Gluosnis;BORUŽĖLĖS;4237053702;Taip;11;4;0;15
23427;Gluosnis;BORUŽĖLĖS;7731887361;Taip;0;0;1;1
23428;Gluosnis;BORUŽĖLĖS;8502947568;Taip;9;0;0;9
23429;Gluosnis;BORUŽĖLĖS;9664090375;Taip;2;0;1;3
23430;Gluosnis;BORUŽĖLĖS;1335152703;Taip;0;6;0;6
23431;Gluosnis;BORUŽĖLĖS;1314992969;Taip;9;0;8;17
23432;Gluosnis;BORUŽĖLĖS;7833136455;Taip;8;0;0;8
23433;Gluosnis;BORUŽĖLĖS;5556821953;Taip;0;4;0;4
23434;Gluosnis;BORUŽĖLĖS;2515646510;Ne;0;0;5;5
23435;Gluosnis;BORUŽĖLĖS;3212658311;Taip;0;0;6;6
23436;Gluosnis;BORUŽĖLĖS;2603201633;Taip;4;4;0;8
23437;Gluosnis;BORUŽĖLĖS;6086258054;Taip;9;4;0;13
23438;Gluosnis;BORUŽĖLĖS;1351519995;Taip;15;3;0;18
23439;Gluosnis;BORUŽĖLĖS;6960673767;Taip;10;0;0;10
23440;Gluosnis;LAPIUKAI;7025815772;Taip;0;0;8;8
23441;Gluosnis;LAPIUKAI;5266206726;Taip;18;0;0;18
23442;Gluosnis;LAPIUKAI;2968946946;Taip;5;6;1;12
23443;Gluosnis;LAPIUKAI;8976032500;Taip;0;10;1;11
23444;Gluosnis;LAPIUKAI;3190331209;Taip;8;0;5;13
23445;Gluosnis;LAPIUKAI;5376108804;Taip;10;0;3;13
23446;Gluosnis;LAPIUKAI;2258921960;Taip;0;0;16;16
23447;Gluosnis;LAPIUKAI;9386396460;Taip;10;0;0;10
23448;Gluosnis;LAPIUKAI;1664508998;Taip;14;0;1;15
23449;Gluosnis;LAPIUKAI;1296975213;Taip;11;0;0;11
23450;Gluosnis;LAPIUKAI;8227732558;Taip;10;0;3;13
23451;Gluosnis;LAPIUKAI;5633386146;Taip;13;0;1;14
23452;Gluosnis;LAPIUKAI;4146877525;Taip;0;3;0;3
23453;Gluosnis;LAPIUKAI;4616132460;Taip;11;0;2;13
23454;Gluosnis;LAPIUKAI;4280829038;Taip;3;3;0;6
23455;Gluosnis;LAPIUKAI;6273179300;Taip;14;0;0;14
23456;Gluosnis;LAPIUKAI;7090336454;Taip;5;4;0;9
23457;Gluosnis;PELĖDŽIUKAI;1933496033;Taip;0;7;0;7
23458;Gluosnis;PELĖDŽIUKAI;8259035822;Taip;0;6;0;6
23459;Gluosnis;PELĖDŽIUKAI;4960167173;Taip;0;1;0;1
23460;Gluosnis;PELĖDŽIUKAI;2181550091;Taip;0;1;0;1
23461;Gluosnis;PELĖDŽIUKAI;6163009686;Taip;5;3;0;8
23462;Gluosnis;PELĖDŽIUKAI;1671693932;Taip;0;3;4;7
23463;Gluosnis;PELĖDŽIUKAI;4005023841;Ne;0;3;4;7
23464;Gluosnis;PELĖDŽIUKAI;9497547057;Taip;0;5;0;5
23465;Gluosnis;PELĖDŽIUKAI;6865973084;Taip;0;2;0;2
23466;Gluosnis;PELĖDŽIUKAI;1298724775;Taip;0;4;0;4
23467;Gluosnis;PELĖDŽIUKAI;1185903576;Taip;2;3;2;7
23468;Gluosnis;PELĖDŽIUKAI;7537587118;Taip;0;3;1;4
23469;Gluosnis;PELĖDŽIUKAI;7075070566;Taip;0;3;0;3
23470;Gluosnis;PELĖDŽIUKAI;7761376910;Taip;0;3;0;3
23471;Gluosnis;PELĖDŽIUKAI;3434902234;Taip;0;3;0;3
23472;Gluosnis;PELĖDŽIUKAI;6944918504;Taip;0;6;0;6
23473;Gluosnis;PELĖDŽIUKAI;7842723958;Taip;0;5;0;5
23474;Gluosnis;PELĖDŽIUKAI;94487630173;Taip;2;9;0;11
23475;Gluosnis;VOVERIUKAI;6747244713;Taip;11;0;3;14
23476;Gluosnis;VOVERIUKAI;3900322680;Taip;6;0;0;6
23477;Gluosnis;VOVERIUKAI;2423433989;Taip;4;3;4;11
23478;Gluosnis;VOVERIUKAI;1263019496;Taip;6;3;1;10
23479;Gluosnis;VOVERIUKAI;4564193030;Taip;0;4;0;4
23480;Gluosnis;VOVERIUKAI;4224637208;Taip;5;3;0;8
23481;Gluosnis;VOVERIUKAI;1144177849;Taip;9;1;0;10
23482;Gluosnis;VOVERIUKAI;6729016081;Taip;0;4;0;4
23483;Gluosnis;VOVERIUKAI;4069584911;Taip;0;3;1;4
23484;Gluosnis;VOVERIUKAI;6119618742;Taip;2;0;0;2
23485;Gluosnis;VOVERIUKAI;2794080237;Taip;13;0;0;13
23486;Gluosnis;VOVERIUKAI;5623135790;Taip;5;3;0;8
23487;Gluosnis;VOVERIUKAI;2310874591;Taip;0;8;0;8
23488;Gluosnis;VOVERIUKAI;5210930032;Taip;5;0;8;13
23489;Gluosnis;VOVERIUKAI;5008836118;Taip;0;0;3;3
23490;Gluosnis;VOVERIUKAI;4361177196;Taip;18;0;0;18
23491;Gluosnis;VOVERIUKAI;9484423786;Taip;7;0;3;10
23492;Gluosnis;VOVERIUKAI;8109714321;Taip;12;0;0;12
23493;Gluosnis;DRUGELIAI;5949954525;Taip;3;5;0;8
23494;Gluosnis;DRUGELIAI;1716235604;Taip;5;4;0;9
23495;Gluosnis;DRUGELIAI;8430102757;Taip;0;4;0;4
23496;Gluosnis;DRUGELIAI;4125830926;Taip;0;14;0;14
23497;Gluosnis;DRUGELIAI;6358187113;Taip;5;0;7;12
23498;Gluosnis;DRUGELIAI;9084785666;Taip;0;4;4;8
23499;Gluosnis;DRUGELIAI;4940563623;Taip;3;0;1;4
23500;Gluosnis;DRUGELIAI;1113731535;Taip;5;5;0;10
23501;Gluosnis;DRUGELIAI;4653963373;Taip;10;2;0;12
23502;Gluosnis;DRUGELIAI;2458662117;Taip;0;0;2;2
23503;Gluosnis;DRUGELIAI;8314366921;Taip;2;0;8;10
23504;Gluosnis;DRUGELIAI;4220504133;Taip;23;0;0;23
23505;Gluosnis;DRUGELIAI;9931766935;Taip;0;0;4;4
23506;Gluosnis;DRUGELIAI;3527418865;Taip;9;4;1;14
23507;Gluosnis;DRUGELIAI;6914171069;Taip;6;0;4;10
23508;Gluosnis;DRUGELIAI;1848647593;Taip;0;12;0;12
23509;Gluosnis;DRUGELIAI;7756397778;Taip;0;0;3;3
23510;Gluosnis;DRUGELIAI;5943955268;Taip;0;0;8;8
23511;Gluosnis;DRUGELIAI;8690911930;Taip;0;6;4;10
23512;Gluosnis;DRUGELIAI;1543842220;Taip;0;0;3;3
23513;Gluosnis;DRUGELIAI;1787206205;Taip;15;1;0;16
23514;Gluosnis;DRUGELIAI;5264930854;Taip;0;10;0;10
23515;Gluosnis;BITUTĖS;4176300773;Taip;12;0;1;13
23516;Gluosnis;BITUTĖS;2554790908;Taip;0;4;0;4
23517;Gluosnis;BITUTĖS;8281499182;Taip;8;0;4;12
23518;Gluosnis;BITUTĖS;2403029153;Taip;0;2;2;4
23519;Gluosnis;BITUTĖS;6432475763;Taip;0;1;1;2
23520;Gluosnis;BITUTĖS;9542889575;Taip;1;3;1;5
23521;Gluosnis;BITUTĖS;1966484574;Taip;5;3;0;8
23522;Gluosnis;BITUTĖS;4353195155;Taip;0;8;2;10
23523;Gluosnis;BITUTĖS;5889360726;Taip;0;3;1;4
23524;Gluosnis;BITUTĖS;8035097045;Taip;4;0;1;5
23525;Gluosnis;BITUTĖS;3362089746;Taip;0;3;3;6
23526;Gluosnis;BITUTĖS;7390361159;Taip;0;3;1;4
23527;Gluosnis;BITUTĖS;8380310240;Taip;0;3;2;5
23528;Gluosnis;BITUTĖS;4481544177;Taip;0;0;9;9
23529;Gluosnis;BITUTĖS;3673702157;Taip;0;1;1;2
23530;Gluosnis;BITUTĖS;9098141563;Taip;7;3;0;10
23531;Gluosnis;BITUTĖS;9201769624;Taip;0;3;1;4
23532;Gluosnis;BITUTĖS;1306381382;Taip;3;0;1;4
23533;Gluosnis;BITUTĖS;6767500085;Taip;0;2;2;4
23534;Gluosnis;BITUTĖS;6001358241;Taip;0;0;6;6
23535;Gluosnis;BITUTĖS;5380755693;Taip;0;3;3;6
23536;Gluosnis;BITUTĖS;6197840105;Taip;0;4;0;4
23537;Gluosnis;BITUTĖS;5204445760;Taip;3;0;6;9
23538;"Vilniaus Saulėtekio mokykla-daugiafunkcinis centras";Priešmokyklinė;1029813471;Taip;0;3;0;3
23539;"Vilniaus Saulėtekio mokykla-daugiafunkcinis centras";Priešmokyklinė;8760467524;Taip;0;3;0;3
23540;"Vilniaus Saulėtekio mokykla-daugiafunkcinis centras";Priešmokyklinė;6738279023;Taip;0;9;0;9
23541;"Vilniaus Saulėtekio mokykla-daugiafunkcinis centras";Priešmokyklinė;1739797553;Taip;0;5;0;5
23542;"Vilniaus Saulėtekio mokykla-daugiafunkcinis centras";Priešmokyklinė;2159833613;Taip;12;3;0;15
23543;"Vilniaus Saulėtekio mokykla-daugiafunkcinis centras";Priešmokyklinė;1193336600;Taip;5;9;0;14
23544;"Vilniaus Saulėtekio mokykla-daugiafunkcinis centras";Priešmokyklinė;5914721966;Taip;0;3;0;3
23545;"Vilniaus Saulėtekio mokykla-daugiafunkcinis centras";Priešmokyklinė;8852228006;Taip;0;3;15;18
23546;"Vilniaus Saulėtekio mokykla-daugiafunkcinis centras";Priešmokyklinė;4159716896;Taip;0;3;0;3
23547;"Vilniaus Saulėtekio mokykla-daugiafunkcinis centras";Priešmokyklinė;1667714484;Taip;6;3;4;13
23548;"Vilniaus Saulėtekio mokykla-daugiafunkcinis centras";Priešmokyklinė;6589058061;Taip;0;3;1;4
23549;"Vilniaus Saulėtekio mokykla-daugiafunkcinis centras";Priešmokyklinė;3048310276;Taip;0;3;7;10
23550;"Vilniaus Saulėtekio mokykla-daugiafunkcinis centras";Priešmokyklinė;6991187086;Ne;0;5;0;5
23551;"Vilniaus Saulėtekio mokykla-daugiafunkcinis centras";Priešmokyklinė;1698381959;Taip;0;5;0;5
23552;"Vilniaus Saulėtekio mokykla-daugiafunkcinis centras";Priešmokyklinė;2500332755;Taip;0;4;0;4
23553;"Vilniaus Saulėtekio mokykla-daugiafunkcinis centras";Priešmokyklinė;2074102166;Taip;0;3;0;3
23554;"Vilniaus Saulėtekio mokykla-daugiafunkcinis centras";Priešmokyklinė;2906786855;Taip;0;3;0;3
23555;"Vilniaus Saulėtekio mokykla-daugiafunkcinis centras";Priešmokyklinė;3108520221;Taip;0;9;0;9
23556;"Vilniaus Saulėtekio mokykla-daugiafunkcinis centras";Priešmokyklinė;8815534200;Taip;3;3;2;8
23557;"Vilniaus Saulėtekio mokykla-daugiafunkcinis centras";Priešmokyklinė;4751570183;Taip;5;3;0;8
23558;"Vilniaus Saulėtekio mokykla-daugiafunkcinis centras";Priešmokyklinė;9164075226;Ne;0;7;0;7
23559;"Vilniaus Saulėtekio mokykla-daugiafunkcinis centras";Priešmokyklinė;2020364455;Taip;0;3;0;3
23560;"Vilniaus Saulėtekio mokykla-daugiafunkcinis centras";Priešmokyklinė;4787974814;Taip;0;3;5;8
23561;"Vilniaus Saulėtekio mokykla-daugiafunkcinis centras";Priešmokyklinė;6553762186;Taip;2;10;0;12
23562;"Vilniaus Saulėtekio mokykla-daugiafunkcinis centras";Priešmokyklinė;9057726203;Taip;9;6;0;15
23563;"Vilniaus Saulėtekio mokykla-daugiafunkcinis centras";Priešmokyklinė;6492909546;Taip;3;3;0;6
23564;"Vilniaus Saulėtekio mokykla-daugiafunkcinis centras";"PRIEŠMOKYKLINĖ 2";9963290362;Ne;5;3;2;10
23565;"Vilniaus Saulėtekio mokykla-daugiafunkcinis centras";"PRIEŠMOKYKLINĖ 2";1342094235;Taip;0;3;1;4
23566;"Vilniaus Saulėtekio mokykla-daugiafunkcinis centras";"PRIEŠMOKYKLINĖ 2";2628936055;Taip;0;5;0;5
23567;"Vilniaus Saulėtekio mokykla-daugiafunkcinis centras";"PRIEŠMOKYKLINĖ 2";1224648193;Taip;5;3;1;9
23568;"Vilniaus Saulėtekio mokykla-daugiafunkcinis centras";"PRIEŠMOKYKLINĖ 2";4542122478;Taip;5;3;3;11
23569;"Vilniaus Saulėtekio mokykla-daugiafunkcinis centras";"PRIEŠMOKYKLINĖ 2";7180555146;Taip;0;0;2;2
23570;"Vilniaus Saulėtekio mokykla-daugiafunkcinis centras";"PRIEŠMOKYKLINĖ 2";4010917080;Taip;0;3;5;8
23571;"Vilniaus Saulėtekio mokykla-daugiafunkcinis centras";"PRIEŠMOKYKLINĖ 2";5927071864;Taip;0;3;1;4
23572;"Vilniaus Saulėtekio mokykla-daugiafunkcinis centras";"PRIEŠMOKYKLINĖ 2";4970499391;Ne;4;3;3;10
23573;"Vilniaus Saulėtekio mokykla-daugiafunkcinis centras";"PRIEŠMOKYKLINĖ 2";6593824471;Taip;6;3;1;10
23574;"Vilniaus Saulėtekio mokykla-daugiafunkcinis centras";"PRIEŠMOKYKLINĖ 2";8669346247;Taip;5;3;1;9
23575;"Vilniaus Saulėtekio mokykla-daugiafunkcinis centras";"PRIEŠMOKYKLINĖ 2";1924079984;Taip;1;3;0;4
23576;"Vilniaus Saulėtekio mokykla-daugiafunkcinis centras";"PRIEŠMOKYKLINĖ 2";5590376570;Ne;0;3;0;3
23577;"Vilniaus Saulėtekio mokykla-daugiafunkcinis centras";"PRIEŠMOKYKLINĖ 2";8766410254;Taip;0;3;2;5
23578;"Vilniaus Saulėtekio mokykla-daugiafunkcinis centras";"PRIEŠMOKYKLINĖ 2";4151582358;Taip;1;5;0;6
23579;"Vilniaus Saulėtekio mokykla-daugiafunkcinis centras";"PRIEŠMOKYKLINĖ 2";1376656872;Taip;5;3;4;12
23580;"Vilniaus Saulėtekio mokykla-daugiafunkcinis centras";"PRIEŠMOKYKLINĖ 2";3639632543;Taip;0;9;0;9
23581;"Vilniaus Saulėtekio mokykla-daugiafunkcinis centras";"PRIEŠMOKYKLINĖ 2";6865962441;Taip;0;9;0;9
23582;"Vilniaus Saulėtekio mokykla-daugiafunkcinis centras";"PRIEŠMOKYKLINĖ 2";3982877012;Taip;11;3;0;14
23583;"Vilniaus Saulėtekio mokykla-daugiafunkcinis centras";"PRIEŠMOKYKLINĖ 2";1660650556;Taip;8;4;0;12
23584;"Vilniaus Saulėtekio mokykla-daugiafunkcinis centras";"PRIEŠMOKYKLINĖ 2";4890393582;Taip;2;3;0;5
23585;"Vilniaus Saulėtekio mokykla-daugiafunkcinis centras";"PRIEŠMOKYKLINĖ 2";5304096806;Taip;0;3;0;3
23586;"Vilniaus Saulėtekio mokykla-daugiafunkcinis centras";"PRIEŠMOKYKLINĖ 2";1648983304;Taip;4;3;0;7
23587;"Vilniaus Saulėtekio mokykla-daugiafunkcinis centras";"PRIEŠMOKYKLINĖ 2";1913663230;Taip;0;3;0;3
23588;"Vilniaus Saulėtekio mokykla-daugiafunkcinis centras";"PRIEŠMOKYKLINĖ 2";1543123485;Taip;5;3;1;9
23589;"Vilniaus Saulėtekio mokykla-daugiafunkcinis centras";"PRIEŠMOKYKLINĖ 2";4176208765;Taip;0;5;0;5
23590;"Vilniaus Saulėtekio mokykla-daugiafunkcinis centras";"PRIEŠMOKYKLINĖ 2";8458361084;Taip;4;3;4;11
23591;"Vilniaus „Genio“ progimnazija";NYKŠTUKAI;6545116373;Taip;0;5;1;6
23592;"Vilniaus „Genio“ progimnazija";NYKŠTUKAI;1666616466;Taip;0;4;0;4
23593;"Vilniaus „Genio“ progimnazija";NYKŠTUKAI;3008272979;Taip;0;6;0;6
23594;"Vilniaus „Genio“ progimnazija";NYKŠTUKAI;96416364735;Taip;0;4;0;4
23595;"Vilniaus „Genio“ progimnazija";NYKŠTUKAI;2036966277;Taip;0;4;0;4
23596;"Vilniaus „Genio“ progimnazija";NYKŠTUKAI;1807466584;Taip;5;5;1;11
23597;"Vilniaus „Genio“ progimnazija";NYKŠTUKAI;4680264973;Taip;0;6;0;6
23598;"Vilniaus „Genio“ progimnazija";NYKŠTUKAI;5850506831;Taip;0;5;2;7
23599;"Vilniaus „Genio“ progimnazija";NYKŠTUKAI;3667800006;Taip;0;4;0;4
23600;"Vilniaus „Genio“ progimnazija";NYKŠTUKAI;2176438968;Taip;0;4;1;5
23601;"Vilniaus „Genio“ progimnazija";NYKŠTUKAI;7509276953;Taip;0;4;0;4
23602;"Vilniaus „Genio“ progimnazija";NYKŠTUKAI;1258769646;Taip;0;4;2;6
23603;"Vilniaus „Genio“ progimnazija";NYKŠTUKAI;2593226897;Ne;4;7;0;11
23604;"Vilniaus „Genio“ progimnazija";NYKŠTUKAI;7005815238;Taip;6;4;0;10
23605;"Vilniaus „Genio“ progimnazija";NYKŠTUKAI;3333552585;Taip;0;4;0;4
23606;"Vilniaus „Genio“ progimnazija";NYKŠTUKAI;5372809413;Taip;0;4;0;4
23607;"Vilniaus „Genio“ progimnazija";NYKŠTUKAI;1089753966;Taip;0;4;0;4
23608;"Vilniaus „Genio“ progimnazija";NYKŠTUKAI;6154837614;Taip;0;11;0;11
23609;"Vilniaus „Genio“ progimnazija";NYKŠTUKAI;2865995680;Taip;1;6;0;7
23610;"Vilniaus „Genio“ progimnazija";NYKŠTUKAI;1432694920;Taip;2;4;2;8
23611;"Vilniaus „Genio“ progimnazija";NYKŠTUKAI;1663216529;Taip;0;6;0;6
23612;"Gintarėlis (Popieriaus g. 46A)";SKRUZDĖLIUKAI;3825572125;Taip;0;5;0;5
23613;"Gintarėlis (Popieriaus g. 46A)";SKRUZDĖLIUKAI;5738933125;Taip;9;4;0;13
23614;"Gintarėlis (Popieriaus g. 46A)";SKRUZDĖLIUKAI;1994856959;Taip;0;3;0;3
23615;"Gintarėlis (Popieriaus g. 46A)";SKRUZDĖLIUKAI;8223747534;Taip;0;3;0;3
23616;"Gintarėlis (Popieriaus g. 46A)";SKRUZDĖLIUKAI;1045355492;Taip;15;0;0;15
23617;"Gintarėlis (Popieriaus g. 46A)";SKRUZDĖLIUKAI;6193540660;Taip;14;1;0;15
23618;"Gintarėlis (Popieriaus g. 46A)";SKRUZDĖLIUKAI;3459439843;Taip;7;3;0;10
23619;"Gintarėlis (Popieriaus g. 46A)";SKRUZDĖLIUKAI;7916257692;Taip;3;4;1;8
23620;"Gintarėlis (Popieriaus g. 46A)";SKRUZDĖLIUKAI;7510541192;Taip;3;2;0;5
23621;"Gintarėlis (Popieriaus g. 46A)";SKRUZDĖLIUKAI;9045108717;Taip;0;9;0;9
23622;"Gintarėlis (Popieriaus g. 46A)";SKRUZDĖLIUKAI;1955719034;Taip;6;5;1;12
23623;"Gintarėlis (Popieriaus g. 46A)";SKRUZDĖLIUKAI;1215549844;Taip;3;2;0;5
23624;"Gintarėlis (Popieriaus g. 46A)";SKRUZDĖLIUKAI;5379858630;Taip;0;2;2;4
23625;"Gintarėlis (Popieriaus g. 46A)";SKRUZDĖLIUKAI;5961603860;Taip;0;9;0;9
23626;"Gintarėlis (Popieriaus g. 46A)";SKRUZDĖLIUKAI;8068499156;Taip;0;8;0;8
23627;"Gintarėlis (Popieriaus g. 46A)";SKRUZDĖLIUKAI;5190355636;Taip;8;3;0;11
23628;"Gintarėlis (Popieriaus g. 46A)";SKRUZDĖLIUKAI;4290033336;Taip;5;3;0;8
23629;"Gintarėlis (Popieriaus g. 46A)";PELĖDŽIUKAI;6506180216;Taip;5;6;0;11
23630;"Gintarėlis (Popieriaus g. 46A)";PELĖDŽIUKAI;9200073539;Taip;10;1;0;11
23631;"Gintarėlis (Popieriaus g. 46A)";PELĖDŽIUKAI;3254739432;Taip;0;3;0;3
23632;"Gintarėlis (Popieriaus g. 46A)";PELĖDŽIUKAI;8019543081;Taip;0;10;0;10
23633;"Gintarėlis (Popieriaus g. 46A)";PELĖDŽIUKAI;1628276472;Taip;0;4;0;4
23634;"Gintarėlis (Popieriaus g. 46A)";PELĖDŽIUKAI;5223116373;Taip;5;4;0;9
23635;"Gintarėlis (Popieriaus g. 46A)";PELĖDŽIUKAI;8792175474;Taip;14;0;0;14
23636;"Gintarėlis (Popieriaus g. 46A)";PELĖDŽIUKAI;3304191482;Taip;0;3;0;3
23637;"Gintarėlis (Popieriaus g. 46A)";PELĖDŽIUKAI;2731865977;Taip;0;3;0;3
23638;"Gintarėlis (Popieriaus g. 46A)";PELĖDŽIUKAI;4181430769;Taip;5;4;0;9
23639;"Gintarėlis (Popieriaus g. 46A)";PELĖDŽIUKAI;3202819190;Taip;0;3;0;3
23640;"Gintarėlis (Popieriaus g. 46A)";PELĖDŽIUKAI;9807784148;Taip;0;5;4;9
23641;"Gintarėlis (Popieriaus g. 46A)";PELĖDŽIUKAI;2546360134;Taip;18;0;0;18
23642;"Gintarėlis (Popieriaus g. 46A)";PELĖDŽIUKAI;2308673417;Taip;0;5;0;5
23643;"Gintarėlis (Popieriaus g. 46A)";PELĖDŽIUKAI;6883573289;Taip;0;5;7;12
23644;"Gintarėlis (Popieriaus g. 46A)";PELĖDŽIUKAI;3127881266;Taip;0;4;0;4
23645;"Gintarėlis (Popieriaus g. 46A)";PELĖDŽIUKAI;2052962147;Taip;10;3;0;13
23646;"Gintarėlis (Popieriaus g. 46A)";"LINKSMASIS AVILYS";7872515649;Taip;5;4;0;9
23647;"Gintarėlis (Popieriaus g. 46A)";"LINKSMASIS AVILYS";7256557310;Taip;0;2;0;2
23648;"Gintarėlis (Popieriaus g. 46A)";"LINKSMASIS AVILYS";6425840559;Taip;0;0;14;14
23649;"Gintarėlis (Popieriaus g. 46A)";"LINKSMASIS AVILYS";3572188688;Taip;6;4;0;10
23650;"Gintarėlis (Popieriaus g. 46A)";"LINKSMASIS AVILYS";7010430969;Taip;0;5;0;5
23651;"Gintarėlis (Popieriaus g. 46A)";"LINKSMASIS AVILYS";7734802846;Taip;0;8;0;8
23652;"Gintarėlis (Popieriaus g. 46A)";"LINKSMASIS AVILYS";1070119148;Taip;0;13;0;13
23653;"Gintarėlis (Popieriaus g. 46A)";"LINKSMASIS AVILYS";9182625265;Taip;0;4;0;4
23654;"Gintarėlis (Popieriaus g. 46A)";"LINKSMASIS AVILYS";3738678648;Taip;0;14;0;14
23655;"Gintarėlis (Popieriaus g. 46A)";"LINKSMASIS AVILYS";77906464117;Taip;0;1;0;1
23656;"Gintarėlis (Popieriaus g. 46A)";"LINKSMASIS AVILYS";2737144359;Taip;0;4;0;4
23657;"Gintarėlis (Popieriaus g. 46A)";"LINKSMASIS AVILYS";9257812097;Taip;4;1;0;5
23658;"Gintarėlis (Popieriaus g. 46A)";"LINKSMASIS AVILYS";8680339493;Taip;0;1;0;1
23659;"Gintarėlis (Popieriaus g. 46A)";Varliukai;6821929306;Taip;0;4;0;4
23660;"Gintarėlis (Popieriaus g. 46A)";Varliukai;7274616480;Taip;0;3;0;3
23661;"Gintarėlis (Popieriaus g. 46A)";Varliukai;1362980885;Taip;0;9;0;9
23662;"Gintarėlis (Popieriaus g. 46A)";Varliukai;9762364250;Taip;0;8;0;8
23663;"Gintarėlis (Popieriaus g. 46A)";Varliukai;6849227110;Taip;0;2;0;2
23664;"Gintarėlis (Popieriaus g. 46A)";Varliukai;4263315669;Taip;11;4;0;15
23665;"Gintarėlis (Popieriaus g. 46A)";Varliukai;6081634102;Taip;0;2;2;4
23666;"Gintarėlis (Popieriaus g. 46A)";Varliukai;7206593645;Ne;0;3;9;12
23667;"Gintarėlis (Popieriaus g. 46A)";Varliukai;7400455090;Taip;0;13;0;13
23668;"Gintarėlis (Popieriaus g. 46A)";Varliukai;3702588434;Taip;0;2;14;16
23669;"Gintarėlis (Popieriaus g. 46A)";Varliukai;7413074674;Taip;0;4;0;4
23670;"Gintarėlis (Popieriaus g. 46A)";Varliukai;7031945895;Taip;10;3;0;13
23671;"Gintarėlis (Popieriaus g. 46A)";Varliukai;6514247750;Taip;0;5;0;5
23672;"Gintarėlis (Popieriaus g. 46A)";Varliukai;1166720069;Taip;13;5;0;18
23673;"Gintarėlis (Popieriaus g. 46A)";Varliukai;4556644354;Taip;5;5;0;10
23674;"Gintarėlis (Popieriaus g. 46A)";Varliukai;7510641510;Taip;0;5;0;5
23675;"Pušynėlis (A. Mickevičiaus g. 21)";DAIGIUKAI;5317547220;Taip;0;0;5;5
23676;"Pušynėlis (A. Mickevičiaus g. 21)";DAIGIUKAI;9025539389;Taip;14;0;0;14
23677;"Pušynėlis (A. Mickevičiaus g. 21)";DAIGIUKAI;5512586591;Taip;17;0;0;17
23678;"Pušynėlis (A. Mickevičiaus g. 21)";DAIGIUKAI;6594473055;Taip;11;0;0;11
23679;"Pušynėlis (A. Mickevičiaus g. 21)";DAIGIUKAI;8211464695;Taip;0;3;2;5
23680;"Pušynėlis (A. Mickevičiaus g. 21)";DAIGIUKAI;6321178561;Taip;5;0;3;8
23681;"Pušynėlis (A. Mickevičiaus g. 21)";DAIGIUKAI;6606436348;Taip;6;1;3;10
23682;"Pušynėlis (A. Mickevičiaus g. 21)";DAIGIUKAI;8457384507;Ne;13;0;0;13
23683;"Pušynėlis (A. Mickevičiaus g. 21)";DAIGIUKAI;1085678424;Taip;8;0;4;12
23684;"Pušynėlis (A. Mickevičiaus g. 21)";DAIGIUKAI;9710499937;Taip;0;18;0;18
23685;"Pušynėlis (A. Mickevičiaus g. 21)";DAIGIUKAI;4685125111;Taip;7;0;0;7
23686;"Pušynėlis (A. Mickevičiaus g. 21)";DAIGIUKAI;9717473430;Taip;0;6;0;6
23687;"Pušynėlis (A. Mickevičiaus g. 21)";DAIGIUKAI;2763762463;Taip;0;5;0;5
23688;"Pušynėlis (A. Mickevičiaus g. 21)";NYKŠTUKAI;1050710006;Taip;14;0;1;15
23689;"Pušynėlis (A. Mickevičiaus g. 21)";NYKŠTUKAI;1758632291;Taip;10;0;0;10
23690;"Pušynėlis (A. Mickevičiaus g. 21)";NYKŠTUKAI;8699085292;Taip;2;3;3;8
23691;"Pušynėlis (A. Mickevičiaus g. 21)";NYKŠTUKAI;8327830781;Taip;9;0;1;10
23692;"Pušynėlis (A. Mickevičiaus g. 21)";NYKŠTUKAI;8820865805;Taip;0;3;11;14
23693;"Pušynėlis (A. Mickevičiaus g. 21)";NYKŠTUKAI;9520423020;Taip;8;2;1;11
23694;"Pušynėlis (A. Mickevičiaus g. 21)";NYKŠTUKAI;1177938753;Taip;10;0;0;10
23695;"Pušynėlis (A. Mickevičiaus g. 21)";NYKŠTUKAI;9450347140;Taip;6;2;0;8
23696;"Pušynėlis (A. Mickevičiaus g. 21)";NYKŠTUKAI;2222790161;Taip;11;3;0;14
23697;"Pušynėlis (A. Mickevičiaus g. 21)";NYKŠTUKAI;7596876368;Taip;8;0;1;9
23698;"Pušynėlis (A. Mickevičiaus g. 21)";NYKŠTUKAI;2892213973;Taip;0;0;4;4
23699;"Pušynėlis (A. Mickevičiaus g. 21)";NYKŠTUKAI;7429853563;Taip;5;7;0;12
23700;"Pušynėlis (A. Mickevičiaus g. 21)";NYKŠTUKAI;8464672994;Taip;16;0;0;16
23701;"Pušynėlis (A. Mickevičiaus g. 21)";NYKŠTUKAI;1904434730;Taip;3;0;0;3
23702;"Pušynėlis (A. Mickevičiaus g. 21)";NYKŠTUKAI;3574446664;Taip;5;3;0;8
23703;"Pušynėlis (A. Mickevičiaus g. 21)";NYKŠTUKAI;3362971538;Taip;0;2;1;3
23704;"Pušynėlis (A. Mickevičiaus g. 21)";NYKŠTUKAI;9055713601;Taip;0;0;5;5
23705;"Pušynėlis (A. Mickevičiaus g. 21)";NYKŠTUKAI;5364537212;Taip;5;2;5;12
23706;"Pušynėlis (A. Mickevičiaus g. 21)";NYKŠTUKAI;7172604103;Taip;5;0;1;6
23707;"Pušynėlis (A. Mickevičiaus g. 21)";NYKŠTUKAI;8839614928;Taip;0;2;5;7
23708;"Pušynėlis (A. Mickevičiaus g. 21)";GILIUKAI;9401101407;Taip;0;4;0;4
23709;"Pušynėlis (A. Mickevičiaus g. 21)";GILIUKAI;4997004998;Taip;3;1;2;6
23710;"Pušynėlis (A. Mickevičiaus g. 21)";GILIUKAI;9517319856;Taip;0;4;0;4
23711;"Pušynėlis (A. Mickevičiaus g. 21)";GILIUKAI;9028515427;Taip;0;8;0;8
23712;"Pušynėlis (A. Mickevičiaus g. 21)";GILIUKAI;2825756894;Taip;11;6;0;17
23713;"Pušynėlis (A. Mickevičiaus g. 21)";GILIUKAI;1134325833;Taip;5;1;0;6
23714;"Pušynėlis (A. Mickevičiaus g. 21)";GILIUKAI;3158789663;Taip;0;4;0;4
23715;"Pušynėlis (A. Mickevičiaus g. 21)";GILIUKAI;5668765825;Taip;10;5;0;15
23716;"Pušynėlis (A. Mickevičiaus g. 21)";GILIUKAI;3954867816;Taip;0;4;0;4
23717;"Pušynėlis (A. Mickevičiaus g. 21)";GILIUKAI;7685809238;Taip;1;3;0;4
23718;"Pušynėlis (A. Mickevičiaus g. 21)";GILIUKAI;2712755125;Taip;0;4;0;4
23719;"Pušynėlis (A. Mickevičiaus g. 21)";GILIUKAI;7011836009;Taip;3;2;0;5
23720;"Pušynėlis (A. Mickevičiaus g. 21)";GILIUKAI;3301741162;Taip;7;0;1;8
23721;"Pušynėlis (A. Mickevičiaus g. 21)";GILIUKAI;6735037523;Taip;7;2;2;11
23722;"Pušynėlis (A. Mickevičiaus g. 21)";GILIUKAI;9147558926;Taip;0;2;4;6
23723;"Pušynėlis (A. Mickevičiaus g. 21)";GILIUKAI;7881263225;Taip;0;3;0;3
23724;"Pušynėlis (A. Mickevičiaus g. 21)";GILIUKAI;1612049897;Taip;3;5;0;8
23725;"Pušynėlis (A. Mickevičiaus g. 21)";GILIUKAI;9920959446;Taip;0;5;0;5
23726;"Pušynėlis (A. Mickevičiaus g. 21)";GILIUKAI;4898147530;Taip;7;0;0;7
23727;"Pušynėlis (A. Mickevičiaus g. 21)";GILIUKAI;2228682366;Ne;0;5;0;5
23728;"Pušynėlis (A. Mickevičiaus g. 21)";GILIUKAI;4464615995;Taip;0;7;0;7
23729;"Naminukas (Klinikų g. 5)";VARPELIAI;2089455192;Taip;5;3;1;9
23730;"Naminukas (Klinikų g. 5)";VARPELIAI;3281707263;Taip;12;0;0;12
23731;"Naminukas (Klinikų g. 5)";VARPELIAI;1828220049;Taip;0;1;1;2
23732;"Naminukas (Klinikų g. 5)";VARPELIAI;7328682222;Taip;6;0;7;13
23733;"Naminukas (Klinikų g. 5)";VARPELIAI;7772300667;Taip;18;0;0;18
23734;"Naminukas (Klinikų g. 5)";VARPELIAI;1086919259;Taip;10;0;3;13
23735;"Naminukas (Klinikų g. 5)";VARPELIAI;3497829075;Taip;4;0;3;7
23736;"Naminukas (Klinikų g. 5)";VARPELIAI;3938225198;Taip;2;3;0;5
23737;"Naminukas (Klinikų g. 5)";VARPELIAI;5991261279;Taip;10;0;8;18
23738;"Naminukas (Klinikų g. 5)";VARPELIAI;2576516583;Taip;12;0;2;14
23739;"Naminukas (Klinikų g. 5)";VARPELIAI;8694425584;Taip;0;0;7;7
23740;"Naminukas (Klinikų g. 5)";VARPELIAI;8782832803;Taip;10;5;0;15
23741;"Naminukas (Klinikų g. 5)";VARPELIAI;5172385044;Taip;10;0;1;11
23742;"Naminukas (Klinikų g. 5)";VARPELIAI;5465843371;Taip;8;4;0;12
23743;"Naminukas (Klinikų g. 5)";VARPELIAI;6515021073;Taip;8;0;3;11
23744;"Naminukas (Klinikų g. 5)";VARPELIAI;9894306360;Taip;14;0;0;14
23745;"Naminukas (Klinikų g. 5)";VARPELIAI;8052458976;Taip;5;0;10;15
23746;"Naminukas (Klinikų g. 5)";SAULUTĖS;9212800864;Ne;0;3;0;3
23747;"Naminukas (Klinikų g. 5)";SAULUTĖS;9215327479;Taip;13;0;0;13
23748;"Naminukas (Klinikų g. 5)";SAULUTĖS;8595804874;Taip;0;0;2;2
23749;"Naminukas (Klinikų g. 5)";SAULUTĖS;7947598191;Taip;0;3;1;4
23750;"Naminukas (Klinikų g. 5)";SAULUTĖS;1635395128;Taip;0;0;1;1
23751;"Naminukas (Klinikų g. 5)";SAULUTĖS;3911352454;Taip;8;0;3;11
23752;"Naminukas (Klinikų g. 5)";SAULUTĖS;7107337857;Taip;0;0;4;4
23753;"Naminukas (Klinikų g. 5)";SAULUTĖS;3079900548;Taip;18;0;0;18
23754;"Naminukas (Klinikų g. 5)";SAULUTĖS;7301768930;Taip;0;0;3;3
23755;"Naminukas (Klinikų g. 5)";SAULUTĖS;2516513740;Taip;0;1;4;5
23756;"Naminukas (Klinikų g. 5)";SAULUTĖS;2336627398;Taip;0;3;1;4
23757;"Naminukas (Klinikų g. 5)";SAULUTĖS;1879925655;Taip;5;1;0;6
23758;"Naminukas (Klinikų g. 5)";SAULUTĖS;2881576194;Taip;5;0;5;10
23759;"Naminukas (Klinikų g. 5)";SAULUTĖS;4836599508;Taip;0;0;3;3
23760;"Naminukas (Klinikų g. 5)";SAULUTĖS;1563213488;Taip;0;0;2;2
23761;"Naminukas (Klinikų g. 5)";SAULUTĖS;4709625816;Taip;0;0;3;3
23762;"Naminukas (Klinikų g. 5)";SAULUTĖS;6471277755;Taip;5;0;0;5
23763;"Naminukas (Klinikų g. 5)";SAULUTĖS;1932169696;Taip;5;0;1;6
23764;"Naminukas (Klinikų g. 5)";DRUGELIAI;2339599448;Taip;12;3;0;15
23765;"Naminukas (Klinikų g. 5)";DRUGELIAI;4077985773;Taip;10;3;0;13
23766;"Naminukas (Klinikų g. 5)";DRUGELIAI;3276656641;Taip;0;0;5;5
23767;"Naminukas (Klinikų g. 5)";DRUGELIAI;6633031473;Taip;3;3;0;6
23768;"Naminukas (Klinikų g. 5)";DRUGELIAI;4116151797;Taip;3;3;2;8
23769;"Naminukas (Klinikų g. 5)";DRUGELIAI;7033053271;Taip;3;4;0;7
23770;"Naminukas (Klinikų g. 5)";DRUGELIAI;1454039572;Taip;14;0;0;14
23771;"Naminukas (Klinikų g. 5)";DRUGELIAI;9740815635;Taip;0;8;0;8
23772;"Naminukas (Klinikų g. 5)";DRUGELIAI;7184471307;Taip;0;0;5;5
23773;"Naminukas (Klinikų g. 5)";DRUGELIAI;6949857110;Taip;4;0;0;4
23774;"Naminukas (Klinikų g. 5)";DRUGELIAI;8039086094;Taip;0;0;6;6
23775;"Naminukas (Klinikų g. 5)";DRUGELIAI;8432194383;Taip;2;4;0;6
23776;"Naminukas (Klinikų g. 5)";DRUGELIAI;7463647806;Taip;7;0;0;7
23777;"Naminukas (Klinikų g. 5)";DRUGELIAI;4171789569;Taip;0;9;0;9
23778;"Naminukas (Klinikų g. 5)";DRUGELIAI;6880075874;Taip;4;4;0;8
23779;"Naminukas (Klinikų g. 5)";DRUGELIAI;8793327541;Taip;2;3;0;5
23780;"Naminukas (Klinikų g. 5)";DRUGELIAI;9835701381;Ne;7;1;0;8
23781;"Naminukas (Klinikų g. 5)";BITUTĖS;21152690883;Taip;0;3;0;3
23782;"Naminukas (Klinikų g. 5)";BITUTĖS;1679106754;Taip;0;7;0;7
23783;"Naminukas (Klinikų g. 5)";BITUTĖS;1528496272;Taip;0;3;0;3
23784;"Naminukas (Klinikų g. 5)";BITUTĖS;92417802345;Taip;8;0;0;8
23785;"Naminukas (Klinikų g. 5)";BITUTĖS;1424288192;Taip;3;0;0;3
23786;"Naminukas (Klinikų g. 5)";BITUTĖS;1180176295;Taip;2;3;0;5
23787;"Naminukas (Klinikų g. 5)";BITUTĖS;9903990297;Taip;5;0;0;5
23788;"Naminukas (Klinikų g. 5)";BITUTĖS;6592057292;Taip;6;3;0;9
23789;"Naminukas (Klinikų g. 5)";BITUTĖS;5578151523;Taip;0;0;4;4
23790;"Naminukas (Klinikų g. 5)";BITUTĖS;4353031174;Taip;6;0;1;7
23791;"Naminukas (Klinikų g. 5)";BITUTĖS;9244494109;Taip;5;0;0;5
23792;"Naminukas (Klinikų g. 5)";BITUTĖS;8923393066;Taip;5;0;0;5
23793;"Naminukas (Klinikų g. 5)";BITUTĖS;9178907705;Taip;5;0;2;7
23794;"Naminukas (Klinikų g. 5)";BITUTĖS;2234877411;Taip;6;0;0;6
23795;"Naminukas (Klinikų g. 5)";BITUTĖS;5288557629;Taip;9;1;0;10
23796;"Naminukas (Klinikų g. 5)";BITUTĖS;5233044803;Taip;5;0;0;5
23797;"Naminukas (Klinikų g. 5)";BITUTĖS;1346035733;Taip;5;4;0;9
23798;"Naminukas (Klinikų g. 5)";BITUTĖS;1730248631;Taip;5;0;0;5
23799;"Naminukas (Klinikų g. 5)";BITUTĖS;3791118736;Taip;5;0;0;5
23800;"Naminukas (Klinikų g. 5)";BITUTĖS;1394918021;Taip;4;0;0;4
23801;"Naminukas (Klinikų g. 5)";BITUTĖS;7099787230;Taip;7;0;0;7
23802;"Naminukas (Klinikų g. 5)";BITUTĖS;3088386659;Taip;5;0;0;5
23803;"Gervelė (Stadiono g. 5)";BORUŽĖLĖS;6427072260;Taip;0;1;0;1
23804;"Gervelė (Stadiono g. 5)";BORUŽĖLĖS;9777308731;Taip;7;3;0;10
23805;"Gervelė (Stadiono g. 5)";BORUŽĖLĖS;5285868851;Taip;5;0;0;5
23806;"Gervelė (Stadiono g. 5)";BORUŽĖLĖS;2712133300;Taip;1;3;0;4
23807;"Gervelė (Stadiono g. 5)";BORUŽĖLĖS;2622183564;Ne;0;12;0;12
23808;"Gervelė (Stadiono g. 5)";BORUŽĖLĖS;1006720360;Taip;0;4;0;4
23809;"Gervelė (Stadiono g. 5)";BORUŽĖLĖS;8190190100;Taip;6;4;0;10
23810;"Gervelė (Stadiono g. 5)";BORUŽĖLĖS;6338612770;Taip;8;0;0;8
23811;"Gervelė (Stadiono g. 5)";BORUŽĖLĖS;6004269553;Taip;8;0;0;8
23812;"Gervelė (Stadiono g. 5)";BORUŽĖLĖS;2770635568;Taip;0;1;0;1
23813;"Gervelė (Stadiono g. 5)";BORUŽĖLĖS;6573919007;Ne;0;11;0;11
23814;"Gervelė (Stadiono g. 5)";BORUŽĖLĖS;8797608822;Ne;0;13;0;13
23815;"Gervelė (Stadiono g. 5)";PAUKŠTELIAI;7959839478;Ne;2;3;0;5
23816;"Gervelė (Stadiono g. 5)";PAUKŠTELIAI;2031118410;Taip;0;5;0;5
23817;"Gervelė (Stadiono g. 5)";PAUKŠTELIAI;5966215998;Taip;18;0;0;18
23818;"Gervelė (Stadiono g. 5)";PAUKŠTELIAI;7463376031;Taip;0;15;0;15
23819;"Gervelė (Stadiono g. 5)";PAUKŠTELIAI;1751440418;Taip;7;6;0;13
23820;"Gervelė (Stadiono g. 5)";PAUKŠTELIAI;3567687304;Taip;0;5;0;5
23821;"Gervelė (Stadiono g. 5)";PAUKŠTELIAI;6372245141;Taip;0;2;0;2
23822;"Gervelė (Stadiono g. 5)";PAUKŠTELIAI;2892214705;Taip;15;0;0;15
23823;"Gervelė (Stadiono g. 5)";PAUKŠTELIAI;7952102572;Taip;7;2;0;9
23824;"Gervelė (Stadiono g. 5)";PAUKŠTELIAI;2372820133;Taip;2;0;0;2
23825;"Gervelė (Stadiono g. 5)";PAUKŠTELIAI;9154032804;Ne;18;0;0;18
23826;"Gervelė (Stadiono g. 5)";PAUKŠTELIAI;7843800194;Taip;0;1;0;1
23827;"Gervelė (Stadiono g. 5)";PAUKŠTELIAI;3676856569;Taip;0;1;0;1
23828;"Gervelė (Stadiono g. 5)";PAUKŠTELIAI;4588890423;Taip;0;11;0;11
23829;"Gervelė (Stadiono g. 5)";PAUKŠTELIAI;6822089289;Taip;0;1;0;1
23830;"Gervelė (Stadiono g. 5)";SPINDULĖLIAI;4508176017;Taip;0;0;1;1
23831;"Gervelė (Stadiono g. 5)";SPINDULĖLIAI;4051246539;Ne;0;4;1;5
23832;"Gervelė (Stadiono g. 5)";SPINDULĖLIAI;1020095914;Taip;4;1;0;5
23833;"Gervelė (Stadiono g. 5)";SPINDULĖLIAI;3306549764;Taip;0;0;1;1
23834;"Gervelė (Stadiono g. 5)";SPINDULĖLIAI;5705915729;Taip;0;0;3;3
23835;"Gervelė (Stadiono g. 5)";SPINDULĖLIAI;6241611652;Taip;0;0;1;1
23836;"Gervelė (Stadiono g. 5)";SPINDULĖLIAI;2207041148;Taip;0;3;1;4
23837;"Gervelė (Stadiono g. 5)";SPINDULĖLIAI;8472436632;Taip;0;18;0;18
23838;"Gervelė (Stadiono g. 5)";SPINDULĖLIAI;1204513844;Taip;0;0;3;3
23839;"Gervelė (Stadiono g. 5)";SPINDULĖLIAI;7419432731;Taip;0;0;3;3
23840;"Gervelė (Stadiono g. 5)";SPINDULĖLIAI;1611114179;Taip;12;0;0;12
23841;"Gervelė (Stadiono g. 5)";SPINDULĖLIAI;8710469480;Taip;7;3;0;10
23842;"Gervelė (Stadiono g. 5)";GĖLYTĖS;6172016747;Taip;10;4;0;14
23843;"Gervelė (Stadiono g. 5)";GĖLYTĖS;3873345138;Ne;10;0;0;10
23844;"Gervelė (Stadiono g. 5)";GĖLYTĖS;5518309115;Taip;0;2;0;2
23845;"Gervelė (Stadiono g. 5)";GĖLYTĖS;2744433344;Taip;0;4;0;4
23846;"Gervelė (Stadiono g. 5)";GĖLYTĖS;4930308435;Taip;0;2;0;2
23847;"Gervelė (Stadiono g. 5)";GĖLYTĖS;6621769160;Taip;8;0;0;8
23848;"Gervelė (Stadiono g. 5)";GĖLYTĖS;7115198351;Taip;5;0;0;5
23849;"Gervelė (Stadiono g. 5)";GĖLYTĖS;4505873061;Ne;0;5;0;5
23850;"Gervelė (Stadiono g. 5)";GĖLYTĖS;9291855374;Taip;0;4;0;4
23851;"Gervelė (Stadiono g. 5)";GĖLYTĖS;4832348492;Taip;0;8;0;8
23852;"Gervelė (Stadiono g. 5)";GĖLYTĖS;7855598075;Taip;7;4;0;11
23853;"Gervelė (Stadiono g. 5)";GĖLYTĖS;4424095457;Taip;0;18;0;18
23854;"Gervelė (Stadiono g. 5)";GĖLYTĖS;8777858708;Ne;0;4;0;4
23855;"Gervelė (Stadiono g. 5)";GĖLYTĖS;6488139414;Taip;15;0;0;15
23856;"Gervelė (Stadiono g. 5)";GĖLYTĖS;3216423543;Taip;8;0;0;8
23857;"Gervelė (Stadiono g. 5)";GĖLYTĖS;4925983616;Taip;0;5;0;5
23858;"Gervelė (Stadiono g. 5)";GĖLYTĖS;7387250891;Taip;2;3;0;5
23859;"Gervelė (Stadiono g. 5)";GĖLYTĖS;3490370918;Ne;0;7;0;7
23860;"Gervelė (Stadiono g. 5)";GĖLYTĖS;9183582003;Ne;0;7;0;7
23861;"Kūlverstukas (Mindaugo g. 7)";GNOMIKI;1720671485;Ne;0;2;0;2
23862;"Kūlverstukas (Mindaugo g. 7)";GNOMIKI;4894478262;Taip;2;1;1;4
23863;"Kūlverstukas (Mindaugo g. 7)";GNOMIKI;2501327054;Ne;5;3;0;8
23864;"Kūlverstukas (Mindaugo g. 7)";GNOMIKI;8348978878;Taip;0;7;0;7
23865;"Kūlverstukas (Mindaugo g. 7)";GNOMIKI;8927489885;Taip;0;3;3;6
23866;"Kūlverstukas (Mindaugo g. 7)";GNOMIKI;2709547427;Taip;5;4;0;9
23867;"Kūlverstukas (Mindaugo g. 7)";GNOMIKI;5532063862;Taip;0;3;0;3
23868;"Kūlverstukas (Mindaugo g. 7)";GNOMIKI;5747277587;Taip;0;1;0;1
23869;"Kūlverstukas (Mindaugo g. 7)";GNOMIKI;1848018684;Taip;0;4;0;4
23870;"Kūlverstukas (Mindaugo g. 7)";GNOMIKI;1166429762;Taip;18;0;0;18
23871;"Kūlverstukas (Mindaugo g. 7)";GNOMIKI;6514730230;Taip;0;2;6;8
23872;"Kūlverstukas (Mindaugo g. 7)";GNOMIKI;5298776235;Taip;4;6;0;10
23873;"Kūlverstukas (Mindaugo g. 7)";GNOMIKI;4116831802;Ne;0;1;0;1
23874;"Kūlverstukas (Mindaugo g. 7)";GNOMIKI;4677564389;Ne;0;1;0;1
23875;"Kūlverstukas (Mindaugo g. 7)";GNOMIKI;1916522637;Taip;0;3;0;3
23876;"Kūlverstukas (Mindaugo g. 7)";GNOMIKI;3239566139;Taip;7;6;0;13
23877;"Kūlverstukas (Mindaugo g. 7)";ZAIČIATA;8994705290;Taip;0;8;0;8
23878;"Kūlverstukas (Mindaugo g. 7)";ZAIČIATA;8496678513;Taip;6;0;0;6
23879;"Kūlverstukas (Mindaugo g. 7)";ZAIČIATA;7933156766;Ne;0;0;3;3
23880;"Kūlverstukas (Mindaugo g. 7)";ZAIČIATA;2494202134;Ne;0;3;0;3
23881;"Kūlverstukas (Mindaugo g. 7)";ZAIČIATA;2714297182;Taip;0;2;1;3
23882;"Kūlverstukas (Mindaugo g. 7)";ZAIČIATA;4998847820;Ne;0;0;11;11
23883;"Kūlverstukas (Mindaugo g. 7)";ZAIČIATA;4271185150;Taip;0;0;4;4
23884;"Kūlverstukas (Mindaugo g. 7)";ZAIČIATA;6497373567;Taip;0;5;0;5
23885;"Kūlverstukas (Mindaugo g. 7)";ZAIČIATA;3660002342;Taip;0;0;10;10
23886;"Kūlverstukas (Mindaugo g. 7)";ZAIČIATA;5079635330;Taip;5;3;0;8
23887;"Kūlverstukas (Mindaugo g. 7)";ZAIČIATA;5879283662;Taip;0;0;3;3
23888;"Kūlverstukas (Mindaugo g. 7)";ZAIČIATA;3067918179;Ne;0;7;0;7
23889;"Kūlverstukas (Mindaugo g. 7)";ZAIČIATA;1776176097;Taip;4;0;4;8
23890;"Kūlverstukas (Mindaugo g. 7)";ZAIČIATA;6685524805;Taip;0;8;0;8
23891;"Kūlverstukas (Mindaugo g. 7)";SVETLIAČKI;6219872984;Taip;9;0;4;13
23892;"Kūlverstukas (Mindaugo g. 7)";SVETLIAČKI;9098427210;Taip;10;0;2;12
23893;"Kūlverstukas (Mindaugo g. 7)";SVETLIAČKI;2091204077;Ne;0;2;0;2
23894;"Kūlverstukas (Mindaugo g. 7)";SVETLIAČKI;70033583066;Taip;0;4;0;4
23895;"Kūlverstukas (Mindaugo g. 7)";SVETLIAČKI;2154916232;Taip;10;2;0;12
23896;"Kūlverstukas (Mindaugo g. 7)";SVETLIAČKI;6376189019;Taip;0;18;0;18
23897;"Kūlverstukas (Mindaugo g. 7)";SVETLIAČKI;5794471794;Taip;0;1;0;1
23898;"Kūlverstukas (Mindaugo g. 7)";SVETLIAČKI;1557237011;Taip;0;4;0;4
23899;"Kūlverstukas (Mindaugo g. 7)";SVETLIAČKI;8577197481;Taip;18;0;0;18
23900;"Kūlverstukas (Mindaugo g. 7)";SVETLIAČKI;3449300504;Taip;5;5;0;10
23901;"Kūlverstukas (Mindaugo g. 7)";SVETLIAČKI;1102996499;Taip;0;1;0;1
23902;"Kūlverstukas (Mindaugo g. 7)";SVETLIAČKI;6311116034;Taip;0;1;0;1
23903;"Kūlverstukas (Mindaugo g. 7)";SVETLIAČKI;5546604017;Taip;0;4;0;4
23904;"Kūlverstukas (Mindaugo g. 7)";SVETLIAČKI;1635418112;Taip;0;0;18;18
23905;"Kūlverstukas (Mindaugo g. 7)";ZVONOČKI;1486878343;Taip;0;5;1;6
23906;"Kūlverstukas (Mindaugo g. 7)";ZVONOČKI;8835111916;Taip;0;2;1;3
23907;"Kūlverstukas (Mindaugo g. 7)";ZVONOČKI;5724787637;Taip;0;2;0;2
23908;"Kūlverstukas (Mindaugo g. 7)";ZVONOČKI;4377803110;Taip;0;3;0;3
23909;"Kūlverstukas (Mindaugo g. 7)";ZVONOČKI;7898746258;Taip;0;2;1;3
23910;"Kūlverstukas (Mindaugo g. 7)";ZVONOČKI;9835391223;Taip;0;3;0;3
23911;"Kūlverstukas (Mindaugo g. 7)";ZVONOČKI;2429527586;Taip;0;0;11;11
23912;"Kūlverstukas (Mindaugo g. 7)";ZVONOČKI;5217751936;Taip;0;13;0;13
23913;"Kūlverstukas (Mindaugo g. 7)";ZVONOČKI;1566191212;Taip;0;1;0;1
23914;"Kūlverstukas (Mindaugo g. 7)";ZVONOČKI;9569296370;Taip;0;4;8;12
23915;"Kūlverstukas (Mindaugo g. 7)";ZVONOČKI;1047459617;Taip;0;4;0;4
23916;"Kūlverstukas (Mindaugo g. 7)";ZVONOČKI;9756326725;Taip;0;2;2;4
23917;"Kūlverstukas (Mindaugo g. 7)";ZVONOČKI;9156801640;Taip;0;2;16;18
23918;"Kūlverstukas (Mindaugo g. 7)";ZVONOČKI;1125206576;Taip;0;7;0;7
23919;"Kūlverstukas (Mindaugo g. 7)";ZVONOČKI;5728941778;Ne;0;2;0;2
23920;"Kūlverstukas (Mindaugo g. 7)";ZVONOČKI;5938022496;Ne;0;5;1;6
23921;"Vilniaus Pavilnio pagrindinė mokykla";"PRIEŠMOKYKLINĖ PL";2738553283;Taip;7;3;0;10
23922;"Vilniaus Pavilnio pagrindinė mokykla";"PRIEŠMOKYKLINĖ PL";2101902207;Taip;0;18;0;18
23923;"Vilniaus Pavilnio pagrindinė mokykla";"PRIEŠMOKYKLINĖ PL";1957926887;Taip;4;14;0;18
23924;"Vilniaus Pavilnio pagrindinė mokykla";"PRIEŠMOKYKLINĖ PL";1046606022;Taip;0;3;0;3
23925;"Vilniaus Pavilnio pagrindinė mokykla";"PRIEŠMOKYKLINĖ RU";4339607826;Ne;0;3;0;3
23926;"Vilniaus Pavilnio pagrindinė mokykla";"PRIEŠMOKYKLINĖ RU";3609961581;Taip;0;3;0;3
23927;"Vilniaus Pavilnio pagrindinė mokykla";"PRIEŠMOKYKLINĖ RU";1568915914;Taip;0;3;0;3
23928;"Vilniaus Pavilnio pagrindinė mokykla";"PRIEŠMOKYKLINĖ RU";5619763557;Ne;0;18;0;18
23929;"Vilniaus Pavilnio pagrindinė mokykla";"PRIEŠMOKYKLINĖ RU";9759761725;Ne;0;18;0;18
23930;"Vilniaus Pavilnio pagrindinė mokykla";"PRIEŠMOKYKLINĖ RU";3058369504;Ne;0;3;0;3
23931;"Vilniaus Pavilnio pagrindinė mokykla";"PRIEŠMOKYKLINĖ RU";9142513631;Taip;5;3;0;8
23932;"Vilniaus Pavilnio pagrindinė mokykla";"PRIEŠMOKYKLINĖ RU";5972567526;Taip;1;3;1;5
23933;"Vilniaus Pavilnio pagrindinė mokykla";"PRIEŠMOKYKLINĖ RU";2846917348;Taip;5;3;1;9
23934;"Vilniaus Pavilnio pagrindinė mokykla";"PRIEŠMOKYKLINĖ RU";6067622823;Taip;0;3;0;3
23935;"Vilniaus Pavilnio pagrindinė mokykla";"PRIEŠMOKYKLINĖ RU";3243226933;Taip;4;3;0;7
23936;"Vilniaus Pavilnio pagrindinė mokykla";"PRIEŠMOKYKLINĖ RU";7544963724;Taip;0;3;0;3
23937;"Vilniaus Pavilnio pagrindinė mokykla";"PRIEŠMOKYKLINĖ RU";6216663291;Taip;0;3;0;3
23938;"Vilniaus Pavilnio pagrindinė mokykla";"PRIEŠMOKYKLINĖ RU";3282845685;Taip;0;3;2;5
23939;"Vilniaus Šilo mokykla";Boružėlės;7122041826;Taip;6;4;0;10
23940;"Vilniaus Šilo mokykla";Boružėlės;9967276147;Taip;0;4;0;4
23941;"Vilniaus Šilo mokykla";Boružėlės;5962551687;Taip;3;4;0;7
23942;"Vilniaus Šilo mokykla";Boružėlės;1196172221;Ne;4;4;0;8
23943;"Vilniaus Šilo mokykla";Boružėlės;1538635985;Taip;18;4;0;22
23944;"Vilniaus Šilo mokykla";Boružėlės;6136087920;Taip;0;22;0;22
23945;"Vilniaus Šilo mokykla";Boružėlės;4544126354;Taip;15;4;0;19
23946;"Vilniaus Šilo mokykla";"1 spec.";1153167430;Taip;2;4;0;6
23947;"Vilniaus Šilo mokykla";"1 spec.";8863021708;Taip;2;4;0;6
23948;"Vilniaus Šilo mokykla";"1 spec.";4438939800;Taip;4;4;0;8
23949;"Vilniaus Šilo mokykla";"1 spec.";1971717759;Taip;11;4;0;15
23950;"Vilniaus Šilo mokykla";"1 spec.";2290889395;Taip;0;4;0;4
23951;"Vilniaus Šilo mokykla";"1 spec.";1180183091;Taip;0;22;0;22
23952;"Vilniaus Šilo mokykla";"6 lav.";29353956408;Taip;1;3;0;4
23953;"Vilniaus Šilo mokykla";"6 lav.";83007167743;Taip;1;3;0;4
23954;"Vilniaus Šilo mokykla";"6 lav.";67989956617;Taip;0;18;0;18
23955;"Vilniaus Šilo mokykla";"6 lav.";49892720109;Taip;2;3;0;5
23956;"Vilniaus Šilo mokykla";"6 lav.";3612746646;Taip;1;3;0;4
23957;"Vilniaus Šilo mokykla";"6 lav.";9054390753;Taip;0;3;0;3
23958;"Vilniaus Šilo mokykla";"6 lav.";2862598950;Ne;2;3;0;5
23959;"Vilniaus Šilo mokykla";"Priešmokyklinė grupė";5311183877;Taip;5;4;0;9
23960;"Vilniaus Šilo mokykla";"Priešmokyklinė grupė";1675384533;Taip;4;4;0;8
23961;"Vilniaus Šilo mokykla";"Priešmokyklinė grupė";3237698420;Taip;0;4;0;4
23962;"Vilniaus Šilo mokykla";"Priešmokyklinė grupė";2070454339;Ne;3;19;0;22
23963;"Vilniaus Šilo mokykla";"Priešmokyklinė grupė";8915901727;Taip;7;4;0;11
23964;"Vilniaus Šilo mokykla";"Priešmokyklinė grupė";9906750269;Taip;0;22;0;22
23965;Malūnėlis;BITUTĖS;1001575740;Taip;0;5;2;7
23966;Malūnėlis;BITUTĖS;8618778205;Taip;0;3;2;5
23967;Malūnėlis;BITUTĖS;2545930114;Taip;8;0;0;8
23968;Malūnėlis;BITUTĖS;3329510128;Taip;8;3;0;11
23969;Malūnėlis;BITUTĖS;5402027714;Taip;0;4;0;4
23970;Malūnėlis;BITUTĖS;6199265600;Taip;0;3;0;3
23971;Malūnėlis;BITUTĖS;6863437022;Taip;0;2;0;2
23972;Malūnėlis;BITUTĖS;5244586185;Ne;9;3;0;12
23973;Malūnėlis;BITUTĖS;7144098762;Taip;11;6;0;17
23974;Malūnėlis;BITUTĖS;1146723570;Taip;0;3;0;3
23975;Malūnėlis;BITUTĖS;9891418762;Taip;0;17;0;17
23976;Malūnėlis;BITUTĖS;8642960989;Taip;0;8;0;8
23977;Malūnėlis;BITUTĖS;5959610426;Taip;0;8;0;8
23978;Malūnėlis;BITUTĖS;4367009696;Taip;0;4;0;4
23979;Malūnėlis;BITUTĖS;5770511204;Taip;7;6;0;13
23980;Malūnėlis;BITUTĖS;9936144392;Taip;0;3;1;4
23981;Malūnėlis;BITUTĖS;1944670796;Taip;2;3;0;5
23982;Malūnėlis;BITUTĖS;5421090978;Taip;0;5;0;5
23983;Malūnėlis;BITUTĖS;8643210289;Taip;3;3;0;6
23984;Malūnėlis;BITUTĖS;8440160819;Taip;0;3;0;3
23985;Malūnėlis;BITUTĖS;1528972517;Taip;0;10;0;10
23986;Malūnėlis;BITUTĖS;4202723476;Taip;0;3;0;3
23987;Malūnėlis;BITUTĖS;8007350745;Taip;0;3;1;4
23988;Malūnėlis;BITUTĖS;9257812097;Taip;4;0;0;4
23989;Malūnėlis;VOVERIUKAI;4307232411;Taip;4;1;0;5
23990;Malūnėlis;VOVERIUKAI;3293082023;Taip;0;2;1;3
23991;Malūnėlis;VOVERIUKAI;6575258889;Taip;4;0;3;7
23992;Malūnėlis;VOVERIUKAI;1003043129;Taip;6;0;0;6
23993;Malūnėlis;VOVERIUKAI;7983537913;Taip;4;2;1;7
23994;Malūnėlis;VOVERIUKAI;9592117637;Taip;8;2;0;10
23995;Malūnėlis;VOVERIUKAI;9894452403;Taip;11;4;0;15
23996;Malūnėlis;VOVERIUKAI;2029506037;Taip;0;2;0;2
23997;Malūnėlis;VOVERIUKAI;9342720464;Taip;0;9;0;9
23998;Malūnėlis;VOVERIUKAI;2192305527;Taip;8;7;0;15
23999;Malūnėlis;VOVERIUKAI;6805587761;Taip;15;0;0;15
24000;Malūnėlis;VOVERIUKAI;3371260811;Taip;11;0;1;12
24001;Malūnėlis;VOVERIUKAI;5061720786;Taip;5;0;2;7
24002;Malūnėlis;VOVERIUKAI;5232728972;Taip;0;0;3;3
24003;Malūnėlis;VOVERIUKAI;2574604828;Taip;0;0;3;3
24004;Malūnėlis;VOVERIUKAI;3898518306;Taip;0;0;4;4
24005;Malūnėlis;VOVERIUKAI;1770049356;Taip;3;1;0;4
24006;Malūnėlis;VOVERIUKAI;5909022614;Taip;3;2;2;7
24007;Malūnėlis;VOVERIUKAI;8751365673;Ne;18;0;0;18
24008;Malūnėlis;VOVERIUKAI;6081634102;Taip;0;1;0;1
24009;Malūnėlis;BORUŽĖLĖS;7556990784;Taip;0;0;9;9
24010;Malūnėlis;BORUŽĖLĖS;1574941416;Taip;1;0;2;3
24011;Malūnėlis;BORUŽĖLĖS;1100719254;Taip;5;2;1;8
24012;Malūnėlis;BORUŽĖLĖS;2525923211;Taip;5;3;1;9
24013;Malūnėlis;BORUŽĖLĖS;6928976717;Taip;0;0;3;3
24014;Malūnėlis;BORUŽĖLĖS;6531364407;Taip;0;0;4;4
24015;Malūnėlis;BORUŽĖLĖS;2637299307;Taip;0;0;4;4
24016;Malūnėlis;BORUŽĖLĖS;8551271848;Taip;0;3;0;3
24017;Malūnėlis;BORUŽĖLĖS;8277245773;Taip;0;7;0;7
24018;Malūnėlis;BORUŽĖLĖS;5686301875;Taip;0;0;4;4
24019;Malūnėlis;BORUŽĖLĖS;1407908511;Ne;0;1;0;1
24020;Malūnėlis;BORUŽĖLĖS;4787212056;Taip;0;5;4;9
24021;Malūnėlis;BORUŽĖLĖS;7740957549;Taip;0;0;6;6
24022;Malūnėlis;BORUŽĖLĖS;5727725132;Taip;8;3;0;11
24023;Malūnėlis;Skruzdėliukų;2093908776;Taip;0;5;0;5
24024;Malūnėlis;Skruzdėliukų;9798968369;Taip;2;3;1;6
24025;Malūnėlis;Skruzdėliukų;1213476648;Taip;0;3;0;3
24026;Malūnėlis;Skruzdėliukų;9300944734;Taip;8;3;0;11
24027;Malūnėlis;Skruzdėliukų;5877882690;Taip;6;0;0;6
24028;Malūnėlis;Skruzdėliukų;9153589128;Taip;17;0;0;17
24029;Malūnėlis;Skruzdėliukų;5474437579;Taip;6;0;0;6
24030;Malūnėlis;Skruzdėliukų;1549241453;Taip;9;0;0;9
24031;Malūnėlis;Skruzdėliukų;4802771311;Taip;11;0;0;11
24032;Malūnėlis;Skruzdėliukų;9207327884;Ne;8;0;0;8
24033;Malūnėlis;Skruzdėliukų;6609446450;Taip;0;0;2;2
24034;Malūnėlis;Skruzdėliukų;5687585794;Taip;7;3;0;10
24035;Malūnėlis;Skruzdėliukų;3402561453;Ne;0;11;0;11
24036;Malūnėlis;Žirniukų;3791873303;Taip;0;8;1;9
24037;Malūnėlis;Žirniukų;3031849277;Taip;5;3;0;8
24038;Malūnėlis;Žirniukų;6747286787;Taip;3;0;0;3
24039;Malūnėlis;Žirniukų;4539998453;Taip;0;3;0;3
24040;Malūnėlis;Žirniukų;6943968536;Taip;0;3;0;3
24041;Malūnėlis;Žirniukų;4841028952;Ne;14;0;2;16
24042;Malūnėlis;Žirniukų;7097858329;Taip;0;3;0;3
24043;Malūnėlis;Žirniukų;1398391534;Taip;10;3;0;13
24044;Malūnėlis;Žirniukų;2961972215;Taip;0;3;2;5
24045;Malūnėlis;Žirniukų;3315571256;Taip;0;1;0;1
24046;Malūnėlis;Žirniukų;3315571256;Taip;0;1;0;1
24047;Malūnėlis;Žirniukų;3315571256;Taip;0;1;0;1
24048;Malūnėlis;Žirniukų;9941335615;Taip;7;1;2;10
24049;Malūnėlis;Žirniukų;3464224841;Taip;0;3;0;3
24050;Malūnėlis;Žirniukų;6047042736;Taip;0;3;1;4
24051;Malūnėlis;Žirniukų;6647872886;Taip;9;3;0;12
