Nr.;"Darželio pavadinimas";"Grupės pavadinimas";"Vaiko Identifikacinis Nr.";"Deklaruotas mieste";"Pateisintos dėl ligos";"Pateisintos dėl kitų priežasčių";"Nepateisintos dienos";"Praleistos dienos Viso"
1;Aitvaras;"VIJURKAI (ALERG.)";1877245088;Ne;5;9;0;14
2;Aitvaras;"VIJURKAI (ALERG.)";6936031222;Taip;5;0;0;5
3;Aitvaras;"VIJURKAI (ALERG.)";6214880713;Taip;0;2;0;2
4;Aitvaras;"VIJURKAI (ALERG.)";2566375128;Taip;0;1;0;1
5;Aitvaras;"VIJURKAI (ALERG.)";1879540041;Taip;8;3;0;11
6;Aitvaras;"VIJURKAI (ALERG.)";1532588441;Taip;0;3;0;3
7;Aitvaras;"VIJURKAI (ALERG.)";8206046301;Taip;0;0;2;2
8;Aitvaras;"VIJURKAI (ALERG.)";1347364985;Taip;9;0;0;9
9;Aitvaras;"VIJURKAI (ALERG.)";9157794193;Taip;12;5;0;17
10;Aitvaras;"VIJURKAI (ALERG.)";9562494357;Taip;0;2;0;2
11;Aitvaras;"VIJURKAI (ALERG.)";6021342178;Taip;6;3;0;9
12;Aitvaras;"VIJURKAI (ALERG.)";2650483861;Taip;5;0;0;5
13;Aitvaras;"VIJURKAI (ALERG.)";2601983670;Taip;0;1;0;1
14;Aitvaras;"VIJURKAI (ALERG.)";2895663259;Taip;8;0;0;8
15;Aitvaras;"VIJURKAI (ALERG.)";3570820823;Taip;5;1;0;6
16;Aitvaras;"VIJURKAI (ALERG.)";6444377924;Taip;9;1;0;10
17;Aitvaras;"VIJURKAI (ALERG.)";4702400490;Taip;8;0;0;8
18;Aitvaras;"SMALSUČIAI (ALERG.)";4868552034;Taip;0;3;0;3
19;Aitvaras;"SMALSUČIAI (ALERG.)";6166757095;Taip;0;4;1;5
20;Aitvaras;"SMALSUČIAI (ALERG.)";4480921300;Taip;0;9;1;10
21;Aitvaras;"SMALSUČIAI (ALERG.)";1019661577;Taip;0;2;0;2
22;Aitvaras;"SMALSUČIAI (ALERG.)";5425259260;Taip;5;4;0;9
23;Aitvaras;"SMALSUČIAI (ALERG.)";6201118021;Taip;0;2;0;2
24;Aitvaras;"SMALSUČIAI (ALERG.)";5750154036;Taip;7;3;0;10
25;Aitvaras;"SMALSUČIAI (ALERG.)";1275561645;Taip;0;1;0;1
26;Aitvaras;"SMALSUČIAI (ALERG.)";6084096300;Taip;0;6;1;7
27;Aitvaras;"SMALSUČIAI (ALERG.)";2004112424;Taip;10;6;0;16
28;Aitvaras;"SMALSUČIAI (ALERG.)";5330618557;Taip;13;0;0;13
29;Aitvaras;"SMALSUČIAI (ALERG.)";3488467265;Taip;0;4;0;4
30;Aitvaras;"SMALSUČIAI (ALERG.)";9745864667;Taip;0;1;0;1
31;Aitvaras;"SMALSUČIAI (ALERG.)";3535659630;Taip;0;6;0;6
32;Aitvaras;"SMALSUČIAI (ALERG.)";4833313373;Taip;0;0;1;1
33;Aitvaras;"SMALSUČIAI (ALERG.)";24247118884;Taip;0;4;0;4
34;Aitvaras;"SMALSUČIAI (ALERG.)";5389627560;Ne;13;2;3;18
35;Aitvaras;"SMALSUČIAI (ALERG.)";1636794584;Ne;0;4;0;4
36;Aitvaras;"SMALSUČIAI (ALERG.)";5956333024;Taip;0;2;0;2
37;Aitvaras;PADAUŽIUKAI;1494094426;Taip;3;6;0;9
38;Aitvaras;PADAUŽIUKAI;9332771711;Taip;0;2;0;2
39;Aitvaras;PADAUŽIUKAI;6550426644;Taip;8;9;0;17
40;Aitvaras;PADAUŽIUKAI;5818794912;Taip;0;2;0;2
41;Aitvaras;PADAUŽIUKAI;58780461337;Ne;0;2;3;5
42;Aitvaras;PADAUŽIUKAI;2034293999;Taip;15;4;0;19
43;Aitvaras;PADAUŽIUKAI;1116271183;Taip;0;1;0;1
44;Aitvaras;PADAUŽIUKAI;44046627149;Taip;0;3;0;3
45;Aitvaras;PADAUŽIUKAI;2804106417;Taip;0;5;0;5
46;Aitvaras;PADAUŽIUKAI;2711888522;Taip;0;5;0;5
47;Aitvaras;PADAUŽIUKAI;1996524718;Taip;2;1;0;3
48;Aitvaras;PADAUŽIUKAI;4110585744;Taip;0;2;0;2
49;Aitvaras;PADAUŽIUKAI;7469656671;Taip;0;2;0;2
50;Aitvaras;PADAUŽIUKAI;2408952971;Taip;13;0;0;13
51;Aitvaras;PADAUŽIUKAI;47875842134;Taip;0;1;0;1
52;Aitvaras;PADAUŽIUKAI;40799643122;Taip;5;4;0;9
53;Aitvaras;PADAUŽIUKAI;9015675095;Taip;0;4;0;4
54;Aitvaras;PADAUŽIUKAI;8503279655;Taip;0;1;4;5
55;Aitvaras;PADAUŽIUKAI;8121858940;Ne;0;1;0;1
56;Aitvaras;"AITVARIUKAI (ALERG.)";3639102842;Taip;0;4;0;4
57;Aitvaras;"AITVARIUKAI (ALERG.)";7243387750;Taip;0;11;0;11
58;Aitvaras;"AITVARIUKAI (ALERG.)";6587437949;Taip;0;10;0;10
59;Aitvaras;"AITVARIUKAI (ALERG.)";7461284958;Taip;0;1;0;1
60;Aitvaras;"AITVARIUKAI (ALERG.)";3394251305;Taip;0;3;0;3
61;Aitvaras;"AITVARIUKAI (ALERG.)";6459307767;Taip;1;1;0;2
62;Aitvaras;"AITVARIUKAI (ALERG.)";5635576679;Taip;0;9;0;9
63;Aitvaras;"AITVARIUKAI (ALERG.)";7988247429;Taip;0;1;0;1
64;Aitvaras;"AITVARIUKAI (ALERG.)";8770777328;Taip;0;17;0;17
65;Aitvaras;"AITVARIUKAI (ALERG.)";3653879553;Taip;4;2;1;7
66;Aitvaras;"AITVARIUKAI (ALERG.)";9721273154;Taip;11;0;0;11
67;Aitvaras;"AITVARIUKAI (ALERG.)";5103105065;Taip;17;0;0;17
68;Aitvaras;"AITVARIUKAI (ALERG.)";1859647003;Taip;10;0;0;10
69;Aitvaras;"AITVARIUKAI (ALERG.)";4777266938;Taip;10;0;0;10
70;Aitvaras;"AITVARIUKAI (ALERG.)";7568388141;Taip;0;4;0;4
71;Aitvaras;"AITVARIUKAI (ALERG.)";3954840915;Taip;4;3;0;7
72;Aitvaras;"AITVARIUKAI (ALERG.)";2146963673;Taip;12;0;0;12
73;Aitvaras;"AITVARIUKAI (ALERG.)";9763502346;Taip;13;0;1;14
74;Aitvaras;"AITVARIUKAI (ALERG.)";9228736015;Taip;0;1;0;1
75;Aitvaras;"AITVARIUKAI (ALERG.)";3775634117;Taip;4;0;0;4
76;Aitvaras;"AITVARIUKAI (ALERG.)";2615576367;Ne;15;0;0;15
77;Aitvaras;"SAULĖS ZUIKUČIAI  (ALERG.)";5711324951;Taip;0;4;0;4
78;Aitvaras;"SAULĖS ZUIKUČIAI  (ALERG.)";5619137905;Taip;2;2;0;4
79;Aitvaras;"SAULĖS ZUIKUČIAI  (ALERG.)";4106097701;Taip;0;2;0;2
80;Aitvaras;"SAULĖS ZUIKUČIAI  (ALERG.)";2184231202;Taip;0;6;0;6
81;Aitvaras;"SAULĖS ZUIKUČIAI  (ALERG.)";2478737835;Taip;0;0;8;8
82;Aitvaras;"SAULĖS ZUIKUČIAI  (ALERG.)";1136438927;Taip;0;3;1;4
83;Aitvaras;"SAULĖS ZUIKUČIAI  (ALERG.)";8137900398;Taip;4;1;0;5
84;Aitvaras;"SAULĖS ZUIKUČIAI  (ALERG.)";9147954612;Taip;0;6;0;6
85;Aitvaras;"SAULĖS ZUIKUČIAI  (ALERG.)";2511844613;Taip;10;1;0;11
86;Aitvaras;"SAULĖS ZUIKUČIAI  (ALERG.)";7907357058;Taip;11;0;2;13
87;Aitvaras;"SAULĖS ZUIKUČIAI  (ALERG.)";9534206000;Taip;4;11;0;15
88;Aitvaras;"SAULĖS ZUIKUČIAI  (ALERG.)";3737054758;Taip;16;0;0;16
89;Aitvaras;"SAULĖS ZUIKUČIAI  (ALERG.)";9271534775;Taip;5;0;0;5
90;Aitvaras;"SAULĖS ZUIKUČIAI  (ALERG.)";8849563638;Taip;0;4;0;4
91;Aitvaras;"SAULĖS ZUIKUČIAI  (ALERG.)";6950820937;Taip;7;10;1;18
92;Aitvaras;"SAULĖS ZUIKUČIAI  (ALERG.)";5283056036;Taip;2;1;0;3
93;Aitvaras;"SAULĖS ZUIKUČIAI  (ALERG.)";5252728205;Taip;5;0;0;5
94;Aitvaras;"SAULĖS ZUIKUČIAI  (ALERG.)";2744696131;Taip;3;10;0;13
95;Aitvaras;"SAULĖS ZUIKUČIAI  (ALERG.)";2373509019;Taip;11;0;4;15
96;Aitvaras;"SAULĖS ZUIKUČIAI  (ALERG.)";2624566766;Taip;5;0;0;5
97;Aitvaras;"SAULĖS ZUIKUČIAI  (ALERG.)";3677551059;Taip;2;2;0;4
98;Aitvaras;"ŽEMYNUKAI (ALERG.)";8567255042;Ne;5;1;0;6
99;Aitvaras;"ŽEMYNUKAI (ALERG.)";6218019092;Taip;0;4;4;8
100;Aitvaras;"ŽEMYNUKAI (ALERG.)";7560642918;Taip;6;1;0;7
101;Aitvaras;"ŽEMYNUKAI (ALERG.)";3820930777;Taip;32;0;0;32
102;Aitvaras;"ŽEMYNUKAI (ALERG.)";6624986090;Taip;0;6;8;14
103;Aitvaras;"ŽEMYNUKAI (ALERG.)";4733627644;Taip;10;8;0;18
104;Aitvaras;"ŽEMYNUKAI (ALERG.)";3104109370;Taip;0;0;4;4
105;Aitvaras;"ŽEMYNUKAI (ALERG.)";7853714142;Taip;10;2;0;12
106;Aitvaras;"ŽEMYNUKAI (ALERG.)";1949144346;Taip;8;3;1;12
107;Aitvaras;"ŽEMYNUKAI (ALERG.)";8641433486;Taip;8;0;3;11
108;Aitvaras;"ŽEMYNUKAI (ALERG.)";9947610763;Taip;0;2;0;2
109;Aitvaras;"ŽEMYNUKAI (ALERG.)";7113016866;Taip;5;3;0;8
110;Aitvaras;"ŽEMYNUKAI (ALERG.)";4377666052;Taip;0;8;2;10
111;Aitvaras;"ŽEMYNUKAI (ALERG.)";8333823078;Taip;7;2;0;9
112;Aitvaras;"ŽEMYNUKAI (ALERG.)";5623106419;Taip;0;1;1;2
113;Aitvaras;"ŽEMYNUKAI (ALERG.)";5351333397;Taip;5;11;0;16
114;Aitvaras;"ŽEMYNUKAI (ALERG.)";2065988478;Taip;5;0;2;7
115;Aitvaras;"ŽEMYNUKAI (ALERG.)";3635354769;Taip;13;4;7;24
116;Aitvaras;"ŽEMYNUKAI (ALERG.)";3851322849;Taip;0;0;1;1
117;Aitvaras;"ŽEMYNUKAI (ALERG.)";7889947603;Taip;10;0;1;11
118;Aitvaras;"ŽEMYNUKAI (ALERG.)";2830321404;Taip;17;12;0;29
119;Aitvaras;"LINKSMUČIAI (ALERG.)";7109001184;Taip;1;0;0;1
120;Aitvaras;"LINKSMUČIAI (ALERG.)";5378212904;Taip;5;1;0;6
121;Aitvaras;"LINKSMUČIAI (ALERG.)";3655710511;Taip;0;2;0;2
122;Aitvaras;"LINKSMUČIAI (ALERG.)";1091372798;Taip;0;4;0;4
123;Aitvaras;"LINKSMUČIAI (ALERG.)";8666824607;Taip;0;4;0;4
124;Aitvaras;"LINKSMUČIAI (ALERG.)";5612991255;Taip;0;3;0;3
125;Aitvaras;"LINKSMUČIAI (ALERG.)";7260577885;Taip;0;2;3;5
126;Aitvaras;"LINKSMUČIAI (ALERG.)";1115202169;Taip;6;0;0;6
127;Aitvaras;"LINKSMUČIAI (ALERG.)";2760970218;Taip;0;1;0;1
128;Aitvaras;"LINKSMUČIAI (ALERG.)";4120515569;Taip;16;2;0;18
129;Aitvaras;"LINKSMUČIAI (ALERG.)";9885781306;Taip;0;2;0;2
130;Aitvaras;"LINKSMUČIAI (ALERG.)";4564723798;Taip;1;0;1;2
131;Aitvaras;"LINKSMUČIAI (ALERG.)";4612994715;Taip;4;0;3;7
132;Aitvaras;"LINKSMUČIAI (ALERG.)";4176681907;Taip;0;11;0;11
133;Aitvaras;"LINKSMUČIAI (ALERG.)";2547934790;Taip;5;0;0;5
134;Aitvaras;"LINKSMUČIAI (ALERG.)";2357399981;Ne;21;0;2;23
135;Aitvaras;"LINKSMUČIAI (ALERG.)";5572538840;Taip;0;11;0;11
136;Aitvaras;"LINKSMUČIAI (ALERG.)";4114397590;Taip;0;3;0;3
137;Aitvaras;NAMINUKAI;3053557807;Taip;11;0;0;11
138;Aitvaras;NAMINUKAI;6126913961;Taip;6;1;0;7
139;Aitvaras;NAMINUKAI;3347213578;Taip;3;4;0;7
140;Aitvaras;NAMINUKAI;9024245490;Taip;4;0;0;4
141;Aitvaras;NAMINUKAI;8512502118;Taip;3;1;0;4
142;Aitvaras;NAMINUKAI;1376605323;Taip;0;1;0;1
143;Aitvaras;NAMINUKAI;6060880045;Taip;0;1;0;1
144;Aitvaras;NAMINUKAI;2821221241;Taip;5;0;0;5
145;Aitvaras;NAMINUKAI;9039303562;Taip;0;2;4;6
146;Aitvaras;NAMINUKAI;6080549524;Taip;0;2;4;6
147;Aitvaras;NAMINUKAI;6048701733;Taip;5;0;0;5
148;Aitvaras;NAMINUKAI;6110226958;Taip;0;0;1;1
149;Aitvaras;NAMINUKAI;4555281655;Taip;0;1;0;1
150;Aitvaras;NAMINUKAI;8043062737;Ne;3;1;0;4
151;Aitvaras;NAMINUKAI;3005447572;Taip;0;3;0;3
152;Aitvaras;NAMINUKAI;1549552392;Taip;10;1;0;11
153;Aitvaras;NAMINUKAI;4498792867;Taip;0;2;0;2
154;Aitvaras;NAMINUKAI;9490714865;Ne;0;7;0;7
155;Aitvaras;NAMINUKAI;1498630458;Taip;0;2;1;3
156;Aitvaras;NAMINUKAI;5967188507;Ne;0;1;5;6
157;Aitvaras;NAMINUKAI;5161069611;Taip;0;1;1;2
158;Aitvaras;NAMINUKAI;7934344218;Taip;5;1;0;6
159;Aitvaras;NAMINUKAI;6279152796;Taip;5;1;0;6
160;Aitvaras;ŠELMIAI;4984058405;Taip;8;2;0;10
161;Aitvaras;ŠELMIAI;9725401255;Taip;8;0;1;9
162;Aitvaras;ŠELMIAI;4547342872;Taip;2;2;2;6
163;Aitvaras;ŠELMIAI;5684526288;Taip;5;1;0;6
164;Aitvaras;ŠELMIAI;5601517340;Taip;0;1;0;1
165;Aitvaras;ŠELMIAI;1019103539;Taip;0;2;0;2
166;Aitvaras;ŠELMIAI;2185746898;Taip;0;5;0;5
167;Aitvaras;ŠELMIAI;8756012613;Taip;0;4;0;4
168;Aitvaras;ŠELMIAI;1203732956;Taip;7;0;0;7
169;Aitvaras;ŠELMIAI;5782609781;Taip;0;1;0;1
170;Aitvaras;ŠELMIAI;7805819121;Taip;0;3;0;3
171;Aitvaras;ŠELMIAI;8558414510;Taip;5;0;0;5
172;Aitvaras;ŠELMIAI;4551774368;Taip;5;0;0;5
173;Aitvaras;ŠELMIAI;4158520145;Taip;0;2;0;2
174;Aitvaras;ŠELMIAI;7352233454;Taip;5;0;0;5
175;Aitvaras;ŠELMIAI;1901118931;Taip;0;2;0;2
176;Aitvaras;ŠELMIAI;4812423010;Taip;5;5;3;13
177;Aitvaras;ŠELMIAI;1112142035;Taip;0;2;7;9
178;Aitvaras;ŠELMIAI;8644983502;Taip;14;3;0;17
179;Aitvaras;ŠELMIAI;9295561516;Taip;0;5;0;5
180;Aitvaras;ŠELMIAI;6188186413;Taip;16;1;0;17
181;Aitvaras;KODĖLČIUKAI;6214572150;Taip;11;0;0;11
182;Aitvaras;KODĖLČIUKAI;3323458595;Taip;0;2;0;2
183;Aitvaras;KODĖLČIUKAI;8065540507;Taip;5;0;2;7
184;Aitvaras;KODĖLČIUKAI;1288810999;Taip;0;0;3;3
185;Aitvaras;KODĖLČIUKAI;6501943902;Taip;8;2;0;10
186;Aitvaras;KODĖLČIUKAI;3101015381;Ne;5;0;2;7
187;Aitvaras;KODĖLČIUKAI;7777235021;Taip;0;1;0;1
188;Aitvaras;KODĖLČIUKAI;5641224483;Taip;0;3;0;3
189;Aitvaras;KODĖLČIUKAI;1830134108;Ne;0;10;1;11
190;Aitvaras;KODĖLČIUKAI;3178965623;Taip;4;3;0;7
191;Aitvaras;KODĖLČIUKAI;5905456814;Taip;0;2;0;2
192;Aitvaras;KODĖLČIUKAI;1761446849;Taip;20;0;0;20
193;Aitvaras;KODĖLČIUKAI;6739827530;Taip;19;0;0;19
194;Aitvaras;KODĖLČIUKAI;2807595769;Taip;7;2;0;9
195;Aitvaras;KODĖLČIUKAI;1252145346;Taip;10;0;0;10
196;Aitvaras;KODĖLČIUKAI;7455895024;Taip;9;0;1;10
197;Aitvaras;KODĖLČIUKAI;8439586875;Taip;0;3;0;3
198;Aitvaras;KODĖLČIUKAI;2328771385;Taip;4;5;0;9
199;Aitvaras;KODĖLČIUKAI;1594675221;Taip;13;1;0;14
200;Aitvaras;KODĖLČIUKAI;5922357091;Taip;4;3;1;8
201;Aitvaras;PABIRUČIAI;1495399113;Taip;8;0;0;8
202;Aitvaras;PABIRUČIAI;7136674662;Taip;0;3;0;3
203;Aitvaras;PABIRUČIAI;9949206639;Taip;4;0;8;12
204;Aitvaras;PABIRUČIAI;4613021421;Taip;4;4;0;8
205;Aitvaras;PABIRUČIAI;2887681961;Taip;15;4;0;19
206;Aitvaras;PABIRUČIAI;7922937851;Taip;7;1;0;8
207;Aitvaras;PABIRUČIAI;4085134058;Taip;9;0;0;9
208;Aitvaras;PABIRUČIAI;8746884740;Taip;4;0;1;5
209;Aitvaras;PABIRUČIAI;4163871634;Taip;5;8;0;13
210;Aitvaras;PABIRUČIAI;3988226974;Taip;5;8;0;13
211;Aitvaras;PABIRUČIAI;2239387580;Taip;5;1;0;6
212;Aitvaras;PABIRUČIAI;6119148164;Taip;11;1;4;16
213;Aitvaras;PABIRUČIAI;2892898328;Taip;15;0;0;15
214;Aitvaras;PABIRUČIAI;3749008647;Taip;14;1;0;15
215;Aitvaras;PABIRUČIAI;4760801928;Taip;5;1;1;7
216;Aitvaras;PABIRUČIAI;1599296739;Taip;5;1;5;11
217;Aitvaras;"SVAJOKLIAI  (ALERG.)";3429046261;Taip;3;0;0;3
218;Aitvaras;"SVAJOKLIAI  (ALERG.)";5659897032;Taip;12;0;0;12
219;Aitvaras;"SVAJOKLIAI  (ALERG.)";4618560397;Taip;3;2;0;5
220;Aitvaras;"SVAJOKLIAI  (ALERG.)";7745736525;Taip;0;0;1;1
221;Aitvaras;"SVAJOKLIAI  (ALERG.)";9209862610;Taip;13;0;1;14
222;Aitvaras;"SVAJOKLIAI  (ALERG.)";6191938291;Taip;12;0;3;15
223;Aitvaras;"SVAJOKLIAI  (ALERG.)";7006713502;Taip;7;1;0;8
224;Aitvaras;"SVAJOKLIAI  (ALERG.)";3923601422;Taip;5;1;0;6
225;Aitvaras;"SVAJOKLIAI  (ALERG.)";5790551266;Taip;11;1;0;12
226;Aitvaras;"SVAJOKLIAI  (ALERG.)";8965957442;Taip;17;0;0;17
227;Aitvaras;"SVAJOKLIAI  (ALERG.)";3891067128;Taip;8;0;0;8
228;Aitvaras;"SVAJOKLIAI  (ALERG.)";1030872812;Taip;5;0;0;5
229;Aitvaras;"SVAJOKLIAI  (ALERG.)";5255843693;Taip;6;0;0;6
230;Aitvaras;"SVAJOKLIAI  (ALERG.)";1448307414;Taip;5;0;0;5
231;Aitvaras;"SVAJOKLIAI  (ALERG.)";2839442228;Ne;7;0;0;7
232;Aitvaras;"SVAJOKLIAI  (ALERG.)";5593105541;Taip;0;1;3;4
233;Aitvaras;"SVAJOKLIAI  (ALERG.)";8963214183;Taip;10;0;0;10
234;Aitvaras;"SVAJOKLIAI  (ALERG.)";6319953077;Taip;8;0;0;8
235;Aitvaras;"SVAJOKLIAI  (ALERG.)";1131690624;Taip;7;0;0;7
236;Aitvaras;"SVAJOKLIAI  (ALERG.)";4801034095;Taip;6;2;0;8
237;Atžalėlės;Gėlytės;4284673729;Taip;4;19;0;23
238;Atžalėlės;Gėlytės;8695865604;Taip;0;6;0;6
239;Atžalėlės;Gėlytės;2385614957;Taip;5;0;1;6
240;Atžalėlės;Gėlytės;5432433423;Taip;2;7;0;9
241;Atžalėlės;Gėlytės;9715625283;Taip;0;4;0;4
242;Atžalėlės;Gėlytės;6024189665;Ne;0;14;8;22
243;Atžalėlės;Gėlytės;4682216852;Taip;0;0;1;1
244;Atžalėlės;Gėlytės;2131592139;Taip;3;0;3;6
245;Atžalėlės;Gėlytės;1500456945;Taip;0;6;4;10
246;Atžalėlės;Gėlytės;1722233272;Taip;0;7;0;7
247;Atžalėlės;Gėlytės;5310990513;Taip;2;3;0;5
248;Atžalėlės;Gėlytės;7702502252;Ne;9;10;0;19
249;Atžalėlės;Gėlytės;9189223222;Taip;10;5;0;15
250;Atžalėlės;Gėlytės;3283415814;Taip;0;7;0;7
251;Atžalėlės;Gėlytės;1146492807;Taip;6;0;4;10
252;Atžalėlės;Gėlytės;3870758086;Taip;0;4;0;4
253;Atžalėlės;Gėlytės;6202250600;Ne;0;0;5;5
254;Atžalėlės;Gėlytės;4098210138;Taip;1;0;1;2
255;Atžalėlės;Gėlytės;5742471497;Taip;0;0;7;7
256;Atžalėlės;Gėlytės;1137741059;Taip;4;0;0;4
257;Atžalėlės;Gėlytės;4238773173;Taip;0;3;3;6
258;Atžalėlės;Drugeliai;4643154006;Taip;3;3;0;6
259;Atžalėlės;Drugeliai;6903666624;Taip;1;3;1;5
260;Atžalėlės;Drugeliai;6782007470;Taip;0;13;0;13
261;Atžalėlės;Drugeliai;1805496887;Taip;8;0;2;10
262;Atžalėlės;Drugeliai;7953922166;Taip;4;3;0;7
263;Atžalėlės;Drugeliai;9222670655;Taip;6;0;0;6
264;Atžalėlės;Drugeliai;77261118958;Taip;0;1;2;3
265;Atžalėlės;Drugeliai;1429493246;Taip;0;8;0;8
266;Atžalėlės;Drugeliai;6114426973;Taip;0;5;0;5
267;Atžalėlės;Drugeliai;1456979448;Taip;0;3;0;3
268;Atžalėlės;Drugeliai;4032519781;Taip;5;6;0;11
269;Atžalėlės;Drugeliai;7756889911;Taip;0;0;6;6
270;Atžalėlės;Drugeliai;5063094678;Taip;5;3;0;8
271;Atžalėlės;Drugeliai;3422605135;Taip;0;0;3;3
272;Atžalėlės;Drugeliai;8718036014;Taip;7;5;0;12
273;Atžalėlės;Drugeliai;4884599397;Taip;7;5;0;12
274;Atžalėlės;Drugeliai;4902947406;Taip;0;1;2;3
275;Atžalėlės;Drugeliai;9463215947;Taip;5;1;0;6
276;Atžalėlės;Drugeliai;6570245757;Taip;8;1;1;10
277;Atžalėlės;Drugeliai;6695872204;Taip;14;4;0;18
278;Atžalėlės;Drugeliai;6393090675;Taip;18;3;0;21
279;Atžalėlės;Gandriukai;2083260403;Taip;0;23;0;23
280;Atžalėlės;Gandriukai;2078549599;Taip;1;0;0;1
281;Atžalėlės;Gandriukai;5119260525;Taip;0;0;4;4
282;Atžalėlės;Gandriukai;1024559742;Taip;4;0;1;5
283;Atžalėlės;Gandriukai;7510951079;Taip;14;4;0;18
284;Atžalėlės;Gandriukai;6594440062;Taip;12;0;1;13
285;Atžalėlės;Gandriukai;4293557144;Taip;0;0;14;14
286;Atžalėlės;Gandriukai;6211002805;Taip;2;0;5;7
287;Atžalėlės;Gandriukai;1305611902;Taip;1;0;0;1
288;Atžalėlės;Gandriukai;5102163688;Taip;0;0;18;18
289;Atžalėlės;Gandriukai;6597540627;Taip;7;0;1;8
290;Atžalėlės;Voveriukai;1865339755;Taip;0;0;2;2
291;Atžalėlės;Voveriukai;4467364336;Taip;0;2;2;4
292;Atžalėlės;Voveriukai;8847754477;Taip;2;11;0;13
293;Atžalėlės;Voveriukai;3795729265;Taip;8;5;5;18
294;Atžalėlės;Voveriukai;8201582382;Taip;0;3;2;5
295;Atžalėlės;Voveriukai;4362058013;Taip;0;3;2;5
296;Atžalėlės;Voveriukai;8819893830;Taip;0;1;1;2
297;Atžalėlės;Voveriukai;3069192413;Taip;7;0;9;16
298;Atžalėlės;Voveriukai;2067246260;Taip;0;3;4;7
299;Atžalėlės;Voveriukai;7532672266;Taip;0;0;2;2
300;Atžalėlės;Voveriukai;5705303891;Ne;4;2;0;6
301;Atžalėlės;Voveriukai;5650427433;Taip;0;1;0;1
302;Atžalėlės;Voveriukai;6975941393;Taip;0;1;1;2
303;Atžalėlės;Voveriukai;8138683218;Taip;0;8;0;8
304;Atžalėlės;Voveriukai;7689394485;Taip;0;3;0;3
305;Atžalėlės;Voveriukai;2662384275;Taip;0;1;0;1
306;Atžalėlės;Voveriukai;4996777116;Taip;0;1;4;5
307;Atžalėlės;Voveriukai;1426744251;Taip;5;0;0;5
308;Atžalėlės;Voveriukai;6684979914;Taip;3;2;0;5
309;Atžalėlės;Voveriukai;8470059012;Ne;0;3;4;7
310;Atžalėlės;Voveriukai;5767549779;Taip;0;3;0;3
311;Atžalėlės;Žirniukai;5584105084;Taip;0;0;1;1
312;Atžalėlės;Žirniukai;9967641617;Taip;0;5;0;5
313;Atžalėlės;Žirniukai;9508110719;Taip;4;0;1;5
314;Atžalėlės;Žirniukai;9085453655;Taip;0;2;0;2
315;Atžalėlės;Žirniukai;1538643591;Taip;19;0;0;19
316;Atžalėlės;Žirniukai;3143856911;Taip;0;6;0;6
317;Atžalėlės;Žirniukai;1212074068;Taip;16;0;0;16
318;Atžalėlės;Žirniukai;9736390705;Taip;4;0;3;7
319;Atžalėlės;Žirniukai;4661388894;Taip;0;5;0;5
320;Atžalėlės;Žirniukai;7196464328;Taip;0;0;4;4
321;Atžalėlės;Žirniukai;7522643082;Taip;2;0;0;2
322;Atžalėlės;Žirniukai;7613931447;Taip;2;0;0;2
323;Atžalėlės;Žirniukai;6723689098;Taip;6;3;0;9
324;Atžalėlės;Žirniukai;9281138840;Taip;0;0;1;1
325;Atžalėlės;Žirniukai;7018297883;Taip;0;0;1;1
326;Atžalėlės;Ežiukai;9053620501;Taip;5;0;6;11
327;Atžalėlės;Ežiukai;9054589111;Taip;0;1;0;1
328;Atžalėlės;Ežiukai;9346744866;Ne;4;2;0;6
329;Atžalėlės;Ežiukai;1505286928;Taip;15;4;0;19
330;Atžalėlės;Ežiukai;4148412941;Taip;0;0;1;1
331;Atžalėlės;Ežiukai;3333808381;Taip;4;0;0;4
332;Atžalėlės;Ežiukai;1710646812;Taip;8;0;2;10
333;Atžalėlės;Ežiukai;9481268935;Taip;5;0;1;6
334;Atžalėlės;Ežiukai;6447615639;Taip;0;1;0;1
335;Atžalėlės;Ežiukai;5972419628;Taip;0;2;0;2
336;Atžalėlės;Ežiukai;3738127350;Taip;0;0;7;7
337;Atžalėlės;Ežiukai;1423254771;Taip;0;3;2;5
338;Atžalėlės;Ežiukai;1614261572;Ne;0;6;0;6
339;Atžalėlės;Ežiukai;6665199013;Taip;0;3;0;3
340;Atžalėlės;Ežiukai;8145965849;Taip;8;0;0;8
341;Atžalėlės;Ežiukai;6108989129;Taip;0;0;1;1
342;Atžalėlės;Ežiukai;5174826594;Taip;5;0;0;5
343;Atžalėlės;Ežiukai;7501772398;Taip;0;0;1;1
344;Atžalėlės;Paukšteliai;7807313362;Taip;0;0;5;5
345;Atžalėlės;Paukšteliai;6537864486;Taip;8;0;0;8
346;Atžalėlės;Paukšteliai;8768704484;Taip;0;5;2;7
347;Atžalėlės;Paukšteliai;6675588261;Taip;8;5;1;14
348;Atžalėlės;Paukšteliai;8524244526;Taip;5;1;2;8
349;Atžalėlės;Paukšteliai;7321516783;Taip;5;0;0;5
350;Atžalėlės;Paukšteliai;6265777690;Taip;0;2;0;2
351;Atžalėlės;Paukšteliai;8512283024;Taip;8;0;0;8
352;Atžalėlės;Paukšteliai;2078781673;Taip;0;1;2;3
353;Atžalėlės;Paukšteliai;1520206753;Taip;3;0;8;11
354;Atžalėlės;Paukšteliai;4790322154;Taip;0;2;0;2
355;Atžalėlės;Paukšteliai;9327437508;Taip;0;11;8;19
356;Atžalėlės;Paukšteliai;4392352210;Taip;5;0;11;16
357;Atžalėlės;Paukšteliai;1774212280;Taip;23;0;0;23
358;Atžalėlės;Meškiukai;8586739429;Taip;2;0;0;2
359;Atžalėlės;Meškiukai;2617568019;Ne;0;1;3;4
360;Atžalėlės;Meškiukai;8619613890;Taip;3;0;0;3
361;Atžalėlės;Meškiukai;3281114596;Taip;0;13;0;13
362;Atžalėlės;Meškiukai;5466374223;Taip;0;0;6;6
363;Atžalėlės;Meškiukai;2433029299;Taip;3;0;1;4
364;Atžalėlės;Meškiukai;5682652546;Taip;0;0;20;20
365;Atžalėlės;Meškiukai;9631336340;Taip;17;0;0;17
366;Atžalėlės;Meškiukai;2930612059;Ne;0;0;11;11
367;Atžalėlės;Meškiukai;6385777303;Ne;5;0;2;7
368;Atžalėlės;Meškiukai;2569491645;Taip;0;1;0;1
369;Atžalėlės;Meškiukai;1431197358;Taip;2;10;0;12
370;Atžalėlės;Meškiukai;4177753994;Taip;1;0;3;4
371;Atžalėlės;Meškiukai;3982090601;Taip;5;0;1;6
372;Atžalėlės;Meškiukai;3743308789;Taip;14;0;0;14
373;Atžalėlės;Meškiukai;2228759708;Ne;13;0;5;18
374;Atžalėlės;Meškiukai;7936991925;Taip;6;0;0;6
375;Atžalėlės;Meškiukai;8976815736;Taip;0;3;0;3
376;Atžalėlės;"BITUTĖS (MODULINĖ)";8707875125;Taip;0;16;0;16
377;Atžalėlės;"BITUTĖS (MODULINĖ)";8060332402;Taip;1;0;2;3
378;Atžalėlės;"BITUTĖS (MODULINĖ)";8396693160;Taip;5;0;0;5
379;Atžalėlės;"BITUTĖS (MODULINĖ)";6253257539;Taip;6;0;0;6
380;Atžalėlės;"BITUTĖS (MODULINĖ)";7052938312;Taip;0;0;2;2
381;Atžalėlės;"BITUTĖS (MODULINĖ)";3559977339;Taip;5;0;1;6
382;Atžalėlės;"BITUTĖS (MODULINĖ)";5593774275;Taip;15;0;0;15
383;Atžalėlės;"BITUTĖS (MODULINĖ)";8129858229;Taip;4;0;0;4
384;Atžalėlės;"BITUTĖS (MODULINĖ)";1939076303;Taip;7;0;1;8
385;Atžalėlės;"BITUTĖS (MODULINĖ)";2322329918;Taip;0;0;3;3
386;Atžalėlės;"BITUTĖS (MODULINĖ)";5148142239;Taip;0;0;3;3
387;Atžalėlės;"ŠYPSENĖLĖS (MODULINĖ)";4071402757;Taip;1;0;1;2
388;Atžalėlės;"ŠYPSENĖLĖS (MODULINĖ)";1943349835;Taip;0;0;5;5
389;Atžalėlės;"ŠYPSENĖLĖS (MODULINĖ)";8564143904;Taip;5;0;4;9
390;Atžalėlės;"ŠYPSENĖLĖS (MODULINĖ)";2298114905;Taip;4;0;0;4
391;Atžalėlės;"ŠYPSENĖLĖS (MODULINĖ)";7159628246;Taip;7;0;1;8
392;Atžalėlės;"ŠYPSENĖLĖS (MODULINĖ)";3299724612;Taip;4;0;0;4
393;Atžalėlės;"BORUŽIUKAI (MODULINĖ)";3198845538;Taip;10;1;1;12
394;Atžalėlės;"BORUŽIUKAI (MODULINĖ)";8681809797;Taip;15;3;0;18
395;Atžalėlės;"BORUŽIUKAI (MODULINĖ)";3590987364;Taip;12;0;3;15
396;Atžalėlės;"BORUŽIUKAI (MODULINĖ)";1383944713;Taip;11;0;1;12
397;Atžalėlės;"BORUŽIUKAI (MODULINĖ)";5582697993;Taip;0;1;0;1
398;Atžalėlės;"BORUŽIUKAI (MODULINĖ)";9201449702;Taip;0;0;6;6
399;Atžalėlės;"BORUŽIUKAI (MODULINĖ)";7980775632;Ne;0;8;0;8
400;Atžalėlės;"SAULUTĖS (MODULINĖ)";4268941401;Taip;2;0;12;14
401;Atžalėlės;"SAULUTĖS (MODULINĖ)";2306086573;Ne;5;0;4;9
402;Atžalėlės;"SAULUTĖS (MODULINĖ)";8385741531;Taip;5;0;7;12
403;Atžalėlės;"SAULUTĖS (MODULINĖ)";8460997063;Taip;0;1;0;1
404;Atžalėlės;"SAULUTĖS (MODULINĖ)";5490741021;Taip;5;2;0;7
405;Aušrelė;PASAKIUKAI;1659335142;Taip;0;1;2;3
406;Aušrelė;PASAKIUKAI;2974714806;Taip;0;0;1;1
407;Aušrelė;PASAKIUKAI;6037757548;Taip;0;0;3;3
408;Aušrelė;PASAKIUKAI;7682402576;Taip;0;3;2;5
409;Aušrelė;PASAKIUKAI;1408751702;Taip;0;2;0;2
410;Aušrelė;PASAKIUKAI;6995749373;Ne;0;4;0;4
411;Aušrelė;PASAKIUKAI;8372554796;Taip;0;5;0;5
412;Aušrelė;PASAKIUKAI;1502146844;Taip;0;3;0;3
413;Aušrelė;PASAKIUKAI;8230362307;Taip;0;3;0;3
414;Aušrelė;PASAKIUKAI;4306578299;Taip;0;4;0;4
415;Aušrelė;PASAKIUKAI;6277405405;Taip;0;11;3;14
416;Aušrelė;PASAKIUKAI;34891640909;Taip;0;3;3;6
417;Aušrelė;PASAKIUKAI;2125080379;Taip;2;3;4;9
418;Aušrelė;PASAKIUKAI;3165692699;Taip;4;2;0;6
419;Aušrelė;BORUŽĖLĖS;6673034329;Taip;11;3;0;14
420;Aušrelė;BORUŽĖLĖS;4957581753;Taip;0;3;0;3
421;Aušrelė;BORUŽĖLĖS;1928260563;Taip;0;4;0;4
422;Aušrelė;BORUŽĖLĖS;8243716759;Taip;0;3;0;3
423;Aušrelė;BORUŽĖLĖS;1549962200;Taip;0;13;0;13
424;Aušrelė;BORUŽĖLĖS;4505922394;Taip;1;3;1;5
425;Aušrelė;BORUŽĖLĖS;7190665397;Taip;0;3;6;9
426;Aušrelė;BORUŽĖLĖS;2991828434;Taip;0;2;0;2
427;Aušrelė;BORUŽĖLĖS;5358315970;Taip;0;3;0;3
428;Aušrelė;BORUŽĖLĖS;8030685444;Taip;0;5;3;8
429;Aušrelė;BORUŽĖLĖS;1814972981;Taip;0;2;6;8
430;Aušrelė;SMALSUČIAI;6761263775;Taip;12;4;0;16
431;Aušrelė;SMALSUČIAI;3015028879;Taip;0;23;0;23
432;Aušrelė;SMALSUČIAI;5935579452;Taip;6;0;0;6
433;Aušrelė;SMALSUČIAI;2863655361;Taip;13;3;0;16
434;Aušrelė;SMALSUČIAI;2390128933;Taip;4;0;0;4
435;Aušrelė;SMALSUČIAI;8503309819;Taip;0;2;0;2
436;Aušrelė;SMALSUČIAI;2827216981;Taip;0;8;0;8
437;Aušrelė;SMALSUČIAI;9443641849;Taip;8;2;0;10
438;Aušrelė;SMALSUČIAI;7930717076;Taip;10;3;0;13
439;Aušrelė;SMALSUČIAI;7609339123;Taip;7;2;0;9
440;Aušrelė;SMALSUČIAI;1556010005;Ne;0;1;0;1
441;Aušrelė;SMALSUČIAI;5478028396;Taip;0;2;0;2
442;Aušrelė;SMALSUČIAI;7070013052;Taip;9;10;0;19
443;Aušrelė;SMALSUČIAI;6507218940;Taip;0;3;0;3
444;Aušrelė;SMALSUČIAI;2266390402;Taip;14;3;0;17
445;Aušrelė;SMALSUČIAI;8032661062;Taip;0;1;5;6
446;Aušrelė;SMALSUČIAI;4262596104;Taip;10;0;0;10
447;Aušrelė;KODĖLČIUKAI;7723159748;Taip;10;0;0;10
448;Aušrelė;KODĖLČIUKAI;7367268748;Taip;4;2;0;6
449;Aušrelė;KODĖLČIUKAI;5712867880;Taip;10;0;0;10
450;Aušrelė;KODĖLČIUKAI;3623813061;Taip;0;6;0;6
451;Aušrelė;KODĖLČIUKAI;8693750994;Taip;9;0;0;9
452;Aušrelė;KODĖLČIUKAI;7327544406;Taip;0;0;1;1
453;Aušrelė;KODĖLČIUKAI;9566144610;Taip;7;2;3;12
454;Aušrelė;KODĖLČIUKAI;6308519574;Taip;0;3;0;3
455;Aušrelė;KODĖLČIUKAI;6186758486;Taip;1;0;2;3
456;Aušrelė;KODĖLČIUKAI;3320399046;Taip;0;0;1;1
457;Aušrelė;KODĖLČIUKAI;6911735462;Taip;0;5;0;5
458;Aušrelė;KODĖLČIUKAI;4248808572;Taip;12;11;0;23
459;Aušrelė;KODĖLČIUKAI;5046027475;Taip;6;0;0;6
460;Aušrelė;KODĖLČIUKAI;8338569001;Taip;13;0;0;13
461;Aušrelė;KODĖLČIUKAI;2766357229;Ne;8;0;1;9
462;Aušrelė;KODĖLČIUKAI;7515666888;Taip;0;7;0;7
463;Aušrelė;KODĖLČIUKAI;8862488358;Taip;8;0;0;8
464;Aušrelė;KODĖLČIUKAI;4882556718;Taip;0;0;4;4
465;Aušrelė;KODĖLČIUKAI;6321332888;Taip;10;0;1;11
466;Aušrelė;PELĖDŽIUKAI;1985540746;Ne;0;0;7;7
467;Aušrelė;PELĖDŽIUKAI;6109859056;Taip;5;1;0;6
468;Aušrelė;PELĖDŽIUKAI;3223092149;Taip;0;12;0;12
469;Aušrelė;PELĖDŽIUKAI;8580241126;Taip;0;0;4;4
470;Aušrelė;PELĖDŽIUKAI;2545065554;Taip;0;1;0;1
471;Aušrelė;PELĖDŽIUKAI;4227228548;Taip;0;0;3;3
472;Aušrelė;PELĖDŽIUKAI;8996445434;Taip;0;0;3;3
473;Aušrelė;PELĖDŽIUKAI;8411336992;Taip;15;0;0;15
474;Aušrelė;PELĖDŽIUKAI;8917907028;Taip;5;0;0;5
475;Aušrelė;PELĖDŽIUKAI;7494298336;Taip;5;1;0;6
476;Aušrelė;PELĖDŽIUKAI;4012186237;Taip;0;0;2;2
477;Aušrelė;PELĖDŽIUKAI;3738923947;Taip;5;1;0;6
478;Aušrelė;PELĖDŽIUKAI;5312189552;Taip;0;3;0;3
479;Aušrelė;PELĖDŽIUKAI;2294224426;Taip;0;3;0;3
480;Aušrelė;AITVARIUKAI;6833654667;Taip;3;1;0;4
481;Aušrelė;AITVARIUKAI;8102749675;Ne;0;7;0;7
482;Aušrelė;AITVARIUKAI;4595435635;Taip;0;1;0;1
483;Aušrelė;AITVARIUKAI;9608444990;Taip;0;10;0;10
484;Aušrelė;AITVARIUKAI;6434548772;Taip;20;3;0;23
485;Aušrelė;AITVARIUKAI;9158248746;Taip;0;15;0;15
486;Aušrelė;AITVARIUKAI;7978186455;Taip;0;0;3;3
487;Aušrelė;AITVARIUKAI;5708459561;Taip;9;3;1;13
488;Aušrelė;AITVARIUKAI;1039180129;Taip;5;2;2;9
489;Aušrelė;AITVARIUKAI;5125295651;Taip;0;3;0;3
490;Aušrelė;AITVARIUKAI;3807967685;Taip;0;1;0;1
491;Aušrelė;AITVARIUKAI;6081100604;Ne;7;0;0;7
492;Aušrelė;AITVARIUKAI;7847650967;Taip;0;8;0;8
493;Aušrelė;AITVARIUKAI;5727081833;Taip;3;2;0;5
494;Aušrelė;AITVARIUKAI;4942168388;Taip;0;23;0;23
495;Aušrelė;AITVARIUKAI;7788139791;Taip;0;3;0;3
496;Aušrelė;BITUTĖS;1741716341;Taip;0;23;0;23
497;Aušrelė;BITUTĖS;4989544273;Taip;0;5;0;5
498;Aušrelė;BITUTĖS;9960201865;Taip;0;1;0;1
499;Aušrelė;BITUTĖS;2071674661;Ne;0;20;0;20
500;Aušrelė;BITUTĖS;1450827353;Taip;0;7;0;7
501;Aušrelė;BITUTĖS;5598494461;Taip;8;4;0;12
502;Aušrelė;BITUTĖS;4935192851;Ne;0;4;0;4
503;Aušrelė;BITUTĖS;9505496063;Ne;9;3;0;12
504;Aušrelė;BITUTĖS;1931955562;Taip;0;1;0;1
505;Aušrelė;BITUTĖS;5614774250;Ne;0;3;0;3
506;Aušrelė;BITUTĖS;6591538425;Taip;0;23;0;23
507;Aušrelė;BITUTĖS;8203256528;Taip;11;3;0;14
508;Aušrelė;BITUTĖS;5741252819;Taip;11;3;0;14
509;Aušrelė;BITUTĖS;1243825974;Taip;0;4;0;4
510;Aušrelė;BITUTĖS;2468245186;Taip;8;0;0;8
511;Aušrelė;BITUTĖS;5266959731;Taip;3;0;0;3
512;Aušrelė;ŽIRNIUKAI;1949809977;Taip;11;3;0;14
513;Aušrelė;ŽIRNIUKAI;9733877752;Taip;0;4;0;4
514;Aušrelė;ŽIRNIUKAI;8542012622;Taip;5;2;0;7
515;Aušrelė;ŽIRNIUKAI;2221714044;Taip;11;0;0;11
516;Aušrelė;ŽIRNIUKAI;1544869163;Ne;6;0;0;6
517;Aušrelė;ŽIRNIUKAI;6577540623;Taip;10;0;0;10
518;Aušrelė;ŽIRNIUKAI;5460833944;Taip;13;0;0;13
519;Aušrelė;ŽIRNIUKAI;6372004855;Taip;0;2;0;2
520;Aušrelė;ŽIRNIUKAI;3713528812;Taip;0;0;1;1
521;Aušrelė;ŽIRNIUKAI;2107898976;Ne;9;4;0;13
522;Aušrelė;ŽIRNIUKAI;1607338052;Taip;0;3;0;3
523;Aušrelė;ŽIRNIUKAI;8573348956;Taip;0;23;0;23
524;Aušrelė;ŽIRNIUKAI;6463141345;Taip;0;2;0;2
525;Aušrelė;ŽIRNIUKAI;1798478023;Ne;5;0;1;6
526;Aušrelė;ŽIRNIUKAI;1754138341;Taip;5;15;0;20
527;Aušrelė;ŽIRNIUKAI;6913824678;Taip;8;0;0;8
528;Aušrelė;ŽIRNIUKAI;8797157671;Taip;16;0;0;16
529;Aušrelė;ŽIRNIUKAI;4591518039;Ne;0;2;0;2
530;Aušrelė;GRYBUKAI;7406063630;Taip;8;0;0;8
531;Aušrelė;GRYBUKAI;9938762910;Taip;0;1;0;1
532;Aušrelė;GRYBUKAI;1463724119;Taip;5;0;0;5
533;Aušrelė;GRYBUKAI;8438945369;Taip;0;6;0;6
534;Aušrelė;GRYBUKAI;6672975558;Taip;8;0;1;9
535;Aušrelė;GRYBUKAI;4565813136;Taip;4;13;5;22
536;Aušrelė;GRYBUKAI;9877307844;Taip;6;1;0;7
537;Aušrelė;GRYBUKAI;8947695521;Taip;0;4;0;4
538;Aušrelė;GRYBUKAI;2311552230;Taip;5;0;0;5
539;Aušrelė;GRYBUKAI;1458580523;Taip;15;1;0;16
540;Aušrelė;GRYBUKAI;1871799626;Taip;0;3;0;3
541;Aušrelė;GRYBUKAI;5733298006;Taip;10;0;0;10
542;Aušrelė;GRYBUKAI;4924950592;Taip;13;0;0;13
543;Aušrelė;GRYBUKAI;2873845920;Taip;0;4;0;4
544;Aušrelė;GRYBUKAI;5904797250;Taip;0;3;3;6
545;Aušrelė;DRUGELIAI;6011466024;Ne;5;0;0;5
546;Aušrelė;DRUGELIAI;9763241451;Ne;0;0;5;5
547;Aušrelė;DRUGELIAI;1209824814;Taip;3;0;0;3
548;Aušrelė;DRUGELIAI;7948024164;Taip;5;0;0;5
549;Aušrelė;DRUGELIAI;5429867368;Ne;0;3;0;3
550;Aušrelė;DRUGELIAI;3831695455;Ne;0;23;0;23
551;Aušrelė;DRUGELIAI;3813270658;Ne;0;5;0;5
552;Aušrelė;DRUGELIAI;4464947621;Taip;4;0;5;9
553;Aušrelė;DRUGELIAI;9126040500;Taip;10;0;1;11
554;Aušrelė;DRUGELIAI;7286960315;Taip;11;0;5;16
555;Aušrelė;DRUGELIAI;2266835623;Taip;8;1;0;9
556;Aušrelė;DRUGELIAI;1094141305;Taip;10;0;2;12
557;Aušrelė;DRUGELIAI;9514049590;Taip;18;0;0;18
558;Aušrelė;DRUGELIAI;5709799539;Taip;5;0;4;9
559;Aušrelė;DRUGELIAI;8724802289;Taip;5;0;4;9
560;Aušrelė;NYKŠTUKAI;9914518299;Taip;13;0;0;13
561;Aušrelė;NYKŠTUKAI;8427699400;Taip;7;5;0;12
562;Aušrelė;NYKŠTUKAI;4297417711;Taip;3;0;0;3
563;Aušrelė;NYKŠTUKAI;7964156691;Taip;6;1;0;7
564;Aušrelė;NYKŠTUKAI;7140465960;Taip;5;1;0;6
565;Aušrelė;NYKŠTUKAI;7937067384;Taip;9;1;0;10
566;Aušrelė;NYKŠTUKAI;8099338305;Taip;13;2;0;15
567;Aušrelė;NYKŠTUKAI;6513026989;Taip;0;5;1;6
568;Aušrelė;NYKŠTUKAI;4282189556;Taip;8;2;0;10
569;Aušrelė;NYKŠTUKAI;4252475967;Ne;11;0;0;11
570;Aušrelė;NYKŠTUKAI;8378225406;Taip;5;2;3;10
571;Aušrelė;NYKŠTUKAI;5018495543;Taip;9;1;1;11
572;Aušrelė;NYKŠTUKAI;3259828075;Taip;7;0;0;7
573;Aušrelė;NYKŠTUKAI;4952876188;Taip;7;0;1;8
574;Aušrelė;SPINDULIUKAI;8848358559;Taip;0;2;0;2
575;Aušrelė;SPINDULIUKAI;3194122285;Taip;0;23;0;23
576;Aušrelė;SPINDULIUKAI;5358736178;Taip;10;0;2;12
577;Aušrelė;SPINDULIUKAI;5801943729;Ne;0;2;0;2
578;Aušrelė;SPINDULIUKAI;8801906679;Taip;0;5;2;7
579;Aušrelė;SPINDULIUKAI;7208341200;Ne;0;23;0;23
580;Aušrelė;SPINDULIUKAI;1446194971;Taip;0;1;0;1
581;Aušrelė;SPINDULIUKAI;9251919940;Taip;0;0;23;23
582;Aušrelė;SPINDULIUKAI;8997650487;Taip;3;1;2;6
583;Aušrelė;SPINDULIUKAI;1805615293;Taip;0;3;0;3
584;Aušrelė;SPINDULIUKAI;7966060521;Taip;0;10;0;10
585;Aušrelė;SPINDULIUKAI;5866673884;Taip;0;2;0;2
586;Aušrelė;SPINDULIUKAI;8835689988;Ne;0;6;1;7
587;Aušrelė;SPINDULIUKAI;5274919078;Taip;1;0;1;2
588;Aušrelė;SPINDULIUKAI;2981314491;Taip;1;2;2;5
589;Aušrelė;SPINDULIUKAI;2441221298;Taip;0;23;0;23
590;Beržynėlis;SVIRPLIUKAI;7360345539;Taip;3;0;0;3
591;Beržynėlis;SVIRPLIUKAI;4134371415;Taip;8;2;0;10
592;Beržynėlis;SVIRPLIUKAI;7278860816;Taip;0;1;0;1
593;Beržynėlis;SVIRPLIUKAI;8404801225;Taip;6;0;0;6
594;Beržynėlis;SVIRPLIUKAI;8303684788;Taip;3;1;0;4
595;Beržynėlis;SVIRPLIUKAI;7953957525;Taip;3;5;0;8
596;Beržynėlis;SVIRPLIUKAI;3841363368;Taip;5;0;0;5
597;Beržynėlis;SVIRPLIUKAI;3418730586;Taip;5;1;0;6
598;Beržynėlis;SVIRPLIUKAI;1468551784;Taip;7;0;0;7
599;Beržynėlis;SVIRPLIUKAI;2221708263;Taip;18;1;0;19
600;Beržynėlis;SVIRPLIUKAI;8880151537;Taip;0;2;0;2
601;Beržynėlis;SVIRPLIUKAI;6516665294;Taip;1;2;0;3
602;Beržynėlis;SVIRPLIUKAI;9580286493;Taip;1;0;0;1
603;Beržynėlis;SVIRPLIUKAI;6673910279;Taip;6;0;0;6
604;Beržynėlis;SVIRPLIUKAI;8701990625;Taip;0;3;0;3
605;Beržynėlis;SVIRPLIUKAI;5027712732;Taip;5;1;0;6
606;Beržynėlis;SVIRPLIUKAI;7555487759;Taip;0;2;0;2
607;Beržynėlis;SVIRPLIUKAI;8340662627;Taip;10;1;0;11
608;Beržynėlis;SVIRPLIUKAI;7788532819;Taip;0;1;0;1
609;Beržynėlis;SVIRPLIUKAI;8533912024;Taip;6;0;0;6
610;Beržynėlis;PELEDŽIUKAI;3278699117;Taip;0;1;0;1
611;Beržynėlis;PELEDŽIUKAI;1516309509;Taip;7;2;0;9
612;Beržynėlis;PELEDŽIUKAI;1395819329;Taip;0;0;1;1
613;Beržynėlis;PELEDŽIUKAI;1838631438;Taip;2;0;0;2
614;Beržynėlis;PELEDŽIUKAI;9566341884;Taip;0;1;0;1
615;Beržynėlis;PELEDŽIUKAI;1682929565;Taip;0;0;8;8
616;Beržynėlis;PELEDŽIUKAI;7248602510;Ne;7;1;0;8
617;Beržynėlis;PELEDŽIUKAI;2681482042;Taip;0;0;5;5
618;Beržynėlis;PELEDŽIUKAI;6395436937;Taip;0;1;0;1
619;Beržynėlis;PELEDŽIUKAI;74856278886;Ne;0;1;0;1
620;Beržynėlis;PELEDŽIUKAI;71505149611;Taip;0;1;0;1
621;Beržynėlis;PELEDŽIUKAI;1639928056;Taip;1;2;0;3
622;Beržynėlis;PELEDŽIUKAI;1176943273;Taip;0;3;3;6
623;Beržynėlis;PELEDŽIUKAI;7929997884;Ne;0;7;0;7
624;Beržynėlis;ŽIOGELIAI;5308596559;Taip;0;2;0;2
625;Beržynėlis;ŽIOGELIAI;4035764376;Taip;0;2;0;2
626;Beržynėlis;ŽIOGELIAI;4970999989;Taip;2;0;0;2
627;Beržynėlis;ŽIOGELIAI;1325972861;Taip;5;0;0;5
628;Beržynėlis;ŽIOGELIAI;6739927917;Ne;0;1;0;1
629;Beržynėlis;ŽIOGELIAI;2971686368;Taip;0;3;0;3
630;Beržynėlis;ŽIOGELIAI;9409317403;Taip;0;3;5;8
631;Beržynėlis;ŽIOGELIAI;6334152631;Taip;0;11;0;11
632;Beržynėlis;ŽIOGELIAI;9305279614;Taip;0;7;0;7
633;Beržynėlis;ŽIOGELIAI;9511051386;Taip;0;2;3;5
634;Beržynėlis;ŽIOGELIAI;5856519538;Taip;6;4;0;10
635;Beržynėlis;ŽIOGELIAI;3339522259;Ne;10;0;0;10
636;Beržynėlis;ŽIOGELIAI;6864823739;Taip;0;2;14;16
637;Beržynėlis;ŽIOGELIAI;9896122318;Ne;0;2;15;17
638;Beržynėlis;ŽIOGELIAI;6837130893;Taip;0;0;5;5
639;Beržynėlis;ŽIOGELIAI;3484188772;Ne;3;2;1;6
640;Beržynėlis;ŽVIRBLIUKAI;2193460960;Taip;0;4;0;4
641;Beržynėlis;ŽVIRBLIUKAI;2482395208;Taip;0;3;2;5
642;Beržynėlis;ŽVIRBLIUKAI;7057284039;Taip;0;1;0;1
643;Beržynėlis;ŽVIRBLIUKAI;2892553878;Taip;0;2;0;2
644;Beržynėlis;ŽVIRBLIUKAI;9503352345;Taip;0;14;0;14
645;Beržynėlis;ŽVIRBLIUKAI;8881566865;Taip;0;0;5;5
646;Beržynėlis;ŽVIRBLIUKAI;8280378527;Taip;0;4;0;4
647;Beržynėlis;ŽVIRBLIUKAI;6713134631;Taip;0;2;0;2
648;Beržynėlis;ŽVIRBLIUKAI;5593146590;Taip;0;2;0;2
649;Beržynėlis;ŽVIRBLIUKAI;9754455116;Taip;2;2;0;4
650;Beržynėlis;ŽVIRBLIUKAI;3334994408;Taip;18;0;0;18
651;Beržynėlis;ŽVIRBLIUKAI;9777841895;Taip;0;1;0;1
652;Beržynėlis;ŽVIRBLIUKAI;4161974847;Taip;0;2;0;2
653;Beržynėlis;ŽVIRBLIUKAI;3209966996;Taip;0;5;0;5
654;Beržynėlis;ŽVIRBLIUKAI;5194416351;Taip;0;6;0;6
655;Beržynėlis;ŽVIRBLIUKAI;5189335842;Taip;0;2;0;2
656;Beržynėlis;ŽIRNIUKAI;6932094459;Taip;0;1;0;1
657;Beržynėlis;ŽIRNIUKAI;5864265458;Taip;0;6;0;6
658;Beržynėlis;ŽIRNIUKAI;2583982025;Taip;4;3;0;7
659;Beržynėlis;ŽIRNIUKAI;7870888327;Taip;0;0;1;1
660;Beržynėlis;ŽIRNIUKAI;1558469002;Taip;15;0;0;15
661;Beržynėlis;ŽIRNIUKAI;9603272698;Taip;11;2;1;14
662;Beržynėlis;ŽIRNIUKAI;9493489114;Taip;11;2;1;14
663;Beržynėlis;ŽIRNIUKAI;4786786104;Taip;2;5;0;7
664;Beržynėlis;ŽIRNIUKAI;4944466205;Taip;3;1;0;4
665;Beržynėlis;ŽIRNIUKAI;6392773584;Taip;10;2;0;12
666;Beržynėlis;ŽIRNIUKAI;2155662035;Taip;9;1;0;10
667;Beržynėlis;ŽIRNIUKAI;4978363316;Taip;20;0;0;20
668;Beržynėlis;ŽIRNIUKAI;7806800327;Ne;0;2;0;2
669;Beržynėlis;VIŠČIUKAI;7016454952;Taip;0;14;0;14
670;Beržynėlis;VIŠČIUKAI;7903644161;Taip;3;0;5;8
671;Beržynėlis;VIŠČIUKAI;4382068779;Taip;15;0;2;17
672;Beržynėlis;VIŠČIUKAI;2272661119;Taip;0;4;0;4
673;Beržynėlis;VIŠČIUKAI;1831776326;Taip;2;0;0;2
674;Beržynėlis;VIŠČIUKAI;1118349439;Taip;7;0;0;7
675;Beržynėlis;VIŠČIUKAI;4369803044;Ne;20;0;0;20
676;Beržynėlis;VIŠČIUKAI;1503903200;Taip;7;0;2;9
677;Beržynėlis;VIŠČIUKAI;7972993168;Ne;5;0;0;5
678;Beržynėlis;VIŠČIUKAI;5049057730;Taip;5;0;0;5
679;Beržynėlis;VIŠČIUKAI;6592330036;Taip;15;0;0;15
680;Beržynėlis;VIŠČIUKAI;7343603169;Taip;6;0;0;6
681;Birutės;SKRUZDELIUKŲ;1761065941;Taip;0;7;0;7
682;Birutės;SKRUZDELIUKŲ;9610268046;Taip;4;0;2;6
683;Birutės;SKRUZDELIUKŲ;4027700332;Taip;0;0;3;3
684;Birutės;SKRUZDELIUKŲ;7685356079;Taip;4;0;1;5
685;Birutės;SKRUZDELIUKŲ;1105133326;Taip;14;3;3;20
686;Birutės;SKRUZDELIUKŲ;8636113039;Taip;0;2;0;2
687;Birutės;SKRUZDELIUKŲ;9411016611;Taip;0;4;0;4
688;Birutės;SKRUZDELIUKŲ;1945532852;Taip;0;0;1;1
689;Birutės;SKRUZDELIUKŲ;5154903444;Taip;0;3;0;3
690;Birutės;SKRUZDELIUKŲ;9541516589;Taip;5;0;1;6
691;Birutės;SKRUZDELIUKŲ;9187671201;Taip;7;1;5;13
692;Birutės;SKRUZDELIUKŲ;8432173636;Taip;0;1;0;1
693;Birutės;SKRUZDELIUKŲ;9904827482;Taip;5;0;1;6
694;Birutės;SKRUZDELIUKŲ;2140552221;Ne;0;1;0;1
695;Birutės;SKRUZDELIUKŲ;8413760872;Taip;10;0;0;10
696;Birutės;SKRUZDELIUKŲ;7940403585;Taip;5;1;0;6
697;Birutės;SKRUZDELIUKŲ;2859160609;Taip;0;3;1;4
698;Birutės;SKRUZDELIUKŲ;7251592439;Taip;0;2;0;2
699;Birutės;SKRUZDELIUKŲ;4375683234;Ne;0;1;0;1
700;Birutės;BITUČIŲ;33770983649;Taip;0;15;0;15
701;Birutės;BITUČIŲ;87693588654;Taip;2;3;0;5
702;Birutės;BITUČIŲ;2975442228;Taip;7;0;0;7
703;Birutės;BITUČIŲ;98391790116;Taip;1;0;0;1
704;Birutės;BITUČIŲ;5947971037;Taip;0;3;0;3
705;Birutės;BITUČIŲ;3870702348;Taip;0;2;0;2
706;Birutės;BITUČIŲ;3436637062;Taip;0;0;1;1
707;Birutės;BITUČIŲ;8465645434;Taip;3;0;0;3
708;Birutės;BITUČIŲ;9722922540;Taip;3;1;0;4
709;Birutės;BITUČIŲ;3061210677;Taip;0;0;1;1
710;Birutės;BITUČIŲ;6431396285;Taip;0;2;2;4
711;Birutės;BITUČIŲ;6081472534;Taip;0;3;3;6
712;Birutės;BITUČIŲ;2674259453;Taip;0;12;0;12
713;Birutės;BITUČIŲ;17865476849;Taip;6;0;0;6
714;Birutės;BITUČIŲ;6006110601;Taip;0;3;1;4
715;Birutės;BITUČIŲ;1243603625;Ne;6;0;1;7
716;Birutės;BITUČIŲ;4253571334;Taip;0;3;0;3
717;Birutės;BITUČIŲ;1447494370;Taip;0;2;1;3
718;Birutės;BORUŽIUKAI;5893851353;Taip;0;3;2;5
719;Birutės;BORUŽIUKAI;5457357625;Taip;0;0;2;2
720;Birutės;BORUŽIUKAI;5869137292;Taip;0;0;1;1
721;Birutės;BORUŽIUKAI;5026442722;Taip;6;6;0;12
722;Birutės;BORUŽIUKAI;6977276295;Taip;0;0;4;4
723;Birutės;BORUŽIUKAI;9289922622;Taip;0;0;1;1
724;Birutės;BORUŽIUKAI;8011210158;Taip;10;0;0;10
725;Birutės;BORUŽIUKAI;4906874758;Taip;0;5;1;6
726;Birutės;BORUŽIUKAI;9263238557;Taip;0;2;0;2
727;Birutės;BORUŽIUKAI;4488481136;Taip;3;0;1;4
728;Birutės;BORUŽIUKAI;6460415179;Taip;0;0;2;2
729;Birutės;BORUŽIUKAI;6973898557;Taip;0;4;0;4
730;Birutės;BORUŽIUKAI;7033907787;Taip;0;0;2;2
731;Birutės;BORUŽIUKAI;5745377474;Taip;7;0;1;8
732;Birutės;BORUŽIUKAI;5897671273;Taip;14;0;0;14
733;Birutės;BORUŽIUKAI;2016711225;Taip;6;0;3;9
734;Birutės;BORUŽIUKAI;1400510886;Taip;3;0;0;3
735;Birutės;BORUŽIUKAI;7494879160;Taip;4;4;1;9
736;Birutės;BORUŽIUKAI;5875585426;Taip;0;0;1;1
737;Birutės;BORUŽIUKAI;7398022393;Ne;3;0;5;8
738;Birutės;BORUŽIUKAI;7741922416;Taip;0;6;5;11
739;Birutės;BORUŽIUKAI;2681370776;Taip;0;0;6;6
740;Birutės;DRUGELIAI;8854957814;Taip;22;0;0;22
741;Birutės;DRUGELIAI;6263985683;Taip;9;0;0;9
742;Birutės;DRUGELIAI;4995437657;Taip;0;1;3;4
743;Birutės;DRUGELIAI;5957267018;Taip;6;0;3;9
744;Birutės;DRUGELIAI;1442496209;Taip;2;0;0;2
745;Birutės;DRUGELIAI;2318034045;Taip;8;0;6;14
746;Birutės;DRUGELIAI;3516719248;Taip;0;0;3;3
747;Birutės;DRUGELIAI;5688633357;Ne;0;1;13;14
748;Birutės;DRUGELIAI;8559820030;Taip;0;0;5;5
749;Birutės;DRUGELIAI;9863681147;Taip;0;0;2;2
750;Birutės;DRUGELIAI;9307655828;Ne;0;0;7;7
751;Birutės;DRUGELIAI;4674152995;Taip;2;0;2;4
752;Birutės;DRUGELIAI;5177528200;Taip;0;0;4;4
753;Birutės;DRUGELIAI;3391101786;Taip;0;0;3;3
754;Birutės;DRUGELIAI;7876057712;Taip;0;0;3;3
755;Birutės;DRUGELIAI;6765257633;Taip;0;0;3;3
756;Birutės;DRUGELIAI;2257683802;Taip;9;0;0;9
757;Birutės;DRUGELIAI;7336936451;Taip;0;11;0;11
758;Bitutė;Aitvariukų;4474600934;Taip;15;0;1;16
759;Bitutė;Aitvariukų;5606049201;Taip;5;2;2;9
760;Bitutė;Aitvariukų;6035394425;Ne;4;5;0;9
761;Bitutė;Aitvariukų;7132616264;Taip;0;10;0;10
762;Bitutė;Aitvariukų;8796728627;Ne;10;4;0;14
763;Bitutė;Aitvariukų;6030674568;Taip;15;0;8;23
764;Bitutė;Aitvariukų;9747786638;Taip;7;1;2;10
765;Bitutė;Aitvariukų;8259512455;Taip;10;1;5;16
766;Bitutė;Aitvariukų;9106644834;Taip;18;1;0;19
767;Bitutė;Aitvariukų;2899217019;Ne;15;0;0;15
768;Bitutė;Aitvariukų;8670124052;Taip;0;2;0;2
769;Bitutė;Aitvariukų;1340530611;Taip;0;0;1;1
770;Bitutė;Aitvariukų;6759511692;Taip;8;0;1;9
771;Bitutė;Aitvariukų;4164058783;Taip;0;0;3;3
772;Bitutė;Aitvariukų;8908052679;Taip;9;0;0;9
773;Bitutė;Aitvariukų;4924483609;Taip;0;12;0;12
774;Bitutė;Aitvariukų;7447624247;Ne;5;9;0;14
775;Bitutė;Ežiukų;56287634684;Taip;0;4;0;4
776;Bitutė;Ežiukų;5126303823;Taip;10;0;0;10
777;Bitutė;Ežiukų;4764586168;Taip;0;4;2;6
778;Bitutė;Ežiukų;8905075899;Taip;5;0;3;8
779;Bitutė;Ežiukų;3600670185;Ne;0;8;0;8
780;Bitutė;Ežiukų;6341806464;Ne;7;0;4;11
781;Bitutė;Ežiukų;7456328992;Ne;0;9;0;9
782;Bitutė;Ežiukų;2812580726;Taip;0;4;3;7
783;Bitutė;Ežiukų;8186706520;Ne;0;34;0;34
784;Bitutė;Ežiukų;1904108612;Taip;0;4;0;4
785;Bitutė;Ežiukų;2122052883;Taip;16;0;0;16
786;Bitutė;Ežiukų;4444523140;Taip;0;1;6;7
787;Bitutė;Ežiukų;4024758152;Taip;0;1;0;1
788;Bitutė;Ežiukų;6194712643;Taip;0;1;0;1
789;Bitutė;Ežiukų;4468366941;Taip;0;0;6;6
790;Bitutė;Ežiukų;5188828679;Taip;2;4;0;6
791;Bitutė;Ežiukų;8109028957;Taip;0;4;0;4
792;Bitutė;Ežiukų;3156654672;Taip;0;3;4;7
793;Bitutė;Žvirbliukų;7047262367;Taip;0;0;3;3
794;Bitutė;Žvirbliukų;3804171750;Taip;0;4;0;4
795;Bitutė;Žvirbliukų;8545377054;Taip;0;5;0;5
796;Bitutė;Žvirbliukų;5406667195;Taip;0;4;0;4
797;Bitutė;Žvirbliukų;4458990772;Taip;10;0;0;10
798;Bitutė;Žvirbliukų;3723040682;Taip;0;8;0;8
799;Bitutė;Žvirbliukų;2190439190;Taip;7;11;0;18
800;Bitutė;Žvirbliukų;7113693496;Taip;16;0;0;16
801;Bitutė;Žvirbliukų;4177331531;Taip;0;0;1;1
802;Bitutė;Žvirbliukų;2483462846;Taip;0;7;0;7
803;Bitutė;Žvirbliukų;7678106084;Taip;0;1;5;6
804;Bitutė;Žvirbliukų;6044969600;Taip;0;4;0;4
805;Bitutė;Žvirbliukų;2444289145;Taip;8;0;0;8
806;Bitutė;Žvirbliukų;3517750478;Taip;0;1;0;1
807;Bitutė;Žvirbliukų;5291764696;Taip;0;0;8;8
808;Bitutė;Žvirbliukų;9523588597;Taip;0;1;1;2
809;Bitutė;Žvirbliukų;9166624750;Taip;5;0;1;6
810;Bitutė;Žvirbliukų;8373105196;Taip;0;2;0;2
811;Bitutė;Žvirbliukų;6014726741;Taip;0;5;0;5
812;Bitutė;Žvirbliukų;4527880105;Taip;0;4;1;5
813;Bitutė;Žvirbliukų;9834697190;Taip;6;0;0;6
814;Bitutė;Gandriukų;8519978626;Taip;0;4;4;8
815;Bitutė;Gandriukų;1809034174;Ne;8;5;3;16
816;Bitutė;Gandriukų;6586888742;Taip;3;4;5;12
817;Bitutė;Gandriukų;5783154071;Taip;0;5;0;5
818;Bitutė;Gandriukų;7387822939;Ne;0;1;0;1
819;Bitutė;Gandriukų;6052204491;Taip;7;1;0;8
820;Bitutė;Gandriukų;37105491775;Taip;0;2;0;2
821;Bitutė;Gandriukų;90943054285;Taip;0;3;0;3
822;Bitutė;Gandriukų;6659750060;Ne;10;5;0;15
823;Bitutė;Gandriukų;9683582019;Taip;0;4;1;5
824;Bitutė;Gandriukų;11567978993;Taip;3;8;0;11
825;Bitutė;Gandriukų;7352524951;Taip;0;6;0;6
826;Bitutė;Gandriukų;2350260809;Taip;7;4;1;12
827;Bitutė;Gandriukų;27144303911;Taip;0;4;0;4
828;Bitutė;Gandriukų;1942685472;Taip;0;1;0;1
829;Bitutė;Gandriukų;1307749129;Taip;0;5;0;5
830;Bitutė;Gandriukų;5653055907;Taip;0;7;0;7
831;Bitutė;Gandriukų;6678928989;Ne;9;12;0;21
832;Bitutė;Gandriukų;1802887869;Taip;0;4;1;5
833;Bitutė;Gandriukų;51054491845;Taip;0;1;0;1
834;Bitutė;Gandriukų;4574673585;Taip;0;5;0;5
835;Bitutė;Gandriukų;47316276655;Taip;0;2;0;2
836;Bitutė;Pelėdžiukai;3254061362;Taip;0;2;0;2
837;Bitutė;Pelėdžiukai;5455919343;Taip;0;4;0;4
838;Bitutė;Pelėdžiukai;8743734366;Taip;5;5;0;10
839;Bitutė;Pelėdžiukai;6674923740;Taip;1;2;0;3
840;Bitutė;Pelėdžiukai;2804203556;Taip;14;4;1;19
841;Bitutė;Pelėdžiukai;8394685672;Taip;9;2;0;11
842;Bitutė;Pelėdžiukai;7056737587;Taip;4;0;0;4
843;Bitutė;Pelėdžiukai;4985270536;Taip;5;4;11;20
844;Bitutė;Pelėdžiukai;1590501589;Taip;5;4;11;20
845;Bitutė;Pelėdžiukai;3796188100;Taip;4;4;1;9
846;Bitutė;Pelėdžiukai;1564763789;Taip;0;4;1;5
847;Bitutė;Pelėdžiukai;1846974702;Taip;0;4;0;4
848;Bitutė;Pelėdžiukai;5679397165;Taip;3;6;0;9
849;Bitutė;Pelėdžiukai;1162903905;Taip;0;1;0;1
850;Bitutė;Pelėdžiukai;3432065233;Taip;5;4;0;9
851;Bitutė;Pelėdžiukai;1560715159;Taip;0;5;1;6
852;Bitutė;Pelėdžiukai;6204566294;Taip;0;4;0;4
853;Bitutė;Pelėdžiukai;2518730247;Taip;6;1;0;7
854;Bitutė;Pelėdžiukai;4315172747;Taip;0;1;0;1
855;Bitutė;Pelėdžiukai;9838379838;Taip;5;11;0;16
856;Bitutė;Pelėdžiukai;3227252972;Ne;0;4;0;4
857;Bitutė;Boružėlių;8276590981;Taip;17;0;4;21
858;Bitutė;Boružėlių;3026526421;Taip;3;4;0;7
859;Bitutė;Boružėlių;7503203424;Taip;10;0;3;13
860;Bitutė;Boružėlių;1711888057;Taip;13;0;1;14
861;Bitutė;Boružėlių;8355346371;Taip;11;0;1;12
862;Bitutė;Boružėlių;2583001947;Taip;15;1;0;16
863;Bitutė;Boružėlių;9545405359;Taip;3;0;6;9
864;Bitutė;Boružėlių;2129484313;Taip;16;2;0;18
865;Bitutė;Boružėlių;9691450767;Taip;0;0;11;11
866;Bitutė;Boružėlių;3170266155;Taip;0;0;13;13
867;Bitutė;Boružėlių;6455582149;Taip;17;0;0;17
868;Bitutė;Boružėlių;2144809294;Taip;13;0;1;14
869;Bitutė;Boružėlių;8011051470;Taip;7;0;4;11
870;Bitutė;Boružėlių;9521938997;Taip;10;4;5;19
871;Bitutė;Boružėlių;9668365838;Taip;10;3;0;13
872;Bitutė;Boružėlių;3870675531;Taip;12;0;0;12
873;Bitutė;Boružėlių;7095475821;Taip;7;0;0;7
874;Bitutė;Boružėlių;6255439813;Taip;7;0;0;7
875;Bitutė;Boružėlių;2623999429;Taip;1;0;2;3
876;Bitutė;Boružėlių;6840722112;Taip;0;0;1;1
877;Bitutė;Boružėlių;4884898917;Taip;12;0;0;12
878;Bitutė;Boružėlių;4869423833;Taip;16;3;0;19
879;Bitutė;Boružėlių;5071978105;Taip;14;0;1;15
880;Bitutė;Šokliukų;8211710975;Taip;9;2;6;17
881;Bitutė;Šokliukų;8872286273;Taip;13;4;0;17
882;Bitutė;Šokliukų;5169768042;Taip;7;2;0;9
883;Bitutė;Šokliukų;4917599786;Ne;11;0;0;11
884;Bitutė;Šokliukų;1348548294;Taip;1;10;0;11
885;Bitutė;Šokliukų;7318555933;Taip;3;6;0;9
886;Bitutė;Šokliukų;1012702386;Taip;0;6;0;6
887;Bitutė;Šokliukų;9924340801;Taip;8;2;0;10
888;Bitutė;Šokliukų;7979566741;Taip;0;6;0;6
889;Bitutė;Šokliukų;7165511381;Taip;0;11;0;11
890;Bitutė;Šokliukų;9465186207;Taip;9;13;0;22
891;Bitutė;Šokliukų;2853616585;Ne;11;4;3;18
892;Bitutė;Šokliukų;5109258680;Taip;0;1;0;1
893;Bitutė;Šokliukų;8439759353;Taip;0;1;0;1
894;Bitutė;Šokliukų;3417576747;Taip;0;2;1;3
895;Bitutė;Šokliukų;8422448947;Ne;7;3;0;10
896;Bitutė;Šokliukų;7926482326;Taip;0;9;0;9
897;Bitutė;Šokliukų;5876700984;Taip;0;5;0;5
898;Bitutė;Šokliukų;2177537591;Ne;9;0;1;10
899;Bitutė;Šokliukų;5759407291;Taip;3;2;0;5
900;Bitutė;Šokliukų;4471813998;Taip;0;4;0;4
901;Bitutė;Šokliukų;9234090775;Ne;4;0;2;6
902;Bitutė;Drugelių;9094567866;Taip;5;0;5;10
903;Bitutė;Drugelių;5759595005;Taip;5;0;0;5
904;Bitutė;Drugelių;2085899696;Taip;8;1;0;9
905;Bitutė;Drugelių;2029309955;Taip;0;8;0;8
906;Bitutė;Drugelių;5845408472;Taip;9;1;3;13
907;Bitutė;Drugelių;5796600501;Taip;0;0;9;9
908;Bitutė;Drugelių;1558826102;Taip;13;0;0;13
909;Bitutė;Drugelių;6325890676;Taip;19;0;1;20
910;Bitutė;Drugelių;2748400429;Taip;22;2;0;24
911;Bitutė;Drugelių;5146691157;Taip;6;0;1;7
912;Bitutė;Drugelių;2848732083;Ne;0;4;0;4
913;Bitutė;Drugelių;5278510767;Taip;0;4;0;4
914;Bitutė;Drugelių;8962725357;Taip;10;1;0;11
915;Bitutė;Drugelių;5471241132;Ne;0;2;0;2
916;Bitutė;Drugelių;1218462939;Taip;0;2;0;2
917;Bitutė;Drugelių;5081300818;Taip;0;1;0;1
918;Bitutė;Drugelių;7013249141;Taip;0;0;4;4
919;Bitutė;Drugelių;1397711778;Taip;10;0;3;13
920;Bitutė;Drugelių;8008237092;Taip;0;4;4;8
921;Bitutė;Drugelių;4545188971;Taip;11;3;0;14
922;Bitutė;Kiškučių;1733189730;Taip;15;3;2;20
923;Bitutė;Kiškučių;9966437881;Taip;0;3;0;3
924;Bitutė;Kiškučių;1985958540;Taip;0;8;0;8
925;Bitutė;Kiškučių;8743960488;Taip;0;0;3;3
926;Bitutė;Kiškučių;9337144831;Taip;11;0;0;11
927;Bitutė;Kiškučių;4566919587;Taip;15;0;0;15
928;Bitutė;Kiškučių;2806899030;Taip;0;8;0;8
929;Bitutė;Kiškučių;5443722813;Taip;0;6;0;6
930;Bitutė;Kiškučių;8789574593;Ne;4;0;2;6
931;Bitutė;Kiškučių;8799003374;Taip;0;13;0;13
932;Bitutė;Kiškučių;4639968278;Taip;0;23;0;23
933;Bitutė;Kiškučių;5490753578;Ne;14;0;2;16
934;Bitutė;"Viščiukų ";3603716923;Taip;13;0;0;13
935;Bitutė;"Viščiukų ";5181958187;Taip;0;23;0;23
936;Bitutė;"Viščiukų ";7694916340;Taip;0;23;0;23
937;Bitutė;"Viščiukų ";8303932330;Taip;9;1;0;10
938;Bitutė;"Viščiukų ";8642411661;Taip;13;1;0;14
939;Bitutė;"Viščiukų ";1198024852;Taip;1;2;0;3
940;Bitutė;"Viščiukų ";9909017070;Taip;1;2;0;3
941;Bitutė;"Viščiukų ";3811028304;Taip;14;0;1;15
942;Bitutė;"Viščiukų ";9592567172;Taip;13;0;0;13
943;Bitutė;"Viščiukų ";7619112317;Taip;0;10;0;10
944;Bitutė;"Viščiukų ";1715987321;Taip;13;0;0;13
945;Bitutė;"Viščiukų ";4926289620;Taip;15;0;0;15
946;Bitutė;"Viščiukų ";8130382253;Taip;13;0;1;14
947;Bitutė;"Viščiukų ";5869737425;Taip;15;0;0;15
948;Bitutė;"Viščiukų ";5220694242;Taip;9;3;0;12
949;Bitutė;"Viščiukų ";7535583229;Taip;10;0;0;10
950;Bitutė;"Viščiukų ";4480187618;Taip;8;0;1;9
951;Bitutė;"Viščiukų ";5061164237;Taip;5;1;0;6
952;Bitutė;"Skruzdėliukai ";5686278261;Taip;9;3;0;12
953;Bitutė;"Skruzdėliukai ";1423694056;Taip;0;5;1;6
954;Bitutė;"Skruzdėliukai ";6311396261;Taip;10;2;0;12
955;Bitutė;"Skruzdėliukai ";2252157473;Taip;9;2;0;11
956;Bitutė;"Skruzdėliukai ";4513783927;Taip;7;0;0;7
957;Bitutė;"Skruzdėliukai ";8667259778;Taip;21;0;1;22
958;Bitutė;"Skruzdėliukai ";8607718704;Taip;0;0;8;8
959;Bitutė;"Skruzdėliukai ";4413880918;Taip;9;0;0;9
960;Bitutė;"Skruzdėliukai ";9436414962;Taip;3;2;0;5
961;Bitutė;"Skruzdėliukai ";9864771568;Taip;0;0;2;2
962;Bitutė;"Skruzdėliukai ";6353690252;Taip;10;0;0;10
963;Bitutė;"Skruzdėliukai ";2160735504;Taip;0;0;2;2
964;Bitutė;"Skruzdėliukai ";1387310054;Taip;3;0;0;3
965;Bitutė;"Skruzdėliukai ";7245807233;Taip;11;0;2;13
966;Bitutė;"Skruzdėliukai ";5433617195;Taip;0;7;0;7
967;Bitutė;"Skruzdėliukai ";2391170362;Taip;8;0;0;8
968;Bitutė;"Nykštukų ";1290146001;Ne;15;0;0;15
969;Bitutė;"Nykštukų ";9352292654;Taip;5;0;2;7
970;Bitutė;"Nykštukų ";5421744666;Taip;17;7;0;24
971;Bitutė;"Nykštukų ";9780599803;Taip;15;0;0;15
972;Bitutė;"Nykštukų ";7741454857;Taip;8;0;3;11
973;Bitutė;"Nykštukų ";3860047703;Ne;14;0;0;14
974;Bitutė;"Nykštukų ";6226996242;Taip;0;3;4;7
975;Bitutė;"Nykštukų ";1460746240;Taip;12;1;0;13
976;Bitutė;"Nykštukų ";8896842164;Taip;0;23;0;23
977;Bitutė;"Nykštukų ";2819417600;Taip;0;4;0;4
978;Bitutė;"Nykštukų ";8561037889;Taip;0;7;0;7
979;Bitutė;"Nykštukų ";6091108131;Taip;17;4;1;22
980;Bitutė;"Nykštukų ";5375847129;Taip;9;1;0;10
981;Bitutė;"Nykštukų ";3528436838;Taip;10;2;0;12
982;Bitutė;"Nykštukų ";8270270602;Taip;15;0;1;16
983;Bitutė;"Nykštukų ";4617493676;Taip;13;0;4;17
984;Bitutė;"Nykštukų ";3806852067;Taip;22;1;0;23
985;Coliukė;DRUGELIAI;3151183436;Taip;3;0;0;3
986;Coliukė;DRUGELIAI;6675290003;Taip;18;0;0;18
987;Coliukė;DRUGELIAI;9890663421;Taip;13;0;1;14
988;Coliukė;DRUGELIAI;7763035106;Taip;4;1;0;5
989;Coliukė;DRUGELIAI;3628571567;Ne;0;16;0;16
990;Coliukė;DRUGELIAI;9688432169;Taip;14;0;0;14
991;Coliukė;DRUGELIAI;7513522378;Taip;16;2;0;18
992;Coliukė;DRUGELIAI;8478006305;Taip;0;3;0;3
993;Coliukė;DRUGELIAI;9352547729;Taip;7;5;0;12
994;Coliukė;DRUGELIAI;3908791146;Taip;1;0;0;1
995;Coliukė;DRUGELIAI;9750447455;Taip;20;0;0;20
996;Coliukė;DRUGELIAI;3367789231;Taip;9;0;1;10
997;Coliukė;DRUGELIAI;1220834062;Taip;9;0;0;9
998;Coliukė;DRUGELIAI;3392367716;Taip;3;0;2;5
999;Coliukė;DRUGELIAI;7621095517;Taip;0;1;0;1
1000;Coliukė;DRUGELIAI;4140716483;Taip;9;0;0;9
1001;Coliukė;DRUGELIAI;2385917598;Taip;8;0;0;8
1002;Coliukė;DRUGELIAI;1390751418;Ne;11;0;0;11
1003;Coliukė;DRUGELIAI;4881447596;Taip;0;4;0;4
1004;Coliukė;DRUGELIAI;6224089401;Taip;0;3;0;3
1005;Coliukė;DRUGELIAI;7284465232;Taip;12;0;1;13
1006;Coliukė;DRUGELIAI;8756465257;Taip;8;2;0;10
1007;Coliukė;BITUTĖS;2167230398;Taip;6;1;0;7
1008;Coliukė;BITUTĖS;5349969025;Taip;11;0;0;11
1009;Coliukė;BITUTĖS;1960898805;Taip;5;10;0;15
1010;Coliukė;BITUTĖS;7920728387;Taip;0;1;0;1
1011;Coliukė;BITUTĖS;8767261039;Taip;13;0;0;13
1012;Coliukė;BITUTĖS;1968467455;Taip;5;0;0;5
1013;Coliukė;BITUTĖS;9462610674;Taip;0;6;0;6
1014;Coliukė;BITUTĖS;8457120425;Taip;0;0;1;1
1015;Coliukė;BITUTĖS;1240946719;Taip;0;5;0;5
1016;Coliukė;BITUTĖS;9331485675;Taip;0;2;0;2
1017;Coliukė;BITUTĖS;9311775782;Taip;8;1;0;9
1018;Coliukė;BITUTĖS;2275327607;Taip;5;1;0;6
1019;Coliukė;BITUTĖS;9879369365;Taip;4;1;0;5
1020;Coliukė;BITUTĖS;4845247006;Taip;11;1;0;12
1021;Coliukė;BITUTĖS;9885547263;Taip;8;0;0;8
1022;Coliukė;BITUTĖS;36554487034;Taip;0;4;0;4
1023;Coliukė;BITUTĖS;1458763954;Taip;4;0;0;4
1024;Coliukė;BITUTĖS;6860757091;Taip;0;4;0;4
1025;Coliukė;BITUTĖS;8517128464;Taip;0;4;0;4
1026;Coliukė;BITUTĖS;8149118599;Taip;8;0;0;8
1027;Coliukė;BITUTĖS;7345905007;Taip;13;0;0;13
1028;Coliukė;BITUTĖS;7358018315;Taip;4;0;0;4
1029;Coliukė;VABALIUKAI;1105879142;Taip;3;12;0;15
1030;Coliukė;VABALIUKAI;1537341012;Taip;8;1;0;9
1031;Coliukė;VABALIUKAI;6984254334;Taip;9;3;0;12
1032;Coliukė;VABALIUKAI;5835199087;Taip;18;0;0;18
1033;Coliukė;VABALIUKAI;4626722910;Taip;15;3;0;18
1034;Coliukė;VABALIUKAI;9526108197;Ne;6;12;0;18
1035;Coliukė;VABALIUKAI;1318558913;Taip;0;3;0;3
1036;Coliukė;VABALIUKAI;6475497234;Taip;8;1;0;9
1037;Coliukė;VABALIUKAI;5596775091;Taip;8;1;0;9
1038;Coliukė;VABALIUKAI;4172517506;Taip;5;1;0;6
1039;Coliukė;VABALIUKAI;4493314926;Taip;8;3;0;11
1040;Coliukė;VABALIUKAI;2469993058;Taip;0;6;0;6
1041;Coliukė;VABALIUKAI;4739310916;Taip;0;5;0;5
1042;Coliukė;VABALIUKAI;5541328815;Ne;13;0;0;13
1043;Coliukė;VABALIUKAI;4649987214;Taip;0;3;0;3
1044;Coliukė;VABALIUKAI;3905904092;Taip;12;1;0;13
1045;Coliukė;VABALIUKAI;9083546061;Taip;3;3;0;6
1046;Coliukė;VABALIUKAI;8521846076;Taip;0;2;0;2
1047;Coliukė;VABALIUKAI;7622526793;Taip;7;3;0;10
1048;Coliukė;VABALIUKAI;1328505569;Ne;7;8;0;15
1049;Coliukė;VABALIUKAI;9268436167;Taip;5;1;0;6
1050;Coliukė;VABALIUKAI;9368334915;Ne;15;4;0;19
1051;Coliukė;VABALIUKAI;5108993131;Taip;11;1;0;12
1052;Coliukė;NYKŠTUKAI;6441253648;Taip;5;1;0;6
1053;Coliukė;NYKŠTUKAI;4537756081;Ne;6;7;0;13
1054;Coliukė;NYKŠTUKAI;4022408510;Taip;0;3;0;3
1055;Coliukė;NYKŠTUKAI;3719547522;Taip;9;0;0;9
1056;Coliukė;NYKŠTUKAI;6403149921;Taip;10;0;0;10
1057;Coliukė;NYKŠTUKAI;9498557347;Taip;11;0;0;11
1058;Coliukė;NYKŠTUKAI;3384332079;Ne;15;0;0;15
1059;Coliukė;NYKŠTUKAI;5283583324;Ne;0;1;0;1
1060;Coliukė;NYKŠTUKAI;9334564869;Taip;15;2;0;17
1061;Coliukė;NYKŠTUKAI;3140659021;Ne;6;0;1;7
1062;Coliukė;NYKŠTUKAI;4845049639;Taip;5;3;0;8
1063;Coliukė;NYKŠTUKAI;3221157300;Taip;8;1;0;9
1064;Coliukė;NYKŠTUKAI;7870865302;Ne;6;6;0;12
1065;Coliukė;NYKŠTUKAI;1575061659;Taip;6;1;0;7
1066;Coliukė;NYKŠTUKAI;2321127662;Taip;0;0;4;4
1067;Coliukė;NYKŠTUKAI;8715608220;Ne;0;6;0;6
1068;Coliukė;NYKŠTUKAI;7502911642;Taip;8;7;0;15
1069;Coliukė;NYKŠTUKAI;4635299740;Taip;8;7;0;15
1070;Coliukė;GĖLYTĖS;9442511803;Taip;8;0;4;12
1071;Coliukė;GĖLYTĖS;6781663126;Taip;5;0;4;9
1072;Coliukė;GĖLYTĖS;6611713551;Taip;23;0;0;23
1073;Coliukė;GĖLYTĖS;6755886435;Taip;8;0;2;10
1074;Coliukė;GĖLYTĖS;1220385522;Taip;16;0;0;16
1075;Coliukė;GĖLYTĖS;8601059431;Taip;8;2;0;10
1076;Coliukė;GĖLYTĖS;1452034828;Taip;18;0;0;18
1077;Coliukė;GĖLYTĖS;6941719947;Ne;0;3;5;8
1078;Coliukė;GĖLYTĖS;5347456579;Taip;13;0;0;13
1079;Coliukė;GĖLYTĖS;9834829829;Taip;11;3;1;15
1080;Coliukė;GĖLYTĖS;9107676840;Ne;0;0;1;1
1081;Coliukė;GĖLYTĖS;8606195508;Ne;3;0;3;6
1082;Coliukė;GĖLYTĖS;4880932369;Taip;17;0;0;17
1083;Coliukė;"BORUŽĖLĖS (SPEC.)";2080118127;Taip;5;1;0;6
1084;Coliukė;"BORUŽĖLĖS (SPEC.)";2617816991;Taip;3;0;1;4
1085;Coliukė;"BORUŽĖLĖS (SPEC.)";1233731506;Taip;0;3;0;3
1086;Coliukė;"BORUŽĖLĖS (SPEC.)";1644303265;Taip;0;0;5;5
1087;Coliukė;"BORUŽĖLĖS (SPEC.)";5706671963;Taip;0;4;0;4
1088;Coliukė;"BORUŽĖLĖS (SPEC.)";4961762841;Taip;6;0;1;7
1089;Coliukė;"BORUŽĖLĖS (SPEC.)";7826554599;Taip;6;2;0;8
1090;Coliukė;"BORUŽĖLĖS (SPEC.)";6920961967;Ne;0;7;0;7
1091;Coliukė;"BORUŽĖLĖS (SPEC.)";1134875499;Taip;0;3;0;3
1092;Coliukė;"BORUŽĖLĖS (SPEC.)";2351866339;Taip;4;0;0;4
1093;Coliukė;"BORUŽĖLĖS (SPEC.)";5756690199;Taip;13;0;0;13
1094;Coliukė;"BORUŽĖLĖS (SPEC.)";6972921877;Taip;11;0;0;11
1095;Coliukė;"BORUŽĖLĖS (SPEC.)";2947495861;Ne;4;0;3;7
1096;Coliukė;"BORUŽĖLĖS (SPEC.)";6246392335;Taip;1;2;0;3
1097;Coliukė;"BORUŽĖLĖS (SPEC.)";5008183731;Taip;12;0;0;12
1098;Čiauškutis;BITUTĖS;7893181156;Ne;0;0;2;2
1099;Čiauškutis;BITUTĖS;7976738303;Ne;5;0;0;5
1100;Čiauškutis;BITUTĖS;4026881335;Taip;13;0;1;14
1101;Čiauškutis;BITUTĖS;9753680961;Taip;0;0;5;5
1102;Čiauškutis;BITUTĖS;4852837431;Taip;0;0;1;1
1103;Čiauškutis;BITUTĖS;4652951382;Ne;0;16;7;23
1104;Čiauškutis;BITUTĖS;2319237497;Taip;9;0;2;11
1105;Čiauškutis;BITUTĖS;1765857419;Ne;0;0;1;1
1106;Čiauškutis;BITUTĖS;7282041196;Taip;1;1;0;2
1107;Čiauškutis;ŽVIRBLIUKAI;9565722619;Taip;0;12;11;23
1108;Čiauškutis;ŽVIRBLIUKAI;5125518366;Taip;6;0;1;7
1109;Čiauškutis;ŽVIRBLIUKAI;4962200863;Taip;0;0;1;1
1110;Čiauškutis;ŽVIRBLIUKAI;7324659239;Taip;0;0;3;3
1111;Čiauškutis;ŽVIRBLIUKAI;4216443034;Taip;1;0;0;1
1112;Čiauškutis;ŽVIRBLIUKAI;2096533965;Ne;0;0;14;14
1113;Čiauškutis;ŽVIRBLIUKAI;9759888353;Ne;0;0;5;5
1114;Čiauškutis;ŽVIRBLIUKAI;8297774828;Taip;5;1;0;6
1115;Čiauškutis;SAULUTĖS;98579606504;Taip;0;3;2;5
1116;Čiauškutis;SAULUTĖS;7027181377;Taip;6;17;0;23
1117;Čiauškutis;SAULUTĖS;43313173294;Taip;7;15;1;23
1118;Čiauškutis;SAULUTĖS;60265156684;Taip;13;3;2;18
1119;Čiauškutis;SAULUTĖS;9052859205;Taip;0;3;1;4
1120;Čiauškutis;SAULUTĖS;7367933940;Taip;0;0;2;2
1121;Čiauškutis;SAULUTĖS;4658994599;Taip;5;0;1;6
1122;Čiauškutis;SAULUTĖS;6115354862;Taip;11;2;1;14
1123;Čiauškutis;SAULUTĖS;5759367884;Taip;17;3;0;20
1124;Čiauškutis;SAULUTĖS;1313716840;Taip;0;1;0;1
1125;Čiauškutis;EŽIUKAI;7746580858;Taip;1;0;2;3
1126;Čiauškutis;EŽIUKAI;2686038029;Taip;0;0;4;4
1127;Čiauškutis;EŽIUKAI;1928404791;Taip;0;0;1;1
1128;Čiauškutis;EŽIUKAI;7489733038;Taip;0;0;7;7
1129;Čiauškutis;EŽIUKAI;5404165993;Taip;5;0;6;11
1130;Čiauškutis;EŽIUKAI;1158816422;Taip;0;0;4;4
1131;Čiauškutis;EŽIUKAI;7239878097;Taip;0;0;1;1
1132;Čiauškutis;EŽIUKAI;5910818962;Ne;3;0;0;3
1133;Čiauškutis;EŽIUKAI;1234494170;Taip;0;0;2;2
1134;Čiauškutis;DRUGELIAI;9072764004;Taip;6;0;0;6
1135;Čiauškutis;DRUGELIAI;1036358147;Taip;10;0;2;12
1136;Čiauškutis;DRUGELIAI;8346845876;Taip;1;0;0;1
1137;Čiauškutis;DRUGELIAI;3724324861;Taip;0;18;0;18
1138;Čiauškutis;DRUGELIAI;2237570705;Taip;0;1;0;1
1139;Čiauškutis;DRUGELIAI;4681902267;Taip;5;3;2;10
1140;Čiauškutis;GENELIAI;7440425102;Ne;4;0;0;4
1141;Čiauškutis;GENELIAI;76449285846;Taip;0;4;0;4
1142;Čiauškutis;GENELIAI;6435287215;Taip;0;2;0;2
1143;Čiauškutis;GENELIAI;1456067541;Ne;12;1;0;13
1144;Čiauškutis;GENELIAI;1657452686;Taip;5;4;0;9
1145;Čiauškutis;GENELIAI;1739403100;Taip;0;23;0;23
1146;Čiauškutis;GENELIAI;6994301415;Ne;2;3;1;6
1147;Čiauškutis;GENELIAI;1846118720;Taip;0;0;3;3
1148;Čiauškutis;GENELIAI;1809511815;Taip;4;0;0;4
1149;Čiauškutis;LINKSMUČIAI;73016259669;Taip;0;4;0;4
1150;Čiauškutis;LINKSMUČIAI;7184626362;Taip;0;2;0;2
1151;Čiauškutis;LINKSMUČIAI;8689127061;Taip;1;8;2;11
1152;Čiauškutis;LINKSMUČIAI;9062135043;Taip;8;0;1;9
1153;Čiauškutis;LINKSMUČIAI;1533938659;Taip;0;0;4;4
1154;Čiauškutis;LINKSMUČIAI;3353905368;Taip;5;0;0;5
1155;Čiauškutis;LINKSMUČIAI;1306672095;Taip;0;0;3;3
1156;Čiauškutis;LINKSMUČIAI;2672796261;Taip;0;0;2;2
1157;Čiauškutis;LINKSMUČIAI;8857039064;Taip;11;0;0;11
1158;Čiauškutis;KIŠKUČIAI;1900086424;Taip;0;1;0;1
1159;Čiauškutis;KIŠKUČIAI;1396093940;Taip;0;0;3;3
1160;Čiauškutis;KIŠKUČIAI;3465024013;Taip;5;1;2;8
1161;Čiauškutis;KIŠKUČIAI;2271458332;Taip;0;0;2;2
1162;Čiauškutis;KIŠKUČIAI;9754417066;Taip;7;0;0;7
1163;Čiauškutis;KIŠKUČIAI;8580034134;Taip;6;0;3;9
1164;Čiauškutis;KIŠKUČIAI;9410262802;Taip;0;0;3;3
1165;Čiauškutis;KIŠKUČIAI;3650541072;Taip;0;0;8;8
1166;Čiauškutis;KIŠKUČIAI;2445742257;Taip;8;11;4;23
1167;Čiauškutis;KIŠKUČIAI;6785604459;Taip;19;1;0;20
1168;Čiauškutis;LAPIUKAI;5052137859;Ne;0;23;0;23
1169;Čiauškutis;LAPIUKAI;7428833348;Taip;0;1;0;1
1170;Čiauškutis;LAPIUKAI;9897499968;Taip;3;18;2;23
1171;Čiauškutis;LAPIUKAI;2737503753;Taip;6;0;1;7
1172;Čiauškutis;LAPIUKAI;8876608072;Taip;5;0;6;11
1173;Čiauškutis;LAPIUKAI;4881821738;Taip;3;0;1;4
1174;Čiauškutis;LAPIUKAI;4881821738;Taip;3;0;1;4
1175;Čiauškutis;LAPIUKAI;6810906239;Taip;8;1;0;9
1176;Čiauškutis;LAPIUKAI;9460608737;Taip;10;0;1;11
1177;Čiauškutis;MEŠKUČIAI;7630342576;Taip;0;5;0;5
1178;Čiauškutis;MEŠKUČIAI;7135435979;Ne;10;1;1;12
1179;Čiauškutis;MEŠKUČIAI;6146321785;Taip;0;21;2;23
1180;Čiauškutis;MEŠKUČIAI;6434727608;Taip;8;11;4;23
1181;Čiauškutis;MEŠKUČIAI;7526975680;Taip;2;0;0;2
1182;Čiauškutis;MEŠKUČIAI;2172687454;Taip;10;0;0;10
1183;Čiauškutis;MEŠKUČIAI;3660195990;Taip;13;0;0;13
1184;Čiauškutis;PELĖDŽIUKAI;4971788697;Taip;22;0;0;22
1185;Čiauškutis;PELĖDŽIUKAI;9228568063;Taip;0;0;6;6
1186;Čiauškutis;PELĖDŽIUKAI;3700692073;Taip;0;0;1;1
1187;Čiauškutis;PELĖDŽIUKAI;3833382641;Taip;7;1;0;8
1188;Čiauškutis;PELĖDŽIUKAI;6615319751;Taip;9;0;1;10
1189;Čiauškutis;PELĖDŽIUKAI;2377986721;Ne;11;0;0;11
1190;Čiauškutis;PELĖDŽIUKAI;5446546214;Ne;0;0;9;9
1191;Čiauškutis;NYKŠTUKAI;8948893335;Taip;5;3;1;9
1192;Čiauškutis;NYKŠTUKAI;2633243682;Taip;0;1;0;1
1193;Čiauškutis;NYKŠTUKAI;4037117222;Taip;1;0;0;1
1194;Čiauškutis;NYKŠTUKAI;5957587644;Taip;14;0;0;14
1195;Čiauškutis;NYKŠTUKAI;1733251156;Taip;0;8;0;8
1196;Čiauškutis;NYKŠTUKAI;5575614158;Taip;8;7;1;16
1197;Čiauškutis;NYKŠTUKAI;7335655769;Ne;0;1;0;1
1198;Delfinukas;Boružėlių;4196156707;Taip;0;0;8;8
1199;Delfinukas;Boružėlių;9184207705;Taip;0;2;2;4
1200;Delfinukas;Boružėlių;2819680099;Taip;0;7;4;11
1201;Delfinukas;Boružėlių;3205671100;Ne;0;1;0;1
1202;Delfinukas;Boružėlių;1119373532;Ne;17;0;1;18
1203;Delfinukas;Boružėlių;4488260667;Taip;0;4;0;4
1204;Delfinukas;Boružėlių;4985159933;Taip;0;1;0;1
1205;Delfinukas;Boružėlių;2163238846;Taip;3;2;2;7
1206;Delfinukas;Boružėlių;4567479900;Taip;8;0;0;8
1207;Delfinukas;Boružėlių;9747075687;Taip;0;1;0;1
1208;Delfinukas;Boružėlių;5585334518;Ne;2;4;0;6
1209;Delfinukas;Boružėlių;6071660741;Taip;12;0;0;12
1210;Delfinukas;Boružėlių;4327924499;Taip;0;0;1;1
1211;Delfinukas;Boružėlių;6693756145;Taip;0;2;0;2
1212;Delfinukas;Boružėlių;6301767635;Taip;0;4;0;4
1213;Delfinukas;Saulytės;8315269427;Taip;0;0;2;2
1214;Delfinukas;Saulytės;4215887291;Taip;3;1;0;4
1215;Delfinukas;Saulytės;3631520143;Taip;5;5;2;12
1216;Delfinukas;Saulytės;9424966984;Ne;0;0;6;6
1217;Delfinukas;Saulytės;6069600728;Taip;0;0;1;1
1218;Delfinukas;Saulytės;1404270345;Taip;0;1;3;4
1219;Delfinukas;Saulytės;3842160990;Taip;0;1;0;1
1220;Delfinukas;Saulytės;8402529296;Taip;5;1;0;6
1221;Delfinukas;Saulytės;5125346405;Taip;0;1;0;1
1222;Delfinukas;Saulytės;5642328792;Ne;8;1;1;10
1223;Delfinukas;Saulytės;8176576958;Taip;7;0;1;8
1224;Delfinukas;Saulytės;8275943176;Taip;0;0;3;3
1225;Delfinukas;Saulytės;8085530134;Taip;0;3;0;3
1226;Delfinukas;Saulytės;8148610460;Taip;12;0;0;12
1227;Delfinukas;Saulytės;6935992202;Taip;5;0;0;5
1228;Delfinukas;Saulytės;8186312409;Taip;10;3;0;13
1229;Delfinukas;Saulytės;7904803011;Taip;0;1;0;1
1230;Delfinukas;Saulytės;1873630966;Ne;0;1;2;3
1231;Delfinukas;Saulytės;5665463557;Taip;5;1;1;7
1232;Delfinukas;Saulytės;1296440609;Ne;0;5;1;6
1233;Delfinukas;Saulytės;5397241026;Taip;0;7;0;7
1234;Delfinukas;Pelėdžiukų;3940838205;Taip;0;1;0;1
1235;Delfinukas;Pelėdžiukų;8774145277;Taip;5;10;0;15
1236;Delfinukas;Pelėdžiukų;3770227955;Taip;8;0;0;8
1237;Delfinukas;Pelėdžiukų;6113662246;Taip;0;9;0;9
1238;Delfinukas;Pelėdžiukų;4710894128;Ne;11;0;0;11
1239;Delfinukas;Pelėdžiukų;1526129772;Taip;6;0;0;6
1240;Delfinukas;Pelėdžiukų;8659309242;Taip;0;4;0;4
1241;Delfinukas;Pelėdžiukų;8267992425;Taip;7;4;0;11
1242;Delfinukas;Pelėdžiukų;9319874239;Ne;5;0;0;5
1243;Delfinukas;Pelėdžiukų;2809947323;Ne;0;0;5;5
1244;Delfinukas;Pelėdžiukų;3465186420;Taip;6;0;0;6
1245;Delfinukas;Pelėdžiukų;4096274346;Taip;9;1;0;10
1246;Delfinukas;Pelėdžiukų;5246300518;Taip;11;2;1;14
1247;Delfinukas;Pelėdžiukų;3702341009;Taip;3;3;0;6
1248;Delfinukas;Pelėdžiukų;2420308954;Taip;7;0;0;7
1249;Delfinukas;Pelėdžiukų;6286748047;Taip;6;12;0;18
1250;Delfinukas;Pelėdžiukų;8432654056;Taip;0;2;6;8
1251;Delfinukas;Pelėdžiukų;1918878505;Taip;4;0;0;4
1252;Delfinukas;Pelėdžiukų;3795705735;Taip;16;0;0;16
1253;Delfinukas;Pelėdžiukų;1575125658;Taip;0;3;0;3
1254;Delfinukas;Pelėdžiukų;4384995354;Taip;0;2;0;2
1255;Delfinukas;Pelėdžiukų;3633392440;Taip;3;2;2;7
1256;Delfinukas;Varliukų;4949220786;Taip;2;3;0;5
1257;Delfinukas;Varliukų;2792051636;Taip;10;0;1;11
1258;Delfinukas;Varliukų;4780352568;Taip;4;0;0;4
1259;Delfinukas;Varliukų;4513031164;Taip;5;11;0;16
1260;Delfinukas;Varliukų;3577180085;Taip;8;0;1;9
1261;Delfinukas;Varliukų;6115370195;Taip;0;0;1;1
1262;Delfinukas;Varliukų;3050258185;Taip;8;0;0;8
1263;Delfinukas;Varliukų;7976681530;Taip;8;0;0;8
1264;Delfinukas;Varliukų;4338259551;Taip;9;0;0;9
1265;Delfinukas;Varliukų;9360553910;Taip;4;7;0;11
1266;Delfinukas;Varliukų;6301601832;Taip;4;0;0;4
1267;Delfinukas;Varliukų;5095713834;Taip;8;7;0;15
1268;Delfinukas;Varliukų;5964021733;Taip;18;3;0;21
1269;Delfinukas;Varliukų;5821591959;Taip;0;4;0;4
1270;Delfinukas;Varliukų;7072060541;Taip;6;0;1;7
1271;Delfinukas;Varliukų;3797355501;Taip;11;0;0;11
1272;Delfinukas;Varliukų;4254414928;Taip;13;0;0;13
1273;Delfinukas;Varliukų;7359531377;Taip;10;0;0;10
1274;Delfinukas;Varpelių;5123666058;Taip;8;1;0;9
1275;Delfinukas;Varpelių;8913681176;Taip;0;5;0;5
1276;Delfinukas;Varpelių;9514189769;Taip;0;2;0;2
1277;Delfinukas;Varpelių;4713803167;Taip;0;3;0;3
1278;Delfinukas;Varpelių;8936645508;Taip;0;5;0;5
1279;Delfinukas;Varpelių;6047881184;Taip;1;0;0;1
1280;Delfinukas;Varpelių;3818558339;Taip;9;0;0;9
1281;Delfinukas;Varpelių;1484123788;Taip;4;1;0;5
1282;Delfinukas;Varpelių;4877757730;Taip;6;1;0;7
1283;Delfinukas;Varpelių;7973858761;Taip;6;1;0;7
1284;Delfinukas;Varpelių;9218154624;Ne;8;0;0;8
1285;Delfinukas;Varpelių;8950528288;Taip;4;0;0;4
1286;Delfinukas;Varpelių;4500756171;Taip;8;0;1;9
1287;Delfinukas;Varpelių;8953230752;Ne;3;0;0;3
1288;Delfinukas;Varpelių;7780893730;Taip;3;2;1;6
1289;Delfinukas;Varpelių;9898427089;Taip;0;1;0;1
1290;Delfinukas;Varpelių;2730512600;Taip;6;4;0;10
1291;Delfinukas;Varpelių;6008032738;Taip;0;3;0;3
1292;Delfinukas;Varpelių;8911433659;Taip;14;0;0;14
1293;Delfinukas;Drugeliai;7615519932;Ne;8;0;0;8
1294;Delfinukas;Drugeliai;6604115681;Taip;14;2;0;16
1295;Delfinukas;Drugeliai;5990192934;Taip;0;3;0;3
1296;Delfinukas;Drugeliai;9635669748;Taip;8;1;0;9
1297;Delfinukas;Drugeliai;8526813977;Taip;8;1;0;9
1298;Delfinukas;Drugeliai;6873181103;Taip;5;5;0;10
1299;Delfinukas;Drugeliai;4484804360;Taip;0;1;0;1
1300;Delfinukas;Drugeliai;8328481987;Taip;10;2;0;12
1301;Delfinukas;Drugeliai;6992505341;Taip;11;2;1;14
1302;Delfinukas;Drugeliai;9927854348;Taip;11;0;0;11
1303;Delfinukas;Drugeliai;2756574162;Taip;4;2;0;6
1304;Delfinukas;Drugeliai;2985669766;Taip;0;7;0;7
1305;Delfinukas;Drugeliai;6457042338;Taip;0;5;0;5
1306;Delfinukas;Drugeliai;5060445169;Taip;0;3;0;3
1307;Delfinukas;Drugeliai;3134897964;Taip;0;5;2;7
1308;Delfinukas;Drugeliai;8411289299;Taip;0;2;0;2
1309;Delfinukas;Drugeliai;2683746435;Taip;5;0;0;5
1310;Delfinukas;Drugeliai;6623617856;Taip;0;3;0;3
1311;Delfinukas;Žuvytės;8160982025;Taip;10;1;0;11
1312;Delfinukas;Žuvytės;6578506861;Taip;0;5;0;5
1313;Delfinukas;Žuvytės;6322255194;Ne;3;1;0;4
1314;Delfinukas;Žuvytės;6572690788;Taip;0;3;0;3
1315;Delfinukas;Žuvytės;7873373923;Taip;0;0;1;1
1316;Delfinukas;Žuvytės;9898412288;Taip;5;3;0;8
1317;Delfinukas;Žuvytės;3397350274;Taip;0;3;0;3
1318;Delfinukas;Žuvytės;9520598359;Taip;0;3;0;3
1319;Delfinukas;Žuvytės;7487111570;Ne;0;1;0;1
1320;Delfinukas;Žuvytės;6844500395;Taip;0;2;0;2
1321;Delfinukas;Žuvytės;6445868759;Taip;0;4;0;4
1322;Delfinukas;Žuvytės;9074294473;Taip;5;0;1;6
1323;Delfinukas;Žuvytės;4678970810;Taip;3;0;0;3
1324;Delfinukas;Žuvytės;6478152041;Taip;0;1;1;2
1325;Delfinukas;Delfinai;2890469172;Taip;0;0;4;4
1326;Delfinukas;Delfinai;9628317328;Ne;0;3;0;3
1327;Delfinukas;Delfinai;5797308373;Taip;0;1;0;1
1328;Delfinukas;Delfinai;8099120371;Taip;7;0;0;7
1329;Delfinukas;Delfinai;3108430680;Taip;0;1;0;1
1330;Delfinukas;Delfinai;7663934825;Taip;0;3;0;3
1331;Delfinukas;Delfinai;2382077576;Taip;0;3;0;3
1332;Delfinukas;Delfinai;1200205376;Taip;6;4;0;10
1333;Delfinukas;Delfinai;7629622746;Taip;0;2;4;6
1334;Delfinukas;Delfinai;4347116918;Taip;0;3;0;3
1335;Delfinukas;Delfinai;1922513830;Taip;0;4;1;5
1336;Delfinukas;Delfinai;8085481968;Taip;1;1;0;2
1337;Delfinukas;Delfinai;9605756229;Taip;3;0;0;3
1338;Delfinukas;Delfinai;3407321091;Taip;0;1;0;1
1339;Delfinukas;Delfinai;7354837777;Taip;15;0;0;15
1340;Delfinukas;Delfinai;9903010418;Taip;0;4;0;4
1341;Delfinukas;Delfinai;6522639028;Ne;7;0;1;8
1342;Delfinukas;Delfinai;9253061888;Ne;8;0;0;8
1343;Delfinukas;Paukšteliai;7366145460;Taip;4;0;0;4
1344;Delfinukas;Paukšteliai;5278689745;Taip;3;3;0;6
1345;Delfinukas;Paukšteliai;6002086491;Taip;0;4;0;4
1346;Delfinukas;Paukšteliai;1164720538;Taip;5;11;0;16
1347;Delfinukas;Paukšteliai;9351906710;Taip;7;0;0;7
1348;Delfinukas;Paukšteliai;9629225917;Taip;5;0;0;5
1349;Delfinukas;Paukšteliai;9332794060;Taip;5;1;2;8
1350;Delfinukas;Paukšteliai;5368435217;Taip;6;1;3;10
1351;Delfinukas;Paukšteliai;6650725760;Taip;6;0;2;8
1352;Delfinukas;Paukšteliai;7968869585;Taip;23;0;0;23
1353;Delfinukas;Paukšteliai;5164599763;Taip;10;0;0;10
1354;Delfinukas;Paukšteliai;9776618488;Taip;3;0;17;20
1355;Delfinukas;Paukšteliai;9586646352;Taip;7;0;0;7
1356;Delfinukas;Paukšteliai;4561911078;Taip;15;0;0;15
1357;Delfinukas;Paukšteliai;4755699845;Taip;14;0;1;15
1358;Delfinukas;Kiškučiai;2094258481;Taip;5;0;0;5
1359;Delfinukas;Kiškučiai;9602317911;Taip;0;3;0;3
1360;Delfinukas;Kiškučiai;8625023976;Taip;0;15;0;15
1361;Delfinukas;Kiškučiai;6352250868;Taip;2;0;0;2
1362;Delfinukas;Kiškučiai;3284212595;Taip;6;0;0;6
1363;Delfinukas;Kiškučiai;6531930806;Taip;2;0;0;2
1364;Delfinukas;Kiškučiai;8439204095;Taip;3;0;0;3
1365;Delfinukas;Kiškučiai;5783537897;Taip;0;3;1;4
1366;Delfinukas;Kiškučiai;2010703982;Taip;0;1;0;1
1367;Delfinukas;Kiškučiai;8728791932;Taip;5;0;0;5
1368;Delfinukas;Kiškučiai;7365398150;Ne;2;0;0;2
1369;Delfinukas;Kiškučiai;2883959240;Taip;11;2;1;14
1370;Delfinukas;Kiškučiai;4179507316;Taip;0;4;0;4
1371;Delfinukas;Kiškučiai;8440546956;Taip;5;0;0;5
1372;Delfinukas;Kiškučiai;1030958414;Taip;1;4;0;5
1373;Delfinukas;Kiškučiai;7638190553;Taip;3;2;1;6
1374;Delfinukas;Kiškučiai;6577214344;Taip;0;4;0;4
1375;Delfinukas;Kiškučiai;2537442505;Taip;5;0;1;6
1376;Delfinukas;BITUTĖS;9719348837;Taip;0;1;0;1
1377;Delfinukas;BITUTĖS;6211076154;Taip;8;0;0;8
1378;Delfinukas;BITUTĖS;6601922746;Taip;6;6;0;12
1379;Delfinukas;BITUTĖS;8896957908;Taip;8;0;0;8
1380;Delfinukas;BITUTĖS;3239635507;Taip;5;0;0;5
1381;Delfinukas;BITUTĖS;5339993544;Taip;6;0;0;6
1382;Delfinukas;BITUTĖS;6929926768;Taip;15;1;0;16
1383;Delfinukas;BITUTĖS;5557399916;Taip;0;1;0;1
1384;Delfinukas;BITUTĖS;8937594052;Taip;0;3;0;3
1385;Delfinukas;BITUTĖS;5179080544;Taip;0;6;0;6
1386;Delfinukas;BITUTĖS;7727263761;Taip;5;0;0;5
1387;Delfinukas;BITUTĖS;4198261848;Taip;1;1;0;2
1388;Delfinukas;BITUTĖS;8081895401;Taip;5;0;0;5
1389;Delfinukas;BITUTĖS;5600320855;Taip;0;10;5;15
1390;Delfinukas;BITUTĖS;9195828884;Taip;7;0;0;7
1391;Delfinukas;BITUTĖS;8552371520;Taip;4;0;0;4
1392;Delfinukas;BITUTĖS;2377204734;Taip;12;1;0;13
1393;Delfinukas;BITUTĖS;6243471374;Taip;0;7;0;7
1394;Delfinukas;BITUTĖS;6325092903;Taip;13;0;0;13
1395;Drevinukas;ZUIKUČIAI;1595081335;Taip;8;0;1;9
1396;Drevinukas;ZUIKUČIAI;2646799484;Taip;0;5;2;7
1397;Drevinukas;ZUIKUČIAI;2772424629;Taip;5;3;1;9
1398;Drevinukas;ZUIKUČIAI;5928234487;Taip;0;0;1;1
1399;Drevinukas;ZUIKUČIAI;8873060121;Taip;5;0;3;8
1400;Drevinukas;ZUIKUČIAI;1567790084;Taip;3;0;0;3
1401;Drevinukas;ZUIKUČIAI;3293457412;Taip;0;0;3;3
1402;Drevinukas;ZUIKUČIAI;6243097297;Taip;0;3;8;11
1403;Drevinukas;ZUIKUČIAI;5704489483;Taip;7;0;4;11
1404;Drevinukas;ZUIKUČIAI;7054681115;Taip;9;1;0;10
1405;Drevinukas;ZUIKUČIAI;3381363132;Taip;15;0;0;15
1406;Drevinukas;ZUIKUČIAI;9174977150;Taip;0;0;2;2
1407;Drevinukas;ZUIKUČIAI;3887137828;Ne;17;0;0;17
1408;Drevinukas;ZUIKUČIAI;4243045398;Taip;12;0;3;15
1409;Drevinukas;ZUIKUČIAI;4309475233;Taip;12;0;3;15
1410;Drevinukas;AŽUOLIUKŲ;1644656704;Taip;9;1;3;13
1411;Drevinukas;AŽUOLIUKŲ;5721031754;Taip;9;0;1;10
1412;Drevinukas;AŽUOLIUKŲ;8701250912;Taip;0;0;1;1
1413;Drevinukas;AŽUOLIUKŲ;8143614891;Taip;0;6;0;6
1414;Drevinukas;AŽUOLIUKŲ;4213259879;Taip;8;2;0;10
1415;Drevinukas;AŽUOLIUKŲ;5673244101;Taip;10;0;2;12
1416;Drevinukas;AŽUOLIUKŲ;3643007998;Ne;12;7;0;19
1417;Drevinukas;AŽUOLIUKŲ;4262951360;Taip;0;0;3;3
1418;Drevinukas;AŽUOLIUKŲ;5959004452;Ne;0;8;1;9
1419;Drevinukas;AŽUOLIUKŲ;4572837478;Taip;12;0;2;14
1420;Drevinukas;AŽUOLIUKŲ;1564065835;Taip;0;4;0;4
1421;Drevinukas;AŽUOLIUKŲ;9289471118;Taip;12;0;0;12
1422;Drevinukas;AŽUOLIUKŲ;9915130747;Ne;10;8;0;18
1423;Drevinukas;AŽUOLIUKŲ;6891793135;Taip;6;1;0;7
1424;Drevinukas;AŽUOLIUKŲ;1058927778;Taip;0;2;0;2
1425;Drevinukas;AŽUOLIUKŲ;9534007163;Ne;10;0;0;10
1426;Drevinukas;AŽUOLIUKŲ;2300338724;Taip;6;1;0;7
1427;Drevinukas;AŽUOLIUKŲ;9513405583;Taip;0;3;0;3
1428;Drevinukas;AŽUOLIUKŲ;5436821826;Taip;0;1;0;1
1429;Drevinukas;PELĖDŽIUKAI;1123115847;Taip;13;0;1;14
1430;Drevinukas;PELĖDŽIUKAI;1987939679;Taip;0;1;0;1
1431;Drevinukas;PELĖDŽIUKAI;4784716615;Taip;0;3;0;3
1432;Drevinukas;PELĖDŽIUKAI;2070374746;Taip;0;0;2;2
1433;Drevinukas;PELĖDŽIUKAI;9803670483;Taip;0;1;2;3
1434;Drevinukas;PELĖDŽIUKAI;7519369167;Taip;12;0;0;12
1435;Drevinukas;PELĖDŽIUKAI;16952164778;Taip;4;5;0;9
1436;Drevinukas;PELĖDŽIUKAI;8180027849;Taip;7;0;2;9
1437;Drevinukas;PELĖDŽIUKAI;4332606643;Taip;0;0;1;1
1438;Drevinukas;PELĖDŽIUKAI;7632515230;Taip;0;2;9;11
1439;Drevinukas;PELĖDŽIUKAI;6304169257;Taip;0;1;0;1
1440;Drevinukas;PELĖDŽIUKAI;5686116320;Taip;0;0;4;4
1441;Drevinukas;PELĖDŽIUKAI;56028675283;Taip;0;1;1;2
1442;Drevinukas;PELĖDŽIUKAI;85288014888;Taip;0;0;3;3
1443;Drevinukas;PELĖDŽIUKAI;6954102486;Ne;0;1;0;1
1444;Drevinukas;PELĖDŽIUKAI;3086451968;Taip;0;0;4;4
1445;Drevinukas;PELĖDŽIUKAI;2857797268;Taip;0;0;2;2
1446;Drevinukas;PELĖDŽIUKAI;6833120798;Taip;0;1;2;3
1447;Drevinukas;PELĖDŽIUKAI;7607135647;Taip;5;0;5;10
1448;Drevinukas;BORUŽĖLĖS;3392249574;Taip;3;0;0;3
1449;Drevinukas;BORUŽĖLĖS;5524567803;Taip;10;0;2;12
1450;Drevinukas;BORUŽĖLĖS;9016985238;Taip;0;1;0;1
1451;Drevinukas;BORUŽĖLĖS;2929598743;Taip;0;6;1;7
1452;Drevinukas;BORUŽĖLĖS;4076576850;Ne;4;0;12;16
1453;Drevinukas;BORUŽĖLĖS;6373230526;Taip;0;1;0;1
1454;Drevinukas;BORUŽĖLĖS;4312429104;Taip;10;0;0;10
1455;Drevinukas;BORUŽĖLĖS;7642022439;Ne;0;0;1;1
1456;Drevinukas;BORUŽĖLĖS;6316000019;Ne;0;0;2;2
1457;Drevinukas;BORUŽĖLĖS;4404254932;Taip;7;11;0;18
1458;Drevinukas;BORUŽĖLĖS;2378493422;Taip;0;3;0;3
1459;Drevinukas;BORUŽĖLĖS;1859208322;Taip;14;0;0;14
1460;Drevinukas;BORUŽĖLĖS;8984653958;Taip;0;13;0;13
1461;Drevinukas;BORUŽĖLĖS;5620887702;Taip;0;7;0;7
1462;Drevinukas;BORUŽĖLĖS;2281463885;Taip;0;0;2;2
1463;Drevinukas;BORUŽĖLĖS;4662426451;Taip;0;4;0;4
1464;Drevinukas;BORUŽĖLĖS;5875459639;Taip;0;4;0;4
1465;Drevinukas;BORUŽĖLĖS;6582186497;Ne;5;0;0;5
1466;Drevinukas;BORUŽĖLĖS;7218201733;Taip;3;0;2;5
1467;Drevinukas;BITUTĖS;3981507849;Taip;0;1;0;1
1468;Drevinukas;BITUTĖS;7753238387;Taip;0;4;2;6
1469;Drevinukas;BITUTĖS;3617570755;Taip;23;0;0;23
1470;Drevinukas;BITUTĖS;5679723776;Taip;11;5;0;16
1471;Drevinukas;BITUTĖS;1720464417;Taip;0;5;0;5
1472;Drevinukas;BITUTĖS;1099462840;Taip;0;5;0;5
1473;Drevinukas;BITUTĖS;8611131264;Taip;10;0;0;10
1474;Drevinukas;BITUTĖS;8936058501;Taip;4;0;2;6
1475;Drevinukas;BITUTĖS;5348609358;Taip;0;3;0;3
1476;Drevinukas;BITUTĖS;1098647410;Taip;4;0;0;4
1477;Drevinukas;BITUTĖS;2312241894;Taip;5;3;0;8
1478;Drevinukas;BITUTĖS;5394143000;Taip;6;0;0;6
1479;Drevinukas;BITUTĖS;3871506691;Taip;5;2;0;7
1480;Drevinukas;BITUTĖS;6914111231;Taip;5;2;0;7
1481;Drevinukas;BITUTĖS;3377957769;Taip;0;0;2;2
1482;Drevinukas;BITUTĖS;2423143170;Taip;8;0;0;8
1483;Drevinukas;BITUTĖS;1343431478;Ne;0;0;5;5
1484;Drevinukas;BITUTĖS;1829421385;Taip;5;0;0;5
1485;Drevinukas;BITUTĖS;8262224710;Taip;1;1;0;2
1486;Drevinukas;NYKŠTUKAI;6165662595;Taip;0;3;3;6
1487;Drevinukas;NYKŠTUKAI;4203106313;Taip;2;3;0;5
1488;Drevinukas;NYKŠTUKAI;4147987057;Taip;4;4;0;8
1489;Drevinukas;NYKŠTUKAI;6645506336;Taip;0;17;0;17
1490;Drevinukas;NYKŠTUKAI;3240313747;Taip;5;0;0;5
1491;Drevinukas;NYKŠTUKAI;8940838262;Taip;0;1;7;8
1492;Drevinukas;NYKŠTUKAI;9695419813;Taip;0;1;0;1
1493;Drevinukas;NYKŠTUKAI;9517560132;Taip;13;1;2;16
1494;Drevinukas;NYKŠTUKAI;6895472558;Taip;15;0;0;15
1495;Drevinukas;NYKŠTUKAI;2571295179;Ne;0;9;0;9
1496;Drevinukas;NYKŠTUKAI;2820241608;Taip;0;3;0;3
1497;Drevinukas;NYKŠTUKAI;5860361695;Taip;0;0;1;1
1498;Drevinukas;NYKŠTUKAI;9845207619;Taip;11;0;0;11
1499;Drevinukas;NYKŠTUKAI;6680003214;Taip;9;0;0;9
1500;Drevinukas;NYKŠTUKAI;3192583690;Ne;0;0;8;8
1501;Drevinukas;NYKŠTUKAI;6659263391;Ne;0;0;8;8
1502;Drevinukas;NYKŠTUKAI;4588368596;Ne;8;0;0;8
1503;Drevinukas;SMALSUČIAI;4242944055;Taip;0;0;6;6
1504;Drevinukas;SMALSUČIAI;1094428951;Taip;6;2;0;8
1505;Drevinukas;SMALSUČIAI;2179736991;Taip;0;3;2;5
1506;Drevinukas;SMALSUČIAI;9004568476;Taip;6;9;0;15
1507;Drevinukas;SMALSUČIAI;9283862598;Taip;14;0;0;14
1508;Drevinukas;SMALSUČIAI;8578579808;Taip;0;0;2;2
1509;Drevinukas;SMALSUČIAI;3611870655;Taip;11;0;0;11
1510;Drevinukas;SMALSUČIAI;7241671439;Taip;14;0;0;14
1511;Drevinukas;SMALSUČIAI;4089351543;Taip;0;12;3;15
1512;Drevinukas;SMALSUČIAI;2201342382;Ne;10;0;1;11
1513;Drevinukas;SMALSUČIAI;4759293403;Taip;13;0;2;15
1514;Drevinukas;SMALSUČIAI;9715586195;Taip;9;0;2;11
1515;Drevinukas;SMALSUČIAI;1368495173;Taip;16;1;0;17
1516;Drevinukas;SMALSUČIAI;8284025903;Taip;12;3;1;16
1517;Drevinukas;SMALSUČIAI;6492987985;Taip;12;0;1;13
1518;Drevinukas;ŽVIRBLIUKAI;7252955092;Taip;0;8;2;10
1519;Drevinukas;ŽVIRBLIUKAI;8350900604;Taip;0;0;6;6
1520;Drevinukas;ŽVIRBLIUKAI;8654858364;Taip;14;0;1;15
1521;Drevinukas;ŽVIRBLIUKAI;5445104383;Taip;8;0;0;8
1522;Drevinukas;ŽVIRBLIUKAI;2662147175;Taip;13;3;1;17
1523;Drevinukas;ŽVIRBLIUKAI;7801920518;Taip;14;3;6;23
1524;Drevinukas;ŽVIRBLIUKAI;1570356979;Taip;10;0;0;10
1525;Drevinukas;ŽVIRBLIUKAI;9123131368;Taip;6;0;2;8
1526;Drevinukas;ŽVIRBLIUKAI;8877080179;Taip;10;0;0;10
1527;Drevinukas;ŽVIRBLIUKAI;6492711565;Ne;0;0;2;2
1528;Drevinukas;ŽVIRBLIUKAI;2274377462;Taip;8;0;1;9
1529;Drevinukas;ŽVIRBLIUKAI;7316996793;Taip;0;4;0;4
1530;Drevinukas;ŽVIRBLIUKAI;3408981880;Taip;15;0;1;16
1531;Drevinukas;ŽVIRBLIUKAI;8953871512;Taip;10;0;0;10
1532;Drevinukas;ŽVIRBLIUKAI;3983656958;Taip;2;0;0;2
1533;Drugelis;NYKŠTUKŲ;9316073597;Taip;0;5;0;5
1534;Drugelis;NYKŠTUKŲ;3551095669;Taip;0;2;6;8
1535;Drugelis;NYKŠTUKŲ;1785724340;Taip;0;5;0;5
1536;Drugelis;NYKŠTUKŲ;6632884258;Ne;0;6;1;7
1537;Drugelis;NYKŠTUKŲ;7447519502;Taip;4;0;0;4
1538;Drugelis;NYKŠTUKŲ;4523513611;Ne;0;5;0;5
1539;Drugelis;NYKŠTUKŲ;6594452094;Taip;18;1;0;19
1540;Drugelis;NYKŠTUKŲ;4825232236;Taip;7;2;0;9
1541;Drugelis;NYKŠTUKŲ;7477547789;Taip;0;1;0;1
1542;Drugelis;NYKŠTUKŲ;8717445483;Taip;4;5;0;9
1543;Drugelis;NYKŠTUKŲ;4471405682;Taip;0;0;1;1
1544;Drugelis;NYKŠTUKŲ;4867387611;Taip;2;7;0;9
1545;Drugelis;NYKŠTUKŲ;7609530453;Taip;0;1;2;3
1546;Drugelis;NYKŠTUKŲ;8070030439;Taip;1;2;0;3
1547;Drugelis;NYKŠTUKŲ;3061896520;Taip;6;0;0;6
1548;Drugelis;NYKŠTUKŲ;4927896706;Taip;0;2;0;2
1549;Drugelis;NYKŠTUKŲ;5692743298;Taip;0;12;0;12
1550;Drugelis;NYKŠTUKŲ;6452921695;Taip;10;2;1;13
1551;Drugelis;NYKŠTUKŲ;1164620381;Taip;0;2;1;3
1552;Drugelis;SMALSUČIŲ;5121351234;Taip;20;0;0;20
1553;Drugelis;SMALSUČIŲ;5000965458;Taip;17;3;0;20
1554;Drugelis;SMALSUČIŲ;9683350741;Taip;11;4;0;15
1555;Drugelis;SMALSUČIŲ;1617833459;Taip;0;8;0;8
1556;Drugelis;SMALSUČIŲ;6533325098;Taip;9;0;0;9
1557;Drugelis;SMALSUČIŲ;4805858183;Taip;20;0;0;20
1558;Drugelis;SMALSUČIŲ;9650052415;Taip;10;0;1;11
1559;Drugelis;SMALSUČIŲ;5533529267;Taip;0;1;0;1
1560;Drugelis;SMALSUČIŲ;3733097479;Taip;5;0;1;6
1561;Drugelis;SMALSUČIŲ;2196445523;Taip;0;5;0;5
1562;Drugelis;SMALSUČIŲ;3645668411;Taip;4;5;0;9
1563;Drugelis;SMALSUČIŲ;3261462674;Taip;0;4;0;4
1564;Drugelis;SMALSUČIŲ;8186338261;Taip;8;12;0;20
1565;Drugelis;SMALSUČIŲ;3372145698;Taip;0;0;2;2
1566;Drugelis;SMALSUČIŲ;6613520046;Taip;6;0;1;7
1567;Drugelis;SMALSUČIŲ;6890441262;Taip;0;4;0;4
1568;Drugelis;MUMINUKŲ;7390061272;Taip;7;0;0;7
1569;Drugelis;MUMINUKŲ;3311620018;Taip;10;0;0;10
1570;Drugelis;MUMINUKŲ;5661335344;Taip;5;1;0;6
1571;Drugelis;MUMINUKŲ;6038184222;Taip;15;0;0;15
1572;Drugelis;MUMINUKŲ;7253876812;Taip;13;0;0;13
1573;Drugelis;MUMINUKŲ;1666992752;Taip;10;0;0;10
1574;Drugelis;MUMINUKŲ;9510744779;Taip;0;5;0;5
1575;Drugelis;MUMINUKŲ;9029137302;Taip;1;0;0;1
1576;Drugelis;MUMINUKŲ;9907121223;Taip;7;0;0;7
1577;Drugelis;MUMINUKŲ;8500348389;Ne;0;2;0;2
1578;Drugelis;MUMINUKŲ;1858504360;Taip;8;3;0;11
1579;Drugelis;MUMINUKŲ;8107970910;Taip;0;7;0;7
1580;Drugelis;MUMINUKŲ;5515894973;Taip;11;2;0;13
1581;Drugelis;MUMINUKŲ;3293212749;Taip;0;0;1;1
1582;Drugelis;MUMINUKŲ;2256221485;Taip;5;0;0;5
1583;Drugelis;MUMINUKŲ;9588931333;Taip;0;2;0;2
1584;Drugelis;MUMINUKŲ;1761596625;Taip;23;0;0;23
1585;Drugelis;PŪKUOTUKAI;9149748841;Ne;0;6;2;8
1586;Drugelis;PŪKUOTUKAI;1217635751;Taip;0;1;5;6
1587;Drugelis;PŪKUOTUKAI;9612696781;Taip;0;8;0;8
1588;Drugelis;PŪKUOTUKAI;1888002607;Taip;0;3;0;3
1589;Drugelis;PŪKUOTUKAI;27569805506;Taip;0;7;0;7
1590;Drugelis;PŪKUOTUKAI;1901608445;Taip;0;8;0;8
1591;Drugelis;PŪKUOTUKAI;1506988472;Taip;0;8;0;8
1592;Drugelis;PŪKUOTUKAI;1991420008;Taip;0;7;0;7
1593;Drugelis;PŪKUOTUKAI;1856912386;Taip;7;0;0;7
1594;Drugelis;PŪKUOTUKAI;1576853049;Taip;0;1;0;1
1595;Drugelis;PŪKUOTUKAI;68223183150;Taip;0;3;0;3
1596;Drugelis;PŪKUOTUKAI;3202149560;Taip;0;1;0;1
1597;Drugelis;PŪKUOTUKAI;1421438458;Ne;0;5;0;5
1598;Drugelis;PŪKUOTUKAI;5954059321;Taip;15;4;0;19
1599;Drugelis;PŪKUOTUKAI;53874036107;Taip;0;3;0;3
1600;Drugelis;PŪKUOTUKAI;4788423265;Taip;0;1;0;1
1601;Drugelis;PŪKUOTUKAI;3096906506;Taip;0;1;0;1
1602;Drugelis;SPINDULIUKAI;3081918342;Taip;3;0;5;8
1603;Drugelis;SPINDULIUKAI;3560294703;Taip;14;0;0;14
1604;Drugelis;SPINDULIUKAI;1215586620;Taip;5;0;0;5
1605;Drugelis;SPINDULIUKAI;9005448398;Taip;22;0;0;22
1606;Drugelis;SPINDULIUKAI;2926662708;Ne;1;0;0;1
1607;Drugelis;SPINDULIUKAI;6504082488;Taip;0;4;0;4
1608;Drugelis;SPINDULIUKAI;7321544601;Taip;0;1;1;2
1609;Drugelis;SPINDULIUKAI;9296067137;Taip;14;1;0;15
1610;Drugelis;SPINDULIUKAI;9855121078;Taip;19;1;0;20
1611;Drugelis;SPINDULIUKAI;6068102133;Taip;18;0;0;18
1612;Drugelis;SPINDULIUKAI;7825151440;Taip;14;1;0;15
1613;Drugelis;SPINDULIUKAI;4812322553;Taip;9;4;0;13
1614;Drugelis;SPINDULIUKAI;6032568621;Taip;0;0;1;1
1615;Drugelis;SPINDULIUKAI;4580456500;Taip;15;0;0;15
1616;Drugelis;SPINDULIUKAI;8259051898;Taip;8;0;4;12
1617;Drugelis;KIŠKUČIAI;3603051567;Taip;9;0;0;9
1618;Drugelis;KIŠKUČIAI;4628926113;Taip;3;8;0;11
1619;Drugelis;KIŠKUČIAI;7307032077;Taip;0;5;0;5
1620;Drugelis;KIŠKUČIAI;1213610973;Taip;15;0;0;15
1621;Drugelis;KIŠKUČIAI;6071997970;Taip;4;5;0;9
1622;Drugelis;KIŠKUČIAI;5950704328;Taip;0;10;0;10
1623;Drugelis;KIŠKUČIAI;9900296726;Taip;15;0;0;15
1624;Drugelis;KIŠKUČIAI;4898099506;Taip;2;1;0;3
1625;Drugelis;KIŠKUČIAI;6997707085;Ne;2;2;1;5
1626;Drugelis;KIŠKUČIAI;1375535260;Taip;0;0;2;2
1627;Drugelis;KIŠKUČIAI;5857726963;Taip;7;0;2;9
1628;Drugelis;KIŠKUČIAI;1817932444;Taip;6;0;0;6
1629;Drugelis;KIŠKUČIAI;9329642466;Taip;0;2;1;3
1630;"Du gaideliai";Uodelių;8896316882;Taip;0;0;1;1
1631;"Du gaideliai";Uodelių;6704167983;Taip;1;9;0;10
1632;"Du gaideliai";Uodelių;6942798420;Taip;0;4;0;4
1633;"Du gaideliai";Uodelių;8420400705;Taip;10;1;0;11
1634;"Du gaideliai";Uodelių;2826490663;Taip;0;0;1;1
1635;"Du gaideliai";Uodelių;4157021754;Taip;0;0;1;1
1636;"Du gaideliai";Uodelių;7193151965;Ne;4;7;0;11
1637;"Du gaideliai";Uodelių;1968978650;Taip;5;0;0;5
1638;"Du gaideliai";Uodelių;2564259600;Taip;3;0;0;3
1639;"Du gaideliai";Uodelių;6132405512;Taip;0;13;0;13
1640;"Du gaideliai";Uodelių;2756525592;Taip;0;3;0;3
1641;"Du gaideliai";Uodelių;7563789811;Taip;0;1;0;1
1642;"Du gaideliai";Uodelių;9126780620;Taip;0;1;0;1
1643;"Du gaideliai";Uodelių;9374869616;Ne;0;1;0;1
1644;"Du gaideliai";Uodelių;5726096980;Taip;9;0;0;9
1645;"Du gaideliai";Uodelių;4408537397;Taip;16;0;0;16
1646;"Du gaideliai";Uodelių;1527839162;Taip;13;3;1;17
1647;"Du gaideliai";Uodelių;5809089345;Taip;5;0;0;5
1648;"Du gaideliai";Uodelių;8174023197;Ne;12;1;0;13
1649;"Du gaideliai";Uodelių;7372149799;Taip;0;11;0;11
1650;"Du gaideliai";Uodelių;5291934919;Taip;0;6;0;6
1651;"Du gaideliai";OŽIUKŲ;8744467866;Taip;4;0;1;5
1652;"Du gaideliai";OŽIUKŲ;7033276798;Taip;0;3;0;3
1653;"Du gaideliai";OŽIUKŲ;5788923258;Taip;0;8;0;8
1654;"Du gaideliai";OŽIUKŲ;8042203623;Taip;3;2;0;5
1655;"Du gaideliai";OŽIUKŲ;3019797369;Taip;3;0;0;3
1656;"Du gaideliai";OŽIUKŲ;9356275460;Taip;0;12;0;12
1657;"Du gaideliai";OŽIUKŲ;6204233540;Taip;0;8;0;8
1658;"Du gaideliai";OŽIUKŲ;2845145754;Taip;0;8;0;8
1659;"Du gaideliai";OŽIUKŲ;7726490359;Taip;18;0;0;18
1660;"Du gaideliai";OŽIUKŲ;6762171696;Taip;5;0;0;5
1661;"Du gaideliai";OŽIUKŲ;5728374219;Taip;0;5;0;5
1662;"Du gaideliai";OŽIUKŲ;5611102395;Ne;0;1;0;1
1663;"Du gaideliai";OŽIUKŲ;8410547195;Taip;18;0;0;18
1664;"Du gaideliai";OŽIUKŲ;9585785202;Ne;0;1;0;1
1665;"Du gaideliai";OŽIUKŲ;2151825222;Taip;0;7;0;7
1666;"Du gaideliai";OŽIUKŲ;8043896286;Taip;3;5;0;8
1667;"Du gaideliai";OŽIUKŲ;6053941133;Taip;0;3;0;3
1668;"Du gaideliai";OŽIUKŲ;6120647567;Taip;0;8;0;8
1669;"Du gaideliai";Vištyčių;1135098595;Taip;0;0;1;1
1670;"Du gaideliai";Vištyčių;3370029981;Ne;0;5;0;5
1671;"Du gaideliai";Vištyčių;2240947701;Taip;0;0;2;2
1672;"Du gaideliai";Vištyčių;3507387826;Taip;0;11;0;11
1673;"Du gaideliai";Vištyčių;4144269068;Taip;0;12;0;12
1674;"Du gaideliai";Vištyčių;1785976627;Taip;0;6;0;6
1675;"Du gaideliai";Vištyčių;2921485707;Taip;0;0;3;3
1676;"Du gaideliai";Vištyčių;8047413507;Taip;1;1;6;8
1677;"Du gaideliai";Vištyčių;9568647033;Taip;5;0;4;9
1678;"Du gaideliai";Vištyčių;5894974508;Taip;0;3;3;6
1679;"Du gaideliai";Vištyčių;5998344519;Taip;7;0;0;7
1680;"Du gaideliai";Vištyčių;6247706405;Taip;12;0;0;12
1681;"Du gaideliai";Vištyčių;1751328192;Taip;0;1;1;2
1682;"Du gaideliai";Vištyčių;5652662610;Taip;5;2;0;7
1683;"Du gaideliai";Vištyčių;6870356241;Taip;0;2;0;2
1684;"Du gaideliai";Vištyčių;5103483956;Taip;0;3;5;8
1685;"Du gaideliai";Vištyčių;6348951959;Taip;5;0;0;5
1686;"Du gaideliai";Vištyčių;1268479215;Taip;0;5;0;5
1687;"Du gaideliai";Vištyčių;3854355215;Taip;0;0;20;20
1688;"Du gaideliai";Vištyčių;3849899284;Taip;0;3;0;3
1689;"Du gaideliai";Vištyčių;2262425557;Taip;5;0;1;6
1690;"Du gaideliai";GAIDŽIUKŲ;1758546983;Taip;0;8;0;8
1691;"Du gaideliai";GAIDŽIUKŲ;7783203480;Taip;0;3;4;7
1692;"Du gaideliai";GAIDŽIUKŲ;94639433266;Taip;0;3;0;3
1693;"Du gaideliai";GAIDŽIUKŲ;9324740716;Ne;5;3;0;8
1694;"Du gaideliai";GAIDŽIUKŲ;6715434585;Taip;0;4;1;5
1695;"Du gaideliai";GAIDŽIUKŲ;7084763712;Taip;0;4;0;4
1696;"Du gaideliai";GAIDŽIUKŲ;1500684755;Ne;5;6;0;11
1697;"Du gaideliai";GAIDŽIUKŲ;6750787450;Taip;0;3;0;3
1698;"Du gaideliai";GAIDŽIUKŲ;5430986033;Taip;0;3;1;4
1699;"Du gaideliai";GAIDŽIUKŲ;27733314504;Taip;0;6;0;6
1700;"Du gaideliai";GAIDŽIUKŲ;1074783418;Taip;5;0;0;5
1701;"Du gaideliai";GAIDŽIUKŲ;5167460184;Taip;0;3;0;3
1702;"Du gaideliai";GAIDŽIUKŲ;3771563320;Taip;0;3;0;3
1703;"Du gaideliai";GAIDŽIUKŲ;6170362846;Taip;0;3;0;3
1704;"Du gaideliai";GAIDŽIUKŲ;1962859229;Taip;0;2;0;2
1705;"Du gaideliai";GAIDŽIUKŲ;7373413569;Taip;0;6;0;6
1706;"Du gaideliai";GAIDŽIUKŲ;1557413692;Taip;0;6;0;6
1707;"Du gaideliai";GAIDŽIUKŲ;3273574176;Taip;5;1;0;6
1708;"Du gaideliai";GAIDŽIUKŲ;7471332824;Taip;0;16;0;16
1709;"Du gaideliai";GAIDŽIUKŲ;4378924981;Taip;0;5;0;5
1710;"Du gaideliai";Musyčių;9506572113;Ne;8;6;0;14
1711;"Du gaideliai";Musyčių;6224116229;Taip;3;0;1;4
1712;"Du gaideliai";Musyčių;6630053388;Ne;5;3;2;10
1713;"Du gaideliai";Musyčių;3654057453;Taip;1;7;0;8
1714;"Du gaideliai";Musyčių;8921985681;Taip;15;7;0;22
1715;"Du gaideliai";Musyčių;1882241729;Taip;7;0;2;9
1716;"Du gaideliai";Musyčių;5225949099;Taip;5;1;1;7
1717;"Du gaideliai";Musyčių;4204930257;Taip;3;0;1;4
1718;"Du gaideliai";Musyčių;3206388799;Taip;0;7;0;7
1719;"Du gaideliai";Musyčių;2616106413;Taip;16;0;0;16
1720;"Du gaideliai";Musyčių;9934568135;Taip;6;7;0;13
1721;"Du gaideliai";Musyčių;4799107717;Taip;5;2;0;7
1722;"Du gaideliai";Musyčių;8624394105;Taip;0;6;0;6
1723;"Du gaideliai";Musyčių;2122841302;Taip;16;0;1;17
1724;"Du gaideliai";Musyčių;7153424410;Taip;0;5;0;5
1725;"Du gaideliai";Musyčių;5514521078;Taip;0;7;0;7
1726;"Du gaideliai";MALŪNO;9561040908;Taip;8;0;0;8
1727;"Du gaideliai";MALŪNO;1048130675;Ne;6;0;0;6
1728;"Du gaideliai";MALŪNO;1777283565;Taip;15;0;1;16
1729;"Du gaideliai";MALŪNO;5113352673;Taip;8;0;1;9
1730;"Du gaideliai";MALŪNO;9477645505;Taip;0;0;2;2
1731;"Du gaideliai";MALŪNO;5142411841;Ne;5;0;1;6
1732;"Du gaideliai";MALŪNO;7855653537;Taip;13;0;0;13
1733;"Du gaideliai";MALŪNO;9832883242;Taip;8;0;0;8
1734;"Du gaideliai";MALŪNO;5016914497;Taip;0;0;12;12
1735;"Du gaideliai";MALŪNO;5060904810;Taip;7;0;0;7
1736;"Du gaideliai";MALŪNO;6054058539;Taip;0;1;0;1
1737;Eglutė;RAMUNĖ;1422631723;Taip;2;14;0;16
1738;Eglutė;RAMUNĖ;6709551046;Ne;8;0;0;8
1739;Eglutė;RAMUNĖ;6093932811;Taip;0;5;0;5
1740;Eglutė;RAMUNĖ;2651867769;Taip;2;0;0;2
1741;Eglutė;RAMUNĖ;3473388722;Taip;0;1;0;1
1742;Eglutė;RAMUNĖ;2597978713;Ne;0;10;0;10
1743;Eglutė;RAMUNĖ;4451772812;Taip;0;0;3;3
1744;Eglutė;RAMUNĖ;9929681000;Taip;0;0;3;3
1745;Eglutė;RAMUNĖ;6105927493;Taip;0;0;3;3
1746;Eglutė;RAMUNĖ;4560670047;Taip;0;0;1;1
1747;Eglutė;RAMUNĖ;1048451048;Taip;0;3;1;4
1748;Eglutė;RAMUNĖ;6142326330;Ne;0;0;8;8
1749;Eglutė;RAMUNĖ;9728550000;Taip;6;0;1;7
1750;Eglutė;RAMUNĖ;1534556744;Taip;0;0;1;1
1751;Eglutė;RAMUNĖ;4047404616;Taip;6;1;0;7
1752;Eglutė;RAMUNĖ;4230594049;Taip;16;0;0;16
1753;Eglutė;RAMUNĖ;2998190195;Ne;0;0;2;2
1754;Eglutė;RAMUNĖ;9402686801;Taip;5;0;0;5
1755;Eglutė;RAMUNĖ;6279703448;Ne;0;0;8;8
1756;Eglutė;RAMUNĖ;7598993411;Taip;10;1;0;11
1757;Eglutė;PELĖDŽIUKAI;9066178904;Taip;0;6;0;6
1758;Eglutė;PELĖDŽIUKAI;7149060118;Taip;0;0;1;1
1759;Eglutė;PELĖDŽIUKAI;8606991706;Taip;3;0;0;3
1760;Eglutė;PELĖDŽIUKAI;6518497374;Taip;0;4;0;4
1761;Eglutė;PELĖDŽIUKAI;3203786388;Taip;0;8;0;8
1762;Eglutė;PELĖDŽIUKAI;8033370429;Taip;0;1;4;5
1763;Eglutė;PELĖDŽIUKAI;3178489517;Taip;13;0;0;13
1764;Eglutė;PELĖDŽIUKAI;3393414294;Taip;0;8;0;8
1765;Eglutė;PELĖDŽIUKAI;1510706652;Taip;0;1;0;1
1766;Eglutė;PELĖDŽIUKAI;1695732622;Taip;0;1;0;1
1767;Eglutė;PELĖDŽIUKAI;9333028072;Taip;0;1;0;1
1768;Eglutė;PELĖDŽIUKAI;5856250605;Taip;5;0;0;5
1769;Eglutė;PELĖDŽIUKAI;2638807860;Taip;6;0;1;7
1770;Eglutė;PELĖDŽIUKAI;2082716398;Taip;0;4;0;4
1771;Eglutė;PELĖDŽIUKAI;3616979217;Taip;5;1;0;6
1772;Eglutė;PELĖDŽIUKAI;9950953029;Taip;10;3;2;15
1773;Eglutė;PELĖDŽIUKAI;6835296034;Taip;0;3;1;4
1774;Eglutė;PELĖDŽIUKAI;7148210944;Taip;0;3;0;3
1775;Eglutė;PELĖDŽIUKAI;1324622835;Taip;7;1;1;9
1776;Eglutė;PELĖDŽIUKAI;1209962222;Taip;0;0;1;1
1777;Eglutė;PELĖDŽIUKAI;3275796441;Ne;0;3;0;3
1778;Eglutė;PELĖDŽIUKAI;1806495674;Taip;4;0;0;4
1779;Eglutė;KODĖLČIUKAI;4490295754;Ne;5;3;0;8
1780;Eglutė;KODĖLČIUKAI;1932785408;Taip;0;10;3;13
1781;Eglutė;KODĖLČIUKAI;3883122650;Taip;7;7;0;14
1782;Eglutė;KODĖLČIUKAI;7859815752;Taip;8;3;1;12
1783;Eglutė;KODĖLČIUKAI;4176597208;Taip;0;4;0;4
1784;Eglutė;KODĖLČIUKAI;7758643349;Taip;5;10;0;15
1785;Eglutė;KODĖLČIUKAI;6483580751;Taip;4;0;0;4
1786;Eglutė;KODĖLČIUKAI;5924994736;Taip;12;0;0;12
1787;Eglutė;KODĖLČIUKAI;1759383841;Ne;0;6;0;6
1788;Eglutė;KODĖLČIUKAI;6597261061;Taip;0;2;0;2
1789;Eglutė;KODĖLČIUKAI;9046652370;Taip;0;0;2;2
1790;Eglutė;KODĖLČIUKAI;9356785605;Taip;0;6;0;6
1791;Eglutė;KODĖLČIUKAI;8943684351;Taip;2;0;2;4
1792;Eglutė;KODĖLČIUKAI;8165126017;Taip;0;1;0;1
1793;Eglutė;KODĖLČIUKAI;9967488317;Taip;5;3;0;8
1794;Eglutė;KODĖLČIUKAI;3584247594;Taip;0;12;0;12
1795;Eglutė;KODĖLČIUKAI;9758104910;Ne;8;3;4;15
1796;Eglutė;KODĖLČIUKAI;1531942494;Ne;0;5;0;5
1797;Eglutė;KODĖLČIUKAI;4635123721;Taip;0;2;0;2
1798;Eglutė;KODĖLČIUKAI;9515238936;Taip;8;1;0;9
1799;Eglutė;KODĖLČIUKAI;5840014240;Taip;0;21;0;21
1800;Eglutė;KODĖLČIUKAI;5678727198;Taip;0;0;2;2
1801;Eglutė;OBUOLIUKAI;3799824061;Ne;8;2;0;10
1802;Eglutė;OBUOLIUKAI;1744942011;Taip;11;5;0;16
1803;Eglutė;OBUOLIUKAI;7027121333;Taip;5;6;0;11
1804;Eglutė;OBUOLIUKAI;6679186715;Taip;18;0;0;18
1805;Eglutė;OBUOLIUKAI;8655425408;Ne;8;0;0;8
1806;Eglutė;OBUOLIUKAI;8384141923;Taip;10;3;1;14
1807;Eglutė;OBUOLIUKAI;5239028554;Ne;0;0;6;6
1808;Eglutė;OBUOLIUKAI;3112281182;Ne;22;0;0;22
1809;Eglutė;OBUOLIUKAI;1432716037;Taip;9;3;0;12
1810;Eglutė;OBUOLIUKAI;4876032787;Taip;2;0;0;2
1811;Eglutė;OBUOLIUKAI;9542684993;Taip;5;12;0;17
1812;Eglutė;OBUOLIUKAI;6967074765;Taip;15;3;0;18
1813;Eglutė;OBUOLIUKAI;9054104040;Taip;10;0;0;10
1814;Eglutė;OBUOLIUKAI;9193920390;Taip;11;0;0;11
1815;Eglutė;OBUOLIUKAI;8246870069;Taip;0;1;0;1
1816;Eglutė;OBUOLIUKAI;1380219881;Taip;0;3;10;13
1817;Eglutė;OBUOLIUKAI;8721209423;Taip;0;6;0;6
1818;Eglutė;OBUOLIUKAI;7789753835;Taip;0;1;2;3
1819;Eglutė;KAŠTONAS;4099257155;Taip;16;0;0;16
1820;Eglutė;KAŠTONAS;6009794480;Taip;0;13;0;13
1821;Eglutė;KAŠTONAS;4252256130;Taip;0;8;3;11
1822;Eglutė;KAŠTONAS;5636437290;Ne;0;2;5;7
1823;Eglutė;KAŠTONAS;5190045146;Taip;0;7;0;7
1824;Eglutė;KAŠTONAS;3985929379;Taip;0;2;0;2
1825;Eglutė;KAŠTONAS;8797889347;Taip;3;3;1;7
1826;Eglutė;KAŠTONAS;1842517164;Taip;15;0;1;16
1827;Eglutė;KAŠTONAS;7703290039;Taip;9;0;5;14
1828;Eglutė;KAŠTONAS;7530638623;Taip;0;0;9;9
1829;Eglutė;KAŠTONAS;2121177107;Taip;14;0;0;14
1830;Eglutė;KAŠTONAS;2357276888;Taip;0;0;13;13
1831;Eglutė;KAŠTONAS;2816913563;Taip;12;0;0;12
1832;Eglutė;KAŠTONAS;7098548563;Taip;0;0;4;4
1833;Eglutė;KAŠTONAS;6146679388;Taip;14;4;0;18
1834;Eglutė;KAŠTONAS;5166183300;Taip;0;13;0;13
1835;Eglutė;KAŠTONAS;7984911632;Taip;14;0;0;14
1836;Eglutė;EŽIUKAI;7491022301;Taip;0;2;2;4
1837;Eglutė;EŽIUKAI;5943856319;Taip;0;3;1;4
1838;Eglutė;EŽIUKAI;1436966647;Taip;6;0;0;6
1839;Eglutė;EŽIUKAI;6891834971;Taip;0;1;0;1
1840;Eglutė;EŽIUKAI;7307564177;Ne;0;1;3;4
1841;Eglutė;EŽIUKAI;7823828202;Taip;0;0;1;1
1842;Eglutė;EŽIUKAI;7354260503;Ne;0;3;0;3
1843;Eglutė;EŽIUKAI;9439309687;Taip;0;0;3;3
1844;Eglutė;EŽIUKAI;1122308715;Taip;0;2;0;2
1845;Eglutė;EŽIUKAI;8523618773;Taip;0;5;0;5
1846;Eglutė;EŽIUKAI;3856651647;Taip;0;3;2;5
1847;Eglutė;EŽIUKAI;8421062747;Taip;6;4;0;10
1848;Eglutė;EŽIUKAI;9992438336;Taip;0;0;2;2
1849;Eglutė;EŽIUKAI;5731355126;Taip;4;3;0;7
1850;Eglutė;EŽIUKAI;8364693548;Ne;5;8;0;13
1851;Eglutė;EŽIUKAI;1265463853;Taip;0;3;0;3
1852;Eglutė;EŽIUKAI;1321901982;Taip;0;7;0;7
1853;Eglutė;EŽIUKAI;9527732584;Taip;8;2;3;13
1854;Eglutė;EŽIUKAI;8162972897;Taip;7;0;0;7
1855;Eglutė;EŽIUKAI;4348313801;Taip;0;3;3;6
1856;Eglutė;EŽIUKAI;9042793284;Taip;10;0;0;10
1857;Eglutė;GILĖ;1550045866;Taip;0;0;1;1
1858;Eglutė;GILĖ;2857760751;Taip;1;0;0;1
1859;Eglutė;GILĖ;5650957826;Taip;11;0;0;11
1860;Eglutė;GILĖ;8129230197;Taip;0;8;1;9
1861;Eglutė;GILĖ;1835565594;Taip;0;0;7;7
1862;Eglutė;GILĖ;1393626624;Taip;0;1;0;1
1863;Eglutė;GILĖ;3740322448;Taip;0;8;0;8
1864;Eglutė;GILĖ;9746021019;Taip;5;0;0;5
1865;Eglutė;GILĖ;1814323427;Taip;5;0;7;12
1866;Eglutė;GILĖ;5013664843;Taip;6;0;2;8
1867;Eglutė;GILĖ;2276311106;Taip;0;0;10;10
1868;Eglutė;GILĖ;6924344686;Taip;0;0;1;1
1869;Eglutė;GILĖ;5645197324;Taip;15;0;0;15
1870;Eglutė;GILĖ;7800243796;Taip;3;0;4;7
1871;Eglutė;GILĖ;2615824395;Taip;0;3;0;3
1872;Eglutė;GILĖ;1899379269;Taip;10;0;3;13
1873;Eglutė;GILĖ;3605053253;Taip;5;2;0;7
1874;Eglutė;SAULUTĖ;9741776217;Taip;0;4;0;4
1875;Eglutė;SAULUTĖ;5285593057;Taip;9;0;0;9
1876;Eglutė;SAULUTĖ;3091324735;Taip;0;3;0;3
1877;Eglutė;SAULUTĖ;8739346084;Taip;0;4;0;4
1878;Eglutė;SAULUTĖ;5518570006;Taip;0;4;0;4
1879;Eglutė;SAULUTĖ;5805450838;Ne;0;0;2;2
1880;Eglutė;SAULUTĖ;9084576953;Ne;0;3;9;12
1881;Eglutė;SAULUTĖ;6309529738;Taip;0;6;0;6
1882;Eglutė;SAULUTĖ;2259077568;Ne;0;3;0;3
1883;Eglutė;SAULUTĖ;4489150480;Taip;0;15;0;15
1884;Eglutė;SAULUTĖ;2425927050;Ne;8;1;2;11
1885;Eglutė;SAULUTĖ;5918429438;Taip;5;0;3;8
1886;Eglutė;SAULUTĖ;5006042568;Taip;0;1;0;1
1887;Eglutė;SAULUTĖ;5275306818;Taip;0;0;6;6
1888;Eglutė;SAULUTĖ;6328900251;Taip;0;3;0;3
1889;Eglutė;SAULUTĖ;9661883776;Taip;6;11;0;17
1890;Eglutė;SAULUTĖ;5505398901;Taip;5;3;0;8
1891;Eglutė;SAULUTĖ;8799063905;Taip;0;1;0;1
1892;Eglutė;SAULUTĖ;5108928996;Taip;5;3;0;8
1893;Eglutė;SAULUTĖ;6572235324;Taip;8;0;0;8
1894;Eglutė;SAULUTĖ;1923176808;Ne;0;0;3;3
1895;Eglutė;SAULUTĖ;2872597971;Taip;11;0;0;11
1896;Eglutė;SAULUTĖ;6424893248;Taip;13;0;4;17
1897;Eglutė;SAULUTĖ;3690266358;Taip;0;1;4;5
1898;Eglutė;ŠARKELĖ;7831541089;Taip;10;0;0;10
1899;Eglutė;ŠARKELĖ;3430016771;Taip;8;9;0;17
1900;Eglutė;ŠARKELĖ;6382927775;Taip;9;4;0;13
1901;Eglutė;ŠARKELĖ;7919553451;Taip;13;3;0;16
1902;Eglutė;ŠARKELĖ;7658345479;Taip;3;1;0;4
1903;Eglutė;ŠARKELĖ;7229612001;Ne;10;4;0;14
1904;Eglutė;ŠARKELĖ;4932945207;Taip;2;16;0;18
1905;Eglutė;ŠARKELĖ;5407757245;Taip;15;0;0;15
1906;Eglutė;ŠARKELĖ;3237476593;Taip;0;3;0;3
1907;Eglutė;ŠARKELĖ;9542103745;Ne;12;3;1;16
1908;Eglutė;ŠARKELĖ;5509138443;Taip;0;23;0;23
1909;Eglutė;ŠARKELĖ;9686836846;Taip;13;1;0;14
1910;Eglutė;ŠARKELĖ;7735192219;Taip;13;1;0;14
1911;Eglutė;ŠARKELĖ;5779671024;Taip;0;6;0;6
1912;Eglutė;ŠARKELĖ;5783776734;Taip;3;8;0;11
1913;Eglutė;ŠARKELĖ;4490541539;Taip;0;8;0;8
1914;Eglutė;ŠARKELĖ;5947727288;Taip;2;2;0;4
1915;Eglutė;ŠARKELĖ;6653111225;Taip;0;0;4;4
1916;Eglutė;NYKŠTUKAI;3011330968;Taip;0;3;0;3
1917;Eglutė;NYKŠTUKAI;8037564034;Taip;0;9;0;9
1918;Eglutė;NYKŠTUKAI;3368734808;Taip;0;5;0;5
1919;Eglutė;NYKŠTUKAI;8749425471;Ne;2;8;0;10
1920;Eglutė;NYKŠTUKAI;4151258155;Taip;5;0;2;7
1921;Eglutė;NYKŠTUKAI;5103022009;Taip;0;4;0;4
1922;Eglutė;NYKŠTUKAI;3091697091;Taip;8;0;0;8
1923;Eglutė;NYKŠTUKAI;4823811890;Taip;0;8;1;9
1924;Eglutė;NYKŠTUKAI;9292940501;Taip;4;0;0;4
1925;Eglutė;NYKŠTUKAI;7313013331;Taip;12;0;0;12
1926;Eglutė;NYKŠTUKAI;3051637136;Taip;7;1;0;8
1927;Eglutė;NYKŠTUKAI;3089527202;Taip;5;0;1;6
1928;Eglutė;NYKŠTUKAI;2669400743;Taip;0;1;0;1
1929;Eglutė;NYKŠTUKAI;1460628870;Taip;3;0;0;3
1930;Eglutė;NYKŠTUKAI;4427853197;Taip;0;0;1;1
1931;Eglutė;ŽIRNIUKAI;3706904006;Taip;3;0;4;7
1932;Eglutė;ŽIRNIUKAI;8698242107;Taip;0;0;21;21
1933;Eglutė;ŽIRNIUKAI;2666894761;Taip;10;0;0;10
1934;Eglutė;ŽIRNIUKAI;6103657328;Ne;5;0;0;5
1935;Eglutė;ŽIRNIUKAI;4465995209;Taip;0;0;9;9
1936;Eglutė;ŽIRNIUKAI;9795027066;Ne;15;0;6;21
1937;Eglutė;ŽIRNIUKAI;4539946535;Taip;11;0;2;13
1938;Eglutė;ŽIRNIUKAI;3974970972;Taip;5;3;2;10
1939;Eglutė;ŽIRNIUKAI;2107488723;Taip;10;0;5;15
1940;Eglutė;ŽIRNIUKAI;9381529574;Taip;7;0;3;10
1941;Eglutė;ŽIRNIUKAI;9150254806;Taip;2;0;0;2
1942;Eglutė;ŽIRNIUKAI;7256251859;Taip;0;6;0;6
1943;Eglutė;ŽIRNIUKAI;1630732306;Ne;3;5;0;8
1944;Eglutė;BORUŽIUKAI;5592515139;Taip;12;0;0;12
1945;Eglutė;BORUŽIUKAI;1630903587;Taip;10;11;0;21
1946;Eglutė;BORUŽIUKAI;7254436716;Taip;5;5;0;10
1947;Eglutė;BORUŽIUKAI;5982037450;Taip;9;0;0;9
1948;Eglutė;BORUŽIUKAI;7994301287;Taip;8;10;1;19
1949;Eglutė;BORUŽIUKAI;9300315869;Taip;16;0;0;16
1950;Eglutė;BORUŽIUKAI;7231828805;Taip;8;0;0;8
1951;Eglutė;BORUŽIUKAI;5704418881;Taip;11;0;0;11
1952;Eglutė;BORUŽIUKAI;8410302338;Taip;5;0;1;6
1953;Eglutė;BORUŽIUKAI;1667851586;Taip;12;0;0;12
1954;Eglutė;BORUŽIUKAI;7564179845;Taip;7;0;3;10
1955;Eglutė;BORUŽIUKAI;9178835404;Taip;0;0;17;17
1956;Eglutė;BORUŽIUKAI;5146804510;Taip;18;0;0;18
1957;Eglutė;BORUŽIUKAI;7618937988;Taip;0;13;0;13
1958;Eglutė;BORUŽIUKAI;6805213753;Taip;0;0;7;7
1959;Eglutė;BORUŽIUKAI;6773894090;Taip;7;0;0;7
1960;"Geniukų kalvė";SAULUTĖS;9557055841;Taip;9;1;0;10
1961;"Geniukų kalvė";SAULUTĖS;4329782598;Taip;0;12;0;12
1962;"Geniukų kalvė";SAULUTĖS;8932671578;Taip;5;0;3;8
1963;"Geniukų kalvė";SAULUTĖS;9711047774;Taip;13;0;0;13
1964;"Geniukų kalvė";SAULUTĖS;1910363787;Taip;0;3;1;4
1965;"Geniukų kalvė";SAULUTĖS;9522911738;Taip;0;1;8;9
1966;"Geniukų kalvė";SAULUTĖS;5348211316;Taip;0;2;0;2
1967;"Geniukų kalvė";SAULUTĖS;7886553419;Taip;3;0;4;7
1968;"Geniukų kalvė";SAULUTĖS;6384832317;Taip;6;3;7;16
1969;"Geniukų kalvė";SAULUTĖS;4946218794;Taip;0;2;1;3
1970;"Geniukų kalvė";SAULUTĖS;4525874796;Taip;0;0;8;8
1971;"Geniukų kalvė";SAULUTĖS;4745451344;Taip;3;0;0;3
1972;"Geniukų kalvė";SAULUTĖS;9768077014;Taip;0;3;0;3
1973;"Geniukų kalvė";SAULUTĖS;7889781552;Taip;0;0;6;6
1974;"Geniukų kalvė";SAULUTĖS;3889643236;Taip;11;0;6;17
1975;"Geniukų kalvė";SAULUTĖS;6016735700;Ne;0;2;2;4
1976;"Geniukų kalvė";SAULUTĖS;9976423099;Taip;3;0;0;3
1977;"Geniukų kalvė";BITUTĖS;5587035951;Taip;7;2;2;11
1978;"Geniukų kalvė";BITUTĖS;6527228763;Taip;11;0;0;11
1979;"Geniukų kalvė";BITUTĖS;9323779212;Taip;11;0;0;11
1980;"Geniukų kalvė";BITUTĖS;4908674542;Taip;5;0;2;7
1981;"Geniukų kalvė";BITUTĖS;7562355477;Taip;0;4;0;4
1982;"Geniukų kalvė";BITUTĖS;2110578252;Taip;3;0;0;3
1983;"Geniukų kalvė";BITUTĖS;8577323715;Taip;0;3;2;5
1984;"Geniukų kalvė";BITUTĖS;7453065865;Taip;8;0;2;10
1985;"Geniukų kalvė";BITUTĖS;8570015975;Taip;0;3;0;3
1986;"Geniukų kalvė";BITUTĖS;4633553106;Taip;12;3;1;16
1987;"Geniukų kalvė";BITUTĖS;3669378459;Ne;19;0;0;19
1988;"Geniukų kalvė";BITUTĖS;4201333532;Taip;9;3;0;12
1989;"Geniukų kalvė";BITUTĖS;5102325807;Taip;0;7;0;7
1990;"Geniukų kalvė";BITUTĖS;1492140432;Taip;15;0;0;15
1991;"Geniukų kalvė";BITUTĖS;6138451393;Taip;0;3;0;3
1992;"Geniukų kalvė";BITUTĖS;7747615302;Taip;0;2;0;2
1993;"Geniukų kalvė";BITUTĖS;4691978116;Taip;15;0;0;15
1994;"Geniukų kalvė";BITUTĖS;6111168227;Taip;5;0;0;5
1995;"Geniukų kalvė";BITUTĖS;7744441981;Taip;0;10;3;13
1996;"Geniukų kalvė";BITUTĖS;1209268848;Taip;0;6;2;8
1997;"Geniukų kalvė";BITUTĖS;6351861630;Taip;8;4;0;12
1998;"Geniukų kalvė";BITUTĖS;3221034847;Taip;0;0;4;4
1999;"Geniukų kalvė";KIŠKUČIAI;5253380852;Taip;0;0;1;1
2000;"Geniukų kalvė";KIŠKUČIAI;2684344984;Ne;0;11;0;11
2001;"Geniukų kalvė";KIŠKUČIAI;5824747638;Taip;17;0;0;17
2002;"Geniukų kalvė";KIŠKUČIAI;9075192344;Taip;17;0;0;17
2003;"Geniukų kalvė";KIŠKUČIAI;5078771341;Taip;9;0;1;10
2004;"Geniukų kalvė";KIŠKUČIAI;4849740486;Ne;0;15;0;15
2005;"Geniukų kalvė";KIŠKUČIAI;9730758999;Taip;5;0;2;7
2006;"Geniukų kalvė";KIŠKUČIAI;9579750299;Taip;0;0;3;3
2007;"Geniukų kalvė";KIŠKUČIAI;9543553237;Taip;5;0;0;5
2008;"Geniukų kalvė";KIŠKUČIAI;2032408983;Taip;5;0;0;5
2009;"Geniukų kalvė";KIŠKUČIAI;4639389587;Ne;0;3;0;3
2010;"Geniukų kalvė";KIŠKUČIAI;4507631652;Taip;0;2;0;2
2011;"Geniukų kalvė";KIŠKUČIAI;9386761753;Taip;7;6;0;13
2012;"Geniukų kalvė";KIŠKUČIAI;4864216994;Taip;5;0;0;5
2013;"Geniukų kalvė";KIŠKUČIAI;5604315555;Ne;3;11;0;14
2014;"Geniukų kalvė";KIŠKUČIAI;7784155503;Ne;3;11;0;14
2015;"Geniukų kalvė";KIŠKUČIAI;6188518268;Taip;5;0;1;6
2016;"Geniukų kalvė";KIŠKUČIAI;1945456486;Taip;0;5;0;5
2017;"Geniukų kalvė";VYTURĖLIAI;1568133009;Taip;5;5;0;10
2018;"Geniukų kalvė";VYTURĖLIAI;8939171238;Taip;2;3;0;5
2019;"Geniukų kalvė";VYTURĖLIAI;2337226175;Taip;0;2;0;2
2020;"Geniukų kalvė";VYTURĖLIAI;2140334255;Ne;0;3;0;3
2021;"Geniukų kalvė";VYTURĖLIAI;7664689396;Taip;10;0;0;10
2022;"Geniukų kalvė";VYTURĖLIAI;8635708009;Taip;0;0;2;2
2023;"Geniukų kalvė";VYTURĖLIAI;4758435835;Taip;0;6;0;6
2024;"Geniukų kalvė";VYTURĖLIAI;2729442911;Taip;0;2;0;2
2025;"Geniukų kalvė";VYTURĖLIAI;23023070502;Taip;0;0;1;1
2026;"Geniukų kalvė";VYTURĖLIAI;8668696743;Ne;1;0;0;1
2027;"Geniukų kalvė";VYTURĖLIAI;2262014110;Taip;0;4;0;4
2028;"Geniukų kalvė";VYTURĖLIAI;2890934301;Ne;0;2;0;2
2029;"Geniukų kalvė";VYTURĖLIAI;2904091819;Taip;0;3;0;3
2030;"Geniukų kalvė";VYTURĖLIAI;1947173142;Taip;2;0;0;2
2031;"Geniukų kalvė";VYTURĖLIAI;2043786151;Taip;0;1;0;1
2032;"Geniukų kalvė";VYTURĖLIAI;1460456166;Taip;5;1;0;6
2033;"Geniukų kalvė";VYTURĖLIAI;30932565379;Taip;5;5;1;11
2034;"Geniukų kalvė";VYTURĖLIAI;3826265557;Ne;5;1;0;6
2035;"Geniukų kalvė";DRUGELIAI;9676782662;Taip;3;2;0;5
2036;"Geniukų kalvė";DRUGELIAI;7745656622;Taip;0;1;0;1
2037;"Geniukų kalvė";DRUGELIAI;6520429663;Taip;5;3;0;8
2038;"Geniukų kalvė";DRUGELIAI;6466912385;Taip;0;2;0;2
2039;"Geniukų kalvė";DRUGELIAI;2718961466;Taip;0;5;1;6
2040;"Geniukų kalvė";DRUGELIAI;2016254460;Taip;0;6;0;6
2041;"Geniukų kalvė";DRUGELIAI;3984265624;Taip;0;14;0;14
2042;"Geniukų kalvė";DRUGELIAI;4813232640;Taip;0;3;0;3
2043;"Geniukų kalvė";DRUGELIAI;5776314197;Taip;0;9;0;9
2044;"Geniukų kalvė";DRUGELIAI;1897809684;Taip;0;3;0;3
2045;"Geniukų kalvė";DRUGELIAI;8872900558;Taip;0;3;0;3
2046;"Geniukų kalvė";DRUGELIAI;1451190239;Taip;0;4;0;4
2047;"Geniukų kalvė";DRUGELIAI;6511955882;Taip;0;3;0;3
2048;"Geniukų kalvė";DRUGELIAI;6500641378;Taip;0;2;0;2
2049;"Geniukų kalvė";DRUGELIAI;2143334688;Taip;0;1;0;1
2050;"Geniukų kalvė";DRUGELIAI;6498149304;Taip;0;1;0;1
2051;"Geniukų kalvė";DRUGELIAI;9990243525;Taip;0;2;1;3
2052;"Geniukų kalvė";DRUGELIAI;48818906299;Taip;5;0;0;5
2053;"Geniukų kalvė";DRUGELIAI;4105170344;Taip;0;5;0;5
2054;"Geniukų kalvė";"SAULĖS ZUIKUČIAI";7033628178;Taip;12;0;0;12
2055;"Geniukų kalvė";"SAULĖS ZUIKUČIAI";7082945033;Taip;8;3;0;11
2056;"Geniukų kalvė";"SAULĖS ZUIKUČIAI";2313382307;Taip;10;0;0;10
2057;"Geniukų kalvė";"SAULĖS ZUIKUČIAI";8309953586;Taip;10;0;0;10
2058;"Geniukų kalvė";"SAULĖS ZUIKUČIAI";1443348537;Taip;13;0;0;13
2059;"Geniukų kalvė";"SAULĖS ZUIKUČIAI";2783285969;Taip;15;0;0;15
2060;"Geniukų kalvė";"SAULĖS ZUIKUČIAI";7500079028;Taip;10;0;1;11
2061;"Geniukų kalvė";"SAULĖS ZUIKUČIAI";8071493871;Taip;5;0;3;8
2062;"Geniukų kalvė";"SAULĖS ZUIKUČIAI";8914605154;Taip;12;0;0;12
2063;"Geniukų kalvė";"SAULĖS ZUIKUČIAI";6016585056;Taip;5;0;0;5
2064;"Geniukų kalvė";"SAULĖS ZUIKUČIAI";2816691996;Taip;10;0;0;10
2065;"Geniukų kalvė";"SAULĖS ZUIKUČIAI";5512172533;Taip;0;10;0;10
2066;"Geniukų kalvė";"SAULĖS ZUIKUČIAI";1375674317;Taip;9;0;0;9
2067;"Geniukų kalvė";"SAULĖS ZUIKUČIAI";4722801116;Taip;8;0;0;8
2068;"Geniukų kalvė";"SAULĖS ZUIKUČIAI";5763009912;Taip;11;0;0;11
2069;"Geniukų kalvė";"SAULĖS ZUIKUČIAI";5245434552;Taip;0;3;0;3
2070;"Geniukų kalvė";"SAULĖS ZUIKUČIAI";2952604528;Taip;15;0;0;15
2071;"Geniukų kalvė";"SAULĖS ZUIKUČIAI";5725034297;Taip;16;0;0;16
2072;"Geniukų kalvė";"SAULĖS ZUIKUČIAI";1499735818;Taip;13;0;0;13
2073;"Geniukų kalvė";"SAULĖS ZUIKUČIAI";4186376527;Taip;7;0;0;7
2074;"Geniukų kalvė";"SAULĖS ZUIKUČIAI";5161600326;Taip;8;0;0;8
2075;"Geniukų kalvė";SMALSUČIAI;2499796674;Taip;4;0;0;4
2076;"Geniukų kalvė";SMALSUČIAI;5974481787;Taip;10;0;4;14
2077;"Geniukų kalvė";SMALSUČIAI;7915720190;Taip;16;0;0;16
2078;"Geniukų kalvė";SMALSUČIAI;7384802397;Taip;10;0;2;12
2079;"Geniukų kalvė";SMALSUČIAI;5993223458;Taip;6;0;0;6
2080;"Geniukų kalvė";SMALSUČIAI;8985466295;Taip;0;2;0;2
2081;"Geniukų kalvė";SMALSUČIAI;5705917381;Taip;0;0;1;1
2082;"Geniukų kalvė";SMALSUČIAI;4231659246;Taip;10;5;0;15
2083;"Geniukų kalvė";SMALSUČIAI;2300947427;Taip;10;3;0;13
2084;"Geniukų kalvė";SMALSUČIAI;1028242614;Taip;0;1;0;1
2085;"Geniukų kalvė";SMALSUČIAI;2596680448;Taip;6;0;0;6
2086;"Geniukų kalvė";SMALSUČIAI;6730270449;Taip;5;0;0;5
2087;"Geniukų kalvė";SMALSUČIAI;4405381922;Taip;12;0;0;12
2088;"Geniukų kalvė";SMALSUČIAI;6473724074;Taip;11;1;0;12
2089;"Geniukų kalvė";SMALSUČIAI;3627418555;Taip;12;4;0;16
2090;"Geniukų kalvė";SMALSUČIAI;9155681194;Ne;9;0;0;9
2091;"Geniukų kalvė";SMALSUČIAI;7440029486;Ne;7;2;0;9
2092;"Geniukų kalvė";SMALSUČIAI;7140298387;Taip;0;7;1;8
2093;"Geniukų kalvė";SMALSUČIAI;6168422514;Taip;23;0;0;23
2094;"Geniukų kalvė";RUDNOSIUKAI;7079072084;Taip;4;0;0;4
2095;"Geniukų kalvė";RUDNOSIUKAI;6149037133;Taip;0;5;0;5
2096;"Geniukų kalvė";RUDNOSIUKAI;5883913787;Taip;0;2;0;2
2097;"Geniukų kalvė";RUDNOSIUKAI;9696452101;Taip;0;0;1;1
2098;"Geniukų kalvė";RUDNOSIUKAI;2426186771;Taip;0;0;1;1
2099;"Geniukų kalvė";RUDNOSIUKAI;5205178173;Taip;4;0;0;4
2100;"Geniukų kalvė";RUDNOSIUKAI;2836282651;Taip;10;0;0;10
2101;"Geniukų kalvė";RUDNOSIUKAI;9847003556;Taip;5;0;0;5
2102;"Geniukų kalvė";RUDNOSIUKAI;7300853810;Taip;0;0;1;1
2103;"Geniukų kalvė";RUDNOSIUKAI;2839299179;Taip;11;2;0;13
2104;"Geniukų kalvė";RUDNOSIUKAI;4664026888;Taip;2;0;0;2
2105;"Geniukų kalvė";RUDNOSIUKAI;3852896932;Taip;5;1;2;8
2106;"Geniukų kalvė";RUDNOSIUKAI;2165793561;Taip;0;9;0;9
2107;"Geniukų kalvė";RUDNOSIUKAI;8973285553;Taip;10;0;0;10
2108;"Geniukų kalvė";RUDNOSIUKAI;4985606198;Taip;3;0;3;6
2109;"Geniukų kalvė";RUDNOSIUKAI;3152130511;Taip;0;1;1;2
2110;"Geniukų kalvė";RUDNOSIUKAI;2798750158;Taip;0;5;0;5
2111;"Geniukų kalvė";PELĖDŽIUKAI;2217221922;Taip;0;0;1;1
2112;"Geniukų kalvė";PELĖDŽIUKAI;8271041553;Taip;0;4;0;4
2113;"Geniukų kalvė";PELĖDŽIUKAI;1237228692;Taip;5;3;1;9
2114;"Geniukų kalvė";PELĖDŽIUKAI;2938446054;Taip;0;6;0;6
2115;"Geniukų kalvė";PELĖDŽIUKAI;3055777730;Taip;5;0;0;5
2116;"Geniukų kalvė";PELĖDŽIUKAI;6070945557;Ne;0;2;0;2
2117;"Geniukų kalvė";PELĖDŽIUKAI;1051563985;Taip;0;5;0;5
2118;"Geniukų kalvė";PELĖDŽIUKAI;6174114461;Taip;5;0;0;5
2119;"Geniukų kalvė";PELĖDŽIUKAI;2659298240;Taip;0;3;0;3
2120;"Geniukų kalvė";PELĖDŽIUKAI;6737863183;Taip;0;1;0;1
2121;"Geniukų kalvė";PELĖDŽIUKAI;5704223824;Ne;0;1;7;8
2122;"Geniukų kalvė";PELĖDŽIUKAI;1811866428;Ne;10;0;1;11
2123;"Geniukų kalvė";PELĖDŽIUKAI;4843411757;Taip;11;0;0;11
2124;"Geniukų kalvė";PELĖDŽIUKAI;8770345339;Taip;7;0;3;10
2125;"Geniukų kalvė";PELĖDŽIUKAI;5146141771;Taip;0;0;3;3
2126;"Geniukų kalvė";PELĖDŽIUKAI;1611845627;Taip;0;0;1;1
2127;"Geniukų kalvė";PELĖDŽIUKAI;9677583445;Ne;10;2;0;12
2128;"Geniukų kalvė";PELĖDŽIUKAI;9921191336;Taip;0;3;0;3
2129;"Geniukų kalvė";BORUŽĖLĖS;9613720001;Taip;0;7;0;7
2130;"Geniukų kalvė";BORUŽĖLĖS;4958738745;Taip;0;9;0;9
2131;"Geniukų kalvė";BORUŽĖLĖS;9069256760;Taip;8;0;0;8
2132;"Geniukų kalvė";BORUŽĖLĖS;5161535756;Taip;0;8;0;8
2133;"Geniukų kalvė";BORUŽĖLĖS;3493492581;Taip;0;3;0;3
2134;"Geniukų kalvė";BORUŽĖLĖS;3085228868;Taip;0;3;0;3
2135;"Geniukų kalvė";BORUŽĖLĖS;6794151223;Taip;4;1;0;5
2136;"Geniukų kalvė";BORUŽĖLĖS;4777155321;Taip;0;4;0;4
2137;"Geniukų kalvė";BORUŽĖLĖS;2180860623;Ne;0;1;0;1
2138;"Geniukų kalvė";BORUŽĖLĖS;8769761434;Taip;6;0;0;6
2139;"Geniukų kalvė";BORUŽĖLĖS;9643242164;Taip;0;6;0;6
2140;"Geniukų kalvė";BORUŽĖLĖS;2665955524;Taip;6;0;0;6
2141;"Geniukų kalvė";BORUŽĖLĖS;4872435715;Taip;0;0;10;10
2142;"Geniukų kalvė";BORUŽĖLĖS;3297360222;Taip;12;2;0;14
2143;"Geniukų kalvė";BORUŽĖLĖS;6828079735;Taip;13;0;0;13
2144;"Geniukų kalvė";BORUŽĖLĖS;2710207578;Taip;5;0;0;5
2145;"Geniukų kalvė";BORUŽĖLĖS;1046406910;Taip;7;0;5;12
2146;"Geniukų kalvė";BORUŽĖLĖS;1454724752;Taip;0;7;0;7
2147;"Geniukų kalvė";BORUŽĖLĖS;8052276633;Taip;0;3;0;3
2148;"Geniukų kalvė";BORUŽĖLĖS;3193006249;Taip;0;0;2;2
2149;"Geniukų kalvė";PAGRANDUKAI;1844495906;Taip;7;2;0;9
2150;"Geniukų kalvė";PAGRANDUKAI;7234620406;Taip;8;4;0;12
2151;"Geniukų kalvė";PAGRANDUKAI;6953313909;Taip;0;11;3;14
2152;"Geniukų kalvė";PAGRANDUKAI;4890413509;Taip;13;0;1;14
2153;"Geniukų kalvė";PAGRANDUKAI;2490231586;Taip;14;0;0;14
2154;"Geniukų kalvė";PAGRANDUKAI;9319251542;Taip;2;0;0;2
2155;"Geniukų kalvė";PAGRANDUKAI;7310171451;Taip;10;3;0;13
2156;"Geniukų kalvė";PAGRANDUKAI;9820642056;Taip;1;1;1;3
2157;"Geniukų kalvė";PAGRANDUKAI;5115570519;Taip;0;2;0;2
2158;"Geniukų kalvė";PAGRANDUKAI;6783296167;Taip;7;0;1;8
2159;"Geniukų kalvė";PAGRANDUKAI;5744371590;Taip;1;0;1;2
2160;"Geniukų kalvė";PAGRANDUKAI;5847488152;Ne;9;1;3;13
2161;"Geniukų kalvė";PAGRANDUKAI;3676717541;Taip;0;1;3;4
2162;"Geniukų kalvė";NYKŠTUKAI;7561521903;Taip;14;0;2;16
2163;"Geniukų kalvė";NYKŠTUKAI;2312298671;Ne;10;4;1;15
2164;"Geniukų kalvė";NYKŠTUKAI;8217855034;Taip;10;7;0;17
2165;"Geniukų kalvė";NYKŠTUKAI;1068112116;Taip;11;2;0;13
2166;"Geniukų kalvė";NYKŠTUKAI;2396085192;Taip;5;0;1;6
2167;"Geniukų kalvė";NYKŠTUKAI;1558977259;Taip;8;2;5;15
2168;"Geniukų kalvė";NYKŠTUKAI;4805806745;Taip;15;0;0;15
2169;"Geniukų kalvė";NYKŠTUKAI;1383717352;Taip;15;0;0;15
2170;"Geniukų kalvė";NYKŠTUKAI;3071724778;Taip;11;0;1;12
2171;"Geniukų kalvė";NYKŠTUKAI;2302465593;Taip;10;1;1;12
2172;"Geniukų kalvė";NYKŠTUKAI;3024701779;Taip;8;5;0;13
2173;"Geniukų kalvė";NYKŠTUKAI;1822730314;Taip;10;0;0;10
2174;"Geniukų kalvė";NYKŠTUKAI;3015544833;Taip;10;5;2;17
2175;"Geniukų kalvė";NYKŠTUKAI;7736527608;Taip;14;0;0;14
2176;Gelvonėlis;ĄŽUOLIUKAI;9058956012;Taip;0;12;0;12
2177;Gelvonėlis;ĄŽUOLIUKAI;3677100165;Ne;6;0;0;6
2178;Gelvonėlis;ĄŽUOLIUKAI;7449710008;Taip;0;2;0;2
2179;Gelvonėlis;ĄŽUOLIUKAI;9492898584;Ne;0;4;0;4
2180;Gelvonėlis;ĄŽUOLIUKAI;7070038335;Ne;10;5;0;15
2181;Gelvonėlis;ĄŽUOLIUKAI;3942630720;Taip;5;6;0;11
2182;Gelvonėlis;ĄŽUOLIUKAI;1453271708;Taip;0;5;0;5
2183;Gelvonėlis;ĄŽUOLIUKAI;9756155028;Taip;0;11;0;11
2184;Gelvonėlis;ĄŽUOLIUKAI;8206816148;Ne;10;0;0;10
2185;Gelvonėlis;ĄŽUOLIUKAI;3165015754;Taip;9;1;0;10
2186;Gelvonėlis;ĄŽUOLIUKAI;1274119900;Ne;0;10;0;10
2187;Gelvonėlis;ĄŽUOLIUKAI;5901499708;Taip;5;1;0;6
2188;Gelvonėlis;ĄŽUOLIUKAI;1403890893;Ne;6;2;0;8
2189;Gelvonėlis;ŽVIRBLIUKAI;6604992169;Taip;10;3;0;13
2190;Gelvonėlis;ŽVIRBLIUKAI;6556472766;Taip;5;3;2;10
2191;Gelvonėlis;ŽVIRBLIUKAI;7182180008;Taip;8;0;0;8
2192;Gelvonėlis;ŽVIRBLIUKAI;8885088900;Taip;0;3;0;3
2193;Gelvonėlis;ŽVIRBLIUKAI;2400289466;Taip;0;3;2;5
2194;Gelvonėlis;ŽVIRBLIUKAI;9493536517;Taip;23;0;0;23
2195;Gelvonėlis;ŽVIRBLIUKAI;9059244134;Taip;0;1;0;1
2196;Gelvonėlis;ŽVIRBLIUKAI;1987204544;Taip;0;9;0;9
2197;Gelvonėlis;ŽVIRBLIUKAI;2288951845;Taip;3;0;0;3
2198;Gelvonėlis;ŽVIRBLIUKAI;2515471132;Taip;5;0;0;5
2199;Gelvonėlis;ŽVIRBLIUKAI;1085845218;Taip;2;6;0;8
2200;Gelvonėlis;ŽVIRBLIUKAI;6319058542;Taip;5;0;2;7
2201;Gelvonėlis;ŽVIRBLIUKAI;9538571448;Taip;0;4;0;4
2202;Gelvonėlis;ŽVIRBLIUKAI;9147186080;Taip;0;5;0;5
2203;Gelvonėlis;ŽVIRBLIUKAI;7620280474;Ne;0;0;2;2
2204;Gelvonėlis;ŽVIRBLIUKAI;7195164378;Taip;0;0;2;2
2205;Gelvonėlis;ŽVIRBLIUKAI;6598178467;Taip;0;4;2;6
2206;Gelvonėlis;ŽVIRBLIUKAI;6068473734;Taip;6;0;0;6
2207;Gelvonėlis;ŽVIRBLIUKAI;8508450500;Taip;0;7;0;7
2208;Gelvonėlis;ŽVIRBLIUKAI;8704971956;Taip;0;0;4;4
2209;Gelvonėlis;ŽVIRBLIUKAI;4281431471;Taip;4;0;0;4
2210;Gelvonėlis;ŽVIRBLIUKAI;8976258838;Ne;6;0;0;6
2211;Gelvonėlis;RASELĖS;9667024635;Taip;0;3;1;4
2212;Gelvonėlis;RASELĖS;9369121356;Taip;0;0;2;2
2213;Gelvonėlis;RASELĖS;2119550116;Taip;6;3;0;9
2214;Gelvonėlis;RASELĖS;3788522708;Taip;0;3;1;4
2215;Gelvonėlis;RASELĖS;6317822775;Taip;0;0;1;1
2216;Gelvonėlis;RASELĖS;5047022305;Taip;7;0;0;7
2217;Gelvonėlis;RASELĖS;6189110767;Taip;0;3;1;4
2218;Gelvonėlis;RASELĖS;7983982378;Taip;0;4;0;4
2219;Gelvonėlis;RASELĖS;2108690954;Ne;0;1;0;1
2220;Gelvonėlis;RASELĖS;1753617545;Taip;7;1;0;8
2221;Gelvonėlis;RASELĖS;7759317220;Taip;0;4;0;4
2222;Gelvonėlis;RASELĖS;5721858659;Taip;10;3;0;13
2223;Gelvonėlis;RASELĖS;1399518471;Taip;0;3;0;3
2224;Gelvonėlis;RASELĖS;5283207520;Taip;0;0;1;1
2225;Gelvonėlis;RASELĖS;3059903126;Taip;0;2;0;2
2226;Gelvonėlis;RASELĖS;6226970200;Taip;5;3;0;8
2227;Gelvonėlis;RASELĖS;1246591538;Taip;2;3;2;7
2228;Gelvonėlis;RASELĖS;6256962184;Taip;0;3;14;17
2229;Gelvonėlis;RASELĖS;91441127098;Taip;0;2;0;2
2230;Gelvonėlis;RASELĖS;1610362831;Taip;0;3;0;3
2231;Gelvonėlis;RASELĖS;9387523651;Ne;0;13;0;13
2232;Gelvonėlis;RASELĖS;75676389361;Taip;5;3;3;11
2233;Gelvonėlis;RASELĖS;4120103012;Ne;8;3;6;17
2234;Gelvonėlis;SAULUTĖ;9396676137;Taip;4;0;0;4
2235;Gelvonėlis;SAULUTĖ;9353066785;Taip;2;0;0;2
2236;Gelvonėlis;SAULUTĖ;3121251271;Taip;0;3;0;3
2237;Gelvonėlis;SAULUTĖ;7429739147;Taip;13;0;4;17
2238;Gelvonėlis;SAULUTĖ;7392743619;Taip;13;0;0;13
2239;Gelvonėlis;SAULUTĖ;8228796927;Taip;13;0;0;13
2240;Gelvonėlis;SAULUTĖ;1368982977;Taip;0;0;2;2
2241;Gelvonėlis;SAULUTĖ;4550077609;Taip;8;0;2;10
2242;Gelvonėlis;SAULUTĖ;1734685590;Taip;4;0;3;7
2243;Gelvonėlis;SAULUTĖ;7936622964;Taip;10;0;0;10
2244;Gelvonėlis;SAULUTĖ;3719670896;Taip;0;5;0;5
2245;Gelvonėlis;SAULUTĖ;3771796903;Taip;0;6;0;6
2246;Gelvonėlis;SAULUTĖ;8022270555;Taip;0;4;0;4
2247;Gelvonėlis;SAULUTĖ;4268590631;Taip;5;3;0;8
2248;Gelvonėlis;SAULUTĖ;5598186460;Taip;15;0;1;16
2249;Gelvonėlis;SAULUTĖ;9767254134;Taip;5;0;0;5
2250;Gelvonėlis;SAULUTĖ;2452711535;Taip;0;1;0;1
2251;Gelvonėlis;SAULUTĖ;7977651492;Ne;1;0;1;2
2252;Gelvonėlis;PELĖDŽIUKAI;3830940009;Taip;0;3;0;3
2253;Gelvonėlis;PELĖDŽIUKAI;2742000725;Ne;0;1;2;3
2254;Gelvonėlis;PELĖDŽIUKAI;1284359362;Taip;0;2;5;7
2255;Gelvonėlis;PELĖDŽIUKAI;4855800131;Taip;0;10;1;11
2256;Gelvonėlis;PELĖDŽIUKAI;8775661719;Taip;0;3;0;3
2257;Gelvonėlis;PELĖDŽIUKAI;21684706944;Ne;0;1;0;1
2258;Gelvonėlis;PELĖDŽIUKAI;3089755141;Taip;0;3;1;4
2259;Gelvonėlis;PELĖDŽIUKAI;1408313697;Taip;0;0;2;2
2260;Gelvonėlis;PELĖDŽIUKAI;3670612781;Taip;3;3;0;6
2261;Gelvonėlis;PELĖDŽIUKAI;69073786634;Taip;0;1;0;1
2262;Gelvonėlis;PELĖDŽIUKAI;6255253658;Taip;0;3;2;5
2263;Gelvonėlis;PELĖDŽIUKAI;9323579468;Taip;0;1;0;1
2264;Gelvonėlis;PELĖDŽIUKAI;7919814808;Taip;0;3;4;7
2265;Gelvonėlis;PELĖDŽIUKAI;1355742622;Taip;0;3;0;3
2266;Gelvonėlis;PELĖDŽIUKAI;5798439412;Taip;0;1;0;1
2267;Gelvonėlis;DRUGELIAI;3371560338;Taip;9;0;0;9
2268;Gelvonėlis;DRUGELIAI;2407650243;Taip;6;1;0;7
2269;Gelvonėlis;DRUGELIAI;2896360160;Taip;0;2;1;3
2270;Gelvonėlis;DRUGELIAI;8365647638;Taip;0;3;0;3
2271;Gelvonėlis;DRUGELIAI;3618681535;Taip;9;0;0;9
2272;Gelvonėlis;DRUGELIAI;4027647695;Taip;7;1;0;8
2273;Gelvonėlis;DRUGELIAI;9386056584;Taip;3;4;0;7
2274;Gelvonėlis;DRUGELIAI;2114734415;Taip;4;17;0;21
2275;Gelvonėlis;DRUGELIAI;5882430535;Taip;8;0;0;8
2276;Gelvonėlis;DRUGELIAI;2645337382;Ne;20;0;0;20
2277;Gelvonėlis;DRUGELIAI;3813000890;Taip;1;8;0;9
2278;Gelvonėlis;DRUGELIAI;6662081736;Taip;13;2;0;15
2279;Gelvonėlis;DRUGELIAI;5379820728;Taip;12;0;0;12
2280;Gelvonėlis;DRUGELIAI;7938324572;Taip;10;3;0;13
2281;Gelvonėlis;DRUGELIAI;4228323474;Taip;0;2;0;2
2282;Gelvonėlis;DRUGELIAI;4162701876;Taip;0;3;0;3
2283;Gelvonėlis;DRUGELIAI;2407650243;Taip;6;1;0;7
2284;Gelvonėlis;VARPELIAI;6225854165;Taip;6;3;0;9
2285;Gelvonėlis;VARPELIAI;2791652988;Taip;10;0;1;11
2286;Gelvonėlis;VARPELIAI;2638430817;Taip;0;1;10;11
2287;Gelvonėlis;VARPELIAI;9600526942;Taip;8;3;0;11
2288;Gelvonėlis;VARPELIAI;1387948936;Taip;0;1;0;1
2289;Gelvonėlis;VARPELIAI;1462716950;Taip;0;3;0;3
2290;Gelvonėlis;VARPELIAI;6949090250;Taip;10;0;0;10
2291;Gelvonėlis;VARPELIAI;9622818893;Taip;5;0;7;12
2292;Gelvonėlis;VARPELIAI;3446593424;Taip;19;0;0;19
2293;Gelvonėlis;VARPELIAI;5207153784;Taip;20;0;0;20
2294;Gelvonėlis;VARPELIAI;9963769327;Taip;16;1;0;17
2295;Gelvonėlis;VARPELIAI;3192542909;Taip;9;0;0;9
2296;Gelvonėlis;BORUŽĖLĖS;8209225630;Taip;0;3;0;3
2297;Gelvonėlis;BORUŽĖLĖS;6554989142;Ne;3;3;0;6
2298;Gelvonėlis;BORUŽĖLĖS;2434789595;Ne;0;0;6;6
2299;Gelvonėlis;BORUŽĖLĖS;4112607183;Taip;0;4;0;4
2300;Gelvonėlis;BORUŽĖLĖS;6243360625;Taip;0;11;0;11
2301;Gelvonėlis;BORUŽĖLĖS;8515746171;Taip;0;8;0;8
2302;Gelvonėlis;BORUŽĖLĖS;1712926391;Taip;11;3;2;16
2303;Gelvonėlis;BORUŽĖLĖS;6647585785;Taip;9;0;0;9
2304;Gelvonėlis;BORUŽĖLĖS;1539850989;Taip;6;0;0;6
2305;Gelvonėlis;BORUŽĖLĖS;1107633909;Ne;0;7;0;7
2306;Gelvonėlis;BORUŽĖLĖS;8973272332;Taip;0;4;0;4
2307;Gelvonėlis;BORUŽĖLĖS;9849765037;Taip;0;3;0;3
2308;Gelvonėlis;BORUŽĖLĖS;3846916445;Taip;5;1;0;6
2309;Gelvonėlis;BORUŽĖLĖS;4749071286;Taip;0;3;0;3
2310;Gelvonėlis;BORUŽĖLĖS;8806934077;Taip;0;0;15;15
2311;Gelvonėlis;BORUŽĖLĖS;3926733474;Taip;0;1;10;11
2312;Gelvonėlis;BORUŽĖLĖS;4620517551;Taip;8;0;2;10
2313;Gelvonėlis;BORUŽĖLĖS;6598688551;Taip;8;0;0;8
2314;Gelvonėlis;NYKŠTUKAI;8987012601;Taip;23;0;0;23
2315;Gelvonėlis;NYKŠTUKAI;1112841066;Taip;5;0;0;5
2316;Gelvonėlis;NYKŠTUKAI;2553846157;Taip;0;4;0;4
2317;Gelvonėlis;NYKŠTUKAI;8003522011;Taip;0;6;0;6
2318;Gelvonėlis;NYKŠTUKAI;5713586282;Taip;3;0;0;3
2319;Gelvonėlis;NYKŠTUKAI;3217646353;Ne;5;0;0;5
2320;Gelvonėlis;NYKŠTUKAI;8560940316;Taip;3;0;1;4
2321;Gelvonėlis;NYKŠTUKAI;8540204705;Taip;5;0;1;6
2322;Gelvonėlis;NYKŠTUKAI;8124516993;Taip;5;0;7;12
2323;Gelvonėlis;NYKŠTUKAI;9751580494;Ne;0;0;1;1
2324;Gelvonėlis;NYKŠTUKAI;4156493586;Taip;0;1;0;1
2325;Gelvonėlis;NYKŠTUKAI;5874473596;Taip;6;3;0;9
2326;Gelvonėlis;BITUTĖS;6534527571;Taip;0;7;0;7
2327;Gelvonėlis;BITUTĖS;1105838340;Taip;10;0;3;13
2328;Gelvonėlis;BITUTĖS;5865866507;Taip;1;0;22;23
2329;Gelvonėlis;BITUTĖS;5444127599;Ne;6;1;0;7
2330;Gelvonėlis;BITUTĖS;1980703633;Taip;2;4;0;6
2331;Gelvonėlis;BITUTĖS;6330751030;Taip;0;0;2;2
2332;Gelvonėlis;BITUTĖS;6710189985;Taip;0;9;0;9
2333;Gelvonėlis;BITUTĖS;5281400074;Taip;18;0;0;18
2334;Gelvonėlis;BITUTĖS;3514762919;Taip;8;0;0;8
2335;Gelvonėlis;BITUTĖS;8792171281;Taip;0;0;2;2
2336;Gelvonėlis;BITUTĖS;7850553299;Taip;13;0;0;13
2337;Gelvonėlis;BITUTĖS;7725313260;Taip;10;0;3;13
2338;Gelvonėlis;BITUTĖS;5816373550;Taip;0;0;2;2
2339;Gelvonėlis;BITUTĖS;4380468764;Taip;0;0;7;7
2340;Gelvonėlis;RAMUNĖLĖS;1104204810;Taip;0;9;0;9
2341;Gelvonėlis;RAMUNĖLĖS;1355774181;Taip;6;0;0;6
2342;Gelvonėlis;RAMUNĖLĖS;2774170680;Taip;0;0;2;2
2343;Gelvonėlis;RAMUNĖLĖS;3269417874;Taip;1;0;2;3
2344;Gelvonėlis;RAMUNĖLĖS;9403505858;Ne;13;0;0;13
2345;Gelvonėlis;RAMUNĖLĖS;7686930719;Ne;4;0;0;4
2346;Gelvonėlis;RAMUNĖLĖS;4450990418;Taip;15;0;0;15
2347;Gelvonėlis;RAMUNĖLĖS;6883156109;Taip;5;3;0;8
2348;Gelvonėlis;RAMUNĖLĖS;1562829157;Taip;0;3;3;6
2349;Gelvonėlis;RAMUNĖLĖS;4211228746;Taip;1;0;0;1
2350;Gelvonėlis;RAMUNĖLĖS;6365451610;Taip;7;0;0;7
2351;Gelvonėlis;RAMUNĖLĖS;1661034338;Taip;0;3;1;4
2352;Gelvonėlis;RAMUNĖLĖS;6851036864;Taip;19;0;0;19
2353;Gelvonėlis;RIEŠUTĖLIAI;3973248307;Taip;3;2;0;5
2354;Gelvonėlis;RIEŠUTĖLIAI;5461812139;Ne;0;16;0;16
2355;Gelvonėlis;RIEŠUTĖLIAI;5986018609;Taip;0;4;4;8
2356;Gelvonėlis;RIEŠUTĖLIAI;4208103106;Taip;3;0;0;3
2357;Gelvonėlis;RIEŠUTĖLIAI;8766702456;Taip;0;3;2;5
2358;Gelvonėlis;RIEŠUTĖLIAI;6305084811;Taip;3;0;2;5
2359;Gelvonėlis;RIEŠUTĖLIAI;2005647155;Ne;0;0;1;1
2360;Gelvonėlis;RIEŠUTĖLIAI;1266479895;Taip;0;1;0;1
2361;Gelvonėlis;RIEŠUTĖLIAI;5934077931;Taip;10;7;0;17
2362;Gelvonėlis;RIEŠUTĖLIAI;3448444552;Taip;4;11;0;15
2363;Gelvonėlis;RIEŠUTĖLIAI;9301814935;Taip;0;12;0;12
2364;Gelvonėlis;RIEŠUTĖLIAI;1466616814;Taip;0;0;6;6
2365;Gelvonėlis;RIEŠUTĖLIAI;2015807805;Taip;18;0;0;18
2366;Gelvonėlis;RIEŠUTĖLIAI;2360728722;Taip;13;0;0;13
2367;Gelvonėlis;RIEŠUTĖLIAI;9132529216;Ne;18;0;0;18
2368;"Gervelė (Dzūkų g. 32)";ŽIRNIUKAI;2523056808;Ne;0;0;2;2
2369;"Gervelė (Dzūkų g. 32)";ŽIRNIUKAI;8533480337;Taip;10;5;0;15
2370;"Gervelė (Dzūkų g. 32)";ŽIRNIUKAI;6895415337;Taip;6;0;0;6
2371;"Gervelė (Dzūkų g. 32)";ŽIRNIUKAI;6227091658;Taip;5;2;0;7
2372;"Gervelė (Dzūkų g. 32)";ŽIRNIUKAI;8439479958;Taip;0;4;0;4
2373;"Gervelė (Dzūkų g. 32)";ŽIRNIUKAI;6844406500;Taip;0;4;0;4
2374;"Gervelė (Dzūkų g. 32)";ŽIRNIUKAI;2359854614;Taip;0;4;0;4
2375;"Gervelė (Dzūkų g. 32)";ŽIRNIUKAI;8811086908;Taip;0;2;0;2
2376;"Gervelė (Dzūkų g. 32)";ŽIRNIUKAI;1573560581;Taip;6;0;0;6
2377;"Gervelė (Dzūkų g. 32)";ŽIRNIUKAI;9133101055;Taip;8;0;0;8
2378;"Gervelė (Dzūkų g. 32)";ŽIRNIUKAI;7192663882;Taip;1;0;1;2
2379;"Gervelė (Dzūkų g. 32)";ŽIRNIUKAI;1783612448;Taip;0;0;4;4
2380;"Gervelė (Dzūkų g. 32)";ŽIRNIUKAI;2563081304;Taip;10;0;2;12
2381;"Gervelė (Dzūkų g. 32)";ŽIRNIUKAI;1101877666;Ne;17;0;0;17
2382;"Gervelė (Dzūkų g. 32)";ŽIRNIUKAI;3164744527;Ne;0;8;0;8
2383;"Gervelė (Dzūkų g. 32)";ŽIRNIUKAI;2046282471;Taip;18;0;0;18
2384;"Gervelė (Dzūkų g. 32)";ŽIRNIUKAI;1024397071;Ne;10;0;0;10
2385;"Gervelė (Dzūkų g. 32)";ŽIRNIUKAI;7040713170;Ne;0;0;5;5
2386;"Gervelė (Dzūkų g. 32)";LAŠIUKAI;3702908570;Taip;5;0;0;5
2387;"Gervelė (Dzūkų g. 32)";LAŠIUKAI;3647044817;Taip;10;0;0;10
2388;"Gervelė (Dzūkų g. 32)";LAŠIUKAI;6431701403;Taip;5;0;2;7
2389;"Gervelė (Dzūkų g. 32)";LAŠIUKAI;7721421570;Taip;0;3;1;4
2390;"Gervelė (Dzūkų g. 32)";LAŠIUKAI;2413995770;Taip;0;0;1;1
2391;"Gervelė (Dzūkų g. 32)";LAŠIUKAI;1637204236;Taip;8;0;0;8
2392;"Gervelė (Dzūkų g. 32)";LAŠIUKAI;8157865822;Taip;0;3;0;3
2393;"Gervelė (Dzūkų g. 32)";LAŠIUKAI;7924884022;Taip;0;16;0;16
2394;"Gervelė (Dzūkų g. 32)";LAŠIUKAI;6834663627;Taip;0;9;0;9
2395;"Gervelė (Dzūkų g. 32)";LAŠIUKAI;1323074335;Taip;10;0;0;10
2396;"Gervelė (Dzūkų g. 32)";LAŠIUKAI;6058944385;Taip;0;5;0;5
2397;"Gervelė (Dzūkų g. 32)";LAŠIUKAI;8273301992;Taip;18;0;3;21
2398;"Gervelė (Dzūkų g. 32)";LAŠIUKAI;5767158743;Taip;0;0;23;23
2399;"Gervelė (Dzūkų g. 32)";LAŠIUKAI;2446758975;Taip;0;8;0;8
2400;"Gervelė (Dzūkų g. 32)";LAŠIUKAI;1353920541;Taip;0;7;0;7
2401;"Gervelė (Dzūkų g. 32)";LAŠIUKAI;1775935853;Taip;0;0;13;13
2402;"Gervelė (Dzūkų g. 32)";LAŠIUKAI;5799823801;Ne;9;0;0;9
2403;"Gervelė (Dzūkų g. 32)";LAŠIUKAI;9313796973;Taip;10;0;13;23
2404;"Gervelė (Dzūkų g. 32)";PABIRUČIAI;7317091881;Taip;7;0;6;13
2405;"Gervelė (Dzūkų g. 32)";PABIRUČIAI;7020599764;Taip;0;3;0;3
2406;"Gervelė (Dzūkų g. 32)";PABIRUČIAI;6951455424;Taip;0;0;4;4
2407;"Gervelė (Dzūkų g. 32)";PABIRUČIAI;1112844296;Taip;0;0;2;2
2408;"Gervelė (Dzūkų g. 32)";PABIRUČIAI;6287806975;Ne;0;5;0;5
2409;"Gervelė (Dzūkų g. 32)";PABIRUČIAI;6228025635;Taip;2;0;1;3
2410;"Gervelė (Dzūkų g. 32)";PABIRUČIAI;9977349707;Taip;0;10;0;10
2411;"Gervelė (Dzūkų g. 32)";PABIRUČIAI;6155979185;Ne;4;6;0;10
2412;"Gervelė (Dzūkų g. 32)";PABIRUČIAI;3333885493;Taip;5;1;0;6
2413;"Gervelė (Dzūkų g. 32)";PABIRUČIAI;4295743997;Taip;1;1;0;2
2414;"Gervelė (Dzūkų g. 32)";PABIRUČIAI;5267617723;Taip;0;0;1;1
2415;"Gervelė (Dzūkų g. 32)";PABIRUČIAI;5953552777;Taip;0;8;0;8
2416;"Gervelė (Dzūkų g. 32)";PABIRUČIAI;4038179503;Taip;0;3;0;3
2417;"Gervelė (Dzūkų g. 32)";PABIRUČIAI;1160084928;Taip;1;0;0;1
2418;"Gervelė (Dzūkų g. 32)";PABIRUČIAI;6987657237;Taip;0;3;1;4
2419;"Gervelė (Dzūkų g. 32)";PABIRUČIAI;8016341646;Ne;5;0;1;6
2420;"Gervelė (Dzūkų g. 32)";PABIRUČIAI;5685222621;Taip;0;0;1;1
2421;"Gervelė (Dzūkų g. 32)";PABIRUČIAI;4294916559;Taip;2;1;0;3
2422;"Gervelė (Dzūkų g. 32)";PABIRUČIAI;3449674095;Ne;3;6;0;9
2423;"Gervelė (Dzūkų g. 32)";BITUTĖS;6090290046;Taip;4;0;1;5
2424;"Gervelė (Dzūkų g. 32)";BITUTĖS;75080308291;Taip;0;3;3;6
2425;"Gervelė (Dzūkų g. 32)";BITUTĖS;6737174004;Taip;0;5;0;5
2426;"Gervelė (Dzūkų g. 32)";BITUTĖS;1616949023;Taip;0;6;0;6
2427;"Gervelė (Dzūkų g. 32)";BITUTĖS;3427400844;Taip;0;9;0;9
2428;"Gervelė (Dzūkų g. 32)";BITUTĖS;8152446576;Taip;2;3;0;5
2429;"Gervelė (Dzūkų g. 32)";BITUTĖS;7302238728;Taip;0;2;0;2
2430;"Gervelė (Dzūkų g. 32)";BITUTĖS;1400044294;Taip;0;2;6;8
2431;"Gervelė (Dzūkų g. 32)";BITUTĖS;8062089041;Taip;2;9;0;11
2432;"Gervelė (Dzūkų g. 32)";BITUTĖS;7697761552;Taip;0;3;1;4
2433;"Gervelė (Dzūkų g. 32)";BITUTĖS;5989713844;Taip;3;1;0;4
2434;"Gervelė (Dzūkų g. 32)";BITUTĖS;4560752068;Taip;0;2;6;8
2435;"Gervelė (Dzūkų g. 32)";BITUTĖS;87619285504;Taip;0;1;6;7
2436;"Gervelė (Dzūkų g. 32)";BITUTĖS;1991238577;Taip;0;7;0;7
2437;"Gervelė (Dzūkų g. 32)";BITUTĖS;2167744244;Taip;0;6;0;6
2438;"Gervelė (Dzūkų g. 32)";BITUTĖS;3525060645;Taip;0;3;0;3
2439;"Gervelė (Dzūkų g. 32)";BITUTĖS;7162551366;Taip;0;23;0;23
2440;"Gervelė (Dzūkų g. 32)";BITUTĖS;9970293084;Taip;0;2;0;2
2441;"Gervelė (Dzūkų g. 32)";BURATINO;3946391650;Taip;0;8;0;8
2442;"Gervelė (Dzūkų g. 32)";BURATINO;7620764911;Taip;4;8;0;12
2443;"Gervelė (Dzūkų g. 32)";BURATINO;9239897472;Taip;0;10;0;10
2444;"Gervelė (Dzūkų g. 32)";BURATINO;8997525194;Taip;0;5;0;5
2445;"Gervelė (Dzūkų g. 32)";BURATINO;3359793310;Taip;0;3;3;6
2446;"Gervelė (Dzūkų g. 32)";BURATINO;9982951468;Taip;0;4;0;4
2447;"Gervelė (Dzūkų g. 32)";BURATINO;5900623823;Ne;0;10;0;10
2448;"Gervelė (Dzūkų g. 32)";BURATINO;4775822341;Taip;0;6;0;6
2449;"Gervelė (Dzūkų g. 32)";BURATINO;8012122042;Taip;0;6;0;6
2450;"Gervelė (Dzūkų g. 32)";BURATINO;2541771432;Ne;5;9;0;14
2451;"Gervelė (Dzūkų g. 32)";BURATINO;2913622440;Taip;23;0;0;23
2452;"Gervelė (Dzūkų g. 32)";BURATINO;7300458249;Taip;13;0;0;13
2453;"Gervelė (Dzūkų g. 32)";BURATINO;3912789554;Ne;0;9;0;9
2454;"Gervelė (Dzūkų g. 32)";BURATINO;1108744283;Taip;0;3;0;3
2455;"Gervelė (Dzūkų g. 32)";BURATINO;6166476760;Ne;0;1;0;1
2456;"Gervelė (Dzūkų g. 32)";BURATINO;4516538272;Taip;5;2;2;9
2457;"Gervelė (Dzūkų g. 32)";BURATINO;9256422807;Taip;13;0;0;13
2458;"Gervelė (Dzūkų g. 32)";BURATINO;3723783633;Taip;0;3;0;3
2459;"Gervelė (Dzūkų g. 32)";VIŠČIUKŲ;9532470407;Taip;8;0;0;8
2460;"Gervelė (Dzūkų g. 32)";VIŠČIUKŲ;8792240321;Taip;15;0;0;15
2461;"Gervelė (Dzūkų g. 32)";VIŠČIUKŲ;7205673717;Taip;0;3;3;6
2462;"Gervelė (Dzūkų g. 32)";VIŠČIUKŲ;7140356352;Taip;15;0;0;15
2463;"Gervelė (Dzūkų g. 32)";VIŠČIUKŲ;8598429197;Taip;18;0;0;18
2464;"Gervelė (Dzūkų g. 32)";VIŠČIUKŲ;9294388176;Taip;11;0;3;14
2465;"Gervelė (Dzūkų g. 32)";VIŠČIUKŲ;3230279203;Taip;15;0;0;15
2466;"Gervelė (Dzūkų g. 32)";VIŠČIUKŲ;8392147716;Taip;10;0;6;16
2467;"Gervelė (Dzūkų g. 32)";VIŠČIUKŲ;5608916470;Taip;5;3;0;8
2468;"Gervelė (Dzūkų g. 32)";VIŠČIUKŲ;8098158634;Taip;2;4;1;7
2469;"Gervelė (Dzūkų g. 32)";VIŠČIUKŲ;3554640994;Taip;3;0;0;3
2470;"Gervelė (Dzūkų g. 32)";VIŠČIUKŲ;9478720027;Taip;16;0;0;16
2471;"Gervelė (Dzūkų g. 32)";VIŠČIUKŲ;2433507386;Ne;13;0;0;13
2472;"Gervelė (Dzūkų g. 32)";VIŠČIUKŲ;4552290778;Ne;7;0;0;7
2473;"Gervelė (Dzūkų g. 32)";VIŠČIUKŲ;3170062234;Ne;8;0;2;10
2474;"Gervelė (Dzūkų g. 32)";VIŠČIUKŲ;4094173207;Taip;0;0;4;4
2475;Gilužis;Skruzdėliukų;35511006307;Taip;0;2;0;2
2476;Gilužis;Skruzdėliukų;1671692484;Ne;5;3;0;8
2477;Gilužis;Skruzdėliukų;1615293331;Taip;0;3;0;3
2478;Gilužis;Skruzdėliukų;9474400084;Taip;0;2;0;2
2479;Gilužis;Skruzdėliukų;5161095299;Ne;0;3;0;3
2480;Gilužis;Skruzdėliukų;70959404439;Taip;0;4;0;4
2481;Gilužis;Skruzdėliukų;8120898865;Taip;0;1;0;1
2482;Gilužis;Skruzdėliukų;8840822243;Taip;7;4;0;11
2483;Gilužis;Skruzdėliukų;4611735601;Taip;0;7;0;7
2484;Gilužis;Skruzdėliukų;4747769984;Taip;0;3;0;3
2485;Gilužis;Skruzdėliukų;5920357223;Taip;0;3;0;3
2486;Gilužis;Skruzdėliukų;8595541498;Taip;0;8;0;8
2487;Gilužis;Skruzdėliukų;5365582271;Taip;0;5;1;6
2488;Gilužis;Skruzdėliukų;7364297673;Taip;3;0;0;3
2489;Gilužis;Skruzdėliukų;2042514241;Taip;0;0;1;1
2490;Gilužis;Skruzdėliukų;3216004438;Taip;0;7;0;7
2491;Gilužis;Skruzdėliukų;48365991937;Taip;1;1;0;2
2492;Gilužis;Skruzdėliukų;1452016675;Taip;0;4;0;4
2493;Gilužis;Skruzdėliukų;29586826889;Taip;5;3;0;8
2494;Gilužis;Skruzdėliukų;3071312399;Taip;5;5;0;10
2495;Gilužis;Skruzdėliukų;6233020671;Taip;2;5;0;7
2496;Gilužis;Nykštukų;4147821853;Taip;6;0;0;6
2497;Gilužis;Nykštukų;7937643339;Taip;0;2;0;2
2498;Gilužis;Nykštukų;3473889426;Taip;13;0;0;13
2499;Gilužis;Nykštukų;9362581908;Taip;13;0;0;13
2500;Gilužis;Nykštukų;8899557365;Taip;0;1;0;1
2501;Gilužis;Nykštukų;7228498662;Taip;0;1;0;1
2502;Gilužis;Nykštukų;1459273692;Taip;6;0;0;6
2503;Gilužis;Nykštukų;4156613717;Taip;0;2;0;2
2504;Gilužis;Nykštukų;5713786735;Taip;0;2;0;2
2505;Gilužis;Nykštukų;4956685016;Taip;0;4;0;4
2506;Gilužis;Nykštukų;6315155554;Ne;0;2;0;2
2507;Gilužis;Nykštukų;9332056404;Taip;5;0;3;8
2508;Gilužis;Nykštukų;8522552650;Taip;6;4;0;10
2509;Gilužis;Nykštukų;3176305306;Taip;5;4;0;9
2510;Gilužis;Nykštukų;4094486541;Taip;0;7;0;7
2511;Gilužis;Nykštukų;6493142538;Taip;7;0;0;7
2512;Gilužis;Nykštukų;5088561405;Taip;0;5;0;5
2513;Gilužis;Bitučių;4841014668;Ne;15;0;0;15
2514;Gilužis;Bitučių;1634295583;Ne;0;1;2;3
2515;Gilužis;Bitučių;4360261750;Ne;0;1;1;2
2516;Gilužis;Bitučių;5728341732;Taip;4;0;0;4
2517;Gilužis;Bitučių;2780710383;Taip;6;0;0;6
2518;Gilužis;Bitučių;6931726275;Taip;5;2;0;7
2519;Gilužis;Bitučių;1867185320;Taip;0;1;0;1
2520;Gilužis;Bitučių;3429435736;Ne;0;0;1;1
2521;Gilužis;Bitučių;8539946703;Taip;0;23;0;23
2522;Gilužis;Bitučių;9000351000;Taip;15;2;0;17
2523;Gilužis;Bitučių;5366174839;Taip;0;1;1;2
2524;Gilužis;Bitučių;5162397237;Taip;0;9;5;14
2525;Gilužis;Bitučių;7250617867;Taip;0;2;0;2
2526;Gilužis;Bitučių;9053608903;Taip;5;8;0;13
2527;Gilužis;Bitučių;6115776872;Taip;0;0;5;5
2528;Gilužis;Bitučių;5651799121;Taip;10;0;2;12
2529;Gilužis;Bitučių;2950813185;Taip;0;5;0;5
2530;Gilužis;Bitučių;6515525848;Taip;0;2;0;2
2531;Gilužis;Kačiukų;4978922821;Taip;0;4;0;4
2532;Gilužis;Kačiukų;2945406185;Taip;0;4;0;4
2533;Gilužis;Kačiukų;1582241363;Ne;3;0;1;4
2534;Gilužis;Kačiukų;7330938312;Taip;3;0;5;8
2535;Gilužis;Kačiukų;6571132974;Taip;0;23;0;23
2536;Gilužis;Kačiukų;7001112696;Taip;0;0;7;7
2537;Gilužis;Kačiukų;6966795180;Taip;11;8;0;19
2538;Gilužis;Kačiukų;5128383851;Taip;5;2;3;10
2539;Gilužis;Kačiukų;8318405114;Taip;5;3;0;8
2540;Gilužis;Kačiukų;7826015897;Taip;0;2;0;2
2541;Gilužis;Kačiukų;4403218878;Taip;0;1;0;1
2542;Gilužis;Kačiukų;9186274541;Taip;5;1;0;6
2543;Gilužis;Kačiukų;3419281756;Taip;0;4;0;4
2544;Gilužis;Kačiukų;9421351780;Taip;3;8;0;11
2545;Gilužis;Kačiukų;6404411477;Taip;0;5;0;5
2546;Gilužis;Kačiukų;4128387076;Taip;0;2;0;2
2547;Gilužis;Kačiukų;7042664923;Taip;5;3;0;8
2548;Gilužis;Kačiukų;9097165155;Ne;16;0;0;16
2549;Gilužis;Kačiukų;8762534617;Taip;0;8;0;8
2550;Gilužis;Pelėdžiukų;5217748032;Taip;6;5;0;11
2551;Gilužis;Pelėdžiukų;5989314494;Taip;0;3;0;3
2552;Gilužis;Pelėdžiukų;7998695149;Taip;6;0;0;6
2553;Gilužis;Pelėdžiukų;7742783427;Taip;6;0;0;6
2554;Gilužis;Pelėdžiukų;7358572344;Taip;3;10;0;13
2555;Gilužis;Pelėdžiukų;4617259961;Taip;8;3;0;11
2556;Gilužis;Pelėdžiukų;1222370750;Taip;0;5;0;5
2557;Gilužis;Pelėdžiukų;9503516686;Taip;0;2;0;2
2558;Gilužis;Pelėdžiukų;9833451628;Taip;0;1;0;1
2559;Gilužis;Pelėdžiukų;6270071724;Taip;0;2;0;2
2560;Gilužis;Pelėdžiukų;7505729606;Ne;0;7;0;7
2561;Gilužis;Pelėdžiukų;4051726208;Taip;6;4;0;10
2562;Gilužis;Pelėdžiukų;7092060789;Taip;0;4;2;6
2563;Gilužis;Pelėdžiukų;1804218972;Taip;0;3;5;8
2564;Gilužis;Pelėdžiukų;1832039250;Taip;7;3;0;10
2565;Gilužis;Pelėdžiukų;3166161973;Taip;14;1;0;15
2566;Gilužis;Pelėdžiukų;5070988982;Taip;0;2;0;2
2567;Gilužis;Pelėdžiukų;7899274495;Taip;5;0;6;11
2568;Gilužis;Pelėdžiukų;6093514885;Taip;5;1;0;6
2569;Gilužis;Pelėdžiukų;2869506388;Taip;11;1;0;12
2570;Gilužis;Drugelių;6121625070;Taip;5;4;1;10
2571;Gilužis;Drugelių;1770064694;Taip;0;3;0;3
2572;Gilužis;Drugelių;9092013248;Taip;8;2;0;10
2573;Gilužis;Drugelių;9109883577;Ne;0;0;4;4
2574;Gilužis;Drugelių;8006465211;Taip;0;0;5;5
2575;Gilužis;Drugelių;5118401707;Taip;3;0;0;3
2576;Gilužis;Drugelių;3190597262;Ne;3;0;1;4
2577;Gilužis;Drugelių;2988856911;Taip;12;0;0;12
2578;Gilužis;Drugelių;3532863024;Taip;11;12;0;23
2579;Gilužis;Drugelių;1376645277;Taip;0;3;0;3
2580;Gilužis;Drugelių;1410870589;Taip;0;10;0;10
2581;Gilužis;Drugelių;6786334223;Taip;6;0;0;6
2582;Gilužis;Drugelių;9112993465;Taip;2;0;7;9
2583;Gilužis;Drugelių;4909329417;Taip;0;3;1;4
2584;Gilužis;Drugelių;8244385001;Taip;0;3;1;4
2585;Gilužis;Drugelių;6429142049;Ne;0;3;0;3
2586;Gilužis;Drugelių;7731169885;Ne;0;1;0;1
2587;Gilužis;Drugelių;1093643746;Taip;0;6;0;6
2588;Gilužis;Drugelių;3902713866;Taip;3;0;0;3
2589;Gilužis;Drugelių;6950139609;Taip;10;0;0;10
2590;Gilužis;Drugelių;2397231165;Ne;11;0;0;11
2591;Gilužis;Saulučių;17896774143;Taip;3;1;3;7
2592;Gilužis;Saulučių;9918995545;Taip;0;1;0;1
2593;Gilužis;Saulučių;4209000927;Taip;0;0;1;1
2594;Gilužis;Saulučių;8595551150;Taip;0;1;0;1
2595;Gilužis;Saulučių;4575619425;Taip;0;4;0;4
2596;Gilužis;Saulučių;4473810097;Taip;4;5;0;9
2597;Gilužis;Saulučių;1649256496;Taip;0;3;0;3
2598;Gilužis;Saulučių;96550272401;Taip;4;3;0;7
2599;Gilužis;Saulučių;2391630554;Taip;0;1;0;1
2600;Gilužis;Saulučių;18997894859;Taip;0;3;0;3
2601;Gilužis;Saulučių;7744997250;Taip;1;2;3;6
2602;Gilužis;Saulučių;32730847948;Taip;3;0;1;4
2603;Gilužis;Saulučių;3181765606;Taip;0;2;0;2
2604;Gilužis;Saulučių;5905237803;Taip;0;3;0;3
2605;Gilužis;Saulučių;2872439079;Taip;0;1;1;2
2606;Gilužis;Saulučių;87425898496;Taip;0;2;0;2
2607;Gilužis;Saulučių;35650138667;Taip;0;1;0;1
2608;Gilužis;Saulučių;9367673896;Taip;0;3;0;3
2609;Gilužis;Saulučių;1453976300;Taip;0;2;0;2
2610;Gilužis;Saulučių;1211233315;Taip;0;3;0;3
2611;Gilužis;Saulučių;5621912516;Taip;0;8;0;8
2612;Gilužis;Paukštelių;1877467761;Ne;0;4;0;4
2613;Gilužis;Paukštelių;1146713023;Taip;0;5;0;5
2614;Gilužis;Paukštelių;1980250599;Taip;0;3;0;3
2615;Gilužis;Paukštelių;1962914764;Taip;14;0;1;15
2616;Gilužis;Paukštelių;7636249706;Ne;0;1;0;1
2617;Gilužis;Paukštelių;2508958685;Ne;0;2;6;8
2618;Gilužis;Paukštelių;8875479631;Taip;3;7;0;10
2619;Gilužis;Paukštelių;5759145600;Taip;0;23;0;23
2620;Gilužis;Paukštelių;8662424856;Taip;0;3;0;3
2621;Gilužis;Paukštelių;2436416327;Taip;2;0;0;2
2622;Gilužis;Paukštelių;6218943275;Taip;0;1;0;1
2623;Gilužis;Paukštelių;2754594238;Taip;0;2;1;3
2624;Gilužis;Paukštelių;8110869130;Taip;2;3;0;5
2625;Gilužis;Paukštelių;1344240019;Taip;0;1;1;2
2626;Gilužis;Paukštelių;4297300799;Taip;4;4;3;11
2627;Gilužis;Paukštelių;8531121002;Taip;6;2;0;8
2628;Gilužis;Paukštelių;9314893329;Taip;0;1;1;2
2629;Gilužis;Paukštelių;46276990963;Taip;0;7;4;11
2630;Gilužis;Paukštelių;5303511810;Taip;16;3;0;19
2631;Gilužis;Obuoliukų;8201769917;Taip;0;7;0;7
2632;Gilužis;Obuoliukų;9892608223;Taip;5;4;0;9
2633;Gilužis;Obuoliukų;4058698645;Taip;0;2;0;2
2634;Gilužis;Obuoliukų;1540018160;Taip;9;3;0;12
2635;Gilužis;Obuoliukų;7716908903;Taip;7;0;0;7
2636;Gilužis;Obuoliukų;3131597174;Taip;0;3;0;3
2637;Gilužis;Obuoliukų;6239369861;Taip;13;0;0;13
2638;Gilužis;Obuoliukų;6172360933;Taip;5;1;0;6
2639;Gilužis;Obuoliukų;7398446674;Taip;3;4;0;7
2640;Gilužis;Obuoliukų;4592380105;Taip;10;6;0;16
2641;Gilužis;Obuoliukų;4242362889;Taip;9;2;0;11
2642;Gilužis;Obuoliukų;7560732216;Taip;9;2;0;11
2643;Gilužis;Obuoliukų;5476140202;Taip;0;3;0;3
2644;Gilužis;Obuoliukų;7606394325;Taip;1;2;0;3
2645;Gilužis;Obuoliukų;6737884137;Taip;0;10;0;10
2646;Gilužis;Obuoliukų;3458957423;Taip;18;0;0;18
2647;Gilužis;Obuoliukų;8900414658;Taip;5;4;0;9
2648;Gilužis;Obuoliukų;3219101391;Ne;5;2;1;8
2649;Gilužis;Obuoliukų;4528131001;Taip;3;3;0;6
2650;Gilužis;Obuoliukų;5895659747;Taip;5;9;0;14
2651;Gilužis;KIŠKUČIŲ;5744027226;Taip;4;1;0;5
2652;Gilužis;KIŠKUČIŲ;8639633038;Taip;12;0;2;14
2653;Gilužis;KIŠKUČIŲ;5721924532;Taip;16;0;0;16
2654;Gilužis;KIŠKUČIŲ;2680643896;Taip;0;5;0;5
2655;Gilužis;KIŠKUČIŲ;5685074731;Taip;5;1;0;6
2656;Gilužis;KIŠKUČIŲ;3649616461;Taip;4;0;2;6
2657;Gilužis;KIŠKUČIŲ;7632771776;Taip;10;0;2;12
2658;Gilužis;KIŠKUČIŲ;7477282548;Taip;9;0;0;9
2659;Gilužis;KIŠKUČIŲ;9061835019;Taip;13;0;0;13
2660;Gilužis;KIŠKUČIŲ;7560574633;Ne;15;0;0;15
2661;Gilužis;KIŠKUČIŲ;4199633620;Ne;12;3;5;20
2662;Gilužis;KIŠKUČIŲ;9851612698;Ne;0;5;0;5
2663;Gilužis;KIŠKUČIŲ;1391410955;Taip;12;6;1;19
2664;Gilužis;KIŠKUČIŲ;6383469680;Taip;14;0;1;15
2665;Gilužis;KIŠKUČIŲ;8341597766;Taip;3;0;3;6
2666;Gilužis;KIŠKUČIŲ;4347319425;Taip;5;0;0;5
2667;Gilužis;KIŠKUČIŲ;8877445672;Taip;18;0;0;18
2668;Gilužis;KIŠKUČIŲ;9489594782;Taip;10;3;0;13
2669;Gilužis;KIŠKUČIŲ;6185954940;Taip;5;0;1;6
2670;Gilužis;Meškučių;7263432152;Ne;0;3;0;3
2671;Gilužis;Meškučių;4655266106;Taip;4;0;0;4
2672;Gilužis;Meškučių;3800593189;Taip;9;5;0;14
2673;Gilužis;Meškučių;4174307847;Taip;8;0;0;8
2674;Gilužis;Meškučių;8393554697;Ne;5;9;0;14
2675;Gilužis;Meškučių;8301535013;Taip;18;0;0;18
2676;Gilužis;Meškučių;2939982311;Taip;7;0;0;7
2677;Gilužis;Meškučių;3365778697;Taip;7;9;0;16
2678;Gilužis;Meškučių;7912093880;Taip;18;0;0;18
2679;Gilužis;Meškučių;2389277783;Taip;0;3;0;3
2680;Gilužis;Meškučių;2500949029;Taip;6;6;0;12
2681;Gilužis;Meškučių;4741129495;Taip;15;2;0;17
2682;Gilužis;Meškučių;7992750316;Taip;5;1;0;6
2683;Gilužis;Meškučių;5505153657;Taip;0;0;1;1
2684;Gilužis;Meškučių;2577554894;Taip;1;0;0;1
2685;Gilužis;Meškučių;6303770262;Ne;19;4;0;23
2686;Gilužis;Meškučių;3148477315;Taip;9;3;0;12
2687;Gilužis;Meškučių;1068375927;Taip;11;0;0;11
2688;Gilužis;Meškučių;8476240141;Taip;0;0;1;1
2689;Gilužis;Meškučių;8780573054;Taip;9;0;1;10
2690;Gilužis;Meškučių;6185280967;Ne;8;1;0;9
2691;Gilužis;Meškučių;5177805719;Taip;11;3;0;14
2692;Gilužis;Meškučių;7045940267;Taip;0;3;0;3
2693;Gilužis;Pagrandukai;6884146146;Taip;0;23;0;23
2694;Gilužis;Pagrandukai;6920910054;Taip;20;0;0;20
2695;Gilužis;Pagrandukai;5705945483;Taip;0;7;0;7
2696;Gilužis;Pagrandukai;6501973647;Taip;13;1;0;14
2697;Gilužis;Pagrandukai;5397975739;Taip;13;0;0;13
2698;Gilužis;Pagrandukai;6109205159;Taip;9;0;0;9
2699;Gilužis;Pagrandukai;2328338059;Taip;9;0;0;9
2700;Gilužis;Pagrandukai;5376639182;Taip;0;8;0;8
2701;Gilužis;Pagrandukai;5378701300;Taip;3;2;0;5
2702;Gilužis;Pagrandukai;3366788027;Taip;3;2;0;5
2703;Gilužis;Pagrandukai;9676661005;Ne;17;0;0;17
2704;Gilužis;Pagrandukai;1306757860;Ne;17;0;0;17
2705;Gilužis;Pagrandukai;2706629834;Taip;8;8;0;16
2706;Gilužis;Pagrandukai;1604096952;Taip;5;8;0;13
2707;Gilužis;Pagrandukai;5184511012;Taip;16;0;0;16
2708;Gilužis;Pagrandukai;9587502317;Taip;16;0;0;16
2709;Gilužis;Pagrandukai;4266998302;Taip;17;1;0;18
2710;Gilužis;Pagrandukai;5334441484;Taip;1;8;0;9
2711;Gilužis;Pagrandukai;6831107153;Taip;16;0;0;16
2712;Gilužis;Pagrandukai;8852862161;Taip;16;0;0;16
2713;Gilužis;Pagrandukai;2955779117;Taip;16;0;0;16
2714;Gilužis;Boružėlių;5497242500;Taip;5;1;0;6
2715;Gilužis;Boružėlių;2516315604;Taip;11;6;1;18
2716;Gilužis;Boružėlių;9783700319;Taip;7;2;1;10
2717;Gilužis;Boružėlių;5394693502;Taip;6;3;0;9
2718;Gilužis;Boružėlių;4455977087;Taip;5;1;0;6
2719;Gilužis;Boružėlių;4876074981;Taip;4;0;0;4
2720;Gilužis;Boružėlių;2633680406;Taip;11;8;0;19
2721;Gilužis;Boružėlių;2221786284;Taip;0;1;0;1
2722;Gilužis;Boružėlių;3002266577;Taip;20;0;0;20
2723;Gilužis;Boružėlių;5190752112;Ne;13;0;0;13
2724;Gilužis;Boružėlių;2440762487;Ne;13;0;0;13
2725;Gilužis;Boružėlių;4509741536;Ne;0;4;0;4
2726;Gilužis;Boružėlių;9707968228;Taip;8;0;0;8
2727;Gilužis;Boružėlių;8628253655;Taip;7;2;0;9
2728;Gilužis;Boružėlių;9104005195;Taip;13;0;0;13
2729;Gilužis;Boružėlių;5581417252;Taip;0;23;0;23
2730;Gilužis;Boružėlių;4106792355;Taip;0;1;0;1
2731;Gilužis;Boružėlių;4475698906;Taip;12;0;0;12
2732;Gilužis;Boružėlių;1085130813;Taip;0;3;0;3
2733;Gilužis;Boružėlių;2615087717;Taip;3;4;3;10
2734;Gilužis;"MEDYNĖLIO 1 GR. (Įsruties g.)";8237963602;Taip;3;1;2;6
2735;Gilužis;"MEDYNĖLIO 1 GR. (Įsruties g.)";9753512366;Taip;5;0;0;5
2736;Gilužis;"MEDYNĖLIO 1 GR. (Įsruties g.)";6914566889;Taip;13;0;0;13
2737;Gilužis;"MEDYNĖLIO 1 GR. (Įsruties g.)";1541283216;Taip;4;0;0;4
2738;Gilužis;"MEDYNĖLIO 1 GR. (Įsruties g.)";5306278297;Taip;17;0;0;17
2739;Gilužis;"MEDYNĖLIO 1 GR. (Įsruties g.)";1054809163;Taip;10;0;1;11
2740;Gilužis;"MEDYNĖLIO 1 GR. (Įsruties g.)";7887970476;Taip;4;0;0;4
2741;Gilužis;"MEDYNĖLIO 1 GR. (Įsruties g.)";4652281185;Taip;0;0;2;2
2742;Gilužis;"MEDYNĖLIO 1 GR. (Įsruties g.)";4122073923;Taip;9;0;0;9
2743;Gilužis;"MEDYNĖLIO 1 GR. (Įsruties g.)";7068801003;Taip;1;0;0;1
2744;Gilužis;"MEDYNĖLIO 2 GR. (Įsruties g.)";3379889899;Taip;8;0;1;9
2745;Gilužis;"MEDYNĖLIO 2 GR. (Įsruties g.)";2915024298;Taip;6;0;0;6
2746;Gilužis;"MEDYNĖLIO 2 GR. (Įsruties g.)";5769955074;Taip;3;0;0;3
2747;Gilužis;"MEDYNĖLIO 2 GR. (Įsruties g.)";7487731015;Taip;8;0;1;9
2748;Gilužis;"MEDYNĖLIO 2 GR. (Įsruties g.)";5490128851;Taip;0;0;1;1
2749;Gilužis;"MEDYNĖLIO 2 GR. (Įsruties g.)";5784201106;Taip;15;0;0;15
2750;Gilužis;"MEDYNĖLIO 2 GR. (Įsruties g.)";8904873416;Taip;4;0;0;4
2751;Gilužis;"MEDYNĖLIO 2 GR. (Įsruties g.)";2851682356;Taip;9;0;0;9
2752;Gilužis;"MEDYNĖLIO 2 GR. (Įsruties g.)";7247606321;Taip;0;23;0;23
2753;Gilužis;"MEDYNĖLIO 2 GR. (Įsruties g.)";5664892047;Taip;0;23;0;23
2754;Gilužis;"STRAZDELIO GR. (Įsruties g.)";6766559505;Taip;3;0;0;3
2755;Gilužis;"STRAZDELIO GR. (Įsruties g.)";3194397689;Taip;4;4;1;9
2756;Gilužis;"STRAZDELIO GR. (Įsruties g.)";5737505086;Taip;0;3;1;4
2757;Gilužis;"STRAZDELIO GR. (Įsruties g.)";3414489196;Taip;0;23;0;23
2758;Gilužis;"STRAZDELIO GR. (Įsruties g.)";6586605929;Taip;0;3;0;3
2759;Gilužis;"STRAZDELIO GR. (Įsruties g.)";3729538163;Taip;0;0;2;2
2760;Gilužis;"STRAZDELIO GR. (Įsruties g.)";6207304860;Taip;9;0;1;10
2761;Gilužis;"STRAZDELIO GR. (Įsruties g.)";7053810996;Taip;1;0;1;2
2762;Gilužis;"STRAZDELIO GR. (Įsruties g.)";2398220397;Taip;12;0;0;12
2763;Gilužis;"STRAZDELIO GR. (Įsruties g.)";1826248450;Taip;5;0;0;5
2764;Gilužis;"STRAZDELIO GR. (Įsruties g.)";9325927745;Taip;0;3;10;13
2765;"Gintarėlis (Didlaukio g. 35)";PAPŪGĖLĖS;8498936096;Taip;0;2;0;2
2766;"Gintarėlis (Didlaukio g. 35)";PAPŪGĖLĖS;8913652291;Taip;5;0;3;8
2767;"Gintarėlis (Didlaukio g. 35)";PAPŪGĖLĖS;2485750596;Taip;0;3;3;6
2768;"Gintarėlis (Didlaukio g. 35)";PAPŪGĖLĖS;1033624080;Taip;0;2;0;2
2769;"Gintarėlis (Didlaukio g. 35)";PAPŪGĖLĖS;2919700367;Ne;8;1;0;9
2770;"Gintarėlis (Didlaukio g. 35)";PAPŪGĖLĖS;1768789948;Taip;2;0;2;4
2771;"Gintarėlis (Didlaukio g. 35)";PAPŪGĖLĖS;2235045173;Taip;0;0;1;1
2772;"Gintarėlis (Didlaukio g. 35)";PAPŪGĖLĖS;9494521554;Taip;0;12;0;12
2773;"Gintarėlis (Didlaukio g. 35)";PAPŪGĖLĖS;7147842224;Taip;0;4;1;5
2774;"Gintarėlis (Didlaukio g. 35)";PAPŪGĖLĖS;5783939567;Taip;0;5;0;5
2775;"Gintarėlis (Didlaukio g. 35)";PAPŪGĖLĖS;7674351459;Taip;0;8;0;8
2776;"Gintarėlis (Didlaukio g. 35)";PAPŪGĖLĖS;6292664833;Taip;8;0;0;8
2777;"Gintarėlis (Didlaukio g. 35)";PAPŪGĖLĖS;8610886062;Taip;5;5;0;10
2778;"Gintarėlis (Didlaukio g. 35)";PAPŪGĖLĖS;5811396263;Taip;0;2;0;2
2779;"Gintarėlis (Didlaukio g. 35)";PAPŪGĖLĖS;1648843117;Taip;13;2;0;15
2780;"Gintarėlis (Didlaukio g. 35)";PAPŪGĖLĖS;1861324153;Taip;0;6;0;6
2781;"Gintarėlis (Didlaukio g. 35)";PAPŪGĖLĖS;3457974670;Taip;7;4;1;12
2782;"Gintarėlis (Didlaukio g. 35)";PAPŪGĖLĖS;1511718436;Ne;3;2;3;8
2783;"Gintarėlis (Didlaukio g. 35)";PAPŪGĖLĖS;4484711857;Taip;0;3;6;9
2784;"Gintarėlis (Didlaukio g. 35)";PAPŪGĖLĖS;6080108998;Taip;7;2;1;10
2785;"Gintarėlis (Didlaukio g. 35)";PAPŪGĖLĖS;6655645997;Taip;6;2;1;9
2786;"Gintarėlis (Didlaukio g. 35)";SPINDULIUKAI;9303448709;Taip;5;0;0;5
2787;"Gintarėlis (Didlaukio g. 35)";SPINDULIUKAI;3600181974;Taip;0;2;0;2
2788;"Gintarėlis (Didlaukio g. 35)";SPINDULIUKAI;6091264509;Taip;17;3;0;20
2789;"Gintarėlis (Didlaukio g. 35)";SPINDULIUKAI;56124970238;Taip;0;4;0;4
2790;"Gintarėlis (Didlaukio g. 35)";SPINDULIUKAI;4902086873;Taip;0;8;1;9
2791;"Gintarėlis (Didlaukio g. 35)";SPINDULIUKAI;34606130829;Taip;0;12;0;12
2792;"Gintarėlis (Didlaukio g. 35)";SPINDULIUKAI;21658913551;Taip;0;1;0;1
2793;"Gintarėlis (Didlaukio g. 35)";SPINDULIUKAI;8405210216;Ne;5;0;0;5
2794;"Gintarėlis (Didlaukio g. 35)";SPINDULIUKAI;18715625324;Taip;5;1;0;6
2795;"Gintarėlis (Didlaukio g. 35)";SPINDULIUKAI;2721386855;Taip;0;2;0;2
2796;"Gintarėlis (Didlaukio g. 35)";SPINDULIUKAI;2914156353;Taip;10;0;4;14
2797;"Gintarėlis (Didlaukio g. 35)";SPINDULIUKAI;5916948150;Taip;0;1;0;1
2798;"Gintarėlis (Didlaukio g. 35)";SPINDULIUKAI;45480802894;Ne;0;4;4;8
2799;"Gintarėlis (Didlaukio g. 35)";SPINDULIUKAI;3978892232;Taip;0;5;0;5
2800;"Gintarėlis (Didlaukio g. 35)";SPINDULIUKAI;1770479969;Taip;0;2;0;2
2801;"Gintarėlis (Didlaukio g. 35)";SPINDULIUKAI;1441282039;Taip;0;3;0;3
2802;"Gintarėlis (Didlaukio g. 35)";SPINDULIUKAI;9539570835;Taip;0;10;0;10
2803;"Gintarėlis (Didlaukio g. 35)";SPINDULIUKAI;7878911379;Taip;0;6;0;6
2804;"Gintarėlis (Didlaukio g. 35)";LAŠIUKAI;6142819210;Taip;5;3;0;8
2805;"Gintarėlis (Didlaukio g. 35)";LAŠIUKAI;7971810025;Taip;0;7;0;7
2806;"Gintarėlis (Didlaukio g. 35)";LAŠIUKAI;28704617970;Ne;0;3;0;3
2807;"Gintarėlis (Didlaukio g. 35)";LAŠIUKAI;5577759167;Taip;5;3;0;8
2808;"Gintarėlis (Didlaukio g. 35)";LAŠIUKAI;8247701603;Taip;0;5;0;5
2809;"Gintarėlis (Didlaukio g. 35)";LAŠIUKAI;4498326942;Taip;0;5;2;7
2810;"Gintarėlis (Didlaukio g. 35)";LAŠIUKAI;4641943773;Taip;0;8;0;8
2811;"Gintarėlis (Didlaukio g. 35)";LAŠIUKAI;1655837441;Ne;0;5;3;8
2812;"Gintarėlis (Didlaukio g. 35)";LAŠIUKAI;1690400583;Taip;0;5;4;9
2813;"Gintarėlis (Didlaukio g. 35)";LAŠIUKAI;1826743229;Taip;0;2;0;2
2814;"Gintarėlis (Didlaukio g. 35)";LAŠIUKAI;9560190761;Taip;0;2;0;2
2815;"Gintarėlis (Didlaukio g. 35)";LAŠIUKAI;5434952733;Taip;0;5;0;5
2816;"Gintarėlis (Didlaukio g. 35)";LAŠIUKAI;5018151097;Taip;3;3;0;6
2817;"Gintarėlis (Didlaukio g. 35)";LAŠIUKAI;9230924100;Taip;0;1;0;1
2818;"Gintarėlis (Didlaukio g. 35)";LAŠIUKAI;4333780287;Taip;0;5;0;5
2819;"Gintarėlis (Didlaukio g. 35)";LAŠIUKAI;7286562743;Taip;12;3;0;15
2820;"Gintarėlis (Didlaukio g. 35)";LAŠIUKAI;1675553097;Taip;0;1;2;3
2821;"Gintarėlis (Didlaukio g. 35)";LAŠIUKAI;8000297636;Taip;0;5;0;5
2822;"Gintarėlis (Didlaukio g. 35)";LAŠIUKAI;3359584322;Taip;0;3;0;3
2823;"Gintarėlis (Didlaukio g. 35)";MEŠKUČIAI;2926488239;Taip;0;1;0;1
2824;"Gintarėlis (Didlaukio g. 35)";MEŠKUČIAI;6618240550;Taip;0;5;0;5
2825;"Gintarėlis (Didlaukio g. 35)";MEŠKUČIAI;8790078624;Taip;10;2;0;12
2826;"Gintarėlis (Didlaukio g. 35)";MEŠKUČIAI;2518840573;Ne;5;13;0;18
2827;"Gintarėlis (Didlaukio g. 35)";MEŠKUČIAI;5187894822;Taip;0;3;0;3
2828;"Gintarėlis (Didlaukio g. 35)";MEŠKUČIAI;3630567294;Taip;0;6;0;6
2829;"Gintarėlis (Didlaukio g. 35)";MEŠKUČIAI;5181872438;Taip;0;4;0;4
2830;"Gintarėlis (Didlaukio g. 35)";MEŠKUČIAI;1565802953;Taip;0;23;0;23
2831;"Gintarėlis (Didlaukio g. 35)";MEŠKUČIAI;2072435242;Taip;0;3;0;3
2832;"Gintarėlis (Didlaukio g. 35)";MEŠKUČIAI;7989239799;Taip;3;4;0;7
2833;"Gintarėlis (Didlaukio g. 35)";MEŠKUČIAI;4356211536;Ne;11;1;0;12
2834;"Gintarėlis (Didlaukio g. 35)";MEŠKUČIAI;1502740714;Taip;5;0;0;5
2835;"Gintarėlis (Didlaukio g. 35)";MEŠKUČIAI;6636835034;Taip;0;5;0;5
2836;"Gintarėlis (Didlaukio g. 35)";MEŠKUČIAI;3830154353;Ne;0;1;0;1
2837;"Gintarėlis (Didlaukio g. 35)";MEŠKUČIAI;3947405446;Taip;15;0;0;15
2838;"Gintarėlis (Didlaukio g. 35)";MEŠKUČIAI;7948438165;Taip;0;7;0;7
2839;"Gintarėlis (Didlaukio g. 35)";MEŠKUČIAI;4642142931;Taip;10;1;0;11
2840;"Gintarėlis (Didlaukio g. 35)";MEŠKUČIAI;6711753930;Taip;0;3;0;3
2841;"Gintarėlis (Didlaukio g. 35)";MEŠKUČIAI;9017592249;Taip;0;2;0;2
2842;"Gintarėlis (Didlaukio g. 35)";MEŠKUČIAI;8375475174;Taip;0;11;0;11
2843;"Gintarėlis (Didlaukio g. 35)";MEŠKUČIAI;1790629500;Taip;5;0;0;5
2844;"Gintarėlis (Didlaukio g. 35)";MEŠKUČIAI;7320085613;Taip;8;0;0;8
2845;"Gintarėlis (Didlaukio g. 35)";DRUGELIAI;1462949250;Taip;2;0;0;2
2846;"Gintarėlis (Didlaukio g. 35)";DRUGELIAI;9737200226;Taip;0;2;1;3
2847;"Gintarėlis (Didlaukio g. 35)";DRUGELIAI;2614258442;Taip;0;10;0;10
2848;"Gintarėlis (Didlaukio g. 35)";DRUGELIAI;4217329880;Taip;0;4;2;6
2849;"Gintarėlis (Didlaukio g. 35)";DRUGELIAI;9687974376;Taip;2;1;0;3
2850;"Gintarėlis (Didlaukio g. 35)";DRUGELIAI;7449437199;Ne;0;4;0;4
2851;"Gintarėlis (Didlaukio g. 35)";DRUGELIAI;2016067859;Taip;5;3;0;8
2852;"Gintarėlis (Didlaukio g. 35)";DRUGELIAI;9579497944;Taip;0;0;1;1
2853;"Gintarėlis (Didlaukio g. 35)";DRUGELIAI;1759218238;Ne;2;8;0;10
2854;"Gintarėlis (Didlaukio g. 35)";DRUGELIAI;1248017244;Taip;4;2;0;6
2855;"Gintarėlis (Didlaukio g. 35)";DRUGELIAI;2792618575;Taip;0;8;0;8
2856;"Gintarėlis (Didlaukio g. 35)";DRUGELIAI;8171192401;Taip;0;3;1;4
2857;"Gintarėlis (Didlaukio g. 35)";DRUGELIAI;7694587246;Taip;0;1;0;1
2858;"Gintarėlis (Didlaukio g. 35)";DRUGELIAI;4904966263;Taip;0;3;0;3
2859;"Gintarėlis (Didlaukio g. 35)";KAČIUKAI;5569843168;Taip;0;1;0;1
2860;"Gintarėlis (Didlaukio g. 35)";KAČIUKAI;3665764153;Taip;0;2;0;2
2861;"Gintarėlis (Didlaukio g. 35)";KAČIUKAI;9774056578;Taip;0;2;0;2
2862;"Gintarėlis (Didlaukio g. 35)";KAČIUKAI;2212296954;Taip;7;0;0;7
2863;"Gintarėlis (Didlaukio g. 35)";KAČIUKAI;3825700024;Taip;8;1;0;9
2864;"Gintarėlis (Didlaukio g. 35)";KAČIUKAI;7057877483;Taip;8;1;0;9
2865;"Gintarėlis (Didlaukio g. 35)";KAČIUKAI;9825811100;Taip;7;0;0;7
2866;"Gintarėlis (Didlaukio g. 35)";KAČIUKAI;7875981690;Taip;8;6;0;14
2867;"Gintarėlis (Didlaukio g. 35)";KAČIUKAI;2544338275;Taip;8;6;0;14
2868;"Gintarėlis (Didlaukio g. 35)";KAČIUKAI;9963329170;Taip;0;3;0;3
2869;"Gintarėlis (Didlaukio g. 35)";KAČIUKAI;7182964126;Taip;5;0;0;5
2870;"Gintarėlis (Didlaukio g. 35)";KAČIUKAI;4754929282;Taip;5;0;0;5
2871;"Gintarėlis (Didlaukio g. 35)";KAČIUKAI;5214984111;Taip;7;0;0;7
2872;"Gintarėlis (Didlaukio g. 35)";KAČIUKAI;1011749698;Taip;5;3;0;8
2873;"Gintarėlis (Didlaukio g. 35)";KAČIUKAI;8261770154;Taip;0;14;0;14
2874;"Gintarėlis (Didlaukio g. 35)";KAČIUKAI;7061545258;Taip;0;2;0;2
2875;"Gintarėlis (Didlaukio g. 35)";KAČIUKAI;5436695400;Ne;0;5;0;5
2876;"Gintarėlis (Didlaukio g. 35)";KAČIUKAI;5921751507;Taip;0;3;0;3
2877;"Gintarėlis (Didlaukio g. 35)";KAČIUKAI;9450900915;Ne;14;0;1;15
2878;"Gintarėlis (Didlaukio g. 35)";KAČIUKAI;5153948767;Taip;0;3;0;3
2879;"Gintarėlis (Didlaukio g. 35)";KAČIUKAI;3814485627;Taip;8;1;0;9
2880;"Gintarėlis (Didlaukio g. 35)";KAČIUKAI;1571260478;Ne;0;5;1;6
2881;"Gintarėlis (Didlaukio g. 35)";KAČIUKAI;9244715396;Taip;8;3;0;11
2882;"Gintarėlis (Didlaukio g. 35)";KAČIUKAI;3015327416;Taip;1;4;1;6
2883;"Gintarėlis (Didlaukio g. 35)";KIŠKUČIAI;2814569415;Taip;0;4;3;7
2884;"Gintarėlis (Didlaukio g. 35)";KIŠKUČIAI;7143014339;Taip;0;3;0;3
2885;"Gintarėlis (Didlaukio g. 35)";KIŠKUČIAI;5796729245;Taip;0;8;0;8
2886;"Gintarėlis (Didlaukio g. 35)";KIŠKUČIAI;9915887420;Taip;0;8;0;8
2887;"Gintarėlis (Didlaukio g. 35)";KIŠKUČIAI;8287685690;Taip;0;4;0;4
2888;"Gintarėlis (Didlaukio g. 35)";KIŠKUČIAI;7815317644;Taip;5;3;0;8
2889;"Gintarėlis (Didlaukio g. 35)";KIŠKUČIAI;2165332442;Taip;3;0;0;3
2890;"Gintarėlis (Didlaukio g. 35)";KIŠKUČIAI;6914904213;Taip;8;0;0;8
2891;"Gintarėlis (Didlaukio g. 35)";KIŠKUČIAI;1696337909;Taip;8;0;0;8
2892;"Gintarėlis (Didlaukio g. 35)";KIŠKUČIAI;6862629244;Taip;10;4;0;14
2893;"Gintarėlis (Didlaukio g. 35)";KIŠKUČIAI;3398936974;Taip;0;2;0;2
2894;"Gintarėlis (Didlaukio g. 35)";KIŠKUČIAI;1918879534;Taip;0;4;0;4
2895;"Gintarėlis (Didlaukio g. 35)";KIŠKUČIAI;7509100750;Taip;0;3;0;3
2896;"Gintarėlis (Didlaukio g. 35)";KIŠKUČIAI;6991746305;Taip;5;3;0;8
2897;"Gintarėlis (Didlaukio g. 35)";KIŠKUČIAI;3792697409;Taip;5;0;0;5
2898;"Gintarėlis (Didlaukio g. 35)";KIŠKUČIAI;6239242631;Taip;5;0;0;5
2899;"Gintarėlis (Didlaukio g. 35)";KIŠKUČIAI;4623909811;Taip;0;7;3;10
2900;"Gintarėlis (Didlaukio g. 35)";KIŠKUČIAI;3357866319;Taip;0;7;0;7
2901;"Gintarėlis (Didlaukio g. 35)";KIŠKUČIAI;8704248985;Taip;0;12;0;12
2902;"Gintarėlis (Didlaukio g. 35)";KIŠKUČIAI;5355691986;Taip;0;3;0;3
2903;"Gintarėlis (Didlaukio g. 35)";KIŠKUČIAI;5919205817;Taip;0;2;6;8
2904;"Gintarėlis (Didlaukio g. 35)";VYTURIUKAI;9954282865;Taip;0;2;0;2
2905;"Gintarėlis (Didlaukio g. 35)";VYTURIUKAI;5834772263;Taip;0;4;0;4
2906;"Gintarėlis (Didlaukio g. 35)";BORUŽĖLĖS;6402043654;Taip;8;2;0;10
2907;"Gintarėlis (Didlaukio g. 35)";BORUŽĖLĖS;6558614008;Taip;0;5;1;6
2908;"Gintarėlis (Didlaukio g. 35)";BORUŽĖLĖS;4348245746;Taip;0;2;0;2
2909;"Gintarėlis (Didlaukio g. 35)";BORUŽĖLĖS;3091731769;Taip;0;4;0;4
2910;"Gintarėlis (Didlaukio g. 35)";BORUŽĖLĖS;6484966941;Taip;0;10;4;14
2911;"Gintarėlis (Didlaukio g. 35)";BORUŽĖLĖS;9004590065;Taip;10;1;0;11
2912;"Gintarėlis (Didlaukio g. 35)";BORUŽĖLĖS;2624469768;Taip;0;2;0;2
2913;"Gintarėlis (Didlaukio g. 35)";BORUŽĖLĖS;8784796186;Taip;5;3;0;8
2914;"Gintarėlis (Didlaukio g. 35)";BORUŽĖLĖS;3538300416;Taip;5;0;0;5
2915;"Gintarėlis (Didlaukio g. 35)";BORUŽĖLĖS;8516817506;Taip;0;11;0;11
2916;"Gintarėlis (Didlaukio g. 35)";BORUŽĖLĖS;3235154374;Taip;0;23;0;23
2917;"Gintarėlis (Didlaukio g. 35)";BORUŽĖLĖS;4809352525;Taip;0;4;0;4
2918;"Gintarėlis (Didlaukio g. 35)";BORUŽĖLĖS;7059730814;Taip;7;1;0;8
2919;"Gintarėlis (Didlaukio g. 35)";BORUŽĖLĖS;5965570522;Taip;7;0;0;7
2920;"Gintarėlis (Didlaukio g. 35)";BORUŽĖLĖS;9970786396;Taip;0;9;0;9
2921;"Gintarėlis (Didlaukio g. 35)";BORUŽĖLĖS;7118758040;Taip;8;0;0;8
2922;"Gintarėlis (Didlaukio g. 35)";BORUŽĖLĖS;9622824643;Taip;23;0;0;23
2923;"Gintarėlis (Didlaukio g. 35)";BORUŽĖLĖS;9476258741;Ne;0;2;2;4
2924;"Gintarėlis (Didlaukio g. 35)";BORUŽĖLĖS;1400817076;Taip;5;0;0;5
2925;"Gintarėlis (Didlaukio g. 35)";BORUŽĖLĖS;1371258551;Taip;13;6;0;19
2926;"Gintarėlis (Didlaukio g. 35)";BORUŽĖLĖS;4334349824;Taip;15;2;0;17
2927;"Gintarėlis (Didlaukio g. 35)";BORUŽĖLĖS;8410642485;Taip;4;6;0;10
2928;"Gintarėlis (Didlaukio g. 35)";BORUŽĖLĖS;9501012756;Taip;8;0;0;8
2929;"Gintarėlis (Didlaukio g. 35)";EŽIUKAI;4676321193;Taip;0;8;0;8
2930;"Gintarėlis (Didlaukio g. 35)";EŽIUKAI;4487346983;Taip;0;5;0;5
2931;"Gintarėlis (Didlaukio g. 35)";EŽIUKAI;2263102527;Taip;10;2;1;13
2932;"Gintarėlis (Didlaukio g. 35)";EŽIUKAI;7919771693;Taip;0;0;2;2
2933;"Gintarėlis (Didlaukio g. 35)";EŽIUKAI;9040480798;Taip;4;2;0;6
2934;"Gintarėlis (Didlaukio g. 35)";EŽIUKAI;8055928882;Taip;0;3;0;3
2935;"Gintarėlis (Didlaukio g. 35)";EŽIUKAI;5024727902;Taip;0;3;0;3
2936;"Gintarėlis (Didlaukio g. 35)";EŽIUKAI;2088008759;Taip;0;1;1;2
2937;"Gintarėlis (Didlaukio g. 35)";EŽIUKAI;6457288028;Taip;0;3;0;3
2938;"Gintarėlis (Didlaukio g. 35)";EŽIUKAI;4660854883;Taip;0;2;0;2
2939;"Gintarėlis (Didlaukio g. 35)";EŽIUKAI;94354056029;Taip;3;1;0;4
2940;"Gintarėlis (Didlaukio g. 35)";EŽIUKAI;1002155392;Taip;0;1;0;1
2941;"Gintarėlis (Didlaukio g. 35)";EŽIUKAI;9130659549;Taip;0;1;0;1
2942;"Gintarėlis (Didlaukio g. 35)";EŽIUKAI;2036488789;Taip;14;0;0;14
2943;"Gintarėlis (Didlaukio g. 35)";EŽIUKAI;7644607132;Taip;0;3;0;3
2944;"Gintarėlis (Didlaukio g. 35)";EŽIUKAI;7192722296;Taip;0;1;0;1
2945;"Gintarėlis (Didlaukio g. 35)";EŽIUKAI;2970527490;Ne;0;5;0;5
2946;"Gintarėlis (Didlaukio g. 35)";EŽIUKAI;1028456578;Taip;0;2;1;3
2947;"Gintarėlis (Didlaukio g. 35)";EŽIUKAI;1066741732;Taip;12;0;1;13
2948;"Gintarėlis (Didlaukio g. 35)";EŽIUKAI;1778573935;Taip;2;3;0;5
2949;"Gintarėlis (Didlaukio g. 35)";EŽIUKAI;9917367735;Taip;0;1;0;1
2950;"Gintarėlis (Didlaukio g. 35)";EŽIUKAI;4514340634;Ne;3;4;1;8
2951;"Gintarėlis (Didlaukio g. 35)";VIŠČIUKAI;1981825456;Taip;2;4;0;6
2952;"Gintarėlis (Didlaukio g. 35)";VIŠČIUKAI;3973889495;Taip;1;2;0;3
2953;"Gintarėlis (Didlaukio g. 35)";VIŠČIUKAI;4749559606;Taip;11;0;0;11
2954;"Gintarėlis (Didlaukio g. 35)";VIŠČIUKAI;4458703839;Ne;8;1;0;9
2955;"Gintarėlis (Didlaukio g. 35)";VIŠČIUKAI;2178808286;Taip;18;2;3;23
2956;"Gintarėlis (Didlaukio g. 35)";VIŠČIUKAI;9073499040;Taip;7;5;2;14
2957;"Gintarėlis (Didlaukio g. 35)";VIŠČIUKAI;6547060300;Taip;0;4;2;6
2958;"Gintarėlis (Didlaukio g. 35)";VIŠČIUKAI;5930354746;Taip;0;4;0;4
2959;"Gintarėlis (Didlaukio g. 35)";VIŠČIUKAI;4535071342;Taip;0;8;0;8
2960;"Gintarėlis (Didlaukio g. 35)";VIŠČIUKAI;8448725884;Taip;0;8;0;8
2961;"Gintarėlis (Didlaukio g. 35)";VIŠČIUKAI;6251670953;Taip;0;7;0;7
2962;"Gintarėlis (Didlaukio g. 35)";VIŠČIUKAI;8805356168;Taip;9;1;0;10
2963;"Gintarėlis (Didlaukio g. 35)";VIŠČIUKAI;4751066825;Taip;9;2;2;13
2964;"Gintarėlis (Didlaukio g. 35)";VIŠČIUKAI;1039098192;Taip;11;5;0;16
2965;"Gintarėlis (Didlaukio g. 35)";VIŠČIUKAI;6042885133;Taip;12;3;1;16
2966;"Gintarėlis (Didlaukio g. 35)";VIŠČIUKAI;7418672923;Taip;9;1;0;10
2967;"Gintarėlis (Didlaukio g. 35)";VIŠČIUKAI;7562170082;Taip;5;16;0;21
2968;"Gintarėlis (Didlaukio g. 35)";VIŠČIUKAI;1367305617;Taip;10;0;0;10
2969;"Gintarėlis (Didlaukio g. 35)";VIŠČIUKAI;6711773127;Taip;0;5;2;7
2970;"Gintarėlis (Didlaukio g. 35)";VIŠČIUKAI;7537009709;Taip;8;1;0;9
2971;"Gintarėlis (Didlaukio g. 35)";VIŠČIUKAI;9191264261;Taip;16;0;0;16
2972;"Gintarėlis (Didlaukio g. 35)";VIŠČIUKAI;2920734274;Taip;5;0;7;12
2973;"Gintarėlis (Didlaukio g. 35)";VIŠČIUKAI;3232990779;Taip;6;4;0;10
2974;"Gintarėlis (Didlaukio g. 35)";"SAULĖS ZUIKUČIAI";4278770021;Taip;4;1;0;5
2975;"Gintarėlis (Didlaukio g. 35)";"SAULĖS ZUIKUČIAI";9915228593;Taip;0;4;0;4
2976;"Gintarėlis (Didlaukio g. 35)";"SAULĖS ZUIKUČIAI";2499727321;Taip;0;4;1;5
2977;"Gintarėlis (Didlaukio g. 35)";"SAULĖS ZUIKUČIAI";2949035147;Taip;10;0;0;10
2978;"Gintarėlis (Didlaukio g. 35)";"SAULĖS ZUIKUČIAI";3839660368;Taip;0;2;0;2
2979;"Gintarėlis (Didlaukio g. 35)";"SAULĖS ZUIKUČIAI";5991638696;Taip;0;5;1;6
2980;"Gintarėlis (Didlaukio g. 35)";"SAULĖS ZUIKUČIAI";6563281778;Taip;8;7;2;17
2981;"Gintarėlis (Didlaukio g. 35)";"SAULĖS ZUIKUČIAI";6133476137;Taip;2;1;0;3
2982;"Gintarėlis (Didlaukio g. 35)";"SAULĖS ZUIKUČIAI";6751822184;Taip;0;5;0;5
2983;"Gintarėlis (Didlaukio g. 35)";"SAULĖS ZUIKUČIAI";8721340357;Taip;5;0;2;7
2984;"Gintarėlis (Didlaukio g. 35)";"SAULĖS ZUIKUČIAI";3876016666;Taip;17;0;0;17
2985;"Gintarėlis (Didlaukio g. 35)";"SAULĖS ZUIKUČIAI";8403881160;Taip;14;5;0;19
2986;"Gintarėlis (Didlaukio g. 35)";"SAULĖS ZUIKUČIAI";5336654560;Taip;3;4;0;7
2987;"Gintarėlis (Didlaukio g. 35)";"SAULĖS ZUIKUČIAI";3732252177;Taip;3;4;0;7
2988;"Gintarėlis (Didlaukio g. 35)";"SAULĖS ZUIKUČIAI";4087751760;Taip;16;0;0;16
2989;"Gintarėlis (Didlaukio g. 35)";"SAULĖS ZUIKUČIAI";4462515146;Taip;9;3;0;12
2990;"Gintarėlis (Didlaukio g. 35)";"SAULĖS ZUIKUČIAI";6138593853;Taip;4;0;0;4
2991;"Gintarėlis (Didlaukio g. 35)";"SAULĖS ZUIKUČIAI";7004430575;Taip;11;0;0;11
2992;"Gintarėlis (Didlaukio g. 35)";"SAULĖS ZUIKUČIAI";5509394003;Taip;16;0;0;16
2993;"Gintarėlis (Didlaukio g. 35)";Pabiručiai;1158055621;Taip;11;0;0;11
2994;"Gintarėlis (Didlaukio g. 35)";Pabiručiai;1474802737;Taip;7;4;0;11
2995;"Gintarėlis (Didlaukio g. 35)";Pabiručiai;6578588403;Taip;0;4;0;4
2996;"Gintarėlis (Didlaukio g. 35)";Šypsenėlės;3575375401;Taip;0;2;8;10
2997;"Gintarėlis (Didlaukio g. 35)";Šypsenėlės;3575375401;Taip;0;2;8;10
2998;"Gintarėlis (Didlaukio g. 35)";Šypsenėlės;3575375401;Taip;0;2;8;10
2999;"Gintarėlis (Didlaukio g. 35)";Šypsenėlės;9020619501;Taip;0;7;4;11
3000;"Gintarėlis (Didlaukio g. 35)";Šypsenėlės;2904118045;Taip;15;0;1;16
3001;"Gintarėlis (Didlaukio g. 35)";Šypsenėlės;5120761293;Taip;0;2;0;2
3002;"Gintarėlis (Didlaukio g. 35)";Šypsenėlės;9413836091;Taip;0;5;3;8
3003;"Gintarėlis (Didlaukio g. 35)";Šypsenėlės;1567290856;Taip;0;0;2;2
3004;"Gintarėlis (Didlaukio g. 35)";Šypsenėlės;3088663209;Taip;0;2;0;2
3005;"Gintarėlis (Didlaukio g. 35)";Šypsenėlės;3794027499;Taip;0;4;0;4
3006;"Gintarėlis (Didlaukio g. 35)";Šypsenėlės;7813187438;Taip;0;3;5;8
3007;"Gintarėlis (Didlaukio g. 35)";Šypsenėlės;9234476307;Taip;0;2;3;5
3008;"Gintarėlis (Didlaukio g. 35)";Šypsenėlės;6561070982;Taip;0;4;0;4
3009;"Gintarėlis (Didlaukio g. 35)";Šypsenėlės;2203238888;Taip;0;3;0;3
3010;"Gintarėlis (Didlaukio g. 35)";Šypsenėlės;3484172382;Taip;0;4;0;4
3011;"Gintarėlis (Didlaukio g. 35)";Šypsenėlės;2256002308;Taip;0;2;1;3
3012;"Gintarėlis (Didlaukio g. 35)";Šypsenėlės;6607854244;Taip;7;0;0;7
3013;"Gintarėlis (Didlaukio g. 35)";Šypsenėlės;1327681704;Taip;0;1;0;1
3014;"Gintarėlis (Didlaukio g. 35)";Šypsenėlės;3987801707;Taip;4;1;0;5
3015;"Gintarėlis (Didlaukio g. 35)";Šypsenėlės;7123016029;Ne;0;1;0;1
3016;"Gintarėlis (Didlaukio g. 35)";Šypsenėlės;3000371147;Taip;0;3;0;3
3017;"Gintarėlis (Didlaukio g. 35)";Šypsenėlės;5717123412;Ne;0;4;0;4
3018;"Gintarėlis (Didlaukio g. 35)";Šypsenėlės;1480486900;Ne;0;2;1;3
3019;"Gintarėlis (Didlaukio g. 35)";Smalsučiai;7486822380;Taip;5;2;0;7
3020;"Gintarėlis (Didlaukio g. 35)";Smalsučiai;1876292168;Taip;7;4;0;11
3021;"Gintarėlis (Didlaukio g. 35)";Smalsučiai;9980747501;Taip;2;0;0;2
3022;"Gintarėlis (Didlaukio g. 35)";Smalsučiai;8754068506;Ne;1;2;1;4
3023;"Gintarėlis (Didlaukio g. 35)";Smalsučiai;7690748176;Taip;5;3;0;8
3024;"Gintarėlis (Didlaukio g. 35)";Smalsučiai;8355089218;Taip;7;0;0;7
3025;"Gintarėlis (Didlaukio g. 35)";Kodėlčiukai;7976989629;Taip;1;0;2;3
3026;"Gintarėlis (Didlaukio g. 35)";Kodėlčiukai;8982034601;Taip;4;0;1;5
3027;"Gintarėlis (Didlaukio g. 35)";Kodėlčiukai;2234295991;Taip;0;1;1;2
3028;"Gintarėlis (Didlaukio g. 35)";Kodėlčiukai;6545866812;Taip;3;1;2;6
3029;"Gintarėlis (Didlaukio g. 35)";Kodėlčiukai;5467958458;Taip;5;3;0;8
3030;"Gintarėlis (Didlaukio g. 35)";Kodėlčiukai;5824210469;Taip;9;0;0;9
3031;"Gintarėlis (Didlaukio g. 35)";Kodėlčiukai;5202442681;Taip;9;0;1;10
3032;"Gintarėlis (Didlaukio g. 35)";Gintariukai;2809388552;Ne;5;0;0;5
3033;"Gintarėlis (Didlaukio g. 35)";Gintariukai;8815001033;Ne;5;0;0;5
3034;"Gintarėlis (Didlaukio g. 35)";Gintariukai;9787141660;Taip;11;0;1;12
3035;Giraitė;Aviliukas;4292730355;Taip;0;5;0;5
3036;Giraitė;Aviliukas;7001163828;Taip;5;3;0;8
3037;Giraitė;Aviliukas;5456658087;Ne;0;0;2;2
3038;Giraitė;Aviliukas;6159650070;Taip;3;3;3;9
3039;Giraitė;Aviliukas;4758750245;Taip;11;0;1;12
3040;Giraitė;Aviliukas;2219854347;Taip;11;0;1;12
3041;Giraitė;Aviliukas;6315990604;Taip;16;7;0;23
3042;Giraitė;Aviliukas;2338867192;Taip;5;0;0;5
3043;Giraitė;Aviliukas;3719285343;Taip;10;0;2;12
3044;Giraitė;Aviliukas;3085107071;Taip;0;0;2;2
3045;Giraitė;Aviliukas;7807844145;Taip;0;3;1;4
3046;Giraitė;Aviliukas;3757900478;Taip;14;0;0;14
3047;Giraitė;Aviliukas;7876457529;Taip;8;0;0;8
3048;Giraitė;Aviliukas;3992069614;Taip;7;3;0;10
3049;Giraitė;Aviliukas;6121586335;Taip;5;0;8;13
3050;Giraitė;Aviliukas;4440444700;Taip;18;0;0;18
3051;Giraitė;Aviliukas;6296485105;Taip;13;0;0;13
3052;Giraitė;Aviliukas;5356944812;Taip;6;0;1;7
3053;Giraitė;Aviliukas;4554565631;Ne;9;3;0;12
3054;Giraitė;Aviliukas;2340866110;Taip;0;0;13;13
3055;Giraitė;LapiukaI;6141730004;Taip;5;1;0;6
3056;Giraitė;LapiukaI;7831526566;Taip;15;0;0;15
3057;Giraitė;LapiukaI;2740656695;Taip;0;1;0;1
3058;Giraitė;LapiukaI;5030697729;Taip;0;2;1;3
3059;Giraitė;LapiukaI;5006156109;Ne;0;1;0;1
3060;Giraitė;LapiukaI;4663343304;Taip;0;1;2;3
3061;Giraitė;LapiukaI;5382004098;Taip;0;2;0;2
3062;Giraitė;LapiukaI;4811513778;Ne;0;1;0;1
3063;Giraitė;LapiukaI;4296449093;Taip;0;2;0;2
3064;Giraitė;LapiukaI;1974159110;Taip;5;3;0;8
3065;Giraitė;LapiukaI;5532639133;Taip;10;3;0;13
3066;Giraitė;LapiukaI;4076402180;Taip;0;9;0;9
3067;Giraitė;LapiukaI;5902161665;Taip;11;3;0;14
3068;Giraitė;LapiukaI;4955786826;Taip;0;3;0;3
3069;Giraitė;LapiukaI;4260343903;Taip;8;0;0;8
3070;Giraitė;LapiukaI;9088123796;Taip;13;0;0;13
3071;Giraitė;LapiukaI;7772177095;Taip;0;2;0;2
3072;Giraitė;LapiukaI;8492822889;Ne;10;0;0;10
3073;Giraitė;LapiukaI;2880342138;Taip;0;0;2;2
3074;Giraitė;Voveriukai;7354834895;Taip;0;3;0;3
3075;Giraitė;Voveriukai;4387282125;Taip;0;1;0;1
3076;Giraitė;Voveriukai;4822168634;Taip;1;5;0;6
3077;Giraitė;Voveriukai;2074303013;Taip;0;3;0;3
3078;Giraitė;Voveriukai;2088867630;Taip;0;2;0;2
3079;Giraitė;Voveriukai;3875214088;Taip;3;1;0;4
3080;Giraitė;Voveriukai;5202562049;Taip;0;1;0;1
3081;Giraitė;Voveriukai;7441871219;Taip;0;3;0;3
3082;Giraitė;Voveriukai;7481895278;Taip;6;0;1;7
3083;Giraitė;Voveriukai;3607198556;Taip;0;5;0;5
3084;Giraitė;Voveriukai;1945918102;Taip;0;11;4;15
3085;Giraitė;Voveriukai;8799195526;Taip;0;1;0;1
3086;Giraitė;Voveriukai;6225092500;Taip;0;0;1;1
3087;Giraitė;Voveriukai;4137699629;Taip;9;0;1;10
3088;Giraitė;Voveriukai;4932174149;Ne;0;0;2;2
3089;Giraitė;Voveriukai;7919088987;Taip;17;3;0;20
3090;Giraitė;Voveriukai;5616242311;Taip;10;3;0;13
3091;Giraitė;Voveriukai;7739516049;Taip;0;1;1;2
3092;Giraitė;Voveriukai;4773517160;Taip;3;0;1;4
3093;Giraitė;Voveriukai;2177856916;Taip;6;0;1;7
3094;Giraitė;Grybukai;2990968206;Taip;0;0;4;4
3095;Giraitė;Grybukai;1312761239;Taip;5;2;0;7
3096;Giraitė;Grybukai;5721669627;Taip;0;1;0;1
3097;Giraitė;Grybukai;5892950503;Taip;0;10;0;10
3098;Giraitė;Grybukai;4839351300;Taip;0;6;0;6
3099;Giraitė;Grybukai;1253151830;Taip;1;0;0;1
3100;Giraitė;Grybukai;4336519836;Taip;10;0;0;10
3101;Giraitė;Grybukai;6836412890;Taip;8;0;0;8
3102;Giraitė;Grybukai;9224845723;Taip;0;3;0;3
3103;Giraitė;Grybukai;4687228561;Taip;3;0;0;3
3104;Giraitė;Grybukai;9882372025;Taip;3;0;4;7
3105;Giraitė;Grybukai;9918028862;Taip;7;3;0;10
3106;Giraitė;Grybukai;5167002022;Taip;10;4;0;14
3107;Giraitė;Grybukai;4785524898;Taip;5;0;0;5
3108;Giraitė;Grybukai;8596389737;Taip;3;0;4;7
3109;Giraitė;Grybukai;1111614295;Taip;0;1;0;1
3110;Giraitė;Grybukai;3683700626;Taip;4;3;0;7
3111;Giraitė;Grybukai;9026736929;Taip;5;4;0;9
3112;Giraitė;Riešutėliai;5365264259;Taip;3;0;0;3
3113;Giraitė;Riešutėliai;7179656901;Ne;10;0;0;10
3114;Giraitė;Riešutėliai;3158451613;Taip;12;0;0;12
3115;Giraitė;Riešutėliai;7910736839;Taip;18;0;0;18
3116;Giraitė;Riešutėliai;3308792461;Taip;18;0;0;18
3117;Giraitė;Riešutėliai;7580600719;Taip;7;0;0;7
3118;Giraitė;Riešutėliai;6838184704;Taip;0;6;1;7
3119;Giraitė;Riešutėliai;5161383686;Taip;3;2;1;6
3120;Giraitė;Riešutėliai;7566944002;Taip;8;0;1;9
3121;Giraitė;Riešutėliai;3839432744;Taip;0;0;1;1
3122;Giraitė;Riešutėliai;7803047658;Taip;0;1;0;1
3123;Giraitė;Riešutėliai;7113991095;Taip;0;3;0;3
3124;Giraitė;Riešutėliai;9144465313;Taip;0;1;0;1
3125;Giraitė;Riešutėliai;6288016799;Taip;6;2;0;8
3126;Giraitė;Riešutėliai;3278871662;Taip;9;1;0;10
3127;Giraitė;Riešutėliai;4168934880;Taip;0;1;0;1
3128;Giraitė;Riešutėliai;6337090583;Taip;5;8;0;13
3129;Giraitė;Riešutėliai;3843211767;Taip;0;0;2;2
3130;Giraitė;Meškiukai;27501094616;Taip;0;1;0;1
3131;Giraitė;Meškiukai;2513312448;Taip;0;1;0;1
3132;Giraitė;Meškiukai;5367392810;Taip;7;2;0;9
3133;Giraitė;Meškiukai;1355594003;Taip;3;5;0;8
3134;Giraitė;Meškiukai;1560868105;Taip;10;0;0;10
3135;Giraitė;Meškiukai;1050699551;Taip;13;0;0;13
3136;Giraitė;Meškiukai;1876815077;Taip;0;3;0;3
3137;Giraitė;Meškiukai;1063628206;Taip;0;3;0;3
3138;Giraitė;Meškiukai;1318214394;Taip;3;0;0;3
3139;Giraitė;Meškiukai;9195735923;Taip;0;0;1;1
3140;Giraitė;Meškiukai;1704154980;Taip;8;2;1;11
3141;Giraitė;Meškiukai;1819657811;Taip;5;1;0;6
3142;Giraitė;Meškiukai;2571892050;Taip;5;3;4;12
3143;Giraitė;Meškiukai;6156715234;Taip;5;0;0;5
3144;Giraitė;Meškiukai;1594965200;Taip;0;0;3;3
3145;Giraitė;Meškiukai;9723242940;Taip;7;3;0;10
3146;Giraitė;Meškiukai;5726182600;Taip;0;2;3;5
3147;Giraitė;Meškiukai;1772790396;Ne;10;0;1;11
3148;Giraitė;Meškiukai;2551280794;Taip;0;21;0;21
3149;Giraitė;Uogelės;8908602761;Taip;2;1;0;3
3150;Giraitė;Uogelės;4717851198;Taip;0;6;0;6
3151;Giraitė;Uogelės;9503157590;Taip;5;3;0;8
3152;Giraitė;Uogelės;9927102264;Taip;4;0;2;6
3153;Giraitė;Uogelės;4843415587;Taip;0;3;0;3
3154;Giraitė;Uogelės;5471577047;Taip;7;2;0;9
3155;Giraitė;Uogelės;2732715332;Taip;0;3;0;3
3156;Giraitė;Uogelės;2307307454;Taip;7;3;0;10
3157;Giraitė;Uogelės;2102237550;Taip;0;1;0;1
3158;Giraitė;Uogelės;6065010363;Taip;0;3;0;3
3159;Giraitė;Uogelės;1583733838;Taip;0;10;0;10
3160;Giraitė;Uogelės;1356340471;Taip;6;3;3;12
3161;Giraitė;Uogelės;7377939409;Ne;12;7;0;19
3162;Giraitė;Uogelės;4288937528;Taip;15;0;0;15
3163;Giraitė;Uogelės;6293111179;Taip;12;5;0;17
3164;Giraitė;Uogelės;7390702355;Taip;4;0;0;4
3165;Giraitė;Šaltinėlis;8427713392;Taip;6;0;1;7
3166;Giraitė;Šaltinėlis;3612494313;Taip;0;0;6;6
3167;Giraitė;Šaltinėlis;2076989836;Taip;12;0;2;14
3168;Giraitė;Šaltinėlis;9589760939;Taip;16;0;0;16
3169;Giraitė;Šaltinėlis;4500393769;Taip;0;1;0;1
3170;Giraitė;Šaltinėlis;3144724475;Taip;0;0;5;5
3171;Giraitė;Šaltinėlis;5525538498;Taip;8;0;4;12
3172;Giraitė;Šaltinėlis;4681342624;Taip;0;0;4;4
3173;Giraitė;Šaltinėlis;6799728348;Taip;10;13;0;23
3174;Giraitė;Šaltinėlis;4431964254;Taip;0;0;7;7
3175;Giraitė;Šaltinėlis;4946664007;Taip;20;0;0;20
3176;Giraitė;Šaltinėlis;6865072274;Taip;11;0;0;11
3177;Giraitė;Šaltinėlis;3108521607;Taip;10;7;2;19
3178;Giraitė;Šaltinėlis;8139743188;Ne;8;1;1;10
3179;Giraitė;Šaltinėlis;2867735227;Ne;8;0;3;11
3180;Giraitė;Šaltinėlis;9669849051;Taip;10;0;2;12
3181;Giraitė;Boružėlės;6378362980;Taip;8;0;0;8
3182;Giraitė;Boružėlės;8612554184;Taip;18;0;0;18
3183;Giraitė;Boružėlės;1436302175;Taip;7;0;3;10
3184;Giraitė;Boružėlės;2064019596;Taip;5;3;0;8
3185;Giraitė;Boružėlės;3346193393;Taip;17;0;0;17
3186;Giraitė;Boružėlės;7260229442;Taip;8;0;0;8
3187;Giraitė;Boružėlės;1126576745;Taip;5;0;0;5
3188;Giraitė;Boružėlės;1772997796;Taip;23;0;0;23
3189;Giraitė;Boružėlės;9281071794;Taip;13;0;0;13
3190;Giraitė;Boružėlės;9386943162;Taip;10;1;0;11
3191;Giraitė;Boružėlės;4749790368;Taip;6;0;0;6
3192;Giraitė;Boružėlės;3039445733;Taip;8;0;0;8
3193;Giraitė;Boružėlės;4719547384;Taip;13;0;0;13
3194;Giraitė;Boružėlės;4008393576;Taip;0;2;0;2
3195;Giraitė;Boružėlės;9766107773;Taip;11;0;2;13
3196;Giraitė;Gandriukai;4680913596;Taip;15;0;0;15
3197;Giraitė;Gandriukai;7384795349;Taip;8;0;0;8
3198;Giraitė;Gandriukai;8525380061;Taip;5;0;1;6
3199;Giraitė;Gandriukai;4851987149;Ne;0;0;4;4
3200;Giraitė;Gandriukai;2205108811;Taip;8;0;2;10
3201;Giraitė;Gandriukai;7008670489;Taip;0;3;0;3
3202;Giraitė;Gandriukai;6277788515;Taip;0;1;3;4
3203;Giraitė;Gandriukai;7767820565;Ne;10;0;0;10
3204;Giraitė;Gandriukai;8819218663;Taip;5;0;0;5
3205;Giraitė;Gandriukai;7269074498;Taip;10;0;0;10
3206;Giraitė;Gandriukai;1490748887;Ne;3;0;0;3
3207;Giraitė;Gandriukai;7789414361;Taip;12;1;0;13
3208;Giraitė;Gandriukai;9850432917;Taip;15;0;0;15
3209;Giraitė;Gandriukai;2313273738;Taip;6;0;0;6
3210;Giraitė;Gandriukai;9625436756;Taip;0;1;0;1
3211;Giraitė;Gandriukai;8101302584;Taip;20;0;0;20
3212;Giraitė;Gandriukai;9307640828;Taip;18;0;0;18
3213;Giraitė;Gandriukai;3027761044;Taip;10;0;0;10
3214;Giraitė;Gandriukai;1125863541;Taip;5;0;0;5
3215;Giraitė;Gandriukai;4371263826;Taip;14;3;0;17
3216;Giraitė;ŽVIRBLIUKAI;8461725999;Taip;0;0;5;5
3217;Giraitė;ŽVIRBLIUKAI;7395332578;Taip;14;0;0;14
3218;Giraitė;ŽVIRBLIUKAI;5086296808;Taip;1;8;0;9
3219;Giraitė;ŽVIRBLIUKAI;9669916418;Taip;10;0;0;10
3220;Giraitė;ŽVIRBLIUKAI;3481695682;Taip;3;0;0;3
3221;Giraitė;ŽVIRBLIUKAI;9471560738;Taip;0;2;0;2
3222;Giraitė;ŽVIRBLIUKAI;6677278422;Taip;10;0;0;10
3223;Giraitė;ŽVIRBLIUKAI;7230351549;Taip;5;5;0;10
3224;Giraitė;ŽVIRBLIUKAI;9728453316;Taip;0;1;0;1
3225;Giraitė;ŽVIRBLIUKAI;9392127689;Taip;0;2;0;2
3226;Giraitė;ŽVIRBLIUKAI;2416162886;Taip;8;0;2;10
3227;Giraitė;ŽVIRBLIUKAI;7543605905;Taip;5;7;0;12
3228;Giraitė;ŽVIRBLIUKAI;8128401630;Taip;17;0;0;17
3229;Giraitė;ŽVIRBLIUKAI;4233170371;Taip;11;0;0;11
3230;Giraitė;ŽVIRBLIUKAI;8871979627;Ne;3;0;0;3
3231;Giraitė;ŽVIRBLIUKAI;3214528809;Taip;0;13;0;13
3232;Giraitė;ŽVIRBLIUKAI;5548434439;Taip;4;10;0;14
3233;Giraitė;ŽVIRBLIUKAI;6474975269;Taip;0;0;1;1
3234;Giraitė;Kiškeliai;1227555563;Taip;4;0;0;4
3235;Giraitė;Kiškeliai;3613828494;Taip;12;0;3;15
3236;Giraitė;Kiškeliai;5447466102;Taip;4;3;0;7
3237;Giraitė;Kiškeliai;2686885139;Taip;0;0;1;1
3238;Giraitė;Kiškeliai;9764802294;Taip;5;0;0;5
3239;Giraitė;Kiškeliai;5574589536;Taip;11;0;2;13
3240;Giraitė;Kiškeliai;2726766768;Taip;13;0;0;13
3241;Giraitė;Kiškeliai;6565165993;Ne;0;0;1;1
3242;Giraitė;Kiškeliai;1456726379;Ne;0;0;2;2
3243;Giraitė;Kiškeliai;7744101334;Ne;1;1;2;4
3244;Giraitė;Kiškeliai;9751078590;Taip;0;0;1;1
3245;Gudrutis;Gandriukų;2197278086;Taip;3;9;1;13
3246;Gudrutis;Gandriukų;6358318238;Taip;5;2;0;7
3247;Gudrutis;Gandriukų;7942601528;Taip;3;0;0;3
3248;Gudrutis;Gandriukų;1701035039;Taip;0;3;0;3
3249;Gudrutis;Gandriukų;4844838728;Taip;12;0;0;12
3250;Gudrutis;Gandriukų;1685531183;Taip;9;0;0;9
3251;Gudrutis;Gandriukų;9253468183;Taip;1;1;3;5
3252;Gudrutis;Gandriukų;1051407930;Taip;3;6;0;9
3253;Gudrutis;Gandriukų;7755882832;Taip;0;1;0;1
3254;Gudrutis;Gandriukų;2487363252;Taip;0;2;1;3
3255;Gudrutis;Gandriukų;7663746093;Taip;0;6;2;8
3256;Gudrutis;Gandriukų;1012579870;Taip;8;1;0;9
3257;Gudrutis;Gandriukų;8512130106;Taip;7;2;2;11
3258;Gudrutis;Gandriukų;3919786807;Taip;5;1;0;6
3259;Gudrutis;Gandriukų;2630768189;Taip;0;5;0;5
3260;Gudrutis;Gandriukų;8165828215;Taip;0;3;10;13
3261;Gudrutis;Gandriukų;1485530468;Taip;10;0;2;12
3262;Gudrutis;Gandriukų;5508723821;Taip;0;4;3;7
3263;Gudrutis;Gandriukų;9044566825;Ne;8;0;0;8
3264;Gudrutis;Gandriukų;8774935740;Ne;0;0;9;9
3265;Gudrutis;Gandriukų;9297898193;Taip;0;15;2;17
3266;Gudrutis;"Saulės zuikučių";7934673005;Taip;0;0;3;3
3267;Gudrutis;"Saulės zuikučių";2199222671;Taip;0;0;1;1
3268;Gudrutis;"Saulės zuikučių";1670550212;Taip;0;0;4;4
3269;Gudrutis;"Saulės zuikučių";5241856014;Taip;6;0;0;6
3270;Gudrutis;"Saulės zuikučių";1225698076;Taip;15;0;0;15
3271;Gudrutis;"Saulės zuikučių";8500911420;Ne;0;0;4;4
3272;Gudrutis;"Saulės zuikučių";5408444872;Taip;0;1;1;2
3273;Gudrutis;"Saulės zuikučių";9041133527;Taip;0;1;0;1
3274;Gudrutis;"Saulės zuikučių";8621229735;Taip;3;9;0;12
3275;Gudrutis;"Saulės zuikučių";8240340213;Taip;0;3;1;4
3276;Gudrutis;"Saulės zuikučių";6846653547;Taip;7;0;0;7
3277;Gudrutis;"Saulės zuikučių";3281890659;Taip;0;6;0;6
3278;Gudrutis;"Saulės zuikučių";2291393238;Taip;0;0;2;2
3279;Gudrutis;"Saulės zuikučių";9752360809;Taip;0;2;0;2
3280;Gudrutis;"Saulės zuikučių";5585248878;Ne;8;0;0;8
3281;Gudrutis;"Saulės zuikučių";1384696362;Taip;0;0;1;1
3282;Gudrutis;"Saulės zuikučių";2666772437;Taip;9;0;3;12
3283;Gudrutis;"Saulės zuikučių";2994309084;Ne;7;0;4;11
3284;Gudrutis;"Saulės zuikučių";3743529726;Ne;0;0;2;2
3285;Gudrutis;Pelėdžiukų;2293472716;Taip;0;0;2;2
3286;Gudrutis;Pelėdžiukų;6835038962;Ne;0;0;3;3
3287;Gudrutis;Pelėdžiukų;6731806925;Taip;0;2;1;3
3288;Gudrutis;Pelėdžiukų;2118727861;Taip;12;0;1;13
3289;Gudrutis;Pelėdžiukų;9701111916;Ne;4;10;2;16
3290;Gudrutis;Pelėdžiukų;1725920873;Taip;4;3;6;13
3291;Gudrutis;Pelėdžiukų;6198012431;Taip;0;5;0;5
3292;Gudrutis;Pelėdžiukų;3646335609;Taip;0;9;0;9
3293;Gudrutis;Pelėdžiukų;7871991275;Taip;2;0;0;2
3294;Gudrutis;Pelėdžiukų;3625838131;Taip;0;6;0;6
3295;Gudrutis;Pelėdžiukų;2337493193;Taip;0;6;0;6
3296;Gudrutis;Pelėdžiukų;2408038213;Taip;3;0;0;3
3297;Gudrutis;Pelėdžiukų;2764843216;Taip;0;3;0;3
3298;Gudrutis;Pelėdžiukų;7955353991;Taip;0;3;0;3
3299;Gudrutis;BITUČIŲ;4193661251;Taip;5;2;3;10
3300;Gudrutis;BITUČIŲ;7443277768;Taip;12;5;0;17
3301;Gudrutis;BITUČIŲ;9797417587;Taip;0;2;0;2
3302;Gudrutis;BITUČIŲ;5574287734;Ne;0;0;4;4
3303;Gudrutis;BITUČIŲ;1228190677;Taip;0;3;6;9
3304;Gudrutis;BITUČIŲ;6700254479;Taip;0;3;2;5
3305;Gudrutis;BITUČIŲ;1693306014;Taip;0;3;6;9
3306;Gudrutis;BITUČIŲ;8398961969;Taip;0;1;0;1
3307;Gudrutis;BITUČIŲ;2074151024;Taip;6;1;0;7
3308;Gudrutis;BITUČIŲ;1991658503;Taip;0;1;1;2
3309;Gudrutis;BITUČIŲ;2592224860;Taip;0;3;0;3
3310;Gudrutis;BITUČIŲ;9841172472;Taip;20;0;0;20
3311;Gudrutis;BITUČIŲ;3359028602;Taip;0;4;0;4
3312;Gudrutis;BITUČIŲ;4945755164;Taip;11;2;0;13
3313;Gudrutis;BITUČIŲ;6443631536;Taip;0;3;0;3
3314;Gudrutis;BITUČIŲ;3363824185;Taip;0;3;0;3
3315;Gudrutis;BITUČIŲ;7773150642;Taip;0;2;2;4
3316;Gudrutis;Boružėlių;2497248749;Taip;23;0;0;23
3317;Gudrutis;Boružėlių;9096764346;Taip;22;0;0;22
3318;Gudrutis;Boružėlių;8525851058;Taip;11;0;0;11
3319;Gudrutis;Boružėlių;8080976400;Taip;11;0;1;12
3320;Gudrutis;Boružėlių;6101410750;Taip;0;1;0;1
3321;Gudrutis;Boružėlių;5710348070;Taip;11;0;1;12
3322;Gudrutis;Boružėlių;8843761360;Taip;11;0;1;12
3323;Gudrutis;Boružėlių;5590297232;Taip;8;0;4;12
3324;Gudrutis;Boružėlių;2145834885;Taip;0;0;13;13
3325;Gudrutis;Boružėlių;2827279258;Taip;3;9;0;12
3326;Gudrutis;Boružėlių;5093267385;Taip;15;0;1;16
3327;Gudrutis;Boružėlių;6063661969;Taip;0;0;23;23
3328;Gudrutis;Boružėlių;1364145110;Taip;20;0;0;20
3329;Gudrutis;Drugeliai;7930414623;Taip;0;0;1;1
3330;Gudrutis;Drugeliai;6458053920;Taip;0;1;0;1
3331;Gudrutis;Drugeliai;5498218329;Taip;4;5;0;9
3332;Gudrutis;Drugeliai;4600814480;Taip;7;1;0;8
3333;Gudrutis;Drugeliai;9454206104;Taip;13;0;0;13
3334;Gudrutis;Drugeliai;5054363773;Taip;3;6;0;9
3335;Gudrutis;Drugeliai;7531077386;Taip;0;1;0;1
3336;Gudrutis;Drugeliai;5931281687;Taip;8;2;0;10
3337;Gudrutis;Drugeliai;7143849852;Ne;15;0;0;15
3338;Gudrutis;Drugeliai;3760014407;Taip;0;0;1;1
3339;Gudrutis;Drugeliai;1588396018;Taip;7;3;0;10
3340;Gudrutis;Drugeliai;3316297441;Taip;0;5;0;5
3341;Gudrutis;Drugeliai;2256458624;Taip;6;0;0;6
3342;Gudrutis;Drugeliai;2278368966;Taip;8;0;0;8
3343;Gudrutis;Drugeliai;5911423362;Taip;8;0;0;8
3344;Gudrutis;Drugeliai;3000289515;Taip;3;2;0;5
3345;Gudrutis;Drugeliai;2784392885;Taip;20;0;0;20
3346;Gudrutis;Drugeliai;1170008457;Taip;10;0;0;10
3347;Jurginėlis;Ąžuoliukai;8571054905;Taip;5;0;2;7
3348;Jurginėlis;Ąžuoliukai;6168508647;Taip;3;13;0;16
3349;Jurginėlis;Ąžuoliukai;5861832676;Taip;0;0;9;9
3350;Jurginėlis;Ąžuoliukai;3933113321;Taip;0;18;0;18
3351;Jurginėlis;Ąžuoliukai;5861418459;Taip;11;7;0;18
3352;Jurginėlis;Ąžuoliukai;5869170503;Taip;4;0;1;5
3353;Jurginėlis;Ąžuoliukai;3562210465;Taip;3;0;0;3
3354;Jurginėlis;Ąžuoliukai;6202225321;Taip;9;0;0;9
3355;Jurginėlis;Ąžuoliukai;7081618073;Taip;7;0;0;7
3356;Jurginėlis;Ąžuoliukai;6851855147;Taip;1;0;0;1
3357;Jurginėlis;Ąžuoliukai;9029587175;Taip;0;1;0;1
3358;Jurginėlis;Ąžuoliukai;9889620429;Taip;0;1;0;1
3359;Jurginėlis;Ąžuoliukai;3324811458;Taip;0;4;0;4
3360;Jurginėlis;Ąžuoliukai;6153432639;Taip;0;0;1;1
3361;Jurginėlis;Ąžuoliukai;8310464710;Taip;23;0;0;23
3362;Jurginėlis;Ąžuoliukai;9850874714;Taip;0;0;3;3
3363;Jurginėlis;Ąžuoliukai;8174251359;Ne;0;3;4;7
3364;Jurginėlis;Ąžuoliukai;2447025385;Taip;6;0;2;8
3365;Jurginėlis;Ąžuoliukai;5313627252;Taip;0;0;3;3
3366;Jurginėlis;Žiogeliai;8159210242;Taip;8;11;0;19
3367;Jurginėlis;Žiogeliai;9934831745;Ne;0;0;1;1
3368;Jurginėlis;Žiogeliai;7251598691;Taip;5;8;0;13
3369;Jurginėlis;Žiogeliai;3083045137;Taip;5;5;0;10
3370;Jurginėlis;Žiogeliai;6906225772;Ne;7;0;4;11
3371;Jurginėlis;Žiogeliai;7010130915;Taip;6;0;1;7
3372;Jurginėlis;Žiogeliai;7907096012;Taip;5;7;0;12
3373;Jurginėlis;Žiogeliai;7250246853;Taip;0;9;0;9
3374;Jurginėlis;Žiogeliai;4110053674;Ne;13;0;5;18
3375;Jurginėlis;Žiogeliai;5160581631;Ne;14;1;0;15
3376;Jurginėlis;Žiogeliai;5037980414;Ne;0;0;1;1
3377;Jurginėlis;Žiogeliai;7300018733;Taip;0;3;0;3
3378;Jurginėlis;Žiogeliai;4674128568;Taip;0;6;0;6
3379;Jurginėlis;Žiogeliai;9305884152;Taip;0;0;6;6
3380;Jurginėlis;Žiogeliai;9716328349;Taip;14;5;1;20
3381;Jurginėlis;Žiogeliai;4441183185;Taip;5;3;0;8
3382;Jurginėlis;Žiogeliai;4502564783;Taip;0;7;0;7
3383;Jurginėlis;Žiogeliai;1937927553;Ne;0;0;2;2
3384;Jurginėlis;Žiogeliai;4682125116;Taip;11;3;0;14
3385;Jurginėlis;Pelėdžiukų;5984893389;Taip;0;2;0;2
3386;Jurginėlis;Pelėdžiukų;3079495897;Taip;0;0;4;4
3387;Jurginėlis;Pelėdžiukų;8727844649;Taip;0;0;6;6
3388;Jurginėlis;Pelėdžiukų;1455749921;Taip;11;2;0;13
3389;Jurginėlis;Pelėdžiukų;2417314519;Taip;5;5;0;10
3390;Jurginėlis;Pelėdžiukų;6968528293;Taip;0;3;0;3
3391;Jurginėlis;Pelėdžiukų;4292932046;Taip;13;0;0;13
3392;Jurginėlis;Pelėdžiukų;8779807396;Taip;8;1;0;9
3393;Jurginėlis;Pelėdžiukų;8443412187;Taip;0;1;0;1
3394;Jurginėlis;Pelėdžiukų;4967548277;Taip;0;14;3;17
3395;Jurginėlis;Pelėdžiukų;1340689348;Ne;0;4;0;4
3396;Jurginėlis;Pelėdžiukų;2221708420;Taip;2;1;2;5
3397;Jurginėlis;Pelėdžiukų;6181547354;Taip;0;5;0;5
3398;Jurginėlis;Pelėdžiukų;2490875633;Taip;8;5;0;13
3399;Jurginėlis;Pelėdžiukų;9760394658;Ne;3;1;1;5
3400;Jurginėlis;Pelėdžiukų;3786379532;Ne;0;3;0;3
3401;Jurginėlis;Boružėlių;4295285885;Taip;0;4;0;4
3402;Jurginėlis;Boružėlių;8920304044;Taip;6;3;0;9
3403;Jurginėlis;Boružėlių;2171115974;Ne;5;11;0;16
3404;Jurginėlis;Boružėlių;3027573572;Taip;0;1;0;1
3405;Jurginėlis;Boružėlių;1758862051;Taip;0;3;0;3
3406;Jurginėlis;Boružėlių;6111863896;Taip;0;13;0;13
3407;Jurginėlis;Boružėlių;1563317396;Taip;0;1;0;1
3408;Jurginėlis;Boružėlių;2133447073;Taip;0;1;0;1
3409;Jurginėlis;Boružėlių;47243459592;Taip;2;2;0;4
3410;Jurginėlis;Boružėlių;8784076886;Taip;0;4;0;4
3411;Jurginėlis;Boružėlių;2446630485;Taip;4;3;0;7
3412;Jurginėlis;Boružėlių;1829089083;Taip;0;2;0;2
3413;Jurginėlis;Boružėlių;1361108271;Taip;0;1;0;1
3414;Jurginėlis;Boružėlių;5386710069;Ne;0;1;0;1
3415;Jurginėlis;Boružėlių;8972814655;Taip;0;4;0;4
3416;Jurginėlis;Boružėlių;4852619394;Taip;9;3;0;12
3417;Jurginėlis;Bitučių;9589394406;Taip;0;1;1;2
3418;Jurginėlis;Bitučių;1927843089;Taip;0;3;5;8
3419;Jurginėlis;Bitučių;3708774681;Taip;0;14;0;14
3420;Jurginėlis;Bitučių;6413324051;Taip;0;4;0;4
3421;Jurginėlis;Bitučių;1787311340;Taip;0;3;0;3
3422;Jurginėlis;Bitučių;7297672386;Taip;0;3;0;3
3423;Jurginėlis;Bitučių;1586599624;Taip;0;3;0;3
3424;Jurginėlis;Bitučių;2710889915;Taip;0;3;0;3
3425;Jurginėlis;Bitučių;1983924909;Taip;0;2;0;2
3426;Jurginėlis;Bitučių;1175441410;Taip;0;4;0;4
3427;Jurginėlis;Bitučių;1082593212;Taip;0;4;0;4
3428;Jurginėlis;Bitučių;4806248290;Taip;0;5;0;5
3429;Jurginėlis;Bitučių;9646318532;Taip;2;3;1;6
3430;Jurginėlis;Bitučių;8227660508;Taip;0;2;0;2
3431;Jurginėlis;Bitučių;77480957625;Taip;0;3;4;7
3432;Jurginėlis;Bitučių;1547101731;Taip;0;3;1;4
3433;Jurginėlis;Bitučių;2624313807;Ne;0;1;0;1
3434;Jurginėlis;Bitučių;5892180334;Taip;0;3;0;3
3435;Jurginėlis;Bitučių;3018576350;Ne;0;1;1;2
3436;Jurginėlis;Skruzdeliukų;1351306981;Taip;0;5;2;7
3437;Jurginėlis;Skruzdeliukų;9146039217;Taip;0;2;0;2
3438;Jurginėlis;Skruzdeliukų;1885598986;Ne;0;1;0;1
3439;Jurginėlis;Skruzdeliukų;3558752347;Taip;7;5;0;12
3440;Jurginėlis;Skruzdeliukų;5734506036;Ne;5;9;0;14
3441;Jurginėlis;Skruzdeliukų;3699180485;Taip;0;2;0;2
3442;Jurginėlis;Skruzdeliukų;1634502874;Ne;5;9;0;14
3443;Jurginėlis;Skruzdeliukų;2441840949;Taip;22;0;0;22
3444;Jurginėlis;Skruzdeliukų;4981043400;Taip;7;0;1;8
3445;Jurginėlis;Skruzdeliukų;1763849354;Taip;5;0;0;5
3446;Jurginėlis;Skruzdeliukų;4944292549;Taip;0;5;0;5
3447;Jurginėlis;Skruzdeliukų;9506129699;Taip;12;1;1;14
3448;Jurginėlis;Skruzdeliukų;9550110246;Taip;0;1;0;1
3449;Jurginėlis;Skruzdeliukų;3822916547;Taip;11;0;4;15
3450;Jurginėlis;Skruzdeliukų;3541542063;Taip;0;0;1;1
3451;Jurginėlis;Skruzdeliukų;1204999684;Taip;23;0;0;23
3452;Jurginėlis;Skruzdeliukų;9937405742;Taip;12;0;0;12
3453;Jurginėlis;Skruzdeliukų;1726968598;Taip;0;17;0;17
3454;Jurginėlis;Skruzdeliukų;2332714713;Taip;18;0;0;18
3455;Jurginėlis;Skruzdeliukų;9961083854;Taip;0;1;0;1
3456;Jurginėlis;Skruzdeliukų;6542567172;Taip;5;7;0;12
3457;Jurginėlis;Drugelių;9065349248;Taip;7;0;0;7
3458;Jurginėlis;Drugelių;8341951659;Taip;8;7;0;15
3459;Jurginėlis;Drugelių;7795042485;Ne;11;0;0;11
3460;Jurginėlis;Drugelių;5138832895;Taip;10;0;2;12
3461;Jurginėlis;Drugelių;3466562781;Taip;0;1;0;1
3462;Jurginėlis;Drugelių;6068645621;Taip;0;12;0;12
3463;Jurginėlis;Drugelių;5234784917;Taip;0;0;6;6
3464;Jurginėlis;Drugelių;4276237094;Taip;7;0;2;9
3465;Jurginėlis;Drugelių;3527520303;Taip;2;0;2;4
3466;Jurginėlis;Drugelių;9736737788;Taip;2;0;0;2
3467;Jurginėlis;Drugelių;1208882528;Taip;0;1;0;1
3468;Jurginėlis;Drugelių;5874949368;Taip;8;0;4;12
3469;Jurginėlis;Drugelių;7349309693;Taip;0;10;2;12
3470;Jurginėlis;Drugelių;3063084253;Taip;20;0;0;20
3471;Jurginėlis;Žibučių;4979618298;Taip;10;1;0;11
3472;Jurginėlis;Žibučių;6636147085;Taip;5;4;0;9
3473;Jurginėlis;Žibučių;1438159631;Taip;2;2;0;4
3474;Jurginėlis;Žibučių;1336429135;Taip;6;0;3;9
3475;Jurginėlis;Žibučių;6948834218;Taip;20;0;1;21
3476;Jurginėlis;Žibučių;7721612113;Taip;7;2;0;9
3477;Jurginėlis;Žibučių;6988386438;Taip;8;0;0;8
3478;Jurginėlis;Žibučių;8111158692;Taip;3;0;0;3
3479;Jurginėlis;Žibučių;5936508522;Taip;11;9;0;20
3480;Jurginėlis;Žibučių;6717892969;Taip;0;10;0;10
3481;Jurginėlis;Žibučių;7977676733;Taip;2;3;0;5
3482;Jurginėlis;Žibučių;7530846375;Taip;0;1;0;1
3483;Jurginėlis;Žibučių;3899526893;Taip;0;2;0;2
3484;Jurginėlis;Žibučių;3861311860;Taip;10;4;1;15
3485;Jurginėlis;Žibučių;1263601087;Taip;6;2;2;10
3486;Jurginėlis;Žibučių;5549766339;Taip;10;4;0;14
3487;Jurginėlis;Žibučių;4429780802;Taip;5;2;0;7
3488;Jurginėlis;Žibučių;8968718021;Taip;3;0;0;3
3489;Jurginėlis;Žibučių;9384422775;Ne;0;4;3;7
3490;Jurginėlis;Žibučių;6259461257;Taip;2;0;0;2
3491;Jurginėlis;Zuikučių;5958832413;Taip;0;1;0;1
3492;Jurginėlis;Zuikučių;4432849717;Taip;0;9;0;9
3493;Jurginėlis;Zuikučių;6587382160;Taip;5;0;5;10
3494;Jurginėlis;Zuikučių;8097652962;Taip;9;1;0;10
3495;Jurginėlis;Zuikučių;4763313715;Ne;11;0;0;11
3496;Jurginėlis;Zuikučių;6671759364;Taip;0;5;3;8
3497;Jurginėlis;Zuikučių;2820249307;Ne;0;0;1;1
3498;Jurginėlis;Zuikučių;8823175066;Taip;0;3;0;3
3499;Jurginėlis;Zuikučių;8161347781;Taip;0;12;0;12
3500;Jurginėlis;Zuikučių;7283697595;Taip;9;0;2;11
3501;Jurginėlis;Zuikučių;4113264904;Taip;4;0;2;6
3502;Jurginėlis;Zuikučių;8117563141;Taip;0;0;1;1
3503;Jurginėlis;Zuikučių;5652597514;Taip;0;13;0;13
3504;Jurginėlis;Zuikučių;6341896288;Taip;0;0;4;4
3505;Jurginėlis;Viščiukų;7193314762;Taip;10;0;0;10
3506;Jurginėlis;Viščiukų;6306274502;Ne;3;0;2;5
3507;Jurginėlis;Viščiukų;4506484183;Taip;13;3;0;16
3508;Jurginėlis;Viščiukų;3741447134;Taip;13;0;0;13
3509;Jurginėlis;Viščiukų;2595002682;Taip;6;0;1;7
3510;Jurginėlis;Viščiukų;5866358319;Taip;8;0;0;8
3511;Jurginėlis;Viščiukų;4648875524;Taip;10;0;0;10
3512;Jurginėlis;Viščiukų;1598578487;Taip;0;0;2;2
3513;Jurginėlis;Viščiukų;4644476606;Taip;11;0;0;11
3514;Jurginėlis;Viščiukų;3622183526;Taip;5;0;0;5
3515;Jurginėlis;Viščiukų;3230200231;Taip;0;1;0;1
3516;Jurginėlis;Viščiukų;7636442845;Taip;18;0;1;19
3517;Jurginėlis;Viščiukų;1286603999;Taip;11;0;1;12
3518;Jurginėlis;Viščiukų;4617952912;Taip;17;0;0;17
3519;Jurginėlis;Meškiukų;1303323955;Taip;9;0;0;9
3520;Jurginėlis;Meškiukų;4466955830;Taip;10;3;4;17
3521;Jurginėlis;Meškiukų;3675820817;Taip;0;23;0;23
3522;Jurginėlis;Meškiukų;5043815909;Taip;0;0;1;1
3523;Jurginėlis;Meškiukų;9901171406;Taip;5;0;1;6
3524;Jurginėlis;Meškiukų;2982526236;Taip;0;1;0;1
3525;Jurginėlis;Meškiukų;4233910766;Taip;7;0;0;7
3526;Jurginėlis;Meškiukų;6594025023;Taip;10;6;0;16
3527;Jurginėlis;Meškiukų;6648657850;Taip;17;1;0;18
3528;Jurginėlis;Meškiukų;6856023398;Taip;0;0;1;1
3529;Jurginėlis;Gandriukų;8017976529;Taip;9;2;0;11
3530;Jurginėlis;Gandriukų;3530906368;Ne;5;6;10;21
3531;Jurginėlis;Gandriukų;6806704355;Taip;16;6;0;22
3532;Jurginėlis;Gandriukų;9288380246;Taip;10;0;2;12
3533;Jurginėlis;Gandriukų;2548920722;Taip;4;4;3;11
3534;Jurginėlis;Gandriukų;7288921301;Taip;13;0;0;13
3535;Jurginėlis;Gandriukų;4827340942;Taip;10;2;2;14
3536;Jurginėlis;Gandriukų;4463258777;Taip;3;2;1;6
3537;Jurginėlis;Gandriukų;1414888906;Taip;4;0;7;11
3538;Jurginėlis;Gandriukų;2225892248;Taip;15;0;3;18
3539;Jurginėlis;Gandriukų;6579565337;Taip;0;1;0;1
3540;Jurginėlis;Gandriukų;7990015623;Taip;0;6;0;6
3541;Jurginėlis;Gandriukų;4158502752;Taip;0;8;0;8
3542;Jurginėlis;Gandriukų;2214809186;Taip;0;2;0;2
3543;Jurginėlis;Gandriukų;3284464951;Taip;20;4;0;24
3544;Jurginėlis;Gandriukų;2263818210;Taip;0;6;0;6
3545;Jurginėlis;Gandriukų;3091019969;Taip;14;0;0;14
3546;Jurginėlis;Gandriukų;2837099502;Taip;0;0;1;1
3547;Jurginėlis;Gandriukų;3462969423;Taip;12;0;2;14
3548;Jurginėlis;Gandriukų;7486778826;Taip;0;2;0;2
3549;Jurginėlis;Gandriukų;5242359650;Ne;0;15;0;15
3550;Jurginėlis;Gandriukų;8144038013;Taip;0;3;0;3
3551;Karusėlė;PAGRANDUKAS;1621482372;Taip;0;5;0;5
3552;Karusėlė;PAGRANDUKAS;3330374479;Taip;13;2;0;15
3553;Karusėlė;PAGRANDUKAS;6183785840;Taip;0;8;0;8
3554;Karusėlė;PAGRANDUKAS;3984262482;Taip;13;0;0;13
3555;Karusėlė;PAGRANDUKAS;9130534156;Taip;0;0;2;2
3556;Karusėlė;PAGRANDUKAS;3660843696;Taip;5;1;0;6
3557;Karusėlė;PAGRANDUKAS;5132581245;Taip;0;8;0;8
3558;Karusėlė;PAGRANDUKAS;2412418335;Taip;0;2;0;2
3559;Karusėlė;PAGRANDUKAS;7393434659;Taip;5;0;0;5
3560;Karusėlė;PAGRANDUKAS;5695697634;Taip;15;2;0;17
3561;Karusėlė;PAGRANDUKAS;7013765804;Taip;0;10;0;10
3562;Karusėlė;PAGRANDUKAS;3429495073;Taip;0;4;2;6
3563;Karusėlė;PAGRANDUKAS;6252613489;Taip;8;5;0;13
3564;Karusėlė;PAGRANDUKAS;5595950213;Taip;3;1;0;4
3565;Karusėlė;PAGRANDUKAS;6004882312;Taip;0;11;0;11
3566;Karusėlė;PAGRANDUKAS;6856800484;Taip;3;2;0;5
3567;Karusėlė;PAGRANDUKAS;5028265234;Ne;0;13;5;18
3568;Karusėlė;PAGRANDUKAS;3972815393;Taip;0;2;0;2
3569;Karusėlė;PAGRANDUKAS;8157193503;Ne;8;5;0;13
3570;Karusėlė;PAGRANDUKAS;8656806219;Taip;0;10;0;10
3571;Karusėlė;NYKŠTUKAS;4966362343;Taip;18;0;0;18
3572;Karusėlė;NYKŠTUKAS;9997776739;Taip;6;0;1;7
3573;Karusėlė;NYKŠTUKAS;4445214427;Taip;0;9;0;9
3574;Karusėlė;NYKŠTUKAS;5216815933;Taip;0;1;0;1
3575;Karusėlė;NYKŠTUKAS;7817417459;Taip;8;1;0;9
3576;Karusėlė;NYKŠTUKAS;6581798125;Taip;0;0;5;5
3577;Karusėlė;NYKŠTUKAS;1486577955;Ne;17;0;0;17
3578;Karusėlė;NYKŠTUKAS;5697305819;Ne;0;2;1;3
3579;Karusėlė;NYKŠTUKAS;8007341411;Taip;18;0;0;18
3580;Karusėlė;NYKŠTUKAS;4296509304;Taip;0;2;0;2
3581;Karusėlė;NYKŠTUKAS;9243932017;Taip;4;2;0;6
3582;Karusėlė;NYKŠTUKAS;5986973796;Taip;20;0;0;20
3583;Karusėlė;NYKŠTUKAS;4856589410;Taip;2;2;1;5
3584;Karusėlė;NYKŠTUKAS;9999461542;Taip;20;0;0;20
3585;Karusėlė;NYKŠTUKAS;9385698812;Taip;0;3;0;3
3586;Karusėlė;NYKŠTUKAS;5328762735;Taip;0;1;0;1
3587;Karusėlė;BITUTĖ;1593728369;Taip;10;5;0;15
3588;Karusėlė;BITUTĖ;6417699445;Taip;0;14;0;14
3589;Karusėlė;BITUTĖ;2426822679;Taip;0;9;0;9
3590;Karusėlė;BITUTĖ;1205498782;Taip;0;4;0;4
3591;Karusėlė;BITUTĖ;7824913364;Ne;15;3;0;18
3592;Karusėlė;BITUTĖ;5960946826;Taip;5;3;0;8
3593;Karusėlė;BITUTĖ;8175498192;Taip;9;0;5;14
3594;Karusėlė;BITUTĖ;5951045233;Taip;0;3;0;3
3595;Karusėlė;BITUTĖ;1487641646;Taip;0;8;0;8
3596;Karusėlė;BITUTĖ;2160071272;Taip;0;5;0;5
3597;Karusėlė;BITUTĖ;9418670930;Ne;8;4;8;20
3598;Karusėlė;BITUTĖ;7167895711;Taip;14;4;0;18
3599;Karusėlė;BITUTĖ;3116403256;Taip;0;4;0;4
3600;Karusėlė;BITUTĖ;7977133699;Taip;0;5;0;5
3601;Karusėlė;BITUTĖ;1204919995;Ne;7;3;4;14
3602;Karusėlė;BORUŽĖLĖ;1705790474;Taip;9;3;0;12
3603;Karusėlė;BORUŽĖLĖ;8608177987;Taip;5;2;0;7
3604;Karusėlė;BORUŽĖLĖ;1311907441;Ne;0;3;0;3
3605;Karusėlė;BORUŽĖLĖ;6313010762;Taip;5;2;1;8
3606;Karusėlė;BORUŽĖLĖ;5859827168;Taip;5;0;1;6
3607;Karusėlė;BORUŽĖLĖ;37349219339;Taip;7;8;0;15
3608;Karusėlė;BORUŽĖLĖ;6811862463;Taip;0;12;0;12
3609;Karusėlė;BORUŽĖLĖ;5471989295;Taip;15;0;0;15
3610;Karusėlė;BORUŽĖLĖ;9753876554;Taip;19;0;0;19
3611;Karusėlė;BORUŽĖLĖ;8717484092;Taip;0;5;0;5
3612;Karusėlė;BORUŽĖLĖ;1994682683;Taip;0;2;0;2
3613;Karusėlė;BORUŽĖLĖ;5632697184;Taip;6;3;2;11
3614;Karusėlė;BORUŽĖLĖ;2247913568;Taip;6;2;0;8
3615;Karusėlė;BORUŽĖLĖ;4262640017;Taip;10;1;0;11
3616;Karusėlė;BORUŽĖLĖ;4845558814;Ne;10;6;0;16
3617;Karusėlė;BORUŽĖLĖ;8406462155;Taip;0;2;0;2
3618;Karusėlė;BORUŽĖLĖ;6495631086;Taip;0;4;0;4
3619;Karusėlė;BORUŽĖLĖ;1183484176;Taip;4;1;0;5
3620;Karusėlė;BORUŽĖLĖ;2287979864;Taip;9;1;0;10
3621;Karusėlė;BORUŽĖLĖ;3389843421;Taip;10;3;0;13
3622;Karusėlė;BORUŽĖLĖ;9409462734;Ne;14;2;4;20
3623;Karusėlė;BORUŽĖLĖ;4818655110;Taip;8;0;0;8
3624;Karusėlė;UOGELĖ;8182071103;Taip;6;0;0;6
3625;Karusėlė;UOGELĖ;9992989896;Taip;0;6;0;6
3626;Karusėlė;UOGELĖ;2084276906;Ne;13;0;0;13
3627;Karusėlė;UOGELĖ;8665314366;Taip;5;6;0;11
3628;Karusėlė;UOGELĖ;4121668687;Taip;5;1;0;6
3629;Karusėlė;UOGELĖ;8316147204;Taip;0;3;0;3
3630;Karusėlė;UOGELĖ;5504719953;Taip;0;11;0;11
3631;Karusėlė;UOGELĖ;5919009583;Taip;20;3;0;23
3632;Karusėlė;UOGELĖ;4199597984;Taip;0;10;0;10
3633;Karusėlė;UOGELĖ;2383023280;Taip;10;7;0;17
3634;Karusėlė;UOGELĖ;1575408822;Taip;0;6;0;6
3635;Karusėlė;UOGELĖ;3917113787;Taip;5;1;0;6
3636;Karusėlė;UOGELĖ;4638918427;Taip;5;2;0;7
3637;Karusėlė;UOGELĖ;3615957761;Taip;0;15;0;15
3638;Karusėlė;UOGELĖ;3514026443;Taip;0;2;0;2
3639;Karusėlė;UOGELĖ;1891147022;Taip;0;0;4;4
3640;Karusėlė;UOGELĖ;9389017016;Taip;0;4;2;6
3641;Karusėlė;UOGELĖ;9683054409;Ne;0;3;3;6
3642;Karusėlė;UOGELĖ;3872322338;Ne;0;1;2;3
3643;Karusėlė;UOGELĖ;3963576314;Taip;0;1;9;10
3644;Karusėlė;GINTARĖLIS;3904453423;Taip;0;2;3;5
3645;Karusėlė;GINTARĖLIS;7489136297;Taip;0;3;2;5
3646;Karusėlė;GINTARĖLIS;3534074990;Taip;11;3;0;14
3647;Karusėlė;GINTARĖLIS;7540323186;Taip;8;0;3;11
3648;Karusėlė;GINTARĖLIS;1019322763;Taip;0;0;9;9
3649;Karusėlė;GINTARĖLIS;8481143199;Taip;18;0;0;18
3650;Karusėlė;GINTARĖLIS;3157893936;Taip;13;2;0;15
3651;Karusėlė;GINTARĖLIS;3136606610;Taip;0;10;8;18
3652;Karusėlė;GINTARĖLIS;7599328323;Taip;0;1;0;1
3653;Karusėlė;GINTARĖLIS;2688863117;Taip;0;5;0;5
3654;Karusėlė;GINTARĖLIS;7439791054;Taip;18;0;0;18
3655;Karusėlė;GINTARĖLIS;3696384277;Taip;13;0;2;15
3656;Karusėlė;GINTARĖLIS;2945027875;Taip;8;0;1;9
3657;Karusėlė;GINTARĖLIS;8855096080;Taip;0;1;0;1
3658;Karusėlė;GINTARĖLIS;8638720071;Taip;9;0;0;9
3659;Karusėlė;GINTARĖLIS;9116238924;Taip;11;0;0;11
3660;Karusėlė;GINTARĖLIS;6433987745;Ne;5;0;2;7
3661;Karusėlė;GINTARĖLIS;9763326660;Taip;0;0;1;1
3662;Karusėlė;GINTARĖLIS;9479962436;Taip;7;0;0;7
3663;Karusėlė;GINTARĖLIS;6232570825;Taip;8;0;1;9
3664;Karusėlė;SAULUTĖ;5627583683;Taip;9;2;0;11
3665;Karusėlė;SAULUTĖ;2242659064;Taip;0;2;4;6
3666;Karusėlė;SAULUTĖ;5146709341;Taip;0;4;0;4
3667;Karusėlė;SAULUTĖ;7814525717;Taip;0;1;0;1
3668;Karusėlė;SAULUTĖ;9996567374;Taip;0;4;0;4
3669;Karusėlė;SAULUTĖ;9400171357;Taip;10;0;0;10
3670;Karusėlė;SAULUTĖ;9656723409;Taip;9;0;2;11
3671;Karusėlė;SAULUTĖ;5766390337;Taip;3;10;0;13
3672;Karusėlė;SAULUTĖ;4879654321;Ne;0;12;0;12
3673;Karusėlė;SAULUTĖ;5803808409;Taip;0;1;0;1
3674;Karusėlė;SAULUTĖ;3149575456;Ne;5;0;0;5
3675;Karusėlė;SAULUTĖ;9451789237;Taip;3;1;5;9
3676;Karusėlė;SAULUTĖ;9450841251;Ne;3;0;5;8
3677;Karusėlė;SAULUTĖ;6338379641;Taip;8;0;0;8
3678;Karusėlė;SAULUTĖ;3082636224;Taip;1;0;5;6
3679;Karusėlė;SAULUTĖ;8830559511;Taip;7;0;4;11
3680;Karusėlė;SAULUTĖ;3228100488;Taip;17;0;0;17
3681;Karusėlė;TIGRIUKAS;8946147763;Taip;6;2;0;8
3682;Karusėlė;TIGRIUKAS;8076851284;Taip;6;0;0;6
3683;Karusėlė;TIGRIUKAS;4426462711;Taip;8;0;0;8
3684;Karusėlė;TIGRIUKAS;9484773068;Taip;13;0;0;13
3685;Karusėlė;TIGRIUKAS;8678437720;Taip;11;0;0;11
3686;Karusėlė;TIGRIUKAS;1698478530;Taip;6;5;0;11
3687;Karusėlė;TIGRIUKAS;9561892809;Taip;7;0;0;7
3688;Karusėlė;TIGRIUKAS;9726299722;Taip;0;4;0;4
3689;Karusėlė;TIGRIUKAS;1576201225;Taip;14;0;0;14
3690;Karusėlė;TIGRIUKAS;9344514262;Taip;16;0;0;16
3691;Karusėlė;TIGRIUKAS;9065247151;Taip;8;0;1;9
3692;Karusėlė;TIGRIUKAS;7131255599;Taip;13;3;0;16
3693;Karusėlė;TIGRIUKAS;4180604225;Taip;13;3;0;16
3694;Karusėlė;TIGRIUKAS;2397938004;Taip;2;0;0;2
3695;Karusėlė;TIGRIUKAS;3605966015;Taip;5;3;0;8
3696;Karusėlė;TIGRIUKAS;9633656827;Taip;0;1;0;1
3697;Karusėlė;TIGRIUKAS;9252093125;Taip;10;4;0;14
3698;Karusėlė;TIGRIUKAS;9736020767;Taip;10;0;0;10
3699;Karusėlė;TIGRIUKAS;5176597751;Taip;6;0;0;6
3700;Karusėlė;TIGRIUKAS;6656808100;Taip;5;1;0;6
3701;Karusėlė;VAIVORYKŠTĖ;1289442716;Taip;6;1;1;8
3702;Karusėlė;VAIVORYKŠTĖ;9855242602;Taip;0;1;0;1
3703;Karusėlė;VAIVORYKŠTĖ;6546648346;Taip;0;3;0;3
3704;Karusėlė;VAIVORYKŠTĖ;8063412271;Taip;10;4;0;14
3705;Karusėlė;VAIVORYKŠTĖ;9408843254;Taip;0;0;1;1
3706;Karusėlė;VAIVORYKŠTĖ;3514315636;Taip;11;0;0;11
3707;Karusėlė;VAIVORYKŠTĖ;8085919723;Taip;11;0;0;11
3708;Karusėlė;VAIVORYKŠTĖ;5444753290;Taip;0;11;0;11
3709;Karusėlė;VAIVORYKŠTĖ;1581504806;Taip;14;0;0;14
3710;Karusėlė;VAIVORYKŠTĖ;2215367063;Taip;0;4;0;4
3711;Karusėlė;VAIVORYKŠTĖ;6424622497;Taip;0;3;0;3
3712;Karusėlė;VAIVORYKŠTĖ;5128774216;Taip;0;10;0;10
3713;Karusėlė;VAIVORYKŠTĖ;1604997207;Ne;0;1;0;1
3714;Karusėlė;VAIVORYKŠTĖ;4110024673;Taip;0;8;0;8
3715;Karusėlė;VAIVORYKŠTĖ;6444553698;Ne;9;0;1;10
3716;Karusėlė;VAIVORYKŠTĖ;9400856559;Taip;0;11;0;11
3717;Karusėlė;VAIVORYKŠTĖ;1083786182;Taip;0;10;0;10
3718;Karusėlė;VAIVORYKŠTĖ;5998868204;Taip;0;1;0;1
3719;Karusėlė;VAIVORYKŠTĖ;6734936247;Taip;5;4;0;9
3720;Karusėlė;"AUKSINĖ ŽUVELĖ";2993499990;Taip;18;0;0;18
3721;Karusėlė;"AUKSINĖ ŽUVELĖ";5834070970;Taip;15;2;0;17
3722;Karusėlė;"AUKSINĖ ŽUVELĖ";8671884362;Taip;5;1;0;6
3723;Karusėlė;"AUKSINĖ ŽUVELĖ";6341570221;Taip;13;0;0;13
3724;Karusėlė;"AUKSINĖ ŽUVELĖ";2135332292;Taip;14;0;0;14
3725;Karusėlė;"AUKSINĖ ŽUVELĖ";9463553056;Taip;10;2;0;12
3726;Karusėlė;"AUKSINĖ ŽUVELĖ";4566201460;Taip;5;0;2;7
3727;Karusėlė;"AUKSINĖ ŽUVELĖ";3551143062;Taip;4;0;0;4
3728;Karusėlė;"AUKSINĖ ŽUVELĖ";8257771271;Taip;4;2;0;6
3729;Karusėlė;"AUKSINĖ ŽUVELĖ";7749015193;Taip;0;9;0;9
3730;Karusėlė;"AUKSINĖ ŽUVELĖ";1008205490;Taip;13;0;0;13
3731;Karusėlė;"AUKSINĖ ŽUVELĖ";3075592618;Taip;5;0;3;8
3732;Karusėlė;"AUKSINĖ ŽUVELĖ";2450390957;Taip;0;0;1;1
3733;Karusėlė;RAMUNĖ;3460470459;Taip;0;13;0;13
3734;Karusėlė;RAMUNĖ;4302662341;Taip;0;12;0;12
3735;Karusėlė;RAMUNĖ;9415377698;Taip;0;6;1;7
3736;Karusėlė;RAMUNĖ;8474027736;Taip;10;3;0;13
3737;Karusėlė;RAMUNĖ;9394220081;Taip;11;0;0;11
3738;Karusėlė;RAMUNĖ;7535451590;Taip;11;1;0;12
3739;Karusėlė;RAMUNĖ;4865727149;Taip;0;4;0;4
3740;Karusėlė;RAMUNĖ;2842034472;Taip;12;0;0;12
3741;Karusėlė;RAMUNĖ;8531556390;Taip;8;1;0;9
3742;Karusėlė;RAMUNĖ;8952114853;Ne;6;3;0;9
3743;Karusėlė;RAMUNĖ;4757820179;Taip;7;2;2;11
3744;Karusėlė;RAMUNĖ;7925395812;Taip;23;0;0;23
3745;Karusėlė;RAMUNĖ;7925395812;Taip;23;0;0;23
3746;Karusėlė;RAMUNĖ;7925395812;Taip;23;0;0;23
3747;Karusėlė;RAMUNĖ;9649615834;Taip;12;0;1;13
3748;Karusėlė;RAMUNĖ;3885475525;Taip;20;3;0;23
3749;Karusėlė;RAMUNĖ;6678283260;Taip;0;0;5;5
3750;Karusėlė;RAMUNĖ;4196250786;Ne;16;0;0;16
3751;Karusėlė;VILKELIS;1412890120;Taip;13;2;4;19
3752;Karusėlė;VILKELIS;4951249625;Taip;0;0;3;3
3753;Karusėlė;VILKELIS;5135054911;Taip;7;0;1;8
3754;Karusėlė;VILKELIS;4130693235;Taip;19;0;1;20
3755;Karusėlė;VILKELIS;8732156686;Taip;0;0;1;1
3756;Karusėlė;VILKELIS;8012963667;Taip;0;0;1;1
3757;Karusėlė;VILKELIS;9340167973;Taip;0;2;3;5
3758;Karusėlė;VILKELIS;9985033530;Taip;0;0;1;1
3759;Karusėlė;VILKELIS;6826455161;Taip;0;2;3;5
3760;Karusėlė;VILKELIS;4211688032;Taip;8;0;3;11
3761;Karusėlė;VILKELIS;2727440190;Taip;5;0;2;7
3762;Karusėlė;VILKELIS;9304912028;Ne;0;0;1;1
3763;Karusėlė;VILKELIS;5802996641;Ne;2;0;2;4
3764;Karusėlė;VILKELIS;2306922755;Taip;0;3;0;3
3765;Karusėlė;VILKELIS;3049506194;Taip;5;0;2;7
3766;Karusėlė;VILKELIS;4103816990;Taip;0;0;2;2
3767;Karusėlė;VILKELIS;4325959483;Taip;0;0;8;8
3768;Karusėlė;VILKELIS;3271464159;Ne;0;0;2;2
3769;Karusėlė;VILKELIS;6062361348;Ne;0;5;0;5
3770;Karusėlė;VILKELIS;7501323454;Taip;0;0;4;4
3771;Karusėlė;VILKELIS;3968719760;Taip;0;2;0;2
3772;Kaštonas;NYKŠTUKAI;7703842464;Taip;17;0;0;17
3773;Kaštonas;NYKŠTUKAI;1262404954;Taip;10;0;0;10
3774;Kaštonas;NYKŠTUKAI;6254250706;Taip;10;0;0;10
3775;Kaštonas;NYKŠTUKAI;8775608339;Taip;0;5;0;5
3776;Kaštonas;NYKŠTUKAI;6613837801;Ne;0;7;1;8
3777;Kaštonas;NYKŠTUKAI;6934262510;Taip;0;8;0;8
3778;Kaštonas;NYKŠTUKAI;6589898580;Taip;5;1;0;6
3779;Kaštonas;NYKŠTUKAI;4824511567;Ne;13;1;0;14
3780;Kaštonas;NYKŠTUKAI;4384907654;Taip;5;3;0;8
3781;Kaštonas;NYKŠTUKAI;3961661158;Taip;0;14;0;14
3782;Kaštonas;NYKŠTUKAI;8318869054;Taip;10;3;0;13
3783;Kaštonas;NYKŠTUKAI;2434765663;Ne;0;4;0;4
3784;Kaštonas;NYKŠTUKAI;2178971789;Taip;13;0;0;13
3785;Kaštonas;NYKŠTUKAI;4444087861;Taip;10;0;0;10
3786;Kaštonas;NYKŠTUKAI;9379171183;Taip;2;2;0;4
3787;Kaštonas;NYKŠTUKAI;9014726465;Taip;11;0;0;11
3788;Kaštonas;NYKŠTUKAI;2361839733;Taip;8;2;0;10
3789;Kaštonas;NYKŠTUKAI;3383390078;Taip;3;7;0;10
3790;Kaštonas;DRUGELIAI;8486955652;Taip;13;3;0;16
3791;Kaštonas;DRUGELIAI;2106924435;Taip;0;5;0;5
3792;Kaštonas;DRUGELIAI;8483888152;Taip;5;7;0;12
3793;Kaštonas;DRUGELIAI;3059036526;Taip;10;0;0;10
3794;Kaštonas;DRUGELIAI;2165890763;Taip;17;0;0;17
3795;Kaštonas;DRUGELIAI;7408901858;Taip;1;6;0;7
3796;Kaštonas;DRUGELIAI;8582453109;Taip;1;7;0;8
3797;Kaštonas;DRUGELIAI;2832688622;Ne;0;5;0;5
3798;Kaštonas;DRUGELIAI;9061158412;Ne;4;3;0;7
3799;Kaštonas;DRUGELIAI;9168456496;Taip;0;10;0;10
3800;Kaštonas;DRUGELIAI;5884427036;Taip;0;8;0;8
3801;Kaštonas;DRUGELIAI;1141693073;Taip;0;2;0;2
3802;Kaštonas;DRUGELIAI;6251564828;Taip;0;1;0;1
3803;Kaštonas;DRUGELIAI;1249299633;Taip;0;3;0;3
3804;Kaštonas;DRUGELIAI;5969052108;Taip;6;0;0;6
3805;Kaštonas;DRUGELIAI;8166925991;Taip;16;5;0;21
3806;Kaštonas;DRUGELIAI;4215759647;Taip;4;1;0;5
3807;Kaštonas;DRUGELIAI;5307755844;Taip;0;12;0;12
3808;Kaštonas;DRUGELIAI;9985164505;Taip;10;3;0;13
3809;Kaštonas;DRUGELIAI;2417951642;Taip;0;3;0;3
3810;Kaštonas;DRUGELIAI;8257643251;Taip;16;0;0;16
3811;Kaštonas;KIŠKUČIAI;2020612346;Taip;0;5;0;5
3812;Kaštonas;KIŠKUČIAI;6585977073;Taip;15;3;0;18
3813;Kaštonas;KIŠKUČIAI;1761520786;Taip;9;0;0;9
3814;Kaštonas;KIŠKUČIAI;9298372326;Ne;0;2;0;2
3815;Kaštonas;KIŠKUČIAI;9778140363;Ne;0;9;0;9
3816;Kaštonas;KIŠKUČIAI;8250964197;Taip;0;9;0;9
3817;Kaštonas;KIŠKUČIAI;7290414209;Taip;0;15;0;15
3818;Kaštonas;KIŠKUČIAI;9356018629;Taip;7;0;0;7
3819;Kaštonas;KIŠKUČIAI;4115242811;Taip;0;4;0;4
3820;Kaštonas;KIŠKUČIAI;1684641447;Taip;15;0;0;15
3821;Kaštonas;KIŠKUČIAI;1207372235;Ne;0;6;0;6
3822;Kaštonas;KIŠKUČIAI;4570064071;Taip;15;0;0;15
3823;Kaštonas;KIŠKUČIAI;4020980625;Taip;0;1;0;1
3824;Kaštonas;KIŠKUČIAI;2898327157;Taip;11;0;0;11
3825;Kaštonas;KIŠKUČIAI;9320223622;Taip;0;10;0;10
3826;Kaštonas;KIŠKUČIAI;3544696101;Taip;10;5;0;15
3827;Kaštonas;KIŠKUČIAI;8014645421;Taip;0;2;0;2
3828;Kaštonas;KIŠKUČIAI;9079078455;Taip;0;2;0;2
3829;Kaštonas;BITUTĖS;7946379086;Taip;6;0;0;6
3830;Kaštonas;BITUTĖS;9285927858;Taip;5;11;0;16
3831;Kaštonas;BITUTĖS;5328263421;Taip;2;0;0;2
3832;Kaštonas;BITUTĖS;9903176616;Taip;7;0;0;7
3833;Kaštonas;BITUTĖS;1747580231;Ne;0;14;0;14
3834;Kaštonas;BITUTĖS;4033866425;Taip;0;6;0;6
3835;Kaštonas;BITUTĖS;4061364544;Taip;3;4;0;7
3836;Kaštonas;BITUTĖS;8275673303;Taip;0;3;0;3
3837;Kaštonas;BITUTĖS;1614180834;Taip;0;0;4;4
3838;Kaštonas;BITUTĖS;6711295699;Taip;10;1;0;11
3839;Kaštonas;BITUTĖS;2877124424;Taip;0;8;0;8
3840;Kaštonas;BITUTĖS;1031628633;Taip;8;5;0;13
3841;Kaštonas;BITUTĖS;4551111709;Taip;8;5;0;13
3842;Kaštonas;BITUTĖS;7508357392;Taip;8;3;0;11
3843;Kaštonas;BITUTĖS;8906976150;Taip;5;5;0;10
3844;Kaštonas;BITUTĖS;8151333699;Taip;0;1;0;1
3845;Kaštonas;BITUTĖS;3649329598;Taip;0;11;0;11
3846;Kaštonas;BITUTĖS;8214699601;Taip;0;3;0;3
3847;Kaštonas;BITUTĖS;8152577445;Taip;0;3;0;3
3848;Kaštonas;BITUTĖS;7291448857;Taip;5;3;0;8
3849;Kaštonas;BITUTĖS;4837002666;Ne;10;0;0;10
3850;Kaštonas;BITUTĖS;2701042709;Taip;5;11;0;16
3851;Kaštonas;BITUTĖS;6175014441;Taip;5;0;0;5
3852;Kaštonas;BITUTĖS;1748975865;Taip;0;2;0;2
3853;Kaštonas;MEŠKIUKAI;5607474492;Taip;5;8;0;13
3854;Kaštonas;MEŠKIUKAI;5350239917;Taip;0;0;1;1
3855;Kaštonas;MEŠKIUKAI;7956422880;Taip;2;11;0;13
3856;Kaštonas;MEŠKIUKAI;3554337770;Taip;0;1;0;1
3857;Kaštonas;MEŠKIUKAI;7911007041;Taip;0;15;0;15
3858;Kaštonas;MEŠKIUKAI;2125410714;Taip;0;7;0;7
3859;Kaštonas;MEŠKIUKAI;6289073634;Taip;3;7;0;10
3860;Kaštonas;MEŠKIUKAI;7553024183;Taip;7;3;0;10
3861;Kaštonas;MEŠKIUKAI;4616084852;Taip;0;11;0;11
3862;Kaštonas;MEŠKIUKAI;1801371129;Taip;17;0;0;17
3863;Kaštonas;MEŠKIUKAI;5157500600;Ne;2;0;0;2
3864;Kaštonas;MEŠKIUKAI;1364391105;Taip;7;1;0;8
3865;Kaštonas;MEŠKIUKAI;6967725663;Taip;0;13;0;13
3866;Kaštonas;MEŠKIUKAI;5153948802;Ne;10;9;0;19
3867;Kaštonas;MEŠKIUKAI;4308169582;Ne;8;3;2;13
3868;Kaštonas;MEŠKIUKAI;8797584508;Taip;9;0;0;9
3869;Kaštonas;MEŠKIUKAI;9965517774;Taip;0;7;0;7
3870;Kaštonas;MEŠKIUKAI;7138581709;Taip;0;7;0;7
3871;Kaštonas;MEŠKIUKAI;8446233414;Taip;5;3;0;8
3872;Kaštonas;MEŠKIUKAI;1196590128;Taip;0;3;0;3
3873;Kaštonas;BORUŽĖLĖS;1501441973;Ne;6;2;0;8
3874;Kaštonas;BORUŽĖLĖS;1612086010;Taip;6;0;0;6
3875;Kaštonas;BORUŽĖLĖS;9034859988;Taip;7;1;0;8
3876;Kaštonas;BORUŽĖLĖS;9249007247;Taip;3;20;0;23
3877;Kaštonas;BORUŽĖLĖS;2057499534;Taip;4;0;0;4
3878;Kaštonas;BORUŽĖLĖS;6896372095;Taip;4;3;0;7
3879;Kaštonas;BORUŽĖLĖS;9807554365;Taip;2;0;0;2
3880;Kaštonas;BORUŽĖLĖS;4708114402;Taip;1;0;0;1
3881;Kaštonas;BORUŽĖLĖS;4641535612;Taip;2;11;0;13
3882;Kaštonas;BORUŽĖLĖS;7383219978;Taip;6;4;0;10
3883;Kaštonas;BORUŽĖLĖS;3251132542;Taip;2;6;0;8
3884;Kaštonas;BORUŽĖLĖS;6425908247;Taip;12;0;0;12
3885;Kaštonas;BORUŽĖLĖS;3860613494;Taip;8;2;0;10
3886;Kaštonas;BORUŽĖLĖS;9317649996;Ne;4;5;0;9
3887;Kaštonas;BORUŽĖLĖS;5948707303;Ne;0;0;4;4
3888;Kaštonas;BORUŽĖLĖS;7698074598;Taip;3;6;0;9
3889;Kaštonas;BORUŽĖLĖS;6749679348;Taip;5;2;0;7
3890;Krivūlė;SPINDULIUKAI;3233000497;Taip;3;0;5;8
3891;Krivūlė;SPINDULIUKAI;2191720088;Taip;3;0;5;8
3892;Krivūlė;SPINDULIUKAI;9865192795;Taip;0;0;1;1
3893;Krivūlė;SPINDULIUKAI;3913058095;Taip;0;0;3;3
3894;Krivūlė;SPINDULIUKAI;1840809151;Taip;6;10;0;16
3895;Krivūlė;SPINDULIUKAI;5057452653;Taip;0;2;3;5
3896;Krivūlė;SPINDULIUKAI;7335245963;Taip;3;0;3;6
3897;Krivūlė;SPINDULIUKAI;5802739148;Taip;0;0;3;3
3898;Krivūlė;SPINDULIUKAI;5667934115;Taip;2;3;0;5
3899;Krivūlė;SPINDULIUKAI;7155162698;Taip;2;0;5;7
3900;Krivūlė;SPINDULIUKAI;9320613086;Taip;17;0;1;18
3901;Krivūlė;SPINDULIUKAI;6632875947;Taip;7;0;0;7
3902;Krivūlė;SPINDULIUKAI;4750075323;Taip;3;0;1;4
3903;Krivūlė;SPINDULIUKAI;3852793979;Taip;10;1;0;11
3904;Krivūlė;SPINDULIUKAI;3184820008;Taip;0;0;6;6
3905;Krivūlė;SPINDULIUKAI;7149268223;Taip;5;7;8;20
3906;Krivūlė;BORUŽĖLĖS;3605506478;Taip;7;0;1;8
3907;Krivūlė;BORUŽĖLĖS;4896656209;Taip;7;0;1;8
3908;Krivūlė;BORUŽĖLĖS;4845515196;Taip;5;1;0;6
3909;Krivūlė;BORUŽĖLĖS;6935969502;Taip;3;0;0;3
3910;Krivūlė;BORUŽĖLĖS;4972360440;Taip;8;0;0;8
3911;Krivūlė;BORUŽĖLĖS;7318064702;Taip;4;6;2;12
3912;Krivūlė;BORUŽĖLĖS;3912620138;Taip;9;0;3;12
3913;Krivūlė;BORUŽĖLĖS;2386053480;Taip;8;0;2;10
3914;Krivūlė;BORUŽĖLĖS;8586287004;Taip;2;0;0;2
3915;Krivūlė;BORUŽĖLĖS;4540069843;Ne;14;0;1;15
3916;Krivūlė;BORUŽĖLĖS;4297876008;Taip;0;0;5;5
3917;Krivūlė;BORUŽĖLĖS;2138125571;Taip;0;2;1;3
3918;Krivūlė;BORUŽĖLĖS;4177660973;Taip;0;11;0;11
3919;Krivūlė;BORUŽĖLĖS;2711010212;Taip;18;1;0;19
3920;Krivūlė;BORUŽĖLĖS;4025821636;Taip;11;0;0;11
3921;Krivūlė;BORUŽĖLĖS;7781918674;Taip;7;1;0;8
3922;Krivūlė;BORUŽĖLĖS;1987255206;Taip;0;10;0;10
3923;Krivūlė;BORUŽĖLĖS;7025398689;Taip;15;0;2;17
3924;Krivūlė;BORUŽĖLĖS;9306686488;Taip;0;10;0;10
3925;Krivūlė;DRUGELIŲ;5966543639;Taip;0;0;4;4
3926;Krivūlė;DRUGELIŲ;6004925249;Taip;0;0;4;4
3927;Krivūlė;DRUGELIŲ;5818988913;Taip;0;3;0;3
3928;Krivūlė;DRUGELIŲ;7873123757;Taip;0;6;1;7
3929;Krivūlė;DRUGELIŲ;19674882649;Taip;0;4;0;4
3930;Krivūlė;DRUGELIŲ;10005041572;Taip;0;2;0;2
3931;Krivūlė;DRUGELIŲ;2654066358;Taip;8;0;3;11
3932;Krivūlė;DRUGELIŲ;2109315338;Taip;0;0;6;6
3933;Krivūlė;DRUGELIŲ;6861483854;Taip;7;0;4;11
3934;Krivūlė;DRUGELIŲ;1515185307;Taip;0;1;0;1
3935;Krivūlė;DRUGELIŲ;9267414141;Taip;0;0;4;4
3936;Krivūlė;DRUGELIŲ;73760357378;Taip;0;3;0;3
3937;Krivūlė;DRUGELIŲ;6753080815;Taip;10;2;0;12
3938;Krivūlė;DRUGELIŲ;4261133734;Taip;0;0;3;3
3939;Krivūlė;DRUGELIŲ;6429160371;Taip;0;0;4;4
3940;Krivūlė;DRUGELIŲ;3924127476;Taip;0;7;0;7
3941;Krivūlė;"BITUTĖS (VALDOFRO)";18486357195;Taip;5;0;3;8
3942;Krivūlė;"BITUTĖS (VALDOFRO)";3769812444;Taip;0;1;0;1
3943;Krivūlė;"BITUTĖS (VALDOFRO)";5128760019;Taip;0;1;0;1
3944;Krivūlė;"BITUTĖS (VALDOFRO)";1851097789;Taip;2;0;1;3
3945;Krivūlė;"BITUTĖS (VALDOFRO)";2647149927;Taip;0;1;0;1
3946;Krivūlė;"BITUTĖS (VALDOFRO)";5113297248;Taip;0;3;4;7
3947;Krivūlė;"BITUTĖS (VALDOFRO)";9632352765;Taip;0;1;0;1
3948;Krivūlė;"BITUTĖS (VALDOFRO)";7848471009;Ne;0;0;2;2
3949;Krivūlė;"BITUTĖS (VALDOFRO)";5405660104;Taip;0;3;8;11
3950;Krivūlė;"BITUTĖS (VALDOFRO)";8834855616;Taip;0;3;0;3
3951;Krivūlė;"BITUTĖS (VALDOFRO)";3655576855;Taip;0;3;0;3
3952;Krivūlė;"BITUTĖS (VALDOFRO)";1561180871;Taip;0;11;0;11
3953;Krivūlė;"BITUTĖS (VALDOFRO)";9702372816;Taip;3;0;1;4
3954;Krivūlė;"BITUTĖS (VALDOFRO)";4619224314;Taip;15;2;2;19
3955;Krivūlė;"BITUTĖS (VALDOFRO)";8105688948;Ne;10;0;3;13
3956;Krivūlė;"BITUTĖS (VALDOFRO)";1932209134;Taip;0;0;3;3
3957;Krivūlė;"BITUTĖS (VALDOFRO)";7768827505;Taip;0;2;1;3
3958;Krivūlė;"BITUTĖS (VALDOFRO)";7714519095;Taip;6;0;1;7
3959;Krivūlė;"BITUTĖS (VALDOFRO)";9409899522;Taip;0;0;1;1
3960;Krivūlė;"BITUTĖS (VALDOFRO)";6365743037;Taip;0;3;5;8
3961;Krivūlė;"BITUTĖS (VALDOFRO)";6217494808;Taip;0;3;2;5
3962;Krivūlė;"BITUTĖS (VALDOFRO)";8748668583;Ne;5;0;0;5
3963;Krivūlė;EŽIUKAI;8042185027;Taip;10;0;1;11
3964;Krivūlė;EŽIUKAI;1256819206;Taip;0;0;16;16
3965;Krivūlė;EŽIUKAI;7242596817;Ne;0;0;7;7
3966;Krivūlė;EŽIUKAI;5664892835;Taip;15;0;0;15
3967;Krivūlė;EŽIUKAI;8399607572;Taip;15;0;0;15
3968;Krivūlė;EŽIUKAI;5369083173;Taip;10;0;4;14
3969;Krivūlė;EŽIUKAI;9051038248;Taip;12;0;0;12
3970;Krivūlė;EŽIUKAI;3144577262;Taip;5;0;3;8
3971;Krivūlė;EŽIUKAI;1898389557;Taip;5;0;2;7
3972;Krivūlė;EŽIUKAI;2607716072;Taip;0;0;1;1
3973;Krivūlė;EŽIUKAI;6830712749;Ne;0;0;3;3
3974;Krivūlė;EŽIUKAI;1574886918;Taip;0;0;6;6
3975;Krivūlė;EŽIUKAI;3836712448;Taip;0;0;1;1
3976;Krivūlė;EŽIUKAI;8873132189;Taip;0;0;6;6
3977;Krivūlė;EŽIUKAI;2430372719;Taip;7;3;0;10
3978;Krivūlė;NYKŠTUKAI;9820383193;Taip;0;2;0;2
3979;Krivūlė;NYKŠTUKAI;2742783991;Taip;0;23;0;23
3980;Krivūlė;NYKŠTUKAI;9401810791;Taip;14;0;1;15
3981;Krivūlė;NYKŠTUKAI;8713384668;Taip;23;0;0;23
3982;Krivūlė;NYKŠTUKAI;9678890051;Taip;0;1;0;1
3983;Krivūlė;NYKŠTUKAI;9553953446;Taip;0;0;4;4
3984;Krivūlė;NYKŠTUKAI;5268832682;Taip;6;3;0;9
3985;Krivūlė;NYKŠTUKAI;8767554721;Taip;6;0;0;6
3986;Krivūlė;NYKŠTUKAI;9529242858;Taip;5;0;2;7
3987;Krivūlė;NYKŠTUKAI;8898023612;Taip;3;0;0;3
3988;Krivūlė;NYKŠTUKAI;5768244312;Taip;1;1;0;2
3989;Krivūlė;NYKŠTUKAI;5870153336;Taip;3;3;3;9
3990;Krivūlė;NYKŠTUKAI;7540940063;Taip;0;3;0;3
3991;Krivūlė;NYKŠTUKAI;7262017017;Taip;7;0;0;7
3992;Krivūlė;NYKŠTUKAI;9773092651;Taip;0;0;3;3
3993;Krivūlė;NYKŠTUKAI;6548893885;Taip;5;0;11;16
3994;Krivūlė;NYKŠTUKAI;8674468359;Taip;0;23;0;23
3995;Krivūlė;"PABIRUČIŲ (Vokiečių g. 1)";1944288576;Taip;2;0;0;2
3996;Krivūlė;"PABIRUČIŲ (Vokiečių g. 1)";9011102232;Taip;0;0;2;2
3997;Krivūlė;"PABIRUČIŲ (Vokiečių g. 1)";5535822704;Taip;0;23;0;23
3998;Krivūlė;"PABIRUČIŲ (Vokiečių g. 1)";3696403149;Ne;0;23;0;23
3999;Krivūlė;"PABIRUČIŲ (Vokiečių g. 1)";4600688626;Taip;0;0;5;5
4000;Krivūlė;"PABIRUČIŲ (Vokiečių g. 1)";4608957977;Taip;5;0;1;6
4001;Krivūlė;"PABIRUČIŲ (Vokiečių g. 1)";4884789671;Taip;12;0;0;12
4002;Krivūlė;"PABIRUČIŲ (Vokiečių g. 1)";8678565710;Taip;0;0;4;4
4003;Krivūlė;"PABIRUČIŲ (Vokiečių g. 1)";9401191578;Taip;2;0;0;2
4004;Krivūlė;"PABIRUČIŲ (Vokiečių g. 1)";2259139771;Taip;8;0;3;11
4005;Krivūlė;"PABIRUČIŲ (Vokiečių g. 1)";3138555448;Taip;8;3;9;20
4006;Krivūlė;"PABIRUČIŲ (Vokiečių g. 1)";2784118970;Taip;0;0;9;9
4007;Krivūlė;"PABIRUČIŲ (Vokiečių g. 1)";3227555647;Taip;0;0;10;10
4008;Krivūlė;"PABIRUČIŲ (Vokiečių g. 1)";4261770381;Taip;18;0;0;18
4009;Krivūlė;"SMALSUČIŲ (Vokiečių g.1)";5304221329;Taip;5;0;1;6
4010;Krivūlė;"SMALSUČIŲ (Vokiečių g.1)";7508079584;Taip;0;0;1;1
4011;Krivūlė;"SMALSUČIŲ (Vokiečių g.1)";5199600243;Taip;0;0;1;1
4012;Krivūlė;"SMALSUČIŲ (Vokiečių g.1)";3076382863;Taip;0;2;0;2
4013;Krivūlė;"SMALSUČIŲ (Vokiečių g.1)";7997564406;Taip;0;3;0;3
4014;Krivūlė;"SMALSUČIŲ (Vokiečių g.1)";8710938907;Taip;8;0;5;13
4015;Krivūlė;"SMALSUČIŲ (Vokiečių g.1)";4491462086;Ne;13;0;0;13
4016;Krivūlė;"SMALSUČIŲ (Vokiečių g.1)";4773564048;Taip;3;1;0;4
4017;Krivūlė;"SMALSUČIŲ (Vokiečių g.1)";9229817861;Ne;0;0;5;5
4018;Krivūlė;"SMALSUČIŲ (Vokiečių g.1)";8042469720;Taip;0;12;0;12
4019;Krivūlė;"SMALSUČIŲ (Vokiečių g.1)";4845066055;Taip;9;0;9;18
4020;Krivūlė;"SMALSUČIŲ (Vokiečių g.1)";9328365491;Taip;5;0;1;6
4021;Krivūlė;"SMALSUČIŲ (Vokiečių g.1)";1815336153;Taip;0;1;0;1
4022;Krivūlė;"SMALSUČIŲ (Vokiečių g.1)";7528273082;Taip;0;0;6;6
4023;Krivūlė;"SMALSUČIŲ (Vokiečių g.1)";6521798502;Taip;0;0;5;5
4024;Krivūlė;"SMALSUČIŲ (Vokiečių g.1)";5790418638;Taip;0;0;1;1
4025;Krivūlė;"GUDRUČIŲ (Vokiečių g. 1)";8520470321;Taip;0;0;2;2
4026;Krivūlė;"GUDRUČIŲ (Vokiečių g. 1)";4681543921;Taip;0;0;1;1
4027;Krivūlė;"GUDRUČIŲ (Vokiečių g. 1)";5753204752;Taip;0;0;4;4
4028;Krivūlė;"GUDRUČIŲ (Vokiečių g. 1)";2536472220;Taip;0;5;0;5
4029;Krivūlė;"GUDRUČIŲ (Vokiečių g. 1)";1622495013;Taip;0;1;7;8
4030;Krivūlė;"GUDRUČIŲ (Vokiečių g. 1)";7436569684;Taip;0;0;3;3
4031;Krivūlė;"GUDRUČIŲ (Vokiečių g. 1)";7727246187;Taip;0;4;1;5
4032;Krivūlė;"GUDRUČIŲ (Vokiečių g. 1)";5652936425;Taip;2;0;0;2
4033;Krivūlė;"GUDRUČIŲ (Vokiečių g. 1)";6072261879;Taip;0;8;4;12
4034;Krivūlė;"GUDRUČIŲ (Vokiečių g. 1)";7904390075;Taip;0;5;0;5
4035;Krivūlė;"GUDRUČIŲ (Vokiečių g. 1)";6931566125;Taip;5;0;0;5
4036;Krivūlė;"GUDRUČIŲ (Vokiečių g. 1)";5149419581;Taip;0;0;6;6
4037;Krivūlė;"GUDRUČIŲ (Vokiečių g. 1)";7789605738;Taip;0;0;9;9
4038;Krivūlė;"GUDRUČIŲ (Vokiečių g. 1)";5097101097;Taip;0;3;0;3
4039;Krivūlė;"GUDRUČIŲ (Vokiečių g. 1)";9693693101;Ne;13;0;2;15
4040;Krivūlė;"GUDRUČIŲ (Vokiečių g. 1)";5462491857;Taip;0;5;3;8
4041;Krivūlė;"GUDRUČIŲ (Vokiečių g. 1)";5182563483;Taip;0;1;2;3
4042;Krivūlė;"GUDRUČIŲ (Vokiečių g. 1)";8871794542;Ne;6;3;10;19
4043;Kodėlčiukas;Saulutės;1725624698;Taip;7;2;0;9
4044;Kodėlčiukas;Saulutės;8393893311;Taip;0;1;2;3
4045;Kodėlčiukas;Saulutės;7509476161;Taip;0;4;0;4
4046;Kodėlčiukas;Saulutės;7327247516;Ne;6;0;1;7
4047;Kodėlčiukas;Saulutės;1645680526;Taip;0;1;1;2
4048;Kodėlčiukas;Saulutės;8992265000;Taip;9;0;0;9
4049;Kodėlčiukas;Saulutės;6285018663;Taip;0;1;0;1
4050;Kodėlčiukas;Saulutės;1033969800;Taip;5;2;0;7
4051;Kodėlčiukas;Saulutės;2433094435;Ne;13;0;0;13
4052;Kodėlčiukas;Saulutės;9042404309;Taip;0;3;0;3
4053;Kodėlčiukas;Saulutės;9476376350;Ne;0;9;0;9
4054;Kodėlčiukas;Saulutės;7611485881;Taip;4;1;0;5
4055;Kodėlčiukas;Saulutės;7561763602;Taip;16;0;1;17
4056;Kodėlčiukas;Saulutės;2289687766;Taip;0;0;1;1
4057;Kodėlčiukas;Saulutės;6476445296;Taip;4;0;0;4
4058;Kodėlčiukas;Saulutės;1992569595;Ne;17;0;0;17
4059;Kodėlčiukas;Saulutės;9527296531;Ne;0;0;13;13
4060;Kodėlčiukas;Saulutės;8070400563;Taip;5;1;0;6
4061;Kodėlčiukas;Saulutės;8447045958;Taip;0;0;2;2
4062;Kodėlčiukas;Saulutės;2542104903;Taip;0;0;9;9
4063;Kodėlčiukas;Nežiniukai;6045564826;Taip;1;1;0;2
4064;Kodėlčiukas;Nežiniukai;7136890681;Taip;8;0;1;9
4065;Kodėlčiukas;Nežiniukai;7971932716;Taip;0;0;2;2
4066;Kodėlčiukas;Nežiniukai;7282579315;Taip;4;0;1;5
4067;Kodėlčiukas;Nežiniukai;6905424567;Taip;6;0;1;7
4068;Kodėlčiukas;Nežiniukai;5443377251;Ne;0;3;0;3
4069;Kodėlčiukas;Nežiniukai;7626940433;Taip;0;6;0;6
4070;Kodėlčiukas;Nežiniukai;9803206596;Taip;10;0;0;10
4071;Kodėlčiukas;Nežiniukai;4917910801;Ne;1;3;0;4
4072;Kodėlčiukas;Nežiniukai;3473981974;Taip;0;0;4;4
4073;Kodėlčiukas;Nežiniukai;4038168647;Taip;0;2;3;5
4074;Kodėlčiukas;Nežiniukai;8378295683;Taip;6;0;7;13
4075;Kodėlčiukas;Nežiniukai;6000831611;Taip;4;3;0;7
4076;Kodėlčiukas;Nežiniukai;7286497455;Taip;10;0;0;10
4077;Kodėlčiukas;Nežiniukai;1603752483;Taip;0;0;2;2
4078;Kodėlčiukas;Nežiniukai;6074758814;Ne;0;10;0;10
4079;Kodėlčiukas;Nežiniukai;1699358514;Ne;0;2;0;2
4080;Kodėlčiukas;Nežiniukai;1302383608;Taip;5;0;6;11
4081;Kodėlčiukas;Nežiniukai;1160612316;Taip;5;0;6;11
4082;Kodėlčiukas;Nežiniukai;5729391456;Taip;6;2;6;14
4083;Kodėlčiukas;Gintarėliai;2560864315;Taip;0;0;2;2
4084;Kodėlčiukas;Gintarėliai;58406224468;Taip;0;3;2;5
4085;Kodėlčiukas;Gintarėliai;9686497547;Taip;0;0;1;1
4086;Kodėlčiukas;Gintarėliai;4884104023;Taip;0;0;5;5
4087;Kodėlčiukas;Gintarėliai;9332136116;Taip;0;3;0;3
4088;Kodėlčiukas;Gintarėliai;4944791330;Taip;2;1;1;4
4089;Kodėlčiukas;Gintarėliai;8219424737;Taip;0;3;1;4
4090;Kodėlčiukas;Gintarėliai;4849314647;Taip;0;0;1;1
4091;Kodėlčiukas;Gintarėliai;5202375085;Taip;4;0;1;5
4092;Kodėlčiukas;Gintarėliai;3758606327;Taip;0;0;1;1
4093;Kodėlčiukas;Gintarėliai;5093139270;Ne;0;0;1;1
4094;Kodėlčiukas;Gintarėliai;8873629130;Taip;5;0;0;5
4095;Kodėlčiukas;Gintarėliai;1190408818;Taip;0;3;18;21
4096;Kodėlčiukas;Gintarėliai;2162480212;Taip;0;8;1;9
4097;Kodėlčiukas;Gintarėliai;6764015170;Taip;4;1;0;5
4098;Kodėlčiukas;Gintarėliai;8606551477;Taip;0;0;10;10
4099;Kodėlčiukas;Šnekučiai;1844016431;Taip;0;5;0;5
4100;Kodėlčiukas;Šnekučiai;1550915654;Taip;0;9;0;9
4101;Kodėlčiukas;Šnekučiai;41123326737;Taip;0;3;0;3
4102;Kodėlčiukas;Šnekučiai;8114859362;Taip;6;16;0;22
4103;Kodėlčiukas;Šnekučiai;1666743304;Taip;5;0;2;7
4104;Kodėlčiukas;Šnekučiai;1432342305;Taip;0;1;2;3
4105;Kodėlčiukas;Šnekučiai;9178209049;Ne;0;2;2;4
4106;Kodėlčiukas;Šnekučiai;5988863934;Taip;0;3;0;3
4107;Kodėlčiukas;Šnekučiai;76164689333;Taip;0;3;1;4
4108;Kodėlčiukas;Šnekučiai;5386820408;Taip;0;3;0;3
4109;Kodėlčiukas;Šnekučiai;6194726931;Taip;0;6;0;6
4110;Kodėlčiukas;Šnekučiai;5782600824;Taip;0;8;0;8
4111;Kodėlčiukas;Šnekučiai;7074381835;Taip;6;5;0;11
4112;Kodėlčiukas;Šnekučiai;2988674717;Ne;0;5;4;9
4113;Kodėlčiukas;Šnekučiai;1834696935;Ne;3;8;0;11
4114;Kodėlčiukas;Šnekučiai;4273202718;Taip;0;1;0;1
4115;Kodėlčiukas;Šnekučiai;2244326972;Taip;0;16;0;16
4116;Kodėlčiukas;Šnekučiai;6761903865;Ne;0;1;0;1
4117;Kodėlčiukas;Šnekučiai;3778271049;Taip;10;0;1;11
4118;Kodėlčiukas;Šnekučiai;7647582987;Ne;0;3;0;3
4119;Kodėlčiukas;Šnekučiai;7510273691;Taip;16;0;0;16
4120;Kodėlčiukas;Pabiručiai;9278139998;Taip;7;0;0;7
4121;Kodėlčiukas;Pabiručiai;6008027505;Taip;2;3;0;5
4122;Kodėlčiukas;Pabiručiai;6065858518;Taip;0;1;0;1
4123;Kodėlčiukas;Pabiručiai;8586746296;Taip;7;1;1;9
4124;Kodėlčiukas;Pabiručiai;9480926599;Ne;11;0;2;13
4125;Kodėlčiukas;Pabiručiai;9511144369;Taip;3;0;2;5
4126;Kodėlčiukas;Pabiručiai;7246943802;Taip;3;8;4;15
4127;Kodėlčiukas;Pabiručiai;8189938439;Taip;0;3;0;3
4128;Kodėlčiukas;Pabiručiai;5587200800;Taip;2;0;1;3
4129;Kodėlčiukas;Pabiručiai;1433623973;Taip;15;5;1;21
4130;Kodėlčiukas;Pabiručiai;1087808091;Ne;0;2;0;2
4131;Kodėlčiukas;Pabiručiai;7570122834;Taip;0;3;2;5
4132;Kodėlčiukas;Pabiručiai;5359866071;Taip;0;1;0;1
4133;Kodėlčiukas;Pabiručiai;5801430256;Taip;5;1;0;6
4134;Kodėlčiukas;Pabiručiai;7455949617;Taip;0;3;0;3
4135;Kodėlčiukas;Pabiručiai;1039982141;Taip;6;0;0;6
4136;Kodėlčiukas;Pabiručiai;4507928289;Taip;0;0;2;2
4137;Kodėlčiukas;Pabiručiai;9830842598;Taip;0;0;5;5
4138;Kodėlčiukas;Smalsučiai;7630180473;Ne;5;4;2;11
4139;Kodėlčiukas;Smalsučiai;8140940288;Taip;0;3;0;3
4140;Kodėlčiukas;Smalsučiai;7246243975;Taip;0;4;0;4
4141;Kodėlčiukas;Smalsučiai;1600501494;Taip;0;1;0;1
4142;Kodėlčiukas;Smalsučiai;3880019350;Taip;0;3;1;4
4143;Kodėlčiukas;Smalsučiai;4818678923;Taip;0;1;1;2
4144;Kodėlčiukas;Smalsučiai;9589692031;Taip;8;0;2;10
4145;Kodėlčiukas;Smalsučiai;1906128091;Taip;0;1;0;1
4146;Kodėlčiukas;Smalsučiai;8302606312;Taip;0;3;2;5
4147;Kodėlčiukas;Smalsučiai;9460792167;Taip;3;1;0;4
4148;Kodėlčiukas;Smalsučiai;7324303899;Taip;0;3;1;4
4149;Kodėlčiukas;Smalsučiai;9794875862;Taip;0;1;8;9
4150;Kodėlčiukas;Smalsučiai;9528997865;Taip;0;8;0;8
4151;Kodėlčiukas;Smalsučiai;1919722425;Taip;0;1;0;1
4152;Kodėlčiukas;Smalsučiai;8879977943;Taip;8;4;0;12
4153;Kodėlčiukas;Smalsučiai;8647609373;Taip;5;7;0;12
4154;Kodėlčiukas;Smalsučiai;2062878300;Taip;5;8;1;14
4155;Kodėlčiukas;Smalsučiai;6950802941;Taip;9;0;0;9
4156;Kodėlčiukas;Smalsučiai;1233880820;Ne;6;0;1;7
4157;Kodėlčiukas;Smalsučiai;8296470927;Ne;0;8;0;8
4158;Kodėlčiukas;Giliukai;9754425363;Taip;5;2;0;7
4159;Kodėlčiukas;Giliukai;5587782917;Taip;1;1;0;2
4160;Kodėlčiukas;Giliukai;8100861190;Taip;5;4;0;9
4161;Kodėlčiukas;Giliukai;7639341503;Ne;0;1;0;1
4162;Kodėlčiukas;Giliukai;8017465692;Taip;0;1;0;1
4163;Kodėlčiukas;Giliukai;7937365710;Taip;7;0;2;9
4164;Kodėlčiukas;Giliukai;1937181137;Taip;0;0;3;3
4165;Kodėlčiukas;Giliukai;9733831323;Taip;5;1;0;6
4166;Kodėlčiukas;Giliukai;7007386353;Taip;0;1;0;1
4167;Kodėlčiukas;Giliukai;9721353724;Taip;9;0;0;9
4168;Kodėlčiukas;Giliukai;2943146610;Ne;0;0;3;3
4169;Kodėlčiukas;Giliukai;2122779530;Taip;7;0;0;7
4170;Kodėlčiukas;Giliukai;8785157050;Taip;10;11;0;21
4171;Kodėlčiukas;Giliukai;5770748359;Taip;0;0;6;6
4172;Kodėlčiukas;Giliukai;6643473339;Taip;5;0;0;5
4173;Kodėlčiukas;Giliukai;8107869258;Ne;0;0;1;1
4174;Kodėlčiukas;Giliukai;5909222351;Taip;21;0;0;21
4175;Kodėlčiukas;Giliukai;3130715310;Taip;4;3;0;7
4176;Kodėlčiukas;Giliukai;3686259290;Taip;0;0;1;1
4177;Kodėlčiukas;Gudručiai;1191430672;Taip;0;0;3;3
4178;Kodėlčiukas;Gudručiai;6988515253;Taip;5;8;0;13
4179;Kodėlčiukas;Gudručiai;3385551650;Taip;9;0;0;9
4180;Kodėlčiukas;Gudručiai;7318908956;Taip;8;4;0;12
4181;Kodėlčiukas;Gudručiai;9865803714;Taip;5;0;1;6
4182;Kodėlčiukas;Gudručiai;7430239198;Taip;5;0;2;7
4183;Kodėlčiukas;Gudručiai;8400610717;Taip;15;0;1;16
4184;Kodėlčiukas;Gudručiai;7116594055;Taip;0;0;1;1
4185;Kodėlčiukas;Gudručiai;9483378853;Taip;0;5;0;5
4186;Kodėlčiukas;Gudručiai;4687333060;Taip;0;3;0;3
4187;Kodėlčiukas;Gudručiai;1491160730;Taip;3;0;0;3
4188;Kodėlčiukas;Gudručiai;2216791610;Taip;10;0;0;10
4189;Kodėlčiukas;Gudručiai;2987907651;Taip;0;5;0;5
4190;Kodėlčiukas;Gudručiai;9028856983;Taip;22;0;0;22
4191;Kodėlčiukas;Gudručiai;1588132166;Taip;3;1;0;4
4192;Kodėlčiukas;Gudručiai;6014084915;Taip;0;12;1;13
4193;Kodėlčiukas;Gudručiai;3068084704;Taip;5;4;2;11
4194;Kodėlčiukas;Gudručiai;6985788287;Taip;13;0;0;13
4195;Kodėlčiukas;Gudručiai;3427610168;Taip;0;0;4;4
4196;Kodėlčiukas;Žirniukai;6522019070;Ne;15;0;0;15
4197;Kodėlčiukas;Žirniukai;6290821274;Taip;8;8;0;16
4198;Kodėlčiukas;Žirniukai;3053949510;Ne;18;0;3;21
4199;Kodėlčiukas;Žirniukai;8429572505;Taip;8;0;0;8
4200;Kodėlčiukas;Žirniukai;4321485862;Taip;0;0;1;1
4201;Kodėlčiukas;Žirniukai;1550287298;Taip;8;0;6;14
4202;Kodėlčiukas;Žirniukai;9045733092;Taip;15;0;1;16
4203;Kodėlčiukas;Žirniukai;4597473929;Taip;18;0;1;19
4204;Kodėlčiukas;Žirniukai;9702236745;Taip;21;0;0;21
4205;Kodėlčiukas;Katinėliai;4730433849;Taip;3;0;0;3
4206;Kodėlčiukas;Katinėliai;6474867237;Taip;5;0;4;9
4207;Kodėlčiukas;Katinėliai;4995538090;Ne;5;0;0;5
4208;Kodėlčiukas;Katinėliai;8045906704;Taip;3;0;2;5
4209;Kodėlčiukas;Katinėliai;7306085848;Taip;16;3;0;19
4210;Kodėlčiukas;Katinėliai;6576466300;Taip;14;0;0;14
4211;Kodėlčiukas;Katinėliai;5650077893;Taip;0;0;8;8
4212;Kodėlčiukas;Katinėliai;3239314295;Taip;9;0;0;9
4213;Kodėlčiukas;Katinėliai;9221561862;Taip;9;0;0;9
4214;Kodėlčiukas;Katinėliai;6355536268;Taip;2;0;2;4
4215;Kodėlčiukas;Katinėliai;2147517344;Taip;0;3;4;7
4216;Kodėlčiukas;Katinėliai;2119041584;Taip;3;0;0;3
4217;Kodėlčiukas;Katinėliai;9826174805;Taip;3;0;2;5
4218;Kodėlčiukas;Katinėliai;4727546035;Taip;6;0;1;7
4219;Kodėlčiukas;Nykštukai;6670171992;Taip;0;2;0;2
4220;Kodėlčiukas;Nykštukai;6935233288;Taip;21;0;0;21
4221;Kodėlčiukas;Nykštukai;8823086730;Taip;23;0;0;23
4222;Kodėlčiukas;Nykštukai;7686420784;Taip;0;0;9;9
4223;Kodėlčiukas;Nykštukai;8348024909;Taip;2;0;0;2
4224;Kodėlčiukas;Nykštukai;8759498015;Ne;0;0;5;5
4225;Kodėlčiukas;Nykštukai;8911944991;Ne;7;0;5;12
4226;Kodėlčiukas;Nykštukai;2465920649;Taip;0;0;1;1
4227;Kodėlčiukas;Nykštukai;4293763647;Taip;0;0;1;1
4228;Kodėlčiukas;Nykštukai;3878358193;Taip;5;0;0;5
4229;Kodėlčiukas;Nykštukai;6097922310;Ne;5;0;1;6
4230;Kodėlčiukas;Nykštukai;1835522972;Taip;8;1;0;9
4231;Kodėlčiukas;Nykštukai;2802895479;Taip;0;3;7;10
4232;Kodėlčiukas;Nykštukai;9914565606;Taip;18;0;2;20
4233;Kodėlčiukas;ŽIOGELIAI;8769409404;Ne;5;0;0;5
4234;Kodėlčiukas;ŽIOGELIAI;5189091564;Taip;0;3;0;3
4235;Kodėlčiukas;ŽIOGELIAI;6745245907;Taip;7;0;3;10
4236;Kodėlčiukas;ŽIOGELIAI;9055399463;Taip;8;0;0;8
4237;Kodėlčiukas;ŽIOGELIAI;4672108384;Taip;11;0;0;11
4238;Kodėlčiukas;ŽIOGELIAI;2081199093;Taip;6;5;7;18
4239;Kodėlčiukas;ŽIOGELIAI;4779994281;Taip;0;4;0;4
4240;Kodėlčiukas;ŽIOGELIAI;5115939251;Taip;3;0;0;3
4241;Kodėlčiukas;ŽIOGELIAI;3223461282;Taip;7;0;0;7
4242;Kodėlčiukas;ŽIOGELIAI;3603781385;Taip;17;1;0;18
4243;Kodėlčiukas;ŽIOGELIAI;6916032116;Taip;0;0;2;2
4244;Kodėlčiukas;ŽIOGELIAI;6749972956;Taip;8;0;0;8
4245;Kodėlčiukas;ŽIOGELIAI;2189949450;Taip;16;0;1;17
4246;Kodėlčiukas;ŽIOGELIAI;7497358286;Taip;6;1;5;12
4247;Kodėlčiukas;ŽIOGELIAI;2990546939;Taip;5;0;0;5
4248;Kodėlčiukas;ŽIOGELIAI;4089558399;Taip;10;0;2;12
4249;Kodėlčiukas;ŽIOGELIAI;6843492891;Taip;5;0;0;5
4250;Kodėlčiukas;ŽIOGELIAI;2933909503;Taip;10;10;0;20
4251;Kodėlčiukas;BITUTĖS;2438891967;Taip;5;0;0;5
4252;Kodėlčiukas;BITUTĖS;8829986201;Taip;0;0;16;16
4253;Kodėlčiukas;BITUTĖS;3985455729;Taip;0;3;1;4
4254;Kodėlčiukas;BITUTĖS;3156788328;Taip;5;0;0;5
4255;Kodėlčiukas;BITUTĖS;7910205296;Taip;0;0;9;9
4256;Kodėlčiukas;BITUTĖS;8037386529;Ne;2;9;0;11
4257;Kodėlčiukas;BITUTĖS;1047209628;Taip;18;0;3;21
4258;Kodėlčiukas;BITUTĖS;4529565626;Taip;14;0;1;15
4259;Kodėlčiukas;BITUTĖS;7227149646;Taip;0;0;8;8
4260;Kodėlčiukas;BITUTĖS;1568628843;Taip;0;1;1;2
4261;Kodėlčiukas;BITUTĖS;9209671311;Ne;8;0;0;8
4262;Kodėlčiukas;BITUTĖS;5752818911;Ne;0;0;1;1
4263;Kodėlčiukas;VYŠNIUKAI;3882838712;Taip;0;0;2;2
4264;Kodėlčiukas;VYŠNIUKAI;7705057116;Taip;8;1;0;9
4265;Kodėlčiukas;VYŠNIUKAI;7643398934;Taip;0;3;3;6
4266;Kodėlčiukas;VYŠNIUKAI;8799798070;Taip;0;0;1;1
4267;Kodėlčiukas;VYŠNIUKAI;7119815662;Taip;10;0;2;12
4268;Kodėlčiukas;VYŠNIUKAI;9398732476;Taip;3;0;6;9
4269;Kodėlčiukas;VYŠNIUKAI;2720748563;Taip;7;0;0;7
4270;Kodėlčiukas;VYŠNIUKAI;2871111867;Taip;0;1;0;1
4271;Kodėlčiukas;VYŠNIUKAI;9914322177;Taip;0;0;1;1
4272;Kodėlčiukas;VYŠNIUKAI;1925590099;Taip;9;0;0;9
4273;Kodėlčiukas;VYŠNIUKAI;7242653444;Taip;7;3;0;10
4274;Kodėlčiukas;VYŠNIUKAI;2298734536;Taip;0;4;1;5
4275;Kodėlčiukas;VYŠNIUKAI;7848240865;Taip;0;1;19;20
4276;Kodėlčiukas;VYŠNIUKAI;6261333618;Ne;0;5;0;5
4277;Kodėlčiukas;VYŠNIUKAI;2549153581;Taip;21;2;0;23
4278;Kodėlčiukas;VYŠNIUKAI;1808211253;Taip;16;0;0;16
4279;Kodėlčiukas;VYŠNIUKAI;5178305435;Ne;4;0;3;7
4280;Kodėlčiukas;VYŠNIUKAI;5061852590;Taip;5;0;3;8
4281;Kodėlčiukas;VYŠNIUKAI;4782931414;Taip;0;3;0;3
4282;Kodėlčiukas;BORUŽĖLĖS;9109362006;Taip;0;1;0;1
4283;Kodėlčiukas;BORUŽĖLĖS;9724373368;Taip;0;10;0;10
4284;Kodėlčiukas;BORUŽĖLĖS;5075801618;Taip;3;0;1;4
4285;Kodėlčiukas;BORUŽĖLĖS;2819860331;Taip;6;0;1;7
4286;Kodėlčiukas;BORUŽĖLĖS;4941186694;Taip;0;0;1;1
4287;Kodėlčiukas;BORUŽĖLĖS;4866089623;Taip;0;1;0;1
4288;Kodėlčiukas;BORUŽĖLĖS;5952121209;Taip;5;5;0;10
4289;Kodėlčiukas;BORUŽĖLĖS;4230906452;Taip;0;4;0;4
4290;Kodėlčiukas;BORUŽĖLĖS;9208137169;Ne;0;1;4;5
4291;Kodėlčiukas;BORUŽĖLĖS;5876187643;Ne;0;0;3;3
4292;Kodėlčiukas;BORUŽĖLĖS;6587593805;Taip;0;0;1;1
4293;Kodėlčiukas;BORUŽĖLĖS;1827752731;Taip;15;3;0;18
4294;Kodėlčiukas;BORUŽĖLĖS;1005178052;Taip;4;0;0;4
4295;Kodėlčiukas;BORUŽĖLĖS;1889809198;Taip;0;0;3;3
4296;Kodėlčiukas;BORUŽĖLĖS;4490196764;Taip;0;0;1;1
4297;Kodėlčiukas;BORUŽĖLĖS;1074477043;Taip;4;0;4;8
4298;Kodėlčiukas;BORUŽĖLĖS;2351468626;Taip;5;0;0;5
4299;Kodėlčiukas;BORUŽĖLĖS;3403889915;Taip;0;1;0;1
4300;Kodėlčiukas;VYTURĖLIAI;6714818379;Taip;0;7;0;7
4301;Kodėlčiukas;VYTURĖLIAI;4218096561;Taip;0;9;0;9
4302;Kodėlčiukas;VYTURĖLIAI;2169307879;Taip;5;0;0;5
4303;Kodėlčiukas;VYTURĖLIAI;2448536092;Taip;16;1;1;18
4304;Kodėlčiukas;VYTURĖLIAI;4585226357;Taip;7;0;0;7
4305;Kodėlčiukas;VYTURĖLIAI;4884233329;Taip;8;0;0;8
4306;Kodėlčiukas;VYTURĖLIAI;8263945732;Taip;0;0;1;1
4307;Kodėlčiukas;VYTURĖLIAI;7612531087;Taip;0;1;0;1
4308;Kodėlčiukas;VYTURĖLIAI;2904858964;Taip;5;0;2;7
4309;Kodėlčiukas;VYTURĖLIAI;9673271313;Taip;0;0;2;2
4310;Kodėlčiukas;VYTURĖLIAI;5710301153;Taip;0;0;9;9
4311;Kodėlčiukas;VYTURĖLIAI;1746835627;Taip;0;0;6;6
4312;Kodėlčiukas;VYTURĖLIAI;5474125905;Ne;10;3;0;13
4313;Kodėlčiukas;VYTURĖLIAI;2298099102;Taip;8;0;3;11
4314;Kodėlčiukas;VYTURĖLIAI;8427457478;Taip;1;10;0;11
4315;Kodėlčiukas;VYTURĖLIAI;5181211722;Taip;8;0;0;8
4316;Kodėlčiukas;VYTURĖLIAI;3472862544;Ne;3;0;1;4
4317;Kodėlčiukas;VYTURĖLIAI;5921714669;Taip;17;0;0;17
4318;Kodėlčiukas;VYTURĖLIAI;7778188733;Taip;15;0;0;15
4319;Kodėlčiukas;DRUGELIAI;4165123345;Taip;1;0;1;2
4320;Kodėlčiukas;DRUGELIAI;1149682376;Taip;11;0;0;11
4321;Kodėlčiukas;DRUGELIAI;7587203481;Taip;0;1;0;1
4322;Kodėlčiukas;DRUGELIAI;5505788210;Taip;0;0;2;2
4323;Kodėlčiukas;DRUGELIAI;5577154148;Taip;2;1;0;3
4324;Kodėlčiukas;DRUGELIAI;8547039654;Taip;5;0;1;6
4325;Kodėlčiukas;DRUGELIAI;4202423480;Taip;0;1;3;4
4326;Kodėlčiukas;DRUGELIAI;9979034031;Taip;0;2;0;2
4327;Kodėlčiukas;DRUGELIAI;3240221130;Ne;0;1;2;3
4328;Kodėlčiukas;DRUGELIAI;7714816675;Taip;20;0;1;21
4329;Kodėlčiukas;DRUGELIAI;9139424911;Taip;5;0;0;5
4330;Kodėlčiukas;DRUGELIAI;9664432781;Taip;5;3;2;10
4331;Kodėlčiukas;DRUGELIAI;5197946954;Taip;5;0;2;7
4332;Kodėlčiukas;DRUGELIAI;8315176054;Taip;0;3;2;5
4333;Kodėlčiukas;DRUGELIAI;3854719881;Taip;3;5;0;8
4334;Kodėlčiukas;DRUGELIAI;7908217415;Taip;6;0;0;6
4335;Kodėlčiukas;OBUOLIUKAI;8784531004;Taip;6;0;0;6
4336;Kodėlčiukas;OBUOLIUKAI;1289342844;Taip;0;6;0;6
4337;Kodėlčiukas;OBUOLIUKAI;7318196860;Taip;0;1;1;2
4338;Kodėlčiukas;OBUOLIUKAI;8208448849;Taip;0;2;0;2
4339;Kodėlčiukas;OBUOLIUKAI;1683506414;Taip;3;0;1;4
4340;Kodėlčiukas;OBUOLIUKAI;3315862631;Taip;0;5;0;5
4341;Kodėlčiukas;OBUOLIUKAI;5896726125;Taip;5;0;1;6
4342;Kodėlčiukas;OBUOLIUKAI;3168418461;Taip;0;1;1;2
4343;Kodėlčiukas;OBUOLIUKAI;9645987751;Taip;0;5;0;5
4344;Kodėlčiukas;OBUOLIUKAI;8782155591;Taip;0;0;1;1
4345;Kodėlčiukas;OBUOLIUKAI;8104220950;Taip;0;12;0;12
4346;Kodėlčiukas;OBUOLIUKAI;2005453189;Taip;10;4;0;14
4347;Kodėlčiukas;OBUOLIUKAI;1180399735;Taip;7;3;0;10
4348;Kodėlčiukas;OBUOLIUKAI;5173730926;Taip;15;2;0;17
4349;Kodėlčiukas;OBUOLIUKAI;3442449482;Taip;3;0;0;3
4350;Kodėlčiukas;OBUOLIUKAI;7946010973;Taip;5;4;0;9
4351;Kodėlčiukas;OBUOLIUKAI;5342852235;Taip;8;0;2;10
4352;Kodėlčiukas;OBUOLIUKAI;8563412043;Ne;5;0;0;5
4353;Kodėlčiukas;OBUOLIUKAI;4026784012;Taip;11;1;0;12
4354;Kodėlčiukas;OBUOLIUKAI;2114176689;Taip;0;23;0;23
4355;Kodėlčiukas;OBUOLIUKAI;3033687110;Ne;0;8;1;9
4356;Kurpaitė;Viščiukų;2157581956;Taip;0;22;0;22
4357;Kurpaitė;Viščiukų;3481813493;Taip;0;2;0;2
4358;Kurpaitė;Viščiukų;8402747029;Taip;0;1;0;1
4359;Kurpaitė;Viščiukų;2373582223;Taip;0;23;0;23
4360;Kurpaitė;Viščiukų;7194351335;Taip;9;0;0;9
4361;Kurpaitė;Viščiukų;2744439309;Ne;5;0;0;5
4362;Kurpaitė;Viščiukų;5923694769;Taip;20;0;0;20
4363;Kurpaitė;Viščiukų;5557028481;Taip;0;3;0;3
4364;Kurpaitė;Viščiukų;5447826458;Taip;0;7;0;7
4365;Kurpaitė;Viščiukų;2867842844;Taip;11;0;0;11
4366;Kurpaitė;Viščiukų;6859316204;Taip;15;0;0;15
4367;Kurpaitė;Gėlyčių;9922582884;Ne;0;5;0;5
4368;Kurpaitė;Gėlyčių;6466518987;Taip;0;6;0;6
4369;Kurpaitė;Gėlyčių;5745448950;Taip;15;0;0;15
4370;Kurpaitė;Gėlyčių;5952306163;Taip;0;4;0;4
4371;Kurpaitė;Gėlyčių;3989274600;Taip;15;3;0;18
4372;Kurpaitė;Gėlyčių;3139272175;Taip;0;11;0;11
4373;Kurpaitė;Gėlyčių;4769611100;Taip;8;0;0;8
4374;Kurpaitė;Gėlyčių;1927773278;Taip;0;12;0;12
4375;Kurpaitė;Gėlyčių;9221882007;Taip;0;1;0;1
4376;Kurpaitė;Gėlyčių;3456815576;Taip;0;10;0;10
4377;Kurpaitė;Gėlyčių;8361612709;Taip;0;5;0;5
4378;Kurpaitė;Gėlyčių;4754807319;Taip;2;0;0;2
4379;Kurpaitė;Gėlyčių;4607835570;Taip;16;0;0;16
4380;Kurpaitė;Gėlyčių;1964193512;Ne;0;4;0;4
4381;Kurpaitė;Gėlyčių;3201081769;Taip;0;0;23;23
4382;Kurpaitė;Drugelių;9384218589;Taip;0;22;0;22
4383;Kurpaitė;Drugelių;5609161523;Taip;7;3;0;10
4384;Kurpaitė;Drugelių;9200404698;Ne;0;5;0;5
4385;Kurpaitė;Drugelių;4592795281;Taip;0;19;0;19
4386;Kurpaitė;Drugelių;9480290430;Taip;0;1;0;1
4387;Kurpaitė;Drugelių;8868415451;Taip;0;15;0;15
4388;Kurpaitė;Drugelių;2290343066;Taip;0;11;0;11
4389;Kurpaitė;Drugelių;4188925256;Taip;0;2;0;2
4390;Kurpaitė;Drugelių;1273426668;Taip;0;9;0;9
4391;Kurpaitė;Drugelių;5220314051;Taip;0;0;1;1
4392;Kurpaitė;Drugelių;3634641300;Taip;0;2;0;2
4393;Kurpaitė;Drugelių;4602268315;Taip;5;5;0;10
4394;Kurpaitė;Drugelių;8592478282;Ne;2;0;0;2
4395;Kurpaitė;Drugelių;6568580994;Taip;0;11;0;11
4396;Kurpaitė;Pelyčių;7546409044;Taip;0;6;0;6
4397;Kurpaitė;Pelyčių;1218040871;Taip;0;6;0;6
4398;Kurpaitė;Pelyčių;1209441106;Taip;5;1;0;6
4399;Kurpaitė;Pelyčių;1505783589;Taip;0;4;0;4
4400;Kurpaitė;Pelyčių;4519369081;Taip;0;3;0;3
4401;Kurpaitė;Pelyčių;2359555461;Taip;5;7;0;12
4402;Kurpaitė;Pelyčių;65434834152;Taip;0;1;0;1
4403;Kurpaitė;Pelyčių;9063294667;Taip;0;3;0;3
4404;Kurpaitė;Pelyčių;4312062240;Ne;0;1;0;1
4405;Kurpaitė;Pelyčių;2827617670;Taip;2;0;0;2
4406;Kurpaitė;Pelyčių;1457318954;Taip;0;1;0;1
4407;Kurpaitė;Pelyčių;7897713994;Taip;0;12;0;12
4408;Kurpaitė;Pelyčių;4168882748;Taip;0;6;0;6
4409;Kurpaitė;Pelyčių;72710210157;Taip;0;2;0;2
4410;Kurpaitė;Pelyčių;1094620507;Taip;0;3;0;3
4411;Kurpaitė;Pelyčių;58127430940;Taip;0;5;0;5
4412;Kurpaitė;Pelyčių;2116580903;Taip;0;3;0;3
4413;Kurpaitė;Pelyčių;24410351286;Taip;0;6;0;6
4414;"Kūlverstukas (Suvalkų g. 6)";Saulutės;7449993309;Taip;11;0;0;11
4415;"Kūlverstukas (Suvalkų g. 6)";Saulutės;2450625415;Taip;5;0;5;10
4416;"Kūlverstukas (Suvalkų g. 6)";Saulutės;2101490038;Taip;5;0;5;10
4417;"Kūlverstukas (Suvalkų g. 6)";Saulutės;7118949795;Taip;0;2;3;5
4418;"Kūlverstukas (Suvalkų g. 6)";Saulutės;4173514390;Taip;10;0;0;10
4419;"Kūlverstukas (Suvalkų g. 6)";Saulutės;2762230590;Taip;3;1;0;4
4420;"Kūlverstukas (Suvalkų g. 6)";Saulutės;9167460438;Taip;9;6;1;16
4421;"Kūlverstukas (Suvalkų g. 6)";Saulutės;8319255735;Taip;0;0;6;6
4422;"Kūlverstukas (Suvalkų g. 6)";Saulutės;7505926208;Taip;4;0;4;8
4423;"Kūlverstukas (Suvalkų g. 6)";Saulutės;1014630718;Taip;4;0;4;8
4424;"Kūlverstukas (Suvalkų g. 6)";Saulutės;1795306946;Ne;1;0;1;2
4425;"Kūlverstukas (Suvalkų g. 6)";Saulutės;1898905623;Taip;3;0;0;3
4426;"Kūlverstukas (Suvalkų g. 6)";Saulutės;3448880105;Ne;0;3;10;13
4427;"Kūlverstukas (Suvalkų g. 6)";Saulutės;8294873714;Taip;5;0;0;5
4428;"Kūlverstukas (Suvalkų g. 6)";Saulutės;7970898546;Ne;0;1;1;2
4429;"Kūlverstukas (Suvalkų g. 6)";Saulutės;4532151103;Taip;11;0;1;12
4430;"Kūlverstukas (Suvalkų g. 6)";Peledžiukai;5488011852;Taip;0;0;4;4
4431;"Kūlverstukas (Suvalkų g. 6)";Peledžiukai;3937419139;Taip;7;3;0;10
4432;"Kūlverstukas (Suvalkų g. 6)";Peledžiukai;6975324309;Taip;0;0;3;3
4433;"Kūlverstukas (Suvalkų g. 6)";Peledžiukai;1452422691;Ne;0;2;4;6
4434;"Kūlverstukas (Suvalkų g. 6)";Peledžiukai;5372936730;Ne;0;0;1;1
4435;"Kūlverstukas (Suvalkų g. 6)";Peledžiukai;4396230034;Taip;0;0;7;7
4436;"Kūlverstukas (Suvalkų g. 6)";Peledžiukai;7359354944;Taip;3;0;0;3
4437;"Kūlverstukas (Suvalkų g. 6)";Peledžiukai;8853848991;Taip;5;0;0;5
4438;"Kūlverstukas (Suvalkų g. 6)";Peledžiukai;6287636806;Taip;8;0;2;10
4439;"Kūlverstukas (Suvalkų g. 6)";Peledžiukai;8092104136;Taip;5;0;3;8
4440;"Kūlverstukas (Suvalkų g. 6)";Peledžiukai;3238807604;Taip;0;8;3;11
4441;"Kūlverstukas (Suvalkų g. 6)";Peledžiukai;1932066021;Taip;9;0;0;9
4442;"Kūlverstukas (Suvalkų g. 6)";Peledžiukai;9655585527;Taip;12;0;3;15
4443;"Kūlverstukas (Suvalkų g. 6)";Peledžiukai;5488852698;Taip;5;0;0;5
4444;"Kūlverstukas (Suvalkų g. 6)";Peledžiukai;5345423038;Taip;6;2;0;8
4445;"Kūlverstukas (Suvalkų g. 6)";Peledžiukai;3270176280;Taip;5;2;0;7
4446;"Kūlverstukas (Suvalkų g. 6)";Peledžiukai;4285624305;Taip;0;3;4;7
4447;"Kūlverstukas (Suvalkų g. 6)";Gelytės;8353856412;Taip;9;5;0;14
4448;"Kūlverstukas (Suvalkų g. 6)";Gelytės;3811616695;Taip;6;0;1;7
4449;"Kūlverstukas (Suvalkų g. 6)";Gelytės;3162808486;Taip;4;0;0;4
4450;"Kūlverstukas (Suvalkų g. 6)";Gelytės;1939668692;Ne;1;0;16;17
4451;"Kūlverstukas (Suvalkų g. 6)";Gelytės;4651091340;Taip;0;23;0;23
4452;"Kūlverstukas (Suvalkų g. 6)";Gelytės;7112217569;Taip;0;3;0;3
4453;"Kūlverstukas (Suvalkų g. 6)";Gelytės;5391554530;Taip;0;2;0;2
4454;"Kūlverstukas (Suvalkų g. 6)";Gelytės;8701405518;Taip;0;0;7;7
4455;"Kūlverstukas (Suvalkų g. 6)";Gelytės;4111966910;Taip;7;0;0;7
4456;"Kūlverstukas (Suvalkų g. 6)";Gelytės;1067182820;Taip;2;0;7;9
4457;"Kūlverstukas (Suvalkų g. 6)";Gelytės;2316978273;Taip;0;0;1;1
4458;"Kūlverstukas (Suvalkų g. 6)";Gelytės;8333084277;Taip;7;0;5;12
4459;"Kūlverstukas (Suvalkų g. 6)";Gelytės;6710735721;Taip;8;2;0;10
4460;"Kūlverstukas (Suvalkų g. 6)";Gelytės;8618967238;Taip;16;0;0;16
4461;"Kūlverstukas (Suvalkų g. 6)";Bitutės;1679412281;Taip;1;0;0;1
4462;"Kūlverstukas (Suvalkų g. 6)";Bitutės;3790418633;Taip;1;0;0;1
4463;"Kūlverstukas (Suvalkų g. 6)";Bitutės;9777005699;Taip;0;5;3;8
4464;"Kūlverstukas (Suvalkų g. 6)";Bitutės;8599785196;Taip;15;0;1;16
4465;"Kūlverstukas (Suvalkų g. 6)";Bitutės;2082087440;Taip;5;0;0;5
4466;"Kūlverstukas (Suvalkų g. 6)";Bitutės;9976311692;Taip;8;2;0;10
4467;"Kūlverstukas (Suvalkų g. 6)";Bitutės;9600326594;Taip;0;23;0;23
4468;"Kūlverstukas (Suvalkų g. 6)";Bitutės;6319075079;Taip;13;0;0;13
4469;"Kūlverstukas (Suvalkų g. 6)";Bitutės;1062604474;Taip;0;0;2;2
4470;"Kūlverstukas (Suvalkų g. 6)";Bitutės;1985177751;Taip;0;2;2;4
4471;"Kūlverstukas (Suvalkų g. 6)";Bitutės;2924333435;Taip;5;0;0;5
4472;"Kūlverstukas (Suvalkų g. 6)";Bitutės;9787833724;Taip;8;0;1;9
4473;"Kūlverstukas (Suvalkų g. 6)";Bitutės;3370339665;Taip;0;0;3;3
4474;"Kūlverstukas (Suvalkų g. 6)";Bitutės;6916013898;Taip;0;0;3;3
4475;Lakštingala;Saulutės;2156571482;Taip;0;0;7;7
4476;Lakštingala;Saulutės;4651600682;Taip;8;0;8;16
4477;Lakštingala;Saulutės;2084960114;Ne;0;0;10;10
4478;Lakštingala;Saulutės;3911509979;Taip;5;2;0;7
4479;Lakštingala;Saulutės;1598639284;Taip;5;3;0;8
4480;Lakštingala;Saulutės;2742489026;Ne;2;0;0;2
4481;Lakštingala;Saulutės;1243254166;Taip;5;11;0;16
4482;Lakštingala;Saulutės;9628476764;Ne;0;3;0;3
4483;Lakštingala;Saulutės;4344553248;Taip;0;0;16;16
4484;Lakštingala;Saulutės;9457533516;Taip;0;0;2;2
4485;Lakštingala;Saulutės;9495341480;Taip;0;6;0;6
4486;Lakštingala;Saulutės;2543779273;Taip;10;1;0;11
4487;Lakštingala;Saulutės;1074616528;Taip;5;0;0;5
4488;Lakštingala;Saulutės;2626498928;Taip;0;3;0;3
4489;Lakštingala;Saulutės;9441296489;Taip;0;2;0;2
4490;Lakštingala;Saulutės;6369696598;Taip;5;0;0;5
4491;Lakštingala;Saulutės;9297542026;Taip;0;4;0;4
4492;Lakštingala;Saulutės;9899997020;Taip;0;2;11;13
4493;Lakštingala;Saulutės;8130468345;Taip;0;2;1;3
4494;Lakštingala;Nykštukai;9725851433;Taip;0;3;1;4
4495;Lakštingala;Nykštukai;8217315818;Ne;0;2;2;4
4496;Lakštingala;Nykštukai;2769474812;Ne;0;3;1;4
4497;Lakštingala;Nykštukai;9879064676;Taip;0;4;0;4
4498;Lakštingala;Nykštukai;2941128360;Ne;0;5;0;5
4499;Lakštingala;Nykštukai;9912622093;Taip;0;1;0;1
4500;Lakštingala;Nykštukai;3509165175;Taip;8;2;0;10
4501;Lakštingala;Nykštukai;3993759015;Taip;3;6;8;17
4502;Lakštingala;Nykštukai;5445945319;Taip;5;6;0;11
4503;Lakštingala;Nykštukai;6332498461;Taip;13;0;3;16
4504;Lakštingala;Nykštukai;1655202909;Taip;0;5;5;10
4505;Lakštingala;Nykštukai;5162605666;Taip;9;3;0;12
4506;Lakštingala;Nykštukai;7994475429;Taip;10;0;0;10
4507;Lakštingala;Nykštukai;1863034132;Taip;0;0;23;23
4508;Lakštingala;Nykštukai;6292331193;Taip;13;0;1;14
4509;Lakštingala;Nykštukai;4032030375;Taip;0;11;0;11
4510;Lakštingala;Nykštukai;2652305131;Taip;0;2;1;3
4511;Lakštingala;Nykštukai;7963839249;Taip;0;3;8;11
4512;Lakštingala;Nykštukai;9375002191;Taip;0;2;2;4
4513;Lakštingala;Nykštukai;4179366572;Taip;3;0;16;19
4514;Lakštingala;Nykštukai;4857448665;Taip;3;1;0;4
4515;Lakštingala;Bitutės;8890852891;Taip;5;3;4;12
4516;Lakštingala;Bitutės;5851957031;Ne;0;2;3;5
4517;Lakštingala;Bitutės;7918688955;Taip;4;1;0;5
4518;Lakštingala;Bitutės;9395512638;Taip;0;4;0;4
4519;Lakštingala;Bitutės;1832608585;Taip;5;3;0;8
4520;Lakštingala;Bitutės;9958821769;Taip;5;5;0;10
4521;Lakštingala;Bitutės;7953724873;Taip;0;3;0;3
4522;Lakštingala;Bitutės;7900597697;Taip;0;3;0;3
4523;Lakštingala;Bitutės;8470575927;Taip;0;3;0;3
4524;Lakštingala;Bitutės;9497327995;Taip;0;1;0;1
4525;Lakštingala;Bitutės;1411121466;Taip;0;5;0;5
4526;Lakštingala;Bitutės;8944088082;Taip;0;5;1;6
4527;Lakštingala;Bitutės;9897713625;Taip;2;0;0;2
4528;Lakštingala;Bitutės;2104150466;Taip;4;0;0;4
4529;Lakštingala;Bitutės;70798601578;Taip;0;10;0;10
4530;Lakštingala;Bitutės;1265027238;Taip;0;9;0;9
4531;Lakštingala;Bitutės;1736130324;Taip;9;2;1;12
4532;Lakštingala;Bitutės;2039579203;Taip;0;2;2;4
4533;Lakštingala;Bitutės;5672932116;Ne;5;5;0;10
4534;Lakštingala;Bitutės;5598711072;Taip;0;2;3;5
4535;Lakštingala;Bitutės;9346986726;Taip;0;2;0;2
4536;Lakštingala;Bitutės;5920907667;Taip;0;5;10;15
4537;Lakštingala;Bitutės;8679582358;Taip;0;2;1;3
4538;Lakštingala;Pūkeliai;9774836470;Taip;0;3;0;3
4539;Lakštingala;Pūkeliai;1958696382;Taip;4;0;0;4
4540;Lakštingala;Pūkeliai;4542992319;Taip;14;3;0;17
4541;Lakštingala;Pūkeliai;2593030897;Taip;0;3;0;3
4542;Lakštingala;Pūkeliai;6908873466;Taip;5;2;0;7
4543;Lakštingala;Pūkeliai;7929034243;Taip;0;3;0;3
4544;Lakštingala;Pūkeliai;5854794141;Taip;0;7;0;7
4545;Lakštingala;Pūkeliai;2130192341;Taip;6;0;0;6
4546;Lakštingala;Pūkeliai;8165998647;Taip;19;0;0;19
4547;Lakštingala;Pūkeliai;1458348357;Taip;2;0;0;2
4548;Lakštingala;Pūkeliai;4465752871;Taip;11;0;0;11
4549;Lakštingala;Pūkeliai;5379344261;Taip;0;1;0;1
4550;Lakštingala;Pūkeliai;7272454093;Taip;0;0;2;2
4551;Lakštingala;Pūkeliai;1587899391;Taip;3;0;0;3
4552;Lakštingala;Pūkeliai;6234559044;Taip;0;0;2;2
4553;Lakštingala;Pūkeliai;5727308039;Taip;0;3;0;3
4554;Lakštingala;Pūkeliai;5051773825;Taip;3;0;0;3
4555;Lakštingala;Pūkeliai;9390342572;Taip;0;5;4;9
4556;Lakštingala;Pūkeliai;6565318145;Taip;15;3;0;18
4557;Lakštingala;Pūkeliai;4384468922;Taip;0;2;4;6
4558;Lakštingala;Pūkeliai;2423761155;Taip;4;2;4;10
4559;Lakštingala;Pūkeliai;8171357606;Taip;0;10;0;10
4560;Lakštingala;Aitvariukai;1474796466;Taip;0;2;3;5
4561;Lakštingala;Aitvariukai;4546036762;Taip;4;0;0;4
4562;Lakštingala;Aitvariukai;6219896499;Taip;0;8;0;8
4563;Lakštingala;Aitvariukai;7876311404;Taip;4;6;0;10
4564;Lakštingala;Aitvariukai;1248909711;Taip;5;8;0;13
4565;Lakštingala;Aitvariukai;9676872125;Taip;0;5;0;5
4566;Lakštingala;Aitvariukai;9083753159;Taip;0;0;7;7
4567;Lakštingala;Aitvariukai;7879280198;Taip;13;3;0;16
4568;Lakštingala;Aitvariukai;4403673558;Ne;11;3;0;14
4569;Lakštingala;Aitvariukai;5693413287;Ne;11;0;3;14
4570;Lakštingala;Aitvariukai;7240426529;Ne;9;1;0;10
4571;Lakštingala;Aitvariukai;8558000223;Taip;0;1;0;1
4572;Lakštingala;Aitvariukai;5244646855;Taip;5;0;0;5
4573;Lakštingala;Aitvariukai;5602079341;Taip;15;0;6;21
4574;Lakštingala;Aitvariukai;3166474163;Taip;0;7;1;8
4575;Lakštingala;Aitvariukai;8609822839;Taip;0;0;10;10
4576;Lakštingala;Aitvariukai;6180443056;Taip;15;1;0;16
4577;Lakštingala;Boružiukai;9795993812;Taip;0;5;1;6
4578;Lakštingala;Boružiukai;9004336424;Ne;0;11;0;11
4579;Lakštingala;Boružiukai;8820053026;Taip;2;1;0;3
4580;Lakštingala;Boružiukai;2072883878;Taip;0;3;0;3
4581;Lakštingala;Boružiukai;4811759034;Taip;0;4;0;4
4582;Lakštingala;Boružiukai;1898853302;Taip;0;3;0;3
4583;Lakštingala;Boružiukai;55720630870;Taip;5;0;0;5
4584;Lakštingala;Boružiukai;4818524423;Taip;4;0;0;4
4585;Lakštingala;Boružiukai;1444534032;Taip;0;2;0;2
4586;Lakštingala;Boružiukai;9724531753;Taip;5;1;0;6
4587;Lakštingala;Boružiukai;1783776913;Taip;3;1;0;4
4588;Lakštingala;Boružiukai;1106475925;Ne;0;1;0;1
4589;Lakštingala;Boružiukai;1667277983;Taip;0;2;0;2
4590;Lakštingala;Boružiukai;6947565845;Taip;0;6;0;6
4591;Lakštingala;Boružiukai;3009692491;Taip;0;3;0;3
4592;Lakštingala;Boružiukai;1800927281;Taip;11;5;0;16
4593;Lakštingala;Boružiukai;2304340938;Taip;0;10;2;12
4594;Lakštingala;Boružiukai;8284565948;Ne;8;0;0;8
4595;Lakštingala;Boružiukai;9445476887;Taip;5;4;0;9
4596;Lakštingala;Boružiukai;8899572475;Taip;0;4;0;4
4597;Lakštingala;Boružiukai;9492056071;Ne;0;3;0;3
4598;Lakštingala;Žiogeliai;5048686136;Taip;10;3;1;14
4599;Lakštingala;Žiogeliai;8404025659;Taip;0;0;16;16
4600;Lakštingala;Žiogeliai;4113993067;Taip;0;11;0;11
4601;Lakštingala;Žiogeliai;6981178960;Taip;0;2;6;8
4602;Lakštingala;Žiogeliai;3908175786;Taip;11;0;5;16
4603;Lakštingala;Žiogeliai;9860169528;Taip;0;0;9;9
4604;Lakštingala;Žiogeliai;4935753482;Taip;20;1;0;21
4605;Lakštingala;Žiogeliai;5008933316;Taip;3;0;0;3
4606;Lakštingala;Žiogeliai;3439681068;Taip;6;1;0;7
4607;Lakštingala;Žiogeliai;3766986041;Taip;11;0;7;18
4608;Lakštingala;Žiogeliai;1974950823;Taip;12;1;0;13
4609;Lakštingala;Žiogeliai;6561743084;Taip;0;2;1;3
4610;Lakštingala;Žiogeliai;1226908540;Taip;0;0;5;5
4611;Lakštingala;Žiogeliai;3951057865;Taip;9;0;5;14
4612;Lakštingala;Žiogeliai;1494530289;Taip;10;0;1;11
4613;Lakštingala;Žiogeliai;7104398627;Taip;5;2;1;8
4614;Lakštingala;Žiogeliai;7361353346;Taip;0;7;0;7
4615;Lakštingala;Žiogeliai;4790291839;Taip;2;0;0;2
4616;Lakštingala;Žiogeliai;8351970017;Taip;5;1;0;6
4617;Lakštingala;Žiogeliai;8333832673;Ne;0;0;9;9
4618;Lakštingala;Žiogeliai;6872095965;Taip;8;0;0;8
4619;Lakštingala;SPINDULIUKAI;4365413054;Taip;2;0;7;9
4620;Lakštingala;SPINDULIUKAI;9762500668;Taip;0;0;4;4
4621;Lakštingala;SPINDULIUKAI;7640007392;Taip;0;13;0;13
4622;Lakštingala;SPINDULIUKAI;4784677514;Taip;0;6;0;6
4623;Lakštingala;SPINDULIUKAI;2022621678;Taip;0;0;4;4
4624;Lakštingala;SPINDULIUKAI;8429523368;Taip;0;9;0;9
4625;Lakštingala;SPINDULIUKAI;6668075753;Taip;5;0;3;8
4626;Lakštingala;SPINDULIUKAI;9081653166;Taip;5;2;0;7
4627;Lakštingala;SPINDULIUKAI;6780591792;Taip;0;1;0;1
4628;Lakštingala;SPINDULIUKAI;4698879435;Taip;3;1;0;4
4629;Lakštingala;SPINDULIUKAI;8722490845;Taip;0;4;0;4
4630;Lakštingala;SPINDULIUKAI;1220858944;Taip;4;4;0;8
4631;Lakštingala;SPINDULIUKAI;7141840160;Taip;0;4;0;4
4632;Lakštingala;SPINDULIUKAI;3282771613;Taip;0;10;0;10
4633;Lakštingala;SPINDULIUKAI;2795341401;Taip;0;3;0;3
4634;Lakštingala;SPINDULIUKAI;5815240975;Taip;3;0;7;10
4635;Lakštingala;Pėledžiukai;3520592784;Taip;0;6;0;6
4636;Lakštingala;Pėledžiukai;5258588961;Taip;5;0;0;5
4637;Lakštingala;Pėledžiukai;6135103377;Taip;13;0;0;13
4638;Lakštingala;Pėledžiukai;4774354751;Taip;0;2;3;5
4639;Lakštingala;Pėledžiukai;3369263112;Taip;0;2;6;8
4640;Lakštingala;Pėledžiukai;8375506323;Taip;0;0;3;3
4641;Lakštingala;Pėledžiukai;2738882466;Taip;0;6;0;6
4642;Lakštingala;Pėledžiukai;8717764626;Taip;0;0;1;1
4643;Lakštingala;Pėledžiukai;8075192528;Taip;0;3;9;12
4644;Lakštingala;Pėledžiukai;6161860331;Taip;0;3;1;4
4645;Lakštingala;Pėledžiukai;6866935290;Taip;8;0;1;9
4646;Lakštingala;Pėledžiukai;8787118512;Taip;4;3;1;8
4647;Lakštingala;Pėledžiukai;6805882038;Taip;10;0;0;10
4648;Lakštingala;Pėledžiukai;7139669240;Taip;0;4;3;7
4649;Lakštingala;Pėledžiukai;9502994399;Taip;0;18;0;18
4650;Lakštingala;Pėledžiukai;9431022632;Taip;13;0;2;15
4651;Lakštingala;Pėledžiukai;9856189053;Taip;0;0;2;2
4652;Lakštingala;Pėledžiukai;5391954600;Taip;8;0;0;8
4653;Lakštingala;Pėledžiukai;4608719006;Ne;6;0;1;7
4654;Lakštingala;Katinėliai;8861428074;Taip;4;0;2;6
4655;Lakštingala;Katinėliai;2346497467;Taip;12;0;0;12
4656;Lakštingala;Katinėliai;9894103692;Taip;15;2;0;17
4657;Lakštingala;Katinėliai;8800538473;Taip;5;0;0;5
4658;Lakštingala;Katinėliai;9093654437;Taip;0;0;6;6
4659;Lakštingala;Katinėliai;2673030043;Taip;0;0;2;2
4660;Lakštingala;Katinėliai;2010478542;Taip;0;0;4;4
4661;Lakštingala;Katinėliai;1371422364;Taip;8;0;0;8
4662;Lakštingala;Katinėliai;6285766353;Taip;0;0;8;8
4663;Lakštingala;Katinėliai;3877448215;Taip;10;0;2;12
4664;Lakštingala;Katinėliai;6148942052;Taip;0;1;0;1
4665;Lakštingala;Katinėliai;7623917384;Taip;0;1;0;1
4666;Lakštingala;Katinėliai;1903292595;Taip;11;0;0;11
4667;Lakštingala;Katinėliai;6764453371;Taip;0;2;0;2
4668;Lakštingala;Katinėliai;4184814075;Taip;8;2;0;10
4669;Lakštingala;Deimantėliai;8310446552;Taip;14;0;1;15
4670;Lakštingala;Deimantėliai;8063735934;Taip;7;0;0;7
4671;Lakštingala;Deimantėliai;7396235662;Taip;17;0;1;18
4672;Lakštingala;Deimantėliai;3863174791;Ne;10;0;0;10
4673;Lakštingala;Deimantėliai;2969366008;Taip;5;2;0;7
4674;Lakštingala;Deimantėliai;9800669350;Taip;2;2;0;4
4675;Lakštingala;Deimantėliai;4725848201;Taip;7;1;0;8
4676;Lakštingala;Deimantėliai;6930466455;Taip;7;1;0;8
4677;Lakštingala;Deimantėliai;5539054769;Taip;0;0;2;2
4678;Lakštingala;Deimantėliai;8421786788;Taip;5;0;0;5
4679;Lakštingala;Deimantėliai;6974936332;Taip;5;0;5;10
4680;Lakštingala;Deimantėliai;8764728846;Taip;2;0;0;2
4681;Lakštingala;Deimantėliai;8663938939;Taip;8;1;0;9
4682;Lakštingala;Deimantėliai;6231045485;Taip;11;0;1;12
4683;Lakštingala;Deimantėliai;5165517709;Taip;5;2;0;7
4684;Lakštingala;Deimantėliai;5965026791;Taip;7;1;0;8
4685;Lakštingala;KIŠKUČIAI;6520436055;Taip;3;1;0;4
4686;Lakštingala;KIŠKUČIAI;3208321841;Taip;2;2;4;8
4687;Lakštingala;KIŠKUČIAI;5464460112;Taip;0;5;1;6
4688;Lakštingala;KIŠKUČIAI;6970022417;Taip;10;1;0;11
4689;Lakštingala;KIŠKUČIAI;5730122965;Taip;5;4;0;9
4690;Lakštingala;KIŠKUČIAI;4140403601;Taip;0;1;0;1
4691;Lakštingala;KIŠKUČIAI;5119365443;Taip;0;1;0;1
4692;Lakštingala;KIŠKUČIAI;6689018476;Taip;5;2;1;8
4693;Lakštingala;KIŠKUČIAI;7017047366;Taip;3;0;0;3
4694;Lakštingala;KIŠKUČIAI;9539081376;Taip;2;0;16;18
4695;Lakštingala;KIŠKUČIAI;4854843534;Taip;6;2;7;15
4696;Lakštingala;KIŠKUČIAI;9162902701;Taip;0;6;14;20
4697;Lakštingala;KIŠKUČIAI;5455119187;Taip;9;0;0;9
4698;Lakštingala;KIŠKUČIAI;1113674539;Taip;8;0;3;11
4699;Lakštingala;KIŠKUČIAI;4370431439;Taip;0;11;4;15
4700;Lakštingala;KIŠKUČIAI;1898108870;Taip;9;7;1;17
4701;Lakštingala;KIŠKUČIAI;6652822827;Taip;0;0;5;5
4702;Lakštingala;KIŠKUČIAI;2998581623;Taip;3;2;0;5
4703;Lakštingala;KIŠKUČIAI;8414220381;Taip;5;0;0;5
4704;Lakštingala;KIŠKUČIAI;7817830649;Taip;7;8;0;15
4705;Lašelis;VIŠČIUKAI;6477439886;Taip;0;7;1;8
4706;Lašelis;VIŠČIUKAI;6912802425;Taip;13;1;0;14
4707;Lašelis;VIŠČIUKAI;6857428142;Taip;0;5;0;5
4708;Lašelis;VIŠČIUKAI;5759317067;Ne;8;2;0;10
4709;Lašelis;VIŠČIUKAI;9884946783;Taip;12;0;0;12
4710;Lašelis;VIŠČIUKAI;1367955273;Ne;0;3;0;3
4711;Lašelis;VIŠČIUKAI;2702582486;Taip;4;3;0;7
4712;Lašelis;VIŠČIUKAI;2824852871;Taip;8;5;0;13
4713;Lašelis;VIŠČIUKAI;1517104634;Taip;0;6;0;6
4714;Lašelis;VIŠČIUKAI;1294930990;Taip;0;1;0;1
4715;Lašelis;VIŠČIUKAI;9440665009;Ne;0;3;0;3
4716;Lašelis;VIŠČIUKAI;2121080776;Ne;0;0;3;3
4717;Lašelis;VIŠČIUKAI;3003679103;Taip;2;0;0;2
4718;Lašelis;VIŠČIUKAI;4427263877;Taip;5;0;6;11
4719;Lašelis;VIŠČIUKAI;1168408482;Taip;6;0;0;6
4720;Lašelis;VIŠČIUKAI;4748156580;Taip;10;0;0;10
4721;Lašelis;VIŠČIUKAI;4860925464;Ne;4;0;0;4
4722;Lašelis;ŠYPSENA;1808067249;Ne;15;1;0;16
4723;Lašelis;ŠYPSENA;4933598046;Taip;10;0;0;10
4724;Lašelis;ŠYPSENA;1060784180;Taip;0;3;0;3
4725;Lašelis;ŠYPSENA;2509469243;Taip;10;3;0;13
4726;Lašelis;ŠYPSENA;4832223461;Taip;10;0;7;17
4727;Lašelis;ŠYPSENA;5416590600;Taip;5;3;1;9
4728;Lašelis;ŠYPSENA;1490179832;Ne;0;9;0;9
4729;Lašelis;ŠYPSENA;6836452490;Taip;8;0;1;9
4730;Lašelis;ŠYPSENA;1983312896;Taip;5;5;0;10
4731;Lašelis;ŠYPSENA;8906479495;Taip;8;0;3;11
4732;Lašelis;ŠYPSENA;2593126568;Taip;0;0;8;8
4733;Lašelis;ŠYPSENA;3995905195;Taip;6;16;0;22
4734;Lašelis;ŠYPSENA;6137626795;Taip;6;0;1;7
4735;Lašelis;ŠYPSENA;1635921119;Ne;5;6;0;11
4736;Lašelis;ŠYPSENA;9664015801;Taip;8;0;0;8
4737;Lašelis;ŠYPSENA;2306501498;Taip;1;0;1;2
4738;Lašelis;ŠYPSENA;2606193652;Ne;0;0;1;1
4739;Lašelis;ŠYPSENA;9434932943;Taip;7;1;0;8
4740;Lašelis;NYKŠTUKAI;4508779926;Taip;0;0;2;2
4741;Lašelis;NYKŠTUKAI;8132517365;Taip;6;4;0;10
4742;Lašelis;NYKŠTUKAI;1244168190;Taip;0;0;6;6
4743;Lašelis;NYKŠTUKAI;1035888733;Taip;0;2;0;2
4744;Lašelis;NYKŠTUKAI;1926439959;Taip;0;3;1;4
4745;Lašelis;NYKŠTUKAI;8318512396;Taip;13;5;0;18
4746;Lašelis;NYKŠTUKAI;2886967297;Taip;0;13;0;13
4747;Lašelis;NYKŠTUKAI;3805049682;Taip;13;0;0;13
4748;Lašelis;NYKŠTUKAI;2401058384;Ne;10;0;1;11
4749;Lašelis;NYKŠTUKAI;8814796010;Taip;4;0;1;5
4750;Lašelis;NYKŠTUKAI;2223293390;Ne;0;0;1;1
4751;Lašelis;NYKŠTUKAI;3675606390;Taip;23;0;0;23
4752;Lašelis;SAULUTĖ;3144718477;Taip;3;0;1;4
4753;Lašelis;SAULUTĖ;7998812497;Taip;0;9;0;9
4754;Lašelis;SAULUTĖ;6669130831;Taip;10;0;0;10
4755;Lašelis;SAULUTĖ;7351939034;Taip;0;0;1;1
4756;Lašelis;SAULUTĖ;3239288878;Taip;12;0;0;12
4757;Lašelis;SAULUTĖ;6829438486;Taip;0;0;3;3
4758;Lašelis;SAULUTĖ;6080664872;Taip;9;0;5;14
4759;Lašelis;SAULUTĖ;1515920896;Taip;8;0;0;8
4760;Lašelis;SAULUTĖ;1085400709;Taip;0;0;6;6
4761;Lašelis;SAULUTĖ;8889959782;Taip;0;0;1;1
4762;Lašelis;SAULUTĖ;1646912457;Taip;8;1;0;9
4763;Lašelis;SAULUTĖ;1816377082;Ne;9;0;0;9
4764;Lašelis;SAULUTĖ;3495676199;Taip;15;0;0;15
4765;Lašelis;SAULUTĖ;5731394231;Taip;11;0;0;11
4766;Lašelis;SAULUTĖ;1085950130;Taip;0;0;2;2
4767;Lašelis;BORUŽĖLĖS;1343964112;Taip;10;0;0;10
4768;Lašelis;BORUŽĖLĖS;1511922965;Ne;0;4;0;4
4769;Lašelis;BORUŽĖLĖS;5634517740;Ne;3;0;0;3
4770;Lašelis;BORUŽĖLĖS;7418586100;Taip;10;0;1;11
4771;Lašelis;BORUŽĖLĖS;1429188137;Taip;0;1;9;10
4772;Lašelis;BORUŽĖLĖS;8394290574;Taip;6;3;0;9
4773;Lašelis;BORUŽĖLĖS;7811809908;Taip;5;0;0;5
4774;Lašelis;BORUŽĖLĖS;4893073148;Taip;0;1;0;1
4775;Lašelis;BORUŽĖLĖS;4113842551;Taip;13;1;0;14
4776;Lašelis;BORUŽĖLĖS;1882188961;Ne;7;0;0;7
4777;Lašelis;BORUŽĖLĖS;6317716501;Taip;11;0;0;11
4778;Lašelis;BORUŽĖLĖS;2991487552;Taip;9;0;0;9
4779;Lašelis;BORUŽĖLĖS;2210081848;Taip;5;0;1;6
4780;Lašelis;BORUŽĖLĖS;1131591230;Taip;9;0;0;9
4781;Lašelis;SKRUZDELIUKAI;8212250478;Taip;6;4;0;10
4782;Lašelis;SKRUZDELIUKAI;8571325340;Taip;8;0;0;8
4783;Lašelis;SKRUZDELIUKAI;5000188106;Ne;15;1;0;16
4784;Lašelis;SKRUZDELIUKAI;6770694679;Taip;7;0;1;8
4785;Lašelis;SKRUZDELIUKAI;6158377421;Ne;17;3;0;20
4786;Lašelis;SKRUZDELIUKAI;3130271837;Taip;0;7;0;7
4787;Lašelis;SKRUZDELIUKAI;2871149756;Taip;18;0;0;18
4788;Lašelis;SKRUZDELIUKAI;7920615797;Ne;23;0;0;23
4789;Lašelis;SKRUZDELIUKAI;3146611814;Taip;0;6;0;6
4790;Lašelis;SKRUZDELIUKAI;7619426839;Ne;11;5;0;16
4791;Lašelis;SKRUZDELIUKAI;8718481664;Taip;8;0;0;8
4792;Lazdynėlis;BITUTĖS;4881322530;Taip;0;5;3;8
4793;Lazdynėlis;BITUTĖS;1748260780;Taip;16;0;2;18
4794;Lazdynėlis;BITUTĖS;4462819848;Taip;8;3;0;11
4795;Lazdynėlis;BITUTĖS;1574847460;Taip;0;3;0;3
4796;Lazdynėlis;BITUTĖS;5030400578;Taip;0;4;0;4
4797;Lazdynėlis;BITUTĖS;8159928299;Taip;12;0;1;13
4798;Lazdynėlis;BITUTĖS;9761942869;Taip;0;1;0;1
4799;Lazdynėlis;BITUTĖS;7911328294;Taip;6;0;0;6
4800;Lazdynėlis;BITUTĖS;1450181711;Taip;0;0;1;1
4801;Lazdynėlis;BITUTĖS;2044188250;Taip;5;1;1;7
4802;Lazdynėlis;BITUTĖS;2032759165;Ne;3;2;0;5
4803;Lazdynėlis;BITUTĖS;2586187455;Taip;18;0;2;20
4804;Lazdynėlis;BITUTĖS;2013752858;Taip;7;2;1;10
4805;Lazdynėlis;BITUTĖS;5562900372;Taip;0;23;0;23
4806;Lazdynėlis;BITUTĖS;3650483589;Taip;6;0;0;6
4807;Lazdynėlis;BITUTĖS;6920441303;Taip;7;0;0;7
4808;Lazdynėlis;BITUTĖS;4153294595;Taip;10;0;0;10
4809;Lazdynėlis;BITUTĖS;7910561870;Taip;0;23;0;23
4810;Lazdynėlis;BITUTĖS;4809829190;Taip;6;0;0;6
4811;Lazdynėlis;EŽIUKAI;1039874409;Taip;0;0;1;1
4812;Lazdynėlis;EŽIUKAI;9362249595;Taip;3;0;2;5
4813;Lazdynėlis;EŽIUKAI;7135087818;Taip;0;0;1;1
4814;Lazdynėlis;EŽIUKAI;6352480127;Taip;0;6;4;10
4815;Lazdynėlis;EŽIUKAI;6819322060;Ne;0;3;10;13
4816;Lazdynėlis;EŽIUKAI;6814362584;Taip;0;0;10;10
4817;Lazdynėlis;EŽIUKAI;9219327706;Taip;0;1;4;5
4818;Lazdynėlis;EŽIUKAI;8229454863;Taip;0;0;2;2
4819;Lazdynėlis;EŽIUKAI;4747688220;Taip;0;0;5;5
4820;Lazdynėlis;EŽIUKAI;1312649234;Taip;0;3;0;3
4821;Lazdynėlis;EŽIUKAI;3097254722;Taip;0;5;5;10
4822;Lazdynėlis;EŽIUKAI;3040417651;Taip;5;0;1;6
4823;Lazdynėlis;EŽIUKAI;2354549025;Taip;11;0;0;11
4824;Lazdynėlis;EŽIUKAI;7208223612;Taip;0;3;8;11
4825;Lazdynėlis;EŽIUKAI;8627994583;Taip;0;3;6;9
4826;Lazdynėlis;EŽIUKAI;4293473176;Taip;0;23;0;23
4827;Lazdynėlis;EŽIUKAI;2723284353;Taip;3;1;0;4
4828;Lazdynėlis;EŽIUKAI;9548653584;Taip;0;0;1;1
4829;Lazdynėlis;EŽIUKAI;6008610525;Taip;5;10;0;15
4830;Lazdynėlis;EŽIUKAI;3879017767;Taip;0;0;3;3
4831;Lazdynėlis;EŽIUKAI;4031719765;Taip;0;3;0;3
4832;Lazdynėlis;BORUŽIUKAI;8337458289;Taip;0;23;0;23
4833;Lazdynėlis;BORUŽIUKAI;2592852361;Taip;0;23;0;23
4834;Lazdynėlis;BORUŽIUKAI;7692056055;Taip;0;0;2;2
4835;Lazdynėlis;BORUŽIUKAI;6394994841;Ne;0;0;4;4
4836;Lazdynėlis;BORUŽIUKAI;2009941344;Ne;0;0;1;1
4837;Lazdynėlis;BORUŽIUKAI;1653216959;Taip;3;0;0;3
4838;Lazdynėlis;BORUŽIUKAI;2058909635;Taip;8;0;0;8
4839;Lazdynėlis;BORUŽIUKAI;3105363578;Taip;0;23;0;23
4840;Lazdynėlis;BORUŽIUKAI;5622254334;Taip;13;0;0;13
4841;Lazdynėlis;BORUŽIUKAI;7587041613;Taip;3;0;0;3
4842;Lazdynėlis;BORUŽIUKAI;2380881303;Taip;12;0;0;12
4843;Lazdynėlis;BORUŽIUKAI;5756228709;Taip;7;0;0;7
4844;Lazdynėlis;BORUŽIUKAI;6824473598;Taip;0;0;1;1
4845;Lazdynėlis;BORUŽIUKAI;1707231039;Taip;0;23;0;23
4846;Lazdynėlis;BORUŽIUKAI;4642875037;Taip;11;1;0;12
4847;Lazdynėlis;BORUŽIUKAI;1722503577;Taip;13;0;0;13
4848;Lazdynėlis;BORUŽIUKAI;4595080695;Taip;11;0;0;11
4849;Lazdynėlis;BORUŽIUKAI;4958640516;Taip;0;23;0;23
4850;Lazdynėlis;BORUŽIUKAI;3351966091;Taip;0;23;0;23
4851;Lazdynėlis;BORUŽIUKAI;9548866880;Taip;15;0;0;15
4852;Lazdynėlis;KAČIUKAI;8295967906;Taip;0;3;2;5
4853;Lazdynėlis;KAČIUKAI;7076664657;Taip;0;1;0;1
4854;Lazdynėlis;KAČIUKAI;1424382629;Taip;6;2;0;8
4855;Lazdynėlis;KAČIUKAI;6787228086;Taip;0;12;0;12
4856;Lazdynėlis;KAČIUKAI;4842228703;Taip;3;0;0;3
4857;Lazdynėlis;KAČIUKAI;6542840562;Taip;0;0;5;5
4858;Lazdynėlis;KAČIUKAI;1265404063;Taip;5;0;0;5
4859;Lazdynėlis;KAČIUKAI;6086766393;Taip;0;11;0;11
4860;Lazdynėlis;KAČIUKAI;5301460250;Taip;0;0;5;5
4861;Lazdynėlis;KAČIUKAI;3091067158;Taip;0;23;0;23
4862;Lazdynėlis;KAČIUKAI;73057057862;Taip;0;14;0;14
4863;Lazdynėlis;KAČIUKAI;7455989945;Taip;0;2;0;2
4864;Lazdynėlis;KAČIUKAI;1817075429;Taip;0;0;2;2
4865;Lazdynėlis;KAČIUKAI;5030460904;Ne;0;3;0;3
4866;Lazdynėlis;KAČIUKAI;2164717183;Taip;0;0;5;5
4867;Lazdynėlis;KAČIUKAI;5504180016;Ne;0;3;6;9
4868;Lazdynėlis;KAČIUKAI;5031826548;Taip;0;1;0;1
4869;Lazdynėlis;KAČIUKAI;7237629135;Taip;0;3;1;4
4870;Lazdynėlis;KAČIUKAI;6657174602;Taip;6;1;0;7
4871;Lazdynėlis;VOVERIUKAI;6994408527;Taip;3;0;0;3
4872;Lazdynėlis;VOVERIUKAI;8159724466;Taip;5;0;0;5
4873;Lazdynėlis;VOVERIUKAI;5051632567;Ne;10;0;0;10
4874;Lazdynėlis;VOVERIUKAI;6276697479;Taip;9;0;0;9
4875;Lazdynėlis;VOVERIUKAI;1335000592;Taip;3;2;1;6
4876;Lazdynėlis;VOVERIUKAI;2514035189;Taip;11;0;2;13
4877;Lazdynėlis;VOVERIUKAI;9477491360;Taip;0;4;0;4
4878;Lazdynėlis;VOVERIUKAI;5256157552;Ne;0;2;5;7
4879;Lazdynėlis;VOVERIUKAI;5889772626;Ne;6;2;1;9
4880;Lazdynėlis;VOVERIUKAI;6559543013;Taip;10;13;0;23
4881;Lazdynėlis;VOVERIUKAI;9231049001;Taip;0;8;2;10
4882;Lazdynėlis;VOVERIUKAI;9886856760;Taip;5;5;0;10
4883;Lazdynėlis;VOVERIUKAI;2998606948;Taip;4;5;0;9
4884;Lazdynėlis;VOVERIUKAI;6164180360;Taip;4;1;0;5
4885;Lazdynėlis;VOVERIUKAI;6415858184;Taip;0;0;2;2
4886;Lazdynėlis;VOVERIUKAI;5796381191;Ne;10;9;0;19
4887;Lazdynėlis;VOVERIUKAI;3062408541;Taip;12;1;0;13
4888;Lazdynėlis;VOVERIUKAI;5557752248;Taip;3;2;0;5
4889;Lazdynėlis;VOVERIUKAI;3779983775;Ne;10;5;0;15
4890;Lazdynėlis;VOVERIUKAI;4550819172;Taip;5;0;0;5
4891;Lazdynėlis;VOVERIUKAI;4771173060;Taip;8;0;0;8
4892;Lazdynėlis;VOVERIUKAI;8314002741;Taip;11;0;0;11
4893;Lazdynėlis;VOVERIUKAI;3365726271;Taip;9;0;0;9
4894;Lazdynėlis;VOVERIUKAI;1355954767;Taip;10;0;0;10
4895;Lazdynėlis;VOVERIUKAI;7941793866;Taip;0;6;2;8
4896;Lazdynėlis;RIEŠUTĖLIAI;3086059608;Ne;10;0;1;11
4897;Lazdynėlis;RIEŠUTĖLIAI;9693153118;Taip;5;3;0;8
4898;Lazdynėlis;RIEŠUTĖLIAI;6056618348;Taip;0;23;0;23
4899;Lazdynėlis;RIEŠUTĖLIAI;5987500024;Taip;0;0;5;5
4900;Lazdynėlis;RIEŠUTĖLIAI;2453740823;Taip;13;0;0;13
4901;Lazdynėlis;RIEŠUTĖLIAI;7545621720;Taip;5;0;4;9
4902;Lazdynėlis;RIEŠUTĖLIAI;8179584161;Taip;0;2;0;2
4903;Lazdynėlis;RIEŠUTĖLIAI;4055450300;Taip;0;2;1;3
4904;Lazdynėlis;RIEŠUTĖLIAI;8942906327;Taip;9;0;2;11
4905;Lazdynėlis;RIEŠUTĖLIAI;3362193379;Taip;0;3;0;3
4906;Lazdynėlis;RIEŠUTĖLIAI;9582702244;Taip;5;0;0;5
4907;Lazdynėlis;RIEŠUTĖLIAI;3062924645;Taip;0;3;0;3
4908;Lazdynėlis;RIEŠUTĖLIAI;3667994076;Taip;6;3;0;9
4909;Lazdynėlis;RIEŠUTĖLIAI;4092363029;Taip;13;0;0;13
4910;Lazdynėlis;RIEŠUTĖLIAI;3250913116;Ne;11;0;2;13
4911;Lazdynėlis;RIEŠUTĖLIAI;8529192130;Taip;0;3;0;3
4912;Lazdynėlis;RIEŠUTĖLIAI;7719697394;Ne;0;0;1;1
4913;Lazdynėlis;ANČIUKAI;9519409694;Taip;8;0;1;9
4914;Lazdynėlis;ANČIUKAI;2526260625;Taip;8;0;0;8
4915;Lazdynėlis;ANČIUKAI;8340712398;Taip;6;1;0;7
4916;Lazdynėlis;ANČIUKAI;6031442797;Taip;0;8;1;9
4917;Lazdynėlis;ANČIUKAI;7552873109;Taip;12;0;1;13
4918;Lazdynėlis;ANČIUKAI;7655218276;Taip;0;2;1;3
4919;Lazdynėlis;ANČIUKAI;7561833526;Taip;15;0;0;15
4920;Lazdynėlis;ANČIUKAI;6817162699;Taip;13;0;3;16
4921;Lazdynėlis;ANČIUKAI;2294873565;Taip;3;0;0;3
4922;Lazdynėlis;ANČIUKAI;1499729462;Taip;0;2;1;3
4923;Lazdynėlis;ANČIUKAI;4745610579;Taip;0;1;1;2
4924;Lazdynėlis;ANČIUKAI;8530159773;Taip;0;0;1;1
4925;Lazdynėlis;ANČIUKAI;3036055537;Taip;0;0;2;2
4926;Lazdynėlis;ANČIUKAI;2911152510;Taip;2;2;6;10
4927;Lazdynėlis;ANČIUKAI;2933025284;Taip;5;10;0;15
4928;Lazdynėlis;ANČIUKAI;5832624944;Taip;0;0;1;1
4929;Lazdynėlis;ANČIUKAI;1168433014;Taip;0;6;1;7
4930;Lazdynėlis;ANČIUKAI;3764854654;Ne;4;0;11;15
4931;Lazdynėlis;ANČIUKAI;1961540377;Taip;3;10;0;13
4932;Lazdynėlis;GUDRUČIAI;4425724586;Taip;7;0;0;7
4933;Lazdynėlis;GUDRUČIAI;4928593615;Taip;0;3;0;3
4934;Lazdynėlis;GUDRUČIAI;6684940385;Taip;4;0;0;4
4935;Lazdynėlis;GUDRUČIAI;9187681789;Ne;0;3;3;6
4936;Lazdynėlis;GUDRUČIAI;6307407620;Taip;0;1;2;3
4937;Lazdynėlis;GUDRUČIAI;1107441074;Taip;0;2;0;2
4938;Lazdynėlis;GUDRUČIAI;24978945607;Taip;0;1;2;3
4939;Lazdynėlis;GUDRUČIAI;18498032472;Taip;0;1;0;1
4940;Lazdynėlis;GUDRUČIAI;158059657;Taip;0;0;1;1
4941;Lazdynėlis;GUDRUČIAI;2587142646;Taip;0;6;1;7
4942;Lazdynėlis;GUDRUČIAI;3902772678;Taip;0;3;0;3
4943;Lazdynėlis;GUDRUČIAI;1386686123;Taip;0;1;0;1
4944;Lazdynėlis;GUDRUČIAI;2603427970;Taip;0;3;0;3
4945;Lazdynėlis;GUDRUČIAI;7965433882;Taip;0;3;0;3
4946;Lazdynėlis;GUDRUČIAI;6863715428;Taip;3;1;0;4
4947;Lazdynėlis;GUDRUČIAI;4779025603;Taip;0;0;3;3
4948;Lazdynėlis;GUDRUČIAI;3043350186;Taip;2;3;0;5
4949;Lazdynėlis;GUDRUČIAI;5182241318;Taip;4;0;0;4
4950;Lazdynėlis;GUDRUČIAI;8008332680;Ne;4;0;0;4
4951;Lazdynėlis;MEŠKIUKAI;4094713096;Taip;8;0;3;11
4952;Lazdynėlis;MEŠKIUKAI;4267469349;Taip;8;0;3;11
4953;Lazdynėlis;MEŠKIUKAI;5354852979;Taip;0;23;0;23
4954;Lazdynėlis;MEŠKIUKAI;3427972329;Taip;7;0;0;7
4955;Lazdynėlis;MEŠKIUKAI;6941986839;Taip;5;0;1;6
4956;Lazdynėlis;MEŠKIUKAI;3697808826;Taip;0;1;0;1
4957;Lazdynėlis;MEŠKIUKAI;2812633983;Taip;10;0;6;16
4958;Lazdynėlis;MEŠKIUKAI;9590507486;Taip;8;0;0;8
4959;Lazdynėlis;MEŠKIUKAI;5982766841;Taip;0;23;0;23
4960;Lazdynėlis;MEŠKIUKAI;1984546310;Taip;3;0;1;4
4961;Lazdynėlis;MEŠKIUKAI;4408660083;Taip;0;23;0;23
4962;Lazdynėlis;MEŠKIUKAI;9930553716;Ne;7;0;0;7
4963;Lazdynėlis;MEŠKIUKAI;6831456807;Taip;5;0;18;23
4964;Lazdynėlis;MEŠKIUKAI;4795464133;Ne;8;0;0;8
4965;Lazdynėlis;MEŠKIUKAI;8567304224;Taip;0;5;2;7
4966;Lazdynėlis;MEŠKIUKAI;7754329238;Ne;1;0;1;2
4967;Lazdynėlis;MEŠKIUKAI;4366502064;Taip;9;0;1;10
4968;Lazdynėlis;MEŠKIUKAI;1331380925;Taip;0;23;0;23
4969;Markučiai;Žirniukų;3525681034;Taip;0;2;0;2
4970;Markučiai;Žirniukų;7312533881;Taip;0;2;0;2
4971;Markučiai;Žirniukų;8679791696;Taip;5;1;0;6
4972;Markučiai;Žirniukų;5269411010;Taip;1;0;1;2
4973;Markučiai;Žirniukų;5250815223;Taip;4;0;12;16
4974;Markučiai;Žirniukų;8934965409;Taip;0;1;0;1
4975;Markučiai;Žirniukų;8360526946;Taip;5;18;0;23
4976;Markučiai;Žirniukų;3073404128;Taip;0;0;2;2
4977;Markučiai;Žirniukų;6674351628;Ne;5;0;4;9
4978;Markučiai;Žirniukų;5614488534;Ne;3;2;6;11
4979;Markučiai;Žirniukų;2367999201;Taip;0;0;6;6
4980;Markučiai;Žirniukų;4242575616;Taip;0;0;2;2
4981;Markučiai;Žirniukų;4223653505;Taip;1;0;2;3
4982;Markučiai;Žirniukų;3802897432;Taip;10;0;19;29
4983;Markučiai;Žirniukų;2099285475;Taip;10;1;2;13
4984;Markučiai;Žirniukų;2344252204;Ne;17;0;5;22
4985;Markučiai;Žirniukų;9576412366;Taip;0;2;0;2
4986;Markučiai;Žirniukų;1395241501;Taip;0;0;4;4
4987;Markučiai;Nykštukų;9545967631;Taip;0;1;0;1
4988;Markučiai;Nykštukų;6898055631;Ne;9;4;1;14
4989;Markučiai;Nykštukų;3378749042;Taip;4;4;7;15
4990;Markučiai;Nykštukų;1884388847;Taip;0;1;0;1
4991;Markučiai;Nykštukų;2170380827;Taip;3;1;0;4
4992;Markučiai;Nykštukų;4485929800;Taip;5;0;0;5
4993;Markučiai;Nykštukų;5183244346;Taip;0;1;0;1
4994;Markučiai;Nykštukų;7624913025;Taip;0;15;0;15
4995;Markučiai;Nykštukų;2994895532;Taip;17;4;0;21
4996;Markučiai;Nykštukų;4150956779;Taip;0;11;0;11
4997;Markučiai;Nykštukų;4920107818;Taip;23;0;0;23
4998;Markučiai;Nykštukų;7680126946;Taip;7;0;9;16
4999;Markučiai;Nykštukų;4222017733;Taip;0;0;4;4
5000;Markučiai;Nykštukų;3414015064;Ne;5;0;3;8
5001;Markučiai;Nykštukų;7642401516;Taip;5;0;1;6
5002;Markučiai;Nykštukų;8055783293;Ne;8;0;0;8
5003;Markučiai;Pelėdžiukų;9180404247;Ne;8;0;6;14
5004;Markučiai;Pelėdžiukų;3386071459;Taip;9;5;0;14
5005;Markučiai;Pelėdžiukų;4653663237;Taip;15;0;1;16
5006;Markučiai;Pelėdžiukų;5727655114;Taip;5;0;0;5
5007;Markučiai;Pelėdžiukų;6740434675;Taip;7;0;1;8
5008;Markučiai;Pelėdžiukų;6707310242;Taip;6;5;3;14
5009;Markučiai;Pelėdžiukų;7947287013;Taip;1;0;0;1
5010;Markučiai;Pelėdžiukų;2543313198;Taip;10;4;2;16
5011;Markučiai;Pelėdžiukų;4418580273;Taip;4;0;0;4
5012;Markučiai;Pelėdžiukų;5522654429;Taip;14;4;0;18
5013;Markučiai;Pelėdžiukų;9219710045;Taip;0;0;1;1
5014;Markučiai;Pelėdžiukų;7539605426;Taip;5;0;0;5
5015;Markučiai;Pelėdžiukų;8888538915;Taip;5;0;0;5
5016;Markučiai;Pelėdžiukų;1623728091;Taip;9;0;0;9
5017;Markučiai;Pelėdžiukų;1799946177;Taip;8;0;0;8
5018;Markučiai;Pelėdžiukų;7809719827;Ne;7;0;4;11
5019;Markučiai;Pelėdžiukų;4860961508;Taip;14;1;1;16
5020;Markučiai;Pelėdžiukų;6260010822;Taip;5;2;1;8
5021;Markučiai;Boružėlių;1171899107;Taip;0;3;0;3
5022;Markučiai;Boružėlių;8078777204;Taip;8;0;0;8
5023;Markučiai;Boružėlių;3755794133;Taip;0;4;0;4
5024;Markučiai;Boružėlių;8244065962;Taip;0;1;0;1
5025;Markučiai;Boružėlių;5902165968;Taip;23;0;0;23
5026;Markučiai;Boružėlių;5981692282;Taip;0;0;1;1
5027;Markučiai;Boružėlių;3739566642;Taip;0;7;0;7
5028;Markučiai;Boružėlių;6868394315;Taip;0;3;0;3
5029;Markučiai;Boružėlių;5663147778;Taip;10;3;2;15
5030;Markučiai;Boružėlių;8271830626;Taip;16;3;1;20
5031;Markučiai;Boružėlių;8046320044;Ne;10;0;1;11
5032;Markučiai;Boružėlių;4244217571;Ne;5;0;0;5
5033;Markučiai;Boružėlių;3315824027;Taip;0;0;9;9
5034;Markučiai;Boružėlių;2060024771;Taip;0;0;7;7
5035;Markučiai;Boružėlių;2539486337;Taip;5;0;3;8
5036;Markučiai;Boružėlių;5562960498;Ne;0;6;2;8
5037;Markučiai;Bitučių;1720541082;Taip;3;1;0;4
5038;Markučiai;Bitučių;8792524832;Taip;3;2;0;5
5039;Markučiai;Bitučių;9518247571;Taip;4;4;0;8
5040;Markučiai;Bitučių;4836298058;Ne;0;0;6;6
5041;Markučiai;Bitučių;9027071539;Taip;11;2;0;13
5042;Markučiai;Bitučių;8748794886;Taip;0;0;15;15
5043;Markučiai;Bitučių;7387460586;Taip;0;1;0;1
5044;Markučiai;Bitučių;8950442843;Taip;11;8;2;21
5045;Markučiai;Bitučių;2840564082;Taip;0;1;0;1
5046;Markučiai;Bitučių;3926993383;Taip;0;0;7;7
5047;Markučiai;Bitučių;6530101961;Taip;16;2;1;19
5048;Markučiai;Bitučių;1908302738;Taip;14;0;3;17
5049;Markučiai;Bitučių;7056367646;Taip;5;4;3;12
5050;Markučiai;Bitučių;8195584468;Taip;6;0;1;7
5051;Markučiai;Bitučių;2049497686;Taip;12;9;0;21
5052;Markučiai;Bitučių;9303448709;Taip;2;0;2;4
5053;Markučiai;Bitučių;8541042547;Taip;0;0;3;3
5054;Markučiai;Bitučių;1447116821;Taip;4;0;1;5
5055;Markučiai;Bitučių;2931958829;Taip;0;1;1;2
5056;Markučiai;Drugelių;3544565354;Taip;10;0;2;12
5057;Markučiai;Drugelių;6992161129;Taip;14;0;0;14
5058;Markučiai;Drugelių;5024860112;Taip;8;0;0;8
5059;Markučiai;Drugelių;9412129807;Taip;0;0;7;7
5060;Markučiai;Drugelių;6979218594;Taip;8;0;0;8
5061;Markučiai;Drugelių;3491734422;Taip;0;0;8;8
5062;Markučiai;Drugelių;3491734422;Taip;0;0;8;8
5063;Markučiai;Drugelių;3491734422;Taip;0;0;8;8
5064;Markučiai;Drugelių;3832641521;Taip;8;0;0;8
5065;Markučiai;Drugelių;4520724770;Taip;4;0;0;4
5066;Markučiai;Drugelių;9391866085;Taip;0;0;2;2
5067;Markučiai;Drugelių;9073616238;Taip;14;0;0;14
5068;Markučiai;Drugelių;4918717178;Taip;8;0;3;11
5069;Markučiai;Drugelių;2967726802;Ne;5;0;0;5
5070;Markučiai;Drugelių;6684544229;Taip;0;0;6;6
5071;Markučiai;Skruzdėliukų;5566529492;Taip;19;0;0;19
5072;Markučiai;Skruzdėliukų;8105747904;Ne;12;1;0;13
5073;Markučiai;Skruzdėliukų;6617799980;Taip;0;6;0;6
5074;Markučiai;Skruzdėliukų;4369408254;Taip;23;0;0;23
5075;Markučiai;Skruzdėliukų;7580249913;Taip;20;0;0;20
5076;Markučiai;Skruzdėliukų;9921530582;Taip;15;0;1;16
5077;Markučiai;Skruzdėliukų;6759427415;Taip;2;0;0;2
5078;Markučiai;Skruzdėliukų;4820576711;Taip;13;0;1;14
5079;Markučiai;Skruzdėliukų;1527620947;Taip;13;7;0;20
5080;Markučiai;Skruzdėliukų;8774323234;Taip;4;0;0;4
5081;Markučiai;Skruzdėliukų;7881183912;Taip;10;3;0;13
5082;Markučiai;Skruzdėliukų;9338996275;Taip;19;0;0;19
5083;Markučiai;Skruzdėliukų;5180034556;Taip;11;0;0;11
5084;Markučiai;Skruzdėliukų;4383128686;Taip;9;0;0;9
5085;Markučiai;ZUIKUČIŲ;82320812575;Taip;5;0;0;5
5086;Markučiai;ZUIKUČIŲ;4861535057;Taip;0;3;0;3
5087;Markučiai;ZUIKUČIŲ;11751635395;Taip;0;3;0;3
5088;Markučiai;ZUIKUČIŲ;1184908076;Taip;0;0;1;1
5089;Markučiai;ZUIKUČIŲ;7729045227;Taip;2;3;1;6
5090;Markučiai;ZUIKUČIŲ;8061880631;Taip;0;1;0;1
5091;Markučiai;ZUIKUČIŲ;1392582514;Taip;0;4;0;4
5092;Markučiai;ZUIKUČIŲ;7691410556;Taip;0;4;0;4
5093;Markučiai;ZUIKUČIŲ;6453095915;Taip;0;3;3;6
5094;Markučiai;ZUIKUČIŲ;6808291628;Taip;0;17;0;17
5095;Markučiai;ZUIKUČIŲ;5387571295;Taip;5;3;0;8
5096;Markučiai;ZUIKUČIŲ;3794643964;Taip;8;3;0;11
5097;Markučiai;ZUIKUČIŲ;5749873170;Taip;0;3;3;6
5098;Markučiai;ZUIKUČIŲ;8605357678;Taip;0;1;0;1
5099;Markučiai;ZUIKUČIŲ;6055058096;Taip;11;0;4;15
5100;Markučiai;ZUIKUČIŲ;1956224017;Taip;6;0;0;6
5101;Markučiai;ŽIOGELIŲ;3163226803;Taip;5;4;5;14
5102;Markučiai;ŽIOGELIŲ;1244026489;Taip;0;6;0;6
5103;Markučiai;ŽIOGELIŲ;76025616287;Ne;0;7;0;7
5104;Markučiai;ŽIOGELIŲ;54892037118;Taip;0;5;3;8
5105;Markučiai;ŽIOGELIŲ;1054802708;Taip;0;2;2;4
5106;Markučiai;ŽIOGELIŲ;67074776419;Taip;0;2;0;2
5107;Markučiai;ŽIOGELIŲ;1007919702;Taip;0;14;0;14
5108;Markučiai;ŽIOGELIŲ;1923521405;Taip;0;1;0;1
5109;Markučiai;ŽIOGELIŲ;1164386108;Taip;0;2;0;2
5110;Markučiai;ŽIOGELIŲ;7850311496;Ne;0;10;0;10
5111;Markučiai;ŽIOGELIŲ;2169583290;Ne;0;6;0;6
5112;Markučiai;ŽIOGELIŲ;3340385503;Ne;0;1;1;2
5113;Markučiai;ŽIOGELIŲ;4152184290;Taip;0;2;1;3
5114;Markučiai;ŽIOGELIŲ;1742944578;Taip;0;1;0;1
5115;Markučiai;ŽIOGELIŲ;23267867195;Taip;0;4;1;5
5116;Markučiai;ŽIOGELIŲ;7481923902;Taip;0;2;2;4
5117;Markučiai;ŽIOGELIŲ;4324776209;Ne;0;2;0;2
5118;Markučiai;ŽIOGELIŲ;3893711315;Ne;0;2;0;2
5119;Markučiai;Ežiukių;1827829954;Taip;6;7;0;13
5120;Markučiai;Ežiukių;4925856706;Taip;0;8;0;8
5121;Markučiai;Ežiukių;6570638672;Taip;0;12;0;12
5122;Markučiai;Ežiukių;5975331223;Taip;0;2;2;4
5123;Markučiai;Ežiukių;2687320408;Taip;0;1;0;1
5124;Markučiai;Ežiukių;8990923872;Taip;5;10;0;15
5125;Markučiai;Ežiukių;5246980173;Taip;1;0;0;1
5126;Markučiai;Ežiukių;6308368050;Taip;15;1;0;16
5127;Markučiai;Ežiukių;4249158803;Taip;9;1;0;10
5128;Markučiai;Ežiukių;5958705106;Taip;5;3;0;8
5129;Markučiai;Ežiukių;1769984489;Taip;0;4;4;8
5130;Markučiai;Ežiukių;7791500322;Taip;0;2;0;2
5131;Markučiai;Ežiukių;9059302464;Taip;9;4;9;22
5132;Markučiai;Ežiukių;2962530721;Taip;5;1;0;6
5133;Markučiai;Ežiukių;6574037877;Taip;5;0;0;5
5134;Markučiai;Ežiukių;5752762229;Taip;0;14;0;14
5135;Markučiai;Ežiukių;4383421917;Taip;0;2;0;2
5136;Markučiai;Ežiukių;9789274040;Ne;0;16;1;17
5137;Mažylis;"4 PRIEŠMOKYKLINĖ GR.";9411559447;Taip;0;0;4;4
5138;Mažylis;"4 PRIEŠMOKYKLINĖ GR.";4252408251;Taip;0;0;4;4
5139;Mažylis;"4 PRIEŠMOKYKLINĖ GR.";4503734408;Taip;0;0;4;4
5140;Mažylis;"4 PRIEŠMOKYKLINĖ GR.";8352202912;Taip;0;0;2;2
5141;Mažylis;"4 PRIEŠMOKYKLINĖ GR.";38277640135;Taip;0;4;2;6
5142;Mažylis;"4 PRIEŠMOKYKLINĖ GR.";1663347167;Taip;0;1;10;11
5143;Mažylis;"4 PRIEŠMOKYKLINĖ GR.";6854350717;Taip;0;0;5;5
5144;Mažylis;"4 PRIEŠMOKYKLINĖ GR.";4104052524;Ne;0;1;6;7
5145;Mažylis;"4 PRIEŠMOKYKLINĖ GR.";3860760654;Taip;5;0;4;9
5146;Mažylis;"4 PRIEŠMOKYKLINĖ GR.";7185347381;Taip;0;0;8;8
5147;Mažylis;"4 PRIEŠMOKYKLINĖ GR.";3344476309;Taip;8;0;3;11
5148;Mažylis;"4 PRIEŠMOKYKLINĖ GR.";6851169340;Taip;0;0;3;3
5149;Mažylis;"4 PRIEŠMOKYKLINĖ GR.";4486742281;Taip;0;0;4;4
5150;Mažylis;"4 PRIEŠMOKYKLINĖ GR.";3217527771;Taip;0;4;3;7
5151;Mažylis;"4 PRIEŠMOKYKLINĖ GR.";7416381505;Taip;7;0;8;15
5152;Mažylis;"4 PRIEŠMOKYKLINĖ GR.";1514640197;Taip;0;0;4;4
5153;Mažylis;"4 PRIEŠMOKYKLINĖ GR.";1002832487;Taip;0;0;2;2
5154;Mažylis;"4 PRIEŠMOKYKLINĖ GR.";9608529135;Taip;5;0;8;13
5155;Mažylis;"4 PRIEŠMOKYKLINĖ GR.";4645411379;Taip;0;2;3;5
5156;Mažylis;"3 DARŽELIO GR.";3081814579;Taip;9;3;1;13
5157;Mažylis;"3 DARŽELIO GR.";6100650710;Taip;0;0;1;1
5158;Mažylis;"3 DARŽELIO GR.";9401388775;Taip;14;0;1;15
5159;Mažylis;"3 DARŽELIO GR.";4817146074;Taip;0;0;1;1
5160;Mažylis;"3 DARŽELIO GR.";7106648054;Taip;8;0;0;8
5161;Mažylis;"3 DARŽELIO GR.";6809320247;Taip;0;3;1;4
5162;Mažylis;"3 DARŽELIO GR.";2006289999;Taip;9;0;0;9
5163;Mažylis;"3 DARŽELIO GR.";7652390515;Taip;0;0;6;6
5164;Mažylis;"3 DARŽELIO GR.";8639480781;Taip;8;0;0;8
5165;Mažylis;"3 DARŽELIO GR.";9341935211;Ne;19;0;0;19
5166;Mažylis;"3 DARŽELIO GR.";2989562406;Ne;12;0;0;12
5167;Mažylis;"3 DARŽELIO GR.";1151737098;Taip;9;0;1;10
5168;Mažylis;"3 DARŽELIO GR.";7642914458;Taip;0;4;0;4
5169;Mažylis;"3 DARŽELIO GR.";5938312001;Ne;10;0;0;10
5170;Mažylis;"3 DARŽELIO GR.";2119733659;Taip;6;0;4;10
5171;Mažylis;"3 DARŽELIO GR.";3126627913;Ne;13;0;3;16
5172;Mažylis;"3 DARŽELIO GR.";6904083734;Taip;11;0;0;11
5173;Mažylis;"3 DARŽELIO GR.";2319506343;Taip;0;0;17;17
5174;Mažylis;"3 DARŽELIO GR.";9416161833;Taip;6;0;0;6
5175;Mažylis;"6 DARŽELIO GR.";5388105083;Ne;7;0;3;10
5176;Mažylis;"6 DARŽELIO GR.";8589124394;Taip;9;0;3;12
5177;Mažylis;"6 DARŽELIO GR.";3641990617;Taip;10;0;0;10
5178;Mažylis;"6 DARŽELIO GR.";1892136590;Taip;5;2;0;7
5179;Mažylis;"6 DARŽELIO GR.";9479398581;Taip;8;1;3;12
5180;Mažylis;"6 DARŽELIO GR.";1381828313;Taip;7;0;1;8
5181;Mažylis;"6 DARŽELIO GR.";7725286603;Taip;0;1;8;9
5182;Mažylis;"6 DARŽELIO GR.";7754956214;Taip;4;0;0;4
5183;Mažylis;"6 DARŽELIO GR.";3615636349;Taip;4;0;2;6
5184;Mažylis;"6 DARŽELIO GR.";9894955253;Taip;11;0;2;13
5185;Mažylis;"6 DARŽELIO GR.";3400122626;Taip;9;0;0;9
5186;Mažylis;"6 DARŽELIO GR.";6270840529;Taip;8;0;2;10
5187;Mažylis;"6 DARŽELIO GR.";4100492642;Ne;20;0;0;20
5188;Mažylis;"6 DARŽELIO GR.";5569913242;Taip;11;0;3;14
5189;Mažylis;"6 DARŽELIO GR.";6492768766;Taip;20;0;0;20
5190;Mažylis;"6 DARŽELIO GR.";6423910850;Taip;12;1;0;13
5191;Mažylis;"6 DARŽELIO GR.";1555305826;Taip;10;0;0;10
5192;Mažylis;"6 DARŽELIO GR.";5977423702;Taip;8;0;2;10
5193;Mažylis;"6 DARŽELIO GR.";9562863405;Taip;8;0;0;8
5194;Mažylis;"6 DARŽELIO GR.";5990843024;Taip;14;0;0;14
5195;Mažylis;"6 DARŽELIO GR.";9981751097;Taip;9;0;7;16
5196;Mažylis;"1 NAUJA (LOPŠELIS)";3486363103;Taip;12;0;0;12
5197;Mažylis;"1 NAUJA (LOPŠELIS)";4985161657;Taip;6;0;0;6
5198;Mažylis;"1 NAUJA (LOPŠELIS)";5297935198;Taip;12;0;0;12
5199;Mažylis;"1 NAUJA (LOPŠELIS)";1993916098;Taip;7;0;0;7
5200;Mažylis;"1 NAUJA (LOPŠELIS)";4309902086;Taip;4;0;3;7
5201;Mažylis;"1 NAUJA (LOPŠELIS)";5727207294;Taip;10;0;0;10
5202;Mažylis;"1 NAUJA (LOPŠELIS)";3064367996;Taip;0;12;0;12
5203;Mažylis;"1 NAUJA (LOPŠELIS)";2110320072;Taip;6;0;0;6
5204;Mažylis;"1 NAUJA (LOPŠELIS)";7810360699;Taip;0;0;4;4
5205;Mažylis;"1 NAUJA (LOPŠELIS)";3911343193;Taip;0;0;4;4
5206;Mažylis;"1 NAUJA (LOPŠELIS)";5225388496;Taip;0;3;4;7
5207;Mažylis;"1 NAUJA (LOPŠELIS)";8259994523;Taip;2;0;2;4
5208;Mažylis;"1 NAUJA (LOPŠELIS)";6500577246;Taip;0;4;1;5
5209;Mažylis;"1 NAUJA (LOPŠELIS)";3098913589;Taip;10;0;0;10
5210;Mažylis;"1 NAUJA (LOPŠELIS)";4201114033;Taip;10;0;0;10
5211;Mažylis;"1 NAUJA (LOPŠELIS)";9025867358;Taip;5;0;0;5
5212;Mažylis;"5 DARŽELIO GR.";2935175014;Taip;17;0;2;19
5213;Mažylis;"5 DARŽELIO GR.";6162880220;Taip;0;3;1;4
5214;Mažylis;"5 DARŽELIO GR.";1762105763;Taip;7;1;0;8
5215;Mažylis;"5 DARŽELIO GR.";2672500259;Taip;0;0;1;1
5216;Mažylis;"5 DARŽELIO GR.";8135596731;Taip;12;0;5;17
5217;Mažylis;"5 DARŽELIO GR.";8866980930;Taip;13;0;0;13
5218;Mažylis;"5 DARŽELIO GR.";2704741847;Ne;0;4;0;4
5219;Mažylis;"5 DARŽELIO GR.";3327673298;Taip;0;0;1;1
5220;Mažylis;"5 DARŽELIO GR.";4280547746;Taip;0;3;0;3
5221;Mažylis;"5 DARŽELIO GR.";9447747294;Taip;0;0;8;8
5222;Mažylis;"5 DARŽELIO GR.";4542742002;Taip;9;0;6;15
5223;Mažylis;"5 DARŽELIO GR.";2126108232;Taip;0;3;4;7
5224;Mažylis;"5 DARŽELIO GR.";4553092508;Ne;0;0;2;2
5225;Mažylis;"5 DARŽELIO GR.";8297427176;Taip;6;2;5;13
5226;Mažylis;"5 DARŽELIO GR.";6009637985;Taip;7;0;1;8
5227;Mažylis;"5 DARŽELIO GR.";5685988186;Taip;7;0;0;7
5228;Mažylis;"5 DARŽELIO GR.";5870983755;Taip;0;0;4;4
5229;Mažylis;"5 DARŽELIO GR.";8999239172;Ne;0;0;3;3
5230;Mažylis;"5 DARŽELIO GR.";3365026025;Taip;12;0;0;12
5231;Mažylis;"DARŽELIS 2 GR.";2795618410;Taip;6;3;5;14
5232;Mažylis;"DARŽELIS 2 GR.";9727982334;Ne;15;0;3;18
5233;Mažylis;"DARŽELIS 2 GR.";8655053217;Taip;10;0;0;10
5234;Mažylis;"DARŽELIS 2 GR.";7414398772;Taip;0;0;4;4
5235;Mažylis;"DARŽELIS 2 GR.";1058725505;Taip;10;7;0;17
5236;Mažylis;"DARŽELIS 2 GR.";9111101357;Taip;11;0;2;13
5237;Mažylis;"DARŽELIS 2 GR.";1533948576;Taip;0;0;1;1
5238;Mažylis;"DARŽELIS 2 GR.";6728351360;Ne;5;0;0;5
5239;Mažylis;"DARŽELIS 2 GR.";6272047137;Taip;0;2;6;8
5240;Mažylis;"DARŽELIS 2 GR.";7255856938;Taip;10;0;8;18
5241;Mažylis;"DARŽELIS 2 GR.";4987487972;Taip;34;0;0;34
5242;Mažylis;"DARŽELIS 2 GR.";9555408203;Taip;3;0;0;3
5243;Mažylis;"DARŽELIS 2 GR.";5165268747;Taip;7;0;5;12
5244;Mažylis;"DARŽELIS 2 GR.";2425437724;Taip;0;0;9;9
5245;Mažylis;"DARŽELIS 2 GR.";2723677422;Taip;11;0;0;11
5246;Mažylis;"DARŽELIS 2 GR.";9875575387;Ne;0;0;1;1
5247;Medynėlis;BITUTĖS;6238256156;Ne;11;1;0;12
5248;Medynėlis;BITUTĖS;8711567312;Taip;0;0;3;3
5249;Medynėlis;BITUTĖS;2993705115;Taip;0;4;8;12
5250;Medynėlis;BITUTĖS;1504612730;Taip;14;0;0;14
5251;Medynėlis;BITUTĖS;5522261530;Taip;7;2;0;9
5252;Medynėlis;BITUTĖS;6576401514;Taip;8;0;0;8
5253;Medynėlis;BITUTĖS;4107846958;Taip;0;4;0;4
5254;Medynėlis;BITUTĖS;7296044569;Taip;0;2;0;2
5255;Medynėlis;BITUTĖS;4418330478;Taip;8;0;2;10
5256;Medynėlis;BITUTĖS;7042766873;Taip;4;0;3;7
5257;Medynėlis;BITUTĖS;6074296305;Taip;0;2;0;2
5258;Medynėlis;BITUTĖS;6815521895;Ne;5;2;1;8
5259;Medynėlis;BITUTĖS;4374464298;Taip;13;0;0;13
5260;Medynėlis;BITUTĖS;8877104963;Taip;23;0;0;23
5261;Medynėlis;BITUTĖS;8107171123;Ne;9;3;0;12
5262;Medynėlis;BITUTĖS;4545707752;Taip;15;0;0;15
5263;Medynėlis;BITUTĖS;4419503239;Taip;5;0;0;5
5264;Medynėlis;BITUTĖS;7870261906;Taip;0;4;0;4
5265;Medynėlis;BITUTĖS;6466874318;Taip;5;4;0;9
5266;Medynėlis;BITUTĖS;2798305000;Taip;2;1;1;4
5267;Medynėlis;BITUTĖS;5440233814;Taip;7;0;0;7
5268;Medynėlis;BITUTĖS;4598267411;Ne;6;1;1;8
5269;Medynėlis;BITUTĖS;5194220650;Taip;4;10;0;14
5270;Medynėlis;DRUGELIAI;7886801955;Taip;20;0;0;20
5271;Medynėlis;DRUGELIAI;6127747445;Ne;0;1;0;1
5272;Medynėlis;DRUGELIAI;33981260502;Taip;0;0;7;7
5273;Medynėlis;DRUGELIAI;4581683292;Taip;0;4;0;4
5274;Medynėlis;DRUGELIAI;7633674694;Taip;0;8;0;8
5275;Medynėlis;DRUGELIAI;6343851636;Taip;0;2;0;2
5276;Medynėlis;DRUGELIAI;8948133343;Taip;0;2;0;2
5277;Medynėlis;DRUGELIAI;9413309043;Taip;0;4;0;4
5278;Medynėlis;DRUGELIAI;3773215372;Taip;2;3;0;5
5279;Medynėlis;DRUGELIAI;1795479738;Taip;10;4;0;14
5280;Medynėlis;DRUGELIAI;4024866819;Taip;5;1;0;6
5281;Medynėlis;DRUGELIAI;7244497661;Taip;9;1;0;10
5282;Medynėlis;DRUGELIAI;8775219704;Taip;0;2;0;2
5283;Medynėlis;DRUGELIAI;5269927048;Taip;0;1;0;1
5284;Medynėlis;DRUGELIAI;1827495325;Taip;0;3;0;3
5285;Medynėlis;DRUGELIAI;2540325264;Ne;6;3;0;9
5286;Medynėlis;DRUGELIAI;3870665108;Ne;0;1;0;1
5287;Medynėlis;DRUGELIAI;9670396828;Taip;0;3;0;3
5288;Medynėlis;DRUGELIAI;2627421550;Taip;0;1;0;1
5289;Medynėlis;DRUGELIAI;2794274146;Taip;0;1;0;1
5290;Medynėlis;SKRUZDĖLIUKAI;4783894465;Taip;10;0;1;11
5291;Medynėlis;SKRUZDĖLIUKAI;3905440176;Taip;3;0;0;3
5292;Medynėlis;SKRUZDĖLIUKAI;1142044361;Taip;6;4;0;10
5293;Medynėlis;SKRUZDĖLIUKAI;8719860414;Ne;8;0;0;8
5294;Medynėlis;SKRUZDĖLIUKAI;6802308420;Taip;1;2;0;3
5295;Medynėlis;SKRUZDĖLIUKAI;4645171858;Taip;0;1;0;1
5296;Medynėlis;SKRUZDĖLIUKAI;3947494044;Taip;7;2;0;9
5297;Medynėlis;SKRUZDĖLIUKAI;3295727210;Taip;15;1;0;16
5298;Medynėlis;SKRUZDĖLIUKAI;8215856660;Ne;8;15;0;23
5299;Medynėlis;SKRUZDĖLIUKAI;8441629302;Taip;12;3;0;15
5300;Medynėlis;SKRUZDĖLIUKAI;3761140697;Taip;8;0;1;9
5301;Medynėlis;SKRUZDĖLIUKAI;5330900656;Taip;8;0;1;9
5302;Medynėlis;SKRUZDĖLIUKAI;4897227188;Taip;3;3;3;9
5303;Medynėlis;SKRUZDĖLIUKAI;2339692406;Taip;20;0;0;20
5304;Medynėlis;SKRUZDĖLIUKAI;2433997383;Taip;18;0;0;18
5305;Medynėlis;SKRUZDĖLIUKAI;9873696787;Taip;2;0;0;2
5306;Medynėlis;VOVERIUKAI;6107849795;Taip;0;0;5;5
5307;Medynėlis;VOVERIUKAI;6826790492;Taip;1;3;0;4
5308;Medynėlis;VOVERIUKAI;2627655353;Taip;10;0;0;10
5309;Medynėlis;VOVERIUKAI;5267128750;Taip;5;2;0;7
5310;Medynėlis;VOVERIUKAI;7638618099;Taip;11;0;1;12
5311;Medynėlis;VOVERIUKAI;4488439037;Taip;0;3;0;3
5312;Medynėlis;VOVERIUKAI;4100792567;Taip;0;0;1;1
5313;Medynėlis;VOVERIUKAI;6101613567;Taip;0;3;2;5
5314;Medynėlis;VOVERIUKAI;1056744101;Taip;0;9;1;10
5315;Medynėlis;VOVERIUKAI;6485314750;Taip;5;3;0;8
5316;Medynėlis;VOVERIUKAI;7455041214;Ne;15;3;0;18
5317;Medynėlis;VOVERIUKAI;2234994999;Taip;12;1;0;13
5318;Medynėlis;VOVERIUKAI;3761845905;Taip;0;1;8;9
5319;Medynėlis;VOVERIUKAI;4217263449;Taip;0;3;0;3
5320;Medynėlis;VOVERIUKAI;9825580191;Taip;0;2;0;2
5321;Medynėlis;VOVERIUKAI;3554823424;Taip;0;3;0;3
5322;Medynėlis;VOVERIUKAI;7272017225;Taip;0;9;0;9
5323;Medynėlis;VOVERIUKAI;4092824377;Taip;4;8;0;12
5324;Medynėlis;VOVERIUKAI;1475701065;Taip;0;3;0;3
5325;Medynėlis;VOVERIUKAI;3674134340;Taip;0;3;4;7
5326;Medynėlis;VOVERIUKAI;5028189785;Taip;6;0;0;6
5327;Medynėlis;VOVERIUKAI;3235523199;Taip;4;0;0;4
5328;Medynėlis;VOVERIUKAI;2784942324;Ne;3;2;0;5
5329;Medynėlis;MEŠKIUKAI;2086963376;Taip;5;1;1;7
5330;Medynėlis;MEŠKIUKAI;7740591575;Ne;0;3;0;3
5331;Medynėlis;MEŠKIUKAI;9304002459;Taip;0;9;4;13
5332;Medynėlis;MEŠKIUKAI;5586407412;Taip;0;2;1;3
5333;Medynėlis;MEŠKIUKAI;90556319090;Taip;8;0;0;8
5334;Medynėlis;MEŠKIUKAI;2834559432;Taip;0;0;1;1
5335;Medynėlis;MEŠKIUKAI;9800678364;Taip;7;5;2;14
5336;Medynėlis;MEŠKIUKAI;2057309788;Taip;0;1;4;5
5337;Medynėlis;MEŠKIUKAI;5982453884;Taip;3;0;2;5
5338;Medynėlis;MEŠKIUKAI;2310200034;Taip;0;1;0;1
5339;Medynėlis;MEŠKIUKAI;1750775033;Ne;14;1;0;15
5340;Medynėlis;MEŠKIUKAI;8441104709;Taip;5;1;2;8
5341;Medynėlis;MEŠKIUKAI;9123873119;Taip;0;0;2;2
5342;Medynėlis;MEŠKIUKAI;2335108073;Taip;0;1;2;3
5343;Medynėlis;MEŠKIUKAI;1237589979;Taip;0;1;1;2
5344;Medynėlis;MEŠKIUKAI;1820113382;Taip;0;3;0;3
5345;Medynėlis;MEŠKIUKAI;6406459222;Ne;0;3;0;3
5346;Medynėlis;MEŠKIUKAI;1173510831;Ne;3;0;0;3
5347;Medynėlis;MEŠKIUKAI;4985243068;Ne;17;3;1;21
5348;Medynėlis;MEŠKIUKAI;7108619017;Taip;0;1;5;6
5349;Medynėlis;MEŠKIUKAI;6999562417;Taip;0;6;0;6
5350;Medynėlis;MEŠKIUKAI;7140184593;Taip;0;3;0;3
5351;Medynėlis;MEŠKIUKAI;3141225891;Taip;0;3;6;9
5352;Medynėlis;PELĖDŽIUKAI;2932544910;Taip;0;0;1;1
5353;Medynėlis;PELĖDŽIUKAI;9079900803;Taip;5;0;0;5
5354;Medynėlis;PELĖDŽIUKAI;5571641847;Taip;0;1;1;2
5355;Medynėlis;PELĖDŽIUKAI;2103255454;Taip;0;16;0;16
5356;Medynėlis;PELĖDŽIUKAI;9184868565;Taip;0;3;0;3
5357;Medynėlis;PELĖDŽIUKAI;6706028300;Taip;0;0;1;1
5358;Medynėlis;PELĖDŽIUKAI;6073797962;Ne;0;1;0;1
5359;Medynėlis;PELĖDŽIUKAI;4222917765;Taip;0;9;0;9
5360;Medynėlis;PELĖDŽIUKAI;1621499650;Taip;0;9;0;9
5361;Medynėlis;PELĖDŽIUKAI;6681155625;Ne;1;0;0;1
5362;Medynėlis;PELĖDŽIUKAI;9438854582;Taip;0;6;2;8
5363;Medynėlis;PELĖDŽIUKAI;1901805808;Taip;0;1;0;1
5364;Medynėlis;PELĖDŽIUKAI;5784691118;Taip;0;1;1;2
5365;Medynėlis;PELĖDŽIUKAI;4468967036;Taip;0;3;0;3
5366;Medynėlis;PELĖDŽIUKAI;2702814930;Taip;0;12;0;12
5367;Medynėlis;PELĖDŽIUKAI;6113913885;Taip;5;1;0;6
5368;Medynėlis;BORUŽIUKAI;3787172254;Taip;0;3;0;3
5369;Medynėlis;BORUŽIUKAI;7232396755;Taip;0;2;0;2
5370;Medynėlis;BORUŽIUKAI;7651663404;Taip;5;1;0;6
5371;Medynėlis;BORUŽIUKAI;1463263793;Taip;0;6;0;6
5372;Medynėlis;BORUŽIUKAI;1406029765;Taip;0;0;1;1
5373;Medynėlis;BORUŽIUKAI;5532880670;Taip;0;0;9;9
5374;Medynėlis;BORUŽIUKAI;1525185037;Taip;0;1;0;1
5375;Medynėlis;BORUŽIUKAI;9919108302;Taip;0;6;0;6
5376;Medynėlis;BORUŽIUKAI;1162859552;Ne;0;12;0;12
5377;Medynėlis;BORUŽIUKAI;6032067904;Taip;0;2;0;2
5378;Medynėlis;BORUŽIUKAI;4315717555;Taip;0;1;0;1
5379;Medynėlis;BORUŽIUKAI;8276864168;Taip;9;3;0;12
5380;Medynėlis;BORUŽIUKAI;5544663829;Taip;0;1;0;1
5381;Medynėlis;BORUŽIUKAI;2701448160;Ne;0;3;0;3
5382;Medynėlis;BORUŽIUKAI;1658457155;Taip;0;1;4;5
5383;Medynėlis;BORUŽIUKAI;8074251036;Taip;0;3;2;5
5384;Medynėlis;BORUŽIUKAI;5158507933;Taip;5;0;0;5
5385;Medynėlis;BORUŽIUKAI;7501831333;Taip;0;3;0;3
5386;Medynėlis;BORUŽIUKAI;2097758483;Taip;0;5;0;5
5387;Medynėlis;BORUŽIUKAI;4267654911;Taip;0;0;1;1
5388;Medynėlis;EŽIUKAI;9729505759;Taip;0;17;0;17
5389;Medynėlis;EŽIUKAI;8125271445;Taip;0;13;0;13
5390;Medynėlis;EŽIUKAI;9847006679;Taip;8;0;0;8
5391;Medynėlis;EŽIUKAI;7317307957;Taip;0;3;6;9
5392;Medynėlis;EŽIUKAI;7860869675;Taip;0;11;0;11
5393;Medynėlis;EŽIUKAI;4471168173;Taip;0;1;0;1
5394;Medynėlis;EŽIUKAI;1062269215;Taip;0;7;4;11
5395;Medynėlis;EŽIUKAI;5197757730;Taip;0;6;0;6
5396;Medynėlis;EŽIUKAI;5333502849;Taip;0;0;3;3
5397;Medynėlis;EŽIUKAI;6536626390;Taip;5;0;1;6
5398;Medynėlis;EŽIUKAI;8953622684;Taip;11;0;0;11
5399;Medynėlis;EŽIUKAI;3230747109;Taip;5;3;0;8
5400;Medynėlis;EŽIUKAI;9175884049;Taip;0;0;2;2
5401;Medynėlis;EŽIUKAI;8609650186;Taip;0;3;1;4
5402;Medynėlis;EŽIUKAI;6826409129;Taip;15;0;1;16
5403;Medynėlis;EŽIUKAI;2929100410;Taip;10;0;0;10
5404;Medynėlis;EŽIUKAI;6359536923;Ne;5;0;1;6
5405;Medynėlis;EŽIUKAI;2676262920;Taip;10;0;2;12
5406;Medynėlis;EŽIUKAI;5339084041;Taip;0;3;0;3
5407;Medynėlis;EŽIUKAI;5766492584;Taip;0;0;2;2
5408;Medynėlis;EŽIUKAI;6561927001;Taip;10;0;0;10
5409;Medynėlis;EŽIUKAI;8838774666;Taip;23;0;0;23
5410;Medynėlis;EŽIUKAI;6349817783;Taip;3;0;1;4
5411;Medynėlis;ZUIKUČIAI;6614028601;Taip;15;0;0;15
5412;Medynėlis;ZUIKUČIAI;8439619837;Taip;12;0;0;12
5413;Medynėlis;ZUIKUČIAI;5389909872;Taip;0;4;0;4
5414;Medynėlis;ZUIKUČIAI;9352391583;Taip;3;0;9;12
5415;Medynėlis;ZUIKUČIAI;4941353702;Taip;12;0;0;12
5416;Medynėlis;ZUIKUČIAI;4040542730;Taip;9;0;0;9
5417;Medynėlis;ZUIKUČIAI;6989524053;Taip;0;0;9;9
5418;Medynėlis;ZUIKUČIAI;9774213537;Taip;0;1;1;2
5419;Medynėlis;ZUIKUČIAI;9977590259;Taip;23;0;0;23
5420;Medynėlis;ZUIKUČIAI;7813766856;Taip;0;0;2;2
5421;Medynėlis;ZUIKUČIAI;7170801214;Taip;3;0;3;6
5422;Medynėlis;ZUIKUČIAI;9373849916;Taip;16;0;1;17
5423;Medynėlis;ZUIKUČIAI;8678054784;Taip;5;0;0;5
5424;Medynėlis;ZUIKUČIAI;6462589513;Taip;0;1;1;2
5425;Medynėlis;ZUIKUČIAI;4204366008;Taip;0;4;0;4
5426;Medynėlis;ZUIKUČIAI;6569938649;Ne;9;0;1;10
5427;Medynėlis;ZUIKUČIAI;2523474347;Taip;10;4;0;14
5428;Medynėlis;KAČIUKAI;8275097931;Taip;0;3;2;5
5429;Medynėlis;KAČIUKAI;5302122600;Taip;13;0;1;14
5430;Medynėlis;KAČIUKAI;6609111216;Taip;8;0;0;8
5431;Medynėlis;KAČIUKAI;6624835214;Taip;0;5;1;6
5432;Medynėlis;KAČIUKAI;2160081492;Taip;16;0;0;16
5433;Medynėlis;KAČIUKAI;4035587227;Taip;6;1;1;8
5434;Medynėlis;KAČIUKAI;8162771849;Taip;3;0;5;8
5435;Medynėlis;KAČIUKAI;9725019515;Ne;10;0;3;13
5436;Medynėlis;KAČIUKAI;3185760752;Taip;8;0;2;10
5437;Medynėlis;KAČIUKAI;5610660982;Taip;5;0;2;7
5438;Medynėlis;KAČIUKAI;6282113738;Taip;10;0;1;11
5439;Medynėlis;KAČIUKAI;4153545500;Taip;9;2;0;11
5440;Medynėlis;KAČIUKAI;8299034970;Taip;13;0;0;13
5441;Medynėlis;KAČIUKAI;7675101600;Taip;4;0;0;4
5442;Medynėlis;KAČIUKAI;1668143166;Taip;16;2;0;18
5443;Medynėlis;KAČIUKAI;4010058673;Taip;0;1;0;1
5444;Medynėlis;KAČIUKAI;6502531749;Taip;0;0;3;3
5445;Medynėlis;KAČIUKAI;9076139419;Taip;0;3;4;7
5446;Medynėlis;KAČIUKAI;1608019909;Taip;0;5;0;5
5447;Medynėlis;KAČIUKAI;1026253778;Ne;0;0;3;3
5448;Medynėlis;PELIUKAI;3638155321;Taip;23;0;0;23
5449;Medynėlis;PELIUKAI;4243521511;Taip;0;2;3;5
5450;Medynėlis;PELIUKAI;9290099536;Taip;8;0;0;8
5451;Medynėlis;PELIUKAI;1500986498;Ne;0;0;3;3
5452;Medynėlis;PELIUKAI;6924524346;Taip;13;0;0;13
5453;Medynėlis;PELIUKAI;2379829985;Taip;7;7;0;14
5454;Medynėlis;PELIUKAI;6926408544;Taip;9;0;3;12
5455;Medynėlis;PELIUKAI;5391199861;Ne;23;0;0;23
5456;Medynėlis;PELIUKAI;6095795724;Taip;10;0;1;11
5457;Medynėlis;PELIUKAI;7914358405;Taip;0;3;1;4
5458;Medynėlis;PELIUKAI;3538656650;Taip;13;3;2;18
5459;Medynėlis;PELIUKAI;2877881247;Taip;10;3;1;14
5460;Medynėlis;PELIUKAI;4145591997;Taip;10;4;0;14
5461;Medynėlis;PELIUKAI;8382537735;Taip;8;0;0;8
5462;Medynėlis;PELIUKAI;7268418306;Taip;5;0;0;5
5463;Medynėlis;PELIUKAI;6470879334;Ne;4;0;1;5
5464;Medynėlis;PELIUKAI;2816510180;Taip;8;0;0;8
5465;Medynėlis;ANČIUKAI;6730475188;Taip;8;2;0;10
5466;Medynėlis;ANČIUKAI;6824842361;Taip;8;0;1;9
5467;Medynėlis;ANČIUKAI;5677747582;Taip;1;1;2;4
5468;Medynėlis;ANČIUKAI;5269794415;Taip;2;0;2;4
5469;Medynėlis;ANČIUKAI;5049081242;Taip;6;0;3;9
5470;Medynėlis;ANČIUKAI;4910857912;Taip;1;0;2;3
5471;Medynėlis;ANČIUKAI;4817353132;Taip;3;0;0;3
5472;Medynėlis;ANČIUKAI;7613699868;Ne;17;0;0;17
5473;Medynėlis;ANČIUKAI;9336656351;Taip;3;6;4;13
5474;Medynėlis;ANČIUKAI;7085226543;Taip;8;0;0;8
5475;Medynėlis;ANČIUKAI;1283602655;Taip;11;1;0;12
5476;Medynėlis;ANČIUKAI;3556203620;Taip;1;0;1;2
5477;Medynėlis;ANČIUKAI;2896713695;Taip;5;1;1;7
5478;Medynėlis;ANČIUKAI;8887092965;Taip;13;0;2;15
5479;Medynėlis;ANČIUKAI;4626655069;Taip;8;0;0;8
5480;Medynėlis;ANČIUKAI;5456045449;Taip;5;2;0;7
5481;Medynėlis;ANČIUKAI;8667441678;Taip;5;2;0;7
5482;Medynėlis;ANČIUKAI;6896823412;Taip;2;0;0;2
5483;Molinukas;NYKŠTUKAI;6353165459;Taip;0;4;0;4
5484;Molinukas;NYKŠTUKAI;5876669121;Taip;2;3;0;5
5485;Molinukas;NYKŠTUKAI;6087698882;Taip;0;3;0;3
5486;Molinukas;NYKŠTUKAI;2211909678;Taip;19;0;0;19
5487;Molinukas;NYKŠTUKAI;2348120316;Taip;0;1;0;1
5488;Molinukas;NYKŠTUKAI;8053608348;Taip;0;6;2;8
5489;Molinukas;NYKŠTUKAI;7623051674;Taip;7;4;0;11
5490;Molinukas;NYKŠTUKAI;1651650182;Taip;0;2;1;3
5491;Molinukas;NYKŠTUKAI;5580968328;Taip;6;0;0;6
5492;Molinukas;NYKŠTUKAI;8536615996;Taip;0;0;1;1
5493;Molinukas;NYKŠTUKAI;1849018608;Taip;0;4;0;4
5494;Molinukas;NYKŠTUKAI;4171978721;Taip;3;0;0;3
5495;Molinukas;NYKŠTUKAI;5525772579;Taip;0;5;0;5
5496;Molinukas;NYKŠTUKAI;4475594896;Taip;9;5;0;14
5497;Molinukas;NYKŠTUKAI;7248705010;Taip;10;0;1;11
5498;Molinukas;NYKŠTUKAI;4101644021;Taip;0;11;0;11
5499;Molinukas;NYKŠTUKAI;6681397435;Taip;11;0;2;13
5500;Molinukas;ZUIKUČIŲ;9203375647;Taip;12;1;0;13
5501;Molinukas;ZUIKUČIŲ;2982968605;Taip;0;3;0;3
5502;Molinukas;ZUIKUČIŲ;8479427729;Ne;0;8;2;10
5503;Molinukas;ZUIKUČIŲ;4225457772;Taip;10;0;0;10
5504;Molinukas;ZUIKUČIŲ;8114735116;Taip;0;16;0;16
5505;Molinukas;ZUIKUČIŲ;5597119459;Taip;12;3;0;15
5506;Molinukas;ZUIKUČIŲ;8582985479;Taip;14;0;0;14
5507;Molinukas;ZUIKUČIŲ;8490020853;Taip;14;0;0;14
5508;Molinukas;ZUIKUČIŲ;2651732418;Taip;12;0;0;12
5509;Molinukas;ZUIKUČIŲ;8988478990;Taip;0;0;1;1
5510;Molinukas;ZUIKUČIŲ;1059002689;Taip;10;7;0;17
5511;Molinukas;ZUIKUČIŲ;5302191209;Taip;14;0;2;16
5512;Molinukas;ZUIKUČIŲ;1605039166;Taip;5;1;0;6
5513;Molinukas;ZUIKUČIŲ;6804127471;Taip;5;1;0;6
5514;Molinukas;ZUIKUČIŲ;2878262979;Taip;17;0;0;17
5515;Molinukas;ZUIKUČIŲ;7441251480;Taip;0;3;1;4
5516;Molinukas;ZUIKUČIŲ;4733315902;Taip;0;0;3;3
5517;Molinukas;ZUIKUČIŲ;2595941277;Taip;0;0;1;1
5518;Molinukas;ZUIKUČIŲ;4718396549;Taip;14;0;0;14
5519;Molinukas;ZUIKUČIŲ;3577613732;Taip;2;0;0;2
5520;Molinukas;SRAIGIUKŲ;8416644024;Taip;0;0;3;3
5521;Molinukas;SRAIGIUKŲ;1686122652;Taip;0;1;1;2
5522;Molinukas;SRAIGIUKŲ;9948685221;Taip;0;2;5;7
5523;Molinukas;SRAIGIUKŲ;6326031969;Taip;0;3;0;3
5524;Molinukas;SRAIGIUKŲ;6636118069;Taip;0;10;0;10
5525;Molinukas;SRAIGIUKŲ;1469884686;Taip;5;0;0;5
5526;Molinukas;SRAIGIUKŲ;1856269656;Taip;0;3;0;3
5527;Molinukas;SRAIGIUKŲ;7377137582;Taip;0;13;0;13
5528;Molinukas;SRAIGIUKŲ;6084682084;Taip;0;6;0;6
5529;Molinukas;SRAIGIUKŲ;8913137310;Ne;4;5;3;12
5530;Molinukas;SRAIGIUKŲ;5387818175;Taip;0;1;0;1
5531;Molinukas;SRAIGIUKŲ;1138255845;Taip;0;5;0;5
5532;Molinukas;SRAIGIUKŲ;8604288346;Taip;0;3;1;4
5533;Molinukas;SRAIGIUKŲ;4806350914;Taip;13;3;0;16
5534;Molinukas;SRAIGIUKŲ;8617979245;Taip;0;3;3;6
5535;Molinukas;SRAIGIUKŲ;4534279257;Taip;3;11;0;14
5536;Molinukas;SRAIGIUKŲ;4918181437;Taip;3;0;3;6
5537;Molinukas;SRAIGIUKŲ;7451224160;Taip;1;1;0;2
5538;Molinukas;SRAIGIUKŲ;8688180482;Taip;3;2;3;8
5539;Molinukas;SRAIGIUKŲ;3917187380;Taip;0;0;2;2
5540;Molinukas;VOVERIUKAI;3469196411;Taip;0;3;0;3
5541;Molinukas;VOVERIUKAI;4583155940;Taip;0;0;3;3
5542;Molinukas;VOVERIUKAI;8541456847;Taip;0;0;2;2
5543;Molinukas;VOVERIUKAI;2286586693;Taip;13;0;0;13
5544;Molinukas;VOVERIUKAI;9413396859;Taip;1;0;0;1
5545;Molinukas;VOVERIUKAI;6898958282;Taip;2;0;5;7
5546;Molinukas;VOVERIUKAI;4000190261;Taip;0;0;2;2
5547;Molinukas;VOVERIUKAI;5685582215;Taip;5;5;2;12
5548;Molinukas;VOVERIUKAI;2356814145;Taip;0;0;5;5
5549;Molinukas;VOVERIUKAI;7446607510;Taip;11;8;0;19
5550;Molinukas;VOVERIUKAI;9667704959;Taip;0;0;11;11
5551;Molinukas;VOVERIUKAI;8516451290;Taip;7;0;0;7
5552;Molinukas;VOVERIUKAI;3030169626;Taip;0;9;0;9
5553;Molinukas;VOVERIUKAI;3207373459;Taip;0;0;15;15
5554;Molinukas;VOVERIUKAI;1865748733;Ne;0;8;2;10
5555;Molinukas;VOVERIUKAI;4209143136;Taip;15;0;2;17
5556;Molinukas;VOVERIUKAI;5648861702;Taip;15;0;2;17
5557;Molinukas;VOVERIUKAI;4957226547;Taip;0;2;0;2
5558;Molinukas;VOVERIUKAI;8865966572;Taip;0;1;0;1
5559;Molinukas;VOVERIUKAI;4950808381;Taip;0;16;5;21
5560;Molinukas;VOVERIUKAI;7378643086;Taip;4;2;1;7
5561;Molinukas;VOVERIUKAI;2779700726;Taip;8;0;12;20
5562;Molinukas;VOVERIUKAI;6832647220;Taip;0;0;7;7
5563;Molinukas;VOVERIUKAI;8247270556;Taip;0;11;3;14
5564;Molinukas;ŽVIRBLIUKŲ;2935945686;Taip;0;2;6;8
5565;Molinukas;ŽVIRBLIUKŲ;7825545164;Taip;11;0;0;11
5566;Molinukas;ŽVIRBLIUKŲ;6190443233;Taip;2;0;1;3
5567;Molinukas;ŽVIRBLIUKŲ;1831078544;Taip;16;0;0;16
5568;Molinukas;ŽVIRBLIUKŲ;7419801506;Taip;11;3;9;23
5569;Molinukas;ŽVIRBLIUKŲ;6531106368;Taip;10;0;0;10
5570;Molinukas;ŽVIRBLIUKŲ;4122429163;Taip;8;0;4;12
5571;Molinukas;ŽVIRBLIUKŲ;8660958288;Taip;5;0;0;5
5572;Molinukas;ŽVIRBLIUKŲ;9163883190;Taip;18;0;0;18
5573;Molinukas;ŽVIRBLIUKŲ;2862680065;Taip;10;0;0;10
5574;Molinukas;ŽVIRBLIUKŲ;3382913312;Taip;8;0;0;8
5575;Molinukas;ŽVIRBLIUKŲ;3331982964;Taip;19;0;0;19
5576;Molinukas;ŽVIRBLIUKŲ;2448588784;Taip;23;0;0;23
5577;Molinukas;ŽVIRBLIUKŲ;2842168450;Taip;13;0;0;13
5578;Molinukas;KAČIUKŲ;4992887072;Taip;6;0;1;7
5579;Molinukas;KAČIUKŲ;8313486714;Taip;23;0;0;23
5580;Molinukas;KAČIUKŲ;3043679624;Taip;5;0;0;5
5581;Molinukas;KAČIUKŲ;2030429825;Taip;0;5;3;8
5582;Molinukas;KAČIUKŲ;4974513900;Taip;0;0;1;1
5583;Molinukas;KAČIUKŲ;6947938890;Taip;21;0;0;21
5584;Molinukas;KAČIUKŲ;3510936830;Taip;7;0;4;11
5585;Molinukas;KAČIUKŲ;8608465121;Taip;10;0;8;18
5586;"Naminukas (Smėlio g. 13)";Drugeliai;6776805494;Taip;0;3;0;3
5587;"Naminukas (Smėlio g. 13)";Drugeliai;2395070574;Taip;0;4;4;8
5588;"Naminukas (Smėlio g. 13)";Drugeliai;5534073614;Taip;11;1;0;12
5589;"Naminukas (Smėlio g. 13)";Drugeliai;1302119260;Taip;4;4;0;8
5590;"Naminukas (Smėlio g. 13)";Drugeliai;2864905392;Taip;6;4;0;10
5591;"Naminukas (Smėlio g. 13)";Drugeliai;7406775925;Taip;19;3;0;22
5592;"Naminukas (Smėlio g. 13)";Drugeliai;1333462200;Taip;23;0;0;23
5593;"Naminukas (Smėlio g. 13)";Drugeliai;5468218968;Taip;0;3;0;3
5594;"Naminukas (Smėlio g. 13)";Drugeliai;5713661641;Taip;2;0;0;2
5595;"Naminukas (Smėlio g. 13)";Drugeliai;6581925461;Taip;0;6;0;6
5596;"Naminukas (Smėlio g. 13)";Drugeliai;3320805432;Taip;0;1;0;1
5597;"Naminukas (Smėlio g. 13)";Drugeliai;9689866363;Taip;0;0;3;3
5598;"Naminukas (Smėlio g. 13)";Drugeliai;2198493034;Taip;4;6;0;10
5599;"Naminukas (Smėlio g. 13)";Drugeliai;8141324449;Taip;15;1;0;16
5600;"Naminukas (Smėlio g. 13)";Drugeliai;4599700492;Ne;5;0;0;5
5601;"Naminukas (Smėlio g. 13)";Drugeliai;8564586014;Taip;0;2;0;2
5602;"Naminukas (Smėlio g. 13)";Drugeliai;3236525642;Taip;0;6;0;6
5603;"Naminukas (Smėlio g. 13)";Drugeliai;7347998152;Taip;0;7;0;7
5604;"Naminukas (Smėlio g. 13)";Bitutės;4419568254;Taip;0;3;0;3
5605;"Naminukas (Smėlio g. 13)";Bitutės;1956749138;Taip;0;3;0;3
5606;"Naminukas (Smėlio g. 13)";Bitutės;6503569633;Ne;0;0;7;7
5607;"Naminukas (Smėlio g. 13)";Bitutės;3192885665;Taip;13;0;0;13
5608;"Naminukas (Smėlio g. 13)";Bitutės;9530232649;Taip;4;1;4;9
5609;"Naminukas (Smėlio g. 13)";Bitutės;8131328042;Taip;8;2;0;10
5610;"Naminukas (Smėlio g. 13)";Bitutės;1710002948;Taip;5;1;0;6
5611;"Naminukas (Smėlio g. 13)";Bitutės;3994190066;Taip;0;0;2;2
5612;"Naminukas (Smėlio g. 13)";Bitutės;5195078101;Taip;0;0;1;1
5613;"Naminukas (Smėlio g. 13)";Bitutės;9541388086;Taip;0;4;3;7
5614;"Naminukas (Smėlio g. 13)";Bitutės;2424412518;Taip;10;4;0;14
5615;"Naminukas (Smėlio g. 13)";Bitutės;41538301616;Taip;0;3;0;3
5616;"Naminukas (Smėlio g. 13)";Bitutės;5493709688;Ne;0;4;5;9
5617;"Naminukas (Smėlio g. 13)";Bitutės;9821244713;Ne;3;0;3;6
5618;"Naminukas (Smėlio g. 13)";Bitutės;4331408714;Taip;2;0;0;2
5619;"Naminukas (Smėlio g. 13)";Paukšteliai;3501921619;Ne;1;1;0;2
5620;"Naminukas (Smėlio g. 13)";Paukšteliai;7297661383;Taip;3;0;0;3
5621;"Naminukas (Smėlio g. 13)";Paukšteliai;5056487802;Taip;2;0;0;2
5622;"Naminukas (Smėlio g. 13)";Paukšteliai;3438010199;Taip;1;0;3;4
5623;"Naminukas (Smėlio g. 13)";Paukšteliai;4998565160;Taip;6;6;0;12
5624;"Naminukas (Smėlio g. 13)";Paukšteliai;9405784626;Taip;0;3;11;14
5625;"Naminukas (Smėlio g. 13)";Paukšteliai;2583886896;Taip;3;0;0;3
5626;"Naminukas (Smėlio g. 13)";Paukšteliai;4778385421;Taip;0;7;0;7
5627;"Naminukas (Smėlio g. 13)";Paukšteliai;6178500478;Taip;7;0;0;7
5628;"Naminukas (Smėlio g. 13)";Paukšteliai;1406418130;Taip;0;5;1;6
5629;"Naminukas (Smėlio g. 13)";Paukšteliai;9891722891;Taip;5;0;4;9
5630;"Naminukas (Smėlio g. 13)";Paukšteliai;2012656186;Ne;0;0;4;4
5631;"Naminukas (Smėlio g. 13)";Paukšteliai;8470716196;Taip;1;0;0;1
5632;"Naminukas (Smėlio g. 13)";Paukšteliai;3727828033;Ne;0;3;0;3
5633;"Naminukas (Smėlio g. 13)";Paukšteliai;9657786543;Ne;0;0;4;4
5634;"Naminukas (Smėlio g. 13)";"NYKŠTUKAI ";5849662446;Taip;0;0;4;4
5635;"Naminukas (Smėlio g. 13)";"NYKŠTUKAI ";7646186458;Taip;4;3;0;7
5636;"Naminukas (Smėlio g. 13)";"NYKŠTUKAI ";5519447152;Taip;13;2;0;15
5637;"Naminukas (Smėlio g. 13)";"NYKŠTUKAI ";5741698937;Taip;1;2;1;4
5638;"Naminukas (Smėlio g. 13)";"NYKŠTUKAI ";1286329245;Taip;4;0;3;7
5639;"Naminukas (Smėlio g. 13)";"NYKŠTUKAI ";3424189866;Taip;4;0;2;6
5640;"Naminukas (Smėlio g. 13)";"NYKŠTUKAI ";3355811632;Taip;0;3;0;3
5641;"Naminukas (Smėlio g. 13)";"NYKŠTUKAI ";1618802271;Taip;5;0;8;13
5642;"Naminukas (Smėlio g. 13)";"NYKŠTUKAI ";1591540165;Taip;11;2;5;18
5643;"Naminukas (Smėlio g. 13)";"NYKŠTUKAI ";9537360943;Taip;14;0;0;14
5644;"Naminukas (Smėlio g. 13)";"NYKŠTUKAI ";1118193598;Ne;3;1;1;5
5645;"Naminukas (Smėlio g. 13)";"NYKŠTUKAI ";8102805098;Taip;0;0;5;5
5646;"Naminukas (Smėlio g. 13)";"NYKŠTUKAI ";9357758815;Taip;0;0;3;3
5647;Nykštukas;SMAGURIAI;8120626738;Taip;0;7;0;7
5648;Nykštukas;SMAGURIAI;9842748132;Ne;8;6;0;14
5649;Nykštukas;SMAGURIAI;1902253981;Taip;0;4;0;4
5650;Nykštukas;SMAGURIAI;9713859038;Ne;6;0;0;6
5651;Nykštukas;SMAGURIAI;7954996421;Taip;0;4;0;4
5652;Nykštukas;SMAGURIAI;6139988523;Taip;5;0;0;5
5653;Nykštukas;SMAGURIAI;5190754451;Taip;0;2;0;2
5654;Nykštukas;SMAGURIAI;8310484267;Taip;0;1;0;1
5655;Nykštukas;SMAGURIAI;1707956308;Taip;0;3;0;3
5656;Nykštukas;SMAGURIAI;8635571067;Taip;0;5;0;5
5657;Nykštukas;SMAGURIAI;2000207070;Taip;0;2;0;2
5658;Nykštukas;SMAGURIAI;2826079911;Taip;6;2;0;8
5659;Nykštukas;SMAGURIAI;7911842707;Taip;11;3;0;14
5660;Nykštukas;SMAGURIAI;6102907953;Taip;14;0;0;14
5661;Nykštukas;SMAGURIAI;7529677915;Taip;3;2;0;5
5662;Nykštukas;SMAGURIAI;4994727422;Ne;4;7;0;11
5663;Nykštukas;SMAGURIAI;3007541327;Taip;0;8;0;8
5664;Nykštukas;SMALSIUKAI;6958596223;Taip;0;3;0;3
5665;Nykštukas;SMALSIUKAI;3002966681;Taip;0;3;0;3
5666;Nykštukas;SMALSIUKAI;4612171029;Taip;0;3;0;3
5667;Nykštukas;SMALSIUKAI;3120577264;Taip;0;6;0;6
5668;Nykštukas;SMALSIUKAI;1386798219;Taip;0;4;0;4
5669;Nykštukas;SMALSIUKAI;2696384135;Taip;0;1;0;1
5670;Nykštukas;SMALSIUKAI;9532956150;Taip;0;4;0;4
5671;Nykštukas;SMALSIUKAI;3273579005;Taip;3;3;0;6
5672;Nykštukas;SMALSIUKAI;3985610575;Taip;4;9;0;13
5673;Nykštukas;SMALSIUKAI;8948554271;Taip;4;1;0;5
5674;Nykštukas;SMALSIUKAI;1102555964;Taip;0;4;2;6
5675;Nykštukas;SMALSIUKAI;6112448299;Taip;0;3;0;3
5676;Nykštukas;SMALSIUKAI;1930357859;Taip;10;0;0;10
5677;Nykštukas;SMALSIUKAI;9100510105;Taip;5;0;0;5
5678;Nykštukas;SMALSIUKAI;9303832542;Taip;0;0;3;3
5679;Nykštukas;SMALSIUKAI;9779645295;Taip;7;3;0;10
5680;Nykštukas;SMALSIUKAI;2571249434;Taip;0;2;0;2
5681;Nykštukas;AITVARIUKAI;6923345088;Taip;0;2;1;3
5682;Nykštukas;AITVARIUKAI;8580777381;Taip;0;6;0;6
5683;Nykštukas;AITVARIUKAI;9216544103;Taip;6;12;0;18
5684;Nykštukas;AITVARIUKAI;9319066179;Taip;3;11;0;14
5685;Nykštukas;AITVARIUKAI;2177539882;Taip;13;0;0;13
5686;Nykštukas;AITVARIUKAI;9595654681;Taip;0;1;0;1
5687;Nykštukas;AITVARIUKAI;9894698453;Taip;0;2;0;2
5688;Nykštukas;AITVARIUKAI;6351178752;Taip;0;0;1;1
5689;Nykštukas;AITVARIUKAI;7332769878;Taip;0;1;0;1
5690;Nykštukas;AITVARIUKAI;7896338372;Taip;13;0;0;13
5691;Nykštukas;AITVARIUKAI;2208319289;Taip;0;6;0;6
5692;Nykštukas;AITVARIUKAI;5285669371;Taip;0;5;0;5
5693;Nykštukas;AITVARIUKAI;8548820023;Taip;6;3;0;9
5694;Nykštukas;AITVARIUKAI;5972246871;Ne;0;2;0;2
5695;Nykštukas;AITVARIUKAI;5538446312;Ne;21;0;0;21
5696;Nykštukas;AITVARIUKAI;4822304386;Taip;0;0;1;1
5697;Nykštukas;AITVARIUKAI;5292127770;Taip;0;0;3;3
5698;Nykštukas;DAINORĖLIAI;7526936193;Ne;12;0;0;12
5699;Nykštukas;DAINORĖLIAI;7730918105;Ne;15;0;0;15
5700;Nykštukas;DAINORĖLIAI;8475127245;Taip;0;0;2;2
5701;Nykštukas;DAINORĖLIAI;5434220008;Taip;7;0;3;10
5702;Nykštukas;DAINORĖLIAI;1122600949;Taip;7;0;1;8
5703;Nykštukas;DAINORĖLIAI;3853935568;Taip;0;3;0;3
5704;Nykštukas;DAINORĖLIAI;9776630115;Taip;0;6;0;6
5705;Nykštukas;DAINORĖLIAI;5291104224;Taip;6;0;0;6
5706;Nykštukas;DAINORĖLIAI;9524639831;Ne;9;1;0;10
5707;Nykštukas;DAINORĖLIAI;3367348573;Taip;0;12;0;12
5708;Nykštukas;DAINORĖLIAI;5961945345;Taip;6;0;0;6
5709;Nykštukas;DAINORĖLIAI;6561696818;Taip;11;2;0;13
5710;Nykštukas;DAINORĖLIAI;1283453188;Taip;11;0;0;11
5711;Nykštukas;DAINORĖLIAI;1167614164;Taip;8;0;0;8
5712;Nykštukas;DAINORĖLIAI;7473124310;Taip;3;0;1;4
5713;Nykštukas;DAINORĖLIAI;1174618721;Taip;10;1;0;11
5714;Nykštukas;DAINORĖLIAI;8681884252;Taip;0;6;0;6
5715;Nykštukas;DAINORĖLIAI;5255726742;Taip;4;0;1;5
5716;Nykštukas;DAINORĖLIAI;9027355399;Taip;0;12;0;12
5717;Nykštukas;DAINORĖLIAI;4893494144;Taip;0;5;0;5
5718;Nykštukas;DAINORĖLIAI;8318089070;Taip;0;0;2;2
5719;Nykštukas;DAINORĖLIAI;2727074729;Taip;3;0;0;3
5720;Nykštukas;POKŠTUKAI;7382271765;Ne;5;3;0;8
5721;Nykštukas;POKŠTUKAI;1655428422;Taip;0;1;0;1
5722;Nykštukas;POKŠTUKAI;2649916049;Taip;0;5;0;5
5723;Nykštukas;POKŠTUKAI;1796016501;Taip;0;17;0;17
5724;Nykštukas;POKŠTUKAI;5958711585;Taip;0;12;0;12
5725;Nykštukas;POKŠTUKAI;3999004312;Taip;3;3;0;6
5726;Nykštukas;POKŠTUKAI;6719999304;Taip;0;5;0;5
5727;Nykštukas;POKŠTUKAI;8148163137;Taip;0;4;0;4
5728;Nykštukas;POKŠTUKAI;8708184278;Taip;0;1;0;1
5729;Nykštukas;POKŠTUKAI;3843163586;Taip;0;3;0;3
5730;Nykštukas;POKŠTUKAI;3507649457;Taip;5;0;0;5
5731;Nykštukas;POKŠTUKAI;4508625009;Taip;0;5;0;5
5732;Nykštukas;POKŠTUKAI;6698622575;Taip;0;7;0;7
5733;Nykštukas;POKŠTUKAI;2982662650;Taip;0;2;0;2
5734;Nykštukas;POKŠTUKAI;2627736026;Taip;0;13;0;13
5735;Nykštukas;POKŠTUKAI;4401103119;Taip;0;12;0;12
5736;Nykštukas;POKŠTUKAI;5287713634;Taip;0;1;0;1
5737;Nykštukas;KODĖLČIUKAI;8168579152;Taip;19;0;0;19
5738;Nykštukas;KODĖLČIUKAI;9285820767;Ne;9;0;0;9
5739;Nykštukas;KODĖLČIUKAI;2685400939;Ne;5;8;0;13
5740;Nykštukas;KODĖLČIUKAI;3278960733;Ne;0;0;6;6
5741;Nykštukas;KODĖLČIUKAI;5934979528;Taip;9;0;0;9
5742;Nykštukas;KODĖLČIUKAI;3760617860;Ne;0;8;0;8
5743;Nykštukas;KODĖLČIUKAI;6927545099;Taip;0;0;2;2
5744;Nykštukas;KODĖLČIUKAI;8042479133;Taip;3;0;5;8
5745;Nykštukas;KODĖLČIUKAI;6794885966;Taip;3;0;5;8
5746;Nykštukas;KODĖLČIUKAI;7616459970;Taip;4;2;0;6
5747;Nykštukas;KODĖLČIUKAI;2623254163;Taip;9;0;1;10
5748;Nykštukas;KODĖLČIUKAI;9296449928;Taip;10;0;0;10
5749;Nykštukas;KODĖLČIUKAI;2992219360;Taip;0;15;0;15
5750;Nykštukas;KODĖLČIUKAI;8804969886;Taip;3;0;1;4
5751;Nykštukas;KODĖLČIUKAI;3552386621;Taip;18;0;0;18
5752;Nykštukas;KODĖLČIUKAI;3990260342;Taip;11;0;0;11
5753;Nykštukas;KODĖLČIUKAI;2692551262;Taip;0;7;1;8
5754;Nykštukas;PASAKORIAI;2661110617;Taip;11;4;0;15
5755;Nykštukas;PASAKORIAI;3040001373;Taip;5;0;3;8
5756;Nykštukas;PASAKORIAI;1855278809;Taip;0;1;0;1
5757;Nykštukas;PASAKORIAI;8640715657;Taip;5;2;0;7
5758;Nykštukas;PASAKORIAI;5504584349;Taip;1;2;0;3
5759;Nykštukas;PASAKORIAI;7990462246;Taip;0;3;0;3
5760;Nykštukas;PASAKORIAI;9413198245;Taip;5;0;4;9
5761;Nykštukas;PASAKORIAI;2518342041;Taip;0;4;0;4
5762;Nykštukas;PASAKORIAI;7828733135;Taip;0;0;7;7
5763;Nykštukas;PASAKORIAI;4090494707;Taip;5;1;0;6
5764;Nykštukas;PASAKORIAI;3026598985;Taip;0;8;0;8
5765;Nykštukas;PASAKORIAI;9714310539;Taip;0;2;0;2
5766;Nykštukas;PASAKORIAI;4795301170;Taip;4;0;0;4
5767;Nykštukas;PASAKORIAI;4992654449;Taip;13;0;1;14
5768;Nykštukas;PASAKORIAI;5337728911;Taip;0;6;0;6
5769;Nykštukas;PASAKORIAI;9509051946;Ne;0;6;0;6
5770;Nykštukas;PASAKORIAI;2231375994;Taip;0;5;0;5
5771;Nykštukas;PASAKORIAI;8371081106;Taip;8;4;0;12
5772;Nykštukas;GUDRUČIAI;9871410323;Taip;0;5;0;5
5773;Nykštukas;GUDRUČIAI;4559818614;Taip;0;1;0;1
5774;Nykštukas;GUDRUČIAI;9250827058;Ne;0;2;0;2
5775;Nykštukas;GUDRUČIAI;7447202642;Taip;15;0;0;15
5776;Nykštukas;GUDRUČIAI;1714708754;Taip;0;0;1;1
5777;Nykštukas;GUDRUČIAI;5157799354;Taip;11;1;0;12
5778;Nykštukas;GUDRUČIAI;4325369395;Taip;0;1;0;1
5779;Nykštukas;GUDRUČIAI;6630804505;Taip;0;4;0;4
5780;Nykštukas;GUDRUČIAI;8363202198;Taip;0;1;0;1
5781;Nykštukas;GUDRUČIAI;7326535810;Taip;5;1;0;6
5782;Nykštukas;GUDRUČIAI;9712596180;Ne;3;0;0;3
5783;Nykštukas;GUDRUČIAI;9941937734;Taip;0;1;1;2
5784;Nykštukas;GUDRUČIAI;3619459404;Taip;0;3;0;3
5785;Nykštukas;GUDRUČIAI;7604740418;Taip;0;1;1;2
5786;Nykštukas;GUDRUČIAI;2970293467;Taip;10;6;0;16
5787;Nykštukas;GUDRUČIAI;2881323571;Ne;5;3;0;8
5788;Nykštukas;GUDRUČIAI;9437700329;Taip;5;4;0;9
5789;Nykštukas;GUDRUČIAI;2872277381;Taip;5;0;0;5
5790;Nykštukas;GUDRUČIAI;9940519259;Ne;0;1;0;1
5791;Nykštukas;NAMINUKAI;7456007276;Taip;0;4;0;4
5792;Nykštukas;NAMINUKAI;7176519994;Taip;3;2;0;5
5793;Nykštukas;NAMINUKAI;2440574056;Taip;0;5;0;5
5794;Nykštukas;NAMINUKAI;4064016871;Taip;0;3;0;3
5795;Nykštukas;NAMINUKAI;9054070492;Taip;0;3;0;3
5796;Nykštukas;NAMINUKAI;6106373554;Ne;11;0;0;11
5797;Nykštukas;NAMINUKAI;5032283848;Taip;5;1;0;6
5798;Nykštukas;NAMINUKAI;7494444468;Taip;2;1;0;3
5799;Nykštukas;NAMINUKAI;3925958632;Taip;2;1;0;3
5800;Nykštukas;NAMINUKAI;7976689381;Taip;7;0;0;7
5801;Nykštukas;NAMINUKAI;9686815141;Taip;6;3;0;9
5802;Nykštukas;NAMINUKAI;4503830456;Taip;0;2;0;2
5803;Nykštukas;NAMINUKAI;4040123876;Taip;0;12;0;12
5804;Nykštukas;NAMINUKAI;1088633575;Taip;11;4;0;15
5805;Nykštukas;NAMINUKAI;5088668786;Taip;6;12;0;18
5806;Nykštukas;NAMINUKAI;1510338621;Taip;14;0;0;14
5807;Nykštukas;NAMINUKAI;9067774103;Ne;18;2;0;20
5808;Nykštukas;NAMINUKAI;3405633312;Ne;0;5;0;5
5809;Nykštukas;KŪLVERSTUKAI;8827094160;Taip;6;3;0;9
5810;Nykštukas;KŪLVERSTUKAI;1148800623;Ne;5;0;0;5
5811;Nykštukas;KŪLVERSTUKAI;6786896381;Taip;5;2;0;7
5812;Nykštukas;KŪLVERSTUKAI;6883272732;Taip;9;0;2;11
5813;Nykštukas;KŪLVERSTUKAI;8919778025;Taip;8;1;0;9
5814;Nykštukas;KŪLVERSTUKAI;4490310109;Ne;0;3;0;3
5815;Nykštukas;KŪLVERSTUKAI;2947976429;Taip;8;0;0;8
5816;Nykštukas;KŪLVERSTUKAI;2763268154;Ne;0;1;1;2
5817;Nykštukas;KŪLVERSTUKAI;9887096503;Taip;13;3;0;16
5818;Nykštukas;TREPSIUKAI;2052451745;Taip;9;0;0;9
5819;Nykštukas;TREPSIUKAI;5103512898;Taip;5;0;0;5
5820;Nykštukas;TREPSIUKAI;7266550834;Taip;6;0;1;7
5821;Nykštukas;TREPSIUKAI;6563871327;Taip;9;0;0;9
5822;Nykštukas;TREPSIUKAI;5085577592;Taip;0;3;0;3
5823;Nykštukas;TREPSIUKAI;8819485547;Taip;12;0;0;12
5824;Nykštukas;TREPSIUKAI;5718555692;Taip;11;0;0;11
5825;Nykštukas;TREPSIUKAI;4499337321;Taip;14;0;0;14
5826;Nykštukas;TREPSIUKAI;4622095064;Taip;12;0;0;12
5827;Nykštukas;TREPSIUKAI;8667489439;Taip;9;0;0;9
5828;Nykštukas;TREPSIUKAI;8047072198;Taip;15;3;0;18
5829;Nykštukas;TREPSIUKAI;9790322329;Taip;8;1;0;9
5830;Nykštukas;ŽIRNIUKAI;9661862689;Taip;12;0;0;12
5831;Nykštukas;ŽIRNIUKAI;1594734231;Taip;0;0;1;1
5832;Nykštukas;ŽIRNIUKAI;1671340074;Taip;10;0;0;10
5833;Nykštukas;ŽIRNIUKAI;3339707558;Taip;0;2;0;2
5834;Nykštukas;ŽIRNIUKAI;7908029688;Taip;0;4;0;4
5835;Nykštukas;ŽIRNIUKAI;7299329150;Taip;4;0;0;4
5836;Nykštukas;ŽIRNIUKAI;9174636607;Taip;0;1;0;1
5837;Nykštukas;ŽIRNIUKAI;1218443707;Ne;4;0;0;4
5838;Nykštukas;ŽIRNIUKAI;6709760898;Ne;0;4;6;10
5839;Nykštukas;ŽIRNIUKAI;2670682135;Ne;0;2;1;3
5840;Nykštukas;ŽIRNIUKAI;1202614927;Taip;0;0;2;2
5841;Nykštukas;ŽIRNIUKAI;2800783215;Taip;8;11;0;19
5842;Nykštukas;ŽIRNIUKAI;2620150024;Taip;3;3;14;20
5843;Nykštukas;ŽIRNIUKAI;3032028847;Ne;16;1;0;17
5844;Nykštukas;ŽIRNIUKAI;4144437365;Taip;3;11;0;14
5845;Nykštukas;ŽIRNIUKAI;6884714823;Taip;2;5;0;7
5846;Nykštukas;ŽIRNIUKAI;1616644404;Taip;0;2;4;6
5847;Nykštukas;ŽIRNIUKAI;9270615518;Taip;3;0;0;3
5848;Nykštukas;ŽIRNIUKAI;2078586374;Taip;7;0;0;7
5849;Ozas;Smalsučiai;2641398988;Taip;0;5;0;5
5850;Ozas;Smalsučiai;9227939420;Ne;4;1;0;5
5851;Ozas;Smalsučiai;87218067796;Taip;8;0;0;8
5852;Ozas;Smalsučiai;1974320330;Taip;0;1;0;1
5853;Ozas;Smalsučiai;1173284700;Taip;0;3;0;3
5854;Ozas;Smalsučiai;71695973592;Ne;0;2;0;2
5855;Ozas;Smalsučiai;57069047630;Ne;0;3;6;9
5856;Ozas;Smalsučiai;3326395879;Taip;0;1;0;1
5857;Ozas;Smalsučiai;5150746885;Taip;0;9;0;9
5858;Ozas;Smalsučiai;1893257809;Taip;0;0;1;1
5859;Ozas;Smalsučiai;6540803077;Taip;0;3;0;3
5860;Ozas;Smalsučiai;8072802467;Taip;0;1;0;1
5861;Ozas;Smalsučiai;1248092034;Ne;0;3;0;3
5862;Ozas;Smalsučiai;43381497677;Taip;0;6;0;6
5863;Ozas;Smalsučiai;3286170280;Taip;0;0;1;1
5864;Ozas;Smalsučiai;9521048381;Taip;8;2;0;10
5865;Ozas;Smalsučiai;2053832360;Taip;2;1;0;3
5866;Ozas;Drugeliai;7802699257;Taip;3;0;0;3
5867;Ozas;Drugeliai;6668470892;Taip;0;1;0;1
5868;Ozas;Drugeliai;2302999759;Taip;0;1;0;1
5869;Ozas;Drugeliai;8088330187;Taip;0;15;0;15
5870;Ozas;Drugeliai;9073973849;Taip;0;3;0;3
5871;Ozas;Drugeliai;9322806566;Taip;0;4;0;4
5872;Ozas;Drugeliai;2676747542;Taip;0;3;20;23
5873;Ozas;Drugeliai;2812687451;Taip;0;1;1;2
5874;Ozas;Drugeliai;8289643065;Taip;2;3;0;5
5875;Ozas;Drugeliai;9987863302;Taip;0;2;1;3
5876;Ozas;Drugeliai;2980799420;Taip;7;3;1;11
5877;Ozas;Drugeliai;1793692289;Ne;0;1;0;1
5878;Ozas;Drugeliai;8318380547;Taip;4;9;0;13
5879;Ozas;Drugeliai;4884054504;Ne;1;0;0;1
5880;Ozas;Drugeliai;43660054250;Taip;0;21;0;21
5881;Ozas;Drugeliai;1871542885;Taip;0;3;0;3
5882;Ozas;Drugeliai;15262583232;Taip;0;7;0;7
5883;Ozas;Drugeliai;1103685699;Taip;0;3;0;3
5884;Ozas;Drugeliai;1335655483;Taip;0;1;0;1
5885;Ozas;Boružėlės;1348960421;Taip;0;2;2;4
5886;Ozas;Boružėlės;1375643969;Ne;0;3;0;3
5887;Ozas;Boružėlės;63852147122;Taip;5;3;1;9
5888;Ozas;Boružėlės;8190314087;Taip;0;3;2;5
5889;Ozas;Boružėlės;3803998816;Taip;2;0;0;2
5890;Ozas;Boružėlės;1212358423;Taip;9;0;0;9
5891;Ozas;Boružėlės;7615907271;Ne;0;5;1;6
5892;Ozas;Boružėlės;1560342499;Taip;0;3;0;3
5893;Ozas;Boružėlės;8529654920;Taip;0;2;0;2
5894;Ozas;Boružėlės;2527574646;Taip;0;6;0;6
5895;Ozas;Boružėlės;9773251894;Taip;0;7;1;8
5896;Ozas;Boružėlės;36523514229;Taip;1;3;0;4
5897;Ozas;Boružėlės;1367050160;Taip;5;3;0;8
5898;Ozas;Boružėlės;2678629892;Taip;0;3;0;3
5899;Ozas;Boružėlės;1826499734;Taip;0;3;0;3
5900;Ozas;Boružėlės;6432357144;Taip;0;3;0;3
5901;Ozas;Boružėlės;1498656201;Taip;0;5;0;5
5902;Ozas;Boružėlės;9130645878;Taip;2;3;7;12
5903;Ozas;Boružėlės;7172573921;Taip;0;2;0;2
5904;Ozas;Boružėlės;68364031736;Taip;5;2;0;7
5905;Ozas;Žiogeliai;7461521320;Taip;0;1;0;1
5906;Ozas;Žiogeliai;6257625501;Taip;0;3;0;3
5907;Ozas;Žiogeliai;7402290524;Ne;9;1;2;12
5908;Ozas;Žiogeliai;4571583671;Taip;0;3;0;3
5909;Ozas;Žiogeliai;5682027094;Taip;3;18;0;21
5910;Ozas;Žiogeliai;4966355020;Taip;8;0;1;9
5911;Ozas;Žiogeliai;9324647606;Taip;3;3;0;6
5912;Ozas;Žiogeliai;4942550213;Taip;8;0;0;8
5913;Ozas;Žiogeliai;8676986286;Taip;0;2;5;7
5914;Ozas;Žiogeliai;2345112767;Taip;0;2;0;2
5915;Ozas;Žiogeliai;5420952391;Taip;0;9;2;11
5916;Ozas;Žiogeliai;9929822317;Ne;1;0;1;2
5917;Ozas;Žiogeliai;2837228320;Taip;0;3;0;3
5918;Ozas;Žiogeliai;5156383727;Taip;0;8;0;8
5919;Ozas;Žiogeliai;2617258206;Ne;0;11;0;11
5920;Ozas;Žiogeliai;9768754737;Ne;0;2;2;4
5921;Ozas;Bitutės;4220780257;Taip;2;6;0;8
5922;Ozas;Bitutės;1161776624;Taip;0;6;2;8
5923;Ozas;Bitutės;4227555342;Ne;11;0;1;12
5924;Ozas;Bitutės;7499756171;Taip;0;13;0;13
5925;Ozas;Bitutės;2705294874;Taip;2;2;0;4
5926;Ozas;Bitutės;2369544599;Taip;0;1;0;1
5927;Ozas;Bitutės;3329391600;Taip;8;0;0;8
5928;Ozas;Bitutės;4254601638;Taip;3;0;4;7
5929;Ozas;Bitutės;4699369567;Taip;0;0;2;2
5930;Ozas;Bitutės;8304671844;Ne;0;0;2;2
5931;Ozas;Bitutės;9772085405;Taip;10;3;0;13
5932;Ozas;Bitutės;7051699003;Ne;5;0;7;12
5933;Ozas;Bitutės;5383877034;Taip;0;0;5;5
5934;Ozas;Bitutės;1117208248;Taip;0;4;0;4
5935;Ozas;Bitutės;6811181735;Taip;7;4;0;11
5936;Ozas;Bitutės;8622621570;Taip;18;0;0;18
5937;Ozas;Bitutės;4260123123;Taip;0;0;1;1
5938;Ozas;Bitutės;7494307084;Taip;1;1;0;2
5939;Ozas;Bitutės;1475005204;Taip;0;3;2;5
5940;Ozas;Bitutės;1895519949;Taip;0;0;2;2
5941;Ozas;Aitvarėliai;1144679735;Taip;14;0;1;15
5942;Ozas;Aitvarėliai;2773182934;Taip;0;0;7;7
5943;Ozas;Aitvarėliai;5642468671;Taip;1;3;0;4
5944;Ozas;Aitvarėliai;1045890394;Taip;0;3;0;3
5945;Ozas;Aitvarėliai;7686706482;Taip;0;2;0;2
5946;Ozas;Aitvarėliai;2395567376;Taip;0;1;0;1
5947;Ozas;Aitvarėliai;2922370952;Taip;0;0;1;1
5948;Ozas;Aitvarėliai;1543683077;Taip;0;0;2;2
5949;Ozas;Aitvarėliai;2165291778;Taip;1;3;4;8
5950;Ozas;Aitvarėliai;8754244281;Taip;18;1;0;19
5951;Ozas;Aitvarėliai;6646671212;Taip;0;3;1;4
5952;Ozas;Aitvarėliai;9443843603;Taip;0;3;7;10
5953;Ozas;Aitvarėliai;3238019756;Taip;8;8;0;16
5954;Ozas;Aitvarėliai;8987796218;Taip;9;10;0;19
5955;Ozas;Aitvarėliai;2544858937;Taip;5;1;0;6
5956;Ozas;Aitvarėliai;3783477511;Ne;0;5;0;5
5957;Ozas;Aitvarėliai;6778987483;Ne;15;0;0;15
5958;Ozas;Aitvarėliai;4891451748;Ne;0;10;1;11
5959;Ozas;Aitvarėliai;7009893338;Ne;7;0;0;7
5960;Ozas;Voveraitės;8178298861;Taip;5;0;0;5
5961;Ozas;Voveraitės;6263062055;Taip;0;1;0;1
5962;Ozas;Voveraitės;9195536968;Taip;0;2;3;5
5963;Ozas;Voveraitės;2991511872;Taip;0;1;0;1
5964;Ozas;Voveraitės;5016547315;Taip;0;8;0;8
5965;Ozas;Voveraitės;1564826076;Taip;0;5;0;5
5966;Ozas;Voveraitės;1240233169;Taip;0;8;0;8
5967;Ozas;Voveraitės;6088757991;Taip;0;3;0;3
5968;Ozas;Voveraitės;5822871838;Taip;0;2;3;5
5969;Ozas;Voveraitės;2635045515;Taip;0;3;0;3
5970;Ozas;Voveraitės;6499549095;Taip;0;3;0;3
5971;Ozas;Voveraitės;6666591428;Taip;0;0;3;3
5972;Ozas;Voveraitės;2297650260;Taip;13;4;1;18
5973;Ozas;Voveraitės;7908028909;Taip;6;2;0;8
5974;Ozas;Voveraitės;9762737217;Taip;7;2;0;9
5975;Ozas;Voveraitės;7421484648;Ne;14;0;9;23
5976;Ozas;Voveraitės;6053885086;Taip;5;0;0;5
5977;Ozas;Voveraitės;5751808248;Taip;6;0;0;6
5978;Ozas;Voveraitės;4556076744;Taip;7;0;1;8
5979;Ozas;Kodelčiukai;8743467101;Taip;0;5;0;5
5980;Ozas;Kodelčiukai;2964318343;Taip;7;3;0;10
5981;Ozas;Kodelčiukai;8696127374;Taip;0;0;1;1
5982;Ozas;Kodelčiukai;3704303636;Taip;5;1;0;6
5983;Ozas;Kodelčiukai;2573702751;Taip;4;0;3;7
5984;Ozas;Kodelčiukai;2951875705;Taip;0;2;0;2
5985;Ozas;Kodelčiukai;7305274617;Taip;15;0;0;15
5986;Ozas;Kodelčiukai;9084187344;Taip;7;0;0;7
5987;Ozas;Kodelčiukai;1348751454;Taip;11;0;0;11
5988;Ozas;Kodelčiukai;9322080266;Taip;8;1;0;9
5989;Ozas;Kodelčiukai;6809992664;Taip;8;1;2;11
5990;Ozas;Kodelčiukai;4516291572;Ne;0;0;1;1
5991;Ozas;Kodelčiukai;4287719751;Taip;0;8;0;8
5992;Ozas;Kodelčiukai;9620747099;Taip;10;0;0;10
5993;Ozas;Kodelčiukai;5216695220;Taip;14;3;0;17
5994;Ozas;Kodelčiukai;7433169909;Ne;11;10;0;21
5995;Ozas;Kodelčiukai;8779047802;Taip;0;0;2;2
5996;Ozas;Kodelčiukai;6609446450;Taip;0;1;2;3
5997;Ozas;Kodelčiukai;6783755555;Ne;0;11;0;11
5998;Ozas;Kodelčiukai;8222112564;Taip;0;1;0;1
5999;Ozas;Pelėdžiukai;4640897674;Taip;5;2;1;8
6000;Ozas;Pelėdžiukai;2281337233;Ne;5;3;3;11
6001;Ozas;Pelėdžiukai;8040293681;Ne;0;1;16;17
6002;Ozas;Pelėdžiukai;1856258542;Taip;0;6;0;6
6003;Ozas;Pelėdžiukai;5922569280;Taip;0;18;0;18
6004;Ozas;Pelėdžiukai;7640409923;Taip;5;6;0;11
6005;Ozas;Pelėdžiukai;4601869799;Taip;0;4;1;5
6006;Ozas;Pelėdžiukai;5958055645;Ne;0;0;1;1
6007;Ozas;Pelėdžiukai;2824133388;Taip;9;0;0;9
6008;Ozas;Pelėdžiukai;7287989663;Taip;4;0;0;4
6009;Ozas;Pelėdžiukai;6819000895;Taip;0;4;0;4
6010;Ozas;Pelėdžiukai;4247941696;Taip;0;1;0;1
6011;Ozas;Pelėdžiukai;5950860889;Taip;5;2;0;7
6012;Ozas;Pelėdžiukai;4886045470;Taip;0;6;0;6
6013;Ozas;Pelėdžiukai;3212050416;Taip;12;0;2;14
6014;Ozas;Pelėdžiukai;3711403511;Taip;5;2;5;12
6015;Ozas;Pelėdžiukai;5392929222;Taip;11;0;1;12
6016;Ozas;Pelėdžiukai;7038928164;Ne;0;0;5;5
6017;Ozas;Pelėdžiukai;8131525146;Taip;18;0;0;18
6018;Ozas;"Kačiukai ";4857216527;Taip;10;0;0;10
6019;Ozas;"Kačiukai ";7776754188;Taip;4;0;1;5
6020;Ozas;"Kačiukai ";5097380041;Taip;6;0;3;9
6021;Ozas;"Kačiukai ";3440198575;Taip;0;0;7;7
6022;Ozas;"Kačiukai ";2522810593;Taip;15;0;0;15
6023;Ozas;"Kačiukai ";3109261153;Taip;12;3;0;15
6024;Ozas;"Kačiukai ";9781398468;Taip;18;0;0;18
6025;Ozas;"Kačiukai ";8488500486;Taip;5;0;2;7
6026;Ozas;"Kačiukai ";7803356246;Taip;0;0;23;23
6027;Ozas;"Kačiukai ";2512535949;Taip;11;0;0;11
6028;Ozas;"Kačiukai ";4595986358;Taip;2;0;1;3
6029;Ozas;"Kačiukai ";5421245991;Taip;5;0;0;5
6030;Ozas;"Kačiukai ";9781527964;Taip;10;10;0;20
6031;Ozas;"Kačiukai ";6456146804;Taip;3;0;0;3
6032;Ozas;"Kačiukai ";9496746778;Taip;5;0;4;9
6033;Ozas;"Kačiukai ";5828548048;Ne;0;0;1;1
6034;Ozas;"Kačiukai ";9655492678;Taip;0;0;2;2
6035;Ozas;Ančiukų;5926100815;Taip;23;0;0;23
6036;Ozas;Ančiukų;2248812743;Taip;0;0;1;1
6037;Ozas;Ančiukų;2454569369;Taip;7;0;1;8
6038;Ozas;Ančiukų;3133776891;Taip;3;0;2;5
6039;Ozas;Ančiukų;2139224651;Taip;4;0;0;4
6040;Ozas;Ančiukų;2819545359;Taip;5;0;0;5
6041;Ozas;Ančiukų;5172367556;Taip;9;5;0;14
6042;Ozas;Ančiukų;5677543279;Taip;9;0;0;9
6043;Ozas;Ančiukų;8923372952;Taip;12;0;0;12
6044;Ozas;Ančiukų;7617839839;Taip;14;0;0;14
6045;Ozas;Ančiukų;9506090620;Taip;12;0;1;13
6046;Ozas;Nykškukų;3139289643;Taip;11;0;0;11
6047;Ozas;Nykškukų;7585213159;Taip;0;8;0;8
6048;Ozas;Nykškukų;6392066805;Taip;11;0;0;11
6049;Ozas;Nykškukų;6346123124;Taip;20;0;1;21
6050;Ozas;Nykškukų;3902722274;Taip;3;0;0;3
6051;Ozas;Nykškukų;7922667688;Taip;1;0;13;14
6052;Ozas;Nykškukų;3817138493;Taip;3;0;0;3
6053;Ozas;Nykškukų;8371368881;Taip;1;0;0;1
6054;Ozas;Nykškukų;6476147361;Taip;3;0;0;3
6055;Ozas;Nykškukų;4994121247;Taip;11;1;0;12
6056;Ozas;Nykškukų;6315443248;Taip;15;1;0;16
6057;Ozas;Nykškukų;6318419889;Ne;15;0;0;15
6058;Ozas;Nykškukų;6186850614;Taip;15;0;1;16
6059;Ozas;Nykškukų;5182160089;Taip;10;0;0;10
6060;Pabiručiai;Voveriukų;4539246865;Taip;0;6;0;6
6061;Pabiručiai;Voveriukų;2349337471;Taip;0;2;3;5
6062;Pabiručiai;Voveriukų;9564303781;Taip;0;5;0;5
6063;Pabiručiai;Voveriukų;4312364951;Taip;0;4;2;6
6064;Pabiručiai;Voveriukų;3756731363;Ne;3;0;7;10
6065;Pabiručiai;Voveriukų;7985360502;Taip;5;0;0;5
6066;Pabiručiai;Voveriukų;3936426174;Taip;0;0;1;1
6067;Pabiručiai;Voveriukų;4069564285;Taip;0;2;0;2
6068;Pabiručiai;Voveriukų;7403996266;Ne;7;0;0;7
6069;Pabiručiai;Voveriukų;7278334800;Taip;12;1;0;13
6070;Pabiručiai;Voveriukų;9468698553;Taip;1;0;0;1
6071;Pabiručiai;Voveriukų;5232678556;Taip;14;0;0;14
6072;Pabiručiai;Voveriukų;7066037017;Taip;0;3;0;3
6073;Pabiručiai;Voveriukų;5549851164;Taip;0;1;0;1
6074;Pabiručiai;Voveriukų;4040533883;Taip;0;1;0;1
6075;Pabiručiai;Voveriukų;2514312233;Taip;0;1;0;1
6076;Pabiručiai;Voveriukų;7606274875;Taip;0;1;0;1
6077;Pabiručiai;Voveriukų;9356327400;Taip;0;3;0;3
6078;Pabiručiai;Voveriukų;4813206044;Taip;0;9;0;9
6079;Pabiručiai;Voveriukų;7846758352;Taip;10;0;0;10
6080;Pabiručiai;Boružiukų;6401188653;Taip;0;1;0;1
6081;Pabiručiai;Boružiukų;1673473814;Taip;5;0;0;5
6082;Pabiručiai;Boružiukų;5686769648;Taip;0;18;0;18
6083;Pabiručiai;Boružiukų;7524993271;Ne;0;3;1;4
6084;Pabiručiai;Boružiukų;4006783343;Ne;7;0;0;7
6085;Pabiručiai;Boružiukų;7046122545;Taip;0;2;0;2
6086;Pabiručiai;Boružiukų;3096466200;Taip;0;3;0;3
6087;Pabiručiai;Boružiukų;4301904533;Taip;0;4;0;4
6088;Pabiručiai;Boružiukų;8175565139;Taip;0;1;0;1
6089;Pabiručiai;Boružiukų;8236964683;Taip;0;3;0;3
6090;Pabiručiai;Boružiukų;1240057541;Taip;0;3;0;3
6091;Pabiručiai;Boružiukų;1671027282;Taip;0;12;1;13
6092;Pabiručiai;Boružiukų;3759350345;Taip;0;2;0;2
6093;Pabiručiai;Boružiukų;3151360288;Taip;12;2;0;14
6094;Pabiručiai;Boružiukų;9299393363;Taip;0;7;0;7
6095;Pabiručiai;Boružiukų;1484291546;Taip;0;1;0;1
6096;Pabiručiai;Boružiukų;2771769336;Taip;0;1;0;1
6097;Pabiručiai;Boružiukų;2607840684;Taip;0;3;0;3
6098;Pabiručiai;Boružiukų;7050339198;Taip;14;3;0;17
6099;Pabiručiai;Boružiukų;4798503931;Taip;8;1;0;9
6100;Pabiručiai;Katinėlių;8284711578;Ne;0;1;0;1
6101;Pabiručiai;Katinėlių;8710389714;Taip;0;1;0;1
6102;Pabiručiai;Katinėlių;1670938208;Taip;9;1;0;10
6103;Pabiručiai;Katinėlių;7969520467;Taip;0;0;20;20
6104;Pabiručiai;Katinėlių;4205107384;Taip;4;0;0;4
6105;Pabiručiai;Katinėlių;4501176225;Taip;0;0;3;3
6106;Pabiručiai;Katinėlių;1749155319;Ne;0;1;0;1
6107;Pabiručiai;Katinėlių;2572570925;Taip;21;0;0;21
6108;Pabiručiai;Katinėlių;34883375155;Taip;0;5;0;5
6109;Pabiručiai;Katinėlių;8306688649;Taip;4;1;0;5
6110;Pabiručiai;Katinėlių;1705085006;Taip;0;2;0;2
6111;Pabiručiai;Katinėlių;58112415466;Ne;0;4;4;8
6112;Pabiručiai;Katinėlių;95695057362;Ne;0;4;0;4
6113;Pabiručiai;Katinėlių;42877891797;Taip;0;1;0;1
6114;Pabiručiai;Katinėlių;6285940478;Taip;0;3;0;3
6115;Pabiručiai;Katinėlių;1122183123;Taip;0;3;2;5
6116;Pabiručiai;Žiogelių;6548776238;Taip;0;0;2;2
6117;Pabiručiai;Žiogelių;3272576627;Taip;8;0;4;12
6118;Pabiručiai;Žiogelių;5522447437;Taip;0;0;1;1
6119;Pabiručiai;Žiogelių;3585198013;Taip;0;3;0;3
6120;Pabiručiai;Žiogelių;7974345478;Taip;10;2;0;12
6121;Pabiručiai;Žiogelių;3206962828;Ne;11;3;1;15
6122;Pabiručiai;Žiogelių;3355875364;Taip;0;2;0;2
6123;Pabiručiai;Žiogelių;5311762824;Taip;16;0;4;20
6124;Pabiručiai;Žiogelių;1587905929;Taip;7;0;4;11
6125;Pabiručiai;Žiogelių;4667769378;Taip;0;11;0;11
6126;Pabiručiai;Žiogelių;7085036701;Taip;0;1;0;1
6127;Pabiručiai;Žiogelių;8367889753;Taip;0;3;0;3
6128;Pabiručiai;Žiogelių;8736658575;Taip;11;0;1;12
6129;Pabiručiai;Žiogelių;8106446562;Taip;0;4;0;4
6130;Pabiručiai;Žiogelių;8421025940;Taip;0;2;1;3
6131;Pabiručiai;Žiogelių;3028063887;Taip;0;3;2;5
6132;Pabiručiai;Smalsiukai;2869383175;Taip;1;0;0;1
6133;Pabiručiai;Smalsiukai;7677235214;Taip;0;0;3;3
6134;Pabiručiai;Smalsiukai;9676561758;Taip;5;0;1;6
6135;Pabiručiai;Smalsiukai;7632969321;Ne;11;0;2;13
6136;Pabiručiai;Smalsiukai;7090116276;Taip;0;3;0;3
6137;Pabiručiai;Smalsiukai;3700401383;Taip;0;21;0;21
6138;Pabiručiai;Smalsiukai;4408666547;Taip;4;6;0;10
6139;Pabiručiai;Smalsiukai;9093137227;Taip;10;0;0;10
6140;Pabiručiai;Smalsiukai;6935913132;Ne;0;3;0;3
6141;Pabiručiai;Smalsiukai;7663581089;Taip;0;5;0;5
6142;Pabiručiai;Smalsiukai;7248314871;Taip;0;0;1;1
6143;Pabiručiai;Smalsiukai;8897462614;Taip;0;4;0;4
6144;Pabiručiai;Smalsiukai;2332338995;Ne;20;0;0;20
6145;Pabiručiai;Smalsiukai;4258226042;Ne;0;16;0;16
6146;Pabiručiai;Smalsiukai;3511851810;Taip;13;0;0;13
6147;Pabiručiai;Smalsiukai;6686039601;Taip;18;0;0;18
6148;Pabiručiai;Smalsiukai;5420231066;Taip;7;0;0;7
6149;Pabiručiai;Smalsiukai;8840885039;Taip;20;0;0;20
6150;Pabiručiai;Smalsiukai;9779260044;Taip;5;0;0;5
6151;Pabiručiai;Smalsiukai;2771891999;Taip;2;0;6;8
6152;Pabiručiai;Smalsiukai;7295052694;Ne;0;3;0;3
6153;Pabiručiai;Kiškučiai;3368607302;Taip;9;0;0;9
6154;Pabiručiai;Kiškučiai;9589005897;Taip;0;11;0;11
6155;Pabiručiai;Kiškučiai;6648966721;Taip;3;3;0;6
6156;Pabiručiai;Kiškučiai;9353062804;Taip;13;0;0;13
6157;Pabiručiai;Kiškučiai;1582754284;Taip;0;2;0;2
6158;Pabiručiai;Kiškučiai;4462744848;Ne;15;5;0;20
6159;Pabiručiai;Kiškučiai;5497318373;Taip;5;0;0;5
6160;Pabiručiai;Kiškučiai;9417138573;Taip;7;0;1;8
6161;Pabiručiai;Kiškučiai;1515270273;Taip;16;4;0;20
6162;Pabiručiai;Kiškučiai;2688728915;Taip;11;8;0;19
6163;Pabiručiai;Kiškučiai;5166525832;Taip;0;13;0;13
6164;Pabiručiai;Kiškučiai;5346249456;Taip;10;5;0;15
6165;Pabiručiai;Kiškučiai;5717534175;Taip;16;0;0;16
6166;Pabiručiai;Kiškučiai;3408518493;Taip;0;5;0;5
6167;Pabiručiai;Kiškučiai;7653129291;Taip;20;0;0;20
6168;Pabiručiai;Kiškučiai;7073230645;Ne;15;2;0;17
6169;Pabiručiai;Kiškučiai;8820585407;Taip;0;4;0;4
6170;Pabiručiai;Kiškučiai;7572077461;Taip;0;3;0;3
6171;Pabiručiai;Kiškučiai;5767879226;Taip;8;1;0;9
6172;Pabiručiai;"Pėledžiukai ";9834824219;Taip;0;1;0;1
6173;Pabiručiai;"Pėledžiukai ";2507088490;Taip;10;4;0;14
6174;Pabiručiai;"Pėledžiukai ";6831569546;Taip;0;0;1;1
6175;Pabiručiai;"Pėledžiukai ";1683369842;Ne;0;2;0;2
6176;Pabiručiai;"Pėledžiukai ";7961879916;Taip;0;3;0;3
6177;Pabiručiai;"Pėledžiukai ";9050994322;Taip;17;3;0;20
6178;Pabiručiai;"Pėledžiukai ";6697518151;Taip;0;5;0;5
6179;Pabiručiai;"Pėledžiukai ";2596301235;Taip;0;1;4;5
6180;Pabiručiai;"Pėledžiukai ";4333645528;Taip;0;2;0;2
6181;Pabiručiai;"Pėledžiukai ";6289025538;Taip;0;12;0;12
6182;Pabiručiai;"Pėledžiukai ";2343561322;Taip;0;2;0;2
6183;Pabiručiai;"Pėledžiukai ";8268101318;Taip;0;4;0;4
6184;Pabiručiai;"Pėledžiukai ";2147165934;Taip;12;0;0;12
6185;Pabiručiai;"Pėledžiukai ";3224195892;Ne;0;3;1;4
6186;Pabiručiai;"Kodelčiūkai ";5950654594;Taip;0;0;2;2
6187;Pabiručiai;"Kodelčiūkai ";8775727677;Taip;0;7;3;10
6188;Pabiručiai;"Kodelčiūkai ";4317656984;Taip;0;0;2;2
6189;Pabiručiai;"Kodelčiūkai ";4785878572;Ne;0;2;0;2
6190;Pabiručiai;"Kodelčiūkai ";2295503584;Ne;6;11;0;17
6191;Pabiručiai;"Kodelčiūkai ";4595458527;Taip;4;0;1;5
6192;Pabiručiai;"Kodelčiūkai ";8716879106;Taip;0;0;1;1
6193;Pabiručiai;"Kodelčiūkai ";9067653417;Taip;15;0;0;15
6194;Pabiručiai;"Kodelčiūkai ";5247780866;Taip;11;3;0;14
6195;Pabiručiai;"Kodelčiūkai ";3433419710;Taip;5;0;0;5
6196;Pabiručiai;"Kodelčiūkai ";6386335808;Taip;13;0;4;17
6197;Pabiručiai;"Kodelčiūkai ";5010271037;Taip;12;1;0;13
6198;Pabiručiai;"Kodelčiūkai ";9538339883;Taip;0;5;1;6
6199;Pabiručiai;"Kodelčiūkai ";8149732126;Taip;0;3;0;3
6200;Pabiručiai;"Kodelčiūkai ";6209553290;Ne;23;0;0;23
6201;Pabiručiai;"Kodelčiūkai ";5913022147;Taip;10;0;1;11
6202;Pabiručiai;"Kodelčiūkai ";3748657353;Ne;2;3;0;5
6203;Pabiručiai;"Kodelčiūkai ";3497466298;Taip;0;5;1;6
6204;Pabiručiai;"Kodelčiūkai ";8179285338;Taip;0;10;0;10
6205;Pabiručiai;"Kodelčiūkai ";1234230729;Taip;13;1;1;15
6206;Pabiručiai;"Peliukų ";4894380231;Taip;10;0;0;10
6207;Pabiručiai;"Peliukų ";6678717039;Ne;0;3;0;3
6208;Pabiručiai;"Peliukų ";7182565608;Taip;13;0;1;14
6209;Pabiručiai;"Peliukų ";1099080685;Taip;0;7;0;7
6210;Pabiručiai;"Peliukų ";5990497129;Taip;0;4;0;4
6211;Pabiručiai;"Peliukų ";9890225918;Taip;5;0;2;7
6212;Pabiručiai;"Peliukų ";8922901677;Taip;3;0;2;5
6213;Pabiručiai;"Peliukų ";1971996148;Taip;0;1;0;1
6214;Pabiručiai;"Peliukų ";4852287574;Taip;13;0;0;13
6215;Pabiručiai;"Peliukų ";1206012259;Taip;0;2;0;2
6216;Pabiručiai;"Peliukų ";9790360371;Taip;0;0;1;1
6217;Pabiručiai;"Peliukų ";7980170279;Taip;5;0;0;5
6218;Pabiručiai;"Peliukų ";9806520732;Taip;13;0;0;13
6219;Pabiručiai;"Viščiukų ";8254676845;Ne;5;0;2;7
6220;Pabiručiai;"Viščiukų ";6742744014;Taip;6;4;0;10
6221;Pabiručiai;"Viščiukų ";7339565412;Taip;19;0;0;19
6222;Pabiručiai;"Viščiukų ";4880717493;Taip;20;0;0;20
6223;Pabiručiai;"Viščiukų ";1138743823;Ne;0;4;0;4
6224;Pabiručiai;"Viščiukų ";3011601512;Taip;5;0;2;7
6225;Pabiručiai;"Viščiukų ";4931180848;Taip;5;1;0;6
6226;Pabiručiai;"Viščiukų ";7798837336;Taip;6;0;3;9
6227;Pabiručiai;"Viščiukų ";7914642744;Taip;12;0;0;12
6228;Pabiručiai;"Viščiukų ";5737214746;Taip;0;3;1;4
6229;Pabiručiai;"Viščiukų ";2141365015;Ne;5;0;1;6
6230;Pabiručiai;"Viščiukų ";6361966325;Taip;0;0;3;3
6231;Pabiručiai;"Viščiukų ";6508093808;Ne;0;4;4;8
6232;Pabiručiai;"Viščiukų ";8649685325;Taip;6;0;2;8
6233;Pabiručiai;"Viščiukų ";4929129093;Ne;5;6;0;11
6234;Pabiručiai;"Drugelių ";6014791534;Taip;15;0;0;15
6235;Pabiručiai;"Drugelių ";9890868992;Taip;6;0;1;7
6236;Pabiručiai;"Drugelių ";2556330147;Taip;0;9;0;9
6237;Pabiručiai;"Drugelių ";5050966784;Taip;9;3;0;12
6238;Pabiručiai;"Drugelių ";5019580409;Ne;5;0;0;5
6239;Pabiručiai;"Drugelių ";9878655387;Taip;10;0;0;10
6240;Pabiručiai;"Drugelių ";4876140467;Taip;9;4;0;13
6241;Pabiručiai;"Drugelių ";4012537474;Taip;8;0;1;9
6242;Pabiručiai;ŽIRNIUKŲ;2924005478;Taip;9;0;0;9
6243;Pabiručiai;ŽIRNIUKŲ;1247522345;Taip;13;0;0;13
6244;Pabiručiai;ŽIRNIUKŲ;1852744763;Taip;10;0;3;13
6245;Pabiručiai;ŽIRNIUKŲ;4851108740;Ne;0;3;0;3
6246;Pabiručiai;ŽIRNIUKŲ;6513943228;Ne;12;0;0;12
6247;Pabiručiai;ŽIRNIUKŲ;2794484633;Ne;22;0;0;22
6248;Pabiručiai;ŽIRNIUKŲ;8870657682;Ne;13;0;0;13
6249;Pabiručiai;ŽIRNIUKŲ;4096412988;Taip;6;0;0;6
6250;Pabiručiai;ŽIRNIUKŲ;8092886420;Ne;11;1;0;12
6251;Pabiručiai;ŽIRNIUKŲ;7873575929;Ne;3;0;0;3
6252;Pabiručiai;ŽIRNIUKŲ;5862643827;Ne;19;0;0;19
6253;Pabiručiai;ŽIRNIUKŲ;5184688482;Taip;10;0;0;10
6254;Pabiručiai;ŽIRNIUKŲ;4755427277;Taip;8;1;0;9
6255;Pabiručiai;ŽIRNIUKŲ;9507212682;Taip;5;0;0;5
6256;Pabiručiai;ŽIRNIUKŲ;9651695086;Taip;8;0;0;8
6257;Pabiručiai;ŽIRNIUKŲ;5899880680;Taip;22;0;0;22
6258;Pagrandukas;Saulytės;6915087488;Taip;0;1;0;1
6259;Pagrandukas;Saulytės;7605508460;Taip;4;1;0;5
6260;Pagrandukas;Saulytės;6349387692;Taip;0;4;0;4
6261;Pagrandukas;Saulytės;8186092469;Taip;0;7;0;7
6262;Pagrandukas;Saulytės;2934300533;Taip;0;8;0;8
6263;Pagrandukas;Saulytės;1548697124;Taip;0;6;0;6
6264;Pagrandukas;Saulytės;6711830251;Taip;0;4;0;4
6265;Pagrandukas;Saulytės;7146697128;Taip;5;2;0;7
6266;Pagrandukas;Saulytės;3157676207;Taip;0;12;0;12
6267;Pagrandukas;Saulytės;7511097160;Taip;0;20;0;20
6268;Pagrandukas;Saulytės;7454863899;Taip;0;5;0;5
6269;Pagrandukas;Saulytės;5560372136;Taip;0;8;0;8
6270;Pagrandukas;Saulytės;1766912463;Taip;0;14;0;14
6271;Pagrandukas;Saulytės;9849054467;Taip;5;5;0;10
6272;Pagrandukas;Saulytės;8024910647;Taip;0;2;0;2
6273;Pagrandukas;Saulytės;8481502330;Taip;0;13;0;13
6274;Pagrandukas;Saulytės;7160305478;Ne;0;3;0;3
6275;Pagrandukas;Saulytės;3008997793;Ne;0;1;0;1
6276;Pagrandukas;Saulytės;6388805960;Taip;0;0;13;13
6277;Pagrandukas;Saulytės;8836178193;Taip;0;11;0;11
6278;Pagrandukas;Saulytės;7157549179;Taip;0;9;0;9
6279;Pagrandukas;Zuikučiai;7834436515;Taip;0;3;5;8
6280;Pagrandukas;Zuikučiai;5903416384;Taip;0;3;3;6
6281;Pagrandukas;Zuikučiai;2439891231;Taip;0;1;6;7
6282;Pagrandukas;Zuikučiai;6710887776;Taip;0;1;6;7
6283;Pagrandukas;Zuikučiai;7665811353;Taip;3;0;3;6
6284;Pagrandukas;Zuikučiai;2212787835;Taip;0;1;0;1
6285;Pagrandukas;Zuikučiai;2711590019;Taip;0;15;3;18
6286;Pagrandukas;Zuikučiai;6449029299;Taip;0;2;0;2
6287;Pagrandukas;Zuikučiai;1405820070;Taip;0;5;1;6
6288;Pagrandukas;Zuikučiai;1054107640;Taip;10;2;0;12
6289;Pagrandukas;Zuikučiai;1885539883;Taip;0;3;5;8
6290;Pagrandukas;Zuikučiai;1795582354;Taip;0;1;0;1
6291;Pagrandukas;Zuikučiai;1587839122;Taip;13;0;0;13
6292;Pagrandukas;Zuikučiai;2101505576;Taip;0;0;10;10
6293;Pagrandukas;Zuikučiai;6765346578;Ne;0;0;9;9
6294;Pagrandukas;Zuikučiai;5922595170;Taip;0;12;0;12
6295;Pagrandukas;Zuikučiai;5030928303;Taip;0;2;3;5
6296;Pagrandukas;Zuikučiai;9139212151;Taip;0;2;4;6
6297;Pagrandukas;Zuikučiai;8643993939;Taip;0;0;11;11
6298;Pagrandukas;Zuikučiai;5021106231;Taip;2;0;0;2
6299;Pagrandukas;Zuikučiai;3494047045;Taip;0;9;0;9
6300;Pagrandukas;Boružėlių;3398225200;Taip;6;6;0;12
6301;Pagrandukas;Boružėlių;5752454925;Ne;0;5;0;5
6302;Pagrandukas;Boružėlių;3587941684;Taip;10;0;0;10
6303;Pagrandukas;Boružėlių;6304701617;Taip;0;2;0;2
6304;Pagrandukas;Boružėlių;3953844737;Taip;0;4;0;4
6305;Pagrandukas;Boružėlių;7271589727;Taip;0;2;0;2
6306;Pagrandukas;Boružėlių;7064391685;Taip;0;0;1;1
6307;Pagrandukas;Boružėlių;1403569615;Taip;5;0;0;5
6308;Pagrandukas;Boružėlių;1998073387;Taip;1;0;0;1
6309;Pagrandukas;Boružėlių;5511396314;Taip;4;7;0;11
6310;Pagrandukas;Boružėlių;5648658237;Taip;0;3;0;3
6311;Pagrandukas;Boružėlių;9651789217;Taip;10;0;0;10
6312;Pagrandukas;Boružėlių;2926077771;Taip;0;18;0;18
6313;Pagrandukas;Boružėlių;2361829423;Taip;4;0;0;4
6314;Pagrandukas;Boružėlių;8286183393;Taip;0;1;2;3
6315;Pagrandukas;Boružėlių;2549704540;Taip;9;1;0;10
6316;Pagrandukas;Boružėlių;9790803767;Ne;5;0;0;5
6317;Pagrandukas;Boružėlių;7043125057;Ne;0;2;2;4
6318;Pagrandukas;Bitutės;6044667668;Ne;5;4;1;10
6319;Pagrandukas;Bitutės;6315627367;Taip;0;0;1;1
6320;Pagrandukas;Bitutės;8529974367;Ne;5;5;5;15
6321;Pagrandukas;Bitutės;4079711515;Taip;3;3;0;6
6322;Pagrandukas;Bitutės;9188382746;Taip;0;0;7;7
6323;Pagrandukas;Bitutės;4603185679;Taip;5;0;1;6
6324;Pagrandukas;Bitutės;5613442667;Taip;10;0;3;13
6325;Pagrandukas;Bitutės;2923517578;Taip;8;12;0;20
6326;Pagrandukas;Bitutės;4322675634;Taip;0;1;0;1
6327;Pagrandukas;Bitutės;3875062228;Taip;0;0;1;1
6328;Pagrandukas;Bitutės;4405567649;Taip;0;1;0;1
6329;Pagrandukas;Bitutės;1583104760;Taip;5;5;1;11
6330;Pagrandukas;Bitutės;5649084353;Taip;5;0;0;5
6331;Pagrandukas;Bitutės;8719834064;Taip;0;5;3;8
6332;Pagrandukas;Bitutės;5821945401;Taip;0;0;6;6
6333;Pagrandukas;Bitutės;7675694987;Taip;6;0;0;6
6334;Pagrandukas;Bitutės;3709131197;Taip;0;4;0;4
6335;Pagrandukas;Bitutės;8280877177;Ne;0;0;3;3
6336;Pagrandukas;Bitutės;2764732768;Taip;0;8;5;13
6337;Pagrandukas;Pelėdžiukai;1714449109;Taip;0;4;0;4
6338;Pagrandukas;Pelėdžiukai;3160109801;Taip;0;2;3;5
6339;Pagrandukas;Pelėdžiukai;7764147734;Taip;0;2;0;2
6340;Pagrandukas;Pelėdžiukai;8633116370;Taip;0;2;2;4
6341;Pagrandukas;Pelėdžiukai;2877401332;Taip;12;1;0;13
6342;Pagrandukas;Pelėdžiukai;3390664086;Taip;4;0;0;4
6343;Pagrandukas;Pelėdžiukai;1733723373;Taip;7;0;0;7
6344;Pagrandukas;Pelėdžiukai;6011346969;Taip;5;1;0;6
6345;Pagrandukas;Pelėdžiukai;1077792535;Taip;14;1;0;15
6346;Pagrandukas;Pelėdžiukai;9583471280;Taip;14;1;0;15
6347;Pagrandukas;Pelėdžiukai;2481532396;Taip;11;0;0;11
6348;Pagrandukas;Pelėdžiukai;2640777376;Taip;10;0;0;10
6349;Pagrandukas;Pelėdžiukai;4910151924;Taip;0;6;0;6
6350;Pagrandukas;Pelėdžiukai;7238694532;Taip;7;6;1;14
6351;Pagrandukas;ŠYPSENĖLIŲ;4627387596;Taip;0;0;2;2
6352;Pagrandukas;ŠYPSENĖLIŲ;1101989969;Taip;0;8;0;8
6353;Pagrandukas;ŠYPSENĖLIŲ;5701479990;Taip;0;1;0;1
6354;Pagrandukas;ŠYPSENĖLIŲ;9981610798;Taip;4;0;0;4
6355;Pagrandukas;ŠYPSENĖLIŲ;6248684084;Taip;10;0;0;10
6356;Pagrandukas;ŠYPSENĖLIŲ;2904880156;Taip;6;0;0;6
6357;Pagrandukas;ŠYPSENĖLIŲ;5173633710;Taip;0;0;2;2
6358;Pagrandukas;ŠYPSENĖLIŲ;8475724797;Taip;0;0;5;5
6359;Pagrandukas;ŠYPSENĖLIŲ;6517393406;Taip;0;0;5;5
6360;Pagrandukas;ŠYPSENĖLIŲ;4094086585;Taip;4;3;0;7
6361;Pagrandukas;ŠYPSENĖLIŲ;6306635507;Taip;0;0;2;2
6362;Pakalnutė;Pagrandukai;7475119623;Taip;8;2;0;10
6363;Pakalnutė;Pagrandukai;2015778005;Taip;4;0;0;4
6364;Pakalnutė;Pagrandukai;5275833872;Taip;18;0;0;18
6365;Pakalnutė;Pagrandukai;5943686565;Taip;6;0;0;6
6366;Pakalnutė;Pagrandukai;2296079246;Taip;8;8;0;16
6367;Pakalnutė;Pagrandukai;9313588621;Taip;7;0;0;7
6368;Pakalnutė;Pagrandukai;5180015882;Taip;0;10;0;10
6369;Pakalnutė;Pagrandukai;3794283102;Taip;0;0;1;1
6370;Pakalnutė;Pagrandukai;3070652992;Taip;18;3;0;21
6371;Pakalnutė;Pagrandukai;7477188659;Taip;4;3;0;7
6372;Pakalnutė;Pagrandukai;8522585063;Taip;6;0;0;6
6373;Pakalnutė;Pagrandukai;4390444128;Taip;6;0;1;7
6374;Pakalnutė;Pagrandukai;1614993691;Taip;5;0;1;6
6375;Pakalnutė;Pagrandukai;7417131378;Taip;17;0;0;17
6376;Pakalnutė;Pagrandukai;6396963609;Taip;18;0;0;18
6377;Pakalnutė;Pagrandukai;1883500676;Taip;5;3;0;8
6378;Pakalnutė;"Pelėdžiukų ";7110858765;Taip;0;0;1;1
6379;Pakalnutė;"Pelėdžiukų ";8553182620;Taip;0;1;0;1
6380;Pakalnutė;"Pelėdžiukų ";3840499737;Taip;0;10;0;10
6381;Pakalnutė;"Pelėdžiukų ";4523766424;Taip;5;0;1;6
6382;Pakalnutė;"Pelėdžiukų ";6577255841;Taip;7;0;0;7
6383;Pakalnutė;"Pelėdžiukų ";7151877991;Ne;6;1;2;9
6384;Pakalnutė;"Pelėdžiukų ";2992768162;Ne;0;3;0;3
6385;Pakalnutė;"Pelėdžiukų ";9505524183;Taip;18;0;0;18
6386;Pakalnutė;"Pelėdžiukų ";8823232039;Taip;4;2;0;6
6387;Pakalnutė;"Pelėdžiukų ";8900756351;Taip;3;0;0;3
6388;Pakalnutė;"Pelėdžiukų ";2035060922;Taip;6;0;0;6
6389;Pakalnutė;"Pelėdžiukų ";7325137583;Taip;0;3;0;3
6390;Pakalnutė;"Pelėdžiukų ";4220368864;Taip;0;3;2;5
6391;Pakalnutė;"Pelėdžiukų ";1330092247;Taip;3;6;0;9
6392;Pakalnutė;"Pelėdžiukų ";3267680599;Ne;0;5;0;5
6393;Pakalnutė;"Pelėdžiukų ";4452372238;Taip;0;6;2;8
6394;Pakalnutė;Ežiukai;1070172991;Taip;0;1;0;1
6395;Pakalnutė;Ežiukai;9323200833;Taip;3;4;0;7
6396;Pakalnutė;Ežiukai;9781993614;Taip;0;8;0;8
6397;Pakalnutė;Ežiukai;9256219647;Taip;0;3;0;3
6398;Pakalnutė;Ežiukai;7853479591;Taip;0;3;0;3
6399;Pakalnutė;Ežiukai;7734657452;Taip;1;0;1;2
6400;Pakalnutė;Ežiukai;8081932074;Taip;0;11;0;11
6401;Pakalnutė;Ežiukai;9706455707;Taip;3;0;1;4
6402;Pakalnutė;Ežiukai;7881545979;Ne;8;2;0;10
6403;Pakalnutė;Ežiukai;8080989574;Taip;5;0;0;5
6404;Pakalnutė;Ežiukai;2755412687;Taip;9;0;0;9
6405;Pakalnutė;Skruzdėliukų;4033813807;Taip;0;3;1;4
6406;Pakalnutė;Skruzdėliukų;7503936754;Taip;8;0;0;8
6407;Pakalnutė;Skruzdėliukų;5409476517;Taip;8;11;0;19
6408;Pakalnutė;Skruzdėliukų;2670302354;Taip;9;0;0;9
6409;Pakalnutė;Skruzdėliukų;7105369111;Taip;5;0;0;5
6410;Pakalnutė;Skruzdėliukų;6944726166;Taip;9;0;0;9
6411;Pakalnutė;Skruzdėliukų;1195872320;Taip;9;5;0;14
6412;Pakalnutė;Skruzdėliukų;3211633472;Taip;8;1;0;9
6413;Pakalnutė;Skruzdėliukų;4423348418;Taip;0;5;0;5
6414;Pakalnutė;Skruzdėliukų;5619262190;Taip;13;0;0;13
6415;Pakalnutė;Skruzdėliukų;3215438452;Taip;5;0;0;5
6416;Pakalnutė;Skruzdėliukų;9681515221;Taip;8;0;0;8
6417;Pakalnutė;Skruzdėliukų;8496839980;Taip;13;0;0;13
6418;Pakalnutė;Skruzdėliukų;9336711927;Taip;0;0;2;2
6419;Pakalnutė;Bitučių;8461220770;Ne;0;0;2;2
6420;Pakalnutė;Bitučių;2765220889;Taip;0;2;0;2
6421;Pakalnutė;Bitučių;5532458706;Taip;0;13;0;13
6422;Pakalnutė;Bitučių;7526989580;Taip;4;0;0;4
6423;Pakalnutė;Bitučių;3306334576;Taip;10;0;0;10
6424;Pakalnutė;Bitučių;2095540372;Taip;0;2;1;3
6425;Pakalnutė;Bitučių;5342592825;Taip;8;0;0;8
6426;Pakalnutė;Bitučių;5464143742;Taip;12;0;0;12
6427;Pakalnutė;Bitučių;6351193702;Taip;0;1;0;1
6428;Pakalnutė;Bitučių;3965390135;Taip;5;0;0;5
6429;Pakalnutė;Bitučių;5355198213;Taip;7;0;0;7
6430;Pakalnutė;Bitučių;4533467194;Ne;0;0;6;6
6431;Pakalnutė;Bitučių;3288449407;Taip;5;0;0;5
6432;Pakalnutė;Bitučių;3583094831;Taip;3;0;2;5
6433;Pakalnutė;Boružiukų;5120176374;Ne;0;5;0;5
6434;Pakalnutė;Boružiukų;6798939288;Taip;0;3;0;3
6435;Pakalnutė;Boružiukų;7357431226;Taip;3;6;0;9
6436;Pakalnutė;Boružiukų;4934095931;Taip;5;3;0;8
6437;Pakalnutė;Boružiukų;5039000154;Taip;4;2;0;6
6438;Pakalnutė;Boružiukų;6575909478;Taip;0;0;2;2
6439;Pakalnutė;Boružiukų;2835611316;Taip;4;0;0;4
6440;Pakalnutė;Boružiukų;7672252382;Taip;0;3;0;3
6441;Pakalnutė;Boružiukų;4950195858;Taip;6;0;0;6
6442;Pakalnutė;Boružiukų;4927086034;Taip;2;0;0;2
6443;Pakalnutė;Boružiukų;6557165567;Taip;8;8;0;16
6444;Pakalnutė;Boružiukų;3677709759;Taip;9;0;0;9
6445;Pakalnutė;Boružiukų;2597900983;Taip;6;0;0;6
6446;Pakalnutė;Boružiukų;2062721289;Taip;6;0;0;6
6447;Pakalnutė;Boružiukų;1340022702;Taip;14;0;0;14
6448;Pakalnutė;Boružiukų;6228196996;Taip;20;0;0;20
6449;Pakalnutė;Boružiukų;7563201788;Ne;3;0;1;4
6450;Pakalnutė;Meškiukų;2666441234;Taip;5;0;0;5
6451;Pakalnutė;Meškiukų;4256222944;Taip;8;3;0;11
6452;Pakalnutė;Meškiukų;2101821362;Taip;0;5;0;5
6453;Pakalnutė;Meškiukų;4069910346;Ne;0;1;0;1
6454;Pakalnutė;Meškiukų;4313652059;Ne;0;8;0;8
6455;Pakalnutė;Meškiukų;3693337607;Taip;5;0;0;5
6456;Pakalnutė;Meškiukų;2923698853;Taip;15;5;0;20
6457;Pakalnutė;Meškiukų;1369906621;Taip;0;0;1;1
6458;Pakalnutė;Nykštukai;9918277117;Taip;5;0;1;6
6459;Pakalnutė;Nykštukai;6633585181;Taip;13;0;0;13
6460;Pakalnutė;Nykštukai;3870628774;Taip;0;0;1;1
6461;Pakalnutė;Nykštukai;8324219868;Ne;0;23;0;23
6462;Pakalnutė;Nykštukai;1864990681;Taip;10;0;1;11
6463;Pakalnutė;Nykštukai;1236187157;Taip;2;0;3;5
6464;Pakalnutė;Nykštukai;2063766287;Taip;0;4;0;4
6465;Pakalnutė;Nykštukai;6528913736;Ne;0;5;0;5
6466;Pakalnutė;Nykštukai;8217779439;Taip;1;0;1;2
6467;Pakalnutė;Nykštukai;8855237588;Taip;3;5;0;8
6468;Pakalnutė;Nykštukai;1561411767;Taip;4;5;0;9
6469;Pakalnutė;Nykštukai;9443826616;Taip;18;0;0;18
6470;Pakalnutė;Nykštukai;7024440142;Taip;0;23;0;23
6471;Pakalnutė;Nykštukai;2578170222;Taip;18;0;0;18
6472;Pakalnutė;Nykštukai;3967515235;Taip;15;3;1;19
6473;Pakalnutė;Nykštukai;5377715404;Taip;19;0;0;19
6474;Pakalnutė;Nykštukai;3938091521;Taip;14;0;0;14
6475;Pakalnutė;"Zuikučių ";1198230323;Taip;0;3;0;3
6476;Pakalnutė;"Zuikučių ";3609982613;Taip;11;2;0;13
6477;Pakalnutė;"Zuikučių ";5958653847;Taip;0;3;0;3
6478;Pakalnutė;"Zuikučių ";1147843795;Taip;0;7;0;7
6479;Pakalnutė;"Zuikučių ";1583462733;Ne;0;3;0;3
6480;Pakalnutė;"Zuikučių ";6377564215;Taip;6;0;0;6
6481;Pakalnutė;"Zuikučių ";8813262660;Taip;0;6;0;6
6482;Pakalnutė;"Zuikučių ";7949588551;Taip;0;0;1;1
6483;Pakalnutė;"Zuikučių ";81578522887;Taip;7;0;0;7
6484;Pakalnutė;"Zuikučių ";2002555659;Ne;0;0;4;4
6485;Pakalnutė;"Zuikučių ";4681267749;Taip;7;3;0;10
6486;Pakalnutė;"Zuikučių ";6884488772;Taip;9;0;1;10
6487;Pakalnutė;"Zuikučių ";5912904296;Taip;5;4;0;9
6488;Pakalnutė;"Drugelių ";5441477374;Ne;8;1;1;10
6489;Pakalnutė;"Drugelių ";7369661890;Taip;1;0;1;2
6490;Pakalnutė;"Drugelių ";5135811550;Taip;8;0;0;8
6491;Pakalnutė;"Drugelių ";7766653114;Taip;8;0;3;11
6492;Pakalnutė;"Drugelių ";7709684372;Taip;8;0;1;9
6493;Pakalnutė;"Drugelių ";9620000116;Taip;0;0;1;1
6494;Pakalnutė;"Drugelių ";5502444590;Taip;8;0;2;10
6495;Pakalnutė;"Drugelių ";3730712580;Taip;4;0;1;5
6496;Pakalnutė;"Drugelių ";9461133636;Taip;12;0;1;13
6497;Pakalnutė;"Drugelių ";4220406978;Ne;4;0;3;7
6498;Pakalnutė;"Drugelių ";5069038636;Taip;5;0;0;5
6499;Pakalnutė;"Drugelių ";7047587606;Taip;8;12;0;20
6500;Pakalnutė;"Drugelių ";2653667596;Taip;0;0;1;1
6501;Pakalnutė;"Drugelių ";2026242407;Ne;5;0;4;9
6502;Pakalnutė;"Drugelių ";2197533802;Taip;9;0;1;10
6503;Pakalnutė;"Drugelių ";1791607977;Taip;5;0;0;5
6504;Pakalnutė;"Drugelių ";4127500142;Taip;6;0;1;7
6505;Pakalnutė;"Drugelių ";9295709508;Taip;12;0;0;12
6506;Pakalnutė;Žvirbliukų;8329725085;Taip;7;1;0;8
6507;Pakalnutė;Žvirbliukų;3190067149;Taip;0;6;1;7
6508;Pakalnutė;Žvirbliukų;7548659665;Taip;6;0;0;6
6509;Pakalnutė;Žvirbliukų;8010667913;Taip;13;0;0;13
6510;Pakalnutė;Žvirbliukų;1662773049;Taip;7;2;1;10
6511;Pakalnutė;Žvirbliukų;5531209454;Taip;6;0;1;7
6512;Pakalnutė;Žvirbliukų;7258417347;Taip;14;0;0;14
6513;Pakalnutė;Žvirbliukų;4961361687;Taip;0;1;0;1
6514;Pakalnutė;Žvirbliukų;5878352514;Taip;8;0;1;9
6515;Pakalnutė;Žvirbliukų;5685361033;Taip;6;2;0;8
6516;Pakalnutė;Žvirbliukų;7782295402;Taip;8;0;0;8
6517;Pakalnutė;Žvirbliukų;7547661599;Taip;13;1;0;14
6518;Pakalnutė;Žvirbliukų;4469974699;Taip;0;2;0;2
6519;Pakalnutė;Žvirbliukų;6159955311;Taip;8;0;0;8
6520;Pakalnutė;Žvirbliukų;3903972025;Taip;7;2;2;11
6521;Panerių;Rūtelė;3438863665;Taip;0;8;0;8
6522;Panerių;Rūtelė;4689913361;Taip;0;0;6;6
6523;Panerių;Rūtelė;2195332401;Taip;0;0;2;2
6524;Panerių;Rūtelė;2571561865;Taip;6;3;0;9
6525;Panerių;Rūtelė;6908487075;Taip;0;3;4;7
6526;Panerių;Rūtelė;2643410976;Ne;0;3;0;3
6527;Panerių;Rūtelė;8771264170;Ne;0;0;1;1
6528;Panerių;Rūtelė;7805429137;Taip;17;0;1;18
6529;Panerių;Rūtelė;9268618414;Taip;5;0;3;8
6530;Panerių;Rūtelė;6411372006;Taip;6;3;2;11
6531;Panerių;Rūtelė;1419817211;Ne;6;2;0;8
6532;Panerių;Rūtelė;2333355325;Taip;6;0;1;7
6533;Panerių;Rūtelė;3913395809;Taip;8;3;4;15
6534;Panerių;Rūtelė;4867297993;Taip;0;0;2;2
6535;Panerių;Rūtelė;2235123048;Ne;16;0;2;18
6536;Panerių;Rūtelė;9631684972;Taip;0;1;4;5
6537;Panerių;Rūtelė;3190117304;Ne;0;9;0;9
6538;Panerių;Rūtelė;8693113275;Ne;18;0;0;18
6539;Panerių;Rūtelė;6468190149;Taip;0;0;2;2
6540;Panerių;Rūtelė;9630302749;Taip;21;0;0;21
6541;Panerių;Rūtelė;3057714143;Taip;0;3;1;4
6542;Panerių;Gėlytės;3550194241;Taip;0;0;1;1
6543;Panerių;Gėlytės;8514805919;Taip;0;0;2;2
6544;Panerių;Gėlytės;1339256258;Taip;0;0;1;1
6545;Panerių;Gėlytės;9729731866;Taip;4;3;0;7
6546;Panerių;Gėlytės;3948776877;Taip;7;0;0;7
6547;Panerių;Gėlytės;2751334281;Taip;0;0;1;1
6548;Panerių;Gėlytės;9432171719;Taip;9;3;0;12
6549;Panerių;Gėlytės;5452996791;Taip;6;2;0;8
6550;Panerių;Gėlytės;1717129076;Ne;9;1;0;10
6551;Panerių;Gėlytės;2035822976;Taip;0;0;5;5
6552;Panerių;Gėlytės;8447920373;Taip;9;0;0;9
6553;Panerių;Gėlytės;4161189870;Taip;0;7;4;11
6554;Panerių;Gėlytės;9004310393;Taip;17;0;0;17
6555;Panerių;Gėlytės;3112608087;Ne;5;0;1;6
6556;Panerių;Gėlytės;5100874548;Taip;10;0;0;10
6557;Panerių;Gėlytės;9955613696;Taip;0;0;1;1
6558;Panerių;Gėlytės;3882802840;Taip;2;3;0;5
6559;Panerių;Gėlytės;6304387432;Taip;0;0;2;2
6560;Panerių;Gėlytės;7166964095;Taip;6;0;1;7
6561;Panerių;Boružė;7657860513;Ne;13;6;0;19
6562;Panerių;Boružė;9014387764;Taip;0;1;0;1
6563;Panerių;Boružė;3273655606;Ne;9;0;2;11
6564;Panerių;Boružė;8067240250;Ne;13;0;0;13
6565;Panerių;Boružė;3526636673;Taip;3;0;0;3
6566;Panerių;Boružė;8407995549;Taip;10;0;1;11
6567;Panerių;Boružė;3502494751;Taip;11;0;0;11
6568;Panerių;Boružė;6653710644;Taip;0;0;1;1
6569;Panerių;Boružė;7227118885;Ne;13;0;0;13
6570;Panerių;Boružė;9288515724;Ne;7;0;1;8
6571;Panerių;Boružė;7976634590;Ne;10;0;0;10
6572;Panerių;Boružė;4957564440;Taip;3;0;2;5
6573;Papartis;ZUIKUČIAI;8874222586;Taip;5;0;5;10
6574;Papartis;ZUIKUČIAI;2446379598;Taip;0;0;7;7
6575;Papartis;ZUIKUČIAI;1191546794;Taip;1;5;1;7
6576;Papartis;ZUIKUČIAI;7619963429;Taip;7;1;0;8
6577;Papartis;ZUIKUČIAI;8958880558;Taip;0;8;1;9
6578;Papartis;ZUIKUČIAI;4380030213;Ne;16;0;0;16
6579;Papartis;ZUIKUČIAI;4906248064;Taip;0;7;3;10
6580;Papartis;ZUIKUČIAI;8447326505;Taip;8;1;0;9
6581;Papartis;ZUIKUČIAI;1919362027;Taip;2;1;1;4
6582;Papartis;ZUIKUČIAI;5361925390;Taip;0;0;3;3
6583;Papartis;ZUIKUČIAI;5796928317;Taip;8;0;0;8
6584;Papartis;ZUIKUČIAI;9375751990;Taip;0;3;1;4
6585;Papartis;ZUIKUČIAI;6266095782;Taip;0;8;0;8
6586;Papartis;ZUIKUČIAI;5786648402;Taip;0;0;9;9
6587;Papartis;ZUIKUČIAI;5776038830;Taip;0;0;3;3
6588;Papartis;ZUIKUČIAI;5579899922;Taip;8;0;4;12
6589;Papartis;ZUIKUČIAI;9358310527;Taip;2;5;0;7
6590;Papartis;ZUIKUČIAI;5363926529;Taip;0;5;0;5
6591;Papartis;ZUIKUČIAI;1722192450;Taip;0;1;1;2
6592;Papartis;DRUGELIAI;8005876431;Taip;7;0;0;7
6593;Papartis;DRUGELIAI;7384518191;Taip;11;3;0;14
6594;Papartis;DRUGELIAI;6664178454;Ne;0;1;2;3
6595;Papartis;DRUGELIAI;2432516496;Taip;10;3;3;16
6596;Papartis;DRUGELIAI;7742769931;Taip;5;0;1;6
6597;Papartis;DRUGELIAI;8305560946;Ne;4;0;2;6
6598;Papartis;DRUGELIAI;4778327620;Taip;5;9;0;14
6599;Papartis;DRUGELIAI;7331682622;Taip;17;0;1;18
6600;Papartis;DRUGELIAI;2824078830;Taip;14;3;1;18
6601;Papartis;DRUGELIAI;8782882575;Taip;0;1;0;1
6602;Papartis;DRUGELIAI;1405767603;Taip;1;3;2;6
6603;Papartis;DRUGELIAI;6435625940;Taip;2;2;0;4
6604;Papartis;DRUGELIAI;7187797639;Taip;8;0;2;10
6605;Papartis;DRUGELIAI;3411472740;Taip;23;0;0;23
6606;Papartis;DRUGELIAI;3209105694;Taip;0;0;1;1
6607;Papartis;DRUGELIAI;8277830926;Taip;1;5;0;6
6608;Papartis;DRUGELIAI;1759982543;Taip;0;4;0;4
6609;Papartis;DRUGELIAI;4689046394;Taip;0;6;0;6
6610;Papartis;ŽVIRBLIUKAI;7590170146;Taip;0;1;0;1
6611;Papartis;ŽVIRBLIUKAI;42803013754;Taip;0;3;0;3
6612;Papartis;ŽVIRBLIUKAI;3408756311;Taip;0;4;0;4
6613;Papartis;ŽVIRBLIUKAI;4935694347;Taip;0;3;0;3
6614;Papartis;ŽVIRBLIUKAI;7067369268;Ne;6;3;0;9
6615;Papartis;ŽVIRBLIUKAI;1836914270;Taip;0;3;0;3
6616;Papartis;ŽVIRBLIUKAI;4508053349;Taip;8;0;0;8
6617;Papartis;ŽVIRBLIUKAI;2778629398;Taip;5;3;3;11
6618;Papartis;ŽVIRBLIUKAI;2535412635;Taip;3;0;2;5
6619;Papartis;ŽVIRBLIUKAI;7102350653;Taip;0;2;0;2
6620;Papartis;ŽVIRBLIUKAI;1205854439;Taip;5;0;0;5
6621;Papartis;ŽVIRBLIUKAI;1672028156;Taip;0;3;0;3
6622;Papartis;ŽVIRBLIUKAI;3295731801;Ne;0;3;2;5
6623;Papartis;ŽVIRBLIUKAI;6797687614;Taip;0;3;0;3
6624;Papartis;ŽVIRBLIUKAI;3475745012;Taip;13;3;1;17
6625;Papartis;ŽVIRBLIUKAI;4634683589;Taip;5;2;0;7
6626;Papartis;ŽVIRBLIUKAI;3267416367;Taip;0;1;1;2
6627;Papartis;ŽVIRBLIUKAI;5265293240;Taip;0;1;2;3
6628;Papartis;ŽVIRBLIUKAI;9134335737;Taip;0;1;3;4
6629;Papartis;ŽVIRBLIUKAI;7387281720;Taip;0;4;0;4
6630;Papartis;PELĖDŽIUKAI;7606939822;Taip;0;1;0;1
6631;Papartis;PELĖDŽIUKAI;2447926422;Taip;0;9;0;9
6632;Papartis;PELĖDŽIUKAI;1260151691;Taip;0;4;0;4
6633;Papartis;PELĖDŽIUKAI;4346817695;Taip;4;0;0;4
6634;Papartis;PELĖDŽIUKAI;1527263538;Taip;0;3;0;3
6635;Papartis;PELĖDŽIUKAI;1219140467;Taip;0;3;0;3
6636;Papartis;PELĖDŽIUKAI;5410369044;Ne;0;7;0;7
6637;Papartis;PELĖDŽIUKAI;1065128993;Taip;0;3;0;3
6638;Papartis;PELĖDŽIUKAI;6126912448;Taip;0;5;0;5
6639;Papartis;PELĖDŽIUKAI;8952917454;Ne;2;3;1;6
6640;Papartis;PELĖDŽIUKAI;3182457453;Taip;20;2;0;22
6641;Papartis;PELĖDŽIUKAI;5675537250;Taip;4;0;0;4
6642;Papartis;PELĖDŽIUKAI;72182866449;Taip;0;2;1;3
6643;Papartis;PELĖDŽIUKAI;4992305227;Taip;8;1;0;9
6644;Papartis;PELĖDŽIUKAI;7703070601;Ne;0;8;0;8
6645;Papartis;PELĖDŽIUKAI;7902130389;Taip;0;1;0;1
6646;Papartis;PELĖDŽIUKAI;1974159967;Taip;0;7;0;7
6647;Papartis;PELĖDŽIUKAI;5732853976;Taip;0;6;1;7
6648;Papartis;PELĖDŽIUKAI;1554777403;Ne;0;1;1;2
6649;Papartis;PELĖDŽIUKAI;3107106078;Taip;0;0;5;5
6650;Papartis;SAULUTĖS;5538433120;Taip;0;5;0;5
6651;Papartis;SAULUTĖS;2669085057;Ne;9;0;7;16
6652;Papartis;SAULUTĖS;6585372451;Taip;5;0;0;5
6653;Papartis;SAULUTĖS;6734567714;Taip;5;0;0;5
6654;Papartis;SAULUTĖS;4570512336;Ne;7;1;0;8
6655;Papartis;SAULUTĖS;3539507686;Taip;7;3;0;10
6656;Papartis;SAULUTĖS;6977513472;Taip;0;3;0;3
6657;Papartis;SAULUTĖS;5070767260;Taip;5;3;0;8
6658;Papartis;SAULUTĖS;9380951144;Taip;0;5;2;7
6659;Papartis;SAULUTĖS;4016297254;Taip;23;0;0;23
6660;Papartis;SAULUTĖS;5323875279;Taip;0;10;0;10
6661;Papartis;SAULUTĖS;5465955537;Taip;7;1;0;8
6662;Papartis;SAULUTĖS;2812347963;Taip;13;1;0;14
6663;Papartis;SAULUTĖS;4597039190;Taip;8;0;0;8
6664;Papartis;SAULUTĖS;8420752169;Taip;0;4;6;10
6665;Papartis;SAULUTĖS;6346776139;Taip;1;14;0;15
6666;Papartis;SAULUTĖS;1352401881;Taip;0;0;1;1
6667;Papartis;SAULUTĖS;3685642787;Taip;12;0;2;14
6668;Papartis;SAULUTĖS;6136213985;Taip;0;6;4;10
6669;Papartis;SAULUTĖS;7107692314;Taip;0;6;4;10
6670;Papartis;GANDRIUKAI;4878190663;Taip;0;0;3;3
6671;Papartis;GANDRIUKAI;9900023788;Taip;0;2;1;3
6672;Papartis;GANDRIUKAI;2783708905;Taip;6;0;3;9
6673;Papartis;GANDRIUKAI;6883101103;Taip;0;1;0;1
6674;Papartis;GANDRIUKAI;2868899342;Taip;3;4;0;7
6675;Papartis;GANDRIUKAI;7768672610;Taip;0;2;0;2
6676;Papartis;GANDRIUKAI;9384670351;Taip;0;5;0;5
6677;Papartis;GANDRIUKAI;9968072478;Taip;0;1;9;10
6678;Papartis;GANDRIUKAI;2215846642;Taip;0;3;0;3
6679;Papartis;GANDRIUKAI;3320524073;Taip;15;3;0;18
6680;Papartis;GANDRIUKAI;9704930584;Taip;0;4;0;4
6681;Papartis;GANDRIUKAI;9804863902;Taip;0;3;0;3
6682;Papartis;GANDRIUKAI;9072635586;Ne;3;7;0;10
6683;Papartis;GANDRIUKAI;7859096984;Taip;0;3;0;3
6684;Papartis;GANDRIUKAI;7252265838;Taip;0;2;0;2
6685;Papartis;GANDRIUKAI;9978625382;Taip;18;0;0;18
6686;Papartis;GANDRIUKAI;5883751305;Ne;0;1;0;1
6687;Papartis;GANDRIUKAI;4509843536;Taip;0;20;0;20
6688;Papartis;GANDRIUKAI;8768526171;Taip;19;0;0;19
6689;Papartis;AITVARELIAI;8891856856;Taip;2;4;0;6
6690;Papartis;AITVARELIAI;6889782462;Taip;8;0;2;10
6691;Papartis;AITVARELIAI;5736456872;Taip;0;4;0;4
6692;Papartis;AITVARELIAI;3040269026;Taip;0;4;0;4
6693;Papartis;AITVARELIAI;8532558577;Taip;0;3;0;3
6694;Papartis;AITVARELIAI;4918854899;Taip;0;5;0;5
6695;Papartis;AITVARELIAI;5252947502;Taip;9;0;0;9
6696;Papartis;AITVARELIAI;1916222143;Taip;4;1;0;5
6697;Papartis;AITVARELIAI;7803854703;Taip;9;1;0;10
6698;Papartis;AITVARELIAI;4261270064;Taip;0;1;0;1
6699;Papartis;AITVARELIAI;6416605464;Taip;10;0;1;11
6700;Papartis;AITVARELIAI;7504793827;Taip;10;0;0;10
6701;Papartis;AITVARELIAI;7156767639;Taip;5;0;2;7
6702;Papartis;AITVARELIAI;5268226380;Ne;11;0;0;11
6703;Papartis;AITVARELIAI;8626682787;Taip;0;0;17;17
6704;Papartis;AITVARELIAI;2116140075;Taip;5;4;0;9
6705;Papartis;AITVARELIAI;3896803048;Taip;11;0;0;11
6706;Papartis;AITVARELIAI;4138926711;Ne;0;0;1;1
6707;Papartis;AITVARELIAI;8989172483;Taip;0;0;19;19
6708;Papartis;AITVARELIAI;9384475270;Taip;10;0;0;10
6709;Papartis;SMALSUČIAI;7856148436;Ne;14;0;0;14
6710;Papartis;SMALSUČIAI;5383936595;Taip;16;0;1;17
6711;Papartis;SMALSUČIAI;1698871014;Taip;13;0;0;13
6712;Papartis;SMALSUČIAI;6274608449;Taip;16;1;1;18
6713;Papartis;SMALSUČIAI;6664773988;Taip;3;3;2;8
6714;Papartis;SMALSUČIAI;8875490564;Taip;13;0;0;13
6715;Papartis;SMALSUČIAI;2921187615;Taip;13;0;0;13
6716;Papartis;SMALSUČIAI;4500675679;Taip;14;2;0;16
6717;Papartis;SMALSUČIAI;7203919287;Taip;13;0;0;13
6718;Papartis;SMALSUČIAI;1486770896;Ne;0;0;3;3
6719;Papartis;SMALSUČIAI;5132031416;Taip;18;0;0;18
6720;Papartis;SMALSUČIAI;3395306653;Taip;15;0;0;15
6721;Papartis;SMALSUČIAI;5964232886;Taip;13;0;0;13
6722;Papartis;SMALSUČIAI;4483401826;Taip;5;0;1;6
6723;Papartis;SMALSUČIAI;1616537800;Taip;10;6;0;16
6724;Papartis;"ŽIRNIUKAI ";8897061283;Taip;8;0;0;8
6725;Papartis;"ŽIRNIUKAI ";3310893254;Taip;0;0;1;1
6726;Papartis;"ŽIRNIUKAI ";1073755384;Taip;0;5;3;8
6727;Papartis;"ŽIRNIUKAI ";7647225316;Taip;6;5;0;11
6728;Papartis;"ŽIRNIUKAI ";1210592579;Taip;8;0;0;8
6729;Papartis;"ŽIRNIUKAI ";1519815331;Taip;5;0;0;5
6730;Papartis;"ŽIRNIUKAI ";4158525314;Taip;0;0;4;4
6731;Papartis;"ŽIRNIUKAI ";4978398085;Taip;0;1;0;1
6732;Papartis;"ŽIRNIUKAI ";9746397380;Taip;0;0;4;4
6733;Papartis;"ŽIRNIUKAI ";4952279543;Taip;0;0;12;12
6734;Papartis;"ŽIRNIUKAI ";5276806556;Taip;2;0;0;2
6735;Papartis;"ŽIRNIUKAI ";2521609574;Taip;15;0;0;15
6736;Papartis;"ŽIRNIUKAI ";7617558492;Taip;0;0;11;11
6737;Papartis;"ŽIRNIUKAI ";8412962815;Ne;0;0;3;3
6738;Papartis;"ŽIRNIUKAI ";1267981238;Taip;9;3;0;12
6739;Papartis;"ŽIRNIUKAI ";2772758899;Taip;0;3;3;6
6740;Papartis;"ŽIRNIUKAI ";1183123161;Ne;13;0;0;13
6741;Papartis;"ŽIRNIUKAI ";1150772988;Ne;0;1;0;1
6742;Papartis;"ŽIRNIUKAI ";6615368741;Taip;9;0;0;9
6743;Papartis;"ŽIRNIUKAI ";7108606229;Ne;11;0;1;12
6744;Papartis;BORUŽĖLĖS;3576856223;Taip;0;6;0;6
6745;Papartis;BORUŽĖLĖS;7492923318;Taip;9;0;0;9
6746;Papartis;BORUŽĖLĖS;1157298413;Taip;6;1;0;7
6747;Papartis;BORUŽĖLĖS;2079105902;Taip;0;1;0;1
6748;Papartis;BORUŽĖLĖS;1159418157;Taip;11;0;0;11
6749;Papartis;BORUŽĖLĖS;3490370261;Taip;19;0;0;19
6750;Papartis;BORUŽĖLĖS;7298032812;Taip;10;0;0;10
6751;Papartis;BORUŽĖLĖS;3107245976;Ne;0;0;1;1
6752;Papartis;BORUŽĖLĖS;1566259150;Ne;13;0;1;14
6753;Papartis;BORUŽĖLĖS;1381195839;Taip;0;0;2;2
6754;Papartis;BORUŽĖLĖS;6107558090;Taip;0;1;0;1
6755;Papartis;BORUŽĖLĖS;6776383676;Taip;10;4;0;14
6756;Papartis;BORUŽĖLĖS;9838432144;Taip;3;3;0;6
6757;Papartis;BORUŽĖLĖS;9884399306;Taip;3;2;0;5
6758;Papartis;BORUŽĖLĖS;1511111597;Taip;10;0;1;11
6759;Papartis;BORUŽĖLĖS;8055310718;Taip;13;0;0;13
6760;Papartis;BORUŽĖLĖS;5959006739;Taip;0;3;0;3
6761;Papartis;VARPELIAI;7260304487;Taip;18;0;0;18
6762;Papartis;VARPELIAI;9581159294;Taip;13;0;9;22
6763;Papartis;VARPELIAI;2956950308;Taip;0;0;2;2
6764;Papartis;VARPELIAI;6710049689;Taip;9;0;4;13
6765;Papartis;VARPELIAI;2777359899;Taip;14;0;2;16
6766;Papartis;VARPELIAI;1993893368;Taip;11;0;0;11
6767;Papartis;VARPELIAI;3345085436;Taip;10;0;0;10
6768;Papartis;VARPELIAI;7189999679;Taip;8;1;0;9
6769;Papartis;VARPELIAI;4256878733;Ne;14;1;2;17
6770;Papartis;VARPELIAI;8443731277;Taip;10;4;0;14
6771;Papartis;VARPELIAI;3419374226;Taip;0;0;22;22
6772;Papartis;VARPELIAI;3173271837;Taip;4;0;0;4
6773;Papartis;VARPELIAI;4952700737;Taip;21;0;0;21
6774;Papartis;VARPELIAI;6146264193;Taip;16;0;0;16
6775;Papartis;VARPELIAI;8642079824;Taip;0;3;2;5
6776;Papartis;VARPELIAI;2421158534;Taip;0;0;3;3
6777;Papartis;VARPELIAI;8872914372;Taip;5;0;0;5
6778;Papartis;NYKŠTUKAI;1566011843;Ne;1;0;0;1
6779;Papartis;NYKŠTUKAI;5942160584;Taip;13;0;0;13
6780;Papartis;NYKŠTUKAI;1680412204;Ne;0;0;1;1
6781;Papartis;NYKŠTUKAI;9285319899;Taip;13;0;4;17
6782;Papartis;NYKŠTUKAI;9502229005;Taip;0;3;0;3
6783;Papartis;NYKŠTUKAI;6949120693;Taip;0;7;0;7
6784;Papartis;NYKŠTUKAI;6794076631;Taip;6;3;0;9
6785;Papartis;NYKŠTUKAI;5957889361;Taip;4;0;0;4
6786;Papartis;NYKŠTUKAI;5608868738;Ne;0;4;0;4
6787;Papartis;NYKŠTUKAI;4203241118;Taip;7;3;0;10
6788;Papartis;NYKŠTUKAI;9939850340;Taip;0;4;0;4
6789;Papartis;NYKŠTUKAI;3324647852;Taip;0;8;2;10
6790;Papartis;NYKŠTUKAI;8932290803;Taip;7;1;1;9
6791;Papartis;NYKŠTUKAI;5652560002;Taip;0;5;0;5
6792;Papartis;NYKŠTUKAI;1559196767;Ne;0;0;4;4
6793;Papartis;NYKŠTUKAI;6360881137;Taip;4;1;1;6
6794;Papartis;NYKŠTUKAI;6941978169;Taip;9;0;2;11
6795;Papartis;NYKŠTUKAI;7080578299;Taip;10;0;5;15
6796;Pasaka;Drugelių;5438303030;Taip;6;0;0;6
6797;Pasaka;Drugelių;5665758011;Taip;0;4;0;4
6798;Pasaka;Drugelių;5027755073;Ne;9;2;0;11
6799;Pasaka;Drugelių;1300996831;Taip;0;2;2;4
6800;Pasaka;Drugelių;1313576071;Taip;0;1;4;5
6801;Pasaka;Drugelių;2621046003;Taip;3;0;0;3
6802;Pasaka;Drugelių;7040953491;Taip;8;4;0;12
6803;Pasaka;Drugelių;7455544922;Taip;0;3;0;3
6804;Pasaka;Drugelių;8963465320;Taip;0;4;0;4
6805;Pasaka;Drugelių;4743331873;Taip;4;1;6;11
6806;Pasaka;Drugelių;1583090840;Taip;0;1;0;1
6807;Pasaka;Drugelių;2774371800;Taip;0;5;3;8
6808;Pasaka;Drugelių;5547931812;Ne;10;1;0;11
6809;Pasaka;Drugelių;7685589423;Taip;0;3;0;3
6810;Pasaka;Drugelių;3088081091;Taip;0;2;0;2
6811;Pasaka;Drugelių;9060396476;Taip;4;3;0;7
6812;Pasaka;Nykštukų;7546205285;Taip;2;5;0;7
6813;Pasaka;Nykštukų;5687494160;Taip;0;3;0;3
6814;Pasaka;Nykštukų;3151916774;Taip;0;4;0;4
6815;Pasaka;Nykštukų;4773893970;Taip;5;3;0;8
6816;Pasaka;Nykštukų;4082752808;Taip;7;0;3;10
6817;Pasaka;Nykštukų;6788771605;Taip;0;3;0;3
6818;Pasaka;Nykštukų;5412931969;Taip;5;6;1;12
6819;Pasaka;Nykštukų;1813068555;Taip;4;2;0;6
6820;Pasaka;Nykštukų;8400549247;Taip;8;0;0;8
6821;Pasaka;Nykštukų;6326056771;Taip;0;5;2;7
6822;Pasaka;Nykštukų;4175157894;Taip;7;0;3;10
6823;Pasaka;Nykštukų;5768958388;Taip;9;2;0;11
6824;Pasaka;Nykštukų;2797217440;Taip;0;2;0;2
6825;Pasaka;Montesori;16974081144;Taip;0;3;9;12
6826;Pasaka;Montesori;1514381003;Taip;0;0;6;6
6827;Pasaka;Montesori;5812041166;Taip;0;3;1;4
6828;Pasaka;Montesori;4305485747;Taip;5;0;5;10
6829;Pasaka;Montesori;7837662446;Ne;4;0;7;11
6830;Pasaka;Montesori;3047931231;Ne;0;0;6;6
6831;Pasaka;Montesori;5031538468;Taip;5;1;0;6
6832;Pasaka;Montesori;6625690696;Taip;5;0;1;6
6833;Pasaka;Montesori;4548601585;Taip;0;5;0;5
6834;Pasaka;Montesori;7887326763;Taip;0;0;1;1
6835;Pasaka;Montesori;4366930715;Taip;0;0;5;5
6836;Pasaka;Montesori;9850592463;Taip;11;0;0;11
6837;Pasaka;Montesori;2995831258;Taip;0;2;0;2
6838;Pasaka;Montesori;1216568014;Taip;0;1;5;6
6839;Pasaka;Montesori;6248810027;Ne;0;0;7;7
6840;Pasaka;Montesori;3620395122;Taip;5;0;4;9
6841;Pasaka;Montesori;5689164477;Taip;5;0;6;11
6842;Pasaka;Montesori;6484610418;Taip;0;0;10;10
6843;Pasaka;Montesori;8873248505;Taip;15;0;0;15
6844;Pasaka;Žirniukų;9867183480;Taip;5;0;1;6
6845;Pasaka;Žirniukų;3783869856;Taip;4;1;0;5
6846;Pasaka;Žirniukų;5651025350;Taip;4;0;0;4
6847;Pasaka;Žirniukų;2422958320;Taip;7;3;1;11
6848;Pasaka;Žirniukų;9438006825;Taip;6;0;0;6
6849;Pasaka;Žirniukų;9136524816;Taip;0;0;5;5
6850;Pasaka;Žirniukų;9766432049;Taip;8;0;3;11
6851;Pasaka;Žirniukų;6668421711;Taip;0;0;2;2
6852;Pasaka;Žirniukų;6387972576;Taip;5;0;0;5
6853;Pasaka;Žirniukų;4948174745;Taip;13;0;0;13
6854;Pasaka;Žirniukų;2144975281;Ne;9;0;1;10
6855;Pasaka;Žirniukų;4629119214;Taip;0;0;2;2
6856;Pasaka;Žirniukų;2086919906;Taip;14;0;8;22
6857;Pasaka;Žirniukų;8519108324;Taip;4;3;0;7
6858;Pasaka;Žirniukų;9950979894;Taip;5;0;4;9
6859;Pasaka;Žirniukų;9654507441;Taip;7;0;1;8
6860;Pasaka;Žirniukų;9654507441;Taip;7;0;1;8
6861;Pasaka;Žirniukų;9654507441;Taip;7;0;1;8
6862;Pasaka;Žirniukų;5921553817;Taip;6;0;1;7
6863;Pasaka;Žirniukų;2569560383;Taip;12;2;0;14
6864;Pasaka;"Voveriukų ";3606141216;Taip;8;5;0;13
6865;Pasaka;"Voveriukų ";5217688848;Taip;8;4;0;12
6866;Pasaka;"Voveriukų ";4171004263;Taip;10;3;0;13
6867;Pasaka;"Voveriukų ";8504575043;Taip;0;0;3;3
6868;Pasaka;"Voveriukų ";1488711275;Taip;0;2;0;2
6869;Pasaka;"Voveriukų ";2854919649;Taip;6;0;1;7
6870;Pasaka;"Voveriukų ";1950145441;Taip;15;0;0;15
6871;Pasaka;"Voveriukų ";4466963221;Taip;0;4;0;4
6872;Pasaka;"Voveriukų ";9588247759;Ne;0;3;0;3
6873;Pasaka;"Voveriukų ";3536862796;Ne;3;0;0;3
6874;Pasaka;"Voveriukų ";8899289832;Ne;0;1;0;1
6875;Pasaka;"Voveriukų ";4915357646;Taip;6;0;5;11
6876;Pasaka;"Voveriukų ";7176272684;Taip;18;1;0;19
6877;Pasaka;"Voveriukų ";4799036184;Taip;0;0;5;5
6878;Pasaka;"Voveriukų ";6684234474;Taip;8;0;2;10
6879;Pasaka;"Voveriukų ";9003508760;Taip;0;5;6;11
6880;Pasaka;"Voveriukų ";6925961600;Ne;0;7;0;7
6881;Pasaka;"Voveriukų ";8421404290;Ne;10;0;0;10
6882;Pasaka;"Voveriukų ";1745181416;Taip;0;0;6;6
6883;Pasaka;"Voveriukų ";9780490338;Taip;16;0;0;16
6884;Pasaka;"Voveriukų ";6315362421;Taip;4;8;0;12
6885;Pasaka;"Voveriukų ";6315362421;Taip;4;8;0;12
6886;Pasaka;"VALDOFRO 12";7010681103;Taip;4;5;0;9
6887;Pasaka;"VALDOFRO 12";56766427323;Taip;6;0;0;6
6888;Pasaka;"VALDOFRO 12";4680456848;Taip;0;0;2;2
6889;Pasaka;"VALDOFRO 12";5141156728;Taip;0;2;0;2
6890;Pasaka;"VALDOFRO 12";2268625523;Taip;6;0;5;11
6891;Pasaka;"VALDOFRO 12";8976424908;Taip;6;0;0;6
6892;Pasaka;"VALDOFRO 12";8701112181;Ne;0;0;5;5
6893;Pasaka;"VALDOFRO 12";1305541319;Taip;4;3;2;9
6894;Pasaka;"VALDOFRO 12";7682903999;Ne;0;0;4;4
6895;Pasaka;"VALDOFRO 12";4325198579;Taip;4;3;5;12
6896;Pasaka;"VALDOFRO 12";6448940090;Taip;0;3;3;6
6897;Pasaka;"VALDOFRO 12";8411025450;Taip;12;1;3;16
6898;Pasaka;"VALDOFRO 12";1756831961;Taip;3;2;1;6
6899;Pasaka;"VALDOFRO 12";3840053722;Ne;6;7;0;13
6900;Pasaka;"VALDOFRO 12";8995205555;Taip;0;2;6;8
6901;Pasaka;"VALDOFRO 12";4548945364;Taip;0;0;2;2
6902;Pasaka;"VALDOFRO 12";4301573328;Taip;9;0;0;9
6903;Pasaka;"VALDOFRO 12";5244582148;Ne;6;0;0;6
6904;Pasaka;"VALDOFRO 12";2650797982;Taip;5;0;5;10
6905;Pasaka;"VALDOFRO 12";9065016148;Taip;9;0;0;9
6906;Pasaka;"VALDOFRO 12";9809498406;Taip;0;0;3;3
6907;Pasaka;"VALDOFRO 12";5040348350;Taip;0;2;6;8
6908;Pasaka;"VALDORFO 2";71365777764;Taip;3;3;0;6
6909;Pasaka;"VALDORFO 2";77904202630;Taip;0;3;4;7
6910;Pasaka;"VALDORFO 2";4752117533;Taip;0;9;0;9
6911;Pasaka;"VALDORFO 2";7950962252;Taip;0;2;0;2
6912;Pasaka;"VALDORFO 2";8590385693;Taip;0;0;2;2
6913;Pasaka;"VALDORFO 2";4620573687;Taip;0;4;0;4
6914;Pasaka;"VALDORFO 2";4825373152;Taip;0;2;3;5
6915;Pasaka;"VALDORFO 2";9462745431;Taip;0;0;8;8
6916;Pasaka;"VALDORFO 2";5399148997;Taip;0;2;0;2
6917;Pasaka;"VALDORFO 2";1799326151;Taip;9;3;0;12
6918;Pasaka;"VALDORFO 2";2273629510;Taip;6;3;0;9
6919;Pasaka;"VALDORFO 2";5903270845;Taip;0;0;8;8
6920;Pasaka;"VALDORFO 2";3778182691;Taip;0;4;0;4
6921;Pasaka;"VALDORFO 2";5742479853;Taip;0;2;3;5
6922;Pasaka;"VALDORFO 2";3049361712;Taip;0;0;3;3
6923;Pasaka;"VALDORFO 2";6497042042;Taip;16;0;1;17
6924;Pasaka;"VALDORFO 2";9150761761;Taip;0;0;2;2
6925;Pasaka;"VALDORFO 2";9821858308;Taip;16;0;0;16
6926;Pasaka;"VALDORFO 2";1648043715;Taip;11;0;0;11
6927;Pasaka;"VALDORFO 2";8855436141;Taip;0;0;6;6
6928;Pasaka;Gudručiai;4137222204;Taip;8;2;2;12
6929;Pasaka;Gudručiai;7103485358;Taip;0;4;2;6
6930;Pasaka;Gudručiai;7648503006;Taip;3;0;0;3
6931;Pasaka;Gudručiai;2400455036;Taip;5;1;0;6
6932;Pasaka;Gudručiai;9722435751;Taip;0;3;0;3
6933;Pasaka;Gudručiai;73703706115;Taip;3;5;4;12
6934;Pasaka;Gudručiai;79170702319;Taip;2;6;2;10
6935;Pasaka;Gudručiai;5965121999;Taip;0;6;3;9
6936;Pasaka;Gudručiai;7286419663;Taip;0;0;2;2
6937;Pasaka;Gudručiai;5973028582;Taip;0;0;5;5
6938;Pasaka;Gudručiai;2788679885;Taip;6;3;0;9
6939;Pasaka;Gudručiai;7445696309;Taip;0;3;0;3
6940;Pasaka;Gudručiai;1565873178;Taip;2;1;2;5
6941;Pasaka;Gudručiai;2697014098;Taip;0;3;0;3
6942;Pasaka;Gudručiai;5651452381;Taip;8;1;0;9
6943;Pasaka;Gudručiai;6441884677;Taip;8;1;0;9
6944;Pasaka;Gudručiai;2018620389;Taip;3;3;2;8
6945;Pasaka;Gudručiai;2671403814;Taip;5;0;1;6
6946;Pasaka;Gudručiai;42548487389;Taip;0;0;2;2
6947;Pasaka;Gudručiai;8448558788;Taip;5;0;1;6
6948;Pasaka;Bitelių;5351364328;Taip;0;0;8;8
6949;Pasaka;Bitelių;4635912654;Taip;0;0;8;8
6950;Pasaka;Bitelių;7248640367;Ne;0;4;0;4
6951;Pasaka;Bitelių;8277245475;Ne;7;0;0;7
6952;Pasaka;Bitelių;6868519179;Taip;4;0;2;6
6953;Pasaka;Bitelių;6759415053;Taip;5;0;4;9
6954;Pasaka;Bitelių;5723970763;Taip;5;3;1;9
6955;Pasaka;Bitelių;9136521759;Taip;0;2;3;5
6956;Pasaka;Bitelių;9737445077;Taip;5;0;0;5
6957;Pasaka;Bitelių;2293613528;Taip;0;7;0;7
6958;Pasaka;Bitelių;3367346582;Taip;18;0;0;18
6959;Pasaka;Bitelių;3351338617;Taip;0;8;0;8
6960;Pasaka;Bitelių;5371046207;Taip;18;0;0;18
6961;Pasaka;Bitelių;1335408890;Taip;0;1;0;1
6962;Pasaka;Bitelių;6139825302;Taip;0;3;0;3
6963;Pasaka;Bitelių;8873115041;Taip;5;0;0;5
6964;Pasaka;Bitelių;1720511696;Taip;5;0;0;5
6965;Pasaka;"Pabiručių ";4846146925;Taip;0;0;11;11
6966;Pasaka;"Pabiručių ";9770811826;Taip;0;0;9;9
6967;Pasaka;"Pabiručių ";5230621839;Taip;8;3;2;13
6968;Pasaka;"Pabiručių ";9471447977;Ne;0;0;4;4
6969;Pasaka;"Pabiručių ";7751618911;Taip;11;0;0;11
6970;Pasaka;"Pabiručių ";7696383564;Taip;3;0;0;3
6971;Pasaka;"Pabiručių ";3796844193;Taip;6;0;1;7
6972;Pasaka;"Pabiručių ";7240424576;Taip;14;0;0;14
6973;Pasaka;"Pabiručių ";4910817298;Taip;0;0;1;1
6974;Pasaka;"Pabiručių ";7127138831;Taip;6;0;0;6
6975;Pasaka;"Pabiručių ";9813397639;Taip;6;0;0;6
6976;Pasaka;"Pabiručių ";4994426702;Taip;0;0;7;7
6977;Pasaka;"Pabiručių ";8289010515;Taip;0;0;7;7
6978;Pasaka;"Pabiručių ";8558563996;Taip;1;0;1;2
6979;Pasaka;Šnekučių;1512874567;Taip;0;2;1;3
6980;Pasaka;Šnekučių;1793176485;Taip;0;4;0;4
6981;Pasaka;Šnekučių;4296539838;Ne;3;0;5;8
6982;Pasaka;Šnekučių;1590306118;Taip;5;1;0;6
6983;Pasaka;Šnekučių;3240292756;Taip;0;1;0;1
6984;Pasaka;Šnekučių;8365256755;Taip;1;3;0;4
6985;Pasaka;Šnekučių;1562771242;Taip;4;0;2;6
6986;Pasaka;Šnekučių;4816441219;Taip;8;0;2;10
6987;Pasaka;Šnekučių;1795497567;Taip;0;3;5;8
6988;Pasaka;Šnekučių;8841669113;Taip;9;0;1;10
6989;Pasaka;Šnekučių;4975045894;Taip;0;0;3;3
6990;Pasaka;Šnekučių;3588073618;Taip;4;0;0;4
6991;Pasaka;Šnekučių;1194745876;Ne;23;0;0;23
6992;Pasaka;Šnekučių;1749821746;Taip;0;3;9;12
6993;Pasaka;Šnekučių;1723076060;Taip;5;0;2;7
6994;Pasaka;Šnekučių;8475365713;Taip;1;2;1;4
6995;Pasaka;Šnekučių;5656511105;Taip;10;0;0;10
6996;Paslaptis;MONTIKI;4683384309;Taip;0;3;0;3
6997;Paslaptis;MONTIKI;6860366087;Ne;15;0;0;15
6998;Paslaptis;MONTIKI;9445405671;Taip;2;0;1;3
6999;Paslaptis;MONTIKI;3572102816;Taip;6;0;3;9
7000;Paslaptis;MONTIKI;2927014406;Ne;10;0;0;10
7001;Paslaptis;MONTIKI;7053452493;Taip;0;1;0;1
7002;Paslaptis;MONTIKI;8909545951;Taip;0;1;0;1
7003;Paslaptis;MONTIKI;3963816472;Taip;3;0;4;7
7004;Paslaptis;MONTIKI;5809630456;Taip;0;1;2;3
7005;Paslaptis;MONTIKI;6764142182;Taip;15;1;0;16
7006;Paslaptis;MONTIKI;3241323665;Ne;9;1;0;10
7007;Paslaptis;MONTIKI;9497654214;Taip;5;0;0;5
7008;Paslaptis;FRUTIKI;9100003209;Ne;0;4;0;4
7009;Paslaptis;FRUTIKI;4130010071;Taip;0;1;0;1
7010;Paslaptis;FRUTIKI;3984799090;Ne;11;0;0;11
7011;Paslaptis;FRUTIKI;5886364670;Taip;0;1;1;2
7012;Paslaptis;FRUTIKI;5406800599;Ne;6;0;0;6
7013;Paslaptis;FRUTIKI;2675089401;Taip;7;0;0;7
7014;Paslaptis;FRUTIKI;1557783684;Taip;0;8;0;8
7015;Paslaptis;FRUTIKI;8895770223;Taip;0;1;0;1
7016;Paslaptis;FRUTIKI;5206529350;Taip;0;12;0;12
7017;Paslaptis;FRUTIKI;2105441745;Taip;13;0;0;13
7018;Paslaptis;FRUTIKI;6686352764;Taip;0;1;3;4
7019;Paslaptis;FRUTIKI;5456011928;Taip;0;3;0;3
7020;Paslaptis;FRUTIKI;8717111488;Ne;0;7;0;7
7021;Paslaptis;FRUTIKI;5756338103;Taip;0;1;0;1
7022;Paslaptis;FRUTIKI;5646806136;Taip;0;1;1;2
7023;Paslaptis;FRUTIKI;4810686225;Taip;0;1;0;1
7024;Paslaptis;FRUTIKI;8296575784;Ne;10;5;0;15
7025;Paslaptis;FRUTIKI;1754621741;Ne;8;1;0;9
7026;Paslaptis;FRUTIKI;7638521198;Taip;13;0;0;13
7027;Paslaptis;KALAMBURIKI;1029321312;Taip;0;3;0;3
7028;Paslaptis;KALAMBURIKI;3093280943;Taip;5;3;0;8
7029;Paslaptis;KALAMBURIKI;9559318660;Taip;3;0;0;3
7030;Paslaptis;KALAMBURIKI;2705751628;Taip;0;5;0;5
7031;Paslaptis;KALAMBURIKI;2879752620;Taip;8;4;0;12
7032;Paslaptis;KALAMBURIKI;8280740387;Taip;0;1;3;4
7033;Paslaptis;KALAMBURIKI;2693910134;Ne;1;4;0;5
7034;Paslaptis;KALAMBURIKI;3104525540;Ne;15;0;0;15
7035;Paslaptis;KALAMBURIKI;1186681520;Taip;7;0;0;7
7036;Paslaptis;KALAMBURIKI;3415869190;Taip;0;8;0;8
7037;Paslaptis;KALAMBURIKI;3549998192;Taip;6;3;0;9
7038;Paslaptis;KALAMBURIKI;1782398974;Taip;8;1;0;9
7039;Paslaptis;KALAMBURIKI;8146824196;Taip;2;1;0;3
7040;Paslaptis;KALAMBURIKI;4109288950;Taip;5;0;0;5
7041;Paslaptis;KALAMBURIKI;3398729758;Taip;0;1;0;1
7042;Paslaptis;KALAMBURIKI;8083478190;Taip;0;1;5;6
7043;Paslaptis;KALAMBURIKI;2089780119;Taip;0;11;0;11
7044;Pasakaitė;Vieversėlių;7685647972;Taip;5;4;8;17
7045;Pasakaitė;Vieversėlių;6459145539;Taip;0;6;0;6
7046;Pasakaitė;Vieversėlių;2194313054;Taip;0;3;0;3
7047;Pasakaitė;Vieversėlių;9587489514;Taip;0;0;2;2
7048;Pasakaitė;Vieversėlių;3444442287;Taip;6;0;2;8
7049;Pasakaitė;Vieversėlių;5485965486;Taip;6;0;0;6
7050;Pasakaitė;Vieversėlių;2563725297;Taip;0;0;2;2
7051;Pasakaitė;Vieversėlių;2849753418;Taip;1;0;7;8
7052;Pasakaitė;Vieversėlių;8043493934;Taip;0;1;0;1
7053;Pasakaitė;Vieversėlių;7963057831;Taip;0;4;0;4
7054;Pasakaitė;Vieversėlių;9543991684;Taip;0;9;0;9
7055;Pasakaitė;Vieversėlių;3680596008;Taip;0;4;0;4
7056;Pasakaitė;Vieversėlių;4882856664;Taip;9;6;1;16
7057;Pasakaitė;Vieversėlių;5953162958;Ne;8;0;3;11
7058;Pasakaitė;Vieversėlių;5948958906;Taip;2;2;0;4
7059;Pasakaitė;Vieversėlių;1060914693;Taip;8;2;0;10
7060;Pasakaitė;Vieversėlių;7761162338;Taip;22;4;0;26
7061;Pasakaitė;Vieversėlių;8463220257;Taip;0;2;0;2
7062;Pasakaitė;Vieversėlių;9018830962;Taip;19;6;0;25
7063;Pasakaitė;Vieversėlių;6736879757;Ne;0;0;13;13
7064;Pasakaitė;Vieversėlių;4191875802;Taip;6;0;9;15
7065;Pasakaitė;Vieversėlių;5020801150;Taip;6;0;1;7
7066;Pasakaitė;Spindulėlių;4758073190;Taip;9;0;0;9
7067;Pasakaitė;Spindulėlių;6714500298;Taip;5;0;0;5
7068;Pasakaitė;Spindulėlių;1697755753;Taip;8;9;0;17
7069;Pasakaitė;Spindulėlių;1056358241;Taip;0;7;0;7
7070;Pasakaitė;Spindulėlių;8105641645;Taip;11;0;0;11
7071;Pasakaitė;Spindulėlių;5791927811;Taip;5;27;0;32
7072;Pasakaitė;Spindulėlių;5094404397;Taip;5;27;0;32
7073;Pasakaitė;Spindulėlių;9870015737;Ne;18;0;0;18
7074;Pasakaitė;Spindulėlių;1449037968;Taip;0;6;0;6
7075;Pasakaitė;Spindulėlių;7474100735;Taip;0;4;0;4
7076;Pasakaitė;Spindulėlių;6015360076;Taip;0;26;0;26
7077;Pasakaitė;Spindulėlių;2733800758;Taip;0;0;2;2
7078;Pasakaitė;Spindulėlių;6256000265;Taip;10;1;0;11
7079;Pasakaitė;Spindulėlių;2891089579;Taip;10;1;0;11
7080;Pasakaitė;Spindulėlių;3652896053;Taip;10;0;0;10
7081;Pasakaitė;Spindulėlių;7265623955;Taip;22;0;1;23
7082;Pasakaitė;Spindulėlių;1564611671;Taip;7;4;1;12
7083;Pasakaitė;Spindulėlių;3283593388;Taip;0;0;3;3
7084;Pasakaitė;Spindulėlių;2652882309;Taip;6;7;0;13
7085;Pasakaitė;Spindulėlių;4268438476;Taip;14;0;0;14
7086;Pasakaitė;Pasagėlių;9895144528;Taip;0;0;6;6
7087;Pasakaitė;Pasagėlių;6609127382;Ne;4;0;0;4
7088;Pasakaitė;Pasagėlių;9409907631;Taip;10;3;0;13
7089;Pasakaitė;Pasagėlių;5589440439;Taip;10;0;1;11
7090;Pasakaitė;Pasagėlių;5959875562;Taip;2;0;0;2
7091;Pasakaitė;Pasagėlių;3355268509;Taip;3;2;0;5
7092;Pasakaitė;Pasagėlių;1959599606;Taip;0;11;0;11
7093;Pasakaitė;Pasagėlių;7440327561;Taip;4;1;0;5
7094;Pasakaitė;Pasagėlių;6325408070;Taip;5;0;4;9
7095;Pasakaitė;Pasagėlių;9238905834;Taip;8;6;0;14
7096;Pasakaitė;Pasagėlių;5970146724;Taip;23;0;0;23
7097;Pasakaitė;Pasagėlių;7666033916;Taip;8;0;0;8
7098;Pasakaitė;Pasagėlių;5540251866;Taip;0;3;0;3
7099;Pasakaitė;Pasagėlių;7219080600;Ne;13;3;0;16
7100;Pasakaitė;Pasagėlių;8264189678;Taip;3;0;0;3
7101;Pasakaitė;Pasagėlių;2341175137;Taip;5;3;1;9
7102;Pasakaitė;Pasagėlių;8905681529;Taip;6;2;0;8
7103;Pasakaitė;Pasagėlių;8165055476;Taip;0;3;3;6
7104;Pasakaitė;Pasagėlių;7360801624;Taip;8;3;0;11
7105;Pasakaitė;Pasagėlių;5617173998;Taip;0;0;1;1
7106;Pasakaitė;Pasagėlių;5034077389;Taip;0;3;3;6
7107;Pasakaitė;Švyturėlių;7702359586;Taip;0;3;0;3
7108;Pasakaitė;Švyturėlių;2721048424;Taip;0;2;0;2
7109;Pasakaitė;Švyturėlių;1278198989;Taip;20;0;3;23
7110;Pasakaitė;Švyturėlių;6847782430;Taip;0;3;0;3
7111;Pasakaitė;Švyturėlių;4728731352;Taip;1;0;0;1
7112;Pasakaitė;Švyturėlių;9821617981;Taip;0;0;4;4
7113;Pasakaitė;Švyturėlių;1619513932;Taip;0;10;0;10
7114;Pasakaitė;Švyturėlių;1184513606;Taip;0;0;3;3
7115;Pasakaitė;Švyturėlių;4864779439;Taip;0;2;0;2
7116;Pasakaitė;Švyturėlių;8223662339;Taip;5;3;0;8
7117;Pasakaitė;Švyturėlių;3710143250;Taip;0;9;0;9
7118;Pasakaitė;Švyturėlių;2329827275;Taip;5;0;2;7
7119;Pasakaitė;Švyturėlių;2933474317;Taip;10;3;0;13
7120;Pasakaitė;Švyturėlių;5498393070;Ne;0;0;1;1
7121;Pasakaitė;Švyturėlių;9012098645;Ne;0;0;2;2
7122;Pasakaitė;Švyturėlių;4604843442;Taip;0;13;0;13
7123;Pasakaitė;Švyturėlių;3417077517;Taip;0;0;3;3
7124;Pasakaitė;Švyturėlių;1793453325;Taip;3;0;1;4
7125;Pasakaitė;Kodėlčiukų;8662488739;Taip;15;0;0;15
7126;Pasakaitė;Kodėlčiukų;9972985920;Taip;5;0;1;6
7127;Pasakaitė;Kodėlčiukų;5699688792;Taip;13;0;1;14
7128;Pasakaitė;Kodėlčiukų;9441990175;Ne;0;0;15;15
7129;Pasakaitė;Kodėlčiukų;1588525307;Taip;4;0;3;7
7130;Pasakaitė;Kodėlčiukų;4485053261;Taip;7;4;2;13
7131;Pasakaitė;Kodėlčiukų;9351971114;Taip;6;0;2;8
7132;Pasakaitė;Kodėlčiukų;2303884875;Taip;14;0;1;15
7133;Pasakaitė;Kodėlčiukų;9543262464;Taip;2;0;0;2
7134;Pasakaitė;Kodėlčiukų;4878562841;Taip;6;0;3;9
7135;Pasakaitė;Kodėlčiukų;2994653871;Taip;8;0;3;11
7136;Pasakaitė;Kodėlčiukų;4328440534;Taip;6;0;0;6
7137;Pasakaitė;Kodėlčiukų;4881361200;Ne;13;0;0;13
7138;Pasakaitė;Kodėlčiukų;2389832646;Taip;8;0;0;8
7139;Pasakaitė;Kodėlčiukų;7138417196;Taip;12;0;2;14
7140;Pasakaitė;Kodėlčiukų;5581264184;Taip;0;5;0;5
7141;Pasakaitė;Kodėlčiukų;8037316673;Ne;8;0;2;10
7142;Pasakaitė;Kodėlčiukų;5732009054;Taip;5;1;0;6
7143;Pasakaitė;Kodėlčiukų;2407824666;Taip;0;3;2;5
7144;Pasakaitė;Kodėlčiukų;6755983130;Taip;17;0;2;19
7145;Pasakaitė;Kodėlčiukų;2476010561;Taip;10;8;5;23
7146;Pasakaitė;Kodėlčiukų;3925034196;Taip;10;8;5;23
7147;Pasakaitė;Gudručių;6568538767;Ne;6;6;0;12
7148;Pasakaitė;Gudručių;1523034176;Taip;0;2;0;2
7149;Pasakaitė;Gudručių;5369558652;Taip;0;1;0;1
7150;Pasakaitė;Gudručių;1019010454;Taip;0;10;0;10
7151;Pasakaitė;Gudručių;4703375416;Taip;0;2;2;4
7152;Pasakaitė;Gudručių;1707428977;Taip;8;3;0;11
7153;Pasakaitė;Gudručių;3345955615;Taip;8;3;0;11
7154;Pasakaitė;Gudručių;1791015854;Taip;0;1;2;3
7155;Pasakaitė;Gudručių;39853246609;Taip;10;0;0;10
7156;Pasakaitė;Gudručių;67374677045;Taip;0;3;0;3
7157;Pasakaitė;Gudručių;4959175420;Taip;8;6;0;14
7158;Pasakaitė;Gudručių;6839399035;Taip;6;0;2;8
7159;Pasakaitė;Gudručių;3778906698;Taip;0;1;4;5
7160;Pasakaitė;Gudručių;1940545723;Taip;6;2;0;8
7161;Pasakaitė;Gudručių;9506178305;Taip;5;0;2;7
7162;Pasakaitė;Gudručių;1809383469;Taip;5;2;1;8
7163;Pasakaitė;Gudručių;1592521766;Taip;5;0;0;5
7164;Pasakaitė;Gudručių;4008826950;Taip;8;0;3;11
7165;Pasakaitė;Gudručių;9031690002;Taip;6;3;1;10
7166;Pasakaitė;Gudručių;2742595829;Taip;0;3;0;3
7167;Pasakaitė;Gudručių;1513903341;Taip;11;3;0;14
7168;Pasakaitė;Gudručių;3231283338;Taip;0;1;1;2
7169;Pasakaitė;Čiulbonėlių;4680949976;Taip;0;6;0;6
7170;Pasakaitė;Čiulbonėlių;7152349570;Taip;5;8;0;13
7171;Pasakaitė;Čiulbonėlių;1458338379;Taip;23;0;0;23
7172;Pasakaitė;Čiulbonėlių;7526264241;Taip;0;3;4;7
7173;Pasakaitė;Čiulbonėlių;3541877287;Taip;0;2;1;3
7174;Pasakaitė;Čiulbonėlių;4974486850;Ne;9;3;0;12
7175;Pasakaitė;Čiulbonėlių;7607522887;Taip;3;9;0;12
7176;Pasakaitė;Čiulbonėlių;3606601644;Taip;0;4;0;4
7177;Pasakaitė;Čiulbonėlių;5313360864;Taip;0;0;1;1
7178;Pasakaitė;Čiulbonėlių;3579498202;Taip;0;9;0;9
7179;Pasakaitė;Čiulbonėlių;1220619991;Taip;0;0;3;3
7180;Pasakaitė;Čiulbonėlių;3400305768;Taip;0;2;0;2
7181;Pasakaitė;Čiulbonėlių;3165658822;Taip;0;3;0;3
7182;Pasakaitė;Čiulbonėlių;4013900094;Taip;0;2;3;5
7183;Pasakaitė;Čiulbonėlių;5605619860;Taip;0;1;0;1
7184;Pasakaitė;Čiulbonėlių;61230317080;Ne;0;8;0;8
7185;Pasakaitė;Čiulbonėlių;8466086339;Taip;7;5;0;12
7186;Pasakaitė;Čiulbonėlių;3259688782;Taip;0;1;1;2
7187;Pasakaitė;Čiulbonėlių;5467179333;Taip;0;3;1;4
7188;Pasakaitė;Čiulbonėlių;1740419218;Taip;0;8;0;8
7189;Pasakaitė;Čiulbonėlių;8469043564;Taip;0;6;5;11
7190;Pasakaitė;"Verpstelių ";7621306769;Taip;1;12;0;13
7191;Pasakaitė;"Verpstelių ";4946855684;Taip;5;11;0;16
7192;Pasakaitė;"Verpstelių ";5556362727;Ne;11;0;1;12
7193;Pasakaitė;"Verpstelių ";7451624229;Ne;5;0;1;6
7194;Pasakaitė;"Verpstelių ";7759051761;Taip;4;0;0;4
7195;Pasakaitė;"Verpstelių ";8315840473;Taip;5;0;0;5
7196;Pasakaitė;"Verpstelių ";1744216870;Taip;5;4;0;9
7197;Pasakaitė;"Verpstelių ";1425166722;Taip;5;0;1;6
7198;Pasakaitė;"Verpstelių ";7813221735;Taip;5;0;6;11
7199;Pasakaitė;"Verpstelių ";9166649594;Taip;4;4;0;8
7200;Pasakaitė;"Verpstelių ";4246461594;Taip;0;0;11;11
7201;Pasakaitė;"Verpstelių ";1963102227;Taip;7;0;12;19
7202;Pasakaitė;"Verpstelių ";8267725352;Taip;5;0;6;11
7203;Pasakaitė;"Verpstelių ";5866092980;Ne;10;0;3;13
7204;Pasakaitė;"Verpstelių ";8562284745;Taip;5;3;0;8
7205;Pasakaitė;"Verpstelių ";1041405418;Taip;4;9;0;13
7206;Pasakaitė;"Verpstelių ";7976921380;Taip;9;6;0;15
7207;Pasakaitė;"Verpstelių ";2505815026;Taip;24;0;5;29
7208;Pasakaitė;"Verpstelių ";5413457806;Taip;5;0;0;5
7209;Pasakaitė;"Verpstelių ";1115383380;Taip;5;0;0;5
7210;Pasakaitė;"Verpstelių ";2714905466;Taip;0;0;1;1
7211;Pasakaitė;"Verpstelių ";9226989209;Taip;5;0;0;5
7212;Pasakaitė;"Verpstelių ";8927014508;Taip;5;0;1;6
7213;Pasakaitė;Smalsučiai;7539851375;Taip;3;0;0;3
7214;Pasakaitė;Smalsučiai;9114337491;Taip;0;0;1;1
7215;Pasakaitė;Smalsučiai;2278658674;Taip;18;0;0;18
7216;Pasakaitė;Smalsučiai;7557414266;Taip;9;3;0;12
7217;Pasakaitė;Smalsučiai;6522727154;Taip;1;0;1;2
7218;Pasakaitė;Smalsučiai;1122248122;Taip;12;0;1;13
7219;Pasakaitė;Smalsučiai;9982451343;Taip;3;0;1;4
7220;Pasakaitė;Smalsučiai;4977052991;Taip;3;0;1;4
7221;Pasakaitė;Smalsučiai;7604996145;Taip;21;0;0;21
7222;Pasakaitė;Smalsučiai;4307883488;Taip;0;12;5;17
7223;Pasakaitė;Smalsučiai;7994712153;Taip;15;3;0;18
7224;Pasakaitė;"Čiauškučiai ";7399335037;Taip;0;2;0;2
7225;Pasakaitė;"Čiauškučiai ";4098119950;Taip;1;6;0;7
7226;Pasakaitė;"Čiauškučiai ";6229020982;Taip;0;2;3;5
7227;Pasakaitė;"Čiauškučiai ";5279719152;Taip;14;3;0;17
7228;Pasakaitė;"Čiauškučiai ";1705913604;Taip;6;0;0;6
7229;Pasakaitė;"Čiauškučiai ";4898974534;Taip;3;0;0;3
7230;Pasakaitė;"Čiauškučiai ";3691817711;Taip;0;2;0;2
7231;Pasakaitė;"Čiauškučiai ";3659371923;Taip;0;0;1;1
7232;Pasakaitė;"Čiauškučiai ";7885958426;Taip;1;0;0;1
7233;Pasakaitė;"Čiauškučiai ";2902368705;Taip;0;20;0;20
7234;Pasakaitė;"Čiauškučiai ";2041179927;Taip;9;0;0;9
7235;Pasakaitė;"Čiauškučiai ";6745120294;Taip;5;0;0;5
7236;Pasakaitė;Pabiručiai;5180059311;Taip;4;1;0;5
7237;Pasakaitė;Pabiručiai;8478538959;Taip;13;0;1;14
7238;Pasakaitė;Pabiručiai;6795204239;Taip;0;0;4;4
7239;Pasakaitė;Pabiručiai;5058070480;Taip;22;0;0;22
7240;Pasakaitė;Pabiručiai;1453976284;Ne;0;14;1;15
7241;Pasakaitė;Pabiručiai;8559244062;Ne;5;0;0;5
7242;Pasakaitė;Pabiručiai;9790988677;Taip;0;17;0;17
7243;Pasakaitė;Pabiručiai;5439936572;Taip;20;1;0;21
7244;Pasakaitė;Pabiručiai;4316883215;Taip;6;0;2;8
7245;Pasakaitė;Pabiručiai;6682010485;Taip;3;0;1;4
7246;Pasakaitė;Pabiručiai;3466308130;Taip;0;0;22;22
7247;Pasakaitė;Pabiručiai;9402238675;Taip;10;0;0;10
7248;Pasakaitė;Pabiručiai;9311649698;Taip;9;0;0;9
7249;Pasakaitė;Linksmučiai;7965916747;Taip;10;0;1;11
7250;Pasakaitė;Linksmučiai;1279728451;Taip;5;0;0;5
7251;Pasakaitė;Linksmučiai;2584717150;Taip;5;0;1;6
7252;Pasakaitė;Linksmučiai;4397797616;Taip;17;0;0;17
7253;Pasakaitė;Linksmučiai;4659277297;Taip;0;0;3;3
7254;Pasakaitė;Linksmučiai;8381083251;Taip;4;0;0;4
7255;Pasakaitė;Linksmučiai;8252123824;Taip;7;0;1;8
7256;Pasakaitė;Linksmučiai;4444725869;Ne;12;0;4;16
7257;Pasakaitė;Linksmučiai;2801785334;Taip;7;0;6;13
7258;Pasakaitė;Linksmučiai;4369400507;Ne;20;0;0;20
7259;Pasakaitė;Linksmučiai;9606533767;Taip;5;0;4;9
7260;Pasakaitė;Linksmučiai;2899659479;Taip;7;8;0;15
7261;Pasakaitė;Linksmučiai;8160163060;Taip;6;0;4;10
7262;Pasakaitė;Linksmučiai;8350808883;Taip;5;0;7;12
7263;Pelėda;BORUŽIUKŲ;3616720339;Taip;5;0;0;5
7264;Pelėda;BORUŽIUKŲ;4036088391;Taip;13;0;0;13
7265;Pelėda;BORUŽIUKŲ;5888109663;Taip;0;5;1;6
7266;Pelėda;BORUŽIUKŲ;8148826427;Ne;9;3;0;12
7267;Pelėda;BORUŽIUKŲ;9253550935;Ne;5;0;3;8
7268;Pelėda;BORUŽIUKŲ;8716979603;Taip;13;4;0;17
7269;Pelėda;BORUŽIUKŲ;9599801230;Taip;7;0;0;7
7270;Pelėda;BORUŽIUKŲ;2600073553;Taip;11;0;2;13
7271;Pelėda;BORUŽIUKŲ;4705608521;Taip;0;0;4;4
7272;Pelėda;BORUŽIUKŲ;6395649040;Taip;5;0;10;15
7273;Pelėda;BORUŽIUKŲ;2626787696;Taip;14;0;0;14
7274;Pelėda;BORUŽIUKŲ;9364884406;Taip;19;0;0;19
7275;Pelėda;BORUŽIUKŲ;8768572308;Taip;6;1;0;7
7276;Pelėda;BORUŽIUKŲ;3627796093;Taip;0;3;12;15
7277;Pelėda;BORUŽIUKŲ;9417248469;Taip;5;0;1;6
7278;Pelėda;BORUŽIUKŲ;1295177430;Taip;0;5;1;6
7279;Pelenė;Varpelis;2647876561;Taip;0;2;0;2
7280;Pelenė;Varpelis;8807342148;Taip;5;0;1;6
7281;Pelenė;Varpelis;2487632125;Taip;5;0;0;5
7282;Pelenė;Varpelis;3174009848;Taip;0;5;0;5
7283;Pelenė;Varpelis;6524101295;Taip;1;2;0;3
7284;Pelenė;Varpelis;4373886054;Taip;0;1;0;1
7285;Pelenė;Varpelis;4376033711;Taip;1;1;0;2
7286;Pelenė;Varpelis;1080017906;Taip;2;0;0;2
7287;Pelenė;Varpelis;4777496709;Taip;10;0;0;10
7288;Pelenė;Varpelis;9447223913;Taip;12;0;2;14
7289;Pelenė;Varpelis;6894978459;Taip;7;5;0;12
7290;Pelenė;Varpelis;4321705575;Taip;0;13;0;13
7291;Pelenė;Varpelis;2103177773;Taip;6;0;0;6
7292;Pelenė;Varpelis;4521556853;Taip;3;0;3;6
7293;Pelenė;Saulutės;7880284433;Taip;0;3;0;3
7294;Pelenė;Saulutės;2737277656;Taip;0;3;1;4
7295;Pelenė;Saulutės;1775717256;Taip;6;0;1;7
7296;Pelenė;Saulutės;4315677064;Taip;0;0;1;1
7297;Pelenė;Saulutės;7587887488;Taip;6;0;0;6
7298;Pelenė;Saulutės;5389865440;Taip;1;3;0;4
7299;Pelenė;Saulutės;8716395810;Taip;5;5;0;10
7300;Pelenė;Saulutės;6191899254;Ne;0;1;0;1
7301;Pelenė;Saulutės;6481466282;Taip;0;5;0;5
7302;Pelenė;Saulutės;6707167720;Taip;5;3;0;8
7303;Pelenė;Saulutės;8466974910;Taip;3;5;0;8
7304;Pelenė;Saulutės;2393964666;Ne;0;0;2;2
7305;Pelenė;Saulutės;5780697554;Taip;0;8;0;8
7306;Pelenė;Saulutės;4989239822;Taip;4;0;0;4
7307;Pelenė;Saulutės;6790396551;Ne;5;0;2;7
7308;Pelenė;Saulutės;1278011268;Taip;0;3;1;4
7309;Pelenė;Saulutės;2426412323;Taip;0;0;1;1
7310;Pelenė;Saulutės;6267178572;Taip;5;0;0;5
7311;Pelenė;Raktelis;9195113444;Taip;8;2;0;10
7312;Pelenė;Raktelis;9075193730;Taip;3;0;0;3
7313;Pelenė;Raktelis;4591637887;Taip;1;10;0;11
7314;Pelenė;Raktelis;7088493729;Taip;6;0;1;7
7315;Pelenė;Raktelis;4090532624;Ne;2;8;0;10
7316;Pelenė;Raktelis;8123162647;Taip;0;4;0;4
7317;Pelenė;Raktelis;3573543545;Taip;0;5;0;5
7318;Pelenė;Raktelis;7659625628;Taip;0;0;4;4
7319;Pelenė;Raktelis;6375060159;Taip;0;6;0;6
7320;Pelenė;Raktelis;2210314952;Taip;0;15;0;15
7321;Pelenė;Raktelis;6419661741;Taip;12;2;0;14
7322;Pelenė;Raktelis;4089199552;Taip;5;1;2;8
7323;Pelenė;Raktelis;6038229659;Taip;1;1;0;2
7324;Pelenė;Raktelis;1060619471;Taip;0;1;1;2
7325;Pelenė;Raktelis;5749399210;Taip;0;3;4;7
7326;Pelenė;Raktelis;4448592497;Taip;4;0;0;4
7327;Pelenė;Raktelis;5333802902;Taip;7;6;0;13
7328;Pelenė;Raktelis;8517226350;Taip;0;3;1;4
7329;Pelenė;Raktelis;5063098703;Taip;0;11;0;11
7330;Pelenė;Žvaigždutės;9473901831;Taip;3;1;0;4
7331;Pelenė;Žvaigždutės;2476080951;Taip;1;0;0;1
7332;Pelenė;Žvaigždutės;5548367924;Taip;19;0;2;21
7333;Pelenė;Žvaigždutės;5031778158;Taip;0;11;0;11
7334;Pelenė;Žvaigždutės;4056676361;Taip;0;0;3;3
7335;Pelenė;Žvaigždutės;6014571367;Taip;0;1;0;1
7336;Pelenė;Žvaigždutės;2555464779;Taip;6;0;0;6
7337;Pelenė;Žvaigždutės;9530531472;Ne;0;8;0;8
7338;Pelenė;Žvaigždutės;2040256240;Taip;0;0;1;1
7339;Pelenė;Žvaigždutės;4870187198;Taip;0;1;0;1
7340;Pelenė;Žvaigždutės;7640768043;Taip;23;0;0;23
7341;Pelenė;Žvaigždutės;4856039707;Taip;13;2;0;15
7342;Pelenė;Žvaigždutės;5894429453;Taip;3;0;0;3
7343;Pelenė;Nykštukas;9584503078;Ne;4;2;0;6
7344;Pelenė;Nykštukas;8770771520;Ne;0;1;0;1
7345;Pelenė;Nykštukas;10457480694;Taip;0;2;0;2
7346;Pelenė;Nykštukas;7254981715;Taip;0;1;0;1
7347;Pelenė;Nykštukas;6579504852;Taip;0;10;0;10
7348;Pelenė;Nykštukas;6021833025;Taip;0;4;0;4
7349;Pelenė;Nykštukas;3596386480;Taip;0;3;0;3
7350;Pelenė;Nykštukas;3385568839;Ne;0;1;0;1
7351;Pelenė;Nykštukas;7589978427;Taip;0;14;0;14
7352;Pelenė;Nykštukas;3189305906;Taip;0;4;0;4
7353;Pelenė;Nykštukas;1750366978;Taip;9;0;0;9
7354;Pelenė;Nykštukas;2092775878;Taip;0;1;0;1
7355;Pelenė;Nykštukas;1142014148;Ne;0;2;1;3
7356;Pelenė;Nykštukas;1605794833;Taip;0;4;0;4
7357;Pelenė;Nykštukas;9063588699;Taip;0;9;0;9
7358;Pelenė;Nykštukas;9621197758;Taip;0;1;0;1
7359;Pelenė;Žirniukai;8529178313;Taip;0;0;1;1
7360;Pelenė;Žirniukai;6046921077;Taip;0;0;2;2
7361;Pelenė;Žirniukai;9601582419;Taip;0;4;0;4
7362;Pelenė;Žirniukai;7057752202;Taip;5;0;0;5
7363;Pelenė;Žirniukai;7399112026;Taip;10;0;0;10
7364;Pelenė;Žirniukai;2443906444;Ne;7;0;0;7
7365;Pelenė;Žirniukai;5922348478;Taip;8;0;2;10
7366;Pelenė;Žirniukai;1313425695;Taip;7;3;3;13
7367;Pelenė;Žirniukai;5211115955;Taip;6;0;1;7
7368;Pelenė;Žirniukai;1595627222;Taip;0;10;0;10
7369;Pelenė;Žirniukai;2438266396;Taip;0;7;0;7
7370;Pelenė;Žirniukai;2590035984;Taip;0;2;0;2
7371;Pelenė;Žirniukai;3863839750;Taip;0;3;1;4
7372;Pelenė;Žirniukai;5686182866;Ne;6;0;1;7
7373;Pelenė;Žirniukai;7383544475;Taip;0;23;0;23
7374;Pelenė;Žirniukai;6661371876;Taip;9;2;0;11
7375;Pelenė;Žirniukai;2270989478;Taip;0;23;0;23
7376;Pelenė;Lašeliai;7017031073;Taip;0;1;1;2
7377;Pelenė;Lašeliai;9018211726;Taip;0;2;0;2
7378;Pelenė;Lašeliai;9313153383;Taip;0;15;0;15
7379;Pelenė;Lašeliai;5836118223;Taip;5;0;0;5
7380;Pelenė;Lašeliai;6316640679;Taip;0;3;2;5
7381;Pelenė;Lašeliai;1711603372;Taip;0;14;0;14
7382;Pelenė;Lašeliai;1944933777;Taip;0;6;0;6
7383;Pelenė;Lašeliai;2303618074;Taip;1;0;7;8
7384;Pelenė;Lašeliai;6167965418;Taip;3;0;1;4
7385;Pelenė;Lašeliai;2765650058;Taip;5;0;0;5
7386;Pelenė;Lašeliai;8841183816;Taip;7;0;0;7
7387;Pelenė;Lašeliai;4431474395;Taip;0;1;0;1
7388;Pelenė;Lašeliai;9097123374;Taip;0;4;0;4
7389;Pelenė;Lašeliai;9162252512;Taip;10;3;5;18
7390;Pelenė;Lašeliai;4695104609;Taip;0;7;0;7
7391;Pelenė;Lašeliai;7148956863;Taip;0;5;0;5
7392;Pelenė;Lašeliai;4148108151;Taip;0;6;0;6
7393;Pelenė;Lašeliai;1303066945;Taip;0;5;0;5
7394;Pelenė;Grūdelis;4624325473;Ne;0;17;0;17
7395;Pelenė;Grūdelis;1902314385;Taip;0;2;2;4
7396;Pelenė;Grūdelis;1140030742;Taip;0;3;0;3
7397;Pelenė;Grūdelis;1336431888;Ne;0;3;9;12
7398;Pelenė;Grūdelis;6632188229;Taip;0;9;0;9
7399;Pelenė;Grūdelis;5356756237;Taip;0;3;0;3
7400;Pelenė;Grūdelis;39705461573;Ne;0;1;0;1
7401;Pelenė;Grūdelis;2154553741;Taip;15;7;0;22
7402;Pelenė;Grūdelis;3497915398;Taip;15;6;0;21
7403;Pelenė;Grūdelis;8598498275;Taip;0;4;0;4
7404;Pelenė;Grūdelis;8404317146;Taip;0;3;2;5
7405;Pelenė;Grūdelis;4307283949;Taip;0;3;0;3
7406;Pelenė;Grūdelis;9009271610;Ne;0;5;0;5
7407;Pelenė;Grūdelis;5325176433;Taip;0;16;0;16
7408;Pelenė;Grūdelis;1114786936;Taip;0;0;3;3
7409;Pelenė;Grūdelis;1245955282;Taip;0;11;0;11
7410;Pelenė;Braškytė;7602432318;Taip;5;8;0;13
7411;Pelenė;Braškytė;2689903631;Taip;0;3;0;3
7412;Pelenė;Braškytė;4982869687;Taip;6;0;0;6
7413;Pelenė;Braškytė;3499827987;Taip;18;0;0;18
7414;Pelenė;Braškytė;8165766331;Taip;5;0;0;5
7415;Pelenė;Braškytė;1384382692;Taip;8;1;1;10
7416;Pelenė;Braškytė;5944620142;Taip;4;0;1;5
7417;Pelenė;Braškytė;4734502322;Taip;17;0;3;20
7418;Pelenė;Braškytė;8504675439;Taip;7;2;0;9
7419;Pelenė;Braškytė;2407328091;Taip;18;0;0;18
7420;Pelenė;Braškytė;8861981715;Taip;7;2;0;9
7421;Pelenė;Braškytė;6306403720;Taip;18;5;0;23
7422;Pelenė;Braškytė;9490816122;Taip;18;0;0;18
7423;Pelenė;Braškytė;2096373376;Taip;10;0;0;10
7424;Pelenė;Boružėlės;4961852594;Taip;0;0;4;4
7425;Pelenė;Boružėlės;3549088727;Taip;5;0;3;8
7426;Pelenė;Boružėlės;5024793693;Taip;0;1;0;1
7427;Pelenė;Boružėlės;6567413229;Ne;5;0;5;10
7428;Pelenė;Boružėlės;6231387335;Taip;0;3;0;3
7429;Pelenė;Boružėlės;4068236246;Taip;17;0;0;17
7430;Pelenė;Boružėlės;3700618977;Taip;9;0;1;10
7431;Pelenė;Boružėlės;5872711862;Taip;6;1;4;11
7432;Pelenė;Boružėlės;6081335781;Taip;0;11;0;11
7433;Pelenė;Boružėlės;2083848693;Taip;10;0;0;10
7434;Pelenė;Boružėlės;4396011355;Taip;5;12;0;17
7435;Pelenė;Boružėlės;6304818782;Taip;0;3;0;3
7436;Pelenė;Boružėlės;8718308575;Taip;0;23;0;23
7437;Pelenė;Saldainiukai;5028095861;Ne;7;0;2;9
7438;Pelenė;Saldainiukai;9505945890;Taip;0;0;2;2
7439;Pelenė;Saldainiukai;8202196292;Taip;0;0;1;1
7440;Pelenė;Saldainiukai;5066227318;Taip;0;0;1;1
7441;Pelenė;Saldainiukai;4305733824;Taip;0;10;1;11
7442;Pelenė;Saldainiukai;2986690431;Taip;10;0;0;10
7443;Pelenė;Saldainiukai;4660385383;Taip;1;0;0;1
7444;Pelenė;Saldainiukai;8862429244;Taip;0;0;1;1
7445;Pelenė;Saldainiukai;5762403752;Taip;0;3;0;3
7446;Pelenė;Saldainiukai;5926700157;Taip;4;0;0;4
7447;Pelenė;Saldainiukai;2882716674;Taip;0;0;1;1
7448;Pelenė;Saldainiukai;4859437855;Taip;6;0;1;7
7449;Pelenė;Saldainiukai;4023923887;Taip;3;0;0;3
7450;Pelenė;Drugeliai;2540405047;Taip;13;0;1;14
7451;Pelenė;Drugeliai;3603352172;Taip;11;0;1;12
7452;Pelenė;Drugeliai;5084452088;Ne;5;0;0;5
7453;Pelenė;Drugeliai;6834792589;Taip;0;1;0;1
7454;Pelenė;Drugeliai;9810123679;Taip;0;1;0;1
7455;Pelenė;Drugeliai;1048899958;Taip;5;0;0;5
7456;Pelenė;Drugeliai;3327213856;Taip;10;3;1;14
7457;Pelenė;Drugeliai;6252972353;Taip;6;0;1;7
7458;Pelenė;Drugeliai;1584256570;Taip;7;0;0;7
7459;Pelenė;Drugeliai;3205331614;Taip;0;0;2;2
7460;Pelenė;Drugeliai;5631629419;Ne;13;4;0;17
7461;Pelenė;Drugeliai;2163737781;Taip;0;4;0;4
7462;Pelenė;Drugeliai;9004080625;Ne;12;0;6;18
7463;Pelenė;Drugeliai;7565331966;Taip;0;23;0;23
7464;Pelenė;Drugeliai;5579900958;Taip;0;0;1;1
7465;Pipiras;EŽIUKAI;1876870081;Taip;4;3;0;7
7466;Pipiras;EŽIUKAI;9275905384;Taip;0;2;3;5
7467;Pipiras;EŽIUKAI;6153579332;Taip;8;0;0;8
7468;Pipiras;EŽIUKAI;1391958633;Taip;0;3;0;3
7469;Pipiras;EŽIUKAI;5637557921;Taip;2;0;3;5
7470;Pipiras;EŽIUKAI;5014457985;Taip;8;4;0;12
7471;Pipiras;EŽIUKAI;1050430252;Ne;0;1;0;1
7472;Pipiras;EŽIUKAI;4927845000;Taip;0;13;0;13
7473;Pipiras;EŽIUKAI;1904376366;Taip;0;19;0;19
7474;Pipiras;EŽIUKAI;2024777430;Taip;0;5;0;5
7475;Pipiras;EŽIUKAI;2402351134;Taip;0;3;1;4
7476;Pipiras;EŽIUKAI;2255644686;Taip;0;3;3;6
7477;Pipiras;EŽIUKAI;7736031786;Taip;0;2;4;6
7478;Pipiras;EŽIUKAI;4959823035;Taip;0;1;0;1
7479;Pipiras;EŽIUKAI;1128674099;Taip;0;5;2;7
7480;Pipiras;EŽIUKAI;6339186940;Taip;0;5;0;5
7481;Pipiras;EŽIUKAI;3422170541;Taip;0;2;0;2
7482;Pipiras;EŽIUKAI;3314276870;Taip;0;4;0;4
7483;Pipiras;EŽIUKAI;7784343130;Taip;0;1;0;1
7484;Pipiras;BITUTĖS;3851239592;Taip;16;1;0;17
7485;Pipiras;BITUTĖS;1645482584;Taip;4;2;0;6
7486;Pipiras;BITUTĖS;9550967420;Taip;21;0;0;21
7487;Pipiras;BITUTĖS;7891664385;Taip;4;0;0;4
7488;Pipiras;BITUTĖS;9050423801;Taip;8;7;0;15
7489;Pipiras;BITUTĖS;3794537946;Taip;8;0;0;8
7490;Pipiras;BITUTĖS;5047070127;Taip;0;0;8;8
7491;Pipiras;BITUTĖS;2645772675;Taip;5;5;0;10
7492;Pipiras;BITUTĖS;3906973646;Taip;10;0;1;11
7493;Pipiras;BITUTĖS;9394456452;Taip;21;0;0;21
7494;Pipiras;BITUTĖS;9610070604;Taip;9;4;0;13
7495;Pipiras;BITUTĖS;8983392098;Taip;21;0;0;21
7496;Pipiras;BITUTĖS;7009194986;Taip;12;0;1;13
7497;Pipiras;BITUTĖS;6362968454;Taip;8;8;0;16
7498;Pipiras;BITUTĖS;6273958740;Taip;3;0;1;4
7499;Pipiras;BITUTĖS;2887703782;Ne;5;2;1;8
7500;Pipiras;NYKŠTUKAI;6696824728;Taip;0;3;0;3
7501;Pipiras;NYKŠTUKAI;1169481984;Taip;8;0;1;9
7502;Pipiras;NYKŠTUKAI;4198534687;Taip;13;2;0;15
7503;Pipiras;NYKŠTUKAI;4458730479;Taip;4;5;4;13
7504;Pipiras;NYKŠTUKAI;4510888337;Taip;2;6;0;8
7505;Pipiras;NYKŠTUKAI;3980950261;Taip;8;1;0;9
7506;Pipiras;NYKŠTUKAI;7828638329;Taip;0;7;4;11
7507;Pipiras;NYKŠTUKAI;6775489564;Taip;5;0;12;17
7508;Pipiras;NYKŠTUKAI;8689174023;Taip;5;5;0;10
7509;Pipiras;NYKŠTUKAI;7747049622;Taip;0;5;0;5
7510;Pipiras;NYKŠTUKAI;9892201598;Taip;5;7;0;12
7511;Pipiras;NYKŠTUKAI;7371386368;Taip;0;5;0;5
7512;Pipiras;NYKŠTUKAI;1019753152;Taip;0;9;0;9
7513;Pipiras;NYKŠTUKAI;9499869533;Taip;4;3;0;7
7514;Pipiras;NYKŠTUKAI;5141447649;Taip;2;3;3;8
7515;Pipiras;NYKŠTUKAI;9877682150;Taip;0;4;1;5
7516;Pipiras;NYKŠTUKAI;9248925267;Taip;0;9;0;9
7517;Pipiras;NYKŠTUKAI;9711147855;Taip;0;0;2;2
7518;Pipiras;PELĖDŽIUKAI;6342044341;Ne;0;1;0;1
7519;Pipiras;PELĖDŽIUKAI;3852848863;Taip;0;2;0;2
7520;Pipiras;PELĖDŽIUKAI;3882437376;Taip;0;0;1;1
7521;Pipiras;PELĖDŽIUKAI;9157870634;Taip;0;3;0;3
7522;Pipiras;PELĖDŽIUKAI;5235868332;Taip;0;1;0;1
7523;Pipiras;PELĖDŽIUKAI;3554786173;Taip;5;0;0;5
7524;Pipiras;PELĖDŽIUKAI;1034182352;Taip;7;6;0;13
7525;Pipiras;PELĖDŽIUKAI;6792777396;Taip;0;4;0;4
7526;Pipiras;PELĖDŽIUKAI;5622119207;Taip;0;3;0;3
7527;Pipiras;PELĖDŽIUKAI;7934365114;Taip;2;1;0;3
7528;Pipiras;PELĖDŽIUKAI;6523189501;Taip;23;0;0;23
7529;Pipiras;PELĖDŽIUKAI;7161727352;Taip;0;2;0;2
7530;Pipiras;PELĖDŽIUKAI;9770780973;Taip;19;0;0;19
7531;Pipiras;PELĖDŽIUKAI;5845498558;Taip;0;3;0;3
7532;Pipiras;PELĖDŽIUKAI;9840040112;Ne;4;4;0;8
7533;Pipiras;PELĖDŽIUKAI;1784839485;Taip;0;17;0;17
7534;Pipiras;PELĖDŽIUKAI;3775916247;Ne;0;4;0;4
7535;Pipiras;PELĖDŽIUKAI;7350131214;Taip;0;3;0;3
7536;Pipiras;DRUGELIAI;1957338631;Taip;6;0;1;7
7537;Pipiras;DRUGELIAI;5856735452;Taip;3;1;0;4
7538;Pipiras;DRUGELIAI;2267192782;Taip;0;8;0;8
7539;Pipiras;DRUGELIAI;1045583136;Taip;0;2;0;2
7540;Pipiras;DRUGELIAI;1711168196;Taip;0;2;1;3
7541;Pipiras;DRUGELIAI;7425654504;Taip;0;6;0;6
7542;Pipiras;DRUGELIAI;9479697733;Taip;0;10;1;11
7543;Pipiras;DRUGELIAI;4017042461;Taip;0;9;0;9
7544;Pipiras;DRUGELIAI;4725221169;Taip;0;1;0;1
7545;Pipiras;DRUGELIAI;5059203266;Taip;2;0;2;4
7546;Pipiras;DRUGELIAI;8140314304;Taip;0;0;4;4
7547;Pipiras;DRUGELIAI;8422419380;Taip;0;1;0;1
7548;Pipiras;DRUGELIAI;6791495556;Taip;0;2;0;2
7549;Pipiras;DRUGELIAI;4811029230;Taip;5;10;0;15
7550;Pipiras;DRUGELIAI;6363349541;Taip;0;5;0;5
7551;Pipiras;DRUGELIAI;6685567970;Taip;10;1;0;11
7552;Pipiras;DRUGELIAI;1353114929;Taip;0;2;0;2
7553;Pipiras;DRUGELIAI;4426479971;Ne;18;0;0;18
7554;Pipiras;GĖLYTĖS;9670710691;Taip;0;0;6;6
7555;Pipiras;GĖLYTĖS;8965139441;Taip;5;2;0;7
7556;Pipiras;GĖLYTĖS;2095794125;Taip;0;0;3;3
7557;Pipiras;GĖLYTĖS;4945164161;Taip;10;7;0;17
7558;Pipiras;GĖLYTĖS;7362002646;Taip;0;7;0;7
7559;Pipiras;GĖLYTĖS;5150723052;Taip;8;0;0;8
7560;Pipiras;GĖLYTĖS;3755824911;Taip;0;2;1;3
7561;Pipiras;GĖLYTĖS;6453274205;Taip;0;13;0;13
7562;Pipiras;GĖLYTĖS;4559954910;Taip;0;9;0;9
7563;Pipiras;GĖLYTĖS;7157187063;Taip;0;11;0;11
7564;Pipiras;GĖLYTĖS;1611488078;Taip;0;1;0;1
7565;Pipiras;GĖLYTĖS;4236597883;Taip;0;0;10;10
7566;Pipiras;GĖLYTĖS;4289497197;Taip;5;0;0;5
7567;Pipiras;GĖLYTĖS;2474548836;Ne;5;5;0;10
7568;Pipiras;GĖLYTĖS;8553422709;Taip;12;0;0;12
7569;Pipiras;GĖLYTĖS;5738334591;Taip;0;5;0;5
7570;Pipiras;GĖLYTĖS;6428525902;Taip;0;4;0;4
7571;Pipiras;GĖLYTĖS;8354158722;Taip;1;0;5;6
7572;Pipiras;BORUŽĖLĖS;4707794599;Taip;0;0;3;3
7573;Pipiras;BORUŽĖLĖS;8673271201;Taip;0;0;1;1
7574;Pipiras;BORUŽĖLĖS;5968015502;Taip;0;6;0;6
7575;Pipiras;BORUŽĖLĖS;4086728233;Taip;8;0;0;8
7576;Pipiras;BORUŽĖLĖS;8508292428;Taip;0;3;0;3
7577;Pipiras;BORUŽĖLĖS;1210940213;Taip;0;1;0;1
7578;Pipiras;BORUŽĖLĖS;8260680662;Taip;9;0;0;9
7579;Pipiras;BORUŽĖLĖS;8959946514;Ne;8;0;0;8
7580;Pipiras;BORUŽĖLĖS;8443786510;Taip;0;11;0;11
7581;Pipiras;BORUŽĖLĖS;1146369304;Taip;0;0;1;1
7582;Pipiras;BORUŽĖLĖS;9970587185;Taip;0;0;2;2
7583;Pipiras;BORUŽĖLĖS;6034298583;Taip;1;7;0;8
7584;Pipiras;BORUŽĖLĖS;6344932171;Taip;0;0;2;2
7585;Pipiras;BORUŽĖLĖS;1550959705;Taip;0;0;1;1
7586;Pipiras;SKRUZDĖLIUKAI;2483867901;Taip;0;2;0;2
7587;Pipiras;SKRUZDĖLIUKAI;1315372873;Taip;0;8;0;8
7588;Pipiras;SKRUZDĖLIUKAI;9372109848;Taip;0;0;3;3
7589;Pipiras;SKRUZDĖLIUKAI;8296425777;Taip;6;2;0;8
7590;Pipiras;SKRUZDĖLIUKAI;9968182443;Ne;3;2;0;5
7591;Pipiras;SKRUZDĖLIUKAI;2296702730;Taip;0;0;1;1
7592;Pipiras;SKRUZDĖLIUKAI;8819018248;Taip;0;16;0;16
7593;Pipiras;SKRUZDĖLIUKAI;3768825314;Taip;15;0;0;15
7594;Pipiras;SKRUZDĖLIUKAI;5888429623;Ne;0;2;2;4
7595;Pipiras;SKRUZDĖLIUKAI;2399588759;Taip;0;3;0;3
7596;Pipiras;SKRUZDĖLIUKAI;3935474148;Taip;0;3;0;3
7597;Pipiras;SKRUZDĖLIUKAI;8081343184;Taip;0;13;0;13
7598;Pipiras;SKRUZDĖLIUKAI;9852475056;Ne;10;2;0;12
7599;Pipiras;SKRUZDĖLIUKAI;6176818802;Taip;0;0;2;2
7600;Pipiras;SKRUZDĖLIUKAI;1215623527;Taip;0;7;0;7
7601;Pipiras;SKRUZDĖLIUKAI;1998249512;Taip;6;0;0;6
7602;Pipiras;SKRUZDĖLIUKAI;9625933545;Taip;0;4;0;4
7603;Pipiras;SKRUZDĖLIUKAI;7211189491;Taip;0;0;5;5
7604;Pipiras;ŽVIRBLIUKŲ;6340323302;Taip;0;4;2;6
7605;Pipiras;ŽVIRBLIUKŲ;5445858240;Taip;0;4;0;4
7606;Pipiras;ŽVIRBLIUKŲ;1242260242;Taip;0;6;0;6
7607;Pipiras;ŽVIRBLIUKŲ;4266424785;Taip;0;0;2;2
7608;Pipiras;ŽVIRBLIUKŲ;3421769229;Taip;4;3;0;7
7609;Pipiras;ŽVIRBLIUKŲ;8520454289;Taip;3;3;0;6
7610;Pipiras;ŽVIRBLIUKŲ;5422547144;Taip;0;8;0;8
7611;Pipiras;ŽVIRBLIUKŲ;6136423200;Taip;0;5;0;5
7612;Pipiras;ŽVIRBLIUKŲ;6694920607;Taip;0;7;0;7
7613;Pipiras;ŽVIRBLIUKŲ;7912217889;Taip;3;5;0;8
7614;Pipiras;ŽVIRBLIUKŲ;3141822820;Taip;0;7;0;7
7615;Pipiras;ŽVIRBLIUKŲ;7870521230;Taip;0;3;4;7
7616;Pipiras;ŽVIRBLIUKŲ;4428216634;Taip;0;1;4;5
7617;Pipiras;ŽVIRBLIUKŲ;2044498561;Taip;5;0;0;5
7618;Pipiras;ŽVIRBLIUKŲ;7026118693;Taip;0;6;0;6
7619;Pipiras;ŽVIRBLIUKŲ;1391682850;Taip;0;4;0;4
7620;Pipiras;ŽVIRBLIUKŲ;87924002679;Taip;0;7;0;7
7621;Pipiras;ŽVIRBLIUKŲ;4496076326;Taip;10;1;0;11
7622;Pipiras;ZUIKUČIŲ;6925577945;Taip;2;0;0;2
7623;Pipiras;ZUIKUČIŲ;9639609431;Taip;0;1;3;4
7624;Pipiras;ZUIKUČIŲ;1682281017;Taip;0;11;0;11
7625;Pipiras;ZUIKUČIŲ;8130815072;Ne;16;2;0;18
7626;Pipiras;ZUIKUČIŲ;7095534371;Taip;0;16;1;17
7627;Pipiras;ZUIKUČIŲ;9665655075;Taip;0;7;0;7
7628;Pipiras;ZUIKUČIŲ;2159315426;Taip;10;1;0;11
7629;Pipiras;ZUIKUČIŲ;8404246568;Taip;5;3;0;8
7630;Pipiras;ZUIKUČIŲ;2599175140;Taip;13;1;0;14
7631;Pipiras;ZUIKUČIŲ;7200147039;Taip;7;1;0;8
7632;Pipiras;ZUIKUČIŲ;5035593032;Taip;0;5;0;5
7633;Pipiras;ZUIKUČIŲ;6361544649;Taip;3;0;0;3
7634;Pipiras;ZUIKUČIŲ;1079088070;Taip;3;0;0;3
7635;Pipiras;VARLIUKŲ;9307622469;Taip;0;10;0;10
7636;Pipiras;VARLIUKŲ;7446225835;Taip;11;1;0;12
7637;Pipiras;VARLIUKŲ;8800890503;Taip;0;3;0;3
7638;Pipiras;VARLIUKŲ;6184943213;Taip;5;1;0;6
7639;Pipiras;VARLIUKŲ;8028360748;Taip;3;4;0;7
7640;Pipiras;VARLIUKŲ;1238280105;Taip;17;2;0;19
7641;Pipiras;VARLIUKŲ;3299099535;Taip;0;18;0;18
7642;Pipiras;VARLIUKŲ;8364783015;Taip;12;0;8;20
7643;Pipiras;VARLIUKŲ;5502186385;Taip;1;0;0;1
7644;Pipiras;VARLIUKŲ;8707560610;Taip;0;0;1;1
7645;Pipiras;VARLIUKŲ;4940053409;Taip;9;0;0;9
7646;Pipiras;VARLIUKŲ;2588075386;Taip;5;2;0;7
7647;Pipiras;VARLIUKŲ;6666112357;Taip;7;7;1;15
7648;Pipiras;VARLIUKŲ;9473056714;Taip;15;1;0;16
7649;Pipiras;VARLIUKŲ;4282267631;Taip;0;0;1;1
7650;Pipiras;ŽIOGELIŲ;7802812858;Taip;3;0;3;6
7651;Pipiras;ŽIOGELIŲ;8697732892;Taip;9;0;4;13
7652;Pipiras;ŽIOGELIŲ;1466527534;Taip;8;0;6;14
7653;Pipiras;ŽIOGELIŲ;1172225661;Taip;0;0;2;2
7654;Pipiras;ŽIOGELIŲ;3825960148;Ne;7;1;5;13
7655;Pipiras;ŽIOGELIŲ;9747219629;Taip;0;0;6;6
7656;Pipiras;ŽIOGELIŲ;8445608419;Ne;7;0;0;7
7657;Pipiras;ŽIOGELIŲ;6602780166;Taip;0;0;3;3
7658;Pipiras;ŽIOGELIŲ;1074913909;Taip;15;0;1;16
7659;Pipiras;ŽIOGELIŲ;4229548366;Taip;7;0;0;7
7660;Pipiras;ŽIOGELIŲ;8666908143;Taip;5;0;6;11
7661;Pipiras;ŽIOGELIŲ;4083110785;Taip;0;0;4;4
7662;Pipiras;ŽIOGELIŲ;7011969610;Taip;8;0;0;8
7663;Pipiras;ŽIOGELIŲ;2784222529;Taip;0;0;3;3
7664;"Prie pasakų parko";ZUIKUČIAI;8493622886;Taip;8;0;2;10
7665;"Prie pasakų parko";ZUIKUČIAI;3907016976;Taip;12;0;1;13
7666;"Prie pasakų parko";ZUIKUČIAI;9770819792;Taip;8;0;0;8
7667;"Prie pasakų parko";ZUIKUČIAI;4904562817;Taip;12;0;0;12
7668;"Prie pasakų parko";ZUIKUČIAI;6662531456;Ne;5;0;3;8
7669;"Prie pasakų parko";ZUIKUČIAI;9659710840;Taip;0;3;0;3
7670;"Prie pasakų parko";ZUIKUČIAI;8781483295;Ne;10;0;0;10
7671;"Prie pasakų parko";ZUIKUČIAI;5394554484;Taip;0;0;2;2
7672;"Prie pasakų parko";ZUIKUČIAI;9707694441;Taip;3;0;1;4
7673;"Prie pasakų parko";ZUIKUČIAI;7220229641;Ne;13;0;0;13
7674;"Prie pasakų parko";PAUKŠČIUKŲ;4860316199;Ne;15;0;0;15
7675;"Prie pasakų parko";PAUKŠČIUKŲ;3907578461;Taip;18;0;1;19
7676;"Prie pasakų parko";PAUKŠČIUKŲ;7359935733;Taip;23;0;0;23
7677;"Prie pasakų parko";PAUKŠČIUKŲ;7330033315;Taip;0;0;2;2
7678;"Prie pasakų parko";PAUKŠČIUKŲ;9061639276;Taip;11;0;0;11
7679;"Prie pasakų parko";PAUKŠČIUKŲ;1476515947;Ne;1;1;0;2
7680;"Prie pasakų parko";PAUKŠČIUKŲ;6601363351;Ne;18;0;0;18
7681;"Prie pasakų parko";PAUKŠČIUKŲ;9784398441;Taip;16;0;0;16
7682;"Prie pasakų parko";PAUKŠČIUKŲ;4891232161;Taip;7;0;0;7
7683;"Prie pasakų parko";PAUKŠČIUKŲ;5737517940;Taip;4;0;4;8
7684;"Prie pasakų parko";PAUKŠČIUKŲ;7693728136;Ne;12;0;0;12
7685;"Prie pasakų parko";"LINKSMOJI ŠEIMYNĖLĖ (SPEC)";2820889357;Ne;13;4;1;18
7686;"Prie pasakų parko";"LINKSMOJI ŠEIMYNĖLĖ (SPEC)";6245610875;Taip;0;3;4;7
7687;"Prie pasakų parko";"LINKSMOJI ŠEIMYNĖLĖ (SPEC)";9469871636;Ne;5;3;3;11
7688;"Prie pasakų parko";"LINKSMOJI ŠEIMYNĖLĖ (SPEC)";5641148690;Taip;7;0;1;8
7689;"Prie pasakų parko";"LINKSMOJI ŠEIMYNĖLĖ (SPEC)";9594976173;Ne;9;0;5;14
7690;"Prie pasakų parko";"LINKSMOJI ŠEIMYNĖLĖ (SPEC)";1828638638;Taip;11;0;0;11
7691;"Prie pasakų parko";"LINKSMOJI ŠEIMYNĖLĖ (SPEC)";5356005675;Taip;0;0;1;1
7692;"Prie pasakų parko";"LINKSMOJI ŠEIMYNĖLĖ (SPEC)";9789977863;Taip;0;1;3;4
7693;"Prie pasakų parko";NYKŠTUKŲ;2287711014;Taip;5;2;1;8
7694;"Prie pasakų parko";NYKŠTUKŲ;6491435655;Taip;3;8;0;11
7695;"Prie pasakų parko";NYKŠTUKŲ;1743429440;Taip;5;6;0;11
7696;"Prie pasakų parko";NYKŠTUKŲ;1811994592;Taip;5;0;2;7
7697;"Prie pasakų parko";NYKŠTUKŲ;7739970115;Taip;5;0;0;5
7698;"Prie pasakų parko";NYKŠTUKŲ;6700916147;Taip;11;0;0;11
7699;"Prie pasakų parko";NYKŠTUKŲ;6733793491;Taip;8;0;5;13
7700;"Prie pasakų parko";NYKŠTUKŲ;2515928623;Taip;3;0;1;4
7701;"Prie pasakų parko";NYKŠTUKŲ;4726737519;Ne;7;0;4;11
7702;"Prie pasakų parko";NYKŠTUKŲ;1316127369;Taip;11;0;1;12
7703;"Prie pasakų parko";NYKŠTUKŲ;2654978735;Taip;10;0;11;21
7704;"Prie pasakų parko";NYKŠTUKŲ;2661900328;Taip;0;0;2;2
7705;"Prie pasakų parko";NYKŠTUKŲ;9225775914;Taip;5;1;0;6
7706;"Prie pasakų parko";NYKŠTUKŲ;4457827262;Taip;5;0;0;5
7707;"Prie pasakų parko";LAŠELIŲ;6865751947;Taip;0;0;3;3
7708;"Prie pasakų parko";LAŠELIŲ;6992830082;Taip;0;1;0;1
7709;"Prie pasakų parko";LAŠELIŲ;1588062393;Taip;0;0;9;9
7710;"Prie pasakų parko";LAŠELIŲ;1278065349;Taip;0;1;1;2
7711;"Prie pasakų parko";LAŠELIŲ;8574432191;Taip;6;0;1;7
7712;"Prie pasakų parko";LAŠELIŲ;4181676762;Taip;0;3;0;3
7713;"Prie pasakų parko";LAŠELIŲ;4548803933;Taip;0;0;1;1
7714;"Prie pasakų parko";LAŠELIŲ;6250610187;Taip;0;6;0;6
7715;"Prie pasakų parko";LAŠELIŲ;9190379838;Taip;3;0;3;6
7716;"Prie pasakų parko";LAŠELIŲ;8189217660;Taip;1;0;0;1
7717;"Prie pasakų parko";LAŠELIŲ;8215830508;Ne;0;7;0;7
7718;"Prie pasakų parko";LAŠELIŲ;2216634402;Taip;5;0;3;8
7719;"Prie pasakų parko";LAŠELIŲ;8849417734;Taip;0;0;1;1
7720;"Prie pasakų parko";LAŠELIŲ;7545372781;Ne;0;0;1;1
7721;"Prie pasakų parko";LAŠELIŲ;2731544174;Taip;15;0;0;15
7722;"Prie pasakų parko";LAŠELIŲ;6361878877;Taip;0;1;0;1
7723;"Prie pasakų parko";LAŠELIŲ;5494350183;Taip;0;0;1;1
7724;"Prie pasakų parko";LAŠELIŲ;5102718403;Taip;0;0;2;2
7725;"Prie pasakų parko";"KAČIUKAI (SPEC)";6772736175;Taip;0;0;5;5
7726;"Prie pasakų parko";"KAČIUKAI (SPEC)";5847625697;Taip;0;0;7;7
7727;"Prie pasakų parko";"KAČIUKAI (SPEC)";2590693851;Taip;8;0;0;8
7728;"Prie pasakų parko";"KAČIUKAI (SPEC)";3949671257;Ne;11;0;0;11
7729;"Prie pasakų parko";"ŽVAIGŽDUTĖS  (SPEC)";7216751216;Taip;0;0;1;1
7730;"Prie pasakų parko";"ŽVAIGŽDUTĖS  (SPEC)";4037594669;Taip;0;0;1;1
7731;"Prie pasakų parko";"ŽVAIGŽDUTĖS  (SPEC)";9072312203;Taip;5;0;0;5
7732;"Prie pasakų parko";"ŽVAIGŽDUTĖS  (SPEC)";5006152810;Taip;7;0;0;7
7733;"Prie pasakų parko";"ŽVAIGŽDUTĖS  (SPEC)";6989235061;Taip;0;0;7;7
7734;"Prie pasakų parko";"ŽVAIGŽDUTĖS  (SPEC)";5009168398;Ne;0;1;0;1
7735;"Prie pasakų parko";"ŽVAIGŽDUTĖS  (SPEC)";6585504578;Taip;4;0;5;9
7736;"Prie pasakų parko";"ŽVAIGŽDUTĖS  (SPEC)";1621710265;Ne;8;0;1;9
7737;"Prie pasakų parko";"ANČIUKAI (SPEC)";8339335908;Taip;10;0;0;10
7738;"Prie pasakų parko";"ANČIUKAI (SPEC)";6802898184;Taip;0;0;3;3
7739;"Prie pasakų parko";"ANČIUKAI (SPEC)";9529949992;Taip;0;0;6;6
7740;"Prie pasakų parko";"ANČIUKAI (SPEC)";6431918357;Taip;23;0;0;23
7741;"Prie pasakų parko";"ANČIUKAI (SPEC)";1190509858;Taip;23;0;0;23
7742;"Prie pasakų parko";"ANČIUKAI (SPEC)";4309482351;Taip;0;0;1;1
7743;"Prie pasakų parko";"ANČIUKAI (SPEC)";2263419475;Taip;10;0;0;10
7744;"Prie pasakų parko";"ANČIUKAI (SPEC)";7200571639;Taip;0;0;1;1
7745;"Prie pasakų parko";TIGRIUKAI;7858530013;Taip;13;1;0;14
7746;"Prie pasakų parko";TIGRIUKAI;3918269702;Taip;11;0;4;15
7747;"Prie pasakų parko";TIGRIUKAI;6446562388;Taip;0;0;7;7
7748;"Prie pasakų parko";TIGRIUKAI;2168919559;Taip;5;7;0;12
7749;"Prie pasakų parko";TIGRIUKAI;8899375521;Ne;18;0;0;18
7750;"Prie pasakų parko";TIGRIUKAI;6710735721;Taip;0;0;1;1
7751;"Prie pasakų parko";TIGRIUKAI;6561145380;Taip;16;0;0;16
7752;"Prie pasakų parko";TIGRIUKAI;9476448601;Taip;0;0;3;3
7753;"Prie pasakų parko";TIGRIUKAI;8715851643;Taip;0;0;3;3
7754;"Prie pasakų parko";TIGRIUKAI;3617673265;Taip;0;0;3;3
7755;"Prie pasakų parko";TIGRIUKAI;1704679306;Taip;0;0;5;5
7756;"Prie pasakų parko";TIGRIUKAI;7776961789;Taip;0;5;1;6
7757;"Prie pasakų parko";TIGRIUKAI;8285260113;Taip;0;6;1;7
7758;"Prie pasakų parko";TIGRIUKAI;3373275644;Taip;9;0;1;10
7759;"Prie pasakų parko";TIGRIUKAI;8738488104;Taip;4;0;0;4
7760;"Prie pasakų parko";TIGRIUKAI;8406002339;Taip;0;0;4;4
7761;"Prie pasakų parko";"EŽIUKŲ (SPEC)";7851357992;Ne;0;0;12;12
7762;"Prie pasakų parko";"EŽIUKŲ (SPEC)";7115825217;Taip;23;0;0;23
7763;"Prie pasakų parko";"EŽIUKŲ (SPEC)";2952868428;Taip;8;0;2;10
7764;"Prie pasakų parko";"EŽIUKŲ (SPEC)";5159105661;Taip;13;0;0;13
7765;"Prie pasakų parko";"EŽIUKŲ (SPEC)";9632354317;Taip;0;0;1;1
7766;"Prie pasakų parko";"EŽIUKŲ (SPEC)";5944113879;Ne;5;0;0;5
7767;"Prie pasakų parko";"EŽIUKŲ (SPEC)";4950143153;Ne;15;0;1;16
7768;"Prie pasakų parko";"BORUŽIUKŲ (SPEC)";9715586563;Ne;3;4;0;7
7769;"Prie pasakų parko";"BORUŽIUKŲ (SPEC)";28574450739;Taip;5;0;0;5
7770;"Prie pasakų parko";"BORUŽIUKŲ (SPEC)";6215345468;Ne;0;3;0;3
7771;"Prie pasakų parko";"BORUŽIUKŲ (SPEC)";7000191099;Taip;0;0;3;3
7772;"Prie pasakų parko";SAULYTĖS;6762267582;Taip;10;0;1;11
7773;"Prie pasakų parko";SAULYTĖS;7459673719;Ne;10;3;2;15
7774;"Prie pasakų parko";SAULYTĖS;4351705573;Taip;8;0;7;15
7775;"Prie pasakų parko";SAULYTĖS;7390391804;Taip;6;0;3;9
7776;"Prie pasakų parko";SAULYTĖS;8685140364;Ne;8;1;0;9
7777;"Prie pasakų parko";SAULYTĖS;6606867989;Taip;10;0;3;13
7778;"Prie pasakų parko";SAULYTĖS;2206221105;Taip;3;0;0;3
7779;"Prie pasakų parko";SAULYTĖS;2201317313;Taip;13;0;0;13
7780;"Prie pasakų parko";SAULYTĖS;3038164555;Taip;3;0;0;3
7781;"Prie pasakų parko";SAULYTĖS;4183640714;Taip;9;0;6;15
7782;"Prie pasakų parko";SAULYTĖS;1738732866;Taip;4;3;0;7
7783;Pumpurėlis;RAMUNĖLIŲ;7610949816;Taip;0;0;1;1
7784;Pumpurėlis;RAMUNĖLIŲ;6165833101;Taip;0;0;1;1
7785;Pumpurėlis;RAMUNĖLIŲ;6977710645;Taip;5;0;1;6
7786;Pumpurėlis;RAMUNĖLIŲ;9431295796;Taip;0;0;6;6
7787;Pumpurėlis;RAMUNĖLIŲ;1395380236;Ne;0;0;5;5
7788;Pumpurėlis;RAMUNĖLIŲ;9424449290;Taip;0;12;0;12
7789;Pumpurėlis;RAMUNĖLIŲ;6955168163;Taip;0;0;1;1
7790;Pumpurėlis;RAMUNĖLIŲ;9726028397;Taip;7;0;0;7
7791;Pumpurėlis;RAMUNĖLIŲ;7229289985;Taip;5;0;8;13
7792;Pumpurėlis;RAMUNĖLIŲ;2969734731;Taip;0;0;1;1
7793;Pumpurėlis;RAMUNĖLIŲ;7559071945;Taip;0;3;0;3
7794;Pumpurėlis;RAMUNĖLIŲ;3953103488;Taip;0;0;1;1
7795;Pumpurėlis;RAMUNĖLIŲ;6511527480;Taip;3;0;0;3
7796;Pumpurėlis;RAMUNĖLIŲ;3838705973;Taip;20;0;0;20
7797;Pumpurėlis;RAMUNĖLIŲ;6726875853;Taip;5;0;3;8
7798;Pumpurėlis;RAMUNĖLIŲ;8667762689;Taip;0;6;0;6
7799;Pumpurėlis;RAMUNĖLIŲ;3874188848;Taip;0;0;15;15
7800;Pumpurėlis;RAMUNĖLIŲ;7619709360;Ne;3;0;1;4
7801;Pumpurėlis;VARPELIŲ;3101133244;Taip;14;1;0;15
7802;Pumpurėlis;VARPELIŲ;3893768713;Taip;0;4;0;4
7803;Pumpurėlis;VARPELIŲ;5023658988;Taip;0;3;4;7
7804;Pumpurėlis;VARPELIŲ;2668855786;Taip;5;6;0;11
7805;Pumpurėlis;VARPELIŲ;8258560345;Taip;0;8;0;8
7806;Pumpurėlis;VARPELIŲ;9612924972;Taip;1;3;0;4
7807;Pumpurėlis;VARPELIŲ;9884099545;Taip;8;4;0;12
7808;Pumpurėlis;VARPELIŲ;3733509497;Taip;9;0;2;11
7809;Pumpurėlis;VARPELIŲ;4508966729;Taip;0;0;1;1
7810;Pumpurėlis;VARPELIŲ;9552913910;Taip;5;3;3;11
7811;Pumpurėlis;VARPELIŲ;5196733185;Taip;1;3;0;4
7812;Pumpurėlis;VARPELIŲ;4928495108;Taip;6;4;0;10
7813;Pumpurėlis;VARPELIŲ;8886730333;Taip;11;4;0;15
7814;Pumpurėlis;VARPELIŲ;2247300456;Taip;1;5;0;6
7815;Pumpurėlis;VARPELIŲ;8525537588;Ne;0;0;3;3
7816;Pumpurėlis;VARPELIŲ;2103139845;Taip;0;0;1;1
7817;Pumpurėlis;VARPELIŲ;6780042929;Taip;11;6;0;17
7818;Pumpurėlis;VARPELIŲ;7182107790;Taip;7;0;0;7
7819;Pumpurėlis;VARPELIŲ;9224879966;Taip;0;0;4;4
7820;Pumpurėlis;DRUGELIŲ;5928552565;Taip;8;0;1;9
7821;Pumpurėlis;DRUGELIŲ;5897036076;Taip;0;3;2;5
7822;Pumpurėlis;DRUGELIŲ;7055989095;Taip;0;18;0;18
7823;Pumpurėlis;DRUGELIŲ;7078621340;Taip;4;2;0;6
7824;Pumpurėlis;DRUGELIŲ;1538548768;Taip;0;0;5;5
7825;Pumpurėlis;DRUGELIŲ;5468796954;Ne;13;3;0;16
7826;Pumpurėlis;DRUGELIŲ;2368226822;Taip;2;3;0;5
7827;Pumpurėlis;DRUGELIŲ;3088476130;Taip;0;0;6;6
7828;Pumpurėlis;DRUGELIŲ;9640790401;Taip;15;3;1;19
7829;Pumpurėlis;DRUGELIŲ;8320987208;Taip;16;0;0;16
7830;Pumpurėlis;DRUGELIŲ;7832408524;Taip;4;0;1;5
7831;Pumpurėlis;DRUGELIŲ;8644853849;Taip;0;10;0;10
7832;Pumpurėlis;DRUGELIŲ;9417688597;Taip;0;0;4;4
7833;Pumpurėlis;DRUGELIŲ;9032255874;Taip;0;3;5;8
7834;Pumpurėlis;DRUGELIŲ;2684592319;Taip;0;0;1;1
7835;Pumpurėlis;DRUGELIŲ;5835115428;Taip;0;3;0;3
7836;Pumpurėlis;DRUGELIŲ;2132563531;Taip;0;8;3;11
7837;Pumpurėlis;DRUGELIŲ;4506063812;Taip;2;4;3;9
7838;Pumpurėlis;DRUGELIŲ;2165141865;Taip;9;0;2;11
7839;Pumpurėlis;DRUGELIŲ;8671697745;Ne;1;0;5;6
7840;Pumpurėlis;KODĖLČIUKŲ;8214602054;Taip;0;0;3;3
7841;Pumpurėlis;KODĖLČIUKŲ;2789026451;Taip;13;0;0;13
7842;Pumpurėlis;KODĖLČIUKŲ;9654958302;Taip;0;1;1;2
7843;Pumpurėlis;KODĖLČIUKŲ;5564844211;Taip;5;0;4;9
7844;Pumpurėlis;KODĖLČIUKŲ;1215117598;Taip;0;2;0;2
7845;Pumpurėlis;KODĖLČIUKŲ;6978091765;Taip;0;0;2;2
7846;Pumpurėlis;KODĖLČIUKŲ;6433757421;Taip;0;0;3;3
7847;Pumpurėlis;KODĖLČIUKŲ;3328647987;Taip;4;0;2;6
7848;Pumpurėlis;KODĖLČIUKŲ;3748601124;Taip;3;0;2;5
7849;Pumpurėlis;KODĖLČIUKŲ;4196409137;Taip;6;0;1;7
7850;Pumpurėlis;KODĖLČIUKŲ;6117720533;Taip;10;0;0;10
7851;Pumpurėlis;KODĖLČIUKŲ;8070486897;Taip;0;0;1;1
7852;Pumpurėlis;KODĖLČIUKŲ;3534133061;Taip;5;0;0;5
7853;Pumpurėlis;KODĖLČIUKŲ;2307819108;Taip;0;4;0;4
7854;Pumpurėlis;KODĖLČIUKŲ;9650395309;Taip;0;2;0;2
7855;Pumpurėlis;KODĖLČIUKŲ;6702744879;Taip;6;3;1;10
7856;Pumpurėlis;KODĖLČIUKŲ;2890596967;Taip;0;0;4;4
7857;Pumpurėlis;KODĖLČIUKŲ;9839285886;Ne;10;3;0;13
7858;Pumpurėlis;LINELIS;1017483419;Taip;0;1;0;1
7859;Pumpurėlis;LINELIS;6957047759;Taip;0;1;0;1
7860;Pumpurėlis;LINELIS;2468796972;Taip;0;3;0;3
7861;Pumpurėlis;LINELIS;1492810528;Taip;0;5;0;5
7862;Pumpurėlis;LINELIS;9138883172;Ne;0;1;0;1
7863;Pumpurėlis;LINELIS;1835168438;Taip;0;3;0;3
7864;Pumpurėlis;LINELIS;4344595328;Taip;0;4;0;4
7865;Pumpurėlis;LINELIS;7566451857;Ne;0;3;0;3
7866;Pumpurėlis;LINELIS;9583257172;Taip;0;1;0;1
7867;Pumpurėlis;LINELIS;7533555059;Taip;0;2;0;2
7868;Pumpurėlis;LINELIS;3298821054;Taip;0;2;0;2
7869;Pumpurėlis;LINELIS;8830261792;Taip;0;3;0;3
7870;Pumpurėlis;LINELIS;87061817106;Taip;0;3;0;3
7871;Pumpurėlis;LINELIS;8806961007;Taip;0;1;0;1
7872;Pumpurėlis;LINELIS;18928851032;Taip;0;3;0;3
7873;Pumpurėlis;LINELIS;2629702959;Taip;0;8;0;8
7874;Pumpurėlis;LINELIS;5964953923;Taip;0;0;5;5
7875;Pumpurėlis;SAULUTĖS;3751769136;Taip;0;0;1;1
7876;Pumpurėlis;SAULUTĖS;5013491568;Taip;8;0;2;10
7877;Pumpurėlis;SAULUTĖS;7488342792;Taip;3;0;0;3
7878;Pumpurėlis;SAULUTĖS;6412442729;Taip;11;3;1;15
7879;Pumpurėlis;SAULUTĖS;2129779614;Taip;0;8;1;9
7880;Pumpurėlis;SAULUTĖS;1053338730;Taip;5;1;1;7
7881;Pumpurėlis;SAULUTĖS;83388662869;Taip;0;1;0;1
7882;Pumpurėlis;SAULUTĖS;1690424790;Taip;0;0;1;1
7883;Pumpurėlis;SAULUTĖS;6230500803;Taip;0;0;5;5
7884;Pumpurėlis;SAULUTĖS;1306102772;Taip;11;3;2;16
7885;Pumpurėlis;SAULUTĖS;1230058211;Ne;0;3;0;3
7886;Pumpurėlis;SAULUTĖS;25029630023;Taip;0;1;0;1
7887;Pumpurėlis;SAULUTĖS;8262886949;Taip;0;3;0;3
7888;Pumpurėlis;SAULUTĖS;1261919194;Taip;0;0;3;3
7889;Pumpurėlis;SAULUTĖS;9733380187;Taip;0;5;0;5
7890;Pumpurėlis;SAULUTĖS;2102427499;Taip;1;0;0;1
7891;Pumpurėlis;SAULUTĖS;1225377038;Ne;0;0;2;2
7892;Pumpurėlis;SAULUTĖS;9317495169;Taip;0;2;0;2
7893;Pumpurėlis;BITUTĖS;4419940231;Taip;4;2;0;6
7894;Pumpurėlis;BITUTĖS;4985045047;Taip;4;0;1;5
7895;Pumpurėlis;BITUTĖS;2651037375;Ne;8;0;1;9
7896;Pumpurėlis;BITUTĖS;2566557351;Taip;0;4;0;4
7897;Pumpurėlis;BITUTĖS;4426697956;Taip;0;0;4;4
7898;Pumpurėlis;BITUTĖS;7363814444;Taip;0;7;0;7
7899;Pumpurėlis;BITUTĖS;3405169131;Taip;0;0;5;5
7900;Pumpurėlis;BITUTĖS;3951445693;Taip;6;0;0;6
7901;Pumpurėlis;BITUTĖS;9612924316;Taip;0;7;0;7
7902;Pumpurėlis;BITUTĖS;5194285627;Taip;0;6;3;9
7903;Pumpurėlis;BITUTĖS;1714440337;Taip;0;0;1;1
7904;Pumpurėlis;BITUTĖS;8655389224;Taip;5;1;0;6
7905;Pumpurėlis;BITUTĖS;3842632260;Taip;0;0;1;1
7906;Pumpurėlis;BITUTĖS;1933502038;Taip;3;12;0;15
7907;Pumpurėlis;BITUTĖS;7062090879;Taip;5;0;0;5
7908;Pumpurėlis;DOBILIUKAI;1839505206;Taip;0;7;0;7
7909;Pumpurėlis;DOBILIUKAI;3970253545;Taip;8;0;5;13
7910;Pumpurėlis;DOBILIUKAI;1808734330;Taip;5;0;1;6
7911;Pumpurėlis;DOBILIUKAI;6968264923;Taip;9;4;0;13
7912;Pumpurėlis;DOBILIUKAI;7038597556;Taip;8;3;0;11
7913;Pumpurėlis;DOBILIUKAI;4130539703;Taip;0;1;0;1
7914;Pumpurėlis;DOBILIUKAI;6307988067;Taip;0;3;1;4
7915;Pumpurėlis;DOBILIUKAI;3374174445;Taip;0;7;0;7
7916;Pumpurėlis;DOBILIUKAI;3398517047;Taip;3;3;0;6
7917;Pumpurėlis;DOBILIUKAI;1961282282;Taip;1;0;0;1
7918;Pumpurėlis;DOBILIUKAI;7276322999;Taip;5;0;0;5
7919;Pumpurėlis;DOBILIUKAI;9058493247;Taip;7;0;1;8
7920;Pumpurėlis;DOBILIUKAI;3214652626;Taip;5;0;0;5
7921;Pumpurėlis;DOBILIUKAI;2028068230;Taip;5;0;0;5
7922;Pumpurėlis;DOBILIUKAI;5444879430;Ne;18;0;0;18
7923;Pumpurėlis;DOBILIUKAI;7825190756;Ne;16;0;0;16
7924;Pumpurėlis;DOBILIUKAI;1438740562;Taip;5;0;0;5
7925;Pumpurėlis;DOBILIUKAI;9740660699;Taip;9;3;0;12
7926;Pumpurėlis;PUPYČIŲ;7652642088;Taip;5;0;0;5
7927;Pumpurėlis;PUPYČIŲ;9317274035;Taip;18;0;3;21
7928;Pumpurėlis;PUPYČIŲ;1555441484;Taip;18;0;3;21
7929;Pumpurėlis;PUPYČIŲ;9052267552;Taip;0;0;2;2
7930;Pumpurėlis;PUPYČIŲ;9372725707;Taip;5;0;1;6
7931;Pumpurėlis;PUPYČIŲ;4249039048;Taip;0;0;5;5
7932;Pumpurėlis;PUPYČIŲ;1082775039;Taip;0;0;5;5
7933;Pumpurėlis;PUPYČIŲ;6982600785;Taip;10;0;3;13
7934;Pumpurėlis;PUPYČIŲ;1667602636;Taip;5;0;3;8
7935;Pumpurėlis;PUPYČIŲ;8212403350;Taip;4;0;0;4
7936;Pumpurėlis;PUPYČIŲ;6795405194;Taip;6;0;3;9
7937;Pumpurėlis;PUPYČIŲ;7443152469;Taip;6;0;14;20
7938;Pumpurėlis;PUPYČIŲ;9306426978;Taip;0;0;10;10
7939;Pumpurėlis;PUPYČIŲ;3259416263;Taip;0;0;23;23
7940;Pumpurėlis;PUPYČIŲ;2715059752;Taip;0;0;1;1
7941;Pumpurėlis;ŽIRNIUKŲ;9903981454;Taip;0;1;2;3
7942;Pumpurėlis;ŽIRNIUKŲ;3537534154;Taip;0;3;0;3
7943;Pumpurėlis;ŽIRNIUKŲ;1782842327;Taip;14;0;1;15
7944;Pumpurėlis;ŽIRNIUKŲ;9478685443;Taip;14;3;0;17
7945;Pumpurėlis;ŽIRNIUKŲ;6647331393;Taip;0;0;4;4
7946;Pumpurėlis;ŽIRNIUKŲ;3001331278;Taip;18;0;0;18
7947;Pumpurėlis;ŽIRNIUKŲ;9735493140;Taip;16;0;0;16
7948;Pumpurėlis;ŽIRNIUKŲ;3964441086;Taip;11;0;0;11
7949;Pumpurėlis;ŽIRNIUKŲ;8550119831;Ne;10;0;0;10
7950;Pumpurėlis;ŽIRNIUKŲ;4245270154;Taip;8;0;0;8
7951;Pumpurėlis;ŽIRNIUKŲ;6860128064;Taip;0;0;15;15
7952;Pumpurėlis;ŽIRNIUKŲ;2282966743;Taip;5;0;0;5
7953;Pumpurėlis;ŽIRNIUKŲ;5968577443;Taip;0;0;1;1
7954;Pumpurėlis;ŽIRNIUKŲ;8083674991;Taip;5;0;0;5
7955;Pumpurėlis;ŽIRNIUKŲ;9750242149;Taip;16;0;0;16
7956;Pumpurėlis;ŽIRNIUKŲ;5420222684;Taip;6;0;0;6
7957;Pumpurėlis;BORUŽĖLIŲ;6223338814;Ne;17;0;0;17
7958;Pumpurėlis;BORUŽĖLIŲ;5659508302;Taip;5;0;0;5
7959;Pumpurėlis;BORUŽĖLIŲ;5998858670;Ne;16;0;0;16
7960;Pumpurėlis;BORUŽĖLIŲ;5835545051;Taip;11;1;0;12
7961;Pumpurėlis;BORUŽĖLIŲ;4188020534;Taip;0;0;4;4
7962;Pumpurėlis;BORUŽĖLIŲ;6256781298;Taip;0;0;1;1
7963;Pumpurėlis;BORUŽĖLIŲ;9136771401;Taip;9;0;1;10
7964;Pumpurėlis;BORUŽĖLIŲ;7045349032;Taip;13;0;0;13
7965;Pumpurėlis;BORUŽĖLIŲ;1017838338;Taip;1;0;2;3
7966;Pumpurėlis;BORUŽĖLIŲ;1648249689;Taip;2;0;0;2
7967;Pumpurėlis;BORUŽĖLIŲ;7843280418;Ne;17;0;0;17
7968;Pumpurėlis;BORUŽĖLIŲ;3531862496;Ne;4;1;3;8
7969;Pumpurėlis;BORUŽĖLIŲ;1441993078;Ne;9;7;0;16
7970;Pumpurėlis;SMALSUČIŲ;6212212516;Ne;19;0;1;20
7971;Pumpurėlis;SMALSUČIŲ;6604801631;Taip;0;0;5;5
7972;Pumpurėlis;SMALSUČIŲ;9363610488;Taip;0;3;0;3
7973;Pumpurėlis;SMALSUČIŲ;8380689261;Taip;0;5;0;5
7974;Pumpurėlis;SMALSUČIŲ;6483338028;Taip;10;0;0;10
7975;Pumpurėlis;SMALSUČIŲ;3492977569;Taip;4;0;4;8
7976;Pumpurėlis;SMALSUČIŲ;6959214331;Taip;4;0;1;5
7977;Pumpurėlis;SMALSUČIŲ;3085309902;Taip;0;0;2;2
7978;Pumpurėlis;SMALSUČIŲ;4964949574;Taip;0;0;3;3
7979;Pumpurėlis;SMALSUČIŲ;2026021360;Taip;5;2;0;7
7980;Pumpurėlis;SMALSUČIŲ;3871151401;Ne;0;0;2;2
7981;Pumpurėlis;SMALSUČIŲ;6557857672;Taip;5;3;0;8
7982;Pumpurėlis;SMALSUČIŲ;5212827184;Taip;0;0;3;3
7983;Pumpurėlis;SMALSUČIŲ;6614797909;Taip;0;1;0;1
7984;Pumpurėlis;SMALSUČIŲ;7813696919;Ne;0;6;0;6
7985;Pumpurėlis;SMALSUČIŲ;5278250113;Taip;8;0;1;9
7986;Pumpurėlis;SMALSUČIŲ;5236515914;Ne;0;0;1;1
7987;Pumpurėlis;SMALSUČIŲ;5456922203;Taip;7;3;0;10
7988;Puriena;Ančiukų;1658720269;Taip;0;0;1;1
7989;Puriena;Ančiukų;6158842119;Taip;0;8;0;8
7990;Puriena;Ančiukų;3557013127;Taip;0;1;0;1
7991;Puriena;Ančiukų;4100466337;Taip;5;0;2;7
7992;Puriena;Ančiukų;9251058353;Taip;0;2;1;3
7993;Puriena;Ančiukų;3681811493;Taip;10;8;0;18
7994;Puriena;Ančiukų;4060087185;Ne;0;0;1;1
7995;Puriena;Ančiukų;6280465748;Taip;3;0;0;3
7996;Puriena;Ančiukų;3033562627;Taip;0;13;0;13
7997;Puriena;Ančiukų;5777076971;Taip;7;8;0;15
7998;Puriena;Ančiukų;8310231540;Taip;0;1;1;2
7999;Puriena;Ančiukų;4460575818;Taip;3;2;0;5
8000;Puriena;Ančiukų;8120597514;Taip;0;2;0;2
8001;Puriena;Ančiukų;7967288875;Taip;0;0;5;5
8002;Puriena;Ančiukų;5336923102;Taip;0;1;0;1
8003;Puriena;Ančiukų;1907429094;Taip;0;3;0;3
8004;Puriena;Ančiukų;4605662701;Taip;6;5;0;11
8005;Puriena;Ančiukų;1819876614;Taip;0;0;1;1
8006;Puriena;Ančiukų;4776745276;Taip;0;1;2;3
8007;Puriena;Ančiukų;6496291933;Taip;4;0;1;5
8008;Puriena;Ančiukų;7769252165;Taip;0;7;0;7
8009;Puriena;Ančiukų;2170025682;Taip;0;0;1;1
8010;Puriena;Ančiukų;3772941726;Taip;0;5;0;5
8011;Puriena;Ančiukų;1428098802;Taip;0;6;0;6
8012;Puriena;Drugeliai;2966464432;Taip;0;0;6;6
8013;Puriena;Drugeliai;4760827000;Taip;0;0;5;5
8014;Puriena;Drugeliai;4812271011;Taip;0;23;0;23
8015;Puriena;Drugeliai;8881337164;Taip;0;4;0;4
8016;Puriena;Drugeliai;5478026060;Taip;0;4;1;5
8017;Puriena;Drugeliai;6914613438;Taip;0;0;2;2
8018;Puriena;Drugeliai;8159342676;Taip;5;0;0;5
8019;Puriena;Drugeliai;1121312813;Taip;3;0;0;3
8020;Puriena;Drugeliai;2321753665;Taip;5;0;2;7
8021;Puriena;Drugeliai;7021756459;Taip;7;0;0;7
8022;Puriena;Drugeliai;9098291788;Taip;0;3;0;3
8023;Puriena;Drugeliai;6613654824;Taip;0;0;1;1
8024;Puriena;Drugeliai;3738277048;Ne;0;5;0;5
8025;Puriena;Drugeliai;7562458336;Taip;0;0;2;2
8026;Puriena;Drugeliai;3579008577;Taip;8;0;2;10
8027;Puriena;Drugeliai;4248701232;Taip;15;0;0;15
8028;Puriena;Drugeliai;7477278612;Taip;0;0;7;7
8029;Puriena;Drugeliai;9847768390;Taip;8;0;0;8
8030;Puriena;Drugeliai;1455237224;Taip;5;2;0;7
8031;Puriena;Drugeliai;6212693015;Taip;15;0;0;15
8032;Puriena;Drugeliai;5593526943;Ne;10;3;0;13
8033;Puriena;Pelėdžiukai;2013783668;Taip;0;4;0;4
8034;Puriena;Pelėdžiukai;8874823029;Taip;3;0;0;3
8035;Puriena;Pelėdžiukai;3149718901;Taip;2;2;2;6
8036;Puriena;Pelėdžiukai;3175917649;Ne;0;0;2;2
8037;Puriena;Pelėdžiukai;8061605125;Taip;0;3;0;3
8038;Puriena;Pelėdžiukai;2579402981;Taip;0;1;2;3
8039;Puriena;Pelėdžiukai;2701942325;Taip;0;7;0;7
8040;Puriena;Pelėdžiukai;2267225709;Ne;0;1;3;4
8041;Puriena;Pelėdžiukai;6413337915;Taip;3;0;0;3
8042;Puriena;Pelėdžiukai;4858971990;Taip;0;2;5;7
8043;Puriena;Pelėdžiukai;1417566073;Ne;10;0;0;10
8044;Puriena;Pelėdžiukai;6463129806;Taip;7;0;0;7
8045;Puriena;Pelėdžiukai;4501239330;Taip;3;3;0;6
8046;Puriena;Pelėdžiukai;5341228269;Taip;8;1;0;9
8047;Puriena;Pelėdžiukai;6352605894;Ne;0;0;1;1
8048;Puriena;Pelėdžiukai;6786694796;Taip;10;0;1;11
8049;Puriena;Pelėdžiukai;1158768017;Taip;4;4;0;8
8050;Puriena;Voveriukai;3826282438;Taip;0;3;0;3
8051;Puriena;Voveriukai;9453994213;Taip;2;0;0;2
8052;Puriena;Voveriukai;8497070167;Ne;5;3;3;11
8053;Puriena;Voveriukai;4517020977;Ne;0;3;2;5
8054;Puriena;Voveriukai;4283608124;Taip;0;3;3;6
8055;Puriena;Voveriukai;8144488922;Taip;0;0;1;1
8056;Puriena;Voveriukai;8476986855;Taip;5;4;0;9
8057;Puriena;Voveriukai;3627403517;Taip;9;0;0;9
8058;Puriena;Voveriukai;2813562677;Taip;0;1;0;1
8059;Puriena;Voveriukai;4653085762;Taip;0;8;0;8
8060;Puriena;Voveriukai;3542374463;Taip;9;3;0;12
8061;Puriena;Voveriukai;1933733714;Taip;0;6;0;6
8062;Puriena;Voveriukai;6150437624;Taip;0;0;2;2
8063;Puriena;Voveriukai;8772936125;Taip;0;0;8;8
8064;Puriena;Voveriukai;6428413592;Ne;7;0;4;11
8065;Puriena;Voveriukai;8242140541;Taip;0;0;6;6
8066;Puriena;Voveriukai;9729644429;Ne;0;0;4;4
8067;Puriena;Voveriukai;6140294839;Taip;11;0;4;15
8068;Puriena;Voveriukai;3455291312;Taip;2;4;2;8
8069;Puriena;Voveriukai;7066959314;Taip;0;0;2;2
8070;Puriena;Bitučių;9413672989;Ne;0;0;2;2
8071;Puriena;Bitučių;5224135638;Taip;0;0;5;5
8072;Puriena;Bitučių;1175665781;Taip;0;3;0;3
8073;Puriena;Bitučių;6853706997;Taip;0;3;0;3
8074;Puriena;Bitučių;1339162214;Taip;0;3;0;3
8075;Puriena;Bitučių;9543884311;Taip;0;7;0;7
8076;Puriena;Bitučių;8022809059;Taip;3;0;0;3
8077;Puriena;Bitučių;5395382717;Taip;0;0;2;2
8078;Puriena;Bitučių;8237149969;Taip;0;1;0;1
8079;Puriena;Bitučių;7481642656;Taip;0;22;0;22
8080;Puriena;Bitučių;8512814466;Taip;8;2;0;10
8081;Puriena;Bitučių;7622407056;Taip;0;0;2;2
8082;Puriena;Bitučių;8416003733;Taip;0;2;3;5
8083;Puriena;Bitučių;8199607793;Taip;0;0;2;2
8084;Puriena;Bitučių;9854244405;Taip;0;2;0;2
8085;Puriena;Bitučių;6780164845;Taip;4;0;2;6
8086;Puriena;Zylutės;7337038503;Taip;0;5;0;5
8087;Puriena;Zylutės;5891404983;Taip;2;0;3;5
8088;Puriena;Zylutės;63196502622;Ne;0;1;2;3
8089;Puriena;Zylutės;9239618299;Taip;0;18;0;18
8090;Puriena;Zylutės;2083071198;Taip;0;9;0;9
8091;Puriena;Zylutės;20286870431;Taip;0;5;0;5
8092;Puriena;Zylutės;8618298134;Taip;7;0;2;9
8093;Puriena;Zylutės;1748337587;Taip;0;0;3;3
8094;Puriena;Zylutės;1820719083;Taip;13;0;0;13
8095;Puriena;Zylutės;11497629767;Taip;5;0;0;5
8096;Puriena;Zylutės;2378865002;Taip;0;2;0;2
8097;Puriena;Zylutės;2131343339;Taip;0;2;6;8
8098;Puriena;Zylutės;8213725698;Taip;3;0;0;3
8099;Puriena;Zylutės;48468411549;Taip;0;0;1;1
8100;Puriena;Zylutės;1703078658;Taip;0;2;6;8
8101;Puriena;Zylutės;1756611673;Taip;0;0;8;8
8102;Puriena;Zylutės;6416145396;Ne;0;3;2;5
8103;Puriena;Zylutės;3031725530;Taip;2;0;1;3
8104;Puriena;Zylutės;6813480086;Ne;9;0;3;12
8105;Puriena;Meškučių;6234132927;Taip;0;2;2;4
8106;Puriena;Meškučių;4563681164;Taip;0;2;1;3
8107;Puriena;Meškučių;3153330970;Taip;3;1;0;4
8108;Puriena;Meškučių;9500729561;Taip;0;2;1;3
8109;Puriena;Meškučių;1238475246;Taip;0;1;0;1
8110;Puriena;Meškučių;5591189546;Taip;0;2;1;3
8111;Puriena;Meškučių;9748726934;Taip;0;0;2;2
8112;Puriena;Meškučių;7466163131;Taip;6;3;1;10
8113;Puriena;Meškučių;8359978283;Taip;0;23;0;23
8114;Puriena;Meškučių;2466609635;Taip;0;2;5;7
8115;Puriena;Meškučių;3309219271;Taip;0;3;0;3
8116;Puriena;Meškučių;9509041179;Taip;10;0;0;10
8117;Puriena;Meškučių;5176663365;Taip;2;2;0;4
8118;Puriena;Meškučių;9961074983;Taip;0;2;1;3
8119;Puriena;Meškučių;3011629747;Taip;5;0;0;5
8120;Puriena;Meškučių;2029981617;Taip;0;2;1;3
8121;Puriena;Meškučių;6185080390;Taip;23;0;0;23
8122;Puriena;Meškučių;3526684967;Taip;8;2;0;10
8123;Puriena;Meškučių;1513909923;Taip;15;0;0;15
8124;Puriena;Meškučių;7556975480;Taip;0;0;3;3
8125;Puriena;Nykštukų;1053386081;Taip;9;0;0;9
8126;Puriena;Nykštukų;5469827031;Ne;9;0;8;17
8127;Puriena;Nykštukų;7649596096;Taip;19;0;4;23
8128;Puriena;Nykštukų;2762325241;Taip;7;0;0;7
8129;Puriena;Nykštukų;9907142348;Taip;3;0;4;7
8130;Puriena;Nykštukų;9369786639;Taip;17;0;0;17
8131;Puriena;Nykštukų;4728991133;Taip;0;0;8;8
8132;Puriena;Nykštukų;2344061847;Taip;5;1;0;6
8133;Puriena;Nykštukų;3630564604;Taip;10;4;0;14
8134;Puriena;Nykštukų;9438604106;Taip;10;0;1;11
8135;Puriena;Nykštukų;9379314578;Taip;11;0;2;13
8136;Puriena;Nykštukų;4211784186;Taip;11;0;4;15
8137;Puriena;Nykštukų;1610219365;Ne;9;8;0;17
8138;Puriena;Nykštukų;2146727759;Taip;3;0;0;3
8139;Puriena;Nykštukų;1988826809;Taip;0;3;0;3
8140;Puriena;Nykštukų;6605817147;Taip;5;0;1;6
8141;Puriena;Nykštukų;6271951373;Taip;0;3;6;9
8142;Puriena;Nykštukų;7869104640;Taip;0;8;0;8
8143;Puriena;Ežiukai;6451492815;Taip;3;0;0;3
8144;Puriena;Ežiukai;6612468095;Ne;17;0;0;17
8145;Puriena;Ežiukai;7913847170;Taip;10;1;0;11
8146;Puriena;Ežiukai;8089081251;Taip;5;5;0;10
8147;Puriena;Ežiukai;2830409862;Ne;8;3;0;11
8148;Puriena;Ežiukai;5550321808;Taip;5;0;0;5
8149;Puriena;Ežiukai;8038573068;Taip;0;1;0;1
8150;Puriena;Ežiukai;2624283930;Taip;11;2;0;13
8151;Puriena;Ežiukai;6001659356;Taip;2;3;0;5
8152;Puriena;Ežiukai;5539708916;Ne;11;4;0;15
8153;Puriena;Ežiukai;3204824116;Taip;0;9;0;9
8154;Puriena;Ežiukai;4954787474;Ne;5;1;0;6
8155;Puriena;Ežiukai;7720549981;Taip;16;0;0;16
8156;Puriena;Ežiukai;5555076926;Taip;0;0;1;1
8157;Puriena;Ežiukai;3232981406;Taip;17;0;0;17
8158;Puriena;Ežiukai;9228372078;Taip;12;0;0;12
8159;Puriena;Ežiukai;5374864513;Taip;23;0;0;23
8160;Puriena;Ežiukai;1737249860;Taip;0;3;0;3
8161;Puriena;Ežiukai;4608801156;Taip;0;1;0;1
8162;Puriena;"Boružiukų ";9600515308;Taip;16;0;0;16
8163;Puriena;"Boružiukų ";7985332838;Taip;0;23;0;23
8164;Puriena;"Boružiukų ";9671916745;Taip;9;11;0;20
8165;Puriena;"Boružiukų ";8195902319;Taip;0;0;5;5
8166;Puriena;"Boružiukų ";4587892949;Taip;13;0;3;16
8167;Puriena;"Boružiukų ";9497287421;Taip;0;1;22;23
8168;Puriena;"Boružiukų ";2818282875;Taip;0;0;2;2
8169;Puriena;"Boružiukų ";3215364967;Taip;9;0;6;15
8170;Puriena;"Boružiukų ";7016498639;Taip;10;0;4;14
8171;Puriena;"Boružiukų ";5797970231;Taip;19;1;0;20
8172;Puriena;"Boružiukų ";3382737176;Taip;8;0;0;8
8173;Puriena;"Boružiukų ";8110665629;Taip;0;2;0;2
8174;Puriena;"Boružiukų ";4006267650;Ne;18;4;0;22
8175;Puriena;"Boružiukų ";3440488785;Taip;0;0;10;10
8176;Puriena;"Boružiukų ";4016228982;Taip;20;0;1;21
8177;Puriena;"Boružiukų ";1796123753;Taip;0;0;23;23
8178;Puriena;"Boružiukų ";5277351784;Taip;6;3;0;9
8179;Puriena;"Boružiukų ";9931397038;Taip;4;0;2;6
8180;Puriena;"Zuikučių ";9907972536;Ne;15;0;0;15
8181;Puriena;"Zuikučių ";4165800035;Taip;0;0;6;6
8182;Puriena;"Zuikučių ";7634536770;Taip;2;1;2;5
8183;Puriena;"Zuikučių ";9423229931;Taip;0;6;0;6
8184;Puriena;"Zuikučių ";8284860687;Taip;2;2;1;5
8185;Puriena;"Zuikučių ";9176303276;Taip;11;7;2;20
8186;Puriena;"Zuikučių ";6941251095;Taip;23;0;0;23
8187;Puriena;"Zuikučių ";4193710604;Taip;4;0;5;9
8188;Puriena;"Zuikučių ";8474426340;Taip;0;14;1;15
8189;Puriena;"Zuikučių ";6227990580;Taip;8;0;2;10
8190;Puriena;"Zuikučių ";2172109284;Taip;17;0;0;17
8191;Puriena;"Zuikučių ";8239919265;Ne;6;0;0;6
8192;Puriena;"Zuikučių ";3094722037;Taip;0;0;7;7
8193;Puriena;"Zuikučių ";6308393533;Taip;2;2;6;10
8194;Puriena;"Zuikučių ";5927216569;Taip;10;1;0;11
8195;Puriena;Skruzdėliukai;8478901457;Taip;0;8;0;8
8196;Puriena;Skruzdėliukai;4647433927;Taip;0;18;0;18
8197;Puriena;Skruzdėliukai;5257713434;Taip;0;18;0;18
8198;Puriena;Skruzdėliukai;11242620566;Taip;0;2;0;2
8199;Puriena;Skruzdėliukai;6285846517;Taip;0;4;3;7
8200;Puriena;Skruzdėliukai;6053657231;Taip;0;1;0;1
8201;Puriena;Skruzdėliukai;5501308683;Taip;0;5;0;5
8202;Puriena;Skruzdėliukai;40573980976;Taip;10;0;0;10
8203;Puriena;Skruzdėliukai;6057477307;Taip;0;0;1;1
8204;Puriena;Skruzdėliukai;4966293604;Taip;0;1;0;1
8205;Puriena;Skruzdėliukai;92604925140;Taip;0;1;0;1
8206;Puriena;Skruzdėliukai;1290962809;Taip;0;6;0;6
8207;Puriena;Skruzdėliukai;23746358787;Taip;0;1;0;1
8208;Puriena;Skruzdėliukai;1263637124;Taip;0;2;0;2
8209;Puriena;Skruzdėliukai;1290933817;Taip;0;12;0;12
8210;Puriena;Skruzdėliukai;8112003551;Taip;0;3;0;3
8211;Pušaitė;Kodėlčiukai;3832434608;Taip;0;5;0;5
8212;Pušaitė;Kodėlčiukai;4838345510;Taip;8;3;1;12
8213;Pušaitė;Kodėlčiukai;7068451014;Taip;0;2;3;5
8214;Pušaitė;Kodėlčiukai;2253477550;Taip;0;4;0;4
8215;Pušaitė;Kodėlčiukai;8750774616;Taip;0;1;0;1
8216;Pušaitė;Kodėlčiukai;2004615252;Taip;0;5;0;5
8217;Pušaitė;Kodėlčiukai;4743105731;Taip;13;0;0;13
8218;Pušaitė;Kodėlčiukai;9391350218;Taip;5;4;0;9
8219;Pušaitė;Kodėlčiukai;2793941689;Taip;7;10;0;17
8220;Pušaitė;Kodėlčiukai;9364887123;Taip;7;5;0;12
8221;Pušaitė;Kodėlčiukai;4326967247;Taip;0;4;1;5
8222;Pušaitė;Kodėlčiukai;5922053969;Taip;3;0;1;4
8223;Pušaitė;Kodėlčiukai;4473930703;Taip;0;2;0;2
8224;Pušaitė;Kodėlčiukai;6775428321;Taip;0;0;1;1
8225;Pušaitė;Kodėlčiukai;4615270419;Taip;0;2;0;2
8226;Pušaitė;Kodėlčiukai;7117784038;Taip;13;1;0;14
8227;Pušaitė;Kodėlčiukai;6186545163;Taip;4;3;0;7
8228;Pušaitė;Saulutės;4511258460;Taip;15;0;3;18
8229;Pušaitė;Saulutės;5422616450;Taip;0;0;3;3
8230;Pušaitė;Saulutės;7237345427;Taip;0;0;2;2
8231;Pušaitė;Saulutės;5819186055;Taip;5;0;0;5
8232;Pušaitė;Saulutės;8931688329;Taip;4;0;1;5
8233;Pušaitė;Saulutės;5981944481;Taip;3;0;0;3
8234;Pušaitė;Saulutės;2254269292;Taip;6;0;0;6
8235;Pušaitė;Saulutės;5306237557;Taip;14;0;0;14
8236;Pušaitė;Saulutės;4234318548;Taip;0;3;3;6
8237;Pušaitė;Saulutės;4883211957;Taip;0;23;0;23
8238;Pušaitė;Saulutės;1384820994;Taip;0;23;0;23
8239;Pušaitė;Saulutės;7480846917;Taip;7;0;2;9
8240;Pušaitė;Saulutės;8355083823;Taip;0;0;4;4
8241;Pušaitė;Saulutės;7291412329;Taip;0;0;4;4
8242;Pušaitė;Saulutės;2543188867;Ne;6;0;0;6
8243;Pušaitė;Saulutės;9577925438;Taip;0;12;0;12
8244;Pušaitė;Saulutės;8914668904;Taip;0;0;2;2
8245;Pušaitė;Zuikučiai;2115591523;Taip;10;0;3;13
8246;Pušaitė;Zuikučiai;8738827821;Taip;2;1;3;6
8247;Pušaitė;Zuikučiai;7477429922;Taip;0;8;0;8
8248;Pušaitė;Zuikučiai;6306133416;Taip;8;0;1;9
8249;Pušaitė;Zuikučiai;2099169654;Taip;5;0;1;6
8250;Pušaitė;Zuikučiai;6355379926;Taip;7;0;1;8
8251;Pušaitė;Zuikučiai;1296700534;Taip;2;3;1;6
8252;Pušaitė;Zuikučiai;51500717235;Taip;0;23;0;23
8253;Pušaitė;Zuikučiai;2125574493;Taip;0;2;0;2
8254;Pušaitė;Zuikučiai;5398532705;Taip;0;0;3;3
8255;Pušaitė;Zuikučiai;3718196299;Taip;0;0;1;1
8256;Pušaitė;Zuikučiai;1295203136;Taip;3;8;2;13
8257;Pušaitė;Zuikučiai;6259961070;Taip;0;8;0;8
8258;Pušaitė;Zuikučiai;2944418714;Taip;11;0;0;11
8259;Pušaitė;Zuikučiai;3813761666;Taip;14;0;0;14
8260;Pušaitė;Zuikučiai;4762094720;Taip;5;3;0;8
8261;Pušaitė;Zuikučiai;6600314608;Taip;14;0;1;15
8262;Pušaitė;Zuikučiai;2130767942;Taip;0;7;0;7
8263;Pušaitė;Zuikučiai;8155746120;Taip;0;8;2;10
8264;Pušaitė;Zuikučiai;9179757395;Taip;0;3;1;4
8265;Pušaitė;Zuikučiai;8592426606;Taip;0;0;2;2
8266;Pušaitė;Zuikučiai;7251064118;Taip;10;0;1;11
8267;Pušaitė;Vėžliukai;1326581025;Taip;0;9;0;9
8268;Pušaitė;Vėžliukai;5161142520;Taip;12;0;1;13
8269;Pušaitė;Vėžliukai;3485234259;Taip;13;0;0;13
8270;Pušaitė;Vėžliukai;3014867515;Taip;5;0;1;6
8271;Pušaitė;Vėžliukai;9414554800;Taip;0;1;0;1
8272;Pušaitė;Vėžliukai;9470667227;Taip;1;0;2;3
8273;Pušaitė;Vėžliukai;6739253961;Taip;13;3;0;16
8274;Pušaitė;Vėžliukai;3014180020;Ne;0;0;2;2
8275;Pušaitė;Vėžliukai;7890577174;Taip;0;5;0;5
8276;Pušaitė;Vėžliukai;7652706756;Taip;0;1;0;1
8277;Pušaitė;Vėžliukai;5318602924;Taip;2;3;0;5
8278;Pušaitė;Vėžliukai;6794867560;Taip;0;2;0;2
8279;Pušaitė;Vėžliukai;5296435012;Taip;0;1;1;2
8280;Pušaitė;Vėžliukai;5512786073;Taip;5;13;0;18
8281;Pušaitė;Vėžliukai;8399589954;Taip;0;3;0;3
8282;Pušaitė;Vėžliukai;4281125486;Taip;0;5;0;5
8283;Pušaitė;Vėžliukai;2777222076;Taip;0;13;0;13
8284;Pušaitė;Vėžliukai;8459530338;Taip;5;2;0;7
8285;Pušaitė;"Linksmieji nykštukai";9265357004;Taip;0;1;0;1
8286;Pušaitė;"Linksmieji nykštukai";3150144924;Taip;1;2;0;3
8287;Pušaitė;"Linksmieji nykštukai";4517181474;Taip;0;2;0;2
8288;Pušaitė;"Linksmieji nykštukai";9033615485;Ne;5;2;0;7
8289;Pušaitė;"Linksmieji nykštukai";3130824742;Taip;0;4;0;4
8290;Pušaitė;"Linksmieji nykštukai";4605161267;Taip;10;3;0;13
8291;Pušaitė;"Linksmieji nykštukai";1024996364;Taip;0;3;4;7
8292;Pušaitė;"Linksmieji nykštukai";4662871524;Taip;4;3;0;7
8293;Pušaitė;"Linksmieji nykštukai";8438652029;Taip;3;0;2;5
8294;Pušaitė;"Linksmieji nykštukai";6578483902;Taip;6;0;3;9
8295;Pušaitė;"Linksmieji nykštukai";3350461304;Taip;0;1;0;1
8296;Pušaitė;"Linksmieji nykštukai";9327636862;Taip;2;1;0;3
8297;Pušaitė;"Linksmieji nykštukai";4175909754;Taip;0;0;3;3
8298;Pušaitė;"Linksmieji nykštukai";3788392895;Taip;17;0;0;17
8299;Pušaitė;"Linksmieji nykštukai";9127444013;Taip;0;3;0;3
8300;Pušaitė;"Linksmieji nykštukai";5422784898;Taip;9;8;0;17
8301;Pušaitė;"Linksmieji nykštukai";5104111840;Taip;2;0;0;2
8302;Pušaitė;"Linksmieji nykštukai";9866431097;Taip;5;5;0;10
8303;Pušaitė;"Linksmieji nykštukai";4564478833;Taip;14;3;0;17
8304;Pušaitė;"Linksmieji nykštukai";4374232593;Taip;15;0;0;15
8305;Pušaitė;"Linksmieji nykštukai";8378313810;Taip;3;4;0;7
8306;Pušaitė;"Kačiukų trobelė";3695016765;Taip;3;0;0;3
8307;Pušaitė;"Kačiukų trobelė";1122112207;Taip;0;6;0;6
8308;Pušaitė;"Kačiukų trobelė";1635528919;Taip;0;1;4;5
8309;Pušaitė;"Kačiukų trobelė";2837439334;Taip;5;0;0;5
8310;Pušaitė;"Kačiukų trobelė";7014914682;Ne;0;1;0;1
8311;Pušaitė;"Kačiukų trobelė";8793102437;Taip;4;10;0;14
8312;Pušaitė;"Kačiukų trobelė";9056933586;Taip;11;3;0;14
8313;Pušaitė;"Kačiukų trobelė";7898355721;Taip;10;0;0;10
8314;Pušaitė;"Kačiukų trobelė";6323180798;Taip;0;1;0;1
8315;Pušaitė;"Kačiukų trobelė";5191894075;Taip;0;2;0;2
8316;Pušaitė;"Kačiukų trobelė";1161519408;Taip;0;23;0;23
8317;Pušaitė;"Kačiukų trobelė";8822285103;Taip;0;11;0;11
8318;Pušaitė;"Kačiukų trobelė";9313564235;Taip;13;2;0;15
8319;Pušaitė;"Kačiukų trobelė";2865062081;Taip;0;7;0;7
8320;Pušaitė;"Kačiukų trobelė";2430891944;Taip;3;0;0;3
8321;Pušaitė;"Kačiukų trobelė";1978339054;Taip;4;11;0;15
8322;Pušaitė;"Kačiukų trobelė";6189116357;Taip;5;0;2;7
8323;Pušaitė;Ežiukai;2090143259;Ne;0;2;0;2
8324;Pušaitė;Ežiukai;2951618391;Taip;9;4;0;13
8325;Pušaitė;Ežiukai;9524002395;Taip;0;3;0;3
8326;Pušaitė;Ežiukai;1111143593;Taip;5;3;1;9
8327;Pušaitė;Ežiukai;5394378197;Taip;0;5;0;5
8328;Pušaitė;Ežiukai;15270671089;Taip;0;7;0;7
8329;Pušaitė;Ežiukai;69869396094;Taip;0;10;0;10
8330;Pušaitė;Ežiukai;3359574190;Taip;4;2;0;6
8331;Pušaitė;Ežiukai;1143122778;Taip;5;2;0;7
8332;Pušaitė;Ežiukai;9461292576;Taip;5;0;0;5
8333;Pušaitė;Ežiukai;4671293211;Taip;0;4;0;4
8334;Pušaitė;Ežiukai;8958364766;Taip;3;4;0;7
8335;Pušaitė;Ežiukai;2983890410;Taip;0;3;0;3
8336;Pušaitė;Ežiukai;7575143890;Taip;0;3;0;3
8337;Pušaitė;Ežiukai;7808186865;Taip;0;9;0;9
8338;Pušaitė;Ežiukai;5436168234;Taip;13;0;0;13
8339;Pušaitė;Ežiukai;8021494509;Taip;10;0;0;10
8340;Pušaitė;Ežiukai;2172342063;Taip;5;6;0;11
8341;Pušaitė;Ežiukai;8309000712;Taip;5;0;0;5
8342;Pušaitė;"Gudručių šalis";8763667682;Taip;12;0;0;12
8343;Pušaitė;"Gudručių šalis";2321256048;Taip;0;1;1;2
8344;Pušaitė;"Gudručių šalis";5488507646;Ne;0;0;3;3
8345;Pušaitė;"Gudručių šalis";1305526154;Taip;10;1;1;12
8346;Pušaitė;"Gudručių šalis";6205900423;Taip;0;23;0;23
8347;Pušaitė;"Gudručių šalis";2078734161;Taip;5;0;3;8
8348;Pušaitė;"Gudručių šalis";8790959900;Taip;2;2;0;4
8349;Pušaitė;"Gudručių šalis";2397106198;Taip;7;0;0;7
8350;Pušaitė;"Gudručių šalis";3694667637;Taip;5;0;0;5
8351;Pušaitė;"Gudručių šalis";8343949011;Taip;0;0;1;1
8352;Pušaitė;"Gudručių šalis";4101285889;Ne;12;0;1;13
8353;Pušaitė;"Gudručių šalis";3959838346;Taip;6;0;1;7
8354;Pušaitė;"Gudručių šalis";5563772495;Taip;0;3;5;8
8355;Pušaitė;"Gudručių šalis";6356263503;Taip;3;0;6;9
8356;Pušaitė;"Gudručių šalis";4626055123;Taip;2;1;1;4
8357;Pušaitė;"Gudručių šalis";2333176054;Taip;2;1;0;3
8358;Pušaitė;"Gudručių šalis";7066207306;Taip;0;0;3;3
8359;Pušaitė;"Gudručių šalis";4918124423;Taip;5;0;2;7
8360;Pušaitė;"Gudručių šalis";6734504906;Taip;0;0;1;1
8361;Pušaitė;"Gudručių šalis";7992567219;Taip;2;0;0;2
8362;Pušaitė;"Gudručių šalis";3380836598;Taip;1;0;0;1
8363;Pušaitė;"Lapučių mokyklėlė";9337726482;Taip;0;4;0;4
8364;Pušaitė;"Lapučių mokyklėlė";5139525557;Taip;4;3;2;9
8365;Pušaitė;"Lapučių mokyklėlė";2666541612;Taip;7;1;0;8
8366;Pušaitė;"Lapučių mokyklėlė";8343225451;Taip;10;9;0;19
8367;Pušaitė;"Lapučių mokyklėlė";8218991320;Taip;3;2;0;5
8368;Pušaitė;"Lapučių mokyklėlė";1994898058;Taip;0;23;0;23
8369;Pušaitė;"Lapučių mokyklėlė";8551426938;Taip;16;0;6;22
8370;Pušaitė;"Lapučių mokyklėlė";4444972517;Taip;14;0;0;14
8371;Pušaitė;"Lapučių mokyklėlė";7615253880;Taip;8;1;0;9
8372;Pušaitė;"Lapučių mokyklėlė";4508356130;Taip;7;0;0;7
8373;Pušaitė;"Lapučių mokyklėlė";4857214952;Taip;0;3;0;3
8374;Pušaitė;"Lapučių mokyklėlė";4138386134;Taip;11;0;0;11
8375;Pušaitė;"Lapučių mokyklėlė";4103149433;Taip;6;4;0;10
8376;Pušaitė;"Lapučių mokyklėlė";4747611989;Taip;6;1;0;7
8377;Pušaitė;"Lapučių mokyklėlė";3387165403;Taip;8;1;0;9
8378;Pušaitė;"Lapučių mokyklėlė";5281161835;Taip;0;0;2;2
8379;Pušaitė;"Lapučių mokyklėlė";5339878948;Ne;13;2;0;15
8380;Pušaitė;"Lapučių mokyklėlė";3610256789;Taip;13;0;2;15
8381;Pušaitė;"Lapučių mokyklėlė";1395577340;Taip;0;1;0;1
8382;Pušaitė;"Lapučių mokyklėlė";1534764228;Taip;0;3;0;3
8383;Pušaitė;"Lapučių mokyklėlė";5328083339;Taip;3;3;1;7
8384;Pušaitė;"Lapučių mokyklėlė";3200968850;Taip;0;9;0;9
8385;Pušaitė;"VOVERIUKAI ";7891007708;Taip;2;0;0;2
8386;Pušaitė;"VOVERIUKAI ";6767281906;Ne;0;1;0;1
8387;Pušaitė;"VOVERIUKAI ";3732377309;Ne;10;0;0;10
8388;Pušaitė;"VOVERIUKAI ";5270528758;Taip;4;0;0;4
8389;Pušaitė;"VOVERIUKAI ";4344634837;Taip;0;23;0;23
8390;Pušaitė;"VOVERIUKAI ";1665030028;Ne;1;14;1;16
8391;Pušaitė;"VOVERIUKAI ";4769806128;Taip;23;0;0;23
8392;Pušaitė;"VOVERIUKAI ";6511940816;Taip;0;23;0;23
8393;Pušaitė;"VOVERIUKAI ";4818407739;Taip;0;23;0;23
8394;Pušaitė;"VOVERIUKAI ";8593282377;Ne;3;0;6;9
8395;Pušaitė;"VOVERIUKAI ";8876092901;Taip;16;0;0;16
8396;Pušaitė;"VOVERIUKAI ";9546541248;Taip;6;0;0;6
8397;Pušaitė;"VOVERIUKAI ";4767321724;Taip;0;23;0;23
8398;Pušaitė;"VOVERIUKAI ";4529006786;Taip;11;1;0;12
8399;Pušaitė;MEŠKUČIAI;5002710062;Taip;0;13;2;15
8400;Pušaitė;MEŠKUČIAI;9872317190;Taip;0;0;1;1
8401;Pušaitė;MEŠKUČIAI;3052743933;Taip;18;0;2;20
8402;Pušaitė;MEŠKUČIAI;3646346787;Taip;10;0;5;15
8403;Pušaitė;MEŠKUČIAI;6754402783;Ne;0;23;0;23
8404;Pušaitė;MEŠKUČIAI;9180309936;Ne;13;0;0;13
8405;Pušaitė;MEŠKUČIAI;4754791489;Taip;7;2;0;9
8406;Pušaitė;MEŠKUČIAI;2264047794;Taip;13;1;0;14
8407;Pušaitė;MEŠKUČIAI;4278699624;Taip;0;23;0;23
8408;Pušaitė;MEŠKUČIAI;8244793037;Taip;12;0;0;12
8409;Pušaitė;MEŠKUČIAI;3508664946;Taip;0;2;0;2
8410;Pušaitė;MEŠKUČIAI;3239486674;Taip;6;0;2;8
8411;Pušaitė;MEŠKUČIAI;9339706754;Taip;10;0;1;11
8412;Pušaitė;MEŠKUČIAI;2887576870;Taip;0;0;5;5
8413;Pušaitė;MEŠKUČIAI;7583243031;Taip;6;0;4;10
8414;Pušaitė;MEŠKUČIAI;9418440677;Taip;0;23;0;23
8415;Pušaitė;MEŠKUČIAI;4082173648;Taip;10;6;0;16
8416;Pušaitė;PELIUKAI;7103772753;Taip;10;0;0;10
8417;Pušaitė;PELIUKAI;9177861202;Taip;0;1;0;1
8418;Pušaitė;PELIUKAI;9164927041;Taip;0;9;0;9
8419;Pušaitė;PELIUKAI;2454348536;Taip;6;0;0;6
8420;Pušaitė;PELIUKAI;6645711171;Taip;23;0;0;23
8421;Pušaitė;PELIUKAI;9867041220;Taip;5;0;0;5
8422;Pušaitė;PELIUKAI;7210529114;Taip;11;3;0;14
8423;Pušaitė;PELIUKAI;2758026755;Taip;2;2;0;4
8424;Pušaitė;PELIUKAI;6851908671;Taip;0;0;3;3
8425;Pušaitė;PELIUKAI;7737524017;Taip;10;0;0;10
8426;Pušaitė;PELIUKAI;2618038364;Taip;0;23;0;23
8427;Pušaitė;PELIUKAI;1180343204;Taip;16;3;0;19
8428;Pušaitė;PELIUKAI;1069369636;Taip;8;5;0;13
8429;Pušaitė;PELIUKAI;5112517007;Taip;0;23;0;23
8430;Pušaitė;PELIUKAI;9261546370;Taip;0;8;0;8
8431;Pušaitė;PELIUKAI;6059415475;Taip;0;23;0;23
8432;"Pušynėlis (Miglos g. 53)";PUMPURĖLIAI;5725602894;Taip;17;4;1;22
8433;"Pušynėlis (Miglos g. 53)";PUMPURĖLIAI;2718421498;Taip;5;4;0;9
8434;"Pušynėlis (Miglos g. 53)";PUMPURĖLIAI;3882064516;Taip;10;1;0;11
8435;"Pušynėlis (Miglos g. 53)";PUMPURĖLIAI;9081582524;Taip;10;1;0;11
8436;"Pušynėlis (Miglos g. 53)";PUMPURĖLIAI;7787646910;Taip;2;0;0;2
8437;"Pušynėlis (Miglos g. 53)";PUMPURĖLIAI;8218331977;Taip;5;5;0;10
8438;"Pušynėlis (Miglos g. 53)";PUMPURĖLIAI;4526807309;Taip;0;4;5;9
8439;"Pušynėlis (Miglos g. 53)";PUMPURĖLIAI;5568838550;Taip;5;6;0;11
8440;"Pušynėlis (Miglos g. 53)";PUMPURĖLIAI;2744665477;Taip;0;4;0;4
8441;"Pušynėlis (Miglos g. 53)";PUMPURĖLIAI;2509111066;Taip;0;6;0;6
8442;"Pušynėlis (Miglos g. 53)";PUMPURĖLIAI;8902047615;Taip;6;0;0;6
8443;"Pušynėlis (Miglos g. 53)";PUMPURĖLIAI;3483639540;Taip;3;2;0;5
8444;"Pušynėlis (Miglos g. 53)";PUMPURĖLIAI;2861000826;Taip;10;0;0;10
8445;"Pušynėlis (Miglos g. 53)";PUMPURĖLIAI;8845728723;Taip;3;0;0;3
8446;"Pušynėlis (Miglos g. 53)";PUMPURĖLIAI;5802582694;Taip;0;3;0;3
8447;"Pušynėlis (Miglos g. 53)";PUMPURĖLIAI;9465619945;Taip;6;3;0;9
8448;"Pušynėlis (Miglos g. 53)";PUMPURĖLIAI;9883505094;Taip;15;3;0;18
8449;"Pušynėlis (Miglos g. 53)";PUMPURĖLIAI;7438923710;Taip;17;4;0;21
8450;"Pušynėlis (Miglos g. 53)";PUMPURĖLIAI;4962270317;Ne;6;0;1;7
8451;"Pušynėlis (Miglos g. 53)";PUMPURĖLIAI;8803766149;Taip;7;4;0;11
8452;"Pušynėlis (Miglos g. 53)";PUMPURĖLIAI;8462742834;Taip;4;3;0;7
8453;"Pušynėlis (Miglos g. 53)";PUMPURĖLIAI;6962705842;Taip;0;0;24;24
8454;"Pušynėlis (Miglos g. 53)";PUMPURĖLIAI;6110878898;Taip;7;3;0;10
8455;"Pušynėlis (Miglos g. 53)";SAULUTĖS;3483007385;Taip;2;4;0;6
8456;"Pušynėlis (Miglos g. 53)";SAULUTĖS;1891728904;Taip;4;0;0;4
8457;"Pušynėlis (Miglos g. 53)";SAULUTĖS;5236219294;Taip;3;0;5;8
8458;"Pušynėlis (Miglos g. 53)";SAULUTĖS;4052132379;Taip;6;0;0;6
8459;"Pušynėlis (Miglos g. 53)";SAULUTĖS;9483417104;Taip;13;0;0;13
8460;"Pušynėlis (Miglos g. 53)";SAULUTĖS;4052365035;Taip;0;0;2;2
8461;"Pušynėlis (Miglos g. 53)";SAULUTĖS;7401066252;Taip;0;0;1;1
8462;"Pušynėlis (Miglos g. 53)";SAULUTĖS;6036296660;Taip;0;4;0;4
8463;"Pušynėlis (Miglos g. 53)";SAULUTĖS;1164201286;Taip;0;3;0;3
8464;"Pušynėlis (Miglos g. 53)";SAULUTĖS;1251787066;Taip;0;0;1;1
8465;"Pušynėlis (Miglos g. 53)";SAULUTĖS;6709692748;Taip;7;1;0;8
8466;"Pušynėlis (Miglos g. 53)";SAULUTĖS;5318223378;Taip;4;0;1;5
8467;"Pušynėlis (Miglos g. 53)";SAULUTĖS;3100230874;Taip;0;23;0;23
8468;"Pušynėlis (Miglos g. 53)";SAULUTĖS;7896617995;Taip;0;0;1;1
8469;"Pušynėlis (Miglos g. 53)";SAULUTĖS;5897839636;Taip;5;0;0;5
8470;"Pušynėlis (Miglos g. 53)";SAULUTĖS;1034336110;Taip;5;2;0;7
8471;"Pušynėlis (Miglos g. 53)";SAULUTĖS;8799095053;Taip;0;1;0;1
8472;"Pušynėlis (Miglos g. 53)";SAULUTĖS;8451160808;Ne;0;0;1;1
8473;"Pušynėlis (Miglos g. 53)";PRIEŠMOKYKLINĖ;8742287326;Taip;6;3;0;9
8474;"Pušynėlis (Miglos g. 53)";PRIEŠMOKYKLINĖ;2012089695;Taip;0;3;0;3
8475;"Pušynėlis (Miglos g. 53)";PRIEŠMOKYKLINĖ;35538053975;Ne;0;4;0;4
8476;"Pušynėlis (Miglos g. 53)";PRIEŠMOKYKLINĖ;76597184985;Taip;0;3;0;3
8477;"Pušynėlis (Miglos g. 53)";PRIEŠMOKYKLINĖ;7729392498;Taip;0;5;0;5
8478;"Pušynėlis (Miglos g. 53)";PRIEŠMOKYKLINĖ;9192206804;Taip;0;2;0;2
8479;"Pušynėlis (Miglos g. 53)";PRIEŠMOKYKLINĖ;6077698697;Taip;0;5;0;5
8480;"Pušynėlis (Miglos g. 53)";PRIEŠMOKYKLINĖ;4668634909;Taip;0;1;0;1
8481;"Pušynėlis (Miglos g. 53)";PRIEŠMOKYKLINĖ;6560054869;Taip;0;4;0;4
8482;"Pušynėlis (Miglos g. 53)";PRIEŠMOKYKLINĖ;2019210609;Taip;0;1;0;1
8483;"Pušynėlis (Miglos g. 53)";PRIEŠMOKYKLINĖ;2793982816;Taip;0;0;2;2
8484;"Pušynėlis (Miglos g. 53)";PRIEŠMOKYKLINĖ;7046421581;Taip;0;3;0;3
8485;"Pušynėlis (Miglos g. 53)";PRIEŠMOKYKLINĖ;9466109315;Ne;0;4;0;4
8486;"Pušynėlis (Miglos g. 53)";PRIEŠMOKYKLINĖ;1573574250;Taip;0;2;0;2
8487;"Pušynėlis (Miglos g. 53)";PRIEŠMOKYKLINĖ;3510202379;Taip;0;0;7;7
8488;"Pušynėlis (Miglos g. 53)";PRIEŠMOKYKLINĖ;2765869141;Taip;0;3;0;3
8489;"Pušynėlis (Miglos g. 53)";"TREPSIUKAI (2018.09)";7732546085;Taip;18;0;0;18
8490;"Pušynėlis (Miglos g. 53)";"TREPSIUKAI (2018.09)";4449613959;Taip;7;0;5;12
8491;"Pušynėlis (Miglos g. 53)";"TREPSIUKAI (2018.09)";8933840402;Taip;0;0;12;12
8492;"Pušynėlis (Miglos g. 53)";"TREPSIUKAI (2018.09)";6414064067;Taip;0;1;0;1
8493;"Pušynėlis (Miglos g. 53)";"TREPSIUKAI (2018.09)";5670094788;Taip;0;3;6;9
8494;"Pušynėlis (Miglos g. 53)";"TREPSIUKAI (2018.09)";5264481173;Taip;0;3;0;3
8495;"Pušynėlis (Miglos g. 53)";"TREPSIUKAI (2018.09)";4468698630;Taip;0;0;4;4
8496;"Pušynėlis (Miglos g. 53)";"TREPSIUKAI (2018.09)";1240222214;Taip;5;0;5;10
8497;"Pušynėlis (Miglos g. 53)";"TREPSIUKAI (2018.09)";6318952845;Taip;1;3;0;4
8498;"Pušynėlis (Miglos g. 53)";"TREPSIUKAI (2018.09)";1508282873;Taip;2;4;8;14
8499;"Pušynėlis (Miglos g. 53)";"TREPSIUKAI (2018.09)";7745507151;Taip;7;0;3;10
8500;"Pušynėlis (Miglos g. 53)";"TREPSIUKAI (2018.09)";8372033449;Taip;0;5;0;5
8501;"Pušynėlis (Miglos g. 53)";"TREPSIUKAI (2018.09)";7964828070;Taip;3;0;3;6
8502;"Pušynėlis (Miglos g. 53)";"TREPSIUKAI (2018.09)";5038740377;Taip;6;2;0;8
8503;Raktelis;LAŠIUKAI;5031703240;Taip;10;0;0;10
8504;Raktelis;LAŠIUKAI;4671391106;Taip;0;2;0;2
8505;Raktelis;LAŠIUKAI;9313156299;Taip;7;3;0;10
8506;Raktelis;LAŠIUKAI;8117871963;Taip;0;10;0;10
8507;Raktelis;LAŠIUKAI;1192775994;Taip;5;2;0;7
8508;Raktelis;LAŠIUKAI;6854111162;Taip;0;3;0;3
8509;Raktelis;LAŠIUKAI;9230053040;Ne;0;4;1;5
8510;Raktelis;LAŠIUKAI;8410301417;Taip;0;5;0;5
8511;Raktelis;LAŠIUKAI;3713386556;Taip;5;4;0;9
8512;Raktelis;LAŠIUKAI;5818899732;Taip;0;10;0;10
8513;Raktelis;LAŠIUKAI;7487507324;Taip;0;2;0;2
8514;Raktelis;LAŠIUKAI;9584164290;Taip;0;3;0;3
8515;Raktelis;LAŠIUKAI;6049420030;Ne;0;3;0;3
8516;Raktelis;LAŠIUKAI;95104355224;Taip;5;3;0;8
8517;Raktelis;LAŠIUKAI;2303286473;Taip;5;0;0;5
8518;Raktelis;LAŠIUKAI;54221331553;Taip;0;4;0;4
8519;Raktelis;LAŠIUKAI;5802689482;Taip;0;8;0;8
8520;Raktelis;LAŠIUKAI;5000264125;Taip;9;3;0;12
8521;Raktelis;LAŠIUKAI;5711863758;Taip;0;4;2;6
8522;Raktelis;LAŠIUKAI;53034039807;Taip;0;9;0;9
8523;Raktelis;LAŠIUKAI;8559758812;Taip;10;4;1;15
8524;Raktelis;LAŠIUKAI;9210856228;Ne;0;0;1;1
8525;Raktelis;BITUTĖS;7265543701;Ne;4;2;0;6
8526;Raktelis;BITUTĖS;5627179884;Taip;0;4;1;5
8527;Raktelis;BITUTĖS;5405322552;Taip;7;0;0;7
8528;Raktelis;BITUTĖS;5492437864;Ne;4;4;0;8
8529;Raktelis;BITUTĖS;5218387088;Taip;7;1;0;8
8530;Raktelis;BITUTĖS;9139322116;Taip;3;0;3;6
8531;Raktelis;BITUTĖS;6929358401;Taip;0;4;0;4
8532;Raktelis;BITUTĖS;9965855682;Taip;0;5;0;5
8533;Raktelis;BITUTĖS;4319176525;Taip;5;0;1;6
8534;Raktelis;BITUTĖS;4187804340;Ne;0;0;1;1
8535;Raktelis;BITUTĖS;5820028619;Taip;0;5;0;5
8536;Raktelis;BITUTĖS;2652125338;Taip;0;0;2;2
8537;Raktelis;BITUTĖS;3821849812;Taip;10;1;0;11
8538;Raktelis;BITUTĖS;3308623522;Ne;8;8;1;17
8539;Raktelis;BITUTĖS;4059286631;Taip;8;2;0;10
8540;Raktelis;BITUTĖS;6974263764;Taip;0;13;0;13
8541;Raktelis;BITUTĖS;6932820066;Taip;13;0;0;13
8542;Raktelis;BITUTĖS;2410682193;Taip;5;0;2;7
8543;Raktelis;BITUTĖS;5705825231;Taip;8;0;0;8
8544;Raktelis;BITUTĖS;4615337759;Taip;0;9;0;9
8545;Raktelis;BITUTĖS;4962251215;Taip;0;10;0;10
8546;Raktelis;BITUTĖS;8282429202;Taip;9;0;0;9
8547;Raktelis;BORUŽĖLĖS;7068061170;Taip;2;0;1;3
8548;Raktelis;BORUŽĖLĖS;2361477092;Taip;11;1;0;12
8549;Raktelis;BORUŽĖLĖS;4226277600;Ne;10;3;0;13
8550;Raktelis;BORUŽĖLĖS;2599670832;Taip;7;0;0;7
8551;Raktelis;BORUŽĖLĖS;1757601091;Taip;7;3;0;10
8552;Raktelis;BORUŽĖLĖS;5865484633;Ne;0;6;0;6
8553;Raktelis;BORUŽĖLĖS;4529213150;Taip;5;0;1;6
8554;Raktelis;BORUŽĖLĖS;4936637343;Taip;3;1;0;4
8555;Raktelis;BORUŽĖLĖS;4333191842;Taip;7;1;1;9
8556;Raktelis;BORUŽĖLĖS;9529797517;Taip;2;0;0;2
8557;Raktelis;BORUŽĖLĖS;1618225282;Taip;6;0;0;6
8558;Raktelis;BORUŽĖLĖS;4442395100;Taip;9;2;0;11
8559;Raktelis;BORUŽĖLĖS;5150954686;Taip;15;0;2;17
8560;Raktelis;BORUŽĖLĖS;3490428062;Taip;10;3;0;13
8561;Raktelis;BORUŽĖLĖS;5404673733;Taip;0;4;0;4
8562;Raktelis;BORUŽĖLĖS;1314972335;Taip;0;9;0;9
8563;Raktelis;BORUŽĖLĖS;3343352568;Taip;1;2;8;11
8564;Raktelis;BORUŽĖLĖS;2698820718;Taip;13;5;0;18
8565;Raktelis;BORUŽĖLĖS;7990626447;Taip;4;5;0;9
8566;Raktelis;BORUŽĖLĖS;7459272209;Taip;3;0;0;3
8567;Raktelis;BORUŽĖLĖS;5046450478;Taip;6;0;0;6
8568;Raktelis;BORUŽĖLĖS;8385770827;Taip;0;2;0;2
8569;Raktelis;BORUŽĖLĖS;1141447274;Ne;9;6;0;15
8570;Raktelis;BORUŽĖLĖS;3456093273;Ne;7;0;0;7
8571;Raktelis;BORUŽĖLĖS;5576511314;Taip;15;5;0;20
8572;Raktelis;KAČIUKAI;5270430511;Taip;7;2;0;9
8573;Raktelis;KAČIUKAI;4622683599;Taip;0;0;2;2
8574;Raktelis;KAČIUKAI;8600632097;Taip;0;4;0;4
8575;Raktelis;KAČIUKAI;7630501672;Taip;0;4;0;4
8576;Raktelis;KAČIUKAI;6007823584;Taip;8;2;0;10
8577;Raktelis;KAČIUKAI;3733786043;Taip;4;0;0;4
8578;Raktelis;KAČIUKAI;8456082594;Taip;0;7;0;7
8579;Raktelis;KAČIUKAI;4676213966;Taip;3;0;0;3
8580;Raktelis;KAČIUKAI;4631375439;Taip;0;6;0;6
8581;Raktelis;KAČIUKAI;6265489540;Taip;7;5;0;12
8582;Raktelis;KAČIUKAI;4160091258;Taip;12;3;0;15
8583;Raktelis;KAČIUKAI;3775306030;Taip;6;0;0;6
8584;Raktelis;KAČIUKAI;6550851582;Taip;8;3;0;11
8585;Raktelis;KAČIUKAI;4009105487;Taip;5;0;3;8
8586;Raktelis;KAČIUKAI;1843086151;Ne;1;1;0;2
8587;Raktelis;KAČIUKAI;1983808547;Taip;8;0;0;8
8588;Raktelis;KAČIUKAI;5042538956;Taip;0;5;0;5
8589;Raktelis;KAČIUKAI;7260767942;Taip;8;1;0;9
8590;Raktelis;KAČIUKAI;6323223256;Taip;0;1;0;1
8591;Raktelis;KAČIUKAI;1123693990;Taip;10;7;0;17
8592;Raktelis;KAČIUKAI;4979657165;Taip;0;21;0;21
8593;Raktelis;KIŠKUČIAI;9390692206;Taip;16;0;0;16
8594;Raktelis;KIŠKUČIAI;7847787737;Taip;5;0;0;5
8595;Raktelis;KIŠKUČIAI;7046291082;Taip;0;0;2;2
8596;Raktelis;KIŠKUČIAI;2278227649;Taip;17;0;0;17
8597;Raktelis;KIŠKUČIAI;8992797384;Taip;4;3;1;8
8598;Raktelis;KIŠKUČIAI;9803505110;Taip;14;0;1;15
8599;Raktelis;KIŠKUČIAI;6473692639;Taip;4;0;2;6
8600;Raktelis;KIŠKUČIAI;1668164327;Taip;4;0;2;6
8601;Raktelis;KIŠKUČIAI;6587878165;Taip;0;1;0;1
8602;Raktelis;KIŠKUČIAI;9169797346;Taip;1;0;1;2
8603;Raktelis;KIŠKUČIAI;2262854947;Taip;3;0;0;3
8604;Raktelis;KIŠKUČIAI;3493159224;Taip;2;0;0;2
8605;Raktelis;KIŠKUČIAI;7605822626;Taip;15;0;0;15
8606;Raktelis;NYKŠTUKAI;7865593006;Ne;9;0;0;9
8607;Raktelis;NYKŠTUKAI;7058612493;Taip;6;0;0;6
8608;Raktelis;NYKŠTUKAI;8817859592;Taip;15;0;0;15
8609;Raktelis;NYKŠTUKAI;4578445282;Taip;0;5;0;5
8610;Raktelis;NYKŠTUKAI;9164539135;Taip;9;1;0;10
8611;Raktelis;NYKŠTUKAI;4147382341;Taip;15;0;0;15
8612;Raktelis;NYKŠTUKAI;3968555691;Taip;8;8;0;16
8613;Raktelis;NYKŠTUKAI;8507551381;Taip;2;0;0;2
8614;Raktelis;NYKŠTUKAI;4764915486;Taip;11;0;0;11
8615;Raktelis;NYKŠTUKAI;4765483387;Taip;12;0;0;12
8616;Raktelis;NYKŠTUKAI;9114203596;Ne;13;0;0;13
8617;Raktelis;NYKŠTUKAI;2803146830;Taip;20;0;0;20
8618;Raktelis;NYKŠTUKAI;1002851704;Taip;8;1;0;9
8619;Raktelis;NYKŠTUKAI;7202523804;Taip;0;5;0;5
8620;Raktelis;PELIUKAI;9599034285;Taip;3;0;0;3
8621;Raktelis;PELIUKAI;1604357851;Taip;9;7;0;16
8622;Raktelis;PELIUKAI;6393143566;Ne;0;5;0;5
8623;Raktelis;PELIUKAI;4014822452;Taip;4;0;0;4
8624;Raktelis;PELIUKAI;5758873229;Taip;0;5;0;5
8625;Raktelis;PELIUKAI;4502236264;Ne;20;0;0;20
8626;Raktelis;PELIUKAI;2754009962;Taip;15;0;0;15
8627;Raktelis;PELIUKAI;3311870918;Taip;4;1;0;5
8628;Raktelis;PELIUKAI;6826993779;Taip;4;1;0;5
8629;Raktelis;PELIUKAI;2301442262;Taip;16;0;1;17
8630;Raktelis;PELIUKAI;6853881405;Taip;10;0;0;10
8631;Raktelis;PELIUKAI;1120263625;Taip;2;4;0;6
8632;Raktelis;PELIUKAI;9983004779;Ne;3;0;0;3
8633;Raktelis;PELIUKAI;7389910330;Taip;9;0;0;9
8634;Raktelis;AGUONOS;6102196040;Taip;5;1;0;6
8635;Raktelis;AGUONOS;1622504968;Taip;5;0;0;5
8636;Raktelis;AGUONOS;6199212999;Taip;0;4;0;4
8637;Raktelis;AGUONOS;7334310944;Taip;5;4;0;9
8638;Raktelis;AGUONOS;6281687751;Taip;0;3;0;3
8639;Raktelis;AGUONOS;1975411457;Taip;15;2;0;17
8640;Raktelis;AGUONOS;6367875352;Taip;6;0;3;9
8641;Raktelis;AGUONOS;7170546710;Taip;13;4;0;17
8642;Raktelis;AGUONOS;4905982507;Taip;0;3;0;3
8643;Raktelis;AGUONOS;9779789133;Taip;5;1;0;6
8644;Raktelis;AGUONOS;9593639791;Taip;11;3;0;14
8645;Raktelis;AGUONOS;1392036584;Ne;0;11;0;11
8646;Raktelis;AGUONOS;6608224825;Taip;7;5;0;12
8647;Raktelis;AGUONOS;4658530212;Ne;6;2;0;8
8648;Raktelis;AGUONOS;4335378625;Taip;18;0;0;18
8649;Raktelis;AGUONOS;8873203690;Ne;5;1;2;8
8650;Raktelis;AGUONOS;9357757604;Taip;15;1;0;16
8651;Raktelis;AGUONOS;8459980712;Taip;0;3;0;3
8652;Raktelis;AGUONOS;7973137015;Taip;5;4;0;9
8653;Raktelis;AGUONOS;9591285702;Taip;12;1;0;13
8654;Raktelis;AGUONOS;8767785444;Taip;3;6;0;9
8655;Raktelis;AGUONOS;9355380341;Taip;0;1;0;1
8656;Raktelis;AGUONOS;2289954824;Taip;0;0;1;1
8657;Raktelis;LAPIUKŲ;6894769625;Taip;19;0;0;19
8658;Raktelis;LAPIUKŲ;9048412613;Taip;2;0;0;2
8659;Raktelis;LAPIUKŲ;3380295375;Ne;0;8;0;8
8660;Raktelis;LAPIUKŲ;7142823740;Taip;0;7;0;7
8661;Raktelis;LAPIUKŲ;3395720463;Taip;0;14;0;14
8662;Raktelis;LAPIUKŲ;4167194960;Taip;1;0;0;1
8663;Raktelis;LAPIUKŲ;2809458453;Taip;0;6;0;6
8664;Raktelis;LAPIUKŲ;2967941870;Taip;3;2;0;5
8665;Raktelis;LAPIUKŲ;6892006495;Taip;5;7;0;12
8666;Raktelis;LAPIUKŲ;3884068578;Taip;0;5;0;5
8667;Raktelis;LAPIUKŲ;4755892641;Taip;10;4;0;14
8668;Raktelis;LAPIUKŲ;7440866459;Taip;5;0;0;5
8669;Raktelis;LAPIUKŲ;3517484891;Taip;10;0;0;10
8670;Raktelis;LAPIUKŲ;6822021176;Taip;14;0;0;14
8671;Raktelis;LAPIUKŲ;8146076115;Taip;0;1;0;1
8672;Raktelis;LAPIUKŲ;4353473162;Ne;3;0;0;3
8673;Raktelis;LAPIUKŲ;8700012974;Taip;0;1;0;1
8674;Raktelis;LAPIUKŲ;1263150004;Taip;5;1;0;6
8675;Raktelis;LAPIUKŲ;1445359221;Taip;4;2;0;6
8676;Raktelis;LAPIUKŲ;9497620710;Taip;8;0;0;8
8677;Raktelis;PELĖDŽIUKAI;5275588088;Taip;0;5;0;5
8678;Raktelis;PELĖDŽIUKAI;54341630847;Taip;0;4;0;4
8679;Raktelis;PELĖDŽIUKAI;8320696048;Taip;0;1;0;1
8680;Raktelis;PELĖDŽIUKAI;67304194087;Taip;0;3;0;3
8681;Raktelis;PELĖDŽIUKAI;2753402906;Taip;0;3;0;3
8682;Raktelis;PELĖDŽIUKAI;5768653399;Taip;14;1;0;15
8683;Raktelis;PELĖDŽIUKAI;7962509432;Taip;0;8;0;8
8684;Raktelis;PELĖDŽIUKAI;9053427316;Taip;0;2;0;2
8685;Raktelis;PELĖDŽIUKAI;9716191639;Taip;6;0;1;7
8686;Raktelis;PELĖDŽIUKAI;8869030487;Taip;23;0;0;23
8687;Raktelis;PELĖDŽIUKAI;1322912585;Taip;10;7;0;17
8688;Raktelis;PELĖDŽIUKAI;9130613710;Ne;0;7;0;7
8689;Raktelis;PELĖDŽIUKAI;9151796053;Taip;2;0;0;2
8690;Raktelis;PELĖDŽIUKAI;2282754345;Taip;0;2;0;2
8691;Raktelis;PELĖDŽIUKAI;8207675881;Taip;0;3;0;3
8692;Raktelis;PELĖDŽIUKAI;5925441742;Taip;0;4;0;4
8693;Raktelis;PELĖDŽIUKAI;5082785025;Taip;0;0;4;4
8694;Raktelis;MEŠKIUKAI;6703168910;Taip;13;1;1;15
8695;Raktelis;MEŠKIUKAI;8851021346;Taip;3;0;0;3
8696;Raktelis;MEŠKIUKAI;4185763817;Taip;8;2;0;10
8697;Raktelis;MEŠKIUKAI;6685891017;Taip;7;3;0;10
8698;Raktelis;MEŠKIUKAI;3484991718;Taip;9;0;0;9
8699;Raktelis;MEŠKIUKAI;6855863189;Taip;1;2;3;6
8700;Raktelis;MEŠKIUKAI;1026592738;Taip;0;4;0;4
8701;Raktelis;MEŠKIUKAI;7900644404;Taip;18;0;0;18
8702;Raktelis;MEŠKIUKAI;9718355271;Taip;7;3;0;10
8703;Raktelis;MEŠKIUKAI;2171952119;Taip;6;0;0;6
8704;Raktelis;MEŠKIUKAI;6358227532;Taip;17;0;2;19
8705;Raktelis;MEŠKIUKAI;8608093349;Taip;5;3;0;8
8706;Rasa;Nykštukai;5176175108;Taip;0;1;11;12
8707;Rasa;Nykštukai;3979273111;Taip;0;9;0;9
8708;Rasa;Nykštukai;4847544355;Taip;5;4;0;9
8709;Rasa;Nykštukai;9723040721;Taip;0;5;0;5
8710;Rasa;Nykštukai;7004232909;Taip;0;5;4;9
8711;Rasa;Nykštukai;1223962374;Taip;0;0;4;4
8712;Rasa;Nykštukai;3200377629;Taip;3;3;0;6
8713;Rasa;Nykštukai;1336291828;Taip;0;2;0;2
8714;Rasa;Nykštukai;5861229664;Taip;0;3;0;3
8715;Rasa;Nykštukai;1386880644;Taip;6;2;2;10
8716;Rasa;Nykštukai;2093263887;Taip;0;0;1;1
8717;Rasa;Nykštukai;2540124793;Taip;0;2;3;5
8718;Rasa;Nykštukai;5363748728;Taip;0;4;0;4
8719;Rasa;Nykštukai;2977737634;Taip;2;0;0;2
8720;Rasa;Nykštukai;8310400946;Taip;5;1;0;6
8721;Rasa;Nykštukai;7520665472;Taip;0;10;0;10
8722;Rasa;Nykštukai;7534306402;Taip;15;0;0;15
8723;Rasa;Nykštukai;7326816081;Ne;0;0;2;2
8724;Rasa;Nykštukai;5864894208;Ne;0;0;2;2
8725;Rasa;Meškiukai;8378755600;Taip;3;0;10;13
8726;Rasa;Meškiukai;3073804713;Taip;0;0;3;3
8727;Rasa;Meškiukai;6691161322;Taip;0;0;1;1
8728;Rasa;Meškiukai;8740659600;Taip;13;10;0;23
8729;Rasa;Meškiukai;6874601830;Taip;10;8;0;18
8730;Rasa;Meškiukai;4127921417;Taip;0;0;10;10
8731;Rasa;Meškiukai;7357915584;Taip;5;5;5;15
8732;Rasa;Meškiukai;8314522373;Taip;0;0;7;7
8733;Rasa;Meškiukai;3548008659;Taip;0;23;0;23
8734;Rasa;Meškiukai;3773600344;Taip;14;0;1;15
8735;Rasa;Meškiukai;2371282781;Taip;14;0;1;15
8736;Rasa;Meškiukai;2555108465;Taip;0;0;3;3
8737;Rasa;Meškiukai;1992726664;Taip;10;0;3;13
8738;Rasa;Meškiukai;7843789214;Taip;4;0;1;5
8739;Rasa;Meškiukai;5165588335;Taip;1;0;0;1
8740;Rasa;Meškiukai;7637404588;Taip;2;3;0;5
8741;Rasa;Meškiukai;7502435359;Taip;0;5;5;10
8742;Rasa;Meškiukai;6853285570;Ne;0;2;2;4
8743;Rasa;Sauliukai;72772661373;Taip;0;0;3;3
8744;Rasa;Sauliukai;6879558965;Taip;0;18;0;18
8745;Rasa;Sauliukai;6356448094;Taip;0;4;0;4
8746;Rasa;Sauliukai;2683897055;Taip;0;5;0;5
8747;Rasa;Sauliukai;2982016133;Ne;0;10;0;10
8748;Rasa;Sauliukai;7534548604;Taip;0;3;0;3
8749;Rasa;Sauliukai;3567565920;Taip;6;3;1;10
8750;Rasa;Sauliukai;4790859112;Taip;0;3;2;5
8751;Rasa;Sauliukai;2110008545;Taip;0;1;0;1
8752;Rasa;Sauliukai;5932187584;Taip;0;8;0;8
8753;Rasa;Sauliukai;4837280374;Ne;13;0;0;13
8754;Rasa;Sauliukai;5145978804;Taip;23;0;0;23
8755;Rasa;Sauliukai;8818450386;Taip;0;0;7;7
8756;Rasa;Sauliukai;6734478649;Taip;0;0;1;1
8757;Rasa;Sauliukai;5606722133;Taip;0;3;0;3
8758;Rasa;Sauliukai;63673920646;Taip;5;3;0;8
8759;Rasa;Sauliukai;8953448462;Taip;0;3;0;3
8760;Rasa;Smalsučiai;5599182715;Taip;0;2;0;2
8761;Rasa;Smalsučiai;9648034081;Taip;2;1;0;3
8762;Rasa;Smalsučiai;2626361958;Taip;15;0;0;15
8763;Rasa;Smalsučiai;7065597550;Taip;9;4;0;13
8764;Rasa;Smalsučiai;2132535297;Taip;0;1;0;1
8765;Rasa;Smalsučiai;8866896989;Ne;0;9;0;9
8766;Rasa;Smalsučiai;9938280570;Taip;0;3;1;4
8767;Rasa;Smalsučiai;1690518970;Taip;0;3;0;3
8768;Rasa;Smalsučiai;3023088027;Ne;0;4;2;6
8769;Rasa;Smalsučiai;4758605343;Taip;0;1;11;12
8770;Rasa;Smalsučiai;3091012313;Taip;6;1;5;12
8771;Rasa;Smalsučiai;7558966891;Ne;5;2;1;8
8772;Rasa;Smalsučiai;6345614521;Taip;0;1;0;1
8773;Rasa;Smalsučiai;1651905746;Taip;0;23;0;23
8774;Rasa;Smalsučiai;1823276800;Taip;0;4;3;7
8775;Rasa;Smalsučiai;6773004268;Taip;8;1;0;9
8776;Rasa;Smalsučiai;5325275053;Ne;0;3;3;6
8777;Rasa;Smalsučiai;2121070882;Ne;0;1;6;7
8778;Rasa;Smalsučiai;6704162447;Taip;0;1;0;1
8779;Rasa;Smalsučiai;4603188598;Taip;8;3;0;11
8780;Rasa;"Pelėdžiukai ";3387615841;Taip;0;3;0;3
8781;Rasa;"Pelėdžiukai ";8674133653;Taip;0;8;0;8
8782;Rasa;"Pelėdžiukai ";8816116600;Taip;10;0;0;10
8783;Rasa;"Pelėdžiukai ";8455168346;Taip;11;0;0;11
8784;Rasa;"Pelėdžiukai ";5141906920;Taip;0;2;0;2
8785;Rasa;"Pelėdžiukai ";1261868339;Taip;5;0;0;5
8786;Rasa;"Pelėdžiukai ";6553479199;Taip;15;0;0;15
8787;Rasa;"Pelėdžiukai ";2968464121;Taip;0;5;5;10
8788;Rasa;"Pelėdžiukai ";5816940902;Ne;3;0;2;5
8789;Rasa;"Pelėdžiukai ";4389917247;Taip;17;0;2;19
8790;Rasa;"Pelėdžiukai ";2123838514;Taip;16;0;1;17
8791;Rasa;"Pelėdžiukai ";1288177637;Taip;9;0;10;19
8792;Rasa;"Pelėdžiukai ";2840437821;Taip;15;0;0;15
8793;Rasa;"Pelėdžiukai ";8403268732;Taip;0;3;0;3
8794;Rasa;Katinėliai;5885520521;Taip;10;0;0;10
8795;Rasa;Katinėliai;5426981046;Taip;0;5;0;5
8796;Rasa;Katinėliai;3657956842;Ne;0;0;1;1
8797;Rasa;Katinėliai;6891623055;Ne;7;0;1;8
8798;Rasa;Katinėliai;9010812748;Taip;0;4;0;4
8799;Rasa;Katinėliai;7220007488;Taip;0;4;0;4
8800;Rasa;Katinėliai;8235869241;Taip;0;1;0;1
8801;Rasa;Katinėliai;4913483444;Taip;0;3;1;4
8802;Rasa;Katinėliai;4734775151;Ne;8;1;0;9
8803;Rasa;Katinėliai;4758138905;Taip;5;0;0;5
8804;Rasa;Katinėliai;9447346901;Taip;6;3;0;9
8805;Rasa;Katinėliai;3631124501;Taip;15;1;0;16
8806;Rasa;Katinėliai;9343039995;Ne;0;3;1;4
8807;Rasa;Katinėliai;4498966097;Taip;0;2;0;2
8808;Rasa;Katinėliai;3428261829;Taip;0;9;0;9
8809;Rasa;Katinėliai;2477057223;Taip;0;3;2;5
8810;Rasa;Katinėliai;5134342817;Taip;0;4;0;4
8811;Rasa;Ančiukai;6755131948;Taip;12;6;1;19
8812;Rasa;Ančiukai;1477018184;Taip;13;0;0;13
8813;Rasa;Ančiukai;4018241056;Taip;0;4;0;4
8814;Rasa;Ančiukai;1736903037;Taip;10;4;0;14
8815;Rasa;Ančiukai;4762348187;Taip;8;0;1;9
8816;Rasa;Ančiukai;7568880413;Taip;0;0;1;1
8817;Rasa;Ančiukai;8622210603;Taip;7;0;4;11
8818;Rasa;Ančiukai;1521328997;Taip;0;6;1;7
8819;Rasa;Ančiukai;3884782148;Taip;15;0;1;16
8820;Rasa;Ančiukai;9230334839;Ne;3;0;3;6
8821;Rasa;Ančiukai;8574946856;Taip;5;1;3;9
8822;Rasa;Ančiukai;6442933249;Taip;11;3;3;17
8823;Rasa;"Vyturiukai ";7028605422;Taip;4;0;5;9
8824;Rasa;"Vyturiukai ";9599510902;Taip;2;0;1;3
8825;Rasa;"Vyturiukai ";2800420481;Taip;0;2;0;2
8826;Rasa;"Vyturiukai ";5869253167;Taip;11;0;0;11
8827;Rasa;"Vyturiukai ";7037958994;Taip;3;3;0;6
8828;Rasa;"Vyturiukai ";8236785255;Taip;4;4;2;10
8829;Rasa;"Vyturiukai ";6887471189;Taip;0;1;1;2
8830;Rasa;"Vyturiukai ";9668538340;Taip;0;0;1;1
8831;Rasa;"Vyturiukai ";4694111253;Taip;0;1;0;1
8832;Rasa;"Vyturiukai ";2347639286;Taip;0;0;5;5
8833;Rasa;"Vyturiukai ";1206005039;Taip;7;3;0;10
8834;Rasa;"Vyturiukai ";9788282861;Taip;0;3;0;3
8835;Rasa;"Vyturiukai ";2711923397;Taip;0;2;2;4
8836;Rasa;"Vyturiukai ";2769096357;Taip;12;0;0;12
8837;Rasa;"Vyturiukai ";6883073764;Taip;0;0;14;14
8838;Rasa;"Vyturiukai ";9706428782;Ne;0;3;2;5
8839;Rasa;"Vyturiukai ";7043271718;Ne;0;0;6;6
8840;Rasa;"Vyturiukai ";6575864256;Taip;13;0;0;13
8841;Rasa;Voveriukai;4111850024;Taip;7;0;1;8
8842;Rasa;Voveriukai;2190948879;Taip;8;5;2;15
8843;Rasa;Voveriukai;1978999728;Ne;0;0;5;5
8844;Rasa;Voveriukai;3546684695;Taip;7;0;2;9
8845;Rasa;Voveriukai;5740754301;Taip;0;0;1;1
8846;Rasa;Voveriukai;5977524939;Taip;0;0;3;3
8847;Rasa;Voveriukai;1592174114;Taip;0;6;10;16
8848;Rasa;Voveriukai;1564194649;Taip;5;0;1;6
8849;Rasa;Voveriukai;1764959761;Taip;0;0;3;3
8850;Rasa;Voveriukai;1765617605;Taip;0;0;7;7
8851;Rasa;Voveriukai;1733179752;Taip;1;8;0;9
8852;Rasa;Voveriukai;2895124729;Ne;0;6;0;6
8853;Rasa;Voveriukai;8469342353;Taip;5;0;0;5
8854;Rasa;Voveriukai;1679709767;Taip;0;3;0;3
8855;Rasa;Voveriukai;5622110823;Ne;0;4;1;5
8856;Rasa;Voveriukai;6221754830;Taip;0;2;0;2
8857;Rasa;Voveriukai;7218250981;Taip;0;17;0;17
8858;Rasa;"DRUGELIAI ";6621628020;Taip;23;0;1;24
8859;Rasa;"DRUGELIAI ";9959160342;Taip;23;0;1;24
8860;Rasa;"DRUGELIAI ";5761013588;Taip;5;0;10;15
8861;Rasa;"DRUGELIAI ";7220103314;Taip;0;0;2;2
8862;Rasa;"DRUGELIAI ";5517138335;Taip;17;4;0;21
8863;Rasa;"DRUGELIAI ";9506388242;Taip;0;11;2;13
8864;Rasa;"DRUGELIAI ";4188303400;Taip;10;0;1;11
8865;Rasa;"DRUGELIAI ";5483943978;Taip;6;0;15;21
8866;Rasa;"DRUGELIAI ";7251815682;Taip;23;0;1;24
8867;Rasa;"DRUGELIAI ";8702962863;Taip;0;1;5;6
8868;Rasa;"DRUGELIAI ";6291089659;Taip;0;0;6;6
8869;Rasa;"DRUGELIAI ";4183378344;Ne;3;0;1;4
8870;Rasa;"DRUGELIAI ";6314411900;Ne;3;0;1;4
8871;Rasa;Zuikučiai;7265752821;Taip;5;0;7;12
8872;Rasa;Zuikučiai;2804115700;Ne;7;0;0;7
8873;Rasa;Zuikučiai;8841534992;Taip;0;2;0;2
8874;Rasa;Zuikučiai;8027532547;Taip;12;2;4;18
8875;Rasa;Zuikučiai;3470054190;Ne;6;0;4;10
8876;Rasa;Zuikučiai;8180141204;Taip;4;0;0;4
8877;Rasa;Zuikučiai;7253736220;Taip;3;4;4;11
8878;Rasa;Zuikučiai;4940758709;Taip;0;14;0;14
8879;Rasa;Zuikučiai;7091899236;Taip;11;6;1;18
8880;Rasa;Zuikučiai;6574998939;Taip;34;0;0;34
8881;Rasa;Zuikučiai;7556723960;Taip;33;0;0;33
8882;Rasa;Zuikučiai;4212798846;Taip;0;0;4;4
8883;Rasa;Zuikučiai;7585566403;Taip;0;1;1;2
8884;Rasa;Zuikučiai;6505001743;Taip;6;2;3;11
8885;Rasa;Zuikučiai;6780996150;Taip;8;0;5;13
8886;Rasa;Širdelė;8424049317;Taip;5;1;0;6
8887;Rasa;Širdelė;8236464670;Taip;0;8;0;8
8888;Rasa;Širdelė;6976298054;Taip;0;1;0;1
8889;Rasa;Širdelė;3668598028;Taip;0;3;0;3
8890;Rasa;Širdelė;2333938367;Taip;0;10;0;10
8891;Rasa;Širdelė;5719253028;Taip;13;0;0;13
8892;Rasa;Širdelė;9140875020;Ne;10;3;0;13
8893;Rasa;Širdelė;5710220699;Taip;0;1;0;1
8894;Rasa;Širdelė;4694382836;Taip;14;0;0;14
8895;Rasa;Širdelė;1796573723;Taip;0;6;0;6
8896;Rasa;Širdelė;3535655117;Taip;0;6;0;6
8897;Rasa;Širdelė;2830296197;Taip;2;0;0;2
8898;Rasa;Širdelė;4361959446;Taip;0;1;2;3
8899;Rasa;Širdelė;3215464914;Taip;7;0;0;7
8900;Rasa;Širdelė;5523764310;Taip;11;0;3;14
8901;Rasa;Širdelė;6760723624;Taip;8;3;2;13
8902;Rasa;Širdelė;6606982242;Taip;0;3;0;3
8903;Rasa;Širdelė;1447258806;Taip;5;0;0;5
8904;Rasa;Širdelė;1627996663;Taip;8;2;0;10
8905;Riešutėlis;Viščiukų;7071757771;Taip;0;0;3;3
8906;Riešutėlis;Viščiukų;6626441225;Taip;8;6;0;14
8907;Riešutėlis;Viščiukų;5013456470;Ne;10;0;0;10
8908;Riešutėlis;Viščiukų;6906373822;Taip;19;3;0;22
8909;Riešutėlis;Viščiukų;2734001106;Taip;5;0;0;5
8910;Riešutėlis;Viščiukų;2493171003;Taip;3;1;0;4
8911;Riešutėlis;Viščiukų;5133625078;Taip;5;1;0;6
8912;Riešutėlis;Viščiukų;2235912189;Taip;1;0;3;4
8913;Riešutėlis;Viščiukų;9864636983;Taip;13;0;0;13
8914;Riešutėlis;Viščiukų;5317904812;Taip;0;0;10;10
8915;Riešutėlis;Viščiukų;8235524536;Taip;0;1;0;1
8916;Riešutėlis;Viščiukų;2832538856;Taip;0;23;0;23
8917;Riešutėlis;Viščiukų;3730909181;Taip;5;0;0;5
8918;Riešutėlis;"Riešutėliai ";3800733442;Taip;13;1;0;14
8919;Riešutėlis;"Riešutėliai ";2117939721;Taip;3;0;0;3
8920;Riešutėlis;"Riešutėliai ";1343776985;Taip;8;0;2;10
8921;Riešutėlis;"Riešutėliai ";5915019363;Taip;0;0;9;9
8922;Riešutėlis;"Riešutėliai ";2207907790;Taip;7;1;0;8
8923;Riešutėlis;"Riešutėliai ";9699503472;Taip;7;0;0;7
8924;Riešutėlis;"Riešutėliai ";2098369052;Taip;3;0;4;7
8925;Riešutėlis;"Riešutėliai ";1426700414;Taip;0;0;9;9
8926;Riešutėlis;"Riešutėliai ";8539906445;Taip;0;1;0;1
8927;Riešutėlis;"Riešutėliai ";5873443383;Taip;12;0;1;13
8928;Riešutėlis;"Riešutėliai ";2301247729;Taip;0;6;2;8
8929;Riešutėlis;"Riešutėliai ";3602707130;Taip;5;1;0;6
8930;Riešutėlis;"Riešutėliai ";8991963843;Taip;3;2;0;5
8931;Riešutėlis;"Riešutėliai ";4293402095;Taip;13;2;3;18
8932;Riešutėlis;"Riešutėliai ";8917451081;Taip;5;3;0;8
8933;Riešutėlis;"Riešutėliai ";4698338374;Taip;10;3;0;13
8934;Riešutėlis;"Riešutėliai ";3345064565;Taip;15;0;0;15
8935;Riešutėlis;"Riešutėliai ";2560507294;Taip;0;0;1;1
8936;Riešutėlis;"Riešutėliai ";9078282526;Taip;0;0;2;2
8937;Riešutėlis;"Riešutėliai ";6762306583;Taip;14;2;0;16
8938;Riešutėlis;Ežiukai;7030346495;Taip;0;15;0;15
8939;Riešutėlis;Ežiukai;9750713954;Taip;1;3;0;4
8940;Riešutėlis;Ežiukai;7601776182;Taip;0;1;0;1
8941;Riešutėlis;Ežiukai;7381623086;Ne;4;1;0;5
8942;Riešutėlis;Ežiukai;9964688413;Taip;7;1;0;8
8943;Riešutėlis;Ežiukai;1548585448;Taip;5;0;1;6
8944;Riešutėlis;Ežiukai;8954127616;Ne;5;1;3;9
8945;Riešutėlis;Ežiukai;2092933906;Taip;0;8;0;8
8946;Riešutėlis;Ežiukai;6813024366;Taip;1;4;0;5
8947;Riešutėlis;Ežiukai;7913381005;Taip;3;4;0;7
8948;Riešutėlis;Ežiukai;8480059272;Taip;0;4;0;4
8949;Riešutėlis;Ežiukai;5728858361;Taip;3;2;1;6
8950;Riešutėlis;Ežiukai;5327627748;Taip;5;0;0;5
8951;Riešutėlis;Ežiukai;6259158270;Taip;0;0;11;11
8952;Riešutėlis;Ežiukai;6194259707;Taip;0;4;0;4
8953;Riešutėlis;Ežiukai;2837471235;Taip;0;16;0;16
8954;Riešutėlis;Ežiukai;2699984170;Taip;0;8;0;8
8955;Riešutėlis;Ežiukai;7050440691;Taip;23;0;0;23
8956;Riešutėlis;Ežiukai;3577669231;Taip;15;3;0;18
8957;Riešutėlis;Ežiukai;9670912357;Ne;10;0;0;10
8958;Riešutėlis;Ežiukai;1818130297;Taip;0;3;0;3
8959;Riešutėlis;Ežiukai;6284614328;Taip;0;10;0;10
8960;Riešutėlis;Pelėdžiukai;3975540383;Taip;4;0;0;4
8961;Riešutėlis;Pelėdžiukai;1705599429;Taip;6;3;3;12
8962;Riešutėlis;Pelėdžiukai;4116506453;Taip;0;0;5;5
8963;Riešutėlis;Pelėdžiukai;2467739101;Taip;5;0;0;5
8964;Riešutėlis;Pelėdžiukai;2587460110;Taip;9;0;6;15
8965;Riešutėlis;Pelėdžiukai;6147780439;Taip;5;0;0;5
8966;Riešutėlis;Pelėdžiukai;3287685792;Taip;5;0;2;7
8967;Riešutėlis;Pelėdžiukai;1811701628;Taip;14;0;2;16
8968;Riešutėlis;Pelėdžiukai;5183264581;Taip;6;0;1;7
8969;Riešutėlis;Pelėdžiukai;4866613045;Taip;0;11;0;11
8970;Riešutėlis;Pelėdžiukai;6121386391;Taip;6;0;2;8
8971;Riešutėlis;Pelėdžiukai;4448024452;Taip;5;0;0;5
8972;Riešutėlis;Pelėdžiukai;3251066115;Taip;5;4;0;9
8973;Riešutėlis;Pelėdžiukai;4808684145;Taip;5;5;0;10
8974;Riešutėlis;Pelėdžiukai;4897581681;Taip;11;0;2;13
8975;Riešutėlis;Pelėdžiukai;7256075146;Taip;0;3;0;3
8976;Riešutėlis;Pelėdžiukai;5443448616;Taip;0;4;0;4
8977;Riešutėlis;Pelėdžiukai;9598824163;Taip;0;1;0;1
8978;Riešutėlis;Pelėdžiukai;8839482370;Taip;5;0;0;5
8979;Riešutėlis;Pelėdžiukai;4692384639;Ne;5;0;1;6
8980;Riešutėlis;Meškiukai;5537309549;Taip;6;1;0;7
8981;Riešutėlis;Meškiukai;1091941952;Taip;3;1;0;4
8982;Riešutėlis;Meškiukai;8271632629;Taip;0;0;1;1
8983;Riešutėlis;Meškiukai;4898775561;Taip;0;1;0;1
8984;Riešutėlis;Meškiukai;2097580659;Taip;14;2;0;16
8985;Riešutėlis;Meškiukai;7987368969;Taip;0;9;0;9
8986;Riešutėlis;Meškiukai;65873300738;Taip;4;3;0;7
8987;Riešutėlis;Meškiukai;26781529460;Taip;4;0;1;5
8988;Riešutėlis;Meškiukai;1936519033;Taip;0;5;1;6
8989;Riešutėlis;Meškiukai;4131218911;Taip;0;8;0;8
8990;Riešutėlis;Meškiukai;4276034784;Taip;0;11;0;11
8991;Riešutėlis;Meškiukai;5097410462;Taip;0;3;0;3
8992;Riešutėlis;Meškiukai;4344185375;Taip;0;7;0;7
8993;Riešutėlis;Meškiukai;6594928740;Ne;3;3;0;6
8994;Riešutėlis;Meškiukai;1623681835;Taip;0;1;0;1
8995;Riešutėlis;Meškiukai;2566084613;Taip;6;2;4;12
8996;Riešutėlis;Meškiukai;1640383686;Taip;10;5;0;15
8997;Riešutėlis;Meškiukai;8087180983;Taip;0;3;4;7
8998;Riešutėlis;Meškiukai;16561622902;Taip;5;4;2;11
8999;Riešutėlis;Meškiukai;2611705234;Ne;9;4;0;13
9000;Riešutėlis;Meškiukai;4404544549;Taip;10;7;0;17
9001;Riešutėlis;Meškiukai;1455509576;Ne;0;5;2;7
9002;Riešutėlis;Meškiukai;1709857621;Taip;0;1;0;1
9003;Riešutėlis;Kiškučiai;9297835044;Taip;0;1;0;1
9004;Riešutėlis;Kiškučiai;9086474785;Taip;0;0;8;8
9005;Riešutėlis;Kiškučiai;3363757821;Ne;10;1;0;11
9006;Riešutėlis;Kiškučiai;8445984114;Taip;23;0;0;23
9007;Riešutėlis;Kiškučiai;5266946070;Taip;8;0;7;15
9008;Riešutėlis;Kiškučiai;9357375649;Taip;3;1;0;4
9009;Riešutėlis;Kiškučiai;9548551553;Taip;5;0;0;5
9010;Riešutėlis;Kiškučiai;9500744921;Ne;20;0;0;20
9011;Riešutėlis;Kiškučiai;4851336076;Taip;6;5;2;13
9012;Riešutėlis;Kiškučiai;6705754238;Taip;0;6;0;6
9013;Riešutėlis;Kiškučiai;1111543507;Ne;0;10;0;10
9014;Riešutėlis;Kiškučiai;9964105252;Ne;4;1;0;5
9015;Riešutėlis;Kiškučiai;5846061115;Taip;0;0;1;1
9016;Riešutėlis;Kiškučiai;2618556733;Taip;0;0;4;4
9017;Riešutėlis;Kiškučiai;2674972275;Taip;3;0;1;4
9018;Riešutėlis;Kiškučiai;9995814717;Taip;0;0;2;2
9019;Riešutėlis;Voveriukų;5995176001;Taip;4;4;0;8
9020;Riešutėlis;Voveriukų;5598052531;Ne;0;2;0;2
9021;Riešutėlis;Voveriukų;8751571852;Taip;4;3;1;8
9022;Riešutėlis;Voveriukų;5282039544;Taip;0;0;1;1
9023;Riešutėlis;Voveriukų;6303767779;Taip;13;1;0;14
9024;Riešutėlis;Voveriukų;6405116059;Taip;0;0;2;2
9025;Riešutėlis;Voveriukų;2430518637;Taip;5;1;0;6
9026;Riešutėlis;Voveriukų;1457008581;Taip;0;2;0;2
9027;Riešutėlis;Voveriukų;1638021880;Taip;6;4;0;10
9028;Riešutėlis;Voveriukų;7225365172;Taip;7;1;0;8
9029;Riešutėlis;Voveriukų;5479780116;Taip;5;0;0;5
9030;Riešutėlis;Voveriukų;4451419273;Ne;5;12;0;17
9031;Riešutėlis;Voveriukų;9040123535;Taip;5;1;0;6
9032;Riešutėlis;Voveriukų;6928558714;Taip;9;0;0;9
9033;Riešutėlis;Voveriukų;3970874098;Taip;7;0;0;7
9034;Riešutėlis;Voveriukų;8012201566;Taip;5;1;0;6
9035;Riešutėlis;Voveriukų;4581184004;Taip;13;0;0;13
9036;Riešutėlis;Voveriukų;1941869661;Ne;0;4;0;4
9037;Riešutėlis;Voveriukų;9023304543;Taip;0;3;0;3
9038;Riešutėlis;Saulutės;4004669930;Taip;0;3;0;3
9039;Riešutėlis;Saulutės;7177632315;Taip;0;4;0;4
9040;Riešutėlis;Saulutės;6721758785;Taip;0;2;0;2
9041;Riešutėlis;Saulutės;3694146893;Taip;0;3;0;3
9042;Riešutėlis;Saulutės;1748151109;Taip;5;0;0;5
9043;Riešutėlis;Saulutės;8738716660;Taip;0;1;0;1
9044;Riešutėlis;Saulutės;4828635362;Taip;10;0;0;10
9045;Riešutėlis;Saulutės;1196740726;Taip;0;4;0;4
9046;Riešutėlis;Saulutės;8415858895;Taip;0;1;4;5
9047;Riešutėlis;Saulutės;4498718519;Ne;9;1;0;10
9048;Riešutėlis;Saulutės;5753609922;Taip;5;0;0;5
9049;Riešutėlis;Saulutės;1860995033;Taip;0;9;14;23
9050;Riešutėlis;Saulutės;6468871352;Taip;0;0;3;3
9051;Riešutėlis;Saulutės;7154361660;Taip;0;13;0;13
9052;Riešutėlis;Saulutės;8677172126;Taip;0;0;1;1
9053;Riešutėlis;Saulutės;2572642260;Taip;0;0;2;2
9054;Riešutėlis;Saulutės;3544780386;Taip;0;6;5;11
9055;Riešutėlis;"Boruželės ";4118652467;Ne;0;23;0;23
9056;Riešutėlis;"Boruželės ";7663823906;Taip;3;4;0;7
9057;Riešutėlis;"Boruželės ";3249196007;Taip;7;0;1;8
9058;Riešutėlis;"Boruželės ";5336618381;Taip;4;1;0;5
9059;Riešutėlis;"Boruželės ";7327578507;Taip;0;1;0;1
9060;Riešutėlis;"Boruželės ";6368610810;Taip;18;0;0;18
9061;Riešutėlis;"Boruželės ";7313602281;Taip;10;0;0;10
9062;Riešutėlis;"Boruželės ";9815988800;Taip;5;2;0;7
9063;Riešutėlis;"Boruželės ";9296178632;Taip;0;10;0;10
9064;Riešutėlis;"Boruželės ";6681930005;Taip;0;0;3;3
9065;Riešutėlis;"Boruželės ";2352984379;Taip;0;9;2;11
9066;Riešutėlis;"Boruželės ";3152100512;Taip;10;0;0;10
9067;Riešutėlis;"Boruželės ";2238641969;Taip;3;0;0;3
9068;Riešutėlis;"Boruželės ";6217500325;Taip;0;23;0;23
9069;Riešutėlis;"Boruželės ";1058206787;Taip;8;0;0;8
9070;Riešutėlis;"Boruželės ";9198289423;Taip;11;1;0;12
9071;Riešutėlis;"Boruželės ";1282121190;Taip;0;2;1;3
9072;Riešutėlis;"Boruželės ";7259198785;Ne;5;0;2;7
9073;Riešutėlis;"Boruželės ";2875416610;Taip;0;3;0;3
9074;Riešutėlis;"Bitutės ";6092611227;Taip;0;16;0;16
9075;Riešutėlis;"Bitutės ";2459494071;Taip;4;6;1;11
9076;Riešutėlis;"Bitutės ";3931422170;Taip;0;23;0;23
9077;Riešutėlis;"Bitutės ";7608622330;Taip;0;1;0;1
9078;Riešutėlis;"Bitutės ";4591910912;Taip;3;0;0;3
9079;Riešutėlis;"Bitutės ";9285782325;Ne;0;5;0;5
9080;Riešutėlis;"Bitutės ";7473054556;Taip;3;2;1;6
9081;Riešutėlis;"Bitutės ";8996456595;Taip;0;2;0;2
9082;Riešutėlis;"Bitutės ";3475897400;Taip;2;0;1;3
9083;Riešutėlis;"Bitutės ";3592271009;Taip;5;1;0;6
9084;Riešutėlis;"Bitutės ";6815804556;Taip;0;1;0;1
9085;Riešutėlis;"Bitutės ";1626888090;Taip;0;2;0;2
9086;Riešutėlis;"Bitutės ";3348517050;Taip;3;1;0;4
9087;Riešutėlis;"Bitutės ";4358354602;Taip;7;5;0;12
9088;Riešutėlis;Drugelių;8266735624;Taip;0;2;0;2
9089;Riešutėlis;Drugelių;4776231497;Taip;0;2;0;2
9090;Riešutėlis;Drugelių;8578903763;Taip;2;3;0;5
9091;Riešutėlis;Drugelių;7769079730;Taip;0;1;0;1
9092;Riešutėlis;Drugelių;5811657782;Taip;0;1;0;1
9093;Riešutėlis;Drugelių;4221375847;Ne;0;4;3;7
9094;Riešutėlis;Drugelių;8845709386;Taip;0;10;0;10
9095;Riešutėlis;Drugelių;8128352818;Taip;0;7;1;8
9096;Riešutėlis;Drugelių;8180618419;Taip;0;4;0;4
9097;Riešutėlis;Drugelių;5412882446;Taip;0;10;2;12
9098;Riešutėlis;Drugelių;8020533200;Taip;0;2;7;9
9099;Riešutėlis;Drugelių;1164273595;Taip;4;7;0;11
9100;Riešutėlis;Drugelių;3836374000;Taip;0;1;0;1
9101;Riešutėlis;Drugelių;8016820352;Taip;8;1;0;9
9102;Riešutėlis;Drugelių;3975091711;Taip;0;4;0;4
9103;Riešutėlis;Drugelių;2599147931;Taip;0;3;0;3
9104;Riešutėlis;Drugelių;3151689985;Taip;0;2;2;4
9105;Riešutėlis;Nykštukų;1858791074;Taip;21;0;0;21
9106;Riešutėlis;Nykštukų;1006119133;Taip;0;0;1;1
9107;Riešutėlis;Nykštukų;4740516426;Taip;10;0;5;15
9108;Riešutėlis;Nykštukų;3150141050;Taip;10;0;3;13
9109;Riešutėlis;Nykštukų;6580050526;Taip;0;0;3;3
9110;Riešutėlis;Nykštukų;4810919435;Taip;7;0;2;9
9111;Riešutėlis;Nykštukų;2736824231;Taip;12;0;0;12
9112;Riešutėlis;Nykštukų;2378301886;Taip;11;0;0;11
9113;Riešutėlis;Nykštukų;2483793992;Taip;8;1;1;10
9114;Riešutėlis;Nykštukų;5262881964;Taip;0;0;3;3
9115;Riešutėlis;Nykštukų;4328166135;Taip;5;0;0;5
9116;Riešutėlis;Nykštukų;9052991215;Taip;0;11;6;17
9117;Riešutėlis;Nykštukų;6582898708;Taip;6;0;2;8
9118;Riešutėlis;Nykštukų;5078051087;Taip;7;1;1;9
9119;Ramunėlė;SAULUTĖS;3852734401;Taip;0;2;2;4
9120;Ramunėlė;SAULUTĖS;1192743154;Taip;0;7;0;7
9121;Ramunėlė;SAULUTĖS;5714771643;Taip;0;3;0;3
9122;Ramunėlė;SAULUTĖS;1483391590;Taip;0;3;0;3
9123;Ramunėlė;SAULUTĖS;9927068798;Taip;14;0;0;14
9124;Ramunėlė;SAULUTĖS;7219400182;Taip;0;4;0;4
9125;Ramunėlė;SAULUTĖS;3779769727;Taip;0;4;0;4
9126;Ramunėlė;SAULUTĖS;5605444408;Taip;0;2;0;2
9127;Ramunėlė;SAULUTĖS;8912978935;Taip;0;1;0;1
9128;Ramunėlė;SAULUTĖS;9533155706;Taip;6;2;0;8
9129;Ramunėlė;SAULUTĖS;3109623760;Taip;9;0;1;10
9130;Ramunėlė;ŽIBUTĖ;4715809064;Taip;0;2;0;2
9131;Ramunėlė;ŽIBUTĖ;5315953299;Taip;0;1;0;1
9132;Ramunėlė;ŽIBUTĖ;5650659504;Taip;0;3;0;3
9133;Ramunėlė;ŽIBUTĖ;6627399830;Taip;0;2;4;6
9134;Ramunėlė;ŽIBUTĖ;8726443989;Taip;0;2;0;2
9135;Ramunėlė;ŽIBUTĖ;5801760033;Taip;8;3;0;11
9136;Ramunėlė;ŽIBUTĖ;6389008823;Taip;10;4;0;14
9137;Ramunėlė;ŽIBUTĖ;9136437288;Taip;0;7;0;7
9138;Ramunėlė;ŽIBUTĖ;2605941371;Taip;4;3;0;7
9139;Ramunėlė;ŽIBUTĖ;7010828978;Taip;4;3;0;7
9140;Ramunėlė;ŽIBUTĖ;3879563193;Taip;14;3;0;17
9141;Ramunėlė;ŽIBUTĖ;2591052434;Taip;0;7;0;7
9142;Ramunėlė;ŽIBUTĖ;2446375037;Taip;0;5;4;9
9143;Ramunėlė;ŽIBUTĖ;1671759939;Taip;7;0;0;7
9144;Ramunėlė;ŽIBUTĖ;6606802660;Taip;0;4;0;4
9145;Ramunėlė;ŽIBUTĖ;5304803880;Taip;0;1;0;1
9146;Ramunėlė;ŽIBUTĖ;3525444906;Taip;0;11;0;11
9147;Ramunėlė;ŽIBUTĖ;8055844166;Taip;3;2;0;5
9148;Ramunėlė;ŽIRNIUKAI;8942483792;Taip;12;0;0;12
9149;Ramunėlė;ŽIRNIUKAI;9994445948;Taip;4;0;1;5
9150;Ramunėlė;ŽIRNIUKAI;6674467484;Taip;0;17;0;17
9151;Ramunėlė;ŽIRNIUKAI;7593855877;Taip;0;4;1;5
9152;Ramunėlė;ŽIRNIUKAI;2177200537;Taip;4;2;1;7
9153;Ramunėlė;ŽIRNIUKAI;7026935746;Taip;2;0;1;3
9154;Ramunėlė;ŽIRNIUKAI;5581693652;Ne;0;1;0;1
9155;Ramunėlė;ŽIRNIUKAI;4269170508;Taip;4;0;1;5
9156;Ramunėlė;ŽIRNIUKAI;7263195574;Taip;0;0;2;2
9157;Ramunėlė;ŽIRNIUKAI;4076525701;Ne;0;0;7;7
9158;Ramunėlė;ŽIRNIUKAI;4139935502;Taip;7;0;0;7
9159;Ramunėlė;ŽIRNIUKAI;1833069020;Taip;4;2;2;8
9160;Ramunėlė;ŽIRNIUKAI;4875011312;Taip;0;0;3;3
9161;Ramunėlė;ŽIRNIUKAI;4084046207;Taip;20;3;0;23
9162;Ramunėlė;ŽIRNIUKAI;2276657044;Taip;0;0;2;2
9163;Ramunėlė;ŽIRNIUKAI;5017020616;Taip;0;1;0;1
9164;Ramunėlė;ŽIRNIUKAI;6458458913;Taip;0;11;0;11
9165;Ramunėlė;ŽIRNIUKAI;6225605784;Taip;6;2;4;12
9166;Ramunėlė;BITUTĖS;8098492540;Ne;5;8;0;13
9167;Ramunėlė;BITUTĖS;6329943991;Taip;0;12;0;12
9168;Ramunėlė;BITUTĖS;7307307882;Taip;0;14;0;14
9169;Ramunėlė;BITUTĖS;2225787182;Taip;0;3;0;3
9170;Ramunėlė;BITUTĖS;6166192468;Taip;0;3;0;3
9171;Ramunėlė;BITUTĖS;5865482869;Taip;0;17;0;17
9172;Ramunėlė;BITUTĖS;8940763540;Ne;3;14;0;17
9173;Ramunėlė;BITUTĖS;6843262303;Taip;0;0;1;1
9174;Ramunėlė;BITUTĖS;7692958269;Taip;0;0;4;4
9175;Ramunėlė;BITUTĖS;9789690425;Taip;0;11;0;11
9176;Ramunėlė;BITUTĖS;1182350830;Taip;4;0;0;4
9177;Ramunėlė;BITUTĖS;6342801407;Taip;17;0;0;17
9178;Ramunėlė;BITUTĖS;4022818032;Taip;8;3;0;11
9179;Ramunėlė;BITUTĖS;7220407572;Taip;0;14;0;14
9180;Ramunėlė;BITUTĖS;1916520056;Taip;5;8;0;13
9181;Ramunėlė;BITUTĖS;2245564567;Taip;0;2;3;5
9182;Ramunėlė;BITUTĖS;6870110390;Taip;0;2;3;5
9183;Ramunėlė;BITUTĖS;6892481929;Taip;0;9;0;9
9184;Ramunėlė;BITUTĖS;2558296296;Taip;10;0;1;11
9185;Ramunėlė;BITUTĖS;6881228078;Taip;6;6;0;12
9186;Ramunėlė;DRUGELIAI;9584620339;Taip;0;3;0;3
9187;Ramunėlė;DRUGELIAI;6930505887;Taip;9;2;0;11
9188;Ramunėlė;DRUGELIAI;8402889872;Taip;0;3;1;4
9189;Ramunėlė;DRUGELIAI;7228065409;Taip;6;3;0;9
9190;Ramunėlė;DRUGELIAI;5170325023;Taip;0;6;0;6
9191;Ramunėlė;DRUGELIAI;3617897977;Taip;0;0;3;3
9192;Ramunėlė;DRUGELIAI;8768539595;Taip;0;8;0;8
9193;Ramunėlė;DRUGELIAI;7955507702;Taip;0;0;1;1
9194;Ramunėlė;DRUGELIAI;1078618047;Taip;0;18;0;18
9195;Ramunėlė;DRUGELIAI;2555810841;Taip;0;1;0;1
9196;Ramunėlė;DRUGELIAI;9984243153;Taip;9;2;0;11
9197;Ramunėlė;DRUGELIAI;4392309015;Taip;0;0;6;6
9198;Ramunėlė;DRUGELIAI;5049415445;Taip;14;0;1;15
9199;Ramunėlė;DRUGELIAI;8460527225;Taip;0;7;0;7
9200;Ramunėlė;DRUGELIAI;1800967823;Taip;2;0;0;2
9201;Ramunėlė;DRUGELIAI;8205893352;Taip;0;1;0;1
9202;Ramunėlė;DRUGELIAI;6809164145;Taip;2;2;4;8
9203;Ramunėlė;DRUGELIAI;6837877393;Ne;5;0;0;5
9204;Ramunėlė;NEUŽMIRŠTUOLĖS;1797997937;Taip;6;0;0;6
9205;Ramunėlė;NEUŽMIRŠTUOLĖS;9326288662;Taip;0;1;0;1
9206;Ramunėlė;NEUŽMIRŠTUOLĖS;4756689520;Taip;12;2;0;14
9207;Ramunėlė;NEUŽMIRŠTUOLĖS;2070729684;Taip;0;2;0;2
9208;Ramunėlė;NEUŽMIRŠTUOLĖS;4329292281;Taip;4;2;1;7
9209;Ramunėlė;NEUŽMIRŠTUOLĖS;6613469006;Taip;0;10;0;10
9210;Ramunėlė;NEUŽMIRŠTUOLĖS;3742982547;Taip;0;3;0;3
9211;Ramunėlė;NEUŽMIRŠTUOLĖS;3106987206;Taip;6;6;0;12
9212;Ramunėlė;NEUŽMIRŠTUOLĖS;8643188779;Taip;5;0;0;5
9213;Ramunėlė;NEUŽMIRŠTUOLĖS;9012749913;Taip;0;6;0;6
9214;Ramunėlė;NEUŽMIRŠTUOLĖS;1579527330;Taip;11;10;0;21
9215;Ramunėlė;NEUŽMIRŠTUOLĖS;7519551613;Taip;6;8;0;14
9216;Ramunėlė;NEUŽMIRŠTUOLĖS;2880352109;Taip;20;0;0;20
9217;Ramunėlė;NEUŽMIRŠTUOLĖS;3949246652;Taip;11;0;0;11
9218;Ramunėlė;NEUŽMIRŠTUOLĖS;3045477012;Taip;9;5;0;14
9219;Ramunėlė;NEUŽMIRŠTUOLĖS;5267145991;Ne;0;0;4;4
9220;Ramunėlė;NEUŽMIRŠTUOLĖS;1181787182;Ne;17;0;0;17
9221;Ramunėlė;OBUOLIUKAI;7364976547;Ne;7;1;0;8
9222;Ramunėlė;OBUOLIUKAI;6156792400;Taip;0;12;0;12
9223;Ramunėlė;OBUOLIUKAI;4233978236;Taip;6;8;0;14
9224;Ramunėlė;OBUOLIUKAI;2983986428;Taip;0;18;0;18
9225;Ramunėlė;OBUOLIUKAI;5548358138;Taip;0;1;0;1
9226;Ramunėlė;OBUOLIUKAI;2427399083;Ne;0;1;0;1
9227;Ramunėlė;OBUOLIUKAI;2422656007;Taip;3;0;4;7
9228;Ramunėlė;OBUOLIUKAI;7829765488;Taip;0;8;0;8
9229;Ramunėlė;OBUOLIUKAI;8623311748;Taip;1;1;0;2
9230;Ramunėlė;OBUOLIUKAI;6849205606;Taip;11;0;0;11
9231;Ramunėlė;OBUOLIUKAI;6604244856;Taip;4;4;0;8
9232;Ramunėlė;OBUOLIUKAI;8617271247;Taip;0;9;0;9
9233;Ramunėlė;OBUOLIUKAI;6413888803;Taip;0;3;0;3
9234;Ramunėlė;OBUOLIUKAI;5610672420;Ne;14;2;0;16
9235;Ramunėlė;OBUOLIUKAI;4400154355;Taip;5;0;0;5
9236;Ramunėlė;OBUOLIUKAI;7250951221;Taip;5;5;1;11
9237;Ramunėlė;OBUOLIUKAI;3802924434;Taip;0;2;3;5
9238;Ramunėlė;OBUOLIUKAI;6981729247;Ne;5;0;0;5
9239;Ramunėlė;SAULĖGRĄŽA;7836959157;Taip;0;0;1;1
9240;Ramunėlė;SAULĖGRĄŽA;2458101652;Taip;11;0;7;18
9241;Ramunėlė;SAULĖGRĄŽA;9663304288;Taip;5;0;2;7
9242;Ramunėlė;SAULĖGRĄŽA;5398069413;Taip;18;0;0;18
9243;Ramunėlė;SAULĖGRĄŽA;7873462803;Taip;0;0;11;11
9244;Ramunėlė;SAULĖGRĄŽA;3793779715;Taip;0;0;6;6
9245;Ramunėlė;SAULĖGRĄŽA;1102946363;Taip;6;0;3;9
9246;Ramunėlė;SAULĖGRĄŽA;3603956795;Taip;0;3;0;3
9247;Ramunėlė;SAULĖGRĄŽA;4902056654;Taip;0;3;0;3
9248;Ramunėlė;SAULĖGRĄŽA;7563892184;Taip;0;3;0;3
9249;Ramunėlė;SAULĖGRĄŽA;3801952385;Taip;5;14;0;19
9250;Ramunėlė;SAULĖGRĄŽA;9120142666;Taip;5;0;2;7
9251;Ramunėlė;SAULĖGRĄŽA;6942789511;Taip;0;0;1;1
9252;Ramunėlė;SAULĖGRĄŽA;6226329879;Ne;0;21;0;21
9253;Ramunėlė;SAULĖGRĄŽA;2415377154;Taip;0;5;6;11
9254;Ramunėlė;BORUŽĖLĖS;7825538259;Taip;0;6;0;6
9255;Ramunėlė;BORUŽĖLĖS;8496322672;Taip;0;1;1;2
9256;Ramunėlė;BORUŽĖLĖS;6695672297;Taip;0;5;0;5
9257;Ramunėlė;BORUŽĖLĖS;7295041630;Taip;0;3;0;3
9258;Ramunėlė;BORUŽĖLĖS;58028743912;Taip;7;5;0;12
9259;Ramunėlė;BORUŽĖLĖS;7750405604;Taip;0;3;0;3
9260;Ramunėlė;BORUŽĖLĖS;1216101539;Taip;0;8;0;8
9261;Ramunėlė;BORUŽĖLĖS;4677819736;Taip;0;1;2;3
9262;Ramunėlė;BORUŽĖLĖS;4349250416;Taip;0;4;0;4
9263;Ramunėlė;BORUŽĖLĖS;1303053333;Taip;0;2;0;2
9264;Ramunėlė;BORUŽĖLĖS;3554787356;Taip;0;3;3;6
9265;Ramunėlė;BORUŽĖLĖS;6310921755;Taip;0;2;0;2
9266;Ramunėlė;BORUŽĖLĖS;3685786758;Taip;0;2;0;2
9267;Ramunėlė;BORUŽĖLĖS;6837072361;Taip;0;4;0;4
9268;Ramunėlė;BORUŽĖLĖS;1534723406;Taip;0;3;3;6
9269;Ramunėlė;BORUŽĖLĖS;8323020864;Taip;0;3;1;4
9270;Ramunėlė;BORUŽĖLĖS;10704826206;Taip;5;2;0;7
9271;Ramunėlė;BORUŽĖLĖS;3065727741;Taip;4;1;3;8
9272;Ramunėlė;BORUŽĖLĖS;9924675250;Taip;0;3;0;3
9273;Ramunėlė;BORUŽĖLĖS;6251432968;Ne;5;1;0;6
9274;Ramunėlė;NYKŠTUKAS;3166386231;Taip;3;1;0;4
9275;Ramunėlė;NYKŠTUKAS;8045080504;Ne;0;2;1;3
9276;Ramunėlė;NYKŠTUKAS;7955197522;Taip;12;3;0;15
9277;Ramunėlė;NYKŠTUKAS;6983139076;Taip;16;0;0;16
9278;Ramunėlė;NYKŠTUKAS;7639613472;Taip;0;18;0;18
9279;Ramunėlė;NYKŠTUKAS;4642590173;Taip;0;1;0;1
9280;Ramunėlė;NYKŠTUKAS;9549605315;Taip;9;0;0;9
9281;Ramunėlė;NYKŠTUKAS;4491147309;Taip;0;0;11;11
9282;Ramunėlė;NYKŠTUKAS;4040520907;Taip;12;1;0;13
9283;Ramunėlė;NYKŠTUKAS;7542328641;Taip;9;0;0;9
9284;Ramunėlė;NYKŠTUKAS;1277413234;Taip;0;8;0;8
9285;Ramunėlė;NYKŠTUKAS;1215510902;Taip;13;0;0;13
9286;Ramunėlė;NYKŠTUKAS;2760710235;Taip;5;0;0;5
9287;Ramunėlė;NYKŠTUKAS;5573083546;Taip;19;0;0;19
9288;Ramunėlė;UOGELĖ;6294697776;Taip;0;8;0;8
9289;Ramunėlė;UOGELĖ;7005354909;Taip;0;2;0;2
9290;Ramunėlė;UOGELĖ;5665429647;Taip;0;2;5;7
9291;Ramunėlė;UOGELĖ;4946797276;Taip;6;8;2;16
9292;Ramunėlė;UOGELĖ;9180197156;Taip;16;2;0;18
9293;Ramunėlė;UOGELĖ;5108864184;Taip;16;0;0;16
9294;Ramunėlė;UOGELĖ;4321527067;Taip;15;0;0;15
9295;Ramunėlė;UOGELĖ;2202879286;Taip;0;2;0;2
9296;Ramunėlė;UOGELĖ;7896711579;Taip;7;3;0;10
9297;Ramunėlė;UOGELĖ;5726947811;Taip;5;5;2;12
9298;Ramunėlė;UOGELĖ;4171905362;Taip;0;11;0;11
9299;Ramunėlė;UOGELĖ;1729152997;Taip;16;0;0;16
9300;Ramunėlė;UOGELĖ;8764042799;Taip;0;5;0;5
9301;Ramunėlė;UOGELĖ;7926168752;Ne;3;0;3;6
9302;Ramunėlė;UOGELĖ;5498856861;Taip;8;0;2;10
9303;Ramunėlė;UOGELĖ;3024065664;Taip;0;5;0;5
9304;Ramunėlė;UOGELĖ;1666033483;Taip;18;2;0;20
9305;Ramunėlė;UOGELĖ;9994601365;Taip;23;0;0;23
9306;Ramunėlė;UOGELĖ;2620747378;Taip;6;0;3;9
9307;Ramunėlė;VARPELIAI;1159457001;Taip;12;3;0;15
9308;Ramunėlė;VARPELIAI;6606966969;Taip;5;0;0;5
9309;Ramunėlė;VARPELIAI;7599491698;Ne;17;0;0;17
9310;Ramunėlė;VARPELIAI;9292235402;Ne;7;0;0;7
9311;Ramunėlė;VARPELIAI;1811931985;Taip;0;3;0;3
9312;Ramunėlė;VARPELIAI;1818513881;Taip;0;3;0;3
9313;Ramunėlė;VARPELIAI;4581826404;Taip;5;0;5;10
9314;Ramunėlė;VARPELIAI;8310875815;Taip;9;9;0;18
9315;Ramunėlė;VARPELIAI;1491688322;Taip;4;3;0;7
9316;Ramunėlė;VARPELIAI;5703289545;Taip;7;0;5;12
9317;Ramunėlė;VARPELIAI;9934852622;Taip;0;7;0;7
9318;Ramunėlė;VARPELIAI;4968998913;Taip;5;0;0;5
9319;Ramunėlė;VARPELIAI;3996453947;Taip;0;1;0;1
9320;Ramunėlė;VARPELIAI;3461269451;Taip;0;2;0;2
9321;Ramunėlė;VARPELIAI;3474578046;Taip;10;2;0;12
9322;Ramunėlė;VARPELIAI;7544671346;Taip;4;1;0;5
9323;Ramunėlė;VARPELIAI;5544992493;Taip;0;2;0;2
9324;Ramunėlė;VARPELIAI;6433856416;Taip;5;3;0;8
9325;Ramunėlė;VARPELIAI;3542912372;Taip;17;0;0;17
9326;Ramunėlė;VARPELIAI;3735308599;Taip;8;1;0;9
9327;Ramunėlė;VARPELIAI;3272747656;Taip;12;0;0;12
9328;Ramunėlė;VARPELIAI;6347893013;Taip;1;3;0;4
9329;Rūta;SMALSUČIAI;6285841968;Taip;3;0;0;3
9330;Rūta;SMALSUČIAI;7649756034;Taip;0;0;2;2
9331;Rūta;SMALSUČIAI;5899860543;Ne;0;13;0;13
9332;Rūta;SMALSUČIAI;1346124133;Taip;0;0;1;1
9333;Rūta;SMALSUČIAI;4728904136;Taip;0;3;0;3
9334;Rūta;SMALSUČIAI;9791861646;Taip;0;3;2;5
9335;Rūta;SMALSUČIAI;2928803089;Taip;0;1;0;1
9336;Rūta;SMALSUČIAI;8378318357;Taip;0;8;0;8
9337;Rūta;SMALSUČIAI;1951202550;Taip;6;0;0;6
9338;Rūta;SMALSUČIAI;3875136625;Ne;0;2;1;3
9339;Rūta;SMALSUČIAI;4962272621;Taip;0;0;1;1
9340;Rūta;SMALSUČIAI;9603105651;Taip;5;0;6;11
9341;Rūta;SMALSUČIAI;9911151238;Taip;7;0;1;8
9342;Rūta;SMALSUČIAI;3843325181;Taip;0;0;6;6
9343;Rūta;SMALSUČIAI;6316768460;Taip;0;0;10;10
9344;Rūta;SMALSUČIAI;8182243701;Taip;0;3;2;5
9345;Rūta;SMALSUČIAI;9386595365;Taip;0;0;3;3
9346;Rūta;SMALSUČIAI;7680605199;Ne;15;5;0;20
9347;Rūta;SMALSUČIAI;6075632046;Taip;3;5;0;8
9348;Rūta;SMALSUČIAI;1035527190;Ne;5;0;5;10
9349;Rūta;KŪLVERSTUKAI;4423305209;Taip;0;3;0;3
9350;Rūta;KŪLVERSTUKAI;7222494215;Taip;5;3;0;8
9351;Rūta;KŪLVERSTUKAI;7519931138;Taip;5;3;1;9
9352;Rūta;KŪLVERSTUKAI;4880804625;Taip;0;1;0;1
9353;Rūta;KŪLVERSTUKAI;3055345528;Taip;0;0;2;2
9354;Rūta;KŪLVERSTUKAI;3499727608;Taip;4;9;0;13
9355;Rūta;KŪLVERSTUKAI;9765301038;Taip;4;9;0;13
9356;Rūta;KŪLVERSTUKAI;9638495757;Taip;3;1;0;4
9357;Rūta;KŪLVERSTUKAI;1962172243;Taip;0;0;2;2
9358;Rūta;KŪLVERSTUKAI;8605070655;Taip;0;0;1;1
9359;Rūta;KŪLVERSTUKAI;7553844890;Taip;0;18;0;18
9360;Rūta;KŪLVERSTUKAI;3964922552;Taip;0;4;0;4
9361;Rūta;KŪLVERSTUKAI;9400586178;Taip;0;0;4;4
9362;Rūta;KŪLVERSTUKAI;2890569107;Taip;4;2;0;6
9363;Rūta;KŪLVERSTUKAI;2474991135;Taip;0;5;4;9
9364;Rūta;KŪLVERSTUKAI;9245618776;Taip;23;0;0;23
9365;Rūta;KŪLVERSTUKAI;5109138407;Ne;0;0;4;4
9366;Rūta;KŪLVERSTUKAI;6096664609;Taip;0;2;6;8
9367;Rūta;KODĖLČIUKAI;4347678781;Taip;0;0;5;5
9368;Rūta;KODĖLČIUKAI;3736279705;Taip;9;0;1;10
9369;Rūta;KODĖLČIUKAI;8416455711;Taip;0;6;0;6
9370;Rūta;KODĖLČIUKAI;8668510009;Taip;5;0;0;5
9371;Rūta;KODĖLČIUKAI;2547849837;Taip;7;0;3;10
9372;Rūta;KODĖLČIUKAI;9501101073;Taip;0;9;0;9
9373;Rūta;KODĖLČIUKAI;8883578144;Taip;0;0;1;1
9374;Rūta;KODĖLČIUKAI;4546082355;Taip;0;1;0;1
9375;Rūta;KODĖLČIUKAI;1000645885;Taip;9;0;0;9
9376;Rūta;KODĖLČIUKAI;3259372153;Taip;5;0;0;5
9377;Rūta;KODĖLČIUKAI;4944413811;Taip;0;0;3;3
9378;Rūta;KODĖLČIUKAI;9916296056;Taip;3;0;0;3
9379;Rūta;KODĖLČIUKAI;4656138649;Ne;5;0;1;6
9380;Rūta;KODĖLČIUKAI;1605412505;Taip;0;0;3;3
9381;Rūta;BORUŽĖLĖS;7712500278;Ne;0;0;9;9
9382;Rūta;BORUŽĖLĖS;8945868791;Taip;0;0;10;10
9383;Rūta;BORUŽĖLĖS;8023404173;Taip;0;0;15;15
9384;Rūta;BORUŽĖLĖS;3348066709;Taip;4;0;3;7
9385;Rūta;BORUŽĖLĖS;4279367893;Taip;12;0;3;15
9386;Rūta;BORUŽĖLĖS;5141290453;Taip;7;0;0;7
9387;Rūta;BORUŽĖLĖS;7006165453;Taip;6;1;0;7
9388;Rūta;BORUŽĖLĖS;6587625933;Taip;5;0;0;5
9389;Rūta;BORUŽĖLĖS;3478391345;Taip;10;0;0;10
9390;Rūta;BORUŽĖLĖS;8303314520;Taip;0;1;0;1
9391;Rūta;BORUŽĖLĖS;3470052541;Taip;0;2;6;8
9392;Rūta;VYTURĖLIAI;1967141665;Taip;0;4;0;4
9393;Rūta;VYTURĖLIAI;3873876608;Taip;0;4;0;4
9394;Rūta;VYTURĖLIAI;8851591109;Ne;10;0;0;10
9395;Rūta;VYTURĖLIAI;1180144866;Taip;0;3;0;3
9396;Rūta;VYTURĖLIAI;3478456813;Taip;5;1;0;6
9397;Rūta;VYTURĖLIAI;1276704331;Taip;5;0;1;6
9398;Rūta;VYTURĖLIAI;6207902435;Taip;0;8;0;8
9399;Rūta;VYTURĖLIAI;1346367896;Taip;0;1;0;1
9400;Rūta;VYTURĖLIAI;4363571135;Taip;0;4;0;4
9401;Rūta;VYTURĖLIAI;6006094035;Taip;9;2;0;11
9402;Rūta;VYTURĖLIAI;7552644990;Taip;0;8;1;9
9403;Rūta;VYTURĖLIAI;1092908255;Taip;0;3;0;3
9404;Rūta;VYTURĖLIAI;8673942478;Ne;0;4;0;4
9405;Rūta;VYTURĖLIAI;4754142240;Taip;0;5;2;7
9406;Rūta;VYTURĖLIAI;6136733410;Taip;5;2;0;7
9407;Rūta;VYTURĖLIAI;1565896222;Taip;0;3;0;3
9408;Rūta;VYTURĖLIAI;8704594038;Taip;3;0;0;3
9409;Rūta;VYTURĖLIAI;7631229177;Taip;2;1;0;3
9410;Rūta;"PABIRUČIAI (LOGOPEDINĖ)";6221528830;Taip;0;1;0;1
9411;Rūta;"PABIRUČIAI (LOGOPEDINĖ)";4911219947;Taip;0;0;1;1
9412;Rūta;"PABIRUČIAI (LOGOPEDINĖ)";8763382361;Taip;1;2;2;5
9413;Rūta;"PABIRUČIAI (LOGOPEDINĖ)";9171781646;Taip;0;0;12;12
9414;Rūta;"PABIRUČIAI (LOGOPEDINĖ)";5871960113;Taip;0;3;0;3
9415;Rūta;"PABIRUČIAI (LOGOPEDINĖ)";5211104903;Taip;1;0;3;4
9416;Rūta;"PABIRUČIAI (LOGOPEDINĖ)";1029871210;Taip;0;0;3;3
9417;Rūta;"PABIRUČIAI (LOGOPEDINĖ)";6572172779;Taip;0;0;1;1
9418;Rūta;"PABIRUČIAI (LOGOPEDINĖ)";3814794448;Taip;0;0;1;1
9419;Rūta;GUDRUČIAI;4044349935;Taip;12;0;1;13
9420;Rūta;GUDRUČIAI;3998791775;Taip;0;0;4;4
9421;Rūta;GUDRUČIAI;3462986405;Taip;4;1;6;11
9422;Rūta;GUDRUČIAI;4293920701;Taip;0;3;0;3
9423;Rūta;GUDRUČIAI;4473591998;Taip;0;3;0;3
9424;Rūta;GUDRUČIAI;9419809946;Taip;0;1;0;1
9425;Rūta;GUDRUČIAI;3044976169;Taip;0;0;2;2
9426;Rūta;GUDRUČIAI;2546023973;Taip;0;6;4;10
9427;Rūta;GUDRUČIAI;8963959004;Taip;5;1;0;6
9428;Rūta;GUDRUČIAI;1811055786;Taip;0;1;0;1
9429;Rūta;GUDRUČIAI;1510268514;Taip;0;4;0;4
9430;Rūta;GUDRUČIAI;6814051598;Taip;0;2;2;4
9431;Rūta;GUDRUČIAI;2702537976;Taip;0;7;0;7
9432;Rūta;GUDRUČIAI;2772130413;Taip;4;5;0;9
9433;Rūta;GUDRUČIAI;1623968580;Taip;0;3;2;5
9434;Rūta;GUDRUČIAI;1182222976;Taip;0;0;3;3
9435;Rūta;SEKLYTĖLĖ;1301573542;Taip;0;3;0;3
9436;Rūta;SEKLYTĖLĖ;3567273206;Taip;1;7;0;8
9437;Rūta;SEKLYTĖLĖ;1671913833;Taip;4;0;0;4
9438;Rūta;SEKLYTĖLĖ;1186493111;Taip;0;10;0;10
9439;Rūta;SEKLYTĖLĖ;9675482322;Taip;0;2;0;2
9440;Rūta;SEKLYTĖLĖ;3820689725;Taip;0;3;0;3
9441;Rūta;SEKLYTĖLĖ;1415664888;Taip;0;3;3;6
9442;Rūta;SEKLYTĖLĖ;4426456302;Taip;0;3;0;3
9443;Rūta;SEKLYTĖLĖ;5114985659;Taip;0;3;0;3
9444;Rūta;SEKLYTĖLĖ;4282074540;Taip;0;1;0;1
9445;Rūta;SEKLYTĖLĖ;8607455403;Taip;0;2;0;2
9446;Rūta;SEKLYTĖLĖ;4168356825;Taip;2;1;0;3
9447;Rūta;SEKLYTĖLĖ;9569447586;Taip;0;2;0;2
9448;Rūta;SEKLYTĖLĖ;1579573872;Taip;0;3;0;3
9449;Rūta;SEKLYTĖLĖ;2677062861;Ne;0;5;0;5
9450;Rūta;SEKLYTĖLĖ;1390207547;Taip;0;5;0;5
9451;Rūta;SEKLYTĖLĖ;5866619097;Taip;0;4;0;4
9452;Rūta;"VARPELIAI (LOGOPEDINĖ)";3055294324;Taip;0;0;7;7
9453;Rūta;"VARPELIAI (LOGOPEDINĖ)";3810636967;Taip;0;2;0;2
9454;Rūta;"VARPELIAI (LOGOPEDINĖ)";8992775168;Taip;0;8;1;9
9455;Rūta;"VARPELIAI (LOGOPEDINĖ)";8026402652;Ne;0;2;1;3
9456;Rūta;"VARPELIAI (LOGOPEDINĖ)";2584812163;Ne;5;5;0;10
9457;Rūta;"VARPELIAI (LOGOPEDINĖ)";6032985748;Taip;0;2;0;2
9458;Rūta;"VARPELIAI (LOGOPEDINĖ)";6891385410;Taip;0;3;0;3
9459;Rūta;"VARPELIAI (LOGOPEDINĖ)";4858914868;Taip;0;3;4;7
9460;Rūta;KIŠKUČIŲ;7837861265;Taip;0;0;2;2
9461;Rūta;KIŠKUČIŲ;2601011765;Ne;5;0;11;16
9462;Rūta;KIŠKUČIŲ;5579794648;Taip;0;10;0;10
9463;Rūta;KIŠKUČIŲ;4165080541;Taip;11;0;0;11
9464;Rūta;KIŠKUČIŲ;3877807687;Ne;5;0;11;16
9465;Rūta;KIŠKUČIŲ;8483916287;Taip;23;0;0;23
9466;Rūta;KIŠKUČIŲ;7724451685;Taip;2;0;2;4
9467;Rūta;KIŠKUČIŲ;8138816581;Ne;0;18;0;18
9468;Rūta;KIŠKUČIŲ;2733932207;Taip;0;7;0;7
9469;Rūta;KIŠKUČIŲ;5902965224;Taip;0;2;0;2
9470;Rūta;KIŠKUČIŲ;9471291067;Taip;0;3;0;3
9471;Rūta;KIŠKUČIŲ;8012225409;Taip;0;0;2;2
9472;Rūta;KIŠKUČIŲ;1290867375;Taip;0;13;0;13
9473;Rūta;KIŠKUČIŲ;2084935094;Taip;7;0;3;10
9474;Rūta;KIŠKUČIŲ;6088978998;Taip;7;0;5;12
9475;Rūta;KIŠKUČIŲ;8320791295;Taip;11;3;0;14
9476;Rūta;KIŠKUČIŲ;3109709043;Taip;10;0;5;15
9477;Rūta;KIŠKUČIŲ;2830990163;Taip;0;0;1;1
9478;Rūta;KIŠKUČIŲ;5137132420;Taip;0;3;0;3
9479;Rūta;ŽVIRBLIUKAI;3352007694;Taip;0;1;0;1
9480;Rūta;ŽVIRBLIUKAI;6417693659;Taip;0;1;1;2
9481;Rūta;ŽVIRBLIUKAI;4090915728;Taip;0;3;0;3
9482;Rūta;ŽVIRBLIUKAI;4466522924;Taip;11;3;2;16
9483;Rūta;ŽVIRBLIUKAI;7905893575;Taip;20;3;0;23
9484;Rūta;ŽVIRBLIUKAI;4436482805;Taip;0;3;0;3
9485;Rūta;ŽVIRBLIUKAI;1260386759;Taip;6;0;0;6
9486;Rūta;ŽVIRBLIUKAI;8935780480;Taip;13;0;0;13
9487;Rūta;ŽVIRBLIUKAI;4208678278;Taip;0;2;0;2
9488;Rūta;ŽVIRBLIUKAI;6044060646;Taip;14;3;0;17
9489;Rūta;ŽVIRBLIUKAI;4776631890;Taip;10;0;4;14
9490;Rūta;ŽVIRBLIUKAI;4440148328;Taip;0;1;3;4
9491;Rūta;ŽVIRBLIUKAI;1671179652;Taip;23;0;0;23
9492;Rūta;ŽVIRBLIUKAI;1152453609;Taip;5;1;2;8
9493;Rūta;ŽVIRBLIUKAI;9012256437;Taip;0;0;3;3
9494;Rūta;SAULUTĖS;6869693434;Taip;9;0;0;9
9495;Rūta;SAULUTĖS;6585842434;Taip;0;0;1;1
9496;Rūta;SAULUTĖS;8806743371;Taip;0;0;1;1
9497;Rūta;SAULUTĖS;8320521011;Taip;0;0;1;1
9498;Rūta;SAULUTĖS;2263820829;Taip;9;2;0;11
9499;Rūta;SAULUTĖS;2391120026;Taip;0;6;0;6
9500;Rūta;SAULUTĖS;3765741047;Taip;0;0;6;6
9501;Rūta;SAULUTĖS;7762509383;Taip;0;1;0;1
9502;Rūta;SAULUTĖS;2685515977;Taip;6;6;0;12
9503;Rūta;SAULUTĖS;5512946296;Taip;3;0;0;3
9504;Rūta;SAULUTĖS;9308127402;Taip;10;0;0;10
9505;Rūta;SAULUTĖS;7422059414;Ne;10;4;0;14
9506;Rūta;SAULUTĖS;6186413364;Taip;0;0;3;3
9507;Rūta;SAULUTĖS;8571905994;Ne;9;1;0;10
9508;Rūta;SAULUTĖS;8479424939;Taip;12;0;0;12
9509;Rūta;SAULUTĖS;9014433476;Taip;0;2;0;2
9510;Rūta;SAULUTĖS;1207463357;Taip;1;0;0;1
9511;Rūta;SAULUTĖS;1131910047;Taip;10;0;0;10
9512;Sadutė;Kiškučiai;6645848193;Taip;0;1;0;1
9513;Sadutė;Kiškučiai;1589424708;Taip;0;5;0;5
9514;Sadutė;Kiškučiai;5992865266;Taip;12;0;0;12
9515;Sadutė;Kiškučiai;3568132830;Taip;8;0;2;10
9516;Sadutė;Kiškučiai;2340908210;Taip;14;0;1;15
9517;Sadutė;Kiškučiai;2087489114;Taip;5;0;0;5
9518;Sadutė;Kiškučiai;6652070415;Taip;10;0;3;13
9519;Sadutė;Kiškučiai;4360361866;Ne;6;1;3;10
9520;Sadutė;Kiškučiai;2139177648;Taip;8;0;0;8
9521;Sadutė;Kiškučiai;6493110772;Taip;5;0;0;5
9522;Sadutė;Kiškučiai;8397295024;Taip;3;2;0;5
9523;Sadutė;Kiškučiai;4075714061;Taip;0;4;0;4
9524;Sadutė;Kiškučiai;3285448692;Taip;8;1;0;9
9525;Sadutė;Kiškučiai;2845125335;Taip;4;1;0;5
9526;Sadutė;Kiškučiai;4135398332;Taip;8;6;0;14
9527;Sadutė;Kiškučiai;3954151590;Taip;19;0;0;19
9528;Sadutė;Kiškučiai;5326000400;Taip;0;0;2;2
9529;Sadutė;Kiškučiai;1860645542;Ne;11;1;0;12
9530;Sadutė;Kiškučiai;2472471722;Taip;9;0;0;9
9531;Sadutė;Boružėlės;9115304973;Taip;0;3;0;3
9532;Sadutė;Boružėlės;8442967732;Taip;0;1;0;1
9533;Sadutė;Boružėlės;1273355194;Taip;0;13;4;17
9534;Sadutė;Boružėlės;3119547420;Taip;0;13;4;17
9535;Sadutė;Boružėlės;8987528237;Taip;0;3;2;5
9536;Sadutė;Boružėlės;6994383907;Taip;7;0;3;10
9537;Sadutė;Boružėlės;7242188081;Taip;0;5;0;5
9538;Sadutė;Boružėlės;3244211391;Taip;0;5;0;5
9539;Sadutė;Boružėlės;3875265137;Taip;0;3;0;3
9540;Sadutė;Boružėlės;5992119777;Taip;0;9;0;9
9541;Sadutė;Boružėlės;5682745869;Taip;0;0;2;2
9542;Sadutė;Boružėlės;5579040052;Ne;0;7;0;7
9543;Sadutė;Boružėlės;3362830536;Taip;10;3;0;13
9544;Sadutė;Boružėlės;5395676303;Taip;0;0;3;3
9545;Sadutė;Boružėlės;1923014145;Taip;0;2;0;2
9546;Sadutė;Boružėlės;5698462283;Taip;0;0;6;6
9547;Sadutė;Boružėlės;3845369333;Taip;6;0;7;13
9548;Sadutė;Boružėlės;8200891038;Ne;0;4;3;7
9549;Sadutė;Boružėlės;4696990344;Ne;15;3;0;18
9550;Sadutė;Boružėlės;4106484107;Taip;0;1;5;6
9551;Sadutė;Bitutės;1759479328;Taip;5;4;0;9
9552;Sadutė;Bitutės;4245873513;Taip;0;8;0;8
9553;Sadutė;Bitutės;1873928395;Taip;14;0;0;14
9554;Sadutė;Bitutės;5866461096;Taip;1;0;0;1
9555;Sadutė;Bitutės;4883934480;Taip;6;1;1;8
9556;Sadutė;Bitutės;7097653016;Taip;2;3;0;5
9557;Sadutė;Bitutės;4479315578;Taip;3;0;0;3
9558;Sadutė;Bitutės;2020766695;Taip;0;23;0;23
9559;Sadutė;Bitutės;5011320850;Taip;2;6;1;9
9560;Sadutė;Bitutės;5973513916;Taip;0;1;0;1
9561;Sadutė;Bitutės;5169694660;Taip;0;1;0;1
9562;Sadutė;Bitutės;3361904803;Taip;11;0;0;11
9563;Sadutė;Bitutės;2355177889;Taip;0;0;4;4
9564;Sadutė;Bitutės;8556086501;Taip;0;1;0;1
9565;Sadutė;Bitutės;6066145909;Taip;18;0;0;18
9566;Sadutė;Bitutės;5142566738;Taip;6;2;1;9
9567;Sadutė;Bitutės;8662375739;Taip;0;1;3;4
9568;Sadutė;Bitutės;9692905987;Taip;16;0;0;16
9569;Sadutė;Bitutės;9107727583;Taip;3;0;2;5
9570;Sadutė;Bitutės;6138604955;Ne;16;0;0;16
9571;Sadutė;Drugeliai;9090754149;Taip;0;3;0;3
9572;Sadutė;Drugeliai;1552350084;Taip;4;4;0;8
9573;Sadutė;Drugeliai;7910380894;Taip;0;3;0;3
9574;Sadutė;Drugeliai;4402558234;Taip;0;4;0;4
9575;Sadutė;Drugeliai;6994547344;Taip;0;4;0;4
9576;Sadutė;Drugeliai;1782594187;Taip;0;1;0;1
9577;Sadutė;Drugeliai;5816844295;Taip;0;9;1;10
9578;Sadutė;Drugeliai;8803249656;Taip;0;9;0;9
9579;Sadutė;Drugeliai;6196282159;Taip;15;3;0;18
9580;Sadutė;Drugeliai;5139219626;Taip;0;2;0;2
9581;Sadutė;Drugeliai;2883991326;Taip;0;1;2;3
9582;Sadutė;Drugeliai;6124376554;Taip;0;3;1;4
9583;Sadutė;Drugeliai;36769610742;Taip;0;3;1;4
9584;Sadutė;Drugeliai;4623727349;Taip;0;3;1;4
9585;Sadutė;Drugeliai;7940706717;Taip;0;6;3;9
9586;Sadutė;Drugeliai;3457375001;Ne;0;13;0;13
9587;Sadutė;Pėledžiukai;9136727429;Taip;0;0;1;1
9588;Sadutė;Pėledžiukai;5616756293;Taip;9;0;0;9
9589;Sadutė;Pėledžiukai;2705458480;Taip;3;2;0;5
9590;Sadutė;Pėledžiukai;6126235707;Taip;16;0;0;16
9591;Sadutė;Pėledžiukai;1537482438;Taip;0;6;0;6
9592;Sadutė;Pėledžiukai;6716550703;Taip;4;0;0;4
9593;Sadutė;Pėledžiukai;7730645448;Taip;0;0;1;1
9594;Sadutė;Pėledžiukai;8914706717;Taip;4;0;3;7
9595;Sadutė;Pėledžiukai;5385678913;Taip;12;0;0;12
9596;Sadutė;Pėledžiukai;2055127699;Taip;0;1;0;1
9597;Sadutė;Pėledžiukai;2747256989;Taip;3;0;0;3
9598;Sadutė;Pėledžiukai;3277826759;Taip;11;0;1;12
9599;Sadutė;Pėledžiukai;4791750087;Taip;9;0;0;9
9600;Sadutė;Kačiukų;1507052440;Taip;7;5;0;12
9601;Sadutė;Kačiukų;1903961488;Taip;0;3;3;6
9602;Sadutė;Kačiukų;2890916313;Taip;0;3;0;3
9603;Sadutė;Kačiukų;2733633163;Taip;0;1;6;7
9604;Sadutė;Kačiukų;3993181500;Taip;0;2;2;4
9605;Sadutė;Kačiukų;8835627470;Taip;0;3;0;3
9606;Sadutė;Kačiukų;2532626934;Taip;0;3;0;3
9607;Sadutė;Kačiukų;2466024649;Taip;0;1;0;1
9608;Sadutė;Kačiukų;6253351299;Taip;2;1;1;4
9609;Sadutė;Kačiukų;2426974464;Taip;0;3;1;4
9610;Sadutė;Kačiukų;8974374101;Taip;6;5;0;11
9611;Sadutė;Kačiukų;4401870028;Taip;0;3;0;3
9612;Sadutė;Kačiukų;8714168144;Taip;3;0;0;3
9613;Sadutė;Kačiukų;3927044011;Taip;0;7;0;7
9614;Sadutė;Kačiukų;8974225608;Taip;5;0;0;5
9615;Sadutė;Kačiukų;8770727233;Taip;0;0;3;3
9616;Sadutė;Kačiukų;8556218971;Taip;0;13;4;17
9617;Sadutė;Kačiukų;5267093203;Taip;5;3;4;12
9618;Sadutė;Kačiukų;6538356822;Taip;3;0;0;3
9619;Sadutė;Kačiukų;5614758320;Taip;2;0;9;11
9620;Sadutė;Kačiukų;2194387139;Taip;1;0;1;2
9621;Sakalėlis;GIRINUKŲ;9566176151;Taip;18;0;0;18
9622;Sakalėlis;GIRINUKŲ;8606714134;Taip;5;0;1;6
9623;Sakalėlis;GIRINUKŲ;5405669698;Taip;0;1;1;2
9624;Sakalėlis;GIRINUKŲ;2474164013;Taip;1;1;0;2
9625;Sakalėlis;GIRINUKŲ;9493905856;Ne;0;0;2;2
9626;Sakalėlis;GIRINUKŲ;5496044442;Taip;6;0;3;9
9627;Sakalėlis;GIRINUKŲ;3165387995;Taip;7;0;0;7
9628;Sakalėlis;GIRINUKŲ;6603105354;Taip;0;0;1;1
9629;Sakalėlis;GIRINUKŲ;3418702674;Taip;3;0;3;6
9630;Sakalėlis;GIRINUKŲ;3748865437;Taip;15;0;0;15
9631;Sakalėlis;GIRINUKŲ;6700169944;Taip;0;0;2;2
9632;Sakalėlis;GIRINUKŲ;3333037807;Taip;6;0;0;6
9633;Sakalėlis;GIRINUKŲ;8667155756;Taip;0;2;5;7
9634;Sakalėlis;GIRINUKŲ;4596727938;Taip;0;0;1;1
9635;Sakalėlis;GIRINUKŲ;8790189865;Taip;10;1;0;11
9636;Sakalėlis;GIRINUKŲ;4458071075;Taip;0;0;1;1
9637;Sakalėlis;GIRINUKŲ;2780141413;Taip;0;8;0;8
9638;Sakalėlis;GIRINUKŲ;1347171934;Taip;0;1;1;2
9639;Sakalėlis;GIRINUKŲ;9250470549;Taip;3;6;2;11
9640;Sakalėlis;GIRINUKŲ;3691879468;Taip;0;0;2;2
9641;Sakalėlis;VYTURIUKŲ;3927487265;Taip;0;4;0;4
9642;Sakalėlis;VYTURIUKŲ;3680732318;Taip;0;6;0;6
9643;Sakalėlis;VYTURIUKŲ;4862004373;Taip;10;0;0;10
9644;Sakalėlis;VYTURIUKŲ;6579827280;Taip;3;2;1;6
9645;Sakalėlis;VYTURIUKŲ;8381310908;Taip;3;0;0;3
9646;Sakalėlis;VYTURIUKŲ;6840368824;Taip;5;0;0;5
9647;Sakalėlis;VYTURIUKŲ;1742362136;Taip;0;0;1;1
9648;Sakalėlis;VYTURIUKŲ;5795250727;Taip;0;2;5;7
9649;Sakalėlis;VYTURIUKŲ;2985239904;Taip;0;3;0;3
9650;Sakalėlis;VYTURIUKŲ;9120873899;Ne;18;0;3;21
9651;Sakalėlis;VYTURIUKŲ;4136266629;Taip;0;0;1;1
9652;Sakalėlis;VYTURIUKŲ;5991029760;Ne;3;0;6;9
9653;Sakalėlis;VYTURIUKŲ;6378711142;Taip;7;0;0;7
9654;Sakalėlis;VYTURIUKŲ;1736303381;Taip;0;3;0;3
9655;Sakalėlis;VYTURIUKŲ;7280513854;Taip;5;0;1;6
9656;Sakalėlis;DRUGELIŲ;8095359035;Taip;0;0;3;3
9657;Sakalėlis;DRUGELIŲ;6515519140;Ne;0;0;2;2
9658;Sakalėlis;DRUGELIŲ;5911341542;Taip;5;0;3;8
9659;Sakalėlis;DRUGELIŲ;9272347788;Taip;11;0;0;11
9660;Sakalėlis;DRUGELIŲ;8331612396;Taip;0;0;5;5
9661;Sakalėlis;DRUGELIŲ;2898006208;Taip;0;12;0;12
9662;Sakalėlis;DRUGELIŲ;7542322748;Taip;10;0;1;11
9663;Sakalėlis;DRUGELIŲ;4918228191;Taip;11;0;0;11
9664;Sakalėlis;DRUGELIŲ;1201086815;Taip;0;0;5;5
9665;Sakalėlis;DRUGELIŲ;3934295338;Taip;0;3;1;4
9666;Sakalėlis;DRUGELIŲ;1117800518;Taip;12;0;0;12
9667;Sakalėlis;DRUGELIŲ;2515169899;Taip;2;3;0;5
9668;Sakalėlis;DRUGELIŲ;8160589611;Taip;0;4;0;4
9669;Sakalėlis;DRUGELIŲ;9836193857;Taip;13;0;0;13
9670;Sakalėlis;DRUGELIŲ;4004006771;Taip;9;3;0;12
9671;Sakalėlis;DRUGELIŲ;8713298648;Taip;0;7;0;7
9672;Sakalėlis;DRUGELIŲ;2889638745;Taip;10;0;1;11
9673;Sakalėlis;DRUGELIŲ;3329244758;Taip;8;0;2;10
9674;Sakalėlis;DRUGELIŲ;7540098033;Taip;0;0;4;4
9675;Sakalėlis;GENIUKŲ;4763858893;Taip;0;10;0;10
9676;Sakalėlis;GENIUKŲ;3337299648;Taip;0;3;3;6
9677;Sakalėlis;GENIUKŲ;43677485606;Taip;0;4;1;5
9678;Sakalėlis;GENIUKŲ;5717022080;Taip;0;3;0;3
9679;Sakalėlis;GENIUKŲ;4515180509;Taip;0;3;0;3
9680;Sakalėlis;GENIUKŲ;1027765680;Taip;0;4;0;4
9681;Sakalėlis;GENIUKŲ;96053733139;Taip;10;3;1;14
9682;Sakalėlis;GENIUKŲ;4612388683;Taip;5;4;0;9
9683;Sakalėlis;GENIUKŲ;7159705304;Taip;0;1;0;1
9684;Sakalėlis;GENIUKŲ;4775685174;Taip;0;0;1;1
9685;Sakalėlis;GENIUKŲ;69916351348;Taip;0;3;1;4
9686;Sakalėlis;GENIUKŲ;8936933971;Taip;0;1;0;1
9687;Sakalėlis;GENIUKŲ;2829386777;Taip;0;2;0;2
9688;Sakalėlis;GENIUKŲ;3371763993;Ne;0;3;1;4
9689;Sakalėlis;GENIUKŲ;7085108710;Taip;1;3;0;4
9690;Sakalėlis;GENIUKŲ;2902195855;Taip;0;3;0;3
9691;Sakalėlis;GENIUKŲ;4364341933;Ne;0;3;2;5
9692;Sakalėlis;VOVERIUKŲ;5172421763;Taip;0;0;3;3
9693;Sakalėlis;VOVERIUKŲ;5233697077;Taip;2;4;3;9
9694;Sakalėlis;VOVERIUKŲ;1953356983;Taip;16;0;1;17
9695;Sakalėlis;VOVERIUKŲ;4358313171;Taip;10;0;0;10
9696;Sakalėlis;VOVERIUKŲ;6806170544;Taip;0;0;1;1
9697;Sakalėlis;VOVERIUKŲ;2557089391;Taip;0;0;4;4
9698;Sakalėlis;VOVERIUKŲ;8133985842;Taip;0;0;3;3
9699;Sakalėlis;VOVERIUKŲ;3574956316;Taip;0;3;0;3
9700;Sakalėlis;VOVERIUKŲ;1403384561;Taip;3;0;1;4
9701;Sakalėlis;VOVERIUKŲ;3927363997;Ne;5;4;0;9
9702;Sakalėlis;VOVERIUKŲ;6293226507;Taip;8;0;4;12
9703;Sakalėlis;VOVERIUKŲ;2699844937;Taip;0;3;0;3
9704;Sakalėlis;VOVERIUKŲ;1273843302;Taip;0;0;1;1
9705;Sakalėlis;VOVERIUKŲ;6217643065;Taip;0;0;6;6
9706;Sakalėlis;VOVERIUKŲ;1669610397;Taip;0;0;3;3
9707;Sakalėlis;VOVERIUKŲ;4344537391;Taip;5;0;6;11
9708;Sakalėlis;VOVERIUKŲ;6016854405;Ne;0;3;0;3
9709;Sakalėlis;VOVERIUKŲ;2531146677;Taip;14;0;0;14
9710;Sakalėlis;VOVERIUKŲ;4968216193;Ne;0;0;1;1
9711;Sakalėlis;PĖLEDŽIUKŲ;1133377117;Taip;0;3;1;4
9712;Sakalėlis;PĖLEDŽIUKŲ;6190741162;Taip;0;1;0;1
9713;Sakalėlis;PĖLEDŽIUKŲ;4430763418;Taip;7;3;0;10
9714;Sakalėlis;PĖLEDŽIUKŲ;1104881142;Taip;0;1;0;1
9715;Sakalėlis;PĖLEDŽIUKŲ;6321575268;Taip;0;5;0;5
9716;Sakalėlis;PĖLEDŽIUKŲ;1702964714;Taip;5;0;0;5
9717;Sakalėlis;PĖLEDŽIUKŲ;30987215315;Taip;0;1;0;1
9718;Sakalėlis;PĖLEDŽIUKŲ;2796230671;Taip;0;3;0;3
9719;Sakalėlis;PĖLEDŽIUKŲ;3962436122;Taip;5;5;0;10
9720;Sakalėlis;PĖLEDŽIUKŲ;1912068116;Taip;0;1;0;1
9721;Sakalėlis;PĖLEDŽIUKŲ;34464485043;Taip;0;0;1;1
9722;Sakalėlis;PĖLEDŽIUKŲ;46629941288;Taip;0;3;0;3
9723;Sakalėlis;PĖLEDŽIUKŲ;5782214279;Taip;0;3;0;3
9724;Sakalėlis;PĖLEDŽIUKŲ;8852001037;Taip;7;3;1;11
9725;Sakalėlis;PĖLEDŽIUKŲ;6180987643;Ne;2;3;0;5
9726;Sakalėlis;PĖLEDŽIUKŲ;3678172501;Taip;0;2;0;2
9727;Sakalėlis;PĖLEDŽIUKŲ;7567476424;Taip;0;0;6;6
9728;Sakalėlis;PĖLEDŽIUKŲ;1839096675;Taip;2;3;0;5
9729;Sakalėlis;PĖLEDŽIUKŲ;5884781964;Taip;3;0;0;3
9730;Sakalėlis;PĖLEDŽIUKŲ;4495453007;Taip;0;3;1;4
9731;Sakalėlis;"BITUČIŲ (LOGOPEDINĖ)";7241416465;Ne;5;3;4;12
9732;Sakalėlis;"BITUČIŲ (LOGOPEDINĖ)";8610668395;Taip;10;1;3;14
9733;Sakalėlis;"BITUČIŲ (LOGOPEDINĖ)";4986131090;Taip;0;3;0;3
9734;Sakalėlis;"BITUČIŲ (LOGOPEDINĖ)";6259640492;Taip;6;0;0;6
9735;Sakalėlis;"BITUČIŲ (LOGOPEDINĖ)";1723436498;Taip;0;3;1;4
9736;Sakalėlis;"BITUČIŲ (LOGOPEDINĖ)";3938470708;Taip;10;0;1;11
9737;Sakalėlis;"BITUČIŲ (LOGOPEDINĖ)";4931253729;Taip;0;0;5;5
9738;Sakalėlis;"BITUČIŲ (LOGOPEDINĖ)";5376872141;Ne;2;0;0;2
9739;Sakalėlis;"BITUČIŲ (LOGOPEDINĖ)";4303490614;Taip;0;5;0;5
9740;Sakalėlis;"BORUŽIUKŲ (LOGOPEDINĖ)";4514546151;Taip;0;4;0;4
9741;Sakalėlis;"BORUŽIUKŲ (LOGOPEDINĖ)";3972897839;Taip;0;3;16;19
9742;Sakalėlis;"BORUŽIUKŲ (LOGOPEDINĖ)";2124857941;Taip;0;1;0;1
9743;Sakalėlis;"BORUŽIUKŲ (LOGOPEDINĖ)";1806698668;Ne;0;3;2;5
9744;Sakalėlis;"BORUŽIUKŲ (LOGOPEDINĖ)";6727251397;Taip;0;4;0;4
9745;Sakalėlis;"BORUŽIUKŲ (LOGOPEDINĖ)";6250400609;Taip;5;0;1;6
9746;Sakalėlis;"BORUŽIUKŲ (LOGOPEDINĖ)";8263169658;Taip;10;0;1;11
9747;Sakalėlis;MEŠKUČIŲ;9546779717;Taip;5;2;0;7
9748;Sakalėlis;MEŠKUČIŲ;8535457018;Taip;5;1;0;6
9749;Sakalėlis;MEŠKUČIŲ;7154383856;Taip;12;0;2;14
9750;Sakalėlis;MEŠKUČIŲ;5082756444;Ne;0;0;6;6
9751;Sakalėlis;MEŠKUČIŲ;7839893402;Taip;0;0;2;2
9752;Sakalėlis;MEŠKUČIŲ;3092760315;Taip;0;6;0;6
9753;Sakalėlis;MEŠKUČIŲ;3524545708;Taip;12;4;0;16
9754;Sakalėlis;MEŠKUČIŲ;5961207419;Taip;0;0;1;1
9755;Sakalėlis;MEŠKUČIŲ;5961861760;Taip;3;0;0;3
9756;Sakalėlis;MEŠKUČIŲ;5677280944;Ne;0;0;8;8
9757;Sakalėlis;MEŠKUČIŲ;2389541483;Ne;5;5;0;10
9758;Sakalėlis;MEŠKUČIŲ;4063074948;Taip;2;0;2;4
9759;Sakalėlis;MEŠKUČIŲ;8108456923;Taip;5;0;0;5
9760;Sakalėlis;MEŠKUČIŲ;7285230768;Taip;5;2;0;7
9761;Sakalėlis;MEŠKUČIŲ;8888784168;Taip;0;1;0;1
9762;Sakalėlis;MEŠKUČIŲ;9794245922;Taip;3;0;5;8
9763;Sakalėlis;MEŠKUČIŲ;8106231242;Taip;16;0;0;16
9764;Sakalėlis;MEŠKUČIŲ;4520212128;Taip;11;0;0;11
9765;Sakalėlis;MEŠKUČIŲ;7228559861;Taip;10;5;4;19
9766;Sakalėlis;MEŠKUČIŲ;1208798798;Taip;5;0;6;11
9767;Sakalėlis;KIŠKUČIŲ;2505477059;Taip;7;0;0;7
9768;Sakalėlis;KIŠKUČIŲ;1004062550;Taip;5;0;3;8
9769;Sakalėlis;KIŠKUČIŲ;5865993835;Taip;13;0;2;15
9770;Sakalėlis;KIŠKUČIŲ;2003090775;Taip;0;0;2;2
9771;Sakalėlis;KIŠKUČIŲ;8228039819;Taip;14;0;2;16
9772;Sakalėlis;KIŠKUČIŲ;7006304327;Taip;0;0;6;6
9773;Sakalėlis;KIŠKUČIŲ;6029443196;Taip;10;5;7;22
9774;Sakalėlis;KIŠKUČIŲ;4633296169;Taip;8;0;0;8
9775;Sakalėlis;KIŠKUČIŲ;4611384179;Taip;12;1;1;14
9776;Sakalėlis;KIŠKUČIŲ;4490632523;Taip;0;0;5;5
9777;Sakalėlis;KIŠKUČIŲ;8015985605;Taip;10;4;1;15
9778;Sakalėlis;KIŠKUČIŲ;5052638078;Taip;23;0;0;23
9779;Sakalėlis;KIŠKUČIŲ;5327382009;Taip;23;0;0;23
9780;Sakalėlis;KIŠKUČIŲ;6897550418;Taip;9;0;0;9
9781;Sakalėlis;KIŠKUČIŲ;9642519454;Taip;11;0;1;12
9782;Sakalėlis;KIŠKUČIŲ;5387119771;Taip;17;0;0;17
9783;Sakalėlis;KIŠKUČIŲ;6328924318;Taip;16;0;0;16
9784;Sakalėlis;SVIRPLIUKŲ;6597274376;Taip;0;1;0;1
9785;Sakalėlis;SVIRPLIUKŲ;5500248048;Taip;0;1;1;2
9786;Sakalėlis;SVIRPLIUKŲ;8562164673;Taip;5;1;1;7
9787;Sakalėlis;SVIRPLIUKŲ;2537030533;Taip;0;0;4;4
9788;Sakalėlis;SVIRPLIUKŲ;3719351129;Taip;10;0;0;10
9789;Sakalėlis;SVIRPLIUKŲ;3570413330;Taip;5;0;1;6
9790;Sakalėlis;SVIRPLIUKŲ;6889888573;Taip;0;0;2;2
9791;Sakalėlis;SVIRPLIUKŲ;7852255204;Taip;2;0;1;3
9792;Sakalėlis;SVIRPLIUKŲ;9926328835;Taip;10;4;0;14
9793;Sakalėlis;SVIRPLIUKŲ;8328069876;Taip;5;0;0;5
9794;Sakalėlis;SVIRPLIUKŲ;7480286509;Taip;0;3;2;5
9795;Sakalėlis;SVIRPLIUKŲ;2250828607;Taip;11;1;1;13
9796;Sakalėlis;SVIRPLIUKŲ;2672429406;Taip;11;1;1;13
9797;Sakalėlis;SVIRPLIUKŲ;6851247779;Taip;8;0;0;8
9798;Sakalėlis;SVIRPLIUKŲ;9776767584;Taip;23;0;0;23
9799;Sakalėlis;SVIRPLIUKŲ;1121818878;Taip;0;6;0;6
9800;Sakalėlis;SVIRPLIUKŲ;5465596207;Taip;18;0;0;18
9801;Sakalėlis;SVIRPLIUKŲ;2233966176;Taip;0;2;7;9
9802;Sakalėlis;SVIRPLIUKŲ;7079300418;Taip;4;0;1;5
9803;Sakalėlis;SVIRPLIUKŲ;8659925528;Taip;10;0;2;12
9804;Sakalėlis;GANDRIUKŲ;8502289806;Taip;5;2;0;7
9805;Sakalėlis;GANDRIUKŲ;5292978341;Taip;0;7;3;10
9806;Sakalėlis;GANDRIUKŲ;9368758708;Taip;13;0;0;13
9807;Sakalėlis;GANDRIUKŲ;8326977226;Taip;1;4;1;6
9808;Sakalėlis;GANDRIUKŲ;7384400795;Taip;10;6;0;16
9809;Sakalėlis;GANDRIUKŲ;3644413861;Taip;5;3;0;8
9810;Sakalėlis;GANDRIUKŲ;4576495786;Taip;10;1;2;13
9811;Sakalėlis;GANDRIUKŲ;4230762388;Ne;18;0;0;18
9812;Sakalėlis;GANDRIUKŲ;3228617971;Taip;10;0;5;15
9813;Sakalėlis;GANDRIUKŲ;1545323439;Taip;6;0;2;8
9814;Sakalėlis;GANDRIUKŲ;5748438461;Taip;6;0;9;15
9815;Sakalėlis;GANDRIUKŲ;2734462553;Taip;5;0;1;6
9816;Sakalėlis;GANDRIUKŲ;2481285439;Taip;8;2;0;10
9817;Sakalėlis;GANDRIUKŲ;7345113972;Taip;0;6;0;6
9818;Sakalėlis;GANDRIUKŲ;6069544792;Ne;0;0;2;2
9819;Sakalėlis;GANDRIUKŲ;5460619168;Taip;7;0;0;7
9820;Sakalėlis;GANDRIUKŲ;1560077883;Ne;9;0;6;15
9821;Salininkų;BORUŽIUKAI;8329495685;Taip;6;0;1;7
9822;Salininkų;BORUŽIUKAI;1005025619;Ne;0;12;0;12
9823;Salininkų;BORUŽIUKAI;3925860408;Taip;4;0;0;4
9824;Salininkų;BORUŽIUKAI;2146404021;Taip;6;0;0;6
9825;Salininkų;BORUŽIUKAI;8718514114;Ne;14;0;1;15
9826;Salininkų;BORUŽIUKAI;8930622266;Taip;15;3;0;18
9827;Salininkų;BORUŽIUKAI;5447236646;Taip;17;3;3;23
9828;Salininkų;BORUŽIUKAI;2208793412;Taip;7;1;0;8
9829;Salininkų;BORUŽIUKAI;1647401700;Taip;3;3;1;7
9830;Salininkų;BORUŽIUKAI;9817285587;Taip;14;0;0;14
9831;Salininkų;BORUŽIUKAI;8823595510;Taip;1;4;0;5
9832;Salininkų;BORUŽIUKAI;9416926474;Taip;12;3;0;15
9833;Salininkų;BORUŽIUKAI;5671229613;Taip;0;3;0;3
9834;Salininkų;BORUŽIUKAI;1254843449;Ne;10;0;1;11
9835;Salininkų;BORUŽIUKAI;3231379271;Taip;0;23;0;23
9836;Salininkų;BORUŽIUKAI;1346133493;Taip;0;23;0;23
9837;Salininkų;BORUŽIUKAI;2273407270;Taip;0;23;0;23
9838;Salininkų;BORUŽIUKAI;9855014750;Taip;0;0;2;2
9839;Salininkų;BORUŽIUKAI;8911016037;Taip;7;0;1;8
9840;Salininkų;GĖLYTĖS;8602489420;Taip;0;6;0;6
9841;Salininkų;GĖLYTĖS;2895782373;Taip;0;11;0;11
9842;Salininkų;GĖLYTĖS;4971070998;Taip;0;0;6;6
9843;Salininkų;GĖLYTĖS;9893985732;Taip;9;14;0;23
9844;Salininkų;GĖLYTĖS;3686372180;Taip;15;0;0;15
9845;Salininkų;GĖLYTĖS;3703729963;Taip;6;0;0;6
9846;Salininkų;GĖLYTĖS;3338213592;Taip;0;10;0;10
9847;Salininkų;GĖLYTĖS;6506819265;Taip;5;7;0;12
9848;Salininkų;GĖLYTĖS;6510096414;Taip;3;5;0;8
9849;Salininkų;GĖLYTĖS;9482632726;Taip;5;0;0;5
9850;Salininkų;GĖLYTĖS;2491796874;Taip;10;0;2;12
9851;Salininkų;GĖLYTĖS;3464228778;Taip;7;5;0;12
9852;Salininkų;GĖLYTĖS;8141168894;Taip;8;0;0;8
9853;Salininkų;GĖLYTĖS;2440831687;Taip;6;4;0;10
9854;Salininkų;GĖLYTĖS;1284909139;Ne;6;10;0;16
9855;Salininkų;GĖLYTĖS;5164367382;Ne;0;1;0;1
9856;Salininkų;GĖLYTĖS;2798153926;Taip;0;2;0;2
9857;Salininkų;GĖLYTĖS;1453214735;Taip;0;4;0;4
9858;Salininkų;DRUGELIAI;2684868661;Taip;12;0;0;12
9859;Salininkų;DRUGELIAI;8063397588;Taip;8;0;1;9
9860;Salininkų;DRUGELIAI;4333027447;Taip;19;0;0;19
9861;Salininkų;DRUGELIAI;3115232507;Taip;3;1;1;5
9862;Salininkų;DRUGELIAI;2009246885;Taip;5;0;0;5
9863;Salininkų;DRUGELIAI;3420217477;Taip;10;0;1;11
9864;Salininkų;DRUGELIAI;3890914603;Taip;8;3;0;11
9865;Salininkų;DRUGELIAI;3181932118;Taip;8;1;0;9
9866;Salininkų;DRUGELIAI;5017068344;Taip;1;0;1;2
9867;Salininkų;DRUGELIAI;3761217912;Taip;0;3;0;3
9868;Salininkų;DRUGELIAI;2208607684;Taip;14;0;0;14
9869;Salininkų;DRUGELIAI;3963410827;Taip;10;0;1;11
9870;Salininkų;DRUGELIAI;5539560359;Taip;13;0;5;18
9871;Salininkų;DRUGELIAI;5587577036;Taip;4;1;1;6
9872;Salininkų;DRUGELIAI;4529253958;Taip;5;4;1;10
9873;Salininkų;DRUGELIAI;5583804491;Taip;11;0;0;11
9874;Salininkų;DRUGELIAI;6786504670;Taip;0;1;0;1
9875;Salininkų;DRUGELIAI;7063718023;Taip;12;0;1;13
9876;Salininkų;DRUGELIAI;9018366347;Taip;10;1;0;11
9877;Salininkų;ŽIRNIUKAI;7643665643;Taip;3;3;0;6
9878;Salininkų;ŽIRNIUKAI;9198411540;Taip;12;0;0;12
9879;Salininkų;ŽIRNIUKAI;6885580632;Taip;3;8;0;11
9880;Salininkų;ŽIRNIUKAI;7409604480;Ne;10;2;2;14
9881;Salininkų;ŽIRNIUKAI;3677558828;Taip;8;1;0;9
9882;Salininkų;ŽIRNIUKAI;8095820690;Ne;5;1;0;6
9883;Salininkų;ŽIRNIUKAI;6482437251;Taip;0;0;3;3
9884;Salininkų;ŽIRNIUKAI;1380797788;Taip;11;6;0;17
9885;Salininkų;ŽIRNIUKAI;2495782496;Taip;0;5;3;8
9886;Salininkų;ŽIRNIUKAI;9896357816;Taip;0;3;0;3
9887;Salininkų;ŽIRNIUKAI;4568462071;Taip;8;0;0;8
9888;Salininkų;ŽIRNIUKAI;9137783249;Taip;10;0;0;10
9889;Salininkų;ŽIRNIUKAI;8524400656;Taip;10;0;0;10
9890;Salininkų;ŽIRNIUKAI;7463713798;Taip;3;12;0;15
9891;Salininkų;ŽIRNIUKAI;9617873735;Taip;6;1;0;7
9892;Salininkų;ŽIRNIUKAI;1111197633;Taip;0;4;3;7
9893;Salininkų;ŽIRNIUKAI;6143967744;Taip;0;0;1;1
9894;Salininkų;ŽIRNIUKAI;8552427446;Taip;0;0;19;19
9895;Salininkų;ŽIRNIUKAI;6586988786;Taip;0;4;0;4
9896;Salininkų;ŽIRNIUKAI;1587485662;Ne;5;0;0;5
9897;Salininkų;PAUKŠČIUKAI;5427013789;Taip;6;3;0;9
9898;Salininkų;PAUKŠČIUKAI;3100499807;Taip;5;3;0;8
9899;Salininkų;PAUKŠČIUKAI;6850925495;Taip;10;1;0;11
9900;Salininkų;PAUKŠČIUKAI;5867676844;Taip;8;0;0;8
9901;Salininkų;PAUKŠČIUKAI;3585435095;Taip;10;0;0;10
9902;Salininkų;PAUKŠČIUKAI;2760231414;Taip;3;1;0;4
9903;Salininkų;PAUKŠČIUKAI;7665409499;Taip;0;0;3;3
9904;Salininkų;PAUKŠČIUKAI;1658695150;Taip;0;4;8;12
9905;Salininkų;PAUKŠČIUKAI;7383557807;Taip;0;10;0;10
9906;Salininkų;PAUKŠČIUKAI;2808778763;Ne;0;10;0;10
9907;Salininkų;PAUKŠČIUKAI;6656578271;Taip;0;5;4;9
9908;Salininkų;PAUKŠČIUKAI;7737045952;Taip;6;0;1;7
9909;Salininkų;PAUKŠČIUKAI;9890660815;Taip;0;3;2;5
9910;Salininkų;PAUKŠČIUKAI;8995565864;Taip;8;3;0;11
9911;Salininkų;PAUKŠČIUKAI;7782972361;Taip;5;0;0;5
9912;Salininkų;PAUKŠČIUKAI;6327046935;Taip;0;6;2;8
9913;Salininkų;PAUKŠČIUKAI;4425748908;Taip;17;1;0;18
9914;Salininkų;PAUKŠČIUKAI;4323257798;Taip;0;2;0;2
9915;Salininkų;PAUKŠČIUKAI;6266609965;Taip;0;3;0;3
9916;Salininkų;PAUKŠČIUKAI;3737834032;Taip;0;0;3;3
9917;Salininkų;BITUTĖS;3252151974;Ne;14;0;0;14
9918;Salininkų;BITUTĖS;6845471044;Taip;15;0;1;16
9919;Salininkų;BITUTĖS;7253347059;Taip;4;0;0;4
9920;Salininkų;BITUTĖS;2467926286;Taip;23;0;0;23
9921;Salininkų;BITUTĖS;8774984357;Taip;0;0;3;3
9922;Salininkų;BITUTĖS;9902751686;Taip;6;0;0;6
9923;Salininkų;BITUTĖS;6551489987;Taip;10;3;0;13
9924;Salininkų;BITUTĖS;2073939432;Taip;5;0;1;6
9925;Salininkų;BITUTĖS;9996809930;Taip;0;0;5;5
9926;Salininkų;BITUTĖS;8992580214;Taip;4;0;0;4
9927;Salininkų;BITUTĖS;3915336062;Taip;8;0;0;8
9928;Salininkų;BITUTĖS;6577237672;Taip;0;1;0;1
9929;Salininkų;BITUTĖS;7639362434;Taip;8;0;4;12
9930;Salininkų;BITUTĖS;4480303856;Taip;0;1;0;1
9931;Salvija;Daigelis(šatil);1062662192;Taip;0;0;2;2
9932;Salvija;Daigelis(šatil);4577248630;Taip;0;12;0;12
9933;Salvija;Daigelis(šatil);9978634888;Taip;0;0;23;23
9934;Salvija;Daigelis(šatil);1676795179;Taip;3;0;5;8
9935;Salvija;Daigelis(šatil);6509829735;Taip;0;0;2;2
9936;Salvija;Daigelis(šatil);3345231579;Taip;0;0;7;7
9937;Salvija;Daigelis(šatil);3640213912;Taip;0;0;1;1
9938;Salvija;Daigelis(šatil);8337554678;Taip;0;0;1;1
9939;Salvija;Daigelis(šatil);5327735648;Taip;6;3;1;10
9940;Salvija;Daigelis(šatil);5805537864;Taip;0;4;0;4
9941;Salvija;Daigelis(šatil);1043297837;Taip;12;0;1;13
9942;Salvija;Daigelis(šatil);3857916185;Taip;0;0;2;2
9943;Salvija;Daigelis(šatil);1065575041;Taip;0;3;11;14
9944;Salvija;Daigelis(šatil);1168900211;Taip;2;0;1;3
9945;Salvija;Daigelis(šatil);7410091250;Taip;0;3;2;5
9946;Salvija;"Pienė (savjon)";5494438837;Taip;0;10;0;10
9947;Salvija;"Pienė (savjon)";8023422294;Taip;11;0;0;11
9948;Salvija;"Pienė (savjon)";4152602039;Ne;5;0;1;6
9949;Salvija;"Pienė (savjon)";8981331532;Taip;10;3;3;16
9950;Salvija;"Pienė (savjon)";7455466649;Taip;23;0;0;23
9951;Salvija;"Pienė (savjon)";8306404275;Taip;0;0;3;3
9952;Salvija;"Pienė (savjon)";8013023311;Taip;0;7;1;8
9953;Salvija;"Pienė (savjon)";1653831148;Taip;0;3;0;3
9954;Salvija;"Pienė (savjon)";4325636377;Taip;0;3;0;3
9955;Salvija;"Pienė (savjon)";1625197280;Taip;0;0;1;1
9956;Salvija;"Pienė (savjon)";8892646200;Taip;13;0;2;15
9957;Salvija;"Pienė (savjon)";7477171133;Ne;0;0;4;4
9958;Salvija;"Pienė (savjon)";6706565915;Taip;0;1;0;1
9959;Salvija;"Pienė (savjon)";8853389268;Ne;0;11;0;11
9960;Salvija;"Pienė (savjon)";3856351749;Ne;0;0;3;3
9961;Salvija;"Pienė (savjon)";7862619996;Ne;0;1;2;3
9962;Salvija;"Pienė (savjon)";3487446998;Taip;6;0;0;6
9963;Salvija;"Pienė (savjon)";4373711097;Ne;0;0;2;2
9964;Salvija;"Pienė (savjon)";5816893736;Taip;5;0;5;10
9965;Salvija;"Pienė (savjon)";1975032693;Ne;7;5;0;12
9966;Saulėtekis;BERŽELIS;3493175211;Taip;0;9;0;9
9967;Saulėtekis;BERŽELIS;8023603198;Taip;13;0;0;13
9968;Saulėtekis;BERŽELIS;8086451893;Taip;1;0;0;1
9969;Saulėtekis;BERŽELIS;9351122147;Taip;8;0;0;8
9970;Saulėtekis;BERŽELIS;6667804855;Taip;4;1;0;5
9971;Saulėtekis;BERŽELIS;1852180633;Taip;5;0;2;7
9972;Saulėtekis;BERŽELIS;5468364505;Taip;5;0;0;5
9973;Saulėtekis;BERŽELIS;4704426104;Taip;4;0;1;5
9974;Saulėtekis;BERŽELIS;7407540257;Taip;2;0;1;3
9975;Saulėtekis;BERŽELIS;7698241758;Taip;7;0;0;7
9976;Saulėtekis;BERŽELIS;5194925689;Taip;0;7;0;7
9977;Saulėtekis;BERŽELIS;1241071413;Taip;11;3;0;14
9978;Saulėtekis;BERŽELIS;7494641077;Taip;8;1;0;9
9979;Saulėtekis;BERŽELIS;1577609727;Taip;8;1;0;9
9980;Saulėtekis;BERŽELIS;2672108464;Taip;8;0;0;8
9981;Saulėtekis;BERŽELIS;9579088485;Taip;0;4;0;4
9982;Saulėtekis;BERŽELIS;2568544418;Taip;3;0;2;5
9983;Saulėtekis;BERŽELIS;8927598999;Ne;18;0;0;18
9984;Saulėtekis;BERŽELIS;9734188792;Ne;18;0;0;18
9985;Saulėtekis;BERŽELIS;6983324115;Taip;4;3;1;8
9986;Saulėtekis;BERŽELIS;8061477303;Taip;8;0;0;8
9987;Saulėtekis;BERŽELIS;7436158953;Taip;19;0;0;19
9988;Saulėtekis;ŠYPSENA;9972687066;Taip;4;3;1;8
9989;Saulėtekis;ŠYPSENA;7346852524;Taip;5;0;0;5
9990;Saulėtekis;ŠYPSENA;7893982893;Taip;0;10;0;10
9991;Saulėtekis;ŠYPSENA;7505040675;Taip;0;4;0;4
9992;Saulėtekis;ŠYPSENA;9791926936;Taip;3;0;1;4
9993;Saulėtekis;ŠYPSENA;8620689981;Taip;0;3;0;3
9994;Saulėtekis;ŠYPSENA;8143793642;Taip;0;3;0;3
9995;Saulėtekis;ŠYPSENA;7673965242;Taip;6;0;0;6
9996;Saulėtekis;ŠYPSENA;3166959569;Taip;2;0;1;3
9997;Saulėtekis;ŠYPSENA;9383567339;Taip;13;0;0;13
9998;Saulėtekis;ŠYPSENA;6608831217;Taip;12;0;0;12
9999;Saulėtekis;ŠYPSENA;7730889108;Taip;0;3;1;4
10000;Saulėtekis;ŠYPSENA;7435424899;Taip;10;3;0;13
10001;Saulėtekis;ŠYPSENA;7803735686;Taip;4;0;0;4
10002;Saulėtekis;ŠYPSENA;9694119292;Taip;23;0;0;23
10003;Saulėtekis;ŠYPSENA;8881524909;Taip;10;1;1;12
10004;Saulėtekis;ŠYPSENA;5518726567;Taip;5;0;0;5
10005;Saulėtekis;ŠYPSENA;2555073719;Ne;6;0;2;8
10006;Saulėtekis;ŠYPSENA;2177470008;Taip;6;0;4;10
10007;Saulėtekis;ŠYPSENA;4250589212;Taip;0;0;7;7
10008;Saulėtekis;NYKŠTUKAI;1896847801;Taip;11;0;0;11
10009;Saulėtekis;NYKŠTUKAI;2686041419;Taip;0;13;0;13
10010;Saulėtekis;NYKŠTUKAI;7849181976;Taip;8;0;0;8
10011;Saulėtekis;NYKŠTUKAI;5748816813;Taip;3;2;0;5
10012;Saulėtekis;NYKŠTUKAI;7555273745;Taip;15;0;0;15
10013;Saulėtekis;NYKŠTUKAI;1416983683;Taip;0;5;0;5
10014;Saulėtekis;NYKŠTUKAI;4758423356;Taip;0;7;0;7
10015;Saulėtekis;NYKŠTUKAI;9270109327;Taip;6;4;0;10
10016;Saulėtekis;NYKŠTUKAI;8273890475;Taip;0;0;2;2
10017;Saulėtekis;NYKŠTUKAI;5183297420;Taip;3;1;0;4
10018;Saulėtekis;NYKŠTUKAI;8007704080;Taip;10;3;0;13
10019;Saulėtekis;NYKŠTUKAI;8683571534;Ne;0;5;0;5
10020;Saulėtekis;NYKŠTUKAI;9481578412;Taip;23;0;0;23
10021;Saulėtekis;NYKŠTUKAI;8167740525;Taip;6;0;0;6
10022;Saulėtekis;NYKŠTUKAI;3371045145;Taip;7;0;0;7
10023;Saulėtekis;NYKŠTUKAI;9818660340;Taip;10;3;0;13
10024;Saulėtekis;NYKŠTUKAI;5888979911;Taip;6;0;0;6
10025;Saulėtekis;NYKŠTUKAI;8090571664;Taip;5;0;0;5
10026;Saulėtekis;NYKŠTUKAI;3957655772;Taip;11;0;0;11
10027;Saulėtekis;PAGRANDUKAS;8102360466;Taip;0;3;0;3
10028;Saulėtekis;PAGRANDUKAS;2371396923;Taip;6;3;1;10
10029;Saulėtekis;PAGRANDUKAS;4152255439;Taip;2;3;0;5
10030;Saulėtekis;PAGRANDUKAS;2209156661;Taip;0;7;0;7
10031;Saulėtekis;PAGRANDUKAS;5552614092;Ne;3;2;1;6
10032;Saulėtekis;PAGRANDUKAS;9497129509;Taip;0;0;1;1
10033;Saulėtekis;PAGRANDUKAS;7186085219;Taip;3;3;0;6
10034;Saulėtekis;PAGRANDUKAS;1020209414;Taip;0;2;1;3
10035;Saulėtekis;PAGRANDUKAS;8745921541;Taip;0;3;0;3
10036;Saulėtekis;PAGRANDUKAS;2728836108;Taip;0;1;4;5
10037;Saulėtekis;PAGRANDUKAS;7164579375;Ne;0;3;0;3
10038;Saulėtekis;PAGRANDUKAS;8574702901;Taip;0;3;0;3
10039;Saulėtekis;PAGRANDUKAS;9941731250;Taip;0;0;1;1
10040;Saulėtekis;PAGRANDUKAS;4038684284;Taip;12;0;0;12
10041;Saulėtekis;PAGRANDUKAS;2935641362;Taip;1;0;0;1
10042;Saulėtekis;PAGRANDUKAS;4676218435;Ne;0;3;0;3
10043;Saulėtekis;PAGRANDUKAS;7598254324;Taip;23;0;0;23
10044;Saulėtekis;PAGRANDUKAS;6026600803;Taip;10;0;3;13
10045;Saulėtekis;PAGRANDUKAS;9737568538;Taip;0;3;1;4
10046;Saulėtekis;PAGRANDUKAS;8468491266;Taip;4;3;0;7
10047;Saulėtekis;PAGRANDUKAS;6181992249;Ne;0;0;3;3
10048;Saulėtekis;PAGRANDUKAS;3366064429;Taip;5;3;0;8
10049;Saulėtekis;PAGRANDUKAS;5824537129;Taip;8;0;2;10
10050;Saulėtekis;RAMUNĖLIŲ;8739919774;Taip;12;0;0;12
10051;Saulėtekis;RAMUNĖLIŲ;2316817605;Taip;2;0;2;4
10052;Saulėtekis;RAMUNĖLIŲ;3987535802;Taip;14;0;1;15
10053;Saulėtekis;RAMUNĖLIŲ;5297650157;Taip;18;5;0;23
10054;Saulėtekis;RAMUNĖLIŲ;8348456528;Taip;6;0;0;6
10055;Saulėtekis;RAMUNĖLIŲ;1866452425;Taip;0;11;8;19
10056;Saulėtekis;RAMUNĖLIŲ;3430209353;Taip;4;0;3;7
10057;Saulėtekis;RAMUNĖLIŲ;5980690239;Taip;2;3;0;5
10058;Saulėtekis;RAMUNĖLIŲ;2786112846;Taip;8;3;0;11
10059;Saulėtekis;RAMUNĖLIŲ;8876580678;Taip;8;3;0;11
10060;Saulėtekis;RAMUNĖLIŲ;1427323748;Taip;3;0;6;9
10061;Saulėtekis;RAMUNĖLIŲ;3224110585;Taip;15;5;0;20
10062;Saulėtekis;RAMUNĖLIŲ;2002180753;Taip;17;0;0;17
10063;Saulėtekis;RAMUNĖLIŲ;3555868198;Taip;15;0;3;18
10064;Saulėtekis;RAMUNĖLIŲ;9668125862;Taip;8;0;1;9
10065;Saulėtekis;RAMUNĖLIŲ;4736430248;Taip;0;3;5;8
10066;Saulėtekis;RAMUNĖLIŲ;1108736588;Ne;3;0;0;3
10067;Saulėtekis;RAMUNĖLIŲ;3270283626;Taip;20;0;3;23
10068;Saulėtekis;RAMUNĖLIŲ;3680199463;Taip;5;3;1;9
10069;Saulėtekis;RAMUNĖLIŲ;2383861394;Taip;0;3;0;3
10070;Saulėtekis;RAMUNĖLIŲ;2872732978;Taip;9;4;0;13
10071;Saulėtekis;PASAKAITĖ;8033763960;Taip;0;3;0;3
10072;Saulėtekis;PASAKAITĖ;9428709415;Taip;23;0;0;23
10073;Saulėtekis;PASAKAITĖ;5086871001;Taip;16;0;0;16
10074;Saulėtekis;PASAKAITĖ;2446282019;Taip;6;1;0;7
10075;Saulėtekis;PASAKAITĖ;8572701238;Taip;3;1;0;4
10076;Saulėtekis;PASAKAITĖ;6063956790;Taip;0;3;0;3
10077;Saulėtekis;PASAKAITĖ;4437540996;Taip;23;0;0;23
10078;Saulėtekis;PASAKAITĖ;7407451018;Taip;0;5;0;5
10079;Saulėtekis;PASAKAITĖ;9226317303;Taip;0;3;0;3
10080;Saulėtekis;PASAKAITĖ;9267790598;Taip;0;2;0;2
10081;Saulėtekis;PASAKAITĖ;6670590135;Taip;0;1;0;1
10082;Saulėtekis;PASAKAITĖ;6720758829;Taip;0;2;0;2
10083;Saulėtekis;PASAKAITĖ;7966714585;Taip;5;3;0;8
10084;Saulėtekis;PASAKAITĖ;3224883243;Taip;5;3;0;8
10085;Saulėtekis;PASAKAITĖ;9382031144;Taip;6;3;0;9
10086;Saulėtekis;PASAKAITĖ;3371914339;Taip;5;3;0;8
10087;Saulėtekis;PASAKAITĖ;6214539956;Taip;9;1;0;10
10088;Saulėtekis;PASAKAITĖ;9584556476;Taip;0;2;3;5
10089;Saulėtekis;PASAKAITĖ;9799880235;Taip;0;9;0;9
10090;Saulėtekis;PASAKAITĖ;2469458604;Taip;6;1;0;7
10091;Saulėtekis;PASAKAITĖ;2206038658;Taip;5;0;0;5
10092;Saulėtekis;VARPELIAI;3303064486;Taip;0;5;0;5
10093;Saulėtekis;VARPELIAI;1355354514;Taip;8;0;1;9
10094;Saulėtekis;VARPELIAI;8195320453;Ne;0;0;2;2
10095;Saulėtekis;VARPELIAI;6534433593;Taip;13;0;0;13
10096;Saulėtekis;VARPELIAI;7338301696;Taip;9;3;1;13
10097;Saulėtekis;VARPELIAI;9383203972;Taip;4;0;0;4
10098;Saulėtekis;VARPELIAI;5870177112;Taip;5;0;0;5
10099;Saulėtekis;VARPELIAI;7171550857;Taip;6;0;1;7
10100;Saulėtekis;VARPELIAI;3157110037;Taip;23;0;0;23
10101;Saulėtekis;VARPELIAI;8331659142;Ne;19;0;1;20
10102;Saulėtekis;VARPELIAI;3832717108;Taip;8;0;3;11
10103;Saulėtekis;VARPELIAI;1198692142;Taip;10;0;0;10
10104;Saulėtekis;VARPELIAI;1240595768;Taip;6;0;0;6
10105;Saulėtekis;VARPELIAI;7625074947;Taip;8;0;5;13
10106;Saulėtekis;VARPELIAI;1479530265;Taip;6;3;2;11
10107;Saulėtekis;VARPELIAI;1164913351;Taip;16;0;0;16
10108;Saulėtekis;VARPELIAI;3499215193;Taip;0;0;1;1
10109;Saulėtekis;GRŪDELIS;1864236745;Taip;5;0;0;5
10110;Saulėtekis;GRŪDELIS;7171048750;Taip;0;0;1;1
10111;Saulėtekis;GRŪDELIS;6535620172;Taip;7;0;2;9
10112;Saulėtekis;GRŪDELIS;8252953405;Taip;0;3;4;7
10113;Saulėtekis;GRŪDELIS;5161940030;Taip;3;0;0;3
10114;Saulėtekis;GRŪDELIS;9646060606;Taip;0;3;0;3
10115;Saulėtekis;GRŪDELIS;1934900185;Ne;18;3;0;21
10116;Saulėtekis;GRŪDELIS;1331793286;Taip;15;3;0;18
10117;Saulėtekis;GRŪDELIS;9995919137;Taip;11;3;0;14
10118;Saulėtekis;GRŪDELIS;6928825133;Taip;5;0;0;5
10119;Saulėtekis;GRŪDELIS;8138047893;Taip;5;3;0;8
10120;Saulėtekis;GRŪDELIS;3953501167;Taip;6;0;1;7
10121;Saulėtekis;GRŪDELIS;2799966199;Ne;0;8;0;8
10122;Saulėtekis;GRŪDELIS;9556937880;Taip;5;0;0;5
10123;Saulėtekis;GRŪDELIS;2646213073;Taip;0;5;0;5
10124;Saulėtekis;GRŪDELIS;6482182524;Taip;13;0;0;13
10125;Saulėtekis;GRŪDELIS;6779891385;Taip;4;0;0;4
10126;Saulėtekis;GRŪDELIS;9743690247;Taip;11;0;2;13
10127;Saulėtekis;GRŪDELIS;7666624373;Taip;0;0;4;4
10128;Saulėtekis;JONVABALIS;1715634399;Taip;0;3;0;3
10129;Saulėtekis;JONVABALIS;7227802003;Taip;0;3;1;4
10130;Saulėtekis;JONVABALIS;4613040294;Taip;0;2;0;2
10131;Saulėtekis;JONVABALIS;1655720839;Taip;0;2;0;2
10132;Saulėtekis;JONVABALIS;3166181835;Taip;4;5;0;9
10133;Saulėtekis;JONVABALIS;6599452886;Taip;10;1;0;11
10134;Saulėtekis;JONVABALIS;8896065807;Taip;3;3;0;6
10135;Saulėtekis;JONVABALIS;2311184444;Taip;0;3;0;3
10136;Saulėtekis;JONVABALIS;9618342480;Taip;0;4;0;4
10137;Saulėtekis;JONVABALIS;1516164123;Taip;4;2;0;6
10138;Saulėtekis;JONVABALIS;60462712074;Taip;0;2;0;2
10139;Saulėtekis;JONVABALIS;1902333363;Taip;1;4;0;5
10140;Saulėtekis;JONVABALIS;4610536784;Ne;0;2;0;2
10141;Saulėtekis;JONVABALIS;6501250875;Taip;0;0;2;2
10142;Saulėtekis;JONVABALIS;8231869593;Taip;0;2;0;2
10143;Saulėtekis;JONVABALIS;8603952810;Taip;5;3;2;10
10144;Saulėtekis;JONVABALIS;9657195627;Taip;0;5;0;5
10145;Saulėtekis;JONVABALIS;3541535891;Taip;0;4;0;4
10146;Saulėtekis;JONVABALIS;4663268649;Taip;6;1;0;7
10147;Saulėtekis;SMALSUČIAI;2474900044;Taip;0;0;4;4
10148;Saulėtekis;SMALSUČIAI;7051608858;Taip;14;1;0;15
10149;Saulėtekis;SMALSUČIAI;2021901593;Taip;4;5;0;9
10150;Saulėtekis;SMALSUČIAI;5954194843;Taip;0;3;0;3
10151;Saulėtekis;SMALSUČIAI;2546789906;Taip;0;7;0;7
10152;Saulėtekis;SMALSUČIAI;4832534190;Taip;8;4;0;12
10153;Saulėtekis;SMALSUČIAI;2238947856;Taip;0;3;2;5
10154;Saulėtekis;SMALSUČIAI;5678858566;Taip;8;6;0;14
10155;Saulėtekis;SMALSUČIAI;9634949452;Taip;0;3;0;3
10156;Saulėtekis;SMALSUČIAI;3450907715;Ne;0;11;0;11
10157;Saulėtekis;SMALSUČIAI;4338502152;Taip;1;0;1;2
10158;Saulėtekis;SMALSUČIAI;81153273188;Taip;0;3;0;3
10159;Saulėtekis;SMALSUČIAI;6102064617;Taip;0;3;0;3
10160;Saulėtekis;SMALSUČIAI;7842280836;Taip;0;1;0;1
10161;Saulėtekis;SMALSUČIAI;9945647968;Taip;5;1;0;6
10162;Saulėtekis;SMALSUČIAI;9983577817;Taip;0;1;0;1
10163;Saulėtekis;SMALSUČIAI;5487547105;Ne;0;23;0;23
10164;Saulėtekis;BITUTĖS;7766084857;Taip;0;3;1;4
10165;Saulėtekis;BITUTĖS;4537254306;Taip;0;1;0;1
10166;Saulėtekis;BITUTĖS;1481503733;Ne;4;0;0;4
10167;Saulėtekis;BITUTĖS;8302260087;Taip;0;2;0;2
10168;Saulėtekis;BITUTĖS;2593106154;Taip;0;3;0;3
10169;Saulėtekis;BITUTĖS;2813949848;Taip;0;3;1;4
10170;Saulėtekis;BITUTĖS;6643388548;Taip;9;1;0;10
10171;Saulėtekis;BITUTĖS;3058991890;Taip;0;0;1;1
10172;Saulėtekis;BITUTĖS;7986712728;Taip;0;10;0;10
10173;Saulėtekis;BITUTĖS;6087170055;Taip;0;3;4;7
10174;Saulėtekis;BITUTĖS;7758268674;Taip;0;3;7;10
10175;Saulėtekis;BITUTĖS;2077976415;Taip;0;3;4;7
10176;Saulėtekis;BITUTĖS;7075757274;Taip;0;11;0;11
10177;Saulėtekis;BITUTĖS;9870595577;Taip;0;0;1;1
10178;Saulėtekis;BITUTĖS;2154590089;Taip;0;2;0;2
10179;Saulėtekis;BITUTĖS;3220993253;Taip;3;0;0;3
10180;Saulėtekis;BITUTĖS;9918219913;Taip;6;1;0;7
10181;Saulėtekis;BITUTĖS;2698535938;Taip;0;5;0;5
10182;Saulėtekis;BITUTĖS;8517049464;Taip;0;3;0;3
10183;Saulėtekis;BITUTĖS;2656659133;Taip;0;3;0;3
10184;Saulėtekis;BITUTĖS;7027103276;Taip;4;3;0;7
10185;Saulėtekis;BITUTĖS;9605052795;Taip;0;3;7;10
10186;Saulėtekis;RIEŠUTĖLIAI;8767786444;Taip;0;0;2;2
10187;Saulėtekis;RIEŠUTĖLIAI;2224626144;Taip;18;0;1;19
10188;Saulėtekis;RIEŠUTĖLIAI;9270231819;Taip;3;0;2;5
10189;Saulėtekis;RIEŠUTĖLIAI;5898051775;Taip;0;0;2;2
10190;Saulėtekis;RIEŠUTĖLIAI;7898928446;Taip;4;4;0;8
10191;Saulėtekis;RIEŠUTĖLIAI;3356705340;Taip;14;0;0;14
10192;Saulėtekis;RIEŠUTĖLIAI;2849915655;Ne;0;3;6;9
10193;Saulėtekis;RIEŠUTĖLIAI;7824492464;Taip;5;0;0;5
10194;Saulėtekis;RIEŠUTĖLIAI;3935935671;Taip;2;1;0;3
10195;Saulėtekis;RIEŠUTĖLIAI;7807096583;Taip;8;0;0;8
10196;Saulėtekis;RIEŠUTĖLIAI;2548612572;Taip;15;0;0;15
10197;Saulėtekis;RIEŠUTĖLIAI;2908714227;Taip;6;0;2;8
10198;Saulėtekis;RIEŠUTĖLIAI;7305619721;Taip;16;4;0;20
10199;Saulėtekis;RIEŠUTĖLIAI;9516841263;Taip;4;0;2;6
10200;Saulėtekis;RIEŠUTĖLIAI;6557482092;Taip;5;0;0;5
10201;Saulėtekis;RIEŠUTĖLIAI;6183384994;Taip;6;3;0;9
10202;Saulėtekis;RIEŠUTĖLIAI;1540848694;Taip;0;2;0;2
10203;Saulėtekis;RIEŠUTĖLIAI;4767842376;Taip;0;0;1;1
10204;Skroblinukas;SVIRPLIUKŲ;5433647187;Taip;0;4;0;4
10205;Skroblinukas;SVIRPLIUKŲ;2195112297;Taip;9;2;6;17
10206;Skroblinukas;SVIRPLIUKŲ;4198512202;Taip;20;0;1;21
10207;Skroblinukas;SVIRPLIUKŲ;7750501815;Taip;0;0;12;12
10208;Skroblinukas;SVIRPLIUKŲ;4960825597;Taip;7;0;2;9
10209;Skroblinukas;SVIRPLIUKŲ;1544598440;Taip;0;3;0;3
10210;Skroblinukas;SVIRPLIUKŲ;6574558658;Taip;9;2;0;11
10211;Skroblinukas;SVIRPLIUKŲ;6254811026;Taip;5;1;12;18
10212;Skroblinukas;SVIRPLIUKŲ;4861971439;Taip;6;1;2;9
10213;Skroblinukas;SVIRPLIUKŲ;7817632987;Ne;9;2;3;14
10214;Skroblinukas;SVIRPLIUKŲ;7675772872;Ne;0;0;6;6
10215;Skroblinukas;SVIRPLIUKŲ;4266945644;Taip;6;0;5;11
10216;Skroblinukas;SVIRPLIUKŲ;9003855190;Taip;0;19;1;20
10217;Skroblinukas;SVIRPLIUKŲ;7216760382;Taip;5;1;1;7
10218;Skroblinukas;SVIRPLIUKŲ;5154111867;Taip;0;4;0;4
10219;Skroblinukas;SVIRPLIUKŲ;8622930871;Taip;15;1;3;19
10220;Skroblinukas;SVIRPLIUKŲ;9661609284;Taip;4;0;1;5
10221;Skroblinukas;SVIRPLIUKŲ;7761972818;Taip;9;5;0;14
10222;Skroblinukas;SVIRPLIUKŲ;9629502585;Taip;0;7;0;7
10223;Skroblinukas;SVIRPLIUKŲ;6461678336;Taip;10;0;0;10
10224;Skroblinukas;SVIRPLIUKŲ;8283516422;Taip;5;0;1;6
10225;Skroblinukas;GANDRIUKŲ;2197158518;Taip;5;0;2;7
10226;Skroblinukas;GANDRIUKŲ;2406619611;Taip;0;6;0;6
10227;Skroblinukas;GANDRIUKŲ;9572912046;Taip;0;19;2;21
10228;Skroblinukas;GANDRIUKŲ;5646847921;Taip;4;6;0;10
10229;Skroblinukas;GANDRIUKŲ;6235844690;Taip;0;0;1;1
10230;Skroblinukas;GANDRIUKŲ;6489976163;Taip;11;0;0;11
10231;Skroblinukas;GANDRIUKŲ;1159546580;Taip;0;5;0;5
10232;Skroblinukas;GANDRIUKŲ;2630699296;Taip;0;1;1;2
10233;Skroblinukas;GANDRIUKŲ;2310750833;Taip;0;6;2;8
10234;Skroblinukas;GANDRIUKŲ;9888115079;Ne;0;2;4;6
10235;Skroblinukas;GANDRIUKŲ;9475514959;Ne;0;6;0;6
10236;Skroblinukas;GANDRIUKŲ;9031598603;Taip;9;2;0;11
10237;Skroblinukas;GANDRIUKŲ;5251903769;Ne;0;12;0;12
10238;Skroblinukas;GANDRIUKŲ;7385271438;Taip;5;0;0;5
10239;Skroblinukas;VYTURIUKŲ;3954228349;Taip;0;0;1;1
10240;Skroblinukas;VYTURIUKŲ;6879979868;Taip;0;0;1;1
10241;Skroblinukas;VYTURIUKŲ;4560580022;Taip;1;3;1;5
10242;Skroblinukas;VYTURIUKŲ;2330232287;Taip;0;0;2;2
10243;Skroblinukas;VYTURIUKŲ;3065235192;Ne;6;0;1;7
10244;Skroblinukas;VYTURIUKŲ;5902713448;Taip;10;4;0;14
10245;Skroblinukas;VYTURIUKŲ;3594000419;Taip;0;4;0;4
10246;Skroblinukas;VYTURIUKŲ;3512297435;Taip;0;4;0;4
10247;Skroblinukas;VYTURIUKŲ;2481980627;Taip;0;10;2;12
10248;Skroblinukas;VYTURIUKŲ;9725125130;Taip;0;0;1;1
10249;Skroblinukas;VYTURIUKŲ;2978284436;Taip;6;0;0;6
10250;Skroblinukas;VYTURIUKŲ;7068452970;Ne;5;0;1;6
10251;Skroblinukas;VYTURIUKŲ;3292517112;Taip;3;6;0;9
10252;Skroblinukas;VYTURIUKŲ;3461165182;Taip;0;0;14;14
10253;Skroblinukas;VYTURIUKŲ;4129726208;Taip;2;0;1;3
10254;Skroblinukas;VYTURIUKŲ;5101136022;Ne;5;3;2;10
10255;Skroblinukas;VYTURIUKŲ;9828486832;Taip;0;5;2;7
10256;Skroblinukas;GENIUKŲ;48655837755;Taip;0;4;0;4
10257;Skroblinukas;GENIUKŲ;2323980730;Taip;0;1;2;3
10258;Skroblinukas;GENIUKŲ;1325903217;Taip;0;10;1;11
10259;Skroblinukas;GENIUKŲ;8380073853;Taip;0;14;0;14
10260;Skroblinukas;GENIUKŲ;4436698905;Taip;0;2;0;2
10261;Skroblinukas;GENIUKŲ;1905085978;Taip;0;0;4;4
10262;Skroblinukas;GENIUKŲ;1557733803;Taip;0;4;0;4
10263;Skroblinukas;GENIUKŲ;9433465007;Taip;4;3;0;7
10264;Skroblinukas;GENIUKŲ;1395950886;Ne;0;4;0;4
10265;Skroblinukas;GENIUKŲ;1696303051;Taip;0;3;0;3
10266;Skroblinukas;GENIUKŲ;9846569195;Taip;0;1;3;4
10267;Skroblinukas;GENIUKŲ;4773576465;Taip;0;5;0;5
10268;Skroblinukas;GENIUKŲ;2704157855;Taip;4;4;1;9
10269;Skroblinukas;GENIUKŲ;9564385215;Taip;0;2;1;3
10270;Skroblinukas;GENIUKŲ;6129591146;Taip;0;5;0;5
10271;Skroblinukas;GENIUKŲ;3128337104;Taip;0;1;0;1
10272;Skroblinukas;GENIUKŲ;4272941994;Taip;0;4;5;9
10273;Skroblinukas;GENIUKŲ;3864043251;Taip;0;4;0;4
10274;Skroblinukas;GENIUKŲ;1064449916;Taip;0;8;3;11
10275;Skroblinukas;GENIUKŲ;2071447940;Taip;3;5;5;13
10276;Skroblinukas;BITUČIŲ;1255323441;Taip;0;3;0;3
10277;Skroblinukas;BITUČIŲ;1934804499;Taip;0;5;0;5
10278;Skroblinukas;BITUČIŲ;6604496585;Taip;0;6;0;6
10279;Skroblinukas;BITUČIŲ;3736883850;Taip;0;6;0;6
10280;Skroblinukas;BITUČIŲ;7191689856;Taip;10;3;0;13
10281;Skroblinukas;BITUČIŲ;2032621707;Taip;0;2;5;7
10282;Skroblinukas;BITUČIŲ;8277152812;Taip;0;0;1;1
10283;Skroblinukas;BITUČIŲ;8374103872;Taip;0;1;0;1
10284;Skroblinukas;BITUČIŲ;4945107862;Ne;0;0;2;2
10285;Skroblinukas;BITUČIŲ;9594078223;Taip;0;2;0;2
10286;Skroblinukas;BITUČIŲ;1688990637;Taip;6;0;0;6
10287;Skroblinukas;BITUČIŲ;1957488412;Taip;0;1;0;1
10288;Skroblinukas;BITUČIŲ;1711568129;Ne;0;3;2;5
10289;Skroblinukas;BITUČIŲ;9664357125;Taip;7;0;6;13
10290;Skroblinukas;BITUČIŲ;6227583229;Taip;0;3;0;3
10291;Skroblinukas;BORUŽĖLIŲ;8715188878;Taip;23;3;0;26
10292;Skroblinukas;BORUŽĖLIŲ;4688496560;Taip;0;0;5;5
10293;Skroblinukas;BORUŽĖLIŲ;7255510731;Taip;0;0;4;4
10294;Skroblinukas;BORUŽĖLIŲ;5841866621;Taip;5;0;5;10
10295;Skroblinukas;BORUŽĖLIŲ;9341501143;Taip;0;0;1;1
10296;Skroblinukas;BORUŽĖLIŲ;3490684777;Taip;4;0;0;4
10297;Skroblinukas;BORUŽĖLIŲ;2717586232;Taip;0;4;0;4
10298;Skroblinukas;BORUŽĖLIŲ;4840767748;Taip;5;0;0;5
10299;Skroblinukas;BORUŽĖLIŲ;5694105568;Taip;10;0;5;15
10300;Skroblinukas;BORUŽĖLIŲ;7771969055;Taip;0;0;16;16
10301;Skroblinukas;BORUŽĖLIŲ;4631657273;Taip;9;0;7;16
10302;Skroblinukas;SKRUZDĖLIUKŲ;5688453546;Taip;0;9;3;12
10303;Skroblinukas;SKRUZDĖLIUKŲ;6890306112;Taip;0;2;0;2
10304;Skroblinukas;SKRUZDĖLIUKŲ;6445065388;Taip;0;8;0;8
10305;Skroblinukas;SKRUZDĖLIUKŲ;9448253468;Taip;4;0;0;4
10306;Skroblinukas;SKRUZDĖLIUKŲ;3771045336;Taip;0;3;0;3
10307;Skroblinukas;SKRUZDĖLIUKŲ;9353353289;Taip;0;5;3;8
10308;Skroblinukas;SKRUZDĖLIUKŲ;5252389111;Taip;0;2;0;2
10309;Skroblinukas;SKRUZDĖLIUKŲ;2883593274;Taip;0;6;0;6
10310;Skroblinukas;SKRUZDĖLIUKŲ;7493915017;Taip;0;1;0;1
10311;Skroblinukas;SKRUZDĖLIUKŲ;5157913924;Taip;0;5;0;5
10312;Skroblinukas;SKRUZDĖLIUKŲ;9368764758;Taip;3;0;0;3
10313;Skroblinukas;SKRUZDĖLIUKŲ;9958188318;Taip;0;6;0;6
10314;Skroblinukas;SKRUZDĖLIUKŲ;8576448571;Taip;0;8;0;8
10315;Skroblinukas;SKRUZDĖLIUKŲ;1002570367;Ne;0;2;0;2
10316;Skroblinukas;SKRUZDĖLIUKŲ;3290115134;Taip;2;3;3;8
10317;Skroblinukas;SKRUZDĖLIUKŲ;9813249677;Taip;0;3;0;3
10318;Skroblinukas;SKRUZDĖLIUKŲ;2101748012;Taip;2;0;0;2
10319;Skroblinukas;SKRUZDĖLIUKŲ;5915278745;Taip;0;3;0;3
10320;Skroblinukas;SKRUZDĖLIUKŲ;6640062847;Ne;5;2;0;7
10321;Skroblinukas;ŽVIRBLIUKŲ;9162582460;Taip;0;2;3;5
10322;Skroblinukas;ŽVIRBLIUKŲ;7955574061;Taip;10;0;0;10
10323;Skroblinukas;ŽVIRBLIUKŲ;7489143683;Ne;0;0;5;5
10324;Skroblinukas;ŽVIRBLIUKŲ;6717008836;Taip;6;0;6;12
10325;Skroblinukas;ŽVIRBLIUKŲ;1232121301;Ne;13;1;0;14
10326;Skroblinukas;ŽVIRBLIUKŲ;1014993354;Taip;10;1;0;11
10327;Skroblinukas;ŽVIRBLIUKŲ;7527177120;Taip;0;5;1;6
10328;Skroblinukas;ŽVIRBLIUKŲ;4002729040;Taip;12;0;1;13
10329;Skroblinukas;ŽVIRBLIUKŲ;4390614970;Taip;21;0;2;23
10330;Skroblinukas;ŽVIRBLIUKŲ;6070633607;Taip;6;0;0;6
10331;Skroblinukas;ŽVIRBLIUKŲ;6135412007;Taip;20;0;0;20
10332;Skroblinukas;ŽVIRBLIUKŲ;2312400921;Taip;20;0;0;20
10333;Skroblinukas;ŽVIRBLIUKŲ;4491947846;Taip;0;11;2;13
10334;Skroblinukas;ŽIOGELIŲ;2885814517;Taip;7;0;0;7
10335;Skroblinukas;ŽIOGELIŲ;4639384934;Taip;5;0;2;7
10336;Skroblinukas;ŽIOGELIŲ;5206925237;Taip;8;0;10;18
10337;Skroblinukas;ŽIOGELIŲ;7581372511;Taip;9;0;1;10
10338;Skroblinukas;ŽIOGELIŲ;8998236911;Taip;5;1;0;6
10339;Skroblinukas;ŽIOGELIŲ;6791969485;Taip;8;3;5;16
10340;Skroblinukas;ŽIOGELIŲ;9737310101;Taip;0;0;10;10
10341;Skroblinukas;ŽIOGELIŲ;8680329175;Taip;14;4;2;20
10342;Skroblinukas;ŽIOGELIŲ;8118284793;Taip;18;0;0;18
10343;Skroblinukas;ŽIOGELIŲ;1844211217;Taip;0;0;5;5
10344;Skroblinukas;ŽIOGELIŲ;5354832150;Taip;9;10;0;19
10345;Skroblinukas;ŽIOGELIŲ;3689247672;Taip;2;1;2;5
10346;Skroblinukas;STRAZDELIŲ;1820748152;Taip;0;2;0;2
10347;Skroblinukas;STRAZDELIŲ;5946356374;Taip;13;0;1;14
10348;Skroblinukas;STRAZDELIŲ;5274898590;Taip;16;3;1;20
10349;Skroblinukas;STRAZDELIŲ;8629189405;Ne;0;2;1;3
10350;Skroblinukas;STRAZDELIŲ;4091852305;Taip;0;6;0;6
10351;Skroblinukas;STRAZDELIŲ;9809817630;Taip;23;0;0;23
10352;Skroblinukas;STRAZDELIŲ;6475609065;Taip;3;0;2;5
10353;Skroblinukas;STRAZDELIŲ;1762416639;Taip;0;1;0;1
10354;Skroblinukas;STRAZDELIŲ;3705638869;Taip;9;0;0;9
10355;Skroblinukas;STRAZDELIŲ;2511496284;Taip;4;0;7;11
10356;Skroblinukas;STRAZDELIŲ;7153774246;Ne;0;0;2;2
10357;Skroblinukas;STRAZDELIŲ;7045587415;Taip;0;0;3;3
10358;Skroblinukas;STRAZDELIŲ;3885884265;Taip;0;0;5;5
10359;Skroblinukas;STRAZDELIŲ;8544069746;Taip;0;3;0;3
10360;Skroblinukas;STRAZDELIŲ;6011466024;Ne;0;0;3;3
10361;Skroblinukas;DRUGELIŲ;8305867345;Taip;0;2;0;2
10362;Skroblinukas;DRUGELIŲ;7400908711;Ne;0;12;0;12
10363;Skroblinukas;DRUGELIŲ;3889890374;Taip;0;5;0;5
10364;Skroblinukas;DRUGELIŲ;9481718833;Taip;3;0;0;3
10365;Skroblinukas;DRUGELIŲ;8864594520;Ne;0;4;4;8
10366;Skroblinukas;DRUGELIŲ;2772360168;Taip;0;7;0;7
10367;Skroblinukas;DRUGELIŲ;3624518310;Taip;0;6;0;6
10368;Skroblinukas;DRUGELIŲ;4831370981;Taip;0;4;0;4
10369;Skroblinukas;DRUGELIŲ;5957417413;Taip;8;6;1;15
10370;Skroblinukas;DRUGELIŲ;3226115050;Taip;9;0;0;9
10371;Skroblinukas;DRUGELIŲ;2887161771;Taip;5;3;2;10
10372;Skroblinukas;DRUGELIŲ;4737605061;Ne;0;19;3;22
10373;Skroblinukas;DRUGELIŲ;2948231687;Taip;3;0;2;5
10374;Skroblinukas;DRUGELIŲ;5912771080;Taip;20;0;3;23
10375;Skroblinukas;DRUGELIŲ;7528824951;Ne;9;0;1;10
10376;Skroblinukas;DRUGELIŲ;2987938909;Taip;5;11;5;21
10377;Skroblinukas;DRUGELIŲ;8286842648;Taip;0;0;10;10
10378;Skroblinukas;DRUGELIŲ;1453029732;Taip;0;7;0;7
10379;Skroblinukas;PELĖDŽIUKŲ;8953844650;Ne;8;2;1;11
10380;Skroblinukas;PELĖDŽIUKŲ;5813075721;Taip;0;5;3;8
10381;Skroblinukas;PELĖDŽIUKŲ;3646325903;Taip;0;4;1;5
10382;Skroblinukas;PELĖDŽIUKŲ;9292990596;Ne;0;1;1;2
10383;Skroblinukas;PELĖDŽIUKŲ;8202855376;Taip;15;0;6;21
10384;Skroblinukas;PELĖDŽIUKŲ;3658815079;Taip;0;1;5;6
10385;Skroblinukas;PELĖDŽIUKŲ;4168542339;Taip;6;0;3;9
10386;Skroblinukas;PELĖDŽIUKŲ;8958893525;Taip;0;5;0;5
10387;Skroblinukas;PELĖDŽIUKŲ;6675716937;Taip;0;0;1;1
10388;Skroblinukas;PELĖDŽIUKŲ;1009065470;Ne;13;0;1;14
10389;Skroblinukas;PELĖDŽIUKŲ;9699407871;Taip;0;0;1;1
10390;Skroblinukas;PELĖDŽIUKŲ;9553242594;Taip;0;4;0;4
10391;Skroblinukas;PELĖDŽIUKŲ;3532258904;Taip;11;0;1;12
10392;Skroblinukas;PELĖDŽIUKŲ;1758987652;Taip;0;0;3;3
10393;Skroblinukas;PELĖDŽIUKŲ;8465074037;Taip;0;0;13;13
10394;Skroblinukas;PELĖDŽIUKŲ;2071093890;Taip;4;1;2;7
10395;Skroblinukas;PELĖDŽIUKŲ;9523720873;Taip;17;0;3;20
10396;Skroblinukas;PELĖDŽIUKŲ;7920117036;Taip;8;2;0;10
10397;Skroblinukas;PELĖDŽIUKŲ;2215428081;Taip;0;1;0;1
10398;Smalsučiai;Žibuoklės;3309134310;Taip;0;5;0;5
10399;Smalsučiai;Žibuoklės;2326167599;Taip;5;0;0;5
10400;Smalsučiai;Žibuoklės;4094037708;Taip;0;0;3;3
10401;Smalsučiai;Žibuoklės;5893045664;Taip;0;1;0;1
10402;Smalsučiai;Žibuoklės;2742992400;Taip;0;0;1;1
10403;Smalsučiai;Žibuoklės;6299355505;Ne;0;1;0;1
10404;Smalsučiai;Žibuoklės;7070240693;Taip;0;1;0;1
10405;Smalsučiai;Žibuoklės;3877274360;Taip;4;0;0;4
10406;Smalsučiai;Žibuoklės;7726086066;Taip;0;2;0;2
10407;Smalsučiai;Žibuoklės;5489140006;Taip;0;8;0;8
10408;Smalsučiai;Žibuoklės;5900294530;Ne;0;0;3;3
10409;Smalsučiai;Žibuoklės;1380214235;Taip;9;0;0;9
10410;Smalsučiai;Žibuoklės;8644849194;Taip;6;2;1;9
10411;Smalsučiai;Žibuoklės;4506058735;Taip;2;0;3;5
10412;Smalsučiai;Žibuoklės;6931092874;Taip;6;0;2;8
10413;Smalsučiai;Žibuoklės;3071594259;Taip;0;8;0;8
10414;Smalsučiai;Žibuoklės;7107126092;Taip;0;8;0;8
10415;Smalsučiai;Aitvarų;3349726106;Taip;11;0;0;11
10416;Smalsučiai;Aitvarų;9305837033;Taip;0;0;2;2
10417;Smalsučiai;Aitvarų;9305837033;Taip;0;0;2;2
10418;Smalsučiai;Aitvarų;9305837033;Taip;0;0;2;2
10419;Smalsučiai;Aitvarų;8877566394;Taip;2;0;5;7
10420;Smalsučiai;Aitvarų;8284740122;Ne;12;0;1;13
10421;Smalsučiai;Aitvarų;4154327720;Taip;10;0;1;11
10422;Smalsučiai;Aitvarų;8985656809;Taip;0;0;2;2
10423;Smalsučiai;Aitvarų;6032887449;Taip;4;0;0;4
10424;Smalsučiai;Aitvarų;9821259659;Taip;0;0;2;2
10425;Smalsučiai;Aitvarų;6232068532;Taip;0;2;3;5
10426;Smalsučiai;Aitvarų;3157534923;Taip;9;0;4;13
10427;Smalsučiai;Aitvarų;6825499095;Taip;5;0;8;13
10428;Smalsučiai;Aitvarų;6090244401;Taip;5;0;0;5
10429;Smalsučiai;Sraigiukų;7933302912;Taip;0;4;0;4
10430;Smalsučiai;Sraigiukų;1471941426;Taip;0;4;1;5
10431;Smalsučiai;Sraigiukų;1458544456;Ne;7;2;0;9
10432;Smalsučiai;Sraigiukų;5406430393;Taip;6;3;0;9
10433;Smalsučiai;Sraigiukų;9582225178;Taip;0;3;0;3
10434;Smalsučiai;Sraigiukų;9604182559;Taip;0;7;0;7
10435;Smalsučiai;Sraigiukų;6469604093;Taip;0;1;0;1
10436;Smalsučiai;Sraigiukų;4566816316;Taip;0;6;1;7
10437;Smalsučiai;Sraigiukų;7396172351;Taip;0;4;0;4
10438;Smalsučiai;Sraigiukų;6358800570;Taip;0;4;0;4
10439;Smalsučiai;Sraigiukų;2327930850;Taip;15;3;0;18
10440;Smalsučiai;Sraigiukų;3787937467;Taip;0;15;0;15
10441;Smalsučiai;Sraigiukų;3399798448;Taip;5;0;0;5
10442;Smalsučiai;Sraigiukų;1997966082;Taip;0;5;3;8
10443;Smalsučiai;Sraigiukų;4585930202;Taip;0;10;0;10
10444;Smalsučiai;Sraigiukų;9155011285;Taip;0;3;0;3
10445;Smalsučiai;Saulučių;1776385691;Taip;0;0;3;3
10446;Smalsučiai;Saulučių;2259361924;Taip;20;0;0;20
10447;Smalsučiai;Saulučių;1162964613;Taip;8;0;3;11
10448;Smalsučiai;Saulučių;9934952886;Taip;3;0;7;10
10449;Smalsučiai;Saulučių;9556433086;Taip;0;3;0;3
10450;Smalsučiai;Saulučių;1904973393;Taip;2;0;0;2
10451;Smalsučiai;Saulučių;3252901131;Taip;0;0;6;6
10452;Smalsučiai;Saulučių;9743116843;Taip;4;0;2;6
10453;Smalsučiai;Saulučių;2392217952;Taip;16;0;0;16
10454;Smalsučiai;Saulučių;1447512509;Taip;18;0;3;21
10455;Smalsučiai;Saulučių;2034284973;Taip;3;3;0;6
10456;Smalsučiai;Saulučių;7423419934;Taip;15;0;0;15
10457;Smalsučiai;Saulučių;7049101015;Taip;0;0;3;3
10458;Smalsučiai;Saulučių;9183519167;Taip;0;0;7;7
10459;Smalsučiai;Saulučių;5708986552;Taip;10;0;0;10
10460;Smalsučiai;Saulučių;4889923629;Taip;8;0;2;10
10461;Smalsučiai;Saulučių;8630411244;Taip;0;3;1;4
10462;Smalsučiai;Saulučių;5541908981;Taip;10;0;0;10
10463;Smalsučiai;Viščiukų;6006832443;Taip;0;3;0;3
10464;Smalsučiai;Viščiukų;9864518144;Taip;0;4;0;4
10465;Smalsučiai;Viščiukų;8128348060;Taip;14;0;3;17
10466;Smalsučiai;Viščiukų;4847584492;Taip;0;1;0;1
10467;Smalsučiai;Viščiukų;6415906523;Taip;0;4;0;4
10468;Smalsučiai;Viščiukų;9732075162;Taip;0;0;1;1
10469;Smalsučiai;Viščiukų;6090391818;Taip;7;3;0;10
10470;Smalsučiai;Viščiukų;7023531176;Taip;0;0;1;1
10471;Smalsučiai;Viščiukų;8259056296;Taip;4;0;2;6
10472;Smalsučiai;Viščiukų;7137550663;Taip;0;0;1;1
10473;Smalsučiai;Viščiukų;3757955200;Taip;10;4;0;14
10474;Smalsučiai;Viščiukų;4288788194;Taip;0;0;2;2
10475;Smalsučiai;Viščiukų;7874635165;Taip;0;3;0;3
10476;Smalsučiai;Viščiukų;5098291946;Ne;23;0;0;23
10477;Smalsučiai;Viščiukų;8578693978;Taip;0;6;0;6
10478;Smalsučiai;Viščiukų;4379645417;Taip;0;3;2;5
10479;Smalsučiai;Boružėlių;9426629964;Taip;0;5;1;6
10480;Smalsučiai;Boružėlių;2208462326;Taip;0;3;0;3
10481;Smalsučiai;Boružėlių;6643253926;Taip;0;1;0;1
10482;Smalsučiai;Boružėlių;7226242747;Taip;0;4;0;4
10483;Smalsučiai;Boružėlių;6578328053;Taip;2;0;0;2
10484;Smalsučiai;Boružėlių;69450514879;Taip;6;3;0;9
10485;Smalsučiai;Boružėlių;4740303929;Taip;0;7;0;7
10486;Smalsučiai;Boružėlių;2694575252;Taip;3;3;0;6
10487;Smalsučiai;Boružėlių;3063127699;Taip;0;3;0;3
10488;Smalsučiai;Boružėlių;2737886714;Taip;0;6;0;6
10489;Smalsučiai;Boružėlių;8523742213;Ne;6;3;1;10
10490;Smalsučiai;Boružėlių;5325706638;Taip;8;2;0;10
10491;Smalsučiai;Boružėlių;9314811354;Taip;0;10;0;10
10492;Smalsučiai;Boružėlių;9196634595;Taip;0;0;1;1
10493;Smalsučiai;Zuikių;2802867649;Taip;0;4;0;4
10494;Smalsučiai;Zuikių;96002139110;Taip;5;0;0;5
10495;Smalsučiai;Zuikių;2953239027;Ne;5;4;0;9
10496;Smalsučiai;Zuikių;5441966713;Taip;1;0;0;1
10497;Smalsučiai;Zuikių;9632022271;Taip;0;3;0;3
10498;Smalsučiai;Zuikių;8306946163;Taip;0;3;0;3
10499;Smalsučiai;Zuikių;6469044880;Taip;3;5;0;8
10500;Smalsučiai;Zuikių;2136420967;Taip;17;0;0;17
10501;Smalsučiai;Zuikių;2059832436;Ne;5;4;0;9
10502;Smalsučiai;Zuikių;1316590100;Taip;0;3;0;3
10503;Smalsučiai;Zuikių;1372591510;Taip;0;1;0;1
10504;Smalsučiai;Zuikių;8810690546;Taip;4;7;0;11
10505;Smalsučiai;Zuikių;9703726869;Taip;0;3;0;3
10506;Smalsučiai;Zuikių;9481692900;Taip;7;1;0;8
10507;Smalsučiai;Zuikių;4909226602;Taip;0;0;3;3
10508;Smalsučiai;Zuikių;6536165801;Taip;2;0;0;2
10509;Smalsučiai;Zuikių;3644256220;Taip;0;8;0;8
10510;Smalsučiai;Nykštukų;9181601713;Taip;6;1;0;7
10511;Smalsučiai;Nykštukų;7637630200;Taip;0;0;3;3
10512;Smalsučiai;Nykštukų;1247774684;Taip;0;2;1;3
10513;Smalsučiai;Nykštukų;2375360937;Taip;15;0;0;15
10514;Smalsučiai;Nykštukų;2015172985;Taip;2;0;0;2
10515;Smalsučiai;Nykštukų;8893480054;Taip;7;1;0;8
10516;Smalsučiai;Nykštukų;6996192450;Taip;3;1;3;7
10517;Smalsučiai;Nykštukų;9378696084;Taip;12;0;1;13
10518;Smalsučiai;Nykštukų;7267389695;Taip;15;0;0;15
10519;Smalsučiai;Nykštukų;6996901033;Ne;4;0;2;6
10520;Smalsučiai;Nykštukų;4847212069;Taip;0;2;4;6
10521;Smalsučiai;Nykštukų;1344461213;Taip;0;0;3;3
10522;Smalsučiai;Nykštukų;8690626891;Taip;5;6;0;11
10523;Smalsučiai;Nykštukų;5719056997;Taip;15;0;0;15
10524;Smalsučiai;Nykštukų;3646740184;Taip;12;1;0;13
10525;Smalsučiai;Nykštukų;6642882883;Taip;8;10;0;18
10526;Smalsučiai;Nykštukų;7143824796;Taip;10;0;0;10
10527;Smalsučiai;Katinėlių;4760366724;Taip;5;3;0;8
10528;Smalsučiai;Katinėlių;2045283348;Taip;12;0;0;12
10529;Smalsučiai;Katinėlių;4847029162;Taip;0;3;0;3
10530;Smalsučiai;Katinėlių;9710944054;Taip;9;0;0;9
10531;Smalsučiai;Katinėlių;5213319192;Taip;2;0;0;2
10532;Smalsučiai;Katinėlių;3782502443;Ne;0;2;0;2
10533;Smalsučiai;Katinėlių;6358968221;Taip;0;2;0;2
10534;Smalsučiai;Katinėlių;9984878984;Taip;9;1;0;10
10535;Smalsučiai;Katinėlių;2369569130;Taip;0;1;0;1
10536;Smalsučiai;Katinėlių;8724759192;Taip;0;1;0;1
10537;Smalsučiai;Katinėlių;2662588310;Ne;6;1;6;13
10538;Smalsučiai;Katinėlių;2668720481;Taip;14;1;0;15
10539;Smalsučiai;Katinėlių;3888503023;Ne;5;5;0;10
10540;Smalsučiai;Katinėlių;2926560092;Taip;0;1;0;1
10541;Smalsučiai;Katinėlių;8210141253;Taip;11;1;0;12
10542;Smalsučiai;Katinėlių;5828514911;Taip;1;0;0;1
10543;Smalsučiai;Katinėlių;6131743288;Taip;13;0;0;13
10544;Smalsučiai;Katinėlių;7318218997;Taip;4;1;0;5
10545;Smalsučiai;PELĖDŽIUKAI;1668692281;Taip;0;3;0;3
10546;Smalsučiai;PELĖDŽIUKAI;7794541741;Taip;7;3;0;10
10547;Smalsučiai;PELĖDŽIUKAI;1599488035;Taip;0;7;0;7
10548;Smalsučiai;PELĖDŽIUKAI;4727475042;Ne;0;8;0;8
10549;Smalsučiai;PELĖDŽIUKAI;8520753848;Taip;0;5;0;5
10550;Smalsučiai;PELĖDŽIUKAI;22791221635;Taip;0;3;0;3
10551;Smalsučiai;PELĖDŽIUKAI;3607226859;Taip;0;7;0;7
10552;Smalsučiai;PELĖDŽIUKAI;5159799570;Taip;0;2;1;3
10553;Smalsučiai;PELĖDŽIUKAI;19592364606;Taip;0;11;0;11
10554;Smalsučiai;PELĖDŽIUKAI;1824321380;Taip;10;3;0;13
10555;Smalsučiai;PELĖDŽIUKAI;6207026048;Taip;0;1;0;1
10556;Smalsučiai;PELĖDŽIUKAI;4145769042;Taip;0;4;0;4
10557;Smalsučiai;PELĖDŽIUKAI;6529889121;Taip;4;1;0;5
10558;Smalsučiai;PELĖDŽIUKAI;1673246147;Taip;0;7;0;7
10559;Smalsučiai;PELĖDŽIUKAI;7713078413;Taip;0;1;0;1
10560;Smalsučiai;PELĖDŽIUKAI;3627324317;Taip;0;4;0;4
10561;Smalsučiai;PELĖDŽIUKAI;5730866119;Ne;0;3;0;3
10562;Smalsučiai;PELĖDŽIUKAI;5611487967;Taip;0;11;0;11
10563;Smalsučiai;Pingvinukai;1305808180;Taip;9;0;0;9
10564;Smalsučiai;Pingvinukai;2305950301;Taip;0;0;1;1
10565;Smalsučiai;Pingvinukai;5109775795;Ne;14;0;0;14
10566;Smalsučiai;Pingvinukai;9222858199;Taip;7;0;1;8
10567;Smalsučiai;Pingvinukai;1909797307;Taip;8;0;2;10
10568;Smalsučiai;Pingvinukai;7400990599;Taip;7;0;0;7
10569;Smalsučiai;Pingvinukai;2673224420;Taip;4;0;0;4
10570;Smalsučiai;Pingvinukai;9771532192;Taip;10;11;0;21
10571;Smalsučiai;Pingvinukai;8402519872;Taip;2;0;0;2
10572;Smalsučiai;Pingvinukai;3746193901;Taip;0;9;0;9
10573;Smalsučiai;Pingvinukai;8499612926;Taip;5;0;4;9
10574;Smalsučiai;Pingvinukai;3625628040;Ne;5;0;2;7
10575;Smalsučiai;Pingvinukai;3045521655;Taip;15;0;1;16
10576;Smalsučiai;Voverikų;4811022648;Taip;3;3;0;6
10577;Smalsučiai;Voverikų;4973651632;Taip;0;0;2;2
10578;Smalsučiai;Voverikų;3509573985;Taip;15;0;0;15
10579;Smalsučiai;Voverikų;2878060759;Taip;2;1;0;3
10580;Smalsučiai;Voverikų;1485450504;Taip;4;1;1;6
10581;Smalsučiai;Voverikų;3042578767;Taip;3;6;0;9
10582;Smalsučiai;Voverikų;2070248478;Taip;12;0;1;13
10583;Smalsučiai;Voverikų;7205498813;Taip;23;0;0;23
10584;Smalsučiai;Voverikų;2612579099;Taip;16;0;0;16
10585;Smalsučiai;Voverikų;1559069582;Taip;3;0;0;3
10586;Smalsučiai;Voverikų;2885279828;Taip;5;0;2;7
10587;Smalsučiai;Voverikų;1162035522;Taip;21;0;0;21
10588;Smalsučiai;Voverikų;5964344820;Taip;9;0;0;9
10589;Spragtukas;NYKŠTUKAI;4527798635;Taip;0;1;0;1
10590;Spragtukas;NYKŠTUKAI;8551195766;Taip;3;3;0;6
10591;Spragtukas;NYKŠTUKAI;2943832694;Taip;0;3;2;5
10592;Spragtukas;NYKŠTUKAI;8297700739;Taip;0;3;0;3
10593;Spragtukas;NYKŠTUKAI;9595221494;Taip;6;2;0;8
10594;Spragtukas;NYKŠTUKAI;6185016824;Taip;13;8;0;21
10595;Spragtukas;NYKŠTUKAI;8715073512;Taip;0;0;1;1
10596;Spragtukas;NYKŠTUKAI;1710184531;Taip;6;4;1;11
10597;Spragtukas;NYKŠTUKAI;2076126173;Ne;0;6;0;6
10598;Spragtukas;NYKŠTUKAI;3012345413;Ne;0;2;0;2
10599;Spragtukas;NYKŠTUKAI;8698492694;Taip;0;11;6;17
10600;Spragtukas;NYKŠTUKAI;1150002524;Taip;10;3;0;13
10601;Spragtukas;NYKŠTUKAI;4493810276;Taip;0;1;0;1
10602;Spragtukas;NYKŠTUKAI;8288793522;Taip;22;2;3;27
10603;Spragtukas;NYKŠTUKAI;6986034864;Taip;0;5;0;5
10604;Spragtukas;NYKŠTUKAI;9665371858;Ne;0;8;0;8
10605;Spragtukas;SAULUTĖ;3337355440;Ne;0;5;0;5
10606;Spragtukas;SAULUTĖ;4669257062;Taip;4;0;0;4
10607;Spragtukas;SAULUTĖ;3692960591;Taip;3;2;0;5
10608;Spragtukas;SAULUTĖ;4586034709;Ne;4;2;0;6
10609;Spragtukas;SAULUTĖ;3968434618;Taip;0;1;0;1
10610;Spragtukas;SAULUTĖ;1150727381;Taip;4;9;0;13
10611;Spragtukas;SAULUTĖ;3948232692;Taip;0;4;0;4
10612;Spragtukas;SAULUTĖ;9149954373;Taip;7;5;0;12
10613;Spragtukas;SAULUTĖ;7511680722;Taip;0;2;0;2
10614;Spragtukas;SAULUTĖ;2987638580;Taip;0;5;1;6
10615;Spragtukas;SAULUTĖ;2879077913;Ne;0;14;0;14
10616;Spragtukas;SAULUTĖ;1998148708;Ne;10;2;0;12
10617;Spragtukas;SAULUTĖ;8227086854;Taip;0;8;0;8
10618;Spragtukas;SAULUTĖ;5697451914;Taip;0;2;0;2
10619;Spragtukas;SAULUTĖ;3086399458;Taip;10;0;1;11
10620;Spragtukas;SAULUTĖ;2879614195;Taip;0;12;0;12
10621;Spragtukas;SPINDULĖLIAI;4675031453;Taip;2;0;1;3
10622;Spragtukas;SPINDULĖLIAI;9781727236;Taip;8;0;1;9
10623;Spragtukas;SPINDULĖLIAI;1029392579;Taip;0;1;2;3
10624;Spragtukas;SPINDULĖLIAI;6417098461;Taip;0;2;1;3
10625;Spragtukas;SPINDULĖLIAI;4485715299;Taip;0;5;0;5
10626;Spragtukas;SPINDULĖLIAI;4224693184;Taip;0;0;2;2
10627;Spragtukas;SPINDULĖLIAI;2493749424;Taip;0;1;3;4
10628;Spragtukas;SPINDULĖLIAI;3411349574;Taip;0;10;0;10
10629;Spragtukas;SPINDULĖLIAI;1323065222;Taip;9;3;0;12
10630;Spragtukas;SPINDULĖLIAI;1827458781;Taip;0;3;8;11
10631;Spragtukas;SPINDULĖLIAI;4764295850;Taip;0;23;0;23
10632;Spragtukas;SPINDULĖLIAI;6385589724;Taip;1;0;7;8
10633;Spragtukas;SPINDULĖLIAI;8912031554;Taip;6;0;7;13
10634;Spragtukas;SPINDULĖLIAI;3798118695;Taip;0;11;0;11
10635;Spragtukas;GINTARĖLIAI;5724874569;Taip;0;10;0;10
10636;Spragtukas;GINTARĖLIAI;1430632638;Taip;0;1;0;1
10637;Spragtukas;GINTARĖLIAI;2255007161;Taip;0;13;0;13
10638;Spragtukas;GINTARĖLIAI;6493380877;Taip;6;0;0;6
10639;Spragtukas;GINTARĖLIAI;5427116799;Taip;0;0;1;1
10640;Spragtukas;GINTARĖLIAI;9664130733;Taip;11;6;0;17
10641;Spragtukas;GINTARĖLIAI;8698469979;Taip;10;16;7;33
10642;Spragtukas;GINTARĖLIAI;1747417905;Taip;0;1;1;2
10643;Spragtukas;GINTARĖLIAI;6388163866;Taip;18;1;5;24
10644;Spragtukas;GINTARĖLIAI;8191270443;Taip;6;0;3;9
10645;Spragtukas;GINTARĖLIAI;3684183344;Ne;1;5;0;6
10646;Spragtukas;GINTARĖLIAI;7806145224;Ne;5;0;3;8
10647;Spragtukas;GINTARĖLIAI;3170388518;Taip;0;4;29;33
10648;Spragtukas;GINTARĖLIAI;2992201984;Taip;9;0;0;9
10649;Spragtukas;GINTARĖLIAI;2217627240;Taip;0;3;14;17
10650;Spragtukas;ČIPOLINO;2371848091;Taip;0;11;0;11
10651;Spragtukas;ČIPOLINO;6582680700;Taip;8;5;0;13
10652;Spragtukas;ČIPOLINO;1599958343;Taip;0;2;0;2
10653;Spragtukas;ČIPOLINO;1547670082;Ne;0;17;0;17
10654;Spragtukas;ČIPOLINO;7504632314;Taip;0;2;0;2
10655;Spragtukas;ČIPOLINO;1597988501;Taip;4;1;0;5
10656;Spragtukas;ČIPOLINO;6526633051;Taip;7;1;0;8
10657;Spragtukas;ČIPOLINO;1058970799;Taip;0;5;0;5
10658;Spragtukas;ČIPOLINO;45661532130;Taip;0;3;0;3
10659;Spragtukas;ČIPOLINO;3045382299;Taip;0;3;0;3
10660;Spragtukas;ČIPOLINO;7640805299;Taip;0;8;0;8
10661;Spragtukas;ČIPOLINO;1365907314;Taip;0;4;0;4
10662;Spragtukas;ČIPOLINO;4941531443;Taip;0;4;0;4
10663;Spragtukas;ČIPOLINO;3566797064;Taip;9;1;0;10
10664;Spragtukas;ČIPOLINO;69114720307;Ne;0;9;0;9
10665;Spragtukas;ČIPOLINO;1044112039;Taip;6;2;0;8
10666;Spragtukas;ČIPOLINO;5707084920;Taip;7;6;0;13
10667;Spragtukas;ČIPOLINO;1482803930;Taip;9;13;0;22
10668;Spragtukas;ČIPOLINO;3356307067;Taip;4;6;5;15
10669;Spragtukas;ČIPOLINO;2691004546;Taip;24;6;0;30
10670;Spragtukas;BORUŽĖLĖS;8614890958;Taip;5;10;0;15
10671;Spragtukas;BORUŽĖLĖS;6548270099;Taip;4;3;0;7
10672;Spragtukas;BORUŽĖLĖS;2356476212;Taip;17;0;4;21
10673;Spragtukas;BORUŽĖLĖS;8287102733;Taip;9;7;0;16
10674;Spragtukas;BORUŽĖLĖS;6584145176;Taip;0;6;0;6
10675;Spragtukas;BORUŽĖLĖS;9965087132;Taip;8;1;0;9
10676;Spragtukas;BORUŽĖLĖS;5150028968;Taip;4;3;0;7
10677;Spragtukas;BORUŽĖLĖS;9754594384;Taip;4;9;0;13
10678;Spragtukas;BORUŽĖLĖS;6824861247;Taip;7;6;0;13
10679;Spragtukas;BORUŽĖLĖS;7264683147;Taip;9;0;2;11
10680;Spragtukas;BORUŽĖLĖS;5556920140;Taip;0;9;0;9
10681;Spragtukas;BORUŽĖLĖS;4347275614;Taip;5;0;5;10
10682;Spragtukas;BORUŽĖLĖS;7073092344;Taip;30;0;0;30
10683;Spragtukas;BORUŽĖLĖS;1046613540;Taip;6;3;0;9
10684;Spragtukas;DRUGELIAI;1514277186;Taip;0;10;0;10
10685;Spragtukas;DRUGELIAI;1326603216;Taip;0;2;0;2
10686;Spragtukas;DRUGELIAI;5306883933;Taip;0;2;0;2
10687;Spragtukas;DRUGELIAI;6573750143;Taip;0;6;0;6
10688;Spragtukas;DRUGELIAI;6800727630;Taip;0;3;0;3
10689;Spragtukas;DRUGELIAI;72636559695;Taip;8;3;2;13
10690;Spragtukas;DRUGELIAI;1384812263;Taip;0;3;0;3
10691;Spragtukas;DRUGELIAI;1849644444;Taip;0;1;0;1
10692;Spragtukas;DRUGELIAI;3654640843;Taip;0;3;0;3
10693;Spragtukas;DRUGELIAI;4929866385;Taip;5;1;0;6
10694;Spragtukas;DRUGELIAI;8246512283;Taip;0;4;0;4
10695;Spragtukas;DRUGELIAI;9045185920;Taip;4;3;0;7
10696;Spragtukas;DRUGELIAI;1627243902;Taip;0;1;0;1
10697;Spragtukas;DRUGELIAI;8463747761;Taip;0;3;0;3
10698;Spragtukas;DRUGELIAI;70413855110;Taip;19;0;0;19
10699;Spragtukas;GAIDELIAI;2541126095;Taip;11;0;10;21
10700;Spragtukas;GAIDELIAI;4097458544;Taip;0;2;6;8
10701;Spragtukas;GAIDELIAI;8957903306;Taip;4;2;2;8
10702;Spragtukas;GAIDELIAI;1326714513;Ne;0;2;4;6
10703;Spragtukas;GAIDELIAI;4676052255;Taip;13;8;10;31
10704;Spragtukas;GAIDELIAI;6370760287;Taip;2;0;0;2
10705;Spragtukas;GAIDELIAI;7911124524;Taip;0;2;5;7
10706;Spragtukas;GAIDELIAI;9509296936;Taip;4;1;2;7
10707;Spragtukas;GAIDELIAI;3216796441;Taip;10;5;1;16
10708;Spragtukas;GAIDELIAI;8440836721;Taip;14;0;0;14
10709;Spragtukas;GAIDELIAI;4535021524;Taip;4;5;2;11
10710;Spragtukas;GAIDELIAI;2679834328;Taip;0;1;0;1
10711;Spragtukas;GAIDELIAI;4088247584;Ne;10;2;10;22
10712;Spragtukas;GAIDELIAI;7313963137;Taip;0;0;1;1
10713;Spragtukas;ŽUVELĖS;9078163633;Taip;6;1;0;7
10714;Spragtukas;ŽUVELĖS;8762832644;Taip;0;1;0;1
10715;Spragtukas;ŽUVELĖS;8652973900;Taip;14;0;0;14
10716;Spragtukas;ŽUVELĖS;3261213140;Taip;0;1;0;1
10717;Spragtukas;ŽUVELĖS;5689392663;Taip;5;3;0;8
10718;Spragtukas;ŽUVELĖS;9592271053;Ne;0;3;0;3
10719;Spragtukas;ŽUVELĖS;1272075883;Taip;5;3;0;8
10720;Spragtukas;ŽUVELĖS;6465991136;Taip;0;4;0;4
10721;Spragtukas;ŽUVELĖS;9282940430;Taip;0;3;0;3
10722;Spragtukas;ŽUVELĖS;6503842956;Taip;0;1;0;1
10723;Spragtukas;ŽUVELĖS;3139748724;Taip;17;0;1;18
10724;Spragtukas;ŽUVELĖS;8640877497;Taip;6;1;2;9
10725;Spragtukas;ŽUVELĖS;2025314314;Taip;0;0;3;3
10726;Spragtukas;ŽUVELĖS;4848647219;Taip;5;3;5;13
10727;Spragtukas;ŽUVELĖS;5836788916;Taip;7;1;0;8
10728;Spragtukas;ŽUVELĖS;5704941595;Taip;0;6;0;6
10729;Spragtukas;ŽUVELĖS;3286456855;Taip;0;1;0;1
10730;Spragtukas;ŽUVELĖS;9662188102;Taip;0;1;1;2
10731;Spragtukas;ŽUVELĖS;2539660577;Taip;0;6;0;6
10732;Spragtukas;ŽUVELĖS;6836232179;Taip;0;5;0;5
10733;Spragtukas;RIEŠUTĖLIAI;3187815703;Taip;6;8;2;16
10734;Spragtukas;RIEŠUTĖLIAI;8684246143;Taip;13;0;0;13
10735;Spragtukas;RIEŠUTĖLIAI;1407611561;Taip;4;0;7;11
10736;Spragtukas;RIEŠUTĖLIAI;8773952377;Ne;5;8;0;13
10737;Spragtukas;RIEŠUTĖLIAI;1977526177;Taip;5;0;0;5
10738;Spragtukas;RIEŠUTĖLIAI;7615522850;Taip;13;2;0;15
10739;Spragtukas;RIEŠUTĖLIAI;6797841737;Ne;0;1;0;1
10740;Spragtukas;RIEŠUTĖLIAI;9204569123;Taip;0;1;1;2
10741;Spragtukas;RIEŠUTĖLIAI;8342098575;Taip;3;0;2;5
10742;Spragtukas;RIEŠUTĖLIAI;1992850470;Taip;0;1;2;3
10743;Spragtukas;RIEŠUTĖLIAI;6158327941;Taip;7;4;4;15
10744;Spragtukas;RIEŠUTĖLIAI;4134127256;Taip;1;0;1;2
10745;Spragtukas;RIEŠUTĖLIAI;1946493379;Taip;18;0;0;18
10746;Spragtukas;RIEŠUTĖLIAI;3009567338;Taip;2;0;0;2
10747;Spragtukas;RIEŠUTĖLIAI;2648358901;Ne;14;3;0;17
10748;Spragtukas;RIEŠUTĖLIAI;3822599790;Taip;0;14;0;14
10749;Spragtukas;RIEŠUTĖLIAI;7767940027;Taip;3;2;2;7
10750;Spragtukas;RIEŠUTĖLIAI;4625065223;Taip;5;0;0;5
10751;Spragtukas;RIEŠUTĖLIAI;6963190259;Taip;12;0;0;12
10752;Spragtukas;RIEŠUTĖLIAI;8732886749;Taip;0;2;4;6
10753;Spragtukas;RIEŠUTĖLIAI;1946493379;Taip;6;0;2;8
10754;Spragtukas;VIŠČIUKAI;8473814776;Taip;4;0;0;4
10755;Spragtukas;VIŠČIUKAI;9294770557;Taip;17;0;0;17
10756;Spragtukas;VIŠČIUKAI;9443091032;Taip;9;0;0;9
10757;Spragtukas;VIŠČIUKAI;4461217748;Taip;0;4;2;6
10758;Spragtukas;VIŠČIUKAI;7412489884;Taip;23;0;0;23
10759;Spragtukas;VIŠČIUKAI;2087416420;Taip;5;2;0;7
10760;Spragtukas;VIŠČIUKAI;7933945356;Taip;1;0;0;1
10761;Spragtukas;VIŠČIUKAI;5948139350;Taip;5;0;0;5
10762;Spragtukas;VIŠČIUKAI;8110631015;Taip;8;0;0;8
10763;Spragtukas;VIŠČIUKAI;4089551688;Taip;4;0;0;4
10764;Spragtukas;VIŠČIUKAI;7522592685;Taip;10;0;4;14
10765;Spragtukas;MEŠKIUKAI;7271482702;Taip;5;4;4;13
10766;Spragtukas;MEŠKIUKAI;9099921999;Taip;4;0;0;4
10767;Spragtukas;MEŠKIUKAI;8307801987;Ne;12;1;0;13
10768;Spragtukas;MEŠKIUKAI;9975308171;Taip;11;2;9;22
10769;Spragtukas;MEŠKIUKAI;1493711333;Ne;5;2;1;8
10770;Spragtukas;MEŠKIUKAI;4742132709;Taip;0;16;0;16
10771;Spragtukas;MEŠKIUKAI;5225669850;Taip;5;1;0;6
10772;Spragtukas;MEŠKIUKAI;8109894184;Taip;5;4;0;9
10773;Spragtukas;MEŠKIUKAI;8396134652;Taip;15;0;0;15
10774;Spragtukas;MEŠKIUKAI;1784758799;Taip;0;3;2;5
10775;Spragtukas;MEŠKIUKAI;4441290823;Taip;5;0;0;5
10776;Spragtukas;MEŠKIUKAI;9310818975;Taip;8;0;1;9
10777;Spragtukas;MEŠKIUKAI;8486415968;Taip;10;0;0;10
10778;Spragtukas;MEŠKIUKAI;1083785206;Taip;7;0;0;7
10779;Spragtukas;MEŠKIUKAI;2026249018;Ne;0;1;0;1
10780;Spragtukas;MEŠKIUKAI;3423699840;Taip;16;2;0;18
10781;Strazdelis;Žiogelių;5346485534;Taip;0;1;0;1
10782;Strazdelis;Žiogelių;9933042249;Taip;0;9;0;9
10783;Strazdelis;Žiogelių;8581533423;Taip;18;0;0;18
10784;Strazdelis;Žiogelių;8209625399;Taip;9;3;0;12
10785;Strazdelis;Žiogelių;1141752802;Taip;12;0;0;12
10786;Strazdelis;Žiogelių;1228651165;Taip;0;1;0;1
10787;Strazdelis;Žiogelių;7768700192;Ne;15;0;0;15
10788;Strazdelis;Žiogelių;3596394112;Taip;3;1;0;4
10789;Strazdelis;Žiogelių;8493572399;Taip;20;0;2;22
10790;Strazdelis;Žiogelių;4563247013;Taip;23;0;0;23
10791;Strazdelis;Žiogelių;6437928004;Taip;10;1;1;12
10792;Strazdelis;Žiogelių;5600979545;Taip;5;8;0;13
10793;Strazdelis;Žiogelių;8971395173;Taip;0;1;0;1
10794;Strazdelis;Žiogelių;4955907851;Taip;18;0;0;18
10795;Strazdelis;Žiogelių;7425818775;Ne;13;1;0;14
10796;Strazdelis;Žiogelių;9567476872;Taip;15;0;0;15
10797;Strazdelis;Žiogelių;4516288199;Taip;3;1;0;4
10798;Strazdelis;Žiogelių;3028208428;Taip;0;1;0;1
10799;Strazdelis;Žiogelių;2753635198;Taip;0;2;5;7
10800;Strazdelis;Žiogelių;1194918926;Taip;0;0;10;10
10801;Strazdelis;Žiogelių;6651360492;Taip;0;12;0;12
10802;Strazdelis;Šeimynėlės;7905687363;Taip;5;1;0;6
10803;Strazdelis;Šeimynėlės;4501391298;Taip;19;0;0;19
10804;Strazdelis;Šeimynėlės;1277844969;Taip;1;0;0;1
10805;Strazdelis;Šeimynėlės;1012692326;Taip;12;1;0;13
10806;Strazdelis;Šeimynėlės;8899530711;Taip;23;0;0;23
10807;Strazdelis;Šeimynėlės;8336759173;Taip;14;0;0;14
10808;Strazdelis;Šeimynėlės;5784406335;Taip;2;7;0;9
10809;Strazdelis;Šeimynėlės;2068793184;Taip;0;3;0;3
10810;Strazdelis;Šeimynėlės;5296218650;Taip;15;0;0;15
10811;Strazdelis;Šeimynėlės;1754106518;Taip;0;4;0;4
10812;Strazdelis;Šeimynėlės;9806107189;Taip;6;4;0;10
10813;Strazdelis;Šeimynėlės;1553329770;Taip;5;0;0;5
10814;Strazdelis;Genelio;8686828982;Taip;0;4;0;4
10815;Strazdelis;Genelio;8277333786;Taip;5;0;0;5
10816;Strazdelis;Genelio;9586256979;Taip;0;1;0;1
10817;Strazdelis;Genelio;3084249678;Taip;0;1;0;1
10818;Strazdelis;Genelio;5499310072;Taip;0;0;4;4
10819;Strazdelis;Genelio;8333151969;Taip;0;3;0;3
10820;Strazdelis;Genelio;7083940713;Taip;0;2;0;2
10821;Strazdelis;Genelio;6271193831;Taip;5;2;0;7
10822;Strazdelis;Genelio;6480803618;Taip;11;3;0;14
10823;Strazdelis;Genelio;9490861272;Taip;15;3;0;18
10824;Strazdelis;Genelio;6071502600;Taip;0;3;0;3
10825;Strazdelis;Genelio;3713797440;Taip;0;3;0;3
10826;Strazdelis;Genelio;3456287323;Taip;13;3;0;16
10827;Strazdelis;Genelio;2459718449;Taip;0;6;0;6
10828;Strazdelis;Genelio;5714581201;Taip;0;7;0;7
10829;Strazdelis;Genelio;8956634754;Taip;2;1;0;3
10830;Strazdelis;Genelio;8762859576;Taip;3;0;7;10
10831;Strazdelis;Genelio;2306665561;Taip;0;5;0;5
10832;Strazdelis;Genelio;7680242840;Taip;23;0;0;23
10833;Strazdelis;Genelio;5742215922;Ne;0;3;2;5
10834;Strazdelis;Vikruolių;2078150337;Taip;5;2;0;7
10835;Strazdelis;Vikruolių;8182994112;Taip;5;0;0;5
10836;Strazdelis;Vikruolių;1362428967;Taip;0;1;0;1
10837;Strazdelis;Vikruolių;9198429790;Taip;0;10;0;10
10838;Strazdelis;Vikruolių;4655931716;Taip;0;3;0;3
10839;Strazdelis;Vikruolių;8634815556;Taip;0;0;3;3
10840;Strazdelis;Vikruolių;6147183190;Taip;0;5;0;5
10841;Strazdelis;Vikruolių;7216768880;Taip;0;5;0;5
10842;Strazdelis;Vikruolių;7823110477;Ne;0;14;0;14
10843;Strazdelis;Vikruolių;9904719582;Taip;9;1;0;10
10844;Strazdelis;Vikruolių;7308925265;Taip;3;1;0;4
10845;Strazdelis;Vikruolių;50350281905;Taip;0;6;0;6
10846;Strazdelis;Vikruolių;8038163444;Taip;0;3;0;3
10847;Strazdelis;Vikruolių;1540973269;Taip;0;1;0;1
10848;Strazdelis;Vikruolių;8801420992;Taip;0;10;0;10
10849;Strazdelis;Vikruolių;5580738386;Taip;0;3;0;3
10850;Strazdelis;Vikruolių;3955783379;Taip;8;2;0;10
10851;Strazdelis;Vikruolių;4430183106;Ne;9;5;0;14
10852;Strazdelis;Vikruolių;4076266466;Taip;0;2;0;2
10853;Strazdelis;Vyturėlių;4454199703;Taip;3;1;0;4
10854;Strazdelis;Vyturėlių;3662217925;Ne;0;1;0;1
10855;Strazdelis;Vyturėlių;4698566091;Taip;0;3;0;3
10856;Strazdelis;Vyturėlių;8274897977;Taip;0;2;0;2
10857;Strazdelis;Vyturėlių;1665134387;Taip;0;3;0;3
10858;Strazdelis;Vyturėlių;45083023033;Taip;0;4;0;4
10859;Strazdelis;Vyturėlių;43314069648;Taip;0;4;0;4
10860;Strazdelis;Vyturėlių;1481671624;Taip;0;4;0;4
10861;Strazdelis;Vyturėlių;4697537943;Ne;0;1;0;1
10862;Strazdelis;Vyturėlių;6014213362;Taip;0;1;0;1
10863;Strazdelis;Vyturėlių;7900362267;Taip;0;2;0;2
10864;Strazdelis;Vyturėlių;9835716116;Taip;0;3;0;3
10865;Strazdelis;Vyturėlių;3943578036;Taip;0;7;0;7
10866;Strazdelis;Vyturėlių;2802486859;Taip;0;3;0;3
10867;Strazdelis;Vyturėlių;3482802557;Taip;0;1;0;1
10868;Strazdelis;Vyturėlių;5749300013;Taip;0;2;0;2
10869;Strazdelis;Vyturėlių;7215063033;Taip;1;1;0;2
10870;Strazdelis;Vyturėlių;7149827850;Taip;0;4;0;4
10871;Strazdelis;Vyturėlių;5834348507;Taip;0;2;0;2
10872;Strazdelis;Vyturėlių;2238875354;Taip;0;1;0;1
10873;Strazdelis;Varpelio;4159072583;Taip;0;6;0;6
10874;Strazdelis;Varpelio;2662549392;Taip;0;3;0;3
10875;Strazdelis;Varpelio;9502341478;Taip;0;3;0;3
10876;Strazdelis;Varpelio;6311710825;Taip;1;3;0;4
10877;Strazdelis;Varpelio;4873707286;Taip;0;2;0;2
10878;Strazdelis;Varpelio;6527855940;Ne;3;6;0;9
10879;Strazdelis;Varpelio;2824416350;Taip;0;3;0;3
10880;Strazdelis;Varpelio;3610250359;Taip;5;4;0;9
10881;Strazdelis;Varpelio;2766970956;Ne;0;9;0;9
10882;Strazdelis;Varpelio;1173067724;Taip;4;5;0;9
10883;Strazdelis;Varpelio;1021364759;Taip;7;3;0;10
10884;Strazdelis;Varpelio;7469848482;Taip;16;0;0;16
10885;Strazdelis;Varpelio;7393083827;Taip;0;2;0;2
10886;Strazdelis;Varpelio;1706026100;Taip;0;2;0;2
10887;Strazdelis;Varpelio;8035603341;Taip;0;1;0;1
10888;Strazdelis;Varpelio;2789987994;Taip;0;7;0;7
10889;Strazdelis;Varpelio;2251157025;Taip;5;1;0;6
10890;Strazdelis;Varpelio;5904388732;Taip;0;5;0;5
10891;Strazdelis;Varpelio;3460993302;Taip;0;2;0;2
10892;Strazdelis;Pelėdžiukų;5892430004;Taip;8;5;0;13
10893;Strazdelis;Pelėdžiukų;8637386316;Taip;3;1;0;4
10894;Strazdelis;Pelėdžiukų;1704292727;Taip;2;3;0;5
10895;Strazdelis;Pelėdžiukų;8371999002;Taip;0;4;0;4
10896;Strazdelis;Pelėdžiukų;6046139859;Taip;1;0;0;1
10897;Strazdelis;Pelėdžiukų;8287554571;Taip;0;1;0;1
10898;Strazdelis;Pelėdžiukų;4448556404;Taip;15;0;0;15
10899;Strazdelis;Pelėdžiukų;8854150040;Taip;0;3;0;3
10900;Strazdelis;Pelėdžiukų;4004930488;Taip;3;3;0;6
10901;Strazdelis;Pelėdžiukų;5768674837;Taip;8;0;0;8
10902;Strazdelis;Pelėdžiukų;9761595867;Taip;7;0;0;7
10903;Strazdelis;Pelėdžiukų;7876385010;Taip;9;0;0;9
10904;Strazdelis;Pelėdžiukų;2848984531;Taip;0;3;0;3
10905;Strazdelis;Pelėdžiukų;1420438624;Ne;0;3;0;3
10906;Strazdelis;Pelėdžiukų;1901641517;Taip;4;4;0;8
10907;Strazdelis;Pelėdžiukų;4617237063;Taip;4;6;0;10
10908;Strazdelis;Pelėdžiukų;3036380561;Taip;0;8;0;8
10909;Strazdelis;Pelėdžiukų;7471890377;Taip;0;1;0;1
10910;Strazdelis;Pelėdžiukų;7349106795;Taip;0;3;0;3
10911;Strazdelis;Pelėdžiukų;2852253325;Ne;0;1;0;1
10912;Strazdelis;Pelėdžiukų;8938997208;Ne;0;3;0;3
10913;Strazdelis;Pelėdžiukų;4562530311;Taip;0;4;0;4
10914;Strazdelis;Saulutės;27177757900;Taip;0;5;0;5
10915;Strazdelis;Saulutės;40932140069;Taip;5;4;0;9
10916;Strazdelis;Saulutės;1523471662;Taip;0;4;0;4
10917;Strazdelis;Saulutės;2854642875;Taip;0;3;0;3
10918;Strazdelis;Saulutės;7578229276;Taip;0;1;0;1
10919;Strazdelis;Saulutės;8710848483;Taip;0;1;0;1
10920;Strazdelis;Saulutės;6614184499;Taip;3;1;0;4
10921;Strazdelis;Saulutės;4129957131;Taip;5;3;0;8
10922;Strazdelis;Saulutės;3425430317;Taip;0;3;0;3
10923;Strazdelis;Saulutės;7081517417;Taip;0;4;0;4
10924;Strazdelis;Saulutės;67641340859;Taip;0;1;0;1
10925;Strazdelis;Saulutės;15298412755;Taip;0;5;0;5
10926;Strazdelis;Saulutės;1802092125;Ne;1;3;0;4
10927;Strazdelis;Saulutės;1391009140;Taip;0;4;0;4
10928;Strazdelis;Saulutės;8808299050;Taip;0;3;0;3
10929;Strazdelis;Saulutės;3270413614;Taip;3;1;0;4
10930;Strazdelis;Saulutės;3316451889;Taip;0;1;0;1
10931;Strazdelis;Saulutės;6113491562;Taip;0;1;0;1
10932;Strazdelis;Saulutės;3753612757;Taip;0;1;0;1
10933;Strazdelis;Saulutės;1474503932;Taip;0;3;0;3
10934;Strazdelis;Saulutės;9662566992;Ne;0;1;0;1
10935;Strazdelis;Bitutės;8485509145;Taip;0;6;0;6
10936;Strazdelis;Bitutės;6508933324;Taip;0;3;0;3
10937;Strazdelis;Bitutės;4020547762;Taip;0;2;0;2
10938;Strazdelis;Bitutės;8753316532;Ne;5;4;0;9
10939;Strazdelis;Bitutės;5232064496;Taip;0;5;0;5
10940;Strazdelis;Bitutės;9435593972;Taip;0;1;0;1
10941;Strazdelis;Bitutės;9555240419;Taip;0;7;0;7
10942;Strazdelis;Bitutės;3043580835;Taip;0;6;0;6
10943;Strazdelis;Bitutės;1539984888;Taip;0;1;0;1
10944;Strazdelis;Bitutės;4400849922;Ne;1;2;0;3
10945;Strazdelis;Bitutės;7890064837;Taip;0;6;0;6
10946;Strazdelis;Bitutės;1881071425;Taip;0;7;0;7
10947;Strazdelis;Bitutės;2908567982;Taip;0;8;0;8
10948;Strazdelis;Bitutės;9548465554;Taip;0;15;0;15
10949;Strazdelis;Bitutės;4463378251;Taip;3;0;0;3
10950;Strazdelis;Bitutės;2963535523;Taip;0;1;0;1
10951;Strazdelis;Bitutės;4369569609;Taip;0;2;0;2
10952;Strazdelis;Bitutės;1005082012;Taip;0;4;0;4
10953;Strazdelis;Bitutės;2081538505;Taip;0;8;0;8
10954;Strazdelis;Bitutės;4784401449;Taip;0;1;0;1
10955;Strazdelis;Mažylių;9357195019;Taip;0;1;0;1
10956;Strazdelis;Mažylių;5256750516;Taip;0;4;0;4
10957;Strazdelis;Mažylių;4965049621;Taip;0;2;2;4
10958;Strazdelis;Mažylių;9383398775;Taip;4;1;0;5
10959;Strazdelis;Mažylių;4699373769;Taip;3;0;0;3
10960;Strazdelis;Mažylių;3648883435;Taip;12;0;0;12
10961;Strazdelis;Mažylių;6788732053;Taip;17;6;0;23
10962;Strazdelis;Mažylių;2764495554;Taip;17;6;0;23
10963;Strazdelis;Mažylių;4904388387;Ne;4;1;0;5
10964;Strazdelis;Mažylių;3082900425;Taip;6;1;0;7
10965;Strazdelis;Mažylių;1265557971;Taip;7;3;3;13
10966;Strazdelis;Mažylių;3900225484;Taip;10;0;2;12
10967;Strazdelis;Mažylių;8734458997;Taip;0;2;3;5
10968;Strazdelis;Mažylių;3561551193;Taip;6;0;0;6
10969;Strazdelis;Mažylių;1932428439;Taip;0;3;0;3
10970;Strazdelis;Mažylių;2871841427;Taip;13;1;0;14
10971;Strazdelis;Mažylių;8699020650;Taip;7;0;2;9
10972;Strazdelis;Pabiručių;7087235151;Taip;8;0;2;10
10973;Strazdelis;Pabiručių;3030445367;Taip;14;1;0;15
10974;Strazdelis;Pabiručių;4966668662;Taip;7;0;0;7
10975;Strazdelis;Pabiručių;8484672456;Taip;10;0;0;10
10976;Strazdelis;Pabiručių;8953577585;Taip;8;0;0;8
10977;Strazdelis;Pabiručių;8677659019;Taip;6;0;0;6
10978;Strazdelis;Pabiručių;4848650799;Taip;0;10;0;10
10979;Strazdelis;Pabiručių;7716476995;Taip;5;0;0;5
10980;Strazdelis;Pabiručių;4174940099;Taip;0;15;0;15
10981;Strazdelis;Pabiručių;8554043784;Taip;14;0;0;14
10982;Strazdelis;Pabiručių;1952086370;Taip;20;0;0;20
10983;Strazdelis;Pabiručių;4461728361;Taip;0;1;1;2
10984;Strazdelis;Pabiručių;8356680705;Taip;3;11;0;14
10985;Strazdelis;Pabiručių;6457478289;Taip;10;0;0;10
10986;Strazdelis;Pabiručių;3426039979;Taip;10;7;0;17
10987;Strazdelis;Pabiručių;4715198107;Taip;0;6;0;6
10988;Strazdelis;Pabiručių;4334385271;Taip;0;0;3;3
10989;Šermukšnėlė;MOLINUKAI;4638109666;Taip;0;0;4;4
10990;Šermukšnėlė;MOLINUKAI;9329824053;Taip;0;5;5;10
10991;Šermukšnėlė;MOLINUKAI;2714018690;Taip;6;0;5;11
10992;Šermukšnėlė;MOLINUKAI;5262882873;Taip;9;1;0;10
10993;Šermukšnėlė;MOLINUKAI;7385114026;Taip;0;0;1;1
10994;Šermukšnėlė;MOLINUKAI;2784732759;Taip;13;0;0;13
10995;Šermukšnėlė;MOLINUKAI;3342919832;Taip;6;4;0;10
10996;Šermukšnėlė;MOLINUKAI;9337047371;Taip;13;3;2;18
10997;Šermukšnėlė;MOLINUKAI;2098090763;Taip;10;0;2;12
10998;Šermukšnėlė;MOLINUKAI;5835100042;Taip;9;0;2;11
10999;Šermukšnėlė;MOLINUKAI;8000479161;Taip;10;0;0;10
11000;Šermukšnėlė;MOLINUKAI;4952285322;Taip;7;5;0;12
11001;Šermukšnėlė;MOLINUKAI;5733048755;Taip;6;0;0;6
11002;Šermukšnėlė;MOLINUKAI;6608458145;Taip;0;0;1;1
11003;Šermukšnėlė;MOLINUKAI;8104182167;Taip;0;0;5;5
11004;Šermukšnėlė;MOLINUKAI;6988120570;Taip;5;8;0;13
11005;Šermukšnėlė;MOLINUKAI;8728441474;Taip;7;3;1;11
11006;Šermukšnėlė;MOLINUKAI;4075151928;Taip;4;0;5;9
11007;Šermukšnėlė;MOLINUKAI;9527382390;Taip;0;0;3;3
11008;Šermukšnėlė;MOLINUKAI;4968522498;Taip;10;8;0;18
11009;Šermukšnėlė;ŠIAUDINUKAI;7249568196;Taip;0;3;0;3
11010;Šermukšnėlė;ŠIAUDINUKAI;3451361097;Taip;8;0;0;8
11011;Šermukšnėlė;ŠIAUDINUKAI;7002917737;Taip;20;0;0;20
11012;Šermukšnėlė;ŠIAUDINUKAI;7785671936;Taip;10;0;0;10
11013;Šermukšnėlė;ŠIAUDINUKAI;3637882900;Taip;0;8;0;8
11014;Šermukšnėlė;ŠIAUDINUKAI;1159472154;Taip;5;3;1;9
11015;Šermukšnėlė;ŠIAUDINUKAI;4956414941;Taip;0;0;2;2
11016;Šermukšnėlė;ŠIAUDINUKAI;3499394539;Taip;0;7;0;7
11017;Šermukšnėlė;ŠIAUDINUKAI;1157979179;Taip;0;4;0;4
11018;Šermukšnėlė;ŠIAUDINUKAI;3701053997;Ne;5;0;1;6
11019;Šermukšnėlė;ŠIAUDINUKAI;7917101921;Taip;15;0;0;15
11020;Šermukšnėlė;ŠIAUDINUKAI;3082272196;Taip;6;2;0;8
11021;Šermukšnėlė;ŠIAUDINUKAI;9903310024;Taip;10;6;0;16
11022;Šermukšnėlė;ŠIAUDINUKAI;9012757607;Taip;7;3;0;10
11023;Šermukšnėlė;ŠIAUDINUKAI;5627334876;Taip;4;0;0;4
11024;Šermukšnėlė;ŠIAUDINUKAI;3550736579;Taip;19;0;0;19
11025;Šermukšnėlė;ŠIAUDINUKAI;5993599994;Taip;10;0;2;12
11026;Šermukšnėlė;ŠIAUDINUKAI;3522028983;Taip;5;0;1;6
11027;Šermukšnėlė;ŠIAUDINUKAI;6077798297;Taip;2;3;0;5
11028;Šermukšnėlė;ŠIAUDINUKAI;2351386211;Taip;0;0;2;2
11029;Šermukšnėlė;ŠIAUDINUKAI;1437314920;Taip;0;6;0;6
11030;Šermukšnėlė;TOŠINUKAI;2160616078;Taip;0;4;0;4
11031;Šermukšnėlė;TOŠINUKAI;1661977128;Taip;5;0;8;13
11032;Šermukšnėlė;TOŠINUKAI;3994316729;Taip;0;0;8;8
11033;Šermukšnėlė;TOŠINUKAI;1459253197;Taip;0;0;6;6
11034;Šermukšnėlė;TOŠINUKAI;5140264695;Taip;0;0;1;1
11035;Šermukšnėlė;TOŠINUKAI;78341448188;Taip;19;0;0;19
11036;Šermukšnėlė;TOŠINUKAI;8279692394;Taip;3;0;1;4
11037;Šermukšnėlė;TOŠINUKAI;5096946133;Taip;0;3;0;3
11038;Šermukšnėlė;TOŠINUKAI;2380988728;Ne;4;2;1;7
11039;Šermukšnėlė;TOŠINUKAI;8956573129;Taip;0;3;1;4
11040;Šermukšnėlė;TOŠINUKAI;4981204674;Taip;0;2;0;2
11041;Šermukšnėlė;TOŠINUKAI;7229632099;Taip;6;3;2;11
11042;Šermukšnėlė;TOŠINUKAI;2529526401;Taip;1;2;2;5
11043;Šermukšnėlė;TOŠINUKAI;7038705221;Taip;0;10;0;10
11044;Šermukšnėlė;TOŠINUKAI;6413821285;Taip;0;6;0;6
11045;Šermukšnėlė;TOŠINUKAI;3081548524;Taip;0;3;0;3
11046;Šermukšnėlė;TOŠINUKAI;5832072195;Taip;0;15;0;15
11047;Šermukšnėlė;TOŠINUKAI;3222466449;Taip;5;3;3;11
11048;Šermukšnėlė;TOŠINUKAI;1753169856;Taip;6;3;0;9
11049;Šermukšnėlė;TOŠINUKAI;9442514813;Taip;0;3;0;3
11050;Šermukšnėlė;TOŠINUKAI;1569084597;Taip;0;3;0;3
11051;Šermukšnėlė;ODINUKAI;4422415026;Ne;0;3;5;8
11052;Šermukšnėlė;ODINUKAI;2176788727;Ne;6;0;1;7
11053;Šermukšnėlė;ODINUKAI;5575518612;Taip;2;0;0;2
11054;Šermukšnėlė;ODINUKAI;5733540837;Taip;5;0;0;5
11055;Šermukšnėlė;ODINUKAI;7262199284;Taip;5;3;0;8
11056;Šermukšnėlė;ODINUKAI;5354978646;Taip;0;10;0;10
11057;Šermukšnėlė;ODINUKAI;1882432812;Taip;0;10;0;10
11058;Šermukšnėlė;ODINUKAI;5151843494;Taip;9;0;1;10
11059;Šermukšnėlė;ODINUKAI;3949629658;Taip;0;3;0;3
11060;Šermukšnėlė;ODINUKAI;4201283154;Taip;5;0;1;6
11061;Šermukšnėlė;ODINUKAI;6105915822;Taip;3;3;0;6
11062;Šermukšnėlė;ODINUKAI;7667114310;Taip;12;2;0;14
11063;Šermukšnėlė;ODINUKAI;7245206247;Taip;0;0;5;5
11064;Šermukšnėlė;ODINUKAI;5397385093;Taip;0;0;2;2
11065;Šermukšnėlė;ODINUKAI;4331948700;Taip;0;1;0;1
11066;Šermukšnėlė;ODINUKAI;6718242890;Taip;7;3;2;12
11067;Šermukšnėlė;ODINUKAI;9664249364;Taip;0;0;2;2
11068;Šermukšnėlė;ODINUKAI;1064222922;Taip;17;0;0;17
11069;Šermukšnėlė;ODINUKAI;7770630580;Taip;0;4;2;6
11070;Šermukšnėlė;ODINUKAI;6194188831;Taip;0;0;2;2
11071;Šermukšnėlė;KRIAUKLELĖS;3613456202;Taip;0;0;6;6
11072;Šermukšnėlė;KRIAUKLELĖS;8541743148;Taip;0;8;0;8
11073;Šermukšnėlė;KRIAUKLELĖS;8709426669;Taip;6;5;0;11
11074;Šermukšnėlė;KRIAUKLELĖS;6585484701;Taip;4;1;0;5
11075;Šermukšnėlė;KRIAUKLELĖS;6599779539;Taip;10;5;0;15
11076;Šermukšnėlė;KRIAUKLELĖS;9876533442;Taip;0;0;1;1
11077;Šermukšnėlė;KRIAUKLELĖS;3653792683;Taip;0;3;0;3
11078;Šermukšnėlė;KRIAUKLELĖS;2506945279;Taip;0;1;0;1
11079;Šermukšnėlė;KRIAUKLELĖS;7266947985;Taip;10;0;4;14
11080;Šermukšnėlė;KRIAUKLELĖS;8117261716;Taip;8;0;1;9
11081;Šermukšnėlė;KRIAUKLELĖS;7458930634;Taip;5;0;0;5
11082;Šermukšnėlė;KRIAUKLELĖS;3245643086;Taip;15;2;0;17
11083;Šermukšnėlė;KRIAUKLELĖS;6342714998;Taip;0;0;1;1
11084;Šermukšnėlė;KRIAUKLELĖS;6946711443;Taip;8;6;3;17
11085;Šermukšnėlė;KRIAUKLELĖS;9074111563;Taip;0;10;0;10
11086;Šermukšnėlė;KRIAUKLELĖS;9908568127;Taip;0;4;0;4
11087;Šermukšnėlė;KRIAUKLELĖS;9783673534;Taip;8;0;1;9
11088;Šermukšnėlė;KRIAUKLELĖS;8748166398;Ne;10;0;0;10
11089;Šermukšnėlė;KRIAUKLELĖS;5408843906;Taip;5;1;0;6
11090;Šermukšnėlė;VYTINUKAI;1523361932;Taip;5;1;0;6
11091;Šermukšnėlė;VYTINUKAI;8531953934;Taip;0;0;3;3
11092;Šermukšnėlė;VYTINUKAI;25189813939;Taip;0;3;0;3
11093;Šermukšnėlė;VYTINUKAI;83123267733;Taip;0;3;1;4
11094;Šermukšnėlė;VYTINUKAI;20028832329;Taip;0;4;0;4
11095;Šermukšnėlė;VYTINUKAI;3959795064;Taip;0;1;0;1
11096;Šermukšnėlė;VYTINUKAI;1244964311;Taip;0;1;0;1
11097;Šermukšnėlė;VYTINUKAI;83882579952;Taip;0;0;1;1
11098;Šermukšnėlė;VYTINUKAI;60840526220;Taip;3;0;0;3
11099;Šermukšnėlė;VYTINUKAI;1025787925;Taip;6;0;0;6
11100;Šermukšnėlė;VYTINUKAI;1519623099;Taip;0;3;4;7
11101;Šermukšnėlė;VYTINUKAI;9654198217;Taip;4;0;1;5
11102;Šermukšnėlė;VYTINUKAI;1670047548;Taip;10;3;0;13
11103;Šermukšnėlė;VYTINUKAI;5281637612;Taip;0;5;0;5
11104;Šermukšnėlė;VYTINUKAI;8123096990;Taip;2;0;2;4
11105;Šermukšnėlė;VYTINUKAI;8511421692;Taip;0;0;5;5
11106;Šermukšnėlė;VYTINUKAI;3883861823;Taip;0;8;0;8
11107;Šermukšnėlė;VYTINUKAI;2163955454;Taip;1;0;1;2
11108;Šermukšnėlė;VYTINUKAI;5225263863;Taip;0;3;0;3
11109;Šermukšnėlė;GINTARĖLIAI;5069572637;Taip;5;0;0;5
11110;Šermukšnėlė;GINTARĖLIAI;8249749948;Taip;0;3;3;6
11111;Šermukšnėlė;GINTARĖLIAI;2989011150;Taip;0;1;0;1
11112;Šermukšnėlė;GINTARĖLIAI;3747531232;Ne;10;1;0;11
11113;Šermukšnėlė;GINTARĖLIAI;1996859146;Taip;5;0;0;5
11114;Šermukšnėlė;GINTARĖLIAI;4176986876;Taip;4;8;0;12
11115;Šermukšnėlė;GINTARĖLIAI;7036078780;Taip;23;0;0;23
11116;Šermukšnėlė;GINTARĖLIAI;1994737857;Taip;5;8;0;13
11117;Šermukšnėlė;GINTARĖLIAI;4619811264;Taip;5;8;0;13
11118;Šermukšnėlė;GINTARĖLIAI;5886893562;Taip;10;8;0;18
11119;Šermukšnėlė;GINTARĖLIAI;4783726095;Taip;0;3;0;3
11120;Šermukšnėlė;GINTARĖLIAI;9714566919;Ne;5;1;0;6
11121;Šermukšnėlė;GINTARĖLIAI;5172187141;Taip;9;3;0;12
11122;Šermukšnėlė;GINTARĖLIAI;3688946505;Taip;4;0;3;7
11123;Šermukšnėlė;GINTARĖLIAI;5905330617;Taip;0;0;1;1
11124;Šermukšnėlė;GINTARĖLIAI;1636944853;Taip;0;6;0;6
11125;Šermukšnėlė;GINTARĖLIAI;7053319091;Ne;11;0;2;13
11126;Šermukšnėlė;GINTARĖLIAI;6351841889;Taip;10;0;1;11
11127;Šermukšnėlė;GINTARĖLIAI;7305013368;Taip;5;2;0;7
11128;Šermukšnėlė;GINTARĖLIAI;6698650179;Taip;14;0;0;14
11129;Šermukšnėlė;GINTARĖLIAI;7106405983;Taip;8;0;2;10
11130;Šermukšnėlė;GINTARĖLIAI;8639470631;Taip;0;0;1;1
11131;Šermukšnėlė;AKMENUKAI;3543061360;Taip;0;6;0;6
11132;Šermukšnėlė;AKMENUKAI;7564745299;Taip;0;11;0;11
11133;Šermukšnėlė;AKMENUKAI;9617044855;Taip;6;5;0;11
11134;Šermukšnėlė;AKMENUKAI;1856012121;Taip;5;0;0;5
11135;Šermukšnėlė;AKMENUKAI;8407947566;Taip;0;0;1;1
11136;Šermukšnėlė;AKMENUKAI;8859731179;Taip;0;4;0;4
11137;Šermukšnėlė;AKMENUKAI;1902848560;Taip;0;4;0;4
11138;Šermukšnėlė;AKMENUKAI;3513568460;Taip;0;3;0;3
11139;Šermukšnėlė;AKMENUKAI;4230698872;Taip;0;0;10;10
11140;Šermukšnėlė;AKMENUKAI;8669676262;Taip;0;5;0;5
11141;Šermukšnėlė;AKMENUKAI;3148857617;Taip;0;10;0;10
11142;Šermukšnėlė;AKMENUKAI;4965640386;Taip;0;0;2;2
11143;Šermukšnėlė;AKMENUKAI;3639954786;Taip;0;0;4;4
11144;Šermukšnėlė;AKMENUKAI;7843128263;Taip;5;0;0;5
11145;Šermukšnėlė;AKMENUKAI;9805841777;Taip;0;8;0;8
11146;Šermukšnėlė;AKMENUKAI;3945291560;Taip;0;10;0;10
11147;Šermukšnėlė;AKMENUKAI;5660238634;Taip;0;0;2;2
11148;Šermukšnėlė;AKMENUKAI;6067298318;Taip;14;0;0;14
11149;Šermukšnėlė;AKMENUKAI;5678559268;Taip;14;0;0;14
11150;Šermukšnėlė;AKMENUKAI;8479230675;Taip;0;12;0;12
11151;Šermukšnėlė;AKMENUKAI;6162830167;Taip;15;0;0;15
11152;Šermukšnėlė;SIŪLINUKAI;4619600451;Ne;1;0;1;2
11153;Šermukšnėlė;SIŪLINUKAI;2967000352;Ne;8;0;1;9
11154;Šermukšnėlė;SIŪLINUKAI;4528448735;Taip;6;0;0;6
11155;Šermukšnėlė;SIŪLINUKAI;2740644605;Taip;12;3;0;15
11156;Šermukšnėlė;SIŪLINUKAI;8454298610;Taip;11;0;0;11
11157;Šermukšnėlė;SIŪLINUKAI;6429038861;Taip;7;7;1;15
11158;Šermukšnėlė;SIŪLINUKAI;6429038861;Taip;7;7;1;15
11159;Šermukšnėlė;SIŪLINUKAI;6429038861;Taip;7;7;1;15
11160;Šermukšnėlė;SIŪLINUKAI;6429038861;Taip;7;7;1;15
11161;Šermukšnėlė;SIŪLINUKAI;1819553019;Taip;10;0;1;11
11162;Šermukšnėlė;SIŪLINUKAI;7568969509;Taip;3;0;0;3
11163;Šermukšnėlė;SIŪLINUKAI;2398592042;Taip;16;0;0;16
11164;Šermukšnėlė;SIŪLINUKAI;7758886713;Ne;0;4;0;4
11165;Šermukšnėlė;SIŪLINUKAI;4390650081;Taip;0;0;1;1
11166;Šermukšnėlė;SIŪLINUKAI;5072021867;Taip;4;0;0;4
11167;Šermukšnėlė;SIŪLINUKAI;7934772640;Taip;0;8;0;8
11168;Šermukšnėlė;SIŪLINUKAI;6231057889;Taip;6;0;0;6
11169;Šermukšnėlė;SIŪLINUKAI;3106890807;Taip;0;2;0;2
11170;Šermukšnėlė;SIŪLINUKAI;3979766151;Ne;3;0;0;3
11171;Šermukšnėlė;MEDINUKAi;8558117857;Ne;0;0;15;15
11172;Šermukšnėlė;MEDINUKAi;1318170904;Taip;12;0;0;12
11173;Šermukšnėlė;MEDINUKAi;5874725607;Taip;8;0;5;13
11174;Šermukšnėlė;MEDINUKAi;7532979465;Taip;14;0;0;14
11175;Šermukšnėlė;MEDINUKAi;7211488009;Taip;12;0;0;12
11176;Šermukšnėlė;MEDINUKAi;3359398381;Taip;5;1;0;6
11177;Šermukšnėlė;MEDINUKAi;6928863055;Taip;4;0;0;4
11178;Šermukšnėlė;MEDINUKAi;6531113007;Taip;3;1;0;4
11179;Šermukšnėlė;MEDINUKAi;8437052600;Taip;14;0;1;15
11180;Šermukšnėlė;MEDINUKAi;8200175951;Taip;19;0;0;19
11181;Šermukšnėlė;MEDINUKAi;7546040491;Taip;5;0;0;5
11182;Šermukšnėlė;MEDINUKAi;9872479998;Taip;16;0;0;16
11183;Šermukšnėlė;MEDINUKAi;8587108797;Taip;23;0;0;23
11184;Šermukšnėlė;SKUDURINUKAI;7523588943;Taip;2;0;0;2
11185;Šermukšnėlė;SKUDURINUKAI;2235123503;Taip;5;0;5;10
11186;Šermukšnėlė;SKUDURINUKAI;9535836301;Taip;5;0;1;6
11187;Šermukšnėlė;SKUDURINUKAI;3138507073;Taip;15;0;0;15
11188;Šermukšnėlė;SKUDURINUKAI;9247356229;Taip;7;8;0;15
11189;Šermukšnėlė;SKUDURINUKAI;3206222470;Taip;18;0;1;19
11190;Šermukšnėlė;SKUDURINUKAI;5751303170;Taip;12;0;0;12
11191;Šermukšnėlė;SKUDURINUKAI;2810624440;Taip;10;0;0;10
11192;Šermukšnėlė;SKUDURINUKAI;3955219247;Taip;10;3;0;13
11193;Šermukšnėlė;SKUDURINUKAI;5564759354;Ne;19;0;0;19
11194;Šermukšnėlė;SKUDURINUKAI;1931894084;Taip;4;0;0;4
11195;Šermukšnėlė;SKUDURINUKAI;6778901855;Taip;5;3;0;8
11196;Šermukšnėlė;SKUDURINUKAI;1502704170;Taip;22;0;0;22
11197;Šermukšnėlė;SKUDURINUKAI;6524173015;Taip;5;0;0;5
11198;Šermukšnėlė;PAGRANDUKAI;8802335133;Taip;0;8;0;8
11199;Šermukšnėlė;PAGRANDUKAI;6797936390;Taip;0;2;0;2
11200;Šermukšnėlė;PAGRANDUKAI;1312471779;Ne;0;0;3;3
11201;Šermukšnėlė;PAGRANDUKAI;6286235756;Taip;0;8;0;8
11202;Šermukšnėlė;PAGRANDUKAI;4219655802;Taip;11;0;0;11
11203;Šermukšnėlė;PAGRANDUKAI;4337084152;Taip;6;11;3;20
11204;Šermukšnėlė;PAGRANDUKAI;8710910167;Taip;0;0;4;4
11205;Šermukšnėlė;PAGRANDUKAI;8092422909;Taip;18;0;2;20
11206;Šermukšnėlė;PAGRANDUKAI;9246072554;Taip;0;8;0;8
11207;Šermukšnėlė;PAGRANDUKAI;1209135668;Taip;20;0;0;20
11208;Šermukšnėlė;PAGRANDUKAI;9080074486;Taip;0;2;4;6
11209;Šermukšnėlė;PAGRANDUKAI;7098953763;Taip;0;0;1;1
11210;Šermukšnėlė;PAGRANDUKAI;5081685546;Taip;8;0;1;9
11211;Šypsena;NYKŠTUKAI;8913058656;Taip;0;2;0;2
11212;Šypsena;NYKŠTUKAI;8508569167;Taip;0;4;0;4
11213;Šypsena;NYKŠTUKAI;5818211923;Taip;0;0;1;1
11214;Šypsena;NYKŠTUKAI;8665786789;Taip;20;0;0;20
11215;Šypsena;NYKŠTUKAI;1716274053;Ne;0;3;0;3
11216;Šypsena;NYKŠTUKAI;6724776618;Taip;5;4;0;9
11217;Šypsena;NYKŠTUKAI;2790906806;Ne;6;7;0;13
11218;Šypsena;NYKŠTUKAI;9363618080;Taip;5;0;3;8
11219;Šypsena;NYKŠTUKAI;9702364620;Ne;8;5;0;13
11220;Šypsena;NYKŠTUKAI;3733757483;Taip;0;8;2;10
11221;Šypsena;NYKŠTUKAI;2179657619;Ne;0;4;0;4
11222;Šypsena;NYKŠTUKAI;2900195046;Taip;0;4;0;4
11223;Šypsena;NYKŠTUKAI;3724645162;Taip;0;0;1;1
11224;Šypsena;NYKŠTUKAI;3003901966;Taip;0;8;0;8
11225;Šypsena;NYKŠTUKAI;2182189246;Taip;5;0;1;6
11226;Šypsena;NYKŠTUKAI;1431850136;Taip;0;3;0;3
11227;Šypsena;NYKŠTUKAI;5142969776;Taip;12;0;1;13
11228;Šypsena;NYKŠTUKAI;8439694239;Taip;3;18;0;21
11229;Šypsena;NYKŠTUKAI;6377979434;Taip;3;0;4;7
11230;Šypsena;NYKŠTUKAI;7332307199;Taip;7;0;0;7
11231;Šypsena;SPINDULIUKAI;7898387398;Taip;0;2;0;2
11232;Šypsena;SPINDULIUKAI;1324902555;Taip;3;3;1;7
11233;Šypsena;SPINDULIUKAI;5222603743;Taip;3;0;0;3
11234;Šypsena;SPINDULIUKAI;7120597034;Taip;5;1;1;7
11235;Šypsena;SPINDULIUKAI;5879506651;Ne;4;1;0;5
11236;Šypsena;SPINDULIUKAI;3823623458;Ne;0;1;0;1
11237;Šypsena;SPINDULIUKAI;6713182218;Taip;0;12;0;12
11238;Šypsena;SPINDULIUKAI;1287205292;Ne;7;0;2;9
11239;Šypsena;SPINDULIUKAI;8215278033;Taip;0;9;1;10
11240;Šypsena;SPINDULIUKAI;7537442618;Taip;0;9;0;9
11241;Šypsena;SPINDULIUKAI;2584574423;Taip;12;0;0;12
11242;Šypsena;SPINDULIUKAI;9704350208;Ne;0;10;0;10
11243;Šypsena;SPINDULIUKAI;5906001927;Taip;0;0;5;5
11244;Šypsena;SPINDULIUKAI;6951845385;Taip;3;0;2;5
11245;Šypsena;SPINDULIUKAI;7877396588;Taip;9;0;3;12
11246;Šypsena;SPINDULIUKAI;4520148322;Taip;0;4;0;4
11247;Šypsena;SPINDULIUKAI;3901424559;Taip;0;4;3;7
11248;Šypsena;SPINDULIUKAI;8765509994;Taip;9;0;2;11
11249;Šypsena;SPINDULIUKAI;3429836513;Taip;0;10;14;24
11250;Šypsena;SPINDULIUKAI;8566236342;Taip;3;0;7;10
11251;Šypsena;SKRUZDELIUKAI;5611440056;Ne;0;0;1;1
11252;Šypsena;SKRUZDELIUKAI;1114341518;Taip;0;5;1;6
11253;Šypsena;SKRUZDELIUKAI;1558614852;Taip;4;2;1;7
11254;Šypsena;SKRUZDELIUKAI;1897176871;Taip;0;1;0;1
11255;Šypsena;SKRUZDELIUKAI;1181590127;Taip;0;8;0;8
11256;Šypsena;SKRUZDELIUKAI;4808041625;Taip;0;3;1;4
11257;Šypsena;SKRUZDELIUKAI;4038279267;Taip;4;5;0;9
11258;Šypsena;SKRUZDELIUKAI;5834057370;Taip;0;4;0;4
11259;Šypsena;SKRUZDELIUKAI;1515803985;Taip;0;1;0;1
11260;Šypsena;SKRUZDELIUKAI;3809171499;Taip;0;2;0;2
11261;Šypsena;SKRUZDELIUKAI;4344780723;Taip;0;0;6;6
11262;Šypsena;SKRUZDELIUKAI;5504570516;Taip;0;0;2;2
11263;Šypsena;SKRUZDELIUKAI;5369445077;Taip;0;6;1;7
11264;Šypsena;SKRUZDELIUKAI;2798819321;Taip;0;3;0;3
11265;Šypsena;SKRUZDELIUKAI;3506046076;Ne;0;3;3;6
11266;Šypsena;SKRUZDELIUKAI;4450146424;Taip;2;0;0;2
11267;Šypsena;SKRUZDELIUKAI;7519967594;Taip;0;0;1;1
11268;Šypsena;Bitutės;1796837022;Taip;0;1;5;6
11269;Šypsena;Bitutės;6158973964;Taip;0;3;0;3
11270;Šypsena;Bitutės;6590285866;Taip;0;1;0;1
11271;Šypsena;Bitutės;4766170132;Ne;0;2;0;2
11272;Šypsena;Bitutės;6832433711;Taip;0;2;0;2
11273;Šypsena;Bitutės;2995753269;Taip;6;1;0;7
11274;Šypsena;Bitutės;2248628927;Taip;0;10;0;10
11275;Šypsena;Bitutės;2706678026;Ne;7;0;0;7
11276;Šypsena;Bitutės;7413098580;Ne;0;3;0;3
11277;Šypsena;Bitutės;3063226692;Ne;0;1;0;1
11278;Šypsena;Bitutės;5985974927;Taip;0;4;0;4
11279;Šypsena;Bitutės;3387625466;Taip;0;2;1;3
11280;Šypsena;Bitutės;1669768648;Ne;5;3;0;8
11281;Šypsena;Bitutės;1575413188;Taip;0;3;0;3
11282;Šypsena;Bitutės;6511231991;Ne;0;1;0;1
11283;Šypsena;Bitutės;2005543016;Ne;9;1;0;10
11284;Šypsena;Bitutės;5568502083;Taip;0;4;0;4
11285;Šypsena;MEŠKIUKAI;9696633725;Taip;0;0;1;1
11286;Šypsena;MEŠKIUKAI;7876871684;Taip;6;2;2;10
11287;Šypsena;MEŠKIUKAI;6055482561;Ne;26;0;0;26
11288;Šypsena;MEŠKIUKAI;6028006499;Taip;0;2;6;8
11289;Šypsena;MEŠKIUKAI;3724483762;Ne;5;1;0;6
11290;Šypsena;MEŠKIUKAI;7817486488;Taip;11;4;3;18
11291;Šypsena;MEŠKIUKAI;9862387726;Taip;5;0;2;7
11292;Šypsena;MEŠKIUKAI;3663446767;Taip;5;0;4;9
11293;Šypsena;MEŠKIUKAI;8094166916;Taip;7;4;1;12
11294;Šypsena;MEŠKIUKAI;5446516798;Taip;0;2;2;4
11295;Šypsena;MEŠKIUKAI;5094556499;Taip;10;7;1;18
11296;Šypsena;MEŠKIUKAI;4496704989;Taip;8;1;1;10
11297;Šypsena;MEŠKIUKAI;7471913547;Taip;4;0;0;4
11298;Šypsena;MEŠKIUKAI;7174068697;Taip;0;0;4;4
11299;Šypsena;BORUŽĖLĖS;7905089772;Taip;4;0;3;7
11300;Šypsena;BORUŽĖLĖS;7234904026;Ne;12;5;0;17
11301;Šypsena;BORUŽĖLĖS;8963484558;Ne;11;0;0;11
11302;Šypsena;BORUŽĖLĖS;3951000812;Taip;3;12;0;15
11303;Šypsena;BORUŽĖLĖS;2177181171;Taip;15;0;0;15
11304;Šypsena;BORUŽĖLĖS;7960872132;Taip;13;0;0;13
11305;Šypsena;BORUŽĖLĖS;4260693029;Ne;5;3;0;8
11306;Šypsena;BORUŽĖLĖS;6859531936;Ne;10;0;0;10
11307;Šnekutis;DRUGELIŲ;9131937590;Taip;22;0;0;22
11308;Šnekutis;DRUGELIŲ;1504945841;Taip;9;11;0;20
11309;Šnekutis;DRUGELIŲ;6305168453;Taip;0;0;4;4
11310;Šnekutis;DRUGELIŲ;9543014297;Taip;13;10;0;23
11311;Šnekutis;DRUGELIŲ;3096125224;Taip;0;3;0;3
11312;Šnekutis;DRUGELIŲ;3386995244;Ne;0;10;0;10
11313;Šnekutis;DRUGELIŲ;8810371475;Taip;0;0;4;4
11314;Šnekutis;DRUGELIŲ;7680962037;Taip;8;0;2;10
11315;Šnekutis;DRUGELIŲ;3611064172;Taip;0;6;0;6
11316;Šnekutis;DRUGELIŲ;3079202929;Taip;0;0;4;4
11317;Šnekutis;DRUGELIŲ;8209686459;Taip;6;5;0;11
11318;Šnekutis;DRUGELIŲ;8036600501;Taip;5;0;0;5
11319;Šnekutis;DRUGELIŲ;6071004512;Taip;5;1;0;6
11320;Šnekutis;DRUGELIŲ;1556960616;Taip;15;1;0;16
11321;Šnekutis;DRUGELIŲ;3177449195;Taip;5;0;5;10
11322;Šnekutis;DRUGELIŲ;4380966487;Taip;1;0;4;5
11323;Šnekutis;DRUGELIŲ;8076487157;Taip;0;0;2;2
11324;Šnekutis;DRUGELIŲ;7954240439;Taip;15;0;0;15
11325;Šnekutis;DRUGELIŲ;6330033887;Taip;5;0;1;6
11326;Šnekutis;Kačiukų;3281475303;Taip;5;3;0;8
11327;Šnekutis;Kačiukų;9670205249;Taip;0;4;3;7
11328;Šnekutis;Kačiukų;7615716438;Ne;9;4;0;13
11329;Šnekutis;Kačiukų;9780684867;Ne;5;0;1;6
11330;Šnekutis;Kačiukų;3166309530;Taip;0;3;2;5
11331;Šnekutis;Kačiukų;4143844589;Taip;1;0;0;1
11332;Šnekutis;Kačiukų;9312935803;Taip;0;3;11;14
11333;Šnekutis;Kačiukų;7236658561;Ne;9;0;0;9
11334;Šnekutis;Kačiukų;4992188525;Ne;3;0;1;4
11335;Šnekutis;Kačiukų;7638626055;Taip;5;5;1;11
11336;Šnekutis;Kačiukų;9157136735;Taip;0;14;0;14
11337;Šnekutis;Kačiukų;4920263429;Taip;0;6;0;6
11338;Šnekutis;Kačiukų;5909584565;Taip;14;0;0;14
11339;Šnekutis;Kačiukų;6234943180;Taip;13;0;0;13
11340;Šnekutis;Kačiukų;2914145045;Ne;20;0;0;20
11341;Šnekutis;Kačiukų;8340697546;Taip;0;0;2;2
11342;Šnekutis;Kačiukų;9896249776;Taip;6;0;0;6
11343;Šnekutis;Kačiukų;2656152037;Taip;0;1;0;1
11344;Šnekutis;Kačiukų;9051956302;Taip;10;0;13;23
11345;Šnekutis;Kačiukų;5521822696;Ne;1;0;4;5
11346;Šnekutis;Kačiukų;9942669058;Ne;0;0;7;7
11347;Šnekutis;Kačiukų;2144568225;Taip;5;0;1;6
11348;Šnekutis;Kačiukų;4624075875;Taip;0;0;8;8
11349;Šnekutis;Pėlėdžiukų;5188035949;Taip;13;0;0;13
11350;Šnekutis;Pėlėdžiukų;3068754741;Taip;3;0;0;3
11351;Šnekutis;Pėlėdžiukų;4334155280;Taip;0;0;1;1
11352;Šnekutis;Pėlėdžiukų;77534335117;Ne;0;3;1;4
11353;Šnekutis;Pėlėdžiukų;3312928478;Taip;5;0;0;5
11354;Šnekutis;Pėlėdžiukų;8745465796;Taip;10;3;3;16
11355;Šnekutis;Pėlėdžiukų;3170928052;Ne;0;0;1;1
11356;Šnekutis;Pėlėdžiukų;3578045341;Ne;8;0;3;11
11357;Šnekutis;Pėlėdžiukų;5117544317;Taip;0;0;2;2
11358;Šnekutis;Pėlėdžiukų;5615869149;Taip;0;3;0;3
11359;Šnekutis;Pėlėdžiukų;1329958641;Taip;8;0;0;8
11360;Šnekutis;Pėlėdžiukų;9511116249;Taip;11;3;0;14
11361;Šnekutis;Pėlėdžiukų;1369660223;Taip;2;0;0;2
11362;Šnekutis;Pėlėdžiukų;1682748852;Taip;6;0;0;6
11363;Šnekutis;Pėlėdžiukų;2525115674;Taip;10;0;0;10
11364;Šnekutis;Pėlėdžiukų;9601932777;Taip;3;10;0;13
11365;Šnekutis;Pėlėdžiukų;4302555600;Taip;3;10;0;13
11366;Šnekutis;Pėlėdžiukų;7507857415;Ne;0;1;0;1
11367;Šnekutis;Pėlėdžiukų;7514753023;Taip;0;3;12;15
11368;Šnekutis;Pėlėdžiukų;54532738133;Ne;2;0;0;2
11369;Šnekutis;Boružėlių;4835202527;Taip;13;2;0;15
11370;Šnekutis;Boružėlių;9054899440;Taip;0;1;0;1
11371;Šnekutis;Boružėlių;9862362744;Taip;5;0;2;7
11372;Šnekutis;Boružėlių;7089000987;Ne;0;2;0;2
11373;Šnekutis;Boružėlių;2843483435;Taip;10;0;0;10
11374;Šnekutis;Boružėlių;5906320006;Taip;1;0;1;2
11375;Šnekutis;Boružėlių;6405894763;Ne;0;3;0;3
11376;Šnekutis;Boružėlių;3889176018;Taip;0;0;5;5
11377;Šnekutis;Boružėlių;6749848086;Taip;0;0;5;5
11378;Šnekutis;Boružėlių;6544973632;Taip;8;0;0;8
11379;Šnekutis;Boružėlių;6146988521;Taip;2;1;0;3
11380;Šnekutis;Boružėlių;5519015388;Taip;0;0;6;6
11381;Šnekutis;Boružėlių;3628210526;Taip;5;0;2;7
11382;Šnekutis;Boružėlių;7344776758;Taip;6;0;1;7
11383;Šnekutis;Boružėlių;5970951526;Taip;6;5;0;11
11384;Šnekutis;Boružėlių;3344425033;Ne;4;0;8;12
11385;Šnekutis;Boružėlių;3937465849;Ne;0;0;2;2
11386;Šnekutis;Boružėlių;8219465079;Taip;11;3;1;15
11387;Šnekutis;Boružėlių;7307895397;Taip;0;0;2;2
11388;Šnekutis;Boružėlių;3371393656;Taip;12;0;2;14
11389;Šnekutis;Boružėlių;2779793970;Ne;16;0;0;16
11390;Šnekutis;Meškučių;3214549246;Ne;19;0;0;19
11391;Šnekutis;Meškučių;2626247219;Taip;5;0;0;5
11392;Šnekutis;Meškučių;7707897830;Taip;8;0;0;8
11393;Šnekutis;Meškučių;2042842873;Taip;0;0;1;1
11394;Šnekutis;Meškučių;2140099519;Taip;5;0;1;6
11395;Šnekutis;Meškučių;9709701441;Taip;3;0;0;3
11396;Šnekutis;Meškučių;1219175855;Taip;7;0;1;8
11397;Šnekutis;Meškučių;9574210410;Taip;6;0;0;6
11398;Šnekutis;Meškučių;7980166125;Taip;6;0;0;6
11399;Šnekutis;Meškučių;8456957469;Taip;2;0;1;3
11400;Šnekutis;Meškučių;3572114463;Ne;10;0;0;10
11401;Šnekutis;Meškučių;8417485561;Taip;0;0;1;1
11402;Šnekutis;Meškučių;2312968654;Taip;10;0;0;10
11403;Šnekutis;Viščiukų;9790241725;Taip;0;5;1;6
11404;Šnekutis;Viščiukų;9322106995;Taip;3;0;0;3
11405;Šnekutis;Viščiukų;3842436406;Taip;5;0;0;5
11406;Šnekutis;Viščiukų;3115675798;Taip;5;0;1;6
11407;Šnekutis;Viščiukų;5934631354;Taip;0;0;1;1
11408;Šnekutis;Viščiukų;4848437026;Taip;2;0;0;2
11409;Šnekutis;Viščiukų;9772257715;Taip;0;1;0;1
11410;Šnekutis;Viščiukų;3593766968;Taip;10;0;0;10
11411;Šnekutis;Viščiukų;1805259980;Taip;9;0;0;9
11412;Šnekutis;Viščiukų;7200356364;Taip;8;0;6;14
11413;Šnekutis;Viščiukų;1248466603;Taip;7;0;1;8
11414;Šnekutis;Viščiukų;9007182019;Taip;14;0;0;14
11415;Užupiukas;VYTURĖLIŲ;5116564840;Taip;0;0;1;1
11416;Užupiukas;VYTURĖLIŲ;7443013255;Taip;3;0;0;3
11417;Užupiukas;VYTURĖLIŲ;3656400244;Taip;0;11;0;11
11418;Užupiukas;VYTURĖLIŲ;3829013911;Taip;0;1;4;5
11419;Užupiukas;VYTURĖLIŲ;9212428150;Taip;0;0;2;2
11420;Užupiukas;VYTURĖLIŲ;8001099421;Taip;10;0;1;11
11421;Užupiukas;VYTURĖLIŲ;4401569800;Taip;0;3;5;8
11422;Užupiukas;VYTURĖLIŲ;1391826582;Taip;0;0;2;2
11423;Užupiukas;VYTURĖLIŲ;5021163099;Taip;0;0;8;8
11424;Užupiukas;VYTURĖLIŲ;8960813016;Taip;3;0;0;3
11425;Užupiukas;VYTURĖLIŲ;9132605734;Taip;3;0;1;4
11426;Užupiukas;VYTURĖLIŲ;8245876832;Ne;0;4;0;4
11427;Užupiukas;VYTURĖLIŲ;7532497390;Taip;0;0;1;1
11428;Užupiukas;VYTURĖLIŲ;5168946019;Taip;0;0;6;6
11429;Užupiukas;VYTURĖLIŲ;5718382826;Taip;0;3;0;3
11430;Užupiukas;VYTURĖLIŲ;9209209113;Ne;10;0;1;11
11431;Užupiukas;VYTURĖLIŲ;9070732925;Taip;0;1;0;1
11432;Užupiukas;VYTURĖLIŲ;1146968021;Taip;0;1;0;1
11433;Užupiukas;VYTURĖLIŲ;1647271985;Taip;5;0;4;9
11434;Užupiukas;KAČIUKŲ;3567963511;Taip;0;3;2;5
11435;Užupiukas;KAČIUKŲ;9991552624;Taip;0;3;0;3
11436;Užupiukas;KAČIUKŲ;3048959458;Taip;5;3;0;8
11437;Užupiukas;KAČIUKŲ;3080668107;Ne;0;7;0;7
11438;Užupiukas;KAČIUKŲ;1809036046;Ne;0;12;1;13
11439;Užupiukas;KAČIUKŲ;1102468034;Taip;0;3;0;3
11440;Užupiukas;KAČIUKŲ;1464016943;Taip;0;3;1;4
11441;Užupiukas;KAČIUKŲ;4485435274;Taip;5;0;1;6
11442;Užupiukas;KAČIUKŲ;1102293237;Taip;9;3;0;12
11443;Užupiukas;KAČIUKŲ;9386211193;Taip;7;4;0;11
11444;Užupiukas;KAČIUKŲ;7048114101;Taip;0;0;3;3
11445;Užupiukas;KAČIUKŲ;1388346927;Taip;0;4;0;4
11446;Užupiukas;KAČIUKŲ;9333587467;Taip;0;3;0;3
11447;Užupiukas;KAČIUKŲ;7574528186;Ne;0;0;4;4
11448;Užupiukas;KAČIUKŲ;7092857844;Taip;0;0;1;1
11449;Užupiukas;KAČIUKŲ;2606742144;Taip;0;3;3;6
11450;Užupiukas;KAČIUKŲ;5233447872;Taip;14;0;3;17
11451;Užupiukas;KAČIUKŲ;9719845726;Taip;0;3;0;3
11452;Užupiukas;KAČIUKŲ;3543913063;Taip;0;0;7;7
11453;Užupiukas;KAČIUKŲ;4920190785;Taip;0;0;11;11
11454;Užupiukas;DRUGELIŲ;8876174256;Taip;11;0;0;11
11455;Užupiukas;DRUGELIŲ;5239006321;Taip;0;1;4;5
11456;Užupiukas;DRUGELIŲ;7581152903;Taip;0;1;5;6
11457;Užupiukas;DRUGELIŲ;5361599156;Taip;0;9;0;9
11458;Užupiukas;DRUGELIŲ;4680027403;Taip;0;0;1;1
11459;Užupiukas;DRUGELIŲ;6698907535;Taip;0;0;12;12
11460;Užupiukas;DRUGELIŲ;9577167600;Ne;11;0;3;14
11461;Užupiukas;DRUGELIŲ;3419182422;Taip;0;0;4;4
11462;Užupiukas;DRUGELIŲ;4854016957;Taip;9;0;1;10
11463;Užupiukas;DRUGELIŲ;8692826414;Taip;6;0;2;8
11464;Užupiukas;DRUGELIŲ;7169272175;Taip;10;0;3;13
11465;Užupiukas;DRUGELIŲ;1156471313;Taip;0;5;1;6
11466;Užupiukas;DRUGELIŲ;4595291532;Taip;0;0;12;12
11467;Užupiukas;DRUGELIŲ;3961733676;Taip;0;0;23;23
11468;Užupiukas;DRUGELIŲ;5006880916;Taip;11;0;0;11
11469;Užupiukas;DRUGELIŲ;4075611307;Taip;0;1;0;1
11470;Užupiukas;DRUGELIŲ;1108429907;Ne;0;0;12;12
11471;Užupiukas;DRUGELIŲ;9295230331;Taip;0;3;4;7
11472;Užupiukas;EŽIUKŲ;1526296386;Ne;0;0;1;1
11473;Užupiukas;EŽIUKŲ;9774124589;Ne;13;0;0;13
11474;Užupiukas;EŽIUKŲ;2724216446;Ne;10;10;0;20
11475;Užupiukas;EŽIUKŲ;9446562736;Taip;0;0;3;3
11476;Užupiukas;EŽIUKŲ;5072363435;Taip;0;0;3;3
11477;Užupiukas;EŽIUKŲ;1651249962;Taip;6;0;0;6
11478;Užupiukas;EŽIUKŲ;1100574872;Taip;13;0;7;20
11479;Užupiukas;EŽIUKŲ;5204808398;Taip;8;0;1;9
11480;Užupiukas;EŽIUKŲ;3171528288;Taip;8;0;3;11
11481;Užupiukas;EŽIUKŲ;7860601571;Taip;6;3;0;9
11482;Užupiukas;EŽIUKŲ;3611922301;Taip;8;3;0;11
11483;Užupiukas;EŽIUKŲ;8020138690;Taip;11;0;1;12
11484;Užupiukas;EŽIUKŲ;6823724962;Taip;23;0;0;23
11485;Užupiukas;EŽIUKŲ;5538327364;Taip;0;0;3;3
11486;Užupiukas;EŽIUKŲ;3057147440;Taip;12;1;0;13
11487;Užupiukas;EŽIUKŲ;6370918943;Taip;0;1;0;1
11488;Užupiukas;EŽIUKŲ;9357101972;Taip;0;0;4;4
11489;Užupiukas;EŽIUKŲ;6512355340;Taip;0;11;0;11
11490;Užupiukas;EŽIUKŲ;4356736070;Taip;9;0;1;10
11491;Užupiukas;EŽIUKŲ;9906475253;Taip;6;0;0;6
11492;Užupiukas;EŽIUKŲ;2362568676;Taip;13;0;0;13
11493;Užupiukas;EŽIUKŲ;8127218866;Taip;13;0;0;13
11494;Užupiukas;BORUŽĖLIŲ;4781598862;Taip;7;0;6;13
11495;Užupiukas;BORUŽĖLIŲ;7861121290;Taip;4;0;0;4
11496;Užupiukas;BORUŽĖLIŲ;12787288319;Taip;5;0;0;5
11497;Užupiukas;BORUŽĖLIŲ;6526550727;Taip;9;0;0;9
11498;Užupiukas;BORUŽĖLIŲ;9735462228;Taip;12;0;0;12
11499;Užupiukas;BORUŽĖLIŲ;1582921323;Taip;9;0;0;9
11500;Užupiukas;BORUŽĖLIŲ;9791681813;Taip;0;2;0;2
11501;Užupiukas;BORUŽĖLIŲ;1503714343;Taip;0;3;0;3
11502;Užupiukas;BORUŽĖLIŲ;8313812681;Taip;10;0;1;11
11503;Užupiukas;BORUŽĖLIŲ;9677572224;Taip;6;0;0;6
11504;Užupiukas;BORUŽĖLIŲ;2445335267;Taip;3;0;0;3
11505;Užupiukas;BORUŽĖLIŲ;38066177076;Taip;0;7;0;7
11506;Užupiukas;BORUŽĖLIŲ;1514268763;Taip;8;3;0;11
11507;Užupiukas;BORUŽĖLIŲ;7555702944;Taip;6;1;0;7
11508;Užupiukas;BORUŽĖLIŲ;2307600884;Taip;0;3;0;3
11509;Užupiukas;BORUŽĖLIŲ;6073039842;Taip;9;3;4;16
11510;Užupiukas;BORUŽĖLIŲ;3038973312;Taip;5;0;1;6
11511;Užupiukas;BORUŽĖLIŲ;6601099182;Ne;5;4;6;15
11512;Užupiukas;BORUŽĖLIŲ;3940264504;Taip;0;1;0;1
11513;Užupiukas;BORUŽĖLIŲ;5517458323;Ne;0;1;2;3
11514;Užupiukas;BORUŽĖLIŲ;7427702848;Taip;3;1;0;4
11515;Užupiukas;SPINDULIUKŲ;5889162375;Taip;0;9;0;9
11516;Užupiukas;SPINDULIUKŲ;1718518621;Taip;0;0;3;3
11517;Užupiukas;SPINDULIUKŲ;7140606152;Taip;0;3;1;4
11518;Užupiukas;SPINDULIUKŲ;1679324943;Taip;0;3;0;3
11519;Užupiukas;SPINDULIUKŲ;7298322865;Taip;5;0;0;5
11520;Užupiukas;SPINDULIUKŲ;8734960045;Taip;13;2;1;16
11521;Užupiukas;SPINDULIUKŲ;3298267311;Taip;0;5;0;5
11522;Užupiukas;SPINDULIUKŲ;9617597828;Taip;0;0;1;1
11523;Užupiukas;SPINDULIUKŲ;8915159672;Taip;0;4;0;4
11524;Užupiukas;SPINDULIUKŲ;1554333137;Taip;0;3;15;18
11525;Užupiukas;SPINDULIUKŲ;9723966502;Taip;0;0;4;4
11526;Užupiukas;SPINDULIUKŲ;9655636851;Taip;0;0;1;1
11527;Užupiukas;SPINDULIUKŲ;8724566014;Taip;1;3;0;4
11528;Užupiukas;SPINDULIUKŲ;8870229834;Taip;5;3;4;12
11529;Užupiukas;SPINDULIUKŲ;14139543365;Taip;0;0;1;1
11530;Užupiukas;SPINDULIUKŲ;9782972949;Taip;0;0;5;5
11531;Užupiukas;SPINDULIUKŲ;3958071677;Ne;0;2;1;3
11532;Užupiukas;SPINDULIUKŲ;3231001225;Taip;0;3;5;8
11533;Užupiukas;SPINDULIUKŲ;5406866873;Taip;0;3;5;8
11534;Užupiukas;ŽVIRBLIUKŲ;8519118225;Taip;15;1;0;16
11535;Užupiukas;ŽVIRBLIUKŲ;7549628277;Taip;5;11;0;16
11536;Užupiukas;ŽVIRBLIUKŲ;5085660507;Taip;5;4;0;9
11537;Užupiukas;ŽVIRBLIUKŲ;2273766308;Taip;11;0;0;11
11538;Užupiukas;ŽVIRBLIUKŲ;7530856195;Taip;6;1;0;7
11539;Užupiukas;ŽVIRBLIUKŲ;9925592494;Taip;7;2;0;9
11540;Užupiukas;ŽVIRBLIUKŲ;7345579721;Taip;10;8;0;18
11541;Užupiukas;ŽVIRBLIUKŲ;4710910251;Taip;10;9;0;19
11542;Užupiukas;ŽVIRBLIUKŲ;9428884149;Taip;3;8;0;11
11543;Užupiukas;ŽVIRBLIUKŲ;4054724625;Taip;0;4;0;4
11544;Užupiukas;ŽVIRBLIUKŲ;2210437775;Taip;0;4;0;4
11545;Užupiukas;ŽVIRBLIUKŲ;1995228207;Taip;6;0;0;6
11546;Užupiukas;ŽVIRBLIUKŲ;1496541880;Taip;0;23;0;23
11547;Užupiukas;ŽVIRBLIUKŲ;1684901495;Taip;3;1;0;4
11548;Užupiukas;ŽVIRBLIUKŲ;2390955083;Taip;0;3;0;3
11549;Užupiukas;ŽVIRBLIUKŲ;6001766518;Taip;3;0;0;3
11550;Užupiukas;ŽVIRBLIUKŲ;3768945773;Taip;4;0;0;4
11551;Užupiukas;ŽVIRBLIUKŲ;3224193396;Taip;0;3;0;3
11552;Užupiukas;ŽVIRBLIUKŲ;1843171673;Taip;13;0;0;13
11553;Užupiukas;ŽVIRBLIUKŲ;4785494419;Ne;5;5;0;10
11554;Užupiukas;ŽVIRBLIUKŲ;6483696325;Taip;0;0;1;1
11555;Užupiukas;ŽVIRBLIUKŲ;8119142600;Taip;0;0;9;9
11556;Užupiukas;PELĖDŽIUKŲ;2938276316;Taip;0;3;5;8
11557;Užupiukas;PELĖDŽIUKŲ;5320544400;Taip;0;1;6;7
11558;Užupiukas;PELĖDŽIUKŲ;40704768956;Taip;0;3;0;3
11559;Užupiukas;PELĖDŽIUKŲ;5665323444;Ne;0;3;2;5
11560;Užupiukas;PELĖDŽIUKŲ;4880828482;Taip;4;1;2;7
11561;Užupiukas;PELĖDŽIUKŲ;6478702476;Taip;0;3;4;7
11562;Užupiukas;PELĖDŽIUKŲ;6110869303;Taip;0;1;4;5
11563;Užupiukas;PELĖDŽIUKŲ;3205769002;Taip;0;0;3;3
11564;Užupiukas;PELĖDŽIUKŲ;79442829922;Taip;0;3;0;3
11565;Užupiukas;PELĖDŽIUKŲ;4247280316;Taip;0;3;0;3
11566;Užupiukas;PELĖDŽIUKŲ;4608233152;Taip;0;5;1;6
11567;Užupiukas;PELĖDŽIUKŲ;5498369850;Taip;0;3;0;3
11568;Užupiukas;PELĖDŽIUKŲ;2821350355;Taip;0;3;2;5
11569;Užupiukas;PELĖDŽIUKŲ;3309195572;Taip;0;3;4;7
11570;Užupiukas;PELĖDŽIUKŲ;4132760111;Ne;0;4;0;4
11571;Užupiukas;PELĖDŽIUKŲ;22401995674;Taip;0;3;1;4
11572;Užupiukas;PELĖDŽIUKŲ;53412835151;Taip;0;3;0;3
11573;Užupiukas;PELĖDŽIUKŲ;3774364829;Taip;2;3;0;5
11574;Užupiukas;PELĖDŽIUKŲ;9197242545;Taip;0;3;8;11
11575;Užupiukas;PELĖDŽIUKŲ;5357731534;Taip;0;3;1;4
11576;Užupiukas;PELĖDŽIUKŲ;5046355276;Taip;0;0;1;1
11577;Užupiukas;VARPELIŲ;7107441792;Taip;3;0;0;3
11578;Užupiukas;VARPELIŲ;8881187663;Taip;0;0;1;1
11579;Užupiukas;VARPELIŲ;7895825571;Taip;0;0;1;1
11580;Užupiukas;VARPELIŲ;8518137669;Taip;8;0;0;8
11581;Užupiukas;VARPELIŲ;7919242126;Taip;0;0;2;2
11582;Užupiukas;VARPELIŲ;9310238442;Taip;0;0;4;4
11583;Užupiukas;VARPELIŲ;2769924857;Taip;3;0;0;3
11584;Užupiukas;VARPELIŲ;6538402680;Ne;13;0;0;13
11585;Užupiukas;VARPELIŲ;5941280824;Taip;12;0;7;19
11586;Užupiukas;VARPELIŲ;7105857162;Taip;5;0;3;8
11587;Užupiukas;VARPELIŲ;2485426055;Taip;10;0;1;11
11588;Užupiukas;VARPELIŲ;7314085267;Taip;6;0;2;8
11589;Užupiukas;VARPELIŲ;2752139377;Taip;6;0;3;9
11590;Užupiukas;VARPELIŲ;4106614478;Taip;0;0;3;3
11591;Užupiukas;VARPELIŲ;1407429980;Taip;9;0;0;9
11592;Užupiukas;VARPELIŲ;4811619739;Taip;5;1;0;6
11593;Užupiukas;VARPELIŲ;1037307190;Taip;0;0;23;23
11594;Užupiukas;VARPELIŲ;2767523129;Taip;0;0;1;1
11595;Užupiukas;VARPELIŲ;9523512906;Taip;10;0;1;11
11596;Užupiukas;VARPELIŲ;2506094889;Taip;15;0;6;21
11597;Užupiukas;SAULUČIŲ;5704945892;Taip;4;0;1;5
11598;Užupiukas;SAULUČIŲ;2681679016;Taip;17;0;0;17
11599;Užupiukas;SAULUČIŲ;3684774901;Ne;0;2;2;4
11600;Užupiukas;SAULUČIŲ;8163092636;Taip;0;0;9;9
11601;Užupiukas;SAULUČIŲ;1976775494;Ne;9;0;2;11
11602;Užupiukas;SAULUČIŲ;5874450724;Taip;5;0;6;11
11603;Užupiukas;SAULUČIŲ;3341292382;Taip;15;0;0;15
11604;Užupiukas;SAULUČIŲ;2211595125;Taip;8;0;0;8
11605;Užupiukas;SAULUČIŲ;7450368045;Taip;11;0;2;13
11606;Užupiukas;SAULUČIŲ;5570569874;Taip;3;0;1;4
11607;Užupiukas;SAULUČIŲ;7643286183;Ne;4;0;3;7
11608;Užupiukas;SAULUČIŲ;2814556305;Taip;0;0;2;2
11609;Užupiukas;SAULUČIŲ;7209853233;Taip;8;0;0;8
11610;Užupiukas;SAULUČIŲ;9953994943;Taip;2;7;0;9
11611;Užupiukas;SAULUČIŲ;7956550754;Ne;6;0;2;8
11612;Užupiukas;SAULUČIŲ;5469735455;Taip;0;1;4;5
11613;Užupiukas;SAULUČIŲ;8489545569;Taip;3;0;2;5
11614;Užupiukas;SAULUČIŲ;7990479988;Taip;4;0;4;8
11615;Užupiukas;SAULUČIŲ;4691413468;Taip;13;0;1;14
11616;Užupiukas;SAULUČIŲ;7423292334;Taip;5;8;0;13
11617;Užupiukas;SAULUČIŲ;9216626936;Taip;0;3;0;3
11618;Užupiukas;SAULUČIŲ;9962455415;Taip;11;0;0;11
11619;Užupiukas;LAPIUKŲ;9833934299;Taip;7;0;0;7
11620;Užupiukas;LAPIUKŲ;4963679583;Taip;16;0;1;17
11621;Užupiukas;LAPIUKŲ;2679915982;Ne;0;1;0;1
11622;Užupiukas;LAPIUKŲ;6004467875;Taip;5;0;0;5
11623;Užupiukas;LAPIUKŲ;7986962850;Taip;8;0;0;8
11624;Užupiukas;LAPIUKŲ;2517606394;Taip;13;0;0;13
11625;Užupiukas;LAPIUKŲ;7559183263;Taip;0;1;0;1
11626;Užupiukas;LAPIUKŲ;7161001771;Taip;12;0;0;12
11627;Užupiukas;LAPIUKŲ;1886792898;Taip;0;3;0;3
11628;Užupiukas;LAPIUKŲ;6967184410;Taip;0;6;2;8
11629;Užupiukas;LAPIUKŲ;4900699267;Taip;0;1;0;1
11630;Užupiukas;LAPIUKŲ;1178152392;Taip;0;1;1;2
11631;Užupiukas;LAPIUKŲ;7029091978;Taip;5;1;6;12
11632;Užupiukas;LAPIUKŲ;1041972540;Taip;0;1;1;2
11633;Užupiukas;LAPIUKŲ;4467470795;Taip;0;1;1;2
11634;Užupiukas;LAPIUKŲ;8252575784;Taip;11;5;0;16
11635;Užupiukas;LAPIUKŲ;3333547785;Taip;11;1;0;12
11636;Užupiukas;NYKŠTUKŲ;4895744524;Taip;16;0;0;16
11637;Užupiukas;NYKŠTUKŲ;3811750547;Taip;0;0;6;6
11638;Užupiukas;NYKŠTUKŲ;2158976125;Taip;0;0;6;6
11639;Užupiukas;NYKŠTUKŲ;6206118484;Taip;5;0;0;5
11640;Užupiukas;NYKŠTUKŲ;4841475687;Taip;4;0;1;5
11641;Užupiukas;NYKŠTUKŲ;4379182756;Taip;3;3;2;8
11642;Užupiukas;NYKŠTUKŲ;9785674147;Taip;0;3;2;5
11643;Užupiukas;NYKŠTUKŲ;3094320206;Taip;0;3;2;5
11644;Užupiukas;NYKŠTUKŲ;9714322911;Taip;9;0;2;11
11645;Užupiukas;NYKŠTUKŲ;3014087333;Taip;3;0;3;6
11646;Užupiukas;NYKŠTUKŲ;7589905741;Taip;5;0;0;5
11647;Užupiukas;NYKŠTUKŲ;1891855020;Taip;20;0;0;20
11648;Užupiukas;NYKŠTUKŲ;1473606331;Taip;0;0;22;22
11649;Užupiukas;NYKŠTUKŲ;4570457987;Taip;15;0;0;15
11650;Vaidilutė;Žiogelis;45949026707;Taip;5;3;0;8
11651;Vaidilutė;Žiogelis;1853463568;Taip;0;13;1;14
11652;Vaidilutė;Žiogelis;16491592864;Taip;10;0;0;10
11653;Vaidilutė;Žiogelis;5203062837;Taip;0;3;0;3
11654;Vaidilutė;Žiogelis;3112025222;Taip;5;0;0;5
11655;Vaidilutė;Žiogelis;4334934114;Taip;8;0;0;8
11656;Vaidilutė;Žiogelis;7843388119;Taip;0;3;0;3
11657;Vaidilutė;Žiogelis;3152118407;Taip;0;0;1;1
11658;Vaidilutė;Žiogelis;5991149222;Taip;0;2;0;2
11659;Vaidilutė;Žiogelis;1786022030;Taip;6;1;1;8
11660;Vaidilutė;Žiogelis;1266927367;Taip;0;3;0;3
11661;Vaidilutė;Žiogelis;1430802591;Taip;0;3;0;3
11662;Vaidilutė;Žiogelis;4259585225;Taip;5;3;0;8
11663;Vaidilutė;Žiogelis;9556632708;Taip;1;3;1;5
11664;Vaidilutė;Žiogelis;1769926207;Taip;0;3;0;3
11665;Vaidilutė;Rūtelė;2131127298;Taip;18;0;0;18
11666;Vaidilutė;Rūtelė;8789527552;Taip;0;3;0;3
11667;Vaidilutė;Rūtelė;7319037375;Ne;0;0;3;3
11668;Vaidilutė;Rūtelė;4838951446;Taip;4;1;0;5
11669;Vaidilutė;Rūtelė;7494818866;Ne;0;3;1;4
11670;Vaidilutė;Rūtelė;5500950179;Taip;8;0;1;9
11671;Vaidilutė;Rūtelė;1140011879;Taip;0;1;1;2
11672;Vaidilutė;Rūtelė;9563257771;Taip;0;3;0;3
11673;Vaidilutė;Rūtelė;2024078532;Taip;0;0;3;3
11674;Vaidilutė;Rūtelė;8505156287;Taip;10;0;0;10
11675;Vaidilutė;Rūtelė;9568450630;Taip;15;0;1;16
11676;Vaidilutė;Rūtelė;7306768961;Taip;10;0;0;10
11677;Vaidilutė;Rūtelė;7532115462;Taip;0;0;3;3
11678;Vaidilutė;Rūtelė;6896047075;Taip;0;8;0;8
11679;Vaidilutė;Rūtelė;3059654988;Taip;5;1;1;7
11680;Vaidilutė;Rūtelė;1341696594;Taip;9;0;1;10
11681;Vaidilutė;Rūtelė;1141947715;Taip;10;0;1;11
11682;Vaidilutė;Rūtelė;9437865610;Taip;0;3;1;4
11683;Vaidilutė;Rūtelė;2014160468;Ne;0;0;2;2
11684;Vaidilutė;Voveraitė;1608646909;Taip;16;0;1;17
11685;Vaidilutė;Voveraitė;9429544108;Taip;10;1;0;11
11686;Vaidilutė;Voveraitė;5652381296;Taip;0;0;1;1
11687;Vaidilutė;Voveraitė;8377824920;Taip;13;4;0;17
11688;Vaidilutė;Voveraitė;5296146822;Taip;5;0;0;5
11689;Vaidilutė;Voveraitė;3299081380;Taip;0;10;0;10
11690;Vaidilutė;Voveraitė;3634285869;Taip;8;5;1;14
11691;Vaidilutė;Voveraitė;7703578508;Taip;14;6;0;20
11692;Vaidilutė;Voveraitė;3150642420;Taip;5;0;0;5
11693;Vaidilutė;Voveraitė;5855762068;Taip;6;6;0;12
11694;Vaidilutė;Voveraitė;8177787790;Taip;0;4;0;4
11695;Vaidilutė;Voveraitė;7327131165;Taip;13;4;0;17
11696;Vaidilutė;Voveraitė;2318578603;Taip;0;2;7;9
11697;Vaidilutė;Voveraitė;1372767364;Ne;0;0;2;2
11698;Vaidilutė;Voveraitė;7478943531;Taip;7;1;0;8
11699;Vaidilutė;Voveraitė;4738318120;Taip;0;9;0;9
11700;Vaidilutė;Voveraitė;3319615121;Taip;0;1;0;1
11701;Vaidilutė;Voveraitė;6299324271;Ne;0;0;5;5
11702;Vaidilutė;Voveraitė;4186708502;Ne;0;0;3;3
11703;Vaidilutė;Voveraitė;2855672500;Ne;0;0;6;6
11704;Vaidilutė;Voveraitė;8053548602;Taip;0;23;0;23
11705;Vaidilutė;Saulutė;8492055287;Taip;19;0;0;19
11706;Vaidilutė;Saulutė;4972645715;Taip;0;0;13;13
11707;Vaidilutė;Saulutė;1355005114;Taip;0;1;1;2
11708;Vaidilutė;Saulutė;4680645841;Taip;0;4;0;4
11709;Vaidilutė;Saulutė;2662468804;Ne;0;1;1;2
11710;Vaidilutė;Saulutė;5217609332;Taip;0;4;0;4
11711;Vaidilutė;Saulutė;2864731541;Taip;16;0;0;16
11712;Vaidilutė;Saulutė;1998872078;Taip;3;0;0;3
11713;Vaidilutė;Saulutė;2468220275;Taip;0;3;3;6
11714;Vaidilutė;Saulutė;1610262589;Taip;5;0;1;6
11715;Vaidilutė;Saulutė;2356037175;Taip;0;1;0;1
11716;Vaidilutė;Saulutė;5054640268;Taip;10;0;1;11
11717;Vaidilutė;Saulutė;6885473308;Taip;2;0;0;2
11718;Vaidilutė;Saulutė;7826111890;Taip;9;1;0;10
11719;Vaidilutė;Saulutė;5945744595;Ne;6;3;0;9
11720;Vaidilutė;Saulutė;6674238265;Taip;0;3;4;7
11721;Vaidilutė;Saulutė;2495112045;Taip;19;0;1;20
11722;Vaidilutė;Saulutė;1092821241;Taip;3;0;0;3
11723;Vaidilutė;Saulutė;2294802783;Taip;1;13;0;14
11724;Vaidilutė;Žibutė;4085959509;Taip;4;0;3;7
11725;Vaidilutė;Žibutė;1001320466;Taip;5;0;1;6
11726;Vaidilutė;Žibutė;9189713003;Taip;12;0;2;14
11727;Vaidilutė;Žibutė;7903242996;Taip;0;0;10;10
11728;Vaidilutė;Žibutė;7400197367;Taip;5;0;0;5
11729;Vaidilutė;Žibutė;5236154349;Taip;5;0;0;5
11730;Vaidilutė;Žibutė;3980894528;Taip;16;0;1;17
11731;Vaidilutė;Žibutė;1362256314;Taip;0;5;0;5
11732;Vaidilutė;Žibutė;7940581813;Taip;2;3;0;5
11733;Vaidilutė;Žibutė;2767482145;Taip;2;5;0;7
11734;Vaidilutė;Žibutė;7765298370;Taip;0;0;3;3
11735;Vaidilutė;Žibutė;8769601956;Taip;0;0;1;1
11736;Vaidilutė;Žibutė;1726638921;Taip;4;1;2;7
11737;Vaidilutė;Žibutė;5415279154;Taip;5;6;0;11
11738;Vaidilutė;Žibutė;1377015807;Taip;0;0;1;1
11739;Vaidilutė;Žibutė;4124217264;Taip;0;0;5;5
11740;Vaidilutė;Žibutė;7429825620;Taip;0;0;2;2
11741;Vaidilutė;Žibutė;7690470762;Taip;12;0;0;12
11742;Vaidilutė;"Ąžuoliukas ";3463112472;Taip;0;0;1;1
11743;Vaidilutė;"Ąžuoliukas ";3730573432;Taip;17;0;0;17
11744;Vaidilutė;"Ąžuoliukas ";1305478052;Taip;0;0;3;3
11745;Vaidilutė;"Ąžuoliukas ";4954285515;Ne;0;1;0;1
11746;Vaidilutė;"Ąžuoliukas ";5439973183;Taip;10;0;1;11
11747;Vaidilutė;"Ąžuoliukas ";4761992071;Taip;0;0;3;3
11748;Vaidilutė;"Ąžuoliukas ";3381544575;Taip;3;0;0;3
11749;Vaidilutė;"Ąžuoliukas ";5307486959;Taip;0;4;0;4
11750;Vaidilutė;"Ąžuoliukas ";1653497170;Taip;0;4;0;4
11751;Vaidilutė;"Ąžuoliukas ";1440819171;Ne;0;12;0;12
11752;Vaidilutė;"Ąžuoliukas ";2668758195;Taip;0;0;9;9
11753;Vaidilutė;"Ąžuoliukas ";4901387311;Taip;8;0;2;10
11754;Vaidilutė;"Ąžuoliukas ";2997948252;Taip;5;0;2;7
11755;Vaidilutė;"Ąžuoliukas ";9723156071;Taip;0;6;4;10
11756;Vaidilutė;"Ąžuoliukas ";4193108560;Ne;11;0;0;11
11757;Vaidilutė;"Ąžuoliukas ";3782651091;Taip;3;0;0;3
11758;Vaidilutė;"Ąžuoliukas ";6637224510;Taip;0;0;11;11
11759;Vaidilutė;"Ąžuoliukas ";6067801976;Taip;0;0;3;3
11760;Vaidilutė;"Žemuogėlė ";1993403692;Taip;0;1;1;2
11761;Vaidilutė;"Žemuogėlė ";42503303158;Taip;0;3;0;3
11762;Vaidilutė;"Žemuogėlė ";9869134464;Taip;0;1;0;1
11763;Vaidilutė;"Žemuogėlė ";29153363263;Taip;11;0;3;14
11764;Vaidilutė;"Žemuogėlė ";3069613102;Taip;2;2;0;4
11765;Vaidilutė;"Žemuogėlė ";1297817018;Taip;0;1;2;3
11766;Vaidilutė;"Žemuogėlė ";5177060346;Taip;2;3;1;6
11767;Vaidilutė;"Žemuogėlė ";4671287016;Taip;8;0;6;14
11768;Vaidilutė;"Žemuogėlė ";9124975928;Taip;0;4;0;4
11769;Vaidilutė;"Žemuogėlė ";7419525100;Taip;0;2;0;2
11770;Vaidilutė;"Žemuogėlė ";1363913645;Taip;0;6;0;6
11771;Vaidilutė;"Žemuogėlė ";5252637701;Taip;0;3;1;4
11772;Vaidilutė;"Žemuogėlė ";3202508790;Taip;5;3;1;9
11773;Vaidilutė;"Žemuogėlė ";1320999237;Taip;0;0;1;1
11774;Vaidilutė;"Žemuogėlė ";9769645272;Taip;0;0;2;2
11775;Vaidilutė;"Žemuogėlė ";1691407801;Taip;0;1;0;1
11776;Vaidilutė;"Žemuogėlė ";1315347184;Taip;0;2;0;2
11777;Vaidilutė;"Žemuogėlė ";1704155743;Taip;0;0;3;3
11778;Vaidilutė;"Žemuogėlė ";5276088687;Taip;0;3;0;3
11779;Vaidilutė;"Vyturėlis ";3121914268;Taip;5;0;0;5
11780;Vaidilutė;"Vyturėlis ";5050251048;Taip;3;10;2;15
11781;Vaidilutė;"Vyturėlis ";9558983004;Taip;0;7;0;7
11782;Vaidilutė;"Vyturėlis ";5326935037;Taip;13;5;1;19
11783;Vaidilutė;"Vyturėlis ";2189753894;Taip;0;6;0;6
11784;Vaidilutė;"Vyturėlis ";9689388330;Taip;0;1;0;1
11785;Vaidilutė;"Vyturėlis ";9584702487;Taip;0;11;0;11
11786;Vaidilutė;"Vyturėlis ";2081959307;Taip;0;2;3;5
11787;Vaidilutė;"Vyturėlis ";8882402632;Taip;0;5;6;11
11788;Vaidilutė;"Vyturėlis ";4230076320;Taip;0;3;0;3
11789;Vaidilutė;"Vyturėlis ";2058071219;Taip;9;3;2;14
11790;Vaidilutė;"Vyturėlis ";1401180999;Taip;0;1;1;2
11791;Vaidilutė;"Vyturėlis ";1417828163;Taip;0;3;0;3
11792;Vaidilutė;"Vyturėlis ";5651628204;Ne;0;3;0;3
11793;Vaidilutė;"Vyturėlis ";2251608691;Taip;8;2;0;10
11794;Vaidilutė;"Vyturėlis ";7914006128;Taip;5;0;0;5
11795;Vaidilutė;"Vyturėlis ";7131561558;Taip;0;1;2;3
11796;Vaidilutė;"Vyturėlis ";2194984060;Taip;0;0;5;5
11797;Vaidilutė;"Vyturėlis ";3351968717;Taip;12;3;0;15
11798;Vaidilutė;"Varpelis ";6250831269;Taip;4;3;0;7
11799;Vaidilutė;"Varpelis ";6037349527;Taip;4;3;4;11
11800;Vaidilutė;"Varpelis ";5867501558;Taip;0;4;0;4
11801;Vaidilutė;"Varpelis ";9317774960;Taip;0;1;0;1
11802;Vaidilutė;"Varpelis ";5448014291;Taip;0;3;0;3
11803;Vaidilutė;"Varpelis ";3497795848;Taip;0;3;3;6
11804;Vaidilutė;"Varpelis ";4280822951;Taip;0;5;2;7
11805;Vaidilutė;"Varpelis ";6107554047;Taip;0;0;1;1
11806;Vaidilutė;"Varpelis ";6022130248;Taip;0;0;8;8
11807;Vaidilutė;"Varpelis ";5594121340;Taip;0;2;3;5
11808;Vaidilutė;"Varpelis ";1882829340;Taip;8;7;1;16
11809;Vaidilutė;"Varpelis ";6097229427;Taip;0;0;1;1
11810;Vaidilutė;"Varpelis ";3353827105;Ne;13;0;2;15
11811;Vaidilutė;"Varpelis ";4362797606;Taip;0;3;0;3
11812;Vaidilutė;"Varpelis ";6322986820;Taip;0;0;2;2
11813;Vaidilutė;"Varpelis ";2941550026;Taip;0;3;0;3
11814;Vaidilutė;"Boružėlių ";6928815317;Taip;23;0;0;23
11815;Vaidilutė;"Boružėlių ";4648985217;Taip;0;3;0;3
11816;Vaidilutė;"Boružėlių ";4805621473;Taip;0;3;0;3
11817;Vaidilutė;"Boružėlių ";5008411199;Taip;6;0;0;6
11818;Vaidilutė;"Boružėlių ";5405461987;Taip;5;0;0;5
11819;Vaidilutė;"Boružėlių ";1283676263;Taip;10;0;0;10
11820;Vaidilutė;"Boružėlių ";8629789128;Taip;8;0;0;8
11821;Vaidilutė;"Boružėlių ";8413764934;Taip;0;1;0;1
11822;Vaidilutė;"Boružėlių ";7019245743;Taip;13;0;0;13
11823;Vaidilutė;"Boružėlių ";8012451263;Taip;5;1;0;6
11824;Vaidilutė;"Boružėlių ";4760330697;Taip;0;13;0;13
11825;Vaidilutė;"Boružėlių ";5205356977;Taip;5;0;0;5
11826;Vaidilutė;"Boružėlių ";5095161432;Taip;9;0;0;9
11827;Vaidilutė;"Malūnelis ";4887753072;Taip;0;3;0;3
11828;Vaidilutė;"Malūnelis ";2876157676;Taip;5;0;0;5
11829;Vaidilutė;"Malūnelis ";6965297550;Taip;12;4;3;19
11830;Vaidilutė;"Malūnelis ";3557654689;Ne;5;0;0;5
11831;Vaidilutė;"Malūnelis ";8257746012;Ne;5;0;0;5
11832;Vaidilutė;"Malūnelis ";8444010416;Taip;0;1;2;3
11833;Vaidilutė;"Malūnelis ";4568108299;Taip;13;0;0;13
11834;Vaidilutė;"Malūnelis ";1998966302;Taip;0;0;1;1
11835;Vaidilutė;"Malūnelis ";5026620305;Taip;5;4;0;9
11836;Vaidilutė;"Malūnelis ";4469754560;Taip;2;0;1;3
11837;Vaidilutė;"Malūnelis ";8433116520;Taip;7;0;1;8
11838;Vaidilutė;"Malūnelis ";5918039529;Taip;5;0;0;5
11839;Vaidilutė;"Malūnelis ";7660273021;Taip;0;1;0;1
11840;Vaidilutė;"Riešutėlis ";3605988018;Taip;2;3;0;5
11841;Vaidilutė;"Riešutėlis ";1161455376;Taip;13;0;1;14
11842;Vaidilutė;"Riešutėlis ";4518002596;Ne;0;0;3;3
11843;Vaidilutė;"Riešutėlis ";4657952465;Ne;0;0;8;8
11844;Vaidilutė;"Riešutėlis ";8756807918;Taip;0;0;5;5
11845;Vaidilutė;"Riešutėlis ";1206696843;Taip;3;3;3;9
11846;Vaidilutė;"Riešutėlis ";9872915544;Taip;0;5;0;5
11847;Vaidilutė;"Riešutėlis ";2976615414;Taip;0;0;9;9
11848;Vaidilutė;"Riešutėlis ";4709977896;Taip;0;7;0;7
11849;Vaidilutė;"Riešutėlis ";9025469107;Taip;0;0;6;6
11850;Vaidilutė;"Riešutėlis ";3862444839;Taip;8;0;0;8
11851;Vaidilutė;"Riešutėlis ";7713772984;Taip;0;0;15;15
11852;Vaidilutė;"Riešutėlis ";3064988592;Taip;8;0;8;16
11853;Vaidilutė;"Riešutėlis ";8296567629;Taip;2;0;1;3
11854;Vaidilutė;"Riešutėlis ";7871629009;Taip;0;0;1;1
11855;Vandenis;ŽUVĖDRŲ;5362078687;Taip;0;3;0;3
11856;Vandenis;ŽUVĖDRŲ;6784010746;Ne;10;2;0;12
11857;Vandenis;ŽUVĖDRŲ;9334958945;Taip;8;1;0;9
11858;Vandenis;ŽUVĖDRŲ;4303303483;Taip;10;5;0;15
11859;Vandenis;ŽUVĖDRŲ;2325465812;Taip;0;3;0;3
11860;Vandenis;ŽUVĖDRŲ;2649542586;Taip;0;13;0;13
11861;Vandenis;ŽUVĖDRŲ;1144490168;Taip;0;3;0;3
11862;Vandenis;ŽUVĖDRŲ;7948161881;Taip;0;10;0;10
11863;Vandenis;ŽUVĖDRŲ;7391206543;Taip;12;0;0;12
11864;Vandenis;ŽUVĖDRŲ;9335319713;Taip;8;0;0;8
11865;Vandenis;ŽUVĖDRŲ;7296608892;Taip;0;4;0;4
11866;Vandenis;ŽUVĖDRŲ;4117091634;Taip;0;4;0;4
11867;Vandenis;ŽUVĖDRŲ;2276497021;Taip;4;1;0;5
11868;Vandenis;ŽUVĖDRŲ;6063181697;Taip;0;2;0;2
11869;Vandenis;ŽUVĖDRŲ;6661117114;Taip;13;1;0;14
11870;Vandenis;ŽUVĖDRŲ;6456557095;Taip;8;0;0;8
11871;Vandenis;ŽUVĖDRŲ;3342147138;Taip;15;0;0;15
11872;Vandenis;ŽUVĖDRŲ;5112768778;Taip;0;6;0;6
11873;Vandenis;RUONIUKŲ;2422642232;Taip;0;6;0;6
11874;Vandenis;RUONIUKŲ;1051281257;Taip;0;6;0;6
11875;Vandenis;RUONIUKŲ;7565308536;Taip;0;2;0;2
11876;Vandenis;RUONIUKŲ;1120907086;Taip;0;6;0;6
11877;Vandenis;RUONIUKŲ;1563710105;Taip;0;0;1;1
11878;Vandenis;RUONIUKŲ;6476051751;Taip;5;8;0;13
11879;Vandenis;RUONIUKŲ;9162936403;Taip;0;2;0;2
11880;Vandenis;RUONIUKŲ;4713395766;Taip;0;2;0;2
11881;Vandenis;RUONIUKŲ;6986724058;Taip;0;1;0;1
11882;Vandenis;RUONIUKŲ;9527253920;Taip;5;3;0;8
11883;Vandenis;RUONIUKŲ;8971291182;Taip;1;0;0;1
11884;Vandenis;RUONIUKŲ;6330187732;Taip;0;13;0;13
11885;Vandenis;RUONIUKŲ;4971165639;Taip;0;4;0;4
11886;Vandenis;RUONIUKŲ;6158299885;Taip;0;0;2;2
11887;Vandenis;RUONIUKŲ;3664560833;Taip;10;0;0;10
11888;Vandenis;ŽUVYČIŲ;55421695186;Taip;8;0;0;8
11889;Vandenis;ŽUVYČIŲ;43933878402;Taip;0;3;0;3
11890;Vandenis;ŽUVYČIŲ;9608871155;Taip;0;1;0;1
11891;Vandenis;ŽUVYČIŲ;7381695975;Taip;0;3;0;3
11892;Vandenis;ŽUVYČIŲ;8430706407;Taip;0;1;0;1
11893;Vandenis;ŽUVYČIŲ;8689134931;Taip;0;3;0;3
11894;Vandenis;ŽUVYČIŲ;4085256182;Taip;0;6;0;6
11895;Vandenis;ŽUVYČIŲ;6828175620;Taip;0;1;0;1
11896;Vandenis;ŽUVYČIŲ;1535450614;Taip;0;0;1;1
11897;Vandenis;ŽUVYČIŲ;7408758565;Taip;0;1;0;1
11898;Vandenis;ŽUVYČIŲ;1598122777;Taip;0;1;0;1
11899;Vandenis;ŽUVYČIŲ;18336904438;Taip;0;3;0;3
11900;Vandenis;ŽUVYČIŲ;1815765498;Taip;5;4;0;9
11901;Vandenis;ŽUVYČIŲ;5549292096;Taip;6;0;0;6
11902;Vandenis;ŽUVYČIŲ;8705188652;Taip;6;4;0;10
11903;Vandenis;ŽUVYČIŲ;24217366528;Taip;0;3;0;3
11904;Vandenis;ŽUVYČIŲ;9994373029;Taip;0;3;0;3
11905;Vandenis;ŽUVYČIŲ;3544717790;Taip;0;3;0;3
11906;Vandenis;ŽUVYČIŲ;4643267945;Ne;0;5;3;8
11907;Vandenis;ŽUVYČIŲ;27409922803;Taip;0;3;1;4
11908;Vandenis;ŽUVYČIŲ;9518434896;Ne;0;5;0;5
11909;Vandenis;PERLIUKŲ;8678508812;Taip;0;6;0;6
11910;Vandenis;PERLIUKŲ;2645775090;Taip;10;0;0;10
11911;Vandenis;PERLIUKŲ;5844576485;Taip;0;3;0;3
11912;Vandenis;PERLIUKŲ;6295009202;Taip;0;6;0;6
11913;Vandenis;PERLIUKŲ;7598257845;Taip;4;0;0;4
11914;Vandenis;PERLIUKŲ;7473692892;Taip;3;0;0;3
11915;Vandenis;PERLIUKŲ;5323428164;Taip;0;4;0;4
11916;Vandenis;PERLIUKŲ;6073002418;Taip;0;4;0;4
11917;Vandenis;PERLIUKŲ;2576575249;Taip;5;1;0;6
11918;Vandenis;PERLIUKŲ;7832674282;Taip;15;0;0;15
11919;Vandenis;PERLIUKŲ;9798192239;Taip;0;3;0;3
11920;Vandenis;PERLIUKŲ;1975385430;Taip;0;3;0;3
11921;Vandenis;PERLIUKŲ;3061606138;Taip;11;3;0;14
11922;Vandenis;PERLIUKŲ;8117385209;Taip;6;0;0;6
11923;Vandenis;PERLIUKŲ;5613067534;Taip;0;5;3;8
11924;Vandenis;PERLIUKŲ;2321919298;Ne;14;1;0;15
11925;Vandenis;PERLIUKŲ;5963181638;Taip;0;1;0;1
11926;Vandenis;PERLIUKŲ;5609737826;Taip;0;0;8;8
11927;Vandenis;PERLIUKŲ;3239754791;Taip;10;2;0;12
11928;Vandenis;PERLIUKŲ;5129492284;Taip;6;2;0;8
11929;Vandenis;ANČIUKŲ;4607196473;Taip;12;0;0;12
11930;Vandenis;ANČIUKŲ;6189862061;Taip;2;7;0;9
11931;Vandenis;ANČIUKŲ;4345021061;Taip;2;7;0;9
11932;Vandenis;ANČIUKŲ;9763300020;Taip;10;3;0;13
11933;Vandenis;ANČIUKŲ;9968877035;Taip;0;1;0;1
11934;Vandenis;ANČIUKŲ;3639160500;Taip;13;0;0;13
11935;Vandenis;ANČIUKŲ;9458613523;Taip;0;1;0;1
11936;Vandenis;ANČIUKŲ;4715198793;Taip;3;2;0;5
11937;Vandenis;ANČIUKŲ;1213743099;Taip;0;2;0;2
11938;Vandenis;ANČIUKŲ;4978712442;Taip;8;3;0;11
11939;Vandenis;ANČIUKŲ;7631982912;Taip;8;2;0;10
11940;Vandenis;ANČIUKŲ;7581114286;Taip;0;7;0;7
11941;Vandenis;ANČIUKŲ;9679010239;Taip;1;6;0;7
11942;Vandenis;ANČIUKŲ;9314410776;Taip;10;5;0;15
11943;Vandenis;ANČIUKŲ;1132534461;Taip;16;0;0;16
11944;Vandenis;ANČIUKŲ;9498231306;Taip;0;3;0;3
11945;Vandenis;ANČIUKŲ;2647966131;Taip;4;0;0;4
11946;Vandenis;ANČIUKŲ;3544764716;Ne;8;2;2;12
11947;Vandenis;ANČIUKŲ;4530824157;Taip;8;0;1;9
11948;Vandenis;VĖŽLIUKŲ;2309166304;Ne;0;10;0;10
11949;Vandenis;VĖŽLIUKŲ;5454049563;Taip;0;1;0;1
11950;Vandenis;VĖŽLIUKŲ;9805578141;Taip;0;1;0;1
11951;Vandenis;VĖŽLIUKŲ;8921666108;Ne;0;6;0;6
11952;Vandenis;VĖŽLIUKŲ;8116532445;Taip;0;3;0;3
11953;Vandenis;VĖŽLIUKŲ;7069369080;Taip;0;2;0;2
11954;Vandenis;VĖŽLIUKŲ;7924399684;Taip;0;7;0;7
11955;Vandenis;VĖŽLIUKŲ;1187395353;Taip;0;4;0;4
11956;Vandenis;VĖŽLIUKŲ;7091356848;Taip;0;3;0;3
11957;Vandenis;VĖŽLIUKŲ;5126732658;Taip;0;4;0;4
11958;Vandenis;VĖŽLIUKŲ;7059385610;Taip;0;3;0;3
11959;Vandenis;VĖŽLIUKŲ;9158541919;Taip;0;5;0;5
11960;Vandenis;VĖŽLIUKŲ;5959181898;Taip;0;5;0;5
11961;Vandenis;VĖŽLIUKŲ;1707354287;Taip;6;4;0;10
11962;Vandenis;VĖŽLIUKŲ;4177166475;Taip;0;3;0;3
11963;Vandenis;VĖŽLIUKŲ;5218101579;Taip;0;2;0;2
11964;Vandenis;VĖŽLIUKŲ;2936885357;Taip;0;2;2;4
11965;Vandenis;VĖŽLIUKŲ;8879608849;Taip;0;12;0;12
11966;Vandenis;AŠTUNKOJŲ;2077783219;Taip;0;2;3;5
11967;Vandenis;AŠTUNKOJŲ;8511948282;Taip;0;4;0;4
11968;Vandenis;AŠTUNKOJŲ;2096950367;Taip;0;4;0;4
11969;Vandenis;AŠTUNKOJŲ;71786730314;Taip;0;4;0;4
11970;Vandenis;AŠTUNKOJŲ;6181866272;Taip;0;1;0;1
11971;Vandenis;AŠTUNKOJŲ;5395847317;Taip;0;3;0;3
11972;Vandenis;AŠTUNKOJŲ;33317650043;Taip;0;1;0;1
11973;Vandenis;AŠTUNKOJŲ;7522472652;Taip;8;0;1;9
11974;Vandenis;AŠTUNKOJŲ;3067868099;Taip;0;3;0;3
11975;Vandenis;AŠTUNKOJŲ;61120985165;Taip;3;3;0;6
11976;Vandenis;AŠTUNKOJŲ;1222539247;Taip;8;0;0;8
11977;Vandenis;AŠTUNKOJŲ;8251169901;Taip;0;6;0;6
11978;Vandenis;AŠTUNKOJŲ;4750141780;Taip;0;3;0;3
11979;Vandenis;AŠTUNKOJŲ;1314724267;Taip;0;1;0;1
11980;Vandenis;AŠTUNKOJŲ;1282499654;Taip;4;3;0;7
11981;Vandenis;AŠTUNKOJŲ;1739780612;Taip;5;5;0;10
11982;Vandenis;AŠTUNKOJŲ;8233407105;Taip;0;5;1;6
11983;Vandenis;AŠTUNKOJŲ;7168910452;Taip;0;1;0;1
11984;Vandenis;AŠTUNKOJŲ;2489776665;Taip;12;5;0;17
11985;Vandenis;AŠTUNKOJŲ;3938359901;Taip;0;5;0;5
11986;Vandenis;AŠTUNKOJŲ;33782837791;Taip;0;4;0;4
11987;Vandenis;AŠTUNKOJŲ;1633589144;Taip;5;4;0;9
11988;Vandenis;GANDRIUKŲ;4753416316;Taip;13;3;0;16
11989;Vandenis;GANDRIUKŲ;8264797886;Taip;10;6;0;16
11990;Vandenis;GANDRIUKŲ;6153669587;Taip;9;0;2;11
11991;Vandenis;GANDRIUKŲ;6260893699;Taip;1;0;0;1
11992;Vandenis;GANDRIUKŲ;1919577714;Taip;19;0;0;19
11993;Vandenis;GANDRIUKŲ;7019646962;Taip;0;1;0;1
11994;Vandenis;GANDRIUKŲ;2078767085;Taip;11;0;0;11
11995;Vandenis;GANDRIUKŲ;2976505868;Taip;16;0;1;17
11996;Vandenis;GANDRIUKŲ;6558155968;Taip;6;1;0;7
11997;Vandenis;GANDRIUKŲ;6691874473;Taip;0;1;10;11
11998;Vandenis;GANDRIUKŲ;6483030616;Taip;0;3;0;3
11999;Vandenis;GANDRIUKŲ;8144830789;Taip;8;0;0;8
12000;Vandenis;GANDRIUKŲ;2381566229;Taip;7;0;0;7
12001;Vandenis;GANDRIUKŲ;5899846599;Ne;11;0;3;14
12002;Vandenis;GANDRIUKŲ;1606103904;Taip;6;4;0;10
12003;Vandenis;GANDRIUKŲ;1753180703;Taip;6;0;0;6
12004;Vandenis;GANDRIUKŲ;7303512055;Taip;1;0;0;1
12005;Vandenis;GANDRIUKŲ;3231434944;Taip;0;0;23;23
12006;Vandenis;GANDRIUKŲ;6327478049;Taip;23;0;0;23
12007;Vandenis;GANDRIUKŲ;7311677107;Taip;0;3;2;5
12008;Vandenis;GANDRIUKŲ;6586215199;Taip;0;16;0;16
12009;Vandenis;ŽĄSIUKAI;8034690071;Taip;5;0;0;5
12010;Vandenis;ŽĄSIUKAI;9937317687;Taip;0;1;0;1
12011;Vandenis;ŽĄSIUKAI;2004158593;Taip;0;2;1;3
12012;Vandenis;ŽĄSIUKAI;4984723792;Taip;0;1;2;3
12013;Vandenis;ŽĄSIUKAI;8014569725;Taip;6;0;0;6
12014;Vandenis;ŽĄSIUKAI;1333381525;Ne;0;3;0;3
12015;Vandenis;ŽĄSIUKAI;7071349847;Taip;0;3;0;3
12016;Vandenis;ŽĄSIUKAI;7070234429;Taip;0;4;0;4
12017;Vandenis;ŽĄSIUKAI;4072405890;Taip;10;0;0;10
12018;Vandenis;ŽĄSIUKAI;5684262347;Taip;2;0;2;4
12019;Vandenis;ŽĄSIUKAI;4349464804;Taip;0;2;0;2
12020;Vandenis;ŽĄSIUKAI;7596199296;Taip;0;5;0;5
12021;Vandenis;ŽĄSIUKAI;6876019354;Taip;0;4;0;4
12022;Vandenis;ŽĄSIUKAI;5607412408;Taip;5;2;0;7
12023;Vandenis;ŽĄSIUKAI;1925178245;Taip;0;1;0;1
12024;Vandenis;ŽĄSIUKAI;5641929490;Taip;0;7;0;7
12025;Vandenis;ŽĄSIUKAI;7058441500;Taip;0;5;0;5
12026;Vandenis;ŽĄSIUKAI;1850352131;Taip;0;1;0;1
12027;Vandenis;ŽĄSIUKAI;2454959791;Taip;10;0;0;10
12028;Vandenis;ŽĄSIUKAI;4565893472;Taip;15;0;0;15
12029;Vandenis;ŽĄSIUKAI;1200834211;Taip;16;0;0;16
12030;Vandenis;ŽĄSIUKAI;9801593009;Taip;0;1;0;1
12031;Vandenis;PURIENŲ;6851178154;Taip;15;1;0;16
12032;Vandenis;PURIENŲ;5440027798;Taip;0;10;3;13
12033;Vandenis;PURIENŲ;4455886780;Taip;14;1;0;15
12034;Vandenis;PURIENŲ;1031451445;Taip;0;1;0;1
12035;Vandenis;PURIENŲ;4815210197;Taip;0;3;0;3
12036;Vandenis;PURIENŲ;3337286021;Taip;0;3;1;4
12037;Vandenis;PURIENŲ;7020534318;Taip;10;0;0;10
12038;Vandenis;PURIENŲ;6027680514;Taip;0;1;0;1
12039;Vandenis;PURIENŲ;3633805607;Taip;0;1;0;1
12040;Vandenis;PURIENŲ;7959438279;Taip;6;2;0;8
12041;Vandenis;PURIENŲ;1788652447;Taip;13;1;0;14
12042;Vandenis;PURIENŲ;6332179750;Taip;0;2;0;2
12043;Vandenis;PURIENŲ;2315167746;Taip;3;0;0;3
12044;Vandenis;PURIENŲ;5540306590;Taip;0;2;0;2
12045;Vandenis;PURIENŲ;2719678617;Taip;3;3;0;6
12046;Vandenis;PURIENŲ;7171302906;Taip;5;1;0;6
12047;Vandenis;PURIENŲ;8085633453;Taip;5;1;0;6
12048;Vandenis;PURIENŲ;1244502945;Taip;5;4;0;9
12049;Vandenis;VARLIUKAI;2661339448;Taip;8;0;0;8
12050;Vandenis;VARLIUKAI;2451901210;Taip;10;0;0;10
12051;Vandenis;VARLIUKAI;1786146371;Taip;0;4;0;4
12052;Vandenis;VARLIUKAI;3393306645;Taip;9;1;2;12
12053;Vandenis;VARLIUKAI;2506411643;Taip;9;1;2;12
12054;Vandenis;VARLIUKAI;8841954633;Taip;15;0;3;18
12055;Vandenis;VARLIUKAI;7001613448;Taip;15;0;3;18
12056;Vandenis;VARLIUKAI;1983972864;Taip;15;0;0;15
12057;Vandenis;VARLIUKAI;6067408982;Taip;7;0;0;7
12058;Vandenis;VARLIUKAI;8239664149;Taip;13;3;0;16
12059;Vandenis;VARLIUKAI;9380306986;Taip;18;0;0;18
12060;Vandenis;VARLIUKAI;1953052452;Taip;5;0;0;5
12061;Vandenis;VARLIUKAI;1799139825;Taip;23;0;0;23
12062;Vandenis;VARLIUKAI;3038533882;Taip;10;3;0;13
12063;Vandenis;VARLIUKAI;3173213991;Taip;6;11;6;23
12064;Vandenis;VARLIUKAI;5675840354;Taip;14;1;0;15
12065;Vandenis;VARLIUKAI;6570331247;Taip;8;0;2;10
12066;Vandenis;VARLIUKAI;2883058280;Taip;5;0;0;5
12067;Vandenis;PINGVINAI;9856199548;Taip;13;1;0;14
12068;Vandenis;PINGVINAI;2209513000;Taip;6;0;0;6
12069;Vandenis;PINGVINAI;2665865704;Taip;14;1;0;15
12070;Vandenis;PINGVINAI;8755050997;Taip;8;0;0;8
12071;Vandenis;PINGVINAI;1780124964;Taip;0;1;0;1
12072;Vandenis;PINGVINAI;9609168578;Taip;0;6;0;6
12073;Vandenis;PINGVINAI;2156775779;Taip;11;1;0;12
12074;Vandenis;PINGVINAI;3360623444;Taip;0;7;4;11
12075;Vandenis;PINGVINAI;5191604973;Taip;10;1;2;13
12076;Vandenis;PINGVINAI;2757376962;Taip;0;0;2;2
12077;Vandenis;PINGVINAI;6992750701;Taip;0;5;4;9
12078;Vandenis;PINGVINAI;6731336385;Taip;18;0;0;18
12079;Vandenis;PINGVINAI;3933306911;Taip;14;0;1;15
12080;Vandenis;PINGVINAI;2534991705;Taip;5;2;2;9
12081;Vandenis;PINGVINAI;4347489809;Taip;4;0;6;10
12082;Vandenis;PINGVINAI;7267965471;Taip;0;0;3;3
12083;Vandenis;PINGVINAI;5632082019;Taip;5;5;2;12
12084;Vandenis;PINGVINAI;9717294497;Taip;6;0;1;7
12085;Vandenis;PINGVINAI;7770227772;Taip;0;17;0;17
12086;Vandenis;PINGVINAI;8560123112;Taip;11;3;0;14
12087;Varpelis;NYKŠTUKAI;7043067458;Taip;0;0;2;2
12088;Varpelis;NYKŠTUKAI;3840270467;Taip;3;0;0;3
12089;Varpelis;NYKŠTUKAI;5940144949;Taip;5;0;0;5
12090;Varpelis;NYKŠTUKAI;3603149779;Taip;0;0;1;1
12091;Varpelis;NYKŠTUKAI;5322766823;Taip;0;0;1;1
12092;Varpelis;NYKŠTUKAI;1081800670;Taip;0;0;5;5
12093;Varpelis;NYKŠTUKAI;6455435982;Taip;0;0;5;5
12094;Varpelis;NYKŠTUKAI;2341013693;Taip;0;0;1;1
12095;Varpelis;NYKŠTUKAI;6834427885;Taip;0;5;0;5
12096;Varpelis;NYKŠTUKAI;5155733224;Taip;11;0;0;11
12097;Varpelis;NYKŠTUKAI;2339010385;Taip;5;0;0;5
12098;Varpelis;NYKŠTUKAI;9372121923;Taip;10;0;1;11
12099;Varpelis;NYKŠTUKAI;1730570091;Taip;2;0;2;4
12100;Varpelis;NYKŠTUKAI;5985806014;Taip;10;0;0;10
12101;Varpelis;NYKŠTUKAI;3268141759;Taip;0;0;2;2
12102;Varpelis;NYKŠTUKAI;4215058265;Ne;4;0;2;6
12103;Varpelis;NYKŠTUKAI;9430776477;Taip;6;0;0;6
12104;Varpelis;NYKŠTUKAI;2000963283;Taip;0;0;1;1
12105;Varpelis;"SPINDULIUKŲ su Valdorfo elementais";8433933260;Taip;0;0;6;6
12106;Varpelis;"SPINDULIUKŲ su Valdorfo elementais";2707029719;Taip;0;0;6;6
12107;Varpelis;"SPINDULIUKŲ su Valdorfo elementais";5709007350;Taip;0;0;6;6
12108;Varpelis;"SPINDULIUKŲ su Valdorfo elementais";3245779018;Taip;0;1;3;4
12109;Varpelis;"SPINDULIUKŲ su Valdorfo elementais";6449284856;Taip;0;1;1;2
12110;Varpelis;"SPINDULIUKŲ su Valdorfo elementais";7936861650;Taip;0;6;0;6
12111;Varpelis;"SPINDULIUKŲ su Valdorfo elementais";6436892919;Taip;0;0;1;1
12112;Varpelis;"SPINDULIUKŲ su Valdorfo elementais";9045708140;Taip;0;0;6;6
12113;Varpelis;"SPINDULIUKŲ su Valdorfo elementais";3055411665;Taip;0;1;1;2
12114;Varpelis;"SPINDULIUKŲ su Valdorfo elementais";9374503688;Taip;0;0;6;6
12115;Varpelis;"SPINDULIUKŲ su Valdorfo elementais";1339590141;Taip;0;0;6;6
12116;Varpelis;"SPINDULIUKŲ su Valdorfo elementais";8468458454;Taip;0;0;5;5
12117;Varpelis;"SPINDULIUKŲ su Valdorfo elementais";4244861127;Taip;0;0;4;4
12118;Varpelis;"SPINDULIUKŲ su Valdorfo elementais";3568872397;Taip;0;1;1;2
12119;Varpelis;"SPINDULIUKŲ su Valdorfo elementais";7209430750;Taip;0;0;2;2
12120;Varpelis;"SPINDULIUKŲ su Valdorfo elementais";8401693477;Taip;0;0;4;4
12121;Varpelis;BITUTĖS;1005905322;Taip;5;0;1;6
12122;Varpelis;BITUTĖS;8224083250;Taip;0;17;0;17
12123;Varpelis;BITUTĖS;7639156840;Taip;8;3;0;11
12124;Varpelis;BITUTĖS;7894929066;Ne;0;0;5;5
12125;Varpelis;BITUTĖS;6004580752;Taip;0;0;5;5
12126;Varpelis;BITUTĖS;3225870950;Taip;0;1;0;1
12127;Varpelis;BITUTĖS;2975306188;Taip;0;0;3;3
12128;Varpelis;BITUTĖS;3216171217;Taip;5;3;4;12
12129;Varpelis;BITUTĖS;9795677397;Taip;6;0;1;7
12130;Varpelis;BITUTĖS;9025614369;Taip;10;0;4;14
12131;Varpelis;BITUTĖS;7137400798;Taip;4;0;0;4
12132;Varpelis;BITUTĖS;6272649584;Taip;7;0;0;7
12133;Varpelis;BITUTĖS;7497169351;Taip;9;0;0;9
12134;Varpelis;BITUTĖS;6325113387;Taip;5;0;2;7
12135;Varpelis;BITUTĖS;8910195286;Taip;10;0;0;10
12136;Varpelis;BITUTĖS;3557362927;Taip;0;9;0;9
12137;Varpelis;BITUTĖS;5994436441;Taip;3;0;0;3
12138;Varpelis;BITUTĖS;9295853884;Taip;0;3;2;5
12139;Varpelis;BITUTĖS;7462297990;Taip;0;0;5;5
12140;Varpelis;BITUTĖS;4811186406;Taip;13;0;2;15
12141;Varpelis;BITUTĖS;9598844152;Taip;0;0;4;4
12142;Varpelis;BITUTĖS;3315895028;Taip;0;0;1;1
12143;Varpelis;BITUTĖS;9539132116;Taip;6;0;9;15
12144;Varpelis;DRUGELIAI;9480364901;Ne;0;0;7;7
12145;Varpelis;DRUGELIAI;4806552843;Taip;5;0;1;6
12146;Varpelis;DRUGELIAI;3680663621;Ne;13;0;0;13
12147;Varpelis;DRUGELIAI;9846434157;Taip;0;0;4;4
12148;Varpelis;DRUGELIAI;8177777797;Taip;10;5;3;18
12149;Varpelis;DRUGELIAI;7097450882;Ne;0;3;1;4
12150;Varpelis;DRUGELIAI;7472071198;Taip;9;0;4;13
12151;Varpelis;DRUGELIAI;6397377742;Taip;10;0;1;11
12152;Varpelis;DRUGELIAI;5421445517;Taip;5;0;9;14
12153;Varpelis;DRUGELIAI;3533283690;Taip;10;0;3;13
12154;Varpelis;DRUGELIAI;2320804215;Taip;0;0;1;1
12155;Varpelis;DRUGELIAI;9089874889;Taip;0;0;4;4
12156;Varpelis;DRUGELIAI;1809892533;Taip;10;3;1;14
12157;Varpelis;DRUGELIAI;2087032775;Taip;10;0;7;17
12158;Varpelis;DRUGELIAI;5357387099;Taip;0;3;0;3
12159;Varpelis;DRUGELIAI;5978994702;Ne;5;0;3;8
12160;Varpelis;DRUGELIAI;5530898751;Taip;0;0;4;4
12161;Varpelis;DRUGELIAI;4584538961;Taip;0;0;6;6
12162;Varpelis;DRUGELIAI;5711104033;Ne;0;0;5;5
12163;Varpelis;DRUGELIAI;4969180325;Taip;0;2;0;2
12164;Vėjelis;Pumpurėliai;2541077369;Ne;15;0;0;15
12165;Vėjelis;Pumpurėliai;3125815427;Taip;11;0;1;12
12166;Vėjelis;Pumpurėliai;5516672613;Taip;12;0;0;12
12167;Vėjelis;Pumpurėliai;2866394056;Taip;0;1;0;1
12168;Vėjelis;Pumpurėliai;1084415930;Taip;10;0;0;10
12169;Vėjelis;Pumpurėliai;9071878406;Taip;10;2;0;12
12170;Vėjelis;Pumpurėliai;3206025676;Taip;12;1;0;13
12171;Vėjelis;Pumpurėliai;5611813359;Taip;12;0;0;12
12172;Vėjelis;Pumpurėliai;1057586168;Ne;15;0;0;15
12173;Vėjelis;Pumpurėliai;9583495324;Taip;3;0;0;3
12174;Vėjelis;Pumpurėliai;7539681314;Taip;0;3;0;3
12175;Vėjelis;Pumpurėliai;3081923183;Taip;10;0;0;10
12176;Vėjelis;Pumpurėliai;9003601108;Taip;14;0;0;14
12177;Vėjelis;Pumpurėliai;6168648640;Taip;0;1;0;1
12178;Vėjelis;Pumpurėliai;1876663813;Taip;6;1;0;7
12179;Vėjelis;Pumpurėliai;6840643273;Ne;5;6;0;11
12180;Vėjelis;Pumpurėliai;9824130744;Ne;5;1;0;6
12181;Vėjelis;Pumpurėliai;1842552329;Taip;14;0;5;19
12182;Vėjelis;Pumpurėliai;9986867356;Taip;0;0;4;4
12183;Vėjelis;Pumpurėliai;8467887788;Taip;11;3;0;14
12184;Vėjelis;Pumpurėliai;9274287800;Ne;5;0;2;7
12185;Vėjelis;Pumpurėliai;5619026707;Taip;2;0;1;3
12186;Vėjelis;Pumpurėliai;8994680698;Taip;11;0;0;11
12187;Vėjelis;Pumpurėliai;2656895893;Taip;11;0;0;11
12188;Vėjelis;Drugeliai;4746932126;Taip;0;3;0;3
12189;Vėjelis;Drugeliai;1978952781;Taip;0;3;0;3
12190;Vėjelis;Drugeliai;8353084814;Taip;5;3;0;8
12191;Vėjelis;Drugeliai;2416832899;Taip;6;1;0;7
12192;Vėjelis;Drugeliai;2734024890;Taip;17;2;0;19
12193;Vėjelis;Drugeliai;7981032872;Taip;0;23;0;23
12194;Vėjelis;Drugeliai;7594586198;Taip;6;3;0;9
12195;Vėjelis;Drugeliai;7697394469;Taip;0;3;2;5
12196;Vėjelis;Drugeliai;4066956765;Taip;0;0;3;3
12197;Vėjelis;Drugeliai;2788205363;Taip;8;3;0;11
12198;Vėjelis;Drugeliai;1331334220;Taip;5;2;2;9
12199;Vėjelis;Drugeliai;2151737048;Taip;5;5;0;10
12200;Vėjelis;Drugeliai;3982318250;Taip;5;0;2;7
12201;Vėjelis;Drugeliai;4473677352;Taip;0;12;0;12
12202;Vėjelis;Drugeliai;4506243333;Taip;6;2;0;8
12203;Vėjelis;Drugeliai;3524350131;Taip;0;3;1;4
12204;Vėjelis;Drugeliai;6061966626;Taip;0;3;0;3
12205;Vėjelis;Drugeliai;3453119286;Taip;11;0;0;11
12206;Vėjelis;Drugeliai;6891260701;Taip;0;6;0;6
12207;Vėjelis;Malūnėlis;1994035417;Ne;0;8;0;8
12208;Vėjelis;Malūnėlis;7097474285;Taip;2;0;0;2
12209;Vėjelis;Malūnėlis;1448699738;Taip;0;2;3;5
12210;Vėjelis;Malūnėlis;3275186042;Taip;5;0;0;5
12211;Vėjelis;Malūnėlis;1882750621;Taip;18;0;0;18
12212;Vėjelis;Malūnėlis;5109441799;Taip;10;0;0;10
12213;Vėjelis;Malūnėlis;4171024976;Taip;8;0;3;11
12214;Vėjelis;Malūnėlis;1871467392;Taip;10;0;5;15
12215;Vėjelis;Malūnėlis;1342200813;Taip;0;3;0;3
12216;Vėjelis;Malūnėlis;8221349174;Taip;0;2;1;3
12217;Vėjelis;Malūnėlis;6600504736;Taip;15;8;0;23
12218;Vėjelis;Malūnėlis;8063276082;Taip;5;2;3;10
12219;Vėjelis;Malūnėlis;6244227830;Taip;13;0;3;16
12220;Vėjelis;Malūnėlis;1417987860;Taip;0;5;2;7
12221;Vėjelis;Malūnėlis;9636946669;Taip;18;0;0;18
12222;Vėjelis;Malūnėlis;5066748621;Taip;7;0;0;7
12223;Vėjelis;Malūnėlis;8822873586;Taip;0;0;1;1
12224;Vėjelis;Žvaigždutės;9492690970;Taip;6;3;1;10
12225;Vėjelis;Žvaigždutės;1436893015;Taip;13;0;0;13
12226;Vėjelis;Žvaigždutės;2117924725;Taip;4;0;0;4
12227;Vėjelis;Žvaigždutės;8866974952;Taip;0;4;0;4
12228;Vėjelis;Žvaigždutės;1549518622;Ne;0;7;0;7
12229;Vėjelis;Žvaigždutės;6386092350;Taip;5;16;0;21
12230;Vėjelis;Žvaigždutės;8386409466;Taip;10;8;0;18
12231;Vėjelis;Žvaigždutės;6844704326;Taip;5;0;1;6
12232;Vėjelis;Žvaigždutės;3315240387;Taip;0;10;0;10
12233;Vėjelis;Žvaigždutės;9557135813;Taip;0;0;2;2
12234;Vėjelis;Žvaigždutės;2132551615;Taip;0;0;20;20
12235;Vėjelis;Žvaigždutės;2522750651;Taip;13;0;0;13
12236;Vėjelis;Žvaigždutės;6777528441;Taip;15;0;1;16
12237;Vėjelis;Žvaigždutės;4868574574;Taip;0;3;0;3
12238;Vėjelis;Žvaigždutės;9135807341;Taip;4;0;0;4
12239;Vėjelis;Žvaigždutės;7247057946;Taip;11;4;1;16
12240;Vėjelis;Žvaigždutės;7046938604;Taip;0;3;0;3
12241;Vėjelis;Žvaigždutės;3495322620;Taip;2;11;0;13
12242;Vėjelis;Žvaigždutės;1956418258;Taip;5;6;0;11
12243;Vėjelis;Žvaigždutės;7203026860;Taip;9;1;0;10
12244;Vėjelis;Žvaigždutės;8300497094;Taip;0;2;1;3
12245;Vėjelis;Varpeliai;7274745807;Ne;0;3;4;7
12246;Vėjelis;Varpeliai;5931553549;Taip;0;1;2;3
12247;Vėjelis;Varpeliai;9926991259;Taip;0;3;3;6
12248;Vėjelis;Varpeliai;6608657740;Taip;7;3;5;15
12249;Vėjelis;Varpeliai;2794205377;Taip;12;0;0;12
12250;Vėjelis;Varpeliai;7507448059;Taip;0;3;0;3
12251;Vėjelis;Varpeliai;2363974247;Taip;0;3;1;4
12252;Vėjelis;Varpeliai;8379298947;Taip;0;3;1;4
12253;Vėjelis;Varpeliai;1205392813;Taip;0;8;0;8
12254;Vėjelis;Varpeliai;98588113289;Taip;0;7;0;7
12255;Vėjelis;Varpeliai;5396347620;Taip;0;4;0;4
12256;Vėjelis;Varpeliai;5031781196;Taip;0;0;1;1
12257;Vėjelis;Varpeliai;4219672982;Taip;0;0;2;2
12258;Vėjelis;Varpeliai;4853650350;Taip;0;1;0;1
12259;Vėjelis;Varpeliai;4521161684;Taip;0;11;0;11
12260;Vėjelis;Varpeliai;60890519853;Taip;0;1;0;1
12261;Vėjelis;Varpeliai;8684461171;Taip;0;4;0;4
12262;Vėjelis;Varpeliai;7133454882;Taip;0;8;0;8
12263;Vėjelis;Varpeliai;1863210064;Taip;0;3;0;3
12264;Vėjelis;Varpeliai;1534169381;Taip;11;4;0;15
12265;Vėjelis;Varpeliai;2957105835;Ne;0;1;1;2
12266;Vėjelis;Varpeliai;8748218387;Taip;0;0;3;3
12267;Vėjelis;Pelėdžiukų;3067215309;Taip;5;3;0;8
12268;Vėjelis;Pelėdžiukų;7211756910;Taip;1;0;4;5
12269;Vėjelis;Pelėdžiukų;2302652824;Ne;10;2;2;14
12270;Vėjelis;Pelėdžiukų;4852532740;Taip;15;1;0;16
12271;Vėjelis;Pelėdžiukų;4450739919;Taip;5;0;0;5
12272;Vėjelis;Pelėdžiukų;9202471939;Taip;0;2;0;2
12273;Vėjelis;Pelėdžiukų;1615837863;Taip;0;2;0;2
12274;Vėjelis;Pelėdžiukų;9852892338;Taip;0;3;0;3
12275;Vėjelis;Pelėdžiukų;8433853523;Taip;6;0;2;8
12276;Vėjelis;Pelėdžiukų;5507017221;Taip;7;2;0;9
12277;Vėjelis;Pelėdžiukų;1259743374;Ne;16;0;0;16
12278;Vėjelis;Pelėdžiukų;6226234271;Taip;15;4;0;19
12279;Vėjelis;Pelėdžiukų;7559733997;Taip;5;0;0;5
12280;Vėjelis;Pelėdžiukų;3764096742;Taip;7;0;1;8
12281;Vėjelis;Pelėdžiukų;8153021028;Ne;8;1;0;9
12282;Vėjelis;Pelėdžiukų;8067153728;Taip;5;8;0;13
12283;Vėjelis;Pelėdžiukų;2283628712;Taip;4;3;0;7
12284;Vėjelis;Pelėdžiukų;2729246397;Taip;18;0;3;21
12285;Vėjelis;Pelėdžiukų;9769871497;Taip;9;0;0;9
12286;Vėjelis;Pelėdžiukų;4318295503;Taip;0;0;2;2
12287;Vėjelis;Pelėdžiukų;9867392835;Taip;0;0;11;11
12288;Vėjelis;Skruzdeliukų;2167025998;Taip;5;1;0;6
12289;Vėjelis;Skruzdeliukų;2467377103;Taip;0;1;0;1
12290;Vėjelis;Skruzdeliukų;8470977526;Taip;0;1;1;2
12291;Vėjelis;Skruzdeliukų;9434737088;Taip;0;1;0;1
12292;Vėjelis;Skruzdeliukų;1952141664;Taip;10;3;0;13
12293;Vėjelis;Skruzdeliukų;3264153232;Taip;7;3;0;10
12294;Vėjelis;Skruzdeliukų;4992783345;Taip;0;8;0;8
12295;Vėjelis;Skruzdeliukų;4412135676;Taip;4;0;0;4
12296;Vėjelis;Skruzdeliukų;6408918277;Taip;0;2;5;7
12297;Vėjelis;Skruzdeliukų;7240155487;Taip;0;0;5;5
12298;Vėjelis;Skruzdeliukų;7695719991;Ne;4;4;2;10
12299;Vėjelis;Skruzdeliukų;6618114389;Taip;0;2;1;3
12300;Vėjelis;Skruzdeliukų;1381923971;Taip;10;5;0;15
12301;Vėjelis;Skruzdeliukų;8630131152;Taip;0;0;1;1
12302;Vėjelis;Skruzdeliukų;6431589805;Taip;0;2;0;2
12303;Vėjelis;Skruzdeliukų;4906958328;Taip;0;3;0;3
12304;Vėjelis;Skruzdeliukų;4080198912;Taip;15;1;0;16
12305;Vėjelis;Skruzdeliukų;1555270425;Taip;0;7;0;7
12306;Vėjelis;Skruzdeliukų;7400967836;Taip;0;4;1;5
12307;Vėjelis;Skruzdeliukų;1467023330;Taip;0;2;0;2
12308;Vėjelis;Pieštukų;8995478684;Taip;0;0;1;1
12309;Vėjelis;Pieštukų;7860576967;Taip;7;0;0;7
12310;Vėjelis;Pieštukų;9546928491;Taip;6;0;0;6
12311;Vėjelis;Pieštukų;9675488924;Taip;6;0;0;6
12312;Vėjelis;Pieštukų;4884057836;Taip;0;0;5;5
12313;Vėjelis;Pieštukų;3898751303;Taip;12;10;0;22
12314;Vėjelis;Pieštukų;5662728912;Taip;5;0;5;10
12315;Vėjelis;Pieštukų;8281508498;Taip;0;0;7;7
12316;Vėjelis;Pieštukų;6909799367;Taip;0;3;0;3
12317;Vėjelis;Pieštukų;7748975870;Ne;7;0;0;7
12318;Vėjelis;Pieštukų;1075188861;Taip;17;0;0;17
12319;Vėjelis;Pieštukų;6823103188;Taip;8;5;0;13
12320;Vėjelis;Pieštukų;7854614677;Taip;0;3;2;5
12321;Vėjelis;Pieštukų;9451358807;Taip;13;0;0;13
12322;Vėjelis;Pieštukų;6453605110;Taip;0;16;0;16
12323;Vėjelis;Pieštukų;2720886612;Taip;2;3;0;5
12324;Vėjelis;Pieštukų;2734891342;Taip;6;3;0;9
12325;Vėjelis;Pieštukų;7101585528;Taip;4;0;1;5
12326;Vėjelis;Pieštukų;2373132607;Taip;3;0;0;3
12327;Vėjelis;Ramunėlių;5987294293;Taip;0;6;0;6
12328;Vėjelis;Ramunėlių;8047799576;Taip;6;6;0;12
12329;Vėjelis;Ramunėlių;7178844364;Taip;5;2;0;7
12330;Vėjelis;Ramunėlių;6996900411;Ne;0;3;0;3
12331;Vėjelis;Ramunėlių;4733227215;Taip;0;0;2;2
12332;Vėjelis;Ramunėlių;5909697341;Taip;0;6;0;6
12333;Vėjelis;Ramunėlių;6451722893;Taip;0;7;0;7
12334;Vėjelis;Ramunėlių;1381191703;Taip;0;5;1;6
12335;Vėjelis;Ramunėlių;9042329808;Taip;0;2;0;2
12336;Vėjelis;Ramunėlių;6660799519;Taip;3;0;0;3
12337;Vėjelis;Ramunėlių;6889825160;Taip;5;0;2;7
12338;Vėjelis;Ramunėlių;4433799070;Taip;0;12;0;12
12339;Vėjelis;Ramunėlių;1235788079;Taip;6;1;0;7
12340;Vėjelis;Ramunėlių;4745262277;Taip;5;5;0;10
12341;Vėjelis;Ramunėlių;8054114720;Taip;6;4;0;10
12342;Vėjelis;Ramunėlių;8986581196;Taip;11;1;0;12
12343;Vėjelis;Nykštukai;9957614551;Taip;6;3;0;9
12344;Vėjelis;Nykštukai;7233448544;Taip;14;5;0;19
12345;Vėjelis;Nykštukai;5339200991;Taip;0;8;0;8
12346;Vėjelis;Nykštukai;6602964509;Taip;0;3;0;3
12347;Vėjelis;Nykštukai;2573683778;Taip;16;0;0;16
12348;Vėjelis;Nykštukai;4713754452;Taip;0;3;0;3
12349;Vėjelis;Nykštukai;7889625599;Taip;11;3;0;14
12350;Vėjelis;Nykštukai;7763996061;Taip;0;11;0;11
12351;Vėjelis;Nykštukai;8755889077;Ne;6;0;0;6
12352;Vėjelis;Nykštukai;2763569936;Ne;9;0;2;11
12353;Vėjelis;Nykštukai;9979979480;Taip;9;0;4;13
12354;Vėjelis;Nykštukai;4063795811;Taip;0;3;0;3
12355;Vėjelis;BITUTĖS;6824919005;Taip;0;2;1;3
12356;Vėjelis;BITUTĖS;4276237884;Taip;4;3;0;7
12357;Vėjelis;BITUTĖS;3772706363;Taip;6;5;0;11
12358;Vėjelis;BITUTĖS;1834203833;Taip;6;5;0;11
12359;Vėjelis;BITUTĖS;8452132066;Taip;0;23;0;23
12360;Vėjelis;BITUTĖS;6283428333;Taip;0;0;9;9
12361;Vėjelis;BITUTĖS;1112394040;Taip;13;0;0;13
12362;Vėjelis;BITUTĖS;6569848405;Taip;10;1;0;11
12363;Vėjelis;BITUTĖS;1457373815;Taip;18;0;0;18
12364;Vėjelis;BITUTĖS;8571757635;Taip;0;4;0;4
12365;Vėjelis;BITUTĖS;1022888418;Taip;0;2;0;2
12366;Vėjelis;BITUTĖS;1116238331;Taip;0;9;0;9
12367;Vėjelis;BITUTĖS;8286070405;Taip;5;2;0;7
12368;Vėjelis;BITUTĖS;1674810054;Taip;8;0;0;8
12369;Vėjelis;BITUTĖS;6581265682;Taip;11;0;0;11
12370;Vėjelis;BITUTĖS;4348246825;Taip;7;0;0;7
12371;Vėjelis;Boruželės;2199680661;Taip;3;0;0;3
12372;Vėjelis;Boruželės;5325081841;Taip;0;3;0;3
12373;Vėjelis;Boruželės;5381588565;Taip;5;3;0;8
12374;Vėjelis;Boruželės;9037622738;Taip;0;3;0;3
12375;Vėjelis;Boruželės;1588345134;Taip;0;3;9;12
12376;Vėjelis;Boruželės;1429496839;Taip;0;0;7;7
12377;Vėjelis;Boruželės;1931659200;Taip;10;3;0;13
12378;Vėjelis;Boruželės;8666759391;Taip;0;2;3;5
12379;Vėjelis;Boruželės;3844131154;Taip;7;0;0;7
12380;Vėjelis;Boruželės;4747466651;Taip;1;10;0;11
12381;Vėjelis;Boruželės;8141198449;Taip;5;3;1;9
12382;Vėjelis;Boruželės;8121537795;Taip;4;1;0;5
12383;Vėjelis;Boruželės;5517128872;Taip;0;0;2;2
12384;Vėjelis;Boruželės;8938491367;Taip;5;3;0;8
12385;Vėjelis;Boruželės;6108049183;Ne;0;0;3;3
12386;Vėjelis;Boruželės;1115802837;Taip;5;0;0;5
12387;Vėjelis;Boruželės;1494531065;Taip;0;3;0;3
12388;Vėjelis;Boruželės;3276062426;Taip;18;0;0;18
12389;Vėjelis;Boruželės;4132824111;Taip;19;0;0;19
12390;Vėjelis;Boruželės;2000277444;Taip;5;0;2;7
12391;Vėjelis;Boruželės;7752923796;Taip;11;0;0;11
12392;Vėtrungė;Debesėlių;3655025938;Ne;5;1;0;6
12393;Vėtrungė;Debesėlių;2825732654;Ne;5;4;0;9
12394;Vėtrungė;Debesėlių;7863176604;Taip;0;1;0;1
12395;Vėtrungė;Debesėlių;3179715496;Taip;0;1;0;1
12396;Vėtrungė;Debesėlių;6439014588;Taip;0;3;0;3
12397;Vėtrungė;Debesėlių;9423361592;Taip;0;4;0;4
12398;Vėtrungė;Debesėlių;1191007983;Taip;0;4;0;4
12399;Vėtrungė;Debesėlių;3745680607;Taip;13;3;0;16
12400;Vėtrungė;Debesėlių;1807742144;Ne;11;4;0;15
12401;Vėtrungė;Debesėlių;9893842192;Taip;7;0;0;7
12402;Vėtrungė;Debesėlių;3433811829;Taip;0;0;6;6
12403;Vėtrungė;Debesėlių;2447851565;Taip;6;3;0;9
12404;Vėtrungė;Debesėlių;2136966687;Taip;0;12;0;12
12405;Vėtrungė;Debesėlių;5836190044;Taip;18;0;0;18
12406;Vėtrungė;Debesėlių;8957071345;Taip;5;0;0;5
12407;Vėtrungė;Debesėlių;5545581078;Taip;0;4;0;4
12408;Vėtrungė;Debesėlių;7185104341;Taip;4;0;9;13
12409;Vėtrungė;Debesėlių;6374739740;Taip;2;4;0;6
12410;Vėtrungė;Debesėlių;5939537473;Ne;9;0;0;9
12411;Vėtrungė;Zuikių;9332362038;Taip;7;0;0;7
12412;Vėtrungė;Zuikių;9407558097;Taip;5;6;0;11
12413;Vėtrungė;Zuikių;4121886031;Taip;4;3;0;7
12414;Vėtrungė;Zuikių;7573021445;Taip;0;0;10;10
12415;Vėtrungė;Zuikių;3335047815;Ne;0;3;0;3
12416;Vėtrungė;Zuikių;8157356569;Ne;0;3;0;3
12417;Vėtrungė;Zuikių;9742099165;Taip;0;5;0;5
12418;Vėtrungė;Zuikių;1215953192;Taip;0;4;2;6
12419;Vėtrungė;Zuikių;3908259010;Ne;5;9;0;14
12420;Vėtrungė;Zuikių;1729819557;Ne;12;0;0;12
12421;Vėtrungė;Zuikių;4916692634;Taip;0;8;0;8
12422;Vėtrungė;Zuikių;6416245099;Ne;0;4;0;4
12423;Vėtrungė;Zuikių;4197321604;Taip;0;1;0;1
12424;Vėtrungė;Zuikių;1007578933;Taip;9;1;0;10
12425;Vėtrungė;Zuikių;7558548846;Taip;9;1;0;10
12426;Vėtrungė;Zuikių;8742161467;Taip;10;1;0;11
12427;Vėtrungė;Zuikių;2537221101;Ne;11;3;0;14
12428;Vėtrungė;Zuikių;7342250921;Taip;7;1;8;16
12429;Vėtrungė;Zuikių;9248113268;Taip;6;1;1;8
12430;Vėtrungė;Zuikių;7435005821;Ne;5;6;0;11
12431;Vėtrungė;Zuikių;1280823326;Ne;0;8;0;8
12432;Vėtrungė;Drugelių;5366256528;Ne;6;0;0;6
12433;Vėtrungė;Drugelių;7476984763;Taip;4;7;0;11
12434;Vėtrungė;Drugelių;9090873546;Taip;1;0;0;1
12435;Vėtrungė;Drugelių;2124476787;Taip;6;0;0;6
12436;Vėtrungė;Drugelių;4578835070;Ne;4;0;2;6
12437;Vėtrungė;Drugelių;8729505032;Taip;1;0;0;1
12438;Vėtrungė;Drugelių;5251308945;Ne;0;2;1;3
12439;Vėtrungė;Drugelių;9812496068;Taip;2;2;0;4
12440;Vėtrungė;Drugelių;8753387108;Taip;0;3;4;7
12441;Vėtrungė;Drugelių;2123410772;Taip;0;2;0;2
12442;Vėtrungė;Drugelių;8905533826;Taip;5;0;0;5
12443;Vėtrungė;Drugelių;7186353024;Taip;3;2;0;5
12444;Vėtrungė;Drugelių;2933312366;Taip;10;5;0;15
12445;Vėtrungė;Drugelių;2508501223;Taip;0;9;0;9
12446;Vėtrungė;Do-re-mi;6449124019;Taip;0;4;0;4
12447;Vėtrungė;Do-re-mi;9324733839;Taip;0;1;0;1
12448;Vėtrungė;Do-re-mi;2287044278;Taip;0;2;0;2
12449;Vėtrungė;Do-re-mi;2928868412;Taip;0;3;0;3
12450;Vėtrungė;Do-re-mi;2883254822;Taip;0;8;0;8
12451;Vėtrungė;Do-re-mi;9518734260;Taip;5;2;4;11
12452;Vėtrungė;Do-re-mi;7496582551;Taip;0;0;1;1
12453;Vėtrungė;Do-re-mi;5430818470;Taip;9;2;0;11
12454;Vėtrungė;Do-re-mi;5832298824;Ne;0;3;0;3
12455;Vėtrungė;Do-re-mi;7895027909;Taip;1;6;0;7
12456;Vėtrungė;Do-re-mi;7807708310;Taip;0;0;8;8
12457;Vėtrungė;Do-re-mi;3200251047;Taip;0;0;2;2
12458;Vėtrungė;Do-re-mi;3369970611;Taip;0;5;0;5
12459;Vėtrungė;Do-re-mi;1808699695;Taip;0;4;1;5
12460;Vėtrungė;Do-re-mi;9079483362;Taip;10;0;3;13
12461;Vėtrungė;Do-re-mi;9271869305;Taip;0;4;2;6
12462;Vėtrungė;Do-re-mi;4709068324;Taip;0;4;0;4
12463;Vėtrungė;Do-re-mi;5452337780;Taip;0;0;3;3
12464;Vėtrungė;Do-re-mi;8956375453;Ne;0;0;4;4
12465;Vėtrungė;Smalsučių;7803736567;Taip;0;4;0;4
12466;Vėtrungė;Smalsučių;6599281163;Taip;7;0;0;7
12467;Vėtrungė;Smalsučių;3249689008;Taip;5;3;0;8
12468;Vėtrungė;Smalsučių;7129180154;Taip;0;3;0;3
12469;Vėtrungė;Smalsučių;7295216791;Taip;0;5;1;6
12470;Vėtrungė;Smalsučių;9795630131;Taip;0;2;4;6
12471;Vėtrungė;Smalsučių;2636219826;Taip;0;3;0;3
12472;Vėtrungė;Smalsučių;7363490503;Ne;0;1;0;1
12473;Vėtrungė;Smalsučių;16216365941;Taip;0;4;0;4
12474;Vėtrungė;Smalsučių;2471926240;Taip;0;3;0;3
12475;Vėtrungė;Smalsučių;7813907852;Taip;0;3;0;3
12476;Vėtrungė;Smalsučių;2440001662;Taip;0;2;0;2
12477;Vėtrungė;Smalsučių;4000379945;Taip;0;7;0;7
12478;Vėtrungė;Smalsučių;5367369908;Taip;0;9;0;9
12479;Vėtrungė;Smalsučių;4154712272;Taip;0;7;0;7
12480;Vėtrungė;Smalsučių;3278452234;Taip;0;4;0;4
12481;Vėtrungė;Smalsučių;7483624989;Ne;0;3;0;3
12482;Vėtrungė;Smalsučių;4394100006;Taip;0;5;1;6
12483;Vėtrungė;Smalsučių;7730716483;Taip;0;6;0;6
12484;Vėtrungė;Gudručių;6732632515;Ne;0;4;0;4
12485;Vėtrungė;Gudručių;8721035192;Taip;5;5;0;10
12486;Vėtrungė;Gudručių;1970034012;Ne;0;3;0;3
12487;Vėtrungė;Gudručių;3404120492;Taip;6;3;0;9
12488;Vėtrungė;Gudručių;7921863675;Taip;0;5;0;5
12489;Vėtrungė;Gudručių;8154023892;Ne;5;1;0;6
12490;Vėtrungė;Gudručių;1522141057;Taip;7;10;0;17
12491;Vėtrungė;Gudručių;9962435598;Ne;16;6;0;22
12492;Vėtrungė;Gudručių;2482436192;Taip;4;5;0;9
12493;Vėtrungė;Gudručių;4092242233;Taip;5;0;0;5
12494;Vėtrungė;Gudručių;1551989977;Taip;0;5;0;5
12495;Vėtrungė;Gudručių;4091719904;Taip;0;4;0;4
12496;Vėtrungė;Gudručių;5994465833;Taip;0;3;0;3
12497;Vėtrungė;Gudručių;4347810256;Taip;0;3;0;3
12498;Vėtrungė;Gudručių;7704497739;Taip;0;3;0;3
12499;Vėtrungė;Gudručių;8643181832;Taip;0;3;2;5
12500;Vėtrungė;Kodėlčių;9172488122;Taip;0;9;0;9
12501;Vėtrungė;Kodėlčių;2739382736;Taip;0;11;0;11
12502;Vėtrungė;Kodėlčių;3903604247;Taip;7;0;0;7
12503;Vėtrungė;Kodėlčių;3500551575;Taip;5;1;0;6
12504;Vėtrungė;Kodėlčių;7872043253;Taip;0;0;1;1
12505;Vėtrungė;Kodėlčių;9852609222;Taip;0;7;12;19
12506;Vėtrungė;Kodėlčių;8465132902;Taip;0;2;0;2
12507;Vėtrungė;Kodėlčių;8859592174;Taip;10;0;0;10
12508;Vėtrungė;Kodėlčių;7862615352;Taip;0;1;0;1
12509;Vėtrungė;Kodėlčių;1540045675;Taip;0;10;0;10
12510;Vėtrungė;Kodėlčių;5385880910;Taip;3;0;0;3
12511;Vėtrungė;Kodėlčių;9211406129;Taip;0;11;0;11
12512;Vėtrungė;Kodėlčių;1032730549;Taip;0;3;0;3
12513;Vėtrungė;Kodėlčių;9127735773;Taip;5;0;1;6
12514;Vėtrungė;Kodėlčių;5830221727;Taip;0;1;0;1
12515;Vėtrungė;Kodėlčių;4756863295;Taip;0;4;0;4
12516;Vėtrungė;Kodėlčių;8985054558;Taip;0;3;0;3
12517;Vėtrungė;Kodėlčių;3922749661;Taip;0;10;0;10
12518;Vėtrungė;Kodėlčių;8013249618;Taip;0;3;0;3
12519;Vėtrungė;Kodėlčių;7740260264;Taip;0;0;4;4
12520;Vėtrungė;Kodėlčių;6807838878;Taip;7;1;0;8
12521;Vėtrungė;Paukštelių;6983172988;Ne;11;0;0;11
12522;Vėtrungė;Paukštelių;8744205170;Taip;3;1;0;4
12523;Vėtrungė;Paukštelių;3466149991;Taip;15;0;0;15
12524;Vėtrungė;Paukštelių;5338424871;Taip;12;0;5;17
12525;Vėtrungė;Paukštelių;4805836717;Taip;10;0;0;10
12526;Vėtrungė;Paukštelių;6812588777;Taip;15;1;0;16
12527;Vėtrungė;Paukštelių;2798915063;Taip;9;0;2;11
12528;Vėtrungė;Paukštelių;2981610749;Taip;13;0;3;16
12529;Vėtrungė;Paukštelių;6146327857;Taip;13;0;0;13
12530;Vėtrungė;Paukštelių;8149563485;Taip;9;1;0;10
12531;Vėtrungė;Viščiukų;5021830780;Taip;4;0;1;5
12532;Vėtrungė;Viščiukų;5808423634;Taip;6;0;0;6
12533;Vėtrungė;Viščiukų;6190900822;Taip;0;0;2;2
12534;Vėtrungė;Viščiukų;3834510410;Taip;0;11;4;15
12535;Vėtrungė;Viščiukų;4597361099;Taip;0;0;10;10
12536;Vėtrungė;Viščiukų;2490075899;Taip;0;3;0;3
12537;Vėtrungė;Viščiukų;4712052283;Ne;0;3;0;3
12538;Vėtrungė;Viščiukų;8761701511;Taip;12;0;0;12
12539;Vėtrungė;Viščiukų;3527585648;Taip;0;0;5;5
12540;Vėtrungė;Viščiukų;9684184905;Ne;8;0;1;9
12541;Vėtrungė;Viščiukų;4145172377;Taip;11;0;1;12
12542;Vėtrungė;Viščiukų;1568598938;Taip;0;0;4;4
12543;Vėtrungė;Viščiukų;8577668542;Taip;8;0;1;9
12544;Vėtrungė;Viščiukų;4740985408;Taip;4;0;2;6
12545;Vėtrungė;Nykštukų;9696984346;Taip;0;11;0;11
12546;Vėtrungė;Nykštukų;7819147751;Taip;2;1;0;3
12547;Vėtrungė;Nykštukų;6990506209;Taip;19;1;0;20
12548;Vėtrungė;Nykštukų;2348557463;Taip;0;11;0;11
12549;Vėtrungė;Nykštukų;7733472482;Taip;13;0;0;13
12550;Vėtrungė;Nykštukų;2309821873;Taip;0;1;0;1
12551;Vėtrungė;Nykštukų;2364156362;Taip;2;6;0;8
12552;Vėtrungė;Nykštukų;4020987532;Taip;3;1;0;4
12553;Vėtrungė;Nykštukų;9569555731;Taip;4;2;0;6
12554;Vėtrungė;Nykštukų;7699392279;Taip;0;17;0;17
12555;Vėtrungė;Nykštukų;9773838651;Taip;6;4;0;10
12556;Vėtrungė;Nykštukų;3869546285;Taip;5;0;0;5
12557;Vėtrungė;Nykštukų;4289435509;Taip;5;3;0;8
12558;Vėtrungė;Meškiukų;2510763357;Taip;4;0;0;4
12559;Vėtrungė;Meškiukų;4713420194;Taip;4;0;0;4
12560;Vėtrungė;Meškiukų;2226654309;Taip;0;1;0;1
12561;Vėtrungė;Meškiukų;9543456295;Ne;5;0;0;5
12562;Vėtrungė;Meškiukų;9207846866;Taip;7;0;0;7
12563;Vėtrungė;Meškiukų;9065848425;Taip;0;10;0;10
12564;Vėtrungė;Meškiukų;3328447991;Taip;0;3;0;3
12565;Vėtrungė;Meškiukų;9685389270;Ne;0;4;0;4
12566;Vėtrungė;Meškiukų;9313438768;Taip;0;2;0;2
12567;Vėtrungė;Meškiukų;2520926439;Taip;3;1;0;4
12568;Vėtrungė;Meškiukų;7143997258;Taip;9;0;0;9
12569;Vėtrungė;Meškiukų;8961791293;Taip;10;0;0;10
12570;Vėtrungė;Meškiukų;2809555356;Taip;0;6;0;6
12571;Vėtrungė;Meškiukų;1766599777;Ne;1;3;2;6
12572;Vėtrungė;Meškiukų;9642541034;Taip;0;3;0;3
12573;Vėtrungė;Meškiukų;8958748086;Taip;10;5;0;15
12574;Vėtrungė;Ąžuoliukų;8775969909;Taip;11;0;3;14
12575;Vėtrungė;Ąžuoliukų;1034537691;Taip;10;0;2;12
12576;Vėtrungė;Ąžuoliukų;8913748584;Ne;0;1;0;1
12577;Vėtrungė;Ąžuoliukų;3073965379;Taip;5;2;0;7
12578;Vėtrungė;Ąžuoliukų;3938684888;Taip;8;1;3;12
12579;Vėtrungė;Ąžuoliukų;2977116563;Taip;2;0;0;2
12580;Vėtrungė;Ąžuoliukų;4925843510;Taip;13;0;1;14
12581;Vėtrungė;Ąžuoliukų;8026065367;Taip;0;3;1;4
12582;Vilnelė;Lakštutė;8843094480;Taip;0;3;0;3
12583;Vilnelė;Lakštutė;6249731759;Taip;0;12;0;12
12584;Vilnelė;Lakštutė;6837850601;Taip;5;1;0;6
12585;Vilnelė;Lakštutė;5554451335;Taip;10;1;0;11
12586;Vilnelė;Lakštutė;1762024490;Ne;5;0;0;5
12587;Vilnelė;Lakštutė;8201829887;Taip;0;5;0;5
12588;Vilnelė;Lakštutė;7702217893;Taip;10;0;0;10
12589;Vilnelė;Lakštutė;4427383755;Taip;17;1;0;18
12590;Vilnelė;Lakštutė;1547117566;Taip;17;1;0;18
12591;Vilnelė;Lakštutė;3231387543;Taip;0;1;0;1
12592;Vilnelė;Lakštutė;1734277231;Taip;0;5;0;5
12593;Vilnelė;Lakštutė;8837662451;Taip;0;17;0;17
12594;Vilnelė;Lakštutė;3900484348;Taip;0;1;0;1
12595;Vilnelė;Lakštutė;5498574366;Taip;0;13;0;13
12596;Vilnelė;Lakštutė;6686896190;Taip;0;5;3;8
12597;Vilnelė;Lakštutė;3032273912;Taip;0;9;0;9
12598;Vilnelė;Lakštutė;4017436910;Taip;10;2;0;12
12599;Vilnelė;Lakštutė;6156838553;Taip;0;8;0;8
12600;Vilnelė;Lakštutė;9843449060;Ne;20;0;0;20
12601;Vilnelė;Lakštutė;2803880424;Taip;5;1;0;6
12602;Vilnelė;Lakštutė;2418216191;Taip;12;0;0;12
12603;Vilnelė;Vyturėlis;5091272908;Taip;5;0;0;5
12604;Vilnelė;Vyturėlis;3009064105;Taip;0;6;0;6
12605;Vilnelė;Vyturėlis;3743740372;Taip;0;1;0;1
12606;Vilnelė;Vyturėlis;2131599015;Taip;1;12;0;13
12607;Vilnelė;Vyturėlis;18740103706;Taip;5;3;0;8
12608;Vilnelė;Vyturėlis;7057183482;Taip;15;0;1;16
12609;Vilnelė;Vyturėlis;8725191514;Taip;6;1;0;7
12610;Vilnelė;Vyturėlis;6308015852;Taip;0;3;0;3
12611;Vilnelė;Vyturėlis;1545570307;Taip;0;1;1;2
12612;Vilnelė;Vyturėlis;5540359276;Taip;0;2;0;2
12613;Vilnelė;Vyturėlis;1966090625;Taip;8;3;0;11
12614;Vilnelė;Vyturėlis;8740717061;Taip;0;5;0;5
12615;Vilnelė;Vyturėlis;3772263873;Taip;5;3;0;8
12616;Vilnelė;Vyturėlis;9183391434;Taip;0;4;0;4
12617;Vilnelė;Vyturėlis;9369955153;Taip;5;0;0;5
12618;Vilnelė;Vyturėlis;5558584030;Taip;0;2;0;2
12619;Vilnelė;Vyturėlis;1151879281;Taip;0;2;0;2
12620;Vilnelė;Vyturėlis;8820091584;Taip;0;0;1;1
12621;Vilnelė;Vyturėlis;8270866998;Taip;0;16;0;16
12622;Vilnelė;Vyturėlis;3454141069;Taip;0;10;0;10
12623;Vilnelė;Vyturėlis;28447690974;Taip;2;0;0;2
12624;Vilnelė;Vyturėlis;1462397783;Taip;0;8;0;8
12625;Vilnelė;Pagrandukas;5508759323;Taip;7;2;0;9
12626;Vilnelė;Pagrandukas;2144925171;Taip;10;0;0;10
12627;Vilnelė;Pagrandukas;4295816753;Taip;0;3;0;3
12628;Vilnelė;Pagrandukas;3844066232;Ne;23;0;0;23
12629;Vilnelė;Pagrandukas;6659537454;Taip;8;3;0;11
12630;Vilnelė;Pagrandukas;5953205533;Taip;10;8;0;18
12631;Vilnelė;Pagrandukas;4448413194;Taip;5;1;0;6
12632;Vilnelė;Pagrandukas;6830433856;Taip;9;0;0;9
12633;Vilnelė;Pagrandukas;6982847450;Taip;6;4;0;10
12634;Vilnelė;Pagrandukas;7560124407;Taip;1;5;2;8
12635;Vilnelė;Pagrandukas;3685294539;Ne;0;3;0;3
12636;Vilnelė;Pagrandukas;4931943297;Taip;0;2;0;2
12637;Vilnelė;Pagrandukas;7882756938;Taip;0;3;0;3
12638;Vilnelė;Pagrandukas;7348404699;Taip;0;2;0;2
12639;Vilnelė;Pagrandukas;3323738649;Taip;0;6;0;6
12640;Vilnelė;Pagrandukas;8116613831;Taip;0;23;0;23
12641;Vilnelė;Pagrandukas;9489760844;Taip;0;1;0;1
12642;Vilnelė;Pagrandukas;6466321228;Taip;0;8;0;8
12643;Vilnelė;Pagrandukas;4478847902;Taip;0;9;0;9
12644;Vilnelė;Pagrandukas;9635159885;Taip;9;0;0;9
12645;Vilnelė;Pagrandukas;6448119003;Taip;0;6;0;6
12646;Vilnelė;Pagrandukas;2165389724;Taip;5;1;1;7
12647;Vilnelė;Bitutė;1720695615;Taip;0;3;0;3
12648;Vilnelė;Bitutė;2121071276;Taip;0;11;0;11
12649;Vilnelė;Bitutė;7387394504;Taip;0;9;0;9
12650;Vilnelė;Bitutė;8593060923;Taip;9;0;3;12
12651;Vilnelė;Bitutė;1882520335;Taip;0;5;1;6
12652;Vilnelė;Bitutė;85074719873;Taip;0;3;0;3
12653;Vilnelė;Bitutė;2990112955;Taip;0;3;2;5
12654;Vilnelė;Bitutė;6318246517;Taip;3;0;1;4
12655;Vilnelė;Bitutė;1281521052;Taip;9;0;0;9
12656;Vilnelė;Bitutė;9058632601;Taip;4;1;0;5
12657;Vilnelė;Bitutė;8615257084;Taip;3;0;0;3
12658;Vilnelė;Bitutė;98028664140;Taip;0;4;0;4
12659;Vilnelė;Bitutė;1507865281;Taip;0;4;0;4
12660;Vilnelė;Bitutė;2130482375;Taip;0;3;0;3
12661;Vilnelė;Bitutė;7292043157;Taip;4;3;0;7
12662;Vilnelė;Bitutė;4480175299;Taip;0;3;0;3
12663;Vilnelė;Bitutė;39494954188;Taip;0;11;0;11
12664;Vilnelė;Bitutė;6327531229;Taip;4;2;4;10
12665;Vilnelė;Bitutė;42835212158;Taip;0;15;0;15
12666;Vilnelė;Bitutė;6146514112;Taip;0;12;0;12
12667;Vilnelė;Bitutė;5013418313;Taip;0;3;0;3
12668;Vilnelė;Bitutė;5932200003;Taip;0;0;2;2
12669;Vilnelė;Bitutė;1783854203;Taip;5;2;0;7
12670;Vilnelė;Šaltinėlis;7752502124;Ne;0;0;4;4
12671;Vilnelė;Šaltinėlis;3064118212;Taip;6;4;0;10
12672;Vilnelė;Šaltinėlis;5813090771;Taip;0;0;3;3
12673;Vilnelė;Šaltinėlis;1234033852;Taip;23;0;0;23
12674;Vilnelė;Šaltinėlis;9317041585;Taip;13;0;1;14
12675;Vilnelė;Šaltinėlis;7992701275;Taip;0;0;9;9
12676;Vilnelė;Šaltinėlis;4670933970;Taip;3;0;0;3
12677;Vilnelė;Šaltinėlis;4817502971;Taip;13;0;1;14
12678;Vilnelė;Šaltinėlis;3712463891;Taip;18;0;1;19
12679;Vilnelė;Šaltinėlis;2343750614;Ne;15;0;0;15
12680;Vilnelė;Šaltinėlis;2700153185;Taip;0;0;3;3
12681;Vilnelė;Šaltinėlis;7231998656;Taip;4;0;0;4
12682;Vilnelė;Šaltinėlis;2683662906;Taip;4;0;0;4
12683;Vilnelė;Šaltinėlis;4982137749;Ne;0;1;0;1
12684;Vilnelė;Riešutėllis;1027463000;Taip;0;2;0;2
12685;Vilnelė;Riešutėllis;7020707723;Taip;12;1;0;13
12686;Vilnelė;Riešutėllis;4203549404;Taip;8;0;0;8
12687;Vilnelė;Riešutėllis;3290952017;Ne;21;0;0;21
12688;Vilnelė;Riešutėllis;8588430578;Taip;0;5;0;5
12689;Vilnelė;Riešutėllis;7957695470;Taip;6;0;0;6
12690;Vilnelė;Riešutėllis;4780827432;Taip;0;3;0;3
12691;Vilnelė;Riešutėllis;4455099179;Taip;0;4;0;4
12692;Vilnelė;Riešutėllis;2367127222;Taip;0;5;0;5
12693;Vilnelė;Riešutėllis;5306723959;Taip;3;0;0;3
12694;Vilnelė;Riešutėllis;3670613082;Taip;7;2;7;16
12695;Vilnelė;Riešutėllis;6417545510;Taip;4;1;0;5
12696;Vilnelė;Riešutėllis;7085972543;Taip;0;1;0;1
12697;Vilnelė;Riešutėllis;3211657057;Taip;0;2;0;2
12698;Vilnelė;Riešutėllis;9016866597;Taip;4;8;0;12
12699;Vilnelė;Riešutėllis;7087798406;Taip;0;2;1;3
12700;Vilnelė;Riešutėllis;4254744025;Ne;10;7;0;17
12701;Vilnelė;Riešutėllis;3730997665;Taip;5;2;0;7
12702;Vilnelė;Riešutėllis;2706699572;Taip;0;1;0;1
12703;Vilnelė;Riešutėllis;8774842903;Taip;7;0;0;7
12704;Vilnelė;Riešutėllis;3031790547;Ne;2;1;0;3
12705;Vilnelė;Nykštukas;4210511566;Ne;11;1;1;13
12706;Vilnelė;Nykštukas;2891787022;Taip;6;0;0;6
12707;Vilnelė;Nykštukas;4734511521;Taip;8;4;0;12
12708;Vilnelė;Nykštukas;6344134620;Taip;1;5;2;8
12709;Vilnelė;Nykštukas;4295630317;Taip;23;1;0;24
12710;Vilnelė;Nykštukas;1554473199;Taip;0;4;0;4
12711;Vilnelė;Nykštukas;1819154122;Ne;5;0;0;5
12712;Vilnelė;Nykštukas;4060927733;Taip;11;1;0;12
12713;Vilnelė;Nykštukas;2299381653;Ne;11;8;0;19
12714;Vilnelė;Nykštukas;5041031750;Taip;6;0;0;6
12715;Vilnelė;Nykštukas;2157793186;Taip;0;1;0;1
12716;Vilnelė;Nykštukas;4516818999;Taip;2;10;0;12
12717;Vilnelė;Nykštukas;8579294202;Taip;0;12;0;12
12718;Vilnelė;Nykštukas;7161529969;Taip;10;0;0;10
12719;Vilnelė;Nykštukas;8493390146;Taip;4;1;0;5
12720;Vilnelė;Nykštukas;6048991617;Taip;1;0;0;1
12721;Vilnelė;Nykštukas;6054488692;Taip;10;0;0;10
12722;Vilnelė;Nykštukas;8630048961;Ne;3;16;0;19
12723;Vilnelė;Nykštukas;7592040226;Taip;6;4;0;10
12724;Vilnelė;Nykštukas;1515873552;Taip;5;2;0;7
12725;Vilnelė;Nykštukas;5629086127;Taip;11;1;0;12
12726;Vilnelė;Pieštukas;9879688569;Taip;0;0;1;1
12727;Vilnelė;Pieštukas;5473379559;Taip;10;1;0;11
12728;Vilnelė;Pieštukas;1792586468;Ne;14;4;0;18
12729;Vilnelė;Pieštukas;3781595939;Taip;0;5;0;5
12730;Vilnelė;Pieštukas;9884955712;Taip;13;2;0;15
12731;Vilnelė;Pieštukas;2479090686;Taip;0;8;0;8
12732;Vilnelė;Pieštukas;3945921490;Taip;0;12;0;12
12733;Vilnelė;Pieštukas;1975954784;Ne;0;4;0;4
12734;Vilnelė;Pieštukas;7199490431;Taip;0;3;0;3
12735;Vilnelė;Pieštukas;1730149127;Taip;0;2;0;2
12736;Vilnelė;Pieštukas;6355912551;Taip;0;11;0;11
12737;Vilnelė;Pieštukas;7976798775;Taip;0;4;0;4
12738;Vilnelė;Pieštukas;3811289758;Taip;0;11;0;11
12739;Vilnelė;Pieštukas;3529718234;Taip;0;10;0;10
12740;Vilnelė;Pieštukas;1880318663;Taip;0;8;0;8
12741;Vilnelė;Pieštukas;9589410276;Taip;0;8;0;8
12742;Vilnelė;Pieštukas;4718994967;Taip;0;16;0;16
12743;Vilnelė;Pieštukas;8092642447;Ne;0;2;0;2
12744;Vilnelė;Pieštukas;3856917286;Taip;0;13;0;13
12745;Vilnelė;Pieštukas;6132739519;Ne;0;3;0;3
12746;Vilnelė;Pieštukas;8162191913;Ne;0;3;0;3
12747;Vilnelė;Pieštukas;3791258264;Taip;3;2;0;5
12748;Vilnelė;Voverytė;7536603663;Ne;0;5;7;12
12749;Vilnelė;Voverytė;3503461211;Taip;5;2;0;7
12750;Vilnelė;Voverytė;3993826389;Taip;0;0;1;1
12751;Vilnelė;Voverytė;7388336851;Taip;0;3;0;3
12752;Vilnelė;Voverytė;8667403338;Taip;0;9;0;9
12753;Vilnelė;Voverytė;7883724600;Taip;0;5;0;5
12754;Vilnelė;Voverytė;1351798589;Taip;0;6;0;6
12755;Vilnelė;Voverytė;9162681538;Taip;0;2;0;2
12756;Vilnelė;Voverytė;3075681823;Taip;0;2;1;3
12757;Vilnelė;Voverytė;6342242777;Taip;0;2;0;2
12758;Vilnelė;Voverytė;3843064564;Taip;0;2;0;2
12759;Vilnelė;Voverytė;3558073399;Taip;0;0;3;3
12760;Vilnelė;Voverytė;2841315531;Taip;0;0;6;6
12761;Vilnelė;Voverytė;9804772168;Taip;0;0;3;3
12762;Vilnelė;Voverytė;7338573817;Taip;0;0;4;4
12763;Vilnelė;Voverytė;8121075430;Taip;0;2;0;2
12764;Vilnelė;Voverytė;1574809879;Taip;10;1;0;11
12765;Vilnelė;Voverytė;6083082959;Taip;12;1;0;13
12766;Vilnelė;Voverytė;2788449626;Taip;0;3;0;3
12767;Vilnelė;Kodėlčiukas;4642378600;Taip;3;5;0;8
12768;Vilnelė;Kodėlčiukas;6618109352;Taip;0;9;0;9
12769;Vilnelė;Kodėlčiukas;6715997340;Ne;5;2;0;7
12770;Vilnelė;Kodėlčiukas;8439505238;Taip;0;2;0;2
12771;Vilnelė;Kodėlčiukas;1580287517;Taip;0;3;0;3
12772;Vilnelė;Kodėlčiukas;4328263940;Taip;0;3;0;3
12773;Vilnelė;Kodėlčiukas;3056845279;Taip;6;0;0;6
12774;Vilnelė;Kodėlčiukas;9537740492;Taip;5;0;2;7
12775;Vilnelė;Kodėlčiukas;9640330864;Taip;12;2;0;14
12776;Vilnelė;Kodėlčiukas;3848720970;Taip;0;2;0;2
12777;Vilnelė;Kodėlčiukas;7833531435;Taip;0;4;0;4
12778;Vilnelė;Kodėlčiukas;5961910077;Taip;5;3;0;8
12779;Vilnelė;Kodėlčiukas;3115242919;Ne;5;0;0;5
12780;Vilnelė;Kodėlčiukas;8543995029;Ne;7;1;0;8
12781;Vilnelė;Kodėlčiukas;1933660272;Taip;6;0;3;9
12782;Vilnelė;Kodėlčiukas;4986079102;Taip;0;2;0;2
12783;Vilnelė;Kodėlčiukas;5398303580;Taip;4;1;0;5
12784;Vilnelė;Kodėlčiukas;9418661965;Taip;5;1;0;6
12785;Vilnelė;Kodėlčiukas;5180951251;Taip;8;2;0;10
12786;Vilnelė;Žirniukas;5612501291;Taip;14;0;0;14
12787;Vilnelė;Žirniukas;2576381995;Taip;0;0;4;4
12788;Vilnelė;Žirniukas;3654833067;Taip;7;1;0;8
12789;Vilnelė;Žirniukas;4322462166;Taip;7;1;0;8
12790;Vilnelė;Žirniukas;9817054571;Taip;13;2;0;15
12791;Vilnelė;Žirniukas;9316933315;Taip;7;2;0;9
12792;Vilnelė;Žirniukas;4758117005;Ne;7;0;0;7
12793;Vilnelė;Žirniukas;1598555488;Taip;9;0;0;9
12794;Vilnelė;Žirniukas;5960725916;Taip;0;12;0;12
12795;Vilnelė;Žirniukas;8329253118;Taip;21;0;0;21
12796;Vilnelė;Žirniukas;9476510950;Taip;0;0;8;8
12797;Vilnelė;Žirniukas;3234028667;Taip;0;2;0;2
12798;Vilnelė;Žirniukas;7870509810;Ne;17;0;0;17
12799;Vilnelė;Žirniukas;6569980514;Taip;13;2;0;15
12800;Vilnelė;Žirniukas;6634526716;Ne;17;0;0;17
12801;Vilnelė;Žirniukas;8848138564;Ne;1;14;0;15
12802;Vilnelė;Žirniukas;5649725693;Taip;0;3;0;3
12803;Vilnelė;Žirniukas;7568755715;Taip;13;0;0;13
12804;Vilnelė;Pipiras;1414168531;Taip;3;1;4;8
12805;Vilnelė;Pipiras;2918624119;Taip;7;0;0;7
12806;Vilnelė;Pipiras;3432602015;Taip;1;1;0;2
12807;Vilnelė;Pipiras;9660305163;Taip;5;0;0;5
12808;Vilnelė;Pipiras;2964672357;Taip;5;0;3;8
12809;Vilnelė;Pipiras;1566734465;Taip;0;0;2;2
12810;Vilnelė;Pipiras;9882766915;Taip;8;15;0;23
12811;Vilnelė;Pipiras;8015908754;Taip;14;0;0;14
12812;Vilnelė;Pipiras;7968029402;Taip;5;0;0;5
12813;Vilnelė;Pipiras;7221712624;Taip;5;0;0;5
12814;Vilnelė;Pipiras;6966791665;Taip;3;1;0;4
12815;Vilnelė;Pipiras;7293735126;Taip;4;1;0;5
12816;Vilnelė;Pipiras;9950598582;Taip;10;0;2;12
12817;Vilnelė;Pipiras;5444967820;Taip;8;2;2;12
12818;Vilnelė;Pipiras;3828623778;Taip;0;5;0;5
12819;Vilnelė;Pipiras;5273665901;Taip;3;5;0;8
12820;Vėrinėlis;GAIDELIAI;6162461750;Taip;0;0;1;1
12821;Vėrinėlis;GAIDELIAI;3500287869;Taip;7;0;5;12
12822;Vėrinėlis;GAIDELIAI;9370715798;Ne;20;0;0;20
12823;Vėrinėlis;GAIDELIAI;6500266853;Taip;28;0;0;28
12824;Vėrinėlis;GAIDELIAI;5891690000;Taip;14;0;3;17
12825;Vėrinėlis;GAIDELIAI;4401001009;Taip;18;10;0;28
12826;Vėrinėlis;GAIDELIAI;4498096701;Taip;0;3;1;4
12827;Vėrinėlis;GAIDELIAI;6055921178;Taip;10;5;1;16
12828;Vėrinėlis;GAIDELIAI;9144004655;Taip;24;0;0;24
12829;Vėrinėlis;GAIDELIAI;8272531606;Taip;24;0;0;24
12830;Vėrinėlis;GAIDELIAI;2114637828;Taip;4;0;7;11
12831;Vėrinėlis;GAIDELIAI;6159725406;Taip;13;0;1;14
12832;Vėrinėlis;GAIDELIAI;1844862699;Taip;26;0;0;26
12833;Vėrinėlis;GAIDELIAI;7455948332;Taip;16;4;0;20
12834;Vėrinėlis;GAIDELIAI;4965735537;Taip;13;0;2;15
12835;Vėrinėlis;SAULUTĖ;7224418233;Taip;14;0;0;14
12836;Vėrinėlis;SAULUTĖ;7471147288;Taip;0;4;0;4
12837;Vėrinėlis;SAULUTĖ;9612956692;Taip;0;7;0;7
12838;Vėrinėlis;SAULUTĖ;8238013636;Taip;18;0;0;18
12839;Vėrinėlis;SAULUTĖ;7273090217;Taip;6;0;0;6
12840;Vėrinėlis;SAULUTĖ;2337883071;Taip;11;0;1;12
12841;Vėrinėlis;SAULUTĖ;3882915774;Taip;0;15;0;15
12842;Vėrinėlis;SAULUTĖ;7440020169;Taip;2;2;0;4
12843;Vėrinėlis;SAULUTĖ;7913975075;Taip;5;5;0;10
12844;Vėrinėlis;SAULUTĖ;9967737864;Taip;0;6;0;6
12845;Vėrinėlis;SAULUTĖ;7364698713;Taip;5;0;1;6
12846;Vėrinėlis;SAULUTĖ;9009344779;Taip;8;3;0;11
12847;Vėrinėlis;SAULUTĖ;4059906525;Taip;6;3;4;13
12848;Vėrinėlis;SAULUTĖ;3832662507;Taip;6;0;0;6
12849;Vėrinėlis;SAULUTĖ;3291922401;Taip;0;3;0;3
12850;Vėrinėlis;SAULUTĖ;1007705906;Taip;5;10;0;15
12851;Vėrinėlis;SAULUTĖ;9289003583;Taip;0;7;0;7
12852;Vėrinėlis;SAULUTĖ;1684203955;Taip;0;7;0;7
12853;Vėrinėlis;SAULUTĖ;5942475043;Taip;0;11;0;11
12854;Vėrinėlis;SAULUTĖ;9310629340;Taip;14;0;0;14
12855;Vėrinėlis;SAULUTĖ;2369434537;Taip;0;1;0;1
12856;Vėrinėlis;NYKŠTUKAI;8755231814;Taip;8;0;0;8
12857;Vėrinėlis;NYKŠTUKAI;9604483237;Ne;0;1;2;3
12858;Vėrinėlis;NYKŠTUKAI;6220653152;Taip;5;5;0;10
12859;Vėrinėlis;NYKŠTUKAI;7981261038;Taip;0;4;0;4
12860;Vėrinėlis;NYKŠTUKAI;1395590011;Taip;0;1;0;1
12861;Vėrinėlis;NYKŠTUKAI;19865450007;Taip;3;0;0;3
12862;Vėrinėlis;NYKŠTUKAI;5511584499;Ne;6;0;0;6
12863;Vėrinėlis;NYKŠTUKAI;4958359640;Taip;0;10;0;10
12864;Vėrinėlis;NYKŠTUKAI;3562371502;Taip;9;0;0;9
12865;Vėrinėlis;NYKŠTUKAI;9751037428;Taip;0;4;0;4
12866;Vėrinėlis;NYKŠTUKAI;4089567420;Taip;0;1;0;1
12867;Vėrinėlis;NYKŠTUKAI;8579819581;Taip;0;1;0;1
12868;Vėrinėlis;NYKŠTUKAI;5209398043;Taip;0;9;0;9
12869;Vėrinėlis;NYKŠTUKAI;3074835599;Taip;5;0;0;5
12870;Vėrinėlis;NYKŠTUKAI;6779005350;Taip;0;3;1;4
12871;Vėrinėlis;NYKŠTUKAI;8824435889;Ne;8;0;5;13
12872;Vėrinėlis;BURATINAS;7093959212;Taip;0;12;0;12
12873;Vėrinėlis;BURATINAS;7078114492;Ne;0;1;0;1
12874;Vėrinėlis;BURATINAS;6280508974;Ne;0;1;0;1
12875;Vėrinėlis;BURATINAS;7963866641;Taip;0;0;23;23
12876;Vėrinėlis;BURATINAS;4666918175;Taip;0;0;2;2
12877;Vėrinėlis;BURATINAS;2774618380;Ne;6;3;0;9
12878;Vėrinėlis;BURATINAS;2857591912;Taip;0;2;0;2
12879;Vėrinėlis;BURATINAS;5429955166;Taip;0;8;0;8
12880;Vėrinėlis;BURATINAS;5429372946;Taip;11;0;1;12
12881;Vėrinėlis;BURATINAS;4183077476;Taip;0;10;0;10
12882;Vėrinėlis;BURATINAS;2529641529;Taip;8;2;0;10
12883;Vėrinėlis;BURATINAS;2467700639;Taip;17;2;0;19
12884;Vėrinėlis;BURATINAS;6136232912;Taip;8;0;0;8
12885;Vėrinėlis;BURATINAS;7092421890;Taip;0;1;0;1
12886;Vėrinėlis;BURATINAS;6058712578;Taip;9;2;0;11
12887;Vėrinėlis;BURATINAS;1164396960;Taip;0;9;0;9
12888;Vėrinėlis;BURATINAS;6413701823;Taip;5;3;1;9
12889;Vėrinėlis;BURATINAS;2364117224;Taip;2;0;11;13
12890;Vėrinėlis;BURATINAS;5206206080;Taip;4;3;2;9
12891;Vėrinėlis;BURATINAS;3947650381;Taip;23;0;0;23
12892;Vėrinėlis;GINTARĖLIAI;5987029334;Ne;13;0;0;13
12893;Vėrinėlis;GINTARĖLIAI;8372084728;Taip;14;0;0;14
12894;Vėrinėlis;GINTARĖLIAI;6054398276;Taip;0;0;3;3
12895;Vėrinėlis;GINTARĖLIAI;7432965615;Taip;5;4;0;9
12896;Vėrinėlis;GINTARĖLIAI;7743951577;Ne;10;0;3;13
12897;Vėrinėlis;GINTARĖLIAI;2006432327;Taip;4;9;0;13
12898;Vėrinėlis;GINTARĖLIAI;6785519869;Ne;19;0;0;19
12899;Vėrinėlis;GINTARĖLIAI;3363388500;Taip;10;4;0;14
12900;Vėrinėlis;GINTARĖLIAI;8545392429;Taip;12;0;6;18
12901;Vėrinėlis;GINTARĖLIAI;9171173116;Taip;0;2;2;4
12902;Vėrinėlis;GINTARĖLIAI;8343196405;Taip;8;8;0;16
12903;Vėrinėlis;GINTARĖLIAI;2284527544;Taip;5;0;1;6
12904;Vėrinėlis;GINTARĖLIAI;5644772729;Taip;10;2;0;12
12905;Vėrinėlis;GINTARĖLIAI;4034106321;Taip;2;1;0;3
12906;Vėrinėlis;RAMUNĖLĖS;4415030161;Taip;0;5;0;5
12907;Vėrinėlis;RAMUNĖLĖS;8620836106;Taip;8;2;0;10
12908;Vėrinėlis;RAMUNĖLĖS;5003344894;Taip;6;1;0;7
12909;Vėrinėlis;RAMUNĖLĖS;5434506594;Taip;7;0;0;7
12910;Vėrinėlis;RAMUNĖLĖS;5041189990;Taip;8;3;0;11
12911;Vėrinėlis;RAMUNĖLĖS;1047139776;Taip;10;3;0;13
12912;Vėrinėlis;RAMUNĖLĖS;3130841241;Taip;6;2;0;8
12913;Vėrinėlis;RAMUNĖLĖS;9798993200;Taip;12;3;0;15
12914;Vėrinėlis;RAMUNĖLĖS;6435612222;Taip;0;1;1;2
12915;Vėrinėlis;RAMUNĖLĖS;6866592245;Taip;7;1;0;8
12916;Vėrinėlis;RAMUNĖLĖS;4728119881;Taip;0;3;0;3
12917;Vėrinėlis;RAMUNĖLĖS;3316897176;Taip;2;1;0;3
12918;Vėrinėlis;RAMUNĖLĖS;1386916991;Taip;5;6;0;11
12919;Vėrinėlis;RAMUNĖLĖS;2090334618;Taip;0;1;0;1
12920;Vėrinėlis;RAMUNĖLĖS;1894717954;Taip;6;4;0;10
12921;Vėrinėlis;RAMUNĖLĖS;3810261864;Taip;6;0;0;6
12922;Vėrinėlis;RAMUNĖLĖS;4191386053;Taip;8;1;0;9
12923;Vėrinėlis;KODELČIUKŲ;7070058961;Taip;0;7;0;7
12924;Vėrinėlis;KODELČIUKŲ;3308843618;Taip;1;4;0;5
12925;Vėrinėlis;KODELČIUKŲ;1535567719;Taip;0;6;0;6
12926;Vėrinėlis;KODELČIUKŲ;8755941866;Taip;10;3;0;13
12927;Vėrinėlis;KODELČIUKŲ;9686481278;Taip;0;1;5;6
12928;Vėrinėlis;KODELČIUKŲ;42298331453;Taip;5;0;0;5
12929;Vėrinėlis;KODELČIUKŲ;8709714647;Taip;0;0;2;2
12930;Vėrinėlis;KODELČIUKŲ;6108187043;Taip;4;2;0;6
12931;Vėrinėlis;KODELČIUKŲ;9119967823;Taip;0;1;0;1
12932;Vėrinėlis;KODELČIUKŲ;4067153819;Taip;0;3;4;7
12933;Vėrinėlis;KODELČIUKŲ;5712568063;Taip;0;3;0;3
12934;Vėrinėlis;KODELČIUKŲ;1467899937;Taip;0;0;1;1
12935;Vėrinėlis;KODELČIUKŲ;8885866108;Taip;4;1;2;7
12936;Vėrinėlis;KODELČIUKŲ;7634939364;Taip;0;4;0;4
12937;Vėrinėlis;KODELČIUKŲ;3049346950;Taip;23;0;0;23
12938;Vėrinėlis;KODELČIUKŲ;8652292752;Taip;7;1;2;10
12939;Vėrinėlis;KODELČIUKŲ;4039903678;Taip;0;1;0;1
12940;Vėrinėlis;KODELČIUKŲ;3729926575;Ne;7;3;1;11
12941;Vėrinėlis;KODELČIUKŲ;9511678036;Taip;0;3;1;4
12942;Vėrinėlis;KODELČIUKŲ;3369668445;Taip;0;13;0;13
12943;Vėrinėlis;KODELČIUKŲ;8728166391;Taip;6;0;0;6
12944;Vėrinėlis;KODELČIUKŲ;5720076968;Taip;13;3;2;18
12945;Vėrinėlis;KODELČIUKŲ;8195455092;Taip;5;0;0;5
12946;Vėrinėlis;ŽIRNIUKAI;1769852084;Taip;6;6;2;14
12947;Vėrinėlis;ŽIRNIUKAI;4981127515;Taip;0;0;3;3
12948;Vėrinėlis;ŽIRNIUKAI;8329989952;Taip;10;0;0;10
12949;Vėrinėlis;ŽIRNIUKAI;4752902173;Taip;0;3;2;5
12950;Vėrinėlis;ŽIRNIUKAI;7237945125;Taip;0;0;2;2
12951;Vėrinėlis;ŽIRNIUKAI;5600815908;Taip;8;0;0;8
12952;Vėrinėlis;ŽIRNIUKAI;7367485961;Ne;0;0;2;2
12953;Vėrinėlis;ŽIRNIUKAI;1736733257;Taip;0;0;2;2
12954;Vėrinėlis;ŽIRNIUKAI;2633143128;Taip;0;0;2;2
12955;Vėrinėlis;ŽIRNIUKAI;9419245081;Taip;0;3;0;3
12956;Vėrinėlis;ŽIRNIUKAI;7817387800;Taip;16;0;0;16
12957;Vėrinėlis;ŽIRNIUKAI;6377447141;Ne;0;0;6;6
12958;Vėrinėlis;ŽIRNIUKAI;7371908331;Taip;0;0;9;9
12959;Vėrinėlis;ŽIRNIUKAI;2087129236;Taip;0;1;0;1
12960;Vėrinėlis;ŽIRNIUKAI;6392625405;Ne;0;7;1;8
12961;Vėrinėlis;ŽIRNIUKAI;1896980533;Taip;0;0;4;4
12962;Vėrinėlis;ŽIRNIUKAI;2732572235;Taip;4;0;1;5
12963;Vėrinėlis;ŽIRNIUKAI;8483525051;Taip;0;0;1;1
12964;Vėrinėlis;ŽIRNIUKAI;8397025332;Taip;0;4;1;5
12965;Vėrinėlis;ŽIRNIUKAI;6576726481;Taip;0;4;1;5
12966;Vėrinėlis;VARPELIAI;7416041207;Taip;0;4;0;4
12967;Vėrinėlis;VARPELIAI;8655158155;Taip;0;5;0;5
12968;Vėrinėlis;VARPELIAI;3829146401;Taip;6;0;1;7
12969;Vėrinėlis;VARPELIAI;6177784856;Taip;4;2;0;6
12970;Vėrinėlis;VARPELIAI;9388153932;Taip;13;0;5;18
12971;Vėrinėlis;VARPELIAI;6362125404;Ne;23;0;0;23
12972;Vėrinėlis;VARPELIAI;9599724421;Taip;0;1;0;1
12973;Vėrinėlis;VARPELIAI;7216867683;Taip;5;4;0;9
12974;Vėrinėlis;VARPELIAI;8336694468;Taip;9;0;0;9
12975;Vėrinėlis;VARPELIAI;2731207996;Taip;0;0;10;10
12976;Vėrinėlis;VARPELIAI;9522506115;Taip;9;2;0;11
12977;Vėrinėlis;VARPELIAI;2625930005;Taip;0;0;1;1
12978;Vėrinėlis;VARPELIAI;2561255096;Taip;9;0;4;13
12979;Vėrinėlis;VARPELIAI;5821107898;Taip;16;0;2;18
12980;Vėrinėlis;VARPELIAI;9351658311;Taip;10;2;1;13
12981;Vėrinėlis;VARPELIAI;3392458614;Taip;0;3;0;3
12982;Vėrinėlis;BORUŽĖLĖS;8759487574;Taip;0;4;0;4
12983;Vėrinėlis;BORUŽĖLĖS;4819016753;Taip;3;0;0;3
12984;Vėrinėlis;BORUŽĖLĖS;1910385020;Taip;0;5;0;5
12985;Vėrinėlis;BORUŽĖLĖS;3934652683;Taip;8;0;0;8
12986;Vėrinėlis;BORUŽĖLĖS;6904733283;Taip;12;0;1;13
12987;Vėrinėlis;BORUŽĖLĖS;2501287529;Taip;0;7;0;7
12988;Vėrinėlis;BORUŽĖLĖS;8904833339;Taip;11;2;0;13
12989;Vėrinėlis;BORUŽĖLĖS;3312501759;Taip;11;2;0;13
12990;Vėrinėlis;BORUŽĖLĖS;9217188911;Taip;0;23;0;23
12991;Vėrinėlis;BORUŽĖLĖS;7414937335;Taip;6;7;0;13
12992;Vėrinėlis;BORUŽĖLĖS;2574507205;Taip;7;3;0;10
12993;Vėrinėlis;BORUŽĖLĖS;4852563692;Taip;0;1;0;1
12994;Vėrinėlis;BORUŽĖLĖS;7953446502;Taip;0;3;0;3
12995;Vėrinėlis;BORUŽĖLĖS;5865529907;Taip;7;0;0;7
12996;Vėrinėlis;BORUŽĖLĖS;9613642664;Taip;0;12;0;12
12997;Vėrinėlis;BORUŽĖLĖS;2467242845;Taip;0;10;0;10
12998;Vėrinėlis;SVEIKUOLIAI;1909742394;Taip;20;1;1;22
12999;Vėrinėlis;SVEIKUOLIAI;6176308531;Taip;0;9;0;9
13000;Vėrinėlis;SVEIKUOLIAI;3070965434;Taip;0;5;0;5
13001;Vėrinėlis;SVEIKUOLIAI;3563114419;Ne;8;2;0;10
13002;Vėrinėlis;SVEIKUOLIAI;3973272659;Taip;0;1;2;3
13003;Vėrinėlis;SVEIKUOLIAI;8032396191;Taip;0;0;1;1
13004;Vėrinėlis;SVEIKUOLIAI;6504377326;Taip;0;1;0;1
13005;Vėrinėlis;SVEIKUOLIAI;8716965452;Taip;13;6;0;19
13006;Vėrinėlis;SVEIKUOLIAI;7584124339;Taip;8;6;0;14
13007;Vėrinėlis;SVEIKUOLIAI;9352630743;Taip;0;3;1;4
13008;Vėrinėlis;SVEIKUOLIAI;4859330774;Taip;18;0;0;18
13009;Vėrinėlis;SVEIKUOLIAI;8543081245;Taip;9;8;0;17
13010;Vėrinėlis;SVEIKUOLIAI;1800434426;Taip;9;4;1;14
13011;Vėrinėlis;SVEIKUOLIAI;3958551159;Taip;12;1;0;13
13012;Vėrinėlis;SVEIKUOLIAI;5614185158;Taip;5;4;3;12
13013;Vėrinėlis;SVEIKUOLIAI;5539714292;Ne;15;5;0;20
13014;Vėrinėlis;SVEIKUOLIAI;2516474825;Taip;18;0;0;18
13015;Vėrinėlis;SVEIKUOLIAI;9058127692;Taip;0;7;0;7
13016;Vėrinėlis;SVEIKUOLIAI;1278914183;Taip;14;0;0;14
13017;Vėrinėlis;SVEIKUOLIAI;7573209012;Taip;8;0;0;8
13018;Vėrinėlis;SVEIKUOLIAI;3084117432;Taip;12;0;0;12
13019;Vėrinėlis;SVEIKUOLIAI;2015928440;Taip;0;2;0;2
13020;Vėrinėlis;ŠIRDELĖS;7734163541;Taip;0;0;3;3
13021;Vėrinėlis;ŠIRDELĖS;7811024382;Ne;8;0;0;8
13022;Vėrinėlis;ŠIRDELĖS;4378592116;Taip;6;0;6;12
13023;Vėrinėlis;ŠIRDELĖS;7517113022;Taip;3;0;0;3
13024;Vėrinėlis;ŠIRDELĖS;1841277321;Taip;0;2;0;2
13025;Vėrinėlis;ŠIRDELĖS;5588658517;Taip;10;8;0;18
13026;Vėrinėlis;ŠIRDELĖS;5653635907;Taip;4;3;0;7
13027;Vėrinėlis;ŠIRDELĖS;1152010178;Taip;10;3;0;13
13028;Vėrinėlis;ŠIRDELĖS;2038169885;Taip;16;4;0;20
13029;Vėrinėlis;ŠIRDELĖS;9375922889;Taip;18;3;0;21
13030;Vėrinėlis;ŠIRDELĖS;5813009126;Taip;14;6;0;20
13031;Vėrinėlis;ŠIRDELĖS;3511809411;Taip;11;3;0;14
13032;Vėrinėlis;ŠIRDELĖS;3535652648;Taip;6;2;6;14
13033;Vėrinėlis;ŠIRDELĖS;9217815657;Taip;0;15;0;15
13034;Vėrinėlis;ŠIRDELĖS;4403875733;Taip;11;0;0;11
13035;Vėrinėlis;ŠIRDELĖS;4700093328;Taip;10;0;0;10
13036;Vėrinėlis;ŠIRDELĖS;1339847370;Taip;11;0;0;11
13037;Vėrinėlis;ŠIRDELĖS;3687250255;Taip;10;0;2;12
13038;Vėrinėlis;ŠIRDELĖS;7361319518;Taip;5;0;1;6
13039;Vėrinėlis;ŠIRDELĖS;2847839917;Ne;15;0;3;18
13040;Vėrinėlis;ŠIRDELĖS;7311740859;Taip;9;3;0;12
13041;Vėrinėlis;ŠIRDELĖS;6905591549;Taip;13;0;0;13
13042;Viltenė;Drugeliai;3625763429;Taip;7;1;0;8
13043;Viltenė;Drugeliai;2392304909;Taip;2;3;0;5
13044;Viltenė;Drugeliai;5781655552;Taip;0;3;0;3
13045;Viltenė;Drugeliai;2410868015;Taip;0;22;0;22
13046;Viltenė;Drugeliai;6810811656;Taip;0;3;0;3
13047;Viltenė;Drugeliai;9228677568;Taip;2;0;0;2
13048;Viltenė;Drugeliai;3905014810;Taip;0;12;0;12
13049;Viltenė;Drugeliai;4121448859;Taip;0;1;0;1
13050;Viltenė;Drugeliai;9157616307;Taip;0;2;0;2
13051;Viltenė;Drugeliai;9476132305;Taip;9;0;0;9
13052;Viltenė;Drugeliai;3052677157;Taip;0;3;0;3
13053;Viltenė;Drugeliai;5522245968;Taip;7;0;0;7
13054;Viltenė;Drugeliai;5552217000;Taip;0;2;0;2
13055;Viltenė;Drugeliai;9756519374;Taip;0;6;0;6
13056;Viltenė;Drugeliai;7928894276;Taip;0;1;0;1
13057;Viltenė;Drugeliai;8527270437;Taip;0;2;0;2
13058;Viltenė;Drugeliai;4195708756;Taip;8;10;0;18
13059;Viltenė;Drugeliai;1267187553;Taip;4;0;0;4
13060;Viltenė;Drugeliai;1081603034;Taip;0;22;0;22
13061;Viltenė;Drugeliai;7500965165;Taip;0;3;0;3
13062;Viltenė;Bitučių;7158824421;Taip;0;6;0;6
13063;Viltenė;Bitučių;2846574130;Taip;19;0;0;19
13064;Viltenė;Bitučių;2656363650;Taip;3;0;0;3
13065;Viltenė;Bitučių;2841144656;Taip;3;0;0;3
13066;Viltenė;Bitučių;7810374329;Taip;6;8;0;14
13067;Viltenė;Bitučių;4001205912;Taip;8;1;0;9
13068;Viltenė;Bitučių;5077874991;Taip;3;0;0;3
13069;Viltenė;Bitučių;8141954391;Taip;7;4;0;11
13070;Viltenė;Bitučių;9095458948;Taip;17;1;0;18
13071;Viltenė;Bitučių;4661430937;Taip;11;2;0;13
13072;Viltenė;Boružėlių;6642790962;Taip;12;0;0;12
13073;Viltenė;Boružėlių;9572407405;Taip;0;6;0;6
13074;Viltenė;Boružėlių;3738838707;Taip;0;4;0;4
13075;Viltenė;Boružėlių;8473588098;Ne;10;4;0;14
13076;Viltenė;Boružėlių;3995418079;Taip;7;0;0;7
13077;Viltenė;Boružėlių;1399653129;Taip;0;3;0;3
13078;Viltenė;Boružėlių;3164402142;Taip;0;8;0;8
13079;Viltenė;Boružėlių;1936628249;Taip;0;4;0;4
13080;Viltenė;Boružėlių;4003018966;Taip;0;16;0;16
13081;Viltenė;Boružėlių;7912396297;Taip;0;10;0;10
13082;Viltenė;Boružėlių;4036109404;Taip;5;0;0;5
13083;Viltenė;Boružėlių;4604298036;Taip;0;7;0;7
13084;Viltenė;Boružėlių;9197007374;Taip;0;1;0;1
13085;Viltenė;Boružėlių;9242034622;Taip;0;4;0;4
13086;Viltenė;Boružėlių;2383607612;Taip;0;10;0;10
13087;Viltenė;Boružėlių;1496943250;Taip;0;3;0;3
13088;Viltenė;Gandriukų;6481491422;Taip;0;3;5;8
13089;Viltenė;Gandriukų;1126409020;Taip;0;3;0;3
13090;Viltenė;Gandriukų;2884698447;Taip;0;2;0;2
13091;Viltenė;Gandriukų;6060648988;Taip;0;2;0;2
13092;Viltenė;Gandriukų;1840626621;Taip;8;2;0;10
13093;Viltenė;Gandriukų;8549631247;Taip;3;4;0;7
13094;Viltenė;Gandriukų;7796422726;Taip;0;1;0;1
13095;Viltenė;Gandriukų;6511850468;Taip;0;3;0;3
13096;Viltenė;Gandriukų;4945108189;Taip;4;0;0;4
13097;Viltenė;Gandriukų;5850652322;Taip;0;1;0;1
13098;Viltenė;Gandriukų;8110413064;Taip;0;3;0;3
13099;Viltenė;Gandriukų;1243595112;Taip;0;4;0;4
13100;Viltenė;Gandriukų;3073228245;Ne;17;0;0;17
13101;Viltenė;Gandriukų;4468743044;Taip;10;0;0;10
13102;Viltenė;Gandriukų;6355857716;Taip;3;0;1;4
13103;Viltenė;Gandriukų;5929135840;Taip;8;0;1;9
13104;Viltenė;Gandriukų;6473925760;Taip;0;3;1;4
13105;Viltenė;Gandriukų;8458769051;Taip;0;3;2;5
13106;Viltenė;Aitvariukai;5083515613;Ne;5;2;0;7
13107;Viltenė;Aitvariukai;2137929911;Taip;0;2;0;2
13108;Viltenė;Aitvariukai;9185054066;Taip;0;3;0;3
13109;Viltenė;Aitvariukai;2502099784;Taip;7;12;0;19
13110;Viltenė;Aitvariukai;2036902795;Taip;0;1;0;1
13111;Viltenė;Aitvariukai;5599943846;Taip;0;1;0;1
13112;Viltenė;Aitvariukai;6721689684;Taip;8;0;0;8
13113;Viltenė;Aitvariukai;6296509460;Taip;0;12;0;12
13114;Viltenė;Aitvariukai;9101795131;Taip;2;3;0;5
13115;Viltenė;Aitvariukai;2702489251;Taip;0;3;0;3
13116;Viltenė;Aitvariukai;3908574248;Taip;7;0;0;7
13117;Viltenė;Aitvariukai;8439859449;Taip;18;0;0;18
13118;Viltenė;Aitvariukai;2976705872;Taip;0;2;0;2
13119;Viltenė;Aitvariukai;2192086488;Taip;5;4;0;9
13120;Viltenė;Aitvariukai;2026654467;Ne;0;6;0;6
13121;Viltenė;Aitvariukai;4641365031;Taip;7;7;0;14
13122;Viltenė;Aitvariukai;7277455268;Taip;0;14;0;14
13123;Viltenė;Aitvariukai;2786572522;Taip;0;3;0;3
13124;Viltenė;Aitvariukai;6171399579;Taip;0;3;0;3
13125;Viltenė;Geniukų;5604263567;Taip;0;5;0;5
13126;Viltenė;Geniukų;1822220265;Taip;15;0;0;15
13127;Viltenė;Geniukų;1423254631;Taip;0;11;0;11
13128;Viltenė;Geniukų;3002690526;Taip;3;3;0;6
13129;Viltenė;Geniukų;6276349499;Taip;0;1;0;1
13130;Viltenė;Geniukų;1054469254;Taip;0;1;0;1
13131;Viltenė;Geniukų;6063181025;Taip;0;1;0;1
13132;Viltenė;Geniukų;1672091332;Taip;0;1;0;1
13133;Viltenė;Geniukų;3018271511;Taip;0;6;0;6
13134;Viltenė;Geniukų;49998813869;Taip;2;1;0;3
13135;Viltenė;Geniukų;3389110405;Taip;0;3;0;3
13136;Viltenė;Geniukų;4319685140;Taip;3;3;0;6
13137;Viltenė;Geniukų;8125023386;Taip;0;3;0;3
13138;Viltenė;Geniukų;1629377078;Ne;4;3;0;7
13139;Viltenė;Geniukų;3746923185;Taip;0;8;0;8
13140;Viltenė;Geniukų;1557503831;Ne;0;3;0;3
13141;Viltenė;Saulutės;6848403057;Taip;0;3;0;3
13142;Viltenė;Saulutės;1615415742;Taip;0;6;0;6
13143;Viltenė;Saulutės;7994367286;Taip;7;2;0;9
13144;Viltenė;Saulutės;9935236068;Ne;0;2;0;2
13145;Viltenė;Saulutės;6664059418;Taip;0;3;0;3
13146;Viltenė;Saulutės;2141002432;Taip;0;6;0;6
13147;Viltenė;Saulutės;1362308882;Taip;0;1;0;1
13148;Viltenė;Saulutės;8920533673;Taip;6;1;0;7
13149;Viltenė;Saulutės;5024192785;Taip;0;5;0;5
13150;Viltenė;Saulutės;1918867591;Taip;0;8;0;8
13151;Viltenė;Saulutės;7559243300;Taip;0;8;0;8
13152;Viltenė;Saulutės;3560474943;Taip;0;8;0;8
13153;Viltenė;Saulutės;1252657362;Taip;0;1;2;3
13154;Viltenė;Saulutės;2559945034;Taip;0;3;0;3
13155;Viltenė;Saulutės;7726650894;Ne;0;4;0;4
13156;Viltenė;Saulutės;3709362712;Ne;0;3;0;3
13157;Viltenė;Saulutės;1841732416;Taip;0;3;0;3
13158;Viltenė;Lapiukų;2034259692;Taip;0;3;0;3
13159;Viltenė;Lapiukų;3473533533;Taip;0;2;0;2
13160;Viltenė;Lapiukų;8696698257;Taip;0;2;0;2
13161;Viltenė;Lapiukų;8248514570;Taip;0;3;0;3
13162;Viltenė;Lapiukų;2878124826;Taip;6;2;0;8
13163;Viltenė;Lapiukų;2660622296;Taip;0;3;0;3
13164;Viltenė;Lapiukų;4550915388;Ne;10;0;0;10
13165;Viltenė;Lapiukų;8122878153;Taip;0;11;0;11
13166;Viltenė;Lapiukų;9573891616;Taip;5;7;0;12
13167;Viltenė;Lapiukų;4243501722;Taip;4;2;0;6
13168;Viltenė;Lapiukų;6429905246;Taip;0;11;0;11
13169;Viltenė;Lapiukų;6070264006;Taip;4;4;0;8
13170;Viltenė;Lapiukų;8187712849;Taip;0;1;0;1
13171;Viltenė;Lapiukų;3679704404;Taip;0;8;0;8
13172;Viltenė;Lapiukų;1507287948;Taip;0;3;0;3
13173;Viltenė;Lapiukų;9846205631;Taip;10;0;0;10
13174;Viltenė;Lapiukų;9063994291;Taip;0;3;0;3
13175;Viltenė;Voveriukai;6888346135;Taip;6;3;0;9
13176;Viltenė;Voveriukai;2936670828;Ne;0;1;1;2
13177;Viltenė;Voveriukai;5816623708;Taip;19;0;1;20
13178;Viltenė;Voveriukai;5611839058;Taip;2;8;0;10
13179;Viltenė;Voveriukai;4030891958;Taip;0;1;0;1
13180;Viltenė;Voveriukai;4414192600;Taip;7;0;5;12
13181;Viltenė;Voveriukai;2483760198;Ne;5;0;0;5
13182;Viltenė;Voveriukai;8341211836;Taip;0;1;3;4
13183;Viltenė;Voveriukai;6954065006;Taip;0;1;3;4
13184;Viltenė;Voveriukai;6741521720;Taip;0;8;0;8
13185;Viltenė;Voveriukai;2642080849;Taip;9;0;0;9
13186;Viltenė;Voveriukai;6040634853;Taip;2;0;0;2
13187;Viltenė;Voveriukai;7322841332;Taip;8;1;0;9
13188;Viltenė;Voveriukai;1888167096;Taip;0;2;0;2
13189;Viltenė;Voveriukai;3291926243;Taip;0;6;0;6
13190;Viltenė;Voveriukai;2013415571;Taip;0;9;1;10
13191;Viltenė;Voveriukai;2894570917;Taip;0;4;0;4
13192;Viltenė;Kiškučiai;6595715908;Taip;10;1;0;11
13193;Viltenė;Kiškučiai;3347380524;Taip;7;2;0;9
13194;Viltenė;Kiškučiai;1641406030;Ne;0;3;0;3
13195;Viltenė;Kiškučiai;2192673126;Taip;16;0;0;16
13196;Viltenė;Kiškučiai;3157417614;Taip;15;0;0;15
13197;Viltenė;Kiškučiai;5974408492;Taip;6;0;0;6
13198;Viltenė;Kiškučiai;9578037239;Taip;9;0;0;9
13199;Viltenė;Kiškučiai;4615393852;Ne;0;8;0;8
13200;Viltenė;Kiškučiai;8091905944;Taip;0;6;0;6
13201;Viltenė;Kiškučiai;7314937470;Taip;6;1;0;7
13202;Viltenė;Kiškučiai;8150583354;Ne;11;0;0;11
13203;Viltenė;Kiškučiai;9760364123;Taip;7;0;0;7
13204;Viltenė;Kiškučiai;6021086235;Taip;9;0;0;9
13205;Viltenė;Kiškučiai;1760899500;Taip;5;0;0;5
13206;Viltenė;Kiškučiai;9862698928;Ne;13;0;0;13
13207;Viltenė;Nykštukų;7993258845;Ne;0;4;1;5
13208;Viltenė;Nykštukų;4981225829;Taip;13;8;0;21
13209;Viltenė;Nykštukų;9424773418;Taip;0;4;0;4
13210;Viltenė;Nykštukų;5677284428;Taip;9;0;0;9
13211;Viltenė;Nykštukų;3343045604;Taip;0;4;0;4
13212;Viltenė;Nykštukų;4537287677;Taip;14;0;0;14
13213;Viltenė;Nykštukų;3306285115;Taip;5;4;0;9
13214;Viltenė;Nykštukų;6992120038;Taip;0;3;2;5
13215;Viltenė;Nykštukų;7331321780;Taip;11;0;0;11
13216;Viltenė;Nykštukų;5707049797;Taip;10;0;0;10
13217;Viltenė;Nykštukų;3853518656;Taip;4;0;1;5
13218;Viltenė;Nykštukų;9288406881;Taip;2;0;0;2
13219;Viltenė;Nykštukų;7370710652;Taip;0;3;0;3
13220;Viltenė;Triušiukai;8346933997;Taip;0;1;0;1
13221;Viltenė;Triušiukai;9819729046;Ne;5;8;0;13
13222;Viltenė;Triušiukai;8258247750;Taip;8;0;0;8
13223;Viltenė;Triušiukai;6635474168;Taip;7;1;2;10
13224;Viltenė;Triušiukai;7754951374;Taip;0;0;3;3
13225;Viltenė;Triušiukai;7145240197;Taip;1;0;0;1
13226;Viltenė;Triušiukai;7058586628;Taip;0;13;0;13
13227;Viltenė;Triušiukai;7005219570;Ne;8;0;0;8
13228;Viltenė;Triušiukai;4552355700;Taip;0;0;4;4
13229;Viltenė;Triušiukai;2850146424;Taip;2;0;0;2
13230;Viltenė;Triušiukai;1318750938;Taip;0;5;0;5
13231;Voveraitė;ŽVIRBLIUKŲ;6684234832;Taip;0;1;13;14
13232;Voveraitė;ŽVIRBLIUKŲ;8119493388;Taip;0;1;2;3
13233;Voveraitė;ŽVIRBLIUKŲ;9715405072;Taip;1;2;0;3
13234;Voveraitė;ŽVIRBLIUKŲ;5804351872;Taip;0;2;3;5
13235;Voveraitė;ŽVIRBLIUKŲ;8925151080;Taip;3;0;0;3
13236;Voveraitė;ŽVIRBLIUKŲ;5510544648;Taip;0;9;0;9
13237;Voveraitė;ŽVIRBLIUKŲ;6959751328;Taip;3;2;1;6
13238;Voveraitė;ŽVIRBLIUKŲ;8803052781;Taip;0;4;0;4
13239;Voveraitė;ŽVIRBLIUKŲ;8257748589;Taip;0;4;0;4
13240;Voveraitė;ŽVIRBLIUKŲ;1522307865;Taip;0;0;1;1
13241;Voveraitė;ŽVIRBLIUKŲ;3811230983;Taip;0;6;6;12
13242;Voveraitė;ŽVIRBLIUKŲ;2142507659;Taip;5;0;2;7
13243;Voveraitė;ŽVIRBLIUKŲ;3247101840;Taip;15;0;2;17
13244;Voveraitė;ŽVIRBLIUKŲ;6643600680;Taip;2;0;3;5
13245;Voveraitė;ŽVIRBLIUKŲ;4460047281;Taip;15;0;0;15
13246;Voveraitė;ŽVIRBLIUKŲ;3877673172;Taip;0;1;0;1
13247;Voveraitė;ŽVIRBLIUKŲ;9117809080;Taip;0;5;1;6
13248;Voveraitė;ŽVIRBLIUKŲ;7861722125;Taip;4;7;0;11
13249;Voveraitė;ŽVIRBLIUKŲ;6994680282;Taip;0;3;3;6
13250;Voveraitė;VOVERIUKŲ;1515087924;Taip;8;3;0;11
13251;Voveraitė;VOVERIUKŲ;9195700962;Ne;12;9;0;21
13252;Voveraitė;VOVERIUKŲ;1340379090;Taip;0;6;0;6
13253;Voveraitė;VOVERIUKŲ;9912862474;Taip;1;2;0;3
13254;Voveraitė;VOVERIUKŲ;1960385335;Ne;9;0;0;9
13255;Voveraitė;VOVERIUKŲ;2594535017;Ne;10;1;0;11
13256;Voveraitė;VOVERIUKŲ;4563198733;Taip;0;4;0;4
13257;Voveraitė;VOVERIUKŲ;8373093305;Taip;0;3;0;3
13258;Voveraitė;VOVERIUKŲ;9514425475;Taip;0;4;0;4
13259;Voveraitė;VOVERIUKŲ;6017698476;Taip;0;3;0;3
13260;Voveraitė;VOVERIUKŲ;6891841301;Taip;0;9;0;9
13261;Voveraitė;VOVERIUKŲ;6007396459;Taip;8;1;0;9
13262;Voveraitė;VOVERIUKŲ;4054841724;Taip;1;7;0;8
13263;Voveraitė;VOVERIUKŲ;2304604061;Taip;6;12;0;18
13264;Voveraitė;VOVERIUKŲ;5956830012;Taip;5;2;0;7
13265;Voveraitė;VOVERIUKŲ;8344323109;Taip;10;2;0;12
13266;Voveraitė;VOVERIUKŲ;1141304286;Taip;1;6;0;7
13267;Voveraitė;VOVERIUKŲ;1663784931;Taip;0;6;0;6
13268;Voveraitė;VOVERIUKŲ;3276295199;Taip;3;8;0;11
13269;Voveraitė;KIŠKUČIŲ;4478984171;Taip;0;1;0;1
13270;Voveraitė;KIŠKUČIŲ;9011096222;Taip;17;2;0;19
13271;Voveraitė;KIŠKUČIŲ;3058377539;Taip;4;4;0;8
13272;Voveraitė;KIŠKUČIŲ;8507818993;Taip;10;1;0;11
13273;Voveraitė;KIŠKUČIŲ;8084986328;Taip;5;3;0;8
13274;Voveraitė;KIŠKUČIŲ;6261152304;Taip;23;0;0;23
13275;Voveraitė;KIŠKUČIŲ;8220437514;Taip;0;3;0;3
13276;Voveraitė;KIŠKUČIŲ;4060906360;Taip;0;3;0;3
13277;Voveraitė;KIŠKUČIŲ;5069929376;Taip;4;2;0;6
13278;Voveraitė;KIŠKUČIŲ;7379045686;Taip;0;4;0;4
13279;Voveraitė;KIŠKUČIŲ;1961699588;Taip;20;0;0;20
13280;Voveraitė;KIŠKUČIŲ;1979839656;Taip;9;0;0;9
13281;Voveraitė;KIŠKUČIŲ;9599137158;Taip;9;0;0;9
13282;Voveraitė;KIŠKUČIŲ;4379372200;Ne;5;0;0;5
13283;Voveraitė;KIŠKUČIŲ;8937070276;Taip;7;0;0;7
13284;Voveraitė;KIŠKUČIŲ;3859125174;Taip;23;0;0;23
13285;Voveraitė;KODĖLČIUKŲ;3274422598;Taip;8;6;1;15
13286;Voveraitė;KODĖLČIUKŲ;8438808999;Ne;2;0;0;2
13287;Voveraitė;KODĖLČIUKŲ;8818603905;Taip;11;0;0;11
13288;Voveraitė;KODĖLČIUKŲ;9397887760;Taip;0;2;1;3
13289;Voveraitė;KODĖLČIUKŲ;4151144278;Ne;3;1;0;4
13290;Voveraitė;KODĖLČIUKŲ;5598685365;Taip;0;7;0;7
13291;Voveraitė;KODĖLČIUKŲ;1482908802;Taip;5;0;0;5
13292;Voveraitė;KODĖLČIUKŲ;7605427741;Taip;0;1;0;1
13293;Voveraitė;KODĖLČIUKŲ;1046297151;Taip;0;3;1;4
13294;Voveraitė;KODĖLČIUKŲ;4996778855;Taip;0;3;2;5
13295;Voveraitė;KODĖLČIUKŲ;3432886020;Taip;14;1;0;15
13296;Voveraitė;KODĖLČIUKŲ;8154347030;Taip;0;3;0;3
13297;Voveraitė;KODĖLČIUKŲ;2482908027;Taip;0;11;0;11
13298;Voveraitė;KODĖLČIUKŲ;8692155848;Taip;0;0;9;9
13299;Voveraitė;KODĖLČIUKŲ;1040007977;Taip;0;2;0;2
13300;Voveraitė;KODĖLČIUKŲ;3881039538;Taip;8;1;3;12
13301;Voveraitė;KODĖLČIUKŲ;7281753415;Taip;8;1;3;12
13302;Voveraitė;KODĖLČIUKŲ;8021563060;Taip;0;5;0;5
13303;Voveraitė;KODĖLČIUKŲ;9816971493;Taip;0;1;2;3
13304;Voveraitė;MEŠKIUKŲ;8881070477;Taip;13;0;0;13
13305;Voveraitė;MEŠKIUKŲ;7253112849;Taip;4;9;0;13
13306;Voveraitė;MEŠKIUKŲ;7499150201;Taip;4;0;0;4
13307;Voveraitė;MEŠKIUKŲ;3217609712;Taip;3;5;0;8
13308;Voveraitė;MEŠKIUKŲ;3088866739;Taip;0;6;0;6
13309;Voveraitė;MEŠKIUKŲ;4207949414;Taip;0;6;0;6
13310;Voveraitė;MEŠKIUKŲ;4547087565;Taip;8;0;0;8
13311;Voveraitė;MEŠKIUKŲ;7474214701;Taip;5;7;0;12
13312;Voveraitė;MEŠKIUKŲ;6853358062;Taip;6;0;0;6
13313;Voveraitė;MEŠKIUKŲ;3539069705;Taip;4;0;0;4
13314;Voveraitė;MEŠKIUKŲ;9544043839;Taip;0;6;0;6
13315;Voveraitė;MEŠKIUKŲ;6609235703;Ne;0;5;0;5
13316;Voveraitė;MEŠKIUKŲ;1528968162;Ne;5;0;0;5
13317;Voveraitė;MEŠKIUKŲ;3159659638;Taip;5;6;0;11
13318;Voveraitė;MEŠKIUKŲ;3532178114;Taip;5;6;0;11
13319;Voveraitė;MEŠKIUKŲ;8992548689;Ne;5;4;0;9
13320;Voveraitė;MEŠKIUKŲ;1813440087;Taip;3;4;0;7
13321;Voveraitė;MEŠKIUKŲ;8534405352;Taip;17;0;0;17
13322;Voveraitė;MEŠKIUKŲ;5018335921;Taip;8;2;0;10
13323;Voveraitė;BORUŽĖLIŲ;3703062195;Taip;0;1;1;2
13324;Voveraitė;BORUŽĖLIŲ;3381417855;Taip;0;5;1;6
13325;Voveraitė;BORUŽĖLIŲ;5437283673;Taip;0;0;1;1
13326;Voveraitė;BORUŽĖLIŲ;3029983180;Taip;0;5;1;6
13327;Voveraitė;BORUŽĖLIŲ;5576058454;Taip;2;1;0;3
13328;Voveraitė;BORUŽĖLIŲ;7797966139;Taip;9;0;2;11
13329;Voveraitė;BORUŽĖLIŲ;4079618555;Taip;0;6;0;6
13330;Voveraitė;BORUŽĖLIŲ;6886337758;Taip;0;12;0;12
13331;Voveraitė;BORUŽĖLIŲ;1592633500;Taip;0;3;0;3
13332;Voveraitė;BORUŽĖLIŲ;1629942114;Taip;2;5;0;7
13333;Voveraitė;BORUŽĖLIŲ;3113780055;Taip;5;6;0;11
13334;Voveraitė;BORUŽĖLIŲ;9933037872;Ne;0;4;0;4
13335;Voveraitė;BORUŽĖLIŲ;65926130735;Taip;6;0;0;6
13336;Voveraitė;BORUŽĖLIŲ;6277010268;Taip;15;0;0;15
13337;Voveraitė;BORUŽĖLIŲ;2831224400;Taip;0;23;0;23
13338;Voveraitė;BORUŽĖLIŲ;2763656717;Taip;0;3;8;11
13339;Voveraitė;PELĖDŽIUKŲ;9491132884;Taip;3;0;0;3
13340;Voveraitė;PELĖDŽIUKŲ;1959958256;Ne;1;3;5;9
13341;Voveraitė;PELĖDŽIUKŲ;6649068571;Taip;0;1;0;1
13342;Voveraitė;PELĖDŽIUKŲ;9231751171;Taip;0;3;0;3
13343;Voveraitė;PELĖDŽIUKŲ;9007031372;Taip;0;4;0;4
13344;Voveraitė;PELĖDŽIUKŲ;6369860178;Taip;6;0;1;7
13345;Voveraitė;PELĖDŽIUKŲ;6433760749;Taip;0;1;0;1
13346;Voveraitė;PELĖDŽIUKŲ;6460834118;Taip;8;0;8;16
13347;Voveraitė;PELĖDŽIUKŲ;4338861332;Taip;0;5;0;5
13348;Voveraitė;PELĖDŽIUKŲ;7314148938;Taip;0;7;0;7
13349;Voveraitė;PELĖDŽIUKŲ;4511771924;Taip;0;7;0;7
13350;Voveraitė;PELĖDŽIUKŲ;602726070;Taip;0;4;0;4
13351;Voveraitė;PELĖDŽIUKŲ;4163635632;Taip;0;8;1;9
13352;Voveraitė;PELĖDŽIUKŲ;1397274691;Taip;0;6;0;6
13353;Voveraitė;DRUGELIŲ;1441921029;Taip;0;1;0;1
13354;Voveraitė;DRUGELIŲ;7531020548;Taip;3;2;0;5
13355;Voveraitė;DRUGELIŲ;4300235743;Taip;15;0;2;17
13356;Voveraitė;DRUGELIŲ;1510853268;Taip;0;15;0;15
13357;Voveraitė;DRUGELIŲ;3388547792;Taip;0;4;0;4
13358;Voveraitė;DRUGELIŲ;8719547570;Taip;15;2;0;17
13359;Voveraitė;DRUGELIŲ;3475601049;Taip;4;0;0;4
13360;Voveraitė;DRUGELIŲ;4017408873;Taip;0;3;1;4
13361;Voveraitė;DRUGELIŲ;7533728486;Taip;5;1;4;10
13362;Voveraitė;DRUGELIŲ;1550830434;Taip;0;7;4;11
13363;Voveraitė;DRUGELIŲ;5114768009;Taip;0;4;0;4
13364;Voveraitė;DRUGELIŲ;1045204378;Taip;8;0;0;8
13365;Voveraitė;DRUGELIŲ;4605007814;Taip;0;0;2;2
13366;Voveraitė;DRUGELIŲ;4911291891;Taip;3;2;10;15
13367;Voveraitė;DRUGELIŲ;4350450125;Taip;0;9;1;10
13368;Voveraitė;DRUGELIŲ;8913940646;Taip;0;1;0;1
13369;Voveraitė;DRUGELIŲ;1201270622;Taip;0;2;14;16
13370;Voveraitė;DRUGELIŲ;7238482039;Taip;3;0;12;15
13371;Voveraitė;DRUGELIŲ;8733354669;Taip;10;0;0;10
13372;Voveraitė;DRUGELIŲ;5605614222;Taip;0;14;1;15
13373;Voveraitė;NYKŠTUKŲ;6579193196;Ne;3;0;4;7
13374;Voveraitė;NYKŠTUKŲ;8940421826;Taip;10;5;0;15
13375;Voveraitė;NYKŠTUKŲ;9332936763;Taip;7;0;4;11
13376;Voveraitė;NYKŠTUKŲ;6206817227;Taip;12;0;1;13
13377;Voveraitė;NYKŠTUKŲ;8206634977;Taip;9;6;0;15
13378;Voveraitė;NYKŠTUKŲ;3068683904;Taip;15;0;5;20
13379;Voveraitė;NYKŠTUKŲ;3600230896;Taip;3;0;11;14
13380;Voveraitė;NYKŠTUKŲ;1294012085;Ne;4;7;2;13
13381;Voveraitė;NYKŠTUKŲ;9363490578;Taip;4;4;0;8
13382;Voveraitė;NYKŠTUKŲ;8217771158;Taip;0;2;0;2
13383;Voveraitė;NYKŠTUKŲ;3409709168;Taip;19;0;0;19
13384;Voveraitė;NYKŠTUKŲ;1318750938;Taip;5;0;0;5
13385;Voveraitė;NYKŠTUKŲ;1045121363;Taip;21;0;0;21
13386;Voveraitė;NYKŠTUKŲ;4430631207;Ne;15;2;0;17
13387;Voveraitė;NYKŠTUKŲ;4741175948;Ne;7;0;0;7
13388;Voveraitė;NYKŠTUKŲ;7652950762;Taip;17;0;0;17
13389;Voveraitė;NYKŠTUKŲ;6092848276;Ne;15;0;0;15
13390;Voveraitė;NYKŠTUKŲ;4533816630;Ne;8;2;0;10
13391;Voveraitė;NYKŠTUKŲ;1237440400;Ne;10;2;5;17
13392;Voveraitė;NYKŠTUKŲ;8664568879;Ne;10;0;0;10
13393;Voveraitė;GENIUKŲ;5467979968;Ne;0;10;0;10
13394;Voveraitė;GENIUKŲ;5296850349;Taip;0;2;0;2
13395;Voveraitė;GENIUKŲ;51213803814;Taip;0;5;1;6
13396;Voveraitė;GENIUKŲ;36749754999;Taip;0;4;0;4
13397;Voveraitė;GENIUKŲ;6819742525;Ne;5;2;1;8
13398;Voveraitė;GENIUKŲ;46205148458;Taip;0;3;0;3
13399;Voveraitė;GENIUKŲ;4045121781;Taip;0;4;0;4
13400;Voveraitė;GENIUKŲ;7786378018;Taip;0;4;0;4
13401;Voveraitė;GENIUKŲ;5449490074;Taip;0;5;13;18
13402;Voveraitė;GENIUKŲ;6690309946;Taip;0;1;0;1
13403;Voveraitė;GENIUKŲ;6653141009;Taip;0;7;8;15
13404;Voveraitė;GENIUKŲ;1772758517;Taip;0;2;1;3
13405;Voveraitė;LAPIUKŲ;1022606584;Taip;6;0;9;15
13406;Voveraitė;LAPIUKŲ;8894121428;Taip;6;0;9;15
13407;Voveraitė;LAPIUKŲ;8405238812;Taip;6;0;0;6
13408;Voveraitė;LAPIUKŲ;2552772063;Ne;0;0;3;3
13409;Voveraitė;LAPIUKŲ;8152541593;Taip;15;0;2;17
13410;Voveraitė;LAPIUKŲ;4891757467;Taip;0;0;16;16
13411;Voveraitė;LAPIUKŲ;9218074631;Taip;4;0;3;7
13412;Voveraitė;LAPIUKŲ;1921260351;Taip;0;0;1;1
13413;Voveraitė;LAPIUKŲ;9120975451;Taip;4;0;2;6
13414;Voveraitė;LAPIUKŲ;3452040361;Taip;11;1;1;13
13415;Voveraitė;LAPIUKŲ;8382950248;Taip;0;0;5;5
13416;Voveraitė;LAPIUKŲ;8695525951;Taip;5;0;3;8
13417;Voveraitė;LAPIUKŲ;6443288864;Taip;9;0;3;12
13418;Voveraitė;LAPIUKŲ;6650343917;Taip;0;2;2;4
13419;Voveraitė;EŽIUKŲ;7969862374;Taip;8;0;3;11
13420;Voveraitė;EŽIUKŲ;4233627593;Taip;4;0;1;5
13421;Voveraitė;EŽIUKŲ;2446269570;Taip;8;2;1;11
13422;Voveraitė;EŽIUKŲ;2761041681;Taip;10;0;0;10
13423;Voveraitė;EŽIUKŲ;8675606844;Taip;0;0;7;7
13424;Voveraitė;EŽIUKŲ;8229145014;Ne;2;0;1;3
13425;Voveraitė;EŽIUKŲ;3168493145;Taip;0;0;2;2
13426;Voveraitė;EŽIUKŲ;2118244290;Taip;0;0;2;2
13427;Voveraitė;EŽIUKŲ;1542869765;Taip;12;0;0;12
13428;Voveraitė;EŽIUKŲ;2755043670;Taip;7;0;0;7
13429;Voveraitė;EŽIUKŲ;3408126903;Taip;5;0;1;6
13430;Voveraitė;EŽIUKŲ;8627692360;Taip;0;0;1;1
13431;Voveraitė;EŽIUKŲ;7776716092;Taip;0;0;2;2
13432;"Trakų Vokė";Voveriukų;1252962923;Taip;5;0;0;5
13433;"Trakų Vokė";Voveriukų;6076083379;Taip;8;2;0;10
13434;"Trakų Vokė";Voveriukų;7656305410;Taip;0;0;2;2
13435;"Trakų Vokė";Voveriukų;5626732539;Taip;0;0;6;6
13436;"Trakų Vokė";Voveriukų;2163756512;Taip;8;0;0;8
13437;"Trakų Vokė";Voveriukų;7706665420;Taip;0;2;4;6
13438;"Trakų Vokė";Voveriukų;7346128036;Taip;0;0;3;3
13439;"Trakų Vokė";Voveriukų;2318712376;Taip;8;6;0;14
13440;"Trakų Vokė";Voveriukų;2812442474;Taip;9;0;1;10
13441;"Trakų Vokė";Voveriukų;7671121106;Taip;0;2;8;10
13442;"Trakų Vokė";Voveriukų;9140597911;Taip;5;0;4;9
13443;"Trakų Vokė";Voveriukų;5741852704;Taip;0;13;6;19
13444;"Trakų Vokė";Voveriukų;8636196544;Taip;0;3;7;10
13445;"Trakų Vokė";Voveriukų;1157451579;Taip;23;0;0;23
13446;"Trakų Vokė";Voveriukų;4516714702;Taip;7;0;0;7
13447;"Trakų Vokė";Voveriukų;7797516793;Taip;0;0;5;5
13448;"Trakų Vokė";Voveriukų;3445611475;Taip;23;0;0;23
13449;"Trakų Vokė";Boružėlių;3319243283;Taip;5;0;2;7
13450;"Trakų Vokė";Boružėlių;2516219363;Taip;0;0;6;6
13451;"Trakų Vokė";Boružėlių;7858812338;Taip;0;0;2;2
13452;"Trakų Vokė";Boružėlių;1088928094;Taip;0;0;3;3
13453;"Trakų Vokė";Boružėlių;6908913934;Taip;0;0;6;6
13454;"Trakų Vokė";Boružėlių;7909596435;Ne;0;2;0;2
13455;"Trakų Vokė";Boružėlių;6751625456;Taip;5;0;0;5
13456;"Trakų Vokė";Boružėlių;7752786907;Taip;15;0;3;18
13457;"Trakų Vokė";Boružėlių;2475068032;Ne;0;0;11;11
13458;"Trakų Vokė";Boružėlių;4601374629;Ne;0;5;0;5
13459;"Trakų Vokė";Boružėlių;4438127190;Ne;5;0;4;9
13460;"Trakų Vokė";Boružėlių;2388817616;Taip;0;0;1;1
13461;"Trakų Vokė";Boružėlių;9453317084;Taip;0;1;0;1
13462;"Trakų Vokė";Boružėlių;1080300137;Taip;5;1;0;6
13463;"Trakų Vokė";Boružėlių;2469340933;Taip;0;0;1;1
13464;"Trakų Vokė";Boružėlių;7318458282;Taip;0;1;0;1
13465;"Trakų Vokė";Boružėlių;6732422645;Taip;0;3;2;5
13466;"Trakų Vokė";Boružėlių;5338798362;Taip;7;0;5;12
13467;"Trakų Vokė";Boružėlių;3913623741;Taip;0;0;2;2
13468;"Trakų Vokė";Boružėlių;4014027030;Taip;0;8;1;9
13469;"Trakų Vokė";Boružėlių;7660240598;Taip;11;7;0;18
13470;"Trakų Vokė";KIŠKUČIŲ;9483709021;Taip;3;0;0;3
13471;"Trakų Vokė";KIŠKUČIŲ;2503382218;Taip;13;0;2;15
13472;"Trakų Vokė";KIŠKUČIŲ;8605461082;Taip;0;2;0;2
13473;"Trakų Vokė";KIŠKUČIŲ;6369848950;Ne;0;0;1;1
13474;"Trakų Vokė";KIŠKUČIŲ;4854440884;Taip;12;0;1;13
13475;"Trakų Vokė";KIŠKUČIŲ;2761614687;Taip;1;0;2;3
13476;"Trakų Vokė";KIŠKUČIŲ;9233090228;Taip;0;0;6;6
13477;"Trakų Vokė";KIŠKUČIŲ;1360046096;Taip;3;5;0;8
13478;"Trakų Vokė";KIŠKUČIŲ;3611639112;Taip;0;3;0;3
13479;"Trakų Vokė";KIŠKUČIŲ;3328527700;Taip;5;0;0;5
13480;"Trakų Vokė";KIŠKUČIŲ;2869217654;Taip;0;8;0;8
13481;"Trakų Vokė";KIŠKUČIŲ;4535167417;Taip;0;3;0;3
13482;"Trakų Vokė";KIŠKUČIŲ;2539647111;Taip;1;0;0;1
13483;"Trakų Vokė";KIŠKUČIŲ;3278842582;Ne;4;0;1;5
13484;"Trakų Vokė";KIŠKUČIŲ;8874384610;Taip;21;0;1;22
13485;"Trakų Vokė";KIŠKUČIŲ;2453791555;Ne;17;0;0;17
13486;"Trakų Vokė";KIŠKUČIŲ;9506008651;Taip;0;0;6;6
13487;"Trakų Vokė";BITUČIŲ;3686108421;Taip;10;0;2;12
13488;"Trakų Vokė";BITUČIŲ;3333979364;Taip;7;1;0;8
13489;"Trakų Vokė";BITUČIŲ;5810595458;Taip;0;2;0;2
13490;"Trakų Vokė";BITUČIŲ;8783922678;Taip;5;0;0;5
13491;"Trakų Vokė";BITUČIŲ;5031669549;Taip;0;3;0;3
13492;"Trakų Vokė";BITUČIŲ;8703806519;Taip;18;0;0;18
13493;"Trakų Vokė";BITUČIŲ;2133793458;Taip;0;0;3;3
13494;"Trakų Vokė";BITUČIŲ;3023545645;Taip;9;0;2;11
13495;"Trakų Vokė";BITUČIŲ;5720994041;Taip;5;0;1;6
13496;"Trakų Vokė";BITUČIŲ;6428645462;Taip;0;9;0;9
13497;"Trakų Vokė";BITUČIŲ;7459132887;Taip;18;0;0;18
13498;"Trakų Vokė";BITUČIŲ;9514298829;Taip;0;0;23;23
13499;"Trakų Vokė";BITUČIŲ;1808420447;Taip;2;0;0;2
13500;"Trakų Vokė";BITUČIŲ;3536227018;Taip;0;0;3;3
13501;"Trakų Vokė";BITUČIŲ;6787506848;Taip;2;1;0;3
13502;"Trakų Vokė";BITUČIŲ;1359519176;Taip;0;2;0;2
13503;"Trakų Vokė";BITUČIŲ;1039317931;Taip;10;0;5;15
13504;Zylutė;Katerok;8749296671;Taip;9;4;0;13
13505;Zylutė;Katerok;1621772702;Ne;8;1;0;9
13506;Zylutė;Katerok;4592825972;Taip;0;1;0;1
13507;Zylutė;Katerok;8747721198;Taip;15;0;0;15
13508;Zylutė;Katerok;8212030518;Taip;0;7;0;7
13509;Zylutė;Katerok;7706833089;Taip;11;6;0;17
13510;Zylutė;Katerok;3115223229;Ne;0;5;0;5
13511;Zylutė;Katerok;2968625045;Ne;4;0;2;6
13512;Zylutė;Katerok;3055559237;Taip;0;7;0;7
13513;Zylutė;Katerok;2792217953;Taip;0;3;0;3
13514;Zylutė;Katerok;5948147748;Ne;0;0;8;8
13515;Zylutė;Katerok;7851423851;Taip;0;6;0;6
13516;Zylutė;Katerok;2945894661;Taip;0;1;6;7
13517;Zylutė;Katerok;9986289837;Taip;10;1;0;11
13518;Zylutė;Katerok;1164530815;Taip;0;7;0;7
13519;Zylutė;Katerok;1423890598;Taip;5;0;0;5
13520;Zylutė;Katerok;8618778936;Taip;0;1;0;1
13521;Zylutė;"Vesole misiaki";9162232979;Taip;0;3;0;3
13522;Zylutė;"Vesole misiaki";9457457032;Taip;6;6;0;12
13523;Zylutė;"Vesole misiaki";4543822765;Taip;12;1;0;13
13524;Zylutė;"Vesole misiaki";4566817285;Taip;0;2;0;2
13525;Zylutė;"Vesole misiaki";9737308076;Taip;0;6;0;6
13526;Zylutė;"Vesole misiaki";5027134228;Ne;0;4;0;4
13527;Zylutė;"Vesole misiaki";5589330186;Taip;3;0;0;3
13528;Zylutė;"Vesole misiaki";3848401615;Taip;6;1;0;7
13529;Zylutė;"Vesole misiaki";2913504349;Taip;0;13;0;13
13530;Zylutė;"Vesole misiaki";6601967273;Taip;9;0;0;9
13531;Zylutė;"Vesole misiaki";2501761963;Taip;0;3;0;3
13532;Zylutė;"Vesole misiaki";6833822248;Ne;18;0;0;18
13533;Zylutė;"Vesole misiaki";3976277394;Ne;0;4;0;4
13534;Zylutė;"Vesole misiaki";2489898107;Taip;2;8;0;10
13535;Zylutė;"Vesole misiaki";2313423907;Taip;0;8;0;8
13536;Zylutė;NYKŠTUKAI;3371202491;Ne;5;0;2;7
13537;Zylutė;NYKŠTUKAI;8820121776;Taip;9;1;0;10
13538;Zylutė;NYKŠTUKAI;4611555689;Taip;0;0;1;1
13539;Zylutė;NYKŠTUKAI;1169490002;Taip;10;7;0;17
13540;Zylutė;NYKŠTUKAI;3994691080;Taip;6;0;0;6
13541;Zylutė;NYKŠTUKAI;4894611078;Taip;0;3;0;3
13542;Zylutė;NYKŠTUKAI;7648922403;Ne;0;2;0;2
13543;Zylutė;NYKŠTUKAI;2113594059;Taip;4;2;0;6
13544;Zylutė;NYKŠTUKAI;9615779237;Taip;0;1;0;1
13545;Zylutė;NYKŠTUKAI;2511658462;Ne;6;0;0;6
13546;Zylutė;Ručijok;5096881585;Ne;11;3;1;15
13547;Zylutė;Ručijok;3201966434;Ne;1;0;2;3
13548;Zylutė;Ručijok;4874246039;Taip;0;2;0;2
13549;Zylutė;Ručijok;3274885318;Taip;0;0;11;11
13550;Zylutė;Ručijok;6607670962;Taip;0;0;2;2
13551;Zylutė;Ručijok;5038936878;Taip;9;0;0;9
13552;Zylutė;Ručijok;2491905840;Ne;18;0;0;18
13553;Zylutė;Ručijok;7742044835;Taip;0;12;0;12
13554;Zylutė;Ručijok;5956114459;Taip;0;9;0;9
13555;Zylutė;Ručijok;6276017610;Taip;6;1;2;9
13556;Zylutė;Ručijok;3128535871;Taip;6;0;3;9
13557;Zylutė;Raduga;9325387975;Taip;0;11;0;11
13558;Zylutė;Raduga;6569135467;Taip;0;7;0;7
13559;Zylutė;Raduga;3117948118;Taip;0;0;11;11
13560;Zylutė;Raduga;2654794460;Taip;0;0;23;23
13561;Zylutė;Raduga;3943002728;Taip;10;0;0;10
13562;Zylutė;Raduga;4043810535;Taip;9;4;0;13
13563;Zylutė;Raduga;2107123106;Ne;7;7;0;14
13564;Zylutė;Raduga;7482740111;Taip;0;0;2;2
13565;Zylutė;Raduga;7824348276;Taip;12;0;0;12
13566;Zylutė;Raduga;4811667497;Ne;0;4;1;5
13567;Zylutė;Raduga;2681013154;Taip;15;1;0;16
13568;Zylutė;Raduga;6833030749;Taip;13;4;0;17
13569;Zylutė;Raduga;4493469560;Taip;0;0;8;8
13570;Zylutė;Raduga;3608920051;Taip;4;1;0;5
13571;Zylutė;Raduga;3059970035;Taip;0;4;0;4
13572;Zylutė;Raduga;5408157164;Taip;0;0;10;10
13573;Zylutė;Raduga;3780475392;Taip;0;10;0;10
13574;Zylutė;"Miki Maus";9159342804;Taip;9;2;0;11
13575;Zylutė;"Miki Maus";8023418946;Taip;0;6;0;6
13576;Zylutė;"Miki Maus";5369354390;Ne;5;11;0;16
13577;Zylutė;"Miki Maus";8121814945;Taip;5;0;0;5
13578;Zylutė;"Miki Maus";9507157625;Taip;11;0;0;11
13579;Zylutė;"Miki Maus";9018673580;Taip;6;0;0;6
13580;Zylutė;"Miki Maus";7762245887;Taip;13;0;0;13
13581;Zylutė;"Miki Maus";9213491152;Taip;5;0;0;5
13582;Zylutė;"Miki Maus";3928932787;Taip;9;0;0;9
13583;Zylutė;"Miki Maus";4057419108;Taip;0;11;0;11
13584;Zylutė;"Miki Maus";3668160578;Taip;0;7;0;7
13585;Zylutė;"Miki Maus";9093777086;Taip;0;3;0;3
13586;Zylutė;"Miki Maus";7123399601;Ne;3;12;0;15
13587;Zylutė;"Miki Maus";5975875502;Ne;11;2;0;13
13588;Zylutė;Solnyško;8379932761;Taip;5;4;0;9
13589;Zylutė;Solnyško;5556769710;Taip;0;0;1;1
13590;Zylutė;Solnyško;2088316489;Taip;0;4;0;4
13591;Zylutė;Solnyško;1076803315;Taip;0;1;0;1
13592;Zylutė;Solnyško;7616444695;Ne;0;1;2;3
13593;Zylutė;Solnyško;5234846079;Taip;4;0;0;4
13594;Zylutė;Solnyško;5939522435;Taip;0;6;0;6
13595;Zylutė;Solnyško;2117820453;Taip;0;1;0;1
13596;Zylutė;Solnyško;5826813410;Taip;0;7;0;7
13597;Zylutė;Solnyško;7447067072;Taip;0;3;2;5
13598;Zylutė;Solnyško;4669449744;Taip;0;10;0;10
13599;Zylutė;Solnyško;1969578486;Taip;4;0;0;4
13600;Zylutė;Solnyško;2520744071;Taip;0;0;6;6
13601;Zylutė;Motyliok;7241045507;Taip;9;0;0;9
13602;Zylutė;Motyliok;9913001904;Ne;3;3;0;6
13603;Zylutė;Motyliok;5891900062;Taip;0;7;0;7
13604;Zylutė;Motyliok;6112586092;Taip;0;4;0;4
13605;Zylutė;Motyliok;8178488164;Taip;6;0;0;6
13606;Zylutė;Motyliok;3547185618;Taip;0;3;0;3
13607;Zylutė;Motyliok;5045652581;Taip;3;9;0;12
13608;Zylutė;Motyliok;9586800176;Taip;10;2;0;12
13609;Zylutė;Motyliok;4497904128;Taip;0;9;0;9
13610;Zylutė;Motyliok;3355159275;Taip;0;5;0;5
13611;Zylutė;Motyliok;9995791665;Taip;20;1;0;21
13612;Zylutė;Motyliok;2654373943;Ne;9;0;0;9
13613;Zylutė;Motyliok;3455374127;Taip;11;6;0;17
13614;Zylutė;Motyliok;1632490481;Taip;7;3;0;10
13615;Zylutė;Motyliok;1726060015;Ne;12;0;0;12
13616;Zylutė;Motyliok;6051657134;Taip;0;3;0;3
13617;Zylutė;Motyliok;3271366684;Taip;13;0;0;13
13618;Zylutė;Motyliok;3633983359;Taip;16;0;0;16
13619;Zylutė;Motyliok;9155513221;Ne;0;3;0;3
13620;Zylutė;ŽVIRBLIUKAI;1319040747;Ne;5;3;4;12
13621;Zylutė;ŽVIRBLIUKAI;4394023057;Taip;5;2;0;7
13622;Zylutė;ŽVIRBLIUKAI;8326987895;Taip;0;4;0;4
13623;Zylutė;ŽVIRBLIUKAI;2364890732;Taip;0;0;15;15
13624;Zylutė;ŽVIRBLIUKAI;9150157724;Ne;3;0;0;3
13625;Zylutė;ŽVIRBLIUKAI;8268700439;Taip;0;3;7;10
13626;Zylutė;ŽVIRBLIUKAI;1220439948;Taip;13;3;0;16
13627;Zylutė;ŽVIRBLIUKAI;4646273830;Ne;5;0;0;5
13628;Zylutė;ŽVIRBLIUKAI;9580188426;Ne;8;0;0;8
13629;Zylutė;ŽVIRBLIUKAI;1797701777;Taip;0;1;1;2
13630;Zylutė;ŽVIRBLIUKAI;2966482773;Ne;0;2;0;2
13631;Zylutė;ŽVIRBLIUKAI;1452384017;Taip;8;0;0;8
13632;Zylutė;ŽVIRBLIUKAI;2697867000;Ne;5;1;0;6
13633;Zylutė;ŽVIRBLIUKAI;8262929231;Ne;5;0;2;7
13634;Zylutė;ŽVIRBLIUKAI;8152140523;Taip;0;0;5;5
13635;Zylutė;ŽVIRBLIUKAI;2061747513;Taip;9;0;5;14
13636;Zylutė;"DRUŽNYJE REBIATA";5332039406;Ne;17;0;0;17
13637;Zylutė;"DRUŽNYJE REBIATA";9039665233;Taip;0;2;0;2
13638;Zylutė;"DRUŽNYJE REBIATA";6075614020;Taip;11;4;0;15
13639;Zylutė;"DRUŽNYJE REBIATA";9518714240;Taip;0;7;0;7
13640;Zylutė;"DRUŽNYJE REBIATA";2693961315;Taip;13;0;0;13
13641;Zylutė;"DRUŽNYJE REBIATA";3372639449;Ne;16;0;0;16
13642;Zylutė;"DRUŽNYJE REBIATA";4916625058;Taip;0;7;0;7
13643;Zylutė;"DRUŽNYJE REBIATA";3447644735;Taip;7;6;0;13
13644;Zylutė;"DRUŽNYJE REBIATA";3174042441;Taip;0;2;0;2
13645;Zylutė;"DRUŽNYJE REBIATA";6848387941;Ne;10;6;0;16
13646;Zylutė;"DRUŽNYJE REBIATA";1404949829;Taip;12;0;0;12
13647;Zylutė;"DRUŽNYJE REBIATA";4548205666;Taip;23;0;0;23
13648;Zylutė;"DRUŽNYJE REBIATA";6962852787;Taip;23;0;0;23
13649;Zylutė;"DRUŽNYJE REBIATA";9220918504;Taip;23;0;0;23
13650;Zylutė;"DRUŽNYJE REBIATA";9193349264;Taip;11;0;0;11
13651;Zylutė;"DRUŽNYJE REBIATA";8204885376;Taip;4;0;0;4
13652;Zylutė;"DRUŽNYJE REBIATA";6281989117;Taip;0;5;0;5
13653;Zylutė;"DRUŽNYJE REBIATA";9769201088;Ne;0;9;0;9
13654;Zylutė;"DRUŽNYJE REBIATA";5233163416;Taip;0;3;0;3
13655;Zylutė;"DRUŽNYJE REBIATA";6784471792;Taip;12;3;0;15
13656;Zylutė;"DRUŽNYJE REBIATA";5126282685;Taip;5;2;0;7
13657;Zylutė;VIEVERSĖLIAI;2125519672;Taip;0;2;0;2
13658;Zylutė;VIEVERSĖLIAI;4505081448;Ne;12;0;0;12
13659;Zylutė;VIEVERSĖLIAI;72716975865;Taip;0;2;0;2
13660;Zylutė;VIEVERSĖLIAI;6275164528;Taip;0;1;0;1
13661;Zylutė;VIEVERSĖLIAI;5172154642;Taip;0;9;0;9
13662;Zylutė;VIEVERSĖLIAI;2943888466;Taip;0;2;0;2
13663;Zylutė;VIEVERSĖLIAI;6907378757;Taip;4;0;0;4
13664;Zylutė;VIEVERSĖLIAI;6723650872;Taip;5;0;0;5
13665;Zylutė;VIEVERSĖLIAI;4016518230;Taip;16;2;0;18
13666;Zylutė;VIEVERSĖLIAI;9660898505;Taip;0;14;0;14
13667;Zylutė;VIEVERSĖLIAI;5544338521;Taip;0;2;0;2
13668;Zylutė;VIEVERSĖLIAI;27488840113;Taip;0;1;0;1
13669;Zylutė;VIEVERSĖLIAI;5162635301;Taip;18;3;0;21
13670;Zylutė;VIEVERSĖLIAI;1939618217;Taip;3;1;0;4
13671;Zylutė;VIEVERSĖLIAI;1048279422;Taip;8;4;0;12
13672;Zylutė;VIEVERSĖLIAI;6548786007;Ne;5;1;0;6
13673;Zylutė;VIEVERSĖLIAI;4154010905;Taip;1;0;0;1
13674;Zylutė;VIEVERSĖLIAI;3074954453;Taip;0;3;0;3
13675;Želmenėliai;Bitučių;4681686872;Taip;0;5;0;5
13676;Želmenėliai;Bitučių;3268310531;Taip;0;12;0;12
13677;Želmenėliai;Bitučių;2122665619;Ne;3;5;0;8
13678;Želmenėliai;Bitučių;2563117992;Taip;7;0;0;7
13679;Želmenėliai;Bitučių;6799702725;Taip;5;2;0;7
13680;Želmenėliai;Bitučių;8358780570;Taip;0;4;0;4
13681;Želmenėliai;Bitučių;9006406225;Taip;0;4;0;4
13682;Želmenėliai;Bitučių;2102401372;Taip;0;3;1;4
13683;Želmenėliai;Bitučių;4931835807;Taip;4;3;0;7
13684;Želmenėliai;Bitučių;5147895081;Taip;0;3;0;3
13685;Želmenėliai;Bitučių;9611741258;Taip;12;0;0;12
13686;Želmenėliai;Bitučių;1619143702;Taip;14;1;0;15
13687;Želmenėliai;Bitučių;5314438217;Taip;0;6;0;6
13688;Želmenėliai;Bitučių;4927030144;Taip;15;3;0;18
13689;Želmenėliai;Bitučių;3739751121;Taip;8;2;0;10
13690;Želmenėliai;Bitučių;8028761330;Ne;9;3;0;12
13691;Želmenėliai;Bitučių;2853659708;Taip;20;0;0;20
13692;Želmenėliai;Bitučių;9207984505;Taip;0;8;0;8
13693;Želmenėliai;Kačiukų;1292462938;Taip;5;4;0;9
13694;Želmenėliai;Kačiukų;2350936740;Ne;5;2;0;7
13695;Želmenėliai;Kačiukų;3063417708;Taip;3;12;0;15
13696;Želmenėliai;Kačiukų;2570248893;Taip;5;1;0;6
13697;Želmenėliai;Kačiukų;2577850672;Taip;0;1;0;1
13698;Želmenėliai;Kačiukų;7197717698;Taip;23;0;0;23
13699;Želmenėliai;Kačiukų;7849682820;Taip;6;5;0;11
13700;Želmenėliai;Kačiukų;2111008869;Taip;8;0;1;9
13701;Želmenėliai;Kačiukų;4589396143;Taip;13;0;0;13
13702;Želmenėliai;Kačiukų;4198085732;Taip;8;0;0;8
13703;Želmenėliai;Kačiukų;6509783586;Taip;13;0;0;13
13704;Želmenėliai;Kačiukų;4126499046;Taip;0;9;0;9
13705;Želmenėliai;Kačiukų;4758240577;Taip;0;4;0;4
13706;Želmenėliai;Kačiukų;7094853897;Ne;13;0;0;13
13707;Želmenėliai;Kačiukų;9493581034;Taip;10;1;0;11
13708;Želmenėliai;Kačiukų;4931664953;Taip;10;2;0;12
13709;Želmenėliai;Kačiukų;4376978921;Taip;0;13;0;13
13710;Želmenėliai;Kačiukų;9313666706;Taip;12;0;0;12
13711;Želmenėliai;Kačiukų;8590129703;Taip;5;0;2;7
13712;Želmenėliai;Kačiukų;3959066963;Taip;0;3;6;9
13713;Želmenėliai;Kačiukų;6761848439;Taip;15;0;0;15
13714;Želmenėliai;Voveriukų;6343814445;Taip;0;2;0;2
13715;Želmenėliai;Voveriukų;7833143421;Taip;0;3;0;3
13716;Želmenėliai;Voveriukų;8418427863;Taip;6;1;0;7
13717;Želmenėliai;Voveriukų;5360157217;Taip;0;18;0;18
13718;Želmenėliai;Voveriukų;2545133678;Taip;10;0;0;10
13719;Želmenėliai;Voveriukų;7423900312;Taip;8;3;0;11
13720;Želmenėliai;Voveriukų;2025424742;Taip;3;0;0;3
13721;Želmenėliai;Voveriukų;4014238120;Taip;12;2;0;14
13722;Želmenėliai;Voveriukų;2924134152;Taip;10;1;2;13
13723;Želmenėliai;Voveriukų;6857922902;Taip;10;0;0;10
13724;Želmenėliai;Voveriukų;9811131936;Taip;11;0;0;11
13725;Želmenėliai;Voveriukų;8968533318;Taip;0;10;0;10
13726;Želmenėliai;Voveriukų;6264955603;Taip;9;0;0;9
13727;Želmenėliai;Voveriukų;8952421941;Taip;0;6;0;6
13728;Želmenėliai;Voveriukų;7345540758;Taip;10;0;0;10
13729;Želmenėliai;Voveriukų;9709599805;Taip;0;4;0;4
13730;Želmenėliai;Voveriukų;4248374729;Taip;13;3;0;16
13731;Želmenėliai;Ežiukų;1652131150;Taip;0;5;0;5
13732;Želmenėliai;Ežiukų;2311169187;Taip;5;1;0;6
13733;Želmenėliai;Ežiukų;3572462731;Taip;0;7;0;7
13734;Želmenėliai;Ežiukų;3353793939;Taip;4;3;0;7
13735;Želmenėliai;Ežiukų;7495157523;Taip;5;0;0;5
13736;Želmenėliai;Ežiukų;3972980949;Taip;0;9;0;9
13737;Želmenėliai;Ežiukų;6779746783;Taip;16;0;0;16
13738;Želmenėliai;Ežiukų;6876147546;Taip;0;6;0;6
13739;Želmenėliai;Ežiukų;9126715074;Ne;8;0;0;8
13740;Želmenėliai;Ežiukų;1260607572;Taip;0;1;0;1
13741;Želmenėliai;Ežiukų;5638248652;Taip;0;0;1;1
13742;Želmenėliai;Ežiukų;2296870749;Taip;3;0;2;5
13743;Želmenėliai;Ežiukų;6180553648;Taip;0;2;0;2
13744;Želmenėliai;Ežiukų;7294722095;Taip;8;6;0;14
13745;Želmenėliai;Ežiukų;4120125150;Taip;13;0;0;13
13746;Želmenėliai;Ežiukų;5281861477;Taip;0;9;0;9
13747;Želmenėliai;Ežiukų;8987377791;Taip;0;7;0;7
13748;Želmenėliai;Ežiukų;7373892344;Taip;5;1;0;6
13749;Želmenėliai;Peledžiukų;8491797555;Taip;20;3;0;23
13750;Želmenėliai;Peledžiukų;7058759730;Ne;0;1;0;1
13751;Želmenėliai;Peledžiukų;4485249321;Taip;0;13;0;13
13752;Želmenėliai;Peledžiukų;4374898642;Taip;5;0;0;5
13753;Želmenėliai;Peledžiukų;7751609462;Taip;8;1;0;9
13754;Želmenėliai;Peledžiukų;5929410363;Taip;9;1;0;10
13755;Želmenėliai;Peledžiukų;5205425589;Taip;9;0;0;9
13756;Želmenėliai;Peledžiukų;5362390260;Taip;8;3;0;11
13757;Želmenėliai;Peledžiukų;1580370689;Taip;0;5;0;5
13758;Želmenėliai;Peledžiukų;7672980212;Taip;12;4;0;16
13759;Želmenėliai;Peledžiukų;6260153299;Taip;0;1;0;1
13760;Želmenėliai;Peledžiukų;6187661667;Taip;10;2;0;12
13761;Želmenėliai;Peledžiukų;6109546917;Ne;0;23;0;23
13762;Želmenėliai;Peledžiukų;8118696261;Taip;8;7;0;15
13763;Želmenėliai;Peledžiukų;4746898209;Taip;0;8;0;8
13764;Želmenėliai;Peledžiukų;9929149682;Ne;5;6;1;12
13765;Želmenėliai;Peledžiukų;3723155757;Taip;0;13;0;13
13766;Želmenėliai;Peledžiukų;5401466574;Taip;6;4;0;10
13767;Želmenėliai;Drugelių;7664430346;Taip;0;4;0;4
13768;Želmenėliai;Drugelių;3417538909;Taip;0;3;0;3
13769;Želmenėliai;Drugelių;3295852546;Taip;0;4;0;4
13770;Želmenėliai;Drugelių;3379266015;Taip;5;10;0;15
13771;Želmenėliai;Drugelių;1984105453;Taip;17;1;1;19
13772;Želmenėliai;Drugelių;4652412483;Taip;0;11;0;11
13773;Želmenėliai;Drugelių;1652949383;Taip;0;1;0;1
13774;Želmenėliai;Drugelių;5046836398;Taip;9;3;0;12
13775;Želmenėliai;Drugelių;13558387807;Taip;0;4;0;4
13776;Želmenėliai;Drugelių;5143554665;Taip;5;6;0;11
13777;Želmenėliai;Drugelių;7585159351;Taip;5;12;0;17
13778;Želmenėliai;Drugelių;4634346755;Taip;0;4;0;4
13779;Želmenėliai;Drugelių;4916436238;Taip;0;1;0;1
13780;Želmenėliai;Drugelių;5558795651;Taip;10;2;0;12
13781;Želmenėliai;Voriukų;4264751761;Taip;5;3;0;8
13782;Želmenėliai;Voriukų;1203343580;Taip;0;4;0;4
13783;Želmenėliai;Voriukų;9351650342;Ne;0;1;0;1
13784;Želmenėliai;Voriukų;7563461821;Taip;0;3;0;3
13785;Želmenėliai;Voriukų;4534946646;Taip;10;0;0;10
13786;Želmenėliai;Voriukų;4075533071;Taip;0;4;0;4
13787;Želmenėliai;Voriukų;4545012342;Taip;0;15;0;15
13788;Želmenėliai;Voriukų;7505996978;Taip;0;9;0;9
13789;Želmenėliai;Voriukų;2722619508;Taip;0;11;0;11
13790;Želmenėliai;Voriukų;5025345647;Taip;0;11;0;11
13791;Želmenėliai;Voriukų;8892137326;Taip;0;2;0;2
13792;Želmenėliai;Voriukų;7700521261;Taip;0;8;0;8
13793;Želmenėliai;Voriukų;1649724696;Ne;0;4;0;4
13794;Želmenėliai;Voriukų;8206979332;Taip;7;0;0;7
13795;Želmenėliai;Boružėlių;1764468979;Taip;6;0;0;6
13796;Želmenėliai;Boružėlių;5161934903;Taip;0;2;0;2
13797;Želmenėliai;Boružėlių;8722573513;Taip;4;4;0;8
13798;Želmenėliai;Boružėlių;3516695805;Taip;0;10;0;10
13799;Želmenėliai;Boružėlių;5949535657;Taip;8;0;0;8
13800;Želmenėliai;Boružėlių;2262009049;Taip;0;2;0;2
13801;Želmenėliai;Boružėlių;3896171121;Taip;4;13;0;17
13802;Želmenėliai;Boružėlių;2951719129;Taip;0;5;0;5
13803;Želmenėliai;Boružėlių;2066439950;Taip;0;1;0;1
13804;Želmenėliai;Boružėlių;5207899503;Taip;10;8;0;18
13805;Želmenėliai;Boružėlių;2111705047;Taip;2;9;0;11
13806;Želmenėliai;Boružėlių;5514167627;Taip;16;1;0;17
13807;Želmenėliai;Boružėlių;2179165096;Ne;18;0;0;18
13808;Želmenėliai;Pūkuotukų;3258904017;Taip;0;3;0;3
13809;Želmenėliai;Pūkuotukų;8667865301;Taip;2;5;0;7
13810;Želmenėliai;Pūkuotukų;1952686295;Taip;2;4;0;6
13811;Želmenėliai;Pūkuotukų;5787772212;Taip;0;3;0;3
13812;Želmenėliai;Pūkuotukų;2727113833;Taip;10;3;0;13
13813;Želmenėliai;Pūkuotukų;9359070885;Taip;0;1;0;1
13814;Želmenėliai;Pūkuotukų;6816346946;Taip;0;1;0;1
13815;Želmenėliai;Pūkuotukų;37152467004;Taip;0;5;0;5
13816;Želmenėliai;Pūkuotukų;5842563754;Taip;0;8;0;8
13817;Želmenėliai;Pūkuotukų;1941723687;Taip;0;1;0;1
13818;Želmenėliai;Pūkuotukų;5616709457;Taip;0;1;0;1
13819;Želmenėliai;Pūkuotukų;4206128805;Taip;12;0;0;12
13820;Želmenėliai;Pūkuotukų;1248541555;Taip;5;5;0;10
13821;Želmenėliai;Pūkuotukų;8300887366;Taip;0;3;0;3
13822;Želmenėliai;Pūkuotukų;1582618217;Taip;0;3;0;3
13823;Želmenėliai;Ančiukų;4979494010;Taip;15;2;0;17
13824;Želmenėliai;Ančiukų;7925266303;Taip;10;7;0;17
13825;Želmenėliai;Ančiukų;8060048377;Taip;23;1;0;24
13826;Želmenėliai;Ančiukų;1606079948;Taip;5;8;0;13
13827;Želmenėliai;Ančiukų;9250666159;Taip;25;0;0;25
13828;Želmenėliai;Ančiukų;5569699398;Taip;25;0;0;25
13829;Želmenėliai;Ančiukų;3926238501;Taip;0;10;2;12
13830;Želmenėliai;Ančiukų;4207070475;Taip;1;1;2;4
13831;Želmenėliai;Ančiukų;8409831053;Taip;17;2;0;19
13832;Želmenėliai;Ančiukų;3608041516;Taip;0;4;0;4
13833;Želmenėliai;Ančiukų;5454656514;Taip;0;4;2;6
13834;Želmenėliai;Ančiukų;3172645969;Taip;23;1;0;24
13835;Želmenėliai;Ančiukų;7128213908;Taip;0;4;0;4
13836;Želmenėliai;Nykštukų;6230010537;Taip;5;6;0;11
13837;Želmenėliai;Nykštukų;4722890143;Taip;6;5;0;11
13838;Želmenėliai;Nykštukų;5052052744;Taip;7;1;0;8
13839;Želmenėliai;Nykštukų;6764567873;Taip;0;19;0;19
13840;Želmenėliai;Nykštukų;9901320882;Taip;0;0;1;1
13841;Želmenėliai;Nykštukų;4526936339;Taip;8;1;0;9
13842;Želmenėliai;Nykštukų;3232996198;Taip;10;0;0;10
13843;Želmenėliai;Nykštukų;2878494111;Taip;3;3;0;6
13844;Želmenėliai;Nykštukų;5169813205;Taip;11;0;0;11
13845;Želmenėliai;Nykštukų;7341132501;Taip;5;4;0;9
13846;Želmenėliai;Nykštukų;9661692350;Taip;10;3;0;13
13847;Želmenėliai;Nykštukų;7123290599;Taip;16;0;0;16
13848;Želmenėliai;Lašelių;8654298177;Taip;14;0;0;14
13849;Želmenėliai;Lašelių;4451798870;Taip;8;0;0;8
13850;Želmenėliai;Lašelių;4485851428;Taip;3;0;0;3
13851;Želmenėliai;Lašelių;4930868989;Taip;0;4;0;4
13852;Želmenėliai;Lašelių;2501163903;Taip;0;3;0;3
13853;Želmenėliai;Lašelių;3346680108;Taip;5;4;0;9
13854;Želmenėliai;Lašelių;4679930998;Taip;8;0;0;8
13855;Želmenėliai;Lašelių;3344426717;Taip;15;0;1;16
13856;Želmenėliai;Lašelių;9483665065;Taip;0;0;4;4
13857;Želmenėliai;Lašelių;9182208354;Taip;12;1;0;13
13858;Želmenėliai;Lašelių;8104790589;Taip;11;2;0;13
13859;Želmenėliai;Lašelių;9544233589;Taip;0;1;0;1
13860;Želmenėliai;Lašelių;3979635800;Taip;11;1;0;12
13861;Žemyna;Čiauškučiai;9985529041;Ne;6;9;0;15
13862;Žemyna;Čiauškučiai;9570187081;Ne;2;6;0;8
13863;Žemyna;Čiauškučiai;2547436771;Taip;0;9;0;9
13864;Žemyna;Čiauškučiai;6051208732;Taip;10;3;0;13
13865;Žemyna;Čiauškučiai;6346173832;Taip;11;0;1;12
13866;Žemyna;Čiauškučiai;8694608716;Taip;0;0;1;1
13867;Žemyna;Čiauškučiai;3074391266;Taip;0;0;4;4
13868;Žemyna;Čiauškučiai;1365045512;Taip;2;0;1;3
13869;Žemyna;Čiauškučiai;7620179886;Taip;0;2;0;2
13870;Žemyna;Čiauškučiai;2792702536;Taip;0;1;0;1
13871;Žemyna;Čiauškučiai;7376806308;Taip;0;1;0;1
13872;Žemyna;Čiauškučiai;7277970673;Taip;0;0;1;1
13873;Žemyna;Čiauškučiai;5069437469;Taip;0;3;1;4
13874;Žemyna;Čiauškučiai;7427119736;Taip;3;0;1;4
13875;Žemyna;Čiauškučiai;4642600915;Taip;3;0;0;3
13876;Žemyna;Čiauškučiai;2354265632;Taip;0;0;1;1
13877;Žemyna;Čiauškučiai;2887459684;Taip;5;3;4;12
13878;Žemyna;Čiauškučiai;1654157342;Taip;6;0;0;6
13879;Žemyna;Čiauškučiai;4652384557;Taip;8;0;0;8
13880;Žemyna;Čiauškučiai;7352868453;Taip;0;5;0;5
13881;Žemyna;Čiauškučiai;4501408683;Taip;2;2;0;4
13882;Žemyna;Čiauškučiai;4613946229;Taip;0;3;1;4
13883;Žemyna;Čiauškučiai;7675699775;Taip;2;2;0;4
13884;Žemyna;Nykštukai;5114094924;Taip;6;4;0;10
13885;Žemyna;Nykštukai;3874855308;Taip;0;0;2;2
13886;Žemyna;Nykštukai;2461700030;Taip;6;3;0;9
13887;Žemyna;Nykštukai;1725771976;Taip;0;0;4;4
13888;Žemyna;Nykštukai;3643594001;Taip;0;3;2;5
13889;Žemyna;Nykštukai;9182709647;Taip;0;2;0;2
13890;Žemyna;Nykštukai;7121742098;Taip;0;4;0;4
13891;Žemyna;Nykštukai;3519840747;Taip;0;1;0;1
13892;Žemyna;Nykštukai;4821941126;Taip;11;0;0;11
13893;Žemyna;Nykštukai;4322192775;Taip;12;0;0;12
13894;Žemyna;Nykštukai;4444870782;Taip;0;3;0;3
13895;Žemyna;Nykštukai;7781924111;Taip;2;3;0;5
13896;Žemyna;Nykštukai;2860210906;Taip;0;0;9;9
13897;Žemyna;Nykštukai;7832066079;Taip;0;4;0;4
13898;Žemyna;Nykštukai;9653530823;Taip;0;1;0;1
13899;Žemyna;Nykštukai;7508491119;Taip;2;3;0;5
13900;Žemyna;Nykštukai;1760568931;Ne;0;0;2;2
13901;Žemyna;Nykštukai;4524929331;Taip;0;3;0;3
13902;Žemyna;Nykštukai;4759403487;Taip;0;9;0;9
13903;Žemyna;Voveriukai;2141941712;Taip;8;0;0;8
13904;Žemyna;Voveriukai;9855080887;Taip;2;0;0;2
13905;Žemyna;Voveriukai;8525229514;Taip;5;2;0;7
13906;Žemyna;Voveriukai;1846287760;Ne;3;0;6;9
13907;Žemyna;Voveriukai;8775518984;Taip;5;1;1;7
13908;Žemyna;Voveriukai;5337086029;Taip;5;0;0;5
13909;Žemyna;Voveriukai;8926045231;Ne;7;4;1;12
13910;Žemyna;Voveriukai;3860791215;Taip;0;8;0;8
13911;Žemyna;Voveriukai;8185243991;Ne;11;0;0;11
13912;Žemyna;Voveriukai;9471382383;Taip;0;4;0;4
13913;Žemyna;Voveriukai;4549562657;Taip;9;1;0;10
13914;Žemyna;Voveriukai;8882641275;Taip;5;5;0;10
13915;Žemyna;Voveriukai;7121061078;Taip;1;2;0;3
13916;Žemyna;Voveriukai;4900914346;Taip;5;10;0;15
13917;Žemyna;Voveriukai;8241038433;Taip;13;4;0;17
13918;Žemyna;Voveriukai;5450351549;Taip;0;1;0;1
13919;Žemyna;Voveriukai;5189603013;Taip;4;0;0;4
13920;Žemyna;Voveriukai;3500358886;Ne;6;2;0;8
13921;Žemyna;Kiškučiai;8622780639;Ne;0;3;0;3
13922;Žemyna;Kiškučiai;1575505075;Taip;5;1;0;6
13923;Žemyna;Kiškučiai;7917100888;Taip;0;1;0;1
13924;Žemyna;Kiškučiai;39916867354;Taip;0;2;0;2
13925;Žemyna;Kiškučiai;4317779866;Taip;0;0;2;2
13926;Žemyna;Kiškučiai;7785889259;Taip;0;3;0;3
13927;Žemyna;Kiškučiai;6536698798;Taip;10;4;0;14
13928;Žemyna;Kiškučiai;8139714064;Taip;0;4;0;4
13929;Žemyna;Kiškučiai;2090395417;Taip;5;2;0;7
13930;Žemyna;Kiškučiai;3895238312;Ne;0;3;1;4
13931;Žemyna;Kiškučiai;4519502372;Taip;0;3;3;6
13932;Žemyna;Kiškučiai;1058705875;Taip;0;1;0;1
13933;Žemyna;Kiškučiai;5233574060;Taip;0;2;0;2
13934;Žemyna;Kiškučiai;15110117571;Taip;0;1;0;1
13935;Žemyna;Kiškučiai;9219519029;Taip;0;9;0;9
13936;Žemyna;Kiškučiai;3875204515;Taip;0;0;1;1
13937;Žemyna;Vyturiukai;2526949655;Taip;3;0;2;5
13938;Žemyna;Vyturiukai;1417007895;Taip;0;3;2;5
13939;Žemyna;Vyturiukai;1481273689;Taip;4;0;0;4
13940;Žemyna;Vyturiukai;7781332622;Taip;10;6;0;16
13941;Žemyna;Vyturiukai;1031171460;Taip;5;0;0;5
13942;Žemyna;Vyturiukai;5204349188;Taip;12;0;0;12
13943;Žemyna;Vyturiukai;1345704379;Taip;0;0;4;4
13944;Žemyna;Vyturiukai;6097681172;Taip;0;1;0;1
13945;Žemyna;Vyturiukai;5133115712;Taip;0;0;6;6
13946;Žemyna;Vyturiukai;5416338054;Taip;3;0;3;6
13947;Žemyna;Vyturiukai;3446774478;Taip;13;0;0;13
13948;Žemyna;Vyturiukai;6271057561;Taip;0;3;0;3
13949;Žemyna;Vyturiukai;2304633263;Taip;0;0;10;10
13950;Žemyna;Vyturiukai;7300819771;Taip;0;1;2;3
13951;Žemyna;Vyturiukai;3679990879;Taip;5;0;2;7
13952;Žemyna;Vyturiukai;8461326396;Taip;0;0;14;14
13953;Žemyna;Vyturiukai;8681308720;Taip;0;2;0;2
13954;Žemyna;Vyturiukai;8577299116;Taip;13;3;2;18
13955;Žemyna;Vyturiukai;9646494715;Taip;11;0;0;11
13956;Žemyna;Vyturiukai;4863350801;Taip;16;0;0;16
13957;Žemyna;Vyturiukai;5655302107;Taip;8;0;0;8
13958;Žemyna;Pelėdžiukai;8040359407;Ne;0;3;2;5
13959;Žemyna;Pelėdžiukai;37570629861;Taip;5;0;0;5
13960;Žemyna;Pelėdžiukai;55161890341;Taip;2;0;0;2
13961;Žemyna;Pelėdžiukai;59506345859;Taip;0;6;0;6
13962;Žemyna;Pelėdžiukai;85135645557;Taip;4;3;0;7
13963;Žemyna;Pelėdžiukai;38769607968;Taip;0;3;0;3
13964;Žemyna;Pelėdžiukai;4235160760;Taip;0;1;1;2
13965;Žemyna;Pelėdžiukai;3622634119;Taip;11;0;0;11
13966;Žemyna;Pelėdžiukai;5306392307;Taip;5;4;2;11
13967;Žemyna;Pelėdžiukai;5508251792;Taip;0;3;0;3
13968;Žemyna;Pelėdžiukai;8096035110;Ne;4;0;1;5
13969;Žemyna;Pelėdžiukai;1687206394;Taip;0;3;2;5
13970;Žemyna;Pelėdžiukai;93423088394;Taip;0;7;0;7
13971;Žemyna;Pelėdžiukai;5933910526;Taip;0;1;0;1
13972;Žemyna;Pelėdžiukai;5506889213;Taip;0;3;0;3
13973;Žemyna;Pelėdžiukai;5815116293;Taip;0;1;1;2
13974;Žemyna;Pelėdžiukai;13242930752;Taip;3;3;1;7
13975;Žemyna;Pelėdžiukai;89787441782;Taip;11;0;0;11
13976;Žemyna;Pelėdžiukai;9224203811;Taip;7;3;3;13
13977;Žemyna;Pelėdžiukai;2527337934;Taip;4;1;0;5
13978;Žemyna;Pelėdžiukai;1867198805;Ne;0;1;0;1
13979;Žemyna;Vijurkai;8500642069;Taip;5;3;4;12
13980;Žemyna;Vijurkai;9148594407;Taip;5;3;1;9
13981;Žemyna;Vijurkai;6701717634;Taip;5;0;0;5
13982;Žemyna;Vijurkai;7693278353;Taip;0;1;2;3
13983;Žemyna;Vijurkai;6430348135;Taip;0;2;0;2
13984;Žemyna;Vijurkai;2976467316;Taip;0;0;2;2
13985;Žemyna;Vijurkai;3357339710;Taip;6;2;0;8
13986;Žemyna;Vijurkai;5940619734;Taip;3;0;0;3
13987;Žemyna;Vijurkai;7925774308;Taip;0;1;1;2
13988;Žemyna;Vijurkai;9958040413;Taip;6;1;1;8
13989;Žemyna;Vijurkai;9866110744;Taip;0;0;1;1
13990;Žemyna;Vijurkai;2412956023;Taip;0;5;0;5
13991;Žemyna;Vijurkai;1114714466;Taip;0;1;0;1
13992;Žemyna;Vijurkai;1264659113;Taip;0;5;0;5
13993;Žemyna;Vijurkai;4410293832;Taip;0;0;8;8
13994;Žemyna;Vijurkai;1652681820;Ne;3;0;0;3
13995;Žemyna;Šnekučiai;9501126807;Taip;15;1;1;17
13996;Žemyna;Šnekučiai;6735720135;Taip;0;0;8;8
13997;Žemyna;Šnekučiai;9912869400;Taip;6;0;0;6
13998;Žemyna;Šnekučiai;2006173745;Taip;0;3;0;3
13999;Žemyna;Šnekučiai;7280740926;Taip;1;1;0;2
14000;Žemyna;Šnekučiai;6419974691;Taip;0;3;9;12
14001;Žemyna;Šnekučiai;9818711030;Ne;0;0;3;3
14002;Žemyna;Šnekučiai;3992383447;Taip;8;0;0;8
14003;Žemyna;Šnekučiai;6856737270;Taip;0;1;2;3
14004;Žemyna;Šnekučiai;5188496664;Taip;0;3;0;3
14005;Žemyna;Šnekučiai;4872348199;Taip;3;0;2;5
14006;Žemyna;Šnekučiai;6878669773;Taip;8;0;1;9
14007;Žemyna;Šnekučiai;4502958166;Taip;3;1;1;5
14008;Žemyna;Šnekučiai;6728229865;Taip;0;3;0;3
14009;Žemyna;Šnekučiai;2710551760;Taip;0;1;0;1
14010;Žemyna;Šnekučiai;4612112289;Taip;0;1;8;9
14011;Žemyna;Šnekučiai;9568886284;Taip;4;0;5;9
14012;Žemyna;Šnekučiai;3982766622;Taip;5;3;2;10
14013;Žemyna;Pabiručiai;9827401825;Taip;2;7;0;9
14014;Žemyna;Pabiručiai;5743535463;Taip;0;14;0;14
14015;Žemyna;Pabiručiai;6958537154;Taip;0;1;0;1
14016;Žemyna;Pabiručiai;7005045961;Taip;0;3;0;3
14017;Žemyna;Pabiručiai;1745197274;Taip;5;2;0;7
14018;Žemyna;Pabiručiai;6041223291;Taip;6;0;0;6
14019;Žemyna;Pabiručiai;8248443265;Taip;0;0;2;2
14020;Žemyna;Pabiručiai;7122276019;Taip;1;1;0;2
14021;Žemyna;Pabiručiai;9094718595;Ne;5;0;0;5
14022;Žemyna;Pabiručiai;6208953341;Taip;0;3;0;3
14023;Žemyna;Pabiručiai;1656335765;Taip;5;0;0;5
14024;Žemyna;Pabiručiai;5127174926;Taip;5;0;0;5
14025;Žemyna;Pabiručiai;8559870965;Taip;0;1;0;1
14026;Žemyna;Pabiručiai;1850100203;Taip;4;0;0;4
14027;Žemyna;Pabiručiai;2860232791;Taip;6;0;0;6
14028;Žemyna;Pabiručiai;4237778022;Taip;9;0;0;9
14029;Žemyna;Pabiručiai;2414400761;Taip;0;12;0;12
14030;Žemyna;Pabiručiai;9511935264;Taip;0;12;0;12
14031;Žemyna;Pabiručiai;4176386795;Taip;10;0;0;10
14032;Žemyna;Pabiručiai;3393414493;Taip;5;0;0;5
14033;Žemyna;Pabiručiai;4960936366;Ne;18;0;0;18
14034;Žemyna;Pabiručiai;2495616844;Taip;8;0;0;8
14035;Žemyna;Drugeliai;7564693757;Taip;0;2;0;2
14036;Žemyna;Drugeliai;8302345911;Taip;0;2;1;3
14037;Žemyna;Drugeliai;3505551915;Taip;5;0;9;14
14038;Žemyna;Drugeliai;2231967652;Taip;5;0;2;7
14039;Žemyna;Drugeliai;3755964840;Taip;9;3;0;12
14040;Žemyna;Drugeliai;9171823612;Taip;0;0;16;16
14041;Žemyna;Drugeliai;5518125715;Taip;0;0;3;3
14042;Žemyna;Drugeliai;9589582451;Taip;6;0;3;9
14043;Žemyna;Drugeliai;1279981170;Taip;10;0;0;10
14044;Žemyna;Drugeliai;2102920661;Taip;0;0;6;6
14045;Žemyna;Drugeliai;6575272457;Taip;0;0;2;2
14046;Žemyna;Drugeliai;6164541167;Taip;6;0;1;7
14047;Žemyna;Drugeliai;7461187735;Taip;2;0;1;3
14048;Žemyna;Drugeliai;3390442637;Taip;16;0;0;16
14049;Žemyna;Drugeliai;2371069183;Taip;8;0;0;8
14050;Žemyna;Drugeliai;2139103576;Taip;0;2;0;2
14051;Žemyna;Drugeliai;7920398415;Taip;0;3;0;3
14052;Žemyna;Drugeliai;1695063377;Taip;5;0;2;7
14053;Žemyna;Drugeliai;7745383607;Taip;8;0;0;8
14054;Žemyna;Drugeliai;7661182825;Taip;4;0;0;4
14055;Žemyna;Drugeliai;4861799571;Taip;6;0;0;6
14056;Žemyna;Drugeliai;7333722030;Taip;11;0;1;12
14057;Žemyna;Drugeliai;8709792653;Taip;14;1;0;15
14058;Žemyna;"ŽIRNIUKAI ";4540472310;Taip;20;3;0;23
14059;Žemyna;"ŽIRNIUKAI ";9647706055;Taip;5;0;6;11
14060;Žemyna;"ŽIRNIUKAI ";7537145330;Taip;18;0;0;18
14061;Žemyna;"ŽIRNIUKAI ";7683443675;Taip;18;0;0;18
14062;Žemyna;"ŽIRNIUKAI ";9796331127;Taip;5;0;0;5
14063;Žemyna;"ŽIRNIUKAI ";3996577758;Taip;5;0;6;11
14064;Žemyna;"ŽIRNIUKAI ";6783675344;Taip;23;0;0;23
14065;Žemyna;"ŽIRNIUKAI ";9082375371;Taip;23;0;0;23
14066;Žemyna;"ŽIRNIUKAI ";1795919515;Taip;5;1;4;10
14067;Žemyna;"ŽIRNIUKAI ";3899901920;Ne;10;8;0;18
14068;Žemyna;"ŽIRNIUKAI ";7831778620;Taip;6;5;0;11
14069;Žemyna;"ŽIRNIUKAI ";9692952139;Taip;0;2;0;2
14070;Žemyna;"ŽIOGELIAI ";2039344248;Taip;2;0;0;2
14071;Žemyna;"ŽIOGELIAI ";5968816137;Taip;8;0;2;10
14072;Žemyna;"ŽIOGELIAI ";4238528111;Taip;8;0;2;10
14073;Žemyna;"ŽIOGELIAI ";3741459808;Taip;8;0;2;10
14074;Žemyna;"ŽIOGELIAI ";3164469202;Taip;9;0;0;9
14075;Žemyna;"ŽIOGELIAI ";3870917221;Taip;10;0;0;10
14076;Žemyna;"ŽIOGELIAI ";6571952468;Taip;0;0;1;1
14077;Žemyna;"ŽIOGELIAI ";6632827240;Taip;18;0;0;18
14078;Žemyna;"ŽIOGELIAI ";3935318882;Taip;10;1;0;11
14079;Žemyna;"ŽIOGELIAI ";2010676445;Taip;10;1;0;11
14080;Žemyna;"ŽIOGELIAI ";1581399038;Taip;5;0;1;6
14081;Žemyna;"ŽIOGELIAI ";8965185578;Taip;3;0;0;3
14082;Žemyna;"ŽIOGELIAI ";8611258788;Taip;9;0;3;12
14083;Žemyna;"ŽIOGELIAI ";6592356004;Taip;20;0;1;21
14084;Žemyna;"ŽIOGELIAI ";9788890112;Taip;22;0;0;22
14085;Žemuogėlė;Boružiukai;1350671777;Taip;9;0;0;9
14086;Žemuogėlė;Boružiukai;9344628661;Taip;0;3;0;3
14087;Žemuogėlė;Boružiukai;2158359435;Ne;24;0;1;25
14088;Žemuogėlė;Boružiukai;1639634300;Taip;6;1;2;9
14089;Žemuogėlė;Boružiukai;5521993938;Taip;9;0;2;11
14090;Žemuogėlė;Boružiukai;1267222057;Taip;5;2;0;7
14091;Žemuogėlė;Boružiukai;9562512849;Taip;6;5;0;11
14092;Žemuogėlė;Boružiukai;8661864424;Taip;0;3;0;3
14093;Žemuogėlė;Boružiukai;5427045039;Taip;14;0;3;17
14094;Žemuogėlė;Boružiukai;1150466286;Taip;6;0;0;6
14095;Žemuogėlė;Boružiukai;8040255583;Taip;0;5;0;5
14096;Žemuogėlė;Boružiukai;2190458676;Ne;5;1;0;6
14097;Žemuogėlė;Boružiukai;6073591450;Taip;0;9;0;9
14098;Žemuogėlė;Boružiukai;7328566035;Taip;0;0;1;1
14099;Žemuogėlė;Boružiukai;8557325116;Taip;0;4;0;4
14100;Žemuogėlė;Boružiukai;1350383125;Taip;0;0;6;6
14101;Žemuogėlė;Boružiukai;7050896262;Taip;9;1;0;10
14102;Žemuogėlė;Boružiukai;3413805578;Taip;3;0;1;4
14103;Žemuogėlė;Boružiukai;1187953952;Taip;0;0;1;1
14104;Žemuogėlė;Boružiukai;3677459716;Taip;15;6;0;21
14105;Žemuogėlė;Boružiukai;8426601160;Taip;9;0;1;10
14106;Žemuogėlė;Boružiukai;5911215640;Taip;0;1;7;8
14107;Žemuogėlė;Šviesuliukai;3837424301;Taip;10;3;0;13
14108;Žemuogėlė;Šviesuliukai;5499401648;Taip;4;2;0;6
14109;Žemuogėlė;Šviesuliukai;3746045950;Taip;0;12;0;12
14110;Žemuogėlė;Šviesuliukai;4663181188;Taip;11;0;0;11
14111;Žemuogėlė;Šviesuliukai;8492878852;Taip;20;0;0;20
14112;Žemuogėlė;Šviesuliukai;7603740057;Taip;17;1;0;18
14113;Žemuogėlė;Šviesuliukai;6755278376;Ne;10;9;0;19
14114;Žemuogėlė;Šviesuliukai;4506847669;Taip;14;2;0;16
14115;Žemuogėlė;Šviesuliukai;7708949381;Taip;14;0;0;14
14116;Žemuogėlė;Šviesuliukai;7837251012;Taip;3;0;0;3
14117;Žemuogėlė;Šviesuliukai;7189855370;Taip;0;11;0;11
14118;Žemuogėlė;Šviesuliukai;3801534195;Taip;27;0;0;27
14119;Žemuogėlė;Šviesuliukai;1341637008;Taip;8;10;0;18
14120;Žemuogėlė;Šviesuliukai;8890454460;Taip;14;4;0;18
14121;Žemuogėlė;Šviesuliukai;7288060676;Taip;26;0;0;26
14122;Žemuogėlė;Šviesuliukai;6086270618;Taip;0;1;0;1
14123;Žemuogėlė;Lašiukai;1251497003;Taip;0;2;0;2
14124;Žemuogėlė;Lašiukai;3706531223;Taip;7;1;0;8
14125;Žemuogėlė;Lašiukai;8029484123;Taip;3;0;0;3
14126;Žemuogėlė;Lašiukai;5992802843;Taip;3;4;0;7
14127;Žemuogėlė;Lašiukai;3753156044;Taip;7;0;0;7
14128;Žemuogėlė;Lašiukai;4565097904;Taip;0;12;0;12
14129;Žemuogėlė;Lašiukai;7592566602;Taip;5;0;1;6
14130;Žemuogėlė;Lašiukai;1555899448;Taip;0;3;1;4
14131;Žemuogėlė;Lašiukai;1953538445;Taip;7;0;2;9
14132;Žemuogėlė;Lašiukai;8644564820;Taip;9;1;0;10
14133;Žemuogėlė;Lašiukai;3546429231;Taip;9;5;0;14
14134;Žemuogėlė;Lašiukai;7137182934;Taip;0;6;2;8
14135;Žemuogėlė;Lašiukai;3073956225;Taip;16;1;0;17
14136;Žemuogėlė;Lašiukai;9693814425;Taip;8;0;0;8
14137;Žemuogėlė;Lašiukai;3825509486;Taip;9;4;0;13
14138;Žemuogėlė;Lašiukai;4933948491;Taip;0;9;0;9
14139;Žemuogėlė;Lašiukai;3059525247;Taip;14;1;0;15
14140;Žemuogėlė;Lašiukai;6747566307;Taip;5;4;0;9
14141;Žemuogėlė;Lašiukai;2115883173;Taip;22;0;0;22
14142;Žemuogėlė;Skambaliukai;54663750186;Taip;0;4;0;4
14143;Žemuogėlė;Skambaliukai;4231767115;Taip;6;3;0;9
14144;Žemuogėlė;Skambaliukai;3977351017;Taip;0;2;0;2
14145;Žemuogėlė;Skambaliukai;3854265246;Taip;4;3;0;7
14146;Žemuogėlė;Skambaliukai;5147617128;Taip;3;13;0;16
14147;Žemuogėlė;Skambaliukai;1058207935;Taip;0;5;0;5
14148;Žemuogėlė;Skambaliukai;1628749648;Taip;10;0;1;11
14149;Žemuogėlė;Skambaliukai;6962103028;Taip;0;5;0;5
14150;Žemuogėlė;Skambaliukai;7714826773;Taip;0;10;0;10
14151;Žemuogėlė;Skambaliukai;3134493860;Taip;0;5;0;5
14152;Žemuogėlė;Skambaliukai;1907004376;Taip;0;2;0;2
14153;Žemuogėlė;Skambaliukai;38870047353;Taip;5;0;0;5
14154;Žemuogėlė;Skambaliukai;7403172794;Taip;10;5;0;15
14155;Žemuogėlė;Skambaliukai;9315711142;Taip;7;1;0;8
14156;Žemuogėlė;Skambaliukai;2102057496;Taip;0;5;0;5
14157;Žemuogėlė;Skambaliukai;4421397490;Taip;0;6;0;6
14158;Žemuogėlė;Skambaliukai;94792383091;Taip;5;13;2;20
14159;Žemuogėlė;Spinduliukai;3411390558;Taip;0;5;0;5
14160;Žemuogėlė;Spinduliukai;9955429241;Taip;0;0;2;2
14161;Žemuogėlė;Spinduliukai;5971652934;Taip;0;17;0;17
14162;Žemuogėlė;Spinduliukai;5127370193;Taip;5;0;2;7
14163;Žemuogėlė;Spinduliukai;1049009199;Taip;0;16;0;16
14164;Žemuogėlė;Spinduliukai;4578291476;Taip;16;0;4;20
14165;Žemuogėlė;Spinduliukai;5126348190;Ne;9;4;0;13
14166;Žemuogėlė;Spinduliukai;9534937419;Taip;0;1;0;1
14167;Žemuogėlė;Spinduliukai;2481547868;Taip;0;9;0;9
14168;Žemuogėlė;Spinduliukai;3612833383;Taip;10;0;0;10
14169;Žemuogėlė;Spinduliukai;9689082202;Taip;3;1;0;4
14170;Žemuogėlė;Spinduliukai;6707522989;Taip;5;7;0;12
14171;Žemuogėlė;Spinduliukai;6059069293;Taip;0;12;0;12
14172;Žemuogėlė;Spinduliukai;5770044886;Taip;6;7;1;14
14173;Žemuogėlė;Spinduliukai;7669457695;Ne;0;1;4;5
14174;Žemuogėlė;Spinduliukai;8675089149;Taip;0;4;0;4
14175;Žemuogėlė;Perliukai;4629107942;Ne;14;6;0;20
14176;Žemuogėlė;Perliukai;1306065826;Taip;3;1;0;4
14177;Žemuogėlė;Perliukai;5505719625;Taip;0;1;0;1
14178;Žemuogėlė;Perliukai;8106709288;Taip;0;9;0;9
14179;Žemuogėlė;Perliukai;2664267604;Taip;19;0;0;19
14180;Žemuogėlė;Perliukai;7794377881;Ne;2;7;1;10
14181;Žemuogėlė;Perliukai;1658954821;Taip;0;7;0;7
14182;Žemuogėlė;Perliukai;4698671798;Taip;2;0;0;2
14183;Žemuogėlė;Perliukai;2922827304;Taip;3;5;0;8
14184;Žemuogėlė;Perliukai;7415364637;Taip;4;0;0;4
14185;Žemuogėlė;Perliukai;3710681463;Taip;13;0;0;13
14186;Žemuogėlė;Perliukai;1796489729;Taip;9;2;0;11
14187;Žemuogėlė;Perliukai;8215763877;Taip;18;0;0;18
14188;Žemuogėlė;Perliukai;2934225120;Ne;15;1;0;16
14189;Žemuogėlė;Perliukai;3426685084;Ne;14;5;0;19
14190;Žemuogėlė;Perliukai;9150335499;Taip;6;1;0;7
14191;Žemuogėlė;Perliukai;1079114347;Taip;29;0;0;29
14192;Žemuogėlė;Perliukai;5902241163;Ne;0;2;0;2
14193;Žemuogėlė;Perliukai;7879519193;Taip;3;2;0;5
14194;Žemuogėlė;Perliukai;2109195565;Taip;5;2;1;8
14195;Žemuogėlė;Drugeliai;2745609317;Taip;4;0;4;8
14196;Žemuogėlė;Drugeliai;9694133286;Taip;4;0;0;4
14197;Žemuogėlė;Drugeliai;5557409350;Taip;12;9;0;21
14198;Žemuogėlė;Drugeliai;7668200447;Taip;0;2;0;2
14199;Žemuogėlė;Drugeliai;7148244029;Taip;0;1;0;1
14200;Žemuogėlė;Drugeliai;1901423257;Taip;3;6;0;9
14201;Žemuogėlė;Drugeliai;4862145385;Taip;10;8;0;18
14202;Žemuogėlė;Drugeliai;4368183799;Taip;0;3;0;3
14203;Žemuogėlė;Drugeliai;9902953729;Taip;16;7;0;23
14204;Žemuogėlė;Drugeliai;9537297860;Taip;0;9;0;9
14205;Žemuogėlė;Drugeliai;5170205929;Taip;11;2;0;13
14206;Žemuogėlė;Drugeliai;2428043195;Taip;6;0;1;7
14207;Žemuogėlė;Drugeliai;1716114524;Taip;15;0;0;15
14208;Žemuogėlė;Drugeliai;8137567729;Taip;17;7;0;24
14209;Žemuogėlė;Drugeliai;8348185761;Taip;14;6;0;20
14210;Žemuogėlė;Drugeliai;9273896998;Taip;0;4;0;4
14211;Žemuogėlė;"VIEVERSIUKAI ";8048818368;Taip;9;0;1;10
14212;Žemuogėlė;"VIEVERSIUKAI ";6577040746;Taip;14;0;0;14
14213;Žemuogėlė;"VIEVERSIUKAI ";9872387354;Taip;8;0;2;10
14214;Žemuogėlė;"VIEVERSIUKAI ";5300388726;Taip;2;4;0;6
14215;Žemuogėlė;"VIEVERSIUKAI ";7823828526;Taip;9;0;0;9
14216;Žemuogėlė;"VIEVERSIUKAI ";6379837644;Taip;0;1;0;1
14217;Žemuogėlė;"VIEVERSIUKAI ";3104276726;Taip;15;0;0;15
14218;Žemuogėlė;"VIEVERSIUKAI ";3419907292;Taip;17;0;1;18
14219;Žemuogėlė;"VIEVERSIUKAI ";7323868051;Taip;4;3;1;8
14220;Žemuogėlė;"VIEVERSIUKAI ";2800160529;Taip;11;3;0;14
14221;Žemuogėlė;"VIEVERSIUKAI ";8934779062;Taip;0;1;0;1
14222;Žemuogėlė;"VIEVERSIUKAI ";3090630899;Taip;0;2;0;2
14223;Žemuogėlė;"VIEVERSIUKAI ";8091000121;Taip;0;1;0;1
14224;Žemuogėlė;"VIEVERSIUKAI ";2110963483;Taip;25;2;0;27
14225;Žemuogėlė;"VIEVERSIUKAI ";7491809175;Taip;0;1;0;1
14226;Žemuogėlė;"NYKŠTUKAI ";1002937953;Taip;0;4;0;4
14227;Žemuogėlė;"NYKŠTUKAI ";6504659145;Ne;0;2;0;2
14228;Žemuogėlė;"NYKŠTUKAI ";3505090532;Taip;19;0;0;19
14229;Žemuogėlė;"NYKŠTUKAI ";5208043522;Ne;15;0;0;15
14230;Žemuogėlė;"NYKŠTUKAI ";3740127955;Taip;2;0;2;4
14231;Žemuogėlė;"NYKŠTUKAI ";5614510812;Taip;26;1;0;27
14232;Žemuogėlė;"NYKŠTUKAI ";9584172565;Ne;15;0;0;15
14233;Žemuogėlė;"NYKŠTUKAI ";8706379207;Taip;15;0;0;15
14234;Žemuogėlė;"NYKŠTUKAI ";1790341419;Ne;3;1;1;5
14235;Žemuogėlė;"NYKŠTUKAI ";4998981337;Taip;0;4;0;4
14236;Žemuogėlė;"NYKŠTUKAI ";6045257180;Taip;4;4;0;8
14237;Žemuogėlė;"NYKŠTUKAI ";8301927361;Taip;9;0;0;9
14238;Žemuogėlė;"NYKŠTUKAI ";2496321184;Taip;16;1;0;17
14239;Žemuogėlė;"NYKŠTUKAI ";8490643028;Taip;2;0;0;2
14240;Žemuogėlė;"NYKŠTUKAI ";2139102266;Taip;8;5;0;13
14241;Žemuogėlė;"NYKŠTUKAI ";9735379466;Taip;16;0;0;16
14242;Žemuogėlė;KIŠKUČIAI;4654060157;Taip;0;2;0;2
14243;Žemuogėlė;KIŠKUČIAI;2652630375;Taip;0;1;0;1
14244;Žemuogėlė;KIŠKUČIAI;1250186598;Taip;0;2;5;7
14245;Žemuogėlė;KIŠKUČIAI;3287415964;Ne;3;0;0;3
14246;Žemuogėlė;KIŠKUČIAI;5094867109;Taip;3;21;0;24
14247;Žemuogėlė;KIŠKUČIAI;5186248897;Taip;3;1;0;4
14248;Žemuogėlė;KIŠKUČIAI;5125826172;Taip;11;4;0;15
14249;Žemuogėlė;KIŠKUČIAI;8262862183;Taip;2;1;0;3
14250;Žemuogėlė;KIŠKUČIAI;1280794094;Taip;0;1;0;1
14251;Žemuogėlė;KIŠKUČIAI;2251142510;Taip;0;1;0;1
14252;Žemuogėlė;KIŠKUČIAI;4974793430;Taip;7;0;2;9
14253;Žemuogėlė;KIŠKUČIAI;6659616731;Taip;0;1;0;1
14254;Žemuogėlė;KIŠKUČIAI;3459960812;Taip;1;0;0;1
14255;Žemuogėlė;Žiniukai;7804015060;Taip;10;6;0;16
14256;Žemuogėlė;Žiniukai;3765022476;Taip;0;2;0;2
14257;Žemuogėlė;Žiniukai;9476688736;Taip;1;4;0;5
14258;Žemuogėlė;Žiniukai;2001471529;Taip;0;1;0;1
14259;Žemuogėlė;Žiniukai;9519563708;Ne;0;3;0;3
14260;Žemuogėlė;Žiniukai;2841634296;Taip;0;6;1;7
14261;Žemuogėlė;Žiniukai;3237083654;Taip;0;3;0;3
14262;Žemuogėlė;Žiniukai;9693894254;Ne;0;11;0;11
14263;Žemuogėlė;Žiniukai;9378432383;Taip;0;4;0;4
14264;Žemuogėlė;Žiniukai;6073971598;Taip;4;2;1;7
14265;Žemuogėlė;Žiniukai;6913038845;Taip;5;3;0;8
14266;Žemuogėlė;Žiniukai;6581889641;Taip;0;4;0;4
14267;Žemuogėlė;Žiniukai;2555902309;Taip;10;3;0;13
14268;Žemuogėlė;Žiniukai;8757701456;Taip;6;2;5;13
14269;Žemuogėlė;Žiniukai;2132549536;Taip;0;9;0;9
14270;Žemuogėlė;Žiniukai;5532053268;Taip;0;1;0;1
14271;Žemuogėlė;Žiniukai;8496353410;Taip;0;4;0;4
14272;Žemuogėlė;Žiniukai;1733808230;Taip;0;5;0;5
14273;Žemuogėlė;Žiniukai;4660479216;Taip;10;0;2;12
14274;Žemuogėlė;Žiniukai;1469759840;Taip;0;2;0;2
14275;Žibutė;PELĖDŽIUKAI;3496675605;Taip;0;11;0;11
14276;Žibutė;PELĖDŽIUKAI;2361682400;Taip;0;3;2;5
14277;Žibutė;PELĖDŽIUKAI;1826763192;Taip;0;1;0;1
14278;Žibutė;PELĖDŽIUKAI;3826875107;Ne;7;4;0;11
14279;Žibutė;PELĖDŽIUKAI;3186792146;Taip;4;0;3;7
14280;Žibutė;PELĖDŽIUKAI;7344095020;Taip;6;0;3;9
14281;Žibutė;PELĖDŽIUKAI;1078105287;Taip;0;7;0;7
14282;Žibutė;PELĖDŽIUKAI;2152452830;Taip;1;0;0;1
14283;Žibutė;PELĖDŽIUKAI;2236930916;Taip;0;8;1;9
14284;Žibutė;PELĖDŽIUKAI;7095870173;Taip;0;1;0;1
14285;Žibutė;PELĖDŽIUKAI;2840754631;Taip;0;8;0;8
14286;Žibutė;PELĖDŽIUKAI;1274409680;Taip;0;3;2;5
14287;Žibutė;PELĖDŽIUKAI;8278928396;Taip;6;4;1;11
14288;Žibutė;PELĖDŽIUKAI;2957525481;Taip;3;3;0;6
14289;Žibutė;PELĖDŽIUKAI;3191351976;Taip;0;0;2;2
14290;Žibutė;KREGŽDUTĖS;7036454359;Taip;9;0;3;12
14291;Žibutė;KREGŽDUTĖS;3555071718;Taip;1;0;0;1
14292;Žibutė;KREGŽDUTĖS;5412917352;Taip;0;0;3;3
14293;Žibutė;KREGŽDUTĖS;5187777741;Taip;10;0;0;10
14294;Žibutė;KREGŽDUTĖS;5190377896;Taip;16;0;2;18
14295;Žibutė;KREGŽDUTĖS;6013340521;Taip;1;0;0;1
14296;Žibutė;KREGŽDUTĖS;3574946816;Taip;0;0;1;1
14297;Žibutė;KREGŽDUTĖS;6194464236;Taip;0;0;8;8
14298;Žibutė;KREGŽDUTĖS;3777544301;Taip;3;0;6;9
14299;Žibutė;KREGŽDUTĖS;9923687090;Ne;0;0;18;18
14300;Žibutė;KREGŽDUTĖS;4847295068;Taip;0;0;15;15
14301;Žibutė;KREGŽDUTĖS;9700866512;Taip;0;3;1;4
14302;Žibutė;KREGŽDUTĖS;7774532200;Taip;0;8;0;8
14303;Žibutė;KREGŽDUTĖS;2607509585;Taip;0;7;1;8
14304;Žibutė;KREGŽDUTĖS;8944042589;Taip;0;7;1;8
14305;Žibutė;KREGŽDUTĖS;2438980348;Taip;0;4;3;7
14306;Žibutė;KREGŽDUTĖS;5126232169;Taip;13;0;0;13
14307;Žibutė;KREGŽDUTĖS;8792292819;Taip;19;0;0;19
14308;Žibutė;KREGŽDUTĖS;7668484415;Taip;0;0;5;5
14309;Žibutė;KREGŽDUTĖS;2516448580;Taip;0;0;7;7
14310;Žibutė;BORUŽĖLĖS;3066580779;Taip;4;0;0;4
14311;Žibutė;BORUŽĖLĖS;1786332689;Taip;3;0;0;3
14312;Žibutė;BORUŽĖLĖS;2910188022;Taip;6;0;0;6
14313;Žibutė;BORUŽĖLĖS;8879347884;Taip;5;0;9;14
14314;Žibutė;BORUŽĖLĖS;7764376193;Taip;5;0;1;6
14315;Žibutė;BORUŽĖLĖS;3618347199;Taip;3;1;0;4
14316;Žibutė;BORUŽĖLĖS;2374119662;Taip;0;7;0;7
14317;Žibutė;BORUŽĖLĖS;1381488132;Taip;0;0;9;9
14318;Žibutė;BORUŽĖLĖS;5591970907;Taip;3;0;8;11
14319;Žibutė;BORUŽĖLĖS;6672033757;Taip;0;3;0;3
14320;Žibutė;BORUŽĖLĖS;7481695788;Taip;3;0;0;3
14321;Žibutė;BORUŽĖLĖS;1112295932;Ne;5;2;0;7
14322;Žibutė;BORUŽĖLĖS;8155327668;Taip;0;3;1;4
14323;Žibutė;BORUŽĖLĖS;5632520305;Taip;7;0;4;11
14324;Žibutė;BORUŽĖLĖS;4622674814;Ne;9;1;2;12
14325;Žibutė;BORUŽĖLĖS;7805758264;Taip;5;1;0;6
14326;Žibutė;BORUŽĖLĖS;8640664660;Taip;10;0;0;10
14327;Žibutė;BITUTĖS;7023683517;Taip;5;2;0;7
14328;Žibutė;BITUTĖS;3687123871;Taip;5;0;0;5
14329;Žibutė;BITUTĖS;2312717334;Taip;0;0;4;4
14330;Žibutė;BITUTĖS;6361543454;Taip;6;3;1;10
14331;Žibutė;BITUTĖS;6934760468;Taip;8;0;0;8
14332;Žibutė;BITUTĖS;4455757640;Taip;6;0;0;6
14333;Žibutė;BITUTĖS;8797870379;Taip;4;3;2;9
14334;Žibutė;BITUTĖS;7792267540;Taip;0;7;0;7
14335;Žibutė;BITUTĖS;9221523836;Taip;18;0;0;18
14336;Žibutė;BITUTĖS;3632745935;Taip;0;11;0;11
14337;Žibutė;BITUTĖS;7611641692;Taip;3;6;2;11
14338;Žibutė;BITUTĖS;5112512917;Taip;18;2;0;20
14339;Žibutė;BITUTĖS;8276724226;Taip;4;3;0;7
14340;Žibutė;BITUTĖS;1515636796;Taip;0;7;0;7
14341;Žibutė;BITUTĖS;7872636200;Taip;0;7;0;7
14342;Žibutė;BITUTĖS;6833179680;Taip;0;0;2;2
14343;Žibutė;BITUTĖS;1614551884;Taip;10;0;2;12
14344;Žibutė;KAČIUKAI;9634311146;Taip;5;0;0;5
14345;Žibutė;KAČIUKAI;9868621666;Ne;1;0;5;6
14346;Žibutė;KAČIUKAI;1366469428;Taip;5;2;0;7
14347;Žibutė;KAČIUKAI;4825064521;Taip;10;0;9;19
14348;Žibutė;KAČIUKAI;5826523148;Taip;0;3;0;3
14349;Žibutė;KAČIUKAI;3957898269;Taip;3;0;0;3
14350;Žibutė;KAČIUKAI;4382812297;Taip;6;0;0;6
14351;Žibutė;KAČIUKAI;7479437931;Taip;8;2;0;10
14352;Žibutė;KAČIUKAI;1362419302;Taip;15;0;0;15
14353;Žibutė;KAČIUKAI;7531027545;Ne;0;0;7;7
14354;Žibutė;KAČIUKAI;3645481894;Taip;0;1;2;3
14355;Žibutė;KAČIUKAI;8880329060;Ne;8;0;0;8
14356;Žibutė;KAČIUKAI;5009495840;Taip;4;0;1;5
14357;Žibutė;KAČIUKAI;7136145033;Ne;3;0;2;5
14358;Žibutė;KAČIUKAI;9498011134;Taip;0;3;0;3
14359;Žibutė;KAČIUKAI;5677389434;Taip;0;3;0;3
14360;Žibutė;KAČIUKAI;5416015554;Taip;0;0;2;2
14361;Žibutė;ZUIKIAI;4741505387;Taip;28;0;0;28
14362;Žibutė;ZUIKIAI;6209156111;Taip;10;6;3;19
14363;Žibutė;ZUIKIAI;9856822557;Taip;5;1;0;6
14364;Žibutė;ZUIKIAI;4787010953;Taip;8;1;0;9
14365;Žibutė;ZUIKIAI;3875455223;Taip;3;7;0;10
14366;Žibutė;ZUIKIAI;3449188614;Taip;10;0;4;14
14367;Žibutė;ZUIKIAI;4434623264;Taip;6;0;0;6
14368;Žibutė;ZUIKIAI;2013724729;Taip;16;2;0;18
14369;Žibutė;ZUIKIAI;3786933891;Taip;22;0;0;22
14370;Žibutė;ZUIKIAI;9379539151;Taip;0;0;2;2
14371;Žibutė;ZUIKIAI;9439026609;Taip;23;2;0;25
14372;Žibutė;ZUIKIAI;6234135622;Taip;13;4;0;17
14373;Žiedas;Bitutės;1484464986;Taip;0;0;5;5
14374;Žiedas;Bitutės;4807479784;Taip;0;2;1;3
14375;Žiedas;Bitutės;6945326867;Taip;0;0;1;1
14376;Žiedas;Bitutės;5513311280;Taip;4;3;2;9
14377;Žiedas;Bitutės;1529988412;Taip;0;2;0;2
14378;Žiedas;Bitutės;1007894628;Taip;5;3;2;10
14379;Žiedas;Bitutės;1625009666;Taip;10;1;0;11
14380;Žiedas;Bitutės;9058688663;Ne;0;6;0;6
14381;Žiedas;Bitutės;7150433256;Taip;0;0;1;1
14382;Žiedas;Bitutės;3414702993;Taip;0;1;0;1
14383;Žiedas;Bitutės;2507543124;Taip;10;8;0;18
14384;Žiedas;Bitutės;34193530;Taip;0;3;0;3
14385;Žiedas;Bitutės;86877563124;Taip;5;3;7;15
14386;Žiedas;Bitutės;78720591915;Taip;0;2;1;3
14387;Žiedas;Bitutės;2026728639;Taip;0;2;1;3
14388;Žiedas;Bitutės;5885209631;Taip;0;3;7;10
14389;Žiedas;Bitutės;1737296046;Taip;0;2;0;2
14390;Žiedas;Bitutės;1048272199;Taip;0;2;2;4
14391;Žiedas;Bitutės;5007348884;Ne;0;3;1;4
14392;Žiedas;Varpeliai;7097790025;Ne;2;1;0;3
14393;Žiedas;Varpeliai;3230107921;Taip;0;0;1;1
14394;Žiedas;Varpeliai;3178778438;Taip;0;7;4;11
14395;Žiedas;Varpeliai;9602083568;Taip;12;3;2;17
14396;Žiedas;Varpeliai;5628720422;Taip;0;7;0;7
14397;Žiedas;Varpeliai;1582961378;Taip;5;0;0;5
14398;Žiedas;Varpeliai;1878050384;Ne;0;0;1;1
14399;Žiedas;Varpeliai;6882614465;Taip;0;0;1;1
14400;Žiedas;Varpeliai;5578227349;Taip;0;1;0;1
14401;Žiedas;Varpeliai;6914059680;Taip;0;1;0;1
14402;Žiedas;Varpeliai;7771247056;Taip;0;0;1;1
14403;Žiedas;Varpeliai;6515510381;Taip;10;1;0;11
14404;Žiedas;Varpeliai;3842589827;Taip;10;3;4;17
14405;Žiedas;Varpeliai;5835309107;Taip;6;0;1;7
14406;Žiedas;Varpeliai;3387263016;Ne;0;1;0;1
14407;Žiedas;Varpeliai;3178580610;Taip;7;2;0;9
14408;Žiedas;Varpeliai;1043230748;Taip;0;3;0;3
14409;Žiedas;Varpeliai;5061575884;Taip;11;0;0;11
14410;Žiedas;Varpeliai;1333233100;Ne;13;2;0;15
14411;Žiedas;Varpeliai;8148831014;Taip;0;2;7;9
14412;Žiedas;Ramunėlės;3055218791;Taip;0;2;0;2
14413;Žiedas;Ramunėlės;1333555044;Taip;6;3;0;9
14414;Žiedas;Ramunėlės;2092319455;Ne;6;3;0;9
14415;Žiedas;Ramunėlės;5789261620;Taip;9;0;0;9
14416;Žiedas;Ramunėlės;3900091129;Ne;5;0;0;5
14417;Žiedas;Ramunėlės;2515028280;Taip;9;0;0;9
14418;Žiedas;Ramunėlės;1583038469;Taip;9;6;0;15
14419;Žiedas;Ramunėlės;8208331527;Taip;8;6;0;14
14420;Žiedas;Ramunėlės;9037835899;Taip;10;2;0;12
14421;Žiedas;Ramunėlės;5577339739;Taip;10;0;3;13
14422;Žiedas;Ramunėlės;6884933845;Taip;9;0;0;9
14423;Žiedas;Ramunėlės;7548653053;Taip;8;0;0;8
14424;Žiedas;Ramunėlės;1659873036;Taip;8;0;0;8
14425;Žiedas;Ramunėlės;2843328732;Taip;3;0;2;5
14426;Žiedas;Ramunėlės;1243169901;Taip;6;0;0;6
14427;Žiedas;Ramunėlės;1580781723;Taip;0;4;0;4
14428;Žiedas;Ramunėlės;5920211041;Ne;9;0;0;9
14429;Žiedas;Ramunėlės;4933650089;Taip;7;0;0;7
14430;Žiedas;Ramunėlės;4044156905;Ne;0;0;4;4
14431;Žiedas;Ramunėlės;4844442247;Taip;11;6;0;17
14432;Žiedas;Ramunėlės;7294671324;Taip;2;0;0;2
14433;Žiedas;Pakalnutės;7798930533;Taip;9;2;0;11
14434;Žiedas;Pakalnutės;1094506858;Ne;10;1;0;11
14435;Žiedas;Pakalnutės;9375048835;Taip;0;1;0;1
14436;Žiedas;Pakalnutės;5266048033;Taip;0;3;4;7
14437;Žiedas;Pakalnutės;1721956438;Ne;8;0;0;8
14438;Žiedas;Pakalnutės;4808020243;Taip;0;1;0;1
14439;Žiedas;Pakalnutės;3742949697;Taip;5;0;0;5
14440;Žiedas;Pakalnutės;6343634478;Ne;0;8;0;8
14441;Žiedas;Pakalnutės;8015880569;Taip;0;2;0;2
14442;Žiedas;Pakalnutės;8857150598;Taip;7;1;0;8
14443;Žiedas;Pakalnutės;2416234016;Taip;11;2;0;13
14444;Žiedas;Pakalnutės;9054709268;Taip;5;1;0;6
14445;Žiedas;Pakalnutės;9964883646;Taip;5;1;0;6
14446;Žiedas;Pakalnutės;4917324037;Taip;10;5;0;15
14447;Žiedas;Pakalnutės;4021189767;Taip;5;0;0;5
14448;Žiedas;Pakalnutės;1346658299;Taip;5;2;0;7
14449;Žiedas;Pakalnutės;4697477761;Taip;11;1;0;12
14450;Žiedas;Pakalnutės;7678333395;Taip;0;3;0;3
14451;Žiedas;Pakalnutės;9207945616;Taip;6;5;0;11
14452;Žiedas;Pakalnutės;7221702677;Ne;0;2;0;2
14453;Žiedas;Rožytės;8645771800;Taip;13;3;0;16
14454;Žiedas;Rožytės;7942276632;Taip;0;1;0;1
14455;Žiedas;Rožytės;7799489700;Taip;11;8;0;19
14456;Žiedas;Rožytės;8163645535;Taip;13;1;0;14
14457;Žiedas;Rožytės;8927034492;Taip;0;0;23;23
14458;Žiedas;Rožytės;8822472312;Taip;0;1;0;1
14459;Žiedas;Rožytės;9021286246;Taip;8;4;0;12
14460;Žiedas;Rožytės;6261847845;Taip;5;0;0;5
14461;Žiedas;Rožytės;1777501190;Taip;4;0;0;4
14462;Žiedas;Rožytės;1844621525;Ne;4;0;2;6
14463;Žiedas;Rožytės;6459679214;Taip;6;4;0;10
14464;Žiedas;Rožytės;6175213274;Ne;0;0;2;2
14465;Žiedas;Rožytės;3984607857;Taip;0;0;1;1
14466;Žiedas;Rožytės;6041919197;Taip;10;3;0;13
14467;Žiedas;Pumpurėliai;5830738378;Taip;5;0;0;5
14468;Žiedas;Pumpurėliai;7780469974;Taip;6;2;0;8
14469;Žiedas;Pumpurėliai;8056265378;Taip;8;0;4;12
14470;Žiedas;Pumpurėliai;9337317396;Taip;0;3;0;3
14471;Žiedas;Pumpurėliai;1086714229;Taip;21;0;0;21
14472;Žiedas;Pumpurėliai;2320411618;Taip;0;3;0;3
14473;Žiedas;Pumpurėliai;5635958124;Taip;9;0;0;9
14474;Žiedas;Pumpurėliai;7677595571;Taip;8;0;0;8
14475;Žiedas;Pumpurėliai;4699833757;Taip;20;0;0;20
14476;Žiedas;Pumpurėliai;2633676360;Taip;4;3;3;10
14477;Žiedas;Pumpurėliai;8797245208;Ne;13;1;0;14
14478;Žiedas;"Dobiliukai ";6066566242;Taip;10;1;0;11
14479;Žiedas;"Dobiliukai ";8436592169;Taip;8;1;0;9
14480;Žiedas;"Dobiliukai ";3654878543;Taip;15;1;0;16
14481;Žiedas;"Dobiliukai ";8444690698;Taip;17;1;0;18
14482;Žiedas;"Dobiliukai ";2715554681;Ne;12;3;0;15
14483;Žiedas;"Dobiliukai ";2132564079;Taip;13;0;0;13
14484;Žiedas;"Dobiliukai ";9586578606;Ne;0;5;0;5
14485;Žiedas;"Dobiliukai ";5353507617;Taip;18;3;2;23
14486;Žiedas;"Dobiliukai ";4087903129;Taip;0;10;0;10
14487;Žiedas;"Dobiliukai ";8185042446;Taip;5;1;0;6
14488;Žiedas;"Dobiliukai ";7049399327;Taip;8;1;1;10
14489;Žiedas;"Dobiliukai ";5788152675;Taip;18;0;0;18
14490;Žiedas;"Dobiliukai ";8388297947;Ne;6;0;0;6
14491;Žiedas;"Dobiliukai ";3011163947;Taip;9;0;0;9
14492;Žiedas;"Dobiliukai ";6748378606;Taip;0;5;1;6
14493;Žiedas;"Dobiliukai ";7558307454;Taip;15;0;0;15
14494;Žiedas;RŪTELĖS;2134466899;Taip;0;1;0;1
14495;Žiedas;RŪTELĖS;6822887260;Taip;0;5;0;5
14496;Žiedas;RŪTELĖS;5914428064;Ne;8;2;0;10
14497;Žiedas;RŪTELĖS;3857121753;Taip;5;3;2;10
14498;Žiedas;RŪTELĖS;6443633568;Taip;18;0;0;18
14499;Žiedas;RŪTELĖS;7491134119;Taip;0;1;0;1
14500;Žiedas;RŪTELĖS;5959899914;Taip;14;0;0;14
14501;Žiedas;RŪTELĖS;7333813704;Taip;5;1;0;6
14502;Žiedas;RŪTELĖS;6658762922;Taip;0;3;0;3
14503;Žiedas;RŪTELĖS;5126173608;Taip;0;5;0;5
14504;Žiedas;RŪTELĖS;1738121071;Taip;0;3;0;3
14505;Žiedas;RŪTELĖS;1253833615;Taip;0;2;2;4
14506;Žiedas;RŪTELĖS;7172793351;Taip;0;5;0;5
14507;Žiedas;RŪTELĖS;4497634040;Taip;0;3;0;3
14508;Žiedas;RŪTELĖS;9218388800;Taip;0;5;0;5
14509;Žiedas;RŪTELĖS;7072578987;Taip;10;5;0;15
14510;Žiedas;RŪTELĖS;3715928992;Ne;6;2;0;8
14511;Žiedas;RŪTELĖS;9352485926;Ne;0;1;0;1
14512;Žiedas;RŪTELĖS;7578964555;Taip;4;2;0;6
14513;Žiedas;RŪTELĖS;5928377774;Taip;0;1;1;2
14514;Žiedas;SAULĖGRĄŽOS;1011602827;Taip;0;4;1;5
14515;Žiedas;SAULĖGRĄŽOS;8887021328;Taip;8;1;0;9
14516;Žiedas;SAULĖGRĄŽOS;2932857132;Taip;4;1;0;5
14517;Žiedas;SAULĖGRĄŽOS;5552786845;Taip;8;1;0;9
14518;Žiedas;SAULĖGRĄŽOS;8833895006;Taip;6;8;0;14
14519;Žiedas;SAULĖGRĄŽOS;5658235821;Taip;12;1;0;13
14520;Žiedas;SAULĖGRĄŽOS;4992446383;Taip;18;0;0;18
14521;Žiedas;SAULĖGRĄŽOS;9057761408;Taip;3;2;0;5
14522;Žiedas;SAULĖGRĄŽOS;1645402434;Taip;7;0;0;7
14523;Žiedas;SAULĖGRĄŽOS;2026540724;Taip;0;6;0;6
14524;Žiedas;SAULĖGRĄŽOS;4564268323;Taip;15;0;1;16
14525;Žiedas;SAULĖGRĄŽOS;8801900486;Taip;0;0;1;1
14526;Žiedas;SAULĖGRĄŽOS;1609487830;Taip;13;2;2;17
14527;Žiedas;SAULĖGRĄŽOS;3437651010;Taip;11;0;0;11
14528;Žiedas;SAULĖGRĄŽOS;3422053505;Taip;8;1;0;9
14529;Žiedas;SAULĖGRĄŽOS;5274845525;Taip;8;3;0;11
14530;Žiedas;SAULĖGRĄŽOS;6053010050;Taip;9;0;0;9
14531;Žiedas;SAULĖGRĄŽOS;7057747531;Taip;3;0;0;3
14532;Žiedas;SAULĖGRĄŽOS;7604200899;Taip;5;0;0;5
14533;Žiedas;SAULĖGRĄŽOS;3303581707;Taip;7;1;0;8
14534;Žiedas;RUGIAGĖLĖS;1035854293;Taip;0;0;3;3
14535;Žiedas;RUGIAGĖLĖS;1917085385;Taip;12;3;0;15
14536;Žiedas;RUGIAGĖLĖS;5987689515;Taip;10;4;0;14
14537;Žiedas;RUGIAGĖLĖS;1826599535;Taip;7;3;0;10
14538;Žiedas;RUGIAGĖLĖS;2124086277;Taip;9;1;0;10
14539;Žiedas;RUGIAGĖLĖS;2642760082;Taip;0;3;0;3
14540;Žiedas;RUGIAGĖLĖS;1093479755;Taip;18;0;0;18
14541;Žiedas;RUGIAGĖLĖS;7381658912;Taip;17;0;0;17
14542;Žiedas;RUGIAGĖLĖS;2964286644;Taip;23;0;0;23
14543;Žiedas;RUGIAGĖLĖS;7228139235;Taip;10;0;0;10
14544;Žiedas;RUGIAGĖLĖS;2347857813;Taip;0;23;0;23
14545;Žiedas;RUGIAGĖLĖS;1975718197;Taip;3;0;4;7
14546;Žiedas;RUGIAGĖLĖS;2312361963;Taip;23;0;0;23
14547;Žiedas;RUGIAGĖLĖS;6859410675;Taip;10;4;0;14
14548;Žiedas;RUGIAGĖLĖS;2148027253;Ne;0;2;3;5
14549;Žiedas;RUGIAGĖLĖS;1758868055;Taip;5;1;2;8
14550;Žiedas;RUGIAGĖLĖS;2182340305;Ne;0;2;1;3
14551;Žiedas;RUGIAGĖLĖS;3099608553;Taip;20;0;0;20
14552;Žiedas;RUGIAGĖLĖS;1390431397;Taip;0;1;4;5
14553;Žiedas;RUGIAGĖLĖS;9393499257;Taip;10;1;0;11
14554;Žiedas;RUGIAGĖLĖS;2170318597;Ne;3;0;0;3
14555;Žiedas;RUGIAGĖLĖS;8276022676;Taip;19;0;0;19
14556;Žiedas;RUGIAGĖLĖS;7584712202;Taip;7;1;0;8
14557;Žiedas;Boružėlės;4922560649;Taip;0;1;0;1
14558;Žiedas;Boružėlės;6703889237;Taip;0;0;1;1
14559;Žiedas;Boružėlės;2095655987;Taip;0;2;0;2
14560;Žiedas;Boružėlės;7814504623;Taip;4;1;0;5
14561;Žiedas;Boružėlės;9648580306;Taip;7;3;0;10
14562;Žiedas;Boružėlės;9699668892;Taip;0;5;0;5
14563;Žiedas;Boružėlės;5653785844;Taip;15;1;0;16
14564;Žiedas;Boružėlės;9247088735;Taip;0;0;2;2
14565;Žiedas;Boružėlės;7396006218;Taip;0;7;0;7
14566;Žiedas;Boružėlės;5588136738;Taip;0;11;0;11
14567;Žiedas;Boružėlės;6786526552;Taip;10;1;2;13
14568;Žiedas;Boružėlės;2511423525;Taip;0;0;3;3
14569;Žiedas;Boružėlės;6432090199;Taip;5;0;0;5
14570;Žiedas;Boružėlės;5626494892;Taip;18;1;0;19
14571;Žiedas;Boružėlės;7708360056;Taip;6;0;5;11
14572;Žiedas;Boružėlės;7954517383;Taip;0;5;2;7
14573;Žiedas;Boružėlės;3702078720;Taip;12;1;0;13
14574;Žiedas;Boružėlės;1794393042;Taip;0;5;1;6
14575;Žiedas;Boružėlės;2849254119;Taip;20;1;0;21
14576;Žiedas;Boružėlės;9736967156;Taip;12;0;2;14
14577;Žiedas;Boružėlės;3586376571;Taip;0;5;0;5
14578;Žiedas;Boružėlės;1139186052;Taip;5;0;0;5
14579;Žiedas;Boružėlės;3704491209;Taip;10;3;0;13
14580;Žiedas;AGUONĖLĖS;1885623466;Taip;17;0;0;17
14581;Žiedas;AGUONĖLĖS;9464217926;Taip;14;0;0;14
14582;Žiedas;AGUONĖLĖS;9543860953;Taip;6;0;0;6
14583;Žiedas;AGUONĖLĖS;3247328978;Taip;13;0;0;13
14584;Žiedas;AGUONĖLĖS;4250009129;Taip;17;1;0;18
14585;Žiedas;AGUONĖLĖS;7399937598;Taip;0;1;0;1
14586;Žiedas;AGUONĖLĖS;1325715061;Taip;12;0;0;12
14587;Žiedas;AGUONĖLĖS;9111149805;Taip;6;3;0;9
14588;Žiedas;AGUONĖLĖS;4695900874;Taip;6;3;0;9
14589;Žiedas;AGUONĖLĖS;3258241663;Taip;8;1;0;9
14590;Žiedas;AGUONĖLĖS;6700593422;Taip;19;0;0;19
14591;Žiedas;AGUONĖLĖS;3835714894;Taip;12;0;0;12
14592;Žiedas;AGUONĖLĖS;7535993061;Taip;10;1;0;11
14593;Žiedas;AGUONĖLĖS;1956219718;Taip;5;1;0;6
14594;Žiedas;AGUONĖLĖS;4809093267;Taip;10;4;0;14
14595;Žiedas;AGUONĖLĖS;1874460511;Taip;13;0;0;13
14596;Žiedas;AGUONĖLĖS;6245366671;Taip;0;1;0;1
14597;Žiedas;AGUONĖLĖS;6856477482;Taip;11;1;0;12
14598;Žiedas;ŽIBUTĖS;3654749109;Taip;10;2;0;12
14599;Žiedas;ŽIBUTĖS;1835893385;Taip;20;0;1;21
14600;Žiedas;ŽIBUTĖS;2913328259;Taip;18;0;0;18
14601;Žiedas;ŽIBUTĖS;7418985667;Taip;12;0;1;13
14602;Žiedas;ŽIBUTĖS;4568189195;Ne;3;0;0;3
14603;Žiedas;ŽIBUTĖS;2097392327;Taip;22;0;0;22
14604;Žiedas;ŽIBUTĖS;9269909624;Taip;7;2;1;10
14605;Žiedas;ŽIBUTĖS;7114207461;Taip;17;0;0;17
14606;Žiedas;ŽIBUTĖS;5106427067;Ne;0;6;2;8
14607;Žiedas;ŽIBUTĖS;3407247493;Taip;13;0;3;16
14608;Žiedas;ŽIBUTĖS;8084555994;Taip;10;0;0;10
14609;Žiedas;ŽIBUTĖS;3477341028;Taip;10;3;0;13
14610;Žiedas;ŽIBUTĖS;6923562927;Taip;18;0;0;18
14611;Žiedas;ŽIBUTĖS;1669599543;Ne;14;0;2;16
14612;Žiedas;ŽIBUTĖS;1509140770;Taip;8;0;0;8
14613;Žiedas;ŽIBUTĖS;7498211984;Taip;10;2;0;12
14614;Žiedas;DRUGELIAI;8517250094;Taip;0;19;0;19
14615;Žiedas;DRUGELIAI;9894489800;Taip;5;0;0;5
14616;Žiedas;DRUGELIAI;2763469583;Taip;0;3;0;3
14617;Žiedas;DRUGELIAI;9757771445;Taip;0;10;0;10
14618;Žiedas;DRUGELIAI;4222689492;Ne;0;2;0;2
14619;Žiedas;DRUGELIAI;2763996098;Taip;15;3;0;18
14620;Žiedas;DRUGELIAI;9129315784;Taip;0;11;0;11
14621;Žiedas;DRUGELIAI;7952899220;Taip;0;3;0;3
14622;Žiedas;DRUGELIAI;2679205188;Ne;11;0;0;11
14623;Žiedas;DRUGELIAI;2026462074;Taip;5;1;0;6
14624;Žiedas;DRUGELIAI;4749655084;Taip;4;0;1;5
14625;Žiedas;DRUGELIAI;9587581470;Taip;0;3;0;3
14626;Žiogelis;SKRUZDELYTĖS;2959983278;Taip;0;5;0;5
14627;Žiogelis;SKRUZDELYTĖS;5281321968;Taip;0;8;1;9
14628;Žiogelis;SKRUZDELYTĖS;3214640817;Taip;0;16;0;16
14629;Žiogelis;SKRUZDELYTĖS;1937740173;Taip;0;9;0;9
14630;Žiogelis;SKRUZDELYTĖS;4115425880;Taip;0;3;0;3
14631;Žiogelis;SKRUZDELYTĖS;5737326104;Taip;10;0;0;10
14632;Žiogelis;SKRUZDELYTĖS;2614574694;Taip;0;2;0;2
14633;Žiogelis;SKRUZDELYTĖS;7107814348;Taip;0;7;0;7
14634;Žiogelis;SKRUZDELYTĖS;9243862028;Taip;0;10;0;10
14635;Žiogelis;SKRUZDELYTĖS;9819352425;Taip;7;0;0;7
14636;Žiogelis;SKRUZDELYTĖS;8780773039;Taip;10;7;0;17
14637;Žiogelis;SKRUZDELYTĖS;7881734492;Taip;4;0;0;4
14638;Žiogelis;SKRUZDELYTĖS;2701091043;Taip;0;1;0;1
14639;Žiogelis;SKRUZDELYTĖS;9120836406;Taip;6;0;0;6
14640;Žiogelis;SKRUZDELYTĖS;6742462116;Ne;5;2;0;7
14641;Žiogelis;SKRUZDELYTĖS;8763533677;Ne;10;1;0;11
14642;Žiogelis;SKRUZDELYTĖS;6608146625;Taip;20;0;0;20
14643;Žiogelis;SKRUZDELYTĖS;9035254979;Taip;17;0;0;17
14644;Žiogelis;ŽIRNIUKAI;2348525913;Taip;14;0;0;14
14645;Žiogelis;ŽIRNIUKAI;2771911603;Taip;4;2;0;6
14646;Žiogelis;ŽIRNIUKAI;6617995346;Taip;0;0;4;4
14647;Žiogelis;ŽIRNIUKAI;9142952548;Taip;4;0;0;4
14648;Žiogelis;ŽIRNIUKAI;8998694866;Taip;0;1;6;7
14649;Žiogelis;ŽIRNIUKAI;3472310047;Taip;0;3;2;5
14650;Žiogelis;ŽIRNIUKAI;8018943297;Taip;0;3;3;6
14651;Žiogelis;ŽIRNIUKAI;8038242532;Taip;7;3;0;10
14652;Žiogelis;ŽIRNIUKAI;9421670525;Taip;0;1;0;1
14653;Žiogelis;ŽIRNIUKAI;2463360858;Taip;0;0;3;3
14654;Žiogelis;ŽIRNIUKAI;1067136657;Taip;2;0;1;3
14655;Žiogelis;ŽIRNIUKAI;9672307977;Taip;0;0;1;1
14656;Žiogelis;ŽIRNIUKAI;5337641310;Taip;3;0;1;4
14657;Žiogelis;ŽIRNIUKAI;4755709634;Taip;0;6;0;6
14658;Žiogelis;ŽIRNIUKAI;6857937795;Taip;0;7;0;7
14659;Žiogelis;ŽIRNIUKAI;9918493914;Taip;6;0;0;6
14660;Žiogelis;ŽIRNIUKAI;3516143432;Taip;10;0;0;10
14661;Žiogelis;ŽIRNIUKAI;5223426277;Taip;4;0;0;4
14662;Žiogelis;DOBILĖLIAI;8683148826;Taip;0;5;0;5
14663;Žiogelis;DOBILĖLIAI;2117192553;Taip;0;8;0;8
14664;Žiogelis;DOBILĖLIAI;1190395481;Taip;0;7;0;7
14665;Žiogelis;DOBILĖLIAI;1465027680;Taip;0;0;1;1
14666;Žiogelis;DOBILĖLIAI;6495456608;Taip;10;0;0;10
14667;Žiogelis;DOBILĖLIAI;5364996984;Taip;0;0;1;1
14668;Žiogelis;DOBILĖLIAI;9568208184;Taip;0;0;1;1
14669;Žiogelis;DOBILĖLIAI;6340620973;Ne;0;0;8;8
14670;Žiogelis;DOBILĖLIAI;6532218580;Taip;5;0;2;7
14671;Žiogelis;DOBILĖLIAI;5911231906;Taip;0;1;0;1
14672;Žiogelis;DOBILĖLIAI;9610249055;Taip;0;0;1;1
14673;Žiogelis;DOBILĖLIAI;6115834138;Taip;3;0;6;9
14674;Žiogelis;DOBILĖLIAI;3887222613;Taip;2;0;1;3
14675;Žiogelis;DOBILĖLIAI;8485067381;Taip;0;0;3;3
14676;Žiogelis;DOBILĖLIAI;7065052244;Taip;0;0;4;4
14677;Žiogelis;DOBILĖLIAI;3427704550;Ne;0;0;1;1
14678;Žiogelis;DOBILĖLIAI;4103035195;Taip;10;0;0;10
14679;Žiogelis;DOBILĖLIAI;3392582853;Taip;0;1;0;1
14680;Žiogelis;DOBILĖLIAI;5557800297;Taip;0;1;0;1
14681;Žiogelis;BORUŽĖLĖS;9295720241;Taip;7;0;0;7
14682;Žiogelis;BORUŽĖLĖS;24941867247;Taip;0;1;0;1
14683;Žiogelis;BORUŽĖLĖS;8819549855;Ne;8;5;1;14
14684;Žiogelis;BORUŽĖLĖS;3189872952;Taip;0;3;2;5
14685;Žiogelis;BORUŽĖLĖS;2883732914;Taip;0;3;2;5
14686;Žiogelis;BORUŽĖLĖS;3503872654;Taip;0;3;1;4
14687;Žiogelis;BORUŽĖLĖS;4445888917;Taip;0;5;1;6
14688;Žiogelis;BORUŽĖLĖS;7881358741;Taip;5;16;0;21
14689;Žiogelis;BORUŽĖLĖS;8702710674;Taip;0;5;0;5
14690;Žiogelis;BORUŽĖLĖS;4671356872;Taip;0;2;0;2
14691;Žiogelis;BORUŽĖLĖS;18018505301;Taip;0;3;0;3
14692;Žiogelis;BORUŽĖLĖS;4343510173;Taip;0;19;0;19
14693;Žiogelis;BORUŽĖLĖS;6659086172;Taip;0;1;0;1
14694;Žiogelis;BORUŽĖLĖS;95713316600;Taip;0;2;0;2
14695;Žiogelis;BORUŽĖLĖS;3203359908;Taip;4;1;2;7
14696;Žiogelis;BORUŽĖLĖS;3320077143;Taip;0;0;1;1
14697;Žiogelis;BORUŽĖLĖS;1160064257;Taip;0;3;0;3
14698;Žiogelis;BORUŽĖLĖS;60959051938;Taip;0;0;1;1
14699;Žiogelis;BORUŽĖLĖS;6346503991;Taip;0;3;7;10
14700;Žiogelis;BORUŽĖLĖS;3560637865;Taip;11;4;0;15
14701;Žiogelis;BORUŽĖLĖS;3420228264;Taip;13;0;0;13
14702;Žiogelis;BORUŽĖLĖS;1996517542;Taip;0;8;0;8
14703;Žiogelis;BORUŽĖLĖS;6760074113;Ne;5;3;2;10
14704;Žiogelis;DRUGELIAI;4080391074;Ne;0;0;2;2
14705;Žiogelis;DRUGELIAI;2797078863;Taip;15;0;0;15
14706;Žiogelis;DRUGELIAI;3813592739;Taip;0;1;0;1
14707;Žiogelis;DRUGELIAI;3820406417;Taip;0;0;5;5
14708;Žiogelis;DRUGELIAI;9533670829;Ne;0;1;1;2
14709;Žiogelis;DRUGELIAI;1673279182;Taip;5;4;0;9
14710;Žiogelis;DRUGELIAI;9964121573;Taip;8;0;4;12
14711;Žiogelis;DRUGELIAI;5104952346;Taip;0;3;3;6
14712;Žiogelis;DRUGELIAI;9431525960;Taip;0;0;5;5
14713;Žiogelis;DRUGELIAI;2622354022;Taip;8;2;0;10
14714;Žiogelis;DRUGELIAI;7462316396;Taip;0;4;0;4
14715;Žiogelis;DRUGELIAI;7395496310;Taip;3;0;1;4
14716;Žiogelis;DRUGELIAI;2243541285;Taip;0;2;4;6
14717;Žiogelis;DRUGELIAI;3810309354;Taip;6;0;1;7
14718;Žiogelis;DRUGELIAI;2326799191;Ne;9;0;0;9
14719;Žiogelis;DRUGELIAI;7974212517;Taip;4;2;0;6
14720;Žiogelis;DRUGELIAI;9423979719;Taip;4;2;0;6
14721;Žiogelis;DRUGELIAI;1833992163;Ne;20;0;0;20
14722;Žiogelis;PELĖDŽIUKAI;4156736676;Taip;0;1;0;1
14723;Žiogelis;PELĖDŽIUKAI;7128248940;Taip;0;1;0;1
14724;Žiogelis;PELĖDŽIUKAI;6709029770;Taip;0;1;0;1
14725;Žiogelis;PELĖDŽIUKAI;7502572217;Taip;15;3;3;21
14726;Žiogelis;PELĖDŽIUKAI;1134384178;Taip;0;0;2;2
14727;Žiogelis;PELĖDŽIUKAI;5876904663;Taip;4;0;1;5
14728;Žiogelis;PELĖDŽIUKAI;8217782981;Taip;18;1;0;19
14729;Žiogelis;PELĖDŽIUKAI;7120126547;Taip;0;5;0;5
14730;Žiogelis;PELĖDŽIUKAI;9387048672;Taip;0;8;0;8
14731;Žiogelis;PELĖDŽIUKAI;3937261260;Taip;0;1;0;1
14732;Žiogelis;PELĖDŽIUKAI;8873231715;Taip;0;0;2;2
14733;Žiogelis;PELĖDŽIUKAI;8894068297;Taip;0;1;0;1
14734;Žiogelis;PELĖDŽIUKAI;4609861306;Taip;4;0;0;4
14735;Žiogelis;PELĖDŽIUKAI;2759766559;Taip;0;9;0;9
14736;Žiogelis;PELĖDŽIUKAI;2160862681;Taip;0;3;0;3
14737;Žiogelis;PELĖDŽIUKAI;7725494899;Taip;0;9;0;9
14738;Žiogelis;PELĖDŽIUKAI;1939672072;Taip;0;0;2;2
14739;Žiogelis;PELĖDŽIUKAI;8689074067;Taip;0;1;0;1
14740;Žiogelis;PELĖDŽIUKAI;4565342104;Taip;0;4;0;4
14741;Žiogelis;PELĖDŽIUKAI;1223396469;Taip;6;3;1;10
14742;Žiogelis;PELĖDŽIUKAI;3500076229;Ne;0;2;2;4
14743;Žiogelis;PELĖDŽIUKAI;8715501524;Taip;6;1;0;7
14744;Žiogelis;VARPELIAI;7888873296;Taip;0;7;0;7
14745;Žiogelis;VARPELIAI;8262619320;Taip;0;4;0;4
14746;Žiogelis;VARPELIAI;3520393042;Ne;0;13;0;13
14747;Žiogelis;VARPELIAI;8983731310;Taip;4;3;0;7
14748;Žiogelis;VARPELIAI;1954544417;Ne;0;2;0;2
14749;Žiogelis;VARPELIAI;6716558946;Ne;6;0;0;6
14750;Žiogelis;VARPELIAI;1035890284;Ne;13;1;0;14
14751;Žiogelis;VARPELIAI;9385596579;Taip;11;0;0;11
14752;Žiogelis;VARPELIAI;3752358694;Taip;16;0;0;16
14753;Žiogelis;VARPELIAI;6402784913;Ne;13;2;0;15
14754;Žiogelis;VARPELIAI;4462189852;Taip;0;2;0;2
14755;Žiogelis;VARPELIAI;9470241656;Ne;4;1;0;5
14756;Žiogelis;VARPELIAI;8133583992;Ne;0;3;0;3
14757;Žiogelis;VARPELIAI;5899326215;Ne;5;1;0;6
14758;Žiogelis;VARPELIAI;6658457517;Ne;3;0;0;3
14759;Žiogelis;VARPELIAI;6650891980;Ne;10;0;0;10
14760;Žiogelis;VARPELIAI;5076511003;Taip;9;1;0;10
14761;Žiogelis;VARPELIAI;7992701275;Taip;0;1;0;1
14762;Žiogelis;KREGŽDUTĖS;1309122110;Taip;0;6;0;6
14763;Žiogelis;KREGŽDUTĖS;7704256764;Taip;0;3;0;3
14764;Žiogelis;KREGŽDUTĖS;1235203700;Taip;0;1;1;2
14765;Žiogelis;KREGŽDUTĖS;6697117406;Taip;0;3;1;4
14766;Žiogelis;KREGŽDUTĖS;2028383677;Taip;4;3;0;7
14767;Žiogelis;KREGŽDUTĖS;3910954904;Taip;5;3;1;9
14768;Žiogelis;KREGŽDUTĖS;2233244282;Taip;4;2;0;6
14769;Žiogelis;KREGŽDUTĖS;9406830518;Taip;0;3;0;3
14770;Žiogelis;KREGŽDUTĖS;1320651707;Taip;0;12;0;12
14771;Žiogelis;KREGŽDUTĖS;85437321236;Taip;0;0;2;2
14772;Žiogelis;KREGŽDUTĖS;1320126836;Taip;0;3;0;3
14773;Žiogelis;KREGŽDUTĖS;3310492752;Taip;5;0;0;5
14774;Žiogelis;KREGŽDUTĖS;2366095661;Taip;2;1;1;4
14775;Žiogelis;KREGŽDUTĖS;7087781379;Taip;0;4;0;4
14776;Žiogelis;KREGŽDUTĖS;4015109974;Taip;0;4;0;4
14777;Žiogelis;KREGŽDUTĖS;14932261911;Taip;0;5;2;7
14778;Žiogelis;KREGŽDUTĖS;4713696984;Taip;0;7;0;7
14779;Žiogelis;KREGŽDUTĖS;1442866468;Taip;5;0;1;6
14780;Žiogelis;KREGŽDUTĖS;1660784232;Ne;7;0;1;8
14781;Žiogelis;KREGŽDUTĖS;5579709130;Taip;0;4;0;4
14782;Žiogelis;KREGŽDUTĖS;9128728457;Ne;0;3;0;3
14783;Žiogelis;KREGŽDUTĖS;5340501392;Taip;0;8;0;8
14784;Žiogelis;KREGŽDUTĖS;8979747150;Taip;0;2;0;2
14785;Žiogelis;ŽVIRBLIUKAI;1106149118;Taip;5;1;0;6
14786;Žiogelis;ŽVIRBLIUKAI;6284764694;Taip;0;5;0;5
14787;Žiogelis;ŽVIRBLIUKAI;9842311161;Taip;12;0;0;12
14788;Žiogelis;ŽVIRBLIUKAI;5475797764;Taip;17;0;0;17
14789;Žiogelis;ŽVIRBLIUKAI;2036243422;Taip;17;1;0;18
14790;Žiogelis;ŽVIRBLIUKAI;9634291623;Taip;7;2;0;9
14791;Žiogelis;ŽVIRBLIUKAI;7802165127;Taip;10;1;0;11
14792;Žiogelis;ŽVIRBLIUKAI;6491130711;Taip;6;0;1;7
14793;Žiogelis;ŽVIRBLIUKAI;9378236361;Taip;15;0;0;15
14794;Žiogelis;ŽVIRBLIUKAI;5445409452;Taip;15;0;0;15
14795;Žiogelis;ŽVIRBLIUKAI;4155916507;Taip;5;2;0;7
14796;Žiogelis;ŽVIRBLIUKAI;4623532521;Taip;0;14;0;14
14797;Žiogelis;ŽVIRBLIUKAI;6988180082;Taip;15;1;0;16
14798;Žiogelis;ŽVIRBLIUKAI;4677227753;Taip;15;1;0;16
14799;Žiogelis;ŽVIRBLIUKAI;9737574835;Taip;0;1;0;1
14800;Žiogelis;ŽVIRBLIUKAI;2529171444;Taip;9;0;0;9
14801;Žiogelis;ŽVIRBLIUKAI;5996045442;Taip;0;5;0;5
14802;Žiogelis;BITUTĖS;4605250897;Taip;0;6;0;6
14803;Žiogelis;BITUTĖS;2173494736;Taip;5;7;0;12
14804;Žiogelis;BITUTĖS;5042341085;Taip;5;0;0;5
14805;Žiogelis;BITUTĖS;6347738933;Taip;0;4;0;4
14806;Žiogelis;BITUTĖS;9627583831;Taip;0;2;0;2
14807;Žiogelis;BITUTĖS;3296450902;Taip;0;7;0;7
14808;Žiogelis;BITUTĖS;3792114246;Taip;0;4;0;4
14809;Žiogelis;BITUTĖS;9981130790;Taip;0;8;0;8
14810;Žiogelis;BITUTĖS;3820534331;Taip;5;3;0;8
14811;Žiogelis;BITUTĖS;9790463889;Ne;0;14;0;14
14812;Žiogelis;BITUTĖS;6024752960;Taip;0;4;0;4
14813;Žiogelis;BITUTĖS;8853905367;Taip;0;4;0;4
14814;Žiogelis;BITUTĖS;1397686161;Taip;0;18;0;18
14815;Žiogelis;BITUTĖS;2171351454;Taip;0;0;3;3
14816;Žiogelis;BITUTĖS;8835394030;Ne;0;7;0;7
14817;Žiogelis;BITUTĖS;4645245689;Taip;13;0;0;13
14818;Žiogelis;BITUTĖS;9874412804;Taip;4;3;0;7
14819;Žiogelis;BITUTĖS;5139645108;Taip;0;4;0;4
14820;Žiogelis;BITUTĖS;9766966628;Taip;8;4;0;12
14821;Žiogelis;RIEŠUTĖLIAI;8303283893;Taip;6;1;0;7
14822;Žiogelis;RIEŠUTĖLIAI;9863503924;Taip;3;0;3;6
14823;Žiogelis;RIEŠUTĖLIAI;6718866954;Taip;17;2;0;19
14824;Žiogelis;RIEŠUTĖLIAI;9144282935;Taip;0;0;2;2
14825;Žiogelis;RIEŠUTĖLIAI;8485973974;Taip;0;1;3;4
14826;Žiogelis;RIEŠUTĖLIAI;6039409252;Taip;0;1;7;8
14827;Žiogelis;RIEŠUTĖLIAI;2275123126;Taip;0;6;0;6
14828;Žiogelis;RIEŠUTĖLIAI;6048534817;Taip;13;1;0;14
14829;Žiogelis;RIEŠUTĖLIAI;5133034709;Taip;16;0;0;16
14830;Žiogelis;RIEŠUTĖLIAI;4147132498;Taip;9;0;0;9
14831;Žiogelis;RIEŠUTĖLIAI;2724389716;Taip;6;0;3;9
14832;Žiogelis;RIEŠUTĖLIAI;7763941077;Ne;4;1;1;6
14833;Žiogelis;RIEŠUTĖLIAI;4946802677;Taip;11;0;0;11
14834;Žiogelis;RIEŠUTĖLIAI;7008807839;Taip;0;5;0;5
14835;Žiogelis;RIEŠUTĖLIAI;2518015116;Taip;4;0;0;4
14836;Žiogelis;RIEŠUTĖLIAI;5984496369;Taip;6;3;0;9
14837;Žiogelis;PAKALNUTĖS;5054228916;Taip;0;13;0;13
14838;Žiogelis;PAKALNUTĖS;8712788346;Taip;7;0;0;7
14839;Žiogelis;PAKALNUTĖS;3428197871;Taip;0;1;0;1
14840;Žiogelis;PAKALNUTĖS;7535167450;Taip;6;7;3;16
14841;Žiogelis;PAKALNUTĖS;1268908081;Taip;6;0;1;7
14842;Žiogelis;PAKALNUTĖS;3856321373;Ne;9;0;2;11
14843;Žiogelis;PAKALNUTĖS;6378295945;Taip;13;1;2;16
14844;Žiogelis;PAKALNUTĖS;8959934210;Taip;0;1;0;1
14845;Žiogelis;PAKALNUTĖS;8591680136;Ne;0;2;0;2
14846;Žiogelis;PAKALNUTĖS;6980853713;Taip;6;0;0;6
14847;Žiogelis;PAKALNUTĖS;7340918175;Taip;4;1;4;9
14848;Žiogelis;PAKALNUTĖS;4513613915;Taip;19;2;0;21
14849;Žiogelis;PAKALNUTĖS;6866685213;Taip;0;2;1;3
14850;Žiogelis;PAKALNUTĖS;5487213418;Taip;0;1;0;1
14851;Žiogelis;PAKALNUTĖS;8058231095;Ne;3;1;5;9
14852;Žiogelis;PAKALNUTĖS;6593794147;Taip;7;0;0;7
14853;Žiogelis;PAKALNUTĖS;1650284820;Ne;3;1;1;5
14854;Žiogelis;PAKALNUTĖS;6515890056;Taip;4;1;1;6
14855;Žiogelis;PAKALNUTĖS;7310459638;Taip;0;10;0;10
14856;Žiogelis;PAKALNUTĖS;1763603533;Taip;0;4;0;4
14857;Žiogelis;PAKALNUTĖS;9813150014;Taip;0;2;3;5
14858;Žiogelis;PAKALNUTĖS;5454676924;Taip;9;0;0;9
14859;Žiogelis;PAKALNUTĖS;7702173581;Taip;0;14;0;14
14860;Žolynėlis;Spanguolėlė;8810441600;Taip;0;7;1;8
14861;Žolynėlis;Spanguolėlė;3261542931;Ne;11;0;0;11
14862;Žolynėlis;Spanguolėlė;6440991320;Taip;0;9;0;9
14863;Žolynėlis;Spanguolėlė;3631138915;Taip;13;0;0;13
14864;Žolynėlis;Spanguolėlė;5218448120;Taip;0;3;0;3
14865;Žolynėlis;Spanguolėlė;4076450179;Taip;7;0;0;7
14866;Žolynėlis;Spanguolėlė;4494255525;Taip;4;1;0;5
14867;Žolynėlis;Spanguolėlė;2493633505;Taip;0;0;6;6
14868;Žolynėlis;Spanguolėlė;6425445537;Taip;0;2;9;11
14869;Žolynėlis;Spanguolėlė;5438607463;Taip;5;0;0;5
14870;Žolynėlis;Spanguolėlė;5208585298;Taip;2;1;0;3
14871;Žolynėlis;Spanguolėlė;7451189254;Taip;0;10;0;10
14872;Žolynėlis;Spanguolėlė;3498596516;Taip;10;0;0;10
14873;Žolynėlis;Spanguolėlė;9498369210;Taip;13;1;0;14
14874;Žolynėlis;Spanguolėlė;7260397656;Taip;12;1;0;13
14875;Žolynėlis;Spanguolėlė;2315947380;Taip;16;0;0;16
14876;Žolynėlis;Spanguolėlė;5074658392;Taip;16;0;0;16
14877;Žolynėlis;Spanguolėlė;6288526291;Ne;5;10;0;15
14878;Žolynėlis;"RŪTELĖ (spec)";1540454207;Taip;2;1;0;3
14879;Žolynėlis;"RŪTELĖ (spec)";4000928238;Taip;6;0;0;6
14880;Žolynėlis;"RŪTELĖ (spec)";5610113641;Taip;5;6;0;11
14881;Žolynėlis;"RŪTELĖ (spec)";9507509872;Taip;0;6;0;6
14882;Žolynėlis;"RŪTELĖ (spec)";2256262371;Taip;2;0;0;2
14883;Žolynėlis;"RŪTELĖ (spec)";8588753136;Taip;23;0;0;23
14884;Žolynėlis;"SAULUTĖ (spec)";9675783636;Taip;3;2;4;9
14885;Žolynėlis;"SAULUTĖ (spec)";7962304738;Taip;0;2;1;3
14886;Žolynėlis;"SAULUTĖ (spec)";6678697536;Taip;13;1;0;14
14887;Žolynėlis;"SAULUTĖ (spec)";6559029399;Taip;3;2;0;5
14888;Žolynėlis;"SAULUTĖ (spec)";3043560150;Taip;5;0;0;5
14889;Žolynėlis;"SAULUTĖ (spec)";3934182673;Taip;15;1;0;16
14890;Žolynėlis;"LINELIS (spec)";2665355759;Taip;0;3;0;3
14891;Žolynėlis;"LINELIS (spec)";1916465295;Taip;6;0;0;6
14892;Žolynėlis;"LINELIS (spec)";3337602618;Ne;1;2;5;8
14893;Žolynėlis;"LINELIS (spec)";8930536051;Taip;3;0;0;3
14894;Žolynėlis;"LINELIS (spec)";2740906284;Taip;18;0;0;18
14895;Žolynėlis;"RASAKILA (spec)";4971887781;Taip;5;1;0;6
14896;Žolynėlis;"RASAKILA (spec)";6510930436;Taip;15;0;0;15
14897;Žolynėlis;"RASAKILA (spec)";6619551947;Taip;0;2;2;4
14898;Žolynėlis;"RASAKILA (spec)";4337084252;Taip;5;1;0;6
14899;Žolynėlis;"RASAKILA (spec)";8839037219;Taip;0;1;0;1
14900;Žolynėlis;"RASAKILA (spec)";4481343085;Ne;18;0;0;18
14901;Žolynėlis;"RAMUNĖLĖS (spec)";8552635547;Taip;0;1;0;1
14902;Žolynėlis;"RAMUNĖLĖS (spec)";4559404699;Taip;0;0;3;3
14903;Žolynėlis;"RAMUNĖLĖS (spec)";1703785525;Taip;9;2;2;13
14904;Žolynėlis;"RAMUNĖLĖS (spec)";2072569949;Taip;9;1;0;10
14905;Žolynėlis;"RAMUNĖLĖS (spec)";1090944316;Taip;0;0;3;3
14906;Žolynėlis;Dobiliukai;2005661306;Taip;0;2;0;2
14907;Žolynėlis;Dobiliukai;2820649587;Taip;0;0;2;2
14908;Žolynėlis;Dobiliukai;7581436340;Taip;4;0;8;12
14909;Žolynėlis;Dobiliukai;6204102296;Taip;5;0;0;5
14910;Žolynėlis;Dobiliukai;3385748516;Taip;14;3;0;17
14911;Žolynėlis;Dobiliukai;4151633786;Taip;4;0;1;5
14912;Žolynėlis;Dobiliukai;2957426163;Taip;0;0;2;2
14913;Žolynėlis;Dobiliukai;5456771327;Taip;1;0;0;1
14914;Žolynėlis;Dobiliukai;8341730420;Taip;0;0;1;1
14915;Žolynėlis;Dobiliukai;5634886191;Taip;2;0;0;2
14916;Žolynėlis;Dobiliukai;3350246193;Taip;0;0;8;8
14917;Žolynėlis;Dobiliukai;5269388947;Taip;0;3;6;9
14918;Žolynėlis;Dobiliukai;1206144208;Taip;6;1;4;11
14919;Žolynėlis;Dobiliukai;1213384150;Taip;0;3;8;11
14920;Žolynėlis;Dobiliukai;7485033527;Taip;0;4;3;7
14921;Žolynėlis;Aguonėlė;3071570864;Taip;0;5;0;5
14922;Žolynėlis;Aguonėlė;1440666914;Taip;0;6;0;6
14923;Žolynėlis;Aguonėlė;1365534272;Taip;10;2;0;12
14924;Žolynėlis;Aguonėlė;2628636018;Taip;0;12;0;12
14925;Žolynėlis;Aguonėlė;6740105842;Taip;4;0;0;4
14926;Žolynėlis;Aguonėlė;3952731134;Taip;1;0;1;2
14927;Žolynėlis;Aguonėlė;6554864184;Ne;0;2;0;2
14928;Žolynėlis;Aguonėlė;9904373687;Taip;8;0;4;12
14929;Žolynėlis;Aguonėlė;9285539649;Taip;5;3;0;8
14930;Žolynėlis;Aguonėlė;5243624422;Taip;0;2;20;22
14931;Žolynėlis;Aguonėlė;6385491699;Ne;6;5;0;11
14932;Žolynėlis;Aguonėlė;4761054847;Taip;16;3;0;19
14933;Žolynėlis;Aguonėlė;6354832415;Taip;5;1;0;6
14934;Žolynėlis;Aguonėlė;9120786116;Taip;0;10;0;10
14935;Žolynėlis;Aguonėlė;1748987196;Ne;5;4;0;9
14936;Žolynėlis;Aguonėlė;4427274462;Taip;9;0;0;9
14937;Žolynėlis;Pienė;3520272555;Taip;0;12;0;12
14938;Žolynėlis;Pienė;2934361190;Taip;0;6;0;6
14939;Žolynėlis;Pienė;6763515483;Taip;2;0;0;2
14940;Žolynėlis;Pienė;1163753820;Taip;1;0;0;1
14941;Žolynėlis;Pienė;9106152447;Taip;0;11;0;11
14942;Žolynėlis;Pienė;1879046798;Taip;0;1;0;1
14943;Žolynėlis;Pienė;9238832484;Taip;15;3;0;18
14944;Žolynėlis;Pienė;3877168024;Taip;11;6;0;17
14945;Žolynėlis;Pienė;6416217971;Taip;0;4;0;4
14946;Žolynėlis;Pienė;4618251201;Ne;0;5;3;8
14947;Žolynėlis;Pienė;5432464074;Taip;0;6;0;6
14948;Žolynėlis;Pienė;1264022895;Ne;5;5;0;10
14949;Žolynėlis;Pienė;8697184617;Taip;1;8;0;9
14950;Žolynėlis;Pienė;8713225753;Taip;0;5;0;5
14951;Žolynėlis;Pienė;5332349177;Taip;0;7;0;7
14952;Žolynėlis;Pienė;5787331165;Taip;0;2;0;2
14953;Žolynėlis;Pienė;5474876914;Ne;6;0;1;7
14954;Žolynėlis;Pienė;3091749692;Ne;5;1;0;6
14955;Žolynėlis;Pienė;2263679711;Ne;10;1;0;11
14956;Žolynėlis;Pienė;5149512625;Ne;0;8;0;8
14957;Žolynėlis;Pienė;5973298389;Taip;0;4;5;9
14958;Žolynėlis;Čiobreliai;5564338170;Taip;19;0;0;19
14959;Žolynėlis;Čiobreliai;6543503409;Taip;0;1;0;1
14960;Žolynėlis;Čiobreliai;8215427354;Taip;0;5;0;5
14961;Žolynėlis;Čiobreliai;8700231970;Taip;3;0;0;3
14962;Žolynėlis;Čiobreliai;7339496409;Taip;2;0;0;2
14963;Žolynėlis;Čiobreliai;2565770471;Taip;0;5;0;5
14964;Žolynėlis;Čiobreliai;6829144389;Taip;0;3;0;3
14965;Žolynėlis;Čiobreliai;4545601535;Taip;0;1;0;1
14966;Žolynėlis;Čiobreliai;7256502393;Taip;5;3;0;8
14967;Žolynėlis;Čiobreliai;1901979061;Ne;0;6;0;6
14968;Žolynėlis;Čiobreliai;8027151284;Taip;6;3;0;9
14969;Žolynėlis;Čiobreliai;5717038791;Taip;2;4;0;6
14970;Žolynėlis;Čiobreliai;1933377698;Ne;0;4;0;4
14971;Žolynėlis;Čiobreliai;2108221942;Taip;5;9;0;14
14972;Žolynėlis;Čiobreliai;2881461471;Taip;0;2;0;2
14973;Žolynėlis;Čiobreliai;2460982987;Ne;8;3;0;11
14974;Žolynėlis;Čiobreliai;7980206574;Taip;3;0;0;3
14975;Žolynėlis;Čiobreliai;3088932720;Taip;0;5;0;5
14976;Žolynėlis;Čiobreliai;4758738231;Taip;5;6;0;11
14977;Žolynėlis;Čiobreliai;6024288147;Taip;0;3;0;3
14978;Žolynėlis;Čiobreliai;1485195267;Taip;0;6;0;6
14979;Žolynėlis;Avietėlė;3293250169;Taip;0;0;1;1
14980;Žolynėlis;Avietėlė;1266614631;Taip;10;0;0;10
14981;Žolynėlis;Avietėlė;2727273826;Taip;2;2;1;5
14982;Žolynėlis;Avietėlė;2718255075;Taip;5;5;0;10
14983;Žolynėlis;Avietėlė;7201413203;Taip;2;5;0;7
14984;Žolynėlis;Avietėlė;4229530366;Taip;8;0;0;8
14985;Žuvėdra;"JŪROS ŽVAIGŽDUTĖS";7272717439;Taip;0;2;4;6
14986;Žuvėdra;"JŪROS ŽVAIGŽDUTĖS";9230342970;Taip;4;3;0;7
14987;Žuvėdra;"JŪROS ŽVAIGŽDUTĖS";2660909247;Taip;0;3;0;3
14988;Žuvėdra;"JŪROS ŽVAIGŽDUTĖS";2092890028;Taip;0;1;5;6
14989;Žuvėdra;"JŪROS ŽVAIGŽDUTĖS";2334342995;Taip;4;3;0;7
14990;Žuvėdra;"JŪROS ŽVAIGŽDUTĖS";5049101816;Taip;0;6;4;10
14991;Žuvėdra;"JŪROS ŽVAIGŽDUTĖS";4011849839;Taip;0;7;0;7
14992;Žuvėdra;"JŪROS ŽVAIGŽDUTĖS";1164464390;Taip;3;1;0;4
14993;Žuvėdra;"JŪROS ŽVAIGŽDUTĖS";1200084485;Taip;10;0;1;11
14994;Žuvėdra;"JŪROS ŽVAIGŽDUTĖS";4177319374;Ne;3;5;0;8
14995;Žuvėdra;"JŪROS ŽVAIGŽDUTĖS";7121154799;Taip;5;8;0;13
14996;Žuvėdra;"JŪROS ŽVAIGŽDUTĖS";7710853637;Taip;0;0;1;1
14997;Žuvėdra;"JŪROS ŽVAIGŽDUTĖS";2858729034;Ne;0;1;5;6
14998;Žuvėdra;"JŪROS ŽVAIGŽDUTĖS";7958768355;Ne;3;0;0;3
14999;Žuvėdra;"JŪROS ŽVAIGŽDUTĖS";6672289932;Taip;6;0;0;6
15000;Žuvėdra;"JŪROS ŽVAIGŽDUTĖS";9733979816;Ne;10;0;3;13
15001;Žuvėdra;"JŪROS ŽVAIGŽDUTĖS";5571732399;Taip;0;0;2;2
15002;Žuvėdra;"JŪROS ŽVAIGŽDUTĖS";3620753237;Taip;3;1;0;4
15003;Žuvėdra;DELFINUKAI;5436158437;Taip;5;1;0;6
15004;Žuvėdra;DELFINUKAI;6952843736;Taip;0;2;0;2
15005;Žuvėdra;DELFINUKAI;2582404760;Taip;0;2;0;2
15006;Žuvėdra;DELFINUKAI;7235005234;Taip;0;0;7;7
15007;Žuvėdra;DELFINUKAI;4702627979;Taip;0;1;0;1
15008;Žuvėdra;DELFINUKAI;5002760763;Taip;6;0;0;6
15009;Žuvėdra;DELFINUKAI;7705946236;Ne;12;2;0;14
15010;Žuvėdra;DELFINUKAI;1974766090;Taip;11;0;0;11
15011;Žuvėdra;DELFINUKAI;8869169590;Ne;1;0;1;2
15012;Žuvėdra;DELFINUKAI;6445790780;Taip;0;0;7;7
15013;Žuvėdra;DELFINUKAI;3069506904;Taip;0;7;0;7
15014;Žuvėdra;DELFINUKAI;5913580058;Ne;0;2;0;2
15015;Žuvėdra;DELFINUKAI;9651268462;Taip;0;3;0;3
15016;Žuvėdra;DELFINUKAI;6309047651;Ne;19;0;0;19
15017;Žuvėdra;OSMINOŽKI;5021263583;Taip;10;0;0;10
15018;Žuvėdra;OSMINOŽKI;63053155507;Taip;0;4;0;4
15019;Žuvėdra;OSMINOŽKI;1941428466;Taip;0;1;0;1
15020;Žuvėdra;OSMINOŽKI;6007871092;Taip;0;2;0;2
15021;Žuvėdra;OSMINOŽKI;2731016281;Taip;0;11;0;11
15022;Žuvėdra;OSMINOŽKI;6612880861;Taip;0;1;0;1
15023;Žuvėdra;OSMINOŽKI;75901332720;Taip;0;3;0;3
15024;Žuvėdra;OSMINOŽKI;14760907606;Taip;23;0;0;23
15025;Žuvėdra;OSMINOŽKI;5684848140;Taip;0;8;0;8
15026;Žuvėdra;OSMINOŽKI;5489757084;Taip;0;5;0;5
15027;Žuvėdra;OSMINOŽKI;5496071972;Taip;0;8;0;8
15028;Žuvėdra;OSMINOŽKI;5273726957;Taip;0;1;0;1
15029;Žuvėdra;OSMINOŽKI;6537464526;Taip;0;11;0;11
15030;Žuvėdra;OSMINOŽKI;5674529681;Taip;0;8;0;8
15031;Žuvėdra;OSMINOŽKI;7630057671;Taip;0;3;0;3
15032;Žuvėdra;OSMINOŽKI;7368183516;Taip;0;7;0;7
15033;Žuvėdra;OSMINOŽKI;3853045274;Taip;0;9;0;9
15034;Žuvėdra;OSMINOŽKI;8822952385;Ne;8;3;0;11
15035;Žuvėdra;OSMINOŽKI;5198825127;Ne;23;0;0;23
15036;Žuvėdra;RUSALAČKA;8700802853;Taip;0;5;0;5
15037;Žuvėdra;RUSALAČKA;1509519996;Taip;0;2;0;2
15038;Žuvėdra;RUSALAČKA;4907571967;Taip;4;0;0;4
15039;Žuvėdra;RUSALAČKA;3613045982;Taip;0;8;0;8
15040;Žuvėdra;RUSALAČKA;7467154866;Ne;0;3;0;3
15041;Žuvėdra;RUSALAČKA;5151984122;Taip;0;5;0;5
15042;Žuvėdra;RUSALAČKA;4715123063;Taip;0;5;0;5
15043;Žuvėdra;RUSALAČKA;6715416675;Taip;6;0;2;8
15044;Žuvėdra;RUSALAČKA;3349158713;Taip;13;3;0;16
15045;Žuvėdra;RUSALAČKA;8942228415;Ne;0;0;1;1
15046;Žuvėdra;RUSALAČKA;8670342549;Taip;0;2;5;7
15047;Žuvėdra;RUSALAČKA;1707519901;Taip;3;5;0;8
15048;Žuvėdra;RUSALAČKA;1810114962;Taip;8;0;0;8
15049;Žuvėdra;RUSALAČKA;1960306957;Taip;0;15;0;15
15050;Žuvėdra;RUSALAČKA;2640238143;Taip;0;9;0;9
15051;Žuvėdra;RUSALAČKA;2577280901;Taip;0;4;1;5
15052;Žuvėdra;RUSALAČKA;5481785360;Taip;11;0;0;11
15053;Žuvėdra;RUSALAČKA;6862766787;Ne;15;0;0;15
15054;Žuvėdra;RUSALAČKA;9011276878;Taip;6;1;0;7
15055;Žuvėdra;RUSALAČKA;7387863175;Taip;0;4;4;8
15056;Žuvėdra;JANTARIKI;8111760611;Taip;17;0;0;17
15057;Žuvėdra;JANTARIKI;4893062971;Taip;6;0;1;7
15058;Žuvėdra;JANTARIKI;1219808187;Ne;7;1;0;8
15059;Žuvėdra;JANTARIKI;9200342856;Taip;0;5;0;5
15060;Žuvėdra;JANTARIKI;2197976174;Taip;10;0;0;10
15061;Žuvėdra;JANTARIKI;4881712317;Taip;10;2;0;12
15062;Žuvėdra;JANTARIKI;7464494386;Taip;5;0;1;6
15063;Žuvėdra;JANTARIKI;1993897043;Taip;7;0;0;7
15064;Žuvėdra;JANTARIKI;3058300342;Taip;9;1;4;14
15065;Žuvėdra;JANTARIKI;7227722516;Ne;15;0;0;15
15066;Žuvėdra;JANTARIKI;9256424331;Taip;14;2;0;16
15067;Žuvėdra;JANTARIKI;7908898376;Taip;5;4;0;9
15068;Žuvėdra;JANTARIKI;2789379055;Taip;5;2;0;7
15069;Žuvėdra;JANTARIKI;9838754800;Taip;5;0;0;5
15070;Žuvėdra;JANTARIKI;1039661177;Taip;8;0;1;9
15071;Žuvėdra;JANTARIKI;1604010000;Taip;15;1;0;16
15072;Žuvėdra;"AUKSINĖ ŽUVELĖ";2844920302;Taip;5;10;0;15
15073;Žuvėdra;"AUKSINĖ ŽUVELĖ";9382616403;Taip;5;0;1;6
15074;Žuvėdra;"AUKSINĖ ŽUVELĖ";2111418502;Taip;5;2;0;7
15075;Žuvėdra;"AUKSINĖ ŽUVELĖ";2323431685;Taip;0;3;0;3
15076;Žuvėdra;"AUKSINĖ ŽUVELĖ";4888533074;Taip;6;7;2;15
15077;Žuvėdra;"AUKSINĖ ŽUVELĖ";2155412338;Taip;16;3;1;20
15078;Žuvėdra;"AUKSINĖ ŽUVELĖ";5009153711;Taip;8;0;0;8
15079;Žuvėdra;"AUKSINĖ ŽUVELĖ";7258677907;Taip;15;0;0;15
15080;Žuvėdra;"AUKSINĖ ŽUVELĖ";4739865462;Taip;6;0;3;9
15081;Žuvėdra;"AUKSINĖ ŽUVELĖ";7135848009;Taip;8;0;0;8
15082;Žuvėdra;"AUKSINĖ ŽUVELĖ";3781157324;Ne;10;0;3;13
15083;Žvangutis;PELIUKŲ;7616874368;Taip;8;0;0;8
15084;Žvangutis;PELIUKŲ;3906808900;Taip;12;3;0;15
15085;Žvangutis;PELIUKŲ;7722153982;Taip;5;0;0;5
15086;Žvangutis;PELIUKŲ;4295016449;Taip;22;0;0;22
15087;Žvangutis;PELIUKŲ;9958554027;Taip;0;3;0;3
15088;Žvangutis;PELIUKŲ;3957064486;Taip;5;4;0;9
15089;Žvangutis;PELIUKŲ;5112520119;Taip;0;8;0;8
15090;Žvangutis;PELIUKŲ;5817402847;Taip;22;0;0;22
15091;Žvangutis;PELIUKŲ;4407484687;Taip;0;5;0;5
15092;Žvangutis;PELIUKŲ;5638068914;Taip;22;0;0;22
15093;Žvangutis;PELIUKŲ;6788355315;Taip;0;5;1;6
15094;Žvangutis;PELIUKŲ;8062689240;Taip;0;4;0;4
15095;Žvangutis;PELIUKŲ;3875906173;Taip;1;1;0;2
15096;Žvangutis;PELIUKŲ;1328464199;Taip;0;11;0;11
15097;Žvangutis;PELIUKŲ;3546672690;Taip;5;1;0;6
15098;Žvangutis;PELIUKŲ;4992231141;Ne;15;0;0;15
15099;Žvangutis;PELIUKŲ;1845924089;Taip;0;1;0;1
15100;Žvangutis;PELIUKŲ;3408933802;Taip;6;0;0;6
15101;Žvangutis;PELIUKŲ;8481666202;Taip;0;4;0;4
15102;Žvangutis;ANČIUKŲ;1420510354;Taip;0;6;0;6
15103;Žvangutis;ANČIUKŲ;9134683276;Taip;0;3;0;3
15104;Žvangutis;ANČIUKŲ;9145365865;Taip;0;11;0;11
15105;Žvangutis;ANČIUKŲ;6701947168;Taip;0;3;0;3
15106;Žvangutis;ANČIUKŲ;3315858185;Taip;23;0;0;23
15107;Žvangutis;ANČIUKŲ;7320625500;Taip;0;2;0;2
15108;Žvangutis;ANČIUKŲ;6110958520;Taip;0;1;0;1
15109;Žvangutis;ANČIUKŲ;6989839997;Taip;14;0;0;14
15110;Žvangutis;ANČIUKŲ;7202747419;Taip;0;6;3;9
15111;Žvangutis;ANČIUKŲ;3817258555;Taip;7;0;0;7
15112;Žvangutis;ANČIUKŲ;3775960571;Taip;0;4;0;4
15113;Žvangutis;ANČIUKŲ;7267340112;Ne;0;9;2;11
15114;Žvangutis;ANČIUKŲ;50889154641;Taip;5;0;0;5
15115;Žvangutis;ANČIUKŲ;1310113034;Taip;0;8;0;8
15116;Žvangutis;ANČIUKŲ;3513746926;Taip;11;1;2;14
15117;Žvangutis;ANČIUKŲ;8511103595;Taip;0;3;5;8
15118;Žvangutis;ANČIUKŲ;6815104137;Taip;2;6;2;10
15119;Žvangutis;ANČIUKŲ;6844824726;Taip;0;0;2;2
15120;Žvangutis;ANČIUKŲ;2600596320;Ne;3;1;0;4
15121;Žvangutis;ANČIUKŲ;1339151674;Taip;0;2;0;2
15122;Žvangutis;PELĖDŽIUKŲ;1322688456;Ne;5;4;0;9
15123;Žvangutis;PELĖDŽIUKŲ;9036869235;Taip;0;1;0;1
15124;Žvangutis;PELĖDŽIUKŲ;2570379643;Taip;6;8;0;14
15125;Žvangutis;PELĖDŽIUKŲ;2623107843;Taip;0;1;0;1
15126;Žvangutis;PELĖDŽIUKŲ;1185135525;Taip;0;4;0;4
15127;Žvangutis;PELĖDŽIUKŲ;2411307963;Taip;0;4;0;4
15128;Žvangutis;PELĖDŽIUKŲ;9468660351;Taip;0;2;0;2
15129;Žvangutis;PELĖDŽIUKŲ;2922083476;Ne;0;6;0;6
15130;Žvangutis;PELĖDŽIUKŲ;1282567366;Taip;0;1;0;1
15131;Žvangutis;PELĖDŽIUKŲ;6068428687;Taip;0;3;0;3
15132;Žvangutis;PELĖDŽIUKŲ;9149037184;Taip;0;16;0;16
15133;Žvangutis;PELĖDŽIUKŲ;5012996199;Taip;0;5;0;5
15134;Žvangutis;PELĖDŽIUKŲ;3276065009;Taip;5;5;0;10
15135;Žvangutis;PELĖDŽIUKŲ;6040986672;Taip;0;12;0;12
15136;Žvangutis;PELĖDŽIUKŲ;2716216474;Taip;5;3;0;8
15137;Žvangutis;PELĖDŽIUKŲ;5723728310;Taip;0;2;0;2
15138;Žvangutis;PELĖDŽIUKŲ;1404378308;Taip;0;6;0;6
15139;Žvangutis;PELĖDŽIUKŲ;6207989105;Taip;0;2;0;2
15140;Žvangutis;PELĖDŽIUKŲ;5539992579;Taip;0;3;0;3
15141;Žvangutis;KAČIUKŲ;7213349517;Taip;3;1;0;4
15142;Žvangutis;KAČIUKŲ;7581320158;Ne;0;2;0;2
15143;Žvangutis;KAČIUKŲ;2296360416;Taip;20;0;0;20
15144;Žvangutis;KAČIUKŲ;7721746116;Taip;0;1;2;3
15145;Žvangutis;KAČIUKŲ;2598842770;Taip;10;0;0;10
15146;Žvangutis;KAČIUKŲ;1142315595;Taip;15;1;0;16
15147;Žvangutis;KAČIUKŲ;9239279639;Taip;0;5;0;5
15148;Žvangutis;KAČIUKŲ;4696437804;Taip;0;14;0;14
15149;Žvangutis;KAČIUKŲ;8492637734;Taip;10;3;0;13
15150;Žvangutis;KAČIUKŲ;2503355659;Taip;15;0;0;15
15151;Žvangutis;KAČIUKŲ;9235884407;Taip;16;3;0;19
15152;Žvangutis;KAČIUKŲ;8360356476;Taip;5;0;0;5
15153;Žvangutis;KAČIUKŲ;8863909185;Taip;0;8;0;8
15154;Žvangutis;KAČIUKŲ;3498584864;Taip;3;0;0;3
15155;Žvangutis;KAČIUKŲ;4408086513;Taip;0;17;0;17
15156;Žvangutis;KAČIUKŲ;1256264382;Taip;0;14;0;14
15157;Žvangutis;KAČIUKŲ;8030520477;Taip;0;4;4;8
15158;Žvangutis;KAČIUKŲ;5166614226;Taip;0;0;2;2
15159;Žvangutis;KAČIUKŲ;8810739982;Taip;7;2;0;9
15160;Žvangutis;KAČIUKŲ;2740875969;Taip;4;0;1;5
15161;Žvangutis;KAČIUKŲ;8269992031;Taip;3;0;4;7
15162;Žvangutis;KAČIUKŲ;1224292338;Taip;11;0;6;17
15163;Žvangutis;KAČIUKŲ;1634651749;Taip;5;0;0;5
15164;Žvangutis;MEŠKUČIŲ;8753815074;Taip;4;0;0;4
15165;Žvangutis;MEŠKUČIŲ;3781959962;Taip;0;0;1;1
15166;Žvangutis;MEŠKUČIŲ;8506809320;Taip;0;3;1;4
15167;Žvangutis;MEŠKUČIŲ;8376022173;Taip;7;0;1;8
15168;Žvangutis;MEŠKUČIŲ;6825952779;Taip;0;9;0;9
15169;Žvangutis;MEŠKUČIŲ;4920234186;Taip;10;0;0;10
15170;Žvangutis;MEŠKUČIŲ;1352736819;Ne;0;0;3;3
15171;Žvangutis;MEŠKUČIŲ;5328547183;Taip;0;10;0;10
15172;Žvangutis;MEŠKUČIŲ;2298103025;Taip;0;3;0;3
15173;Žvangutis;MEŠKUČIŲ;9406190681;Taip;3;0;1;4
15174;Žvangutis;MEŠKUČIŲ;5126809299;Taip;8;0;0;8
15175;Žvangutis;MEŠKUČIŲ;8598396569;Taip;5;1;1;7
15176;Žvangutis;KIŠKUČIŲ;8906823569;Taip;11;0;0;11
15177;Žvangutis;KIŠKUČIŲ;6094686500;Taip;0;0;1;1
15178;Žvangutis;KIŠKUČIŲ;9711017196;Taip;3;0;2;5
15179;Žvangutis;KIŠKUČIŲ;7051007224;Taip;0;6;0;6
15180;Žvangutis;KIŠKUČIŲ;1592158260;Taip;23;0;0;23
15181;Žvangutis;KIŠKUČIŲ;5022657156;Taip;0;0;6;6
15182;Žvangutis;KIŠKUČIŲ;6741623841;Taip;0;0;1;1
15183;Žvangutis;KIŠKUČIŲ;3029382724;Taip;8;0;0;8
15184;Žvangutis;KIŠKUČIŲ;6047042736;Taip;4;0;4;8
15185;Žvangutis;KIŠKUČIŲ;4514606021;Taip;0;10;0;10
15186;Žirniukas;Boružiukų;5311746004;Taip;4;0;2;6
15187;Žirniukas;Boružiukų;6466220057;Taip;0;1;0;1
15188;Žirniukas;Boružiukų;2476906136;Taip;0;2;1;3
15189;Žirniukas;Boružiukų;2785102131;Taip;0;2;0;2
15190;Žirniukas;Boružiukų;6624263476;Taip;0;1;0;1
15191;Žirniukas;Boružiukų;8213507698;Taip;0;3;0;3
15192;Žirniukas;Boružiukų;2528905738;Taip;0;2;0;2
15193;Žirniukas;Boružiukų;6363169823;Taip;8;0;0;8
15194;Žirniukas;Boružiukų;2636634198;Taip;0;9;0;9
15195;Žirniukas;Boružiukų;8148254025;Taip;5;2;1;8
15196;Žirniukas;Boružiukų;6531175340;Taip;0;3;0;3
15197;Žirniukas;Boružiukų;9647374339;Taip;0;3;0;3
15198;Žirniukas;Boružiukų;6641200341;Taip;0;4;0;4
15199;Žirniukas;Boružiukų;3022672028;Taip;16;3;0;19
15200;Žirniukas;Boružiukų;3909152902;Taip;3;0;0;3
15201;Žirniukas;Boružiukų;9896989995;Taip;0;1;0;1
15202;Žirniukas;Boružiukų;5420360864;Taip;0;4;0;4
15203;Žirniukas;Boružiukų;1873446232;Taip;0;0;4;4
15204;Žirniukas;Boružiukų;8294569569;Taip;0;4;7;11
15205;Žirniukas;Boružiukų;7397202752;Taip;3;5;2;10
15206;Žirniukas;Boružiukų;7190628011;Taip;3;0;4;7
15207;Žirniukas;Smalsučiai;2132625724;Taip;0;3;0;3
15208;Žirniukas;Smalsučiai;5761169841;Taip;8;0;0;8
15209;Žirniukas;Smalsučiai;5104110821;Taip;6;0;0;6
15210;Žirniukas;Smalsučiai;5471647472;Taip;0;2;0;2
15211;Žirniukas;Smalsučiai;2151329751;Taip;0;5;0;5
15212;Žirniukas;Smalsučiai;5939918015;Taip;0;1;0;1
15213;Žirniukas;Smalsučiai;2049123663;Taip;6;0;0;6
15214;Žirniukas;Smalsučiai;3010062747;Taip;0;1;0;1
15215;Žirniukas;Smalsučiai;2162238771;Taip;0;2;0;2
15216;Žirniukas;Smalsučiai;1064894307;Taip;0;8;0;8
15217;Žirniukas;Smalsučiai;4378877068;Taip;0;3;0;3
15218;Žirniukas;Smalsučiai;2029018108;Taip;0;5;1;6
15219;Žirniukas;Smalsučiai;2309995947;Taip;11;0;0;11
15220;Žirniukas;Smalsučiai;1162904969;Taip;4;3;0;7
15221;Žirniukas;Smalsučiai;7644911127;Taip;5;0;0;5
15222;Žirniukas;Smalsučiai;1514504241;Taip;0;4;0;4
15223;Žirniukas;Smalsučiai;6180439078;Ne;0;0;3;3
15224;Žirniukas;Smalsučiai;5987510202;Taip;0;2;0;2
15225;Žirniukas;Smalsučiai;1944169398;Taip;0;6;0;6
15226;Žirniukas;Smalsučiai;7975957714;Taip;0;7;3;10
15227;Žirniukas;Smalsučiai;3808838764;Taip;0;5;0;5
15228;Žirniukas;Smalsučiai;9374080010;Taip;9;0;0;9
15229;Žirniukas;Smalsučiai;1678041002;Ne;5;7;0;12
15230;Žirniukas;Gėlyčių;2982628594;Taip;3;0;0;3
15231;Žirniukas;Gėlyčių;6121388208;Taip;10;0;0;10
15232;Žirniukas;Gėlyčių;6201949014;Taip;10;0;3;13
15233;Žirniukas;Gėlyčių;8881187941;Taip;0;14;0;14
15234;Žirniukas;Gėlyčių;5103440019;Taip;3;0;0;3
15235;Žirniukas;Gėlyčių;3370588608;Taip;6;0;0;6
15236;Žirniukas;Gėlyčių;7872611724;Taip;4;0;1;5
15237;Žirniukas;Gėlyčių;9497414375;Taip;0;0;3;3
15238;Žirniukas;Gėlyčių;5422282267;Taip;10;0;1;11
15239;Žirniukas;Gėlyčių;5427116799;Taip;0;0;1;1
15240;Žirniukas;Nykštukų;2489070480;Taip;5;0;2;7
15241;Žirniukas;Nykštukų;2746074694;Taip;11;0;0;11
15242;Žirniukas;Nykštukų;4282344625;Taip;5;1;0;6
15243;Žirniukas;Nykštukų;3874713264;Taip;8;4;0;12
15244;Žirniukas;Nykštukų;1532129054;Taip;0;1;0;1
15245;Žirniukas;Nykštukų;7368124402;Taip;0;14;0;14
15246;Žirniukas;Nykštukų;1635353228;Taip;0;1;0;1
15247;Žirniukas;Nykštukų;2526769571;Taip;0;0;2;2
15248;Žirniukas;Nykštukų;9730269905;Taip;5;0;1;6
15249;Žirniukas;Nykštukų;9478756666;Taip;0;4;0;4
15250;Žirniukas;Nykštukų;4732089209;Taip;8;2;0;10
15251;Žirniukas;Saulytės;2733313392;Taip;0;3;0;3
15252;Žirniukas;Saulytės;9707776533;Taip;2;3;0;5
15253;Žirniukas;Saulytės;7278153529;Taip;0;3;0;3
15254;Žirniukas;Saulytės;7927815250;Taip;0;3;0;3
15255;Žirniukas;Saulytės;2325139043;Taip;10;3;0;13
15256;Žirniukas;Saulytės;4527367786;Taip;0;2;0;2
15257;Žirniukas;Saulytės;3610402086;Taip;3;1;0;4
15258;Žirniukas;Saulytės;6362626389;Taip;0;3;0;3
15259;Žirniukas;Saulytės;9961947583;Taip;0;6;0;6
15260;Žirniukas;Saulytės;9656768968;Taip;0;7;0;7
15261;Žirniukas;Saulytės;4045432303;Taip;7;1;0;8
15262;Žirniukas;Saulytės;1074945082;Taip;10;3;0;13
15263;Žirniukas;Saulytės;1594735501;Taip;0;3;0;3
15264;Žirniukas;Saulytės;4433579937;Ne;0;1;3;4
15265;Žirniukas;Saulytės;4229687519;Taip;0;1;0;1
15266;Žirniukas;Saulytės;8151071354;Ne;12;0;0;12
15267;Žirniukas;Saulytės;8599313527;Ne;0;2;4;6
15268;Žirniukas;Saulytės;4320686646;Taip;0;5;0;5
15269;Žirniukas;Drugelių;6271194358;Taip;0;3;0;3
15270;Žirniukas;Drugelių;9232828844;Taip;0;4;0;4
15271;Žirniukas;Drugelių;5269074776;Taip;0;0;6;6
15272;Žirniukas;Drugelių;3509857181;Ne;0;0;2;2
15273;Žirniukas;Drugelių;1590778538;Taip;3;0;0;3
15274;Žirniukas;Drugelių;9901196251;Taip;6;0;5;11
15275;Žirniukas;Drugelių;2555959199;Taip;5;0;0;5
15276;Žirniukas;Drugelių;4762596462;Taip;0;0;2;2
15277;Žirniukas;Drugelių;5046469974;Taip;7;0;0;7
15278;Žirniukas;Drugelių;1826203483;Ne;8;0;0;8
15279;Žirniukas;Drugelių;4536071547;Taip;0;2;3;5
15280;Žirniukas;Drugelių;6501961029;Taip;0;2;0;2
15281;Žirniukas;Drugelių;3996393849;Taip;8;0;0;8
15282;Žirniukas;Drugelių;7240364379;Taip;0;0;2;2
15283;Žirniukas;Drugelių;6300372863;Taip;1;9;0;10
15284;Žirniukas;Drugelių;5670489807;Taip;0;3;0;3
15285;Žirniukas;Drugelių;9794535841;Taip;14;0;0;14
15286;Žirniukas;Drugelių;1018506580;Taip;0;0;17;17
15287;Žirniukas;Drugelių;6993784924;Taip;0;0;1;1
15288;Žirniukas;Drugelių;9384464752;Taip;0;3;4;7
15289;Žirniukas;Pelėdžiukai;2895924102;Taip;5;0;5;10
15290;Žirniukas;Pelėdžiukai;4347695841;Taip;0;0;2;2
15291;Žirniukas;Pelėdžiukai;9381704756;Taip;5;0;1;6
15292;Žirniukas;Pelėdžiukai;4847093256;Taip;0;2;0;2
15293;Žirniukas;Pelėdžiukai;7356213150;Ne;3;8;0;11
15294;Žirniukas;Pelėdžiukai;7545458622;Taip;16;1;0;17
15295;Žirniukas;Pelėdžiukai;5376080603;Taip;0;0;3;3
15296;Žirniukas;Pelėdžiukai;9511974432;Taip;0;2;1;3
15297;Žirniukas;Pelėdžiukai;7755938379;Taip;2;2;1;5
15298;Žirniukas;Pelėdžiukai;5470692657;Taip;0;2;5;7
15299;Žirniukas;Pelėdžiukai;8690042163;Taip;0;2;6;8
15300;Žirniukas;Pelėdžiukai;8808445761;Ne;4;1;0;5
15301;Žirniukas;Pelėdžiukai;2332260494;Taip;2;0;0;2
15302;Žirniukas;Pelėdžiukai;3907578167;Ne;12;0;0;12
15303;Žirniukas;Pelėdžiukai;4069128550;Taip;18;0;0;18
15304;Žirniukas;ZUIKUČIAI;5613818351;Ne;0;2;2;4
15305;Žirniukas;ZUIKUČIAI;1345594362;Taip;5;1;0;6
15306;Žirniukas;ZUIKUČIAI;1005139737;Taip;7;0;1;8
15307;Žirniukas;ZUIKUČIAI;7081683726;Taip;5;10;0;15
15308;Žirniukas;ZUIKUČIAI;7021496832;Taip;4;0;1;5
15309;Žirniukas;ZUIKUČIAI;4860680720;Taip;11;0;0;11
15310;Žirniukas;ZUIKUČIAI;7269948694;Taip;0;2;5;7
15311;Žirniukas;ZUIKUČIAI;6594686128;Taip;7;0;0;7
15312;Žirniukas;ZUIKUČIAI;9993119353;Taip;0;2;1;3
15313;Žirniukas;ZUIKUČIAI;1679864330;Taip;12;8;0;20
15314;Žirniukas;ZUIKUČIAI;9569187800;Taip;6;2;0;8
15315;Aušra;Kodėlčiukai;2611563172;Taip;0;9;0;9
15316;Aušra;Kodėlčiukai;3420851059;Taip;3;1;0;4
15317;Aušra;Kodėlčiukai;6139706771;Taip;2;0;1;3
15318;Aušra;Kodėlčiukai;7314273812;Taip;10;5;0;15
15319;Aušra;Kodėlčiukai;4540040693;Taip;17;0;0;17
15320;Aušra;Kodėlčiukai;1423840991;Ne;11;0;0;11
15321;Aušra;Kodėlčiukai;5013135853;Taip;5;5;0;10
15322;Aušra;Kodėlčiukai;9728140172;Taip;0;4;0;4
15323;Aušra;Kodėlčiukai;7765504789;Taip;0;6;0;6
15324;Aušra;Kodėlčiukai;8108663467;Taip;3;4;0;7
15325;Aušra;Kodėlčiukai;4824773027;Ne;0;1;0;1
15326;Aušra;Kodėlčiukai;1897365632;Taip;5;6;0;11
15327;Aušra;Kodėlčiukai;7469266085;Taip;0;18;0;18
15328;Aušra;Kodėlčiukai;1010721404;Taip;0;4;0;4
15329;Aušra;Kodėlčiukai;1883185016;Ne;0;1;0;1
15330;Aušra;Kodėlčiukai;9437530221;Taip;8;4;0;12
15331;Aušra;Kodėlčiukai;7367602247;Taip;0;3;0;3
15332;Aušra;Kodėlčiukai;3627487971;Taip;0;3;0;3
15333;Aušra;"4B klasė";92119607174;Taip;13;0;0;13
15334;Aušra;"4B klasė";22923377435;Taip;1;0;0;1
15335;Aušra;"4B klasė";41852924528;Taip;0;23;0;23
15336;Aušra;"4B klasė";58526614808;Taip;0;23;0;23
15337;Aušra;"4B klasė";41039525379;Ne;1;0;0;1
15338;Aušra;"4B klasė";37339481276;Taip;1;0;0;1
15339;Aušra;"4B klasė";45165946624;Taip;1;0;0;1
15340;Aušra;"4B klasė";59107169775;Taip;1;0;0;1
15341;Aušra;"4B klasė";48349819906;Taip;1;0;0;1
15342;Aušra;"4B klasė";71596384638;Taip;1;0;0;1
15343;Aušra;"4B klasė";52332096506;Taip;1;0;0;1
15344;Aušra;"4B klasė";35703433862;Taip;1;0;0;1
15345;Aušra;"4B klasė";6201728036;Taip;0;23;0;23
15346;Aušra;"4B klasė";36889923728;Taip;3;0;0;3
15347;Aušra;"4B klasė";39957179831;Taip;1;0;0;1
15348;Aušra;"4B klasė";52909474598;Ne;1;0;0;1
15349;Aušra;"4B klasė";8901585006;Taip;0;23;0;23
15350;Aušra;"4B klasė";64562667133;Taip;0;23;0;23
15351;Aušra;"4B klasė";95076478544;Ne;1;0;0;1
15352;Aušra;"4B klasė";36899257479;Ne;1;0;0;1
15353;Aušra;"4B klasė";57520886724;Taip;1;0;0;1
15354;Aušra;"4B klasė";1815771421;Taip;1;0;0;1
15355;Aušra;"4B klasė";75433637766;Taip;0;23;0;23
15356;Aušra;"4B klasė";83119050626;Taip;0;23;0;23
15357;Aušra;Smalsučiai;1450251779;Taip;0;8;0;8
15358;Aušra;Smalsučiai;5409157554;Taip;7;0;0;7
15359;Aušra;Smalsučiai;8176840834;Taip;0;4;0;4
15360;Aušra;Smalsučiai;3680329197;Taip;5;0;0;5
15361;Aušra;Smalsučiai;8740755922;Taip;16;1;0;17
15362;Aušra;Smalsučiai;3898178166;Taip;0;2;0;2
15363;Aušra;Smalsučiai;29499576216;Taip;0;3;0;3
15364;Aušra;Smalsučiai;1940882109;Taip;0;3;0;3
15365;Aušra;Smalsučiai;4404047456;Taip;1;1;0;2
15366;Aušra;Smalsučiai;97102749430;Taip;0;1;1;2
15367;Aušra;Smalsučiai;9702136789;Taip;0;5;0;5
15368;Aušra;Smalsučiai;8709340592;Taip;3;0;0;3
15369;Aušra;Smalsučiai;5673568541;Taip;0;0;4;4
15370;Aušra;Smalsučiai;5524681006;Taip;9;3;0;12
15371;Aušra;Smalsučiai;6384243597;Taip;0;7;0;7
15372;Aušra;Smalsučiai;19402768340;Taip;0;16;0;16
15373;Aušra;Smalsučiai;2523842161;Taip;0;2;3;5
15374;Aušra;Smalsučiai;1343532870;Taip;0;2;0;2
15375;Aušra;Smalsučiai;7043021721;Taip;0;17;0;17
15376;Aušra;Smalsučiai;1612662076;Taip;0;13;0;13
15377;Aušra;Smalsučiai;1387254053;Taip;0;2;0;2
15378;Aušra;Smalsučiai;1575761029;Taip;0;3;4;7
15379;Aušra;Smalsučiai;5777939563;Taip;0;1;0;1
15380;Aušra;Smalsučiai;7814902928;Taip;5;12;0;17
15381;Aušra;"1A klasė";84116863778;Taip;1;0;0;1
15382;Aušra;"1A klasė";11053850075;Taip;1;0;0;1
15383;Aušra;"1A klasė";23609052737;Taip;1;0;0;1
15384;Aušra;"1A klasė";1893586984;Taip;8;0;0;8
15385;Aušra;"1A klasė";15657824495;Taip;5;0;0;5
15386;Aušra;"1A klasė";5988529284;Taip;1;0;0;1
15387;Aušra;"1A klasė";79051821501;Taip;5;0;0;5
15388;Aušra;"1A klasė";2062470430;Ne;2;0;0;2
15389;Aušra;"1A klasė";1219257874;Taip;0;23;0;23
15390;Aušra;"1A klasė";4325224130;Ne;2;0;0;2
15391;Aušra;"1B klasė";50687988382;Taip;3;0;0;3
15392;Aušra;"1B klasė";1021183555;Taip;1;0;0;1
15393;Aušra;"1B klasė";8428069167;Taip;2;0;0;2
15394;Aušra;"1B klasė";4024898537;Taip;1;0;0;1
15395;Aušra;"1B klasė";46481555688;Taip;13;0;0;13
15396;Aušra;"1B klasė";70844824182;Ne;15;0;0;15
15397;Aušra;"1B klasė";9940683245;Taip;1;0;0;1
15398;Aušra;"1B klasė";1640356242;Taip;1;0;0;1
15399;Aušra;"1B klasė";7794899167;Taip;2;0;0;2
15400;Aušra;"2A klasė";5468993286;Taip;1;0;0;1
15401;Aušra;"2A klasė";1145863002;Taip;0;23;0;23
15402;Aušra;"2A klasė";1427235223;Taip;2;0;0;2
15403;Aušra;"2A klasė";48817619537;Taip;1;0;0;1
15404;Aušra;"2A klasė";2131349938;Taip;1;0;0;1
15405;Aušra;"2A klasė";42344686036;Taip;1;0;0;1
15406;Aušra;"2A klasė";2647629246;Taip;4;0;0;4
15407;Aušra;"3A klasė";8510995681;Ne;1;0;0;1
15408;Aušra;"3A klasė";9605206310;Taip;6;0;0;6
15409;Aušra;"3A klasė";1396233353;Taip;12;0;0;12
15410;Aušra;"3A klasė";3284383302;Taip;1;0;0;1
15411;Aušra;"3A klasė";13157844661;Taip;1;0;0;1
15412;Aušra;"3A klasė";14157070764;Taip;1;0;0;1
15413;Aušra;"3A klasė";99073448709;Taip;0;23;0;23
15414;Aušra;"3A klasė";68160889669;Taip;2;0;0;2
15415;Aušra;"3A klasė";1437126272;Ne;2;0;0;2
15416;Aušra;"3A klasė";15330844181;Taip;3;0;0;3
15417;Aušra;"3A klasė";39537089288;Taip;1;0;0;1
15418;Aušra;"3A klasė";2062775070;Taip;3;0;0;3
15419;Aušra;"3A klasė";3965445196;Taip;1;0;0;1
15420;Aušra;"3A klasė";85578471272;Taip;1;0;0;1
15421;Aušra;"3A klasė";88655846176;Taip;1;0;0;1
15422;Aušra;"3A klasė";73509864636;Ne;1;0;0;1
15423;Aušra;"3A klasė";27958163601;Taip;1;0;0;1
15424;Aušra;"3A klasė";40499781883;Taip;2;0;0;2
15425;Aušra;"3A klasė";68031503463;Taip;1;0;0;1
15426;Aušra;"3A klasė";81633973264;Taip;4;0;0;4
15427;Aušra;"3A klasė";70233681803;Taip;0;23;0;23
15428;Aušra;"3A klasė";1437385365;Taip;0;23;0;23
15429;Aušra;"3A klasė";51185323645;Ne;0;23;0;23
15430;Aušra;"3A klasė";52985512945;Taip;0;23;0;23
15431;Aušra;"3A klasė";97781409787;Taip;3;0;0;3
15432;Aušra;"3A klasė";474412140;Ne;4;0;0;4
15433;Aušra;"3A klasė";40714551025;Taip;2;0;0;2
15434;Aušra;"3A klasė";58699109274;Taip;5;0;0;5
15435;Aušra;"4A klasė";68481706412;Taip;0;23;0;23
15436;Aušra;"4A klasė";99886964420;Taip;0;23;0;23
15437;Aušra;"4A klasė";19920237804;Taip;2;0;0;2
15438;Aušra;"4A klasė";13361663464;Taip;1;0;0;1
15439;Aušra;"4A klasė";97596344387;Taip;3;0;0;3
15440;Aušra;"4A klasė";97596344387;Taip;3;0;0;3
15441;Aušra;"4A klasė";34795588283;Ne;0;23;0;23
15442;Aušra;"4A klasė";93365393803;Taip;2;0;0;2
15443;Aušra;"4A klasė";52864653926;Taip;3;0;0;3
15444;Aušra;"4A klasė";10272136932;Ne;1;0;0;1
15445;Aušra;"4A klasė";77425098448;Taip;0;23;0;23
15446;Aušra;"4A klasė";42015974556;Taip;2;0;0;2
15447;Aušra;"4A klasė";2113586354;Taip;4;0;0;4
15448;Aušra;"4A klasė";19718806057;Taip;0;23;0;23
15449;Aušra;"4A klasė";21856009403;Taip;0;23;0;23
15450;Aušra;Pabiručiai;7542690501;Taip;7;0;0;7
15451;Aušra;Pabiručiai;9466807067;Taip;8;1;0;9
15452;Aušra;Pabiručiai;6508435821;Taip;10;2;0;12
15453;Aušra;Pabiručiai;7926621700;Taip;3;11;0;14
15454;Aušra;Pabiručiai;8665364744;Taip;23;0;0;23
15455;Aušra;Pabiručiai;6555345047;Taip;11;3;0;14
15456;Aušra;Pabiručiai;7888891808;Taip;10;3;0;13
15457;Aušra;Pabiručiai;8769357172;Taip;0;3;0;3
15458;Aušra;Pabiručiai;1306616759;Taip;8;4;0;12
15459;Aušra;Pabiručiai;5797692122;Ne;4;5;2;11
15460;Aušra;Pabiručiai;4071233786;Taip;6;0;0;6
15461;Aušra;Pabiručiai;4646215025;Taip;8;0;6;14
15462;Aušra;Pabiručiai;7199483890;Ne;7;0;3;10
15463;Aušra;Pabiručiai;3008573040;Ne;0;2;0;2
15464;Aušra;Pabiručiai;7944904281;Taip;12;0;0;12
15465;Aušra;Pabiručiai;3336605264;Taip;4;5;0;9
15466;Aušra;Pabiručiai;7159809546;Taip;0;2;0;2
15467;Aušra;Pabiručiai;3553620602;Taip;10;3;0;13
15468;Aušra;Pabiručiai;3759593393;Taip;4;3;0;7
15469;Aušra;Pabiručiai;2904303784;Taip;4;0;0;4
15470;Aušra;Pabiručiai;6056923592;Taip;9;0;0;9
15471;Aušra;Pabiručiai;3953653896;Taip;12;3;0;15
15472;Aušra;Pabiručiai;2273160688;Taip;9;3;0;12
15473;Aušra;Pabiručiai;8462418277;Taip;8;0;0;8
15474;Aušra;Gudručiai;2271582954;Taip;9;0;0;9
15475;Aušra;Gudručiai;4564561993;Taip;13;0;0;13
15476;Aušra;Gudručiai;9614562473;Taip;0;3;0;3
15477;Aušra;Gudručiai;6658178519;Taip;5;2;0;7
15478;Aušra;Gudručiai;7921251819;Taip;0;3;0;3
15479;Aušra;Gudručiai;9628651723;Ne;10;6;0;16
15480;Aušra;Gudručiai;3343235857;Taip;2;0;0;2
15481;Aušra;Gudručiai;1337138547;Taip;0;3;0;3
15482;Aušra;Gudručiai;3530905126;Taip;0;0;23;23
15483;Aušra;Gudručiai;1429548355;Ne;0;7;0;7
15484;Aušra;Gudručiai;5955385407;Ne;7;2;3;12
15485;Aušra;Gudručiai;2243689816;Taip;0;3;0;3
15486;Aušra;Gudručiai;1693711284;Taip;0;10;0;10
15487;Aušra;Gudručiai;6935310711;Taip;0;3;0;3
15488;Aušra;Gudručiai;3698868934;Taip;0;3;0;3
15489;Aušra;Gudručiai;9079804366;Taip;1;1;0;2
15490;Aušra;Gudručiai;3498143162;Taip;1;1;0;2
15491;Aušra;Gudručiai;5053808615;Taip;9;2;0;11
15492;Aušra;Naminukai;5993984086;Taip;11;1;0;12
15493;Aušra;Naminukai;8884580599;Ne;14;0;0;14
15494;Aušra;Naminukai;6614027605;Taip;13;2;0;15
15495;Aušra;Naminukai;2039920706;Taip;0;7;0;7
15496;Aušra;Naminukai;6965081051;Taip;0;3;0;3
15497;Aušra;Naminukai;2768220823;Taip;7;5;1;13
15498;Aušra;Naminukai;5925213006;Taip;4;0;2;6
15499;Aušra;Naminukai;1630814772;Taip;9;1;0;10
15500;Aušra;Naminukai;9333701196;Taip;5;2;0;7
15501;Aušra;Naminukai;4010347313;Taip;0;17;0;17
15502;Aušra;Naminukai;3860755808;Taip;18;0;0;18
15503;Aušra;Naminukai;4339450816;Taip;0;3;0;3
15504;Aušra;Naminukai;4000881716;Taip;4;5;2;11
15505;Aušra;Naminukai;8021547491;Ne;3;2;2;7
15506;Aušra;Naminukai;5268479689;Taip;3;0;1;4
15507;Aušra;Naminukai;3526010606;Taip;8;1;0;9
15508;Aušra;Naminukai;4163605313;Taip;8;1;0;9
15509;Aušra;Naminukai;3468946868;Taip;22;0;0;22
15510;Aušra;Naminukai;7710131755;Taip;6;0;2;8
15511;Aušra;Naminukai;8584355573;Ne;1;1;2;4
15512;Aušra;Naminukai;2495610772;Taip;5;6;0;11
15513;Aušra;Naminukai;8489362814;Taip;2;0;3;5
15514;Aušra;" 1C klasė";43737170074;Taip;6;0;0;6
15515;Aušra;" 1C klasė";1198248619;Taip;1;0;0;1
15516;Aušra;" 1C klasė";7649832094;Taip;7;0;0;7
15517;Aušra;" 1C klasė";8225188274;Taip;2;0;0;2
15518;Aušra;" 1C klasė";1371282149;Taip;2;0;0;2
15519;Berželis;PČIOLKI;6113571093;Taip;0;3;0;3
15520;Berželis;PČIOLKI;9024992452;Taip;0;3;0;3
15521;Berželis;PČIOLKI;1521982237;Taip;4;2;0;6
15522;Berželis;PČIOLKI;2615440913;Ne;0;3;1;4
15523;Berželis;PČIOLKI;4013215941;Taip;0;3;0;3
15524;Berželis;PČIOLKI;3772780161;Taip;12;1;0;13
15525;Berželis;PČIOLKI;4563582416;Taip;12;1;0;13
15526;Berželis;PČIOLKI;9894751274;Taip;0;2;0;2
15527;Berželis;PČIOLKI;7526006253;Taip;0;9;0;9
15528;Berželis;PČIOLKI;1036370516;Taip;2;3;0;5
15529;Berželis;PČIOLKI;9644196870;Taip;0;3;0;3
15530;Berželis;PČIOLKI;2214171136;Taip;6;3;0;9
15531;Berželis;PČIOLKI;97218091736;Taip;0;2;0;2
15532;Berželis;PČIOLKI;5798989689;Taip;0;3;0;3
15533;Berželis;PČIOLKI;2007064959;Taip;9;3;1;13
15534;Berželis;PČIOLKI;5084171353;Taip;0;3;0;3
15535;Berželis;PČIOLKI;4521372127;Taip;0;1;0;1
15536;Berželis;PČIOLKI;1067618571;Taip;2;3;0;5
15537;Berželis;"BOŽJI KOROVKI";9132058594;Taip;5;3;0;8
15538;Berželis;"BOŽJI KOROVKI";7421059780;Taip;10;0;1;11
15539;Berželis;"BOŽJI KOROVKI";5739847580;Taip;10;0;0;10
15540;Berželis;"BOŽJI KOROVKI";4100740863;Taip;17;0;0;17
15541;Berželis;"BOŽJI KOROVKI";5953387226;Taip;0;23;0;23
15542;Berželis;"BOŽJI KOROVKI";3070917065;Ne;15;3;0;18
15543;Berželis;"BOŽJI KOROVKI";8118040960;Taip;0;2;2;4
15544;Berželis;"BOŽJI KOROVKI";2005082089;Taip;13;1;0;14
15545;Berželis;"BOŽJI KOROVKI";5692603837;Taip;10;1;0;11
15546;Berželis;"BOŽJI KOROVKI";5194480946;Taip;5;1;0;6
15547;Berželis;"BOŽJI KOROVKI";9848723402;Taip;8;3;2;13
15548;Berželis;"BOŽJI KOROVKI";5551459997;Taip;0;3;0;3
15549;Berželis;"BOŽJI KOROVKI";6651007152;Taip;6;0;0;6
15550;Berželis;"BOŽJI KOROVKI";8451877584;Taip;6;0;0;6
15551;Berželis;"BOŽJI KOROVKI";7080168105;Taip;12;1;0;13
15552;Berželis;"BOŽJI KOROVKI";9438498834;Ne;5;0;0;5
15553;Berželis;"BOŽJI KOROVKI";1132252592;Taip;3;1;2;6
15554;Berželis;"BOŽJI KOROVKI";5550598069;Taip;5;0;1;6
15555;Berželis;"BOŽJI KOROVKI";1852964349;Taip;0;0;2;2
15556;Berželis;"BOŽJI KOROVKI";8871199713;Taip;0;4;0;4
15557;Berželis;"BOŽJI KOROVKI";1722262813;Taip;0;6;0;6
15558;Berželis;"BOŽJI KOROVKI";9466461910;Taip;20;0;0;20
15559;Berželis;SOLNYŠKO;1498165322;Taip;3;0;3;6
15560;Berželis;SOLNYŠKO;8737788279;Taip;3;0;0;3
15561;Berželis;SOLNYŠKO;2901168499;Ne;5;0;0;5
15562;Berželis;SOLNYŠKO;7411282628;Taip;20;0;0;20
15563;Berželis;SOLNYŠKO;8957312159;Taip;0;9;0;9
15564;Berželis;SOLNYŠKO;4910899296;Taip;0;0;23;23
15565;Berželis;SOLNYŠKO;1167103292;Taip;0;0;1;1
15566;Berželis;SOLNYŠKO;5408368340;Taip;0;0;5;5
15567;Berželis;SOLNYŠKO;1070751052;Taip;0;0;4;4
15568;Berželis;SOLNYŠKO;5464385395;Taip;0;4;0;4
15569;Berželis;SOLNYŠKO;1424868444;Taip;0;11;0;11
15570;Berželis;SOLNYŠKO;1146976812;Ne;0;4;0;4
15571;Berželis;SOLNYŠKO;6774460279;Taip;23;0;0;23
15572;Berželis;BABOČKI;4923631429;Taip;0;0;2;2
15573;Berželis;BABOČKI;2016194182;Taip;8;2;2;12
15574;Berželis;BABOČKI;2030770943;Taip;4;0;2;6
15575;Berželis;BABOČKI;2667957070;Taip;0;3;0;3
15576;Berželis;BABOČKI;7781031211;Taip;0;11;0;11
15577;Berželis;BABOČKI;2493612905;Ne;0;3;0;3
15578;Berželis;BABOČKI;5688897783;Taip;0;9;0;9
15579;Berželis;BABOČKI;6942559693;Taip;5;0;0;5
15580;Berželis;BABOČKI;9245706377;Taip;9;0;0;9
15581;Berželis;BABOČKI;6352635742;Taip;0;3;0;3
15582;Berželis;BABOČKI;3613459846;Taip;3;0;0;3
15583;Berželis;BABOČKI;8448872491;Taip;8;0;0;8
15584;Berželis;BABOČKI;5069322062;Taip;0;3;0;3
15585;Berželis;BABOČKI;2954451168;Taip;5;0;2;7
15586;Berželis;BABOČKI;9585609150;Taip;6;8;0;14
15587;Berželis;BABOČKI;9091691636;Taip;0;0;5;5
15588;Berželis;BABOČKI;7940591009;Taip;0;0;2;2
15589;Berželis;BABOČKI;4546285993;Taip;5;0;14;19
15590;Berželis;BABOČKI;5876182759;Taip;0;8;0;8
15591;Berželis;BABOČKI;9568910880;Taip;12;0;1;13
15592;Berželis;BABOČKI;6577232093;Taip;3;0;3;6
15593;Berželis;SOVUŠKI;8185887403;Taip;23;0;0;23
15594;Berželis;SOVUŠKI;8989621715;Taip;0;4;0;4
15595;Berželis;SOVUŠKI;1289333809;Taip;12;2;0;14
15596;Berželis;SOVUŠKI;8086074279;Taip;0;14;0;14
15597;Berželis;SOVUŠKI;9273819928;Taip;7;0;0;7
15598;Berželis;SOVUŠKI;9750863775;Taip;6;3;0;9
15599;Berželis;SOVUŠKI;1769470120;Taip;0;17;0;17
15600;Berželis;SOVUŠKI;6706273205;Taip;8;0;0;8
15601;Berželis;SOVUŠKI;2895332184;Ne;13;0;0;13
15602;Berželis;SOVUŠKI;1464998584;Taip;9;0;0;9
15603;Berželis;SOVUŠKI;2844736188;Taip;8;0;0;8
15604;Berželis;SOVUŠKI;3835273594;Taip;6;2;0;8
15605;Berželis;SOVUŠKI;2632535013;Taip;6;1;0;7
15606;Berželis;SOVUŠKI;6698849108;Taip;0;0;3;3
15607;Berželis;SOVUŠKI;1583268041;Taip;1;1;0;2
15608;Berželis;PODSOLNUŠKI;1044720859;Taip;3;0;3;6
15609;Berželis;PODSOLNUŠKI;9945124824;Taip;7;0;2;9
15610;Berželis;PODSOLNUŠKI;8168498937;Taip;9;0;1;10
15611;Berželis;PODSOLNUŠKI;9072126286;Taip;12;0;0;12
15612;Berželis;PODSOLNUŠKI;8633724383;Taip;21;0;0;21
15613;Berželis;PODSOLNUŠKI;2259367998;Taip;10;0;0;10
15614;Berželis;PODSOLNUŠKI;1964320071;Taip;15;0;0;15
15615;Berželis;PODSOLNUŠKI;2615832804;Taip;9;0;0;9
15616;Berželis;PODSOLNUŠKI;9133988149;Taip;0;3;6;9
15617;Berželis;PODSOLNUŠKI;5795151632;Taip;3;0;0;3
15618;Berželis;PODSOLNUŠKI;6686248053;Taip;13;1;0;14
15619;Berželis;PODSOLNUŠKI;5963915092;Taip;8;0;0;8
15620;Berželis;PODSOLNUŠKI;3378237475;Taip;15;0;0;15
15621;Berželis;LAPIUKAI;2539824027;Taip;4;0;0;4
15622;Berželis;LAPIUKAI;2971765753;Taip;0;1;18;19
15623;Berželis;LAPIUKAI;7947225506;Ne;0;0;1;1
15624;Berželis;LAPIUKAI;2144796691;Taip;20;0;0;20
15625;Berželis;LAPIUKAI;1834920753;Taip;7;0;0;7
15626;Berželis;LAPIUKAI;6384939601;Taip;0;0;2;2
15627;Berželis;LAPIUKAI;2794074071;Ne;0;0;3;3
15628;Berželis;LAPIUKAI;9681310544;Taip;4;0;1;5
15629;Berželis;LAPIUKAI;4254592648;Taip;0;0;10;10
15630;Berželis;LAPIUKAI;9543499205;Taip;0;2;0;2
15631;Berželis;LAPIUKAI;9749516260;Taip;7;0;0;7
15632;Berželis;LAPIUKAI;2947072348;Ne;0;0;1;1
15633;Berželis;MEŠKIUKAI;8994102218;Taip;0;2;0;2
15634;Berželis;MEŠKIUKAI;4854931959;Ne;6;0;3;9
15635;Berželis;MEŠKIUKAI;8679005113;Ne;0;0;2;2
15636;Berželis;MEŠKIUKAI;7902774064;Taip;23;0;0;23
15637;Berželis;MEŠKIUKAI;2062794406;Taip;9;0;1;10
15638;Berželis;MEŠKIUKAI;9459031158;Taip;20;0;0;20
15639;Berželis;MEŠKIUKAI;9178527605;Taip;0;3;0;3
15640;Berželis;MEŠKIUKAI;1235617054;Taip;0;5;0;5
15641;Berželis;MEŠKIUKAI;1178588907;Taip;6;0;1;7
15642;Berželis;MEŠKIUKAI;5100214127;Taip;0;0;2;2
15643;Berželis;MEŠKIUKAI;3535856504;Ne;0;0;2;2
15644;Berželis;MEŠKIUKAI;6186408090;Ne;12;0;0;12
15645;Berželis;MEŠKIUKAI;1673524685;Taip;14;0;1;15
15646;Berželis;MEŠKIUKAI;2762946143;Taip;0;9;0;9
15647;Berželis;ŽIEDELIAI;3786609012;Ne;5;0;0;5
15648;Berželis;ŽIEDELIAI;9805181733;Taip;5;0;0;5
15649;Berželis;ŽIEDELIAI;1165300871;Taip;3;0;0;3
15650;Berželis;ŽIEDELIAI;2016827207;Ne;5;0;0;5
15651;Berželis;ŽIEDELIAI;9979442772;Ne;0;0;4;4
15652;Berželis;ŽIEDELIAI;9881246268;Taip;0;0;1;1
15653;Berželis;ŽIEDELIAI;7042967329;Taip;4;0;4;8
15654;Berželis;ŽIEDELIAI;9925865228;Taip;0;0;2;2
15655;Berželis;ŽIEDELIAI;1402975280;Taip;5;1;0;6
15656;Berželis;ŽIEDELIAI;1535940949;Ne;0;19;0;19
15657;Berželis;ŽIEDELIAI;3351114197;Taip;1;5;3;9
15658;Berželis;ŽIEDELIAI;5248880873;Taip;16;0;0;16
15659;Berželis;ŽIEDELIAI;2262911854;Taip;14;0;0;14
15660;Berželis;ŽIEDELIAI;2508532190;Taip;12;0;0;12
15661;Berželis;NYKŠTUKAI;8148104183;Ne;11;0;0;11
15662;Berželis;NYKŠTUKAI;7935684899;Ne;7;0;8;15
15663;Berželis;NYKŠTUKAI;1403664386;Taip;8;2;0;10
15664;Berželis;NYKŠTUKAI;5637168259;Taip;7;0;0;7
15665;Berželis;NYKŠTUKAI;9666648116;Taip;8;0;0;8
15666;Berželis;NYKŠTUKAI;3559065542;Ne;5;3;8;16
15667;Berželis;NYKŠTUKAI;3556594755;Taip;0;0;6;6
15668;Berželis;NYKŠTUKAI;8430372047;Taip;0;3;0;3
15669;Berželis;NYKŠTUKAI;5101382213;Taip;8;0;0;8
15670;Berželis;NYKŠTUKAI;2425621326;Ne;6;0;1;7
15671;Berželis;NYKŠTUKAI;7676141462;Ne;0;6;0;6
15672;Berželis;NYKŠTUKAI;3852021563;Taip;0;0;1;1
15673;Berželis;NYKŠTUKAI;3379227410;Taip;16;0;0;16
15674;Berželis;NYKŠTUKAI;4032178538;Taip;0;4;0;4
15675;Berželis;NYKŠTUKAI;5839964720;Taip;0;2;0;2
15676;Berželis;UOGELĖS;2354237981;Taip;0;0;4;4
15677;Berželis;UOGELĖS;8164697203;Taip;0;3;3;6
15678;Berželis;UOGELĖS;8735934456;Taip;0;0;4;4
15679;Berželis;UOGELĖS;5304917030;Ne;0;0;1;1
15680;Berželis;UOGELĖS;6136155301;Taip;15;0;4;19
15681;Berželis;UOGELĖS;9950641759;Taip;7;0;2;9
15682;Berželis;UOGELĖS;9034464618;Taip;5;0;0;5
15683;Berželis;UOGELĖS;5851732944;Taip;5;0;3;8
15684;Berželis;UOGELĖS;2321608974;Ne;0;0;9;9
15685;Berželis;UOGELĖS;3229996417;Taip;0;0;7;7
15686;Berželis;UOGELĖS;6773760208;Ne;14;0;0;14
15687;Berželis;UOGELĖS;7750905743;Taip;0;2;0;2
15688;Berželis;UOGELĖS;4607486516;Ne;7;0;1;8
15689;Berželis;UOGELĖS;8814953641;Ne;3;0;0;3
15690;Berželis;UOGELĖS;5197350105;Taip;13;0;0;13
15691;Berželis;KODĖLČIUKAI;5786052354;Ne;1;0;0;1
15692;Berželis;KODĖLČIUKAI;5134372871;Taip;0;2;0;2
15693;Berželis;KODĖLČIUKAI;7852089381;Taip;3;0;0;3
15694;Berželis;KODĖLČIUKAI;5751995154;Ne;5;0;0;5
15695;Berželis;KODĖLČIUKAI;7986744784;Ne;3;1;0;4
15696;Berželis;KODĖLČIUKAI;1127524998;Taip;0;4;1;5
15697;Berželis;KODĖLČIUKAI;3951962738;Ne;0;1;0;1
15698;Berželis;KODĖLČIUKAI;2193392844;Ne;4;0;3;7
15699;Berželis;KODĖLČIUKAI;9696962207;Taip;7;0;2;9
15700;Berželis;KODĖLČIUKAI;8286301258;Taip;4;1;0;5
15701;Berželis;KODĖLČIUKAI;8875116641;Taip;0;0;2;2
15702;Berželis;KODĖLČIUKAI;9282593781;Taip;0;11;0;11
15703;Berželis;KODĖLČIUKAI;6500588668;Taip;4;0;1;5
15704;Berželis;KODĖLČIUKAI;3327751482;Ne;9;2;0;11
15705;Berželis;KODĖLČIUKAI;6060490387;Taip;0;0;1;1
15706;Saulutė;Drugeliai;5987478379;Ne;16;0;0;16
15707;Saulutė;Drugeliai;5943795519;Taip;0;1;1;2
15708;Saulutė;Drugeliai;4067009709;Taip;0;4;3;7
15709;Saulutė;Drugeliai;3991128892;Taip;9;0;0;9
15710;Saulutė;Drugeliai;4781756849;Taip;9;0;2;11
15711;Saulutė;Drugeliai;7689842018;Taip;0;0;2;2
15712;Saulutė;Drugeliai;4288298305;Taip;11;1;0;12
15713;Saulutė;Drugeliai;9133269796;Ne;15;0;0;15
15714;Saulutė;Drugeliai;6057938367;Taip;23;0;0;23
15715;Saulutė;Drugeliai;1268204445;Taip;3;1;2;6
15716;Saulutė;Drugeliai;1585403702;Taip;10;0;1;11
15717;Saulutė;Drugeliai;4915192103;Taip;0;0;1;1
15718;Saulutė;Drugeliai;2301903550;Taip;20;3;0;23
15719;Saulutė;Drugeliai;3265401334;Taip;3;5;0;8
15720;Saulutė;Drugeliai;2337702344;Ne;0;2;0;2
15721;Saulutė;Drugeliai;3662919521;Taip;0;3;0;3
15722;Saulutė;Drugeliai;9410517602;Taip;5;0;0;5
15723;Saulutė;Drugeliai;1088813143;Taip;4;0;1;5
15724;Saulutė;Drugeliai;8409958782;Taip;0;1;1;2
15725;Saulutė;Drugeliai;6304028361;Taip;10;0;0;10
15726;Saulutė;"Saulės zuikučiai";8946107286;Taip;0;4;0;4
15727;Saulutė;"Saulės zuikučiai";2397257894;Taip;0;4;0;4
15728;Saulutė;"Saulės zuikučiai";5148542811;Taip;33;0;0;33
15729;Saulutė;"Saulės zuikučiai";2259917151;Taip;1;4;0;5
15730;Saulutė;"Saulės zuikučiai";3749374270;Taip;0;5;0;5
15731;Saulutė;"Saulės zuikučiai";8242602551;Ne;0;3;0;3
15732;Saulutė;"Saulės zuikučiai";5247769309;Taip;7;3;0;10
15733;Saulutė;"Saulės zuikučiai";2816806902;Taip;5;2;0;7
15734;Saulutė;"Saulės zuikučiai";2781003892;Taip;0;2;0;2
15735;Saulutė;"Saulės zuikučiai";5839981073;Ne;2;0;5;7
15736;Saulutė;"Saulės zuikučiai";7888435573;Taip;0;2;1;3
15737;Saulutė;"Saulės zuikučiai";3089541630;Taip;0;2;0;2
15738;Saulutė;"Saulės zuikučiai";1562393383;Taip;0;2;2;4
15739;Saulutė;"Saulės zuikučiai";3272296969;Ne;0;4;0;4
15740;Saulutė;"Saulės zuikučiai";6924891265;Taip;5;1;7;13
15741;Saulutė;"Saulės zuikučiai";4663795223;Taip;0;1;6;7
15742;Saulutė;"Saulės zuikučiai";5931269521;Taip;16;1;5;22
15743;Saulutė;"Saulės zuikučiai";7839168221;Taip;17;0;0;17
15744;Saulutė;"Saulės zuikučiai";4945943570;Ne;8;4;7;19
15745;Saulutė;"Saulės zuikučiai";3730442890;Taip;9;4;1;14
15746;Saulutė;"Saulės zuikučiai";3620722907;Taip;3;4;0;7
15747;Saulutė;Boružėlės;3295289082;Taip;0;5;0;5
15748;Saulutė;Boružėlės;1587328722;Taip;10;0;0;10
15749;Saulutė;Boružėlės;8390767549;Taip;3;3;0;6
15750;Saulutė;Boružėlės;7576532632;Taip;0;0;4;4
15751;Saulutė;Boružėlės;2725491887;Taip;5;0;7;12
15752;Saulutė;Boružėlės;9314889468;Taip;0;3;0;3
15753;Saulutė;Boružėlės;7764493159;Taip;7;3;0;10
15754;Saulutė;Boružėlės;5565832676;Taip;3;3;0;6
15755;Saulutė;Boružėlės;5811810714;Taip;5;1;0;6
15756;Saulutė;Boružėlės;8643975544;Ne;0;0;2;2
15757;Saulutė;Boružėlės;7474989619;Ne;0;13;5;18
15758;Saulutė;Boružėlės;8619163154;Ne;4;10;0;14
15759;Saulutė;Boružėlės;1803710557;Taip;5;0;1;6
15760;Saulutė;Boružėlės;9173336078;Taip;5;1;0;6
15761;Saulutė;Boružėlės;9098663596;Taip;0;0;3;3
15762;Saulutė;Boružėlės;1265174091;Taip;0;0;3;3
15763;Saulutė;Boružėlės;2527027536;Taip;1;3;1;5
15764;Saulutė;Boružėlės;2988010963;Taip;10;0;0;10
15765;Saulutė;Boružėlės;3852862834;Taip;3;5;0;8
15766;Saulutė;Boružėlės;1275552038;Taip;7;0;1;8
15767;Saulutė;Nykštukai;2601822200;Taip;0;3;1;4
15768;Saulutė;Nykštukai;3244850673;Taip;0;7;0;7
15769;Saulutė;Nykštukai;9497439410;Taip;0;5;0;5
15770;Saulutė;Nykštukai;5607937410;Taip;0;5;0;5
15771;Saulutė;Nykštukai;3571751974;Taip;0;0;1;1
15772;Saulutė;Nykštukai;3221612665;Ne;14;1;0;15
15773;Saulutė;Nykštukai;2140277182;Taip;0;3;0;3
15774;Saulutė;Nykštukai;4510990261;Taip;6;0;0;6
15775;Saulutė;Nykštukai;4800144085;Taip;0;0;1;1
15776;Saulutė;Nykštukai;8257363228;Taip;0;3;1;4
15777;Saulutė;Nykštukai;9664809396;Ne;4;0;0;4
15778;Saulutė;Nykštukai;8984040932;Taip;0;4;0;4
15779;Saulutė;Nykštukai;3463428772;Taip;5;2;0;7
15780;Saulutė;Nykštukai;3126468651;Taip;3;1;9;13
15781;Saulutė;Nykštukai;4390098560;Taip;0;3;0;3
15782;Saulutė;Nykštukai;3363212754;Taip;0;5;0;5
15783;Saulutė;Nykštukai;5442075474;Taip;18;0;0;18
15784;Saulutė;Nykštukai;4298556244;Taip;0;0;1;1
15785;Saulutė;Nykštukai;8722717930;Ne;21;0;0;21
15786;Saulutė;Nykštukai;9930330487;Taip;0;0;3;3
15787;Saulutė;Nykštukai;7158455528;Taip;0;3;0;3
15788;Saulutė;Nykštukai;2669711574;Ne;5;8;0;13
15789;Saulutė;Meškiukai;8952893819;Taip;0;13;0;13
15790;Saulutė;Meškiukai;4222649372;Ne;8;5;0;13
15791;Saulutė;Meškiukai;1229624643;Taip;13;0;0;13
15792;Saulutė;Meškiukai;9572394489;Taip;9;0;7;16
15793;Saulutė;Meškiukai;9567511354;Taip;15;0;0;15
15794;Saulutė;Meškiukai;6126870829;Taip;0;20;0;20
15795;Saulutė;Meškiukai;6579874077;Taip;13;4;0;17
15796;Saulutė;Meškiukai;6178908581;Taip;0;9;5;14
15797;Saulutė;Meškiukai;8472510151;Taip;7;0;0;7
15798;Saulutė;Meškiukai;6955061957;Taip;5;15;0;20
15799;Saulutė;Meškiukai;7478215328;Taip;4;2;2;8
15800;Saulutė;Meškiukai;9727366891;Taip;6;0;5;11
15801;Saulutė;Meškiukai;3565818383;Taip;9;0;0;9
15802;Saulutė;Meškiukai;5219429911;Taip;0;11;10;21
15803;Saulutė;Meškiukai;3125186472;Taip;11;0;0;11
15804;Saulutė;Meškiukai;5509365461;Taip;12;0;0;12
15805;Saulutė;Ežiukai;2813274509;Taip;10;0;2;12
15806;Saulutė;Ežiukai;3410606033;Ne;0;8;0;8
15807;Saulutė;Ežiukai;2315812734;Taip;10;0;3;13
15808;Saulutė;Ežiukai;8736917541;Taip;0;9;0;9
15809;Saulutė;Ežiukai;5999318972;Taip;0;1;0;1
15810;Saulutė;Ežiukai;4363210987;Taip;0;2;2;4
15811;Saulutė;Ežiukai;5972503001;Taip;4;0;0;4
15812;Saulutė;Ežiukai;6884472677;Taip;11;0;0;11
15813;Saulutė;Ežiukai;6219942114;Taip;0;0;2;2
15814;Saulutė;Ežiukai;4194586403;Taip;7;0;4;11
15815;Saulutė;Ežiukai;1853984777;Taip;6;0;4;10
15816;Saulutė;Ežiukai;1666301750;Ne;1;0;9;10
15817;Saulutė;Ežiukai;2484025931;Taip;0;15;1;16
15818;Saulutė;Ežiukai;4039065925;Ne;3;0;1;4
15819;Saulutė;Ežiukai;7967532537;Taip;0;0;1;1
15820;Saulutė;Ežiukai;1370201372;Taip;0;5;0;5
15821;Saulutė;Ežiukai;5335820652;Taip;14;0;0;14
15822;Saulutė;Ežiukai;2728669975;Taip;0;4;0;4
15823;Saulutė;Ežiukai;9892855816;Ne;5;0;0;5
15824;Saulutė;Ežiukai;9398356470;Taip;0;0;7;7
15825;Saulutė;Bitutės;5448950324;Taip;13;0;2;15
15826;Saulutė;Bitutės;3948540247;Taip;0;0;2;2
15827;Saulutė;Bitutės;4130972647;Taip;8;0;1;9
15828;Saulutė;Bitutės;3242810449;Taip;4;3;0;7
15829;Saulutė;Bitutės;5897526863;Taip;17;0;2;19
15830;Saulutė;Bitutės;9110162513;Taip;0;0;8;8
15831;Saulutė;Bitutės;1648978545;Taip;10;13;0;23
15832;Saulutė;Bitutės;6927834443;Taip;0;15;3;18
15833;Saulutė;Bitutės;8714520840;Ne;0;3;20;23
15834;Saulutė;Bitutės;9726675673;Taip;15;0;0;15
15835;Saulutė;Bitutės;8520474896;Taip;15;0;0;15
15836;Saulutė;Bitutės;6189637986;Taip;7;2;0;9
15837;Saulutė;Bitutės;7132125341;Taip;3;0;1;4
15838;Saulutė;Bitutės;3215349379;Taip;9;0;6;15
15839;Saulutė;Bitutės;3259790911;Taip;8;0;1;9
15840;Saulutė;Bitutės;7311594119;Taip;10;0;0;10
15841;Saulutė;Pelėdžiukai;8512137633;Taip;8;0;0;8
15842;Saulutė;Pelėdžiukai;4211866191;Taip;5;0;1;6
15843;Saulutė;Pelėdžiukai;2373409300;Taip;0;0;4;4
15844;Saulutė;Pelėdžiukai;8405262902;Taip;18;0;0;18
15845;Saulutė;Pelėdžiukai;1745754752;Taip;0;0;1;1
15846;Saulutė;Pelėdžiukai;4123500930;Ne;0;3;3;6
15847;Saulutė;Pelėdžiukai;1056158093;Taip;13;0;0;13
15848;Saulutė;Pelėdžiukai;8371366346;Taip;0;12;1;13
15849;Saulutė;Pelėdžiukai;6842585310;Taip;9;0;1;10
15850;Saulutė;Pelėdžiukai;1776164273;Taip;0;0;7;7
15851;Saulutė;Pelėdžiukai;5850783789;Taip;0;7;0;7
15852;Saulutė;Pelėdžiukai;6608003946;Taip;0;15;0;15
15853;Saulutė;Pelėdžiukai;7243072252;Taip;0;0;1;1
15854;Saulutė;Pelėdžiukai;2450554594;Taip;0;1;0;1
15855;Saulutė;Pelėdžiukai;7620841597;Taip;10;0;1;11
15856;Saulutė;Pelėdžiukai;7640441297;Taip;0;0;7;7
15857;Saulutė;Pelėdžiukai;6046611248;Ne;0;10;0;10
15858;Saulutė;Pelėdžiukai;4301516165;Taip;0;23;0;23
15859;Saulutė;Pelėdžiukai;7258180835;Ne;0;5;0;5
15860;Saulutė;Pelėdžiukai;2566263680;Ne;4;5;1;10
15861;Saulutė;Pelėdžiukai;9106119465;Ne;3;0;2;5
15862;Saulutė;Zylutės;3228226715;Taip;0;3;4;7
15863;Saulutė;Zylutės;8040751073;Ne;5;0;0;5
15864;Saulutė;Zylutės;2074473832;Taip;1;0;0;1
15865;Saulutė;Zylutės;8041118115;Taip;0;23;0;23
15866;Saulutė;Zylutės;5198558993;Taip;0;23;0;23
15867;Saulutė;Zylutės;6109527712;Ne;0;1;0;1
15868;Saulutė;Zylutės;4686825392;Taip;5;0;0;5
15869;Saulutė;Zylutės;8717210130;Taip;10;0;0;10
15870;Saulutė;Zylutės;5264813819;Taip;0;0;1;1
15871;Saulutė;Zylutės;2885398200;Taip;0;3;1;4
15872;Saulutė;Zylutės;7844396402;Taip;0;1;0;1
15873;Saulutė;Zylutės;7351477901;Taip;0;2;0;2
15874;Saulutė;Zylutės;9146298505;Ne;0;17;0;17
15875;Saulutė;Zylutės;1324799653;Taip;0;7;0;7
15876;Saulutė;Zylutės;3691381351;Taip;0;5;2;7
15877;Saulutė;Zylutės;2010774109;Taip;5;4;0;9
15878;Saulutė;Zylutės;8379304869;Ne;3;4;2;9
15879;Saulutė;Zylutės;66108847230;Taip;0;8;0;8
15880;Saulutė;Zylutės;95439358242;Ne;0;3;0;3
15881;Saulutė;Zylutės;9947607411;Ne;2;2;1;5
15882;Saulutė;Zylutės;3408369823;Taip;0;3;5;8
15883;Saulutė;"1 klasė";1717909005;Taip;0;4;0;4
15884;Saulutė;"1 klasė";87814849917;Taip;0;4;0;4
15885;Saulutė;"1 klasė";84919478493;Taip;0;4;0;4
15886;Saulutė;"1 klasė";1320018338;Taip;0;4;0;4
15887;Saulutė;"1 klasė";8599199376;Taip;0;4;0;4
15888;Saulutė;"1 klasė";8944601874;Taip;1;4;0;5
15889;Saulutė;"1 klasė";3064199909;Taip;1;4;0;5
15890;Saulutė;"1 klasė";1556270046;Taip;0;4;0;4
15891;Saulutė;"1 klasė";4272320685;Taip;1;4;0;5
15892;Saulutė;"1 klasė";1291318940;Taip;5;4;0;9
15893;Saulutė;"1 klasė";1391904744;Taip;0;4;0;4
15894;Saulutė;"1 klasė";6096297366;Ne;2;4;0;6
15895;Saulutė;"1 klasė";1609952589;Taip;1;4;0;5
15896;Saulutė;"1 klasė";1513449225;Taip;0;4;0;4
15897;Saulutė;"1 klasė";7281873166;Taip;2;4;0;6
15898;Saulutė;"1 klasė";1911318708;Taip;0;4;0;4
15899;Saulutė;"1 klasė";28772515317;Taip;0;4;0;4
15900;Saulutė;"1 klasė";1786491396;Taip;0;4;0;4
15901;Saulutė;"1 klasė";1332002470;Taip;0;4;0;4
15902;Saulutė;"1 klasė";9081236999;Ne;0;1;0;1
15903;Saulutė;"1 klasė";16622528829;Taip;0;4;0;4
15904;Saulutė;"1 klasė";61073095949;Taip;8;4;0;12
15905;Saulutė;"1 klasė";3505492809;Taip;1;4;0;5
15906;Saulutė;"1 klasė";8952155496;Ne;0;4;0;4
15907;Saulutė;"1 klasė";9235972927;Taip;0;4;0;4
15908;Saulutė;"1 klasė";2677995903;Taip;0;4;0;4
15909;Saulutė;"1 klasė";1386800520;Ne;2;4;0;6
15910;Saulutė;"1 klasė";89920419797;Taip;0;4;0;4
15911;Saulutė;"2 klasė";45306237230;Taip;2;4;0;6
15912;Saulutė;"2 klasė";79438946697;Taip;0;4;0;4
15913;Saulutė;"2 klasė";79919438191;Ne;4;4;0;8
15914;Saulutė;"2 klasė";29074930927;Taip;1;4;0;5
15915;Saulutė;"2 klasė";8369703027;Taip;2;4;0;6
15916;Saulutė;"2 klasė";21605684303;Taip;0;4;0;4
15917;Saulutė;"2 klasė";31705050946;Taip;7;4;0;11
15918;Saulutė;"2 klasė";2622662153;Taip;4;4;0;8
15919;Saulutė;"2 klasė";9612975694;Taip;8;4;0;12
15920;Saulutė;"2 klasė";37315117916;Taip;1;4;0;5
15921;Saulutė;"2 klasė";3445723020;Ne;0;4;0;4
15922;Saulutė;"2 klasė";14195215027;Taip;8;4;0;12
15923;Saulutė;"2 klasė";2098990667;Taip;0;4;0;4
15924;Saulutė;"2 klasė";27386434894;Taip;0;4;0;4
15925;Saulutė;"2 klasė";77923802656;Taip;0;4;0;4
15926;Saulutė;"2 klasė";46280382280;Taip;0;4;0;4
15927;Saulutė;"2 klasė";1935503629;Taip;1;4;0;5
15928;Saulutė;"2 klasė";75405796772;Taip;20;4;0;24
15929;Saulutė;"2 klasė";1277263391;Taip;0;4;0;4
15930;Saulutė;"2 klasė";97145959022;Taip;1;4;0;5
15931;Saulutė;"2 klasė";64418469679;Taip;0;4;0;4
15932;Saulutė;"2 klasė";77170708225;Taip;8;4;0;12
15933;Saulutė;"2 klasė";4640909915;Ne;1;4;0;5
15934;Saulutė;"2 klasė";65492344097;Taip;0;4;0;4
15935;Saulutė;"2 klasė";1704733670;Ne;0;4;0;4
15936;Saulutė;"2 klasė";1534183935;Taip;0;4;0;4
15937;Saulutė;"2 klasė";5574049005;Taip;2;4;0;6
15938;Saulutė;"2 klasė";1510434265;Taip;0;4;0;4
15939;Saulutė;"3 klasė";1005459768;Taip;0;4;0;4
15940;Saulutė;"3 klasė";1804521229;Taip;4;4;0;8
15941;Saulutė;"3 klasė";76108591835;Ne;0;4;0;4
15942;Saulutė;"3 klasė";1475031090;Taip;2;4;0;6
15943;Saulutė;"3 klasė";3156830821;Taip;1;4;0;5
15944;Saulutė;"3 klasė";5741276602;Taip;0;4;0;4
15945;Saulutė;"3 klasė";3246485288;Taip;0;4;0;4
15946;Saulutė;"3 klasė";44452051978;Ne;0;4;0;4
15947;Saulutė;"3 klasė";78967475616;Ne;2;4;0;6
15948;Saulutė;"3 klasė";89710141573;Taip;0;4;0;4
15949;Saulutė;"3 klasė";25124975646;Taip;0;4;0;4
15950;Saulutė;"3 klasė";3450668814;Taip;0;4;0;4
15951;Saulutė;"3 klasė";8168961080;Ne;3;4;0;7
15952;Saulutė;"3 klasė";57283533169;Taip;0;4;0;4
15953;Saulutė;"3 klasė";76744652185;Taip;1;4;0;5
15954;Saulutė;"3 klasė";97296161595;Taip;0;4;0;4
15955;Saulutė;"3 klasė";87409240076;Taip;5;4;0;9
15956;Saulutė;"3 klasė";1205642335;Taip;1;4;0;5
15957;Saulutė;"3 klasė";2426509692;Ne;1;4;0;5
15958;Saulutė;"3 klasė";36414547943;Taip;0;4;0;4
15959;Saulutė;"3 klasė";99841176399;Taip;0;4;0;4
15960;Saulutė;"3 klasė";21703177024;Taip;1;4;0;5
15961;Saulutė;"3 klasė";1337654926;Taip;0;4;0;4
15962;Saulutė;"3 klasė";54950572289;Taip;1;4;0;5
15963;Saulutė;"3 klasė";13147367113;Taip;3;4;0;7
15964;Saulutė;"3 klasė";2216383015;Taip;1;4;0;5
15965;Saulutė;"3 klasė";1644704074;Taip;0;4;0;4
15966;Saulutė;"3 klasė";96497471950;Taip;1;4;0;5
15967;Saulutė;"3 klasė";6557918941;Ne;0;4;0;4
15968;Saulutė;"4 klasė";5822529731;Taip;0;4;0;4
15969;Saulutė;"4 klasė";67739063665;Ne;3;4;0;7
15970;Saulutė;"4 klasė";13916981850;Taip;2;4;0;6
15971;Saulutė;"4 klasė";39606108938;Ne;0;4;0;4
15972;Saulutė;"4 klasė";81191097069;Taip;0;4;0;4
15973;Saulutė;"4 klasė";92198716772;Taip;4;4;0;8
15974;Saulutė;"4 klasė";16523279366;Taip;0;4;0;4
15975;Saulutė;"4 klasė";2262536579;Taip;2;4;0;6
15976;Saulutė;"4 klasė";2095347468;Ne;14;4;0;18
15977;Saulutė;"4 klasė";2819521168;Taip;0;4;0;4
15978;Saulutė;"4 klasė";37839378248;Taip;0;4;0;4
15979;Saulutė;"4 klasė";8308288099;Ne;0;4;0;4
15980;Saulutė;"4 klasė";30863736694;Taip;6;4;0;10
15981;Saulutė;"4 klasė";12964000357;Taip;1;4;0;5
15982;Saulutė;"4 klasė";54726632101;Taip;10;4;0;14
15983;Saulutė;"4 klasė";25720655179;Taip;4;4;0;8
15984;Saulutė;"4 klasė";45877127245;Taip;3;4;0;7
15985;Saulutė;"4 klasė";82106514982;Taip;3;4;0;7
15986;Saulutė;"4 klasė";61113930769;Taip;0;4;0;4
15987;Saulutė;"4 klasė";5213320470;Ne;0;4;0;4
15988;Saulutė;"4 klasė";90078805222;Taip;0;4;0;4
15989;Saulutė;"4 klasė";50110262859;Taip;1;4;0;5
15990;Saulutė;"4 klasė";42204884890;Ne;2;4;0;6
15991;Svaja;SAULĖGRĄŽA;4189290919;Taip;0;23;0;23
15992;Svaja;SAULĖGRĄŽA;4333001830;Taip;5;0;0;5
15993;Svaja;SAULĖGRĄŽA;3912426942;Taip;2;0;0;2
15994;Svaja;SAULĖGRĄŽA;9680766688;Taip;2;0;3;5
15995;Svaja;SAULĖGRĄŽA;3809817617;Ne;6;0;2;8
15996;Svaja;SAULĖGRĄŽA;3792660330;Taip;3;0;0;3
15997;Svaja;SAULĖGRĄŽA;3563842321;Taip;4;0;0;4
15998;Svaja;SAULĖGRĄŽA;4253831334;Taip;7;2;0;9
15999;Svaja;SAULĖGRĄŽA;3461282516;Taip;3;0;1;4
16000;Svaja;SAULĖGRĄŽA;9240037050;Taip;6;3;0;9
16001;Svaja;SAULĖGRĄŽA;7089640807;Taip;19;0;1;20
16002;Svaja;SAULĖGRĄŽA;6963684639;Taip;8;2;0;10
16003;Svaja;SAULĖGRĄŽA;4510147045;Taip;0;9;0;9
16004;Svaja;SAULĖGRĄŽA;6928763381;Taip;0;22;0;22
16005;Svaja;SAULĖGRĄŽA;3501620040;Taip;6;4;0;10
16006;Svaja;SAULĖGRĄŽA;7575922215;Taip;0;3;0;3
16007;Svaja;SAULĖGRĄŽA;7408966637;Taip;0;4;0;4
16008;Svaja;SAULĖGRĄŽA;7747251736;Taip;0;0;4;4
16009;Svaja;"STEBUKLINGAS ŽIBINTAS";9814969596;Taip;0;6;0;6
16010;Svaja;"STEBUKLINGAS ŽIBINTAS";2200408537;Taip;0;0;3;3
16011;Svaja;"STEBUKLINGAS ŽIBINTAS";3940123543;Taip;6;3;0;9
16012;Svaja;"STEBUKLINGAS ŽIBINTAS";8353427144;Taip;0;0;1;1
16013;Svaja;"STEBUKLINGAS ŽIBINTAS";9843726794;Taip;0;3;1;4
16014;Svaja;"STEBUKLINGAS ŽIBINTAS";4237592104;Ne;0;3;1;4
16015;Svaja;"STEBUKLINGAS ŽIBINTAS";2658828200;Taip;0;2;0;2
16016;Svaja;"STEBUKLINGAS ŽIBINTAS";4290716676;Taip;7;5;0;12
16017;Svaja;"STEBUKLINGAS ŽIBINTAS";9102872020;Taip;5;0;2;7
16018;Svaja;"STEBUKLINGAS ŽIBINTAS";4394417103;Taip;8;3;2;13
16019;Svaja;"STEBUKLINGAS ŽIBINTAS";8827421660;Taip;0;1;0;1
16020;Svaja;"STEBUKLINGAS ŽIBINTAS";7277217069;Taip;0;3;3;6
16021;Svaja;"STEBUKLINGAS ŽIBINTAS";1050291871;Ne;8;3;1;12
16022;Svaja;"STEBUKLINGAS ŽIBINTAS";2188430052;Taip;0;0;7;7
16023;Svaja;"STEBUKLINGAS ŽIBINTAS";1860076171;Ne;5;0;4;9
16024;Svaja;"STEBUKLINGAS ŽIBINTAS";8363418532;Taip;0;0;13;13
16025;Svaja;"STEBUKLINGAS ŽIBINTAS";8172396846;Taip;13;0;0;13
16026;Svaja;"STEBUKLINGAS ŽIBINTAS";9545690301;Taip;0;3;2;5
16027;Svaja;"STEBUKLINGAS ŽIBINTAS";4004383843;Taip;0;5;0;5
16028;Svaja;"STEBUKLINGAS ŽIBINTAS";6128350581;Taip;3;3;0;6
16029;Svaja;"STEBUKLINGAS ŽIBINTAS";1150040935;Taip;7;0;0;7
16030;Svaja;SAULUTĖ;50207734108;Ne;5;3;0;8
16031;Svaja;SAULUTĖ;20473739993;Taip;10;0;0;10
16032;Svaja;SAULUTĖ;30719991872;Ne;3;0;2;5
16033;Svaja;SAULUTĖ;6665752307;Taip;6;0;1;7
16034;Svaja;SAULUTĖ;4968201186;Ne;0;5;0;5
16035;Svaja;SAULUTĖ;8689706130;Taip;0;5;0;5
16036;Svaja;SAULUTĖ;6807834176;Taip;0;0;1;1
16037;Svaja;SAULUTĖ;7020342969;Taip;0;5;0;5
16038;Svaja;SAULUTĖ;2750615517;Taip;14;0;2;16
16039;Svaja;SAULUTĖ;3049808328;Ne;0;0;5;5
16040;Svaja;SAULUTĖ;4341042027;Taip;0;3;1;4
16041;Svaja;SAULUTĖ;3802996573;Ne;9;0;3;12
16042;Svaja;SAULUTĖ;7936765752;Taip;0;3;0;3
16043;Svaja;SAULUTĖ;4293339784;Taip;2;4;0;6
16044;Svaja;SAULUTĖ;9475971731;Taip;4;0;0;4
16045;Svaja;SAULUTĖ;5479482244;Ne;3;0;2;5
16046;Svaja;SAULUTĖ;7473493846;Taip;7;0;1;8
16047;Svaja;SAULUTĖ;5443682744;Taip;4;0;0;4
16048;Svaja;SAULUTĖ;9112198914;Taip;0;3;0;3
16049;Svaja;SAULUTĖ;2166382346;Ne;0;3;0;3
16050;Svaja;SAULUTĖ;8656417794;Taip;3;3;1;7
16051;Svaja;SAULUTĖ;1377813636;Taip;0;4;0;4
16052;Svaja;"AUKSINĖ ŽUVELĖ";9091970902;Taip;7;0;3;10
16053;Svaja;"AUKSINĖ ŽUVELĖ";9826552657;Ne;0;3;0;3
16054;Svaja;"AUKSINĖ ŽUVELĖ";6028471687;Taip;0;0;2;2
16055;Svaja;"AUKSINĖ ŽUVELĖ";1877749103;Taip;10;0;1;11
16056;Svaja;"AUKSINĖ ŽUVELĖ";5033214011;Taip;10;0;0;10
16057;Svaja;"AUKSINĖ ŽUVELĖ";5224855138;Taip;0;1;3;4
16058;Svaja;"AUKSINĖ ŽUVELĖ";5013548619;Taip;0;3;0;3
16059;Svaja;"AUKSINĖ ŽUVELĖ";5908440171;Taip;0;0;2;2
16060;Svaja;"AUKSINĖ ŽUVELĖ";5230444195;Taip;20;0;1;21
16061;Svaja;"AUKSINĖ ŽUVELĖ";1914129062;Taip;10;0;0;10
16062;Svaja;"AUKSINĖ ŽUVELĖ";3567924341;Taip;7;0;0;7
16063;Svaja;"AUKSINĖ ŽUVELĖ";2427918378;Taip;4;0;0;4
16064;Svaja;"AUKSINĖ ŽUVELĖ";7605002899;Taip;0;0;8;8
16065;Svaja;"AUKSINĖ ŽUVELĖ";5198482539;Taip;0;1;0;1
16066;Svaja;"AUKSINĖ ŽUVELĖ";7562678317;Taip;10;0;0;10
16067;Svaja;"PRIE ĮLANKOS";5595087767;Taip;0;3;0;3
16068;Svaja;"PRIE ĮLANKOS";8503177793;Taip;6;0;0;6
16069;Svaja;"PRIE ĮLANKOS";1633236289;Taip;10;5;0;15
16070;Svaja;"PRIE ĮLANKOS";9414846817;Taip;10;0;0;10
16071;Svaja;"PRIE ĮLANKOS";9311520300;Taip;0;0;1;1
16072;Svaja;"PRIE ĮLANKOS";9864664937;Taip;0;3;0;3
16073;Svaja;"PRIE ĮLANKOS";4014493868;Taip;0;3;0;3
16074;Svaja;"PRIE ĮLANKOS";6388514464;Taip;0;3;0;3
16075;Svaja;"PRIE ĮLANKOS";5862570666;Taip;9;0;0;9
16076;Svaja;"PRIE ĮLANKOS";2018689468;Taip;0;3;0;3
16077;Svaja;"PRIE ĮLANKOS";1617844709;Taip;15;0;1;16
16078;Svaja;"PRIE ĮLANKOS";3102257512;Taip;0;15;1;16
16079;Svaja;"PRIE ĮLANKOS";4393041946;Taip;0;0;1;1
16080;Svaja;"PRIE ĮLANKOS";1044733634;Taip;0;3;1;4
16081;Svaja;"PRIE ĮLANKOS";6676145522;Ne;4;3;0;7
16082;Svaja;"PRIE ĮLANKOS";1671495181;Taip;0;3;0;3
16083;Svaja;"PRIE ĮLANKOS";9950569499;Taip;10;0;1;11
16084;Svaja;"PRIE ĮLANKOS";4284157599;Taip;5;0;0;5
16085;Svaja;"PRIE ĮLANKOS";3868254757;Taip;0;2;1;3
16086;Svaja;"PRIE ĮLANKOS";6361228838;Taip;15;0;1;16
16087;Svaja;"PRIE ĮLANKOS";7514587933;Ne;0;9;0;9
16088;Svaja;"1 B klasė";24863928147;Taip;0;3;0;3
16089;Svaja;"1 B klasė";1865658456;Taip;0;3;0;3
16090;Svaja;"1 B klasė";8279605005;Taip;0;23;0;23
16091;Svaja;"1 B klasė";55925058866;Taip;0;23;0;23
16092;Svaja;"1 B klasė";1437557657;Taip;0;6;0;6
16093;Svaja;"1 B klasė";25194696146;Taip;0;3;0;3
16094;Svaja;"1 B klasė";1704075006;Taip;0;3;0;3
16095;Svaja;"1 B klasė";8875237023;Taip;0;3;0;3
16096;Svaja;"1 B klasė";64196174690;Taip;0;23;0;23
16097;Svaja;"1 B klasė";8491275729;Taip;0;3;0;3
16098;Svaja;"1 B klasė";21871530266;Taip;0;3;0;3
16099;Svaja;"1 B klasė";7753488216;Taip;0;3;0;3
16100;Svaja;"1 B klasė";36505115395;Taip;0;23;0;23
16101;Svaja;"1 B klasė";7911488445;Taip;0;4;0;4
16102;Svaja;"1 B klasė";6593047776;Taip;0;4;0;4
16103;Svaja;"1 B klasė";15159708127;Taip;0;6;0;6
16104;Svaja;"1 B klasė";2985196852;Taip;0;3;0;3
16105;Svaja;"1 B klasė";9110985103;Taip;0;3;0;3
16106;Svaja;"1 B klasė";3562817807;Taip;0;7;0;7
16107;Svaja;"1 B klasė";2069150261;Ne;0;7;0;7
16108;Svaja;"1 B klasė";1191494598;Taip;0;3;0;3
16109;Svaja;"1 B klasė";11671380984;Taip;0;9;0;9
16110;Svaja;"1 B klasė";99183628764;Taip;0;4;0;4
16111;Svaja;"1 B klasė";1369637618;Taip;0;3;0;3
16112;Svaja;"1 B klasė";3660152224;Taip;0;3;0;3
16113;Svaja;"1 A klasė";5337604370;Taip;0;3;0;3
16114;Svaja;"1 A klasė";1046879533;Taip;0;3;0;3
16115;Svaja;"1 A klasė";2147266053;Taip;0;8;0;8
16116;Svaja;"1 A klasė";4846025153;Taip;0;3;0;3
16117;Svaja;"1 A klasė";1714711904;Taip;0;4;0;4
16118;Svaja;"1 A klasė";47457128214;Taip;0;3;0;3
16119;Svaja;"1 A klasė";65917456866;Ne;0;4;0;4
16120;Svaja;"1 A klasė";1197826066;Taip;0;3;0;3
16121;Svaja;"1 A klasė";73679997517;Taip;0;3;0;3
16122;Svaja;"1 A klasė";7669562010;Ne;0;6;0;6
16123;Svaja;"1 A klasė";5335776957;Taip;0;23;0;23
16124;Svaja;"1 A klasė";56117509354;Taip;0;3;0;3
16125;Svaja;"1 A klasė";27445299450;Taip;0;3;0;3
16126;Svaja;"1 A klasė";1576498450;Taip;0;3;0;3
16127;Svaja;"1 A klasė";43307670660;Taip;0;3;0;3
16128;Svaja;"1 A klasė";1295012978;Taip;7;3;0;10
16129;Svaja;"1 A klasė";22702341083;Taip;0;4;0;4
16130;Svaja;"1 A klasė";70641067006;Taip;0;8;0;8
16131;Svaja;"1 A klasė";58102699652;Taip;0;3;0;3
16132;Svaja;"1 A klasė";2076060840;Taip;0;3;0;3
16133;Svaja;"1 A klasė";4900757614;Taip;0;3;0;3
16134;Svaja;"1 A klasė";1061894314;Taip;0;6;0;6
16135;Svaja;"1 A klasė";8697355813;Ne;0;7;0;7
16136;Svaja;"1 A klasė";193181908;Ne;0;3;0;3
16137;Svaja;"1 A klasė";193181908;Ne;0;3;0;3
16138;Svaja;"2 A klasė";9628146488;Ne;0;3;0;3
16139;Svaja;"2 A klasė";1562041360;Taip;0;5;0;5
16140;Svaja;"2 A klasė";43223177664;Taip;0;3;0;3
16141;Svaja;"2 A klasė";1017471747;Taip;0;3;0;3
16142;Svaja;"2 A klasė";26500981786;Taip;0;3;0;3
16143;Svaja;"2 A klasė";5522433229;Ne;0;3;0;3
16144;Svaja;"2 A klasė";1400892707;Taip;0;3;0;3
16145;Svaja;"2 A klasė";30027404222;Taip;0;3;0;3
16146;Svaja;"2 A klasė";23112873505;Taip;0;3;0;3
16147;Svaja;"2 A klasė";15246943974;Taip;0;5;0;5
16148;Svaja;"2 A klasė";1297727288;Taip;0;3;0;3
16149;Svaja;"2 A klasė";1304775332;Taip;0;5;0;5
16150;Svaja;"2 A klasė";8198614500;Taip;0;5;0;5
16151;Svaja;"2 A klasė";67462299886;Taip;0;3;0;3
16152;Svaja;"2 A klasė";40856210635;Taip;0;3;0;3
16153;Svaja;"2 A klasė";18733824395;Taip;0;3;0;3
16154;Svaja;"2 A klasė";84508228457;Taip;0;3;0;3
16155;Svaja;"2 A klasė";2058827699;Taip;0;3;0;3
16156;Svaja;"2 A klasė";1352488176;Taip;0;3;0;3
16157;Svaja;"2 A klasė";1660742385;Taip;0;3;0;3
16158;Svaja;"2 A klasė";89042677798;Taip;0;3;0;3
16159;Svaja;"2 A klasė";26902749194;Taip;0;4;0;4
16160;Svaja;"2 A klasė";3022690832;Taip;0;3;0;3
16161;Svaja;"2 A klasė";1943166503;Taip;0;4;0;4
16162;Svaja;"2 A klasė";1048576329;Taip;0;3;0;3
16163;Svaja;"2 B klasė";4804779327;Taip;0;23;0;23
16164;Svaja;"2 B klasė";7719185632;Taip;0;3;0;3
16165;Svaja;"2 B klasė";69028070656;Taip;0;3;0;3
16166;Svaja;"2 B klasė";54745410330;Taip;0;9;0;9
16167;Svaja;"2 B klasė";30036722764;Taip;0;3;0;3
16168;Svaja;"2 B klasė";1509272327;Taip;0;3;0;3
16169;Svaja;"2 B klasė";1601648171;Ne;0;3;0;3
16170;Svaja;"2 B klasė";89316574266;Taip;0;3;0;3
16171;Svaja;"2 B klasė";78293798850;Taip;0;9;0;9
16172;Svaja;"2 B klasė";40814723278;Taip;0;7;0;7
16173;Svaja;"2 B klasė";1967394949;Taip;0;3;0;3
16174;Svaja;"2 B klasė";4881476441;Taip;0;3;0;3
16175;Svaja;"2 B klasė";87432529423;Taip;0;3;0;3
16176;Svaja;"2 B klasė";19887874988;Ne;0;4;0;4
16177;Svaja;"2 B klasė";69413101571;Taip;0;3;0;3
16178;Svaja;"2 B klasė";57216954289;Taip;0;3;0;3
16179;Svaja;"2 B klasė";1655551042;Taip;0;3;0;3
16180;Svaja;"2 B klasė";76618850202;Taip;0;3;0;3
16181;Svaja;"2 B klasė";21608020858;Taip;0;11;0;11
16182;Svaja;"2 B klasė";3077814152;Taip;0;3;0;3
16183;Svaja;"2 B klasė";809734624;Taip;0;5;0;5
16184;Svaja;"2 B klasė";44989143252;Taip;0;7;0;7
16185;Svaja;"2 B klasė";6056157113;Taip;0;3;0;3
16186;Svaja;"2 B klasė";30360097999;Taip;0;23;0;23
16187;Svaja;"2 B klasė";1378219785;Taip;0;3;0;3
16188;Svaja;"3 A klasė";72752022712;Taip;0;5;0;5
16189;Svaja;"3 A klasė";8828911320;Taip;0;4;0;4
16190;Svaja;"3 A klasė";60448774566;Taip;0;4;0;4
16191;Svaja;"3 A klasė";75104768118;Taip;0;4;0;4
16192;Svaja;"3 A klasė";1649920341;Taip;0;4;0;4
16193;Svaja;"3 A klasė";30754812113;Taip;0;4;0;4
16194;Svaja;"3 A klasė";64487515384;Taip;0;23;0;23
16195;Svaja;"3 A klasė";34216516886;Taip;0;4;0;4
16196;Svaja;"3 A klasė";3474439050;Taip;0;8;0;8
16197;Svaja;"3 A klasė";63346231562;Taip;0;23;0;23
16198;Svaja;"3 A klasė";75296600945;Ne;0;5;0;5
16199;Svaja;"3 A klasė";6057524892;Taip;0;23;0;23
16200;Svaja;"3 A klasė";2321739150;Ne;0;9;0;9
16201;Svaja;"3 A klasė";4617061890;Ne;0;7;0;7
16202;Svaja;"3 A klasė";89695643588;Taip;0;7;0;7
16203;Svaja;"3 A klasė";3604946305;Taip;0;5;0;5
16204;Svaja;"3 A klasė";25578518444;Taip;0;6;0;6
16205;Svaja;"3 A klasė";1168637823;Taip;0;4;0;4
16206;Svaja;"3 A klasė";4906784415;Taip;0;9;0;9
16207;Svaja;"3 A klasė";15252353189;Taip;0;23;0;23
16208;Svaja;"3 B klasė";6905550313;Ne;0;23;0;23
16209;Svaja;"3 B klasė";62971657427;Taip;0;4;0;4
16210;Svaja;"3 B klasė";1367687415;Taip;0;6;0;6
16211;Svaja;"3 B klasė";4416877973;Taip;0;4;0;4
16212;Svaja;"3 B klasė";1847775266;Taip;0;23;0;23
16213;Svaja;"3 B klasė";17947580061;Taip;0;4;0;4
16214;Svaja;"3 B klasė";6969692916;Taip;0;4;0;4
16215;Svaja;"3 B klasė";44418402260;Taip;0;4;0;4
16216;Svaja;"3 B klasė";50649509868;Taip;0;4;0;4
16217;Svaja;"3 B klasė";73391331150;Taip;0;4;0;4
16218;Svaja;"3 B klasė";70507326327;Taip;0;23;0;23
16219;Svaja;"3 B klasė";80772711351;Taip;0;4;0;4
16220;Svaja;"3 B klasė";54328462992;Taip;0;23;0;23
16221;Svaja;"3 B klasė";1470843400;Taip;0;4;0;4
16222;Svaja;"3 B klasė";92044111261;Taip;0;4;0;4
16223;Svaja;"3 B klasė";11937575740;Taip;0;6;0;6
16224;Svaja;"3 B klasė";8011137572;Taip;0;4;0;4
16225;Svaja;"3 B klasė";71708072632;Taip;0;5;0;5
16226;Svaja;"3 B klasė";56506642672;Taip;0;5;0;5
16227;Svaja;"3 B klasė";3526873547;Ne;0;23;0;23
16228;Svaja;"3 B klasė";70506691027;Taip;0;23;0;23
16229;Svaja;"3 B klasė";4282243865;Taip;0;23;0;23
16230;Svaja;"4 A klasė";96680395594;Taip;0;4;0;4
16231;Svaja;"4 A klasė";31604152893;Ne;0;4;0;4
16232;Svaja;"4 A klasė";70513111186;Ne;0;4;0;4
16233;Svaja;"4 A klasė";72655912805;Taip;0;4;0;4
16234;Svaja;"4 A klasė";20363553383;Taip;0;9;0;9
16235;Svaja;"4 A klasė";8876971658;Taip;0;5;0;5
16236;Svaja;"4 A klasė";69928474471;Taip;0;21;0;21
16237;Svaja;"4 A klasė";49184638535;Taip;0;23;0;23
16238;Svaja;"4 A klasė";3775578708;Taip;0;11;0;11
16239;Svaja;"4 A klasė";58497063533;Taip;0;7;0;7
16240;Svaja;"4 A klasė";89075087937;Taip;0;23;0;23
16241;Svaja;"4 A klasė";99157757025;Ne;0;4;0;4
16242;Svaja;"4 A klasė";16955510836;Ne;0;4;0;4
16243;Svaja;"4 A klasė";24812635291;Taip;0;7;0;7
16244;Svaja;"4 A klasė";21534170175;Taip;0;4;0;4
16245;Svaja;"4 A klasė";28311552445;Ne;0;23;0;23
16246;Svaja;"4 A klasė";38781141060;Taip;0;4;0;4
16247;Svaja;"4 A klasė";88447528808;Taip;0;8;0;8
16248;Svaja;"4 A klasė";66507774550;Taip;0;4;0;4
16249;Svaja;"4 A klasė";76101749947;Taip;0;23;0;23
16250;Svaja;"4 A klasė";18432518932;Taip;0;4;0;4
16251;Svaja;"4 B klasė";61996055386;Taip;0;23;0;23
16252;Svaja;"4 B klasė";57983452414;Taip;0;23;0;23
16253;Svaja;"4 B klasė";30200636424;Ne;0;23;0;23
16254;Svaja;"4 B klasė";8802243719;Taip;0;23;0;23
16255;Svaja;"4 B klasė";7747921362;Taip;0;23;0;23
16256;Svaja;"4 B klasė";38464012322;Taip;0;4;0;4
16257;Svaja;"4 B klasė";5712106350;Taip;0;4;0;4
16258;Svaja;"4 B klasė";9401605132;Taip;0;4;0;4
16259;Svaja;"4 B klasė";27313057222;Ne;0;23;0;23
16260;Svaja;"4 B klasė";68894832324;Taip;0;22;0;22
16261;Svaja;"4 B klasė";29972474690;Taip;0;23;0;23
16262;Svaja;"4 B klasė";47441661801;Ne;0;4;0;4
16263;Svaja;"4 B klasė";62579722313;Taip;0;4;0;4
16264;Svaja;"4 B klasė";21035820496;Taip;0;23;0;23
16265;Svaja;"4 B klasė";71840791098;Taip;0;4;0;4
16266;Svaja;"4 B klasė";59707838958;Taip;0;23;0;23
16267;Svaja;"4 B klasė";71086654007;Taip;0;23;0;23
16268;Svaja;"4 B klasė";15871540340;Taip;0;23;0;23
16269;Svaja;"4 B klasė";97651620085;Taip;0;6;0;6
16270;Svaja;"4 B klasė";77796846388;Taip;0;23;0;23
16271;Svaja;"4 C klasė";79260508923;Taip;0;4;0;4
16272;Svaja;"4 C klasė";94437606762;Taip;0;23;0;23
16273;Svaja;"4 C klasė";73440582394;Taip;0;23;0;23
16274;Svaja;"4 C klasė";60982723867;Taip;0;23;0;23
16275;Svaja;"4 C klasė";70157518595;Taip;0;23;0;23
16276;Svaja;"4 C klasė";5975083034;Taip;0;23;0;23
16277;Svaja;"4 C klasė";76871144487;Taip;0;23;0;23
16278;Svaja;"4 C klasė";6613028133;Taip;0;4;0;4
16279;Svaja;"4 C klasė";48888360976;Taip;0;4;0;4
16280;Svaja;"4 C klasė";12226488343;Taip;0;23;0;23
16281;Svaja;"4 C klasė";3909240894;Taip;0;4;0;4
16282;Svaja;"4 C klasė";53352329988;Taip;0;4;0;4
16283;Svaja;"4 C klasė";59917024948;Taip;0;4;0;4
16284;Svaja;"4 C klasė";73691352138;Ne;0;4;0;4
16285;Svaja;"4 C klasė";66967032561;Taip;0;4;0;4
16286;Svaja;"4 C klasė";77712240909;Taip;0;4;0;4
16287;Svaja;"4 C klasė";82358174131;Taip;0;4;0;4
16288;Svaja;"4 C klasė";25585032766;Taip;0;23;0;23
16289;Svaja;"4 C klasė";79572045341;Taip;0;23;0;23
16290;Svaja;"3 C klasė";1848422504;Taip;0;14;0;14
16291;Svaja;"3 C klasė";3743948734;Taip;0;17;0;17
16292;Svaja;"3 C klasė";25934507261;Ne;0;5;0;5
16293;Svaja;"3 C klasė";89047123808;Taip;0;15;0;15
16294;Svaja;"3 C klasė";74904581010;Taip;0;23;0;23
16295;Svaja;"3 C klasė";50510924690;Taip;0;4;0;4
16296;Svaja;"3 C klasė";41183537732;Taip;0;11;0;11
16297;Svaja;"3 C klasė";70714898590;Taip;0;3;0;3
16298;Svaja;"3 C klasė";54852358913;Ne;0;23;0;23
16299;Svaja;"3 C klasė";57253216255;Taip;0;14;0;14
16300;Svaja;"3 C klasė";34995551069;Taip;0;23;0;23
16301;Svaja;"3 C klasė";1795682827;Taip;0;4;0;4
16302;Svaja;"3 C klasė";93651139102;Taip;0;4;0;4
16303;Svaja;"3 C klasė";1742951527;Taip;0;6;0;6
16304;Svaja;"3 C klasė";91855230473;Taip;0;5;0;5
16305;Svaja;"3 C klasė";1855559693;Taip;0;23;0;23
16306;Svaja;"3 C klasė";2165716699;Taip;0;8;0;8
16307;Svaja;"3 C klasė";31216445971;Ne;0;23;0;23
16308;Svaja;"3 C klasė";20342193231;Taip;0;4;0;4
16309;Svaja;"3 C klasė";54462393937;Taip;0;5;0;5
16310;Svaja;"3 C klasė";36001411632;Taip;0;3;0;3
16311;Svaja;"3 C klasė";94449039022;Taip;0;23;0;23
16312;Svaja;"3 C klasė";85150525696;Ne;0;3;0;3
16313;Svaja;"3 C klasė";91088224294;Taip;0;19;0;19
16314;Šilelis;PAUKŠTELIAI;6128379060;Taip;18;1;0;19
16315;Šilelis;PAUKŠTELIAI;9653439873;Taip;8;0;0;8
16316;Šilelis;PAUKŠTELIAI;2823486581;Taip;5;0;0;5
16317;Šilelis;PAUKŠTELIAI;6369443270;Taip;0;11;0;11
16318;Šilelis;PAUKŠTELIAI;7595774842;Taip;10;0;2;12
16319;Šilelis;PAUKŠTELIAI;6614686867;Taip;15;0;0;15
16320;Šilelis;PAUKŠTELIAI;3053443777;Taip;17;0;0;17
16321;Šilelis;PAUKŠTELIAI;4960501068;Taip;17;1;0;18
16322;Šilelis;PAUKŠTELIAI;7072057348;Taip;8;0;0;8
16323;Šilelis;PAUKŠTELIAI;5974537364;Taip;15;3;0;18
16324;Šilelis;PAUKŠTELIAI;8166061969;Taip;8;0;0;8
16325;Šilelis;PAUKŠTELIAI;2051644210;Taip;7;0;0;7
16326;Šilelis;PAUKŠTELIAI;1124854378;Taip;18;1;0;19
16327;Šilelis;PAUKŠTELIAI;8184170908;Taip;10;0;0;10
16328;Šilelis;PAUKŠTELIAI;7197420388;Ne;0;13;0;13
16329;Šilelis;PAUKŠTELIAI;9107920165;Ne;0;13;0;13
16330;Šilelis;PAUKŠTELIAI;4432542988;Taip;5;0;0;5
16331;Šilelis;PAUKŠTELIAI;6852463814;Ne;0;5;0;5
16332;Šilelis;PAUKŠTELIAI;9799198904;Taip;13;0;0;13
16333;Šilelis;PAUKŠTELIAI;5493811298;Taip;0;0;1;1
16334;Šilelis;SKRUZDELIUKAI;7502057552;Taip;0;4;0;4
16335;Šilelis;SKRUZDELIUKAI;6099940488;Taip;8;0;0;8
16336;Šilelis;SKRUZDELIUKAI;6139976105;Ne;8;0;0;8
16337;Šilelis;SKRUZDELIUKAI;3823958567;Taip;8;4;0;12
16338;Šilelis;SKRUZDELIUKAI;1887013803;Taip;0;1;3;4
16339;Šilelis;SKRUZDELIUKAI;6359318134;Taip;2;3;1;6
16340;Šilelis;SKRUZDELIUKAI;5598152793;Taip;2;0;2;4
16341;Šilelis;SKRUZDELIUKAI;8090773379;Taip;0;10;0;10
16342;Šilelis;SKRUZDELIUKAI;1200024379;Ne;7;0;0;7
16343;Šilelis;SKRUZDELIUKAI;7299084520;Taip;0;2;0;2
16344;Šilelis;SKRUZDELIUKAI;9589138527;Taip;9;6;0;15
16345;Šilelis;SKRUZDELIUKAI;3967932407;Taip;0;3;0;3
16346;Šilelis;SKRUZDELIUKAI;2972202874;Ne;12;0;0;12
16347;Šilelis;SKRUZDELIUKAI;9461117894;Taip;12;0;0;12
16348;Šilelis;SKRUZDELIUKAI;5817818596;Taip;5;0;5;10
16349;Šilelis;SKRUZDELIUKAI;6827855685;Taip;0;0;2;2
16350;Šilelis;SKRUZDELIUKAI;5091571136;Ne;0;1;0;1
16351;Šilelis;SKRUZDELIUKAI;8297975308;Taip;0;8;0;8
16352;Šilelis;SKRUZDELIUKAI;3381053227;Taip;9;4;0;13
16353;Šilelis;SKRUZDELIUKAI;9276607554;Taip;0;8;0;8
16354;Šilelis;SMERFY;3247333567;Taip;0;2;0;2
16355;Šilelis;SMERFY;6999088222;Taip;0;0;1;1
16356;Šilelis;SMERFY;5665331529;Taip;4;0;0;4
16357;Šilelis;SMERFY;3089270468;Taip;5;8;0;13
16358;Šilelis;SMERFY;7824279279;Ne;0;5;0;5
16359;Šilelis;SMERFY;4504627601;Taip;0;0;1;1
16360;Šilelis;SMERFY;7534468539;Taip;0;3;0;3
16361;Šilelis;SMERFY;6390855924;Ne;3;3;0;6
16362;Šilelis;SMERFY;1821827154;Taip;0;0;1;1
16363;Šilelis;SMERFY;4196893379;Taip;9;0;1;10
16364;Šilelis;SMERFY;1890114622;Taip;0;3;0;3
16365;Šilelis;SMERFY;5025956218;Taip;5;0;0;5
16366;Šilelis;EŽIUKAI;9266061396;Taip;3;0;1;4
16367;Šilelis;EŽIUKAI;4494932923;Taip;0;2;0;2
16368;Šilelis;EŽIUKAI;7074963804;Taip;0;7;0;7
16369;Šilelis;EŽIUKAI;1165219272;Taip;5;0;0;5
16370;Šilelis;EŽIUKAI;4702068672;Taip;0;4;0;4
16371;Šilelis;EŽIUKAI;5020209473;Taip;0;7;0;7
16372;Šilelis;EŽIUKAI;2295849333;Taip;5;3;0;8
16373;Šilelis;EŽIUKAI;5131051261;Taip;5;0;1;6
16374;Šilelis;EŽIUKAI;1883483049;Taip;0;7;0;7
16375;Šilelis;EŽIUKAI;6386996498;Taip;7;0;8;15
16376;Šilelis;EŽIUKAI;4822495270;Taip;10;3;0;13
16377;Šilelis;EŽIUKAI;3211649292;Taip;0;0;3;3
16378;Šilelis;EŽIUKAI;2681063256;Taip;0;0;4;4
16379;Šilelis;EŽIUKAI;7208757038;Taip;0;0;9;9
16380;Šilelis;NYKŠTUKAI;3046954717;Taip;6;0;0;6
16381;Šilelis;NYKŠTUKAI;2862894359;Taip;0;0;1;1
16382;Šilelis;NYKŠTUKAI;3158708835;Taip;10;2;1;13
16383;Šilelis;NYKŠTUKAI;6195580698;Taip;4;0;2;6
16384;Šilelis;NYKŠTUKAI;6107771932;Taip;3;3;0;6
16385;Šilelis;NYKŠTUKAI;4323998445;Taip;5;0;5;10
16386;Šilelis;NYKŠTUKAI;2095572561;Taip;10;0;3;13
16387;Šilelis;NYKŠTUKAI;2161973782;Taip;0;15;0;15
16388;Šilelis;NYKŠTUKAI;4459114205;Taip;5;2;0;7
16389;Šilelis;NYKŠTUKAI;3728633100;Taip;7;1;0;8
16390;Šilelis;NYKŠTUKAI;3999426414;Taip;6;7;0;13
16391;Šilelis;NYKŠTUKAI;5745874033;Taip;0;0;2;2
16392;Šilelis;NYKŠTUKAI;9769483899;Taip;4;3;1;8
16393;Šilelis;NYKŠTUKAI;3120671593;Taip;0;0;1;1
16394;Šilelis;NYKŠTUKAI;2908840424;Taip;15;0;1;16
16395;Šilelis;NYKŠTUKAI;6980045156;Taip;2;0;0;2
16396;Šilelis;NYKŠTUKAI;9685227636;Taip;0;0;1;1
16397;Šilelis;NYKŠTUKAI;4868465692;Taip;11;0;1;12
16398;Šilelis;NYKŠTUKAI;4754544277;Taip;17;0;0;17
16399;Šilelis;ANČIUKAI;1726944289;Taip;5;0;4;9
16400;Šilelis;ANČIUKAI;4336942500;Taip;10;0;0;10
16401;Šilelis;ANČIUKAI;9661578871;Taip;5;0;1;6
16402;Šilelis;ANČIUKAI;6616262730;Taip;0;3;1;4
16403;Šilelis;ANČIUKAI;4323750313;Taip;10;0;2;12
16404;Šilelis;ANČIUKAI;3221398692;Taip;10;0;0;10
16405;Šilelis;ANČIUKAI;6364741317;Taip;10;0;0;10
16406;Šilelis;ANČIUKAI;1325857464;Taip;20;0;1;21
16407;Šilelis;ANČIUKAI;9407916190;Taip;0;5;5;10
16408;Šilelis;ANČIUKAI;8188160849;Taip;0;0;1;1
16409;Šilelis;ANČIUKAI;7128670936;Taip;11;0;1;12
16410;Šilelis;ANČIUKAI;8613748314;Taip;9;1;2;12
16411;Šilelis;ANČIUKAI;8807755852;Taip;5;4;0;9
16412;Šilelis;ANČIUKAI;5926624138;Taip;0;0;2;2
16413;Šilelis;ANČIUKAI;8603589758;Taip;0;0;2;2
16414;Šilelis;KAČIUKAI;9899047136;Taip;0;1;1;2
16415;Šilelis;KAČIUKAI;3216168797;Taip;7;0;0;7
16416;Šilelis;KAČIUKAI;9848760151;Ne;3;6;0;9
16417;Šilelis;KAČIUKAI;8387022157;Taip;13;1;0;14
16418;Šilelis;KAČIUKAI;3393466953;Ne;0;9;0;9
16419;Šilelis;KAČIUKAI;2111979474;Taip;3;1;0;4
16420;Šilelis;KAČIUKAI;8064905796;Taip;0;4;0;4
16421;Šilelis;KAČIUKAI;5176259940;Ne;0;6;2;8
16422;Šilelis;KAČIUKAI;5589764935;Taip;16;0;2;18
16423;Šilelis;KAČIUKAI;7123048946;Taip;4;1;0;5
16424;Šilelis;KAČIUKAI;6479728064;Taip;0;10;0;10
16425;Šilelis;KAČIUKAI;3686287802;Ne;0;1;0;1
16426;Šilelis;KAČIUKAI;2906501601;Taip;0;12;0;12
16427;Šilelis;KAČIUKAI;6510813364;Taip;8;2;0;10
16428;Šilelis;KAČIUKAI;8319185507;Taip;0;1;0;1
16429;Šilelis;KAČIUKAI;8504187981;Ne;0;4;4;8
16430;Šilelis;KAČIUKAI;6470073008;Taip;0;6;0;6
16431;Šilelis;KAČIUKAI;3419284228;Taip;11;0;0;11
16432;Šilelis;KAČIUKAI;3712001932;Taip;0;8;0;8
16433;Šilelis;KAČIUKAI;9106999969;Taip;0;5;0;5
16434;Šilelis;KAČIUKAI;5030871828;Taip;0;0;3;3
16435;Šilelis;KAČIUKAI;6894466509;Taip;7;0;3;10
16436;Šilelis;KAČIUKAI;5026203678;Taip;6;5;1;12
16437;Šilelis;KIŠKUČIAI;8759694551;Taip;0;0;2;2
16438;Šilelis;KIŠKUČIAI;4799789212;Taip;23;0;0;23
16439;Šilelis;KIŠKUČIAI;2209552706;Taip;6;0;2;8
16440;Šilelis;KIŠKUČIAI;3296197220;Taip;3;0;2;5
16441;Šilelis;KIŠKUČIAI;4386065478;Taip;0;6;0;6
16442;Šilelis;KIŠKUČIAI;7043644521;Taip;7;11;0;18
16443;Šilelis;KIŠKUČIAI;8096868221;Taip;0;3;0;3
16444;Šilelis;KIŠKUČIAI;3395084186;Ne;4;0;0;4
16445;Šilelis;KIŠKUČIAI;3382252131;Taip;20;0;0;20
16446;Šilelis;KIŠKUČIAI;9746722034;Taip;7;0;2;9
16447;Šilelis;KIŠKUČIAI;5815768693;Taip;0;0;1;1
16448;Šilelis;KIŠKUČIAI;8598321310;Taip;0;0;10;10
16449;Šilelis;KREGŽDUTĖS;9715544798;Taip;14;0;0;14
16450;Šilelis;KREGŽDUTĖS;1025643459;Taip;10;5;0;15
16451;Šilelis;KREGŽDUTĖS;2896605690;Taip;8;0;1;9
16452;Šilelis;KREGŽDUTĖS;8453070684;Ne;12;0;0;12
16453;Šilelis;KREGŽDUTĖS;1286082219;Taip;0;0;5;5
16454;Šilelis;KREGŽDUTĖS;3068950702;Taip;8;0;0;8
16455;Šilelis;KREGŽDUTĖS;8665357907;Taip;13;1;0;14
16456;Šilelis;KREGŽDUTĖS;1152159735;Taip;8;0;1;9
16457;Šilelis;KREGŽDUTĖS;6630114847;Taip;17;0;0;17
16458;Šilelis;KREGŽDUTĖS;3953114161;Taip;2;1;3;6
16459;Šilelis;KREGŽDUTĖS;2499322761;Taip;20;0;0;20
16460;Šilelis;KREGŽDUTĖS;8659845107;Taip;8;0;0;8
16461;Šilelis;KREGŽDUTĖS;3235890717;Taip;17;0;0;17
16462;Šilelis;KREGŽDUTĖS;8855625488;Taip;2;0;0;2
16463;Šilelis;KREGŽDUTĖS;5223262925;Taip;5;0;0;5
16464;Šilelis;KREGŽDUTĖS;1279361795;Taip;16;0;0;16
16465;Šilelis;PAGRANDUKAI;4814863979;Taip;0;2;0;2
16466;Šilelis;PAGRANDUKAI;9670243727;Taip;0;2;0;2
16467;Šilelis;PAGRANDUKAI;8357287467;Taip;10;0;0;10
16468;Šilelis;PAGRANDUKAI;20525573092;Taip;0;2;0;2
16469;Šilelis;PAGRANDUKAI;3583955729;Taip;3;2;0;5
16470;Šilelis;PAGRANDUKAI;7623203279;Taip;0;0;2;2
16471;Šilelis;PAGRANDUKAI;4340856490;Taip;0;4;0;4
16472;Šilelis;PAGRANDUKAI;3807787648;Taip;0;0;3;3
16473;Šilelis;PAGRANDUKAI;6276408187;Taip;6;0;0;6
16474;Šilelis;PAGRANDUKAI;8416126751;Taip;3;0;3;6
16475;Šilelis;PAGRANDUKAI;2397366916;Taip;7;3;0;10
16476;Šilelis;PAGRANDUKAI;7936978436;Taip;0;2;0;2
16477;Šilelis;PAGRANDUKAI;1747920772;Taip;5;2;0;7
16478;Šilelis;PAGRANDUKAI;3843999609;Taip;5;4;0;9
16479;Šilelis;PAGRANDUKAI;1898004894;Taip;0;2;0;2
16480;Šilelis;PAGRANDUKAI;9427466974;Ne;0;11;0;11
16481;Šilelis;BITUTĖS;2948291866;Taip;0;5;0;5
16482;Šilelis;BITUTĖS;5835209357;Ne;5;0;0;5
16483;Šilelis;BITUTĖS;7512731255;Taip;0;1;2;3
16484;Šilelis;BITUTĖS;9035595952;Taip;0;0;1;1
16485;Šilelis;BITUTĖS;7814807923;Taip;8;4;0;12
16486;Šilelis;BITUTĖS;5305660046;Taip;0;3;0;3
16487;Šilelis;BITUTĖS;9071963194;Ne;6;1;2;9
16488;Šilelis;BITUTĖS;5843337891;Taip;11;0;0;11
16489;Šilelis;BITUTĖS;1960952604;Taip;4;0;5;9
16490;Šilelis;BITUTĖS;3954379433;Taip;6;11;0;17
16491;Šilelis;BITUTĖS;7350013139;Taip;0;14;0;14
16492;Šilelis;BITUTĖS;3879234745;Taip;0;0;3;3
16493;Šilelis;BITUTĖS;3062557053;Taip;4;0;0;4
16494;Šilelis;BITUTĖS;1390916076;Taip;5;0;2;7
16495;Šilelis;BITUTĖS;6143099736;Taip;0;0;2;2
16496;Šilelis;BITUTĖS;2667785768;Taip;7;0;2;9
16497;Šilelis;BITUTĖS;2023309512;Ne;9;0;0;9
16498;Šilelis;BITUTĖS;5210301367;Taip;8;0;0;8
16499;Šilelis;BITUTĖS;5375413045;Taip;0;12;0;12
16500;Šilelis;BITUTĖS;6297546907;Taip;14;0;0;14
16501;Šilelis;BITUTĖS;4682742121;Taip;5;0;0;5
16502;Šilelis;DRUGELIAI;3598370884;Taip;13;3;0;16
16503;Šilelis;DRUGELIAI;1347150938;Taip;5;0;0;5
16504;Šilelis;DRUGELIAI;7636725161;Taip;4;1;0;5
16505;Šilelis;DRUGELIAI;1891388542;Taip;0;3;0;3
16506;Šilelis;DRUGELIAI;5759824196;Taip;0;3;0;3
16507;Šilelis;DRUGELIAI;31906089315;Taip;0;1;0;1
16508;Šilelis;DRUGELIAI;4115738520;Taip;0;2;0;2
16509;Šilelis;DRUGELIAI;3824174896;Taip;0;2;0;2
16510;Šilelis;DRUGELIAI;8090765017;Taip;0;5;0;5
16511;Šilelis;DRUGELIAI;54633547799;Taip;0;3;0;3
16512;Šilelis;DRUGELIAI;1019874215;Taip;0;0;1;1
16513;Šilelis;DRUGELIAI;1638362625;Taip;0;3;0;3
16514;Šilelis;DRUGELIAI;9482667810;Taip;5;0;0;5
16515;Šilelis;DRUGELIAI;6230566495;Taip;0;2;0;2
16516;Šilelis;DRUGELIAI;6523676718;Taip;0;8;0;8
16517;Šilelis;DRUGELIAI;5766702969;Taip;0;4;0;4
16518;Šilelis;DRUGELIAI;1984731000;Taip;0;2;0;2
16519;Šilelis;DRUGELIAI;6104538160;Taip;5;4;0;9
16520;Šilelis;DRUGELIAI;7542121945;Ne;0;2;0;2
16521;Vaduvos;PAGRANDUKAI;8408017356;Taip;0;10;0;10
16522;Vaduvos;PAGRANDUKAI;72724196791;Taip;0;14;0;14
16523;Vaduvos;PAGRANDUKAI;9371067563;Taip;0;2;0;2
16524;Vaduvos;PAGRANDUKAI;4029586203;Taip;0;3;0;3
16525;Vaduvos;PAGRANDUKAI;18035723255;Taip;1;0;0;1
16526;Vaduvos;PAGRANDUKAI;5954492368;Taip;0;1;2;3
16527;Vaduvos;PAGRANDUKAI;7397068779;Ne;0;5;0;5
16528;Vaduvos;PAGRANDUKAI;8875709110;Taip;0;3;0;3
16529;Vaduvos;PAGRANDUKAI;7305111076;Taip;0;1;0;1
16530;Vaduvos;PAGRANDUKAI;68848152670;Ne;0;9;0;9
16531;Vaduvos;PAGRANDUKAI;4105978403;Taip;0;1;0;1
16532;Vaduvos;PAGRANDUKAI;5428067167;Taip;10;1;1;12
16533;Vaduvos;PAGRANDUKAI;3699578284;Taip;10;2;0;12
16534;Vaduvos;PAGRANDUKAI;8299189235;Taip;23;0;0;23
16535;Vaduvos;KODĖLČIUKAI;3010510262;Taip;7;0;0;7
16536;Vaduvos;KODĖLČIUKAI;9429028460;Taip;5;4;0;9
16537;Vaduvos;KODĖLČIUKAI;6210729584;Taip;6;4;0;10
16538;Vaduvos;KODĖLČIUKAI;4177935331;Taip;18;1;0;19
16539;Vaduvos;KODĖLČIUKAI;9983148737;Taip;0;1;0;1
16540;Vaduvos;KODĖLČIUKAI;6810198013;Taip;5;3;1;9
16541;Vaduvos;KODĖLČIUKAI;3641822841;Taip;10;0;2;12
16542;Vaduvos;KODĖLČIUKAI;4270137614;Taip;8;1;2;11
16543;Vaduvos;KODĖLČIUKAI;3682708061;Taip;5;0;0;5
16544;Vaduvos;KODĖLČIUKAI;5262165284;Taip;8;0;2;10
16545;Vaduvos;KODĖLČIUKAI;8603418399;Taip;23;0;0;23
16546;Vaduvos;KODĖLČIUKAI;3096104197;Taip;11;0;1;12
16547;Vaduvos;KODĖLČIUKAI;5761137540;Taip;3;10;0;13
16548;Vaduvos;KODĖLČIUKAI;9597857664;Taip;8;0;0;8
16549;Vaduvos;KODĖLČIUKAI;1054097622;Ne;5;0;6;11
16550;Vaduvos;KODĖLČIUKAI;6013737546;Taip;0;0;13;13
16551;Vaduvos;KODĖLČIUKAI;6991960029;Taip;8;2;0;10
16552;Vaduvos;KODĖLČIUKAI;4789480822;Taip;0;1;0;1
16553;Vaduvos;SMALSUČIAI;3555513755;Taip;0;5;0;5
16554;Vaduvos;SMALSUČIAI;2184711783;Taip;0;0;1;1
16555;Vaduvos;SMALSUČIAI;5573145836;Taip;0;1;0;1
16556;Vaduvos;SMALSUČIAI;7337663549;Taip;0;3;0;3
16557;Vaduvos;SMALSUČIAI;5055972872;Taip;5;2;0;7
16558;Vaduvos;SMALSUČIAI;1423148023;Taip;0;5;0;5
16559;Vaduvos;SMALSUČIAI;3091707832;Ne;8;4;0;12
16560;Vaduvos;SMALSUČIAI;87008942241;Taip;0;3;2;5
16561;Vaduvos;SMALSUČIAI;7181151562;Ne;0;3;0;3
16562;Vaduvos;SMALSUČIAI;7431411663;Taip;0;9;0;9
16563;Vaduvos;SMALSUČIAI;2257135127;Taip;18;0;1;19
16564;Vaduvos;SMALSUČIAI;6462126837;Taip;0;1;0;1
16565;Vaduvos;SMALSUČIAI;1265287458;Taip;10;0;1;11
16566;Vaduvos;SMALSUČIAI;1434871968;Taip;5;5;0;10
16567;Vaduvos;SMALSUČIAI;3948025914;Taip;8;0;7;15
16568;Vaduvos;SMALSUČIAI;6253552951;Ne;0;0;1;1
16569;Vaduvos;GILIUKAI;1277811729;Taip;7;5;0;12
16570;Vaduvos;GILIUKAI;1969325922;Taip;0;2;0;2
16571;Vaduvos;GILIUKAI;5376707663;Ne;0;2;0;2
16572;Vaduvos;GILIUKAI;6409466338;Taip;5;0;0;5
16573;Vaduvos;GILIUKAI;2835635250;Taip;4;0;1;5
16574;Vaduvos;GILIUKAI;2939561403;Taip;10;0;0;10
16575;Vaduvos;GILIUKAI;8188374113;Taip;10;4;0;14
16576;Vaduvos;GILIUKAI;6514406042;Taip;5;0;0;5
16577;Vaduvos;GILIUKAI;3057729267;Taip;10;3;0;13
16578;Vaduvos;GILIUKAI;6346625714;Taip;3;1;0;4
16579;Vaduvos;GILIUKAI;8580834401;Taip;3;0;3;6
16580;Vaduvos;GILIUKAI;9167796462;Taip;12;0;0;12
16581;Vaduvos;GILIUKAI;6276149710;Taip;15;0;3;18
16582;Vaduvos;GILIUKAI;6572776966;Taip;6;0;0;6
16583;Vaduvos;GILIUKAI;6676167440;Ne;5;0;1;6
16584;Vaduvos;GILIUKAI;2957685586;Taip;20;1;0;21
16585;Vaduvos;GILIUKAI;3540548094;Taip;8;0;0;8
16586;Vaduvos;GILIUKAI;8964194121;Taip;12;0;0;12
16587;Vaduvos;GILIUKAI;5297217576;Taip;0;7;0;7
16588;Vaduvos;GILIUKAI;5010914832;Taip;0;2;0;2
16589;Vaduvos;BORUŽĖLĖS;6439773886;Taip;0;7;0;7
16590;Vaduvos;BORUŽĖLĖS;6593754016;Taip;8;9;0;17
16591;Vaduvos;BORUŽĖLĖS;7521846747;Taip;0;9;0;9
16592;Vaduvos;BORUŽĖLĖS;1422507884;Taip;0;5;0;5
16593;Vaduvos;BORUŽĖLĖS;3461756429;Taip;0;3;0;3
16594;Vaduvos;BORUŽĖLĖS;8324927031;Taip;0;0;1;1
16595;Vaduvos;BORUŽĖLĖS;4465504676;Taip;8;0;0;8
16596;Vaduvos;BORUŽĖLĖS;7904713344;Taip;13;0;0;13
16597;Vaduvos;BORUŽĖLĖS;2417613291;Taip;4;0;1;5
16598;Vaduvos;BORUŽĖLĖS;5717064754;Ne;0;0;6;6
16599;Vaduvos;BORUŽĖLĖS;8064111922;Taip;9;0;6;15
16600;Vaduvos;BORUŽĖLĖS;2923920649;Taip;0;5;0;5
16601;Vaduvos;BORUŽĖLĖS;3255011809;Taip;0;6;0;6
16602;Vaduvos;BORUŽĖLĖS;9188471756;Taip;0;2;0;2
16603;Vaduvos;BORUŽĖLĖS;7169054113;Taip;0;10;0;10
16604;Vaduvos;BORUŽĖLĖS;2366843609;Taip;0;10;0;10
16605;Vaduvos;DRUGELIAI;4936598927;Taip;9;3;0;12
16606;Vaduvos;DRUGELIAI;2341467486;Taip;10;0;2;12
16607;Vaduvos;DRUGELIAI;5510687497;Ne;4;4;0;8
16608;Vaduvos;DRUGELIAI;9824469881;Taip;9;0;2;11
16609;Vaduvos;DRUGELIAI;5915272436;Ne;23;0;0;23
16610;Vaduvos;DRUGELIAI;4238942070;Taip;5;0;2;7
16611;Vaduvos;DRUGELIAI;1539465611;Taip;5;0;0;5
16612;Vaduvos;DRUGELIAI;8384302877;Taip;14;0;0;14
16613;Vaduvos;DRUGELIAI;6770559352;Taip;8;0;1;9
16614;Vaduvos;DRUGELIAI;4856601924;Taip;8;2;0;10
16615;Vaduvos;DRUGELIAI;3477273224;Taip;8;0;0;8
16616;Vaduvos;DRUGELIAI;2452309232;Taip;10;2;0;12
16617;Vaduvos;DRUGELIAI;6776150749;Ne;7;0;0;7
16618;Vaduvos;DRUGELIAI;4587836073;Taip;9;4;0;13
16619;Vaduvos;DRUGELIAI;9333495119;Taip;7;8;0;15
16620;Vaduvos;DRUGELIAI;7597268115;Taip;5;0;6;11
16621;Vaduvos;DRUGELIAI;8400344609;Taip;8;0;0;8
16622;Vaduvos;DRUGELIAI;2789503381;Taip;5;3;0;8
16623;Vaduvos;DRUGELIAI;1987969267;Taip;9;3;1;13
16624;Vaduvos;DRUGELIAI;8990472878;Ne;15;0;0;15
16625;Vaduvos;DRUGELIAI;2717887489;Taip;21;0;0;21
16626;Vaduvos;RIEŠUTĖLIAI;6611531526;Taip;9;0;0;9
16627;Vaduvos;RIEŠUTĖLIAI;1466282653;Taip;18;0;1;19
16628;Vaduvos;RIEŠUTĖLIAI;3206096414;Taip;8;0;2;10
16629;Vaduvos;RIEŠUTĖLIAI;8055108164;Taip;15;0;2;17
16630;Vaduvos;RIEŠUTĖLIAI;5509202519;Taip;0;0;4;4
16631;Vaduvos;RIEŠUTĖLIAI;5775152939;Taip;16;0;0;16
16632;Vaduvos;RIEŠUTĖLIAI;8070494719;Taip;0;0;9;9
16633;Vaduvos;RIEŠUTĖLIAI;9232960362;Taip;8;0;5;13
16634;Vaduvos;RIEŠUTĖLIAI;7425991335;Taip;0;0;8;8
16635;Vaduvos;RIEŠUTĖLIAI;7592658267;Taip;0;0;5;5
16636;Vaduvos;RIEŠUTĖLIAI;8533315132;Taip;0;7;0;7
16637;Vaduvos;RIEŠUTĖLIAI;2508650990;Taip;5;7;0;12
16638;Vaduvos;RIEŠUTĖLIAI;6943057114;Taip;4;0;4;8
16639;Vaduvos;RIEŠUTĖLIAI;8669267296;Taip;4;0;0;4
16640;Vaduvos;RIEŠUTĖLIAI;1736248725;Taip;0;8;0;8
16641;Vaduvos;"1 klasė";3174998523;Ne;0;3;0;3
16642;Vaduvos;"1 klasė";1825188497;Taip;0;3;0;3
16643;Vaduvos;"1 klasė";3722349868;Taip;0;3;0;3
16644;Vaduvos;"1 klasė";13888236429;Taip;0;3;0;3
16645;Vaduvos;"1 klasė";5307128703;Taip;0;3;0;3
16646;Vaduvos;"1 klasė";6128582180;Taip;0;3;0;3
16647;Vaduvos;"1 klasė";62183976729;Taip;0;3;0;3
16648;Vaduvos;"1 klasė";93702732546;Taip;0;3;0;3
16649;Vaduvos;"1 klasė";15757662594;Taip;0;3;0;3
16650;Vaduvos;"1 klasė";41870343319;Taip;0;10;0;10
16651;Vaduvos;"1 klasė";4513707989;Ne;0;4;0;4
16652;Vaduvos;"1 klasė";68937983441;Taip;0;8;0;8
16653;Vaduvos;"1 klasė";59616893535;Taip;0;3;0;3
16654;Vaduvos;"1 klasė";22641388717;Taip;0;4;0;4
16655;Vaduvos;"1 klasė";21499108813;Taip;0;3;0;3
16656;Vaduvos;"1 klasė";79437154441;Taip;0;3;0;3
16657;Vaduvos;"1 klasė";46608435244;Taip;0;3;0;3
16658;Vaduvos;"1 klasė";61046090149;Taip;0;3;0;3
16659;Vaduvos;"1 klasė";56280470781;Ne;0;6;0;6
16660;Vaduvos;"1 klasė";11202010413;Taip;0;23;0;23
16661;Vaduvos;"1 klasė";1370696345;Taip;0;4;0;4
16662;Vaduvos;"1 klasė";4342471835;Taip;0;3;0;3
16663;Vaduvos;"1 klasė";9112649520;Taip;0;5;0;5
16664;Vaduvos;"1 klasė";1599595256;Taip;0;3;0;3
16665;Vaduvos;"1 klasė";5435336235;Taip;0;7;0;7
16666;Vaduvos;"1 klasė";1681367373;Taip;0;8;0;8
16667;Vaduvos;"3 klasė";97423576166;Taip;0;3;0;3
16668;Vaduvos;"3 klasė";38504924027;Taip;0;3;0;3
16669;Vaduvos;"3 klasė";96148085691;Taip;0;5;0;5
16670;Vaduvos;"3 klasė";12330772986;Ne;0;3;0;3
16671;Vaduvos;"3 klasė";33277362439;Ne;0;4;0;4
16672;Vaduvos;"3 klasė";32138087379;Taip;0;23;0;23
16673;Vaduvos;"3 klasė";67324784528;Taip;0;3;0;3
16674;Vaduvos;"3 klasė";4807104855;Taip;0;3;0;3
16675;Vaduvos;"3 klasė";2181614424;Taip;0;3;0;3
16676;Vaduvos;"3 klasė";2019573643;Taip;0;3;0;3
16677;Vaduvos;"3 klasė";27419094487;Taip;0;3;0;3
16678;Vaduvos;"3 klasė";89793734700;Taip;0;7;0;7
16679;Vaduvos;"3 klasė";17473821556;Taip;0;10;0;10
16680;Vaduvos;"3 klasė";53866301875;Ne;0;23;0;23
16681;Vaduvos;"3 klasė";7786986697;Taip;0;3;0;3
16682;Vaduvos;"3 klasė";9147332638;Taip;0;3;0;3
16683;Vaduvos;"3 klasė";1532675814;Taip;0;4;0;4
16684;Vaduvos;"3 klasė";98259624669;Taip;0;3;0;3
16685;Vaduvos;"3 klasė";36931517006;Taip;0;3;0;3
16686;Vaduvos;"3 klasė";61243424057;Taip;0;3;0;3
16687;Vaduvos;"3 klasė";30979103892;Taip;0;10;0;10
16688;Vaduvos;"3 klasė";78245732319;Taip;0;3;0;3
16689;Vaduvos;"3 klasė";48433447683;Taip;0;5;0;5
16690;Vaduvos;"3 klasė";85090873161;Ne;0;23;0;23
16691;Vaduvos;"3 klasė";41272273463;Ne;0;3;0;3
16692;Vaduvos;"4 klasė";96473212525;Taip;0;6;0;6
16693;Vaduvos;"4 klasė";75428164558;Taip;0;3;0;3
16694;Vaduvos;"4 klasė";63286903462;Taip;0;8;0;8
16695;Vaduvos;"4 klasė";13721939854;Taip;0;10;0;10
16696;Vaduvos;"4 klasė";1171210935;Taip;0;4;0;4
16697;Vaduvos;"4 klasė";7172286009;Taip;0;3;0;3
16698;Vaduvos;"4 klasė";6049882391;Ne;0;23;0;23
16699;Vaduvos;"4 klasė";38013859931;Taip;0;8;0;8
16700;Vaduvos;"4 klasė";4591744662;Taip;0;3;0;3
16701;Vaduvos;"4 klasė";9149523910;Taip;0;3;0;3
16702;Vaduvos;"4 klasė";76662161382;Taip;0;3;0;3
16703;Vaduvos;"4 klasė";26934740147;Taip;0;7;0;7
16704;Vaduvos;"4 klasė";18300713872;Taip;0;23;0;23
16705;Vaduvos;"4 klasė";768455288;Taip;0;3;0;3
16706;Vaduvos;"4 klasė";1768173501;Taip;0;9;0;9
16707;Vaduvos;"4 klasė";60531886576;Taip;0;3;0;3
16708;Vaduvos;"4 klasė";38462664426;Ne;0;4;0;4
16709;Vaduvos;"4 klasė";1821644443;Ne;0;4;0;4
16710;Vaduvos;"2 B klasė";95104294893;Taip;0;4;0;4
16711;Vaduvos;"2 B klasė";40872193458;Taip;0;4;0;4
16712;Vaduvos;"2 B klasė";6500567162;Taip;0;8;0;8
16713;Vaduvos;"2 B klasė";78931952732;Ne;0;4;0;4
16714;Vaduvos;"2 B klasė";1241148402;Ne;0;4;0;4
16715;Vaduvos;"2 B klasė";66359913774;Taip;0;3;0;3
16716;Vaduvos;"2 B klasė";24887196729;Ne;0;10;0;10
16717;Vaduvos;"2 B klasė";39687066893;Taip;0;4;0;4
16718;Vaduvos;"2 B klasė";64074141491;Taip;0;4;0;4
16719;Vaduvos;"2 B klasė";93924290247;Taip;0;4;0;4
16720;Vaduvos;"2 B klasė";47465933557;Taip;0;5;0;5
16721;Vaduvos;"2 B klasė";62521006557;Taip;0;4;0;4
16722;Vaduvos;"2 B klasė";16882774330;Taip;0;6;0;6
16723;Vaduvos;"2 B klasė";3259114583;Taip;0;4;0;4
16724;Vaduvos;"2 B klasė";87671358423;Taip;0;23;0;23
16725;Vaduvos;"2 B klasė";55138588393;Taip;0;4;0;4
16726;Vaduvos;"2 B klasė";3310156076;Ne;0;5;0;5
16727;Vaduvos;"2 A klasė";6279678482;Ne;0;3;0;3
16728;Vaduvos;"2 A klasė";96892752634;Taip;0;18;0;18
16729;Vaduvos;"2 A klasė";61243200177;Taip;0;3;0;3
16730;Vaduvos;"2 A klasė";62703428759;Taip;0;3;0;3
16731;Vaduvos;"2 A klasė";68420568339;Taip;0;3;0;3
16732;Vaduvos;"2 A klasė";49738318631;Taip;0;3;0;3
16733;Vaduvos;"2 A klasė";65647119496;Taip;0;3;0;3
16734;Vaduvos;"2 A klasė";19390879176;Taip;0;3;0;3
16735;Vaduvos;"2 A klasė";6155494370;Ne;0;3;0;3
16736;Vaduvos;"2 A klasė";1139509471;Taip;0;23;0;23
16737;Vaduvos;"2 A klasė";70693742936;Taip;0;6;0;6
16738;Vaduvos;"2 A klasė";1010061503;Taip;0;5;0;5
16739;Vaduvos;"2 A klasė";1107557891;Taip;0;23;0;23
16740;Vaduvos;"2 A klasė";8802765960;Ne;0;6;0;6
16741;Vaduvos;"2 A klasė";3172047211;Taip;0;3;0;3
16742;Vilkpėdės;BORUŽĖLĖS;8002436634;Taip;0;0;3;3
16743;Vilkpėdės;BORUŽĖLĖS;1249504082;Taip;0;4;4;8
16744;Vilkpėdės;BORUŽĖLĖS;4052026470;Taip;10;0;3;13
16745;Vilkpėdės;BORUŽĖLĖS;4726171678;Taip;5;0;0;5
16746;Vilkpėdės;BORUŽĖLĖS;7519472444;Taip;7;0;0;7
16747;Vilkpėdės;BORUŽĖLĖS;3991785883;Taip;7;0;2;9
16748;Vilkpėdės;BORUŽĖLĖS;9334610111;Taip;0;1;3;4
16749;Vilkpėdės;BORUŽĖLĖS;7992484314;Taip;0;3;4;7
16750;Vilkpėdės;BORUŽĖLĖS;5050493757;Taip;5;6;1;12
16751;Vilkpėdės;BORUŽĖLĖS;8217972925;Taip;0;6;3;9
16752;Vilkpėdės;BORUŽĖLĖS;2232913117;Ne;0;0;7;7
16753;Vilkpėdės;BORUŽĖLĖS;7805866055;Taip;5;0;0;5
16754;Vilkpėdės;BORUŽĖLĖS;3994451071;Taip;12;0;0;12
16755;Vilkpėdės;BORUŽĖLĖS;2529188623;Taip;5;0;1;6
16756;Vilkpėdės;BORUŽĖLĖS;5569182344;Taip;3;0;0;3
16757;Vilkpėdės;SKRUZDĖLIUKAI;7661268641;Taip;0;5;0;5
16758;Vilkpėdės;SKRUZDĖLIUKAI;4018140154;Taip;5;0;0;5
16759;Vilkpėdės;SKRUZDĖLIUKAI;2419661008;Taip;4;0;6;10
16760;Vilkpėdės;SKRUZDĖLIUKAI;7114183123;Taip;10;0;0;10
16761;Vilkpėdės;SKRUZDĖLIUKAI;8804335248;Taip;7;0;0;7
16762;Vilkpėdės;SKRUZDĖLIUKAI;2525399410;Taip;10;0;1;11
16763;Vilkpėdės;SKRUZDĖLIUKAI;4656475161;Taip;0;0;3;3
16764;Vilkpėdės;SKRUZDĖLIUKAI;5812430367;Taip;0;7;0;7
16765;Vilkpėdės;SKRUZDĖLIUKAI;1478022307;Taip;0;3;0;3
16766;Vilkpėdės;SKRUZDĖLIUKAI;2205143759;Ne;0;1;0;1
16767;Vilkpėdės;SKRUZDĖLIUKAI;6598572049;Taip;0;2;0;2
16768;Vilkpėdės;SKRUZDĖLIUKAI;2418313731;Taip;5;0;2;7
16769;Vilkpėdės;SKRUZDĖLIUKAI;1342167313;Taip;10;8;3;21
16770;Vilkpėdės;SKRUZDĖLIUKAI;2703704892;Ne;0;0;5;5
16771;Vilkpėdės;SKRUZDĖLIUKAI;5956701303;Taip;2;0;0;2
16772;Vilkpėdės;SKRUZDĖLIUKAI;8385974099;Taip;16;0;0;16
16773;Vilkpėdės;DRUGELIAI;1040357501;Taip;4;7;0;11
16774;Vilkpėdės;DRUGELIAI;6876470245;Taip;4;7;0;11
16775;Vilkpėdės;DRUGELIAI;8431620518;Taip;15;0;0;15
16776;Vilkpėdės;DRUGELIAI;7008659662;Taip;4;0;1;5
16777;Vilkpėdės;DRUGELIAI;9501254301;Taip;8;0;0;8
16778;Vilkpėdės;DRUGELIAI;2751013757;Taip;13;0;0;13
16779;Vilkpėdės;DRUGELIAI;4998396593;Taip;17;0;0;17
16780;Vilkpėdės;DRUGELIAI;1278300322;Taip;5;9;0;14
16781;Vilkpėdės;DRUGELIAI;9797550851;Taip;16;0;0;16
16782;Vilkpėdės;DRUGELIAI;2379571797;Taip;10;0;0;10
16783;Vilkpėdės;ŽIOGELIAI;5551822633;Taip;14;0;0;14
16784;Vilkpėdės;ŽIOGELIAI;3666145718;Taip;0;5;0;5
16785;Vilkpėdės;ŽIOGELIAI;5422061533;Taip;5;1;0;6
16786;Vilkpėdės;ŽIOGELIAI;4311938034;Taip;0;2;0;2
16787;Vilkpėdės;ŽIOGELIAI;5346798201;Taip;0;9;0;9
16788;Vilkpėdės;ŽIOGELIAI;3720639726;Taip;0;4;0;4
16789;Vilkpėdės;ŽIOGELIAI;1609823694;Taip;15;0;5;20
16790;Vilkpėdės;ŽIOGELIAI;7634076203;Taip;7;10;0;17
16791;Vilkpėdės;ŽIOGELIAI;3350784810;Taip;6;0;0;6
16792;Vilkpėdės;ŽIOGELIAI;1655985778;Taip;13;2;0;15
16793;Vilkpėdės;ŽIOGELIAI;3664125930;Ne;5;0;0;5
16794;Vilkpėdės;ŽIOGELIAI;3737265597;Taip;3;0;0;3
16795;Vilkpėdės;ŽIOGELIAI;2241104719;Taip;0;1;0;1
16796;Vilkpėdės;ŽIOGELIAI;8423972962;Taip;0;3;0;3
16797;Vilkpėdės;ŽIOGELIAI;1537270256;Taip;8;5;0;13
16798;Vilkpėdės;ŽIOGELIAI;3229559339;Taip;8;5;0;13
16799;Vilkpėdės;ŽIOGELIAI;8783790519;Taip;0;1;3;4
16800;Vilkpėdės;BITUTĖS;6418829930;Taip;0;2;0;2
16801;Vilkpėdės;BITUTĖS;1633942236;Taip;6;0;6;12
16802;Vilkpėdės;BITUTĖS;8484873068;Taip;10;0;0;10
16803;Vilkpėdės;BITUTĖS;2503128176;Ne;0;3;0;3
16804;Vilkpėdės;BITUTĖS;9570469277;Ne;0;3;8;11
16805;Vilkpėdės;BITUTĖS;5420512675;Taip;0;0;16;16
16806;Vilkpėdės;BITUTĖS;8613778606;Taip;6;3;0;9
16807;Vilkpėdės;BITUTĖS;7991758361;Taip;0;3;0;3
16808;Vilkpėdės;BITUTĖS;2736318576;Taip;0;0;1;1
16809;Vilkpėdės;BITUTĖS;6064336759;Taip;0;8;0;8
16810;Vilkpėdės;BITUTĖS;5577199802;Taip;5;0;1;6
16811;Vilkpėdės;BITUTĖS;8930504912;Taip;4;0;1;5
16812;Vilkpėdės;BITUTĖS;3303872633;Taip;5;3;0;8
16813;Vilkpėdės;BITUTĖS;5972405023;Ne;9;3;0;12
16814;Vilkpėdės;BITUTĖS;4485811377;Ne;12;2;0;14
16815;Vilkpėdės;BITUTĖS;5274855225;Taip;16;0;1;17
16816;Vilkpėdės;BITUTĖS;8860791478;Taip;5;2;0;7
16817;Vilkpėdės;BITUTĖS;7829343719;Taip;9;0;8;17
16818;Vilkpėdės;"4 klasė";14499651046;Ne;0;5;0;5
16819;Vilkpėdės;"4 klasė";90217345315;Taip;0;4;0;4
16820;Vilkpėdės;"4 klasė";51286525404;Taip;1;4;0;5
16821;Vilkpėdės;"4 klasė";49513181091;Ne;2;4;0;6
16822;Vilkpėdės;"4 klasė";37450374921;Taip;0;4;0;4
16823;Vilkpėdės;"4 klasė";36704555745;Taip;0;4;0;4
16824;Vilkpėdės;"4 klasė";1024429836;Taip;0;5;0;5
16825;Vilkpėdės;"4 klasė";66356984763;Taip;0;8;0;8
16826;Vilkpėdės;"4 klasė";88279045901;Taip;15;5;0;20
16827;Vilkpėdės;"4 klasė";66451097025;Taip;2;4;0;6
16828;Vilkpėdės;"4 klasė";2806307083;Taip;0;4;0;4
16829;Vilkpėdės;"4 klasė";51799865091;Taip;0;4;0;4
16830;Vilkpėdės;"4 klasė";79269485254;Taip;15;4;0;19
16831;Vilkpėdės;"4 klasė";61833757576;Taip;0;6;0;6
16832;Vilkpėdės;"4 klasė";64216245300;Taip;0;4;0;4
16833;Vilkpėdės;GUDRUČIAI;1527272055;Taip;0;2;0;2
16834;Vilkpėdės;GUDRUČIAI;1451102218;Taip;5;2;0;7
16835;Vilkpėdės;GUDRUČIAI;2065010940;Ne;16;0;0;16
16836;Vilkpėdės;GUDRUČIAI;2181146968;Taip;0;4;5;9
16837;Vilkpėdės;GUDRUČIAI;4392760215;Taip;0;1;0;1
16838;Vilkpėdės;GUDRUČIAI;4515945951;Taip;0;0;3;3
16839;Vilkpėdės;GUDRUČIAI;2736368118;Taip;9;0;0;9
16840;Vilkpėdės;GUDRUČIAI;7527929277;Taip;20;0;0;20
16841;Vilkpėdės;GUDRUČIAI;46561435465;Taip;0;2;0;2
16842;Vilkpėdės;GUDRUČIAI;48059844727;Taip;0;3;0;3
16843;Vilkpėdės;GUDRUČIAI;8865545376;Taip;0;3;0;3
16844;Vilkpėdės;GUDRUČIAI;4735164204;Taip;6;0;0;6
16845;Vilkpėdės;GUDRUČIAI;7889480219;Ne;5;3;0;8
16846;Vilkpėdės;GUDRUČIAI;9867411687;Taip;0;4;0;4
16847;Vilkpėdės;GUDRUČIAI;2900581406;Taip;6;3;0;9
16848;Vilkpėdės;GUDRUČIAI;7875898177;Taip;0;4;0;4
16849;Vilkpėdės;GUDRUČIAI;9605399822;Taip;2;3;0;5
16850;Vilkpėdės;GUDRUČIAI;4276158771;Taip;5;6;0;11
16851;Vilkpėdės;GUDRUČIAI;2604179994;Taip;0;4;0;4
16852;Vilkpėdės;GUDRUČIAI;3696611509;Taip;3;3;2;8
16853;Vilkpėdės;SMALSUČIAI;9294350205;Taip;5;0;0;5
16854;Vilkpėdės;SMALSUČIAI;4095366279;Taip;0;4;0;4
16855;Vilkpėdės;SMALSUČIAI;5048931309;Taip;5;0;0;5
16856;Vilkpėdės;SMALSUČIAI;7698759895;Taip;5;2;0;7
16857;Vilkpėdės;SMALSUČIAI;1019057127;Taip;12;0;0;12
16858;Vilkpėdės;SMALSUČIAI;1217929358;Taip;5;2;0;7
16859;Vilkpėdės;SMALSUČIAI;1807884737;Taip;8;5;0;13
16860;Vilkpėdės;SMALSUČIAI;2251274741;Taip;6;3;0;9
16861;Vilkpėdės;SMALSUČIAI;6816745585;Taip;13;0;0;13
16862;Vilkpėdės;SMALSUČIAI;9460356725;Ne;0;1;0;1
16863;Vilkpėdės;SMALSUČIAI;8128254701;Taip;0;7;0;7
16864;Vilkpėdės;SMALSUČIAI;8015392054;Taip;6;1;0;7
16865;Vilkpėdės;SMALSUČIAI;2320350937;Taip;5;0;0;5
16866;Vilkpėdės;SMALSUČIAI;7747013579;Taip;10;3;0;13
16867;Vilkpėdės;SMALSUČIAI;7894766629;Taip;5;8;0;13
16868;Vilkpėdės;SMALSUČIAI;3987021185;Taip;11;1;0;12
16869;Vilkpėdės;SMALSUČIAI;7010024061;Taip;10;0;0;10
16870;Vilkpėdės;SMALSUČIAI;6522707709;Taip;0;7;0;7
16871;Vilkpėdės;SMALSUČIAI;9795696242;Taip;0;8;0;8
16872;Vilkpėdės;SMALSUČIAI;6261547304;Taip;8;0;0;8
16873;Vilkpėdės;SMALSUČIAI;2420271759;Taip;5;4;0;9
16874;Vilkpėdės;KODĖLČIUKŲ;6283767445;Taip;0;1;0;1
16875;Vilkpėdės;KODĖLČIUKŲ;9605430333;Taip;0;4;0;4
16876;Vilkpėdės;KODĖLČIUKŲ;7745776486;Ne;0;3;0;3
16877;Vilkpėdės;KODĖLČIUKŲ;8969001990;Taip;17;0;0;17
16878;Vilkpėdės;KODĖLČIUKŲ;7158737372;Taip;5;7;0;12
16879;Vilkpėdės;KODĖLČIUKŲ;3785308006;Taip;8;0;1;9
16880;Vilkpėdės;KODĖLČIUKŲ;6744834487;Taip;15;0;1;16
16881;Vilkpėdės;KODĖLČIUKŲ;4166416292;Taip;0;11;0;11
16882;Vilkpėdės;KODĖLČIUKŲ;3888880306;Taip;0;4;0;4
16883;Vilkpėdės;KODĖLČIUKŲ;9601934563;Taip;0;1;0;1
16884;Vilkpėdės;KODĖLČIUKŲ;7401886306;Ne;0;1;0;1
16885;Vilkpėdės;KODĖLČIUKŲ;1528619779;Taip;2;2;0;4
16886;Vilkpėdės;KODĖLČIUKŲ;2359315281;Taip;2;1;0;3
16887;Vilkpėdės;KODĖLČIUKŲ;1571869318;Ne;7;1;0;8
16888;Vilkpėdės;KODĖLČIUKŲ;6820236577;Taip;2;5;0;7
16889;Vilkpėdės;KODĖLČIUKŲ;4255757333;Ne;7;2;0;9
16890;Vilkpėdės;KODĖLČIUKŲ;5053032081;Taip;0;2;0;2
16891;Vilkpėdės;KODĖLČIUKŲ;6778288398;Taip;6;0;0;6
16892;Žiburėlis;Nykštukai;7163594513;Taip;0;3;0;3
16893;Žiburėlis;Nykštukai;5174211773;Taip;0;1;3;4
16894;Žiburėlis;Nykštukai;5408766721;Taip;0;2;0;2
16895;Žiburėlis;Nykštukai;3646988912;Taip;0;3;0;3
16896;Žiburėlis;Nykštukai;7211961512;Taip;0;1;0;1
16897;Žiburėlis;Nykštukai;7465939429;Taip;5;1;0;6
16898;Žiburėlis;Nykštukai;7307386173;Taip;20;0;0;20
16899;Žiburėlis;Nykštukai;8215816053;Taip;0;2;0;2
16900;Žiburėlis;Nykštukai;4710995351;Taip;8;0;0;8
16901;Žiburėlis;Nykštukai;7633450988;Ne;7;2;0;9
16902;Žiburėlis;Nykštukai;2292895729;Taip;0;5;0;5
16903;Žiburėlis;Nykštukai;9806454408;Ne;0;7;0;7
16904;Žiburėlis;Nykštukai;3938379566;Taip;0;13;0;13
16905;Žiburėlis;Nykštukai;9932264675;Taip;0;3;0;3
16906;Žiburėlis;Nykštukai;8480167191;Taip;0;20;0;20
16907;Žiburėlis;Nykštukai;1559091567;Taip;0;7;0;7
16908;Žiburėlis;Nykštukai;3750024153;Taip;0;7;0;7
16909;Žiburėlis;"Žiniukai ";5816890413;Taip;1;4;0;5
16910;Žiburėlis;"Žiniukai ";2928528630;Ne;8;1;0;9
16911;Žiburėlis;"Žiniukai ";2624326930;Taip;14;6;0;20
16912;Žiburėlis;"Žiniukai ";6300247811;Taip;7;3;2;12
16913;Žiburėlis;"Žiniukai ";3033049328;Taip;6;2;0;8
16914;Žiburėlis;"Žiniukai ";3262856058;Taip;10;6;0;16
16915;Žiburėlis;"Žiniukai ";7424129974;Taip;4;14;0;18
16916;Žiburėlis;"Žiniukai ";4187381976;Taip;0;3;0;3
16917;Žiburėlis;"Žiniukai ";5006361324;Taip;0;4;1;5
16918;Žiburėlis;"Žiniukai ";2956339420;Taip;4;4;0;8
16919;Žiburėlis;"Žiniukai ";2999365435;Ne;0;2;0;2
16920;Žiburėlis;"Žiniukai ";7070952018;Taip;0;4;4;8
16921;Žiburėlis;"Žiniukai ";8438876806;Taip;0;9;0;9
16922;Žiburėlis;"Žiniukai ";3687703187;Ne;0;8;0;8
16923;Žiburėlis;"Žiniukai ";8535429783;Taip;4;4;0;8
16924;Žiburėlis;"Žiniukai ";1061646244;Ne;0;2;0;2
16925;Žiburėlis;"Žiniukai ";2741301903;Taip;0;2;0;2
16926;Žiburėlis;"Smalsiukai ";5438697081;Taip;0;3;0;3
16927;Žiburėlis;"Smalsiukai ";1126972447;Ne;8;2;0;10
16928;Žiburėlis;"Smalsiukai ";5114554577;Taip;0;9;0;9
16929;Žiburėlis;"Smalsiukai ";3936418539;Taip;0;10;0;10
16930;Žiburėlis;"Smalsiukai ";2072972990;Taip;6;3;0;9
16931;Žiburėlis;"Smalsiukai ";3835820013;Taip;0;2;0;2
16932;Žiburėlis;"Smalsiukai ";4355778076;Taip;0;1;0;1
16933;Žiburėlis;"Smalsiukai ";92490398630;Taip;0;3;0;3
16934;Žiburėlis;"Smalsiukai ";67168630669;Taip;0;3;0;3
16935;Žiburėlis;"Smalsiukai ";7578655857;Taip;0;2;0;2
16936;Žiburėlis;"Smalsiukai ";9253393819;Taip;0;8;0;8
16937;Žiburėlis;"Smalsiukai ";1599112927;Taip;0;12;0;12
16938;Žiburėlis;"Smalsiukai ";18739941845;Taip;0;3;0;3
16939;Žiburėlis;"Smalsiukai ";24639355056;Taip;0;2;0;2
16940;Žiburėlis;"Smalsiukai ";6519139977;Taip;0;19;0;19
16941;Žiburėlis;"Smalsiukai ";7861704875;Taip;0;1;0;1
16942;Žiburėlis;"Smalsiukai ";34873231652;Taip;0;3;0;3
16943;Žiburėlis;"Smalsiukai ";1125662904;Taip;0;13;0;13
16944;Žiburėlis;"Smalsiukai ";2175751377;Taip;0;2;0;2
16945;Žiburėlis;"Smalsiukai ";28985997205;Taip;7;7;0;14
16946;Žiburėlis;"Giliukai ";7310274376;Taip;0;1;0;1
16947;Žiburėlis;"Giliukai ";9215654134;Taip;4;0;0;4
16948;Žiburėlis;"Giliukai ";2866098551;Ne;17;0;0;17
16949;Žiburėlis;"Giliukai ";6946621147;Taip;0;8;0;8
16950;Žiburėlis;"Giliukai ";5148264064;Taip;9;3;0;12
16951;Žiburėlis;"Giliukai ";6733333096;Ne;12;0;0;12
16952;Žiburėlis;"Giliukai ";1943162133;Taip;0;3;0;3
16953;Žiburėlis;"Giliukai ";6232492947;Taip;0;3;0;3
16954;Žiburėlis;"Giliukai ";3807588865;Ne;12;1;0;13
16955;Žiburėlis;"Giliukai ";4091901597;Taip;0;10;0;10
16956;Žiburėlis;"Giliukai ";4016969144;Taip;9;1;0;10
16957;Žiburėlis;"Giliukai ";3776569251;Taip;0;9;0;9
16958;Žiburėlis;"Giliukai ";9494271740;Taip;6;5;0;11
16959;Žiburėlis;"Giliukai ";3992503848;Taip;11;4;0;15
16960;Žiburėlis;"Giliukai ";8440073413;Taip;5;4;0;9
16961;Žiburėlis;"Giliukai ";6121237159;Taip;5;4;0;9
16962;Žiburėlis;"Giliukai ";6289338466;Taip;11;0;0;11
16963;Žiburėlis;"Giliukai ";7977098545;Taip;3;0;0;3
16964;Žiburėlis;"Giliukai ";2990465012;Taip;16;0;0;16
16965;Žiburėlis;Meškiukai;3593851196;Taip;4;3;0;7
16966;Žiburėlis;Meškiukai;9470154520;Taip;0;8;1;9
16967;Žiburėlis;Meškiukai;2285666668;Ne;0;0;11;11
16968;Žiburėlis;Meškiukai;2836519241;Taip;9;0;0;9
16969;Žiburėlis;Meškiukai;4667559315;Taip;4;1;0;5
16970;Žiburėlis;Meškiukai;9731661697;Taip;12;0;0;12
16971;Žiburėlis;Meškiukai;9321467329;Taip;12;0;1;13
16972;Žiburėlis;Meškiukai;2254407798;Taip;8;5;0;13
16973;Žiburėlis;Meškiukai;4887304311;Taip;5;1;0;6
16974;Žiburėlis;Meškiukai;1651713696;Taip;1;0;1;2
16975;Žiburėlis;Meškiukai;1105220246;Taip;5;0;1;6
16976;Žiburėlis;Meškiukai;8415647388;Taip;10;0;0;10
16977;Žiburėlis;Meškiukai;2371990135;Taip;10;3;0;13
16978;Žiburėlis;Meškiukai;3522480911;Taip;12;0;0;12
16979;Žiburėlis;Meškiukai;5683969627;Taip;17;0;2;19
16980;Žiburėlis;Viščiukai;7364102991;Taip;14;0;0;14
16981;Žiburėlis;Viščiukai;2506620539;Taip;7;0;0;7
16982;Žiburėlis;Viščiukai;9553194981;Taip;7;0;0;7
16983;Žiburėlis;Viščiukai;8179414341;Taip;7;0;2;9
16984;Žiburėlis;Viščiukai;7140031765;Taip;15;0;2;17
16985;Žiburėlis;Viščiukai;1758251348;Taip;0;1;0;1
16986;Žiburėlis;Viščiukai;1121755119;Taip;0;0;2;2
16987;Žiburėlis;Viščiukai;3738184802;Taip;12;0;0;12
16988;Žiburėlis;Viščiukai;8603154782;Taip;0;0;9;9
16989;Žiburėlis;Viščiukai;4727673956;Taip;5;0;7;12
16990;Žiburėlis;Viščiukai;8284913889;Taip;7;0;1;8
16991;Žiburėlis;Viščiukai;2851350451;Taip;5;5;0;10
16992;Žiburėlis;Viščiukai;6206770019;Taip;4;0;5;9
16993;Žiburėlis;Viščiukai;5314676261;Taip;3;0;0;3
16994;Žiburėlis;"Drambliukai ";5724506894;Taip;10;1;0;11
16995;Žiburėlis;"Drambliukai ";2102574423;Taip;2;1;0;3
16996;Žiburėlis;"Drambliukai ";4937518207;Taip;4;0;0;4
16997;Žiburėlis;"Drambliukai ";2383554216;Taip;5;0;0;5
16998;Žiburėlis;"Drambliukai ";9041469393;Taip;8;0;0;8
16999;Žiburėlis;"Drambliukai ";8285987095;Taip;12;0;0;12
17000;Žiburėlis;"Drambliukai ";2805244671;Taip;0;19;0;19
17001;Žiburėlis;"Drambliukai ";5025452484;Taip;0;12;0;12
17002;Žiburėlis;"Drambliukai ";9344950711;Taip;0;2;0;2
17003;Žiburėlis;"Drambliukai ";8082088504;Taip;1;5;0;6
17004;Žiburėlis;"Drambliukai ";9771442035;Ne;2;1;0;3
17005;Žiburėlis;"Drambliukai ";5194593598;Taip;19;0;0;19
17006;Žiburėlis;"Drambliukai ";3821663597;Taip;0;7;0;7
17007;Žiburėlis;"Drambliukai ";8752098051;Taip;1;5;0;6
17008;Žiburėlis;"Drambliukai ";8207315673;Taip;10;0;0;10
17009;Žiburėlis;BORUŽIUKAI;9964255985;Taip;0;4;0;4
17010;Žiburėlis;BORUŽIUKAI;7895148630;Taip;0;0;23;23
17011;Žiburėlis;BORUŽIUKAI;8936912406;Taip;13;2;0;15
17012;Žiburėlis;BORUŽIUKAI;2500898625;Taip;6;1;0;7
17013;Žiburėlis;BORUŽIUKAI;1422951221;Ne;0;3;0;3
17014;Žiburėlis;BORUŽIUKAI;4631232618;Taip;13;0;0;13
17015;Žiburėlis;BORUŽIUKAI;5793531526;Taip;0;2;0;2
17016;Žiburėlis;BORUŽIUKAI;4578828135;Taip;0;1;0;1
17017;Žiburėlis;BORUŽIUKAI;6128571259;Taip;0;0;4;4
17018;Žiburėlis;BORUŽIUKAI;3760039280;Taip;0;3;0;3
17019;Žiburėlis;BORUŽIUKAI;7769235807;Taip;6;0;0;6
17020;Žiburėlis;BORUŽIUKAI;5799439634;Taip;0;6;0;6
17021;Žiburėlis;BORUŽIUKAI;7343491213;Taip;0;3;0;3
17022;Žiburėlis;BORUŽIUKAI;8373944614;Taip;11;0;5;16
17023;Žiburėlis;BORUŽIUKAI;9256751455;Taip;9;0;0;9
17024;Žiburėlis;BORUŽIUKAI;2077823704;Taip;0;4;0;4
17025;Žiburėlis;BORUŽIUKAI;9357376188;Taip;5;4;0;9
17026;Žiburėlis;BORUŽIUKAI;1661456806;Taip;0;0;1;1
17027;Žiburėlis;BORUŽIUKAI;4233222771;Taip;0;2;0;2
17028;Žiburėlis;BORUŽIUKAI;9029039015;Taip;0;2;0;2
17029;Žiburėlis;BORUŽIUKAI;7017574924;Taip;0;10;5;15
17030;Žiburėlis;SPINDULIUKAI;2995697464;Taip;12;0;0;12
17031;Žiburėlis;SPINDULIUKAI;7856708616;Taip;7;6;0;13
17032;Žiburėlis;SPINDULIUKAI;2491972986;Taip;6;10;0;16
17033;Žiburėlis;SPINDULIUKAI;1190058462;Taip;0;2;1;3
17034;Žiburėlis;SPINDULIUKAI;8970153523;Taip;4;0;0;4
17035;Žiburėlis;SPINDULIUKAI;7402647048;Taip;0;3;0;3
17036;Žiburėlis;SPINDULIUKAI;9352485231;Taip;0;1;0;1
17037;Žiburėlis;SPINDULIUKAI;6830200578;Taip;12;1;0;13
17038;Žiburėlis;SPINDULIUKAI;5951659866;Taip;0;10;0;10
17039;Žiburėlis;SPINDULIUKAI;1775465307;Taip;0;1;0;1
17040;Žiburėlis;SPINDULIUKAI;8973307069;Taip;0;1;0;1
17041;Žiburėlis;SPINDULIUKAI;5098955523;Taip;0;15;0;15
17042;Žiburėlis;SPINDULIUKAI;5629404179;Taip;0;4;0;4
17043;Žiburėlis;SPINDULIUKAI;6647598068;Taip;0;0;4;4
17044;Žiburėlis;SPINDULIUKAI;8686565770;Taip;0;3;0;3
17045;Žiburėlis;SPINDULIUKAI;7825665451;Taip;8;5;0;13
17046;Žiburėlis;SPINDULIUKAI;5556807335;Taip;2;1;0;3
17047;Žiburėlis;SPINDULIUKAI;2808361570;Taip;7;2;0;9
17048;Žiburėlis;KIŠKUČIAI;6492467281;Taip;0;0;6;6
17049;Žiburėlis;KIŠKUČIAI;3352845095;Taip;5;0;3;8
17050;Žiburėlis;KIŠKUČIAI;1004953300;Taip;5;2;0;7
17051;Žiburėlis;KIŠKUČIAI;3296994981;Taip;14;2;0;16
17052;Žiburėlis;KIŠKUČIAI;1887550130;Ne;13;0;5;18
17053;Žiburėlis;KIŠKUČIAI;6019278045;Taip;3;0;0;3
17054;Žiburėlis;KIŠKUČIAI;4079793067;Taip;0;0;3;3
17055;Žiburėlis;KIŠKUČIAI;5418413225;Taip;0;0;1;1
17056;Žiburėlis;KIŠKUČIAI;1334695206;Taip;23;0;0;23
17057;Žiburėlis;KIŠKUČIAI;7597762608;Taip;9;2;0;11
17058;Žiburėlis;KIŠKUČIAI;5145195661;Taip;23;0;0;23
17059;Žiburėlis;KIŠKUČIAI;4477396434;Ne;23;0;0;23
17060;Žiburėlis;KIŠKUČIAI;2712358146;Taip;0;0;4;4
17061;Žiburėlis;KIŠKUČIAI;2117995780;Taip;5;0;0;5
17062;Žiburėlis;KIŠKUČIAI;4003368130;Taip;5;0;3;8
17063;Žiburėlis;KIŠKUČIAI;1868558773;Taip;3;0;2;5
17064;Žiburėlis;KIŠKUČIAI;2083500905;Taip;0;2;0;2
17065;Žiburėlis;KIŠKUČIAI;6577061306;Taip;0;0;6;6
17066;Žiburėlis;DRUGELIAI;9783567484;Ne;0;4;0;4
17067;Žiburėlis;DRUGELIAI;4109288891;Ne;9;4;1;14
17068;Žiburėlis;DRUGELIAI;1015624216;Taip;0;6;0;6
17069;Žiburėlis;DRUGELIAI;9526477121;Ne;5;2;0;7
17070;Žiburėlis;DRUGELIAI;4387021429;Taip;0;6;0;6
17071;Žiburėlis;DRUGELIAI;5002691930;Taip;0;1;0;1
17072;Žiburėlis;DRUGELIAI;8018718405;Taip;0;3;0;3
17073;Žiburėlis;DRUGELIAI;4910787530;Taip;4;12;0;16
17074;Žiburėlis;DRUGELIAI;5324852807;Ne;8;2;0;10
17075;Žiburėlis;DRUGELIAI;4916545915;Taip;0;5;0;5
17076;Žiburėlis;DRUGELIAI;7278242428;Taip;5;0;0;5
17077;Žiburėlis;DRUGELIAI;5732540560;Ne;0;3;0;3
17078;Žiburėlis;DRUGELIAI;1228806324;Taip;0;3;0;3
17079;Žiburėlis;DRUGELIAI;2163018032;Taip;9;3;0;12
17080;Žiburėlis;DRUGELIAI;4581800760;Taip;13;0;0;13
17081;Bangelė;Aštuonkojai;6026399355;Taip;0;4;0;4
17082;Bangelė;Aštuonkojai;5476753511;Taip;0;1;0;1
17083;Bangelė;Aštuonkojai;9168310196;Taip;0;8;0;8
17084;Bangelė;Aštuonkojai;1351714626;Taip;0;1;0;1
17085;Bangelė;Aštuonkojai;1754002501;Taip;0;0;3;3
17086;Bangelė;Aštuonkojai;8336001702;Ne;0;2;0;2
17087;Bangelė;Aštuonkojai;8875703109;Taip;0;5;0;5
17088;Bangelė;Aštuonkojai;6953698592;Ne;0;0;2;2
17089;Bangelė;Aštuonkojai;3063439996;Taip;0;2;0;2
17090;Bangelė;Aštuonkojai;2156837975;Taip;0;0;1;1
17091;Bangelė;Aštuonkojai;9143945953;Taip;4;5;0;9
17092;Bangelė;Aštuonkojai;3022508446;Ne;0;0;1;1
17093;Bangelė;Aštuonkojai;6980232224;Ne;0;1;2;3
17094;Bangelė;Aštuonkojai;1390623903;Taip;0;4;0;4
17095;Bangelė;Aštuonkojai;9788923823;Taip;0;12;10;22
17096;Bangelė;Aštuonkojai;7136625230;Taip;0;9;0;9
17097;Bangelė;Aštuonkojai;6216334243;Taip;0;5;0;5
17098;Bangelė;Delfinukai,;6978215876;Taip;3;0;0;3
17099;Bangelė;Delfinukai,;7434358474;Taip;0;13;0;13
17100;Bangelė;Delfinukai,;2575806242;Taip;0;1;1;2
17101;Bangelė;Delfinukai,;9801978617;Taip;0;1;3;4
17102;Bangelė;Delfinukai,;7434879947;Taip;0;1;2;3
17103;Bangelė;Delfinukai,;5994720767;Taip;0;4;0;4
17104;Bangelė;Delfinukai,;4036461205;Taip;0;2;0;2
17105;Bangelė;Delfinukai,;3344441441;Taip;0;3;11;14
17106;Bangelė;Delfinukai,;2858929915;Taip;0;3;0;3
17107;Bangelė;Delfinukai,;7068305612;Taip;14;0;0;14
17108;Bangelė;Delfinukai,;4412780063;Taip;0;5;0;5
17109;Bangelė;Delfinukai,;9608900293;Taip;5;3;0;8
17110;Bangelė;Delfinukai,;4080993439;Taip;0;3;0;3
17111;Bangelė;"Saulės spindulėliai";55668308050;Taip;0;7;0;7
17112;Bangelė;"Saulės spindulėliai";9150185864;Taip;0;0;2;2
17113;Bangelė;"Saulės spindulėliai";2863118434;Ne;10;4;0;14
17114;Bangelė;"Saulės spindulėliai";9167286651;Taip;14;3;2;19
17115;Bangelė;"Saulės spindulėliai";43740476077;Taip;0;11;2;13
17116;Bangelė;"Saulės spindulėliai";9846780259;Ne;0;1;3;4
17117;Bangelė;"Saulės spindulėliai";1377734102;Taip;0;3;3;6
17118;Bangelė;"Saulės spindulėliai";5950451237;Taip;0;7;0;7
17119;Bangelė;"Saulės spindulėliai";9488932192;Taip;0;4;0;4
17120;Bangelė;"Saulės spindulėliai";1728085772;Ne;0;1;0;1
17121;Bangelė;"Saulės spindulėliai";6173470021;Taip;5;0;0;5
17122;Bangelė;"Saulės spindulėliai";6927540308;Ne;0;0;1;1
17123;Bangelė;"Saulės spindulėliai";9464115339;Taip;0;3;0;3
17124;Bangelė;"Saulės spindulėliai";4122927034;Ne;0;6;0;6
17125;Bangelė;"Saulės spindulėliai";3338203753;Taip;0;3;0;3
17126;Bangelė;"Saulės spindulėliai";2503946448;Taip;0;2;0;2
17127;Bangelė;"Saulės spindulėliai";2872188915;Ne;0;0;1;1
17128;Bangelė;"Pingvinukai ";9980881014;Taip;0;0;2;2
17129;Bangelė;"Pingvinukai ";4317054990;Taip;5;5;0;10
17130;Bangelė;"Pingvinukai ";8943721679;Taip;3;5;1;9
17131;Bangelė;"Pingvinukai ";6566277472;Taip;15;0;0;15
17132;Bangelė;"Pingvinukai ";7362196984;Ne;3;0;0;3
17133;Bangelė;"Pingvinukai ";4712616315;Taip;9;0;1;10
17134;Bangelė;"Pingvinukai ";4940247006;Taip;3;0;0;3
17135;Bangelė;"Pingvinukai ";8335931279;Taip;0;1;0;1
17136;Bangelė;"Pingvinukai ";9311379746;Taip;0;6;1;7
17137;Bangelė;"Pingvinukai ";9955097720;Taip;0;1;0;1
17138;Bangelė;"Pingvinukai ";4851593235;Taip;0;6;1;7
17139;Bangelė;"Pingvinukai ";8998648968;Taip;6;0;0;6
17140;Bangelė;"Pingvinukai ";7016039389;Taip;5;1;0;6
17141;Bangelė;"Pingvinukai ";2127734178;Taip;8;0;0;8
17142;Bangelė;"Pingvinukai ";2107766301;Taip;0;11;0;11
17143;Bangelė;"Pingvinukai ";5237434283;Taip;3;0;0;3
17144;Bangelė;"Pingvinukai ";4651237403;Taip;10;0;2;12
17145;Bangelė;"Pingvinukai ";8661284187;Taip;5;0;0;5
17146;Bangelė;"Jūros žvaigždutės ";5673493708;Taip;16;0;0;16
17147;Bangelė;"Jūros žvaigždutės ";9447145378;Taip;0;9;0;9
17148;Bangelė;"Jūros žvaigždutės ";4086446380;Taip;5;3;0;8
17149;Bangelė;"Jūros žvaigždutės ";8745595583;Ne;15;2;0;17
17150;Bangelė;"Jūros žvaigždutės ";9268294844;Taip;0;2;0;2
17151;Bangelė;"Jūros žvaigždutės ";4831656996;Taip;12;0;1;13
17152;Bangelė;"Jūros žvaigždutės ";9267349375;Ne;0;3;13;16
17153;Bangelė;"Jūros žvaigždutės ";3069288815;Taip;6;0;0;6
17154;Bangelė;"Jūros žvaigždutės ";8563674709;Taip;9;0;1;10
17155;Bangelė;"Jūros žvaigždutės ";6705583340;Taip;0;0;2;2
17156;Bangelė;"Jūros žvaigždutės ";2662758502;Taip;0;5;0;5
17157;Bangelė;"Jūros žvaigždutės ";6174617493;Taip;7;0;3;10
17158;Bangelė;"Jūros žvaigždutės ";9633372201;Ne;18;0;0;18
17159;Bangelė;"Jūros žvaigždutės ";8075810032;Taip;5;3;0;8
17160;Bangelė;"Jūros žvaigždutės ";3500097405;Taip;23;0;0;23
17161;Bangelė;Žuvytės;9009809585;Ne;0;3;0;3
17162;Bangelė;Žuvytės;6496580354;Taip;13;0;4;17
17163;Bangelė;Žuvytės;6480681705;Taip;0;4;0;4
17164;Bangelė;Žuvytės;7142694888;Ne;7;0;2;9
17165;Bangelė;Žuvytės;8734511431;Taip;0;4;0;4
17166;Bangelė;Žuvytės;1895213200;Taip;6;0;1;7
17167;Bangelė;Žuvytės;9765268154;Taip;8;6;0;14
17168;Bangelė;Žuvytės;8495423628;Taip;18;0;0;18
17169;Bangelė;Žuvytės;7419016784;Ne;3;0;5;8
17170;Bangelė;Žuvytės;5190563034;Taip;7;0;2;9
17171;Bangelė;Žuvytės;3991021350;Taip;10;0;5;15
17172;Bangelė;Žuvytės;9954762483;Taip;0;8;2;10
17173;Bangelė;Žuvytės;9493465898;Ne;17;0;0;17
17174;Bangelė;Žuvytės;5597329949;Taip;4;0;0;4
17175;Bangelė;Žuvytės;2134225414;Taip;8;0;0;8
17176;Bangelė;Žuvytės;4494049529;Taip;8;2;0;10
17177;Bangelė;Žuvytės;3334029244;Taip;7;6;0;13
17178;Bangelė;Žuvytės;6165322599;Taip;0;6;0;6
17179;Bangelė;Žuvytės;3016778137;Taip;12;0;0;12
17180;Bangelė;Žuvytės;1898671487;Taip;0;3;0;3
17181;Bangelė;Žuvytės;7174742281;Taip;19;0;1;20
17182;Bangelė;Žuvytės;6806911810;Ne;7;0;6;13
17183;Bangelė;Ruoniai;8149880453;Taip;6;2;0;8
17184;Bangelė;Ruoniai;8836861853;Taip;0;3;0;3
17185;Bangelė;Ruoniai;4571869439;Taip;0;1;0;1
17186;Bangelė;Ruoniai;9672505885;Taip;0;1;1;2
17187;Bangelė;Ruoniai;8990701154;Taip;5;0;1;6
17188;Bangelė;Ruoniai;6861123988;Taip;0;4;0;4
17189;Bangelė;Ruoniai;7233139048;Taip;0;3;0;3
17190;Bangelė;Ruoniai;6044653707;Taip;0;11;0;11
17191;Bangelė;Ruoniai;1915827035;Taip;0;11;0;11
17192;Bangelė;Ruoniai;9041585534;Taip;0;1;0;1
17193;Bangelė;Ruoniai;9706351115;Taip;0;3;0;3
17194;Bangelė;Ruoniai;2764009011;Taip;8;0;0;8
17195;Bangelė;Ruoniai;8758933649;Taip;16;0;2;18
17196;Bangelė;Ruoniai;3900236858;Taip;0;2;0;2
17197;Bangelė;Ruoniai;7230987338;Taip;5;4;0;9
17198;Bangelė;Ruoniai;7337449523;Taip;0;0;1;1
17199;Bangelė;Ruoniai;1528387105;Taip;0;3;0;3
17200;Bangelė;Ruoniai;6712145066;Taip;8;1;0;9
17201;Bangelė;"Pagrandukai ";9561221619;Taip;10;4;0;14
17202;Bangelė;"Pagrandukai ";9128326823;Taip;16;0;2;18
17203;Bangelė;"Pagrandukai ";9992207035;Taip;3;0;3;6
17204;Bangelė;"Pagrandukai ";5625257865;Taip;5;0;3;8
17205;Bangelė;"Pagrandukai ";6415607960;Taip;13;0;1;14
17206;Bangelė;"Pagrandukai ";1182624046;Taip;0;7;0;7
17207;Bangelė;"Pagrandukai ";9355348960;Taip;8;0;0;8
17208;Bangelė;"Pagrandukai ";1467390411;Taip;13;0;0;13
17209;Bangelė;"Pagrandukai ";2730545639;Taip;13;0;0;13
17210;Bangelė;"Pagrandukai ";4041276015;Taip;2;0;0;2
17211;Bangelė;"Pagrandukai ";7503518328;Taip;8;0;0;8
17212;Bangelė;"Pagrandukai ";7365591972;Taip;0;0;1;1
17213;Bangelė;"Pagrandukai ";9010238689;Taip;14;1;0;15
17214;Bangelė;"Pagrandukai ";5829865386;Taip;9;0;2;11
17215;Bangelė;"Zuikučiai ";9705672732;Taip;6;9;0;15
17216;Bangelė;"Zuikučiai ";7364368699;Taip;10;1;0;11
17217;Bangelė;"Zuikučiai ";6400785821;Ne;16;0;0;16
17218;Bangelė;"Zuikučiai ";5961647252;Taip;0;3;0;3
17219;Bangelė;"Zuikučiai ";9092263358;Ne;18;0;0;18
17220;Bangelė;"Zuikučiai ";8493650050;Taip;15;3;0;18
17221;Bangelė;"Zuikučiai ";3851738513;Taip;19;0;0;19
17222;Bangelė;"Zuikučiai ";3452984649;Taip;23;0;0;23
17223;Bangelė;"Zuikučiai ";2362345363;Taip;1;0;2;3
17224;Bangelė;"Zuikučiai ";4891131242;Taip;18;0;0;18
17225;Bangelė;"Zuikučiai ";7445583512;Taip;13;2;0;15
17226;Bangelė;"Zuikučiai ";8931569423;Ne;14;0;0;14
17227;Bangelė;"Zuikučiai ";2382714949;Ne;14;0;0;14
17228;Bangelė;"Zuikučiai ";7755966282;Taip;5;1;0;6
17229;Bangelė;"Zuikučiai ";4480762963;Taip;14;0;0;14
17230;Bangelė;"Zuikučiai ";8765892966;Taip;0;1;0;1
17231;Gėlynas;PAKALNUTĖ;4557380282;Taip;4;6;0;10
17232;Gėlynas;PAKALNUTĖ;6884111634;Taip;6;1;2;9
17233;Gėlynas;PAKALNUTĖ;1548317086;Taip;2;0;0;2
17234;Gėlynas;PAKALNUTĖ;3470963396;Taip;0;6;0;6
17235;Gėlynas;PAKALNUTĖ;6053841081;Taip;0;12;0;12
17236;Gėlynas;PAKALNUTĖ;2171064300;Taip;6;0;0;6
17237;Gėlynas;PAKALNUTĖ;2404562144;Taip;0;3;0;3
17238;Gėlynas;PAKALNUTĖ;7504469409;Taip;0;3;0;3
17239;Gėlynas;PAKALNUTĖ;8693415786;Taip;0;7;0;7
17240;Gėlynas;PAKALNUTĖ;4366442459;Taip;5;0;1;6
17241;Gėlynas;PAKALNUTĖ;1463783538;Taip;3;0;0;3
17242;Gėlynas;PAKALNUTĖ;7064068912;Ne;5;10;0;15
17243;Gėlynas;PAKALNUTĖ;1822933936;Taip;0;3;0;3
17244;Gėlynas;PAKALNUTĖ;4668195919;Taip;3;0;0;3
17245;Gėlynas;PAKALNUTĖ;8555408466;Ne;0;7;0;7
17246;Gėlynas;PAKALNUTĖ;2377323648;Taip;6;0;0;6
17247;Gėlynas;PAKALNUTĖ;5382148888;Taip;5;3;0;8
17248;Gėlynas;PAKALNUTĖ;6296728638;Taip;0;1;0;1
17249;Gėlynas;PAKALNUTĖ;2273705177;Taip;3;0;5;8
17250;Gėlynas;PAKALNUTĖ;2520140743;Ne;3;0;0;3
17251;Gėlynas;VARPELIS;2769668641;Taip;0;5;0;5
17252;Gėlynas;VARPELIS;1004866224;Taip;0;10;1;11
17253;Gėlynas;VARPELIS;2417880374;Taip;10;1;2;13
17254;Gėlynas;VARPELIS;4382465307;Taip;12;3;0;15
17255;Gėlynas;VARPELIS;5135747448;Taip;0;3;0;3
17256;Gėlynas;VARPELIS;1754734306;Taip;0;11;0;11
17257;Gėlynas;VARPELIS;1774829898;Taip;4;0;0;4
17258;Gėlynas;VARPELIS;7562201835;Taip;3;0;3;6
17259;Gėlynas;VARPELIS;2132298690;Taip;20;3;0;23
17260;Gėlynas;VARPELIS;7877521812;Taip;5;0;0;5
17261;Gėlynas;VARPELIS;8464074679;Taip;0;3;0;3
17262;Gėlynas;VARPELIS;9911225363;Taip;5;3;1;9
17263;Gėlynas;VARPELIS;5395474698;Ne;0;10;0;10
17264;Gėlynas;VARPELIS;1257113113;Taip;10;3;0;13
17265;Gėlynas;VARPELIS;6898127005;Taip;0;6;0;6
17266;Gėlynas;VARPELIS;3365442661;Taip;15;3;0;18
17267;Gėlynas;VARPELIS;5145396320;Taip;6;3;7;16
17268;Gėlynas;VARPELIS;7814357385;Ne;0;3;0;3
17269;Gėlynas;VARPELIS;1674569569;Taip;0;3;0;3
17270;Gėlynas;VARPELIS;7808971151;Taip;4;3;1;8
17271;Gėlynas;VARPELIS;4916885450;Taip;20;0;0;20
17272;Gėlynas;RAKTAŽOLĖ;3572020585;Taip;0;3;0;3
17273;Gėlynas;RAKTAŽOLĖ;5634213306;Taip;0;2;0;2
17274;Gėlynas;RAKTAŽOLĖ;3491517766;Taip;0;5;0;5
17275;Gėlynas;RAKTAŽOLĖ;4505012978;Taip;0;6;0;6
17276;Gėlynas;RAKTAŽOLĖ;5541707540;Taip;3;0;0;3
17277;Gėlynas;RAKTAŽOLĖ;5124029118;Taip;8;3;0;11
17278;Gėlynas;RAKTAŽOLĖ;9508507084;Taip;6;0;0;6
17279;Gėlynas;RAKTAŽOLĖ;8999346908;Taip;11;0;0;11
17280;Gėlynas;RAKTAŽOLĖ;8458276300;Taip;0;10;0;10
17281;Gėlynas;RAKTAŽOLĖ;9382160515;Ne;0;2;0;2
17282;Gėlynas;RAKTAŽOLĖ;7730322729;Taip;5;3;0;8
17283;Gėlynas;RAKTAŽOLĖ;6528464599;Taip;4;2;0;6
17284;Gėlynas;RAKTAŽOLĖ;8615943743;Taip;0;11;0;11
17285;Gėlynas;RAKTAŽOLĖ;7389502638;Ne;0;12;0;12
17286;Gėlynas;RAKTAŽOLĖ;5751256561;Taip;12;0;2;14
17287;Gėlynas;RAKTAŽOLĖ;8080660097;Ne;0;4;0;4
17288;Gėlynas;RAKTAŽOLĖ;1015554617;Taip;0;1;0;1
17289;Gėlynas;RAKTAŽOLĖ;6875794958;Taip;2;5;0;7
17290;Gėlynas;RAKTAŽOLĖ;8444505017;Taip;11;3;0;14
17291;Gėlynas;RAKTAŽOLĖ;5695333666;Taip;0;9;0;9
17292;Gėlynas;SAULĖGRĄŽA;7150367866;Taip;8;0;0;8
17293;Gėlynas;SAULĖGRĄŽA;5898582218;Taip;7;0;0;7
17294;Gėlynas;SAULĖGRĄŽA;1505666690;Taip;8;0;0;8
17295;Gėlynas;SAULĖGRĄŽA;3492361041;Taip;0;6;0;6
17296;Gėlynas;SAULĖGRĄŽA;6451922757;Taip;18;0;3;21
17297;Gėlynas;SAULĖGRĄŽA;2141722631;Taip;8;1;0;9
17298;Gėlynas;SAULĖGRĄŽA;2742456983;Taip;10;0;0;10
17299;Gėlynas;SAULĖGRĄŽA;4983822000;Taip;6;0;0;6
17300;Gėlynas;SAULĖGRĄŽA;3549079170;Taip;8;5;0;13
17301;Gėlynas;SAULĖGRĄŽA;9305282699;Taip;5;4;0;9
17302;Gėlynas;SAULĖGRĄŽA;6815740588;Taip;0;0;9;9
17303;Gėlynas;SAULĖGRĄŽA;3606076029;Taip;9;3;0;12
17304;Gėlynas;SAULĖGRĄŽA;5964419627;Taip;9;0;0;9
17305;Gėlynas;SAULĖGRĄŽA;4824667762;Taip;5;0;0;5
17306;Gėlynas;SAULĖGRĄŽA;9330385153;Taip;0;1;0;1
17307;Gėlynas;SAULĖGRĄŽA;9724668402;Taip;0;1;0;1
17308;Gėlynas;SAULĖGRĄŽA;9462822190;Taip;10;2;0;12
17309;Gėlynas;SAULĖGRĄŽA;2784709117;Taip;5;0;0;5
17310;Gėlynas;SAULĖGRĄŽA;6114995335;Taip;10;3;0;13
17311;Gėlynas;SAULĖGRĄŽA;5291444399;Taip;0;5;0;5
17312;Gėlynas;SAULĖGRĄŽA;5320531856;Taip;0;0;1;1
17313;Gėlynas;SAULĖGRĄŽA;7998013477;Taip;6;3;1;10
17314;Gėlynas;SAULĖGRĄŽA;6244314445;Taip;15;0;0;15
17315;Gėlynas;RAMUNĖLĖ;1665668966;Taip;0;0;1;1
17316;Gėlynas;RAMUNĖLĖ;9707677931;Taip;0;2;0;2
17317;Gėlynas;RAMUNĖLĖ;1235384604;Taip;0;3;0;3
17318;Gėlynas;RAMUNĖLĖ;9230984365;Taip;0;0;1;1
17319;Gėlynas;RAMUNĖLĖ;5813156578;Taip;15;0;0;15
17320;Gėlynas;RAMUNĖLĖ;6221721945;Taip;5;0;6;11
17321;Gėlynas;RAMUNĖLĖ;7005278902;Taip;0;3;0;3
17322;Gėlynas;RAMUNĖLĖ;6790040590;Ne;3;11;1;15
17323;Gėlynas;RAMUNĖLĖ;4854709904;Taip;0;10;0;10
17324;Gėlynas;RAMUNĖLĖ;2434552926;Ne;0;7;2;9
17325;Gėlynas;RAMUNĖLĖ;8550986498;Taip;15;0;2;17
17326;Gėlynas;RAMUNĖLĖ;9973824348;Ne;9;0;3;12
17327;Gėlynas;ŽIBUTĖ;4192292896;Taip;0;18;0;18
17328;Gėlynas;ŽIBUTĖ;6826311903;Taip;6;0;0;6
17329;Gėlynas;ŽIBUTĖ;8447789767;Taip;3;10;0;13
17330;Gėlynas;ŽIBUTĖ;1862266440;Taip;10;0;0;10
17331;Gėlynas;ŽIBUTĖ;3746597878;Taip;5;3;0;8
17332;Gėlynas;ŽIBUTĖ;9182072776;Taip;11;0;1;12
17333;Gėlynas;ŽIBUTĖ;4292724541;Taip;11;0;0;11
17334;Gėlynas;ŽIBUTĖ;8681345327;Taip;12;0;0;12
17335;Gėlynas;ŽIBUTĖ;7988094745;Taip;0;0;2;2
17336;Gėlynas;ŽIBUTĖ;9552677108;Taip;10;3;0;13
17337;Gėlynas;ŽIBUTĖ;2608369575;Taip;10;3;0;13
17338;Gėlynas;ŽIBUTĖ;1949260962;Taip;13;3;0;16
17339;Gėlynas;ŽIBUTĖ;6635004996;Taip;8;0;0;8
17340;Gėlynas;ŽIBUTĖ;1556683639;Taip;4;4;0;8
17341;Gėlynas;ŽIBUTĖ;5942466822;Taip;12;0;3;15
17342;Gėlynas;ŽIBUTĖ;2193861056;Taip;5;0;0;5
17343;Gėlynas;ŽIBUTĖ;8743722205;Taip;0;5;0;5
17344;Gėlynas;ŽIBUTĖ;2790269385;Taip;10;3;0;13
17345;Gėlynas;ŽIBUTĖ;2885148633;Taip;10;0;0;10
17346;Obelėlė;Gudručiai;2014314139;Ne;5;0;1;6
17347;Obelėlė;Gudručiai;9900484892;Taip;3;10;1;14
17348;Obelėlė;Gudručiai;9586720282;Taip;8;0;2;10
17349;Obelėlė;Gudručiai;4015702815;Taip;13;0;0;13
17350;Obelėlė;Gudručiai;5141585309;Taip;7;0;0;7
17351;Obelėlė;Gudručiai;9736557012;Taip;8;0;0;8
17352;Obelėlė;Gudručiai;6720058972;Taip;7;0;0;7
17353;Obelėlė;Gudručiai;4451814487;Taip;5;0;0;5
17354;Obelėlė;Gudručiai;2053807216;Taip;5;0;2;7
17355;Obelėlė;Gudručiai;2204293216;Ne;3;0;0;3
17356;Obelėlė;Gudručiai;1184082097;Taip;5;3;0;8
17357;Obelėlė;Gudručiai;1312484983;Taip;6;0;2;8
17358;Obelėlė;Gudručiai;1565630870;Taip;0;5;0;5
17359;Obelėlė;Gudručiai;1598785483;Taip;5;3;0;8
17360;Obelėlė;Pasakaitė;1695933896;Ne;4;1;3;8
17361;Obelėlė;Pasakaitė;79601449969;Taip;10;1;0;11
17362;Obelėlė;Pasakaitė;3330983614;Taip;0;2;0;2
17363;Obelėlė;Pasakaitė;4257479486;Taip;4;0;1;5
17364;Obelėlė;Pasakaitė;8394566707;Taip;0;1;0;1
17365;Obelėlė;Pasakaitė;9527363918;Taip;0;1;0;1
17366;Obelėlė;Pasakaitė;10939948244;Taip;0;2;0;2
17367;Obelėlė;Pasakaitė;1141707374;Taip;0;3;1;4
17368;Obelėlė;Pasakaitė;6789881144;Taip;0;3;0;3
17369;Obelėlė;Pasakaitė;6036130112;Taip;0;0;1;1
17370;Obelėlė;Pasakaitė;1893470952;Taip;0;0;7;7
17371;Obelėlė;Pasakaitė;7754276632;Taip;0;23;0;23
17372;Obelėlė;Pasakaitė;69055416041;Taip;0;0;2;2
17373;Obelėlė;Pasakaitė;3517342646;Taip;0;0;3;3
17374;Obelėlė;Pasakaitė;4220808775;Taip;0;2;0;2
17375;Obelėlė;Pasakaitė;1507072248;Taip;0;0;1;1
17376;Obelėlė;Pasakaitė;7934760271;Taip;7;3;2;12
17377;Obelėlė;Svajokliai;9981446556;Taip;7;0;0;7
17378;Obelėlė;Svajokliai;4849499826;Taip;3;2;2;7
17379;Obelėlė;Svajokliai;1469593267;Taip;10;0;2;12
17380;Obelėlė;Svajokliai;9819048265;Taip;14;0;0;14
17381;Obelėlė;Svajokliai;4489212434;Taip;3;0;1;4
17382;Obelėlė;Svajokliai;6325027163;Taip;0;0;1;1
17383;Obelėlė;Svajokliai;5312394513;Taip;0;0;1;1
17384;Obelėlė;Svajokliai;5620250331;Taip;8;0;0;8
17385;Obelėlė;Svajokliai;5588467580;Taip;6;3;7;16
17386;Obelėlė;Svajokliai;7094715237;Taip;0;0;5;5
17387;Obelėlė;Svajokliai;9070960601;Taip;0;0;1;1
17388;Obelėlė;Svajokliai;3986892111;Taip;0;3;0;3
17389;Obelėlė;Svajokliai;7003947655;Taip;0;1;0;1
17390;Obelėlė;Svajokliai;9641297002;Taip;0;3;0;3
17391;Obelėlė;Svajokliai;8918176312;Taip;5;3;0;8
17392;Obelėlė;Svajokliai;8604451971;Taip;10;0;1;11
17393;Obelėlė;Svajokliai;7794072582;Taip;3;0;3;6
17394;Obelėlė;Svajokliai;6785654280;Taip;0;12;4;16
17395;Obelėlė;Svajokliai;6311322617;Taip;5;3;0;8
17396;Obelėlė;Svajokliai;2813927086;Taip;8;1;0;9
17397;Obelėlė;Smalsučiai;6497584911;Taip;11;0;1;12
17398;Obelėlė;Smalsučiai;7687093936;Taip;7;3;0;10
17399;Obelėlė;Smalsučiai;1469375976;Taip;11;0;0;11
17400;Obelėlė;Smalsučiai;7108517080;Taip;0;0;2;2
17401;Obelėlė;Smalsučiai;6008839269;Taip;3;0;0;3
17402;Obelėlė;Smalsučiai;4987747783;Taip;5;0;2;7
17403;Obelėlė;Smalsučiai;5085970254;Taip;0;0;3;3
17404;Obelėlė;Smalsučiai;8709758561;Taip;5;0;0;5
17405;Obelėlė;Smalsučiai;4318546408;Taip;5;1;0;6
17406;Obelėlė;Smalsučiai;2631405243;Taip;5;0;0;5
17407;Obelėlė;Smalsučiai;8173307704;Taip;7;0;3;10
17408;Obelėlė;Smalsučiai;9796759067;Taip;11;3;0;14
17409;Obelėlė;Smalsučiai;6720808705;Taip;0;2;1;3
17410;Obelėlė;Smalsučiai;7850656031;Taip;3;0;3;6
17411;Obelėlė;Smalsučiai;9084969712;Taip;0;0;6;6
17412;Obelėlė;Smalsučiai;6364101139;Taip;9;0;1;10
17413;Obelėlė;Smalsučiai;6064646690;Taip;0;5;0;5
17414;Obelėlė;Smalsučiai;8183287212;Taip;0;2;0;2
17415;Obelėlė;Smalsučiai;2574840626;Taip;4;5;0;9
17416;Obelėlė;Smalsučiai;8981403984;Taip;0;13;0;13
17417;Obelėlė;Pabiručiai;2035035265;Taip;0;10;0;10
17418;Obelėlė;Pabiručiai;5763713052;Taip;0;23;0;23
17419;Obelėlė;Pabiručiai;7667966704;Taip;0;0;2;2
17420;Obelėlė;Pabiručiai;1819480590;Taip;0;0;4;4
17421;Obelėlė;Pabiručiai;8579887226;Taip;15;0;0;15
17422;Obelėlė;Pabiručiai;6946457363;Taip;0;0;1;1
17423;Obelėlė;Pabiručiai;3951816174;Taip;0;0;3;3
17424;Obelėlė;Pabiručiai;5599466885;Taip;3;0;4;7
17425;Obelėlė;Pabiručiai;9634414572;Taip;0;0;1;1
17426;Obelėlė;Pabiručiai;4851824672;Taip;0;0;4;4
17427;Obelėlė;Pabiručiai;3526079444;Ne;0;0;3;3
17428;Obelėlė;Pabiručiai;9731565368;Taip;0;8;0;8
17429;Obelėlė;Pabiručiai;8827515572;Taip;5;0;1;6
17430;Obelėlė;Pabiručiai;8443192155;Taip;5;0;0;5
17431;Obelėlė;Pabiručiai;9627134967;Ne;0;7;0;7
17432;Obelėlė;Pabiručiai;5368376431;Ne;19;0;0;19
17433;Obelėlė;Strakaliukai;1706102918;Taip;0;0;4;4
17434;Obelėlė;Strakaliukai;2770477678;Taip;0;7;0;7
17435;Obelėlė;Strakaliukai;8682794598;Taip;0;6;0;6
17436;Obelėlė;Strakaliukai;8754552660;Taip;0;0;5;5
17437;Obelėlė;Strakaliukai;9716500560;Taip;6;2;0;8
17438;Obelėlė;Strakaliukai;4251418414;Ne;1;6;0;7
17439;Obelėlė;Strakaliukai;7128421330;Taip;0;0;5;5
17440;Obelėlė;Strakaliukai;5943314566;Taip;20;0;1;21
17441;Obelėlė;Strakaliukai;3116100694;Taip;3;0;0;3
17442;Obelėlė;Strakaliukai;5741823041;Taip;3;0;2;5
17443;Obelėlė;Strakaliukai;8050551266;Taip;0;12;0;12
17444;Obelėlė;Strakaliukai;7468335279;Ne;5;0;1;6
17445;Obelėlė;Strakaliukai;1180508643;Taip;0;3;4;7
17446;Obelėlė;Strakaliukai;7124393375;Taip;0;0;9;9
17447;Obelėlė;Strakaliukai;5001844064;Taip;5;3;2;10
17448;Obelėlė;Strakaliukai;9976694313;Taip;0;5;0;5
17449;Obelėlė;Saulutė;2772753891;Taip;12;0;0;12
17450;Obelėlė;Saulutė;8486560892;Taip;5;4;0;9
17451;Obelėlė;Saulutė;1858251094;Taip;0;5;0;5
17452;Obelėlė;Saulutė;2893378990;Taip;10;0;0;10
17453;Obelėlė;Saulutė;6874039388;Taip;4;0;0;4
17454;Obelėlė;Saulutė;7491934262;Taip;0;0;9;9
17455;Obelėlė;Saulutė;9043542844;Taip;4;0;1;5
17456;Obelėlė;Saulutė;4321210604;Taip;12;0;0;12
17457;Obelėlė;Saulutė;4209489251;Taip;7;0;0;7
17458;Obelėlė;Saulutė;4309622934;Taip;6;0;0;6
17459;Obelėlė;Saulutė;6470533765;Taip;0;1;0;1
17460;Obelėlė;Saulutė;8223715886;Taip;0;1;0;1
17461;Obelėlė;Saulutė;8461505586;Taip;4;0;4;8
17462;Obelėlė;Saulutė;2730569223;Taip;18;0;0;18
17463;Obelėlė;Saulutė;4218895290;Taip;11;0;2;13
17464;Obelėlė;Rieduliukai;9008900055;Taip;16;0;0;16
17465;Obelėlė;Rieduliukai;9332534001;Taip;16;0;0;16
17466;Obelėlė;Rieduliukai;2465101384;Ne;11;0;1;12
17467;Obelėlė;Rieduliukai;7403160073;Taip;12;0;1;13
17468;Obelėlė;Rieduliukai;2663004768;Taip;11;0;1;12
17469;Obelėlė;Rieduliukai;8060994250;Taip;10;0;0;10
17470;Obelėlė;Rieduliukai;1788880520;Taip;5;0;4;9
17471;Obelėlė;Rieduliukai;3452970142;Ne;1;4;0;5
17472;Obelėlė;Rieduliukai;4505857257;Taip;5;0;2;7
17473;Obelėlė;Rieduliukai;9995891955;Taip;13;0;1;14
17474;Obelėlė;Rieduliukai;4707488292;Taip;15;0;0;15
17475;Obelėlė;Rieduliukai;3646359565;Taip;19;0;0;19
17476;Obelėlė;Rieduliukai;5366112771;Taip;0;0;1;1
17477;Obelėlė;Rieduliukai;5603904852;Taip;7;1;4;12
17478;Obelėlė;Rieduliukai;2031637374;Taip;0;0;8;8
17479;Obelėlė;Rieduliukai;4678269928;Taip;6;0;0;6
17480;Obelėlė;Žirniukai;5209482838;Taip;17;0;1;18
17481;Obelėlė;Žirniukai;8422696011;Taip;10;0;1;11
17482;Obelėlė;Žirniukai;5503843905;Taip;0;3;0;3
17483;Obelėlė;Žirniukai;6133596410;Taip;0;0;6;6
17484;Obelėlė;Žirniukai;2702773541;Taip;11;0;1;12
17485;Obelėlė;Žirniukai;2769784741;Taip;4;1;0;5
17486;Obelėlė;Žirniukai;8982197866;Taip;12;0;0;12
17487;Obelėlė;Žirniukai;1222183008;Taip;0;0;2;2
17488;Obelėlė;Žirniukai;7813350634;Taip;4;0;0;4
17489;Obelėlė;Žirniukai;3568124213;Taip;0;12;0;12
17490;Obelėlė;Žirniukai;5478392319;Taip;0;0;2;2
17491;Obelėlė;Žirniukai;4223995429;Taip;5;0;1;6
17492;Obelėlė;Žirniukai;3287262204;Taip;0;0;6;6
17493;Obelėlė;Žirniukai;9005520809;Taip;5;0;0;5
17494;Obelėlė;Žirniukai;5192989376;Taip;1;1;3;5
17495;Obelėlė;Žirniukai;1799603610;Taip;0;12;0;12
17496;Obelėlė;Bičiuliai;3425736276;Taip;7;0;0;7
17497;Obelėlė;Bičiuliai;5776116844;Taip;0;3;1;4
17498;Obelėlė;Bičiuliai;8487088625;Taip;0;1;0;1
17499;Obelėlė;Bičiuliai;1630067014;Taip;1;0;2;3
17500;Obelėlė;Bičiuliai;1537769810;Taip;0;0;3;3
17501;Obelėlė;Bičiuliai;8371648703;Taip;2;0;2;4
17502;Obelėlė;Bičiuliai;2329734472;Taip;0;0;1;1
17503;Obelėlė;Bičiuliai;1419189517;Taip;0;0;2;2
17504;Obelėlė;Bičiuliai;8155712451;Taip;4;3;2;9
17505;Obelėlė;Bičiuliai;4849175527;Ne;0;0;1;1
17506;Obelėlė;Bičiuliai;1362135757;Taip;8;0;0;8
17507;Obelėlė;Bičiuliai;3769993089;Taip;0;0;1;1
17508;Obelėlė;Bičiuliai;5374979248;Taip;6;0;0;6
17509;Obelėlė;Bičiuliai;2170134084;Taip;0;0;5;5
17510;Obelėlė;Bičiuliai;1909459236;Taip;0;3;0;3
17511;Obelėlė;Bičiuliai;8757731600;Taip;0;0;3;3
17512;Obelėlė;Kodėlčiukai;9960526051;Taip;0;0;3;3
17513;Obelėlė;Kodėlčiukai;1050919659;Taip;3;0;2;5
17514;Obelėlė;Kodėlčiukai;7014872044;Taip;0;0;5;5
17515;Obelėlė;Kodėlčiukai;3028107343;Taip;17;0;0;17
17516;Obelėlė;Kodėlčiukai;4717038536;Taip;6;0;0;6
17517;Obelėlė;Kodėlčiukai;4840134079;Taip;4;0;0;4
17518;Obelėlė;Kodėlčiukai;3320493372;Taip;5;0;1;6
17519;Obelėlė;Kodėlčiukai;8366162313;Taip;7;0;1;8
17520;Obelėlė;Kodėlčiukai;7901070568;Taip;0;0;2;2
17521;Obelėlė;Kodėlčiukai;6481365666;Taip;4;0;0;4
17522;Obelėlė;Kodėlčiukai;2227383487;Taip;0;0;2;2
17523;Obelėlė;Kodėlčiukai;8818153952;Taip;13;0;1;14
17524;Obelėlė;Kodėlčiukai;4887103549;Taip;8;0;0;8
17525;Obelėlė;Kodėlčiukai;5221918341;Taip;3;0;4;7
17526;Obelėlė;Kodėlčiukai;3748406335;Taip;8;0;0;8
17527;Obelėlė;Kodėlčiukai;7696478568;Taip;0;7;1;8
17528;Obelėlė;Kodėlčiukai;7422668691;Ne;7;0;2;9
17529;Obelėlė;Kodėlčiukai;5233321854;Ne;0;0;2;2
17530;Obelėlė;Kodėlčiukai;1472630240;Taip;16;0;0;16
17531;Obelėlė;Pagrandukai;3467743802;Taip;0;23;0;23
17532;Obelėlė;Pagrandukai;7934967787;Taip;8;0;0;8
17533;Obelėlė;Pagrandukai;4673426170;Taip;5;1;1;7
17534;Obelėlė;Pagrandukai;6436061438;Taip;3;0;0;3
17535;Obelėlė;Pagrandukai;6938326798;Taip;0;23;0;23
17536;Obelėlė;Pagrandukai;9258651395;Taip;17;0;2;19
17537;Obelėlė;Pagrandukai;3563701047;Taip;9;0;0;9
17538;Obelėlė;Pagrandukai;8319899105;Taip;0;33;0;33
17539;Obelėlė;Pagrandukai;9514739912;Taip;3;0;0;3
17540;Obelėlė;Pagrandukai;7368698046;Taip;7;0;4;11
17541;Spygliukas;Bitutės;9245739052;Ne;10;0;0;10
17542;Spygliukas;Bitutės;1283097421;Taip;8;11;0;19
17543;Spygliukas;Bitutės;8404929784;Taip;0;2;0;2
17544;Spygliukas;Bitutės;4835818382;Taip;10;4;0;14
17545;Spygliukas;Bitutės;9070219319;Taip;0;3;0;3
17546;Spygliukas;Bitutės;9413950200;Taip;0;4;0;4
17547;Spygliukas;Bitutės;1664878188;Taip;0;1;2;3
17548;Spygliukas;Bitutės;8869320003;Taip;0;1;1;2
17549;Spygliukas;Bitutės;8476882854;Taip;8;5;0;13
17550;Spygliukas;Bitutės;1333556956;Ne;8;1;0;9
17551;Spygliukas;Bitutės;8270525839;Taip;5;9;0;14
17552;Spygliukas;Bitutės;3697691132;Taip;15;1;0;16
17553;Spygliukas;Bitutės;1550737449;Taip;14;0;0;14
17554;Spygliukas;Bitutės;4053158210;Taip;8;0;0;8
17555;Spygliukas;Bitutės;2395961015;Taip;0;1;1;2
17556;Spygliukas;Kiškučiai;1927028026;Taip;20;1;0;21
17557;Spygliukas;Kiškučiai;3094528907;Taip;0;9;0;9
17558;Spygliukas;Kiškučiai;9813995933;Taip;7;7;0;14
17559;Spygliukas;Kiškučiai;4013601534;Taip;6;0;0;6
17560;Spygliukas;Kiškučiai;3959136555;Taip;8;10;0;18
17561;Spygliukas;Kiškučiai;6383264068;Taip;5;2;1;8
17562;Spygliukas;Kiškučiai;5369930705;Taip;17;0;1;18
17563;Spygliukas;Kiškučiai;6246925536;Taip;11;0;2;13
17564;Spygliukas;Kiškučiai;1037321774;Ne;0;1;3;4
17565;Spygliukas;Kiškučiai;5615854225;Taip;0;2;0;2
17566;Spygliukas;Kiškučiai;7261580644;Taip;0;4;0;4
17567;Spygliukas;Kiškučiai;7243104877;Taip;1;4;0;5
17568;Spygliukas;Kiškučiai;1436452804;Taip;0;4;6;10
17569;Spygliukas;Kiškučiai;8347377310;Taip;6;0;2;8
17570;Spygliukas;Kiškučiai;1330384915;Taip;20;0;0;20
17571;Spygliukas;Kiškučiai;8299276429;Ne;6;0;0;6
17572;Spygliukas;Boružėlės;3569857813;Taip;0;0;1;1
17573;Spygliukas;Boružėlės;5493599614;Taip;0;9;0;9
17574;Spygliukas;Boružėlės;6931145017;Taip;0;15;0;15
17575;Spygliukas;Boružėlės;8802722601;Taip;0;8;0;8
17576;Spygliukas;Boružėlės;9285259322;Taip;5;5;0;10
17577;Spygliukas;Boružėlės;1341333016;Taip;23;0;0;23
17578;Spygliukas;Boružėlės;5561426508;Taip;10;0;0;10
17579;Spygliukas;Boružėlės;8806126755;Taip;0;0;1;1
17580;Spygliukas;Boružėlės;4477402331;Taip;3;0;0;3
17581;Spygliukas;Boružėlės;2772801133;Taip;5;0;0;5
17582;Spygliukas;Boružėlės;4245624629;Taip;0;1;0;1
17583;Spygliukas;Boružėlės;6332646009;Taip;0;3;0;3
17584;Spygliukas;Boružėlės;3706443395;Taip;3;3;0;6
17585;Spygliukas;Boružėlės;5765106914;Taip;0;3;0;3
17586;Spygliukas;Boružėlės;3416275094;Taip;4;0;2;6
17587;Spygliukas;Boružėlės;1401951658;Taip;0;11;2;13
17588;Spygliukas;Boružėlės;6248409896;Taip;0;2;0;2
17589;Spygliukas;Boružėlės;8708083787;Taip;3;6;0;9
17590;Spygliukas;Boružėlės;8825264090;Taip;0;3;5;8
17591;Spygliukas;Boružėlės;3919560072;Taip;0;0;1;1
17592;Spygliukas;Boružėlės;4577592862;Taip;3;2;0;5
17593;Spygliukas;Boružėlės;6835488489;Taip;0;9;0;9
17594;Spygliukas;Boružėlės;7900652746;Taip;0;3;0;3
17595;Spygliukas;Ežiukai;1983112873;Taip;0;1;0;1
17596;Spygliukas;Ežiukai;4615217628;Taip;3;2;0;5
17597;Spygliukas;Ežiukai;2184487073;Taip;5;1;0;6
17598;Spygliukas;Ežiukai;5612894706;Taip;0;4;0;4
17599;Spygliukas;Ežiukai;6552944183;Ne;4;0;1;5
17600;Spygliukas;Ežiukai;6459076295;Taip;5;0;0;5
17601;Spygliukas;Ežiukai;7749937772;Taip;7;12;2;21
17602;Spygliukas;Ežiukai;5160835235;Taip;0;1;1;2
17603;Spygliukas;Ežiukai;2719100414;Taip;0;2;4;6
17604;Spygliukas;Ežiukai;1429613380;Taip;11;0;0;11
17605;Spygliukas;Ežiukai;4026252608;Taip;1;2;0;3
17606;Spygliukas;Ežiukai;4098112375;Taip;0;0;4;4
17607;Spygliukas;Ežiukai;9321493897;Taip;0;0;5;5
17608;Spygliukas;Ežiukai;7908419787;Taip;9;0;1;10
17609;Spygliukas;Ežiukai;5366783639;Taip;0;3;0;3
17610;Spygliukas;Ežiukai;3088387895;Taip;5;0;1;6
17611;Spygliukas;Ežiukai;7287543571;Taip;18;1;0;19
17612;Spygliukas;Geniukai;8821434815;Taip;6;0;1;7
17613;Spygliukas;Geniukai;2713999021;Taip;9;0;0;9
17614;Spygliukas;Geniukai;6700076900;Taip;0;0;9;9
17615;Spygliukas;Geniukai;8338260940;Taip;0;0;5;5
17616;Spygliukas;Geniukai;1863442354;Taip;0;1;3;4
17617;Spygliukas;Geniukai;9945315122;Taip;0;0;1;1
17618;Spygliukas;Geniukai;1291429206;Taip;0;4;0;4
17619;Spygliukas;Geniukai;2950722789;Taip;2;0;0;2
17620;Spygliukas;Geniukai;9141146733;Taip;7;0;0;7
17621;Spygliukas;Geniukai;6363991196;Taip;12;0;0;12
17622;Spygliukas;Geniukai;8308394841;Taip;0;11;2;13
17623;Spygliukas;Geniukai;1127941700;Taip;0;2;0;2
17624;Spygliukas;Geniukai;9783154498;Taip;2;0;0;2
17625;Spygliukas;Geniukai;8581453160;Taip;2;0;0;2
17626;Spygliukas;Geniukai;7573756485;Taip;1;0;2;3
17627;Spygliukas;Geniukai;7531515854;Taip;0;23;0;23
17628;Spygliukas;Riešutėliai;29449834997;Taip;4;3;2;9
17629;Spygliukas;Riešutėliai;1855897974;Taip;0;1;1;2
17630;Spygliukas;Riešutėliai;1940209166;Taip;0;3;0;3
17631;Spygliukas;Riešutėliai;8992822256;Taip;5;0;0;5
17632;Spygliukas;Riešutėliai;1939828587;Taip;0;3;0;3
17633;Spygliukas;Riešutėliai;1238940921;Taip;0;1;1;2
17634;Spygliukas;Riešutėliai;9797138740;Taip;0;3;3;6
17635;Spygliukas;Riešutėliai;9001243644;Taip;5;8;2;15
17636;Spygliukas;Riešutėliai;1679263120;Taip;0;3;0;3
17637;Spygliukas;Riešutėliai;7250958367;Taip;0;3;0;3
17638;Spygliukas;Riešutėliai;9975117461;Taip;0;1;3;4
17639;Spygliukas;Riešutėliai;5022615426;Ne;0;1;0;1
17640;Spygliukas;Riešutėliai;7114613140;Taip;0;3;0;3
17641;Spygliukas;Riešutėliai;4430242310;Taip;0;3;0;3
17642;Spygliukas;Riešutėliai;8103481313;Taip;0;4;0;4
17643;Spygliukas;Riešutėliai;7421000718;Taip;0;1;0;1
17644;Spygliukas;Riešutėliai;2980459339;Taip;0;3;0;3
17645;Spygliukas;Riešutėliai;4653108810;Taip;0;3;0;3
17646;Spygliukas;Riešutėliai;16828631895;Taip;0;0;2;2
17647;Spygliukas;Pelėdžiukai;1260920726;Taip;5;0;0;5
17648;Spygliukas;Pelėdžiukai;4355472423;Ne;0;0;1;1
17649;Spygliukas;Pelėdžiukai;8686118262;Taip;10;2;0;12
17650;Spygliukas;Pelėdžiukai;6242194100;Taip;0;1;1;2
17651;Spygliukas;Pelėdžiukai;5778081118;Taip;6;3;1;10
17652;Spygliukas;Pelėdžiukai;4721066953;Taip;0;4;1;5
17653;Spygliukas;Pelėdžiukai;4949371837;Taip;6;1;0;7
17654;Spygliukas;Pelėdžiukai;3658613027;Ne;8;0;1;9
17655;Spygliukas;Pelėdžiukai;1662885055;Ne;3;5;0;8
17656;Spygliukas;Pelėdžiukai;50047868918;Taip;6;0;0;6
17657;Spygliukas;Pelėdžiukai;3365209400;Taip;0;2;0;2
17658;Spygliukas;Pelėdžiukai;6457632191;Taip;0;6;0;6
17659;Spygliukas;Pelėdžiukai;1691209405;Taip;0;4;0;4
17660;Spygliukas;Pelėdžiukai;9178184431;Taip;0;3;0;3
17661;Spygliukas;Pelėdžiukai;2739564216;Taip;5;3;0;8
17662;Spygliukas;Pelėdžiukai;4610504338;Taip;0;1;0;1
17663;Spygliukas;Zylutės;9465470810;Ne;13;0;0;13
17664;Spygliukas;Zylutės;4417471958;Ne;23;0;0;23
17665;Spygliukas;Zylutės;3811864870;Taip;0;0;2;2
17666;Spygliukas;Zylutės;4177369871;Taip;12;0;2;14
17667;Spygliukas;Zylutės;8105507156;Taip;0;4;0;4
17668;Spygliukas;Zylutės;6858338620;Taip;1;0;0;1
17669;Spygliukas;Zylutės;9601530981;Taip;6;0;1;7
17670;Spygliukas;Zylutės;3066293772;Ne;3;0;0;3
17671;Spygliukas;Zylutės;3268222954;Taip;0;10;0;10
17672;Spygliukas;Zylutės;1775612723;Taip;4;0;0;4
17673;Spygliukas;Zylutės;5006372835;Taip;11;0;0;11
17674;Spygliukas;Zylutės;8408234202;Taip;0;0;5;5
17675;Spygliukas;Zylutės;3317395260;Taip;19;0;0;19
17676;Spygliukas;Zylutės;6343141973;Taip;13;0;1;14
17677;Spygliukas;Zylutės;2632672131;Taip;10;1;0;11
17678;Spygliukas;Zylutės;5638595939;Taip;3;3;0;6
17679;Spygliukas;Skruzdėliukai;8246739374;Taip;4;0;0;4
17680;Spygliukas;Skruzdėliukai;2514022679;Taip;0;0;1;1
17681;Spygliukas;Skruzdėliukai;5739075961;Taip;14;0;0;14
17682;Spygliukas;Skruzdėliukai;7324915516;Taip;19;0;0;19
17683;Spygliukas;Skruzdėliukai;6414439254;Taip;19;0;0;19
17684;Spygliukas;Skruzdėliukai;7663839690;Taip;9;0;0;9
17685;Spygliukas;Skruzdėliukai;2738766977;Taip;10;1;0;11
17686;Spygliukas;Skruzdėliukai;8426426785;Taip;18;0;0;18
17687;Spygliukas;Skruzdėliukai;1243647769;Taip;4;0;0;4
17688;Spygliukas;Skruzdėliukai;6680699873;Taip;0;23;0;23
17689;Spygliukas;Skruzdėliukai;2955219028;Ne;10;3;0;13
17690;Spygliukas;Skruzdėliukai;1823720183;Ne;10;1;0;11
17691;Spygliukas;Skruzdėliukai;8565217488;Taip;9;0;1;10
17692;Spygliukas;Skruzdėliukai;1729199382;Ne;16;0;0;16
17693;Spygliukas;Skruzdėliukai;2367685286;Taip;10;0;4;14
17694;Spygliukas;Skruzdėliukai;3065727701;Ne;10;1;0;11
17695;Spygliukas;Voveraitės;9112172144;Taip;14;3;0;17
17696;Spygliukas;Voveraitės;7897603878;Taip;0;10;0;10
17697;Spygliukas;Voveraitės;7741841634;Taip;0;2;0;2
17698;Spygliukas;Voveraitės;3077468722;Taip;15;3;0;18
17699;Spygliukas;Voveraitės;6587957213;Taip;10;2;0;12
17700;Spygliukas;Voveraitės;6758336405;Ne;0;0;1;1
17701;Spygliukas;Voveraitės;3668191959;Taip;0;14;0;14
17702;Spygliukas;Voveraitės;1426267001;Taip;0;0;1;1
17703;Spygliukas;Voveraitės;7611880543;Taip;3;0;0;3
17704;Spygliukas;Voveraitės;8189748611;Taip;0;3;0;3
17705;Spygliukas;Voveraitės;8877911083;Taip;7;0;0;7
17706;Spygliukas;Voveraitės;6405496193;Taip;10;1;0;11
17707;Spygliukas;Voveraitės;7113913750;Ne;5;0;1;6
17708;Spygliukas;Voveraitės;9231097598;Taip;0;3;2;5
17709;Spygliukas;Voveraitės;4681061579;Taip;11;3;0;14
17710;Spygliukas;Voveraitės;7313828707;Taip;6;0;0;6
17711;Spygliukas;Voveraitės;1234195733;Taip;7;1;0;8
17712;Spygliukas;Voveraitės;4508351101;Taip;0;3;0;3
17713;Spygliukas;Giliukų;6015646417;Taip;11;12;0;23
17714;Spygliukas;Giliukų;1761340174;Taip;0;2;0;2
17715;Spygliukas;Giliukų;7522567241;Taip;0;1;0;1
17716;Spygliukas;Giliukų;7460280684;Taip;0;0;3;3
17717;Spygliukas;Giliukų;4429961491;Taip;0;0;3;3
17718;Spygliukas;Giliukų;8821028259;Taip;9;0;1;10
17719;Spygliukas;Giliukų;3237501537;Taip;7;2;3;12
17720;Spygliukas;Giliukų;8722863277;Taip;5;2;3;10
17721;Spygliukas;Giliukų;9025238241;Taip;8;0;0;8
17722;Spygliukas;Giliukų;7776811391;Taip;4;0;0;4
17723;Spygliukas;Giliukų;3777763305;Taip;18;0;0;18
17724;Spygliukas;Giliukų;4626877679;Taip;0;23;0;23
17725;Spygliukas;Giliukų;5255993275;Taip;11;0;5;16
17726;Spygliukas;Drugeliai;7271659513;Taip;0;8;0;8
17727;Spygliukas;Drugeliai;8604767396;Ne;0;1;0;1
17728;Spygliukas;Drugeliai;4634660174;Taip;10;0;2;12
17729;Spygliukas;Drugeliai;7924880159;Taip;5;0;0;5
17730;Spygliukas;Drugeliai;4368224847;Ne;9;0;4;13
17731;Spygliukas;Drugeliai;9316731983;Taip;0;0;7;7
17732;Spygliukas;Drugeliai;5012876830;Taip;3;5;1;9
17733;Spygliukas;Drugeliai;7125425492;Taip;0;3;0;3
17734;Spygliukas;Drugeliai;5214431060;Ne;0;1;0;1
17735;Spygliukas;Drugeliai;7928675053;Taip;6;0;0;6
17736;Spygliukas;Drugeliai;9052337501;Taip;0;3;5;8
17737;Spygliukas;Drugeliai;4505044604;Taip;0;9;0;9
17738;Spygliukas;Drugeliai;2989701249;Taip;0;0;2;2
17739;Spygliukas;Drugeliai;9086986643;Taip;10;1;0;11
17740;Spygliukas;Drugeliai;9392554576;Taip;0;1;0;1
17741;Spygliukas;Drugeliai;8646122773;Taip;0;4;0;4
17742;Vieversys;Žirniukai;5365334453;Taip;3;0;2;5
17743;Vieversys;Žirniukai;7029322013;Ne;0;1;0;1
17744;Vieversys;Žirniukai;2266222087;Taip;4;0;1;5
17745;Vieversys;Žirniukai;2869545222;Taip;4;0;3;7
17746;Vieversys;Žirniukai;7601876587;Taip;3;0;0;3
17747;Vieversys;Žirniukai;2024837493;Taip;5;0;1;6
17748;Vieversys;Žirniukai;8129566710;Taip;0;3;1;4
17749;Vieversys;Žirniukai;5576923685;Taip;0;2;0;2
17750;Vieversys;Žirniukai;6052943894;Taip;0;0;4;4
17751;Vieversys;Žirniukai;3295424711;Taip;3;0;0;3
17752;Vieversys;Žirniukai;3575906273;Taip;4;0;1;5
17753;Vieversys;Žirniukai;9856798869;Taip;0;21;2;23
17754;Vieversys;Žirniukai;1724543625;Taip;12;0;0;12
17755;Vieversys;Žirniukai;6530685517;Taip;2;0;0;2
17756;Vieversys;Žirniukai;3533711179;Taip;4;3;1;8
17757;Vieversys;Žirniukai;2242368843;Taip;7;0;1;8
17758;Vieversys;Varpelių;5150986489;Taip;11;0;0;11
17759;Vieversys;Varpelių;9463693741;Taip;6;0;1;7
17760;Vieversys;Varpelių;1924774817;Ne;7;0;1;8
17761;Vieversys;Varpelių;3595005599;Taip;11;0;1;12
17762;Vieversys;Varpelių;9155896981;Taip;0;3;0;3
17763;Vieversys;Varpelių;5160814541;Taip;0;3;0;3
17764;Vieversys;Varpelių;9580031042;Taip;0;3;0;3
17765;Vieversys;Varpelių;2635722489;Taip;5;0;2;7
17766;Vieversys;Varpelių;3262738994;Taip;0;11;0;11
17767;Vieversys;Varpelių;8350070741;Taip;13;0;0;13
17768;Vieversys;Varpelių;2805682329;Taip;10;1;0;11
17769;Vieversys;Varpelių;9453100342;Taip;0;1;0;1
17770;Vieversys;Varpelių;2956566201;Taip;7;0;0;7
17771;Vieversys;Varpelių;1727558984;Taip;0;0;11;11
17772;Vieversys;Varpelių;4780828296;Taip;6;0;1;7
17773;Vieversys;Varpelių;3297728501;Taip;0;1;0;1
17774;Vieversys;Varpelių;3780226431;Taip;3;0;2;5
17775;Vieversys;Varpelių;3572628491;Taip;6;0;0;6
17776;Vieversys;Varpelių;1128991679;Taip;3;0;0;3
17777;Vieversys;Kiškučių;5922485482;Taip;0;1;0;1
17778;Vieversys;Kiškučių;3917758713;Taip;0;2;1;3
17779;Vieversys;Kiškučių;9387421639;Taip;0;1;4;5
17780;Vieversys;Kiškučių;2383765752;Taip;4;1;0;5
17781;Vieversys;Kiškučių;1247565595;Taip;8;3;0;11
17782;Vieversys;Kiškučių;7812227428;Taip;0;0;3;3
17783;Vieversys;Kiškučių;53977164888;Taip;0;5;0;5
17784;Vieversys;Kiškučių;5810605263;Taip;0;1;7;8
17785;Vieversys;Kiškučių;3205204176;Taip;0;0;2;2
17786;Vieversys;Kiškučių;82594887399;Taip;0;4;4;8
17787;Vieversys;Kiškučių;6787960120;Ne;8;0;1;9
17788;Vieversys;Kiškučių;9612415733;Taip;9;5;0;14
17789;Vieversys;Kiškučių;1728554204;Taip;0;3;1;4
17790;Vieversys;Kiškučių;5286521728;Ne;14;3;0;17
17791;Vieversys;Kiškučių;1149316471;Taip;0;12;0;12
17792;Vieversys;Kiškučių;7500147648;Taip;2;3;0;5
17793;Vieversys;Kiškučių;95891054066;Taip;0;3;0;3
17794;Vieversys;Kiškučių;4313822180;Taip;0;1;0;1
17795;Vieversys;Kiškučių;8038341998;Ne;0;2;0;2
17796;Vieversys;Kiškučių;6720355390;Ne;0;3;2;5
17797;Vieversys;Kiškučių;1933907389;Taip;0;4;0;4
17798;Vieversys;Pelėdžiukų;8421719030;Taip;0;1;0;1
17799;Vieversys;Pelėdžiukų;77272293257;Taip;12;0;0;12
17800;Vieversys;Pelėdžiukų;94463134058;Taip;0;3;0;3
17801;Vieversys;Pelėdžiukų;2193074123;Taip;0;2;0;2
17802;Vieversys;Pelėdžiukų;9499315463;Taip;0;1;0;1
17803;Vieversys;Pelėdžiukų;9774365819;Taip;0;3;0;3
17804;Vieversys;Pelėdžiukų;2521488728;Taip;0;1;2;3
17805;Vieversys;Pelėdžiukų;6473759470;Taip;5;6;0;11
17806;Vieversys;Pelėdžiukų;1273951001;Taip;5;1;0;6
17807;Vieversys;Pelėdžiukų;48430863473;Taip;0;2;0;2
17808;Vieversys;Pelėdžiukų;50181034746;Taip;0;0;1;1
17809;Vieversys;Pelėdžiukų;1027693153;Taip;0;8;0;8
17810;Vieversys;Pelėdžiukų;5871715452;Taip;0;0;2;2
17811;Vieversys;Pelėdžiukų;9659337657;Taip;4;1;0;5
17812;Vieversys;Pelėdžiukų;3458399180;Taip;5;0;0;5
17813;Vieversys;Pelėdžiukų;1361156816;Taip;4;3;0;7
17814;Vieversys;Pelėdžiukų;4216521988;Taip;2;0;0;2
17815;Vieversys;Pelėdžiukų;3755410640;Taip;0;2;0;2
17816;Vieversys;Pelėdžiukų;1322495361;Taip;0;1;0;1
17817;Vieversys;Pelėdžiukų;1757028935;Taip;0;1;0;1
17818;Vieversys;Pelėdžiukų;4488027554;Taip;0;1;0;1
17819;Vieversys;Saulučių;3164280186;Taip;0;0;5;5
17820;Vieversys;Saulučių;3405502715;Taip;0;3;1;4
17821;Vieversys;Saulučių;6127272124;Taip;0;0;2;2
17822;Vieversys;Saulučių;4892622551;Taip;2;0;0;2
17823;Vieversys;Saulučių;5654533451;Taip;4;3;0;7
17824;Vieversys;Saulučių;9985374057;Taip;13;0;0;13
17825;Vieversys;Saulučių;1748006118;Taip;10;0;0;10
17826;Vieversys;Saulučių;4690095102;Taip;11;0;0;11
17827;Vieversys;Saulučių;7048475906;Taip;7;0;1;8
17828;Vieversys;Saulučių;4072323869;Taip;6;0;0;6
17829;Vieversys;Saulučių;2663322242;Ne;6;0;0;6
17830;Vieversys;Saulučių;7596355010;Taip;7;0;1;8
17831;Vieversys;Saulučių;3360981720;Taip;4;0;1;5
17832;Vieversys;Saulučių;9322322737;Taip;0;0;3;3
17833;Vieversys;Kregždučių;3156245273;Taip;0;0;15;15
17834;Vieversys;Kregždučių;5645852451;Taip;10;1;0;11
17835;Vieversys;Kregždučių;9088171869;Taip;8;0;1;9
17836;Vieversys;Kregždučių;7998100115;Taip;0;10;0;10
17837;Vieversys;Kregždučių;9093088054;Taip;6;3;0;9
17838;Vieversys;Kregždučių;4870401841;Taip;0;0;1;1
17839;Vieversys;Kregždučių;6808541662;Taip;7;1;1;9
17840;Vieversys;Kregždučių;2529690060;Taip;0;3;1;4
17841;Vieversys;Kregždučių;2230503026;Taip;0;0;1;1
17842;Vieversys;Kregždučių;8141710663;Taip;0;0;3;3
17843;Vieversys;Kregždučių;6157594693;Taip;0;4;0;4
17844;Vieversys;Kregždučių;1322953831;Taip;5;4;0;9
17845;Vieversys;Kregždučių;9090281352;Taip;18;0;0;18
17846;Vieversys;Kregždučių;4308330177;Ne;11;0;1;12
17847;Vieversys;Kregždučių;3122763958;Taip;5;4;6;15
17848;Vieversys;Kregždučių;2938302462;Taip;12;2;0;14
17849;Vieversys;Kregždučių;9577869269;Taip;0;0;1;1
17850;Vieversys;Boružėlių;6838828193;Taip;5;0;0;5
17851;Vieversys;Boružėlių;8587368497;Taip;0;0;2;2
17852;Vieversys;Boružėlių;5683183310;Taip;9;0;0;9
17853;Vieversys;Boružėlių;4565799599;Taip;0;3;0;3
17854;Vieversys;Boružėlių;7399326463;Taip;10;0;0;10
17855;Vieversys;Boružėlių;4088189914;Taip;0;0;2;2
17856;Vieversys;Boružėlių;7364582681;Taip;0;5;2;7
17857;Vieversys;Boružėlių;9826657384;Taip;9;0;1;10
17858;Vieversys;Boružėlių;3731412573;Taip;0;0;1;1
17859;Vieversys;Boružėlių;9255292099;Taip;0;3;2;5
17860;Vieversys;Boružėlių;7429565381;Taip;14;3;0;17
17861;Vieversys;Boružėlių;4297477514;Taip;8;0;0;8
17862;Vieversys;Boružėlių;6148482625;Taip;14;0;0;14
17863;Vieversys;Boružėlių;2701284187;Taip;11;0;0;11
17864;Vieversys;Boružėlių;9911792407;Taip;18;0;1;19
17865;Vieversys;Boružėlių;6234199996;Taip;18;0;1;19
17866;Vieversys;Bitučių;8706336322;Taip;23;0;0;23
17867;Vieversys;Bitučių;5966170543;Taip;10;0;0;10
17868;Vieversys;Bitučių;5210732072;Taip;11;0;0;11
17869;Vieversys;Bitučių;9188208330;Taip;2;0;0;2
17870;Vieversys;Bitučių;2072413459;Taip;3;2;0;5
17871;Vieversys;Bitučių;9454017990;Ne;23;0;0;23
17872;Vieversys;Bitučių;9476611261;Taip;23;0;0;23
17873;Vieversys;Bitučių;6083402842;Taip;0;0;1;1
17874;Vieversys;Bitučių;4428101863;Taip;4;0;0;4
17875;Vieversys;Bitučių;9978867863;Taip;0;0;1;1
17876;Vieversys;Bitučių;9092693925;Taip;8;0;0;8
17877;Vieversys;Bitučių;2661027772;Taip;3;0;0;3
17878;Vieversys;Bitučių;3601928285;Taip;5;0;0;5
17879;Vieversys;Bitučių;8492908398;Taip;3;0;0;3
17880;Vieversys;Bitučių;5479620291;Taip;17;0;0;17
17881;Vieversys;Bitučių;5417413393;Taip;6;0;0;6
17882;Vieversys;Smalsučių;3681120339;Taip;2;1;4;7
17883;Vieversys;Smalsučių;9164615794;Taip;8;2;0;10
17884;Vieversys;Smalsučių;3684937630;Taip;13;0;2;15
17885;Vieversys;Smalsučių;6563139211;Taip;0;4;0;4
17886;Vieversys;Smalsučių;4294676988;Taip;12;3;0;15
17887;Vieversys;Smalsučių;4835022593;Taip;10;1;0;11
17888;Vieversys;Smalsučių;3249717073;Taip;3;6;0;9
17889;Vieversys;Smalsučių;8174124875;Taip;5;2;0;7
17890;Vieversys;Smalsučių;5769453869;Taip;3;7;0;10
17891;Vieversys;Smalsučių;3946609345;Taip;5;0;1;6
17892;Vieversys;Smalsučių;9686787125;Ne;0;3;3;6
17893;Vieversys;Smalsučių;4455039401;Taip;4;3;0;7
17894;Vieversys;Smalsučių;9835682858;Taip;0;11;8;19
17895;Vieversys;Smalsučių;6486852268;Ne;17;0;0;17
17896;Vieversys;Smalsučių;7007620994;Taip;0;0;10;10
17897;Vieversys;Smalsučių;9494957750;Taip;0;1;6;7
17898;Vieversys;Kodėlčiukų;9217208794;Taip;0;23;0;23
17899;Vieversys;Kodėlčiukų;5037806018;Taip;1;0;1;2
17900;Vieversys;Kodėlčiukų;1752359969;Taip;4;5;0;9
17901;Vieversys;Kodėlčiukų;6791121542;Taip;5;0;0;5
17902;Vieversys;Kodėlčiukų;5912306325;Taip;0;18;0;18
17903;Vieversys;Kodėlčiukų;5898422871;Taip;6;4;0;10
17904;Vieversys;Kodėlčiukų;4193031329;Ne;3;0;0;3
17905;Vieversys;Kodėlčiukų;7453156612;Taip;0;0;6;6
17906;Vieversys;Kodėlčiukų;6926960486;Taip;3;3;0;6
17907;Vieversys;Kodėlčiukų;3180687885;Taip;18;0;0;18
17908;Vieversys;Kodėlčiukų;1881076551;Taip;4;0;1;5
17909;Vieversys;Kodėlčiukų;1384388802;Taip;8;3;0;11
17910;Vieversys;Kodėlčiukų;9965162863;Taip;0;3;7;10
17911;Vieversys;Kodėlčiukų;4702339508;Taip;0;4;2;6
17912;Vieversys;Kodėlčiukų;4631238425;Taip;10;4;0;14
17913;Vieversys;Kodėlčiukų;8512643926;Taip;13;0;1;14
17914;Vieversys;Kodėlčiukų;7967372524;Ne;8;0;1;9
17915;Vieversys;Kodėlčiukų;4703696958;Taip;11;0;0;11
17916;Vieversys;NYKŠTUKAI;7611047781;Taip;7;1;0;8
17917;Vieversys;NYKŠTUKAI;2107000312;Taip;0;9;4;13
17918;Vieversys;NYKŠTUKAI;1963481567;Taip;3;0;7;10
17919;Vieversys;NYKŠTUKAI;7539934804;Taip;10;0;0;10
17920;Vieversys;NYKŠTUKAI;1714096583;Taip;18;0;0;18
17921;Vieversys;NYKŠTUKAI;8371839883;Taip;10;0;1;11
17922;Vieversys;NYKŠTUKAI;6474334564;Taip;6;0;0;6
17923;Vieversys;NYKŠTUKAI;6631296204;Taip;5;0;1;6
17924;Vieversys;NYKŠTUKAI;2092872414;Taip;0;0;1;1
17925;Vieversys;NYKŠTUKAI;5394635510;Taip;5;0;3;8
17926;Vieversys;NYKŠTUKAI;1160455554;Taip;15;0;1;16
17927;Vieversys;NYKŠTUKAI;8200432952;Taip;15;8;0;23
17928;Vieversys;NYKŠTUKAI;2535992834;Taip;13;0;0;13
17929;Vieversys;NYKŠTUKAI;4974924858;Taip;2;0;1;3
17930;Vieversys;NYKŠTUKAI;4087823915;Taip;15;0;0;15
17931;Vieversys;NYKŠTUKAI;7111551694;Ne;11;0;0;11
17932;Vieversys;DRUGELIAI;9412299328;Taip;18;0;0;18
17933;Vieversys;DRUGELIAI;1552959751;Taip;3;0;1;4
17934;Vieversys;DRUGELIAI;5384977888;Taip;13;0;0;13
17935;Vieversys;DRUGELIAI;6000875464;Taip;6;7;0;13
17936;Vieversys;DRUGELIAI;9813883328;Taip;3;0;1;4
17937;Vieversys;DRUGELIAI;7708807923;Taip;14;0;1;15
17938;Vieversys;DRUGELIAI;5580265718;Ne;11;1;0;12
17939;Vieversys;DRUGELIAI;6581002790;Taip;9;0;1;10
17940;Vieversys;DRUGELIAI;8966020793;Taip;10;1;0;11
17941;Vieversys;DRUGELIAI;5164567779;Taip;3;1;0;4
17942;Žirmūnėliai;SAULUTĖS;6116321928;Taip;3;0;0;3
17943;Žirmūnėliai;SAULUTĖS;2310523676;Taip;5;2;0;7
17944;Žirmūnėliai;SAULUTĖS;4922028935;Taip;10;3;2;15
17945;Žirmūnėliai;SAULUTĖS;1948299433;Taip;0;3;20;23
17946;Žirmūnėliai;SAULUTĖS;4763350308;Taip;1;0;0;1
17947;Žirmūnėliai;SAULUTĖS;5626711530;Taip;0;16;0;16
17948;Žirmūnėliai;SAULUTĖS;3902161368;Taip;5;2;0;7
17949;Žirmūnėliai;SAULUTĖS;6072407337;Taip;11;0;0;11
17950;Žirmūnėliai;SAULUTĖS;4338673048;Taip;5;0;2;7
17951;Žirmūnėliai;SAULUTĖS;4793967980;Taip;0;2;2;4
17952;Žirmūnėliai;SAULUTĖS;8242112212;Taip;0;3;7;10
17953;Žirmūnėliai;SAULUTĖS;1940552890;Taip;0;3;0;3
17954;Žirmūnėliai;SAULUTĖS;2392106040;Taip;0;9;0;9
17955;Žirmūnėliai;SAULUTĖS;4343419766;Taip;4;1;0;5
17956;Žirmūnėliai;SAULUTĖS;9145626116;Taip;0;4;6;10
17957;Žirmūnėliai;SAULUTĖS;7675488865;Taip;9;0;4;13
17958;Žirmūnėliai;SAULUTĖS;8345632807;Taip;0;3;0;3
17959;Žirmūnėliai;SAULUTĖS;8592714547;Taip;0;5;0;5
17960;Žirmūnėliai;GILIUKAI;6430944858;Taip;10;0;0;10
17961;Žirmūnėliai;GILIUKAI;3562689670;Taip;0;8;0;8
17962;Žirmūnėliai;GILIUKAI;5929166560;Taip;8;2;2;12
17963;Žirmūnėliai;GILIUKAI;3767421827;Taip;0;2;1;3
17964;Žirmūnėliai;GILIUKAI;4327504033;Taip;0;3;0;3
17965;Žirmūnėliai;GILIUKAI;5104310002;Taip;10;1;2;13
17966;Žirmūnėliai;GILIUKAI;1025809131;Taip;7;2;4;13
17967;Žirmūnėliai;GILIUKAI;6899109664;Taip;0;4;0;4
17968;Žirmūnėliai;GILIUKAI;1473482823;Ne;0;0;2;2
17969;Žirmūnėliai;GILIUKAI;7410921362;Taip;1;5;0;6
17970;Žirmūnėliai;GILIUKAI;6597451758;Taip;4;1;1;6
17971;Žirmūnėliai;GILIUKAI;8627403283;Taip;0;0;9;9
17972;Žirmūnėliai;GILIUKAI;5089884149;Taip;8;0;4;12
17973;Žirmūnėliai;GILIUKAI;1791977446;Taip;4;1;0;5
17974;Žirmūnėliai;GILIUKAI;6875484657;Taip;0;0;7;7
17975;Žirmūnėliai;GILIUKAI;9871163622;Taip;5;0;1;6
17976;Žirmūnėliai;GILIUKAI;3532895278;Ne;0;2;2;4
17977;Žirmūnėliai;GILIUKAI;8459217612;Taip;3;0;0;3
17978;Žirmūnėliai;GILIUKAI;2959090234;Taip;3;0;3;6
17979;Žirmūnėliai;GILIUKAI;5486475468;Taip;0;6;1;7
17980;Žirmūnėliai;GILIUKAI;8618410295;Taip;24;0;0;24
17981;Žirmūnėliai;DRUGELIAI;7020486370;Taip;0;3;0;3
17982;Žirmūnėliai;DRUGELIAI;3449815783;Taip;0;1;0;1
17983;Žirmūnėliai;DRUGELIAI;9541122034;Taip;0;3;0;3
17984;Žirmūnėliai;DRUGELIAI;5736502380;Taip;0;5;0;5
17985;Žirmūnėliai;DRUGELIAI;9378860669;Taip;7;1;0;8
17986;Žirmūnėliai;DRUGELIAI;8607934394;Taip;0;10;0;10
17987;Žirmūnėliai;DRUGELIAI;7892626521;Taip;0;9;0;9
17988;Žirmūnėliai;DRUGELIAI;8999160836;Taip;0;2;0;2
17989;Žirmūnėliai;DRUGELIAI;8209309240;Taip;0;8;0;8
17990;Žirmūnėliai;DRUGELIAI;2837129621;Taip;0;1;0;1
17991;Žirmūnėliai;DRUGELIAI;1273684243;Taip;0;0;3;3
17992;Žirmūnėliai;DRUGELIAI;2971175236;Taip;0;4;1;5
17993;Žirmūnėliai;DRUGELIAI;6594728970;Taip;5;0;0;5
17994;Žirmūnėliai;DRUGELIAI;4336415033;Ne;7;0;0;7
17995;Žirmūnėliai;DRUGELIAI;9241738140;Taip;10;3;0;13
17996;Žirmūnėliai;BORUŽIUKAI;52420072025;Taip;0;0;2;2
17997;Žirmūnėliai;BORUŽIUKAI;4796654075;Taip;0;1;0;1
17998;Žirmūnėliai;BORUŽIUKAI;9926432375;Taip;0;4;0;4
17999;Žirmūnėliai;BORUŽIUKAI;2739395691;Taip;0;2;0;2
18000;Žirmūnėliai;BORUŽIUKAI;3351861764;Taip;0;7;0;7
18001;Žirmūnėliai;BORUŽIUKAI;6161223611;Taip;0;3;0;3
18002;Žirmūnėliai;BORUŽIUKAI;5611315994;Taip;0;8;0;8
18003;Žirmūnėliai;BORUŽIUKAI;7528704460;Taip;0;8;0;8
18004;Žirmūnėliai;BORUŽIUKAI;1618573494;Taip;13;6;0;19
18005;Žirmūnėliai;BORUŽIUKAI;31403739893;Ne;5;7;0;12
18006;Žirmūnėliai;BORUŽIUKAI;5367009184;Taip;0;0;1;1
18007;Žirmūnėliai;BORUŽIUKAI;3540307559;Taip;5;0;0;5
18008;Žirmūnėliai;BORUŽIUKAI;3274576752;Taip;0;3;0;3
18009;Žirmūnėliai;BORUŽIUKAI;5209700153;Taip;0;2;1;3
18010;Žirmūnėliai;BORUŽIUKAI;8339819296;Taip;0;0;2;2
18011;Žirmūnėliai;BORUŽIUKAI;2033271165;Taip;0;4;2;6
18012;Žirmūnėliai;EŽIUKAI;2661052835;Taip;0;10;0;10
18013;Žirmūnėliai;EŽIUKAI;1655437833;Taip;0;1;4;5
18014;Žirmūnėliai;EŽIUKAI;3640979388;Taip;0;1;0;1
18015;Žirmūnėliai;EŽIUKAI;6878528100;Taip;0;0;10;10
18016;Žirmūnėliai;EŽIUKAI;8440187348;Taip;4;1;0;5
18017;Žirmūnėliai;EŽIUKAI;4565479092;Taip;5;0;0;5
18018;Žirmūnėliai;EŽIUKAI;4968278870;Taip;7;0;1;8
18019;Žirmūnėliai;EŽIUKAI;2693415717;Taip;0;3;3;6
18020;Žirmūnėliai;EŽIUKAI;7953019230;Taip;5;10;0;15
18021;Žirmūnėliai;EŽIUKAI;1832367936;Taip;0;0;2;2
18022;Žirmūnėliai;EŽIUKAI;3180116136;Taip;0;3;0;3
18023;Žirmūnėliai;EŽIUKAI;9759491055;Taip;3;6;5;14
18024;Žirmūnėliai;EŽIUKAI;1127214387;Ne;5;1;2;8
18025;Žirmūnėliai;EŽIUKAI;4101748829;Taip;15;4;0;19
18026;Žirmūnėliai;EŽIUKAI;2379638934;Taip;0;9;0;9
18027;Žirmūnėliai;EŽIUKAI;6448582622;Taip;3;1;0;4
18028;Žirmūnėliai;EŽIUKAI;4710829908;Taip;0;3;0;3
18029;Žirmūnėliai;EŽIUKAI;7580002502;Taip;5;1;5;11
18030;Žirmūnėliai;EŽIUKAI;4638575301;Taip;0;2;0;2
18031;Žirmūnėliai;EŽIUKAI;3310847619;Taip;0;0;4;4
18032;Žirmūnėliai;EŽIUKAI;1977798059;Taip;0;4;12;16
18033;Žirmūnėliai;ŽVIRBLIUKAI;6896145409;Taip;0;3;0;3
18034;Žirmūnėliai;ŽVIRBLIUKAI;1255857051;Taip;4;0;0;4
18035;Žirmūnėliai;ŽVIRBLIUKAI;1347664230;Taip;0;2;15;17
18036;Žirmūnėliai;ŽVIRBLIUKAI;8030469722;Taip;0;1;3;4
18037;Žirmūnėliai;ŽVIRBLIUKAI;1381923106;Taip;0;4;0;4
18038;Žirmūnėliai;ŽVIRBLIUKAI;5037669167;Taip;0;5;1;6
18039;Žirmūnėliai;ŽVIRBLIUKAI;4598761492;Taip;0;3;0;3
18040;Žirmūnėliai;ŽVIRBLIUKAI;1435743911;Taip;9;0;0;9
18041;Žirmūnėliai;ŽVIRBLIUKAI;8308074932;Taip;3;4;0;7
18042;Žirmūnėliai;ŽVIRBLIUKAI;1761284228;Taip;0;3;2;5
18043;Žirmūnėliai;ŽVIRBLIUKAI;1894070647;Ne;0;3;0;3
18044;Žirmūnėliai;ŽVIRBLIUKAI;7062967491;Taip;0;2;1;3
18045;Žirmūnėliai;ŽVIRBLIUKAI;9482910388;Taip;0;9;0;9
18046;Žirmūnėliai;ŽVIRBLIUKAI;1569772948;Ne;11;0;0;11
18047;Žirmūnėliai;SPALVELĖS;4815427530;Taip;0;5;6;11
18048;Žirmūnėliai;SPALVELĖS;6641667315;Taip;0;3;0;3
18049;Žirmūnėliai;SPALVELĖS;9936156579;Ne;0;2;0;2
18050;Žirmūnėliai;SPALVELĖS;2985092368;Ne;10;1;0;11
18051;Žirmūnėliai;SPALVELĖS;2841958534;Taip;5;1;0;6
18052;Žirmūnėliai;SPALVELĖS;6259368139;Taip;4;10;0;14
18053;Žirmūnėliai;SPALVELĖS;1356219744;Taip;7;4;0;11
18054;Žirmūnėliai;SPALVELĖS;8538773532;Taip;0;5;2;7
18055;Žirmūnėliai;SPALVELĖS;3051025147;Taip;0;0;6;6
18056;Žirmūnėliai;SPALVELĖS;6934204209;Taip;14;0;0;14
18057;Žirmūnėliai;SPALVELĖS;9306935083;Taip;3;2;0;5
18058;Žirmūnėliai;SPALVELĖS;7067837709;Ne;3;0;0;3
18059;Žirmūnėliai;SPALVELĖS;5316869112;Taip;0;0;8;8
18060;Žirmūnėliai;SPALVELĖS;4807331877;Taip;6;0;4;10
18061;Žirmūnėliai;SPALVELĖS;8742911909;Taip;0;2;1;3
18062;Žirmūnėliai;SPALVELĖS;6817236579;Taip;0;12;0;12
18063;Žirmūnėliai;SPALVELĖS;9042509512;Taip;10;0;0;10
18064;Žirmūnėliai;SPALVELĖS;5076712824;Taip;0;3;0;3
18065;Žirmūnėliai;SPALVELĖS;8444883234;Ne;16;0;1;17
18066;Žirmūnėliai;DEBESĖLIAI;6908512961;Taip;0;14;0;14
18067;Žirmūnėliai;DEBESĖLIAI;1571242696;Taip;0;1;0;1
18068;Žirmūnėliai;DEBESĖLIAI;7087770068;Taip;10;2;0;12
18069;Žirmūnėliai;DEBESĖLIAI;4347548125;Taip;16;0;0;16
18070;Žirmūnėliai;DEBESĖLIAI;3330603362;Taip;9;0;1;10
18071;Žirmūnėliai;DEBESĖLIAI;5440814849;Taip;9;0;0;9
18072;Žirmūnėliai;DEBESĖLIAI;7680479258;Taip;0;0;1;1
18073;Žirmūnėliai;DEBESĖLIAI;8136265008;Taip;0;15;0;15
18074;Žirmūnėliai;DEBESĖLIAI;7568228423;Taip;0;3;2;5
18075;Žirmūnėliai;DEBESĖLIAI;9813507899;Taip;10;0;0;10
18076;Žirmūnėliai;DEBESĖLIAI;8687642039;Taip;0;0;3;3
18077;Žirmūnėliai;DEBESĖLIAI;5982848146;Taip;13;0;2;15
18078;Žirmūnėliai;DEBESĖLIAI;3646039695;Taip;0;1;0;1
18079;Žirmūnėliai;DEBESĖLIAI;5676730437;Taip;0;0;1;1
18080;Žirmūnėliai;DEBESĖLIAI;4653124134;Taip;9;0;0;9
18081;Žirmūnėliai;DEBESĖLIAI;4501490189;Taip;10;0;1;11
18082;Žirmūnėliai;DEBESĖLIAI;8239982682;Taip;0;0;2;2
18083;Žirmūnėliai;VIŠČIUKAI;2270868598;Taip;0;2;1;3
18084;Žirmūnėliai;VIŠČIUKAI;2802717644;Taip;0;2;0;2
18085;Žirmūnėliai;VIŠČIUKAI;3029428022;Taip;8;0;0;8
18086;Žirmūnėliai;VIŠČIUKAI;9759504463;Taip;8;0;0;8
18087;Žirmūnėliai;VIŠČIUKAI;4134541560;Taip;6;0;0;6
18088;Žirmūnėliai;VIŠČIUKAI;8481357052;Taip;6;0;0;6
18089;Žirmūnėliai;VIŠČIUKAI;6892941066;Taip;0;0;2;2
18090;Žirmūnėliai;VIŠČIUKAI;9858198555;Taip;2;0;0;2
18091;Žirmūnėliai;VIŠČIUKAI;3641319043;Taip;3;2;1;6
18092;Žirmūnėliai;VIŠČIUKAI;6523502376;Taip;5;0;1;6
18093;Žirmūnėliai;VIŠČIUKAI;9280663182;Taip;5;3;0;8
18094;Žirmūnėliai;VIŠČIUKAI;5281338626;Taip;5;0;0;5
18095;Žirmūnėliai;VIŠČIUKAI;9688006040;Taip;15;0;0;15
18096;Žirmūnėliai;VIŠČIUKAI;5622319185;Taip;8;0;3;11
18097;Žirmūnėliai;VIŠČIUKAI;7053321410;Taip;8;0;4;12
18098;Žirmūnėliai;VIŠČIUKAI;4512970900;Taip;0;0;1;1
18099;Žirmūnėliai;ZUIKUČIŲ;4291114238;Taip;5;3;0;8
18100;Žirmūnėliai;ZUIKUČIŲ;2229737837;Taip;0;9;13;22
18101;Žirmūnėliai;ZUIKUČIŲ;3977279181;Taip;11;0;0;11
18102;Žirmūnėliai;ZUIKUČIŲ;8002655555;Taip;0;12;0;12
18103;Žirmūnėliai;ZUIKUČIŲ;6427861912;Taip;12;0;0;12
18104;Žirmūnėliai;ZUIKUČIŲ;2736632324;Taip;8;0;0;8
18105;Žirmūnėliai;ZUIKUČIŲ;5892153807;Taip;7;1;0;8
18106;Žirmūnėliai;ZUIKUČIŲ;2870069039;Taip;7;1;4;12
18107;Žirmūnėliai;ZUIKUČIŲ;6543834058;Taip;3;0;3;6
18108;Žirmūnėliai;ZUIKUČIŲ;8271996884;Taip;0;1;1;2
18109;Žirmūnėliai;ZUIKUČIŲ;3012945005;Ne;4;0;0;4
18110;Žirmūnėliai;ZUIKUČIŲ;8782085662;Taip;13;1;1;15
18111;Žirmūnėliai;ZUIKUČIŲ;3174613910;Taip;2;1;2;5
18112;Žirmūnėliai;ZUIKUČIŲ;5668266601;Taip;9;0;3;12
18113;Žirmūnėliai;ZUIKUČIŲ;9472372819;Ne;5;2;3;10
18114;Žirmūnėliai;OBUOLIUKAI;4575123456;Taip;0;3;0;3
18115;Žirmūnėliai;OBUOLIUKAI;3795476732;Ne;5;0;2;7
18116;Žirmūnėliai;OBUOLIUKAI;1917500190;Ne;3;7;0;10
18117;Žirmūnėliai;OBUOLIUKAI;2073922023;Taip;3;0;0;3
18118;Žirmūnėliai;OBUOLIUKAI;7059249540;Taip;21;0;0;21
18119;Žirmūnėliai;OBUOLIUKAI;4999561481;Taip;5;2;0;7
18120;Žirmūnėliai;OBUOLIUKAI;6358006462;Taip;18;1;0;19
18121;Žirmūnėliai;OBUOLIUKAI;2497258407;Taip;4;5;0;9
18122;Žirmūnėliai;OBUOLIUKAI;3949374730;Taip;5;0;0;5
18123;Žirmūnėliai;OBUOLIUKAI;6869102228;Taip;13;0;0;13
18124;Žirmūnėliai;OBUOLIUKAI;9367849317;Taip;5;3;0;8
18125;Žirmūnėliai;OBUOLIUKAI;9892620134;Taip;0;2;0;2
18126;Žirmūnėliai;OBUOLIUKAI;6450412481;Taip;10;0;0;10
18127;Žirmūnėliai;OBUOLIUKAI;9225654910;Taip;1;4;0;5
18128;Žirmūnėliai;OBUOLIUKAI;5483418311;Taip;5;0;0;5
18129;Žirmūnėliai;OBUOLIUKAI;7945713337;Taip;5;0;0;5
18130;Žirmūnėliai;OBUOLIUKAI;8823426998;Taip;0;6;0;6
18131;Žirmūnėliai;DAINORĖLIAI;1255294064;Taip;21;1;1;23
18132;Žirmūnėliai;DAINORĖLIAI;5616289290;Taip;21;0;0;21
18133;Žirmūnėliai;DAINORĖLIAI;3520677404;Taip;4;4;1;9
18134;Žirmūnėliai;DAINORĖLIAI;9978718231;Taip;4;1;0;5
18135;Žirmūnėliai;DAINORĖLIAI;7589155099;Taip;0;2;3;5
18136;Žirmūnėliai;DAINORĖLIAI;4641264260;Taip;5;0;0;5
18137;Žirmūnėliai;DAINORĖLIAI;8794707243;Taip;6;13;1;20
18138;Žirmūnėliai;DAINORĖLIAI;3546787595;Ne;11;0;0;11
18139;Žirmūnėliai;DAINORĖLIAI;5646794795;Taip;0;0;4;4
18140;Žirmūnėliai;DAINORĖLIAI;5901940160;Taip;8;0;0;8
18141;Žirmūnėliai;DAINORĖLIAI;9908958250;Taip;8;6;0;14
18142;Žirmūnėliai;DAINORĖLIAI;1116572386;Taip;4;1;4;9
18143;Žirmūnėliai;DAINORĖLIAI;6991062262;Taip;3;0;0;3
18144;Dainorėliai;VARPELIAI;87242570532;Taip;0;2;2;4
18145;Dainorėliai;VARPELIAI;18233813290;Taip;0;3;0;3
18146;Dainorėliai;VARPELIAI;6176171443;Taip;0;5;0;5
18147;Dainorėliai;VARPELIAI;88781762328;Taip;7;1;0;8
18148;Dainorėliai;VARPELIAI;7822546498;Taip;0;1;0;1
18149;Dainorėliai;VARPELIAI;5693385617;Taip;5;3;0;8
18150;Dainorėliai;VARPELIAI;8267213392;Taip;0;8;0;8
18151;Dainorėliai;VARPELIAI;5959380807;Taip;0;1;0;1
18152;Dainorėliai;VARPELIAI;2938732886;Taip;0;3;0;3
18153;Dainorėliai;VARPELIAI;3183793211;Taip;8;0;0;8
18154;Dainorėliai;VARPELIAI;65467351140;Taip;0;1;0;1
18155;Dainorėliai;VARPELIAI;8521878734;Taip;0;3;0;3
18156;Dainorėliai;VARPELIAI;1928369859;Ne;3;2;1;6
18157;Dainorėliai;VARPELIAI;6430425182;Taip;0;2;0;2
18158;Dainorėliai;VARPELIAI;4269946363;Taip;0;1;0;1
18159;Dainorėliai;VARPELIAI;1088248393;Taip;15;0;0;15
18160;Dainorėliai;VARPELIAI;2070086316;Taip;0;3;0;3
18161;Dainorėliai;VARPELIAI;2074070030;Taip;0;3;0;3
18162;Dainorėliai;VARPELIAI;4591161640;Taip;0;4;0;4
18163;Dainorėliai;VARPELIAI;6909583023;Taip;3;0;0;3
18164;Dainorėliai;VARPELIAI;9319771186;Taip;8;2;0;10
18165;Dainorėliai;VARPELIAI;68134437706;Taip;0;4;0;4
18166;Dainorėliai;ŽIOGELIAI;5591598390;Taip;3;5;0;8
18167;Dainorėliai;ŽIOGELIAI;6481621329;Ne;4;1;0;5
18168;Dainorėliai;ŽIOGELIAI;5715129088;Taip;6;0;0;6
18169;Dainorėliai;ŽIOGELIAI;9132532505;Taip;10;1;0;11
18170;Dainorėliai;ŽIOGELIAI;2450726148;Taip;11;0;0;11
18171;Dainorėliai;ŽIOGELIAI;5793828922;Taip;0;2;0;2
18172;Dainorėliai;ŽIOGELIAI;7591953671;Taip;17;0;0;17
18173;Dainorėliai;ŽIOGELIAI;6169434322;Taip;7;1;0;8
18174;Dainorėliai;ŽIOGELIAI;2094849111;Taip;5;0;0;5
18175;Dainorėliai;ŽIOGELIAI;6659114730;Taip;12;0;1;13
18176;Dainorėliai;ŽIOGELIAI;3887433142;Taip;8;3;0;11
18177;Dainorėliai;ŽIOGELIAI;2541781620;Taip;4;5;0;9
18178;Dainorėliai;ŽIOGELIAI;8239000041;Taip;0;3;0;3
18179;Dainorėliai;ŽIOGELIAI;7984447187;Taip;11;0;0;11
18180;Dainorėliai;ŽIOGELIAI;3897725337;Taip;1;0;0;1
18181;Dainorėliai;ŽIOGELIAI;4307634491;Taip;0;1;0;1
18182;Dainorėliai;ŽIOGELIAI;3598951899;Taip;16;4;0;20
18183;Dainorėliai;ŽIOGELIAI;4973241539;Taip;0;19;0;19
18184;Dainorėliai;ŽIOGELIAI;3592770633;Taip;5;0;0;5
18185;Dainorėliai;ŽIOGELIAI;4969782237;Taip;0;3;0;3
18186;Dainorėliai;DRUGELIAI;6403389248;Taip;0;2;1;3
18187;Dainorėliai;DRUGELIAI;8962657389;Taip;0;2;5;7
18188;Dainorėliai;DRUGELIAI;2703267758;Taip;6;1;0;7
18189;Dainorėliai;DRUGELIAI;6899629612;Taip;0;2;0;2
18190;Dainorėliai;DRUGELIAI;2605119306;Taip;8;0;0;8
18191;Dainorėliai;DRUGELIAI;9976869100;Taip;0;0;1;1
18192;Dainorėliai;DRUGELIAI;9303046800;Taip;0;2;1;3
18193;Dainorėliai;DRUGELIAI;5854379630;Taip;3;0;0;3
18194;Dainorėliai;DRUGELIAI;3711954197;Taip;15;0;0;15
18195;Dainorėliai;DRUGELIAI;3573324654;Taip;0;1;0;1
18196;Dainorėliai;DRUGELIAI;3741337791;Taip;0;4;0;4
18197;Dainorėliai;DRUGELIAI;1718576253;Taip;0;2;0;2
18198;Dainorėliai;DRUGELIAI;2803571247;Taip;0;5;4;9
18199;Dainorėliai;DRUGELIAI;5084474142;Taip;0;1;0;1
18200;Dainorėliai;DRUGELIAI;1332165159;Taip;7;0;0;7
18201;Dainorėliai;DRUGELIAI;8684975630;Taip;4;9;0;13
18202;Dainorėliai;DRUGELIAI;2740773904;Taip;18;0;0;18
18203;Dainorėliai;DRUGELIAI;6460217912;Taip;0;13;0;13
18204;Dainorėliai;"1 klasė";2520667095;Taip;0;3;0;3
18205;Dainorėliai;"1 klasė";1333499160;Taip;3;3;0;6
18206;Dainorėliai;"1 klasė";50432354832;Taip;1;3;0;4
18207;Dainorėliai;"1 klasė";1626877066;Taip;0;3;0;3
18208;Dainorėliai;"1 klasė";1158895670;Taip;0;3;0;3
18209;Dainorėliai;"1 klasė";73649870571;Taip;10;3;0;13
18210;Dainorėliai;"1 klasė";19286303769;Taip;0;3;0;3
18211;Dainorėliai;"1 klasė";73386013083;Taip;0;3;0;3
18212;Dainorėliai;"1 klasė";27521381629;Taip;0;3;0;3
18213;Dainorėliai;"1 klasė";53935690864;Taip;0;3;0;3
18214;Dainorėliai;"1 klasė";6411939690;Taip;0;3;0;3
18215;Dainorėliai;"1 klasė";2287353933;Taip;5;3;0;8
18216;Dainorėliai;"1 klasė";36313982965;Taip;0;3;0;3
18217;Dainorėliai;"1 klasė";86659723162;Taip;0;3;0;3
18218;Dainorėliai;"1 klasė";5479496104;Ne;2;3;0;5
18219;Dainorėliai;"1 klasė";94480397292;Ne;0;3;0;3
18220;Dainorėliai;"1 klasė";6404337541;Taip;5;3;0;8
18221;Dainorėliai;"1 klasė";49483881135;Taip;0;3;0;3
18222;Dainorėliai;"1 klasė";86187568203;Taip;0;3;0;3
18223;Dainorėliai;"1 klasė";1015870220;Taip;0;3;0;3
18224;Dainorėliai;"1 klasė";1515552402;Taip;0;3;0;3
18225;Dainorėliai;"1 klasė";7114409929;Taip;0;3;0;3
18226;Dainorėliai;"1 klasė";1084400276;Taip;0;3;0;3
18227;Dainorėliai;"1 klasė";1531362555;Ne;4;3;0;7
18228;Dainorėliai;"1 klasė";6195426672;Taip;0;3;0;3
18229;Dainorėliai;"2 klasė";67124516230;Ne;0;3;0;3
18230;Dainorėliai;"2 klasė";7506194777;Taip;0;3;0;3
18231;Dainorėliai;"2 klasė";1829858221;Taip;5;3;0;8
18232;Dainorėliai;"2 klasė";1470784692;Taip;0;3;0;3
18233;Dainorėliai;"2 klasė";7569146994;Taip;0;3;0;3
18234;Dainorėliai;"2 klasė";45577031767;Taip;0;3;0;3
18235;Dainorėliai;"2 klasė";58071607976;Ne;2;3;0;5
18236;Dainorėliai;"2 klasė";1646521870;Taip;0;3;0;3
18237;Dainorėliai;"2 klasė";29132059636;Taip;0;3;0;3
18238;Dainorėliai;"2 klasė";32573583030;Taip;0;3;0;3
18239;Dainorėliai;"2 klasė";97947842490;Taip;0;3;0;3
18240;Dainorėliai;"2 klasė";63211091321;Taip;4;3;0;7
18241;Dainorėliai;"2 klasė";87717571411;Taip;0;3;0;3
18242;Dainorėliai;"2 klasė";18936645521;Taip;0;3;0;3
18243;Dainorėliai;"2 klasė";80499999855;Ne;0;3;0;3
18244;Dainorėliai;"2 klasė";6948863728;Taip;0;3;0;3
18245;Dainorėliai;"2 klasė";2531690903;Taip;5;3;0;8
18246;Dainorėliai;"2 klasė";35134511946;Taip;0;3;0;3
18247;Dainorėliai;"2 klasė";1121139222;Taip;0;3;0;3
18248;Dainorėliai;"2 klasė";99597416067;Taip;0;3;0;3
18249;Dainorėliai;"2 klasė";77718940253;Taip;0;3;0;3
18250;Dainorėliai;"2 klasė";5236797727;Taip;5;3;0;8
18251;Dainorėliai;"3 klasė";2045625141;Taip;2;3;0;5
18252;Dainorėliai;"3 klasė";84084897419;Taip;1;3;0;4
18253;Dainorėliai;"3 klasė";34219208558;Taip;5;3;0;8
18254;Dainorėliai;"3 klasė";13138644060;Taip;0;3;0;3
18255;Dainorėliai;"3 klasė";49342277188;Taip;1;3;0;4
18256;Dainorėliai;"3 klasė";42402953271;Taip;0;3;0;3
18257;Dainorėliai;"3 klasė";2441164154;Taip;0;3;0;3
18258;Dainorėliai;"3 klasė";69556449215;Taip;0;3;0;3
18259;Dainorėliai;"3 klasė";8244355193;Taip;1;3;0;4
18260;Dainorėliai;"3 klasė";2142553899;Taip;5;3;0;8
18261;Dainorėliai;"3 klasė";37660372564;Taip;0;3;0;3
18262;Dainorėliai;"3 klasė";1889037823;Taip;0;3;0;3
18263;Dainorėliai;"3 klasė";98796240124;Taip;0;3;0;3
18264;Dainorėliai;"3 klasė";98830139164;Taip;1;3;0;4
18265;Dainorėliai;"3 klasė";37708779599;Taip;0;3;0;3
18266;Dainorėliai;"3 klasė";18741625569;Taip;0;3;0;3
18267;Dainorėliai;"3 klasė";84424772471;Taip;0;3;0;3
18268;Dainorėliai;"3 klasė";34686211072;Taip;1;3;0;4
18269;Dainorėliai;"3 klasė";79461209783;Taip;0;3;0;3
18270;Dainorėliai;"3 klasė";47323045857;Taip;1;3;0;4
18271;Dainorėliai;"3 klasė";10679627657;Taip;0;3;0;3
18272;Dainorėliai;"3 klasė";25073134850;Taip;0;3;0;3
18273;Dainorėliai;"3 klasė";65118883315;Taip;0;3;0;3
18274;Dainorėliai;"3 klasė";84999972369;Taip;1;3;0;4
18275;Dainorėliai;"3 klasė";1209781483;Taip;5;3;0;8
18276;Dainorėliai;"3 klasė";69732047046;Taip;6;3;0;9
18277;Dainorėliai;"4 klasė";29726515194;Taip;1;3;0;4
18278;Dainorėliai;"4 klasė";8562371599;Taip;2;3;0;5
18279;Dainorėliai;"4 klasė";19292860218;Taip;1;3;0;4
18280;Dainorėliai;"4 klasė";97182565649;Taip;0;3;0;3
18281;Dainorėliai;"4 klasė";65982869126;Taip;5;3;0;8
18282;Dainorėliai;"4 klasė";93738984644;Taip;0;3;0;3
18283;Dainorėliai;"4 klasė";69409530494;Taip;0;3;0;3
18284;Dainorėliai;"4 klasė";57179351170;Taip;0;3;0;3
18285;Dainorėliai;"4 klasė";77907054102;Taip;0;3;0;3
18286;Dainorėliai;"4 klasė";24048489264;Ne;0;3;0;3
18287;Dainorėliai;"4 klasė";4773358825;Taip;1;3;0;4
18288;Dainorėliai;"4 klasė";91457137356;Taip;3;3;0;6
18289;Dainorėliai;"4 klasė";5010994621;Taip;0;3;0;3
18290;Dainorėliai;"4 klasė";13846131820;Taip;1;3;0;4
18291;Dainorėliai;"4 klasė";23144978287;Taip;1;3;0;4
18292;Dainorėliai;"4 klasė";6203511535;Taip;2;3;0;5
18293;Dainorėliai;"4 klasė";81956978417;Taip;1;3;0;4
18294;Dainorėliai;"4 klasė";3018657993;Taip;0;3;0;3
18295;Dainorėliai;"4 klasė";48245075123;Taip;0;3;0;3
18296;Dainorėliai;"4 klasė";57618865048;Taip;2;3;0;5
18297;Dainorėliai;"4 klasė";84749521489;Taip;0;10;0;10
18298;Dainorėliai;"4 klasė";26315465923;Taip;0;3;0;3
18299;Dainorėliai;SAULUTĖS;4798415786;Ne;0;3;0;3
18300;Dainorėliai;SAULUTĖS;6704354150;Taip;0;5;0;5
18301;Dainorėliai;SAULUTĖS;4612995336;Ne;0;1;0;1
18302;Dainorėliai;SAULUTĖS;5687390372;Taip;0;4;0;4
18303;Dainorėliai;SAULUTĖS;4307591123;Taip;0;3;0;3
18304;Dainorėliai;SAULUTĖS;5632663846;Taip;0;1;0;1
18305;Dainorėliai;SAULUTĖS;7804441689;Taip;7;1;1;9
18306;Dainorėliai;SAULUTĖS;6090746954;Taip;0;7;0;7
18307;Dainorėliai;SAULUTĖS;5410183494;Taip;2;3;0;5
18308;Dainorėliai;SAULUTĖS;9130473411;Taip;0;3;0;3
18309;Dainorėliai;SAULUTĖS;5587907483;Ne;11;1;2;14
18310;Dainorėliai;SAULUTĖS;3762178533;Taip;6;1;1;8
18311;Dainorėliai;SAULUTĖS;2064843848;Taip;5;3;0;8
18312;Dainorėliai;SAULUTĖS;4431804759;Taip;0;13;0;13
18313;Dainorėliai;SAULUTĖS;8857018998;Taip;6;1;0;7
18314;Dainorėliai;SAULUTĖS;1547686786;Taip;0;2;0;2
18315;Dainorėliai;SAULUTĖS;6697149560;Taip;3;0;0;3
18316;Dainorėliai;PUMPURĖLIŲ;6132543858;Taip;0;0;1;1
18317;Dainorėliai;PUMPURĖLIŲ;5691833295;Taip;0;15;6;21
18318;Dainorėliai;PUMPURĖLIŲ;4560328911;Taip;10;0;0;10
18319;Dainorėliai;PUMPURĖLIŲ;4435310580;Taip;5;1;21;27
18320;Dainorėliai;PUMPURĖLIŲ;7197089520;Taip;0;0;3;3
18321;Dainorėliai;PUMPURĖLIŲ;6362265057;Taip;0;1;0;1
18322;Dainorėliai;PUMPURĖLIŲ;2215481883;Taip;0;4;7;11
18323;Dainorėliai;PUMPURĖLIŲ;1233029451;Taip;2;3;11;16
18324;Dainorėliai;PUMPURĖLIŲ;3561729784;Taip;3;0;3;6
18325;Dainorėliai;PUMPURĖLIŲ;5534783929;Taip;4;0;0;4
18326;Dainorėliai;PUMPURĖLIŲ;3705286231;Taip;0;2;0;2
18327;Dainorėliai;PUMPURĖLIŲ;4848146301;Taip;0;0;2;2
18328;Dainorėliai;DEBESĖLIŲ;2095914442;Taip;0;1;0;1
18329;Dainorėliai;DEBESĖLIŲ;3271090533;Taip;11;4;4;19
18330;Dainorėliai;DEBESĖLIŲ;6284140548;Ne;0;13;0;13
18331;Dainorėliai;DEBESĖLIŲ;5605084046;Taip;0;1;0;1
18332;Dainorėliai;DEBESĖLIŲ;5283566263;Taip;0;4;0;4
18333;Dainorėliai;DEBESĖLIŲ;9285865812;Taip;0;4;0;4
18334;Dainorėliai;DEBESĖLIŲ;2823401633;Taip;0;10;0;10
18335;Dainorėliai;DEBESĖLIŲ;6513417505;Taip;5;5;0;10
18336;Dainorėliai;DEBESĖLIŲ;1873415679;Ne;0;3;0;3
18337;Dainorėliai;DEBESĖLIŲ;1554081754;Taip;3;0;0;3
18338;Dainorėliai;DEBESĖLIŲ;6449332338;Taip;0;4;0;4
18339;Dainorėliai;DEBESĖLIŲ;2534758615;Taip;0;3;0;3
18340;Dainorėliai;DEBESĖLIŲ;4255893222;Taip;0;4;7;11
18341;Dainorėliai;DEBESĖLIŲ;4033317616;Taip;5;5;0;10
18342;Lokiukas;BITUTĖS;3329205450;Taip;10;3;1;14
18343;Lokiukas;BITUTĖS;7920238202;Taip;0;0;1;1
18344;Lokiukas;BITUTĖS;1376124245;Taip;0;23;0;23
18345;Lokiukas;BITUTĖS;2181315008;Taip;0;0;3;3
18346;Lokiukas;BITUTĖS;3896883842;Taip;18;0;0;18
18347;Lokiukas;BITUTĖS;8656751314;Taip;18;0;0;18
18348;Lokiukas;BITUTĖS;4551069961;Taip;0;3;7;10
18349;Lokiukas;BITUTĖS;5794303981;Taip;13;1;0;14
18350;Lokiukas;BITUTĖS;2671053309;Taip;11;1;0;12
18351;Lokiukas;BITUTĖS;6883994020;Taip;0;3;1;4
18352;Lokiukas;BITUTĖS;8209165996;Taip;0;4;0;4
18353;Lokiukas;BITUTĖS;1647778939;Taip;6;3;4;13
18354;Lokiukas;BITUTĖS;9480025132;Taip;0;0;1;1
18355;Lokiukas;BITUTĖS;6260486656;Taip;0;15;2;17
18356;Lokiukas;BITUTĖS;8334800302;Taip;0;3;0;3
18357;Lokiukas;BITUTĖS;1987485885;Ne;0;3;3;6
18358;Lokiukas;BITUTĖS;8378138411;Ne;8;0;2;10
18359;Lokiukas;BITUTĖS;3397999534;Taip;0;3;0;3
18360;Lokiukas;BITUTĖS;8059759103;Taip;0;1;0;1
18361;Lokiukas;BITUTĖS;8994257898;Taip;15;0;0;15
18362;Lokiukas;"1 B klasė";14605095801;Taip;2;3;0;5
18363;Lokiukas;"1 B klasė";8036643654;Taip;0;3;0;3
18364;Lokiukas;"1 B klasė";5879386524;Taip;2;3;0;5
18365;Lokiukas;"1 B klasė";9625041533;Ne;11;3;0;14
18366;Lokiukas;"1 B klasė";2476231041;Ne;14;0;0;14
18367;Lokiukas;"1 B klasė";2548712970;Taip;1;3;0;4
18368;Lokiukas;"1 B klasė";1570438208;Taip;23;0;0;23
18369;Lokiukas;"1 B klasė";2673522432;Taip;23;0;0;23
18370;Lokiukas;"1 B klasė";47399326083;Taip;0;3;0;3
18371;Lokiukas;"1 B klasė";7591418969;Ne;1;3;0;4
18372;Lokiukas;"1 B klasė";4569798381;Taip;23;0;0;23
18373;Lokiukas;"1 B klasė";8399364170;Taip;11;3;0;14
18374;Lokiukas;"1 B klasė";97284171512;Taip;0;3;0;3
18375;Lokiukas;"1 B klasė";5943583254;Taip;1;3;0;4
18376;Lokiukas;"1 B klasė";3070998871;Taip;2;3;0;5
18377;Lokiukas;"1 B klasė";5453470660;Taip;1;3;0;4
18378;Lokiukas;"1 B klasė";4427448272;Taip;23;0;0;23
18379;Lokiukas;"1 B klasė";20659573470;Taip;23;0;0;23
18380;Lokiukas;"1 B klasė";5437008837;Taip;4;3;0;7
18381;Lokiukas;"1 B klasė";4580716838;Taip;0;3;0;3
18382;Lokiukas;"1 B klasė";39975872119;Taip;0;3;0;3
18383;Lokiukas;"1 B klasė";8568285232;Taip;0;3;0;3
18384;Lokiukas;"1 B klasė";9501202273;Taip;1;3;0;4
18385;Lokiukas;"1 B klasė";8943496964;Ne;21;0;0;21
18386;Lokiukas;"1 A klasė";56069293343;Taip;1;3;0;4
18387;Lokiukas;"1 A klasė";69364831994;Ne;6;0;0;6
18388;Lokiukas;"1 A klasė";1230490562;Ne;23;0;0;23
18389;Lokiukas;"1 A klasė";8452600632;Taip;3;3;0;6
18390;Lokiukas;"1 A klasė";39222094073;Taip;2;3;0;5
18391;Lokiukas;"1 A klasė";74169282323;Taip;8;3;0;11
18392;Lokiukas;"1 A klasė";35890122494;Taip;1;3;0;4
18393;Lokiukas;"1 A klasė";1626698185;Taip;6;3;0;9
18394;Lokiukas;"1 A klasė";8455869600;Taip;1;3;0;4
18395;Lokiukas;"1 A klasė";1625137322;Taip;2;3;0;5
18396;Lokiukas;"1 A klasė";2170176922;Ne;10;3;0;13
18397;Lokiukas;"1 A klasė";8270572748;Ne;1;3;0;4
18398;Lokiukas;"1 A klasė";34800098950;Taip;4;3;0;7
18399;Lokiukas;"1 A klasė";3825101647;Ne;20;3;0;23
18400;Lokiukas;"1 A klasė";8618280811;Ne;2;3;0;5
18401;Lokiukas;"1 A klasė";8323172347;Taip;7;3;0;10
18402;Lokiukas;"1 A klasė";7844351275;Ne;11;3;0;14
18403;Lokiukas;"1 A klasė";2045735700;Taip;1;3;0;4
18404;Lokiukas;"1 A klasė";3981653153;Ne;1;3;0;4
18405;Lokiukas;"1 A klasė";6318538591;Taip;1;3;0;4
18406;Lokiukas;"1 A klasė";43500434912;Taip;8;3;0;11
18407;Lokiukas;"1 A klasė";25141529581;Taip;1;3;0;4
18408;Lokiukas;"1 A klasė";3369746590;Taip;1;3;0;4
18409;Lokiukas;"1 A klasė";3004895246;Ne;15;3;0;18
18410;Lokiukas;"1 A klasė";3061816821;Ne;1;3;0;4
18411;Lokiukas;GUDRUČIAI;8687864179;Ne;1;0;1;2
18412;Lokiukas;GUDRUČIAI;5446430319;Taip;4;3;5;12
18413;Lokiukas;GUDRUČIAI;5995034919;Taip;10;3;0;13
18414;Lokiukas;GUDRUČIAI;2354942164;Ne;0;3;1;4
18415;Lokiukas;GUDRUČIAI;35364823312;Taip;0;3;0;3
18416;Lokiukas;GUDRUČIAI;5076773045;Taip;1;0;2;3
18417;Lokiukas;GUDRUČIAI;1188049956;Taip;0;3;0;3
18418;Lokiukas;GUDRUČIAI;1620856143;Ne;4;3;0;7
18419;Lokiukas;GUDRUČIAI;1733486244;Taip;7;0;1;8
18420;Lokiukas;GUDRUČIAI;4633366779;Taip;0;3;0;3
18421;Lokiukas;GUDRUČIAI;3485639108;Taip;4;0;1;5
18422;Lokiukas;GUDRUČIAI;3991821717;Taip;3;7;0;10
18423;Lokiukas;GUDRUČIAI;1606617694;Taip;5;7;0;12
18424;Lokiukas;GUDRUČIAI;8243342948;Taip;0;3;0;3
18425;Lokiukas;GUDRUČIAI;1210407640;Taip;0;3;2;5
18426;Lokiukas;BORUŽĖLĖS;4849031542;Taip;0;3;2;5
18427;Lokiukas;BORUŽĖLĖS;2625981190;Taip;6;3;0;9
18428;Lokiukas;BORUŽĖLĖS;4585621105;Taip;0;2;0;2
18429;Lokiukas;BORUŽĖLĖS;8576418875;Taip;10;6;0;16
18430;Lokiukas;BORUŽĖLĖS;6869785650;Taip;0;8;0;8
18431;Lokiukas;BORUŽĖLĖS;8630112458;Taip;1;3;2;6
18432;Lokiukas;BORUŽĖLĖS;3930463578;Taip;0;3;2;5
18433;Lokiukas;BORUŽĖLĖS;2660616022;Taip;0;3;0;3
18434;Lokiukas;BORUŽĖLĖS;9798351980;Taip;10;0;2;12
18435;Lokiukas;BORUŽĖLĖS;5401463671;Ne;0;3;0;3
18436;Lokiukas;BORUŽĖLĖS;9996442005;Ne;0;3;0;3
18437;Lokiukas;BORUŽĖLĖS;1226376844;Taip;0;2;0;2
18438;Lokiukas;BORUŽĖLĖS;4840187188;Taip;15;3;0;18
18439;Lokiukas;BORUŽĖLĖS;1724976098;Taip;0;16;0;16
18440;Lokiukas;BORUŽĖLĖS;7426579018;Taip;7;8;0;15
18441;Lokiukas;BORUŽĖLĖS;1974049743;Ne;0;4;1;5
18442;Lokiukas;BORUŽĖLĖS;3733581089;Taip;0;3;3;6
18443;Lokiukas;BORUŽĖLĖS;3876368364;Taip;10;2;0;12
18444;Lokiukas;BORUŽĖLĖS;9354491312;Taip;13;2;0;15
18445;Lokiukas;BORUŽĖLĖS;1076719080;Taip;5;4;0;9
18446;Lokiukas;ANČIUKAI;5982831490;Ne;7;3;0;10
18447;Lokiukas;ANČIUKAI;5670185948;Ne;0;3;4;7
18448;Lokiukas;ANČIUKAI;5843699073;Taip;5;3;0;8
18449;Lokiukas;ANČIUKAI;4788062781;Taip;0;23;0;23
18450;Lokiukas;ANČIUKAI;8758248334;Taip;4;3;0;7
18451;Lokiukas;ANČIUKAI;2466354050;Taip;0;3;0;3
18452;Lokiukas;ANČIUKAI;3849212461;Taip;5;3;7;15
18453;Lokiukas;ANČIUKAI;1756658146;Taip;8;3;4;15
18454;Lokiukas;ANČIUKAI;3668903653;Taip;14;1;1;16
18455;Lokiukas;ANČIUKAI;7509043689;Taip;11;0;0;11
18456;Lokiukas;ANČIUKAI;2266747745;Taip;14;3;0;17
18457;Lokiukas;ANČIUKAI;4417116107;Taip;0;1;1;2
18458;Lokiukas;ANČIUKAI;5893844708;Taip;6;1;0;7
18459;Lokiukas;ANČIUKAI;3015119335;Taip;0;13;2;15
18460;Lokiukas;ANČIUKAI;1712365476;Taip;0;23;0;23
18461;Lokiukas;ANČIUKAI;6827710384;Taip;0;23;0;23
18462;Lokiukas;KODĖLČIUKAI;2642065594;Taip;0;10;0;10
18463;Lokiukas;KODĖLČIUKAI;5943412920;Taip;4;3;0;7
18464;Lokiukas;KODĖLČIUKAI;6758550653;Taip;5;5;5;15
18465;Lokiukas;KODĖLČIUKAI;6336140882;Taip;0;11;4;15
18466;Lokiukas;KODĖLČIUKAI;8775608581;Taip;0;3;0;3
18467;Lokiukas;KODĖLČIUKAI;8915504279;Taip;0;3;0;3
18468;Lokiukas;KODĖLČIUKAI;4379238557;Taip;5;2;0;7
18469;Lokiukas;KODĖLČIUKAI;3694653020;Ne;0;1;0;1
18470;Lokiukas;KODĖLČIUKAI;4060641736;Ne;6;5;1;12
18471;Lokiukas;KODĖLČIUKAI;1025576053;Taip;0;1;0;1
18472;Lokiukas;KODĖLČIUKAI;1040288021;Taip;8;3;0;11
18473;Lokiukas;KODĖLČIUKAI;34546519642;Taip;5;2;0;7
18474;Lokiukas;KODĖLČIUKAI;9336617879;Taip;0;2;0;2
18475;Lokiukas;KODĖLČIUKAI;7943213321;Taip;0;5;1;6
18476;Lokiukas;KODĖLČIUKAI;6069516217;Taip;0;3;2;5
18477;Lokiukas;KODĖLČIUKAI;1752784666;Taip;8;4;0;12
18478;Lokiukas;KODĖLČIUKAI;4007839265;Taip;0;1;0;1
18479;Lokiukas;KODĖLČIUKAI;5467387832;Taip;2;3;0;5
18480;Lokiukas;KODĖLČIUKAI;9307491947;Taip;0;2;0;2
18481;Lokiukas;KODĖLČIUKAI;3744484616;Ne;2;3;0;5
18482;Lokiukas;KODĖLČIUKAI;8286358519;Taip;2;3;4;9
18483;Lokiukas;KODĖLČIUKAI;1886540733;Taip;2;3;0;5
18484;Lokiukas;KODĖLČIUKAI;8902619265;Taip;0;1;2;3
18485;Lokiukas;DRUGELIAI;1170293017;Taip;8;3;0;11
18486;Lokiukas;DRUGELIAI;4442073527;Taip;8;4;0;12
18487;Lokiukas;DRUGELIAI;2021477393;Taip;5;0;0;5
18488;Lokiukas;DRUGELIAI;4206181176;Taip;3;9;0;12
18489;Lokiukas;DRUGELIAI;7006828256;Taip;15;3;0;18
18490;Lokiukas;DRUGELIAI;7532603655;Taip;6;1;0;7
18491;Lokiukas;DRUGELIAI;4858829710;Taip;17;0;0;17
18492;Lokiukas;DRUGELIAI;8329540746;Taip;0;1;0;1
18493;Lokiukas;DRUGELIAI;2782818158;Taip;5;0;0;5
18494;Lokiukas;DRUGELIAI;4197547631;Taip;11;5;0;16
18495;Lokiukas;DRUGELIAI;8596706753;Taip;8;2;0;10
18496;Lokiukas;DRUGELIAI;4272205822;Taip;6;0;0;6
18497;Lokiukas;DRUGELIAI;2374601283;Taip;0;3;1;4
18498;Lokiukas;DRUGELIAI;7195184433;Taip;12;4;0;16
18499;Lokiukas;DRUGELIAI;4919744559;Taip;13;5;0;18
18500;Lokiukas;DRUGELIAI;6226281752;Taip;5;3;0;8
18501;Lokiukas;DRUGELIAI;1390586527;Taip;16;0;1;17
18502;Lokiukas;DRUGELIAI;8266708371;Taip;11;0;0;11
18503;Lokiukas;DRUGELIAI;2093224908;Taip;4;4;0;8
18504;Lokiukas;DRUGELIAI;1341265560;Taip;0;7;0;7
18505;Lokiukas;DRUGELIAI;5131662172;Ne;18;0;0;18
18506;Lokiukas;DRUGELIAI;1913742619;Ne;0;3;0;3
18507;Lokiukas;DRUGELIAI;4284574166;Ne;5;3;0;8
18508;Lokiukas;"2 A klasė";1201125655;Taip;0;3;0;3
18509;Lokiukas;"2 A klasė";2502465398;Taip;8;3;0;11
18510;Lokiukas;"2 A klasė";67133709394;Taip;9;3;0;12
18511;Lokiukas;"2 A klasė";73696992182;Ne;1;3;0;4
18512;Lokiukas;"2 A klasė";1056075876;Taip;0;3;0;3
18513;Lokiukas;"2 A klasė";9890308887;Taip;5;3;0;8
18514;Lokiukas;"2 A klasė";82025637099;Ne;5;3;0;8
18515;Lokiukas;"2 A klasė";8846527481;Taip;0;3;0;3
18516;Lokiukas;"2 A klasė";4353695640;Ne;3;3;0;6
18517;Lokiukas;"2 A klasė";73515179103;Taip;4;3;0;7
18518;Lokiukas;"2 A klasė";36677665098;Taip;0;3;0;3
18519;Lokiukas;"2 A klasė";131300206;Taip;2;3;0;5
18520;Lokiukas;"2 A klasė";77512682081;Taip;0;3;0;3
18521;Lokiukas;"2 A klasė";66528256040;Taip;0;3;0;3
18522;Lokiukas;"2 A klasė";86120193313;Taip;5;3;0;8
18523;Lokiukas;"2 A klasė";45028887854;Taip;5;3;0;8
18524;Lokiukas;"2 A klasė";83528495608;Taip;2;3;0;5
18525;Lokiukas;"2 A klasė";51237034253;Taip;5;3;0;8
18526;Lokiukas;"2 A klasė";52940830874;Taip;5;3;0;8
18527;Lokiukas;"2 A klasė";8240261104;Taip;6;3;0;9
18528;Lokiukas;"2 A klasė";27403835292;Taip;1;3;0;4
18529;Lokiukas;"2 A klasė";83086633109;Taip;9;3;0;12
18530;Lokiukas;"2 A klasė";38884246104;Taip;11;3;0;14
18531;Lokiukas;"2 B klasė";7235277422;Taip;0;3;0;3
18532;Lokiukas;"2 B klasė";1133294157;Taip;0;3;0;3
18533;Lokiukas;"2 B klasė";1072148409;Taip;1;3;0;4
18534;Lokiukas;"2 B klasė";92373834478;Ne;5;3;0;8
18535;Lokiukas;"2 B klasė";2054450461;Taip;8;3;0;11
18536;Lokiukas;"2 B klasė";3255141230;Taip;23;0;0;23
18537;Lokiukas;"2 B klasė";3255141230;Taip;23;0;0;23
18538;Lokiukas;"2 B klasė";14234831040;Taip;2;3;0;5
18539;Lokiukas;"2 B klasė";57505829630;Taip;0;3;0;3
18540;Lokiukas;"2 B klasė";7334971595;Taip;6;3;0;9
18541;Lokiukas;"2 B klasė";51059574159;Taip;4;3;0;7
18542;Lokiukas;"2 B klasė";4662981914;Taip;5;3;0;8
18543;Lokiukas;"2 B klasė";2959877846;Taip;23;0;0;23
18544;Lokiukas;"2 B klasė";6414861823;Taip;23;0;0;23
18545;Lokiukas;"2 B klasė";7130407913;Taip;23;0;0;23
18546;Lokiukas;"2 B klasė";98045145204;Taip;1;3;0;4
18547;Lokiukas;"2 B klasė";68390568000;Taip;23;0;0;23
18548;Lokiukas;"2 B klasė";8980902068;Taip;1;3;0;4
18549;Lokiukas;"2 B klasė";4164426360;Taip;4;3;0;7
18550;Lokiukas;"2 B klasė";14937983736;Taip;1;3;0;4
18551;Lokiukas;"2 B klasė";8996622650;Taip;0;3;0;3
18552;Lokiukas;"2 B klasė";61807094999;Taip;0;3;0;3
18553;Lokiukas;"2 B klasė";2078673522;Taip;0;3;0;3
18554;Lokiukas;"2 B klasė";40006848965;Taip;2;3;0;5
18555;Lokiukas;"2 B klasė";32714964224;Taip;0;3;0;3
18556;Lokiukas;"2 B klasė";8920359311;Taip;0;3;0;3
18557;Lokiukas;"2 B klasė";38001876942;Taip;0;3;0;3
18558;Lokiukas;"3 A klasė";25170045140;Taip;23;0;0;23
18559;Lokiukas;"3 A klasė";15406362908;Taip;3;3;0;6
18560;Lokiukas;"3 A klasė";45122233067;Taip;0;3;0;3
18561;Lokiukas;"3 A klasė";15685936471;Taip;1;3;0;4
18562;Lokiukas;"3 A klasė";10948160841;Taip;23;0;0;23
18563;Lokiukas;"3 A klasė";21802863853;Taip;0;3;0;3
18564;Lokiukas;"3 A klasė";29577495646;Taip;1;3;0;4
18565;Lokiukas;"3 A klasė";22979689191;Taip;5;3;0;8
18566;Lokiukas;"3 A klasė";80754592972;Taip;3;3;0;6
18567;Lokiukas;"3 A klasė";14903100496;Taip;0;3;0;3
18568;Lokiukas;"3 A klasė";97609897018;Taip;1;3;0;4
18569;Lokiukas;"3 A klasė";4608275224;Taip;8;3;0;11
18570;Lokiukas;"3 A klasė";99706061553;Taip;11;3;0;14
18571;Lokiukas;"3 A klasė";7785940412;Taip;1;3;0;4
18572;Lokiukas;"3 A klasė";24099693663;Taip;6;3;0;9
18573;Lokiukas;"3 A klasė";72092394330;Taip;0;3;0;3
18574;Lokiukas;"3 A klasė";35769782473;Taip;0;3;0;3
18575;Lokiukas;"3 A klasė";23688235312;Taip;0;3;0;3
18576;Lokiukas;"3 A klasė";43070670534;Taip;0;3;0;3
18577;Lokiukas;"3 A klasė";38531751377;Taip;4;3;0;7
18578;Lokiukas;"3 A klasė";15574258138;Taip;1;3;0;4
18579;Lokiukas;"3 A klasė";59840033826;Taip;1;3;0;4
18580;Lokiukas;"3 A klasė";24523198513;Taip;23;0;0;23
18581;Lokiukas;"3 A klasė";84273668685;Taip;1;3;0;4
18582;Lokiukas;"3 A klasė";9077016953;Taip;10;3;0;13
18583;Lokiukas;"3 A klasė";9747265775;Taip;23;0;0;23
18584;Lokiukas;"3 A klasė";5198408183;Taip;2;3;0;5
18585;Lokiukas;"3 A klasė";80793623068;Ne;3;3;0;6
18586;Lokiukas;"3 A klasė";93374754851;Taip;5;3;0;8
18587;Lokiukas;"3 B klasė";5311341721;Taip;0;23;0;23
18588;Lokiukas;"3 B klasė";61890775725;Taip;8;3;0;11
18589;Lokiukas;"3 B klasė";32506466236;Taip;0;3;0;3
18590;Lokiukas;"3 B klasė";24221829774;Taip;4;3;0;7
18591;Lokiukas;"3 B klasė";96046361641;Taip;0;3;0;3
18592;Lokiukas;"3 B klasė";7324496782;Taip;1;3;0;4
18593;Lokiukas;"3 B klasė";95910336503;Taip;0;3;0;3
18594;Lokiukas;"3 B klasė";58513885211;Taip;1;3;0;4
18595;Lokiukas;"3 B klasė";57958699478;Taip;0;3;0;3
18596;Lokiukas;"3 B klasė";10811780420;Taip;10;3;0;13
18597;Lokiukas;"3 B klasė";18646642032;Taip;2;3;0;5
18598;Lokiukas;"3 B klasė";79109699217;Taip;1;3;0;4
18599;Lokiukas;"3 B klasė";50713289266;Taip;18;0;0;18
18600;Lokiukas;"3 B klasė";20231469825;Taip;4;3;0;7
18601;Lokiukas;"3 B klasė";18336619115;Ne;0;3;0;3
18602;Lokiukas;"3 B klasė";2105377652;Taip;2;3;0;5
18603;Lokiukas;"3 B klasė";39867459515;Taip;1;3;0;4
18604;Lokiukas;"3 B klasė";1146878499;Taip;1;3;0;4
18605;Lokiukas;"3 B klasė";46587243900;Taip;1;3;0;4
18606;Lokiukas;"3 B klasė";62268017779;Taip;1;3;0;4
18607;Lokiukas;"3 B klasė";28796727185;Taip;14;0;0;14
18608;Lokiukas;"3 B klasė";88415635113;Taip;12;0;0;12
18609;Lokiukas;"3 B klasė";9141446821;Taip;6;0;0;6
18610;Lokiukas;"3 B klasė";7497324442;Taip;23;0;0;23
18611;Lokiukas;"3 B klasė";7903535850;Taip;7;0;0;7
18612;Lokiukas;"3 B klasė";75507005694;Taip;4;3;0;7
18613;Lokiukas;"3 B klasė";73426072972;Taip;4;3;0;7
18614;Lokiukas;"3 B klasė";59913848400;Taip;4;3;0;7
18615;Lokiukas;"4 A klasė";67818191566;Taip;2;3;0;5
18616;Lokiukas;"4 A klasė";45280536946;Taip;20;3;0;23
18617;Lokiukas;"4 A klasė";53087036306;Taip;0;3;0;3
18618;Lokiukas;"4 A klasė";79223457439;Taip;4;3;0;7
18619;Lokiukas;"4 A klasė";75613665040;Taip;0;3;0;3
18620;Lokiukas;"4 A klasė";10240586503;Taip;2;3;0;5
18621;Lokiukas;"4 A klasė";86623153797;Taip;1;3;0;4
18622;Lokiukas;"4 A klasė";27050402360;Taip;0;3;0;3
18623;Lokiukas;"4 A klasė";43389930516;Taip;1;3;0;4
18624;Lokiukas;"4 A klasė";23222644824;Taip;2;3;0;5
18625;Lokiukas;"4 A klasė";52296454506;Taip;1;3;0;4
18626;Lokiukas;"4 A klasė";66999644935;Taip;23;0;0;23
18627;Lokiukas;"4 A klasė";72167964645;Taip;4;0;0;4
18628;Lokiukas;"4 A klasė";2143040924;Taip;23;0;0;23
18629;Lokiukas;"4 A klasė";3206276637;Ne;13;0;0;13
18630;Lokiukas;"4 A klasė";5775631777;Taip;11;0;0;11
18631;Lokiukas;"4 A klasė";3703002168;Taip;2;3;0;5
18632;Lokiukas;"4 A klasė";38636200254;Taip;0;3;0;3
18633;Lokiukas;"4 A klasė";47410036889;Taip;0;3;0;3
18634;Lokiukas;"4 A klasė";53544600623;Taip;2;3;0;5
18635;Lokiukas;"4 A klasė";6702448475;Taip;1;3;0;4
18636;Lokiukas;"4 A klasė";82966541165;Taip;0;3;0;3
18637;Lokiukas;"4 A klasė";42292408557;Taip;23;0;0;23
18638;Lokiukas;"4 B klasė";35018370441;Taip;0;3;0;3
18639;Lokiukas;"4 B klasė";60370754283;Taip;4;3;0;7
18640;Lokiukas;"4 B klasė";98289469398;Taip;1;3;0;4
18641;Lokiukas;"4 B klasė";15445053855;Taip;1;3;0;4
18642;Lokiukas;"4 B klasė";3262579895;Taip;0;3;0;3
18643;Lokiukas;"4 B klasė";51554951703;Taip;20;3;0;23
18644;Lokiukas;"4 B klasė";88947878548;Taip;0;3;0;3
18645;Lokiukas;"4 B klasė";29198900240;Taip;0;3;0;3
18646;Lokiukas;"4 B klasė";77441549037;Taip;0;3;0;3
18647;Lokiukas;"4 B klasė";79301547085;Taip;0;3;0;3
18648;Lokiukas;"4 B klasė";10897713744;Taip;0;3;0;3
18649;Lokiukas;"4 B klasė";16889795010;Taip;23;0;0;23
18650;Lokiukas;"4 B klasė";5067673212;Taip;11;3;0;14
18651;Lokiukas;"4 B klasė";1424195731;Taip;20;3;0;23
18652;Lokiukas;"4 B klasė";1104333637;Taip;1;3;0;4
18653;Lokiukas;"4 B klasė";69089214980;Taip;23;0;0;23
18654;Lokiukas;"4 B klasė";45735190114;Taip;20;3;0;23
18655;Lokiukas;"4 B klasė";2353550739;Taip;0;3;0;3
18656;Lokiukas;"4 B klasė";15004419516;Taip;4;3;0;7
18657;Lokiukas;"4 B klasė";1245850082;Taip;20;3;0;23
18658;Lokiukas;"4 B klasė";1661940145;Taip;20;3;0;23
18659;Lokiukas;"4 B klasė";2375879565;Taip;23;0;0;23
18660;Šaltinėlis;Ančiukų;3901200729;Taip;14;0;0;14
18661;Šaltinėlis;Ančiukų;1312785137;Taip;5;5;0;10
18662;Šaltinėlis;Ančiukų;9209105445;Taip;0;13;0;13
18663;Šaltinėlis;Ančiukų;9112527921;Taip;0;4;0;4
18664;Šaltinėlis;Ančiukų;9398488555;Taip;9;5;0;14
18665;Šaltinėlis;Ančiukų;2027779524;Taip;2;3;0;5
18666;Šaltinėlis;Ančiukų;5498764523;Taip;8;0;0;8
18667;Šaltinėlis;Ančiukų;4226929875;Taip;15;0;0;15
18668;Šaltinėlis;Ančiukų;1489377928;Taip;5;9;0;14
18669;Šaltinėlis;Ančiukų;7325258256;Ne;23;0;0;23
18670;Šaltinėlis;Ančiukų;5005394548;Taip;13;0;0;13
18671;Šaltinėlis;Ančiukų;1102861619;Taip;4;6;0;10
18672;Šaltinėlis;Ančiukų;1928794692;Taip;7;0;2;9
18673;Šaltinėlis;Ančiukų;1742421427;Taip;4;1;2;7
18674;Šaltinėlis;Ančiukų;9581384663;Taip;12;0;0;12
18675;Šaltinėlis;Ančiukų;9465174636;Taip;10;8;0;18
18676;Šaltinėlis;Ančiukų;8034195267;Taip;8;3;0;11
18677;Šaltinėlis;Ančiukų;5455997139;Ne;2;2;0;4
18678;Šaltinėlis;Ančiukų;9588260206;Taip;15;0;2;17
18679;Šaltinėlis;Ančiukų;8116985061;Ne;15;0;0;15
18680;Šaltinėlis;Bitučių;9983153464;Taip;6;3;0;9
18681;Šaltinėlis;Bitučių;56396772538;Taip;0;3;0;3
18682;Šaltinėlis;Bitučių;5251390843;Ne;13;3;0;16
18683;Šaltinėlis;Bitučių;8500790262;Taip;0;4;0;4
18684;Šaltinėlis;Bitučių;4332884673;Taip;0;4;0;4
18685;Šaltinėlis;Bitučių;3493429067;Taip;12;3;0;15
18686;Šaltinėlis;Bitučių;9362495172;Taip;0;1;2;3
18687;Šaltinėlis;Bitučių;6462738640;Taip;0;4;0;4
18688;Šaltinėlis;Bitučių;77872075694;Taip;0;17;0;17
18689;Šaltinėlis;Bitučių;7133143923;Taip;0;9;0;9
18690;Šaltinėlis;Bitučių;6887838949;Taip;6;7;0;13
18691;Šaltinėlis;Bitučių;2630875135;Taip;0;3;0;3
18692;Šaltinėlis;Bitučių;9218883174;Taip;6;0;0;6
18693;Šaltinėlis;Bitučių;2973820849;Taip;8;3;0;11
18694;Šaltinėlis;Bitučių;9820788524;Taip;0;10;0;10
18695;Šaltinėlis;Bitučių;9769491789;Taip;3;3;0;6
18696;Šaltinėlis;Bitučių;9274165569;Taip;0;7;0;7
18697;Šaltinėlis;Bitučių;2084451705;Taip;10;3;0;13
18698;Šaltinėlis;Bitučių;8555517284;Taip;10;4;0;14
18699;Šaltinėlis;Bitučių;1543331408;Taip;0;3;0;3
18700;Šaltinėlis;Bitučių;7483928256;Taip;8;3;0;11
18701;Šaltinėlis;Bitučių;2646901307;Taip;12;1;0;13
18702;Šaltinėlis;Bitučių;7737797979;Taip;10;4;0;14
18703;Šaltinėlis;Saulutės;7311831014;Ne;8;3;0;11
18704;Šaltinėlis;Saulutės;5854723120;Taip;5;9;0;14
18705;Šaltinėlis;Saulutės;5833136956;Taip;0;1;0;1
18706;Šaltinėlis;Saulutės;3483756240;Taip;9;0;0;9
18707;Šaltinėlis;Saulutės;6380346298;Taip;0;17;0;17
18708;Šaltinėlis;Saulutės;5799032398;Taip;7;6;0;13
18709;Šaltinėlis;Saulutės;5525740049;Ne;5;8;0;13
18710;Šaltinėlis;Saulutės;5382567842;Taip;0;8;0;8
18711;Šaltinėlis;Saulutės;1978469605;Ne;10;0;0;10
18712;Šaltinėlis;Saulutės;4743907195;Taip;10;3;0;13
18713;Šaltinėlis;Saulutės;5343279219;Taip;0;7;0;7
18714;Šaltinėlis;Saulutės;7118672118;Ne;0;5;0;5
18715;Šaltinėlis;Saulutės;2465009553;Taip;0;6;0;6
18716;Šaltinėlis;Saulutės;5345738219;Taip;15;3;0;18
18717;Šaltinėlis;Saulutės;6721510313;Taip;5;3;0;8
18718;Šaltinėlis;Saulutės;7650840990;Taip;7;3;0;10
18719;Šaltinėlis;Saulutės;1678450741;Taip;0;6;0;6
18720;Šaltinėlis;Saulutės;5774391181;Ne;10;2;0;12
18721;Šaltinėlis;Saulutės;4681460322;Taip;6;7;0;13
18722;Šaltinėlis;Saulutės;3968514430;Taip;11;1;0;12
18723;Šaltinėlis;Saulutės;8950694484;Ne;2;2;0;4
18724;Šaltinėlis;Saulutės;2499890317;Taip;17;0;0;17
18725;Šaltinėlis;Saulutės;3579974049;Taip;0;11;0;11
18726;Šaltinėlis;Meškiukų;6915625306;Taip;7;1;0;8
18727;Šaltinėlis;Meškiukų;6645807642;Taip;5;5;2;12
18728;Šaltinėlis;Meškiukų;9759912102;Ne;0;2;0;2
18729;Šaltinėlis;Meškiukų;4664741207;Taip;13;1;1;15
18730;Šaltinėlis;Meškiukų;1400918201;Ne;13;1;0;14
18731;Šaltinėlis;Meškiukų;5420067622;Taip;0;6;0;6
18732;Šaltinėlis;Meškiukų;1656674673;Taip;3;2;0;5
18733;Šaltinėlis;Meškiukų;4248763165;Taip;0;5;0;5
18734;Šaltinėlis;Meškiukų;5982018366;Taip;5;6;0;11
18735;Šaltinėlis;Meškiukų;9922223978;Taip;17;3;0;20
18736;Šaltinėlis;Meškiukų;8995077908;Taip;17;5;0;22
18737;Šaltinėlis;Meškiukų;5982188743;Ne;0;3;0;3
18738;Šaltinėlis;Meškiukų;6586783795;Taip;10;4;1;15
18739;Šaltinėlis;Meškiukų;7468640592;Taip;0;5;0;5
18740;Šaltinėlis;Meškiukų;4064231806;Taip;11;3;0;14
18741;Šaltinėlis;Meškiukų;4159654434;Taip;10;0;1;11
18742;Šaltinėlis;Meškiukų;6688536661;Taip;4;0;0;4
18743;Šaltinėlis;Meškiukų;8880659539;Ne;12;1;0;13
18744;Šaltinėlis;Meškiukų;3228788999;Taip;0;1;0;1
18745;Šaltinėlis;Meškiukų;5905345563;Taip;9;1;0;10
18746;Šaltinėlis;Meškiukų;2332065937;Taip;4;0;0;4
18747;Šaltinėlis;Nykštukai;9766640995;Ne;12;3;0;15
18748;Šaltinėlis;Nykštukai;3356138058;Taip;8;3;1;12
18749;Šaltinėlis;Nykštukai;5434349511;Taip;23;0;0;23
18750;Šaltinėlis;Nykštukai;4226068669;Taip;4;2;0;6
18751;Šaltinėlis;Nykštukai;2976773344;Ne;12;3;0;15
18752;Šaltinėlis;Nykštukai;3687243030;Taip;0;11;0;11
18753;Šaltinėlis;Nykštukai;4364256563;Taip;16;2;0;18
18754;Šaltinėlis;Nykštukai;9333013048;Taip;9;0;2;11
18755;Šaltinėlis;Nykštukai;4029616063;Taip;7;0;3;10
18756;Šaltinėlis;Nykštukai;6530797082;Taip;11;0;0;11
18757;Šaltinėlis;Nykštukai;7534585887;Taip;23;0;0;23
18758;Šaltinėlis;Nykštukai;8977029692;Taip;0;4;0;4
18759;Šaltinėlis;Nykštukai;7120592596;Taip;0;0;2;2
18760;Šaltinėlis;Nykštukai;6244924079;Taip;19;0;0;19
18761;Šaltinėlis;Nykštukai;3806267811;Taip;8;0;2;10
18762;Šaltinėlis;Nykštukai;3497881408;Ne;0;6;0;6
18763;Šaltinėlis;Nykštukai;6383844995;Taip;13;0;0;13
18764;Šaltinėlis;Perliukų;2825412170;Taip;0;6;0;6
18765;Šaltinėlis;Perliukų;1686009371;Taip;0;2;1;3
18766;Šaltinėlis;Perliukų;9522524163;Taip;16;3;0;19
18767;Šaltinėlis;Perliukų;9075507649;Taip;9;0;0;9
18768;Šaltinėlis;Perliukų;7068058767;Taip;0;5;0;5
18769;Šaltinėlis;Perliukų;2189112609;Taip;0;2;3;5
18770;Šaltinėlis;Perliukų;8914777163;Taip;10;5;0;15
18771;Šaltinėlis;Perliukų;7387221265;Taip;1;3;0;4
18772;Šaltinėlis;Perliukų;9674923143;Taip;20;0;0;20
18773;Šaltinėlis;Perliukų;1823048790;Taip;1;0;0;1
18774;Šaltinėlis;Perliukų;3073692882;Taip;7;6;0;13
18775;Šaltinėlis;Perliukų;5325974488;Taip;3;4;0;7
18776;Šaltinėlis;Perliukų;2022956307;Taip;4;6;0;10
18777;Šaltinėlis;Perliukų;2126751248;Taip;0;3;0;3
18778;Šaltinėlis;Perliukų;3271931810;Taip;8;0;9;17
18779;Šaltinėlis;Perliukų;7955094634;Taip;0;0;1;1
18780;Šaltinėlis;Perliukų;1445108285;Taip;0;2;0;2
18781;Šaltinėlis;Perliukų;7133044918;Taip;1;0;0;1
18782;Šaltinėlis;Perliukų;8695191968;Taip;0;4;0;4
18783;Šaltinėlis;Perliukų;4430546695;Taip;11;3;0;14
18784;Šaltinėlis;Perliukų;8506287076;Taip;4;0;1;5
18785;Šaltinėlis;BORUŽĖLĖS;3505001330;Taip;10;2;0;12
18786;Šaltinėlis;BORUŽĖLĖS;8973369897;Taip;6;4;0;10
18787;Šaltinėlis;BORUŽĖLĖS;3780870805;Taip;5;0;0;5
18788;Šaltinėlis;BORUŽĖLĖS;2157520281;Taip;14;1;0;15
18789;Šaltinėlis;BORUŽĖLĖS;1441937630;Taip;0;0;2;2
18790;Šaltinėlis;BORUŽĖLĖS;8995954572;Taip;10;0;2;12
18791;Šaltinėlis;BORUŽĖLĖS;4742849747;Taip;4;4;0;8
18792;Šaltinėlis;BORUŽĖLĖS;5996579651;Taip;0;3;0;3
18793;Šaltinėlis;BORUŽĖLĖS;5331397179;Ne;10;0;1;11
18794;Šaltinėlis;BORUŽĖLĖS;1238867065;Taip;9;0;2;11
18795;Šaltinėlis;BORUŽĖLĖS;8258039377;Taip;0;4;0;4
18796;Šaltinėlis;BORUŽĖLĖS;9218436977;Taip;18;0;0;18
18797;Šaltinėlis;BORUŽĖLĖS;2353630084;Taip;2;1;0;3
18798;Šaltinėlis;BORUŽĖLĖS;5593692486;Taip;8;0;0;8
18799;Šaltinėlis;BORUŽĖLĖS;1496105338;Taip;0;0;8;8
18800;Šaltinėlis;1A;9188065549;Ne;0;3;0;3
18801;Šaltinėlis;1A;9305706589;Ne;0;3;0;3
18802;Šaltinėlis;1A;1580090516;Taip;0;3;0;3
18803;Šaltinėlis;1A;2034838765;Taip;0;4;0;4
18804;Šaltinėlis;1A;2105963102;Taip;0;3;0;3
18805;Šaltinėlis;1A;3582666579;Taip;0;3;0;3
18806;Šaltinėlis;1A;46569341613;Taip;0;3;0;3
18807;Šaltinėlis;1A;2801321116;Taip;0;5;0;5
18808;Šaltinėlis;1A;1091056386;Taip;0;3;0;3
18809;Šaltinėlis;1A;52142182972;Taip;0;3;0;3
18810;Šaltinėlis;1A;6880337593;Ne;0;3;0;3
18811;Šaltinėlis;1A;3516760367;Taip;0;8;0;8
18812;Šaltinėlis;1A;56542341895;Ne;0;3;0;3
18813;Šaltinėlis;1A;1910670134;Taip;0;4;0;4
18814;Šaltinėlis;1A;9595350871;Taip;0;3;0;3
18815;Šaltinėlis;1A;15925823621;Taip;0;3;0;3
18816;Šaltinėlis;1A;8902634958;Taip;0;16;0;16
18817;Šaltinėlis;1A;9757246434;Taip;0;6;0;6
18818;Šaltinėlis;1A;7262120071;Ne;0;5;0;5
18819;Šaltinėlis;1A;1004445904;Taip;0;3;0;3
18820;Šaltinėlis;"2A klasė";32264290873;Taip;0;4;0;4
18821;Šaltinėlis;"2A klasė";1767635282;Taip;0;3;0;3
18822;Šaltinėlis;"2A klasė";1390316465;Taip;0;3;0;3
18823;Šaltinėlis;"2A klasė";5442943843;Taip;0;3;0;3
18824;Šaltinėlis;"2A klasė";6764006747;Taip;0;9;0;9
18825;Šaltinėlis;"2A klasė";1658370782;Taip;0;3;0;3
18826;Šaltinėlis;"2A klasė";10918276041;Taip;0;3;0;3
18827;Šaltinėlis;"2A klasė";3455754351;Taip;0;23;0;23
18828;Šaltinėlis;"2A klasė";66575684640;Taip;0;3;0;3
18829;Šaltinėlis;"2A klasė";86592374576;Taip;0;22;0;22
18830;Šaltinėlis;"2A klasė";13808708760;Taip;0;4;0;4
18831;Šaltinėlis;"2A klasė";1614411921;Ne;0;4;0;4
18832;Šaltinėlis;"2A klasė";79406746980;Taip;0;3;0;3
18833;Šaltinėlis;"2A klasė";3577137327;Taip;0;4;0;4
18834;Šaltinėlis;"2A klasė";1224027643;Taip;0;4;0;4
18835;Šaltinėlis;"2A klasė";48525545812;Taip;0;3;0;3
18836;Šaltinėlis;"2A klasė";7073644279;Taip;0;6;0;6
18837;Šaltinėlis;"2A klasė";3022926855;Taip;0;8;0;8
18838;Šaltinėlis;"2A klasė";1190394855;Taip;0;3;0;3
18839;Šaltinėlis;"2A klasė";40186714037;Taip;0;3;0;3
18840;Šaltinėlis;"2A klasė";1456486363;Taip;0;8;0;8
18841;Šaltinėlis;"2A klasė";32949623652;Taip;0;7;0;7
18842;Šaltinėlis;"3A klasė";14213856824;Taip;0;6;0;6
18843;Šaltinėlis;"3A klasė";80649337160;Taip;0;5;0;5
18844;Šaltinėlis;"3A klasė";92958012146;Taip;0;3;0;3
18845;Šaltinėlis;"3A klasė";84656960510;Taip;0;3;0;3
18846;Šaltinėlis;"3A klasė";83621946293;Taip;0;23;0;23
18847;Šaltinėlis;"3A klasė";67808618878;Ne;0;23;0;23
18848;Šaltinėlis;"3A klasė";1278910777;Taip;0;3;0;3
18849;Šaltinėlis;"3A klasė";9647785988;Taip;0;23;0;23
18850;Šaltinėlis;"3A klasė";82671662416;Taip;0;3;0;3
18851;Šaltinėlis;"3A klasė";54025577281;Taip;0;4;0;4
18852;Šaltinėlis;"3A klasė";488285764;Taip;0;3;0;3
18853;Šaltinėlis;"3A klasė";29482180151;Taip;0;3;0;3
18854;Šaltinėlis;"3A klasė";54753218491;Taip;0;23;0;23
18855;Šaltinėlis;"3A klasė";86029472773;Taip;0;23;0;23
18856;Šaltinėlis;"3A klasė";64821172553;Taip;0;4;0;4
18857;Šaltinėlis;"3A klasė";5744976843;Taip;0;4;0;4
18858;Šaltinėlis;"3A klasė";25459069972;Ne;0;4;0;4
18859;Šaltinėlis;"3A klasė";6669392157;Taip;0;5;0;5
18860;Šaltinėlis;"3A klasė";89358384113;Taip;0;7;0;7
18861;Šaltinėlis;"3A klasė";28956971978;Taip;0;8;0;8
18862;Šaltinėlis;"3A klasė";4050444191;Taip;0;5;0;5
18863;Šaltinėlis;"3A klasė";89093437170;Taip;0;3;0;3
18864;Šaltinėlis;"3A klasė";51872331010;Taip;0;3;0;3
18865;Šaltinėlis;"4A klasė";83657465071;Taip;0;3;0;3
18866;Šaltinėlis;"4A klasė";86309198604;Taip;0;5;0;5
18867;Šaltinėlis;"4A klasė";9705941341;Taip;0;10;0;10
18868;Šaltinėlis;"4A klasė";38496350161;Taip;0;23;0;23
18869;Šaltinėlis;"4A klasė";62612067151;Taip;0;3;0;3
18870;Šaltinėlis;"4A klasė";96133834896;Taip;0;23;0;23
18871;Šaltinėlis;"4A klasė";73466313766;Taip;0;3;0;3
18872;Šaltinėlis;"4A klasė";2323456393;Taip;0;23;0;23
18873;Šaltinėlis;"4A klasė";56279691365;Taip;0;3;0;3
18874;Šaltinėlis;"4A klasė";4587186145;Taip;0;3;0;3
18875;Šaltinėlis;"4A klasė";70948186548;Taip;0;3;0;3
18876;Šaltinėlis;"4A klasė";47045578599;Ne;0;3;0;3
18877;Šaltinėlis;"4A klasė";36718328105;Taip;0;3;0;3
18878;Šaltinėlis;"4A klasė";86995081866;Taip;0;8;0;8
18879;Šaltinėlis;"4A klasė";7929809205;Ne;0;3;0;3
18880;Šaltinėlis;"4A klasė";29683761586;Ne;0;3;0;3
18881;Šaltinėlis;"4A klasė";9842958341;Ne;0;3;0;3
18882;Šaltinėlis;"4A klasė";40769315138;Taip;0;5;0;5
18883;Šaltinėlis;"4A klasė";7563879445;Taip;0;3;0;3
18884;Šaltinėlis;"4A klasė";66754907606;Ne;0;23;0;23
18885;Šaltinėlis;"4A klasė";35387543586;Taip;0;5;0;5
18886;Šaltinėlis;"4A klasė";6056572441;Ne;0;3;0;3
18887;Šaltinėlis;"4A klasė";9927833966;Ne;0;5;0;5
18888;Šaltinėlis;3B;93256161233;Taip;0;3;0;3
18889;Šaltinėlis;3B;83173349544;Taip;0;3;0;3
18890;Šaltinėlis;3B;39088869084;Taip;0;5;0;5
18891;Šaltinėlis;3B;1422035829;Taip;0;3;0;3
18892;Šaltinėlis;3B;7711903999;Ne;0;3;0;3
18893;Šaltinėlis;3B;95542489944;Ne;0;8;0;8
18894;Šaltinėlis;3B;3072314714;Taip;0;3;0;3
18895;Šaltinėlis;3B;1220687492;Taip;0;3;0;3
18896;Šaltinėlis;3B;74337710550;Taip;0;3;0;3
18897;Šaltinėlis;3B;35401075864;Taip;0;3;0;3
18898;Šaltinėlis;3B;19630605543;Taip;0;4;0;4
18899;Šaltinėlis;3B;84522552145;Taip;0;3;0;3
18900;Šaltinėlis;3B;3626545396;Ne;0;10;0;10
18901;Šaltinėlis;3B;6317111400;Taip;0;7;0;7
18902;Šaltinėlis;3B;4762756751;Ne;0;3;0;3
18903;Šaltinėlis;3B;72372808270;Taip;0;3;0;3
18904;Šaltinėlis;3B;1924418657;Taip;0;5;0;5
18905;Šaltinėlis;3B;77194317310;Taip;0;8;0;8
18906;Šaltinėlis;3B;57847832778;Taip;0;3;0;3
18907;Šaltinėlis;3B;2099800744;Taip;0;3;0;3
18908;Šaltinėlis;3B;70315400705;Taip;0;3;0;3
18909;Šaltinėlis;3B;81082410620;Taip;0;4;0;4
18910;Šaltinėlis;1B;84494627465;Taip;0;3;0;3
18911;Šaltinėlis;1B;2146141461;Taip;0;3;0;3
18912;Šaltinėlis;1B;6068980312;Taip;0;4;0;4
18913;Šaltinėlis;1B;9425353041;Taip;0;3;0;3
18914;Šaltinėlis;1B;17147527171;Taip;0;23;0;23
18915;Šaltinėlis;1B;1935762293;Taip;0;13;0;13
18916;Šaltinėlis;1B;1716801722;Taip;0;9;0;9
18917;Šaltinėlis;1B;2333071711;Taip;0;4;0;4
18918;Šaltinėlis;1B;23301579810;Taip;0;7;0;7
18919;Šaltinėlis;1B;52507085619;Taip;0;4;0;4
18920;Šaltinėlis;1B;1023238509;Taip;0;5;0;5
18921;Šaltinėlis;1B;526307704;Taip;0;5;0;5
18922;Šaltinėlis;1B;1958647188;Taip;0;4;0;4
18923;Šaltinėlis;1B;1583520894;Taip;0;23;0;23
18924;Šaltinėlis;1B;11083638216;Taip;0;7;0;7
18925;Šaltinėlis;PELĖDŽIUKAI;8973208195;Taip;0;3;0;3
18926;Šaltinėlis;PELĖDŽIUKAI;1367082230;Taip;11;0;3;14
18927;Šaltinėlis;PELĖDŽIUKAI;4387568448;Taip;0;3;1;4
18928;Šaltinėlis;PELĖDŽIUKAI;7723290276;Taip;3;3;0;6
18929;Šaltinėlis;PELĖDŽIUKAI;1348724947;Taip;17;3;0;20
18930;Šaltinėlis;PELĖDŽIUKAI;2658414287;Taip;4;3;0;7
18931;Šaltinėlis;PELĖDŽIUKAI;3638565578;Taip;0;1;0;1
18932;Šaltinėlis;PELĖDŽIUKAI;8721116918;Taip;0;1;0;1
18933;Šaltinėlis;PELĖDŽIUKAI;7211267255;Taip;4;3;2;9
18934;Šaltinėlis;PELĖDŽIUKAI;1040333590;Taip;0;2;5;7
18935;Šaltinėlis;PELĖDŽIUKAI;3660687688;Taip;0;9;0;9
18936;Šaltinėlis;PELĖDŽIUKAI;5869977541;Ne;0;3;10;13
18937;Šaltinėlis;PELĖDŽIUKAI;3609939325;Ne;2;0;0;2
18938;Šaltinėlis;PELĖDŽIUKAI;9108653045;Taip;0;2;0;2
18939;Šaltinėlis;PELĖDŽIUKAI;9762392403;Taip;0;6;0;6
18940;Šaltinėlis;PELĖDŽIUKAI;2230403251;Ne;0;3;2;5
18941;Šaltinėlis;PELĖDŽIUKAI;7918995181;Taip;10;3;1;14
18942;Šaltinėlis;PELĖDŽIUKAI;9673105905;Ne;7;3;3;13
18943;Šaltinėlis;PELĖDŽIUKAI;5099997904;Taip;0;3;3;6
18944;Gabijėlė;GANDRIUKŲ;4498088417;Taip;0;3;1;4
18945;Gabijėlė;GANDRIUKŲ;2277489032;Taip;0;0;1;1
18946;Gabijėlė;GANDRIUKŲ;8994076883;Taip;1;0;0;1
18947;Gabijėlė;GANDRIUKŲ;7087892822;Taip;5;5;2;12
18948;Gabijėlė;GANDRIUKŲ;5057272847;Taip;0;4;12;16
18949;Gabijėlė;GANDRIUKŲ;3548399391;Taip;0;3;5;8
18950;Gabijėlė;GANDRIUKŲ;3532989398;Taip;5;3;0;8
18951;Gabijėlė;GANDRIUKŲ;2215880644;Taip;5;3;1;9
18952;Gabijėlė;GANDRIUKŲ;3799003783;Taip;0;4;0;4
18953;Gabijėlė;GANDRIUKŲ;5513530983;Ne;0;2;0;2
18954;Gabijėlė;GANDRIUKŲ;9581539166;Taip;3;3;2;8
18955;Gabijėlė;GANDRIUKŲ;6004026516;Taip;0;5;0;5
18956;Gabijėlė;GANDRIUKŲ;4634029418;Taip;5;5;0;10
18957;Gabijėlė;GANDRIUKŲ;4328252445;Taip;0;7;0;7
18958;Gabijėlė;GANDRIUKŲ;9706026832;Taip;7;0;0;7
18959;Gabijėlė;GANDRIUKŲ;2491503656;Taip;0;6;0;6
18960;Gabijėlė;GANDRIUKŲ;8904768332;Taip;0;0;4;4
18961;Gabijėlė;GANDRIUKŲ;5715645968;Taip;2;0;0;2
18962;Gabijėlė;GANDRIUKŲ;8572833698;Taip;3;0;1;4
18963;Gabijėlė;GANDRIUKŲ;8646572151;Taip;0;0;2;2
18964;Gabijėlė;GANDRIUKŲ;5054419205;Ne;11;5;0;16
18965;Gabijėlė;GANDRIUKŲ;7530976246;Taip;5;0;0;5
18966;Gabijėlė;GANDRIUKŲ;3920525584;Taip;0;10;0;10
18967;Gabijėlė;GANDRIUKŲ;2682112101;Taip;0;4;0;4
18968;Gabijėlė;LAKŠTINGALIUKŲ;7019425859;Taip;3;0;0;3
18969;Gabijėlė;LAKŠTINGALIUKŲ;1611004144;Taip;10;3;0;13
18970;Gabijėlė;LAKŠTINGALIUKŲ;5862882027;Taip;6;1;1;8
18971;Gabijėlė;LAKŠTINGALIUKŲ;8798786098;Taip;4;2;0;6
18972;Gabijėlė;LAKŠTINGALIUKŲ;8035360208;Taip;0;4;0;4
18973;Gabijėlė;LAKŠTINGALIUKŲ;2384469423;Taip;11;0;3;14
18974;Gabijėlė;LAKŠTINGALIUKŲ;8167646385;Taip;0;5;3;8
18975;Gabijėlė;LAKŠTINGALIUKŲ;8926268619;Taip;15;0;0;15
18976;Gabijėlė;LAKŠTINGALIUKŲ;9480021589;Taip;5;0;0;5
18977;Gabijėlė;LAKŠTINGALIUKŲ;3215569531;Ne;3;0;0;3
18978;Gabijėlė;LAKŠTINGALIUKŲ;5992403900;Taip;0;0;12;12
18979;Gabijėlė;LAKŠTINGALIUKŲ;9116943443;Taip;0;1;3;4
18980;Gabijėlė;LAKŠTINGALIUKŲ;8383489040;Taip;5;5;0;10
18981;Gabijėlė;LAKŠTINGALIUKŲ;6927730664;Taip;5;8;0;13
18982;Gabijėlė;LAKŠTINGALIUKŲ;7444385669;Taip;7;0;0;7
18983;Gabijėlė;LAKŠTINGALIUKŲ;9398722388;Taip;0;4;0;4
18984;Gabijėlė;LAKŠTINGALIUKŲ;9491327802;Ne;8;0;0;8
18985;Gabijėlė;LAKŠTINGALIUKŲ;6730947751;Taip;5;0;0;5
18986;Gabijėlė;LAKŠTINGALIUKŲ;2550300871;Taip;0;1;0;1
18987;Gabijėlė;LAKŠTINGALIUKŲ;9324498850;Taip;0;5;2;7
18988;Gabijėlė;LAKŠTINGALIUKŲ;8314088016;Taip;6;2;0;8
18989;Gabijėlė;LAKŠTINGALIUKŲ;6295299651;Taip;6;2;0;8
18990;Gabijėlė;LAKŠTINGALIUKŲ;9694544564;Taip;0;0;5;5
18991;Gabijėlė;LAKŠTINGALIUKŲ;4827797140;Taip;0;6;0;6
18992;Gabijėlė;LAKŠTINGALIUKŲ;6931780900;Taip;7;0;2;9
18993;Gabijėlė;LAKŠTINGALIUKŲ;2030555139;Ne;9;3;1;13
18994;Gabijėlė;ŽVIRBLIUKŲ;4475530177;Taip;4;3;1;8
18995;Gabijėlė;ŽVIRBLIUKŲ;5743861607;Taip;0;3;0;3
18996;Gabijėlė;ŽVIRBLIUKŲ;7410541320;Taip;0;12;0;12
18997;Gabijėlė;ŽVIRBLIUKŲ;4493192224;Ne;4;1;1;6
18998;Gabijėlė;ŽVIRBLIUKŲ;9259964641;Taip;0;6;0;6
18999;Gabijėlė;ŽVIRBLIUKŲ;3268231136;Taip;0;13;0;13
19000;Gabijėlė;ŽVIRBLIUKŲ;5332825339;Ne;0;3;2;5
19001;Gabijėlė;ŽVIRBLIUKŲ;2264669298;Taip;3;0;0;3
19002;Gabijėlė;ŽVIRBLIUKŲ;5942625633;Taip;1;0;3;4
19003;Gabijėlė;ŽVIRBLIUKŲ;3155403180;Taip;6;0;4;10
19004;Gabijėlė;ŽVIRBLIUKŲ;1158461185;Taip;6;0;1;7
19005;Gabijėlė;ŽVIRBLIUKŲ;3218415151;Taip;4;0;6;10
19006;Gabijėlė;ŽVIRBLIUKŲ;8823299212;Taip;0;3;0;3
19007;Gabijėlė;ŽVIRBLIUKŲ;8879972953;Taip;5;4;0;9
19008;Gabijėlė;ŽVIRBLIUKŲ;9627906252;Taip;0;12;3;15
19009;Gabijėlė;ŽVIRBLIUKŲ;1725665169;Taip;0;3;0;3
19010;Gabijėlė;ŽVIRBLIUKŲ;6674038058;Taip;4;2;1;7
19011;Gabijėlė;ŽVIRBLIUKŲ;4146051969;Taip;13;0;0;13
19012;Gabijėlė;ŽVIRBLIUKŲ;6604681536;Taip;9;1;0;10
19013;Gabijėlė;ŽVIRBLIUKŲ;1273722177;Ne;18;0;0;18
19014;Gabijėlė;ŽVIRBLIUKŲ;6310234092;Taip;10;3;1;14
19015;Gabijėlė;ŽVIRBLIUKŲ;8384795164;Taip;0;2;0;2
19016;Gabijėlė;ŽVIRBLIUKŲ;3209491491;Taip;7;0;2;9
19017;Gabijėlė;GENIUKŲ;3445433386;Taip;0;11;0;11
19018;Gabijėlė;GENIUKŲ;2980295345;Taip;6;2;0;8
19019;Gabijėlė;GENIUKŲ;1862655595;Taip;0;3;0;3
19020;Gabijėlė;GENIUKŲ;7312628876;Taip;0;4;0;4
19021;Gabijėlė;GENIUKŲ;1581688238;Taip;0;1;1;2
19022;Gabijėlė;GENIUKŲ;5301905117;Taip;0;9;0;9
19023;Gabijėlė;GENIUKŲ;3176075887;Taip;0;4;0;4
19024;Gabijėlė;GENIUKŲ;9972967198;Taip;5;0;0;5
19025;Gabijėlė;GENIUKŲ;1589534853;Taip;0;1;0;1
19026;Gabijėlė;GENIUKŲ;6482824000;Taip;11;0;1;12
19027;Gabijėlė;GENIUKŲ;5962852108;Taip;10;0;1;11
19028;Gabijėlė;GENIUKŲ;7178676049;Taip;4;3;0;7
19029;Gabijėlė;GENIUKŲ;1974388885;Ne;0;3;5;8
19030;Gabijėlė;GENIUKŲ;5418276275;Taip;8;0;0;8
19031;Gabijėlė;GENIUKŲ;2407507314;Taip;15;3;1;19
19032;Gabijėlė;GENIUKŲ;3827747057;Taip;0;5;0;5
19033;Gabijėlė;GENIUKŲ;8305098808;Taip;5;1;0;6
19034;Gabijėlė;GENIUKŲ;4234733280;Taip;0;5;0;5
19035;Gabijėlė;GENIUKŲ;6375754699;Ne;0;3;1;4
19036;Gabijėlė;GENIUKŲ;6869951613;Taip;0;4;0;4
19037;Gabijėlė;GENIUKŲ;7173852168;Ne;11;4;0;15
19038;Gabijėlė;GENIUKŲ;8036572198;Taip;0;14;0;14
19039;Gabijėlė;DAGILIUKŲ;9348393550;Taip;0;3;0;3
19040;Gabijėlė;DAGILIUKŲ;4264925447;Taip;0;3;0;3
19041;Gabijėlė;DAGILIUKŲ;9120107749;Taip;5;0;1;6
19042;Gabijėlė;DAGILIUKŲ;9494313873;Taip;0;1;0;1
19043;Gabijėlė;DAGILIUKŲ;9783343968;Taip;0;1;0;1
19044;Gabijėlė;DAGILIUKŲ;3017939983;Taip;0;4;0;4
19045;Gabijėlė;DAGILIUKŲ;4462129182;Taip;8;1;0;9
19046;Gabijėlė;DAGILIUKŲ;9503639471;Ne;0;0;1;1
19047;Gabijėlė;DAGILIUKŲ;1988597157;Taip;10;0;0;10
19048;Gabijėlė;DAGILIUKŲ;9895518740;Taip;13;0;1;14
19049;Gabijėlė;DAGILIUKŲ;9449023766;Taip;0;3;0;3
19050;Gabijėlė;DAGILIUKŲ;1286688629;Taip;17;2;0;19
19051;Gabijėlė;DAGILIUKŲ;1455856766;Ne;0;3;2;5
19052;Gabijėlė;DAGILIUKŲ;3700639354;Taip;0;1;0;1
19053;Gabijėlė;DAGILIUKŲ;6438144206;Taip;0;8;0;8
19054;Gabijėlė;DAGILIUKŲ;8662914262;Taip;0;13;0;13
19055;Gabijėlė;DAGILIUKŲ;9280283478;Taip;0;6;0;6
19056;Gabijėlė;DAGILIUKŲ;2254104149;Taip;11;3;0;14
19057;Gabijėlė;DAGILIUKŲ;4490619514;Taip;10;0;0;10
19058;Gabijėlė;DAGILIUKŲ;2386980295;Taip;0;0;7;7
19059;Gabijėlė;DAGILIUKŲ;4664011011;Taip;21;0;0;21
19060;Gabijėlė;PELEDŽIUKŲ;6794056622;Taip;4;0;2;6
19061;Gabijėlė;PELEDŽIUKŲ;4170105224;Taip;6;5;0;11
19062;Gabijėlė;PELEDŽIUKŲ;1356830225;Taip;0;0;1;1
19063;Gabijėlė;PELEDŽIUKŲ;9265103627;Taip;0;0;1;1
19064;Gabijėlė;PELEDŽIUKŲ;9451897367;Taip;6;0;0;6
19065;Gabijėlė;PELEDŽIUKŲ;1583034900;Taip;0;0;2;2
19066;Gabijėlė;PELEDŽIUKŲ;2128428173;Taip;0;0;1;1
19067;Gabijėlė;PELEDŽIUKŲ;7028670164;Taip;0;0;4;4
19068;Gabijėlė;PELEDŽIUKŲ;2885913045;Taip;9;1;0;10
19069;Gabijėlė;PELEDŽIUKŲ;7096789623;Taip;0;0;5;5
19070;Gabijėlė;PELEDŽIUKŲ;4724322463;Taip;0;0;2;2
19071;Gabijėlė;PELEDŽIUKŲ;1810898809;Taip;0;0;1;1
19072;Gabijėlė;PELEDŽIUKŲ;5801792404;Taip;13;0;1;14
19073;Gabijėlė;PELEDŽIUKŲ;8550877260;Taip;0;11;0;11
19074;Gabijėlė;PELEDŽIUKŲ;5579070948;Taip;0;0;2;2
19075;Gabijėlė;PELEDŽIUKŲ;8549800358;Taip;6;0;3;9
19076;Gabijėlė;PELEDŽIUKŲ;8133131896;Taip;4;0;1;5
19077;Gabijėlė;PELEDŽIUKŲ;2048046055;Taip;5;0;2;7
19078;Gabijėlė;KREGZDŽIUKŲ;1759118326;Taip;6;0;3;9
19079;Gabijėlė;KREGZDŽIUKŲ;9533325351;Taip;9;0;0;9
19080;Gabijėlė;KREGZDŽIUKŲ;5407565441;Taip;14;0;1;15
19081;Gabijėlė;KREGZDŽIUKŲ;6845038692;Taip;0;2;0;2
19082;Gabijėlė;KREGZDŽIUKŲ;9683202312;Ne;0;3;3;6
19083;Gabijėlė;KREGZDŽIUKŲ;2357515455;Taip;0;0;1;1
19084;Gabijėlė;KREGZDŽIUKŲ;1574272380;Taip;5;7;0;12
19085;Gabijėlė;KREGZDŽIUKŲ;9675186834;Ne;10;5;0;15
19086;Gabijėlė;KREGZDŽIUKŲ;2634722171;Taip;5;1;0;6
19087;Gabijėlė;KREGZDŽIUKŲ;4317708029;Taip;0;13;0;13
19088;Gabijėlė;KREGZDŽIUKŲ;8555272917;Taip;4;0;1;5
19089;Gabijėlė;KREGZDŽIUKŲ;1142939183;Taip;0;3;0;3
19090;Gabijėlė;KREGZDŽIUKŲ;9676186208;Taip;0;3;0;3
19091;Gabijėlė;KREGZDŽIUKŲ;3584692524;Taip;0;1;0;1
19092;Gabijėlė;KREGZDŽIUKŲ;8613821848;Taip;22;0;0;22
19093;Gabijėlė;KREGZDŽIUKŲ;7038167942;Taip;0;11;0;11
19094;Gabijėlė;KREGZDŽIUKŲ;6570702235;Taip;15;0;0;15
19095;Gabijėlė;KREGZDŽIUKŲ;9528783892;Taip;0;7;0;7
19096;Gabijėlė;KREGZDŽIUKŲ;9030890792;Taip;17;0;0;17
19097;Gabijėlė;KREGZDŽIUKŲ;3031333199;Taip;17;0;0;17
19098;Gabijėlė;KREGZDŽIUKŲ;9116153981;Taip;0;6;0;6
19099;Gabijėlė;KREGZDŽIUKŲ;7447079902;Taip;12;0;1;13
19100;Gabijėlė;KREGZDŽIUKŲ;2289016022;Taip;5;0;4;9
19101;Gabijėlė;KREGZDŽIUKŲ;4575230225;Taip;8;0;0;8
19102;Gabijėlė;ZYLIUKŲ;6154378055;Taip;23;0;0;23
19103;Gabijėlė;ZYLIUKŲ;7700700293;Taip;7;0;4;11
19104;Gabijėlė;ZYLIUKŲ;6759447513;Taip;0;0;3;3
19105;Gabijėlė;ZYLIUKŲ;1090635644;Taip;6;0;0;6
19106;Gabijėlė;ZYLIUKŲ;9893869150;Taip;1;0;1;2
19107;Gabijėlė;ZYLIUKŲ;6463161337;Taip;0;0;2;2
19108;Gabijėlė;ZYLIUKŲ;7921467223;Taip;0;0;3;3
19109;Gabijėlė;ZYLIUKŲ;4376486874;Taip;0;1;3;4
19110;Gabijėlė;ZYLIUKŲ;6983092888;Taip;0;0;4;4
19111;Gabijėlė;ZYLIUKŲ;4267803371;Taip;0;6;2;8
19112;Gabijėlė;ZYLIUKŲ;9259673720;Taip;0;0;5;5
19113;Gabijėlė;ZYLIUKŲ;8362509831;Taip;5;3;0;8
19114;Gabijėlė;ZYLIUKŲ;4907669556;Taip;0;0;11;11
19115;Gabijėlė;ZYLIUKŲ;1947898190;Taip;0;8;0;8
19116;Gabijėlė;ZYLIUKŲ;2384174631;Taip;0;0;3;3
19117;Gabijėlė;ZYLIUKŲ;5736012194;Taip;16;0;1;17
19118;Gabijėlė;ZYLIUKŲ;4712780337;Taip;0;7;1;8
19119;Gabijėlė;ZYLIUKŲ;1004297369;Taip;3;0;2;5
19120;Gabijėlė;ZYLIUKŲ;7180444215;Taip;0;0;9;9
19121;Gabijėlė;VOLUNGĖLIŲ;4000838897;Ne;3;4;1;8
19122;Gabijėlė;VOLUNGĖLIŲ;2099510027;Taip;9;1;0;10
19123;Gabijėlė;VOLUNGĖLIŲ;6842537434;Taip;0;4;0;4
19124;Gabijėlė;VOLUNGĖLIŲ;2227816651;Taip;8;3;0;11
19125;Gabijėlė;VOLUNGĖLIŲ;6956030813;Taip;11;2;0;13
19126;Gabijėlė;VOLUNGĖLIŲ;8733551230;Taip;8;1;2;11
19127;Gabijėlė;VOLUNGĖLIŲ;3763595874;Taip;18;0;0;18
19128;Gabijėlė;VOLUNGĖLIŲ;5360985745;Taip;8;0;0;8
19129;Gabijėlė;VOLUNGĖLIŲ;5737066080;Taip;5;4;0;9
19130;Gabijėlė;VOLUNGĖLIŲ;5972136800;Taip;0;2;0;2
19131;Gabijėlė;VOLUNGĖLIŲ;3972933727;Ne;2;2;0;4
19132;Gabijėlė;VOLUNGĖLIŲ;6643563560;Taip;5;6;0;11
19133;Gabijėlė;VOLUNGĖLIŲ;8312753333;Taip;0;3;0;3
19134;Gabijėlė;VOLUNGĖLIŲ;2523400466;Taip;0;5;1;6
19135;Gabijėlė;VOLUNGĖLIŲ;8569742033;Taip;5;3;1;9
19136;Gabijėlė;VOLUNGĖLIŲ;8327903800;Taip;13;1;0;14
19137;Gabijėlė;VOLUNGĖLIŲ;2251276876;Taip;0;4;0;4
19138;Gabijėlė;VOLUNGĖLIŲ;4160646449;Taip;0;2;0;2
19139;Gabijėlė;VOLUNGĖLIŲ;5290200767;Taip;18;0;0;18
19140;Gabijėlė;VOLUNGĖLIŲ;5060265729;Taip;0;8;0;8
19141;Gabijėlė;VOLUNGĖLIŲ;6960725029;Taip;20;0;0;20
19142;Gabijėlė;VOLUNGĖLIŲ;3098846537;Taip;5;1;0;6
19143;Gabijėlė;VOLUNGĖLIŲ;3995459990;Taip;10;3;0;13
19144;Gabijėlė;VOLUNGĖLIŲ;8320449381;Taip;10;9;0;19
19145;Gabijėlė;ANČIUKŲ;2036978425;Taip;0;3;0;3
19146;Gabijėlė;ANČIUKŲ;5219706067;Taip;0;7;0;7
19147;Gabijėlė;ANČIUKŲ;3454412432;Taip;2;5;0;7
19148;Gabijėlė;ANČIUKŲ;9822093084;Taip;5;4;0;9
19149;Gabijėlė;ANČIUKŲ;1415184607;Taip;5;3;0;8
19150;Gabijėlė;ANČIUKŲ;85836097485;Taip;0;2;0;2
19151;Gabijėlė;ANČIUKŲ;1917587420;Taip;0;9;0;9
19152;Gabijėlė;ANČIUKŲ;1465584524;Taip;10;3;0;13
19153;Gabijėlė;ANČIUKŲ;6198439092;Taip;0;11;0;11
19154;Gabijėlė;ANČIUKŲ;7948343328;Taip;0;3;0;3
19155;Gabijėlė;ANČIUKŲ;8111239476;Taip;10;3;0;13
19156;Gabijėlė;ANČIUKŲ;8778396292;Taip;0;1;2;3
19157;Gabijėlė;ANČIUKŲ;4085049535;Taip;10;4;0;14
19158;Gabijėlė;ANČIUKŲ;8893637755;Taip;0;8;0;8
19159;Gabijėlė;ANČIUKŲ;8874692591;Ne;0;0;7;7
19160;Gabijėlė;ANČIUKŲ;4752631976;Taip;2;0;0;2
19161;Gabijėlė;ANČIUKŲ;5783373671;Taip;0;3;0;3
19162;Gabijėlė;ANČIUKŲ;6766770793;Taip;0;9;0;9
19163;Gabijėlė;ANČIUKŲ;10796114623;Taip;0;11;0;11
19164;Gabijėlė;ANČIUKŲ;43123279348;Taip;0;1;0;1
19165;Gabijėlė;BALANDŽIUKŲ;6719097956;Taip;0;3;0;3
19166;Gabijėlė;BALANDŽIUKŲ;9157819780;Taip;0;7;0;7
19167;Gabijėlė;BALANDŽIUKŲ;1045338865;Taip;0;1;0;1
19168;Gabijėlė;BALANDŽIUKŲ;2097260657;Ne;5;4;0;9
19169;Gabijėlė;BALANDŽIUKŲ;8131229306;Taip;0;3;2;5
19170;Gabijėlė;BALANDŽIUKŲ;8525869648;Taip;0;6;0;6
19171;Gabijėlė;BALANDŽIUKŲ;2070050969;Taip;0;6;0;6
19172;Gabijėlė;BALANDŽIUKŲ;15049855022;Taip;2;2;0;4
19173;Gabijėlė;BALANDŽIUKŲ;2776579713;Ne;1;1;0;2
19174;Gabijėlė;BALANDŽIUKŲ;7977751362;Taip;10;0;0;10
19175;Gabijėlė;BALANDŽIUKŲ;5906952432;Taip;10;0;0;10
19176;Gabijėlė;BALANDŽIUKŲ;9197020006;Taip;6;3;0;9
19177;Gabijėlė;BALANDŽIUKŲ;1615940996;Taip;0;18;0;18
19178;Gabijėlė;BALANDŽIUKŲ;65735862964;Taip;0;1;0;1
19179;Gabijėlė;BALANDŽIUKŲ;6196322537;Taip;0;5;0;5
19180;Gabijėlė;BALANDŽIUKŲ;8746641978;Taip;3;0;0;3
19181;Gabijėlė;BALANDŽIUKŲ;56914218692;Taip;0;2;0;2
19182;Gabijėlė;BALANDŽIUKŲ;4330624300;Taip;3;1;0;4
19183;Gabijėlė;BALANDŽIUKŲ;2921208571;Taip;3;0;0;3
19184;Gabijėlė;BALANDŽIUKŲ;9501202207;Taip;3;4;0;7
19185;Gabijėlė;BALANDŽIUKŲ;6145720452;Ne;18;3;0;21
19186;Gabijėlė;BALANDŽIUKŲ;7563741123;Taip;0;13;0;13
19187;Gabijėlė;BALANDŽIUKŲ;3694447705;Taip;2;2;2;6
19188;Gabijėlė;VYTURIUKŲ;6131649116;Taip;0;0;3;3
19189;Gabijėlė;VYTURIUKŲ;7894667201;Taip;10;1;0;11
19190;Gabijėlė;VYTURIUKŲ;3960795412;Taip;4;0;0;4
19191;Gabijėlė;VYTURIUKŲ;5652244967;Taip;11;2;0;13
19192;Gabijėlė;VYTURIUKŲ;6013482554;Taip;0;4;0;4
19193;Gabijėlė;VYTURIUKŲ;3343196830;Taip;6;0;1;7
19194;Gabijėlė;VYTURIUKŲ;6728495961;Taip;14;0;0;14
19195;Gabijėlė;VYTURIUKŲ;1523190444;Taip;11;0;2;13
19196;Gabijėlė;VYTURIUKŲ;7295985579;Taip;5;0;7;12
19197;Gabijėlė;VYTURIUKŲ;6834871835;Taip;8;0;0;8
19198;Gabijėlė;VYTURIUKŲ;1185216449;Taip;8;1;0;9
19199;Gabijėlė;VYTURIUKŲ;6107630313;Taip;0;0;5;5
19200;Gabijėlė;VYTURIUKŲ;5297866989;Taip;3;0;0;3
19201;Gabijėlė;VYTURIUKŲ;4278783863;Taip;0;0;1;1
19202;Gabijėlė;VYTURIUKŲ;7509112343;Ne;18;0;0;18
19203;Gabijėlė;VYTURIUKŲ;4248856615;Taip;0;5;0;5
19204;Gabijėlė;VYTURIUKŲ;6539078572;Ne;0;10;0;10
19205;Saulėgrąža;Bitutės;8660677159;Taip;5;0;3;8
19206;Saulėgrąža;Bitutės;5940167166;Taip;0;0;3;3
19207;Saulėgrąža;Bitutės;6641588877;Taip;10;0;2;12
19208;Saulėgrąža;Bitutės;8505655534;Taip;5;0;2;7
19209;Saulėgrąža;Bitutės;2809788049;Taip;11;0;5;16
19210;Saulėgrąža;Bitutės;4733063461;Taip;13;0;1;14
19211;Saulėgrąža;Bitutės;3899237871;Taip;0;4;0;4
19212;Saulėgrąža;Bitutės;1381240000;Taip;0;0;11;11
19213;Saulėgrąža;Bitutės;8766433391;Ne;0;1;0;1
19214;Saulėgrąža;Bitutės;7283302671;Taip;4;0;2;6
19215;Saulėgrąža;Bitutės;4265356484;Ne;0;0;1;1
19216;Saulėgrąža;Bitutės;2042826101;Ne;0;0;2;2
19217;Saulėgrąža;Bitutės;4471740960;Taip;5;0;1;6
19218;Saulėgrąža;Bitutės;8384708422;Taip;0;0;1;1
19219;Saulėgrąža;Bitutės;1345079291;Taip;0;3;0;3
19220;Saulėgrąža;Bitutės;3319538368;Taip;3;3;3;9
19221;Saulėgrąža;Bitutės;8597567633;Taip;15;0;0;15
19222;Saulėgrąža;Bitutės;7387477589;Taip;7;1;0;8
19223;Saulėgrąža;Bitutės;5221286194;Taip;0;3;2;5
19224;Saulėgrąža;Bitutės;9481319116;Taip;7;0;1;8
19225;Saulėgrąža;Bitutės;8531862400;Ne;0;0;2;2
19226;Saulėgrąža;Skruzdėliukai;7211562324;Taip;0;2;0;2
19227;Saulėgrąža;Skruzdėliukai;7636592904;Taip;0;4;2;6
19228;Saulėgrąža;Skruzdėliukai;87694187780;Taip;0;3;0;3
19229;Saulėgrąža;Skruzdėliukai;6036373745;Taip;0;3;0;3
19230;Saulėgrąža;Skruzdėliukai;2029367287;Taip;0;3;1;4
19231;Saulėgrąža;Skruzdėliukai;4904157108;Taip;8;3;1;12
19232;Saulėgrąža;Skruzdėliukai;2453261741;Taip;0;0;4;4
19233;Saulėgrąža;Skruzdėliukai;6867062357;Taip;0;1;0;1
19234;Saulėgrąža;Skruzdėliukai;9701242161;Taip;0;0;1;1
19235;Saulėgrąža;Skruzdėliukai;2123441401;Taip;0;0;4;4
19236;Saulėgrąža;Skruzdėliukai;6373141401;Taip;0;7;0;7
19237;Saulėgrąža;Skruzdėliukai;5674402704;Taip;0;6;0;6
19238;Saulėgrąža;Skruzdėliukai;8140258691;Taip;0;4;0;4
19239;Saulėgrąža;Skruzdėliukai;6942029629;Taip;0;0;1;1
19240;Saulėgrąža;Skruzdėliukai;1397888834;Ne;0;0;11;11
19241;Saulėgrąža;Gudručiai;1557512232;Taip;5;0;3;8
19242;Saulėgrąža;Gudručiai;3334830210;Taip;20;0;0;20
19243;Saulėgrąža;Gudručiai;3460944414;Taip;0;0;2;2
19244;Saulėgrąža;Gudručiai;1220044197;Ne;9;0;0;9
19245;Saulėgrąža;Gudručiai;6087243776;Taip;0;1;2;3
19246;Saulėgrąža;Gudručiai;4656827505;Taip;9;5;0;14
19247;Saulėgrąža;Gudručiai;2325641957;Taip;8;0;3;11
19248;Saulėgrąža;Gudručiai;2142393859;Taip;15;3;0;18
19249;Saulėgrąža;Gudručiai;9377753981;Taip;0;0;1;1
19250;Saulėgrąža;Gudručiai;2811204521;Taip;0;0;1;1
19251;Saulėgrąža;Gudručiai;9703861091;Taip;0;0;4;4
19252;Saulėgrąža;Gudručiai;5493928884;Taip;0;1;0;1
19253;Saulėgrąža;Gudručiai;6925730672;Taip;5;0;0;5
19254;Saulėgrąža;Gudručiai;2787116787;Taip;0;0;1;1
19255;Saulėgrąža;Gudručiai;9537997340;Taip;13;0;0;13
19256;Saulėgrąža;Gudručiai;6188169984;Ne;9;0;4;13
19257;Saulėgrąža;Gudručiai;4593109666;Taip;14;0;0;14
19258;Saulėgrąža;Gudručiai;3455052574;Taip;3;0;0;3
19259;Saulėgrąža;Gudručiai;6803731510;Taip;2;0;6;8
19260;Saulėgrąža;Gudručiai;9235493036;Taip;3;0;1;4
19261;Saulėgrąža;Gudručiai;5230565797;Taip;0;3;0;3
19262;Saulėgrąža;Smalsučiai;1507699415;Ne;7;0;0;7
19263;Saulėgrąža;Smalsučiai;6415042057;Taip;8;3;0;11
19264;Saulėgrąža;Smalsučiai;2378071205;Ne;3;0;0;3
19265;Saulėgrąža;Smalsučiai;9641357813;Taip;13;0;0;13
19266;Saulėgrąža;Smalsučiai;7374802873;Taip;0;4;0;4
19267;Saulėgrąža;Smalsučiai;2405382490;Taip;0;2;0;2
19268;Saulėgrąža;Smalsučiai;7236623241;Taip;0;3;0;3
19269;Saulėgrąža;Smalsučiai;4204112706;Taip;0;5;0;5
19270;Saulėgrąža;Smalsučiai;6627868194;Taip;9;0;0;9
19271;Saulėgrąža;Smalsučiai;3574399274;Taip;0;0;1;1
19272;Saulėgrąža;Smalsučiai;5201590576;Taip;9;0;0;9
19273;Saulėgrąža;Smalsučiai;12350048317;Taip;7;2;0;9
19274;Saulėgrąža;Smalsučiai;1314754650;Taip;0;7;0;7
19275;Saulėgrąža;Smalsučiai;7964046826;Taip;3;0;0;3
19276;Saulėgrąža;Smalsučiai;4252425680;Taip;0;3;0;3
19277;Saulėgrąža;Smalsučiai;1563002207;Taip;0;6;0;6
19278;Saulėgrąža;Smalsučiai;3551146001;Taip;0;4;0;4
19279;Saulėgrąža;"Boruželės ";3889868838;Taip;10;0;0;10
19280;Saulėgrąža;"Boruželės ";1613110580;Taip;3;0;1;4
19281;Saulėgrąža;"Boruželės ";6802366478;Taip;13;0;0;13
19282;Saulėgrąža;"Boruželės ";9604238128;Taip;8;0;11;19
19283;Saulėgrąža;"Boruželės ";4587532777;Ne;16;0;0;16
19284;Saulėgrąža;"Boruželės ";1008547550;Taip;0;0;4;4
19285;Saulėgrąža;"Boruželės ";4930162914;Taip;1;0;5;6
19286;Saulėgrąža;"Boruželės ";8986368849;Taip;0;0;3;3
19287;Saulėgrąža;"Boruželės ";3080026762;Taip;3;0;0;3
19288;Saulėgrąža;"Boruželės ";9328524382;Taip;9;0;2;11
19289;Saulėgrąža;"Boruželės ";2598768766;Taip;12;0;0;12
19290;Saulėgrąža;"Boruželės ";5734857301;Taip;10;0;1;11
19291;Saulėgrąža;"Boruželės ";2938082077;Taip;7;0;0;7
19292;Saulėgrąža;"Boruželės ";9658060059;Taip;8;0;1;9
19293;Saulėgrąža;"Boruželės ";3594593787;Taip;0;5;0;5
19294;Saulėgrąža;"Boruželės ";2455622343;Taip;0;0;3;3
19295;Saulėgrąža;Drugeliai;8155080474;Taip;1;0;5;6
19296;Saulėgrąža;Drugeliai;1955944355;Taip;4;0;0;4
19297;Saulėgrąža;Drugeliai;2680631642;Taip;5;0;1;6
19298;Saulėgrąža;Drugeliai;6127496900;Taip;6;0;7;13
19299;Saulėgrąža;Drugeliai;7267854768;Taip;4;4;0;8
19300;Saulėgrąža;Drugeliai;8841882983;Taip;15;0;5;20
19301;Saulėgrąža;Drugeliai;6608001857;Taip;0;5;1;6
19302;Saulėgrąža;Drugeliai;4663169787;Taip;5;0;4;9
19303;Saulėgrąža;Drugeliai;6981928727;Taip;0;0;3;3
19304;Saulėgrąža;Drugeliai;8873608939;Taip;4;4;0;8
19305;Saulėgrąža;Drugeliai;7281353368;Taip;0;1;0;1
19306;Saulėgrąža;Drugeliai;8138991066;Taip;15;0;1;16
19307;Saulėgrąža;Drugeliai;1379283244;Taip;0;2;2;4
19308;Saulėgrąža;Drugeliai;4767744537;Ne;16;0;2;18
19309;Saulėgrąža;Drugeliai;1564385864;Taip;0;0;1;1
19310;Saulėgrąža;Drugeliai;4361365993;Taip;0;0;6;6
19311;Saulėgrąža;Drugeliai;8882080945;Taip;8;0;8;16
19312;Saulėgrąža;Drugeliai;1080500584;Taip;10;4;1;15
19313;Saulėgrąža;Drugeliai;1386348080;Taip;0;0;10;10
19314;Saulėgrąža;Drugeliai;3318222372;Taip;0;4;0;4
19315;Saulėgrąža;Drugeliai;8148900529;Taip;0;0;1;1
19316;Saulėgrąža;Drugeliai;3988854847;Taip;0;0;5;5
19317;Saulėgrąža;Pabiručiai;2570007539;Taip;6;0;1;7
19318;Saulėgrąža;Pabiručiai;1193968905;Taip;6;0;0;6
19319;Saulėgrąža;Pabiručiai;6924492377;Ne;4;12;0;16
19320;Saulėgrąža;Pabiručiai;1732823416;Taip;0;0;2;2
19321;Saulėgrąža;Pabiručiai;2063366170;Taip;8;0;1;9
19322;Saulėgrąža;Pabiručiai;5417303387;Taip;9;0;2;11
19323;Saulėgrąža;Pabiručiai;4687158499;Ne;1;0;0;1
19324;Saulėgrąža;Pabiručiai;4113866451;Taip;6;0;0;6
19325;Saulėgrąža;Pabiručiai;5759064166;Taip;0;3;0;3
19326;Saulėgrąža;Pabiručiai;3014850439;Taip;0;0;20;20
19327;Saulėgrąža;Pabiručiai;7563907981;Taip;3;0;5;8
19328;Saulėgrąža;Pabiručiai;7110805205;Taip;16;0;1;17
19329;Saulėgrąža;Pabiručiai;6489291407;Ne;8;0;0;8
19330;Saulėgrąža;Pabiručiai;5302001715;Taip;0;0;12;12
19331;Saulėgrąža;Pabiručiai;6846627257;Taip;0;5;0;5
19332;Saulėgrąža;Pabiručiai;4869924215;Taip;0;0;2;2
19333;Saulėgrąža;Pagrandukai;7283179482;Taip;10;0;0;10
19334;Saulėgrąža;Pagrandukai;3060727219;Ne;8;8;7;23
19335;Saulėgrąža;Pagrandukai;4405035646;Taip;0;0;6;6
19336;Saulėgrąža;Pagrandukai;4017783391;Taip;5;0;0;5
19337;Saulėgrąža;Pagrandukai;3811142022;Taip;0;0;6;6
19338;Saulėgrąža;Pagrandukai;5584937620;Taip;0;0;8;8
19339;Saulėgrąža;Pagrandukai;3745791935;Taip;12;0;1;13
19340;Saulėgrąža;Pagrandukai;3785206644;Taip;10;0;0;10
19341;Saulėgrąža;Pagrandukai;2395186861;Ne;21;0;0;21
19342;Saulėgrąža;Pagrandukai;6130342214;Taip;4;0;9;13
19343;Saulėgrąža;Pagrandukai;3860139612;Taip;0;0;23;23
19344;Saulėgrąža;Pagrandukai;7545277683;Taip;0;6;2;8
19345;Saulėgrąža;Pagrandukai;5633604322;Taip;18;0;3;21
19346;Saulėgrąža;Pagrandukai;2882565651;Taip;6;0;1;7
19347;Saulėgrąža;Pagrandukai;3270627153;Taip;5;0;0;5
19348;Pilaitukas;BITUTĖS;3519198814;Taip;0;2;0;2
19349;Pilaitukas;BITUTĖS;8169484415;Taip;0;7;0;7
19350;Pilaitukas;BITUTĖS;1253300093;Taip;0;1;0;1
19351;Pilaitukas;BITUTĖS;1729494874;Taip;3;2;0;5
19352;Pilaitukas;BITUTĖS;2242454299;Taip;0;4;1;5
19353;Pilaitukas;BITUTĖS;4082490488;Taip;10;3;0;13
19354;Pilaitukas;BITUTĖS;3345387791;Taip;9;0;0;9
19355;Pilaitukas;BITUTĖS;3913169122;Taip;0;3;0;3
19356;Pilaitukas;BITUTĖS;3541354283;Taip;8;1;0;9
19357;Pilaitukas;BITUTĖS;5740951665;Taip;13;3;1;17
19358;Pilaitukas;BITUTĖS;4591799893;Taip;21;0;0;21
19359;Pilaitukas;BITUTĖS;6308557885;Taip;11;0;0;11
19360;Pilaitukas;BITUTĖS;6514731102;Taip;10;0;0;10
19361;Pilaitukas;BITUTĖS;5988165204;Taip;4;0;0;4
19362;Pilaitukas;BITUTĖS;3037850837;Taip;0;2;0;2
19363;Pilaitukas;BITUTĖS;9126553732;Taip;6;0;0;6
19364;Pilaitukas;BITUTĖS;7438112270;Taip;0;0;2;2
19365;Pilaitukas;BITUTĖS;1295215465;Ne;2;4;0;6
19366;Pilaitukas;BITUTĖS;5331915157;Taip;0;0;1;1
19367;Pilaitukas;BITUTĖS;6099109886;Taip;0;4;0;4
19368;Pilaitukas;BITUTĖS;3159733673;Taip;3;10;0;13
19369;Pilaitukas;BITUTĖS;2122392982;Ne;5;9;0;14
19370;Pilaitukas;BITUTĖS;7082099968;Taip;6;7;0;13
19371;Pilaitukas;ZUIKUČIAI;8993885764;Ne;5;3;0;8
19372;Pilaitukas;ZUIKUČIAI;5206637809;Taip;2;0;2;4
19373;Pilaitukas;ZUIKUČIAI;5288784331;Taip;0;2;0;2
19374;Pilaitukas;ZUIKUČIAI;8255398803;Taip;10;5;0;15
19375;Pilaitukas;ZUIKUČIAI;2862447956;Taip;0;1;0;1
19376;Pilaitukas;ZUIKUČIAI;8727175656;Taip;0;1;0;1
19377;Pilaitukas;ZUIKUČIAI;8207194955;Taip;0;0;6;6
19378;Pilaitukas;ZUIKUČIAI;5640802570;Taip;0;1;3;4
19379;Pilaitukas;ZUIKUČIAI;4623818227;Taip;0;1;0;1
19380;Pilaitukas;ZUIKUČIAI;9988041515;Taip;0;1;1;2
19381;Pilaitukas;ZUIKUČIAI;9108428738;Taip;0;1;1;2
19382;Pilaitukas;ZUIKUČIAI;1607454890;Taip;0;10;0;10
19383;Pilaitukas;ZUIKUČIAI;5710747769;Taip;3;2;2;7
19384;Pilaitukas;ZUIKUČIAI;7568744500;Taip;0;3;0;3
19385;Pilaitukas;ZUIKUČIAI;5407354218;Taip;10;3;0;13
19386;Pilaitukas;ZUIKUČIAI;1704055907;Taip;5;3;3;11
19387;Pilaitukas;ZUIKUČIAI;6426415533;Taip;0;0;1;1
19388;Pilaitukas;ZUIKUČIAI;9735358433;Taip;0;1;0;1
19389;Pilaitukas;ZUIKUČIAI;2705235576;Taip;0;11;0;11
19390;Pilaitukas;ANČIUKAI;3357097410;Taip;9;0;0;9
19391;Pilaitukas;ANČIUKAI;7773318230;Taip;11;5;0;16
19392;Pilaitukas;ANČIUKAI;4097742120;Ne;18;0;0;18
19393;Pilaitukas;ANČIUKAI;2923272767;Ne;5;4;0;9
19394;Pilaitukas;ANČIUKAI;8620858011;Taip;5;2;0;7
19395;Pilaitukas;ANČIUKAI;4286388920;Taip;17;0;0;17
19396;Pilaitukas;ANČIUKAI;3761827714;Taip;12;2;0;14
19397;Pilaitukas;ANČIUKAI;1120549352;Taip;1;0;0;1
19398;Pilaitukas;ANČIUKAI;6888607864;Taip;9;5;0;14
19399;Pilaitukas;ANČIUKAI;5490465905;Taip;3;6;0;9
19400;Pilaitukas;ANČIUKAI;7876850509;Taip;3;10;1;14
19401;Pilaitukas;ANČIUKAI;3035456834;Taip;0;10;0;10
19402;Pilaitukas;ANČIUKAI;2476942319;Taip;0;9;0;9
19403;Pilaitukas;ANČIUKAI;8033540052;Taip;1;2;2;5
19404;Pilaitukas;ANČIUKAI;1781762820;Taip;0;2;0;2
19405;Pilaitukas;ANČIUKAI;3005101776;Taip;9;0;4;13
19406;Pilaitukas;ANČIUKAI;8787181006;Taip;0;1;0;1
19407;Pilaitukas;ANČIUKAI;7189824054;Ne;5;2;0;7
19408;Pilaitukas;ANČIUKAI;9332831979;Taip;0;1;3;4
19409;Pilaitukas;ANČIUKAI;5706918634;Taip;8;1;2;11
19410;Pilaitukas;ANČIUKAI;8954370321;Taip;5;0;3;8
19411;Pilaitukas;ANČIUKAI;1660462256;Taip;0;10;0;10
19412;Pilaitukas;MEŠKIUKAI;8577357264;Taip;3;2;0;5
19413;Pilaitukas;MEŠKIUKAI;5297214263;Taip;8;6;0;14
19414;Pilaitukas;MEŠKIUKAI;8268790017;Ne;14;0;0;14
19415;Pilaitukas;MEŠKIUKAI;2054626415;Taip;15;3;0;18
19416;Pilaitukas;MEŠKIUKAI;9742268665;Taip;16;0;0;16
19417;Pilaitukas;MEŠKIUKAI;8322980583;Taip;0;1;0;1
19418;Pilaitukas;MEŠKIUKAI;1610122884;Taip;11;0;0;11
19419;Pilaitukas;MEŠKIUKAI;3867660147;Taip;11;0;0;11
19420;Pilaitukas;MEŠKIUKAI;2365387089;Taip;0;0;1;1
19421;Pilaitukas;MEŠKIUKAI;9670329628;Taip;6;1;0;7
19422;Pilaitukas;MEŠKIUKAI;7750575554;Taip;18;0;0;18
19423;Pilaitukas;MEŠKIUKAI;9397435605;Taip;0;3;0;3
19424;Pilaitukas;MEŠKIUKAI;9187961584;Taip;0;1;0;1
19425;Pilaitukas;MEŠKIUKAI;7781507786;Taip;7;1;0;8
19426;Pilaitukas;MEŠKIUKAI;4171896175;Taip;5;1;0;6
19427;Pilaitukas;MEŠKIUKAI;1362132769;Taip;0;1;0;1
19428;Pilaitukas;MEŠKIUKAI;1591276987;Taip;10;0;0;10
19429;Pilaitukas;MEŠKIUKAI;2830212921;Taip;2;3;0;5
19430;Pilaitukas;MEŠKIUKAI;9930306085;Taip;22;0;0;22
19431;Pilaitukas;MEŠKIUKAI;8279288250;Taip;14;0;0;14
19432;Pilaitukas;MEŠKIUKAI;8380819975;Taip;7;2;0;9
19433;Pilaitukas;MEŠKIUKAI;8710069256;Ne;13;0;1;14
19434;Pilaitukas;MEŠKIUKAI;6807166920;Taip;8;0;0;8
19435;Pilaitukas;ŽUVYTĖS;48011638560;Taip;5;3;0;8
19436;Pilaitukas;ŽUVYTĖS;8319676743;Taip;0;3;0;3
19437;Pilaitukas;ŽUVYTĖS;36338976218;Taip;5;3;0;8
19438;Pilaitukas;ŽUVYTĖS;9224653856;Taip;15;3;0;18
19439;Pilaitukas;ŽUVYTĖS;4694691187;Taip;5;1;0;6
19440;Pilaitukas;ŽUVYTĖS;2110458181;Taip;0;0;2;2
19441;Pilaitukas;ŽUVYTĖS;5252233127;Taip;1;8;0;9
19442;Pilaitukas;ŽUVYTĖS;1512181401;Taip;3;4;0;7
19443;Pilaitukas;ŽUVYTĖS;2298935154;Taip;8;0;0;8
19444;Pilaitukas;ŽUVYTĖS;5949185075;Taip;0;3;0;3
19445;Pilaitukas;ŽUVYTĖS;2117570444;Taip;0;0;1;1
19446;Pilaitukas;ŽUVYTĖS;79485847381;Taip;3;1;0;4
19447;Pilaitukas;ŽUVYTĖS;7909465673;Taip;2;0;0;2
19448;Pilaitukas;ŽUVYTĖS;92108889661;Taip;0;2;0;2
19449;Pilaitukas;ŽUVYTĖS;4505384039;Taip;7;3;0;10
19450;Pilaitukas;ŽUVYTĖS;58250008277;Taip;0;5;0;5
19451;Pilaitukas;ŽUVYTĖS;1618432877;Taip;2;12;0;14
19452;Pilaitukas;ŽUVYTĖS;9724892897;Taip;0;3;0;3
19453;Pilaitukas;ŽUVYTĖS;3821748678;Taip;0;3;0;3
19454;Pilaitukas;ŽUVYTĖS;1114477688;Taip;3;5;0;8
19455;Pilaitukas;PAUKŠTELIAI;4505147961;Taip;0;3;0;3
19456;Pilaitukas;PAUKŠTELIAI;2736736697;Taip;0;4;0;4
19457;Pilaitukas;PAUKŠTELIAI;1135880899;Taip;0;6;0;6
19458;Pilaitukas;PAUKŠTELIAI;18466900688;Taip;0;5;0;5
19459;Pilaitukas;PAUKŠTELIAI;4038320896;Taip;11;0;0;11
19460;Pilaitukas;PAUKŠTELIAI;3794882532;Taip;8;3;0;11
19461;Pilaitukas;PAUKŠTELIAI;5689385925;Taip;5;3;0;8
19462;Pilaitukas;PAUKŠTELIAI;5405252621;Taip;0;3;0;3
19463;Pilaitukas;PAUKŠTELIAI;5939557073;Taip;0;5;0;5
19464;Pilaitukas;PAUKŠTELIAI;39600380611;Taip;8;0;0;8
19465;Pilaitukas;PAUKŠTELIAI;3214740183;Taip;0;1;0;1
19466;Pilaitukas;PAUKŠTELIAI;2929868229;Ne;0;2;0;2
19467;Pilaitukas;PAUKŠTELIAI;9924612250;Taip;0;4;0;4
19468;Pilaitukas;PAUKŠTELIAI;6117985788;Taip;6;0;0;6
19469;Pilaitukas;PAUKŠTELIAI;57931719105;Taip;0;1;0;1
19470;Pilaitukas;PAUKŠTELIAI;9618329726;Taip;0;2;0;2
19471;Pilaitukas;PAUKŠTELIAI;1003278169;Taip;0;2;2;4
19472;Pilaitukas;PAUKŠTELIAI;9450834035;Taip;0;4;0;4
19473;Pilaitukas;PAUKŠTELIAI;5604992163;Taip;0;4;0;4
19474;Pilaitukas;PAUKŠTELIAI;1693309238;Taip;0;4;0;4
19475;Pilaitukas;BORUŽĖLĖS;5063602139;Taip;3;6;0;9
19476;Pilaitukas;BORUŽĖLĖS;5984878126;Taip;0;11;1;12
19477;Pilaitukas;BORUŽĖLĖS;9898379569;Taip;0;4;1;5
19478;Pilaitukas;BORUŽĖLĖS;5324806808;Ne;0;1;7;8
19479;Pilaitukas;BORUŽĖLĖS;5185051301;Taip;0;2;0;2
19480;Pilaitukas;BORUŽĖLĖS;5326258755;Taip;0;1;0;1
19481;Pilaitukas;BORUŽĖLĖS;6838035491;Taip;2;0;0;2
19482;Pilaitukas;BORUŽĖLĖS;1731106179;Taip;7;5;0;12
19483;Pilaitukas;BORUŽĖLĖS;3784944532;Taip;16;3;1;20
19484;Pilaitukas;BORUŽĖLĖS;5186675623;Taip;15;0;0;15
19485;Pilaitukas;BORUŽĖLĖS;4317406707;Taip;5;0;0;5
19486;Pilaitukas;BORUŽĖLĖS;4589130143;Taip;7;0;0;7
19487;Pilaitukas;BORUŽĖLĖS;1944443723;Taip;11;0;0;11
19488;Pilaitukas;DRUGELIAI;1677962644;Ne;2;4;0;6
19489;Pilaitukas;DRUGELIAI;4745358362;Ne;2;4;0;6
19490;Pilaitukas;DRUGELIAI;2917197418;Ne;13;0;3;16
19491;Pilaitukas;DRUGELIAI;6712878938;Taip;13;0;0;13
19492;Pilaitukas;DRUGELIAI;3298272815;Ne;10;5;1;16
19493;Pilaitukas;DRUGELIAI;3772830210;Taip;18;0;0;18
19494;Pilaitukas;DRUGELIAI;4719223490;Taip;18;0;0;18
19495;Pilaitukas;DRUGELIAI;9414051187;Taip;10;0;5;15
19496;Pilaitukas;DRUGELIAI;6280870972;Taip;14;0;1;15
19497;Pilaitukas;DRUGELIAI;9741985709;Ne;16;0;1;17
19498;Pilaitukas;DRUGELIAI;7807341574;Taip;8;0;0;8
19499;Pilaitukas;DRUGELIAI;5215800828;Taip;0;0;2;2
19500;Pilaitukas;DRUGELIAI;2414941263;Ne;8;0;0;8
19501;Pilaitukas;DRUGELIAI;2210253038;Taip;22;0;0;22
19502;Pilaitukas;DRUGELIAI;7222856683;Taip;7;0;0;7
19503;Pilaitukas;DRUGELIAI;7830059468;Taip;13;0;0;13
19504;Pilaitukas;DRUGELIAI;7479542200;Taip;0;0;5;5
19505;Pilaitukas;DRUGELIAI;5901884512;Taip;11;0;0;11
19506;Pilaitukas;PELIUKAI;9246925227;Taip;9;0;1;10
19507;Pilaitukas;PELIUKAI;7808204054;Taip;9;0;0;9
19508;Pilaitukas;PELIUKAI;4810825253;Taip;8;4;0;12
19509;Pilaitukas;PELIUKAI;8769116377;Taip;5;0;2;7
19510;Pilaitukas;PELIUKAI;8501376663;Taip;0;5;0;5
19511;Pilaitukas;PELIUKAI;3395656390;Taip;9;0;0;9
19512;Pilaitukas;PELIUKAI;5421602723;Ne;12;1;0;13
19513;Pilaitukas;PELIUKAI;6754825353;Taip;0;4;0;4
19514;Pilaitukas;PELIUKAI;8168228529;Taip;8;6;0;14
19515;Pilaitukas;PELIUKAI;4014329370;Taip;15;0;0;15
19516;Pilaitukas;PELIUKAI;6833933586;Taip;0;3;0;3
19517;Pilaitukas;PELIUKAI;2416277190;Taip;19;0;0;19
19518;Pilaitukas;PELIUKAI;9774222130;Taip;6;0;2;8
19519;Pilaitukas;PELIUKAI;1270365948;Taip;10;1;2;13
19520;Pilaitukas;PELIUKAI;7604004800;Taip;15;0;0;15
19521;Pilaitukas;PELIUKAI;9556421129;Taip;10;0;0;10
19522;Pilaitukas;PELIUKAI;3954210452;Ne;8;1;0;9
19523;Pilaitukas;PELIUKAI;5223336496;Taip;8;0;1;9
19524;Pilaitukas;PELIUKAI;3651140874;Taip;9;0;3;12
19525;Pilaitukas;PELIUKAI;2823859128;Taip;12;0;0;12
19526;Pilaitukas;PELIUKAI;7750936973;Taip;16;0;0;16
19527;Pilaitukas;KAČIUKAI;2406183145;Taip;0;0;1;1
19528;Pilaitukas;KAČIUKAI;2379660463;Taip;0;0;1;1
19529;Pilaitukas;KAČIUKAI;1585341963;Taip;2;4;0;6
19530;Pilaitukas;KAČIUKAI;7594484959;Taip;5;1;0;6
19531;Pilaitukas;KAČIUKAI;2463482642;Taip;0;1;0;1
19532;Pilaitukas;KAČIUKAI;3080014745;Taip;15;2;0;17
19533;Pilaitukas;KAČIUKAI;5353687011;Taip;13;2;0;15
19534;Pilaitukas;KAČIUKAI;6525191057;Taip;0;0;2;2
19535;Pilaitukas;KAČIUKAI;8009040109;Taip;7;8;0;15
19536;Pilaitukas;KAČIUKAI;2105380328;Taip;0;0;23;23
19537;Pilaitukas;KAČIUKAI;5326689274;Taip;14;6;0;20
19538;Pilaitukas;KAČIUKAI;9653647227;Taip;14;6;0;20
19539;Pilaitukas;KAČIUKAI;1999942175;Taip;15;1;0;16
19540;Pilaitukas;KAČIUKAI;3825942473;Taip;0;17;0;17
19541;Pilaitukas;KAČIUKAI;1611371690;Taip;23;0;0;23
19542;Pilaitukas;KAČIUKAI;9247501721;Taip;0;1;1;2
19543;Pilaitukas;KAČIUKAI;9974310580;Taip;0;3;0;3
19544;Pilaitukas;KAČIUKAI;6235375235;Taip;10;2;1;13
19545;Pilaitukas;KAČIUKAI;9914575692;Taip;0;3;0;3
19546;Pilaitukas;SAULUTĖS;8047683859;Taip;8;0;3;11
19547;Pilaitukas;SAULUTĖS;8694369154;Taip;8;0;3;11
19548;Pilaitukas;SAULUTĖS;9405479859;Taip;9;0;0;9
19549;Pilaitukas;SAULUTĖS;2336933998;Taip;23;0;0;23
19550;Pilaitukas;SAULUTĖS;1134083816;Taip;16;0;0;16
19551;Pilaitukas;SAULUTĖS;2110996493;Taip;10;0;0;10
19552;Pilaitukas;SAULUTĖS;1452645899;Taip;3;0;4;7
19553;Pilaitukas;SAULUTĖS;9587140991;Taip;16;0;0;16
19554;Pilaitukas;SAULUTĖS;2215317686;Taip;13;0;0;13
19555;Pilaitukas;MENULIUKAI;6337917448;Taip;2;8;0;10
19556;Pilaitukas;MENULIUKAI;3636976107;Taip;2;8;0;10
19557;Pilaitukas;MENULIUKAI;5026344198;Taip;0;2;2;4
19558;Pilaitukas;MENULIUKAI;5564784922;Taip;0;2;2;4
19559;Pilaitukas;MENULIUKAI;1290017967;Taip;0;7;0;7
19560;Pilaitukas;MENULIUKAI;5691854235;Taip;0;2;0;2
19561;Pilaitukas;MENULIUKAI;6054821801;Taip;8;5;0;13
19562;Pilaitukas;MENULIUKAI;8207648026;Taip;13;0;2;15
19563;Pilaitukas;MENULIUKAI;3921932673;Taip;13;0;2;15
19564;Pilaitukas;MENULIUKAI;5682244165;Taip;10;0;0;10
19565;Pilaitukas;MENULIUKAI;3952708917;Taip;11;3;1;15
19566;Pilaitukas;ĖŽIUKAI;1568651642;Taip;0;3;7;10
19567;Pilaitukas;ĖŽIUKAI;2892275540;Taip;2;0;0;2
19568;Pilaitukas;ĖŽIUKAI;1746050808;Taip;7;0;0;7
19569;Pilaitukas;ĖŽIUKAI;2633256935;Taip;11;0;1;12
19570;Pilaitukas;ĖŽIUKAI;8747053041;Taip;11;0;1;12
19571;Pilaitukas;ĖŽIUKAI;7555601497;Taip;5;0;1;6
19572;Pilaitukas;ĖŽIUKAI;5979852431;Taip;11;0;0;11
19573;Pilaitukas;ĖŽIUKAI;9306169443;Taip;3;0;0;3
19574;Pilaitukas;ĖŽIUKAI;5155899628;Taip;5;0;1;6
19575;Pilaitukas;ĖŽIUKAI;5340877261;Taip;5;0;1;6
19576;Pilaitukas;ĖŽIUKAI;2342453729;Taip;0;2;1;3
19577;Pilaitukas;ĖŽIUKAI;6064545501;Taip;0;10;0;10
19578;Pilaitukas;ĖŽIUKAI;5904710385;Taip;6;0;0;6
19579;Pilaitukas;ĖŽIUKAI;1486895496;Taip;6;0;0;6
19580;Pilaitukas;ĖŽIUKAI;9441608677;Taip;10;0;0;10
19581;Pilaitukas;"ŠNEKUČIAI (ĮSRŪTIES G. 27-101)";2883122532;Taip;0;0;11;11
19582;Pilaitukas;"ŠNEKUČIAI (ĮSRŪTIES G. 27-101)";2883122532;Taip;0;0;11;11
19583;Pilaitukas;"ŠNEKUČIAI (ĮSRŪTIES G. 27-101)";2883122532;Taip;0;0;11;11
19584;Pilaitukas;"ŠNEKUČIAI (ĮSRŪTIES G. 27-101)";8801482035;Taip;17;0;0;17
19585;Pilaitukas;"ŠNEKUČIAI (ĮSRŪTIES G. 27-101)";2894028512;Taip;10;0;0;10
19586;Pilaitukas;"ŠNEKUČIAI (ĮSRŪTIES G. 27-101)";7224121082;Taip;6;0;9;15
19587;Pilaitukas;"ŠNEKUČIAI (ĮSRŪTIES G. 27-101)";9622989196;Taip;0;0;3;3
19588;Pilaitukas;"SMALSUČIAI (ĮSRŪTIES G. 27-101)";1793393776;Taip;11;0;6;17
19589;Pilaitukas;"SMALSUČIAI (ĮSRŪTIES G. 27-101)";3273127718;Taip;18;0;0;18
19590;Pilaitukas;"SMALSUČIAI (ĮSRŪTIES G. 27-101)";7034013577;Taip;11;0;1;12
19591;Pilaitukas;"SMALSUČIAI (ĮSRŪTIES G. 27-101)";4898803794;Taip;17;0;0;17
19592;Pilaitukas;"GUDRUČIAI (ĮSRŪTIES G. 27-101)";1571691020;Ne;0;0;7;7
19593;Pilaitukas;"GUDRUČIAI (ĮSRŪTIES G. 27-101)";3068325053;Ne;0;0;7;7
19594;Pilaitukas;"GUDRUČIAI (ĮSRŪTIES G. 27-101)";1430155044;Ne;3;0;0;3
19595;Pilaitukas;"GUDRUČIAI (ĮSRŪTIES G. 27-101)";1517834246;Taip;2;0;0;2
19596;Pilaitukas;"GUDRUČIAI (ĮSRŪTIES G. 27-101)";93271260871;Taip;3;5;0;8
19597;Pilaitukas;"GUDRUČIAI (ĮSRŪTIES G. 27-101)";5059528135;Taip;18;0;0;18
19598;Pilaitukas;"GUDRUČIAI (ĮSRŪTIES G. 27-101)";7904142328;Taip;0;2;0;2
19599;Pilaitukas;"GUDRUČIAI (ĮSRŪTIES G. 27-101)";3674481373;Taip;0;2;0;2
19600;Pilaitukas;"GUDRUČIAI (ĮSRŪTIES G. 27-101)";2682252810;Taip;0;1;3;4
19601;Pilaitukas;"GUDRUČIAI (ĮSRŪTIES G. 27-101)";8928237970;Taip;5;0;1;6
19602;Pilaitukas;"GUDRUČIAI (ĮSRŪTIES G. 27-101)";7290732562;Taip;0;3;4;7
19603;Pilaitukas;"GUDRUČIAI (ĮSRŪTIES G. 27-101)";3489297719;Taip;2;0;1;3
19604;Pilaitukas;"GUDRUČIAI (ĮSRŪTIES G. 27-101)";87035008129;Taip;0;3;0;3
19605;Pilaitukas;"GUDRUČIAI (ĮSRŪTIES G. 27-101)";2819283284;Taip;5;18;0;23
19606;Pilaitukas;"GUDRUČIAI (ĮSRŪTIES G. 27-101)";7380303098;Taip;0;3;2;5
19607;Pilaitukas;"GUDRUČIAI (ĮSRŪTIES G. 27-101)";9186679454;Taip;0;0;2;2
19608;Pilaitukas;"GUDRUČIAI (ĮSRŪTIES G. 27-101)";9921730735;Taip;6;1;0;7
19609;Pilaitukas;"GUDRUČIAI (ĮSRŪTIES G. 27-101)";8584321345;Taip;0;0;1;1
19610;Pilaitukas;"GUDRUČIAI (ĮSRŪTIES G. 27-101)";1747834520;Ne;0;8;0;8
19611;Pilaitukas;"GUDRUČIAI (ĮSRŪTIES G. 27-101)";5574732283;Taip;8;0;2;10
19612;Pilaitukas;"GUDRUČIAI (ĮSRŪTIES G. 27-101)";5464065587;Taip;0;3;0;3
19613;Pilaitukas;"GUDRUČIAI (ĮSRŪTIES G. 27-101)";3621245783;Taip;0;0;2;2
19614;Švelnukas;Pelėdžiukai;8016531082;Taip;4;15;4;23
19615;Švelnukas;Pelėdžiukai;8219071968;Taip;0;4;5;9
19616;Švelnukas;Pelėdžiukai;3235768013;Taip;0;3;0;3
19617;Švelnukas;Pelėdžiukai;9008722163;Taip;5;3;0;8
19618;Švelnukas;Pelėdžiukai;1116279011;Ne;0;1;0;1
19619;Švelnukas;Pelėdžiukai;3892058023;Ne;0;1;0;1
19620;Švelnukas;Pelėdžiukai;5681611554;Taip;3;0;2;5
19621;Švelnukas;Pelėdžiukai;8589226595;Taip;3;0;7;10
19622;Švelnukas;Pelėdžiukai;9802064955;Taip;0;3;0;3
19623;Švelnukas;Pelėdžiukai;5041138716;Taip;0;3;0;3
19624;Švelnukas;Pelėdžiukai;3804532959;Taip;0;2;0;2
19625;Švelnukas;Pelėdžiukai;8650902343;Taip;0;0;1;1
19626;Švelnukas;Pelėdžiukai;1409803554;Taip;0;2;0;2
19627;Švelnukas;Pelėdžiukai;1991507109;Ne;8;2;1;11
19628;Švelnukas;Pelėdžiukai;9808833734;Taip;0;0;4;4
19629;Švelnukas;Pelėdžiukai;6069027553;Taip;7;0;1;8
19630;Švelnukas;Ežiukai;64192510147;Taip;0;3;0;3
19631;Švelnukas;Ežiukai;25374873288;Taip;0;3;1;4
19632;Švelnukas;Ežiukai;6282389058;Taip;0;1;0;1
19633;Švelnukas;Ežiukai;23795609183;Taip;0;0;1;1
19634;Švelnukas;Ežiukai;4711482287;Taip;4;0;0;4
19635;Švelnukas;Ežiukai;8681264696;Taip;4;6;0;10
19636;Švelnukas;Ežiukai;4373567509;Taip;0;1;0;1
19637;Švelnukas;Ežiukai;2521009631;Taip;3;0;2;5
19638;Švelnukas;Ežiukai;1165172787;Taip;10;1;0;11
19639;Švelnukas;Ežiukai;2892176166;Taip;0;1;0;1
19640;Švelnukas;Ežiukai;7308701231;Taip;0;3;1;4
19641;Švelnukas;Ežiukai;2400781175;Taip;0;5;1;6
19642;Švelnukas;Ežiukai;6209334207;Taip;3;0;1;4
19643;Švelnukas;Ežiukai;1201550386;Taip;0;0;1;1
19644;Švelnukas;Ežiukai;7266255326;Taip;0;1;1;2
19645;Švelnukas;Ežiukai;2348752207;Taip;0;23;0;23
19646;Švelnukas;Ežiukai;1143579276;Taip;0;0;1;1
19647;Švelnukas;Ežiukai;5409130195;Taip;15;0;0;15
19648;Švelnukas;Ežiukai;3645855145;Taip;0;1;0;1
19649;Švelnukas;Ežiukai;9402567487;Ne;5;0;4;9
19650;Švelnukas;Ežiukai;8569985034;Ne;0;1;6;7
19651;Švelnukas;Švelnukai;4681584014;Taip;5;0;0;5
19652;Švelnukas;Švelnukai;6607578153;Taip;0;5;3;8
19653;Švelnukas;Švelnukai;8847738918;Taip;0;0;1;1
19654;Švelnukas;Švelnukai;1982267458;Taip;0;0;1;1
19655;Švelnukas;Švelnukai;9766734938;Taip;0;3;4;7
19656;Švelnukas;Švelnukai;1411710913;Taip;0;1;1;2
19657;Švelnukas;Švelnukai;5032829856;Taip;0;0;2;2
19658;Švelnukas;Švelnukai;5213589179;Taip;0;7;0;7
19659;Švelnukas;Švelnukai;1963518457;Taip;0;3;0;3
19660;Švelnukas;Švelnukai;4194249709;Taip;0;3;5;8
19661;Švelnukas;Švelnukai;3228293160;Taip;0;1;0;1
19662;Švelnukas;Švelnukai;4629757899;Taip;5;4;0;9
19663;Švelnukas;Švelnukai;6964997767;Taip;0;3;1;4
19664;Švelnukas;Švelnukai;8951810066;Taip;3;0;0;3
19665;Švelnukas;Švelnukai;2663990082;Taip;3;0;2;5
19666;Švelnukas;Švelnukai;5960966542;Taip;8;0;0;8
19667;Švelnukas;Boružiukai;1951447127;Taip;0;0;15;15
19668;Švelnukas;Boružiukai;3849957906;Taip;0;0;3;3
19669;Švelnukas;Boružiukai;5550841477;Taip;13;0;0;13
19670;Švelnukas;Boružiukai;1264256177;Taip;8;4;0;12
19671;Švelnukas;Boružiukai;1332533332;Taip;6;0;3;9
19672;Švelnukas;Boružiukai;8787505507;Ne;0;1;1;2
19673;Švelnukas;Boružiukai;8458233793;Taip;0;0;2;2
19674;Švelnukas;Boružiukai;7967996032;Taip;5;0;4;9
19675;Švelnukas;Boružiukai;8951980999;Taip;0;0;1;1
19676;Švelnukas;Boružiukai;4990399144;Taip;5;6;0;11
19677;Švelnukas;Boružiukai;9575767514;Ne;0;0;16;16
19678;Švelnukas;Boružiukai;6282137936;Taip;0;1;0;1
19679;Švelnukas;Boružiukai;2088128734;Taip;5;2;0;7
19680;Švelnukas;Boružiukai;2077614498;Ne;0;2;3;5
19681;Švelnukas;Boružiukai;3145935641;Taip;0;3;0;3
19682;Švelnukas;Boružiukai;4404904322;Taip;0;0;5;5
19683;Švelnukas;Boružiukai;8895028305;Taip;3;0;1;4
19684;Švelnukas;Boružiukai;4961854528;Taip;0;3;0;3
19685;Švelnukas;Smalsučiai;9558811523;Taip;5;0;0;5
19686;Švelnukas;Smalsučiai;5554625346;Taip;0;0;3;3
19687;Švelnukas;Smalsučiai;3282020958;Taip;0;0;3;3
19688;Švelnukas;Smalsučiai;5805289419;Taip;0;0;1;1
19689;Švelnukas;Smalsučiai;7987715134;Taip;7;5;1;13
19690;Švelnukas;Smalsučiai;3455801077;Taip;0;23;0;23
19691;Švelnukas;Smalsučiai;8193690277;Taip;5;0;1;6
19692;Švelnukas;Smalsučiai;9371102717;Taip;0;23;0;23
19693;Švelnukas;Smalsučiai;3472774028;Taip;8;0;3;11
19694;Švelnukas;Smalsučiai;5845744917;Taip;0;3;1;4
19695;Švelnukas;Smalsučiai;6764222588;Taip;0;3;18;21
19696;Švelnukas;Smalsučiai;1840752560;Taip;0;7;7;14
19697;Švelnukas;Smalsučiai;8268391509;Taip;8;0;1;9
19698;Švelnukas;Smalsučiai;4467095100;Taip;0;0;1;1
19699;Švelnukas;Nykštukai;1293700097;Taip;0;1;0;1
19700;Švelnukas;Nykštukai;8221642452;Taip;0;3;0;3
19701;Švelnukas;Nykštukai;2141519946;Taip;0;3;0;3
19702;Švelnukas;Nykštukai;8771953161;Taip;0;3;5;8
19703;Švelnukas;Nykštukai;5327209876;Taip;0;1;0;1
19704;Švelnukas;Nykštukai;2282356211;Taip;5;1;0;6
19705;Švelnukas;Nykštukai;4697253853;Taip;0;1;2;3
19706;Švelnukas;Nykštukai;7387060610;Taip;0;3;0;3
19707;Švelnukas;Nykštukai;1762528313;Taip;0;3;8;11
19708;Švelnukas;Nykštukai;6633233824;Taip;10;0;0;10
19709;Švelnukas;Nykštukai;2106591525;Taip;3;0;0;3
19710;Švelnukas;Nykštukai;93497358197;Taip;0;1;0;1
19711;Švelnukas;Nykštukai;2971380970;Taip;0;5;0;5
19712;Švelnukas;Nykštukai;3389897065;Taip;0;5;0;5
19713;Švelnukas;Nykštukai;4302735157;Taip;0;3;3;6
19714;Švelnukas;Nykštukai;2785396019;Taip;0;0;2;2
19715;Švelnukas;Nykštukai;6195335543;Taip;0;1;0;1
19716;Boružėlė;"Nykštukai gudručiai";7736917485;Taip;9;8;0;17
19717;Boružėlė;"Nykštukai gudručiai";9520696660;Taip;0;0;2;2
19718;Boružėlė;"Nykštukai gudručiai";5691884576;Ne;0;1;0;1
19719;Boružėlė;"Nykštukai gudručiai";9193273478;Taip;21;0;0;21
19720;Boružėlė;"Nykštukai gudručiai";8359957290;Ne;0;5;5;10
19721;Boružėlė;"Nykštukai gudručiai";8141240094;Taip;0;0;9;9
19722;Boružėlė;"Nykštukai gudručiai";2349571778;Taip;15;0;0;15
19723;Boružėlė;"Nykštukai gudručiai";1894170218;Taip;13;0;0;13
19724;Boružėlė;"Nykštukai gudručiai";3509512899;Taip;15;0;0;15
19725;Boružėlė;"Nykštukai gudručiai";8888151470;Taip;15;0;0;15
19726;Boružėlė;"Nykštukai gudručiai";3430953692;Taip;0;7;0;7
19727;Boružėlė;"Nykštukai gudručiai";8365962523;Taip;0;7;2;9
19728;Boružėlė;"Nykštukai gudručiai";3592853535;Taip;9;3;0;12
19729;Boružėlė;"Nykštukai gudručiai";6876323023;Taip;1;1;0;2
19730;Boružėlė;"Nykštukai gudručiai";2744894565;Taip;0;10;2;12
19731;Boružėlė;"Nykštukai gudručiai";6590829182;Ne;5;11;0;16
19732;Boružėlė;"Nykštukai gudručiai";3129825206;Ne;0;5;0;5
19733;Boružėlė;"Nykštukai gudručiai";8789209196;Taip;5;0;0;5
19734;Boružėlė;"Nykštukai gudručiai";9078805020;Taip;8;0;0;8
19735;Boružėlė;"Saulės zuikučiai";4554260776;Taip;15;0;0;15
19736;Boružėlė;"Saulės zuikučiai";5298170118;Taip;8;0;0;8
19737;Boružėlė;"Saulės zuikučiai";1116012068;Taip;9;2;1;12
19738;Boružėlė;"Saulės zuikučiai";1292298259;Taip;6;0;1;7
19739;Boružėlė;"Saulės zuikučiai";3130977416;Taip;7;0;1;8
19740;Boružėlė;"Saulės zuikučiai";7256396576;Taip;8;2;3;13
19741;Boružėlė;"Saulės zuikučiai";4323998138;Taip;7;0;0;7
19742;Boružėlė;"Saulės zuikučiai";2087238951;Taip;6;1;0;7
19743;Boružėlė;"Saulės zuikučiai";3952645542;Ne;0;5;0;5
19744;Boružėlė;"Saulės zuikučiai";5516103398;Taip;11;0;2;13
19745;Boružėlė;"Saulės zuikučiai";8259586236;Taip;7;2;0;9
19746;Boružėlė;"Saulės zuikučiai";3955841578;Taip;7;2;0;9
19747;Boružėlė;"Saulės zuikučiai";1583223569;Taip;7;2;0;9
19748;Boružėlė;"Saulės zuikučiai";4433248526;Taip;0;3;0;3
19749;Boružėlė;"Saulės zuikučiai";1547802140;Taip;3;0;5;8
19750;Boružėlė;"Saulės zuikučiai";4020348640;Taip;7;0;0;7
19751;Boružėlė;"Saulės zuikučiai";2842256033;Taip;8;0;0;8
19752;Boružėlė;"Saulės zuikučiai";2561969142;Taip;13;0;2;15
19753;Boružėlė;"Saulės zuikučiai";7262515868;Taip;0;1;0;1
19754;Boružėlė;"Saulės zuikučiai";6527254253;Taip;10;3;0;13
19755;Boružėlė;"Saulės zuikučiai";7942043844;Taip;0;8;4;12
19756;Boružėlė;Gėlytės;3288141024;Taip;0;7;0;7
19757;Boružėlė;Gėlytės;1166207929;Taip;12;1;0;13
19758;Boružėlė;Gėlytės;7956982615;Ne;0;2;2;4
19759;Boružėlė;Gėlytės;4637656311;Taip;8;5;8;21
19760;Boružėlė;Gėlytės;3226733236;Taip;4;0;0;4
19761;Boružėlė;Gėlytės;6070356395;Taip;5;3;0;8
19762;Boružėlė;Gėlytės;4180537253;Taip;10;1;0;11
19763;Boružėlė;Gėlytės;6722353853;Taip;12;0;3;15
19764;Boružėlė;Gėlytės;5252261660;Taip;23;0;0;23
19765;Boružėlė;Gėlytės;8376436755;Taip;0;0;6;6
19766;Boružėlė;Gėlytės;3300678477;Taip;0;2;0;2
19767;Boružėlė;Gėlytės;7763958937;Taip;0;0;6;6
19768;Boružėlė;Gėlytės;9855354210;Taip;5;0;0;5
19769;Boružėlė;Gėlytės;2515608520;Ne;14;0;0;14
19770;Boružėlė;Gėlytės;3354291446;Taip;0;0;1;1
19771;Boružėlė;Gėlytės;8520403894;Taip;7;4;0;11
19772;Boružėlė;Gėlytės;4268486154;Ne;0;10;0;10
19773;Boružėlė;Gėlytės;8205706322;Taip;12;0;3;15
19774;Boružėlė;Gėlytės;8834231529;Ne;10;7;1;18
19775;Boružėlė;Gėlytės;8929444125;Taip;0;0;8;8
19776;Boružėlė;Smalsutis;5129244830;Taip;0;2;2;4
19777;Boružėlė;Smalsutis;2887130633;Taip;4;0;0;4
19778;Boružėlė;Smalsutis;4947670606;Taip;0;1;4;5
19779;Boružėlė;Smalsutis;2917508421;Taip;5;0;0;5
19780;Boružėlė;Smalsutis;7263730692;Taip;0;11;0;11
19781;Boružėlė;Smalsutis;5708558321;Taip;0;4;0;4
19782;Boružėlė;Smalsutis;6484173786;Taip;0;1;0;1
19783;Boružėlė;Smalsutis;6742157071;Taip;2;0;0;2
19784;Boružėlė;Smalsutis;2132904457;Taip;0;7;0;7
19785;Boružėlė;Smalsutis;39553430808;Taip;0;3;2;5
19786;Boružėlė;Smalsutis;4958704459;Taip;6;3;0;9
19787;Boružėlė;Smalsutis;5618586722;Taip;0;1;4;5
19788;Boružėlė;Smalsutis;8493908653;Taip;0;4;0;4
19789;Boružėlė;Smalsutis;4283064680;Taip;0;0;4;4
19790;Boružėlė;Smalsutis;2447148171;Ne;18;0;0;18
19791;Boružėlė;Smalsutis;1391562352;Taip;11;0;0;11
19792;Boružėlė;Smalsutis;7386694567;Taip;0;2;0;2
19793;Boružėlė;Smalsutis;9634967237;Taip;7;0;0;7
19794;Boružėlė;Smalsutis;3592594142;Taip;7;0;0;7
19795;Boružėlė;Drugeliai;8357946299;Taip;0;4;0;4
19796;Boružėlė;Drugeliai;1130980139;Taip;0;4;0;4
19797;Boružėlė;Drugeliai;6463583187;Taip;0;4;0;4
19798;Boružėlė;Drugeliai;3136028536;Taip;5;0;0;5
19799;Boružėlė;Drugeliai;2211576663;Taip;0;9;0;9
19800;Boružėlė;Drugeliai;1559001916;Taip;9;4;0;13
19801;Boružėlė;Drugeliai;4233602822;Taip;0;1;0;1
19802;Boružėlė;Drugeliai;9463322491;Taip;0;1;0;1
19803;Boružėlė;Drugeliai;8482813204;Taip;0;1;0;1
19804;Boružėlė;Drugeliai;6369070055;Taip;0;0;2;2
19805;Boružėlė;Drugeliai;6902130914;Taip;9;1;1;11
19806;Boružėlė;Drugeliai;3459207879;Taip;6;7;0;13
19807;Boružėlė;Drugeliai;6980022864;Taip;0;1;0;1
19808;Boružėlė;Drugeliai;7756929745;Taip;0;2;0;2
19809;Boružėlė;Drugeliai;5726187445;Taip;2;0;0;2
19810;Boružėlė;Drugeliai;2308405580;Taip;0;0;13;13
19811;Boružėlė;Drugeliai;3405184929;Taip;0;0;2;2
19812;Boružėlė;Drugeliai;8213060214;Taip;6;1;0;7
19813;Boružėlė;Drugeliai;3331238309;Taip;23;0;0;23
19814;Boružėlė;Drugeliai;2783338563;Taip;0;4;0;4
19815;Boružėlė;Vyturėliai;1913540317;Taip;4;2;0;6
19816;Boružėlė;Vyturėliai;1591582954;Taip;3;8;0;11
19817;Boružėlė;Vyturėliai;3322567969;Taip;0;3;0;3
19818;Boružėlė;Vyturėliai;8311383437;Taip;0;2;0;2
19819;Boružėlė;Vyturėliai;7534482245;Ne;5;3;1;9
19820;Boružėlė;Vyturėliai;3310676316;Ne;2;4;0;6
19821;Boružėlė;Vyturėliai;87834777247;Taip;8;5;0;13
19822;Boružėlė;Vyturėliai;50071056728;Taip;0;10;0;10
19823;Boružėlė;Vyturėliai;43300167107;Taip;0;2;0;2
19824;Boružėlė;Vyturėliai;2098408445;Taip;5;3;0;8
19825;Boružėlė;Vyturėliai;8706461730;Ne;0;2;0;2
19826;Boružėlė;Vyturėliai;5337704114;Taip;4;5;0;9
19827;Boružėlė;Vyturėliai;8225622711;Taip;0;1;0;1
19828;Boružėlė;Vyturėliai;9150703371;Taip;0;1;0;1
19829;Boružėlė;Vyturėliai;5811751925;Taip;0;7;0;7
19830;Boružėlė;Vyturėliai;6978158667;Taip;0;4;0;4
19831;Boružėlė;Vyturėliai;9640681773;Taip;0;3;9;12
19832;Boružėlė;Vyturėliai;5576016171;Taip;0;2;2;4
19833;Boružėlė;Žvaigždutės;4990831292;Taip;5;0;0;5
19834;Boružėlė;Žvaigždutės;9838823214;Taip;4;0;0;4
19835;Boružėlė;Žvaigždutės;7825636053;Taip;0;5;0;5
19836;Boružėlė;Žvaigždutės;7901880926;Taip;5;0;1;6
19837;Boružėlė;Žvaigždutės;6242220139;Taip;0;12;0;12
19838;Boružėlė;Žvaigždutės;3489498503;Taip;11;3;0;14
19839;Boružėlė;Žvaigždutės;5274016839;Taip;0;3;0;3
19840;Boružėlė;Žvaigždutės;9720535449;Taip;0;3;0;3
19841;Boružėlė;Žvaigždutės;6435556131;Taip;0;3;0;3
19842;Boružėlė;Žvaigždutės;5307997577;Taip;0;0;6;6
19843;Boružėlė;Žvaigždutės;6724101421;Taip;0;1;0;1
19844;Boružėlė;Žvaigždutės;6972646373;Taip;0;1;0;1
19845;Boružėlė;Žvaigždutės;8820827882;Taip;0;6;0;6
19846;Boružėlė;Žvaigždutės;5242187638;Taip;3;0;0;3
19847;Boružėlė;Žvaigždutės;1799882790;Taip;7;7;1;15
19848;Boružėlė;Žvaigždutės;5420788580;Taip;0;1;0;1
19849;Boružėlė;Žvaigždutės;6130634131;Taip;5;0;0;5
19850;Boružėlė;Ąžuoliukai;4519645340;Taip;0;6;0;6
19851;Boružėlė;Ąžuoliukai;4994696176;Taip;0;5;0;5
19852;Boružėlė;Ąžuoliukai;6439902117;Taip;0;3;0;3
19853;Boružėlė;Ąžuoliukai;3840860155;Taip;5;3;0;8
19854;Boružėlė;Ąžuoliukai;7722277859;Taip;11;3;0;14
19855;Boružėlė;Ąžuoliukai;5832223872;Taip;0;1;0;1
19856;Boružėlė;Ąžuoliukai;3695411422;Taip;0;3;0;3
19857;Boružėlė;Ąžuoliukai;76222777017;Taip;3;4;0;7
19858;Boružėlė;Ąžuoliukai;2077228543;Taip;0;0;21;21
19859;Boružėlė;Ąžuoliukai;6022191251;Taip;0;3;0;3
19860;Boružėlė;Ąžuoliukai;3869817904;Taip;4;2;0;6
19861;Boružėlė;Ąžuoliukai;9269501176;Taip;11;0;0;11
19862;Boružėlė;Ąžuoliukai;8029389952;Taip;0;4;0;4
19863;Boružėlė;Ąžuoliukai;8683282162;Taip;5;0;0;5
19864;Boružėlė;Ąžuoliukai;9999252614;Taip;0;1;0;1
19865;Boružėlė;Saulutės;9492548829;Taip;9;2;0;11
19866;Boružėlė;Saulutės;5437943626;Taip;9;5;0;14
19867;Boružėlė;Saulutės;3503931241;Taip;9;5;0;14
19868;Boružėlė;Saulutės;8882070834;Taip;9;0;0;9
19869;Boružėlė;Saulutės;7882386455;Ne;3;0;0;3
19870;Boružėlė;Saulutės;6265279517;Taip;9;0;0;9
19871;Boružėlė;Saulutės;6275425512;Taip;9;0;0;9
19872;Boružėlė;Saulutės;2879726579;Taip;10;0;0;10
19873;Boružėlė;Saulutės;8804878419;Taip;3;3;0;6
19874;Boružėlė;Saulutės;3871593172;Taip;0;3;0;3
19875;Boružėlė;Saulutės;3953507461;Taip;7;2;0;9
19876;Boružėlė;Saulutės;1492091211;Taip;2;2;0;4
19877;Boružėlė;Saulutės;1830043506;Taip;9;0;0;9
19878;Boružėlė;Saulutės;5680510186;Taip;0;9;0;9
19879;Boružėlė;Saulutės;1152697871;Taip;6;5;0;11
19880;Boružėlė;Saulutės;1779839709;Ne;2;5;0;7
19881;Boružėlė;Saulutės;7652740249;Taip;11;1;0;12
19882;Boružėlė;Saulutės;5508064424;Ne;10;3;0;13
19883;Boružėlė;Saulutės;5064892417;Taip;3;2;0;5
19884;Boružėlė;Saulutės;8577301586;Taip;0;1;0;1
19885;Boružėlė;Saulutės;8660954142;Taip;0;1;0;1
19886;Boružėlė;Ežiukai;9342498392;Taip;6;0;0;6
19887;Boružėlė;Ežiukai;8195442951;Taip;0;8;4;12
19888;Boružėlė;Ežiukai;6448688592;Taip;3;0;0;3
19889;Boružėlė;Ežiukai;2429696310;Taip;0;13;0;13
19890;Boružėlė;Ežiukai;9893643199;Taip;7;8;0;15
19891;Boružėlė;Ežiukai;3112016309;Taip;13;0;0;13
19892;Boružėlė;Ežiukai;5394149649;Taip;13;0;0;13
19893;Boružėlė;Ežiukai;9391811395;Taip;5;3;0;8
19894;Boružėlė;Ežiukai;8167376712;Taip;11;4;0;15
19895;Boružėlė;Ežiukai;1784594085;Taip;0;5;0;5
19896;Boružėlė;Ežiukai;5825164520;Taip;0;0;7;7
19897;Boružėlė;Ežiukai;7190980006;Taip;2;2;0;4
19898;Boružėlė;Ežiukai;7459531236;Taip;10;0;0;10
19899;Boružėlė;Ežiukai;8818358360;Taip;10;0;0;10
19900;Boružėlė;Ežiukai;1693082285;Taip;0;0;8;8
19901;Boružėlė;Ežiukai;2926620929;Taip;8;0;0;8
19902;Boružėlė;Ežiukai;6609156790;Taip;0;6;1;7
19903;Boružėlė;Ežiukai;8291389794;Taip;16;1;0;17
19904;Boružėlė;Ežiukai;2524469162;Taip;6;0;0;6
19905;Boružėlė;Ežiukai;5492228053;Taip;10;4;0;14
19906;Boružėlė;Ežiukai;6087811262;Taip;14;2;0;16
19907;Boružėlė;Boružiukai;7068409148;Taip;0;2;0;2
19908;Boružėlė;Boružiukai;8434178580;Taip;15;0;0;15
19909;Boružėlė;Boružiukai;8752343077;Taip;1;2;0;3
19910;Boružėlė;Boružiukai;8944790932;Taip;0;0;23;23
19911;Boružėlė;Boružiukai;7065907155;Taip;0;0;23;23
19912;Boružėlė;Boružiukai;4113917886;Taip;0;0;23;23
19913;Boružėlė;Boružiukai;1608652924;Taip;0;0;23;23
19914;Boružėlė;Boružiukai;7149439740;Taip;0;3;0;3
19915;Boružėlė;Boružiukai;3005601935;Taip;0;4;0;4
19916;Boružėlė;Boružiukai;4497753570;Taip;10;0;0;10
19917;Boružėlė;Boružiukai;1865891989;Ne;3;2;0;5
19918;Boružėlė;Boružiukai;3097874340;Taip;10;1;0;11
19919;Boružėlė;Boružiukai;1551933321;Taip;5;7;0;12
19920;Boružėlė;Boružiukai;3097217902;Taip;0;0;23;23
19921;Boružėlė;Boružiukai;2084361709;Taip;8;2;1;11
19922;Boružėlė;Boružiukai;4727351240;Taip;13;2;0;15
19923;Boružėlė;Nykštukai;3331139963;Taip;0;1;0;1
19924;Boružėlė;Nykštukai;1047419932;Taip;5;1;0;6
19925;Boružėlė;Nykštukai;2104101406;Taip;0;5;0;5
19926;Boružėlė;Nykštukai;8377410278;Taip;0;0;3;3
19927;Boružėlė;Nykštukai;4928818565;Taip;5;0;0;5
19928;Boružėlė;Nykštukai;5619719965;Taip;0;5;0;5
19929;Boružėlė;Nykštukai;6267999965;Taip;15;4;0;19
19930;Boružėlė;Nykštukai;8073918985;Ne;6;1;0;7
19931;Boružėlė;Nykštukai;3595998843;Taip;8;2;0;10
19932;Boružėlė;Nykštukai;1929202434;Taip;3;0;0;3
19933;Boružėlė;Nykštukai;4217116059;Taip;1;0;0;1
19934;Boružėlė;Nykštukai;8165748779;Taip;0;1;2;3
19935;Žaliakalnio;Drugeliai;6379145626;Ne;0;4;1;5
19936;Žaliakalnio;Drugeliai;7094914749;Taip;9;4;0;13
19937;Žaliakalnio;Drugeliai;7449949339;Ne;4;4;0;8
19938;Žaliakalnio;Drugeliai;1413563085;Ne;10;1;0;11
19939;Žaliakalnio;Drugeliai;2432935088;Ne;0;2;0;2
19940;Žaliakalnio;Drugeliai;1033910097;Taip;0;5;0;5
19941;Žaliakalnio;Drugeliai;9032003195;Ne;7;1;0;8
19942;Žaliakalnio;Drugeliai;7566429633;Taip;3;9;0;12
19943;Žaliakalnio;Drugeliai;3835667120;Ne;0;2;0;2
19944;Žaliakalnio;Drugeliai;6341640909;Taip;10;1;0;11
19945;Žaliakalnio;Drugeliai;2305496316;Ne;0;2;0;2
19946;Žaliakalnio;Drugeliai;9984857605;Taip;8;0;0;8
19947;Žaliakalnio;Drugeliai;5764128482;Taip;0;4;0;4
19948;Žaliakalnio;Drugeliai;4497938258;Taip;1;0;0;1
19949;Žaliakalnio;Drugeliai;1673321992;Taip;6;0;0;6
19950;Žaliakalnio;Boružėlių;5843020412;Taip;0;5;0;5
19951;Žaliakalnio;Boružėlių;9625531462;Taip;0;14;0;14
19952;Žaliakalnio;Boružėlių;6699373334;Taip;0;14;0;14
19953;Žaliakalnio;Boružėlių;7087535800;Taip;5;2;0;7
19954;Žaliakalnio;Boružėlių;1528111839;Taip;0;1;0;1
19955;Žaliakalnio;Boružėlių;7023886811;Taip;0;5;0;5
19956;Žaliakalnio;Boružėlių;7977009681;Taip;8;0;0;8
19957;Žaliakalnio;Boružėlių;2808776865;Taip;5;0;0;5
19958;Žaliakalnio;Boružėlių;2278681435;Taip;12;0;1;13
19959;Žaliakalnio;Boružėlių;9421259943;Taip;3;0;0;3
19960;Žaliakalnio;Boružėlių;3445649442;Ne;0;3;0;3
19961;Žaliakalnio;Boružėlių;3105500733;Taip;0;3;0;3
19962;Žaliakalnio;Boružėlių;1200844791;Taip;0;3;0;3
19963;Žaliakalnio;Boružėlių;8052539476;Taip;23;0;0;23
19964;Žaliakalnio;Boružėlių;6590016097;Ne;8;4;0;12
19965;Žaliakalnio;Boružėlių;8304431519;Ne;15;0;2;17
19966;Žaliakalnio;Boružėlių;5488964606;Taip;0;2;0;2
19967;Žaliakalnio;Boružėlių;8429135626;Taip;0;13;0;13
19968;Žaliakalnio;Boružėlių;8534973941;Taip;15;4;0;19
19969;Žaliakalnio;Boružėlių;2987217910;Taip;15;0;0;15
19970;Žaliakalnio;Boružėlių;5157814568;Taip;0;2;2;4
19971;Žaliakalnio;Zuikučiai;1592051491;Taip;0;8;0;8
19972;Žaliakalnio;Zuikučiai;6088333997;Taip;0;11;0;11
19973;Žaliakalnio;Zuikučiai;2673619031;Taip;0;5;0;5
19974;Žaliakalnio;Zuikučiai;5843314345;Taip;6;3;0;9
19975;Žaliakalnio;Zuikučiai;2180165053;Taip;5;3;0;8
19976;Žaliakalnio;Zuikučiai;6823528666;Taip;15;1;0;16
19977;Žaliakalnio;Zuikučiai;3509064089;Taip;0;5;0;5
19978;Žaliakalnio;Zuikučiai;7000429934;Taip;0;4;0;4
19979;Žaliakalnio;Zuikučiai;5730610895;Taip;6;4;0;10
19980;Žaliakalnio;Zuikučiai;6881070397;Taip;0;6;0;6
19981;Žaliakalnio;Zuikučiai;8209559343;Taip;5;3;1;9
19982;Žaliakalnio;Zuikučiai;9799056285;Taip;0;4;0;4
19983;Žaliakalnio;Zuikučiai;1321592040;Ne;1;3;0;4
19984;Žaliakalnio;Zuikučiai;8298313285;Ne;0;2;0;2
19985;Žaliakalnio;Zuikučiai;9331287916;Taip;5;3;0;8
19986;Žaliakalnio;Zuikučiai;6726832258;Ne;0;4;0;4
19987;Žaliakalnio;Zuikučiai;4607456527;Taip;7;3;0;10
19988;Žaliakalnio;Zuikučiai;9363615751;Taip;5;5;0;10
19989;Žaliakalnio;Zuikučiai;6727442688;Ne;18;0;0;18
19990;Žaliakalnio;Bitutė;5744370516;Taip;5;1;0;6
19991;Žaliakalnio;Bitutė;3619817569;Taip;23;0;0;23
19992;Žaliakalnio;Bitutė;3905448562;Taip;3;12;0;15
19993;Žaliakalnio;Bitutė;8481665290;Taip;0;3;0;3
19994;Žaliakalnio;Bitutė;8950583202;Taip;2;0;1;3
19995;Žaliakalnio;Bitutė;6324315523;Taip;16;0;0;16
19996;Žaliakalnio;Bitutė;6877235095;Taip;8;0;0;8
19997;Žaliakalnio;Bitutė;2280683252;Ne;4;1;0;5
19998;Žaliakalnio;Bitutė;7711347723;Taip;0;2;0;2
19999;Žaliakalnio;Bitutė;4561672875;Taip;0;3;0;3
20000;Žaliakalnio;Bitutė;8185190219;Taip;9;0;0;9
20001;Žaliakalnio;Bitutė;7830692152;Taip;0;4;0;4
20002;Žaliakalnio;Bitutė;1423481154;Taip;3;3;0;6
20003;Žaliakalnio;Bitutė;4928400872;Taip;4;7;0;11
20004;Žaliakalnio;Bitutė;2613771302;Taip;15;0;0;15
20005;Žaliakalnio;Bitutė;3976548663;Taip;6;3;0;9
20006;Žaliakalnio;Bitutė;8599646291;Taip;0;0;1;1
20007;Žaliakalnio;Bitutė;1343293430;Taip;0;5;0;5
20008;Žaliakalnio;Bitutė;3721878250;Ne;0;4;2;6
20009;Žaliakalnio;Bitutė;6291287113;Taip;8;0;0;8
20010;Žaliakalnio;Bitutė;4412760433;Taip;13;0;1;14
20011;Žaliakalnio;Bitutė;7989372873;Ne;5;1;0;6
20012;Žaliakalnio;Bitutė;1173977434;Taip;2;1;0;3
20013;Žaliakalnio;Nykštukų;9069518153;Taip;0;4;0;4
20014;Žaliakalnio;Nykštukų;8142435757;Taip;6;1;0;7
20015;Žaliakalnio;Nykštukų;3446593135;Taip;10;1;0;11
20016;Žaliakalnio;Nykštukų;1064854294;Taip;6;9;0;15
20017;Žaliakalnio;Nykštukų;4891656355;Ne;0;3;0;3
20018;Žaliakalnio;Nykštukų;1632465983;Taip;12;7;0;19
20019;Žaliakalnio;Nykštukų;8472945857;Taip;0;2;0;2
20020;Žaliakalnio;Nykštukų;5565027085;Ne;2;1;0;3
20021;Žaliakalnio;Nykštukų;2242604156;Ne;0;3;0;3
20022;Žaliakalnio;Nykštukų;8852165484;Taip;10;0;0;10
20023;Žaliakalnio;Nykštukų;9801618806;Taip;5;1;0;6
20024;Žaliakalnio;Nykštukų;2225778044;Taip;7;2;0;9
20025;Žaliakalnio;Nykštukų;4255734788;Taip;15;0;0;15
20026;Žaliakalnio;Nykštukų;7793937917;Taip;0;6;0;6
20027;Žaliakalnio;Nykštukų;8117013474;Ne;5;3;0;8
20028;Žaliakalnio;Nykštukų;7205368281;Taip;1;6;0;7
20029;Žaliakalnio;Nykštukų;8360480591;Taip;3;1;10;14
20030;Žaliakalnio;Nykštukų;4036239701;Taip;10;0;0;10
20031;Žaliakalnio;Nykštukų;5258266970;Taip;12;0;0;12
20032;Žaliakalnio;Nykštukų;3041002600;Taip;2;2;0;4
20033;Žaliakalnio;ŽIOGELIAI;2426844621;Ne;0;1;0;1
20034;Žaliakalnio;ŽIOGELIAI;5752912101;Ne;3;1;0;4
20035;Žaliakalnio;ŽIOGELIAI;9967098834;Ne;0;3;0;3
20036;Žaliakalnio;ŽIOGELIAI;1133557422;Taip;0;5;0;5
20037;Žaliakalnio;ŽIOGELIAI;3464935314;Ne;0;6;0;6
20038;Žaliakalnio;ŽIOGELIAI;7648422668;Ne;0;7;0;7
20039;Žaliakalnio;ŽIOGELIAI;4702470511;Taip;0;7;0;7
20040;Žaliakalnio;ŽIOGELIAI;2272043654;Taip;0;5;0;5
20041;Žaliakalnio;ŽIOGELIAI;8518422934;Taip;0;3;0;3
20042;Žaliakalnio;ŽIOGELIAI;6674631040;Ne;9;0;0;9
20043;Žaliakalnio;ŽIOGELIAI;8245784590;Taip;19;0;0;19
20044;Žaliakalnio;ŽIOGELIAI;9485995178;Taip;0;8;0;8
20045;Žaliakalnio;ŽIOGELIAI;8383425712;Ne;0;5;0;5
20046;Žaliakalnio;ŽIOGELIAI;1309236035;Ne;0;23;0;23
20047;Žaliakalnio;ŽIOGELIAI;2514763739;Ne;0;5;0;5
20048;Žaliakalnio;ŽIOGELIAI;6294045755;Taip;10;2;0;12
20049;Žaliakalnio;ŽIOGELIAI;8232697563;Taip;5;3;0;8
20050;Žaliakalnio;ŽIOGELIAI;2694424532;Taip;0;7;0;7
20051;Žaliakalnio;ŽIOGELIAI;6136717862;Ne;0;3;0;3
20052;Žaliakalnio;ŽIOGELIAI;8316505307;Taip;0;1;0;1
20053;Žaliakalnio;SAULUTĖS;5602734465;Taip;0;12;0;12
20054;Žaliakalnio;SAULUTĖS;1253655689;Taip;6;0;0;6
20055;Žaliakalnio;SAULUTĖS;3016537413;Taip;0;1;0;1
20056;Žaliakalnio;SAULUTĖS;6795532166;Taip;9;0;0;9
20057;Žaliakalnio;SAULUTĖS;4154737541;Ne;8;1;0;9
20058;Žaliakalnio;SAULUTĖS;7913029369;Taip;3;0;0;3
20059;Žaliakalnio;SAULUTĖS;7793917852;Taip;6;0;3;9
20060;Žaliakalnio;SAULUTĖS;3018398546;Taip;3;3;0;6
20061;Žaliakalnio;SAULUTĖS;8765159796;Taip;18;0;0;18
20062;Žaliakalnio;SAULUTĖS;3028921540;Taip;7;3;0;10
20063;Žaliakalnio;SAULUTĖS;7636933790;Taip;20;3;0;23
20064;Žaliakalnio;SAULUTĖS;4355433666;Taip;5;5;0;10
20065;Žaliakalnio;SAULUTĖS;1975313368;Taip;23;0;0;23
20066;Žaliakalnio;SAULUTĖS;9016032548;Taip;0;4;0;4
20067;Žaliakalnio;SAULUTĖS;1715385224;Taip;0;7;0;7
20068;Žaliakalnio;SAULUTĖS;3304186400;Taip;0;12;0;12
20069;Žaliakalnio;SAULUTĖS;3434815790;Taip;6;1;0;7
20070;Žaliakalnio;SAULUTĖS;3832291926;Taip;4;0;0;4
20071;Žaliakalnio;SAULUTĖS;7071209465;Taip;10;2;0;12
20072;Žaliakalnio;SAULUTĖS;7543073516;Taip;0;10;0;10
20073;Žaliakalnio;SAULUTĖS;9379373983;Taip;0;4;0;4
20074;Volungė;Bitutės;6661730121;Taip;8;0;0;8
20075;Volungė;Bitutės;5791161943;Taip;4;0;9;13
20076;Volungė;Bitutės;3307326410;Taip;5;5;3;13
20077;Volungė;Bitutės;5300334761;Taip;0;1;0;1
20078;Volungė;Bitutės;6755366051;Taip;10;0;0;10
20079;Volungė;Bitutės;4013639324;Taip;0;0;10;10
20080;Volungė;Bitutės;8470433743;Taip;0;0;23;23
20081;Volungė;Bitutės;2599441104;Taip;0;0;6;6
20082;Volungė;Bitutės;5892600735;Taip;0;0;8;8
20083;Volungė;Bitutės;1902122510;Taip;6;3;1;10
20084;Volungė;Bitutės;1752817125;Taip;0;0;23;23
20085;Volungė;Bitutės;3515725398;Taip;7;3;1;11
20086;Volungė;Bitutės;3666364101;Taip;0;3;6;9
20087;Volungė;Bitutės;7151952679;Taip;0;3;5;8
20088;Volungė;Bitutės;5960027749;Taip;0;0;5;5
20089;Volungė;Bitutės;5149291935;Taip;5;0;0;5
20090;Volungė;Bitutės;8166517073;Taip;5;0;0;5
20091;Volungė;Bitutės;3106135598;Taip;0;8;1;9
20092;Volungė;Boružiukai;6431477042;Taip;0;0;2;2
20093;Volungė;Boružiukai;1137713075;Taip;6;5;0;11
20094;Volungė;Boružiukai;2322594823;Taip;0;8;0;8
20095;Volungė;Boružiukai;7965601199;Taip;0;3;0;3
20096;Volungė;Boružiukai;3746978206;Taip;0;0;1;1
20097;Volungė;Boružiukai;1528289101;Taip;0;0;2;2
20098;Volungė;Boružiukai;9188994935;Taip;0;16;0;16
20099;Volungė;Boružiukai;8285309230;Taip;0;3;1;4
20100;Volungė;Boružiukai;7149986415;Taip;0;0;4;4
20101;Volungė;Boružiukai;4598763851;Taip;0;3;1;4
20102;Volungė;Boružiukai;7867741556;Taip;6;2;0;8
20103;Volungė;Boružiukai;8459167833;Taip;0;8;1;9
20104;Volungė;Boružiukai;8784150784;Taip;0;13;0;13
20105;Volungė;Boružiukai;6028582927;Taip;5;6;0;11
20106;Volungė;Boružiukai;3832613221;Taip;10;6;1;17
20107;Volungė;Boružiukai;1757041481;Taip;8;0;3;11
20108;Volungė;Boružiukai;7971287899;Ne;0;0;5;5
20109;Volungė;Boružiukai;2627555750;Taip;0;0;1;1
20110;Volungė;Boružiukai;1974650443;Taip;0;0;3;3
20111;Volungė;Boružiukai;2068447339;Taip;0;0;12;12
20112;Volungė;Boružiukai;3528581949;Taip;5;0;9;14
20113;Volungė;Žvirbliukai;2360026330;Taip;0;0;3;3
20114;Volungė;Žvirbliukai;8414351815;Taip;0;0;4;4
20115;Volungė;Žvirbliukai;2051410463;Taip;5;0;11;16
20116;Volungė;Žvirbliukai;9575894080;Ne;7;0;3;10
20117;Volungė;Žvirbliukai;8927595898;Taip;13;0;0;13
20118;Volungė;Žvirbliukai;9384821249;Taip;5;0;0;5
20119;Volungė;Žvirbliukai;5361410157;Taip;0;0;5;5
20120;Volungė;Žvirbliukai;4235842588;Ne;0;0;3;3
20121;Volungė;Žvirbliukai;3028611395;Taip;0;8;0;8
20122;Volungė;Žvirbliukai;2949033093;Ne;5;0;2;7
20123;Volungė;Žvirbliukai;2159667991;Taip;5;0;8;13
20124;Volungė;Žvirbliukai;4337994278;Taip;0;0;10;10
20125;Volungė;Žvirbliukai;3282765504;Taip;0;0;6;6
20126;Volungė;Žiogeliai;6360834021;Taip;0;4;0;4
20127;Volungė;Žiogeliai;4856240879;Ne;5;0;4;9
20128;Volungė;Žiogeliai;4694016281;Taip;5;0;2;7
20129;Volungė;Žiogeliai;8640511964;Taip;0;0;6;6
20130;Volungė;Žiogeliai;5170536566;Taip;0;0;1;1
20131;Volungė;Žiogeliai;8421730419;Taip;9;0;5;14
20132;Volungė;Žiogeliai;6532202782;Taip;0;4;0;4
20133;Volungė;Žiogeliai;2712034356;Taip;0;3;4;7
20134;Volungė;Žiogeliai;2246291631;Taip;10;0;0;10
20135;Volungė;Žiogeliai;2456643081;Taip;3;0;4;7
20136;Volungė;Žiogeliai;6920821813;Taip;0;0;1;1
20137;Volungė;Žiogeliai;8299305464;Taip;0;0;17;17
20138;Volungė;Žiogeliai;1781838937;Taip;0;4;0;4
20139;Volungė;Žiogeliai;7859381467;Taip;0;23;0;23
20140;Volungė;Žiogeliai;3091641738;Ne;0;0;3;3
20141;Volungė;Žiogeliai;8578521969;Taip;4;3;0;7
20142;Volungė;Žiogeliai;5710662590;Taip;0;0;3;3
20143;Volungė;Žiogeliai;4839484528;Taip;5;3;0;8
20144;Volungė;Žiogeliai;5174427959;Taip;5;0;1;6
20145;Volungė;Žiogeliai;4726043862;Taip;0;8;1;9
20146;Volungė;Pelėdžiukai;2890377876;Taip;0;8;0;8
20147;Volungė;Pelėdžiukai;1099216923;Taip;0;3;10;13
20148;Volungė;Pelėdžiukai;3430719834;Taip;0;8;0;8
20149;Volungė;Pelėdžiukai;2420242319;Taip;0;3;0;3
20150;Volungė;Pelėdžiukai;7973680488;Taip;0;3;0;3
20151;Volungė;Pelėdžiukai;3356901662;Taip;13;0;0;13
20152;Volungė;Pelėdžiukai;1225378067;Taip;0;2;1;3
20153;Volungė;Pelėdžiukai;9629567682;Taip;0;0;3;3
20154;Volungė;Pelėdžiukai;1120682487;Taip;0;3;1;4
20155;Volungė;Pelėdžiukai;9082860913;Taip;0;0;4;4
20156;Volungė;Pelėdžiukai;8174587725;Taip;0;3;2;5
20157;Volungė;Pelėdžiukai;2187800215;Taip;0;1;0;1
20158;Volungė;Pelėdžiukai;7521910384;Taip;0;3;1;4
20159;Volungė;Pelėdžiukai;6565522808;Taip;0;3;0;3
20160;Volungė;Pelėdžiukai;9068889427;Taip;5;1;1;7
20161;Volungė;Pelėdžiukai;4123080241;Taip;0;1;11;12
20162;Volungė;Pelėdžiukai;8268202101;Taip;0;3;1;4
20163;Volungė;Pelėdžiukai;1366066359;Taip;0;8;1;9
20164;Volungė;Drugeliai;6280208510;Taip;0;5;0;5
20165;Volungė;Drugeliai;4032261812;Taip;6;0;6;12
20166;Volungė;Drugeliai;6488473384;Taip;5;0;6;11
20167;Volungė;Drugeliai;8045459660;Taip;14;0;0;14
20168;Volungė;Drugeliai;1402200673;Taip;14;0;0;14
20169;Volungė;Drugeliai;7574856429;Taip;10;0;1;11
20170;Volungė;Drugeliai;5284011092;Taip;0;0;1;1
20171;Volungė;Drugeliai;4427076715;Taip;10;3;0;13
20172;Volungė;Drugeliai;9729285419;Ne;0;2;8;10
20173;Volungė;Drugeliai;2686827560;Taip;0;0;3;3
20174;Volungė;Drugeliai;9973604148;Taip;0;0;1;1
20175;Volungė;Drugeliai;8905401944;Taip;0;0;14;14
20176;Volungė;Drugeliai;1164632050;Taip;0;0;1;1
20177;Volungė;Drugeliai;2923810441;Ne;0;0;7;7
20178;Volungė;Drugeliai;6782622442;Taip;5;0;5;10
20179;Volungė;Drugeliai;3020629341;Taip;5;0;1;6
20180;Volungė;Drugeliai;4252713086;Taip;0;0;11;11
20181;Volungė;Drugeliai;2530804242;Taip;0;0;1;1
20182;Volungė;Drugeliai;5354511593;Taip;11;0;3;14
20183;Volungė;Drugeliai;3150532451;Taip;10;0;2;12
20184;Volungė;Drugeliai;9343118795;Taip;2;0;3;5
20185;Volungė;Drugeliai;4745609424;Ne;5;0;3;8
20186;Volungė;Drugeliai;7584598377;Taip;13;0;4;17
20187;Volungė;"SKRUZDĖLIUKAI ";3394646139;Taip;10;0;1;11
20188;Volungė;"SKRUZDĖLIUKAI ";4223287277;Taip;4;0;0;4
20189;Volungė;"SKRUZDĖLIUKAI ";6464890465;Taip;10;0;5;15
20190;Volungė;"SKRUZDĖLIUKAI ";2493541457;Taip;15;0;5;20
20191;Volungė;"SKRUZDĖLIUKAI ";1948015523;Ne;4;0;1;5
20192;Volungė;"SKRUZDĖLIUKAI ";1101228927;Taip;10;0;3;13
20193;Volungė;"SKRUZDĖLIUKAI ";5332306628;Taip;0;0;10;10
20194;Volungė;"SKRUZDĖLIUKAI ";9319825151;Taip;1;0;15;16
20195;Volungė;"SKRUZDĖLIUKAI ";6370584522;Taip;0;6;0;6
20196;Volungė;"SKRUZDĖLIUKAI ";8168630107;Taip;0;5;5;10
20197;Volungė;"SKRUZDĖLIUKAI ";5833091791;Taip;5;0;1;6
20198;Volungė;"SKRUZDĖLIUKAI ";5994884455;Taip;9;0;0;9
20199;Volungė;"SKRUZDĖLIUKAI ";3818924175;Taip;5;0;0;5
20200;Volungė;"SKRUZDĖLIUKAI ";8244731771;Taip;0;0;3;3
20201;Volungė;"SKRUZDĖLIUKAI ";6110117105;Taip;9;0;4;13
20202;Volungė;"SKRUZDĖLIUKAI ";4944556574;Taip;13;0;1;14
20203;Volungė;"SKRUZDĖLIUKAI ";2212423676;Taip;10;0;3;13
20204;Volungė;"SKRUZDĖLIUKAI ";5942497397;Taip;10;0;7;17
20205;Volungė;"SKRUZDĖLIUKAI ";4991465781;Taip;9;0;0;9
20206;Volungė;"SKRUZDĖLIUKAI ";8613580206;Taip;6;0;1;7
20207;Volungė;Zylutės;4664635246;Ne;10;0;4;14
20208;Volungė;Zylutės;9382043452;Taip;8;0;0;8
20209;Volungė;Zylutės;1125730734;Taip;7;0;0;7
20210;Volungė;Zylutės;5650558154;Taip;10;0;0;10
20211;Volungė;Zylutės;5588544003;Taip;0;3;1;4
20212;Volungė;Zylutės;3758750922;Taip;10;3;7;20
20213;Volungė;Zylutės;2663288986;Taip;8;0;3;11
20214;Volungė;Zylutės;3460701723;Taip;0;0;1;1
20215;Volungė;Zylutės;9562426487;Taip;7;0;2;9
20216;Volungė;Zylutės;4136178027;Taip;8;1;0;9
20217;Volungė;Zylutės;5882826586;Ne;0;0;15;15
20218;Volungė;Zylutės;6969633765;Taip;0;0;1;1
20219;Volungė;Zylutės;6445614647;Taip;11;0;0;11
20220;Volungė;Zylutės;5561683986;Taip;6;0;3;9
20221;Giliukas;SMALSUČIAI;9134734376;Taip;7;0;1;8
20222;Giliukas;SMALSUČIAI;6742406486;Taip;7;0;0;7
20223;Giliukas;SMALSUČIAI;9556962586;Ne;0;0;4;4
20224;Giliukas;SMALSUČIAI;2840410579;Taip;0;0;5;5
20225;Giliukas;SMALSUČIAI;2378721717;Taip;2;0;0;2
20226;Giliukas;SMALSUČIAI;7316126011;Taip;0;0;2;2
20227;Giliukas;SMALSUČIAI;6203352124;Taip;3;0;0;3
20228;Giliukas;SMALSUČIAI;9704885611;Taip;0;2;1;3
20229;Giliukas;SMALSUČIAI;7993049824;Ne;8;0;0;8
20230;Giliukas;SMALSUČIAI;7412960823;Taip;0;0;1;1
20231;Giliukas;SMALSUČIAI;5452941895;Taip;0;0;8;8
20232;Giliukas;GUDRUČIAI;2335031800;Taip;0;3;0;3
20233;Giliukas;GUDRUČIAI;3847358328;Taip;0;4;0;4
20234;Giliukas;GUDRUČIAI;6165618131;Ne;0;12;0;12
20235;Giliukas;GUDRUČIAI;9608331265;Taip;4;2;0;6
20236;Giliukas;GUDRUČIAI;3691791222;Taip;9;0;0;9
20237;Giliukas;GUDRUČIAI;1870173947;Taip;10;0;2;12
20238;Giliukas;GUDRUČIAI;9644050818;Taip;0;4;1;5
20239;Giliukas;GUDRUČIAI;3983555939;Taip;7;3;0;10
20240;Giliukas;GUDRUČIAI;2951628295;Ne;0;5;0;5
20241;Giliukas;GUDRUČIAI;9408948207;Taip;0;4;0;4
20242;Giliukas;GUDRUČIAI;2003990493;Taip;0;5;1;6
20243;Giliukas;GUDRUČIAI;4960232685;Taip;9;0;0;9
20244;Giliukas;GUDRUČIAI;4916844983;Taip;0;3;0;3
20245;Giliukas;GUDRUČIAI;5787041097;Taip;18;0;0;18
20246;Giliukas;GUDRUČIAI;9458151965;Taip;0;0;2;2
20247;Giliukas;GUDRUČIAI;7159681896;Taip;1;11;0;12
20248;Giliukas;PABIRUČIAI;4183026763;Taip;8;0;1;9
20249;Giliukas;PABIRUČIAI;1221640023;Taip;5;0;0;5
20250;Giliukas;PABIRUČIAI;2362785562;Ne;15;3;0;18
20251;Giliukas;PABIRUČIAI;4247090684;Taip;0;1;2;3
20252;Giliukas;PABIRUČIAI;9824315755;Taip;20;0;0;20
20253;Giliukas;PABIRUČIAI;3054591644;Taip;0;0;3;3
20254;Giliukas;PABIRUČIAI;3870143024;Taip;9;1;0;10
20255;Giliukas;PABIRUČIAI;6914013230;Taip;4;0;0;4
20256;Giliukas;PABIRUČIAI;2512831288;Taip;8;0;0;8
20257;Giliukas;PABIRUČIAI;7013767174;Taip;3;0;0;3
20258;Giliukas;PABIRUČIAI;4810236703;Ne;0;0;1;1
20259;Giliukas;PABIRUČIAI;4105974682;Taip;7;0;0;7
20260;Giliukas;PABIRUČIAI;8874804636;Taip;0;2;0;2
20261;Giliukas;ŠVELNUKAI;7402797271;Taip;7;0;4;11
20262;Giliukas;ŠVELNUKAI;9270743786;Taip;4;0;3;7
20263;Giliukas;ŠVELNUKAI;5834233526;Taip;23;0;0;23
20264;Giliukas;ŠVELNUKAI;5000654626;Taip;5;0;0;5
20265;Giliukas;ŠVELNUKAI;8973584424;Taip;7;0;1;8
20266;Giliukas;ŠVELNUKAI;2881704755;Taip;3;0;0;3
20267;Giliukas;ŠVELNUKAI;3238820351;Taip;5;0;0;5
20268;Giliukas;ŽINIUKAI;6422178450;Taip;0;3;3;6
20269;Giliukas;ŽINIUKAI;2502801547;Taip;11;3;0;14
20270;Giliukas;ŽINIUKAI;9617542456;Taip;0;21;0;21
20271;Giliukas;ŽINIUKAI;2562809633;Taip;8;4;0;12
20272;Giliukas;ŽINIUKAI;5326178821;Ne;0;13;0;13
20273;Giliukas;ŽINIUKAI;2692141913;Taip;21;0;0;21
20274;Giliukas;ŽINIUKAI;9152432124;Taip;15;0;0;15
20275;Giliukas;ŽINIUKAI;4854370266;Taip;0;4;0;4
20276;Giliukas;ŽINIUKAI;6703080106;Taip;13;2;0;15
20277;Giliukas;ŽINIUKAI;3150981084;Ne;10;5;1;16
20278;Giliukas;ŽINIUKAI;6134554678;Taip;9;4;0;13
20279;Giliukas;ŽINIUKAI;6338583515;Taip;3;4;0;7
20280;Giliukas;ŽINIUKAI;2064182165;Taip;12;0;0;12
20281;Giliukas;ŽINIUKAI;5201020765;Taip;17;3;0;20
20282;Giliukas;ŽINIUKAI;2042324002;Taip;0;2;0;2
20283;Giliukas;ŽINIUKAI;3137768675;Taip;6;3;0;9
20284;Giliukas;ŽINIUKAI;3718774263;Taip;5;0;0;5
20285;Giliukas;MYLIMUKAI;7205807049;Taip;8;1;9;18
20286;Giliukas;MYLIMUKAI;1165810193;Taip;8;1;9;18
20287;Giliukas;MYLIMUKAI;3055598917;Taip;0;2;1;3
20288;Giliukas;MYLIMUKAI;6953123617;Taip;0;10;0;10
20289;Giliukas;MYLIMUKAI;4207939009;Taip;0;0;1;1
20290;Giliukas;MYLIMUKAI;2742106493;Taip;6;3;0;9
20291;Giliukas;MYLIMUKAI;1916905497;Taip;9;0;0;9
20292;Giliukas;MYLIMUKAI;7053406257;Taip;10;0;2;12
20293;Giliukas;MYLIMUKAI;5222092567;Taip;14;0;0;14
20294;Giliukas;MYLIMUKAI;4581414740;Ne;15;1;1;17
20295;Giliukas;MYLIMUKAI;2226855971;Taip;0;0;6;6
20296;Giliukas;MYLIMUKAI;7431116067;Taip;17;0;0;17
20297;Giliukas;MYLIMUKAI;5298822890;Taip;7;1;0;8
20298;Giliukas;MYLIMUKAI;3726149759;Taip;7;0;2;9
20299;Giliukas;MYLIMUKAI;5300517567;Ne;0;10;0;10
20300;Giliukas;MYLIMUKAI;5625404051;Taip;9;0;1;10
20301;Giliukas;MYLIMUKAI;9224387185;Taip;0;23;0;23
20302;Giliukas;ČIAUŠKUČIAI;1762536884;Taip;10;0;0;10
20303;Giliukas;ČIAUŠKUČIAI;8701216181;Taip;13;0;0;13
20304;Giliukas;ČIAUŠKUČIAI;7646966187;Taip;10;0;0;10
20305;Giliukas;ČIAUŠKUČIAI;2801731379;Taip;0;3;0;3
20306;Giliukas;ČIAUŠKUČIAI;8499893356;Ne;13;2;0;15
20307;Giliukas;ČIAUŠKUČIAI;9205911152;Taip;18;0;0;18
20308;Giliukas;ČIAUŠKUČIAI;3720032249;Taip;7;0;0;7
20309;Giliukas;ČIAUŠKUČIAI;3659105022;Ne;0;10;0;10
20310;Giliukas;ČIAUŠKUČIAI;4940718205;Ne;10;2;0;12
20311;Giliukas;ČIAUŠKUČIAI;8491008130;Ne;6;1;0;7
20312;Giliukas;ČIAUŠKUČIAI;4163383707;Taip;6;3;0;9
20313;Giliukas;ČIAUŠKUČIAI;2612551188;Taip;13;0;0;13
20314;Giliukas;ČIAUŠKUČIAI;9366734581;Taip;4;2;0;6
20315;Giliukas;ČIAUŠKUČIAI;9462634699;Taip;10;0;0;10
20316;Giliukas;ČIAUŠKUČIAI;8106782330;Taip;3;0;1;4
20317;Giliukas;ČIAUŠKUČIAI;9274289812;Taip;3;0;0;3
20318;Giliukas;ČIAUŠKUČIAI;1332725572;Taip;13;3;0;16
20319;Giliukas;ŠNEKUČIAI;9229086918;Taip;12;0;3;15
20320;Giliukas;ŠNEKUČIAI;3274313536;Ne;4;0;4;8
20321;Giliukas;ŠNEKUČIAI;9287193955;Taip;6;6;0;12
20322;Giliukas;ŠNEKUČIAI;5527212334;Taip;10;0;2;12
20323;Giliukas;ŠNEKUČIAI;9499591494;Taip;2;0;0;2
20324;Giliukas;ŠNEKUČIAI;2099575372;Taip;5;0;4;9
20325;Giliukas;ŠNEKUČIAI;6157459742;Taip;9;0;3;12
20326;Giliukas;ŠNEKUČIAI;4258921446;Taip;9;0;1;10
20327;Giliukas;ŠNEKUČIAI;1439350058;Taip;14;0;0;14
20328;Giliukas;ŠNEKUČIAI;4843920452;Taip;15;0;0;15
20329;Giliukas;ŠNEKUČIAI;2004782696;Taip;5;0;2;7
20330;Giliukas;ŠNEKUČIAI;8977247073;Taip;1;0;1;2
20331;Giliukas;ŠNEKUČIAI;8147492951;Taip;5;0;6;11
20332;Giliukas;ŠNEKUČIAI;2349166172;Taip;17;0;0;17
20333;Giliukas;ŠNEKUČIAI;8241215831;Taip;18;0;0;18
20334;Giliukas;ŠNEKUČIAI;9475918013;Taip;9;0;1;10
20335;Giliukas;ŠNEKUČIAI;7944198886;Taip;10;0;0;10
20336;"Lazdynų mokykla (Žėručio g. 4)";Drugeliai;4520091712;Taip;0;0;2;2
20337;"Lazdynų mokykla (Žėručio g. 4)";Drugeliai;8472834181;Taip;5;2;0;7
20338;"Lazdynų mokykla (Žėručio g. 4)";Drugeliai;9196184984;Taip;15;0;0;15
20339;"Lazdynų mokykla (Žėručio g. 4)";Drugeliai;2469486746;Taip;0;2;0;2
20340;"Lazdynų mokykla (Žėručio g. 4)";Drugeliai;6394098306;Taip;10;0;6;16
20341;"Lazdynų mokykla (Žėručio g. 4)";Drugeliai;2027751624;Taip;0;3;0;3
20342;"Lazdynų mokykla (Žėručio g. 4)";Drugeliai;2767732459;Ne;8;3;0;11
20343;"Lazdynų mokykla (Žėručio g. 4)";Drugeliai;5902104981;Taip;5;7;0;12
20344;"Lazdynų mokykla (Žėručio g. 4)";Drugeliai;7590111138;Taip;5;2;0;7
20345;"Lazdynų mokykla (Žėručio g. 4)";Drugeliai;7524849851;Taip;2;2;2;6
20346;"Lazdynų mokykla (Žėručio g. 4)";Drugeliai;1951041742;Ne;7;7;0;14
20347;"Lazdynų mokykla (Žėručio g. 4)";Drugeliai;9309081745;Taip;20;0;1;21
20348;"Lazdynų mokykla (Žėručio g. 4)";Drugeliai;8650496265;Taip;0;0;2;2
20349;"Lazdynų mokykla (Žėručio g. 4)";Drugeliai;8001610972;Ne;10;1;0;11
20350;"Lazdynų mokykla (Žėručio g. 4)";Drugeliai;4684618253;Taip;13;0;0;13
20351;"Lazdynų mokykla (Žėručio g. 4)";Drugeliai;6658025277;Ne;12;0;0;12
20352;"Lazdynų mokykla (Žėručio g. 4)";Drugeliai;7074859809;Taip;14;1;3;18
20353;"Lazdynų mokykla (Žėručio g. 4)";Drugeliai;4097980299;Ne;6;1;0;7
20354;"Lazdynų mokykla (Žėručio g. 4)";Zuikučiai;3435025978;Taip;0;0;9;9
20355;"Lazdynų mokykla (Žėručio g. 4)";Zuikučiai;8899186547;Taip;15;0;4;19
20356;"Lazdynų mokykla (Žėručio g. 4)";Zuikučiai;5465094647;Taip;0;6;0;6
20357;"Lazdynų mokykla (Žėručio g. 4)";Zuikučiai;1044630813;Taip;0;3;0;3
20358;"Lazdynų mokykla (Žėručio g. 4)";Zuikučiai;3268305561;Taip;5;1;0;6
20359;"Lazdynų mokykla (Žėručio g. 4)";Zuikučiai;3535244441;Taip;5;2;1;8
20360;"Lazdynų mokykla (Žėručio g. 4)";Zuikučiai;3265099747;Taip;0;0;1;1
20361;"Lazdynų mokykla (Žėručio g. 4)";Zuikučiai;1336503878;Ne;19;0;0;19
20362;"Lazdynų mokykla (Žėručio g. 4)";Zuikučiai;5181200460;Taip;12;0;0;12
20363;"Lazdynų mokykla (Žėručio g. 4)";Zuikučiai;8669630986;Ne;18;1;0;19
20364;"Lazdynų mokykla (Žėručio g. 4)";Zuikučiai;3715070791;Taip;5;2;1;8
20365;"Lazdynų mokykla (Žėručio g. 4)";Zuikučiai;7232402011;Taip;6;3;0;9
20366;"Lazdynų mokykla (Žėručio g. 4)";Zuikučiai;3302443490;Taip;10;2;0;12
20367;"Lazdynų mokykla (Žėručio g. 4)";Zuikučiai;7000921682;Taip;4;1;0;5
20368;"Lazdynų mokykla (Žėručio g. 4)";Zuikučiai;7229926614;Taip;7;0;0;7
20369;"Lazdynų mokykla (Žėručio g. 4)";Zuikučiai;2624013880;Taip;16;0;0;16
20370;"Lazdynų mokykla (Žėručio g. 4)";RUPG;6038907328;Taip;5;3;0;8
20371;"Lazdynų mokykla (Žėručio g. 4)";RUPG;4086774324;Taip;0;23;0;23
20372;"Lazdynų mokykla (Žėručio g. 4)";RUPG;6070629454;Taip;0;23;0;23
20373;"Lazdynų mokykla (Žėručio g. 4)";RUPG;1118653070;Ne;3;3;0;6
20374;"Lazdynų mokykla (Žėručio g. 4)";RUPG;3367804873;Ne;3;4;0;7
20375;"Lazdynų mokykla (Žėručio g. 4)";RUPG;5806696915;Taip;0;3;1;4
20376;"Lazdynų mokykla (Žėručio g. 4)";RUPG;2209697834;Taip;8;3;5;16
20377;"Lazdynų mokykla (Žėručio g. 4)";RUPG;6638804854;Ne;0;23;0;23
20378;"Lazdynų mokykla (Žėručio g. 4)";RUPG;3634678954;Taip;0;3;0;3
20379;"Lazdynų mokykla (Žėručio g. 4)";RUPG;1910570858;Taip;8;3;0;11
20380;"Lazdynų mokykla (Žėručio g. 4)";RUPG;8318567916;Taip;8;4;0;12
20381;"Lazdynų mokykla (Žėručio g. 4)";RUPG;5982019255;Taip;5;3;0;8
20382;"Lazdynų mokykla (Žėručio g. 4)";RUPG;2160440145;Taip;20;3;0;23
20383;"Lazdynų mokykla (Žėručio g. 4)";RUPG;1025406111;Taip;0;3;2;5
20384;"Lazdynų mokykla (Žėručio g. 4)";RUPG;5095782784;Taip;14;3;0;17
20385;"Lazdynų mokykla (Žėručio g. 4)";LEPG;9656050113;Taip;5;3;0;8
20386;"Lazdynų mokykla (Žėručio g. 4)";LEPG;6822686126;Taip;0;3;1;4
20387;"Lazdynų mokykla (Žėručio g. 4)";LEPG;2070196225;Taip;0;3;0;3
20388;"Lazdynų mokykla (Žėručio g. 4)";LEPG;2613078582;Taip;5;6;0;11
20389;"Lazdynų mokykla (Žėručio g. 4)";LEPG;7059075747;Taip;0;3;1;4
20390;"Lazdynų mokykla (Žėručio g. 4)";LEPG;5438716880;Taip;4;3;0;7
20391;"Lazdynų mokykla (Žėručio g. 4)";LEPG;7487278074;Taip;0;3;3;6
20392;"Lazdynų mokykla (Žėručio g. 4)";LEPG;7320049068;Taip;8;3;0;11
20393;"Lazdynų mokykla (Žėručio g. 4)";LEPG;1396367371;Taip;3;3;2;8
20394;"Lazdynų mokykla (Žėručio g. 4)";LEPG;7324846434;Taip;0;3;0;3
20395;"Lazdynų mokykla (Žėručio g. 4)";LEPG;1532248269;Taip;0;3;0;3
20396;"Lazdynų mokykla (Žėručio g. 4)";LEPG;3675401775;Taip;0;3;1;4
20397;"Lazdynų mokykla (Žėručio g. 4)";LEPG;6794153377;Taip;13;3;1;17
20398;"Lazdynų mokykla (Žėručio g. 4)";LEPG;2825614921;Ne;5;3;0;8
20399;"Lazdynų mokykla (Žėručio g. 4)";LEPG;8866490265;Taip;5;3;1;9
20400;"Lazdynų mokykla (Žėručio g. 4)";LEPG;9592456683;Taip;5;6;0;11
20401;"Lazdynų mokykla (Žėručio g. 4)";LEPG;6117542654;Taip;1;3;0;4
20402;"Lazdynų mokykla (Žėručio g. 4)";LEPG;4149212470;Taip;0;3;1;4
20403;"Lazdynų mokykla (Žėručio g. 4)";LEPG;8324750958;Ne;6;3;1;10
20404;"Lazdynų mokykla (Žėručio g. 4)";LEPG;7659209862;Taip;11;3;0;14
20405;"Lazdynų mokykla (Žėručio g. 4)";RUPG;3631150576;Taip;0;3;0;3
20406;"Lazdynų mokykla (Žėručio g. 4)";RUPG;5015519090;Taip;8;3;3;14
20407;"Lazdynų mokykla (Žėručio g. 4)";RUPG;1745679183;Taip;10;3;0;13
20408;"Lazdynų mokykla (Žėručio g. 4)";RUPG;9255723192;Ne;0;3;3;6
20409;"Lazdynų mokykla (Žėručio g. 4)";RUPG;9639587601;Taip;0;3;0;3
20410;"Lazdynų mokykla (Žėručio g. 4)";RUPG;4087148273;Taip;1;3;1;5
20411;"Lazdynų mokykla (Žėručio g. 4)";RUPG;2740942924;Taip;7;3;0;10
20412;"Lazdynų mokykla (Žėručio g. 4)";RUPG;2700475528;Taip;7;3;0;10
20413;"Lazdynų mokykla (Žėručio g. 4)";RUPG;7180617984;Ne;0;3;1;4
20414;"Lazdynų mokykla (Žėručio g. 4)";RUPG;4023257875;Taip;9;3;0;12
20415;"Lazdynų mokykla (Žėručio g. 4)";RUPG;2308739823;Taip;0;3;1;4
20416;"Lazdynų mokykla (Žėručio g. 4)";RUPG;9123178095;Taip;0;7;0;7
20417;"Lazdynų mokykla (Žėručio g. 4)";RUPG;3000676765;Taip;0;3;2;5
20418;"Lazdynų mokykla (Žėručio g. 4)";RUPG;9968637187;Taip;7;3;1;11
20419;"Lazdynų mokykla (Žėručio g. 4)";RUPG;8886654664;Taip;15;3;0;18
20420;"„Atžalyno” mokykla-darželis";Giliukai;1579954367;Taip;0;3;6;9
20421;"„Atžalyno” mokykla-darželis";Giliukai;9655000018;Taip;0;3;0;3
20422;"„Atžalyno” mokykla-darželis";Giliukai;8826921260;Ne;4;3;0;7
20423;"„Atžalyno” mokykla-darželis";Giliukai;2773253032;Taip;0;3;1;4
20424;"„Atžalyno” mokykla-darželis";Giliukai;3170216428;Taip;0;3;2;5
20425;"„Atžalyno” mokykla-darželis";Giliukai;4345420422;Taip;0;1;2;3
20426;"„Atžalyno” mokykla-darželis";Giliukai;2772290605;Taip;9;3;0;12
20427;"„Atžalyno” mokykla-darželis";Giliukai;5596753512;Taip;0;3;1;4
20428;"„Atžalyno” mokykla-darželis";Giliukai;1958519966;Ne;0;3;3;6
20429;"„Atžalyno” mokykla-darželis";Giliukai;9806203065;Ne;5;3;2;10
20430;"„Atžalyno” mokykla-darželis";Giliukai;8688627865;Ne;0;3;0;3
20431;"„Atžalyno” mokykla-darželis";Giliukai;2601122166;Taip;12;0;0;12
20432;"„Atžalyno” mokykla-darželis";Giliukai;3529875728;Taip;0;3;0;3
20433;"„Atžalyno” mokykla-darželis";Giliukai;1311162040;Taip;0;2;0;2
20434;"„Atžalyno” mokykla-darželis";Giliukai;4427232735;Taip;0;3;3;6
20435;"„Atžalyno” mokykla-darželis";Giliukai;9013323901;Ne;0;3;2;5
20436;"„Atžalyno” mokykla-darželis";Giliukai;5503766544;Taip;0;3;0;3
20437;"„Atžalyno” mokykla-darželis";Giliukai;5030879885;Taip;9;3;4;16
20438;"„Atžalyno” mokykla-darželis";Riešutėliai;4360099345;Taip;13;4;0;17
20439;"„Atžalyno” mokykla-darželis";Riešutėliai;5947938371;Ne;11;0;6;17
20440;"„Atžalyno” mokykla-darželis";Riešutėliai;5384245347;Taip;0;9;0;9
20441;"„Atžalyno” mokykla-darželis";Riešutėliai;4246430352;Taip;16;0;5;21
20442;"„Atžalyno” mokykla-darželis";Riešutėliai;8574494664;Ne;1;7;1;9
20443;"„Atžalyno” mokykla-darželis";Riešutėliai;5815412814;Taip;0;1;0;1
20444;"„Atžalyno” mokykla-darželis";Riešutėliai;4161658496;Ne;8;4;0;12
20445;"„Atžalyno” mokykla-darželis";Riešutėliai;8942132574;Taip;12;4;0;16
20446;"„Atžalyno” mokykla-darželis";Riešutėliai;3564781987;Taip;0;1;0;1
20447;"„Atžalyno” mokykla-darželis";Riešutėliai;7109850241;Taip;0;16;4;20
20448;"„Atžalyno” mokykla-darželis";Riešutėliai;7368616441;Ne;5;0;9;14
20449;"„Atžalyno” mokykla-darželis";Riešutėliai;5709028342;Taip;20;0;0;20
20450;"„Atžalyno” mokykla-darželis";Riešutėliai;8803555426;Ne;3;2;1;6
20451;"„Atžalyno” mokykla-darželis";Riešutėliai;5994983369;Ne;5;1;0;6
20452;"„Atžalyno” mokykla-darželis";Riešutėliai;1041363325;Taip;0;1;15;16
20453;"„Atžalyno” mokykla-darželis";Riešutėliai;7676614240;Taip;0;0;4;4
20454;"„Atžalyno” mokykla-darželis";Riešutėliai;3751729666;Taip;6;0;4;10
20455;"„Atžalyno” mokykla-darželis";Riešutėliai;3441950153;Taip;14;0;4;18
20456;"„Atžalyno” mokykla-darželis";Riešutėliai;4223591454;Taip;0;4;3;7
20457;"„Atžalyno” mokykla-darželis";Žirniukai;6903825217;Taip;11;10;0;21
20458;"„Atžalyno” mokykla-darželis";Žirniukai;9101301819;Ne;3;0;7;10
20459;"„Atžalyno” mokykla-darželis";Žirniukai;6602037942;Taip;0;0;1;1
20460;"„Atžalyno” mokykla-darželis";Žirniukai;7579781779;Taip;8;6;0;14
20461;"„Atžalyno” mokykla-darželis";Žirniukai;1915676392;Ne;8;0;8;16
20462;"„Atžalyno” mokykla-darželis";Žirniukai;7669725276;Taip;3;14;0;17
20463;"„Atžalyno” mokykla-darželis";Žirniukai;5986664970;Taip;4;13;0;17
20464;"„Atžalyno” mokykla-darželis";Žirniukai;9913048992;Taip;5;8;2;15
20465;"„Atžalyno” mokykla-darželis";Žirniukai;4616870552;Taip;0;0;3;3
20466;"„Atžalyno” mokykla-darželis";Žirniukai;4107946143;Taip;0;9;0;9
20467;"„Atžalyno” mokykla-darželis";Žirniukai;7883570492;Ne;0;10;0;10
20468;"„Atžalyno” mokykla-darželis";Žirniukai;8320161812;Taip;0;13;6;19
20469;"„Atžalyno” mokykla-darželis";Žirniukai;5335059675;Taip;0;2;1;3
20470;"„Atžalyno” mokykla-darželis";Žirniukai;6922776405;Taip;0;1;16;17
20471;"„Atžalyno” mokykla-darželis";Žirniukai;9690554753;Taip;7;0;8;15
20472;"„Atžalyno” mokykla-darželis";Žirniukai;1961428224;Ne;17;0;4;21
20473;"„Atžalyno” mokykla-darželis";Žirniukai;8070499557;Taip;8;8;0;16
20474;"„Atžalyno” mokykla-darželis";Žirniukai;2446697763;Taip;8;0;3;11
20475;"„Atžalyno” mokykla-darželis";Žirniukai;2462839180;Taip;0;0;1;1
20476;"„Atžalyno” mokykla-darželis";Žirniukai;4784990018;Taip;3;13;0;16
20477;"„Atžalyno” mokykla-darželis";VYŠNIUKAI;6120955217;Ne;7;0;2;9
20478;"„Atžalyno” mokykla-darželis";VYŠNIUKAI;1787256844;Ne;10;0;5;15
20479;"„Atžalyno” mokykla-darželis";VYŠNIUKAI;2547003287;Ne;10;0;5;15
20480;"„Atžalyno” mokykla-darželis";VYŠNIUKAI;4503448206;Taip;4;4;5;13
20481;"„Atžalyno” mokykla-darželis";VYŠNIUKAI;3664056583;Taip;0;11;1;12
20482;"„Atžalyno” mokykla-darželis";VYŠNIUKAI;5456248305;Taip;17;0;1;18
20483;"„Atžalyno” mokykla-darželis";VYŠNIUKAI;3719072139;Taip;5;4;0;9
20484;"„Atžalyno” mokykla-darželis";VYŠNIUKAI;9245994735;Taip;10;9;0;19
20485;"„Atžalyno” mokykla-darželis";VYŠNIUKAI;3770167696;Taip;3;3;9;15
20486;"„Atžalyno” mokykla-darželis";VYŠNIUKAI;2000352986;Taip;5;0;2;7
20487;"„Atžalyno” mokykla-darželis";VYŠNIUKAI;2177213062;Taip;4;19;0;23
20488;"„Atžalyno” mokykla-darželis";VYŠNIUKAI;4635394632;Ne;14;4;0;18
20489;"„Atžalyno” mokykla-darželis";VYŠNIUKAI;3524131672;Taip;7;0;4;11
20490;"„Atžalyno” mokykla-darželis";VYŠNIUKAI;4840490901;Taip;17;4;1;22
20491;"„Atžalyno” mokykla-darželis";VYŠNIUKAI;4796052680;Taip;14;0;1;15
20492;"„Atžalyno” mokykla-darželis";VYŠNIUKAI;3181675972;Taip;7;0;3;10
20493;"„Atžalyno” mokykla-darželis";VYŠNIUKAI;8163063211;Taip;6;0;1;7
20494;"„Atžalyno” mokykla-darželis";VYŠNIUKAI;4431437971;Taip;17;3;0;20
20495;"„Atžalyno” mokykla-darželis";PIPIRIUKAI;8357021249;Ne;0;11;0;11
20496;"„Atžalyno” mokykla-darželis";PIPIRIUKAI;4582284727;Taip;0;3;0;3
20497;"„Atžalyno” mokykla-darželis";PIPIRIUKAI;4785607785;Ne;0;0;2;2
20498;"„Atžalyno” mokykla-darželis";PIPIRIUKAI;5615246040;Taip;0;0;5;5
20499;"„Atžalyno” mokykla-darželis";PIPIRIUKAI;1988657552;Taip;11;0;1;12
20500;"„Atžalyno” mokykla-darželis";PIPIRIUKAI;6721771665;Ne;0;3;0;3
20501;"„Atžalyno” mokykla-darželis";PIPIRIUKAI;7946139474;Taip;0;0;6;6
20502;"„Atžalyno” mokykla-darželis";PIPIRIUKAI;2108706876;Taip;9;0;4;13
20503;"„Atžalyno” mokykla-darželis";PIPIRIUKAI;1228919159;Taip;5;6;0;11
20504;"„Atžalyno” mokykla-darželis";PIPIRIUKAI;3919301151;Taip;10;0;1;11
20505;"„Atžalyno” mokykla-darželis";PIPIRIUKAI;3624299098;Taip;0;4;3;7
20506;"„Atžalyno” mokykla-darželis";PIPIRIUKAI;2537063401;Taip;0;3;3;6
20507;"„Atžalyno” mokykla-darželis";PIPIRIUKAI;4166521512;Taip;10;0;4;14
20508;"„Atžalyno” mokykla-darželis";PIPIRIUKAI;8372179128;Taip;0;3;0;3
20509;"„Atžalyno” mokykla-darželis";PIPIRIUKAI;3204191459;Taip;15;3;0;18
20510;"„Atžalyno” mokykla-darželis";PIPIRIUKAI;3015863723;Taip;5;0;0;5
20511;"„Atžalyno” mokykla-darželis";PIPIRIUKAI;3323233525;Taip;5;0;0;5
20512;"„Atžalyno” mokykla-darželis";PIPIRIUKAI;4596770586;Taip;4;4;1;9
20513;"„Atžalyno” mokykla-darželis";PIPIRIUKAI;7652421432;Taip;0;4;0;4
20514;"Vilniaus Naujininkų mokykla";"SAULĖS ZUIKUČIAI";1096474672;Taip;0;3;0;3
20515;"Vilniaus Naujininkų mokykla";"SAULĖS ZUIKUČIAI";9856315057;Ne;0;3;0;3
20516;"Vilniaus Naujininkų mokykla";"SAULĖS ZUIKUČIAI";6894804166;Taip;0;19;0;19
20517;"Vilniaus Naujininkų mokykla";"SAULĖS ZUIKUČIAI";3192556582;Taip;0;13;0;13
20518;"Vilniaus Naujininkų mokykla";"SAULĖS ZUIKUČIAI";1901250406;Ne;0;4;1;5
20519;"Vilniaus Naujininkų mokykla";"SAULĖS ZUIKUČIAI";1041144226;Ne;20;0;0;20
20520;"Vilniaus Naujininkų mokykla";"SAULĖS ZUIKUČIAI";9427388681;Taip;0;3;0;3
20521;"Vilniaus Naujininkų mokykla";"SAULĖS ZUIKUČIAI";5512321795;Taip;0;4;0;4
20522;"Vilniaus Naujininkų mokykla";"SAULĖS ZUIKUČIAI";9411054207;Ne;0;6;0;6
20523;"Vilniaus Naujininkų mokykla";"SAULĖS ZUIKUČIAI";3810550099;Taip;0;9;0;9
20524;"Vilniaus Naujininkų mokykla";"SAULĖS ZUIKUČIAI";7692387379;Taip;10;0;1;11
20525;"Vilniaus Naujininkų mokykla";"SAULĖS ZUIKUČIAI";8935072613;Taip;5;3;1;9
20526;"Vilniaus Naujininkų mokykla";"SAULĖS ZUIKUČIAI";9544088525;Ne;4;4;0;8
20527;"Vilniaus Naujininkų mokykla";"SAULĖS ZUIKUČIAI";9488762308;Taip;5;3;11;19
20528;"Vilniaus Naujininkų mokykla";"SAULĖS ZUIKUČIAI";2437553321;Ne;0;0;23;23
20529;"Vilniaus Naujininkų mokykla";"SAULĖS ZUIKUČIAI";5148002236;Taip;0;3;0;3
20530;"Vilniaus Naujininkų mokykla";SMALSUČIAI;2428447892;Taip;0;4;1;5
20531;"Vilniaus Naujininkų mokykla";SMALSUČIAI;1224054771;Taip;0;4;0;4
20532;"Vilniaus Naujininkų mokykla";SMALSUČIAI;79174984189;Taip;0;0;2;2
20533;"Vilniaus Naujininkų mokykla";SMALSUČIAI;1662993666;Taip;0;4;0;4
20534;"Vilniaus Naujininkų mokykla";SMALSUČIAI;7144596269;Ne;12;4;2;18
20535;"Vilniaus Naujininkų mokykla";SMALSUČIAI;6362889550;Taip;5;9;0;14
20536;"Vilniaus Naujininkų mokykla";SMALSUČIAI;1980755137;Taip;3;4;3;10
20537;"Vilniaus Naujininkų mokykla";SMALSUČIAI;1920917916;Taip;8;4;0;12
20538;"Vilniaus Naujininkų mokykla";SMALSUČIAI;8828658544;Ne;0;3;0;3
20539;"Vilniaus Naujininkų mokykla";SMALSUČIAI;5633127620;Taip;3;4;6;13
20540;"Vilniaus Naujininkų mokykla";SMALSUČIAI;3867799187;Taip;4;4;3;11
20541;"Vilniaus Naujininkų mokykla";SMALSUČIAI;1350744949;Taip;10;4;5;19
20542;"Vilniaus Naujininkų mokykla";SMALSUČIAI;63557632023;Taip;16;1;0;17
20543;"Vilniaus Naujininkų mokykla";SMALSUČIAI;8280826634;Ne;0;4;6;10
20544;"Vilniaus Naujininkų mokykla";SMALSUČIAI;5302103644;Ne;0;11;0;11
20545;"Vilniaus Naujininkų mokykla";SMALSUČIAI;5638817349;Taip;0;4;1;5
20546;"Vilniaus Naujininkų mokykla";SMALSUČIAI;1880254518;Taip;11;1;0;12
20547;"Vilniaus Karaliaus Mindaugo pagrindinė mokykla";"PUG 2";8957131694;Taip;13;0;0;13
20548;"Vilniaus Karaliaus Mindaugo pagrindinė mokykla";"PUG 2";1159232792;Taip;3;0;6;9
20549;"Vilniaus Karaliaus Mindaugo pagrindinė mokykla";"PUG 2";2248658930;Taip;6;0;2;8
20550;"Vilniaus Karaliaus Mindaugo pagrindinė mokykla";"PUG 2";47454787439;Taip;0;0;2;2
20551;"Vilniaus Karaliaus Mindaugo pagrindinė mokykla";"PUG 2";2092637040;Taip;11;0;3;14
20552;"Vilniaus Karaliaus Mindaugo pagrindinė mokykla";"PUG 2";5029631107;Taip;0;0;1;1
20553;"Vilniaus Karaliaus Mindaugo pagrindinė mokykla";"PUG 2";6196554287;Taip;0;1;1;2
20554;"Vilniaus Karaliaus Mindaugo pagrindinė mokykla";"PUG 2";4661051023;Taip;0;3;5;8
20555;"Vilniaus Karaliaus Mindaugo pagrindinė mokykla";"PUG 2";1507200600;Taip;0;3;3;6
20556;"Vilniaus Karaliaus Mindaugo pagrindinė mokykla";"PUG 2";7440474403;Taip;0;0;4;4
20557;"Vilniaus Karaliaus Mindaugo pagrindinė mokykla";"PUG 2";8860314164;Taip;3;3;0;6
20558;"Vilniaus Karaliaus Mindaugo pagrindinė mokykla";"PUG 2";4684525618;Taip;5;0;0;5
20559;"Vilniaus Karaliaus Mindaugo pagrindinė mokykla";"PUG 2";2876837284;Ne;0;0;2;2
20560;"Vilniaus Karaliaus Mindaugo pagrindinė mokykla";"PUG 1";3860781857;Taip;0;10;2;12
20561;"Vilniaus Karaliaus Mindaugo pagrindinė mokykla";"PUG 1";1904462840;Taip;0;3;0;3
20562;"Vilniaus Karaliaus Mindaugo pagrindinė mokykla";"PUG 1";24287759126;Taip;0;3;0;3
20563;"Vilniaus Karaliaus Mindaugo pagrindinė mokykla";"PUG 1";1830572633;Taip;0;0;1;1
20564;"Vilniaus Karaliaus Mindaugo pagrindinė mokykla";"PUG 1";1445657342;Taip;0;3;0;3
20565;"Vilniaus Karaliaus Mindaugo pagrindinė mokykla";"PUG 1";9313380552;Taip;0;3;0;3
20566;"Vilniaus Karaliaus Mindaugo pagrindinė mokykla";"PUG 1";7782678159;Ne;0;1;2;3
20567;"Vilniaus Karaliaus Mindaugo pagrindinė mokykla";"PUG 1";7876029445;Taip;0;3;1;4
20568;"Vilniaus Karaliaus Mindaugo pagrindinė mokykla";"PUG 1";9522269582;Taip;0;3;0;3
20569;"Vilniaus Karaliaus Mindaugo pagrindinė mokykla";"PUG 3";1799477959;Taip;5;3;0;8
20570;"Vilniaus Karaliaus Mindaugo pagrindinė mokykla";"PUG 3";7433354196;Ne;0;0;2;2
20571;"Vilniaus Karaliaus Mindaugo pagrindinė mokykla";"PUG 3";2836206893;Taip;3;0;0;3
20572;"Vilniaus Karaliaus Mindaugo pagrindinė mokykla";"PUG 3";38426234048;Taip;0;0;1;1
20573;"Vilniaus Karaliaus Mindaugo pagrindinė mokykla";"PUG 3";1502213914;Taip;0;3;1;4
20574;"Vilniaus Karaliaus Mindaugo pagrindinė mokykla";"PUG 3";1929838733;Taip;5;0;4;9
20575;"Vilniaus Karaliaus Mindaugo pagrindinė mokykla";"PUG 3";3344717003;Taip;11;0;0;11
20576;"Vilniaus Karaliaus Mindaugo pagrindinė mokykla";"PUG 3";4677405885;Taip;0;0;5;5
20577;"Vilniaus Karaliaus Mindaugo pagrindinė mokykla";"PUG 3";6406285034;Taip;0;3;2;5
20578;"Vilniaus Karaliaus Mindaugo pagrindinė mokykla";"PUG 3";3786379532;Ne;7;0;1;8
20579;"Vilniaus Karaliaus Mindaugo pagrindinė mokykla";"PUG 3";3018576350;Ne;7;0;1;8
20580;"Vilniaus Levo Karsavino vidurinė mokykla";PELEDŽIUKAI;2149830021;Taip;10;3;0;13
20581;"Vilniaus Levo Karsavino vidurinė mokykla";PELEDŽIUKAI;2718046390;Taip;0;3;0;3
20582;"Vilniaus Levo Karsavino vidurinė mokykla";PELEDŽIUKAI;9094287056;Taip;5;3;1;9
20583;"Vilniaus Levo Karsavino vidurinė mokykla";PELEDŽIUKAI;8721423900;Taip;8;3;1;12
20584;"Vilniaus Levo Karsavino vidurinė mokykla";PELEDŽIUKAI;6917007871;Taip;7;3;2;12
20585;"Vilniaus Levo Karsavino vidurinė mokykla";PELEDŽIUKAI;3452236805;Taip;0;23;0;23
20586;"Vilniaus Levo Karsavino vidurinė mokykla";PELEDŽIUKAI;4066969586;Taip;5;3;2;10
20587;"Vilniaus Levo Karsavino vidurinė mokykla";PELEDŽIUKAI;8564433463;Ne;0;3;0;3
20588;"Vilniaus Levo Karsavino vidurinė mokykla";PELEDŽIUKAI;1067737206;Taip;0;11;0;11
20589;"Vilniaus Levo Karsavino vidurinė mokykla";PELEDŽIUKAI;1288690113;Taip;0;9;0;9
20590;"Vilniaus Levo Karsavino vidurinė mokykla";PELEDŽIUKAI;55396452032;Taip;5;3;1;9
20591;"Vilniaus Levo Karsavino vidurinė mokykla";PELEDŽIUKAI;2276463136;Taip;0;3;0;3
20592;"Vilniaus Levo Karsavino vidurinė mokykla";PELEDŽIUKAI;43259107285;Taip;3;5;0;8
20593;"Vilniaus Levo Karsavino vidurinė mokykla";PELEDŽIUKAI;9947263640;Taip;0;3;7;10
20594;"Vilniaus Levo Karsavino vidurinė mokykla";PELEDŽIUKAI;3641595127;Taip;0;3;0;3
20595;"Vilniaus Levo Karsavino vidurinė mokykla";PELEDŽIUKAI;3254847545;Taip;0;23;0;23
20596;"Vilniaus Levo Karsavino vidurinė mokykla";PELEDŽIUKAI;3381954095;Taip;5;3;2;10
20597;"Vilniaus Levo Karsavino vidurinė mokykla";PELEDŽIUKAI;7227603702;Taip;0;3;0;3
20598;"Vilniaus Levo Karsavino vidurinė mokykla";PELEDŽIUKAI;57138305703;Taip;5;3;1;9
20599;"Vilniaus Levo Karsavino vidurinė mokykla";Žiniukai;3333990952;Taip;0;3;0;3
20600;"Vilniaus Levo Karsavino vidurinė mokykla";Žiniukai;5548875714;Taip;0;3;0;3
20601;"Vilniaus Levo Karsavino vidurinė mokykla";Žiniukai;5452659798;Taip;0;9;0;9
20602;"Vilniaus Levo Karsavino vidurinė mokykla";Žiniukai;5803032683;Taip;0;3;1;4
20603;"Vilniaus Levo Karsavino vidurinė mokykla";Žiniukai;2306517891;Taip;0;23;0;23
20604;"Vilniaus Levo Karsavino vidurinė mokykla";Žiniukai;1428614163;Taip;0;3;1;4
20605;"Vilniaus Levo Karsavino vidurinė mokykla";Žiniukai;9801214344;Ne;0;23;0;23
20606;"Vilniaus Levo Karsavino vidurinė mokykla";Žiniukai;8180889070;Taip;11;3;0;14
20607;"Vilniaus Levo Karsavino vidurinė mokykla";Žiniukai;7023565057;Taip;0;3;1;4
20608;"Vilniaus Levo Karsavino vidurinė mokykla";Žiniukai;2157398751;Taip;0;3;0;3
20609;"Vilniaus Levo Karsavino vidurinė mokykla";Žiniukai;7804533930;Taip;0;3;4;7
20610;"Vilniaus Levo Karsavino vidurinė mokykla";Žiniukai;3379725202;Taip;0;3;0;3
20611;"Vilniaus Levo Karsavino vidurinė mokykla";Žiniukai;7298260831;Taip;5;3;0;8
20612;"Vilniaus Levo Karsavino vidurinė mokykla";Žiniukai;4302751308;Taip;0;3;0;3
20613;"Vilniaus Levo Karsavino vidurinė mokykla";Žiniukai;7920182730;Taip;0;3;0;3
20614;"Vilniaus Levo Karsavino vidurinė mokykla";Žiniukai;12377363480;Taip;0;3;0;3
20615;"Vilniaus Levo Karsavino vidurinė mokykla";Žiniukai;8199573104;Taip;6;3;1;10
20616;"Vilniaus Levo Karsavino vidurinė mokykla";Žiniukai;9589810356;Taip;5;3;0;8
20617;"Vilniaus Levo Karsavino vidurinė mokykla";Žiniukai;64214150955;Taip;6;3;2;11
20618;"Vilniaus Liepkalnio Pagrindinė Mokykla";Bitutės;5597152556;Taip;0;4;2;6
20619;"Vilniaus Liepkalnio Pagrindinė Mokykla";Bitutės;4115995882;Ne;0;4;2;6
20620;"Vilniaus Liepkalnio Pagrindinė Mokykla";Bitutės;6136792125;Taip;0;4;0;4
20621;"Vilniaus Liepkalnio Pagrindinė Mokykla";Bitutės;9293634828;Taip;7;4;2;13
20622;"Vilniaus Liepkalnio Pagrindinė Mokykla";Bitutės;8324581018;Ne;0;4;2;6
20623;"Vilniaus Liepkalnio Pagrindinė Mokykla";Bitutės;1599633295;Taip;0;4;0;4
20624;"Vilniaus Liepkalnio Pagrindinė Mokykla";Bitutės;9589525954;Taip;10;4;0;14
20625;"Vilniaus Liepkalnio Pagrindinė Mokykla";Bitutės;7052487356;Taip;15;4;0;19
20626;"Vilniaus Liepkalnio Pagrindinė Mokykla";Bitutės;2080390421;Ne;0;4;1;5
20627;"Vilniaus Liepkalnio Pagrindinė Mokykla";Bitutės;5323726165;Taip;5;4;0;9
20628;"Vilniaus Liepkalnio Pagrindinė Mokykla";Bitutės;7922755136;Taip;0;4;0;4
20629;"Vilniaus Liepkalnio Pagrindinė Mokykla";Bitutės;1578956182;Taip;6;4;1;11
20630;"Vilniaus Liepkalnio Pagrindinė Mokykla";Bitutės;3721504364;Taip;0;4;0;4
20631;"Vilniaus Liepkalnio Pagrindinė Mokykla";Bitutės;1795366502;Taip;0;4;7;11
20632;"Vilniaus Liepkalnio Pagrindinė Mokykla";Bitutės;9211966929;Taip;0;4;5;9
20633;"Vilniaus Liepkalnio Pagrindinė Mokykla";Bitutės;4112888719;Taip;0;4;1;5
20634;"Vilniaus Liepkalnio Pagrindinė Mokykla";Bitutės;8809471063;Taip;0;4;4;8
20635;"Vilniaus Liepkalnio Pagrindinė Mokykla";Bitutės;6492909546;Taip;0;10;0;10
20636;"Vilniaus Liepkalnio Pagrindinė Mokykla";Bitutės;5197037585;Ne;0;4;0;4
20637;"Vilniaus Liepkalnio Pagrindinė Mokykla";Bitutės;9771780358;Taip;9;4;5;18
20638;"Vilniaus Liepkalnio Pagrindinė Mokykla";Bitutės;4973569038;Taip;0;4;0;4
20639;"Vilniaus Pranciškaus Skorinos gimnazija";Saulytė;5194059497;Taip;17;5;1;23
20640;"Vilniaus Pranciškaus Skorinos gimnazija";Saulytė;5034268767;Taip;0;4;5;9
20641;"Vilniaus Pranciškaus Skorinos gimnazija";Saulytė;3036582121;Taip;0;7;1;8
20642;"Vilniaus Pranciškaus Skorinos gimnazija";Saulytė;5304082676;Ne;7;4;1;12
20643;"Vilniaus Pranciškaus Skorinos gimnazija";Saulytė;7055894770;Taip;0;4;0;4
20644;"Vilniaus Pranciškaus Skorinos gimnazija";Saulytė;6995285377;Ne;3;5;0;8
20645;"Vilniaus Pranciškaus Skorinos gimnazija";Saulytė;6336168033;Taip;0;4;0;4
20646;"Vilniaus Pranciškaus Skorinos gimnazija";Saulytė;3984446381;Taip;11;5;0;16
20647;"Vilniaus Pranciškaus Skorinos gimnazija";Saulytė;8641919789;Ne;0;4;1;5
20648;"Vilniaus Pranciškaus Skorinos gimnazija";Saulytė;5733610359;Taip;10;10;5;25
20649;"Vilniaus Pranciškaus Skorinos gimnazija";Saulytė;4501408366;Taip;5;11;0;16
20650;"Vilniaus Pranciškaus Skorinos gimnazija";Saulytė;4705514590;Ne;0;6;0;6
20651;"Vilniaus Pranciškaus Skorinos gimnazija";Saulytė;4165354124;Taip;3;5;0;8
20652;"Vilniaus Pranciškaus Skorinos gimnazija";Saulytė;6940231858;Ne;0;16;0;16
20653;"Vilniaus Pranciškaus Skorinos gimnazija";Saulytė;8572069816;Taip;7;9;0;16
20654;"Vilniaus Pranciškaus Skorinos gimnazija";Saulytė;4810459063;Taip;0;4;0;4
20655;"Vilniaus Pranciškaus Skorinos gimnazija";Saulytė;3354419392;Taip;0;33;0;33
20656;"Vilniaus Pranciškaus Skorinos gimnazija";Saulytė;9176198859;Ne;3;4;1;8
20657;"Vilniaus Pranciškaus Skorinos gimnazija";Saulytė;3234612149;Taip;14;7;1;22
20658;"Vilniaus Simono Konarskio mokykla";"1 GR.";1464992631;Taip;0;3;0;3
20659;"Vilniaus Simono Konarskio mokykla";"1 GR.";7375004714;Taip;0;3;0;3
20660;"Vilniaus Simono Konarskio mokykla";"1 GR.";9822287576;Taip;0;3;0;3
20661;"Vilniaus Simono Konarskio mokykla";"1 GR.";7052198958;Taip;0;3;0;3
20662;"Vilniaus Simono Konarskio mokykla";"1 GR.";1498329448;Taip;0;3;0;3
20663;"Vilniaus Simono Konarskio mokykla";"1 GR.";3593323270;Taip;0;3;0;3
20664;"Vilniaus Simono Konarskio mokykla";"1 GR.";4463822099;Ne;0;3;0;3
20665;"Vilniaus Simono Konarskio mokykla";"1 GR.";9079781265;Taip;0;3;0;3
20666;"Vilniaus Simono Konarskio mokykla";"1 GR.";1048630061;Taip;0;3;0;3
20667;"Vilniaus Simono Konarskio mokykla";"1 GR.";4286223155;Taip;0;3;0;3
20668;"Vilniaus Simono Konarskio mokykla";"1 GR.";5073378325;Taip;0;3;0;3
20669;"Vilniaus Simono Konarskio mokykla";"1 GR.";8552079735;Ne;0;3;0;3
20670;"Vilniaus Simono Konarskio mokykla";"1 GR.";9093492513;Ne;5;3;0;8
20671;"Vilniaus Simono Konarskio mokykla";"1 GR.";7701956270;Taip;0;3;0;3
20672;"Vilniaus Trakų Vokės gimnazija";Priešmokyklinė;9386629495;Taip;4;4;0;8
20673;"Vilniaus Trakų Vokės gimnazija";Priešmokyklinė;6209271043;Taip;0;4;2;6
20674;"Vilniaus Trakų Vokės gimnazija";Priešmokyklinė;3406479364;Taip;0;2;0;2
20675;"Vilniaus Trakų Vokės gimnazija";Priešmokyklinė;1461337199;Taip;0;7;0;7
20676;"Vilniaus Trakų Vokės gimnazija";Priešmokyklinė;5526830430;Taip;1;1;0;2
20677;"Vilniaus Trakų Vokės gimnazija";Priešmokyklinė;4849992906;Taip;0;10;0;10
20678;"Vilniaus Trakų Vokės gimnazija";Priešmokyklinė;3098390989;Taip;8;0;0;8
20679;"Vilniaus Trakų Vokės gimnazija";Priešmokyklinė;50553766116;Taip;0;1;1;2
20680;"Vilniaus Trakų Vokės gimnazija";Priešmokyklinė;8542147751;Taip;0;4;0;4
20681;"Vilniaus Trakų Vokės gimnazija";Priešmokyklinė;2672165297;Ne;0;0;5;5
20682;"Vilniaus Trakų Vokės gimnazija";Priešmokyklinė;2955411131;Taip;6;10;0;16
20683;"Vilniaus Trakų Vokės gimnazija";Priešmokyklinė;4846130117;Taip;0;1;0;1
20684;"Vilniaus Trakų Vokės gimnazija";Priešmokyklinė;1433982328;Taip;0;6;0;6
20685;"Vilniaus Trakų Vokės gimnazija";Priešmokyklinė;8658085249;Taip;0;4;1;5
20686;"Vilniaus Trakų Vokės gimnazija";Priešmokyklinė;39255784762;Taip;5;0;0;5
20687;"Vilniaus Trakų Vokės gimnazija";Priešmokyklinė;4599632235;Taip;0;3;0;3
20688;"Vilniaus Trakų Vokės gimnazija";Priešmokyklinė;2839396687;Taip;0;4;0;4
20689;"Vilniaus Trakų Vokės gimnazija";Priešmokyklinė;8857529726;Taip;0;1;5;6
20690;"Vilniaus Trakų Vokės gimnazija";Priešmokyklinė;7566567901;Taip;14;4;4;22
20691;"Vilniaus Trakų Vokės gimnazija";"Priešmokyklinė 2";4362066941;Taip;16;0;4;20
20692;"Vilniaus Trakų Vokės gimnazija";"Priešmokyklinė 2";1074730366;Ne;12;2;0;14
20693;"Vilniaus Trakų Vokės gimnazija";"Priešmokyklinė 2";6593654477;Taip;0;1;0;1
20694;"Vilniaus Trakų Vokės gimnazija";"Priešmokyklinė 2";9582511053;Taip;0;13;0;13
20695;"Vilniaus Trakų Vokės gimnazija";"Priešmokyklinė 2";3775081619;Taip;0;1;0;1
20696;"Vilniaus Trakų Vokės gimnazija";"Priešmokyklinė 2";4615315809;Taip;4;4;3;11
20697;"Vilniaus Trakų Vokės gimnazija";"Priešmokyklinė 2";25106446270;Taip;0;9;0;9
20698;"Vilniaus Trakų Vokės gimnazija";"Priešmokyklinė 2";18963190527;Taip;0;4;0;4
20699;"Vilniaus Trakų Vokės gimnazija";"Priešmokyklinė 2";4914675622;Taip;0;3;11;14
20700;"Vilniaus Trakų Vokės gimnazija";"Priešmokyklinė 2";5251929660;Taip;6;4;0;10
20701;"Vilniaus Trakų Vokės gimnazija";"Priešmokyklinė 2";3690179876;Taip;5;4;9;18
20702;"Vilniaus Trakų Vokės gimnazija";"Priešmokyklinė 2";8218370873;Ne;0;2;2;4
20703;"Vilniaus Trakų Vokės gimnazija";"Priešmokyklinė 2";6615724604;Taip;4;4;0;8
20704;"Vilniaus Trakų Vokės gimnazija";"Priešmokyklinė 2";4720226790;Taip;4;0;1;5
20705;"Vilniaus Trakų Vokės gimnazija";"Priešmokyklinė 2";1057189769;Taip;0;9;1;10
20706;"Vilniaus Trakų Vokės gimnazija";"Priešmokyklinė 2";2149804129;Ne;0;4;1;5
20707;"Vilniaus Trakų Vokės gimnazija";"Priešmokyklinė 2";1590598232;Taip;7;4;7;18
20708;"Vilniaus Trakų Vokės gimnazija";"Priešmokyklinė 2";8168960897;Ne;11;11;1;23
20709;"Vilniaus Trakų Vokės gimnazija";"Priešmokyklinė 2";9960520926;Ne;4;4;0;8
20710;"Vilniaus Trakų Vokės gimnazija";"Priešmokyklinė 2";9039274775;Taip;5;2;0;7
20711;"Vilniaus Trakų Vokės gimnazija";"Priešmokyklinė 3";7547303829;Taip;0;4;2;6
20712;"Vilniaus Trakų Vokės gimnazija";"Priešmokyklinė 3";2301758912;Taip;16;2;1;19
20713;"Vilniaus Trakų Vokės gimnazija";"Priešmokyklinė 3";7792654474;Taip;0;4;0;4
20714;"Vilniaus Trakų Vokės gimnazija";"Priešmokyklinė 3";3449317958;Taip;0;0;5;5
20715;"Vilniaus Trakų Vokės gimnazija";"Priešmokyklinė 3";9268558715;Taip;5;4;3;12
20716;"Vilniaus Trakų Vokės gimnazija";"Priešmokyklinė 3";9668538340;Taip;0;0;5;5
20717;"Vilniaus Trakų Vokės gimnazija";"Priešmokyklinė 3";2469486746;Taip;0;0;15;15
20718;"Vilniaus Trakų Vokės gimnazija";"Priešmokyklinė 3";95320712086;Taip;0;0;7;7
20719;"Vilniaus Trakų Vokės gimnazija";"Priešmokyklinė 3";1053286928;Taip;0;0;7;7
20720;"Vilniaus Trakų Vokės gimnazija";"Priešmokyklinė 3";5115117246;Ne;17;0;7;24
20721;"Vilniaus Trakų Vokės gimnazija";"Priešmokyklinė 3";6765094662;Taip;1;5;0;6
20722;"Vilniaus Trakų Vokės gimnazija";"Priešmokyklinė 3";6835150864;Taip;0;9;0;9
20723;"Vilniaus Trakų Vokės gimnazija";"Priešmokyklinė 3";1940148622;Taip;0;4;8;12
20724;"Vilniaus Trakų Vokės gimnazija";"Priešmokyklinė 3";9051697544;Ne;13;0;4;17
20725;"Vilniaus Trakų Vokės gimnazija";"Priešmokyklinė 3";1398572100;Taip;0;0;6;6
20726;"Vilniaus Trakų Vokės gimnazija";"Priešmokyklinė 3";2730385281;Taip;0;0;4;4
20727;"Vilniaus Salininkų gimnazija";"Priešmokyklinė A";22167560908;Taip;0;10;0;10
20728;"Vilniaus Salininkų gimnazija";"Priešmokyklinė A";10335028421;Taip;2;3;0;5
20729;"Vilniaus Salininkų gimnazija";"Priešmokyklinė A";8683841956;Taip;0;3;0;3
20730;"Vilniaus Salininkų gimnazija";"Priešmokyklinė A";1180792335;Taip;0;5;0;5
20731;"Vilniaus Salininkų gimnazija";"Priešmokyklinė A";5063792784;Taip;0;4;0;4
20732;"Vilniaus Salininkų gimnazija";"Priešmokyklinė A";1704033440;Taip;0;9;0;9
20733;"Vilniaus Salininkų gimnazija";"Priešmokyklinė A";46867660097;Taip;0;6;0;6
20734;"Vilniaus Salininkų gimnazija";"Priešmokyklinė A";3692008687;Taip;0;10;0;10
20735;"Vilniaus Salininkų gimnazija";"Priešmokyklinė A";2292919406;Taip;0;4;0;4
20736;"Vilniaus Salininkų gimnazija";"Priešmokyklinė A";35611320012;Taip;0;5;0;5
20737;"Vilniaus Salininkų gimnazija";"Priešmokyklinė A";4269202761;Taip;0;4;0;4
20738;"Vilniaus Salininkų gimnazija";"Priešmokyklinė A";9375550172;Taip;0;3;0;3
20739;"Vilniaus Salininkų gimnazija";"Priešmokyklinė A";7160091629;Taip;9;9;0;18
20740;"Vilniaus Salininkų gimnazija";"Priešmokyklinė A";41023354439;Taip;0;3;0;3
20741;"Vilniaus Salininkų gimnazija";"Priešmokyklinė A";1642658060;Taip;0;4;0;4
20742;"Vilniaus Salininkų gimnazija";"Priešmokyklinė A";3848448401;Taip;0;3;0;3
20743;"Vilniaus Salininkų gimnazija";"Priešmokyklinė A";3737786832;Ne;4;4;0;8
20744;"Vilniaus Salininkų gimnazija";"Priešmokyklinė A";8025611655;Taip;0;3;0;3
20745;"Vilniaus Salininkų gimnazija";"Priešmokyklinė A";4939261324;Taip;0;3;0;3
20746;"Vilniaus Salininkų gimnazija";"Priešmokyklinė A";6738902611;Taip;0;23;0;23
20747;"Vilniaus Salininkų gimnazija";"Priešmokyklinė A";2989580886;Taip;0;3;0;3
20748;"Vilniaus Salininkų gimnazija";"Priešmokyklinė A";3661928980;Taip;0;3;0;3
20749;"Vilniaus Salininkų gimnazija";"PRIEŠMOKYKLINĖ B";7378039370;Taip;3;3;0;6
20750;"Vilniaus Salininkų gimnazija";"PRIEŠMOKYKLINĖ B";98941037508;Taip;0;3;0;3
20751;"Vilniaus Salininkų gimnazija";"PRIEŠMOKYKLINĖ B";1355032282;Taip;0;3;0;3
20752;"Vilniaus Salininkų gimnazija";"PRIEŠMOKYKLINĖ B";8018093186;Ne;5;3;0;8
20753;"Vilniaus Salininkų gimnazija";"PRIEŠMOKYKLINĖ B";9216372353;Taip;1;3;0;4
20754;"Vilniaus Salininkų gimnazija";"PRIEŠMOKYKLINĖ B";3015424614;Taip;4;3;0;7
20755;"Vilniaus Salininkų gimnazija";"PRIEŠMOKYKLINĖ B";8488127476;Ne;0;3;0;3
20756;"Vilniaus Salininkų gimnazija";"PRIEŠMOKYKLINĖ B";8410624264;Taip;0;6;0;6
20757;"Vilniaus Salininkų gimnazija";"PRIEŠMOKYKLINĖ B";1544346282;Taip;0;3;0;3
20758;"Vilniaus Salininkų gimnazija";"PRIEŠMOKYKLINĖ B";2066091911;Taip;0;3;0;3
20759;"Vilniaus Salininkų gimnazija";"PRIEŠMOKYKLINĖ B";1723241116;Taip;1;3;0;4
20760;"Vilniaus Salininkų gimnazija";"PRIEŠMOKYKLINĖ B";30123603107;Taip;1;3;0;4
20761;"Vilniaus Salininkų gimnazija";"PRIEŠMOKYKLINĖ B";8659656902;Taip;0;3;0;3
20762;"Vilniaus Salininkų gimnazija";"PRIEŠMOKYKLINĖ B";8288199783;Taip;0;3;0;3
20763;"Vilniaus Salininkų gimnazija";"PRIEŠMOKYKLINĖ B";1065549119;Taip;5;3;0;8
20764;"Vilniaus Salininkų gimnazija";"PRIEŠMOKYKLINĖ B";1460694577;Taip;0;3;0;3
20765;"Vilniaus Salininkų gimnazija";"PRIEŠMOKYKLINĖ B";2786775879;Taip;1;3;0;4
20766;"Vilniaus Salininkų gimnazija";"PRIEŠMOKYKLINĖ B";5689344488;Taip;0;3;0;3
20767;"Vilniaus Salininkų gimnazija";"PRIEŠMOKYKLINĖ B";9513785510;Taip;0;3;0;3
20768;"Vilniaus Salininkų gimnazija";"PRIEŠMOKYKLINĖ B";91859774311;Taip;4;3;0;7
20769;"Vilniaus Salininkų gimnazija";"PRIEŠMOKYKLINĖ B";9026612929;Taip;2;3;0;5
20770;"Vilniaus „Spindulio“ progimnazija";PM2;3093606855;Taip;4;3;0;7
20771;"Vilniaus „Spindulio“ progimnazija";PM2;6304295422;Taip;0;3;0;3
20772;"Vilniaus „Spindulio“ progimnazija";PM2;5078945984;Taip;0;3;0;3
20773;"Vilniaus „Spindulio“ progimnazija";PM2;9099945815;Taip;7;3;0;10
20774;"Vilniaus „Spindulio“ progimnazija";PM2;75538036055;Taip;6;3;0;9
20775;"Vilniaus „Spindulio“ progimnazija";PM2;15583558585;Taip;7;3;3;13
20776;"Vilniaus „Spindulio“ progimnazija";PM2;2427349194;Ne;0;3;1;4
20777;"Vilniaus „Spindulio“ progimnazija";PM2;7445566160;Taip;6;3;2;11
20778;"Vilniaus „Spindulio“ progimnazija";PM2;6561536457;Taip;0;2;0;2
20779;"Vilniaus „Spindulio“ progimnazija";PM2;8023936861;Ne;6;0;0;6
20780;"Vilniaus „Spindulio“ progimnazija";PM2;7277680544;Taip;4;1;0;5
20781;"Vilniaus „Spindulio“ progimnazija";PM2;6479094819;Taip;12;3;0;15
20782;"Vilniaus „Spindulio“ progimnazija";PM2;2356833740;Taip;3;3;2;8
20783;"Vilniaus „Spindulio“ progimnazija";PM2;1338287524;Taip;0;3;0;3
20784;"Vilniaus „Spindulio“ progimnazija";PM2;9516852657;Taip;4;3;0;7
20785;"Vilniaus „Spindulio“ progimnazija";PM2;1364873935;Taip;5;0;3;8
20786;"Vilniaus „Spindulio“ progimnazija";PM2;7528505426;Taip;8;3;0;11
20787;"Vilniaus „Spindulio“ progimnazija";PM2;7120717682;Taip;9;3;0;12
20788;"Vilniaus „Spindulio“ progimnazija";PM2;6201567680;Taip;4;3;0;7
20789;"Vilniaus „Spindulio“ progimnazija";PM2;8012626513;Taip;5;3;0;8
20790;"Vilniaus „Spindulio“ progimnazija";PM2;52216192635;Taip;10;3;1;14
20791;"Vilniaus „Spindulio“ progimnazija";PM2;4791752179;Taip;0;3;0;3
20792;"Vilniaus „Spindulio“ progimnazija";PM1;43859975789;Taip;0;3;0;3
20793;"Vilniaus „Spindulio“ progimnazija";PM1;4701887030;Taip;0;3;0;3
20794;"Vilniaus „Spindulio“ progimnazija";PM1;60320557464;Taip;4;4;0;8
20795;"Vilniaus „Spindulio“ progimnazija";PM1;2531571615;Taip;0;3;0;3
20796;"Vilniaus „Spindulio“ progimnazija";PM1;1421633312;Ne;3;0;0;3
20797;"Vilniaus „Spindulio“ progimnazija";PM1;3678131609;Taip;0;3;0;3
20798;"Vilniaus „Spindulio“ progimnazija";PM1;1194444282;Taip;0;3;0;3
20799;"Vilniaus „Spindulio“ progimnazija";PM1;56885383122;Taip;0;6;0;6
20800;"Vilniaus „Spindulio“ progimnazija";PM1;1338476746;Taip;5;5;0;10
20801;"Vilniaus „Spindulio“ progimnazija";PM1;1251961268;Taip;0;3;0;3
20802;"Vilniaus „Spindulio“ progimnazija";PM1;2402204674;Taip;5;3;0;8
20803;"Vilniaus „Spindulio“ progimnazija";PM1;6700068320;Taip;9;3;0;12
20804;"Vilniaus „Spindulio“ progimnazija";PM1;9347513042;Taip;0;4;0;4
20805;"Vilniaus „Spindulio“ progimnazija";PM1;1153333591;Taip;0;3;0;3
20806;"Vilniaus „Spindulio“ progimnazija";PM1;1650166115;Taip;5;3;0;8
20807;"Vilniaus „Spindulio“ progimnazija";PM1;9573336239;Taip;0;3;0;3
20808;"Vilniaus „Spindulio“ progimnazija";PM1;4239224971;Taip;0;3;2;5
20809;"Vilniaus „Spindulio“ progimnazija";PM1;1454101129;Taip;0;1;0;1
20810;"Vilniaus „Spindulio“ progimnazija";PM1;1325054642;Taip;0;1;0;1
20811;"Vilniaus „Spindulio“ progimnazija";PM1;1160537966;Taip;5;0;0;5
20812;"Vilniaus „Spindulio“ progimnazija";PM1;91028452879;Taip;0;3;0;3
20813;"Vilniaus „Spindulio“ progimnazija";PM1;1789047913;Taip;0;3;0;3
20814;"Vilniaus Vladislavo Sirokomlės gimnazija";Nykštukai;1797237248;Taip;0;4;0;4
20815;"Vilniaus Vladislavo Sirokomlės gimnazija";Nykštukai;6031408197;Taip;5;4;0;9
20816;"Vilniaus Vladislavo Sirokomlės gimnazija";Nykštukai;1947403400;Taip;0;4;1;5
20817;"Vilniaus Vladislavo Sirokomlės gimnazija";Nykštukai;1499061139;Taip;0;32;0;32
20818;"Vilniaus Vladislavo Sirokomlės gimnazija";Nykštukai;2219712757;Taip;5;4;0;9
20819;"Vilniaus Vladislavo Sirokomlės gimnazija";Nykštukai;5544613599;Taip;3;4;3;10
20820;"Vilniaus Vladislavo Sirokomlės gimnazija";Nykštukai;25415760747;Taip;4;7;0;11
20821;"Vilniaus Vladislavo Sirokomlės gimnazija";Nykštukai;17201639406;Taip;3;4;0;7
20822;"Vilniaus Vladislavo Sirokomlės gimnazija";Nykštukai;8302624354;Taip;8;5;0;13
20823;"Vilniaus Vladislavo Sirokomlės gimnazija";Nykštukai;1492328724;Taip;1;5;0;6
20824;"Vilniaus Vladislavo Sirokomlės gimnazija";Nykštukai;4436165764;Taip;0;5;0;5
20825;"Vilniaus Vladislavo Sirokomlės gimnazija";Nykštukai;1837566431;Ne;8;5;0;13
20826;"Vilniaus Vladislavo Sirokomlės gimnazija";Nykštukai;8016643568;Taip;4;4;0;8
20827;"Vilniaus Vladislavo Sirokomlės gimnazija";Nykštukai;4534828670;Taip;0;32;0;32
20828;"Vilniaus Vladislavo Sirokomlės gimnazija";Nykštukai;4069044269;Taip;0;4;0;4
20829;"Vilniaus Vladislavo Sirokomlės gimnazija";Nykštukai;9391697537;Taip;8;5;1;14
20830;"Vilniaus Vladislavo Sirokomlės gimnazija";Nykštukai;5422289286;Taip;5;5;1;11
20831;"Vilniaus Vladislavo Sirokomlės gimnazija";Nykštukai;5625943720;Taip;7;5;0;12
20832;"Vilniaus Vladislavo Sirokomlės gimnazija";Nykštukai;2946297529;Taip;0;5;0;5
20833;"Vilniaus Vladislavo Sirokomlės gimnazija";Smurfai;5844437769;Taip;4;4;0;8
20834;"Vilniaus Vladislavo Sirokomlės gimnazija";Smurfai;9751494612;Taip;0;6;0;6
20835;"Vilniaus Vladislavo Sirokomlės gimnazija";Smurfai;4727265555;Taip;0;10;0;10
20836;"Vilniaus Vladislavo Sirokomlės gimnazija";Smurfai;7071043164;Taip;5;6;0;11
20837;"Vilniaus Vladislavo Sirokomlės gimnazija";Smurfai;1493604303;Taip;0;4;0;4
20838;"Vilniaus Vladislavo Sirokomlės gimnazija";Smurfai;4830374546;Taip;0;5;0;5
20839;"Vilniaus Vladislavo Sirokomlės gimnazija";Smurfai;4506651162;Taip;0;7;0;7
20840;"Vilniaus Vladislavo Sirokomlės gimnazija";Smurfai;1817869518;Taip;0;4;0;4
20841;"Vilniaus Vladislavo Sirokomlės gimnazija";Smurfai;1512245903;Taip;0;4;0;4
20842;"Vilniaus Vladislavo Sirokomlės gimnazija";Smurfai;7904983228;Ne;0;6;0;6
20843;"Vilniaus Vladislavo Sirokomlės gimnazija";Smurfai;1570206034;Ne;10;7;0;17
20844;"Vilniaus Vladislavo Sirokomlės gimnazija";Smurfai;1820583792;Taip;0;7;0;7
20845;"Vilniaus Vladislavo Sirokomlės gimnazija";Smurfai;2386927970;Taip;1;5;0;6
20846;"Vilniaus Vladislavo Sirokomlės gimnazija";Smurfai;92356998180;Taip;2;8;0;10
20847;"Vilniaus Vladislavo Sirokomlės gimnazija";Smurfai;4990982790;Taip;3;6;0;9
20848;"Vilniaus Vladislavo Sirokomlės gimnazija";Smurfai;3795927209;Taip;0;5;0;5
20849;"Vilniaus Vladislavo Sirokomlės gimnazija";Smurfai;3880578523;Taip;2;6;0;8
20850;"Vilniaus Vladislavo Sirokomlės gimnazija";Smurfai;9868386182;Taip;3;5;0;8
20851;"Vilniaus Vladislavo Sirokomlės gimnazija";Smurfai;1090204906;Taip;1;5;0;6
20852;"Vilniaus „Pelėdos” pradinė mokykla";Bitutės;3131930907;Taip;5;3;0;8
20853;"Vilniaus „Pelėdos” pradinė mokykla";Bitutės;2023718424;Taip;0;2;0;2
20854;"Vilniaus „Pelėdos” pradinė mokykla";Bitutės;13170636069;Taip;0;3;0;3
20855;"Vilniaus „Pelėdos” pradinė mokykla";Bitutės;1627717901;Taip;5;3;0;8
20856;"Vilniaus „Pelėdos” pradinė mokykla";Bitutės;49343952061;Taip;0;3;0;3
20857;"Vilniaus „Pelėdos” pradinė mokykla";Bitutės;8281005516;Ne;10;3;0;13
20858;"Vilniaus „Pelėdos” pradinė mokykla";Bitutės;7678062264;Taip;0;3;6;9
20859;"Vilniaus „Pelėdos” pradinė mokykla";Bitutės;6610166355;Taip;4;1;0;5
20860;"Vilniaus „Pelėdos” pradinė mokykla";Bitutės;5282345380;Taip;0;0;1;1
20861;"Vilniaus „Pelėdos” pradinė mokykla";Bitutės;4427123314;Taip;4;3;0;7
20862;"Vilniaus „Pelėdos” pradinė mokykla";Bitutės;5610993611;Taip;0;3;2;5
20863;"Vilniaus „Pelėdos” pradinė mokykla";Bitutės;1121936989;Taip;0;3;1;4
20864;"Vilniaus „Pelėdos” pradinė mokykla";Bitutės;4268531240;Taip;0;3;0;3
20865;"Vilniaus „Pelėdos” pradinė mokykla";Bitutės;3312575449;Taip;0;3;0;3
20866;"Vilniaus „Pelėdos” pradinė mokykla";Bitutės;9558483512;Taip;0;2;0;2
20867;"Vilniaus „Pelėdos” pradinė mokykla";Bitutės;9343761295;Taip;5;2;1;8
20868;"Vilniaus „Pelėdos” pradinė mokykla";Bitutės;7006338378;Taip;0;3;1;4
20869;"Vilniaus „Pelėdos” pradinė mokykla";Bitutės;3030820917;Ne;0;3;0;3
20870;"Vilniaus „Pelėdos” pradinė mokykla";Bitutės;3768735503;Taip;3;0;2;5
20871;"Vilniaus „Pelėdos” pradinė mokykla";Bitutės;6597383913;Taip;0;1;2;3
20872;"Vilniaus „Pelėdos” pradinė mokykla";Bitutės;7972395014;Taip;0;3;3;6
20873;"Vilniaus „Pelėdos” pradinė mokykla";Boružėlės;1032549174;Taip;0;3;0;3
20874;"Vilniaus „Pelėdos” pradinė mokykla";Boružėlės;1314392095;Ne;0;3;0;3
20875;"Vilniaus „Pelėdos” pradinė mokykla";Boružėlės;1249227477;Taip;0;1;0;1
20876;"Vilniaus „Pelėdos” pradinė mokykla";Boružėlės;5169736542;Taip;0;3;0;3
20877;"Vilniaus „Pelėdos” pradinė mokykla";Boružėlės;6897988246;Taip;0;1;0;1
20878;"Vilniaus „Pelėdos” pradinė mokykla";Boružėlės;1830060403;Taip;0;3;0;3
20879;"Vilniaus „Pelėdos” pradinė mokykla";Boružėlės;1153781469;Taip;15;3;0;18
20880;"Vilniaus „Pelėdos” pradinė mokykla";Boružėlės;93600065957;Taip;0;3;0;3
20881;"Vilniaus „Pelėdos” pradinė mokykla";Boružėlės;3970413055;Taip;0;3;0;3
20882;"Vilniaus „Pelėdos” pradinė mokykla";Boružėlės;9279913053;Ne;11;0;0;11
20883;"Vilniaus „Pelėdos” pradinė mokykla";Boružėlės;1616324236;Ne;0;3;0;3
20884;"Vilniaus „Pelėdos” pradinė mokykla";Boružėlės;1704933971;Taip;0;3;0;3
20885;"Vilniaus „Pelėdos” pradinė mokykla";Boružėlės;8370864547;Taip;0;1;0;1
20886;"Vilniaus „Pelėdos” pradinė mokykla";Boružėlės;6623852620;Ne;0;3;0;3
20887;"Vilniaus „Pelėdos” pradinė mokykla";Boružėlės;5140876051;Ne;0;3;0;3
20888;"Vilniaus Joachimo Lelevelio inžinerijos mokykla";0A;57362664278;Taip;0;3;0;3
20889;"Vilniaus Joachimo Lelevelio inžinerijos mokykla";0A;1694423628;Taip;9;3;0;12
20890;"Vilniaus Joachimo Lelevelio inžinerijos mokykla";0A;19420482998;Taip;5;3;0;8
20891;"Vilniaus Joachimo Lelevelio inžinerijos mokykla";0A;1546251543;Taip;0;23;0;23
20892;"Vilniaus Joachimo Lelevelio inžinerijos mokykla";0A;9130637883;Taip;0;7;2;9
20893;"Vilniaus Joachimo Lelevelio inžinerijos mokykla";0A;6217540064;Taip;4;5;0;9
20894;"Vilniaus Joachimo Lelevelio inžinerijos mokykla";0A;1954888655;Taip;0;3;2;5
20895;"Vilniaus Joachimo Lelevelio inžinerijos mokykla";0A;7776071299;Taip;4;3;1;8
20896;"Vilniaus Joachimo Lelevelio inžinerijos mokykla";0A;9215070593;Taip;2;3;0;5
20897;"Vilniaus Joachimo Lelevelio inžinerijos mokykla";0A;3039980710;Taip;0;8;0;8
20898;"Vilniaus Joachimo Lelevelio inžinerijos mokykla";0A;1826015013;Taip;4;3;0;7
20899;"Vilniaus Joachimo Lelevelio inžinerijos mokykla";0A;5630659056;Taip;0;6;0;6
20900;"Vilniaus Joachimo Lelevelio inžinerijos mokykla";0A;9171690612;Taip;0;5;7;12
20901;"Vilniaus Joachimo Lelevelio inžinerijos mokykla";0A;3271832822;Taip;3;6;0;9
20902;"Vilniaus Joachimo Lelevelio inžinerijos mokykla";0A;2797443202;Ne;0;3;0;3
20903;"Vilniaus Joachimo Lelevelio inžinerijos mokykla";0B;6404064049;Taip;0;4;1;5
20904;"Vilniaus Joachimo Lelevelio inžinerijos mokykla";0B;2324578741;Taip;0;4;1;5
20905;"Vilniaus Joachimo Lelevelio inžinerijos mokykla";0B;6132569107;Taip;0;4;0;4
20906;"Vilniaus Joachimo Lelevelio inžinerijos mokykla";0B;64247830728;Taip;0;30;0;30
20907;"Vilniaus Joachimo Lelevelio inžinerijos mokykla";0B;2601103834;Taip;0;12;0;12
20908;"Vilniaus Joachimo Lelevelio inžinerijos mokykla";0B;65960895249;Taip;0;5;0;5
20909;"Vilniaus Joachimo Lelevelio inžinerijos mokykla";0B;5722934228;Taip;0;6;0;6
20910;"Vilniaus Joachimo Lelevelio inžinerijos mokykla";0B;1385352925;Taip;0;5;0;5
20911;"Vilniaus Joachimo Lelevelio inžinerijos mokykla";0B;4209118353;Taip;0;9;0;9
20912;"Vilniaus Joachimo Lelevelio inžinerijos mokykla";0B;6883982889;Taip;6;4;2;12
20913;"Vilniaus Joachimo Lelevelio inžinerijos mokykla";0B;9595277597;Taip;0;8;0;8
20914;"Vilniaus Joachimo Lelevelio inžinerijos mokykla";0B;2842587194;Taip;0;4;0;4
20915;"Vilniaus Joachimo Lelevelio inžinerijos mokykla";0B;8042807487;Taip;0;4;0;4
20916;"Vilniaus Joachimo Lelevelio inžinerijos mokykla";0B;6501930436;Taip;5;4;0;9
20917;"Vilniaus Joachimo Lelevelio inžinerijos mokykla";0B;71081903240;Taip;0;4;0;4
20918;"Vilniaus Juzefo Ignacijaus Kraševskio gimnazija";Priešmokyklinė;2201538495;Taip;0;3;0;3
20919;"Vilniaus Juzefo Ignacijaus Kraševskio gimnazija";Priešmokyklinė;9114472645;Ne;0;6;0;6
20920;"Vilniaus Juzefo Ignacijaus Kraševskio gimnazija";Priešmokyklinė;5261769707;Taip;10;3;0;13
20921;"Vilniaus Juzefo Ignacijaus Kraševskio gimnazija";Priešmokyklinė;5255617339;Ne;14;3;1;18
20922;"Vilniaus Juzefo Ignacijaus Kraševskio gimnazija";Priešmokyklinė;1600495468;Taip;0;6;0;6
20923;"Vilniaus Juzefo Ignacijaus Kraševskio gimnazija";Priešmokyklinė;3733665122;Taip;7;5;0;12
20924;"Vilniaus Juzefo Ignacijaus Kraševskio gimnazija";Priešmokyklinė;2168987649;Taip;3;3;1;7
20925;"Vilniaus Juzefo Ignacijaus Kraševskio gimnazija";Priešmokyklinė;4499924331;Taip;0;6;0;6
20926;"Vilniaus Juzefo Ignacijaus Kraševskio gimnazija";Priešmokyklinė;6048337545;Taip;0;3;0;3
20927;"Vilniaus Juzefo Ignacijaus Kraševskio gimnazija";Priešmokyklinė;9948555227;Taip;5;3;5;13
20928;"Vilniaus Juzefo Ignacijaus Kraševskio gimnazija";Priešmokyklinė;7993975989;Ne;0;6;0;6
20929;"Vilniaus Juzefo Ignacijaus Kraševskio gimnazija";Priešmokyklinė;2684151591;Taip;4;4;0;8
20930;"Vilniaus Juzefo Ignacijaus Kraševskio gimnazija";Priešmokyklinė;7670166244;Taip;5;3;1;9
20931;"Vilniaus Juzefo Ignacijaus Kraševskio gimnazija";Priešmokyklinė;4864834075;Taip;0;9;0;9
20932;"Vilniaus Juzefo Ignacijaus Kraševskio gimnazija";Priešmokyklinė;1837140329;Ne;3;3;1;7
20933;"Vilniaus Juzefo Ignacijaus Kraševskio gimnazija";Priešmokyklinė;1460429651;Taip;6;4;0;10
20934;"Vilniaus Juzefo Ignacijaus Kraševskio gimnazija";Priešmokyklinė;9501262918;Ne;0;8;1;9
20935;"Vilniaus Juzefo Ignacijaus Kraševskio gimnazija";Priešmokyklinė;9333766622;Ne;0;9;0;9
20936;"Vilniaus Juzefo Ignacijaus Kraševskio gimnazija";Priešmokyklinė;3507672150;Taip;0;9;0;9
20937;"Vilniaus Juzefo Ignacijaus Kraševskio gimnazija";Priešmokyklinė;7305350540;Taip;8;4;0;12
20938;"Vilniaus Juzefo Ignacijaus Kraševskio gimnazija";Priešmokyklinė;3698808100;Taip;10;4;0;14
20939;"Vilniaus Jono Pauliaus II progimnazija";Nykštukai;2055530718;Taip;1;4;0;5
20940;"Vilniaus Jono Pauliaus II progimnazija";Nykštukai;7140223126;Taip;0;4;0;4
20941;"Vilniaus Jono Pauliaus II progimnazija";Nykštukai;48694326383;Taip;0;4;0;4
20942;"Vilniaus Jono Pauliaus II progimnazija";Nykštukai;4831426440;Taip;0;5;0;5
20943;"Vilniaus Jono Pauliaus II progimnazija";Nykštukai;3762141936;Taip;0;4;0;4
20944;"Vilniaus Jono Pauliaus II progimnazija";Nykštukai;8703046661;Taip;0;5;0;5
20945;"Vilniaus Jono Pauliaus II progimnazija";Nykštukai;6724813553;Taip;3;6;0;9
20946;"Vilniaus Jono Pauliaus II progimnazija";Nykštukai;51629266891;Taip;7;4;0;11
20947;"Vilniaus Jono Pauliaus II progimnazija";Nykštukai;7268811782;Taip;9;4;0;13
20948;"Vilniaus Jono Pauliaus II progimnazija";Nykštukai;8998452731;Taip;3;4;0;7
20949;"Vilniaus Jono Pauliaus II progimnazija";Nykštukai;4071338645;Taip;0;4;0;4
20950;"Vilniaus Jono Pauliaus II progimnazija";Nykštukai;3637409607;Taip;0;7;0;7
20951;"Vilniaus Jono Pauliaus II progimnazija";Nykštukai;4607613986;Taip;0;24;0;24
20952;"Vilniaus Jono Pauliaus II progimnazija";Nykštukai;6988819614;Taip;0;4;0;4
20953;"Vilniaus Jono Pauliaus II progimnazija";Nykštukai;9672929606;Taip;0;4;3;7
20954;"Vilniaus Jono Pauliaus II progimnazija";Nykštukai;9457189905;Taip;11;4;0;15
20955;"Vilniaus Jono Pauliaus II progimnazija";Nykštukai;2013905907;Taip;0;5;0;5
20956;"Vilniaus Jono Pauliaus II progimnazija";Nykštukai;2095972347;Taip;1;4;0;5
20957;"Vilniaus Jono Pauliaus II progimnazija";Nykštukai;1624125024;Taip;1;6;0;7
20958;"Vilniaus Jono Pauliaus II progimnazija";Nykštukai;8796557675;Taip;0;6;0;6
20959;"Vilniaus Jono Pauliaus II progimnazija";Nykštukai;5902455219;Taip;0;9;0;9
20960;"Vilniaus Jono Pauliaus II progimnazija";Žiniukai;36350993825;Taip;0;6;1;7
20961;"Vilniaus Jono Pauliaus II progimnazija";Žiniukai;8607110629;Taip;5;4;1;10
20962;"Vilniaus Jono Pauliaus II progimnazija";Žiniukai;6779413882;Taip;8;4;0;12
20963;"Vilniaus Jono Pauliaus II progimnazija";Žiniukai;1897451825;Taip;0;5;0;5
20964;"Vilniaus Jono Pauliaus II progimnazija";Žiniukai;49110267692;Taip;0;4;4;8
20965;"Vilniaus Jono Pauliaus II progimnazija";Žiniukai;7947148051;Taip;0;7;0;7
20966;"Vilniaus Jono Pauliaus II progimnazija";Žiniukai;9246391309;Taip;0;6;0;6
20967;"Vilniaus Jono Pauliaus II progimnazija";Žiniukai;35673258175;Taip;2;4;0;6
20968;"Vilniaus Jono Pauliaus II progimnazija";Žiniukai;4472742569;Taip;0;4;2;6
20969;"Vilniaus Jono Pauliaus II progimnazija";Žiniukai;69245659818;Taip;0;11;0;11
20970;"Vilniaus Jono Pauliaus II progimnazija";Žiniukai;9664467134;Taip;7;4;0;11
20971;"Vilniaus Jono Pauliaus II progimnazija";Žiniukai;7838787153;Taip;5;4;0;9
20972;"Vilniaus Jono Pauliaus II progimnazija";Žiniukai;8922195998;Taip;5;4;0;9
20973;"Vilniaus Jono Pauliaus II progimnazija";Žiniukai;1429139157;Taip;3;4;0;7
20974;"Vilniaus Jono Pauliaus II progimnazija";Žiniukai;3042409414;Taip;0;13;0;13
20975;"Vilniaus Jono Pauliaus II progimnazija";Žiniukai;8245310502;Taip;5;5;1;11
20976;"Vilniaus Jono Pauliaus II progimnazija";Žiniukai;5593546668;Taip;0;4;0;4
20977;"Vilniaus Jono Pauliaus II progimnazija";Žiniukai;1460444785;Taip;5;7;0;12
20978;"Vilniaus Jono Pauliaus II progimnazija";Žiniukai;9262869284;Taip;6;4;2;12
20979;"Vilniaus Jono Pauliaus II progimnazija";Žiniukai;38456484551;Taip;0;5;0;5
20980;"Vilniaus Jono Pauliaus II progimnazija";Žiniukai;6646474196;Taip;0;4;1;5
20981;"Vilniaus Jono Pauliaus II progimnazija";Spindulėlis;2391924358;Taip;0;4;0;4
20982;"Vilniaus Jono Pauliaus II progimnazija";Spindulėlis;9953834483;Taip;0;4;0;4
20983;"Vilniaus Jono Pauliaus II progimnazija";Spindulėlis;1950514819;Taip;0;33;0;33
20984;"Vilniaus Jono Pauliaus II progimnazija";Spindulėlis;1298127839;Ne;0;5;0;5
20985;"Vilniaus Jono Pauliaus II progimnazija";Spindulėlis;4034847901;Taip;0;5;0;5
20986;"Vilniaus Jono Pauliaus II progimnazija";Spindulėlis;8980788109;Taip;0;4;0;4
20987;"Vilniaus Jono Pauliaus II progimnazija";Spindulėlis;1009453682;Taip;13;4;0;17
20988;"Vilniaus Jono Pauliaus II progimnazija";Spindulėlis;4579700769;Taip;0;4;3;7
20989;"Vilniaus Jono Pauliaus II progimnazija";Spindulėlis;7136135394;Taip;0;4;0;4
20990;"Vilniaus Jono Pauliaus II progimnazija";Spindulėlis;2244921301;Taip;0;4;0;4
20991;"Vilniaus Jono Pauliaus II progimnazija";Spindulėlis;1133359254;Taip;15;4;0;19
20992;"Vilniaus Jono Pauliaus II progimnazija";Spindulėlis;8336138549;Taip;0;5;0;5
20993;"Vilniaus Jono Pauliaus II progimnazija";Spindulėlis;1831094707;Taip;0;5;0;5
20994;"Vilniaus Jono Pauliaus II progimnazija";Spindulėlis;5036549574;Taip;3;4;0;7
20995;"Vilniaus Jono Pauliaus II progimnazija";Spindulėlis;5451923881;Taip;10;4;0;14
20996;"Vilniaus Jono Pauliaus II progimnazija";Spindulėlis;8100789958;Taip;0;6;0;6
20997;"Vilniaus Jono Pauliaus II progimnazija";Spindulėlis;6964047214;Taip;7;4;0;11
20998;"Vilniaus Jono Pauliaus II progimnazija";Spindulėlis;2445444641;Taip;5;4;0;9
20999;"Vilniaus Jono Pauliaus II progimnazija";Spindulėlis;5079107907;Taip;8;5;0;13
21000;"Vilniaus Jono Pauliaus II progimnazija";Spindulėlis;9908198854;Taip;0;4;0;4
21001;"Vilniaus Jono Pauliaus II progimnazija";Spindulėlis;6595165722;Taip;0;5;0;5
21002;Gluosnis;KIŠKUČIAI;6955695422;Taip;7;0;0;7
21003;Gluosnis;KIŠKUČIAI;1305651237;Taip;18;0;0;18
21004;Gluosnis;KIŠKUČIAI;4285562600;Taip;8;3;0;11
21005;Gluosnis;KIŠKUČIAI;5432102004;Taip;11;0;0;11
21006;Gluosnis;KIŠKUČIAI;8009719622;Taip;0;0;1;1
21007;Gluosnis;KIŠKUČIAI;9833971809;Taip;10;0;0;10
21008;Gluosnis;KIŠKUČIAI;6883663577;Taip;6;5;0;11
21009;Gluosnis;KIŠKUČIAI;1512855055;Taip;7;2;2;11
21010;Gluosnis;KIŠKUČIAI;8337313448;Taip;2;0;4;6
21011;Gluosnis;KIŠKUČIAI;4632419177;Taip;15;0;0;15
21012;Gluosnis;KIŠKUČIAI;6113153127;Taip;8;0;1;9
21013;Gluosnis;KIŠKUČIAI;7769522093;Taip;10;0;0;10
21014;Gluosnis;KIŠKUČIAI;8928597187;Taip;0;0;3;3
21015;Gluosnis;KIŠKUČIAI;9221983318;Taip;9;0;0;9
21016;Gluosnis;KIŠKUČIAI;2187312618;Taip;0;5;2;7
21017;Gluosnis;KIŠKUČIAI;5664156894;Taip;6;0;0;6
21018;Gluosnis;KIŠKUČIAI;7073637619;Taip;5;0;0;5
21019;Gluosnis;KIŠKUČIAI;1391404073;Taip;5;0;1;6
21020;Gluosnis;KIŠKUČIAI;4591550636;Taip;2;8;2;12
21021;Gluosnis;EŽIUKAI;4153713911;Ne;5;0;3;8
21022;Gluosnis;EŽIUKAI;5350702449;Taip;13;0;0;13
21023;Gluosnis;EŽIUKAI;3988305400;Taip;0;11;0;11
21024;Gluosnis;EŽIUKAI;9788278155;Taip;4;0;0;4
21025;Gluosnis;EŽIUKAI;7974944779;Taip;3;0;0;3
21026;Gluosnis;EŽIUKAI;7526020668;Taip;0;3;0;3
21027;Gluosnis;EŽIUKAI;5522411084;Taip;0;1;2;3
21028;Gluosnis;EŽIUKAI;5392759654;Ne;10;0;1;11
21029;Gluosnis;EŽIUKAI;6681653921;Taip;0;5;0;5
21030;Gluosnis;EŽIUKAI;4902627153;Taip;23;0;0;23
21031;Gluosnis;EŽIUKAI;2525780494;Taip;4;0;0;4
21032;Gluosnis;EŽIUKAI;9389736360;Taip;10;0;0;10
21033;Gluosnis;EŽIUKAI;2707855273;Taip;10;2;1;13
21034;Gluosnis;EŽIUKAI;7523459118;Taip;0;0;3;3
21035;Gluosnis;EŽIUKAI;2794163383;Ne;7;0;0;7
21036;Gluosnis;EŽIUKAI;7264550578;Taip;10;3;1;14
21037;Gluosnis;EŽIUKAI;5368171142;Taip;0;7;1;8
21038;Gluosnis;EŽIUKAI;6754799196;Taip;8;0;5;13
21039;Gluosnis;EŽIUKAI;9888037899;Taip;11;0;4;15
21040;Gluosnis;MEŠKIUKAI;8981904827;Taip;10;0;0;10
21041;Gluosnis;MEŠKIUKAI;8998776286;Taip;18;0;0;18
21042;Gluosnis;MEŠKIUKAI;1846499141;Taip;8;0;3;11
21043;Gluosnis;MEŠKIUKAI;7935750427;Taip;10;0;0;10
21044;Gluosnis;MEŠKIUKAI;4905002832;Taip;0;3;0;3
21045;Gluosnis;MEŠKIUKAI;9102081648;Ne;8;0;1;9
21046;Gluosnis;MEŠKIUKAI;4498429439;Taip;15;0;0;15
21047;Gluosnis;MEŠKIUKAI;8259160584;Taip;5;0;0;5
21048;Gluosnis;MEŠKIUKAI;1235091885;Taip;5;7;0;12
21049;Gluosnis;MEŠKIUKAI;1165636758;Taip;13;0;0;13
21050;Gluosnis;MEŠKIUKAI;8499748544;Taip;4;0;0;4
21051;Gluosnis;MEŠKIUKAI;2867319899;Taip;0;1;0;1
21052;Gluosnis;MEŠKIUKAI;9699577397;Taip;13;0;0;13
21053;Gluosnis;MEŠKIUKAI;4107344313;Taip;2;0;5;7
21054;Gluosnis;MEŠKIUKAI;1101472999;Taip;5;0;0;5
21055;Gluosnis;MEŠKIUKAI;7995558671;Taip;16;0;0;16
21056;Gluosnis;MEŠKIUKAI;1602556462;Taip;0;0;1;1
21057;Gluosnis;MEŠKIUKAI;8842139496;Taip;5;0;0;5
21058;Gluosnis;MEŠKIUKAI;4060859156;Taip;5;1;0;6
21059;Gluosnis;MEŠKIUKAI;6428753580;Taip;10;0;0;10
21060;Gluosnis;MEŠKIUKAI;3323237449;Taip;0;7;0;7
21061;Gluosnis;MEŠKIUKAI;3038732180;Taip;15;3;0;18
21062;Gluosnis;MEŠKIUKAI;1712795835;Taip;0;3;0;3
21063;Gluosnis;BORUŽĖLĖS;8840658383;Ne;16;0;0;16
21064;Gluosnis;BORUŽĖLĖS;1102935178;Taip;9;0;5;14
21065;Gluosnis;BORUŽĖLĖS;2167312808;Taip;10;0;0;10
21066;Gluosnis;BORUŽĖLĖS;4204797742;Taip;0;3;0;3
21067;Gluosnis;BORUŽĖLĖS;6302765948;Taip;7;0;1;8
21068;Gluosnis;BORUŽĖLĖS;9938235476;Taip;0;6;0;6
21069;Gluosnis;BORUŽĖLĖS;2945796648;Taip;3;0;0;3
21070;Gluosnis;BORUŽĖLĖS;4237053702;Ne;10;2;0;12
21071;Gluosnis;BORUŽĖLĖS;6320411660;Taip;0;10;0;10
21072;Gluosnis;BORUŽĖLĖS;7731887361;Taip;3;0;0;3
21073;Gluosnis;BORUŽĖLĖS;8502947568;Taip;0;0;1;1
21074;Gluosnis;BORUŽĖLĖS;1335152703;Taip;3;3;0;6
21075;Gluosnis;BORUŽĖLĖS;1314992969;Ne;0;0;3;3
21076;Gluosnis;BORUŽĖLĖS;7833136455;Taip;0;1;0;1
21077;Gluosnis;BORUŽĖLĖS;5556821953;Ne;6;0;1;7
21078;Gluosnis;BORUŽĖLĖS;2515646510;Taip;15;0;0;15
21079;Gluosnis;BORUŽĖLĖS;3212658311;Taip;0;10;0;10
21080;Gluosnis;BORUŽĖLĖS;2603201633;Taip;8;0;0;8
21081;Gluosnis;BORUŽĖLĖS;6086258054;Taip;4;3;0;7
21082;Gluosnis;BORUŽĖLĖS;1351519995;Taip;7;3;0;10
21083;Gluosnis;BORUŽĖLĖS;6960673767;Taip;12;0;0;12
21084;Gluosnis;LAPIUKAI;7025815772;Taip;17;0;0;17
21085;Gluosnis;LAPIUKAI;5266206726;Taip;23;0;0;23
21086;Gluosnis;LAPIUKAI;8976032500;Taip;0;0;2;2
21087;Gluosnis;LAPIUKAI;3190331209;Taip;0;0;1;1
21088;Gluosnis;LAPIUKAI;5376108804;Taip;19;0;1;20
21089;Gluosnis;LAPIUKAI;1664508998;Taip;3;0;3;6
21090;Gluosnis;LAPIUKAI;1296975213;Taip;16;0;1;17
21091;Gluosnis;LAPIUKAI;6518579198;Taip;8;0;7;15
21092;Gluosnis;LAPIUKAI;5633386146;Taip;0;0;15;15
21093;Gluosnis;LAPIUKAI;4280829038;Ne;13;0;0;13
21094;Gluosnis;LAPIUKAI;6273179300;Taip;0;0;7;7
21095;Gluosnis;LAPIUKAI;7090336454;Taip;0;5;0;5
21096;Gluosnis;PELĖDŽIUKAI;1933496033;Taip;0;1;0;1
21097;Gluosnis;PELĖDŽIUKAI;8259035822;Taip;0;4;0;4
21098;Gluosnis;PELĖDŽIUKAI;4960167173;Taip;5;0;0;5
21099;Gluosnis;PELĖDŽIUKAI;6163009686;Taip;0;4;0;4
21100;Gluosnis;PELĖDŽIUKAI;1671693932;Taip;0;3;6;9
21101;Gluosnis;PELĖDŽIUKAI;4005023841;Ne;0;3;4;7
21102;Gluosnis;PELĖDŽIUKAI;6865973084;Taip;0;1;0;1
21103;Gluosnis;PELĖDŽIUKAI;1298724775;Ne;0;2;0;2
21104;Gluosnis;PELĖDŽIUKAI;1185903576;Taip;0;0;1;1
21105;Gluosnis;PELĖDŽIUKAI;7537587118;Taip;4;2;3;9
21106;Gluosnis;PELĖDŽIUKAI;7075070566;Taip;0;1;1;2
21107;Gluosnis;PELĖDŽIUKAI;3434902234;Taip;0;0;4;4
21108;Gluosnis;PELĖDŽIUKAI;6944918504;Taip;0;2;11;13
21109;Gluosnis;PELĖDŽIUKAI;7842723958;Taip;0;1;0;1
21110;Gluosnis;PELĖDŽIUKAI;94487630173;Ne;16;0;0;16
21111;Gluosnis;VOVERIUKAI;6747244713;Taip;4;0;0;4
21112;Gluosnis;VOVERIUKAI;3900322680;Taip;8;0;0;8
21113;Gluosnis;VOVERIUKAI;2423433989;Taip;5;0;10;15
21114;Gluosnis;VOVERIUKAI;1263019496;Taip;18;0;0;18
21115;Gluosnis;VOVERIUKAI;4564193030;Taip;0;1;0;1
21116;Gluosnis;VOVERIUKAI;4224637208;Taip;9;0;1;10
21117;Gluosnis;VOVERIUKAI;1144177849;Taip;9;0;1;10
21118;Gluosnis;VOVERIUKAI;6729016081;Taip;11;0;1;12
21119;Gluosnis;VOVERIUKAI;4069584911;Taip;4;0;0;4
21120;Gluosnis;VOVERIUKAI;6119618742;Taip;15;0;0;15
21121;Gluosnis;VOVERIUKAI;2794080237;Taip;8;2;0;10
21122;Gluosnis;VOVERIUKAI;5623135790;Taip;13;0;0;13
21123;Gluosnis;VOVERIUKAI;2310874591;Taip;18;2;0;20
21124;Gluosnis;VOVERIUKAI;5210930032;Taip;15;0;0;15
21125;Gluosnis;VOVERIUKAI;5008836118;Taip;10;0;1;11
21126;Gluosnis;VOVERIUKAI;4361177196;Taip;19;0;0;19
21127;Gluosnis;VOVERIUKAI;9484423786;Taip;8;0;2;10
21128;Gluosnis;VOVERIUKAI;8109714321;Ne;15;0;0;15
21129;Gluosnis;DRUGELIAI;5949954525;Taip;6;0;1;7
21130;Gluosnis;DRUGELIAI;1716235604;Taip;5;1;0;6
21131;Gluosnis;DRUGELIAI;4125830926;Taip;0;12;0;12
21132;Gluosnis;DRUGELIAI;6358187113;Taip;5;0;5;10
21133;Gluosnis;DRUGELIAI;9084785666;Taip;9;0;0;9
21134;Gluosnis;DRUGELIAI;4940563623;Taip;3;0;2;5
21135;Gluosnis;DRUGELIAI;1113731535;Taip;0;4;0;4
21136;Gluosnis;DRUGELIAI;4653963373;Taip;4;1;0;5
21137;Gluosnis;DRUGELIAI;8314366921;Taip;8;0;0;8
21138;Gluosnis;DRUGELIAI;4220504133;Taip;0;0;5;5
21139;Gluosnis;DRUGELIAI;9931766935;Taip;6;5;3;14
21140;Gluosnis;DRUGELIAI;3527418865;Taip;18;0;0;18
21141;Gluosnis;DRUGELIAI;6914171069;Taip;8;0;4;12
21142;Gluosnis;DRUGELIAI;1848647593;Taip;10;3;0;13
21143;Gluosnis;DRUGELIAI;5943955268;Taip;14;0;2;16
21144;Gluosnis;DRUGELIAI;8690911930;Taip;12;0;0;12
21145;Gluosnis;DRUGELIAI;1543842220;Taip;8;0;0;8
21146;Gluosnis;DRUGELIAI;1787206205;Taip;8;1;0;9
21147;Gluosnis;BITUTĖS;4176300773;Taip;13;0;0;13
21148;Gluosnis;BITUTĖS;2554790908;Taip;7;1;0;8
21149;Gluosnis;BITUTĖS;8281499182;Taip;5;0;2;7
21150;Gluosnis;BITUTĖS;2403029153;Taip;2;2;0;4
21151;Gluosnis;BITUTĖS;6432475763;Taip;0;0;1;1
21152;Gluosnis;BITUTĖS;9542889575;Taip;5;0;0;5
21153;Gluosnis;BITUTĖS;1966484574;Taip;2;3;2;7
21154;Gluosnis;BITUTĖS;4353195155;Taip;0;8;2;10
21155;Gluosnis;BITUTĖS;5889360726;Taip;0;0;2;2
21156;Gluosnis;BITUTĖS;8035097045;Ne;3;0;4;7
21157;Gluosnis;BITUTĖS;3362089746;Taip;0;3;3;6
21158;Gluosnis;BITUTĖS;7390361159;Taip;13;0;0;13
21159;Gluosnis;BITUTĖS;8380310240;Taip;10;3;0;13
21160;Gluosnis;BITUTĖS;4481544177;Taip;5;0;0;5
21161;Gluosnis;BITUTĖS;3673702157;Taip;10;0;1;11
21162;Gluosnis;BITUTĖS;9098141563;Taip;5;0;5;10
21163;Gluosnis;BITUTĖS;9201769624;Taip;0;3;1;4
21164;Gluosnis;BITUTĖS;1306381382;Taip;2;0;0;2
21165;Gluosnis;BITUTĖS;6767500085;Ne;8;0;0;8
21166;Gluosnis;BITUTĖS;6001358241;Taip;15;0;2;17
21167;Gluosnis;BITUTĖS;5380755693;Ne;6;3;3;12
21168;Gluosnis;BITUTĖS;6197840105;Taip;0;1;0;1
21169;Gluosnis;BITUTĖS;5204445760;Ne;1;0;0;1
21170;"Vilniaus Saulėtekio mokykla-daugiafunkcinis centras";Priešmokyklinė;3661928980;Taip;0;0;2;2
21171;"Vilniaus Saulėtekio mokykla-daugiafunkcinis centras";Priešmokyklinė;1029813471;Taip;0;3;0;3
21172;"Vilniaus Saulėtekio mokykla-daugiafunkcinis centras";Priešmokyklinė;8760467524;Taip;10;3;1;14
21173;"Vilniaus Saulėtekio mokykla-daugiafunkcinis centras";Priešmokyklinė;6738279023;Taip;0;9;0;9
21174;"Vilniaus Saulėtekio mokykla-daugiafunkcinis centras";Priešmokyklinė;1739797553;Taip;0;3;0;3
21175;"Vilniaus Saulėtekio mokykla-daugiafunkcinis centras";Priešmokyklinė;2159833613;Taip;0;7;0;7
21176;"Vilniaus Saulėtekio mokykla-daugiafunkcinis centras";Priešmokyklinė;1193336600;Taip;0;7;0;7
21177;"Vilniaus Saulėtekio mokykla-daugiafunkcinis centras";Priešmokyklinė;5914721966;Taip;0;3;1;4
21178;"Vilniaus Saulėtekio mokykla-daugiafunkcinis centras";Priešmokyklinė;8852228006;Ne;0;3;0;3
21179;"Vilniaus Saulėtekio mokykla-daugiafunkcinis centras";Priešmokyklinė;4159716896;Taip;0;3;1;4
21180;"Vilniaus Saulėtekio mokykla-daugiafunkcinis centras";Priešmokyklinė;1667714484;Taip;6;3;0;9
21181;"Vilniaus Saulėtekio mokykla-daugiafunkcinis centras";Priešmokyklinė;6589058061;Taip;0;3;1;4
21182;"Vilniaus Saulėtekio mokykla-daugiafunkcinis centras";Priešmokyklinė;3048310276;Taip;0;12;0;12
21183;"Vilniaus Saulėtekio mokykla-daugiafunkcinis centras";Priešmokyklinė;6991187086;Ne;0;3;1;4
21184;"Vilniaus Saulėtekio mokykla-daugiafunkcinis centras";Priešmokyklinė;1698381959;Taip;0;5;0;5
21185;"Vilniaus Saulėtekio mokykla-daugiafunkcinis centras";Priešmokyklinė;2500332755;Taip;0;3;0;3
21186;"Vilniaus Saulėtekio mokykla-daugiafunkcinis centras";Priešmokyklinė;2074102166;Taip;0;3;3;6
21187;"Vilniaus Saulėtekio mokykla-daugiafunkcinis centras";Priešmokyklinė;2906786855;Taip;0;3;1;4
21188;"Vilniaus Saulėtekio mokykla-daugiafunkcinis centras";Priešmokyklinė;3108520221;Taip;0;13;0;13
21189;"Vilniaus Saulėtekio mokykla-daugiafunkcinis centras";Priešmokyklinė;8815534200;Ne;13;3;1;17
21190;"Vilniaus Saulėtekio mokykla-daugiafunkcinis centras";Priešmokyklinė;4751570183;Taip;0;5;0;5
21191;"Vilniaus Saulėtekio mokykla-daugiafunkcinis centras";Priešmokyklinė;9164075226;Ne;0;5;0;5
21192;"Vilniaus Saulėtekio mokykla-daugiafunkcinis centras";Priešmokyklinė;2020364455;Taip;0;3;0;3
21193;"Vilniaus Saulėtekio mokykla-daugiafunkcinis centras";Priešmokyklinė;4787974814;Taip;3;3;2;8
21194;"Vilniaus Saulėtekio mokykla-daugiafunkcinis centras";Priešmokyklinė;6553762186;Taip;0;16;0;16
21195;"Vilniaus Saulėtekio mokykla-daugiafunkcinis centras";Priešmokyklinė;9057726203;Taip;13;4;0;17
21196;"Vilniaus Saulėtekio mokykla-daugiafunkcinis centras";Priešmokyklinė;6492909546;Taip;0;3;0;3
21197;"Vilniaus Saulėtekio mokykla-daugiafunkcinis centras";"PRIEŠMOKYKLINĖ 2";9963290362;Ne;0;3;1;4
21198;"Vilniaus Saulėtekio mokykla-daugiafunkcinis centras";"PRIEŠMOKYKLINĖ 2";1342094235;Taip;0;3;2;5
21199;"Vilniaus Saulėtekio mokykla-daugiafunkcinis centras";"PRIEŠMOKYKLINĖ 2";2628936055;Taip;1;4;0;5
21200;"Vilniaus Saulėtekio mokykla-daugiafunkcinis centras";"PRIEŠMOKYKLINĖ 2";1224648193;Taip;4;3;0;7
21201;"Vilniaus Saulėtekio mokykla-daugiafunkcinis centras";"PRIEŠMOKYKLINĖ 2";4542122478;Taip;2;3;3;8
21202;"Vilniaus Saulėtekio mokykla-daugiafunkcinis centras";"PRIEŠMOKYKLINĖ 2";7180555146;Taip;12;3;0;15
21203;"Vilniaus Saulėtekio mokykla-daugiafunkcinis centras";"PRIEŠMOKYKLINĖ 2";4010917080;Taip;1;3;1;5
21204;"Vilniaus Saulėtekio mokykla-daugiafunkcinis centras";"PRIEŠMOKYKLINĖ 2";5927071864;Taip;0;3;0;3
21205;"Vilniaus Saulėtekio mokykla-daugiafunkcinis centras";"PRIEŠMOKYKLINĖ 2";4970499391;Ne;3;3;4;10
21206;"Vilniaus Saulėtekio mokykla-daugiafunkcinis centras";"PRIEŠMOKYKLINĖ 2";6593824471;Ne;15;3;1;19
21207;"Vilniaus Saulėtekio mokykla-daugiafunkcinis centras";"PRIEŠMOKYKLINĖ 2";8669346247;Taip;0;3;4;7
21208;"Vilniaus Saulėtekio mokykla-daugiafunkcinis centras";"PRIEŠMOKYKLINĖ 2";1924079984;Taip;0;3;4;7
21209;"Vilniaus Saulėtekio mokykla-daugiafunkcinis centras";"PRIEŠMOKYKLINĖ 2";5590376570;Ne;3;3;0;6
21210;"Vilniaus Saulėtekio mokykla-daugiafunkcinis centras";"PRIEŠMOKYKLINĖ 2";8766410254;Taip;0;3;0;3
21211;"Vilniaus Saulėtekio mokykla-daugiafunkcinis centras";"PRIEŠMOKYKLINĖ 2";4151582358;Taip;0;3;0;3
21212;"Vilniaus Saulėtekio mokykla-daugiafunkcinis centras";"PRIEŠMOKYKLINĖ 2";1376656872;Taip;5;3;3;11
21213;"Vilniaus Saulėtekio mokykla-daugiafunkcinis centras";"PRIEŠMOKYKLINĖ 2";3639632543;Taip;0;4;0;4
21214;"Vilniaus Saulėtekio mokykla-daugiafunkcinis centras";"PRIEŠMOKYKLINĖ 2";6865962441;Taip;0;4;0;4
21215;"Vilniaus Saulėtekio mokykla-daugiafunkcinis centras";"PRIEŠMOKYKLINĖ 2";3982877012;Taip;6;3;1;10
21216;"Vilniaus Saulėtekio mokykla-daugiafunkcinis centras";"PRIEŠMOKYKLINĖ 2";1660650556;Taip;0;12;0;12
21217;"Vilniaus Saulėtekio mokykla-daugiafunkcinis centras";"PRIEŠMOKYKLINĖ 2";4890393582;Taip;0;3;0;3
21218;"Vilniaus Saulėtekio mokykla-daugiafunkcinis centras";"PRIEŠMOKYKLINĖ 2";5304096806;Taip;0;3;2;5
21219;"Vilniaus Saulėtekio mokykla-daugiafunkcinis centras";"PRIEŠMOKYKLINĖ 2";1648983304;Taip;5;3;0;8
21220;"Vilniaus Saulėtekio mokykla-daugiafunkcinis centras";"PRIEŠMOKYKLINĖ 2";1913663230;Taip;0;6;0;6
21221;"Vilniaus Saulėtekio mokykla-daugiafunkcinis centras";"PRIEŠMOKYKLINĖ 2";1543123485;Taip;0;3;1;4
21222;"Vilniaus Saulėtekio mokykla-daugiafunkcinis centras";"PRIEŠMOKYKLINĖ 2";4176208765;Taip;14;5;0;19
21223;"Vilniaus Saulėtekio mokykla-daugiafunkcinis centras";"PRIEŠMOKYKLINĖ 2";8458361084;Taip;0;3;1;4
21224;"Vilniaus „Genio“ progimnazija";NYKŠTUKAI;6545116373;Taip;0;4;0;4
21225;"Vilniaus „Genio“ progimnazija";NYKŠTUKAI;1666616466;Taip;0;6;0;6
21226;"Vilniaus „Genio“ progimnazija";NYKŠTUKAI;3008272979;Taip;0;6;0;6
21227;"Vilniaus „Genio“ progimnazija";NYKŠTUKAI;96416364735;Taip;0;4;0;4
21228;"Vilniaus „Genio“ progimnazija";NYKŠTUKAI;2036966277;Taip;0;4;0;4
21229;"Vilniaus „Genio“ progimnazija";NYKŠTUKAI;1807466584;Taip;12;4;1;17
21230;"Vilniaus „Genio“ progimnazija";NYKŠTUKAI;4680264973;Taip;0;4;0;4
21231;"Vilniaus „Genio“ progimnazija";NYKŠTUKAI;5850506831;Taip;0;5;0;5
21232;"Vilniaus „Genio“ progimnazija";NYKŠTUKAI;3667800006;Taip;0;4;0;4
21233;"Vilniaus „Genio“ progimnazija";NYKŠTUKAI;2176438968;Taip;0;4;0;4
21234;"Vilniaus „Genio“ progimnazija";NYKŠTUKAI;7509276953;Taip;0;4;1;5
21235;"Vilniaus „Genio“ progimnazija";NYKŠTUKAI;1258769646;Taip;0;4;0;4
21236;"Vilniaus „Genio“ progimnazija";NYKŠTUKAI;2593226897;Ne;13;5;0;18
21237;"Vilniaus „Genio“ progimnazija";NYKŠTUKAI;7005815238;Ne;0;5;0;5
21238;"Vilniaus „Genio“ progimnazija";NYKŠTUKAI;3333552585;Taip;0;4;0;4
21239;"Vilniaus „Genio“ progimnazija";NYKŠTUKAI;5372809413;Taip;2;4;0;6
21240;"Vilniaus „Genio“ progimnazija";NYKŠTUKAI;1089753966;Taip;0;4;0;4
21241;"Vilniaus „Genio“ progimnazija";NYKŠTUKAI;6154837614;Taip;0;4;1;5
21242;"Vilniaus „Genio“ progimnazija";NYKŠTUKAI;2865995680;Taip;0;12;0;12
21243;"Vilniaus „Genio“ progimnazija";NYKŠTUKAI;1432694920;Taip;4;12;0;16
21244;"Vilniaus „Genio“ progimnazija";NYKŠTUKAI;1663216529;Taip;0;4;0;4
21245;"Gintarėlis (Popieriaus g. 46A)";SKRUZDĖLIUKAI;6162836315;Taip;0;9;0;9
21246;"Gintarėlis (Popieriaus g. 46A)";SKRUZDĖLIUKAI;3825572125;Taip;3;1;0;4
21247;"Gintarėlis (Popieriaus g. 46A)";SKRUZDĖLIUKAI;5738933125;Taip;0;16;0;16
21248;"Gintarėlis (Popieriaus g. 46A)";SKRUZDĖLIUKAI;1994856959;Taip;4;2;0;6
21249;"Gintarėlis (Popieriaus g. 46A)";SKRUZDĖLIUKAI;8223747534;Taip;8;0;0;8
21250;"Gintarėlis (Popieriaus g. 46A)";SKRUZDĖLIUKAI;1045355492;Taip;4;2;2;8
21251;"Gintarėlis (Popieriaus g. 46A)";SKRUZDĖLIUKAI;6193540660;Ne;11;0;0;11
21252;"Gintarėlis (Popieriaus g. 46A)";SKRUZDĖLIUKAI;3459439843;Taip;8;13;0;21
21253;"Gintarėlis (Popieriaus g. 46A)";SKRUZDĖLIUKAI;7916257692;Taip;5;2;1;8
21254;"Gintarėlis (Popieriaus g. 46A)";SKRUZDĖLIUKAI;7510541192;Taip;2;2;0;4
21255;"Gintarėlis (Popieriaus g. 46A)";SKRUZDĖLIUKAI;9045108717;Taip;0;18;0;18
21256;"Gintarėlis (Popieriaus g. 46A)";SKRUZDĖLIUKAI;1955719034;Taip;11;2;2;15
21257;"Gintarėlis (Popieriaus g. 46A)";SKRUZDĖLIUKAI;1215549844;Taip;12;1;0;13
21258;"Gintarėlis (Popieriaus g. 46A)";SKRUZDĖLIUKAI;5379858630;Taip;0;0;12;12
21259;"Gintarėlis (Popieriaus g. 46A)";SKRUZDĖLIUKAI;5961603860;Taip;0;10;0;10
21260;"Gintarėlis (Popieriaus g. 46A)";SKRUZDĖLIUKAI;8068499156;Taip;0;4;0;4
21261;"Gintarėlis (Popieriaus g. 46A)";PELĖDŽIUKAI;6506180216;Taip;0;6;0;6
21262;"Gintarėlis (Popieriaus g. 46A)";PELĖDŽIUKAI;9200073539;Ne;16;1;0;17
21263;"Gintarėlis (Popieriaus g. 46A)";PELĖDŽIUKAI;3254739432;Taip;7;0;1;8
21264;"Gintarėlis (Popieriaus g. 46A)";PELĖDŽIUKAI;8019543081;Taip;0;3;0;3
21265;"Gintarėlis (Popieriaus g. 46A)";PELĖDŽIUKAI;1628276472;Taip;0;3;0;3
21266;"Gintarėlis (Popieriaus g. 46A)";PELĖDŽIUKAI;5223116373;Taip;10;2;2;14
21267;"Gintarėlis (Popieriaus g. 46A)";PELĖDŽIUKAI;8792175474;Ne;16;0;0;16
21268;"Gintarėlis (Popieriaus g. 46A)";PELĖDŽIUKAI;3304191482;Taip;15;2;1;18
21269;"Gintarėlis (Popieriaus g. 46A)";PELĖDŽIUKAI;4181430769;Taip;4;0;0;4
21270;"Gintarėlis (Popieriaus g. 46A)";PELĖDŽIUKAI;3202819190;Taip;0;0;11;11
21271;"Gintarėlis (Popieriaus g. 46A)";PELĖDŽIUKAI;9807784148;Ne;12;2;2;16
21272;"Gintarėlis (Popieriaus g. 46A)";PELĖDŽIUKAI;2546360134;Taip;8;0;0;8
21273;"Gintarėlis (Popieriaus g. 46A)";PELĖDŽIUKAI;2308673417;Taip;1;0;0;1
21274;"Gintarėlis (Popieriaus g. 46A)";PELĖDŽIUKAI;6883573289;Ne;5;2;3;10
21275;"Gintarėlis (Popieriaus g. 46A)";PELĖDŽIUKAI;3127881266;Taip;11;0;1;12
21276;"Gintarėlis (Popieriaus g. 46A)";PELĖDŽIUKAI;2052962147;Taip;8;0;1;9
21277;"Gintarėlis (Popieriaus g. 46A)";"LINKSMASIS AVILYS";7872515649;Taip;0;2;0;2
21278;"Gintarėlis (Popieriaus g. 46A)";"LINKSMASIS AVILYS";7256557310;Taip;0;4;0;4
21279;"Gintarėlis (Popieriaus g. 46A)";"LINKSMASIS AVILYS";6425840559;Taip;0;0;13;13
21280;"Gintarėlis (Popieriaus g. 46A)";"LINKSMASIS AVILYS";3572188688;Taip;4;0;7;11
21281;"Gintarėlis (Popieriaus g. 46A)";"LINKSMASIS AVILYS";7010430969;Taip;0;2;1;3
21282;"Gintarėlis (Popieriaus g. 46A)";"LINKSMASIS AVILYS";1070119148;Taip;0;10;0;10
21283;"Gintarėlis (Popieriaus g. 46A)";"LINKSMASIS AVILYS";9182625265;Taip;0;1;0;1
21284;"Gintarėlis (Popieriaus g. 46A)";"LINKSMASIS AVILYS";3738678648;Taip;0;4;0;4
21285;"Gintarėlis (Popieriaus g. 46A)";"LINKSMASIS AVILYS";77906464117;Taip;0;3;0;3
21286;"Gintarėlis (Popieriaus g. 46A)";"LINKSMASIS AVILYS";2737144359;Taip;0;1;0;1
21287;"Gintarėlis (Popieriaus g. 46A)";"LINKSMASIS AVILYS";9257812097;Taip;12;0;0;12
21288;"Gintarėlis (Popieriaus g. 46A)";"LINKSMASIS AVILYS";8680339493;Taip;4;2;2;8
21289;"Gintarėlis (Popieriaus g. 46A)";Varliukai;6821929306;Taip;3;1;4;8
21290;"Gintarėlis (Popieriaus g. 46A)";Varliukai;7274616480;Taip;8;0;0;8
21291;"Gintarėlis (Popieriaus g. 46A)";Varliukai;1362980885;Taip;7;10;0;17
21292;"Gintarėlis (Popieriaus g. 46A)";Varliukai;9762364250;Taip;7;3;0;10
21293;"Gintarėlis (Popieriaus g. 46A)";Varliukai;6849227110;Taip;0;6;0;6
21294;"Gintarėlis (Popieriaus g. 46A)";Varliukai;4263315669;Taip;15;0;0;15
21295;"Gintarėlis (Popieriaus g. 46A)";Varliukai;5190355636;Taip;9;0;0;9
21296;"Gintarėlis (Popieriaus g. 46A)";Varliukai;4290033336;Taip;3;0;0;3
21297;"Gintarėlis (Popieriaus g. 46A)";Varliukai;6081634102;Taip;11;0;0;11
21298;"Gintarėlis (Popieriaus g. 46A)";Varliukai;7206593645;Ne;0;0;14;14
21299;"Gintarėlis (Popieriaus g. 46A)";Varliukai;7400455090;Taip;0;18;0;18
21300;"Gintarėlis (Popieriaus g. 46A)";Varliukai;3702588434;Taip;15;0;6;21
21301;"Gintarėlis (Popieriaus g. 46A)";Varliukai;7413074674;Ne;8;1;2;11
21302;"Gintarėlis (Popieriaus g. 46A)";Varliukai;7031945895;Taip;0;7;0;7
21303;"Gintarėlis (Popieriaus g. 46A)";Varliukai;6514247750;Taip;14;0;0;14
21304;"Gintarėlis (Popieriaus g. 46A)";Varliukai;1166720069;Taip;8;0;0;8
21305;"Gintarėlis (Popieriaus g. 46A)";Varliukai;4556644354;Taip;14;0;0;14
21306;"Pušynėlis (A. Mickevičiaus g. 21)";DAIGIUKAI;5317547220;Taip;4;0;0;4
21307;"Pušynėlis (A. Mickevičiaus g. 21)";DAIGIUKAI;9025539389;Taip;13;0;0;13
21308;"Pušynėlis (A. Mickevičiaus g. 21)";DAIGIUKAI;5512586591;Taip;15;0;3;18
21309;"Pušynėlis (A. Mickevičiaus g. 21)";DAIGIUKAI;6594473055;Taip;7;1;6;14
21310;"Pušynėlis (A. Mickevičiaus g. 21)";DAIGIUKAI;8211464695;Taip;5;0;0;5
21311;"Pušynėlis (A. Mickevičiaus g. 21)";DAIGIUKAI;6321178561;Taip;0;6;0;6
21312;"Pušynėlis (A. Mickevičiaus g. 21)";DAIGIUKAI;8457384507;Ne;3;0;4;7
21313;"Pušynėlis (A. Mickevičiaus g. 21)";DAIGIUKAI;1085678424;Taip;5;0;1;6
21314;"Pušynėlis (A. Mickevičiaus g. 21)";DAIGIUKAI;4685125111;Taip;8;0;0;8
21315;"Pušynėlis (A. Mickevičiaus g. 21)";DAIGIUKAI;9717473430;Taip;5;1;0;6
21316;"Pušynėlis (A. Mickevičiaus g. 21)";DAIGIUKAI;2763762463;Taip;0;1;0;1
21317;"Pušynėlis (A. Mickevičiaus g. 21)";NYKŠTUKAI;1050710006;Ne;0;0;3;3
21318;"Pušynėlis (A. Mickevičiaus g. 21)";NYKŠTUKAI;1758632291;Ne;12;1;0;13
21319;"Pušynėlis (A. Mickevičiaus g. 21)";NYKŠTUKAI;8699085292;Taip;12;0;0;12
21320;"Pušynėlis (A. Mickevičiaus g. 21)";NYKŠTUKAI;8327830781;Taip;0;0;10;10
21321;"Pušynėlis (A. Mickevičiaus g. 21)";NYKŠTUKAI;8820865805;Taip;8;2;0;10
21322;"Pušynėlis (A. Mickevičiaus g. 21)";NYKŠTUKAI;1177938753;Taip;8;1;2;11
21323;"Pušynėlis (A. Mickevičiaus g. 21)";NYKŠTUKAI;9450347140;Taip;11;4;0;15
21324;"Pušynėlis (A. Mickevičiaus g. 21)";NYKŠTUKAI;2222790161;Taip;0;6;0;6
21325;"Pušynėlis (A. Mickevičiaus g. 21)";NYKŠTUKAI;7596876368;Taip;7;1;3;11
21326;"Pušynėlis (A. Mickevičiaus g. 21)";NYKŠTUKAI;2892213973;Taip;2;1;1;4
21327;"Pušynėlis (A. Mickevičiaus g. 21)";NYKŠTUKAI;7429853563;Ne;8;8;0;16
21328;"Pušynėlis (A. Mickevičiaus g. 21)";NYKŠTUKAI;8464672994;Taip;11;1;0;12
21329;"Pušynėlis (A. Mickevičiaus g. 21)";NYKŠTUKAI;1904434730;Taip;0;0;6;6
21330;"Pušynėlis (A. Mickevičiaus g. 21)";NYKŠTUKAI;3574446664;Ne;0;2;3;5
21331;"Pušynėlis (A. Mickevičiaus g. 21)";NYKŠTUKAI;3362971538;Taip;18;0;0;18
21332;"Pušynėlis (A. Mickevičiaus g. 21)";NYKŠTUKAI;9055713601;Taip;5;0;0;5
21333;"Pušynėlis (A. Mickevičiaus g. 21)";NYKŠTUKAI;5364537212;Taip;5;1;6;12
21334;"Pušynėlis (A. Mickevičiaus g. 21)";NYKŠTUKAI;8839614928;Taip;0;0;6;6
21335;"Pušynėlis (A. Mickevičiaus g. 21)";GILIUKAI;9401101407;Taip;0;2;0;2
21336;"Pušynėlis (A. Mickevičiaus g. 21)";GILIUKAI;9517319856;Taip;0;4;0;4
21337;"Pušynėlis (A. Mickevičiaus g. 21)";GILIUKAI;9028515427;Taip;0;1;0;1
21338;"Pušynėlis (A. Mickevičiaus g. 21)";GILIUKAI;2825756894;Taip;8;10;1;19
21339;"Pušynėlis (A. Mickevičiaus g. 21)";GILIUKAI;1134325833;Taip;0;3;0;3
21340;"Pušynėlis (A. Mickevičiaus g. 21)";GILIUKAI;3158789663;Taip;0;1;0;1
21341;"Pušynėlis (A. Mickevičiaus g. 21)";GILIUKAI;5668765825;Taip;10;3;1;14
21342;"Pušynėlis (A. Mickevičiaus g. 21)";GILIUKAI;7685809238;Taip;5;1;0;6
21343;"Pušynėlis (A. Mickevičiaus g. 21)";GILIUKAI;2712755125;Taip;0;1;0;1
21344;"Pušynėlis (A. Mickevičiaus g. 21)";GILIUKAI;7011836009;Taip;0;10;0;10
21345;"Pušynėlis (A. Mickevičiaus g. 21)";GILIUKAI;3301741162;Taip;0;2;0;2
21346;"Pušynėlis (A. Mickevičiaus g. 21)";GILIUKAI;6735037523;Taip;8;3;3;14
21347;"Pušynėlis (A. Mickevičiaus g. 21)";GILIUKAI;7881263225;Taip;0;11;0;11
21348;"Pušynėlis (A. Mickevičiaus g. 21)";GILIUKAI;1612049897;Taip;0;4;0;4
21349;"Pušynėlis (A. Mickevičiaus g. 21)";GILIUKAI;9920959446;Taip;0;1;0;1
21350;"Pušynėlis (A. Mickevičiaus g. 21)";GILIUKAI;4898147530;Taip;0;0;1;1
21351;"Pušynėlis (A. Mickevičiaus g. 21)";GILIUKAI;2228682366;Ne;0;7;0;7
21352;"Pušynėlis (A. Mickevičiaus g. 21)";GILIUKAI;4464615995;Taip;0;2;0;2
21353;"Naminukas (Klinikų g. 5)";VARPELIAI;2089455192;Taip;12;3;0;15
21354;"Naminukas (Klinikų g. 5)";VARPELIAI;3281707263;Ne;0;0;1;1
21355;"Naminukas (Klinikų g. 5)";VARPELIAI;1828220049;Taip;8;0;2;10
21356;"Naminukas (Klinikų g. 5)";VARPELIAI;7328682222;Taip;0;0;5;5
21357;"Naminukas (Klinikų g. 5)";VARPELIAI;7772300667;Taip;15;0;0;15
21358;"Naminukas (Klinikų g. 5)";VARPELIAI;1086919259;Taip;19;0;0;19
21359;"Naminukas (Klinikų g. 5)";VARPELIAI;3938225198;Taip;7;0;1;8
21360;"Naminukas (Klinikų g. 5)";VARPELIAI;5991261279;Taip;14;0;4;18
21361;"Naminukas (Klinikų g. 5)";VARPELIAI;8694425584;Taip;0;0;4;4
21362;"Naminukas (Klinikų g. 5)";VARPELIAI;5172385044;Taip;19;0;0;19
21363;"Naminukas (Klinikų g. 5)";VARPELIAI;5465843371;Taip;8;3;1;12
21364;"Naminukas (Klinikų g. 5)";VARPELIAI;6515021073;Taip;12;0;1;13
21365;"Naminukas (Klinikų g. 5)";VARPELIAI;9894306360;Taip;8;0;1;9
21366;"Naminukas (Klinikų g. 5)";VARPELIAI;8052458976;Taip;16;0;0;16
21367;"Naminukas (Klinikų g. 5)";SAULUTĖS;9212800864;Ne;0;6;0;6
21368;"Naminukas (Klinikų g. 5)";SAULUTĖS;9215327479;Taip;6;0;0;6
21369;"Naminukas (Klinikų g. 5)";SAULUTĖS;7947598191;Taip;0;0;1;1
21370;"Naminukas (Klinikų g. 5)";SAULUTĖS;3911352454;Taip;9;0;3;12
21371;"Naminukas (Klinikų g. 5)";SAULUTĖS;7107337857;Taip;0;0;3;3
21372;"Naminukas (Klinikų g. 5)";SAULUTĖS;3079900548;Taip;22;0;0;22
21373;"Naminukas (Klinikų g. 5)";SAULUTĖS;2516513740;Taip;0;1;1;2
21374;"Naminukas (Klinikų g. 5)";SAULUTĖS;1879925655;Taip;5;5;1;11
21375;"Naminukas (Klinikų g. 5)";SAULUTĖS;2881576194;Ne;10;0;4;14
21376;"Naminukas (Klinikų g. 5)";SAULUTĖS;6901818921;Taip;5;5;0;10
21377;"Naminukas (Klinikų g. 5)";SAULUTĖS;4836599508;Taip;0;0;9;9
21378;"Naminukas (Klinikų g. 5)";SAULUTĖS;1563213488;Taip;8;0;1;9
21379;"Naminukas (Klinikų g. 5)";SAULUTĖS;4709625816;Ne;0;0;2;2
21380;"Naminukas (Klinikų g. 5)";SAULUTĖS;6471277755;Taip;0;0;6;6
21381;"Naminukas (Klinikų g. 5)";SAULUTĖS;1932169696;Taip;18;0;0;18
21382;"Naminukas (Klinikų g. 5)";DRUGELIAI;2339599448;Taip;0;8;0;8
21383;"Naminukas (Klinikų g. 5)";DRUGELIAI;4077985773;Taip;0;3;4;7
21384;"Naminukas (Klinikų g. 5)";DRUGELIAI;3276656641;Taip;0;0;7;7
21385;"Naminukas (Klinikų g. 5)";DRUGELIAI;4116151797;Ne;0;0;4;4
21386;"Naminukas (Klinikų g. 5)";DRUGELIAI;7033053271;Taip;7;0;1;8
21387;"Naminukas (Klinikų g. 5)";DRUGELIAI;1454039572;Ne;8;0;1;9
21388;"Naminukas (Klinikų g. 5)";DRUGELIAI;7184471307;Taip;0;0;3;3
21389;"Naminukas (Klinikų g. 5)";DRUGELIAI;6949857110;Taip;0;6;0;6
21390;"Naminukas (Klinikų g. 5)";DRUGELIAI;8432194383;Taip;0;3;0;3
21391;"Naminukas (Klinikų g. 5)";DRUGELIAI;7463647806;Taip;4;0;6;10
21392;"Naminukas (Klinikų g. 5)";DRUGELIAI;4171789569;Taip;0;10;10;20
21393;"Naminukas (Klinikų g. 5)";DRUGELIAI;6880075874;Taip;0;3;0;3
21394;"Naminukas (Klinikų g. 5)";DRUGELIAI;8793327541;Taip;0;1;0;1
21395;"Naminukas (Klinikų g. 5)";DRUGELIAI;9835701381;Ne;0;0;4;4
21396;"Naminukas (Klinikų g. 5)";BITUTĖS;21152690883;Taip;2;3;0;5
21397;"Naminukas (Klinikų g. 5)";BITUTĖS;1528496272;Taip;0;3;0;3
21398;"Naminukas (Klinikų g. 5)";BITUTĖS;92417802345;Taip;0;0;1;1
21399;"Naminukas (Klinikų g. 5)";BITUTĖS;1424288192;Taip;0;0;1;1
21400;"Naminukas (Klinikų g. 5)";BITUTĖS;1180176295;Taip;0;4;0;4
21401;"Naminukas (Klinikų g. 5)";BITUTĖS;9903990297;Taip;1;0;0;1
21402;"Naminukas (Klinikų g. 5)";BITUTĖS;6592057292;Taip;11;3;0;14
21403;"Naminukas (Klinikų g. 5)";BITUTĖS;5578151523;Taip;3;0;0;3
21404;"Naminukas (Klinikų g. 5)";BITUTĖS;9244494109;Taip;0;6;0;6
21405;"Naminukas (Klinikų g. 5)";BITUTĖS;8923393066;Taip;0;6;0;6
21406;"Naminukas (Klinikų g. 5)";BITUTĖS;9178907705;Taip;4;7;1;12
21407;"Naminukas (Klinikų g. 5)";BITUTĖS;2234877411;Taip;1;0;0;1
21408;"Naminukas (Klinikų g. 5)";BITUTĖS;5288557629;Taip;0;8;0;8
21409;"Naminukas (Klinikų g. 5)";BITUTĖS;5233044803;Taip;0;0;2;2
21410;"Naminukas (Klinikų g. 5)";BITUTĖS;1346035733;Taip;4;0;0;4
21411;"Naminukas (Klinikų g. 5)";BITUTĖS;1730248631;Taip;0;0;6;6
21412;"Naminukas (Klinikų g. 5)";BITUTĖS;3791118736;Taip;2;0;0;2
21413;"Naminukas (Klinikų g. 5)";BITUTĖS;1394918021;Taip;1;0;0;1
21414;"Naminukas (Klinikų g. 5)";BITUTĖS;7099787230;Taip;0;3;0;3
21415;"Naminukas (Klinikų g. 5)";BITUTĖS;3088386659;Taip;0;0;1;1
21416;"Gervelė (Stadiono g. 5)";BORUŽĖLĖS;9777308731;Taip;5;0;0;5
21417;"Gervelė (Stadiono g. 5)";BORUŽĖLĖS;2712133300;Taip;5;0;0;5
21418;"Gervelė (Stadiono g. 5)";BORUŽĖLĖS;1006720360;Taip;2;0;0;2
21419;"Gervelė (Stadiono g. 5)";BORUŽĖLĖS;8190190100;Taip;5;1;0;6
21420;"Gervelė (Stadiono g. 5)";BORUŽĖLĖS;6573919007;Ne;1;3;0;4
21421;"Gervelė (Stadiono g. 5)";BORUŽĖLĖS;8797608822;Ne;2;0;0;2
21422;"Gervelė (Stadiono g. 5)";PAUKŠTELIAI;7959839478;Ne;5;0;0;5
21423;"Gervelė (Stadiono g. 5)";PAUKŠTELIAI;2031118410;Taip;0;7;0;7
21424;"Gervelė (Stadiono g. 5)";PAUKŠTELIAI;5966215998;Taip;22;0;0;22
21425;"Gervelė (Stadiono g. 5)";PAUKŠTELIAI;7463376031;Taip;0;21;0;21
21426;"Gervelė (Stadiono g. 5)";PAUKŠTELIAI;3567687304;Taip;2;4;0;6
21427;"Gervelė (Stadiono g. 5)";PAUKŠTELIAI;6372245141;Taip;0;2;0;2
21428;"Gervelė (Stadiono g. 5)";PAUKŠTELIAI;7952102572;Taip;19;0;0;19
21429;"Gervelė (Stadiono g. 5)";PAUKŠTELIAI;9154032804;Ne;0;12;0;12
21430;"Gervelė (Stadiono g. 5)";PAUKŠTELIAI;3676856569;Taip;0;1;0;1
21431;"Gervelė (Stadiono g. 5)";PAUKŠTELIAI;4588890423;Taip;0;18;0;18
21432;"Gervelė (Stadiono g. 5)";SPINDULĖLIAI;1020095914;Taip;2;9;0;11
21433;"Gervelė (Stadiono g. 5)";SPINDULĖLIAI;5705915729;Taip;5;0;0;5
21434;"Gervelė (Stadiono g. 5)";SPINDULĖLIAI;6241611652;Taip;3;0;0;3
21435;"Gervelė (Stadiono g. 5)";SPINDULĖLIAI;2207041148;Taip;13;0;0;13
21436;"Gervelė (Stadiono g. 5)";SPINDULĖLIAI;3397741232;Taip;3;0;0;3
21437;"Gervelė (Stadiono g. 5)";SPINDULĖLIAI;8472436632;Ne;1;15;0;16
21438;"Gervelė (Stadiono g. 5)";SPINDULĖLIAI;1204513844;Taip;2;0;0;2
21439;"Gervelė (Stadiono g. 5)";SPINDULĖLIAI;8126701466;Taip;3;0;0;3
21440;"Gervelė (Stadiono g. 5)";SPINDULĖLIAI;7419432731;Taip;12;0;0;12
21441;"Gervelė (Stadiono g. 5)";SPINDULĖLIAI;1611114179;Ne;6;1;0;7
21442;"Gervelė (Stadiono g. 5)";GĖLYTĖS;3873345138;Ne;0;3;0;3
21443;"Gervelė (Stadiono g. 5)";GĖLYTĖS;5518309115;Taip;8;0;0;8
21444;"Gervelė (Stadiono g. 5)";GĖLYTĖS;2744433344;Taip;0;1;0;1
21445;"Gervelė (Stadiono g. 5)";GĖLYTĖS;9291855374;Taip;0;1;0;1
21446;"Gervelė (Stadiono g. 5)";GĖLYTĖS;7855598075;Taip;0;5;0;5
21447;"Gervelė (Stadiono g. 5)";GĖLYTĖS;8777858708;Ne;0;4;0;4
21448;"Gervelė (Stadiono g. 5)";GĖLYTĖS;4925983616;Taip;3;0;0;3
21449;"Gervelė (Stadiono g. 5)";GĖLYTĖS;7387250891;Ne;4;0;0;4
21450;"Gervelė (Stadiono g. 5)";GĖLYTĖS;3490370918;Ne;0;2;0;2
21451;"Gervelė (Stadiono g. 5)";GĖLYTĖS;9183582003;Ne;0;2;0;2
21452;"Kūlverstukas (Mindaugo g. 7)";GNOMIKI;1720671485;Ne;8;0;0;8
21453;"Kūlverstukas (Mindaugo g. 7)";GNOMIKI;4894478262;Taip;10;0;0;10
21454;"Kūlverstukas (Mindaugo g. 7)";GNOMIKI;2501327054;Ne;0;3;0;3
21455;"Kūlverstukas (Mindaugo g. 7)";GNOMIKI;8348978878;Taip;0;5;0;5
21456;"Kūlverstukas (Mindaugo g. 7)";GNOMIKI;8927489885;Taip;6;0;0;6
21457;"Kūlverstukas (Mindaugo g. 7)";GNOMIKI;2709547427;Ne;0;4;0;4
21458;"Kūlverstukas (Mindaugo g. 7)";GNOMIKI;5532063862;Taip;11;0;0;11
21459;"Kūlverstukas (Mindaugo g. 7)";GNOMIKI;5747277587;Taip;5;2;0;7
21460;"Kūlverstukas (Mindaugo g. 7)";GNOMIKI;1848018684;Taip;0;3;0;3
21461;"Kūlverstukas (Mindaugo g. 7)";GNOMIKI;1166429762;Taip;10;0;0;10
21462;"Kūlverstukas (Mindaugo g. 7)";GNOMIKI;6514730230;Taip;14;0;0;14
21463;"Kūlverstukas (Mindaugo g. 7)";GNOMIKI;5298776235;Taip;0;4;0;4
21464;"Kūlverstukas (Mindaugo g. 7)";GNOMIKI;4116831802;Ne;5;1;0;6
21465;"Kūlverstukas (Mindaugo g. 7)";GNOMIKI;4677564389;Ne;5;4;0;9
21466;"Kūlverstukas (Mindaugo g. 7)";GNOMIKI;1916522637;Taip;15;0;1;16
21467;"Kūlverstukas (Mindaugo g. 7)";GNOMIKI;3239566139;Taip;0;10;0;10
21468;"Kūlverstukas (Mindaugo g. 7)";ZAIČIATA;8994705290;Taip;0;13;0;13
21469;"Kūlverstukas (Mindaugo g. 7)";ZAIČIATA;8496678513;Taip;5;0;0;5
21470;"Kūlverstukas (Mindaugo g. 7)";ZAIČIATA;2494202134;Ne;0;5;0;5
21471;"Kūlverstukas (Mindaugo g. 7)";ZAIČIATA;4998847820;Ne;0;0;17;17
21472;"Kūlverstukas (Mindaugo g. 7)";ZAIČIATA;4271185150;Ne;4;0;0;4
21473;"Kūlverstukas (Mindaugo g. 7)";ZAIČIATA;6497373567;Taip;0;5;0;5
21474;"Kūlverstukas (Mindaugo g. 7)";ZAIČIATA;3660002342;Taip;0;0;5;5
21475;"Kūlverstukas (Mindaugo g. 7)";ZAIČIATA;5079635330;Taip;5;0;0;5
21476;"Kūlverstukas (Mindaugo g. 7)";ZAIČIATA;5879283662;Taip;5;0;2;7
21477;"Kūlverstukas (Mindaugo g. 7)";ZAIČIATA;3067918179;Ne;0;5;0;5
21478;"Kūlverstukas (Mindaugo g. 7)";ZAIČIATA;1776176097;Taip;10;0;3;13
21479;"Kūlverstukas (Mindaugo g. 7)";ZAIČIATA;6685524805;Taip;0;3;0;3
21480;"Kūlverstukas (Mindaugo g. 7)";SVETLIAČKI;6219872984;Taip;0;0;3;3
21481;"Kūlverstukas (Mindaugo g. 7)";SVETLIAČKI;9098427210;Taip;0;0;6;6
21482;"Kūlverstukas (Mindaugo g. 7)";SVETLIAČKI;2091204077;Ne;0;1;0;1
21483;"Kūlverstukas (Mindaugo g. 7)";SVETLIAČKI;70033583066;Taip;0;3;0;3
21484;"Kūlverstukas (Mindaugo g. 7)";SVETLIAČKI;2154916232;Taip;0;9;2;11
21485;"Kūlverstukas (Mindaugo g. 7)";SVETLIAČKI;9535522910;Ne;0;0;23;23
21486;"Kūlverstukas (Mindaugo g. 7)";SVETLIAČKI;6376189019;Taip;0;1;0;1
21487;"Kūlverstukas (Mindaugo g. 7)";SVETLIAČKI;1557237011;Taip;0;5;3;8
21488;"Kūlverstukas (Mindaugo g. 7)";SVETLIAČKI;7829384850;Ne;0;1;0;1
21489;"Kūlverstukas (Mindaugo g. 7)";SVETLIAČKI;8577197481;Ne;6;0;13;19
21490;"Kūlverstukas (Mindaugo g. 7)";SVETLIAČKI;3449300504;Taip;4;3;0;7
21491;"Kūlverstukas (Mindaugo g. 7)";SVETLIAČKI;1102996499;Taip;5;1;0;6
21492;"Kūlverstukas (Mindaugo g. 7)";SVETLIAČKI;6311116034;Taip;5;1;0;6
21493;"Kūlverstukas (Mindaugo g. 7)";SVETLIAČKI;5546604017;Taip;0;5;3;8
21494;"Kūlverstukas (Mindaugo g. 7)";SVETLIAČKI;1635418112;Taip;0;0;12;12
21495;"Kūlverstukas (Mindaugo g. 7)";ZVONOČKI;1486878343;Taip;0;0;2;2
21496;"Kūlverstukas (Mindaugo g. 7)";ZVONOČKI;8835111916;Taip;0;0;4;4
21497;"Kūlverstukas (Mindaugo g. 7)";ZVONOČKI;5724787637;Taip;5;1;0;6
21498;"Kūlverstukas (Mindaugo g. 7)";ZVONOČKI;4377803110;Taip;0;2;0;2
21499;"Kūlverstukas (Mindaugo g. 7)";ZVONOČKI;9835391223;Taip;0;4;0;4
21500;"Kūlverstukas (Mindaugo g. 7)";ZVONOČKI;2429527586;Taip;0;0;6;6
21501;"Kūlverstukas (Mindaugo g. 7)";ZVONOČKI;5217751936;Taip;0;15;3;18
21502;"Kūlverstukas (Mindaugo g. 7)";ZVONOČKI;1566191212;Taip;0;1;0;1
21503;"Kūlverstukas (Mindaugo g. 7)";ZVONOČKI;9569296370;Taip;0;7;2;9
21504;"Kūlverstukas (Mindaugo g. 7)";ZVONOČKI;1047459617;Taip;5;0;0;5
21505;"Kūlverstukas (Mindaugo g. 7)";ZVONOČKI;9756326725;Taip;1;0;5;6
21506;"Kūlverstukas (Mindaugo g. 7)";ZVONOČKI;9156801640;Taip;0;1;0;1
21507;"Kūlverstukas (Mindaugo g. 7)";ZVONOČKI;1125206576;Taip;0;8;0;8
21508;"Kūlverstukas (Mindaugo g. 7)";ZVONOČKI;5728941778;Ne;0;4;2;6
21509;"Kūlverstukas (Mindaugo g. 7)";ZVONOČKI;5938022496;Ne;0;4;5;9
21510;"Vilniaus Pavilnio pagrindinė mokykla";"PRIEŠMOKYKLINĖ PL";2738553283;Taip;4;3;4;11
21511;"Vilniaus Pavilnio pagrindinė mokykla";"PRIEŠMOKYKLINĖ PL";2101902207;Taip;0;23;0;23
21512;"Vilniaus Pavilnio pagrindinė mokykla";"PRIEŠMOKYKLINĖ PL";1957926887;Taip;3;20;0;23
21513;"Vilniaus Pavilnio pagrindinė mokykla";"PRIEŠMOKYKLINĖ RU";4339607826;Ne;0;3;0;3
21514;"Vilniaus Pavilnio pagrindinė mokykla";"PRIEŠMOKYKLINĖ RU";3609961581;Taip;0;3;2;5
21515;"Vilniaus Pavilnio pagrindinė mokykla";"PRIEŠMOKYKLINĖ RU";1568915914;Taip;0;3;0;3
21516;"Vilniaus Pavilnio pagrindinė mokykla";"PRIEŠMOKYKLINĖ RU";5619763557;Ne;0;23;0;23
21517;"Vilniaus Pavilnio pagrindinė mokykla";"PRIEŠMOKYKLINĖ RU";9759761725;Ne;0;23;0;23
21518;"Vilniaus Pavilnio pagrindinė mokykla";"PRIEŠMOKYKLINĖ RU";3058369504;Ne;0;3;0;3
21519;"Vilniaus Pavilnio pagrindinė mokykla";"PRIEŠMOKYKLINĖ RU";9142513631;Taip;8;3;0;11
21520;"Vilniaus Pavilnio pagrindinė mokykla";"PRIEŠMOKYKLINĖ RU";5972567526;Taip;0;3;1;4
21521;"Vilniaus Pavilnio pagrindinė mokykla";"PRIEŠMOKYKLINĖ RU";2846917348;Taip;0;3;1;4
21522;"Vilniaus Pavilnio pagrindinė mokykla";"PRIEŠMOKYKLINĖ RU";6067622823;Taip;0;3;0;3
21523;"Vilniaus Pavilnio pagrindinė mokykla";"PRIEŠMOKYKLINĖ RU";3243226933;Ne;10;3;0;13
21524;"Vilniaus Pavilnio pagrindinė mokykla";"PRIEŠMOKYKLINĖ RU";7544963724;Taip;0;3;2;5
21525;"Vilniaus Pavilnio pagrindinė mokykla";"PRIEŠMOKYKLINĖ RU";6216663291;Taip;0;3;1;4
21526;"Vilniaus Pavilnio pagrindinė mokykla";"PRIEŠMOKYKLINĖ RU";3282845685;Taip;0;3;6;9
21527;"Vilniaus Šilo mokykla";Boružėlės;7122041826;Taip;6;1;0;7
21528;"Vilniaus Šilo mokykla";Boružėlės;9967276147;Taip;8;4;0;12
21529;"Vilniaus Šilo mokykla";Boružėlės;5962551687;Ne;15;5;0;20
21530;"Vilniaus Šilo mokykla";Boružėlės;1196172221;Ne;3;1;0;4
21531;"Vilniaus Šilo mokykla";Boružėlės;1538635985;Taip;24;4;0;28
21532;"Vilniaus Šilo mokykla";Boružėlės;6136087920;Taip;13;4;0;17
21533;"Vilniaus Šilo mokykla";Boružėlės;4544126354;Taip;15;4;0;19
21534;"Vilniaus Šilo mokykla";"1 spec.";1153167430;Taip;3;0;0;3
21535;"Vilniaus Šilo mokykla";"1 spec.";8863021708;Taip;12;4;0;16
21536;"Vilniaus Šilo mokykla";"1 spec.";4438939800;Taip;0;4;0;4
21537;"Vilniaus Šilo mokykla";"1 spec.";1971717759;Taip;6;4;0;10
21538;"Vilniaus Šilo mokykla";"1 spec.";2290889395;Taip;0;4;0;4
21539;"Vilniaus Šilo mokykla";"1 spec.";1180183091;Ne;0;24;0;24
21540;"Vilniaus Šilo mokykla";"6 lav.";29353956408;Taip;1;4;0;5
21541;"Vilniaus Šilo mokykla";"6 lav.";83007167743;Ne;1;9;0;10
21542;"Vilniaus Šilo mokykla";"6 lav.";67989956617;Taip;0;24;0;24
21543;"Vilniaus Šilo mokykla";"6 lav.";49892720109;Taip;0;9;0;9
21544;"Vilniaus Šilo mokykla";"6 lav.";3612746646;Taip;2;4;0;6
21545;"Vilniaus Šilo mokykla";"6 lav.";9054390753;Taip;0;4;0;4
21546;"Vilniaus Šilo mokykla";"6 lav.";2862598950;Ne;1;9;0;10
21547;"Vilniaus Šilo mokykla";"Priešmokyklinė grupė";5311183877;Taip;15;4;0;19
21548;"Vilniaus Šilo mokykla";"Priešmokyklinė grupė";1675384533;Taip;19;4;0;23
21549;"Vilniaus Šilo mokykla";"Priešmokyklinė grupė";3237698420;Taip;3;4;0;7
21550;"Vilniaus Šilo mokykla";"Priešmokyklinė grupė";2070454339;Ne;20;4;0;24
21551;"Vilniaus Šilo mokykla";"Priešmokyklinė grupė";8915901727;Taip;5;4;0;9
21552;"Vilniaus Šilo mokykla";"Priešmokyklinė grupė";9906750269;Taip;4;13;0;17
21553;Malūnėlis;BITUTĖS;1001575740;Taip;5;1;1;7
21554;Malūnėlis;BITUTĖS;8618778205;Taip;0;3;0;3
21555;Malūnėlis;BITUTĖS;2545930114;Taip;9;6;0;15
21556;Malūnėlis;BITUTĖS;3329510128;Taip;4;15;0;19
21557;Malūnėlis;BITUTĖS;5402027714;Taip;5;1;0;6
21558;Malūnėlis;BITUTĖS;6199265600;Taip;0;1;0;1
21559;Malūnėlis;BITUTĖS;7144098762;Taip;11;0;0;11
21560;Malūnėlis;BITUTĖS;1146723570;Taip;10;0;0;10
21561;Malūnėlis;BITUTĖS;9891418762;Taip;13;0;5;18
21562;Malūnėlis;BITUTĖS;8642960989;Taip;5;2;0;7
21563;Malūnėlis;BITUTĖS;5959610426;Taip;13;1;0;14
21564;Malūnėlis;BITUTĖS;4367009696;Taip;0;11;0;11
21565;Malūnėlis;BITUTĖS;5770511204;Taip;3;5;0;8
21566;Malūnėlis;BITUTĖS;9936144392;Taip;0;1;4;5
21567;Malūnėlis;BITUTĖS;1944670796;Taip;0;5;2;7
21568;Malūnėlis;BITUTĖS;5421090978;Taip;5;1;0;6
21569;Malūnėlis;BITUTĖS;8643210289;Taip;14;0;0;14
21570;Malūnėlis;BITUTĖS;8440160819;Taip;6;0;0;6
21571;Malūnėlis;BITUTĖS;1528972517;Taip;0;11;0;11
21572;Malūnėlis;BITUTĖS;8007350745;Taip;5;5;0;10
21573;Malūnėlis;VOVERIUKAI;4307232411;Taip;6;0;0;6
21574;Malūnėlis;VOVERIUKAI;3293082023;Taip;0;2;0;2
21575;Malūnėlis;VOVERIUKAI;6575258889;Taip;4;5;0;9
21576;Malūnėlis;VOVERIUKAI;1003043129;Taip;14;0;0;14
21577;Malūnėlis;VOVERIUKAI;3779723692;Taip;0;2;0;2
21578;Malūnėlis;VOVERIUKAI;7983537913;Taip;7;0;1;8
21579;Malūnėlis;VOVERIUKAI;9592117637;Taip;16;1;0;17
21580;Malūnėlis;VOVERIUKAI;9894452403;Ne;10;0;0;10
21581;Malūnėlis;VOVERIUKAI;2029506037;Taip;8;2;0;10
21582;Malūnėlis;VOVERIUKAI;9342720464;Ne;11;5;0;16
21583;Malūnėlis;VOVERIUKAI;2246526281;Taip;3;2;0;5
21584;Malūnėlis;VOVERIUKAI;2192305527;Taip;19;0;1;20
21585;Malūnėlis;VOVERIUKAI;6805587761;Taip;19;0;0;19
21586;Malūnėlis;VOVERIUKAI;3371260811;Taip;8;7;0;15
21587;Malūnėlis;VOVERIUKAI;5061720786;Taip;5;0;3;8
21588;Malūnėlis;VOVERIUKAI;5232728972;Taip;11;0;0;11
21589;Malūnėlis;VOVERIUKAI;2574604828;Taip;2;0;1;3
21590;Malūnėlis;VOVERIUKAI;3898518306;Taip;0;11;4;15
21591;Malūnėlis;VOVERIUKAI;1770049356;Taip;2;1;3;6
21592;Malūnėlis;VOVERIUKAI;8458676611;Taip;0;0;11;11
21593;Malūnėlis;VOVERIUKAI;5909022614;Taip;15;0;1;16
21594;Malūnėlis;VOVERIUKAI;8751365673;Ne;0;0;7;7
21595;Malūnėlis;BORUŽĖLĖS;7556990784;Taip;5;0;7;12
21596;Malūnėlis;BORUŽĖLĖS;1574941416;Taip;0;23;0;23
21597;Malūnėlis;BORUŽĖLĖS;1100719254;Ne;0;2;0;2
21598;Malūnėlis;BORUŽĖLĖS;2525923211;Taip;9;0;9;18
21599;Malūnėlis;BORUŽĖLĖS;9304119075;Taip;4;0;0;4
21600;Malūnėlis;BORUŽĖLĖS;6928976717;Taip;5;0;1;6
21601;Malūnėlis;BORUŽĖLĖS;6647872886;Taip;10;3;4;17
21602;Malūnėlis;BORUŽĖLĖS;6531364407;Taip;3;0;3;6
21603;Malūnėlis;BORUŽĖLĖS;2637299307;Taip;9;0;3;12
21604;Malūnėlis;BORUŽĖLĖS;8551271848;Taip;0;0;2;2
21605;Malūnėlis;BORUŽĖLĖS;8277245773;Taip;13;1;0;14
21606;Malūnėlis;BORUŽĖLĖS;5686301875;Taip;5;0;2;7
21607;Malūnėlis;BORUŽĖLĖS;1407908511;Ne;6;0;0;6
21608;Malūnėlis;BORUŽĖLĖS;4787212056;Taip;0;23;0;23
