Nr.;"Darželio pavadinimas";"Grupės pavadinimas";"Vaiko Identifikacinis Nr.";"Deklaruotas mieste";"Pateisintos dėl ligos";"Pateisintos dėl kitų priežasčių";"Nepateisintos dienos";"Praleistos dienos Viso"
1;Aitvaras;"VIJURKAI (ALERG.)";1877245088;Ne;6;7;0;13
2;Aitvaras;"VIJURKAI (ALERG.)";6936031222;Taip;0;6;1;7
3;Aitvaras;"VIJURKAI (ALERG.)";6214880713;Taip;0;1;0;1
4;Aitvaras;"VIJURKAI (ALERG.)";2566375128;Taip;6;1;0;7
5;Aitvaras;"VIJURKAI (ALERG.)";1879540041;Taip;0;10;0;10
6;Aitvaras;"VIJURKAI (ALERG.)";1532588441;Taip;0;3;0;3
7;Aitvaras;"VIJURKAI (ALERG.)";8206046301;Taip;8;0;1;9
8;Aitvaras;"VIJURKAI (ALERG.)";1347364985;Taip;15;0;0;15
9;Aitvaras;"VIJURKAI (ALERG.)";9157794193;Taip;14;2;0;16
10;Aitvaras;"VIJURKAI (ALERG.)";9562494357;Taip;0;2;0;2
11;Aitvaras;"VIJURKAI (ALERG.)";6021342178;Taip;6;1;0;7
12;Aitvaras;"VIJURKAI (ALERG.)";2650483861;Taip;0;3;0;3
13;Aitvaras;"VIJURKAI (ALERG.)";2601983670;Taip;0;2;0;2
14;Aitvaras;"VIJURKAI (ALERG.)";2895663259;Taip;5;0;0;5
15;Aitvaras;"VIJURKAI (ALERG.)";6444377924;Taip;0;0;19;19
16;Aitvaras;"VIJURKAI (ALERG.)";4702400490;Taip;0;1;0;1
17;Aitvaras;"SMALSUČIAI (ALERG.)";4868552034;Taip;0;1;1;2
18;Aitvaras;"SMALSUČIAI (ALERG.)";6166757095;Taip;12;1;0;13
19;Aitvaras;"SMALSUČIAI (ALERG.)";4480921300;Taip;5;1;0;6
20;Aitvaras;"SMALSUČIAI (ALERG.)";1019661577;Taip;0;3;0;3
21;Aitvaras;"SMALSUČIAI (ALERG.)";5425259260;Taip;0;1;0;1
22;Aitvaras;"SMALSUČIAI (ALERG.)";6201118021;Taip;0;2;0;2
23;Aitvaras;"SMALSUČIAI (ALERG.)";5750154036;Taip;0;1;0;1
24;Aitvaras;"SMALSUČIAI (ALERG.)";6084096300;Taip;0;2;2;4
25;Aitvaras;"SMALSUČIAI (ALERG.)";2004112424;Taip;0;3;0;3
26;Aitvaras;"SMALSUČIAI (ALERG.)";5330618557;Taip;7;2;0;9
27;Aitvaras;"SMALSUČIAI (ALERG.)";3488467265;Taip;0;3;0;3
28;Aitvaras;"SMALSUČIAI (ALERG.)";9745864667;Taip;0;5;0;5
29;Aitvaras;"SMALSUČIAI (ALERG.)";9810370596;Taip;4;0;0;4
30;Aitvaras;"SMALSUČIAI (ALERG.)";1954364886;Taip;6;2;0;8
31;Aitvaras;"SMALSUČIAI (ALERG.)";3535659630;Taip;0;1;1;2
32;Aitvaras;"SMALSUČIAI (ALERG.)";4833313373;Taip;0;1;2;3
33;Aitvaras;"SMALSUČIAI (ALERG.)";24247118884;Taip;0;3;0;3
34;Aitvaras;"SMALSUČIAI (ALERG.)";5504431748;Taip;5;0;0;5
35;Aitvaras;"SMALSUČIAI (ALERG.)";5389627560;Ne;0;2;3;5
36;Aitvaras;"SMALSUČIAI (ALERG.)";2953536545;Taip;0;3;1;4
37;Aitvaras;"SMALSUČIAI (ALERG.)";1636794584;Ne;0;4;0;4
38;Aitvaras;"SMALSUČIAI (ALERG.)";5956333024;Taip;0;1;0;1
39;Aitvaras;"SMALSUČIAI (ALERG.)";5595233402;Taip;5;0;0;5
40;Aitvaras;PADAUŽIUKAI;1494094426;Taip;0;5;0;5
41;Aitvaras;PADAUŽIUKAI;6550426644;Taip;15;4;0;19
42;Aitvaras;PADAUŽIUKAI;5818794912;Taip;0;4;0;4
43;Aitvaras;PADAUŽIUKAI;58780461337;Ne;0;1;4;5
44;Aitvaras;PADAUŽIUKAI;2034293999;Taip;17;0;0;17
45;Aitvaras;PADAUŽIUKAI;1116271183;Taip;0;1;0;1
46;Aitvaras;PADAUŽIUKAI;1996524718;Taip;5;1;0;6
47;Aitvaras;PADAUŽIUKAI;4110585744;Taip;0;3;0;3
48;Aitvaras;PADAUŽIUKAI;7469656671;Taip;0;1;0;1
49;Aitvaras;PADAUŽIUKAI;6010324894;Taip;0;1;0;1
50;Aitvaras;PADAUŽIUKAI;2408952971;Taip;21;0;0;21
51;Aitvaras;PADAUŽIUKAI;47875842134;Taip;0;1;0;1
52;Aitvaras;PADAUŽIUKAI;40799643122;Taip;0;2;0;2
53;Aitvaras;PADAUŽIUKAI;8784628567;Taip;0;1;0;1
54;Aitvaras;PADAUŽIUKAI;9015675095;Taip;4;2;0;6
55;Aitvaras;PADAUŽIUKAI;8121858940;Ne;0;1;4;5
56;Aitvaras;PADAUŽIUKAI;6951219468;Taip;5;1;0;6
57;Aitvaras;"AITVARIUKAI (ALERG.)";3639102842;Taip;0;2;0;2
58;Aitvaras;"AITVARIUKAI (ALERG.)";7243387750;Taip;5;6;0;11
59;Aitvaras;"AITVARIUKAI (ALERG.)";6587437949;Taip;8;4;0;12
60;Aitvaras;"AITVARIUKAI (ALERG.)";7461284958;Taip;0;5;0;5
61;Aitvaras;"AITVARIUKAI (ALERG.)";3394251305;Taip;0;3;0;3
62;Aitvaras;"AITVARIUKAI (ALERG.)";6459307767;Taip;3;0;0;3
63;Aitvaras;"AITVARIUKAI (ALERG.)";5635576679;Taip;0;9;0;9
64;Aitvaras;"AITVARIUKAI (ALERG.)";7988247429;Taip;5;2;0;7
65;Aitvaras;"AITVARIUKAI (ALERG.)";8770777328;Taip;5;2;0;7
66;Aitvaras;"AITVARIUKAI (ALERG.)";3653879553;Taip;0;2;2;4
67;Aitvaras;"AITVARIUKAI (ALERG.)";9721273154;Taip;12;0;1;13
68;Aitvaras;"AITVARIUKAI (ALERG.)";5103105065;Taip;17;0;0;17
69;Aitvaras;"AITVARIUKAI (ALERG.)";8543644000;Taip;0;1;0;1
70;Aitvaras;"AITVARIUKAI (ALERG.)";1859647003;Taip;8;0;0;8
71;Aitvaras;"AITVARIUKAI (ALERG.)";4204923580;Taip;9;2;0;11
72;Aitvaras;"AITVARIUKAI (ALERG.)";4777266938;Taip;15;2;0;17
73;Aitvaras;"AITVARIUKAI (ALERG.)";7568388141;Taip;11;1;0;12
74;Aitvaras;"AITVARIUKAI (ALERG.)";3954840915;Taip;0;0;2;2
75;Aitvaras;"AITVARIUKAI (ALERG.)";2146963673;Taip;7;0;0;7
76;Aitvaras;"AITVARIUKAI (ALERG.)";9763502346;Taip;6;8;0;14
77;Aitvaras;"AITVARIUKAI (ALERG.)";9228736015;Taip;0;1;0;1
78;Aitvaras;"AITVARIUKAI (ALERG.)";3775634117;Taip;0;2;0;2
79;Aitvaras;"AITVARIUKAI (ALERG.)";2615576367;Ne;5;4;0;9
80;Aitvaras;"SAULĖS ZUIKUČIAI  (ALERG.)";5711324951;Taip;11;6;0;17
81;Aitvaras;"SAULĖS ZUIKUČIAI  (ALERG.)";5619137905;Taip;13;2;0;15
82;Aitvaras;"SAULĖS ZUIKUČIAI  (ALERG.)";4106097701;Taip;0;3;0;3
83;Aitvaras;"SAULĖS ZUIKUČIAI  (ALERG.)";2184231202;Taip;0;6;3;9
84;Aitvaras;"SAULĖS ZUIKUČIAI  (ALERG.)";2478737835;Taip;5;0;4;9
85;Aitvaras;"SAULĖS ZUIKUČIAI  (ALERG.)";1136438927;Taip;5;2;0;7
86;Aitvaras;"SAULĖS ZUIKUČIAI  (ALERG.)";8137900398;Taip;4;1;5;10
87;Aitvaras;"SAULĖS ZUIKUČIAI  (ALERG.)";9147954612;Taip;7;0;1;8
88;Aitvaras;"SAULĖS ZUIKUČIAI  (ALERG.)";2511844613;Taip;10;1;1;12
89;Aitvaras;"SAULĖS ZUIKUČIAI  (ALERG.)";7907357058;Taip;10;1;0;11
90;Aitvaras;"SAULĖS ZUIKUČIAI  (ALERG.)";9534206000;Taip;10;2;0;12
91;Aitvaras;"SAULĖS ZUIKUČIAI  (ALERG.)";3737054758;Taip;18;0;2;20
92;Aitvaras;"SAULĖS ZUIKUČIAI  (ALERG.)";9271534775;Taip;10;0;3;13
93;Aitvaras;"SAULĖS ZUIKUČIAI  (ALERG.)";8849563638;Taip;13;2;0;15
94;Aitvaras;"SAULĖS ZUIKUČIAI  (ALERG.)";6950820937;Taip;15;0;0;15
95;Aitvaras;"SAULĖS ZUIKUČIAI  (ALERG.)";5252728205;Taip;0;0;1;1
96;Aitvaras;"SAULĖS ZUIKUČIAI  (ALERG.)";2744696131;Taip;0;6;0;6
97;Aitvaras;"SAULĖS ZUIKUČIAI  (ALERG.)";2373509019;Taip;16;0;0;16
98;Aitvaras;"SAULĖS ZUIKUČIAI  (ALERG.)";2624566766;Taip;15;0;1;16
99;Aitvaras;"SAULĖS ZUIKUČIAI  (ALERG.)";3677551059;Ne;5;1;0;6
100;Aitvaras;"ŽEMYNUKAI (ALERG.)";8567255042;Ne;13;1;0;14
101;Aitvaras;"ŽEMYNUKAI (ALERG.)";6218019092;Taip;0;5;5;10
102;Aitvaras;"ŽEMYNUKAI (ALERG.)";7560642918;Taip;0;1;0;1
103;Aitvaras;"ŽEMYNUKAI (ALERG.)";3820930777;Taip;31;0;0;31
104;Aitvaras;"ŽEMYNUKAI (ALERG.)";6624986090;Taip;18;0;1;19
105;Aitvaras;"ŽEMYNUKAI (ALERG.)";4733627644;Taip;0;6;3;9
106;Aitvaras;"ŽEMYNUKAI (ALERG.)";3104109370;Taip;5;2;6;13
107;Aitvaras;"ŽEMYNUKAI (ALERG.)";7853714142;Taip;0;3;3;6
108;Aitvaras;"ŽEMYNUKAI (ALERG.)";1949144346;Taip;10;3;0;13
109;Aitvaras;"ŽEMYNUKAI (ALERG.)";8641433486;Taip;10;0;7;17
110;Aitvaras;"ŽEMYNUKAI (ALERG.)";3961423273;Taip;9;0;0;9
111;Aitvaras;"ŽEMYNUKAI (ALERG.)";9947610763;Taip;0;3;1;4
112;Aitvaras;"ŽEMYNUKAI (ALERG.)";7113016866;Taip;5;3;0;8
113;Aitvaras;"ŽEMYNUKAI (ALERG.)";4377666052;Taip;6;3;2;11
114;Aitvaras;"ŽEMYNUKAI (ALERG.)";8333823078;Taip;17;3;0;20
115;Aitvaras;"ŽEMYNUKAI (ALERG.)";5623106419;Taip;2;6;0;8
116;Aitvaras;"ŽEMYNUKAI (ALERG.)";5351333397;Taip;10;5;0;15
117;Aitvaras;"ŽEMYNUKAI (ALERG.)";2065988478;Taip;8;0;5;13
118;Aitvaras;"ŽEMYNUKAI (ALERG.)";3635354769;Taip;0;4;25;29
119;Aitvaras;"ŽEMYNUKAI (ALERG.)";7889947603;Taip;17;0;1;18
120;Aitvaras;"ŽEMYNUKAI (ALERG.)";1662289664;Taip;7;0;0;7
121;Aitvaras;"LINKSMUČIAI (ALERG.)";5238819066;Taip;5;0;1;6
122;Aitvaras;"LINKSMUČIAI (ALERG.)";7109001184;Taip;1;0;0;1
123;Aitvaras;"LINKSMUČIAI (ALERG.)";3655710511;Taip;0;1;0;1
124;Aitvaras;"LINKSMUČIAI (ALERG.)";1091372798;Taip;0;1;0;1
125;Aitvaras;"LINKSMUČIAI (ALERG.)";8666824607;Taip;10;1;0;11
126;Aitvaras;"LINKSMUČIAI (ALERG.)";5612991255;Taip;5;2;0;7
127;Aitvaras;"LINKSMUČIAI (ALERG.)";7260577885;Taip;0;1;0;1
128;Aitvaras;"LINKSMUČIAI (ALERG.)";1599183050;Taip;2;0;1;3
129;Aitvaras;"LINKSMUČIAI (ALERG.)";1115202169;Taip;0;2;0;2
130;Aitvaras;"LINKSMUČIAI (ALERG.)";2760970218;Taip;0;1;0;1
131;Aitvaras;"LINKSMUČIAI (ALERG.)";4120515569;Taip;8;6;0;14
132;Aitvaras;"LINKSMUČIAI (ALERG.)";9885781306;Taip;10;2;0;12
133;Aitvaras;"LINKSMUČIAI (ALERG.)";4564723798;Taip;5;0;0;5
134;Aitvaras;"LINKSMUČIAI (ALERG.)";4612994715;Taip;1;0;6;7
135;Aitvaras;"LINKSMUČIAI (ALERG.)";4176681907;Taip;6;5;0;11
136;Aitvaras;"LINKSMUČIAI (ALERG.)";2547934790;Taip;5;0;0;5
137;Aitvaras;"LINKSMUČIAI (ALERG.)";2357399981;Ne;7;0;0;7
138;Aitvaras;"LINKSMUČIAI (ALERG.)";5572538840;Taip;6;0;0;6
139;Aitvaras;"LINKSMUČIAI (ALERG.)";4114397590;Taip;7;1;0;8
140;Aitvaras;NAMINUKAI;3053557807;Taip;7;0;1;8
141;Aitvaras;NAMINUKAI;6126913961;Taip;6;0;0;6
142;Aitvaras;NAMINUKAI;3347213578;Taip;0;1;2;3
143;Aitvaras;NAMINUKAI;9024245490;Taip;2;2;0;4
144;Aitvaras;NAMINUKAI;8512502118;Taip;3;1;0;4
145;Aitvaras;NAMINUKAI;2821221241;Taip;0;1;0;1
146;Aitvaras;NAMINUKAI;9039303562;Taip;0;2;2;4
147;Aitvaras;NAMINUKAI;6080549524;Taip;0;2;2;4
148;Aitvaras;NAMINUKAI;6048701733;Taip;1;0;1;2
149;Aitvaras;NAMINUKAI;6110226958;Taip;0;0;12;12
150;Aitvaras;NAMINUKAI;4555281655;Taip;0;2;0;2
151;Aitvaras;NAMINUKAI;8043062737;Ne;0;6;0;6
152;Aitvaras;NAMINUKAI;3005447572;Taip;0;1;0;1
153;Aitvaras;NAMINUKAI;1549552392;Taip;6;1;1;8
154;Aitvaras;NAMINUKAI;4498792867;Taip;0;4;0;4
155;Aitvaras;NAMINUKAI;9490714865;Ne;0;4;0;4
156;Aitvaras;NAMINUKAI;1498630458;Taip;0;0;1;1
157;Aitvaras;NAMINUKAI;5967188507;Ne;0;2;2;4
158;Aitvaras;NAMINUKAI;5161069611;Taip;0;0;2;2
159;Aitvaras;NAMINUKAI;7934344218;Taip;16;0;0;16
160;Aitvaras;NAMINUKAI;6279152796;Taip;0;5;0;5
161;Aitvaras;ŠELMIAI;4984058405;Taip;5;5;0;10
162;Aitvaras;ŠELMIAI;9725401255;Taip;5;0;5;10
163;Aitvaras;ŠELMIAI;4547342872;Taip;5;2;0;7
164;Aitvaras;ŠELMIAI;5684526288;Taip;5;4;4;13
165;Aitvaras;ŠELMIAI;7764574135;Taip;5;0;0;5
166;Aitvaras;ŠELMIAI;5601517340;Taip;7;2;0;9
167;Aitvaras;ŠELMIAI;1019103539;Taip;12;4;0;16
168;Aitvaras;ŠELMIAI;2185746898;Taip;10;3;0;13
169;Aitvaras;ŠELMIAI;8756012613;Taip;5;1;0;6
170;Aitvaras;ŠELMIAI;1203732956;Taip;13;0;0;13
171;Aitvaras;ŠELMIAI;5782609781;Taip;6;2;0;8
172;Aitvaras;ŠELMIAI;7805819121;Taip;8;6;0;14
173;Aitvaras;ŠELMIAI;8558414510;Taip;10;2;1;13
174;Aitvaras;ŠELMIAI;4551774368;Taip;10;2;1;13
175;Aitvaras;ŠELMIAI;4158520145;Taip;0;2;0;2
176;Aitvaras;ŠELMIAI;7352233454;Taip;0;11;0;11
177;Aitvaras;ŠELMIAI;1901118931;Taip;5;1;0;6
178;Aitvaras;ŠELMIAI;4812423010;Taip;0;5;1;6
179;Aitvaras;ŠELMIAI;1112142035;Taip;0;3;13;16
180;Aitvaras;ŠELMIAI;8644983502;Taip;10;3;0;13
181;Aitvaras;ŠELMIAI;9295561516;Taip;0;9;0;9
182;Aitvaras;ŠELMIAI;6188186413;Taip;0;3;7;10
183;Aitvaras;KODĖLČIUKAI;6214572150;Taip;7;0;0;7
184;Aitvaras;KODĖLČIUKAI;3323458595;Taip;0;1;0;1
185;Aitvaras;KODĖLČIUKAI;8065540507;Taip;5;0;2;7
186;Aitvaras;KODĖLČIUKAI;1288810999;Taip;1;0;5;6
187;Aitvaras;KODĖLČIUKAI;6501943902;Taip;8;1;0;9
188;Aitvaras;KODĖLČIUKAI;4350590529;Taip;0;0;2;2
189;Aitvaras;KODĖLČIUKAI;7777235021;Taip;0;2;1;3
190;Aitvaras;KODĖLČIUKAI;5641224483;Taip;0;5;1;6
191;Aitvaras;KODĖLČIUKAI;1830134108;Ne;0;1;5;6
192;Aitvaras;KODĖLČIUKAI;3178965623;Taip;0;1;0;1
193;Aitvaras;KODĖLČIUKAI;5905456814;Taip;5;0;0;5
194;Aitvaras;KODĖLČIUKAI;2807595769;Taip;6;2;0;8
195;Aitvaras;KODĖLČIUKAI;1252145346;Taip;0;0;3;3
196;Aitvaras;KODĖLČIUKAI;7455895024;Taip;4;0;2;6
197;Aitvaras;KODĖLČIUKAI;8439586875;Taip;0;3;0;3
198;Aitvaras;KODĖLČIUKAI;2328771385;Ne;1;5;0;6
199;Aitvaras;KODĖLČIUKAI;8360380303;Taip;0;2;1;3
200;Aitvaras;KODĖLČIUKAI;1594675221;Taip;17;1;0;18
201;Aitvaras;KODĖLČIUKAI;5922357091;Taip;5;2;2;9
202;Aitvaras;PABIRUČIAI;1495399113;Taip;2;0;0;2
203;Aitvaras;PABIRUČIAI;7136674662;Taip;0;9;0;9
204;Aitvaras;PABIRUČIAI;9949206639;Taip;0;0;2;2
205;Aitvaras;PABIRUČIAI;4613021421;Taip;0;1;0;1
206;Aitvaras;PABIRUČIAI;2887681961;Taip;8;7;0;15
207;Aitvaras;PABIRUČIAI;7922937851;Taip;1;1;0;2
208;Aitvaras;PABIRUČIAI;4085134058;Taip;16;0;0;16
209;Aitvaras;PABIRUČIAI;8746884740;Taip;0;0;3;3
210;Aitvaras;PABIRUČIAI;4163871634;Taip;4;13;0;17
211;Aitvaras;PABIRUČIAI;3988226974;Taip;4;13;0;17
212;Aitvaras;PABIRUČIAI;1070324386;Taip;8;1;0;9
213;Aitvaras;PABIRUČIAI;2239387580;Taip;9;1;0;10
214;Aitvaras;PABIRUČIAI;6119148164;Taip;10;2;3;15
215;Aitvaras;PABIRUČIAI;2892898328;Taip;0;12;0;12
216;Aitvaras;PABIRUČIAI;3749008647;Taip;15;1;3;19
217;Aitvaras;PABIRUČIAI;4760801928;Taip;18;1;0;19
218;Aitvaras;PABIRUČIAI;1599296739;Taip;0;0;10;10
219;Aitvaras;PABIRUČIAI;4987412561;Taip;0;1;1;2
220;Aitvaras;"SVAJOKLIAI  (ALERG.)";5659897032;Taip;6;1;0;7
221;Aitvaras;"SVAJOKLIAI  (ALERG.)";4618560397;Taip;0;1;0;1
222;Aitvaras;"SVAJOKLIAI  (ALERG.)";9209862610;Taip;6;0;1;7
223;Aitvaras;"SVAJOKLIAI  (ALERG.)";6191938291;Taip;3;0;4;7
224;Aitvaras;"SVAJOKLIAI  (ALERG.)";7006713502;Taip;0;1;1;2
225;Aitvaras;"SVAJOKLIAI  (ALERG.)";5790551266;Taip;6;1;0;7
226;Aitvaras;"SVAJOKLIAI  (ALERG.)";2975696317;Taip;4;0;0;4
227;Aitvaras;"SVAJOKLIAI  (ALERG.)";8965957442;Taip;16;0;0;16
228;Aitvaras;"SVAJOKLIAI  (ALERG.)";3891067128;Taip;5;0;1;6
229;Aitvaras;"SVAJOKLIAI  (ALERG.)";8352951885;Taip;17;0;0;17
230;Aitvaras;"SVAJOKLIAI  (ALERG.)";5255843693;Taip;7;0;1;8
231;Aitvaras;"SVAJOKLIAI  (ALERG.)";2839442228;Ne;5;0;0;5
232;Aitvaras;"SVAJOKLIAI  (ALERG.)";5593105541;Taip;0;2;0;2
233;Aitvaras;"SVAJOKLIAI  (ALERG.)";8963214183;Taip;10;0;0;10
234;Aitvaras;"SVAJOKLIAI  (ALERG.)";6319953077;Taip;3;0;0;3
235;Aitvaras;"SVAJOKLIAI  (ALERG.)";1131690624;Taip;2;0;0;2
236;Aitvaras;"SVAJOKLIAI  (ALERG.)";4801034095;Taip;6;2;0;8
237;Atžalėlės;Gėlytės;4284673729;Taip;0;21;0;21
238;Atžalėlės;Gėlytės;8695865604;Taip;0;5;0;5
239;Atžalėlės;Gėlytės;2385614957;Taip;0;0;1;1
240;Atžalėlės;Gėlytės;5432433423;Ne;0;7;0;7
241;Atžalėlės;Gėlytės;9715625283;Taip;0;11;0;11
242;Atžalėlės;Gėlytės;2131592139;Taip;0;5;2;7
243;Atžalėlės;Gėlytės;3191066669;Taip;0;2;4;6
244;Atžalėlės;Gėlytės;1500456945;Taip;0;0;4;4
245;Atžalėlės;Gėlytės;1722233272;Taip;0;10;0;10
246;Atžalėlės;Gėlytės;5310990513;Taip;0;1;0;1
247;Atžalėlės;Gėlytės;7702502252;Ne;0;12;0;12
248;Atžalėlės;Gėlytės;9189223222;Taip;0;6;0;6
249;Atžalėlės;Gėlytės;3283415814;Taip;9;1;0;10
250;Atžalėlės;Gėlytės;1146492807;Taip;0;0;5;5
251;Atžalėlės;Gėlytės;3870758086;Taip;0;1;0;1
252;Atžalėlės;Gėlytės;6202250600;Ne;10;0;0;10
253;Atžalėlės;Gėlytės;4098210138;Taip;0;1;0;1
254;Atžalėlės;Gėlytės;6177038838;Taip;0;1;0;1
255;Atžalėlės;Gėlytės;5742471497;Taip;5;0;6;11
256;Atžalėlės;Gėlytės;1137741059;Taip;3;0;0;3
257;Atžalėlės;Gėlytės;4238773173;Taip;0;2;1;3
258;Atžalėlės;Gėlytės;1450609695;Taip;0;1;0;1
259;Atžalėlės;Drugeliai;4643154006;Taip;0;2;0;2
260;Atžalėlės;Drugeliai;6903666624;Taip;8;1;1;10
261;Atžalėlės;Drugeliai;2315790531;Taip;0;1;0;1
262;Atžalėlės;Drugeliai;6782007470;Taip;0;12;0;12
263;Atžalėlės;Drugeliai;1805496887;Taip;7;6;0;13
264;Atžalėlės;Drugeliai;5417971068;Taip;0;1;0;1
265;Atžalėlės;Drugeliai;7953922166;Taip;0;1;0;1
266;Atžalėlės;Drugeliai;5147078840;Taip;0;9;0;9
267;Atžalėlės;Drugeliai;9222670655;Taip;1;3;0;4
268;Atžalėlės;Drugeliai;77261118958;Taip;0;1;0;1
269;Atžalėlės;Drugeliai;1429493246;Taip;0;2;0;2
270;Atžalėlės;Drugeliai;6114426973;Taip;4;8;0;12
271;Atžalėlės;Drugeliai;1456979448;Taip;10;3;0;13
272;Atžalėlės;Drugeliai;4032519781;Taip;0;5;0;5
273;Atžalėlės;Drugeliai;7756889911;Taip;0;1;2;3
274;Atžalėlės;Drugeliai;5063094678;Taip;0;2;1;3
275;Atžalėlės;Drugeliai;3422605135;Taip;0;1;2;3
276;Atžalėlės;Drugeliai;8718036014;Taip;10;2;0;12
277;Atžalėlės;Drugeliai;4884599397;Taip;10;2;0;12
278;Atžalėlės;Drugeliai;4902947406;Taip;0;1;4;5
279;Atžalėlės;Drugeliai;9463215947;Taip;0;2;0;2
280;Atžalėlės;Drugeliai;6570245757;Taip;0;1;0;1
281;Atžalėlės;Drugeliai;6695872204;Taip;10;5;0;15
282;Atžalėlės;Drugeliai;6393090675;Taip;0;2;1;3
283;Atžalėlės;Gandriukai;2083260403;Taip;0;14;0;14
284;Atžalėlės;Gandriukai;3692090073;Taip;0;0;2;2
285;Atžalėlės;Gandriukai;2078549599;Taip;0;0;6;6
286;Atžalėlės;Gandriukai;5119260525;Taip;6;0;2;8
287;Atžalėlės;Gandriukai;7510951079;Taip;10;5;0;15
288;Atžalėlės;Gandriukai;6594440062;Taip;19;0;0;19
289;Atžalėlės;Gandriukai;4293557144;Taip;13;3;0;16
290;Atžalėlės;Gandriukai;6211002805;Taip;6;0;2;8
291;Atžalėlės;Gandriukai;1305611902;Taip;0;0;6;6
292;Atžalėlės;Gandriukai;5102163688;Taip;15;0;3;18
293;Atžalėlės;Voveriukai;1865339755;Taip;0;1;0;1
294;Atžalėlės;Voveriukai;4467364336;Taip;0;1;1;2
295;Atžalėlės;Voveriukai;9699811980;Taip;0;1;1;2
296;Atžalėlės;Voveriukai;8847754477;Taip;0;2;0;2
297;Atžalėlės;Voveriukai;3795729265;Taip;5;0;6;11
298;Atžalėlės;Voveriukai;8201582382;Taip;4;1;2;7
299;Atžalėlės;Voveriukai;4362058013;Taip;4;1;3;8
300;Atžalėlės;Voveriukai;8819893830;Taip;0;1;7;8
301;Atžalėlės;Voveriukai;3069192413;Taip;0;0;6;6
302;Atžalėlės;Voveriukai;2067246260;Taip;0;1;6;7
303;Atžalėlės;Voveriukai;7532672266;Taip;10;1;1;12
304;Atžalėlės;Voveriukai;5705303891;Ne;0;5;0;5
305;Atžalėlės;Voveriukai;5650427433;Taip;3;1;0;4
306;Atžalėlės;Voveriukai;1316154666;Taip;0;1;0;1
307;Atžalėlės;Voveriukai;6975941393;Taip;0;1;0;1
308;Atžalėlės;Voveriukai;8138683218;Taip;0;3;0;3
309;Atžalėlės;Voveriukai;7689394485;Taip;0;1;1;2
310;Atžalėlės;Voveriukai;2662384275;Taip;0;1;0;1
311;Atžalėlės;Voveriukai;4996777116;Taip;0;1;2;3
312;Atžalėlės;Voveriukai;1426744251;Taip;0;2;0;2
313;Atžalėlės;Voveriukai;6684979914;Taip;1;0;2;3
314;Atžalėlės;Voveriukai;8470059012;Ne;0;1;1;2
315;Atžalėlės;Voveriukai;5767549779;Taip;0;1;3;4
316;Atžalėlės;Žirniukai;2374624441;Taip;0;1;0;1
317;Atžalėlės;Žirniukai;9707462467;Taip;0;1;0;1
318;Atžalėlės;Žirniukai;9967641617;Taip;0;6;0;6
319;Atžalėlės;Žirniukai;9508110719;Taip;1;0;1;2
320;Atžalėlės;Žirniukai;9085453655;Taip;0;2;0;2
321;Atžalėlės;Žirniukai;1538643591;Taip;11;10;0;21
322;Atžalėlės;Žirniukai;3143856911;Taip;0;8;0;8
323;Atžalėlės;Žirniukai;1212074068;Taip;16;0;0;16
324;Atžalėlės;Žirniukai;9736390705;Taip;10;0;1;11
325;Atžalėlės;Žirniukai;4661388894;Taip;0;0;6;6
326;Atžalėlės;Žirniukai;5319794176;Taip;0;0;1;1
327;Atžalėlės;Žirniukai;7196464328;Taip;0;5;0;5
328;Atžalėlės;Žirniukai;7522643082;Ne;1;2;0;3
329;Atžalėlės;Žirniukai;7613931447;Ne;1;2;0;3
330;Atžalėlės;Žirniukai;6723689098;Taip;0;1;0;1
331;Atžalėlės;Žirniukai;9281138840;Taip;9;0;5;14
332;Atžalėlės;Žirniukai;7018297883;Taip;0;1;6;7
333;Atžalėlės;Ežiukai;4227804985;Taip;0;0;1;1
334;Atžalėlės;Ežiukai;9053620501;Taip;0;0;5;5
335;Atžalėlės;Ežiukai;9054589111;Taip;0;1;0;1
336;Atžalėlės;Ežiukai;9346744866;Ne;0;4;0;4
337;Atžalėlės;Ežiukai;1505286928;Taip;4;3;0;7
338;Atžalėlės;Ežiukai;4148412941;Taip;0;0;3;3
339;Atžalėlės;Ežiukai;3333808381;Taip;0;0;1;1
340;Atžalėlės;Ežiukai;1710646812;Taip;1;0;3;4
341;Atžalėlės;Ežiukai;6447615639;Taip;0;0;1;1
342;Atžalėlės;Ežiukai;5972419628;Taip;0;4;0;4
343;Atžalėlės;Ežiukai;3738127350;Taip;9;0;3;12
344;Atžalėlės;Ežiukai;1423254771;Taip;11;10;0;21
345;Atžalėlės;Ežiukai;1614261572;Ne;12;1;0;13
346;Atžalėlės;Ežiukai;6665199013;Taip;5;1;0;6
347;Atžalėlės;Ežiukai;8145965849;Taip;10;0;0;10
348;Atžalėlės;Ežiukai;6108989129;Taip;0;0;1;1
349;Atžalėlės;Ežiukai;5174826594;Taip;5;0;0;5
350;Atžalėlės;Ežiukai;7501772398;Taip;0;0;3;3
351;Atžalėlės;Paukšteliai;7807313362;Taip;3;0;3;6
352;Atžalėlės;Paukšteliai;6537864486;Taip;5;0;0;5
353;Atžalėlės;Paukšteliai;8768704484;Taip;4;0;3;7
354;Atžalėlės;Paukšteliai;6675588261;Taip;4;0;3;7
355;Atžalėlės;Paukšteliai;8524244526;Taip;5;2;0;7
356;Atžalėlės;Paukšteliai;6873507667;Taip;0;0;1;1
357;Atžalėlės;Paukšteliai;7321516783;Taip;2;0;2;4
358;Atžalėlės;Paukšteliai;6265777690;Taip;0;1;0;1
359;Atžalėlės;Paukšteliai;1844980319;Taip;0;1;1;2
360;Atžalėlės;Paukšteliai;5997958773;Taip;0;1;0;1
361;Atžalėlės;Paukšteliai;8512283024;Taip;6;0;1;7
362;Atžalėlės;Paukšteliai;2078781673;Taip;8;0;0;8
363;Atžalėlės;Paukšteliai;1520206753;Taip;16;0;3;19
364;Atžalėlės;Paukšteliai;4790322154;Taip;0;6;0;6
365;Atžalėlės;Paukšteliai;4081717007;Taip;8;0;1;9
366;Atžalėlės;Paukšteliai;1089221288;Taip;3;0;1;4
367;Atžalėlės;Paukšteliai;9327437508;Taip;0;12;0;12
368;Atžalėlės;Paukšteliai;7356877676;Taip;0;0;1;1
369;Atžalėlės;Paukšteliai;4392352210;Taip;7;0;0;7
370;Atžalėlės;Paukšteliai;1774212280;Taip;13;0;0;13
371;Atžalėlės;Meškiukai;9925178685;Taip;0;0;3;3
372;Atžalėlės;Meškiukai;2617568019;Ne;5;1;0;6
373;Atžalėlės;Meškiukai;4233689945;Taip;0;0;1;1
374;Atžalėlės;Meškiukai;8619613890;Taip;0;0;9;9
375;Atžalėlės;Meškiukai;3281114596;Taip;0;18;0;18
376;Atžalėlės;Meškiukai;5466374223;Taip;0;0;7;7
377;Atžalėlės;Meškiukai;2433029299;Taip;2;0;2;4
378;Atžalėlės;Meškiukai;5682652546;Taip;0;0;13;13
379;Atžalėlės;Meškiukai;9631336340;Taip;2;1;3;6
380;Atžalėlės;Meškiukai;2930612059;Ne;0;20;1;21
381;Atžalėlės;Meškiukai;2569491645;Taip;3;1;0;4
382;Atžalėlės;Meškiukai;1431197358;Taip;0;5;0;5
383;Atžalėlės;Meškiukai;4177753994;Taip;11;0;0;11
384;Atžalėlės;Meškiukai;3982090601;Taip;0;0;5;5
385;Atžalėlės;Meškiukai;3743308789;Taip;6;0;3;9
386;Atžalėlės;Meškiukai;2228759708;Ne;3;0;0;3
387;Atžalėlės;Meškiukai;7936991925;Taip;0;0;1;1
388;Atžalėlės;Meškiukai;8976815736;Taip;0;1;3;4
389;Atžalėlės;"BITUTĖS (MODULINĖ)";8707875125;Taip;0;16;0;16
390;Atžalėlės;"BITUTĖS (MODULINĖ)";8060332402;Taip;5;0;0;5
391;Atžalėlės;"BITUTĖS (MODULINĖ)";8396693160;Taip;3;0;3;6
392;Atžalėlės;"BITUTĖS (MODULINĖ)";6253257539;Taip;9;0;0;9
393;Atžalėlės;"BITUTĖS (MODULINĖ)";7052938312;Taip;9;0;1;10
394;Atžalėlės;"BITUTĖS (MODULINĖ)";3559977339;Taip;5;0;0;5
395;Atžalėlės;"BITUTĖS (MODULINĖ)";5593774275;Taip;18;0;0;18
396;Atžalėlės;"BITUTĖS (MODULINĖ)";8129858229;Taip;0;3;0;3
397;Atžalėlės;"BITUTĖS (MODULINĖ)";2322329918;Taip;0;0;1;1
398;Atžalėlės;"BITUTĖS (MODULINĖ)";6368553568;Taip;0;0;2;2
399;Atžalėlės;"BITUTĖS (MODULINĖ)";5148142239;Taip;0;0;2;2
400;Atžalėlės;"ŠYPSENĖLĖS (MODULINĖ)";4071402757;Taip;1;0;1;2
401;Atžalėlės;"ŠYPSENĖLĖS (MODULINĖ)";1943349835;Taip;0;6;0;6
402;Atžalėlės;"ŠYPSENĖLĖS (MODULINĖ)";8564143904;Taip;0;0;6;6
403;Atžalėlės;"ŠYPSENĖLĖS (MODULINĖ)";7159628246;Taip;2;0;0;2
404;Atžalėlės;"ŠYPSENĖLĖS (MODULINĖ)";1386101803;Taip;0;0;1;1
405;Atžalėlės;"ŠYPSENĖLĖS (MODULINĖ)";3299724612;Taip;0;7;0;7
406;Atžalėlės;"BORUŽIUKAI (MODULINĖ)";3198845538;Taip;15;0;0;15
407;Atžalėlės;"BORUŽIUKAI (MODULINĖ)";8681809797;Taip;7;1;2;10
408;Atžalėlės;"BORUŽIUKAI (MODULINĖ)";3590987364;Taip;4;0;2;6
409;Atžalėlės;"BORUŽIUKAI (MODULINĖ)";1383944713;Taip;14;0;0;14
410;Atžalėlės;"BORUŽIUKAI (MODULINĖ)";5582697993;Taip;0;1;0;1
411;Atžalėlės;"BORUŽIUKAI (MODULINĖ)";9201449702;Taip;0;0;1;1
412;Atžalėlės;"BORUŽIUKAI (MODULINĖ)";7980775632;Ne;0;8;0;8
413;Atžalėlės;"SAULUTĖS (MODULINĖ)";1929417022;Taip;5;0;0;5
414;Atžalėlės;"SAULUTĖS (MODULINĖ)";4268941401;Taip;0;14;3;17
415;Atžalėlės;"SAULUTĖS (MODULINĖ)";1797932125;Taip;6;0;0;6
416;Atžalėlės;"SAULUTĖS (MODULINĖ)";2306086573;Ne;3;0;1;4
417;Atžalėlės;"SAULUTĖS (MODULINĖ)";8385741531;Taip;0;6;15;21
418;Atžalėlės;"SAULUTĖS (MODULINĖ)";8460997063;Taip;3;2;0;5
419;Atžalėlės;"SAULUTĖS (MODULINĖ)";5490741021;Taip;0;2;2;4
420;Atžalėlės;"SAULUTĖS (MODULINĖ)";8208908249;Taip;2;0;0;2
421;Atžalėlės;"SAULUTĖS (MODULINĖ)";6048763811;Taip;10;1;0;11
422;Aušrelė;PASAKIUKAI;1659335142;Taip;0;3;0;3
423;Aušrelė;PASAKIUKAI;2974714806;Taip;0;2;0;2
424;Aušrelė;PASAKIUKAI;1327431679;Taip;0;1;0;1
425;Aušrelė;PASAKIUKAI;7682402576;Taip;0;2;0;2
426;Aušrelė;PASAKIUKAI;1408751702;Taip;0;3;0;3
427;Aušrelė;PASAKIUKAI;6995749373;Ne;4;2;0;6
428;Aušrelė;PASAKIUKAI;8372554796;Taip;0;1;0;1
429;Aušrelė;PASAKIUKAI;1502146844;Taip;0;1;0;1
430;Aušrelė;PASAKIUKAI;8341539501;Taip;0;1;0;1
431;Aušrelė;PASAKIUKAI;8230362307;Taip;0;1;0;1
432;Aušrelė;PASAKIUKAI;4306578299;Taip;4;2;0;6
433;Aušrelė;PASAKIUKAI;5777214701;Taip;0;2;0;2
434;Aušrelė;PASAKIUKAI;6277405405;Taip;0;5;0;5
435;Aušrelė;PASAKIUKAI;3682523696;Taip;0;1;0;1
436;Aušrelė;PASAKIUKAI;34891640909;Taip;0;2;0;2
437;Aušrelė;PASAKIUKAI;2125080379;Taip;0;1;0;1
438;Aušrelė;PASAKIUKAI;3165692699;Taip;0;1;0;1
439;Aušrelė;BORUŽĖLĖS;6673034329;Taip;12;2;0;14
440;Aušrelė;BORUŽĖLĖS;4957581753;Taip;0;2;0;2
441;Aušrelė;BORUŽĖLĖS;1928260563;Taip;0;1;0;1
442;Aušrelė;BORUŽĖLĖS;8243716759;Taip;0;8;2;10
443;Aušrelė;BORUŽĖLĖS;1549962200;Taip;0;9;0;9
444;Aušrelė;BORUŽĖLĖS;4505922394;Taip;6;1;1;8
445;Aušrelė;BORUŽĖLĖS;7190665397;Taip;0;1;0;1
446;Aušrelė;BORUŽĖLĖS;2991828434;Taip;4;1;1;6
447;Aušrelė;BORUŽĖLĖS;5358315970;Taip;0;1;0;1
448;Aušrelė;BORUŽĖLĖS;8030685444;Taip;0;2;0;2
449;Aušrelė;BORUŽĖLĖS;1814972981;Taip;6;2;0;8
450;Aušrelė;SMALSUČIAI;6761263775;Taip;0;9;0;9
451;Aušrelė;SMALSUČIAI;3015028879;Taip;0;20;0;20
452;Aušrelė;SMALSUČIAI;5935579452;Taip;0;1;0;1
453;Aušrelė;SMALSUČIAI;2863655361;Taip;0;3;1;4
454;Aušrelė;SMALSUČIAI;2390128933;Taip;0;1;0;1
455;Aušrelė;SMALSUČIAI;8503309819;Taip;0;5;0;5
456;Aušrelė;SMALSUČIAI;2827216981;Taip;0;2;0;2
457;Aušrelė;SMALSUČIAI;9443641849;Taip;0;3;0;3
458;Aušrelė;SMALSUČIAI;7930717076;Taip;4;3;0;7
459;Aušrelė;SMALSUČIAI;7609339123;Taip;5;1;1;7
460;Aušrelė;SMALSUČIAI;1556010005;Taip;0;1;0;1
461;Aušrelė;SMALSUČIAI;5478028396;Taip;0;2;0;2
462;Aušrelė;SMALSUČIAI;7070013052;Taip;9;1;0;10
463;Aušrelė;SMALSUČIAI;3581155949;Taip;0;4;0;4
464;Aušrelė;SMALSUČIAI;6507218940;Taip;0;1;0;1
465;Aušrelė;SMALSUČIAI;2266390402;Taip;0;3;5;8
466;Aušrelė;SMALSUČIAI;8032661062;Taip;0;1;3;4
467;Aušrelė;SMALSUČIAI;4262596104;Taip;0;1;0;1
468;Aušrelė;SMALSUČIAI;1976613166;Taip;0;3;0;3
469;Aušrelė;KODĖLČIUKAI;7723159748;Taip;11;0;0;11
470;Aušrelė;KODĖLČIUKAI;7367268748;Taip;0;2;2;4
471;Aušrelė;KODĖLČIUKAI;5712867880;Taip;3;0;0;3
472;Aušrelė;KODĖLČIUKAI;3623813061;Taip;0;2;0;2
473;Aušrelė;KODĖLČIUKAI;4288695809;Taip;0;2;1;3
474;Aušrelė;KODĖLČIUKAI;8693750994;Taip;6;0;0;6
475;Aušrelė;KODĖLČIUKAI;7327544406;Taip;5;1;0;6
476;Aušrelė;KODĖLČIUKAI;9566144610;Taip;0;0;3;3
477;Aušrelė;KODĖLČIUKAI;6308519574;Taip;0;2;0;2
478;Aušrelė;KODĖLČIUKAI;6186758486;Taip;0;1;1;2
479;Aušrelė;KODĖLČIUKAI;3320399046;Taip;0;1;3;4
480;Aušrelė;KODĖLČIUKAI;6911735462;Taip;3;3;0;6
481;Aušrelė;KODĖLČIUKAI;4248808572;Taip;0;20;0;20
482;Aušrelė;KODĖLČIUKAI;8338569001;Taip;0;1;0;1
483;Aušrelė;KODĖLČIUKAI;2766357229;Ne;0;1;3;4
484;Aušrelė;KODĖLČIUKAI;7515666888;Taip;3;0;0;3
485;Aušrelė;KODĖLČIUKAI;4882556718;Taip;0;1;2;3
486;Aušrelė;KODĖLČIUKAI;6321332888;Taip;0;3;1;4
487;Aušrelė;PELĖDŽIUKAI;1985540746;Ne;12;1;0;13
488;Aušrelė;PELĖDŽIUKAI;4725588671;Taip;0;1;0;1
489;Aušrelė;PELĖDŽIUKAI;3223092149;Taip;0;17;0;17
490;Aušrelė;PELĖDŽIUKAI;8580241126;Taip;0;0;4;4
491;Aušrelė;PELĖDŽIUKAI;2545065554;Taip;0;2;0;2
492;Aušrelė;PELĖDŽIUKAI;4227228548;Taip;0;0;2;2
493;Aušrelė;PELĖDŽIUKAI;8996445434;Taip;0;0;3;3
494;Aušrelė;PELĖDŽIUKAI;8411336992;Taip;0;0;1;1
495;Aušrelė;PELĖDŽIUKAI;8917907028;Taip;3;0;0;3
496;Aušrelė;PELĖDŽIUKAI;7494298336;Taip;5;6;0;11
497;Aušrelė;PELĖDŽIUKAI;4012186237;Taip;0;0;4;4
498;Aušrelė;PELĖDŽIUKAI;3738923947;Taip;0;1;0;1
499;Aušrelė;PELĖDŽIUKAI;5312189552;Taip;0;3;0;3
500;Aušrelė;PELĖDŽIUKAI;1642358593;Ne;0;0;1;1
501;Aušrelė;PELĖDŽIUKAI;2294224426;Taip;0;2;0;2
502;Aušrelė;AITVARIUKAI;6833654667;Taip;2;2;0;4
503;Aušrelė;AITVARIUKAI;8102749675;Ne;0;8;0;8
504;Aušrelė;AITVARIUKAI;4595435635;Taip;6;0;0;6
505;Aušrelė;AITVARIUKAI;9608444990;Taip;0;1;1;2
506;Aušrelė;AITVARIUKAI;6434548772;Taip;16;0;0;16
507;Aušrelė;AITVARIUKAI;9158248746;Taip;2;0;0;2
508;Aušrelė;AITVARIUKAI;7978186455;Taip;0;20;0;20
509;Aušrelė;AITVARIUKAI;5602774323;Taip;4;2;0;6
510;Aušrelė;AITVARIUKAI;5708459561;Taip;6;0;2;8
511;Aušrelė;AITVARIUKAI;1039180129;Taip;4;4;1;9
512;Aušrelė;AITVARIUKAI;5125295651;Taip;0;6;0;6
513;Aušrelė;AITVARIUKAI;3807967685;Taip;0;10;0;10
514;Aušrelė;AITVARIUKAI;6081100604;Ne;9;2;0;11
515;Aušrelė;AITVARIUKAI;7847650967;Taip;0;4;0;4
516;Aušrelė;AITVARIUKAI;5727081833;Taip;1;1;0;2
517;Aušrelė;AITVARIUKAI;8210698019;Taip;0;20;0;20
518;Aušrelė;AITVARIUKAI;4942168388;Taip;0;20;0;20
519;Aušrelė;AITVARIUKAI;7788139791;Taip;0;1;1;2
520;Aušrelė;BITUTĖS;1741716341;Taip;0;18;0;18
521;Aušrelė;BITUTĖS;9960201865;Taip;2;1;0;3
522;Aušrelė;BITUTĖS;2071674661;Ne;0;13;0;13
523;Aušrelė;BITUTĖS;1450827353;Taip;5;0;0;5
524;Aušrelė;BITUTĖS;5598494461;Taip;0;17;0;17
525;Aušrelė;BITUTĖS;4935192851;Ne;0;4;0;4
526;Aušrelė;BITUTĖS;9505496063;Ne;0;4;0;4
527;Aušrelė;BITUTĖS;1931955562;Taip;6;1;0;7
528;Aušrelė;BITUTĖS;5614774250;Ne;0;2;0;2
529;Aušrelė;BITUTĖS;6591538425;Taip;0;18;0;18
530;Aušrelė;BITUTĖS;8203256528;Taip;0;14;0;14
531;Aušrelė;BITUTĖS;5741252819;Taip;0;14;0;14
532;Aušrelė;BITUTĖS;1243825974;Taip;0;6;0;6
533;Aušrelė;BITUTĖS;2468245186;Taip;0;1;0;1
534;Aušrelė;BITUTĖS;5266959731;Taip;0;1;1;2
535;Aušrelė;ŽIRNIUKAI;1949809977;Taip;8;0;0;8
536;Aušrelė;ŽIRNIUKAI;9733877752;Taip;0;6;0;6
537;Aušrelė;ŽIRNIUKAI;8542012622;Taip;0;2;0;2
538;Aušrelė;ŽIRNIUKAI;2221714044;Taip;10;0;0;10
539;Aušrelė;ŽIRNIUKAI;1544869163;Ne;0;1;0;1
540;Aušrelė;ŽIRNIUKAI;6577540623;Taip;7;0;0;7
541;Aušrelė;ŽIRNIUKAI;5460833944;Taip;13;0;0;13
542;Aušrelė;ŽIRNIUKAI;6372004855;Taip;9;1;0;10
543;Aušrelė;ŽIRNIUKAI;3713528812;Taip;2;3;0;5
544;Aušrelė;ŽIRNIUKAI;2107898976;Ne;10;3;0;13
545;Aušrelė;ŽIRNIUKAI;1607338052;Taip;0;3;0;3
546;Aušrelė;ŽIRNIUKAI;8573348956;Taip;0;20;0;20
547;Aušrelė;ŽIRNIUKAI;6463141345;Taip;0;2;0;2
548;Aušrelė;ŽIRNIUKAI;1798478023;Ne;10;0;0;10
549;Aušrelė;ŽIRNIUKAI;1754138341;Taip;6;8;0;14
550;Aušrelė;ŽIRNIUKAI;8797157671;Taip;5;0;0;5
551;Aušrelė;ŽIRNIUKAI;4591518039;Taip;0;2;0;2
552;Aušrelė;GRYBUKAI;1463724119;Taip;0;1;0;1
553;Aušrelė;GRYBUKAI;8438945369;Taip;0;6;0;6
554;Aušrelė;GRYBUKAI;6672975558;Taip;2;3;1;6
555;Aušrelė;GRYBUKAI;4565813136;Taip;0;1;15;16
556;Aušrelė;GRYBUKAI;9877307844;Taip;1;1;0;2
557;Aušrelė;GRYBUKAI;8947695521;Taip;0;1;0;1
558;Aušrelė;GRYBUKAI;7130040621;Taip;0;3;1;4
559;Aušrelė;GRYBUKAI;2311552230;Taip;1;0;0;1
560;Aušrelė;GRYBUKAI;1458580523;Taip;9;1;1;11
561;Aušrelė;GRYBUKAI;1871799626;Taip;0;1;0;1
562;Aušrelė;GRYBUKAI;5733298006;Taip;9;2;0;11
563;Aušrelė;GRYBUKAI;4924950592;Taip;0;0;1;1
564;Aušrelė;GRYBUKAI;6924023022;Taip;4;0;0;4
565;Aušrelė;GRYBUKAI;2466858636;Taip;0;20;0;20
566;Aušrelė;GRYBUKAI;2873845920;Taip;0;1;0;1
567;Aušrelė;GRYBUKAI;5904797250;Taip;19;1;0;20
568;Aušrelė;DRUGELIAI;9763241451;Ne;1;0;3;4
569;Aušrelė;DRUGELIAI;1209824814;Taip;4;1;5;10
570;Aušrelė;DRUGELIAI;7948024164;Taip;7;0;1;8
571;Aušrelė;DRUGELIAI;5429867368;Ne;2;3;0;5
572;Aušrelė;DRUGELIAI;3831695455;Ne;10;8;0;18
573;Aušrelė;DRUGELIAI;2737402297;Ne;4;0;2;6
574;Aušrelė;DRUGELIAI;4254737302;Taip;0;0;1;1
575;Aušrelė;DRUGELIAI;4464947621;Taip;12;1;0;13
576;Aušrelė;DRUGELIAI;9126040500;Taip;10;0;1;11
577;Aušrelė;DRUGELIAI;7286960315;Taip;5;0;4;9
578;Aušrelė;DRUGELIAI;2266835623;Taip;2;4;0;6
579;Aušrelė;DRUGELIAI;1094141305;Taip;6;0;0;6
580;Aušrelė;DRUGELIAI;9514049590;Taip;0;0;4;4
581;Aušrelė;DRUGELIAI;5709799539;Taip;10;0;1;11
582;Aušrelė;DRUGELIAI;8724802289;Taip;9;0;2;11
583;Aušrelė;DRUGELIAI;5815844340;Ne;0;1;0;1
584;Aušrelė;NYKŠTUKAI;9914518299;Taip;0;1;0;1
585;Aušrelė;NYKŠTUKAI;4297417711;Taip;0;1;0;1
586;Aušrelė;NYKŠTUKAI;4004600465;Taip;0;5;0;5
587;Aušrelė;NYKŠTUKAI;7964156691;Taip;0;4;0;4
588;Aušrelė;NYKŠTUKAI;7140465960;Taip;4;1;0;5
589;Aušrelė;NYKŠTUKAI;7937067384;Taip;3;0;0;3
590;Aušrelė;NYKŠTUKAI;8099338305;Taip;6;3;0;9
591;Aušrelė;NYKŠTUKAI;6513026989;Taip;6;0;0;6
592;Aušrelė;NYKŠTUKAI;4282189556;Taip;14;1;0;15
593;Aušrelė;NYKŠTUKAI;4252475967;Ne;1;0;0;1
594;Aušrelė;NYKŠTUKAI;8378225406;Taip;1;2;0;3
595;Aušrelė;NYKŠTUKAI;5018495543;Taip;9;0;0;9
596;Aušrelė;NYKŠTUKAI;3259828075;Taip;1;3;0;4
597;Aušrelė;NYKŠTUKAI;4952876188;Taip;1;0;0;1
598;Aušrelė;SPINDULIUKAI;8848358559;Taip;5;1;0;6
599;Aušrelė;SPINDULIUKAI;3194122285;Taip;0;20;0;20
600;Aušrelė;SPINDULIUKAI;5358736178;Taip;16;0;0;16
601;Aušrelė;SPINDULIUKAI;2857158437;Taip;5;0;0;5
602;Aušrelė;SPINDULIUKAI;5801943729;Ne;8;0;0;8
603;Aušrelė;SPINDULIUKAI;8801906679;Taip;6;3;0;9
604;Aušrelė;SPINDULIUKAI;7208341200;Ne;0;20;0;20
605;Aušrelė;SPINDULIUKAI;1446194971;Taip;5;1;0;6
606;Aušrelė;SPINDULIUKAI;2319188134;Taip;4;1;0;5
607;Aušrelė;SPINDULIUKAI;9251919940;Taip;0;0;20;20
608;Aušrelė;SPINDULIUKAI;1805615293;Taip;10;2;0;12
609;Aušrelė;SPINDULIUKAI;7966060521;Taip;0;1;0;1
610;Aušrelė;SPINDULIUKAI;5866673884;Taip;2;2;0;4
611;Aušrelė;SPINDULIUKAI;6418762623;Taip;0;5;0;5
612;Aušrelė;SPINDULIUKAI;8835689988;Ne;0;2;0;2
613;Aušrelė;SPINDULIUKAI;5274919078;Taip;0;2;2;4
614;Aušrelė;SPINDULIUKAI;2981314491;Taip;8;1;0;9
615;Aušrelė;SPINDULIUKAI;2441221298;Taip;0;20;0;20
616;Beržynėlis;SVIRPLIUKAI;4134371415;Taip;8;2;0;10
617;Beržynėlis;SVIRPLIUKAI;7278860816;Taip;8;2;0;10
618;Beržynėlis;SVIRPLIUKAI;4013099670;Taip;0;1;0;1
619;Beržynėlis;SVIRPLIUKAI;8303684788;Taip;9;3;0;12
620;Beržynėlis;SVIRPLIUKAI;7953957525;Taip;6;3;0;9
621;Beržynėlis;SVIRPLIUKAI;3418730586;Taip;0;1;0;1
622;Beržynėlis;SVIRPLIUKAI;1468551784;Taip;10;0;0;10
623;Beržynėlis;SVIRPLIUKAI;2221708263;Taip;11;0;0;11
624;Beržynėlis;SVIRPLIUKAI;6516665294;Ne;0;1;0;1
625;Beržynėlis;SVIRPLIUKAI;6673910279;Taip;0;1;0;1
626;Beržynėlis;SVIRPLIUKAI;8701990625;Taip;3;1;0;4
627;Beržynėlis;SVIRPLIUKAI;5027712732;Taip;10;0;0;10
628;Beržynėlis;SVIRPLIUKAI;7555487759;Taip;3;2;0;5
629;Beržynėlis;SVIRPLIUKAI;7788532819;Taip;8;2;0;10
630;Beržynėlis;SVIRPLIUKAI;8533912024;Taip;14;2;0;16
631;Beržynėlis;PELEDŽIUKAI;3278699117;Taip;0;11;0;11
632;Beržynėlis;PELEDŽIUKAI;1516309509;Taip;1;1;0;2
633;Beržynėlis;PELEDŽIUKAI;1395819329;Taip;0;0;3;3
634;Beržynėlis;PELEDŽIUKAI;9566341884;Taip;4;2;5;11
635;Beržynėlis;PELEDŽIUKAI;1682929565;Taip;0;0;6;6
636;Beržynėlis;PELEDŽIUKAI;7248602510;Ne;0;2;3;5
637;Beržynėlis;PELEDŽIUKAI;2681482042;Taip;0;0;1;1
638;Beržynėlis;PELEDŽIUKAI;6395436937;Taip;0;5;0;5
639;Beržynėlis;PELEDŽIUKAI;3641421009;Taip;4;0;0;4
640;Beržynėlis;PELEDŽIUKAI;2791734213;Taip;0;2;1;3
641;Beržynėlis;PELEDŽIUKAI;74856278886;Ne;0;1;0;1
642;Beržynėlis;PELEDŽIUKAI;71505149611;Taip;0;1;0;1
643;Beržynėlis;PELEDŽIUKAI;1639928056;Taip;0;2;1;3
644;Beržynėlis;PELEDŽIUKAI;1176943273;Taip;0;1;1;2
645;Beržynėlis;PELEDŽIUKAI;7929997884;Ne;0;5;2;7
646;Beržynėlis;PELEDŽIUKAI;8688852668;Taip;0;1;0;1
647;Beržynėlis;ŽIOGELIAI;5308596559;Taip;0;3;1;4
648;Beržynėlis;ŽIOGELIAI;4035764376;Taip;8;1;0;9
649;Beržynėlis;ŽIOGELIAI;4970999989;Taip;0;1;0;1
650;Beržynėlis;ŽIOGELIAI;9088059487;Taip;0;2;2;4
651;Beržynėlis;ŽIOGELIAI;5473666098;Taip;0;1;0;1
652;Beržynėlis;ŽIOGELIAI;7589778533;Taip;0;1;0;1
653;Beržynėlis;ŽIOGELIAI;8591800387;Taip;0;1;0;1
654;Beržynėlis;ŽIOGELIAI;6739927917;Ne;0;2;3;5
655;Beržynėlis;ŽIOGELIAI;2971686368;Taip;0;6;0;6
656;Beržynėlis;ŽIOGELIAI;9409317403;Taip;0;2;4;6
657;Beržynėlis;ŽIOGELIAI;9305279614;Taip;0;7;0;7
658;Beržynėlis;ŽIOGELIAI;9511051386;Taip;0;3;9;12
659;Beržynėlis;ŽIOGELIAI;5856519538;Taip;0;16;1;17
660;Beržynėlis;ŽIOGELIAI;3339522259;Ne;0;1;5;6
661;Beržynėlis;ŽIOGELIAI;6337962165;Taip;0;1;0;1
662;Beržynėlis;ŽIOGELIAI;6864823739;Taip;0;2;6;8
663;Beržynėlis;ŽIOGELIAI;9896122318;Ne;0;1;0;1
664;Beržynėlis;ŽIOGELIAI;6837130893;Taip;0;0;1;1
665;Beržynėlis;ŽIOGELIAI;3484188772;Ne;6;0;4;10
666;Beržynėlis;ŽVIRBLIUKAI;2193460960;Taip;0;2;0;2
667;Beržynėlis;ŽVIRBLIUKAI;2482395208;Taip;0;3;0;3
668;Beržynėlis;ŽVIRBLIUKAI;7057284039;Taip;0;1;0;1
669;Beržynėlis;ŽVIRBLIUKAI;2892553878;Taip;0;12;0;12
670;Beržynėlis;ŽVIRBLIUKAI;4466393687;Taip;0;2;0;2
671;Beržynėlis;ŽVIRBLIUKAI;4774769217;Taip;0;2;1;3
672;Beržynėlis;ŽVIRBLIUKAI;9503352345;Taip;0;2;5;7
673;Beržynėlis;ŽVIRBLIUKAI;8881566865;Taip;0;0;8;8
674;Beržynėlis;ŽVIRBLIUKAI;8280378527;Taip;0;3;0;3
675;Beržynėlis;ŽVIRBLIUKAI;6713134631;Taip;0;2;0;2
676;Beržynėlis;ŽVIRBLIUKAI;5593146590;Taip;0;1;0;1
677;Beržynėlis;ŽVIRBLIUKAI;9754455116;Taip;9;1;0;10
678;Beržynėlis;ŽVIRBLIUKAI;3334994408;Taip;11;0;0;11
679;Beržynėlis;ŽVIRBLIUKAI;9777841895;Taip;0;2;2;4
680;Beržynėlis;ŽVIRBLIUKAI;6293884233;Taip;0;2;1;3
681;Beržynėlis;ŽVIRBLIUKAI;4161974847;Ne;0;2;1;3
682;Beržynėlis;ŽVIRBLIUKAI;3209966996;Taip;0;1;0;1
683;Beržynėlis;ŽVIRBLIUKAI;5194416351;Taip;0;2;0;2
684;Beržynėlis;ŽVIRBLIUKAI;1228384088;Taip;7;0;1;8
685;Beržynėlis;ŽVIRBLIUKAI;5189335842;Taip;0;2;5;7
686;Beržynėlis;ŽIRNIUKAI;6932094459;Taip;0;2;0;2
687;Beržynėlis;ŽIRNIUKAI;5864265458;Taip;0;10;0;10
688;Beržynėlis;ŽIRNIUKAI;2583982025;Taip;0;4;0;4
689;Beržynėlis;ŽIRNIUKAI;7870888327;Taip;4;0;0;4
690;Beržynėlis;ŽIRNIUKAI;1558469002;Taip;5;0;0;5
691;Beržynėlis;ŽIRNIUKAI;9603272698;Taip;14;2;0;16
692;Beržynėlis;ŽIRNIUKAI;9493489114;Taip;14;2;0;16
693;Beržynėlis;ŽIRNIUKAI;4786786104;Taip;6;5;0;11
694;Beržynėlis;ŽIRNIUKAI;4944466205;Taip;5;1;0;6
695;Beržynėlis;ŽIRNIUKAI;6392773584;Taip;0;2;0;2
696;Beržynėlis;ŽIRNIUKAI;2155662035;Taip;8;1;0;9
697;Beržynėlis;ŽIRNIUKAI;4978363316;Taip;11;0;0;11
698;Beržynėlis;ŽIRNIUKAI;7806800327;Ne;14;0;0;14
699;Beržynėlis;VIŠČIUKAI;7016454952;Taip;10;2;0;12
700;Beržynėlis;VIŠČIUKAI;7903644161;Taip;10;0;0;10
701;Beržynėlis;VIŠČIUKAI;1707585750;Taip;3;14;2;19
702;Beržynėlis;VIŠČIUKAI;4382068779;Taip;14;0;0;14
703;Beržynėlis;VIŠČIUKAI;2272661119;Taip;6;1;0;7
704;Beržynėlis;VIŠČIUKAI;1831776326;Taip;12;0;0;12
705;Beržynėlis;VIŠČIUKAI;1118349439;Taip;0;0;4;4
706;Beržynėlis;VIŠČIUKAI;4369803044;Ne;15;0;0;15
707;Beržynėlis;VIŠČIUKAI;1503903200;Taip;0;0;1;1
708;Beržynėlis;VIŠČIUKAI;3593785967;Taip;5;0;0;5
709;Beržynėlis;VIŠČIUKAI;7972993168;Ne;0;2;0;2
710;Beržynėlis;VIŠČIUKAI;5049057730;Taip;5;0;5;10
711;Beržynėlis;VIŠČIUKAI;7084666673;Taip;7;1;0;8
712;Beržynėlis;VIŠČIUKAI;6592330036;Taip;6;0;0;6
713;Beržynėlis;VIŠČIUKAI;7343603169;Taip;6;0;0;6
714;Beržynėlis;VIŠČIUKAI;3100097647;Taip;0;0;5;5
715;Birutės;SKRUZDELIUKŲ;1761065941;Taip;0;2;0;2
716;Birutės;SKRUZDELIUKŲ;9610268046;Taip;5;0;0;5
717;Birutės;SKRUZDELIUKŲ;4027700332;Taip;0;0;3;3
718;Birutės;SKRUZDELIUKŲ;1105133326;Taip;5;2;13;20
719;Birutės;SKRUZDELIUKŲ;8636113039;Taip;0;4;0;4
720;Birutės;SKRUZDELIUKŲ;9411016611;Taip;0;4;0;4
721;Birutės;SKRUZDELIUKŲ;7119951690;Taip;5;0;0;5
722;Birutės;SKRUZDELIUKŲ;1945532852;Taip;0;1;0;1
723;Birutės;SKRUZDELIUKŲ;5154903444;Taip;0;1;0;1
724;Birutės;SKRUZDELIUKŲ;9187671201;Taip;6;1;3;10
725;Birutės;SKRUZDELIUKŲ;7404631298;Taip;5;0;0;5
726;Birutės;SKRUZDELIUKŲ;8432173636;Taip;0;4;0;4
727;Birutės;SKRUZDELIUKŲ;9904827482;Taip;0;11;0;11
728;Birutės;SKRUZDELIUKŲ;2140552221;Ne;0;1;0;1
729;Birutės;SKRUZDELIUKŲ;8413760872;Taip;4;3;0;7
730;Birutės;SKRUZDELIUKŲ;7940403585;Taip;9;1;0;10
731;Birutės;SKRUZDELIUKŲ;2859160609;Taip;0;1;0;1
732;Birutės;SKRUZDELIUKŲ;7251592439;Taip;9;0;0;9
733;Birutės;BITUČIŲ;1599159924;Ne;0;0;2;2
734;Birutės;BITUČIŲ;33770983649;Taip;2;3;0;5
735;Birutės;BITUČIŲ;87693588654;Taip;0;1;0;1
736;Birutės;BITUČIŲ;2975442228;Taip;0;3;0;3
737;Birutės;BITUČIŲ;5770026060;Taip;0;1;0;1
738;Birutės;BITUČIŲ;5947971037;Taip;5;3;0;8
739;Birutės;BITUČIŲ;3870702348;Taip;0;1;0;1
740;Birutės;BITUČIŲ;3436637062;Taip;19;0;0;19
741;Birutės;BITUČIŲ;8465645434;Taip;1;0;0;1
742;Birutės;BITUČIŲ;9722922540;Taip;0;0;6;6
743;Birutės;BITUČIŲ;3061210677;Taip;0;1;1;2
744;Birutės;BITUČIŲ;6081472534;Taip;0;1;0;1
745;Birutės;BITUČIŲ;2674259453;Taip;5;0;2;7
746;Birutės;BITUČIŲ;17865476849;Taip;5;0;0;5
747;Birutės;BITUČIŲ;2329522074;Taip;0;1;0;1
748;Birutės;BITUČIŲ;6006110601;Taip;0;0;1;1
749;Birutės;BITUČIŲ;4253571334;Taip;0;2;0;2
750;Birutės;BITUČIŲ;1447494370;Taip;1;1;0;2
751;Birutės;BORUŽIUKAI;5893851353;Taip;2;1;0;3
752;Birutės;BORUŽIUKAI;5457357625;Taip;4;0;1;5
753;Birutės;BORUŽIUKAI;5869137292;Taip;3;0;0;3
754;Birutės;BORUŽIUKAI;5026442722;Taip;0;5;0;5
755;Birutės;BORUŽIUKAI;6977276295;Taip;16;0;3;19
756;Birutės;BORUŽIUKAI;9289922622;Taip;0;0;1;1
757;Birutės;BORUŽIUKAI;1776142202;Taip;4;0;3;7
758;Birutės;BORUŽIUKAI;4906874758;Taip;0;1;0;1
759;Birutės;BORUŽIUKAI;9263238557;Taip;0;1;0;1
760;Birutės;BORUŽIUKAI;4488481136;Taip;0;3;2;5
761;Birutės;BORUŽIUKAI;6460415179;Taip;0;0;2;2
762;Birutės;BORUŽIUKAI;6973898557;Taip;0;3;0;3
763;Birutės;BORUŽIUKAI;7033907787;Taip;1;0;1;2
764;Birutės;BORUŽIUKAI;5745377474;Taip;0;1;3;4
765;Birutės;BORUŽIUKAI;5897671273;Taip;11;0;10;21
766;Birutės;BORUŽIUKAI;2016711225;Taip;7;0;1;8
767;Birutės;BORUŽIUKAI;1400510886;Taip;0;0;1;1
768;Birutės;BORUŽIUKAI;7494879160;Ne;1;0;0;1
769;Birutės;BORUŽIUKAI;5875585426;Taip;0;0;3;3
770;Birutės;BORUŽIUKAI;7398022393;Ne;0;0;1;1
771;Birutės;BORUŽIUKAI;7712882120;Taip;8;1;1;10
772;Birutės;BORUŽIUKAI;7741922416;Taip;0;11;2;13
773;Birutės;BORUŽIUKAI;2681370776;Taip;0;0;3;3
774;Birutės;DRUGELIAI;8854957814;Taip;6;0;7;13
775;Birutės;DRUGELIAI;6263985683;Taip;2;0;0;2
776;Birutės;DRUGELIAI;4995437657;Taip;0;0;2;2
777;Birutės;DRUGELIAI;5957267018;Taip;0;0;5;5
778;Birutės;DRUGELIAI;1442496209;Taip;4;0;0;4
779;Birutės;DRUGELIAI;2318034045;Taip;11;0;1;12
780;Birutės;DRUGELIAI;9727836236;Ne;2;0;0;2
781;Birutės;DRUGELIAI;3516719248;Taip;0;0;1;1
782;Birutės;DRUGELIAI;5688633357;Ne;0;2;10;12
783;Birutės;DRUGELIAI;8559820030;Taip;0;0;12;12
784;Birutės;DRUGELIAI;9863681147;Taip;0;0;1;1
785;Birutės;DRUGELIAI;9307655828;Ne;14;0;1;15
786;Birutės;DRUGELIAI;3115571205;Taip;0;0;1;1
787;Birutės;DRUGELIAI;4674152995;Taip;0;0;1;1
788;Birutės;DRUGELIAI;5177528200;Taip;7;0;2;9
789;Birutės;DRUGELIAI;3391101786;Taip;3;0;3;6
790;Birutės;DRUGELIAI;7876057712;Taip;0;0;1;1
791;Birutės;DRUGELIAI;6765257633;Taip;1;0;3;4
792;Birutės;DRUGELIAI;7336936451;Taip;0;11;0;11
793;Bitutė;Aitvariukų;4474600934;Taip;0;1;1;2
794;Bitutė;Aitvariukų;5606049201;Taip;12;2;0;14
795;Bitutė;Aitvariukų;6035394425;Ne;8;4;0;12
796;Bitutė;Aitvariukų;7132616264;Taip;0;8;0;8
797;Bitutė;Aitvariukų;8796728627;Ne;0;3;0;3
798;Bitutė;Aitvariukų;6030674568;Taip;11;0;2;13
799;Bitutė;Aitvariukų;9747786638;Taip;8;0;3;11
800;Bitutė;Aitvariukų;8259512455;Taip;0;0;6;6
801;Bitutė;Aitvariukų;9106644834;Taip;9;1;0;10
802;Bitutė;Aitvariukų;2899217019;Ne;9;0;0;9
803;Bitutė;Aitvariukų;8670124052;Taip;2;1;0;3
804;Bitutė;Aitvariukų;1340530611;Taip;0;0;1;1
805;Bitutė;Aitvariukų;6759511692;Taip;7;0;1;8
806;Bitutė;Aitvariukų;4164058783;Taip;9;0;1;10
807;Bitutė;Aitvariukų;8908052679;Taip;15;0;0;15
808;Bitutė;Aitvariukų;4924483609;Taip;0;8;0;8
809;Bitutė;Aitvariukų;7447624247;Ne;5;6;0;11
810;Bitutė;Aitvariukų;5880651175;Taip;3;0;0;3
811;Bitutė;Aitvariukų;6601881478;Ne;0;0;3;3
812;Bitutė;Ežiukų;56287634684;Taip;0;1;2;3
813;Bitutė;Ežiukų;5126303823;Taip;7;0;7;14
814;Bitutė;Ežiukų;4764586168;Taip;0;1;2;3
815;Bitutė;Ežiukų;8905075899;Taip;5;0;3;8
816;Bitutė;Ežiukų;3600670185;Taip;0;0;2;2
817;Bitutė;Ežiukų;6341806464;Ne;0;0;7;7
818;Bitutė;Ežiukų;7456328992;Ne;0;1;0;1
819;Bitutė;Ežiukų;2812580726;Ne;0;4;3;7
820;Bitutė;Ežiukų;8186706520;Ne;0;31;0;31
821;Bitutė;Ežiukų;1904108612;Taip;0;1;0;1
822;Bitutė;Ežiukų;2122052883;Taip;9;0;4;13
823;Bitutė;Ežiukų;4444523140;Taip;4;1;2;7
824;Bitutė;Ežiukų;4024758152;Taip;0;1;0;1
825;Bitutė;Ežiukų;6194712643;Taip;0;1;0;1
826;Bitutė;Ežiukų;4468366941;Taip;5;0;2;7
827;Bitutė;Ežiukų;5188828679;Taip;1;2;0;3
828;Bitutė;Ežiukų;8109028957;Taip;0;2;0;2
829;Bitutė;Ežiukų;3156654672;Taip;5;1;8;14
830;Bitutė;Žvirbliukų;7047262367;Taip;5;0;0;5
831;Bitutė;Žvirbliukų;3804171750;Taip;0;2;0;2
832;Bitutė;Žvirbliukų;8545377054;Taip;0;2;0;2
833;Bitutė;Žvirbliukų;5406667195;Taip;0;1;1;2
834;Bitutė;Žvirbliukų;4458990772;Taip;0;0;1;1
835;Bitutė;Žvirbliukų;3723040682;Taip;0;5;0;5
836;Bitutė;Žvirbliukų;2190439190;Taip;9;3;0;12
837;Bitutė;Žvirbliukų;7113693496;Taip;4;0;3;7
838;Bitutė;Žvirbliukų;4177331531;Taip;0;0;3;3
839;Bitutė;Žvirbliukų;2483462846;Taip;0;4;0;4
840;Bitutė;Žvirbliukų;7678106084;Taip;0;1;0;1
841;Bitutė;Žvirbliukų;6044969600;Taip;0;1;0;1
842;Bitutė;Žvirbliukų;2444289145;Taip;1;5;0;6
843;Bitutė;Žvirbliukų;3517750478;Taip;0;6;0;6
844;Bitutė;Žvirbliukų;5291764696;Taip;0;0;3;3
845;Bitutė;Žvirbliukų;9523588597;Taip;0;1;1;2
846;Bitutė;Žvirbliukų;9166624750;Taip;13;0;0;13
847;Bitutė;Žvirbliukų;8373105196;Taip;0;1;8;9
848;Bitutė;Žvirbliukų;6014726741;Taip;0;1;0;1
849;Bitutė;Žvirbliukų;4527880105;Taip;0;1;2;3
850;Bitutė;Žvirbliukų;9834697190;Taip;1;0;0;1
851;Bitutė;Gandriukų;8519978626;Ne;0;2;3;5
852;Bitutė;Gandriukų;1809034174;Ne;9;1;2;12
853;Bitutė;Gandriukų;6586888742;Taip;7;1;11;19
854;Bitutė;Gandriukų;5783154071;Ne;0;2;0;2
855;Bitutė;Gandriukų;7387822939;Ne;0;1;5;6
856;Bitutė;Gandriukų;6052204491;Taip;0;2;0;2
857;Bitutė;Gandriukų;37105491775;Taip;0;2;0;2
858;Bitutė;Gandriukų;90943054285;Taip;4;7;0;11
859;Bitutė;Gandriukų;6659750060;Ne;0;1;0;1
860;Bitutė;Gandriukų;9683582019;Taip;0;1;1;2
861;Bitutė;Gandriukų;11567978993;Taip;9;10;0;19
862;Bitutė;Gandriukų;7352524951;Taip;0;1;0;1
863;Bitutė;Gandriukų;2350260809;Taip;0;1;7;8
864;Bitutė;Gandriukų;27144303911;Taip;0;2;0;2
865;Bitutė;Gandriukų;1942685472;Taip;0;6;0;6
866;Bitutė;Gandriukų;1307749129;Taip;0;4;0;4
867;Bitutė;Gandriukų;5653055907;Taip;2;4;0;6
868;Bitutė;Gandriukų;6678928989;Ne;10;2;0;12
869;Bitutė;Gandriukų;1802887869;Taip;2;1;0;3
870;Bitutė;Gandriukų;51054491845;Taip;0;1;0;1
871;Bitutė;Gandriukų;4574673585;Taip;0;2;1;3
872;Bitutė;Gandriukų;47316276655;Taip;0;2;0;2
873;Bitutė;Pelėdžiukai;3254061362;Taip;5;0;0;5
874;Bitutė;Pelėdžiukai;5455919343;Taip;0;3;0;3
875;Bitutė;Pelėdžiukai;8743734366;Taip;13;2;0;15
876;Bitutė;Pelėdžiukai;6674923740;Taip;0;2;0;2
877;Bitutė;Pelėdžiukai;2804203556;Taip;15;1;0;16
878;Bitutė;Pelėdžiukai;8394685672;Taip;6;1;0;7
879;Bitutė;Pelėdžiukai;7056737587;Taip;2;0;0;2
880;Bitutė;Pelėdžiukai;4985270536;Taip;0;13;0;13
881;Bitutė;Pelėdžiukai;1590501589;Taip;0;13;0;13
882;Bitutė;Pelėdžiukai;3796188100;Taip;0;3;1;4
883;Bitutė;Pelėdžiukai;1564763789;Taip;0;1;0;1
884;Bitutė;Pelėdžiukai;1846974702;Taip;5;1;0;6
885;Bitutė;Pelėdžiukai;5679397165;Taip;6;1;0;7
886;Bitutė;Pelėdžiukai;1162903905;Taip;0;1;0;1
887;Bitutė;Pelėdžiukai;3432065233;Taip;0;1;0;1
888;Bitutė;Pelėdžiukai;1560715159;Taip;0;6;0;6
889;Bitutė;Pelėdžiukai;6204566294;Taip;0;1;0;1
890;Bitutė;Pelėdžiukai;2518730247;Taip;3;1;3;7
891;Bitutė;Pelėdžiukai;4315172747;Taip;5;1;0;6
892;Bitutė;Pelėdžiukai;9838379838;Taip;4;5;0;9
893;Bitutė;Pelėdžiukai;3227252972;Ne;0;1;0;1
894;Bitutė;Boružėlių;8276590981;Taip;12;1;3;16
895;Bitutė;Boružėlių;3026526421;Taip;11;4;0;15
896;Bitutė;Boružėlių;7503203424;Taip;15;0;1;16
897;Bitutė;Boružėlių;1711888057;Taip;8;0;0;8
898;Bitutė;Boružėlių;8355346371;Taip;7;0;0;7
899;Bitutė;Boružėlių;2583001947;Taip;2;6;1;9
900;Bitutė;Boružėlių;9545405359;Taip;8;0;0;8
901;Bitutė;Boružėlių;2129484313;Taip;9;7;0;16
902;Bitutė;Boružėlių;9691450767;Taip;0;0;3;3
903;Bitutė;Boružėlių;3170266155;Taip;10;0;3;13
904;Bitutė;Boružėlių;6455582149;Taip;5;0;1;6
905;Bitutė;Boružėlių;2144809294;Taip;1;0;2;3
906;Bitutė;Boružėlių;8011051470;Taip;12;0;7;19
907;Bitutė;Boružėlių;9521938997;Taip;9;2;0;11
908;Bitutė;Boružėlių;9668365838;Taip;13;0;0;13
909;Bitutė;Boružėlių;3870675531;Taip;0;0;1;1
910;Bitutė;Boružėlių;7095475821;Taip;5;0;1;6
911;Bitutė;Boružėlių;6255439813;Taip;16;0;0;16
912;Bitutė;Boružėlių;2623999429;Taip;10;0;0;10
913;Bitutė;Boružėlių;6840722112;Taip;8;0;2;10
914;Bitutė;Boružėlių;4884898917;Taip;5;5;0;10
915;Bitutė;Boružėlių;4869423833;Taip;5;1;7;13
916;Bitutė;Boružėlių;5071978105;Taip;6;0;1;7
917;Bitutė;Šokliukų;8211710975;Taip;0;7;6;13
918;Bitutė;Šokliukų;8872286273;Taip;9;1;0;10
919;Bitutė;Šokliukų;5169768042;Taip;6;2;0;8
920;Bitutė;Šokliukų;4917599786;Ne;1;0;0;1
921;Bitutė;Šokliukų;1348548294;Taip;0;15;0;15
922;Bitutė;Šokliukų;7318555933;Taip;0;6;0;6
923;Bitutė;Šokliukų;1012702386;Taip;0;5;1;6
924;Bitutė;Šokliukų;9924340801;Taip;3;6;0;9
925;Bitutė;Šokliukų;7979566741;Ne;8;1;0;9
926;Bitutė;Šokliukų;7165511381;Taip;8;4;1;13
927;Bitutė;Šokliukų;9465186207;Taip;15;4;0;19
928;Bitutė;Šokliukų;2853616585;Ne;13;1;2;16
929;Bitutė;Šokliukų;5109258680;Taip;4;2;0;6
930;Bitutė;Šokliukų;8439759353;Taip;9;0;0;9
931;Bitutė;Šokliukų;3417576747;Taip;0;3;1;4
932;Bitutė;Šokliukų;8422448947;Ne;1;8;0;9
933;Bitutė;Šokliukų;7926482326;Taip;0;8;0;8
934;Bitutė;Šokliukų;5876700984;Taip;0;3;0;3
935;Bitutė;Šokliukų;2177537591;Ne;2;0;1;3
936;Bitutė;Šokliukų;5759407291;Taip;0;1;0;1
937;Bitutė;Šokliukų;4471813998;Taip;0;1;0;1
938;Bitutė;Šokliukų;9234090775;Ne;6;0;5;11
939;Bitutė;Drugelių;9094567866;Taip;0;3;1;4
940;Bitutė;Drugelių;5759595005;Taip;0;0;2;2
941;Bitutė;Drugelių;2085899696;Taip;16;5;0;21
942;Bitutė;Drugelių;2029309955;Taip;0;4;0;4
943;Bitutė;Drugelių;7376746010;Taip;0;6;0;6
944;Bitutė;Drugelių;5845408472;Taip;4;2;0;6
945;Bitutė;Drugelių;3611348253;Taip;0;3;0;3
946;Bitutė;Drugelių;8727525320;Taip;8;0;0;8
947;Bitutė;Drugelių;1558826102;Taip;13;0;0;13
948;Bitutė;Drugelių;6325890676;Taip;22;0;0;22
949;Bitutė;Drugelių;2748400429;Taip;27;4;0;31
950;Bitutė;Drugelių;5146691157;Taip;2;0;0;2
951;Bitutė;Drugelių;2848732083;Ne;0;2;1;3
952;Bitutė;Drugelių;5278510767;Taip;0;2;0;2
953;Bitutė;Drugelių;8962725357;Taip;5;1;0;6
954;Bitutė;Drugelių;5471241132;Ne;0;7;0;7
955;Bitutė;Drugelių;1218462939;Taip;3;2;0;5
956;Bitutė;Drugelių;5081300818;Taip;6;13;0;19
957;Bitutė;Drugelių;7013249141;Taip;0;3;1;4
958;Bitutė;Drugelių;1397711778;Taip;7;5;3;15
959;Bitutė;Drugelių;8008237092;Taip;0;10;4;14
960;Bitutė;Drugelių;4545188971;Taip;17;1;0;18
961;Bitutė;Kiškučių;9451529077;Taip;0;0;2;2
962;Bitutė;Kiškučių;1907876695;Taip;0;1;0;1
963;Bitutė;Kiškučių;7720798466;Taip;3;0;0;3
964;Bitutė;Kiškučių;1662815358;Taip;0;1;0;1
965;Bitutė;Kiškučių;1733189730;Taip;0;4;0;4
966;Bitutė;Kiškučių;9966437881;Taip;0;1;0;1
967;Bitutė;Kiškučių;1985958540;Taip;0;2;0;2
968;Bitutė;Kiškučių;8743960488;Taip;0;5;2;7
969;Bitutė;Kiškučių;9337144831;Taip;0;4;0;4
970;Bitutė;Kiškučių;4566919587;Taip;5;0;0;5
971;Bitutė;Kiškučių;2806899030;Taip;2;1;0;3
972;Bitutė;Kiškučių;5443722813;Taip;0;5;0;5
973;Bitutė;Kiškučių;1241863345;Taip;0;2;0;2
974;Bitutė;Kiškučių;8789574593;Ne;1;0;6;7
975;Bitutė;Kiškučių;8799003374;Taip;0;13;0;13
976;Bitutė;Kiškučių;9217178863;Taip;0;1;0;1
977;Bitutė;Kiškučių;5490753578;Ne;13;0;0;13
978;Bitutė;"Viščiukų ";3603716923;Taip;5;0;0;5
979;Bitutė;"Viščiukų ";5181958187;Taip;0;4;2;6
980;Bitutė;"Viščiukų ";7694916340;Taip;0;31;0;31
981;Bitutė;"Viščiukų ";8303932330;Taip;8;2;0;10
982;Bitutė;"Viščiukų ";8642411661;Taip;6;2;0;8
983;Bitutė;"Viščiukų ";1198024852;Taip;12;2;0;14
984;Bitutė;"Viščiukų ";9909017070;Taip;13;1;0;14
985;Bitutė;"Viščiukų ";3811028304;Taip;23;0;0;23
986;Bitutė;"Viščiukų ";9592567172;Taip;3;3;0;6
987;Bitutė;"Viščiukų ";7619112317;Taip;0;4;0;4
988;Bitutė;"Viščiukų ";1715987321;Taip;21;0;0;21
989;Bitutė;"Viščiukų ";4926289620;Taip;10;0;2;12
990;Bitutė;"Viščiukų ";8130382253;Taip;10;3;0;13
991;Bitutė;"Viščiukų ";5869737425;Taip;12;0;0;12
992;Bitutė;"Viščiukų ";5220694242;Taip;0;2;0;2
993;Bitutė;"Viščiukų ";7535583229;Taip;4;6;0;10
994;Bitutė;"Viščiukų ";4480187618;Taip;5;0;0;5
995;Bitutė;"Viščiukų ";5061164237;Taip;9;0;0;9
996;Bitutė;"Skruzdėliukai ";5686278261;Taip;0;9;0;9
997;Bitutė;"Skruzdėliukai ";5942493696;Ne;0;1;0;1
998;Bitutė;"Skruzdėliukai ";6311396261;Taip;5;2;0;7
999;Bitutė;"Skruzdėliukai ";7145036085;Taip;5;2;2;9
1000;Bitutė;"Skruzdėliukai ";2252157473;Taip;2;0;1;3
1001;Bitutė;"Skruzdėliukai ";6169426273;Taip;13;1;2;16
1002;Bitutė;"Skruzdėliukai ";4513783927;Taip;0;0;2;2
1003;Bitutė;"Skruzdėliukai ";8667259778;Taip;5;0;11;16
1004;Bitutė;"Skruzdėliukai ";4413880918;Taip;0;0;4;4
1005;Bitutė;"Skruzdėliukai ";9436414962;Taip;10;3;0;13
1006;Bitutė;"Skruzdėliukai ";9864771568;Taip;3;0;6;9
1007;Bitutė;"Skruzdėliukai ";6353690252;Taip;7;1;1;9
1008;Bitutė;"Skruzdėliukai ";2160735504;Taip;13;1;0;14
1009;Bitutė;"Skruzdėliukai ";1387310054;Taip;16;0;0;16
1010;Bitutė;"Skruzdėliukai ";7245807233;Taip;6;0;3;9
1011;Bitutė;"Skruzdėliukai ";4467090141;Taip;0;1;1;2
1012;Bitutė;"Skruzdėliukai ";5433617195;Taip;0;4;0;4
1013;Bitutė;"Skruzdėliukai ";2391170362;Taip;5;0;0;5
1014;Bitutė;"Nykštukų ";1290146001;Ne;11;0;1;12
1015;Bitutė;"Nykštukų ";3359918177;Taip;6;0;0;6
1016;Bitutė;"Nykštukų ";9352292654;Taip;0;10;2;12
1017;Bitutė;"Nykštukų ";5421744666;Taip;11;1;0;12
1018;Bitutė;"Nykštukų ";9780599803;Taip;21;0;0;21
1019;Bitutė;"Nykštukų ";7741454857;Taip;2;0;3;5
1020;Bitutė;"Nykštukų ";3860047703;Ne;5;0;0;5
1021;Bitutė;"Nykštukų ";6226996242;Taip;0;2;0;2
1022;Bitutė;"Nykštukų ";1460746240;Taip;16;1;0;17
1023;Bitutė;"Nykštukų ";8896842164;Taip;0;31;0;31
1024;Bitutė;"Nykštukų ";2819417600;Taip;6;1;0;7
1025;Bitutė;"Nykštukų ";8561037889;Taip;0;8;0;8
1026;Bitutė;"Nykštukų ";6091108131;Taip;10;2;0;12
1027;Bitutė;"Nykštukų ";5375847129;Taip;15;0;0;15
1028;Bitutė;"Nykštukų ";3528436838;Taip;12;1;0;13
1029;Bitutė;"Nykštukų ";8270270602;Taip;10;0;2;12
1030;Bitutė;"Nykštukų ";4617493676;Taip;6;0;8;14
1031;Bitutė;"Nykštukų ";3806852067;Taip;16;1;0;17
1032;Coliukė;DRUGELIAI;3151183436;Taip;6;0;1;7
1033;Coliukė;DRUGELIAI;6675290003;Taip;12;0;0;12
1034;Coliukė;DRUGELIAI;9890663421;Taip;17;0;0;17
1035;Coliukė;DRUGELIAI;7763035106;Taip;0;1;0;1
1036;Coliukė;DRUGELIAI;3628571567;Taip;0;6;0;6
1037;Coliukė;DRUGELIAI;9688432169;Taip;11;0;0;11
1038;Coliukė;DRUGELIAI;7513522378;Taip;10;1;0;11
1039;Coliukė;DRUGELIAI;8478006305;Taip;0;1;0;1
1040;Coliukė;DRUGELIAI;9352547729;Taip;0;3;0;3
1041;Coliukė;DRUGELIAI;3908791146;Taip;16;0;0;16
1042;Coliukė;DRUGELIAI;9750447455;Taip;7;3;0;10
1043;Coliukė;DRUGELIAI;3367789231;Taip;10;0;0;10
1044;Coliukė;DRUGELIAI;1220834062;Taip;0;1;0;1
1045;Coliukė;DRUGELIAI;3392367716;Taip;0;0;1;1
1046;Coliukė;DRUGELIAI;2385917598;Taip;5;0;0;5
1047;Coliukė;DRUGELIAI;1390751418;Ne;2;0;0;2
1048;Coliukė;DRUGELIAI;4881447596;Taip;0;2;0;2
1049;Coliukė;DRUGELIAI;6224089401;Taip;0;4;0;4
1050;Coliukė;DRUGELIAI;7284465232;Taip;16;1;0;17
1051;Coliukė;DRUGELIAI;8756465257;Taip;6;1;0;7
1052;Coliukė;BITUTĖS;6725408547;Taip;0;0;6;6
1053;Coliukė;BITUTĖS;2167230398;Taip;11;0;0;11
1054;Coliukė;BITUTĖS;1960898805;Taip;10;6;0;16
1055;Coliukė;BITUTĖS;7920728387;Taip;6;1;0;7
1056;Coliukė;BITUTĖS;8767261039;Taip;5;0;0;5
1057;Coliukė;BITUTĖS;1968467455;Taip;10;0;0;10
1058;Coliukė;BITUTĖS;9462610674;Taip;0;1;0;1
1059;Coliukė;BITUTĖS;4188233426;Taip;5;2;0;7
1060;Coliukė;BITUTĖS;8457120425;Taip;8;0;0;8
1061;Coliukė;BITUTĖS;1240946719;Taip;0;4;0;4
1062;Coliukė;BITUTĖS;9331485675;Taip;0;1;0;1
1063;Coliukė;BITUTĖS;9311775782;Taip;0;1;0;1
1064;Coliukė;BITUTĖS;2275327607;Taip;0;1;0;1
1065;Coliukė;BITUTĖS;3346269598;Taip;0;1;0;1
1066;Coliukė;BITUTĖS;9879369365;Taip;6;6;0;12
1067;Coliukė;BITUTĖS;4845247006;Taip;1;4;0;5
1068;Coliukė;BITUTĖS;9885547263;Taip;9;0;1;10
1069;Coliukė;BITUTĖS;36554487034;Taip;0;3;0;3
1070;Coliukė;BITUTĖS;1458763954;Taip;0;1;0;1
1071;Coliukė;BITUTĖS;6860757091;Taip;1;1;0;2
1072;Coliukė;BITUTĖS;8517128464;Taip;0;1;1;2
1073;Coliukė;BITUTĖS;8149118599;Taip;2;3;0;5
1074;Coliukė;BITUTĖS;7345905007;Taip;5;0;0;5
1075;Coliukė;BITUTĖS;7358018315;Taip;0;0;2;2
1076;Coliukė;VABALIUKAI;1105879142;Taip;6;1;0;7
1077;Coliukė;VABALIUKAI;1537341012;Taip;5;2;0;7
1078;Coliukė;VABALIUKAI;6984254334;Taip;0;3;0;3
1079;Coliukė;VABALIUKAI;5835199087;Taip;11;0;0;11
1080;Coliukė;VABALIUKAI;4626722910;Taip;13;1;0;14
1081;Coliukė;VABALIUKAI;9526108197;Ne;7;4;0;11
1082;Coliukė;VABALIUKAI;1318558913;Taip;0;1;0;1
1083;Coliukė;VABALIUKAI;6475497234;Taip;15;0;0;15
1084;Coliukė;VABALIUKAI;5596775091;Taip;15;0;0;15
1085;Coliukė;VABALIUKAI;4172517506;Taip;11;2;0;13
1086;Coliukė;VABALIUKAI;4493314926;Taip;1;5;0;6
1087;Coliukė;VABALIUKAI;2469993058;Taip;0;7;0;7
1088;Coliukė;VABALIUKAI;4739310916;Taip;5;2;0;7
1089;Coliukė;VABALIUKAI;5541328815;Ne;10;0;0;10
1090;Coliukė;VABALIUKAI;4649987214;Taip;0;2;0;2
1091;Coliukė;VABALIUKAI;3905904092;Taip;14;0;0;14
1092;Coliukė;VABALIUKAI;9083546061;Taip;1;3;0;4
1093;Coliukė;VABALIUKAI;1476750428;Taip;0;2;0;2
1094;Coliukė;VABALIUKAI;8521846076;Taip;11;5;0;16
1095;Coliukė;VABALIUKAI;7622526793;Taip;0;8;0;8
1096;Coliukė;VABALIUKAI;1328505569;Ne;0;9;0;9
1097;Coliukė;VABALIUKAI;9268436167;Taip;11;2;0;13
1098;Coliukė;VABALIUKAI;9368334915;Ne;5;0;0;5
1099;Coliukė;VABALIUKAI;5108993131;Taip;16;1;0;17
1100;Coliukė;NYKŠTUKAI;6441253648;Taip;10;0;0;10
1101;Coliukė;NYKŠTUKAI;9693392372;Taip;0;3;0;3
1102;Coliukė;NYKŠTUKAI;4537756081;Ne;10;5;0;15
1103;Coliukė;NYKŠTUKAI;4022408510;Taip;0;1;0;1
1104;Coliukė;NYKŠTUKAI;3719547522;Taip;1;1;0;2
1105;Coliukė;NYKŠTUKAI;6403149921;Taip;9;1;0;10
1106;Coliukė;NYKŠTUKAI;5450167562;Taip;0;1;0;1
1107;Coliukė;NYKŠTUKAI;3384332079;Ne;6;1;1;8
1108;Coliukė;NYKŠTUKAI;1198781036;Taip;4;1;0;5
1109;Coliukė;NYKŠTUKAI;5283583324;Ne;0;3;0;3
1110;Coliukė;NYKŠTUKAI;9334564869;Taip;1;0;0;1
1111;Coliukė;NYKŠTUKAI;6781303455;Taip;0;2;0;2
1112;Coliukė;NYKŠTUKAI;3140659021;Ne;21;0;0;21
1113;Coliukė;NYKŠTUKAI;4845049639;Taip;0;1;2;3
1114;Coliukė;NYKŠTUKAI;3221157300;Taip;14;0;0;14
1115;Coliukė;NYKŠTUKAI;7870865302;Ne;0;11;0;11
1116;Coliukė;NYKŠTUKAI;1575061659;Taip;1;0;0;1
1117;Coliukė;NYKŠTUKAI;3678496820;Taip;0;0;1;1
1118;Coliukė;NYKŠTUKAI;2321127662;Taip;0;0;4;4
1119;Coliukė;NYKŠTUKAI;8715608220;Ne;0;1;0;1
1120;Coliukė;NYKŠTUKAI;7502911642;Taip;1;9;0;10
1121;Coliukė;NYKŠTUKAI;4635299740;Taip;1;9;0;10
1122;Coliukė;GĖLYTĖS;9442511803;Taip;0;0;4;4
1123;Coliukė;GĖLYTĖS;6781663126;Taip;1;0;0;1
1124;Coliukė;GĖLYTĖS;6611713551;Taip;0;4;0;4
1125;Coliukė;GĖLYTĖS;6755886435;Taip;1;0;0;1
1126;Coliukė;GĖLYTĖS;1220385522;Taip;14;0;0;14
1127;Coliukė;GĖLYTĖS;8601059431;Taip;5;0;0;5
1128;Coliukė;GĖLYTĖS;1452034828;Taip;1;1;0;2
1129;Coliukė;GĖLYTĖS;6941719947;Taip;5;1;2;8
1130;Coliukė;GĖLYTĖS;5347456579;Taip;10;0;0;10
1131;Coliukė;GĖLYTĖS;9834829829;Taip;6;0;0;6
1132;Coliukė;GĖLYTĖS;9107676840;Taip;4;0;1;5
1133;Coliukė;GĖLYTĖS;8606195508;Taip;16;0;1;17
1134;Coliukė;GĖLYTĖS;4880932369;Taip;7;0;2;9
1135;Coliukė;"BORUŽĖLĖS (SPEC.)";2080118127;Taip;0;1;0;1
1136;Coliukė;"BORUŽĖLĖS (SPEC.)";2617816991;Taip;0;5;0;5
1137;Coliukė;"BORUŽĖLĖS (SPEC.)";1233731506;Taip;0;1;0;1
1138;Coliukė;"BORUŽĖLĖS (SPEC.)";1644303265;Taip;0;0;5;5
1139;Coliukė;"BORUŽĖLĖS (SPEC.)";5706671963;Taip;0;1;0;1
1140;Coliukė;"BORUŽĖLĖS (SPEC.)";4961762841;Taip;6;0;0;6
1141;Coliukė;"BORUŽĖLĖS (SPEC.)";7826554599;Taip;7;0;2;9
1142;Coliukė;"BORUŽĖLĖS (SPEC.)";6920961967;Ne;0;5;0;5
1143;Coliukė;"BORUŽĖLĖS (SPEC.)";1134875499;Taip;0;1;0;1
1144;Coliukė;"BORUŽĖLĖS (SPEC.)";2351866339;Taip;8;0;0;8
1145;Coliukė;"BORUŽĖLĖS (SPEC.)";5756690199;Taip;0;0;2;2
1146;Coliukė;"BORUŽĖLĖS (SPEC.)";2947495861;Ne;0;0;4;4
1147;Coliukė;"BORUŽĖLĖS (SPEC.)";6246392335;Taip;0;2;0;2
1148;Coliukė;"BORUŽĖLĖS (SPEC.)";5008183731;Taip;12;0;0;12
1149;Čiauškutis;BITUTĖS;7893181156;Ne;0;0;1;1
1150;Čiauškutis;BITUTĖS;7976738303;Ne;8;0;2;10
1151;Čiauškutis;BITUTĖS;4026881335;Taip;11;0;0;11
1152;Čiauškutis;BITUTĖS;9753680961;Taip;0;5;4;9
1153;Čiauškutis;BITUTĖS;4852837431;Taip;7;0;1;8
1154;Čiauškutis;BITUTĖS;4652951382;Ne;0;19;2;21
1155;Čiauškutis;BITUTĖS;3837360101;Taip;5;0;4;9
1156;Čiauškutis;BITUTĖS;2319237497;Taip;8;0;0;8
1157;Čiauškutis;BITUTĖS;1765857419;Ne;4;1;0;5
1158;Čiauškutis;BITUTĖS;7282041196;Taip;7;9;1;17
1159;Čiauškutis;ŽVIRBLIUKAI;7654242839;Taip;1;0;1;2
1160;Čiauškutis;ŽVIRBLIUKAI;9565722619;Taip;0;20;1;21
1161;Čiauškutis;ŽVIRBLIUKAI;5125518366;Taip;11;0;4;15
1162;Čiauškutis;ŽVIRBLIUKAI;4962200863;Taip;0;0;3;3
1163;Čiauškutis;ŽVIRBLIUKAI;7468763527;Taip;0;0;1;1
1164;Čiauškutis;ŽVIRBLIUKAI;7324659239;Taip;8;0;1;9
1165;Čiauškutis;ŽVIRBLIUKAI;4216443034;Taip;0;0;1;1
1166;Čiauškutis;ŽVIRBLIUKAI;2096533965;Ne;21;0;0;21
1167;Čiauškutis;ŽVIRBLIUKAI;9759888353;Ne;0;0;6;6
1168;Čiauškutis;ŽVIRBLIUKAI;8297774828;Taip;7;1;0;8
1169;Čiauškutis;SAULUTĖS;98579606504;Taip;0;1;0;1
1170;Čiauškutis;SAULUTĖS;7027181377;Taip;0;20;1;21
1171;Čiauškutis;SAULUTĖS;43313173294;Taip;0;16;5;21
1172;Čiauškutis;SAULUTĖS;60265156684;Taip;13;6;2;21
1173;Čiauškutis;SAULUTĖS;9052859205;Taip;0;1;1;2
1174;Čiauškutis;SAULUTĖS;7367933940;Taip;5;0;0;5
1175;Čiauškutis;SAULUTĖS;4658994599;Taip;0;1;1;2
1176;Čiauškutis;SAULUTĖS;6115354862;Taip;6;0;0;6
1177;Čiauškutis;SAULUTĖS;5759367884;Taip;0;2;1;3
1178;Čiauškutis;SAULUTĖS;1313716840;Taip;0;1;0;1
1179;Čiauškutis;EŽIUKAI;2686038029;Taip;0;0;4;4
1180;Čiauškutis;EŽIUKAI;1928404791;Taip;0;0;1;1
1181;Čiauškutis;EŽIUKAI;7489733038;Taip;0;0;2;2
1182;Čiauškutis;EŽIUKAI;5404165993;Taip;0;0;1;1
1183;Čiauškutis;EŽIUKAI;1158816422;Taip;0;0;1;1
1184;Čiauškutis;EŽIUKAI;7239878097;Taip;3;1;0;4
1185;Čiauškutis;EŽIUKAI;5910818962;Ne;5;0;1;6
1186;Čiauškutis;EŽIUKAI;1234494170;Taip;8;0;1;9
1187;Čiauškutis;DRUGELIAI;7080320173;Taip;8;0;0;8
1188;Čiauškutis;DRUGELIAI;7312776041;Ne;0;1;1;2
1189;Čiauškutis;DRUGELIAI;9072764004;Taip;7;0;1;8
1190;Čiauškutis;DRUGELIAI;1036358147;Taip;16;0;2;18
1191;Čiauškutis;DRUGELIAI;8346845876;Taip;0;0;1;1
1192;Čiauškutis;DRUGELIAI;3724324861;Taip;4;17;0;21
1193;Čiauškutis;DRUGELIAI;2237570705;Taip;0;0;5;5
1194;Čiauškutis;DRUGELIAI;4681902267;Taip;10;0;3;13
1195;Čiauškutis;GENELIAI;7440425102;Ne;3;1;0;4
1196;Čiauškutis;GENELIAI;76449285846;Taip;0;1;0;1
1197;Čiauškutis;GENELIAI;6435287215;Taip;0;1;0;1
1198;Čiauškutis;GENELIAI;1456067541;Ne;0;2;0;2
1199;Čiauškutis;GENELIAI;1657452686;Taip;1;1;0;2
1200;Čiauškutis;GENELIAI;1739403100;Taip;0;20;1;21
1201;Čiauškutis;GENELIAI;6994301415;Ne;0;1;1;2
1202;Čiauškutis;GENELIAI;1224986101;Taip;4;1;2;7
1203;Čiauškutis;GENELIAI;1809511815;Taip;0;1;2;3
1204;Čiauškutis;LINKSMUČIAI;73016259669;Taip;0;1;0;1
1205;Čiauškutis;LINKSMUČIAI;7184626362;Taip;0;1;0;1
1206;Čiauškutis;LINKSMUČIAI;8689127061;Taip;5;16;0;21
1207;Čiauškutis;LINKSMUČIAI;1306672095;Taip;0;1;0;1
1208;Čiauškutis;LINKSMUČIAI;2672796261;Taip;8;0;0;8
1209;Čiauškutis;KIŠKUČIAI;1900086424;Taip;3;2;0;5
1210;Čiauškutis;KIŠKUČIAI;1396093940;Taip;9;0;2;11
1211;Čiauškutis;KIŠKUČIAI;3465024013;Taip;12;0;1;13
1212;Čiauškutis;KIŠKUČIAI;2271458332;Taip;0;0;1;1
1213;Čiauškutis;KIŠKUČIAI;9754417066;Taip;9;0;3;12
1214;Čiauškutis;KIŠKUČIAI;8580034134;Taip;5;0;2;7
1215;Čiauškutis;KIŠKUČIAI;9410262802;Taip;0;0;2;2
1216;Čiauškutis;KIŠKUČIAI;3650541072;Taip;0;0;8;8
1217;Čiauškutis;KIŠKUČIAI;2445742257;Taip;0;18;3;21
1218;Čiauškutis;KIŠKUČIAI;6785604459;Taip;21;0;0;21
1219;Čiauškutis;LAPIUKAI;5052137859;Ne;0;15;6;21
1220;Čiauškutis;LAPIUKAI;7428833348;Taip;0;2;1;3
1221;Čiauškutis;LAPIUKAI;9897499968;Taip;1;20;0;21
1222;Čiauškutis;LAPIUKAI;2737503753;Taip;0;0;3;3
1223;Čiauškutis;LAPIUKAI;8876608072;Taip;0;0;8;8
1224;Čiauškutis;LAPIUKAI;4881821738;Taip;0;0;1;1
1225;Čiauškutis;LAPIUKAI;4881821738;Taip;0;0;1;1
1226;Čiauškutis;LAPIUKAI;6810906239;Taip;9;0;3;12
1227;Čiauškutis;LAPIUKAI;9460608737;Taip;8;0;1;9
1228;Čiauškutis;MEŠKUČIAI;7630342576;Taip;0;2;0;2
1229;Čiauškutis;MEŠKUČIAI;7135435979;Ne;0;1;8;9
1230;Čiauškutis;MEŠKUČIAI;7274368180;Taip;0;0;6;6
1231;Čiauškutis;MEŠKUČIAI;6146321785;Taip;5;12;4;21
1232;Čiauškutis;MEŠKUČIAI;6434727608;Taip;7;9;5;21
1233;Čiauškutis;MEŠKUČIAI;7526975680;Taip;0;2;0;2
1234;Čiauškutis;MEŠKUČIAI;2172687454;Taip;12;0;1;13
1235;Čiauškutis;MEŠKUČIAI;3660195990;Taip;1;0;0;1
1236;Čiauškutis;PELĖDŽIUKAI;4971788697;Taip;0;1;0;1
1237;Čiauškutis;PELĖDŽIUKAI;9228568063;Taip;0;0;4;4
1238;Čiauškutis;PELĖDŽIUKAI;1561833758;Taip;2;0;0;2
1239;Čiauškutis;PELĖDŽIUKAI;3700692073;Taip;7;0;1;8
1240;Čiauškutis;PELĖDŽIUKAI;3833382641;Taip;4;0;1;5
1241;Čiauškutis;PELĖDŽIUKAI;6615319751;Taip;7;0;5;12
1242;Čiauškutis;PELĖDŽIUKAI;8111541739;Taip;6;0;1;7
1243;Čiauškutis;NYKŠTUKAI;8948893335;Taip;12;0;0;12
1244;Čiauškutis;NYKŠTUKAI;2633243682;Taip;0;5;0;5
1245;Čiauškutis;NYKŠTUKAI;4037117222;Taip;1;0;0;1
1246;Čiauškutis;NYKŠTUKAI;6705934636;Taip;0;0;1;1
1247;Čiauškutis;NYKŠTUKAI;5957587644;Taip;5;0;8;13
1248;Čiauškutis;NYKŠTUKAI;1733251156;Taip;14;0;0;14
1249;Čiauškutis;NYKŠTUKAI;5575614158;Taip;5;0;3;8
1250;Čiauškutis;NYKŠTUKAI;2044220236;Taip;0;1;1;2
1251;Čiauškutis;NYKŠTUKAI;7335655769;Ne;0;0;1;1
1252;Daigelis;Bitutės;2252139639;Ne;5;0;0;5
1253;Daigelis;Bitutės;1639589842;Taip;7;0;0;7
1254;Daigelis;Bitutės;1201983358;Taip;13;0;0;13
1255;Daigelis;Bitutės;8855668502;Taip;27;0;0;27
1256;Daigelis;Bitutės;6285764348;Ne;10;0;0;10
1257;Daigelis;Bitutės;4624516876;Taip;10;0;0;10
1258;Daigelis;Bitutės;1333421528;Taip;10;0;0;10
1259;Daigelis;Bitutės;7503012332;Taip;9;0;0;9
1260;Daigelis;Bitutės;6198126746;Taip;20;0;0;20
1261;Daigelis;"VIEVERSĖLIAI (SPEC)";9392290289;Taip;6;0;0;6
1262;Daigelis;Spinduliukai;4715171946;Taip;8;0;0;8
1263;Daigelis;Spinduliukai;3333255527;Taip;6;0;0;6
1264;Daigelis;Spinduliukai;6384314661;Ne;5;0;0;5
1265;Daigelis;Spinduliukai;7367305924;Taip;2;0;0;2
1266;Daigelis;Pelėdžiukai;6718987671;Taip;7;0;0;7
1267;Daigelis;Pelėdžiukai;1429061018;Taip;8;0;0;8
1268;Daigelis;Pelėdžiukai;4215451069;Taip;10;0;0;10
1269;Daigelis;Žvaigždutės;5750485070;Ne;10;0;0;10
1270;Daigelis;Skruzdėliukai;3383805498;Taip;9;0;0;9
1271;Daigelis;Skruzdėliukai;8499408010;Taip;10;0;0;10
1272;Daigelis;Skruzdėliukai;2303781119;Taip;10;0;0;10
1273;Daigelis;Skruzdėliukai;9552228706;Taip;5;0;0;5
1274;Daigelis;Skruzdėliukai;8317879752;Taip;4;0;0;4
1275;Daigelis;Gėlytės;2603945833;Taip;8;0;0;8
1276;Daigelis;Gėlytės;8338714756;Taip;11;0;0;11
1277;Daigelis;Gėlytės;8855198771;Taip;13;0;0;13
1278;Daigelis;Funtiki;9724634409;Taip;16;0;0;16
1279;Daigelis;Funtiki;4162501269;Taip;8;0;0;8
1280;Daigelis;Nevaliaški;8016639677;Taip;5;0;0;5
1281;Daigelis;Nevaliaški;6518661502;Taip;6;0;0;6
1282;Daigelis;Nevaliaški;4615798936;Taip;5;0;0;5
1283;Daigelis;Nevaliaški;1883094184;Taip;5;0;0;5
1284;Delfinukas;Boružėlių;9184207705;Taip;0;4;1;5
1285;Delfinukas;Boružėlių;2819680099;Taip;0;1;0;1
1286;Delfinukas;Boružėlių;3205671100;Ne;0;1;0;1
1287;Delfinukas;Boružėlių;1119373532;Ne;14;0;0;14
1288;Delfinukas;Boružėlių;7737665102;Taip;13;2;1;16
1289;Delfinukas;Boružėlių;5443027988;Ne;0;4;0;4
1290;Delfinukas;Boružėlių;2163238846;Taip;10;0;0;10
1291;Delfinukas;Boružėlių;4567479900;Taip;16;0;0;16
1292;Delfinukas;Boružėlių;9747075687;Taip;4;1;0;5
1293;Delfinukas;Boružėlių;7312438969;Taip;7;0;0;7
1294;Delfinukas;Boružėlių;5585334518;Ne;6;0;0;6
1295;Delfinukas;Boružėlių;6071660741;Taip;11;1;0;12
1296;Delfinukas;Boružėlių;4327924499;Taip;14;0;0;14
1297;Delfinukas;Boružėlių;6693756145;Taip;12;0;0;12
1298;Delfinukas;Boružėlių;6301767635;Taip;11;3;0;14
1299;Delfinukas;Saulytės;8315269427;Taip;5;0;5;10
1300;Delfinukas;Saulytės;4215887291;Taip;0;2;0;2
1301;Delfinukas;Saulytės;3631520143;Taip;11;0;7;18
1302;Delfinukas;Saulytės;9424966984;Taip;0;0;16;16
1303;Delfinukas;Saulytės;6069600728;Taip;0;0;3;3
1304;Delfinukas;Saulytės;9729550922;Taip;0;6;0;6
1305;Delfinukas;Saulytės;1404270345;Taip;0;0;7;7
1306;Delfinukas;Saulytės;3842160990;Taip;0;2;0;2
1307;Delfinukas;Saulytės;8402529296;Ne;7;0;1;8
1308;Delfinukas;Saulytės;5125346405;Taip;0;0;3;3
1309;Delfinukas;Saulytės;5642328792;Ne;6;2;1;9
1310;Delfinukas;Saulytės;8176576958;Taip;12;0;0;12
1311;Delfinukas;Saulytės;8275943176;Taip;7;0;7;14
1312;Delfinukas;Saulytės;8085530134;Taip;0;10;0;10
1313;Delfinukas;Saulytės;8148610460;Taip;5;0;0;5
1314;Delfinukas;Saulytės;8186312409;Taip;0;3;1;4
1315;Delfinukas;Saulytės;7904803011;Taip;0;3;0;3
1316;Delfinukas;Saulytės;1873630966;Ne;0;2;0;2
1317;Delfinukas;Saulytės;5665463557;Taip;1;1;1;3
1318;Delfinukas;Saulytės;1296440609;Ne;1;0;0;1
1319;Delfinukas;Saulytės;5397241026;Taip;4;5;1;10
1320;Delfinukas;Pelėdžiukų;8774145277;Taip;0;3;0;3
1321;Delfinukas;Pelėdžiukų;6113662246;Taip;0;19;0;19
1322;Delfinukas;Pelėdžiukų;4710894128;Ne;8;1;0;9
1323;Delfinukas;Pelėdžiukų;1526129772;Taip;1;2;1;4
1324;Delfinukas;Pelėdžiukų;8659309242;Taip;0;3;0;3
1325;Delfinukas;Pelėdžiukų;8267992425;Taip;0;3;0;3
1326;Delfinukas;Pelėdžiukų;9319874239;Ne;0;1;0;1
1327;Delfinukas;Pelėdžiukų;2809947323;Ne;3;1;0;4
1328;Delfinukas;Pelėdžiukų;3465186420;Taip;0;1;9;10
1329;Delfinukas;Pelėdžiukų;4096274346;Taip;6;0;0;6
1330;Delfinukas;Pelėdžiukų;5246300518;Taip;1;2;2;5
1331;Delfinukas;Pelėdžiukų;3702341009;Taip;0;3;0;3
1332;Delfinukas;Pelėdžiukų;2420308954;Taip;1;0;2;3
1333;Delfinukas;Pelėdžiukų;6286748047;Taip;1;9;0;10
1334;Delfinukas;Pelėdžiukų;8432654056;Ne;3;1;0;4
1335;Delfinukas;Pelėdžiukų;1918878505;Taip;3;0;0;3
1336;Delfinukas;Pelėdžiukų;3795705735;Taip;0;1;0;1
1337;Delfinukas;Pelėdžiukų;1575125658;Taip;0;7;0;7
1338;Delfinukas;Pelėdžiukų;4384995354;Taip;10;0;0;10
1339;Delfinukas;Pelėdžiukų;3633392440;Ne;10;2;1;13
1340;Delfinukas;Varliukų;4949220786;Taip;12;1;0;13
1341;Delfinukas;Varliukų;2792051636;Taip;14;1;0;15
1342;Delfinukas;Varliukų;4780352568;Taip;3;0;0;3
1343;Delfinukas;Varliukų;3577180085;Taip;11;0;0;11
1344;Delfinukas;Varliukų;6115370195;Ne;16;0;2;18
1345;Delfinukas;Varliukų;3050258185;Taip;20;0;0;20
1346;Delfinukas;Varliukų;7976681530;Taip;5;0;1;6
1347;Delfinukas;Varliukų;4338259551;Taip;10;0;1;11
1348;Delfinukas;Varliukų;9360553910;Taip;10;5;0;15
1349;Delfinukas;Varliukų;6301601832;Taip;0;1;0;1
1350;Delfinukas;Varliukų;5095713834;Taip;11;1;1;13
1351;Delfinukas;Varliukų;5964021733;Taip;17;2;0;19
1352;Delfinukas;Varliukų;5821591959;Taip;0;5;0;5
1353;Delfinukas;Varliukų;9095895182;Taip;0;0;2;2
1354;Delfinukas;Varliukų;5138840297;Taip;6;2;0;8
1355;Delfinukas;Varliukų;7072060541;Taip;12;0;0;12
1356;Delfinukas;Varliukų;3797355501;Taip;10;4;0;14
1357;Delfinukas;Varliukų;4751611934;Taip;8;0;1;9
1358;Delfinukas;Varliukų;4254414928;Taip;11;0;0;11
1359;Delfinukas;Varliukų;7359531377;Taip;16;0;0;16
1360;Delfinukas;Varpelių;5123666058;Taip;7;0;0;7
1361;Delfinukas;Varpelių;8913681176;Taip;5;1;0;6
1362;Delfinukas;Varpelių;9514189769;Taip;0;1;0;1
1363;Delfinukas;Varpelių;4713803167;Taip;2;5;0;7
1364;Delfinukas;Varpelių;8936645508;Taip;4;9;0;13
1365;Delfinukas;Varpelių;6047881184;Taip;3;0;0;3
1366;Delfinukas;Varpelių;3818558339;Taip;1;0;0;1
1367;Delfinukas;Varpelių;1484123788;Taip;0;2;1;3
1368;Delfinukas;Varpelių;4877757730;Taip;4;1;1;6
1369;Delfinukas;Varpelių;7973858761;Taip;0;1;2;3
1370;Delfinukas;Varpelių;9218154624;Ne;9;1;0;10
1371;Delfinukas;Varpelių;8950528288;Taip;16;0;0;16
1372;Delfinukas;Varpelių;8829835426;Ne;5;0;0;5
1373;Delfinukas;Varpelių;4500756171;Taip;5;0;0;5
1374;Delfinukas;Varpelių;8953230752;Ne;4;1;0;5
1375;Delfinukas;Varpelių;7780893730;Taip;7;1;0;8
1376;Delfinukas;Varpelių;9898427089;Taip;0;1;0;1
1377;Delfinukas;Varpelių;2730512600;Taip;0;2;0;2
1378;Delfinukas;Varpelių;6008032738;Taip;3;2;0;5
1379;Delfinukas;Varpelių;8911433659;Taip;8;0;0;8
1380;Delfinukas;Drugeliai;7615519932;Ne;8;1;4;13
1381;Delfinukas;Drugeliai;6604115681;Taip;2;13;0;15
1382;Delfinukas;Drugeliai;5990192934;Taip;5;1;0;6
1383;Delfinukas;Drugeliai;9635669748;Taip;1;1;1;3
1384;Delfinukas;Drugeliai;8526813977;Taip;1;1;1;3
1385;Delfinukas;Drugeliai;6873181103;Taip;8;0;0;8
1386;Delfinukas;Drugeliai;4484804360;Taip;0;2;1;3
1387;Delfinukas;Drugeliai;8328481987;Taip;8;2;1;11
1388;Delfinukas;Drugeliai;6992505341;Taip;21;0;0;21
1389;Delfinukas;Drugeliai;8129592398;Taip;10;0;0;10
1390;Delfinukas;Drugeliai;8606989493;Taip;0;0;1;1
1391;Delfinukas;Drugeliai;9927854348;Taip;0;0;1;1
1392;Delfinukas;Drugeliai;2756574162;Taip;1;0;0;1
1393;Delfinukas;Drugeliai;2985669766;Taip;0;1;10;11
1394;Delfinukas;Drugeliai;7609115506;Taip;0;2;0;2
1395;Delfinukas;Drugeliai;6457042338;Taip;0;10;0;10
1396;Delfinukas;Drugeliai;5060445169;Taip;0;3;0;3
1397;Delfinukas;Drugeliai;3134897964;Taip;6;2;0;8
1398;Delfinukas;Drugeliai;8411289299;Taip;0;1;0;1
1399;Delfinukas;Drugeliai;2683746435;Taip;1;0;1;2
1400;Delfinukas;Drugeliai;6623617856;Taip;8;3;0;11
1401;Delfinukas;Žuvytės;8160982025;Taip;0;2;0;2
1402;Delfinukas;Žuvytės;6578506861;Taip;6;0;0;6
1403;Delfinukas;Žuvytės;9934325492;Taip;0;1;0;1
1404;Delfinukas;Žuvytės;6322255194;Ne;9;0;0;9
1405;Delfinukas;Žuvytės;6572690788;Taip;0;2;0;2
1406;Delfinukas;Žuvytės;7873373923;Taip;0;0;1;1
1407;Delfinukas;Žuvytės;9898412288;Taip;0;1;0;1
1408;Delfinukas;Žuvytės;3397350274;Taip;2;2;0;4
1409;Delfinukas;Žuvytės;9520598359;Taip;11;7;0;18
1410;Delfinukas;Žuvytės;3804996594;Ne;9;1;1;11
1411;Delfinukas;Žuvytės;2066127119;Taip;9;1;0;10
1412;Delfinukas;Žuvytės;7487111570;Ne;0;4;0;4
1413;Delfinukas;Žuvytės;8702718951;Taip;0;1;2;3
1414;Delfinukas;Žuvytės;6844500395;Taip;0;3;1;4
1415;Delfinukas;Žuvytės;6445868759;Taip;0;3;1;4
1416;Delfinukas;Žuvytės;9074294473;Taip;0;0;3;3
1417;Delfinukas;Žuvytės;4678970810;Taip;11;0;0;11
1418;Delfinukas;Žuvytės;6478152041;Taip;4;2;0;6
1419;Delfinukas;Delfinai;2890469172;Taip;0;0;9;9
1420;Delfinukas;Delfinai;9628317328;Ne;2;2;1;5
1421;Delfinukas;Delfinai;5797308373;Taip;0;3;0;3
1422;Delfinukas;Delfinai;5241426445;Taip;0;2;0;2
1423;Delfinukas;Delfinai;8099120371;Taip;8;1;0;9
1424;Delfinukas;Delfinai;7663934825;Taip;0;2;0;2
1425;Delfinukas;Delfinai;1200205376;Taip;0;2;0;2
1426;Delfinukas;Delfinai;7629622746;Taip;7;1;0;8
1427;Delfinukas;Delfinai;4347116918;Taip;0;9;0;9
1428;Delfinukas;Delfinai;1922513830;Taip;0;4;0;4
1429;Delfinukas;Delfinai;6270012707;Ne;0;1;0;1
1430;Delfinukas;Delfinai;8085481968;Taip;5;1;0;6
1431;Delfinukas;Delfinai;3407321091;Taip;6;0;0;6
1432;Delfinukas;Delfinai;7354837777;Taip;17;0;0;17
1433;Delfinukas;Delfinai;9903010418;Taip;0;11;0;11
1434;Delfinukas;Delfinai;8884939114;Taip;5;0;0;5
1435;Delfinukas;Delfinai;6522639028;Ne;11;0;2;13
1436;Delfinukas;Delfinai;9253061888;Ne;9;0;2;11
1437;Delfinukas;Paukšteliai;7366145460;Taip;4;1;3;8
1438;Delfinukas;Paukšteliai;5278689745;Taip;15;1;0;16
1439;Delfinukas;Paukšteliai;6002086491;Taip;0;1;0;1
1440;Delfinukas;Paukšteliai;1164720538;Taip;3;5;0;8
1441;Delfinukas;Paukšteliai;9351906710;Taip;4;0;0;4
1442;Delfinukas;Paukšteliai;9629225917;Taip;6;0;0;6
1443;Delfinukas;Paukšteliai;9332794060;Ne;19;0;0;19
1444;Delfinukas;Paukšteliai;5368435217;Taip;2;1;6;9
1445;Delfinukas;Paukšteliai;6650725760;Taip;11;0;5;16
1446;Delfinukas;Paukšteliai;7968869585;Taip;21;0;0;21
1447;Delfinukas;Paukšteliai;5164599763;Taip;17;0;0;17
1448;Delfinukas;Paukšteliai;9776618488;Taip;11;0;0;11
1449;Delfinukas;Paukšteliai;9586646352;Taip;5;6;0;11
1450;Delfinukas;Paukšteliai;4561911078;Taip;8;0;5;13
1451;Delfinukas;Paukšteliai;4755699845;Taip;7;1;7;15
1452;Delfinukas;Kiškučiai;2094258481;Taip;3;0;0;3
1453;Delfinukas;Kiškučiai;9602317911;Taip;0;1;0;1
1454;Delfinukas;Kiškučiai;8625023976;Taip;0;1;0;1
1455;Delfinukas;Kiškučiai;6352250868;Taip;12;2;0;14
1456;Delfinukas;Kiškučiai;3284212595;Taip;6;0;0;6
1457;Delfinukas;Kiškučiai;6531930806;Taip;6;0;0;6
1458;Delfinukas;Kiškučiai;8439204095;Taip;6;1;0;7
1459;Delfinukas;Kiškučiai;5783537897;Taip;0;1;0;1
1460;Delfinukas;Kiškučiai;8728791932;Taip;7;0;0;7
1461;Delfinukas;Kiškučiai;7365398150;Ne;21;0;0;21
1462;Delfinukas;Kiškučiai;2883959240;Taip;20;0;0;20
1463;Delfinukas;Kiškučiai;4179507316;Taip;4;7;0;11
1464;Delfinukas;Kiškučiai;8440546956;Taip;0;6;0;6
1465;Delfinukas;Kiškučiai;1030958414;Taip;0;1;0;1
1466;Delfinukas;Kiškučiai;7638190553;Ne;0;2;3;5
1467;Delfinukas;Kiškučiai;6577214344;Taip;0;10;0;10
1468;Delfinukas;Kiškučiai;2537442505;Taip;14;0;1;15
1469;Delfinukas;BITUTĖS;9719348837;Taip;5;0;0;5
1470;Delfinukas;BITUTĖS;6211076154;Taip;5;0;0;5
1471;Delfinukas;BITUTĖS;6601922746;Taip;6;3;0;9
1472;Delfinukas;BITUTĖS;8896957908;Ne;1;0;0;1
1473;Delfinukas;BITUTĖS;3239635507;Taip;5;1;1;7
1474;Delfinukas;BITUTĖS;5339993544;Taip;0;1;0;1
1475;Delfinukas;BITUTĖS;6929926768;Taip;11;2;0;13
1476;Delfinukas;BITUTĖS;5557399916;Taip;8;0;0;8
1477;Delfinukas;BITUTĖS;8937594052;Taip;0;3;1;4
1478;Delfinukas;BITUTĖS;5179080544;Taip;0;10;0;10
1479;Delfinukas;BITUTĖS;7727263761;Taip;5;0;0;5
1480;Delfinukas;BITUTĖS;9941631164;Taip;5;0;1;6
1481;Delfinukas;BITUTĖS;4198261848;Taip;10;0;0;10
1482;Delfinukas;BITUTĖS;8081895401;Taip;6;0;1;7
1483;Delfinukas;BITUTĖS;5600320855;Taip;14;3;0;17
1484;Delfinukas;BITUTĖS;9195828884;Taip;0;0;1;1
1485;Delfinukas;BITUTĖS;8552371520;Taip;0;0;3;3
1486;Delfinukas;BITUTĖS;2377204734;Taip;16;0;0;16
1487;Delfinukas;BITUTĖS;6243471374;Taip;5;4;0;9
1488;Delfinukas;BITUTĖS;4303234827;Ne;6;0;0;6
1489;Delfinukas;BITUTĖS;6325092903;Taip;12;1;0;13
1490;Drevinukas;ZUIKUČIAI;5500759834;Taip;0;0;1;1
1491;Drevinukas;ZUIKUČIAI;9817317105;Taip;0;0;4;4
1492;Drevinukas;ZUIKUČIAI;1595081335;Taip;1;7;2;10
1493;Drevinukas;ZUIKUČIAI;2646799484;Taip;0;0;1;1
1494;Drevinukas;ZUIKUČIAI;2772424629;Taip;15;0;5;20
1495;Drevinukas;ZUIKUČIAI;8873060121;Taip;5;0;2;7
1496;Drevinukas;ZUIKUČIAI;1567790084;Taip;0;3;0;3
1497;Drevinukas;ZUIKUČIAI;3293457412;Taip;0;0;3;3
1498;Drevinukas;ZUIKUČIAI;6243097297;Taip;0;0;13;13
1499;Drevinukas;ZUIKUČIAI;5704489483;Taip;0;0;3;3
1500;Drevinukas;ZUIKUČIAI;7054681115;Taip;0;0;1;1
1501;Drevinukas;ZUIKUČIAI;5887233286;Taip;0;1;0;1
1502;Drevinukas;ZUIKUČIAI;3381363132;Taip;1;2;0;3
1503;Drevinukas;ZUIKUČIAI;6462582301;Taip;2;0;0;2
1504;Drevinukas;ZUIKUČIAI;3070518153;Taip;0;0;1;1
1505;Drevinukas;ZUIKUČIAI;9174977150;Taip;0;0;1;1
1506;Drevinukas;ZUIKUČIAI;4243045398;Taip;6;3;0;9
1507;Drevinukas;ZUIKUČIAI;4309475233;Taip;6;3;0;9
1508;Drevinukas;AŽUOLIUKŲ;1644656704;Taip;0;2;2;4
1509;Drevinukas;AŽUOLIUKŲ;5721031754;Taip;0;1;0;1
1510;Drevinukas;AŽUOLIUKŲ;4714478955;Taip;0;1;2;3
1511;Drevinukas;AŽUOLIUKŲ;8701250912;Taip;0;1;2;3
1512;Drevinukas;AŽUOLIUKŲ;8143614891;Taip;0;6;2;8
1513;Drevinukas;AŽUOLIUKŲ;4213259879;Taip;11;3;0;14
1514;Drevinukas;AŽUOLIUKŲ;5673244101;Taip;0;2;0;2
1515;Drevinukas;AŽUOLIUKŲ;3643007998;Ne;5;10;0;15
1516;Drevinukas;AŽUOLIUKŲ;4262951360;Taip;6;1;1;8
1517;Drevinukas;AŽUOLIUKŲ;5959004452;Ne;0;2;0;2
1518;Drevinukas;AŽUOLIUKŲ;7689145214;Taip;4;1;0;5
1519;Drevinukas;AŽUOLIUKŲ;4572837478;Taip;6;1;3;10
1520;Drevinukas;AŽUOLIUKŲ;1564065835;Taip;0;6;0;6
1521;Drevinukas;AŽUOLIUKŲ;9289471118;Taip;0;2;1;3
1522;Drevinukas;AŽUOLIUKŲ;9915130747;Ne;0;12;0;12
1523;Drevinukas;AŽUOLIUKŲ;6891793135;Taip;0;2;1;3
1524;Drevinukas;AŽUOLIUKŲ;1058927778;Taip;0;1;1;2
1525;Drevinukas;AŽUOLIUKŲ;9534007163;Ne;15;1;1;17
1526;Drevinukas;AŽUOLIUKŲ;2300338724;Taip;0;13;0;13
1527;Drevinukas;AŽUOLIUKŲ;3725760478;Taip;0;1;0;1
1528;Drevinukas;AŽUOLIUKŲ;9513405583;Taip;0;2;0;2
1529;Drevinukas;AŽUOLIUKŲ;5436821826;Taip;0;1;1;2
1530;Drevinukas;AŽUOLIUKŲ;8896207423;Taip;4;0;0;4
1531;Drevinukas;PELĖDŽIUKAI;1123115847;Taip;1;1;3;5
1532;Drevinukas;PELĖDŽIUKAI;1987939679;Taip;0;2;0;2
1533;Drevinukas;PELĖDŽIUKAI;9336227821;Taip;0;1;0;1
1534;Drevinukas;PELĖDŽIUKAI;4784716615;Taip;0;2;0;2
1535;Drevinukas;PELĖDŽIUKAI;2070374746;Taip;0;1;1;2
1536;Drevinukas;PELĖDŽIUKAI;8661862777;Taip;0;2;0;2
1537;Drevinukas;PELĖDŽIUKAI;9803670483;Taip;0;2;9;11
1538;Drevinukas;PELĖDŽIUKAI;7519369167;Ne;0;2;4;6
1539;Drevinukas;PELĖDŽIUKAI;16952164778;Taip;0;2;1;3
1540;Drevinukas;PELĖDŽIUKAI;3657451903;Taip;2;1;0;3
1541;Drevinukas;PELĖDŽIUKAI;8180027849;Taip;0;1;2;3
1542;Drevinukas;PELĖDŽIUKAI;7632515230;Taip;0;1;2;3
1543;Drevinukas;PELĖDŽIUKAI;6304169257;Taip;0;1;0;1
1544;Drevinukas;PELĖDŽIUKAI;5686116320;Taip;0;2;0;2
1545;Drevinukas;PELĖDŽIUKAI;56028675283;Taip;0;2;1;3
1546;Drevinukas;PELĖDŽIUKAI;85288014888;Taip;0;1;0;1
1547;Drevinukas;PELĖDŽIUKAI;1019214451;Taip;6;1;0;7
1548;Drevinukas;PELĖDŽIUKAI;6954102486;Ne;0;0;2;2
1549;Drevinukas;PELĖDŽIUKAI;3086451968;Taip;0;1;0;1
1550;Drevinukas;PELĖDŽIUKAI;2857797268;Taip;0;2;0;2
1551;Drevinukas;PELĖDŽIUKAI;6833120798;Taip;0;2;0;2
1552;Drevinukas;PELĖDŽIUKAI;7607135647;Taip;0;2;0;2
1553;Drevinukas;BORUŽĖLĖS;4134729710;Taip;0;0;1;1
1554;Drevinukas;BORUŽĖLĖS;5236292764;Taip;0;0;1;1
1555;Drevinukas;BORUŽĖLĖS;3032536983;Taip;0;0;1;1
1556;Drevinukas;BORUŽĖLĖS;3392249574;Taip;0;2;1;3
1557;Drevinukas;BORUŽĖLĖS;5524567803;Taip;0;1;3;4
1558;Drevinukas;BORUŽĖLĖS;2929598743;Taip;0;2;0;2
1559;Drevinukas;BORUŽĖLĖS;4076576850;Ne;3;1;10;14
1560;Drevinukas;BORUŽĖLĖS;6373230526;Taip;0;1;12;13
1561;Drevinukas;BORUŽĖLĖS;7642022439;Ne;0;0;2;2
1562;Drevinukas;BORUŽĖLĖS;6316000019;Taip;0;1;1;2
1563;Drevinukas;BORUŽĖLĖS;4404254932;Taip;0;1;1;2
1564;Drevinukas;BORUŽĖLĖS;2378493422;Taip;3;2;2;7
1565;Drevinukas;BORUŽĖLĖS;1859208322;Taip;0;1;5;6
1566;Drevinukas;BORUŽĖLĖS;8984653958;Taip;0;1;0;1
1567;Drevinukas;BORUŽĖLĖS;5620887702;Taip;0;1;0;1
1568;Drevinukas;BORUŽĖLĖS;2281463885;Taip;3;1;0;4
1569;Drevinukas;BORUŽĖLĖS;4662426451;Taip;0;1;1;2
1570;Drevinukas;BORUŽĖLĖS;5875459639;Taip;5;1;0;6
1571;Drevinukas;BORUŽĖLĖS;6582186497;Ne;7;1;2;10
1572;Drevinukas;BORUŽĖLĖS;7218201733;Taip;10;0;0;10
1573;Drevinukas;BITUTĖS;3981507849;Taip;0;1;1;2
1574;Drevinukas;BITUTĖS;7753238387;Taip;0;2;0;2
1575;Drevinukas;BITUTĖS;3617570755;Taip;21;0;0;21
1576;Drevinukas;BITUTĖS;5679723776;Taip;0;5;0;5
1577;Drevinukas;BITUTĖS;1720464417;Taip;0;1;1;2
1578;Drevinukas;BITUTĖS;6095020718;Taip;1;1;0;2
1579;Drevinukas;BITUTĖS;1099462840;Taip;0;3;0;3
1580;Drevinukas;BITUTĖS;1152161183;Taip;4;1;0;5
1581;Drevinukas;BITUTĖS;8611131264;Taip;0;2;0;2
1582;Drevinukas;BITUTĖS;8936058501;Taip;7;2;0;9
1583;Drevinukas;BITUTĖS;9772484901;Ne;0;1;0;1
1584;Drevinukas;BITUTĖS;5348609358;Taip;3;2;0;5
1585;Drevinukas;BITUTĖS;1098647410;Taip;0;1;1;2
1586;Drevinukas;BITUTĖS;2312241894;Taip;0;1;0;1
1587;Drevinukas;BITUTĖS;5394143000;Taip;0;0;2;2
1588;Drevinukas;BITUTĖS;3871506691;Taip;0;4;0;4
1589;Drevinukas;BITUTĖS;6914111231;Taip;0;4;0;4
1590;Drevinukas;BITUTĖS;3377957769;Taip;0;1;0;1
1591;Drevinukas;BITUTĖS;2423143170;Taip;2;1;0;3
1592;Drevinukas;BITUTĖS;1343431478;Ne;0;1;2;3
1593;Drevinukas;BITUTĖS;1829421385;Taip;5;1;0;6
1594;Drevinukas;BITUTĖS;8262224710;Taip;0;4;0;4
1595;Drevinukas;BITUTĖS;8479979176;Taip;0;1;1;2
1596;Drevinukas;BITUTĖS;2531207946;Taip;0;1;0;1
1597;Drevinukas;NYKŠTUKAI;8385750920;Taip;0;1;0;1
1598;Drevinukas;NYKŠTUKAI;6165662595;Taip;5;1;3;9
1599;Drevinukas;NYKŠTUKAI;4203106313;Taip;0;1;0;1
1600;Drevinukas;NYKŠTUKAI;4147987057;Taip;0;8;0;8
1601;Drevinukas;NYKŠTUKAI;6645506336;Taip;0;9;0;9
1602;Drevinukas;NYKŠTUKAI;3240313747;Taip;6;0;2;8
1603;Drevinukas;NYKŠTUKAI;8940838262;Taip;0;1;2;3
1604;Drevinukas;NYKŠTUKAI;9695419813;Taip;0;2;10;12
1605;Drevinukas;NYKŠTUKAI;9517560132;Taip;7;1;1;9
1606;Drevinukas;NYKŠTUKAI;6895472558;Taip;0;1;7;8
1607;Drevinukas;NYKŠTUKAI;2039086829;Taip;0;2;0;2
1608;Drevinukas;NYKŠTUKAI;2571295179;Ne;0;8;0;8
1609;Drevinukas;NYKŠTUKAI;2820241608;Taip;0;5;0;5
1610;Drevinukas;NYKŠTUKAI;5999370094;Taip;0;0;1;1
1611;Drevinukas;NYKŠTUKAI;5860361695;Taip;0;1;1;2
1612;Drevinukas;NYKŠTUKAI;9845207619;Taip;10;0;1;11
1613;Drevinukas;NYKŠTUKAI;8694887879;Taip;6;2;0;8
1614;Drevinukas;NYKŠTUKAI;6680003214;Taip;0;6;1;7
1615;Drevinukas;NYKŠTUKAI;3192583690;Ne;2;1;5;8
1616;Drevinukas;NYKŠTUKAI;6659263391;Ne;2;1;5;8
1617;Drevinukas;NYKŠTUKAI;4588368596;Ne;11;0;1;12
1618;Drevinukas;SMALSUČIAI;4242944055;Taip;5;0;1;6
1619;Drevinukas;SMALSUČIAI;1094428951;Taip;5;2;0;7
1620;Drevinukas;SMALSUČIAI;2179736991;Taip;0;2;1;3
1621;Drevinukas;SMALSUČIAI;9105675010;Taip;0;0;1;1
1622;Drevinukas;SMALSUČIAI;9004568476;Taip;1;1;0;2
1623;Drevinukas;SMALSUČIAI;9283862598;Taip;0;2;3;5
1624;Drevinukas;SMALSUČIAI;8578579808;Taip;0;1;0;1
1625;Drevinukas;SMALSUČIAI;3611870655;Taip;4;1;0;5
1626;Drevinukas;SMALSUČIAI;7241671439;Taip;10;1;1;12
1627;Drevinukas;SMALSUČIAI;4089351543;Taip;0;8;0;8
1628;Drevinukas;SMALSUČIAI;2201342382;Ne;1;0;0;1
1629;Drevinukas;SMALSUČIAI;4759293403;Taip;6;1;0;7
1630;Drevinukas;SMALSUČIAI;7863529560;Taip;0;1;0;1
1631;Drevinukas;SMALSUČIAI;9715586195;Taip;0;15;1;16
1632;Drevinukas;SMALSUČIAI;1368495173;Taip;0;4;0;4
1633;Drevinukas;SMALSUČIAI;8284025903;Taip;14;3;0;17
1634;Drevinukas;SMALSUČIAI;6492987985;Taip;6;1;1;8
1635;Drevinukas;ŽVIRBLIUKAI;7252955092;Taip;0;6;7;13
1636;Drevinukas;ŽVIRBLIUKAI;8654858364;Taip;6;1;4;11
1637;Drevinukas;ŽVIRBLIUKAI;5445104383;Taip;0;1;0;1
1638;Drevinukas;ŽVIRBLIUKAI;2662147175;Taip;8;4;0;12
1639;Drevinukas;ŽVIRBLIUKAI;7801920518;Taip;0;2;19;21
1640;Drevinukas;ŽVIRBLIUKAI;1570356979;Taip;0;1;5;6
1641;Drevinukas;ŽVIRBLIUKAI;9123131368;Taip;0;0;1;1
1642;Drevinukas;ŽVIRBLIUKAI;8877080179;Taip;0;1;0;1
1643;Drevinukas;ŽVIRBLIUKAI;6492711565;Ne;0;1;1;2
1644;Drevinukas;ŽVIRBLIUKAI;2274377462;Taip;5;1;1;7
1645;Drevinukas;ŽVIRBLIUKAI;7316996793;Taip;0;3;0;3
1646;Drevinukas;ŽVIRBLIUKAI;3408981880;Taip;4;1;1;6
1647;Drevinukas;ŽVIRBLIUKAI;8953871512;Taip;0;6;3;9
1648;Drevinukas;ŽVIRBLIUKAI;3983656958;Taip;5;2;0;7
1649;Drevinukas;ŽVIRBLIUKAI;1957961770;Taip;0;1;1;2
1650;Drugelis;NYKŠTUKŲ;9316073597;Taip;0;1;0;1
1651;Drugelis;NYKŠTUKŲ;3551095669;Taip;0;1;0;1
1652;Drugelis;NYKŠTUKŲ;1785724340;Taip;5;2;0;7
1653;Drugelis;NYKŠTUKŲ;6632884258;Ne;0;3;2;5
1654;Drugelis;NYKŠTUKŲ;7447519502;Taip;6;1;0;7
1655;Drugelis;NYKŠTUKŲ;6594452094;Taip;0;5;2;7
1656;Drugelis;NYKŠTUKŲ;5122256823;Taip;0;3;0;3
1657;Drugelis;NYKŠTUKŲ;4825232236;Taip;0;1;0;1
1658;Drugelis;NYKŠTUKŲ;7477547789;Taip;0;2;1;3
1659;Drugelis;NYKŠTUKŲ;8717445483;Taip;0;6;0;6
1660;Drugelis;NYKŠTUKŲ;4471405682;Taip;4;0;4;8
1661;Drugelis;NYKŠTUKŲ;4867387611;Taip;9;3;0;12
1662;Drugelis;NYKŠTUKŲ;7609530453;Taip;0;1;3;4
1663;Drugelis;NYKŠTUKŲ;8070030439;Taip;0;1;0;1
1664;Drugelis;NYKŠTUKŲ;3061896520;Taip;0;1;0;1
1665;Drugelis;NYKŠTUKŲ;4927896706;Taip;0;1;0;1
1666;Drugelis;NYKŠTUKŲ;5692743298;Taip;0;1;5;6
1667;Drugelis;NYKŠTUKŲ;6452921695;Taip;6;1;4;11
1668;Drugelis;NYKŠTUKŲ;5902687211;Taip;0;0;3;3
1669;Drugelis;NYKŠTUKŲ;8591548746;Ne;0;4;0;4
1670;Drugelis;SMALSUČIŲ;5121351234;Taip;14;0;0;14
1671;Drugelis;SMALSUČIŲ;6626437352;Ne;2;0;2;4
1672;Drugelis;SMALSUČIŲ;5000965458;Taip;14;2;0;16
1673;Drugelis;SMALSUČIŲ;9683350741;Taip;19;0;0;19
1674;Drugelis;SMALSUČIŲ;1617833459;Taip;0;0;1;1
1675;Drugelis;SMALSUČIŲ;4058293462;Taip;2;0;1;3
1676;Drugelis;SMALSUČIŲ;6533325098;Taip;0;0;1;1
1677;Drugelis;SMALSUČIŲ;4805858183;Taip;13;1;0;14
1678;Drugelis;SMALSUČIŲ;9650052415;Taip;5;0;1;6
1679;Drugelis;SMALSUČIŲ;5533529267;Taip;6;0;0;6
1680;Drugelis;SMALSUČIŲ;3733097479;Taip;18;0;0;18
1681;Drugelis;SMALSUČIŲ;9066572677;Taip;5;0;0;5
1682;Drugelis;SMALSUČIŲ;2196445523;Taip;0;5;0;5
1683;Drugelis;SMALSUČIŲ;3645668411;Taip;1;7;0;8
1684;Drugelis;SMALSUČIŲ;3261462674;Taip;0;5;0;5
1685;Drugelis;SMALSUČIŲ;8186338261;Taip;1;0;0;1
1686;Drugelis;SMALSUČIŲ;3372145698;Taip;10;0;1;11
1687;Drugelis;SMALSUČIŲ;6613520046;Taip;3;0;0;3
1688;Drugelis;SMALSUČIŲ;6890441262;Taip;3;2;0;5
1689;Drugelis;MUMINUKŲ;7390061272;Taip;0;0;1;1
1690;Drugelis;MUMINUKŲ;3311620018;Taip;0;1;0;1
1691;Drugelis;MUMINUKŲ;8812550811;Taip;0;3;1;4
1692;Drugelis;MUMINUKŲ;5661335344;Taip;4;2;0;6
1693;Drugelis;MUMINUKŲ;6038184222;Taip;0;1;0;1
1694;Drugelis;MUMINUKŲ;9851124145;Taip;0;0;1;1
1695;Drugelis;MUMINUKŲ;1816845006;Taip;0;0;1;1
1696;Drugelis;MUMINUKŲ;1666992752;Taip;3;3;1;7
1697;Drugelis;MUMINUKŲ;9510744779;Taip;0;3;0;3
1698;Drugelis;MUMINUKŲ;9029137302;Taip;13;1;0;14
1699;Drugelis;MUMINUKŲ;9907121223;Taip;5;1;0;6
1700;Drugelis;MUMINUKŲ;8500348389;Ne;3;1;0;4
1701;Drugelis;MUMINUKŲ;1858504360;Taip;4;4;0;8
1702;Drugelis;MUMINUKŲ;8366330478;Taip;0;5;0;5
1703;Drugelis;MUMINUKŲ;8107970910;Taip;8;5;0;13
1704;Drugelis;MUMINUKŲ;5515894973;Taip;5;1;0;6
1705;Drugelis;MUMINUKŲ;8282807535;Taip;0;0;1;1
1706;Drugelis;MUMINUKŲ;3293212749;Taip;0;2;1;3
1707;Drugelis;MUMINUKŲ;2256221485;Taip;0;1;0;1
1708;Drugelis;MUMINUKŲ;9588931333;Taip;10;1;0;11
1709;Drugelis;MUMINUKŲ;3176174057;Ne;0;1;0;1
1710;Drugelis;MUMINUKŲ;1761596625;Taip;17;0;0;17
1711;Drugelis;PŪKUOTUKAI;9149748841;Ne;0;3;0;3
1712;Drugelis;PŪKUOTUKAI;1217635751;Taip;0;1;12;13
1713;Drugelis;PŪKUOTUKAI;9612696781;Taip;0;6;0;6
1714;Drugelis;PŪKUOTUKAI;1888002607;Taip;0;1;0;1
1715;Drugelis;PŪKUOTUKAI;27569805506;Ne;0;11;0;11
1716;Drugelis;PŪKUOTUKAI;1961898730;Taip;0;3;0;3
1717;Drugelis;PŪKUOTUKAI;7406396614;Taip;0;2;0;2
1718;Drugelis;PŪKUOTUKAI;1901608445;Taip;0;6;0;6
1719;Drugelis;PŪKUOTUKAI;1506988472;Taip;0;5;0;5
1720;Drugelis;PŪKUOTUKAI;1991420008;Taip;0;5;0;5
1721;Drugelis;PŪKUOTUKAI;1856912386;Taip;0;3;1;4
1722;Drugelis;PŪKUOTUKAI;1576853049;Taip;0;1;2;3
1723;Drugelis;PŪKUOTUKAI;68223183150;Taip;0;1;0;1
1724;Drugelis;PŪKUOTUKAI;3202149560;Taip;0;1;0;1
1725;Drugelis;PŪKUOTUKAI;1421438458;Ne;0;5;0;5
1726;Drugelis;PŪKUOTUKAI;5954059321;Taip;8;3;0;11
1727;Drugelis;PŪKUOTUKAI;1541276266;Ne;0;1;2;3
1728;Drugelis;PŪKUOTUKAI;53874036107;Taip;0;3;0;3
1729;Drugelis;PŪKUOTUKAI;4788423265;Taip;0;3;1;4
1730;Drugelis;PŪKUOTUKAI;3096906506;Taip;0;2;0;2
1731;Drugelis;SPINDULIUKAI;3081918342;Taip;8;0;1;9
1732;Drugelis;SPINDULIUKAI;3560294703;Taip;3;0;1;4
1733;Drugelis;SPINDULIUKAI;1215586620;Taip;0;0;1;1
1734;Drugelis;SPINDULIUKAI;9005448398;Taip;21;0;0;21
1735;Drugelis;SPINDULIUKAI;2926662708;Ne;0;0;1;1
1736;Drugelis;SPINDULIUKAI;6504082488;Taip;0;3;0;3
1737;Drugelis;SPINDULIUKAI;7321544601;Taip;4;1;1;6
1738;Drugelis;SPINDULIUKAI;9296067137;Taip;20;0;0;20
1739;Drugelis;SPINDULIUKAI;9855121078;Taip;6;12;0;18
1740;Drugelis;SPINDULIUKAI;6068102133;Taip;0;1;0;1
1741;Drugelis;SPINDULIUKAI;7825151440;Taip;0;2;0;2
1742;Drugelis;SPINDULIUKAI;4812322553;Taip;0;3;5;8
1743;Drugelis;SPINDULIUKAI;6032568621;Taip;0;1;2;3
1744;Drugelis;SPINDULIUKAI;4580456500;Taip;11;0;0;11
1745;Drugelis;SPINDULIUKAI;8259051898;Taip;11;1;0;12
1746;Drugelis;SPINDULIUKAI;2573357635;Taip;2;0;0;2
1747;Drugelis;KIŠKUČIAI;3603051567;Taip;6;0;0;6
1748;Drugelis;KIŠKUČIAI;4628926113;Taip;9;1;0;10
1749;Drugelis;KIŠKUČIAI;7307032077;Taip;0;2;5;7
1750;Drugelis;KIŠKUČIAI;4871624566;Taip;4;0;1;5
1751;Drugelis;KIŠKUČIAI;1213610973;Ne;13;0;0;13
1752;Drugelis;KIŠKUČIAI;9211760307;Taip;0;8;1;9
1753;Drugelis;KIŠKUČIAI;6071997970;Taip;10;1;0;11
1754;Drugelis;KIŠKUČIAI;8819853863;Taip;5;0;2;7
1755;Drugelis;KIŠKUČIAI;5950704328;Taip;12;0;0;12
1756;Drugelis;KIŠKUČIAI;4898099506;Taip;0;2;0;2
1757;Drugelis;KIŠKUČIAI;6997707085;Ne;3;2;0;5
1758;Drugelis;KIŠKUČIAI;1375535260;Taip;0;0;3;3
1759;Drugelis;KIŠKUČIAI;5857726963;Taip;6;0;1;7
1760;Drugelis;KIŠKUČIAI;1817932444;Taip;6;0;2;8
1761;Drugelis;KIŠKUČIAI;8891228382;Taip;0;0;2;2
1762;"Du gaideliai";Uodelių;6704167983;Taip;2;0;3;5
1763;"Du gaideliai";Uodelių;6942798420;Taip;0;9;0;9
1764;"Du gaideliai";Uodelių;8420400705;Taip;0;8;0;8
1765;"Du gaideliai";Uodelių;4157021754;Taip;0;1;3;4
1766;"Du gaideliai";Uodelių;7193151965;Taip;17;0;0;17
1767;"Du gaideliai";Uodelių;1968978650;Taip;0;0;1;1
1768;"Du gaideliai";Uodelių;2564259600;Taip;6;0;0;6
1769;"Du gaideliai";Uodelių;6132405512;Taip;0;12;0;12
1770;"Du gaideliai";Uodelių;2756525592;Taip;0;3;0;3
1771;"Du gaideliai";Uodelių;7563789811;Taip;2;1;0;3
1772;"Du gaideliai";Uodelių;9126780620;Taip;0;2;0;2
1773;"Du gaideliai";Uodelių;9374869616;Ne;0;0;1;1
1774;"Du gaideliai";Uodelių;5726096980;Taip;0;3;0;3
1775;"Du gaideliai";Uodelių;4408537397;Taip;10;0;0;10
1776;"Du gaideliai";Uodelių;1527839162;Taip;3;1;4;8
1777;"Du gaideliai";Uodelių;5809089345;Taip;0;0;4;4
1778;"Du gaideliai";Uodelių;8174023197;Ne;5;6;0;11
1779;"Du gaideliai";Uodelių;7372149799;Taip;5;4;0;9
1780;"Du gaideliai";OŽIUKŲ;8744467866;Taip;21;0;0;21
1781;"Du gaideliai";OŽIUKŲ;7033276798;Taip;4;1;0;5
1782;"Du gaideliai";OŽIUKŲ;5788923258;Taip;0;10;0;10
1783;"Du gaideliai";OŽIUKŲ;8042203623;Taip;0;22;0;22
1784;"Du gaideliai";OŽIUKŲ;2100449108;Taip;0;0;5;5
1785;"Du gaideliai";OŽIUKŲ;7575534590;Taip;0;7;0;7
1786;"Du gaideliai";OŽIUKŲ;3019797369;Taip;13;1;0;14
1787;"Du gaideliai";OŽIUKŲ;9356275460;Ne;10;0;8;18
1788;"Du gaideliai";OŽIUKŲ;6204233540;Taip;6;4;0;10
1789;"Du gaideliai";OŽIUKŲ;2845145754;Taip;13;5;0;18
1790;"Du gaideliai";OŽIUKŲ;7726490359;Taip;16;0;0;16
1791;"Du gaideliai";OŽIUKŲ;6762171696;Taip;12;0;0;12
1792;"Du gaideliai";OŽIUKŲ;5728374219;Taip;11;1;0;12
1793;"Du gaideliai";OŽIUKŲ;5611102395;Ne;17;2;0;19
1794;"Du gaideliai";OŽIUKŲ;8410547195;Taip;10;0;0;10
1795;"Du gaideliai";OŽIUKŲ;2905083899;Taip;20;0;0;20
1796;"Du gaideliai";OŽIUKŲ;9585785202;Ne;0;14;0;14
1797;"Du gaideliai";OŽIUKŲ;2151825222;Taip;5;1;0;6
1798;"Du gaideliai";OŽIUKŲ;8043896286;Taip;5;0;0;5
1799;"Du gaideliai";OŽIUKŲ;6053941133;Taip;5;1;0;6
1800;"Du gaideliai";OŽIUKŲ;6120647567;Taip;8;2;0;10
1801;"Du gaideliai";Vištyčių;1135098595;Taip;0;5;1;6
1802;"Du gaideliai";Vištyčių;3370029981;Ne;0;1;0;1
1803;"Du gaideliai";Vištyčių;2240947701;Taip;5;0;1;6
1804;"Du gaideliai";Vištyčių;3507387826;Taip;5;4;0;9
1805;"Du gaideliai";Vištyčių;4144269068;Taip;0;7;0;7
1806;"Du gaideliai";Vištyčių;1785976627;Taip;0;0;3;3
1807;"Du gaideliai";Vištyčių;8047413507;Taip;10;1;0;11
1808;"Du gaideliai";Vištyčių;9568647033;Taip;0;0;1;1
1809;"Du gaideliai";Vištyčių;5894974508;Taip;0;3;0;3
1810;"Du gaideliai";Vištyčių;5998344519;Taip;11;0;1;12
1811;"Du gaideliai";Vištyčių;6247706405;Taip;5;0;1;6
1812;"Du gaideliai";Vištyčių;1751328192;Taip;0;1;0;1
1813;"Du gaideliai";Vištyčių;5652662610;Taip;8;1;0;9
1814;"Du gaideliai";Vištyčių;6870356241;Taip;0;2;0;2
1815;"Du gaideliai";Vištyčių;5103483956;Taip;0;1;0;1
1816;"Du gaideliai";Vištyčių;6348951959;Taip;10;0;0;10
1817;"Du gaideliai";Vištyčių;1268479215;Taip;10;2;0;12
1818;"Du gaideliai";Vištyčių;3854355215;Taip;0;0;15;15
1819;"Du gaideliai";Vištyčių;3849899284;Taip;0;1;2;3
1820;"Du gaideliai";GAIDŽIUKŲ;1758546983;Taip;0;14;0;14
1821;"Du gaideliai";GAIDŽIUKŲ;7783203480;Taip;0;2;1;3
1822;"Du gaideliai";GAIDŽIUKŲ;94639433266;Taip;0;1;0;1
1823;"Du gaideliai";GAIDŽIUKŲ;9324740716;Taip;0;6;0;6
1824;"Du gaideliai";GAIDŽIUKŲ;6715434585;Taip;0;3;2;5
1825;"Du gaideliai";GAIDŽIUKŲ;7084763712;Taip;0;1;2;3
1826;"Du gaideliai";GAIDŽIUKŲ;1500684755;Ne;0;11;0;11
1827;"Du gaideliai";GAIDŽIUKŲ;6750787450;Taip;0;1;0;1
1828;"Du gaideliai";GAIDŽIUKŲ;5430986033;Taip;0;1;3;4
1829;"Du gaideliai";GAIDŽIUKŲ;27733314504;Taip;0;2;0;2
1830;"Du gaideliai";GAIDŽIUKŲ;5167460184;Taip;0;1;0;1
1831;"Du gaideliai";GAIDŽIUKŲ;1549762923;Taip;0;1;0;1
1832;"Du gaideliai";GAIDŽIUKŲ;3771563320;Taip;0;1;0;1
1833;"Du gaideliai";GAIDŽIUKŲ;6203383711;Taip;0;1;0;1
1834;"Du gaideliai";GAIDŽIUKŲ;6170362846;Taip;9;1;0;10
1835;"Du gaideliai";GAIDŽIUKŲ;1962859229;Taip;5;1;0;6
1836;"Du gaideliai";GAIDŽIUKŲ;7373413569;Taip;0;4;0;4
1837;"Du gaideliai";GAIDŽIUKŲ;1557413692;Taip;0;3;0;3
1838;"Du gaideliai";GAIDŽIUKŲ;7471332824;Taip;0;3;0;3
1839;"Du gaideliai";GAIDŽIUKŲ;4378924981;Taip;0;1;0;1
1840;"Du gaideliai";Musyčių;9506572113;Taip;5;4;0;9
1841;"Du gaideliai";Musyčių;6224116229;Taip;0;0;3;3
1842;"Du gaideliai";Musyčių;6630053388;Ne;0;1;1;2
1843;"Du gaideliai";Musyčių;3654057453;Taip;17;4;0;21
1844;"Du gaideliai";Musyčių;8921985681;Taip;0;17;3;20
1845;"Du gaideliai";Musyčių;1882241729;Taip;6;0;4;10
1846;"Du gaideliai";Musyčių;5225949099;Taip;5;1;1;7
1847;"Du gaideliai";Musyčių;4204930257;Taip;8;0;1;9
1848;"Du gaideliai";Musyčių;3206388799;Ne;0;13;0;13
1849;"Du gaideliai";Musyčių;2616106413;Taip;1;0;0;1
1850;"Du gaideliai";Musyčių;9934568135;Taip;12;4;0;16
1851;"Du gaideliai";Musyčių;4799107717;Taip;10;2;0;12
1852;"Du gaideliai";Musyčių;8624394105;Taip;15;5;0;20
1853;"Du gaideliai";Musyčių;2122841302;Taip;16;0;2;18
1854;"Du gaideliai";Musyčių;7153424410;Taip;0;4;0;4
1855;"Du gaideliai";Musyčių;4557902728;Taip;4;0;0;4
1856;"Du gaideliai";Musyčių;5514521078;Taip;5;6;0;11
1857;"Du gaideliai";MALŪNO;9561040908;Taip;0;0;1;1
1858;"Du gaideliai";MALŪNO;1048130675;Ne;10;1;3;14
1859;"Du gaideliai";MALŪNO;3601150560;Taip;0;0;1;1
1860;"Du gaideliai";MALŪNO;1777283565;Taip;15;0;0;15
1861;"Du gaideliai";MALŪNO;1940981083;Taip;0;0;1;1
1862;"Du gaideliai";MALŪNO;5113352673;Taip;8;0;0;8
1863;"Du gaideliai";MALŪNO;9477645505;Taip;0;1;4;5
1864;"Du gaideliai";MALŪNO;5142411841;Ne;9;0;0;9
1865;"Du gaideliai";MALŪNO;7855653537;Taip;16;0;0;16
1866;"Du gaideliai";MALŪNO;9832883242;Taip;6;0;0;6
1867;"Du gaideliai";MALŪNO;9619723983;Taip;5;1;0;6
1868;"Du gaideliai";MALŪNO;5016914497;Taip;4;0;4;8
1869;"Du gaideliai";MALŪNO;5060904810;Taip;9;0;0;9
1870;"Du gaideliai";MALŪNO;4759244471;Taip;4;1;0;5
1871;"Du gaideliai";MALŪNO;6054058539;Taip;5;2;0;7
1872;Eglutė;RAMUNĖ;1422631723;Taip;0;14;0;14
1873;Eglutė;RAMUNĖ;6709551046;Ne;7;3;0;10
1874;Eglutė;RAMUNĖ;6093932811;Taip;0;1;0;1
1875;Eglutė;RAMUNĖ;3473388722;Taip;5;1;0;6
1876;Eglutė;RAMUNĖ;2597978713;Ne;0;15;0;15
1877;Eglutė;RAMUNĖ;4451772812;Ne;0;0;1;1
1878;Eglutė;RAMUNĖ;9929681000;Taip;3;0;3;6
1879;Eglutė;RAMUNĖ;6105927493;Taip;0;0;3;3
1880;Eglutė;RAMUNĖ;4560670047;Taip;7;3;1;11
1881;Eglutė;RAMUNĖ;6142326330;Ne;0;0;11;11
1882;Eglutė;RAMUNĖ;9728550000;Taip;0;0;3;3
1883;Eglutė;RAMUNĖ;1534556744;Taip;0;6;6;12
1884;Eglutė;RAMUNĖ;4047404616;Taip;0;7;0;7
1885;Eglutė;RAMUNĖ;4230594049;Taip;11;0;0;11
1886;Eglutė;RAMUNĖ;2998190195;Ne;5;1;1;7
1887;Eglutė;RAMUNĖ;9402686801;Taip;0;0;8;8
1888;Eglutė;RAMUNĖ;6279703448;Ne;0;0;11;11
1889;Eglutė;RAMUNĖ;7598993411;Taip;0;13;0;13
1890;Eglutė;PELĖDŽIUKAI;9066178904;Taip;0;1;0;1
1891;Eglutė;PELĖDŽIUKAI;8606991706;Taip;0;1;8;9
1892;Eglutė;PELĖDŽIUKAI;6518497374;Taip;0;1;0;1
1893;Eglutė;PELĖDŽIUKAI;3203786388;Taip;0;1;0;1
1894;Eglutė;PELĖDŽIUKAI;8033370429;Taip;0;7;4;11
1895;Eglutė;PELĖDŽIUKAI;3178489517;Taip;0;1;5;6
1896;Eglutė;PELĖDŽIUKAI;3393414294;Taip;0;1;0;1
1897;Eglutė;PELĖDŽIUKAI;1510706652;Taip;0;1;0;1
1898;Eglutė;PELĖDŽIUKAI;1695732622;Taip;0;1;0;1
1899;Eglutė;PELĖDŽIUKAI;9333028072;Taip;0;1;1;2
1900;Eglutė;PELĖDŽIUKAI;5856250605;Taip;0;4;0;4
1901;Eglutė;PELĖDŽIUKAI;2638807860;Taip;5;11;0;16
1902;Eglutė;PELĖDŽIUKAI;2082716398;Taip;0;1;0;1
1903;Eglutė;PELĖDŽIUKAI;3616979217;Taip;0;1;0;1
1904;Eglutė;PELĖDŽIUKAI;9950953029;Taip;0;1;9;10
1905;Eglutė;PELĖDŽIUKAI;6835296034;Taip;0;1;0;1
1906;Eglutė;PELĖDŽIUKAI;7148210944;Taip;0;8;0;8
1907;Eglutė;PELĖDŽIUKAI;1324622835;Taip;12;1;3;16
1908;Eglutė;PELĖDŽIUKAI;3275796441;Ne;5;1;2;8
1909;Eglutė;PELĖDŽIUKAI;1806495674;Taip;6;1;0;7
1910;Eglutė;PELĖDŽIUKAI;6544877723;Ne;0;5;0;5
1911;Eglutė;KODĖLČIUKAI;4490295754;Ne;0;3;0;3
1912;Eglutė;KODĖLČIUKAI;1932785408;Taip;0;1;0;1
1913;Eglutė;KODĖLČIUKAI;3883122650;Taip;1;1;0;2
1914;Eglutė;KODĖLČIUKAI;7859815752;Taip;0;2;2;4
1915;Eglutė;KODĖLČIUKAI;4176597208;Taip;0;1;2;3
1916;Eglutė;KODĖLČIUKAI;7758643349;Taip;8;0;1;9
1917;Eglutė;KODĖLČIUKAI;6483580751;Taip;0;2;0;2
1918;Eglutė;KODĖLČIUKAI;5924994736;Taip;0;1;1;2
1919;Eglutė;KODĖLČIUKAI;1759383841;Ne;0;5;0;5
1920;Eglutė;KODĖLČIUKAI;6597261061;Taip;0;3;0;3
1921;Eglutė;KODĖLČIUKAI;9046652370;Taip;4;1;2;7
1922;Eglutė;KODĖLČIUKAI;9356785605;Taip;0;6;0;6
1923;Eglutė;KODĖLČIUKAI;8943684351;Taip;0;1;2;3
1924;Eglutė;KODĖLČIUKAI;8165126017;Taip;0;1;2;3
1925;Eglutė;KODĖLČIUKAI;9967488317;Taip;5;1;0;6
1926;Eglutė;KODĖLČIUKAI;3584247594;Taip;0;2;0;2
1927;Eglutė;KODĖLČIUKAI;9758104910;Ne;1;0;13;14
1928;Eglutė;KODĖLČIUKAI;1531942494;Ne;0;5;0;5
1929;Eglutė;KODĖLČIUKAI;4635123721;Taip;0;2;0;2
1930;Eglutė;KODĖLČIUKAI;9515238936;Taip;2;2;1;5
1931;Eglutė;KODĖLČIUKAI;5840014240;Taip;0;8;0;8
1932;Eglutė;KODĖLČIUKAI;5678727198;Taip;0;1;0;1
1933;Eglutė;OBUOLIUKAI;3799824061;Ne;0;6;0;6
1934;Eglutė;OBUOLIUKAI;1744942011;Taip;3;1;0;4
1935;Eglutė;OBUOLIUKAI;7027121333;Taip;2;2;0;4
1936;Eglutė;OBUOLIUKAI;6679186715;Taip;1;0;1;2
1937;Eglutė;OBUOLIUKAI;8655425408;Ne;0;0;1;1
1938;Eglutė;OBUOLIUKAI;8384141923;Taip;10;1;0;11
1939;Eglutė;OBUOLIUKAI;5239028554;Taip;0;3;1;4
1940;Eglutė;OBUOLIUKAI;3112281182;Ne;11;0;6;17
1941;Eglutė;OBUOLIUKAI;1432716037;Taip;1;0;0;1
1942;Eglutė;OBUOLIUKAI;9542684993;Taip;0;1;0;1
1943;Eglutė;OBUOLIUKAI;6967074765;Taip;0;3;11;14
1944;Eglutė;OBUOLIUKAI;9054104040;Taip;8;0;1;9
1945;Eglutė;OBUOLIUKAI;9193920390;Taip;5;1;0;6
1946;Eglutė;OBUOLIUKAI;8246870069;Taip;0;2;0;2
1947;Eglutė;OBUOLIUKAI;1380219881;Taip;0;1;1;2
1948;Eglutė;OBUOLIUKAI;8721209423;Taip;10;2;0;12
1949;Eglutė;OBUOLIUKAI;7789753835;Taip;0;8;2;10
1950;Eglutė;KAŠTONAS;4099257155;Taip;10;0;4;14
1951;Eglutė;KAŠTONAS;6009794480;Taip;0;3;0;3
1952;Eglutė;KAŠTONAS;6539887315;Taip;0;1;0;1
1953;Eglutė;KAŠTONAS;4252256130;Taip;0;0;3;3
1954;Eglutė;KAŠTONAS;8534997648;Taip;0;0;6;6
1955;Eglutė;KAŠTONAS;7234851379;Taip;0;4;0;4
1956;Eglutė;KAŠTONAS;5636437290;Ne;0;0;7;7
1957;Eglutė;KAŠTONAS;5190045146;Taip;0;4;0;4
1958;Eglutė;KAŠTONAS;8797889347;Taip;0;1;0;1
1959;Eglutė;KAŠTONAS;1842517164;Taip;12;0;3;15
1960;Eglutė;KAŠTONAS;7703290039;Taip;0;1;0;1
1961;Eglutė;KAŠTONAS;7530638623;Taip;0;9;0;9
1962;Eglutė;KAŠTONAS;2357276888;Taip;0;0;12;12
1963;Eglutė;KAŠTONAS;2816913563;Taip;1;0;3;4
1964;Eglutė;KAŠTONAS;7098548563;Taip;0;0;2;2
1965;Eglutė;KAŠTONAS;6146679388;Taip;5;2;0;7
1966;Eglutė;KAŠTONAS;5166183300;Taip;0;7;0;7
1967;Eglutė;KAŠTONAS;7984911632;Taip;0;3;2;5
1968;Eglutė;KAŠTONAS;7811667336;Taip;3;1;0;4
1969;Eglutė;EŽIUKAI;7491022301;Taip;3;1;1;5
1970;Eglutė;EŽIUKAI;5943856319;Taip;0;1;0;1
1971;Eglutė;EŽIUKAI;1050313582;Taip;0;0;3;3
1972;Eglutė;EŽIUKAI;1436966647;Taip;2;0;0;2
1973;Eglutė;EŽIUKAI;6891834971;Taip;0;2;0;2
1974;Eglutė;EŽIUKAI;7307564177;Taip;0;0;8;8
1975;Eglutė;EŽIUKAI;7823828202;Ne;0;1;1;2
1976;Eglutė;EŽIUKAI;7354260503;Ne;0;4;0;4
1977;Eglutė;EŽIUKAI;9439309687;Taip;0;1;3;4
1978;Eglutė;EŽIUKAI;1122308715;Taip;0;1;3;4
1979;Eglutė;EŽIUKAI;8523618773;Taip;0;12;0;12
1980;Eglutė;EŽIUKAI;3856651647;Taip;4;1;2;7
1981;Eglutė;EŽIUKAI;8421062747;Taip;17;1;0;18
1982;Eglutė;EŽIUKAI;9992438336;Taip;0;6;1;7
1983;Eglutė;EŽIUKAI;5731355126;Taip;0;6;1;7
1984;Eglutė;EŽIUKAI;8364693548;Ne;0;7;0;7
1985;Eglutė;EŽIUKAI;1265463853;Taip;0;1;4;5
1986;Eglutė;EŽIUKAI;1908835124;Ne;0;1;0;1
1987;Eglutė;EŽIUKAI;1321901982;Taip;0;0;1;1
1988;Eglutė;EŽIUKAI;9527732584;Taip;0;0;4;4
1989;Eglutė;EŽIUKAI;8162972897;Taip;0;4;0;4
1990;Eglutė;EŽIUKAI;4348313801;Taip;0;1;4;5
1991;Eglutė;EŽIUKAI;9042793284;Taip;0;1;2;3
1992;Eglutė;GILĖ;1550045866;Taip;0;2;8;10
1993;Eglutė;GILĖ;8325288373;Taip;0;1;7;8
1994;Eglutė;GILĖ;6272115803;Taip;0;1;0;1
1995;Eglutė;GILĖ;6550999480;Taip;0;0;1;1
1996;Eglutė;GILĖ;2857760751;Taip;11;0;0;11
1997;Eglutė;GILĖ;8129230197;Taip;0;1;1;2
1998;Eglutė;GILĖ;1835565594;Taip;0;1;7;8
1999;Eglutė;GILĖ;1393626624;Taip;0;1;0;1
2000;Eglutė;GILĖ;2917925763;Taip;0;1;1;2
2001;Eglutė;GILĖ;3740322448;Taip;0;2;0;2
2002;Eglutė;GILĖ;9746021019;Taip;0;1;5;6
2003;Eglutė;GILĖ;1814323427;Taip;21;0;0;21
2004;Eglutė;GILĖ;5013664843;Taip;0;1;1;2
2005;Eglutė;GILĖ;2276311106;Taip;0;5;0;5
2006;Eglutė;GILĖ;5645197324;Taip;0;1;2;3
2007;Eglutė;GILĖ;7800243796;Taip;0;0;11;11
2008;Eglutė;GILĖ;9098132159;Taip;0;2;1;3
2009;Eglutė;GILĖ;2615824395;Taip;5;1;0;6
2010;Eglutė;GILĖ;1899379269;Taip;6;1;1;8
2011;Eglutė;GILĖ;3605053253;Taip;12;1;5;18
2012;Eglutė;SAULUTĖ;9741776217;Taip;0;1;1;2
2013;Eglutė;SAULUTĖ;5285593057;Taip;7;0;1;8
2014;Eglutė;SAULUTĖ;3091324735;Taip;0;1;0;1
2015;Eglutė;SAULUTĖ;5518570006;Taip;0;2;0;2
2016;Eglutė;SAULUTĖ;5805450838;Ne;0;1;1;2
2017;Eglutė;SAULUTĖ;9084576953;Ne;0;0;11;11
2018;Eglutė;SAULUTĖ;6309529738;Taip;0;4;0;4
2019;Eglutė;SAULUTĖ;2259077568;Ne;0;5;1;6
2020;Eglutė;SAULUTĖ;4489150480;Taip;8;6;0;14
2021;Eglutė;SAULUTĖ;2425927050;Ne;10;8;0;18
2022;Eglutė;SAULUTĖ;3006381069;Taip;10;0;0;10
2023;Eglutė;SAULUTĖ;5006042568;Taip;0;1;0;1
2024;Eglutė;SAULUTĖ;5275306818;Taip;0;0;4;4
2025;Eglutė;SAULUTĖ;2621445549;Taip;0;0;1;1
2026;Eglutė;SAULUTĖ;6328900251;Taip;0;1;6;7
2027;Eglutė;SAULUTĖ;9661883776;Taip;0;1;0;1
2028;Eglutė;SAULUTĖ;8799063905;Taip;0;2;0;2
2029;Eglutė;SAULUTĖ;5108928996;Taip;9;0;2;11
2030;Eglutė;SAULUTĖ;6572235324;Taip;10;0;0;10
2031;Eglutė;SAULUTĖ;6424893248;Taip;10;0;2;12
2032;Eglutė;SAULUTĖ;3690266358;Taip;11;1;0;12
2033;Eglutė;ŠARKELĖ;7831541089;Taip;14;0;0;14
2034;Eglutė;ŠARKELĖ;3430016771;Taip;9;6;0;15
2035;Eglutė;ŠARKELĖ;6382927775;Taip;2;6;0;8
2036;Eglutė;ŠARKELĖ;7919553451;Taip;21;0;0;21
2037;Eglutė;ŠARKELĖ;7658345479;Taip;0;7;0;7
2038;Eglutė;ŠARKELĖ;7229612001;Ne;12;2;0;14
2039;Eglutė;ŠARKELĖ;4932945207;Taip;0;0;21;21
2040;Eglutė;ŠARKELĖ;5407757245;Taip;9;0;0;9
2041;Eglutė;ŠARKELĖ;3237476593;Taip;0;1;0;1
2042;Eglutė;ŠARKELĖ;9542103745;Ne;6;0;6;12
2043;Eglutė;ŠARKELĖ;3848175048;Taip;0;1;0;1
2044;Eglutė;ŠARKELĖ;5509138443;Taip;0;0;16;16
2045;Eglutė;ŠARKELĖ;1122907387;Taip;1;1;0;2
2046;Eglutė;ŠARKELĖ;9686836846;Taip;10;1;0;11
2047;Eglutė;ŠARKELĖ;7735192219;Taip;0;1;0;1
2048;Eglutė;ŠARKELĖ;5779671024;Taip;0;3;0;3
2049;Eglutė;ŠARKELĖ;5783776734;Taip;0;6;0;6
2050;Eglutė;ŠARKELĖ;4490541539;Taip;0;1;0;1
2051;Eglutė;ŠARKELĖ;3719202688;Taip;3;1;0;4
2052;Eglutė;ŠARKELĖ;5947727288;Taip;5;0;0;5
2053;Eglutė;ŠARKELĖ;6653111225;Taip;8;0;2;10
2054;Eglutė;NYKŠTUKAI;3011330968;Taip;0;1;1;2
2055;Eglutė;NYKŠTUKAI;8037564034;Taip;0;11;0;11
2056;Eglutė;NYKŠTUKAI;8749425471;Ne;9;8;0;17
2057;Eglutė;NYKŠTUKAI;4151258155;Taip;7;1;1;9
2058;Eglutė;NYKŠTUKAI;6965837585;Taip;0;0;3;3
2059;Eglutė;NYKŠTUKAI;5103022009;Taip;4;2;0;6
2060;Eglutė;NYKŠTUKAI;8542684582;Taip;0;0;13;13
2061;Eglutė;NYKŠTUKAI;3091697091;Taip;3;0;1;4
2062;Eglutė;NYKŠTUKAI;4823811890;Taip;8;0;0;8
2063;Eglutė;NYKŠTUKAI;9292940501;Taip;10;1;0;11
2064;Eglutė;NYKŠTUKAI;3210398495;Taip;0;0;1;1
2065;Eglutė;NYKŠTUKAI;7313013331;Taip;5;0;1;6
2066;Eglutė;NYKŠTUKAI;3051637136;Taip;4;1;0;5
2067;Eglutė;NYKŠTUKAI;5810733285;Taip;7;0;5;12
2068;Eglutė;NYKŠTUKAI;3089527202;Taip;6;0;2;8
2069;Eglutė;NYKŠTUKAI;2669400743;Taip;0;10;0;10
2070;Eglutė;NYKŠTUKAI;1460628870;Taip;11;0;1;12
2071;Eglutė;NYKŠTUKAI;4427853197;Taip;2;1;1;4
2072;Eglutė;ŽIRNIUKAI;3706904006;Taip;9;0;0;9
2073;Eglutė;ŽIRNIUKAI;8698242107;Taip;0;19;2;21
2074;Eglutė;ŽIRNIUKAI;2666894761;Taip;5;0;0;5
2075;Eglutė;ŽIRNIUKAI;4465995209;Taip;5;0;6;11
2076;Eglutė;ŽIRNIUKAI;9795027066;Ne;10;0;7;17
2077;Eglutė;ŽIRNIUKAI;4539946535;Taip;1;5;7;13
2078;Eglutė;ŽIRNIUKAI;4697026463;Taip;4;0;0;4
2079;Eglutė;ŽIRNIUKAI;3974970972;Taip;0;1;0;1
2080;Eglutė;ŽIRNIUKAI;2107488723;Taip;5;0;1;6
2081;Eglutė;ŽIRNIUKAI;9381529574;Taip;10;0;1;11
2082;Eglutė;ŽIRNIUKAI;9150254806;Taip;5;0;1;6
2083;Eglutė;ŽIRNIUKAI;7256251859;Taip;0;4;0;4
2084;Eglutė;ŽIRNIUKAI;1630732306;Ne;0;1;0;1
2085;Eglutė;BORUŽIUKAI;5592515139;Taip;5;0;1;6
2086;Eglutė;BORUŽIUKAI;9964146295;Ne;0;5;0;5
2087;Eglutė;BORUŽIUKAI;1630903587;Taip;0;17;0;17
2088;Eglutė;BORUŽIUKAI;7254436716;Taip;0;17;0;17
2089;Eglutė;BORUŽIUKAI;5982037450;Taip;1;3;0;4
2090;Eglutė;BORUŽIUKAI;7994301287;Taip;7;0;0;7
2091;Eglutė;BORUŽIUKAI;9300315869;Taip;7;0;3;10
2092;Eglutė;BORUŽIUKAI;7231828805;Taip;1;9;0;10
2093;Eglutė;BORUŽIUKAI;5704418881;Taip;16;0;0;16
2094;Eglutė;BORUŽIUKAI;8410302338;Taip;10;0;0;10
2095;Eglutė;BORUŽIUKAI;1667851586;Taip;6;0;0;6
2096;Eglutė;BORUŽIUKAI;1715411901;Taip;0;2;5;7
2097;Eglutė;BORUŽIUKAI;9875724921;Taip;0;0;12;12
2098;Eglutė;BORUŽIUKAI;7564179845;Taip;7;9;1;17
2099;Eglutė;BORUŽIUKAI;9178835404;Taip;0;0;21;21
2100;Eglutė;BORUŽIUKAI;5146804510;Taip;11;0;1;12
2101;Eglutė;BORUŽIUKAI;7618937988;Taip;0;5;0;5
2102;Eglutė;BORUŽIUKAI;8640200557;Taip;0;0;7;7
2103;Eglutė;BORUŽIUKAI;6805213753;Taip;0;0;10;10
2104;Eglutė;BORUŽIUKAI;6773894090;Taip;0;0;2;2
2105;"Geniukų kalvė";SAULUTĖS;9557055841;Taip;11;0;2;13
2106;"Geniukų kalvė";SAULUTĖS;4329782598;Taip;0;9;0;9
2107;"Geniukų kalvė";SAULUTĖS;8932671578;Taip;0;0;1;1
2108;"Geniukų kalvė";SAULUTĖS;9711047774;Taip;0;0;5;5
2109;"Geniukų kalvė";SAULUTĖS;1910363787;Ne;0;1;1;2
2110;"Geniukų kalvė";SAULUTĖS;9522911738;Taip;0;4;1;5
2111;"Geniukų kalvė";SAULUTĖS;5348211316;Taip;0;5;0;5
2112;"Geniukų kalvė";SAULUTĖS;7886553419;Taip;6;2;0;8
2113;"Geniukų kalvė";SAULUTĖS;6384832317;Taip;13;0;3;16
2114;"Geniukų kalvė";SAULUTĖS;4946218794;Taip;0;1;0;1
2115;"Geniukų kalvė";SAULUTĖS;4525874796;Taip;0;1;1;2
2116;"Geniukų kalvė";SAULUTĖS;4745451344;Taip;0;0;3;3
2117;"Geniukų kalvė";SAULUTĖS;9768077014;Taip;0;1;0;1
2118;"Geniukų kalvė";SAULUTĖS;3889643236;Taip;6;1;0;7
2119;"Geniukų kalvė";SAULUTĖS;6102906310;Taip;0;1;5;6
2120;"Geniukų kalvė";SAULUTĖS;6016735700;Ne;0;0;7;7
2121;"Geniukų kalvė";SAULUTĖS;9976423099;Taip;0;2;1;3
2122;"Geniukų kalvė";BITUTĖS;5587035951;Taip;11;1;1;13
2123;"Geniukų kalvė";BITUTĖS;9323779212;Taip;9;0;0;9
2124;"Geniukų kalvė";BITUTĖS;4908674542;Taip;0;1;1;2
2125;"Geniukų kalvė";BITUTĖS;2110578252;Taip;4;1;0;5
2126;"Geniukų kalvė";BITUTĖS;8577323715;Taip;0;1;3;4
2127;"Geniukų kalvė";BITUTĖS;8570015975;Taip;0;0;3;3
2128;"Geniukų kalvė";BITUTĖS;9455124402;Taip;0;0;2;2
2129;"Geniukų kalvė";BITUTĖS;4633553106;Taip;10;1;0;11
2130;"Geniukų kalvė";BITUTĖS;3669378459;Ne;17;0;0;17
2131;"Geniukų kalvė";BITUTĖS;4201333532;Taip;1;4;1;6
2132;"Geniukų kalvė";BITUTĖS;5102325807;Taip;10;4;0;14
2133;"Geniukų kalvė";BITUTĖS;1492140432;Taip;10;0;2;12
2134;"Geniukų kalvė";BITUTĖS;1426555835;Taip;0;1;1;2
2135;"Geniukų kalvė";BITUTĖS;6138451393;Taip;2;2;0;4
2136;"Geniukų kalvė";BITUTĖS;7747615302;Taip;0;4;0;4
2137;"Geniukų kalvė";BITUTĖS;4691978116;Taip;11;3;0;14
2138;"Geniukų kalvė";BITUTĖS;6111168227;Taip;0;1;2;3
2139;"Geniukų kalvė";BITUTĖS;7744441981;Taip;0;0;1;1
2140;"Geniukų kalvė";BITUTĖS;1209268848;Taip;0;0;1;1
2141;"Geniukų kalvė";BITUTĖS;6351861630;Taip;0;3;1;4
2142;"Geniukų kalvė";BITUTĖS;6214681079;Taip;0;3;0;3
2143;"Geniukų kalvė";BITUTĖS;3221034847;Taip;0;5;0;5
2144;"Geniukų kalvė";KIŠKUČIAI;5253380852;Taip;15;0;1;16
2145;"Geniukų kalvė";KIŠKUČIAI;2684344984;Ne;5;0;4;9
2146;"Geniukų kalvė";KIŠKUČIAI;5824747638;Taip;6;0;0;6
2147;"Geniukų kalvė";KIŠKUČIAI;9075192344;Taip;11;0;0;11
2148;"Geniukų kalvė";KIŠKUČIAI;5078771341;Taip;11;0;2;13
2149;"Geniukų kalvė";KIŠKUČIAI;4849740486;Ne;0;0;2;2
2150;"Geniukų kalvė";KIŠKUČIAI;9730758999;Taip;0;0;1;1
2151;"Geniukų kalvė";KIŠKUČIAI;9579750299;Taip;0;0;5;5
2152;"Geniukų kalvė";KIŠKUČIAI;9543553237;Taip;11;0;1;12
2153;"Geniukų kalvė";KIŠKUČIAI;2032408983;Taip;10;0;1;11
2154;"Geniukų kalvė";KIŠKUČIAI;4639389587;Ne;8;0;0;8
2155;"Geniukų kalvė";KIŠKUČIAI;4507631652;Taip;6;0;1;7
2156;"Geniukų kalvė";KIŠKUČIAI;9386761753;Taip;1;0;0;1
2157;"Geniukų kalvė";KIŠKUČIAI;4864216994;Taip;2;0;1;3
2158;"Geniukų kalvė";KIŠKUČIAI;5604315555;Ne;10;0;1;11
2159;"Geniukų kalvė";KIŠKUČIAI;7784155503;Ne;10;0;1;11
2160;"Geniukų kalvė";KIŠKUČIAI;6188518268;Taip;1;0;1;2
2161;"Geniukų kalvė";KIŠKUČIAI;1945456486;Taip;4;0;1;5
2162;"Geniukų kalvė";KIŠKUČIAI;2396085192;Taip;0;14;0;14
2163;"Geniukų kalvė";VYTURĖLIAI;5945583960;Taip;0;1;0;1
2164;"Geniukų kalvė";VYTURĖLIAI;1568133009;Taip;0;1;0;1
2165;"Geniukų kalvė";VYTURĖLIAI;8939171238;Taip;3;1;0;4
2166;"Geniukų kalvė";VYTURĖLIAI;2337226175;Taip;2;2;0;4
2167;"Geniukų kalvė";VYTURĖLIAI;2140334255;Ne;0;1;0;1
2168;"Geniukų kalvė";VYTURĖLIAI;4844734556;Taip;0;1;0;1
2169;"Geniukų kalvė";VYTURĖLIAI;8635708009;Taip;1;0;0;1
2170;"Geniukų kalvė";VYTURĖLIAI;4758435835;Taip;0;2;0;2
2171;"Geniukų kalvė";VYTURĖLIAI;2729442911;Taip;0;2;0;2
2172;"Geniukų kalvė";VYTURĖLIAI;23023070502;Taip;0;2;0;2
2173;"Geniukų kalvė";VYTURĖLIAI;9081596975;Taip;3;4;0;7
2174;"Geniukų kalvė";VYTURĖLIAI;8668696743;Ne;1;0;0;1
2175;"Geniukų kalvė";VYTURĖLIAI;2262014110;Taip;0;1;0;1
2176;"Geniukų kalvė";VYTURĖLIAI;2890934301;Ne;0;1;0;1
2177;"Geniukų kalvė";VYTURĖLIAI;2904091819;Taip;0;3;0;3
2178;"Geniukų kalvė";VYTURĖLIAI;43097490633;Taip;5;7;0;12
2179;"Geniukų kalvė";VYTURĖLIAI;1460456166;Taip;3;0;0;3
2180;"Geniukų kalvė";VYTURĖLIAI;30932565379;Taip;8;2;0;10
2181;"Geniukų kalvė";VYTURĖLIAI;3826265557;Ne;3;1;0;4
2182;"Geniukų kalvė";VYTURĖLIAI;5756909142;Taip;0;1;0;1
2183;"Geniukų kalvė";DRUGELIAI;9676782662;Taip;2;1;0;3
2184;"Geniukų kalvė";DRUGELIAI;6520429663;Taip;9;1;0;10
2185;"Geniukų kalvė";DRUGELIAI;5542539934;Taip;2;1;0;3
2186;"Geniukų kalvė";DRUGELIAI;9666918437;Taip;2;0;0;2
2187;"Geniukų kalvė";DRUGELIAI;6466912385;Taip;0;1;0;1
2188;"Geniukų kalvė";DRUGELIAI;2718961466;Taip;8;3;0;11
2189;"Geniukų kalvė";DRUGELIAI;2016254460;Taip;0;6;0;6
2190;"Geniukų kalvė";DRUGELIAI;3984265624;Taip;0;4;0;4
2191;"Geniukų kalvė";DRUGELIAI;4813232640;Taip;0;1;0;1
2192;"Geniukų kalvė";DRUGELIAI;7081093742;Taip;0;1;0;1
2193;"Geniukų kalvė";DRUGELIAI;5776314197;Taip;6;1;0;7
2194;"Geniukų kalvė";DRUGELIAI;1897809684;Taip;0;1;0;1
2195;"Geniukų kalvė";DRUGELIAI;8872900558;Taip;0;1;0;1
2196;"Geniukų kalvė";DRUGELIAI;2031800114;Taip;0;12;1;13
2197;"Geniukų kalvė";DRUGELIAI;1451190239;Taip;4;3;0;7
2198;"Geniukų kalvė";DRUGELIAI;6511955882;Taip;0;2;0;2
2199;"Geniukų kalvė";DRUGELIAI;2233161242;Taip;0;1;0;1
2200;"Geniukų kalvė";DRUGELIAI;6500641378;Taip;0;5;0;5
2201;"Geniukų kalvė";DRUGELIAI;2143334688;Taip;0;1;0;1
2202;"Geniukų kalvė";DRUGELIAI;6498149304;Taip;0;6;0;6
2203;"Geniukų kalvė";DRUGELIAI;9990243525;Taip;2;0;0;2
2204;"Geniukų kalvė";DRUGELIAI;48818906299;Taip;0;1;0;1
2205;"Geniukų kalvė";DRUGELIAI;4105170344;Taip;2;1;0;3
2206;"Geniukų kalvė";"SAULĖS ZUIKUČIAI";7033628178;Taip;1;0;0;1
2207;"Geniukų kalvė";"SAULĖS ZUIKUČIAI";7082945033;Taip;0;1;0;1
2208;"Geniukų kalvė";"SAULĖS ZUIKUČIAI";2313382307;Taip;0;1;0;1
2209;"Geniukų kalvė";"SAULĖS ZUIKUČIAI";8309953586;Taip;0;1;0;1
2210;"Geniukų kalvė";"SAULĖS ZUIKUČIAI";1443348537;Taip;9;0;0;9
2211;"Geniukų kalvė";"SAULĖS ZUIKUČIAI";2783285969;Taip;11;0;1;12
2212;"Geniukų kalvė";"SAULĖS ZUIKUČIAI";7500079028;Taip;0;0;9;9
2213;"Geniukų kalvė";"SAULĖS ZUIKUČIAI";8071493871;Taip;3;0;0;3
2214;"Geniukų kalvė";"SAULĖS ZUIKUČIAI";8914605154;Taip;1;0;0;1
2215;"Geniukų kalvė";"SAULĖS ZUIKUČIAI";6016585056;Taip;13;0;0;13
2216;"Geniukų kalvė";"SAULĖS ZUIKUČIAI";2816691996;Taip;0;1;0;1
2217;"Geniukų kalvė";"SAULĖS ZUIKUČIAI";5512172533;Taip;0;4;0;4
2218;"Geniukų kalvė";"SAULĖS ZUIKUČIAI";1375674317;Taip;0;1;0;1
2219;"Geniukų kalvė";"SAULĖS ZUIKUČIAI";4722801116;Taip;0;1;0;1
2220;"Geniukų kalvė";"SAULĖS ZUIKUČIAI";5763009912;Taip;1;1;3;5
2221;"Geniukų kalvė";"SAULĖS ZUIKUČIAI";5245434552;Taip;0;1;0;1
2222;"Geniukų kalvė";"SAULĖS ZUIKUČIAI";2952604528;Taip;0;1;0;1
2223;"Geniukų kalvė";"SAULĖS ZUIKUČIAI";5725034297;Taip;1;3;0;4
2224;"Geniukų kalvė";"SAULĖS ZUIKUČIAI";1499735818;Taip;11;0;2;13
2225;"Geniukų kalvė";"SAULĖS ZUIKUČIAI";4186376527;Taip;11;0;1;12
2226;"Geniukų kalvė";"SAULĖS ZUIKUČIAI";5161600326;Taip;0;0;2;2
2227;"Geniukų kalvė";SMALSUČIAI;2499796674;Taip;0;0;5;5
2228;"Geniukų kalvė";SMALSUČIAI;5974481787;Taip;8;0;0;8
2229;"Geniukų kalvė";SMALSUČIAI;7915720190;Taip;5;0;0;5
2230;"Geniukų kalvė";SMALSUČIAI;5993223458;Taip;0;0;1;1
2231;"Geniukų kalvė";SMALSUČIAI;8985466295;Taip;0;1;0;1
2232;"Geniukų kalvė";SMALSUČIAI;5129841490;Taip;7;1;0;8
2233;"Geniukų kalvė";SMALSUČIAI;5705917381;Taip;14;1;0;15
2234;"Geniukų kalvė";SMALSUČIAI;2300947427;Taip;5;1;1;7
2235;"Geniukų kalvė";SMALSUČIAI;1028242614;Taip;7;2;0;9
2236;"Geniukų kalvė";SMALSUČIAI;2596680448;Taip;3;2;0;5
2237;"Geniukų kalvė";SMALSUČIAI;6730270449;Taip;13;1;0;14
2238;"Geniukų kalvė";SMALSUČIAI;4405381922;Taip;0;1;0;1
2239;"Geniukų kalvė";SMALSUČIAI;6473724074;Taip;5;2;0;7
2240;"Geniukų kalvė";SMALSUČIAI;3627418555;Taip;0;4;0;4
2241;"Geniukų kalvė";SMALSUČIAI;9155681194;Ne;11;1;0;12
2242;"Geniukų kalvė";SMALSUČIAI;7440029486;Ne;5;2;0;7
2243;"Geniukų kalvė";SMALSUČIAI;7140298387;Ne;5;0;0;5
2244;"Geniukų kalvė";SMALSUČIAI;6168422514;Taip;21;0;0;21
2245;"Geniukų kalvė";RUDNOSIUKAI;7079072084;Taip;7;0;0;7
2246;"Geniukų kalvė";RUDNOSIUKAI;6060825704;Ne;0;9;1;10
2247;"Geniukų kalvė";RUDNOSIUKAI;6149037133;Taip;0;6;0;6
2248;"Geniukų kalvė";RUDNOSIUKAI;5883913787;Taip;2;2;0;4
2249;"Geniukų kalvė";RUDNOSIUKAI;2426186771;Taip;0;2;0;2
2250;"Geniukų kalvė";RUDNOSIUKAI;5205178173;Taip;6;0;0;6
2251;"Geniukų kalvė";RUDNOSIUKAI;7300853810;Taip;0;6;2;8
2252;"Geniukų kalvė";RUDNOSIUKAI;2839299179;Taip;3;1;0;4
2253;"Geniukų kalvė";RUDNOSIUKAI;4664026888;Taip;1;0;0;1
2254;"Geniukų kalvė";RUDNOSIUKAI;3852896932;Taip;2;0;1;3
2255;"Geniukų kalvė";RUDNOSIUKAI;2165793561;Taip;0;8;0;8
2256;"Geniukų kalvė";RUDNOSIUKAI;5559324196;Taip;0;0;1;1
2257;"Geniukų kalvė";RUDNOSIUKAI;4985606198;Taip;0;0;3;3
2258;"Geniukų kalvė";RUDNOSIUKAI;3631181701;Taip;0;0;1;1
2259;"Geniukų kalvė";RUDNOSIUKAI;3152130511;Taip;3;1;0;4
2260;"Geniukų kalvė";RUDNOSIUKAI;2798750158;Taip;2;1;0;3
2261;"Geniukų kalvė";RUDNOSIUKAI;6373989816;Taip;13;0;1;14
2262;"Geniukų kalvė";PELĖDŽIUKAI;8271041553;Taip;0;2;0;2
2263;"Geniukų kalvė";PELĖDŽIUKAI;1237228692;Taip;5;1;0;6
2264;"Geniukų kalvė";PELĖDŽIUKAI;2938446054;Taip;0;3;2;5
2265;"Geniukų kalvė";PELĖDŽIUKAI;3055777730;Taip;0;1;4;5
2266;"Geniukų kalvė";PELĖDŽIUKAI;6070945557;Ne;0;2;0;2
2267;"Geniukų kalvė";PELĖDŽIUKAI;1051563985;Taip;0;4;0;4
2268;"Geniukų kalvė";PELĖDŽIUKAI;6174114461;Taip;5;1;0;6
2269;"Geniukų kalvė";PELĖDŽIUKAI;2659298240;Taip;0;1;4;5
2270;"Geniukų kalvė";PELĖDŽIUKAI;6737863183;Taip;0;0;1;1
2271;"Geniukų kalvė";PELĖDŽIUKAI;5704223824;Ne;0;1;0;1
2272;"Geniukų kalvė";PELĖDŽIUKAI;1811866428;Ne;0;0;2;2
2273;"Geniukų kalvė";PELĖDŽIUKAI;6410008429;Taip;0;1;0;1
2274;"Geniukų kalvė";PELĖDŽIUKAI;8770345339;Taip;10;0;5;15
2275;"Geniukų kalvė";PELĖDŽIUKAI;5146141771;Taip;13;0;1;14
2276;"Geniukų kalvė";PELĖDŽIUKAI;1611845627;Taip;0;0;1;1
2277;"Geniukų kalvė";PELĖDŽIUKAI;9677583445;Ne;5;2;2;9
2278;"Geniukų kalvė";PELĖDŽIUKAI;6237208661;Taip;0;0;1;1
2279;"Geniukų kalvė";PELĖDŽIUKAI;9921191336;Taip;0;1;3;4
2280;"Geniukų kalvė";BORUŽĖLĖS;9613720001;Taip;0;1;2;3
2281;"Geniukų kalvė";BORUŽĖLĖS;4958738745;Taip;0;6;0;6
2282;"Geniukų kalvė";BORUŽĖLĖS;9069256760;Taip;1;0;0;1
2283;"Geniukų kalvė";BORUŽĖLĖS;5161535756;Taip;0;3;0;3
2284;"Geniukų kalvė";BORUŽĖLĖS;3493492581;Taip;0;2;0;2
2285;"Geniukų kalvė";BORUŽĖLĖS;3085228868;Taip;0;1;0;1
2286;"Geniukų kalvė";BORUŽĖLĖS;6794151223;Taip;0;1;0;1
2287;"Geniukų kalvė";BORUŽĖLĖS;4777155321;Taip;1;1;0;2
2288;"Geniukų kalvė";BORUŽĖLĖS;1037854104;Taip;0;1;0;1
2289;"Geniukų kalvė";BORUŽĖLĖS;2180860623;Ne;0;2;1;3
2290;"Geniukų kalvė";BORUŽĖLĖS;8769761434;Taip;12;0;1;13
2291;"Geniukų kalvė";BORUŽĖLĖS;1891205998;Taip;0;1;0;1
2292;"Geniukų kalvė";BORUŽĖLĖS;9643242164;Taip;0;1;0;1
2293;"Geniukų kalvė";BORUŽĖLĖS;2665955524;Taip;7;1;0;8
2294;"Geniukų kalvė";BORUŽĖLĖS;4872435715;Taip;0;0;2;2
2295;"Geniukų kalvė";BORUŽĖLĖS;3297360222;Taip;0;5;0;5
2296;"Geniukų kalvė";BORUŽĖLĖS;6828079735;Taip;1;0;0;1
2297;"Geniukų kalvė";BORUŽĖLĖS;2710207578;Taip;0;1;0;1
2298;"Geniukų kalvė";BORUŽĖLĖS;1046406910;Taip;15;1;1;17
2299;"Geniukų kalvė";BORUŽĖLĖS;1454724752;Taip;2;3;0;5
2300;"Geniukų kalvė";BORUŽĖLĖS;8052276633;Taip;0;2;1;3
2301;"Geniukų kalvė";BORUŽĖLĖS;3193006249;Taip;0;1;6;7
2302;"Geniukų kalvė";PAGRANDUKAI;1844495906;Taip;0;0;5;5
2303;"Geniukų kalvė";PAGRANDUKAI;7234620406;Taip;6;0;0;6
2304;"Geniukų kalvė";PAGRANDUKAI;6953313909;Taip;10;6;3;19
2305;"Geniukų kalvė";PAGRANDUKAI;4890413509;Taip;0;0;1;1
2306;"Geniukų kalvė";PAGRANDUKAI;2490231586;Taip;0;1;0;1
2307;"Geniukų kalvė";PAGRANDUKAI;9319251542;Taip;0;0;1;1
2308;"Geniukų kalvė";PAGRANDUKAI;7310171451;Taip;0;5;1;6
2309;"Geniukų kalvė";PAGRANDUKAI;8653679467;Taip;0;0;1;1
2310;"Geniukų kalvė";PAGRANDUKAI;9820642056;Taip;0;1;2;3
2311;"Geniukų kalvė";PAGRANDUKAI;6783296167;Taip;0;0;3;3
2312;"Geniukų kalvė";PAGRANDUKAI;8525540366;Taip;0;0;19;19
2313;"Geniukų kalvė";PAGRANDUKAI;5744371590;Taip;2;0;5;7
2314;"Geniukų kalvė";PAGRANDUKAI;5847488152;Ne;6;0;4;10
2315;"Geniukų kalvė";PAGRANDUKAI;3676717541;Taip;8;0;3;11
2316;"Geniukų kalvė";NYKŠTUKAI;7561521903;Taip;6;0;1;7
2317;"Geniukų kalvė";NYKŠTUKAI;2312298671;Ne;11;1;0;12
2318;"Geniukų kalvė";NYKŠTUKAI;8217855034;Taip;0;11;1;12
2319;"Geniukų kalvė";NYKŠTUKAI;1068112116;Taip;17;0;0;17
2320;"Geniukų kalvė";NYKŠTUKAI;1421857914;Taip;0;2;1;3
2321;"Geniukų kalvė";NYKŠTUKAI;1558977259;Taip;0;1;3;4
2322;"Geniukų kalvė";NYKŠTUKAI;4805806745;Taip;2;0;0;2
2323;"Geniukų kalvė";NYKŠTUKAI;1383717352;Taip;2;0;0;2
2324;"Geniukų kalvė";NYKŠTUKAI;3071724778;Taip;6;1;0;7
2325;"Geniukų kalvė";NYKŠTUKAI;2302465593;Taip;6;0;3;9
2326;"Geniukų kalvė";NYKŠTUKAI;3024701779;Taip;1;3;0;4
2327;"Geniukų kalvė";NYKŠTUKAI;1822730314;Taip;0;0;3;3
2328;"Geniukų kalvė";NYKŠTUKAI;3015544833;Taip;9;3;0;12
2329;"Geniukų kalvė";NYKŠTUKAI;6680434763;Taip;6;1;0;7
2330;"Geniukų kalvė";NYKŠTUKAI;7736527608;Taip;8;0;0;8
2331;Gelvonėlis;ĄŽUOLIUKAI;2329699993;Ne;0;7;0;7
2332;Gelvonėlis;ĄŽUOLIUKAI;9058956012;Taip;0;10;0;10
2333;Gelvonėlis;ĄŽUOLIUKAI;4111774915;Taip;0;1;0;1
2334;Gelvonėlis;ĄŽUOLIUKAI;3677100165;Ne;0;12;0;12
2335;Gelvonėlis;ĄŽUOLIUKAI;7449710008;Taip;2;7;0;9
2336;Gelvonėlis;ĄŽUOLIUKAI;9492898584;Ne;7;2;0;9
2337;Gelvonėlis;ĄŽUOLIUKAI;8163855482;Taip;0;1;0;1
2338;Gelvonėlis;ĄŽUOLIUKAI;3942630720;Taip;0;10;0;10
2339;Gelvonėlis;ĄŽUOLIUKAI;1453271708;Taip;0;5;0;5
2340;Gelvonėlis;ĄŽUOLIUKAI;9756155028;Taip;9;1;0;10
2341;Gelvonėlis;ĄŽUOLIUKAI;8206816148;Ne;10;0;0;10
2342;Gelvonėlis;ĄŽUOLIUKAI;3165015754;Taip;3;0;0;3
2343;Gelvonėlis;ĄŽUOLIUKAI;1274119900;Ne;0;7;0;7
2344;Gelvonėlis;ĄŽUOLIUKAI;5901499708;Taip;6;2;0;8
2345;Gelvonėlis;ĄŽUOLIUKAI;1403890893;Ne;13;0;0;13
2346;Gelvonėlis;ŽVIRBLIUKAI;6604992169;Taip;0;1;0;1
2347;Gelvonėlis;ŽVIRBLIUKAI;6556472766;Taip;0;2;6;8
2348;Gelvonėlis;ŽVIRBLIUKAI;7182180008;Taip;1;0;0;1
2349;Gelvonėlis;ŽVIRBLIUKAI;8885088900;Taip;0;2;5;7
2350;Gelvonėlis;ŽVIRBLIUKAI;2400289466;Taip;0;1;2;3
2351;Gelvonėlis;ŽVIRBLIUKAI;9493536517;Taip;1;0;2;3
2352;Gelvonėlis;ŽVIRBLIUKAI;1987204544;Taip;0;2;0;2
2353;Gelvonėlis;ŽVIRBLIUKAI;2288951845;Taip;3;0;0;3
2354;Gelvonėlis;ŽVIRBLIUKAI;2515471132;Taip;2;0;4;6
2355;Gelvonėlis;ŽVIRBLIUKAI;1085845218;Taip;10;0;0;10
2356;Gelvonėlis;ŽVIRBLIUKAI;6319058542;Taip;0;1;0;1
2357;Gelvonėlis;ŽVIRBLIUKAI;9538571448;Taip;0;6;0;6
2358;Gelvonėlis;ŽVIRBLIUKAI;9147186080;Taip;0;4;0;4
2359;Gelvonėlis;ŽVIRBLIUKAI;7620280474;Ne;5;0;2;7
2360;Gelvonėlis;ŽVIRBLIUKAI;7195164378;Taip;5;0;1;6
2361;Gelvonėlis;ŽVIRBLIUKAI;6598178467;Taip;10;1;0;11
2362;Gelvonėlis;ŽVIRBLIUKAI;6068473734;Taip;1;0;0;1
2363;Gelvonėlis;ŽVIRBLIUKAI;4913415466;Taip;0;0;1;1
2364;Gelvonėlis;ŽVIRBLIUKAI;8508450500;Taip;0;5;0;5
2365;Gelvonėlis;ŽVIRBLIUKAI;8704971956;Taip;20;0;1;21
2366;Gelvonėlis;ŽVIRBLIUKAI;4281431471;Taip;4;0;0;4
2367;Gelvonėlis;ŽVIRBLIUKAI;8976258838;Ne;0;4;0;4
2368;Gelvonėlis;RASELĖS;9667024635;Taip;0;3;2;5
2369;Gelvonėlis;RASELĖS;9369121356;Taip;0;0;1;1
2370;Gelvonėlis;RASELĖS;2119550116;Taip;0;1;0;1
2371;Gelvonėlis;RASELĖS;3788522708;Taip;0;1;2;3
2372;Gelvonėlis;RASELĖS;6317822775;Taip;8;1;1;10
2373;Gelvonėlis;RASELĖS;5047022305;Taip;8;1;0;9
2374;Gelvonėlis;RASELĖS;6189110767;Taip;0;1;1;2
2375;Gelvonėlis;RASELĖS;7983982378;Taip;0;2;0;2
2376;Gelvonėlis;RASELĖS;2108690954;Ne;7;1;0;8
2377;Gelvonėlis;RASELĖS;1753617545;Taip;0;1;1;2
2378;Gelvonėlis;RASELĖS;7759317220;Taip;5;2;0;7
2379;Gelvonėlis;RASELĖS;1399518471;Taip;0;1;2;3
2380;Gelvonėlis;RASELĖS;5283207520;Taip;0;1;0;1
2381;Gelvonėlis;RASELĖS;3059903126;Taip;0;1;2;3
2382;Gelvonėlis;RASELĖS;6226970200;Taip;10;1;0;11
2383;Gelvonėlis;RASELĖS;1246591538;Taip;0;1;1;2
2384;Gelvonėlis;RASELĖS;6256962184;Taip;0;1;3;4
2385;Gelvonėlis;RASELĖS;91441127098;Taip;0;1;1;2
2386;Gelvonėlis;RASELĖS;1610362831;Taip;3;1;1;5
2387;Gelvonėlis;RASELĖS;9387523651;Ne;0;8;0;8
2388;Gelvonėlis;RASELĖS;75676389361;Taip;0;1;1;2
2389;Gelvonėlis;RASELĖS;4120103012;Ne;0;1;2;3
2390;Gelvonėlis;SAULUTĖ;9353066785;Taip;4;0;0;4
2391;Gelvonėlis;SAULUTĖ;3121251271;Taip;0;2;0;2
2392;Gelvonėlis;SAULUTĖ;7429739147;Taip;2;0;10;12
2393;Gelvonėlis;SAULUTĖ;7392743619;Taip;6;0;1;7
2394;Gelvonėlis;SAULUTĖ;8228796927;Taip;16;0;0;16
2395;Gelvonėlis;SAULUTĖ;4550077609;Taip;0;0;1;1
2396;Gelvonėlis;SAULUTĖ;1734685590;Taip;7;0;1;8
2397;Gelvonėlis;SAULUTĖ;7936622964;Taip;0;3;0;3
2398;Gelvonėlis;SAULUTĖ;3719670896;Taip;0;5;0;5
2399;Gelvonėlis;SAULUTĖ;1672409070;Ne;5;5;0;10
2400;Gelvonėlis;SAULUTĖ;3771796903;Taip;0;3;0;3
2401;Gelvonėlis;SAULUTĖ;8022270555;Taip;0;2;0;2
2402;Gelvonėlis;SAULUTĖ;4268590631;Taip;6;0;3;9
2403;Gelvonėlis;SAULUTĖ;5598186460;Taip;15;1;0;16
2404;Gelvonėlis;SAULUTĖ;9767254134;Taip;10;0;1;11
2405;Gelvonėlis;SAULUTĖ;2452711535;Taip;10;1;0;11
2406;Gelvonėlis;SAULUTĖ;7977651492;Ne;1;0;0;1
2407;Gelvonėlis;PELĖDŽIUKAI;3830940009;Taip;0;1;0;1
2408;Gelvonėlis;PELĖDŽIUKAI;2742000725;Ne;0;1;9;10
2409;Gelvonėlis;PELĖDŽIUKAI;3147489259;Taip;0;3;0;3
2410;Gelvonėlis;PELĖDŽIUKAI;1284359362;Taip;0;1;0;1
2411;Gelvonėlis;PELĖDŽIUKAI;9798684265;Taip;5;0;0;5
2412;Gelvonėlis;PELĖDŽIUKAI;4855800131;Taip;0;0;1;1
2413;Gelvonėlis;PELĖDŽIUKAI;8775661719;Taip;0;1;0;1
2414;Gelvonėlis;PELĖDŽIUKAI;21684706944;Ne;6;1;0;7
2415;Gelvonėlis;PELĖDŽIUKAI;3089755141;Taip;0;1;1;2
2416;Gelvonėlis;PELĖDŽIUKAI;3670612781;Taip;0;0;2;2
2417;Gelvonėlis;PELĖDŽIUKAI;69073786634;Taip;0;0;1;1
2418;Gelvonėlis;PELĖDŽIUKAI;29928181395;Taip;7;2;0;9
2419;Gelvonėlis;PELĖDŽIUKAI;6255253658;Taip;0;1;2;3
2420;Gelvonėlis;PELĖDŽIUKAI;9323579468;Taip;7;1;1;9
2421;Gelvonėlis;PELĖDŽIUKAI;7919814808;Taip;0;1;8;9
2422;Gelvonėlis;PELĖDŽIUKAI;1355742622;Taip;0;5;0;5
2423;Gelvonėlis;DRUGELIAI;3371560338;Taip;14;0;0;14
2424;Gelvonėlis;DRUGELIAI;2407650243;Taip;11;0;1;12
2425;Gelvonėlis;DRUGELIAI;8365647638;Taip;0;2;0;2
2426;Gelvonėlis;DRUGELIAI;3618681535;Taip;11;0;0;11
2427;Gelvonėlis;DRUGELIAI;4027647695;Taip;2;0;0;2
2428;Gelvonėlis;DRUGELIAI;9386056584;Taip;2;4;0;6
2429;Gelvonėlis;DRUGELIAI;2114734415;Taip;20;1;0;21
2430;Gelvonėlis;DRUGELIAI;5882430535;Taip;6;0;0;6
2431;Gelvonėlis;DRUGELIAI;9140900868;Taip;10;0;0;10
2432;Gelvonėlis;DRUGELIAI;2645337382;Ne;10;2;0;12
2433;Gelvonėlis;DRUGELIAI;3813000890;Ne;6;1;0;7
2434;Gelvonėlis;DRUGELIAI;6662081736;Taip;15;0;0;15
2435;Gelvonėlis;DRUGELIAI;5379820728;Taip;12;0;0;12
2436;Gelvonėlis;DRUGELIAI;7938324572;Taip;12;0;0;12
2437;Gelvonėlis;DRUGELIAI;4162701876;Taip;11;1;0;12
2438;Gelvonėlis;DRUGELIAI;2407650243;Taip;11;0;1;12
2439;Gelvonėlis;VARPELIAI;9149117970;Taip;0;2;0;2
2440;Gelvonėlis;VARPELIAI;6225854165;Taip;0;1;0;1
2441;Gelvonėlis;VARPELIAI;2791652988;Taip;10;6;0;16
2442;Gelvonėlis;VARPELIAI;2638430817;Taip;0;1;7;8
2443;Gelvonėlis;VARPELIAI;9600526942;Taip;6;5;0;11
2444;Gelvonėlis;VARPELIAI;1387948936;Taip;0;3;0;3
2445;Gelvonėlis;VARPELIAI;9650922918;Taip;0;1;0;1
2446;Gelvonėlis;VARPELIAI;1462716950;Taip;0;9;0;9
2447;Gelvonėlis;VARPELIAI;6949090250;Taip;0;0;1;1
2448;Gelvonėlis;VARPELIAI;9622818893;Taip;6;0;2;8
2449;Gelvonėlis;VARPELIAI;3446593424;Taip;11;0;1;12
2450;Gelvonėlis;VARPELIAI;6869418701;Taip;6;0;0;6
2451;Gelvonėlis;VARPELIAI;5207153784;Taip;6;0;0;6
2452;Gelvonėlis;VARPELIAI;9963769327;Taip;1;5;0;6
2453;Gelvonėlis;VARPELIAI;3192542909;Taip;5;0;1;6
2454;Gelvonėlis;BORUŽĖLĖS;8209225630;Taip;6;6;0;12
2455;Gelvonėlis;BORUŽĖLĖS;6554989142;Ne;10;2;0;12
2456;Gelvonėlis;BORUŽĖLĖS;8056058298;Taip;0;1;0;1
2457;Gelvonėlis;BORUŽĖLĖS;4112607183;Taip;1;2;2;5
2458;Gelvonėlis;BORUŽĖLĖS;6243360625;Taip;0;8;0;8
2459;Gelvonėlis;BORUŽĖLĖS;5790038422;Taip;4;1;0;5
2460;Gelvonėlis;BORUŽĖLĖS;1587584701;Ne;0;0;2;2
2461;Gelvonėlis;BORUŽĖLĖS;8515746171;Taip;4;1;0;5
2462;Gelvonėlis;BORUŽĖLĖS;1712926391;Taip;0;1;4;5
2463;Gelvonėlis;BORUŽĖLĖS;6647585785;Taip;9;0;1;10
2464;Gelvonėlis;BORUŽĖLĖS;1539850989;Taip;1;0;0;1
2465;Gelvonėlis;BORUŽĖLĖS;1107633909;Ne;5;6;0;11
2466;Gelvonėlis;BORUŽĖLĖS;8973272332;Taip;0;3;0;3
2467;Gelvonėlis;BORUŽĖLĖS;9849765037;Taip;0;1;0;1
2468;Gelvonėlis;BORUŽĖLĖS;3846916445;Taip;7;4;0;11
2469;Gelvonėlis;BORUŽĖLĖS;4749071286;Taip;5;2;0;7
2470;Gelvonėlis;BORUŽĖLĖS;8806934077;Taip;15;0;3;18
2471;Gelvonėlis;BORUŽĖLĖS;3926733474;Taip;0;1;7;8
2472;Gelvonėlis;BORUŽĖLĖS;4620517551;Taip;5;0;2;7
2473;Gelvonėlis;BORUŽĖLĖS;6598688551;Taip;15;0;0;15
2474;Gelvonėlis;NYKŠTUKAI;8987012601;Taip;17;0;0;17
2475;Gelvonėlis;NYKŠTUKAI;1112841066;Taip;5;6;0;11
2476;Gelvonėlis;NYKŠTUKAI;2553846157;Taip;1;0;1;2
2477;Gelvonėlis;NYKŠTUKAI;8003522011;Taip;5;6;0;11
2478;Gelvonėlis;NYKŠTUKAI;5713586282;Taip;6;0;0;6
2479;Gelvonėlis;NYKŠTUKAI;3217646353;Ne;3;5;0;8
2480;Gelvonėlis;NYKŠTUKAI;8560940316;Taip;5;0;0;5
2481;Gelvonėlis;NYKŠTUKAI;8540204705;Taip;0;1;0;1
2482;Gelvonėlis;NYKŠTUKAI;8124516993;Taip;0;13;1;14
2483;Gelvonėlis;NYKŠTUKAI;9751580494;Ne;3;0;0;3
2484;Gelvonėlis;NYKŠTUKAI;4156493586;Taip;4;0;1;5
2485;Gelvonėlis;NYKŠTUKAI;5124211917;Taip;0;3;1;4
2486;Gelvonėlis;NYKŠTUKAI;5305480599;Taip;3;0;0;3
2487;Gelvonėlis;NYKŠTUKAI;5874473596;Taip;0;5;0;5
2488;Gelvonėlis;NYKŠTUKAI;9597033956;Taip;16;0;0;16
2489;Gelvonėlis;BITUTĖS;6534527571;Taip;0;3;0;3
2490;Gelvonėlis;BITUTĖS;1105838340;Taip;10;0;0;10
2491;Gelvonėlis;BITUTĖS;5865866507;Taip;0;0;21;21
2492;Gelvonėlis;BITUTĖS;5444127599;Ne;9;3;0;12
2493;Gelvonėlis;BITUTĖS;1980703633;Taip;5;1;0;6
2494;Gelvonėlis;BITUTĖS;5633162524;Taip;0;3;0;3
2495;Gelvonėlis;BITUTĖS;6330751030;Taip;0;0;1;1
2496;Gelvonėlis;BITUTĖS;6710189985;Taip;5;6;0;11
2497;Gelvonėlis;BITUTĖS;5281400074;Taip;13;0;0;13
2498;Gelvonėlis;BITUTĖS;3514762919;Taip;1;9;0;10
2499;Gelvonėlis;BITUTĖS;8792171281;Taip;1;0;3;4
2500;Gelvonėlis;BITUTĖS;7850553299;Taip;0;0;3;3
2501;Gelvonėlis;BITUTĖS;1730718430;Ne;13;0;0;13
2502;Gelvonėlis;BITUTĖS;8480138654;Taip;11;0;3;14
2503;Gelvonėlis;BITUTĖS;7725313260;Taip;3;0;5;8
2504;Gelvonėlis;BITUTĖS;5816373550;Taip;3;0;0;3
2505;Gelvonėlis;BITUTĖS;4380468764;Taip;7;7;0;14
2506;Gelvonėlis;RAMUNĖLĖS;1104204810;Taip;11;5;0;16
2507;Gelvonėlis;RAMUNĖLĖS;1355774181;Taip;15;0;1;16
2508;Gelvonėlis;RAMUNĖLĖS;2774170680;Taip;10;0;5;15
2509;Gelvonėlis;RAMUNĖLĖS;3269417874;Taip;9;0;0;9
2510;Gelvonėlis;RAMUNĖLĖS;9403505858;Ne;8;0;0;8
2511;Gelvonėlis;RAMUNĖLĖS;7686930719;Ne;3;1;0;4
2512;Gelvonėlis;RAMUNĖLĖS;4450990418;Taip;15;0;0;15
2513;Gelvonėlis;RAMUNĖLĖS;7419947442;Taip;10;0;0;10
2514;Gelvonėlis;RAMUNĖLĖS;6883156109;Taip;8;0;0;8
2515;Gelvonėlis;RAMUNĖLĖS;1562829157;Taip;8;0;0;8
2516;Gelvonėlis;RAMUNĖLĖS;4211228746;Taip;0;1;0;1
2517;Gelvonėlis;RAMUNĖLĖS;6365451610;Taip;0;0;1;1
2518;Gelvonėlis;RAMUNĖLĖS;1661034338;Taip;10;1;1;12
2519;Gelvonėlis;RAMUNĖLĖS;6851036864;Taip;14;0;0;14
2520;Gelvonėlis;RAMUNĖLĖS;2821485779;Taip;15;0;0;15
2521;Gelvonėlis;RAMUNĖLĖS;6518583809;Taip;10;0;1;11
2522;Gelvonėlis;RAMUNĖLĖS;2818319130;Taip;3;0;0;3
2523;Gelvonėlis;RIEŠUTĖLIAI;3368423382;Taip;10;4;0;14
2524;Gelvonėlis;RIEŠUTĖLIAI;3973248307;Taip;12;2;0;14
2525;Gelvonėlis;RIEŠUTĖLIAI;5461812139;Ne;10;8;0;18
2526;Gelvonėlis;RIEŠUTĖLIAI;5986018609;Taip;0;2;2;4
2527;Gelvonėlis;RIEŠUTĖLIAI;4208103106;Taip;14;0;0;14
2528;Gelvonėlis;RIEŠUTĖLIAI;8766702456;Taip;0;1;1;2
2529;Gelvonėlis;RIEŠUTĖLIAI;6305084811;Taip;10;0;1;11
2530;Gelvonėlis;RIEŠUTĖLIAI;1266479895;Taip;0;5;0;5
2531;Gelvonėlis;RIEŠUTĖLIAI;5934077931;Taip;5;8;0;13
2532;Gelvonėlis;RIEŠUTĖLIAI;6471921512;Taip;7;4;0;11
2533;Gelvonėlis;RIEŠUTĖLIAI;3448444552;Taip;6;2;0;8
2534;Gelvonėlis;RIEŠUTĖLIAI;4832167372;Taip;10;0;0;10
2535;Gelvonėlis;RIEŠUTĖLIAI;9301814935;Taip;0;3;1;4
2536;Gelvonėlis;RIEŠUTĖLIAI;1466616814;Taip;10;0;4;14
2537;Gelvonėlis;RIEŠUTĖLIAI;2015807805;Taip;12;0;0;12
2538;Gelvonėlis;RIEŠUTĖLIAI;9323228591;Taip;0;0;4;4
2539;Gelvonėlis;RIEŠUTĖLIAI;2360728722;Taip;13;0;2;15
2540;Gelvonėlis;RIEŠUTĖLIAI;9132529216;Ne;15;1;0;16
2541;"Gervelė (Dzūkų g. 32)";ŽIRNIUKAI;2523056808;Ne;0;5;0;5
2542;"Gervelė (Dzūkų g. 32)";ŽIRNIUKAI;8533480337;Taip;0;4;0;4
2543;"Gervelė (Dzūkų g. 32)";ŽIRNIUKAI;6895415337;Taip;6;0;0;6
2544;"Gervelė (Dzūkų g. 32)";ŽIRNIUKAI;6227091658;Taip;0;1;0;1
2545;"Gervelė (Dzūkų g. 32)";ŽIRNIUKAI;8439479958;Taip;0;7;2;9
2546;"Gervelė (Dzūkų g. 32)";ŽIRNIUKAI;6844406500;Taip;0;10;1;11
2547;"Gervelė (Dzūkų g. 32)";ŽIRNIUKAI;2359854614;Taip;0;5;0;5
2548;"Gervelė (Dzūkų g. 32)";ŽIRNIUKAI;8811086908;Taip;0;2;0;2
2549;"Gervelė (Dzūkų g. 32)";ŽIRNIUKAI;1573560581;Taip;16;0;0;16
2550;"Gervelė (Dzūkų g. 32)";ŽIRNIUKAI;9133101055;Taip;16;0;2;18
2551;"Gervelė (Dzūkų g. 32)";ŽIRNIUKAI;7192663882;Taip;4;0;1;5
2552;"Gervelė (Dzūkų g. 32)";ŽIRNIUKAI;1783612448;Taip;0;0;8;8
2553;"Gervelė (Dzūkų g. 32)";ŽIRNIUKAI;2563081304;Taip;0;0;1;1
2554;"Gervelė (Dzūkų g. 32)";ŽIRNIUKAI;1101877666;Ne;18;0;0;18
2555;"Gervelė (Dzūkų g. 32)";ŽIRNIUKAI;3164744527;Ne;0;11;0;11
2556;"Gervelė (Dzūkų g. 32)";ŽIRNIUKAI;2046282471;Taip;18;0;0;18
2557;"Gervelė (Dzūkų g. 32)";ŽIRNIUKAI;1024397071;Ne;10;0;1;11
2558;"Gervelė (Dzūkų g. 32)";ŽIRNIUKAI;7040713170;Ne;5;0;0;5
2559;"Gervelė (Dzūkų g. 32)";ŽIRNIUKAI;4075328330;Taip;0;0;16;16
2560;"Gervelė (Dzūkų g. 32)";LAŠIUKAI;3647044817;Taip;0;0;1;1
2561;"Gervelė (Dzūkų g. 32)";LAŠIUKAI;6431701403;Taip;0;0;3;3
2562;"Gervelė (Dzūkų g. 32)";LAŠIUKAI;7721421570;Taip;0;2;2;4
2563;"Gervelė (Dzūkų g. 32)";LAŠIUKAI;2413995770;Taip;11;0;1;12
2564;"Gervelė (Dzūkų g. 32)";LAŠIUKAI;1637204236;Taip;8;0;1;9
2565;"Gervelė (Dzūkų g. 32)";LAŠIUKAI;8157865822;Taip;0;1;1;2
2566;"Gervelė (Dzūkų g. 32)";LAŠIUKAI;7924884022;Taip;5;10;0;15
2567;"Gervelė (Dzūkų g. 32)";LAŠIUKAI;6834663627;Taip;5;9;0;14
2568;"Gervelė (Dzūkų g. 32)";LAŠIUKAI;1323074335;Taip;9;0;0;9
2569;"Gervelė (Dzūkų g. 32)";LAŠIUKAI;6058944385;Taip;0;5;0;5
2570;"Gervelė (Dzūkų g. 32)";LAŠIUKAI;5767158743;Taip;9;0;1;10
2571;"Gervelė (Dzūkų g. 32)";LAŠIUKAI;2446758975;Taip;14;2;0;16
2572;"Gervelė (Dzūkų g. 32)";LAŠIUKAI;1353920541;Taip;0;4;0;4
2573;"Gervelė (Dzūkų g. 32)";LAŠIUKAI;5799823801;Ne;15;0;0;15
2574;"Gervelė (Dzūkų g. 32)";LAŠIUKAI;4899690598;Ne;3;0;2;5
2575;"Gervelė (Dzūkų g. 32)";PABIRUČIAI;7317091881;Taip;0;5;6;11
2576;"Gervelė (Dzūkų g. 32)";PABIRUČIAI;7020599764;Taip;0;1;2;3
2577;"Gervelė (Dzūkų g. 32)";PABIRUČIAI;6951455424;Taip;0;0;5;5
2578;"Gervelė (Dzūkų g. 32)";PABIRUČIAI;1112844296;Taip;5;0;1;6
2579;"Gervelė (Dzūkų g. 32)";PABIRUČIAI;6287806975;Ne;0;4;0;4
2580;"Gervelė (Dzūkų g. 32)";PABIRUČIAI;6228025635;Taip;1;0;1;2
2581;"Gervelė (Dzūkų g. 32)";PABIRUČIAI;9977349707;Taip;0;10;2;12
2582;"Gervelė (Dzūkų g. 32)";PABIRUČIAI;6155979185;Ne;5;6;0;11
2583;"Gervelė (Dzūkų g. 32)";PABIRUČIAI;3333885493;Taip;0;2;0;2
2584;"Gervelė (Dzūkų g. 32)";PABIRUČIAI;4295743997;Taip;1;1;0;2
2585;"Gervelė (Dzūkų g. 32)";PABIRUČIAI;7935059565;Taip;0;1;0;1
2586;"Gervelė (Dzūkų g. 32)";PABIRUČIAI;5267617723;Taip;5;0;4;9
2587;"Gervelė (Dzūkų g. 32)";PABIRUČIAI;5953552777;Taip;0;5;0;5
2588;"Gervelė (Dzūkų g. 32)";PABIRUČIAI;4038179503;Taip;13;1;1;15
2589;"Gervelė (Dzūkų g. 32)";PABIRUČIAI;1160084928;Taip;1;0;1;2
2590;"Gervelė (Dzūkų g. 32)";PABIRUČIAI;6987657237;Taip;0;1;0;1
2591;"Gervelė (Dzūkų g. 32)";PABIRUČIAI;8016341646;Ne;4;0;2;6
2592;"Gervelė (Dzūkų g. 32)";PABIRUČIAI;5685222621;Taip;0;0;2;2
2593;"Gervelė (Dzūkų g. 32)";PABIRUČIAI;4294916559;Taip;9;1;0;10
2594;"Gervelė (Dzūkų g. 32)";PABIRUČIAI;3449674095;Ne;1;3;0;4
2595;"Gervelė (Dzūkų g. 32)";BITUTĖS;6448855055;Taip;0;1;0;1
2596;"Gervelė (Dzūkų g. 32)";BITUTĖS;6090290046;Taip;15;1;1;17
2597;"Gervelė (Dzūkų g. 32)";BITUTĖS;75080308291;Taip;0;3;0;3
2598;"Gervelė (Dzūkų g. 32)";BITUTĖS;6737174004;Taip;3;6;0;9
2599;"Gervelė (Dzūkų g. 32)";BITUTĖS;1616949023;Taip;0;3;0;3
2600;"Gervelė (Dzūkų g. 32)";BITUTĖS;3427400844;Taip;0;11;0;11
2601;"Gervelė (Dzūkų g. 32)";BITUTĖS;8152446576;Taip;5;0;3;8
2602;"Gervelė (Dzūkų g. 32)";BITUTĖS;7302238728;Taip;0;2;0;2
2603;"Gervelė (Dzūkų g. 32)";BITUTĖS;1400044294;Taip;0;1;2;3
2604;"Gervelė (Dzūkų g. 32)";BITUTĖS;8062089041;Ne;17;1;0;18
2605;"Gervelė (Dzūkų g. 32)";BITUTĖS;7697761552;Taip;3;1;2;6
2606;"Gervelė (Dzūkų g. 32)";BITUTĖS;5989713844;Taip;18;0;0;18
2607;"Gervelė (Dzūkų g. 32)";BITUTĖS;4560752068;Taip;0;6;0;6
2608;"Gervelė (Dzūkų g. 32)";BITUTĖS;89076506192;Taip;8;1;0;9
2609;"Gervelė (Dzūkų g. 32)";BITUTĖS;87619285504;Taip;0;1;4;5
2610;"Gervelė (Dzūkų g. 32)";BITUTĖS;1991238577;Taip;0;10;0;10
2611;"Gervelė (Dzūkų g. 32)";BITUTĖS;2167744244;Taip;10;3;0;13
2612;"Gervelė (Dzūkų g. 32)";BITUTĖS;3525060645;Taip;0;4;0;4
2613;"Gervelė (Dzūkų g. 32)";BITUTĖS;7162551366;Taip;0;21;0;21
2614;"Gervelė (Dzūkų g. 32)";BITUTĖS;9970293084;Taip;0;1;0;1
2615;"Gervelė (Dzūkų g. 32)";BURATINO;3946391650;Taip;5;1;0;6
2616;"Gervelė (Dzūkų g. 32)";BURATINO;7620764911;Taip;0;15;0;15
2617;"Gervelė (Dzūkų g. 32)";BURATINO;9239897472;Taip;11;6;0;17
2618;"Gervelė (Dzūkų g. 32)";BURATINO;8997525194;Taip;13;2;0;15
2619;"Gervelė (Dzūkų g. 32)";BURATINO;3359793310;Taip;0;1;7;8
2620;"Gervelė (Dzūkų g. 32)";BURATINO;9982951468;Taip;3;9;0;12
2621;"Gervelė (Dzūkų g. 32)";BURATINO;5900623823;Taip;1;11;0;12
2622;"Gervelė (Dzūkų g. 32)";BURATINO;4775822341;Taip;5;10;0;15
2623;"Gervelė (Dzūkų g. 32)";BURATINO;8012122042;Taip;5;3;0;8
2624;"Gervelė (Dzūkų g. 32)";BURATINO;2541771432;Ne;0;4;0;4
2625;"Gervelė (Dzūkų g. 32)";BURATINO;2913622440;Taip;8;0;5;13
2626;"Gervelė (Dzūkų g. 32)";BURATINO;3912789554;Ne;10;1;0;11
2627;"Gervelė (Dzūkų g. 32)";BURATINO;4434618210;Taip;0;1;0;1
2628;"Gervelė (Dzūkų g. 32)";BURATINO;1108744283;Taip;0;5;0;5
2629;"Gervelė (Dzūkų g. 32)";BURATINO;4516538272;Taip;0;1;4;5
2630;"Gervelė (Dzūkų g. 32)";BURATINO;3723783633;Taip;0;1;0;1
2631;"Gervelė (Dzūkų g. 32)";VIŠČIUKŲ;9532470407;Taip;5;0;0;5
2632;"Gervelė (Dzūkų g. 32)";VIŠČIUKŲ;8792240321;Taip;6;0;3;9
2633;"Gervelė (Dzūkų g. 32)";VIŠČIUKŲ;7205673717;Taip;5;1;3;9
2634;"Gervelė (Dzūkų g. 32)";VIŠČIUKŲ;7140356352;Taip;6;0;1;7
2635;"Gervelė (Dzūkų g. 32)";VIŠČIUKŲ;8598429197;Taip;12;0;1;13
2636;"Gervelė (Dzūkų g. 32)";VIŠČIUKŲ;9294388176;Taip;10;0;2;12
2637;"Gervelė (Dzūkų g. 32)";VIŠČIUKŲ;3230279203;Taip;1;0;0;1
2638;"Gervelė (Dzūkų g. 32)";VIŠČIUKŲ;8392147716;Taip;7;1;0;8
2639;"Gervelė (Dzūkų g. 32)";VIŠČIUKŲ;5608916470;Taip;0;1;0;1
2640;"Gervelė (Dzūkų g. 32)";VIŠČIUKŲ;8098158634;Taip;0;2;0;2
2641;"Gervelė (Dzūkų g. 32)";VIŠČIUKŲ;3554640994;Taip;5;0;0;5
2642;"Gervelė (Dzūkų g. 32)";VIŠČIUKŲ;9478720027;Taip;9;0;0;9
2643;"Gervelė (Dzūkų g. 32)";VIŠČIUKŲ;4552290778;Ne;0;0;4;4
2644;"Gervelė (Dzūkų g. 32)";VIŠČIUKŲ;3170062234;Ne;1;0;4;5
2645;Gilužis;Skruzdėliukų;35511006307;Taip;7;4;0;11
2646;Gilužis;Skruzdėliukų;1671692484;Ne;5;2;0;7
2647;Gilužis;Skruzdėliukų;1615293331;Taip;1;1;0;2
2648;Gilužis;Skruzdėliukų;9474400084;Taip;0;5;0;5
2649;Gilužis;Skruzdėliukų;5161095299;Ne;0;1;0;1
2650;Gilužis;Skruzdėliukų;70959404439;Taip;4;4;0;8
2651;Gilužis;Skruzdėliukų;8120898865;Taip;0;2;0;2
2652;Gilužis;Skruzdėliukų;8840822243;Taip;4;2;0;6
2653;Gilužis;Skruzdėliukų;4611735601;Taip;3;3;0;6
2654;Gilužis;Skruzdėliukų;4747769984;Taip;0;2;0;2
2655;Gilužis;Skruzdėliukų;5920357223;Taip;0;1;0;1
2656;Gilužis;Skruzdėliukų;8595541498;Taip;8;3;0;11
2657;Gilužis;Skruzdėliukų;5365582271;Taip;4;6;0;10
2658;Gilužis;Skruzdėliukų;7364297673;Taip;0;1;0;1
2659;Gilužis;Skruzdėliukų;2042514241;Taip;0;9;1;10
2660;Gilužis;Skruzdėliukų;3216004438;Taip;0;4;0;4
2661;Gilužis;Skruzdėliukų;7766747590;Taip;2;0;0;2
2662;Gilužis;Skruzdėliukų;48365991937;Taip;8;5;0;13
2663;Gilužis;Skruzdėliukų;1452016675;Taip;4;1;0;5
2664;Gilužis;Skruzdėliukų;29586826889;Taip;9;2;0;11
2665;Gilužis;Skruzdėliukų;3071312399;Taip;10;1;0;11
2666;Gilužis;Skruzdėliukų;6233020671;Taip;0;3;0;3
2667;Gilužis;Nykštukų;3132445117;Taip;0;2;1;3
2668;Gilužis;Nykštukų;4147821853;Taip;0;2;0;2
2669;Gilužis;Nykštukų;7937643339;Taip;0;1;0;1
2670;Gilužis;Nykštukų;3473889426;Taip;1;0;0;1
2671;Gilužis;Nykštukų;9362581908;Taip;1;1;0;2
2672;Gilužis;Nykštukų;8899557365;Taip;0;1;0;1
2673;Gilužis;Nykštukų;2661894041;Taip;19;1;0;20
2674;Gilužis;Nykštukų;7228498662;Taip;2;1;0;3
2675;Gilužis;Nykštukų;1459273692;Taip;5;0;0;5
2676;Gilužis;Nykštukų;4156613717;Taip;0;1;0;1
2677;Gilužis;Nykštukų;5713786735;Taip;15;0;0;15
2678;Gilužis;Nykštukų;6315155554;Taip;1;2;0;3
2679;Gilužis;Nykštukų;9332056404;Taip;2;0;6;8
2680;Gilužis;Nykštukų;4541291716;Taip;8;1;0;9
2681;Gilužis;Nykštukų;8522552650;Taip;0;10;0;10
2682;Gilužis;Nykštukų;3176305306;Taip;0;4;0;4
2683;Gilužis;Nykštukų;4795108770;Ne;0;2;0;2
2684;Gilužis;Nykštukų;4094486541;Taip;0;1;0;1
2685;Gilužis;Nykštukų;6493142538;Taip;3;1;0;4
2686;Gilužis;Nykštukų;5088561405;Taip;0;5;0;5
2687;Gilužis;Bitučių;4841014668;Ne;8;0;0;8
2688;Gilužis;Bitučių;3399162399;Taip;6;3;0;9
2689;Gilužis;Bitučių;5973671038;Taip;5;3;0;8
2690;Gilužis;Bitučių;1634295583;Ne;0;2;6;8
2691;Gilužis;Bitučių;4360261750;Ne;0;2;6;8
2692;Gilužis;Bitučių;5728341732;Taip;0;0;9;9
2693;Gilužis;Bitučių;2780710383;Taip;9;0;0;9
2694;Gilužis;Bitučių;6931726275;Taip;6;2;0;8
2695;Gilužis;Bitučių;1867185320;Taip;0;3;0;3
2696;Gilužis;Bitučių;3429435736;Ne;1;2;15;18
2697;Gilužis;Bitučių;8539946703;Taip;0;21;0;21
2698;Gilužis;Bitučių;9000351000;Taip;10;1;0;11
2699;Gilužis;Bitučių;5366174839;Taip;2;2;5;9
2700;Gilužis;Bitučių;5162397237;Taip;0;4;0;4
2701;Gilužis;Bitučių;7250617867;Taip;3;5;0;8
2702;Gilužis;Bitučių;9053608903;Taip;14;2;0;16
2703;Gilužis;Bitučių;6115776872;Taip;0;0;10;10
2704;Gilužis;Bitučių;5651799121;Taip;0;0;6;6
2705;Gilužis;Bitučių;1334619137;Taip;3;1;0;4
2706;Gilužis;Bitučių;2950813185;Taip;0;2;0;2
2707;Gilužis;Bitučių;6515525848;Taip;0;14;0;14
2708;Gilužis;Kačiukų;1273655212;Taip;0;3;0;3
2709;Gilužis;Kačiukų;4978922821;Taip;2;2;0;4
2710;Gilužis;Kačiukų;2945406185;Taip;2;2;0;4
2711;Gilužis;Kačiukų;1582241363;Ne;14;0;0;14
2712;Gilužis;Kačiukų;7330938312;Taip;4;0;1;5
2713;Gilužis;Kačiukų;6571132974;Taip;0;21;0;21
2714;Gilužis;Kačiukų;7001112696;Taip;0;0;3;3
2715;Gilužis;Kačiukų;9034842169;Taip;3;0;0;3
2716;Gilužis;Kačiukų;6966795180;Taip;1;0;0;1
2717;Gilužis;Kačiukų;5128383851;Taip;0;0;8;8
2718;Gilužis;Kačiukų;8318405114;Taip;6;2;0;8
2719;Gilužis;Kačiukų;7826015897;Taip;5;2;0;7
2720;Gilužis;Kačiukų;4403218878;Taip;5;0;1;6
2721;Gilužis;Kačiukų;9186274541;Taip;0;1;0;1
2722;Gilužis;Kačiukų;3419281756;Taip;9;2;0;11
2723;Gilužis;Kačiukų;9421351780;Taip;0;1;0;1
2724;Gilužis;Kačiukų;6404411477;Taip;0;3;0;3
2725;Gilužis;Kačiukų;4128387076;Taip;0;0;1;1
2726;Gilužis;Kačiukų;7042664923;Taip;5;1;1;7
2727;Gilužis;Kačiukų;9097165155;Ne;16;0;0;16
2728;Gilužis;Kačiukų;8762534617;Taip;0;1;0;1
2729;Gilužis;Pelėdžiukų;5217748032;Taip;0;5;0;5
2730;Gilužis;Pelėdžiukų;5989314494;Taip;0;3;0;3
2731;Gilužis;Pelėdžiukų;7998695149;Taip;8;0;0;8
2732;Gilužis;Pelėdžiukų;7742783427;Taip;8;0;0;8
2733;Gilužis;Pelėdžiukų;7358572344;Taip;0;7;0;7
2734;Gilužis;Pelėdžiukų;4617259961;Taip;0;6;0;6
2735;Gilužis;Pelėdžiukų;1222370750;Taip;2;7;0;9
2736;Gilužis;Pelėdžiukų;9503516686;Taip;0;1;0;1
2737;Gilužis;Pelėdžiukų;9833451628;Taip;0;4;0;4
2738;Gilužis;Pelėdžiukų;6270071724;Taip;0;2;0;2
2739;Gilužis;Pelėdžiukų;7505729606;Ne;0;1;1;2
2740;Gilužis;Pelėdžiukų;4051726208;Taip;5;5;0;10
2741;Gilužis;Pelėdžiukų;7092060789;Taip;0;2;0;2
2742;Gilužis;Pelėdžiukų;1804218972;Taip;7;1;2;10
2743;Gilužis;Pelėdžiukų;2434419240;Taip;0;1;0;1
2744;Gilužis;Pelėdžiukų;1832039250;Taip;0;6;2;8
2745;Gilužis;Pelėdžiukų;3166161973;Taip;10;1;0;11
2746;Gilužis;Pelėdžiukų;5070988982;Taip;0;6;0;6
2747;Gilužis;Pelėdžiukų;7899274495;Taip;0;0;9;9
2748;Gilužis;Pelėdžiukų;6093514885;Taip;0;1;3;4
2749;Gilužis;Pelėdžiukų;2869506388;Taip;11;1;0;12
2750;Gilužis;Drugelių;6121625070;Taip;0;1;0;1
2751;Gilužis;Drugelių;1770064694;Taip;0;6;0;6
2752;Gilužis;Drugelių;9591229878;Taip;9;0;1;10
2753;Gilužis;Drugelių;9092013248;Taip;11;1;0;12
2754;Gilužis;Drugelių;9109883577;Ne;5;1;2;8
2755;Gilužis;Drugelių;8006465211;Taip;5;0;4;9
2756;Gilužis;Drugelių;3190597262;Ne;21;0;0;21
2757;Gilužis;Drugelių;2988856911;Taip;3;0;0;3
2758;Gilužis;Drugelių;3532863024;Taip;7;13;0;20
2759;Gilužis;Drugelių;1376645277;Taip;0;1;0;1
2760;Gilužis;Drugelių;1410870589;Taip;2;8;0;10
2761;Gilužis;Drugelių;6786334223;Taip;6;0;1;7
2762;Gilužis;Drugelių;9112993465;Taip;6;0;0;6
2763;Gilužis;Drugelių;4909329417;Taip;5;1;0;6
2764;Gilužis;Drugelių;8244385001;Taip;5;1;0;6
2765;Gilužis;Drugelių;6429142049;Taip;0;1;1;2
2766;Gilužis;Drugelių;7731169885;Ne;7;1;0;8
2767;Gilužis;Drugelių;1093643746;Taip;0;3;0;3
2768;Gilužis;Drugelių;3902713866;Taip;3;0;0;3
2769;Gilužis;Drugelių;6950139609;Taip;6;0;3;9
2770;Gilužis;Drugelių;2397231165;Ne;8;1;0;9
2771;Gilužis;Saulučių;17896774143;Taip;0;1;7;8
2772;Gilužis;Saulučių;9918995545;Taip;0;3;0;3
2773;Gilužis;Saulučių;4209000927;Taip;9;1;0;10
2774;Gilužis;Saulučių;8595551150;Taip;10;3;0;13
2775;Gilužis;Saulučių;4575619425;Taip;3;1;2;6
2776;Gilužis;Saulučių;4473810097;Taip;0;6;0;6
2777;Gilužis;Saulučių;1649256496;Taip;0;4;0;4
2778;Gilužis;Saulučių;96550272401;Taip;6;1;0;7
2779;Gilužis;Saulučių;69504888193;Taip;0;1;0;1
2780;Gilužis;Saulučių;2391630554;Taip;3;1;0;4
2781;Gilužis;Saulučių;18997894859;Taip;0;1;0;1
2782;Gilužis;Saulučių;7744997250;Taip;5;4;0;9
2783;Gilužis;Saulučių;32730847948;Taip;7;1;0;8
2784;Gilužis;Saulučių;3181765606;Taip;2;1;0;3
2785;Gilužis;Saulučių;5905237803;Taip;3;1;0;4
2786;Gilužis;Saulučių;79805583046;Taip;0;1;0;1
2787;Gilužis;Saulučių;2872439079;Taip;0;1;1;2
2788;Gilužis;Saulučių;87425898496;Taip;0;1;5;6
2789;Gilužis;Saulučių;35650138667;Taip;5;1;0;6
2790;Gilužis;Saulučių;9367673896;Taip;8;1;0;9
2791;Gilužis;Saulučių;1453976300;Taip;0;2;0;2
2792;Gilužis;Saulučių;1211233315;Taip;0;1;0;1
2793;Gilužis;Saulučių;5621912516;Taip;0;8;0;8
2794;Gilužis;Paukštelių;1877467761;Ne;0;2;0;2
2795;Gilužis;Paukštelių;1146713023;Taip;0;4;0;4
2796;Gilužis;Paukštelių;1980250599;Taip;0;1;2;3
2797;Gilužis;Paukštelių;1962914764;Taip;11;0;3;14
2798;Gilužis;Paukštelių;7636249706;Taip;0;1;0;1
2799;Gilužis;Paukštelių;2508958685;Ne;0;1;7;8
2800;Gilužis;Paukštelių;72738770293;Taip;0;1;1;2
2801;Gilužis;Paukštelių;8875479631;Taip;10;7;0;17
2802;Gilužis;Paukštelių;5759145600;Taip;0;21;0;21
2803;Gilužis;Paukštelių;8662424856;Taip;0;1;0;1
2804;Gilužis;Paukštelių;2436416327;Taip;0;0;2;2
2805;Gilužis;Paukštelių;6218943275;Taip;3;1;2;6
2806;Gilužis;Paukštelių;2754594238;Taip;0;2;0;2
2807;Gilužis;Paukštelių;8110869130;Taip;6;1;0;7
2808;Gilužis;Paukštelių;1344240019;Taip;0;1;0;1
2809;Gilužis;Paukštelių;4297300799;Taip;0;1;4;5
2810;Gilužis;Paukštelių;9314893329;Taip;1;1;0;2
2811;Gilužis;Paukštelių;46276990963;Taip;0;1;0;1
2812;Gilužis;Paukštelių;5303511810;Taip;9;1;1;11
2813;Gilužis;Obuoliukų;8201769917;Taip;6;4;0;10
2814;Gilužis;Obuoliukų;9892608223;Taip;0;6;1;7
2815;Gilužis;Obuoliukų;4058698645;Taip;0;4;0;4
2816;Gilužis;Obuoliukų;1540018160;Taip;8;1;0;9
2817;Gilužis;Obuoliukų;7716908903;Taip;5;0;0;5
2818;Gilužis;Obuoliukų;3131597174;Taip;6;3;1;10
2819;Gilužis;Obuoliukų;6239369861;Taip;1;0;1;2
2820;Gilužis;Obuoliukų;6172360933;Taip;8;1;0;9
2821;Gilužis;Obuoliukų;7398446674;Taip;0;1;1;2
2822;Gilužis;Obuoliukų;4592380105;Taip;0;11;0;11
2823;Gilužis;Obuoliukų;4242362889;Taip;9;0;0;9
2824;Gilužis;Obuoliukų;7560732216;Taip;9;0;0;9
2825;Gilužis;Obuoliukų;5476140202;Taip;0;1;1;2
2826;Gilužis;Obuoliukų;7606394325;Taip;5;0;1;6
2827;Gilužis;Obuoliukų;6737884137;Taip;0;12;0;12
2828;Gilužis;Obuoliukų;6825745985;Taip;0;1;0;1
2829;Gilužis;Obuoliukų;3458957423;Taip;1;11;0;12
2830;Gilužis;Obuoliukų;8900414658;Taip;0;2;2;4
2831;Gilužis;Obuoliukų;3219101391;Ne;7;1;1;9
2832;Gilužis;Obuoliukų;4528131001;Taip;10;2;0;12
2833;Gilužis;Obuoliukų;5895659747;Taip;0;11;0;11
2834;Gilužis;KIŠKUČIŲ;5744027226;Taip;5;1;3;9
2835;Gilužis;KIŠKUČIŲ;8639633038;Taip;5;0;0;5
2836;Gilužis;KIŠKUČIŲ;5721924532;Taip;9;0;0;9
2837;Gilužis;KIŠKUČIŲ;6323747855;Taip;0;0;1;1
2838;Gilužis;KIŠKUČIŲ;2680643896;Taip;5;4;0;9
2839;Gilužis;KIŠKUČIŲ;5685074731;Taip;5;0;0;5
2840;Gilužis;KIŠKUČIŲ;3649616461;Taip;0;4;0;4
2841;Gilužis;KIŠKUČIŲ;7632771776;Taip;6;0;0;6
2842;Gilužis;KIŠKUČIŲ;7477282548;Taip;6;0;0;6
2843;Gilužis;KIŠKUČIŲ;9061835019;Taip;7;0;3;10
2844;Gilužis;KIŠKUČIŲ;7560574633;Ne;1;0;2;3
2845;Gilužis;KIŠKUČIŲ;4199633620;Ne;6;2;0;8
2846;Gilužis;KIŠKUČIŲ;9851612698;Ne;6;5;0;11
2847;Gilužis;KIŠKUČIŲ;1391410955;Taip;19;0;0;19
2848;Gilužis;KIŠKUČIŲ;6383469680;Taip;9;2;0;11
2849;Gilužis;KIŠKUČIŲ;8341597766;Taip;3;0;1;4
2850;Gilužis;KIŠKUČIŲ;3171560628;Taip;2;0;4;6
2851;Gilužis;KIŠKUČIŲ;4347319425;Taip;4;0;0;4
2852;Gilužis;KIŠKUČIŲ;8591741716;Taip;2;1;1;4
2853;Gilužis;KIŠKUČIŲ;8877445672;Taip;17;0;0;17
2854;Gilužis;KIŠKUČIŲ;9489594782;Taip;10;1;0;11
2855;Gilužis;KIŠKUČIŲ;6185954940;Taip;9;0;0;9
2856;Gilužis;Meškučių;7263432152;Ne;0;3;0;3
2857;Gilužis;Meškučių;3800593189;Taip;13;4;0;17
2858;Gilužis;Meškučių;4174307847;Taip;11;0;0;11
2859;Gilužis;Meškučių;8393554697;Ne;5;6;0;11
2860;Gilužis;Meškučių;2939982311;Taip;5;1;0;6
2861;Gilužis;Meškučių;3365778697;Taip;10;4;0;14
2862;Gilužis;Meškučių;7912093880;Taip;17;0;0;17
2863;Gilužis;Meškučių;2389277783;Taip;0;1;0;1
2864;Gilužis;Meškučių;2500949029;Taip;0;5;0;5
2865;Gilužis;Meškučių;4741129495;Taip;11;3;0;14
2866;Gilužis;Meškučių;7992750316;Taip;11;0;0;11
2867;Gilužis;Meškučių;5505153657;Taip;0;3;1;4
2868;Gilužis;Meškučių;2577554894;Taip;6;1;0;7
2869;Gilužis;Meškučių;6303770262;Taip;10;1;0;11
2870;Gilužis;Meškučių;3148477315;Taip;9;1;0;10
2871;Gilužis;Meškučių;1068375927;Taip;11;0;0;11
2872;Gilužis;Meškučių;8476240141;Taip;9;10;0;19
2873;Gilužis;Meškučių;8780573054;Taip;6;0;0;6
2874;Gilužis;Meškučių;6185280967;Ne;15;1;0;16
2875;Gilužis;Meškučių;5177805719;Taip;6;1;0;7
2876;Gilužis;Pagrandukai;6884146146;Taip;0;21;0;21
2877;Gilužis;Pagrandukai;6920910054;Taip;12;5;0;17
2878;Gilužis;Pagrandukai;5705945483;Taip;0;15;0;15
2879;Gilužis;Pagrandukai;6501973647;Taip;10;0;0;10
2880;Gilužis;Pagrandukai;5397975739;Taip;10;0;0;10
2881;Gilužis;Pagrandukai;6109205159;Taip;3;1;0;4
2882;Gilužis;Pagrandukai;2328338059;Taip;3;1;0;4
2883;Gilužis;Pagrandukai;5376639182;Taip;0;8;0;8
2884;Gilužis;Pagrandukai;5378701300;Taip;3;1;0;4
2885;Gilužis;Pagrandukai;3366788027;Taip;3;1;0;4
2886;Gilužis;Pagrandukai;9676661005;Ne;13;0;0;13
2887;Gilužis;Pagrandukai;1306757860;Ne;13;0;0;13
2888;Gilužis;Pagrandukai;2706629834;Taip;15;1;0;16
2889;Gilužis;Pagrandukai;1604096952;Taip;1;0;0;1
2890;Gilužis;Pagrandukai;5184511012;Taip;13;0;0;13
2891;Gilužis;Pagrandukai;9587502317;Taip;13;0;0;13
2892;Gilužis;Pagrandukai;4266998302;Taip;1;4;1;6
2893;Gilužis;Pagrandukai;5334441484;Taip;0;1;0;1
2894;Gilužis;Pagrandukai;6831107153;Taip;13;0;0;13
2895;Gilužis;Pagrandukai;8852862161;Taip;13;0;0;13
2896;Gilužis;Pagrandukai;2955779117;Taip;13;0;0;13
2897;Gilužis;Boružėlių;5497242500;Taip;1;2;0;3
2898;Gilužis;Boružėlių;2516315604;Taip;11;0;2;13
2899;Gilužis;Boružėlių;9783700319;Taip;16;0;0;16
2900;Gilužis;Boružėlių;5394693502;Taip;0;1;0;1
2901;Gilužis;Boružėlių;4455977087;Taip;9;1;0;10
2902;Gilužis;Boružėlių;4876074981;Taip;2;1;0;3
2903;Gilužis;Boružėlių;2633680406;Taip;3;0;0;3
2904;Gilužis;Boružėlių;2221786284;Taip;2;3;0;5
2905;Gilužis;Boružėlių;3002266577;Taip;6;4;0;10
2906;Gilužis;Boružėlių;5190752112;Ne;13;0;0;13
2907;Gilužis;Boružėlių;2440762487;Ne;13;0;0;13
2908;Gilužis;Boružėlių;4509741536;Ne;7;2;0;9
2909;Gilužis;Boružėlių;9707968228;Taip;14;0;0;14
2910;Gilužis;Boružėlių;8628253655;Taip;11;1;0;12
2911;Gilužis;Boružėlių;9104005195;Taip;4;0;0;4
2912;Gilužis;Boružėlių;5581417252;Taip;0;21;0;21
2913;Gilužis;Boružėlių;4106792355;Taip;6;1;0;7
2914;Gilužis;Boružėlių;4475698906;Taip;13;1;0;14
2915;Gilužis;Boružėlių;1085130813;Taip;0;2;0;2
2916;Gilužis;Boružėlių;2615087717;Taip;4;6;0;10
2917;Gilužis;"MEDYNĖLIO 1 GR. (Įsruties g.)";8237963602;Taip;9;0;0;9
2918;Gilužis;"MEDYNĖLIO 1 GR. (Įsruties g.)";9753512366;Taip;11;0;5;16
2919;Gilužis;"MEDYNĖLIO 1 GR. (Įsruties g.)";6914566889;Taip;21;0;0;21
2920;Gilužis;"MEDYNĖLIO 1 GR. (Įsruties g.)";1541283216;Taip;11;0;0;11
2921;Gilužis;"MEDYNĖLIO 1 GR. (Įsruties g.)";5306278297;Taip;14;0;1;15
2922;Gilužis;"MEDYNĖLIO 1 GR. (Įsruties g.)";1054809163;Taip;9;0;0;9
2923;Gilužis;"MEDYNĖLIO 1 GR. (Įsruties g.)";7887970476;Taip;15;0;0;15
2924;Gilužis;"MEDYNĖLIO 1 GR. (Įsruties g.)";6507021182;Taip;6;0;1;7
2925;Gilužis;"MEDYNĖLIO 1 GR. (Įsruties g.)";4652281185;Taip;9;0;0;9
2926;Gilužis;"MEDYNĖLIO 1 GR. (Įsruties g.)";4122073923;Taip;6;0;0;6
2927;Gilužis;"MEDYNĖLIO 1 GR. (Įsruties g.)";2364391112;Taip;4;0;0;4
2928;Gilužis;"MEDYNĖLIO 1 GR. (Įsruties g.)";6514483362;Ne;0;0;1;1
2929;Gilužis;"MEDYNĖLIO 1 GR. (Įsruties g.)";7068801003;Taip;7;0;0;7
2930;Gilužis;"MEDYNĖLIO 2 GR. (Įsruties g.)";3379889899;Taip;11;0;1;12
2931;Gilužis;"MEDYNĖLIO 2 GR. (Įsruties g.)";2915024298;Taip;6;0;1;7
2932;Gilužis;"MEDYNĖLIO 2 GR. (Įsruties g.)";2567788346;Taip;0;0;1;1
2933;Gilužis;"MEDYNĖLIO 2 GR. (Įsruties g.)";5769955074;Ne;7;0;0;7
2934;Gilužis;"MEDYNĖLIO 2 GR. (Įsruties g.)";7487731015;Taip;4;0;0;4
2935;Gilužis;"MEDYNĖLIO 2 GR. (Įsruties g.)";5490128851;Taip;3;1;1;5
2936;Gilužis;"MEDYNĖLIO 2 GR. (Įsruties g.)";5784201106;Taip;10;0;1;11
2937;Gilužis;"MEDYNĖLIO 2 GR. (Įsruties g.)";8904873416;Taip;7;0;0;7
2938;Gilužis;"MEDYNĖLIO 2 GR. (Įsruties g.)";2851682356;Taip;13;0;1;14
2939;Gilužis;"MEDYNĖLIO 2 GR. (Įsruties g.)";7247606321;Taip;0;21;0;21
2940;Gilužis;"MEDYNĖLIO 2 GR. (Įsruties g.)";5664892047;Taip;0;21;0;21
2941;Gilužis;"STRAZDELIO GR. (Įsruties g.)";6485579727;Taip;1;0;1;2
2942;Gilužis;"STRAZDELIO GR. (Įsruties g.)";6766559505;Taip;9;0;0;9
2943;Gilužis;"STRAZDELIO GR. (Įsruties g.)";3194397689;Taip;11;4;0;15
2944;Gilužis;"STRAZDELIO GR. (Įsruties g.)";5737505086;Taip;0;21;0;21
2945;Gilužis;"STRAZDELIO GR. (Įsruties g.)";3414489196;Taip;0;21;0;21
2946;Gilužis;"STRAZDELIO GR. (Įsruties g.)";6586605929;Ne;0;21;0;21
2947;Gilužis;"STRAZDELIO GR. (Įsruties g.)";3729538163;Taip;10;0;1;11
2948;Gilužis;"STRAZDELIO GR. (Įsruties g.)";6207304860;Taip;6;0;0;6
2949;Gilužis;"STRAZDELIO GR. (Įsruties g.)";7053810996;Taip;7;0;2;9
2950;Gilužis;"STRAZDELIO GR. (Įsruties g.)";2398220397;Taip;11;0;0;11
2951;Gilužis;"STRAZDELIO GR. (Įsruties g.)";1826248450;Taip;11;0;0;11
2952;Gilužis;"STRAZDELIO GR. (Įsruties g.)";3331616067;Taip;6;0;0;6
2953;Gilužis;"STRAZDELIO GR. (Įsruties g.)";8477445384;Taip;2;0;6;8
2954;Gilužis;"STRAZDELIO GR. (Įsruties g.)";9325927745;Taip;13;1;5;19
2955;Gilužis;"STRAZDELIO GR. (Įsruties g.)";5921538837;Taip;7;0;1;8
2956;"Gintarėlis (Didlaukio g. 35)";PAPŪGĖLĖS;8498936096;Taip;0;3;0;3
2957;"Gintarėlis (Didlaukio g. 35)";PAPŪGĖLĖS;8913652291;Taip;4;0;1;5
2958;"Gintarėlis (Didlaukio g. 35)";PAPŪGĖLĖS;2485750596;Taip;0;1;0;1
2959;"Gintarėlis (Didlaukio g. 35)";PAPŪGĖLĖS;1033624080;Taip;6;2;0;8
2960;"Gintarėlis (Didlaukio g. 35)";PAPŪGĖLĖS;2919700367;Ne;1;2;4;7
2961;"Gintarėlis (Didlaukio g. 35)";PAPŪGĖLĖS;1768789948;Taip;0;0;1;1
2962;"Gintarėlis (Didlaukio g. 35)";PAPŪGĖLĖS;2595566032;Taip;10;0;0;10
2963;"Gintarėlis (Didlaukio g. 35)";PAPŪGĖLĖS;9141438560;Taip;6;0;0;6
2964;"Gintarėlis (Didlaukio g. 35)";PAPŪGĖLĖS;2235045173;Taip;2;0;0;2
2965;"Gintarėlis (Didlaukio g. 35)";PAPŪGĖLĖS;9494521554;Taip;5;5;0;10
2966;"Gintarėlis (Didlaukio g. 35)";PAPŪGĖLĖS;7494884360;Taip;0;2;0;2
2967;"Gintarėlis (Didlaukio g. 35)";PAPŪGĖLĖS;7147842224;Taip;0;3;1;4
2968;"Gintarėlis (Didlaukio g. 35)";PAPŪGĖLĖS;5783939567;Taip;0;1;5;6
2969;"Gintarėlis (Didlaukio g. 35)";PAPŪGĖLĖS;7674351459;Taip;0;3;0;3
2970;"Gintarėlis (Didlaukio g. 35)";PAPŪGĖLĖS;6292664833;Taip;4;0;4;8
2971;"Gintarėlis (Didlaukio g. 35)";PAPŪGĖLĖS;8610886062;Taip;0;5;1;6
2972;"Gintarėlis (Didlaukio g. 35)";PAPŪGĖLĖS;5811396263;Taip;1;1;0;2
2973;"Gintarėlis (Didlaukio g. 35)";PAPŪGĖLĖS;1648843117;Taip;1;2;3;6
2974;"Gintarėlis (Didlaukio g. 35)";PAPŪGĖLĖS;1861324153;Taip;0;11;0;11
2975;"Gintarėlis (Didlaukio g. 35)";PAPŪGĖLĖS;3457974670;Taip;4;2;4;10
2976;"Gintarėlis (Didlaukio g. 35)";PAPŪGĖLĖS;1511718436;Ne;11;2;1;14
2977;"Gintarėlis (Didlaukio g. 35)";PAPŪGĖLĖS;4484711857;Taip;0;1;8;9
2978;"Gintarėlis (Didlaukio g. 35)";PAPŪGĖLĖS;6080108998;Taip;6;2;1;9
2979;"Gintarėlis (Didlaukio g. 35)";PAPŪGĖLĖS;6655645997;Taip;6;2;1;9
2980;"Gintarėlis (Didlaukio g. 35)";SPINDULIUKAI;9303448709;Taip;1;0;1;2
2981;"Gintarėlis (Didlaukio g. 35)";SPINDULIUKAI;3600181974;Taip;0;1;0;1
2982;"Gintarėlis (Didlaukio g. 35)";SPINDULIUKAI;6091264509;Taip;0;4;0;4
2983;"Gintarėlis (Didlaukio g. 35)";SPINDULIUKAI;56124970238;Taip;2;2;0;4
2984;"Gintarėlis (Didlaukio g. 35)";SPINDULIUKAI;4902086873;Taip;0;1;0;1
2985;"Gintarėlis (Didlaukio g. 35)";SPINDULIUKAI;22394648690;Ne;0;1;0;1
2986;"Gintarėlis (Didlaukio g. 35)";SPINDULIUKAI;34606130829;Taip;0;4;0;4
2987;"Gintarėlis (Didlaukio g. 35)";SPINDULIUKAI;21658913551;Taip;0;2;0;2
2988;"Gintarėlis (Didlaukio g. 35)";SPINDULIUKAI;8405210216;Ne;0;2;2;4
2989;"Gintarėlis (Didlaukio g. 35)";SPINDULIUKAI;18715625324;Taip;0;1;0;1
2990;"Gintarėlis (Didlaukio g. 35)";SPINDULIUKAI;2721386855;Taip;0;4;0;4
2991;"Gintarėlis (Didlaukio g. 35)";SPINDULIUKAI;2914156353;Taip;2;1;3;6
2992;"Gintarėlis (Didlaukio g. 35)";SPINDULIUKAI;4612041848;Taip;0;1;0;1
2993;"Gintarėlis (Didlaukio g. 35)";SPINDULIUKAI;5916948150;Taip;0;2;1;3
2994;"Gintarėlis (Didlaukio g. 35)";SPINDULIUKAI;45480802894;Ne;5;4;0;9
2995;"Gintarėlis (Didlaukio g. 35)";SPINDULIUKAI;3978892232;Taip;0;1;0;1
2996;"Gintarėlis (Didlaukio g. 35)";SPINDULIUKAI;1770479969;Taip;5;1;0;6
2997;"Gintarėlis (Didlaukio g. 35)";SPINDULIUKAI;1441282039;Taip;5;1;0;6
2998;"Gintarėlis (Didlaukio g. 35)";SPINDULIUKAI;8206947475;Taip;0;1;0;1
2999;"Gintarėlis (Didlaukio g. 35)";SPINDULIUKAI;9539570835;Taip;0;7;0;7
3000;"Gintarėlis (Didlaukio g. 35)";SPINDULIUKAI;7878911379;Taip;0;1;0;1
3001;"Gintarėlis (Didlaukio g. 35)";LAŠIUKAI;6142819210;Taip;1;2;0;3
3002;"Gintarėlis (Didlaukio g. 35)";LAŠIUKAI;7971810025;Taip;6;1;0;7
3003;"Gintarėlis (Didlaukio g. 35)";LAŠIUKAI;28704617970;Ne;4;1;0;5
3004;"Gintarėlis (Didlaukio g. 35)";LAŠIUKAI;5577759167;Taip;0;2;0;2
3005;"Gintarėlis (Didlaukio g. 35)";LAŠIUKAI;8247701603;Taip;0;1;0;1
3006;"Gintarėlis (Didlaukio g. 35)";LAŠIUKAI;4498326942;Taip;8;1;0;9
3007;"Gintarėlis (Didlaukio g. 35)";LAŠIUKAI;4641943773;Taip;4;3;0;7
3008;"Gintarėlis (Didlaukio g. 35)";LAŠIUKAI;6288086420;Taip;7;1;0;8
3009;"Gintarėlis (Didlaukio g. 35)";LAŠIUKAI;1655837441;Ne;0;3;4;7
3010;"Gintarėlis (Didlaukio g. 35)";LAŠIUKAI;1690400583;Taip;5;3;0;8
3011;"Gintarėlis (Didlaukio g. 35)";LAŠIUKAI;8186804032;Taip;0;1;0;1
3012;"Gintarėlis (Didlaukio g. 35)";LAŠIUKAI;1826743229;Taip;0;2;0;2
3013;"Gintarėlis (Didlaukio g. 35)";LAŠIUKAI;9560190761;Taip;0;2;0;2
3014;"Gintarėlis (Didlaukio g. 35)";LAŠIUKAI;5434952733;Taip;7;1;0;8
3015;"Gintarėlis (Didlaukio g. 35)";LAŠIUKAI;5018151097;Taip;5;1;0;6
3016;"Gintarėlis (Didlaukio g. 35)";LAŠIUKAI;9230924100;Taip;0;2;1;3
3017;"Gintarėlis (Didlaukio g. 35)";LAŠIUKAI;4333780287;Taip;0;10;0;10
3018;"Gintarėlis (Didlaukio g. 35)";LAŠIUKAI;7286562743;Taip;0;4;0;4
3019;"Gintarėlis (Didlaukio g. 35)";LAŠIUKAI;1675553097;Taip;5;1;2;8
3020;"Gintarėlis (Didlaukio g. 35)";LAŠIUKAI;8000297636;Taip;10;1;0;11
3021;"Gintarėlis (Didlaukio g. 35)";LAŠIUKAI;3359584322;Taip;11;2;0;13
3022;"Gintarėlis (Didlaukio g. 35)";LAŠIUKAI;6377674849;Taip;0;0;1;1
3023;"Gintarėlis (Didlaukio g. 35)";LAŠIUKAI;3820683506;Taip;0;2;0;2
3024;"Gintarėlis (Didlaukio g. 35)";MEŠKUČIAI;2926488239;Taip;0;1;0;1
3025;"Gintarėlis (Didlaukio g. 35)";MEŠKUČIAI;6618240550;Taip;0;2;0;2
3026;"Gintarėlis (Didlaukio g. 35)";MEŠKUČIAI;8790078624;Taip;5;0;0;5
3027;"Gintarėlis (Didlaukio g. 35)";MEŠKUČIAI;2518840573;Ne;0;3;0;3
3028;"Gintarėlis (Didlaukio g. 35)";MEŠKUČIAI;5187894822;Taip;0;2;0;2
3029;"Gintarėlis (Didlaukio g. 35)";MEŠKUČIAI;3630567294;Taip;0;7;0;7
3030;"Gintarėlis (Didlaukio g. 35)";MEŠKUČIAI;5181872438;Taip;10;1;0;11
3031;"Gintarėlis (Didlaukio g. 35)";MEŠKUČIAI;1565802953;Taip;0;21;0;21
3032;"Gintarėlis (Didlaukio g. 35)";MEŠKUČIAI;2072435242;Taip;0;2;0;2
3033;"Gintarėlis (Didlaukio g. 35)";MEŠKUČIAI;7989239799;Taip;5;1;0;6
3034;"Gintarėlis (Didlaukio g. 35)";MEŠKUČIAI;4356211536;Ne;12;0;0;12
3035;"Gintarėlis (Didlaukio g. 35)";MEŠKUČIAI;1502740714;Taip;0;1;0;1
3036;"Gintarėlis (Didlaukio g. 35)";MEŠKUČIAI;6636835034;Taip;0;2;0;2
3037;"Gintarėlis (Didlaukio g. 35)";MEŠKUČIAI;3830154353;Ne;0;1;0;1
3038;"Gintarėlis (Didlaukio g. 35)";MEŠKUČIAI;3947405446;Taip;0;1;0;1
3039;"Gintarėlis (Didlaukio g. 35)";MEŠKUČIAI;4642142931;Taip;5;4;0;9
3040;"Gintarėlis (Didlaukio g. 35)";MEŠKUČIAI;6711753930;Taip;0;3;0;3
3041;"Gintarėlis (Didlaukio g. 35)";MEŠKUČIAI;9017592249;Taip;10;1;0;11
3042;"Gintarėlis (Didlaukio g. 35)";MEŠKUČIAI;8375475174;Taip;9;3;0;12
3043;"Gintarėlis (Didlaukio g. 35)";MEŠKUČIAI;7029401386;Taip;6;1;0;7
3044;"Gintarėlis (Didlaukio g. 35)";MEŠKUČIAI;7320085613;Taip;1;0;0;1
3045;"Gintarėlis (Didlaukio g. 35)";DRUGELIAI;1462949250;Taip;0;1;0;1
3046;"Gintarėlis (Didlaukio g. 35)";DRUGELIAI;6655809299;Taip;0;0;2;2
3047;"Gintarėlis (Didlaukio g. 35)";DRUGELIAI;2614258442;Taip;0;8;0;8
3048;"Gintarėlis (Didlaukio g. 35)";DRUGELIAI;1452402931;Taip;0;1;0;1
3049;"Gintarėlis (Didlaukio g. 35)";DRUGELIAI;7571352126;Taip;0;1;1;2
3050;"Gintarėlis (Didlaukio g. 35)";DRUGELIAI;9687974376;Taip;0;5;0;5
3051;"Gintarėlis (Didlaukio g. 35)";DRUGELIAI;7449437199;Ne;0;3;0;3
3052;"Gintarėlis (Didlaukio g. 35)";DRUGELIAI;3341850450;Taip;0;1;1;2
3053;"Gintarėlis (Didlaukio g. 35)";DRUGELIAI;1759218238;Ne;5;2;0;7
3054;"Gintarėlis (Didlaukio g. 35)";DRUGELIAI;1248017244;Taip;10;1;0;11
3055;"Gintarėlis (Didlaukio g. 35)";DRUGELIAI;2792618575;Taip;0;3;0;3
3056;"Gintarėlis (Didlaukio g. 35)";DRUGELIAI;8171192401;Taip;5;1;0;6
3057;"Gintarėlis (Didlaukio g. 35)";DRUGELIAI;7694587246;Taip;0;2;0;2
3058;"Gintarėlis (Didlaukio g. 35)";DRUGELIAI;4904966263;Taip;0;1;0;1
3059;"Gintarėlis (Didlaukio g. 35)";KAČIUKAI;5569843168;Taip;0;2;1;3
3060;"Gintarėlis (Didlaukio g. 35)";KAČIUKAI;3665764153;Taip;10;4;4;18
3061;"Gintarėlis (Didlaukio g. 35)";KAČIUKAI;9774056578;Taip;16;2;0;18
3062;"Gintarėlis (Didlaukio g. 35)";KAČIUKAI;2212296954;Taip;5;0;1;6
3063;"Gintarėlis (Didlaukio g. 35)";KAČIUKAI;3825700024;Taip;7;0;0;7
3064;"Gintarėlis (Didlaukio g. 35)";KAČIUKAI;7057877483;Taip;1;2;1;4
3065;"Gintarėlis (Didlaukio g. 35)";KAČIUKAI;9825811100;Taip;10;0;0;10
3066;"Gintarėlis (Didlaukio g. 35)";KAČIUKAI;7875981690;Taip;0;6;1;7
3067;"Gintarėlis (Didlaukio g. 35)";KAČIUKAI;2544338275;Taip;0;6;1;7
3068;"Gintarėlis (Didlaukio g. 35)";KAČIUKAI;9963329170;Taip;0;10;0;10
3069;"Gintarėlis (Didlaukio g. 35)";KAČIUKAI;5214984111;Taip;1;1;0;2
3070;"Gintarėlis (Didlaukio g. 35)";KAČIUKAI;1011749698;Taip;0;2;2;4
3071;"Gintarėlis (Didlaukio g. 35)";KAČIUKAI;8261770154;Taip;5;12;0;17
3072;"Gintarėlis (Didlaukio g. 35)";KAČIUKAI;7061545258;Taip;0;1;0;1
3073;"Gintarėlis (Didlaukio g. 35)";KAČIUKAI;5436695400;Ne;0;2;1;3
3074;"Gintarėlis (Didlaukio g. 35)";KAČIUKAI;5921751507;Taip;14;1;0;15
3075;"Gintarėlis (Didlaukio g. 35)";KAČIUKAI;9450900915;Taip;8;0;8;16
3076;"Gintarėlis (Didlaukio g. 35)";KAČIUKAI;5153948767;Taip;1;0;0;1
3077;"Gintarėlis (Didlaukio g. 35)";KAČIUKAI;3814485627;Taip;2;1;0;3
3078;"Gintarėlis (Didlaukio g. 35)";KAČIUKAI;1571260478;Ne;5;2;0;7
3079;"Gintarėlis (Didlaukio g. 35)";KAČIUKAI;9244715396;Taip;9;1;1;11
3080;"Gintarėlis (Didlaukio g. 35)";KAČIUKAI;3015327416;Taip;1;0;0;1
3081;"Gintarėlis (Didlaukio g. 35)";KIŠKUČIAI;9279399214;Taip;0;1;0;1
3082;"Gintarėlis (Didlaukio g. 35)";KIŠKUČIAI;3921015919;Taip;0;1;0;1
3083;"Gintarėlis (Didlaukio g. 35)";KIŠKUČIAI;2814569415;Taip;0;8;0;8
3084;"Gintarėlis (Didlaukio g. 35)";KIŠKUČIAI;5796729245;Taip;0;7;0;7
3085;"Gintarėlis (Didlaukio g. 35)";KIŠKUČIAI;9915887420;Taip;0;7;0;7
3086;"Gintarėlis (Didlaukio g. 35)";KIŠKUČIAI;8287685690;Taip;0;2;0;2
3087;"Gintarėlis (Didlaukio g. 35)";KIŠKUČIAI;7815317644;Taip;0;1;0;1
3088;"Gintarėlis (Didlaukio g. 35)";KIŠKUČIAI;6914904213;Taip;1;2;0;3
3089;"Gintarėlis (Didlaukio g. 35)";KIŠKUČIAI;1696337909;Taip;1;2;0;3
3090;"Gintarėlis (Didlaukio g. 35)";KIŠKUČIAI;6862629244;Taip;0;6;0;6
3091;"Gintarėlis (Didlaukio g. 35)";KIŠKUČIAI;3398936974;Taip;6;0;0;6
3092;"Gintarėlis (Didlaukio g. 35)";KIŠKUČIAI;1918879534;Taip;0;3;0;3
3093;"Gintarėlis (Didlaukio g. 35)";KIŠKUČIAI;7509100750;Taip;0;3;0;3
3094;"Gintarėlis (Didlaukio g. 35)";KIŠKUČIAI;6991746305;Taip;4;1;0;5
3095;"Gintarėlis (Didlaukio g. 35)";KIŠKUČIAI;3792697409;Taip;0;0;1;1
3096;"Gintarėlis (Didlaukio g. 35)";KIŠKUČIAI;6239242631;Taip;8;1;0;9
3097;"Gintarėlis (Didlaukio g. 35)";KIŠKUČIAI;4623909811;Taip;0;2;0;2
3098;"Gintarėlis (Didlaukio g. 35)";KIŠKUČIAI;3357866319;Ne;0;5;2;7
3099;"Gintarėlis (Didlaukio g. 35)";KIŠKUČIAI;8116557698;Ne;0;7;0;7
3100;"Gintarėlis (Didlaukio g. 35)";KIŠKUČIAI;8704248985;Taip;14;0;0;14
3101;"Gintarėlis (Didlaukio g. 35)";KIŠKUČIAI;5355691986;Taip;0;5;0;5
3102;"Gintarėlis (Didlaukio g. 35)";KIŠKUČIAI;5919205817;Taip;5;0;0;5
3103;"Gintarėlis (Didlaukio g. 35)";VYTURIUKAI;8768094601;Ne;0;1;0;1
3104;"Gintarėlis (Didlaukio g. 35)";VYTURIUKAI;5834772263;Taip;5;5;0;10
3105;"Gintarėlis (Didlaukio g. 35)";VYTURIUKAI;9533972547;Taip;4;0;2;6
3106;"Gintarėlis (Didlaukio g. 35)";BORUŽĖLĖS;6402043654;Taip;4;1;0;5
3107;"Gintarėlis (Didlaukio g. 35)";BORUŽĖLĖS;6558614008;Taip;10;3;0;13
3108;"Gintarėlis (Didlaukio g. 35)";BORUŽĖLĖS;4348245746;Taip;5;1;5;11
3109;"Gintarėlis (Didlaukio g. 35)";BORUŽĖLĖS;3091731769;Taip;0;1;0;1
3110;"Gintarėlis (Didlaukio g. 35)";BORUŽĖLĖS;6484966941;Taip;0;1;0;1
3111;"Gintarėlis (Didlaukio g. 35)";BORUŽĖLĖS;9004590065;Taip;8;2;1;11
3112;"Gintarėlis (Didlaukio g. 35)";BORUŽĖLĖS;2624469768;Taip;5;1;0;6
3113;"Gintarėlis (Didlaukio g. 35)";BORUŽĖLĖS;8784796186;Taip;0;2;0;2
3114;"Gintarėlis (Didlaukio g. 35)";BORUŽĖLĖS;3538300416;Taip;0;3;0;3
3115;"Gintarėlis (Didlaukio g. 35)";BORUŽĖLĖS;8516817506;Taip;0;6;0;6
3116;"Gintarėlis (Didlaukio g. 35)";BORUŽĖLĖS;3235154374;Taip;0;21;0;21
3117;"Gintarėlis (Didlaukio g. 35)";BORUŽĖLĖS;4809352525;Taip;0;2;0;2
3118;"Gintarėlis (Didlaukio g. 35)";BORUŽĖLĖS;7059730814;Taip;0;1;0;1
3119;"Gintarėlis (Didlaukio g. 35)";BORUŽĖLĖS;5965570522;Taip;0;1;0;1
3120;"Gintarėlis (Didlaukio g. 35)";BORUŽĖLĖS;9179216093;Taip;0;1;0;1
3121;"Gintarėlis (Didlaukio g. 35)";BORUŽĖLĖS;9970786396;Taip;3;3;0;6
3122;"Gintarėlis (Didlaukio g. 35)";BORUŽĖLĖS;7118758040;Taip;1;1;0;2
3123;"Gintarėlis (Didlaukio g. 35)";BORUŽĖLĖS;9622824643;Taip;19;0;0;19
3124;"Gintarėlis (Didlaukio g. 35)";BORUŽĖLĖS;9476258741;Ne;0;2;4;6
3125;"Gintarėlis (Didlaukio g. 35)";BORUŽĖLĖS;1400817076;Taip;8;1;0;9
3126;"Gintarėlis (Didlaukio g. 35)";BORUŽĖLĖS;1371258551;Taip;6;0;0;6
3127;"Gintarėlis (Didlaukio g. 35)";BORUŽĖLĖS;8410642485;Taip;3;3;2;8
3128;"Gintarėlis (Didlaukio g. 35)";BORUŽĖLĖS;9501012756;Taip;11;0;0;11
3129;"Gintarėlis (Didlaukio g. 35)";EŽIUKAI;4676321193;Taip;0;3;0;3
3130;"Gintarėlis (Didlaukio g. 35)";EŽIUKAI;4487346983;Taip;0;2;0;2
3131;"Gintarėlis (Didlaukio g. 35)";EŽIUKAI;2263102527;Taip;7;2;1;10
3132;"Gintarėlis (Didlaukio g. 35)";EŽIUKAI;7919771693;Taip;2;1;0;3
3133;"Gintarėlis (Didlaukio g. 35)";EŽIUKAI;9040480798;Taip;5;1;0;6
3134;"Gintarėlis (Didlaukio g. 35)";EŽIUKAI;8055928882;Taip;0;5;0;5
3135;"Gintarėlis (Didlaukio g. 35)";EŽIUKAI;5024727902;Taip;0;2;0;2
3136;"Gintarėlis (Didlaukio g. 35)";EŽIUKAI;2088008759;Taip;0;2;4;6
3137;"Gintarėlis (Didlaukio g. 35)";EŽIUKAI;3799412062;Taip;0;3;2;5
3138;"Gintarėlis (Didlaukio g. 35)";EŽIUKAI;6457288028;Taip;0;1;0;1
3139;"Gintarėlis (Didlaukio g. 35)";EŽIUKAI;4660854883;Taip;6;1;0;7
3140;"Gintarėlis (Didlaukio g. 35)";EŽIUKAI;94354056029;Taip;0;3;0;3
3141;"Gintarėlis (Didlaukio g. 35)";EŽIUKAI;1002155392;Taip;0;2;0;2
3142;"Gintarėlis (Didlaukio g. 35)";EŽIUKAI;9130659549;Taip;0;2;0;2
3143;"Gintarėlis (Didlaukio g. 35)";EŽIUKAI;2036488789;Taip;0;1;0;1
3144;"Gintarėlis (Didlaukio g. 35)";EŽIUKAI;7644607132;Taip;3;1;0;4
3145;"Gintarėlis (Didlaukio g. 35)";EŽIUKAI;7192722296;Taip;0;1;0;1
3146;"Gintarėlis (Didlaukio g. 35)";EŽIUKAI;2970527490;Ne;5;2;0;7
3147;"Gintarėlis (Didlaukio g. 35)";EŽIUKAI;1028456578;Taip;0;1;0;1
3148;"Gintarėlis (Didlaukio g. 35)";EŽIUKAI;1066741732;Taip;1;0;2;3
3149;"Gintarėlis (Didlaukio g. 35)";EŽIUKAI;1778573935;Taip;3;2;0;5
3150;"Gintarėlis (Didlaukio g. 35)";EŽIUKAI;9917367735;Taip;3;0;0;3
3151;"Gintarėlis (Didlaukio g. 35)";EŽIUKAI;4514340634;Ne;0;2;1;3
3152;"Gintarėlis (Didlaukio g. 35)";VIŠČIUKAI;1981825456;Taip;4;1;0;5
3153;"Gintarėlis (Didlaukio g. 35)";VIŠČIUKAI;3973889495;Taip;14;1;0;15
3154;"Gintarėlis (Didlaukio g. 35)";VIŠČIUKAI;4749559606;Taip;10;2;1;13
3155;"Gintarėlis (Didlaukio g. 35)";VIŠČIUKAI;4458703839;Ne;7;1;0;8
3156;"Gintarėlis (Didlaukio g. 35)";VIŠČIUKAI;2178808286;Taip;0;17;0;17
3157;"Gintarėlis (Didlaukio g. 35)";VIŠČIUKAI;9073499040;Taip;13;1;0;14
3158;"Gintarėlis (Didlaukio g. 35)";VIŠČIUKAI;6547060300;Taip;13;1;0;14
3159;"Gintarėlis (Didlaukio g. 35)";VIŠČIUKAI;5930354746;Taip;0;2;0;2
3160;"Gintarėlis (Didlaukio g. 35)";VIŠČIUKAI;4535071342;Taip;10;1;0;11
3161;"Gintarėlis (Didlaukio g. 35)";VIŠČIUKAI;8448725884;Taip;10;1;0;11
3162;"Gintarėlis (Didlaukio g. 35)";VIŠČIUKAI;6251670953;Taip;10;6;0;16
3163;"Gintarėlis (Didlaukio g. 35)";VIŠČIUKAI;8805356168;Taip;0;4;0;4
3164;"Gintarėlis (Didlaukio g. 35)";VIŠČIUKAI;4751066825;Taip;0;3;4;7
3165;"Gintarėlis (Didlaukio g. 35)";VIŠČIUKAI;1039098192;Taip;4;6;2;12
3166;"Gintarėlis (Didlaukio g. 35)";VIŠČIUKAI;6042885133;Taip;9;2;2;13
3167;"Gintarėlis (Didlaukio g. 35)";VIŠČIUKAI;7418672923;Taip;10;1;0;11
3168;"Gintarėlis (Didlaukio g. 35)";VIŠČIUKAI;7562170082;Taip;9;10;0;19
3169;"Gintarėlis (Didlaukio g. 35)";VIŠČIUKAI;1367305617;Taip;9;1;0;10
3170;"Gintarėlis (Didlaukio g. 35)";VIŠČIUKAI;6711773127;Taip;5;3;1;9
3171;"Gintarėlis (Didlaukio g. 35)";VIŠČIUKAI;7537009709;Taip;11;2;1;14
3172;"Gintarėlis (Didlaukio g. 35)";VIŠČIUKAI;9191264261;Taip;4;0;2;6
3173;"Gintarėlis (Didlaukio g. 35)";VIŠČIUKAI;2920734274;Taip;0;0;8;8
3174;"Gintarėlis (Didlaukio g. 35)";VIŠČIUKAI;3232990779;Taip;12;1;0;13
3175;"Gintarėlis (Didlaukio g. 35)";"SAULĖS ZUIKUČIAI";4278770021;Taip;0;2;0;2
3176;"Gintarėlis (Didlaukio g. 35)";"SAULĖS ZUIKUČIAI";9915228593;Taip;0;3;0;3
3177;"Gintarėlis (Didlaukio g. 35)";"SAULĖS ZUIKUČIAI";2499727321;Taip;7;2;0;9
3178;"Gintarėlis (Didlaukio g. 35)";"SAULĖS ZUIKUČIAI";2949035147;Taip;4;0;0;4
3179;"Gintarėlis (Didlaukio g. 35)";"SAULĖS ZUIKUČIAI";3839660368;Taip;0;6;0;6
3180;"Gintarėlis (Didlaukio g. 35)";"SAULĖS ZUIKUČIAI";5991638696;Taip;12;2;0;14
3181;"Gintarėlis (Didlaukio g. 35)";"SAULĖS ZUIKUČIAI";6563281778;Taip;0;5;0;5
3182;"Gintarėlis (Didlaukio g. 35)";"SAULĖS ZUIKUČIAI";6133476137;Taip;0;4;0;4
3183;"Gintarėlis (Didlaukio g. 35)";"SAULĖS ZUIKUČIAI";6751822184;Taip;5;2;0;7
3184;"Gintarėlis (Didlaukio g. 35)";"SAULĖS ZUIKUČIAI";8721340357;Taip;5;0;4;9
3185;"Gintarėlis (Didlaukio g. 35)";"SAULĖS ZUIKUČIAI";8403881160;Taip;5;6;0;11
3186;"Gintarėlis (Didlaukio g. 35)";"SAULĖS ZUIKUČIAI";5336654560;Taip;1;0;0;1
3187;"Gintarėlis (Didlaukio g. 35)";"SAULĖS ZUIKUČIAI";3732252177;Taip;1;0;0;1
3188;"Gintarėlis (Didlaukio g. 35)";"SAULĖS ZUIKUČIAI";4087751760;Taip;16;0;0;16
3189;"Gintarėlis (Didlaukio g. 35)";"SAULĖS ZUIKUČIAI";4462515146;Taip;10;0;0;10
3190;"Gintarėlis (Didlaukio g. 35)";"SAULĖS ZUIKUČIAI";6138593853;Taip;13;1;0;14
3191;"Gintarėlis (Didlaukio g. 35)";"SAULĖS ZUIKUČIAI";5338409090;Taip;0;1;0;1
3192;"Gintarėlis (Didlaukio g. 35)";"SAULĖS ZUIKUČIAI";7004430575;Taip;7;2;0;9
3193;"Gintarėlis (Didlaukio g. 35)";"SAULĖS ZUIKUČIAI";5509394003;Taip;5;0;5;10
3194;"Gintarėlis (Didlaukio g. 35)";"SAULĖS ZUIKUČIAI";1482227839;Taip;0;4;0;4
3195;"Gintarėlis (Didlaukio g. 35)";Pabiručiai;4757160835;Taip;0;0;1;1
3196;"Gintarėlis (Didlaukio g. 35)";Pabiručiai;1158055621;Taip;5;2;0;7
3197;"Gintarėlis (Didlaukio g. 35)";Pabiručiai;1474802737;Taip;5;3;1;9
3198;"Gintarėlis (Didlaukio g. 35)";Pabiručiai;6578588403;Taip;7;4;0;11
3199;"Gintarėlis (Didlaukio g. 35)";Šypsenėlės;3575375401;Taip;15;2;0;17
3200;"Gintarėlis (Didlaukio g. 35)";Šypsenėlės;3575375401;Taip;15;2;0;17
3201;"Gintarėlis (Didlaukio g. 35)";Šypsenėlės;3575375401;Taip;15;2;0;17
3202;"Gintarėlis (Didlaukio g. 35)";Šypsenėlės;9020619501;Taip;0;2;0;2
3203;"Gintarėlis (Didlaukio g. 35)";Šypsenėlės;2904118045;Taip;12;0;0;12
3204;"Gintarėlis (Didlaukio g. 35)";Šypsenėlės;5120761293;Taip;0;1;0;1
3205;"Gintarėlis (Didlaukio g. 35)";Šypsenėlės;9413836091;Taip;0;3;4;7
3206;"Gintarėlis (Didlaukio g. 35)";Šypsenėlės;7337543180;Taip;0;1;0;1
3207;"Gintarėlis (Didlaukio g. 35)";Šypsenėlės;7337543180;Taip;0;1;0;1
3208;"Gintarėlis (Didlaukio g. 35)";Šypsenėlės;7337543180;Taip;0;1;0;1
3209;"Gintarėlis (Didlaukio g. 35)";Šypsenėlės;1567290856;Taip;8;0;0;8
3210;"Gintarėlis (Didlaukio g. 35)";Šypsenėlės;7661638176;Ne;0;2;0;2
3211;"Gintarėlis (Didlaukio g. 35)";Šypsenėlės;9477018713;Taip;0;1;0;1
3212;"Gintarėlis (Didlaukio g. 35)";Šypsenėlės;9477018713;Taip;0;1;0;1
3213;"Gintarėlis (Didlaukio g. 35)";Šypsenėlės;9477018713;Taip;0;1;0;1
3214;"Gintarėlis (Didlaukio g. 35)";Šypsenėlės;3088663209;Taip;0;2;1;3
3215;"Gintarėlis (Didlaukio g. 35)";Šypsenėlės;3794027499;Taip;0;1;0;1
3216;"Gintarėlis (Didlaukio g. 35)";Šypsenėlės;9234476307;Taip;0;1;0;1
3217;"Gintarėlis (Didlaukio g. 35)";Šypsenėlės;6561070982;Taip;5;1;0;6
3218;"Gintarėlis (Didlaukio g. 35)";Šypsenėlės;2203238888;Taip;3;1;0;4
3219;"Gintarėlis (Didlaukio g. 35)";Šypsenėlės;3484172382;Taip;0;2;0;2
3220;"Gintarėlis (Didlaukio g. 35)";Šypsenėlės;2256002308;Taip;0;2;0;2
3221;"Gintarėlis (Didlaukio g. 35)";Šypsenėlės;6607854244;Taip;1;2;2;5
3222;"Gintarėlis (Didlaukio g. 35)";Šypsenėlės;1327681704;Taip;3;2;1;6
3223;"Gintarėlis (Didlaukio g. 35)";Šypsenėlės;3987801707;Taip;0;2;0;2
3224;"Gintarėlis (Didlaukio g. 35)";Šypsenėlės;7123016029;Ne;0;2;6;8
3225;"Gintarėlis (Didlaukio g. 35)";Šypsenėlės;3000371147;Taip;0;1;0;1
3226;"Gintarėlis (Didlaukio g. 35)";Šypsenėlės;5717123412;Ne;0;7;0;7
3227;"Gintarėlis (Didlaukio g. 35)";Šypsenėlės;1480486900;Ne;0;2;0;2
3228;"Gintarėlis (Didlaukio g. 35)";Smalsučiai;7486822380;Taip;0;2;1;3
3229;"Gintarėlis (Didlaukio g. 35)";Smalsučiai;8387819754;Taip;0;6;0;6
3230;"Gintarėlis (Didlaukio g. 35)";Smalsučiai;8292698645;Taip;5;2;0;7
3231;"Gintarėlis (Didlaukio g. 35)";Smalsučiai;1876292168;Taip;4;7;0;11
3232;"Gintarėlis (Didlaukio g. 35)";Smalsučiai;9980747501;Taip;2;0;0;2
3233;"Gintarėlis (Didlaukio g. 35)";Smalsučiai;8754068506;Ne;0;2;0;2
3234;"Gintarėlis (Didlaukio g. 35)";Smalsučiai;7690748176;Taip;1;1;0;2
3235;"Gintarėlis (Didlaukio g. 35)";Smalsučiai;8355089218;Taip;0;2;0;2
3236;"Gintarėlis (Didlaukio g. 35)";Kodėlčiukai;7976989629;Taip;5;0;0;5
3237;"Gintarėlis (Didlaukio g. 35)";Kodėlčiukai;8982034601;Taip;0;0;3;3
3238;"Gintarėlis (Didlaukio g. 35)";Kodėlčiukai;2234295991;Taip;0;4;0;4
3239;"Gintarėlis (Didlaukio g. 35)";Kodėlčiukai;6545866812;Taip;7;1;1;9
3240;"Gintarėlis (Didlaukio g. 35)";Kodėlčiukai;5467958458;Taip;0;2;0;2
3241;"Gintarėlis (Didlaukio g. 35)";Kodėlčiukai;5824210469;Taip;0;0;3;3
3242;"Gintarėlis (Didlaukio g. 35)";Kodėlčiukai;5202442681;Taip;4;0;0;4
3243;"Gintarėlis (Didlaukio g. 35)";Gintariukai;2809388552;Ne;7;0;1;8
3244;"Gintarėlis (Didlaukio g. 35)";Gintariukai;9374716095;Taip;7;0;0;7
3245;"Gintarėlis (Didlaukio g. 35)";Gintariukai;8815001033;Ne;3;1;0;4
3246;"Gintarėlis (Didlaukio g. 35)";Gintariukai;9787141660;Taip;5;0;2;7
3247;Giraitė;Aviliukas;4292730355;Taip;0;3;0;3
3248;Giraitė;Aviliukas;7001163828;Taip;0;1;0;1
3249;Giraitė;Aviliukas;5456658087;Ne;2;0;2;4
3250;Giraitė;Aviliukas;6159650070;Taip;2;1;0;3
3251;Giraitė;Aviliukas;5275912609;Taip;7;1;0;8
3252;Giraitė;Aviliukas;4758750245;Taip;14;0;0;14
3253;Giraitė;Aviliukas;2219854347;Taip;15;0;1;16
3254;Giraitė;Aviliukas;6315990604;Taip;9;0;0;9
3255;Giraitė;Aviliukas;2338867192;Taip;5;0;1;6
3256;Giraitė;Aviliukas;3719285343;Taip;5;0;7;12
3257;Giraitė;Aviliukas;3085107071;Taip;0;6;0;6
3258;Giraitė;Aviliukas;7807844145;Taip;1;0;0;1
3259;Giraitė;Aviliukas;3757900478;Taip;11;0;0;11
3260;Giraitė;Aviliukas;7876457529;Taip;0;1;2;3
3261;Giraitė;Aviliukas;3992069614;Taip;0;1;4;5
3262;Giraitė;Aviliukas;6121586335;Taip;0;0;9;9
3263;Giraitė;Aviliukas;4440444700;Taip;11;0;3;14
3264;Giraitė;Aviliukas;6296485105;Taip;1;0;2;3
3265;Giraitė;Aviliukas;5356944812;Taip;11;0;0;11
3266;Giraitė;Aviliukas;4554565631;Ne;3;1;0;4
3267;Giraitė;Aviliukas;2340866110;Taip;0;1;6;7
3268;Giraitė;LapiukaI;6141730004;Taip;15;1;0;16
3269;Giraitė;LapiukaI;6325909670;Taip;0;0;1;1
3270;Giraitė;LapiukaI;7831526566;Taip;6;0;0;6
3271;Giraitė;LapiukaI;2740656695;Taip;17;0;0;17
3272;Giraitė;LapiukaI;5030697729;Taip;5;1;0;6
3273;Giraitė;LapiukaI;1921430434;Taip;4;1;6;11
3274;Giraitė;LapiukaI;5006156109;Ne;0;1;0;1
3275;Giraitė;LapiukaI;4663343304;Taip;0;1;2;3
3276;Giraitė;LapiukaI;5382004098;Taip;9;1;0;10
3277;Giraitė;LapiukaI;4811513778;Ne;0;1;0;1
3278;Giraitė;LapiukaI;4296449093;Ne;0;2;0;2
3279;Giraitė;LapiukaI;1974159110;Taip;18;1;0;19
3280;Giraitė;LapiukaI;5532639133;Taip;4;1;0;5
3281;Giraitė;LapiukaI;4076402180;Taip;0;2;0;2
3282;Giraitė;LapiukaI;5902161665;Taip;0;6;0;6
3283;Giraitė;LapiukaI;4955786826;Taip;5;5;0;10
3284;Giraitė;LapiukaI;4260343903;Taip;1;0;0;1
3285;Giraitė;LapiukaI;9088123796;Taip;15;0;0;15
3286;Giraitė;LapiukaI;7772177095;Taip;7;1;0;8
3287;Giraitė;LapiukaI;8492822889;Ne;0;1;0;1
3288;Giraitė;LapiukaI;2880342138;Taip;0;0;5;5
3289;Giraitė;Voveriukai;7354834895;Taip;6;0;0;6
3290;Giraitė;Voveriukai;4387282125;Taip;5;2;0;7
3291;Giraitė;Voveriukai;6265908751;Taip;7;1;0;8
3292;Giraitė;Voveriukai;4822168634;Taip;6;0;0;6
3293;Giraitė;Voveriukai;2074303013;Taip;0;1;0;1
3294;Giraitė;Voveriukai;3875214088;Taip;7;6;0;13
3295;Giraitė;Voveriukai;5202562049;Taip;0;2;0;2
3296;Giraitė;Voveriukai;7441871219;Taip;7;1;0;8
3297;Giraitė;Voveriukai;7481895278;Taip;4;0;1;5
3298;Giraitė;Voveriukai;3607198556;Taip;0;5;0;5
3299;Giraitė;Voveriukai;1945918102;Taip;11;1;0;12
3300;Giraitė;Voveriukai;8799195526;Taip;7;0;0;7
3301;Giraitė;Voveriukai;6225092500;Taip;0;0;1;1
3302;Giraitė;Voveriukai;4137699629;Taip;0;0;2;2
3303;Giraitė;Voveriukai;4932174149;Ne;0;0;1;1
3304;Giraitė;Voveriukai;3896789232;Taip;0;0;1;1
3305;Giraitė;Voveriukai;7919088987;Taip;0;1;0;1
3306;Giraitė;Voveriukai;5616242311;Taip;0;1;0;1
3307;Giraitė;Voveriukai;7739516049;Taip;0;1;0;1
3308;Giraitė;Voveriukai;4773517160;Taip;14;0;0;14
3309;Giraitė;Voveriukai;2177856916;Taip;7;1;0;8
3310;Giraitė;Grybukai;2990968206;Taip;0;1;1;2
3311;Giraitė;Grybukai;1312761239;Taip;0;4;0;4
3312;Giraitė;Grybukai;5721669627;Taip;0;1;3;4
3313;Giraitė;Grybukai;4839351300;Taip;0;4;0;4
3314;Giraitė;Grybukai;9495968363;Taip;0;1;0;1
3315;Giraitė;Grybukai;1253151830;Taip;0;1;0;1
3316;Giraitė;Grybukai;9224845723;Taip;0;1;0;1
3317;Giraitė;Grybukai;4687228561;Taip;6;0;0;6
3318;Giraitė;Grybukai;9882372025;Taip;6;0;0;6
3319;Giraitė;Grybukai;5167002022;Taip;6;0;0;6
3320;Giraitė;Grybukai;8596389737;Taip;0;5;1;6
3321;Giraitė;Grybukai;1111614295;Taip;0;1;0;1
3322;Giraitė;Grybukai;8869728241;Taip;0;0;2;2
3323;Giraitė;Grybukai;3683700626;Taip;5;3;0;8
3324;Giraitė;Grybukai;9026736929;Taip;0;2;0;2
3325;Giraitė;Riešutėliai;5365264259;Taip;0;2;0;2
3326;Giraitė;Riešutėliai;7179656901;Ne;5;1;0;6
3327;Giraitė;Riešutėliai;3158451613;Taip;6;1;0;7
3328;Giraitė;Riešutėliai;7910736839;Taip;6;0;0;6
3329;Giraitė;Riešutėliai;3308792461;Taip;6;0;0;6
3330;Giraitė;Riešutėliai;7423115504;Taip;5;0;0;5
3331;Giraitė;Riešutėliai;7580600719;Ne;6;0;0;6
3332;Giraitė;Riešutėliai;6838184704;Taip;7;5;0;12
3333;Giraitė;Riešutėliai;5148257412;Taip;8;1;0;9
3334;Giraitė;Riešutėliai;7566944002;Taip;11;0;0;11
3335;Giraitė;Riešutėliai;3839432744;Taip;5;1;0;6
3336;Giraitė;Riešutėliai;7803047658;Taip;0;1;0;1
3337;Giraitė;Riešutėliai;7113991095;Taip;0;1;0;1
3338;Giraitė;Riešutėliai;9144465313;Taip;0;1;0;1
3339;Giraitė;Riešutėliai;6288016799;Taip;15;1;0;16
3340;Giraitė;Riešutėliai;3278871662;Taip;6;1;0;7
3341;Giraitė;Riešutėliai;4168934880;Taip;0;1;0;1
3342;Giraitė;Riešutėliai;6337090583;Taip;9;0;0;9
3343;Giraitė;Riešutėliai;3843211767;Taip;0;4;1;5
3344;Giraitė;Meškiukai;27501094616;Taip;0;1;0;1
3345;Giraitė;Meškiukai;2513312448;Taip;0;2;0;2
3346;Giraitė;Meškiukai;5367392810;Taip;0;2;0;2
3347;Giraitė;Meškiukai;5461837332;Taip;0;1;0;1
3348;Giraitė;Meškiukai;1355594003;Ne;0;1;0;1
3349;Giraitė;Meškiukai;1560868105;Taip;3;0;0;3
3350;Giraitė;Meškiukai;1050699551;Taip;1;5;0;6
3351;Giraitė;Meškiukai;1876815077;Taip;0;1;0;1
3352;Giraitė;Meškiukai;1063628206;Taip;5;1;0;6
3353;Giraitė;Meškiukai;9195735923;Taip;0;1;0;1
3354;Giraitė;Meškiukai;65251975467;Taip;0;1;0;1
3355;Giraitė;Meškiukai;1704154980;Taip;5;1;4;10
3356;Giraitė;Meškiukai;1819657811;Taip;0;1;0;1
3357;Giraitė;Meškiukai;2571892050;Taip;0;1;8;9
3358;Giraitė;Meškiukai;6156715234;Taip;0;5;1;6
3359;Giraitė;Meškiukai;1594965200;Taip;0;0;5;5
3360;Giraitė;Meškiukai;9723242940;Taip;3;1;0;4
3361;Giraitė;Meškiukai;5726182600;Taip;2;7;0;9
3362;Giraitė;Meškiukai;1772790396;Ne;8;0;0;8
3363;Giraitė;Meškiukai;2551280794;Taip;5;3;0;8
3364;Giraitė;Uogelės;8908602761;Taip;3;1;0;4
3365;Giraitė;Uogelės;4717851198;Taip;5;1;2;8
3366;Giraitė;Uogelės;1729871315;Taip;0;2;0;2
3367;Giraitė;Uogelės;9503157590;Taip;3;1;1;5
3368;Giraitė;Uogelės;4317544803;Taip;5;1;0;6
3369;Giraitė;Uogelės;9927102264;Taip;6;0;1;7
3370;Giraitė;Uogelės;4843415587;Taip;0;1;0;1
3371;Giraitė;Uogelės;5471577047;Taip;5;1;0;6
3372;Giraitė;Uogelės;2732715332;Taip;0;1;0;1
3373;Giraitė;Uogelės;2307307454;Taip;5;0;0;5
3374;Giraitė;Uogelės;2102237550;Taip;0;2;2;4
3375;Giraitė;Uogelės;6065010363;Taip;0;1;0;1
3376;Giraitė;Uogelės;5255040944;Taip;0;1;0;1
3377;Giraitė;Uogelės;7094750784;Taip;0;7;0;7
3378;Giraitė;Uogelės;1356340471;Taip;2;6;1;9
3379;Giraitė;Uogelės;7377939409;Ne;0;2;0;2
3380;Giraitė;Uogelės;4288937528;Taip;10;0;1;11
3381;Giraitė;Uogelės;6293111179;Taip;10;3;0;13
3382;Giraitė;Uogelės;7390702355;Taip;8;0;3;11
3383;Giraitė;Šaltinėlis;5876711899;Taip;0;0;1;1
3384;Giraitė;Šaltinėlis;8427713392;Taip;5;0;3;8
3385;Giraitė;Šaltinėlis;3612494313;Taip;0;0;6;6
3386;Giraitė;Šaltinėlis;2076989836;Taip;18;0;0;18
3387;Giraitė;Šaltinėlis;9589760939;Taip;17;0;0;17
3388;Giraitė;Šaltinėlis;4500393769;Taip;8;1;0;9
3389;Giraitė;Šaltinėlis;3144724475;Ne;0;0;3;3
3390;Giraitė;Šaltinėlis;5525538498;Taip;7;0;3;10
3391;Giraitė;Šaltinėlis;6799728348;Taip;13;0;8;21
3392;Giraitė;Šaltinėlis;4431964254;Taip;10;0;0;10
3393;Giraitė;Šaltinėlis;4946664007;Taip;18;0;1;19
3394;Giraitė;Šaltinėlis;1170698327;Taip;4;4;0;8
3395;Giraitė;Šaltinėlis;6865072274;Taip;16;0;0;16
3396;Giraitė;Šaltinėlis;3108521607;Taip;7;0;4;11
3397;Giraitė;Šaltinėlis;8139743188;Ne;8;1;0;9
3398;Giraitė;Šaltinėlis;2867735227;Ne;6;0;1;7
3399;Giraitė;Šaltinėlis;9669849051;Taip;5;0;1;6
3400;Giraitė;Boružėlės;6378362980;Taip;10;0;1;11
3401;Giraitė;Boružėlės;8612554184;Taip;16;0;0;16
3402;Giraitė;Boružėlės;1436302175;Taip;5;0;1;6
3403;Giraitė;Boružėlės;2064019596;Taip;2;2;0;4
3404;Giraitė;Boružėlės;3346193393;Taip;12;0;1;13
3405;Giraitė;Boružėlės;7260229442;Taip;10;0;1;11
3406;Giraitė;Boružėlės;1126576745;Taip;6;0;0;6
3407;Giraitė;Boružėlės;1772997796;Taip;6;0;0;6
3408;Giraitė;Boružėlės;9281071794;Taip;16;0;0;16
3409;Giraitė;Boružėlės;9386943162;Taip;3;0;3;6
3410;Giraitė;Boružėlės;4749790368;Taip;11;0;2;13
3411;Giraitė;Boružėlės;3039445733;Taip;9;0;0;9
3412;Giraitė;Boružėlės;4719547384;Taip;6;0;0;6
3413;Giraitė;Boružėlės;4008393576;Taip;8;1;1;10
3414;Giraitė;Boružėlės;9766107773;Taip;6;1;0;7
3415;Giraitė;Gandriukai;4680913596;Taip;0;0;1;1
3416;Giraitė;Gandriukai;3643426944;Taip;6;0;2;8
3417;Giraitė;Gandriukai;8525380061;Taip;14;0;0;14
3418;Giraitė;Gandriukai;4851987149;Ne;14;0;0;14
3419;Giraitė;Gandriukai;2205108811;Taip;5;0;1;6
3420;Giraitė;Gandriukai;7008670489;Taip;4;1;1;6
3421;Giraitė;Gandriukai;6277788515;Taip;0;1;1;2
3422;Giraitė;Gandriukai;7767820565;Ne;0;0;4;4
3423;Giraitė;Gandriukai;8819218663;Taip;10;1;0;11
3424;Giraitė;Gandriukai;7269074498;Taip;1;0;1;2
3425;Giraitė;Gandriukai;1490748887;Ne;10;0;1;11
3426;Giraitė;Gandriukai;7789414361;Taip;11;0;0;11
3427;Giraitė;Gandriukai;9850432917;Taip;17;0;0;17
3428;Giraitė;Gandriukai;2313273738;Taip;11;0;0;11
3429;Giraitė;Gandriukai;9625436756;Taip;2;1;0;3
3430;Giraitė;Gandriukai;8101302584;Taip;17;0;0;17
3431;Giraitė;Gandriukai;9307640828;Taip;1;4;0;5
3432;Giraitė;Gandriukai;3027761044;Taip;15;0;0;15
3433;Giraitė;Gandriukai;1125863541;Taip;0;1;1;2
3434;Giraitė;Gandriukai;4371263826;Taip;14;1;0;15
3435;Giraitė;ŽVIRBLIUKAI;6715354865;Taip;9;1;0;10
3436;Giraitė;ŽVIRBLIUKAI;8461725999;Taip;0;0;3;3
3437;Giraitė;ŽVIRBLIUKAI;7395332578;Taip;1;0;0;1
3438;Giraitė;ŽVIRBLIUKAI;5086296808;Taip;0;11;0;11
3439;Giraitė;ŽVIRBLIUKAI;9669916418;Taip;5;0;8;13
3440;Giraitė;ŽVIRBLIUKAI;3481695682;Taip;9;0;0;9
3441;Giraitė;ŽVIRBLIUKAI;7551981095;Taip;0;1;0;1
3442;Giraitė;ŽVIRBLIUKAI;7678134658;Taip;0;1;1;2
3443;Giraitė;ŽVIRBLIUKAI;9471560738;Taip;0;4;0;4
3444;Giraitė;ŽVIRBLIUKAI;6677278422;Taip;6;0;0;6
3445;Giraitė;ŽVIRBLIUKAI;7230351549;Taip;1;0;2;3
3446;Giraitė;ŽVIRBLIUKAI;9728453316;Taip;0;1;1;2
3447;Giraitė;ŽVIRBLIUKAI;9114364139;Taip;0;1;0;1
3448;Giraitė;ŽVIRBLIUKAI;2416162886;Taip;4;0;7;11
3449;Giraitė;ŽVIRBLIUKAI;7543605905;Taip;8;5;1;14
3450;Giraitė;ŽVIRBLIUKAI;8128401630;Taip;6;0;0;6
3451;Giraitė;ŽVIRBLIUKAI;4233170371;Taip;10;0;0;10
3452;Giraitė;ŽVIRBLIUKAI;8871979627;Ne;0;1;1;2
3453;Giraitė;ŽVIRBLIUKAI;3214528809;Taip;0;6;0;6
3454;Giraitė;ŽVIRBLIUKAI;5548434439;Taip;0;0;1;1
3455;Giraitė;ŽVIRBLIUKAI;6474975269;Taip;0;0;1;1
3456;Giraitė;Kiškeliai;1227555563;Taip;6;0;1;7
3457;Giraitė;Kiškeliai;3613828494;Taip;8;0;4;12
3458;Giraitė;Kiškeliai;5447466102;Taip;4;3;3;10
3459;Giraitė;Kiškeliai;2686885139;Taip;6;0;0;6
3460;Giraitė;Kiškeliai;9764802294;Taip;10;0;1;11
3461;Giraitė;Kiškeliai;5574589536;Taip;11;0;0;11
3462;Giraitė;Kiškeliai;2726766768;Taip;8;0;3;11
3463;Giraitė;Kiškeliai;4927582548;Taip;6;0;9;15
3464;Giraitė;Kiškeliai;6565165993;Ne;0;0;3;3
3465;Giraitė;Kiškeliai;1456726379;Ne;5;0;2;7
3466;Giraitė;Kiškeliai;7744101334;Ne;4;0;0;4
3467;Giraitė;Kiškeliai;9751078590;Taip;9;0;1;10
3468;Gudrutis;Gandriukų;2197278086;Taip;0;3;0;3
3469;Gudrutis;Gandriukų;6358318238;Taip;0;2;2;4
3470;Gudrutis;Gandriukų;7942601528;Taip;0;2;1;3
3471;Gudrutis;Gandriukų;1701035039;Taip;0;1;0;1
3472;Gudrutis;Gandriukų;4844838728;Taip;6;0;3;9
3473;Gudrutis;Gandriukų;1685531183;Taip;5;0;2;7
3474;Gudrutis;Gandriukų;9253468183;Taip;7;2;1;10
3475;Gudrutis;Gandriukų;1051407930;Taip;0;0;3;3
3476;Gudrutis;Gandriukų;7755882832;Taip;0;2;0;2
3477;Gudrutis;Gandriukų;2487363252;Taip;0;1;4;5
3478;Gudrutis;Gandriukų;7663746093;Taip;10;1;1;12
3479;Gudrutis;Gandriukų;1012579870;Taip;1;2;1;4
3480;Gudrutis;Gandriukų;8512130106;Taip;0;2;2;4
3481;Gudrutis;Gandriukų;3919786807;Taip;6;2;3;11
3482;Gudrutis;Gandriukų;2630768189;Taip;0;0;7;7
3483;Gudrutis;Gandriukų;8165828215;Taip;8;1;0;9
3484;Gudrutis;Gandriukų;1485530468;Taip;5;0;7;12
3485;Gudrutis;Gandriukų;5508723821;Taip;7;4;0;11
3486;Gudrutis;Gandriukų;9044566825;Ne;4;1;0;5
3487;Gudrutis;Gandriukų;8774935740;Ne;5;1;1;7
3488;Gudrutis;Gandriukų;9297898193;Taip;0;21;0;21
3489;Gudrutis;Gandriukų;9784116399;Ne;12;0;0;12
3490;Gudrutis;"Saulės zuikučių";7934673005;Taip;0;0;2;2
3491;Gudrutis;"Saulės zuikučių";2199222671;Taip;0;0;5;5
3492;Gudrutis;"Saulės zuikučių";1587454709;Taip;0;1;0;1
3493;Gudrutis;"Saulės zuikučių";1670550212;Taip;0;1;4;5
3494;Gudrutis;"Saulės zuikučių";5241856014;Taip;6;0;0;6
3495;Gudrutis;"Saulės zuikučių";1225698076;Taip;8;0;0;8
3496;Gudrutis;"Saulės zuikučių";8500911420;Ne;0;0;5;5
3497;Gudrutis;"Saulės zuikučių";5408444872;Taip;0;1;3;4
3498;Gudrutis;"Saulės zuikučių";5728436444;Taip;0;1;1;2
3499;Gudrutis;"Saulės zuikučių";8621229735;Taip;0;0;2;2
3500;Gudrutis;"Saulės zuikučių";8240340213;Taip;0;1;3;4
3501;Gudrutis;"Saulės zuikučių";6846653547;Taip;0;5;2;7
3502;Gudrutis;"Saulės zuikučių";3281890659;Taip;0;5;0;5
3503;Gudrutis;"Saulės zuikučių";5585248878;Ne;0;4;2;6
3504;Gudrutis;"Saulės zuikučių";1384696362;Taip;0;0;6;6
3505;Gudrutis;"Saulės zuikučių";2666772437;Taip;5;0;1;6
3506;Gudrutis;"Saulės zuikučių";2994309084;Ne;0;0;1;1
3507;Gudrutis;"Saulės zuikučių";3743529726;Ne;0;0;6;6
3508;Gudrutis;Pelėdžiukų;2293472716;Taip;0;0;4;4
3509;Gudrutis;Pelėdžiukų;6835038962;Ne;0;0;10;10
3510;Gudrutis;Pelėdžiukų;6731806925;Taip;0;1;0;1
3511;Gudrutis;Pelėdžiukų;2118727861;Taip;4;0;2;6
3512;Gudrutis;Pelėdžiukų;9701111916;Ne;1;0;6;7
3513;Gudrutis;Pelėdžiukų;1725920873;Taip;0;1;4;5
3514;Gudrutis;Pelėdžiukų;1901358996;Taip;0;0;11;11
3515;Gudrutis;Pelėdžiukų;7664517480;Taip;0;0;2;2
3516;Gudrutis;Pelėdžiukų;9847597133;Taip;0;2;0;2
3517;Gudrutis;Pelėdžiukų;6198012431;Taip;5;1;0;6
3518;Gudrutis;Pelėdžiukų;3646335609;Taip;0;0;4;4
3519;Gudrutis;Pelėdžiukų;7871991275;Taip;0;0;3;3
3520;Gudrutis;Pelėdžiukų;5580618896;Taip;0;0;3;3
3521;Gudrutis;Pelėdžiukų;2468434676;Taip;4;0;3;7
3522;Gudrutis;Pelėdžiukų;3625838131;Taip;0;1;0;1
3523;Gudrutis;Pelėdžiukų;2337493193;Taip;0;1;0;1
3524;Gudrutis;Pelėdžiukų;2408038213;Taip;4;1;2;7
3525;Gudrutis;Pelėdžiukų;2764843216;Taip;4;1;0;5
3526;Gudrutis;Pelėdžiukų;7955353991;Taip;0;2;0;2
3527;Gudrutis;BITUČIŲ;6742455931;Ne;0;11;0;11
3528;Gudrutis;BITUČIŲ;4193661251;Taip;0;2;0;2
3529;Gudrutis;BITUČIŲ;7443277768;Taip;11;1;0;12
3530;Gudrutis;BITUČIŲ;9797417587;Taip;0;1;0;1
3531;Gudrutis;BITUČIŲ;5574287734;Ne;0;1;1;2
3532;Gudrutis;BITUČIŲ;2431077357;Taip;4;1;0;5
3533;Gudrutis;BITUČIŲ;7116979528;Ne;5;1;2;8
3534;Gudrutis;BITUČIŲ;1228190677;Taip;0;1;2;3
3535;Gudrutis;BITUČIŲ;6700254479;Taip;0;1;1;2
3536;Gudrutis;BITUČIŲ;1693306014;Taip;0;1;0;1
3537;Gudrutis;BITUČIŲ;8398961969;Taip;0;2;0;2
3538;Gudrutis;BITUČIŲ;2074151024;Taip;1;0;0;1
3539;Gudrutis;BITUČIŲ;1991658503;Taip;0;1;0;1
3540;Gudrutis;BITUČIŲ;2592224860;Taip;0;4;0;4
3541;Gudrutis;BITUČIŲ;9841172472;Taip;0;1;2;3
3542;Gudrutis;BITUČIŲ;3359028602;Taip;0;1;0;1
3543;Gudrutis;BITUČIŲ;4945755164;Taip;0;2;2;4
3544;Gudrutis;BITUČIŲ;6443631536;Taip;0;1;0;1
3545;Gudrutis;BITUČIŲ;3363824185;Taip;0;1;0;1
3546;Gudrutis;BITUČIŲ;7773150642;Taip;0;1;0;1
3547;Gudrutis;Boružėlių;2497248749;Taip;16;0;0;16
3548;Gudrutis;Boružėlių;6284712576;Taip;8;0;1;9
3549;Gudrutis;Boružėlių;9096764346;Taip;21;0;0;21
3550;Gudrutis;Boružėlių;5306281458;Taip;0;0;11;11
3551;Gudrutis;Boružėlių;8783180638;Taip;0;0;11;11
3552;Gudrutis;Boružėlių;8525851058;Taip;8;0;3;11
3553;Gudrutis;Boružėlių;8080976400;Taip;4;0;0;4
3554;Gudrutis;Boružėlių;9808350750;Taip;0;1;0;1
3555;Gudrutis;Boružėlių;6101410750;Taip;0;2;0;2
3556;Gudrutis;Boružėlių;5710348070;Taip;10;0;3;13
3557;Gudrutis;Boružėlių;8843761360;Taip;10;0;3;13
3558;Gudrutis;Boružėlių;5590297232;Taip;2;0;3;5
3559;Gudrutis;Boružėlių;2145834885;Taip;0;0;13;13
3560;Gudrutis;Boružėlių;2827279258;Taip;1;0;3;4
3561;Gudrutis;Boružėlių;5093267385;Taip;10;1;2;13
3562;Gudrutis;Boružėlių;1364145110;Taip;11;0;0;11
3563;Gudrutis;Boružėlių;1737001982;Taip;4;1;0;5
3564;Gudrutis;Drugeliai;7930414623;Taip;9;0;1;10
3565;Gudrutis;Drugeliai;6458053920;Taip;0;2;0;2
3566;Gudrutis;Drugeliai;5498218329;Taip;0;3;0;3
3567;Gudrutis;Drugeliai;4600814480;Taip;0;1;0;1
3568;Gudrutis;Drugeliai;9454206104;Taip;6;2;1;9
3569;Gudrutis;Drugeliai;5054363773;Taip;8;1;2;11
3570;Gudrutis;Drugeliai;7531077386;Taip;0;1;0;1
3571;Gudrutis;Drugeliai;5931281687;Taip;5;0;3;8
3572;Gudrutis;Drugeliai;3264829331;Taip;13;1;0;14
3573;Gudrutis;Drugeliai;7143849852;Ne;9;1;0;10
3574;Gudrutis;Drugeliai;3760014407;Taip;0;2;2;4
3575;Gudrutis;Drugeliai;1588396018;Taip;4;1;0;5
3576;Gudrutis;Drugeliai;3316297441;Taip;6;2;0;8
3577;Gudrutis;Drugeliai;6307643172;Taip;0;0;7;7
3578;Gudrutis;Drugeliai;2256458624;Taip;8;1;0;9
3579;Gudrutis;Drugeliai;2278368966;Taip;3;1;1;5
3580;Gudrutis;Drugeliai;5911423362;Taip;14;0;0;14
3581;Gudrutis;Drugeliai;3000289515;Taip;1;0;0;1
3582;Gudrutis;Drugeliai;2784392885;Taip;4;12;0;16
3583;Gudrutis;Drugeliai;1170008457;Taip;5;12;1;18
3584;Jurginėlis;Ąžuoliukai;7309052653;Taip;0;0;8;8
3585;Jurginėlis;Ąžuoliukai;2501462080;Taip;0;0;1;1
3586;Jurginėlis;Ąžuoliukai;8571054905;Taip;3;0;0;3
3587;Jurginėlis;Ąžuoliukai;8969526123;Taip;2;0;0;2
3588;Jurginėlis;Ąžuoliukai;6168508647;Taip;13;0;1;14
3589;Jurginėlis;Ąžuoliukai;5861832676;Taip;0;0;4;4
3590;Jurginėlis;Ąžuoliukai;3933113321;Taip;0;16;0;16
3591;Jurginėlis;Ąžuoliukai;5861418459;Taip;0;5;0;5
3592;Jurginėlis;Ąžuoliukai;5869170503;Taip;0;0;1;1
3593;Jurginėlis;Ąžuoliukai;6202225321;Taip;3;0;4;7
3594;Jurginėlis;Ąžuoliukai;7081618073;Taip;0;1;2;3
3595;Jurginėlis;Ąžuoliukai;9029587175;Taip;0;4;0;4
3596;Jurginėlis;Ąžuoliukai;9889620429;Taip;0;3;0;3
3597;Jurginėlis;Ąžuoliukai;3324811458;Taip;0;1;0;1
3598;Jurginėlis;Ąžuoliukai;6153432639;Taip;0;1;0;1
3599;Jurginėlis;Ąžuoliukai;8310464710;Taip;0;0;6;6
3600;Jurginėlis;Ąžuoliukai;8174251359;Ne;0;0;10;10
3601;Jurginėlis;Ąžuoliukai;2447025385;Taip;17;0;1;18
3602;Jurginėlis;Ąžuoliukai;5313627252;Taip;0;0;9;9
3603;Jurginėlis;Žiogeliai;8159210242;Taip;0;12;0;12
3604;Jurginėlis;Žiogeliai;9934831745;Ne;11;0;0;11
3605;Jurginėlis;Žiogeliai;7251598691;Taip;21;0;0;21
3606;Jurginėlis;Žiogeliai;3083045137;Taip;6;8;0;14
3607;Jurginėlis;Žiogeliai;6906225772;Ne;11;2;0;13
3608;Jurginėlis;Žiogeliai;7010130915;Taip;0;0;3;3
3609;Jurginėlis;Žiogeliai;7907096012;Taip;6;4;0;10
3610;Jurginėlis;Žiogeliai;7250246853;Taip;0;4;0;4
3611;Jurginėlis;Žiogeliai;4110053674;Ne;16;5;0;21
3612;Jurginėlis;Žiogeliai;5160581631;Ne;1;0;0;1
3613;Jurginėlis;Žiogeliai;6438669072;Taip;5;0;0;5
3614;Jurginėlis;Žiogeliai;5037980414;Ne;0;5;1;6
3615;Jurginėlis;Žiogeliai;7300018733;Taip;0;3;0;3
3616;Jurginėlis;Žiogeliai;4674128568;Taip;0;1;0;1
3617;Jurginėlis;Žiogeliai;9305884152;Ne;15;2;0;17
3618;Jurginėlis;Žiogeliai;9716328349;Taip;12;9;0;21
3619;Jurginėlis;Žiogeliai;4441183185;Taip;4;1;1;6
3620;Jurginėlis;Žiogeliai;4502564783;Taip;9;0;0;9
3621;Jurginėlis;Žiogeliai;1937927553;Ne;3;1;0;4
3622;Jurginėlis;Žiogeliai;7527178332;Taip;6;1;0;7
3623;Jurginėlis;Žiogeliai;4682125116;Taip;0;1;0;1
3624;Jurginėlis;Žiogeliai;3920971621;Taip;8;0;0;8
3625;Jurginėlis;Pelėdžiukų;5984893389;Taip;0;2;0;2
3626;Jurginėlis;Pelėdžiukų;3079495897;Ne;8;2;0;10
3627;Jurginėlis;Pelėdžiukų;8727844649;Taip;0;0;8;8
3628;Jurginėlis;Pelėdžiukų;1455749921;Taip;0;5;0;5
3629;Jurginėlis;Pelėdžiukų;7809274980;Taip;0;1;1;2
3630;Jurginėlis;Pelėdžiukų;2417314519;Taip;0;3;0;3
3631;Jurginėlis;Pelėdžiukų;6968528293;Taip;0;3;0;3
3632;Jurginėlis;Pelėdžiukų;4292932046;Taip;10;0;0;10
3633;Jurginėlis;Pelėdžiukų;8779807396;Taip;6;1;0;7
3634;Jurginėlis;Pelėdžiukų;8443412187;Taip;6;1;1;8
3635;Jurginėlis;Pelėdžiukų;4967548277;Taip;0;14;1;15
3636;Jurginėlis;Pelėdžiukų;2925253653;Taip;0;6;0;6
3637;Jurginėlis;Pelėdžiukų;1340689348;Ne;5;2;0;7
3638;Jurginėlis;Pelėdžiukų;2221708420;Taip;0;1;1;2
3639;Jurginėlis;Pelėdžiukų;6181547354;Taip;10;3;0;13
3640;Jurginėlis;Pelėdžiukų;2490875633;Taip;11;1;0;12
3641;Jurginėlis;Pelėdžiukų;9760394658;Ne;17;0;0;17
3642;Jurginėlis;Pelėdžiukų;3786379532;Ne;5;1;0;6
3643;Jurginėlis;Boružėlių;4295285885;Taip;0;2;0;2
3644;Jurginėlis;Boružėlių;8920304044;Taip;0;2;0;2
3645;Jurginėlis;Boružėlių;2171115974;Ne;8;1;0;9
3646;Jurginėlis;Boružėlių;3027573572;Taip;0;3;0;3
3647;Jurginėlis;Boružėlių;8338173095;Ne;19;1;0;20
3648;Jurginėlis;Boružėlių;1758862051;Taip;0;6;0;6
3649;Jurginėlis;Boružėlių;1467200002;Ne;8;1;0;9
3650;Jurginėlis;Boružėlių;4851923549;Taip;0;1;0;1
3651;Jurginėlis;Boružėlių;6111863896;Taip;0;10;0;10
3652;Jurginėlis;Boružėlių;1701720412;Taip;0;1;0;1
3653;Jurginėlis;Boružėlių;1563317396;Taip;0;4;0;4
3654;Jurginėlis;Boružėlių;2133447073;Taip;0;1;0;1
3655;Jurginėlis;Boružėlių;47243459592;Taip;6;2;0;8
3656;Jurginėlis;Boružėlių;8784076886;Taip;4;1;0;5
3657;Jurginėlis;Boružėlių;2446630485;Taip;10;1;0;11
3658;Jurginėlis;Boružėlių;1829089083;Taip;4;2;0;6
3659;Jurginėlis;Boružėlių;1361108271;Ne;5;1;0;6
3660;Jurginėlis;Boružėlių;5386710069;Ne;5;4;0;9
3661;Jurginėlis;Boružėlių;8972814655;Taip;0;1;0;1
3662;Jurginėlis;Boružėlių;4852619394;Taip;0;1;0;1
3663;Jurginėlis;Bitučių;9589394406;Ne;0;1;1;2
3664;Jurginėlis;Bitučių;1927843089;Taip;10;1;0;11
3665;Jurginėlis;Bitučių;3708774681;Taip;0;11;0;11
3666;Jurginėlis;Bitučių;6413324051;Taip;0;6;0;6
3667;Jurginėlis;Bitučių;2639125463;Taip;0;0;4;4
3668;Jurginėlis;Bitučių;1787311340;Taip;0;2;0;2
3669;Jurginėlis;Bitučių;7297672386;Taip;0;1;0;1
3670;Jurginėlis;Bitučių;1586599624;Taip;0;1;0;1
3671;Jurginėlis;Bitučių;2710889915;Taip;0;2;0;2
3672;Jurginėlis;Bitučių;1983924909;Taip;0;1;0;1
3673;Jurginėlis;Bitučių;1175441410;Taip;0;1;0;1
3674;Jurginėlis;Bitučių;1082593212;Taip;0;1;0;1
3675;Jurginėlis;Bitučių;4806248290;Taip;0;3;5;8
3676;Jurginėlis;Bitučių;903039398;Taip;0;1;0;1
3677;Jurginėlis;Bitučių;9646318532;Taip;0;1;0;1
3678;Jurginėlis;Bitučių;8227660508;Taip;0;1;0;1
3679;Jurginėlis;Bitučių;77480957625;Taip;0;1;0;1
3680;Jurginėlis;Bitučių;1547101731;Taip;0;1;0;1
3681;Jurginėlis;Bitučių;2624313807;Ne;2;1;0;3
3682;Jurginėlis;Bitučių;7928799065;Taip;8;1;0;9
3683;Jurginėlis;Bitučių;5892180334;Taip;0;1;0;1
3684;Jurginėlis;Bitučių;3018576350;Ne;6;1;0;7
3685;Jurginėlis;Skruzdeliukų;9146039217;Taip;3;1;0;4
3686;Jurginėlis;Skruzdeliukų;1885598986;Ne;0;1;0;1
3687;Jurginėlis;Skruzdeliukų;3558752347;Taip;0;2;0;2
3688;Jurginėlis;Skruzdeliukų;5734506036;Ne;0;6;0;6
3689;Jurginėlis;Skruzdeliukų;3699180485;Taip;0;1;0;1
3690;Jurginėlis;Skruzdeliukų;4981043400;Taip;2;0;0;2
3691;Jurginėlis;Skruzdeliukų;1763849354;Taip;9;0;0;9
3692;Jurginėlis;Skruzdeliukų;4944292549;Taip;0;3;0;3
3693;Jurginėlis;Skruzdeliukų;9506129699;Taip;12;0;0;12
3694;Jurginėlis;Skruzdeliukų;9550110246;Taip;0;1;0;1
3695;Jurginėlis;Skruzdeliukų;3822916547;Taip;17;0;0;17
3696;Jurginėlis;Skruzdeliukų;1204999684;Taip;12;0;0;12
3697;Jurginėlis;Skruzdeliukų;9937405742;Taip;13;0;0;13
3698;Jurginėlis;Skruzdeliukų;1726968598;Taip;0;18;0;18
3699;Jurginėlis;Skruzdeliukų;2332714713;Taip;7;0;0;7
3700;Jurginėlis;Skruzdeliukų;9961083854;Taip;0;3;0;3
3701;Jurginėlis;Skruzdeliukų;6542567172;Ne;5;7;0;12
3702;Jurginėlis;Drugelių;2025403481;Taip;5;0;0;5
3703;Jurginėlis;Drugelių;9065349248;Taip;5;0;3;8
3704;Jurginėlis;Drugelių;8341951659;Taip;1;9;0;10
3705;Jurginėlis;Drugelių;7795042485;Ne;6;0;0;6
3706;Jurginėlis;Drugelių;5138832895;Taip;11;0;1;12
3707;Jurginėlis;Drugelių;6068645621;Taip;5;8;0;13
3708;Jurginėlis;Drugelių;4276237094;Taip;11;1;0;12
3709;Jurginėlis;Drugelių;2689492215;Ne;4;0;0;4
3710;Jurginėlis;Drugelių;3527520303;Taip;0;0;1;1
3711;Jurginėlis;Drugelių;9736737788;Taip;0;0;3;3
3712;Jurginėlis;Drugelių;1208882528;Taip;0;0;1;1
3713;Jurginėlis;Drugelių;5874949368;Taip;11;0;2;13
3714;Jurginėlis;Drugelių;3063084253;Taip;8;0;0;8
3715;Jurginėlis;Drugelių;7409019574;Taip;10;4;0;14
3716;Jurginėlis;Žibučių;4979618298;Taip;0;3;0;3
3717;Jurginėlis;Žibučių;6636147085;Taip;5;1;1;7
3718;Jurginėlis;Žibučių;1438159631;Taip;5;6;0;11
3719;Jurginėlis;Žibučių;1336429135;Taip;0;0;1;1
3720;Jurginėlis;Žibučių;6948834218;Taip;1;0;7;8
3721;Jurginėlis;Žibučių;7721612113;Taip;3;1;0;4
3722;Jurginėlis;Žibučių;6988386438;Taip;5;0;1;6
3723;Jurginėlis;Žibučių;8111158692;Taip;5;0;0;5
3724;Jurginėlis;Žibučių;5936508522;Taip;10;6;0;16
3725;Jurginėlis;Žibučių;6717892969;Taip;4;6;0;10
3726;Jurginėlis;Žibučių;7977676733;Taip;5;1;0;6
3727;Jurginėlis;Žibučių;7530846375;Taip;0;1;0;1
3728;Jurginėlis;Žibučių;3899526893;Taip;0;2;3;5
3729;Jurginėlis;Žibučių;3861311860;Taip;6;1;2;9
3730;Jurginėlis;Žibučių;1263601087;Taip;5;1;3;9
3731;Jurginėlis;Žibučių;5549766339;Taip;0;5;0;5
3732;Jurginėlis;Žibučių;4429780802;Taip;0;3;0;3
3733;Jurginėlis;Žibučių;8968718021;Taip;15;0;0;15
3734;Jurginėlis;Žibučių;2782553941;Taip;5;0;1;6
3735;Jurginėlis;Žibučių;6259461257;Taip;5;0;0;5
3736;Jurginėlis;Žibučių;7252041334;Taip;11;0;1;12
3737;Jurginėlis;Zuikučių;5958832413;Taip;0;2;0;2
3738;Jurginėlis;Zuikučių;4432849717;Taip;0;8;0;8
3739;Jurginėlis;Zuikučių;6587382160;Taip;3;0;3;6
3740;Jurginėlis;Zuikučių;8097652962;Taip;11;1;0;12
3741;Jurginėlis;Zuikučių;4763313715;Ne;14;0;1;15
3742;Jurginėlis;Zuikučių;6671759364;Taip;3;5;0;8
3743;Jurginėlis;Zuikučių;6197396872;Taip;0;0;2;2
3744;Jurginėlis;Zuikučių;2820249307;Ne;0;0;2;2
3745;Jurginėlis;Zuikučių;8823175066;Taip;3;1;0;4
3746;Jurginėlis;Zuikučių;8161347781;Taip;15;3;0;18
3747;Jurginėlis;Zuikučių;7283697595;Taip;8;0;3;11
3748;Jurginėlis;Zuikučių;4113264904;Taip;10;0;2;12
3749;Jurginėlis;Zuikučių;8117563141;Taip;0;0;4;4
3750;Jurginėlis;Zuikučių;6341896288;Taip;0;0;1;1
3751;Jurginėlis;Zuikučių;2536744421;Taip;0;17;0;17
3752;Jurginėlis;Viščiukų;7193314762;Taip;5;0;3;8
3753;Jurginėlis;Viščiukų;6306274502;Ne;5;0;3;8
3754;Jurginėlis;Viščiukų;4506484183;Taip;0;15;0;15
3755;Jurginėlis;Viščiukų;3741447134;Taip;6;0;1;7
3756;Jurginėlis;Viščiukų;2595002682;Taip;9;0;3;12
3757;Jurginėlis;Viščiukų;5866358319;Taip;4;0;4;8
3758;Jurginėlis;Viščiukų;4648875524;Taip;5;2;0;7
3759;Jurginėlis;Viščiukų;1598578487;Taip;9;0;4;13
3760;Jurginėlis;Viščiukų;4644476606;Taip;9;0;3;12
3761;Jurginėlis;Viščiukų;2870716390;Taip;2;4;0;6
3762;Jurginėlis;Viščiukų;3230200231;Taip;15;2;0;17
3763;Jurginėlis;Viščiukų;7636442845;Taip;2;0;4;6
3764;Jurginėlis;Viščiukų;1286603999;Taip;3;0;2;5
3765;Jurginėlis;Viščiukų;4617952912;Taip;11;0;0;11
3766;Jurginėlis;Meškiukų;8844614653;Taip;0;0;3;3
3767;Jurginėlis;Meškiukų;1303323955;Taip;5;0;1;6
3768;Jurginėlis;Meškiukų;4466955830;Taip;5;0;3;8
3769;Jurginėlis;Meškiukų;6932501634;Taip;9;0;1;10
3770;Jurginėlis;Meškiukų;2248773321;Taip;0;0;4;4
3771;Jurginėlis;Meškiukų;3675820817;Taip;7;0;10;17
3772;Jurginėlis;Meškiukų;6285599044;Ne;0;0;10;10
3773;Jurginėlis;Meškiukų;5043815909;Taip;4;0;2;6
3774;Jurginėlis;Meškiukų;2982526236;Taip;0;1;0;1
3775;Jurginėlis;Meškiukų;4233910766;Taip;0;1;0;1
3776;Jurginėlis;Meškiukų;6594025023;Taip;0;6;0;6
3777;Jurginėlis;Meškiukų;6648657850;Taip;5;1;0;6
3778;Jurginėlis;Meškiukų;6856023398;Taip;5;0;5;10
3779;Jurginėlis;Gandriukų;8017976529;Taip;5;4;0;9
3780;Jurginėlis;Gandriukų;3530906368;Ne;10;1;5;16
3781;Jurginėlis;Gandriukų;6806704355;Taip;21;0;0;21
3782;Jurginėlis;Gandriukų;9288380246;Taip;2;0;4;6
3783;Jurginėlis;Gandriukų;2548920722;Taip;14;0;0;14
3784;Jurginėlis;Gandriukų;7288921301;Taip;9;0;0;9
3785;Jurginėlis;Gandriukų;4827340942;Taip;8;3;0;11
3786;Jurginėlis;Gandriukų;4463258777;Taip;7;2;0;9
3787;Jurginėlis;Gandriukų;1414888906;Taip;0;0;4;4
3788;Jurginėlis;Gandriukų;2225892248;Taip;0;0;2;2
3789;Jurginėlis;Gandriukų;6579565337;Taip;2;1;1;4
3790;Jurginėlis;Gandriukų;7990015623;Taip;0;3;0;3
3791;Jurginėlis;Gandriukų;4158502752;Taip;8;2;0;10
3792;Jurginėlis;Gandriukų;2214809186;Taip;2;0;1;3
3793;Jurginėlis;Gandriukų;3284464951;Taip;17;4;0;21
3794;Jurginėlis;Gandriukų;2263818210;Taip;0;2;0;2
3795;Jurginėlis;Gandriukų;3091019969;Taip;15;0;0;15
3796;Jurginėlis;Gandriukų;2837099502;Taip;0;0;3;3
3797;Jurginėlis;Gandriukų;3462969423;Taip;0;3;0;3
3798;Jurginėlis;Gandriukų;7486778826;Taip;0;2;0;2
3799;Jurginėlis;Gandriukų;5242359650;Ne;0;7;0;7
3800;Jurginėlis;Gandriukų;8144038013;Taip;0;7;0;7
3801;Karusėlė;PAGRANDUKAS;1621482372;Taip;0;3;0;3
3802;Karusėlė;PAGRANDUKAS;3330374479;Taip;7;1;0;8
3803;Karusėlė;PAGRANDUKAS;6183785840;Taip;0;2;0;2
3804;Karusėlė;PAGRANDUKAS;3984262482;Taip;18;0;0;18
3805;Karusėlė;PAGRANDUKAS;9130534156;Taip;10;0;0;10
3806;Karusėlė;PAGRANDUKAS;5132581245;Taip;10;4;0;14
3807;Karusėlė;PAGRANDUKAS;2412418335;Taip;0;1;0;1
3808;Karusėlė;PAGRANDUKAS;7393434659;Taip;9;0;0;9
3809;Karusėlė;PAGRANDUKAS;5695697634;Taip;0;4;0;4
3810;Karusėlė;PAGRANDUKAS;7013765804;Taip;0;8;0;8
3811;Karusėlė;PAGRANDUKAS;3429495073;Taip;0;2;0;2
3812;Karusėlė;PAGRANDUKAS;6252613489;Taip;5;6;0;11
3813;Karusėlė;PAGRANDUKAS;5595950213;Taip;4;2;1;7
3814;Karusėlė;PAGRANDUKAS;6004882312;Taip;0;6;0;6
3815;Karusėlė;PAGRANDUKAS;6856800484;Taip;4;0;0;4
3816;Karusėlė;PAGRANDUKAS;5028265234;Ne;0;20;0;20
3817;Karusėlė;PAGRANDUKAS;3972815393;Taip;8;3;0;11
3818;Karusėlė;PAGRANDUKAS;8157193503;Ne;11;1;0;12
3819;Karusėlė;PAGRANDUKAS;8656806219;Taip;0;5;0;5
3820;Karusėlė;NYKŠTUKAS;4966362343;Taip;1;0;0;1
3821;Karusėlė;NYKŠTUKAS;9997776739;Taip;6;0;3;9
3822;Karusėlė;NYKŠTUKAS;4445214427;Taip;0;13;0;13
3823;Karusėlė;NYKŠTUKAS;9354431582;Taip;0;1;0;1
3824;Karusėlė;NYKŠTUKAS;5216815933;Taip;0;6;0;6
3825;Karusėlė;NYKŠTUKAS;7817417459;Taip;7;2;2;11
3826;Karusėlė;NYKŠTUKAS;9654804545;Taip;0;4;0;4
3827;Karusėlė;NYKŠTUKAS;6581798125;Taip;0;3;0;3
3828;Karusėlė;NYKŠTUKAS;1486577955;Ne;8;2;0;10
3829;Karusėlė;NYKŠTUKAS;8007341411;Taip;16;0;0;16
3830;Karusėlė;NYKŠTUKAS;4296509304;Taip;0;1;0;1
3831;Karusėlė;NYKŠTUKAS;9243932017;Taip;0;2;5;7
3832;Karusėlė;NYKŠTUKAS;5986973796;Taip;15;0;0;15
3833;Karusėlė;NYKŠTUKAS;4856589410;Taip;6;2;4;12
3834;Karusėlė;NYKŠTUKAS;9999461542;Taip;5;1;0;6
3835;Karusėlė;NYKŠTUKAS;9385698812;Taip;8;2;0;10
3836;Karusėlė;NYKŠTUKAS;5328762735;Taip;5;2;0;7
3837;Karusėlė;NYKŠTUKAS;1078396181;Taip;7;0;0;7
3838;Karusėlė;BITUTĖ;1593728369;Taip;6;4;0;10
3839;Karusėlė;BITUTĖ;6417699445;Taip;0;1;0;1
3840;Karusėlė;BITUTĖ;2426822679;Taip;0;1;0;1
3841;Karusėlė;BITUTĖ;1205498782;Taip;0;2;5;7
3842;Karusėlė;BITUTĖ;7824913364;Ne;4;1;0;5
3843;Karusėlė;BITUTĖ;5651238035;Taip;4;0;0;4
3844;Karusėlė;BITUTĖ;5960946826;Taip;0;1;0;1
3845;Karusėlė;BITUTĖ;8175498192;Taip;0;3;5;8
3846;Karusėlė;BITUTĖ;5951045233;Taip;0;3;0;3
3847;Karusėlė;BITUTĖ;1487641646;Taip;0;3;0;3
3848;Karusėlė;BITUTĖ;6692345915;Taip;1;1;0;2
3849;Karusėlė;BITUTĖ;1211005513;Taip;0;10;0;10
3850;Karusėlė;BITUTĖ;2160071272;Taip;0;4;0;4
3851;Karusėlė;BITUTĖ;9418670930;Ne;0;3;4;7
3852;Karusėlė;BITUTĖ;7167895711;Taip;0;4;0;4
3853;Karusėlė;BITUTĖ;3116403256;Taip;0;1;0;1
3854;Karusėlė;BITUTĖ;7977133699;Taip;0;4;0;4
3855;Karusėlė;BITUTĖ;6165548450;Taip;1;5;0;6
3856;Karusėlė;BITUTĖ;1204919995;Ne;0;3;14;17
3857;Karusėlė;BORUŽĖLĖ;1705790474;Taip;0;3;1;4
3858;Karusėlė;BORUŽĖLĖ;8608177987;Taip;0;1;0;1
3859;Karusėlė;BORUŽĖLĖ;1311907441;Ne;7;1;0;8
3860;Karusėlė;BORUŽĖLĖ;6313010762;Taip;5;1;0;6
3861;Karusėlė;BORUŽĖLĖ;5859827168;Taip;10;1;0;11
3862;Karusėlė;BORUŽĖLĖ;37349219339;Taip;5;2;0;7
3863;Karusėlė;BORUŽĖLĖ;6811862463;Taip;7;7;0;14
3864;Karusėlė;BORUŽĖLĖ;5471989295;Taip;11;1;0;12
3865;Karusėlė;BORUŽĖLĖ;9753876554;Taip;3;1;1;5
3866;Karusėlė;BORUŽĖLĖ;8717484092;Taip;3;2;0;5
3867;Karusėlė;BORUŽĖLĖ;1994682683;Taip;0;3;1;4
3868;Karusėlė;BORUŽĖLĖ;5632697184;Taip;0;2;3;5
3869;Karusėlė;BORUŽĖLĖ;2247913568;Taip;3;1;0;4
3870;Karusėlė;BORUŽĖLĖ;4262640017;Taip;9;1;0;10
3871;Karusėlė;BORUŽĖLĖ;4845558814;Ne;10;7;0;17
3872;Karusėlė;BORUŽĖLĖ;6495631086;Taip;0;2;0;2
3873;Karusėlė;BORUŽĖLĖ;1183484176;Taip;0;4;0;4
3874;Karusėlė;BORUŽĖLĖ;2287979864;Taip;0;0;1;1
3875;Karusėlė;BORUŽĖLĖ;3389843421;Taip;0;12;0;12
3876;Karusėlė;BORUŽĖLĖ;9409462734;Ne;0;3;4;7
3877;Karusėlė;BORUŽĖLĖ;4818655110;Taip;14;0;0;14
3878;Karusėlė;UOGELĖ;9805481603;Taip;0;1;0;1
3879;Karusėlė;UOGELĖ;8182071103;Taip;8;0;0;8
3880;Karusėlė;UOGELĖ;9992989896;Taip;0;1;0;1
3881;Karusėlė;UOGELĖ;2084276906;Ne;14;0;0;14
3882;Karusėlė;UOGELĖ;8665314366;Taip;6;6;0;12
3883;Karusėlė;UOGELĖ;5504719953;Taip;0;15;0;15
3884;Karusėlė;UOGELĖ;5919009583;Taip;21;0;0;21
3885;Karusėlė;UOGELĖ;4199597984;Taip;4;2;0;6
3886;Karusėlė;UOGELĖ;2383023280;Taip;0;13;0;13
3887;Karusėlė;UOGELĖ;1575408822;Taip;0;14;0;14
3888;Karusėlė;UOGELĖ;3917113787;Taip;0;2;0;2
3889;Karusėlė;UOGELĖ;4638918427;Taip;1;0;1;2
3890;Karusėlė;UOGELĖ;3615957761;Taip;1;13;0;14
3891;Karusėlė;UOGELĖ;3514026443;Taip;6;0;0;6
3892;Karusėlė;UOGELĖ;1891147022;Taip;0;1;2;3
3893;Karusėlė;UOGELĖ;3872322338;Ne;0;1;0;1
3894;Karusėlė;UOGELĖ;3963576314;Taip;0;1;2;3
3895;Karusėlė;GINTARĖLIS;3773170060;Taip;7;1;1;9
3896;Karusėlė;GINTARĖLIS;3904453423;Taip;0;2;6;8
3897;Karusėlė;GINTARĖLIS;7489136297;Taip;0;3;1;4
3898;Karusėlė;GINTARĖLIS;3534074990;Taip;15;1;1;17
3899;Karusėlė;GINTARĖLIS;7540323186;Taip;12;0;1;13
3900;Karusėlė;GINTARĖLIS;1019322763;Taip;21;0;0;21
3901;Karusėlė;GINTARĖLIS;8481143199;Taip;11;0;1;12
3902;Karusėlė;GINTARĖLIS;3157893936;Taip;5;4;0;9
3903;Karusėlė;GINTARĖLIS;8409412605;Taip;16;0;1;17
3904;Karusėlė;GINTARĖLIS;3136606610;Taip;2;1;0;3
3905;Karusėlė;GINTARĖLIS;7599328323;Taip;5;1;0;6
3906;Karusėlė;GINTARĖLIS;2688863117;Taip;0;1;0;1
3907;Karusėlė;GINTARĖLIS;7439791054;Taip;14;0;0;14
3908;Karusėlė;GINTARĖLIS;3696384277;Taip;0;0;8;8
3909;Karusėlė;GINTARĖLIS;2945027875;Taip;15;0;0;15
3910;Karusėlė;GINTARĖLIS;8855096080;Taip;0;6;0;6
3911;Karusėlė;GINTARĖLIS;9116238924;Taip;0;0;1;1
3912;Karusėlė;GINTARĖLIS;6433987745;Ne;6;0;4;10
3913;Karusėlė;GINTARĖLIS;9763326660;Taip;0;1;1;2
3914;Karusėlė;GINTARĖLIS;9479962436;Ne;14;0;1;15
3915;Karusėlė;GINTARĖLIS;6232570825;Taip;1;0;0;1
3916;Karusėlė;SAULUTĖ;5627583683;Taip;10;2;0;12
3917;Karusėlė;SAULUTĖ;2242659064;Taip;0;8;0;8
3918;Karusėlė;SAULUTĖ;5146709341;Taip;0;2;0;2
3919;Karusėlė;SAULUTĖ;7814525717;Taip;0;12;0;12
3920;Karusėlė;SAULUTĖ;9996567374;Taip;0;5;0;5
3921;Karusėlė;SAULUTĖ;8331985564;Taip;0;2;1;3
3922;Karusėlė;SAULUTĖ;9400171357;Taip;0;2;0;2
3923;Karusėlė;SAULUTĖ;9656723409;Taip;0;2;0;2
3924;Karusėlė;SAULUTĖ;5766390337;Taip;4;1;0;5
3925;Karusėlė;SAULUTĖ;4879654321;Taip;0;1;0;1
3926;Karusėlė;SAULUTĖ;5803808409;Taip;5;1;0;6
3927;Karusėlė;SAULUTĖ;3149575456;Ne;5;0;0;5
3928;Karusėlė;SAULUTĖ;5640656442;Taip;6;1;0;7
3929;Karusėlė;SAULUTĖ;9451789237;Taip;0;1;0;1
3930;Karusėlė;SAULUTĖ;9450841251;Ne;1;2;7;10
3931;Karusėlė;SAULUTĖ;8830559511;Taip;0;0;4;4
3932;Karusėlė;SAULUTĖ;3228100488;Taip;15;1;0;16
3933;Karusėlė;TIGRIUKAS;8946147763;Taip;0;2;0;2
3934;Karusėlė;TIGRIUKAS;8076851284;Taip;2;1;0;3
3935;Karusėlė;TIGRIUKAS;4426462711;Taip;16;0;0;16
3936;Karusėlė;TIGRIUKAS;9484773068;Taip;16;0;0;16
3937;Karusėlė;TIGRIUKAS;1698478530;Taip;0;3;0;3
3938;Karusėlė;TIGRIUKAS;9561892809;Taip;10;0;0;10
3939;Karusėlė;TIGRIUKAS;9726299722;Taip;0;2;0;2
3940;Karusėlė;TIGRIUKAS;1576201225;Taip;21;0;0;21
3941;Karusėlė;TIGRIUKAS;9344514262;Taip;10;0;0;10
3942;Karusėlė;TIGRIUKAS;9065247151;Taip;2;1;0;3
3943;Karusėlė;TIGRIUKAS;7131255599;Taip;8;4;0;12
3944;Karusėlė;TIGRIUKAS;4180604225;Taip;8;4;0;12
3945;Karusėlė;TIGRIUKAS;9252093125;Taip;3;3;0;6
3946;Karusėlė;TIGRIUKAS;9736020767;Taip;0;0;1;1
3947;Karusėlė;TIGRIUKAS;5176597751;Taip;2;1;0;3
3948;Karusėlė;TIGRIUKAS;6656808100;Taip;6;0;0;6
3949;Karusėlė;VAIVORYKŠTĖ;1289442716;Taip;0;0;2;2
3950;Karusėlė;VAIVORYKŠTĖ;9855242602;Taip;5;0;2;7
3951;Karusėlė;VAIVORYKŠTĖ;6546648346;Taip;0;8;0;8
3952;Karusėlė;VAIVORYKŠTĖ;8063412271;Taip;6;1;0;7
3953;Karusėlė;VAIVORYKŠTĖ;9408843254;Taip;0;5;5;10
3954;Karusėlė;VAIVORYKŠTĖ;3514315636;Taip;4;2;3;9
3955;Karusėlė;VAIVORYKŠTĖ;8085919723;Taip;6;2;1;9
3956;Karusėlė;VAIVORYKŠTĖ;5444753290;Taip;0;12;0;12
3957;Karusėlė;VAIVORYKŠTĖ;1581504806;Taip;10;1;0;11
3958;Karusėlė;VAIVORYKŠTĖ;2215367063;Taip;0;7;0;7
3959;Karusėlė;VAIVORYKŠTĖ;6424622497;Taip;3;2;0;5
3960;Karusėlė;VAIVORYKŠTĖ;5855430678;Taip;0;1;0;1
3961;Karusėlė;VAIVORYKŠTĖ;2757263085;Taip;0;1;0;1
3962;Karusėlė;VAIVORYKŠTĖ;4110024673;Taip;4;5;0;9
3963;Karusėlė;VAIVORYKŠTĖ;6444553698;Ne;10;0;2;12
3964;Karusėlė;VAIVORYKŠTĖ;9400856559;Taip;0;5;0;5
3965;Karusėlė;VAIVORYKŠTĖ;1083786182;Taip;0;5;0;5
3966;Karusėlė;VAIVORYKŠTĖ;5998868204;Taip;0;1;0;1
3967;Karusėlė;VAIVORYKŠTĖ;6734936247;Taip;7;2;0;9
3968;Karusėlė;"AUKSINĖ ŽUVELĖ";2993499990;Taip;11;0;3;14
3969;Karusėlė;"AUKSINĖ ŽUVELĖ";6341570221;Taip;0;0;12;12
3970;Karusėlė;"AUKSINĖ ŽUVELĖ";2135332292;Taip;0;5;0;5
3971;Karusėlė;"AUKSINĖ ŽUVELĖ";8441520423;Taip;5;0;0;5
3972;Karusėlė;"AUKSINĖ ŽUVELĖ";9463553056;Taip;5;1;0;6
3973;Karusėlė;"AUKSINĖ ŽUVELĖ";4566201460;Taip;2;0;0;2
3974;Karusėlė;"AUKSINĖ ŽUVELĖ";3551143062;Taip;0;1;0;1
3975;Karusėlė;"AUKSINĖ ŽUVELĖ";8257771271;Taip;4;1;0;5
3976;Karusėlė;"AUKSINĖ ŽUVELĖ";7749015193;Taip;0;7;0;7
3977;Karusėlė;"AUKSINĖ ŽUVELĖ";1008205490;Taip;16;0;2;18
3978;Karusėlė;"AUKSINĖ ŽUVELĖ";3075592618;Taip;2;0;0;2
3979;Karusėlė;"AUKSINĖ ŽUVELĖ";2450390957;Taip;6;0;0;6
3980;Karusėlė;"AUKSINĖ ŽUVELĖ";4871960780;Taip;13;0;2;15
3981;Karusėlė;"AUKSINĖ ŽUVELĖ";8848085495;Ne;21;0;0;21
3982;Karusėlė;RAMUNĖ;8362740639;Taip;5;1;0;6
3983;Karusėlė;RAMUNĖ;3460470459;Taip;10;1;1;12
3984;Karusėlė;RAMUNĖ;4302662341;Taip;0;14;0;14
3985;Karusėlė;RAMUNĖ;9415377698;Taip;0;2;0;2
3986;Karusėlė;RAMUNĖ;8474027736;Taip;10;3;0;13
3987;Karusėlė;RAMUNĖ;7535451590;Taip;4;1;2;7
3988;Karusėlė;RAMUNĖ;4865727149;Taip;16;0;0;16
3989;Karusėlė;RAMUNĖ;2842034472;Taip;7;0;2;9
3990;Karusėlė;RAMUNĖ;8531556390;Taip;0;1;0;1
3991;Karusėlė;RAMUNĖ;8952114853;Ne;12;2;0;14
3992;Karusėlė;RAMUNĖ;4757820179;Taip;0;2;1;3
3993;Karusėlė;RAMUNĖ;9649615834;Taip;7;0;0;7
3994;Karusėlė;RAMUNĖ;3885475525;Taip;10;4;0;14
3995;Karusėlė;RAMUNĖ;6678283260;Taip;0;2;0;2
3996;Karusėlė;RAMUNĖ;4196250786;Ne;0;2;0;2
3997;Karusėlė;VILKELIS;1412890120;Taip;2;6;0;8
3998;Karusėlė;VILKELIS;4951249625;Taip;14;0;0;14
3999;Karusėlė;VILKELIS;5135054911;Taip;7;0;1;8
4000;Karusėlė;VILKELIS;4130693235;Taip;21;0;0;21
4001;Karusėlė;VILKELIS;8012963667;Taip;5;2;0;7
4002;Karusėlė;VILKELIS;9340167973;Taip;3;2;0;5
4003;Karusėlė;VILKELIS;9985033530;Taip;2;1;1;4
4004;Karusėlė;VILKELIS;6826455161;Taip;0;0;1;1
4005;Karusėlė;VILKELIS;3661917922;Taip;0;0;1;1
4006;Karusėlė;VILKELIS;4211688032;Taip;14;0;0;14
4007;Karusėlė;VILKELIS;2727440190;Taip;0;0;2;2
4008;Karusėlė;VILKELIS;9304912028;Ne;0;0;1;1
4009;Karusėlė;VILKELIS;5802996641;Ne;0;1;0;1
4010;Karusėlė;VILKELIS;2306922755;Taip;0;3;1;4
4011;Karusėlė;VILKELIS;4103816990;Taip;0;0;7;7
4012;Karusėlė;VILKELIS;4325959483;Taip;5;11;0;16
4013;Karusėlė;VILKELIS;3271464159;Ne;9;0;0;9
4014;Karusėlė;VILKELIS;7501323454;Taip;5;0;4;9
4015;Karusėlė;VILKELIS;3968719760;Taip;0;1;2;3
4016;Kaštonas;NYKŠTUKAI;7703842464;Taip;3;0;6;9
4017;Kaštonas;NYKŠTUKAI;1262404954;Taip;1;0;0;1
4018;Kaštonas;NYKŠTUKAI;6254250706;Taip;1;0;0;1
4019;Kaštonas;NYKŠTUKAI;8867446698;Taip;3;0;1;4
4020;Kaštonas;NYKŠTUKAI;8775608339;Taip;0;7;0;7
4021;Kaštonas;NYKŠTUKAI;6613837801;Ne;5;0;0;5
4022;Kaštonas;NYKŠTUKAI;6934262510;Taip;0;5;0;5
4023;Kaštonas;NYKŠTUKAI;6589898580;Taip;8;3;0;11
4024;Kaštonas;NYKŠTUKAI;4824511567;Ne;10;0;0;10
4025;Kaštonas;NYKŠTUKAI;4384907654;Taip;11;4;0;15
4026;Kaštonas;NYKŠTUKAI;3961661158;Taip;0;13;0;13
4027;Kaštonas;NYKŠTUKAI;8318869054;Taip;0;6;0;6
4028;Kaštonas;NYKŠTUKAI;2434765663;Ne;0;1;0;1
4029;Kaštonas;NYKŠTUKAI;2178971789;Taip;1;0;0;1
4030;Kaštonas;NYKŠTUKAI;4444087861;Taip;9;0;2;11
4031;Kaštonas;NYKŠTUKAI;9379171183;Taip;7;0;3;10
4032;Kaštonas;NYKŠTUKAI;9014726465;Taip;0;13;0;13
4033;Kaštonas;NYKŠTUKAI;2361839733;Taip;10;1;0;11
4034;Kaštonas;NYKŠTUKAI;3383390078;Taip;0;21;0;21
4035;Kaštonas;DRUGELIAI;8486955652;Taip;1;8;0;9
4036;Kaštonas;DRUGELIAI;2106924435;Taip;0;4;0;4
4037;Kaštonas;DRUGELIAI;8483888152;Taip;0;5;0;5
4038;Kaštonas;DRUGELIAI;2165890763;Taip;5;0;0;5
4039;Kaštonas;DRUGELIAI;7408901858;Taip;0;3;0;3
4040;Kaštonas;DRUGELIAI;5099098185;Taip;0;3;0;3
4041;Kaštonas;DRUGELIAI;8582453109;Taip;7;3;0;10
4042;Kaštonas;DRUGELIAI;2832688622;Ne;7;6;0;13
4043;Kaštonas;DRUGELIAI;9061158412;Ne;17;0;0;17
4044;Kaštonas;DRUGELIAI;9168456496;Taip;0;3;7;10
4045;Kaštonas;DRUGELIAI;5884427036;Taip;0;11;0;11
4046;Kaštonas;DRUGELIAI;1141693073;Taip;0;5;0;5
4047;Kaštonas;DRUGELIAI;6251564828;Taip;0;5;0;5
4048;Kaštonas;DRUGELIAI;1249299633;Taip;0;5;0;5
4049;Kaštonas;DRUGELIAI;5969052108;Taip;5;0;0;5
4050;Kaštonas;DRUGELIAI;8166925991;Taip;6;8;0;14
4051;Kaštonas;DRUGELIAI;4215759647;Taip;5;7;0;12
4052;Kaštonas;DRUGELIAI;6114301692;Taip;4;0;0;4
4053;Kaštonas;DRUGELIAI;5307755844;Taip;0;6;0;6
4054;Kaštonas;DRUGELIAI;9985164505;Taip;4;4;0;8
4055;Kaštonas;DRUGELIAI;2417951642;Taip;0;1;0;1
4056;Kaštonas;DRUGELIAI;8257643251;Taip;5;10;0;15
4057;Kaštonas;KIŠKUČIAI;2020612346;Taip;0;9;0;9
4058;Kaštonas;KIŠKUČIAI;6585977073;Taip;6;2;0;8
4059;Kaštonas;KIŠKUČIAI;1761520786;Taip;5;1;0;6
4060;Kaštonas;KIŠKUČIAI;9298372326;Ne;0;5;0;5
4061;Kaštonas;KIŠKUČIAI;9778140363;Ne;0;9;0;9
4062;Kaštonas;KIŠKUČIAI;8250964197;Taip;0;16;0;16
4063;Kaštonas;KIŠKUČIAI;7290414209;Taip;0;8;0;8
4064;Kaštonas;KIŠKUČIAI;9356018629;Taip;10;2;0;12
4065;Kaštonas;KIŠKUČIAI;4115242811;Taip;0;2;0;2
4066;Kaštonas;KIŠKUČIAI;1684641447;Taip;9;5;0;14
4067;Kaštonas;KIŠKUČIAI;1207372235;Ne;8;2;0;10
4068;Kaštonas;KIŠKUČIAI;4570064071;Taip;9;0;1;10
4069;Kaštonas;KIŠKUČIAI;2898327157;Taip;7;0;0;7
4070;Kaštonas;KIŠKUČIAI;9320223622;Taip;0;12;0;12
4071;Kaštonas;BITUTĖS;9285927858;Taip;10;4;0;14
4072;Kaštonas;BITUTĖS;5328263421;Taip;4;0;1;5
4073;Kaštonas;BITUTĖS;9903176616;Taip;10;2;0;12
4074;Kaštonas;BITUTĖS;1747580231;Ne;0;14;2;16
4075;Kaštonas;BITUTĖS;4033866425;Taip;0;4;0;4
4076;Kaštonas;BITUTĖS;4061364544;Taip;15;1;0;16
4077;Kaštonas;BITUTĖS;8275673303;Taip;0;7;3;10
4078;Kaštonas;BITUTĖS;1614180834;Taip;5;0;4;9
4079;Kaštonas;BITUTĖS;6711295699;Taip;9;5;0;14
4080;Kaštonas;BITUTĖS;2877124424;Taip;0;4;0;4
4081;Kaštonas;BITUTĖS;1031628633;Taip;8;0;0;8
4082;Kaštonas;BITUTĖS;4551111709;Taip;8;0;0;8
4083;Kaštonas;BITUTĖS;7508357392;Taip;0;9;0;9
4084;Kaštonas;BITUTĖS;8906976150;Taip;0;12;0;12
4085;Kaštonas;BITUTĖS;8151333699;Taip;16;1;0;17
4086;Kaštonas;BITUTĖS;3649329598;Taip;0;13;0;13
4087;Kaštonas;BITUTĖS;8214699601;Taip;0;5;0;5
4088;Kaštonas;BITUTĖS;8152577445;Taip;0;2;1;3
4089;Kaštonas;BITUTĖS;7291448857;Taip;5;5;0;10
4090;Kaštonas;BITUTĖS;4837002666;Ne;2;1;9;12
4091;Kaštonas;BITUTĖS;2701042709;Taip;1;12;0;13
4092;Kaštonas;BITUTĖS;6175014441;Taip;0;0;1;1
4093;Kaštonas;BITUTĖS;1748975865;Taip;0;3;0;3
4094;Kaštonas;MEŠKIUKAI;5607474492;Taip;0;21;0;21
4095;Kaštonas;MEŠKIUKAI;5350239917;Taip;0;2;0;2
4096;Kaštonas;MEŠKIUKAI;7956422880;Taip;10;5;0;15
4097;Kaštonas;MEŠKIUKAI;3554337770;Taip;0;0;1;1
4098;Kaštonas;MEŠKIUKAI;7911007041;Taip;0;11;0;11
4099;Kaštonas;MEŠKIUKAI;2125410714;Taip;5;4;0;9
4100;Kaštonas;MEŠKIUKAI;6289073634;Taip;0;21;0;21
4101;Kaštonas;MEŠKIUKAI;7553024183;Taip;11;0;0;11
4102;Kaštonas;MEŠKIUKAI;4616084852;Taip;5;1;0;6
4103;Kaštonas;MEŠKIUKAI;1801371129;Taip;1;0;1;2
4104;Kaštonas;MEŠKIUKAI;5157500600;Ne;0;2;0;2
4105;Kaštonas;MEŠKIUKAI;6606094891;Taip;12;4;0;16
4106;Kaštonas;MEŠKIUKAI;1364391105;Taip;0;3;0;3
4107;Kaštonas;MEŠKIUKAI;6967725663;Taip;17;1;0;18
4108;Kaštonas;MEŠKIUKAI;5153948802;Ne;16;2;0;18
4109;Kaštonas;MEŠKIUKAI;4308169582;Ne;8;1;2;11
4110;Kaštonas;MEŠKIUKAI;8797584508;Taip;6;0;0;6
4111;Kaštonas;MEŠKIUKAI;9965517774;Taip;0;9;0;9
4112;Kaštonas;MEŠKIUKAI;7138581709;Taip;0;9;0;9
4113;Kaštonas;MEŠKIUKAI;8446233414;Taip;9;0;0;9
4114;Kaštonas;MEŠKIUKAI;1196590128;Taip;17;1;0;18
4115;Kaštonas;BORUŽĖLĖS;1501441973;Ne;0;7;0;7
4116;Kaštonas;BORUŽĖLĖS;1612086010;Taip;10;1;0;11
4117;Kaštonas;BORUŽĖLĖS;9034859988;Taip;5;1;0;6
4118;Kaštonas;BORUŽĖLĖS;9249007247;Taip;0;12;0;12
4119;Kaštonas;BORUŽĖLĖS;2057499534;Taip;2;0;0;2
4120;Kaštonas;BORUŽĖLĖS;6896372095;Taip;1;1;0;2
4121;Kaštonas;BORUŽĖLĖS;1976138680;Ne;0;3;0;3
4122;Kaštonas;BORUŽĖLĖS;9807554365;Taip;11;0;0;11
4123;Kaštonas;BORUŽĖLĖS;4708114402;Taip;0;4;0;4
4124;Kaštonas;BORUŽĖLĖS;7992154554;Taip;0;2;0;2
4125;Kaštonas;BORUŽĖLĖS;4641535612;Taip;0;13;0;13
4126;Kaštonas;BORUŽĖLĖS;7383219978;Taip;0;3;0;3
4127;Kaštonas;BORUŽĖLĖS;3251132542;Taip;2;1;0;3
4128;Kaštonas;BORUŽĖLĖS;6425908247;Taip;2;3;0;5
4129;Kaštonas;BORUŽĖLĖS;3860613494;Taip;8;1;0;9
4130;Kaštonas;BORUŽĖLĖS;9317649996;Ne;0;3;0;3
4131;Kaštonas;BORUŽĖLĖS;5948707303;Taip;11;1;0;12
4132;Kaštonas;BORUŽĖLĖS;7698074598;Taip;13;3;0;16
4133;Kaštonas;BORUŽĖLĖS;6749679348;Taip;8;1;0;9
4134;Kaštonas;BORUŽĖLĖS;5060824071;Taip;0;7;0;7
4135;Krivūlė;SPINDULIUKAI;3233000497;Taip;10;0;0;10
4136;Krivūlė;SPINDULIUKAI;2191720088;Taip;10;0;0;10
4137;Krivūlė;SPINDULIUKAI;3913058095;Taip;0;0;6;6
4138;Krivūlė;SPINDULIUKAI;1840809151;Taip;3;0;0;3
4139;Krivūlė;SPINDULIUKAI;7335245963;Taip;6;0;0;6
4140;Krivūlė;SPINDULIUKAI;5802739148;Taip;0;4;2;6
4141;Krivūlė;SPINDULIUKAI;5667934115;Taip;6;1;0;7
4142;Krivūlė;SPINDULIUKAI;8348288864;Taip;0;0;5;5
4143;Krivūlė;SPINDULIUKAI;7155162698;Taip;3;1;7;11
4144;Krivūlė;SPINDULIUKAI;1151179495;Taip;0;0;1;1
4145;Krivūlė;SPINDULIUKAI;9320613086;Taip;13;0;1;14
4146;Krivūlė;SPINDULIUKAI;6632875947;Taip;0;5;0;5
4147;Krivūlė;SPINDULIUKAI;4750075323;Taip;4;0;0;4
4148;Krivūlė;SPINDULIUKAI;7199431924;Taip;0;11;0;11
4149;Krivūlė;SPINDULIUKAI;3184820008;Taip;0;0;3;3
4150;Krivūlė;SPINDULIUKAI;7149268223;Taip;0;0;9;9
4151;Krivūlė;BORUŽĖLĖS;3605506478;Taip;2;0;0;2
4152;Krivūlė;BORUŽĖLĖS;4896656209;Taip;2;0;0;2
4153;Krivūlė;BORUŽĖLĖS;4845515196;Taip;0;7;0;7
4154;Krivūlė;BORUŽĖLĖS;5676562063;Taip;0;0;1;1
4155;Krivūlė;BORUŽĖLĖS;6935969502;Taip;0;0;1;1
4156;Krivūlė;BORUŽĖLĖS;4972360440;Taip;5;0;0;5
4157;Krivūlė;BORUŽĖLĖS;7318064702;Taip;0;0;1;1
4158;Krivūlė;BORUŽĖLĖS;3912620138;Taip;2;0;3;5
4159;Krivūlė;BORUŽĖLĖS;3246787504;Ne;0;0;2;2
4160;Krivūlė;BORUŽĖLĖS;5531566792;Taip;0;0;1;1
4161;Krivūlė;BORUŽĖLĖS;2386053480;Taip;16;0;1;17
4162;Krivūlė;BORUŽĖLĖS;8586287004;Taip;1;0;0;1
4163;Krivūlė;BORUŽĖLĖS;4540069843;Ne;6;0;3;9
4164;Krivūlė;BORUŽĖLĖS;4297876008;Taip;0;1;2;3
4165;Krivūlė;BORUŽĖLĖS;2138125571;Taip;0;1;0;1
4166;Krivūlė;BORUŽĖLĖS;4177660973;Taip;0;4;0;4
4167;Krivūlė;BORUŽĖLĖS;2711010212;Taip;14;1;0;15
4168;Krivūlė;BORUŽĖLĖS;4025821636;Taip;6;0;0;6
4169;Krivūlė;BORUŽĖLĖS;7781918674;Taip;2;3;0;5
4170;Krivūlė;BORUŽĖLĖS;1987255206;Taip;8;0;2;10
4171;Krivūlė;BORUŽĖLĖS;7025398689;Taip;17;0;1;18
4172;Krivūlė;DRUGELIŲ;5966543639;Taip;0;0;3;3
4173;Krivūlė;DRUGELIŲ;6004925249;Taip;0;1;1;2
4174;Krivūlė;DRUGELIŲ;5818988913;Taip;0;3;3;6
4175;Krivūlė;DRUGELIŲ;7873123757;Taip;0;1;1;2
4176;Krivūlė;DRUGELIŲ;19674882649;Taip;0;1;0;1
4177;Krivūlė;DRUGELIŲ;2903062788;Taip;0;11;0;11
4178;Krivūlė;DRUGELIŲ;10005041572;Taip;0;1;1;2
4179;Krivūlė;DRUGELIŲ;37502093836;Taip;0;1;0;1
4180;Krivūlė;DRUGELIŲ;83840444975;Taip;0;1;0;1
4181;Krivūlė;DRUGELIŲ;2654066358;Taip;11;0;0;11
4182;Krivūlė;DRUGELIŲ;2109315338;Taip;0;0;1;1
4183;Krivūlė;DRUGELIŲ;6861483854;Taip;13;0;2;15
4184;Krivūlė;DRUGELIŲ;1515185307;Taip;0;2;0;2
4185;Krivūlė;DRUGELIŲ;9267414141;Taip;0;1;3;4
4186;Krivūlė;DRUGELIŲ;1217856292;Taip;0;1;1;2
4187;Krivūlė;DRUGELIŲ;73760357378;Taip;0;1;2;3
4188;Krivūlė;DRUGELIŲ;6753080815;Taip;0;1;8;9
4189;Krivūlė;DRUGELIŲ;4261133734;Taip;0;1;0;1
4190;Krivūlė;DRUGELIŲ;6429160371;Taip;0;10;0;10
4191;Krivūlė;DRUGELIŲ;3924127476;Taip;0;4;0;4
4192;Krivūlė;"BITUTĖS (VALDOFRO)";18486357195;Taip;0;1;2;3
4193;Krivūlė;"BITUTĖS (VALDOFRO)";3769812444;Taip;5;6;0;11
4194;Krivūlė;"BITUTĖS (VALDOFRO)";5128760019;Taip;5;6;0;11
4195;Krivūlė;"BITUTĖS (VALDOFRO)";1851097789;Taip;4;0;1;5
4196;Krivūlė;"BITUTĖS (VALDOFRO)";7789248863;Taip;0;1;0;1
4197;Krivūlė;"BITUTĖS (VALDOFRO)";5113297248;Taip;0;1;3;4
4198;Krivūlė;"BITUTĖS (VALDOFRO)";7848471009;Ne;0;0;2;2
4199;Krivūlė;"BITUTĖS (VALDOFRO)";5405660104;Taip;0;1;8;9
4200;Krivūlė;"BITUTĖS (VALDOFRO)";8834855616;Taip;0;6;0;6
4201;Krivūlė;"BITUTĖS (VALDOFRO)";3655576855;Taip;0;1;1;2
4202;Krivūlė;"BITUTĖS (VALDOFRO)";1561180871;Taip;0;9;0;9
4203;Krivūlė;"BITUTĖS (VALDOFRO)";9702372816;Taip;1;0;2;3
4204;Krivūlė;"BITUTĖS (VALDOFRO)";4619224314;Taip;0;1;20;21
4205;Krivūlė;"BITUTĖS (VALDOFRO)";8105688948;Ne;0;8;0;8
4206;Krivūlė;"BITUTĖS (VALDOFRO)";1932209134;Taip;0;0;1;1
4207;Krivūlė;"BITUTĖS (VALDOFRO)";7768827505;Taip;0;0;10;10
4208;Krivūlė;"BITUTĖS (VALDOFRO)";7714519095;Taip;1;0;2;3
4209;Krivūlė;"BITUTĖS (VALDOFRO)";9409899522;Taip;0;0;4;4
4210;Krivūlė;"BITUTĖS (VALDOFRO)";6365743037;Taip;0;1;9;10
4211;Krivūlė;"BITUTĖS (VALDOFRO)";6217494808;Taip;0;8;0;8
4212;Krivūlė;"BITUTĖS (VALDOFRO)";8748668583;Ne;5;0;2;7
4213;Krivūlė;EŽIUKAI;8042185027;Taip;11;0;0;11
4214;Krivūlė;EŽIUKAI;1256819206;Taip;0;0;17;17
4215;Krivūlė;EŽIUKAI;3616024832;Taip;0;0;1;1
4216;Krivūlė;EŽIUKAI;7242596817;Ne;0;0;2;2
4217;Krivūlė;EŽIUKAI;5369083173;Taip;11;0;0;11
4218;Krivūlė;EŽIUKAI;9051038248;Taip;13;0;2;15
4219;Krivūlė;EŽIUKAI;3144577262;Taip;8;0;2;10
4220;Krivūlė;EŽIUKAI;1898389557;Taip;0;0;1;1
4221;Krivūlė;EŽIUKAI;2607716072;Taip;3;0;2;5
4222;Krivūlė;EŽIUKAI;6830712749;Ne;0;0;7;7
4223;Krivūlė;EŽIUKAI;1574886918;Taip;0;0;1;1
4224;Krivūlė;EŽIUKAI;3836712448;Taip;10;0;0;10
4225;Krivūlė;EŽIUKAI;8873132189;Taip;0;0;7;7
4226;Krivūlė;EŽIUKAI;2430372719;Taip;0;1;0;1
4227;Krivūlė;EŽIUKAI;2157856704;Taip;0;21;0;21
4228;Krivūlė;NYKŠTUKAI;2742783991;Taip;0;21;0;21
4229;Krivūlė;NYKŠTUKAI;9401810791;Taip;1;0;4;5
4230;Krivūlė;NYKŠTUKAI;8713384668;Taip;11;0;10;21
4231;Krivūlė;NYKŠTUKAI;9678890051;Taip;7;0;0;7
4232;Krivūlė;NYKŠTUKAI;9553953446;Taip;5;0;3;8
4233;Krivūlė;NYKŠTUKAI;5268832682;Taip;0;16;0;16
4234;Krivūlė;NYKŠTUKAI;8767554721;Taip;0;1;1;2
4235;Krivūlė;NYKŠTUKAI;9529242858;Taip;0;0;1;1
4236;Krivūlė;NYKŠTUKAI;8898023612;Taip;1;0;0;1
4237;Krivūlė;NYKŠTUKAI;5768244312;Taip;7;3;0;10
4238;Krivūlė;NYKŠTUKAI;5870153336;Taip;0;1;1;2
4239;Krivūlė;NYKŠTUKAI;7540940063;Taip;0;1;5;6
4240;Krivūlė;NYKŠTUKAI;9773092651;Taip;0;0;6;6
4241;Krivūlė;NYKŠTUKAI;6548893885;Taip;10;1;5;16
4242;Krivūlė;NYKŠTUKAI;8674468359;Taip;0;21;0;21
4243;Krivūlė;"PABIRUČIŲ (Vokiečių g. 1)";1944288576;Taip;0;0;6;6
4244;Krivūlė;"PABIRUČIŲ (Vokiečių g. 1)";9011102232;Taip;0;0;11;11
4245;Krivūlė;"PABIRUČIŲ (Vokiečių g. 1)";5535822704;Taip;0;21;0;21
4246;Krivūlė;"PABIRUČIŲ (Vokiečių g. 1)";3696403149;Taip;0;21;0;21
4247;Krivūlė;"PABIRUČIŲ (Vokiečių g. 1)";4600688626;Taip;0;0;2;2
4248;Krivūlė;"PABIRUČIŲ (Vokiečių g. 1)";4608957977;Taip;0;0;1;1
4249;Krivūlė;"PABIRUČIŲ (Vokiečių g. 1)";4884789671;Taip;10;0;1;11
4250;Krivūlė;"PABIRUČIŲ (Vokiečių g. 1)";9401191578;Taip;3;0;1;4
4251;Krivūlė;"PABIRUČIŲ (Vokiečių g. 1)";2259139771;Taip;4;0;1;5
4252;Krivūlė;"PABIRUČIŲ (Vokiečių g. 1)";3138555448;Taip;6;2;3;11
4253;Krivūlė;"PABIRUČIŲ (Vokiečių g. 1)";2784118970;Taip;0;0;4;4
4254;Krivūlė;"PABIRUČIŲ (Vokiečių g. 1)";3227555647;Taip;3;0;3;6
4255;Krivūlė;"PABIRUČIŲ (Vokiečių g. 1)";4261770381;Taip;16;0;1;17
4256;Krivūlė;"PABIRUČIŲ (Vokiečių g. 1)";5721252419;Taip;0;9;0;9
4257;Krivūlė;"SMALSUČIŲ (Vokiečių g.1)";5304221329;Taip;0;1;1;2
4258;Krivūlė;"SMALSUČIŲ (Vokiečių g.1)";7508079584;Taip;0;0;6;6
4259;Krivūlė;"SMALSUČIŲ (Vokiečių g.1)";3076382863;Taip;0;1;2;3
4260;Krivūlė;"SMALSUČIŲ (Vokiečių g.1)";7997564406;Taip;0;1;0;1
4261;Krivūlė;"SMALSUČIŲ (Vokiečių g.1)";8710938907;Taip;0;0;4;4
4262;Krivūlė;"SMALSUČIŲ (Vokiečių g.1)";4491462086;Taip;4;0;4;8
4263;Krivūlė;"SMALSUČIŲ (Vokiečių g.1)";4773564048;Taip;0;4;0;4
4264;Krivūlė;"SMALSUČIŲ (Vokiečių g.1)";3324090723;Taip;5;0;4;9
4265;Krivūlė;"SMALSUČIŲ (Vokiečių g.1)";9229817861;Ne;0;0;5;5
4266;Krivūlė;"SMALSUČIŲ (Vokiečių g.1)";8042469720;Taip;0;15;0;15
4267;Krivūlė;"SMALSUČIŲ (Vokiečių g.1)";4845066055;Taip;4;0;4;8
4268;Krivūlė;"SMALSUČIŲ (Vokiečių g.1)";9328365491;Taip;0;0;1;1
4269;Krivūlė;"SMALSUČIŲ (Vokiečių g.1)";1815336153;Taip;0;6;0;6
4270;Krivūlė;"SMALSUČIŲ (Vokiečių g.1)";7528273082;Taip;0;1;2;3
4271;Krivūlė;"SMALSUČIŲ (Vokiečių g.1)";6521798502;Taip;0;0;5;5
4272;Krivūlė;"SMALSUČIŲ (Vokiečių g.1)";4094383258;Taip;0;0;2;2
4273;Krivūlė;"GUDRUČIŲ (Vokiečių g. 1)";8520470321;Taip;0;0;11;11
4274;Krivūlė;"GUDRUČIŲ (Vokiečių g. 1)";4681543921;Taip;0;0;6;6
4275;Krivūlė;"GUDRUČIŲ (Vokiečių g. 1)";5753204752;Taip;0;10;1;11
4276;Krivūlė;"GUDRUČIŲ (Vokiečių g. 1)";2659604299;Taip;0;0;4;4
4277;Krivūlė;"GUDRUČIŲ (Vokiečių g. 1)";1622495013;Taip;5;1;4;10
4278;Krivūlė;"GUDRUČIŲ (Vokiečių g. 1)";4741154518;Taip;0;0;1;1
4279;Krivūlė;"GUDRUČIŲ (Vokiečių g. 1)";7436569684;Taip;0;0;2;2
4280;Krivūlė;"GUDRUČIŲ (Vokiečių g. 1)";7727246187;Taip;1;1;0;2
4281;Krivūlė;"GUDRUČIŲ (Vokiečių g. 1)";6072261879;Taip;0;0;7;7
4282;Krivūlė;"GUDRUČIŲ (Vokiečių g. 1)";7904390075;Taip;0;5;0;5
4283;Krivūlė;"GUDRUČIŲ (Vokiečių g. 1)";5149419581;Taip;0;0;6;6
4284;Krivūlė;"GUDRUČIŲ (Vokiečių g. 1)";7789605738;Taip;15;0;0;15
4285;Krivūlė;"GUDRUČIŲ (Vokiečių g. 1)";9693693101;Ne;0;0;2;2
4286;Krivūlė;"GUDRUČIŲ (Vokiečių g. 1)";5462491857;Taip;8;4;0;12
4287;Krivūlė;"GUDRUČIŲ (Vokiečių g. 1)";5182563483;Taip;0;1;2;3
4288;Krivūlė;"GUDRUČIŲ (Vokiečių g. 1)";8871794542;Ne;0;1;4;5
4289;Kodėlčiukas;Saulutės;6517880481;Taip;0;0;1;1
4290;Kodėlčiukas;Saulutės;1725624698;Taip;7;1;0;8
4291;Kodėlčiukas;Saulutės;8393893311;Taip;0;1;3;4
4292;Kodėlčiukas;Saulutės;7509476161;Taip;0;2;0;2
4293;Kodėlčiukas;Saulutės;7327247516;Ne;5;0;1;6
4294;Kodėlčiukas;Saulutės;1645680526;Taip;0;2;2;4
4295;Kodėlčiukas;Saulutės;8992265000;Taip;1;0;1;2
4296;Kodėlčiukas;Saulutės;6285018663;Taip;0;8;0;8
4297;Kodėlčiukas;Saulutės;1033969800;Taip;11;1;0;12
4298;Kodėlčiukas;Saulutės;2433094435;Ne;8;1;0;9
4299;Kodėlčiukas;Saulutės;9042404309;Taip;0;1;4;5
4300;Kodėlčiukas;Saulutės;3276075664;Taip;0;0;1;1
4301;Kodėlčiukas;Saulutės;7611485881;Taip;4;1;0;5
4302;Kodėlčiukas;Saulutės;7561763602;Taip;1;0;2;3
4303;Kodėlčiukas;Saulutės;2289687766;Taip;0;0;13;13
4304;Kodėlčiukas;Saulutės;6476445296;Taip;8;1;0;9
4305;Kodėlčiukas;Saulutės;1992569595;Ne;10;0;1;11
4306;Kodėlčiukas;Saulutės;9527296531;Ne;0;0;19;19
4307;Kodėlčiukas;Saulutės;8447045958;Taip;11;0;0;11
4308;Kodėlčiukas;Saulutės;2542104903;Taip;0;0;5;5
4309;Kodėlčiukas;Nežiniukai;6045564826;Taip;9;0;2;11
4310;Kodėlčiukas;Nežiniukai;7136890681;Taip;0;0;2;2
4311;Kodėlčiukas;Nežiniukai;7282579315;Taip;18;0;0;18
4312;Kodėlčiukas;Nežiniukai;6905424567;Taip;0;0;5;5
4313;Kodėlčiukas;Nežiniukai;5443377251;Ne;0;1;1;2
4314;Kodėlčiukas;Nežiniukai;3150006441;Taip;0;1;0;1
4315;Kodėlčiukas;Nežiniukai;7626940433;Taip;0;6;3;9
4316;Kodėlčiukas;Nežiniukai;9803206596;Taip;0;0;6;6
4317;Kodėlčiukas;Nežiniukai;4917910801;Ne;17;2;0;19
4318;Kodėlčiukas;Nežiniukai;3473981974;Taip;0;0;1;1
4319;Kodėlčiukas;Nežiniukai;4038168647;Taip;5;1;4;10
4320;Kodėlčiukas;Nežiniukai;8378295683;Taip;12;0;1;13
4321;Kodėlčiukas;Nežiniukai;6000831611;Taip;5;1;0;6
4322;Kodėlčiukas;Nežiniukai;7286497455;Taip;10;1;1;12
4323;Kodėlčiukas;Nežiniukai;1603752483;Taip;0;0;3;3
4324;Kodėlčiukas;Nežiniukai;6074758814;Ne;12;8;0;20
4325;Kodėlčiukas;Nežiniukai;1699358514;Ne;0;1;1;2
4326;Kodėlčiukas;Nežiniukai;1302383608;Taip;0;0;7;7
4327;Kodėlčiukas;Nežiniukai;1160612316;Taip;10;0;3;13
4328;Kodėlčiukas;Nežiniukai;5729391456;Taip;10;1;2;13
4329;Kodėlčiukas;Gintarėliai;2560864315;Taip;0;1;1;2
4330;Kodėlčiukas;Gintarėliai;58406224468;Taip;0;1;5;6
4331;Kodėlčiukas;Gintarėliai;1485012710;Taip;0;1;2;3
4332;Kodėlčiukas;Gintarėliai;20084022099;Taip;3;1;1;5
4333;Kodėlčiukas;Gintarėliai;9686497547;Taip;0;1;2;3
4334;Kodėlčiukas;Gintarėliai;4884104023;Taip;0;1;0;1
4335;Kodėlčiukas;Gintarėliai;1632458573;Taip;0;2;0;2
4336;Kodėlčiukas;Gintarėliai;9332136116;Taip;5;1;0;6
4337;Kodėlčiukas;Gintarėliai;4944791330;Taip;0;0;1;1
4338;Kodėlčiukas;Gintarėliai;8219424737;Taip;0;1;0;1
4339;Kodėlčiukas;Gintarėliai;4849314647;Taip;8;1;0;9
4340;Kodėlčiukas;Gintarėliai;5202375085;Taip;5;1;2;8
4341;Kodėlčiukas;Gintarėliai;3758606327;Taip;0;1;2;3
4342;Kodėlčiukas;Gintarėliai;5093139270;Ne;0;1;1;2
4343;Kodėlčiukas;Gintarėliai;4738357524;Taip;0;1;1;2
4344;Kodėlčiukas;Gintarėliai;8873629130;Taip;8;1;0;9
4345;Kodėlčiukas;Gintarėliai;1190408818;Taip;0;1;10;11
4346;Kodėlčiukas;Gintarėliai;2162480212;Taip;0;1;3;4
4347;Kodėlčiukas;Gintarėliai;6764015170;Taip;3;3;0;6
4348;Kodėlčiukas;Gintarėliai;6248137523;Taip;7;0;0;7
4349;Kodėlčiukas;Gintarėliai;8606551477;Taip;0;1;4;5
4350;Kodėlčiukas;Šnekučiai;1844016431;Taip;0;0;2;2
4351;Kodėlčiukas;Šnekučiai;1935757837;Taip;0;2;0;2
4352;Kodėlčiukas;Šnekučiai;41123326737;Taip;0;1;0;1
4353;Kodėlčiukas;Šnekučiai;8114859362;Taip;0;11;0;11
4354;Kodėlčiukas;Šnekučiai;1666743304;Taip;1;1;0;2
4355;Kodėlčiukas;Šnekučiai;1432342305;Taip;0;1;3;4
4356;Kodėlčiukas;Šnekučiai;9178209049;Ne;0;1;6;7
4357;Kodėlčiukas;Šnekučiai;5988863934;Taip;0;0;2;2
4358;Kodėlčiukas;Šnekučiai;76164689333;Taip;4;1;0;5
4359;Kodėlčiukas;Šnekučiai;5386820408;Taip;0;4;0;4
4360;Kodėlčiukas;Šnekučiai;6194726931;Taip;0;5;0;5
4361;Kodėlčiukas;Šnekučiai;7074381835;Taip;1;0;0;1
4362;Kodėlčiukas;Šnekučiai;2988674717;Ne;10;4;3;17
4363;Kodėlčiukas;Šnekučiai;2244326972;Taip;0;0;3;3
4364;Kodėlčiukas;Šnekučiai;6761903865;Ne;0;3;0;3
4365;Kodėlčiukas;Šnekučiai;3778271049;Taip;8;1;1;10
4366;Kodėlčiukas;Šnekučiai;7647582987;Ne;0;1;0;1
4367;Kodėlčiukas;Šnekučiai;7510273691;Taip;1;0;0;1
4368;Kodėlčiukas;Pabiručiai;9278139998;Taip;6;3;0;9
4369;Kodėlčiukas;Pabiručiai;6008027505;Taip;0;1;0;1
4370;Kodėlčiukas;Pabiručiai;5894631257;Ne;3;1;0;4
4371;Kodėlčiukas;Pabiručiai;6065858518;Taip;0;1;0;1
4372;Kodėlčiukas;Pabiručiai;8586746296;Taip;0;1;1;2
4373;Kodėlčiukas;Pabiručiai;9480926599;Ne;15;1;0;16
4374;Kodėlčiukas;Pabiručiai;9511144369;Taip;0;0;2;2
4375;Kodėlčiukas;Pabiručiai;7246943802;Taip;4;1;3;8
4376;Kodėlčiukas;Pabiručiai;8189938439;Taip;0;0;2;2
4377;Kodėlčiukas;Pabiručiai;5587200800;Taip;7;0;0;7
4378;Kodėlčiukas;Pabiručiai;1433623973;Taip;1;10;0;11
4379;Kodėlčiukas;Pabiručiai;1087808091;Ne;0;2;0;2
4380;Kodėlčiukas;Pabiručiai;7570122834;Taip;0;1;0;1
4381;Kodėlčiukas;Pabiručiai;5359866071;Taip;0;1;0;1
4382;Kodėlčiukas;Pabiručiai;5801430256;Taip;1;3;0;4
4383;Kodėlčiukas;Pabiručiai;7455949617;Taip;0;3;0;3
4384;Kodėlčiukas;Pabiručiai;1039982141;Taip;5;0;0;5
4385;Kodėlčiukas;Pabiručiai;4507928289;Taip;0;0;1;1
4386;Kodėlčiukas;Pabiručiai;9830842598;Taip;6;0;5;11
4387;Kodėlčiukas;Pabiručiai;8291672306;Taip;0;0;2;2
4388;Kodėlčiukas;Pabiručiai;3882838712;Taip;0;1;1;2
4389;Kodėlčiukas;Pabiručiai;8635107742;Taip;0;0;1;1
4390;Kodėlčiukas;Smalsučiai;7630180473;Ne;0;2;4;6
4391;Kodėlčiukas;Smalsučiai;8140940288;Taip;0;1;0;1
4392;Kodėlčiukas;Smalsučiai;7246243975;Taip;4;2;0;6
4393;Kodėlčiukas;Smalsučiai;1600501494;Taip;0;2;0;2
4394;Kodėlčiukas;Smalsučiai;3880019350;Taip;0;1;0;1
4395;Kodėlčiukas;Smalsučiai;4818678923;Taip;0;6;0;6
4396;Kodėlčiukas;Smalsučiai;9589692031;Taip;7;0;1;8
4397;Kodėlčiukas;Smalsučiai;1906128091;Taip;0;1;1;2
4398;Kodėlčiukas;Smalsučiai;8302606312;Taip;0;2;0;2
4399;Kodėlčiukas;Smalsučiai;9460792167;Taip;6;2;0;8
4400;Kodėlčiukas;Smalsučiai;7324303899;Taip;0;1;0;1
4401;Kodėlčiukas;Smalsučiai;9794875862;Taip;0;1;6;7
4402;Kodėlčiukas;Smalsučiai;9528997865;Taip;0;4;4;8
4403;Kodėlčiukas;Smalsučiai;1919722425;Taip;0;1;4;5
4404;Kodėlčiukas;Smalsučiai;8879977943;Taip;11;0;0;11
4405;Kodėlčiukas;Smalsučiai;8647609373;Taip;0;10;0;10
4406;Kodėlčiukas;Smalsučiai;2062878300;Taip;3;1;2;6
4407;Kodėlčiukas;Smalsučiai;6950802941;Taip;8;1;2;11
4408;Kodėlčiukas;Smalsučiai;1233880820;Ne;8;2;0;10
4409;Kodėlčiukas;Smalsučiai;8296470927;Ne;0;1;0;1
4410;Kodėlčiukas;Giliukai;9754425363;Taip;11;1;0;12
4411;Kodėlčiukas;Giliukai;5587782917;Taip;9;3;0;12
4412;Kodėlčiukas;Giliukai;8100861190;Ne;0;8;0;8
4413;Kodėlčiukas;Giliukai;7639341503;Ne;0;1;0;1
4414;Kodėlčiukas;Giliukai;8017465692;Taip;6;4;0;10
4415;Kodėlčiukas;Giliukai;7937365710;Taip;10;0;1;11
4416;Kodėlčiukas;Giliukai;9733831323;Taip;0;5;4;9
4417;Kodėlčiukas;Giliukai;7007386353;Taip;0;1;0;1
4418;Kodėlčiukas;Giliukai;9721353724;Taip;0;1;4;5
4419;Kodėlčiukas;Giliukai;2943146610;Ne;0;0;1;1
4420;Kodėlčiukas;Giliukai;5573845415;Ne;10;0;1;11
4421;Kodėlčiukas;Giliukai;2122779530;Taip;10;0;1;11
4422;Kodėlčiukas;Giliukai;8785157050;Taip;9;10;0;19
4423;Kodėlčiukas;Giliukai;5770748359;Taip;0;13;0;13
4424;Kodėlčiukas;Giliukai;9992204262;Taip;11;0;1;12
4425;Kodėlčiukas;Giliukai;6643473339;Taip;0;8;0;8
4426;Kodėlčiukas;Giliukai;8107869258;Ne;0;0;2;2
4427;Kodėlčiukas;Giliukai;5909222351;Taip;6;14;1;21
4428;Kodėlčiukas;Giliukai;3130715310;Taip;6;1;0;7
4429;Kodėlčiukas;Giliukai;3686259290;Taip;0;0;12;12
4430;Kodėlčiukas;Gudručiai;1191430672;Taip;0;0;1;1
4431;Kodėlčiukas;Gudručiai;6988515253;Taip;0;10;0;10
4432;Kodėlčiukas;Gudručiai;3385551650;Taip;0;0;1;1
4433;Kodėlčiukas;Gudručiai;7318908956;Taip;1;0;0;1
4434;Kodėlčiukas;Gudručiai;8400610717;Taip;11;0;5;16
4435;Kodėlčiukas;Gudručiai;7116594055;Taip;0;0;4;4
4436;Kodėlčiukas;Gudručiai;1801366890;Taip;0;0;1;1
4437;Kodėlčiukas;Gudručiai;9483378853;Taip;0;4;0;4
4438;Kodėlčiukas;Gudručiai;8890987483;Ne;0;0;6;6
4439;Kodėlčiukas;Gudručiai;4687333060;Taip;0;1;0;1
4440;Kodėlčiukas;Gudručiai;1491160730;Taip;0;5;0;5
4441;Kodėlčiukas;Gudručiai;2216791610;Taip;1;0;0;1
4442;Kodėlčiukas;Gudručiai;2987907651;Taip;0;0;2;2
4443;Kodėlčiukas;Gudručiai;9028856983;Taip;8;0;2;10
4444;Kodėlčiukas;Gudručiai;1588132166;Taip;6;1;1;8
4445;Kodėlčiukas;Gudručiai;6014084915;Taip;0;9;3;12
4446;Kodėlčiukas;Gudručiai;3068084704;Taip;9;2;1;12
4447;Kodėlčiukas;Gudručiai;6985788287;Taip;1;0;0;1
4448;Kodėlčiukas;Gudručiai;3427610168;Taip;10;0;2;12
4449;Kodėlčiukas;Žirniukai;2402290604;Taip;6;0;3;9
4450;Kodėlčiukas;Žirniukai;6522019070;Taip;8;0;0;8
4451;Kodėlčiukas;Žirniukai;1050905569;Taip;5;0;3;8
4452;Kodėlčiukas;Žirniukai;3053949510;Ne;10;0;2;12
4453;Kodėlčiukas;Žirniukai;5325660102;Taip;7;0;0;7
4454;Kodėlčiukas;Žirniukai;8429572505;Taip;0;0;4;4
4455;Kodėlčiukas;Žirniukai;4321485862;Taip;2;0;6;8
4456;Kodėlčiukas;Žirniukai;1550287298;Taip;1;0;0;1
4457;Kodėlčiukas;Žirniukai;9045733092;Taip;5;0;10;15
4458;Kodėlčiukas;Žirniukai;4597473929;Taip;12;0;0;12
4459;Kodėlčiukas;Žirniukai;4969181023;Taip;1;0;0;1
4460;Kodėlčiukas;Žirniukai;9702236745;Taip;13;0;4;17
4461;Kodėlčiukas;Katinėliai;4730433849;Taip;1;0;2;3
4462;Kodėlčiukas;Katinėliai;4995538090;Ne;0;0;3;3
4463;Kodėlčiukas;Katinėliai;8045906704;Taip;0;0;4;4
4464;Kodėlčiukas;Katinėliai;7306085848;Taip;5;1;0;6
4465;Kodėlčiukas;Katinėliai;6576466300;Taip;5;1;2;8
4466;Kodėlčiukas;Katinėliai;5650077893;Taip;15;1;0;16
4467;Kodėlčiukas;Katinėliai;3239314295;Taip;1;0;3;4
4468;Kodėlčiukas;Katinėliai;9221561862;Taip;5;1;0;6
4469;Kodėlčiukas;Katinėliai;6355536268;Taip;5;0;0;5
4470;Kodėlčiukas;Katinėliai;2147517344;Taip;12;1;1;14
4471;Kodėlčiukas;Katinėliai;2119041584;Taip;11;0;0;11
4472;Kodėlčiukas;Katinėliai;9826174805;Taip;0;0;1;1
4473;Kodėlčiukas;Katinėliai;1570599010;Taip;4;0;0;4
4474;Kodėlčiukas;Katinėliai;4727546035;Taip;10;0;1;11
4475;Kodėlčiukas;Nykštukai;6670171992;Taip;7;0;1;8
4476;Kodėlčiukas;Nykštukai;6935233288;Taip;18;0;0;18
4477;Kodėlčiukas;Nykštukai;8823086730;Taip;16;0;1;17
4478;Kodėlčiukas;Nykštukai;7686420784;Taip;0;0;7;7
4479;Kodėlčiukas;Nykštukai;8348024909;Taip;2;0;1;3
4480;Kodėlčiukas;Nykštukai;8759498015;Ne;0;0;2;2
4481;Kodėlčiukas;Nykštukai;9418778626;Taip;3;0;1;4
4482;Kodėlčiukas;Nykštukai;8911944991;Ne;4;0;3;7
4483;Kodėlčiukas;Nykštukai;4293763647;Taip;1;0;0;1
4484;Kodėlčiukas;Nykštukai;3878358193;Taip;7;0;0;7
4485;Kodėlčiukas;Nykštukai;1835522972;Taip;13;0;0;13
4486;Kodėlčiukas;Nykštukai;4986413731;Taip;9;0;0;9
4487;Kodėlčiukas;Nykštukai;2802895479;Taip;0;9;4;13
4488;Kodėlčiukas;Nykštukai;9914565606;Taip;6;0;2;8
4489;Kodėlčiukas;ŽIOGELIAI;8769409404;Ne;10;0;0;10
4490;Kodėlčiukas;ŽIOGELIAI;5189091564;Taip;4;0;1;5
4491;Kodėlčiukas;ŽIOGELIAI;6745245907;Taip;4;0;3;7
4492;Kodėlčiukas;ŽIOGELIAI;9055399463;Taip;12;0;2;14
4493;Kodėlčiukas;ŽIOGELIAI;4672108384;Taip;12;0;0;12
4494;Kodėlčiukas;ŽIOGELIAI;2081199093;Taip;21;0;0;21
4495;Kodėlčiukas;ŽIOGELIAI;4779994281;Taip;15;0;0;15
4496;Kodėlčiukas;ŽIOGELIAI;5115939251;Taip;0;0;2;2
4497;Kodėlčiukas;ŽIOGELIAI;3223461282;Taip;10;0;0;10
4498;Kodėlčiukas;ŽIOGELIAI;3603781385;Taip;3;0;0;3
4499;Kodėlčiukas;ŽIOGELIAI;6749972956;Taip;13;0;3;16
4500;Kodėlčiukas;ŽIOGELIAI;2189949450;Taip;0;0;2;2
4501;Kodėlčiukas;ŽIOGELIAI;7497358286;Taip;10;0;3;13
4502;Kodėlčiukas;ŽIOGELIAI;2990546939;Taip;10;0;0;10
4503;Kodėlčiukas;ŽIOGELIAI;4089558399;Taip;16;0;1;17
4504;Kodėlčiukas;ŽIOGELIAI;6843492891;Taip;5;0;1;6
4505;Kodėlčiukas;ŽIOGELIAI;2933909503;Taip;16;0;1;17
4506;Kodėlčiukas;BITUTĖS;2313607716;Taip;5;0;0;5
4507;Kodėlčiukas;BITUTĖS;2438891967;Taip;10;0;0;10
4508;Kodėlčiukas;BITUTĖS;8829986201;Taip;3;0;1;4
4509;Kodėlčiukas;BITUTĖS;3985455729;Taip;0;8;2;10
4510;Kodėlčiukas;BITUTĖS;8144034996;Ne;0;0;3;3
4511;Kodėlčiukas;BITUTĖS;3156788328;Taip;8;0;0;8
4512;Kodėlčiukas;BITUTĖS;7910205296;Taip;1;0;7;8
4513;Kodėlčiukas;BITUTĖS;9736751250;Taip;0;0;3;3
4514;Kodėlčiukas;BITUTĖS;8037386529;Ne;0;7;0;7
4515;Kodėlčiukas;BITUTĖS;1047209628;Taip;13;0;8;21
4516;Kodėlčiukas;BITUTĖS;5068611716;Ne;8;0;0;8
4517;Kodėlčiukas;BITUTĖS;8932472612;Taip;0;0;5;5
4518;Kodėlčiukas;BITUTĖS;7186835214;Taip;0;0;2;2
4519;Kodėlčiukas;BITUTĖS;4529565626;Taip;4;0;1;5
4520;Kodėlčiukas;BITUTĖS;7227149646;Taip;0;0;4;4
4521;Kodėlčiukas;BITUTĖS;1568628843;Taip;0;8;0;8
4522;Kodėlčiukas;BITUTĖS;9209671311;Ne;19;0;0;19
4523;Kodėlčiukas;BITUTĖS;6726383331;Ne;11;0;0;11
4524;Kodėlčiukas;VYŠNIUKAI;7643398934;Taip;5;2;1;8
4525;Kodėlčiukas;VYŠNIUKAI;8799798070;Taip;0;0;4;4
4526;Kodėlčiukas;VYŠNIUKAI;7119815662;Taip;8;1;2;11
4527;Kodėlčiukas;VYŠNIUKAI;9398732476;Taip;3;0;5;8
4528;Kodėlčiukas;VYŠNIUKAI;2720748563;Taip;9;1;0;10
4529;Kodėlčiukas;VYŠNIUKAI;2871111867;Taip;11;1;0;12
4530;Kodėlčiukas;VYŠNIUKAI;9914322177;Taip;3;0;1;4
4531;Kodėlčiukas;VYŠNIUKAI;1925590099;Taip;3;0;1;4
4532;Kodėlčiukas;VYŠNIUKAI;7242653444;Taip;9;0;1;10
4533;Kodėlčiukas;VYŠNIUKAI;2298734536;Taip;0;2;0;2
4534;Kodėlčiukas;VYŠNIUKAI;7848240865;Taip;0;1;2;3
4535;Kodėlčiukas;VYŠNIUKAI;6261333618;Ne;5;0;1;6
4536;Kodėlčiukas;VYŠNIUKAI;2549153581;Taip;20;1;0;21
4537;Kodėlčiukas;VYŠNIUKAI;1808211253;Taip;1;0;0;1
4538;Kodėlčiukas;VYŠNIUKAI;5178305435;Ne;4;0;4;8
4539;Kodėlčiukas;VYŠNIUKAI;5061852590;Taip;8;1;0;9
4540;Kodėlčiukas;VYŠNIUKAI;4782931414;Taip;7;1;0;8
4541;Kodėlčiukas;VYŠNIUKAI;1803320085;Taip;0;0;2;2
4542;Kodėlčiukas;VYŠNIUKAI;3938536446;Taip;0;0;2;2
4543;Kodėlčiukas;BORUŽĖLĖS;9109362006;Taip;0;1;0;1
4544;Kodėlčiukas;BORUŽĖLĖS;9169500252;Taip;6;0;0;6
4545;Kodėlčiukas;BORUŽĖLĖS;9724373368;Taip;0;8;0;8
4546;Kodėlčiukas;BORUŽĖLĖS;5075801618;Taip;12;0;2;14
4547;Kodėlčiukas;BORUŽĖLĖS;2819860331;Taip;0;0;1;1
4548;Kodėlčiukas;BORUŽĖLĖS;4941186694;Taip;0;1;2;3
4549;Kodėlčiukas;BORUŽĖLĖS;4866089623;Taip;0;1;0;1
4550;Kodėlčiukas;BORUŽĖLĖS;5952121209;Taip;0;7;0;7
4551;Kodėlčiukas;BORUŽĖLĖS;4230906452;Taip;0;3;0;3
4552;Kodėlčiukas;BORUŽĖLĖS;8779350309;Taip;0;0;1;1
4553;Kodėlčiukas;BORUŽĖLĖS;9208137169;Ne;0;6;4;10
4554;Kodėlčiukas;BORUŽĖLĖS;5876187643;Ne;0;0;1;1
4555;Kodėlčiukas;BORUŽĖLĖS;1206798597;Taip;0;16;0;16
4556;Kodėlčiukas;BORUŽĖLĖS;6587593805;Taip;0;0;3;3
4557;Kodėlčiukas;BORUŽĖLĖS;1827752731;Taip;4;1;2;7
4558;Kodėlčiukas;BORUŽĖLĖS;1005178052;Taip;0;0;1;1
4559;Kodėlčiukas;BORUŽĖLĖS;1889809198;Taip;0;0;1;1
4560;Kodėlčiukas;BORUŽĖLĖS;4490196764;Taip;0;0;4;4
4561;Kodėlčiukas;BORUŽĖLĖS;1074477043;Taip;8;0;1;9
4562;Kodėlčiukas;BORUŽĖLĖS;2351468626;Taip;5;2;0;7
4563;Kodėlčiukas;BORUŽĖLĖS;3403889915;Taip;0;11;0;11
4564;Kodėlčiukas;VYTURĖLIAI;6714818379;Taip;0;8;0;8
4565;Kodėlčiukas;VYTURĖLIAI;4218096561;Taip;0;7;0;7
4566;Kodėlčiukas;VYTURĖLIAI;4514764005;Taip;0;1;0;1
4567;Kodėlčiukas;VYTURĖLIAI;2169307879;Taip;11;0;1;12
4568;Kodėlčiukas;VYTURĖLIAI;2448536092;Taip;3;0;0;3
4569;Kodėlčiukas;VYTURĖLIAI;4585226357;Taip;0;0;2;2
4570;Kodėlčiukas;VYTURĖLIAI;4884233329;Taip;6;0;1;7
4571;Kodėlčiukas;VYTURĖLIAI;8263945732;Taip;10;0;1;11
4572;Kodėlčiukas;VYTURĖLIAI;2904858964;Taip;12;1;0;13
4573;Kodėlčiukas;VYTURĖLIAI;3413659259;Taip;0;0;1;1
4574;Kodėlčiukas;VYTURĖLIAI;9673271313;Taip;0;0;3;3
4575;Kodėlčiukas;VYTURĖLIAI;5710301153;Taip;0;0;8;8
4576;Kodėlčiukas;VYTURĖLIAI;5474125905;Taip;7;2;0;9
4577;Kodėlčiukas;VYTURĖLIAI;8427457478;Taip;10;3;0;13
4578;Kodėlčiukas;VYTURĖLIAI;5181211722;Taip;17;0;0;17
4579;Kodėlčiukas;VYTURĖLIAI;3472862544;Ne;2;0;1;3
4580;Kodėlčiukas;VYTURĖLIAI;5921714669;Taip;4;4;0;8
4581;Kodėlčiukas;VYTURĖLIAI;7778188733;Taip;10;1;0;11
4582;Kodėlčiukas;DRUGELIAI;4165123345;Taip;3;0;1;4
4583;Kodėlčiukas;DRUGELIAI;5772071707;Taip;8;0;1;9
4584;Kodėlčiukas;DRUGELIAI;1149682376;Taip;0;0;1;1
4585;Kodėlčiukas;DRUGELIAI;7587203481;Taip;1;1;0;2
4586;Kodėlčiukas;DRUGELIAI;2353960861;Taip;0;1;1;2
4587;Kodėlčiukas;DRUGELIAI;3267687337;Taip;11;0;1;12
4588;Kodėlčiukas;DRUGELIAI;5505788210;Taip;0;0;2;2
4589;Kodėlčiukas;DRUGELIAI;5577154148;Taip;8;1;0;9
4590;Kodėlčiukas;DRUGELIAI;8547039654;Taip;0;0;2;2
4591;Kodėlčiukas;DRUGELIAI;4202423480;Taip;0;2;1;3
4592;Kodėlčiukas;DRUGELIAI;9979034031;Taip;0;5;0;5
4593;Kodėlčiukas;DRUGELIAI;3240221130;Ne;0;1;0;1
4594;Kodėlčiukas;DRUGELIAI;7714816675;Taip;13;1;0;14
4595;Kodėlčiukas;DRUGELIAI;9139424911;Ne;0;0;2;2
4596;Kodėlčiukas;DRUGELIAI;9664432781;Taip;0;2;3;5
4597;Kodėlčiukas;DRUGELIAI;5197946954;Taip;5;0;2;7
4598;Kodėlčiukas;DRUGELIAI;8315176054;Taip;0;8;1;9
4599;Kodėlčiukas;DRUGELIAI;3651073383;Taip;0;0;2;2
4600;Kodėlčiukas;DRUGELIAI;3854719881;Taip;9;0;0;9
4601;Kodėlčiukas;DRUGELIAI;7908217415;Taip;8;0;0;8
4602;Kodėlčiukas;OBUOLIUKAI;8784531004;Taip;1;0;0;1
4603;Kodėlčiukas;OBUOLIUKAI;1289342844;Taip;0;5;0;5
4604;Kodėlčiukas;OBUOLIUKAI;7318196860;Taip;3;0;0;3
4605;Kodėlčiukas;OBUOLIUKAI;8208448849;Taip;5;1;0;6
4606;Kodėlčiukas;OBUOLIUKAI;1683506414;Taip;8;0;0;8
4607;Kodėlčiukas;OBUOLIUKAI;3315862631;Taip;0;4;3;7
4608;Kodėlčiukas;OBUOLIUKAI;5896726125;Taip;0;0;5;5
4609;Kodėlčiukas;OBUOLIUKAI;3168418461;Taip;0;6;0;6
4610;Kodėlčiukas;OBUOLIUKAI;9645987751;Taip;10;2;0;12
4611;Kodėlčiukas;OBUOLIUKAI;5860975805;Taip;2;0;0;2
4612;Kodėlčiukas;OBUOLIUKAI;8782155591;Taip;6;1;0;7
4613;Kodėlčiukas;OBUOLIUKAI;8104220950;Taip;0;13;0;13
4614;Kodėlčiukas;OBUOLIUKAI;2005453189;Taip;10;0;1;11
4615;Kodėlčiukas;OBUOLIUKAI;1180399735;Taip;0;1;0;1
4616;Kodėlčiukas;OBUOLIUKAI;5173730926;Taip;9;1;2;12
4617;Kodėlčiukas;OBUOLIUKAI;3442449482;Taip;4;0;2;6
4618;Kodėlčiukas;OBUOLIUKAI;7946010973;Ne;7;1;0;8
4619;Kodėlčiukas;OBUOLIUKAI;5342852235;Taip;12;0;3;15
4620;Kodėlčiukas;OBUOLIUKAI;8563412043;Ne;8;0;1;9
4621;Kodėlčiukas;OBUOLIUKAI;4026784012;Taip;5;0;4;9
4622;Kodėlčiukas;OBUOLIUKAI;2114176689;Ne;0;21;0;21
4623;Kodėlčiukas;OBUOLIUKAI;3033687110;Ne;9;2;1;12
4624;Kurpaitė;Viščiukų;4657523142;Taip;0;1;0;1
4625;Kurpaitė;Viščiukų;2157581956;Taip;0;19;0;19
4626;Kurpaitė;Viščiukų;3481813493;Taip;5;1;0;6
4627;Kurpaitė;Viščiukų;8402747029;Taip;0;3;0;3
4628;Kurpaitė;Viščiukų;4687182527;Taip;9;0;0;9
4629;Kurpaitė;Viščiukų;2373582223;Taip;0;21;0;21
4630;Kurpaitė;Viščiukų;7194351335;Taip;8;0;0;8
4631;Kurpaitė;Viščiukų;5701318496;Taip;5;1;0;6
4632;Kurpaitė;Viščiukų;2744439309;Ne;0;4;0;4
4633;Kurpaitė;Viščiukų;5923694769;Taip;10;0;0;10
4634;Kurpaitė;Viščiukų;5557028481;Taip;0;1;0;1
4635;Kurpaitė;Viščiukų;5447826458;Taip;0;8;0;8
4636;Kurpaitė;Viščiukų;9825971721;Taip;0;5;0;5
4637;Kurpaitė;Viščiukų;2867842844;Taip;10;0;0;10
4638;Kurpaitė;Viščiukų;6859316204;Taip;16;0;0;16
4639;Kurpaitė;Gėlyčių;6466518987;Taip;0;6;0;6
4640;Kurpaitė;Gėlyčių;9769835612;Taip;0;7;0;7
4641;Kurpaitė;Gėlyčių;5745448950;Taip;8;4;0;12
4642;Kurpaitė;Gėlyčių;5952306163;Taip;0;5;0;5
4643;Kurpaitė;Gėlyčių;3989274600;Taip;0;1;0;1
4644;Kurpaitė;Gėlyčių;3139272175;Taip;0;4;0;4
4645;Kurpaitė;Gėlyčių;4769611100;Taip;11;2;0;13
4646;Kurpaitė;Gėlyčių;4426311033;Taip;0;3;0;3
4647;Kurpaitė;Gėlyčių;1927773278;Taip;0;13;0;13
4648;Kurpaitė;Gėlyčių;9221882007;Taip;6;1;0;7
4649;Kurpaitė;Gėlyčių;3456815576;Taip;0;15;0;15
4650;Kurpaitė;Gėlyčių;8361612709;Taip;0;9;0;9
4651;Kurpaitė;Gėlyčių;4754807319;Taip;5;0;0;5
4652;Kurpaitė;Gėlyčių;4607835570;Taip;10;0;0;10
4653;Kurpaitė;Gėlyčių;1964193512;Ne;0;11;0;11
4654;Kurpaitė;Drugelių;9384218589;Taip;0;7;0;7
4655;Kurpaitė;Drugelių;5844470373;Taip;8;0;0;8
4656;Kurpaitė;Drugelių;5609161523;Taip;5;1;0;6
4657;Kurpaitė;Drugelių;9200404698;Ne;0;13;0;13
4658;Kurpaitė;Drugelių;5064875626;Taip;4;0;0;4
4659;Kurpaitė;Drugelių;4592795281;Taip;0;18;0;18
4660;Kurpaitė;Drugelių;9480290430;Taip;0;1;0;1
4661;Kurpaitė;Drugelių;8868415451;Taip;0;1;0;1
4662;Kurpaitė;Drugelių;2290343066;Taip;0;15;0;15
4663;Kurpaitė;Drugelių;4188925256;Taip;0;4;0;4
4664;Kurpaitė;Drugelių;1273426668;Taip;0;7;0;7
4665;Kurpaitė;Drugelių;1413326858;Ne;3;0;0;3
4666;Kurpaitė;Drugelių;3634641300;Taip;0;1;0;1
4667;Kurpaitė;Drugelių;4602268315;Taip;2;1;0;3
4668;Kurpaitė;Drugelių;6568580994;Taip;0;11;0;11
4669;Kurpaitė;Pelyčių;4964063637;Taip;0;0;1;1
4670;Kurpaitė;Pelyčių;7546409044;Taip;0;7;0;7
4671;Kurpaitė;Pelyčių;7249931704;Taip;0;2;0;2
4672;Kurpaitė;Pelyčių;1218040871;Taip;4;4;0;8
4673;Kurpaitė;Pelyčių;1505783589;Taip;0;4;0;4
4674;Kurpaitė;Pelyčių;2359555461;Taip;0;2;0;2
4675;Kurpaitė;Pelyčių;65434834152;Taip;0;5;0;5
4676;Kurpaitė;Pelyčių;9063294667;Taip;0;1;0;1
4677;Kurpaitė;Pelyčių;4312062240;Ne;8;1;0;9
4678;Kurpaitė;Pelyčių;2827617670;Taip;0;1;0;1
4679;Kurpaitė;Pelyčių;1457318954;Taip;0;8;0;8
4680;Kurpaitė;Pelyčių;7897713994;Taip;0;1;0;1
4681;Kurpaitė;Pelyčių;4168882748;Taip;0;5;0;5
4682;Kurpaitė;Pelyčių;72710210157;Taip;3;1;2;6
4683;Kurpaitė;Pelyčių;1094620507;Taip;0;1;0;1
4684;Kurpaitė;Pelyčių;58127430940;Taip;0;9;0;9
4685;Kurpaitė;Pelyčių;2116580903;Taip;0;2;0;2
4686;Kurpaitė;Pelyčių;24410351286;Taip;0;11;0;11
4687;"Kūlverstukas (Suvalkų g. 6)";Saulutės;7449993309;Ne;6;0;2;8
4688;"Kūlverstukas (Suvalkų g. 6)";Saulutės;2450625415;Ne;9;0;2;11
4689;"Kūlverstukas (Suvalkų g. 6)";Saulutės;2101490038;Taip;9;0;2;11
4690;"Kūlverstukas (Suvalkų g. 6)";Saulutės;7118949795;Taip;0;1;1;2
4691;"Kūlverstukas (Suvalkų g. 6)";Saulutės;4173514390;Taip;0;0;4;4
4692;"Kūlverstukas (Suvalkų g. 6)";Saulutės;2762230590;Ne;9;0;0;9
4693;"Kūlverstukas (Suvalkų g. 6)";Saulutės;5103259175;Taip;0;0;1;1
4694;"Kūlverstukas (Suvalkų g. 6)";Saulutės;9167460438;Taip;9;8;0;17
4695;"Kūlverstukas (Suvalkų g. 6)";Saulutės;8319255735;Taip;6;0;0;6
4696;"Kūlverstukas (Suvalkų g. 6)";Saulutės;4846324136;Ne;1;0;0;1
4697;"Kūlverstukas (Suvalkų g. 6)";Saulutės;7505926208;Taip;0;3;0;3
4698;"Kūlverstukas (Suvalkų g. 6)";Saulutės;1014630718;Ne;0;3;0;3
4699;"Kūlverstukas (Suvalkų g. 6)";Saulutės;1795306946;Ne;19;0;0;19
4700;"Kūlverstukas (Suvalkų g. 6)";Saulutės;5340239466;Taip;0;5;0;5
4701;"Kūlverstukas (Suvalkų g. 6)";Saulutės;3448880105;Taip;6;1;4;11
4702;"Kūlverstukas (Suvalkų g. 6)";Saulutės;7970898546;Ne;2;1;0;3
4703;"Kūlverstukas (Suvalkų g. 6)";Saulutės;4532151103;Taip;4;0;0;4
4704;"Kūlverstukas (Suvalkų g. 6)";Peledžiukai;5488011852;Ne;10;0;1;11
4705;"Kūlverstukas (Suvalkų g. 6)";Peledžiukai;3937419139;Taip;0;1;0;1
4706;"Kūlverstukas (Suvalkų g. 6)";Peledžiukai;1452422691;Ne;5;1;7;13
4707;"Kūlverstukas (Suvalkų g. 6)";Peledžiukai;5372936730;Ne;0;1;0;1
4708;"Kūlverstukas (Suvalkų g. 6)";Peledžiukai;4396230034;Taip;6;0;2;8
4709;"Kūlverstukas (Suvalkų g. 6)";Peledžiukai;7359354944;Taip;0;2;0;2
4710;"Kūlverstukas (Suvalkų g. 6)";Peledžiukai;8853848991;Ne;0;0;2;2
4711;"Kūlverstukas (Suvalkų g. 6)";Peledžiukai;6287636806;Ne;1;0;0;1
4712;"Kūlverstukas (Suvalkų g. 6)";Peledžiukai;8092104136;Taip;11;1;1;13
4713;"Kūlverstukas (Suvalkų g. 6)";Peledžiukai;3238807604;Taip;4;2;0;6
4714;"Kūlverstukas (Suvalkų g. 6)";Peledžiukai;1932066021;Taip;15;0;0;15
4715;"Kūlverstukas (Suvalkų g. 6)";Peledžiukai;9655585527;Taip;2;1;0;3
4716;"Kūlverstukas (Suvalkų g. 6)";Peledžiukai;5488852698;Taip;9;1;0;10
4717;"Kūlverstukas (Suvalkų g. 6)";Peledžiukai;5345423038;Taip;0;6;0;6
4718;"Kūlverstukas (Suvalkų g. 6)";Peledžiukai;3270176280;Taip;0;7;0;7
4719;"Kūlverstukas (Suvalkų g. 6)";Peledžiukai;4285624305;Taip;6;0;0;6
4720;"Kūlverstukas (Suvalkų g. 6)";Gelytės;8353856412;Ne;3;5;0;8
4721;"Kūlverstukas (Suvalkų g. 6)";Gelytės;3811616695;Taip;8;3;0;11
4722;"Kūlverstukas (Suvalkų g. 6)";Gelytės;3162808486;Ne;4;0;1;5
4723;"Kūlverstukas (Suvalkų g. 6)";Gelytės;8346712630;Taip;0;1;0;1
4724;"Kūlverstukas (Suvalkų g. 6)";Gelytės;1939668692;Ne;14;5;0;19
4725;"Kūlverstukas (Suvalkų g. 6)";Gelytės;4651091340;Ne;0;21;0;21
4726;"Kūlverstukas (Suvalkų g. 6)";Gelytės;7112217569;Ne;2;5;1;8
4727;"Kūlverstukas (Suvalkų g. 6)";Gelytės;5391554530;Taip;0;5;0;5
4728;"Kūlverstukas (Suvalkų g. 6)";Gelytės;8701405518;Taip;0;2;3;5
4729;"Kūlverstukas (Suvalkų g. 6)";Gelytės;4111966910;Taip;6;0;0;6
4730;"Kūlverstukas (Suvalkų g. 6)";Gelytės;8964753108;Taip;0;1;0;1
4731;"Kūlverstukas (Suvalkų g. 6)";Gelytės;2389231051;Taip;0;1;0;1
4732;"Kūlverstukas (Suvalkų g. 6)";Gelytės;1067182820;Taip;6;5;2;13
4733;"Kūlverstukas (Suvalkų g. 6)";Gelytės;2316978273;Taip;0;4;0;4
4734;"Kūlverstukas (Suvalkų g. 6)";Gelytės;8333084277;Taip;6;1;1;8
4735;"Kūlverstukas (Suvalkų g. 6)";Gelytės;6710735721;Taip;0;3;3;6
4736;"Kūlverstukas (Suvalkų g. 6)";Gelytės;8618967238;Taip;0;0;1;1
4737;"Kūlverstukas (Suvalkų g. 6)";Bitutės;1679412281;Taip;4;0;0;4
4738;"Kūlverstukas (Suvalkų g. 6)";Bitutės;3790418633;Taip;3;0;0;3
4739;"Kūlverstukas (Suvalkų g. 6)";Bitutės;9777005699;Ne;10;0;0;10
4740;"Kūlverstukas (Suvalkų g. 6)";Bitutės;8599785196;Ne;10;0;0;10
4741;"Kūlverstukas (Suvalkų g. 6)";Bitutės;2082087440;Ne;0;4;0;4
4742;"Kūlverstukas (Suvalkų g. 6)";Bitutės;9976311692;Taip;0;7;0;7
4743;"Kūlverstukas (Suvalkų g. 6)";Bitutės;9600326594;Taip;0;21;0;21
4744;"Kūlverstukas (Suvalkų g. 6)";Bitutės;6319075079;Taip;13;0;0;13
4745;"Kūlverstukas (Suvalkų g. 6)";Bitutės;1062604474;Taip;0;5;0;5
4746;"Kūlverstukas (Suvalkų g. 6)";Bitutės;3712773480;Taip;5;0;2;7
4747;"Kūlverstukas (Suvalkų g. 6)";Bitutės;1985177751;Taip;0;1;12;13
4748;"Kūlverstukas (Suvalkų g. 6)";Bitutės;2924333435;Taip;2;0;1;3
4749;"Kūlverstukas (Suvalkų g. 6)";Bitutės;9787833724;Taip;0;0;1;1
4750;"Kūlverstukas (Suvalkų g. 6)";Bitutės;3370339665;Taip;2;0;0;2
4751;"Kūlverstukas (Suvalkų g. 6)";Bitutės;6916013898;Taip;4;0;2;6
4752;Lakštingala;Saulutės;2156571482;Ne;0;2;4;6
4753;Lakštingala;Saulutės;4651600682;Taip;2;0;3;5
4754;Lakštingala;Saulutės;2084960114;Ne;0;0;5;5
4755;Lakštingala;Saulutės;1598639284;Taip;0;2;0;2
4756;Lakštingala;Saulutės;2742489026;Ne;8;0;1;9
4757;Lakštingala;Saulutės;1243254166;Taip;0;17;0;17
4758;Lakštingala;Saulutės;9628476764;Ne;0;2;0;2
4759;Lakštingala;Saulutės;4344553248;Taip;21;0;0;21
4760;Lakštingala;Saulutės;6567480562;Taip;0;1;0;1
4761;Lakštingala;Saulutės;9495341480;Taip;2;3;0;5
4762;Lakštingala;Saulutės;2543779273;Taip;20;0;0;20
4763;Lakštingala;Saulutės;2093953744;Taip;0;2;0;2
4764;Lakštingala;Saulutės;1074616528;Taip;0;0;5;5
4765;Lakštingala;Saulutės;2626498928;Taip;9;2;0;11
4766;Lakštingala;Saulutės;9441296489;Taip;5;2;0;7
4767;Lakštingala;Saulutės;6369696598;Taip;11;0;0;11
4768;Lakštingala;Saulutės;9297542026;Taip;0;6;0;6
4769;Lakštingala;Saulutės;9899997020;Taip;4;1;0;5
4770;Lakštingala;Saulutės;8130468345;Taip;0;2;0;2
4771;Lakštingala;Nykštukai;9725851433;Taip;0;0;3;3
4772;Lakštingala;Nykštukai;8217315818;Ne;0;0;3;3
4773;Lakštingala;Nykštukai;2769474812;Ne;0;1;0;1
4774;Lakštingala;Nykštukai;2941128360;Ne;0;1;0;1
4775;Lakštingala;Nykštukai;9912622093;Taip;0;0;1;1
4776;Lakštingala;Nykštukai;3509165175;Taip;2;0;2;4
4777;Lakštingala;Nykštukai;3993759015;Taip;9;8;0;17
4778;Lakštingala;Nykštukai;5445945319;Taip;0;9;0;9
4779;Lakštingala;Nykštukai;6332498461;Taip;3;0;3;6
4780;Lakštingala;Nykštukai;1655202909;Taip;0;3;13;16
4781;Lakštingala;Nykštukai;6009631424;Taip;3;2;0;5
4782;Lakštingala;Nykštukai;5162605666;Taip;6;1;1;8
4783;Lakštingala;Nykštukai;2073818724;Taip;0;0;1;1
4784;Lakštingala;Nykštukai;7994475429;Taip;0;1;0;1
4785;Lakštingala;Nykštukai;1863034132;Taip;0;0;21;21
4786;Lakštingala;Nykštukai;6292331193;Taip;1;0;0;1
4787;Lakštingala;Nykštukai;9489982241;Taip;4;1;0;5
4788;Lakštingala;Nykštukai;4032030375;Taip;0;3;0;3
4789;Lakštingala;Nykštukai;2652305131;Taip;0;21;0;21
4790;Lakštingala;Nykštukai;7963839249;Taip;0;0;4;4
4791;Lakštingala;Nykštukai;9375002191;Taip;0;0;3;3
4792;Lakštingala;Nykštukai;4179366572;Taip;1;0;12;13
4793;Lakštingala;Bitutės;8890852891;Taip;0;1;3;4
4794;Lakštingala;Bitutės;5851957031;Ne;0;5;0;5
4795;Lakštingala;Bitutės;7918688955;Taip;0;1;0;1
4796;Lakštingala;Bitutės;9395512638;Taip;0;1;0;1
4797;Lakštingala;Bitutės;9958821769;Taip;4;3;1;8
4798;Lakštingala;Bitutės;7953724873;Taip;0;2;0;2
4799;Lakštingala;Bitutės;7900597697;Taip;0;2;0;2
4800;Lakštingala;Bitutės;8470575927;Taip;0;1;0;1
4801;Lakštingala;Bitutės;1411121466;Taip;0;2;0;2
4802;Lakštingala;Bitutės;8944088082;Taip;0;2;0;2
4803;Lakštingala;Bitutės;9897713625;Taip;0;1;0;1
4804;Lakštingala;Bitutės;2104150466;Taip;0;2;2;4
4805;Lakštingala;Bitutės;70798601578;Taip;0;4;0;4
4806;Lakštingala;Bitutės;1736130324;Taip;0;2;0;2
4807;Lakštingala;Bitutės;2039579203;Taip;0;2;0;2
4808;Lakštingala;Bitutės;5672932116;Ne;0;3;7;10
4809;Lakštingala;Bitutės;5598711072;Taip;0;2;0;2
4810;Lakštingala;Bitutės;9346986726;Taip;0;3;0;3
4811;Lakštingala;Bitutės;3872205876;Taip;11;0;0;11
4812;Lakštingala;Bitutės;5920907667;Taip;3;5;4;12
4813;Lakštingala;Bitutės;8679582358;Taip;0;0;4;4
4814;Lakštingala;Bitutės;2266870318;Taip;0;1;3;4
4815;Lakštingala;Pūkeliai;9774836470;Taip;0;1;0;1
4816;Lakštingala;Pūkeliai;1958696382;Taip;0;1;4;5
4817;Lakštingala;Pūkeliai;4542992319;Taip;9;0;0;9
4818;Lakštingala;Pūkeliai;2593030897;Taip;0;2;0;2
4819;Lakštingala;Pūkeliai;6908873466;Taip;0;1;0;1
4820;Lakštingala;Pūkeliai;7929034243;Taip;0;11;0;11
4821;Lakštingala;Pūkeliai;2130192341;Taip;16;1;0;17
4822;Lakštingala;Pūkeliai;8165998647;Taip;18;0;0;18
4823;Lakštingala;Pūkeliai;1458348357;Taip;5;0;1;6
4824;Lakštingala;Pūkeliai;4465752871;Taip;8;0;0;8
4825;Lakštingala;Pūkeliai;5379344261;Taip;0;3;0;3
4826;Lakštingala;Pūkeliai;4722328994;Taip;3;1;0;4
4827;Lakštingala;Pūkeliai;7272454093;Taip;0;0;4;4
4828;Lakštingala;Pūkeliai;1587899391;Taip;0;5;0;5
4829;Lakštingala;Pūkeliai;6234559044;Taip;0;0;9;9
4830;Lakštingala;Pūkeliai;5727308039;Taip;0;2;0;2
4831;Lakštingala;Pūkeliai;5051773825;Taip;1;0;0;1
4832;Lakštingala;Pūkeliai;9390342572;Taip;0;2;0;2
4833;Lakštingala;Pūkeliai;5949665703;Taip;0;0;1;1
4834;Lakštingala;Pūkeliai;6565318145;Taip;1;0;0;1
4835;Lakštingala;Pūkeliai;4384468922;Taip;2;3;4;9
4836;Lakštingala;Pūkeliai;2423761155;Taip;10;1;0;11
4837;Lakštingala;Pūkeliai;8171357606;Taip;11;1;0;12
4838;Lakštingala;Aitvariukai;9629855134;Taip;0;1;0;1
4839;Lakštingala;Aitvariukai;4546036762;Taip;9;0;1;10
4840;Lakštingala;Aitvariukai;6219896499;Taip;0;4;0;4
4841;Lakštingala;Aitvariukai;7876311404;Taip;0;0;1;1
4842;Lakštingala;Aitvariukai;1248909711;Taip;6;2;3;11
4843;Lakštingala;Aitvariukai;9676872125;Taip;0;1;0;1
4844;Lakštingala;Aitvariukai;9083753159;Taip;3;0;1;4
4845;Lakštingala;Aitvariukai;7879280198;Taip;6;3;0;9
4846;Lakštingala;Aitvariukai;4403673558;Ne;6;4;1;11
4847;Lakštingala;Aitvariukai;5693413287;Ne;0;2;5;7
4848;Lakštingala;Aitvariukai;7240426529;Ne;18;2;0;20
4849;Lakštingala;Aitvariukai;8558000223;Taip;3;1;0;4
4850;Lakštingala;Aitvariukai;5244646855;Taip;3;0;1;4
4851;Lakštingala;Aitvariukai;5602079341;Taip;17;0;0;17
4852;Lakštingala;Aitvariukai;7404386777;Taip;5;0;0;5
4853;Lakštingala;Aitvariukai;3166474163;Taip;0;2;0;2
4854;Lakštingala;Aitvariukai;8609822839;Taip;3;2;1;6
4855;Lakštingala;Aitvariukai;6180443056;Taip;11;0;0;11
4856;Lakštingala;Aitvariukai;3113050690;Ne;0;2;0;2
4857;Lakštingala;Boružiukai;9004336424;Ne;0;8;0;8
4858;Lakštingala;Boružiukai;87470014156;Taip;0;1;0;1
4859;Lakštingala;Boružiukai;8820053026;Taip;0;1;0;1
4860;Lakštingala;Boružiukai;2072883878;Taip;0;1;0;1
4861;Lakštingala;Boružiukai;4811759034;Taip;0;2;0;2
4862;Lakštingala;Boružiukai;1898853302;Taip;0;3;1;4
4863;Lakštingala;Boružiukai;4818524423;Taip;7;1;0;8
4864;Lakštingala;Boružiukai;1444534032;Taip;0;1;0;1
4865;Lakštingala;Boružiukai;9724531753;Taip;0;2;0;2
4866;Lakštingala;Boružiukai;1783776913;Taip;0;2;0;2
4867;Lakštingala;Boružiukai;1106475925;Ne;0;1;1;2
4868;Lakštingala;Boružiukai;1667277983;Taip;0;1;0;1
4869;Lakštingala;Boružiukai;6947565845;Taip;0;3;0;3
4870;Lakštingala;Boružiukai;3009692491;Taip;0;7;0;7
4871;Lakštingala;Boružiukai;1800927281;Ne;6;4;1;11
4872;Lakštingala;Boružiukai;9998322501;Taip;0;3;3;6
4873;Lakštingala;Boružiukai;2304340938;Taip;0;1;0;1
4874;Lakštingala;Boružiukai;8284565948;Ne;0;1;0;1
4875;Lakštingala;Boružiukai;9445476887;Taip;0;1;0;1
4876;Lakštingala;Boružiukai;8899572475;Taip;0;1;2;3
4877;Lakštingala;Boružiukai;9492056071;Ne;0;1;0;1
4878;Lakštingala;Žiogeliai;5048686136;Taip;0;0;2;2
4879;Lakštingala;Žiogeliai;8404025659;Taip;0;0;10;10
4880;Lakštingala;Žiogeliai;4113993067;Ne;0;3;0;3
4881;Lakštingala;Žiogeliai;6981178960;Taip;0;2;7;9
4882;Lakštingala;Žiogeliai;3908175786;Taip;14;0;1;15
4883;Lakštingala;Žiogeliai;9860169528;Taip;0;0;1;1
4884;Lakštingala;Žiogeliai;4935753482;Taip;7;4;2;13
4885;Lakštingala;Žiogeliai;5008933316;Taip;1;0;0;1
4886;Lakštingala;Žiogeliai;3439681068;Taip;0;1;0;1
4887;Lakštingala;Žiogeliai;3766986041;Taip;17;0;1;18
4888;Lakštingala;Žiogeliai;1974950823;Taip;8;1;0;9
4889;Lakštingala;Žiogeliai;6561743084;Taip;0;2;0;2
4890;Lakštingala;Žiogeliai;1226908540;Taip;0;0;6;6
4891;Lakštingala;Žiogeliai;3951057865;Taip;0;0;3;3
4892;Lakštingala;Žiogeliai;1494530289;Taip;0;0;6;6
4893;Lakštingala;Žiogeliai;7661973162;Taip;0;1;1;2
4894;Lakštingala;Žiogeliai;7104398627;Taip;5;2;0;7
4895;Lakštingala;Žiogeliai;7361353346;Taip;0;1;0;1
4896;Lakštingala;Žiogeliai;4790291839;Taip;1;0;0;1
4897;Lakštingala;Žiogeliai;8351970017;Taip;1;0;1;2
4898;Lakštingala;Žiogeliai;8333832673;Ne;0;1;0;1
4899;Lakštingala;Žiogeliai;6872095965;Taip;1;0;11;12
4900;Lakštingala;SPINDULIUKAI;4365413054;Taip;0;0;5;5
4901;Lakštingala;SPINDULIUKAI;9762500668;Taip;0;2;3;5
4902;Lakštingala;SPINDULIUKAI;7640007392;Taip;6;4;0;10
4903;Lakštingala;SPINDULIUKAI;4784677514;Taip;7;0;0;7
4904;Lakštingala;SPINDULIUKAI;1619201521;Taip;0;2;0;2
4905;Lakštingala;SPINDULIUKAI;2022621678;Taip;1;0;1;2
4906;Lakštingala;SPINDULIUKAI;8429523368;Taip;0;5;0;5
4907;Lakštingala;SPINDULIUKAI;6668075753;Taip;5;0;4;9
4908;Lakštingala;SPINDULIUKAI;9081653166;Taip;0;4;0;4
4909;Lakštingala;SPINDULIUKAI;6780591792;Taip;5;1;0;6
4910;Lakštingala;SPINDULIUKAI;4698879435;Taip;2;0;1;3
4911;Lakštingala;SPINDULIUKAI;8722490845;Taip;0;0;3;3
4912;Lakštingala;SPINDULIUKAI;1220858944;Taip;2;3;0;5
4913;Lakštingala;SPINDULIUKAI;3823860988;Taip;0;0;6;6
4914;Lakštingala;SPINDULIUKAI;7141840160;Taip;0;1;0;1
4915;Lakštingala;SPINDULIUKAI;3282771613;Taip;5;8;0;13
4916;Lakštingala;SPINDULIUKAI;2795341401;Taip;4;1;0;5
4917;Lakštingala;SPINDULIUKAI;5815240975;Taip;9;0;1;10
4918;Lakštingala;SPINDULIUKAI;1633544390;Taip;2;0;0;2
4919;Lakštingala;Pėledžiukai;3520592784;Taip;0;2;0;2
4920;Lakštingala;Pėledžiukai;5258588961;Taip;4;0;3;7
4921;Lakštingala;Pėledžiukai;6135103377;Taip;1;0;0;1
4922;Lakštingala;Pėledžiukai;4774354751;Taip;0;2;7;9
4923;Lakštingala;Pėledžiukai;3369263112;Taip;6;2;0;8
4924;Lakštingala;Pėledžiukai;8375506323;Taip;0;0;1;1
4925;Lakštingala;Pėledžiukai;2738882466;Taip;0;1;0;1
4926;Lakštingala;Pėledžiukai;8717764626;Taip;0;0;1;1
4927;Lakštingala;Pėledžiukai;8075192528;Taip;0;2;1;3
4928;Lakštingala;Pėledžiukai;3766779594;Taip;0;2;0;2
4929;Lakštingala;Pėledžiukai;4270513515;Taip;0;1;0;1
4930;Lakštingala;Pėledžiukai;2514377385;Taip;0;1;0;1
4931;Lakštingala;Pėledžiukai;6161860331;Taip;5;6;0;11
4932;Lakštingala;Pėledžiukai;6866935290;Taip;11;2;4;17
4933;Lakštingala;Pėledžiukai;6805882038;Taip;2;2;0;4
4934;Lakštingala;Pėledžiukai;7139669240;Taip;0;2;8;10
4935;Lakštingala;Pėledžiukai;9502994399;Taip;11;0;1;12
4936;Lakštingala;Pėledžiukai;9431022632;Taip;1;0;2;3
4937;Lakštingala;Pėledžiukai;9856189053;Taip;3;10;0;13
4938;Lakštingala;Pėledžiukai;5391954600;Taip;5;0;0;5
4939;Lakštingala;Pėledžiukai;4608719006;Ne;0;0;5;5
4940;Lakštingala;Katinėliai;8861428074;Taip;0;0;1;1
4941;Lakštingala;Katinėliai;9894103692;Taip;10;1;0;11
4942;Lakštingala;Katinėliai;8800538473;Taip;7;0;1;8
4943;Lakštingala;Katinėliai;9093654437;Ne;0;0;3;3
4944;Lakštingala;Katinėliai;6011421835;Taip;10;0;0;10
4945;Lakštingala;Katinėliai;2673030043;Taip;10;0;1;11
4946;Lakštingala;Katinėliai;2010478542;Taip;0;0;6;6
4947;Lakštingala;Katinėliai;1371422364;Taip;10;0;1;11
4948;Lakštingala;Katinėliai;6285766353;Taip;1;0;9;10
4949;Lakštingala;Katinėliai;3877448215;Taip;4;0;1;5
4950;Lakštingala;Katinėliai;6148942052;Taip;0;2;1;3
4951;Lakštingala;Katinėliai;7623917384;Taip;0;2;0;2
4952;Lakštingala;Katinėliai;1903292595;Taip;0;1;0;1
4953;Lakštingala;Katinėliai;6764453371;Taip;8;1;0;9
4954;Lakštingala;Katinėliai;4184814075;Taip;2;2;0;4
4955;Lakštingala;Deimantėliai;8310446552;Taip;6;0;0;6
4956;Lakštingala;Deimantėliai;8063735934;Taip;3;0;0;3
4957;Lakštingala;Deimantėliai;7396235662;Taip;9;0;0;9
4958;Lakštingala;Deimantėliai;3863174791;Ne;13;0;0;13
4959;Lakštingala;Deimantėliai;2969366008;Taip;12;0;0;12
4960;Lakštingala;Deimantėliai;9800669350;Taip;11;0;0;11
4961;Lakštingala;Deimantėliai;4725848201;Taip;8;0;0;8
4962;Lakštingala;Deimantėliai;6930466455;Ne;15;1;0;16
4963;Lakštingala;Deimantėliai;3352073562;Taip;0;0;17;17
4964;Lakštingala;Deimantėliai;5539054769;Taip;0;2;2;4
4965;Lakštingala;Deimantėliai;8421786788;Taip;0;0;3;3
4966;Lakštingala;Deimantėliai;6974936332;Taip;11;0;0;11
4967;Lakštingala;Deimantėliai;8764728846;Taip;6;2;0;8
4968;Lakštingala;Deimantėliai;8663938939;Ne;17;0;0;17
4969;Lakštingala;Deimantėliai;6231045485;Taip;11;0;0;11
4970;Lakštingala;Deimantėliai;5165517709;Taip;12;1;0;13
4971;Lakštingala;Deimantėliai;5965026791;Taip;1;2;0;3
4972;Lakštingala;KIŠKUČIAI;6520436055;Taip;3;1;0;4
4973;Lakštingala;KIŠKUČIAI;3208321841;Taip;2;3;0;5
4974;Lakštingala;KIŠKUČIAI;5464460112;Taip;0;3;1;4
4975;Lakštingala;KIŠKUČIAI;6970022417;Taip;3;2;1;6
4976;Lakštingala;KIŠKUČIAI;5730122965;Taip;15;3;0;18
4977;Lakštingala;KIŠKUČIAI;4140403601;Taip;5;0;0;5
4978;Lakštingala;KIŠKUČIAI;5119365443;Taip;8;0;0;8
4979;Lakštingala;KIŠKUČIAI;6689018476;Taip;10;1;0;11
4980;Lakštingala;KIŠKUČIAI;7017047366;Taip;5;0;2;7
4981;Lakštingala;KIŠKUČIAI;9539081376;Taip;0;0;16;16
4982;Lakštingala;KIŠKUČIAI;4854843534;Taip;0;2;1;3
4983;Lakštingala;KIŠKUČIAI;9162902701;Taip;9;0;8;17
4984;Lakštingala;KIŠKUČIAI;5455119187;Taip;7;7;1;15
4985;Lakštingala;KIŠKUČIAI;1113674539;Taip;14;0;1;15
4986;Lakštingala;KIŠKUČIAI;4370431439;Taip;0;0;4;4
4987;Lakštingala;KIŠKUČIAI;1898108870;Taip;10;11;0;21
4988;Lakštingala;KIŠKUČIAI;6652822827;Taip;5;0;0;5
4989;Lakštingala;KIŠKUČIAI;2998581623;Taip;19;2;0;21
4990;Lakštingala;KIŠKUČIAI;8414220381;Taip;6;0;0;6
4991;Lakštingala;KIŠKUČIAI;7817830649;Taip;0;13;0;13
4992;Lašelis;VIŠČIUKAI;6477439886;Taip;14;3;0;17
4993;Lašelis;VIŠČIUKAI;6912802425;Taip;14;5;0;19
4994;Lašelis;VIŠČIUKAI;6857428142;Taip;5;1;0;6
4995;Lašelis;VIŠČIUKAI;5759317067;Ne;16;3;0;19
4996;Lašelis;VIŠČIUKAI;9884946783;Taip;20;1;0;21
4997;Lašelis;VIŠČIUKAI;1367955273;Ne;0;11;0;11
4998;Lašelis;VIŠČIUKAI;2702582486;Taip;16;0;0;16
4999;Lašelis;VIŠČIUKAI;2824852871;Taip;20;1;0;21
5000;Lašelis;VIŠČIUKAI;1517104634;Ne;8;1;0;9
5001;Lašelis;VIŠČIUKAI;1294930990;Taip;0;1;0;1
5002;Lašelis;VIŠČIUKAI;9440665009;Ne;10;1;0;11
5003;Lašelis;VIŠČIUKAI;2121080776;Ne;6;1;2;9
5004;Lašelis;VIŠČIUKAI;4427263877;Taip;12;0;1;13
5005;Lašelis;VIŠČIUKAI;1168408482;Taip;8;0;0;8
5006;Lašelis;VIŠČIUKAI;4748156580;Taip;12;0;0;12
5007;Lašelis;VIŠČIUKAI;4860925464;Ne;1;0;0;1
5008;Lašelis;ŠYPSENA;7137348151;Taip;5;0;0;5
5009;Lašelis;ŠYPSENA;1808067249;Ne;7;7;0;14
5010;Lašelis;ŠYPSENA;4933598046;Taip;12;0;0;12
5011;Lašelis;ŠYPSENA;1060784180;Taip;19;0;0;19
5012;Lašelis;ŠYPSENA;2509469243;Taip;19;1;0;20
5013;Lašelis;ŠYPSENA;4832223461;Taip;13;0;0;13
5014;Lašelis;ŠYPSENA;5416590600;Taip;10;1;1;12
5015;Lašelis;ŠYPSENA;1490179832;Ne;0;16;0;16
5016;Lašelis;ŠYPSENA;6836452490;Taip;0;0;6;6
5017;Lašelis;ŠYPSENA;1983312896;Taip;1;2;0;3
5018;Lašelis;ŠYPSENA;1279052767;Ne;0;0;1;1
5019;Lašelis;ŠYPSENA;8906479495;Taip;3;0;3;6
5020;Lašelis;ŠYPSENA;2593126568;Taip;9;0;4;13
5021;Lašelis;ŠYPSENA;3995905195;Taip;0;21;0;21
5022;Lašelis;ŠYPSENA;6137626795;Taip;11;0;0;11
5023;Lašelis;ŠYPSENA;1635921119;Ne;5;2;0;7
5024;Lašelis;ŠYPSENA;9664015801;Taip;0;6;0;6
5025;Lašelis;ŠYPSENA;2306501498;Taip;0;0;1;1
5026;Lašelis;ŠYPSENA;2606193652;Ne;0;0;3;3
5027;Lašelis;ŠYPSENA;9434932943;Taip;11;7;0;18
5028;Lašelis;NYKŠTUKAI;4508779926;Taip;9;1;3;13
5029;Lašelis;NYKŠTUKAI;5931015581;Taip;0;1;0;1
5030;Lašelis;NYKŠTUKAI;1175045927;Taip;5;0;0;5
5031;Lašelis;NYKŠTUKAI;8132517365;Taip;0;5;0;5
5032;Lašelis;NYKŠTUKAI;1244168190;Taip;0;0;2;2
5033;Lašelis;NYKŠTUKAI;4566547120;Taip;0;2;0;2
5034;Lašelis;NYKŠTUKAI;1035888733;Taip;0;3;0;3
5035;Lašelis;NYKŠTUKAI;1926439959;Taip;0;1;6;7
5036;Lašelis;NYKŠTUKAI;8318512396;Taip;3;1;1;5
5037;Lašelis;NYKŠTUKAI;2886967297;Taip;0;4;0;4
5038;Lašelis;NYKŠTUKAI;3805049682;Taip;4;0;0;4
5039;Lašelis;NYKŠTUKAI;2401058384;Ne;15;0;0;15
5040;Lašelis;NYKŠTUKAI;1042560186;Ne;0;1;1;2
5041;Lašelis;NYKŠTUKAI;8814796010;Taip;7;0;2;9
5042;Lašelis;NYKŠTUKAI;2223293390;Ne;6;1;2;9
5043;Lašelis;NYKŠTUKAI;3675606390;Taip;0;21;0;21
5044;Lašelis;SAULUTĖ;3144718477;Taip;7;0;3;10
5045;Lašelis;SAULUTĖ;1777442316;Taip;5;0;1;6
5046;Lašelis;SAULUTĖ;7998812497;Taip;16;0;0;16
5047;Lašelis;SAULUTĖ;7351939034;Taip;0;0;1;1
5048;Lašelis;SAULUTĖ;3239288878;Taip;5;0;3;8
5049;Lašelis;SAULUTĖ;6829438486;Taip;0;0;11;11
5050;Lašelis;SAULUTĖ;6080664872;Taip;16;0;1;17
5051;Lašelis;SAULUTĖ;2204859014;Taip;0;5;0;5
5052;Lašelis;SAULUTĖ;1515920896;Taip;0;0;3;3
5053;Lašelis;SAULUTĖ;1085400709;Taip;7;0;7;14
5054;Lašelis;SAULUTĖ;8889959782;Taip;0;0;1;1
5055;Lašelis;SAULUTĖ;1816377082;Taip;0;0;2;2
5056;Lašelis;SAULUTĖ;2034007263;Taip;10;0;0;10
5057;Lašelis;SAULUTĖ;3495676199;Taip;5;0;0;5
5058;Lašelis;SAULUTĖ;5731394231;Taip;2;0;4;6
5059;Lašelis;BORUŽĖLĖS;1343964112;Taip;0;0;1;1
5060;Lašelis;BORUŽĖLĖS;7502668870;Taip;0;4;0;4
5061;Lašelis;BORUŽĖLĖS;1511922965;Taip;0;1;0;1
5062;Lašelis;BORUŽĖLĖS;5634517740;Ne;3;0;3;6
5063;Lašelis;BORUŽĖLĖS;7418586100;Taip;17;0;1;18
5064;Lašelis;BORUŽĖLĖS;1429188137;Taip;1;0;1;2
5065;Lašelis;BORUŽĖLĖS;8394290574;Taip;0;2;0;2
5066;Lašelis;BORUŽĖLĖS;7811809908;Taip;0;5;0;5
5067;Lašelis;BORUŽĖLĖS;4893073148;Taip;0;2;0;2
5068;Lašelis;BORUŽĖLĖS;4113842551;Taip;4;1;0;5
5069;Lašelis;BORUŽĖLĖS;1882188961;Ne;10;0;1;11
5070;Lašelis;BORUŽĖLĖS;6317716501;Taip;7;0;0;7
5071;Lašelis;BORUŽĖLĖS;8905080707;Taip;3;0;0;3
5072;Lašelis;BORUŽĖLĖS;2991487552;Taip;10;0;1;11
5073;Lašelis;BORUŽĖLĖS;1131591230;Taip;16;1;0;17
5074;Lašelis;SKRUZDELIUKAI;8212250478;Taip;2;5;1;8
5075;Lašelis;SKRUZDELIUKAI;8571325340;Taip;3;0;3;6
5076;Lašelis;SKRUZDELIUKAI;5000188106;Ne;8;4;0;12
5077;Lašelis;SKRUZDELIUKAI;6203027620;Taip;13;0;0;13
5078;Lašelis;SKRUZDELIUKAI;9954809499;Ne;0;0;1;1
5079;Lašelis;SKRUZDELIUKAI;6770694679;Taip;8;0;0;8
5080;Lašelis;SKRUZDELIUKAI;6158377421;Ne;1;9;0;10
5081;Lašelis;SKRUZDELIUKAI;3130271837;Taip;5;4;0;9
5082;Lašelis;SKRUZDELIUKAI;2871149756;Taip;21;0;0;21
5083;Lašelis;SKRUZDELIUKAI;7920615797;Ne;16;0;0;16
5084;Lašelis;SKRUZDELIUKAI;3146611814;Ne;5;6;0;11
5085;Lašelis;SKRUZDELIUKAI;7619426839;Ne;10;7;0;17
5086;Lašelis;SKRUZDELIUKAI;8718481664;Taip;16;0;0;16
5087;Lazdynėlis;BITUTĖS;4881322530;Taip;0;1;1;2
5088;Lazdynėlis;BITUTĖS;1748260780;Taip;4;0;0;4
5089;Lazdynėlis;BITUTĖS;4462819848;Taip;12;0;0;12
5090;Lazdynėlis;BITUTĖS;1574847460;Taip;0;1;1;2
5091;Lazdynėlis;BITUTĖS;5030400578;Taip;0;5;0;5
5092;Lazdynėlis;BITUTĖS;8159928299;Taip;0;0;3;3
5093;Lazdynėlis;BITUTĖS;7911328294;Taip;5;0;0;5
5094;Lazdynėlis;BITUTĖS;1450181711;Taip;0;1;2;3
5095;Lazdynėlis;BITUTĖS;2044188250;Taip;0;1;0;1
5096;Lazdynėlis;BITUTĖS;4142277927;Taip;0;0;2;2
5097;Lazdynėlis;BITUTĖS;2032759165;Ne;0;12;1;13
5098;Lazdynėlis;BITUTĖS;4826167852;Taip;0;1;0;1
5099;Lazdynėlis;BITUTĖS;2802505435;Taip;0;1;2;3
5100;Lazdynėlis;BITUTĖS;2586187455;Taip;7;1;0;8
5101;Lazdynėlis;BITUTĖS;2013752858;Taip;0;0;4;4
5102;Lazdynėlis;BITUTĖS;4545757725;Taip;3;1;0;4
5103;Lazdynėlis;BITUTĖS;5562900372;Taip;0;21;0;21
5104;Lazdynėlis;BITUTĖS;3650483589;Taip;0;0;1;1
5105;Lazdynėlis;BITUTĖS;6963058612;Taip;3;12;2;17
5106;Lazdynėlis;BITUTĖS;6920441303;Taip;0;0;1;1
5107;Lazdynėlis;BITUTĖS;4153294595;Taip;6;1;0;7
5108;Lazdynėlis;BITUTĖS;7910561870;Taip;0;21;0;21
5109;Lazdynėlis;BITUTĖS;4809829190;Taip;0;1;1;2
5110;Lazdynėlis;EŽIUKAI;1039874409;Taip;0;1;1;2
5111;Lazdynėlis;EŽIUKAI;9362249595;Taip;0;1;0;1
5112;Lazdynėlis;EŽIUKAI;7135087818;Taip;6;0;2;8
5113;Lazdynėlis;EŽIUKAI;6352480127;Taip;0;0;1;1
5114;Lazdynėlis;EŽIUKAI;6819322060;Ne;0;7;0;7
5115;Lazdynėlis;EŽIUKAI;6814362584;Taip;0;1;7;8
5116;Lazdynėlis;EŽIUKAI;9219327706;Taip;0;10;0;10
5117;Lazdynėlis;EŽIUKAI;1312649234;Taip;0;1;0;1
5118;Lazdynėlis;EŽIUKAI;3040417651;Taip;10;0;0;10
5119;Lazdynėlis;EŽIUKAI;7208223612;Taip;0;1;7;8
5120;Lazdynėlis;EŽIUKAI;8627994583;Taip;11;0;1;12
5121;Lazdynėlis;EŽIUKAI;4293473176;Taip;0;21;0;21
5122;Lazdynėlis;EŽIUKAI;2723284353;Taip;1;0;0;1
5123;Lazdynėlis;EŽIUKAI;6008610525;Taip;0;0;1;1
5124;Lazdynėlis;EŽIUKAI;3879017767;Taip;0;1;1;2
5125;Lazdynėlis;EŽIUKAI;4031719765;Taip;0;1;0;1
5126;Lazdynėlis;BORUŽIUKAI;8337458289;Taip;0;21;0;21
5127;Lazdynėlis;BORUŽIUKAI;2592852361;Taip;0;21;0;21
5128;Lazdynėlis;BORUŽIUKAI;7692056055;Taip;0;1;1;2
5129;Lazdynėlis;BORUŽIUKAI;4190852647;Taip;4;1;1;6
5130;Lazdynėlis;BORUŽIUKAI;2058909635;Taip;1;0;1;2
5131;Lazdynėlis;BORUŽIUKAI;3105363578;Taip;0;21;0;21
5132;Lazdynėlis;BORUŽIUKAI;5622254334;Taip;11;0;1;12
5133;Lazdynėlis;BORUŽIUKAI;2380881303;Taip;3;0;2;5
5134;Lazdynėlis;BORUŽIUKAI;2632078843;Taip;10;0;3;13
5135;Lazdynėlis;BORUŽIUKAI;5756228709;Taip;0;1;2;3
5136;Lazdynėlis;BORUŽIUKAI;6824473598;Taip;6;1;0;7
5137;Lazdynėlis;BORUŽIUKAI;1707231039;Taip;0;21;0;21
5138;Lazdynėlis;BORUŽIUKAI;6413861274;Taip;14;0;0;14
5139;Lazdynėlis;BORUŽIUKAI;8030743153;Taip;13;0;0;13
5140;Lazdynėlis;BORUŽIUKAI;4642875037;Taip;1;2;0;3
5141;Lazdynėlis;BORUŽIUKAI;1722503577;Taip;2;0;0;2
5142;Lazdynėlis;BORUŽIUKAI;4595080695;Taip;0;21;0;21
5143;Lazdynėlis;BORUŽIUKAI;4958640516;Taip;0;21;0;21
5144;Lazdynėlis;BORUŽIUKAI;3351966091;Taip;0;21;0;21
5145;Lazdynėlis;BORUŽIUKAI;9548866880;Taip;7;0;0;7
5146;Lazdynėlis;KAČIUKAI;5888646355;Taip;4;0;0;4
5147;Lazdynėlis;KAČIUKAI;3678422730;Taip;0;1;0;1
5148;Lazdynėlis;KAČIUKAI;5708643953;Taip;5;1;0;6
5149;Lazdynėlis;KAČIUKAI;8295967906;Taip;0;2;0;2
5150;Lazdynėlis;KAČIUKAI;7076664657;Taip;0;1;2;3
5151;Lazdynėlis;KAČIUKAI;7864896721;Ne;0;2;0;2
5152;Lazdynėlis;KAČIUKAI;1424382629;Taip;10;1;0;11
5153;Lazdynėlis;KAČIUKAI;7313399153;Taip;0;1;0;1
5154;Lazdynėlis;KAČIUKAI;4842228703;Taip;0;0;2;2
5155;Lazdynėlis;KAČIUKAI;6542840562;Taip;0;2;0;2
5156;Lazdynėlis;KAČIUKAI;1265404063;Taip;2;1;0;3
5157;Lazdynėlis;KAČIUKAI;5301460250;Taip;0;0;3;3
5158;Lazdynėlis;KAČIUKAI;3091067158;Taip;0;3;0;3
5159;Lazdynėlis;KAČIUKAI;73057057862;Taip;3;1;6;10
5160;Lazdynėlis;KAČIUKAI;7455989945;Taip;5;1;2;8
5161;Lazdynėlis;KAČIUKAI;1817075429;Taip;4;0;0;4
5162;Lazdynėlis;KAČIUKAI;5030460904;Ne;0;2;0;2
5163;Lazdynėlis;KAČIUKAI;2164717183;Taip;0;1;3;4
5164;Lazdynėlis;KAČIUKAI;5504180016;Ne;0;7;1;8
5165;Lazdynėlis;KAČIUKAI;5031826548;Taip;5;1;0;6
5166;Lazdynėlis;KAČIUKAI;7237629135;Taip;0;2;0;2
5167;Lazdynėlis;KAČIUKAI;6657174602;Taip;0;1;1;2
5168;Lazdynėlis;VOVERIUKAI;6994408527;Taip;5;1;2;8
5169;Lazdynėlis;VOVERIUKAI;8159724466;Taip;0;7;0;7
5170;Lazdynėlis;VOVERIUKAI;5051632567;Ne;13;0;0;13
5171;Lazdynėlis;VOVERIUKAI;1335000592;Taip;6;0;0;6
5172;Lazdynėlis;VOVERIUKAI;2514035189;Taip;0;0;6;6
5173;Lazdynėlis;VOVERIUKAI;9477491360;Taip;0;0;2;2
5174;Lazdynėlis;VOVERIUKAI;5256157552;Ne;8;0;0;8
5175;Lazdynėlis;VOVERIUKAI;5889772626;Ne;7;1;0;8
5176;Lazdynėlis;VOVERIUKAI;6559543013;Taip;10;4;0;14
5177;Lazdynėlis;VOVERIUKAI;9231049001;Taip;6;0;0;6
5178;Lazdynėlis;VOVERIUKAI;9886856760;Taip;12;0;0;12
5179;Lazdynėlis;VOVERIUKAI;2998606948;Taip;8;0;0;8
5180;Lazdynėlis;VOVERIUKAI;6164180360;Taip;1;0;0;1
5181;Lazdynėlis;VOVERIUKAI;6415858184;Taip;14;0;1;15
5182;Lazdynėlis;VOVERIUKAI;5796381191;Ne;5;4;0;9
5183;Lazdynėlis;VOVERIUKAI;3062408541;Taip;6;0;0;6
5184;Lazdynėlis;VOVERIUKAI;5557752248;Taip;2;1;0;3
5185;Lazdynėlis;VOVERIUKAI;3779983775;Ne;5;1;0;6
5186;Lazdynėlis;VOVERIUKAI;4550819172;Taip;2;1;0;3
5187;Lazdynėlis;VOVERIUKAI;4771173060;Taip;11;0;4;15
5188;Lazdynėlis;VOVERIUKAI;8314002741;Taip;6;2;0;8
5189;Lazdynėlis;VOVERIUKAI;3365726271;Taip;0;2;0;2
5190;Lazdynėlis;VOVERIUKAI;1355954767;Taip;0;2;0;2
5191;Lazdynėlis;VOVERIUKAI;7941793866;Taip;0;4;0;4
5192;Lazdynėlis;RIEŠUTĖLIAI;3086059608;Ne;4;1;1;6
5193;Lazdynėlis;RIEŠUTĖLIAI;9693153118;Taip;0;2;0;2
5194;Lazdynėlis;RIEŠUTĖLIAI;6056618348;Taip;0;21;0;21
5195;Lazdynėlis;RIEŠUTĖLIAI;2478218103;Taip;0;1;0;1
5196;Lazdynėlis;RIEŠUTĖLIAI;5987500024;Taip;0;0;4;4
5197;Lazdynėlis;RIEŠUTĖLIAI;2453740823;Taip;3;5;0;8
5198;Lazdynėlis;RIEŠUTĖLIAI;4552505857;Taip;0;1;1;2
5199;Lazdynėlis;RIEŠUTĖLIAI;7545621720;Taip;0;2;1;3
5200;Lazdynėlis;RIEŠUTĖLIAI;7464997080;Taip;0;0;1;1
5201;Lazdynėlis;RIEŠUTĖLIAI;8179584161;Taip;0;1;0;1
5202;Lazdynėlis;RIEŠUTĖLIAI;3239107488;Ne;10;3;0;13
5203;Lazdynėlis;RIEŠUTĖLIAI;4055450300;Taip;0;0;1;1
5204;Lazdynėlis;RIEŠUTĖLIAI;8942906327;Taip;2;7;0;9
5205;Lazdynėlis;RIEŠUTĖLIAI;3362193379;Taip;0;2;0;2
5206;Lazdynėlis;RIEŠUTĖLIAI;9582702244;Taip;3;0;0;3
5207;Lazdynėlis;RIEŠUTĖLIAI;3062924645;Taip;0;1;0;1
5208;Lazdynėlis;RIEŠUTĖLIAI;3667994076;Taip;0;9;1;10
5209;Lazdynėlis;RIEŠUTĖLIAI;7523052754;Taip;0;5;3;8
5210;Lazdynėlis;RIEŠUTĖLIAI;1668899344;Taip;0;1;2;3
5211;Lazdynėlis;RIEŠUTĖLIAI;4092363029;Taip;4;1;0;5
5212;Lazdynėlis;RIEŠUTĖLIAI;3250913116;Ne;0;0;1;1
5213;Lazdynėlis;RIEŠUTĖLIAI;8529192130;Taip;6;0;1;7
5214;Lazdynėlis;RIEŠUTĖLIAI;7719697394;Ne;0;1;0;1
5215;Lazdynėlis;ANČIUKAI;9519409694;Taip;4;0;0;4
5216;Lazdynėlis;ANČIUKAI;2526260625;Taip;4;1;1;6
5217;Lazdynėlis;ANČIUKAI;6031442797;Taip;0;1;3;4
5218;Lazdynėlis;ANČIUKAI;7552873109;Taip;17;0;0;17
5219;Lazdynėlis;ANČIUKAI;7655218276;Taip;0;3;0;3
5220;Lazdynėlis;ANČIUKAI;7561833526;Taip;5;1;0;6
5221;Lazdynėlis;ANČIUKAI;6817162699;Taip;11;1;0;12
5222;Lazdynėlis;ANČIUKAI;2294873565;Taip;5;0;0;5
5223;Lazdynėlis;ANČIUKAI;1499729462;Taip;0;1;1;2
5224;Lazdynėlis;ANČIUKAI;4745610579;Taip;2;1;0;3
5225;Lazdynėlis;ANČIUKAI;8530159773;Taip;0;1;0;1
5226;Lazdynėlis;ANČIUKAI;2911152510;Taip;1;1;2;4
5227;Lazdynėlis;ANČIUKAI;1168433014;Taip;0;0;4;4
5228;Lazdynėlis;ANČIUKAI;3764854654;Ne;5;0;2;7
5229;Lazdynėlis;ANČIUKAI;1961540377;Taip;16;0;4;20
5230;Lazdynėlis;GUDRUČIAI;4425724586;Taip;1;0;0;1
5231;Lazdynėlis;GUDRUČIAI;4928593615;Taip;0;1;0;1
5232;Lazdynėlis;GUDRUČIAI;6684940385;Taip;1;0;0;1
5233;Lazdynėlis;GUDRUČIAI;9187681789;Ne;0;1;2;3
5234;Lazdynėlis;GUDRUČIAI;6307407620;Taip;0;1;1;2
5235;Lazdynėlis;GUDRUČIAI;1852865534;Taip;1;0;0;1
5236;Lazdynėlis;GUDRUČIAI;7789345652;Taip;0;0;5;5
5237;Lazdynėlis;GUDRUČIAI;3902772678;Taip;0;7;0;7
5238;Lazdynėlis;GUDRUČIAI;8822378464;Taip;5;0;0;5
5239;Lazdynėlis;GUDRUČIAI;2441835588;Taip;3;1;0;4
5240;Lazdynėlis;GUDRUČIAI;1386686123;Taip;0;1;0;1
5241;Lazdynėlis;GUDRUČIAI;2603427970;Taip;0;21;0;21
5242;Lazdynėlis;GUDRUČIAI;7965433882;Taip;0;1;0;1
5243;Lazdynėlis;GUDRUČIAI;6863715428;Taip;0;1;1;2
5244;Lazdynėlis;GUDRUČIAI;4779025603;Taip;0;0;15;15
5245;Lazdynėlis;GUDRUČIAI;44510351979;Taip;0;1;1;2
5246;Lazdynėlis;GUDRUČIAI;3043350186;Taip;0;2;0;2
5247;Lazdynėlis;GUDRUČIAI;8008332680;Ne;6;0;0;6
5248;Lazdynėlis;MEŠKIUKAI;4094713096;Taip;0;0;3;3
5249;Lazdynėlis;MEŠKIUKAI;4267469349;Taip;15;1;0;16
5250;Lazdynėlis;MEŠKIUKAI;5354852979;Taip;0;21;0;21
5251;Lazdynėlis;MEŠKIUKAI;3427972329;Taip;0;0;2;2
5252;Lazdynėlis;MEŠKIUKAI;6941986839;Taip;1;2;4;7
5253;Lazdynėlis;MEŠKIUKAI;3697808826;Taip;3;1;0;4
5254;Lazdynėlis;MEŠKIUKAI;2812633983;Taip;1;0;2;3
5255;Lazdynėlis;MEŠKIUKAI;9590507486;Taip;6;1;1;8
5256;Lazdynėlis;MEŠKIUKAI;1488371861;Taip;0;0;5;5
5257;Lazdynėlis;MEŠKIUKAI;5982766841;Taip;0;21;0;21
5258;Lazdynėlis;MEŠKIUKAI;1984546310;Taip;0;1;0;1
5259;Lazdynėlis;MEŠKIUKAI;4408660083;Taip;0;21;0;21
5260;Lazdynėlis;MEŠKIUKAI;9930553716;Ne;0;2;0;2
5261;Lazdynėlis;MEŠKIUKAI;6831456807;Taip;3;0;1;4
5262;Lazdynėlis;MEŠKIUKAI;8567304224;Taip;5;0;2;7
5263;Lazdynėlis;MEŠKIUKAI;7754329238;Ne;0;1;2;3
5264;Lazdynėlis;MEŠKIUKAI;4366502064;Taip;6;0;0;6
5265;Lazdynėlis;MEŠKIUKAI;1331380925;Taip;0;21;0;21
5266;Liepsnelė;Ramunėlės;6566895135;Taip;4;0;0;4
5267;Liepsnelė;Ramunėlės;6294010142;Taip;3;0;0;3
5268;Liepsnelė;Ramunėlės;2522846125;Taip;5;0;0;5
5269;Liepsnelė;Ramunėlės;5037883064;Taip;5;0;0;5
5270;Liepsnelė;Ramunėlės;3467086136;Taip;15;0;0;15
5271;Liepsnelė;Zuikučiai;4321786654;Taip;6;0;0;6
5272;Liepsnelė;Zuikučiai;4798353152;Taip;12;0;0;12
5273;Liepsnelė;Zuikučiai;1125190558;Taip;5;0;0;5
5274;Liepsnelė;Zuikučiai;1132758499;Taip;9;0;0;9
5275;Liepsnelė;Zuikučiai;3774949481;Taip;9;0;0;9
5276;Liepsnelė;Nykštukai;9993335478;Taip;9;0;0;9
5277;Liepsnelė;Nykštukai;4088586188;Taip;10;0;0;10
5278;Liepsnelė;Nykštukai;8189699392;Taip;4;0;0;4
5279;Liepsnelė;Nykštukai;4070825932;Taip;3;0;0;3
5280;Liepsnelė;Nykštukai;9950106412;Taip;6;0;0;6
5281;Liepsnelė;Nykštukai;3982153133;Taip;9;0;0;9
5282;Liepsnelė;Nykštukai;5909672361;Ne;10;0;0;10
5283;Liepsnelė;Žvirbliukai;8080492986;Taip;9;0;0;9
5284;Liepsnelė;Žvirbliukai;1625321820;Taip;12;0;0;12
5285;Liepsnelė;Žvirbliukai;2080374597;Ne;10;0;0;10
5286;Liepsnelė;Meškiukai;5138923652;Taip;10;0;0;10
5287;Liepsnelė;Meškiukai;7007685622;Taip;7;0;0;7
5288;Liepsnelė;Meškiukai;4080298620;Taip;10;0;0;10
5289;Liepsnelė;Meškiukai;2326664705;Taip;5;0;0;5
5290;Liepsnelė;Meškiukai;6568963048;Taip;7;0;0;7
5291;Liepsnelė;SAULUTĖ;9864646484;Taip;11;0;0;11
5292;Liepsnelė;SAULUTĖ;8216737803;Ne;5;0;0;5
5293;Liepsnelė;SAULUTĖ;8216737803;Ne;5;0;0;5
5294;Liepsnelė;SAULUTĖ;8598242099;Taip;8;0;0;8
5295;Liepsnelė;Varpeliai;1487219062;Taip;5;0;0;5
5296;Liepsnelė;Varpeliai;7241069517;Taip;19;0;0;19
5297;Markučiai;Žirniukų;3525681034;Taip;2;1;2;5
5298;Markučiai;Žirniukų;7312533881;Taip;2;1;2;5
5299;Markučiai;Žirniukų;8679791696;Taip;0;0;3;3
5300;Markučiai;Žirniukų;5269411010;Taip;5;0;2;7
5301;Markučiai;Žirniukų;5250815223;Taip;5;0;1;6
5302;Markučiai;Žirniukų;8934965409;Taip;0;1;0;1
5303;Markučiai;Žirniukų;8360526946;Taip;4;16;0;20
5304;Markučiai;Žirniukų;7244815252;Taip;6;0;0;6
5305;Markučiai;Žirniukų;2096169972;Taip;2;0;0;2
5306;Markučiai;Žirniukų;3073404128;Taip;0;0;1;1
5307;Markučiai;Žirniukų;6674351628;Ne;8;0;2;10
5308;Markučiai;Žirniukų;5614488534;Ne;5;2;3;10
5309;Markučiai;Žirniukų;2367999201;Taip;7;0;1;8
5310;Markučiai;Žirniukų;4242575616;Taip;0;0;2;2
5311;Markučiai;Žirniukų;4223653505;Taip;6;0;0;6
5312;Markučiai;Žirniukų;3802897432;Taip;16;0;10;26
5313;Markučiai;Žirniukų;2099285475;Taip;1;0;3;4
5314;Markučiai;Žirniukų;2344252204;Ne;8;0;12;20
5315;Markučiai;Žirniukų;9576412366;Taip;0;1;0;1
5316;Markučiai;Žirniukų;1395241501;Taip;15;0;6;21
5317;Markučiai;Nykštukų;7507551844;Taip;0;1;0;1
5318;Markučiai;Nykštukų;9545967631;Taip;0;0;3;3
5319;Markučiai;Nykštukų;6121911851;Taip;5;0;0;5
5320;Markučiai;Nykštukų;6898055631;Ne;4;3;1;8
5321;Markučiai;Nykštukų;3378749042;Taip;9;1;5;15
5322;Markučiai;Nykštukų;1884388847;Taip;0;1;0;1
5323;Markučiai;Nykštukų;2170380827;Taip;0;1;0;1
5324;Markučiai;Nykštukų;5183244346;Taip;6;1;0;7
5325;Markučiai;Nykštukų;7624913025;Taip;5;8;0;13
5326;Markučiai;Nykštukų;2994895532;Taip;6;1;0;7
5327;Markučiai;Nykštukų;4846899377;Taip;0;0;2;2
5328;Markučiai;Nykštukų;4150956779;Taip;0;1;0;1
5329;Markučiai;Nykštukų;4920107818;Taip;9;0;0;9
5330;Markučiai;Nykštukų;7680126946;Taip;1;0;7;8
5331;Markučiai;Nykštukų;4222017733;Taip;15;0;0;15
5332;Markučiai;Nykštukų;3414015064;Ne;6;0;2;8
5333;Markučiai;Nykštukų;7642401516;Taip;0;0;2;2
5334;Markučiai;Nykštukų;8055783293;Ne;5;0;2;7
5335;Markučiai;Pelėdžiukų;9180404247;Ne;0;0;6;6
5336;Markučiai;Pelėdžiukų;3386071459;Taip;0;6;7;13
5337;Markučiai;Pelėdžiukų;4653663237;Taip;6;0;1;7
5338;Markučiai;Pelėdžiukų;5727655114;Taip;0;0;2;2
5339;Markučiai;Pelėdžiukų;6740434675;Taip;0;0;1;1
5340;Markučiai;Pelėdžiukų;6707310242;Taip;1;0;13;14
5341;Markučiai;Pelėdžiukų;7947287013;Taip;5;0;0;5
5342;Markučiai;Pelėdžiukų;2543313198;Taip;7;1;1;9
5343;Markučiai;Pelėdžiukų;4418580273;Taip;6;0;1;7
5344;Markučiai;Pelėdžiukų;5522654429;Taip;9;5;2;16
5345;Markučiai;Pelėdžiukų;7539605426;Taip;3;0;3;6
5346;Markučiai;Pelėdžiukų;8888538915;Taip;15;0;0;15
5347;Markučiai;Pelėdžiukų;1623728091;Taip;0;0;2;2
5348;Markučiai;Pelėdžiukų;1799946177;Taip;7;0;1;8
5349;Markučiai;Pelėdžiukų;7809719827;Ne;3;0;4;7
5350;Markučiai;Pelėdžiukų;4860961508;Taip;6;1;0;7
5351;Markučiai;Pelėdžiukų;6260010822;Taip;5;1;0;6
5352;Markučiai;Pelėdžiukų;6569807889;Taip;0;2;0;2
5353;Markučiai;Boružėlių;1171899107;Taip;2;1;0;3
5354;Markučiai;Boružėlių;8078777204;Ne;11;0;1;12
5355;Markučiai;Boružėlių;3755794133;Taip;0;1;1;2
5356;Markučiai;Boružėlių;8244065962;Taip;0;1;0;1
5357;Markučiai;Boružėlių;5902165968;Taip;6;1;0;7
5358;Markučiai;Boružėlių;5981692282;Taip;0;5;0;5
5359;Markučiai;Boružėlių;3739566642;Taip;15;2;0;17
5360;Markučiai;Boružėlių;6868394315;Taip;0;3;0;3
5361;Markučiai;Boružėlių;7634475536;Ne;0;0;1;1
5362;Markučiai;Boružėlių;5663147778;Taip;0;1;2;3
5363;Markučiai;Boružėlių;8271830626;Taip;6;1;0;7
5364;Markučiai;Boružėlių;8046320044;Ne;2;0;0;2
5365;Markučiai;Boružėlių;4244217571;Ne;16;0;0;16
5366;Markučiai;Boružėlių;3315824027;Taip;10;1;2;13
5367;Markučiai;Boružėlių;2060024771;Taip;7;0;1;8
5368;Markučiai;Boružėlių;2539486337;Taip;0;0;5;5
5369;Markučiai;Boružėlių;5562960498;Ne;0;4;2;6
5370;Markučiai;Bitučių;1720541082;Taip;0;5;0;5
5371;Markučiai;Bitučių;8792524832;Taip;3;3;0;6
5372;Markučiai;Bitučių;9518247571;Taip;9;1;0;10
5373;Markučiai;Bitučių;4836298058;Ne;0;0;6;6
5374;Markučiai;Bitučių;9027071539;Taip;6;1;0;7
5375;Markučiai;Bitučių;8748794886;Taip;0;0;8;8
5376;Markučiai;Bitučių;7387460586;Taip;0;1;1;2
5377;Markučiai;Bitučių;8950442843;Taip;27;0;1;28
5378;Markučiai;Bitučių;2840564082;Taip;4;1;0;5
5379;Markučiai;Bitučių;3926993383;Taip;0;0;7;7
5380;Markučiai;Bitučių;6530101961;Taip;9;1;4;14
5381;Markučiai;Bitučių;1908302738;Taip;6;0;6;12
5382;Markučiai;Bitučių;7056367646;Taip;19;1;1;21
5383;Markučiai;Bitučių;8195584468;Taip;6;0;1;7
5384;Markučiai;Bitučių;2049497686;Taip;13;3;2;18
5385;Markučiai;Bitučių;8541042547;Taip;0;0;2;2
5386;Markučiai;Bitučių;1447116821;Taip;1;0;2;3
5387;Markučiai;Bitučių;2931958829;Taip;0;1;0;1
5388;Markučiai;Drugelių;3544565354;Taip;0;0;1;1
5389;Markučiai;Drugelių;6992161129;Taip;4;0;1;5
5390;Markučiai;Drugelių;5024860112;Taip;0;0;7;7
5391;Markučiai;Drugelių;9412129807;Taip;10;3;0;13
5392;Markučiai;Drugelių;6979218594;Taip;3;0;0;3
5393;Markučiai;Drugelių;3491734422;Taip;0;0;7;7
5394;Markučiai;Drugelių;3491734422;Taip;0;0;7;7
5395;Markučiai;Drugelių;3491734422;Taip;0;0;7;7
5396;Markučiai;Drugelių;3832641521;Taip;10;0;0;10
5397;Markučiai;Drugelių;4520724770;Taip;1;0;1;2
5398;Markučiai;Drugelių;8050852518;Ne;0;0;2;2
5399;Markučiai;Drugelių;9391866085;Taip;5;0;2;7
5400;Markučiai;Drugelių;9073616238;Taip;6;0;0;6
5401;Markučiai;Drugelių;4918717178;Taip;2;0;4;6
5402;Markučiai;Drugelių;2967726802;Ne;7;0;1;8
5403;Markučiai;Drugelių;6684544229;Taip;9;0;2;11
5404;Markučiai;Skruzdėliukų;5566529492;Taip;5;0;0;5
5405;Markučiai;Skruzdėliukų;8105747904;Ne;10;2;2;14
5406;Markučiai;Skruzdėliukų;6617799980;Taip;5;7;0;12
5407;Markučiai;Skruzdėliukų;4369408254;Taip;7;0;7;14
5408;Markučiai;Skruzdėliukų;7580249913;Taip;23;0;0;23
5409;Markučiai;Skruzdėliukų;2246646548;Taip;11;3;0;14
5410;Markučiai;Skruzdėliukų;9921530582;Taip;1;0;3;4
5411;Markučiai;Skruzdėliukų;6759427415;Taip;22;0;0;22
5412;Markučiai;Skruzdėliukų;4820576711;Taip;17;7;0;24
5413;Markučiai;Skruzdėliukų;1527620947;Taip;0;22;0;22
5414;Markučiai;Skruzdėliukų;8774323234;Taip;0;0;4;4
5415;Markučiai;Skruzdėliukų;7881183912;Taip;11;1;0;12
5416;Markučiai;Skruzdėliukų;9338996275;Taip;12;0;0;12
5417;Markučiai;Skruzdėliukų;5180034556;Taip;5;0;0;5
5418;Markučiai;Skruzdėliukų;4383128686;Taip;12;0;0;12
5419;Markučiai;ZUIKUČIŲ;82320812575;Taip;0;3;0;3
5420;Markučiai;ZUIKUČIŲ;4861535057;Taip;0;1;0;1
5421;Markučiai;ZUIKUČIŲ;11751635395;Taip;0;10;0;10
5422;Markučiai;ZUIKUČIŲ;1184908076;Taip;0;1;1;2
5423;Markučiai;ZUIKUČIŲ;7729045227;Taip;5;1;0;6
5424;Markučiai;ZUIKUČIŲ;8061880631;Taip;4;1;0;5
5425;Markučiai;ZUIKUČIŲ;1392582514;Taip;11;4;0;15
5426;Markučiai;ZUIKUČIŲ;7691410556;Taip;2;1;0;3
5427;Markučiai;ZUIKUČIŲ;6453095915;Taip;6;1;1;8
5428;Markučiai;ZUIKUČIŲ;6808291628;Taip;4;13;0;17
5429;Markučiai;ZUIKUČIŲ;5387571295;Taip;7;1;2;10
5430;Markučiai;ZUIKUČIŲ;3794643964;Taip;0;2;0;2
5431;Markučiai;ZUIKUČIŲ;91228262895;Taip;1;1;0;2
5432;Markučiai;ZUIKUČIŲ;5749873170;Taip;0;1;0;1
5433;Markučiai;ZUIKUČIŲ;8605357678;Taip;0;1;0;1
5434;Markučiai;ZUIKUČIŲ;6055058096;Taip;9;0;1;10
5435;Markučiai;ZUIKUČIŲ;1956224017;Taip;0;1;1;2
5436;Markučiai;ŽIOGELIŲ;3163226803;Taip;5;2;2;9
5437;Markučiai;ŽIOGELIŲ;1244026489;Taip;0;3;0;3
5438;Markučiai;ŽIOGELIŲ;76025616287;Ne;0;1;0;1
5439;Markučiai;ŽIOGELIŲ;54892037118;Taip;0;1;4;5
5440;Markučiai;ŽIOGELIŲ;1054802708;Taip;3;1;1;5
5441;Markučiai;ŽIOGELIŲ;67074776419;Taip;0;2;0;2
5442;Markučiai;ŽIOGELIŲ;1007919702;Taip;0;8;0;8
5443;Markučiai;ŽIOGELIŲ;1923521405;Taip;0;1;0;1
5444;Markučiai;ŽIOGELIŲ;1164386108;Taip;0;1;0;1
5445;Markučiai;ŽIOGELIŲ;7850311496;Ne;0;2;0;2
5446;Markučiai;ŽIOGELIŲ;2169583290;Ne;0;11;0;11
5447;Markučiai;ŽIOGELIŲ;3340385503;Taip;0;1;1;2
5448;Markučiai;ŽIOGELIŲ;4152184290;Taip;0;0;3;3
5449;Markučiai;ŽIOGELIŲ;1742944578;Taip;0;1;0;1
5450;Markučiai;ŽIOGELIŲ;23267867195;Taip;0;1;0;1
5451;Markučiai;ŽIOGELIŲ;7481923902;Taip;0;1;2;3
5452;Markučiai;ŽIOGELIŲ;4324776209;Ne;0;1;2;3
5453;Markučiai;Ežiukių;1827829954;Taip;0;6;0;6
5454;Markučiai;Ežiukių;4925856706;Taip;0;4;0;4
5455;Markučiai;Ežiukių;6570638672;Taip;0;5;0;5
5456;Markučiai;Ežiukių;5975331223;Taip;0;2;3;5
5457;Markučiai;Ežiukių;2687320408;Taip;0;1;0;1
5458;Markučiai;Ežiukių;8990923872;Taip;0;7;0;7
5459;Markučiai;Ežiukių;6308368050;Taip;5;2;0;7
5460;Markučiai;Ežiukių;4249158803;Taip;5;1;0;6
5461;Markučiai;Ežiukių;5958705106;Taip;0;1;0;1
5462;Markučiai;Ežiukių;1769984489;Taip;0;0;1;1
5463;Markučiai;Ežiukių;7791500322;Taip;0;13;0;13
5464;Markučiai;Ežiukių;9059302464;Taip;4;1;5;10
5465;Markučiai;Ežiukių;2962530721;Taip;0;1;0;1
5466;Markučiai;Ežiukių;6574037877;Taip;15;0;0;15
5467;Markučiai;Ežiukių;5752762229;Taip;0;2;0;2
5468;Markučiai;Ežiukių;4383421917;Taip;0;2;0;2
5469;Markučiai;Ežiukių;9789274040;Ne;0;13;0;13
5470;Mažylis;"4 PRIEŠMOKYKLINĖ GR.";9411559447;Taip;4;0;1;5
5471;Mažylis;"4 PRIEŠMOKYKLINĖ GR.";4252408251;Taip;6;0;0;6
5472;Mažylis;"4 PRIEŠMOKYKLINĖ GR.";4503734408;Taip;4;0;1;5
5473;Mažylis;"4 PRIEŠMOKYKLINĖ GR.";8352202912;Taip;0;0;3;3
5474;Mažylis;"4 PRIEŠMOKYKLINĖ GR.";38277640135;Taip;0;1;2;3
5475;Mažylis;"4 PRIEŠMOKYKLINĖ GR.";1663347167;Taip;10;1;3;14
5476;Mažylis;"4 PRIEŠMOKYKLINĖ GR.";6854350717;Taip;0;0;1;1
5477;Mažylis;"4 PRIEŠMOKYKLINĖ GR.";4104052524;Ne;0;1;0;1
5478;Mažylis;"4 PRIEŠMOKYKLINĖ GR.";3860760654;Taip;6;0;0;6
5479;Mažylis;"4 PRIEŠMOKYKLINĖ GR.";7185347381;Taip;1;0;8;9
5480;Mažylis;"4 PRIEŠMOKYKLINĖ GR.";3344476309;Taip;3;0;5;8
5481;Mažylis;"4 PRIEŠMOKYKLINĖ GR.";6851169340;Taip;0;0;1;1
5482;Mažylis;"4 PRIEŠMOKYKLINĖ GR.";4486742281;Taip;0;0;8;8
5483;Mažylis;"4 PRIEŠMOKYKLINĖ GR.";3217527771;Taip;0;1;0;1
5484;Mažylis;"4 PRIEŠMOKYKLINĖ GR.";7416381505;Taip;17;5;1;23
5485;Mažylis;"4 PRIEŠMOKYKLINĖ GR.";1514640197;Taip;0;0;4;4
5486;Mažylis;"4 PRIEŠMOKYKLINĖ GR.";1002832487;Taip;0;0;5;5
5487;Mažylis;"4 PRIEŠMOKYKLINĖ GR.";9608529135;Taip;0;0;17;17
5488;Mažylis;"4 PRIEŠMOKYKLINĖ GR.";4645411379;Taip;0;1;0;1
5489;Mažylis;"3 DARŽELIO GR.";3081814579;Taip;6;1;0;7
5490;Mažylis;"3 DARŽELIO GR.";6100650710;Taip;0;0;1;1
5491;Mažylis;"3 DARŽELIO GR.";9401388775;Taip;0;0;7;7
5492;Mažylis;"3 DARŽELIO GR.";4817146074;Taip;0;1;1;2
5493;Mažylis;"3 DARŽELIO GR.";7106648054;Taip;5;0;0;5
5494;Mažylis;"3 DARŽELIO GR.";6809320247;Taip;0;1;7;8
5495;Mažylis;"3 DARŽELIO GR.";2006289999;Taip;5;0;1;6
5496;Mažylis;"3 DARŽELIO GR.";7652390515;Taip;9;0;1;10
5497;Mažylis;"3 DARŽELIO GR.";8639480781;Taip;0;0;1;1
5498;Mažylis;"3 DARŽELIO GR.";9341935211;Ne;11;0;2;13
5499;Mažylis;"3 DARŽELIO GR.";2989562406;Ne;0;0;4;4
5500;Mažylis;"3 DARŽELIO GR.";1151737098;Taip;3;1;0;4
5501;Mažylis;"3 DARŽELIO GR.";7642914458;Taip;4;1;1;6
5502;Mažylis;"3 DARŽELIO GR.";5938312001;Ne;0;0;2;2
5503;Mažylis;"3 DARŽELIO GR.";2119733659;Taip;0;0;3;3
5504;Mažylis;"3 DARŽELIO GR.";3126627913;Taip;3;0;5;8
5505;Mažylis;"3 DARŽELIO GR.";6904083734;Taip;1;0;2;3
5506;Mažylis;"3 DARŽELIO GR.";1420913875;Taip;0;0;10;10
5507;Mažylis;"3 DARŽELIO GR.";2319506343;Taip;0;0;2;2
5508;Mažylis;"3 DARŽELIO GR.";9416161833;Taip;0;0;4;4
5509;Mažylis;"6 DARŽELIO GR.";5388105083;Ne;0;0;5;5
5510;Mažylis;"6 DARŽELIO GR.";8589124394;Taip;6;0;0;6
5511;Mažylis;"6 DARŽELIO GR.";3641990617;Taip;2;1;0;3
5512;Mažylis;"6 DARŽELIO GR.";1892136590;Taip;0;1;1;2
5513;Mažylis;"6 DARŽELIO GR.";9479398581;Taip;0;1;3;4
5514;Mažylis;"6 DARŽELIO GR.";1381828313;Taip;0;0;4;4
5515;Mažylis;"6 DARŽELIO GR.";7725286603;Taip;10;1;2;13
5516;Mažylis;"6 DARŽELIO GR.";3615636349;Taip;6;0;2;8
5517;Mažylis;"6 DARŽELIO GR.";9894955253;Taip;11;0;0;11
5518;Mažylis;"6 DARŽELIO GR.";6270840529;Taip;3;0;1;4
5519;Mažylis;"6 DARŽELIO GR.";4100492642;Ne;0;0;17;17
5520;Mažylis;"6 DARŽELIO GR.";5569913242;Taip;0;0;2;2
5521;Mažylis;"6 DARŽELIO GR.";7841955949;Taip;0;0;11;11
5522;Mažylis;"6 DARŽELIO GR.";6492768766;Taip;16;0;0;16
5523;Mažylis;"6 DARŽELIO GR.";6423910850;Taip;1;1;0;2
5524;Mažylis;"6 DARŽELIO GR.";1555305826;Taip;0;0;8;8
5525;Mažylis;"6 DARŽELIO GR.";5977423702;Taip;9;10;0;19
5526;Mažylis;"6 DARŽELIO GR.";9562863405;Taip;2;0;0;2
5527;Mažylis;"6 DARŽELIO GR.";5990843024;Taip;0;0;9;9
5528;Mažylis;"6 DARŽELIO GR.";9981751097;Taip;11;0;1;12
5529;Mažylis;"1 NAUJA (LOPŠELIS)";4985161657;Taip;0;0;2;2
5530;Mažylis;"1 NAUJA (LOPŠELIS)";5297935198;Taip;14;0;0;14
5531;Mažylis;"1 NAUJA (LOPŠELIS)";1993916098;Taip;5;0;1;6
5532;Mažylis;"1 NAUJA (LOPŠELIS)";4309902086;Taip;11;0;0;11
5533;Mažylis;"1 NAUJA (LOPŠELIS)";3064367996;Taip;0;9;0;9
5534;Mažylis;"1 NAUJA (LOPŠELIS)";2110320072;Taip;8;0;0;8
5535;Mažylis;"1 NAUJA (LOPŠELIS)";7810360699;Taip;15;0;1;16
5536;Mažylis;"1 NAUJA (LOPŠELIS)";3911343193;Taip;0;0;13;13
5537;Mažylis;"1 NAUJA (LOPŠELIS)";5225388496;Taip;6;1;2;9
5538;Mažylis;"1 NAUJA (LOPŠELIS)";8259994523;Taip;8;0;1;9
5539;Mažylis;"1 NAUJA (LOPŠELIS)";6500577246;Taip;4;2;0;6
5540;Mažylis;"1 NAUJA (LOPŠELIS)";3098913589;Taip;8;0;0;8
5541;Mažylis;"1 NAUJA (LOPŠELIS)";4201114033;Taip;3;0;1;4
5542;Mažylis;"1 NAUJA (LOPŠELIS)";9025867358;Taip;7;0;1;8
5543;Mažylis;"5 DARŽELIO GR.";2935175014;Taip;17;0;1;18
5544;Mažylis;"5 DARŽELIO GR.";2979849055;Taip;0;0;2;2
5545;Mažylis;"5 DARŽELIO GR.";6162880220;Taip;0;1;0;1
5546;Mažylis;"5 DARŽELIO GR.";1762105763;Taip;4;1;0;5
5547;Mažylis;"5 DARŽELIO GR.";2672500259;Ne;0;0;8;8
5548;Mažylis;"5 DARŽELIO GR.";8135596731;Taip;0;0;6;6
5549;Mažylis;"5 DARŽELIO GR.";8866980930;Taip;2;0;1;3
5550;Mažylis;"5 DARŽELIO GR.";2704741847;Ne;0;1;1;2
5551;Mažylis;"5 DARŽELIO GR.";4280547746;Taip;0;1;0;1
5552;Mažylis;"5 DARŽELIO GR.";9447747294;Taip;0;0;13;13
5553;Mažylis;"5 DARŽELIO GR.";4542742002;Taip;0;0;4;4
5554;Mažylis;"5 DARŽELIO GR.";2126108232;Taip;0;1;4;5
5555;Mažylis;"5 DARŽELIO GR.";8297427176;Taip;0;1;1;2
5556;Mažylis;"5 DARŽELIO GR.";6009637985;Taip;3;0;0;3
5557;Mažylis;"5 DARŽELIO GR.";5685988186;Taip;6;0;0;6
5558;Mažylis;"5 DARŽELIO GR.";5870983755;Taip;6;1;0;7
5559;Mažylis;"5 DARŽELIO GR.";8999239172;Taip;0;0;3;3
5560;Mažylis;"5 DARŽELIO GR.";3365026025;Taip;6;0;0;6
5561;Mažylis;"DARŽELIS 2 GR.";2795618410;Taip;5;1;2;8
5562;Mažylis;"DARŽELIS 2 GR.";9727982334;Ne;5;0;6;11
5563;Mažylis;"DARŽELIS 2 GR.";8655053217;Taip;5;0;1;6
5564;Mažylis;"DARŽELIS 2 GR.";7414398772;Taip;7;0;0;7
5565;Mažylis;"DARŽELIS 2 GR.";1058725505;Taip;11;4;0;15
5566;Mažylis;"DARŽELIS 2 GR.";4880415881;Taip;1;1;0;2
5567;Mažylis;"DARŽELIS 2 GR.";1219174313;Taip;11;0;0;11
5568;Mažylis;"DARŽELIS 2 GR.";9111101357;Taip;16;0;1;17
5569;Mažylis;"DARŽELIS 2 GR.";1533948576;Taip;0;7;2;9
5570;Mažylis;"DARŽELIS 2 GR.";6272047137;Taip;0;1;2;3
5571;Mažylis;"DARŽELIS 2 GR.";7255856938;Taip;11;0;5;16
5572;Mažylis;"DARŽELIS 2 GR.";4987487972;Taip;21;0;0;21
5573;Mažylis;"DARŽELIS 2 GR.";9555408203;Ne;6;0;2;8
5574;Mažylis;"DARŽELIS 2 GR.";5165268747;Taip;5;5;2;12
5575;Mažylis;"DARŽELIS 2 GR.";2425437724;Taip;0;0;11;11
5576;Mažylis;"DARŽELIS 2 GR.";2723677422;Taip;1;0;1;2
5577;Mažylis;"DARŽELIS 2 GR.";9875575387;Ne;7;0;0;7
5578;Mažylis;"DARŽELIS 2 GR.";5658868407;Taip;15;0;0;15
5579;Medynėlis;BITUTĖS;6238256156;Ne;0;4;0;4
5580;Medynėlis;BITUTĖS;8711567312;Taip;0;0;6;6
5581;Medynėlis;BITUTĖS;2993705115;Taip;0;2;2;4
5582;Medynėlis;BITUTĖS;1504612730;Ne;1;0;1;2
5583;Medynėlis;BITUTĖS;5522261530;Taip;0;5;0;5
5584;Medynėlis;BITUTĖS;6576401514;Taip;0;3;2;5
5585;Medynėlis;BITUTĖS;4107846958;Ne;0;6;0;6
5586;Medynėlis;BITUTĖS;7296044569;Taip;9;1;0;10
5587;Medynėlis;BITUTĖS;4418330478;Taip;9;0;2;11
5588;Medynėlis;BITUTĖS;7042766873;Taip;10;0;2;12
5589;Medynėlis;BITUTĖS;6074296305;Taip;0;2;0;2
5590;Medynėlis;BITUTĖS;6815521895;Ne;0;0;3;3
5591;Medynėlis;BITUTĖS;4374464298;Taip;11;0;0;11
5592;Medynėlis;BITUTĖS;8877104963;Taip;16;0;0;16
5593;Medynėlis;BITUTĖS;8107171123;Ne;7;3;0;10
5594;Medynėlis;BITUTĖS;4545707752;Taip;5;0;2;7
5595;Medynėlis;BITUTĖS;4419503239;Taip;0;0;5;5
5596;Medynėlis;BITUTĖS;7870261906;Taip;4;2;0;6
5597;Medynėlis;BITUTĖS;6466874318;Ne;0;3;0;3
5598;Medynėlis;BITUTĖS;2798305000;Taip;3;1;3;7
5599;Medynėlis;BITUTĖS;5440233814;Taip;2;6;1;9
5600;Medynėlis;BITUTĖS;4598267411;Ne;14;1;0;15
5601;Medynėlis;BITUTĖS;5194220650;Taip;14;0;0;14
5602;Medynėlis;DRUGELIAI;7886801955;Taip;4;2;0;6
5603;Medynėlis;DRUGELIAI;6127747445;Ne;0;2;0;2
5604;Medynėlis;DRUGELIAI;33981260502;Taip;0;0;1;1
5605;Medynėlis;DRUGELIAI;4581683292;Taip;4;2;0;6
5606;Medynėlis;DRUGELIAI;7633674694;Taip;0;1;0;1
5607;Medynėlis;DRUGELIAI;5530782065;Taip;0;2;0;2
5608;Medynėlis;DRUGELIAI;6343851636;Taip;4;2;0;6
5609;Medynėlis;DRUGELIAI;8948133343;Taip;0;11;0;11
5610;Medynėlis;DRUGELIAI;9413309043;Taip;0;2;0;2
5611;Medynėlis;DRUGELIAI;3773215372;Taip;5;1;0;6
5612;Medynėlis;DRUGELIAI;1795479738;Taip;0;10;0;10
5613;Medynėlis;DRUGELIAI;7244497661;Taip;8;1;0;9
5614;Medynėlis;DRUGELIAI;8775219704;Taip;0;1;0;1
5615;Medynėlis;DRUGELIAI;5269927048;Taip;6;1;0;7
5616;Medynėlis;DRUGELIAI;1827495325;Taip;0;1;0;1
5617;Medynėlis;DRUGELIAI;2540325264;Ne;14;1;0;15
5618;Medynėlis;DRUGELIAI;3870665108;Ne;0;1;0;1
5619;Medynėlis;DRUGELIAI;9670396828;Taip;11;0;0;11
5620;Medynėlis;DRUGELIAI;5551121950;Taip;2;1;0;3
5621;Medynėlis;DRUGELIAI;2627421550;Taip;0;1;0;1
5622;Medynėlis;DRUGELIAI;2794274146;Taip;0;1;0;1
5623;Medynėlis;SKRUZDĖLIUKAI;4783894465;Taip;12;0;1;13
5624;Medynėlis;SKRUZDĖLIUKAI;3905440176;Taip;0;1;0;1
5625;Medynėlis;SKRUZDĖLIUKAI;1142044361;Taip;0;2;0;2
5626;Medynėlis;SKRUZDĖLIUKAI;8719860414;Ne;0;0;4;4
5627;Medynėlis;SKRUZDĖLIUKAI;6802308420;Taip;9;1;0;10
5628;Medynėlis;SKRUZDĖLIUKAI;4645171858;Taip;4;2;0;6
5629;Medynėlis;SKRUZDĖLIUKAI;3947494044;Taip;6;1;0;7
5630;Medynėlis;SKRUZDĖLIUKAI;3295727210;Taip;11;1;0;12
5631;Medynėlis;SKRUZDĖLIUKAI;8215856660;Ne;1;16;0;17
5632;Medynėlis;SKRUZDĖLIUKAI;8441629302;Taip;0;1;0;1
5633;Medynėlis;SKRUZDĖLIUKAI;3761140697;Taip;16;0;0;16
5634;Medynėlis;SKRUZDĖLIUKAI;5330900656;Taip;10;0;1;11
5635;Medynėlis;SKRUZDĖLIUKAI;4897227188;Taip;17;1;0;18
5636;Medynėlis;SKRUZDĖLIUKAI;2339692406;Taip;15;0;0;15
5637;Medynėlis;SKRUZDĖLIUKAI;2433997383;Taip;7;0;0;7
5638;Medynėlis;SKRUZDĖLIUKAI;9873696787;Taip;5;0;3;8
5639;Medynėlis;VOVERIUKAI;6107849795;Taip;5;7;1;13
5640;Medynėlis;VOVERIUKAI;6826790492;Taip;0;1;1;2
5641;Medynėlis;VOVERIUKAI;2627655353;Taip;0;1;3;4
5642;Medynėlis;VOVERIUKAI;5267128750;Taip;0;1;0;1
5643;Medynėlis;VOVERIUKAI;7638618099;Taip;0;1;5;6
5644;Medynėlis;VOVERIUKAI;4488439037;Taip;0;1;2;3
5645;Medynėlis;VOVERIUKAI;4100792567;Taip;0;0;2;2
5646;Medynėlis;VOVERIUKAI;6101613567;Taip;0;1;1;2
5647;Medynėlis;VOVERIUKAI;1056744101;Taip;0;0;15;15
5648;Medynėlis;VOVERIUKAI;6485314750;Taip;0;1;0;1
5649;Medynėlis;VOVERIUKAI;7455041214;Ne;14;1;0;15
5650;Medynėlis;VOVERIUKAI;2234994999;Taip;3;3;0;6
5651;Medynėlis;VOVERIUKAI;3761845905;Taip;0;1;9;10
5652;Medynėlis;VOVERIUKAI;4217263449;Taip;0;1;5;6
5653;Medynėlis;VOVERIUKAI;9825580191;Taip;0;2;1;3
5654;Medynėlis;VOVERIUKAI;3554823424;Taip;0;1;0;1
5655;Medynėlis;VOVERIUKAI;7272017225;Taip;0;6;0;6
5656;Medynėlis;VOVERIUKAI;4092824377;Taip;6;4;0;10
5657;Medynėlis;VOVERIUKAI;1475701065;Taip;0;7;0;7
5658;Medynėlis;VOVERIUKAI;3674134340;Taip;0;3;4;7
5659;Medynėlis;VOVERIUKAI;5028189785;Taip;4;0;3;7
5660;Medynėlis;VOVERIUKAI;3235523199;Taip;3;0;0;3
5661;Medynėlis;VOVERIUKAI;2784942324;Ne;0;1;0;1
5662;Medynėlis;MEŠKIUKAI;2086963376;Taip;1;0;0;1
5663;Medynėlis;MEŠKIUKAI;7740591575;Ne;5;1;0;6
5664;Medynėlis;MEŠKIUKAI;9304002459;Taip;8;1;1;10
5665;Medynėlis;MEŠKIUKAI;90556319090;Taip;6;1;3;10
5666;Medynėlis;MEŠKIUKAI;2834559432;Taip;0;1;3;4
5667;Medynėlis;MEŠKIUKAI;9800678364;Taip;0;0;9;9
5668;Medynėlis;MEŠKIUKAI;2057309788;Taip;0;4;2;6
5669;Medynėlis;MEŠKIUKAI;5982453884;Taip;0;1;0;1
5670;Medynėlis;MEŠKIUKAI;1750775033;Ne;9;1;0;10
5671;Medynėlis;MEŠKIUKAI;8441104709;Taip;12;0;0;12
5672;Medynėlis;MEŠKIUKAI;9123873119;Taip;0;1;0;1
5673;Medynėlis;MEŠKIUKAI;2335108073;Taip;3;3;1;7
5674;Medynėlis;MEŠKIUKAI;1237589979;Taip;3;1;6;10
5675;Medynėlis;MEŠKIUKAI;1820113382;Taip;10;1;2;13
5676;Medynėlis;MEŠKIUKAI;6406459222;Ne;15;1;0;16
5677;Medynėlis;MEŠKIUKAI;1173510831;Ne;6;0;0;6
5678;Medynėlis;MEŠKIUKAI;4985243068;Ne;15;1;0;16
5679;Medynėlis;MEŠKIUKAI;7108619017;Taip;4;1;0;5
5680;Medynėlis;MEŠKIUKAI;6999562417;Taip;0;3;5;8
5681;Medynėlis;MEŠKIUKAI;7140184593;Taip;1;0;3;4
5682;Medynėlis;MEŠKIUKAI;3141225891;Taip;8;0;3;11
5683;Medynėlis;PELĖDŽIUKAI;2932544910;Taip;5;0;0;5
5684;Medynėlis;PELĖDŽIUKAI;9079900803;Taip;0;0;3;3
5685;Medynėlis;PELĖDŽIUKAI;5571641847;Taip;3;0;0;3
5686;Medynėlis;PELĖDŽIUKAI;2103255454;Taip;0;3;0;3
5687;Medynėlis;PELĖDŽIUKAI;9355165862;Taip;1;0;1;2
5688;Medynėlis;PELĖDŽIUKAI;9184868565;Taip;6;1;0;7
5689;Medynėlis;PELĖDŽIUKAI;6706028300;Taip;0;0;1;1
5690;Medynėlis;PELĖDŽIUKAI;6955467123;Taip;3;0;1;4
5691;Medynėlis;PELĖDŽIUKAI;6073797962;Ne;0;2;0;2
5692;Medynėlis;PELĖDŽIUKAI;5785463517;Taip;0;0;1;1
5693;Medynėlis;PELĖDŽIUKAI;4222917765;Taip;0;11;0;11
5694;Medynėlis;PELĖDŽIUKAI;1621499650;Taip;0;11;0;11
5695;Medynėlis;PELĖDŽIUKAI;6681155625;Ne;7;0;1;8
5696;Medynėlis;PELĖDŽIUKAI;9438854582;Taip;0;1;0;1
5697;Medynėlis;PELĖDŽIUKAI;1901805808;Taip;0;1;1;2
5698;Medynėlis;PELĖDŽIUKAI;5784691118;Taip;0;1;1;2
5699;Medynėlis;PELĖDŽIUKAI;4468967036;Taip;0;1;2;3
5700;Medynėlis;PELĖDŽIUKAI;2702814930;Taip;0;0;2;2
5701;Medynėlis;PELĖDŽIUKAI;6113913885;Taip;0;0;1;1
5702;Medynėlis;BORUŽIUKAI;3787172254;Taip;0;1;3;4
5703;Medynėlis;BORUŽIUKAI;7232396755;Taip;5;1;0;6
5704;Medynėlis;BORUŽIUKAI;7651663404;Taip;8;1;1;10
5705;Medynėlis;BORUŽIUKAI;1463263793;Taip;0;15;0;15
5706;Medynėlis;BORUŽIUKAI;1406029765;Taip;5;0;0;5
5707;Medynėlis;BORUŽIUKAI;9764215406;Taip;2;1;0;3
5708;Medynėlis;BORUŽIUKAI;8271170887;Taip;0;1;0;1
5709;Medynėlis;BORUŽIUKAI;5532880670;Taip;0;1;7;8
5710;Medynėlis;BORUŽIUKAI;1525185037;Taip;0;1;0;1
5711;Medynėlis;BORUŽIUKAI;1333848517;Taip;6;6;0;12
5712;Medynėlis;BORUŽIUKAI;9919108302;Taip;0;4;0;4
5713;Medynėlis;BORUŽIUKAI;1162859552;Ne;0;7;0;7
5714;Medynėlis;BORUŽIUKAI;6032067904;Taip;4;0;0;4
5715;Medynėlis;BORUŽIUKAI;4315717555;Taip;9;3;1;13
5716;Medynėlis;BORUŽIUKAI;8276864168;Ne;0;1;4;5
5717;Medynėlis;BORUŽIUKAI;5544663829;Taip;0;2;0;2
5718;Medynėlis;BORUŽIUKAI;2701448160;Ne;0;1;8;9
5719;Medynėlis;BORUŽIUKAI;1658457155;Taip;0;2;2;4
5720;Medynėlis;BORUŽIUKAI;8074251036;Taip;0;1;0;1
5721;Medynėlis;BORUŽIUKAI;5158507933;Taip;20;0;0;20
5722;Medynėlis;BORUŽIUKAI;7501831333;Taip;0;10;0;10
5723;Medynėlis;BORUŽIUKAI;2097758483;Taip;0;6;0;6
5724;Medynėlis;BORUŽIUKAI;4267654911;Taip;0;1;0;1
5725;Medynėlis;EŽIUKAI;9729505759;Taip;0;11;1;12
5726;Medynėlis;EŽIUKAI;8125271445;Taip;0;8;0;8
5727;Medynėlis;EŽIUKAI;9847006679;Taip;9;0;0;9
5728;Medynėlis;EŽIUKAI;7317307957;Taip;0;1;2;3
5729;Medynėlis;EŽIUKAI;7860869675;Taip;11;0;1;12
5730;Medynėlis;EŽIUKAI;4471168173;Taip;0;1;2;3
5731;Medynėlis;EŽIUKAI;1062269215;Taip;7;7;4;18
5732;Medynėlis;EŽIUKAI;5197757730;Ne;0;9;0;9
5733;Medynėlis;EŽIUKAI;5333502849;Taip;0;1;3;4
5734;Medynėlis;EŽIUKAI;6536626390;Taip;10;0;1;11
5735;Medynėlis;EŽIUKAI;8953622684;Taip;0;0;1;1
5736;Medynėlis;EŽIUKAI;3230747109;Taip;5;0;3;8
5737;Medynėlis;EŽIUKAI;9175884049;Taip;8;0;0;8
5738;Medynėlis;EŽIUKAI;8609650186;Taip;0;1;0;1
5739;Medynėlis;EŽIUKAI;6826409129;Taip;7;0;2;9
5740;Medynėlis;EŽIUKAI;2929100410;Taip;1;1;0;2
5741;Medynėlis;EŽIUKAI;6359536923;Ne;0;0;1;1
5742;Medynėlis;EŽIUKAI;2676262920;Taip;0;0;2;2
5743;Medynėlis;EŽIUKAI;5339084041;Taip;5;1;0;6
5744;Medynėlis;EŽIUKAI;5766492584;Taip;0;0;1;1
5745;Medynėlis;EŽIUKAI;6561927001;Taip;5;1;0;6
5746;Medynėlis;EŽIUKAI;8838774666;Taip;21;0;0;21
5747;Medynėlis;EŽIUKAI;6349817783;Taip;8;0;2;10
5748;Medynėlis;ZUIKUČIAI;6614028601;Taip;2;0;0;2
5749;Medynėlis;ZUIKUČIAI;8439619837;Taip;10;0;2;12
5750;Medynėlis;ZUIKUČIAI;5389909872;Taip;3;2;0;5
5751;Medynėlis;ZUIKUČIAI;9352391583;Taip;5;0;2;7
5752;Medynėlis;ZUIKUČIAI;4941353702;Taip;0;1;4;5
5753;Medynėlis;ZUIKUČIAI;3709984586;Taip;7;3;1;11
5754;Medynėlis;ZUIKUČIAI;4040542730;Taip;15;0;0;15
5755;Medynėlis;ZUIKUČIAI;6989524053;Taip;0;0;3;3
5756;Medynėlis;ZUIKUČIAI;9774213537;Taip;0;0;2;2
5757;Medynėlis;ZUIKUČIAI;7129951535;Taip;0;0;1;1
5758;Medynėlis;ZUIKUČIAI;4303234827;Ne;5;0;0;5
5759;Medynėlis;ZUIKUČIAI;9977590259;Taip;6;0;0;6
5760;Medynėlis;ZUIKUČIAI;7170801214;Taip;0;0;1;1
5761;Medynėlis;ZUIKUČIAI;9373849916;Taip;3;0;6;9
5762;Medynėlis;ZUIKUČIAI;8678054784;Taip;5;0;1;6
5763;Medynėlis;ZUIKUČIAI;6462589513;Taip;3;0;0;3
5764;Medynėlis;ZUIKUČIAI;4204366008;Taip;0;4;1;5
5765;Medynėlis;ZUIKUČIAI;6569938649;Ne;0;0;4;4
5766;Medynėlis;ZUIKUČIAI;2523474347;Taip;15;1;0;16
5767;Medynėlis;KAČIUKAI;8275097931;Taip;1;2;0;3
5768;Medynėlis;KAČIUKAI;5302122600;Taip;10;0;2;12
5769;Medynėlis;KAČIUKAI;6609111216;Taip;2;0;0;2
5770;Medynėlis;KAČIUKAI;6624835214;Taip;10;1;0;11
5771;Medynėlis;KAČIUKAI;2160081492;Taip;6;0;0;6
5772;Medynėlis;KAČIUKAI;4035587227;Taip;16;0;0;16
5773;Medynėlis;KAČIUKAI;8162771849;Taip;7;0;3;10
5774;Medynėlis;KAČIUKAI;9725019515;Ne;0;0;4;4
5775;Medynėlis;KAČIUKAI;3185760752;Taip;12;0;1;13
5776;Medynėlis;KAČIUKAI;5610660982;Taip;9;0;1;10
5777;Medynėlis;KAČIUKAI;6282113738;Taip;19;0;0;19
5778;Medynėlis;KAČIUKAI;4153545500;Taip;1;7;0;8
5779;Medynėlis;KAČIUKAI;8299034970;Taip;1;0;5;6
5780;Medynėlis;KAČIUKAI;7675101600;Ne;0;1;1;2
5781;Medynėlis;KAČIUKAI;1668143166;Taip;5;3;2;10
5782;Medynėlis;KAČIUKAI;4010058673;Taip;8;1;0;9
5783;Medynėlis;KAČIUKAI;6502531749;Taip;0;0;9;9
5784;Medynėlis;KAČIUKAI;9076139419;Taip;0;4;2;6
5785;Medynėlis;KAČIUKAI;1608019909;Taip;14;3;0;17
5786;Medynėlis;KAČIUKAI;1026253778;Ne;0;0;2;2
5787;Medynėlis;PELIUKAI;6622963662;Taip;0;0;1;1
5788;Medynėlis;PELIUKAI;3638155321;Taip;8;1;0;9
5789;Medynėlis;PELIUKAI;4243521511;Taip;0;1;0;1
5790;Medynėlis;PELIUKAI;9290099536;Taip;21;0;0;21
5791;Medynėlis;PELIUKAI;1500986498;Ne;7;0;1;8
5792;Medynėlis;PELIUKAI;2379829985;Taip;6;1;2;9
5793;Medynėlis;PELIUKAI;5391199861;Ne;21;0;0;21
5794;Medynėlis;PELIUKAI;9485498942;Taip;0;0;1;1
5795;Medynėlis;PELIUKAI;6095795724;Taip;6;0;0;6
5796;Medynėlis;PELIUKAI;7914358405;Taip;0;1;0;1
5797;Medynėlis;PELIUKAI;7695626630;Taip;0;0;1;1
5798;Medynėlis;PELIUKAI;9182653290;Taip;6;0;0;6
5799;Medynėlis;PELIUKAI;3538656650;Taip;15;6;0;21
5800;Medynėlis;PELIUKAI;2877881247;Taip;0;7;0;7
5801;Medynėlis;PELIUKAI;4145591997;Taip;7;1;0;8
5802;Medynėlis;PELIUKAI;8382537735;Taip;0;0;2;2
5803;Medynėlis;PELIUKAI;6470879334;Ne;2;0;1;3
5804;Medynėlis;PELIUKAI;2816510180;Taip;0;0;2;2
5805;Medynėlis;ANČIUKAI;9857514451;Taip;1;0;0;1
5806;Medynėlis;ANČIUKAI;6730475188;Taip;15;0;0;15
5807;Medynėlis;ANČIUKAI;6824842361;Taip;7;0;1;8
5808;Medynėlis;ANČIUKAI;5677747582;Taip;9;0;0;9
5809;Medynėlis;ANČIUKAI;4498233742;Taip;13;0;0;13
5810;Medynėlis;ANČIUKAI;5049081242;Taip;17;1;0;18
5811;Medynėlis;ANČIUKAI;4910857912;Taip;2;0;0;2
5812;Medynėlis;ANČIUKAI;4817353132;Taip;0;0;7;7
5813;Medynėlis;ANČIUKAI;7613699868;Ne;7;0;2;9
5814;Medynėlis;ANČIUKAI;9336656351;Taip;11;0;0;11
5815;Medynėlis;ANČIUKAI;7085226543;Taip;19;0;0;19
5816;Medynėlis;ANČIUKAI;1283602655;Taip;0;0;12;12
5817;Medynėlis;ANČIUKAI;3556203620;Taip;0;0;5;5
5818;Medynėlis;ANČIUKAI;2896713695;Taip;2;1;0;3
5819;Medynėlis;ANČIUKAI;8887092965;Taip;0;0;5;5
5820;Medynėlis;ANČIUKAI;4626655069;Taip;1;0;1;2
5821;Medynėlis;ANČIUKAI;5456045449;Taip;0;2;0;2
5822;Medynėlis;ANČIUKAI;8667441678;Taip;0;2;0;2
5823;Molinukas;NYKŠTUKAI;6353165459;Taip;0;4;0;4
5824;Molinukas;NYKŠTUKAI;5876669121;Taip;0;1;0;1
5825;Molinukas;NYKŠTUKAI;6087698882;Taip;0;1;0;1
5826;Molinukas;NYKŠTUKAI;2211909678;Taip;11;0;0;11
5827;Molinukas;NYKŠTUKAI;2348120316;Taip;0;3;0;3
5828;Molinukas;NYKŠTUKAI;8053608348;Taip;10;1;0;11
5829;Molinukas;NYKŠTUKAI;7623051674;Taip;0;2;0;2
5830;Molinukas;NYKŠTUKAI;9448910819;Taip;0;1;1;2
5831;Molinukas;NYKŠTUKAI;1651650182;Taip;0;1;0;1
5832;Molinukas;NYKŠTUKAI;5580968328;Taip;1;1;0;2
5833;Molinukas;NYKŠTUKAI;8536615996;Taip;0;0;2;2
5834;Molinukas;NYKŠTUKAI;7602239077;Taip;3;0;0;3
5835;Molinukas;NYKŠTUKAI;1849018608;Taip;0;1;0;1
5836;Molinukas;NYKŠTUKAI;4171978721;Taip;11;1;0;12
5837;Molinukas;NYKŠTUKAI;9293819449;Taip;0;0;1;1
5838;Molinukas;NYKŠTUKAI;5525772579;Taip;0;5;0;5
5839;Molinukas;NYKŠTUKAI;4475594896;Taip;0;4;0;4
5840;Molinukas;NYKŠTUKAI;7248705010;Taip;11;2;0;13
5841;Molinukas;NYKŠTUKAI;4101644021;Taip;6;4;0;10
5842;Molinukas;NYKŠTUKAI;6681397435;Taip;11;0;2;13
5843;Molinukas;ZUIKUČIŲ;9203375647;Taip;1;4;0;5
5844;Molinukas;ZUIKUČIŲ;2982968605;Taip;0;1;0;1
5845;Molinukas;ZUIKUČIŲ;8479427729;Ne;4;0;2;6
5846;Molinukas;ZUIKUČIŲ;4225457772;Taip;6;0;0;6
5847;Molinukas;ZUIKUČIŲ;8114735116;Taip;0;4;0;4
5848;Molinukas;ZUIKUČIŲ;5597119459;Taip;0;1;2;3
5849;Molinukas;ZUIKUČIŲ;8582985479;Taip;11;0;0;11
5850;Molinukas;ZUIKUČIŲ;8490020853;Taip;11;0;0;11
5851;Molinukas;ZUIKUČIŲ;2651732418;Taip;1;0;2;3
5852;Molinukas;ZUIKUČIŲ;8988478990;Taip;5;0;1;6
5853;Molinukas;ZUIKUČIŲ;1059002689;Taip;11;9;0;20
5854;Molinukas;ZUIKUČIŲ;5302191209;Taip;12;0;3;15
5855;Molinukas;ZUIKUČIŲ;1605039166;Taip;5;0;1;6
5856;Molinukas;ZUIKUČIŲ;6804127471;Taip;5;0;1;6
5857;Molinukas;ZUIKUČIŲ;2878262979;Taip;1;0;0;1
5858;Molinukas;ZUIKUČIŲ;7441251480;Taip;0;0;1;1
5859;Molinukas;ZUIKUČIŲ;4733315902;Taip;4;0;4;8
5860;Molinukas;ZUIKUČIŲ;2595941277;Taip;0;0;1;1
5861;Molinukas;ZUIKUČIŲ;2706981559;Taip;5;1;3;9
5862;Molinukas;ZUIKUČIŲ;6638634402;Taip;5;0;0;5
5863;Molinukas;ZUIKUČIŲ;3516132254;Taip;5;0;0;5
5864;Molinukas;ZUIKUČIŲ;4718396549;Taip;18;0;0;18
5865;Molinukas;ZUIKUČIŲ;3577613732;Taip;5;1;2;8
5866;Molinukas;ZUIKUČIŲ;9972204424;Taip;3;0;1;4
5867;Molinukas;ZUIKUČIŲ;3419958136;Taip;10;0;1;11
5868;Molinukas;ZUIKUČIŲ;2789279432;Taip;0;0;1;1
5869;Molinukas;SRAIGIUKŲ;8416644024;Taip;0;1;3;4
5870;Molinukas;SRAIGIUKŲ;1686122652;Taip;0;1;0;1
5871;Molinukas;SRAIGIUKŲ;9948685221;Taip;1;3;2;6
5872;Molinukas;SRAIGIUKŲ;6326031969;Taip;0;1;4;5
5873;Molinukas;SRAIGIUKŲ;8393217418;Taip;4;2;0;6
5874;Molinukas;SRAIGIUKŲ;6636118069;Taip;4;1;1;6
5875;Molinukas;SRAIGIUKŲ;1856269656;Taip;0;1;0;1
5876;Molinukas;SRAIGIUKŲ;4766547534;Taip;5;0;0;5
5877;Molinukas;SRAIGIUKŲ;7377137582;Taip;0;3;0;3
5878;Molinukas;SRAIGIUKŲ;6084682084;Taip;3;8;0;11
5879;Molinukas;SRAIGIUKŲ;8913137310;Ne;0;3;3;6
5880;Molinukas;SRAIGIUKŲ;5387818175;Taip;4;1;0;5
5881;Molinukas;SRAIGIUKŲ;1138255845;Taip;0;1;0;1
5882;Molinukas;SRAIGIUKŲ;8604288346;Taip;9;2;5;16
5883;Molinukas;SRAIGIUKŲ;4806350914;Taip;0;1;0;1
5884;Molinukas;SRAIGIUKŲ;8617979245;Taip;0;1;2;3
5885;Molinukas;SRAIGIUKŲ;2757744826;Taip;2;1;0;3
5886;Molinukas;SRAIGIUKŲ;4534279257;Taip;7;1;0;8
5887;Molinukas;SRAIGIUKŲ;4918181437;Taip;0;1;3;4
5888;Molinukas;SRAIGIUKŲ;7451224160;Taip;2;1;0;3
5889;Molinukas;SRAIGIUKŲ;8688180482;Taip;6;2;1;9
5890;Molinukas;SRAIGIUKŲ;3917187380;Taip;5;1;0;6
5891;Molinukas;VOVERIUKAI;3469196411;Taip;16;1;0;17
5892;Molinukas;VOVERIUKAI;4583155940;Taip;0;0;7;7
5893;Molinukas;VOVERIUKAI;8541456847;Taip;0;0;8;8
5894;Molinukas;VOVERIUKAI;2286586693;Taip;3;1;2;6
5895;Molinukas;VOVERIUKAI;9413396859;Taip;2;0;0;2
5896;Molinukas;VOVERIUKAI;6898958282;Taip;6;0;1;7
5897;Molinukas;VOVERIUKAI;4000190261;Taip;0;0;1;1
5898;Molinukas;VOVERIUKAI;5685582215;Taip;0;3;3;6
5899;Molinukas;VOVERIUKAI;2356814145;Taip;0;0;4;4
5900;Molinukas;VOVERIUKAI;7446607510;Taip;2;4;0;6
5901;Molinukas;VOVERIUKAI;9667704959;Taip;9;0;7;16
5902;Molinukas;VOVERIUKAI;8516451290;Taip;1;0;1;2
5903;Molinukas;VOVERIUKAI;3030169626;Taip;0;1;0;1
5904;Molinukas;VOVERIUKAI;3207373459;Taip;5;0;7;12
5905;Molinukas;VOVERIUKAI;1865748733;Ne;2;2;0;4
5906;Molinukas;VOVERIUKAI;4209143136;Taip;16;0;0;16
5907;Molinukas;VOVERIUKAI;5648861702;Taip;16;0;0;16
5908;Molinukas;VOVERIUKAI;4957226547;Taip;8;0;1;9
5909;Molinukas;VOVERIUKAI;8865966572;Taip;0;1;1;2
5910;Molinukas;VOVERIUKAI;4950808381;Taip;0;5;7;12
5911;Molinukas;VOVERIUKAI;7378643086;Taip;0;1;5;6
5912;Molinukas;VOVERIUKAI;2779700726;Taip;8;0;10;18
5913;Molinukas;VOVERIUKAI;6832647220;Taip;0;0;9;9
5914;Molinukas;VOVERIUKAI;8247270556;Taip;5;1;4;10
5915;Molinukas;ŽVIRBLIUKŲ;2935945686;Taip;7;1;5;13
5916;Molinukas;ŽVIRBLIUKŲ;7825545164;Taip;1;0;1;2
5917;Molinukas;ŽVIRBLIUKŲ;6190443233;Taip;5;0;1;6
5918;Molinukas;ŽVIRBLIUKŲ;1831078544;Taip;16;0;0;16
5919;Molinukas;ŽVIRBLIUKŲ;7419801506;Taip;0;1;8;9
5920;Molinukas;ŽVIRBLIUKŲ;6531106368;Taip;4;0;3;7
5921;Molinukas;ŽVIRBLIUKŲ;4122429163;Taip;5;0;0;5
5922;Molinukas;ŽVIRBLIUKŲ;8660958288;Taip;6;2;0;8
5923;Molinukas;ŽVIRBLIUKŲ;2862680065;Taip;11;0;0;11
5924;Molinukas;ŽVIRBLIUKŲ;3382913312;Taip;1;0;7;8
5925;Molinukas;ŽVIRBLIUKŲ;3331982964;Taip;0;0;1;1
5926;Molinukas;ŽVIRBLIUKŲ;2448588784;Taip;10;1;1;12
5927;Molinukas;ŽVIRBLIUKŲ;2842168450;Taip;7;0;0;7
5928;Molinukas;KAČIUKŲ;4992887072;Taip;6;0;2;8
5929;Molinukas;KAČIUKŲ;1292778118;Taip;4;0;3;7
5930;Molinukas;KAČIUKŲ;8769667823;Taip;0;1;0;1
5931;Molinukas;KAČIUKŲ;8313486714;Taip;5;0;1;6
5932;Molinukas;KAČIUKŲ;3043679624;Taip;15;1;0;16
5933;Molinukas;KAČIUKŲ;2030429825;Taip;4;0;1;5
5934;Molinukas;KAČIUKŲ;4974513900;Taip;0;3;0;3
5935;Molinukas;KAČIUKŲ;1826463800;Taip;0;2;0;2
5936;Molinukas;KAČIUKŲ;6947938890;Taip;21;0;0;21
5937;Molinukas;KAČIUKŲ;1970929144;Taip;0;0;2;2
5938;Molinukas;KAČIUKŲ;3510936830;Taip;0;0;3;3
5939;Molinukas;KAČIUKŲ;8608465121;Taip;11;0;4;15
5940;Molinukas;KAČIUKŲ;1651103318;Taip;4;0;3;7
5941;Molinukas;KAČIUKŲ;8973341322;Taip;9;0;0;9
5942;"Naminukas (Smėlio g. 13)";Drugeliai;6776805494;Taip;0;5;0;5
5943;"Naminukas (Smėlio g. 13)";Drugeliai;2395070574;Taip;4;1;0;5
5944;"Naminukas (Smėlio g. 13)";Drugeliai;5534073614;Taip;0;1;0;1
5945;"Naminukas (Smėlio g. 13)";Drugeliai;2132345627;Taip;0;1;1;2
5946;"Naminukas (Smėlio g. 13)";Drugeliai;1302119260;Taip;0;3;5;8
5947;"Naminukas (Smėlio g. 13)";Drugeliai;2864905392;Taip;20;0;0;20
5948;"Naminukas (Smėlio g. 13)";Drugeliai;7406775925;Taip;6;2;3;11
5949;"Naminukas (Smėlio g. 13)";Drugeliai;1333462200;Taip;1;0;5;6
5950;"Naminukas (Smėlio g. 13)";Drugeliai;5468218968;Taip;0;1;0;1
5951;"Naminukas (Smėlio g. 13)";Drugeliai;5713661641;Taip;0;1;0;1
5952;"Naminukas (Smėlio g. 13)";Drugeliai;3320805432;Taip;0;2;0;2
5953;"Naminukas (Smėlio g. 13)";Drugeliai;9689866363;Taip;0;0;1;1
5954;"Naminukas (Smėlio g. 13)";Drugeliai;2198493034;Taip;0;3;3;6
5955;"Naminukas (Smėlio g. 13)";Drugeliai;8141324449;Taip;8;0;5;13
5956;"Naminukas (Smėlio g. 13)";Drugeliai;8564586014;Taip;0;2;0;2
5957;"Naminukas (Smėlio g. 13)";Drugeliai;3236525642;Taip;0;5;0;5
5958;"Naminukas (Smėlio g. 13)";Drugeliai;7347998152;Taip;0;5;0;5
5959;"Naminukas (Smėlio g. 13)";Bitutės;4419568254;Taip;0;1;0;1
5960;"Naminukas (Smėlio g. 13)";Bitutės;1956749138;Taip;0;1;4;5
5961;"Naminukas (Smėlio g. 13)";Bitutės;6503569633;Ne;0;1;5;6
5962;"Naminukas (Smėlio g. 13)";Bitutės;3192885665;Taip;1;0;5;6
5963;"Naminukas (Smėlio g. 13)";Bitutės;9530232649;Taip;4;1;5;10
5964;"Naminukas (Smėlio g. 13)";Bitutės;8131328042;Taip;4;2;8;14
5965;"Naminukas (Smėlio g. 13)";Bitutės;7888950723;Taip;0;0;2;2
5966;"Naminukas (Smėlio g. 13)";Bitutės;1710002948;Taip;0;1;0;1
5967;"Naminukas (Smėlio g. 13)";Bitutės;3994190066;Taip;0;1;0;1
5968;"Naminukas (Smėlio g. 13)";Bitutės;5195078101;Taip;3;2;0;5
5969;"Naminukas (Smėlio g. 13)";Bitutės;9541388086;Taip;0;1;2;3
5970;"Naminukas (Smėlio g. 13)";Bitutės;2424412518;Taip;13;1;5;19
5971;"Naminukas (Smėlio g. 13)";Bitutės;41538301616;Taip;0;1;0;1
5972;"Naminukas (Smėlio g. 13)";Bitutės;5493709688;Taip;0;1;12;13
5973;"Naminukas (Smėlio g. 13)";Bitutės;2769848640;Taip;0;1;0;1
5974;"Naminukas (Smėlio g. 13)";Bitutės;9821244713;Ne;10;0;3;13
5975;"Naminukas (Smėlio g. 13)";Bitutės;7847923107;Taip;5;0;0;5
5976;"Naminukas (Smėlio g. 13)";Bitutės;1480152104;Taip;7;1;0;8
5977;"Naminukas (Smėlio g. 13)";Paukšteliai;3501921619;Ne;0;1;0;1
5978;"Naminukas (Smėlio g. 13)";Paukšteliai;7297661383;Taip;0;0;2;2
5979;"Naminukas (Smėlio g. 13)";Paukšteliai;5056487802;Taip;0;1;0;1
5980;"Naminukas (Smėlio g. 13)";Paukšteliai;3438010199;Taip;6;0;6;12
5981;"Naminukas (Smėlio g. 13)";Paukšteliai;4998565160;Taip;10;3;0;13
5982;"Naminukas (Smėlio g. 13)";Paukšteliai;9405784626;Taip;0;1;6;7
5983;"Naminukas (Smėlio g. 13)";Paukšteliai;2583886896;Taip;0;0;1;1
5984;"Naminukas (Smėlio g. 13)";Paukšteliai;4778385421;Taip;0;8;0;8
5985;"Naminukas (Smėlio g. 13)";Paukšteliai;6178500478;Taip;1;0;1;2
5986;"Naminukas (Smėlio g. 13)";Paukšteliai;1406418130;Taip;10;0;0;10
5987;"Naminukas (Smėlio g. 13)";Paukšteliai;9891722891;Taip;4;6;0;10
5988;"Naminukas (Smėlio g. 13)";Paukšteliai;2012656186;Ne;0;0;1;1
5989;"Naminukas (Smėlio g. 13)";Paukšteliai;3727828033;Ne;0;4;0;4
5990;"Naminukas (Smėlio g. 13)";"NYKŠTUKAI ";5849662446;Taip;0;6;0;6
5991;"Naminukas (Smėlio g. 13)";"NYKŠTUKAI ";7646186458;Taip;2;0;0;2
5992;"Naminukas (Smėlio g. 13)";"NYKŠTUKAI ";5519447152;Taip;11;2;0;13
5993;"Naminukas (Smėlio g. 13)";"NYKŠTUKAI ";5741698937;Taip;7;1;2;10
5994;"Naminukas (Smėlio g. 13)";"NYKŠTUKAI ";1286329245;Taip;16;0;1;17
5995;"Naminukas (Smėlio g. 13)";"NYKŠTUKAI ";3424189866;Ne;16;0;1;17
5996;"Naminukas (Smėlio g. 13)";"NYKŠTUKAI ";1618802271;Taip;0;0;8;8
5997;"Naminukas (Smėlio g. 13)";"NYKŠTUKAI ";1591540165;Taip;16;0;0;16
5998;"Naminukas (Smėlio g. 13)";"NYKŠTUKAI ";9537360943;Taip;12;4;0;16
5999;"Naminukas (Smėlio g. 13)";"NYKŠTUKAI ";1118193598;Ne;4;0;0;4
6000;"Naminukas (Smėlio g. 13)";"NYKŠTUKAI ";8102805098;Taip;9;0;1;10
6001;"Naminukas (Smėlio g. 13)";"NYKŠTUKAI ";9357758815;Taip;0;0;2;2
6002;Nykštukas;SMAGURIAI;8120626738;Taip;0;8;0;8
6003;Nykštukas;SMAGURIAI;9842748132;Ne;15;1;0;16
6004;Nykštukas;SMAGURIAI;4830484167;Taip;8;1;0;9
6005;Nykštukas;SMAGURIAI;1902253981;Taip;0;4;0;4
6006;Nykštukas;SMAGURIAI;4949895196;Taip;4;1;0;5
6007;Nykštukas;SMAGURIAI;9713859038;Ne;2;1;0;3
6008;Nykštukas;SMAGURIAI;7954996421;Taip;5;6;0;11
6009;Nykštukas;SMAGURIAI;4771072061;Taip;9;1;0;10
6010;Nykštukas;SMAGURIAI;6139988523;Taip;0;1;0;1
6011;Nykštukas;SMAGURIAI;5190754451;Taip;0;3;0;3
6012;Nykštukas;SMAGURIAI;8310484267;Taip;5;1;0;6
6013;Nykštukas;SMAGURIAI;1707956308;Taip;5;1;0;6
6014;Nykštukas;SMAGURIAI;8635571067;Taip;0;1;0;1
6015;Nykštukas;SMAGURIAI;9326131725;Taip;0;1;0;1
6016;Nykštukas;SMAGURIAI;2000207070;Taip;0;1;0;1
6017;Nykštukas;SMAGURIAI;2826079911;Taip;0;2;0;2
6018;Nykštukas;SMAGURIAI;7911842707;Taip;11;3;0;14
6019;Nykštukas;SMAGURIAI;6102907953;Taip;6;2;0;8
6020;Nykštukas;SMAGURIAI;7529677915;Taip;3;4;0;7
6021;Nykštukas;SMAGURIAI;4994727422;Ne;5;6;0;11
6022;Nykštukas;SMAGURIAI;3007541327;Taip;5;1;0;6
6023;Nykštukas;SMAGURIAI;3370000872;Taip;0;1;0;1
6024;Nykštukas;SMALSIUKAI;5121027981;Taip;10;1;0;11
6025;Nykštukas;SMALSIUKAI;6958596223;Taip;0;2;2;4
6026;Nykštukas;SMALSIUKAI;4612171029;Taip;0;1;0;1
6027;Nykštukas;SMALSIUKAI;3120577264;Taip;0;12;0;12
6028;Nykštukas;SMALSIUKAI;1386798219;Taip;11;2;0;13
6029;Nykštukas;SMALSIUKAI;2696384135;Taip;4;3;0;7
6030;Nykštukas;SMALSIUKAI;9532956150;Taip;0;5;0;5
6031;Nykštukas;SMALSIUKAI;3273579005;Taip;5;4;0;9
6032;Nykštukas;SMALSIUKAI;3985610575;Taip;10;3;0;13
6033;Nykštukas;SMALSIUKAI;8948554271;Taip;0;1;0;1
6034;Nykštukas;SMALSIUKAI;1102555964;Taip;0;1;0;1
6035;Nykštukas;SMALSIUKAI;4331906712;Taip;0;2;0;2
6036;Nykštukas;SMALSIUKAI;6112448299;Taip;0;2;1;3
6037;Nykštukas;SMALSIUKAI;1930357859;Taip;0;1;0;1
6038;Nykštukas;SMALSIUKAI;9100510105;Taip;0;1;0;1
6039;Nykštukas;SMALSIUKAI;2143857296;Taip;0;2;0;2
6040;Nykštukas;SMALSIUKAI;9779645295;Taip;0;3;0;3
6041;Nykštukas;SMALSIUKAI;2571249434;Taip;0;6;0;6
6042;Nykštukas;SMALSIUKAI;3694497590;Taip;0;1;0;1
6043;Nykštukas;AITVARIUKAI;6923345088;Taip;5;0;0;5
6044;Nykštukas;AITVARIUKAI;8580777381;Taip;7;1;0;8
6045;Nykštukas;AITVARIUKAI;9216544103;Taip;1;2;0;3
6046;Nykštukas;AITVARIUKAI;9319066179;Taip;0;6;0;6
6047;Nykštukas;AITVARIUKAI;2177539882;Taip;5;0;1;6
6048;Nykštukas;AITVARIUKAI;9595654681;Taip;5;0;1;6
6049;Nykštukas;AITVARIUKAI;9894698453;Taip;0;1;0;1
6050;Nykštukas;AITVARIUKAI;6351178752;Taip;4;0;1;5
6051;Nykštukas;AITVARIUKAI;2232317366;Taip;0;0;1;1
6052;Nykštukas;AITVARIUKAI;7332769878;Ne;5;2;0;7
6053;Nykštukas;AITVARIUKAI;7896338372;Taip;8;0;0;8
6054;Nykštukas;AITVARIUKAI;2208319289;Taip;0;12;0;12
6055;Nykštukas;AITVARIUKAI;8548820023;Taip;7;0;0;7
6056;Nykštukas;AITVARIUKAI;9545178064;Taip;5;0;0;5
6057;Nykštukas;AITVARIUKAI;3561627809;Taip;5;0;0;5
6058;Nykštukas;AITVARIUKAI;5538446312;Ne;6;0;2;8
6059;Nykštukas;AITVARIUKAI;4822304386;Taip;0;0;2;2
6060;Nykštukas;AITVARIUKAI;4177690371;Taip;3;0;0;3
6061;Nykštukas;AITVARIUKAI;5292127770;Taip;0;0;1;1
6062;Nykštukas;DAINORĖLIAI;7526936193;Ne;1;2;2;5
6063;Nykštukas;DAINORĖLIAI;7730918105;Ne;0;1;0;1
6064;Nykštukas;DAINORĖLIAI;8475127245;Taip;0;1;3;4
6065;Nykštukas;DAINORĖLIAI;5434220008;Taip;0;0;3;3
6066;Nykštukas;DAINORĖLIAI;1122600949;Taip;1;0;6;7
6067;Nykštukas;DAINORĖLIAI;3853935568;Taip;0;6;0;6
6068;Nykštukas;DAINORĖLIAI;9776630115;Taip;0;5;0;5
6069;Nykštukas;DAINORĖLIAI;9524639831;Ne;0;1;0;1
6070;Nykštukas;DAINORĖLIAI;3367348573;Taip;0;11;0;11
6071;Nykštukas;DAINORĖLIAI;5961945345;Taip;3;0;1;4
6072;Nykštukas;DAINORĖLIAI;6561696818;Taip;4;0;5;9
6073;Nykštukas;DAINORĖLIAI;1283453188;Taip;12;0;0;12
6074;Nykštukas;DAINORĖLIAI;1167614164;Taip;1;0;0;1
6075;Nykštukas;DAINORĖLIAI;7473124310;Taip;2;0;1;3
6076;Nykštukas;DAINORĖLIAI;1174618721;Taip;0;3;0;3
6077;Nykštukas;DAINORĖLIAI;8681884252;Taip;0;4;0;4
6078;Nykštukas;DAINORĖLIAI;5255726742;Taip;19;0;0;19
6079;Nykštukas;DAINORĖLIAI;9027355399;Taip;0;10;0;10
6080;Nykštukas;DAINORĖLIAI;4893494144;Taip;0;3;0;3
6081;Nykštukas;DAINORĖLIAI;8318089070;Taip;0;0;4;4
6082;Nykštukas;DAINORĖLIAI;2727074729;Taip;1;7;3;11
6083;Nykštukas;POKŠTUKAI;7382271765;Ne;0;6;0;6
6084;Nykštukas;POKŠTUKAI;1655428422;Taip;0;2;0;2
6085;Nykštukas;POKŠTUKAI;2649916049;Taip;0;11;0;11
6086;Nykštukas;POKŠTUKAI;1796016501;Taip;0;19;0;19
6087;Nykštukas;POKŠTUKAI;5958711585;Taip;5;3;0;8
6088;Nykštukas;POKŠTUKAI;3999004312;Taip;4;3;0;7
6089;Nykštukas;POKŠTUKAI;6719999304;Taip;5;8;0;13
6090;Nykštukas;POKŠTUKAI;8148163137;Taip;5;6;0;11
6091;Nykštukas;POKŠTUKAI;8708184278;Taip;0;2;0;2
6092;Nykštukas;POKŠTUKAI;5699671696;Taip;0;8;0;8
6093;Nykštukas;POKŠTUKAI;3843163586;Taip;0;8;0;8
6094;Nykštukas;POKŠTUKAI;1316018865;Taip;0;5;0;5
6095;Nykštukas;POKŠTUKAI;3507649457;Taip;0;1;0;1
6096;Nykštukas;POKŠTUKAI;3428031037;Taip;0;9;0;9
6097;Nykštukas;POKŠTUKAI;4508625009;Taip;0;9;0;9
6098;Nykštukas;POKŠTUKAI;6698622575;Taip;6;1;0;7
6099;Nykštukas;POKŠTUKAI;2982662650;Taip;0;2;0;2
6100;Nykštukas;POKŠTUKAI;2627736026;Taip;0;16;0;16
6101;Nykštukas;POKŠTUKAI;4401103119;Taip;0;7;0;7
6102;Nykštukas;POKŠTUKAI;5287713634;Taip;0;3;0;3
6103;Nykštukas;KODĖLČIUKAI;8168579152;Taip;4;0;0;4
6104;Nykštukas;KODĖLČIUKAI;9285820767;Ne;2;0;0;2
6105;Nykštukas;KODĖLČIUKAI;2685400939;Ne;16;0;0;16
6106;Nykštukas;KODĖLČIUKAI;3278960733;Ne;4;0;2;6
6107;Nykštukas;KODĖLČIUKAI;5934979528;Taip;1;0;2;3
6108;Nykštukas;KODĖLČIUKAI;3760617860;Ne;0;4;0;4
6109;Nykštukas;KODĖLČIUKAI;6927545099;Ne;6;0;1;7
6110;Nykštukas;KODĖLČIUKAI;8042479133;Taip;0;0;9;9
6111;Nykštukas;KODĖLČIUKAI;6999380958;Taip;9;0;2;11
6112;Nykštukas;KODĖLČIUKAI;6794885966;Taip;11;0;0;11
6113;Nykštukas;KODĖLČIUKAI;7616459970;Taip;6;1;0;7
6114;Nykštukas;KODĖLČIUKAI;2623254163;Taip;21;0;0;21
6115;Nykštukas;KODĖLČIUKAI;9296449928;Taip;1;0;2;3
6116;Nykštukas;KODĖLČIUKAI;2992219360;Taip;1;8;1;10
6117;Nykštukas;KODĖLČIUKAI;8804969886;Taip;10;0;1;11
6118;Nykštukas;KODĖLČIUKAI;3552386621;Taip;20;0;0;20
6119;Nykštukas;KODĖLČIUKAI;3990260342;Taip;11;0;0;11
6120;Nykštukas;KODĖLČIUKAI;2692551262;Taip;5;0;0;5
6121;Nykštukas;PASAKORIAI;2661110617;Taip;0;9;0;9
6122;Nykštukas;PASAKORIAI;3040001373;Taip;6;0;4;10
6123;Nykštukas;PASAKORIAI;1855278809;Taip;0;4;0;4
6124;Nykštukas;PASAKORIAI;8640715657;Taip;8;0;2;10
6125;Nykštukas;PASAKORIAI;5504584349;Taip;5;1;1;7
6126;Nykštukas;PASAKORIAI;7990462246;Taip;0;3;2;5
6127;Nykštukas;PASAKORIAI;1379378120;Taip;0;0;2;2
6128;Nykštukas;PASAKORIAI;9413198245;Taip;13;0;0;13
6129;Nykštukas;PASAKORIAI;2518342041;Taip;0;4;0;4
6130;Nykštukas;PASAKORIAI;7828733135;Taip;0;0;4;4
6131;Nykštukas;PASAKORIAI;4480184458;Taip;0;0;4;4
6132;Nykštukas;PASAKORIAI;4090494707;Taip;2;1;0;3
6133;Nykštukas;PASAKORIAI;3026598985;Taip;5;1;0;6
6134;Nykštukas;PASAKORIAI;9714310539;Taip;0;4;0;4
6135;Nykštukas;PASAKORIAI;4795301170;Taip;3;1;1;5
6136;Nykštukas;PASAKORIAI;1579064341;Taip;10;0;1;11
6137;Nykštukas;PASAKORIAI;4992654449;Taip;0;0;5;5
6138;Nykštukas;PASAKORIAI;5337728911;Taip;9;3;0;12
6139;Nykštukas;PASAKORIAI;9509051946;Ne;0;5;0;5
6140;Nykštukas;PASAKORIAI;2231375994;Taip;7;7;0;14
6141;Nykštukas;PASAKORIAI;8371081106;Taip;9;4;0;13
6142;Nykštukas;PASAKORIAI;3496434361;Taip;0;2;0;2
6143;Nykštukas;GUDRUČIAI;4559818614;Taip;0;2;0;2
6144;Nykštukas;GUDRUČIAI;9250827058;Ne;0;2;0;2
6145;Nykštukas;GUDRUČIAI;7447202642;Taip;3;0;0;3
6146;Nykštukas;GUDRUČIAI;1714708754;Taip;3;1;0;4
6147;Nykštukas;GUDRUČIAI;5157799354;Taip;5;0;0;5
6148;Nykštukas;GUDRUČIAI;4325369395;Taip;0;0;3;3
6149;Nykštukas;GUDRUČIAI;6630804505;Taip;0;4;0;4
6150;Nykštukas;GUDRUČIAI;8363202198;Taip;0;2;0;2
6151;Nykštukas;GUDRUČIAI;7326535810;Taip;6;2;0;8
6152;Nykštukas;GUDRUČIAI;9941937734;Taip;0;0;2;2
6153;Nykštukas;GUDRUČIAI;2494482185;Taip;7;0;0;7
6154;Nykštukas;GUDRUČIAI;3619459404;Taip;3;5;1;9
6155;Nykštukas;GUDRUČIAI;1934596739;Ne;0;0;2;2
6156;Nykštukas;GUDRUČIAI;7604740418;Taip;4;0;1;5
6157;Nykštukas;GUDRUČIAI;2970293467;Taip;13;2;0;15
6158;Nykštukas;GUDRUČIAI;2881323571;Ne;0;3;1;4
6159;Nykštukas;GUDRUČIAI;9437700329;Taip;3;4;0;7
6160;Nykštukas;GUDRUČIAI;2872277381;Taip;6;1;0;7
6161;Nykštukas;GUDRUČIAI;9940519259;Ne;3;0;0;3
6162;Nykštukas;NAMINUKAI;7456007276;Taip;0;4;0;4
6163;Nykštukas;NAMINUKAI;7176519994;Taip;11;0;0;11
6164;Nykštukas;NAMINUKAI;2440574056;Taip;5;1;0;6
6165;Nykštukas;NAMINUKAI;4064016871;Taip;0;1;1;2
6166;Nykštukas;NAMINUKAI;9054070492;Taip;0;1;0;1
6167;Nykštukas;NAMINUKAI;6519078450;Taip;4;0;0;4
6168;Nykštukas;NAMINUKAI;6106373554;Ne;1;0;0;1
6169;Nykštukas;NAMINUKAI;4925214655;Taip;0;1;0;1
6170;Nykštukas;NAMINUKAI;5032283848;Taip;3;1;0;4
6171;Nykštukas;NAMINUKAI;7494444468;Taip;3;1;0;4
6172;Nykštukas;NAMINUKAI;3925958632;Taip;3;1;0;4
6173;Nykštukas;NAMINUKAI;6338717583;Taip;0;2;0;2
6174;Nykštukas;NAMINUKAI;7976689381;Taip;3;0;0;3
6175;Nykštukas;NAMINUKAI;9686815141;Taip;0;3;0;3
6176;Nykštukas;NAMINUKAI;9575291096;Taip;0;4;0;4
6177;Nykštukas;NAMINUKAI;4503830456;Taip;0;2;0;2
6178;Nykštukas;NAMINUKAI;4040123876;Taip;0;6;0;6
6179;Nykštukas;NAMINUKAI;5088668786;Taip;1;2;0;3
6180;Nykštukas;NAMINUKAI;8874850019;Taip;6;1;0;7
6181;Nykštukas;NAMINUKAI;1510338621;Taip;2;1;0;3
6182;Nykštukas;NAMINUKAI;9067774103;Ne;21;0;0;21
6183;Nykštukas;NAMINUKAI;3405633312;Ne;0;5;0;5
6184;Nykštukas;KŪLVERSTUKAI;8827094160;Taip;0;3;0;3
6185;Nykštukas;KŪLVERSTUKAI;6786896381;Taip;10;1;0;11
6186;Nykštukas;KŪLVERSTUKAI;6883272732;Taip;11;0;3;14
6187;Nykštukas;KŪLVERSTUKAI;8919778025;Taip;16;0;0;16
6188;Nykštukas;KŪLVERSTUKAI;6337924089;Taip;13;0;0;13
6189;Nykštukas;KŪLVERSTUKAI;4323166473;Taip;10;0;0;10
6190;Nykštukas;KŪLVERSTUKAI;4490310109;Ne;6;2;0;8
6191;Nykštukas;KŪLVERSTUKAI;2947976429;Taip;6;0;1;7
6192;Nykštukas;KŪLVERSTUKAI;2763268154;Ne;0;3;0;3
6193;Nykštukas;KŪLVERSTUKAI;9887096503;Taip;8;1;0;9
6194;Nykštukas;TREPSIUKAI;2052451745;Taip;7;0;0;7
6195;Nykštukas;TREPSIUKAI;5103512898;Taip;9;0;1;10
6196;Nykštukas;TREPSIUKAI;7603500691;Taip;0;0;1;1
6197;Nykštukas;TREPSIUKAI;7266550834;Taip;5;0;0;5
6198;Nykštukas;TREPSIUKAI;6563871327;Taip;3;0;0;3
6199;Nykštukas;TREPSIUKAI;5085577592;Taip;0;1;0;1
6200;Nykštukas;TREPSIUKAI;8819485547;Taip;11;0;0;11
6201;Nykštukas;TREPSIUKAI;5718555692;Taip;11;0;2;13
6202;Nykštukas;TREPSIUKAI;4499337321;Taip;17;0;0;17
6203;Nykštukas;TREPSIUKAI;4622095064;Ne;4;0;0;4
6204;Nykštukas;TREPSIUKAI;8667489439;Taip;3;0;2;5
6205;Nykštukas;TREPSIUKAI;5010715255;Taip;5;1;0;6
6206;Nykštukas;TREPSIUKAI;8047072198;Taip;0;4;0;4
6207;Nykštukas;TREPSIUKAI;9790322329;Taip;3;4;0;7
6208;Nykštukas;TREPSIUKAI;8695794490;Taip;2;0;1;3
6209;Nykštukas;ŽIRNIUKAI;9661862689;Taip;11;0;0;11
6210;Nykštukas;ŽIRNIUKAI;1594734231;Taip;1;0;0;1
6211;Nykštukas;ŽIRNIUKAI;1671340074;Ne;5;1;0;6
6212;Nykštukas;ŽIRNIUKAI;7908029688;Taip;0;2;3;5
6213;Nykštukas;ŽIRNIUKAI;7299329150;Taip;0;0;4;4
6214;Nykštukas;ŽIRNIUKAI;1218443707;Ne;6;1;0;7
6215;Nykštukas;ŽIRNIUKAI;7535385367;Taip;0;0;2;2
6216;Nykštukas;ŽIRNIUKAI;6709760898;Ne;6;1;2;9
6217;Nykštukas;ŽIRNIUKAI;2670682135;Ne;0;1;0;1
6218;Nykštukas;ŽIRNIUKAI;1202614927;Taip;5;1;0;6
6219;Nykštukas;ŽIRNIUKAI;1366524995;Taip;2;0;0;2
6220;Nykštukas;ŽIRNIUKAI;2800783215;Taip;0;21;0;21
6221;Nykštukas;ŽIRNIUKAI;2620150024;Taip;0;1;19;20
6222;Nykštukas;ŽIRNIUKAI;3032028847;Ne;11;0;0;11
6223;Nykštukas;ŽIRNIUKAI;4144437365;Taip;6;1;0;7
6224;Nykštukas;ŽIRNIUKAI;6884714823;Taip;3;5;0;8
6225;Nykštukas;ŽIRNIUKAI;1616644404;Taip;0;2;5;7
6226;Nykštukas;ŽIRNIUKAI;9270615518;Taip;0;5;0;5
6227;Nykštukas;ŽIRNIUKAI;2078586374;Taip;1;0;0;1
6228;Ozas;Smalsučiai;2641398988;Taip;0;2;0;2
6229;Ozas;Smalsučiai;9227939420;Ne;0;1;0;1
6230;Ozas;Smalsučiai;87218067796;Taip;0;7;0;7
6231;Ozas;Smalsučiai;4397034031;Taip;0;8;1;9
6232;Ozas;Smalsučiai;1974320330;Taip;0;1;0;1
6233;Ozas;Smalsučiai;1173284700;Taip;0;1;0;1
6234;Ozas;Smalsučiai;67987032400;Taip;0;0;2;2
6235;Ozas;Smalsučiai;71695973592;Ne;0;1;1;2
6236;Ozas;Smalsučiai;57069047630;Ne;6;1;1;8
6237;Ozas;Smalsučiai;3326395879;Taip;0;1;0;1
6238;Ozas;Smalsučiai;5150746885;Taip;0;4;0;4
6239;Ozas;Smalsučiai;1893257809;Taip;0;1;1;2
6240;Ozas;Smalsučiai;6540803077;Taip;0;1;0;1
6241;Ozas;Smalsučiai;8072802467;Taip;0;3;0;3
6242;Ozas;Smalsučiai;1248092034;Ne;0;1;0;1
6243;Ozas;Smalsučiai;43381497677;Taip;2;2;0;4
6244;Ozas;Smalsučiai;7351651916;Taip;0;2;0;2
6245;Ozas;Smalsučiai;3286170280;Taip;0;1;2;3
6246;Ozas;Smalsučiai;9521048381;Taip;0;1;1;2
6247;Ozas;Smalsučiai;2053832360;Taip;2;1;0;3
6248;Ozas;Smalsučiai;9905575489;Ne;3;0;2;5
6249;Ozas;Drugeliai;7802699257;Taip;0;1;1;2
6250;Ozas;Drugeliai;6668470892;Taip;0;1;0;1
6251;Ozas;Drugeliai;2302999759;Taip;0;1;0;1
6252;Ozas;Drugeliai;8088330187;Taip;0;13;0;13
6253;Ozas;Drugeliai;9073973849;Taip;9;1;0;10
6254;Ozas;Drugeliai;9322806566;Taip;4;4;0;8
6255;Ozas;Drugeliai;2676747542;Taip;0;1;20;21
6256;Ozas;Drugeliai;2812687451;Taip;5;1;0;6
6257;Ozas;Drugeliai;8289643065;Taip;0;1;0;1
6258;Ozas;Drugeliai;9987863302;Taip;0;2;2;4
6259;Ozas;Drugeliai;2980799420;Taip;10;1;1;12
6260;Ozas;Drugeliai;1793692289;Ne;0;1;0;1
6261;Ozas;Drugeliai;8318380547;Taip;0;6;0;6
6262;Ozas;Drugeliai;4884054504;Ne;7;0;0;7
6263;Ozas;Drugeliai;43660054250;Taip;0;15;0;15
6264;Ozas;Drugeliai;7565002863;Taip;0;1;0;1
6265;Ozas;Drugeliai;1871542885;Taip;0;1;0;1
6266;Ozas;Drugeliai;15262583232;Taip;0;16;0;16
6267;Ozas;Drugeliai;1103685699;Taip;0;3;0;3
6268;Ozas;Drugeliai;1335655483;Taip;6;0;0;6
6269;Ozas;Drugeliai;4207160323;Taip;0;1;0;1
6270;Ozas;Boružėlės;1348960421;Taip;0;1;1;2
6271;Ozas;Boružėlės;1375643969;Ne;0;1;0;1
6272;Ozas;Boružėlės;63852147122;Taip;4;1;1;6
6273;Ozas;Boružėlės;8190314087;Taip;0;1;0;1
6274;Ozas;Boružėlės;3803998816;Taip;0;1;0;1
6275;Ozas;Boružėlės;1212358423;Taip;0;2;0;2
6276;Ozas;Boružėlės;7615907271;Ne;0;2;0;2
6277;Ozas;Boružėlės;1560342499;Taip;0;2;0;2
6278;Ozas;Boružėlės;8529654920;Taip;0;1;0;1
6279;Ozas;Boružėlės;2527574646;Taip;0;8;1;9
6280;Ozas;Boružėlės;9773251894;Taip;13;1;0;14
6281;Ozas;Boružėlės;36523514229;Taip;0;2;0;2
6282;Ozas;Boružėlės;1367050160;Taip;0;1;1;2
6283;Ozas;Boružėlės;2678629892;Taip;0;1;0;1
6284;Ozas;Boružėlės;1826499734;Taip;0;1;0;1
6285;Ozas;Boružėlės;6432357144;Taip;5;1;0;6
6286;Ozas;Boružėlės;1498656201;Taip;5;2;0;7
6287;Ozas;Boružėlės;9130645878;Ne;0;1;5;6
6288;Ozas;Boružėlės;60194872867;Taip;0;1;0;1
6289;Ozas;Boružėlės;7172573921;Taip;0;1;1;2
6290;Ozas;Boružėlės;1682529482;Taip;0;2;0;2
6291;Ozas;Boružėlės;68364031736;Taip;0;2;1;3
6292;Ozas;Žiogeliai;7461521320;Taip;6;1;0;7
6293;Ozas;Žiogeliai;6257625501;Taip;0;1;0;1
6294;Ozas;Žiogeliai;7402290524;Ne;0;1;3;4
6295;Ozas;Žiogeliai;1562277866;Taip;0;0;1;1
6296;Ozas;Žiogeliai;4571583671;Taip;0;1;0;1
6297;Ozas;Žiogeliai;5682027094;Taip;2;5;12;19
6298;Ozas;Žiogeliai;4966355020;Taip;0;0;1;1
6299;Ozas;Žiogeliai;9324647606;Ne;9;0;0;9
6300;Ozas;Žiogeliai;9392526836;Taip;0;1;1;2
6301;Ozas;Žiogeliai;4942550213;Taip;3;1;0;4
6302;Ozas;Žiogeliai;8676986286;Taip;11;2;2;15
6303;Ozas;Žiogeliai;2345112767;Taip;5;4;0;9
6304;Ozas;Žiogeliai;5420952391;Taip;10;6;0;16
6305;Ozas;Žiogeliai;9929822317;Ne;0;0;2;2
6306;Ozas;Žiogeliai;2837228320;Taip;0;4;0;4
6307;Ozas;Žiogeliai;5156383727;Taip;0;4;0;4
6308;Ozas;Žiogeliai;2617258206;Ne;0;14;2;16
6309;Ozas;Žiogeliai;9768754737;Ne;0;5;0;5
6310;Ozas;Žiogeliai;7264789334;Taip;0;2;0;2
6311;Ozas;Bitutės;4220780257;Taip;10;1;0;11
6312;Ozas;Bitutės;1161776624;Taip;0;1;2;3
6313;Ozas;Bitutės;7499756171;Taip;0;16;0;16
6314;Ozas;Bitutės;2705294874;Taip;2;0;1;3
6315;Ozas;Bitutės;2369544599;Taip;0;6;0;6
6316;Ozas;Bitutės;3329391600;Taip;4;0;0;4
6317;Ozas;Bitutės;4254601638;Taip;1;0;0;1
6318;Ozas;Bitutės;4699369567;Taip;0;0;2;2
6319;Ozas;Bitutės;8304671844;Ne;0;0;1;1
6320;Ozas;Bitutės;5968428143;Ne;5;0;0;5
6321;Ozas;Bitutės;9772085405;Taip;0;2;6;8
6322;Ozas;Bitutės;7051699003;Ne;18;1;0;19
6323;Ozas;Bitutės;5383877034;Taip;0;0;4;4
6324;Ozas;Bitutės;1117208248;Taip;0;7;0;7
6325;Ozas;Bitutės;6811181735;Taip;6;4;0;10
6326;Ozas;Bitutės;8622621570;Taip;17;0;0;17
6327;Ozas;Bitutės;4260123123;Taip;3;0;2;5
6328;Ozas;Bitutės;7494307084;Taip;0;1;0;1
6329;Ozas;Bitutės;1475005204;Ne;0;0;2;2
6330;Ozas;Bitutės;1895519949;Taip;0;0;2;2
6331;Ozas;Aitvarėliai;1144679735;Taip;0;0;6;6
6332;Ozas;Aitvarėliai;2773182934;Taip;0;0;3;3
6333;Ozas;Aitvarėliai;5642468671;Taip;0;1;0;1
6334;Ozas;Aitvarėliai;1045890394;Taip;6;1;0;7
6335;Ozas;Aitvarėliai;7686706482;Taip;0;1;0;1
6336;Ozas;Aitvarėliai;2395567376;Taip;0;1;0;1
6337;Ozas;Aitvarėliai;2922370952;Taip;0;0;1;1
6338;Ozas;Aitvarėliai;5383739203;Taip;0;1;1;2
6339;Ozas;Aitvarėliai;4583818638;Taip;0;0;3;3
6340;Ozas;Aitvarėliai;1543683077;Taip;0;0;1;1
6341;Ozas;Aitvarėliai;2165291778;Taip;2;12;0;14
6342;Ozas;Aitvarėliai;8754244281;Taip;11;5;0;16
6343;Ozas;Aitvarėliai;6646671212;Taip;0;0;1;1
6344;Ozas;Aitvarėliai;9443843603;Taip;7;3;0;10
6345;Ozas;Aitvarėliai;3238019756;Taip;13;0;0;13
6346;Ozas;Aitvarėliai;8987796218;Taip;10;7;0;17
6347;Ozas;Aitvarėliai;2544858937;Taip;10;1;0;11
6348;Ozas;Aitvarėliai;3783477511;Ne;8;7;0;15
6349;Ozas;Aitvarėliai;6778987483;Ne;1;0;6;7
6350;Ozas;Aitvarėliai;9813020279;Taip;0;1;0;1
6351;Ozas;Aitvarėliai;4891451748;Ne;0;1;4;5
6352;Ozas;Aitvarėliai;7009893338;Ne;1;0;0;1
6353;Ozas;Voveraitės;8178298861;Taip;0;0;1;1
6354;Ozas;Voveraitės;6263062055;Taip;1;1;0;2
6355;Ozas;Voveraitės;9195536968;Taip;7;1;0;8
6356;Ozas;Voveraitės;2991511872;Taip;0;3;1;4
6357;Ozas;Voveraitės;5016547315;Taip;0;2;0;2
6358;Ozas;Voveraitės;1564826076;Taip;0;1;0;1
6359;Ozas;Voveraitės;1240233169;Taip;0;6;0;6
6360;Ozas;Voveraitės;6088757991;Taip;0;2;0;2
6361;Ozas;Voveraitės;5822871838;Taip;0;3;3;6
6362;Ozas;Voveraitės;2635045515;Taip;0;1;0;1
6363;Ozas;Voveraitės;6499549095;Taip;0;2;0;2
6364;Ozas;Voveraitės;6666591428;Taip;0;2;0;2
6365;Ozas;Voveraitės;7908028909;Taip;2;2;0;4
6366;Ozas;Voveraitės;9762737217;Taip;0;3;1;4
6367;Ozas;Voveraitės;7421484648;Ne;13;0;8;21
6368;Ozas;Voveraitės;1997125531;Taip;6;0;0;6
6369;Ozas;Voveraitės;6053885086;Taip;0;1;0;1
6370;Ozas;Voveraitės;7978092840;Taip;0;1;0;1
6371;Ozas;Voveraitės;5751808248;Ne;6;1;0;7
6372;Ozas;Voveraitės;4556076744;Taip;10;0;1;11
6373;Ozas;Voveraitės;8503041003;Taip;0;0;2;2
6374;Ozas;Kodelčiukai;8743467101;Taip;4;6;0;10
6375;Ozas;Kodelčiukai;2964318343;Taip;7;1;0;8
6376;Ozas;Kodelčiukai;8696127374;Taip;8;1;0;9
6377;Ozas;Kodelčiukai;3704303636;Taip;5;2;0;7
6378;Ozas;Kodelčiukai;2573702751;Taip;0;0;1;1
6379;Ozas;Kodelčiukai;3412369198;Taip;5;0;0;5
6380;Ozas;Kodelčiukai;2951875705;Taip;0;1;0;1
6381;Ozas;Kodelčiukai;7305274617;Taip;15;0;0;15
6382;Ozas;Kodelčiukai;9306887706;Taip;4;1;0;5
6383;Ozas;Kodelčiukai;9084187344;Taip;0;1;1;2
6384;Ozas;Kodelčiukai;1348751454;Taip;10;1;0;11
6385;Ozas;Kodelčiukai;9322080266;Taip;10;1;0;11
6386;Ozas;Kodelčiukai;6809992664;Ne;8;4;0;12
6387;Ozas;Kodelčiukai;4516291572;Ne;10;0;0;10
6388;Ozas;Kodelčiukai;4287719751;Taip;0;6;0;6
6389;Ozas;Kodelčiukai;9620747099;Taip;12;1;0;13
6390;Ozas;Kodelčiukai;5216695220;Taip;5;1;0;6
6391;Ozas;Kodelčiukai;8779047802;Taip;6;1;0;7
6392;Ozas;Kodelčiukai;6609446450;Taip;0;1;0;1
6393;Ozas;Kodelčiukai;6783755555;Ne;0;5;0;5
6394;Ozas;Kodelčiukai;8222112564;Ne;0;5;0;5
6395;Ozas;Pelėdžiukai;4640897674;Ne;0;1;0;1
6396;Ozas;Pelėdžiukai;9277208213;Taip;8;1;0;9
6397;Ozas;Pelėdžiukai;2281337233;Ne;0;0;1;1
6398;Ozas;Pelėdžiukai;8040293681;Ne;0;0;12;12
6399;Ozas;Pelėdžiukai;5922569280;Taip;2;2;1;5
6400;Ozas;Pelėdžiukai;7640409923;Taip;0;3;0;3
6401;Ozas;Pelėdžiukai;4601869799;Taip;6;1;4;11
6402;Ozas;Pelėdžiukai;5958055645;Ne;0;0;3;3
6403;Ozas;Pelėdžiukai;7125754645;Taip;0;0;4;4
6404;Ozas;Pelėdžiukai;2824133388;Taip;0;2;0;2
6405;Ozas;Pelėdžiukai;7287989663;Taip;0;4;1;5
6406;Ozas;Pelėdžiukai;6819000895;Taip;0;1;0;1
6407;Ozas;Pelėdžiukai;4247941696;Taip;5;0;0;5
6408;Ozas;Pelėdžiukai;5950860889;Taip;0;1;4;5
6409;Ozas;Pelėdžiukai;4886045470;Taip;0;5;0;5
6410;Ozas;Pelėdžiukai;3212050416;Taip;1;0;0;1
6411;Ozas;Pelėdžiukai;3725141591;Taip;0;0;1;1
6412;Ozas;Pelėdžiukai;3711403511;Taip;17;0;1;18
6413;Ozas;Pelėdžiukai;5392929222;Taip;10;0;1;11
6414;Ozas;Pelėdžiukai;7038928164;Ne;0;0;2;2
6415;Ozas;Pelėdžiukai;8131525146;Taip;15;0;0;15
6416;Ozas;"Kačiukai ";4857216527;Taip;12;0;0;12
6417;Ozas;"Kačiukai ";7776754188;Taip;15;0;2;17
6418;Ozas;"Kačiukai ";5097380041;Ne;10;0;1;11
6419;Ozas;"Kačiukai ";3440198575;Taip;0;0;2;2
6420;Ozas;"Kačiukai ";2522810593;Taip;0;0;2;2
6421;Ozas;"Kačiukai ";3109261153;Taip;12;1;0;13
6422;Ozas;"Kačiukai ";9781398468;Taip;18;0;1;19
6423;Ozas;"Kačiukai ";8488500486;Taip;9;0;0;9
6424;Ozas;"Kačiukai ";7803356246;Taip;0;0;21;21
6425;Ozas;"Kačiukai ";2512535949;Taip;16;0;0;16
6426;Ozas;"Kačiukai ";4595986358;Taip;0;1;1;2
6427;Ozas;"Kačiukai ";5421245991;Taip;12;0;0;12
6428;Ozas;"Kačiukai ";9781527964;Taip;10;8;0;18
6429;Ozas;"Kačiukai ";6456146804;Taip;3;0;1;4
6430;Ozas;"Kačiukai ";9496746778;Taip;0;0;1;1
6431;Ozas;"Kačiukai ";4514798132;Taip;17;1;0;18
6432;Ozas;"Kačiukai ";9655492678;Taip;6;0;5;11
6433;Ozas;Ančiukų;3037323341;Taip;0;1;0;1
6434;Ozas;Ančiukų;5926100815;Taip;21;0;0;21
6435;Ozas;Ančiukų;2454569369;Taip;4;0;0;4
6436;Ozas;Ančiukų;3133776891;Taip;1;0;3;4
6437;Ozas;Ančiukų;2139224651;Taip;1;0;11;12
6438;Ozas;Ančiukų;2819545359;Taip;5;0;1;6
6439;Ozas;Ančiukų;5172367556;Taip;8;6;0;14
6440;Ozas;Ančiukų;5677543279;Taip;4;0;0;4
6441;Ozas;Ančiukų;8923372952;Taip;0;0;1;1
6442;Ozas;Ančiukų;7617839839;Taip;19;0;0;19
6443;Ozas;Ančiukų;9506090620;Taip;1;0;0;1
6444;Ozas;Nykškukų;3139289643;Taip;0;1;1;2
6445;Ozas;Nykškukų;7585213159;Taip;0;2;0;2
6446;Ozas;Nykškukų;6392066805;Taip;6;0;0;6
6447;Ozas;Nykškukų;6346123124;Taip;16;1;0;17
6448;Ozas;Nykškukų;3902722274;Taip;9;0;0;9
6449;Ozas;Nykškukų;7922667688;Taip;0;0;5;5
6450;Ozas;Nykškukų;8781771299;Taip;12;0;0;12
6451;Ozas;Nykškukų;3817138493;Taip;1;0;0;1
6452;Ozas;Nykškukų;8371368881;Taip;13;0;0;13
6453;Ozas;Nykškukų;6476147361;Taip;3;0;0;3
6454;Ozas;Nykškukų;4994121247;Taip;9;2;0;11
6455;Ozas;Nykškukų;6315443248;Taip;21;0;0;21
6456;Ozas;Nykškukų;6318419889;Ne;6;0;0;6
6457;Ozas;Nykškukų;6186850614;Taip;0;0;6;6
6458;Ozas;Nykškukų;5182160089;Taip;14;0;1;15
6459;Ozas;Nykškukų;1536889312;Taip;8;0;0;8
6460;Pabiručiai;Voveriukų;1498738549;Taip;0;0;3;3
6461;Pabiručiai;Voveriukų;2349337471;Taip;4;2;0;6
6462;Pabiručiai;Voveriukų;9564303781;Taip;0;0;6;6
6463;Pabiručiai;Voveriukų;4312364951;Taip;12;2;0;14
6464;Pabiručiai;Voveriukų;3756731363;Ne;3;0;5;8
6465;Pabiručiai;Voveriukų;7985360502;Taip;6;0;1;7
6466;Pabiručiai;Voveriukų;3936426174;Taip;5;0;1;6
6467;Pabiručiai;Voveriukų;4069564285;Taip;0;1;0;1
6468;Pabiručiai;Voveriukų;7403996266;Ne;26;0;0;26
6469;Pabiručiai;Voveriukų;7278334800;Taip;4;1;0;5
6470;Pabiručiai;Voveriukų;9468698553;Taip;4;0;1;5
6471;Pabiručiai;Voveriukų;5232678556;Ne;0;1;0;1
6472;Pabiručiai;Voveriukų;7066037017;Taip;5;2;0;7
6473;Pabiručiai;Voveriukų;5549851164;Taip;0;1;0;1
6474;Pabiručiai;Voveriukų;4040533883;Taip;0;8;0;8
6475;Pabiručiai;Voveriukų;2514312233;Taip;7;3;0;10
6476;Pabiručiai;Voveriukų;7606274875;Taip;7;3;0;10
6477;Pabiručiai;Voveriukų;9356327400;Taip;10;1;0;11
6478;Pabiručiai;Voveriukų;4813206044;Taip;0;10;0;10
6479;Pabiručiai;Voveriukų;7846758352;Taip;0;1;0;1
6480;Pabiručiai;Boružiukų;6401188653;Taip;3;1;1;5
6481;Pabiručiai;Boružiukų;1673473814;Taip;8;0;0;8
6482;Pabiručiai;Boružiukų;5686769648;Taip;16;5;0;21
6483;Pabiručiai;Boružiukų;7524993271;Ne;0;2;2;4
6484;Pabiručiai;Boružiukų;5708597471;Taip;0;1;0;1
6485;Pabiručiai;Boružiukų;4006783343;Ne;2;0;0;2
6486;Pabiručiai;Boružiukų;7046122545;Taip;0;5;0;5
6487;Pabiručiai;Boružiukų;4301904533;Taip;9;2;0;11
6488;Pabiručiai;Boružiukų;8175565139;Taip;5;1;0;6
6489;Pabiručiai;Boružiukų;8236964683;Taip;0;6;0;6
6490;Pabiručiai;Boružiukų;1671027282;Taip;5;2;0;7
6491;Pabiručiai;Boružiukų;3759350345;Taip;9;2;0;11
6492;Pabiručiai;Boružiukų;3151360288;Taip;5;2;0;7
6493;Pabiručiai;Boružiukų;9299393363;Taip;15;4;0;19
6494;Pabiručiai;Boružiukų;1484291546;Taip;0;3;1;4
6495;Pabiručiai;Boružiukų;2771769336;Taip;0;2;0;2
6496;Pabiručiai;Boružiukų;2607840684;Taip;10;2;0;12
6497;Pabiručiai;Boružiukų;4681771534;Taip;4;1;0;5
6498;Pabiručiai;Boružiukų;7050339198;Taip;0;14;0;14
6499;Pabiručiai;Boružiukų;4798503931;Taip;7;1;0;8
6500;Pabiručiai;Katinėlių;8284711578;Ne;10;0;0;10
6501;Pabiručiai;Katinėlių;8710389714;Taip;9;1;0;10
6502;Pabiručiai;Katinėlių;1670938208;Taip;0;1;0;1
6503;Pabiručiai;Katinėlių;3756365293;Taip;9;1;0;10
6504;Pabiručiai;Katinėlių;6283372742;Taip;0;1;0;1
6505;Pabiručiai;Katinėlių;4205107384;Taip;0;1;2;3
6506;Pabiručiai;Katinėlių;4501176225;Taip;0;7;0;7
6507;Pabiručiai;Katinėlių;1749155319;Ne;0;2;9;11
6508;Pabiručiai;Katinėlių;2572570925;Taip;15;1;0;16
6509;Pabiručiai;Katinėlių;34883375155;Taip;5;5;0;10
6510;Pabiručiai;Katinėlių;8306688649;Taip;0;1;1;2
6511;Pabiručiai;Katinėlių;1705085006;Taip;11;1;1;13
6512;Pabiručiai;Katinėlių;58112415466;Ne;10;1;1;12
6513;Pabiručiai;Katinėlių;95695057362;Ne;0;2;0;2
6514;Pabiručiai;Katinėlių;42877891797;Taip;0;5;0;5
6515;Pabiručiai;Katinėlių;6285940478;Taip;0;2;2;4
6516;Pabiručiai;Katinėlių;1122183123;Taip;0;1;0;1
6517;Pabiručiai;Žiogelių;6548776238;Taip;0;1;2;3
6518;Pabiručiai;Žiogelių;3272576627;Taip;14;0;0;14
6519;Pabiručiai;Žiogelių;5522447437;Taip;6;0;1;7
6520;Pabiručiai;Žiogelių;7974345478;Taip;6;6;0;12
6521;Pabiručiai;Žiogelių;3206962828;Ne;2;1;3;6
6522;Pabiručiai;Žiogelių;3355875364;Taip;0;5;0;5
6523;Pabiručiai;Žiogelių;5311762824;Taip;18;0;5;23
6524;Pabiručiai;Žiogelių;1587905929;Taip;14;0;4;18
6525;Pabiručiai;Žiogelių;4667769378;Taip;10;3;0;13
6526;Pabiručiai;Žiogelių;7085036701;Taip;5;0;0;5
6527;Pabiručiai;Žiogelių;8367889753;Taip;0;1;0;1
6528;Pabiručiai;Žiogelių;8736658575;Taip;1;0;2;3
6529;Pabiručiai;Žiogelių;8106446562;Taip;0;8;0;8
6530;Pabiručiai;Žiogelių;8421025940;Taip;0;1;2;3
6531;Pabiručiai;Žiogelių;1311650644;Taip;0;6;0;6
6532;Pabiručiai;Žiogelių;3028063887;Taip;0;1;5;6
6533;Pabiručiai;Smalsiukai;2869383175;Taip;8;0;1;9
6534;Pabiručiai;Smalsiukai;7677235214;Taip;12;0;3;15
6535;Pabiručiai;Smalsiukai;9676561758;Taip;6;1;0;7
6536;Pabiručiai;Smalsiukai;7632969321;Ne;11;0;1;12
6537;Pabiručiai;Smalsiukai;7090116276;Taip;8;1;1;10
6538;Pabiručiai;Smalsiukai;4408666547;Taip;0;1;1;2
6539;Pabiručiai;Smalsiukai;9093137227;Taip;0;0;1;1
6540;Pabiručiai;Smalsiukai;6935913132;Ne;0;2;0;2
6541;Pabiručiai;Smalsiukai;1344711015;Taip;7;2;0;9
6542;Pabiručiai;Smalsiukai;7663581089;Taip;0;3;0;3
6543;Pabiručiai;Smalsiukai;7248314871;Taip;11;0;1;12
6544;Pabiručiai;Smalsiukai;9610623364;Taip;4;5;0;9
6545;Pabiručiai;Smalsiukai;8897462614;Taip;0;1;0;1
6546;Pabiručiai;Smalsiukai;2332338995;Ne;15;0;0;15
6547;Pabiručiai;Smalsiukai;4258226042;Ne;0;9;0;9
6548;Pabiručiai;Smalsiukai;3511851810;Taip;11;0;0;11
6549;Pabiručiai;Smalsiukai;6686039601;Taip;16;0;1;17
6550;Pabiručiai;Smalsiukai;5420231066;Taip;6;0;0;6
6551;Pabiručiai;Smalsiukai;8840885039;Taip;5;0;1;6
6552;Pabiručiai;Smalsiukai;9779260044;Taip;16;0;0;16
6553;Pabiručiai;Smalsiukai;2771891999;Taip;3;0;2;5
6554;Pabiručiai;Smalsiukai;7295052694;Ne;0;2;0;2
6555;Pabiručiai;Kiškučiai;9589005897;Taip;2;16;0;18
6556;Pabiručiai;Kiškučiai;6648966721;Taip;0;2;0;2
6557;Pabiručiai;Kiškučiai;9353062804;Taip;11;2;0;13
6558;Pabiručiai;Kiškučiai;1582754284;Taip;0;6;0;6
6559;Pabiručiai;Kiškučiai;4462744848;Ne;0;16;0;16
6560;Pabiručiai;Kiškučiai;5621183663;Taip;0;1;0;1
6561;Pabiručiai;Kiškučiai;9417138573;Taip;4;3;0;7
6562;Pabiručiai;Kiškučiai;1515270273;Taip;0;2;0;2
6563;Pabiručiai;Kiškučiai;2688728915;Taip;17;5;0;22
6564;Pabiručiai;Kiškučiai;5166525832;Taip;0;2;0;2
6565;Pabiručiai;Kiškučiai;8409455566;Taip;0;1;0;1
6566;Pabiručiai;Kiškučiai;1028312285;Taip;4;2;0;6
6567;Pabiručiai;Kiškučiai;5346249456;Taip;9;1;0;10
6568;Pabiručiai;Kiškučiai;5717534175;Taip;2;1;0;3
6569;Pabiručiai;Kiškučiai;3408518493;Taip;0;6;0;6
6570;Pabiručiai;Kiškučiai;7653129291;Taip;0;12;0;12
6571;Pabiručiai;Kiškučiai;7073230645;Ne;0;4;0;4
6572;Pabiručiai;Kiškučiai;8820585407;Taip;6;2;0;8
6573;Pabiručiai;Kiškučiai;7572077461;Taip;13;1;0;14
6574;Pabiručiai;Kiškučiai;5767879226;Taip;6;1;0;7
6575;Pabiručiai;"Pėledžiukai ";9834824219;Taip;4;10;0;14
6576;Pabiručiai;"Pėledžiukai ";2507088490;Taip;0;14;0;14
6577;Pabiručiai;"Pėledžiukai ";6831569546;Taip;15;0;0;15
6578;Pabiručiai;"Pėledžiukai ";1683369842;Ne;10;1;0;11
6579;Pabiručiai;"Pėledžiukai ";7478484190;Taip;0;7;0;7
6580;Pabiručiai;"Pėledžiukai ";7961879916;Taip;0;5;0;5
6581;Pabiručiai;"Pėledžiukai ";9050994322;Taip;3;1;0;4
6582;Pabiručiai;"Pėledžiukai ";1049154287;Taip;4;0;0;4
6583;Pabiručiai;"Pėledžiukai ";6697518151;Taip;0;8;0;8
6584;Pabiručiai;"Pėledžiukai ";2596301235;Taip;7;1;1;9
6585;Pabiručiai;"Pėledžiukai ";4333645528;Taip;0;14;0;14
6586;Pabiručiai;"Pėledžiukai ";6289025538;Taip;0;17;0;17
6587;Pabiručiai;"Pėledžiukai ";2343561322;Taip;0;3;1;4
6588;Pabiručiai;"Pėledžiukai ";3674583662;Taip;14;1;0;15
6589;Pabiručiai;"Pėledžiukai ";8268101318;Taip;6;4;0;10
6590;Pabiručiai;"Pėledžiukai ";2147165934;Taip;0;0;1;1
6591;Pabiručiai;"Pėledžiukai ";7385149524;Taip;8;0;0;8
6592;Pabiručiai;"Pėledžiukai ";7203091216;Taip;7;0;0;7
6593;Pabiručiai;"Pėledžiukai ";3224195892;Ne;15;0;0;15
6594;Pabiručiai;"Kodelčiūkai ";5950654594;Taip;0;5;0;5
6595;Pabiručiai;"Kodelčiūkai ";4317656984;Taip;8;0;0;8
6596;Pabiručiai;"Kodelčiūkai ";4785878572;Ne;0;3;0;3
6597;Pabiručiai;"Kodelčiūkai ";2295503584;Ne;5;11;0;16
6598;Pabiručiai;"Kodelčiūkai ";4595458527;Taip;5;1;0;6
6599;Pabiručiai;"Kodelčiūkai ";8716879106;Taip;0;0;1;1
6600;Pabiručiai;"Kodelčiūkai ";9067653417;Taip;6;0;2;8
6601;Pabiručiai;"Kodelčiūkai ";5247780866;Taip;9;1;0;10
6602;Pabiručiai;"Kodelčiūkai ";3433419710;Taip;14;1;0;15
6603;Pabiručiai;"Kodelčiūkai ";6386335808;Taip;3;0;5;8
6604;Pabiručiai;"Kodelčiūkai ";5010271037;Taip;4;1;0;5
6605;Pabiručiai;"Kodelčiūkai ";9538339883;Taip;0;0;3;3
6606;Pabiručiai;"Kodelčiūkai ";8149732126;Taip;0;2;0;2
6607;Pabiručiai;"Kodelčiūkai ";7289131864;Taip;0;1;0;1
6608;Pabiručiai;"Kodelčiūkai ";6209553290;Ne;21;0;0;21
6609;Pabiručiai;"Kodelčiūkai ";5913022147;Taip;8;0;2;10
6610;Pabiručiai;"Kodelčiūkai ";3748657353;Ne;6;1;0;7
6611;Pabiručiai;"Kodelčiūkai ";3497466298;Taip;12;2;0;14
6612;Pabiručiai;"Kodelčiūkai ";8179285338;Taip;0;8;0;8
6613;Pabiručiai;"Kodelčiūkai ";1234230729;Ne;26;0;0;26
6614;Pabiručiai;"Peliukų ";4894380231;Taip;4;0;0;4
6615;Pabiručiai;"Peliukų ";6678717039;Ne;0;3;0;3
6616;Pabiručiai;"Peliukų ";7182565608;Taip;6;1;0;7
6617;Pabiručiai;"Peliukų ";1099080685;Taip;0;5;0;5
6618;Pabiručiai;"Peliukų ";5990497129;Taip;9;5;0;14
6619;Pabiručiai;"Peliukų ";9890225918;Taip;6;0;0;6
6620;Pabiručiai;"Peliukų ";7644854044;Taip;0;0;1;1
6621;Pabiručiai;"Peliukų ";3826505104;Ne;0;0;1;1
6622;Pabiručiai;"Peliukų ";1971996148;Taip;5;1;0;6
6623;Pabiručiai;"Peliukų ";4852287574;Taip;11;5;0;16
6624;Pabiručiai;"Peliukų ";1206012259;Taip;0;1;0;1
6625;Pabiručiai;"Peliukų ";9790360371;Taip;3;0;0;3
6626;Pabiručiai;"Peliukų ";9806520732;Taip;10;0;1;11
6627;Pabiručiai;"Viščiukų ";8254676845;Ne;10;7;0;17
6628;Pabiručiai;"Viščiukų ";7339565412;Taip;11;0;1;12
6629;Pabiručiai;"Viščiukų ";4880717493;Taip;13;0;0;13
6630;Pabiručiai;"Viščiukų ";1138743823;Ne;0;1;0;1
6631;Pabiručiai;"Viščiukų ";3011601512;Taip;0;2;0;2
6632;Pabiručiai;"Viščiukų ";4931180848;Taip;0;5;0;5
6633;Pabiručiai;"Viščiukų ";7798837336;Taip;16;0;0;16
6634;Pabiručiai;"Viščiukų ";7914642744;Taip;20;0;0;20
6635;Pabiručiai;"Viščiukų ";5737214746;Taip;23;1;0;24
6636;Pabiručiai;"Viščiukų ";2141365015;Ne;16;0;0;16
6637;Pabiručiai;"Viščiukų ";6361966325;Taip;5;0;2;7
6638;Pabiručiai;"Viščiukų ";6508093808;Ne;10;1;0;11
6639;Pabiručiai;"Viščiukų ";8649685325;Taip;0;0;3;3
6640;Pabiručiai;"Viščiukų ";4929129093;Ne;0;10;0;10
6641;Pabiručiai;"Drugelių ";6014791534;Taip;6;4;0;10
6642;Pabiručiai;"Drugelių ";9890868992;Ne;12;0;1;13
6643;Pabiručiai;"Drugelių ";2556330147;Taip;6;9;0;15
6644;Pabiručiai;"Drugelių ";5050966784;Taip;0;2;0;2
6645;Pabiručiai;"Drugelių ";5019580409;Ne;21;0;0;21
6646;Pabiručiai;"Drugelių ";3531292373;Taip;0;1;0;1
6647;Pabiručiai;"Drugelių ";8668524776;Taip;0;3;0;3
6648;Pabiručiai;"Drugelių ";9878655387;Taip;5;0;0;5
6649;Pabiručiai;"Drugelių ";4876140467;Taip;15;3;0;18
6650;Pabiručiai;"Drugelių ";6481162347;Taip;3;1;0;4
6651;Pabiručiai;"Drugelių ";4012537474;Taip;7;0;1;8
6652;Pabiručiai;"Drugelių ";4701982784;Taip;16;0;0;16
6653;Pabiručiai;"Drugelių ";5147367745;Taip;9;0;0;9
6654;Pabiručiai;ŽIRNIUKŲ;5704073222;Ne;10;1;0;11
6655;Pabiručiai;ŽIRNIUKŲ;2924005478;Taip;5;0;1;6
6656;Pabiručiai;ŽIRNIUKŲ;1247522345;Taip;8;0;1;9
6657;Pabiručiai;ŽIRNIUKŲ;1852744763;Taip;12;0;5;17
6658;Pabiručiai;ŽIRNIUKŲ;4851108740;Ne;10;1;0;11
6659;Pabiručiai;ŽIRNIUKŲ;6513943228;Ne;10;0;0;10
6660;Pabiručiai;ŽIRNIUKŲ;2794484633;Ne;16;0;0;16
6661;Pabiručiai;ŽIRNIUKŲ;8870657682;Ne;16;0;0;16
6662;Pabiručiai;ŽIRNIUKŲ;4096412988;Taip;4;1;0;5
6663;Pabiručiai;ŽIRNIUKŲ;8092886420;Ne;13;0;0;13
6664;Pabiručiai;ŽIRNIUKŲ;7873575929;Ne;1;2;0;3
6665;Pabiručiai;ŽIRNIUKŲ;5862643827;Ne;19;0;0;19
6666;Pabiručiai;ŽIRNIUKŲ;5184688482;Taip;15;0;2;17
6667;Pabiručiai;ŽIRNIUKŲ;4755427277;Taip;12;0;2;14
6668;Pabiručiai;ŽIRNIUKŲ;9507212682;Taip;0;1;0;1
6669;Pabiručiai;ŽIRNIUKŲ;9651695086;Taip;5;0;4;9
6670;Pabiručiai;ŽIRNIUKŲ;5899880680;Taip;21;0;0;21
6671;Pagrandukas;Saulytės;6915087488;Taip;0;1;0;1
6672;Pagrandukas;Saulytės;7605508460;Taip;1;6;0;7
6673;Pagrandukas;Saulytės;6349387692;Taip;9;1;0;10
6674;Pagrandukas;Saulytės;8186092469;Taip;0;4;0;4
6675;Pagrandukas;Saulytės;2934300533;Taip;0;5;0;5
6676;Pagrandukas;Saulytės;1548697124;Taip;0;4;0;4
6677;Pagrandukas;Saulytės;6711830251;Taip;4;4;0;8
6678;Pagrandukas;Saulytės;7146697128;Taip;0;1;0;1
6679;Pagrandukas;Saulytės;3157676207;Taip;0;6;0;6
6680;Pagrandukas;Saulytės;7511097160;Taip;0;18;0;18
6681;Pagrandukas;Saulytės;5560372136;Taip;0;10;0;10
6682;Pagrandukas;Saulytės;1766912463;Taip;0;9;0;9
6683;Pagrandukas;Saulytės;9849054467;Taip;0;11;0;11
6684;Pagrandukas;Saulytės;8024910647;Taip;12;3;0;15
6685;Pagrandukas;Saulytės;8481502330;Taip;0;4;0;4
6686;Pagrandukas;Saulytės;3008997793;Ne;0;2;0;2
6687;Pagrandukas;Saulytės;6388805960;Taip;0;0;29;29
6688;Pagrandukas;Saulytės;8836178193;Taip;0;2;0;2
6689;Pagrandukas;Saulytės;7157549179;Taip;0;1;0;1
6690;Pagrandukas;Zuikučiai;7834436515;Taip;0;1;0;1
6691;Pagrandukas;Zuikučiai;5903416384;Taip;0;1;0;1
6692;Pagrandukas;Zuikučiai;2439891231;Taip;0;2;3;5
6693;Pagrandukas;Zuikučiai;6710887776;Taip;0;2;3;5
6694;Pagrandukas;Zuikučiai;7665811353;Taip;0;0;1;1
6695;Pagrandukas;Zuikučiai;2212787835;Taip;0;1;0;1
6696;Pagrandukas;Zuikučiai;2711590019;Taip;0;1;0;1
6697;Pagrandukas;Zuikučiai;6449029299;Taip;0;3;0;3
6698;Pagrandukas;Zuikučiai;1405820070;Taip;0;4;2;6
6699;Pagrandukas;Zuikučiai;1054107640;Taip;0;12;0;12
6700;Pagrandukas;Zuikučiai;1885539883;Taip;0;1;0;1
6701;Pagrandukas;Zuikučiai;1795582354;Taip;0;2;0;2
6702;Pagrandukas;Zuikučiai;2822538227;Taip;1;8;0;9
6703;Pagrandukas;Zuikučiai;1587839122;Taip;19;0;0;19
6704;Pagrandukas;Zuikučiai;2101505576;Taip;5;0;8;13
6705;Pagrandukas;Zuikučiai;6765346578;Ne;5;0;2;7
6706;Pagrandukas;Zuikučiai;5922595170;Taip;0;3;0;3
6707;Pagrandukas;Zuikučiai;5030928303;Taip;0;1;0;1
6708;Pagrandukas;Zuikučiai;9139212151;Taip;0;1;3;4
6709;Pagrandukas;Zuikučiai;8643993939;Taip;0;0;1;1
6710;Pagrandukas;Zuikučiai;5021106231;Taip;3;1;0;4
6711;Pagrandukas;Boružėlių;3398225200;Taip;0;1;0;1
6712;Pagrandukas;Boružėlių;5752454925;Ne;0;1;0;1
6713;Pagrandukas;Boružėlių;3587941684;Taip;1;0;0;1
6714;Pagrandukas;Boružėlių;5946007985;Taip;0;1;0;1
6715;Pagrandukas;Boružėlių;7770852445;Taip;2;1;0;3
6716;Pagrandukas;Boružėlių;3953844737;Taip;0;1;0;1
6717;Pagrandukas;Boružėlių;7271589727;Taip;0;1;0;1
6718;Pagrandukas;Boružėlių;1403569615;Taip;6;1;1;8
6719;Pagrandukas;Boružėlių;1998073387;Taip;0;1;0;1
6720;Pagrandukas;Boružėlių;5511396314;Taip;0;10;0;10
6721;Pagrandukas;Boružėlių;5648658237;Taip;0;2;0;2
6722;Pagrandukas;Boružėlių;6911951786;Ne;0;2;0;2
6723;Pagrandukas;Boružėlių;2926077771;Taip;0;10;0;10
6724;Pagrandukas;Boružėlių;2361829423;Taip;0;1;1;2
6725;Pagrandukas;Boružėlių;8286183393;Taip;0;1;0;1
6726;Pagrandukas;Boružėlių;2549704540;Taip;4;2;0;6
6727;Pagrandukas;Boružėlių;7043125057;Ne;20;1;0;21
6728;Pagrandukas;Bitutės;6044667668;Ne;0;2;3;5
6729;Pagrandukas;Bitutės;6315627367;Taip;6;0;0;6
6730;Pagrandukas;Bitutės;8529974367;Ne;0;3;3;6
6731;Pagrandukas;Bitutės;4079711515;Taip;6;2;0;8
6732;Pagrandukas;Bitutės;8625382465;Taip;3;0;0;3
6733;Pagrandukas;Bitutės;9188382746;Taip;0;0;10;10
6734;Pagrandukas;Bitutės;4603185679;Taip;0;0;1;1
6735;Pagrandukas;Bitutės;5613442667;Taip;0;0;15;15
6736;Pagrandukas;Bitutės;2923517578;Taip;1;13;0;14
6737;Pagrandukas;Bitutės;4322675634;Taip;0;1;0;1
6738;Pagrandukas;Bitutės;3875062228;Taip;5;0;3;8
6739;Pagrandukas;Bitutės;4405567649;Taip;8;1;0;9
6740;Pagrandukas;Bitutės;1583104760;Taip;12;2;0;14
6741;Pagrandukas;Bitutės;5649084353;Taip;7;2;0;9
6742;Pagrandukas;Bitutės;8719834064;Taip;6;1;2;9
6743;Pagrandukas;Bitutės;5821945401;Taip;0;0;3;3
6744;Pagrandukas;Bitutės;7675694987;Taip;1;0;0;1
6745;Pagrandukas;Bitutės;3709131197;Taip;0;2;0;2
6746;Pagrandukas;Bitutės;2098182423;Taip;0;1;0;1
6747;Pagrandukas;Bitutės;8280877177;Ne;1;0;1;2
6748;Pagrandukas;Bitutės;2764732768;Taip;5;2;1;8
6749;Pagrandukas;Pelėdžiukai;1714449109;Taip;0;4;0;4
6750;Pagrandukas;Pelėdžiukai;3160109801;Taip;0;2;5;7
6751;Pagrandukas;Pelėdžiukai;2877401332;Taip;5;1;0;6
6752;Pagrandukas;Pelėdžiukai;8167118045;Taip;13;0;0;13
6753;Pagrandukas;Pelėdžiukai;3390664086;Taip;11;0;0;11
6754;Pagrandukas;Pelėdžiukai;1733723373;Taip;0;2;0;2
6755;Pagrandukas;Pelėdžiukai;6011346969;Taip;12;0;0;12
6756;Pagrandukas;Pelėdžiukai;1077792535;Taip;5;1;0;6
6757;Pagrandukas;Pelėdžiukai;9583471280;Taip;5;1;0;6
6758;Pagrandukas;Pelėdžiukai;2481532396;Taip;12;1;0;13
6759;Pagrandukas;Pelėdžiukai;4398016119;Taip;5;4;0;9
6760;Pagrandukas;Pelėdžiukai;2640777376;Taip;0;0;8;8
6761;Pagrandukas;Pelėdžiukai;4910151924;Taip;3;5;0;8
6762;Pagrandukas;Pelėdžiukai;9431513632;Taip;9;1;0;10
6763;Pagrandukas;Pelėdžiukai;1977974235;Taip;0;3;3;6
6764;Pagrandukas;Pelėdžiukai;7238694532;Taip;9;3;0;12
6765;Pagrandukas;ŠYPSENĖLIŲ;7173561328;Taip;2;1;0;3
6766;Pagrandukas;ŠYPSENĖLIŲ;1101989969;Taip;0;9;0;9
6767;Pagrandukas;ŠYPSENĖLIŲ;5701479990;Taip;0;1;0;1
6768;Pagrandukas;ŠYPSENĖLIŲ;9981610798;Taip;0;0;4;4
6769;Pagrandukas;ŠYPSENĖLIŲ;6248684084;Taip;12;0;0;12
6770;Pagrandukas;ŠYPSENĖLIŲ;2904880156;Taip;9;0;1;10
6771;Pagrandukas;ŠYPSENĖLIŲ;5173633710;Taip;0;0;2;2
6772;Pagrandukas;ŠYPSENĖLIŲ;6057078416;Taip;0;0;8;8
6773;Pagrandukas;ŠYPSENĖLIŲ;1855833141;Taip;0;16;1;17
6774;Pagrandukas;ŠYPSENĖLIŲ;5272914210;Taip;0;0;1;1
6775;Pagrandukas;ŠYPSENĖLIŲ;6517393406;Taip;0;0;2;2
6776;Pagrandukas;ŠYPSENĖLIŲ;4094086585;Taip;9;1;1;11
6777;Pagrandukas;ŠYPSENĖLIŲ;6306635507;Taip;4;0;0;4
6778;Pakalnutė;Pagrandukai;7475119623;Taip;0;4;0;4
6779;Pakalnutė;Pagrandukai;9677810607;Taip;0;1;0;1
6780;Pakalnutė;Pagrandukai;5275833872;Taip;15;0;0;15
6781;Pakalnutė;Pagrandukai;5943686565;Taip;6;0;0;6
6782;Pakalnutė;Pagrandukai;2296079246;Taip;13;0;0;13
6783;Pakalnutė;Pagrandukai;9313588621;Taip;1;0;0;1
6784;Pakalnutė;Pagrandukai;7962849592;Taip;3;1;0;4
6785;Pakalnutė;Pagrandukai;5180015882;Taip;9;1;0;10
6786;Pakalnutė;Pagrandukai;3794283102;Taip;5;1;0;6
6787;Pakalnutė;Pagrandukai;3070652992;Taip;10;1;0;11
6788;Pakalnutė;Pagrandukai;7477188659;Taip;4;1;0;5
6789;Pakalnutė;Pagrandukai;8522585063;Taip;1;0;0;1
6790;Pakalnutė;Pagrandukai;4390444128;Taip;1;0;0;1
6791;Pakalnutė;Pagrandukai;2642359967;Taip;3;0;1;4
6792;Pakalnutė;Pagrandukai;1614993691;Taip;5;1;0;6
6793;Pakalnutė;Pagrandukai;7417131378;Taip;12;0;0;12
6794;Pakalnutė;Pagrandukai;6396963609;Taip;10;0;0;10
6795;Pakalnutė;Pagrandukai;6708041407;Taip;1;0;2;3
6796;Pakalnutė;Pagrandukai;1883500676;Taip;0;7;0;7
6797;Pakalnutė;"Pelėdžiukų ";7110858765;Taip;0;0;2;2
6798;Pakalnutė;"Pelėdžiukų ";8553182620;Taip;0;1;5;6
6799;Pakalnutė;"Pelėdžiukų ";3840499737;Taip;0;1;3;4
6800;Pakalnutė;"Pelėdžiukų ";4523766424;Taip;9;2;0;11
6801;Pakalnutė;"Pelėdžiukų ";6577255841;Taip;1;0;1;2
6802;Pakalnutė;"Pelėdžiukų ";7151877991;Ne;0;0;5;5
6803;Pakalnutė;"Pelėdžiukų ";2992768162;Ne;10;2;0;12
6804;Pakalnutė;"Pelėdžiukų ";9505524183;Taip;7;0;3;10
6805;Pakalnutė;"Pelėdžiukų ";8823232039;Taip;4;1;0;5
6806;Pakalnutė;"Pelėdžiukų ";8900756351;Taip;0;0;1;1
6807;Pakalnutė;"Pelėdžiukų ";2035060922;Taip;1;0;0;1
6808;Pakalnutė;"Pelėdžiukų ";7325137583;Taip;0;0;2;2
6809;Pakalnutė;"Pelėdžiukų ";4220368864;Taip;0;1;0;1
6810;Pakalnutė;"Pelėdžiukų ";1330092247;Taip;0;5;4;9
6811;Pakalnutė;"Pelėdžiukų ";3267680599;Ne;0;5;0;5
6812;Pakalnutė;"Pelėdžiukų ";4353883274;Ne;0;0;1;1
6813;Pakalnutė;Ežiukai;5058727058;Taip;6;0;0;6
6814;Pakalnutė;Ežiukai;4052166895;Taip;5;0;2;7
6815;Pakalnutė;Ežiukai;1070172991;Taip;0;2;0;2
6816;Pakalnutė;Ežiukai;9323200833;Taip;0;2;0;2
6817;Pakalnutė;Ežiukai;9781993614;Taip;2;1;0;3
6818;Pakalnutė;Ežiukai;9256219647;Taip;2;1;0;3
6819;Pakalnutė;Ežiukai;7853479591;Taip;0;2;0;2
6820;Pakalnutė;Ežiukai;4317305712;Taip;4;0;0;4
6821;Pakalnutė;Ežiukai;7734657452;Taip;0;0;2;2
6822;Pakalnutė;Ežiukai;8081932074;Taip;5;0;0;5
6823;Pakalnutė;Ežiukai;9706455707;Taip;6;0;1;7
6824;Pakalnutė;Ežiukai;7881545979;Ne;0;4;0;4
6825;Pakalnutė;Ežiukai;8080989574;Taip;2;2;0;4
6826;Pakalnutė;Ežiukai;5911381706;Taip;4;3;0;7
6827;Pakalnutė;Ežiukai;2755412687;Taip;9;0;2;11
6828;Pakalnutė;Ežiukai;8236718590;Taip;0;3;0;3
6829;Pakalnutė;Skruzdėliukų;4033813807;Taip;18;1;0;19
6830;Pakalnutė;Skruzdėliukų;7503936754;Taip;5;0;0;5
6831;Pakalnutė;Skruzdėliukų;5409476517;Taip;2;8;0;10
6832;Pakalnutė;Skruzdėliukų;2670302354;Taip;1;0;0;1
6833;Pakalnutė;Skruzdėliukų;7105369111;Taip;0;0;1;1
6834;Pakalnutė;Skruzdėliukų;6944726166;Taip;6;0;0;6
6835;Pakalnutė;Skruzdėliukų;1195872320;Taip;6;1;0;7
6836;Pakalnutė;Skruzdėliukų;3211633472;Taip;1;0;0;1
6837;Pakalnutė;Skruzdėliukų;4423348418;Taip;0;3;0;3
6838;Pakalnutė;Skruzdėliukų;6055727963;Taip;0;1;0;1
6839;Pakalnutė;Skruzdėliukų;5619262190;Taip;10;0;0;10
6840;Pakalnutė;Skruzdėliukų;3215438452;Taip;1;0;0;1
6841;Pakalnutė;Skruzdėliukų;9681515221;Taip;6;0;0;6
6842;Pakalnutė;Skruzdėliukų;8496839980;Taip;6;1;0;7
6843;Pakalnutė;Skruzdėliukų;9336711927;Ne;5;0;1;6
6844;Pakalnutė;Skruzdėliukų;3288449407;Taip;0;1;0;1
6845;Pakalnutė;Bitučių;2993145079;Taip;0;1;0;1
6846;Pakalnutė;Bitučių;8461220770;Ne;0;1;0;1
6847;Pakalnutė;Bitučių;2367683002;Taip;0;1;0;1
6848;Pakalnutė;Bitučių;2765220889;Taip;0;1;0;1
6849;Pakalnutė;Bitučių;9445909071;Taip;3;3;1;7
6850;Pakalnutė;Bitučių;5532458706;Taip;1;10;0;11
6851;Pakalnutė;Bitučių;7526989580;Taip;2;1;0;3
6852;Pakalnutė;Bitučių;5941955322;Taip;4;0;1;5
6853;Pakalnutė;Bitučių;3306334576;Taip;0;1;0;1
6854;Pakalnutė;Bitučių;2095540372;Taip;0;1;0;1
6855;Pakalnutė;Bitučių;5342592825;Taip;1;0;0;1
6856;Pakalnutė;Bitučių;2932205226;Taip;0;1;0;1
6857;Pakalnutė;Bitučių;5464143742;Taip;11;2;0;13
6858;Pakalnutė;Bitučių;6351193702;Taip;5;1;0;6
6859;Pakalnutė;Bitučių;2070744110;Taip;0;1;0;1
6860;Pakalnutė;Bitučių;3965390135;Taip;3;0;1;4
6861;Pakalnutė;Bitučių;5355198213;Taip;7;0;0;7
6862;Pakalnutė;Bitučių;4533467194;Ne;2;1;0;3
6863;Pakalnutė;Bitučių;3583094831;Taip;1;2;0;3
6864;Pakalnutė;Boružiukų;5120176374;Ne;4;1;0;5
6865;Pakalnutė;Boružiukų;6798939288;Taip;9;1;0;10
6866;Pakalnutė;Boružiukų;7357431226;Taip;0;7;0;7
6867;Pakalnutė;Boružiukų;4934095931;Taip;0;1;0;1
6868;Pakalnutė;Boružiukų;5039000154;Taip;0;2;0;2
6869;Pakalnutė;Boružiukų;6575909478;Ne;0;11;0;11
6870;Pakalnutė;Boružiukų;7223747714;Taip;3;0;0;3
6871;Pakalnutė;Boružiukų;2835611316;Taip;4;0;0;4
6872;Pakalnutė;Boružiukų;7672252382;Ne;2;2;0;4
6873;Pakalnutė;Boružiukų;4950195858;Taip;10;0;1;11
6874;Pakalnutė;Boružiukų;4927086034;Taip;2;0;0;2
6875;Pakalnutė;Boružiukų;6557165567;Taip;8;0;0;8
6876;Pakalnutė;Boružiukų;3677709759;Taip;1;0;4;5
6877;Pakalnutė;Boružiukų;2597900983;Taip;6;1;0;7
6878;Pakalnutė;Boružiukų;2062721289;Taip;0;1;0;1
6879;Pakalnutė;Boružiukų;1340022702;Taip;5;0;0;5
6880;Pakalnutė;Boružiukų;6228196996;Taip;12;0;0;12
6881;Pakalnutė;Boružiukų;7563201788;Taip;0;10;1;11
6882;Pakalnutė;Meškiukų;2666441234;Taip;5;0;0;5
6883;Pakalnutė;Meškiukų;4256222944;Taip;7;3;0;10
6884;Pakalnutė;Meškiukų;2101821362;Taip;0;14;0;14
6885;Pakalnutė;Meškiukų;4069910346;Ne;5;0;0;5
6886;Pakalnutė;Meškiukų;4313652059;Ne;5;4;0;9
6887;Pakalnutė;Meškiukų;6133481935;Taip;0;2;0;2
6888;Pakalnutė;Meškiukų;3693337607;Taip;3;0;0;3
6889;Pakalnutė;Meškiukų;2923698853;Taip;6;11;0;17
6890;Pakalnutė;Meškiukų;1369906621;Taip;0;0;1;1
6891;Pakalnutė;Nykštukai;9918277117;Taip;6;0;0;6
6892;Pakalnutė;Nykštukai;6633585181;Taip;5;0;2;7
6893;Pakalnutė;Nykštukai;3870628774;Taip;5;0;1;6
6894;Pakalnutė;Nykštukai;8324219868;Ne;0;21;0;21
6895;Pakalnutė;Nykštukai;1864990681;Taip;4;1;0;5
6896;Pakalnutė;Nykštukai;2063766287;Taip;8;1;0;9
6897;Pakalnutė;Nykštukai;6528913736;Ne;0;2;0;2
6898;Pakalnutė;Nykštukai;8217779439;Taip;0;1;0;1
6899;Pakalnutė;Nykštukai;6206296685;Taip;0;21;0;21
6900;Pakalnutė;Nykštukai;8855237588;Taip;0;8;0;8
6901;Pakalnutė;Nykštukai;1561411767;Taip;7;0;0;7
6902;Pakalnutė;Nykštukai;9443826616;Taip;10;0;0;10
6903;Pakalnutė;Nykštukai;7024440142;Taip;0;11;0;11
6904;Pakalnutė;Nykštukai;2578170222;Taip;3;1;3;7
6905;Pakalnutė;Nykštukai;3967515235;Taip;0;0;1;1
6906;Pakalnutė;Nykštukai;5377715404;Taip;21;0;0;21
6907;Pakalnutė;Nykštukai;3938091521;Taip;13;0;0;13
6908;Pakalnutė;Nykštukai;4971065032;Taip;5;0;1;6
6909;Pakalnutė;"Zuikučių ";1198230323;Taip;0;1;2;3
6910;Pakalnutė;"Zuikučių ";3609982613;Taip;4;1;0;5
6911;Pakalnutė;"Zuikučių ";5958653847;Taip;0;1;0;1
6912;Pakalnutė;"Zuikučių ";1147843795;Taip;0;1;0;1
6913;Pakalnutė;"Zuikučių ";3555822605;Taip;2;1;0;3
6914;Pakalnutė;"Zuikučių ";1583462733;Ne;0;1;1;2
6915;Pakalnutė;"Zuikučių ";6377564215;Taip;1;0;0;1
6916;Pakalnutė;"Zuikučių ";8813262660;Taip;0;1;0;1
6917;Pakalnutė;"Zuikučių ";7949588551;Taip;10;0;1;11
6918;Pakalnutė;"Zuikučių ";2002555659;Ne;3;0;5;8
6919;Pakalnutė;"Zuikučių ";4681267749;Ne;0;4;0;4
6920;Pakalnutė;"Zuikučių ";6884488772;Taip;6;0;2;8
6921;Pakalnutė;"Zuikučių ";5912904296;Taip;0;2;0;2
6922;Pakalnutė;"Drugelių ";5441477374;Ne;1;3;0;4
6923;Pakalnutė;"Drugelių ";7369661890;Taip;8;0;1;9
6924;Pakalnutė;"Drugelių ";5135811550;Taip;6;0;1;7
6925;Pakalnutė;"Drugelių ";7766653114;Taip;1;0;2;3
6926;Pakalnutė;"Drugelių ";7709684372;Taip;1;6;0;7
6927;Pakalnutė;"Drugelių ";9620000116;Taip;4;0;1;5
6928;Pakalnutė;"Drugelių ";5502444590;Taip;0;0;1;1
6929;Pakalnutė;"Drugelių ";3730712580;Taip;3;1;0;4
6930;Pakalnutė;"Drugelių ";4220406978;Ne;0;0;3;3
6931;Pakalnutė;"Drugelių ";5069038636;Taip;0;11;0;11
6932;Pakalnutė;"Drugelių ";7047587606;Taip;2;11;0;13
6933;Pakalnutė;"Drugelių ";2653667596;Taip;0;1;3;4
6934;Pakalnutė;"Drugelių ";2026242407;Ne;0;0;1;1
6935;Pakalnutė;"Drugelių ";2197533802;Taip;0;1;0;1
6936;Pakalnutė;"Drugelių ";1791607977;Taip;1;1;0;2
6937;Pakalnutė;"Drugelių ";4127500142;Taip;0;1;5;6
6938;Pakalnutė;"Drugelių ";9295709508;Taip;10;0;1;11
6939;Pakalnutė;Žvirbliukų;7421275778;Taip;4;0;0;4
6940;Pakalnutė;Žvirbliukų;8329725085;Taip;0;2;1;3
6941;Pakalnutė;Žvirbliukų;3190067149;Taip;0;9;0;9
6942;Pakalnutė;Žvirbliukų;7548659665;Taip;1;2;5;8
6943;Pakalnutė;Žvirbliukų;8010667913;Taip;6;0;2;8
6944;Pakalnutė;Žvirbliukų;1662773049;Taip;7;2;0;9
6945;Pakalnutė;Žvirbliukų;5531209454;Taip;9;5;0;14
6946;Pakalnutė;Žvirbliukų;3342793992;Taip;0;0;3;3
6947;Pakalnutė;Žvirbliukų;7258417347;Taip;26;0;0;26
6948;Pakalnutė;Žvirbliukų;4961361687;Taip;2;1;0;3
6949;Pakalnutė;Žvirbliukų;5878352514;Taip;1;0;3;4
6950;Pakalnutė;Žvirbliukų;5685361033;Ne;1;0;8;9
6951;Pakalnutė;Žvirbliukų;7782295402;Taip;3;0;0;3
6952;Pakalnutė;Žvirbliukų;7547661599;Taip;12;0;0;12
6953;Pakalnutė;Žvirbliukų;4469974699;Taip;10;1;0;11
6954;Pakalnutė;Žvirbliukų;6159955311;Taip;6;0;0;6
6955;Pakalnutė;Žvirbliukų;3903972025;Taip;9;5;0;14
6956;Panerių;Rūtelė;4689913361;Taip;0;0;7;7
6957;Panerių;Rūtelė;2195332401;Taip;0;0;2;2
6958;Panerių;Rūtelė;2571561865;Taip;3;3;0;6
6959;Panerių;Rūtelė;6908487075;Taip;0;1;10;11
6960;Panerių;Rūtelė;2643410976;Ne;0;1;0;1
6961;Panerių;Rūtelė;8771264170;Ne;0;0;2;2
6962;Panerių;Rūtelė;2189532651;Taip;0;1;3;4
6963;Panerių;Rūtelė;3346395516;Taip;0;1;3;4
6964;Panerių;Rūtelė;7805429137;Taip;0;0;3;3
6965;Panerių;Rūtelė;9268618414;Taip;0;0;3;3
6966;Panerių;Rūtelė;6411372006;Taip;9;1;6;16
6967;Panerių;Rūtelė;1419817211;Ne;16;0;0;16
6968;Panerių;Rūtelė;2333355325;Taip;0;0;1;1
6969;Panerių;Rūtelė;3913395809;Taip;5;1;10;16
6970;Panerių;Rūtelė;2235123048;Ne;2;0;9;11
6971;Panerių;Rūtelė;3190117304;Ne;0;9;0;9
6972;Panerių;Rūtelė;8693113275;Ne;4;0;6;10
6973;Panerių;Rūtelė;6468190149;Taip;0;0;1;1
6974;Panerių;Rūtelė;9630302749;Taip;1;0;4;5
6975;Panerių;Rūtelė;3057714143;Taip;0;1;1;2
6976;Panerių;Gėlytės;3550194241;Taip;0;0;1;1
6977;Panerių;Gėlytės;1339256258;Taip;4;0;0;4
6978;Panerių;Gėlytės;9729731866;Taip;6;0;0;6
6979;Panerių;Gėlytės;3948776877;Taip;2;0;0;2
6980;Panerių;Gėlytės;2751334281;Taip;6;1;1;8
6981;Panerių;Gėlytės;9432171719;Taip;10;1;0;11
6982;Panerių;Gėlytės;5452996791;Taip;0;1;0;1
6983;Panerių;Gėlytės;1717129076;Ne;21;0;2;23
6984;Panerių;Gėlytės;2035822976;Taip;0;0;1;1
6985;Panerių;Gėlytės;8447920373;Taip;0;0;3;3
6986;Panerių;Gėlytės;4161189870;Taip;0;8;0;8
6987;Panerių;Gėlytės;9004310393;Ne;2;0;1;3
6988;Panerių;Gėlytės;3882802840;Taip;1;1;0;2
6989;Panerių;Gėlytės;6304387432;Taip;0;1;1;2
6990;Panerių;Gėlytės;7166964095;Taip;2;0;4;6
6991;Panerių;Gėlytės;8109366029;Ne;10;0;2;12
6992;Panerių;Boružė;7657860513;Taip;6;4;0;10
6993;Panerių;Boružė;9014387764;Taip;0;3;0;3
6994;Panerių;Boružė;4369979548;Ne;0;0;1;1
6995;Panerių;Boružė;3273655606;Ne;16;0;0;16
6996;Panerių;Boružė;8067240250;Ne;9;0;5;14
6997;Panerių;Boružė;3526636673;Taip;6;2;0;8
6998;Panerių;Boružė;8407995549;Taip;7;0;3;10
6999;Panerių;Boružė;3502494751;Taip;7;0;6;13
7000;Panerių;Boružė;6653710644;Ne;4;0;1;5
7001;Panerių;Boružė;7227118885;Ne;5;0;5;10
7002;Panerių;Boružė;9288515724;Ne;10;0;4;14
7003;Panerių;Boružė;7976634590;Taip;0;0;2;2
7004;Panerių;Boružė;4716214117;Taip;11;7;0;18
7005;Panerių;Boružė;4957564440;Taip;12;0;0;12
7006;Panerių;Boružė;1985780685;Ne;5;0;2;7
7007;Papartis;ZUIKUČIAI;8874222586;Taip;10;0;1;11
7008;Papartis;ZUIKUČIAI;2446379598;Taip;0;8;0;8
7009;Papartis;ZUIKUČIAI;3054883426;Taip;12;1;0;13
7010;Papartis;ZUIKUČIAI;1191546794;Taip;8;1;0;9
7011;Papartis;ZUIKUČIAI;7619963429;Taip;1;1;0;2
7012;Papartis;ZUIKUČIAI;8958880558;Taip;0;16;0;16
7013;Papartis;ZUIKUČIAI;4380030213;Ne;11;0;0;11
7014;Papartis;ZUIKUČIAI;4906248064;Taip;0;5;1;6
7015;Papartis;ZUIKUČIAI;8447326505;Taip;7;1;1;9
7016;Papartis;ZUIKUČIAI;1919362027;Taip;1;1;0;2
7017;Papartis;ZUIKUČIAI;4640068595;Taip;0;1;0;1
7018;Papartis;ZUIKUČIAI;5361925390;Taip;0;0;1;1
7019;Papartis;ZUIKUČIAI;5796928317;Taip;0;0;1;1
7020;Papartis;ZUIKUČIAI;9375751990;Taip;0;6;0;6
7021;Papartis;ZUIKUČIAI;6266095782;Taip;9;1;0;10
7022;Papartis;ZUIKUČIAI;5786648402;Taip;0;0;4;4
7023;Papartis;ZUIKUČIAI;5776038830;Taip;5;0;0;5
7024;Papartis;ZUIKUČIAI;5579899922;Taip;10;0;0;10
7025;Papartis;ZUIKUČIAI;8808902528;Taip;5;0;0;5
7026;Papartis;ZUIKUČIAI;9358310527;Taip;3;10;0;13
7027;Papartis;ZUIKUČIAI;5363926529;Taip;0;4;0;4
7028;Papartis;ZUIKUČIAI;1722192450;Taip;0;2;0;2
7029;Papartis;DRUGELIAI;8005876431;Taip;5;2;0;7
7030;Papartis;DRUGELIAI;7384518191;Taip;0;1;0;1
7031;Papartis;DRUGELIAI;6664178454;Ne;0;1;2;3
7032;Papartis;DRUGELIAI;2432516496;Taip;0;2;2;4
7033;Papartis;DRUGELIAI;7742769931;Taip;9;0;2;11
7034;Papartis;DRUGELIAI;8305560946;Ne;0;0;3;3
7035;Papartis;DRUGELIAI;4778327620;Taip;0;3;0;3
7036;Papartis;DRUGELIAI;7331682622;Taip;11;0;2;13
7037;Papartis;DRUGELIAI;2824078830;Taip;5;1;2;8
7038;Papartis;DRUGELIAI;1405767603;Taip;5;1;1;7
7039;Papartis;DRUGELIAI;6435625940;Taip;3;2;0;5
7040;Papartis;DRUGELIAI;7187797639;Taip;8;0;2;10
7041;Papartis;DRUGELIAI;3411472740;Taip;4;0;7;11
7042;Papartis;DRUGELIAI;3209105694;Taip;6;0;1;7
7043;Papartis;DRUGELIAI;8277830926;Taip;3;1;0;4
7044;Papartis;DRUGELIAI;1759982543;Taip;5;2;1;8
7045;Papartis;DRUGELIAI;4689046394;Taip;1;0;0;1
7046;Papartis;DRUGELIAI;5430993785;Taip;5;2;0;7
7047;Papartis;ŽVIRBLIUKAI;7590170146;Taip;0;1;1;2
7048;Papartis;ŽVIRBLIUKAI;42803013754;Taip;0;1;0;1
7049;Papartis;ŽVIRBLIUKAI;3408756311;Taip;0;1;1;2
7050;Papartis;ŽVIRBLIUKAI;4935694347;Taip;0;1;0;1
7051;Papartis;ŽVIRBLIUKAI;7067369268;Ne;3;1;3;7
7052;Papartis;ŽVIRBLIUKAI;1836914270;Taip;0;1;1;2
7053;Papartis;ŽVIRBLIUKAI;4508053349;Taip;0;1;0;1
7054;Papartis;ŽVIRBLIUKAI;2778629398;Taip;0;8;6;14
7055;Papartis;ŽVIRBLIUKAI;2535412635;Taip;11;0;0;11
7056;Papartis;ŽVIRBLIUKAI;1205854439;Taip;6;0;2;8
7057;Papartis;ŽVIRBLIUKAI;1672028156;Taip;0;2;0;2
7058;Papartis;ŽVIRBLIUKAI;8148483438;Taip;0;0;1;1
7059;Papartis;ŽVIRBLIUKAI;3295731801;Ne;0;1;2;3
7060;Papartis;ŽVIRBLIUKAI;6797687614;Taip;0;1;4;5
7061;Papartis;ŽVIRBLIUKAI;3475745012;Taip;7;1;5;13
7062;Papartis;ŽVIRBLIUKAI;4634683589;Taip;0;0;4;4
7063;Papartis;ŽVIRBLIUKAI;3267416367;Taip;0;5;0;5
7064;Papartis;ŽVIRBLIUKAI;5265293240;Taip;0;2;1;3
7065;Papartis;ŽVIRBLIUKAI;9134335737;Taip;0;2;1;3
7066;Papartis;ŽVIRBLIUKAI;7387281720;Taip;0;4;0;4
7067;Papartis;PELĖDŽIUKAI;7606939822;Taip;0;2;0;2
7068;Papartis;PELĖDŽIUKAI;2447926422;Taip;0;3;0;3
7069;Papartis;PELĖDŽIUKAI;1260151691;Taip;0;2;1;3
7070;Papartis;PELĖDŽIUKAI;4346817695;Taip;0;1;0;1
7071;Papartis;PELĖDŽIUKAI;1527263538;Taip;0;1;0;1
7072;Papartis;PELĖDŽIUKAI;1219140467;Taip;0;3;0;3
7073;Papartis;PELĖDŽIUKAI;5410369044;Ne;9;2;0;11
7074;Papartis;PELĖDŽIUKAI;1065128993;Taip;0;2;1;3
7075;Papartis;PELĖDŽIUKAI;6126912448;Taip;0;2;0;2
7076;Papartis;PELĖDŽIUKAI;8952917454;Ne;0;1;1;2
7077;Papartis;PELĖDŽIUKAI;3182457453;Taip;0;1;0;1
7078;Papartis;PELĖDŽIUKAI;5675537250;Taip;0;5;0;5
7079;Papartis;PELĖDŽIUKAI;72182866449;Taip;0;1;0;1
7080;Papartis;PELĖDŽIUKAI;4992305227;Taip;7;1;0;8
7081;Papartis;PELĖDŽIUKAI;7703070601;Ne;0;1;0;1
7082;Papartis;PELĖDŽIUKAI;7902130389;Taip;9;1;0;10
7083;Papartis;PELĖDŽIUKAI;4279580382;Ne;0;0;1;1
7084;Papartis;PELĖDŽIUKAI;1974159967;Taip;0;2;2;4
7085;Papartis;PELĖDŽIUKAI;5732853976;Taip;0;1;1;2
7086;Papartis;PELĖDŽIUKAI;1554777403;Ne;0;0;2;2
7087;Papartis;PELĖDŽIUKAI;3107106078;Taip;0;1;0;1
7088;Papartis;SAULUTĖS;5538433120;Ne;0;0;4;4
7089;Papartis;SAULUTĖS;2669085057;Ne;12;0;9;21
7090;Papartis;SAULUTĖS;6585372451;Taip;11;0;0;11
7091;Papartis;SAULUTĖS;4570512336;Ne;0;1;1;2
7092;Papartis;SAULUTĖS;1231594320;Taip;0;1;2;3
7093;Papartis;SAULUTĖS;3539507686;Taip;0;3;2;5
7094;Papartis;SAULUTĖS;3595627659;Taip;0;0;3;3
7095;Papartis;SAULUTĖS;6977513472;Taip;0;2;0;2
7096;Papartis;SAULUTĖS;5070767260;Taip;0;1;0;1
7097;Papartis;SAULUTĖS;9380951144;Taip;2;0;2;4
7098;Papartis;SAULUTĖS;4016297254;Taip;21;0;0;21
7099;Papartis;SAULUTĖS;5323875279;Taip;0;4;0;4
7100;Papartis;SAULUTĖS;5465955537;Taip;5;0;3;8
7101;Papartis;SAULUTĖS;2812347963;Taip;0;1;0;1
7102;Papartis;SAULUTĖS;4597039190;Taip;6;0;0;6
7103;Papartis;SAULUTĖS;8420752169;Taip;0;2;4;6
7104;Papartis;SAULUTĖS;6346776139;Taip;5;0;2;7
7105;Papartis;SAULUTĖS;1352401881;Taip;0;1;0;1
7106;Papartis;SAULUTĖS;3685642787;Taip;6;0;1;7
7107;Papartis;SAULUTĖS;6136213985;Taip;4;0;4;8
7108;Papartis;SAULUTĖS;7107692314;Taip;3;0;2;5
7109;Papartis;GANDRIUKAI;4878190663;Taip;0;0;3;3
7110;Papartis;GANDRIUKAI;9900023788;Taip;0;1;0;1
7111;Papartis;GANDRIUKAI;8946678515;Taip;0;0;3;3
7112;Papartis;GANDRIUKAI;2783708905;Taip;5;4;0;9
7113;Papartis;GANDRIUKAI;6883101103;Taip;0;0;1;1
7114;Papartis;GANDRIUKAI;2868899342;Taip;3;2;0;5
7115;Papartis;GANDRIUKAI;7768672610;Taip;0;1;0;1
7116;Papartis;GANDRIUKAI;9384670351;Taip;0;2;0;2
7117;Papartis;GANDRIUKAI;9968072478;Taip;0;0;4;4
7118;Papartis;GANDRIUKAI;2215846642;Taip;6;0;0;6
7119;Papartis;GANDRIUKAI;3320524073;Taip;3;0;0;3
7120;Papartis;GANDRIUKAI;9704930584;Taip;0;10;0;10
7121;Papartis;GANDRIUKAI;9804863902;Taip;0;2;0;2
7122;Papartis;GANDRIUKAI;9072635586;Ne;1;8;0;9
7123;Papartis;GANDRIUKAI;7859096984;Taip;4;5;0;9
7124;Papartis;GANDRIUKAI;1442806517;Taip;0;1;0;1
7125;Papartis;GANDRIUKAI;7252265838;Taip;0;1;0;1
7126;Papartis;GANDRIUKAI;9978625382;Taip;16;0;1;17
7127;Papartis;GANDRIUKAI;5883751305;Ne;3;1;0;4
7128;Papartis;GANDRIUKAI;4509843536;Taip;21;0;0;21
7129;Papartis;GANDRIUKAI;8768526171;Taip;16;0;0;16
7130;Papartis;AITVARELIAI;8891856856;Taip;5;1;0;6
7131;Papartis;AITVARELIAI;6889782462;Ne;0;0;9;9
7132;Papartis;AITVARELIAI;8532558577;Taip;0;2;0;2
7133;Papartis;AITVARELIAI;5252947502;Taip;0;14;0;14
7134;Papartis;AITVARELIAI;1916222143;Taip;0;6;0;6
7135;Papartis;AITVARELIAI;7018190169;Taip;0;5;0;5
7136;Papartis;AITVARELIAI;7803854703;Taip;0;2;0;2
7137;Papartis;AITVARELIAI;4261270064;Taip;0;1;0;1
7138;Papartis;AITVARELIAI;6416605464;Taip;6;0;0;6
7139;Papartis;AITVARELIAI;1266338760;Taip;0;1;0;1
7140;Papartis;AITVARELIAI;7504793827;Taip;12;0;0;12
7141;Papartis;AITVARELIAI;7156767639;Taip;7;0;2;9
7142;Papartis;AITVARELIAI;5268226380;Ne;5;1;0;6
7143;Papartis;AITVARELIAI;8626682787;Taip;0;0;2;2
7144;Papartis;AITVARELIAI;2116140075;Taip;0;7;0;7
7145;Papartis;AITVARELIAI;3896803048;Taip;0;1;0;1
7146;Papartis;AITVARELIAI;8989172483;Taip;0;0;9;9
7147;Papartis;SMALSUČIAI;7856148436;Ne;11;0;2;13
7148;Papartis;SMALSUČIAI;4969807705;Taip;0;0;1;1
7149;Papartis;SMALSUČIAI;5383936595;Taip;7;0;0;7
7150;Papartis;SMALSUČIAI;1698871014;Taip;8;0;0;8
7151;Papartis;SMALSUČIAI;6274608449;Taip;0;1;2;3
7152;Papartis;SMALSUČIAI;6664773988;Taip;0;1;1;2
7153;Papartis;SMALSUČIAI;8875490564;Taip;12;0;1;13
7154;Papartis;SMALSUČIAI;2921187615;Taip;5;0;1;6
7155;Papartis;SMALSUČIAI;5128663521;Taip;7;1;0;8
7156;Papartis;SMALSUČIAI;4500675679;Taip;3;3;0;6
7157;Papartis;SMALSUČIAI;7203919287;Taip;4;4;0;8
7158;Papartis;SMALSUČIAI;1486770896;Ne;0;0;2;2
7159;Papartis;SMALSUČIAI;5132031416;Taip;12;0;0;12
7160;Papartis;SMALSUČIAI;3395306653;Taip;19;0;0;19
7161;Papartis;SMALSUČIAI;5964232886;Taip;6;0;2;8
7162;Papartis;SMALSUČIAI;7149853209;Taip;0;0;1;1
7163;Papartis;SMALSUČIAI;4483401826;Taip;5;0;1;6
7164;Papartis;SMALSUČIAI;1616537800;Taip;0;5;0;5
7165;Papartis;"ŽIRNIUKAI ";8897061283;Taip;6;0;0;6
7166;Papartis;"ŽIRNIUKAI ";3310893254;Taip;1;0;0;1
7167;Papartis;"ŽIRNIUKAI ";1073755384;Taip;12;0;0;12
7168;Papartis;"ŽIRNIUKAI ";7647225316;Taip;6;3;0;9
7169;Papartis;"ŽIRNIUKAI ";1210592579;Taip;2;0;1;3
7170;Papartis;"ŽIRNIUKAI ";1519815331;Taip;0;1;0;1
7171;Papartis;"ŽIRNIUKAI ";4158525314;Taip;15;1;0;16
7172;Papartis;"ŽIRNIUKAI ";4978398085;Taip;0;1;0;1
7173;Papartis;"ŽIRNIUKAI ";9746397380;Taip;5;0;1;6
7174;Papartis;"ŽIRNIUKAI ";4952279543;Taip;0;0;4;4
7175;Papartis;"ŽIRNIUKAI ";5276806556;Taip;6;0;0;6
7176;Papartis;"ŽIRNIUKAI ";2521609574;Taip;6;0;4;10
7177;Papartis;"ŽIRNIUKAI ";7617558492;Taip;0;0;7;7
7178;Papartis;"ŽIRNIUKAI ";8412962815;Ne;0;0;1;1
7179;Papartis;"ŽIRNIUKAI ";1267981238;Taip;7;10;4;21
7180;Papartis;"ŽIRNIUKAI ";2772758899;Taip;10;1;0;11
7181;Papartis;"ŽIRNIUKAI ";1183123161;Ne;3;0;2;5
7182;Papartis;"ŽIRNIUKAI ";1150772988;Ne;0;4;0;4
7183;Papartis;"ŽIRNIUKAI ";6615368741;Taip;1;0;3;4
7184;Papartis;"ŽIRNIUKAI ";7108606229;Ne;5;0;4;9
7185;Papartis;BORUŽĖLĖS;3576856223;Taip;5;3;0;8
7186;Papartis;BORUŽĖLĖS;7492923318;Taip;9;0;0;9
7187;Papartis;BORUŽĖLĖS;1157298413;Taip;0;1;0;1
7188;Papartis;BORUŽĖLĖS;2079105902;Taip;0;1;1;2
7189;Papartis;BORUŽĖLĖS;1159418157;Taip;0;2;0;2
7190;Papartis;BORUŽĖLĖS;3490370261;Taip;18;0;0;18
7191;Papartis;BORUŽĖLĖS;7298032812;Taip;9;0;1;10
7192;Papartis;BORUŽĖLĖS;3107245976;Ne;0;0;1;1
7193;Papartis;BORUŽĖLĖS;1566259150;Ne;12;0;0;12
7194;Papartis;BORUŽĖLĖS;1381195839;Taip;0;2;0;2
7195;Papartis;BORUŽĖLĖS;6107558090;Taip;6;2;0;8
7196;Papartis;BORUŽĖLĖS;6776383676;Taip;11;8;0;19
7197;Papartis;BORUŽĖLĖS;9838432144;Taip;18;0;0;18
7198;Papartis;BORUŽĖLĖS;9884399306;Taip;15;0;0;15
7199;Papartis;BORUŽĖLĖS;1511111597;Taip;3;0;0;3
7200;Papartis;BORUŽĖLĖS;8055310718;Taip;9;0;0;9
7201;Papartis;BORUŽĖLĖS;5959006739;Taip;4;1;0;5
7202;Papartis;VARPELIAI;7260304487;Taip;18;0;0;18
7203;Papartis;VARPELIAI;9581159294;Taip;0;0;21;21
7204;Papartis;VARPELIAI;2956950308;Taip;7;4;0;11
7205;Papartis;VARPELIAI;6710049689;Taip;12;0;0;12
7206;Papartis;VARPELIAI;2777359899;Taip;13;0;3;16
7207;Papartis;VARPELIAI;1993893368;Taip;11;0;0;11
7208;Papartis;VARPELIAI;3345085436;Taip;1;0;0;1
7209;Papartis;VARPELIAI;7189999679;Taip;9;1;0;10
7210;Papartis;VARPELIAI;4256878733;Ne;0;0;2;2
7211;Papartis;VARPELIAI;8443731277;Taip;0;0;2;2
7212;Papartis;VARPELIAI;3419374226;Taip;3;0;0;3
7213;Papartis;VARPELIAI;2600724041;Taip;15;0;0;15
7214;Papartis;VARPELIAI;4952700737;Taip;19;0;0;19
7215;Papartis;VARPELIAI;6146264193;Taip;12;0;8;20
7216;Papartis;VARPELIAI;8642079824;Taip;15;1;2;18
7217;Papartis;VARPELIAI;2421158534;Taip;0;0;2;2
7218;Papartis;VARPELIAI;8872914372;Taip;8;0;4;12
7219;Papartis;NYKŠTUKAI;1566011843;Ne;10;0;0;10
7220;Papartis;NYKŠTUKAI;5652769035;Taip;0;2;0;2
7221;Papartis;NYKŠTUKAI;5942160584;Taip;4;0;2;6
7222;Papartis;NYKŠTUKAI;9922091482;Taip;1;2;0;3
7223;Papartis;NYKŠTUKAI;1680412204;Ne;4;0;0;4
7224;Papartis;NYKŠTUKAI;9285319899;Taip;0;0;6;6
7225;Papartis;NYKŠTUKAI;9502229005;Taip;0;1;0;1
7226;Papartis;NYKŠTUKAI;6949120693;Taip;0;1;0;1
7227;Papartis;NYKŠTUKAI;6794076631;Ne;0;2;0;2
7228;Papartis;NYKŠTUKAI;5957889361;Taip;0;1;1;2
7229;Papartis;NYKŠTUKAI;5608868738;Ne;0;4;0;4
7230;Papartis;NYKŠTUKAI;4203241118;Ne;0;2;6;8
7231;Papartis;NYKŠTUKAI;4806652727;Taip;0;1;0;1
7232;Papartis;NYKŠTUKAI;9939850340;Taip;0;6;0;6
7233;Papartis;NYKŠTUKAI;3324647852;Taip;2;1;4;7
7234;Papartis;NYKŠTUKAI;8932290803;Taip;4;0;3;7
7235;Papartis;NYKŠTUKAI;5652560002;Taip;5;2;0;7
7236;Papartis;NYKŠTUKAI;1559196767;Ne;0;0;3;3
7237;Papartis;NYKŠTUKAI;6360881137;Taip;0;1;0;1
7238;Papartis;NYKŠTUKAI;7080578299;Taip;1;0;7;8
7239;Pasaka;Drugelių;5665758011;Taip;0;1;0;1
7240;Pasaka;Drugelių;3092993659;Taip;0;1;0;1
7241;Pasaka;Drugelių;5027755073;Ne;0;2;3;5
7242;Pasaka;Drugelių;1300996831;Taip;0;4;0;4
7243;Pasaka;Drugelių;1313576071;Ne;0;1;0;1
7244;Pasaka;Drugelių;2621046003;Taip;0;1;0;1
7245;Pasaka;Drugelių;7040953491;Taip;0;2;2;4
7246;Pasaka;Drugelių;7455544922;Taip;0;4;0;4
7247;Pasaka;Drugelių;8963465320;Taip;0;1;0;1
7248;Pasaka;Drugelių;4743331873;Taip;0;11;0;11
7249;Pasaka;Drugelių;1583090840;Taip;10;1;0;11
7250;Pasaka;Drugelių;2774371800;Taip;3;2;4;9
7251;Pasaka;Drugelių;5547931812;Ne;5;2;0;7
7252;Pasaka;Drugelių;7685589423;Taip;10;1;0;11
7253;Pasaka;Drugelių;3088081091;Taip;0;2;0;2
7254;Pasaka;Drugelių;9060396476;Taip;0;2;0;2
7255;Pasaka;Drugelių;7078492847;Taip;4;3;0;7
7256;Pasaka;Nykštukų;7546205285;Taip;0;1;0;1
7257;Pasaka;Nykštukų;5687494160;Taip;4;1;0;5
7258;Pasaka;Nykštukų;3151916774;Taip;0;1;0;1
7259;Pasaka;Nykštukų;4773893970;Taip;0;3;1;4
7260;Pasaka;Nykštukų;4082752808;Taip;8;0;2;10
7261;Pasaka;Nykštukų;6788771605;Taip;0;1;0;1
7262;Pasaka;Nykštukų;5412931969;Taip;6;0;0;6
7263;Pasaka;Nykštukų;1813068555;Taip;0;1;0;1
7264;Pasaka;Nykštukų;9567521319;Taip;11;0;0;11
7265;Pasaka;Nykštukų;6326056771;Taip;6;2;3;11
7266;Pasaka;Nykštukų;4175157894;Taip;2;0;2;4
7267;Pasaka;Nykštukų;5768958388;Taip;5;2;5;12
7268;Pasaka;Nykštukų;2797217440;Taip;0;2;0;2
7269;Pasaka;Nykštukų;7292437626;Taip;0;1;0;1
7270;Pasaka;Montesori;16974081144;Taip;0;1;5;6
7271;Pasaka;Montesori;5812041166;Taip;0;1;2;3
7272;Pasaka;Montesori;4305485747;Taip;0;0;1;1
7273;Pasaka;Montesori;7837662446;Ne;5;0;0;5
7274;Pasaka;Montesori;5240642967;Ne;0;0;1;1
7275;Pasaka;Montesori;3047931231;Ne;10;0;3;13
7276;Pasaka;Montesori;3195380938;Taip;0;0;1;1
7277;Pasaka;Montesori;5031538468;Taip;6;0;0;6
7278;Pasaka;Montesori;6625690696;Taip;2;0;1;3
7279;Pasaka;Montesori;4548601585;Ne;0;6;0;6
7280;Pasaka;Montesori;7887326763;Taip;0;0;3;3
7281;Pasaka;Montesori;9850592463;Taip;3;0;1;4
7282;Pasaka;Montesori;2995831258;Taip;4;1;0;5
7283;Pasaka;Montesori;6248810027;Ne;10;0;4;14
7284;Pasaka;Montesori;3620395122;Taip;0;0;4;4
7285;Pasaka;Montesori;5689164477;Taip;5;0;2;7
7286;Pasaka;Montesori;8873248505;Taip;14;0;1;15
7287;Pasaka;Žirniukų;9867183480;Taip;0;1;0;1
7288;Pasaka;Žirniukų;3783869856;Taip;3;0;0;3
7289;Pasaka;Žirniukų;2815348652;Taip;0;1;0;1
7290;Pasaka;Žirniukų;5651025350;Taip;0;1;0;1
7291;Pasaka;Žirniukų;2422958320;Taip;0;1;3;4
7292;Pasaka;Žirniukų;9438006825;Taip;0;1;3;4
7293;Pasaka;Žirniukų;9136524816;Taip;0;5;0;5
7294;Pasaka;Žirniukų;9766432049;Taip;21;0;0;21
7295;Pasaka;Žirniukų;6668421711;Taip;6;0;0;6
7296;Pasaka;Žirniukų;6387972576;Taip;8;3;0;11
7297;Pasaka;Žirniukų;4948174745;Taip;8;0;1;9
7298;Pasaka;Žirniukų;2144975281;Ne;0;0;3;3
7299;Pasaka;Žirniukų;4629119214;Taip;0;0;5;5
7300;Pasaka;Žirniukų;2086919906;Taip;1;0;20;21
7301;Pasaka;Žirniukų;8519108324;Taip;7;1;1;9
7302;Pasaka;Žirniukų;9950979894;Taip;0;0;3;3
7303;Pasaka;Žirniukų;9654507441;Taip;16;0;0;16
7304;Pasaka;Žirniukų;9654507441;Taip;16;0;0;16
7305;Pasaka;Žirniukų;9654507441;Taip;16;0;0;16
7306;Pasaka;Žirniukų;5921553817;Taip;6;0;1;7
7307;Pasaka;Žirniukų;2569560383;Taip;1;0;3;4
7308;Pasaka;"Voveriukų ";3606141216;Taip;5;7;0;12
7309;Pasaka;"Voveriukų ";5217688848;Taip;5;7;0;12
7310;Pasaka;"Voveriukų ";4171004263;Taip;0;1;0;1
7311;Pasaka;"Voveriukų ";8504575043;Taip;5;0;4;9
7312;Pasaka;"Voveriukų ";1488711275;Taip;0;1;0;1
7313;Pasaka;"Voveriukų ";1950145441;Taip;0;0;1;1
7314;Pasaka;"Voveriukų ";4466963221;Taip;0;8;0;8
7315;Pasaka;"Voveriukų ";9588247759;Ne;0;2;3;5
7316;Pasaka;"Voveriukų ";3536862796;Ne;4;1;0;5
7317;Pasaka;"Voveriukų ";8899289832;Ne;7;0;0;7
7318;Pasaka;"Voveriukų ";4915357646;Taip;1;0;4;5
7319;Pasaka;"Voveriukų ";7176272684;Taip;7;4;0;11
7320;Pasaka;"Voveriukų ";4799036184;Taip;0;0;6;6
7321;Pasaka;"Voveriukų ";6684234474;Ne;16;0;0;16
7322;Pasaka;"Voveriukų ";9003508760;Taip;0;1;0;1
7323;Pasaka;"Voveriukų ";6925961600;Ne;0;5;0;5
7324;Pasaka;"Voveriukų ";8421404290;Ne;8;0;0;8
7325;Pasaka;"Voveriukų ";1745181416;Taip;0;5;6;11
7326;Pasaka;"Voveriukų ";9780490338;Taip;14;5;0;19
7327;Pasaka;"Voveriukų ";6315362421;Taip;0;1;1;2
7328;Pasaka;"Voveriukų ";6315362421;Taip;0;1;1;2
7329;Pasaka;"VALDOFRO 12";7010681103;Taip;0;3;0;3
7330;Pasaka;"VALDOFRO 12";56766427323;Taip;0;0;2;2
7331;Pasaka;"VALDOFRO 12";8976424908;Taip;0;0;4;4
7332;Pasaka;"VALDOFRO 12";8701112181;Ne;0;0;2;2
7333;Pasaka;"VALDOFRO 12";1305541319;Taip;0;1;0;1
7334;Pasaka;"VALDOFRO 12";7682903999;Ne;0;0;4;4
7335;Pasaka;"VALDOFRO 12";4325198579;Taip;0;1;5;6
7336;Pasaka;"VALDOFRO 12";6448940090;Taip;0;0;2;2
7337;Pasaka;"VALDOFRO 12";8411025450;Taip;5;4;1;10
7338;Pasaka;"VALDOFRO 12";1756831961;Taip;2;1;0;3
7339;Pasaka;"VALDOFRO 12";3840053722;Ne;0;4;0;4
7340;Pasaka;"VALDOFRO 12";8995205555;Taip;0;0;3;3
7341;Pasaka;"VALDOFRO 12";4548945364;Taip;4;0;1;5
7342;Pasaka;"VALDOFRO 12";8912822936;Taip;0;1;2;3
7343;Pasaka;"VALDOFRO 12";5244582148;Ne;12;0;0;12
7344;Pasaka;"VALDOFRO 12";9809498406;Taip;5;0;1;6
7345;Pasaka;"VALDOFRO 12";5040348350;Taip;0;6;0;6
7346;Pasaka;"VALDORFO 2";71365777764;Taip;4;1;0;5
7347;Pasaka;"VALDORFO 2";77904202630;Taip;0;1;0;1
7348;Pasaka;"VALDORFO 2";4752117533;Taip;0;6;0;6
7349;Pasaka;"VALDORFO 2";7950962252;Taip;0;0;5;5
7350;Pasaka;"VALDORFO 2";8590385693;Taip;0;1;0;1
7351;Pasaka;"VALDORFO 2";4620573687;Taip;0;3;1;4
7352;Pasaka;"VALDORFO 2";9462745431;Taip;0;1;0;1
7353;Pasaka;"VALDORFO 2";5399148997;Taip;0;1;0;1
7354;Pasaka;"VALDORFO 2";1799326151;Taip;0;1;4;5
7355;Pasaka;"VALDORFO 2";2273629510;Taip;0;1;4;5
7356;Pasaka;"VALDORFO 2";5903270845;Taip;0;0;3;3
7357;Pasaka;"VALDORFO 2";3778182691;Taip;0;3;1;4
7358;Pasaka;"VALDORFO 2";5742479853;Taip;0;1;1;2
7359;Pasaka;"VALDORFO 2";3049361712;Taip;3;0;0;3
7360;Pasaka;"VALDORFO 2";6497042042;Taip;0;0;1;1
7361;Pasaka;"VALDORFO 2";9150761761;Taip;5;0;1;6
7362;Pasaka;"VALDORFO 2";9821858308;Taip;0;0;2;2
7363;Pasaka;"VALDORFO 2";1648043715;Taip;0;0;3;3
7364;Pasaka;Gudručiai;4137222204;Taip;7;0;0;7
7365;Pasaka;Gudručiai;7103485358;Taip;0;1;0;1
7366;Pasaka;Gudručiai;7648503006;Taip;1;0;0;1
7367;Pasaka;Gudručiai;2400455036;Taip;0;1;0;1
7368;Pasaka;Gudručiai;9722435751;Taip;2;1;0;3
7369;Pasaka;Gudručiai;73703706115;Taip;0;1;2;3
7370;Pasaka;Gudručiai;79170702319;Taip;1;0;0;1
7371;Pasaka;Gudručiai;5965121999;Taip;0;0;2;2
7372;Pasaka;Gudručiai;7286419663;Taip;0;0;6;6
7373;Pasaka;Gudručiai;5973028582;Taip;0;0;4;4
7374;Pasaka;Gudručiai;2788679885;Taip;0;1;0;1
7375;Pasaka;Gudručiai;7445696309;Taip;0;1;0;1
7376;Pasaka;Gudručiai;1565873178;Taip;0;5;0;5
7377;Pasaka;Gudručiai;2697014098;Taip;0;1;0;1
7378;Pasaka;Gudručiai;5651452381;Taip;10;1;0;11
7379;Pasaka;Gudručiai;6441884677;Taip;5;1;0;6
7380;Pasaka;Gudručiai;2018620389;Taip;5;1;0;6
7381;Pasaka;Gudručiai;2671403814;Taip;0;0;2;2
7382;Pasaka;Gudručiai;42548487389;Taip;0;0;6;6
7383;Pasaka;Gudručiai;8448558788;Taip;0;1;0;1
7384;Pasaka;Bitelių;5351364328;Taip;0;0;13;13
7385;Pasaka;Bitelių;4635912654;Taip;0;0;13;13
7386;Pasaka;Bitelių;7248640367;Ne;0;5;0;5
7387;Pasaka;Bitelių;8277245475;Ne;0;2;2;4
7388;Pasaka;Bitelių;6868519179;Taip;3;0;4;7
7389;Pasaka;Bitelių;6759415053;Taip;5;0;1;6
7390;Pasaka;Bitelių;5723970763;Taip;0;1;1;2
7391;Pasaka;Bitelių;9136521759;Taip;0;1;0;1
7392;Pasaka;Bitelių;9737445077;Taip;0;0;1;1
7393;Pasaka;Bitelių;2638182985;Taip;0;2;0;2
7394;Pasaka;Bitelių;3367346582;Taip;2;2;4;8
7395;Pasaka;Bitelių;3351338617;Taip;0;2;0;2
7396;Pasaka;Bitelių;5371046207;Taip;5;0;1;6
7397;Pasaka;Bitelių;1335408890;Taip;0;1;0;1
7398;Pasaka;Bitelių;6139825302;Taip;0;4;0;4
7399;Pasaka;Bitelių;4970812899;Taip;6;0;1;7
7400;Pasaka;Bitelių;1720511696;Taip;6;0;0;6
7401;Pasaka;"Pabiručių ";4846146925;Taip;0;0;2;2
7402;Pasaka;"Pabiručių ";9770811826;Taip;6;0;0;6
7403;Pasaka;"Pabiručių ";5230621839;Taip;0;1;2;3
7404;Pasaka;"Pabiručių ";9471447977;Ne;0;0;8;8
7405;Pasaka;"Pabiručių ";7751618911;Taip;6;2;0;8
7406;Pasaka;"Pabiručių ";7696383564;Taip;6;0;4;10
7407;Pasaka;"Pabiručių ";3796844193;Taip;4;0;5;9
7408;Pasaka;"Pabiručių ";7240424576;Taip;1;0;0;1
7409;Pasaka;"Pabiručių ";4910817298;Taip;0;0;7;7
7410;Pasaka;"Pabiručių ";7127138831;Taip;4;0;0;4
7411;Pasaka;"Pabiručių ";9813397639;Taip;9;0;0;9
7412;Pasaka;"Pabiručių ";4994426702;Taip;5;0;0;5
7413;Pasaka;"Pabiručių ";8289010515;Taip;5;0;0;5
7414;Pasaka;"Pabiručių ";8558563996;Taip;5;1;0;6
7415;Pasaka;"Pabiručių ";3557547656;Taip;17;0;0;17
7416;Pasaka;Šnekučių;3709664132;Taip;0;1;1;2
7417;Pasaka;Šnekučių;1512874567;Taip;0;1;0;1
7418;Pasaka;Šnekučių;1793176485;Taip;0;3;0;3
7419;Pasaka;Šnekučių;4296539838;Ne;1;0;2;3
7420;Pasaka;Šnekučių;1590306118;Taip;10;1;0;11
7421;Pasaka;Šnekučių;6795580569;Ne;0;0;1;1
7422;Pasaka;Šnekučių;3240292756;Taip;0;2;1;3
7423;Pasaka;Šnekučių;4215568107;Taip;3;3;0;6
7424;Pasaka;Šnekučių;8365256755;Taip;0;1;0;1
7425;Pasaka;Šnekučių;4816441219;Taip;3;0;6;9
7426;Pasaka;Šnekučių;1795497567;Taip;6;0;5;11
7427;Pasaka;Šnekučių;8347051587;Taip;5;3;0;8
7428;Pasaka;Šnekučių;8841669113;Taip;0;0;1;1
7429;Pasaka;Šnekučių;4975045894;Taip;14;0;0;14
7430;Pasaka;Šnekučių;3588073618;Taip;0;0;4;4
7431;Pasaka;Šnekučių;1194745876;Ne;1;0;1;2
7432;Pasaka;Šnekučių;1749821746;Taip;0;1;0;1
7433;Pasaka;Šnekučių;1723076060;Taip;0;1;3;4
7434;Pasaka;Šnekučių;8475365713;Taip;0;0;5;5
7435;Pasaka;Šnekučių;5656511105;Taip;3;0;2;5
7436;Paslaptis;MONTIKI;4683384309;Taip;9;2;0;11
7437;Paslaptis;MONTIKI;9929877115;Ne;10;3;0;13
7438;Paslaptis;MONTIKI;6860366087;Taip;1;0;0;1
7439;Paslaptis;MONTIKI;9445405671;Taip;6;0;4;10
7440;Paslaptis;MONTIKI;3572102816;Taip;14;0;0;14
7441;Paslaptis;MONTIKI;2927014406;Ne;5;1;1;7
7442;Paslaptis;MONTIKI;7053452493;Taip;7;1;0;8
7443;Paslaptis;MONTIKI;8909545951;Taip;8;0;0;8
7444;Paslaptis;MONTIKI;3963816472;Taip;1;8;1;10
7445;Paslaptis;MONTIKI;5809630456;Taip;3;0;0;3
7446;Paslaptis;MONTIKI;6764142182;Taip;11;0;0;11
7447;Paslaptis;MONTIKI;3241323665;Taip;11;0;0;11
7448;Paslaptis;MONTIKI;9299390190;Taip;5;0;0;5
7449;Paslaptis;MONTIKI;9497654214;Taip;10;3;0;13
7450;Paslaptis;MONTIKI;1080710834;Taip;5;0;0;5
7451;Paslaptis;FRUTIKI;9100003209;Ne;13;2;0;15
7452;Paslaptis;FRUTIKI;4130010071;Taip;0;1;0;1
7453;Paslaptis;FRUTIKI;3984799090;Taip;11;1;0;12
7454;Paslaptis;FRUTIKI;5886364670;Taip;15;0;0;15
7455;Paslaptis;FRUTIKI;5406800599;Taip;4;0;2;6
7456;Paslaptis;FRUTIKI;2675089401;Taip;0;1;1;2
7457;Paslaptis;FRUTIKI;1557783684;Taip;9;4;0;13
7458;Paslaptis;FRUTIKI;8895770223;Taip;8;0;0;8
7459;Paslaptis;FRUTIKI;5206529350;Taip;8;3;0;11
7460;Paslaptis;FRUTIKI;2105441745;Taip;8;0;0;8
7461;Paslaptis;FRUTIKI;6686352764;Taip;9;0;2;11
7462;Paslaptis;FRUTIKI;5456011928;Taip;0;6;0;6
7463;Paslaptis;FRUTIKI;8717111488;Taip;9;2;0;11
7464;Paslaptis;FRUTIKI;5756338103;Taip;0;1;0;1
7465;Paslaptis;FRUTIKI;5646806136;Taip;10;1;0;11
7466;Paslaptis;FRUTIKI;6513238386;Taip;4;0;0;4
7467;Paslaptis;FRUTIKI;6098345982;Taip;0;1;0;1
7468;Paslaptis;FRUTIKI;4810686225;Taip;10;1;0;11
7469;Paslaptis;FRUTIKI;8296575784;Ne;14;1;0;15
7470;Paslaptis;FRUTIKI;1754621741;Ne;3;2;0;5
7471;Paslaptis;FRUTIKI;7638521198;Taip;3;1;0;4
7472;Paslaptis;KALAMBURIKI;1029321312;Taip;5;2;0;7
7473;Paslaptis;KALAMBURIKI;3093280943;Taip;0;2;0;2
7474;Paslaptis;KALAMBURIKI;9559318660;Taip;3;1;0;4
7475;Paslaptis;KALAMBURIKI;2879752620;Taip;0;7;0;7
7476;Paslaptis;KALAMBURIKI;8280740387;Taip;0;7;3;10
7477;Paslaptis;KALAMBURIKI;2693910134;Ne;0;2;0;2
7478;Paslaptis;KALAMBURIKI;2891547963;Taip;0;1;0;1
7479;Paslaptis;KALAMBURIKI;3104525540;Ne;9;1;1;11
7480;Paslaptis;KALAMBURIKI;1186681520;Taip;5;0;0;5
7481;Paslaptis;KALAMBURIKI;3415869190;Taip;9;4;0;13
7482;Paslaptis;KALAMBURIKI;1983773762;Taip;0;2;0;2
7483;Paslaptis;KALAMBURIKI;5557019619;Taip;0;2;0;2
7484;Paslaptis;KALAMBURIKI;3549998192;Taip;0;0;4;4
7485;Paslaptis;KALAMBURIKI;1782398974;Taip;5;1;0;6
7486;Paslaptis;KALAMBURIKI;8146824196;Taip;6;0;0;6
7487;Paslaptis;KALAMBURIKI;3398729758;Taip;0;5;0;5
7488;Paslaptis;KALAMBURIKI;8083478190;Taip;0;0;10;10
7489;Paslaptis;KALAMBURIKI;2089780119;Taip;11;7;0;18
7490;Pasakaitė;Vieversėlių;7685647972;Taip;0;1;14;15
7491;Pasakaitė;Vieversėlių;6459145539;Taip;0;3;0;3
7492;Pasakaitė;Vieversėlių;2194313054;Ne;0;11;0;11
7493;Pasakaitė;Vieversėlių;9587489514;Taip;7;0;0;7
7494;Pasakaitė;Vieversėlių;3444442287;Taip;6;0;2;8
7495;Pasakaitė;Vieversėlių;5485965486;Taip;5;0;0;5
7496;Pasakaitė;Vieversėlių;2563725297;Taip;3;0;2;5
7497;Pasakaitė;Vieversėlių;2849753418;Taip;3;0;2;5
7498;Pasakaitė;Vieversėlių;8043493934;Taip;0;1;0;1
7499;Pasakaitė;Vieversėlių;7963057831;Taip;0;1;0;1
7500;Pasakaitė;Vieversėlių;9543991684;Taip;0;5;0;5
7501;Pasakaitė;Vieversėlių;3680596008;Taip;0;1;0;1
7502;Pasakaitė;Vieversėlių;4882856664;Taip;6;0;0;6
7503;Pasakaitė;Vieversėlių;5953162958;Ne;10;0;0;10
7504;Pasakaitė;Vieversėlių;5948958906;Taip;7;1;0;8
7505;Pasakaitė;Vieversėlių;1060914693;Taip;1;1;0;2
7506;Pasakaitė;Vieversėlių;7761162338;Taip;9;4;0;13
7507;Pasakaitė;Vieversėlių;8463220257;Taip;7;1;0;8
7508;Pasakaitė;Vieversėlių;9018830962;Taip;19;2;0;21
7509;Pasakaitė;Vieversėlių;6736879757;Ne;7;0;6;13
7510;Pasakaitė;Vieversėlių;4191875802;Taip;7;0;4;11
7511;Pasakaitė;Vieversėlių;5020801150;Taip;7;0;1;8
7512;Pasakaitė;Spindulėlių;1962693480;Taip;0;0;2;2
7513;Pasakaitė;Spindulėlių;4758073190;Taip;2;0;0;2
7514;Pasakaitė;Spindulėlių;6714500298;Taip;5;5;0;10
7515;Pasakaitė;Spindulėlių;1697755753;Taip;0;2;0;2
7516;Pasakaitė;Spindulėlių;1056358241;Taip;3;3;0;6
7517;Pasakaitė;Spindulėlių;8105641645;Taip;7;0;0;7
7518;Pasakaitė;Spindulėlių;5791927811;Taip;12;19;0;31
7519;Pasakaitė;Spindulėlių;5094404397;Taip;12;19;0;31
7520;Pasakaitė;Spindulėlių;9870015737;Ne;18;0;0;18
7521;Pasakaitė;Spindulėlių;1449037968;Ne;10;4;0;14
7522;Pasakaitė;Spindulėlių;7474100735;Taip;6;4;0;10
7523;Pasakaitė;Spindulėlių;6015360076;Taip;0;20;0;20
7524;Pasakaitė;Spindulėlių;2733800758;Taip;8;0;0;8
7525;Pasakaitė;Spindulėlių;6256000265;Taip;14;0;0;14
7526;Pasakaitė;Spindulėlių;2891089579;Taip;14;0;0;14
7527;Pasakaitė;Spindulėlių;3381303531;Taip;0;0;1;1
7528;Pasakaitė;Spindulėlių;3652896053;Taip;7;0;0;7
7529;Pasakaitė;Spindulėlių;7265623955;Taip;24;0;0;24
7530;Pasakaitė;Spindulėlių;1564611671;Taip;5;1;1;7
7531;Pasakaitė;Spindulėlių;3283593388;Taip;9;0;0;9
7532;Pasakaitė;Spindulėlių;2652882309;Ne;7;4;0;11
7533;Pasakaitė;Spindulėlių;4268438476;Taip;13;0;0;13
7534;Pasakaitė;Pasagėlių;2810892060;Ne;0;0;1;1
7535;Pasakaitė;Pasagėlių;9895144528;Taip;9;0;5;14
7536;Pasakaitė;Pasagėlių;6609127382;Ne;9;0;1;10
7537;Pasakaitė;Pasagėlių;9409907631;Taip;15;1;0;16
7538;Pasakaitė;Pasagėlių;5589440439;Taip;11;0;1;12
7539;Pasakaitė;Pasagėlių;5959875562;Taip;9;0;0;9
7540;Pasakaitė;Pasagėlių;3355268509;Taip;10;2;0;12
7541;Pasakaitė;Pasagėlių;1959599606;Taip;9;4;0;13
7542;Pasakaitė;Pasagėlių;7440327561;Taip;11;1;0;12
7543;Pasakaitė;Pasagėlių;6325408070;Taip;7;0;0;7
7544;Pasakaitė;Pasagėlių;9238905834;Taip;12;2;0;14
7545;Pasakaitė;Pasagėlių;5970146724;Taip;0;21;0;21
7546;Pasakaitė;Pasagėlių;4826492004;Taip;0;3;0;3
7547;Pasakaitė;Pasagėlių;7666033916;Taip;21;0;0;21
7548;Pasakaitė;Pasagėlių;5540251866;Taip;9;0;0;9
7549;Pasakaitė;Pasagėlių;7219080600;Ne;9;2;0;11
7550;Pasakaitė;Pasagėlių;8264189678;Taip;8;0;0;8
7551;Pasakaitė;Pasagėlių;2341175137;Taip;16;1;0;17
7552;Pasakaitė;Pasagėlių;8905681529;Taip;10;1;0;11
7553;Pasakaitė;Pasagėlių;8165055476;Taip;9;1;1;11
7554;Pasakaitė;Pasagėlių;7360801624;Taip;10;1;0;11
7555;Pasakaitė;Pasagėlių;5617173998;Taip;10;0;0;10
7556;Pasakaitė;Pasagėlių;5034077389;Taip;10;1;2;13
7557;Pasakaitė;Švyturėlių;7702359586;Taip;0;1;0;1
7558;Pasakaitė;Švyturėlių;2721048424;Taip;3;8;0;11
7559;Pasakaitė;Švyturėlių;1278198989;Taip;15;0;3;18
7560;Pasakaitė;Švyturėlių;6847782430;Taip;10;1;0;11
7561;Pasakaitė;Švyturėlių;1533259056;Taip;0;0;2;2
7562;Pasakaitė;Švyturėlių;4728731352;Taip;0;0;2;2
7563;Pasakaitė;Švyturėlių;2404448954;Taip;5;0;1;6
7564;Pasakaitė;Švyturėlių;9821617981;Taip;0;0;7;7
7565;Pasakaitė;Švyturėlių;1619513932;Taip;0;1;0;1
7566;Pasakaitė;Švyturėlių;1184513606;Taip;0;0;3;3
7567;Pasakaitė;Švyturėlių;2751828639;Taip;0;1;0;1
7568;Pasakaitė;Švyturėlių;4864779439;Ne;0;5;0;5
7569;Pasakaitė;Švyturėlių;8223662339;Taip;15;1;0;16
7570;Pasakaitė;Švyturėlių;3710143250;Taip;0;0;1;1
7571;Pasakaitė;Švyturėlių;2329827275;Taip;0;0;7;7
7572;Pasakaitė;Švyturėlių;2933474317;Taip;12;1;0;13
7573;Pasakaitė;Švyturėlių;5498393070;Ne;0;0;5;5
7574;Pasakaitė;Švyturėlių;9012098645;Ne;0;0;2;2
7575;Pasakaitė;Švyturėlių;4604843442;Taip;0;3;0;3
7576;Pasakaitė;Švyturėlių;3417077517;Taip;0;0;2;2
7577;Pasakaitė;Švyturėlių;1793453325;Taip;7;1;0;8
7578;Pasakaitė;Švyturėlių;1384552110;Ne;0;0;1;1
7579;Pasakaitė;Švyturėlių;4694818333;Taip;0;0;2;2
7580;Pasakaitė;Kodėlčiukų;8662488739;Taip;9;0;1;10
7581;Pasakaitė;Kodėlčiukų;9972985920;Taip;4;0;0;4
7582;Pasakaitė;Kodėlčiukų;5699688792;Taip;21;0;0;21
7583;Pasakaitė;Kodėlčiukų;9441990175;Taip;0;0;6;6
7584;Pasakaitė;Kodėlčiukų;4485053261;Taip;0;1;0;1
7585;Pasakaitė;Kodėlčiukų;9351971114;Taip;4;0;1;5
7586;Pasakaitė;Kodėlčiukų;2303884875;Taip;6;0;0;6
7587;Pasakaitė;Kodėlčiukų;9543262464;Taip;2;0;0;2
7588;Pasakaitė;Kodėlčiukų;4878562841;Taip;0;0;4;4
7589;Pasakaitė;Kodėlčiukų;2994653871;Taip;10;0;0;10
7590;Pasakaitė;Kodėlčiukų;4328440534;Taip;7;0;0;7
7591;Pasakaitė;Kodėlčiukų;4881361200;Ne;8;0;2;10
7592;Pasakaitė;Kodėlčiukų;2389832646;Taip;4;1;1;6
7593;Pasakaitė;Kodėlčiukų;7138417196;Taip;6;0;0;6
7594;Pasakaitė;Kodėlčiukų;5581264184;Taip;1;6;0;7
7595;Pasakaitė;Kodėlčiukų;8037316673;Ne;3;0;0;3
7596;Pasakaitė;Kodėlčiukų;5732009054;Taip;5;3;0;8
7597;Pasakaitė;Kodėlčiukų;2407824666;Taip;0;1;5;6
7598;Pasakaitė;Kodėlčiukų;6755983130;Taip;11;0;6;17
7599;Pasakaitė;Kodėlčiukų;2476010561;Taip;6;5;1;12
7600;Pasakaitė;Kodėlčiukų;3925034196;Taip;6;5;1;12
7601;Pasakaitė;Gudručių;6568538767;Ne;8;2;0;10
7602;Pasakaitė;Gudručių;1523034176;Taip;0;1;0;1
7603;Pasakaitė;Gudručių;5369558652;Taip;8;1;0;9
7604;Pasakaitė;Gudručių;1019010454;Taip;0;1;4;5
7605;Pasakaitė;Gudručių;1707428977;Taip;4;1;5;10
7606;Pasakaitė;Gudručių;9680682204;Taip;0;1;0;1
7607;Pasakaitė;Gudručių;3345955615;Taip;8;0;0;8
7608;Pasakaitė;Gudručių;1791015854;Taip;0;8;1;9
7609;Pasakaitė;Gudručių;39853246609;Taip;6;1;0;7
7610;Pasakaitė;Gudručių;67374677045;Taip;6;0;0;6
7611;Pasakaitė;Gudručių;4959175420;Taip;8;2;0;10
7612;Pasakaitė;Gudručių;6839399035;Taip;0;1;1;2
7613;Pasakaitė;Gudručių;3778906698;Taip;0;1;1;2
7614;Pasakaitė;Gudručių;1940545723;Taip;0;3;0;3
7615;Pasakaitė;Gudručių;9506178305;Taip;10;0;0;10
7616;Pasakaitė;Gudručių;1809383469;Taip;5;1;0;6
7617;Pasakaitė;Gudručių;4008826950;Taip;1;10;0;11
7618;Pasakaitė;Gudručių;9031690002;Taip;0;1;5;6
7619;Pasakaitė;Gudručių;2742595829;Taip;8;1;0;9
7620;Pasakaitė;Gudručių;1513903341;Taip;5;6;0;11
7621;Pasakaitė;Gudručių;8390366303;Taip;4;1;0;5
7622;Pasakaitė;Gudručių;3231283338;Taip;0;1;0;1
7623;Pasakaitė;Čiulbonėlių;4680949976;Taip;7;10;0;17
7624;Pasakaitė;Čiulbonėlių;7152349570;Taip;0;10;0;10
7625;Pasakaitė;Čiulbonėlių;1458338379;Taip;20;0;0;20
7626;Pasakaitė;Čiulbonėlių;7526264241;Taip;0;1;1;2
7627;Pasakaitė;Čiulbonėlių;3541877287;Taip;0;1;3;4
7628;Pasakaitė;Čiulbonėlių;4974486850;Ne;4;1;1;6
7629;Pasakaitė;Čiulbonėlių;7607522887;Taip;14;0;0;14
7630;Pasakaitė;Čiulbonėlių;3606601644;Taip;0;10;0;10
7631;Pasakaitė;Čiulbonėlių;5313360864;Taip;9;0;0;9
7632;Pasakaitė;Čiulbonėlių;3579498202;Taip;12;1;0;13
7633;Pasakaitė;Čiulbonėlių;1220619991;Taip;8;0;0;8
7634;Pasakaitė;Čiulbonėlių;7790937149;Taip;20;1;0;21
7635;Pasakaitė;Čiulbonėlių;3400305768;Taip;20;1;0;21
7636;Pasakaitė;Čiulbonėlių;3165658822;Taip;7;3;0;10
7637;Pasakaitė;Čiulbonėlių;83018133588;Taip;0;2;0;2
7638;Pasakaitė;Čiulbonėlių;4013900094;Taip;0;1;0;1
7639;Pasakaitė;Čiulbonėlių;5605619860;Taip;0;1;0;1
7640;Pasakaitė;Čiulbonėlių;61230317080;Ne;0;7;0;7
7641;Pasakaitė;Čiulbonėlių;8466086339;Taip;0;4;0;4
7642;Pasakaitė;Čiulbonėlių;5467179333;Taip;7;1;0;8
7643;Pasakaitė;Čiulbonėlių;1740419218;Taip;0;9;0;9
7644;Pasakaitė;Čiulbonėlių;8469043564;Taip;10;1;3;14
7645;Pasakaitė;"Verpstelių ";7621306769;Taip;9;4;0;13
7646;Pasakaitė;"Verpstelių ";4946855684;Taip;10;10;0;20
7647;Pasakaitė;"Verpstelių ";5556362727;Ne;3;0;3;6
7648;Pasakaitė;"Verpstelių ";7451624229;Ne;7;0;0;7
7649;Pasakaitė;"Verpstelių ";7759051761;Taip;9;1;0;10
7650;Pasakaitė;"Verpstelių ";8315840473;Taip;10;5;0;15
7651;Pasakaitė;"Verpstelių ";1744216870;Taip;8;4;0;12
7652;Pasakaitė;"Verpstelių ";1425166722;Taip;15;0;3;18
7653;Pasakaitė;"Verpstelių ";7813221735;Taip;15;0;2;17
7654;Pasakaitė;"Verpstelių ";9166649594;Taip;4;1;0;5
7655;Pasakaitė;"Verpstelių ";4246461594;Taip;10;0;9;19
7656;Pasakaitė;"Verpstelių ";1963102227;Taip;15;0;2;17
7657;Pasakaitė;"Verpstelių ";8267725352;Taip;14;0;0;14
7658;Pasakaitė;"Verpstelių ";5866092980;Taip;2;0;2;4
7659;Pasakaitė;"Verpstelių ";8562284745;Taip;17;1;0;18
7660;Pasakaitė;"Verpstelių ";1041405418;Taip;9;7;0;16
7661;Pasakaitė;"Verpstelių ";7976921380;Taip;7;1;0;8
7662;Pasakaitė;"Verpstelių ";2505815026;Taip;10;0;10;20
7663;Pasakaitė;"Verpstelių ";5413457806;Taip;10;2;0;12
7664;Pasakaitė;"Verpstelių ";1115383380;Taip;11;0;0;11
7665;Pasakaitė;"Verpstelių ";2714905466;Taip;3;0;1;4
7666;Pasakaitė;"Verpstelių ";9226989209;Taip;10;0;0;10
7667;Pasakaitė;"Verpstelių ";8927014508;Taip;10;0;1;11
7668;Pasakaitė;Smalsučiai;7539851375;Taip;7;0;0;7
7669;Pasakaitė;Smalsučiai;2278658674;Taip;17;0;0;17
7670;Pasakaitė;Smalsučiai;7557414266;Taip;12;1;0;13
7671;Pasakaitė;Smalsučiai;6522727154;Taip;13;3;0;16
7672;Pasakaitė;Smalsučiai;1122248122;Taip;0;0;12;12
7673;Pasakaitė;Smalsučiai;9982451343;Taip;1;4;3;8
7674;Pasakaitė;Smalsučiai;4977052991;Taip;1;0;1;2
7675;Pasakaitė;Smalsučiai;7604996145;Taip;17;0;0;17
7676;Pasakaitė;Smalsučiai;4144569088;Taip;0;0;4;4
7677;Pasakaitė;Smalsučiai;4307883488;Taip;0;15;0;15
7678;Pasakaitė;Smalsučiai;2546550685;Taip;0;1;0;1
7679;Pasakaitė;Smalsučiai;5115067331;Ne;0;10;0;10
7680;Pasakaitė;Smalsučiai;7994712153;Taip;10;0;2;12
7681;Pasakaitė;"Čiauškučiai ";7399335037;Taip;9;1;0;10
7682;Pasakaitė;"Čiauškučiai ";4098119950;Taip;5;4;0;9
7683;Pasakaitė;"Čiauškučiai ";9512782063;Taip;9;4;0;13
7684;Pasakaitė;"Čiauškučiai ";5279719152;Taip;0;3;0;3
7685;Pasakaitė;"Čiauškučiai ";6160327808;Taip;10;0;1;11
7686;Pasakaitė;"Čiauškučiai ";1705913604;Taip;12;0;0;12
7687;Pasakaitė;"Čiauškučiai ";3691817711;Taip;14;4;0;18
7688;Pasakaitė;"Čiauškučiai ";3659371923;Taip;0;0;1;1
7689;Pasakaitė;"Čiauškučiai ";7885958426;Taip;12;0;0;12
7690;Pasakaitė;"Čiauškučiai ";2902368705;Taip;0;13;0;13
7691;Pasakaitė;"Čiauškučiai ";2041179927;Taip;0;0;1;1
7692;Pasakaitė;"Čiauškučiai ";6745120294;Taip;6;0;0;6
7693;Pasakaitė;Pabiručiai;5180059311;Taip;7;19;0;26
7694;Pasakaitė;Pabiručiai;5162170061;Taip;5;0;1;6
7695;Pasakaitė;Pabiručiai;8478538959;Taip;5;0;2;7
7696;Pasakaitė;Pabiručiai;6795204239;Taip;10;0;0;10
7697;Pasakaitė;Pabiručiai;5058070480;Taip;24;0;0;24
7698;Pasakaitė;Pabiručiai;1453976284;Ne;16;0;6;22
7699;Pasakaitė;Pabiručiai;8559244062;Ne;14;0;0;14
7700;Pasakaitė;Pabiručiai;9790988677;Taip;0;20;6;26
7701;Pasakaitė;Pabiručiai;5439936572;Taip;10;10;6;26
7702;Pasakaitė;Pabiručiai;4316883215;Taip;15;0;0;15
7703;Pasakaitė;Pabiručiai;6682010485;Taip;11;0;0;11
7704;Pasakaitė;Pabiručiai;3466308130;Taip;21;0;3;24
7705;Pasakaitė;Pabiručiai;9402238675;Taip;18;0;0;18
7706;Pasakaitė;Pabiručiai;9311649698;Taip;2;1;0;3
7707;Pasakaitė;Pabiručiai;5499373802;Taip;13;0;0;13
7708;Pasakaitė;Linksmučiai;7965916747;Taip;15;0;0;15
7709;Pasakaitė;Linksmučiai;1279728451;Taip;5;0;0;5
7710;Pasakaitė;Linksmučiai;2584717150;Taip;7;0;1;8
7711;Pasakaitė;Linksmučiai;4397797616;Taip;16;0;1;17
7712;Pasakaitė;Linksmučiai;4659277297;Taip;7;0;2;9
7713;Pasakaitė;Linksmučiai;8381083251;Taip;0;0;2;2
7714;Pasakaitė;Linksmučiai;8252123824;Taip;17;0;0;17
7715;Pasakaitė;Linksmučiai;4444725869;Ne;1;0;20;21
7716;Pasakaitė;Linksmučiai;2801785334;Taip;13;0;1;14
7717;Pasakaitė;Linksmučiai;4369400507;Ne;18;0;0;18
7718;Pasakaitė;Linksmučiai;2899659479;Taip;7;1;0;8
7719;Pasakaitė;Linksmučiai;8160163060;Taip;10;0;0;10
7720;Pasakaitė;Linksmučiai;8350808883;Taip;0;0;5;5
7721;Pasakaitė;Linksmučiai;5745073940;Taip;9;0;4;13
7722;Pelenė;Varpelis;2647876561;Taip;0;1;0;1
7723;Pelenė;Varpelis;8807342148;Taip;6;0;0;6
7724;Pelenė;Varpelis;8239650471;Taip;0;0;1;1
7725;Pelenė;Varpelis;4004975235;Taip;1;0;1;2
7726;Pelenė;Varpelis;8790613872;Taip;1;0;1;2
7727;Pelenė;Varpelis;2487632125;Taip;7;0;1;8
7728;Pelenė;Varpelis;5228983908;Taip;5;1;0;6
7729;Pelenė;Varpelis;6524101295;Taip;3;1;0;4
7730;Pelenė;Varpelis;4373886054;Taip;14;0;0;14
7731;Pelenė;Varpelis;8038559319;Taip;0;1;0;1
7732;Pelenė;Varpelis;7578318198;Taip;11;0;0;11
7733;Pelenė;Varpelis;4376033711;Taip;0;1;0;1
7734;Pelenė;Varpelis;1080017906;Taip;1;0;0;1
7735;Pelenė;Varpelis;4777496709;Taip;0;0;2;2
7736;Pelenė;Varpelis;9447223913;Taip;0;0;9;9
7737;Pelenė;Varpelis;6894978459;Taip;19;1;0;20
7738;Pelenė;Varpelis;4321705575;Taip;0;10;0;10
7739;Pelenė;Varpelis;2103177773;Taip;10;0;0;10
7740;Pelenė;Varpelis;6864263698;Taip;17;0;0;17
7741;Pelenė;Varpelis;4521556853;Ne;3;0;1;4
7742;Pelenė;Saulutės;7880284433;Taip;0;2;0;2
7743;Pelenė;Saulutės;2737277656;Taip;0;6;0;6
7744;Pelenė;Saulutės;1775717256;Taip;0;1;1;2
7745;Pelenė;Saulutės;4315677064;Taip;0;0;2;2
7746;Pelenė;Saulutės;7587887488;Taip;0;2;0;2
7747;Pelenė;Saulutės;5389865440;Taip;5;1;0;6
7748;Pelenė;Saulutės;8716395810;Taip;0;2;0;2
7749;Pelenė;Saulutės;6191899254;Ne;0;0;3;3
7750;Pelenė;Saulutės;6481466282;Taip;4;0;1;5
7751;Pelenė;Saulutės;6707167720;Taip;0;1;0;1
7752;Pelenė;Saulutės;8466974910;Taip;0;3;0;3
7753;Pelenė;Saulutės;2393964666;Ne;0;0;3;3
7754;Pelenė;Saulutės;5780697554;Taip;0;3;0;3
7755;Pelenė;Saulutės;4989239822;Taip;0;0;1;1
7756;Pelenė;Saulutės;1278011268;Taip;0;1;0;1
7757;Pelenė;Saulutės;2426412323;Taip;0;0;1;1
7758;Pelenė;Saulutės;6267178572;Taip;6;3;0;9
7759;Pelenė;Raktelis;9195113444;Taip;1;4;0;5
7760;Pelenė;Raktelis;9075193730;Taip;5;0;1;6
7761;Pelenė;Raktelis;4591637887;Taip;0;3;0;3
7762;Pelenė;Raktelis;7088493729;Taip;5;0;0;5
7763;Pelenė;Raktelis;4090532624;Ne;10;2;0;12
7764;Pelenė;Raktelis;8123162647;Taip;0;5;0;5
7765;Pelenė;Raktelis;3573543545;Taip;0;7;0;7
7766;Pelenė;Raktelis;7659625628;Taip;0;0;2;2
7767;Pelenė;Raktelis;6375060159;Taip;6;11;0;17
7768;Pelenė;Raktelis;2210314952;Taip;0;2;0;2
7769;Pelenė;Raktelis;6419661741;Taip;5;2;0;7
7770;Pelenė;Raktelis;4089199552;Taip;5;1;2;8
7771;Pelenė;Raktelis;6038229659;Taip;0;1;2;3
7772;Pelenė;Raktelis;1060619471;Taip;5;0;0;5
7773;Pelenė;Raktelis;5749399210;Taip;6;1;0;7
7774;Pelenė;Raktelis;4448592497;Taip;1;0;0;1
7775;Pelenė;Raktelis;5333802902;Taip;4;6;0;10
7776;Pelenė;Raktelis;8517226350;Taip;0;1;3;4
7777;Pelenė;Raktelis;1049199372;Taip;0;2;0;2
7778;Pelenė;Raktelis;2241816838;Taip;3;0;0;3
7779;Pelenė;Raktelis;5063098703;Taip;0;0;3;3
7780;Pelenė;Žvaigždutės;9473901831;Taip;0;1;2;3
7781;Pelenė;Žvaigždutės;2476080951;Taip;0;0;1;1
7782;Pelenė;Žvaigždutės;5548367924;Taip;10;0;2;12
7783;Pelenė;Žvaigždutės;5031778158;Taip;0;10;0;10
7784;Pelenė;Žvaigždutės;4056676361;Taip;0;4;1;5
7785;Pelenė;Žvaigždutės;6014571367;Ne;0;4;0;4
7786;Pelenė;Žvaigždutės;4602503400;Taip;0;0;2;2
7787;Pelenė;Žvaigždutės;2555464779;Taip;4;2;0;6
7788;Pelenė;Žvaigždutės;9530531472;Ne;0;3;0;3
7789;Pelenė;Žvaigždutės;2040256240;Taip;6;0;2;8
7790;Pelenė;Žvaigždutės;4870187198;Taip;0;1;0;1
7791;Pelenė;Žvaigždutės;7640768043;Taip;21;0;0;21
7792;Pelenė;Žvaigždutės;7614130590;Taip;5;0;2;7
7793;Pelenė;Žvaigždutės;5894429453;Taip;1;0;2;3
7794;Pelenė;Nykštukas;4541391191;Taip;0;1;4;5
7795;Pelenė;Nykštukas;9584503078;Ne;0;1;3;4
7796;Pelenė;Nykštukas;8770771520;Ne;2;1;0;3
7797;Pelenė;Nykštukas;10457480694;Taip;6;1;0;7
7798;Pelenė;Nykštukas;6579504852;Taip;0;11;0;11
7799;Pelenė;Nykštukas;6021833025;Taip;0;2;0;2
7800;Pelenė;Nykštukas;1978481168;Taip;0;3;0;3
7801;Pelenė;Nykštukas;3596386480;Taip;0;6;0;6
7802;Pelenė;Nykštukas;7205437280;Taip;0;1;0;1
7803;Pelenė;Nykštukas;3385568839;Ne;1;0;0;1
7804;Pelenė;Nykštukas;7589978427;Taip;0;9;0;9
7805;Pelenė;Nykštukas;3189305906;Taip;7;0;0;7
7806;Pelenė;Nykštukas;1750366978;Taip;0;0;2;2
7807;Pelenė;Nykštukas;2092775878;Taip;0;2;0;2
7808;Pelenė;Nykštukas;8675348688;Taip;0;1;0;1
7809;Pelenė;Nykštukas;1142014148;Ne;0;1;0;1
7810;Pelenė;Nykštukas;1605794833;Taip;0;3;0;3
7811;Pelenė;Nykštukas;9063588699;Taip;5;5;0;10
7812;Pelenė;Nykštukas;9621197758;Taip;0;1;0;1
7813;Pelenė;Nykštukas;3296147024;Taip;0;7;0;7
7814;Pelenė;Žirniukai;8529178313;Taip;0;0;4;4
7815;Pelenė;Žirniukai;6046921077;Taip;0;0;3;3
7816;Pelenė;Žirniukai;9601582419;Taip;13;1;0;14
7817;Pelenė;Žirniukai;7057752202;Taip;6;0;0;6
7818;Pelenė;Žirniukai;7399112026;Taip;0;0;3;3
7819;Pelenė;Žirniukai;2443906444;Ne;6;0;0;6
7820;Pelenė;Žirniukai;5922348478;Taip;12;0;0;12
7821;Pelenė;Žirniukai;1313425695;Taip;6;1;1;8
7822;Pelenė;Žirniukai;5211115955;Taip;3;0;0;3
7823;Pelenė;Žirniukai;1595627222;Taip;0;9;0;9
7824;Pelenė;Žirniukai;2438266396;Taip;0;6;0;6
7825;Pelenė;Žirniukai;2590035984;Taip;15;0;0;15
7826;Pelenė;Žirniukai;3863839750;Taip;0;1;0;1
7827;Pelenė;Žirniukai;5686182866;Ne;7;6;3;16
7828;Pelenė;Žirniukai;7383544475;Taip;0;11;0;11
7829;Pelenė;Žirniukai;2270989478;Taip;0;21;0;21
7830;Pelenė;Žirniukai;8617997163;Taip;14;0;0;14
7831;Pelenė;Žirniukai;7959433937;Taip;5;0;0;5
7832;Pelenė;Žirniukai;4703442187;Ne;0;0;4;4
7833;Pelenė;Lašeliai;7017031073;Taip;4;1;0;5
7834;Pelenė;Lašeliai;9018211726;Taip;6;1;0;7
7835;Pelenė;Lašeliai;9313153383;Taip;0;2;0;2
7836;Pelenė;Lašeliai;5836118223;Taip;6;0;0;6
7837;Pelenė;Lašeliai;6316640679;Taip;0;1;13;14
7838;Pelenė;Lašeliai;1711603372;Taip;0;9;0;9
7839;Pelenė;Lašeliai;1944933777;Taip;10;5;0;15
7840;Pelenė;Lašeliai;2303618074;Taip;0;0;5;5
7841;Pelenė;Lašeliai;6167965418;Taip;4;0;0;4
7842;Pelenė;Lašeliai;2765650058;Taip;0;10;0;10
7843;Pelenė;Lašeliai;8841183816;Taip;5;0;1;6
7844;Pelenė;Lašeliai;4431474395;Taip;0;1;0;1
7845;Pelenė;Lašeliai;9097123374;Taip;8;0;0;8
7846;Pelenė;Lašeliai;9162252512;Taip;0;1;6;7
7847;Pelenė;Lašeliai;4695104609;Taip;0;10;0;10
7848;Pelenė;Lašeliai;7148956863;Taip;0;6;0;6
7849;Pelenė;Lašeliai;4148108151;Taip;0;2;0;2
7850;Pelenė;Lašeliai;1303066945;Taip;7;0;0;7
7851;Pelenė;Lašeliai;3563882751;Ne;0;6;0;6
7852;Pelenė;Grūdelis;4624325473;Ne;0;6;0;6
7853;Pelenė;Grūdelis;1868951268;Taip;0;1;0;1
7854;Pelenė;Grūdelis;1902314385;Taip;0;1;2;3
7855;Pelenė;Grūdelis;1140030742;Taip;0;2;0;2
7856;Pelenė;Grūdelis;1336431888;Ne;6;1;1;8
7857;Pelenė;Grūdelis;6632188229;Taip;0;11;0;11
7858;Pelenė;Grūdelis;5356756237;Taip;5;1;5;11
7859;Pelenė;Grūdelis;39705461573;Ne;0;2;0;2
7860;Pelenė;Grūdelis;1781704945;Taip;2;1;0;3
7861;Pelenė;Grūdelis;2154553741;Taip;0;1;0;1
7862;Pelenė;Grūdelis;3497915398;Taip;0;1;0;1
7863;Pelenė;Grūdelis;8598498275;Taip;0;3;0;3
7864;Pelenė;Grūdelis;8404317146;Taip;0;1;2;3
7865;Pelenė;Grūdelis;4307283949;Taip;0;1;1;2
7866;Pelenė;Grūdelis;9009271610;Ne;0;12;0;12
7867;Pelenė;Grūdelis;1710249888;Taip;0;1;0;1
7868;Pelenė;Grūdelis;5325176433;Taip;0;8;0;8
7869;Pelenė;Grūdelis;1245955282;Taip;0;3;0;3
7870;Pelenė;Braškytė;7602432318;Taip;0;4;0;4
7871;Pelenė;Braškytė;2689903631;Taip;15;2;0;17
7872;Pelenė;Braškytė;4982869687;Taip;0;0;1;1
7873;Pelenė;Braškytė;3499827987;Taip;2;0;0;2
7874;Pelenė;Braškytė;8165766331;Taip;11;1;0;12
7875;Pelenė;Braškytė;1384382692;Taip;0;1;9;10
7876;Pelenė;Braškytė;5944620142;Ne;0;0;1;1
7877;Pelenė;Braškytė;4734502322;Taip;1;0;9;10
7878;Pelenė;Braškytė;8504675439;Taip;3;0;0;3
7879;Pelenė;Braškytė;2407328091;Taip;0;4;0;4
7880;Pelenė;Braškytė;8861981715;Taip;0;1;3;4
7881;Pelenė;Braškytė;6306403720;Taip;21;0;0;21
7882;Pelenė;Braškytė;9490816122;Taip;9;0;0;9
7883;Pelenė;Braškytė;2096373376;Taip;0;8;0;8
7884;Pelenė;Boružėlės;4961852594;Taip;8;0;1;9
7885;Pelenė;Boružėlės;1975574464;Taip;15;0;0;15
7886;Pelenė;Boružėlės;3549088727;Taip;0;0;2;2
7887;Pelenė;Boružėlės;5024793693;Taip;0;1;1;2
7888;Pelenė;Boružėlės;6567413229;Ne;0;0;2;2
7889;Pelenė;Boružėlės;6231387335;Taip;0;20;0;20
7890;Pelenė;Boružėlės;4068236246;Taip;0;5;0;5
7891;Pelenė;Boružėlės;3700618977;Taip;11;0;0;11
7892;Pelenė;Boružėlės;5872711862;Taip;0;1;0;1
7893;Pelenė;Boružėlės;6081335781;Taip;3;5;0;8
7894;Pelenė;Boružėlės;3060502977;Taip;3;0;1;4
7895;Pelenė;Boružėlės;2083848693;Taip;2;0;1;3
7896;Pelenė;Boružėlės;1268615831;Ne;0;0;1;1
7897;Pelenė;Boružėlės;4396011355;Taip;5;0;1;6
7898;Pelenė;Boružėlės;6304818782;Taip;6;1;0;7
7899;Pelenė;Boružėlės;8718308575;Taip;0;21;0;21
7900;Pelenė;Boružėlės;5743530682;Ne;0;0;1;1
7901;Pelenė;Saldainiukai;5028095861;Ne;10;0;1;11
7902;Pelenė;Saldainiukai;8202196292;Taip;0;5;0;5
7903;Pelenė;Saldainiukai;5066227318;Taip;8;0;2;10
7904;Pelenė;Saldainiukai;7926586349;Taip;0;0;1;1
7905;Pelenė;Saldainiukai;4305733824;Taip;0;0;1;1
7906;Pelenė;Saldainiukai;2986690431;Taip;0;0;1;1
7907;Pelenė;Saldainiukai;4051874126;Taip;0;2;0;2
7908;Pelenė;Saldainiukai;4660385383;Taip;5;0;3;8
7909;Pelenė;Saldainiukai;8862429244;Taip;0;0;4;4
7910;Pelenė;Saldainiukai;9969975097;Ne;6;0;0;6
7911;Pelenė;Saldainiukai;5762403752;Taip;0;6;0;6
7912;Pelenė;Saldainiukai;5926700157;Taip;1;0;1;2
7913;Pelenė;Saldainiukai;8961082265;Taip;0;2;0;2
7914;Pelenė;Saldainiukai;2882716674;Taip;0;4;2;6
7915;Pelenė;Saldainiukai;4859437855;Taip;0;0;17;17
7916;Pelenė;Saldainiukai;4023923887;Taip;5;0;0;5
7917;Pelenė;Drugeliai;2540405047;Taip;13;0;2;15
7918;Pelenė;Drugeliai;3603352172;Taip;0;0;2;2
7919;Pelenė;Drugeliai;5084452088;Ne;0;1;0;1
7920;Pelenė;Drugeliai;9218868317;Taip;0;0;1;1
7921;Pelenė;Drugeliai;2628676128;Taip;10;0;0;10
7922;Pelenė;Drugeliai;6834792589;Taip;0;1;0;1
7923;Pelenė;Drugeliai;9810123679;Taip;0;2;0;2
7924;Pelenė;Drugeliai;3327213856;Taip;12;1;0;13
7925;Pelenė;Drugeliai;6252972353;Taip;11;0;0;11
7926;Pelenė;Drugeliai;1584256570;Taip;8;0;0;8
7927;Pelenė;Drugeliai;5631629419;Ne;9;5;0;14
7928;Pelenė;Drugeliai;2163737781;Taip;3;14;0;17
7929;Pelenė;Drugeliai;9004080625;Ne;0;0;7;7
7930;Pelenė;Drugeliai;7565331966;Taip;5;16;0;21
7931;Pelenė;Drugeliai;5074054534;Taip;0;4;0;4
7932;Pelenė;Drugeliai;8194354176;Ne;5;0;1;6
7933;Pelenė;Drugeliai;5579900958;Taip;12;0;1;13
7934;Pipiras;EŽIUKAI;1876870081;Taip;11;1;0;12
7935;Pipiras;EŽIUKAI;9275905384;Taip;1;2;0;3
7936;Pipiras;EŽIUKAI;41585818819;Taip;0;1;0;1
7937;Pipiras;EŽIUKAI;6153579332;Taip;6;1;1;8
7938;Pipiras;EŽIUKAI;1391958633;Taip;0;1;0;1
7939;Pipiras;EŽIUKAI;5637557921;Taip;0;6;0;6
7940;Pipiras;EŽIUKAI;7799786844;Taip;2;2;0;4
7941;Pipiras;EŽIUKAI;5014457985;Taip;0;3;0;3
7942;Pipiras;EŽIUKAI;1050430252;Ne;0;2;0;2
7943;Pipiras;EŽIUKAI;4927845000;Taip;2;1;0;3
7944;Pipiras;EŽIUKAI;1904376366;Taip;0;2;0;2
7945;Pipiras;EŽIUKAI;3008358842;Ne;2;0;0;2
7946;Pipiras;EŽIUKAI;2024777430;Taip;0;8;0;8
7947;Pipiras;EŽIUKAI;2402351134;Taip;5;1;2;8
7948;Pipiras;EŽIUKAI;2255644686;Taip;0;1;16;17
7949;Pipiras;EŽIUKAI;7736031786;Taip;6;1;3;10
7950;Pipiras;EŽIUKAI;4959823035;Taip;0;2;0;2
7951;Pipiras;EŽIUKAI;1128674099;Taip;0;4;0;4
7952;Pipiras;EŽIUKAI;6339186940;Taip;0;1;0;1
7953;Pipiras;EŽIUKAI;3422170541;Taip;0;3;0;3
7954;Pipiras;EŽIUKAI;3314276870;Taip;10;1;0;11
7955;Pipiras;EŽIUKAI;7784343130;Taip;3;2;5;10
7956;Pipiras;BITUTĖS;3851239592;Taip;11;0;0;11
7957;Pipiras;BITUTĖS;1645482584;Taip;0;1;0;1
7958;Pipiras;BITUTĖS;7891664385;Taip;15;0;0;15
7959;Pipiras;BITUTĖS;9050423801;Taip;6;3;0;9
7960;Pipiras;BITUTĖS;3794537946;Taip;10;0;0;10
7961;Pipiras;BITUTĖS;5047070127;Taip;3;0;4;7
7962;Pipiras;BITUTĖS;2645772675;Taip;6;1;0;7
7963;Pipiras;BITUTĖS;9394456452;Taip;21;0;0;21
7964;Pipiras;BITUTĖS;9610070604;Taip;5;4;0;9
7965;Pipiras;BITUTĖS;7009194986;Taip;4;2;0;6
7966;Pipiras;BITUTĖS;6362968454;Taip;0;10;0;10
7967;Pipiras;BITUTĖS;6273958740;Taip;15;0;0;15
7968;Pipiras;BITUTĖS;2887703782;Ne;8;2;0;10
7969;Pipiras;BITUTĖS;9950318827;Taip;5;0;0;5
7970;Pipiras;NYKŠTUKAI;6696824728;Ne;3;2;0;5
7971;Pipiras;NYKŠTUKAI;2016718354;Taip;3;0;0;3
7972;Pipiras;NYKŠTUKAI;1169481984;Taip;6;0;0;6
7973;Pipiras;NYKŠTUKAI;4198534687;Taip;6;1;0;7
7974;Pipiras;NYKŠTUKAI;4458730479;Taip;11;6;0;17
7975;Pipiras;NYKŠTUKAI;4510888337;Taip;5;10;0;15
7976;Pipiras;NYKŠTUKAI;3980950261;Taip;2;1;0;3
7977;Pipiras;NYKŠTUKAI;6775489564;Taip;6;0;6;12
7978;Pipiras;NYKŠTUKAI;8689174023;Taip;5;2;0;7
7979;Pipiras;NYKŠTUKAI;7747049622;Taip;10;1;0;11
7980;Pipiras;NYKŠTUKAI;9892201598;Taip;0;17;4;21
7981;Pipiras;NYKŠTUKAI;7371386368;Taip;1;0;0;1
7982;Pipiras;NYKŠTUKAI;1019753152;Taip;0;5;0;5
7983;Pipiras;NYKŠTUKAI;9499869533;Taip;5;1;0;6
7984;Pipiras;NYKŠTUKAI;5141447649;Taip;0;1;0;1
7985;Pipiras;NYKŠTUKAI;9877682150;Taip;0;2;2;4
7986;Pipiras;NYKŠTUKAI;9248925267;Taip;0;5;0;5
7987;Pipiras;NYKŠTUKAI;9711147855;Taip;0;1;0;1
7988;Pipiras;PELĖDŽIUKAI;6342044341;Ne;16;0;0;16
7989;Pipiras;PELĖDŽIUKAI;3852848863;Taip;5;2;0;7
7990;Pipiras;PELĖDŽIUKAI;3882437376;Taip;0;0;1;1
7991;Pipiras;PELĖDŽIUKAI;9157870634;Taip;0;1;0;1
7992;Pipiras;PELĖDŽIUKAI;5235868332;Taip;5;1;0;6
7993;Pipiras;PELĖDŽIUKAI;3554786173;Taip;7;0;1;8
7994;Pipiras;PELĖDŽIUKAI;1034182352;Taip;17;0;0;17
7995;Pipiras;PELĖDŽIUKAI;2075041950;Taip;4;0;1;5
7996;Pipiras;PELĖDŽIUKAI;6792777396;Taip;0;2;0;2
7997;Pipiras;PELĖDŽIUKAI;6780333972;Taip;11;1;0;12
7998;Pipiras;PELĖDŽIUKAI;5622119207;Taip;0;6;0;6
7999;Pipiras;PELĖDŽIUKAI;7934365114;Taip;8;0;0;8
8000;Pipiras;PELĖDŽIUKAI;6523189501;Taip;19;0;0;19
8001;Pipiras;PELĖDŽIUKAI;7161727352;Taip;0;14;0;14
8002;Pipiras;PELĖDŽIUKAI;9770780973;Taip;8;0;0;8
8003;Pipiras;PELĖDŽIUKAI;5845498558;Taip;0;5;0;5
8004;Pipiras;PELĖDŽIUKAI;9840040112;Ne;2;4;0;6
8005;Pipiras;PELĖDŽIUKAI;1784839485;Taip;0;4;0;4
8006;Pipiras;PELĖDŽIUKAI;3775916247;Ne;0;3;0;3
8007;Pipiras;PELĖDŽIUKAI;7350131214;Taip;4;0;0;4
8008;Pipiras;DRUGELIAI;5908707752;Ne;0;2;8;10
8009;Pipiras;DRUGELIAI;1957338631;Taip;5;0;3;8
8010;Pipiras;DRUGELIAI;5856735452;Taip;6;2;0;8
8011;Pipiras;DRUGELIAI;2267192782;Taip;0;8;0;8
8012;Pipiras;DRUGELIAI;1045583136;Taip;5;2;0;7
8013;Pipiras;DRUGELIAI;7425654504;Ne;0;8;0;8
8014;Pipiras;DRUGELIAI;9479697733;Taip;5;0;4;9
8015;Pipiras;DRUGELIAI;4017042461;Taip;0;11;1;12
8016;Pipiras;DRUGELIAI;4725221169;Taip;10;0;0;10
8017;Pipiras;DRUGELIAI;5059203266;Taip;2;0;1;3
8018;Pipiras;DRUGELIAI;8140314304;Taip;0;0;3;3
8019;Pipiras;DRUGELIAI;8422419380;Taip;3;2;0;5
8020;Pipiras;DRUGELIAI;6791495556;Ne;0;3;0;3
8021;Pipiras;DRUGELIAI;4811029230;Taip;0;0;7;7
8022;Pipiras;DRUGELIAI;6363349541;Taip;0;2;0;2
8023;Pipiras;DRUGELIAI;6685567970;Taip;0;2;0;2
8024;Pipiras;DRUGELIAI;1353114929;Taip;0;2;0;2
8025;Pipiras;DRUGELIAI;4426479971;Taip;1;0;0;1
8026;Pipiras;DRUGELIAI;7551948603;Ne;0;0;2;2
8027;Pipiras;GĖLYTĖS;9670710691;Taip;0;0;13;13
8028;Pipiras;GĖLYTĖS;8965139441;Taip;10;2;0;12
8029;Pipiras;GĖLYTĖS;2095794125;Taip;10;0;1;11
8030;Pipiras;GĖLYTĖS;8675473349;Taip;0;6;0;6
8031;Pipiras;GĖLYTĖS;4945164161;Taip;5;5;1;11
8032;Pipiras;GĖLYTĖS;7362002646;Taip;5;2;0;7
8033;Pipiras;GĖLYTĖS;5150723052;Ne;6;0;0;6
8034;Pipiras;GĖLYTĖS;3755824911;Taip;6;2;4;12
8035;Pipiras;GĖLYTĖS;6453274205;Taip;4;3;0;7
8036;Pipiras;GĖLYTĖS;4559954910;Taip;0;9;0;9
8037;Pipiras;GĖLYTĖS;7157187063;Taip;9;5;0;14
8038;Pipiras;GĖLYTĖS;4021613243;Taip;0;1;0;1
8039;Pipiras;GĖLYTĖS;1611488078;Taip;3;2;0;5
8040;Pipiras;GĖLYTĖS;4236597883;Taip;0;0;2;2
8041;Pipiras;GĖLYTĖS;2474548836;Ne;3;3;1;7
8042;Pipiras;GĖLYTĖS;8553422709;Taip;0;1;0;1
8043;Pipiras;GĖLYTĖS;5738334591;Taip;10;2;0;12
8044;Pipiras;GĖLYTĖS;6428525902;Taip;3;1;0;4
8045;Pipiras;GĖLYTĖS;8354158722;Taip;11;0;0;11
8046;Pipiras;BORUŽĖLĖS;4707794599;Taip;7;0;0;7
8047;Pipiras;BORUŽĖLĖS;8673271201;Taip;1;0;2;3
8048;Pipiras;BORUŽĖLĖS;5968015502;Taip;5;4;0;9
8049;Pipiras;BORUŽĖLĖS;4086728233;Taip;0;1;0;1
8050;Pipiras;BORUŽĖLĖS;8508292428;Taip;0;1;0;1
8051;Pipiras;BORUŽĖLĖS;1210940213;Taip;0;1;0;1
8052;Pipiras;BORUŽĖLĖS;8260680662;Taip;0;1;0;1
8053;Pipiras;BORUŽĖLĖS;1548928533;Taip;0;6;0;6
8054;Pipiras;BORUŽĖLĖS;9097987789;Taip;0;3;0;3
8055;Pipiras;BORUŽĖLĖS;6310054093;Taip;5;1;0;6
8056;Pipiras;BORUŽĖLĖS;8959946514;Ne;8;0;3;11
8057;Pipiras;BORUŽĖLĖS;8443786510;Taip;0;1;0;1
8058;Pipiras;BORUŽĖLĖS;1146369304;Taip;6;8;0;14
8059;Pipiras;BORUŽĖLĖS;9970587185;Taip;0;0;2;2
8060;Pipiras;BORUŽĖLĖS;6034298583;Taip;6;5;0;11
8061;Pipiras;BORUŽĖLĖS;6344932171;Taip;9;0;1;10
8062;Pipiras;BORUŽĖLĖS;1550959705;Taip;0;0;2;2
8063;Pipiras;SKRUZDĖLIUKAI;7969837759;Taip;0;1;0;1
8064;Pipiras;SKRUZDĖLIUKAI;2483867901;Taip;5;0;0;5
8065;Pipiras;SKRUZDĖLIUKAI;1315372873;Taip;0;11;0;11
8066;Pipiras;SKRUZDĖLIUKAI;9372109848;Taip;0;10;0;10
8067;Pipiras;SKRUZDĖLIUKAI;8296425777;Taip;5;1;0;6
8068;Pipiras;SKRUZDĖLIUKAI;9968182443;Ne;1;2;0;3
8069;Pipiras;SKRUZDĖLIUKAI;2296702730;Taip;5;0;0;5
8070;Pipiras;SKRUZDĖLIUKAI;3768825314;Taip;0;0;10;10
8071;Pipiras;SKRUZDĖLIUKAI;5888429623;Ne;2;2;1;5
8072;Pipiras;SKRUZDĖLIUKAI;4309096743;Taip;5;0;1;6
8073;Pipiras;SKRUZDĖLIUKAI;2399588759;Taip;0;7;0;7
8074;Pipiras;SKRUZDĖLIUKAI;3935474148;Taip;2;2;0;4
8075;Pipiras;SKRUZDĖLIUKAI;8081343184;Taip;10;1;0;11
8076;Pipiras;SKRUZDĖLIUKAI;9852475056;Ne;10;2;0;12
8077;Pipiras;SKRUZDĖLIUKAI;6176818802;Taip;5;0;2;7
8078;Pipiras;SKRUZDĖLIUKAI;1215623527;Taip;0;5;0;5
8079;Pipiras;SKRUZDĖLIUKAI;1998249512;Taip;0;0;1;1
8080;Pipiras;SKRUZDĖLIUKAI;9625933545;Taip;3;4;0;7
8081;Pipiras;SKRUZDĖLIUKAI;7211189491;Taip;0;0;2;2
8082;Pipiras;ŽVIRBLIUKŲ;6340323302;Taip;0;6;0;6
8083;Pipiras;ŽVIRBLIUKŲ;5445858240;Taip;0;4;1;5
8084;Pipiras;ŽVIRBLIUKŲ;1242260242;Taip;0;3;3;6
8085;Pipiras;ŽVIRBLIUKŲ;3421769229;Taip;5;2;0;7
8086;Pipiras;ŽVIRBLIUKŲ;8520454289;Taip;0;2;0;2
8087;Pipiras;ŽVIRBLIUKŲ;5422547144;Taip;0;4;0;4
8088;Pipiras;ŽVIRBLIUKŲ;6136423200;Taip;0;1;1;2
8089;Pipiras;ŽVIRBLIUKŲ;1144813356;Taip;0;1;2;3
8090;Pipiras;ŽVIRBLIUKŲ;6694920607;Taip;7;8;0;15
8091;Pipiras;ŽVIRBLIUKŲ;7912217889;Taip;4;4;0;8
8092;Pipiras;ŽVIRBLIUKŲ;3141822820;Taip;0;7;0;7
8093;Pipiras;ŽVIRBLIUKŲ;7870521230;Taip;0;3;5;8
8094;Pipiras;ŽVIRBLIUKŲ;4428216634;Taip;0;1;1;2
8095;Pipiras;ŽVIRBLIUKŲ;5502001191;Taip;0;1;0;1
8096;Pipiras;ŽVIRBLIUKŲ;5778300856;Taip;0;1;0;1
8097;Pipiras;ŽVIRBLIUKŲ;3888552150;Taip;0;1;0;1
8098;Pipiras;ŽVIRBLIUKŲ;2240865490;Taip;0;1;0;1
8099;Pipiras;ŽVIRBLIUKŲ;7026118693;Taip;0;3;1;4
8100;Pipiras;ŽVIRBLIUKŲ;87924002679;Taip;6;4;0;10
8101;Pipiras;ŽVIRBLIUKŲ;4496076326;Taip;0;1;0;1
8102;Pipiras;ZUIKUČIŲ;6925577945;Taip;14;0;0;14
8103;Pipiras;ZUIKUČIŲ;9639609431;Taip;8;1;0;9
8104;Pipiras;ZUIKUČIŲ;1682281017;Ne;0;9;0;9
8105;Pipiras;ZUIKUČIŲ;8130815072;Ne;1;2;0;3
8106;Pipiras;ZUIKUČIŲ;7095534371;Taip;0;14;0;14
8107;Pipiras;ZUIKUČIŲ;9665655075;Taip;0;4;0;4
8108;Pipiras;ZUIKUČIŲ;2159315426;Taip;11;0;0;11
8109;Pipiras;ZUIKUČIŲ;8404246568;Taip;0;5;0;5
8110;Pipiras;ZUIKUČIŲ;2599175140;Taip;10;2;0;12
8111;Pipiras;ZUIKUČIŲ;7200147039;Taip;5;7;0;12
8112;Pipiras;ZUIKUČIŲ;5035593032;Taip;7;0;2;9
8113;Pipiras;ZUIKUČIŲ;4743474665;Taip;3;5;0;8
8114;Pipiras;ZUIKUČIŲ;9422467047;Ne;6;0;0;6
8115;Pipiras;ZUIKUČIŲ;4991725638;Taip;9;0;0;9
8116;Pipiras;VARLIUKŲ;9307622469;Taip;0;21;0;21
8117;Pipiras;VARLIUKŲ;7446225835;Taip;14;0;0;14
8118;Pipiras;VARLIUKŲ;8800890503;Taip;4;1;0;5
8119;Pipiras;VARLIUKŲ;6184943213;Taip;4;2;0;6
8120;Pipiras;VARLIUKŲ;8028360748;Taip;7;1;0;8
8121;Pipiras;VARLIUKŲ;1238280105;Taip;17;1;0;18
8122;Pipiras;VARLIUKŲ;3299099535;Taip;0;2;0;2
8123;Pipiras;VARLIUKŲ;8364783015;Taip;21;0;0;21
8124;Pipiras;VARLIUKŲ;5502186385;Taip;5;0;1;6
8125;Pipiras;VARLIUKŲ;8707560610;Taip;13;0;0;13
8126;Pipiras;VARLIUKŲ;4940053409;Taip;1;0;0;1
8127;Pipiras;VARLIUKŲ;2588075386;Taip;7;1;0;8
8128;Pipiras;VARLIUKŲ;6666112357;Taip;10;2;0;12
8129;Pipiras;VARLIUKŲ;9473056714;Taip;0;11;0;11
8130;Pipiras;VARLIUKŲ;4282267631;Taip;3;0;0;3
8131;Pipiras;ŽIOGELIŲ;7802812858;Taip;2;0;11;13
8132;Pipiras;ŽIOGELIŲ;8697732892;Taip;17;0;1;18
8133;Pipiras;ŽIOGELIŲ;1466527534;Taip;0;1;3;4
8134;Pipiras;ŽIOGELIŲ;1172225661;Taip;0;1;0;1
8135;Pipiras;ŽIOGELIŲ;3825960148;Ne;9;2;5;16
8136;Pipiras;ŽIOGELIŲ;9747219629;Taip;7;0;0;7
8137;Pipiras;ŽIOGELIŲ;8445608419;Ne;3;0;1;4
8138;Pipiras;ŽIOGELIŲ;6602780166;Taip;6;1;3;10
8139;Pipiras;ŽIOGELIŲ;1074913909;Taip;0;0;21;21
8140;Pipiras;ŽIOGELIŲ;4229548366;Taip;11;0;2;13
8141;Pipiras;ŽIOGELIŲ;8666908143;Taip;5;5;0;10
8142;Pipiras;ŽIOGELIŲ;4083110785;Taip;7;0;1;8
8143;Pipiras;ŽIOGELIŲ;7011969610;Taip;7;0;0;7
8144;Pipiras;ŽIOGELIŲ;2784222529;Taip;5;0;5;10
8145;"Prie pasakų parko";ZUIKUČIAI;8493622886;Taip;11;0;0;11
8146;"Prie pasakų parko";ZUIKUČIAI;3998970024;Taip;3;0;0;3
8147;"Prie pasakų parko";ZUIKUČIAI;3907016976;Taip;10;0;1;11
8148;"Prie pasakų parko";ZUIKUČIAI;9770819792;Taip;10;0;1;11
8149;"Prie pasakų parko";ZUIKUČIAI;4904562817;Taip;8;0;1;9
8150;"Prie pasakų parko";ZUIKUČIAI;6662531456;Ne;16;0;0;16
8151;"Prie pasakų parko";ZUIKUČIAI;9659710840;Taip;0;14;0;14
8152;"Prie pasakų parko";ZUIKUČIAI;8781483295;Ne;9;0;1;10
8153;"Prie pasakų parko";ZUIKUČIAI;5394554484;Taip;4;0;1;5
8154;"Prie pasakų parko";ZUIKUČIAI;9707694441;Taip;8;0;0;8
8155;"Prie pasakų parko";ZUIKUČIAI;7220229641;Ne;15;0;0;15
8156;"Prie pasakų parko";ZUIKUČIAI;8616467675;Taip;5;0;3;8
8157;"Prie pasakų parko";ZUIKUČIAI;8215496569;Ne;6;0;0;6
8158;"Prie pasakų parko";ZUIKUČIAI;9742058853;Taip;0;0;2;2
8159;"Prie pasakų parko";PAUKŠČIUKŲ;4860316199;Ne;13;0;1;14
8160;"Prie pasakų parko";PAUKŠČIUKŲ;3907578461;Taip;12;0;1;13
8161;"Prie pasakų parko";PAUKŠČIUKŲ;7359935733;Taip;16;0;0;16
8162;"Prie pasakų parko";PAUKŠČIUKŲ;7330033315;Taip;5;0;4;9
8163;"Prie pasakų parko";PAUKŠČIUKŲ;9061639276;Taip;21;0;0;21
8164;"Prie pasakų parko";PAUKŠČIUKŲ;1476515947;Ne;12;1;1;14
8165;"Prie pasakų parko";PAUKŠČIUKŲ;6601363351;Ne;1;0;2;3
8166;"Prie pasakų parko";PAUKŠČIUKŲ;9784398441;Taip;14;0;0;14
8167;"Prie pasakų parko";PAUKŠČIUKŲ;4891232161;Taip;5;0;0;5
8168;"Prie pasakų parko";PAUKŠČIUKŲ;9550985822;Taip;2;0;0;2
8169;"Prie pasakų parko";PAUKŠČIUKŲ;5737517940;Taip;10;0;3;13
8170;"Prie pasakų parko";PAUKŠČIUKŲ;7693728136;Ne;13;0;0;13
8171;"Prie pasakų parko";PAUKŠČIUKŲ;2088585478;Taip;5;0;6;11
8172;"Prie pasakų parko";"LINKSMOJI ŠEIMYNĖLĖ (SPEC)";2820889357;Ne;6;0;5;11
8173;"Prie pasakų parko";"LINKSMOJI ŠEIMYNĖLĖ (SPEC)";29445903073;Taip;5;0;2;7
8174;"Prie pasakų parko";"LINKSMOJI ŠEIMYNĖLĖ (SPEC)";1549137154;Taip;3;0;2;5
8175;"Prie pasakų parko";"LINKSMOJI ŠEIMYNĖLĖ (SPEC)";6245610875;Taip;15;0;2;17
8176;"Prie pasakų parko";"LINKSMOJI ŠEIMYNĖLĖ (SPEC)";9469871636;Ne;10;0;2;12
8177;"Prie pasakų parko";"LINKSMOJI ŠEIMYNĖLĖ (SPEC)";5641148690;Taip;0;0;3;3
8178;"Prie pasakų parko";"LINKSMOJI ŠEIMYNĖLĖ (SPEC)";9594976173;Ne;0;0;2;2
8179;"Prie pasakų parko";"LINKSMOJI ŠEIMYNĖLĖ (SPEC)";1828638638;Taip;15;0;0;15
8180;"Prie pasakų parko";"LINKSMOJI ŠEIMYNĖLĖ (SPEC)";5356005675;Taip;6;0;0;6
8181;"Prie pasakų parko";"LINKSMOJI ŠEIMYNĖLĖ (SPEC)";9789977863;Taip;5;0;5;10
8182;"Prie pasakų parko";NYKŠTUKŲ;2287711014;Taip;6;1;3;10
8183;"Prie pasakų parko";NYKŠTUKŲ;6491435655;Taip;6;5;0;11
8184;"Prie pasakų parko";NYKŠTUKŲ;1743429440;Taip;0;5;0;5
8185;"Prie pasakų parko";NYKŠTUKŲ;1811994592;Ne;5;0;2;7
8186;"Prie pasakų parko";NYKŠTUKŲ;7739970115;Taip;1;0;1;2
8187;"Prie pasakų parko";NYKŠTUKŲ;6700916147;Taip;9;0;0;9
8188;"Prie pasakų parko";NYKŠTUKŲ;6733793491;Taip;11;0;1;12
8189;"Prie pasakų parko";NYKŠTUKŲ;4674683653;Taip;0;0;2;2
8190;"Prie pasakų parko";NYKŠTUKŲ;2515928623;Taip;9;0;2;11
8191;"Prie pasakų parko";NYKŠTUKŲ;4726737519;Taip;6;0;1;7
8192;"Prie pasakų parko";NYKŠTUKŲ;1316127369;Taip;11;0;0;11
8193;"Prie pasakų parko";NYKŠTUKŲ;2654978735;Taip;17;0;4;21
8194;"Prie pasakų parko";NYKŠTUKŲ;2661900328;Taip;0;0;2;2
8195;"Prie pasakų parko";NYKŠTUKŲ;3202292611;Ne;0;0;4;4
8196;"Prie pasakų parko";NYKŠTUKŲ;9225775914;Taip;4;1;0;5
8197;"Prie pasakų parko";NYKŠTUKŲ;4457827262;Taip;8;0;1;9
8198;"Prie pasakų parko";LAŠELIŲ;6865751947;Taip;0;0;1;1
8199;"Prie pasakų parko";LAŠELIŲ;6992830082;Taip;0;2;0;2
8200;"Prie pasakų parko";LAŠELIŲ;1588062393;Taip;0;0;1;1
8201;"Prie pasakų parko";LAŠELIŲ;1278065349;Taip;8;0;2;10
8202;"Prie pasakų parko";LAŠELIŲ;8574432191;Taip;0;1;1;2
8203;"Prie pasakų parko";LAŠELIŲ;4181676762;Taip;0;0;1;1
8204;"Prie pasakų parko";LAŠELIŲ;4548803933;Taip;0;0;5;5
8205;"Prie pasakų parko";LAŠELIŲ;6250610187;Taip;0;7;0;7
8206;"Prie pasakų parko";LAŠELIŲ;3504938510;Taip;0;0;3;3
8207;"Prie pasakų parko";LAŠELIŲ;9190379838;Taip;7;0;2;9
8208;"Prie pasakų parko";LAŠELIŲ;8189217660;Taip;0;6;0;6
8209;"Prie pasakų parko";LAŠELIŲ;8215830508;Ne;0;7;0;7
8210;"Prie pasakų parko";LAŠELIŲ;2216634402;Taip;7;0;0;7
8211;"Prie pasakų parko";LAŠELIŲ;8849417734;Taip;9;0;1;10
8212;"Prie pasakų parko";LAŠELIŲ;2731544174;Taip;0;0;1;1
8213;"Prie pasakų parko";LAŠELIŲ;6361878877;Taip;9;0;0;9
8214;"Prie pasakų parko";LAŠELIŲ;5494350183;Taip;0;6;0;6
8215;"Prie pasakų parko";LAŠELIŲ;5102718403;Taip;7;0;3;10
8216;"Prie pasakų parko";"KAČIUKAI (SPEC)";6772736175;Taip;16;0;1;17
8217;"Prie pasakų parko";"KAČIUKAI (SPEC)";5847625697;Taip;9;0;5;14
8218;"Prie pasakų parko";"KAČIUKAI (SPEC)";2590693851;Taip;1;0;1;2
8219;"Prie pasakų parko";"KAČIUKAI (SPEC)";3949671257;Ne;12;0;0;12
8220;"Prie pasakų parko";"ŽVAIGŽDUTĖS  (SPEC)";7216751216;Taip;15;0;1;16
8221;"Prie pasakų parko";"ŽVAIGŽDUTĖS  (SPEC)";4037594669;Taip;0;0;2;2
8222;"Prie pasakų parko";"ŽVAIGŽDUTĖS  (SPEC)";9072312203;Taip;5;1;0;6
8223;"Prie pasakų parko";"ŽVAIGŽDUTĖS  (SPEC)";5006152810;Taip;0;0;1;1
8224;"Prie pasakų parko";"ŽVAIGŽDUTĖS  (SPEC)";6989235061;Taip;0;0;10;10
8225;"Prie pasakų parko";"ŽVAIGŽDUTĖS  (SPEC)";5009168398;Ne;0;0;2;2
8226;"Prie pasakų parko";"ŽVAIGŽDUTĖS  (SPEC)";6585504578;Taip;8;0;5;13
8227;"Prie pasakų parko";"ŽVAIGŽDUTĖS  (SPEC)";1621710265;Ne;10;0;1;11
8228;"Prie pasakų parko";"ANČIUKAI (SPEC)";8339335908;Taip;0;0;2;2
8229;"Prie pasakų parko";"ANČIUKAI (SPEC)";6802898184;Taip;5;0;3;8
8230;"Prie pasakų parko";"ANČIUKAI (SPEC)";9529949992;Taip;2;0;2;4
8231;"Prie pasakų parko";"ANČIUKAI (SPEC)";6431918357;Taip;21;0;0;21
8232;"Prie pasakų parko";"ANČIUKAI (SPEC)";1190509858;Taip;21;0;0;21
8233;"Prie pasakų parko";"ANČIUKAI (SPEC)";4309482351;Taip;15;0;0;15
8234;"Prie pasakų parko";"ANČIUKAI (SPEC)";2263419475;Taip;11;0;0;11
8235;"Prie pasakų parko";"ANČIUKAI (SPEC)";7200571639;Taip;4;0;2;6
8236;"Prie pasakų parko";TIGRIUKAI;7858530013;Taip;10;5;0;15
8237;"Prie pasakų parko";TIGRIUKAI;3918269702;Ne;7;0;3;10
8238;"Prie pasakų parko";TIGRIUKAI;6446562388;Taip;0;0;5;5
8239;"Prie pasakų parko";TIGRIUKAI;2168919559;Taip;0;1;0;1
8240;"Prie pasakų parko";TIGRIUKAI;8899375521;Ne;9;1;0;10
8241;"Prie pasakų parko";TIGRIUKAI;6561145380;Taip;5;5;0;10
8242;"Prie pasakų parko";TIGRIUKAI;9476448601;Taip;4;0;1;5
8243;"Prie pasakų parko";TIGRIUKAI;8029428034;Taip;6;0;0;6
8244;"Prie pasakų parko";TIGRIUKAI;8715851643;Taip;0;0;3;3
8245;"Prie pasakų parko";TIGRIUKAI;3617673265;Taip;0;0;1;1
8246;"Prie pasakų parko";TIGRIUKAI;1704679306;Taip;0;0;7;7
8247;"Prie pasakų parko";TIGRIUKAI;7776961789;Taip;3;0;3;6
8248;"Prie pasakų parko";TIGRIUKAI;8285260113;Taip;0;6;0;6
8249;"Prie pasakų parko";TIGRIUKAI;3373275644;Taip;0;4;2;6
8250;"Prie pasakų parko";TIGRIUKAI;5518041213;Taip;0;1;3;4
8251;"Prie pasakų parko";TIGRIUKAI;8738488104;Taip;7;1;4;12
8252;"Prie pasakų parko";TIGRIUKAI;8406002339;Taip;0;0;1;1
8253;"Prie pasakų parko";"EŽIUKŲ (SPEC)";7851357992;Ne;0;0;11;11
8254;"Prie pasakų parko";"EŽIUKŲ (SPEC)";7115825217;Taip;3;0;10;13
8255;"Prie pasakų parko";"EŽIUKŲ (SPEC)";2952868428;Taip;11;0;2;13
8256;"Prie pasakų parko";"EŽIUKŲ (SPEC)";5159105661;Taip;11;0;0;11
8257;"Prie pasakų parko";"EŽIUKŲ (SPEC)";5944113879;Ne;7;0;3;10
8258;"Prie pasakų parko";"EŽIUKŲ (SPEC)";4950143153;Ne;0;0;1;1
8259;"Prie pasakų parko";"BORUŽIUKŲ (SPEC)";9715586563;Ne;16;0;3;19
8260;"Prie pasakų parko";"BORUŽIUKŲ (SPEC)";28574450739;Taip;7;0;1;8
8261;"Prie pasakų parko";"BORUŽIUKŲ (SPEC)";6215345468;Ne;5;0;2;7
8262;"Prie pasakų parko";"BORUŽIUKŲ (SPEC)";7000191099;Taip;21;0;0;21
8263;"Prie pasakų parko";SAULYTĖS;6762267582;Taip;15;0;0;15
8264;"Prie pasakų parko";SAULYTĖS;7459673719;Ne;10;1;2;13
8265;"Prie pasakų parko";SAULYTĖS;4351705573;Taip;6;0;2;8
8266;"Prie pasakų parko";SAULYTĖS;7390391804;Taip;0;0;3;3
8267;"Prie pasakų parko";SAULYTĖS;8685140364;Ne;8;7;0;15
8268;"Prie pasakų parko";SAULYTĖS;6606867989;Taip;13;0;0;13
8269;"Prie pasakų parko";SAULYTĖS;2206221105;Taip;21;0;0;21
8270;"Prie pasakų parko";SAULYTĖS;2201317313;Taip;11;0;0;11
8271;"Prie pasakų parko";SAULYTĖS;3038164555;Taip;0;0;1;1
8272;"Prie pasakų parko";SAULYTĖS;4183640714;Taip;0;0;5;5
8273;"Prie pasakų parko";SAULYTĖS;1738732866;Taip;0;0;1;1
8274;Pumpurėlis;RAMUNĖLIŲ;6165833101;Taip;3;0;2;5
8275;Pumpurėlis;RAMUNĖLIŲ;6977710645;Taip;5;0;0;5
8276;Pumpurėlis;RAMUNĖLIŲ;9431295796;Taip;0;0;4;4
8277;Pumpurėlis;RAMUNĖLIŲ;1395380236;Ne;0;0;4;4
8278;Pumpurėlis;RAMUNĖLIŲ;9424449290;Taip;8;4;0;12
8279;Pumpurėlis;RAMUNĖLIŲ;5171198109;Taip;0;1;1;2
8280;Pumpurėlis;RAMUNĖLIŲ;9726028397;Taip;0;0;1;1
8281;Pumpurėlis;RAMUNĖLIŲ;7229289985;Taip;7;0;5;12
8282;Pumpurėlis;RAMUNĖLIŲ;2969734731;Taip;0;0;1;1
8283;Pumpurėlis;RAMUNĖLIŲ;7559071945;Taip;0;1;1;2
8284;Pumpurėlis;RAMUNĖLIŲ;6574415196;Taip;0;0;2;2
8285;Pumpurėlis;RAMUNĖLIŲ;3953103488;Ne;5;6;1;12
8286;Pumpurėlis;RAMUNĖLIŲ;6511527480;Taip;0;6;0;6
8287;Pumpurėlis;RAMUNĖLIŲ;3838705973;Taip;5;0;8;13
8288;Pumpurėlis;RAMUNĖLIŲ;6726875853;Taip;0;0;2;2
8289;Pumpurėlis;RAMUNĖLIŲ;8667762689;Taip;6;5;0;11
8290;Pumpurėlis;RAMUNĖLIŲ;3874188848;Taip;0;0;13;13
8291;Pumpurėlis;RAMUNĖLIŲ;2233224512;Taip;0;0;1;1
8292;Pumpurėlis;RAMUNĖLIŲ;7619709360;Ne;6;0;5;11
8293;Pumpurėlis;VARPELIŲ;3101133244;Taip;7;1;0;8
8294;Pumpurėlis;VARPELIŲ;3893768713;Taip;0;8;0;8
8295;Pumpurėlis;VARPELIŲ;5023658988;Taip;0;1;0;1
8296;Pumpurėlis;VARPELIŲ;2668855786;Taip;0;13;0;13
8297;Pumpurėlis;VARPELIŲ;8258560345;Taip;1;6;0;7
8298;Pumpurėlis;VARPELIŲ;9612924972;Taip;0;1;0;1
8299;Pumpurėlis;VARPELIŲ;9884099545;Ne;4;4;0;8
8300;Pumpurėlis;VARPELIŲ;3733509497;Taip;12;0;2;14
8301;Pumpurėlis;VARPELIŲ;4508966729;Ne;0;0;7;7
8302;Pumpurėlis;VARPELIŲ;9552913910;Taip;20;1;0;21
8303;Pumpurėlis;VARPELIŲ;5196733185;Taip;0;1;1;2
8304;Pumpurėlis;VARPELIŲ;4928495108;Taip;0;5;0;5
8305;Pumpurėlis;VARPELIŲ;8886730333;Taip;7;2;0;9
8306;Pumpurėlis;VARPELIŲ;5564680653;Taip;0;0;1;1
8307;Pumpurėlis;VARPELIŲ;1411232443;Taip;4;0;0;4
8308;Pumpurėlis;VARPELIŲ;8525537588;Ne;0;1;0;1
8309;Pumpurėlis;VARPELIŲ;2103139845;Taip;0;0;1;1
8310;Pumpurėlis;VARPELIŲ;6780042929;Taip;0;16;0;16
8311;Pumpurėlis;VARPELIŲ;7182107790;Taip;1;0;8;9
8312;Pumpurėlis;VARPELIŲ;4629544683;Taip;6;0;0;6
8313;Pumpurėlis;VARPELIŲ;9224879966;Taip;0;0;5;5
8314;Pumpurėlis;DRUGELIŲ;5928552565;Taip;1;0;8;9
8315;Pumpurėlis;DRUGELIŲ;5897036076;Taip;0;1;0;1
8316;Pumpurėlis;DRUGELIŲ;7055989095;Taip;0;17;0;17
8317;Pumpurėlis;DRUGELIŲ;7078621340;Taip;5;1;0;6
8318;Pumpurėlis;DRUGELIŲ;1538548768;Taip;5;0;4;9
8319;Pumpurėlis;DRUGELIŲ;2368226822;Taip;7;1;2;10
8320;Pumpurėlis;DRUGELIŲ;3088476130;Taip;0;0;1;1
8321;Pumpurėlis;DRUGELIŲ;9640790401;Taip;7;1;1;9
8322;Pumpurėlis;DRUGELIŲ;8320987208;Taip;6;0;0;6
8323;Pumpurėlis;DRUGELIŲ;7832408524;Taip;4;0;0;4
8324;Pumpurėlis;DRUGELIŲ;8644853849;Taip;0;10;0;10
8325;Pumpurėlis;DRUGELIŲ;9417688597;Taip;4;0;2;6
8326;Pumpurėlis;DRUGELIŲ;9032255874;Taip;8;1;3;12
8327;Pumpurėlis;DRUGELIŲ;9996789041;Taip;0;0;1;1
8328;Pumpurėlis;DRUGELIŲ;2684592319;Taip;0;0;2;2
8329;Pumpurėlis;DRUGELIŲ;5835115428;Taip;6;1;0;7
8330;Pumpurėlis;DRUGELIŲ;2132563531;Taip;0;1;1;2
8331;Pumpurėlis;DRUGELIŲ;4506063812;Taip;0;4;1;5
8332;Pumpurėlis;DRUGELIŲ;2165141865;Taip;1;0;0;1
8333;Pumpurėlis;DRUGELIŲ;8671697745;Ne;7;0;1;8
8334;Pumpurėlis;KODĖLČIUKŲ;2789026451;Taip;10;0;4;14
8335;Pumpurėlis;KODĖLČIUKŲ;9654958302;Taip;0;1;0;1
8336;Pumpurėlis;KODĖLČIUKŲ;1215117598;Taip;2;5;0;7
8337;Pumpurėlis;KODĖLČIUKŲ;6978091765;Taip;6;0;1;7
8338;Pumpurėlis;KODĖLČIUKŲ;6433757421;Taip;5;0;1;6
8339;Pumpurėlis;KODĖLČIUKŲ;3328647987;Taip;1;0;0;1
8340;Pumpurėlis;KODĖLČIUKŲ;3748601124;Taip;8;0;0;8
8341;Pumpurėlis;KODĖLČIUKŲ;6004234378;Taip;9;0;1;10
8342;Pumpurėlis;KODĖLČIUKŲ;4196409137;Ne;7;0;0;7
8343;Pumpurėlis;KODĖLČIUKŲ;6117720533;Taip;12;0;0;12
8344;Pumpurėlis;KODĖLČIUKŲ;8070486897;Taip;0;0;4;4
8345;Pumpurėlis;KODĖLČIUKŲ;3534133061;Taip;0;6;0;6
8346;Pumpurėlis;KODĖLČIUKŲ;2611141763;Taip;0;0;2;2
8347;Pumpurėlis;KODĖLČIUKŲ;2307819108;Taip;0;3;0;3
8348;Pumpurėlis;KODĖLČIUKŲ;9650395309;Taip;0;5;0;5
8349;Pumpurėlis;KODĖLČIUKŲ;3563609848;Taip;0;0;1;1
8350;Pumpurėlis;KODĖLČIUKŲ;2890596967;Taip;10;0;0;10
8351;Pumpurėlis;KODĖLČIUKŲ;9839285886;Ne;0;4;0;4
8352;Pumpurėlis;LINELIS;1017483419;Taip;0;2;0;2
8353;Pumpurėlis;LINELIS;6957047759;Taip;0;2;0;2
8354;Pumpurėlis;LINELIS;2468796972;Taip;0;1;0;1
8355;Pumpurėlis;LINELIS;1492810528;Taip;0;6;0;6
8356;Pumpurėlis;LINELIS;1835168438;Taip;5;1;0;6
8357;Pumpurėlis;LINELIS;4344595328;Taip;0;8;0;8
8358;Pumpurėlis;LINELIS;7566451857;Ne;0;11;0;11
8359;Pumpurėlis;LINELIS;9583257172;Taip;9;0;0;9
8360;Pumpurėlis;LINELIS;13952236905;Taip;0;1;0;1
8361;Pumpurėlis;LINELIS;7533555059;Taip;6;0;0;6
8362;Pumpurėlis;LINELIS;5615260965;Taip;0;1;0;1
8363;Pumpurėlis;LINELIS;6669327226;Taip;0;1;0;1
8364;Pumpurėlis;LINELIS;3298821054;Taip;0;2;0;2
8365;Pumpurėlis;LINELIS;8830261792;Taip;0;1;0;1
8366;Pumpurėlis;LINELIS;87061817106;Taip;0;3;0;3
8367;Pumpurėlis;LINELIS;8806961007;Taip;0;1;0;1
8368;Pumpurėlis;LINELIS;18928851032;Taip;3;1;0;4
8369;Pumpurėlis;LINELIS;8747439652;Taip;0;1;0;1
8370;Pumpurėlis;LINELIS;2629702959;Taip;8;4;0;12
8371;Pumpurėlis;LINELIS;5964953923;Taip;0;1;3;4
8372;Pumpurėlis;SAULUTĖS;3751769136;Taip;0;1;0;1
8373;Pumpurėlis;SAULUTĖS;5013491568;Taip;0;1;0;1
8374;Pumpurėlis;SAULUTĖS;7488342792;Taip;0;0;1;1
8375;Pumpurėlis;SAULUTĖS;6412442729;Taip;7;1;0;8
8376;Pumpurėlis;SAULUTĖS;2129779614;Ne;0;1;5;6
8377;Pumpurėlis;SAULUTĖS;1053338730;Taip;0;0;1;1
8378;Pumpurėlis;SAULUTĖS;7123915287;Taip;0;1;1;2
8379;Pumpurėlis;SAULUTĖS;83388662869;Taip;0;1;0;1
8380;Pumpurėlis;SAULUTĖS;1690424790;Taip;0;1;0;1
8381;Pumpurėlis;SAULUTĖS;1397924008;Ne;0;1;0;1
8382;Pumpurėlis;SAULUTĖS;6230500803;Taip;0;1;2;3
8383;Pumpurėlis;SAULUTĖS;1306102772;Taip;0;1;0;1
8384;Pumpurėlis;SAULUTĖS;1230058211;Ne;0;1;0;1
8385;Pumpurėlis;SAULUTĖS;25029630023;Taip;0;1;0;1
8386;Pumpurėlis;SAULUTĖS;6535398274;Ne;3;0;0;3
8387;Pumpurėlis;SAULUTĖS;8262886949;Taip;0;3;0;3
8388;Pumpurėlis;SAULUTĖS;1261919194;Taip;0;1;1;2
8389;Pumpurėlis;SAULUTĖS;9733380187;Taip;4;1;0;5
8390;Pumpurėlis;SAULUTĖS;2102427499;Ne;0;8;2;10
8391;Pumpurėlis;SAULUTĖS;1225377038;Ne;0;1;0;1
8392;Pumpurėlis;SAULUTĖS;9317495169;Taip;0;1;0;1
8393;Pumpurėlis;BITUTĖS;4419940231;Taip;0;8;0;8
8394;Pumpurėlis;BITUTĖS;4985045047;Taip;0;0;2;2
8395;Pumpurėlis;BITUTĖS;2651037375;Ne;10;0;1;11
8396;Pumpurėlis;BITUTĖS;1768239820;Taip;0;0;1;1
8397;Pumpurėlis;BITUTĖS;2566557351;Taip;0;0;6;6
8398;Pumpurėlis;BITUTĖS;4426697956;Ne;0;0;2;2
8399;Pumpurėlis;BITUTĖS;7363814444;Taip;0;7;0;7
8400;Pumpurėlis;BITUTĖS;3405169131;Taip;4;0;1;5
8401;Pumpurėlis;BITUTĖS;3951445693;Taip;0;0;1;1
8402;Pumpurėlis;BITUTĖS;9612924316;Taip;0;5;0;5
8403;Pumpurėlis;BITUTĖS;5194285627;Taip;0;0;2;2
8404;Pumpurėlis;BITUTĖS;1714440337;Taip;0;0;1;1
8405;Pumpurėlis;BITUTĖS;8655389224;Taip;0;2;0;2
8406;Pumpurėlis;BITUTĖS;1674341906;Ne;0;9;1;10
8407;Pumpurėlis;BITUTĖS;3842632260;Taip;0;0;1;1
8408;Pumpurėlis;BITUTĖS;1933502038;Taip;1;0;1;2
8409;Pumpurėlis;BITUTĖS;2230191718;Taip;0;0;1;1
8410;Pumpurėlis;BITUTĖS;7062090879;Taip;10;0;0;10
8411;Pumpurėlis;BITUTĖS;9245739052;Ne;0;0;1;1
8412;Pumpurėlis;BITUTĖS;8470433743;Taip;5;0;0;5
8413;Pumpurėlis;DOBILIUKAI;9179780392;Taip;3;1;0;4
8414;Pumpurėlis;DOBILIUKAI;1839505206;Taip;0;7;0;7
8415;Pumpurėlis;DOBILIUKAI;3970253545;Taip;0;0;5;5
8416;Pumpurėlis;DOBILIUKAI;1808734330;Taip;13;0;0;13
8417;Pumpurėlis;DOBILIUKAI;6968264923;Taip;9;4;0;13
8418;Pumpurėlis;DOBILIUKAI;7038597556;Taip;0;7;0;7
8419;Pumpurėlis;DOBILIUKAI;4130539703;Taip;0;1;0;1
8420;Pumpurėlis;DOBILIUKAI;6307988067;Taip;0;1;0;1
8421;Pumpurėlis;DOBILIUKAI;3374174445;Taip;0;6;0;6
8422;Pumpurėlis;DOBILIUKAI;3398517047;Taip;0;1;0;1
8423;Pumpurėlis;DOBILIUKAI;7276322999;Taip;0;1;0;1
8424;Pumpurėlis;DOBILIUKAI;5587118874;Taip;0;1;1;2
8425;Pumpurėlis;DOBILIUKAI;9058493247;Taip;1;1;0;2
8426;Pumpurėlis;DOBILIUKAI;5444879430;Ne;0;0;1;1
8427;Pumpurėlis;DOBILIUKAI;7825190756;Ne;5;0;1;6
8428;Pumpurėlis;DOBILIUKAI;1438740562;Taip;0;1;0;1
8429;Pumpurėlis;DOBILIUKAI;9740660699;Ne;7;9;0;16
8430;Pumpurėlis;PUPYČIŲ;7652642088;Taip;0;0;1;1
8431;Pumpurėlis;PUPYČIŲ;9317274035;Taip;14;0;0;14
8432;Pumpurėlis;PUPYČIŲ;1555441484;Taip;14;0;0;14
8433;Pumpurėlis;PUPYČIŲ;9052267552;Taip;0;0;3;3
8434;Pumpurėlis;PUPYČIŲ;9372725707;Taip;0;3;0;3
8435;Pumpurėlis;PUPYČIŲ;4249039048;Taip;0;1;7;8
8436;Pumpurėlis;PUPYČIŲ;1082775039;Taip;3;0;1;4
8437;Pumpurėlis;PUPYČIŲ;6982600785;Taip;18;0;1;19
8438;Pumpurėlis;PUPYČIŲ;1667602636;Taip;10;0;0;10
8439;Pumpurėlis;PUPYČIŲ;8212403350;Taip;0;0;1;1
8440;Pumpurėlis;PUPYČIŲ;1448399754;Taip;0;0;1;1
8441;Pumpurėlis;PUPYČIŲ;6795405194;Taip;8;0;3;11
8442;Pumpurėlis;PUPYČIŲ;7443152469;Taip;0;0;20;20
8443;Pumpurėlis;PUPYČIŲ;9306426978;Taip;0;0;7;7
8444;Pumpurėlis;PUPYČIŲ;3259416263;Taip;0;0;18;18
8445;Pumpurėlis;PUPYČIŲ;6939412463;Taip;0;0;1;1
8446;Pumpurėlis;PUPYČIŲ;8458676611;Taip;0;0;1;1
8447;Pumpurėlis;ŽIRNIUKŲ;9903981454;Taip;5;1;0;6
8448;Pumpurėlis;ŽIRNIUKŲ;3537534154;Taip;0;4;0;4
8449;Pumpurėlis;ŽIRNIUKŲ;1782842327;Taip;11;0;3;14
8450;Pumpurėlis;ŽIRNIUKŲ;9478685443;Taip;0;10;2;12
8451;Pumpurėlis;ŽIRNIUKŲ;6647331393;Taip;18;1;2;21
8452;Pumpurėlis;ŽIRNIUKŲ;3001331278;Taip;10;0;1;11
8453;Pumpurėlis;ŽIRNIUKŲ;9735493140;Taip;13;0;3;16
8454;Pumpurėlis;ŽIRNIUKŲ;8550119831;Ne;0;1;2;3
8455;Pumpurėlis;ŽIRNIUKŲ;4245270154;Taip;9;0;0;9
8456;Pumpurėlis;ŽIRNIUKŲ;6860128064;Taip;0;0;13;13
8457;Pumpurėlis;ŽIRNIUKŲ;2282966743;Taip;9;0;0;9
8458;Pumpurėlis;ŽIRNIUKŲ;5968577443;Taip;3;0;3;6
8459;Pumpurėlis;ŽIRNIUKŲ;8083674991;Taip;6;0;0;6
8460;Pumpurėlis;ŽIRNIUKŲ;9750242149;Taip;1;1;0;2
8461;Pumpurėlis;ŽIRNIUKŲ;5420222684;Taip;0;2;0;2
8462;Pumpurėlis;ŽIRNIUKŲ;6422203618;Taip;4;0;1;5
8463;Pumpurėlis;BORUŽĖLIŲ;2269864490;Taip;0;0;3;3
8464;Pumpurėlis;BORUŽĖLIŲ;6223338814;Ne;5;0;1;6
8465;Pumpurėlis;BORUŽĖLIŲ;5659508302;Taip;0;0;1;1
8466;Pumpurėlis;BORUŽĖLIŲ;5998858670;Ne;6;0;3;9
8467;Pumpurėlis;BORUŽĖLIŲ;7398363498;Taip;0;5;1;6
8468;Pumpurėlis;BORUŽĖLIŲ;5835545051;Taip;5;1;0;6
8469;Pumpurėlis;BORUŽĖLIŲ;9136771401;Taip;5;0;5;10
8470;Pumpurėlis;BORUŽĖLIŲ;7045349032;Taip;14;0;1;15
8471;Pumpurėlis;BORUŽĖLIŲ;1017838338;Taip;3;0;0;3
8472;Pumpurėlis;BORUŽĖLIŲ;1648249689;Taip;5;0;1;6
8473;Pumpurėlis;BORUŽĖLIŲ;7535098093;Taip;6;0;0;6
8474;Pumpurėlis;BORUŽĖLIŲ;7843280418;Ne;8;0;0;8
8475;Pumpurėlis;BORUŽĖLIŲ;3531862496;Ne;7;1;0;8
8476;Pumpurėlis;BORUŽĖLIŲ;1441993078;Ne;7;0;1;8
8477;Pumpurėlis;BORUŽĖLIŲ;2768082342;Ne;0;0;3;3
8478;Pumpurėlis;SMALSUČIŲ;6212212516;Ne;10;1;2;13
8479;Pumpurėlis;SMALSUČIŲ;6604801631;Taip;4;0;1;5
8480;Pumpurėlis;SMALSUČIŲ;9363610488;Taip;0;2;0;2
8481;Pumpurėlis;SMALSUČIŲ;8380689261;Taip;0;0;1;1
8482;Pumpurėlis;SMALSUČIŲ;6483338028;Taip;5;0;2;7
8483;Pumpurėlis;SMALSUČIŲ;3492977569;Taip;8;0;0;8
8484;Pumpurėlis;SMALSUČIŲ;6959214331;Taip;0;1;2;3
8485;Pumpurėlis;SMALSUČIŲ;3085309902;Taip;0;0;1;1
8486;Pumpurėlis;SMALSUČIŲ;4964949574;Taip;2;0;3;5
8487;Pumpurėlis;SMALSUČIŲ;2905797053;Taip;1;0;0;1
8488;Pumpurėlis;SMALSUČIŲ;2026021360;Taip;5;1;0;6
8489;Pumpurėlis;SMALSUČIŲ;3871151401;Ne;0;0;3;3
8490;Pumpurėlis;SMALSUČIŲ;6557857672;Taip;12;1;0;13
8491;Pumpurėlis;SMALSUČIŲ;5212827184;Taip;0;0;1;1
8492;Pumpurėlis;SMALSUČIŲ;6614797909;Taip;0;1;0;1
8493;Pumpurėlis;SMALSUČIŲ;7813696919;Ne;0;0;5;5
8494;Pumpurėlis;SMALSUČIŲ;5278250113;Taip;3;0;1;4
8495;Pumpurėlis;SMALSUČIŲ;5236515914;Ne;0;0;2;2
8496;Pumpurėlis;SMALSUČIŲ;5456922203;Taip;20;1;0;21
8497;Pumpurėlis;"GUDRUČIAI (Trinapolio g. 11)";8475215020;Taip;5;0;0;5
8498;Pumpurėlis;"GUDRUČIAI (Trinapolio g. 11)";6920353753;Taip;0;0;1;1
8499;Pumpurėlis;"GUDRUČIAI (Trinapolio g. 11)";6920353753;Taip;0;0;1;1
8500;Pumpurėlis;"GUDRUČIAI (Trinapolio g. 11)";2130008026;Taip;0;0;3;3
8501;Pumpurėlis;"GUDRUČIAI (Trinapolio g. 11)";9353403057;Taip;6;0;0;6
8502;Pumpurėlis;"GUDRUČIAI (Trinapolio g. 11)";9353403057;Taip;6;0;0;6
8503;Pumpurėlis;"GUDRUČIAI (Trinapolio g. 11)";3387386473;Taip;1;0;1;2
8504;Pumpurėlis;"GUDRUČIAI (Trinapolio g. 11)";7002569226;Ne;0;0;5;5
8505;Pumpurėlis;"GUDRUČIAI (Trinapolio g. 11)";1189960583;Ne;8;0;0;8
8506;Pumpurėlis;"PABIRUČIAI (Trinapolio g. 11)";5249717804;Ne;2;0;0;2
8507;Pumpurėlis;"PABIRUČIAI (Trinapolio g. 11)";8207951541;Ne;3;0;0;3
8508;Pumpurėlis;"PABIRUČIAI (Trinapolio g. 11)";4696006714;Ne;0;0;1;1
8509;Puriena;Ančiukų;1658720269;Taip;11;0;0;11
8510;Puriena;Ančiukų;6158842119;Taip;1;2;0;3
8511;Puriena;Ančiukų;3557013127;Taip;0;1;0;1
8512;Puriena;Ančiukų;4100466337;Taip;12;0;2;14
8513;Puriena;Ančiukų;9251058353;Taip;5;1;0;6
8514;Puriena;Ančiukų;3681811493;Taip;0;2;0;2
8515;Puriena;Ančiukų;4060087185;Ne;0;1;7;8
8516;Puriena;Ančiukų;6280465748;Taip;16;0;0;16
8517;Puriena;Ančiukų;3033562627;Taip;6;7;0;13
8518;Puriena;Ančiukų;5777076971;Taip;6;7;0;13
8519;Puriena;Ančiukų;8310231540;Taip;14;1;0;15
8520;Puriena;Ančiukų;4460575818;Taip;0;7;0;7
8521;Puriena;Ančiukų;8120597514;Taip;0;9;0;9
8522;Puriena;Ančiukų;7967288875;Taip;9;0;1;10
8523;Puriena;Ančiukų;5336923102;Taip;0;6;0;6
8524;Puriena;Ančiukų;1907429094;Taip;0;1;0;1
8525;Puriena;Ančiukų;4605662701;Ne;0;10;0;10
8526;Puriena;Ančiukų;1819876614;Taip;0;0;1;1
8527;Puriena;Ančiukų;4776745276;Taip;0;1;8;9
8528;Puriena;Ančiukų;6496291933;Taip;0;0;1;1
8529;Puriena;Ančiukų;7769252165;Taip;0;4;0;4
8530;Puriena;Ančiukų;2170025682;Taip;8;0;1;9
8531;Puriena;Ančiukų;3772941726;Taip;0;2;0;2
8532;Puriena;Ančiukų;1428098802;Taip;0;2;0;2
8533;Puriena;Drugeliai;2966464432;Taip;0;3;0;3
8534;Puriena;Drugeliai;4760827000;Taip;0;0;1;1
8535;Puriena;Drugeliai;4812271011;Taip;0;21;0;21
8536;Puriena;Drugeliai;1521955898;Taip;0;4;0;4
8537;Puriena;Drugeliai;8881337164;Taip;3;1;0;4
8538;Puriena;Drugeliai;5478026060;Taip;0;0;1;1
8539;Puriena;Drugeliai;8159342676;Taip;0;0;7;7
8540;Puriena;Drugeliai;1121312813;Ne;2;2;0;4
8541;Puriena;Drugeliai;2321753665;Taip;0;0;5;5
8542;Puriena;Drugeliai;7021756459;Taip;6;2;1;9
8543;Puriena;Drugeliai;1564155036;Ne;6;1;2;9
8544;Puriena;Drugeliai;6613654824;Taip;0;3;0;3
8545;Puriena;Drugeliai;3738277048;Ne;7;3;0;10
8546;Puriena;Drugeliai;7562458336;Taip;0;0;1;1
8547;Puriena;Drugeliai;3579008577;Taip;15;0;1;16
8548;Puriena;Drugeliai;4248701232;Taip;7;0;7;14
8549;Puriena;Drugeliai;7477278612;Taip;0;1;0;1
8550;Puriena;Drugeliai;9847768390;Taip;8;0;0;8
8551;Puriena;Drugeliai;1455237224;Taip;0;1;3;4
8552;Puriena;Drugeliai;6212693015;Taip;8;6;0;14
8553;Puriena;Drugeliai;5593526943;Ne;7;1;0;8
8554;Puriena;Pelėdžiukai;2013783668;Taip;5;1;0;6
8555;Puriena;Pelėdžiukai;8874823029;Taip;5;0;4;9
8556;Puriena;Pelėdžiukai;3149718901;Taip;2;2;6;10
8557;Puriena;Pelėdžiukai;9041388275;Taip;0;2;0;2
8558;Puriena;Pelėdžiukai;3175917649;Ne;0;0;1;1
8559;Puriena;Pelėdžiukai;8061605125;Taip;5;2;1;8
8560;Puriena;Pelėdžiukai;2579402981;Taip;0;1;1;2
8561;Puriena;Pelėdžiukai;3671297035;Taip;6;0;0;6
8562;Puriena;Pelėdžiukai;2701942325;Taip;0;5;0;5
8563;Puriena;Pelėdžiukai;2267225709;Ne;0;1;2;3
8564;Puriena;Pelėdžiukai;6413337915;Taip;6;0;2;8
8565;Puriena;Pelėdžiukai;4858971990;Taip;0;1;0;1
8566;Puriena;Pelėdžiukai;1417566073;Ne;16;0;0;16
8567;Puriena;Pelėdžiukai;6463129806;Taip;0;1;0;1
8568;Puriena;Pelėdžiukai;4501239330;Taip;0;1;1;2
8569;Puriena;Pelėdžiukai;5341228269;Taip;16;0;0;16
8570;Puriena;Pelėdžiukai;6352605894;Ne;4;0;2;6
8571;Puriena;Pelėdžiukai;6786694796;Taip;16;0;0;16
8572;Puriena;Pelėdžiukai;5080805225;Taip;10;0;2;12
8573;Puriena;Pelėdžiukai;1158768017;Taip;6;1;0;7
8574;Puriena;Voveriukai;3826282438;Taip;8;1;2;11
8575;Puriena;Voveriukai;9453994213;Taip;8;0;2;10
8576;Puriena;Voveriukai;8497070167;Ne;9;1;0;10
8577;Puriena;Voveriukai;4517020977;Ne;7;1;2;10
8578;Puriena;Voveriukai;4283608124;Taip;0;2;1;3
8579;Puriena;Voveriukai;8144488922;Taip;0;2;2;4
8580;Puriena;Voveriukai;8476986855;Taip;0;3;0;3
8581;Puriena;Voveriukai;3627403517;Taip;0;0;4;4
8582;Puriena;Voveriukai;8130975863;Taip;0;2;0;2
8583;Puriena;Voveriukai;2813562677;Taip;0;0;1;1
8584;Puriena;Voveriukai;7120683581;Taip;0;1;3;4
8585;Puriena;Voveriukai;4653085762;Taip;0;11;1;12
8586;Puriena;Voveriukai;3542374463;Taip;6;7;3;16
8587;Puriena;Voveriukai;1933733714;Taip;0;1;0;1
8588;Puriena;Voveriukai;6150437624;Taip;0;1;1;2
8589;Puriena;Voveriukai;8772936125;Taip;0;0;9;9
8590;Puriena;Voveriukai;6428413592;Ne;7;0;4;11
8591;Puriena;Voveriukai;8242140541;Taip;0;0;6;6
8592;Puriena;Voveriukai;4498919764;Taip;12;0;1;13
8593;Puriena;Voveriukai;9729644429;Ne;7;0;0;7
8594;Puriena;Voveriukai;6140294839;Taip;19;0;0;19
8595;Puriena;Voveriukai;3455291312;Taip;11;0;1;12
8596;Puriena;Voveriukai;7066959314;Taip;5;3;1;9
8597;Puriena;Bitučių;9413672989;Ne;0;0;8;8
8598;Puriena;Bitučių;5224135638;Taip;0;0;3;3
8599;Puriena;Bitučių;1175665781;Taip;5;1;0;6
8600;Puriena;Bitučių;6853706997;Taip;3;1;0;4
8601;Puriena;Bitučių;9962011647;Taip;0;0;5;5
8602;Puriena;Bitučių;1339162214;Taip;8;1;0;9
8603;Puriena;Bitučių;9543884311;Taip;0;5;2;7
8604;Puriena;Bitučių;6656013805;Taip;6;0;0;6
8605;Puriena;Bitučių;8022809059;Taip;6;0;1;7
8606;Puriena;Bitučių;5395382717;Taip;0;3;0;3
8607;Puriena;Bitučių;8237149969;Taip;0;1;0;1
8608;Puriena;Bitučių;7481642656;Taip;0;21;0;21
8609;Puriena;Bitučių;8512814466;Taip;0;4;0;4
8610;Puriena;Bitučių;7622407056;Taip;0;0;1;1
8611;Puriena;Bitučių;4017644414;Taip;0;1;2;3
8612;Puriena;Bitučių;8416003733;Taip;0;1;0;1
8613;Puriena;Bitučių;8199607793;Taip;0;0;1;1
8614;Puriena;Bitučių;6780164845;Taip;6;0;2;8
8615;Puriena;Zylutės;7337038503;Taip;12;0;0;12
8616;Puriena;Zylutės;5891404983;Taip;3;2;0;5
8617;Puriena;Zylutės;63196502622;Ne;6;0;0;6
8618;Puriena;Zylutės;9239618299;Taip;0;15;0;15
8619;Puriena;Zylutės;2083071198;Taip;0;4;0;4
8620;Puriena;Zylutės;20286870431;Taip;0;1;0;1
8621;Puriena;Zylutės;8618298134;Taip;7;0;2;9
8622;Puriena;Zylutės;1748337587;Taip;0;0;2;2
8623;Puriena;Zylutės;1820719083;Taip;5;0;2;7
8624;Puriena;Zylutės;2089174669;Taip;0;12;0;12
8625;Puriena;Zylutės;11497629767;Taip;8;1;0;9
8626;Puriena;Zylutės;2146036332;Ne;6;0;0;6
8627;Puriena;Zylutės;2378865002;Taip;0;2;0;2
8628;Puriena;Zylutės;2131343339;Taip;0;1;0;1
8629;Puriena;Zylutės;8213725698;Taip;8;0;0;8
8630;Puriena;Zylutės;8707076857;Taip;0;0;1;1
8631;Puriena;Zylutės;48468411549;Taip;0;2;0;2
8632;Puriena;Zylutės;1703078658;Taip;8;1;0;9
8633;Puriena;Zylutės;1756611673;Taip;6;0;0;6
8634;Puriena;Zylutės;6416145396;Ne;13;0;0;13
8635;Puriena;Zylutės;3031725530;Taip;6;1;0;7
8636;Puriena;Zylutės;6813480086;Ne;0;1;0;1
8637;Puriena;Meškučių;6234132927;Taip;6;2;0;8
8638;Puriena;Meškučių;4563681164;Taip;3;2;0;5
8639;Puriena;Meškučių;3153330970;Taip;10;1;0;11
8640;Puriena;Meškučių;9500729561;Ne;0;1;0;1
8641;Puriena;Meškučių;1238475246;Taip;10;1;0;11
8642;Puriena;Meškučių;5591189546;Taip;0;2;1;3
8643;Puriena;Meškučių;9748726934;Taip;5;1;0;6
8644;Puriena;Meškučių;7466163131;Taip;5;0;1;6
8645;Puriena;Meškučių;8359978283;Taip;0;21;0;21
8646;Puriena;Meškučių;2466609635;Taip;4;2;2;8
8647;Puriena;Meškučių;3309219271;Taip;5;2;0;7
8648;Puriena;Meškučių;9509041179;Taip;10;0;2;12
8649;Puriena;Meškučių;5176663365;Taip;10;1;0;11
8650;Puriena;Meškučių;9961074983;Taip;5;2;2;9
8651;Puriena;Meškučių;3011629747;Taip;11;0;0;11
8652;Puriena;Meškučių;2029981617;Taip;8;1;0;9
8653;Puriena;Meškučių;6185080390;Taip;16;1;0;17
8654;Puriena;Meškučių;3526684967;Taip;8;2;0;10
8655;Puriena;Meškučių;1513909923;Taip;6;0;2;8
8656;Puriena;Meškučių;7556975480;Taip;10;0;5;15
8657;Puriena;Meškučių;2711642252;Taip;8;1;0;9
8658;Puriena;Meškučių;8093664167;Taip;8;1;0;9
8659;Puriena;Nykštukų;1053386081;Taip;6;0;2;8
8660;Puriena;Nykštukų;5469827031;Ne;9;0;3;12
8661;Puriena;Nykštukų;7649596096;Taip;8;0;13;21
8662;Puriena;Nykštukų;2762325241;Taip;15;0;3;18
8663;Puriena;Nykštukų;9907142348;Taip;11;0;1;12
8664;Puriena;Nykštukų;9369786639;Taip;9;0;1;10
8665;Puriena;Nykštukų;4728991133;Taip;0;0;9;9
8666;Puriena;Nykštukų;2344061847;Taip;13;1;0;14
8667;Puriena;Nykštukų;3630564604;Taip;0;3;5;8
8668;Puriena;Nykštukų;9438604106;Taip;7;0;2;9
8669;Puriena;Nykštukų;9379314578;Taip;17;0;1;18
8670;Puriena;Nykštukų;4211784186;Ne;12;0;1;13
8671;Puriena;Nykštukų;1610219365;Ne;7;3;0;10
8672;Puriena;Nykštukų;2146727759;Taip;16;2;1;19
8673;Puriena;Nykštukų;1988826809;Taip;3;1;0;4
8674;Puriena;Nykštukų;6605817147;Taip;5;0;1;6
8675;Puriena;Nykštukų;6271951373;Taip;0;1;8;9
8676;Puriena;Nykštukų;7869104640;Taip;8;8;0;16
8677;Puriena;Ežiukai;6451492815;Taip;0;1;2;3
8678;Puriena;Ežiukai;6612468095;Ne;16;0;0;16
8679;Puriena;Ežiukai;7913847170;Taip;3;1;0;4
8680;Puriena;Ežiukai;8089081251;Taip;18;0;0;18
8681;Puriena;Ežiukai;2830409862;Ne;10;5;0;15
8682;Puriena;Ežiukai;5550321808;Taip;16;0;0;16
8683;Puriena;Ežiukai;8038573068;Taip;0;1;2;3
8684;Puriena;Ežiukai;2624283930;Taip;6;1;0;7
8685;Puriena;Ežiukai;6001659356;Taip;4;3;0;7
8686;Puriena;Ežiukai;5539708916;Ne;10;1;0;11
8687;Puriena;Ežiukai;7335537384;Taip;10;0;0;10
8688;Puriena;Ežiukai;3204824116;Taip;13;0;1;14
8689;Puriena;Ežiukai;4954787474;Ne;17;0;0;17
8690;Puriena;Ežiukai;7720549981;Taip;18;0;0;18
8691;Puriena;Ežiukai;5555076926;Taip;11;0;0;11
8692;Puriena;Ežiukai;2312297583;Taip;0;0;2;2
8693;Puriena;Ežiukai;3232981406;Taip;18;0;0;18
8694;Puriena;Ežiukai;9228372078;Taip;18;0;0;18
8695;Puriena;Ežiukai;5374864513;Taip;21;0;0;21
8696;Puriena;Ežiukai;1737249860;Taip;0;1;0;1
8697;Puriena;Ežiukai;4608801156;Taip;5;1;0;6
8698;Puriena;Ežiukai;6991740430;Taip;0;1;2;3
8699;Puriena;"Boružiukų ";9600515308;Taip;19;0;0;19
8700;Puriena;"Boružiukų ";7985332838;Taip;0;21;0;21
8701;Puriena;"Boružiukų ";9671916745;Taip;4;0;0;4
8702;Puriena;"Boružiukų ";8195902319;Taip;5;0;4;9
8703;Puriena;"Boružiukų ";4587892949;Taip;10;0;2;12
8704;Puriena;"Boružiukų ";9497287421;Taip;0;21;0;21
8705;Puriena;"Boružiukų ";2818282875;Taip;6;0;7;13
8706;Puriena;"Boružiukų ";3215364967;Taip;0;0;2;2
8707;Puriena;"Boružiukų ";7016498639;Taip;15;0;0;15
8708;Puriena;"Boružiukų ";5797970231;Taip;6;2;0;8
8709;Puriena;"Boružiukų ";3382737176;Taip;5;0;0;5
8710;Puriena;"Boružiukų ";8110665629;Taip;0;4;0;4
8711;Puriena;"Boružiukų ";4006267650;Ne;14;3;0;17
8712;Puriena;"Boružiukų ";3440488785;Taip;5;0;6;11
8713;Puriena;"Boružiukų ";4016228982;Taip;21;0;0;21
8714;Puriena;"Boružiukų ";1796123753;Taip;5;0;11;16
8715;Puriena;"Boružiukų ";5277351784;Taip;0;1;0;1
8716;Puriena;"Boružiukų ";9931397038;Taip;0;0;8;8
8717;Puriena;"Zuikučių ";3252190329;Taip;5;0;3;8
8718;Puriena;"Zuikučių ";9907972536;Ne;5;1;0;6
8719;Puriena;"Zuikučių ";4165800035;Taip;0;0;5;5
8720;Puriena;"Zuikučių ";7634536770;Taip;0;1;1;2
8721;Puriena;"Zuikučių ";9423229931;Taip;4;1;0;5
8722;Puriena;"Zuikučių ";8284860687;Taip;6;1;0;7
8723;Puriena;"Zuikučių ";9176303276;Taip;5;9;6;20
8724;Puriena;"Zuikučių ";6941251095;Taip;21;0;0;21
8725;Puriena;"Zuikučių ";4193710604;Taip;0;5;1;6
8726;Puriena;"Zuikučių ";8474426340;Taip;5;0;1;6
8727;Puriena;"Zuikučių ";6227990580;Taip;4;0;0;4
8728;Puriena;"Zuikučių ";2172109284;Taip;0;4;0;4
8729;Puriena;"Zuikučių ";8239919265;Ne;0;0;2;2
8730;Puriena;"Zuikučių ";3094722037;Taip;7;0;0;7
8731;Puriena;"Zuikučių ";6308393533;Taip;8;0;5;13
8732;Puriena;"Zuikučių ";5927216569;Taip;1;0;0;1
8733;Puriena;Skruzdėliukai;2203259310;Taip;0;0;1;1
8734;Puriena;Skruzdėliukai;8478901457;Taip;0;5;1;6
8735;Puriena;Skruzdėliukai;4647433927;Taip;0;21;0;21
8736;Puriena;Skruzdėliukai;5257713434;Taip;0;21;0;21
8737;Puriena;Skruzdėliukai;9106525954;Taip;0;2;0;2
8738;Puriena;Skruzdėliukai;11242620566;Taip;0;1;2;3
8739;Puriena;Skruzdėliukai;6285846517;Taip;0;1;0;1
8740;Puriena;Skruzdėliukai;5999564879;Taip;0;2;0;2
8741;Puriena;Skruzdėliukai;9139110598;Taip;0;1;0;1
8742;Puriena;Skruzdėliukai;5501308683;Taip;0;1;1;2
8743;Puriena;Skruzdėliukai;2663832596;Taip;0;6;0;6
8744;Puriena;Skruzdėliukai;6057477307;Taip;10;0;0;10
8745;Puriena;Skruzdėliukai;4966293604;Taip;0;1;0;1
8746;Puriena;Skruzdėliukai;92604925140;Taip;0;1;0;1
8747;Puriena;Skruzdėliukai;1381379515;Taip;0;1;0;1
8748;Puriena;Skruzdėliukai;1290962809;Taip;0;1;0;1
8749;Puriena;Skruzdėliukai;1263637124;Taip;0;2;0;2
8750;Puriena;Skruzdėliukai;1290933817;Taip;0;1;0;1
8751;Puriena;Skruzdėliukai;8112003551;Taip;0;1;0;1
8752;Pušaitė;Kodėlčiukai;8702361596;Taip;0;1;0;1
8753;Pušaitė;Kodėlčiukai;3832434608;Taip;0;3;0;3
8754;Pušaitė;Kodėlčiukai;4838345510;Taip;0;1;0;1
8755;Pušaitė;Kodėlčiukai;7068451014;Taip;0;1;0;1
8756;Pušaitė;Kodėlčiukai;2253477550;Taip;6;3;0;9
8757;Pušaitė;Kodėlčiukai;6275090953;Taip;0;1;0;1
8758;Pušaitė;Kodėlčiukai;8750774616;Taip;0;1;0;1
8759;Pušaitė;Kodėlčiukai;4198571222;Taip;0;0;1;1
8760;Pušaitė;Kodėlčiukai;2004615252;Taip;0;1;0;1
8761;Pušaitė;Kodėlčiukai;4743105731;Taip;1;0;0;1
8762;Pušaitė;Kodėlčiukai;9391350218;Taip;0;5;0;5
8763;Pušaitė;Kodėlčiukai;2793941689;Taip;14;0;0;14
8764;Pušaitė;Kodėlčiukai;9364887123;Taip;10;2;0;12
8765;Pušaitė;Kodėlčiukai;4326967247;Taip;0;1;0;1
8766;Pušaitė;Kodėlčiukai;5922053969;Taip;6;0;0;6
8767;Pušaitė;Kodėlčiukai;4473930703;Taip;0;1;0;1
8768;Pušaitė;Kodėlčiukai;6775428321;Taip;0;1;1;2
8769;Pušaitė;Kodėlčiukai;4615270419;Taip;7;2;0;9
8770;Pušaitė;Kodėlčiukai;7117784038;Taip;6;2;0;8
8771;Pušaitė;Kodėlčiukai;6186545163;Taip;0;2;0;2
8772;Pušaitė;Saulutės;4511258460;Taip;5;6;3;14
8773;Pušaitė;Saulutės;5422616450;Taip;0;0;2;2
8774;Pušaitė;Saulutės;7237345427;Taip;0;0;2;2
8775;Pušaitė;Saulutės;8931688329;Taip;7;0;0;7
8776;Pušaitė;Saulutės;2254269292;Taip;14;0;0;14
8777;Pušaitė;Saulutės;5306237557;Taip;10;0;0;10
8778;Pušaitė;Saulutės;4234318548;Taip;0;1;3;4
8779;Pušaitė;Saulutės;4883211957;Taip;0;21;0;21
8780;Pušaitė;Saulutės;1384820994;Taip;0;21;0;21
8781;Pušaitė;Saulutės;7480846917;Taip;4;0;0;4
8782;Pušaitė;Saulutės;8355083823;Taip;3;0;3;6
8783;Pušaitė;Saulutės;7291412329;Taip;10;0;1;11
8784;Pušaitė;Saulutės;2543188867;Ne;0;0;2;2
8785;Pušaitė;Saulutės;9577925438;Taip;5;0;0;5
8786;Pušaitė;Saulutės;8914668904;Taip;3;0;0;3
8787;Pušaitė;Zuikučiai;2115591523;Taip;6;0;3;9
8788;Pušaitė;Zuikučiai;8738827821;Taip;0;0;2;2
8789;Pušaitė;Zuikučiai;7477429922;Taip;2;6;0;8
8790;Pušaitė;Zuikučiai;6306133416;Taip;0;1;0;1
8791;Pušaitė;Zuikučiai;2099169654;Taip;5;0;0;5
8792;Pušaitė;Zuikučiai;6355379926;Taip;21;0;0;21
8793;Pušaitė;Zuikučiai;1296700534;Taip;0;1;2;3
8794;Pušaitė;Zuikučiai;51500717235;Taip;16;0;0;16
8795;Pušaitė;Zuikučiai;5398532705;Taip;0;0;6;6
8796;Pušaitė;Zuikučiai;3718196299;Taip;0;2;0;2
8797;Pušaitė;Zuikučiai;1295203136;Taip;0;1;2;3
8798;Pušaitė;Zuikučiai;6259961070;Taip;0;2;0;2
8799;Pušaitė;Zuikučiai;2944418714;Taip;16;0;0;16
8800;Pušaitė;Zuikučiai;3813761666;Taip;5;2;10;17
8801;Pušaitė;Zuikučiai;4762094720;Taip;1;2;3;6
8802;Pušaitė;Zuikučiai;6600314608;Taip;16;0;0;16
8803;Pušaitė;Zuikučiai;2130767942;Taip;5;8;0;13
8804;Pušaitė;Zuikučiai;8155746120;Taip;0;10;0;10
8805;Pušaitė;Zuikučiai;9179757395;Taip;0;1;0;1
8806;Pušaitė;Zuikučiai;8592426606;Taip;4;1;1;6
8807;Pušaitė;Zuikučiai;7251064118;Taip;6;1;1;8
8808;Pušaitė;Vėžliukai;8412276797;Taip;5;0;0;5
8809;Pušaitė;Vėžliukai;1326581025;Taip;0;14;0;14
8810;Pušaitė;Vėžliukai;8135552679;Taip;0;5;0;5
8811;Pušaitė;Vėžliukai;5161142520;Taip;9;0;0;9
8812;Pušaitė;Vėžliukai;3485234259;Taip;6;1;0;7
8813;Pušaitė;Vėžliukai;3014867515;Taip;7;0;0;7
8814;Pušaitė;Vėžliukai;9470667227;Taip;4;3;0;7
8815;Pušaitė;Vėžliukai;6739253961;Taip;1;3;0;4
8816;Pušaitė;Vėžliukai;3014180020;Ne;0;0;2;2
8817;Pušaitė;Vėžliukai;7890577174;Taip;0;3;0;3
8818;Pušaitė;Vėžliukai;7652706756;Taip;10;1;0;11
8819;Pušaitė;Vėžliukai;5318602924;Taip;0;3;0;3
8820;Pušaitė;Vėžliukai;6794867560;Taip;0;0;1;1
8821;Pušaitė;Vėžliukai;6180888008;Taip;2;2;0;4
8822;Pušaitė;Vėžliukai;5296435012;Taip;0;1;0;1
8823;Pušaitė;Vėžliukai;6833083982;Taip;0;1;0;1
8824;Pušaitė;Vėžliukai;5512786073;Taip;2;5;0;7
8825;Pušaitė;Vėžliukai;8399589954;Taip;0;3;0;3
8826;Pušaitė;Vėžliukai;4281125486;Taip;0;7;0;7
8827;Pušaitė;Vėžliukai;2777222076;Taip;9;2;0;11
8828;Pušaitė;Vėžliukai;8459530338;Taip;0;6;0;6
8829;Pušaitė;"Linksmieji nykštukai";9265357004;Taip;10;2;1;13
8830;Pušaitė;"Linksmieji nykštukai";3150144924;Taip;5;0;1;6
8831;Pušaitė;"Linksmieji nykštukai";7520393710;Taip;0;0;1;1
8832;Pušaitė;"Linksmieji nykštukai";4517181474;Taip;0;2;2;4
8833;Pušaitė;"Linksmieji nykštukai";9033615485;Ne;0;2;0;2
8834;Pušaitė;"Linksmieji nykštukai";3130824742;Taip;0;0;1;1
8835;Pušaitė;"Linksmieji nykštukai";4605161267;Taip;15;3;3;21
8836;Pušaitė;"Linksmieji nykštukai";1781601521;Taip;7;0;0;7
8837;Pušaitė;"Linksmieji nykštukai";1024996364;Taip;0;0;1;1
8838;Pušaitė;"Linksmieji nykštukai";4662871524;Taip;0;8;1;9
8839;Pušaitė;"Linksmieji nykštukai";8438652029;Taip;0;0;3;3
8840;Pušaitė;"Linksmieji nykštukai";6578483902;Taip;0;0;1;1
8841;Pušaitė;"Linksmieji nykštukai";9327636862;Taip;0;0;1;1
8842;Pušaitė;"Linksmieji nykštukai";4175909754;Taip;0;5;7;12
8843;Pušaitė;"Linksmieji nykštukai";3788392895;Taip;10;1;1;12
8844;Pušaitė;"Linksmieji nykštukai";3195191374;Taip;0;2;6;8
8845;Pušaitė;"Linksmieji nykštukai";9127444013;Taip;0;0;1;1
8846;Pušaitė;"Linksmieji nykštukai";5422784898;Taip;0;1;1;2
8847;Pušaitė;"Linksmieji nykštukai";5104111840;Taip;6;0;1;7
8848;Pušaitė;"Linksmieji nykštukai";9866431097;Taip;4;0;1;5
8849;Pušaitė;"Linksmieji nykštukai";4564478833;Taip;0;0;1;1
8850;Pušaitė;"Linksmieji nykštukai";4374232593;Taip;7;2;1;10
8851;Pušaitė;"Linksmieji nykštukai";8378313810;Taip;0;1;1;2
8852;Pušaitė;"Kačiukų trobelė";3695016765;Taip;9;0;1;10
8853;Pušaitė;"Kačiukų trobelė";5415680731;Taip;2;1;0;3
8854;Pušaitė;"Kačiukų trobelė";7983115812;Taip;0;2;0;2
8855;Pušaitė;"Kačiukų trobelė";1122112207;Taip;0;5;0;5
8856;Pušaitė;"Kačiukų trobelė";1635528919;Taip;2;6;0;8
8857;Pušaitė;"Kačiukų trobelė";7014914682;Ne;13;0;0;13
8858;Pušaitė;"Kačiukų trobelė";1624587173;Taip;0;1;0;1
8859;Pušaitė;"Kačiukų trobelė";8793102437;Taip;8;8;0;16
8860;Pušaitė;"Kačiukų trobelė";9056933586;Taip;13;2;0;15
8861;Pušaitė;"Kačiukų trobelė";7898355721;Taip;6;0;1;7
8862;Pušaitė;"Kačiukų trobelė";6323180798;Taip;3;0;0;3
8863;Pušaitė;"Kačiukų trobelė";5191894075;Taip;0;12;0;12
8864;Pušaitė;"Kačiukų trobelė";1161519408;Taip;9;2;0;11
8865;Pušaitė;"Kačiukų trobelė";8822285103;Taip;0;5;0;5
8866;Pušaitė;"Kačiukų trobelė";9313564235;Taip;11;1;0;12
8867;Pušaitė;"Kačiukų trobelė";2865062081;Taip;4;1;0;5
8868;Pušaitė;"Kačiukų trobelė";2430891944;Taip;8;0;0;8
8869;Pušaitė;"Kačiukų trobelė";1978339054;Taip;0;1;0;1
8870;Pušaitė;"Kačiukų trobelė";6189116357;Taip;4;0;0;4
8871;Pušaitė;Ežiukai;2090143259;Ne;0;2;1;3
8872;Pušaitė;Ežiukai;2951618391;Taip;0;2;5;7
8873;Pušaitė;Ežiukai;9524002395;Taip;0;2;0;2
8874;Pušaitė;Ežiukai;1111143593;Taip;0;6;0;6
8875;Pušaitė;Ežiukai;5394378197;Taip;0;1;7;8
8876;Pušaitė;Ežiukai;15270671089;Taip;0;1;0;1
8877;Pušaitė;Ežiukai;69869396094;Taip;0;8;1;9
8878;Pušaitė;Ežiukai;3359574190;Taip;0;9;0;9
8879;Pušaitė;Ežiukai;1143122778;Taip;0;5;0;5
8880;Pušaitė;Ežiukai;9461292576;Taip;15;1;0;16
8881;Pušaitė;Ežiukai;5185787803;Taip;0;1;0;1
8882;Pušaitė;Ežiukai;4671293211;Taip;0;2;0;2
8883;Pušaitė;Ežiukai;4101326122;Taip;0;1;1;2
8884;Pušaitė;Ežiukai;8958364766;Taip;0;3;0;3
8885;Pušaitė;Ežiukai;2983890410;Taip;5;1;0;6
8886;Pušaitė;Ežiukai;7575143890;Taip;0;1;0;1
8887;Pušaitė;Ežiukai;7808186865;Taip;0;12;0;12
8888;Pušaitė;Ežiukai;4842783897;Taip;0;5;0;5
8889;Pušaitė;Ežiukai;6472169278;Taip;0;2;0;2
8890;Pušaitė;Ežiukai;8021494509;Taip;0;1;0;1
8891;Pušaitė;Ežiukai;2172342063;Taip;10;2;0;12
8892;Pušaitė;Ežiukai;8309000712;Taip;15;1;0;16
8893;Pušaitė;"Gudručių šalis";8763667682;Taip;3;0;2;5
8894;Pušaitė;"Gudručių šalis";2321256048;Taip;13;0;0;13
8895;Pušaitė;"Gudručių šalis";5488507646;Ne;0;0;1;1
8896;Pušaitė;"Gudručių šalis";1305526154;Taip;16;0;0;16
8897;Pušaitė;"Gudručių šalis";6205900423;Taip;0;21;0;21
8898;Pušaitė;"Gudručių šalis";2078734161;Taip;0;0;5;5
8899;Pušaitė;"Gudručių šalis";2397106198;Taip;6;0;0;6
8900;Pušaitė;"Gudručių šalis";8343949011;Taip;1;0;0;1
8901;Pušaitė;"Gudručių šalis";4101285889;Ne;1;0;6;7
8902;Pušaitė;"Gudručių šalis";3959838346;Taip;16;0;0;16
8903;Pušaitė;"Gudručių šalis";5563772495;Taip;0;1;1;2
8904;Pušaitė;"Gudručių šalis";6356263503;Taip;6;0;2;8
8905;Pušaitė;"Gudručių šalis";4626055123;Taip;1;1;0;2
8906;Pušaitė;"Gudručių šalis";2333176054;Taip;1;0;0;1
8907;Pušaitė;"Gudručių šalis";7066207306;Taip;0;0;7;7
8908;Pušaitė;"Gudručių šalis";6734504906;Taip;6;0;2;8
8909;Pušaitė;"Gudručių šalis";7992567219;Taip;18;0;1;19
8910;Pušaitė;"Gudručių šalis";3380836598;Taip;6;0;0;6
8911;Pušaitė;"Lapučių mokyklėlė";9337726482;Taip;3;1;0;4
8912;Pušaitė;"Lapučių mokyklėlė";5139525557;Taip;0;2;1;3
8913;Pušaitė;"Lapučių mokyklėlė";2666541612;Taip;0;2;0;2
8914;Pušaitė;"Lapučių mokyklėlė";8343225451;Taip;8;2;1;11
8915;Pušaitė;"Lapučių mokyklėlė";1994898058;Taip;0;21;0;21
8916;Pušaitė;"Lapučių mokyklėlė";8551426938;Taip;20;0;0;20
8917;Pušaitė;"Lapučių mokyklėlė";4444972517;Taip;6;0;1;7
8918;Pušaitė;"Lapučių mokyklėlė";7615253880;Taip;15;1;0;16
8919;Pušaitė;"Lapučių mokyklėlė";4508356130;Taip;6;2;8;16
8920;Pušaitė;"Lapučių mokyklėlė";4857214952;Taip;0;3;3;6
8921;Pušaitė;"Lapučių mokyklėlė";4138386134;Taip;0;2;0;2
8922;Pušaitė;"Lapučių mokyklėlė";4103149433;Taip;1;0;0;1
8923;Pušaitė;"Lapučių mokyklėlė";4747611989;Taip;3;0;0;3
8924;Pušaitė;"Lapučių mokyklėlė";3387165403;Taip;5;0;0;5
8925;Pušaitė;"Lapučių mokyklėlė";5281161835;Taip;0;0;3;3
8926;Pušaitė;"Lapučių mokyklėlė";5339878948;Ne;1;3;0;4
8927;Pušaitė;"Lapučių mokyklėlė";3610256789;Taip;16;0;1;17
8928;Pušaitė;"Lapučių mokyklėlė";6576647982;Taip;3;0;0;3
8929;Pušaitė;"Lapučių mokyklėlė";1395577340;Taip;0;2;0;2
8930;Pušaitė;"Lapučių mokyklėlė";1534764228;Taip;7;3;0;10
8931;Pušaitė;"Lapučių mokyklėlė";5328083339;Taip;7;1;0;8
8932;Pušaitė;"Lapučių mokyklėlė";3200968850;Taip;4;8;0;12
8933;Pušaitė;"VOVERIUKAI ";7891007708;Taip;0;1;0;1
8934;Pušaitė;"VOVERIUKAI ";6767281906;Ne;10;3;0;13
8935;Pušaitė;"VOVERIUKAI ";3732377309;Ne;6;1;0;7
8936;Pušaitė;"VOVERIUKAI ";5270528758;Taip;0;1;1;2
8937;Pušaitė;"VOVERIUKAI ";4344634837;Taip;0;21;0;21
8938;Pušaitė;"VOVERIUKAI ";1665030028;Ne;6;1;0;7
8939;Pušaitė;"VOVERIUKAI ";5013833636;Taip;7;1;0;8
8940;Pušaitė;"VOVERIUKAI ";4769806128;Taip;6;0;1;7
8941;Pušaitė;"VOVERIUKAI ";6742576615;Taip;0;1;1;2
8942;Pušaitė;"VOVERIUKAI ";6511940816;Taip;0;21;0;21
8943;Pušaitė;"VOVERIUKAI ";4818407739;Taip;0;21;0;21
8944;Pušaitė;"VOVERIUKAI ";8593282377;Taip;10;0;0;10
8945;Pušaitė;"VOVERIUKAI ";8876092901;Taip;10;0;1;11
8946;Pušaitė;"VOVERIUKAI ";9546541248;Taip;0;0;2;2
8947;Pušaitė;"VOVERIUKAI ";4767321724;Taip;0;21;0;21
8948;Pušaitė;"VOVERIUKAI ";1542239525;Taip;11;1;0;12
8949;Pušaitė;"VOVERIUKAI ";4529006786;Taip;13;0;0;13
8950;Pušaitė;MEŠKUČIAI;5002710062;Taip;0;13;2;15
8951;Pušaitė;MEŠKUČIAI;3052743933;Taip;0;21;0;21
8952;Pušaitė;MEŠKUČIAI;3646346787;Taip;16;2;0;18
8953;Pušaitė;MEŠKUČIAI;6754402783;Ne;0;21;0;21
8954;Pušaitė;MEŠKUČIAI;9180309936;Ne;10;1;0;11
8955;Pušaitė;MEŠKUČIAI;4754791489;Taip;1;6;0;7
8956;Pušaitė;MEŠKUČIAI;2264047794;Taip;5;3;0;8
8957;Pušaitė;MEŠKUČIAI;4278699624;Taip;0;21;0;21
8958;Pušaitė;MEŠKUČIAI;8244793037;Taip;7;2;2;11
8959;Pušaitė;MEŠKUČIAI;3508664946;Taip;0;4;2;6
8960;Pušaitė;MEŠKUČIAI;3239486674;Taip;11;0;0;11
8961;Pušaitė;MEŠKUČIAI;9339706754;Taip;11;0;0;11
8962;Pušaitė;MEŠKUČIAI;2887576870;Taip;3;0;2;5
8963;Pušaitė;MEŠKUČIAI;7583243031;Taip;3;0;1;4
8964;Pušaitė;MEŠKUČIAI;9418440677;Taip;0;21;0;21
8965;Pušaitė;MEŠKUČIAI;4082173648;Taip;0;7;0;7
8966;Pušaitė;PELIUKAI;7103772753;Taip;1;0;0;1
8967;Pušaitė;PELIUKAI;9177861202;Taip;8;1;0;9
8968;Pušaitė;PELIUKAI;9164927041;Taip;6;9;0;15
8969;Pušaitė;PELIUKAI;2454348536;Taip;7;0;0;7
8970;Pušaitė;PELIUKAI;6645711171;Taip;17;4;0;21
8971;Pušaitė;PELIUKAI;9867041220;Taip;11;0;1;12
8972;Pušaitė;PELIUKAI;9031289300;Taip;10;0;1;11
8973;Pušaitė;PELIUKAI;7210529114;Taip;11;1;0;12
8974;Pušaitė;PELIUKAI;2758026755;Taip;0;11;0;11
8975;Pušaitė;PELIUKAI;6851908671;Taip;3;1;1;5
8976;Pušaitė;PELIUKAI;7737524017;Ne;10;1;0;11
8977;Pušaitė;PELIUKAI;2618038364;Taip;0;21;0;21
8978;Pušaitė;PELIUKAI;1180343204;Taip;10;6;0;16
8979;Pušaitė;PELIUKAI;1069369636;Taip;0;4;0;4
8980;Pušaitė;PELIUKAI;5112517007;Taip;0;21;0;21
8981;Pušaitė;PELIUKAI;9261546370;Taip;0;2;0;2
8982;Pušaitė;PELIUKAI;6059415475;Taip;0;21;0;21
8983;"Pušynėlis (Miglos g. 53)";PUMPURĖLIAI;5725602894;Taip;13;1;3;17
8984;"Pušynėlis (Miglos g. 53)";PUMPURĖLIAI;2718421498;Taip;0;4;2;6
8985;"Pušynėlis (Miglos g. 53)";PUMPURĖLIAI;3882064516;Taip;5;4;1;10
8986;"Pušynėlis (Miglos g. 53)";PUMPURĖLIAI;9081582524;Taip;5;4;1;10
8987;"Pušynėlis (Miglos g. 53)";PUMPURĖLIAI;8218331977;Taip;0;2;0;2
8988;"Pušynėlis (Miglos g. 53)";PUMPURĖLIAI;4526807309;Taip;10;2;0;12
8989;"Pušynėlis (Miglos g. 53)";PUMPURĖLIAI;5568838550;Taip;5;1;0;6
8990;"Pušynėlis (Miglos g. 53)";PUMPURĖLIAI;2744665477;Taip;15;0;0;15
8991;"Pušynėlis (Miglos g. 53)";PUMPURĖLIAI;2509111066;Taip;0;2;4;6
8992;"Pušynėlis (Miglos g. 53)";PUMPURĖLIAI;3483639540;Taip;0;2;0;2
8993;"Pušynėlis (Miglos g. 53)";PUMPURĖLIAI;2861000826;Taip;0;10;0;10
8994;"Pušynėlis (Miglos g. 53)";PUMPURĖLIAI;8845728723;Taip;6;0;0;6
8995;"Pušynėlis (Miglos g. 53)";PUMPURĖLIAI;5802582694;Taip;0;0;2;2
8996;"Pušynėlis (Miglos g. 53)";PUMPURĖLIAI;9465619945;Taip;0;2;4;6
8997;"Pušynėlis (Miglos g. 53)";PUMPURĖLIAI;9883505094;Taip;0;5;0;5
8998;"Pušynėlis (Miglos g. 53)";PUMPURĖLIAI;7438923710;Taip;15;1;0;16
8999;"Pušynėlis (Miglos g. 53)";PUMPURĖLIAI;4962270317;Taip;6;1;1;8
9000;"Pušynėlis (Miglos g. 53)";PUMPURĖLIAI;8803766149;Taip;9;1;1;11
9001;"Pušynėlis (Miglos g. 53)";PUMPURĖLIAI;8462742834;Taip;4;2;0;6
9002;"Pušynėlis (Miglos g. 53)";PUMPURĖLIAI;6962705842;Taip;9;1;11;21
9003;"Pušynėlis (Miglos g. 53)";PUMPURĖLIAI;6110878898;Taip;6;0;0;6
9004;"Pušynėlis (Miglos g. 53)";SAULUTĖS;3483007385;Taip;0;2;0;2
9005;"Pušynėlis (Miglos g. 53)";SAULUTĖS;1891728904;Taip;0;2;0;2
9006;"Pušynėlis (Miglos g. 53)";SAULUTĖS;2508640229;Ne;0;0;1;1
9007;"Pušynėlis (Miglos g. 53)";SAULUTĖS;5236219294;Taip;0;0;13;13
9008;"Pušynėlis (Miglos g. 53)";SAULUTĖS;4052132379;Taip;0;0;1;1
9009;"Pušynėlis (Miglos g. 53)";SAULUTĖS;1102029570;Taip;0;0;3;3
9010;"Pušynėlis (Miglos g. 53)";SAULUTĖS;9483417104;Taip;6;0;1;7
9011;"Pušynėlis (Miglos g. 53)";SAULUTĖS;7401066252;Taip;0;0;1;1
9012;"Pušynėlis (Miglos g. 53)";SAULUTĖS;6036296660;Taip;0;2;0;2
9013;"Pušynėlis (Miglos g. 53)";SAULUTĖS;1164201286;Taip;0;2;0;2
9014;"Pušynėlis (Miglos g. 53)";SAULUTĖS;1251787066;Taip;0;0;4;4
9015;"Pušynėlis (Miglos g. 53)";SAULUTĖS;6709692748;Taip;0;2;0;2
9016;"Pušynėlis (Miglos g. 53)";SAULUTĖS;5318223378;Taip;0;0;4;4
9017;"Pušynėlis (Miglos g. 53)";SAULUTĖS;3100230874;Taip;0;18;0;18
9018;"Pušynėlis (Miglos g. 53)";SAULUTĖS;7896617995;Taip;7;0;1;8
9019;"Pušynėlis (Miglos g. 53)";SAULUTĖS;5897839636;Taip;0;5;0;5
9020;"Pušynėlis (Miglos g. 53)";SAULUTĖS;1034336110;Taip;0;7;0;7
9021;"Pušynėlis (Miglos g. 53)";SAULUTĖS;8799095053;Taip;0;2;0;2
9022;"Pušynėlis (Miglos g. 53)";SAULUTĖS;8451160808;Taip;3;0;1;4
9023;"Pušynėlis (Miglos g. 53)";PRIEŠMOKYKLINĖ;25261143142;Taip;0;2;0;2
9024;"Pušynėlis (Miglos g. 53)";PRIEŠMOKYKLINĖ;8742287326;Taip;0;1;0;1
9025;"Pušynėlis (Miglos g. 53)";PRIEŠMOKYKLINĖ;6549217377;Taip;4;1;0;5
9026;"Pušynėlis (Miglos g. 53)";PRIEŠMOKYKLINĖ;2012089695;Taip;0;10;0;10
9027;"Pušynėlis (Miglos g. 53)";PRIEŠMOKYKLINĖ;35538053975;Ne;5;1;0;6
9028;"Pušynėlis (Miglos g. 53)";PRIEŠMOKYKLINĖ;76597184985;Taip;0;1;0;1
9029;"Pušynėlis (Miglos g. 53)";PRIEŠMOKYKLINĖ;7729392498;Taip;0;1;1;2
9030;"Pušynėlis (Miglos g. 53)";PRIEŠMOKYKLINĖ;9192206804;Taip;0;1;0;1
9031;"Pušynėlis (Miglos g. 53)";PRIEŠMOKYKLINĖ;6077698697;Taip;0;1;2;3
9032;"Pušynėlis (Miglos g. 53)";PRIEŠMOKYKLINĖ;4668634909;Taip;0;3;0;3
9033;"Pušynėlis (Miglos g. 53)";PRIEŠMOKYKLINĖ;6560054869;Taip;0;7;0;7
9034;"Pušynėlis (Miglos g. 53)";PRIEŠMOKYKLINĖ;4030500100;Taip;0;4;2;6
9035;"Pušynėlis (Miglos g. 53)";PRIEŠMOKYKLINĖ;8172450090;Taip;0;4;2;6
9036;"Pušynėlis (Miglos g. 53)";PRIEŠMOKYKLINĖ;2793982816;Taip;0;1;0;1
9037;"Pušynėlis (Miglos g. 53)";PRIEŠMOKYKLINĖ;7046421581;Ne;1;1;3;5
9038;"Pušynėlis (Miglos g. 53)";PRIEŠMOKYKLINĖ;9466109315;Ne;0;2;0;2
9039;"Pušynėlis (Miglos g. 53)";PRIEŠMOKYKLINĖ;9154108688;Taip;0;0;3;3
9040;"Pušynėlis (Miglos g. 53)";PRIEŠMOKYKLINĖ;1573574250;Taip;0;1;0;1
9041;"Pušynėlis (Miglos g. 53)";PRIEŠMOKYKLINĖ;3510202379;Taip;0;1;3;4
9042;"Pušynėlis (Miglos g. 53)";PRIEŠMOKYKLINĖ;2765869141;Taip;6;0;0;6
9043;"Pušynėlis (Miglos g. 53)";"TREPSIUKAI (2018.09)";7732546085;Taip;0;0;2;2
9044;"Pušynėlis (Miglos g. 53)";"TREPSIUKAI (2018.09)";4449613959;Taip;8;0;5;13
9045;"Pušynėlis (Miglos g. 53)";"TREPSIUKAI (2018.09)";8933840402;Taip;0;0;6;6
9046;"Pušynėlis (Miglos g. 53)";"TREPSIUKAI (2018.09)";5488832089;Ne;0;0;2;2
9047;"Pušynėlis (Miglos g. 53)";"TREPSIUKAI (2018.09)";6414064067;Taip;5;1;0;6
9048;"Pušynėlis (Miglos g. 53)";"TREPSIUKAI (2018.09)";5670094788;Taip;0;1;3;4
9049;"Pušynėlis (Miglos g. 53)";"TREPSIUKAI (2018.09)";5264481173;Taip;6;0;0;6
9050;"Pušynėlis (Miglos g. 53)";"TREPSIUKAI (2018.09)";1240222214;Taip;0;1;7;8
9051;"Pušynėlis (Miglos g. 53)";"TREPSIUKAI (2018.09)";6318952845;Taip;0;1;1;2
9052;"Pušynėlis (Miglos g. 53)";"TREPSIUKAI (2018.09)";1508282873;Taip;0;0;1;1
9053;"Pušynėlis (Miglos g. 53)";"TREPSIUKAI (2018.09)";7745507151;Taip;0;0;3;3
9054;"Pušynėlis (Miglos g. 53)";"TREPSIUKAI (2018.09)";8372033449;Taip;0;4;0;4
9055;"Pušynėlis (Miglos g. 53)";"TREPSIUKAI (2018.09)";7964828070;Taip;12;0;3;15
9056;"Pušynėlis (Miglos g. 53)";"TREPSIUKAI (2018.09)";4603625624;Taip;0;1;0;1
9057;"Pušynėlis (Miglos g. 53)";"TREPSIUKAI (2018.09)";3682719098;Taip;0;0;1;1
9058;"Pušynėlis (Miglos g. 53)";"TREPSIUKAI (2018.09)";5038740377;Taip;0;1;0;1
9059;Raktelis;LAŠIUKAI;5031703240;Taip;0;1;0;1
9060;Raktelis;LAŠIUKAI;4671391106;Taip;4;0;0;4
9061;Raktelis;LAŠIUKAI;8117871963;Taip;0;11;0;11
9062;Raktelis;LAŠIUKAI;1192775994;Taip;0;2;2;4
9063;Raktelis;LAŠIUKAI;6854111162;Taip;6;1;0;7
9064;Raktelis;LAŠIUKAI;9230053040;Ne;12;2;0;14
9065;Raktelis;LAŠIUKAI;3713386556;Taip;0;3;1;4
9066;Raktelis;LAŠIUKAI;7487507324;Taip;0;1;0;1
9067;Raktelis;LAŠIUKAI;9584164290;Taip;0;1;0;1
9068;Raktelis;LAŠIUKAI;6049420030;Ne;0;4;0;4
9069;Raktelis;LAŠIUKAI;3345708690;Ne;13;1;0;14
9070;Raktelis;LAŠIUKAI;95104355224;Taip;0;1;0;1
9071;Raktelis;LAŠIUKAI;2303286473;Taip;8;1;0;9
9072;Raktelis;LAŠIUKAI;54221331553;Taip;11;1;1;13
9073;Raktelis;LAŠIUKAI;5802689482;Taip;0;13;0;13
9074;Raktelis;LAŠIUKAI;5000264125;Taip;5;3;3;11
9075;Raktelis;LAŠIUKAI;1457880868;Taip;0;3;0;3
9076;Raktelis;LAŠIUKAI;5711863758;Taip;6;3;3;12
9077;Raktelis;LAŠIUKAI;53034039807;Taip;5;4;0;9
9078;Raktelis;LAŠIUKAI;7248631013;Taip;7;0;0;7
9079;Raktelis;LAŠIUKAI;8559758812;Taip;0;7;0;7
9080;Raktelis;LAŠIUKAI;9210856228;Ne;0;1;0;1
9081;Raktelis;BITUTĖS;7265543701;Ne;1;0;0;1
9082;Raktelis;BITUTĖS;5627179884;Taip;0;2;0;2
9083;Raktelis;BITUTĖS;5405322552;Taip;14;0;0;14
9084;Raktelis;BITUTĖS;5492437864;Ne;0;3;1;4
9085;Raktelis;BITUTĖS;5218387088;Taip;1;1;0;2
9086;Raktelis;BITUTĖS;9139322116;Taip;5;0;4;9
9087;Raktelis;BITUTĖS;6929358401;Taip;0;1;0;1
9088;Raktelis;BITUTĖS;9965855682;Taip;4;2;0;6
9089;Raktelis;BITUTĖS;4319176525;Taip;0;0;3;3
9090;Raktelis;BITUTĖS;4317705126;Taip;0;1;0;1
9091;Raktelis;BITUTĖS;4187804340;Ne;0;0;5;5
9092;Raktelis;BITUTĖS;5820028619;Taip;12;3;0;15
9093;Raktelis;BITUTĖS;2652125338;Taip;0;0;1;1
9094;Raktelis;BITUTĖS;3821849812;Taip;10;0;0;10
9095;Raktelis;BITUTĖS;3308623522;Ne;8;3;0;11
9096;Raktelis;BITUTĖS;4059286631;Taip;6;0;0;6
9097;Raktelis;BITUTĖS;5913060415;Taip;5;1;0;6
9098;Raktelis;BITUTĖS;6974263764;Taip;4;4;0;8
9099;Raktelis;BITUTĖS;6932820066;Taip;6;0;0;6
9100;Raktelis;BITUTĖS;2410682193;Taip;1;0;0;1
9101;Raktelis;BITUTĖS;5705825231;Taip;1;0;0;1
9102;Raktelis;BITUTĖS;4615337759;Taip;0;1;0;1
9103;Raktelis;BITUTĖS;4962251215;Taip;4;5;0;9
9104;Raktelis;BITUTĖS;8282429202;Taip;5;3;0;8
9105;Raktelis;BORUŽĖLĖS;7068061170;Taip;19;0;0;19
9106;Raktelis;BORUŽĖLĖS;2361477092;Taip;9;8;0;17
9107;Raktelis;BORUŽĖLĖS;4226277600;Ne;12;0;0;12
9108;Raktelis;BORUŽĖLĖS;2599670832;Taip;6;1;0;7
9109;Raktelis;BORUŽĖLĖS;1757601091;Taip;11;1;0;12
9110;Raktelis;BORUŽĖLĖS;5865484633;Ne;0;1;0;1
9111;Raktelis;BORUŽĖLĖS;4529213150;Taip;0;0;1;1
9112;Raktelis;BORUŽĖLĖS;4936637343;Taip;6;1;0;7
9113;Raktelis;BORUŽĖLĖS;4333191842;Taip;11;0;2;13
9114;Raktelis;BORUŽĖLĖS;9529797517;Taip;0;6;0;6
9115;Raktelis;BORUŽĖLĖS;1618225282;Taip;1;0;4;5
9116;Raktelis;BORUŽĖLĖS;4442395100;Taip;10;0;1;11
9117;Raktelis;BORUŽĖLĖS;5150954686;Taip;19;0;0;19
9118;Raktelis;BORUŽĖLĖS;3490428062;Taip;8;5;0;13
9119;Raktelis;BORUŽĖLĖS;5404673733;Ne;6;1;0;7
9120;Raktelis;BORUŽĖLĖS;1314972335;Taip;8;7;0;15
9121;Raktelis;BORUŽĖLĖS;3343352568;Taip;10;2;0;12
9122;Raktelis;BORUŽĖLĖS;2698820718;Taip;6;5;0;11
9123;Raktelis;BORUŽĖLĖS;7990626447;Taip;5;1;0;6
9124;Raktelis;BORUŽĖLĖS;7459272209;Taip;1;0;1;2
9125;Raktelis;BORUŽĖLĖS;5046450478;Taip;8;1;0;9
9126;Raktelis;BORUŽĖLĖS;1141447274;Ne;6;4;0;10
9127;Raktelis;BORUŽĖLĖS;3456093273;Ne;6;2;0;8
9128;Raktelis;BORUŽĖLĖS;5576511314;Taip;16;0;0;16
9129;Raktelis;KAČIUKAI;5270430511;Taip;1;2;0;3
9130;Raktelis;KAČIUKAI;4622683599;Taip;12;0;0;12
9131;Raktelis;KAČIUKAI;8600632097;Taip;5;2;0;7
9132;Raktelis;KAČIUKAI;7630501672;Taip;6;1;0;7
9133;Raktelis;KAČIUKAI;6007823584;Taip;6;1;0;7
9134;Raktelis;KAČIUKAI;3733786043;Taip;1;1;0;2
9135;Raktelis;KAČIUKAI;8456082594;Taip;3;2;0;5
9136;Raktelis;KAČIUKAI;4676213966;Taip;5;0;0;5
9137;Raktelis;KAČIUKAI;4631375439;Taip;0;6;0;6
9138;Raktelis;KAČIUKAI;6265489540;Taip;0;6;0;6
9139;Raktelis;KAČIUKAI;4160091258;Taip;18;1;0;19
9140;Raktelis;KAČIUKAI;3775306030;Taip;8;1;0;9
9141;Raktelis;KAČIUKAI;6550851582;Taip;3;0;0;3
9142;Raktelis;KAČIUKAI;4009105487;Taip;1;0;3;4
9143;Raktelis;KAČIUKAI;1843086151;Ne;10;1;0;11
9144;Raktelis;KAČIUKAI;1983808547;Taip;0;0;1;1
9145;Raktelis;KAČIUKAI;5042538956;Taip;6;1;0;7
9146;Raktelis;KAČIUKAI;7260767942;Taip;14;1;0;15
9147;Raktelis;KAČIUKAI;6323223256;Taip;9;1;0;10
9148;Raktelis;KAČIUKAI;1123693990;Taip;5;3;0;8
9149;Raktelis;KAČIUKAI;4979657165;Taip;4;1;0;5
9150;Raktelis;KAČIUKAI;2700148968;Taip;0;1;0;1
9151;Raktelis;KIŠKUČIAI;9390692206;Taip;14;0;1;15
9152;Raktelis;KIŠKUČIAI;7847787737;Taip;4;1;0;5
9153;Raktelis;KIŠKUČIAI;7046291082;Taip;10;1;0;11
9154;Raktelis;KIŠKUČIAI;2278227649;Taip;12;0;0;12
9155;Raktelis;KIŠKUČIAI;8992797384;Taip;11;1;0;12
9156;Raktelis;KIŠKUČIAI;9803505110;Taip;16;1;0;17
9157;Raktelis;KIŠKUČIAI;6473692639;Taip;14;0;0;14
9158;Raktelis;KIŠKUČIAI;1668164327;Taip;14;0;0;14
9159;Raktelis;KIŠKUČIAI;6587878165;Taip;5;5;0;10
9160;Raktelis;KIŠKUČIAI;9169797346;Taip;6;8;0;14
9161;Raktelis;KIŠKUČIAI;2262854947;Taip;15;0;2;17
9162;Raktelis;KIŠKUČIAI;3493159224;Taip;8;0;1;9
9163;Raktelis;KIŠKUČIAI;7605822626;Taip;20;0;0;20
9164;Raktelis;NYKŠTUKAI;7865593006;Ne;4;0;0;4
9165;Raktelis;NYKŠTUKAI;4252867688;Taip;10;0;1;11
9166;Raktelis;NYKŠTUKAI;8817859592;Taip;6;0;2;8
9167;Raktelis;NYKŠTUKAI;4578445282;Taip;7;4;0;11
9168;Raktelis;NYKŠTUKAI;9164539135;Taip;9;2;0;11
9169;Raktelis;NYKŠTUKAI;4147382341;Taip;13;0;0;13
9170;Raktelis;NYKŠTUKAI;3968555691;Taip;2;12;0;14
9171;Raktelis;NYKŠTUKAI;2234892629;Taip;10;0;0;10
9172;Raktelis;NYKŠTUKAI;8507551381;Taip;7;0;0;7
9173;Raktelis;NYKŠTUKAI;4764915486;Taip;13;0;0;13
9174;Raktelis;NYKŠTUKAI;4765483387;Taip;6;0;2;8
9175;Raktelis;NYKŠTUKAI;9114203596;Ne;2;5;0;7
9176;Raktelis;NYKŠTUKAI;2803146830;Taip;12;2;0;14
9177;Raktelis;NYKŠTUKAI;1002851704;Taip;7;0;0;7
9178;Raktelis;NYKŠTUKAI;7202523804;Taip;0;6;0;6
9179;Raktelis;PELIUKAI;9599034285;Taip;1;0;0;1
9180;Raktelis;PELIUKAI;1604357851;Taip;0;15;0;15
9181;Raktelis;PELIUKAI;6393143566;Ne;8;2;0;10
9182;Raktelis;PELIUKAI;5758873229;Taip;0;1;0;1
9183;Raktelis;PELIUKAI;2141128125;Taip;4;0;0;4
9184;Raktelis;PELIUKAI;4502236264;Ne;4;2;0;6
9185;Raktelis;PELIUKAI;2754009962;Taip;0;0;1;1
9186;Raktelis;PELIUKAI;3311870918;Taip;6;0;0;6
9187;Raktelis;PELIUKAI;6826993779;Taip;6;0;0;6
9188;Raktelis;PELIUKAI;2044812301;Taip;0;2;3;5
9189;Raktelis;PELIUKAI;2301442262;Taip;4;0;0;4
9190;Raktelis;PELIUKAI;6853881405;Taip;0;1;0;1
9191;Raktelis;PELIUKAI;1120263625;Taip;0;2;1;3
9192;Raktelis;PELIUKAI;9983004779;Ne;2;0;0;2
9193;Raktelis;PELIUKAI;7389910330;Taip;9;1;0;10
9194;Raktelis;AGUONOS;1622504968;Taip;0;0;1;1
9195;Raktelis;AGUONOS;6199212999;Taip;0;4;0;4
9196;Raktelis;AGUONOS;7334310944;Taip;0;1;0;1
9197;Raktelis;AGUONOS;6281687751;Taip;0;2;0;2
9198;Raktelis;AGUONOS;1975411457;Taip;16;0;0;16
9199;Raktelis;AGUONOS;6367875352;Taip;0;0;7;7
9200;Raktelis;AGUONOS;7170546710;Taip;21;0;0;21
9201;Raktelis;AGUONOS;9593639791;Taip;10;6;0;16
9202;Raktelis;AGUONOS;1392036584;Ne;9;6;0;15
9203;Raktelis;AGUONOS;6608224825;Taip;0;9;0;9
9204;Raktelis;AGUONOS;4658530212;Ne;1;2;0;3
9205;Raktelis;AGUONOS;4335378625;Taip;1;0;0;1
9206;Raktelis;AGUONOS;8873203690;Ne;0;7;0;7
9207;Raktelis;AGUONOS;9357757604;Taip;0;9;0;9
9208;Raktelis;AGUONOS;8459980712;Taip;0;2;0;2
9209;Raktelis;AGUONOS;7973137015;Taip;5;9;0;14
9210;Raktelis;AGUONOS;9591285702;Taip;0;2;0;2
9211;Raktelis;AGUONOS;8767785444;Taip;8;8;0;16
9212;Raktelis;AGUONOS;9355380341;Taip;0;0;1;1
9213;Raktelis;LAPIUKŲ;6894769625;Taip;17;1;0;18
9214;Raktelis;LAPIUKŲ;3380295375;Ne;0;6;0;6
9215;Raktelis;LAPIUKŲ;7142823740;Taip;0;1;0;1
9216;Raktelis;LAPIUKŲ;3395720463;Taip;0;6;0;6
9217;Raktelis;LAPIUKŲ;4167194960;Taip;1;0;0;1
9218;Raktelis;LAPIUKŲ;2809458453;Taip;1;4;0;5
9219;Raktelis;LAPIUKŲ;5487606214;Taip;0;1;0;1
9220;Raktelis;LAPIUKŲ;2967941870;Taip;2;0;0;2
9221;Raktelis;LAPIUKŲ;6892006495;Taip;0;7;0;7
9222;Raktelis;LAPIUKŲ;3884068578;Taip;0;2;0;2
9223;Raktelis;LAPIUKŲ;4755892641;Taip;10;2;0;12
9224;Raktelis;LAPIUKŲ;7440866459;Taip;9;1;0;10
9225;Raktelis;LAPIUKŲ;3517484891;Taip;0;4;0;4
9226;Raktelis;LAPIUKŲ;5688795147;Taip;5;2;0;7
9227;Raktelis;LAPIUKŲ;8035618134;Ne;0;1;0;1
9228;Raktelis;LAPIUKŲ;6822021176;Taip;10;0;0;10
9229;Raktelis;LAPIUKŲ;8146076115;Taip;5;1;0;6
9230;Raktelis;LAPIUKŲ;4353473162;Ne;5;0;0;5
9231;Raktelis;LAPIUKŲ;8700012974;Taip;0;1;0;1
9232;Raktelis;LAPIUKŲ;1445359221;Taip;2;0;0;2
9233;Raktelis;LAPIUKŲ;9497620710;Taip;1;0;0;1
9234;Raktelis;PELĖDŽIUKAI;5275588088;Taip;0;6;0;6
9235;Raktelis;PELĖDŽIUKAI;3602722744;Taip;5;0;5;10
9236;Raktelis;PELĖDŽIUKAI;54341630847;Taip;7;2;0;9
9237;Raktelis;PELĖDŽIUKAI;8320696048;Taip;5;1;0;6
9238;Raktelis;PELĖDŽIUKAI;67304194087;Taip;0;1;0;1
9239;Raktelis;PELĖDŽIUKAI;2753402906;Taip;0;2;0;2
9240;Raktelis;PELĖDŽIUKAI;5768653399;Taip;17;0;0;17
9241;Raktelis;PELĖDŽIUKAI;7962509432;Taip;0;2;0;2
9242;Raktelis;PELĖDŽIUKAI;67972824332;Taip;0;2;0;2
9243;Raktelis;PELĖDŽIUKAI;9053427316;Taip;3;2;1;6
9244;Raktelis;PELĖDŽIUKAI;3423529085;Taip;0;1;0;1
9245;Raktelis;PELĖDŽIUKAI;9716191639;Taip;5;1;2;8
9246;Raktelis;PELĖDŽIUKAI;8869030487;Ne;10;0;0;10
9247;Raktelis;PELĖDŽIUKAI;6877934219;Ne;10;1;0;11
9248;Raktelis;PELĖDŽIUKAI;9130613710;Ne;0;8;0;8
9249;Raktelis;PELĖDŽIUKAI;9151796053;Taip;9;0;0;9
9250;Raktelis;PELĖDŽIUKAI;2282754345;Ne;0;2;0;2
9251;Raktelis;PELĖDŽIUKAI;8207675881;Taip;6;1;0;7
9252;Raktelis;PELĖDŽIUKAI;6385127914;Taip;4;0;1;5
9253;Raktelis;PELĖDŽIUKAI;7869495911;Taip;6;1;0;7
9254;Raktelis;PELĖDŽIUKAI;5925441742;Taip;0;2;0;2
9255;Raktelis;PELĖDŽIUKAI;5082785025;Taip;5;0;3;8
9256;Raktelis;MEŠKIUKAI;6703168910;Taip;11;0;0;11
9257;Raktelis;MEŠKIUKAI;8851021346;Taip;12;0;0;12
9258;Raktelis;MEŠKIUKAI;4185763817;Taip;14;2;0;16
9259;Raktelis;MEŠKIUKAI;6685891017;Taip;4;1;0;5
9260;Raktelis;MEŠKIUKAI;3484991718;Taip;7;0;0;7
9261;Raktelis;MEŠKIUKAI;6855863189;Taip;15;1;0;16
9262;Raktelis;MEŠKIUKAI;1026592738;Taip;0;3;0;3
9263;Raktelis;MEŠKIUKAI;7900644404;Taip;19;0;0;19
9264;Raktelis;MEŠKIUKAI;5718804414;Taip;10;0;0;10
9265;Raktelis;MEŠKIUKAI;9718355271;Taip;3;0;2;5
9266;Raktelis;MEŠKIUKAI;2171952119;Taip;12;0;0;12
9267;Raktelis;MEŠKIUKAI;6358227532;Taip;1;3;0;4
9268;Raktelis;MEŠKIUKAI;8608093349;Taip;7;0;0;7
9269;Rasa;Nykštukai;5176175108;Taip;0;1;6;7
9270;Rasa;Nykštukai;3979273111;Taip;0;2;0;2
9271;Rasa;Nykštukai;4847544355;Taip;0;3;0;3
9272;Rasa;Nykštukai;9723040721;Taip;0;10;0;10
9273;Rasa;Nykštukai;7004232909;Taip;0;2;0;2
9274;Rasa;Nykštukai;1223962374;Taip;0;0;11;11
9275;Rasa;Nykštukai;3200377629;Taip;8;5;0;13
9276;Rasa;Nykštukai;1336291828;Taip;0;11;0;11
9277;Rasa;Nykštukai;5861229664;Taip;0;1;0;1
9278;Rasa;Nykštukai;1386880644;Taip;2;3;2;7
9279;Rasa;Nykštukai;7228037580;Taip;0;2;0;2
9280;Rasa;Nykštukai;2540124793;Taip;0;3;2;5
9281;Rasa;Nykštukai;5363748728;Taip;0;3;2;5
9282;Rasa;Nykštukai;2977737634;Taip;10;0;0;10
9283;Rasa;Nykštukai;8310400946;Taip;10;3;0;13
9284;Rasa;Nykštukai;7520665472;Taip;0;13;0;13
9285;Rasa;Nykštukai;7534306402;Taip;10;2;0;12
9286;Rasa;Nykštukai;7326816081;Ne;7;0;2;9
9287;Rasa;Nykštukai;5864894208;Ne;0;0;9;9
9288;Rasa;Meškiukai;8378755600;Taip;15;2;0;17
9289;Rasa;Meškiukai;3073804713;Taip;0;0;3;3
9290;Rasa;Meškiukai;6691161322;Taip;0;0;4;4
9291;Rasa;Meškiukai;8740659600;Taip;0;21;0;21
9292;Rasa;Meškiukai;6874601830;Taip;15;6;0;21
9293;Rasa;Meškiukai;4127921417;Taip;0;1;8;9
9294;Rasa;Meškiukai;7357915584;Taip;0;9;0;9
9295;Rasa;Meškiukai;8314522373;Taip;9;0;0;9
9296;Rasa;Meškiukai;3548008659;Taip;0;21;0;21
9297;Rasa;Meškiukai;3773600344;Taip;19;0;0;19
9298;Rasa;Meškiukai;2371282781;Taip;19;0;0;19
9299;Rasa;Meškiukai;2555108465;Taip;7;0;1;8
9300;Rasa;Meškiukai;1992726664;Taip;6;1;5;12
9301;Rasa;Meškiukai;7843789214;Taip;0;0;1;1
9302;Rasa;Meškiukai;5165588335;Taip;5;1;0;6
9303;Rasa;Meškiukai;7637404588;Taip;0;1;0;1
9304;Rasa;Meškiukai;7502435359;Taip;0;4;5;9
9305;Rasa;Meškiukai;6853285570;Ne;3;0;2;5
9306;Rasa;Meškiukai;8674133653;Taip;0;21;0;21
9307;Rasa;Meškiukai;2840437821;Taip;10;0;0;10
9308;Rasa;Sauliukai;72772661373;Taip;0;1;0;1
9309;Rasa;Sauliukai;6879558965;Taip;2;1;1;4
9310;Rasa;Sauliukai;6356448094;Taip;0;1;0;1
9311;Rasa;Sauliukai;2683897055;Taip;8;0;0;8
9312;Rasa;Sauliukai;2982016133;Ne;0;2;0;2
9313;Rasa;Sauliukai;8052120247;Taip;5;3;0;8
9314;Rasa;Sauliukai;7534548604;Taip;0;2;0;2
9315;Rasa;Sauliukai;3567565920;Taip;0;1;0;1
9316;Rasa;Sauliukai;7565880116;Taip;0;3;0;3
9317;Rasa;Sauliukai;4790859112;Taip;0;1;0;1
9318;Rasa;Sauliukai;5932187584;Taip;0;1;0;1
9319;Rasa;Sauliukai;4260142706;Taip;0;3;0;3
9320;Rasa;Sauliukai;5145978804;Taip;19;1;0;20
9321;Rasa;Sauliukai;5606722133;Taip;2;1;0;3
9322;Rasa;Sauliukai;63673920646;Taip;4;2;0;6
9323;Rasa;Sauliukai;8953448462;Taip;0;1;0;1
9324;Rasa;Smalsučiai;5599182715;Taip;0;5;0;5
9325;Rasa;Smalsučiai;9648034081;Taip;2;1;0;3
9326;Rasa;Smalsučiai;2626361958;Taip;1;0;0;1
9327;Rasa;Smalsučiai;7065597550;Taip;0;1;0;1
9328;Rasa;Smalsučiai;2132535297;Taip;4;1;0;5
9329;Rasa;Smalsučiai;8866896989;Ne;0;6;0;6
9330;Rasa;Smalsučiai;9938280570;Taip;3;1;1;5
9331;Rasa;Smalsučiai;1690518970;Taip;0;9;0;9
9332;Rasa;Smalsučiai;3023088027;Ne;0;1;0;1
9333;Rasa;Smalsučiai;4758605343;Taip;0;0;1;1
9334;Rasa;Smalsučiai;3091012313;Taip;0;2;10;12
9335;Rasa;Smalsučiai;7558966891;Ne;3;1;0;4
9336;Rasa;Smalsučiai;6345614521;Taip;0;1;0;1
9337;Rasa;Smalsučiai;1651905746;Taip;0;2;0;2
9338;Rasa;Smalsučiai;1823276800;Taip;0;1;0;1
9339;Rasa;Smalsučiai;6773004268;Taip;0;2;1;3
9340;Rasa;Smalsučiai;1457384318;Taip;0;1;1;2
9341;Rasa;Smalsučiai;5325275053;Ne;1;1;3;5
9342;Rasa;Smalsučiai;2121070882;Ne;0;6;0;6
9343;Rasa;Smalsučiai;6704162447;Taip;2;1;0;3
9344;Rasa;Smalsučiai;4603188598;Taip;0;1;0;1
9345;Rasa;"Pelėdžiukai ";3387615841;Taip;0;2;0;2
9346;Rasa;"Pelėdžiukai ";8816116600;Taip;3;1;0;4
9347;Rasa;"Pelėdžiukai ";8455168346;Taip;4;0;2;6
9348;Rasa;"Pelėdžiukai ";9056416308;Taip;0;1;0;1
9349;Rasa;"Pelėdžiukai ";3381468321;Taip;5;2;0;7
9350;Rasa;"Pelėdžiukai ";1261868339;Taip;7;0;3;10
9351;Rasa;"Pelėdžiukai ";6553479199;Taip;19;0;0;19
9352;Rasa;"Pelėdžiukai ";4947382314;Taip;0;1;0;1
9353;Rasa;"Pelėdžiukai ";2968464121;Taip;0;2;0;2
9354;Rasa;"Pelėdžiukai ";5816940902;Taip;1;0;0;1
9355;Rasa;"Pelėdžiukai ";4389917247;Taip;16;0;2;18
9356;Rasa;"Pelėdžiukai ";2123838514;Taip;11;0;2;13
9357;Rasa;"Pelėdžiukai ";1288177637;Taip;9;0;3;12
9358;Rasa;"Pelėdžiukai ";8403268732;Taip;7;1;0;8
9359;Rasa;Katinėliai;5885520521;Taip;3;1;0;4
9360;Rasa;Katinėliai;5426981046;Taip;5;1;3;9
9361;Rasa;Katinėliai;3657956842;Ne;5;0;1;6
9362;Rasa;Katinėliai;6891623055;Ne;12;0;2;14
9363;Rasa;Katinėliai;9010812748;Taip;0;1;0;1
9364;Rasa;Katinėliai;7220007488;Taip;5;1;0;6
9365;Rasa;Katinėliai;8235869241;Taip;0;2;1;3
9366;Rasa;Katinėliai;2984661168;Taip;10;0;0;10
9367;Rasa;Katinėliai;4913483444;Taip;11;0;1;12
9368;Rasa;Katinėliai;4734775151;Ne;0;0;5;5
9369;Rasa;Katinėliai;4758138905;Taip;0;0;4;4
9370;Rasa;Katinėliai;9447346901;Taip;11;2;3;16
9371;Rasa;Katinėliai;3631124501;Taip;11;2;0;13
9372;Rasa;Katinėliai;9343039995;Ne;0;2;0;2
9373;Rasa;Katinėliai;4084236196;Taip;5;1;0;6
9374;Rasa;Katinėliai;4498966097;Taip;0;0;1;1
9375;Rasa;Katinėliai;3428261829;Taip;0;0;5;5
9376;Rasa;Katinėliai;2477057223;Taip;0;0;1;1
9377;Rasa;Katinėliai;5134342817;Taip;0;2;0;2
9378;Rasa;Ančiukai;6755131948;Taip;4;0;0;4
9379;Rasa;Ančiukai;1477018184;Taip;4;0;5;9
9380;Rasa;Ančiukai;4018241056;Taip;2;1;0;3
9381;Rasa;Ančiukai;1736903037;Taip;0;1;0;1
9382;Rasa;Ančiukai;4762348187;Taip;5;1;0;6
9383;Rasa;Ančiukai;8622210603;Taip;2;0;1;3
9384;Rasa;Ančiukai;1521328997;Taip;0;0;2;2
9385;Rasa;Ančiukai;3884782148;Taip;3;0;2;5
9386;Rasa;Ančiukai;9230334839;Taip;0;0;1;1
9387;Rasa;Ančiukai;8574946856;Taip;3;2;2;7
9388;Rasa;Ančiukai;6442933249;Taip;9;0;0;9
9389;Rasa;Ančiukai;4979105526;Ne;0;0;6;6
9390;Rasa;"Vyturiukai ";7028605422;Taip;6;0;3;9
9391;Rasa;"Vyturiukai ";9599510902;Taip;5;0;1;6
9392;Rasa;"Vyturiukai ";2800420481;Taip;0;1;0;1
9393;Rasa;"Vyturiukai ";5869253167;Taip;0;0;1;1
9394;Rasa;"Vyturiukai ";7037958994;Taip;6;1;0;7
9395;Rasa;"Vyturiukai ";8236785255;Taip;6;4;1;11
9396;Rasa;"Vyturiukai ";6887471189;Taip;2;1;5;8
9397;Rasa;"Vyturiukai ";4694111253;Taip;5;1;0;6
9398;Rasa;"Vyturiukai ";2347639286;Ne;12;0;3;15
9399;Rasa;"Vyturiukai ";1206005039;Taip;9;1;0;10
9400;Rasa;"Vyturiukai ";9788282861;Taip;0;2;1;3
9401;Rasa;"Vyturiukai ";2711923397;Ne;2;0;0;2
9402;Rasa;"Vyturiukai ";2769096357;Taip;6;0;1;7
9403;Rasa;"Vyturiukai ";6883073764;Taip;7;1;5;13
9404;Rasa;"Vyturiukai ";9706428782;Ne;2;8;0;10
9405;Rasa;"Vyturiukai ";7043271718;Ne;7;1;5;13
9406;Rasa;"Vyturiukai ";6575864256;Taip;6;0;2;8
9407;Rasa;Voveriukai;4111850024;Taip;7;1;1;9
9408;Rasa;Voveriukai;2190948879;Taip;20;0;0;20
9409;Rasa;Voveriukai;1978999728;Ne;0;0;5;5
9410;Rasa;Voveriukai;3546684695;Taip;10;0;0;10
9411;Rasa;Voveriukai;4010262461;Taip;5;4;0;9
9412;Rasa;Voveriukai;5740754301;Taip;0;0;1;1
9413;Rasa;Voveriukai;5977524939;Taip;0;0;1;1
9414;Rasa;Voveriukai;1592174114;Taip;0;0;6;6
9415;Rasa;Voveriukai;1564194649;Taip;10;0;1;11
9416;Rasa;Voveriukai;1764959761;Taip;0;0;1;1
9417;Rasa;Voveriukai;1765617605;Taip;0;0;1;1
9418;Rasa;Voveriukai;1733179752;Taip;0;3;0;3
9419;Rasa;Voveriukai;2895124729;Ne;4;4;0;8
9420;Rasa;Voveriukai;8469342353;Taip;0;5;1;6
9421;Rasa;Voveriukai;1679709767;Taip;0;1;14;15
9422;Rasa;Voveriukai;5622110823;Ne;5;3;3;11
9423;Rasa;Voveriukai;6221754830;Taip;10;1;0;11
9424;Rasa;Voveriukai;7218250981;Ne;14;1;1;16
9425;Rasa;"DRUGELIAI ";6621628020;Taip;21;0;0;21
9426;Rasa;"DRUGELIAI ";9959160342;Taip;21;0;0;21
9427;Rasa;"DRUGELIAI ";5761013588;Taip;5;0;16;21
9428;Rasa;"DRUGELIAI ";7220103314;Taip;0;5;2;7
9429;Rasa;"DRUGELIAI ";5517138335;Taip;20;1;0;21
9430;Rasa;"DRUGELIAI ";9506388242;Taip;0;16;0;16
9431;Rasa;"DRUGELIAI ";4188303400;Taip;5;0;2;7
9432;Rasa;"DRUGELIAI ";5483943978;Taip;8;3;0;11
9433;Rasa;"DRUGELIAI ";7251815682;Taip;17;0;0;17
9434;Rasa;"DRUGELIAI ";8702962863;Taip;2;5;0;7
9435;Rasa;"DRUGELIAI ";6291089659;Taip;0;0;4;4
9436;Rasa;"DRUGELIAI ";4183378344;Ne;2;0;3;5
9437;Rasa;"DRUGELIAI ";6314411900;Ne;2;0;3;5
9438;Rasa;Zuikučiai;7265752821;Taip;5;0;7;12
9439;Rasa;Zuikučiai;2804115700;Ne;6;0;0;6
9440;Rasa;Zuikučiai;8841534992;Taip;6;1;0;7
9441;Rasa;Zuikučiai;8027532547;Ne;15;2;4;21
9442;Rasa;Zuikučiai;3470054190;Ne;5;0;3;8
9443;Rasa;Zuikučiai;8180141204;Taip;0;4;0;4
9444;Rasa;Zuikučiai;7253736220;Taip;8;2;0;10
9445;Rasa;Zuikučiai;4940758709;Taip;10;10;0;20
9446;Rasa;Zuikučiai;7091899236;Taip;10;3;1;14
9447;Rasa;Zuikučiai;6574998939;Taip;12;0;0;12
9448;Rasa;Zuikučiai;7556723960;Ne;21;1;0;22
9449;Rasa;Zuikučiai;4212798846;Taip;10;2;2;14
9450;Rasa;Zuikučiai;7585566403;Taip;2;1;0;3
9451;Rasa;Zuikučiai;6505001743;Taip;15;1;0;16
9452;Rasa;Zuikučiai;6780996150;Taip;4;1;1;6
9453;Rasa;Širdelė;8424049317;Taip;0;12;1;13
9454;Rasa;Širdelė;8236464670;Taip;9;4;0;13
9455;Rasa;Širdelė;6976298054;Taip;0;17;0;17
9456;Rasa;Širdelė;3668598028;Taip;0;3;0;3
9457;Rasa;Širdelė;2333938367;Taip;0;1;0;1
9458;Rasa;Širdelė;5719253028;Taip;0;12;1;13
9459;Rasa;Širdelė;9140875020;Ne;6;12;0;18
9460;Rasa;Širdelė;5710220699;Taip;0;2;0;2
9461;Rasa;Širdelė;4694382836;Taip;10;1;0;11
9462;Rasa;Širdelė;1796573723;Taip;0;6;0;6
9463;Rasa;Širdelė;3535655117;Taip;8;3;0;11
9464;Rasa;Širdelė;4361959446;Ne;0;3;0;3
9465;Rasa;Širdelė;3215464914;Taip;11;1;0;12
9466;Rasa;Širdelė;5523764310;Taip;7;2;3;12
9467;Rasa;Širdelė;6760723624;Taip;7;2;4;13
9468;Rasa;Širdelė;6606982242;Taip;0;2;0;2
9469;Rasa;Širdelė;1447258806;Taip;17;0;0;17
9470;Rasa;Širdelė;1627996663;Taip;19;2;0;21
9471;Riešutėlis;Viščiukų;7071757771;Taip;4;0;0;4
9472;Riešutėlis;Viščiukų;6626441225;Taip;6;0;1;7
9473;Riešutėlis;Viščiukų;5013456470;Ne;9;0;0;9
9474;Riešutėlis;Viščiukų;6906373822;Taip;11;1;0;12
9475;Riešutėlis;Viščiukų;4636191548;Taip;0;0;21;21
9476;Riešutėlis;Viščiukų;2734001106;Taip;17;0;0;17
9477;Riešutėlis;Viščiukų;2493171003;Taip;8;5;0;13
9478;Riešutėlis;Viščiukų;5133625078;Taip;7;4;0;11
9479;Riešutėlis;Viščiukų;2235912189;Taip;1;0;0;1
9480;Riešutėlis;Viščiukų;9864636983;Taip;8;0;1;9
9481;Riešutėlis;Viščiukų;4429903561;Taip;0;0;21;21
9482;Riešutėlis;Viščiukų;5317904812;Taip;0;0;4;4
9483;Riešutėlis;Viščiukų;8235524536;Taip;1;1;0;2
9484;Riešutėlis;Viščiukų;7795124495;Taip;7;0;14;21
9485;Riešutėlis;Viščiukų;2832538856;Taip;0;0;21;21
9486;Riešutėlis;Viščiukų;3730909181;Taip;16;0;0;16
9487;Riešutėlis;"Riešutėliai ";3800733442;Taip;10;2;0;12
9488;Riešutėlis;"Riešutėliai ";2117939721;Taip;0;0;1;1
9489;Riešutėlis;"Riešutėliai ";1343776985;Taip;5;0;1;6
9490;Riešutėlis;"Riešutėliai ";5915019363;Taip;7;6;0;13
9491;Riešutėlis;"Riešutėliai ";2207907790;Taip;10;0;0;10
9492;Riešutėlis;"Riešutėliai ";9699503472;Taip;0;0;7;7
9493;Riešutėlis;"Riešutėliai ";2098369052;Taip;11;0;0;11
9494;Riešutėlis;"Riešutėliai ";1426700414;Taip;12;0;5;17
9495;Riešutėlis;"Riešutėliai ";8539906445;Taip;5;2;0;7
9496;Riešutėlis;"Riešutėliai ";5873443383;Taip;0;0;3;3
9497;Riešutėlis;"Riešutėliai ";2301247729;Taip;0;7;0;7
9498;Riešutėlis;"Riešutėliai ";3602707130;Taip;7;2;0;9
9499;Riešutėlis;"Riešutėliai ";8991963843;Taip;5;1;0;6
9500;Riešutėlis;"Riešutėliai ";9318640304;Taip;6;0;0;6
9501;Riešutėlis;"Riešutėliai ";4293402095;Taip;1;1;0;2
9502;Riešutėlis;"Riešutėliai ";8917451081;Taip;0;7;0;7
9503;Riešutėlis;"Riešutėliai ";4698338374;Taip;5;3;1;9
9504;Riešutėlis;"Riešutėliai ";3345064565;Taip;0;1;0;1
9505;Riešutėlis;"Riešutėliai ";2560507294;Taip;0;0;1;1
9506;Riešutėlis;"Riešutėliai ";9078282526;Taip;0;1;3;4
9507;Riešutėlis;"Riešutėliai ";6762306583;Taip;10;3;0;13
9508;Riešutėlis;Ežiukai;7030346495;Taip;8;7;0;15
9509;Riešutėlis;Ežiukai;9750713954;Taip;7;3;0;10
9510;Riešutėlis;Ežiukai;7601776182;Taip;0;1;0;1
9511;Riešutėlis;Ežiukai;7381623086;Ne;11;1;0;12
9512;Riešutėlis;Ežiukai;9964688413;Taip;8;1;0;9
9513;Riešutėlis;Ežiukai;1548585448;Taip;0;1;1;2
9514;Riešutėlis;Ežiukai;8954127616;Ne;11;1;6;18
9515;Riešutėlis;Ežiukai;2092933906;Taip;6;8;0;14
9516;Riešutėlis;Ežiukai;6813024366;Taip;14;2;0;16
9517;Riešutėlis;Ežiukai;7913381005;Taip;5;7;0;12
9518;Riešutėlis;Ežiukai;3460145784;Taip;0;1;0;1
9519;Riešutėlis;Ežiukai;8480059272;Taip;10;2;0;12
9520;Riešutėlis;Ežiukai;5728858361;Taip;3;1;1;5
9521;Riešutėlis;Ežiukai;5327627748;Taip;10;6;1;17
9522;Riešutėlis;Ežiukai;6259158270;Taip;0;1;3;4
9523;Riešutėlis;Ežiukai;6194259707;Taip;0;3;5;8
9524;Riešutėlis;Ežiukai;2837471235;Taip;5;10;0;15
9525;Riešutėlis;Ežiukai;2699984170;Taip;0;7;0;7
9526;Riešutėlis;Ežiukai;7050440691;Taip;6;1;2;9
9527;Riešutėlis;Ežiukai;8066712255;Ne;0;0;2;2
9528;Riešutėlis;Ežiukai;3577669231;Taip;0;2;0;2
9529;Riešutėlis;Ežiukai;9670912357;Ne;5;0;0;5
9530;Riešutėlis;Ežiukai;1818130297;Taip;0;2;0;2
9531;Riešutėlis;Ežiukai;6284614328;Taip;0;1;5;6
9532;Riešutėlis;Pelėdžiukai;3975540383;Ne;0;0;1;1
9533;Riešutėlis;Pelėdžiukai;1705599429;Taip;5;1;3;9
9534;Riešutėlis;Pelėdžiukai;4116506453;Taip;0;0;1;1
9535;Riešutėlis;Pelėdžiukai;2467739101;Taip;0;1;0;1
9536;Riešutėlis;Pelėdžiukai;2587460110;Taip;13;0;1;14
9537;Riešutėlis;Pelėdžiukai;6147780439;Taip;5;2;1;8
9538;Riešutėlis;Pelėdžiukai;3287685792;Taip;0;2;2;4
9539;Riešutėlis;Pelėdžiukai;1811701628;Taip;1;0;15;16
9540;Riešutėlis;Pelėdžiukai;5183264581;Taip;0;1;0;1
9541;Riešutėlis;Pelėdžiukai;4866613045;Taip;0;0;14;14
9542;Riešutėlis;Pelėdžiukai;6121386391;Taip;0;7;0;7
9543;Riešutėlis;Pelėdžiukai;4448024452;Taip;4;0;1;5
9544;Riešutėlis;Pelėdžiukai;3251066115;Taip;5;5;0;10
9545;Riešutėlis;Pelėdžiukai;4808684145;Taip;0;3;1;4
9546;Riešutėlis;Pelėdžiukai;4897581681;Taip;11;0;1;12
9547;Riešutėlis;Pelėdžiukai;7256075146;Taip;0;4;0;4
9548;Riešutėlis;Pelėdžiukai;5443448616;Taip;5;4;0;9
9549;Riešutėlis;Pelėdžiukai;9598824163;Taip;0;2;2;4
9550;Riešutėlis;Pelėdžiukai;8839482370;Taip;9;0;0;9
9551;Riešutėlis;Pelėdžiukai;4692384639;Ne;0;0;4;4
9552;Riešutėlis;Meškiukai;5537309549;Taip;0;3;2;5
9553;Riešutėlis;Meškiukai;1091941952;Taip;0;2;0;2
9554;Riešutėlis;Meškiukai;8271632629;Taip;0;1;0;1
9555;Riešutėlis;Meškiukai;4898775561;Taip;0;1;0;1
9556;Riešutėlis;Meškiukai;2097580659;Taip;0;3;1;4
9557;Riešutėlis;Meškiukai;7987368969;Taip;5;3;0;8
9558;Riešutėlis;Meškiukai;65873300738;Taip;0;4;0;4
9559;Riešutėlis;Meškiukai;26781529460;Taip;9;1;1;11
9560;Riešutėlis;Meškiukai;1936519033;Taip;5;2;0;7
9561;Riešutėlis;Meškiukai;4131218911;Taip;10;3;0;13
9562;Riešutėlis;Meškiukai;4276034784;Taip;0;5;0;5
9563;Riešutėlis;Meškiukai;4344185375;Taip;0;6;0;6
9564;Riešutėlis;Meškiukai;6594928740;Ne;8;1;0;9
9565;Riešutėlis;Meškiukai;1623681835;Taip;1;2;0;3
9566;Riešutėlis;Meškiukai;2566084613;Taip;16;1;0;17
9567;Riešutėlis;Meškiukai;1640383686;Taip;0;4;0;4
9568;Riešutėlis;Meškiukai;8087180983;Taip;5;1;3;9
9569;Riešutėlis;Meškiukai;16561622902;Taip;0;3;1;4
9570;Riešutėlis;Meškiukai;2611705234;Ne;0;3;0;3
9571;Riešutėlis;Meškiukai;4404544549;Taip;0;2;0;2
9572;Riešutėlis;Meškiukai;1455509576;Ne;0;3;1;4
9573;Riešutėlis;Meškiukai;1709857621;Taip;0;2;1;3
9574;Riešutėlis;Kiškučiai;9297835044;Taip;21;0;0;21
9575;Riešutėlis;Kiškučiai;9086474785;Taip;4;0;0;4
9576;Riešutėlis;Kiškučiai;3363757821;Ne;6;1;0;7
9577;Riešutėlis;Kiškučiai;2581250615;Taip;3;0;4;7
9578;Riešutėlis;Kiškučiai;8445984114;Ne;16;1;0;17
9579;Riešutėlis;Kiškučiai;9357375649;Taip;7;3;0;10
9580;Riešutėlis;Kiškučiai;9500744921;Ne;7;0;0;7
9581;Riešutėlis;Kiškučiai;4851336076;Taip;4;8;0;12
9582;Riešutėlis;Kiškučiai;6705754238;Taip;0;6;1;7
9583;Riešutėlis;Kiškučiai;9964105252;Ne;3;1;0;4
9584;Riešutėlis;Kiškučiai;5846061115;Taip;3;0;1;4
9585;Riešutėlis;Kiškučiai;2618556733;Taip;15;1;0;16
9586;Riešutėlis;Kiškučiai;2674972275;Taip;4;0;3;7
9587;Riešutėlis;Kiškučiai;9995814717;Taip;5;0;0;5
9588;Riešutėlis;Voveriukų;5995176001;Taip;0;1;0;1
9589;Riešutėlis;Voveriukų;5598052531;Ne;0;2;1;3
9590;Riešutėlis;Voveriukų;8751571852;Taip;0;1;0;1
9591;Riešutėlis;Voveriukų;6303767779;Taip;0;1;0;1
9592;Riešutėlis;Voveriukų;2430518637;Taip;0;2;1;3
9593;Riešutėlis;Voveriukų;1457008581;Taip;0;1;0;1
9594;Riešutėlis;Voveriukų;1638021880;Taip;4;4;0;8
9595;Riešutėlis;Voveriukų;7225365172;Taip;0;3;0;3
9596;Riešutėlis;Voveriukų;8750531305;Taip;0;2;0;2
9597;Riešutėlis;Voveriukų;5479780116;Taip;0;1;0;1
9598;Riešutėlis;Voveriukų;9839084885;Taip;0;1;0;1
9599;Riešutėlis;Voveriukų;4451419273;Ne;0;15;0;15
9600;Riešutėlis;Voveriukų;9040123535;Taip;0;1;0;1
9601;Riešutėlis;Voveriukų;6928558714;Taip;0;8;0;8
9602;Riešutėlis;Voveriukų;3970874098;Taip;0;1;0;1
9603;Riešutėlis;Voveriukų;8012201566;Taip;0;3;0;3
9604;Riešutėlis;Voveriukų;7198434243;Taip;0;1;0;1
9605;Riešutėlis;Voveriukų;4581184004;Taip;3;0;1;4
9606;Riešutėlis;Voveriukų;1941869661;Ne;0;1;0;1
9607;Riešutėlis;Voveriukų;9023304543;Taip;0;4;0;4
9608;Riešutėlis;Saulutės;4004669930;Taip;0;3;3;6
9609;Riešutėlis;Saulutės;6721758785;Taip;0;5;1;6
9610;Riešutėlis;Saulutės;3694146893;Taip;0;1;0;1
9611;Riešutėlis;Saulutės;1748151109;Taip;6;4;1;11
9612;Riešutėlis;Saulutės;8504832383;Taip;10;0;0;10
9613;Riešutėlis;Saulutės;6292679662;Taip;0;0;5;5
9614;Riešutėlis;Saulutės;8738716660;Taip;0;3;2;5
9615;Riešutėlis;Saulutės;4828635362;Taip;0;2;0;2
9616;Riešutėlis;Saulutės;6635909614;Taip;0;1;0;1
9617;Riešutėlis;Saulutės;1196740726;Taip;0;3;3;6
9618;Riešutėlis;Saulutės;8415858895;Taip;5;1;0;6
9619;Riešutėlis;Saulutės;4498718519;Ne;0;2;2;4
9620;Riešutėlis;Saulutės;5753609922;Taip;0;2;1;3
9621;Riešutėlis;Saulutės;1860995033;Taip;0;8;13;21
9622;Riešutėlis;Saulutės;5013754772;Taip;5;0;1;6
9623;Riešutėlis;Saulutės;7154361660;Taip;16;3;0;19
9624;Riešutėlis;Saulutės;8677172126;Taip;6;0;1;7
9625;Riešutėlis;Saulutės;2395391926;Taip;3;0;1;4
9626;Riešutėlis;Saulutės;2572642260;Taip;0;0;5;5
9627;Riešutėlis;Saulutės;3544780386;Taip;0;0;4;4
9628;Riešutėlis;"Boruželės ";4118652467;Ne;0;21;0;21
9629;Riešutėlis;"Boruželės ";7663823906;Taip;10;3;0;13
9630;Riešutėlis;"Boruželės ";5336618381;Taip;4;0;0;4
9631;Riešutėlis;"Boruželės ";7327578507;Taip;10;0;0;10
9632;Riešutėlis;"Boruželės ";6368610810;Taip;0;2;0;2
9633;Riešutėlis;"Boruželės ";7313602281;Taip;1;0;2;3
9634;Riešutėlis;"Boruželės ";9815988800;Taip;9;1;0;10
9635;Riešutėlis;"Boruželės ";6681930005;Taip;0;0;1;1
9636;Riešutėlis;"Boruželės ";2352984379;Taip;10;7;1;18
9637;Riešutėlis;"Boruželės ";3152100512;Taip;15;0;2;17
9638;Riešutėlis;"Boruželės ";2238641969;Taip;6;0;3;9
9639;Riešutėlis;"Boruželės ";6217500325;Taip;0;21;0;21
9640;Riešutėlis;"Boruželės ";1058206787;Taip;0;0;1;1
9641;Riešutėlis;"Boruželės ";9198289423;Taip;5;2;0;7
9642;Riešutėlis;"Boruželės ";1282121190;Taip;6;2;0;8
9643;Riešutėlis;"Boruželės ";7259198785;Ne;5;0;2;7
9644;Riešutėlis;"Boruželės ";2875416610;Taip;8;1;0;9
9645;Riešutėlis;"Bitutės ";8498902448;Taip;0;2;3;5
9646;Riešutėlis;"Bitutės ";2498093110;Taip;5;1;0;6
9647;Riešutėlis;"Bitutės ";2459494071;Taip;0;0;2;2
9648;Riešutėlis;"Bitutės ";3931422170;Taip;0;0;10;10
9649;Riešutėlis;"Bitutės ";8265627960;Taip;2;5;0;7
9650;Riešutėlis;"Bitutės ";4591910912;Taip;3;0;0;3
9651;Riešutėlis;"Bitutės ";9285782325;Ne;0;6;0;6
9652;Riešutėlis;"Bitutės ";7473054556;Taip;1;1;1;3
9653;Riešutėlis;"Bitutės ";8996456595;Taip;0;3;0;3
9654;Riešutėlis;"Bitutės ";3592271009;Taip;7;6;1;14
9655;Riešutėlis;"Bitutės ";6815804556;Taip;0;1;0;1
9656;Riešutėlis;"Bitutės ";1626888090;Taip;5;1;0;6
9657;Riešutėlis;"Bitutės ";4358354602;Taip;9;1;0;10
9658;Riešutėlis;Drugelių;8266735624;Taip;0;1;0;1
9659;Riešutėlis;Drugelių;4776231497;Taip;0;1;0;1
9660;Riešutėlis;Drugelių;8578903763;Taip;0;6;0;6
9661;Riešutėlis;Drugelių;5811657782;Taip;5;6;1;12
9662;Riešutėlis;Drugelių;4221375847;Ne;0;1;0;1
9663;Riešutėlis;Drugelių;1942944625;Taip;0;3;0;3
9664;Riešutėlis;Drugelių;8845709386;Taip;0;6;0;6
9665;Riešutėlis;Drugelių;8352146446;Taip;13;1;0;14
9666;Riešutėlis;Drugelių;8180618419;Taip;0;1;0;1
9667;Riešutėlis;Drugelių;5412882446;Taip;0;5;3;8
9668;Riešutėlis;Drugelių;8020533200;Taip;5;5;0;10
9669;Riešutėlis;Drugelių;1164273595;Taip;10;1;0;11
9670;Riešutėlis;Drugelių;8918753084;Taip;0;1;1;2
9671;Riešutėlis;Drugelių;3836374000;Taip;0;2;0;2
9672;Riešutėlis;Drugelių;8016820352;Taip;0;1;0;1
9673;Riešutėlis;Drugelių;3975091711;Taip;0;3;3;6
9674;Riešutėlis;Drugelių;3071643137;Taip;0;1;0;1
9675;Riešutėlis;Drugelių;2599147931;Taip;0;1;0;1
9676;Riešutėlis;Drugelių;3151689985;Taip;4;1;0;5
9677;Riešutėlis;Nykštukų;1858791074;Taip;9;0;0;9
9678;Riešutėlis;Nykštukų;1006119133;Taip;0;1;0;1
9679;Riešutėlis;Nykštukų;3759837057;Taip;0;6;15;21
9680;Riešutėlis;Nykštukų;4740516426;Taip;12;0;1;13
9681;Riešutėlis;Nykštukų;3150141050;Taip;3;0;3;6
9682;Riešutėlis;Nykštukų;6580050526;Taip;10;0;0;10
9683;Riešutėlis;Nykštukų;4810919435;Taip;0;0;8;8
9684;Riešutėlis;Nykštukų;2736824231;Taip;13;0;0;13
9685;Riešutėlis;Nykštukų;2378301886;Taip;10;0;0;10
9686;Riešutėlis;Nykštukų;2483793992;Taip;12;1;0;13
9687;Riešutėlis;Nykštukų;5262881964;Taip;4;0;2;6
9688;Riešutėlis;Nykštukų;4328166135;Taip;5;2;1;8
9689;Riešutėlis;Nykštukų;9052991215;Taip;0;10;6;16
9690;Riešutėlis;Nykštukų;6582898708;Taip;5;0;5;10
9691;Riešutėlis;Nykštukų;6318150385;Taip;3;0;2;5
9692;Riešutėlis;Nykštukų;4042719626;Ne;16;0;0;16
9693;Riešutėlis;Nykštukų;5078051087;Taip;13;0;0;13
9694;Rytas;Geniukų;4435466932;Taip;12;0;0;12
9695;Rytas;Vyturėlių;1803237458;Taip;12;0;0;12
9696;Rytas;Voveriukų;5410353706;Taip;12;0;0;12
9697;Ramunėlė;SAULUTĖS;3852734401;Taip;0;1;0;1
9698;Ramunėlė;SAULUTĖS;1192743154;Taip;0;5;0;5
9699;Ramunėlė;SAULUTĖS;5714771643;Taip;0;3;0;3
9700;Ramunėlė;SAULUTĖS;1483391590;Taip;0;3;0;3
9701;Ramunėlė;SAULUTĖS;4209191105;Taip;0;3;0;3
9702;Ramunėlė;SAULUTĖS;9927068798;Taip;7;3;1;11
9703;Ramunėlė;SAULUTĖS;7219400182;Taip;0;7;0;7
9704;Ramunėlė;SAULUTĖS;3779769727;Taip;0;4;0;4
9705;Ramunėlė;SAULUTĖS;5605444408;Taip;3;1;0;4
9706;Ramunėlė;SAULUTĖS;8912978935;Taip;0;3;0;3
9707;Ramunėlė;SAULUTĖS;1618282165;Taip;0;0;2;2
9708;Ramunėlė;SAULUTĖS;9533155706;Taip;5;2;0;7
9709;Ramunėlė;SAULUTĖS;6595858698;Taip;0;1;0;1
9710;Ramunėlė;SAULUTĖS;3109623760;Taip;10;0;4;14
9711;Ramunėlė;ŽIBUTĖ;4715809064;Taip;0;2;0;2
9712;Ramunėlė;ŽIBUTĖ;5315953299;Taip;4;3;0;7
9713;Ramunėlė;ŽIBUTĖ;2173425836;Taip;6;2;0;8
9714;Ramunėlė;ŽIBUTĖ;2686455030;Taip;6;2;0;8
9715;Ramunėlė;ŽIBUTĖ;5650659504;Taip;0;4;0;4
9716;Ramunėlė;ŽIBUTĖ;6627399830;Taip;0;5;1;6
9717;Ramunėlė;ŽIBUTĖ;8726443989;Taip;0;3;0;3
9718;Ramunėlė;ŽIBUTĖ;5801760033;Taip;0;1;0;1
9719;Ramunėlė;ŽIBUTĖ;6389008823;Taip;5;5;0;10
9720;Ramunėlė;ŽIBUTĖ;9136437288;Taip;0;1;0;1
9721;Ramunėlė;ŽIBUTĖ;6040461460;Taip;10;1;0;11
9722;Ramunėlė;ŽIBUTĖ;2605941371;Taip;0;1;0;1
9723;Ramunėlė;ŽIBUTĖ;7010828978;Taip;6;0;0;6
9724;Ramunėlė;ŽIBUTĖ;3879563193;Taip;13;7;0;20
9725;Ramunėlė;ŽIBUTĖ;2591052434;Taip;0;2;0;2
9726;Ramunėlė;ŽIBUTĖ;2446375037;Taip;15;3;0;18
9727;Ramunėlė;ŽIBUTĖ;1671759939;Taip;8;2;0;10
9728;Ramunėlė;ŽIBUTĖ;6606802660;Taip;0;1;0;1
9729;Ramunėlė;ŽIBUTĖ;5304803880;Taip;0;1;0;1
9730;Ramunėlė;ŽIBUTĖ;3525444906;Taip;0;14;0;14
9731;Ramunėlė;ŽIBUTĖ;8055844166;Taip;5;2;0;7
9732;Ramunėlė;ŽIRNIUKAI;8942483792;Taip;9;0;5;14
9733;Ramunėlė;ŽIRNIUKAI;9994445948;Taip;0;1;0;1
9734;Ramunėlė;ŽIRNIUKAI;6674467484;Taip;0;15;0;15
9735;Ramunėlė;ŽIRNIUKAI;7593855877;Taip;4;3;4;11
9736;Ramunėlė;ŽIRNIUKAI;2177200537;Taip;0;2;2;4
9737;Ramunėlė;ŽIRNIUKAI;7026935746;Taip;2;0;0;2
9738;Ramunėlė;ŽIRNIUKAI;5581693652;Ne;6;1;0;7
9739;Ramunėlė;ŽIRNIUKAI;4269170508;Taip;10;1;2;13
9740;Ramunėlė;ŽIRNIUKAI;7263195574;Taip;0;0;2;2
9741;Ramunėlė;ŽIRNIUKAI;4076525701;Ne;0;0;2;2
9742;Ramunėlė;ŽIRNIUKAI;4139935502;Taip;0;0;2;2
9743;Ramunėlė;ŽIRNIUKAI;1833069020;Taip;8;1;0;9
9744;Ramunėlė;ŽIRNIUKAI;4875011312;Taip;0;0;6;6
9745;Ramunėlė;ŽIRNIUKAI;4084046207;Taip;8;2;0;10
9746;Ramunėlė;ŽIRNIUKAI;5017020616;Taip;0;2;0;2
9747;Ramunėlė;ŽIRNIUKAI;6458458913;Taip;5;0;0;5
9748;Ramunėlė;ŽIRNIUKAI;6225605784;Taip;7;2;3;12
9749;Ramunėlė;ŽIRNIUKAI;4805808663;Ne;10;0;1;11
9750;Ramunėlė;BITUTĖS;8098492540;Ne;0;4;0;4
9751;Ramunėlė;BITUTĖS;6329943991;Taip;0;11;0;11
9752;Ramunėlė;BITUTĖS;7307307882;Taip;5;4;0;9
9753;Ramunėlė;BITUTĖS;2225787182;Taip;4;8;0;12
9754;Ramunėlė;BITUTĖS;6166192468;Taip;6;3;0;9
9755;Ramunėlė;BITUTĖS;5865482869;Taip;0;14;0;14
9756;Ramunėlė;BITUTĖS;8940763540;Ne;0;4;0;4
9757;Ramunėlė;BITUTĖS;6843262303;Taip;1;0;2;3
9758;Ramunėlė;BITUTĖS;7692958269;Taip;5;0;2;7
9759;Ramunėlė;BITUTĖS;8086994543;Taip;0;1;0;1
9760;Ramunėlė;BITUTĖS;5822045625;Taip;1;1;0;2
9761;Ramunėlė;BITUTĖS;9789690425;Taip;0;6;0;6
9762;Ramunėlė;BITUTĖS;1182350830;Taip;0;2;0;2
9763;Ramunėlė;BITUTĖS;6342801407;Taip;1;0;1;2
9764;Ramunėlė;BITUTĖS;4022818032;Taip;5;0;0;5
9765;Ramunėlė;BITUTĖS;7220407572;Taip;0;8;0;8
9766;Ramunėlė;BITUTĖS;1916520056;Taip;0;11;0;11
9767;Ramunėlė;BITUTĖS;2245564567;Taip;6;1;0;7
9768;Ramunėlė;BITUTĖS;6870110390;Taip;0;2;0;2
9769;Ramunėlė;BITUTĖS;6892481929;Taip;0;2;0;2
9770;Ramunėlė;BITUTĖS;2558296296;Taip;11;0;0;11
9771;Ramunėlė;BITUTĖS;6881228078;Taip;0;2;0;2
9772;Ramunėlė;DRUGELIAI;9584620339;Taip;4;1;0;5
9773;Ramunėlė;DRUGELIAI;6930505887;Taip;3;2;0;5
9774;Ramunėlė;DRUGELIAI;8402889872;Taip;0;4;0;4
9775;Ramunėlė;DRUGELIAI;7228065409;Taip;0;8;0;8
9776;Ramunėlė;DRUGELIAI;5170325023;Taip;2;2;0;4
9777;Ramunėlė;DRUGELIAI;3617897977;Taip;0;1;1;2
9778;Ramunėlė;DRUGELIAI;8768539595;Taip;0;6;0;6
9779;Ramunėlė;DRUGELIAI;1078618047;Taip;18;6;0;24
9780;Ramunėlė;DRUGELIAI;2555810841;Taip;0;0;3;3
9781;Ramunėlė;DRUGELIAI;9984243153;Taip;3;2;0;5
9782;Ramunėlė;DRUGELIAI;1199673371;Taip;0;1;1;2
9783;Ramunėlė;DRUGELIAI;4392309015;Taip;0;0;2;2
9784;Ramunėlė;DRUGELIAI;5049415445;Taip;6;0;4;10
9785;Ramunėlė;DRUGELIAI;8460527225;Taip;0;4;0;4
9786;Ramunėlė;DRUGELIAI;1800967823;Taip;3;0;0;3
9787;Ramunėlė;DRUGELIAI;8205893352;Taip;0;2;0;2
9788;Ramunėlė;DRUGELIAI;6809164145;Taip;4;1;0;5
9789;Ramunėlė;DRUGELIAI;6837877393;Ne;10;2;0;12
9790;Ramunėlė;NEUŽMIRŠTUOLĖS;1797997937;Taip;10;0;1;11
9791;Ramunėlė;NEUŽMIRŠTUOLĖS;9326288662;Taip;0;1;0;1
9792;Ramunėlė;NEUŽMIRŠTUOLĖS;9928703066;Taip;9;1;0;10
9793;Ramunėlė;NEUŽMIRŠTUOLĖS;4756689520;Ne;11;2;0;13
9794;Ramunėlė;NEUŽMIRŠTUOLĖS;2070729684;Taip;11;8;0;19
9795;Ramunėlė;NEUŽMIRŠTUOLĖS;4329292281;Taip;5;2;2;9
9796;Ramunėlė;NEUŽMIRŠTUOLĖS;6613469006;Taip;18;5;0;23
9797;Ramunėlė;NEUŽMIRŠTUOLĖS;3742982547;Taip;0;3;1;4
9798;Ramunėlė;NEUŽMIRŠTUOLĖS;3106987206;Taip;4;0;0;4
9799;Ramunėlė;NEUŽMIRŠTUOLĖS;2281370785;Taip;9;0;1;10
9800;Ramunėlė;NEUŽMIRŠTUOLĖS;8643188779;Taip;25;0;0;25
9801;Ramunėlė;NEUŽMIRŠTUOLĖS;9012749913;Taip;6;4;0;10
9802;Ramunėlė;NEUŽMIRŠTUOLĖS;1728034615;Taip;3;4;0;7
9803;Ramunėlė;NEUŽMIRŠTUOLĖS;1579527330;Taip;13;15;0;28
9804;Ramunėlė;NEUŽMIRŠTUOLĖS;7519551613;Taip;0;9;0;9
9805;Ramunėlė;NEUŽMIRŠTUOLĖS;2880352109;Taip;26;0;0;26
9806;Ramunėlė;NEUŽMIRŠTUOLĖS;3949246652;Taip;27;0;0;27
9807;Ramunėlė;NEUŽMIRŠTUOLĖS;3045477012;Taip;11;2;0;13
9808;Ramunėlė;NEUŽMIRŠTUOLĖS;5267145991;Ne;13;3;1;17
9809;Ramunėlė;NEUŽMIRŠTUOLĖS;1181787182;Ne;10;0;0;10
9810;Ramunėlė;OBUOLIUKAI;3683181174;Taip;10;0;1;11
9811;Ramunėlė;OBUOLIUKAI;7364976547;Ne;10;3;0;13
9812;Ramunėlė;OBUOLIUKAI;6156792400;Taip;5;6;0;11
9813;Ramunėlė;OBUOLIUKAI;4233978236;Taip;8;11;0;19
9814;Ramunėlė;OBUOLIUKAI;2983986428;Taip;0;25;0;25
9815;Ramunėlė;OBUOLIUKAI;5548358138;Taip;3;0;0;3
9816;Ramunėlė;OBUOLIUKAI;2427399083;Ne;7;3;1;11
9817;Ramunėlė;OBUOLIUKAI;2422656007;Taip;12;0;4;16
9818;Ramunėlė;OBUOLIUKAI;7829765488;Taip;0;3;0;3
9819;Ramunėlė;OBUOLIUKAI;8623311748;Taip;2;6;0;8
9820;Ramunėlė;OBUOLIUKAI;6849205606;Taip;14;0;2;16
9821;Ramunėlė;OBUOLIUKAI;6604244856;Taip;5;3;0;8
9822;Ramunėlė;OBUOLIUKAI;8617271247;Taip;0;7;0;7
9823;Ramunėlė;OBUOLIUKAI;6413888803;Taip;0;4;0;4
9824;Ramunėlė;OBUOLIUKAI;5610672420;Ne;22;1;0;23
9825;Ramunėlė;OBUOLIUKAI;4400154355;Taip;8;0;1;9
9826;Ramunėlė;OBUOLIUKAI;7250951221;Taip;0;3;4;7
9827;Ramunėlė;OBUOLIUKAI;3802924434;Taip;11;3;0;14
9828;Ramunėlė;OBUOLIUKAI;6981729247;Ne;10;2;0;12
9829;Ramunėlė;SAULĖGRĄŽA;7836959157;Taip;0;0;4;4
9830;Ramunėlė;SAULĖGRĄŽA;2458101652;Taip;16;0;2;18
9831;Ramunėlė;SAULĖGRĄŽA;9663304288;Taip;5;0;5;10
9832;Ramunėlė;SAULĖGRĄŽA;5398069413;Taip;16;0;0;16
9833;Ramunėlė;SAULĖGRĄŽA;7873462803;Taip;0;0;8;8
9834;Ramunėlė;SAULĖGRĄŽA;3793779715;Taip;0;0;7;7
9835;Ramunėlė;SAULĖGRĄŽA;6775947111;Taip;0;0;4;4
9836;Ramunėlė;SAULĖGRĄŽA;1102946363;Taip;3;0;4;7
9837;Ramunėlė;SAULĖGRĄŽA;3603956795;Taip;5;3;0;8
9838;Ramunėlė;SAULĖGRĄŽA;4902056654;Taip;5;3;0;8
9839;Ramunėlė;SAULĖGRĄŽA;7563892184;Taip;5;3;0;8
9840;Ramunėlė;SAULĖGRĄŽA;3801952385;Taip;2;13;0;15
9841;Ramunėlė;SAULĖGRĄŽA;9120142666;Ne;19;0;0;19
9842;Ramunėlė;SAULĖGRĄŽA;6942789511;Taip;0;3;8;11
9843;Ramunėlė;SAULĖGRĄŽA;6226329879;Ne;0;29;0;29
9844;Ramunėlė;SAULĖGRĄŽA;2415377154;Taip;0;5;13;18
9845;Ramunėlė;BORUŽĖLĖS;7825538259;Taip;5;6;0;11
9846;Ramunėlė;BORUŽĖLĖS;8496322672;Taip;4;1;2;7
9847;Ramunėlė;BORUŽĖLĖS;6695672297;Taip;0;1;0;1
9848;Ramunėlė;BORUŽĖLĖS;7295041630;Taip;0;4;0;4
9849;Ramunėlė;BORUŽĖLĖS;58028743912;Taip;5;0;2;7
9850;Ramunėlė;BORUŽĖLĖS;7750405604;Taip;0;1;0;1
9851;Ramunėlė;BORUŽĖLĖS;1216101539;Taip;0;11;0;11
9852;Ramunėlė;BORUŽĖLĖS;2499280049;Taip;0;1;0;1
9853;Ramunėlė;BORUŽĖLĖS;4677819736;Taip;0;0;2;2
9854;Ramunėlė;BORUŽĖLĖS;4349250416;Taip;0;4;0;4
9855;Ramunėlė;BORUŽĖLĖS;1303053333;Taip;0;1;0;1
9856;Ramunėlė;BORUŽĖLĖS;3554787356;Taip;0;1;0;1
9857;Ramunėlė;BORUŽĖLĖS;6310921755;Taip;0;3;0;3
9858;Ramunėlė;BORUŽĖLĖS;3685786758;Taip;0;6;0;6
9859;Ramunėlė;BORUŽĖLĖS;3566074517;Taip;0;1;4;5
9860;Ramunėlė;BORUŽĖLĖS;6837072361;Taip;0;5;0;5
9861;Ramunėlė;BORUŽĖLĖS;1534723406;Taip;10;4;2;16
9862;Ramunėlė;BORUŽĖLĖS;8323020864;Taip;0;1;2;3
9863;Ramunėlė;BORUŽĖLĖS;10704826206;Taip;5;4;0;9
9864;Ramunėlė;BORUŽĖLĖS;3065727741;Taip;0;0;1;1
9865;Ramunėlė;BORUŽĖLĖS;9924675250;Taip;0;3;0;3
9866;Ramunėlė;BORUŽĖLĖS;6251432968;Ne;0;4;0;4
9867;Ramunėlė;NYKŠTUKAS;3166386231;Taip;2;2;0;4
9868;Ramunėlė;NYKŠTUKAS;8045080504;Ne;2;1;0;3
9869;Ramunėlė;NYKŠTUKAS;7955197522;Taip;0;3;2;5
9870;Ramunėlė;NYKŠTUKAS;6983139076;Taip;0;0;4;4
9871;Ramunėlė;NYKŠTUKAS;7639613472;Taip;0;23;0;23
9872;Ramunėlė;NYKŠTUKAS;4642590173;Taip;6;2;0;8
9873;Ramunėlė;NYKŠTUKAS;9549605315;Taip;4;1;0;5
9874;Ramunėlė;NYKŠTUKAS;4491147309;Taip;11;0;4;15
9875;Ramunėlė;NYKŠTUKAS;4040520907;Taip;3;17;0;20
9876;Ramunėlė;NYKŠTUKAS;7542328641;Taip;5;0;0;5
9877;Ramunėlė;NYKŠTUKAS;1277413234;Taip;8;7;0;15
9878;Ramunėlė;NYKŠTUKAS;1215510902;Taip;16;1;0;17
9879;Ramunėlė;NYKŠTUKAS;2760710235;Taip;0;0;1;1
9880;Ramunėlė;NYKŠTUKAS;5573083546;Taip;17;0;0;17
9881;Ramunėlė;UOGELĖ;6294697776;Taip;9;2;0;11
9882;Ramunėlė;UOGELĖ;7005354909;Taip;0;3;0;3
9883;Ramunėlė;UOGELĖ;5665429647;Taip;0;4;2;6
9884;Ramunėlė;UOGELĖ;9180197156;Taip;1;2;0;3
9885;Ramunėlė;UOGELĖ;5108864184;Taip;1;2;0;3
9886;Ramunėlė;UOGELĖ;4321527067;Taip;15;4;0;19
9887;Ramunėlė;UOGELĖ;2202879286;Taip;0;1;0;1
9888;Ramunėlė;UOGELĖ;7896711579;Taip;0;5;1;6
9889;Ramunėlė;UOGELĖ;5726947811;Taip;0;4;0;4
9890;Ramunėlė;UOGELĖ;4171905362;Taip;0;6;0;6
9891;Ramunėlė;UOGELĖ;1729152997;Taip;22;0;1;23
9892;Ramunėlė;UOGELĖ;8764042799;Taip;0;4;0;4
9893;Ramunėlė;UOGELĖ;7926168752;Ne;6;0;0;6
9894;Ramunėlė;UOGELĖ;5498856861;Taip;23;0;0;23
9895;Ramunėlė;UOGELĖ;3024065664;Taip;11;7;0;18
9896;Ramunėlė;UOGELĖ;1666033483;Taip;16;3;0;19
9897;Ramunėlė;UOGELĖ;9994601365;Taip;15;0;3;18
9898;Ramunėlė;UOGELĖ;2620747378;Taip;0;0;3;3
9899;Ramunėlė;VARPELIAI;1159457001;Taip;11;1;0;12
9900;Ramunėlė;VARPELIAI;6606966969;Taip;12;0;3;15
9901;Ramunėlė;VARPELIAI;7599491698;Taip;1;20;0;21
9902;Ramunėlė;VARPELIAI;9292235402;Ne;7;0;1;8
9903;Ramunėlė;VARPELIAI;1811931985;Taip;0;3;0;3
9904;Ramunėlė;VARPELIAI;1818513881;Taip;0;3;2;5
9905;Ramunėlė;VARPELIAI;4581826404;Taip;0;0;1;1
9906;Ramunėlė;VARPELIAI;8310875815;Taip;0;3;0;3
9907;Ramunėlė;VARPELIAI;1491688322;Taip;5;3;0;8
9908;Ramunėlė;VARPELIAI;5703289545;Taip;0;0;7;7
9909;Ramunėlė;VARPELIAI;9934852622;Taip;0;4;0;4
9910;Ramunėlė;VARPELIAI;4968998913;Taip;0;0;4;4
9911;Ramunėlė;VARPELIAI;3996453947;Taip;5;3;0;8
9912;Ramunėlė;VARPELIAI;3461269451;Taip;0;7;0;7
9913;Ramunėlė;VARPELIAI;3474578046;Taip;14;0;0;14
9914;Ramunėlė;VARPELIAI;7544671346;Taip;2;6;0;8
9915;Ramunėlė;VARPELIAI;5544992493;Taip;4;4;0;8
9916;Ramunėlė;VARPELIAI;6433856416;Taip;0;4;0;4
9917;Ramunėlė;VARPELIAI;3542912372;Taip;16;0;2;18
9918;Ramunėlė;VARPELIAI;3735308599;Taip;2;3;0;5
9919;Ramunėlė;VARPELIAI;3272747656;Taip;14;1;0;15
9920;Ramunėlė;VARPELIAI;6347893013;Taip;0;3;2;5
9921;Rūta;SMALSUČIAI;7649756034;Taip;8;0;2;10
9922;Rūta;SMALSUČIAI;5899860543;Ne;0;9;0;9
9923;Rūta;SMALSUČIAI;4728904136;Taip;0;5;0;5
9924;Rūta;SMALSUČIAI;9791861646;Taip;0;1;4;5
9925;Rūta;SMALSUČIAI;2928803089;Taip;0;6;0;6
9926;Rūta;SMALSUČIAI;8378318357;Taip;0;3;0;3
9927;Rūta;SMALSUČIAI;1951202550;Taip;4;0;2;6
9928;Rūta;SMALSUČIAI;3875136625;Ne;0;1;0;1
9929;Rūta;SMALSUČIAI;9603105651;Taip;20;0;1;21
9930;Rūta;SMALSUČIAI;9911151238;Taip;5;0;3;8
9931;Rūta;SMALSUČIAI;7434152435;Taip;0;2;0;2
9932;Rūta;SMALSUČIAI;3843325181;Ne;0;0;4;4
9933;Rūta;SMALSUČIAI;6316768460;Taip;0;0;11;11
9934;Rūta;SMALSUČIAI;8182243701;Taip;0;2;0;2
9935;Rūta;SMALSUČIAI;9386595365;Taip;0;0;1;1
9936;Rūta;SMALSUČIAI;7680605199;Ne;14;5;0;19
9937;Rūta;SMALSUČIAI;6075632046;Taip;0;2;0;2
9938;Rūta;SMALSUČIAI;1035527190;Ne;1;0;0;1
9939;Rūta;KŪLVERSTUKAI;4423305209;Taip;0;1;0;1
9940;Rūta;KŪLVERSTUKAI;7222494215;Taip;0;2;0;2
9941;Rūta;KŪLVERSTUKAI;7519931138;Taip;0;2;0;2
9942;Rūta;KŪLVERSTUKAI;4880804625;Taip;0;2;1;3
9943;Rūta;KŪLVERSTUKAI;3055345528;Taip;0;0;4;4
9944;Rūta;KŪLVERSTUKAI;3499727608;Taip;1;3;0;4
9945;Rūta;KŪLVERSTUKAI;9765301038;Taip;1;3;0;4
9946;Rūta;KŪLVERSTUKAI;9638495757;Taip;6;0;0;6
9947;Rūta;KŪLVERSTUKAI;1962172243;Taip;0;0;2;2
9948;Rūta;KŪLVERSTUKAI;8605070655;Taip;0;1;0;1
9949;Rūta;KŪLVERSTUKAI;7553844890;Taip;0;11;0;11
9950;Rūta;KŪLVERSTUKAI;3964922552;Taip;0;1;0;1
9951;Rūta;KŪLVERSTUKAI;9400586178;Taip;0;6;5;11
9952;Rūta;KŪLVERSTUKAI;3956912957;Taip;0;2;2;4
9953;Rūta;KŪLVERSTUKAI;2890569107;Taip;0;2;0;2
9954;Rūta;KŪLVERSTUKAI;2474991135;Taip;0;2;7;9
9955;Rūta;KŪLVERSTUKAI;1216786487;Taip;3;11;0;14
9956;Rūta;KŪLVERSTUKAI;9245618776;Taip;0;8;0;8
9957;Rūta;KŪLVERSTUKAI;5109138407;Ne;0;0;3;3
9958;Rūta;KŪLVERSTUKAI;6096664609;Ne;0;0;3;3
9959;Rūta;KODĖLČIUKAI;5962981130;Taip;10;0;0;10
9960;Rūta;KODĖLČIUKAI;4347678781;Taip;2;0;3;5
9961;Rūta;KODĖLČIUKAI;3736279705;Taip;6;0;0;6
9962;Rūta;KODĖLČIUKAI;8416455711;Taip;0;0;2;2
9963;Rūta;KODĖLČIUKAI;8668510009;Taip;10;0;1;11
9964;Rūta;KODĖLČIUKAI;2547849837;Taip;9;0;0;9
9965;Rūta;KODĖLČIUKAI;9501101073;Taip;5;2;4;11
9966;Rūta;KODĖLČIUKAI;8883578144;Taip;9;0;0;9
9967;Rūta;KODĖLČIUKAI;4546082355;Taip;0;6;0;6
9968;Rūta;KODĖLČIUKAI;1000645885;Taip;0;8;0;8
9969;Rūta;KODĖLČIUKAI;5766392854;Taip;4;0;0;4
9970;Rūta;KODĖLČIUKAI;4944413811;Taip;0;0;1;1
9971;Rūta;KODĖLČIUKAI;9916296056;Taip;5;0;0;5
9972;Rūta;KODĖLČIUKAI;4656138649;Ne;6;0;2;8
9973;Rūta;KODĖLČIUKAI;1605412505;Taip;0;0;3;3
9974;Rūta;BORUŽĖLĖS;7712500278;Ne;0;0;12;12
9975;Rūta;BORUŽĖLĖS;3898579878;Taip;3;0;3;6
9976;Rūta;BORUŽĖLĖS;8945868791;Taip;0;0;6;6
9977;Rūta;BORUŽĖLĖS;8023404173;Taip;0;0;11;11
9978;Rūta;BORUŽĖLĖS;3348066709;Taip;9;0;1;10
9979;Rūta;BORUŽĖLĖS;4279367893;Taip;5;0;4;9
9980;Rūta;BORUŽĖLĖS;5141290453;Taip;6;0;0;6
9981;Rūta;BORUŽĖLĖS;7006165453;Taip;9;0;0;9
9982;Rūta;BORUŽĖLĖS;6587625933;Taip;10;1;0;11
9983;Rūta;BORUŽĖLĖS;8303314520;Taip;10;3;0;13
9984;Rūta;BORUŽĖLĖS;3470052541;Taip;13;1;1;15
9985;Rūta;BORUŽĖLĖS;2625691851;Taip;0;0;8;8
9986;Rūta;BORUŽĖLĖS;1804222979;Ne;0;0;1;1
9987;Rūta;VYTURĖLIAI;1967141665;Taip;0;0;2;2
9988;Rūta;VYTURĖLIAI;3873876608;Taip;10;1;0;11
9989;Rūta;VYTURĖLIAI;8851591109;Ne;0;1;0;1
9990;Rūta;VYTURĖLIAI;1180144866;Taip;0;2;0;2
9991;Rūta;VYTURĖLIAI;3478456813;Taip;0;2;0;2
9992;Rūta;VYTURĖLIAI;1276704331;Taip;0;1;2;3
9993;Rūta;VYTURĖLIAI;6207902435;Taip;0;1;0;1
9994;Rūta;VYTURĖLIAI;8889388348;Taip;0;1;0;1
9995;Rūta;VYTURĖLIAI;1346367896;Taip;0;1;0;1
9996;Rūta;VYTURĖLIAI;4363571135;Taip;2;2;0;4
9997;Rūta;VYTURĖLIAI;6006094035;Taip;6;1;0;7
9998;Rūta;VYTURĖLIAI;1521231573;Taip;3;2;0;5
9999;Rūta;VYTURĖLIAI;7552644990;Ne;0;1;3;4
10000;Rūta;VYTURĖLIAI;1092908255;Taip;0;9;0;9
10001;Rūta;VYTURĖLIAI;8673942478;Ne;0;7;0;7
10002;Rūta;VYTURĖLIAI;4754142240;Taip;0;2;0;2
10003;Rūta;VYTURĖLIAI;6136733410;Taip;0;1;0;1
10004;Rūta;VYTURĖLIAI;1565896222;Taip;5;1;0;6
10005;Rūta;VYTURĖLIAI;8704594038;Taip;0;1;1;2
10006;Rūta;VYTURĖLIAI;7631229177;Taip;3;0;0;3
10007;Rūta;"PABIRUČIAI (LOGOPEDINĖ)";6221528830;Taip;0;3;0;3
10008;Rūta;"PABIRUČIAI (LOGOPEDINĖ)";8763382361;Taip;0;1;14;15
10009;Rūta;"PABIRUČIAI (LOGOPEDINĖ)";5871960113;Taip;0;3;0;3
10010;Rūta;"PABIRUČIAI (LOGOPEDINĖ)";5211104903;Taip;6;0;0;6
10011;Rūta;"PABIRUČIAI (LOGOPEDINĖ)";1029871210;Taip;0;1;0;1
10012;Rūta;"PABIRUČIAI (LOGOPEDINĖ)";3814794448;Taip;0;0;1;1
10013;Rūta;GUDRUČIAI;4044349935;Taip;0;4;0;4
10014;Rūta;GUDRUČIAI;3998791775;Taip;13;0;2;15
10015;Rūta;GUDRUČIAI;3043164521;Taip;3;0;0;3
10016;Rūta;GUDRUČIAI;3462986405;Taip;10;2;0;12
10017;Rūta;GUDRUČIAI;8548089843;Ne;8;0;3;11
10018;Rūta;GUDRUČIAI;4293920701;Taip;0;1;1;2
10019;Rūta;GUDRUČIAI;4473591998;Taip;6;3;1;10
10020;Rūta;GUDRUČIAI;9419809946;Taip;0;2;0;2
10021;Rūta;GUDRUČIAI;9589117921;Taip;0;2;0;2
10022;Rūta;GUDRUČIAI;3044976169;Taip;3;0;1;4
10023;Rūta;GUDRUČIAI;2546023973;Taip;3;0;2;5
10024;Rūta;GUDRUČIAI;8273644943;Taip;3;2;0;5
10025;Rūta;GUDRUČIAI;8963959004;Taip;0;7;3;10
10026;Rūta;GUDRUČIAI;3454881685;Taip;0;0;4;4
10027;Rūta;GUDRUČIAI;1811055786;Taip;0;2;0;2
10028;Rūta;GUDRUČIAI;1510268514;Taip;3;2;0;5
10029;Rūta;GUDRUČIAI;6814051598;Taip;4;1;0;5
10030;Rūta;GUDRUČIAI;2702537976;Taip;2;1;0;3
10031;Rūta;GUDRUČIAI;2772130413;Taip;5;2;0;7
10032;Rūta;GUDRUČIAI;1623968580;Taip;0;1;3;4
10033;Rūta;GUDRUČIAI;8592528906;Ne;2;0;2;4
10034;Rūta;GUDRUČIAI;1182222976;Taip;0;0;3;3
10035;Rūta;SEKLYTĖLĖ;4823677957;Taip;0;0;2;2
10036;Rūta;SEKLYTĖLĖ;1301573542;Taip;8;1;0;9
10037;Rūta;SEKLYTĖLĖ;5009619812;Taip;12;1;0;13
10038;Rūta;SEKLYTĖLĖ;3567273206;Taip;6;5;0;11
10039;Rūta;SEKLYTĖLĖ;1671913833;Taip;0;1;0;1
10040;Rūta;SEKLYTĖLĖ;1186493111;Taip;0;12;0;12
10041;Rūta;SEKLYTĖLĖ;9675482322;Taip;4;1;0;5
10042;Rūta;SEKLYTĖLĖ;3820689725;Taip;0;2;0;2
10043;Rūta;SEKLYTĖLĖ;1415664888;Taip;0;7;0;7
10044;Rūta;SEKLYTĖLĖ;4426456302;Taip;0;1;1;2
10045;Rūta;SEKLYTĖLĖ;5114985659;Taip;0;1;0;1
10046;Rūta;SEKLYTĖLĖ;4282074540;Taip;0;0;1;1
10047;Rūta;SEKLYTĖLĖ;8607455403;Taip;0;4;0;4
10048;Rūta;SEKLYTĖLĖ;4168356825;Taip;0;0;4;4
10049;Rūta;SEKLYTĖLĖ;9569447586;Taip;0;1;0;1
10050;Rūta;SEKLYTĖLĖ;1579573872;Taip;0;5;0;5
10051;Rūta;SEKLYTĖLĖ;2677062861;Ne;4;2;0;6
10052;Rūta;SEKLYTĖLĖ;1390207547;Taip;0;3;1;4
10053;Rūta;SEKLYTĖLĖ;32004750783;Taip;0;2;0;2
10054;Rūta;SEKLYTĖLĖ;1368317570;Taip;0;1;0;1
10055;Rūta;SEKLYTĖLĖ;5866619097;Taip;0;1;0;1
10056;Rūta;SEKLYTĖLĖ;2912054049;Taip;8;0;0;8
10057;Rūta;"VARPELIAI (LOGOPEDINĖ)";3055294324;Taip;0;0;6;6
10058;Rūta;"VARPELIAI (LOGOPEDINĖ)";3810636967;Taip;0;3;0;3
10059;Rūta;"VARPELIAI (LOGOPEDINĖ)";8992775168;Taip;0;0;1;1
10060;Rūta;"VARPELIAI (LOGOPEDINĖ)";8026402652;Ne;2;2;1;5
10061;Rūta;"VARPELIAI (LOGOPEDINĖ)";2584812163;Ne;0;1;0;1
10062;Rūta;"VARPELIAI (LOGOPEDINĖ)";6032985748;Taip;0;3;0;3
10063;Rūta;"VARPELIAI (LOGOPEDINĖ)";6891385410;Taip;0;1;0;1
10064;Rūta;"VARPELIAI (LOGOPEDINĖ)";4858914868;Taip;5;1;1;7
10065;Rūta;KIŠKUČIŲ;7837861265;Taip;0;0;4;4
10066;Rūta;KIŠKUČIŲ;2601011765;Ne;14;0;2;16
10067;Rūta;KIŠKUČIŲ;5579794648;Taip;0;1;19;20
10068;Rūta;KIŠKUČIŲ;4165080541;Taip;8;0;1;9
10069;Rūta;KIŠKUČIŲ;3877807687;Ne;0;0;12;12
10070;Rūta;KIŠKUČIŲ;9429856388;Taip;0;0;6;6
10071;Rūta;KIŠKUČIŲ;8483916287;Taip;12;0;1;13
10072;Rūta;KIŠKUČIŲ;7724451685;Taip;4;0;0;4
10073;Rūta;KIŠKUČIŲ;8138816581;Ne;0;0;21;21
10074;Rūta;KIŠKUČIŲ;2733932207;Taip;0;4;0;4
10075;Rūta;KIŠKUČIŲ;5902965224;Taip;0;1;2;3
10076;Rūta;KIŠKUČIŲ;9471291067;Taip;0;3;0;3
10077;Rūta;KIŠKUČIŲ;8012225409;Taip;0;0;2;2
10078;Rūta;KIŠKUČIŲ;1290867375;Taip;0;11;0;11
10079;Rūta;KIŠKUČIŲ;2084935094;Taip;5;0;0;5
10080;Rūta;KIŠKUČIŲ;6088978998;Taip;10;0;0;10
10081;Rūta;KIŠKUČIŲ;8320791295;Taip;0;1;1;2
10082;Rūta;KIŠKUČIŲ;3109709043;Taip;19;0;0;19
10083;Rūta;KIŠKUČIŲ;2830990163;Taip;0;0;2;2
10084;Rūta;ŽVIRBLIUKAI;3352007694;Taip;0;2;2;4
10085;Rūta;ŽVIRBLIUKAI;9243332756;Taip;0;2;5;7
10086;Rūta;ŽVIRBLIUKAI;1059126758;Taip;5;7;0;12
10087;Rūta;ŽVIRBLIUKAI;6417693659;Taip;5;1;5;11
10088;Rūta;ŽVIRBLIUKAI;4090915728;Taip;4;1;0;5
10089;Rūta;ŽVIRBLIUKAI;4466522924;Taip;0;3;6;9
10090;Rūta;ŽVIRBLIUKAI;7905893575;Taip;6;2;0;8
10091;Rūta;ŽVIRBLIUKAI;4436482805;Taip;0;3;0;3
10092;Rūta;ŽVIRBLIUKAI;1260386759;Taip;0;4;0;4
10093;Rūta;ŽVIRBLIUKAI;8935780480;Taip;6;0;0;6
10094;Rūta;ŽVIRBLIUKAI;4208678278;Taip;5;1;0;6
10095;Rūta;ŽVIRBLIUKAI;6044060646;Taip;7;0;0;7
10096;Rūta;ŽVIRBLIUKAI;9220661972;Taip;5;0;0;5
10097;Rūta;ŽVIRBLIUKAI;5109026000;Taip;0;4;0;4
10098;Rūta;ŽVIRBLIUKAI;4776631890;Taip;7;0;1;8
10099;Rūta;ŽVIRBLIUKAI;4440148328;Taip;11;2;0;13
10100;Rūta;ŽVIRBLIUKAI;1671179652;Taip;6;0;1;7
10101;Rūta;ŽVIRBLIUKAI;1152453609;Taip;0;2;0;2
10102;Rūta;ŽVIRBLIUKAI;9012256437;Taip;0;2;1;3
10103;Rūta;SAULUTĖS;6585842434;Taip;0;0;2;2
10104;Rūta;SAULUTĖS;6620957022;Ne;0;0;1;1
10105;Rūta;SAULUTĖS;8806743371;Taip;0;0;1;1
10106;Rūta;SAULUTĖS;8320521011;Taip;0;0;2;2
10107;Rūta;SAULUTĖS;2263820829;Taip;0;0;3;3
10108;Rūta;SAULUTĖS;3765741047;Taip;0;0;6;6
10109;Rūta;SAULUTĖS;7762509383;Taip;0;1;0;1
10110;Rūta;SAULUTĖS;2685515977;Taip;5;1;0;6
10111;Rūta;SAULUTĖS;5512946296;Taip;3;0;0;3
10112;Rūta;SAULUTĖS;9308127402;Taip;0;5;1;6
10113;Rūta;SAULUTĖS;7422059414;Ne;10;7;0;17
10114;Rūta;SAULUTĖS;8571905994;Ne;1;0;0;1
10115;Rūta;SAULUTĖS;8479424939;Taip;15;0;1;16
10116;Rūta;SAULUTĖS;9014433476;Taip;4;4;0;8
10117;Rūta;SAULUTĖS;1207463357;Taip;11;0;5;16
10118;Rūta;SAULUTĖS;1131910047;Taip;21;0;0;21
10119;Sadutė;Kiškučiai;6645848193;Taip;0;6;0;6
10120;Sadutė;Kiškučiai;1589424708;Taip;0;2;0;2
10121;Sadutė;Kiškučiai;5992865266;Taip;7;0;0;7
10122;Sadutė;Kiškučiai;3568132830;Taip;6;8;5;19
10123;Sadutė;Kiškučiai;2340908210;Taip;18;0;0;18
10124;Sadutė;Kiškučiai;2087489114;Taip;5;0;0;5
10125;Sadutė;Kiškučiai;6652070415;Taip;7;0;1;8
10126;Sadutė;Kiškučiai;4360361866;Ne;7;0;1;8
10127;Sadutė;Kiškučiai;2139177648;Taip;6;0;0;6
10128;Sadutė;Kiškučiai;8397295024;Taip;6;1;0;7
10129;Sadutė;Kiškučiai;4075714061;Taip;0;4;0;4
10130;Sadutė;Kiškučiai;3285448692;Taip;0;1;2;3
10131;Sadutė;Kiškučiai;2845125335;Taip;0;1;0;1
10132;Sadutė;Kiškučiai;3954151590;Taip;1;0;3;4
10133;Sadutė;Kiškučiai;5326000400;Ne;0;21;0;21
10134;Sadutė;Kiškučiai;1860645542;Ne;4;0;3;7
10135;Sadutė;Kiškučiai;2472471722;Taip;2;0;2;4
10136;Sadutė;Boružėlės;9115304973;Taip;0;1;2;3
10137;Sadutė;Boružėlės;8442967732;Taip;0;0;1;1
10138;Sadutė;Boružėlės;1273355194;Taip;10;0;0;10
10139;Sadutė;Boružėlės;3119547420;Taip;10;0;0;10
10140;Sadutė;Boružėlės;8987528237;Taip;0;0;2;2
10141;Sadutė;Boružėlės;6994383907;Taip;0;0;1;1
10142;Sadutė;Boružėlės;8914509685;Taip;0;0;3;3
10143;Sadutė;Boružėlės;3875265137;Taip;0;0;3;3
10144;Sadutė;Boružėlės;5992119777;Taip;6;1;0;7
10145;Sadutė;Boružėlės;5682745869;Taip;0;0;2;2
10146;Sadutė;Boružėlės;7072437339;Taip;0;0;1;1
10147;Sadutė;Boružėlės;3362830536;Taip;0;4;1;5
10148;Sadutė;Boružėlės;5395676303;Taip;0;0;2;2
10149;Sadutė;Boružėlės;1923014145;Taip;0;0;1;1
10150;Sadutė;Boružėlės;3845369333;Taip;7;0;6;13
10151;Sadutė;Boružėlės;8200891038;Ne;4;0;0;4
10152;Sadutė;Boružėlės;4696990344;Ne;0;1;1;2
10153;Sadutė;Bitutės;1759479328;Taip;2;2;2;6
10154;Sadutė;Bitutės;1975767401;Taip;2;1;0;3
10155;Sadutė;Bitutės;4245873513;Taip;0;6;0;6
10156;Sadutė;Bitutės;1873928395;Taip;7;0;0;7
10157;Sadutė;Bitutės;5866461096;Taip;0;0;2;2
10158;Sadutė;Bitutės;7097653016;Taip;0;1;2;3
10159;Sadutė;Bitutės;4479315578;Taip;9;0;0;9
10160;Sadutė;Bitutės;2020766695;Taip;0;21;0;21
10161;Sadutė;Bitutės;5011320850;Taip;0;0;3;3
10162;Sadutė;Bitutės;4161502667;Ne;0;0;1;1
10163;Sadutė;Bitutės;5973513916;Taip;0;2;0;2
10164;Sadutė;Bitutės;5169694660;Taip;0;2;0;2
10165;Sadutė;Bitutės;3361904803;Taip;6;0;2;8
10166;Sadutė;Bitutės;1231048342;Taip;0;1;0;1
10167;Sadutė;Bitutės;2355177889;Taip;0;0;4;4
10168;Sadutė;Bitutės;8556086501;Taip;0;1;0;1
10169;Sadutė;Bitutės;6066145909;Taip;5;2;2;9
10170;Sadutė;Bitutės;5142566738;Taip;9;1;2;12
10171;Sadutė;Bitutės;8662375739;Taip;0;7;0;7
10172;Sadutė;Bitutės;9692905987;Taip;6;0;0;6
10173;Sadutė;Bitutės;9107727583;Taip;0;0;3;3
10174;Sadutė;Bitutės;6138604955;Ne;3;0;0;3
10175;Sadutė;Drugeliai;9090754149;Taip;0;1;0;1
10176;Sadutė;Drugeliai;1552350084;Taip;0;2;0;2
10177;Sadutė;Drugeliai;7910380894;Ne;0;2;0;2
10178;Sadutė;Drugeliai;4402558234;Taip;4;2;0;6
10179;Sadutė;Drugeliai;6994547344;Taip;0;1;0;1
10180;Sadutė;Drugeliai;1782594187;Taip;0;3;1;4
10181;Sadutė;Drugeliai;5816844295;Taip;0;1;0;1
10182;Sadutė;Drugeliai;8803249656;Taip;4;2;1;7
10183;Sadutė;Drugeliai;6196282159;Taip;17;1;0;18
10184;Sadutė;Drugeliai;5139219626;Taip;0;1;0;1
10185;Sadutė;Drugeliai;1735450955;Taip;0;1;0;1
10186;Sadutė;Drugeliai;2064784580;Taip;0;1;0;1
10187;Sadutė;Drugeliai;2883991326;Taip;0;1;1;2
10188;Sadutė;Drugeliai;7731164484;Taip;0;6;0;6
10189;Sadutė;Drugeliai;6124376554;Taip;5;1;0;6
10190;Sadutė;Drugeliai;36769610742;Taip;0;1;5;6
10191;Sadutė;Drugeliai;4623727349;Taip;6;2;0;8
10192;Sadutė;Drugeliai;7940706717;Taip;0;1;2;3
10193;Sadutė;Drugeliai;3457375001;Ne;0;6;2;8
10194;Sadutė;Pėledžiukai;9136727429;Taip;0;0;1;1
10195;Sadutė;Pėledžiukai;5616756293;Taip;20;1;0;21
10196;Sadutė;Pėledžiukai;2705458480;Taip;12;0;0;12
10197;Sadutė;Pėledžiukai;6314488650;Ne;8;0;0;8
10198;Sadutė;Pėledžiukai;6126235707;Taip;17;0;0;17
10199;Sadutė;Pėledžiukai;1537482438;Taip;4;0;1;5
10200;Sadutė;Pėledžiukai;6716550703;Taip;1;6;0;7
10201;Sadutė;Pėledžiukai;4013188468;Ne;5;0;0;5
10202;Sadutė;Pėledžiukai;7551299839;Taip;11;0;0;11
10203;Sadutė;Pėledžiukai;8914706717;Taip;5;0;7;12
10204;Sadutė;Pėledžiukai;6379705269;Taip;8;0;0;8
10205;Sadutė;Pėledžiukai;5385678913;Taip;9;0;1;10
10206;Sadutė;Pėledžiukai;2055127699;Taip;7;1;0;8
10207;Sadutė;Pėledžiukai;2747256989;Taip;10;0;0;10
10208;Sadutė;Pėledžiukai;3277826759;Taip;0;0;1;1
10209;Sadutė;Pėledžiukai;4791750087;Taip;8;0;1;9
10210;Sadutė;Kačiukų;1507052440;Taip;0;10;0;10
10211;Sadutė;Kačiukų;1903961488;Taip;0;1;1;2
10212;Sadutė;Kačiukų;2890916313;Taip;0;6;2;8
10213;Sadutė;Kačiukų;2733633163;Taip;0;1;0;1
10214;Sadutė;Kačiukų;3993181500;Taip;0;1;0;1
10215;Sadutė;Kačiukų;8835627470;Taip;3;1;0;4
10216;Sadutė;Kačiukų;2532626934;Taip;0;1;0;1
10217;Sadutė;Kačiukų;2466024649;Taip;0;1;0;1
10218;Sadutė;Kačiukų;6253351299;Taip;0;1;0;1
10219;Sadutė;Kačiukų;2426974464;Taip;0;1;1;2
10220;Sadutė;Kačiukų;5438448926;Taip;0;0;1;1
10221;Sadutė;Kačiukų;8974374101;Taip;0;1;6;7
10222;Sadutė;Kačiukų;4401870028;Taip;0;1;3;4
10223;Sadutė;Kačiukų;8714168144;Taip;1;10;0;11
10224;Sadutė;Kačiukų;3927044011;Taip;0;0;1;1
10225;Sadutė;Kačiukų;8770727233;Taip;0;0;1;1
10226;Sadutė;Kačiukų;8556218971;Taip;0;1;2;3
10227;Sadutė;Kačiukų;5267093203;Taip;12;1;2;15
10228;Sadutė;Kačiukų;6538356822;Taip;6;0;0;6
10229;Sadutė;Kačiukų;5614758320;Taip;0;6;3;9
10230;Sadutė;Kačiukų;2194387139;Taip;1;0;2;3
10231;Sakalėlis;GIRINUKŲ;9566176151;Taip;10;0;1;11
10232;Sakalėlis;GIRINUKŲ;8606714134;Taip;0;0;1;1
10233;Sakalėlis;GIRINUKŲ;5405669698;Taip;0;1;0;1
10234;Sakalėlis;GIRINUKŲ;2474164013;Taip;9;1;1;11
10235;Sakalėlis;GIRINUKŲ;9493905856;Ne;0;0;4;4
10236;Sakalėlis;GIRINUKŲ;5496044442;Taip;6;0;1;7
10237;Sakalėlis;GIRINUKŲ;6603105354;Taip;0;0;4;4
10238;Sakalėlis;GIRINUKŲ;3418702674;Taip;0;1;2;3
10239;Sakalėlis;GIRINUKŲ;3748865437;Taip;7;0;0;7
10240;Sakalėlis;GIRINUKŲ;6700169944;Taip;0;0;1;1
10241;Sakalėlis;GIRINUKŲ;3333037807;Taip;14;0;1;15
10242;Sakalėlis;GIRINUKŲ;8790189865;Taip;11;1;0;12
10243;Sakalėlis;GIRINUKŲ;4458071075;Taip;0;0;2;2
10244;Sakalėlis;GIRINUKŲ;4209146744;Taip;0;3;0;3
10245;Sakalėlis;GIRINUKŲ;2780141413;Taip;0;6;0;6
10246;Sakalėlis;GIRINUKŲ;1347171934;Taip;5;1;1;7
10247;Sakalėlis;GIRINUKŲ;9250470549;Ne;0;1;0;1
10248;Sakalėlis;GIRINUKŲ;3691879468;Taip;0;0;2;2
10249;Sakalėlis;VYTURIUKŲ;3927487265;Taip;3;1;0;4
10250;Sakalėlis;VYTURIUKŲ;3680732318;Taip;0;9;0;9
10251;Sakalėlis;VYTURIUKŲ;4862004373;Taip;0;1;2;3
10252;Sakalėlis;VYTURIUKŲ;8422299669;Ne;2;0;1;3
10253;Sakalėlis;VYTURIUKŲ;6579827280;Taip;0;2;0;2
10254;Sakalėlis;VYTURIUKŲ;8381310908;Taip;5;1;0;6
10255;Sakalėlis;VYTURIUKŲ;6840368824;Taip;10;0;1;11
10256;Sakalėlis;VYTURIUKŲ;7285833058;Taip;0;0;2;2
10257;Sakalėlis;VYTURIUKŲ;1742362136;Taip;10;0;1;11
10258;Sakalėlis;VYTURIUKŲ;5795250727;Taip;0;1;4;5
10259;Sakalėlis;VYTURIUKŲ;2985239904;Taip;0;1;0;1
10260;Sakalėlis;VYTURIUKŲ;3351218789;Ne;5;0;2;7
10261;Sakalėlis;VYTURIUKŲ;9120873899;Ne;17;0;0;17
10262;Sakalėlis;VYTURIUKŲ;4136266629;Taip;0;0;2;2
10263;Sakalėlis;VYTURIUKŲ;5991029760;Ne;16;0;1;17
10264;Sakalėlis;VYTURIUKŲ;6378711142;Taip;9;0;1;10
10265;Sakalėlis;VYTURIUKŲ;1736303381;Taip;5;1;1;7
10266;Sakalėlis;VYTURIUKŲ;1200252225;Taip;0;7;0;7
10267;Sakalėlis;VYTURIUKŲ;7280513854;Taip;6;0;0;6
10268;Sakalėlis;DRUGELIŲ;8095359035;Taip;0;0;4;4
10269;Sakalėlis;DRUGELIŲ;7706606275;Taip;0;6;0;6
10270;Sakalėlis;DRUGELIŲ;5911341542;Taip;0;0;3;3
10271;Sakalėlis;DRUGELIŲ;9272347788;Taip;0;0;3;3
10272;Sakalėlis;DRUGELIŲ;8331612396;Taip;0;0;1;1
10273;Sakalėlis;DRUGELIŲ;2898006208;Taip;0;1;7;8
10274;Sakalėlis;DRUGELIŲ;7542322748;Taip;3;0;3;6
10275;Sakalėlis;DRUGELIŲ;1201086815;Taip;0;0;5;5
10276;Sakalėlis;DRUGELIŲ;3934295338;Taip;0;2;0;2
10277;Sakalėlis;DRUGELIŲ;1117800518;Taip;10;0;0;10
10278;Sakalėlis;DRUGELIŲ;2515169899;Taip;0;1;0;1
10279;Sakalėlis;DRUGELIŲ;8160589611;Taip;2;3;0;5
10280;Sakalėlis;DRUGELIŲ;9836193857;Taip;0;0;1;1
10281;Sakalėlis;DRUGELIŲ;4004006771;Taip;0;1;7;8
10282;Sakalėlis;DRUGELIŲ;1833573491;Taip;0;0;2;2
10283;Sakalėlis;DRUGELIŲ;8713298648;Taip;0;2;0;2
10284;Sakalėlis;DRUGELIŲ;2889638745;Taip;0;0;3;3
10285;Sakalėlis;DRUGELIŲ;3329244758;Taip;0;0;1;1
10286;Sakalėlis;DRUGELIŲ;7540098033;Taip;2;0;1;3
10287;Sakalėlis;GENIUKŲ;4763858893;Taip;0;1;0;1
10288;Sakalėlis;GENIUKŲ;3337299648;Taip;0;1;1;2
10289;Sakalėlis;GENIUKŲ;43677485606;Taip;0;2;0;2
10290;Sakalėlis;GENIUKŲ;5717022080;Taip;0;1;1;2
10291;Sakalėlis;GENIUKŲ;4515180509;Taip;0;1;1;2
10292;Sakalėlis;GENIUKŲ;1027765680;Taip;0;3;0;3
10293;Sakalėlis;GENIUKŲ;81681433432;Taip;5;1;1;7
10294;Sakalėlis;GENIUKŲ;96053733139;Taip;0;1;3;4
10295;Sakalėlis;GENIUKŲ;4612388683;Taip;0;7;0;7
10296;Sakalėlis;GENIUKŲ;7159705304;Taip;0;2;0;2
10297;Sakalėlis;GENIUKŲ;4775685174;Taip;0;1;0;1
10298;Sakalėlis;GENIUKŲ;69916351348;Taip;0;1;0;1
10299;Sakalėlis;GENIUKŲ;8936933971;Taip;0;1;2;3
10300;Sakalėlis;GENIUKŲ;2829386777;Taip;12;1;0;13
10301;Sakalėlis;GENIUKŲ;3371763993;Ne;7;1;1;9
10302;Sakalėlis;GENIUKŲ;7085108710;Taip;1;1;0;2
10303;Sakalėlis;GENIUKŲ;2902195855;Taip;0;1;0;1
10304;Sakalėlis;GENIUKŲ;36670171187;Taip;0;1;1;2
10305;Sakalėlis;GENIUKŲ;4364341933;Ne;0;1;1;2
10306;Sakalėlis;VOVERIUKŲ;5172421763;Taip;7;0;1;8
10307;Sakalėlis;VOVERIUKŲ;5233697077;Taip;7;1;2;10
10308;Sakalėlis;VOVERIUKŲ;6414564366;Ne;13;0;0;13
10309;Sakalėlis;VOVERIUKŲ;1953356983;Taip;11;0;4;15
10310;Sakalėlis;VOVERIUKŲ;4358313171;Taip;0;0;1;1
10311;Sakalėlis;VOVERIUKŲ;6806170544;Taip;11;0;1;12
10312;Sakalėlis;VOVERIUKŲ;2557089391;Taip;13;0;1;14
10313;Sakalėlis;VOVERIUKŲ;8133985842;Taip;8;0;0;8
10314;Sakalėlis;VOVERIUKŲ;3574956316;Taip;3;3;0;6
10315;Sakalėlis;VOVERIUKŲ;1403384561;Taip;1;0;1;2
10316;Sakalėlis;VOVERIUKŲ;3927363997;Ne;10;3;0;13
10317;Sakalėlis;VOVERIUKŲ;6293226507;Taip;12;0;0;12
10318;Sakalėlis;VOVERIUKŲ;2699844937;Taip;7;0;0;7
10319;Sakalėlis;VOVERIUKŲ;1273843302;Taip;0;1;1;2
10320;Sakalėlis;VOVERIUKŲ;6217643065;Taip;0;0;2;2
10321;Sakalėlis;VOVERIUKŲ;1669610397;Taip;0;0;4;4
10322;Sakalėlis;VOVERIUKŲ;4344537391;Taip;0;0;7;7
10323;Sakalėlis;VOVERIUKŲ;6016854405;Ne;0;8;0;8
10324;Sakalėlis;VOVERIUKŲ;2531146677;Taip;11;0;1;12
10325;Sakalėlis;VOVERIUKŲ;2575873447;Taip;10;0;1;11
10326;Sakalėlis;VOVERIUKŲ;9592852011;Taip;0;1;0;1
10327;Sakalėlis;PĖLEDŽIUKŲ;1133377117;Taip;0;1;1;2
10328;Sakalėlis;PĖLEDŽIUKŲ;6190741162;Taip;0;5;2;7
10329;Sakalėlis;PĖLEDŽIUKŲ;4430763418;Taip;6;6;0;12
10330;Sakalėlis;PĖLEDŽIUKŲ;1104881142;Taip;0;1;1;2
10331;Sakalėlis;PĖLEDŽIUKŲ;6321575268;Taip;0;1;0;1
10332;Sakalėlis;PĖLEDŽIUKŲ;1702964714;Taip;0;0;4;4
10333;Sakalėlis;PĖLEDŽIUKŲ;30987215315;Taip;0;1;0;1
10334;Sakalėlis;PĖLEDŽIUKŲ;2796230671;Taip;0;1;5;6
10335;Sakalėlis;PĖLEDŽIUKŲ;3962436122;Taip;0;3;0;3
10336;Sakalėlis;PĖLEDŽIUKŲ;1912068116;Taip;0;1;3;4
10337;Sakalėlis;PĖLEDŽIUKŲ;34464485043;Taip;0;1;1;2
10338;Sakalėlis;PĖLEDŽIUKŲ;1141943082;Taip;0;1;0;1
10339;Sakalėlis;PĖLEDŽIUKŲ;46629941288;Taip;0;1;0;1
10340;Sakalėlis;PĖLEDŽIUKŲ;5782214279;Taip;0;7;1;8
10341;Sakalėlis;PĖLEDŽIUKŲ;8852001037;Taip;15;1;5;21
10342;Sakalėlis;PĖLEDŽIUKŲ;6180987643;Ne;3;1;5;9
10343;Sakalėlis;PĖLEDŽIUKŲ;3678172501;Taip;4;5;0;9
10344;Sakalėlis;PĖLEDŽIUKŲ;7567476424;Taip;0;1;0;1
10345;Sakalėlis;PĖLEDŽIUKŲ;2055710873;Taip;0;0;1;1
10346;Sakalėlis;PĖLEDŽIUKŲ;1839096675;Taip;6;1;0;7
10347;Sakalėlis;PĖLEDŽIUKŲ;1339314644;Taip;0;1;2;3
10348;Sakalėlis;PĖLEDŽIUKŲ;5884781964;Taip;0;0;7;7
10349;Sakalėlis;PĖLEDŽIUKŲ;4495453007;Taip;0;1;1;2
10350;Sakalėlis;"BITUČIŲ (LOGOPEDINĖ)";7241416465;Ne;4;1;5;10
10351;Sakalėlis;"BITUČIŲ (LOGOPEDINĖ)";4857211754;Taip;5;1;0;6
10352;Sakalėlis;"BITUČIŲ (LOGOPEDINĖ)";8610668395;Taip;11;0;0;11
10353;Sakalėlis;"BITUČIŲ (LOGOPEDINĖ)";6259640492;Taip;3;0;0;3
10354;Sakalėlis;"BITUČIŲ (LOGOPEDINĖ)";1723436498;Taip;0;7;0;7
10355;Sakalėlis;"BITUČIŲ (LOGOPEDINĖ)";3938470708;Taip;8;0;0;8
10356;Sakalėlis;"BITUČIŲ (LOGOPEDINĖ)";4931253729;Taip;0;0;4;4
10357;Sakalėlis;"BITUČIŲ (LOGOPEDINĖ)";5376872141;Ne;2;0;1;3
10358;Sakalėlis;"BITUČIŲ (LOGOPEDINĖ)";4303490614;Taip;0;5;0;5
10359;Sakalėlis;"BORUŽIUKŲ (LOGOPEDINĖ)";4514546151;Taip;0;3;1;4
10360;Sakalėlis;"BORUŽIUKŲ (LOGOPEDINĖ)";3972897839;Taip;5;11;0;16
10361;Sakalėlis;"BORUŽIUKŲ (LOGOPEDINĖ)";2124857941;Taip;0;1;0;1
10362;Sakalėlis;"BORUŽIUKŲ (LOGOPEDINĖ)";1806698668;Ne;3;1;1;5
10363;Sakalėlis;"BORUŽIUKŲ (LOGOPEDINĖ)";9823633774;Taip;6;0;1;7
10364;Sakalėlis;"BORUŽIUKŲ (LOGOPEDINĖ)";6727251397;Taip;0;3;0;3
10365;Sakalėlis;"BORUŽIUKŲ (LOGOPEDINĖ)";6250400609;Taip;0;0;1;1
10366;Sakalėlis;"BORUŽIUKŲ (LOGOPEDINĖ)";6222204020;Taip;0;0;1;1
10367;Sakalėlis;"BORUŽIUKŲ (LOGOPEDINĖ)";7602249339;Taip;0;0;1;1
10368;Sakalėlis;"BORUŽIUKŲ (LOGOPEDINĖ)";8263169658;Taip;0;0;5;5
10369;Sakalėlis;MEŠKUČIŲ;9546779717;Taip;6;2;1;9
10370;Sakalėlis;MEŠKUČIŲ;8535457018;Taip;0;4;0;4
10371;Sakalėlis;MEŠKUČIŲ;4813561523;Taip;3;0;2;5
10372;Sakalėlis;MEŠKUČIŲ;7154383856;Taip;13;0;1;14
10373;Sakalėlis;MEŠKUČIŲ;5082756444;Ne;4;0;0;4
10374;Sakalėlis;MEŠKUČIŲ;7839893402;Taip;0;0;1;1
10375;Sakalėlis;MEŠKUČIŲ;3092760315;Taip;0;4;0;4
10376;Sakalėlis;MEŠKUČIŲ;3524545708;Taip;0;4;0;4
10377;Sakalėlis;MEŠKUČIŲ;5961207419;Taip;0;0;4;4
10378;Sakalėlis;MEŠKUČIŲ;5961861760;Taip;2;0;0;2
10379;Sakalėlis;MEŠKUČIŲ;5677280944;Ne;6;0;1;7
10380;Sakalėlis;MEŠKUČIŲ;2389541483;Ne;8;4;0;12
10381;Sakalėlis;MEŠKUČIŲ;4063074948;Taip;0;0;2;2
10382;Sakalėlis;MEŠKUČIŲ;8108456923;Taip;1;0;0;1
10383;Sakalėlis;MEŠKUČIŲ;7285230768;Taip;10;1;0;11
10384;Sakalėlis;MEŠKUČIŲ;8888784168;Taip;5;1;1;7
10385;Sakalėlis;MEŠKUČIŲ;2090313887;Ne;4;0;1;5
10386;Sakalėlis;MEŠKUČIŲ;9794245922;Taip;11;0;0;11
10387;Sakalėlis;MEŠKUČIŲ;8106231242;Taip;6;0;0;6
10388;Sakalėlis;MEŠKUČIŲ;4520212128;Taip;0;1;1;2
10389;Sakalėlis;MEŠKUČIŲ;7228559861;Taip;7;7;4;18
10390;Sakalėlis;MEŠKUČIŲ;1208798798;Taip;15;0;0;15
10391;Sakalėlis;KIŠKUČIŲ;2505477059;Taip;0;0;4;4
10392;Sakalėlis;KIŠKUČIŲ;1004062550;Taip;0;0;1;1
10393;Sakalėlis;KIŠKUČIŲ;5865993835;Taip;5;0;3;8
10394;Sakalėlis;KIŠKUČIŲ;2003090775;Taip;0;0;2;2
10395;Sakalėlis;KIŠKUČIŲ;8228039819;Taip;11;0;3;14
10396;Sakalėlis;KIŠKUČIŲ;7006304327;Taip;0;0;2;2
10397;Sakalėlis;KIŠKUČIŲ;6029443196;Taip;12;1;6;19
10398;Sakalėlis;KIŠKUČIŲ;4633296169;Taip;5;0;0;5
10399;Sakalėlis;KIŠKUČIŲ;4611384179;Taip;0;9;1;10
10400;Sakalėlis;KIŠKUČIŲ;4490632523;Taip;0;0;4;4
10401;Sakalėlis;KIŠKUČIŲ;8015985605;Taip;15;0;1;16
10402;Sakalėlis;KIŠKUČIŲ;5052638078;Taip;15;0;0;15
10403;Sakalėlis;KIŠKUČIŲ;5327382009;Taip;15;0;0;15
10404;Sakalėlis;KIŠKUČIŲ;6897550418;Taip;5;0;0;5
10405;Sakalėlis;KIŠKUČIŲ;9642519454;Taip;4;0;1;5
10406;Sakalėlis;KIŠKUČIŲ;5387119771;Taip;17;0;0;17
10407;Sakalėlis;KIŠKUČIŲ;6328924318;Taip;13;0;0;13
10408;Sakalėlis;KIŠKUČIŲ;8868588637;Ne;6;0;4;10
10409;Sakalėlis;SVIRPLIUKŲ;6597274376;Taip;2;6;1;9
10410;Sakalėlis;SVIRPLIUKŲ;5500248048;Taip;4;1;0;5
10411;Sakalėlis;SVIRPLIUKŲ;8562164673;Taip;9;1;1;11
10412;Sakalėlis;SVIRPLIUKŲ;2537030533;Taip;0;0;4;4
10413;Sakalėlis;SVIRPLIUKŲ;3719351129;Taip;0;1;3;4
10414;Sakalėlis;SVIRPLIUKŲ;3570413330;Taip;1;0;4;5
10415;Sakalėlis;SVIRPLIUKŲ;6889888573;Taip;0;0;2;2
10416;Sakalėlis;SVIRPLIUKŲ;7852255204;Taip;1;0;4;5
10417;Sakalėlis;SVIRPLIUKŲ;9926328835;Taip;0;1;0;1
10418;Sakalėlis;SVIRPLIUKŲ;1253452975;Taip;0;0;1;1
10419;Sakalėlis;SVIRPLIUKŲ;8328069876;Taip;2;0;0;2
10420;Sakalėlis;SVIRPLIUKŲ;7480286509;Taip;6;1;3;10
10421;Sakalėlis;SVIRPLIUKŲ;2250828607;Taip;10;1;6;17
10422;Sakalėlis;SVIRPLIUKŲ;2672429406;Taip;10;1;6;17
10423;Sakalėlis;SVIRPLIUKŲ;6851247779;Taip;7;1;0;8
10424;Sakalėlis;SVIRPLIUKŲ;9776767584;Taip;12;0;0;12
10425;Sakalėlis;SVIRPLIUKŲ;8501785305;Ne;15;0;1;16
10426;Sakalėlis;SVIRPLIUKŲ;1121818878;Taip;3;1;0;4
10427;Sakalėlis;SVIRPLIUKŲ;5465596207;Taip;9;0;0;9
10428;Sakalėlis;SVIRPLIUKŲ;2233966176;Taip;0;1;9;10
10429;Sakalėlis;SVIRPLIUKŲ;7079300418;Taip;10;0;2;12
10430;Sakalėlis;SVIRPLIUKŲ;8659925528;Taip;16;0;0;16
10431;Sakalėlis;GANDRIUKŲ;8502289806;Taip;0;6;0;6
10432;Sakalėlis;GANDRIUKŲ;5292978341;Taip;0;4;1;5
10433;Sakalėlis;GANDRIUKŲ;9368758708;Taip;18;0;0;18
10434;Sakalėlis;GANDRIUKŲ;8326977226;Taip;0;1;0;1
10435;Sakalėlis;GANDRIUKŲ;7384400795;Taip;10;3;3;16
10436;Sakalėlis;GANDRIUKŲ;3644413861;Taip;6;1;0;7
10437;Sakalėlis;GANDRIUKŲ;4576495786;Taip;0;4;0;4
10438;Sakalėlis;GANDRIUKŲ;4230762388;Ne;14;0;0;14
10439;Sakalėlis;GANDRIUKŲ;3228617971;Taip;0;3;2;5
10440;Sakalėlis;GANDRIUKŲ;1545323439;Taip;5;0;3;8
10441;Sakalėlis;GANDRIUKŲ;5748438461;Ne;5;6;0;11
10442;Sakalėlis;GANDRIUKŲ;2481285439;Taip;0;1;3;4
10443;Sakalėlis;GANDRIUKŲ;7345113972;Taip;0;1;0;1
10444;Sakalėlis;GANDRIUKŲ;6069544792;Ne;0;0;4;4
10445;Sakalėlis;GANDRIUKŲ;5460619168;Taip;8;0;1;9
10446;Sakalėlis;GANDRIUKŲ;1560077883;Ne;5;6;0;11
10447;Salininkų;BORUŽIUKAI;8329495685;Taip;8;0;0;8
10448;Salininkų;BORUŽIUKAI;1005025619;Ne;0;10;0;10
10449;Salininkų;BORUŽIUKAI;3925860408;Taip;6;0;0;6
10450;Salininkų;BORUŽIUKAI;2146404021;Taip;0;1;0;1
10451;Salininkų;BORUŽIUKAI;8718514114;Ne;22;0;0;22
10452;Salininkų;BORUŽIUKAI;8930622266;Taip;3;5;0;8
10453;Salininkų;BORUŽIUKAI;5447236646;Taip;5;1;3;9
10454;Salininkų;BORUŽIUKAI;2208793412;Taip;0;2;0;2
10455;Salininkų;BORUŽIUKAI;1647401700;Taip;7;2;2;11
10456;Salininkų;BORUŽIUKAI;9817285587;Taip;13;0;0;13
10457;Salininkų;BORUŽIUKAI;8823595510;Taip;6;0;0;6
10458;Salininkų;BORUŽIUKAI;9416926474;Taip;11;1;1;13
10459;Salininkų;BORUŽIUKAI;5671229613;Taip;0;1;0;1
10460;Salininkų;BORUŽIUKAI;1254843449;Ne;7;4;0;11
10461;Salininkų;BORUŽIUKAI;3231379271;Taip;0;21;0;21
10462;Salininkų;BORUŽIUKAI;1346133493;Taip;0;1;0;1
10463;Salininkų;BORUŽIUKAI;2273407270;Taip;0;1;0;1
10464;Salininkų;BORUŽIUKAI;9855014750;Taip;0;0;1;1
10465;Salininkų;BORUŽIUKAI;8911016037;Taip;11;0;0;11
10466;Salininkų;GĖLYTĖS;8602489420;Taip;10;3;0;13
10467;Salininkų;GĖLYTĖS;2895782373;Taip;0;6;0;6
10468;Salininkų;GĖLYTĖS;4971070998;Taip;0;0;3;3
10469;Salininkų;GĖLYTĖS;9893985732;Taip;5;10;0;15
10470;Salininkų;GĖLYTĖS;3686372180;Taip;13;0;0;13
10471;Salininkų;GĖLYTĖS;9892443649;Taip;0;1;0;1
10472;Salininkų;GĖLYTĖS;3703729963;Taip;5;2;0;7
10473;Salininkų;GĖLYTĖS;3338213592;Taip;0;4;0;4
10474;Salininkų;GĖLYTĖS;6510096414;Taip;5;7;0;12
10475;Salininkų;GĖLYTĖS;2491796874;Taip;5;0;0;5
10476;Salininkų;GĖLYTĖS;3464228778;Taip;3;4;0;7
10477;Salininkų;GĖLYTĖS;8141168894;Taip;10;0;0;10
10478;Salininkų;GĖLYTĖS;2440831687;Taip;6;5;0;11
10479;Salininkų;GĖLYTĖS;1284909139;Taip;3;3;0;6
10480;Salininkų;GĖLYTĖS;5164367382;Ne;5;2;1;8
10481;Salininkų;GĖLYTĖS;2726813574;Taip;4;5;0;9
10482;Salininkų;GĖLYTĖS;1453214735;Taip;2;1;0;3
10483;Salininkų;DRUGELIAI;2684868661;Taip;0;1;0;1
10484;Salininkų;DRUGELIAI;4333027447;Taip;1;1;0;2
10485;Salininkų;DRUGELIAI;2009246885;Taip;1;0;3;4
10486;Salininkų;DRUGELIAI;3420217477;Taip;0;0;2;2
10487;Salininkų;DRUGELIAI;3890914603;Taip;7;6;0;13
10488;Salininkų;DRUGELIAI;3181932118;Taip;7;6;0;13
10489;Salininkų;DRUGELIAI;5017068344;Taip;5;0;0;5
10490;Salininkų;DRUGELIAI;3761217912;Taip;5;0;0;5
10491;Salininkų;DRUGELIAI;2208607684;Taip;0;4;0;4
10492;Salininkų;DRUGELIAI;3963410827;Taip;10;0;1;11
10493;Salininkų;DRUGELIAI;5539560359;Taip;6;0;7;13
10494;Salininkų;DRUGELIAI;5587577036;Taip;9;0;1;10
10495;Salininkų;DRUGELIAI;5375668400;Taip;0;3;0;3
10496;Salininkų;DRUGELIAI;4529253958;Taip;0;1;0;1
10497;Salininkų;DRUGELIAI;5583804491;Taip;11;0;0;11
10498;Salininkų;DRUGELIAI;7063718023;Taip;5;0;0;5
10499;Salininkų;DRUGELIAI;9018366347;Taip;11;0;0;11
10500;Salininkų;ŽIRNIUKAI;7643665643;Taip;0;2;0;2
10501;Salininkų;ŽIRNIUKAI;9198411540;Taip;6;0;0;6
10502;Salininkų;ŽIRNIUKAI;6885580632;Taip;10;2;0;12
10503;Salininkų;ŽIRNIUKAI;7409604480;Ne;0;2;4;6
10504;Salininkų;ŽIRNIUKAI;3677558828;Taip;1;0;0;1
10505;Salininkų;ŽIRNIUKAI;8095820690;Ne;1;0;1;2
10506;Salininkų;ŽIRNIUKAI;6482437251;Taip;0;0;3;3
10507;Salininkų;ŽIRNIUKAI;1380797788;Taip;2;7;0;9
10508;Salininkų;ŽIRNIUKAI;2495782496;Taip;0;1;0;1
10509;Salininkų;ŽIRNIUKAI;9896357816;Taip;7;1;0;8
10510;Salininkų;ŽIRNIUKAI;4568462071;Taip;5;0;2;7
10511;Salininkų;ŽIRNIUKAI;9137783249;Taip;5;2;0;7
10512;Salininkų;ŽIRNIUKAI;8524400656;Taip;5;2;0;7
10513;Salininkų;ŽIRNIUKAI;7463713798;Taip;0;8;4;12
10514;Salininkų;ŽIRNIUKAI;9617873735;Taip;6;0;0;6
10515;Salininkų;ŽIRNIUKAI;1111197633;Taip;5;1;0;6
10516;Salininkų;ŽIRNIUKAI;6143967744;Taip;9;0;3;12
10517;Salininkų;ŽIRNIUKAI;8552427446;Taip;0;0;8;8
10518;Salininkų;ŽIRNIUKAI;6586988786;Taip;8;0;0;8
10519;Salininkų;ŽIRNIUKAI;1587485662;Ne;0;1;5;6
10520;Salininkų;PAUKŠČIUKAI;8047582970;Taip;0;0;1;1
10521;Salininkų;PAUKŠČIUKAI;6850925495;Taip;0;1;2;3
10522;Salininkų;PAUKŠČIUKAI;3585435095;Taip;10;1;0;11
10523;Salininkų;PAUKŠČIUKAI;2760231414;Taip;0;1;0;1
10524;Salininkų;PAUKŠČIUKAI;7665409499;Taip;10;0;2;12
10525;Salininkų;PAUKŠČIUKAI;1658695150;Taip;5;1;1;7
10526;Salininkų;PAUKŠČIUKAI;7383557807;Taip;0;14;0;14
10527;Salininkų;PAUKŠČIUKAI;9344614003;Taip;0;1;0;1
10528;Salininkų;PAUKŠČIUKAI;2808778763;Ne;0;9;0;9
10529;Salininkų;PAUKŠČIUKAI;6656578271;Taip;4;2;2;8
10530;Salininkų;PAUKŠČIUKAI;7737045952;Taip;0;0;1;1
10531;Salininkų;PAUKŠČIUKAI;9890660815;Taip;0;1;0;1
10532;Salininkų;PAUKŠČIUKAI;8995565864;Taip;1;2;0;3
10533;Salininkų;PAUKŠČIUKAI;7782972361;Taip;0;1;0;1
10534;Salininkų;PAUKŠČIUKAI;8394582546;Taip;0;5;0;5
10535;Salininkų;PAUKŠČIUKAI;6327046935;Taip;10;1;0;11
10536;Salininkų;PAUKŠČIUKAI;4425748908;Taip;1;7;0;8
10537;Salininkų;PAUKŠČIUKAI;4323257798;Taip;0;1;0;1
10538;Salininkų;PAUKŠČIUKAI;6266609965;Taip;0;3;0;3
10539;Salininkų;PAUKŠČIUKAI;3737834032;Taip;0;0;6;6
10540;Salininkų;BITUTĖS;3252151974;Ne;19;0;2;21
10541;Salininkų;BITUTĖS;6845471044;Taip;11;0;1;12
10542;Salininkų;BITUTĖS;7253347059;Taip;6;0;0;6
10543;Salininkų;BITUTĖS;2467926286;Taip;3;3;0;6
10544;Salininkų;BITUTĖS;8774984357;Taip;0;0;3;3
10545;Salininkų;BITUTĖS;9902751686;Taip;0;1;0;1
10546;Salininkų;BITUTĖS;6551489987;Taip;0;3;0;3
10547;Salininkų;BITUTĖS;6979816464;Taip;0;1;0;1
10548;Salininkų;BITUTĖS;1928897962;Taip;14;1;0;15
10549;Salininkų;BITUTĖS;3527495230;Taip;0;1;0;1
10550;Salininkų;BITUTĖS;5582091833;Ne;0;1;0;1
10551;Salininkų;BITUTĖS;2073939432;Taip;0;1;0;1
10552;Salininkų;BITUTĖS;9996809930;Taip;0;0;2;2
10553;Salininkų;BITUTĖS;3915336062;Taip;1;0;0;1
10554;Salininkų;BITUTĖS;6577237672;Taip;4;1;0;5
10555;Salininkų;BITUTĖS;7115888747;Taip;5;0;4;9
10556;Salininkų;BITUTĖS;7639362434;Taip;0;0;4;4
10557;Salininkų;BITUTĖS;2370778977;Taip;3;0;0;3
10558;Salininkų;BITUTĖS;1020073382;Taip;3;0;0;3
10559;Salininkų;BITUTĖS;4480303856;Taip;5;1;7;13
10560;Salvija;Daigelis(šatil);1062662192;Taip;0;0;1;1
10561;Salvija;Daigelis(šatil);4577248630;Taip;0;7;0;7
10562;Salvija;Daigelis(šatil);9978634888;Taip;0;0;18;18
10563;Salvija;Daigelis(šatil);1676795179;Taip;0;0;4;4
10564;Salvija;Daigelis(šatil);4665919836;Taip;0;0;1;1
10565;Salvija;Daigelis(šatil);1511271658;Taip;1;0;0;1
10566;Salvija;Daigelis(šatil);3345231579;Taip;1;0;6;7
10567;Salvija;Daigelis(šatil);8337554678;Taip;0;0;1;1
10568;Salvija;Daigelis(šatil);5327735648;Taip;5;0;3;8
10569;Salvija;Daigelis(šatil);5805537864;Taip;0;3;0;3
10570;Salvija;Daigelis(šatil);6323383244;Taip;0;2;0;2
10571;Salvija;Daigelis(šatil);1043297837;Taip;6;0;5;11
10572;Salvija;Daigelis(šatil);3857916185;Taip;0;0;3;3
10573;Salvija;Daigelis(šatil);5554431690;Taip;0;0;6;6
10574;Salvija;Daigelis(šatil);1065575041;Taip;8;0;6;14
10575;Salvija;Daigelis(šatil);1168900211;Taip;0;0;2;2
10576;Salvija;Daigelis(šatil);7410091250;Taip;1;0;2;3
10577;Salvija;"Pienė (savjon)";8023422294;Taip;7;0;0;7
10578;Salvija;"Pienė (savjon)";4152602039;Ne;3;0;2;5
10579;Salvija;"Pienė (savjon)";8981331532;Taip;5;0;3;8
10580;Salvija;"Pienė (savjon)";7455466649;Taip;21;0;0;21
10581;Salvija;"Pienė (savjon)";8306404275;Taip;0;0;3;3
10582;Salvija;"Pienė (savjon)";1261005294;Taip;0;0;1;1
10583;Salvija;"Pienė (savjon)";8013023311;Taip;0;0;2;2
10584;Salvija;"Pienė (savjon)";1653831148;Taip;5;2;0;7
10585;Salvija;"Pienė (savjon)";4325636377;Taip;4;0;0;4
10586;Salvija;"Pienė (savjon)";1625197280;Taip;7;0;1;8
10587;Salvija;"Pienė (savjon)";8892646200;Taip;13;0;1;14
10588;Salvija;"Pienė (savjon)";7477171133;Ne;0;0;3;3
10589;Salvija;"Pienė (savjon)";6706565915;Taip;0;0;3;3
10590;Salvija;"Pienė (savjon)";8853389268;Ne;0;1;0;1
10591;Salvija;"Pienė (savjon)";3856351749;Ne;0;0;1;1
10592;Salvija;"Pienė (savjon)";8158680641;Taip;6;0;0;6
10593;Salvija;"Pienė (savjon)";7862619996;Ne;0;0;4;4
10594;Salvija;"Pienė (savjon)";3487446998;Taip;0;0;1;1
10595;Salvija;"Pienė (savjon)";5816893736;Taip;0;0;2;2
10596;Salvija;"Pienė (savjon)";1975032693;Ne;0;0;4;4
10597;Saulėtekis;BERŽELIS;3493175211;Taip;5;5;0;10
10598;Saulėtekis;BERŽELIS;8023603198;Taip;11;0;0;11
10599;Saulėtekis;BERŽELIS;8086451893;Taip;11;0;0;11
10600;Saulėtekis;BERŽELIS;9351122147;Taip;1;0;0;1
10601;Saulėtekis;BERŽELIS;6667804855;Taip;0;1;3;4
10602;Saulėtekis;BERŽELIS;1852180633;Taip;3;0;2;5
10603;Saulėtekis;BERŽELIS;5468364505;Taip;0;0;2;2
10604;Saulėtekis;BERŽELIS;4704426104;Taip;12;0;0;12
10605;Saulėtekis;BERŽELIS;6920619390;Ne;5;0;1;6
10606;Saulėtekis;BERŽELIS;7698241758;Taip;10;0;1;11
10607;Saulėtekis;BERŽELIS;5194925689;Taip;13;1;0;14
10608;Saulėtekis;BERŽELIS;1241071413;Taip;11;0;0;11
10609;Saulėtekis;BERŽELIS;7494641077;Taip;10;1;0;11
10610;Saulėtekis;BERŽELIS;1577609727;Taip;10;1;0;11
10611;Saulėtekis;BERŽELIS;2672108464;Taip;7;0;1;8
10612;Saulėtekis;BERŽELIS;9579088485;Taip;3;4;0;7
10613;Saulėtekis;BERŽELIS;2568544418;Taip;3;0;0;3
10614;Saulėtekis;BERŽELIS;8927598999;Ne;16;0;0;16
10615;Saulėtekis;BERŽELIS;9734188792;Ne;16;0;1;17
10616;Saulėtekis;BERŽELIS;6983324115;Taip;0;1;0;1
10617;Saulėtekis;BERŽELIS;8061477303;Taip;9;0;2;11
10618;Saulėtekis;BERŽELIS;7436158953;Taip;1;0;1;2
10619;Saulėtekis;ŠYPSENA;1720125332;Ne;3;0;0;3
10620;Saulėtekis;ŠYPSENA;9972687066;Taip;0;1;0;1
10621;Saulėtekis;ŠYPSENA;7346852524;Taip;7;1;0;8
10622;Saulėtekis;ŠYPSENA;6072030240;Taip;0;1;0;1
10623;Saulėtekis;ŠYPSENA;7893982893;Taip;7;4;1;12
10624;Saulėtekis;ŠYPSENA;7505040675;Taip;0;2;0;2
10625;Saulėtekis;ŠYPSENA;9791926936;Taip;0;0;2;2
10626;Saulėtekis;ŠYPSENA;8620689981;Taip;2;1;0;3
10627;Saulėtekis;ŠYPSENA;8143793642;Taip;0;2;0;2
10628;Saulėtekis;ŠYPSENA;7673965242;Taip;21;0;0;21
10629;Saulėtekis;ŠYPSENA;3166959569;Taip;0;0;5;5
10630;Saulėtekis;ŠYPSENA;9661075465;Taip;0;2;0;2
10631;Saulėtekis;ŠYPSENA;9383567339;Taip;21;0;0;21
10632;Saulėtekis;ŠYPSENA;6608831217;Taip;8;4;0;12
10633;Saulėtekis;ŠYPSENA;7730889108;Taip;5;1;2;8
10634;Saulėtekis;ŠYPSENA;7435424899;Taip;10;1;0;11
10635;Saulėtekis;ŠYPSENA;7803735686;Taip;6;0;0;6
10636;Saulėtekis;ŠYPSENA;9694119292;Taip;1;0;20;21
10637;Saulėtekis;ŠYPSENA;8881524909;Taip;7;0;0;7
10638;Saulėtekis;ŠYPSENA;5518726567;Taip;7;1;0;8
10639;Saulėtekis;ŠYPSENA;2555073719;Ne;7;0;4;11
10640;Saulėtekis;ŠYPSENA;2177470008;Taip;10;0;4;14
10641;Saulėtekis;ŠYPSENA;4250589212;Taip;0;0;10;10
10642;Saulėtekis;NYKŠTUKAI;1896847801;Taip;1;0;0;1
10643;Saulėtekis;NYKŠTUKAI;2686041419;Taip;0;0;3;3
10644;Saulėtekis;NYKŠTUKAI;7849181976;Taip;1;0;1;2
10645;Saulėtekis;NYKŠTUKAI;5748816813;Taip;12;1;0;13
10646;Saulėtekis;NYKŠTUKAI;7555273745;Taip;11;0;0;11
10647;Saulėtekis;NYKŠTUKAI;1416983683;Taip;5;1;0;6
10648;Saulėtekis;NYKŠTUKAI;4758423356;Taip;6;2;0;8
10649;Saulėtekis;NYKŠTUKAI;9270109327;Taip;6;2;0;8
10650;Saulėtekis;NYKŠTUKAI;8273890475;Taip;6;0;2;8
10651;Saulėtekis;NYKŠTUKAI;5183297420;Taip;4;3;0;7
10652;Saulėtekis;NYKŠTUKAI;8007704080;Taip;17;0;0;17
10653;Saulėtekis;NYKŠTUKAI;8683571534;Ne;9;2;0;11
10654;Saulėtekis;NYKŠTUKAI;9481578412;Taip;21;0;0;21
10655;Saulėtekis;NYKŠTUKAI;8167740525;Taip;10;0;0;10
10656;Saulėtekis;NYKŠTUKAI;3371045145;Taip;9;0;0;9
10657;Saulėtekis;NYKŠTUKAI;9818660340;Taip;11;0;0;11
10658;Saulėtekis;NYKŠTUKAI;3729811521;Taip;8;0;0;8
10659;Saulėtekis;NYKŠTUKAI;5888979911;Taip;1;4;0;5
10660;Saulėtekis;NYKŠTUKAI;9787534807;Taip;4;0;1;5
10661;Saulėtekis;NYKŠTUKAI;8090571664;Taip;6;0;0;6
10662;Saulėtekis;NYKŠTUKAI;9104549419;Taip;9;0;0;9
10663;Saulėtekis;NYKŠTUKAI;3957655772;Taip;16;0;0;16
10664;Saulėtekis;PAGRANDUKAS;8102360466;Taip;0;1;1;2
10665;Saulėtekis;PAGRANDUKAS;2371396923;Taip;0;1;0;1
10666;Saulėtekis;PAGRANDUKAS;4152255439;Taip;3;1;0;4
10667;Saulėtekis;PAGRANDUKAS;2209156661;Taip;0;6;0;6
10668;Saulėtekis;PAGRANDUKAS;5552614092;Ne;0;1;0;1
10669;Saulėtekis;PAGRANDUKAS;9497129509;Taip;0;0;2;2
10670;Saulėtekis;PAGRANDUKAS;7186085219;Taip;4;1;0;5
10671;Saulėtekis;PAGRANDUKAS;1020209414;Taip;0;3;0;3
10672;Saulėtekis;PAGRANDUKAS;8745921541;Taip;5;1;0;6
10673;Saulėtekis;PAGRANDUKAS;2728836108;Taip;7;1;2;10
10674;Saulėtekis;PAGRANDUKAS;7164579375;Ne;0;1;0;1
10675;Saulėtekis;PAGRANDUKAS;8574702901;Taip;0;1;0;1
10676;Saulėtekis;PAGRANDUKAS;9941731250;Taip;0;0;1;1
10677;Saulėtekis;PAGRANDUKAS;4038684284;Ne;12;0;0;12
10678;Saulėtekis;PAGRANDUKAS;2935641362;Taip;8;0;1;9
10679;Saulėtekis;PAGRANDUKAS;4676218435;Ne;0;1;1;2
10680;Saulėtekis;PAGRANDUKAS;7598254324;Taip;17;0;0;17
10681;Saulėtekis;PAGRANDUKAS;6026600803;Taip;8;0;0;8
10682;Saulėtekis;PAGRANDUKAS;9737568538;Taip;1;1;2;4
10683;Saulėtekis;PAGRANDUKAS;8468491266;Taip;13;0;0;13
10684;Saulėtekis;PAGRANDUKAS;6181992249;Ne;0;0;3;3
10685;Saulėtekis;PAGRANDUKAS;8390615573;Taip;5;0;1;6
10686;Saulėtekis;PAGRANDUKAS;3366064429;Taip;0;1;1;2
10687;Saulėtekis;PAGRANDUKAS;5824537129;Taip;1;0;6;7
10688;Saulėtekis;RAMUNĖLIŲ;8739919774;Taip;9;0;0;9
10689;Saulėtekis;RAMUNĖLIŲ;4681031693;Taip;0;0;1;1
10690;Saulėtekis;RAMUNĖLIŲ;2316817605;Taip;1;0;0;1
10691;Saulėtekis;RAMUNĖLIŲ;3987535802;Taip;9;0;1;10
10692;Saulėtekis;RAMUNĖLIŲ;5297650157;Taip;10;0;0;10
10693;Saulėtekis;RAMUNĖLIŲ;6979741482;Taip;7;0;1;8
10694;Saulėtekis;RAMUNĖLIŲ;8348456528;Taip;10;0;0;10
10695;Saulėtekis;RAMUNĖLIŲ;1866452425;Taip;0;10;8;18
10696;Saulėtekis;RAMUNĖLIŲ;3430209353;Taip;0;0;2;2
10697;Saulėtekis;RAMUNĖLIŲ;5980690239;Taip;9;1;3;13
10698;Saulėtekis;RAMUNĖLIŲ;2786112846;Taip;0;1;1;2
10699;Saulėtekis;RAMUNĖLIŲ;8876580678;Taip;0;1;1;2
10700;Saulėtekis;RAMUNĖLIŲ;1427323748;Taip;21;0;0;21
10701;Saulėtekis;RAMUNĖLIŲ;3224110585;Taip;1;8;0;9
10702;Saulėtekis;RAMUNĖLIŲ;2002180753;Taip;8;0;5;13
10703;Saulėtekis;RAMUNĖLIŲ;5685176596;Taip;3;0;2;5
10704;Saulėtekis;RAMUNĖLIŲ;3555868198;Taip;8;0;0;8
10705;Saulėtekis;RAMUNĖLIŲ;9668125862;Taip;14;0;1;15
10706;Saulėtekis;RAMUNĖLIŲ;4736430248;Taip;8;0;5;13
10707;Saulėtekis;RAMUNĖLIŲ;1108736588;Ne;6;0;0;6
10708;Saulėtekis;RAMUNĖLIŲ;3680199463;Taip;4;1;3;8
10709;Saulėtekis;RAMUNĖLIŲ;2383861394;Taip;5;11;0;16
10710;Saulėtekis;RAMUNĖLIŲ;2872732978;Taip;6;7;0;13
10711;Saulėtekis;PASAKAITĖ;8033763960;Taip;10;0;0;10
10712;Saulėtekis;PASAKAITĖ;9428709415;Taip;6;0;0;6
10713;Saulėtekis;PASAKAITĖ;5086871001;Taip;7;0;0;7
10714;Saulėtekis;PASAKAITĖ;2446282019;Taip;0;1;0;1
10715;Saulėtekis;PASAKAITĖ;8572701238;Taip;5;1;0;6
10716;Saulėtekis;PASAKAITĖ;6063956790;Taip;0;1;0;1
10717;Saulėtekis;PASAKAITĖ;4437540996;Taip;8;1;0;9
10718;Saulėtekis;PASAKAITĖ;7407451018;Taip;4;11;0;15
10719;Saulėtekis;PASAKAITĖ;9226317303;Taip;6;1;0;7
10720;Saulėtekis;PASAKAITĖ;9267790598;Taip;6;2;3;11
10721;Saulėtekis;PASAKAITĖ;6670590135;Taip;1;2;0;3
10722;Saulėtekis;PASAKAITĖ;6720758829;Taip;5;1;0;6
10723;Saulėtekis;PASAKAITĖ;7966714585;Taip;9;0;0;9
10724;Saulėtekis;PASAKAITĖ;3224883243;Taip;6;0;0;6
10725;Saulėtekis;PASAKAITĖ;9382031144;Taip;0;13;0;13
10726;Saulėtekis;PASAKAITĖ;3371914339;Taip;0;1;0;1
10727;Saulėtekis;PASAKAITĖ;6214539956;Taip;10;2;0;12
10728;Saulėtekis;PASAKAITĖ;9584556476;Taip;6;4;0;10
10729;Saulėtekis;PASAKAITĖ;9799880235;Taip;0;2;0;2
10730;Saulėtekis;PASAKAITĖ;2469458604;Taip;21;0;0;21
10731;Saulėtekis;PASAKAITĖ;3499575148;Taip;0;2;0;2
10732;Saulėtekis;PASAKAITĖ;2206038658;Taip;9;0;0;9
10733;Saulėtekis;VARPELIAI;3303064486;Taip;5;0;0;5
10734;Saulėtekis;VARPELIAI;1355354514;Taip;1;4;0;5
10735;Saulėtekis;VARPELIAI;8195320453;Ne;10;0;1;11
10736;Saulėtekis;VARPELIAI;6534433593;Taip;9;0;0;9
10737;Saulėtekis;VARPELIAI;5997903066;Taip;0;0;2;2
10738;Saulėtekis;VARPELIAI;7338301696;Taip;1;8;0;9
10739;Saulėtekis;VARPELIAI;5870177112;Taip;10;0;1;11
10740;Saulėtekis;VARPELIAI;7171550857;Taip;1;0;8;9
10741;Saulėtekis;VARPELIAI;3157110037;Taip;21;0;0;21
10742;Saulėtekis;VARPELIAI;8331659142;Ne;16;0;5;21
10743;Saulėtekis;VARPELIAI;3832717108;Taip;8;0;0;8
10744;Saulėtekis;VARPELIAI;1198692142;Taip;19;0;0;19
10745;Saulėtekis;VARPELIAI;1240595768;Taip;7;0;0;7
10746;Saulėtekis;VARPELIAI;7625074947;Taip;7;0;1;8
10747;Saulėtekis;VARPELIAI;1479530265;Taip;5;1;1;7
10748;Saulėtekis;VARPELIAI;1164913351;Taip;12;0;0;12
10749;Saulėtekis;GRŪDELIS;1864236745;Taip;0;1;0;1
10750;Saulėtekis;GRŪDELIS;7171048750;Taip;0;0;2;2
10751;Saulėtekis;GRŪDELIS;6535620172;Taip;4;0;7;11
10752;Saulėtekis;GRŪDELIS;8252953405;Taip;10;1;0;11
10753;Saulėtekis;GRŪDELIS;8219644557;Taip;0;0;5;5
10754;Saulėtekis;GRŪDELIS;5161940030;Taip;0;0;1;1
10755;Saulėtekis;GRŪDELIS;5218345414;Taip;9;0;0;9
10756;Saulėtekis;GRŪDELIS;9646060606;Taip;0;4;1;5
10757;Saulėtekis;GRŪDELIS;1934900185;Ne;14;2;0;16
10758;Saulėtekis;GRŪDELIS;1331793286;Taip;10;1;2;13
10759;Saulėtekis;GRŪDELIS;9995919137;Taip;11;2;0;13
10760;Saulėtekis;GRŪDELIS;8138047893;Taip;14;1;0;15
10761;Saulėtekis;GRŪDELIS;3953501167;Taip;10;0;0;10
10762;Saulėtekis;GRŪDELIS;2799966199;Ne;0;13;0;13
10763;Saulėtekis;GRŪDELIS;2646213073;Taip;0;3;2;5
10764;Saulėtekis;GRŪDELIS;6482182524;Taip;10;0;2;12
10765;Saulėtekis;GRŪDELIS;6779891385;Taip;6;0;0;6
10766;Saulėtekis;GRŪDELIS;9743690247;Taip;14;0;0;14
10767;Saulėtekis;GRŪDELIS;7666624373;Taip;9;0;0;9
10768;Saulėtekis;JONVABALIS;1715634399;Ne;0;6;0;6
10769;Saulėtekis;JONVABALIS;7227802003;Taip;0;1;0;1
10770;Saulėtekis;JONVABALIS;4613040294;Taip;7;1;0;8
10771;Saulėtekis;JONVABALIS;1655720839;Taip;5;2;0;7
10772;Saulėtekis;JONVABALIS;3166181835;Taip;1;2;0;3
10773;Saulėtekis;JONVABALIS;6599452886;Taip;0;1;0;1
10774;Saulėtekis;JONVABALIS;8896065807;Taip;14;0;0;14
10775;Saulėtekis;JONVABALIS;3207128776;Taip;6;0;0;6
10776;Saulėtekis;JONVABALIS;2311184444;Taip;10;2;0;12
10777;Saulėtekis;JONVABALIS;9618342480;Taip;0;1;0;1
10778;Saulėtekis;JONVABALIS;1516164123;Taip;0;1;0;1
10779;Saulėtekis;JONVABALIS;60462712074;Taip;0;1;0;1
10780;Saulėtekis;JONVABALIS;1902333363;Taip;7;1;0;8
10781;Saulėtekis;JONVABALIS;4610536784;Ne;0;3;0;3
10782;Saulėtekis;JONVABALIS;8239855620;Taip;0;5;0;5
10783;Saulėtekis;JONVABALIS;6501250875;Taip;2;3;0;5
10784;Saulėtekis;JONVABALIS;8231869593;Taip;0;11;0;11
10785;Saulėtekis;JONVABALIS;8603952810;Taip;5;2;0;7
10786;Saulėtekis;JONVABALIS;9657195627;Taip;3;2;0;5
10787;Saulėtekis;JONVABALIS;3541535891;Taip;9;1;0;10
10788;Saulėtekis;JONVABALIS;4663268649;Taip;5;2;0;7
10789;Saulėtekis;JONVABALIS;25199011812;Taip;9;0;0;9
10790;Saulėtekis;SMALSUČIAI;2474900044;Taip;1;1;0;2
10791;Saulėtekis;SMALSUČIAI;2021901593;Taip;2;2;0;4
10792;Saulėtekis;SMALSUČIAI;5954194843;Taip;6;0;0;6
10793;Saulėtekis;SMALSUČIAI;2546789906;Taip;13;1;0;14
10794;Saulėtekis;SMALSUČIAI;8002806189;Taip;1;0;3;4
10795;Saulėtekis;SMALSUČIAI;4832534190;Taip;12;1;0;13
10796;Saulėtekis;SMALSUČIAI;2238947856;Taip;2;1;0;3
10797;Saulėtekis;SMALSUČIAI;5678858566;Taip;0;4;0;4
10798;Saulėtekis;SMALSUČIAI;2407911405;Taip;0;1;0;1
10799;Saulėtekis;SMALSUČIAI;9634949452;Taip;0;1;0;1
10800;Saulėtekis;SMALSUČIAI;3450907715;Ne;0;13;0;13
10801;Saulėtekis;SMALSUČIAI;4338502152;Taip;0;1;0;1
10802;Saulėtekis;SMALSUČIAI;81153273188;Taip;10;1;0;11
10803;Saulėtekis;SMALSUČIAI;6102064617;Taip;0;1;1;2
10804;Saulėtekis;SMALSUČIAI;7842280836;Taip;0;1;1;2
10805;Saulėtekis;SMALSUČIAI;9945647968;Taip;0;3;0;3
10806;Saulėtekis;SMALSUČIAI;9983577817;Taip;0;1;3;4
10807;Saulėtekis;SMALSUČIAI;84982517658;Taip;0;6;1;7
10808;Saulėtekis;SMALSUČIAI;5487547105;Ne;0;21;0;21
10809;Saulėtekis;SMALSUČIAI;1922979974;Taip;9;0;0;9
10810;Saulėtekis;BITUTĖS;7766084857;Taip;0;1;1;2
10811;Saulėtekis;BITUTĖS;4537254306;Taip;0;1;0;1
10812;Saulėtekis;BITUTĖS;1699576940;Ne;0;1;1;2
10813;Saulėtekis;BITUTĖS;1481503733;Ne;0;1;0;1
10814;Saulėtekis;BITUTĖS;8302260087;Taip;3;1;1;5
10815;Saulėtekis;BITUTĖS;2593106154;Taip;0;3;0;3
10816;Saulėtekis;BITUTĖS;2813949848;Taip;0;2;2;4
10817;Saulėtekis;BITUTĖS;6643388548;Taip;5;1;0;6
10818;Saulėtekis;BITUTĖS;3058991890;Taip;0;2;0;2
10819;Saulėtekis;BITUTĖS;7986712728;Taip;0;6;0;6
10820;Saulėtekis;BITUTĖS;6087170055;Ne;1;1;4;6
10821;Saulėtekis;BITUTĖS;7758268674;Taip;0;1;3;4
10822;Saulėtekis;BITUTĖS;2077976415;Taip;4;1;2;7
10823;Saulėtekis;BITUTĖS;7075757274;Taip;5;1;5;11
10824;Saulėtekis;BITUTĖS;9870595577;Taip;0;1;0;1
10825;Saulėtekis;BITUTĖS;2154590089;Taip;4;2;0;6
10826;Saulėtekis;BITUTĖS;3220993253;Taip;1;0;0;1
10827;Saulėtekis;BITUTĖS;9918219913;Taip;0;1;4;5
10828;Saulėtekis;BITUTĖS;2698535938;Taip;0;2;0;2
10829;Saulėtekis;BITUTĖS;8517049464;Taip;0;1;0;1
10830;Saulėtekis;BITUTĖS;2656659133;Taip;0;2;0;2
10831;Saulėtekis;BITUTĖS;7027103276;Taip;0;1;3;4
10832;Saulėtekis;BITUTĖS;9605052795;Taip;0;1;3;4
10833;Saulėtekis;RIEŠUTĖLIAI;8767786444;Taip;10;1;0;11
10834;Saulėtekis;RIEŠUTĖLIAI;2224626144;Taip;16;1;0;17
10835;Saulėtekis;RIEŠUTĖLIAI;9270231819;Taip;9;1;0;10
10836;Saulėtekis;RIEŠUTĖLIAI;5898051775;Taip;5;1;6;12
10837;Saulėtekis;RIEŠUTĖLIAI;7898928446;Taip;0;5;0;5
10838;Saulėtekis;RIEŠUTĖLIAI;3356705340;Taip;11;1;0;12
10839;Saulėtekis;RIEŠUTĖLIAI;2849915655;Ne;5;1;2;8
10840;Saulėtekis;RIEŠUTĖLIAI;7824492464;Taip;10;1;0;11
10841;Saulėtekis;RIEŠUTĖLIAI;3935935671;Taip;17;0;0;17
10842;Saulėtekis;RIEŠUTĖLIAI;7807096583;Taip;13;2;0;15
10843;Saulėtekis;RIEŠUTĖLIAI;2548612572;Taip;8;1;0;9
10844;Saulėtekis;RIEŠUTĖLIAI;2908714227;Taip;16;1;1;18
10845;Saulėtekis;RIEŠUTĖLIAI;7305619721;Taip;0;18;0;18
10846;Saulėtekis;RIEŠUTĖLIAI;9516841263;Taip;3;1;2;6
10847;Saulėtekis;RIEŠUTĖLIAI;6557482092;Taip;0;1;0;1
10848;Saulėtekis;RIEŠUTĖLIAI;6183384994;Taip;10;1;1;12
10849;Saulėtekis;RIEŠUTĖLIAI;1540848694;Taip;4;1;0;5
10850;Saulėtekis;RIEŠUTĖLIAI;3559882322;Taip;5;1;3;9
10851;Saulėtekis;RIEŠUTĖLIAI;4767842376;Taip;6;1;0;7
10852;Skroblinukas;SVIRPLIUKŲ;5433647187;Taip;0;2;2;4
10853;Skroblinukas;SVIRPLIUKŲ;2195112297;Taip;23;1;2;26
10854;Skroblinukas;SVIRPLIUKŲ;4198512202;Taip;7;0;9;16
10855;Skroblinukas;SVIRPLIUKŲ;7750501815;Taip;18;0;2;20
10856;Skroblinukas;SVIRPLIUKŲ;4960825597;Taip;0;0;2;2
10857;Skroblinukas;SVIRPLIUKŲ;1544598440;Taip;11;1;0;12
10858;Skroblinukas;SVIRPLIUKŲ;6574558658;Taip;5;4;0;9
10859;Skroblinukas;SVIRPLIUKŲ;6254811026;Taip;5;0;5;10
10860;Skroblinukas;SVIRPLIUKŲ;4861971439;Taip;10;0;4;14
10861;Skroblinukas;SVIRPLIUKŲ;7817632987;Ne;0;2;1;3
10862;Skroblinukas;SVIRPLIUKŲ;7675772872;Ne;0;0;2;2
10863;Skroblinukas;SVIRPLIUKŲ;4266945644;Taip;12;0;1;13
10864;Skroblinukas;SVIRPLIUKŲ;9003855190;Ne;10;15;1;26
10865;Skroblinukas;SVIRPLIUKŲ;7216760382;Taip;20;0;1;21
10866;Skroblinukas;SVIRPLIUKŲ;5154111867;Taip;8;2;0;10
10867;Skroblinukas;SVIRPLIUKŲ;8622930871;Taip;21;1;2;24
10868;Skroblinukas;SVIRPLIUKŲ;9661609284;Taip;0;0;1;1
10869;Skroblinukas;SVIRPLIUKŲ;3260267388;Taip;0;0;7;7
10870;Skroblinukas;SVIRPLIUKŲ;7761972818;Taip;1;0;0;1
10871;Skroblinukas;SVIRPLIUKŲ;9629502585;Taip;3;8;0;11
10872;Skroblinukas;SVIRPLIUKŲ;6461678336;Taip;1;0;0;1
10873;Skroblinukas;SVIRPLIUKŲ;8283516422;Taip;7;0;1;8
10874;Skroblinukas;GANDRIUKŲ;2197158518;Taip;0;4;2;6
10875;Skroblinukas;GANDRIUKŲ;2406619611;Taip;0;2;1;3
10876;Skroblinukas;GANDRIUKŲ;9572912046;Taip;0;29;0;29
10877;Skroblinukas;GANDRIUKŲ;5646847921;Taip;27;2;0;29
10878;Skroblinukas;GANDRIUKŲ;1851920334;Taip;0;0;3;3
10879;Skroblinukas;GANDRIUKŲ;9377215921;Taip;3;0;0;3
10880;Skroblinukas;GANDRIUKŲ;6235844690;Taip;5;0;0;5
10881;Skroblinukas;GANDRIUKŲ;6489976163;Taip;6;0;3;9
10882;Skroblinukas;GANDRIUKŲ;1159546580;Taip;0;1;0;1
10883;Skroblinukas;GANDRIUKŲ;2630699296;Taip;0;1;0;1
10884;Skroblinukas;GANDRIUKŲ;2310750833;Taip;12;4;0;16
10885;Skroblinukas;GANDRIUKŲ;9888115079;Ne;0;0;3;3
10886;Skroblinukas;GANDRIUKŲ;9475514959;Ne;0;4;0;4
10887;Skroblinukas;GANDRIUKŲ;9031598603;Taip;8;2;1;11
10888;Skroblinukas;GANDRIUKŲ;5251903769;Ne;7;9;0;16
10889;Skroblinukas;GANDRIUKŲ;7385271438;Taip;0;0;1;1
10890;Skroblinukas;VYTURIUKŲ;3954228349;Taip;0;0;1;1
10891;Skroblinukas;VYTURIUKŲ;6879979868;Taip;0;1;2;3
10892;Skroblinukas;VYTURIUKŲ;4560580022;Taip;0;1;0;1
10893;Skroblinukas;VYTURIUKŲ;3065235192;Taip;10;0;0;10
10894;Skroblinukas;VYTURIUKŲ;5902713448;Taip;8;1;0;9
10895;Skroblinukas;VYTURIUKŲ;3594000419;Taip;0;3;0;3
10896;Skroblinukas;VYTURIUKŲ;3512297435;Taip;0;3;0;3
10897;Skroblinukas;VYTURIUKŲ;2481980627;Taip;0;0;1;1
10898;Skroblinukas;VYTURIUKŲ;6293879765;Taip;0;0;1;1
10899;Skroblinukas;VYTURIUKŲ;9725125130;Taip;0;0;1;1
10900;Skroblinukas;VYTURIUKŲ;2978284436;Taip;0;0;1;1
10901;Skroblinukas;VYTURIUKŲ;7068452970;Ne;2;0;2;4
10902;Skroblinukas;VYTURIUKŲ;3292517112;Taip;0;1;3;4
10903;Skroblinukas;VYTURIUKŲ;3461165182;Taip;0;0;18;18
10904;Skroblinukas;VYTURIUKŲ;4129726208;Taip;0;0;2;2
10905;Skroblinukas;VYTURIUKŲ;3351309750;Ne;0;0;1;1
10906;Skroblinukas;VYTURIUKŲ;5101136022;Ne;4;1;2;7
10907;Skroblinukas;VYTURIUKŲ;9828486832;Taip;5;0;1;6
10908;Skroblinukas;VYTURIUKŲ;7891369140;Taip;10;0;0;10
10909;Skroblinukas;GENIUKŲ;48655837755;Taip;0;1;0;1
10910;Skroblinukas;GENIUKŲ;2323980730;Taip;0;1;0;1
10911;Skroblinukas;GENIUKŲ;1325903217;Taip;0;5;0;5
10912;Skroblinukas;GENIUKŲ;8380073853;Taip;0;6;0;6
10913;Skroblinukas;GENIUKŲ;4436698905;Taip;6;2;0;8
10914;Skroblinukas;GENIUKŲ;1905085978;Taip;0;0;6;6
10915;Skroblinukas;GENIUKŲ;1557733803;Taip;4;2;0;6
10916;Skroblinukas;GENIUKŲ;9433465007;Taip;15;1;0;16
10917;Skroblinukas;GENIUKŲ;1395950886;Ne;0;1;1;2
10918;Skroblinukas;GENIUKŲ;1696303051;Taip;0;2;0;2
10919;Skroblinukas;GENIUKŲ;9846569195;Taip;0;1;2;3
10920;Skroblinukas;GENIUKŲ;4773576465;Taip;0;5;0;5
10921;Skroblinukas;GENIUKŲ;2704157855;Taip;10;1;0;11
10922;Skroblinukas;GENIUKŲ;9564385215;Taip;5;0;0;5
10923;Skroblinukas;GENIUKŲ;6129591146;Taip;0;3;0;3
10924;Skroblinukas;GENIUKŲ;3128337104;Taip;3;3;1;7
10925;Skroblinukas;GENIUKŲ;4272941994;Taip;12;1;3;16
10926;Skroblinukas;GENIUKŲ;3864043251;Taip;0;1;0;1
10927;Skroblinukas;GENIUKŲ;1064449916;Taip;0;7;3;10
10928;Skroblinukas;GENIUKŲ;2071447940;Taip;11;1;0;12
10929;Skroblinukas;BITUČIŲ;1255323441;Taip;0;2;1;3
10930;Skroblinukas;BITUČIŲ;1934804499;Taip;6;1;0;7
10931;Skroblinukas;BITUČIŲ;2134821488;Taip;6;1;0;7
10932;Skroblinukas;BITUČIŲ;6604496585;Taip;4;1;0;5
10933;Skroblinukas;BITUČIŲ;3736883850;Taip;6;3;1;10
10934;Skroblinukas;BITUČIŲ;7191689856;Taip;10;6;0;16
10935;Skroblinukas;BITUČIŲ;2032621707;Taip;0;2;10;12
10936;Skroblinukas;BITUČIŲ;8277152812;Taip;5;0;0;5
10937;Skroblinukas;BITUČIŲ;8374103872;Taip;0;1;0;1
10938;Skroblinukas;BITUČIŲ;8618587013;Taip;0;1;0;1
10939;Skroblinukas;BITUČIŲ;4945107862;Ne;0;0;1;1
10940;Skroblinukas;BITUČIŲ;9594078223;Taip;0;1;0;1
10941;Skroblinukas;BITUČIŲ;1688990637;Taip;10;0;0;10
10942;Skroblinukas;BITUČIŲ;1957488412;Taip;0;3;6;9
10943;Skroblinukas;BITUČIŲ;1000804920;Taip;0;1;0;1
10944;Skroblinukas;BITUČIŲ;1711568129;Ne;13;1;1;15
10945;Skroblinukas;BITUČIŲ;1293348150;Taip;1;1;0;2
10946;Skroblinukas;BITUČIŲ;9664357125;Taip;9;1;2;12
10947;Skroblinukas;BITUČIŲ;5001921323;Taip;0;1;0;1
10948;Skroblinukas;BITUČIŲ;6227583229;Taip;8;3;4;15
10949;Skroblinukas;BORUŽĖLIŲ;8715188878;Taip;8;14;2;24
10950;Skroblinukas;BORUŽĖLIŲ;7255510731;Taip;10;0;5;15
10951;Skroblinukas;BORUŽĖLIŲ;5841866621;Taip;6;0;1;7
10952;Skroblinukas;BORUŽĖLIŲ;9341501143;Taip;6;0;1;7
10953;Skroblinukas;BORUŽĖLIŲ;2523742608;Taip;3;0;0;3
10954;Skroblinukas;BORUŽĖLIŲ;2311459579;Taip;3;0;0;3
10955;Skroblinukas;BORUŽĖLIŲ;3490684777;Taip;8;0;1;9
10956;Skroblinukas;BORUŽĖLIŲ;2717586232;Taip;0;9;0;9
10957;Skroblinukas;BORUŽĖLIŲ;4840767748;Taip;7;3;0;10
10958;Skroblinukas;BORUŽĖLIŲ;5694105568;Taip;0;0;10;10
10959;Skroblinukas;BORUŽĖLIŲ;7771969055;Taip;0;0;7;7
10960;Skroblinukas;BORUŽĖLIŲ;4631657273;Taip;15;0;0;15
10961;Skroblinukas;BORUŽĖLIŲ;8711201474;Ne;0;0;6;6
10962;Skroblinukas;SKRUZDĖLIUKŲ;5688453546;Taip;0;4;1;5
10963;Skroblinukas;SKRUZDĖLIUKŲ;6890306112;Taip;0;23;0;23
10964;Skroblinukas;SKRUZDĖLIUKŲ;6445065388;Taip;0;11;0;11
10965;Skroblinukas;SKRUZDĖLIUKŲ;3006521657;Taip;0;1;0;1
10966;Skroblinukas;SKRUZDĖLIUKŲ;3771045336;Taip;0;2;0;2
10967;Skroblinukas;SKRUZDĖLIUKŲ;9353353289;Taip;0;5;1;6
10968;Skroblinukas;SKRUZDĖLIUKŲ;5252389111;Taip;0;1;0;1
10969;Skroblinukas;SKRUZDĖLIUKŲ;2883593274;Taip;1;2;0;3
10970;Skroblinukas;SKRUZDĖLIUKŲ;7493915017;Taip;0;0;2;2
10971;Skroblinukas;SKRUZDĖLIUKŲ;5157913924;Taip;5;8;0;13
10972;Skroblinukas;SKRUZDĖLIUKŲ;9368764758;Taip;0;5;2;7
10973;Skroblinukas;SKRUZDĖLIUKŲ;9958188318;Taip;0;9;0;9
10974;Skroblinukas;SKRUZDĖLIUKŲ;8576448571;Taip;6;11;0;17
10975;Skroblinukas;SKRUZDĖLIUKŲ;1002570367;Ne;0;3;2;5
10976;Skroblinukas;SKRUZDĖLIUKŲ;3290115134;Taip;0;1;4;5
10977;Skroblinukas;SKRUZDĖLIUKŲ;9813249677;Taip;0;8;0;8
10978;Skroblinukas;SKRUZDĖLIUKŲ;2101748012;Taip;0;1;1;2
10979;Skroblinukas;SKRUZDĖLIUKŲ;2706526326;Ne;0;1;0;1
10980;Skroblinukas;SKRUZDĖLIUKŲ;5915278745;Taip;0;1;0;1
10981;Skroblinukas;SKRUZDĖLIUKŲ;6640062847;Ne;4;3;1;8
10982;Skroblinukas;ŽVIRBLIUKŲ;9162582460;Taip;0;1;5;6
10983;Skroblinukas;ŽVIRBLIUKŲ;7955574061;Taip;2;2;0;4
10984;Skroblinukas;ŽVIRBLIUKŲ;7489143683;Ne;0;3;0;3
10985;Skroblinukas;ŽVIRBLIUKŲ;6717008836;Taip;0;0;7;7
10986;Skroblinukas;ŽVIRBLIUKŲ;1232121301;Ne;15;1;1;17
10987;Skroblinukas;ŽVIRBLIUKŲ;1014993354;Taip;10;3;0;13
10988;Skroblinukas;ŽVIRBLIUKŲ;7527177120;Taip;0;2;7;9
10989;Skroblinukas;ŽVIRBLIUKŲ;4002729040;Taip;5;0;1;6
10990;Skroblinukas;ŽVIRBLIUKŲ;4197050176;Taip;10;0;0;10
10991;Skroblinukas;ŽVIRBLIUKŲ;4390614970;Taip;1;0;5;6
10992;Skroblinukas;ŽVIRBLIUKŲ;6070633607;Taip;8;0;0;8
10993;Skroblinukas;ŽVIRBLIUKŲ;6135412007;Taip;20;0;3;23
10994;Skroblinukas;ŽVIRBLIUKŲ;2312400921;Taip;10;0;11;21
10995;Skroblinukas;ŽVIRBLIUKŲ;4491947846;Taip;0;12;2;14
10996;Skroblinukas;ŽIOGELIŲ;2885814517;Taip;0;10;0;10
10997;Skroblinukas;ŽIOGELIŲ;2363368201;Taip;0;0;2;2
10998;Skroblinukas;ŽIOGELIŲ;4639384934;Taip;7;0;3;10
10999;Skroblinukas;ŽIOGELIŲ;5206925237;Taip;19;0;5;24
11000;Skroblinukas;ŽIOGELIŲ;7581372511;Taip;5;0;7;12
11001;Skroblinukas;ŽIOGELIŲ;8998236911;Taip;0;4;0;4
11002;Skroblinukas;ŽIOGELIŲ;6791969485;Taip;0;6;7;13
11003;Skroblinukas;ŽIOGELIŲ;9737310101;Taip;0;0;4;4
11004;Skroblinukas;ŽIOGELIŲ;8680329175;Taip;0;1;4;5
11005;Skroblinukas;ŽIOGELIŲ;8118284793;Taip;6;0;1;7
11006;Skroblinukas;ŽIOGELIŲ;1844211217;Taip;9;0;1;10
11007;Skroblinukas;ŽIOGELIŲ;5354832150;Taip;1;5;0;6
11008;Skroblinukas;ŽIOGELIŲ;3689247672;Taip;0;0;5;5
11009;Skroblinukas;STRAZDELIŲ;1820748152;Taip;0;6;2;8
11010;Skroblinukas;STRAZDELIŲ;5946356374;Taip;8;0;1;9
11011;Skroblinukas;STRAZDELIŲ;5274898590;Taip;15;0;0;15
11012;Skroblinukas;STRAZDELIŲ;8629189405;Ne;11;0;3;14
11013;Skroblinukas;STRAZDELIŲ;4091852305;Taip;0;5;0;5
11014;Skroblinukas;STRAZDELIŲ;9809817630;Taip;21;0;0;21
11015;Skroblinukas;STRAZDELIŲ;6475609065;Taip;5;0;0;5
11016;Skroblinukas;STRAZDELIŲ;1762416639;Taip;3;1;0;4
11017;Skroblinukas;STRAZDELIŲ;3705638869;Taip;7;0;0;7
11018;Skroblinukas;STRAZDELIŲ;2511496284;Taip;15;0;2;17
11019;Skroblinukas;STRAZDELIŲ;7153774246;Ne;5;0;2;7
11020;Skroblinukas;STRAZDELIŲ;7045587415;Taip;0;0;7;7
11021;Skroblinukas;STRAZDELIŲ;8734405028;Taip;0;9;2;11
11022;Skroblinukas;STRAZDELIŲ;3885884265;Taip;0;0;9;9
11023;Skroblinukas;STRAZDELIŲ;8544069746;Taip;0;3;0;3
11024;Skroblinukas;STRAZDELIŲ;6011466024;Ne;0;0;2;2
11025;Skroblinukas;DRUGELIŲ;7400908711;Ne;7;7;1;15
11026;Skroblinukas;DRUGELIŲ;3889890374;Taip;0;2;0;2
11027;Skroblinukas;DRUGELIŲ;9481718833;Taip;12;0;0;12
11028;Skroblinukas;DRUGELIŲ;8864594520;Ne;4;1;3;8
11029;Skroblinukas;DRUGELIŲ;2772360168;Taip;0;4;0;4
11030;Skroblinukas;DRUGELIŲ;3624518310;Taip;2;1;0;3
11031;Skroblinukas;DRUGELIŲ;4831370981;Taip;0;9;0;9
11032;Skroblinukas;DRUGELIŲ;5957417413;Taip;5;6;2;13
11033;Skroblinukas;DRUGELIŲ;3226115050;Taip;6;0;0;6
11034;Skroblinukas;DRUGELIŲ;2887161771;Taip;8;2;1;11
11035;Skroblinukas;DRUGELIŲ;4737605061;Ne;0;18;5;23
11036;Skroblinukas;DRUGELIŲ;8390240445;Taip;0;0;1;1
11037;Skroblinukas;DRUGELIŲ;2948231687;Taip;7;0;2;9
11038;Skroblinukas;DRUGELIŲ;5912771080;Taip;11;2;4;17
11039;Skroblinukas;DRUGELIŲ;7528824951;Ne;6;0;2;8
11040;Skroblinukas;DRUGELIŲ;2987938909;Taip;10;6;4;20
11041;Skroblinukas;DRUGELIŲ;8064713969;Taip;7;0;0;7
11042;Skroblinukas;DRUGELIŲ;8286842648;Taip;12;0;1;13
11043;Skroblinukas;DRUGELIŲ;1453029732;Taip;0;5;0;5
11044;Skroblinukas;DRUGELIŲ;3312235148;Taip;10;0;0;10
11045;Skroblinukas;PELĖDŽIUKŲ;8953844650;Ne;0;1;0;1
11046;Skroblinukas;PELĖDŽIUKŲ;5813075721;Taip;0;0;3;3
11047;Skroblinukas;PELĖDŽIUKŲ;3646325903;Taip;0;5;0;5
11048;Skroblinukas;PELĖDŽIUKŲ;9292990596;Ne;0;0;7;7
11049;Skroblinukas;PELĖDŽIUKŲ;8202855376;Taip;0;1;1;2
11050;Skroblinukas;PELĖDŽIUKŲ;3658815079;Taip;0;1;5;6
11051;Skroblinukas;PELĖDŽIUKŲ;5418212729;Taip;0;1;0;1
11052;Skroblinukas;PELĖDŽIUKŲ;4168542339;Taip;0;0;1;1
11053;Skroblinukas;PELĖDŽIUKŲ;8958893525;Taip;0;6;0;6
11054;Skroblinukas;PELĖDŽIUKŲ;6675716937;Taip;0;0;1;1
11055;Skroblinukas;PELĖDŽIUKŲ;1009065470;Ne;1;0;4;5
11056;Skroblinukas;PELĖDŽIUKŲ;9699407871;Taip;0;0;1;1
11057;Skroblinukas;PELĖDŽIUKŲ;9553242594;Taip;0;17;0;17
11058;Skroblinukas;PELĖDŽIUKŲ;3532258904;Taip;5;1;0;6
11059;Skroblinukas;PELĖDŽIUKŲ;8465074037;Taip;0;0;4;4
11060;Skroblinukas;PELĖDŽIUKŲ;2071093890;Taip;0;1;0;1
11061;Skroblinukas;PELĖDŽIUKŲ;9523720873;Taip;20;0;1;21
11062;Skroblinukas;PELĖDŽIUKŲ;7920117036;Taip;9;1;0;10
11063;Skroblinukas;PELĖDŽIUKŲ;2215428081;Taip;0;7;0;7
11064;Smalsučiai;Žibuoklės;6535494814;Taip;4;0;1;5
11065;Smalsučiai;Žibuoklės;3309134310;Taip;5;2;0;7
11066;Smalsučiai;Žibuoklės;2326167599;Taip;0;1;2;3
11067;Smalsučiai;Žibuoklės;4094037708;Taip;0;0;1;1
11068;Smalsučiai;Žibuoklės;5893045664;Taip;6;3;1;10
11069;Smalsučiai;Žibuoklės;5482692473;Taip;5;1;0;6
11070;Smalsučiai;Žibuoklės;2742992400;Taip;5;0;1;6
11071;Smalsučiai;Žibuoklės;6299355505;Ne;0;2;0;2
11072;Smalsučiai;Žibuoklės;7070240693;Taip;0;2;0;2
11073;Smalsučiai;Žibuoklės;3877274360;Taip;0;2;0;2
11074;Smalsučiai;Žibuoklės;7726086066;Ne;0;1;0;1
11075;Smalsučiai;Žibuoklės;9988599126;Taip;0;0;5;5
11076;Smalsučiai;Žibuoklės;5489140006;Taip;0;0;3;3
11077;Smalsučiai;Žibuoklės;5900294530;Ne;0;11;0;11
11078;Smalsučiai;Žibuoklės;8644849194;Taip;2;2;1;5
11079;Smalsučiai;Žibuoklės;4506058735;Taip;12;1;1;14
11080;Smalsučiai;Žibuoklės;6931092874;Taip;5;0;0;5
11081;Smalsučiai;Žibuoklės;3071594259;Taip;0;1;0;1
11082;Smalsučiai;Žibuoklės;7107126092;Taip;0;1;0;1
11083;Smalsučiai;Aitvarų;3349726106;Taip;3;1;0;4
11084;Smalsučiai;Aitvarų;2219168902;Taip;1;0;0;1
11085;Smalsučiai;Aitvarų;9305837033;Taip;5;0;1;6
11086;Smalsučiai;Aitvarų;9305837033;Taip;5;0;1;6
11087;Smalsučiai;Aitvarų;9305837033;Taip;5;0;1;6
11088;Smalsučiai;Aitvarų;8877566394;Taip;5;0;2;7
11089;Smalsučiai;Aitvarų;3888093640;Taip;0;0;1;1
11090;Smalsučiai;Aitvarų;8284740122;Ne;12;0;4;16
11091;Smalsučiai;Aitvarų;1309254661;Taip;3;1;0;4
11092;Smalsučiai;Aitvarų;4154327720;Taip;1;0;1;2
11093;Smalsučiai;Aitvarų;8985656809;Taip;4;0;2;6
11094;Smalsučiai;Aitvarų;6032887449;Taip;7;1;0;8
11095;Smalsučiai;Aitvarų;9821259659;Taip;8;1;1;10
11096;Smalsučiai;Aitvarų;4054278651;Ne;6;0;1;7
11097;Smalsučiai;Aitvarų;6232068532;Taip;6;1;0;7
11098;Smalsučiai;Aitvarų;3157534923;Taip;0;0;1;1
11099;Smalsučiai;Aitvarų;6825499095;Taip;0;11;2;13
11100;Smalsučiai;Aitvarų;4832292565;Taip;9;0;2;11
11101;Smalsučiai;Aitvarų;2835117069;Taip;0;0;2;2
11102;Smalsučiai;Aitvarų;2610753472;Taip;4;0;0;4
11103;Smalsučiai;Aitvarų;6090244401;Taip;0;0;2;2
11104;Smalsučiai;Sraigiukų;7933302912;Taip;0;8;0;8
11105;Smalsučiai;Sraigiukų;1471941426;Taip;0;6;0;6
11106;Smalsučiai;Sraigiukų;1458544456;Ne;0;8;0;8
11107;Smalsučiai;Sraigiukų;5406430393;Taip;8;3;0;11
11108;Smalsučiai;Sraigiukų;9582225178;Taip;0;3;0;3
11109;Smalsučiai;Sraigiukų;9604182559;Ne;0;15;0;15
11110;Smalsučiai;Sraigiukų;6469604093;Taip;0;2;0;2
11111;Smalsučiai;Sraigiukų;4364810458;Taip;0;1;0;1
11112;Smalsučiai;Sraigiukų;4566816316;Taip;15;1;0;16
11113;Smalsučiai;Sraigiukų;5184903287;Taip;0;1;0;1
11114;Smalsučiai;Sraigiukų;4134975456;Taip;0;0;1;1
11115;Smalsučiai;Sraigiukų;6358800570;Taip;10;1;0;11
11116;Smalsučiai;Sraigiukų;2327930850;Taip;0;6;0;6
11117;Smalsučiai;Sraigiukų;3787937467;Taip;0;12;0;12
11118;Smalsučiai;Sraigiukų;4824786207;Taip;0;2;0;2
11119;Smalsučiai;Sraigiukų;3399798448;Taip;0;0;3;3
11120;Smalsučiai;Sraigiukų;1997966082;Taip;0;3;0;3
11121;Smalsučiai;Sraigiukų;4585930202;Taip;0;9;0;9
11122;Smalsučiai;Sraigiukų;8193410963;Taip;0;1;0;1
11123;Smalsučiai;Sraigiukų;9155011285;Taip;0;1;0;1
11124;Smalsučiai;Saulučių;1776385691;Taip;0;0;2;2
11125;Smalsučiai;Saulučių;2259361924;Taip;7;0;1;8
11126;Smalsučiai;Saulučių;1162964613;Ne;0;0;8;8
11127;Smalsučiai;Saulučių;9934952886;Taip;2;1;4;7
11128;Smalsučiai;Saulučių;9556433086;Taip;5;5;0;10
11129;Smalsučiai;Saulučių;1904973393;Taip;5;1;0;6
11130;Smalsučiai;Saulučių;3252901131;Taip;0;0;1;1
11131;Smalsučiai;Saulučių;9743116843;Taip;1;0;0;1
11132;Smalsučiai;Saulučių;2392217952;Taip;4;0;4;8
11133;Smalsučiai;Saulučių;1447512509;Taip;21;0;0;21
11134;Smalsučiai;Saulučių;2034284973;Taip;0;1;0;1
11135;Smalsučiai;Saulučių;7049101015;Taip;0;0;1;1
11136;Smalsučiai;Saulučių;9183519167;Taip;10;0;1;11
11137;Smalsučiai;Saulučių;5708986552;Taip;10;0;6;16
11138;Smalsučiai;Saulučių;4889923629;Taip;1;0;0;1
11139;Smalsučiai;Saulučių;8630411244;Taip;8;1;2;11
11140;Smalsučiai;Saulučių;5541908981;Taip;0;0;1;1
11141;Smalsučiai;Saulučių;1213476648;Taip;9;0;0;9
11142;Smalsučiai;Viščiukų;6006832443;Taip;0;1;0;1
11143;Smalsučiai;Viščiukų;9864518144;Taip;2;2;0;4
11144;Smalsučiai;Viščiukų;8128348060;Taip;8;0;4;12
11145;Smalsučiai;Viščiukų;4847584492;Taip;5;0;0;5
11146;Smalsučiai;Viščiukų;6415906523;Taip;0;1;0;1
11147;Smalsučiai;Viščiukų;4425714802;Taip;0;0;3;3
11148;Smalsučiai;Viščiukų;6090391818;Taip;5;1;0;6
11149;Smalsučiai;Viščiukų;7023531176;Taip;0;1;0;1
11150;Smalsučiai;Viščiukų;8259056296;Taip;0;0;3;3
11151;Smalsučiai;Viščiukų;9637877396;Taip;11;0;1;12
11152;Smalsučiai;Viščiukų;7137550663;Taip;0;1;0;1
11153;Smalsučiai;Viščiukų;2958335372;Taip;0;1;0;1
11154;Smalsučiai;Viščiukų;3757955200;Taip;3;2;1;6
11155;Smalsučiai;Viščiukų;4288788194;Taip;0;0;2;2
11156;Smalsučiai;Viščiukų;7874635165;Taip;0;1;2;3
11157;Smalsučiai;Viščiukų;5098291946;Ne;17;0;0;17
11158;Smalsučiai;Viščiukų;8578693978;Taip;0;8;0;8
11159;Smalsučiai;Viščiukų;4379645417;Taip;0;1;3;4
11160;Smalsučiai;Viščiukų;5536697307;Taip;7;0;3;10
11161;Smalsučiai;Boružėlių;9426629964;Ne;1;2;0;3
11162;Smalsučiai;Boružėlių;1703679877;Taip;0;0;1;1
11163;Smalsučiai;Boružėlių;2208462326;Taip;0;2;0;2
11164;Smalsučiai;Boružėlių;6643253926;Taip;0;4;0;4
11165;Smalsučiai;Boružėlių;1473016908;Taip;4;0;0;4
11166;Smalsučiai;Boružėlių;7226242747;Ne;0;2;0;2
11167;Smalsučiai;Boružėlių;6085020049;Taip;4;2;0;6
11168;Smalsučiai;Boružėlių;8340768848;Taip;7;1;0;8
11169;Smalsučiai;Boružėlių;69450514879;Taip;0;1;0;1
11170;Smalsučiai;Boružėlių;4740303929;Taip;0;4;0;4
11171;Smalsučiai;Boružėlių;4046718551;Taip;0;1;0;1
11172;Smalsučiai;Boružėlių;2694575252;Taip;2;1;0;3
11173;Smalsučiai;Boružėlių;3063127699;Taip;7;2;0;9
11174;Smalsučiai;Boružėlių;2737886714;Taip;0;3;0;3
11175;Smalsučiai;Boružėlių;8523742213;Ne;0;1;2;3
11176;Smalsučiai;Boružėlių;2034790691;Taip;11;0;0;11
11177;Smalsučiai;Boružėlių;5325706638;Taip;11;2;0;13
11178;Smalsučiai;Boružėlių;9314811354;Taip;0;3;0;3
11179;Smalsučiai;Boružėlių;9196634595;Taip;0;1;0;1
11180;Smalsučiai;Boružėlių;6899040199;Taip;4;3;0;7
11181;Smalsučiai;Zuikių;2802867649;Taip;0;2;0;2
11182;Smalsučiai;Zuikių;96002139110;Taip;0;3;0;3
11183;Smalsučiai;Zuikių;2953239027;Ne;0;2;0;2
11184;Smalsučiai;Zuikių;5441966713;Taip;0;1;0;1
11185;Smalsučiai;Zuikių;9632022271;Taip;0;1;0;1
11186;Smalsučiai;Zuikių;8306946163;Taip;0;8;0;8
11187;Smalsučiai;Zuikių;6469044880;Taip;0;4;0;4
11188;Smalsučiai;Zuikių;99467576480;Taip;5;1;0;6
11189;Smalsučiai;Zuikių;2136420967;Taip;11;0;0;11
11190;Smalsučiai;Zuikių;2059832436;Ne;0;3;0;3
11191;Smalsučiai;Zuikių;1316590100;Taip;0;1;0;1
11192;Smalsučiai;Zuikių;1372591510;Taip;0;3;0;3
11193;Smalsučiai;Zuikių;8810690546;Taip;0;3;0;3
11194;Smalsučiai;Zuikių;9703726869;Taip;0;4;0;4
11195;Smalsučiai;Zuikių;9481692900;Taip;7;3;0;10
11196;Smalsučiai;Zuikių;3644256220;Taip;0;2;0;2
11197;Smalsučiai;Nykštukų;9181601713;Ne;0;4;0;4
11198;Smalsučiai;Nykštukų;7637630200;Taip;0;0;1;1
11199;Smalsučiai;Nykštukų;1247774684;Taip;5;0;0;5
11200;Smalsučiai;Nykštukų;2375360937;Taip;7;0;0;7
11201;Smalsučiai;Nykštukų;8893480054;Taip;2;0;2;4
11202;Smalsučiai;Nykštukų;6996192450;Taip;0;1;1;2
11203;Smalsučiai;Nykštukų;9378696084;Taip;4;0;3;7
11204;Smalsučiai;Nykštukų;7267389695;Taip;7;0;0;7
11205;Smalsučiai;Nykštukų;4847212069;Taip;0;1;3;4
11206;Smalsučiai;Nykštukų;1224857159;Taip;3;2;0;5
11207;Smalsučiai;Nykštukų;8690626891;Taip;9;1;0;10
11208;Smalsučiai;Nykštukų;5719056997;Taip;3;2;0;5
11209;Smalsučiai;Nykštukų;6747286787;Taip;0;2;0;2
11210;Smalsučiai;Nykštukų;3646740184;Taip;5;0;2;7
11211;Smalsučiai;Nykštukų;6642882883;Taip;14;0;0;14
11212;Smalsučiai;Nykštukų;7143824796;Taip;1;0;0;1
11213;Smalsučiai;Katinėlių;4760366724;Taip;0;1;0;1
11214;Smalsučiai;Katinėlių;2045283348;Taip;8;1;0;9
11215;Smalsučiai;Katinėlių;4847029162;Taip;1;0;0;1
11216;Smalsučiai;Katinėlių;5213319192;Taip;3;0;0;3
11217;Smalsučiai;Katinėlių;3782502443;Ne;5;2;0;7
11218;Smalsučiai;Katinėlių;6358968221;Taip;0;1;0;1
11219;Smalsučiai;Katinėlių;9984878984;Taip;6;1;0;7
11220;Smalsučiai;Katinėlių;2369569130;Taip;0;1;0;1
11221;Smalsučiai;Katinėlių;5535858303;Taip;2;0;0;2
11222;Smalsučiai;Katinėlių;8724759192;Taip;0;2;0;2
11223;Smalsučiai;Katinėlių;2662588310;Ne;0;4;2;6
11224;Smalsučiai;Katinėlių;2668720481;Taip;0;8;0;8
11225;Smalsučiai;Katinėlių;4030955447;Ne;2;1;0;3
11226;Smalsučiai;Katinėlių;4075656060;Taip;0;2;0;2
11227;Smalsučiai;Katinėlių;8210141253;Taip;11;1;0;12
11228;Smalsučiai;Katinėlių;5828514911;Taip;1;0;0;1
11229;Smalsučiai;Katinėlių;7318218997;Taip;3;1;0;4
11230;Smalsučiai;PELĖDŽIUKAI;1668692281;Ne;0;1;0;1
11231;Smalsučiai;PELĖDŽIUKAI;7794541741;Taip;0;1;0;1
11232;Smalsučiai;PELĖDŽIUKAI;1181574676;Taip;0;2;0;2
11233;Smalsučiai;PELĖDŽIUKAI;1599488035;Taip;0;3;0;3
11234;Smalsučiai;PELĖDŽIUKAI;4727475042;Ne;0;0;1;1
11235;Smalsučiai;PELĖDŽIUKAI;8520753848;Taip;0;4;0;4
11236;Smalsučiai;PELĖDŽIUKAI;22791221635;Taip;0;1;0;1
11237;Smalsučiai;PELĖDŽIUKAI;3607226859;Taip;0;3;0;3
11238;Smalsučiai;PELĖDŽIUKAI;1467603676;Taip;0;1;0;1
11239;Smalsučiai;PELĖDŽIUKAI;5159799570;Taip;0;1;0;1
11240;Smalsučiai;PELĖDŽIUKAI;19592364606;Ne;0;15;0;15
11241;Smalsučiai;PELĖDŽIUKAI;1824321380;Taip;0;1;0;1
11242;Smalsučiai;PELĖDŽIUKAI;6207026048;Taip;0;1;0;1
11243;Smalsučiai;PELĖDŽIUKAI;4145769042;Taip;0;2;0;2
11244;Smalsučiai;PELĖDŽIUKAI;6529889121;Taip;4;2;0;6
11245;Smalsučiai;PELĖDŽIUKAI;1673246147;Taip;0;8;0;8
11246;Smalsučiai;PELĖDŽIUKAI;7713078413;Taip;0;1;0;1
11247;Smalsučiai;PELĖDŽIUKAI;3627324317;Taip;0;8;0;8
11248;Smalsučiai;PELĖDŽIUKAI;5730866119;Ne;0;1;0;1
11249;Smalsučiai;Pingvinukai;1305808180;Taip;1;1;1;3
11250;Smalsučiai;Pingvinukai;2305950301;Taip;0;0;2;2
11251;Smalsučiai;Pingvinukai;5109775795;Ne;17;1;0;18
11252;Smalsučiai;Pingvinukai;9222858199;Taip;4;0;3;7
11253;Smalsučiai;Pingvinukai;1909797307;Taip;8;0;6;14
11254;Smalsučiai;Pingvinukai;7400990599;Taip;14;0;2;16
11255;Smalsučiai;Pingvinukai;2673224420;Taip;4;0;1;5
11256;Smalsučiai;Pingvinukai;9771532192;Taip;13;6;0;19
11257;Smalsučiai;Pingvinukai;8402519872;Taip;0;1;0;1
11258;Smalsučiai;Pingvinukai;3746193901;Taip;14;1;0;15
11259;Smalsučiai;Pingvinukai;8499612926;Taip;5;0;1;6
11260;Smalsučiai;Pingvinukai;3625628040;Ne;11;0;1;12
11261;Smalsučiai;Pingvinukai;6128134712;Taip;0;0;1;1
11262;Smalsučiai;Pingvinukai;3045521655;Taip;7;0;1;8
11263;Smalsučiai;Pingvinukai;8615789381;Taip;9;0;1;10
11264;Smalsučiai;Voverikų;4811022648;Taip;5;1;0;6
11265;Smalsučiai;Voverikų;4973651632;Taip;0;0;5;5
11266;Smalsučiai;Voverikų;3509573985;Taip;15;0;0;15
11267;Smalsučiai;Voverikų;2878060759;Taip;7;1;0;8
11268;Smalsučiai;Voverikų;1485450504;Taip;7;0;0;7
11269;Smalsučiai;Voverikų;3042578767;Taip;0;2;0;2
11270;Smalsučiai;Voverikų;2070248478;Taip;7;0;0;7
11271;Smalsučiai;Voverikų;7205498813;Taip;6;1;5;12
11272;Smalsučiai;Voverikų;2612579099;Taip;21;0;0;21
11273;Smalsučiai;Voverikų;2885279828;Taip;5;0;0;5
11274;Smalsučiai;Voverikų;1162035522;Taip;9;0;4;13
11275;Smalsučiai;Voverikų;5964344820;Taip;11;0;0;11
11276;Smalsučiai;Voverikų;4105866680;Ne;0;8;0;8
11277;Spragtukas;NYKŠTUKAI;4527798635;Taip;8;1;0;9
11278;Spragtukas;NYKŠTUKAI;8551195766;Taip;14;0;0;14
11279;Spragtukas;NYKŠTUKAI;2943832694;Taip;3;0;4;7
11280;Spragtukas;NYKŠTUKAI;8297700739;Taip;0;1;0;1
11281;Spragtukas;NYKŠTUKAI;9595221494;Taip;6;0;2;8
11282;Spragtukas;NYKŠTUKAI;6185016824;Taip;1;4;0;5
11283;Spragtukas;NYKŠTUKAI;1710184531;Taip;6;10;0;16
11284;Spragtukas;NYKŠTUKAI;2076126173;Ne;0;5;0;5
11285;Spragtukas;NYKŠTUKAI;3012345413;Ne;3;1;0;4
11286;Spragtukas;NYKŠTUKAI;8698492694;Taip;4;1;15;20
11287;Spragtukas;NYKŠTUKAI;1150002524;Taip;0;3;0;3
11288;Spragtukas;NYKŠTUKAI;4493810276;Taip;5;0;0;5
11289;Spragtukas;NYKŠTUKAI;8288793522;Taip;13;2;0;15
11290;Spragtukas;NYKŠTUKAI;6986034864;Taip;0;1;0;1
11291;Spragtukas;NYKŠTUKAI;9665371858;Ne;0;3;0;3
11292;Spragtukas;SAULUTĖ;3337355440;Ne;0;1;0;1
11293;Spragtukas;SAULUTĖ;4669257062;Taip;5;1;0;6
11294;Spragtukas;SAULUTĖ;3692960591;Taip;5;1;0;6
11295;Spragtukas;SAULUTĖ;6192381779;Taip;2;0;0;2
11296;Spragtukas;SAULUTĖ;4586034709;Ne;5;0;2;7
11297;Spragtukas;SAULUTĖ;2305568596;Taip;0;1;0;1
11298;Spragtukas;SAULUTĖ;1150727381;Taip;0;12;0;12
11299;Spragtukas;SAULUTĖ;9191831532;Taip;0;1;0;1
11300;Spragtukas;SAULUTĖ;3948232692;Taip;7;2;1;10
11301;Spragtukas;SAULUTĖ;9149954373;Taip;0;10;0;10
11302;Spragtukas;SAULUTĖ;7511680722;Taip;0;2;0;2
11303;Spragtukas;SAULUTĖ;8235791891;Taip;7;1;0;8
11304;Spragtukas;SAULUTĖ;2987638580;Taip;0;3;4;7
11305;Spragtukas;SAULUTĖ;5687853390;Taip;0;1;0;1
11306;Spragtukas;SAULUTĖ;6679886985;Taip;3;0;1;4
11307;Spragtukas;SAULUTĖ;2879077913;Ne;4;2;0;6
11308;Spragtukas;SAULUTĖ;1998148708;Ne;2;1;1;4
11309;Spragtukas;SAULUTĖ;8227086854;Taip;0;7;0;7
11310;Spragtukas;SAULUTĖ;5697451914;Taip;3;8;0;11
11311;Spragtukas;SAULUTĖ;3086399458;Taip;0;0;3;3
11312;Spragtukas;SAULUTĖ;2879614195;Taip;0;11;0;11
11313;Spragtukas;SPINDULĖLIAI;4675031453;Taip;0;1;0;1
11314;Spragtukas;SPINDULĖLIAI;9781727236;Taip;0;1;1;2
11315;Spragtukas;SPINDULĖLIAI;1029392579;Taip;0;1;1;2
11316;Spragtukas;SPINDULĖLIAI;6417098461;Taip;0;8;0;8
11317;Spragtukas;SPINDULĖLIAI;4485715299;Taip;0;7;0;7
11318;Spragtukas;SPINDULĖLIAI;2493749424;Taip;5;1;3;9
11319;Spragtukas;SPINDULĖLIAI;3411349574;Taip;4;0;0;4
11320;Spragtukas;SPINDULĖLIAI;1323065222;Taip;0;1;3;4
11321;Spragtukas;SPINDULĖLIAI;1827458781;Taip;0;1;1;2
11322;Spragtukas;SPINDULĖLIAI;4764295850;Taip;10;1;0;11
11323;Spragtukas;SPINDULĖLIAI;6385589724;Taip;0;0;2;2
11324;Spragtukas;SPINDULĖLIAI;8912031554;Taip;0;0;4;4
11325;Spragtukas;SPINDULĖLIAI;3798118695;Taip;11;4;0;15
11326;Spragtukas;GINTARĖLIAI;8339926929;Taip;0;3;1;4
11327;Spragtukas;GINTARĖLIAI;5724874569;Taip;8;0;0;8
11328;Spragtukas;GINTARĖLIAI;1430632638;Taip;0;3;0;3
11329;Spragtukas;GINTARĖLIAI;8625143071;Taip;5;0;0;5
11330;Spragtukas;GINTARĖLIAI;2255007161;Taip;0;7;0;7
11331;Spragtukas;GINTARĖLIAI;6493380877;Taip;1;0;0;1
11332;Spragtukas;GINTARĖLIAI;9664130733;Taip;1;8;0;9
11333;Spragtukas;GINTARĖLIAI;8698469979;Taip;20;0;0;20
11334;Spragtukas;GINTARĖLIAI;1747417905;Taip;0;1;6;7
11335;Spragtukas;GINTARĖLIAI;6388163866;Taip;12;1;0;13
11336;Spragtukas;GINTARĖLIAI;8191270443;Ne;1;0;1;2
11337;Spragtukas;GINTARĖLIAI;3684183344;Taip;1;2;0;3
11338;Spragtukas;GINTARĖLIAI;7806145224;Ne;0;2;1;3
11339;Spragtukas;GINTARĖLIAI;3170388518;Taip;0;1;20;21
11340;Spragtukas;GINTARĖLIAI;2992201984;Taip;9;4;0;13
11341;Spragtukas;GINTARĖLIAI;2217627240;Taip;10;1;1;12
11342;Spragtukas;ČIPOLINO;2371848091;Taip;0;4;0;4
11343;Spragtukas;ČIPOLINO;6582680700;Taip;4;1;1;6
11344;Spragtukas;ČIPOLINO;1599958343;Taip;0;1;0;1
11345;Spragtukas;ČIPOLINO;1547670082;Ne;0;5;0;5
11346;Spragtukas;ČIPOLINO;7504632314;Taip;10;1;0;11
11347;Spragtukas;ČIPOLINO;1597988501;Taip;0;1;0;1
11348;Spragtukas;ČIPOLINO;6526633051;Taip;0;1;0;1
11349;Spragtukas;ČIPOLINO;1058970799;Taip;1;0;2;3
11350;Spragtukas;ČIPOLINO;45661532130;Taip;0;3;0;3
11351;Spragtukas;ČIPOLINO;3045382299;Taip;0;1;1;2
11352;Spragtukas;ČIPOLINO;7640805299;Taip;0;4;0;4
11353;Spragtukas;ČIPOLINO;1365907314;Taip;1;1;2;4
11354;Spragtukas;ČIPOLINO;4941531443;Taip;1;1;2;4
11355;Spragtukas;ČIPOLINO;3566797064;Taip;2;0;0;2
11356;Spragtukas;ČIPOLINO;2902550587;Taip;5;0;0;5
11357;Spragtukas;ČIPOLINO;69114720307;Ne;0;1;3;4
11358;Spragtukas;ČIPOLINO;1044112039;Taip;6;5;0;11
11359;Spragtukas;ČIPOLINO;5707084920;Taip;7;5;0;12
11360;Spragtukas;ČIPOLINO;1482803930;Taip;10;3;0;13
11361;Spragtukas;ČIPOLINO;3356307067;Taip;10;5;0;15
11362;Spragtukas;ČIPOLINO;2691004546;Taip;6;15;0;21
11363;Spragtukas;BORUŽĖLĖS;8614890958;Taip;5;7;0;12
11364;Spragtukas;BORUŽĖLĖS;6548270099;Taip;9;0;0;9
11365;Spragtukas;BORUŽĖLĖS;2356476212;Taip;6;0;3;9
11366;Spragtukas;BORUŽĖLĖS;8287102733;Taip;20;1;0;21
11367;Spragtukas;BORUŽĖLĖS;6584145176;Taip;0;1;0;1
11368;Spragtukas;BORUŽĖLĖS;9965087132;Taip;1;2;0;3
11369;Spragtukas;BORUŽĖLĖS;5150028968;Taip;0;1;0;1
11370;Spragtukas;BORUŽĖLĖS;9754594384;Taip;15;3;0;18
11371;Spragtukas;BORUŽĖLĖS;6824861247;Taip;0;1;0;1
11372;Spragtukas;BORUŽĖLĖS;7264683147;Taip;6;0;1;7
11373;Spragtukas;BORUŽĖLĖS;5556920140;Taip;7;1;0;8
11374;Spragtukas;BORUŽĖLĖS;6547167325;Taip;7;0;0;7
11375;Spragtukas;BORUŽĖLĖS;4347275614;Taip;0;0;8;8
11376;Spragtukas;BORUŽĖLĖS;7073092344;Taip;11;0;6;17
11377;Spragtukas;BORUŽĖLĖS;1046613540;Taip;2;4;0;6
11378;Spragtukas;DRUGELIAI;1336973131;Taip;0;1;0;1
11379;Spragtukas;DRUGELIAI;1514277186;Taip;4;1;0;5
11380;Spragtukas;DRUGELIAI;1326603216;Taip;14;1;0;15
11381;Spragtukas;DRUGELIAI;5306883933;Taip;0;1;0;1
11382;Spragtukas;DRUGELIAI;6322121173;Taip;0;1;0;1
11383;Spragtukas;DRUGELIAI;6573750143;Taip;0;3;0;3
11384;Spragtukas;DRUGELIAI;6800727630;Taip;0;1;0;1
11385;Spragtukas;DRUGELIAI;72636559695;Ne;0;1;3;4
11386;Spragtukas;DRUGELIAI;1384812263;Taip;0;1;0;1
11387;Spragtukas;DRUGELIAI;1849644444;Taip;3;1;1;5
11388;Spragtukas;DRUGELIAI;3654640843;Taip;0;1;0;1
11389;Spragtukas;DRUGELIAI;4929866385;Taip;0;1;0;1
11390;Spragtukas;DRUGELIAI;8246512283;Taip;0;1;0;1
11391;Spragtukas;DRUGELIAI;9045185920;Taip;0;1;1;2
11392;Spragtukas;DRUGELIAI;1627243902;Taip;7;2;0;9
11393;Spragtukas;DRUGELIAI;4131998934;Taip;0;1;0;1
11394;Spragtukas;DRUGELIAI;8463747761;Taip;0;1;0;1
11395;Spragtukas;DRUGELIAI;5477997543;Taip;0;1;0;1
11396;Spragtukas;GAIDELIAI;2541126095;Taip;6;0;3;9
11397;Spragtukas;GAIDELIAI;4097458544;Taip;5;1;2;8
11398;Spragtukas;GAIDELIAI;8957903306;Taip;0;1;4;5
11399;Spragtukas;GAIDELIAI;1326714513;Ne;0;1;6;7
11400;Spragtukas;GAIDELIAI;4676052255;Ne;0;16;0;16
11401;Spragtukas;GAIDELIAI;7911124524;Taip;0;1;7;8
11402;Spragtukas;GAIDELIAI;9509296936;Taip;8;1;0;9
11403;Spragtukas;GAIDELIAI;3216796441;Taip;11;1;0;12
11404;Spragtukas;GAIDELIAI;8440836721;Taip;3;5;0;8
11405;Spragtukas;GAIDELIAI;4535021524;Taip;0;1;1;2
11406;Spragtukas;GAIDELIAI;2679834328;Taip;5;1;0;6
11407;Spragtukas;GAIDELIAI;4088247584;Ne;18;0;0;18
11408;Spragtukas;ŽUVELĖS;8762832644;Taip;5;1;0;6
11409;Spragtukas;ŽUVELĖS;8652973900;Taip;1;0;0;1
11410;Spragtukas;ŽUVELĖS;3261213140;Taip;0;2;0;2
11411;Spragtukas;ŽUVELĖS;5689392663;Taip;5;1;0;6
11412;Spragtukas;ŽUVELĖS;9592271053;Ne;0;1;0;1
11413;Spragtukas;ŽUVELĖS;1272075883;Taip;5;1;0;6
11414;Spragtukas;ŽUVELĖS;6465991136;Taip;0;3;0;3
11415;Spragtukas;ŽUVELĖS;9282940430;Taip;0;2;0;2
11416;Spragtukas;ŽUVELĖS;6503842956;Taip;3;2;0;5
11417;Spragtukas;ŽUVELĖS;2578400770;Taip;0;12;0;12
11418;Spragtukas;ŽUVELĖS;3139748724;Taip;6;0;5;11
11419;Spragtukas;ŽUVELĖS;8640877497;Taip;0;1;0;1
11420;Spragtukas;ŽUVELĖS;2025314314;Taip;0;0;3;3
11421;Spragtukas;ŽUVELĖS;4848647219;Taip;1;1;0;2
11422;Spragtukas;ŽUVELĖS;3491418162;Taip;0;9;1;10
11423;Spragtukas;ŽUVELĖS;5836788916;Taip;0;2;0;2
11424;Spragtukas;ŽUVELĖS;5704941595;Taip;5;11;0;16
11425;Spragtukas;ŽUVELĖS;3286456855;Taip;0;2;1;3
11426;Spragtukas;ŽUVELĖS;9662188102;Taip;6;2;5;13
11427;Spragtukas;ŽUVELĖS;2539660577;Taip;1;0;3;4
11428;Spragtukas;ŽUVELĖS;6757604305;Taip;7;0;0;7
11429;Spragtukas;RIEŠUTĖLIAI;3187815703;Taip;10;3;0;13
11430;Spragtukas;RIEŠUTĖLIAI;8684246143;Taip;10;0;0;10
11431;Spragtukas;RIEŠUTĖLIAI;1407611561;Taip;13;0;0;13
11432;Spragtukas;RIEŠUTĖLIAI;8773952377;Ne;0;3;0;3
11433;Spragtukas;RIEŠUTĖLIAI;1977526177;Taip;5;0;0;5
11434;Spragtukas;RIEŠUTĖLIAI;7615522850;Ne;3;1;0;4
11435;Spragtukas;RIEŠUTĖLIAI;6797841737;Ne;0;1;0;1
11436;Spragtukas;RIEŠUTĖLIAI;9204569123;Taip;0;1;0;1
11437;Spragtukas;RIEŠUTĖLIAI;8342098575;Taip;4;0;0;4
11438;Spragtukas;RIEŠUTĖLIAI;1992850470;Taip;3;1;0;4
11439;Spragtukas;RIEŠUTĖLIAI;6158327941;Taip;8;1;0;9
11440;Spragtukas;RIEŠUTĖLIAI;4134127256;Taip;6;0;1;7
11441;Spragtukas;RIEŠUTĖLIAI;3009567338;Taip;0;1;0;1
11442;Spragtukas;RIEŠUTĖLIAI;2648358901;Ne;6;1;0;7
11443;Spragtukas;RIEŠUTĖLIAI;3822599790;Taip;0;11;0;11
11444;Spragtukas;RIEŠUTĖLIAI;7767940027;Taip;0;2;2;4
11445;Spragtukas;RIEŠUTĖLIAI;4625065223;Taip;3;0;0;3
11446;Spragtukas;RIEŠUTĖLIAI;6963190259;Taip;11;0;0;11
11447;Spragtukas;RIEŠUTĖLIAI;8732886749;Taip;10;1;0;11
11448;Spragtukas;RIEŠUTĖLIAI;1946493379;Taip;19;0;0;19
11449;Spragtukas;VIŠČIUKAI;8473814776;Taip;0;1;0;1
11450;Spragtukas;VIŠČIUKAI;9294770557;Taip;8;0;0;8
11451;Spragtukas;VIŠČIUKAI;9443091032;Taip;6;1;2;9
11452;Spragtukas;VIŠČIUKAI;4461217748;Ne;0;1;0;1
11453;Spragtukas;VIŠČIUKAI;7412489884;Taip;21;0;0;21
11454;Spragtukas;VIŠČIUKAI;2087416420;Taip;0;2;0;2
11455;Spragtukas;VIŠČIUKAI;7933945356;Taip;0;5;0;5
11456;Spragtukas;VIŠČIUKAI;5948139350;Taip;0;0;1;1
11457;Spragtukas;VIŠČIUKAI;8110631015;Taip;0;1;1;2
11458;Spragtukas;VIŠČIUKAI;4089551688;Ne;4;0;0;4
11459;Spragtukas;VIŠČIUKAI;7522592685;Taip;7;0;1;8
11460;Spragtukas;MEŠKIUKAI;5440632023;Taip;6;1;0;7
11461;Spragtukas;MEŠKIUKAI;7271482702;Taip;17;2;0;19
11462;Spragtukas;MEŠKIUKAI;9099921999;Taip;6;0;0;6
11463;Spragtukas;MEŠKIUKAI;8307801987;Ne;0;1;0;1
11464;Spragtukas;MEŠKIUKAI;9975308171;Taip;7;0;4;11
11465;Spragtukas;MEŠKIUKAI;1493711333;Ne;0;9;1;10
11466;Spragtukas;MEŠKIUKAI;4742132709;Ne;7;7;0;14
11467;Spragtukas;MEŠKIUKAI;5225669850;Taip;6;0;0;6
11468;Spragtukas;MEŠKIUKAI;8109894184;Taip;7;1;1;9
11469;Spragtukas;MEŠKIUKAI;8396134652;Taip;18;0;1;19
11470;Spragtukas;MEŠKIUKAI;1784758799;Taip;0;5;2;7
11471;Spragtukas;MEŠKIUKAI;4441290823;Taip;3;0;0;3
11472;Spragtukas;MEŠKIUKAI;9310818975;Taip;1;1;13;15
11473;Spragtukas;MEŠKIUKAI;8486415968;Taip;4;0;0;4
11474;Spragtukas;MEŠKIUKAI;1083785206;Ne;0;1;0;1
11475;Spragtukas;MEŠKIUKAI;2026249018;Ne;0;1;0;1
11476;Spragtukas;MEŠKIUKAI;3423699840;Taip;9;0;2;11
11477;Strazdelis;Žiogelių;5346485534;Taip;0;3;0;3
11478;Strazdelis;Žiogelių;9933042249;Taip;0;7;0;7
11479;Strazdelis;Žiogelių;8581533423;Taip;16;0;0;16
11480;Strazdelis;Žiogelių;8209625399;Taip;7;2;3;12
11481;Strazdelis;Žiogelių;1141752802;Taip;5;0;2;7
11482;Strazdelis;Žiogelių;1228651165;Taip;10;2;0;12
11483;Strazdelis;Žiogelių;3596394112;Taip;10;1;1;12
11484;Strazdelis;Žiogelių;8493572399;Taip;0;0;7;7
11485;Strazdelis;Žiogelių;4563247013;Taip;14;0;0;14
11486;Strazdelis;Žiogelių;6437928004;Taip;12;0;1;13
11487;Strazdelis;Žiogelių;5600979545;Taip;0;8;0;8
11488;Strazdelis;Žiogelių;8971395173;Taip;0;1;1;2
11489;Strazdelis;Žiogelių;4955907851;Taip;7;0;2;9
11490;Strazdelis;Žiogelių;7425818775;Ne;0;1;3;4
11491;Strazdelis;Žiogelių;9567476872;Taip;5;0;1;6
11492;Strazdelis;Žiogelių;4516288199;Taip;16;0;0;16
11493;Strazdelis;Žiogelių;3028208428;Taip;4;0;1;5
11494;Strazdelis;Žiogelių;2753635198;Taip;0;2;2;4
11495;Strazdelis;Žiogelių;1194918926;Taip;0;0;10;10
11496;Strazdelis;Žiogelių;6651360492;Taip;6;6;0;12
11497;Strazdelis;Žiogelių;8686828982;Ne;11;4;1;16
11498;Strazdelis;Žiogelių;7913526787;Taip;4;0;1;5
11499;Strazdelis;Šeimynėlės;6570504154;Taip;5;2;0;7
11500;Strazdelis;Šeimynėlės;3848288765;Taip;9;1;0;10
11501;Strazdelis;Šeimynėlės;5033799225;Taip;0;2;0;2
11502;Strazdelis;Šeimynėlės;1683900907;Taip;7;0;0;7
11503;Strazdelis;Šeimynėlės;3897248010;Taip;2;1;0;3
11504;Strazdelis;Šeimynėlės;2990771887;Taip;0;11;0;11
11505;Strazdelis;Šeimynėlės;7905687363;Taip;8;2;0;10
11506;Strazdelis;Šeimynėlės;4501391298;Taip;4;4;0;8
11507;Strazdelis;Šeimynėlės;9057914477;Taip;14;0;1;15
11508;Strazdelis;Šeimynėlės;1012692326;Taip;16;1;0;17
11509;Strazdelis;Šeimynėlės;8899530711;Taip;21;0;0;21
11510;Strazdelis;Šeimynėlės;8336759173;Taip;13;0;0;13
11511;Strazdelis;Šeimynėlės;5784406335;Taip;0;4;0;4
11512;Strazdelis;Šeimynėlės;2068793184;Taip;6;3;0;9
11513;Strazdelis;Šeimynėlės;5296218650;Taip;9;0;0;9
11514;Strazdelis;Šeimynėlės;1754106518;Taip;0;1;0;1
11515;Strazdelis;Šeimynėlės;9806107189;Taip;0;7;0;7
11516;Strazdelis;Šeimynėlės;5924324241;Taip;13;0;0;13
11517;Strazdelis;Šeimynėlės;8295035233;Taip;0;1;0;1
11518;Strazdelis;Šeimynėlės;1553329770;Taip;0;1;0;1
11519;Strazdelis;Genelio;8277333786;Taip;0;0;1;1
11520;Strazdelis;Genelio;9586256979;Taip;3;1;0;4
11521;Strazdelis;Genelio;3084249678;Ne;0;11;0;11
11522;Strazdelis;Genelio;5499310072;Taip;5;2;0;7
11523;Strazdelis;Genelio;8333151969;Taip;0;2;1;3
11524;Strazdelis;Genelio;7083940713;Taip;4;1;0;5
11525;Strazdelis;Genelio;6271193831;Taip;8;2;0;10
11526;Strazdelis;Genelio;6480803618;Taip;5;4;3;12
11527;Strazdelis;Genelio;9490861272;Taip;5;6;0;11
11528;Strazdelis;Genelio;6071502600;Taip;8;1;0;9
11529;Strazdelis;Genelio;3713797440;Taip;8;1;0;9
11530;Strazdelis;Genelio;3456287323;Taip;19;2;0;21
11531;Strazdelis;Genelio;1034497200;Taip;6;0;0;6
11532;Strazdelis;Genelio;2459718449;Taip;7;3;0;10
11533;Strazdelis;Genelio;2483283363;Taip;5;0;0;5
11534;Strazdelis;Genelio;5714581201;Taip;0;2;1;3
11535;Strazdelis;Genelio;8956634754;Taip;0;4;0;4
11536;Strazdelis;Genelio;8762859576;Taip;8;1;0;9
11537;Strazdelis;Genelio;2306665561;Taip;0;2;0;2
11538;Strazdelis;Genelio;7680242840;Taip;15;3;0;18
11539;Strazdelis;Genelio;4545538133;Taip;5;3;0;8
11540;Strazdelis;Genelio;5742215922;Ne;7;3;0;10
11541;Strazdelis;Vikruolių;2078150337;Taip;10;1;0;11
11542;Strazdelis;Vikruolių;8182994112;Taip;7;0;0;7
11543;Strazdelis;Vikruolių;1362428967;Taip;0;2;0;2
11544;Strazdelis;Vikruolių;2871673641;Taip;0;3;0;3
11545;Strazdelis;Vikruolių;9198429790;Taip;0;1;0;1
11546;Strazdelis;Vikruolių;4655931716;Taip;0;3;4;7
11547;Strazdelis;Vikruolių;8754275576;Taip;5;0;0;5
11548;Strazdelis;Vikruolių;8634815556;Taip;0;1;0;1
11549;Strazdelis;Vikruolių;6147183190;Taip;10;1;0;11
11550;Strazdelis;Vikruolių;7216768880;Taip;0;2;0;2
11551;Strazdelis;Vikruolių;7823110477;Ne;1;8;0;9
11552;Strazdelis;Vikruolių;1187534672;Taip;0;1;0;1
11553;Strazdelis;Vikruolių;9904719582;Taip;3;4;0;7
11554;Strazdelis;Vikruolių;7308925265;Taip;0;7;0;7
11555;Strazdelis;Vikruolių;50350281905;Taip;0;1;0;1
11556;Strazdelis;Vikruolių;8038163444;Taip;0;1;0;1
11557;Strazdelis;Vikruolių;1540973269;Taip;0;2;0;2
11558;Strazdelis;Vikruolių;8801420992;Taip;2;1;0;3
11559;Strazdelis;Vikruolių;5580738386;Taip;0;1;0;1
11560;Strazdelis;Vikruolių;3955783379;Taip;8;0;0;8
11561;Strazdelis;Vikruolių;4430183106;Ne;0;1;7;8
11562;Strazdelis;Vikruolių;4076266466;Taip;15;1;0;16
11563;Strazdelis;Vyturėlių;4929828091;Taip;0;3;0;3
11564;Strazdelis;Vyturėlių;4454199703;Ne;12;1;0;13
11565;Strazdelis;Vyturėlių;3662217925;Ne;0;4;0;4
11566;Strazdelis;Vyturėlių;4698566091;Taip;0;1;0;1
11567;Strazdelis;Vyturėlių;8274897977;Taip;0;3;1;4
11568;Strazdelis;Vyturėlių;1665134387;Taip;7;1;0;8
11569;Strazdelis;Vyturėlių;45083023033;Taip;6;0;0;6
11570;Strazdelis;Vyturėlių;43314069648;Ne;0;1;0;1
11571;Strazdelis;Vyturėlių;1481671624;Taip;4;1;0;5
11572;Strazdelis;Vyturėlių;4697537943;Ne;0;7;0;7
11573;Strazdelis;Vyturėlių;6014213362;Taip;0;1;1;2
11574;Strazdelis;Vyturėlių;7900362267;Taip;0;1;0;1
11575;Strazdelis;Vyturėlių;9835716116;Taip;12;1;0;13
11576;Strazdelis;Vyturėlių;3943578036;Taip;6;1;0;7
11577;Strazdelis;Vyturėlių;2802486859;Taip;0;3;0;3
11578;Strazdelis;Vyturėlių;5749300013;Taip;0;6;0;6
11579;Strazdelis;Vyturėlių;7215063033;Taip;0;1;0;1
11580;Strazdelis;Vyturėlių;7149827850;Taip;3;3;0;6
11581;Strazdelis;Vyturėlių;5834348507;Taip;5;0;0;5
11582;Strazdelis;Vyturėlių;2238875354;Taip;0;1;0;1
11583;Strazdelis;Varpelio;4159072583;Taip;6;5;0;11
11584;Strazdelis;Varpelio;2662549392;Taip;0;2;0;2
11585;Strazdelis;Varpelio;9502341478;Taip;0;9;0;9
11586;Strazdelis;Varpelio;6311710825;Taip;0;2;0;2
11587;Strazdelis;Varpelio;1955166372;Taip;0;2;0;2
11588;Strazdelis;Varpelio;4873707286;Taip;1;3;0;4
11589;Strazdelis;Varpelio;6527855940;Ne;4;3;0;7
11590;Strazdelis;Varpelio;2824416350;Taip;0;6;0;6
11591;Strazdelis;Varpelio;3610250359;Taip;4;3;0;7
11592;Strazdelis;Varpelio;2766970956;Ne;0;8;0;8
11593;Strazdelis;Varpelio;1173067724;Taip;5;2;0;7
11594;Strazdelis;Varpelio;1021364759;Taip;0;3;0;3
11595;Strazdelis;Varpelio;7469848482;Taip;3;3;0;6
11596;Strazdelis;Varpelio;1841285441;Ne;0;1;0;1
11597;Strazdelis;Varpelio;7393083827;Taip;0;6;0;6
11598;Strazdelis;Varpelio;6555803164;Taip;0;5;0;5
11599;Strazdelis;Varpelio;1706026100;Taip;0;3;0;3
11600;Strazdelis;Varpelio;8035603341;Taip;0;3;0;3
11601;Strazdelis;Varpelio;2789987994;Taip;0;1;0;1
11602;Strazdelis;Varpelio;2251157025;Taip;5;0;0;5
11603;Strazdelis;Varpelio;5904388732;Taip;6;5;0;11
11604;Strazdelis;Varpelio;3460993302;Taip;5;7;0;12
11605;Strazdelis;Varpelio;9776075027;Taip;14;0;0;14
11606;Strazdelis;Pelėdžiukų;5892430004;Ne;12;2;0;14
11607;Strazdelis;Pelėdžiukų;8637386316;Taip;1;1;0;2
11608;Strazdelis;Pelėdžiukų;1704292727;Taip;0;1;0;1
11609;Strazdelis;Pelėdžiukų;8371999002;Taip;0;3;0;3
11610;Strazdelis;Pelėdžiukų;6046139859;Taip;4;2;1;7
11611;Strazdelis;Pelėdžiukų;8287554571;Taip;3;1;0;4
11612;Strazdelis;Pelėdžiukų;4448556404;Taip;4;3;0;7
11613;Strazdelis;Pelėdžiukų;8854150040;Taip;0;1;0;1
11614;Strazdelis;Pelėdžiukų;4004930488;Taip;0;11;0;11
11615;Strazdelis;Pelėdžiukų;5768674837;Taip;11;1;0;12
11616;Strazdelis;Pelėdžiukų;9761595867;Taip;6;1;0;7
11617;Strazdelis;Pelėdžiukų;7876385010;Taip;0;0;2;2
11618;Strazdelis;Pelėdžiukų;2848984531;Taip;10;1;0;11
11619;Strazdelis;Pelėdžiukų;1420438624;Ne;0;1;0;1
11620;Strazdelis;Pelėdžiukų;1901641517;Taip;10;1;0;11
11621;Strazdelis;Pelėdžiukų;4617237063;Taip;0;3;1;4
11622;Strazdelis;Pelėdžiukų;3036380561;Taip;0;3;1;4
11623;Strazdelis;Pelėdžiukų;7471890377;Taip;0;6;0;6
11624;Strazdelis;Pelėdžiukų;7349106795;Taip;0;3;0;3
11625;Strazdelis;Pelėdžiukų;2852253325;Ne;0;1;0;1
11626;Strazdelis;Pelėdžiukų;8938997208;Ne;0;3;0;3
11627;Strazdelis;Pelėdžiukų;4562530311;Taip;0;5;0;5
11628;Strazdelis;Saulutės;27177757900;Taip;12;2;0;14
11629;Strazdelis;Saulutės;40932140069;Taip;5;2;0;7
11630;Strazdelis;Saulutės;1523471662;Taip;5;5;0;10
11631;Strazdelis;Saulutės;2854642875;Taip;5;1;0;6
11632;Strazdelis;Saulutės;7578229276;Taip;0;1;0;1
11633;Strazdelis;Saulutės;8710848483;Taip;0;2;0;2
11634;Strazdelis;Saulutės;6614184499;Taip;5;2;0;7
11635;Strazdelis;Saulutės;4129957131;Taip;0;1;0;1
11636;Strazdelis;Saulutės;3425430317;Taip;0;1;0;1
11637;Strazdelis;Saulutės;7081517417;Taip;0;2;0;2
11638;Strazdelis;Saulutės;67641340859;Taip;0;3;0;3
11639;Strazdelis;Saulutės;15298412755;Taip;0;2;0;2
11640;Strazdelis;Saulutės;1802092125;Taip;4;1;0;5
11641;Strazdelis;Saulutės;1391009140;Taip;10;3;0;13
11642;Strazdelis;Saulutės;8808299050;Taip;0;2;0;2
11643;Strazdelis;Saulutės;3270413614;Taip;5;5;0;10
11644;Strazdelis;Saulutės;3316451889;Taip;0;1;0;1
11645;Strazdelis;Saulutės;12713270671;Taip;0;2;0;2
11646;Strazdelis;Saulutės;6113491562;Taip;0;1;0;1
11647;Strazdelis;Saulutės;1474503932;Taip;0;2;1;3
11648;Strazdelis;Saulutės;6779352728;Taip;2;0;0;2
11649;Strazdelis;Saulutės;9662566992;Ne;9;2;0;11
11650;Strazdelis;Bitutės;8485509145;Taip;0;2;0;2
11651;Strazdelis;Bitutės;6508933324;Taip;5;2;0;7
11652;Strazdelis;Bitutės;4020547762;Taip;0;2;0;2
11653;Strazdelis;Bitutės;8753316532;Ne;4;3;0;7
11654;Strazdelis;Bitutės;5232064496;Taip;7;2;0;9
11655;Strazdelis;Bitutės;9555240419;Taip;6;4;0;10
11656;Strazdelis;Bitutės;3043580835;Taip;0;3;0;3
11657;Strazdelis;Bitutės;1539984888;Taip;0;2;0;2
11658;Strazdelis;Bitutės;4400849922;Taip;0;3;0;3
11659;Strazdelis;Bitutės;7890064837;Taip;6;11;0;17
11660;Strazdelis;Bitutės;1881071425;Taip;0;2;0;2
11661;Strazdelis;Bitutės;2908567982;Taip;6;5;0;11
11662;Strazdelis;Bitutės;9548465554;Taip;0;5;0;5
11663;Strazdelis;Bitutės;7466648222;Ne;3;3;0;6
11664;Strazdelis;Bitutės;4463378251;Taip;0;2;0;2
11665;Strazdelis;Bitutės;8443837176;Taip;9;0;0;9
11666;Strazdelis;Bitutės;2963535523;Taip;0;1;0;1
11667;Strazdelis;Bitutės;4369569609;Taip;0;4;0;4
11668;Strazdelis;Bitutės;1005082012;Taip;7;1;0;8
11669;Strazdelis;Bitutės;2589303722;Taip;0;1;0;1
11670;Strazdelis;Bitutės;3149930355;Taip;0;1;0;1
11671;Strazdelis;Bitutės;2081538505;Taip;0;6;0;6
11672;Strazdelis;Bitutės;4784401449;Taip;2;1;0;3
11673;Strazdelis;Mažylių;9357195019;Taip;5;0;1;6
11674;Strazdelis;Mažylių;5256750516;Taip;0;5;0;5
11675;Strazdelis;Mažylių;4965049621;Taip;2;2;1;5
11676;Strazdelis;Mažylių;9383398775;Taip;10;0;0;10
11677;Strazdelis;Mažylių;2378910473;Taip;10;5;0;15
11678;Strazdelis;Mažylių;4699373769;Taip;5;1;0;6
11679;Strazdelis;Mažylių;3648883435;Taip;21;0;0;21
11680;Strazdelis;Mažylių;6788732053;Taip;16;0;0;16
11681;Strazdelis;Mažylių;2764495554;Taip;16;0;0;16
11682;Strazdelis;Mažylių;7039347901;Taip;0;0;1;1
11683;Strazdelis;Mažylių;4904388387;Ne;13;0;0;13
11684;Strazdelis;Mažylių;1265557971;Taip;0;2;0;2
11685;Strazdelis;Mažylių;3900225484;Taip;3;3;0;6
11686;Strazdelis;Mažylių;8734458997;Taip;11;1;0;12
11687;Strazdelis;Mažylių;3561551193;Taip;11;1;0;12
11688;Strazdelis;Mažylių;1932428439;Taip;0;3;0;3
11689;Strazdelis;Mažylių;2871841427;Taip;10;4;0;14
11690;Strazdelis;Mažylių;8699020650;Taip;7;0;0;7
11691;Strazdelis;Pabiručių;7087235151;Taip;6;3;0;9
11692;Strazdelis;Pabiručių;3030445367;Taip;6;0;0;6
11693;Strazdelis;Pabiručių;4966668662;Taip;5;2;0;7
11694;Strazdelis;Pabiručių;8484672456;Taip;5;1;0;6
11695;Strazdelis;Pabiručių;8953577585;Taip;1;6;0;7
11696;Strazdelis;Pabiručių;8677659019;Taip;9;0;0;9
11697;Strazdelis;Pabiručių;4848650799;Taip;0;1;0;1
11698;Strazdelis;Pabiručių;7716476995;Taip;3;1;0;4
11699;Strazdelis;Pabiručių;4174940099;Taip;0;16;0;16
11700;Strazdelis;Pabiručių;8554043784;Taip;9;3;0;12
11701;Strazdelis;Pabiručių;1952086370;Taip;13;0;1;14
11702;Strazdelis;Pabiručių;7802337169;Taip;5;0;2;7
11703;Strazdelis;Pabiručių;4461728361;Taip;8;0;1;9
11704;Strazdelis;Pabiručių;8356680705;Taip;1;4;0;5
11705;Strazdelis;Pabiručių;6457478289;Taip;5;1;0;6
11706;Strazdelis;Pabiručių;3426039979;Taip;10;1;0;11
11707;Strazdelis;Pabiručių;4715198107;Taip;1;0;0;1
11708;Strazdelis;Pabiručių;4334385271;Taip;8;8;0;16
11709;Šermukšnėlė;MOLINUKAI;9746313951;Taip;5;5;1;11
11710;Šermukšnėlė;MOLINUKAI;4638109666;Taip;5;0;2;7
11711;Šermukšnėlė;MOLINUKAI;9329824053;Taip;7;0;0;7
11712;Šermukšnėlė;MOLINUKAI;2714018690;Taip;11;0;0;11
11713;Šermukšnėlė;MOLINUKAI;5262882873;Taip;0;1;1;2
11714;Šermukšnėlė;MOLINUKAI;7385114026;Taip;11;0;3;14
11715;Šermukšnėlė;MOLINUKAI;2784732759;Taip;11;0;0;11
11716;Šermukšnėlė;MOLINUKAI;3342919832;Taip;0;1;1;2
11717;Šermukšnėlė;MOLINUKAI;9337047371;Taip;15;1;1;17
11718;Šermukšnėlė;MOLINUKAI;2098090763;Taip;5;0;3;8
11719;Šermukšnėlė;MOLINUKAI;5835100042;Taip;0;0;4;4
11720;Šermukšnėlė;MOLINUKAI;8000479161;Taip;11;0;0;11
11721;Šermukšnėlė;MOLINUKAI;4952285322;Taip;0;1;0;1
11722;Šermukšnėlė;MOLINUKAI;5733048755;Taip;5;0;1;6
11723;Šermukšnėlė;MOLINUKAI;6608458145;Taip;0;0;1;1
11724;Šermukšnėlė;MOLINUKAI;8104182167;Taip;5;0;1;6
11725;Šermukšnėlė;MOLINUKAI;6988120570;Taip;0;9;0;9
11726;Šermukšnėlė;MOLINUKAI;8728441474;Taip;0;1;2;3
11727;Šermukšnėlė;MOLINUKAI;4075151928;Taip;9;0;1;10
11728;Šermukšnėlė;MOLINUKAI;9527382390;Taip;5;0;0;5
11729;Šermukšnėlė;MOLINUKAI;4968522498;Taip;15;2;0;17
11730;Šermukšnėlė;ŠIAUDINUKAI;7249568196;Taip;0;1;0;1
11731;Šermukšnėlė;ŠIAUDINUKAI;3451361097;Taip;1;0;0;1
11732;Šermukšnėlė;ŠIAUDINUKAI;7002917737;Taip;1;0;0;1
11733;Šermukšnėlė;ŠIAUDINUKAI;7785671936;Taip;1;0;0;1
11734;Šermukšnėlė;ŠIAUDINUKAI;3637882900;Taip;0;8;0;8
11735;Šermukšnėlė;ŠIAUDINUKAI;1159472154;Taip;3;1;0;4
11736;Šermukšnėlė;ŠIAUDINUKAI;4956414941;Taip;5;1;1;7
11737;Šermukšnėlė;ŠIAUDINUKAI;3499394539;Taip;0;3;0;3
11738;Šermukšnėlė;ŠIAUDINUKAI;1157979179;Taip;0;5;0;5
11739;Šermukšnėlė;ŠIAUDINUKAI;3701053997;Ne;19;0;0;19
11740;Šermukšnėlė;ŠIAUDINUKAI;7917101921;Taip;6;0;0;6
11741;Šermukšnėlė;ŠIAUDINUKAI;3082272196;Ne;5;1;1;7
11742;Šermukšnėlė;ŠIAUDINUKAI;9903310024;Taip;0;1;0;1
11743;Šermukšnėlė;ŠIAUDINUKAI;9012757607;Taip;0;1;0;1
11744;Šermukšnėlė;ŠIAUDINUKAI;3550736579;Taip;11;0;0;11
11745;Šermukšnėlė;ŠIAUDINUKAI;5993599994;Taip;11;0;1;12
11746;Šermukšnėlė;ŠIAUDINUKAI;3522028983;Taip;0;0;1;1
11747;Šermukšnėlė;ŠIAUDINUKAI;6077798297;Taip;5;2;0;7
11748;Šermukšnėlė;ŠIAUDINUKAI;2351386211;Taip;0;0;2;2
11749;Šermukšnėlė;ŠIAUDINUKAI;1437314920;Taip;0;2;0;2
11750;Šermukšnėlė;TOŠINUKAI;2160616078;Taip;0;2;0;2
11751;Šermukšnėlė;TOŠINUKAI;1661977128;Taip;10;0;3;13
11752;Šermukšnėlė;TOŠINUKAI;3994316729;Taip;0;0;2;2
11753;Šermukšnėlė;TOŠINUKAI;1459253197;Taip;0;0;2;2
11754;Šermukšnėlė;TOŠINUKAI;78341448188;Taip;12;0;0;12
11755;Šermukšnėlė;TOŠINUKAI;8279692394;Taip;0;1;3;4
11756;Šermukšnėlė;TOŠINUKAI;5096946133;Taip;0;1;0;1
11757;Šermukšnėlė;TOŠINUKAI;8956573129;Ne;0;1;0;1
11758;Šermukšnėlė;TOŠINUKAI;4981204674;Taip;6;3;0;9
11759;Šermukšnėlė;TOŠINUKAI;7229632099;Taip;1;1;1;3
11760;Šermukšnėlė;TOŠINUKAI;2529526401;Ne;0;1;4;5
11761;Šermukšnėlė;TOŠINUKAI;7038705221;Taip;0;1;0;1
11762;Šermukšnėlė;TOŠINUKAI;6413821285;Taip;0;8;0;8
11763;Šermukšnėlė;TOŠINUKAI;9035625467;Ne;3;0;2;5
11764;Šermukšnėlė;TOŠINUKAI;3081548524;Taip;2;1;0;3
11765;Šermukšnėlė;TOŠINUKAI;5832072195;Taip;0;8;0;8
11766;Šermukšnėlė;TOŠINUKAI;3222466449;Taip;5;1;2;8
11767;Šermukšnėlė;TOŠINUKAI;1753169856;Taip;0;1;0;1
11768;Šermukšnėlė;TOŠINUKAI;6430627501;Taip;0;0;5;5
11769;Šermukšnėlė;TOŠINUKAI;9442514813;Taip;0;1;1;2
11770;Šermukšnėlė;TOŠINUKAI;1569084597;Taip;2;1;4;7
11771;Šermukšnėlė;ODINUKAI;4422415026;Ne;0;1;5;6
11772;Šermukšnėlė;ODINUKAI;5545018656;Taip;0;0;1;1
11773;Šermukšnėlė;ODINUKAI;2176788727;Ne;1;0;0;1
11774;Šermukšnėlė;ODINUKAI;5575518612;Taip;0;0;1;1
11775;Šermukšnėlė;ODINUKAI;5733540837;Taip;1;0;1;2
11776;Šermukšnėlė;ODINUKAI;7262199284;Taip;12;1;0;13
11777;Šermukšnėlė;ODINUKAI;5159461963;Taip;0;2;0;2
11778;Šermukšnėlė;ODINUKAI;5354978646;Taip;0;1;1;2
11779;Šermukšnėlė;ODINUKAI;1882432812;Taip;0;1;1;2
11780;Šermukšnėlė;ODINUKAI;3949629658;Taip;5;0;0;5
11781;Šermukšnėlė;ODINUKAI;6105915822;Taip;0;1;0;1
11782;Šermukšnėlė;ODINUKAI;9742208172;Taip;4;0;1;5
11783;Šermukšnėlė;ODINUKAI;7667114310;Taip;0;2;1;3
11784;Šermukšnėlė;ODINUKAI;7245206247;Taip;0;0;3;3
11785;Šermukšnėlė;ODINUKAI;5397385093;Taip;0;0;1;1
11786;Šermukšnėlė;ODINUKAI;4331948700;Taip;0;1;0;1
11787;Šermukšnėlė;ODINUKAI;6718242890;Taip;7;1;0;8
11788;Šermukšnėlė;ODINUKAI;9664249364;Ne;0;0;1;1
11789;Šermukšnėlė;ODINUKAI;1064222922;Taip;6;0;3;9
11790;Šermukšnėlė;ODINUKAI;6194188831;Taip;0;1;0;1
11791;Šermukšnėlė;KRIAUKLELĖS;3613456202;Taip;0;0;2;2
11792;Šermukšnėlė;KRIAUKLELĖS;8709426669;Taip;0;11;0;11
11793;Šermukšnėlė;KRIAUKLELĖS;6599779539;Taip;0;5;0;5
11794;Šermukšnėlė;KRIAUKLELĖS;9876533442;Taip;0;0;1;1
11795;Šermukšnėlė;KRIAUKLELĖS;3653792683;Taip;0;1;0;1
11796;Šermukšnėlė;KRIAUKLELĖS;7266947985;Taip;5;0;8;13
11797;Šermukšnėlė;KRIAUKLELĖS;4256630681;Taip;0;6;1;7
11798;Šermukšnėlė;KRIAUKLELĖS;8117261716;Taip;11;0;0;11
11799;Šermukšnėlė;KRIAUKLELĖS;3245643086;Taip;0;5;0;5
11800;Šermukšnėlė;KRIAUKLELĖS;6342714998;Taip;0;0;2;2
11801;Šermukšnėlė;KRIAUKLELĖS;6946711443;Taip;3;0;0;3
11802;Šermukšnėlė;KRIAUKLELĖS;9074111563;Taip;0;4;0;4
11803;Šermukšnėlė;KRIAUKLELĖS;9908568127;Taip;0;2;0;2
11804;Šermukšnėlė;KRIAUKLELĖS;8748166398;Ne;16;0;0;16
11805;Šermukšnėlė;KRIAUKLELĖS;5408843906;Taip;3;1;0;4
11806;Šermukšnėlė;VYTINUKAI;1523361932;Taip;0;1;1;2
11807;Šermukšnėlė;VYTINUKAI;8531953934;Taip;5;1;1;7
11808;Šermukšnėlė;VYTINUKAI;25189813939;Taip;3;1;0;4
11809;Šermukšnėlė;VYTINUKAI;83123267733;Taip;1;1;1;3
11810;Šermukšnėlė;VYTINUKAI;20028832329;Taip;0;3;0;3
11811;Šermukšnėlė;VYTINUKAI;3959795064;Taip;0;1;0;1
11812;Šermukšnėlė;VYTINUKAI;8498288021;Ne;0;7;0;7
11813;Šermukšnėlė;VYTINUKAI;6291531570;Taip;0;1;0;1
11814;Šermukšnėlė;VYTINUKAI;1244964311;Taip;0;1;2;3
11815;Šermukšnėlė;VYTINUKAI;83882579952;Taip;0;1;0;1
11816;Šermukšnėlė;VYTINUKAI;60840526220;Taip;0;3;0;3
11817;Šermukšnėlė;VYTINUKAI;1025787925;Taip;0;0;1;1
11818;Šermukšnėlė;VYTINUKAI;1519623099;Taip;0;2;0;2
11819;Šermukšnėlė;VYTINUKAI;9654198217;Taip;0;1;0;1
11820;Šermukšnėlė;VYTINUKAI;1670047548;Taip;4;1;1;6
11821;Šermukšnėlė;VYTINUKAI;1685592290;Taip;0;1;0;1
11822;Šermukšnėlė;VYTINUKAI;8123096990;Taip;6;1;0;7
11823;Šermukšnėlė;VYTINUKAI;8511421692;Taip;0;1;1;2
11824;Šermukšnėlė;VYTINUKAI;3883861823;Taip;0;5;0;5
11825;Šermukšnėlė;VYTINUKAI;5225263863;Taip;0;1;1;2
11826;Šermukšnėlė;GINTARĖLIAI;5069572637;Taip;0;1;0;1
11827;Šermukšnėlė;GINTARĖLIAI;8249749948;Taip;0;1;0;1
11828;Šermukšnėlė;GINTARĖLIAI;2989011150;Taip;0;2;0;2
11829;Šermukšnėlė;GINTARĖLIAI;4176986876;Taip;9;5;0;14
11830;Šermukšnėlė;GINTARĖLIAI;7036078780;Taip;11;0;1;12
11831;Šermukšnėlė;GINTARĖLIAI;1994737857;Taip;0;1;0;1
11832;Šermukšnėlė;GINTARĖLIAI;4619811264;Taip;0;1;0;1
11833;Šermukšnėlė;GINTARĖLIAI;5886893562;Taip;11;1;0;12
11834;Šermukšnėlė;GINTARĖLIAI;4783726095;Taip;0;2;0;2
11835;Šermukšnėlė;GINTARĖLIAI;9714566919;Ne;0;1;1;2
11836;Šermukšnėlė;GINTARĖLIAI;5172187141;Taip;0;6;0;6
11837;Šermukšnėlė;GINTARĖLIAI;3688946505;Taip;6;0;1;7
11838;Šermukšnėlė;GINTARĖLIAI;5905330617;Taip;0;0;1;1
11839;Šermukšnėlė;GINTARĖLIAI;1636944853;Taip;0;10;0;10
11840;Šermukšnėlė;GINTARĖLIAI;7053319091;Ne;1;0;2;3
11841;Šermukšnėlė;GINTARĖLIAI;6351841889;Ne;10;0;0;10
11842;Šermukšnėlė;GINTARĖLIAI;7305013368;Taip;6;1;0;7
11843;Šermukšnėlė;GINTARĖLIAI;6698650179;Taip;6;0;0;6
11844;Šermukšnėlė;GINTARĖLIAI;7106405983;Taip;0;0;1;1
11845;Šermukšnėlė;AKMENUKAI;3543061360;Taip;8;4;0;12
11846;Šermukšnėlė;AKMENUKAI;7564745299;Taip;10;2;0;12
11847;Šermukšnėlė;AKMENUKAI;9617044855;Taip;0;11;0;11
11848;Šermukšnėlė;AKMENUKAI;1856012121;Taip;12;0;0;12
11849;Šermukšnėlė;AKMENUKAI;8407947566;Taip;4;6;1;11
11850;Šermukšnėlė;AKMENUKAI;1902848560;Taip;5;2;0;7
11851;Šermukšnėlė;AKMENUKAI;3513568460;Taip;2;1;2;5
11852;Šermukšnėlė;AKMENUKAI;6896990721;Taip;0;1;2;3
11853;Šermukšnėlė;AKMENUKAI;8669676262;Taip;0;7;0;7
11854;Šermukšnėlė;AKMENUKAI;3148857617;Taip;12;5;0;17
11855;Šermukšnėlė;AKMENUKAI;4965640386;Taip;6;0;1;7
11856;Šermukšnėlė;AKMENUKAI;3639954786;Taip;0;0;4;4
11857;Šermukšnėlė;AKMENUKAI;7843128263;Taip;0;1;0;1
11858;Šermukšnėlė;AKMENUKAI;9805841777;Taip;0;6;0;6
11859;Šermukšnėlė;AKMENUKAI;3945291560;Taip;0;4;0;4
11860;Šermukšnėlė;AKMENUKAI;5660238634;Taip;0;0;1;1
11861;Šermukšnėlė;AKMENUKAI;6067298318;Taip;4;0;2;6
11862;Šermukšnėlė;AKMENUKAI;5678559268;Taip;16;0;0;16
11863;Šermukšnėlė;AKMENUKAI;8479230675;Taip;0;11;0;11
11864;Šermukšnėlė;AKMENUKAI;6162830167;Taip;2;0;0;2
11865;Šermukšnėlė;SIŪLINUKAI;4619600451;Ne;0;0;2;2
11866;Šermukšnėlė;SIŪLINUKAI;2967000352;Ne;18;0;0;18
11867;Šermukšnėlė;SIŪLINUKAI;4528448735;Taip;0;0;1;1
11868;Šermukšnėlė;SIŪLINUKAI;2740644605;Taip;8;1;0;9
11869;Šermukšnėlė;SIŪLINUKAI;8454298610;Taip;5;0;2;7
11870;Šermukšnėlė;SIŪLINUKAI;6429038861;Taip;7;0;0;7
11871;Šermukšnėlė;SIŪLINUKAI;6429038861;Taip;7;0;0;7
11872;Šermukšnėlė;SIŪLINUKAI;6429038861;Taip;7;0;0;7
11873;Šermukšnėlė;SIŪLINUKAI;6429038861;Taip;7;0;0;7
11874;Šermukšnėlė;SIŪLINUKAI;1819553019;Taip;11;0;2;13
11875;Šermukšnėlė;SIŪLINUKAI;7568969509;Taip;16;0;0;16
11876;Šermukšnėlė;SIŪLINUKAI;7758886713;Ne;10;0;0;10
11877;Šermukšnėlė;SIŪLINUKAI;4390650081;Taip;5;0;4;9
11878;Šermukšnėlė;SIŪLINUKAI;5072021867;Taip;9;1;0;10
11879;Šermukšnėlė;SIŪLINUKAI;7934772640;Taip;7;4;0;11
11880;Šermukšnėlė;SIŪLINUKAI;3994075596;Ne;0;0;1;1
11881;Šermukšnėlė;SIŪLINUKAI;3098629992;Taip;0;0;1;1
11882;Šermukšnėlė;SIŪLINUKAI;6231057889;Taip;6;0;0;6
11883;Šermukšnėlė;SIŪLINUKAI;3106890807;Taip;0;2;0;2
11884;Šermukšnėlė;SIŪLINUKAI;3979766151;Ne;6;0;0;6
11885;Šermukšnėlė;SIŪLINUKAI;9534316724;Taip;10;0;0;10
11886;Šermukšnėlė;SIŪLINUKAI;2705569653;Taip;1;0;0;1
11887;Šermukšnėlė;MEDINUKAi;8558117857;Ne;0;21;0;21
11888;Šermukšnėlė;MEDINUKAi;1318170904;Taip;5;0;5;10
11889;Šermukšnėlė;MEDINUKAi;6149973884;Taip;1;0;1;2
11890;Šermukšnėlė;MEDINUKAi;5874725607;Taip;4;0;2;6
11891;Šermukšnėlė;MEDINUKAi;7532979465;Taip;3;0;3;6
11892;Šermukšnėlė;MEDINUKAi;7211488009;Taip;6;0;1;7
11893;Šermukšnėlė;MEDINUKAi;3359398381;Taip;0;5;0;5
11894;Šermukšnėlė;MEDINUKAi;6928863055;Taip;0;0;1;1
11895;Šermukšnėlė;MEDINUKAi;8437052600;Taip;4;0;5;9
11896;Šermukšnėlė;MEDINUKAi;8200175951;Taip;16;1;1;18
11897;Šermukšnėlė;MEDINUKAi;7546040491;Taip;5;0;1;6
11898;Šermukšnėlė;MEDINUKAi;9872479998;Taip;12;0;0;12
11899;Šermukšnėlė;MEDINUKAi;8587108797;Taip;21;0;0;21
11900;Šermukšnėlė;MEDINUKAi;5605191023;Taip;4;0;4;8
11901;Šermukšnėlė;SKUDURINUKAI;7523588943;Taip;0;1;0;1
11902;Šermukšnėlė;SKUDURINUKAI;2235123503;Taip;6;0;5;11
11903;Šermukšnėlė;SKUDURINUKAI;9535836301;Taip;1;0;1;2
11904;Šermukšnėlė;SKUDURINUKAI;3138507073;Taip;15;0;0;15
11905;Šermukšnėlė;SKUDURINUKAI;9247356229;Taip;11;0;0;11
11906;Šermukšnėlė;SKUDURINUKAI;3206222470;Taip;18;0;0;18
11907;Šermukšnėlė;SKUDURINUKAI;5751303170;Taip;9;0;0;9
11908;Šermukšnėlė;SKUDURINUKAI;2810624440;Taip;7;5;0;12
11909;Šermukšnėlė;SKUDURINUKAI;3955219247;Taip;10;0;0;10
11910;Šermukšnėlė;SKUDURINUKAI;5564759354;Ne;10;1;0;11
11911;Šermukšnėlė;SKUDURINUKAI;1931894084;Taip;1;0;0;1
11912;Šermukšnėlė;SKUDURINUKAI;6778901855;Taip;0;1;8;9
11913;Šermukšnėlė;SKUDURINUKAI;1502704170;Taip;9;0;2;11
11914;Šermukšnėlė;SKUDURINUKAI;6524173015;Taip;2;0;0;2
11915;Šermukšnėlė;PAGRANDUKAI;8802335133;Taip;3;1;0;4
11916;Šermukšnėlė;PAGRANDUKAI;6797936390;Taip;5;4;0;9
11917;Šermukšnėlė;PAGRANDUKAI;1312471779;Ne;5;0;1;6
11918;Šermukšnėlė;PAGRANDUKAI;4219655802;Taip;4;0;0;4
11919;Šermukšnėlė;PAGRANDUKAI;4337084152;Taip;8;0;6;14
11920;Šermukšnėlė;PAGRANDUKAI;8710910167;Taip;0;0;5;5
11921;Šermukšnėlė;PAGRANDUKAI;8092422909;Taip;17;0;1;18
11922;Šermukšnėlė;PAGRANDUKAI;9246072554;Taip;0;1;2;3
11923;Šermukšnėlė;PAGRANDUKAI;6185588116;Taip;5;0;0;5
11924;Šermukšnėlė;PAGRANDUKAI;1209135668;Taip;14;0;0;14
11925;Šermukšnėlė;PAGRANDUKAI;9080074486;Taip;9;1;0;10
11926;Šermukšnėlė;PAGRANDUKAI;7098953763;Taip;0;0;3;3
11927;Šermukšnėlė;PAGRANDUKAI;5081685546;Ne;14;0;0;14
11928;Šermukšnėlė;PAGRANDUKAI;5456669766;Taip;4;0;0;4
11929;Šermukšnėlė;PAGRANDUKAI;8641098720;Taip;11;0;0;11
11930;Šermukšnėlė;PAGRANDUKAI;4810571143;Taip;0;6;0;6
11931;Šypsena;NYKŠTUKAI;8913058656;Taip;0;5;0;5
11932;Šypsena;NYKŠTUKAI;8508569167;Taip;0;4;0;4
11933;Šypsena;NYKŠTUKAI;5818211923;Taip;0;0;1;1
11934;Šypsena;NYKŠTUKAI;8665786789;Taip;16;0;0;16
11935;Šypsena;NYKŠTUKAI;1716274053;Ne;0;4;0;4
11936;Šypsena;NYKŠTUKAI;6724776618;Taip;7;1;4;12
11937;Šypsena;NYKŠTUKAI;2790906806;Ne;5;0;1;6
11938;Šypsena;NYKŠTUKAI;9363618080;Taip;2;0;2;4
11939;Šypsena;NYKŠTUKAI;9702364620;Ne;0;8;0;8
11940;Šypsena;NYKŠTUKAI;3733757483;Taip;5;2;0;7
11941;Šypsena;NYKŠTUKAI;2179657619;Ne;0;3;0;3
11942;Šypsena;NYKŠTUKAI;2900195046;Taip;11;2;0;13
11943;Šypsena;NYKŠTUKAI;3724645162;Taip;0;0;1;1
11944;Šypsena;NYKŠTUKAI;3003901966;Taip;11;5;0;16
11945;Šypsena;NYKŠTUKAI;2182189246;Taip;8;0;1;9
11946;Šypsena;NYKŠTUKAI;1431850136;Taip;0;1;0;1
11947;Šypsena;NYKŠTUKAI;5142969776;Taip;14;0;0;14
11948;Šypsena;NYKŠTUKAI;8439694239;Taip;1;7;0;8
11949;Šypsena;NYKŠTUKAI;6377979434;Taip;15;2;0;17
11950;Šypsena;NYKŠTUKAI;7332307199;Taip;2;0;2;4
11951;Šypsena;NYKŠTUKAI;7074211876;Taip;0;0;6;6
11952;Šypsena;SPINDULIUKAI;7898387398;Taip;0;5;0;5
11953;Šypsena;SPINDULIUKAI;1324902555;Taip;11;1;0;12
11954;Šypsena;SPINDULIUKAI;5222603743;Taip;10;2;0;12
11955;Šypsena;SPINDULIUKAI;7120597034;Taip;7;1;0;8
11956;Šypsena;SPINDULIUKAI;5879506651;Ne;5;1;0;6
11957;Šypsena;SPINDULIUKAI;3823623458;Ne;0;1;0;1
11958;Šypsena;SPINDULIUKAI;4695547847;Taip;3;0;1;4
11959;Šypsena;SPINDULIUKAI;6713182218;Taip;13;2;0;15
11960;Šypsena;SPINDULIUKAI;1287205292;Ne;16;0;0;16
11961;Šypsena;SPINDULIUKAI;8215278033;Taip;0;0;5;5
11962;Šypsena;SPINDULIUKAI;7537442618;Taip;5;2;0;7
11963;Šypsena;SPINDULIUKAI;2584574423;Taip;15;0;0;15
11964;Šypsena;SPINDULIUKAI;9704350208;Ne;0;5;0;5
11965;Šypsena;SPINDULIUKAI;5906001927;Taip;15;0;1;16
11966;Šypsena;SPINDULIUKAI;6951845385;Taip;4;0;0;4
11967;Šypsena;SPINDULIUKAI;7877396588;Taip;0;5;0;5
11968;Šypsena;SPINDULIUKAI;4520148322;Taip;0;4;0;4
11969;Šypsena;SPINDULIUKAI;3901424559;Taip;0;1;0;1
11970;Šypsena;SPINDULIUKAI;8765509994;Taip;1;0;1;2
11971;Šypsena;SPINDULIUKAI;3429836513;Taip;0;1;22;23
11972;Šypsena;SPINDULIUKAI;8566236342;Taip;11;0;4;15
11973;Šypsena;SKRUZDELIUKAI;5611440056;Ne;5;3;2;10
11974;Šypsena;SKRUZDELIUKAI;1114341518;Taip;6;0;0;6
11975;Šypsena;SKRUZDELIUKAI;1558614852;Taip;11;1;1;13
11976;Šypsena;SKRUZDELIUKAI;1897176871;Taip;6;2;0;8
11977;Šypsena;SKRUZDELIUKAI;8715718525;Taip;0;0;2;2
11978;Šypsena;SKRUZDELIUKAI;2312828770;Taip;0;1;0;1
11979;Šypsena;SKRUZDELIUKAI;1181590127;Taip;7;8;0;15
11980;Šypsena;SKRUZDELIUKAI;4808041625;Taip;0;1;1;2
11981;Šypsena;SKRUZDELIUKAI;1422418997;Taip;0;1;0;1
11982;Šypsena;SKRUZDELIUKAI;4038279267;Taip;7;3;1;11
11983;Šypsena;SKRUZDELIUKAI;5834057370;Taip;0;3;0;3
11984;Šypsena;SKRUZDELIUKAI;1515803985;Taip;0;2;0;2
11985;Šypsena;SKRUZDELIUKAI;3809171499;Taip;0;1;0;1
11986;Šypsena;SKRUZDELIUKAI;4344780723;Taip;0;0;12;12
11987;Šypsena;SKRUZDELIUKAI;5504570516;Taip;0;1;0;1
11988;Šypsena;SKRUZDELIUKAI;5369445077;Taip;0;0;1;1
11989;Šypsena;SKRUZDELIUKAI;2798819321;Taip;0;4;0;4
11990;Šypsena;SKRUZDELIUKAI;3506046076;Ne;6;1;2;9
11991;Šypsena;SKRUZDELIUKAI;4450146424;Taip;9;1;0;10
11992;Šypsena;SKRUZDELIUKAI;7519967594;Taip;10;6;1;17
11993;Šypsena;Bitutės;1796837022;Taip;5;1;0;6
11994;Šypsena;Bitutės;6158973964;Taip;9;2;0;11
11995;Šypsena;Bitutės;6590285866;Taip;0;1;0;1
11996;Šypsena;Bitutės;4766170132;Ne;0;2;0;2
11997;Šypsena;Bitutės;6832433711;Taip;0;1;0;1
11998;Šypsena;Bitutės;2995753269;Taip;0;1;3;4
11999;Šypsena;Bitutės;2248628927;Taip;5;4;0;9
12000;Šypsena;Bitutės;7413098580;Ne;13;4;0;17
12001;Šypsena;Bitutės;3063226692;Ne;0;1;1;2
12002;Šypsena;Bitutės;5985974927;Taip;0;2;0;2
12003;Šypsena;Bitutės;3387625466;Taip;1;1;4;6
12004;Šypsena;Bitutės;1669768648;Ne;0;3;0;3
12005;Šypsena;Bitutės;1575413188;Taip;0;4;0;4
12006;Šypsena;Bitutės;6511231991;Ne;0;1;0;1
12007;Šypsena;Bitutės;2005543016;Ne;0;1;0;1
12008;Šypsena;Bitutės;5568502083;Taip;0;4;0;4
12009;Šypsena;MEŠKIUKAI;9696633725;Taip;0;0;2;2
12010;Šypsena;MEŠKIUKAI;7876871684;Taip;7;2;4;13
12011;Šypsena;MEŠKIUKAI;6055482561;Ne;14;0;0;14
12012;Šypsena;MEŠKIUKAI;6028006499;Taip;0;1;9;10
12013;Šypsena;MEŠKIUKAI;3724483762;Ne;9;1;0;10
12014;Šypsena;MEŠKIUKAI;7817486488;Taip;22;1;0;23
12015;Šypsena;MEŠKIUKAI;9862387726;Taip;8;0;1;9
12016;Šypsena;MEŠKIUKAI;8001187137;Ne;0;0;1;1
12017;Šypsena;MEŠKIUKAI;3663446767;Taip;6;0;2;8
12018;Šypsena;MEŠKIUKAI;8094166916;Taip;8;1;1;10
12019;Šypsena;MEŠKIUKAI;5446516798;Taip;0;0;3;3
12020;Šypsena;MEŠKIUKAI;5094556499;Taip;9;1;6;16
12021;Šypsena;MEŠKIUKAI;4496704989;Taip;0;4;0;4
12022;Šypsena;MEŠKIUKAI;7174068697;Taip;3;0;3;6
12023;Šypsena;BORUŽĖLĖS;6738149077;Taip;10;2;0;12
12024;Šypsena;BORUŽĖLĖS;7905089772;Taip;9;0;1;10
12025;Šypsena;BORUŽĖLĖS;7234904026;Ne;11;2;0;13
12026;Šypsena;BORUŽĖLĖS;8963484558;Ne;1;4;0;5
12027;Šypsena;BORUŽĖLĖS;3951000812;Taip;11;4;0;15
12028;Šypsena;BORUŽĖLĖS;2177181171;Taip;11;0;1;12
12029;Šypsena;BORUŽĖLĖS;7960872132;Taip;8;0;1;9
12030;Šypsena;BORUŽĖLĖS;4260693029;Ne;13;3;0;16
12031;Šypsena;BORUŽĖLĖS;6859531936;Ne;0;1;1;2
12032;Šnekutis;DRUGELIŲ;1504945841;Taip;6;7;0;13
12033;Šnekutis;DRUGELIŲ;6305168453;Taip;6;0;3;9
12034;Šnekutis;DRUGELIŲ;9543014297;Taip;5;0;1;6
12035;Šnekutis;DRUGELIŲ;3096125224;Taip;0;5;0;5
12036;Šnekutis;DRUGELIŲ;3386995244;Ne;0;0;6;6
12037;Šnekutis;DRUGELIŲ;2131948397;Taip;0;1;0;1
12038;Šnekutis;DRUGELIŲ;8984597121;Taip;6;0;0;6
12039;Šnekutis;DRUGELIŲ;8810371475;Taip;0;15;0;15
12040;Šnekutis;DRUGELIŲ;7680962037;Taip;8;0;1;9
12041;Šnekutis;DRUGELIŲ;7089148766;Taip;9;5;0;14
12042;Šnekutis;DRUGELIŲ;3611064172;Taip;0;0;1;1
12043;Šnekutis;DRUGELIŲ;3079202929;Taip;0;0;1;1
12044;Šnekutis;DRUGELIŲ;8209686459;Taip;0;2;0;2
12045;Šnekutis;DRUGELIŲ;8036600501;Taip;0;1;0;1
12046;Šnekutis;DRUGELIŲ;6071004512;Taip;3;0;0;3
12047;Šnekutis;DRUGELIŲ;8570372260;Taip;0;2;0;2
12048;Šnekutis;DRUGELIŲ;1556960616;Taip;15;2;5;22
12049;Šnekutis;DRUGELIŲ;3177449195;Taip;7;0;0;7
12050;Šnekutis;DRUGELIŲ;4380966487;Taip;4;0;1;5
12051;Šnekutis;DRUGELIŲ;8076487157;Taip;0;1;4;5
12052;Šnekutis;DRUGELIŲ;7954240439;Taip;16;0;0;16
12053;Šnekutis;DRUGELIŲ;6330033887;Taip;10;0;1;11
12054;Šnekutis;Kačiukų;3281475303;Taip;0;6;1;7
12055;Šnekutis;Kačiukų;9670205249;Taip;2;6;0;8
12056;Šnekutis;Kačiukų;7615716438;Ne;0;4;0;4
12057;Šnekutis;Kačiukų;9780684867;Ne;0;4;0;4
12058;Šnekutis;Kačiukų;3271262071;Taip;9;4;1;14
12059;Šnekutis;Kačiukų;3166309530;Taip;0;1;0;1
12060;Šnekutis;Kačiukų;4143844589;Taip;7;0;1;8
12061;Šnekutis;Kačiukų;9312935803;Ne;0;1;13;14
12062;Šnekutis;Kačiukų;7236658561;Taip;0;1;0;1
12063;Šnekutis;Kačiukų;4992188525;Ne;0;1;0;1
12064;Šnekutis;Kačiukų;7638626055;Taip;0;0;1;1
12065;Šnekutis;Kačiukų;9157136735;Ne;0;10;0;10
12066;Šnekutis;Kačiukų;4920263429;Taip;5;1;0;6
12067;Šnekutis;Kačiukų;5909584565;Taip;0;1;0;1
12068;Šnekutis;Kačiukų;6234943180;Taip;0;1;0;1
12069;Šnekutis;Kačiukų;2914145045;Ne;18;0;0;18
12070;Šnekutis;Kačiukų;8340697546;Taip;0;0;3;3
12071;Šnekutis;Kačiukų;9896249776;Taip;15;0;1;16
12072;Šnekutis;Kačiukų;2656152037;Taip;0;1;0;1
12073;Šnekutis;Kačiukų;9051956302;Taip;0;1;20;21
12074;Šnekutis;Kačiukų;5521822696;Ne;0;4;0;4
12075;Šnekutis;Kačiukų;9942669058;Ne;0;1;2;3
12076;Šnekutis;Kačiukų;2144568225;Taip;0;0;2;2
12077;Šnekutis;Kačiukų;4624075875;Taip;0;0;3;3
12078;Šnekutis;Pėlėdžiukų;5188035949;Taip;6;0;1;7
12079;Šnekutis;Pėlėdžiukų;3068754741;Taip;0;1;5;6
12080;Šnekutis;Pėlėdžiukų;77534335117;Ne;8;1;2;11
12081;Šnekutis;Pėlėdžiukų;3312928478;Taip;7;0;0;7
12082;Šnekutis;Pėlėdžiukų;8866360301;Taip;6;0;3;9
12083;Šnekutis;Pėlėdžiukų;8745465796;Taip;11;1;1;13
12084;Šnekutis;Pėlėdžiukų;3170928052;Ne;2;0;1;3
12085;Šnekutis;Pėlėdžiukų;3578045341;Ne;5;0;1;6
12086;Šnekutis;Pėlėdžiukų;1329958641;Taip;0;0;1;1
12087;Šnekutis;Pėlėdžiukų;9511116249;Taip;0;1;1;2
12088;Šnekutis;Pėlėdžiukų;1369660223;Taip;6;0;0;6
12089;Šnekutis;Pėlėdžiukų;1682748852;Taip;12;1;0;13
12090;Šnekutis;Pėlėdžiukų;9601932777;Taip;19;0;0;19
12091;Šnekutis;Pėlėdžiukų;4302555600;Taip;19;0;0;19
12092;Šnekutis;Pėlėdžiukų;7507857415;Ne;0;1;0;1
12093;Šnekutis;Pėlėdžiukų;7514753023;Taip;16;0;0;16
12094;Šnekutis;Pėlėdžiukų;54532738133;Ne;3;0;0;3
12095;Šnekutis;Boružėlių;4835202527;Taip;0;2;1;3
12096;Šnekutis;Boružėlių;9326455786;Taip;11;0;1;12
12097;Šnekutis;Boružėlių;9054899440;Taip;11;0;1;12
12098;Šnekutis;Boružėlių;9862362744;Taip;5;0;1;6
12099;Šnekutis;Boružėlių;5597629090;Taip;6;0;1;7
12100;Šnekutis;Boružėlių;7089000987;Ne;2;0;0;2
12101;Šnekutis;Boružėlių;2843483435;Taip;10;0;1;11
12102;Šnekutis;Boružėlių;5906320006;Taip;9;0;0;9
12103;Šnekutis;Boružėlių;6405894763;Ne;10;4;0;14
12104;Šnekutis;Boružėlių;3889176018;Taip;5;0;1;6
12105;Šnekutis;Boružėlių;6749848086;Taip;0;0;7;7
12106;Šnekutis;Boružėlių;6146988521;Ne;8;2;0;10
12107;Šnekutis;Boružėlių;5519015388;Taip;15;0;6;21
12108;Šnekutis;Boružėlių;3628210526;Taip;1;0;1;2
12109;Šnekutis;Boružėlių;7344776758;Taip;6;0;0;6
12110;Šnekutis;Boružėlių;5970951526;Taip;6;0;0;6
12111;Šnekutis;Boružėlių;3344425033;Ne;0;0;3;3
12112;Šnekutis;Boružėlių;3937465849;Ne;4;0;1;5
12113;Šnekutis;Boružėlių;8219465079;Taip;0;0;2;2
12114;Šnekutis;Boružėlių;6015384795;Ne;0;0;1;1
12115;Šnekutis;Boružėlių;7307895397;Taip;16;0;0;16
12116;Šnekutis;Boružėlių;3371393656;Taip;18;0;1;19
12117;Šnekutis;Boružėlių;2779793970;Ne;21;0;0;21
12118;Šnekutis;Meškučių;2852111627;Taip;6;0;0;6
12119;Šnekutis;Meškučių;3214549246;Ne;21;0;0;21
12120;Šnekutis;Meškučių;6306269165;Ne;2;0;0;2
12121;Šnekutis;Meškučių;2626247219;Taip;16;0;1;17
12122;Šnekutis;Meškučių;2042842873;Taip;7;2;0;9
12123;Šnekutis;Meškučių;2140099519;Taip;0;1;0;1
12124;Šnekutis;Meškučių;9709701441;Taip;11;0;0;11
12125;Šnekutis;Meškučių;1219175855;Taip;8;0;0;8
12126;Šnekutis;Meškučių;9574210410;Taip;0;0;1;1
12127;Šnekutis;Meškučių;7980166125;Taip;12;0;0;12
12128;Šnekutis;Meškučių;8456957469;Taip;5;0;0;5
12129;Šnekutis;Meškučių;3572114463;Ne;16;0;0;16
12130;Šnekutis;Meškučių;8417485561;Taip;9;0;1;10
12131;Šnekutis;Meškučių;2312968654;Taip;3;0;0;3
12132;Šnekutis;Viščiukų;9790241725;Taip;4;0;0;4
12133;Šnekutis;Viščiukų;9322106995;Taip;10;0;0;10
12134;Šnekutis;Viščiukų;3842436406;Taip;7;1;0;8
12135;Šnekutis;Viščiukų;3115675798;Taip;5;0;0;5
12136;Šnekutis;Viščiukų;5934631354;Taip;0;0;5;5
12137;Šnekutis;Viščiukų;4848437026;Taip;5;0;2;7
12138;Šnekutis;Viščiukų;9772257715;Ne;8;1;0;9
12139;Šnekutis;Viščiukų;3593766968;Taip;9;0;1;10
12140;Šnekutis;Viščiukų;1833392181;Taip;5;0;0;5
12141;Šnekutis;Viščiukų;1805259980;Taip;11;0;0;11
12142;Šnekutis;Viščiukų;7200356364;Taip;16;0;0;16
12143;Šnekutis;Viščiukų;1248466603;Taip;15;0;0;15
12144;Šnekutis;Viščiukų;9007182019;Taip;21;0;0;21
12145;Šnekutis;Viščiukų;7006343288;Taip;12;0;1;13
12146;Šnekutis;Viščiukų;5919317274;Taip;5;0;0;5
12147;Užupiukas;VYTURĖLIŲ;5116564840;Taip;0;0;3;3
12148;Užupiukas;VYTURĖLIŲ;7443013255;Taip;5;0;0;5
12149;Užupiukas;VYTURĖLIŲ;3656400244;Taip;0;7;2;9
12150;Užupiukas;VYTURĖLIŲ;3829013911;Taip;11;0;1;12
12151;Užupiukas;VYTURĖLIŲ;9212428150;Taip;5;0;1;6
12152;Užupiukas;VYTURĖLIŲ;8001099421;Taip;14;0;0;14
12153;Užupiukas;VYTURĖLIŲ;4401569800;Taip;0;0;11;11
12154;Užupiukas;VYTURĖLIŲ;1391826582;Taip;2;0;5;7
12155;Užupiukas;VYTURĖLIŲ;5021163099;Ne;0;0;2;2
12156;Užupiukas;VYTURĖLIŲ;8960813016;Taip;16;0;0;16
12157;Užupiukas;VYTURĖLIŲ;9132605734;Taip;8;0;1;9
12158;Užupiukas;VYTURĖLIŲ;8245876832;Ne;4;1;1;6
12159;Užupiukas;VYTURĖLIŲ;5168946019;Taip;0;0;4;4
12160;Užupiukas;VYTURĖLIŲ;5718382826;Taip;0;3;5;8
12161;Užupiukas;VYTURĖLIŲ;9209209113;Ne;11;0;0;11
12162;Užupiukas;VYTURĖLIŲ;9070732925;Taip;0;2;0;2
12163;Užupiukas;VYTURĖLIŲ;1647271985;Taip;0;0;1;1
12164;Užupiukas;VYTURĖLIŲ;1791922219;Taip;0;0;4;4
12165;Užupiukas;VYTURĖLIŲ;8347350503;Taip;8;0;2;10
12166;Užupiukas;VYTURĖLIŲ;2580733127;Taip;0;1;0;1
12167;Užupiukas;KAČIUKŲ;3905448176;Taip;8;0;0;8
12168;Užupiukas;KAČIUKŲ;3567963511;Taip;0;1;4;5
12169;Užupiukas;KAČIUKŲ;9991552624;Taip;0;6;0;6
12170;Užupiukas;KAČIUKŲ;3048959458;Taip;0;1;1;2
12171;Užupiukas;KAČIUKŲ;3080668107;Ne;14;1;0;15
12172;Užupiukas;KAČIUKŲ;1809036046;Ne;0;3;0;3
12173;Užupiukas;KAČIUKŲ;1102468034;Taip;0;1;1;2
12174;Užupiukas;KAČIUKŲ;1464016943;Taip;7;4;0;11
12175;Užupiukas;KAČIUKŲ;4485435274;Taip;0;0;2;2
12176;Užupiukas;KAČIUKŲ;1102293237;Taip;0;6;0;6
12177;Užupiukas;KAČIUKŲ;9386211193;Taip;0;1;10;11
12178;Užupiukas;KAČIUKŲ;7048114101;Taip;20;1;0;21
12179;Užupiukas;KAČIUKŲ;1388346927;Taip;7;2;0;9
12180;Užupiukas;KAČIUKŲ;9333587467;Taip;0;3;0;3
12181;Užupiukas;KAČIUKŲ;7574528186;Ne;15;0;0;15
12182;Užupiukas;KAČIUKŲ;7092857844;Taip;4;0;3;7
12183;Užupiukas;KAČIUKŲ;2606742144;Taip;0;1;1;2
12184;Užupiukas;KAČIUKŲ;5233447872;Taip;20;1;0;21
12185;Užupiukas;KAČIUKŲ;9719845726;Taip;0;4;1;5
12186;Užupiukas;KAČIUKŲ;3543913063;Taip;0;1;9;10
12187;Užupiukas;KAČIUKŲ;4920190785;Taip;13;3;2;18
12188;Užupiukas;DRUGELIŲ;8876174256;Taip;15;0;1;16
12189;Užupiukas;DRUGELIŲ;5239006321;Taip;5;1;1;7
12190;Užupiukas;DRUGELIŲ;7581152903;Taip;0;1;9;10
12191;Užupiukas;DRUGELIŲ;5361599156;Taip;1;1;0;2
12192;Užupiukas;DRUGELIŲ;4680027403;Taip;0;0;1;1
12193;Užupiukas;DRUGELIŲ;6698907535;Taip;3;0;0;3
12194;Užupiukas;DRUGELIŲ;9577167600;Ne;11;0;0;11
12195;Užupiukas;DRUGELIŲ;3419182422;Taip;5;0;1;6
12196;Užupiukas;DRUGELIŲ;4854016957;Taip;1;1;7;9
12197;Užupiukas;DRUGELIŲ;8692826414;Taip;1;1;4;6
12198;Užupiukas;DRUGELIŲ;7169272175;Taip;21;0;0;21
12199;Užupiukas;DRUGELIŲ;1156471313;Taip;3;0;3;6
12200;Užupiukas;DRUGELIŲ;4595291532;Taip;0;0;7;7
12201;Užupiukas;DRUGELIŲ;3383643388;Ne;3;1;1;5
12202;Užupiukas;DRUGELIŲ;3961733676;Taip;21;0;0;21
12203;Užupiukas;DRUGELIŲ;5006880916;Taip;12;1;0;13
12204;Užupiukas;DRUGELIŲ;4075611307;Taip;0;2;1;3
12205;Užupiukas;DRUGELIŲ;9715624372;Ne;13;0;0;13
12206;Užupiukas;DRUGELIŲ;1108429907;Ne;1;1;6;8
12207;Užupiukas;DRUGELIŲ;9295230331;Taip;0;0;9;9
12208;Užupiukas;DRUGELIŲ;3940029893;Taip;1;0;0;1
12209;Užupiukas;DRUGELIŲ;3575209839;Taip;0;2;0;2
12210;Užupiukas;EŽIUKŲ;1526296386;Ne;4;0;2;6
12211;Užupiukas;EŽIUKŲ;9774124589;Ne;0;0;4;4
12212;Užupiukas;EŽIUKŲ;2724216446;Ne;0;9;0;9
12213;Užupiukas;EŽIUKŲ;9446562736;Taip;0;0;1;1
12214;Užupiukas;EŽIUKŲ;5072363435;Taip;0;0;2;2
12215;Užupiukas;EŽIUKŲ;1100574872;Taip;0;2;3;5
12216;Užupiukas;EŽIUKŲ;5204808398;Taip;0;0;5;5
12217;Užupiukas;EŽIUKŲ;3171528288;Taip;0;0;9;9
12218;Užupiukas;EŽIUKŲ;7860601571;Taip;0;1;1;2
12219;Užupiukas;EŽIUKŲ;3611922301;Taip;0;0;3;3
12220;Užupiukas;EŽIUKŲ;8020138690;Taip;0;0;3;3
12221;Užupiukas;EŽIUKŲ;6823724962;Taip;1;4;1;6
12222;Užupiukas;EŽIUKŲ;5538327364;Taip;0;0;2;2
12223;Užupiukas;EŽIUKŲ;3057147440;Taip;0;1;1;2
12224;Užupiukas;EŽIUKŲ;6370918943;Taip;0;1;2;3
12225;Užupiukas;EŽIUKŲ;9357101972;Taip;0;0;1;1
12226;Užupiukas;EŽIUKŲ;6512355340;Taip;3;0;1;4
12227;Užupiukas;EŽIUKŲ;4356736070;Taip;0;0;3;3
12228;Užupiukas;EŽIUKŲ;9906475253;Taip;4;0;7;11
12229;Užupiukas;EŽIUKŲ;8127218866;Taip;12;0;0;12
12230;Užupiukas;BORUŽĖLIŲ;4781598862;Taip;2;0;4;6
12231;Užupiukas;BORUŽĖLIŲ;7861121290;Taip;1;0;0;1
12232;Užupiukas;BORUŽĖLIŲ;12787288319;Taip;4;0;0;4
12233;Užupiukas;BORUŽĖLIŲ;6526550727;Taip;1;0;0;1
12234;Užupiukas;BORUŽĖLIŲ;9735462228;Taip;0;0;2;2
12235;Užupiukas;BORUŽĖLIŲ;9791681813;Taip;0;1;0;1
12236;Užupiukas;BORUŽĖLIŲ;1503714343;Taip;1;0;6;7
12237;Užupiukas;BORUŽĖLIŲ;8313812681;Taip;4;0;1;5
12238;Užupiukas;BORUŽĖLIŲ;9677572224;Taip;2;0;0;2
12239;Užupiukas;BORUŽĖLIŲ;2445335267;Taip;1;0;0;1
12240;Užupiukas;BORUŽĖLIŲ;38066177076;Taip;1;0;0;1
12241;Užupiukas;BORUŽĖLIŲ;1514268763;Taip;1;0;0;1
12242;Užupiukas;BORUŽĖLIŲ;2307600884;Taip;0;1;4;5
12243;Užupiukas;BORUŽĖLIŲ;6073039842;Taip;8;1;1;10
12244;Užupiukas;BORUŽĖLIŲ;3038973312;Taip;2;0;1;3
12245;Užupiukas;BORUŽĖLIŲ;6601099182;Ne;4;4;0;8
12246;Užupiukas;BORUŽĖLIŲ;3940264504;Taip;0;0;7;7
12247;Užupiukas;BORUŽĖLIŲ;5517458323;Ne;0;0;1;1
12248;Užupiukas;BORUŽĖLIŲ;7427702848;Taip;0;9;0;9
12249;Užupiukas;SPINDULIUKŲ;5889162375;Taip;0;1;0;1
12250;Užupiukas;SPINDULIUKŲ;1718518621;Taip;0;1;3;4
12251;Užupiukas;SPINDULIUKŲ;1679324943;Taip;2;1;1;4
12252;Užupiukas;SPINDULIUKŲ;7298322865;Taip;12;0;0;12
12253;Užupiukas;SPINDULIUKŲ;8734960045;Taip;0;1;2;3
12254;Užupiukas;SPINDULIUKŲ;9863097416;Taip;0;1;1;2
12255;Užupiukas;SPINDULIUKŲ;1772019951;Taip;3;1;1;5
12256;Užupiukas;SPINDULIUKŲ;3298267311;Taip;0;1;0;1
12257;Užupiukas;SPINDULIUKŲ;9617597828;Taip;6;0;2;8
12258;Užupiukas;SPINDULIUKŲ;8915159672;Taip;0;2;0;2
12259;Užupiukas;SPINDULIUKŲ;2348243399;Taip;0;1;1;2
12260;Užupiukas;SPINDULIUKŲ;1554333137;Taip;0;1;20;21
12261;Užupiukas;SPINDULIUKŲ;9723966502;Taip;0;1;3;4
12262;Užupiukas;SPINDULIUKŲ;9655636851;Taip;0;1;0;1
12263;Užupiukas;SPINDULIUKŲ;8724566014;Taip;1;1;7;9
12264;Užupiukas;SPINDULIUKŲ;8870229834;Taip;0;6;0;6
12265;Užupiukas;SPINDULIUKŲ;14139543365;Taip;0;1;1;2
12266;Užupiukas;SPINDULIUKŲ;9096157655;Taip;0;1;4;5
12267;Užupiukas;SPINDULIUKŲ;9782972949;Taip;5;1;1;7
12268;Užupiukas;SPINDULIUKŲ;3958071677;Ne;9;1;2;12
12269;Užupiukas;SPINDULIUKŲ;3231001225;Taip;0;1;3;4
12270;Užupiukas;SPINDULIUKŲ;5406866873;Taip;0;1;3;4
12271;Užupiukas;ŽVIRBLIUKŲ;8519118225;Taip;0;3;0;3
12272;Užupiukas;ŽVIRBLIUKŲ;7549628277;Taip;0;3;0;3
12273;Užupiukas;ŽVIRBLIUKŲ;5085660507;Taip;6;3;0;9
12274;Užupiukas;ŽVIRBLIUKŲ;2273766308;Taip;11;2;0;13
12275;Užupiukas;ŽVIRBLIUKŲ;7530856195;Taip;3;1;0;4
12276;Užupiukas;ŽVIRBLIUKŲ;9925592494;Taip;0;0;2;2
12277;Užupiukas;ŽVIRBLIUKŲ;7345579721;Taip;1;1;0;2
12278;Užupiukas;ŽVIRBLIUKŲ;4710910251;Taip;0;2;2;4
12279;Užupiukas;ŽVIRBLIUKŲ;9428884149;Taip;6;0;0;6
12280;Užupiukas;ŽVIRBLIUKŲ;4054724625;Taip;13;1;0;14
12281;Užupiukas;ŽVIRBLIUKŲ;2210437775;Taip;0;1;0;1
12282;Užupiukas;ŽVIRBLIUKŲ;1995228207;Taip;1;0;0;1
12283;Užupiukas;ŽVIRBLIUKŲ;1496541880;Taip;5;6;9;20
12284;Užupiukas;ŽVIRBLIUKŲ;1684901495;Taip;1;0;0;1
12285;Užupiukas;ŽVIRBLIUKŲ;2390955083;Taip;0;1;0;1
12286;Užupiukas;ŽVIRBLIUKŲ;6001766518;Taip;3;0;1;4
12287;Užupiukas;ŽVIRBLIUKŲ;3768945773;Taip;6;0;0;6
12288;Užupiukas;ŽVIRBLIUKŲ;1843171673;Taip;1;0;0;1
12289;Užupiukas;ŽVIRBLIUKŲ;4785494419;Ne;16;1;0;17
12290;Užupiukas;ŽVIRBLIUKŲ;8119142600;Taip;8;0;1;9
12291;Užupiukas;PELĖDŽIUKŲ;2938276316;Taip;0;1;0;1
12292;Užupiukas;PELĖDŽIUKŲ;5320544400;Taip;0;0;2;2
12293;Užupiukas;PELĖDŽIUKŲ;40704768956;Taip;0;1;1;2
12294;Užupiukas;PELĖDŽIUKŲ;5665323444;Ne;5;1;9;15
12295;Užupiukas;PELĖDŽIUKŲ;4880828482;Taip;0;1;6;7
12296;Užupiukas;PELĖDŽIUKŲ;6478702476;Taip;0;1;3;4
12297;Užupiukas;PELĖDŽIUKŲ;6110869303;Taip;0;1;0;1
12298;Užupiukas;PELĖDŽIUKŲ;3205769002;Taip;0;3;0;3
12299;Užupiukas;PELĖDŽIUKŲ;79442829922;Taip;0;1;0;1
12300;Užupiukas;PELĖDŽIUKŲ;4247280316;Taip;0;1;0;1
12301;Užupiukas;PELĖDŽIUKŲ;4608233152;Taip;0;1;0;1
12302;Užupiukas;PELĖDŽIUKŲ;5498369850;Taip;0;1;2;3
12303;Užupiukas;PELĖDŽIUKŲ;2821350355;Taip;0;1;4;5
12304;Užupiukas;PELĖDŽIUKŲ;3309195572;Taip;5;1;4;10
12305;Užupiukas;PELĖDŽIUKŲ;4132760111;Ne;0;2;0;2
12306;Užupiukas;PELĖDŽIUKŲ;22401995674;Taip;0;1;0;1
12307;Užupiukas;PELĖDŽIUKŲ;53412835151;Taip;0;1;0;1
12308;Užupiukas;PELĖDŽIUKŲ;6236652118;Taip;0;0;1;1
12309;Užupiukas;PELĖDŽIUKŲ;3774364829;Taip;0;1;1;2
12310;Užupiukas;PELĖDŽIUKŲ;9197242545;Taip;0;1;3;4
12311;Užupiukas;PELĖDŽIUKŲ;5357731534;Ne;0;1;0;1
12312;Užupiukas;PELĖDŽIUKŲ;5046355276;Taip;5;1;1;7
12313;Užupiukas;PELĖDŽIUKŲ;1091861376;Taip;2;1;1;4
12314;Užupiukas;VARPELIŲ;7107441792;Taip;11;0;1;12
12315;Užupiukas;VARPELIŲ;8881187663;Taip;6;0;1;7
12316;Užupiukas;VARPELIŲ;8518137669;Taip;2;3;0;5
12317;Užupiukas;VARPELIŲ;7919242126;Taip;0;0;1;1
12318;Užupiukas;VARPELIŲ;9310238442;Taip;5;0;2;7
12319;Užupiukas;VARPELIŲ;2769924857;Taip;12;0;0;12
12320;Užupiukas;VARPELIŲ;6538402680;Ne;12;0;2;14
12321;Užupiukas;VARPELIŲ;5941280824;Taip;0;0;10;10
12322;Užupiukas;VARPELIŲ;7105857162;Taip;11;0;1;12
12323;Užupiukas;VARPELIŲ;2485426055;Taip;14;0;2;16
12324;Užupiukas;VARPELIŲ;7314085267;Taip;8;0;0;8
12325;Užupiukas;VARPELIŲ;2752139377;Taip;0;0;1;1
12326;Užupiukas;VARPELIŲ;4106614478;Taip;6;1;2;9
12327;Užupiukas;VARPELIŲ;1407429980;Taip;0;0;2;2
12328;Užupiukas;VARPELIŲ;4811619739;Taip;8;0;2;10
12329;Užupiukas;VARPELIŲ;1037307190;Taip;0;0;21;21
12330;Užupiukas;VARPELIŲ;2767523129;Taip;0;0;2;2
12331;Užupiukas;VARPELIŲ;9523512906;Taip;17;0;0;17
12332;Užupiukas;VARPELIŲ;2506094889;Taip;0;0;1;1
12333;Užupiukas;VARPELIŲ;3745080560;Ne;0;0;2;2
12334;Užupiukas;VARPELIŲ;9815421737;Taip;0;0;2;2
12335;Užupiukas;SAULUČIŲ;5704945892;Taip;0;1;0;1
12336;Užupiukas;SAULUČIŲ;2681679016;Taip;0;0;2;2
12337;Užupiukas;SAULUČIŲ;3684774901;Ne;0;1;0;1
12338;Užupiukas;SAULUČIŲ;8163092636;Taip;0;0;8;8
12339;Užupiukas;SAULUČIŲ;1976775494;Ne;6;0;3;9
12340;Užupiukas;SAULUČIŲ;5874450724;Taip;0;0;1;1
12341;Užupiukas;SAULUČIŲ;3341292382;Taip;10;0;2;12
12342;Užupiukas;SAULUČIŲ;2211595125;Taip;6;0;0;6
12343;Užupiukas;SAULUČIŲ;7450368045;Taip;0;1;7;8
12344;Užupiukas;SAULUČIŲ;5570569874;Taip;0;0;3;3
12345;Užupiukas;SAULUČIŲ;7643286183;Ne;0;0;2;2
12346;Užupiukas;SAULUČIŲ;2814556305;Taip;3;0;1;4
12347;Užupiukas;SAULUČIŲ;7209853233;Taip;0;0;1;1
12348;Užupiukas;SAULUČIŲ;9953994943;Taip;16;0;0;16
12349;Užupiukas;SAULUČIŲ;7956550754;Ne;7;0;3;10
12350;Užupiukas;SAULUČIŲ;5469735455;Taip;0;1;2;3
12351;Užupiukas;SAULUČIŲ;8489545569;Taip;1;0;4;5
12352;Užupiukas;SAULUČIŲ;7990479988;Taip;0;0;5;5
12353;Užupiukas;SAULUČIŲ;4691413468;Taip;5;0;6;11
12354;Užupiukas;SAULUČIŲ;7423292334;Taip;4;8;0;12
12355;Užupiukas;SAULUČIŲ;9216626936;Taip;3;1;1;5
12356;Užupiukas;SAULUČIŲ;9962455415;Taip;6;0;0;6
12357;Užupiukas;LAPIUKŲ;9833934299;Taip;0;8;0;8
12358;Užupiukas;LAPIUKŲ;4963679583;Taip;5;0;1;6
12359;Užupiukas;LAPIUKŲ;1718048938;Taip;4;1;0;5
12360;Užupiukas;LAPIUKŲ;7986962850;Taip;0;1;0;1
12361;Užupiukas;LAPIUKŲ;2517606394;Taip;0;10;1;11
12362;Užupiukas;LAPIUKŲ;7487174943;Taip;0;1;0;1
12363;Užupiukas;LAPIUKŲ;5965564175;Ne;0;2;0;2
12364;Užupiukas;LAPIUKŲ;5680350014;Taip;0;1;1;2
12365;Užupiukas;LAPIUKŲ;7161001771;Taip;3;1;7;11
12366;Užupiukas;LAPIUKŲ;1886792898;Taip;0;1;0;1
12367;Užupiukas;LAPIUKŲ;6967184410;Taip;0;1;1;2
12368;Užupiukas;LAPIUKŲ;1178152392;Taip;0;3;0;3
12369;Užupiukas;LAPIUKŲ;3311694266;Taip;0;2;0;2
12370;Užupiukas;LAPIUKŲ;1041972540;Taip;0;1;0;1
12371;Užupiukas;LAPIUKŲ;4467470795;Taip;0;1;0;1
12372;Užupiukas;LAPIUKŲ;8252575784;Taip;0;1;0;1
12373;Užupiukas;LAPIUKŲ;3333547785;Taip;6;1;1;8
12374;Užupiukas;LAPIUKŲ;8529259340;Taip;2;1;0;3
12375;Užupiukas;NYKŠTUKŲ;4895744524;Taip;16;0;0;16
12376;Užupiukas;NYKŠTUKŲ;3811750547;Taip;16;0;0;16
12377;Užupiukas;NYKŠTUKŲ;2158976125;Taip;16;0;0;16
12378;Užupiukas;NYKŠTUKŲ;6857321547;Taip;21;0;0;21
12379;Užupiukas;NYKŠTUKŲ;5381329362;Ne;5;0;2;7
12380;Užupiukas;NYKŠTUKŲ;6206118484;Taip;5;0;0;5
12381;Užupiukas;NYKŠTUKŲ;4841475687;Taip;3;0;0;3
12382;Užupiukas;NYKŠTUKŲ;1399112659;Taip;5;0;15;20
12383;Užupiukas;NYKŠTUKŲ;4379182756;Taip;4;0;0;4
12384;Užupiukas;NYKŠTUKŲ;9785674147;Taip;4;0;0;4
12385;Užupiukas;NYKŠTUKŲ;3094320206;Taip;6;0;0;6
12386;Užupiukas;NYKŠTUKŲ;9714322911;Taip;6;0;2;8
12387;Užupiukas;NYKŠTUKŲ;3014087333;Taip;4;0;2;6
12388;Užupiukas;NYKŠTUKŲ;7589905741;Taip;9;0;0;9
12389;Užupiukas;NYKŠTUKŲ;1891855020;Taip;0;0;2;2
12390;Užupiukas;NYKŠTUKŲ;1473606331;Taip;9;0;2;11
12391;Užupiukas;NYKŠTUKŲ;4570457987;Taip;10;0;3;13
12392;Užupiukas;NYKŠTUKŲ;9312234251;Taip;2;0;0;2
12393;Vaidilutė;Žiogelis;7779630805;Taip;0;0;1;1
12394;Vaidilutė;Žiogelis;9876388990;Taip;17;0;1;18
12395;Vaidilutė;Žiogelis;3990013866;Taip;0;0;1;1
12396;Vaidilutė;Žiogelis;45949026707;Taip;6;2;0;8
12397;Vaidilutė;Žiogelis;1853463568;Taip;0;1;0;1
12398;Vaidilutė;Žiogelis;5620009051;Taip;0;1;0;1
12399;Vaidilutė;Žiogelis;16491592864;Taip;0;1;0;1
12400;Vaidilutė;Žiogelis;5203062837;Taip;7;1;0;8
12401;Vaidilutė;Žiogelis;3112025222;Taip;7;0;1;8
12402;Vaidilutė;Žiogelis;4334934114;Taip;5;1;0;6
12403;Vaidilutė;Žiogelis;7843388119;Taip;0;1;0;1
12404;Vaidilutė;Žiogelis;2041126370;Taip;0;0;1;1
12405;Vaidilutė;Žiogelis;3152118407;Taip;0;0;1;1
12406;Vaidilutė;Žiogelis;5991149222;Taip;0;5;0;5
12407;Vaidilutė;Žiogelis;1786022030;Taip;1;1;0;2
12408;Vaidilutė;Žiogelis;1266927367;Taip;0;1;0;1
12409;Vaidilutė;Žiogelis;1430802591;Taip;0;1;2;3
12410;Vaidilutė;Žiogelis;4259585225;Taip;0;1;0;1
12411;Vaidilutė;Žiogelis;9556632708;Taip;0;1;0;1
12412;Vaidilutė;Žiogelis;1769926207;Taip;0;1;2;3
12413;Vaidilutė;Rūtelė;2131127298;Taip;0;1;0;1
12414;Vaidilutė;Rūtelė;8789527552;Taip;0;1;1;2
12415;Vaidilutė;Rūtelė;7319037375;Taip;0;0;1;1
12416;Vaidilutė;Rūtelė;4838951446;Taip;0;1;0;1
12417;Vaidilutė;Rūtelė;7494818866;Ne;0;1;0;1
12418;Vaidilutė;Rūtelė;5500950179;Taip;5;0;1;6
12419;Vaidilutė;Rūtelė;1140011879;Taip;0;1;3;4
12420;Vaidilutė;Rūtelė;9563257771;Taip;0;1;0;1
12421;Vaidilutė;Rūtelė;9652684068;Taip;5;0;4;9
12422;Vaidilutė;Rūtelė;2024078532;Taip;0;0;1;1
12423;Vaidilutė;Rūtelė;5482030284;Taip;0;1;1;2
12424;Vaidilutė;Rūtelė;8505156287;Taip;12;0;1;13
12425;Vaidilutė;Rūtelė;7532115462;Taip;3;0;1;4
12426;Vaidilutė;Rūtelė;6896047075;Taip;0;0;2;2
12427;Vaidilutė;Rūtelė;3059654988;Taip;0;0;2;2
12428;Vaidilutė;Rūtelė;1341696594;Taip;1;0;0;1
12429;Vaidilutė;Rūtelė;1141947715;Taip;2;1;1;4
12430;Vaidilutė;Rūtelė;9437865610;Taip;0;1;1;2
12431;Vaidilutė;Rūtelė;2014160468;Ne;0;0;1;1
12432;Vaidilutė;Voveraitė;3248203941;Taip;0;0;3;3
12433;Vaidilutė;Voveraitė;1608646909;Taip;11;0;0;11
12434;Vaidilutė;Voveraitė;9429544108;Ne;0;0;2;2
12435;Vaidilutė;Voveraitė;5652381296;Taip;3;0;0;3
12436;Vaidilutė;Voveraitė;8377824920;Taip;0;11;0;11
12437;Vaidilutė;Voveraitė;5296146822;Taip;0;0;2;2
12438;Vaidilutė;Voveraitė;3299081380;Taip;11;0;0;11
12439;Vaidilutė;Voveraitė;3634285869;Taip;14;0;4;18
12440;Vaidilutė;Voveraitė;7703578508;Taip;13;0;0;13
12441;Vaidilutė;Voveraitė;3150642420;Taip;7;0;1;8
12442;Vaidilutė;Voveraitė;5855762068;Taip;0;0;4;4
12443;Vaidilutė;Voveraitė;8177787790;Taip;0;0;2;2
12444;Vaidilutė;Voveraitė;7327131165;Taip;10;1;4;15
12445;Vaidilutė;Voveraitė;2318578603;Taip;0;6;7;13
12446;Vaidilutė;Voveraitė;9372280434;Taip;0;0;2;2
12447;Vaidilutė;Voveraitė;1372767364;Ne;4;0;2;6
12448;Vaidilutė;Voveraitė;7478943531;Taip;0;1;0;1
12449;Vaidilutė;Voveraitė;4738318120;Taip;17;4;0;21
12450;Vaidilutė;Voveraitė;3319615121;Taip;9;0;0;9
12451;Vaidilutė;Voveraitė;6299324271;Ne;8;0;1;9
12452;Vaidilutė;Voveraitė;4186708502;Ne;10;0;0;10
12453;Vaidilutė;Voveraitė;2855672500;Ne;12;3;0;15
12454;Vaidilutė;Voveraitė;8053548602;Taip;0;0;21;21
12455;Vaidilutė;Saulutė;8492055287;Taip;6;0;2;8
12456;Vaidilutė;Saulutė;6844372910;Taip;0;1;4;5
12457;Vaidilutė;Saulutė;4972645715;Taip;0;15;3;18
12458;Vaidilutė;Saulutė;1355005114;Taip;5;0;0;5
12459;Vaidilutė;Saulutė;4680645841;Taip;0;9;0;9
12460;Vaidilutė;Saulutė;2662468804;Taip;3;0;1;4
12461;Vaidilutė;Saulutė;5217609332;Taip;0;2;1;3
12462;Vaidilutė;Saulutė;2864731541;Taip;11;0;0;11
12463;Vaidilutė;Saulutė;1998872078;Taip;7;0;1;8
12464;Vaidilutė;Saulutė;2468220275;Taip;0;1;1;2
12465;Vaidilutė;Saulutė;1610262589;Taip;0;0;3;3
12466;Vaidilutė;Saulutė;2356037175;Taip;0;1;3;4
12467;Vaidilutė;Saulutė;5054640268;Taip;0;1;3;4
12468;Vaidilutė;Saulutė;6885473308;Taip;1;11;0;12
12469;Vaidilutė;Saulutė;7826111890;Taip;2;1;0;3
12470;Vaidilutė;Saulutė;9870763434;Taip;3;0;1;4
12471;Vaidilutė;Saulutė;5945744595;Ne;7;1;0;8
12472;Vaidilutė;Saulutė;6674238265;Taip;0;1;4;5
12473;Vaidilutė;Saulutė;1092821241;Taip;4;1;0;5
12474;Vaidilutė;Saulutė;2294802783;Taip;15;3;0;18
12475;Vaidilutė;Žibutė;5668493994;Taip;3;0;1;4
12476;Vaidilutė;Žibutė;4085959509;Taip;4;2;0;6
12477;Vaidilutė;Žibutė;1001320466;Taip;8;0;1;9
12478;Vaidilutė;Žibutė;9189713003;Taip;4;0;1;5
12479;Vaidilutė;Žibutė;7903242996;Taip;4;0;6;10
12480;Vaidilutė;Žibutė;7400197367;Taip;0;1;0;1
12481;Vaidilutė;Žibutė;5236154349;Taip;4;0;2;6
12482;Vaidilutė;Žibutė;3980894528;Ne;18;0;0;18
12483;Vaidilutė;Žibutė;1362256314;Taip;0;6;0;6
12484;Vaidilutė;Žibutė;7940581813;Taip;5;0;1;6
12485;Vaidilutė;Žibutė;2767482145;Taip;0;0;1;1
12486;Vaidilutė;Žibutė;7765298370;Taip;0;0;2;2
12487;Vaidilutė;Žibutė;8769601956;Taip;0;0;3;3
12488;Vaidilutė;Žibutė;1726638921;Taip;0;0;2;2
12489;Vaidilutė;Žibutė;5415279154;Taip;3;1;1;5
12490;Vaidilutė;Žibutė;1377015807;Taip;0;1;1;2
12491;Vaidilutė;Žibutė;4124217264;Taip;0;0;3;3
12492;Vaidilutė;Žibutė;7429825620;Taip;3;0;1;4
12493;Vaidilutė;Žibutė;3087959868;Taip;10;0;0;10
12494;Vaidilutė;Žibutė;7690470762;Taip;14;1;0;15
12495;Vaidilutė;"Ąžuoliukas ";3463112472;Taip;0;0;3;3
12496;Vaidilutė;"Ąžuoliukas ";3730573432;Taip;13;0;2;15
12497;Vaidilutė;"Ąžuoliukas ";6586072228;Taip;0;3;0;3
12498;Vaidilutė;"Ąžuoliukas ";5988376676;Taip;0;0;1;1
12499;Vaidilutė;"Ąžuoliukas ";1305478052;Taip;0;0;1;1
12500;Vaidilutė;"Ąžuoliukas ";4954285515;Ne;0;1;0;1
12501;Vaidilutė;"Ąžuoliukas ";5556351358;Taip;0;1;0;1
12502;Vaidilutė;"Ąžuoliukas ";5439973183;Taip;11;0;0;11
12503;Vaidilutė;"Ąžuoliukas ";4761992071;Taip;3;0;3;6
12504;Vaidilutė;"Ąžuoliukas ";3381544575;Taip;1;0;1;2
12505;Vaidilutė;"Ąžuoliukas ";5307486959;Taip;0;1;3;4
12506;Vaidilutė;"Ąžuoliukas ";1653497170;Taip;0;1;3;4
12507;Vaidilutė;"Ąžuoliukas ";1440819171;Ne;5;1;0;6
12508;Vaidilutė;"Ąžuoliukas ";2668758195;Taip;0;1;0;1
12509;Vaidilutė;"Ąžuoliukas ";4901387311;Taip;0;1;2;3
12510;Vaidilutė;"Ąžuoliukas ";9811981645;Taip;0;1;0;1
12511;Vaidilutė;"Ąžuoliukas ";2997948252;Taip;8;0;2;10
12512;Vaidilutė;"Ąžuoliukas ";9723156071;Taip;0;0;3;3
12513;Vaidilutė;"Ąžuoliukas ";4193108560;Ne;5;0;1;6
12514;Vaidilutė;"Ąžuoliukas ";3782651091;Taip;0;0;4;4
12515;Vaidilutė;"Ąžuoliukas ";6637224510;Taip;0;0;3;3
12516;Vaidilutė;"Ąžuoliukas ";6067801976;Taip;0;0;2;2
12517;Vaidilutė;"Žemuogėlė ";1993403692;Taip;0;1;3;4
12518;Vaidilutė;"Žemuogėlė ";42503303158;Taip;0;2;0;2
12519;Vaidilutė;"Žemuogėlė ";9869134464;Taip;2;0;0;2
12520;Vaidilutė;"Žemuogėlė ";29153363263;Taip;11;0;1;12
12521;Vaidilutė;"Žemuogėlė ";3069613102;Taip;0;1;0;1
12522;Vaidilutė;"Žemuogėlė ";1297817018;Taip;2;0;1;3
12523;Vaidilutė;"Žemuogėlė ";5177060346;Taip;0;2;0;2
12524;Vaidilutė;"Žemuogėlė ";4671287016;Taip;17;0;0;17
12525;Vaidilutė;"Žemuogėlė ";9124975928;Taip;0;3;0;3
12526;Vaidilutė;"Žemuogėlė ";7419525100;Taip;0;1;0;1
12527;Vaidilutė;"Žemuogėlė ";1363913645;Taip;0;1;0;1
12528;Vaidilutė;"Žemuogėlė ";5252637701;Taip;0;1;0;1
12529;Vaidilutė;"Žemuogėlė ";3202508790;Taip;0;1;3;4
12530;Vaidilutė;"Žemuogėlė ";1320999237;Taip;0;1;4;5
12531;Vaidilutė;"Žemuogėlė ";9769645272;Taip;0;1;1;2
12532;Vaidilutė;"Žemuogėlė ";1691407801;Taip;0;1;0;1
12533;Vaidilutė;"Žemuogėlė ";1315347184;Taip;0;1;0;1
12534;Vaidilutė;"Žemuogėlė ";1704155743;Taip;0;1;1;2
12535;Vaidilutė;"Žemuogėlė ";5276088687;Taip;2;1;0;3
12536;Vaidilutė;"Žemuogėlė ";1477508451;Taip;0;1;1;2
12537;Vaidilutė;"Vyturėlis ";3121914268;Taip;0;0;1;1
12538;Vaidilutė;"Vyturėlis ";5050251048;Taip;5;11;0;16
12539;Vaidilutė;"Vyturėlis ";7106410219;Taip;0;0;1;1
12540;Vaidilutė;"Vyturėlis ";9558983004;Taip;5;0;6;11
12541;Vaidilutė;"Vyturėlis ";5326935037;Taip;14;0;0;14
12542;Vaidilutė;"Vyturėlis ";2189753894;Taip;0;5;0;5
12543;Vaidilutė;"Vyturėlis ";9689388330;Taip;0;0;1;1
12544;Vaidilutė;"Vyturėlis ";9584702487;Taip;0;1;0;1
12545;Vaidilutė;"Vyturėlis ";2081959307;Taip;0;1;0;1
12546;Vaidilutė;"Vyturėlis ";8882402632;Taip;0;1;3;4
12547;Vaidilutė;"Vyturėlis ";1539700521;Taip;1;1;0;2
12548;Vaidilutė;"Vyturėlis ";4230076320;Taip;0;1;0;1
12549;Vaidilutė;"Vyturėlis ";8628545847;Taip;0;0;1;1
12550;Vaidilutė;"Vyturėlis ";2058071219;Taip;0;1;4;5
12551;Vaidilutė;"Vyturėlis ";4388069915;Taip;0;0;1;1
12552;Vaidilutė;"Vyturėlis ";1401180999;Taip;0;0;1;1
12553;Vaidilutė;"Vyturėlis ";1417828163;Taip;0;1;0;1
12554;Vaidilutė;"Vyturėlis ";5651628204;Ne;0;4;0;4
12555;Vaidilutė;"Vyturėlis ";2251608691;Taip;4;0;1;5
12556;Vaidilutė;"Vyturėlis ";7914006128;Taip;5;0;1;6
12557;Vaidilutė;"Vyturėlis ";2194984060;Taip;0;0;2;2
12558;Vaidilutė;"Vyturėlis ";3351968717;Ne;0;6;0;6
12559;Vaidilutė;"Varpelis ";6250831269;Taip;0;1;0;1
12560;Vaidilutė;"Varpelis ";2763266518;Taip;0;1;0;1
12561;Vaidilutė;"Varpelis ";6037349527;Taip;0;1;5;6
12562;Vaidilutė;"Varpelis ";5867501558;Taip;0;1;0;1
12563;Vaidilutė;"Varpelis ";3832349858;Taip;0;6;0;6
12564;Vaidilutė;"Varpelis ";9317774960;Taip;0;0;1;1
12565;Vaidilutė;"Varpelis ";5448014291;Taip;4;1;0;5
12566;Vaidilutė;"Varpelis ";3497795848;Taip;0;3;2;5
12567;Vaidilutė;"Varpelis ";6022130248;Taip;0;0;8;8
12568;Vaidilutė;"Varpelis ";5101104226;Taip;0;0;1;1
12569;Vaidilutė;"Varpelis ";5594121340;Taip;0;0;2;2
12570;Vaidilutė;"Varpelis ";1882829340;Taip;5;6;0;11
12571;Vaidilutė;"Varpelis ";3353827105;Ne;6;0;6;12
12572;Vaidilutė;"Varpelis ";4362797606;Taip;0;1;0;1
12573;Vaidilutė;"Varpelis ";6322986820;Taip;0;0;3;3
12574;Vaidilutė;"Varpelis ";2941550026;Taip;3;4;2;9
12575;Vaidilutė;"Boružėlių ";6928815317;Taip;15;0;0;15
12576;Vaidilutė;"Boružėlių ";4805621473;Taip;0;1;0;1
12577;Vaidilutė;"Boružėlių ";4348206726;Taip;3;0;0;3
12578;Vaidilutė;"Boružėlių ";1283676263;Taip;11;0;7;18
12579;Vaidilutė;"Boružėlių ";8629789128;Taip;2;0;0;2
12580;Vaidilutė;"Boružėlių ";8012451263;Taip;21;0;0;21
12581;Vaidilutė;"Boružėlių ";4760330697;Taip;0;21;0;21
12582;Vaidilutė;"Boružėlių ";5095161432;Taip;5;0;1;6
12583;Vaidilutė;"Malūnelis ";4887753072;Taip;0;5;0;5
12584;Vaidilutė;"Malūnelis ";7726116370;Taip;0;0;2;2
12585;Vaidilutė;"Malūnelis ";2876157676;Taip;4;0;0;4
12586;Vaidilutė;"Malūnelis ";6965297550;Taip;0;1;7;8
12587;Vaidilutė;"Malūnelis ";8444010416;Taip;0;1;10;11
12588;Vaidilutė;"Malūnelis ";4568108299;Taip;8;0;0;8
12589;Vaidilutė;"Malūnelis ";1998966302;Taip;0;0;2;2
12590;Vaidilutė;"Malūnelis ";5026620305;Taip;7;1;0;8
12591;Vaidilutė;"Malūnelis ";3826303389;Taip;2;0;2;4
12592;Vaidilutė;"Malūnelis ";4469754560;Taip;5;0;0;5
12593;Vaidilutė;"Malūnelis ";8433116520;Taip;10;0;2;12
12594;Vaidilutė;"Malūnelis ";5918039529;Taip;14;0;0;14
12595;Vaidilutė;"Malūnelis ";3850868701;Taip;0;1;0;1
12596;Vaidilutė;"Malūnelis ";7660273021;Taip;0;3;0;3
12597;Vaidilutė;"Riešutėlis ";1161455376;Taip;5;0;2;7
12598;Vaidilutė;"Riešutėlis ";4518002596;Ne;8;0;1;9
12599;Vaidilutė;"Riešutėlis ";4657952465;Ne;0;0;4;4
12600;Vaidilutė;"Riešutėlis ";8756807918;Taip;0;0;6;6
12601;Vaidilutė;"Riešutėlis ";9782176726;Taip;0;0;3;3
12602;Vaidilutė;"Riešutėlis ";1206696843;Taip;0;1;4;5
12603;Vaidilutė;"Riešutėlis ";9872915544;Taip;0;5;0;5
12604;Vaidilutė;"Riešutėlis ";2976615414;Taip;6;0;5;11
12605;Vaidilutė;"Riešutėlis ";4709977896;Taip;0;1;0;1
12606;Vaidilutė;"Riešutėlis ";2409760986;Taip;0;0;4;4
12607;Vaidilutė;"Riešutėlis ";4051575845;Taip;0;0;3;3
12608;Vaidilutė;"Riešutėlis ";9025469107;Taip;0;0;2;2
12609;Vaidilutė;"Riešutėlis ";3862444839;Taip;11;0;0;11
12610;Vaidilutė;"Riešutėlis ";9567786222;Taip;0;0;1;1
12611;Vaidilutė;"Riešutėlis ";3321127541;Taip;0;0;1;1
12612;Vaidilutė;"Riešutėlis ";7713772984;Taip;0;0;21;21
12613;Vaidilutė;"Riešutėlis ";3064988592;Taip;8;0;3;11
12614;Vaidilutė;"Riešutėlis ";8296567629;Taip;0;0;3;3
12615;Vaidilutė;"Riešutėlis ";7871629009;Taip;0;0;1;1
12616;Vandenis;ŽUVĖDRŲ;5362078687;Taip;0;4;0;4
12617;Vandenis;ŽUVĖDRŲ;6784010746;Ne;5;2;2;9
12618;Vandenis;ŽUVĖDRŲ;2238926097;Taip;0;1;0;1
12619;Vandenis;ŽUVĖDRŲ;9334958945;Taip;6;0;0;6
12620;Vandenis;ŽUVĖDRŲ;7447487403;Taip;5;3;0;8
12621;Vandenis;ŽUVĖDRŲ;7646133208;Taip;13;1;0;14
12622;Vandenis;ŽUVĖDRŲ;4303303483;Taip;4;3;0;7
12623;Vandenis;ŽUVĖDRŲ;2325465812;Taip;5;2;0;7
12624;Vandenis;ŽUVĖDRŲ;2649542586;Taip;10;5;0;15
12625;Vandenis;ŽUVĖDRŲ;7948161881;Taip;4;1;0;5
12626;Vandenis;ŽUVĖDRŲ;9335319713;Taip;7;3;0;10
12627;Vandenis;ŽUVĖDRŲ;6068154206;Taip;0;10;0;10
12628;Vandenis;ŽUVĖDRŲ;7296608892;Taip;5;3;0;8
12629;Vandenis;ŽUVĖDRŲ;4117091634;Taip;0;1;0;1
12630;Vandenis;ŽUVĖDRŲ;2276497021;Taip;0;1;0;1
12631;Vandenis;ŽUVĖDRŲ;6063181697;Taip;0;2;0;2
12632;Vandenis;ŽUVĖDRŲ;6661117114;Taip;2;3;0;5
12633;Vandenis;ŽUVĖDRŲ;6456557095;Taip;14;1;0;15
12634;Vandenis;ŽUVĖDRŲ;3342147138;Taip;12;5;0;17
12635;Vandenis;ŽUVĖDRŲ;5112768778;Ne;0;18;0;18
12636;Vandenis;RUONIUKŲ;2422642232;Taip;5;8;0;13
12637;Vandenis;RUONIUKŲ;1051281257;Taip;5;8;0;13
12638;Vandenis;RUONIUKŲ;7565308536;Taip;0;4;0;4
12639;Vandenis;RUONIUKŲ;1120907086;Taip;0;4;0;4
12640;Vandenis;RUONIUKŲ;1563710105;Taip;0;1;1;2
12641;Vandenis;RUONIUKŲ;7702272913;Ne;3;0;3;6
12642;Vandenis;RUONIUKŲ;6476051751;Taip;0;9;0;9
12643;Vandenis;RUONIUKŲ;9162936403;Taip;0;2;0;2
12644;Vandenis;RUONIUKŲ;4713395766;Taip;2;4;0;6
12645;Vandenis;RUONIUKŲ;6986724058;Taip;0;4;0;4
12646;Vandenis;RUONIUKŲ;7754158588;Taip;0;0;1;1
12647;Vandenis;RUONIUKŲ;9731729915;Taip;2;1;0;3
12648;Vandenis;RUONIUKŲ;9527253920;Taip;5;1;0;6
12649;Vandenis;RUONIUKŲ;8971291182;Taip;12;0;1;13
12650;Vandenis;RUONIUKŲ;6330187732;Taip;10;5;0;15
12651;Vandenis;RUONIUKŲ;9688954631;Taip;0;11;0;11
12652;Vandenis;RUONIUKŲ;8729351613;Ne;0;1;0;1
12653;Vandenis;RUONIUKŲ;4971165639;Taip;4;1;0;5
12654;Vandenis;RUONIUKŲ;6158299885;Taip;0;1;2;3
12655;Vandenis;RUONIUKŲ;3664560833;Taip;0;1;0;1
12656;Vandenis;RUONIUKŲ;5535901447;Taip;0;4;0;4
12657;Vandenis;ŽUVYČIŲ;55421695186;Taip;0;2;0;2
12658;Vandenis;ŽUVYČIŲ;43933878402;Taip;0;1;0;1
12659;Vandenis;ŽUVYČIŲ;9608871155;Taip;0;4;0;4
12660;Vandenis;ŽUVYČIŲ;7381695975;Taip;0;3;0;3
12661;Vandenis;ŽUVYČIŲ;8430706407;Taip;0;1;0;1
12662;Vandenis;ŽUVYČIŲ;8689134931;Taip;0;2;0;2
12663;Vandenis;ŽUVYČIŲ;4085256182;Taip;2;5;0;7
12664;Vandenis;ŽUVYČIŲ;6828175620;Taip;0;2;0;2
12665;Vandenis;ŽUVYČIŲ;1535450614;Taip;0;1;0;1
12666;Vandenis;ŽUVYČIŲ;7408758565;Taip;0;1;0;1
12667;Vandenis;ŽUVYČIŲ;1568158992;Taip;2;1;0;3
12668;Vandenis;ŽUVYČIŲ;1598122777;Taip;0;1;0;1
12669;Vandenis;ŽUVYČIŲ;18336904438;Taip;0;1;0;1
12670;Vandenis;ŽUVYČIŲ;1815765498;Taip;0;4;0;4
12671;Vandenis;ŽUVYČIŲ;5549292096;Taip;0;6;0;6
12672;Vandenis;ŽUVYČIŲ;8705188652;Taip;5;1;0;6
12673;Vandenis;ŽUVYČIŲ;71513217054;Taip;2;0;0;2
12674;Vandenis;ŽUVYČIŲ;24217366528;Taip;0;1;0;1
12675;Vandenis;ŽUVYČIŲ;9994373029;Taip;0;1;0;1
12676;Vandenis;ŽUVYČIŲ;3544717790;Taip;0;1;0;1
12677;Vandenis;ŽUVYČIŲ;4643267945;Ne;0;3;1;4
12678;Vandenis;ŽUVYČIŲ;9518434896;Ne;0;3;1;4
12679;Vandenis;ŽUVYČIŲ;2638433939;Taip;0;1;0;1
12680;Vandenis;PERLIUKŲ;8678508812;Taip;0;2;0;2
12681;Vandenis;PERLIUKŲ;2645775090;Taip;0;11;0;11
12682;Vandenis;PERLIUKŲ;5844576485;Taip;8;1;0;9
12683;Vandenis;PERLIUKŲ;6295009202;Taip;0;3;0;3
12684;Vandenis;PERLIUKŲ;7598257845;Taip;0;4;0;4
12685;Vandenis;PERLIUKŲ;5323428164;Taip;10;1;0;11
12686;Vandenis;PERLIUKŲ;6073002418;Taip;0;1;1;2
12687;Vandenis;PERLIUKŲ;5565147603;Taip;0;1;1;2
12688;Vandenis;PERLIUKŲ;2690536940;Taip;0;1;0;1
12689;Vandenis;PERLIUKŲ;2576575249;Taip;0;1;0;1
12690;Vandenis;PERLIUKŲ;9798192239;Taip;5;2;0;7
12691;Vandenis;PERLIUKŲ;1975385430;Taip;0;9;0;9
12692;Vandenis;PERLIUKŲ;3061606138;Taip;0;1;0;1
12693;Vandenis;PERLIUKŲ;8117385209;Taip;0;2;9;11
12694;Vandenis;PERLIUKŲ;5613067534;Taip;0;6;1;7
12695;Vandenis;PERLIUKŲ;2321919298;Ne;13;0;0;13
12696;Vandenis;PERLIUKŲ;5963181638;Taip;5;2;1;8
12697;Vandenis;PERLIUKŲ;5609737826;Taip;6;0;8;14
12698;Vandenis;PERLIUKŲ;3239754791;Taip;0;5;0;5
12699;Vandenis;PERLIUKŲ;5129492284;Taip;0;2;0;2
12700;Vandenis;ANČIUKŲ;4607196473;Taip;5;1;1;7
12701;Vandenis;ANČIUKŲ;6189862061;Taip;0;2;0;2
12702;Vandenis;ANČIUKŲ;4345021061;Taip;0;2;0;2
12703;Vandenis;ANČIUKŲ;9763300020;Taip;11;3;1;15
12704;Vandenis;ANČIUKŲ;9968877035;Taip;6;1;0;7
12705;Vandenis;ANČIUKŲ;3639160500;Taip;11;0;0;11
12706;Vandenis;ANČIUKŲ;9458613523;Taip;0;2;0;2
12707;Vandenis;ANČIUKŲ;4715198793;Taip;4;0;0;4
12708;Vandenis;ANČIUKŲ;1213743099;Taip;7;1;0;8
12709;Vandenis;ANČIUKŲ;4954121871;Taip;9;1;0;10
12710;Vandenis;ANČIUKŲ;4983424940;Taip;0;1;0;1
12711;Vandenis;ANČIUKŲ;4978712442;Taip;6;1;0;7
12712;Vandenis;ANČIUKŲ;7631982912;Taip;0;3;0;3
12713;Vandenis;ANČIUKŲ;7581114286;Taip;0;3;0;3
12714;Vandenis;ANČIUKŲ;9679010239;Taip;6;1;0;7
12715;Vandenis;ANČIUKŲ;9314410776;Taip;8;3;0;11
12716;Vandenis;ANČIUKŲ;1132534461;Taip;0;2;0;2
12717;Vandenis;ANČIUKŲ;9498231306;Taip;0;1;0;1
12718;Vandenis;ANČIUKŲ;2647966131;Taip;15;0;0;15
12719;Vandenis;ANČIUKŲ;3544764716;Ne;15;2;0;17
12720;Vandenis;ANČIUKŲ;4530824157;Taip;10;0;2;12
12721;Vandenis;VĖŽLIUKŲ;2309166304;Ne;6;2;0;8
12722;Vandenis;VĖŽLIUKŲ;5454049563;Taip;7;2;2;11
12723;Vandenis;VĖŽLIUKŲ;9805578141;Taip;7;2;2;11
12724;Vandenis;VĖŽLIUKŲ;8921666108;Ne;10;2;0;12
12725;Vandenis;VĖŽLIUKŲ;8116532445;Taip;0;4;0;4
12726;Vandenis;VĖŽLIUKŲ;7069369080;Taip;0;5;0;5
12727;Vandenis;VĖŽLIUKŲ;7924399684;Taip;0;3;0;3
12728;Vandenis;VĖŽLIUKŲ;1187395353;Taip;6;6;0;12
12729;Vandenis;VĖŽLIUKŲ;7091356848;Taip;0;7;0;7
12730;Vandenis;VĖŽLIUKŲ;5126732658;Taip;2;3;2;7
12731;Vandenis;VĖŽLIUKŲ;7059385610;Taip;0;7;0;7
12732;Vandenis;VĖŽLIUKŲ;9158541919;Taip;10;1;0;11
12733;Vandenis;VĖŽLIUKŲ;5959181898;Taip;10;1;0;11
12734;Vandenis;VĖŽLIUKŲ;1707354287;Taip;0;2;0;2
12735;Vandenis;VĖŽLIUKŲ;9704394568;Taip;0;3;0;3
12736;Vandenis;VĖŽLIUKŲ;4177166475;Taip;0;5;0;5
12737;Vandenis;VĖŽLIUKŲ;5218101579;Taip;6;5;0;11
12738;Vandenis;VĖŽLIUKŲ;8416839037;Taip;0;2;0;2
12739;Vandenis;VĖŽLIUKŲ;2936885357;Taip;14;0;0;14
12740;Vandenis;VĖŽLIUKŲ;8879608849;Taip;0;10;0;10
12741;Vandenis;AŠTUNKOJŲ;2077783219;Taip;0;3;0;3
12742;Vandenis;AŠTUNKOJŲ;8511948282;Taip;0;2;0;2
12743;Vandenis;AŠTUNKOJŲ;2096950367;Taip;0;1;0;1
12744;Vandenis;AŠTUNKOJŲ;71786730314;Taip;0;1;0;1
12745;Vandenis;AŠTUNKOJŲ;6181866272;Taip;0;4;0;4
12746;Vandenis;AŠTUNKOJŲ;5395847317;Taip;0;3;0;3
12747;Vandenis;AŠTUNKOJŲ;33317650043;Taip;7;1;0;8
12748;Vandenis;AŠTUNKOJŲ;7522472652;Taip;0;2;0;2
12749;Vandenis;AŠTUNKOJŲ;3243079651;Taip;0;1;0;1
12750;Vandenis;AŠTUNKOJŲ;3067868099;Taip;0;1;0;1
12751;Vandenis;AŠTUNKOJŲ;61120985165;Taip;4;11;0;15
12752;Vandenis;AŠTUNKOJŲ;1222539247;Taip;0;1;0;1
12753;Vandenis;AŠTUNKOJŲ;8251169901;Taip;0;4;0;4
12754;Vandenis;AŠTUNKOJŲ;4750141780;Taip;0;8;0;8
12755;Vandenis;AŠTUNKOJŲ;1621481561;Taip;0;2;0;2
12756;Vandenis;AŠTUNKOJŲ;1314724267;Taip;0;4;0;4
12757;Vandenis;AŠTUNKOJŲ;1282499654;Taip;0;3;0;3
12758;Vandenis;AŠTUNKOJŲ;1739780612;Taip;0;12;0;12
12759;Vandenis;AŠTUNKOJŲ;8233407105;Taip;0;3;1;4
12760;Vandenis;AŠTUNKOJŲ;7168910452;Taip;0;2;0;2
12761;Vandenis;AŠTUNKOJŲ;2489776665;Taip;0;1;1;2
12762;Vandenis;AŠTUNKOJŲ;3938359901;Taip;0;1;0;1
12763;Vandenis;AŠTUNKOJŲ;33782837791;Taip;5;1;0;6
12764;Vandenis;AŠTUNKOJŲ;1633589144;Taip;0;1;0;1
12765;Vandenis;GANDRIUKŲ;4753416316;Taip;10;5;1;16
12766;Vandenis;GANDRIUKŲ;8264797886;Taip;0;6;0;6
12767;Vandenis;GANDRIUKŲ;9936940067;Ne;5;0;0;5
12768;Vandenis;GANDRIUKŲ;6153669587;Taip;11;0;0;11
12769;Vandenis;GANDRIUKŲ;6260893699;Taip;5;2;0;7
12770;Vandenis;GANDRIUKŲ;1919577714;Taip;10;1;2;13
12771;Vandenis;GANDRIUKŲ;7019646962;Taip;1;1;1;3
12772;Vandenis;GANDRIUKŲ;2078767085;Taip;7;2;2;11
12773;Vandenis;GANDRIUKŲ;2976505868;Taip;19;0;0;19
12774;Vandenis;GANDRIUKŲ;6558155968;Taip;0;3;1;4
12775;Vandenis;GANDRIUKŲ;6691874473;Taip;0;1;4;5
12776;Vandenis;GANDRIUKŲ;6483030616;Taip;3;4;0;7
12777;Vandenis;GANDRIUKŲ;8144830789;Taip;6;0;0;6
12778;Vandenis;GANDRIUKŲ;2381566229;Taip;8;0;1;9
12779;Vandenis;GANDRIUKŲ;5899846599;Ne;7;0;1;8
12780;Vandenis;GANDRIUKŲ;8127873607;Ne;1;1;0;2
12781;Vandenis;GANDRIUKŲ;1606103904;Taip;6;1;0;7
12782;Vandenis;GANDRIUKŲ;1753180703;Taip;0;1;0;1
12783;Vandenis;GANDRIUKŲ;7303512055;Taip;5;1;1;7
12784;Vandenis;GANDRIUKŲ;3231434944;Ne;0;0;21;21
12785;Vandenis;GANDRIUKŲ;6327478049;Taip;5;0;16;21
12786;Vandenis;GANDRIUKŲ;7311677107;Taip;0;1;0;1
12787;Vandenis;GANDRIUKŲ;6586215199;Taip;0;3;1;4
12788;Vandenis;ŽĄSIUKAI;8034690071;Taip;5;0;3;8
12789;Vandenis;ŽĄSIUKAI;9937317687;Taip;8;3;0;11
12790;Vandenis;ŽĄSIUKAI;2004158593;Taip;0;9;0;9
12791;Vandenis;ŽĄSIUKAI;4984723792;Taip;0;0;8;8
12792;Vandenis;ŽĄSIUKAI;8014569725;Taip;6;0;0;6
12793;Vandenis;ŽĄSIUKAI;1333381525;Ne;0;2;0;2
12794;Vandenis;ŽĄSIUKAI;7071349847;Taip;0;5;0;5
12795;Vandenis;ŽĄSIUKAI;7070234429;Taip;0;2;0;2
12796;Vandenis;ŽĄSIUKAI;4072405890;Taip;5;1;0;6
12797;Vandenis;ŽĄSIUKAI;5684262347;Taip;4;0;0;4
12798;Vandenis;ŽĄSIUKAI;4349464804;Taip;9;0;1;10
12799;Vandenis;ŽĄSIUKAI;7596199296;Taip;0;3;4;7
12800;Vandenis;ŽĄSIUKAI;6876019354;Taip;0;8;0;8
12801;Vandenis;ŽĄSIUKAI;5607412408;Taip;3;3;0;6
12802;Vandenis;ŽĄSIUKAI;1925178245;Taip;0;2;0;2
12803;Vandenis;ŽĄSIUKAI;5641929490;Taip;0;5;0;5
12804;Vandenis;ŽĄSIUKAI;7058441500;Taip;3;1;0;4
12805;Vandenis;ŽĄSIUKAI;1850352131;Taip;11;0;0;11
12806;Vandenis;ŽĄSIUKAI;2454959791;Taip;12;0;0;12
12807;Vandenis;ŽĄSIUKAI;4565893472;Taip;14;1;0;15
12808;Vandenis;ŽĄSIUKAI;1200834211;Taip;1;0;20;21
12809;Vandenis;ŽĄSIUKAI;9801593009;Taip;5;1;0;6
12810;Vandenis;PURIENŲ;6851178154;Taip;1;2;0;3
12811;Vandenis;PURIENŲ;5440027798;Taip;8;1;0;9
12812;Vandenis;PURIENŲ;4455886780;Taip;10;1;0;11
12813;Vandenis;PURIENŲ;4815210197;Taip;0;4;0;4
12814;Vandenis;PURIENŲ;3337286021;Taip;10;1;0;11
12815;Vandenis;PURIENŲ;7020534318;Taip;0;0;3;3
12816;Vandenis;PURIENŲ;6027680514;Taip;10;1;0;11
12817;Vandenis;PURIENŲ;2960005490;Taip;0;11;1;12
12818;Vandenis;PURIENŲ;1180322026;Taip;0;10;1;11
12819;Vandenis;PURIENŲ;3633805607;Taip;0;3;0;3
12820;Vandenis;PURIENŲ;7959438279;Taip;10;2;0;12
12821;Vandenis;PURIENŲ;1788652447;Taip;0;1;0;1
12822;Vandenis;PURIENŲ;6332179750;Taip;10;1;0;11
12823;Vandenis;PURIENŲ;2315167746;Taip;1;0;0;1
12824;Vandenis;PURIENŲ;5540306590;Taip;0;1;1;2
12825;Vandenis;PURIENŲ;7171302906;Taip;6;1;0;7
12826;Vandenis;PURIENŲ;8085633453;Taip;6;1;0;7
12827;Vandenis;PURIENŲ;2614561762;Taip;0;2;0;2
12828;Vandenis;PURIENŲ;1244502945;Taip;5;1;0;6
12829;Vandenis;VARLIUKAI;2661339448;Taip;7;0;3;10
12830;Vandenis;VARLIUKAI;2451901210;Taip;10;1;0;11
12831;Vandenis;VARLIUKAI;1786146371;Taip;0;6;0;6
12832;Vandenis;VARLIUKAI;2506411643;Taip;0;2;1;3
12833;Vandenis;VARLIUKAI;8841954633;Taip;7;2;0;9
12834;Vandenis;VARLIUKAI;7001613448;Taip;7;1;0;8
12835;Vandenis;VARLIUKAI;1983972864;Taip;9;0;6;15
12836;Vandenis;VARLIUKAI;6067408982;Taip;5;1;0;6
12837;Vandenis;VARLIUKAI;8239664149;Taip;11;2;0;13
12838;Vandenis;VARLIUKAI;9380306986;Taip;0;1;0;1
12839;Vandenis;VARLIUKAI;1799139825;Taip;2;0;0;2
12840;Vandenis;VARLIUKAI;3038533882;Taip;20;1;0;21
12841;Vandenis;VARLIUKAI;3173213991;Taip;20;1;0;21
12842;Vandenis;VARLIUKAI;5675840354;Taip;4;1;0;5
12843;Vandenis;VARLIUKAI;6570331247;Taip;5;2;0;7
12844;Vandenis;VARLIUKAI;2883058280;Taip;10;0;0;10
12845;Vandenis;PINGVINAI;9856199548;Taip;12;1;0;13
12846;Vandenis;PINGVINAI;2665865704;Taip;17;0;0;17
12847;Vandenis;PINGVINAI;1780124964;Taip;0;3;0;3
12848;Vandenis;PINGVINAI;9609168578;Taip;0;5;0;5
12849;Vandenis;PINGVINAI;2156775779;Taip;7;1;0;8
12850;Vandenis;PINGVINAI;3360623444;Taip;0;5;0;5
12851;Vandenis;PINGVINAI;5191604973;Taip;5;1;0;6
12852;Vandenis;PINGVINAI;2757376962;Taip;0;2;0;2
12853;Vandenis;PINGVINAI;6992750701;Taip;5;4;0;9
12854;Vandenis;PINGVINAI;6731336385;Taip;1;1;0;2
12855;Vandenis;PINGVINAI;3933306911;Taip;13;1;0;14
12856;Vandenis;PINGVINAI;2534991705;Taip;0;3;1;4
12857;Vandenis;PINGVINAI;4347489809;Taip;1;1;4;6
12858;Vandenis;PINGVINAI;7267965471;Taip;0;0;1;1
12859;Vandenis;PINGVINAI;5632082019;Taip;0;1;0;1
12860;Vandenis;PINGVINAI;9717294497;Taip;0;2;0;2
12861;Vandenis;PINGVINAI;7770227772;Taip;0;16;0;16
12862;Vandenis;PINGVINAI;8560123112;Taip;5;2;0;7
12863;Varpelis;BITUTĖS;1005905322;Taip;0;0;3;3
12864;Varpelis;BITUTĖS;8224083250;Taip;10;6;0;16
12865;Varpelis;BITUTĖS;7639156840;Taip;0;0;2;2
12866;Varpelis;BITUTĖS;7894929066;Ne;0;0;5;5
12867;Varpelis;BITUTĖS;6004580752;Taip;0;0;1;1
12868;Varpelis;BITUTĖS;3225870950;Taip;0;0;2;2
12869;Varpelis;BITUTĖS;2975306188;Taip;0;0;2;2
12870;Varpelis;BITUTĖS;3216171217;Taip;0;0;1;1
12871;Varpelis;BITUTĖS;9795677397;Taip;0;0;14;14
12872;Varpelis;BITUTĖS;9025614369;Taip;0;0;2;2
12873;Varpelis;BITUTĖS;7137400798;Taip;0;0;1;1
12874;Varpelis;BITUTĖS;6272649584;Taip;0;0;2;2
12875;Varpelis;BITUTĖS;7497169351;Taip;5;0;0;5
12876;Varpelis;BITUTĖS;6325113387;Taip;0;9;2;11
12877;Varpelis;BITUTĖS;3557362927;Taip;0;0;9;9
12878;Varpelis;BITUTĖS;5994436441;Taip;0;0;1;1
12879;Varpelis;BITUTĖS;9295853884;Taip;0;0;3;3
12880;Varpelis;BITUTĖS;7462297990;Taip;0;0;1;1
12881;Varpelis;BITUTĖS;4811186406;Taip;0;0;5;5
12882;Varpelis;BITUTĖS;9598844152;Taip;0;0;2;2
12883;Varpelis;BITUTĖS;3315895028;Taip;0;0;1;1
12884;Varpelis;BITUTĖS;9539132116;Taip;16;0;0;16
12885;Vėjelis;Pumpurėliai;2541077369;Ne;1;2;0;3
12886;Vėjelis;Pumpurėliai;3125815427;Taip;9;0;1;10
12887;Vėjelis;Pumpurėliai;5516672613;Taip;1;2;0;3
12888;Vėjelis;Pumpurėliai;2866394056;Taip;5;1;0;6
12889;Vėjelis;Pumpurėliai;1084415930;Taip;8;2;0;10
12890;Vėjelis;Pumpurėliai;9071878406;Taip;9;1;0;10
12891;Vėjelis;Pumpurėliai;3206025676;Taip;1;2;0;3
12892;Vėjelis;Pumpurėliai;1057586168;Ne;19;0;0;19
12893;Vėjelis;Pumpurėliai;9583495324;Taip;1;1;0;2
12894;Vėjelis;Pumpurėliai;7539681314;Taip;6;1;0;7
12895;Vėjelis;Pumpurėliai;3081923183;Taip;0;2;2;4
12896;Vėjelis;Pumpurėliai;9003601108;Taip;0;1;0;1
12897;Vėjelis;Pumpurėliai;6168648640;Taip;0;1;0;1
12898;Vėjelis;Pumpurėliai;1876663813;Taip;3;2;0;5
12899;Vėjelis;Pumpurėliai;6840643273;Ne;17;0;0;17
12900;Vėjelis;Pumpurėliai;9824130744;Ne;0;2;0;2
12901;Vėjelis;Pumpurėliai;1842552329;Taip;1;0;5;6
12902;Vėjelis;Pumpurėliai;9986867356;Taip;0;1;0;1
12903;Vėjelis;Pumpurėliai;8467887788;Taip;6;4;0;10
12904;Vėjelis;Pumpurėliai;9274287800;Ne;0;5;1;6
12905;Vėjelis;Pumpurėliai;5619026707;Taip;0;1;0;1
12906;Vėjelis;Pumpurėliai;8994680698;Taip;6;1;0;7
12907;Vėjelis;Pumpurėliai;2656895893;Taip;6;0;0;6
12908;Vėjelis;Drugeliai;4746932126;Taip;2;2;2;6
12909;Vėjelis;Drugeliai;1978952781;Taip;0;1;0;1
12910;Vėjelis;Drugeliai;8353084814;Taip;0;1;0;1
12911;Vėjelis;Drugeliai;2416832899;Taip;1;0;0;1
12912;Vėjelis;Drugeliai;2734024890;Taip;7;4;0;11
12913;Vėjelis;Drugeliai;7981032872;Taip;0;21;0;21
12914;Vėjelis;Drugeliai;7594586198;Taip;1;0;1;2
12915;Vėjelis;Drugeliai;7697394469;Taip;2;1;4;7
12916;Vėjelis;Drugeliai;4066956765;Taip;0;2;3;5
12917;Vėjelis;Drugeliai;2788205363;Taip;0;3;2;5
12918;Vėjelis;Drugeliai;1331334220;Taip;0;9;2;11
12919;Vėjelis;Drugeliai;2151737048;Taip;7;0;0;7
12920;Vėjelis;Drugeliai;4988352741;Taip;0;0;1;1
12921;Vėjelis;Drugeliai;3982318250;Taip;0;0;1;1
12922;Vėjelis;Drugeliai;4473677352;Taip;0;6;0;6
12923;Vėjelis;Drugeliai;4506243333;Taip;16;0;1;17
12924;Vėjelis;Drugeliai;3524350131;Taip;1;0;1;2
12925;Vėjelis;Drugeliai;6061966626;Taip;0;1;0;1
12926;Vėjelis;Drugeliai;3453119286;Taip;2;0;0;2
12927;Vėjelis;Drugeliai;6891260701;Taip;0;4;0;4
12928;Vėjelis;Malūnėlis;7097474285;Taip;0;1;1;2
12929;Vėjelis;Malūnėlis;1448699738;Taip;0;2;4;6
12930;Vėjelis;Malūnėlis;3275186042;Taip;8;0;0;8
12931;Vėjelis;Malūnėlis;1882750621;Taip;7;0;2;9
12932;Vėjelis;Malūnėlis;5109441799;Taip;4;0;0;4
12933;Vėjelis;Malūnėlis;4171024976;Taip;8;0;1;9
12934;Vėjelis;Malūnėlis;1871467392;Taip;13;0;1;14
12935;Vėjelis;Malūnėlis;1342200813;Taip;0;6;0;6
12936;Vėjelis;Malūnėlis;8221349174;Taip;0;2;0;2
12937;Vėjelis;Malūnėlis;6600504736;Taip;6;0;0;6
12938;Vėjelis;Malūnėlis;8063276082;Taip;0;2;4;6
12939;Vėjelis;Malūnėlis;6244227830;Taip;8;0;1;9
12940;Vėjelis;Malūnėlis;1417987860;Taip;21;0;0;21
12941;Vėjelis;Malūnėlis;9636946669;Taip;14;0;2;16
12942;Vėjelis;Malūnėlis;5066748621;Taip;6;0;0;6
12943;Vėjelis;Malūnėlis;8822873586;Taip;0;0;2;2
12944;Vėjelis;Žvaigždutės;9492690970;Taip;0;2;0;2
12945;Vėjelis;Žvaigždutės;1436893015;Taip;4;0;0;4
12946;Vėjelis;Žvaigždutės;2117924725;Taip;4;0;0;4
12947;Vėjelis;Žvaigždutės;8866974952;Taip;0;0;1;1
12948;Vėjelis;Žvaigždutės;1549518622;Ne;0;8;0;8
12949;Vėjelis;Žvaigždutės;6386092350;Taip;15;5;0;20
12950;Vėjelis;Žvaigždutės;6844704326;Taip;0;1;1;2
12951;Vėjelis;Žvaigždutės;3315240387;Taip;0;13;0;13
12952;Vėjelis;Žvaigždutės;9557135813;Taip;0;0;2;2
12953;Vėjelis;Žvaigždutės;2132551615;Taip;3;0;9;12
12954;Vėjelis;Žvaigždutės;2522750651;Taip;4;0;0;4
12955;Vėjelis;Žvaigždutės;6777528441;Taip;0;1;1;2
12956;Vėjelis;Žvaigždutės;4868574574;Taip;0;1;0;1
12957;Vėjelis;Žvaigždutės;9135807341;Taip;3;1;0;4
12958;Vėjelis;Žvaigždutės;4101161670;Taip;0;1;0;1
12959;Vėjelis;Žvaigždutės;7247057946;Taip;19;0;0;19
12960;Vėjelis;Žvaigždutės;7046938604;Taip;0;2;0;2
12961;Vėjelis;Žvaigždutės;3495322620;Taip;0;5;0;5
12962;Vėjelis;Žvaigždutės;1956418258;Taip;0;9;0;9
12963;Vėjelis;Žvaigždutės;7203026860;Taip;1;1;0;2
12964;Vėjelis;Žvaigždutės;8300497094;Taip;9;1;0;10
12965;Vėjelis;Varpeliai;7274745807;Ne;0;1;5;6
12966;Vėjelis;Varpeliai;5931553549;Taip;0;1;1;2
12967;Vėjelis;Varpeliai;9926991259;Taip;0;1;8;9
12968;Vėjelis;Varpeliai;6608657740;Taip;5;1;3;9
12969;Vėjelis;Varpeliai;2794205377;Taip;5;0;0;5
12970;Vėjelis;Varpeliai;7507448059;Taip;5;3;0;8
12971;Vėjelis;Varpeliai;2363974247;Taip;9;1;0;10
12972;Vėjelis;Varpeliai;8379298947;Taip;9;1;0;10
12973;Vėjelis;Varpeliai;1205392813;Taip;0;9;0;9
12974;Vėjelis;Varpeliai;98588113289;Taip;0;1;0;1
12975;Vėjelis;Varpeliai;5396347620;Taip;0;1;0;1
12976;Vėjelis;Varpeliai;5031781196;Taip;0;1;4;5
12977;Vėjelis;Varpeliai;4219672982;Taip;8;0;0;8
12978;Vėjelis;Varpeliai;50124109589;Taip;0;0;1;1
12979;Vėjelis;Varpeliai;4853650350;Taip;0;2;0;2
12980;Vėjelis;Varpeliai;4521161684;Taip;0;4;0;4
12981;Vėjelis;Varpeliai;60890519853;Taip;5;1;0;6
12982;Vėjelis;Varpeliai;8684461171;Taip;0;3;0;3
12983;Vėjelis;Varpeliai;7133454882;Taip;0;3;0;3
12984;Vėjelis;Varpeliai;1863210064;Taip;0;1;1;2
12985;Vėjelis;Varpeliai;6221257045;Taip;0;1;1;2
12986;Vėjelis;Varpeliai;1534169381;Taip;5;2;0;7
12987;Vėjelis;Varpeliai;8748218387;Taip;5;0;0;5
12988;Vėjelis;Pelėdžiukų;3067215309;Taip;6;1;0;7
12989;Vėjelis;Pelėdžiukų;7211756910;Taip;0;4;0;4
12990;Vėjelis;Pelėdžiukų;2302652824;Ne;12;0;0;12
12991;Vėjelis;Pelėdžiukų;4852532740;Taip;21;0;0;21
12992;Vėjelis;Pelėdžiukų;4450739919;Taip;5;0;0;5
12993;Vėjelis;Pelėdžiukų;9202471939;Taip;5;1;0;6
12994;Vėjelis;Pelėdžiukų;1615837863;Taip;5;1;0;6
12995;Vėjelis;Pelėdžiukų;9852892338;Taip;8;0;0;8
12996;Vėjelis;Pelėdžiukų;8433853523;Taip;5;1;0;6
12997;Vėjelis;Pelėdžiukų;5507017221;Taip;6;0;0;6
12998;Vėjelis;Pelėdžiukų;1259743374;Ne;15;0;0;15
12999;Vėjelis;Pelėdžiukų;6226234271;Taip;0;21;0;21
13000;Vėjelis;Pelėdžiukų;3764096742;Taip;5;0;0;5
13001;Vėjelis;Pelėdžiukų;8153021028;Ne;14;0;0;14
13002;Vėjelis;Pelėdžiukų;8067153728;Taip;6;4;0;10
13003;Vėjelis;Pelėdžiukų;2283628712;Taip;4;1;3;8
13004;Vėjelis;Pelėdžiukų;2729246397;Taip;21;0;0;21
13005;Vėjelis;Pelėdžiukų;9769871497;Taip;0;0;4;4
13006;Vėjelis;Pelėdžiukų;4318295503;Taip;7;0;0;7
13007;Vėjelis;Pelėdžiukų;9867392835;Taip;12;0;1;13
13008;Vėjelis;Skruzdeliukų;2167025998;Taip;3;0;0;3
13009;Vėjelis;Skruzdeliukų;2467377103;Taip;0;1;0;1
13010;Vėjelis;Skruzdeliukų;8470977526;Taip;0;14;0;14
13011;Vėjelis;Skruzdeliukų;9434737088;Taip;2;1;0;3
13012;Vėjelis;Skruzdeliukų;1952141664;Taip;6;1;0;7
13013;Vėjelis;Skruzdeliukų;3264153232;Taip;4;2;5;11
13014;Vėjelis;Skruzdeliukų;4992783345;Taip;0;7;0;7
13015;Vėjelis;Skruzdeliukų;4997987762;Taip;8;1;2;11
13016;Vėjelis;Skruzdeliukų;8356715925;Ne;0;1;2;3
13017;Vėjelis;Skruzdeliukų;4946988585;Taip;3;0;3;6
13018;Vėjelis;Skruzdeliukų;6408918277;Taip;4;1;4;9
13019;Vėjelis;Skruzdeliukų;7240155487;Taip;6;0;0;6
13020;Vėjelis;Skruzdeliukų;7695719991;Ne;0;2;3;5
13021;Vėjelis;Skruzdeliukų;6618114389;Taip;0;3;2;5
13022;Vėjelis;Skruzdeliukų;1381923971;Taip;0;6;0;6
13023;Vėjelis;Skruzdeliukų;8630131152;Taip;8;1;4;13
13024;Vėjelis;Skruzdeliukų;6431589805;Taip;0;1;0;1
13025;Vėjelis;Skruzdeliukų;9177137585;Taip;3;0;0;3
13026;Vėjelis;Skruzdeliukų;4906958328;Taip;16;1;0;17
13027;Vėjelis;Skruzdeliukų;4080198912;Taip;6;0;1;7
13028;Vėjelis;Skruzdeliukų;1555270425;Taip;3;1;1;5
13029;Vėjelis;Skruzdeliukų;7400967836;Taip;0;1;2;3
13030;Vėjelis;Skruzdeliukų;1467023330;Taip;5;1;0;6
13031;Vėjelis;Pieštukų;7860576967;Taip;5;0;0;5
13032;Vėjelis;Pieštukų;4884057836;Taip;0;0;5;5
13033;Vėjelis;Pieštukų;3898751303;Taip;14;7;0;21
13034;Vėjelis;Pieštukų;5662728912;Taip;10;0;10;20
13035;Vėjelis;Pieštukų;8281508498;Taip;0;0;12;12
13036;Vėjelis;Pieštukų;6909799367;Taip;0;1;4;5
13037;Vėjelis;Pieštukų;7748975870;Taip;11;0;0;11
13038;Vėjelis;Pieštukų;1075188861;Taip;17;0;0;17
13039;Vėjelis;Pieštukų;6823103188;Taip;13;5;0;18
13040;Vėjelis;Pieštukų;7854614677;Taip;8;1;0;9
13041;Vėjelis;Pieštukų;9451358807;Taip;14;1;0;15
13042;Vėjelis;Pieštukų;6453605110;Taip;0;12;0;12
13043;Vėjelis;Pieštukų;2720886612;Taip;0;1;0;1
13044;Vėjelis;Pieštukų;2734891342;Taip;4;4;0;8
13045;Vėjelis;Pieštukų;7101585528;Taip;0;1;1;2
13046;Vėjelis;Pieštukų;2373132607;Taip;5;0;0;5
13047;Vėjelis;Ramunėlių;5987294293;Taip;0;7;0;7
13048;Vėjelis;Ramunėlių;8047799576;Taip;15;3;0;18
13049;Vėjelis;Ramunėlių;7178844364;Taip;5;3;0;8
13050;Vėjelis;Ramunėlių;6996900411;Ne;8;5;0;13
13051;Vėjelis;Ramunėlių;5909697341;Ne;0;1;0;1
13052;Vėjelis;Ramunėlių;6451722893;Taip;7;3;0;10
13053;Vėjelis;Ramunėlių;3584347608;Ne;10;0;0;10
13054;Vėjelis;Ramunėlių;1381191703;Ne;0;2;0;2
13055;Vėjelis;Ramunėlių;9042329808;Ne;0;1;0;1
13056;Vėjelis;Ramunėlių;6660799519;Taip;7;2;0;9
13057;Vėjelis;Ramunėlių;6889825160;Taip;4;0;0;4
13058;Vėjelis;Ramunėlių;4433799070;Taip;0;11;0;11
13059;Vėjelis;Ramunėlių;1235788079;Taip;3;1;0;4
13060;Vėjelis;Ramunėlių;4745262277;Taip;4;2;0;6
13061;Vėjelis;Ramunėlių;7790713917;Taip;5;1;0;6
13062;Vėjelis;Ramunėlių;8054114720;Taip;0;4;0;4
13063;Vėjelis;Ramunėlių;8986581196;Taip;13;1;0;14
13064;Vėjelis;Nykštukai;6741600874;Taip;15;0;0;15
13065;Vėjelis;Nykštukai;9957614551;Ne;0;2;0;2
13066;Vėjelis;Nykštukai;7233448544;Taip;13;0;0;13
13067;Vėjelis;Nykštukai;5339200991;Taip;0;1;0;1
13068;Vėjelis;Nykštukai;6602964509;Taip;4;0;0;4
13069;Vėjelis;Nykštukai;2573683778;Taip;6;0;0;6
13070;Vėjelis;Nykštukai;3843601190;Taip;9;0;2;11
13071;Vėjelis;Nykštukai;3574432129;Taip;5;0;0;5
13072;Vėjelis;Nykštukai;4713754452;Taip;10;1;0;11
13073;Vėjelis;Nykštukai;7889625599;Taip;18;1;0;19
13074;Vėjelis;Nykštukai;7763996061;Taip;0;2;0;2
13075;Vėjelis;Nykštukai;8755889077;Ne;1;0;0;1
13076;Vėjelis;Nykštukai;2763569936;Ne;4;1;1;6
13077;Vėjelis;Nykštukai;9979979480;Taip;7;0;1;8
13078;Vėjelis;Nykštukai;4063795811;Taip;0;1;0;1
13079;Vėjelis;BITUTĖS;6824919005;Taip;10;2;0;12
13080;Vėjelis;BITUTĖS;4276237884;Taip;0;4;0;4
13081;Vėjelis;BITUTĖS;3772706363;Taip;15;3;0;18
13082;Vėjelis;BITUTĖS;1834203833;Taip;5;2;1;8
13083;Vėjelis;BITUTĖS;8452132066;Taip;0;21;0;21
13084;Vėjelis;BITUTĖS;6283428333;Taip;14;0;0;14
13085;Vėjelis;BITUTĖS;1112394040;Taip;5;2;1;8
13086;Vėjelis;BITUTĖS;3767625080;Taip;0;1;0;1
13087;Vėjelis;BITUTĖS;6569848405;Taip;0;2;0;2
13088;Vėjelis;BITUTĖS;1457373815;Taip;0;16;0;16
13089;Vėjelis;BITUTĖS;8571757635;Taip;0;1;0;1
13090;Vėjelis;BITUTĖS;9625857378;Taip;5;1;0;6
13091;Vėjelis;BITUTĖS;1116238331;Taip;0;6;0;6
13092;Vėjelis;BITUTĖS;8286070405;Taip;0;5;0;5
13093;Vėjelis;BITUTĖS;1674810054;Taip;8;0;0;8
13094;Vėjelis;BITUTĖS;6581265682;Taip;6;5;0;11
13095;Vėjelis;BITUTĖS;1070853175;Taip;0;0;3;3
13096;Vėjelis;BITUTĖS;4348246825;Taip;6;0;1;7
13097;Vėjelis;Boruželės;2199680661;Taip;0;3;0;3
13098;Vėjelis;Boruželės;5325081841;Taip;0;2;0;2
13099;Vėjelis;Boruželės;9037622738;Taip;0;3;0;3
13100;Vėjelis;Boruželės;1588345134;Taip;0;1;4;5
13101;Vėjelis;Boruželės;1429496839;Taip;0;5;7;12
13102;Vėjelis;Boruželės;1931659200;Taip;0;2;0;2
13103;Vėjelis;Boruželės;8666759391;Taip;0;3;2;5
13104;Vėjelis;Boruželės;3844131154;Taip;1;0;3;4
13105;Vėjelis;Boruželės;4747466651;Taip;6;1;0;7
13106;Vėjelis;Boruželės;3473416323;Taip;0;1;0;1
13107;Vėjelis;Boruželės;8141198449;Taip;0;5;5;10
13108;Vėjelis;Boruželės;8121537795;Taip;0;2;0;2
13109;Vėjelis;Boruželės;5517128872;Taip;0;2;0;2
13110;Vėjelis;Boruželės;8938491367;Taip;0;2;0;2
13111;Vėjelis;Boruželės;6108049183;Ne;0;2;0;2
13112;Vėjelis;Boruželės;1494531065;Taip;0;1;0;1
13113;Vėjelis;Boruželės;3276062426;Taip;1;0;0;1
13114;Vėjelis;Boruželės;4132824111;Taip;11;0;2;13
13115;Vėjelis;Boruželės;2000277444;Taip;5;1;1;7
13116;Vėjelis;Boruželės;7752923796;Taip;0;1;1;2
13117;Vėtrungė;Debesėlių;3655025938;Ne;5;0;0;5
13118;Vėtrungė;Debesėlių;2825732654;Ne;4;2;0;6
13119;Vėtrungė;Debesėlių;7863176604;Taip;0;1;0;1
13120;Vėtrungė;Debesėlių;3179715496;Taip;0;1;0;1
13121;Vėtrungė;Debesėlių;6439014588;Taip;0;3;4;7
13122;Vėtrungė;Debesėlių;9423361592;Taip;0;2;0;2
13123;Vėtrungė;Debesėlių;4269488000;Taip;0;0;7;7
13124;Vėtrungė;Debesėlių;1191007983;Taip;0;6;0;6
13125;Vėtrungė;Debesėlių;3745680607;Taip;2;3;0;5
13126;Vėtrungė;Debesėlių;9359012317;Taip;0;1;0;1
13127;Vėtrungė;Debesėlių;1807742144;Ne;7;2;0;9
13128;Vėtrungė;Debesėlių;9893842192;Taip;15;4;0;19
13129;Vėtrungė;Debesėlių;3433811829;Taip;0;0;2;2
13130;Vėtrungė;Debesėlių;2447851565;Taip;0;2;0;2
13131;Vėtrungė;Debesėlių;2136966687;Taip;0;11;0;11
13132;Vėtrungė;Debesėlių;5246813735;Taip;0;1;0;1
13133;Vėtrungė;Debesėlių;5836190044;Taip;12;1;0;13
13134;Vėtrungė;Debesėlių;5545581078;Taip;0;1;0;1
13135;Vėtrungė;Debesėlių;7185104341;Taip;0;6;9;15
13136;Vėtrungė;Debesėlių;6374739740;Taip;13;1;0;14
13137;Vėtrungė;Debesėlių;5939537473;Taip;11;0;2;13
13138;Vėtrungė;Debesėlių;1871358961;Taip;0;0;1;1
13139;Vėtrungė;Zuikių;9332362038;Taip;2;0;0;2
13140;Vėtrungė;Zuikių;9407558097;Taip;5;7;0;12
13141;Vėtrungė;Zuikių;4121886031;Taip;10;2;0;12
13142;Vėtrungė;Zuikių;7573021445;Taip;0;8;0;8
13143;Vėtrungė;Zuikių;3335047815;Ne;0;3;0;3
13144;Vėtrungė;Zuikių;8157356569;Ne;0;3;0;3
13145;Vėtrungė;Zuikių;9742099165;Taip;0;2;0;2
13146;Vėtrungė;Zuikių;1215953192;Taip;4;1;1;6
13147;Vėtrungė;Zuikių;3908259010;Ne;5;1;0;6
13148;Vėtrungė;Zuikių;1729819557;Ne;0;2;1;3
13149;Vėtrungė;Zuikių;4916692634;Taip;0;5;0;5
13150;Vėtrungė;Zuikių;6416245099;Ne;0;1;0;1
13151;Vėtrungė;Zuikių;4197321604;Taip;0;1;0;1
13152;Vėtrungė;Zuikių;1007578933;Taip;0;1;0;1
13153;Vėtrungė;Zuikių;7558548846;Taip;0;1;0;1
13154;Vėtrungė;Zuikių;8742161467;Taip;5;4;0;9
13155;Vėtrungė;Zuikių;2537221101;Ne;12;1;0;13
13156;Vėtrungė;Zuikių;7342250921;Taip;7;0;5;12
13157;Vėtrungė;Zuikių;9248113268;Taip;3;1;1;5
13158;Vėtrungė;Zuikių;7435005821;Ne;14;2;0;16
13159;Vėtrungė;Zuikių;1280823326;Ne;0;8;2;10
13160;Vėtrungė;Drugelių;5366256528;Ne;13;0;0;13
13161;Vėtrungė;Drugelių;5622109033;Taip;1;2;0;3
13162;Vėtrungė;Drugelių;7476984763;Ne;6;0;5;11
13163;Vėtrungė;Drugelių;9090873546;Taip;9;0;1;10
13164;Vėtrungė;Drugelių;2124476787;Taip;1;0;0;1
13165;Vėtrungė;Drugelių;4578835070;Taip;12;0;0;12
13166;Vėtrungė;Drugelių;8729505032;Taip;1;0;1;2
13167;Vėtrungė;Drugelių;5251308945;Ne;17;0;0;17
13168;Vėtrungė;Drugelių;9812496068;Taip;2;1;0;3
13169;Vėtrungė;Drugelių;8753387108;Taip;0;2;4;6
13170;Vėtrungė;Drugelių;3634995652;Taip;0;1;0;1
13171;Vėtrungė;Drugelių;2123410772;Taip;5;5;0;10
13172;Vėtrungė;Drugelių;3744377479;Taip;0;0;3;3
13173;Vėtrungė;Drugelių;8905533826;Taip;0;2;0;2
13174;Vėtrungė;Drugelių;7186353024;Taip;0;3;0;3
13175;Vėtrungė;Drugelių;2933312366;Taip;8;5;0;13
13176;Vėtrungė;Drugelių;2508501223;Taip;0;3;0;3
13177;Vėtrungė;Do-re-mi;9324733839;Taip;0;1;0;1
13178;Vėtrungė;Do-re-mi;2287044278;Taip;0;2;1;3
13179;Vėtrungė;Do-re-mi;2928868412;Taip;0;9;2;11
13180;Vėtrungė;Do-re-mi;9518734260;Taip;7;2;2;11
13181;Vėtrungė;Do-re-mi;7496582551;Taip;0;0;1;1
13182;Vėtrungė;Do-re-mi;5430818470;Taip;1;4;0;5
13183;Vėtrungė;Do-re-mi;5832298824;Ne;0;3;0;3
13184;Vėtrungė;Do-re-mi;7895027909;Taip;0;4;4;8
13185;Vėtrungė;Do-re-mi;7807708310;Taip;0;0;9;9
13186;Vėtrungė;Do-re-mi;3200251047;Taip;0;0;1;1
13187;Vėtrungė;Do-re-mi;3369970611;Taip;0;9;0;9
13188;Vėtrungė;Do-re-mi;1808699695;Taip;0;1;8;9
13189;Vėtrungė;Do-re-mi;9079483362;Taip;5;0;5;10
13190;Vėtrungė;Do-re-mi;9271869305;Taip;0;1;8;9
13191;Vėtrungė;Do-re-mi;4709068324;Taip;0;1;1;2
13192;Vėtrungė;Do-re-mi;5452337780;Taip;2;0;8;10
13193;Vėtrungė;Do-re-mi;8956375453;Ne;5;0;2;7
13194;Vėtrungė;Do-re-mi;9865628172;Taip;5;0;1;6
13195;Vėtrungė;Smalsučių;7803736567;Taip;10;1;0;11
13196;Vėtrungė;Smalsučių;6599281163;Taip;0;1;0;1
13197;Vėtrungė;Smalsučių;3249689008;Taip;0;6;0;6
13198;Vėtrungė;Smalsučių;7129180154;Taip;0;1;0;1
13199;Vėtrungė;Smalsučių;7295216791;Taip;0;3;0;3
13200;Vėtrungė;Smalsučių;9795630131;Taip;0;1;0;1
13201;Vėtrungė;Smalsučių;2636219826;Taip;2;1;0;3
13202;Vėtrungė;Smalsučių;7363490503;Ne;0;4;0;4
13203;Vėtrungė;Smalsučių;16216365941;Taip;0;1;0;1
13204;Vėtrungė;Smalsučių;2471926240;Taip;0;1;0;1
13205;Vėtrungė;Smalsučių;7813907852;Taip;0;1;0;1
13206;Vėtrungė;Smalsučių;2440001662;Taip;5;1;0;6
13207;Vėtrungė;Smalsučių;4000379945;Taip;10;6;0;16
13208;Vėtrungė;Smalsučių;5367369908;Taip;0;1;0;1
13209;Vėtrungė;Smalsučių;4154712272;Taip;0;3;0;3
13210;Vėtrungė;Smalsučių;3278452234;Taip;0;3;0;3
13211;Vėtrungė;Smalsučių;7483624989;Taip;0;2;0;2
13212;Vėtrungė;Smalsučių;4394100006;Taip;4;2;0;6
13213;Vėtrungė;Smalsučių;7730716483;Taip;1;4;0;5
13214;Vėtrungė;Gudručių;6732632515;Ne;9;3;0;12
13215;Vėtrungė;Gudručių;8721035192;Taip;0;9;0;9
13216;Vėtrungė;Gudručių;1970034012;Ne;0;6;0;6
13217;Vėtrungė;Gudručių;3404120492;Taip;0;2;0;2
13218;Vėtrungė;Gudručių;8897558066;Taip;0;1;0;1
13219;Vėtrungė;Gudručių;7921863675;Taip;0;12;0;12
13220;Vėtrungė;Gudručių;8154023892;Ne;0;9;0;9
13221;Vėtrungė;Gudručių;1522141057;Taip;6;7;0;13
13222;Vėtrungė;Gudručių;9962435598;Ne;10;3;0;13
13223;Vėtrungė;Gudručių;2864217098;Taip;0;1;0;1
13224;Vėtrungė;Gudručių;6964225210;Ne;3;1;0;4
13225;Vėtrungė;Gudručių;2482436192;Taip;5;4;0;9
13226;Vėtrungė;Gudručių;4092242233;Taip;10;2;0;12
13227;Vėtrungė;Gudručių;1551989977;Taip;0;1;0;1
13228;Vėtrungė;Gudručių;4091719904;Taip;0;5;0;5
13229;Vėtrungė;Gudručių;5994465833;Taip;4;2;0;6
13230;Vėtrungė;Gudručių;4347810256;Taip;5;0;0;5
13231;Vėtrungė;Gudručių;7704497739;Taip;0;1;0;1
13232;Vėtrungė;Gudručių;8643181832;Taip;2;1;1;4
13233;Vėtrungė;Gudručių;1520846063;Taip;0;2;3;5
13234;Vėtrungė;Kodėlčių;9172488122;Taip;0;14;0;14
13235;Vėtrungė;Kodėlčių;2739382736;Taip;0;23;0;23
13236;Vėtrungė;Kodėlčių;3903604247;Taip;12;0;2;14
13237;Vėtrungė;Kodėlčių;3500551575;Taip;0;1;0;1
13238;Vėtrungė;Kodėlčių;7872043253;Taip;0;6;1;7
13239;Vėtrungė;Kodėlčių;9852609222;Taip;10;2;0;12
13240;Vėtrungė;Kodėlčių;8465132902;Taip;3;2;0;5
13241;Vėtrungė;Kodėlčių;8859592174;Taip;0;1;0;1
13242;Vėtrungė;Kodėlčių;7862615352;Taip;0;1;0;1
13243;Vėtrungė;Kodėlčių;1540045675;Taip;0;7;0;7
13244;Vėtrungė;Kodėlčių;5385880910;Taip;6;0;0;6
13245;Vėtrungė;Kodėlčių;9211406129;Taip;0;2;0;2
13246;Vėtrungė;Kodėlčių;7511121411;Taip;0;1;0;1
13247;Vėtrungė;Kodėlčių;9127735773;Taip;0;1;4;5
13248;Vėtrungė;Kodėlčių;4756863295;Taip;9;2;0;11
13249;Vėtrungė;Kodėlčių;8985054558;Taip;3;1;0;4
13250;Vėtrungė;Kodėlčių;3922749661;Taip;8;11;0;19
13251;Vėtrungė;Kodėlčių;8013249618;Taip;0;8;0;8
13252;Vėtrungė;Kodėlčių;3887230224;Taip;0;2;0;2
13253;Vėtrungė;Kodėlčių;7740260264;Taip;10;0;0;10
13254;Vėtrungė;Kodėlčių;6807838878;Taip;2;2;0;4
13255;Vėtrungė;Paukštelių;6983172988;Ne;7;0;0;7
13256;Vėtrungė;Paukštelių;8744205170;Taip;10;5;0;15
13257;Vėtrungė;Paukštelių;3466149991;Taip;5;5;0;10
13258;Vėtrungė;Paukštelių;7258995031;Taip;0;2;4;6
13259;Vėtrungė;Paukštelių;5338424871;Taip;13;0;8;21
13260;Vėtrungė;Paukštelių;4805836717;Taip;1;0;0;1
13261;Vėtrungė;Paukštelių;6812588777;Taip;11;6;0;17
13262;Vėtrungė;Paukštelių;2798915063;Taip;6;0;3;9
13263;Vėtrungė;Paukštelių;2981610749;Taip;11;0;2;13
13264;Vėtrungė;Paukštelių;6146327857;Taip;6;0;0;6
13265;Vėtrungė;Paukštelių;8149563485;Taip;9;0;0;9
13266;Vėtrungė;Viščiukų;2725607774;Taip;6;0;0;6
13267;Vėtrungė;Viščiukų;5021830780;Taip;8;0;1;9
13268;Vėtrungė;Viščiukų;5808423634;Taip;7;0;0;7
13269;Vėtrungė;Viščiukų;6190900822;Taip;0;0;1;1
13270;Vėtrungė;Viščiukų;3834510410;Taip;5;5;0;10
13271;Vėtrungė;Viščiukų;4597361099;Taip;0;0;11;11
13272;Vėtrungė;Viščiukų;2490075899;Taip;10;1;0;11
13273;Vėtrungė;Viščiukų;4712052283;Ne;0;3;1;4
13274;Vėtrungė;Viščiukų;8761701511;Taip;17;0;1;18
13275;Vėtrungė;Viščiukų;3527585648;Taip;10;0;2;12
13276;Vėtrungė;Viščiukų;9684184905;Ne;0;0;2;2
13277;Vėtrungė;Viščiukų;4145172377;Taip;14;0;0;14
13278;Vėtrungė;Viščiukų;1568598938;Taip;0;1;0;1
13279;Vėtrungė;Viščiukų;8577668542;Taip;10;0;0;10
13280;Vėtrungė;Viščiukų;4740985408;Taip;8;0;0;8
13281;Vėtrungė;Nykštukų;9696984346;Taip;0;16;0;16
13282;Vėtrungė;Nykštukų;7819147751;Ne;2;1;0;3
13283;Vėtrungė;Nykštukų;6990506209;Taip;0;2;0;2
13284;Vėtrungė;Nykštukų;2348557463;Taip;4;7;0;11
13285;Vėtrungė;Nykštukų;7733472482;Taip;15;1;0;16
13286;Vėtrungė;Nykštukų;2309821873;Taip;7;4;0;11
13287;Vėtrungė;Nykštukų;2364156362;Taip;10;3;0;13
13288;Vėtrungė;Nykštukų;8059553343;Taip;0;12;0;12
13289;Vėtrungė;Nykštukų;4020987532;Taip;2;1;2;5
13290;Vėtrungė;Nykštukų;9569555731;Taip;0;1;0;1
13291;Vėtrungė;Nykštukų;7699392279;Taip;0;18;0;18
13292;Vėtrungė;Nykštukų;9773838651;Taip;9;7;0;16
13293;Vėtrungė;Nykštukų;6866720274;Taip;0;1;0;1
13294;Vėtrungė;Nykštukų;4289435509;Taip;0;2;0;2
13295;Vėtrungė;Meškiukų;2510763357;Taip;1;1;0;2
13296;Vėtrungė;Meškiukų;4713420194;Taip;1;1;0;2
13297;Vėtrungė;Meškiukų;2226654309;Taip;0;9;0;9
13298;Vėtrungė;Meškiukų;9207846866;Taip;8;0;1;9
13299;Vėtrungė;Meškiukų;9065848425;Taip;0;10;0;10
13300;Vėtrungė;Meškiukų;3328447991;Taip;0;1;0;1
13301;Vėtrungė;Meškiukų;9685389270;Ne;0;8;0;8
13302;Vėtrungė;Meškiukų;9313438768;Taip;0;5;0;5
13303;Vėtrungė;Meškiukų;3122948974;Taip;0;1;0;1
13304;Vėtrungė;Meškiukų;2520926439;Taip;15;0;0;15
13305;Vėtrungė;Meškiukų;7143997258;Taip;0;1;0;1
13306;Vėtrungė;Meškiukų;8961791293;Taip;1;2;0;3
13307;Vėtrungė;Meškiukų;2809555356;Taip;0;4;0;4
13308;Vėtrungė;Meškiukų;1766599777;Ne;6;1;4;11
13309;Vėtrungė;Meškiukų;9642541034;Taip;0;1;0;1
13310;Vėtrungė;Meškiukų;8958748086;Taip;11;1;0;12
13311;Vėtrungė;Meškiukų;5887929703;Taip;0;5;0;5
13312;Vėtrungė;Ąžuoliukų;1034537691;Taip;5;0;0;5
13313;Vėtrungė;Ąžuoliukų;7568316390;Taip;0;1;1;2
13314;Vėtrungė;Ąžuoliukų;6363761237;Taip;5;1;0;6
13315;Vėtrungė;Ąžuoliukų;8913748584;Ne;6;0;0;6
13316;Vėtrungė;Ąžuoliukų;3073965379;Taip;0;1;1;2
13317;Vėtrungė;Ąžuoliukų;3938684888;Taip;5;1;0;6
13318;Vėtrungė;Ąžuoliukų;6073563461;Taip;0;1;1;2
13319;Vėtrungė;Ąžuoliukų;4925843510;Taip;1;0;2;3
13320;Vėtrungė;Ąžuoliukų;8867794275;Taip;0;1;0;1
13321;Vėtrungė;Ąžuoliukų;7096106273;Ne;21;0;9;30
13322;Vėtrungė;Ąžuoliukų;8026065367;Taip;0;1;0;1
13323;Vėtrungė;Ąžuoliukų;6476717645;Taip;6;0;0;6
13324;Vėtrungė;Ąžuoliukų;5167580818;Taip;19;0;0;19
13325;Vilnelė;Lakštutė;8843094480;Taip;12;0;0;12
13326;Vilnelė;Lakštutė;5786086401;Taip;0;1;0;1
13327;Vilnelė;Lakštutė;6249731759;Taip;0;17;0;17
13328;Vilnelė;Lakštutė;6837850601;Taip;0;2;0;2
13329;Vilnelė;Lakštutė;5554451335;Taip;12;1;0;13
13330;Vilnelė;Lakštutė;1762024490;Ne;0;1;3;4
13331;Vilnelė;Lakštutė;4427383755;Taip;0;2;0;2
13332;Vilnelė;Lakštutė;1547117566;Taip;0;2;0;2
13333;Vilnelė;Lakštutė;1734277231;Taip;0;2;0;2
13334;Vilnelė;Lakštutė;8837662451;Taip;0;18;0;18
13335;Vilnelė;Lakštutė;3900484348;Taip;6;1;0;7
13336;Vilnelė;Lakštutė;5498574366;Taip;0;10;0;10
13337;Vilnelė;Lakštutė;6686896190;Taip;5;1;0;6
13338;Vilnelė;Lakštutė;3032273912;Taip;0;13;0;13
13339;Vilnelė;Lakštutė;4017436910;Taip;2;1;3;6
13340;Vilnelė;Lakštutė;6156838553;Taip;7;1;0;8
13341;Vilnelė;Lakštutė;9843449060;Ne;17;0;0;17
13342;Vilnelė;Lakštutė;2803880424;Taip;0;1;1;2
13343;Vilnelė;Lakštutė;2418216191;Taip;10;0;0;10
13344;Vilnelė;Vyturėlis;5091272908;Taip;1;2;1;4
13345;Vilnelė;Vyturėlis;1133945467;Taip;0;0;5;5
13346;Vilnelė;Vyturėlis;3009064105;Taip;4;3;0;7
13347;Vilnelė;Vyturėlis;3743740372;Taip;0;1;0;1
13348;Vilnelė;Vyturėlis;2131599015;Taip;0;6;0;6
13349;Vilnelė;Vyturėlis;18740103706;Taip;11;6;0;17
13350;Vilnelė;Vyturėlis;7057183482;Taip;21;0;0;21
13351;Vilnelė;Vyturėlis;8725191514;Taip;5;2;0;7
13352;Vilnelė;Vyturėlis;6308015852;Taip;0;3;0;3
13353;Vilnelė;Vyturėlis;7963783957;Taip;2;0;0;2
13354;Vilnelė;Vyturėlis;1545570307;Taip;4;1;0;5
13355;Vilnelė;Vyturėlis;5540359276;Taip;0;1;0;1
13356;Vilnelė;Vyturėlis;1966090625;Taip;2;3;0;5
13357;Vilnelė;Vyturėlis;8740717061;Taip;0;3;0;3
13358;Vilnelė;Vyturėlis;3772263873;Taip;0;6;0;6
13359;Vilnelė;Vyturėlis;9183391434;Taip;10;3;0;13
13360;Vilnelė;Vyturėlis;2159103903;Taip;0;1;0;1
13361;Vilnelė;Vyturėlis;9369955153;Taip;12;1;0;13
13362;Vilnelė;Vyturėlis;5558584030;Taip;6;1;0;7
13363;Vilnelė;Vyturėlis;1151879281;Taip;6;0;0;6
13364;Vilnelė;Vyturėlis;8820091584;Taip;0;0;2;2
13365;Vilnelė;Vyturėlis;8270866998;Taip;5;14;0;19
13366;Vilnelė;Vyturėlis;3454141069;Taip;0;0;1;1
13367;Vilnelė;Vyturėlis;28447690974;Taip;1;0;0;1
13368;Vilnelė;Vyturėlis;1462397783;Taip;0;4;0;4
13369;Vilnelė;Pagrandukas;5508759323;Ne;6;2;1;9
13370;Vilnelė;Pagrandukas;2144925171;Taip;0;2;0;2
13371;Vilnelė;Pagrandukas;4295816753;Taip;0;2;0;2
13372;Vilnelė;Pagrandukas;3844066232;Ne;2;4;0;6
13373;Vilnelė;Pagrandukas;6659537454;Taip;0;4;0;4
13374;Vilnelė;Pagrandukas;5953205533;Taip;0;14;0;14
13375;Vilnelė;Pagrandukas;4448413194;Taip;10;1;0;11
13376;Vilnelė;Pagrandukas;6830433856;Taip;0;2;0;2
13377;Vilnelė;Pagrandukas;4664946923;Taip;0;3;0;3
13378;Vilnelė;Pagrandukas;6982847450;Taip;0;3;2;5
13379;Vilnelė;Pagrandukas;7560124407;Taip;0;3;7;10
13380;Vilnelė;Pagrandukas;3685294539;Taip;5;2;0;7
13381;Vilnelė;Pagrandukas;4931943297;Taip;0;2;0;2
13382;Vilnelė;Pagrandukas;7882756938;Taip;3;0;0;3
13383;Vilnelė;Pagrandukas;7348404699;Taip;0;11;0;11
13384;Vilnelė;Pagrandukas;3323738649;Taip;0;1;0;1
13385;Vilnelė;Pagrandukas;8116613831;Taip;8;5;0;13
13386;Vilnelė;Pagrandukas;9489760844;Taip;0;2;1;3
13387;Vilnelė;Pagrandukas;6466321228;Taip;10;2;0;12
13388;Vilnelė;Pagrandukas;4478847902;Taip;0;2;0;2
13389;Vilnelė;Pagrandukas;9635159885;Taip;0;2;2;4
13390;Vilnelė;Pagrandukas;6448119003;Taip;4;1;0;5
13391;Vilnelė;Pagrandukas;2165389724;Taip;4;0;1;5
13392;Vilnelė;Bitutė;1720695615;Taip;0;1;0;1
13393;Vilnelė;Bitutė;2121071276;Taip;6;0;2;8
13394;Vilnelė;Bitutė;7387394504;Taip;0;6;0;6
13395;Vilnelė;Bitutė;8593060923;Taip;2;0;4;6
13396;Vilnelė;Bitutė;1882520335;Taip;0;1;0;1
13397;Vilnelė;Bitutė;85074719873;Taip;0;1;0;1
13398;Vilnelė;Bitutė;2990112955;Taip;0;2;5;7
13399;Vilnelė;Bitutė;6318246517;Taip;5;0;0;5
13400;Vilnelė;Bitutė;1281521052;Taip;5;9;0;14
13401;Vilnelė;Bitutė;9058632601;Taip;0;2;0;2
13402;Vilnelė;Bitutė;8615257084;Taip;1;0;0;1
13403;Vilnelė;Bitutė;98028664140;Taip;0;1;0;1
13404;Vilnelė;Bitutė;1507865281;Taip;12;2;0;14
13405;Vilnelė;Bitutė;2130482375;Taip;0;7;0;7
13406;Vilnelė;Bitutė;7292043157;Taip;0;1;0;1
13407;Vilnelė;Bitutė;4480175299;Taip;0;7;0;7
13408;Vilnelė;Bitutė;39494954188;Taip;0;13;0;13
13409;Vilnelė;Bitutė;6327531229;Taip;0;1;0;1
13410;Vilnelė;Bitutė;42835212158;Taip;0;9;0;9
13411;Vilnelė;Bitutė;6146514112;Taip;0;9;0;9
13412;Vilnelė;Bitutė;5013418313;Taip;0;1;0;1
13413;Vilnelė;Bitutė;5932200003;Ne;0;0;2;2
13414;Vilnelė;Bitutė;1783854203;Taip;2;1;0;3
13415;Vilnelė;Bitutė;9016832316;Taip;0;0;2;2
13416;Vilnelė;Bitutė;6155522893;Taip;3;0;0;3
13417;Vilnelė;Šaltinėlis;7752502124;Ne;17;0;0;17
13418;Vilnelė;Šaltinėlis;3064118212;Taip;15;0;1;16
13419;Vilnelė;Šaltinėlis;5813090771;Taip;8;0;2;10
13420;Vilnelė;Šaltinėlis;1234033852;Taip;21;0;0;21
13421;Vilnelė;Šaltinėlis;9317041585;Taip;11;0;2;13
13422;Vilnelė;Šaltinėlis;4670933970;Taip;0;0;2;2
13423;Vilnelė;Šaltinėlis;4817502971;Taip;16;0;0;16
13424;Vilnelė;Šaltinėlis;3712463891;Taip;6;0;0;6
13425;Vilnelė;Šaltinėlis;2343750614;Ne;8;0;0;8
13426;Vilnelė;Šaltinėlis;2700153185;Taip;5;0;1;6
13427;Vilnelė;Šaltinėlis;7231998656;Taip;16;0;0;16
13428;Vilnelė;Šaltinėlis;2683662906;Taip;7;0;1;8
13429;Vilnelė;Šaltinėlis;3142594542;Taip;0;2;8;10
13430;Vilnelė;Šaltinėlis;4982137749;Ne;0;3;0;3
13431;Vilnelė;Riešutėllis;1027463000;Taip;0;2;0;2
13432;Vilnelė;Riešutėllis;7020707723;Taip;5;9;0;14
13433;Vilnelė;Riešutėllis;1960860528;Taip;0;0;1;1
13434;Vilnelė;Riešutėllis;4203549404;Taip;6;0;6;12
13435;Vilnelė;Riešutėllis;3290952017;Ne;3;4;0;7
13436;Vilnelė;Riešutėllis;8588430578;Taip;0;6;0;6
13437;Vilnelė;Riešutėllis;7957695470;Taip;3;0;0;3
13438;Vilnelė;Riešutėllis;8750705826;Taip;8;1;0;9
13439;Vilnelė;Riešutėllis;4780827432;Taip;6;2;0;8
13440;Vilnelė;Riešutėllis;4455099179;Taip;0;3;0;3
13441;Vilnelė;Riešutėllis;2367127222;Taip;0;1;0;1
13442;Vilnelė;Riešutėllis;5306723959;Taip;0;0;1;1
13443;Vilnelė;Riešutėllis;3670613082;Taip;5;3;0;8
13444;Vilnelė;Riešutėllis;6417545510;Taip;1;1;0;2
13445;Vilnelė;Riešutėllis;7085972543;Taip;2;2;0;4
13446;Vilnelė;Riešutėllis;3211657057;Taip;0;1;0;1
13447;Vilnelė;Riešutėllis;9016866597;Taip;5;7;0;12
13448;Vilnelė;Riešutėllis;7087798406;Taip;0;1;0;1
13449;Vilnelė;Riešutėllis;4254744025;Ne;6;9;0;15
13450;Vilnelė;Riešutėllis;3730997665;Taip;11;2;0;13
13451;Vilnelė;Riešutėllis;2706699572;Taip;4;2;0;6
13452;Vilnelė;Riešutėllis;8774842903;Taip;14;0;0;14
13453;Vilnelė;Riešutėllis;3031790547;Ne;0;2;0;2
13454;Vilnelė;Nykštukas;4210511566;Taip;17;1;0;18
13455;Vilnelė;Nykštukas;2891787022;Taip;6;0;0;6
13456;Vilnelė;Nykštukas;4734511521;Taip;14;1;0;15
13457;Vilnelė;Nykštukas;6344134620;Taip;0;3;0;3
13458;Vilnelė;Nykštukas;4295630317;Taip;26;1;0;27
13459;Vilnelė;Nykštukas;1554473199;Taip;4;3;0;7
13460;Vilnelė;Nykštukas;4060927733;Taip;18;1;0;19
13461;Vilnelė;Nykštukas;2299381653;Ne;11;8;0;19
13462;Vilnelė;Nykštukas;5041031750;Taip;1;0;6;7
13463;Vilnelė;Nykštukas;2157793186;Taip;0;1;0;1
13464;Vilnelė;Nykštukas;4516818999;Taip;6;12;0;18
13465;Vilnelė;Nykštukas;8579294202;Taip;0;20;0;20
13466;Vilnelė;Nykštukas;7161529969;Taip;0;1;0;1
13467;Vilnelė;Nykštukas;3720979747;Taip;0;1;0;1
13468;Vilnelė;Nykštukas;6048991617;Ne;5;4;1;10
13469;Vilnelė;Nykštukas;6054488692;Taip;6;0;0;6
13470;Vilnelė;Nykštukas;8630048961;Ne;6;10;0;16
13471;Vilnelė;Nykštukas;7592040226;Taip;14;5;0;19
13472;Vilnelė;Nykštukas;1515873552;Taip;12;1;0;13
13473;Vilnelė;Nykštukas;5629086127;Taip;7;0;0;7
13474;Vilnelė;Pieštukas;9879688569;Taip;12;1;0;13
13475;Vilnelė;Pieštukas;5473379559;Taip;10;2;0;12
13476;Vilnelė;Pieštukas;1792586468;Ne;0;2;0;2
13477;Vilnelė;Pieštukas;3781595939;Taip;7;2;0;9
13478;Vilnelė;Pieštukas;9884955712;Taip;15;2;0;17
13479;Vilnelė;Pieštukas;2479090686;Taip;8;9;0;17
13480;Vilnelė;Pieštukas;3945921490;Taip;0;14;0;14
13481;Vilnelė;Pieštukas;1975954784;Ne;5;5;0;10
13482;Vilnelė;Pieštukas;7199490431;Taip;0;1;0;1
13483;Vilnelė;Pieštukas;1730149127;Taip;13;1;0;14
13484;Vilnelė;Pieštukas;5778176840;Taip;0;5;0;5
13485;Vilnelė;Pieštukas;6355912551;Taip;6;3;0;9
13486;Vilnelė;Pieštukas;7976798775;Taip;0;8;0;8
13487;Vilnelė;Pieštukas;3811289758;Taip;5;8;0;13
13488;Vilnelė;Pieštukas;3529718234;Taip;18;1;0;19
13489;Vilnelė;Pieštukas;1880318663;Taip;0;1;0;1
13490;Vilnelė;Pieštukas;9589410276;Taip;0;1;0;1
13491;Vilnelė;Pieštukas;4718994967;Taip;4;7;0;11
13492;Vilnelė;Pieštukas;8092642447;Ne;3;1;0;4
13493;Vilnelė;Pieštukas;3856917286;Taip;0;8;0;8
13494;Vilnelė;Pieštukas;6132739519;Ne;0;10;0;10
13495;Vilnelė;Pieštukas;8162191913;Ne;1;2;0;3
13496;Vilnelė;Pieštukas;3791258264;Taip;0;2;1;3
13497;Vilnelė;Voverytė;7536603663;Ne;0;3;10;13
13498;Vilnelė;Voverytė;3503461211;Taip;3;4;0;7
13499;Vilnelė;Voverytė;3993826389;Taip;3;0;1;4
13500;Vilnelė;Voverytė;7388336851;Taip;8;6;0;14
13501;Vilnelė;Voverytė;8667403338;Taip;5;2;0;7
13502;Vilnelė;Voverytė;7883724600;Taip;5;3;0;8
13503;Vilnelė;Voverytė;4166351390;Taip;12;0;0;12
13504;Vilnelė;Voverytė;1351798589;Taip;0;18;0;18
13505;Vilnelė;Voverytė;9162681538;Taip;0;3;2;5
13506;Vilnelė;Voverytė;3075681823;Taip;0;3;1;4
13507;Vilnelė;Voverytė;6342242777;Taip;0;1;0;1
13508;Vilnelė;Voverytė;3843064564;Taip;6;0;0;6
13509;Vilnelė;Voverytė;3558073399;Taip;8;0;1;9
13510;Vilnelė;Voverytė;2923012145;Taip;13;0;0;13
13511;Vilnelė;Voverytė;2841315531;Taip;0;0;21;21
13512;Vilnelė;Voverytė;9804772168;Taip;0;0;7;7
13513;Vilnelė;Voverytė;1596625263;Taip;4;0;3;7
13514;Vilnelė;Voverytė;7338573817;Taip;0;0;4;4
13515;Vilnelė;Voverytė;8121075430;Taip;0;11;0;11
13516;Vilnelė;Voverytė;1574809879;Taip;17;1;0;18
13517;Vilnelė;Voverytė;6083082959;Taip;0;3;0;3
13518;Vilnelė;Voverytė;2788449626;Taip;5;2;1;8
13519;Vilnelė;Kodėlčiukas;4642378600;Taip;11;1;0;12
13520;Vilnelė;Kodėlčiukas;6618109352;Taip;0;18;0;18
13521;Vilnelė;Kodėlčiukas;6715997340;Ne;11;1;0;12
13522;Vilnelė;Kodėlčiukas;9482133396;Taip;7;0;1;8
13523;Vilnelė;Kodėlčiukas;8439505238;Taip;5;0;0;5
13524;Vilnelė;Kodėlčiukas;1580287517;Taip;0;3;0;3
13525;Vilnelė;Kodėlčiukas;5558378376;Taip;5;1;0;6
13526;Vilnelė;Kodėlčiukas;4328263940;Taip;6;2;0;8
13527;Vilnelė;Kodėlčiukas;3056845279;Taip;6;7;0;13
13528;Vilnelė;Kodėlčiukas;9537740492;Taip;11;0;0;11
13529;Vilnelė;Kodėlčiukas;9640330864;Taip;6;0;0;6
13530;Vilnelė;Kodėlčiukas;3848720970;Taip;0;1;2;3
13531;Vilnelė;Kodėlčiukas;7833531435;Taip;0;4;0;4
13532;Vilnelė;Kodėlčiukas;5961910077;Taip;6;1;0;7
13533;Vilnelė;Kodėlčiukas;3115242919;Ne;0;3;2;5
13534;Vilnelė;Kodėlčiukas;8543995029;Taip;0;8;0;8
13535;Vilnelė;Kodėlčiukas;1933660272;Taip;0;0;1;1
13536;Vilnelė;Kodėlčiukas;4986079102;Taip;0;6;0;6
13537;Vilnelė;Kodėlčiukas;9418661965;Taip;8;1;0;9
13538;Vilnelė;Kodėlčiukas;5180951251;Taip;4;2;1;7
13539;Vilnelė;Žirniukas;5612501291;Taip;3;0;1;4
13540;Vilnelė;Žirniukas;3654833067;Taip;0;2;1;3
13541;Vilnelė;Žirniukas;4322462166;Taip;0;2;1;3
13542;Vilnelė;Žirniukas;9817054571;Taip;1;0;3;4
13543;Vilnelė;Žirniukas;9316933315;Taip;7;0;1;8
13544;Vilnelė;Žirniukas;1598555488;Taip;6;1;0;7
13545;Vilnelė;Žirniukas;5960725916;Taip;0;17;0;17
13546;Vilnelė;Žirniukas;8329253118;Taip;21;0;0;21
13547;Vilnelė;Žirniukas;9476510950;Taip;0;0;5;5
13548;Vilnelė;Žirniukas;3234028667;Taip;0;2;6;8
13549;Vilnelė;Žirniukas;7870509810;Taip;10;0;1;11
13550;Vilnelė;Žirniukas;6569980514;Taip;11;0;3;14
13551;Vilnelė;Žirniukas;6634526716;Ne;1;10;0;11
13552;Vilnelė;Žirniukas;8848138564;Taip;6;0;0;6
13553;Vilnelė;Žirniukas;5649725693;Taip;0;3;6;9
13554;Vilnelė;Žirniukas;7568755715;Taip;1;2;5;8
13555;Vilnelė;Žirniukas;1371066506;Taip;0;9;0;9
13556;Vilnelė;Žirniukas;4758117005;Taip;18;0;0;18
13557;Vilnelė;Pipiras;1414168531;Taip;12;0;0;12
13558;Vilnelė;Pipiras;2918624119;Taip;6;0;0;6
13559;Vilnelė;Pipiras;3432602015;Taip;1;0;0;1
13560;Vilnelė;Pipiras;9660305163;Taip;0;4;0;4
13561;Vilnelė;Pipiras;2964672357;Taip;6;0;1;7
13562;Vilnelė;Pipiras;1566734465;Taip;0;5;0;5
13563;Vilnelė;Pipiras;9882766915;Taip;9;6;0;15
13564;Vilnelė;Pipiras;8015908754;Taip;21;0;0;21
13565;Vilnelė;Pipiras;7968029402;Taip;4;2;1;7
13566;Vilnelė;Pipiras;7221712624;Taip;2;2;1;5
13567;Vilnelė;Pipiras;6966791665;Taip;2;1;0;3
13568;Vilnelė;Pipiras;7293735126;Taip;2;1;0;3
13569;Vilnelė;Pipiras;9950598582;Taip;5;0;2;7
13570;Vilnelė;Pipiras;5444967820;Taip;1;0;0;1
13571;Vilnelė;Pipiras;3828623778;Taip;10;6;0;16
13572;Vilnelė;Pipiras;5273665901;Taip;0;7;0;7
13573;Vilnelė;Pipiras;5173602064;Taip;7;2;0;9
13574;Vėrinėlis;GAIDELIAI;7069247393;Taip;0;0;5;5
13575;Vėrinėlis;GAIDELIAI;6162461750;Taip;0;0;1;1
13576;Vėrinėlis;GAIDELIAI;3500287869;Taip;12;0;5;17
13577;Vėrinėlis;GAIDELIAI;9370715798;Ne;15;0;1;16
13578;Vėrinėlis;GAIDELIAI;6500266853;Taip;22;0;1;23
13579;Vėrinėlis;GAIDELIAI;5891690000;Taip;9;0;5;14
13580;Vėrinėlis;GAIDELIAI;4401001009;Taip;11;15;0;26
13581;Vėrinėlis;GAIDELIAI;4498096701;Taip;5;0;1;6
13582;Vėrinėlis;GAIDELIAI;6055921178;Taip;10;9;0;19
13583;Vėrinėlis;GAIDELIAI;9144004655;Taip;18;0;0;18
13584;Vėrinėlis;GAIDELIAI;8272531606;Taip;18;0;0;18
13585;Vėrinėlis;GAIDELIAI;2114637828;Taip;10;0;1;11
13586;Vėrinėlis;GAIDELIAI;6159725406;Taip;14;0;1;15
13587;Vėrinėlis;GAIDELIAI;1844862699;Taip;17;0;1;18
13588;Vėrinėlis;GAIDELIAI;7455948332;Taip;15;6;0;21
13589;Vėrinėlis;GAIDELIAI;4965735537;Taip;16;0;2;18
13590;Vėrinėlis;SAULUTĖ;7224418233;Taip;21;0;0;21
13591;Vėrinėlis;SAULUTĖ;9612956692;Taip;0;5;0;5
13592;Vėrinėlis;SAULUTĖ;8238013636;Taip;8;0;0;8
13593;Vėrinėlis;SAULUTĖ;7273090217;Taip;0;0;1;1
13594;Vėrinėlis;SAULUTĖ;2337883071;Taip;9;0;3;12
13595;Vėrinėlis;SAULUTĖ;3882915774;Taip;0;5;0;5
13596;Vėrinėlis;SAULUTĖ;7440020169;Taip;5;1;0;6
13597;Vėrinėlis;SAULUTĖ;7913975075;Taip;0;7;0;7
13598;Vėrinėlis;SAULUTĖ;9967737864;Taip;6;2;0;8
13599;Vėrinėlis;SAULUTĖ;7364698713;Taip;0;0;1;1
13600;Vėrinėlis;SAULUTĖ;9009344779;Taip;15;2;0;17
13601;Vėrinėlis;SAULUTĖ;4059906525;Taip;12;0;0;12
13602;Vėrinėlis;SAULUTĖ;3832662507;Taip;1;0;0;1
13603;Vėrinėlis;SAULUTĖ;3291922401;Taip;0;2;0;2
13604;Vėrinėlis;SAULUTĖ;1007705906;Taip;9;2;0;11
13605;Vėrinėlis;SAULUTĖ;9289003583;Taip;0;4;0;4
13606;Vėrinėlis;SAULUTĖ;1684203955;Taip;0;4;0;4
13607;Vėrinėlis;SAULUTĖ;5942475043;Taip;12;8;0;20
13608;Vėrinėlis;SAULUTĖ;9310629340;Taip;5;0;0;5
13609;Vėrinėlis;SAULUTĖ;2369434537;Taip;4;0;0;4
13610;Vėrinėlis;NYKŠTUKAI;1865151493;Taip;0;1;1;2
13611;Vėrinėlis;NYKŠTUKAI;8755231814;Taip;2;0;1;3
13612;Vėrinėlis;NYKŠTUKAI;9604483237;Ne;0;1;9;10
13613;Vėrinėlis;NYKŠTUKAI;6220653152;Taip;8;1;0;9
13614;Vėrinėlis;NYKŠTUKAI;7981261038;Taip;0;1;0;1
13615;Vėrinėlis;NYKŠTUKAI;1395590011;Taip;0;7;3;10
13616;Vėrinėlis;NYKŠTUKAI;19865450007;Taip;6;0;1;7
13617;Vėrinėlis;NYKŠTUKAI;5511584499;Ne;1;0;0;1
13618;Vėrinėlis;NYKŠTUKAI;3562371502;Taip;6;0;0;6
13619;Vėrinėlis;NYKŠTUKAI;9751037428;Taip;1;7;0;8
13620;Vėrinėlis;NYKŠTUKAI;4089567420;Taip;0;1;0;1
13621;Vėrinėlis;NYKŠTUKAI;8579819581;Taip;0;3;0;3
13622;Vėrinėlis;NYKŠTUKAI;5209398043;Taip;0;4;0;4
13623;Vėrinėlis;NYKŠTUKAI;3074835599;Taip;2;0;0;2
13624;Vėrinėlis;NYKŠTUKAI;6779005350;Taip;4;1;0;5
13625;Vėrinėlis;NYKŠTUKAI;8824435889;Ne;0;1;0;1
13626;Vėrinėlis;BURATINAS;7093959212;Taip;0;1;0;1
13627;Vėrinėlis;BURATINAS;8100283579;Taip;7;0;0;7
13628;Vėrinėlis;BURATINAS;7078114492;Ne;0;1;0;1
13629;Vėrinėlis;BURATINAS;6280508974;Ne;0;1;0;1
13630;Vėrinėlis;BURATINAS;2774618380;Ne;0;4;0;4
13631;Vėrinėlis;BURATINAS;2857591912;Taip;0;1;0;1
13632;Vėrinėlis;BURATINAS;5429955166;Taip;0;8;0;8
13633;Vėrinėlis;BURATINAS;4183077476;Taip;0;9;0;9
13634;Vėrinėlis;BURATINAS;2529641529;Taip;0;10;0;10
13635;Vėrinėlis;BURATINAS;2467700639;Taip;8;13;0;21
13636;Vėrinėlis;BURATINAS;6136232912;Taip;0;4;0;4
13637;Vėrinėlis;BURATINAS;7092421890;Taip;10;0;0;10
13638;Vėrinėlis;BURATINAS;6058712578;Taip;13;2;0;15
13639;Vėrinėlis;BURATINAS;1164396960;Taip;5;6;0;11
13640;Vėrinėlis;BURATINAS;6413701823;Taip;0;1;0;1
13641;Vėrinėlis;BURATINAS;2364117224;Taip;0;7;0;7
13642;Vėrinėlis;BURATINAS;5206206080;Taip;0;1;2;3
13643;Vėrinėlis;BURATINAS;3947650381;Taip;11;0;0;11
13644;Vėrinėlis;GINTARĖLIAI;5987029334;Taip;21;0;0;21
13645;Vėrinėlis;GINTARĖLIAI;8372084728;Taip;11;0;0;11
13646;Vėrinėlis;GINTARĖLIAI;6054398276;Taip;2;3;1;6
13647;Vėrinėlis;GINTARĖLIAI;7432965615;Taip;5;10;0;15
13648;Vėrinėlis;GINTARĖLIAI;3457199716;Taip;11;2;0;13
13649;Vėrinėlis;GINTARĖLIAI;7743951577;Taip;6;0;1;7
13650;Vėrinėlis;GINTARĖLIAI;2006432327;Taip;7;1;0;8
13651;Vėrinėlis;GINTARĖLIAI;6785519869;Ne;19;0;0;19
13652;Vėrinėlis;GINTARĖLIAI;3363388500;Taip;5;5;0;10
13653;Vėrinėlis;GINTARĖLIAI;1872534206;Ne;0;1;0;1
13654;Vėrinėlis;GINTARĖLIAI;8545392429;Taip;10;0;0;10
13655;Vėrinėlis;GINTARĖLIAI;9171173116;Taip;10;0;0;10
13656;Vėrinėlis;GINTARĖLIAI;8343196405;Taip;12;2;0;14
13657;Vėrinėlis;GINTARĖLIAI;2284527544;Taip;3;0;0;3
13658;Vėrinėlis;GINTARĖLIAI;5644772729;Taip;3;2;0;5
13659;Vėrinėlis;GINTARĖLIAI;4034106321;Taip;5;2;0;7
13660;Vėrinėlis;RAMUNĖLĖS;4415030161;Taip;0;4;0;4
13661;Vėrinėlis;RAMUNĖLĖS;8620836106;Taip;0;2;0;2
13662;Vėrinėlis;RAMUNĖLĖS;5003344894;Taip;0;1;1;2
13663;Vėrinėlis;RAMUNĖLĖS;8922728881;Taip;0;1;0;1
13664;Vėrinėlis;RAMUNĖLĖS;5434506594;Taip;0;3;0;3
13665;Vėrinėlis;RAMUNĖLĖS;5041189990;Taip;10;4;0;14
13666;Vėrinėlis;RAMUNĖLĖS;1047139776;Taip;0;1;0;1
13667;Vėrinėlis;RAMUNĖLĖS;9798993200;Taip;0;1;0;1
13668;Vėrinėlis;RAMUNĖLĖS;6435612222;Taip;0;4;0;4
13669;Vėrinėlis;RAMUNĖLĖS;6866592245;Taip;5;0;0;5
13670;Vėrinėlis;RAMUNĖLĖS;4728119881;Taip;0;1;0;1
13671;Vėrinėlis;RAMUNĖLĖS;3316897176;Taip;0;5;0;5
13672;Vėrinėlis;RAMUNĖLĖS;1386916991;Taip;11;2;0;13
13673;Vėrinėlis;RAMUNĖLĖS;2090334618;Taip;0;12;0;12
13674;Vėrinėlis;RAMUNĖLĖS;3810261864;Taip;4;1;0;5
13675;Vėrinėlis;RAMUNĖLĖS;4191386053;Taip;0;2;0;2
13676;Vėrinėlis;KODELČIUKŲ;7070058961;Taip;0;6;0;6
13677;Vėrinėlis;KODELČIUKŲ;3308843618;Taip;0;1;0;1
13678;Vėrinėlis;KODELČIUKŲ;1535567719;Taip;0;12;0;12
13679;Vėrinėlis;KODELČIUKŲ;8755941866;Taip;6;1;3;10
13680;Vėrinėlis;KODELČIUKŲ;42298331453;Taip;4;0;0;4
13681;Vėrinėlis;KODELČIUKŲ;8709714647;Taip;3;3;2;8
13682;Vėrinėlis;KODELČIUKŲ;6108187043;Taip;0;6;0;6
13683;Vėrinėlis;KODELČIUKŲ;9119967823;Taip;0;0;3;3
13684;Vėrinėlis;KODELČIUKŲ;4067153819;Taip;0;1;8;9
13685;Vėrinėlis;KODELČIUKŲ;5712568063;Taip;0;1;0;1
13686;Vėrinėlis;KODELČIUKŲ;1467899937;Taip;0;1;4;5
13687;Vėrinėlis;KODELČIUKŲ;8885866108;Taip;0;6;0;6
13688;Vėrinėlis;KODELČIUKŲ;7634939364;Taip;0;2;0;2
13689;Vėrinėlis;KODELČIUKŲ;3049346950;Taip;7;0;5;12
13690;Vėrinėlis;KODELČIUKŲ;8652292752;Taip;0;1;5;6
13691;Vėrinėlis;KODELČIUKŲ;4039903678;Taip;0;1;4;5
13692;Vėrinėlis;KODELČIUKŲ;3729926575;Ne;0;1;4;5
13693;Vėrinėlis;KODELČIUKŲ;7167034587;Taip;0;3;0;3
13694;Vėrinėlis;KODELČIUKŲ;9511678036;Taip;0;1;4;5
13695;Vėrinėlis;KODELČIUKŲ;3369668445;Taip;3;1;0;4
13696;Vėrinėlis;KODELČIUKŲ;8728166391;Taip;0;1;1;2
13697;Vėrinėlis;KODELČIUKŲ;5720076968;Taip;7;1;4;12
13698;Vėrinėlis;KODELČIUKŲ;8195455092;Taip;4;0;0;4
13699;Vėrinėlis;ŽIRNIUKAI;1769852084;Taip;10;0;1;11
13700;Vėrinėlis;ŽIRNIUKAI;4718732261;Taip;0;1;0;1
13701;Vėrinėlis;ŽIRNIUKAI;4981127515;Taip;0;0;2;2
13702;Vėrinėlis;ŽIRNIUKAI;8329989952;Taip;9;0;0;9
13703;Vėrinėlis;ŽIRNIUKAI;3202518504;Taip;0;0;1;1
13704;Vėrinėlis;ŽIRNIUKAI;4752902173;Taip;6;4;1;11
13705;Vėrinėlis;ŽIRNIUKAI;7237945125;Taip;7;0;1;8
13706;Vėrinėlis;ŽIRNIUKAI;5600815908;Taip;5;0;0;5
13707;Vėrinėlis;ŽIRNIUKAI;7367485961;Ne;0;0;1;1
13708;Vėrinėlis;ŽIRNIUKAI;1736733257;Taip;10;0;1;11
13709;Vėrinėlis;ŽIRNIUKAI;2687583764;Taip;13;0;2;15
13710;Vėrinėlis;ŽIRNIUKAI;2633143128;Taip;8;0;1;9
13711;Vėrinėlis;ŽIRNIUKAI;9419245081;Taip;0;1;3;4
13712;Vėrinėlis;ŽIRNIUKAI;7817387800;Taip;6;0;0;6
13713;Vėrinėlis;ŽIRNIUKAI;6377447141;Ne;10;0;4;14
13714;Vėrinėlis;ŽIRNIUKAI;7371908331;Taip;0;0;5;5
13715;Vėrinėlis;ŽIRNIUKAI;2087129236;Taip;5;0;2;7
13716;Vėrinėlis;ŽIRNIUKAI;6392625405;Ne;5;2;0;7
13717;Vėrinėlis;ŽIRNIUKAI;1896980533;Taip;9;0;1;10
13718;Vėrinėlis;ŽIRNIUKAI;2732572235;Taip;0;0;2;2
13719;Vėrinėlis;ŽIRNIUKAI;8483525051;Taip;0;0;1;1
13720;Vėrinėlis;ŽIRNIUKAI;8397025332;Taip;2;0;1;3
13721;Vėrinėlis;ŽIRNIUKAI;6576726481;Taip;2;0;1;3
13722;Vėrinėlis;VARPELIAI;8655158155;Taip;5;4;0;9
13723;Vėrinėlis;VARPELIAI;3829146401;Taip;2;1;1;4
13724;Vėrinėlis;VARPELIAI;6177784856;Taip;5;6;0;11
13725;Vėrinėlis;VARPELIAI;9388153932;Taip;11;0;5;16
13726;Vėrinėlis;VARPELIAI;6362125404;Ne;10;3;0;13
13727;Vėrinėlis;VARPELIAI;9599724421;Taip;7;1;0;8
13728;Vėrinėlis;VARPELIAI;7216867683;Taip;2;3;0;5
13729;Vėrinėlis;VARPELIAI;8336694468;Taip;6;0;0;6
13730;Vėrinėlis;VARPELIAI;2731207996;Taip;0;1;6;7
13731;Vėrinėlis;VARPELIAI;9522506115;Taip;7;2;0;9
13732;Vėrinėlis;VARPELIAI;2561255096;Taip;15;0;1;16
13733;Vėrinėlis;VARPELIAI;5821107898;Taip;12;0;1;13
13734;Vėrinėlis;VARPELIAI;9351658311;Taip;0;9;0;9
13735;Vėrinėlis;VARPELIAI;3392458614;Taip;5;2;0;7
13736;Vėrinėlis;BORUŽĖLĖS;8759487574;Taip;11;2;0;13
13737;Vėrinėlis;BORUŽĖLĖS;4819016753;Taip;6;0;0;6
13738;Vėrinėlis;BORUŽĖLĖS;1910385020;Taip;6;0;0;6
13739;Vėrinėlis;BORUŽĖLĖS;2078857084;Taip;2;0;2;4
13740;Vėrinėlis;BORUŽĖLĖS;3934652683;Taip;15;0;1;16
13741;Vėrinėlis;BORUŽĖLĖS;6904733283;Taip;5;0;5;10
13742;Vėrinėlis;BORUŽĖLĖS;4446546335;Taip;0;0;1;1
13743;Vėrinėlis;BORUŽĖLĖS;3718510933;Ne;4;0;0;4
13744;Vėrinėlis;BORUŽĖLĖS;2501287529;Taip;0;1;0;1
13745;Vėrinėlis;BORUŽĖLĖS;8904833339;Taip;4;1;0;5
13746;Vėrinėlis;BORUŽĖLĖS;3312501759;Taip;4;1;0;5
13747;Vėrinėlis;BORUŽĖLĖS;9217188911;Taip;0;21;0;21
13748;Vėrinėlis;BORUŽĖLĖS;7414937335;Taip;6;8;0;14
13749;Vėrinėlis;BORUŽĖLĖS;2574507205;Taip;1;3;0;4
13750;Vėrinėlis;BORUŽĖLĖS;6671382987;Taip;14;0;0;14
13751;Vėrinėlis;BORUŽĖLĖS;4852563692;Taip;0;1;0;1
13752;Vėrinėlis;BORUŽĖLĖS;7953446502;Taip;0;18;0;18
13753;Vėrinėlis;BORUŽĖLĖS;5865529907;Taip;14;0;1;15
13754;Vėrinėlis;BORUŽĖLĖS;9613642664;Taip;0;4;0;4
13755;Vėrinėlis;BORUŽĖLĖS;2467242845;Ne;0;5;0;5
13756;Vėrinėlis;SVEIKUOLIAI;1909742394;Taip;6;0;0;6
13757;Vėrinėlis;SVEIKUOLIAI;6176308531;Taip;5;4;0;9
13758;Vėrinėlis;SVEIKUOLIAI;3070965434;Taip;0;2;2;4
13759;Vėrinėlis;SVEIKUOLIAI;6154618103;Taip;0;1;0;1
13760;Vėrinėlis;SVEIKUOLIAI;3563114419;Ne;7;1;1;9
13761;Vėrinėlis;SVEIKUOLIAI;3973272659;Taip;2;1;1;4
13762;Vėrinėlis;SVEIKUOLIAI;8032396191;Taip;0;0;1;1
13763;Vėrinėlis;SVEIKUOLIAI;8716965452;Taip;15;2;0;17
13764;Vėrinėlis;SVEIKUOLIAI;7584124339;Taip;6;5;0;11
13765;Vėrinėlis;SVEIKUOLIAI;9352630743;Taip;0;1;1;2
13766;Vėrinėlis;SVEIKUOLIAI;4859330774;Taip;15;1;0;16
13767;Vėrinėlis;SVEIKUOLIAI;8543081245;Taip;11;6;0;17
13768;Vėrinėlis;SVEIKUOLIAI;1800434426;Taip;0;2;0;2
13769;Vėrinėlis;SVEIKUOLIAI;3958551159;Taip;6;0;0;6
13770;Vėrinėlis;SVEIKUOLIAI;5614185158;Taip;7;2;0;9
13771;Vėrinėlis;SVEIKUOLIAI;5539714292;Ne;8;5;0;13
13772;Vėrinėlis;SVEIKUOLIAI;2516474825;Taip;16;0;0;16
13773;Vėrinėlis;SVEIKUOLIAI;9058127692;Taip;8;2;0;10
13774;Vėrinėlis;SVEIKUOLIAI;1278914183;Taip;16;0;1;17
13775;Vėrinėlis;SVEIKUOLIAI;7573209012;Taip;2;0;0;2
13776;Vėrinėlis;SVEIKUOLIAI;2015928440;Taip;8;1;1;10
13777;Vėrinėlis;ŠIRDELĖS;7734163541;Taip;0;0;7;7
13778;Vėrinėlis;ŠIRDELĖS;4378592116;Taip;1;0;6;7
13779;Vėrinėlis;ŠIRDELĖS;7517113022;Taip;6;0;0;6
13780;Vėrinėlis;ŠIRDELĖS;1841277321;Taip;0;5;0;5
13781;Vėrinėlis;ŠIRDELĖS;5588658517;Taip;3;2;0;5
13782;Vėrinėlis;ŠIRDELĖS;5653635907;Taip;1;3;0;4
13783;Vėrinėlis;ŠIRDELĖS;1152010178;Taip;5;1;1;7
13784;Vėrinėlis;ŠIRDELĖS;2038169885;Taip;1;14;0;15
13785;Vėrinėlis;ŠIRDELĖS;9375922889;Taip;8;2;0;10
13786;Vėrinėlis;ŠIRDELĖS;5813009126;Taip;0;4;0;4
13787;Vėrinėlis;ŠIRDELĖS;3511809411;Taip;1;8;0;9
13788;Vėrinėlis;ŠIRDELĖS;3535652648;Taip;6;1;1;8
13789;Vėrinėlis;ŠIRDELĖS;9217815657;Taip;0;4;0;4
13790;Vėrinėlis;ŠIRDELĖS;4403875733;Taip;3;0;1;4
13791;Vėrinėlis;ŠIRDELĖS;4700093328;Taip;13;0;0;13
13792;Vėrinėlis;ŠIRDELĖS;1939318286;Taip;5;1;0;6
13793;Vėrinėlis;ŠIRDELĖS;3687250255;Taip;1;0;0;1
13794;Vėrinėlis;ŠIRDELĖS;2847839917;Ne;10;0;1;11
13795;Vėrinėlis;ŠIRDELĖS;7311740859;Taip;5;1;0;6
13796;Vėrinėlis;ŠIRDELĖS;6905591549;Taip;2;0;0;2
13797;Viltenė;Drugeliai;3625763429;Taip;5;3;0;8
13798;Viltenė;Drugeliai;2392304909;Taip;6;0;0;6
13799;Viltenė;Drugeliai;5781655552;Taip;14;1;0;15
13800;Viltenė;Drugeliai;2410868015;Taip;0;17;0;17
13801;Viltenė;Drugeliai;4616047113;Ne;0;11;0;11
13802;Viltenė;Drugeliai;6810811656;Taip;5;2;0;7
13803;Viltenė;Drugeliai;9228677568;Taip;0;1;0;1
13804;Viltenė;Drugeliai;3905014810;Taip;0;10;0;10
13805;Viltenė;Drugeliai;9157616307;Taip;3;2;0;5
13806;Viltenė;Drugeliai;3052677157;Taip;0;1;0;1
13807;Viltenė;Drugeliai;5522245968;Taip;1;1;0;2
13808;Viltenė;Drugeliai;5552217000;Taip;0;3;0;3
13809;Viltenė;Drugeliai;8527270437;Taip;0;2;0;2
13810;Viltenė;Drugeliai;4195708756;Taip;6;3;0;9
13811;Viltenė;Drugeliai;1081603034;Taip;0;6;0;6
13812;Viltenė;Drugeliai;7500965165;Taip;0;7;0;7
13813;Viltenė;Bitučių;7158824421;Taip;0;1;0;1
13814;Viltenė;Bitučių;2846574130;Taip;1;11;0;12
13815;Viltenė;Bitučių;8336855920;Ne;5;6;0;11
13816;Viltenė;Bitučių;2656363650;Taip;0;3;0;3
13817;Viltenė;Bitučių;2841144656;Taip;0;4;0;4
13818;Viltenė;Bitučių;7810374329;Taip;5;7;0;12
13819;Viltenė;Bitučių;4724382069;Taip;7;1;0;8
13820;Viltenė;Bitučių;4001205912;Taip;8;0;0;8
13821;Viltenė;Bitučių;5077874991;Taip;0;6;0;6
13822;Viltenė;Bitučių;8141954391;Taip;5;2;0;7
13823;Viltenė;Bitučių;4379784712;Taip;4;2;0;6
13824;Viltenė;Bitučių;9095458948;Taip;14;0;0;14
13825;Viltenė;Bitučių;4661430937;Taip;10;0;0;10
13826;Viltenė;Bitučių;5241075224;Taip;0;8;0;8
13827;Viltenė;Boružėlių;6642790962;Taip;10;1;0;11
13828;Viltenė;Boružėlių;9572407405;Taip;0;8;0;8
13829;Viltenė;Boružėlių;3738838707;Taip;0;2;0;2
13830;Viltenė;Boružėlių;8473588098;Ne;0;9;0;9
13831;Viltenė;Boružėlių;3995418079;Taip;0;1;0;1
13832;Viltenė;Boružėlių;1399653129;Taip;0;3;0;3
13833;Viltenė;Boružėlių;7526555727;Ne;0;6;0;6
13834;Viltenė;Boružėlių;3164402142;Taip;0;8;0;8
13835;Viltenė;Boružėlių;1936628249;Taip;0;4;0;4
13836;Viltenė;Boružėlių;7912396297;Taip;0;3;0;3
13837;Viltenė;Boružėlių;4036109404;Taip;0;1;0;1
13838;Viltenė;Boružėlių;4604298036;Taip;0;7;0;7
13839;Viltenė;Boružėlių;9197007374;Taip;0;4;0;4
13840;Viltenė;Boružėlių;9242034622;Taip;0;1;0;1
13841;Viltenė;Boružėlių;6621273812;Taip;0;1;0;1
13842;Viltenė;Boružėlių;2383607612;Taip;5;7;0;12
13843;Viltenė;Boružėlių;1496943250;Taip;0;1;0;1
13844;Viltenė;Gandriukų;6481491422;Taip;2;0;0;2
13845;Viltenė;Gandriukų;2884698447;Taip;0;1;0;1
13846;Viltenė;Gandriukų;6060648988;Taip;0;3;0;3
13847;Viltenė;Gandriukų;1840626621;Taip;0;8;0;8
13848;Viltenė;Gandriukų;8549631247;Taip;0;6;0;6
13849;Viltenė;Gandriukų;7796422726;Taip;0;6;0;6
13850;Viltenė;Gandriukų;2815105107;Taip;0;1;0;1
13851;Viltenė;Gandriukų;6511850468;Taip;0;2;0;2
13852;Viltenė;Gandriukų;4945108189;Taip;1;0;0;1
13853;Viltenė;Gandriukų;5850652322;Taip;6;0;0;6
13854;Viltenė;Gandriukų;8110413064;Taip;0;1;0;1
13855;Viltenė;Gandriukų;1243595112;Taip;0;1;0;1
13856;Viltenė;Gandriukų;3073228245;Ne;15;0;0;15
13857;Viltenė;Gandriukų;4468743044;Taip;2;2;0;4
13858;Viltenė;Gandriukų;6355857716;Taip;1;2;0;3
13859;Viltenė;Gandriukų;5929135840;Taip;3;0;0;3
13860;Viltenė;Gandriukų;6473925760;Taip;9;0;0;9
13861;Viltenė;Gandriukų;8458769051;Taip;0;2;0;2
13862;Viltenė;Aitvariukai;5083515613;Ne;3;1;0;4
13863;Viltenė;Aitvariukai;2137929911;Taip;0;6;0;6
13864;Viltenė;Aitvariukai;9185054066;Taip;0;3;0;3
13865;Viltenė;Aitvariukai;2502099784;Taip;0;5;0;5
13866;Viltenė;Aitvariukai;5599943846;Taip;0;1;0;1
13867;Viltenė;Aitvariukai;6296509460;Taip;0;5;0;5
13868;Viltenė;Aitvariukai;9101795131;Taip;0;4;0;4
13869;Viltenė;Aitvariukai;3908574248;Taip;0;1;0;1
13870;Viltenė;Aitvariukai;8439859449;Taip;21;0;0;21
13871;Viltenė;Aitvariukai;2976705872;Taip;0;1;0;1
13872;Viltenė;Aitvariukai;2192086488;Taip;0;6;0;6
13873;Viltenė;Aitvariukai;2026654467;Ne;0;2;0;2
13874;Viltenė;Aitvariukai;4641365031;Taip;5;7;0;12
13875;Viltenė;Aitvariukai;7277455268;Taip;0;18;0;18
13876;Viltenė;Aitvariukai;3245284852;Taip;2;1;0;3
13877;Viltenė;Aitvariukai;2786572522;Taip;0;1;0;1
13878;Viltenė;Aitvariukai;6171399579;Taip;5;2;0;7
13879;Viltenė;Geniukų;5604263567;Taip;5;0;0;5
13880;Viltenė;Geniukų;1822220265;Taip;5;2;0;7
13881;Viltenė;Geniukų;6349032936;Taip;14;0;0;14
13882;Viltenė;Geniukų;1423254631;Taip;0;2;0;2
13883;Viltenė;Geniukų;3002690526;Taip;1;1;0;2
13884;Viltenė;Geniukų;6276349499;Taip;0;1;0;1
13885;Viltenė;Geniukų;1054469254;Taip;0;1;0;1
13886;Viltenė;Geniukų;6063181025;Taip;0;1;0;1
13887;Viltenė;Geniukų;3018271511;Taip;0;4;0;4
13888;Viltenė;Geniukų;3389110405;Taip;0;1;0;1
13889;Viltenė;Geniukų;4319685140;Taip;0;5;0;5
13890;Viltenė;Geniukų;8125023386;Taip;0;1;0;1
13891;Viltenė;Geniukų;9035687504;Taip;0;1;0;1
13892;Viltenė;Geniukų;1629377078;Ne;0;3;0;3
13893;Viltenė;Geniukų;3746923185;Taip;6;3;0;9
13894;Viltenė;Geniukų;1557503831;Ne;0;4;0;4
13895;Viltenė;Saulutės;6848403057;Taip;0;1;0;1
13896;Viltenė;Saulutės;1615415742;Taip;10;3;0;13
13897;Viltenė;Saulutės;7994367286;Taip;0;3;0;3
13898;Viltenė;Saulutės;9935236068;Ne;0;2;0;2
13899;Viltenė;Saulutės;6664059418;Taip;6;5;0;11
13900;Viltenė;Saulutės;2141002432;Taip;0;8;0;8
13901;Viltenė;Saulutės;1362308882;Taip;0;1;0;1
13902;Viltenė;Saulutės;8920533673;Taip;6;1;0;7
13903;Viltenė;Saulutės;5024192785;Taip;4;1;0;5
13904;Viltenė;Saulutės;1918867591;Taip;6;5;0;11
13905;Viltenė;Saulutės;7559243300;Taip;6;2;0;8
13906;Viltenė;Saulutės;8512665706;Taip;3;0;0;3
13907;Viltenė;Saulutės;3560474943;Taip;0;13;0;13
13908;Viltenė;Saulutės;2840208662;Taip;0;1;0;1
13909;Viltenė;Saulutės;1252657362;Taip;11;0;0;11
13910;Viltenė;Saulutės;2559945034;Taip;2;1;0;3
13911;Viltenė;Saulutės;9055821628;Taip;0;2;0;2
13912;Viltenė;Saulutės;9858998005;Taip;3;1;0;4
13913;Viltenė;Saulutės;7726650894;Ne;8;2;0;10
13914;Viltenė;Saulutės;3709362712;Ne;0;1;0;1
13915;Viltenė;Lapiukų;2034259692;Taip;4;3;0;7
13916;Viltenė;Lapiukų;3473533533;Taip;0;4;0;4
13917;Viltenė;Lapiukų;8696698257;Taip;0;2;0;2
13918;Viltenė;Lapiukų;8248514570;Taip;5;1;0;6
13919;Viltenė;Lapiukų;2878124826;Taip;0;1;0;1
13920;Viltenė;Lapiukų;2660622296;Taip;1;1;0;2
13921;Viltenė;Lapiukų;4550915388;Ne;0;7;0;7
13922;Viltenė;Lapiukų;8122878153;Taip;0;2;0;2
13923;Viltenė;Lapiukų;9573891616;Taip;0;7;0;7
13924;Viltenė;Lapiukų;4243501722;Taip;1;1;0;2
13925;Viltenė;Lapiukų;6429905246;Taip;7;2;0;9
13926;Viltenė;Lapiukų;6070264006;Taip;5;2;0;7
13927;Viltenė;Lapiukų;3679704404;Taip;0;5;0;5
13928;Viltenė;Lapiukų;1507287948;Taip;0;1;0;1
13929;Viltenė;Lapiukų;9846205631;Taip;0;4;0;4
13930;Viltenė;Lapiukų;9063994291;Taip;0;1;0;1
13931;Viltenė;Voveriukai;6888346135;Taip;13;1;1;15
13932;Viltenė;Voveriukai;2936670828;Ne;0;1;0;1
13933;Viltenė;Voveriukai;5816623708;Taip;21;0;0;21
13934;Viltenė;Voveriukai;5611839058;Taip;0;1;0;1
13935;Viltenė;Voveriukai;4414192600;Taip;11;1;3;15
13936;Viltenė;Voveriukai;2483760198;Ne;0;1;0;1
13937;Viltenė;Voveriukai;8341211836;Taip;0;1;2;3
13938;Viltenė;Voveriukai;6954065006;Taip;0;1;2;3
13939;Viltenė;Voveriukai;6741521720;Taip;0;12;0;12
13940;Viltenė;Voveriukai;2642080849;Taip;1;0;5;6
13941;Viltenė;Voveriukai;6040634853;Taip;2;0;0;2
13942;Viltenė;Voveriukai;7322841332;Taip;9;0;0;9
13943;Viltenė;Voveriukai;1888167096;Taip;0;1;0;1
13944;Viltenė;Voveriukai;3291926243;Taip;0;5;0;5
13945;Viltenė;Voveriukai;2013415571;Taip;2;1;0;3
13946;Viltenė;Voveriukai;2894570917;Taip;1;0;0;1
13947;Viltenė;Voveriukai;1890096287;Taip;1;0;0;1
13948;Viltenė;Kiškučiai;6595715908;Taip;2;1;0;3
13949;Viltenė;Kiškučiai;3347380524;Taip;5;2;0;7
13950;Viltenė;Kiškučiai;1641406030;Ne;6;1;0;7
13951;Viltenė;Kiškučiai;2192673126;Taip;16;0;0;16
13952;Viltenė;Kiškučiai;3157417614;Taip;5;1;0;6
13953;Viltenė;Kiškučiai;5974408492;Taip;0;3;0;3
13954;Viltenė;Kiškučiai;9578037239;Taip;7;0;0;7
13955;Viltenė;Kiškučiai;4615393852;Ne;0;2;0;2
13956;Viltenė;Kiškučiai;8091905944;Taip;5;2;0;7
13957;Viltenė;Kiškučiai;7314937470;Taip;10;0;0;10
13958;Viltenė;Kiškučiai;8150583354;Ne;11;0;0;11
13959;Viltenė;Kiškučiai;9760364123;Taip;6;0;0;6
13960;Viltenė;Kiškučiai;6021086235;Taip;17;0;0;17
13961;Viltenė;Kiškučiai;9862698928;Ne;9;0;0;9
13962;Viltenė;Nykštukų;7993258845;Ne;0;1;0;1
13963;Viltenė;Nykštukų;4981225829;Taip;14;0;0;14
13964;Viltenė;Nykštukų;9424773418;Taip;7;0;0;7
13965;Viltenė;Nykštukų;3343045604;Taip;0;2;0;2
13966;Viltenė;Nykštukų;4537287677;Taip;7;1;0;8
13967;Viltenė;Nykštukų;3306285115;Taip;6;0;0;6
13968;Viltenė;Nykštukų;6992120038;Taip;10;2;0;12
13969;Viltenė;Nykštukų;7331321780;Taip;13;0;0;13
13970;Viltenė;Nykštukų;5707049797;Taip;2;1;0;3
13971;Viltenė;Nykštukų;2036857372;Taip;0;0;3;3
13972;Viltenė;Nykštukų;3853518656;Taip;0;4;0;4
13973;Viltenė;Nykštukų;8588903828;Taip;0;1;0;1
13974;Viltenė;Nykštukų;9288406881;Taip;0;2;0;2
13975;Viltenė;Nykštukų;7370710652;Taip;0;1;1;2
13976;Viltenė;Nykštukų;9582577013;Taip;7;0;0;7
13977;Viltenė;Triušiukai;6379567497;Taip;0;2;0;2
13978;Viltenė;Triušiukai;8346933997;Taip;0;1;3;4
13979;Viltenė;Triušiukai;8278572246;Taip;0;1;0;1
13980;Viltenė;Triušiukai;1587868835;Taip;0;6;0;6
13981;Viltenė;Triušiukai;9819729046;Ne;0;10;0;10
13982;Viltenė;Triušiukai;8258247750;Taip;16;0;0;16
13983;Viltenė;Triušiukai;6635474168;Taip;16;0;0;16
13984;Viltenė;Triušiukai;7754951374;Taip;3;1;0;4
13985;Viltenė;Triušiukai;7145240197;Taip;9;0;0;9
13986;Viltenė;Triušiukai;7058586628;Taip;10;6;0;16
13987;Viltenė;Triušiukai;7005219570;Ne;0;1;0;1
13988;Viltenė;Triušiukai;4552355700;Taip;3;0;1;4
13989;Viltenė;Triušiukai;2850146424;Taip;0;8;0;8
13990;Viltenė;Triušiukai;1318750938;Taip;0;3;0;3
13991;Voveraitė;ŽVIRBLIUKŲ;6684234832;Taip;0;2;0;2
13992;Voveraitė;ŽVIRBLIUKŲ;8119493388;Taip;5;1;0;6
13993;Voveraitė;ŽVIRBLIUKŲ;9715405072;Taip;5;3;0;8
13994;Voveraitė;ŽVIRBLIUKŲ;5804351872;Taip;0;0;1;1
13995;Voveraitė;ŽVIRBLIUKŲ;5510544648;Taip;0;0;1;1
13996;Voveraitė;ŽVIRBLIUKŲ;6959751328;Taip;5;0;0;5
13997;Voveraitė;ŽVIRBLIUKŲ;8803052781;Taip;0;8;1;9
13998;Voveraitė;ŽVIRBLIUKŲ;8257748589;Taip;0;1;0;1
13999;Voveraitė;ŽVIRBLIUKŲ;1522307865;Taip;0;7;0;7
14000;Voveraitė;ŽVIRBLIUKŲ;3811230983;Taip;5;1;11;17
14001;Voveraitė;ŽVIRBLIUKŲ;2142507659;Taip;5;0;0;5
14002;Voveraitė;ŽVIRBLIUKŲ;5395915359;Taip;5;0;0;5
14003;Voveraitė;ŽVIRBLIUKŲ;3247101840;Taip;0;0;4;4
14004;Voveraitė;ŽVIRBLIUKŲ;6643600680;Taip;0;0;6;6
14005;Voveraitė;ŽVIRBLIUKŲ;4460047281;Taip;0;0;2;2
14006;Voveraitė;ŽVIRBLIUKŲ;3877673172;Taip;3;2;7;12
14007;Voveraitė;ŽVIRBLIUKŲ;7008576999;Taip;0;3;0;3
14008;Voveraitė;ŽVIRBLIUKŲ;2716400502;Taip;0;3;0;3
14009;Voveraitė;ŽVIRBLIUKŲ;9117809080;Ne;5;0;1;6
14010;Voveraitė;ŽVIRBLIUKŲ;7861722125;Taip;10;1;1;12
14011;Voveraitė;ŽVIRBLIUKŲ;6994680282;Taip;0;2;0;2
14012;Voveraitė;VOVERIUKŲ;1515087924;Taip;7;1;0;8
14013;Voveraitė;VOVERIUKŲ;9195700962;Ne;16;3;0;19
14014;Voveraitė;VOVERIUKŲ;5138855000;Taip;2;2;0;4
14015;Voveraitė;VOVERIUKŲ;1340379090;Taip;6;0;0;6
14016;Voveraitė;VOVERIUKŲ;9912862474;Taip;9;2;0;11
14017;Voveraitė;VOVERIUKŲ;1960385335;Ne;10;1;0;11
14018;Voveraitė;VOVERIUKŲ;2594535017;Ne;0;2;0;2
14019;Voveraitė;VOVERIUKŲ;4563198733;Taip;5;2;0;7
14020;Voveraitė;VOVERIUKŲ;8373093305;Taip;4;0;0;4
14021;Voveraitė;VOVERIUKŲ;9514425475;Taip;6;1;0;7
14022;Voveraitė;VOVERIUKŲ;6891841301;Taip;0;10;0;10
14023;Voveraitė;VOVERIUKŲ;5935777154;Taip;0;1;0;1
14024;Voveraitė;VOVERIUKŲ;6007396459;Taip;11;0;0;11
14025;Voveraitė;VOVERIUKŲ;4054841724;Taip;21;0;0;21
14026;Voveraitė;VOVERIUKŲ;2304604061;Taip;9;8;0;17
14027;Voveraitė;VOVERIUKŲ;5956830012;Taip;4;2;0;6
14028;Voveraitė;VOVERIUKŲ;8344323109;Taip;10;1;0;11
14029;Voveraitė;VOVERIUKŲ;1141304286;Taip;9;2;0;11
14030;Voveraitė;VOVERIUKŲ;1663784931;Taip;13;2;0;15
14031;Voveraitė;VOVERIUKŲ;7744504020;Taip;0;1;0;1
14032;Voveraitė;KIŠKUČIŲ;9537862791;Taip;5;0;0;5
14033;Voveraitė;KIŠKUČIŲ;4478984171;Taip;0;1;0;1
14034;Voveraitė;KIŠKUČIŲ;3736638759;Taip;0;2;0;2
14035;Voveraitė;KIŠKUČIŲ;9011096222;Taip;11;0;10;21
14036;Voveraitė;KIŠKUČIŲ;3058377539;Taip;0;5;0;5
14037;Voveraitė;KIŠKUČIŲ;8507818993;Taip;0;3;0;3
14038;Voveraitė;KIŠKUČIŲ;8746008166;Taip;7;2;0;9
14039;Voveraitė;KIŠKUČIŲ;8084986328;Taip;0;2;0;2
14040;Voveraitė;KIŠKUČIŲ;6261152304;Taip;1;0;0;1
14041;Voveraitė;KIŠKUČIŲ;8220437514;Taip;0;2;0;2
14042;Voveraitė;KIŠKUČIŲ;4060906360;Taip;0;3;0;3
14043;Voveraitė;KIŠKUČIŲ;5069929376;Taip;7;0;0;7
14044;Voveraitė;KIŠKUČIŲ;7379045686;Taip;6;1;0;7
14045;Voveraitė;KIŠKUČIŲ;1961699588;Taip;21;0;0;21
14046;Voveraitė;KIŠKUČIŲ;1979839656;Taip;0;1;0;1
14047;Voveraitė;KIŠKUČIŲ;9599137158;Taip;11;1;0;12
14048;Voveraitė;KIŠKUČIŲ;8121423914;Taip;4;2;0;6
14049;Voveraitė;KIŠKUČIŲ;4379372200;Ne;5;2;0;7
14050;Voveraitė;KIŠKUČIŲ;8528435385;Taip;4;1;0;5
14051;Voveraitė;KIŠKUČIŲ;8937070276;Taip;5;1;0;6
14052;Voveraitė;KIŠKUČIŲ;3859125174;Taip;2;0;0;2
14053;Voveraitė;KODĖLČIUKŲ;3274422598;Taip;1;1;0;2
14054;Voveraitė;KODĖLČIUKŲ;8438808999;Ne;4;1;2;7
14055;Voveraitė;KODĖLČIUKŲ;9397887760;Taip;0;2;0;2
14056;Voveraitė;KODĖLČIUKŲ;4151144278;Ne;5;0;0;5
14057;Voveraitė;KODĖLČIUKŲ;5598685365;Taip;5;1;0;6
14058;Voveraitė;KODĖLČIUKŲ;1482908802;Taip;0;5;0;5
14059;Voveraitė;KODĖLČIUKŲ;9887747925;Taip;4;1;0;5
14060;Voveraitė;KODĖLČIUKŲ;7605427741;Taip;3;4;0;7
14061;Voveraitė;KODĖLČIUKŲ;3344886524;Ne;0;0;1;1
14062;Voveraitė;KODĖLČIUKŲ;1046297151;Taip;0;1;0;1
14063;Voveraitė;KODĖLČIUKŲ;4996778855;Taip;0;1;0;1
14064;Voveraitė;KODĖLČIUKŲ;3432886020;Taip;0;2;0;2
14065;Voveraitė;KODĖLČIUKŲ;8154347030;Taip;9;6;0;15
14066;Voveraitė;KODĖLČIUKŲ;2482908027;Taip;0;7;0;7
14067;Voveraitė;KODĖLČIUKŲ;8692155848;Taip;0;0;2;2
14068;Voveraitė;KODĖLČIUKŲ;1040007977;Taip;4;2;0;6
14069;Voveraitė;KODĖLČIUKŲ;3881039538;Taip;4;1;2;7
14070;Voveraitė;KODĖLČIUKŲ;7281753415;Taip;4;1;2;7
14071;Voveraitė;KODĖLČIUKŲ;8021563060;Taip;0;3;4;7
14072;Voveraitė;KODĖLČIUKŲ;9816971493;Taip;0;1;8;9
14073;Voveraitė;MEŠKIUKŲ;8881070477;Taip;9;1;0;10
14074;Voveraitė;MEŠKIUKŲ;7253112849;Taip;0;1;0;1
14075;Voveraitė;MEŠKIUKŲ;7499150201;Taip;2;0;0;2
14076;Voveraitė;MEŠKIUKŲ;3217609712;Taip;5;2;0;7
14077;Voveraitė;MEŠKIUKŲ;3088866739;Taip;0;2;0;2
14078;Voveraitė;MEŠKIUKŲ;4207949414;Taip;4;0;0;4
14079;Voveraitė;MEŠKIUKŲ;4547087565;Ne;0;2;0;2
14080;Voveraitė;MEŠKIUKŲ;7474214701;Taip;0;2;0;2
14081;Voveraitė;MEŠKIUKŲ;6853358062;Taip;6;0;0;6
14082;Voveraitė;MEŠKIUKŲ;3539069705;Taip;0;1;0;1
14083;Voveraitė;MEŠKIUKŲ;9544043839;Taip;5;0;0;5
14084;Voveraitė;MEŠKIUKŲ;6609235703;Ne;0;8;0;8
14085;Voveraitė;MEŠKIUKŲ;1528968162;Ne;6;2;0;8
14086;Voveraitė;MEŠKIUKŲ;3159659638;Taip;9;3;0;12
14087;Voveraitė;MEŠKIUKŲ;3532178114;Taip;9;3;0;12
14088;Voveraitė;MEŠKIUKŲ;8992548689;Ne;5;4;0;9
14089;Voveraitė;MEŠKIUKŲ;5196036817;Taip;0;5;0;5
14090;Voveraitė;MEŠKIUKŲ;1813440087;Taip;6;0;0;6
14091;Voveraitė;MEŠKIUKŲ;8534405352;Taip;15;0;0;15
14092;Voveraitė;MEŠKIUKŲ;5018335921;Taip;9;2;0;11
14093;Voveraitė;BORUŽĖLIŲ;3703062195;Taip;0;1;0;1
14094;Voveraitė;BORUŽĖLIŲ;3381417855;Taip;0;2;0;2
14095;Voveraitė;BORUŽĖLIŲ;5437283673;Taip;5;1;0;6
14096;Voveraitė;BORUŽĖLIŲ;3029983180;Taip;0;5;0;5
14097;Voveraitė;BORUŽĖLIŲ;5576058454;Taip;5;0;0;5
14098;Voveraitė;BORUŽĖLIŲ;7797966139;Taip;8;0;1;9
14099;Voveraitė;BORUŽĖLIŲ;4079618555;Taip;5;2;1;8
14100;Voveraitė;BORUŽĖLIŲ;6886337758;Taip;0;10;0;10
14101;Voveraitė;BORUŽĖLIŲ;1592633500;Taip;0;3;0;3
14102;Voveraitė;BORUŽĖLIŲ;1629942114;Taip;0;4;0;4
14103;Voveraitė;BORUŽĖLIŲ;1058273156;Taip;0;1;0;1
14104;Voveraitė;BORUŽĖLIŲ;9933037872;Ne;0;2;0;2
14105;Voveraitė;BORUŽĖLIŲ;3615729576;Taip;0;2;1;3
14106;Voveraitė;BORUŽĖLIŲ;6277010268;Taip;7;0;0;7
14107;Voveraitė;BORUŽĖLIŲ;2831224400;Taip;4;5;2;11
14108;Voveraitė;BORUŽĖLIŲ;2763656717;Taip;0;1;8;9
14109;Voveraitė;PELĖDŽIUKŲ;1775800865;Taip;5;2;0;7
14110;Voveraitė;PELĖDŽIUKŲ;1959958256;Ne;8;1;4;13
14111;Voveraitė;PELĖDŽIUKŲ;6649068571;Taip;0;1;0;1
14112;Voveraitė;PELĖDŽIUKŲ;9231751171;Taip;5;1;0;6
14113;Voveraitė;PELĖDŽIUKŲ;54408671673;Taip;0;1;0;1
14114;Voveraitė;PELĖDŽIUKŲ;72154318379;Taip;5;1;0;6
14115;Voveraitė;PELĖDŽIUKŲ;9007031372;Taip;3;3;0;6
14116;Voveraitė;PELĖDŽIUKŲ;7069780513;Taip;5;0;0;5
14117;Voveraitė;PELĖDŽIUKŲ;6433760749;Taip;0;2;0;2
14118;Voveraitė;PELĖDŽIUKŲ;6460834118;Taip;8;0;7;15
14119;Voveraitė;PELĖDŽIUKŲ;4338861332;Taip;0;3;1;4
14120;Voveraitė;PELĖDŽIUKŲ;7314148938;Taip;0;1;0;1
14121;Voveraitė;PELĖDŽIUKŲ;4511771924;Taip;0;1;0;1
14122;Voveraitė;PELĖDŽIUKŲ;602726070;Taip;0;1;0;1
14123;Voveraitė;PELĖDŽIUKŲ;4163635632;Taip;0;3;2;5
14124;Voveraitė;PELĖDŽIUKŲ;1397274691;Taip;0;4;0;4
14125;Voveraitė;DRUGELIŲ;1441921029;Taip;0;2;0;2
14126;Voveraitė;DRUGELIŲ;7531020548;Taip;5;2;0;7
14127;Voveraitė;DRUGELIŲ;4300235743;Taip;1;1;0;2
14128;Voveraitė;DRUGELIŲ;1510853268;Taip;0;1;0;1
14129;Voveraitė;DRUGELIŲ;3388547792;Taip;0;4;0;4
14130;Voveraitė;DRUGELIŲ;8719547570;Taip;4;0;0;4
14131;Voveraitė;DRUGELIŲ;3475601049;Taip;6;0;0;6
14132;Voveraitė;DRUGELIŲ;4017408873;Taip;0;0;2;2
14133;Voveraitė;DRUGELIŲ;7533728486;Taip;1;1;0;2
14134;Voveraitė;DRUGELIŲ;1550830434;Taip;5;5;0;10
14135;Voveraitė;DRUGELIŲ;5114768009;Taip;5;1;0;6
14136;Voveraitė;DRUGELIŲ;1045204378;Taip;0;1;0;1
14137;Voveraitė;DRUGELIŲ;4605007814;Taip;0;2;0;2
14138;Voveraitė;DRUGELIŲ;4911291891;Taip;0;2;15;17
14139;Voveraitė;DRUGELIŲ;4782336282;Taip;7;0;0;7
14140;Voveraitė;DRUGELIŲ;6415024059;Taip;0;7;0;7
14141;Voveraitė;DRUGELIŲ;4350450125;Taip;0;12;0;12
14142;Voveraitė;DRUGELIŲ;8913940646;Taip;0;2;8;10
14143;Voveraitė;DRUGELIŲ;1201270622;Taip;0;2;6;8
14144;Voveraitė;DRUGELIŲ;7238482039;Taip;7;0;9;16
14145;Voveraitė;DRUGELIŲ;8733354669;Taip;0;0;1;1
14146;Voveraitė;DRUGELIŲ;5605614222;Taip;0;0;1;1
14147;Voveraitė;NYKŠTUKŲ;6579193196;Ne;1;0;1;2
14148;Voveraitė;NYKŠTUKŲ;8940421826;Taip;0;0;1;1
14149;Voveraitė;NYKŠTUKŲ;9332936763;Taip;1;0;5;6
14150;Voveraitė;NYKŠTUKŲ;6206817227;Taip;6;0;0;6
14151;Voveraitė;NYKŠTUKŲ;8206634977;Taip;10;3;2;15
14152;Voveraitė;NYKŠTUKŲ;3068683904;Taip;9;0;4;13
14153;Voveraitė;NYKŠTUKŲ;3600230896;Taip;7;0;3;10
14154;Voveraitė;NYKŠTUKŲ;1294012085;Ne;0;9;0;9
14155;Voveraitė;NYKŠTUKŲ;9363490578;Taip;5;7;0;12
14156;Voveraitė;NYKŠTUKŲ;8217771158;Taip;0;7;0;7
14157;Voveraitė;NYKŠTUKŲ;3409709168;Taip;1;0;2;3
14158;Voveraitė;NYKŠTUKŲ;1045121363;Taip;7;0;0;7
14159;Voveraitė;NYKŠTUKŲ;4319786615;Taip;10;1;0;11
14160;Voveraitė;NYKŠTUKŲ;4430631207;Ne;12;0;0;12
14161;Voveraitė;NYKŠTUKŲ;4741175948;Ne;0;0;4;4
14162;Voveraitė;NYKŠTUKŲ;7652950762;Taip;11;0;1;12
14163;Voveraitė;NYKŠTUKŲ;6092848276;Ne;6;0;1;7
14164;Voveraitė;NYKŠTUKŲ;4533816630;Ne;4;1;0;5
14165;Voveraitė;NYKŠTUKŲ;1237440400;Ne;12;0;0;12
14166;Voveraitė;NYKŠTUKŲ;8664568879;Taip;0;1;0;1
14167;Voveraitė;NYKŠTUKŲ;3261542931;Ne;10;0;2;12
14168;Voveraitė;GENIUKŲ;5467979968;Ne;0;1;0;1
14169;Voveraitė;GENIUKŲ;5296850349;Taip;0;1;20;21
14170;Voveraitė;GENIUKŲ;51213803814;Taip;0;1;0;1
14171;Voveraitė;GENIUKŲ;2304004487;Taip;2;1;0;3
14172;Voveraitė;GENIUKŲ;36749754999;Taip;0;1;0;1
14173;Voveraitė;GENIUKŲ;6819742525;Ne;0;1;0;1
14174;Voveraitė;GENIUKŲ;46205148458;Taip;0;1;0;1
14175;Voveraitė;GENIUKŲ;4468214107;Taip;0;1;0;1
14176;Voveraitė;GENIUKŲ;9921313716;Taip;0;6;0;6
14177;Voveraitė;GENIUKŲ;9431523085;Taip;0;1;0;1
14178;Voveraitė;GENIUKŲ;4045121781;Taip;0;2;0;2
14179;Voveraitė;GENIUKŲ;7786378018;Taip;5;1;0;6
14180;Voveraitė;GENIUKŲ;5449490074;Taip;0;2;15;17
14181;Voveraitė;GENIUKŲ;6690309946;Taip;0;3;0;3
14182;Voveraitė;GENIUKŲ;6653141009;Taip;0;1;0;1
14183;Voveraitė;GENIUKŲ;2208396431;Taip;5;3;0;8
14184;Voveraitė;GENIUKŲ;1772758517;Taip;0;1;0;1
14185;Voveraitė;LAPIUKŲ;2552772063;Ne;0;0;1;1
14186;Voveraitė;LAPIUKŲ;8152541593;Taip;14;0;0;14
14187;Voveraitė;LAPIUKŲ;4891757467;Taip;0;0;10;10
14188;Voveraitė;LAPIUKŲ;9218074631;Taip;3;0;2;5
14189;Voveraitė;LAPIUKŲ;1921260351;Taip;0;0;1;1
14190;Voveraitė;LAPIUKŲ;3452040361;Taip;5;4;1;10
14191;Voveraitė;LAPIUKŲ;8382950248;Taip;0;0;4;4
14192;Voveraitė;LAPIUKŲ;8695525951;Taip;5;0;4;9
14193;Voveraitė;LAPIUKŲ;6443288864;Taip;0;2;1;3
14194;Voveraitė;LAPIUKŲ;6650343917;Taip;6;4;2;12
14195;Voveraitė;LAPIUKŲ;8451803815;Taip;0;0;1;1
14196;Voveraitė;EŽIUKŲ;7969862374;Taip;9;0;2;11
14197;Voveraitė;EŽIUKŲ;4233627593;Taip;8;0;0;8
14198;Voveraitė;EŽIUKŲ;2446269570;Taip;1;4;7;12
14199;Voveraitė;EŽIUKŲ;2761041681;Taip;10;0;0;10
14200;Voveraitė;EŽIUKŲ;8074808131;Taip;13;0;2;15
14201;Voveraitė;EŽIUKŲ;8675606844;Taip;0;2;1;3
14202;Voveraitė;EŽIUKŲ;8229145014;Ne;10;0;1;11
14203;Voveraitė;EŽIUKŲ;3168493145;Taip;0;0;4;4
14204;Voveraitė;EŽIUKŲ;2118244290;Taip;0;0;2;2
14205;Voveraitė;EŽIUKŲ;3971484538;Taip;15;0;3;18
14206;Voveraitė;EŽIUKŲ;1542869765;Taip;10;0;1;11
14207;Voveraitė;EŽIUKŲ;2755043670;Taip;13;2;1;16
14208;Voveraitė;EŽIUKŲ;3408126903;Taip;15;0;1;16
14209;Voveraitė;EŽIUKŲ;8627692360;Taip;10;0;0;10
14210;Voveraitė;EŽIUKŲ;7776716092;Taip;4;2;3;9
14211;"Trakų Vokė";Voveriukų;1252962923;Taip;17;0;0;17
14212;"Trakų Vokė";Voveriukų;6076083379;Taip;1;6;0;7
14213;"Trakų Vokė";Voveriukų;5626732539;Taip;0;2;0;2
14214;"Trakų Vokė";Voveriukų;2163756512;Taip;7;0;0;7
14215;"Trakų Vokė";Voveriukų;7346128036;Taip;0;0;1;1
14216;"Trakų Vokė";Voveriukų;2318712376;Taip;0;0;5;5
14217;"Trakų Vokė";Voveriukų;2812442474;Taip;1;0;0;1
14218;"Trakų Vokė";Voveriukų;7671121106;Taip;0;1;4;5
14219;"Trakų Vokė";Voveriukų;9140597911;Taip;0;8;3;11
14220;"Trakų Vokė";Voveriukų;5741852704;Taip;5;0;2;7
14221;"Trakų Vokė";Voveriukų;8636196544;Taip;9;1;0;10
14222;"Trakų Vokė";Voveriukų;1157451579;Taip;21;0;0;21
14223;"Trakų Vokė";Voveriukų;4516714702;Taip;6;0;1;7
14224;"Trakų Vokė";Voveriukų;7797516793;Taip;0;1;0;1
14225;"Trakų Vokė";Voveriukų;3445611475;Taip;5;0;3;8
14226;"Trakų Vokė";Boružėlių;1039690987;Taip;5;0;1;6
14227;"Trakų Vokė";Boružėlių;2516219363;Taip;0;0;6;6
14228;"Trakų Vokė";Boružėlių;6908913934;Taip;10;0;1;11
14229;"Trakų Vokė";Boružėlių;7909596435;Ne;5;6;0;11
14230;"Trakų Vokė";Boružėlių;6751625456;Taip;6;0;0;6
14231;"Trakų Vokė";Boružėlių;7752786907;Taip;11;0;1;12
14232;"Trakų Vokė";Boružėlių;2475068032;Ne;0;0;7;7
14233;"Trakų Vokė";Boružėlių;4601374629;Ne;0;5;0;5
14234;"Trakų Vokė";Boružėlių;4438127190;Ne;8;0;4;12
14235;"Trakų Vokė";Boružėlių;2388817616;Taip;5;0;1;6
14236;"Trakų Vokė";Boružėlių;1080300137;Taip;7;5;1;13
14237;"Trakų Vokė";Boružėlių;2469340933;Taip;0;0;1;1
14238;"Trakų Vokė";Boružėlių;7318458282;Taip;0;1;0;1
14239;"Trakų Vokė";Boružėlių;6732422645;Taip;5;1;1;7
14240;"Trakų Vokė";Boružėlių;5338798362;Taip;6;0;1;7
14241;"Trakų Vokė";Boružėlių;3913623741;Taip;0;0;2;2
14242;"Trakų Vokė";Boružėlių;4014027030;Taip;0;0;2;2
14243;"Trakų Vokė";Boružėlių;7660240598;Ne;3;9;0;12
14244;"Trakų Vokė";KIŠKUČIŲ;9094930495;Taip;4;0;0;4
14245;"Trakų Vokė";KIŠKUČIŲ;9483709021;Taip;0;1;1;2
14246;"Trakų Vokė";KIŠKUČIŲ;2503382218;Taip;1;0;0;1
14247;"Trakų Vokė";KIŠKUČIŲ;8605461082;Taip;4;1;1;6
14248;"Trakų Vokė";KIŠKUČIŲ;6369848950;Ne;0;0;2;2
14249;"Trakų Vokė";KIŠKUČIŲ;4854440884;Taip;18;0;0;18
14250;"Trakų Vokė";KIŠKUČIŲ;2761614687;Taip;12;0;0;12
14251;"Trakų Vokė";KIŠKUČIŲ;9233090228;Taip;0;1;3;4
14252;"Trakų Vokė";KIŠKUČIŲ;6277305384;Taip;0;0;2;2
14253;"Trakų Vokė";KIŠKUČIŲ;2880299812;Taip;0;0;2;2
14254;"Trakų Vokė";KIŠKUČIŲ;1360046096;Taip;11;1;0;12
14255;"Trakų Vokė";KIŠKUČIŲ;3611639112;Taip;4;1;1;6
14256;"Trakų Vokė";KIŠKUČIŲ;3328527700;Taip;5;1;0;6
14257;"Trakų Vokė";KIŠKUČIŲ;5206616285;Taip;0;1;0;1
14258;"Trakų Vokė";KIŠKUČIŲ;2869217654;Taip;0;3;0;3
14259;"Trakų Vokė";KIŠKUČIŲ;4535167417;Taip;0;4;0;4
14260;"Trakų Vokė";KIŠKUČIŲ;2539647111;Taip;7;1;0;8
14261;"Trakų Vokė";KIŠKUČIŲ;6326568445;Taip;0;1;0;1
14262;"Trakų Vokė";KIŠKUČIŲ;8874384610;Taip;20;0;1;21
14263;"Trakų Vokė";KIŠKUČIŲ;2453791555;Ne;7;0;1;8
14264;"Trakų Vokė";KIŠKUČIŲ;9506008651;Taip;5;0;2;7
14265;"Trakų Vokė";BITUČIŲ;3686108421;Taip;0;0;2;2
14266;"Trakų Vokė";BITUČIŲ;5810595458;Taip;0;2;0;2
14267;"Trakų Vokė";BITUČIŲ;8783922678;Taip;7;0;1;8
14268;"Trakų Vokė";BITUČIŲ;5031669549;Taip;0;0;2;2
14269;"Trakų Vokė";BITUČIŲ;8703806519;Taip;11;0;10;21
14270;"Trakų Vokė";BITUČIŲ;4531294784;Taip;12;0;1;13
14271;"Trakų Vokė";BITUČIŲ;2133793458;Taip;0;0;1;1
14272;"Trakų Vokė";BITUČIŲ;3023545645;Taip;0;1;0;1
14273;"Trakų Vokė";BITUČIŲ;5720994041;Taip;5;0;0;5
14274;"Trakų Vokė";BITUČIŲ;6428645462;Taip;6;0;0;6
14275;"Trakų Vokė";BITUČIŲ;7459132887;Taip;1;0;3;4
14276;"Trakų Vokė";BITUČIŲ;1808420447;Taip;0;4;0;4
14277;"Trakų Vokė";BITUČIŲ;6402002961;Taip;0;1;0;1
14278;"Trakų Vokė";BITUČIŲ;3536227018;Taip;0;0;5;5
14279;"Trakų Vokė";BITUČIŲ;6787506848;Taip;0;1;0;1
14280;"Trakų Vokė";BITUČIŲ;3372734352;Taip;4;0;0;4
14281;"Trakų Vokė";BITUČIŲ;1000323267;Taip;8;0;1;9
14282;"Trakų Vokė";BITUČIŲ;1359519176;Taip;0;1;0;1
14283;"Trakų Vokė";BITUČIŲ;1039317931;Taip;0;0;13;13
14284;Zylutė;Katerok;8749296671;Taip;3;1;0;4
14285;Zylutė;Katerok;4592825972;Taip;0;3;0;3
14286;Zylutė;Katerok;8747721198;Taip;9;0;0;9
14287;Zylutė;Katerok;8212030518;Taip;0;4;0;4
14288;Zylutė;Katerok;7706833089;Taip;5;8;0;13
14289;Zylutė;Katerok;3115223229;Ne;0;0;4;4
14290;Zylutė;Katerok;1897871944;Taip;0;4;0;4
14291;Zylutė;Katerok;5687201052;Ne;0;2;0;2
14292;Zylutė;Katerok;3055559237;Taip;0;1;2;3
14293;Zylutė;Katerok;2792217953;Taip;0;3;0;3
14294;Zylutė;Katerok;5948147748;Ne;0;0;3;3
14295;Zylutė;Katerok;7851423851;Taip;5;7;0;12
14296;Zylutė;Katerok;2945894661;Taip;5;0;4;9
14297;Zylutė;Katerok;9986289837;Taip;10;1;3;14
14298;Zylutė;Katerok;1164530815;Taip;0;1;2;3
14299;Zylutė;Katerok;1423890598;Taip;7;0;2;9
14300;Zylutė;Katerok;8618778936;Taip;0;1;0;1
14301;Zylutė;"Vesole misiaki";3332865242;Taip;0;4;0;4
14302;Zylutė;"Vesole misiaki";9162232979;Taip;3;1;0;4
14303;Zylutė;"Vesole misiaki";9457457032;Taip;2;2;0;4
14304;Zylutė;"Vesole misiaki";4543822765;Taip;3;0;0;3
14305;Zylutė;"Vesole misiaki";4566817285;Taip;0;8;0;8
14306;Zylutė;"Vesole misiaki";9737308076;Taip;7;2;0;9
14307;Zylutė;"Vesole misiaki";2999425729;Taip;7;2;0;9
14308;Zylutė;"Vesole misiaki";1290248125;Ne;5;1;0;6
14309;Zylutė;"Vesole misiaki";5027134228;Ne;3;10;0;13
14310;Zylutė;"Vesole misiaki";5589330186;Taip;14;0;0;14
14311;Zylutė;"Vesole misiaki";3848401615;Taip;11;1;1;13
14312;Zylutė;"Vesole misiaki";2913504349;Taip;0;9;0;9
14313;Zylutė;"Vesole misiaki";6601967273;Taip;5;0;0;5
14314;Zylutė;"Vesole misiaki";2501761963;Taip;0;1;0;1
14315;Zylutė;"Vesole misiaki";6833822248;Ne;9;1;0;10
14316;Zylutė;"Vesole misiaki";2489898107;Taip;6;4;0;10
14317;Zylutė;"Vesole misiaki";2313423907;Taip;0;7;0;7
14318;Zylutė;NYKŠTUKAI;3371202491;Ne;0;0;2;2
14319;Zylutė;NYKŠTUKAI;8820121776;Taip;1;0;0;1
14320;Zylutė;NYKŠTUKAI;4611555689;Taip;0;5;0;5
14321;Zylutė;NYKŠTUKAI;1169490002;Taip;8;5;0;13
14322;Zylutė;NYKŠTUKAI;3994691080;Taip;11;0;0;11
14323;Zylutė;NYKŠTUKAI;4894611078;Taip;0;1;0;1
14324;Zylutė;NYKŠTUKAI;7648922403;Ne;6;2;0;8
14325;Zylutė;NYKŠTUKAI;9615779237;Taip;0;3;0;3
14326;Zylutė;NYKŠTUKAI;2604844156;Taip;0;8;0;8
14327;Zylutė;NYKŠTUKAI;2511658462;Ne;5;1;0;6
14328;Zylutė;NYKŠTUKAI;3035745273;Taip;0;3;0;3
14329;Zylutė;NYKŠTUKAI;2620903587;Ne;7;6;0;13
14330;Zylutė;Ručijok;5096881585;Ne;8;1;0;9
14331;Zylutė;Ručijok;4874246039;Taip;0;1;0;1
14332;Zylutė;Ručijok;3058040516;Taip;0;0;3;3
14333;Zylutė;Ručijok;2916622808;Taip;0;0;1;1
14334;Zylutė;Ručijok;5038936878;Taip;0;0;2;2
14335;Zylutė;Ručijok;2491905840;Ne;11;0;1;12
14336;Zylutė;Ručijok;7742044835;Taip;0;3;0;3
14337;Zylutė;Ručijok;6276017610;Taip;0;0;2;2
14338;Zylutė;Ručijok;3128535871;Taip;13;0;3;16
14339;Zylutė;Raduga;9325387975;Taip;0;12;0;12
14340;Zylutė;Raduga;6569135467;Taip;0;1;0;1
14341;Zylutė;Raduga;3117948118;Taip;0;0;3;3
14342;Zylutė;Raduga;3826815202;Taip;0;1;0;1
14343;Zylutė;Raduga;3943002728;Taip;9;1;0;10
14344;Zylutė;Raduga;4043810535;Taip;0;1;0;1
14345;Zylutė;Raduga;2107123106;Ne;10;7;0;17
14346;Zylutė;Raduga;7482740111;Taip;0;0;1;1
14347;Zylutė;Raduga;7824348276;Taip;1;0;0;1
14348;Zylutė;Raduga;4811667497;Ne;17;1;0;18
14349;Zylutė;Raduga;2681013154;Taip;6;1;5;12
14350;Zylutė;Raduga;4493469560;Taip;0;0;10;10
14351;Zylutė;Raduga;3608920051;Taip;0;4;0;4
14352;Zylutė;Raduga;3059970035;Taip;3;1;0;4
14353;Zylutė;Raduga;5408157164;Taip;0;0;4;4
14354;Zylutė;Raduga;3780475392;Taip;7;8;0;15
14355;Zylutė;"Miki Maus";9159342804;Taip;8;4;0;12
14356;Zylutė;"Miki Maus";8023418946;Taip;5;6;0;11
14357;Zylutė;"Miki Maus";5369354390;Ne;9;7;0;16
14358;Zylutė;"Miki Maus";8121814945;Taip;3;0;0;3
14359;Zylutė;"Miki Maus";9507157625;Taip;4;0;0;4
14360;Zylutė;"Miki Maus";8101232865;Taip;4;0;0;4
14361;Zylutė;"Miki Maus";9018673580;Taip;6;0;0;6
14362;Zylutė;"Miki Maus";7762245887;Taip;1;0;0;1
14363;Zylutė;"Miki Maus";9213491152;Taip;14;1;0;15
14364;Zylutė;"Miki Maus";4057419108;Ne;21;0;0;21
14365;Zylutė;"Miki Maus";3668160578;Taip;0;6;0;6
14366;Zylutė;"Miki Maus";7123399601;Ne;1;4;0;5
14367;Zylutė;"Miki Maus";5975875502;Ne;6;5;0;11
14368;Zylutė;Solnyško;8379932761;Taip;15;1;0;16
14369;Zylutė;Solnyško;5556769710;Taip;0;0;4;4
14370;Zylutė;Solnyško;2088316489;Taip;0;5;0;5
14371;Zylutė;Solnyško;1076803315;Taip;0;7;3;10
14372;Zylutė;Solnyško;7616444695;Ne;7;1;2;10
14373;Zylutė;Solnyško;5234846079;Taip;0;0;1;1
14374;Zylutė;Solnyško;5939522435;Taip;0;14;0;14
14375;Zylutė;Solnyško;2117820453;Taip;0;0;3;3
14376;Zylutė;Solnyško;5826813410;Taip;0;8;0;8
14377;Zylutė;Solnyško;8033573972;Ne;2;0;0;2
14378;Zylutė;Solnyško;7447067072;Taip;5;0;1;6
14379;Zylutė;Solnyško;4478652694;Ne;0;2;0;2
14380;Zylutė;Solnyško;1969578486;Taip;3;0;2;5
14381;Zylutė;Solnyško;6573541087;Taip;13;0;0;13
14382;Zylutė;Solnyško;2520744071;Taip;0;0;5;5
14383;Zylutė;Motyliok;7241045507;Ne;6;0;0;6
14384;Zylutė;Motyliok;9913001904;Ne;0;1;0;1
14385;Zylutė;Motyliok;5891900062;Taip;0;7;0;7
14386;Zylutė;Motyliok;6112586092;Taip;0;8;0;8
14387;Zylutė;Motyliok;8178488164;Taip;1;0;0;1
14388;Zylutė;Motyliok;3547185618;Taip;0;1;0;1
14389;Zylutė;Motyliok;5045652581;Taip;14;5;0;19
14390;Zylutė;Motyliok;9586800176;Taip;0;3;0;3
14391;Zylutė;Motyliok;4497904128;Taip;0;11;0;11
14392;Zylutė;Motyliok;3355159275;Taip;0;1;0;1
14393;Zylutė;Motyliok;9995791665;Taip;10;0;0;10
14394;Zylutė;Motyliok;1455822427;Taip;5;0;0;5
14395;Zylutė;Motyliok;2654373943;Ne;5;1;0;6
14396;Zylutė;Motyliok;3455374127;Taip;11;5;0;16
14397;Zylutė;Motyliok;1632490481;Taip;0;2;0;2
14398;Zylutė;Motyliok;1726060015;Ne;10;0;0;10
14399;Zylutė;Motyliok;6051657134;Taip;12;1;0;13
14400;Zylutė;Motyliok;3271366684;Taip;8;0;0;8
14401;Zylutė;Motyliok;3633983359;Taip;21;0;0;21
14402;Zylutė;Motyliok;9155513221;Ne;10;1;0;11
14403;Zylutė;ŽVIRBLIUKAI;1319040747;Ne;0;1;7;8
14404;Zylutė;ŽVIRBLIUKAI;4394023057;Taip;0;1;0;1
14405;Zylutė;ŽVIRBLIUKAI;8326987895;Taip;0;5;0;5
14406;Zylutė;ŽVIRBLIUKAI;9330583784;Taip;6;0;0;6
14407;Zylutė;ŽVIRBLIUKAI;9150157724;Ne;6;0;3;9
14408;Zylutė;ŽVIRBLIUKAI;8268700439;Taip;9;1;0;10
14409;Zylutė;ŽVIRBLIUKAI;1220439948;Taip;0;11;0;11
14410;Zylutė;ŽVIRBLIUKAI;9580188426;Ne;5;0;0;5
14411;Zylutė;ŽVIRBLIUKAI;1797701777;Taip;3;1;0;4
14412;Zylutė;ŽVIRBLIUKAI;2966482773;Ne;0;1;0;1
14413;Zylutė;ŽVIRBLIUKAI;1452384017;Taip;1;0;1;2
14414;Zylutė;ŽVIRBLIUKAI;2697867000;Ne;0;1;2;3
14415;Zylutė;ŽVIRBLIUKAI;8262929231;Ne;0;0;3;3
14416;Zylutė;ŽVIRBLIUKAI;8152140523;Taip;6;0;3;9
14417;Zylutė;ŽVIRBLIUKAI;8346794629;Taip;3;0;0;3
14418;Zylutė;ŽVIRBLIUKAI;2061747513;Taip;13;0;0;13
14419;Zylutė;"DRUŽNYJE REBIATA";5332039406;Ne;17;0;1;18
14420;Zylutė;"DRUŽNYJE REBIATA";9039665233;Taip;1;1;0;2
14421;Zylutė;"DRUŽNYJE REBIATA";6075614020;Taip;0;9;0;9
14422;Zylutė;"DRUŽNYJE REBIATA";9518714240;Taip;5;1;0;6
14423;Zylutė;"DRUŽNYJE REBIATA";2693961315;Taip;6;0;0;6
14424;Zylutė;"DRUŽNYJE REBIATA";3372639449;Ne;6;1;0;7
14425;Zylutė;"DRUŽNYJE REBIATA";4916625058;Taip;0;2;0;2
14426;Zylutė;"DRUŽNYJE REBIATA";3447644735;Taip;0;4;0;4
14427;Zylutė;"DRUŽNYJE REBIATA";3174042441;Taip;7;1;0;8
14428;Zylutė;"DRUŽNYJE REBIATA";6848387941;Ne;8;1;0;9
14429;Zylutė;"DRUŽNYJE REBIATA";1404949829;Taip;5;0;0;5
14430;Zylutė;"DRUŽNYJE REBIATA";4548205666;Taip;3;4;0;7
14431;Zylutė;"DRUŽNYJE REBIATA";6962852787;Taip;3;4;0;7
14432;Zylutė;"DRUŽNYJE REBIATA";9220918504;Taip;3;4;0;7
14433;Zylutė;"DRUŽNYJE REBIATA";9193349264;Taip;4;0;0;4
14434;Zylutė;"DRUŽNYJE REBIATA";2444440430;Taip;0;1;0;1
14435;Zylutė;"DRUŽNYJE REBIATA";8130859512;Taip;5;1;0;6
14436;Zylutė;"DRUŽNYJE REBIATA";6281989117;Taip;8;0;0;8
14437;Zylutė;"DRUŽNYJE REBIATA";9769201088;Ne;0;6;0;6
14438;Zylutė;"DRUŽNYJE REBIATA";5233163416;Taip;3;1;0;4
14439;Zylutė;"DRUŽNYJE REBIATA";6784471792;Taip;12;1;0;13
14440;Zylutė;"DRUŽNYJE REBIATA";5126282685;Taip;9;0;0;9
14441;Zylutė;VIEVERSĖLIAI;2125519672;Taip;0;1;0;1
14442;Zylutė;VIEVERSĖLIAI;4505081448;Ne;3;1;0;4
14443;Zylutė;VIEVERSĖLIAI;72716975865;Taip;5;1;0;6
14444;Zylutė;VIEVERSĖLIAI;6275164528;Taip;5;1;0;6
14445;Zylutė;VIEVERSĖLIAI;5172154642;Taip;0;5;0;5
14446;Zylutė;VIEVERSĖLIAI;2943888466;Taip;0;5;0;5
14447;Zylutė;VIEVERSĖLIAI;6907378757;Taip;0;1;0;1
14448;Zylutė;VIEVERSĖLIAI;4016518230;Taip;5;1;0;6
14449;Zylutė;VIEVERSĖLIAI;9660898505;Taip;0;9;0;9
14450;Zylutė;VIEVERSĖLIAI;5544338521;Taip;0;2;0;2
14451;Zylutė;VIEVERSĖLIAI;5162635301;Taip;21;0;0;21
14452;Zylutė;VIEVERSĖLIAI;1939618217;Taip;0;1;0;1
14453;Zylutė;VIEVERSĖLIAI;1048279422;Taip;5;6;0;11
14454;Zylutė;VIEVERSĖLIAI;3919565034;Taip;5;0;0;5
14455;Zylutė;VIEVERSĖLIAI;6548786007;Ne;0;7;0;7
14456;Zylutė;VIEVERSĖLIAI;3074954453;Taip;0;1;0;1
14457;Želmenėliai;Bitučių;4681686872;Taip;0;3;0;3
14458;Želmenėliai;Bitučių;3268310531;Taip;9;1;0;10
14459;Želmenėliai;Bitučių;2122665619;Ne;0;3;3;6
14460;Želmenėliai;Bitučių;2563117992;Taip;5;1;1;7
14461;Želmenėliai;Bitučių;6799702725;Taip;0;4;0;4
14462;Želmenėliai;Bitučių;8358780570;Taip;0;3;0;3
14463;Želmenėliai;Bitučių;9006406225;Taip;0;2;0;2
14464;Želmenėliai;Bitučių;2102401372;Taip;0;1;0;1
14465;Želmenėliai;Bitučių;4931835807;Taip;0;2;0;2
14466;Želmenėliai;Bitučių;5147895081;Taip;4;1;0;5
14467;Želmenėliai;Bitučių;6481952132;Taip;0;4;0;4
14468;Želmenėliai;Bitučių;9611741258;Taip;1;0;1;2
14469;Želmenėliai;Bitučių;1619143702;Taip;9;0;0;9
14470;Želmenėliai;Bitučių;9825545754;Taip;15;0;0;15
14471;Želmenėliai;Bitučių;5314438217;Taip;0;4;0;4
14472;Želmenėliai;Bitučių;4927030144;Taip;0;2;0;2
14473;Želmenėliai;Bitučių;3739751121;Taip;8;2;0;10
14474;Želmenėliai;Bitučių;8028761330;Ne;0;1;0;1
14475;Želmenėliai;Bitučių;2853659708;Taip;11;0;0;11
14476;Želmenėliai;Bitučių;9207984505;Taip;0;7;0;7
14477;Želmenėliai;Kačiukų;1292462938;Taip;3;0;1;4
14478;Želmenėliai;Kačiukų;2350936740;Ne;5;3;0;8
14479;Želmenėliai;Kačiukų;3063417708;Taip;6;1;0;7
14480;Želmenėliai;Kačiukų;2577850672;Taip;0;1;0;1
14481;Želmenėliai;Kačiukų;7197717698;Taip;1;0;0;1
14482;Želmenėliai;Kačiukų;7849682820;Taip;17;1;0;18
14483;Želmenėliai;Kačiukų;2111008869;Taip;3;0;0;3
14484;Želmenėliai;Kačiukų;4589396143;Taip;5;1;0;6
14485;Želmenėliai;Kačiukų;4198085732;Taip;9;0;0;9
14486;Želmenėliai;Kačiukų;6509783586;Taip;12;1;0;13
14487;Želmenėliai;Kačiukų;4758240577;Taip;0;3;0;3
14488;Želmenėliai;Kačiukų;7094853897;Ne;11;1;0;12
14489;Želmenėliai;Kačiukų;9493581034;Taip;0;4;0;4
14490;Želmenėliai;Kačiukų;4931664953;Taip;14;2;0;16
14491;Želmenėliai;Kačiukų;4376978921;Taip;5;0;0;5
14492;Želmenėliai;Kačiukų;9313666706;Taip;8;2;0;10
14493;Želmenėliai;Kačiukų;8590129703;Taip;0;0;5;5
14494;Želmenėliai;Kačiukų;3959066963;Taip;0;1;3;4
14495;Želmenėliai;Kačiukų;6761848439;Taip;7;0;1;8
14496;Želmenėliai;Voveriukų;6343814445;Taip;0;3;0;3
14497;Želmenėliai;Voveriukų;7833143421;Taip;0;2;0;2
14498;Želmenėliai;Voveriukų;8418427863;Taip;0;2;0;2
14499;Želmenėliai;Voveriukų;5360157217;Taip;25;5;0;30
14500;Želmenėliai;Voveriukų;2545133678;Taip;0;2;0;2
14501;Želmenėliai;Voveriukų;7423900312;Taip;0;9;0;9
14502;Želmenėliai;Voveriukų;2025424742;Taip;7;0;0;7
14503;Želmenėliai;Voveriukų;4014238120;Taip;0;1;0;1
14504;Želmenėliai;Voveriukų;2924134152;Taip;10;0;0;10
14505;Želmenėliai;Voveriukų;6857922902;Taip;8;0;0;8
14506;Želmenėliai;Voveriukų;9811131936;Taip;11;0;1;12
14507;Želmenėliai;Voveriukų;8968533318;Taip;1;11;0;12
14508;Želmenėliai;Voveriukų;6264955603;Taip;2;7;0;9
14509;Želmenėliai;Voveriukų;8952421941;Taip;14;0;0;14
14510;Želmenėliai;Voveriukų;7345540758;Taip;16;0;0;16
14511;Želmenėliai;Voveriukų;9709599805;Taip;5;2;0;7
14512;Želmenėliai;Voveriukų;4248374729;Taip;0;5;0;5
14513;Želmenėliai;Ežiukų;1652131150;Taip;0;3;0;3
14514;Želmenėliai;Ežiukų;5795735579;Taip;0;1;0;1
14515;Želmenėliai;Ežiukų;2311169187;Taip;7;0;1;8
14516;Želmenėliai;Ežiukų;3572462731;Taip;0;1;0;1
14517;Želmenėliai;Ežiukų;3353793939;Taip;1;0;0;1
14518;Želmenėliai;Ežiukų;7495157523;Taip;9;1;0;10
14519;Želmenėliai;Ežiukų;3972980949;Taip;0;9;0;9
14520;Želmenėliai;Ežiukų;6779746783;Taip;9;0;0;9
14521;Želmenėliai;Ežiukų;6876147546;Taip;0;4;0;4
14522;Želmenėliai;Ežiukų;9126715074;Ne;1;0;0;1
14523;Želmenėliai;Ežiukų;1260607572;Taip;0;3;1;4
14524;Želmenėliai;Ežiukų;5638248652;Taip;6;0;0;6
14525;Želmenėliai;Ežiukų;8154713582;Taip;18;0;1;19
14526;Želmenėliai;Ežiukų;2296870749;Taip;2;6;1;9
14527;Želmenėliai;Ežiukų;6180553648;Taip;0;1;0;1
14528;Želmenėliai;Ežiukų;5171736943;Taip;0;1;0;1
14529;Želmenėliai;Ežiukų;7294722095;Taip;8;8;0;16
14530;Želmenėliai;Ežiukų;4120125150;Taip;13;2;0;15
14531;Želmenėliai;Ežiukų;5281861477;Taip;0;1;0;1
14532;Želmenėliai;Ežiukų;8987377791;Taip;0;3;0;3
14533;Želmenėliai;Ežiukų;7373892344;Taip;15;2;0;17
14534;Želmenėliai;Peledžiukų;8491797555;Taip;13;3;0;16
14535;Želmenėliai;Peledžiukų;7058759730;Ne;0;1;0;1
14536;Želmenėliai;Peledžiukų;4485249321;Taip;0;2;0;2
14537;Želmenėliai;Peledžiukų;3869372021;Taip;0;5;0;5
14538;Želmenėliai;Peledžiukų;4374898642;Taip;15;1;0;16
14539;Želmenėliai;Peledžiukų;7751609462;Taip;10;0;0;10
14540;Želmenėliai;Peledžiukų;5929410363;Taip;16;2;0;18
14541;Želmenėliai;Peledžiukų;5205425589;Taip;4;1;0;5
14542;Želmenėliai;Peledžiukų;5362390260;Taip;0;2;0;2
14543;Želmenėliai;Peledžiukų;1580370689;Taip;0;6;0;6
14544;Želmenėliai;Peledžiukų;1983575576;Taip;11;0;0;11
14545;Želmenėliai;Peledžiukų;7672980212;Taip;6;3;0;9
14546;Želmenėliai;Peledžiukų;6260153299;Taip;3;1;0;4
14547;Želmenėliai;Peledžiukų;6187661667;Taip;0;3;0;3
14548;Želmenėliai;Peledžiukų;6109546917;Ne;8;8;0;16
14549;Želmenėliai;Peledžiukų;8118696261;Taip;13;1;0;14
14550;Želmenėliai;Peledžiukų;4746898209;Taip;3;8;0;11
14551;Želmenėliai;Peledžiukų;9929149682;Taip;11;0;0;11
14552;Želmenėliai;Peledžiukų;3723155757;Taip;12;4;0;16
14553;Želmenėliai;Peledžiukų;5401466574;Taip;11;0;0;11
14554;Želmenėliai;Peledžiukų;6662439747;Taip;11;1;0;12
14555;Želmenėliai;Drugelių;7664430346;Taip;10;2;0;12
14556;Želmenėliai;Drugelių;3417538909;Taip;0;3;4;7
14557;Želmenėliai;Drugelių;3295852546;Taip;0;2;0;2
14558;Želmenėliai;Drugelių;3379266015;Taip;15;3;0;18
14559;Želmenėliai;Drugelių;1984105453;Taip;15;2;0;17
14560;Želmenėliai;Drugelių;4652412483;Taip;0;12;0;12
14561;Želmenėliai;Drugelių;1652949383;Taip;8;1;0;9
14562;Želmenėliai;Drugelių;5046836398;Taip;11;3;0;14
14563;Želmenėliai;Drugelių;9237611484;Taip;0;0;1;1
14564;Želmenėliai;Drugelių;13558387807;Taip;0;2;0;2
14565;Želmenėliai;Drugelių;5143554665;Taip;17;1;0;18
14566;Želmenėliai;Drugelių;7585159351;Taip;0;8;0;8
14567;Želmenėliai;Drugelių;4634346755;Taip;2;7;0;9
14568;Želmenėliai;Drugelių;4916436238;Taip;0;1;0;1
14569;Želmenėliai;Drugelių;5558795651;Taip;12;1;0;13
14570;Želmenėliai;Voriukų;4264751761;Taip;2;3;0;5
14571;Želmenėliai;Voriukų;1203343580;Taip;8;12;0;20
14572;Želmenėliai;Voriukų;9351650342;Ne;0;1;0;1
14573;Želmenėliai;Voriukų;7563461821;Taip;0;11;0;11
14574;Želmenėliai;Voriukų;4534946646;Taip;10;1;0;11
14575;Želmenėliai;Voriukų;4075533071;Taip;0;2;0;2
14576;Želmenėliai;Voriukų;4545012342;Taip;0;2;0;2
14577;Želmenėliai;Voriukų;7505996978;Taip;12;4;0;16
14578;Želmenėliai;Voriukų;2722619508;Taip;0;8;0;8
14579;Želmenėliai;Voriukų;5025345647;Taip;0;10;0;10
14580;Želmenėliai;Voriukų;8892137326;Taip;0;3;0;3
14581;Želmenėliai;Voriukų;7700521261;Taip;0;9;0;9
14582;Želmenėliai;Voriukų;1649724696;Ne;0;2;0;2
14583;Želmenėliai;Voriukų;8206979332;Taip;0;1;1;2
14584;Želmenėliai;Boružėlių;7792850272;Taip;1;0;0;1
14585;Želmenėliai;Boružėlių;1764468979;Taip;0;2;0;2
14586;Želmenėliai;Boružėlių;5161934903;Taip;0;7;0;7
14587;Želmenėliai;Boružėlių;8722573513;Taip;0;4;0;4
14588;Želmenėliai;Boružėlių;3516695805;Taip;9;7;0;16
14589;Želmenėliai;Boružėlių;5949535657;Taip;16;0;0;16
14590;Želmenėliai;Boružėlių;2262009049;Taip;13;0;0;13
14591;Želmenėliai;Boružėlių;7077832687;Taip;0;5;0;5
14592;Želmenėliai;Boružėlių;3896171121;Taip;0;4;0;4
14593;Želmenėliai;Boružėlių;2951719129;Taip;13;2;0;15
14594;Želmenėliai;Boružėlių;2066439950;Taip;3;2;0;5
14595;Želmenėliai;Boružėlių;5207899503;Taip;5;9;0;14
14596;Želmenėliai;Boružėlių;2111705047;Taip;5;1;0;6
14597;Želmenėliai;Boružėlių;5514167627;Taip;5;2;0;7
14598;Želmenėliai;Boružėlių;8474210476;Ne;10;0;0;10
14599;Želmenėliai;Boružėlių;2179165096;Ne;8;3;0;11
14600;Želmenėliai;Pūkuotukų;3258904017;Taip;3;2;0;5
14601;Želmenėliai;Pūkuotukų;8667865301;Taip;0;1;7;8
14602;Želmenėliai;Pūkuotukų;1952686295;Taip;4;1;0;5
14603;Želmenėliai;Pūkuotukų;5787772212;Taip;0;7;0;7
14604;Želmenėliai;Pūkuotukų;2727113833;Taip;1;3;0;4
14605;Želmenėliai;Pūkuotukų;9359070885;Taip;0;4;0;4
14606;Želmenėliai;Pūkuotukų;6816346946;Taip;7;7;0;14
14607;Želmenėliai;Pūkuotukų;37152467004;Taip;0;7;0;7
14608;Želmenėliai;Pūkuotukų;5842563754;Taip;0;10;0;10
14609;Želmenėliai;Pūkuotukų;1941723687;Taip;5;1;0;6
14610;Želmenėliai;Pūkuotukų;1239398642;Taip;0;4;0;4
14611;Želmenėliai;Pūkuotukų;5616709457;Taip;0;4;0;4
14612;Želmenėliai;Pūkuotukų;4206128805;Taip;0;11;0;11
14613;Želmenėliai;Pūkuotukų;1248541555;Taip;0;3;2;5
14614;Želmenėliai;Pūkuotukų;8300887366;Taip;0;4;0;4
14615;Želmenėliai;Pūkuotukų;1582618217;Taip;4;6;0;10
14616;Želmenėliai;Ančiukų;4979494010;Taip;14;0;0;14
14617;Želmenėliai;Ančiukų;7925266303;Taip;14;0;0;14
14618;Želmenėliai;Ančiukų;8060048377;Taip;24;0;0;24
14619;Želmenėliai;Ančiukų;1606079948;Taip;0;9;0;9
14620;Želmenėliai;Ančiukų;9250666159;Taip;21;0;0;21
14621;Želmenėliai;Ančiukų;5569699398;Taip;21;0;0;21
14622;Želmenėliai;Ančiukų;3926238501;Taip;0;10;0;10
14623;Želmenėliai;Ančiukų;4207070475;Taip;1;4;0;5
14624;Želmenėliai;Ančiukų;8409831053;Taip;11;2;0;13
14625;Želmenėliai;Ančiukų;3608041516;Taip;0;1;0;1
14626;Želmenėliai;Ančiukų;5454656514;Taip;0;5;2;7
14627;Želmenėliai;Ančiukų;3172645969;Taip;20;1;0;21
14628;Želmenėliai;Ančiukų;7128213908;Taip;0;11;0;11
14629;Želmenėliai;Nykštukų;6230010537;Taip;0;8;0;8
14630;Želmenėliai;Nykštukų;5052052744;Taip;10;1;0;11
14631;Želmenėliai;Nykštukų;6764567873;Taip;0;7;0;7
14632;Želmenėliai;Nykštukų;9901320882;Taip;5;1;0;6
14633;Želmenėliai;Nykštukų;4526936339;Taip;6;0;0;6
14634;Želmenėliai;Nykštukų;3232996198;Taip;11;0;2;13
14635;Želmenėliai;Nykštukų;2878494111;Taip;0;1;0;1
14636;Želmenėliai;Nykštukų;7341132501;Taip;0;3;0;3
14637;Želmenėliai;Nykštukų;9661692350;Taip;10;13;0;23
14638;Želmenėliai;Nykštukų;7123290599;Taip;7;0;0;7
14639;Želmenėliai;Lašelių;8654298177;Taip;0;1;0;1
14640;Želmenėliai;Lašelių;4451798870;Taip;1;0;0;1
14641;Želmenėliai;Lašelių;4485851428;Taip;7;2;0;9
14642;Želmenėliai;Lašelių;4930868989;Taip;5;1;0;6
14643;Želmenėliai;Lašelių;3346680108;Taip;10;2;0;12
14644;Želmenėliai;Lašelių;4679930998;Taip;5;2;1;8
14645;Želmenėliai;Lašelių;3344426717;Taip;0;1;0;1
14646;Želmenėliai;Lašelių;9483665065;Taip;18;1;0;19
14647;Želmenėliai;Lašelių;9182208354;Taip;3;1;0;4
14648;Želmenėliai;Lašelių;8104790589;Taip;11;2;0;13
14649;Želmenėliai;Lašelių;9544233589;Taip;0;1;0;1
14650;Želmenėliai;Lašelių;3979635800;Taip;5;0;0;5
14651;Žemyna;Čiauškučiai;9985529041;Ne;9;0;0;9
14652;Žemyna;Čiauškučiai;2547436771;Taip;0;4;0;4
14653;Žemyna;Čiauškučiai;6051208732;Taip;11;1;0;12
14654;Žemyna;Čiauškučiai;6346173832;Taip;6;0;8;14
14655;Žemyna;Čiauškučiai;8694608716;Taip;0;1;0;1
14656;Žemyna;Čiauškučiai;3074391266;Taip;0;0;1;1
14657;Žemyna;Čiauškučiai;4693414703;Taip;6;0;0;6
14658;Žemyna;Čiauškučiai;1365045512;Taip;5;0;0;5
14659;Žemyna;Čiauškučiai;7620179886;Taip;0;0;2;2
14660;Žemyna;Čiauškučiai;2792702536;Taip;0;1;1;2
14661;Žemyna;Čiauškučiai;7376806308;Taip;0;1;0;1
14662;Žemyna;Čiauškučiai;7277970673;Taip;0;0;3;3
14663;Žemyna;Čiauškučiai;5069437469;Taip;4;1;0;5
14664;Žemyna;Čiauškučiai;7427119736;Taip;1;0;2;3
14665;Žemyna;Čiauškučiai;4642600915;Taip;0;1;0;1
14666;Žemyna;Čiauškučiai;2354265632;Taip;6;0;1;7
14667;Žemyna;Čiauškučiai;2887459684;Taip;0;1;1;2
14668;Žemyna;Čiauškučiai;1654157342;Taip;1;1;0;2
14669;Žemyna;Čiauškučiai;4652384557;Taip;2;1;0;3
14670;Žemyna;Čiauškučiai;7352868453;Taip;0;1;0;1
14671;Žemyna;Čiauškučiai;4501408683;Taip;0;0;1;1
14672;Žemyna;Čiauškučiai;4613946229;Taip;0;1;1;2
14673;Žemyna;Čiauškučiai;7675699775;Taip;0;2;0;2
14674;Žemyna;Nykštukai;5114094924;Taip;0;3;2;5
14675;Žemyna;Nykštukai;3874855308;Taip;0;0;1;1
14676;Žemyna;Nykštukai;2461700030;Taip;0;5;0;5
14677;Žemyna;Nykštukai;1725771976;Taip;0;0;5;5
14678;Žemyna;Nykštukai;3643594001;Taip;0;1;2;3
14679;Žemyna;Nykštukai;9182709647;Taip;0;1;0;1
14680;Žemyna;Nykštukai;7121742098;Taip;0;3;0;3
14681;Žemyna;Nykštukai;3519840747;Taip;0;1;0;1
14682;Žemyna;Nykštukai;4265606762;Taip;0;0;1;1
14683;Žemyna;Nykštukai;4821941126;Taip;2;0;0;2
14684;Žemyna;Nykštukai;4322192775;Taip;0;1;0;1
14685;Žemyna;Nykštukai;4444870782;Taip;0;3;0;3
14686;Žemyna;Nykštukai;7781924111;Taip;1;0;1;2
14687;Žemyna;Nykštukai;4257096808;Taip;0;6;0;6
14688;Žemyna;Nykštukai;2860210906;Taip;0;0;12;12
14689;Žemyna;Nykštukai;7832066079;Taip;0;5;0;5
14690;Žemyna;Nykštukai;9653530823;Taip;0;3;0;3
14691;Žemyna;Nykštukai;7508491119;Taip;0;2;0;2
14692;Žemyna;Nykštukai;2928125522;Taip;0;1;0;1
14693;Žemyna;Nykštukai;1760568931;Ne;0;0;3;3
14694;Žemyna;Nykštukai;4524929331;Taip;0;1;0;1
14695;Žemyna;Nykštukai;4759403487;Taip;0;5;0;5
14696;Žemyna;Voveriukai;2141941712;Taip;3;0;0;3
14697;Žemyna;Voveriukai;9855080887;Taip;0;0;2;2
14698;Žemyna;Voveriukai;6912605631;Taip;5;1;0;6
14699;Žemyna;Voveriukai;8525229514;Taip;5;0;1;6
14700;Žemyna;Voveriukai;1846287760;Ne;0;0;1;1
14701;Žemyna;Voveriukai;8775518984;Taip;0;2;0;2
14702;Žemyna;Voveriukai;5337086029;Taip;1;0;2;3
14703;Žemyna;Voveriukai;8926045231;Ne;16;0;1;17
14704;Žemyna;Voveriukai;3860791215;Taip;0;5;0;5
14705;Žemyna;Voveriukai;8185243991;Ne;0;1;5;6
14706;Žemyna;Voveriukai;9471382383;Taip;0;0;2;2
14707;Žemyna;Voveriukai;4549562657;Taip;8;0;1;9
14708;Žemyna;Voveriukai;8882641275;Taip;2;10;0;12
14709;Žemyna;Voveriukai;7121061078;Taip;2;0;0;2
14710;Žemyna;Voveriukai;4900914346;Taip;11;3;0;14
14711;Žemyna;Voveriukai;8241038433;Taip;3;0;1;4
14712;Žemyna;Voveriukai;5450351549;Taip;0;0;1;1
14713;Žemyna;Voveriukai;5189603013;Taip;0;3;0;3
14714;Žemyna;Voveriukai;3500358886;Ne;4;0;0;4
14715;Žemyna;Kiškučiai;8622780639;Ne;2;0;0;2
14716;Žemyna;Kiškučiai;1575505075;Taip;0;1;0;1
14717;Žemyna;Kiškučiai;7917100888;Taip;0;1;0;1
14718;Žemyna;Kiškučiai;39916867354;Taip;0;1;0;1
14719;Žemyna;Kiškučiai;4317779866;Taip;0;0;1;1
14720;Žemyna;Kiškučiai;5258444578;Taip;6;1;1;8
14721;Žemyna;Kiškučiai;7785889259;Taip;0;1;0;1
14722;Žemyna;Kiškučiai;7676796264;Taip;0;1;0;1
14723;Žemyna;Kiškučiai;6536698798;Taip;12;1;0;13
14724;Žemyna;Kiškučiai;8139714064;Taip;0;1;0;1
14725;Žemyna;Kiškučiai;2090395417;Taip;9;3;0;12
14726;Žemyna;Kiškučiai;3895238312;Ne;10;1;0;11
14727;Žemyna;Kiškučiai;5056205809;Taip;6;0;0;6
14728;Žemyna;Kiškučiai;4519502372;Taip;0;1;5;6
14729;Žemyna;Kiškučiai;2137718635;Taip;0;3;1;4
14730;Žemyna;Kiškučiai;8018865138;Taip;0;3;0;3
14731;Žemyna;Kiškučiai;1717797530;Taip;0;6;0;6
14732;Žemyna;Kiškučiai;1058705875;Taip;0;1;0;1
14733;Žemyna;Kiškučiai;5233574060;Taip;0;1;0;1
14734;Žemyna;Kiškučiai;15110117571;Taip;8;1;0;9
14735;Žemyna;Kiškučiai;9219519029;Taip;0;12;0;12
14736;Žemyna;Kiškučiai;3875204515;Taip;0;1;0;1
14737;Žemyna;Kiškučiai;7638038269;Ne;0;2;0;2
14738;Žemyna;Vyturiukai;2526949655;Taip;4;2;1;7
14739;Žemyna;Vyturiukai;1417007895;Taip;0;0;3;3
14740;Žemyna;Vyturiukai;5355845891;Taip;0;1;0;1
14741;Žemyna;Vyturiukai;1481273689;Taip;10;0;0;10
14742;Žemyna;Vyturiukai;7781332622;Taip;1;8;0;9
14743;Žemyna;Vyturiukai;9366133892;Taip;0;6;0;6
14744;Žemyna;Vyturiukai;1031171460;Taip;10;0;0;10
14745;Žemyna;Vyturiukai;5204349188;Taip;9;0;0;9
14746;Žemyna;Vyturiukai;1345704379;Taip;12;0;0;12
14747;Žemyna;Vyturiukai;6097681172;Taip;0;14;0;14
14748;Žemyna;Vyturiukai;5133115712;Taip;0;0;4;4
14749;Žemyna;Vyturiukai;5416338054;Taip;0;0;4;4
14750;Žemyna;Vyturiukai;3446774478;Taip;2;7;0;9
14751;Žemyna;Vyturiukai;6271057561;Taip;0;2;0;2
14752;Žemyna;Vyturiukai;2304633263;Taip;6;0;1;7
14753;Žemyna;Vyturiukai;7300819771;Taip;0;2;0;2
14754;Žemyna;Vyturiukai;3679990879;Taip;8;0;0;8
14755;Žemyna;Vyturiukai;8461326396;Taip;11;0;3;14
14756;Žemyna;Vyturiukai;8681308720;Taip;2;1;0;3
14757;Žemyna;Vyturiukai;8577299116;Taip;15;1;0;16
14758;Žemyna;Vyturiukai;9646494715;Taip;2;4;0;6
14759;Žemyna;Vyturiukai;4863350801;Taip;18;0;0;18
14760;Žemyna;Vyturiukai;6372465987;Taip;5;0;0;5
14761;Žemyna;Vyturiukai;5655302107;Taip;7;0;0;7
14762;Žemyna;Pelėdžiukai;8040359407;Ne;3;1;2;6
14763;Žemyna;Pelėdžiukai;37570629861;Taip;5;5;0;10
14764;Žemyna;Pelėdžiukai;55161890341;Taip;8;1;0;9
14765;Žemyna;Pelėdžiukai;59506345859;Taip;0;2;0;2
14766;Žemyna;Pelėdžiukai;85135645557;Taip;0;1;0;1
14767;Žemyna;Pelėdžiukai;38769607968;Taip;0;0;2;2
14768;Žemyna;Pelėdžiukai;4235160760;Taip;5;1;0;6
14769;Žemyna;Pelėdžiukai;3622634119;Taip;0;1;0;1
14770;Žemyna;Pelėdžiukai;6618285685;Taip;0;1;0;1
14771;Žemyna;Pelėdžiukai;5306392307;Taip;0;2;0;2
14772;Žemyna;Pelėdžiukai;5508251792;Taip;0;2;0;2
14773;Žemyna;Pelėdžiukai;8096035110;Ne;0;1;4;5
14774;Žemyna;Pelėdžiukai;1687206394;Taip;6;1;0;7
14775;Žemyna;Pelėdžiukai;93423088394;Taip;0;1;0;1
14776;Žemyna;Pelėdžiukai;5933910526;Taip;0;1;0;1
14777;Žemyna;Pelėdžiukai;5506889213;Taip;0;1;0;1
14778;Žemyna;Pelėdžiukai;5815116293;Taip;2;0;1;3
14779;Žemyna;Pelėdžiukai;13242930752;Taip;0;1;4;5
14780;Žemyna;Pelėdžiukai;89787441782;Taip;11;0;0;11
14781;Žemyna;Pelėdžiukai;9224203811;Taip;6;1;6;13
14782;Žemyna;Pelėdžiukai;2527337934;Taip;0;1;3;4
14783;Žemyna;Pelėdžiukai;1867198805;Ne;0;1;0;1
14784;Žemyna;Vijurkai;8500642069;Taip;0;1;0;1
14785;Žemyna;Vijurkai;9148594407;Taip;0;1;2;3
14786;Žemyna;Vijurkai;6812823390;Taip;0;1;0;1
14787;Žemyna;Vijurkai;3938938667;Taip;0;1;0;1
14788;Žemyna;Vijurkai;7125026803;Taip;0;3;0;3
14789;Žemyna;Vijurkai;7693278353;Taip;0;4;0;4
14790;Žemyna;Vijurkai;6430348135;Taip;0;2;0;2
14791;Žemyna;Vijurkai;2976467316;Taip;0;1;0;1
14792;Žemyna;Vijurkai;3357339710;Taip;11;0;0;11
14793;Žemyna;Vijurkai;7341750699;Taip;0;7;2;9
14794;Žemyna;Vijurkai;7925774308;Taip;0;1;1;2
14795;Žemyna;Vijurkai;9958040413;Taip;0;1;0;1
14796;Žemyna;Vijurkai;1531980297;Taip;0;1;0;1
14797;Žemyna;Vijurkai;9866110744;Taip;0;0;5;5
14798;Žemyna;Vijurkai;2412956023;Taip;0;4;0;4
14799;Žemyna;Vijurkai;1118997229;Taip;0;1;0;1
14800;Žemyna;Vijurkai;1114714466;Taip;0;1;2;3
14801;Žemyna;Vijurkai;5318574856;Ne;0;1;0;1
14802;Žemyna;Vijurkai;1264659113;Taip;0;9;0;9
14803;Žemyna;Vijurkai;4410293832;Taip;0;1;3;4
14804;Žemyna;Vijurkai;1652681820;Ne;0;2;0;2
14805;Žemyna;Šnekučiai;9501126807;Taip;11;1;1;13
14806;Žemyna;Šnekučiai;6735720135;Taip;0;0;1;1
14807;Žemyna;Šnekučiai;9912869400;Taip;1;0;1;2
14808;Žemyna;Šnekučiai;2006173745;Taip;0;1;0;1
14809;Žemyna;Šnekučiai;6116581655;Taip;0;0;3;3
14810;Žemyna;Šnekučiai;7280740926;Taip;0;0;3;3
14811;Žemyna;Šnekučiai;6419974691;Taip;10;1;2;13
14812;Žemyna;Šnekučiai;9818711030;Ne;4;2;0;6
14813;Žemyna;Šnekučiai;7764615445;Taip;0;10;0;10
14814;Žemyna;Šnekučiai;5868208651;Taip;0;0;1;1
14815;Žemyna;Šnekučiai;3992383447;Taip;7;0;0;7
14816;Žemyna;Šnekučiai;6856737270;Taip;0;2;0;2
14817;Žemyna;Šnekučiai;5188496664;Taip;0;1;1;2
14818;Žemyna;Šnekučiai;4872348199;Taip;1;10;0;11
14819;Žemyna;Šnekučiai;6878669773;Taip;1;0;1;2
14820;Žemyna;Šnekučiai;4502958166;Taip;0;5;0;5
14821;Žemyna;Šnekučiai;6728229865;Taip;0;3;0;3
14822;Žemyna;Šnekučiai;2710551760;Taip;0;2;0;2
14823;Žemyna;Šnekučiai;4612112289;Taip;0;0;1;1
14824;Žemyna;Šnekučiai;9568886284;Taip;6;0;2;8
14825;Žemyna;Šnekučiai;3982766622;Taip;0;1;5;6
14826;Žemyna;Pabiručiai;9827401825;Taip;0;2;0;2
14827;Žemyna;Pabiručiai;5743535463;Taip;0;6;0;6
14828;Žemyna;Pabiručiai;6958537154;Taip;0;5;0;5
14829;Žemyna;Pabiručiai;7005045961;Taip;0;1;1;2
14830;Žemyna;Pabiručiai;1745197274;Taip;9;3;0;12
14831;Žemyna;Pabiručiai;6041223291;Taip;6;0;1;7
14832;Žemyna;Pabiručiai;8248443265;Taip;6;0;0;6
14833;Žemyna;Pabiručiai;7122276019;Taip;6;0;0;6
14834;Žemyna;Pabiručiai;9094718595;Ne;14;0;1;15
14835;Žemyna;Pabiručiai;6208953341;Taip;0;8;2;10
14836;Žemyna;Pabiručiai;1656335765;Taip;0;1;0;1
14837;Žemyna;Pabiručiai;5127174926;Taip;15;0;0;15
14838;Žemyna;Pabiručiai;8559870965;Taip;0;0;6;6
14839;Žemyna;Pabiručiai;1850100203;Taip;1;0;3;4
14840;Žemyna;Pabiručiai;6450681255;Taip;7;1;0;8
14841;Žemyna;Pabiručiai;2860232791;Taip;3;0;4;7
14842;Žemyna;Pabiručiai;4237778022;Taip;5;0;0;5
14843;Žemyna;Pabiručiai;2414400761;Taip;0;10;2;12
14844;Žemyna;Pabiručiai;9511935264;Taip;0;2;1;3
14845;Žemyna;Pabiručiai;4176386795;Taip;8;0;0;8
14846;Žemyna;Pabiručiai;3393414493;Taip;5;0;1;6
14847;Žemyna;Pabiručiai;4960936366;Ne;8;0;0;8
14848;Žemyna;Pabiručiai;2495616844;Taip;1;0;1;2
14849;Žemyna;Drugeliai;7564693757;Taip;13;4;0;17
14850;Žemyna;Drugeliai;3505551915;Taip;0;0;5;5
14851;Žemyna;Drugeliai;2231967652;Taip;0;0;1;1
14852;Žemyna;Drugeliai;3755964840;Taip;2;2;0;4
14853;Žemyna;Drugeliai;9171823612;Taip;0;0;15;15
14854;Žemyna;Drugeliai;5518125715;Taip;4;0;0;4
14855;Žemyna;Drugeliai;9589582451;Taip;0;0;5;5
14856;Žemyna;Drugeliai;3872427931;Taip;8;0;0;8
14857;Žemyna;Drugeliai;1279981170;Taip;5;0;1;6
14858;Žemyna;Drugeliai;2102920661;Taip;5;0;4;9
14859;Žemyna;Drugeliai;6575272457;Taip;0;0;9;9
14860;Žemyna;Drugeliai;6164541167;Taip;9;1;1;11
14861;Žemyna;Drugeliai;7461187735;Taip;0;0;1;1
14862;Žemyna;Drugeliai;3390442637;Taip;5;1;0;6
14863;Žemyna;Drugeliai;2139103576;Taip;0;6;0;6
14864;Žemyna;Drugeliai;7920398415;Taip;0;4;0;4
14865;Žemyna;Drugeliai;1695063377;Taip;16;0;0;16
14866;Žemyna;Drugeliai;7745383607;Taip;0;0;1;1
14867;Žemyna;Drugeliai;7661182825;Taip;0;2;0;2
14868;Žemyna;Drugeliai;7333722030;Taip;11;0;0;11
14869;Žemyna;Drugeliai;8709792653;Taip;1;0;0;1
14870;Žemyna;"ŽIRNIUKAI ";4540472310;Taip;11;4;0;15
14871;Žemyna;"ŽIRNIUKAI ";9647706055;Taip;0;0;3;3
14872;Žemyna;"ŽIRNIUKAI ";2883862675;Taip;0;2;0;2
14873;Žemyna;"ŽIRNIUKAI ";7537145330;Taip;19;0;0;19
14874;Žemyna;"ŽIRNIUKAI ";7683443675;Taip;21;0;0;21
14875;Žemyna;"ŽIRNIUKAI ";9796331127;Taip;0;2;0;2
14876;Žemyna;"ŽIRNIUKAI ";3996577758;Taip;0;2;0;2
14877;Žemyna;"ŽIRNIUKAI ";6783675344;Taip;14;0;0;14
14878;Žemyna;"ŽIRNIUKAI ";9082375371;Taip;14;0;0;14
14879;Žemyna;"ŽIRNIUKAI ";1795919515;Taip;8;0;0;8
14880;Žemyna;"ŽIRNIUKAI ";3899901920;Ne;0;1;0;1
14881;Žemyna;"ŽIRNIUKAI ";7831778620;Taip;0;3;2;5
14882;Žemyna;"ŽIOGELIAI ";2039344248;Taip;4;0;1;5
14883;Žemyna;"ŽIOGELIAI ";5968816137;Taip;1;0;2;3
14884;Žemyna;"ŽIOGELIAI ";4238528111;Taip;5;0;1;6
14885;Žemyna;"ŽIOGELIAI ";3741459808;Taip;5;0;1;6
14886;Žemyna;"ŽIOGELIAI ";3164469202;Taip;9;0;2;11
14887;Žemyna;"ŽIOGELIAI ";3870917221;Taip;13;0;0;13
14888;Žemyna;"ŽIOGELIAI ";6571952468;Taip;0;0;2;2
14889;Žemyna;"ŽIOGELIAI ";6632827240;Taip;11;5;1;17
14890;Žemyna;"ŽIOGELIAI ";3935318882;Taip;6;1;0;7
14891;Žemyna;"ŽIOGELIAI ";2010676445;Taip;6;1;0;7
14892;Žemyna;"ŽIOGELIAI ";8965185578;Taip;5;2;0;7
14893;Žemyna;"ŽIOGELIAI ";8611258788;Taip;11;0;1;12
14894;Žemyna;"ŽIOGELIAI ";6592356004;Taip;21;0;0;21
14895;Žemyna;"ŽIOGELIAI ";9788890112;Taip;21;0;0;21
14896;Žemuogėlė;Boružiukai;1350671777;Taip;5;0;0;5
14897;Žemuogėlė;Boružiukai;9344628661;Taip;0;1;0;1
14898;Žemuogėlė;Boružiukai;2158359435;Ne;21;0;2;23
14899;Žemuogėlė;Boružiukai;1639634300;Taip;10;0;0;10
14900;Žemuogėlė;Boružiukai;5521993938;Ne;10;0;7;17
14901;Žemuogėlė;Boružiukai;1267222057;Taip;10;1;0;11
14902;Žemuogėlė;Boružiukai;9562512849;Taip;15;3;0;18
14903;Žemuogėlė;Boružiukai;8661864424;Taip;0;3;0;3
14904;Žemuogėlė;Boružiukai;5427045039;Taip;19;0;1;20
14905;Žemuogėlė;Boružiukai;1150466286;Taip;5;1;0;6
14906;Žemuogėlė;Boružiukai;8040255583;Taip;0;2;0;2
14907;Žemuogėlė;Boružiukai;2190458676;Ne;22;0;0;22
14908;Žemuogėlė;Boružiukai;6073591450;Taip;10;0;1;11
14909;Žemuogėlė;Boružiukai;7328566035;Taip;0;0;3;3
14910;Žemuogėlė;Boružiukai;8557325116;Taip;0;7;2;9
14911;Žemuogėlė;Boružiukai;1350383125;Taip;5;0;5;10
14912;Žemuogėlė;Boružiukai;7050896262;Taip;15;1;0;16
14913;Žemuogėlė;Boružiukai;3413805578;Taip;8;0;0;8
14914;Žemuogėlė;Boružiukai;1187953952;Taip;0;0;1;1
14915;Žemuogėlė;Boružiukai;3677459716;Taip;24;0;0;24
14916;Žemuogėlė;Boružiukai;8426601160;Taip;10;0;0;10
14917;Žemuogėlė;Boružiukai;5911215640;Taip;2;0;4;6
14918;Žemuogėlė;Šviesuliukai;3837424301;Taip;7;0;0;7
14919;Žemuogėlė;Šviesuliukai;5499401648;Taip;0;7;0;7
14920;Žemuogėlė;Šviesuliukai;3746045950;Taip;0;14;0;14
14921;Žemuogėlė;Šviesuliukai;4663181188;Taip;6;0;0;6
14922;Žemuogėlė;Šviesuliukai;8492878852;Taip;3;0;0;3
14923;Žemuogėlė;Šviesuliukai;7603740057;Taip;11;6;0;17
14924;Žemuogėlė;Šviesuliukai;6755278376;Ne;0;6;0;6
14925;Žemuogėlė;Šviesuliukai;4506847669;Taip;6;1;0;7
14926;Žemuogėlė;Šviesuliukai;7708949381;Taip;1;6;0;7
14927;Žemuogėlė;Šviesuliukai;7837251012;Taip;9;0;1;10
14928;Žemuogėlė;Šviesuliukai;7189855370;Taip;0;11;0;11
14929;Žemuogėlė;Šviesuliukai;3801534195;Taip;26;0;0;26
14930;Žemuogėlė;Šviesuliukai;1341637008;Taip;0;0;1;1
14931;Žemuogėlė;Šviesuliukai;8890454460;Taip;5;2;0;7
14932;Žemuogėlė;Šviesuliukai;7288060676;Taip;27;1;0;28
14933;Žemuogėlė;Šviesuliukai;6086270618;Ne;9;1;0;10
14934;Žemuogėlė;Lašiukai;1251497003;Taip;0;1;0;1
14935;Žemuogėlė;Lašiukai;3706531223;Taip;9;1;0;10
14936;Žemuogėlė;Lašiukai;8029484123;Taip;8;1;0;9
14937;Žemuogėlė;Lašiukai;5992802843;Taip;0;1;0;1
14938;Žemuogėlė;Lašiukai;3753156044;Taip;1;0;0;1
14939;Žemuogėlė;Lašiukai;7592566602;Taip;0;0;1;1
14940;Žemuogėlė;Lašiukai;1555899448;Taip;0;1;2;3
14941;Žemuogėlė;Lašiukai;1953538445;Taip;17;0;0;17
14942;Žemuogėlė;Lašiukai;3546429231;Taip;10;8;0;18
14943;Žemuogėlė;Lašiukai;9579921777;Taip;0;2;0;2
14944;Žemuogėlė;Lašiukai;7137182934;Taip;0;0;2;2
14945;Žemuogėlė;Lašiukai;3073956225;Taip;10;1;0;11
14946;Žemuogėlė;Lašiukai;9693814425;Taip;4;0;0;4
14947;Žemuogėlė;Lašiukai;3825509486;Taip;19;1;0;20
14948;Žemuogėlė;Lašiukai;3059525247;Taip;5;2;0;7
14949;Žemuogėlė;Lašiukai;6747566307;Taip;0;2;0;2
14950;Žemuogėlė;Lašiukai;2115883173;Taip;22;0;3;25
14951;Žemuogėlė;Lašiukai;9732291476;Taip;0;0;4;4
14952;Žemuogėlė;Skambaliukai;54663750186;Taip;0;1;0;1
14953;Žemuogėlė;Skambaliukai;3854265246;Taip;3;2;0;5
14954;Žemuogėlė;Skambaliukai;5147617128;Taip;0;13;0;13
14955;Žemuogėlė;Skambaliukai;1058207935;Taip;0;2;0;2
14956;Žemuogėlė;Skambaliukai;1628749648;Taip;13;0;1;14
14957;Žemuogėlė;Skambaliukai;6962103028;Taip;0;6;0;6
14958;Žemuogėlė;Skambaliukai;7714826773;Taip;5;12;0;17
14959;Žemuogėlė;Skambaliukai;3134493860;Taip;0;4;0;4
14960;Žemuogėlė;Skambaliukai;1907004376;Taip;5;2;0;7
14961;Žemuogėlė;Skambaliukai;38870047353;Taip;5;1;0;6
14962;Žemuogėlė;Skambaliukai;7403172794;Taip;0;3;0;3
14963;Žemuogėlė;Skambaliukai;9315711142;Taip;0;3;3;6
14964;Žemuogėlė;Skambaliukai;2102057496;Taip;0;3;0;3
14965;Žemuogėlė;Skambaliukai;4421397490;Taip;0;0;2;2
14966;Žemuogėlė;Skambaliukai;94792383091;Taip;5;15;2;22
14967;Žemuogėlė;Spinduliukai;3411390558;Taip;0;3;0;3
14968;Žemuogėlė;Spinduliukai;9955429241;Taip;0;0;3;3
14969;Žemuogėlė;Spinduliukai;5971652934;Taip;10;13;0;23
14970;Žemuogėlė;Spinduliukai;5127370193;Taip;0;0;5;5
14971;Žemuogėlė;Spinduliukai;1049009199;Ne;10;7;0;17
14972;Žemuogėlė;Spinduliukai;4578291476;Taip;10;14;2;26
14973;Žemuogėlė;Spinduliukai;5126348190;Ne;0;5;0;5
14974;Žemuogėlė;Spinduliukai;9534937419;Taip;0;4;0;4
14975;Žemuogėlė;Spinduliukai;2481547868;Taip;13;1;0;14
14976;Žemuogėlė;Spinduliukai;3612833383;Taip;16;1;0;17
14977;Žemuogėlė;Spinduliukai;9689082202;Ne;5;0;0;5
14978;Žemuogėlė;Spinduliukai;6707522989;Taip;0;7;0;7
14979;Žemuogėlė;Spinduliukai;6059069293;Taip;0;16;0;16
14980;Žemuogėlė;Spinduliukai;5770044886;Taip;10;7;0;17
14981;Žemuogėlė;Spinduliukai;7669457695;Ne;0;2;2;4
14982;Žemuogėlė;Spinduliukai;3041461125;Taip;2;2;0;4
14983;Žemuogėlė;Spinduliukai;8675089149;Taip;0;4;0;4
14984;Žemuogėlė;Spinduliukai;4933948491;Taip;3;0;0;3
14985;Žemuogėlė;Perliukai;4629107942;Ne;20;11;0;31
14986;Žemuogėlė;Perliukai;5505719625;Ne;0;1;0;1
14987;Žemuogėlė;Perliukai;8106709288;Taip;5;1;0;6
14988;Žemuogėlė;Perliukai;2664267604;Taip;24;0;0;24
14989;Žemuogėlė;Perliukai;1060986850;Taip;0;5;0;5
14990;Žemuogėlė;Perliukai;7794377881;Ne;1;1;0;2
14991;Žemuogėlė;Perliukai;1658954821;Taip;8;12;0;20
14992;Žemuogėlė;Perliukai;4698671798;Taip;11;1;1;13
14993;Žemuogėlė;Perliukai;2922827304;Taip;16;0;0;16
14994;Žemuogėlė;Perliukai;7415364637;Taip;11;0;0;11
14995;Žemuogėlė;Perliukai;3710681463;Taip;1;0;0;1
14996;Žemuogėlė;Perliukai;5687585794;Taip;3;0;1;4
14997;Žemuogėlė;Perliukai;1796489729;Taip;16;0;0;16
14998;Žemuogėlė;Perliukai;8215763877;Taip;10;2;0;12
14999;Žemuogėlė;Perliukai;2934225120;Ne;1;1;0;2
15000;Žemuogėlė;Perliukai;3426685084;Ne;12;1;3;16
15001;Žemuogėlė;Perliukai;9150335499;Taip;21;0;0;21
15002;Žemuogėlė;Perliukai;1079114347;Taip;19;0;0;19
15003;Žemuogėlė;Perliukai;5902241163;Ne;0;2;0;2
15004;Žemuogėlė;Perliukai;7879519193;Taip;0;3;0;3
15005;Žemuogėlė;Perliukai;2109195565;Taip;12;0;0;12
15006;Žemuogėlė;Drugeliai;2745609317;Taip;6;0;0;6
15007;Žemuogėlė;Drugeliai;9694133286;Taip;1;0;0;1
15008;Žemuogėlė;Drugeliai;5557409350;Taip;5;8;0;13
15009;Žemuogėlė;Drugeliai;7668200447;Taip;0;1;0;1
15010;Žemuogėlė;Drugeliai;7148244029;Taip;3;1;0;4
15011;Žemuogėlė;Drugeliai;1901423257;Taip;0;7;0;7
15012;Žemuogėlė;Drugeliai;4862145385;Taip;8;7;0;15
15013;Žemuogėlė;Drugeliai;4368183799;Ne;10;1;0;11
15014;Žemuogėlė;Drugeliai;9902953729;Taip;23;0;0;23
15015;Žemuogėlė;Drugeliai;9537297860;Taip;14;2;0;16
15016;Žemuogėlė;Drugeliai;5170205929;Taip;5;8;0;13
15017;Žemuogėlė;Drugeliai;2428043195;Taip;4;0;0;4
15018;Žemuogėlė;Drugeliai;1716114524;Taip;21;0;0;21
15019;Žemuogėlė;Drugeliai;8137567729;Taip;12;1;0;13
15020;Žemuogėlė;Drugeliai;8348185761;Taip;20;4;0;24
15021;Žemuogėlė;Drugeliai;9273896998;Taip;13;4;0;17
15022;Žemuogėlė;"VIEVERSIUKAI ";8048818368;Taip;6;0;0;6
15023;Žemuogėlė;"VIEVERSIUKAI ";6577040746;Taip;1;2;2;5
15024;Žemuogėlė;"VIEVERSIUKAI ";9872387354;Taip;3;0;2;5
15025;Žemuogėlė;"VIEVERSIUKAI ";2674188340;Taip;15;1;0;16
15026;Žemuogėlė;"VIEVERSIUKAI ";5300388726;Taip;2;10;0;12
15027;Žemuogėlė;"VIEVERSIUKAI ";6379837644;Taip;4;3;1;8
15028;Žemuogėlė;"VIEVERSIUKAI ";3104276726;Taip;11;0;0;11
15029;Žemuogėlė;"VIEVERSIUKAI ";3419907292;Taip;16;0;1;17
15030;Žemuogėlė;"VIEVERSIUKAI ";7323868051;Taip;0;2;0;2
15031;Žemuogėlė;"VIEVERSIUKAI ";2800160529;Taip;23;1;0;24
15032;Žemuogėlė;"VIEVERSIUKAI ";8934779062;Taip;7;1;0;8
15033;Žemuogėlė;"VIEVERSIUKAI ";3090630899;Taip;4;2;2;8
15034;Žemuogėlė;"VIEVERSIUKAI ";8091000121;Taip;0;4;3;7
15035;Žemuogėlė;"VIEVERSIUKAI ";2110963483;Taip;26;2;0;28
15036;Žemuogėlė;"NYKŠTUKAI ";1002937953;Taip;0;4;0;4
15037;Žemuogėlė;"NYKŠTUKAI ";6504659145;Ne;2;1;0;3
15038;Žemuogėlė;"NYKŠTUKAI ";3505090532;Taip;12;0;0;12
15039;Žemuogėlė;"NYKŠTUKAI ";5208043522;Ne;1;0;0;1
15040;Žemuogėlė;"NYKŠTUKAI ";3740127955;Taip;0;0;1;1
15041;Žemuogėlė;"NYKŠTUKAI ";5614510812;Taip;13;0;0;13
15042;Žemuogėlė;"NYKŠTUKAI ";4089939292;Taip;2;0;0;2
15043;Žemuogėlė;"NYKŠTUKAI ";9584172565;Ne;18;0;0;18
15044;Žemuogėlė;"NYKŠTUKAI ";8706379207;Taip;11;0;2;13
15045;Žemuogėlė;"NYKŠTUKAI ";1790341419;Ne;2;1;6;9
15046;Žemuogėlė;"NYKŠTUKAI ";4998981337;Taip;3;7;0;10
15047;Žemuogėlė;"NYKŠTUKAI ";6045257180;Taip;1;0;1;2
15048;Žemuogėlė;"NYKŠTUKAI ";8301927361;Taip;21;0;0;21
15049;Žemuogėlė;"NYKŠTUKAI ";2496321184;Taip;8;1;0;9
15050;Žemuogėlė;"NYKŠTUKAI ";8490643028;Taip;10;0;0;10
15051;Žemuogėlė;"NYKŠTUKAI ";2139102266;Taip;13;2;0;15
15052;Žemuogėlė;"NYKŠTUKAI ";9735379466;Taip;19;0;0;19
15053;Žemuogėlė;KIŠKUČIAI;4654060157;Taip;0;2;2;4
15054;Žemuogėlė;KIŠKUČIAI;2652630375;Taip;0;1;2;3
15055;Žemuogėlė;KIŠKUČIAI;1250186598;Taip;5;2;4;11
15056;Žemuogėlė;KIŠKUČIAI;3287415964;Ne;5;1;1;7
15057;Žemuogėlė;KIŠKUČIAI;5094867109;Taip;0;16;0;16
15058;Žemuogėlė;KIŠKUČIAI;5186248897;Taip;28;1;0;29
15059;Žemuogėlė;KIŠKUČIAI;5125826172;Taip;5;11;0;16
15060;Žemuogėlė;KIŠKUČIAI;8262862183;Taip;5;0;0;5
15061;Žemuogėlė;KIŠKUČIAI;8798113318;Taip;0;1;0;1
15062;Žemuogėlė;KIŠKUČIAI;1280794094;Taip;0;2;0;2
15063;Žemuogėlė;KIŠKUČIAI;2251142510;Taip;2;1;0;3
15064;Žemuogėlė;KIŠKUČIAI;4974793430;Taip;13;0;1;14
15065;Žemuogėlė;KIŠKUČIAI;6659616731;Taip;3;0;0;3
15066;Žemuogėlė;KIŠKUČIAI;3459960812;Taip;11;0;0;11
15067;Žemuogėlė;Žiniukai;7804015060;Taip;0;3;0;3
15068;Žemuogėlė;Žiniukai;3765022476;Taip;5;0;0;5
15069;Žemuogėlė;Žiniukai;9476688736;Taip;5;1;0;6
15070;Žemuogėlė;Žiniukai;2001471529;Taip;0;1;1;2
15071;Žemuogėlė;Žiniukai;9519563708;Ne;0;4;1;5
15072;Žemuogėlė;Žiniukai;5266493632;Taip;0;5;0;5
15073;Žemuogėlė;Žiniukai;2841634296;Taip;0;3;0;3
15074;Žemuogėlė;Žiniukai;3237083654;Taip;4;1;0;5
15075;Žemuogėlė;Žiniukai;2259779058;Taip;7;0;0;7
15076;Žemuogėlė;Žiniukai;9693894254;Ne;5;3;1;9
15077;Žemuogėlė;Žiniukai;9378432383;Taip;5;1;0;6
15078;Žemuogėlė;Žiniukai;6073971598;Taip;1;2;0;3
15079;Žemuogėlė;Žiniukai;6913038845;Taip;4;1;0;5
15080;Žemuogėlė;Žiniukai;6581889641;Taip;0;2;2;4
15081;Žemuogėlė;Žiniukai;2555902309;Taip;6;6;0;12
15082;Žemuogėlė;Žiniukai;8757701456;Taip;15;2;0;17
15083;Žemuogėlė;Žiniukai;2132549536;Taip;5;8;0;13
15084;Žemuogėlė;Žiniukai;5532053268;Taip;8;2;0;10
15085;Žemuogėlė;Žiniukai;8496353410;Taip;0;10;0;10
15086;Žemuogėlė;Žiniukai;1733808230;Taip;0;10;0;10
15087;Žemuogėlė;Žiniukai;4660479216;Taip;7;0;1;8
15088;Žibutė;PELĖDŽIUKAI;3496675605;Taip;0;2;0;2
15089;Žibutė;PELĖDŽIUKAI;59824395612;Taip;0;1;1;2
15090;Žibutė;PELĖDŽIUKAI;2361682400;Taip;0;1;1;2
15091;Žibutė;PELĖDŽIUKAI;1826763192;Taip;0;2;11;13
15092;Žibutė;PELĖDŽIUKAI;1259481487;Taip;0;1;0;1
15093;Žibutė;PELĖDŽIUKAI;3826875107;Taip;0;3;0;3
15094;Žibutė;PELĖDŽIUKAI;3186792146;Taip;0;1;4;5
15095;Žibutė;PELĖDŽIUKAI;7344095020;Taip;4;1;2;7
15096;Žibutė;PELĖDŽIUKAI;1078105287;Taip;0;4;0;4
15097;Žibutė;PELĖDŽIUKAI;1394895695;Taip;4;1;0;5
15098;Žibutė;PELĖDŽIUKAI;2236930916;Taip;0;1;0;1
15099;Žibutė;PELĖDŽIUKAI;7095870173;Taip;0;1;0;1
15100;Žibutė;PELĖDŽIUKAI;2840754631;Taip;10;1;0;11
15101;Žibutė;PELĖDŽIUKAI;6089325755;Taip;0;1;1;2
15102;Žibutė;PELĖDŽIUKAI;1274409680;Taip;7;1;0;8
15103;Žibutė;PELĖDŽIUKAI;8278928396;Taip;5;1;0;6
15104;Žibutė;PELĖDŽIUKAI;2957525481;Taip;5;2;0;7
15105;Žibutė;PELĖDŽIUKAI;3191351976;Taip;0;1;1;2
15106;Žibutė;KREGŽDUTĖS;7036454359;Taip;12;0;0;12
15107;Žibutė;KREGŽDUTĖS;3555071718;Taip;1;0;1;2
15108;Žibutė;KREGŽDUTĖS;5190377896;Taip;17;0;0;17
15109;Žibutė;KREGŽDUTĖS;3574946816;Taip;0;0;1;1
15110;Žibutė;KREGŽDUTĖS;6194464236;Taip;0;0;4;4
15111;Žibutė;KREGŽDUTĖS;3777544301;Taip;0;0;4;4
15112;Žibutė;KREGŽDUTĖS;9923687090;Ne;17;0;0;17
15113;Žibutė;KREGŽDUTĖS;4847295068;Taip;10;0;2;12
15114;Žibutė;KREGŽDUTĖS;9700866512;Taip;0;1;2;3
15115;Žibutė;KREGŽDUTĖS;7774532200;Taip;10;2;1;13
15116;Žibutė;KREGŽDUTĖS;2607509585;Taip;0;0;1;1
15117;Žibutė;KREGŽDUTĖS;2438980348;Taip;0;0;4;4
15118;Žibutė;KREGŽDUTĖS;9918283923;Taip;0;0;1;1
15119;Žibutė;KREGŽDUTĖS;5126232169;Taip;6;0;1;7
15120;Žibutė;KREGŽDUTĖS;8792292819;Taip;14;0;7;21
15121;Žibutė;KREGŽDUTĖS;7668484415;Taip;0;0;7;7
15122;Žibutė;KREGŽDUTĖS;2516448580;Taip;0;0;3;3
15123;Žibutė;BORUŽĖLĖS;4278832423;Taip;4;1;0;5
15124;Žibutė;BORUŽĖLĖS;3066580779;Taip;5;0;5;10
15125;Žibutė;BORUŽĖLĖS;1786332689;Taip;10;0;0;10
15126;Žibutė;BORUŽĖLĖS;8879347884;Taip;6;0;5;11
15127;Žibutė;BORUŽĖLĖS;7764376193;Taip;8;0;1;9
15128;Žibutė;BORUŽĖLĖS;3618347199;Taip;0;1;0;1
15129;Žibutė;BORUŽĖLĖS;5186839413;Taip;0;1;2;3
15130;Žibutė;BORUŽĖLĖS;2374119662;Taip;12;5;0;17
15131;Žibutė;BORUŽĖLĖS;1381488132;Taip;0;0;11;11
15132;Žibutė;BORUŽĖLĖS;5591970907;Taip;1;0;5;6
15133;Žibutė;BORUŽĖLĖS;6672033757;Taip;0;1;0;1
15134;Žibutė;BORUŽĖLĖS;7481695788;Taip;0;10;0;10
15135;Žibutė;BORUŽĖLĖS;1112295932;Ne;10;0;0;10
15136;Žibutė;BORUŽĖLĖS;8155327668;Taip;3;0;5;8
15137;Žibutė;BORUŽĖLĖS;5632520305;Taip;0;0;6;6
15138;Žibutė;BORUŽĖLĖS;4622674814;Ne;0;1;0;1
15139;Žibutė;BORUŽĖLĖS;7805758264;Taip;1;4;0;5
15140;Žibutė;BORUŽĖLĖS;8640664660;Taip;0;0;5;5
15141;Žibutė;BITUTĖS;7023683517;Taip;6;2;0;8
15142;Žibutė;BITUTĖS;7853531467;Taip;0;1;0;1
15143;Žibutė;BITUTĖS;3687123871;Taip;3;0;1;4
15144;Žibutė;BITUTĖS;2312717334;Taip;0;0;3;3
15145;Žibutė;BITUTĖS;6361543454;Taip;3;2;0;5
15146;Žibutė;BITUTĖS;1297347740;Taip;0;0;3;3
15147;Žibutė;BITUTĖS;6934760468;Taip;0;1;0;1
15148;Žibutė;BITUTĖS;4455757640;Taip;5;1;1;7
15149;Žibutė;BITUTĖS;8797870379;Taip;9;3;3;15
15150;Žibutė;BITUTĖS;7792267540;Taip;5;5;2;12
15151;Žibutė;BITUTĖS;9221523836;Taip;0;7;0;7
15152;Žibutė;BITUTĖS;3632745935;Taip;5;2;5;12
15153;Žibutė;BITUTĖS;7611641692;Taip;0;1;0;1
15154;Žibutė;BITUTĖS;5112512917;Taip;0;5;3;8
15155;Žibutė;BITUTĖS;8276724226;Taip;0;1;2;3
15156;Žibutė;BITUTĖS;4685356158;Taip;0;0;2;2
15157;Žibutė;BITUTĖS;1515636796;Taip;0;1;0;1
15158;Žibutė;BITUTĖS;7872636200;Taip;0;4;1;5
15159;Žibutė;BITUTĖS;6833179680;Taip;0;9;0;9
15160;Žibutė;BITUTĖS;1614551884;Taip;10;1;1;12
15161;Žibutė;KAČIUKAI;6978977383;Taip;0;1;0;1
15162;Žibutė;KAČIUKAI;9634311146;Taip;0;2;1;3
15163;Žibutė;KAČIUKAI;9868621666;Ne;0;0;5;5
15164;Žibutė;KAČIUKAI;1366469428;Taip;6;2;0;8
15165;Žibutė;KAČIUKAI;4825064521;Taip;7;0;13;20
15166;Žibutė;KAČIUKAI;5826523148;Taip;0;2;1;3
15167;Žibutė;KAČIUKAI;3957898269;Taip;1;5;1;7
15168;Žibutė;KAČIUKAI;5591698130;Taip;0;0;2;2
15169;Žibutė;KAČIUKAI;1004098038;Taip;7;0;2;9
15170;Žibutė;KAČIUKAI;7479437931;Taip;13;5;0;18
15171;Žibutė;KAČIUKAI;1362419302;Taip;0;5;0;5
15172;Žibutė;KAČIUKAI;7531027545;Ne;0;0;4;4
15173;Žibutė;KAČIUKAI;3645481894;Taip;3;1;0;4
15174;Žibutė;KAČIUKAI;8880329060;Ne;0;1;7;8
15175;Žibutė;KAČIUKAI;5009495840;Taip;2;0;0;2
15176;Žibutė;KAČIUKAI;7136145033;Ne;6;5;1;12
15177;Žibutė;KAČIUKAI;9498011134;Taip;2;1;0;3
15178;Žibutė;KAČIUKAI;5677389434;Taip;0;3;0;3
15179;Žibutė;KAČIUKAI;5416015554;Taip;0;0;3;3
15180;Žibutė;ZUIKIAI;4741505387;Taip;16;0;0;16
15181;Žibutė;ZUIKIAI;6209156111;Taip;9;2;0;11
15182;Žibutė;ZUIKIAI;2787326978;Taip;7;0;1;8
15183;Žibutė;ZUIKIAI;9856822557;Taip;1;1;0;2
15184;Žibutė;ZUIKIAI;4787010953;Taip;15;0;0;15
15185;Žibutė;ZUIKIAI;3875455223;Taip;3;1;0;4
15186;Žibutė;ZUIKIAI;3449188614;Taip;6;0;2;8
15187;Žibutė;ZUIKIAI;4434623264;Taip;2;2;0;4
15188;Žibutė;ZUIKIAI;2013724729;Taip;11;1;0;12
15189;Žibutė;ZUIKIAI;3786933891;Taip;6;1;0;7
15190;Žibutė;ZUIKIAI;9379539151;Taip;3;2;0;5
15191;Žibutė;ZUIKIAI;9439026609;Taip;18;2;0;20
15192;Žibutė;ZUIKIAI;6234135622;Taip;14;0;0;14
15193;Žiedas;Bitutės;1484464986;Taip;0;1;2;3
15194;Žiedas;Bitutės;4807479784;Ne;0;2;0;2
15195;Žiedas;Bitutės;5513311280;Taip;0;1;1;2
15196;Žiedas;Bitutės;1529988412;Taip;0;1;1;2
15197;Žiedas;Bitutės;1007894628;Taip;12;1;0;13
15198;Žiedas;Bitutės;1625009666;Taip;0;3;2;5
15199;Žiedas;Bitutės;1550350520;Ne;9;1;0;10
15200;Žiedas;Bitutės;9058688663;Ne;7;1;0;8
15201;Žiedas;Bitutės;7150433256;Taip;0;2;2;4
15202;Žiedas;Bitutės;3414702993;Taip;6;1;0;7
15203;Žiedas;Bitutės;2507543124;Taip;12;4;0;16
15204;Žiedas;Bitutės;88471315730;Taip;0;2;0;2
15205;Žiedas;Bitutės;34193530;Taip;0;1;0;1
15206;Žiedas;Bitutės;69485023219;Taip;0;1;0;1
15207;Žiedas;Bitutės;86877563124;Taip;15;1;1;17
15208;Žiedas;Bitutės;78720591915;Taip;0;2;4;6
15209;Žiedas;Bitutės;5108263139;Taip;11;0;0;11
15210;Žiedas;Bitutės;5885209631;Taip;0;1;4;5
15211;Žiedas;Bitutės;1737296046;Taip;0;2;1;3
15212;Žiedas;Bitutės;1048272199;Taip;0;4;0;4
15213;Žiedas;Bitutės;5007348884;Ne;0;1;1;2
15214;Žiedas;Varpeliai;7097790025;Ne;0;3;0;3
15215;Žiedas;Varpeliai;3230107921;Taip;0;0;1;1
15216;Žiedas;Varpeliai;3178778438;Taip;15;2;0;17
15217;Žiedas;Varpeliai;9602083568;Taip;12;3;0;15
15218;Žiedas;Varpeliai;5628720422;Taip;12;0;0;12
15219;Žiedas;Varpeliai;1582961378;Taip;3;2;0;5
15220;Žiedas;Varpeliai;1878050384;Ne;0;0;1;1
15221;Žiedas;Varpeliai;6882614465;Taip;0;2;0;2
15222;Žiedas;Varpeliai;6914059680;Taip;12;0;0;12
15223;Žiedas;Varpeliai;7771247056;Taip;4;1;0;5
15224;Žiedas;Varpeliai;6515510381;Taip;0;1;0;1
15225;Žiedas;Varpeliai;3842589827;Taip;9;1;0;10
15226;Žiedas;Varpeliai;3387263016;Ne;0;1;0;1
15227;Žiedas;Varpeliai;3178580610;Taip;0;3;0;3
15228;Žiedas;Varpeliai;5061575884;Taip;10;0;0;10
15229;Žiedas;Varpeliai;1333233100;Ne;20;1;0;21
15230;Žiedas;Varpeliai;9020540780;Taip;0;1;0;1
15231;Žiedas;Varpeliai;8148831014;Taip;0;3;2;5
15232;Žiedas;Varpeliai;9140396365;Taip;0;1;0;1
15233;Žiedas;Ramunėlės;3055218791;Taip;0;1;0;1
15234;Žiedas;Ramunėlės;1333555044;Taip;6;1;0;7
15235;Žiedas;Ramunėlės;2092319455;Ne;4;7;0;11
15236;Žiedas;Ramunėlės;8753972322;Taip;0;4;0;4
15237;Žiedas;Ramunėlės;3900091129;Ne;14;0;0;14
15238;Žiedas;Ramunėlės;2515028280;Taip;0;4;0;4
15239;Žiedas;Ramunėlės;1583038469;Taip;0;6;0;6
15240;Žiedas;Ramunėlės;8208331527;Taip;0;3;0;3
15241;Žiedas;Ramunėlės;9037835899;Taip;5;1;0;6
15242;Žiedas;Ramunėlės;5577339739;Taip;2;0;1;3
15243;Žiedas;Ramunėlės;6884933845;Taip;0;2;0;2
15244;Žiedas;Ramunėlės;7548653053;Taip;0;1;0;1
15245;Žiedas;Ramunėlės;1659873036;Taip;2;2;0;4
15246;Žiedas;Ramunėlės;2843328732;Taip;0;1;4;5
15247;Žiedas;Ramunėlės;1243169901;Taip;0;1;0;1
15248;Žiedas;Ramunėlės;1580781723;Taip;1;4;0;5
15249;Žiedas;Ramunėlės;4933650089;Taip;11;2;0;13
15250;Žiedas;Ramunėlės;4044156905;Ne;2;9;2;13
15251;Žiedas;Ramunėlės;4844442247;Taip;0;7;0;7
15252;Žiedas;Ramunėlės;7294671324;Taip;0;4;0;4
15253;Žiedas;Pakalnutės;7798930533;Taip;0;3;0;3
15254;Žiedas;Pakalnutės;1094506858;Ne;6;7;0;13
15255;Žiedas;Pakalnutės;9375048835;Taip;0;6;0;6
15256;Žiedas;Pakalnutės;5266048033;Taip;2;3;0;5
15257;Žiedas;Pakalnutės;5804334198;Taip;0;0;2;2
15258;Žiedas;Pakalnutės;4808020243;Taip;0;1;0;1
15259;Žiedas;Pakalnutės;3742949697;Taip;0;1;0;1
15260;Žiedas;Pakalnutės;6343634478;Ne;5;11;0;16
15261;Žiedas;Pakalnutės;8015880569;Taip;0;2;0;2
15262;Žiedas;Pakalnutės;8857150598;Taip;10;2;0;12
15263;Žiedas;Pakalnutės;2416234016;Taip;10;1;0;11
15264;Žiedas;Pakalnutės;9054709268;Taip;4;3;0;7
15265;Žiedas;Pakalnutės;9964883646;Taip;0;1;0;1
15266;Žiedas;Pakalnutės;4917324037;Taip;8;2;0;10
15267;Žiedas;Pakalnutės;4021189767;Taip;2;3;0;5
15268;Žiedas;Pakalnutės;1346658299;Taip;0;7;0;7
15269;Žiedas;Pakalnutės;4663390744;Taip;0;2;0;2
15270;Žiedas;Pakalnutės;7678333395;Taip;0;3;0;3
15271;Žiedas;Pakalnutės;9207945616;Taip;10;2;0;12
15272;Žiedas;Pakalnutės;7221702677;Ne;0;1;0;1
15273;Žiedas;Pakalnutės;2393112381;Taip;0;5;0;5
15274;Žiedas;Rožytės;8645771800;Taip;14;0;0;14
15275;Žiedas;Rožytės;7942276632;Taip;3;2;0;5
15276;Žiedas;Rožytės;7799489700;Taip;0;19;0;19
15277;Žiedas;Rožytės;8163645535;Taip;0;5;0;5
15278;Žiedas;Rožytės;8927034492;Taip;0;0;21;21
15279;Žiedas;Rožytės;2182381160;Taip;2;1;0;3
15280;Žiedas;Rožytės;8822472312;Taip;0;1;0;1
15281;Žiedas;Rožytės;9021286246;Taip;0;6;0;6
15282;Žiedas;Rožytės;6261847845;Taip;0;1;3;4
15283;Žiedas;Rožytės;5020148822;Taip;5;1;0;6
15284;Žiedas;Rožytės;1777501190;Taip;10;1;0;11
15285;Žiedas;Rožytės;1844621525;Ne;10;0;1;11
15286;Žiedas;Rožytės;6459679214;Taip;0;6;0;6
15287;Žiedas;Rožytės;7672879525;Taip;5;2;0;7
15288;Žiedas;Rožytės;6175213274;Ne;0;1;0;1
15289;Žiedas;Rožytės;3984607857;Taip;12;0;0;12
15290;Žiedas;Rožytės;6041919197;Taip;0;4;0;4
15291;Žiedas;Pumpurėliai;5830738378;Taip;10;1;0;11
15292;Žiedas;Pumpurėliai;2320543511;Taip;0;4;0;4
15293;Žiedas;Pumpurėliai;4360175072;Taip;11;0;1;12
15294;Žiedas;Pumpurėliai;9238553024;Taip;9;1;0;10
15295;Žiedas;Pumpurėliai;7780469974;Taip;16;0;0;16
15296;Žiedas;Pumpurėliai;8056265378;Ne;8;0;10;18
15297;Žiedas;Pumpurėliai;9337317396;Taip;12;3;0;15
15298;Žiedas;Pumpurėliai;8088806507;Ne;5;5;0;10
15299;Žiedas;Pumpurėliai;1086714229;Taip;10;0;0;10
15300;Žiedas;Pumpurėliai;2320411618;Taip;2;4;0;6
15301;Žiedas;Pumpurėliai;5635958124;Taip;2;1;0;3
15302;Žiedas;Pumpurėliai;7677595571;Taip;8;1;4;13
15303;Žiedas;Pumpurėliai;4699833757;Taip;5;1;0;6
15304;Žiedas;Pumpurėliai;2633676360;Taip;0;1;1;2
15305;Žiedas;Pumpurėliai;8797245208;Ne;6;0;1;7
15306;Žiedas;"Dobiliukai ";6066566242;Taip;17;1;0;18
15307;Žiedas;"Dobiliukai ";8436592169;Taip;11;1;0;12
15308;Žiedas;"Dobiliukai ";3654878543;Taip;10;1;1;12
15309;Žiedas;"Dobiliukai ";8794003030;Taip;0;1;0;1
15310;Žiedas;"Dobiliukai ";8444690698;Taip;5;1;5;11
15311;Žiedas;"Dobiliukai ";2715554681;Ne;9;2;0;11
15312;Žiedas;"Dobiliukai ";2132564079;Taip;8;0;2;10
15313;Žiedas;"Dobiliukai ";9586578606;Ne;0;7;0;7
15314;Žiedas;"Dobiliukai ";3940002957;Ne;0;1;0;1
15315;Žiedas;"Dobiliukai ";5353507617;Taip;17;1;0;18
15316;Žiedas;"Dobiliukai ";4087903129;Taip;0;6;0;6
15317;Žiedas;"Dobiliukai ";8185042446;Taip;0;1;3;4
15318;Žiedas;"Dobiliukai ";7049399327;Taip;0;2;0;2
15319;Žiedas;"Dobiliukai ";5788152675;Taip;1;0;0;1
15320;Žiedas;"Dobiliukai ";2462497997;Taip;0;1;0;1
15321;Žiedas;"Dobiliukai ";8388297947;Ne;0;1;0;1
15322;Žiedas;"Dobiliukai ";3011163947;Taip;0;0;1;1
15323;Žiedas;"Dobiliukai ";6748378606;Taip;5;1;0;6
15324;Žiedas;"Dobiliukai ";7558307454;Taip;1;0;0;1
15325;Žiedas;"Dobiliukai ";6795173519;Taip;4;1;3;8
15326;Žiedas;RŪTELĖS;2134466899;Taip;0;1;0;1
15327;Žiedas;RŪTELĖS;5108263139;Taip;0;1;0;1
15328;Žiedas;RŪTELĖS;6822887260;Taip;0;1;0;1
15329;Žiedas;RŪTELĖS;5914428064;Ne;3;4;0;7
15330;Žiedas;RŪTELĖS;3857121753;Taip;0;2;2;4
15331;Žiedas;RŪTELĖS;6443633568;Taip;16;3;0;19
15332;Žiedas;RŪTELĖS;7491134119;Taip;0;2;0;2
15333;Žiedas;RŪTELĖS;5959899914;Taip;0;3;0;3
15334;Žiedas;RŪTELĖS;7333813704;Taip;0;1;0;1
15335;Žiedas;RŪTELĖS;6658762922;Taip;0;2;0;2
15336;Žiedas;RŪTELĖS;5126173608;Taip;0;3;1;4
15337;Žiedas;RŪTELĖS;1738121071;Taip;0;2;0;2
15338;Žiedas;RŪTELĖS;5420327672;Taip;0;1;0;1
15339;Žiedas;RŪTELĖS;1253833615;Taip;0;2;0;2
15340;Žiedas;RŪTELĖS;7172793351;Taip;0;1;0;1
15341;Žiedas;RŪTELĖS;4497634040;Taip;3;1;0;4
15342;Žiedas;RŪTELĖS;9218388800;Taip;0;3;0;3
15343;Žiedas;RŪTELĖS;7072578987;Taip;12;3;0;15
15344;Žiedas;RŪTELĖS;3715928992;Ne;0;2;2;4
15345;Žiedas;RŪTELĖS;9352485926;Taip;5;0;2;7
15346;Žiedas;RŪTELĖS;5928377774;Taip;0;0;6;6
15347;Žiedas;SAULĖGRĄŽOS;1011602827;Taip;0;3;1;4
15348;Žiedas;SAULĖGRĄŽOS;8887021328;Taip;0;1;0;1
15349;Žiedas;SAULĖGRĄŽOS;2932857132;Taip;0;1;3;4
15350;Žiedas;SAULĖGRĄŽOS;5552786845;Taip;13;1;0;14
15351;Žiedas;SAULĖGRĄŽOS;8833895006;Taip;5;9;0;14
15352;Žiedas;SAULĖGRĄŽOS;5658235821;Taip;10;1;0;11
15353;Žiedas;SAULĖGRĄŽOS;4992446383;Taip;0;1;2;3
15354;Žiedas;SAULĖGRĄŽOS;9057761408;Taip;13;1;0;14
15355;Žiedas;SAULĖGRĄŽOS;1645402434;Taip;0;2;0;2
15356;Žiedas;SAULĖGRĄŽOS;2026540724;Taip;0;4;0;4
15357;Žiedas;SAULĖGRĄŽOS;4564268323;Taip;10;5;0;15
15358;Žiedas;SAULĖGRĄŽOS;8801900486;Taip;0;1;0;1
15359;Žiedas;SAULĖGRĄŽOS;1609487830;Taip;0;1;0;1
15360;Žiedas;SAULĖGRĄŽOS;3437651010;Taip;0;1;2;3
15361;Žiedas;SAULĖGRĄŽOS;3422053505;Taip;0;17;0;17
15362;Žiedas;SAULĖGRĄŽOS;5274845525;Taip;10;3;0;13
15363;Žiedas;SAULĖGRĄŽOS;6053010050;Taip;0;1;0;1
15364;Žiedas;SAULĖGRĄŽOS;9685152753;Taip;0;1;3;4
15365;Žiedas;SAULĖGRĄŽOS;7604200899;Taip;0;1;0;1
15366;Žiedas;SAULĖGRĄŽOS;3303581707;Taip;4;2;0;6
15367;Žiedas;RUGIAGĖLĖS;1035854293;Taip;0;1;2;3
15368;Žiedas;RUGIAGĖLĖS;1917085385;Taip;3;2;0;5
15369;Žiedas;RUGIAGĖLĖS;5987689515;Taip;6;2;0;8
15370;Žiedas;RUGIAGĖLĖS;1826599535;Taip;5;0;0;5
15371;Žiedas;RUGIAGĖLĖS;2124086277;Taip;0;1;2;3
15372;Žiedas;RUGIAGĖLĖS;2642760082;Taip;0;4;0;4
15373;Žiedas;RUGIAGĖLĖS;1093479755;Taip;5;1;2;8
15374;Žiedas;RUGIAGĖLĖS;7381658912;Taip;0;2;2;4
15375;Žiedas;RUGIAGĖLĖS;2964286644;Ne;20;1;0;21
15376;Žiedas;RUGIAGĖLĖS;2347857813;Taip;0;21;0;21
15377;Žiedas;RUGIAGĖLĖS;1975718197;Taip;6;1;1;8
15378;Žiedas;RUGIAGĖLĖS;2312361963;Taip;0;0;21;21
15379;Žiedas;RUGIAGĖLĖS;6859410675;Taip;6;1;0;7
15380;Žiedas;RUGIAGĖLĖS;2148027253;Ne;15;1;0;16
15381;Žiedas;RUGIAGĖLĖS;1758868055;Taip;0;1;2;3
15382;Žiedas;RUGIAGĖLĖS;2182340305;Ne;2;1;0;3
15383;Žiedas;RUGIAGĖLĖS;1958481432;Taip;0;0;2;2
15384;Žiedas;RUGIAGĖLĖS;3099608553;Taip;6;2;1;9
15385;Žiedas;RUGIAGĖLĖS;1390431397;Taip;0;0;2;2
15386;Žiedas;RUGIAGĖLĖS;9393499257;Taip;0;1;0;1
15387;Žiedas;RUGIAGĖLĖS;2170318597;Ne;0;2;1;3
15388;Žiedas;RUGIAGĖLĖS;8276022676;Taip;12;0;0;12
15389;Žiedas;RUGIAGĖLĖS;7584712202;Taip;0;2;0;2
15390;Žiedas;Boružėlės;4922560649;Taip;5;1;0;6
15391;Žiedas;Boružėlės;2095655987;Taip;0;3;0;3
15392;Žiedas;Boružėlės;7814504623;Taip;6;0;0;6
15393;Žiedas;Boružėlės;9648580306;Taip;8;2;0;10
15394;Žiedas;Boružėlės;9699668892;Taip;0;1;0;1
15395;Žiedas;Boružėlės;5653785844;Taip;18;0;0;18
15396;Žiedas;Boružėlės;9247088735;Taip;17;1;0;18
15397;Žiedas;Boružėlės;7396006218;Taip;0;2;0;2
15398;Žiedas;Boružėlės;5588136738;Taip;0;6;0;6
15399;Žiedas;Boružėlės;6786526552;Taip;9;2;0;11
15400;Žiedas;Boružėlės;2511423525;Taip;7;1;1;9
15401;Žiedas;Boružėlės;6432090199;Taip;5;1;0;6
15402;Žiedas;Boružėlės;5626494892;Taip;16;0;0;16
15403;Žiedas;Boružėlės;7954517383;Taip;6;2;0;8
15404;Žiedas;Boružėlės;3702078720;Taip;13;1;0;14
15405;Žiedas;Boružėlės;2849254119;Taip;10;3;1;14
15406;Žiedas;Boružėlės;9736967156;Taip;2;2;2;6
15407;Žiedas;Boružėlės;3586376571;Taip;9;2;0;11
15408;Žiedas;Boružėlės;1139186052;Taip;14;0;0;14
15409;Žiedas;Boružėlės;3704491209;Taip;8;6;0;14
15410;Žiedas;AGUONĖLĖS;1885623466;Taip;15;1;0;16
15411;Žiedas;AGUONĖLĖS;9464217926;Taip;14;1;0;15
15412;Žiedas;AGUONĖLĖS;9543860953;Taip;6;1;0;7
15413;Žiedas;AGUONĖLĖS;3247328978;Taip;10;2;0;12
15414;Žiedas;AGUONĖLĖS;4250009129;Taip;7;1;0;8
15415;Žiedas;AGUONĖLĖS;7399937598;Taip;5;1;0;6
15416;Žiedas;AGUONĖLĖS;1325715061;Taip;0;1;2;3
15417;Žiedas;AGUONĖLĖS;9111149805;Taip;0;2;0;2
15418;Žiedas;AGUONĖLĖS;4695900874;Taip;0;2;0;2
15419;Žiedas;AGUONĖLĖS;3258241663;Taip;2;3;0;5
15420;Žiedas;AGUONĖLĖS;6700593422;Taip;18;0;0;18
15421;Žiedas;AGUONĖLĖS;3835714894;Taip;10;1;0;11
15422;Žiedas;AGUONĖLĖS;7535993061;Taip;3;1;0;4
15423;Žiedas;AGUONĖLĖS;4809093267;Taip;12;1;0;13
15424;Žiedas;AGUONĖLĖS;1874460511;Taip;8;0;0;8
15425;Žiedas;AGUONĖLĖS;6245366671;Taip;0;1;0;1
15426;Žiedas;AGUONĖLĖS;6856477482;Taip;17;1;0;18
15427;Žiedas;ŽIBUTĖS;3654749109;Taip;0;1;2;3
15428;Žiedas;ŽIBUTĖS;1835893385;Taip;5;0;4;9
15429;Žiedas;ŽIBUTĖS;2913328259;Taip;9;0;0;9
15430;Žiedas;ŽIBUTĖS;7418985667;Taip;10;0;3;13
15431;Žiedas;ŽIBUTĖS;4568189195;Ne;2;3;0;5
15432;Žiedas;ŽIBUTĖS;2097392327;Taip;7;0;7;14
15433;Žiedas;ŽIBUTĖS;9269909624;Taip;8;1;1;10
15434;Žiedas;ŽIBUTĖS;7114207461;Taip;17;1;0;18
15435;Žiedas;ŽIBUTĖS;5106427067;Ne;6;1;5;12
15436;Žiedas;ŽIBUTĖS;3407247493;Taip;14;0;0;14
15437;Žiedas;ŽIBUTĖS;8084555994;Taip;7;1;0;8
15438;Žiedas;ŽIBUTĖS;3477341028;Taip;0;5;0;5
15439;Žiedas;ŽIBUTĖS;6923562927;Taip;1;20;0;21
15440;Žiedas;ŽIBUTĖS;1669599543;Ne;17;1;0;18
15441;Žiedas;ŽIBUTĖS;1509140770;Taip;0;3;1;4
15442;Žiedas;ŽIBUTĖS;7498211984;Taip;10;1;1;12
15443;Žiedas;ŽIBUTĖS;3948942801;Taip;0;1;2;3
15444;Žiedas;DRUGELIAI;8517250094;Taip;0;2;1;3
15445;Žiedas;DRUGELIAI;9894489800;Taip;8;1;0;9
15446;Žiedas;DRUGELIAI;2763469583;Taip;0;3;0;3
15447;Žiedas;DRUGELIAI;9757771445;Taip;11;3;0;14
15448;Žiedas;DRUGELIAI;4222689492;Ne;0;1;0;1
15449;Žiedas;DRUGELIAI;2763996098;Taip;5;2;0;7
15450;Žiedas;DRUGELIAI;4983852075;Taip;0;2;0;2
15451;Žiedas;DRUGELIAI;9129315784;Taip;0;6;0;6
15452;Žiedas;DRUGELIAI;7952899220;Taip;0;9;0;9
15453;Žiedas;DRUGELIAI;2679205188;Ne;0;1;0;1
15454;Žiedas;DRUGELIAI;2026462074;Taip;0;1;0;1
15455;Žiedas;DRUGELIAI;4749655084;Taip;0;2;0;2
15456;Žiedas;DRUGELIAI;9587581470;Taip;0;1;1;2
15457;Žiedas;DRUGELIAI;9415269410;Ne;5;2;0;7
15458;Žilvitis;BITUČIŲ;7054808979;Ne;10;0;0;10
15459;Žiogelis;SKRUZDELYTĖS;2959983278;Taip;12;0;0;12
15460;Žiogelis;SKRUZDELYTĖS;4677024422;Taip;15;0;0;15
15461;Žiogelis;SKRUZDELYTĖS;6165380986;Taip;0;0;3;3
15462;Žiogelis;SKRUZDELYTĖS;5281321968;Taip;3;0;0;3
15463;Žiogelis;SKRUZDELYTĖS;3214640817;Taip;17;0;0;17
15464;Žiogelis;SKRUZDELYTĖS;1937740173;Taip;14;0;0;14
15465;Žiogelis;SKRUZDELYTĖS;4115425880;Taip;0;3;0;3
15466;Žiogelis;SKRUZDELYTĖS;5737326104;Taip;1;2;2;5
15467;Žiogelis;SKRUZDELYTĖS;2614574694;Ne;0;2;0;2
15468;Žiogelis;SKRUZDELYTĖS;7107814348;Taip;10;6;0;16
15469;Žiogelis;SKRUZDELYTĖS;9243862028;Taip;0;4;0;4
15470;Žiogelis;SKRUZDELYTĖS;7395901559;Taip;4;0;2;6
15471;Žiogelis;SKRUZDELYTĖS;9819352425;Taip;7;2;0;9
15472;Žiogelis;SKRUZDELYTĖS;8780773039;Taip;9;5;0;14
15473;Žiogelis;SKRUZDELYTĖS;7881734492;Taip;10;0;1;11
15474;Žiogelis;SKRUZDELYTĖS;9330018409;Taip;0;0;1;1
15475;Žiogelis;SKRUZDELYTĖS;9120836406;Taip;5;0;1;6
15476;Žiogelis;SKRUZDELYTĖS;6742462116;Ne;0;2;0;2
15477;Žiogelis;SKRUZDELYTĖS;8763533677;Ne;14;0;0;14
15478;Žiogelis;SKRUZDELYTĖS;6608146625;Taip;3;0;1;4
15479;Žiogelis;SKRUZDELYTĖS;9035254979;Taip;13;0;0;13
15480;Žiogelis;ŽIRNIUKAI;2348525913;Taip;7;0;2;9
15481;Žiogelis;ŽIRNIUKAI;2771911603;Taip;13;1;0;14
15482;Žiogelis;ŽIRNIUKAI;6617995346;Taip;5;5;5;15
15483;Žiogelis;ŽIRNIUKAI;7936785905;Taip;5;0;0;5
15484;Žiogelis;ŽIRNIUKAI;9142952548;Taip;6;0;3;9
15485;Žiogelis;ŽIRNIUKAI;4450344120;Taip;0;0;5;5
15486;Žiogelis;ŽIRNIUKAI;8998694866;Taip;0;0;3;3
15487;Žiogelis;ŽIRNIUKAI;3472310047;Taip;0;0;3;3
15488;Žiogelis;ŽIRNIUKAI;8018943297;Taip;0;0;5;5
15489;Žiogelis;ŽIRNIUKAI;8038242532;Taip;8;0;0;8
15490;Žiogelis;ŽIRNIUKAI;9421670525;Taip;7;0;1;8
15491;Žiogelis;ŽIRNIUKAI;2463360858;Taip;8;0;1;9
15492;Žiogelis;ŽIRNIUKAI;1067136657;Taip;2;0;0;2
15493;Žiogelis;ŽIRNIUKAI;9672307977;Taip;0;0;1;1
15494;Žiogelis;ŽIRNIUKAI;5337641310;Taip;0;0;2;2
15495;Žiogelis;ŽIRNIUKAI;4755709634;Taip;0;0;3;3
15496;Žiogelis;ŽIRNIUKAI;2833768296;Taip;0;0;2;2
15497;Žiogelis;ŽIRNIUKAI;6857937795;Taip;10;2;0;12
15498;Žiogelis;ŽIRNIUKAI;9918493914;Taip;5;0;2;7
15499;Žiogelis;ŽIRNIUKAI;3516143432;Taip;10;0;2;12
15500;Žiogelis;ŽIRNIUKAI;5223426277;Taip;5;0;0;5
15501;Žiogelis;DOBILĖLIAI;8683148826;Taip;0;10;0;10
15502;Žiogelis;DOBILĖLIAI;3308563362;Taip;0;2;0;2
15503;Žiogelis;DOBILĖLIAI;2117192553;Taip;0;2;0;2
15504;Žiogelis;DOBILĖLIAI;1190395481;Taip;0;1;0;1
15505;Žiogelis;DOBILĖLIAI;1465027680;Taip;2;0;0;2
15506;Žiogelis;DOBILĖLIAI;5364996984;Taip;0;1;0;1
15507;Žiogelis;DOBILĖLIAI;9568208184;Taip;0;1;0;1
15508;Žiogelis;DOBILĖLIAI;6340620973;Ne;0;0;6;6
15509;Žiogelis;DOBILĖLIAI;5961630249;Taip;0;0;2;2
15510;Žiogelis;DOBILĖLIAI;5911231906;Taip;0;5;0;5
15511;Žiogelis;DOBILĖLIAI;9610249055;Taip;0;2;0;2
15512;Žiogelis;DOBILĖLIAI;6115834138;Taip;0;0;1;1
15513;Žiogelis;DOBILĖLIAI;3887222613;Taip;1;0;0;1
15514;Žiogelis;DOBILĖLIAI;8485067381;Taip;0;0;1;1
15515;Žiogelis;DOBILĖLIAI;7065052244;Taip;1;0;0;1
15516;Žiogelis;DOBILĖLIAI;4103035195;Taip;7;1;0;8
15517;Žiogelis;BORUŽĖLĖS;24941867247;Taip;0;1;0;1
15518;Žiogelis;BORUŽĖLĖS;8819549855;Ne;0;2;1;3
15519;Žiogelis;BORUŽĖLĖS;3189872952;Taip;0;2;1;3
15520;Žiogelis;BORUŽĖLĖS;2883732914;Taip;0;1;0;1
15521;Žiogelis;BORUŽĖLĖS;3503872654;Taip;0;3;3;6
15522;Žiogelis;BORUŽĖLĖS;4445888917;Taip;0;1;0;1
15523;Žiogelis;BORUŽĖLĖS;7881358741;Taip;6;0;0;6
15524;Žiogelis;BORUŽĖLĖS;64865699245;Taip;0;2;0;2
15525;Žiogelis;BORUŽĖLĖS;8702710674;Taip;0;4;0;4
15526;Žiogelis;BORUŽĖLĖS;4671356872;Taip;3;4;0;7
15527;Žiogelis;BORUŽĖLĖS;18018505301;Taip;15;1;0;16
15528;Žiogelis;BORUŽĖLĖS;3750023611;Taip;2;0;0;2
15529;Žiogelis;BORUŽĖLĖS;4343510173;Taip;6;4;0;10
15530;Žiogelis;BORUŽĖLĖS;6659086172;Taip;4;1;0;5
15531;Žiogelis;BORUŽĖLĖS;3203359908;Taip;0;2;1;3
15532;Žiogelis;BORUŽĖLĖS;3320077143;Taip;0;2;1;3
15533;Žiogelis;BORUŽĖLĖS;1160064257;Taip;0;1;0;1
15534;Žiogelis;BORUŽĖLĖS;1609336147;Taip;4;0;0;4
15535;Žiogelis;BORUŽĖLĖS;6346503991;Taip;0;1;3;4
15536;Žiogelis;BORUŽĖLĖS;3560637865;Taip;0;3;0;3
15537;Žiogelis;BORUŽĖLĖS;3420228264;Taip;0;1;0;1
15538;Žiogelis;BORUŽĖLĖS;1996517542;Taip;0;3;0;3
15539;Žiogelis;BORUŽĖLĖS;6760074113;Ne;3;1;1;5
15540;Žiogelis;DRUGELIAI;4080391074;Ne;0;0;9;9
15541;Žiogelis;DRUGELIAI;2797078863;Taip;12;0;0;12
15542;Žiogelis;DRUGELIAI;3813592739;Taip;5;0;0;5
15543;Žiogelis;DRUGELIAI;3820406417;Taip;0;1;12;13
15544;Žiogelis;DRUGELIAI;9533670829;Ne;0;1;2;3
15545;Žiogelis;DRUGELIAI;1673279182;Taip;5;12;0;17
15546;Žiogelis;DRUGELIAI;9964121573;Taip;10;0;3;13
15547;Žiogelis;DRUGELIAI;5104952346;Taip;0;2;0;2
15548;Žiogelis;DRUGELIAI;9431525960;Taip;11;5;0;16
15549;Žiogelis;DRUGELIAI;9717527407;Taip;6;0;0;6
15550;Žiogelis;DRUGELIAI;2622354022;Taip;6;1;0;7
15551;Žiogelis;DRUGELIAI;7462316396;Taip;11;3;0;14
15552;Žiogelis;DRUGELIAI;7395496310;Ne;14;0;0;14
15553;Žiogelis;DRUGELIAI;2243541285;Taip;0;2;9;11
15554;Žiogelis;DRUGELIAI;3810309354;Taip;0;1;6;7
15555;Žiogelis;DRUGELIAI;2326799191;Ne;1;1;0;2
15556;Žiogelis;DRUGELIAI;7974212517;Taip;11;1;0;12
15557;Žiogelis;DRUGELIAI;9423979719;Taip;11;1;0;12
15558;Žiogelis;DRUGELIAI;1833992163;Ne;5;0;0;5
15559;Žiogelis;PELĖDŽIUKAI;7128248940;Taip;0;5;0;5
15560;Žiogelis;PELĖDŽIUKAI;6709029770;Taip;0;1;0;1
15561;Žiogelis;PELĖDŽIUKAI;7502572217;Taip;0;1;6;7
15562;Žiogelis;PELĖDŽIUKAI;1134384178;Taip;0;1;0;1
15563;Žiogelis;PELĖDŽIUKAI;5876904663;Taip;5;1;0;6
15564;Žiogelis;PELĖDŽIUKAI;8217782981;Taip;5;3;0;8
15565;Žiogelis;PELĖDŽIUKAI;7120126547;Taip;0;1;0;1
15566;Žiogelis;PELĖDŽIUKAI;9387048672;Taip;0;8;0;8
15567;Žiogelis;PELĖDŽIUKAI;4378941619;Taip;5;0;0;5
15568;Žiogelis;PELĖDŽIUKAI;3937261260;Taip;0;2;0;2
15569;Žiogelis;PELĖDŽIUKAI;8873231715;Taip;0;4;0;4
15570;Žiogelis;PELĖDŽIUKAI;8894068297;Taip;0;1;0;1
15571;Žiogelis;PELĖDŽIUKAI;4609861306;Taip;0;1;0;1
15572;Žiogelis;PELĖDŽIUKAI;2759766559;Taip;5;6;0;11
15573;Žiogelis;PELĖDŽIUKAI;2160862681;Taip;9;1;0;10
15574;Žiogelis;PELĖDŽIUKAI;7725494899;Taip;5;5;0;10
15575;Žiogelis;PELĖDŽIUKAI;1939672072;Taip;0;0;1;1
15576;Žiogelis;PELĖDŽIUKAI;8689074067;Taip;0;1;0;1
15577;Žiogelis;PELĖDŽIUKAI;4565342104;Taip;0;1;0;1
15578;Žiogelis;PELĖDŽIUKAI;1223396469;Taip;11;3;0;14
15579;Žiogelis;PELĖDŽIUKAI;8715501524;Taip;15;0;0;15
15580;Žiogelis;VARPELIAI;7888873296;Taip;8;4;0;12
15581;Žiogelis;VARPELIAI;8262619320;Taip;0;3;0;3
15582;Žiogelis;VARPELIAI;3520393042;Ne;6;4;0;10
15583;Žiogelis;VARPELIAI;8983731310;Taip;5;6;0;11
15584;Žiogelis;VARPELIAI;1954544417;Ne;10;0;0;10
15585;Žiogelis;VARPELIAI;6716558946;Ne;7;0;0;7
15586;Žiogelis;VARPELIAI;1035890284;Ne;4;5;0;9
15587;Žiogelis;VARPELIAI;9385596579;Taip;9;0;0;9
15588;Žiogelis;VARPELIAI;1447349850;Taip;0;3;0;3
15589;Žiogelis;VARPELIAI;3752358694;Taip;7;0;0;7
15590;Žiogelis;VARPELIAI;6402784913;Ne;9;3;0;12
15591;Žiogelis;VARPELIAI;3502278745;Taip;0;1;0;1
15592;Žiogelis;VARPELIAI;4462189852;Taip;10;0;0;10
15593;Žiogelis;VARPELIAI;9470241656;Ne;21;0;0;21
15594;Žiogelis;VARPELIAI;8133583992;Ne;12;2;0;14
15595;Žiogelis;VARPELIAI;2346231162;Ne;6;3;0;9
15596;Žiogelis;VARPELIAI;5899326215;Ne;15;0;0;15
15597;Žiogelis;VARPELIAI;6658457517;Ne;7;1;0;8
15598;Žiogelis;VARPELIAI;6650891980;Ne;19;1;0;20
15599;Žiogelis;VARPELIAI;5076511003;Taip;13;0;0;13
15600;Žiogelis;VARPELIAI;1139259000;Taip;14;0;0;14
15601;Žiogelis;VARPELIAI;7992701275;Taip;16;0;0;16
15602;Žiogelis;VARPELIAI;3838714439;Ne;18;0;0;18
15603;Žiogelis;KREGŽDUTĖS;1309122110;Taip;9;1;0;10
15604;Žiogelis;KREGŽDUTĖS;7704256764;Taip;0;1;0;1
15605;Žiogelis;KREGŽDUTĖS;1235203700;Ne;0;1;0;1
15606;Žiogelis;KREGŽDUTĖS;6701809272;Taip;0;3;0;3
15607;Žiogelis;KREGŽDUTĖS;6697117406;Taip;0;3;1;4
15608;Žiogelis;KREGŽDUTĖS;2028383677;Taip;0;5;0;5
15609;Žiogelis;KREGŽDUTĖS;3910954904;Taip;5;1;0;6
15610;Žiogelis;KREGŽDUTĖS;2233244282;Taip;0;1;0;1
15611;Žiogelis;KREGŽDUTĖS;9862582346;Taip;3;2;1;6
15612;Žiogelis;KREGŽDUTĖS;9406830518;Taip;7;2;0;9
15613;Žiogelis;KREGŽDUTĖS;1320651707;Taip;0;2;0;2
15614;Žiogelis;KREGŽDUTĖS;85437321236;Taip;0;1;0;1
15615;Žiogelis;KREGŽDUTĖS;1320126836;Taip;0;2;0;2
15616;Žiogelis;KREGŽDUTĖS;3310492752;Taip;0;2;0;2
15617;Žiogelis;KREGŽDUTĖS;2366095661;Taip;0;5;0;5
15618;Žiogelis;KREGŽDUTĖS;8675451323;Taip;0;1;0;1
15619;Žiogelis;KREGŽDUTĖS;7087781379;Taip;5;1;0;6
15620;Žiogelis;KREGŽDUTĖS;4015109974;Taip;5;1;0;6
15621;Žiogelis;KREGŽDUTĖS;14932261911;Taip;0;3;3;6
15622;Žiogelis;KREGŽDUTĖS;4713696984;Taip;5;5;0;10
15623;Žiogelis;KREGŽDUTĖS;1442866468;Taip;0;1;3;4
15624;Žiogelis;KREGŽDUTĖS;1660784232;Ne;0;1;4;5
15625;Žiogelis;KREGŽDUTĖS;5579709130;Taip;0;5;0;5
15626;Žiogelis;KREGŽDUTĖS;9128728457;Ne;0;1;0;1
15627;Žiogelis;KREGŽDUTĖS;5340501392;Taip;0;8;0;8
15628;Žiogelis;KREGŽDUTĖS;8979747150;Taip;8;1;0;9
15629;Žiogelis;ŽVIRBLIUKAI;1106149118;Taip;5;1;0;6
15630;Žiogelis;ŽVIRBLIUKAI;6284764694;Taip;0;4;0;4
15631;Žiogelis;ŽVIRBLIUKAI;9842311161;Taip;15;0;0;15
15632;Žiogelis;ŽVIRBLIUKAI;5475797764;Taip;21;0;0;21
15633;Žiogelis;ŽVIRBLIUKAI;2036243422;Taip;7;1;0;8
15634;Žiogelis;ŽVIRBLIUKAI;9634291623;Taip;5;3;0;8
15635;Žiogelis;ŽVIRBLIUKAI;7802165127;Taip;6;2;0;8
15636;Žiogelis;ŽVIRBLIUKAI;6491130711;Taip;5;0;2;7
15637;Žiogelis;ŽVIRBLIUKAI;9378236361;Taip;15;0;0;15
15638;Žiogelis;ŽVIRBLIUKAI;5445409452;Taip;15;0;0;15
15639;Žiogelis;ŽVIRBLIUKAI;4155916507;Taip;0;7;0;7
15640;Žiogelis;ŽVIRBLIUKAI;4623532521;Taip;4;2;0;6
15641;Žiogelis;ŽVIRBLIUKAI;6988180082;Taip;16;0;0;16
15642;Žiogelis;ŽVIRBLIUKAI;4677227753;Taip;16;0;0;16
15643;Žiogelis;ŽVIRBLIUKAI;9737574835;Taip;0;1;0;1
15644;Žiogelis;ŽVIRBLIUKAI;2529171444;Taip;0;2;0;2
15645;Žiogelis;ŽVIRBLIUKAI;5996045442;Taip;5;6;0;11
15646;Žiogelis;BITUTĖS;4814936645;Taip;2;0;0;2
15647;Žiogelis;BITUTĖS;3752355139;Taip;13;0;4;17
15648;Žiogelis;BITUTĖS;4605250897;Taip;0;1;0;1
15649;Žiogelis;BITUTĖS;2173494736;Taip;3;2;0;5
15650;Žiogelis;BITUTĖS;5042341085;Taip;10;0;0;10
15651;Žiogelis;BITUTĖS;6347738933;Taip;16;1;0;17
15652;Žiogelis;BITUTĖS;9627583831;Taip;0;15;0;15
15653;Žiogelis;BITUTĖS;3296450902;Taip;0;1;0;1
15654;Žiogelis;BITUTĖS;3792114246;Taip;10;1;0;11
15655;Žiogelis;BITUTĖS;9981130790;Taip;0;9;0;9
15656;Žiogelis;BITUTĖS;3820534331;Taip;0;1;0;1
15657;Žiogelis;BITUTĖS;4630381709;Taip;0;1;0;1
15658;Žiogelis;BITUTĖS;9790463889;Ne;0;11;0;11
15659;Žiogelis;BITUTĖS;6024752960;Taip;0;3;0;3
15660;Žiogelis;BITUTĖS;8853905367;Taip;0;3;0;3
15661;Žiogelis;BITUTĖS;1397686161;Taip;0;13;0;13
15662;Žiogelis;BITUTĖS;2171351454;Taip;0;2;0;2
15663;Žiogelis;BITUTĖS;8835394030;Ne;0;2;0;2
15664;Žiogelis;BITUTĖS;4645245689;Taip;0;3;0;3
15665;Žiogelis;BITUTĖS;9874412804;Taip;0;3;0;3
15666;Žiogelis;BITUTĖS;5139645108;Taip;0;5;0;5
15667;Žiogelis;BITUTĖS;9766966628;Taip;13;1;0;14
15668;Žiogelis;RIEŠUTĖLIAI;8303283893;Taip;0;7;0;7
15669;Žiogelis;RIEŠUTĖLIAI;9863503924;Taip;0;0;5;5
15670;Žiogelis;RIEŠUTĖLIAI;6718866954;Taip;14;0;3;17
15671;Žiogelis;RIEŠUTĖLIAI;9144282935;Taip;0;0;3;3
15672;Žiogelis;RIEŠUTĖLIAI;5741157573;Taip;3;0;0;3
15673;Žiogelis;RIEŠUTĖLIAI;8485973974;Taip;5;1;0;6
15674;Žiogelis;RIEŠUTĖLIAI;6039409252;Taip;17;0;0;17
15675;Žiogelis;RIEŠUTĖLIAI;6048534817;Taip;0;1;12;13
15676;Žiogelis;RIEŠUTĖLIAI;5133034709;Taip;19;0;0;19
15677;Žiogelis;RIEŠUTĖLIAI;2724389716;Taip;0;0;11;11
15678;Žiogelis;RIEŠUTĖLIAI;7763941077;Ne;0;0;6;6
15679;Žiogelis;RIEŠUTĖLIAI;4946802677;Taip;11;0;0;11
15680;Žiogelis;RIEŠUTĖLIAI;7008807839;Taip;0;3;5;8
15681;Žiogelis;RIEŠUTĖLIAI;5984496369;Taip;0;4;0;4
15682;Žiogelis;PAKALNUTĖS;1618384759;Taip;0;1;0;1
15683;Žiogelis;PAKALNUTĖS;5054228916;Taip;0;0;2;2
15684;Žiogelis;PAKALNUTĖS;8712788346;Taip;2;0;0;2
15685;Žiogelis;PAKALNUTĖS;3428197871;Taip;7;0;0;7
15686;Žiogelis;PAKALNUTĖS;7535167450;Taip;11;0;0;11
15687;Žiogelis;PAKALNUTĖS;3361421852;Taip;0;1;0;1
15688;Žiogelis;PAKALNUTĖS;1268908081;Taip;0;2;0;2
15689;Žiogelis;PAKALNUTĖS;3856321373;Ne;13;1;0;14
15690;Žiogelis;PAKALNUTĖS;6378295945;Taip;9;1;0;10
15691;Žiogelis;PAKALNUTĖS;8959934210;Taip;6;2;0;8
15692;Žiogelis;PAKALNUTĖS;8591680136;Ne;0;2;0;2
15693;Žiogelis;PAKALNUTĖS;6980853713;Taip;9;0;0;9
15694;Žiogelis;PAKALNUTĖS;7340918175;Taip;6;2;1;9
15695;Žiogelis;PAKALNUTĖS;6866685213;Taip;6;0;0;6
15696;Žiogelis;PAKALNUTĖS;5487213418;Taip;0;1;0;1
15697;Žiogelis;PAKALNUTĖS;8058231095;Ne;9;1;1;11
15698;Žiogelis;PAKALNUTĖS;6593794147;Taip;3;0;0;3
15699;Žiogelis;PAKALNUTĖS;1650284820;Ne;6;0;0;6
15700;Žiogelis;PAKALNUTĖS;6515890056;Taip;0;2;0;2
15701;Žiogelis;PAKALNUTĖS;7310459638;Taip;0;2;2;4
15702;Žiogelis;PAKALNUTĖS;1763603533;Taip;0;5;0;5
15703;Žiogelis;PAKALNUTĖS;9813150014;Taip;1;2;0;3
15704;Žiogelis;PAKALNUTĖS;5454676924;Taip;7;1;0;8
15705;Žiogelis;PAKALNUTĖS;7702173581;Taip;3;1;0;4
15706;Žolynėlis;Spanguolėlė;8810441600;Taip;0;3;3;6
15707;Žolynėlis;Spanguolėlė;6440991320;Taip;4;2;1;7
15708;Žolynėlis;Spanguolėlė;3631138915;Taip;1;0;0;1
15709;Žolynėlis;Spanguolėlė;5218448120;Taip;10;2;1;13
15710;Žolynėlis;Spanguolėlė;4076450179;Taip;10;2;0;12
15711;Žolynėlis;Spanguolėlė;4494255525;Ne;0;2;1;3
15712;Žolynėlis;Spanguolėlė;2493633505;Taip;0;1;5;6
15713;Žolynėlis;Spanguolėlė;5438607463;Taip;16;1;0;17
15714;Žolynėlis;Spanguolėlė;5208585298;Taip;0;6;0;6
15715;Žolynėlis;Spanguolėlė;3498596516;Taip;1;0;0;1
15716;Žolynėlis;Spanguolėlė;9498369210;Taip;16;1;0;17
15717;Žolynėlis;Spanguolėlė;7260397656;Taip;7;0;3;10
15718;Žolynėlis;Spanguolėlė;2315947380;Taip;10;2;0;12
15719;Žolynėlis;Spanguolėlė;5074658392;Taip;10;2;0;12
15720;Žolynėlis;"RŪTELĖ (spec)";4000928238;Taip;7;1;0;8
15721;Žolynėlis;"RŪTELĖ (spec)";9507509872;Taip;3;4;0;7
15722;Žolynėlis;"RŪTELĖ (spec)";2256262371;Taip;3;5;0;8
15723;Žolynėlis;"RŪTELĖ (spec)";1412336878;Taip;0;2;6;8
15724;Žolynėlis;"RŪTELĖ (spec)";8588753136;Taip;13;1;0;14
15725;Žolynėlis;"SAULUTĖ (spec)";9675783636;Taip;15;1;0;16
15726;Žolynėlis;"SAULUTĖ (spec)";7962304738;Ne;0;2;0;2
15727;Žolynėlis;"SAULUTĖ (spec)";6678697536;Taip;15;1;0;16
15728;Žolynėlis;"SAULUTĖ (spec)";6559029399;Taip;0;2;0;2
15729;Žolynėlis;"SAULUTĖ (spec)";3043560150;Taip;0;1;0;1
15730;Žolynėlis;"SAULUTĖ (spec)";3934182673;Taip;0;2;2;4
15731;Žolynėlis;"LINELIS (spec)";2665355759;Taip;5;3;0;8
15732;Žolynėlis;"LINELIS (spec)";2346018814;Taip;0;1;4;5
15733;Žolynėlis;"LINELIS (spec)";1916465295;Taip;6;0;0;6
15734;Žolynėlis;"LINELIS (spec)";3337602618;Ne;0;2;11;13
15735;Žolynėlis;"LINELIS (spec)";8930536051;Taip;0;1;0;1
15736;Žolynėlis;"LINELIS (spec)";2740906284;Taip;0;1;1;2
15737;Žolynėlis;"RASAKILA (spec)";6510930436;Taip;14;0;0;14
15738;Žolynėlis;"RASAKILA (spec)";6619551947;Taip;18;1;0;19
15739;Žolynėlis;"RASAKILA (spec)";8839037219;Ne;11;0;0;11
15740;Žolynėlis;"RASAKILA (spec)";4481343085;Ne;8;0;0;8
15741;Žolynėlis;"RAMUNĖLĖS (spec)";8552635547;Taip;10;1;2;13
15742;Žolynėlis;"RAMUNĖLĖS (spec)";4559404699;Taip;5;0;4;9
15743;Žolynėlis;"RAMUNĖLĖS (spec)";1703785525;Taip;5;2;2;9
15744;Žolynėlis;"RAMUNĖLĖS (spec)";2072569949;Taip;9;0;0;9
15745;Žolynėlis;"RAMUNĖLĖS (spec)";1090944316;Taip;6;0;4;10
15746;Žolynėlis;Dobiliukai;2005661306;Taip;0;3;0;3
15747;Žolynėlis;Dobiliukai;2820649587;Taip;4;0;3;7
15748;Žolynėlis;Dobiliukai;7581436340;Taip;16;0;1;17
15749;Žolynėlis;Dobiliukai;6204102296;Taip;6;0;2;8
15750;Žolynėlis;Dobiliukai;3385748516;Taip;16;2;0;18
15751;Žolynėlis;Dobiliukai;4151633786;Taip;3;0;3;6
15752;Žolynėlis;Dobiliukai;2957426163;Taip;10;0;1;11
15753;Žolynėlis;Dobiliukai;5456771327;Taip;21;0;0;21
15754;Žolynėlis;Dobiliukai;8341730420;Taip;7;0;1;8
15755;Žolynėlis;Dobiliukai;3350246193;Taip;0;0;2;2
15756;Žolynėlis;Dobiliukai;5269388947;Taip;10;1;0;11
15757;Žolynėlis;Dobiliukai;1206144208;Taip;5;1;1;7
15758;Žolynėlis;Dobiliukai;1213384150;Taip;0;2;1;3
15759;Žolynėlis;Dobiliukai;7485033527;Taip;10;1;0;11
15760;Žolynėlis;Aguonėlė;3071570864;Taip;10;3;6;19
15761;Žolynėlis;Aguonėlė;1440666914;Taip;15;3;0;18
15762;Žolynėlis;Aguonėlė;1365534272;Taip;11;1;0;12
15763;Žolynėlis;Aguonėlė;2628636018;Taip;0;5;0;5
15764;Žolynėlis;Aguonėlė;6740105842;Taip;8;2;0;10
15765;Žolynėlis;Aguonėlė;3952731134;Taip;1;0;0;1
15766;Žolynėlis;Aguonėlė;6554864184;Ne;10;0;0;10
15767;Žolynėlis;Aguonėlė;9285539649;Ne;5;0;0;5
15768;Žolynėlis;Aguonėlė;5243624422;Taip;16;1;0;17
15769;Žolynėlis;Aguonėlė;4761054847;Taip;10;2;0;12
15770;Žolynėlis;Aguonėlė;6354832415;Taip;0;3;0;3
15771;Žolynėlis;Aguonėlė;9120786116;Taip;0;2;0;2
15772;Žolynėlis;Aguonėlė;1748987196;Ne;0;14;0;14
15773;Žolynėlis;Aguonėlė;4427274462;Taip;4;1;0;5
15774;Žolynėlis;Aguonėlė;3819863015;Taip;0;0;3;3
15775;Žolynėlis;Pienė;3520272555;Taip;0;8;0;8
15776;Žolynėlis;Pienė;2934361190;Taip;0;4;0;4
15777;Žolynėlis;Pienė;6763515483;Taip;3;2;0;5
15778;Žolynėlis;Pienė;1163753820;Taip;0;1;0;1
15779;Žolynėlis;Pienė;9106152447;Taip;0;8;0;8
15780;Žolynėlis;Pienė;1879046798;Taip;0;9;0;9
15781;Žolynėlis;Pienė;9238832484;Taip;6;2;2;10
15782;Žolynėlis;Pienė;3877168024;Taip;14;2;0;16
15783;Žolynėlis;Pienė;6416217971;Taip;5;4;0;9
15784;Žolynėlis;Pienė;4618251201;Ne;0;4;0;4
15785;Žolynėlis;Pienė;5432464074;Taip;9;5;0;14
15786;Žolynėlis;Pienė;8510764089;Ne;0;1;0;1
15787;Žolynėlis;Pienė;1264022895;Ne;4;2;0;6
15788;Žolynėlis;Pienė;8697184617;Taip;0;1;0;1
15789;Žolynėlis;Pienė;8713225753;Taip;5;1;0;6
15790;Žolynėlis;Pienė;5332349177;Taip;7;5;0;12
15791;Žolynėlis;Pienė;5787331165;Taip;0;8;0;8
15792;Žolynėlis;Pienė;5474876914;Ne;4;0;1;5
15793;Žolynėlis;Pienė;3091749692;Ne;0;1;0;1
15794;Žolynėlis;Pienė;2263679711;Ne;1;2;0;3
15795;Žolynėlis;Pienė;5149512625;Ne;0;2;0;2
15796;Žolynėlis;Pienė;5973298389;Taip;0;3;7;10
15797;Žolynėlis;Čiobreliai;5564338170;Taip;1;2;0;3
15798;Žolynėlis;Čiobreliai;6543503409;Taip;4;8;0;12
15799;Žolynėlis;Čiobreliai;8215427354;Taip;17;2;0;19
15800;Žolynėlis;Čiobreliai;8700231970;Taip;1;0;0;1
15801;Žolynėlis;Čiobreliai;7339496409;Taip;3;1;0;4
15802;Žolynėlis;Čiobreliai;2565770471;Taip;19;0;0;19
15803;Žolynėlis;Čiobreliai;6829144389;Taip;13;4;0;17
15804;Žolynėlis;Čiobreliai;4545601535;Taip;0;3;0;3
15805;Žolynėlis;Čiobreliai;7256502393;Taip;0;2;0;2
15806;Žolynėlis;Čiobreliai;1901979061;Ne;0;3;0;3
15807;Žolynėlis;Čiobreliai;8027151284;Taip;10;1;0;11
15808;Žolynėlis;Čiobreliai;5717038791;Taip;0;3;0;3
15809;Žolynėlis;Čiobreliai;1933377698;Ne;0;9;0;9
15810;Žolynėlis;Čiobreliai;2108221942;Taip;17;1;0;18
15811;Žolynėlis;Čiobreliai;2881461471;Taip;0;2;0;2
15812;Žolynėlis;Čiobreliai;7339110559;Taip;8;1;0;9
15813;Žolynėlis;Čiobreliai;2460982987;Ne;0;2;0;2
15814;Žolynėlis;Čiobreliai;7980206574;Taip;2;1;0;3
15815;Žolynėlis;Čiobreliai;3088932720;Taip;0;3;0;3
15816;Žolynėlis;Čiobreliai;4758738231;Taip;0;9;0;9
15817;Žolynėlis;Čiobreliai;6024288147;Taip;17;1;0;18
15818;Žolynėlis;Čiobreliai;1485195267;Taip;0;5;0;5
15819;Žolynėlis;Avietėlė;5873931225;Ne;4;0;0;4
15820;Žolynėlis;Avietėlė;6124252688;Taip;14;0;0;14
15821;Žolynėlis;Avietėlė;3293250169;Taip;6;8;0;14
15822;Žolynėlis;Avietėlė;1266614631;Taip;12;0;0;12
15823;Žolynėlis;Avietėlė;2727273826;Taip;18;1;0;19
15824;Žolynėlis;Avietėlė;2718255075;Taip;5;6;0;11
15825;Žolynėlis;Avietėlė;7201413203;Taip;11;0;0;11
15826;Žolynėlis;Avietėlė;7517815798;Taip;17;0;0;17
15827;Žolynėlis;Avietėlė;4094173207;Taip;9;0;0;9
15828;Žolynėlis;Avietėlė;4229530366;Taip;11;3;0;14
15829;Žolynėlis;Avietėlė;5771745015;Taip;6;0;0;6
15830;Žuvėdra;"JŪROS ŽVAIGŽDUTĖS";7272717439;Taip;0;0;1;1
15831;Žuvėdra;"JŪROS ŽVAIGŽDUTĖS";9230342970;Taip;0;2;0;2
15832;Žuvėdra;"JŪROS ŽVAIGŽDUTĖS";1938808693;Taip;5;1;0;6
15833;Žuvėdra;"JŪROS ŽVAIGŽDUTĖS";2660909247;Taip;3;0;0;3
15834;Žuvėdra;"JŪROS ŽVAIGŽDUTĖS";2092890028;Taip;0;1;0;1
15835;Žuvėdra;"JŪROS ŽVAIGŽDUTĖS";2334342995;Taip;2;0;1;3
15836;Žuvėdra;"JŪROS ŽVAIGŽDUTĖS";5049101816;Taip;0;11;0;11
15837;Žuvėdra;"JŪROS ŽVAIGŽDUTĖS";4011849839;Taip;0;1;0;1
15838;Žuvėdra;"JŪROS ŽVAIGŽDUTĖS";1164464390;Taip;0;6;0;6
15839;Žuvėdra;"JŪROS ŽVAIGŽDUTĖS";1200084485;Taip;0;6;0;6
15840;Žuvėdra;"JŪROS ŽVAIGŽDUTĖS";4177319374;Taip;8;1;0;9
15841;Žuvėdra;"JŪROS ŽVAIGŽDUTĖS";7121154799;Taip;0;11;0;11
15842;Žuvėdra;"JŪROS ŽVAIGŽDUTĖS";8162649794;Taip;0;3;0;3
15843;Žuvėdra;"JŪROS ŽVAIGŽDUTĖS";7710853637;Taip;5;0;0;5
15844;Žuvėdra;"JŪROS ŽVAIGŽDUTĖS";2858729034;Ne;5;6;0;11
15845;Žuvėdra;"JŪROS ŽVAIGŽDUTĖS";6672289932;Taip;5;0;0;5
15846;Žuvėdra;"JŪROS ŽVAIGŽDUTĖS";9733979816;Ne;6;0;1;7
15847;Žuvėdra;"JŪROS ŽVAIGŽDUTĖS";5571732399;Taip;0;0;3;3
15848;Žuvėdra;"JŪROS ŽVAIGŽDUTĖS";3620753237;Taip;0;8;0;8
15849;Žuvėdra;DELFINUKAI;6952843736;Taip;5;1;0;6
15850;Žuvėdra;DELFINUKAI;2582404760;Taip;0;5;0;5
15851;Žuvėdra;DELFINUKAI;5818639448;Taip;0;0;1;1
15852;Žuvėdra;DELFINUKAI;7235005234;Taip;0;0;4;4
15853;Žuvėdra;DELFINUKAI;5876618912;Taip;11;3;0;14
15854;Žuvėdra;DELFINUKAI;4702627979;Taip;8;0;0;8
15855;Žuvėdra;DELFINUKAI;6327915228;Taip;7;0;0;7
15856;Žuvėdra;DELFINUKAI;7803397430;Taip;0;3;0;3
15857;Žuvėdra;DELFINUKAI;7705946236;Taip;17;0;0;17
15858;Žuvėdra;DELFINUKAI;1974766090;Taip;11;1;0;12
15859;Žuvėdra;DELFINUKAI;8869169590;Ne;4;1;0;5
15860;Žuvėdra;DELFINUKAI;3069506904;Taip;0;12;0;12
15861;Žuvėdra;DELFINUKAI;5913580058;Ne;4;0;0;4
15862;Žuvėdra;DELFINUKAI;9651268462;Taip;7;4;0;11
15863;Žuvėdra;DELFINUKAI;6309047651;Ne;0;0;6;6
15864;Žuvėdra;DELFINUKAI;2082128566;Taip;0;6;0;6
15865;Žuvėdra;OSMINOŽKI;1340241206;Taip;0;1;0;1
15866;Žuvėdra;OSMINOŽKI;5021263583;Taip;0;1;0;1
15867;Žuvėdra;OSMINOŽKI;63053155507;Taip;0;4;0;4
15868;Žuvėdra;OSMINOŽKI;1941428466;Taip;0;1;0;1
15869;Žuvėdra;OSMINOŽKI;6007871092;Taip;0;1;0;1
15870;Žuvėdra;OSMINOŽKI;2731016281;Taip;0;12;0;12
15871;Žuvėdra;OSMINOŽKI;6612880861;Taip;0;1;0;1
15872;Žuvėdra;OSMINOŽKI;75901332720;Taip;0;1;0;1
15873;Žuvėdra;OSMINOŽKI;14760907606;Taip;1;0;10;11
15874;Žuvėdra;OSMINOŽKI;5684848140;Taip;0;10;0;10
15875;Žuvėdra;OSMINOŽKI;5489757084;Taip;0;5;0;5
15876;Žuvėdra;OSMINOŽKI;8408371550;Taip;10;1;0;11
15877;Žuvėdra;OSMINOŽKI;5496071972;Taip;0;5;0;5
15878;Žuvėdra;OSMINOŽKI;5273726957;Taip;4;1;0;5
15879;Žuvėdra;OSMINOŽKI;6537464526;Taip;5;8;0;13
15880;Žuvėdra;OSMINOŽKI;7630057671;Taip;0;1;0;1
15881;Žuvėdra;OSMINOŽKI;7368183516;Taip;4;2;0;6
15882;Žuvėdra;OSMINOŽKI;3853045274;Taip;0;8;0;8
15883;Žuvėdra;OSMINOŽKI;3185158741;Taip;0;2;0;2
15884;Žuvėdra;OSMINOŽKI;8822952385;Ne;7;1;0;8
15885;Žuvėdra;OSMINOŽKI;5198825127;Taip;6;0;3;9
15886;Žuvėdra;OSMINOŽKI;5561903903;Taip;0;7;0;7
15887;Žuvėdra;RUSALAČKA;2849503557;Taip;8;0;0;8
15888;Žuvėdra;RUSALAČKA;8700802853;Taip;3;4;0;7
15889;Žuvėdra;RUSALAČKA;1509519996;Ne;16;0;0;16
15890;Žuvėdra;RUSALAČKA;7467154866;Ne;3;1;0;4
15891;Žuvėdra;RUSALAČKA;5151984122;Taip;0;3;0;3
15892;Žuvėdra;RUSALAČKA;4715123063;Taip;0;7;0;7
15893;Žuvėdra;RUSALAČKA;6715416675;Taip;1;0;1;2
15894;Žuvėdra;RUSALAČKA;8308610070;Taip;10;1;0;11
15895;Žuvėdra;RUSALAČKA;3349158713;Taip;10;3;0;13
15896;Žuvėdra;RUSALAČKA;8942228415;Ne;0;1;0;1
15897;Žuvėdra;RUSALAČKA;8670342549;Taip;0;2;3;5
15898;Žuvėdra;RUSALAČKA;1707519901;Taip;2;0;1;3
15899;Žuvėdra;RUSALAČKA;1810114962;Ne;11;0;0;11
15900;Žuvėdra;RUSALAČKA;1960306957;Taip;7;10;0;17
15901;Žuvėdra;RUSALAČKA;2640238143;Taip;10;3;0;13
15902;Žuvėdra;RUSALAČKA;2577280901;Taip;8;1;0;9
15903;Žuvėdra;RUSALAČKA;5481785360;Taip;4;0;0;4
15904;Žuvėdra;RUSALAČKA;6862766787;Ne;8;2;0;10
15905;Žuvėdra;RUSALAČKA;9011276878;Taip;7;1;0;8
15906;Žuvėdra;RUSALAČKA;7387863175;Taip;0;2;2;4
15907;Žuvėdra;JANTARIKI;8111760611;Taip;11;0;0;11
15908;Žuvėdra;JANTARIKI;4893062971;Taip;5;0;0;5
15909;Žuvėdra;JANTARIKI;1219808187;Ne;0;1;0;1
15910;Žuvėdra;JANTARIKI;2197976174;Taip;7;2;0;9
15911;Žuvėdra;JANTARIKI;4881712317;Taip;17;0;0;17
15912;Žuvėdra;JANTARIKI;7464494386;Taip;6;0;0;6
15913;Žuvėdra;JANTARIKI;1993897043;Taip;0;1;0;1
15914;Žuvėdra;JANTARIKI;3058300342;Taip;0;2;1;3
15915;Žuvėdra;JANTARIKI;7227722516;Ne;7;3;0;10
15916;Žuvėdra;JANTARIKI;9256424331;Taip;11;3;0;14
15917;Žuvėdra;JANTARIKI;7908898376;Taip;5;0;0;5
15918;Žuvėdra;JANTARIKI;2789379055;Taip;0;1;0;1
15919;Žuvėdra;JANTARIKI;9838754800;Taip;6;1;0;7
15920;Žuvėdra;JANTARIKI;1039661177;Taip;4;1;0;5
15921;Žuvėdra;JANTARIKI;1604010000;Taip;0;10;0;10
15922;Žuvėdra;"AUKSINĖ ŽUVELĖ";2844920302;Taip;0;12;0;12
15923;Žuvėdra;"AUKSINĖ ŽUVELĖ";9460887312;Taip;6;0;0;6
15924;Žuvėdra;"AUKSINĖ ŽUVELĖ";2111418502;Taip;4;4;0;8
15925;Žuvėdra;"AUKSINĖ ŽUVELĖ";2806386840;Taip;1;0;0;1
15926;Žuvėdra;"AUKSINĖ ŽUVELĖ";2323431685;Taip;10;1;0;11
15927;Žuvėdra;"AUKSINĖ ŽUVELĖ";4888533074;Ne;5;1;2;8
15928;Žuvėdra;"AUKSINĖ ŽUVELĖ";2155412338;Taip;0;21;0;21
15929;Žuvėdra;"AUKSINĖ ŽUVELĖ";5009153711;Taip;7;1;8;16
15930;Žuvėdra;"AUKSINĖ ŽUVELĖ";7258677907;Ne;2;1;0;3
15931;Žuvėdra;"AUKSINĖ ŽUVELĖ";4739865462;Taip;0;0;3;3
15932;Žuvėdra;"AUKSINĖ ŽUVELĖ";7135848009;Taip;11;0;0;11
15933;Žuvėdra;"AUKSINĖ ŽUVELĖ";3781157324;Ne;16;0;0;16
15934;Žvangutis;PELIUKŲ;7616874368;Taip;13;1;0;14
15935;Žvangutis;PELIUKŲ;3906808900;Taip;6;1;0;7
15936;Žvangutis;PELIUKŲ;7722153982;Taip;0;5;0;5
15937;Žvangutis;PELIUKŲ;4295016449;Taip;21;0;0;21
15938;Žvangutis;PELIUKŲ;9958554027;Taip;0;11;0;11
15939;Žvangutis;PELIUKŲ;8592522675;Taip;5;1;0;6
15940;Žvangutis;PELIUKŲ;3957064486;Taip;15;0;0;15
15941;Žvangutis;PELIUKŲ;5112520119;Taip;0;2;0;2
15942;Žvangutis;PELIUKŲ;5817402847;Taip;13;8;0;21
15943;Žvangutis;PELIUKŲ;4407484687;Taip;0;19;0;19
15944;Žvangutis;PELIUKŲ;5638068914;Taip;0;19;0;19
15945;Žvangutis;PELIUKŲ;4337928288;Taip;6;2;0;8
15946;Žvangutis;PELIUKŲ;6788355315;Taip;4;0;1;5
15947;Žvangutis;PELIUKŲ;8062689240;Taip;0;1;0;1
15948;Žvangutis;PELIUKŲ;3875906173;Taip;0;3;0;3
15949;Žvangutis;PELIUKŲ;1328464199;Taip;0;7;0;7
15950;Žvangutis;PELIUKŲ;3546672690;Taip;4;1;0;5
15951;Žvangutis;PELIUKŲ;4992231141;Ne;0;2;1;3
15952;Žvangutis;PELIUKŲ;3408933802;Taip;11;0;0;11
15953;Žvangutis;PELIUKŲ;8481666202;Taip;3;0;2;5
15954;Žvangutis;PELIUKŲ;4705131089;Taip;0;2;0;2
15955;Žvangutis;ANČIUKŲ;1420510354;Taip;0;8;0;8
15956;Žvangutis;ANČIUKŲ;9134683276;Taip;0;2;0;2
15957;Žvangutis;ANČIUKŲ;9145365865;Taip;20;1;0;21
15958;Žvangutis;ANČIUKŲ;6701947168;Taip;0;1;0;1
15959;Žvangutis;ANČIUKŲ;3315858185;Taip;11;1;0;12
15960;Žvangutis;ANČIUKŲ;7320625500;Taip;0;10;0;10
15961;Žvangutis;ANČIUKŲ;6110958520;Taip;0;2;0;2
15962;Žvangutis;ANČIUKŲ;6989839997;Taip;1;1;0;2
15963;Žvangutis;ANČIUKŲ;7202747419;Taip;4;2;2;8
15964;Žvangutis;ANČIUKŲ;3817258555;Taip;3;0;0;3
15965;Žvangutis;ANČIUKŲ;3775960571;Taip;15;1;0;16
15966;Žvangutis;ANČIUKŲ;7267340112;Ne;0;1;0;1
15967;Žvangutis;ANČIUKŲ;50889154641;Taip;0;1;0;1
15968;Žvangutis;ANČIUKŲ;1310113034;Taip;0;2;0;2
15969;Žvangutis;ANČIUKŲ;3513746926;Taip;5;1;1;7
15970;Žvangutis;ANČIUKŲ;4053450010;Taip;0;1;0;1
15971;Žvangutis;ANČIUKŲ;8511103595;Taip;0;2;0;2
15972;Žvangutis;ANČIUKŲ;6815104137;Taip;0;1;0;1
15973;Žvangutis;ANČIUKŲ;6844824726;Taip;0;3;5;8
15974;Žvangutis;ANČIUKŲ;9408369641;Taip;0;3;0;3
15975;Žvangutis;ANČIUKŲ;2600596320;Ne;0;2;0;2
15976;Žvangutis;ANČIUKŲ;1339151674;Taip;0;3;1;4
15977;Žvangutis;PELĖDŽIUKŲ;1322688456;Ne;0;2;0;2
15978;Žvangutis;PELĖDŽIUKŲ;9036869235;Taip;0;2;0;2
15979;Žvangutis;PELĖDŽIUKŲ;2570379643;Taip;4;1;0;5
15980;Žvangutis;PELĖDŽIUKŲ;2623107843;Taip;0;1;0;1
15981;Žvangutis;PELĖDŽIUKŲ;1185135525;Taip;0;3;0;3
15982;Žvangutis;PELĖDŽIUKŲ;2411307963;Taip;0;1;0;1
15983;Žvangutis;PELĖDŽIUKŲ;9468660351;Taip;0;1;0;1
15984;Žvangutis;PELĖDŽIUKŲ;1324948757;Ne;0;1;0;1
15985;Žvangutis;PELĖDŽIUKŲ;2922083476;Ne;0;11;0;11
15986;Žvangutis;PELĖDŽIUKŲ;1282567366;Ne;0;1;0;1
15987;Žvangutis;PELĖDŽIUKŲ;6068428687;Taip;9;1;0;10
15988;Žvangutis;PELĖDŽIUKŲ;9149037184;Taip;0;10;0;10
15989;Žvangutis;PELĖDŽIUKŲ;3665275100;Taip;0;1;0;1
15990;Žvangutis;PELĖDŽIUKŲ;5012996199;Taip;0;8;0;8
15991;Žvangutis;PELĖDŽIUKŲ;8295525284;Ne;2;4;0;6
15992;Žvangutis;PELĖDŽIUKŲ;3276065009;Ne;15;1;0;16
15993;Žvangutis;PELĖDŽIUKŲ;6040986672;Taip;0;6;0;6
15994;Žvangutis;PELĖDŽIUKŲ;2716216474;Taip;5;0;0;5
15995;Žvangutis;PELĖDŽIUKŲ;5723728310;Taip;0;1;0;1
15996;Žvangutis;PELĖDŽIUKŲ;1404378308;Taip;4;1;0;5
15997;Žvangutis;PELĖDŽIUKŲ;6207989105;Taip;5;1;0;6
15998;Žvangutis;PELĖDŽIUKŲ;5539992579;Taip;0;4;0;4
15999;Žvangutis;KAČIUKŲ;7213349517;Taip;2;1;0;3
16000;Žvangutis;KAČIUKŲ;7581320158;Ne;0;2;2;4
16001;Žvangutis;KAČIUKŲ;2296360416;Taip;21;0;0;21
16002;Žvangutis;KAČIUKŲ;2598842770;Taip;12;0;0;12
16003;Žvangutis;KAČIUKŲ;1142315595;Taip;10;2;3;15
16004;Žvangutis;KAČIUKŲ;9239279639;Taip;0;2;0;2
16005;Žvangutis;KAČIUKŲ;4696437804;Taip;6;2;0;8
16006;Žvangutis;KAČIUKŲ;8492637734;Taip;0;10;0;10
16007;Žvangutis;KAČIUKŲ;9235884407;Taip;0;16;0;16
16008;Žvangutis;KAČIUKŲ;8360356476;Taip;0;1;0;1
16009;Žvangutis;KAČIUKŲ;8863909185;Taip;5;12;0;17
16010;Žvangutis;KAČIUKŲ;4408086513;Taip;11;1;0;12
16011;Žvangutis;KAČIUKŲ;1256264382;Taip;0;12;0;12
16012;Žvangutis;KAČIUKŲ;8030520477;Taip;0;2;0;2
16013;Žvangutis;KAČIUKŲ;5166614226;Taip;0;0;2;2
16014;Žvangutis;KAČIUKŲ;8810739982;Taip;0;1;0;1
16015;Žvangutis;KAČIUKŲ;2740875969;Taip;3;0;2;5
16016;Žvangutis;KAČIUKŲ;8269992031;Taip;0;0;4;4
16017;Žvangutis;KAČIUKŲ;1224292338;Taip;8;0;1;9
16018;Žvangutis;MEŠKUČIŲ;8753815074;Taip;3;0;0;3
16019;Žvangutis;MEŠKUČIŲ;3781959962;Taip;2;0;0;2
16020;Žvangutis;MEŠKUČIŲ;8506809320;Taip;6;1;0;7
16021;Žvangutis;MEŠKUČIŲ;8376022173;Ne;2;0;1;3
16022;Žvangutis;MEŠKUČIŲ;6825952779;Taip;6;0;2;8
16023;Žvangutis;MEŠKUČIŲ;4920234186;Taip;6;0;0;6
16024;Žvangutis;MEŠKUČIŲ;1590704985;Taip;8;0;0;8
16025;Žvangutis;MEŠKUČIŲ;5328547183;Taip;21;0;0;21
16026;Žvangutis;MEŠKUČIŲ;5126809299;Taip;8;0;1;9
16027;Žvangutis;MEŠKUČIŲ;9883337991;Ne;11;0;0;11
16028;Žvangutis;MEŠKUČIŲ;8598396569;Taip;0;0;1;1
16029;Žvangutis;KIŠKUČIŲ;8906823569;Taip;11;0;1;12
16030;Žvangutis;KIŠKUČIŲ;6094686500;Taip;4;0;3;7
16031;Žvangutis;KIŠKUČIŲ;2049990751;Taip;0;0;3;3
16032;Žvangutis;KIŠKUČIŲ;9711017196;Taip;0;0;7;7
16033;Žvangutis;KIŠKUČIŲ;7051007224;Taip;7;0;1;8
16034;Žvangutis;KIŠKUČIŲ;3940893168;Taip;0;0;4;4
16035;Žvangutis;KIŠKUČIŲ;1592158260;Taip;12;0;0;12
16036;Žvangutis;KIŠKUČIŲ;5022657156;Taip;0;0;4;4
16037;Žvangutis;KIŠKUČIŲ;7645908955;Taip;14;0;0;14
16038;Žvangutis;KIŠKUČIŲ;6741623841;Taip;0;0;6;6
16039;Žvangutis;KIŠKUČIŲ;3029382724;Taip;11;0;0;11
16040;Žvangutis;KIŠKUČIŲ;6047042736;Taip;6;0;2;8
16041;Žvangutis;KIŠKUČIŲ;4514606021;Taip;0;12;0;12
16042;Žvangutis;KIŠKUČIŲ;7844987649;Taip;10;0;1;11
16043;Žirniukas;Boružiukų;5311746004;Taip;6;0;1;7
16044;Žirniukas;Boružiukų;6466220057;Taip;0;1;0;1
16045;Žirniukas;Boružiukų;2476906136;Taip;6;0;0;6
16046;Žirniukas;Boružiukų;2785102131;Taip;0;1;0;1
16047;Žirniukas;Boružiukų;6624263476;Taip;0;1;0;1
16048;Žirniukas;Boružiukų;8213507698;Taip;0;1;0;1
16049;Žirniukas;Boružiukų;2528905738;Taip;0;2;1;3
16050;Žirniukas;Boružiukų;6268788036;Taip;0;2;0;2
16051;Žirniukas;Boružiukų;6363169823;Taip;1;2;0;3
16052;Žirniukas;Boružiukų;2636634198;Taip;0;1;0;1
16053;Žirniukas;Boružiukų;8148254025;Taip;0;1;0;1
16054;Žirniukas;Boružiukų;6531175340;Taip;0;3;1;4
16055;Žirniukas;Boružiukų;9647374339;Taip;0;1;0;1
16056;Žirniukas;Boružiukų;6641200341;Taip;0;2;0;2
16057;Žirniukas;Boružiukų;3022672028;Taip;5;4;0;9
16058;Žirniukas;Boružiukų;3909152902;Taip;0;1;0;1
16059;Žirniukas;Boružiukų;8180092480;Ne;7;0;0;7
16060;Žirniukas;Boružiukų;9896989995;Taip;0;2;1;3
16061;Žirniukas;Boružiukų;5420360864;Taip;0;2;0;2
16062;Žirniukas;Boružiukų;1873446232;Taip;0;0;2;2
16063;Žirniukas;Boružiukų;8294569569;Taip;0;4;6;10
16064;Žirniukas;Boružiukų;7397202752;Taip;0;3;5;8
16065;Žirniukas;Boružiukų;7190628011;Taip;1;0;4;5
16066;Žirniukas;Smalsučiai;2132625724;Taip;0;1;0;1
16067;Žirniukas;Smalsučiai;2557138057;Taip;0;2;0;2
16068;Žirniukas;Smalsučiai;8644938346;Taip;0;1;0;1
16069;Žirniukas;Smalsučiai;5761169841;Taip;0;0;1;1
16070;Žirniukas;Smalsučiai;5104110821;Taip;0;2;1;3
16071;Žirniukas;Smalsučiai;5471647472;Taip;5;3;0;8
16072;Žirniukas;Smalsučiai;2151329751;Ne;0;2;0;2
16073;Žirniukas;Smalsučiai;5939918015;Taip;0;6;4;10
16074;Žirniukas;Smalsučiai;2049123663;Taip;0;0;2;2
16075;Žirniukas;Smalsučiai;3010062747;Taip;0;1;0;1
16076;Žirniukas;Smalsučiai;2162238771;Taip;0;3;0;3
16077;Žirniukas;Smalsučiai;1064894307;Taip;1;2;0;3
16078;Žirniukas;Smalsučiai;4378877068;Taip;0;1;0;1
16079;Žirniukas;Smalsučiai;2029018108;Taip;0;3;1;4
16080;Žirniukas;Smalsučiai;2309995947;Taip;0;3;1;4
16081;Žirniukas;Smalsučiai;1162904969;Taip;5;1;5;11
16082;Žirniukas;Smalsučiai;7644911127;Taip;0;1;0;1
16083;Žirniukas;Smalsučiai;1514504241;Taip;0;3;0;3
16084;Žirniukas;Smalsučiai;6180439078;Ne;5;1;0;6
16085;Žirniukas;Smalsučiai;5987510202;Taip;0;1;0;1
16086;Žirniukas;Smalsučiai;1944169398;Taip;0;3;0;3
16087;Žirniukas;Smalsučiai;7975957714;Taip;0;0;1;1
16088;Žirniukas;Smalsučiai;3808838764;Taip;0;3;0;3
16089;Žirniukas;Smalsučiai;9896415564;Ne;3;0;0;3
16090;Žirniukas;Smalsučiai;9374080010;Taip;1;0;0;1
16091;Žirniukas;Smalsučiai;1678041002;Ne;0;1;4;5
16092;Žirniukas;Gėlyčių;2982628594;Taip;6;0;0;6
16093;Žirniukas;Gėlyčių;6121388208;Taip;3;0;2;5
16094;Žirniukas;Gėlyčių;6201949014;Taip;8;0;0;8
16095;Žirniukas;Gėlyčių;5103440019;Taip;6;0;0;6
16096;Žirniukas;Gėlyčių;7872611724;Taip;0;1;2;3
16097;Žirniukas;Gėlyčių;9497414375;Taip;2;0;2;4
16098;Žirniukas;Gėlyčių;5422282267;Taip;0;6;1;7
16099;Žirniukas;Gėlyčių;3189741449;Taip;5;0;3;8
16100;Žirniukas;Gėlyčių;3214136760;Taip;0;8;0;8
16101;Žirniukas;Nykštukų;2489070480;Taip;0;0;1;1
16102;Žirniukas;Nykštukų;5734197350;Taip;0;1;0;1
16103;Žirniukas;Nykštukų;2746074694;Taip;5;0;0;5
16104;Žirniukas;Nykštukų;4282344625;Taip;4;1;0;5
16105;Žirniukas;Nykštukų;3874713264;Taip;1;2;0;3
16106;Žirniukas;Nykštukų;1532129054;Taip;0;1;0;1
16107;Žirniukas;Nykštukų;7368124402;Taip;0;5;0;5
16108;Žirniukas;Nykštukų;1635353228;Taip;0;1;1;2
16109;Žirniukas;Nykštukų;2027344763;Taip;0;1;0;1
16110;Žirniukas;Nykštukų;9478756666;Taip;0;1;1;2
16111;Žirniukas;Nykštukų;4704879073;Taip;6;0;0;6
16112;Žirniukas;Nykštukų;4732089209;Taip;2;3;0;5
16113;Žirniukas;Nykštukų;9988669252;Ne;3;0;0;3
16114;Žirniukas;Nykštukų;8242086461;Taip;0;3;0;3
16115;Žirniukas;Nykštukų;8242086461;Taip;0;3;0;3
16116;Žirniukas;Nykštukų;8242086461;Taip;0;3;0;3
16117;Žirniukas;Nykštukų;6511802399;Taip;0;3;0;3
16118;Žirniukas;Nykštukų;6511802399;Taip;0;3;0;3
16119;Žirniukas;Nykštukų;6511802399;Taip;0;3;0;3
16120;Žirniukas;Saulytės;5819443551;Taip;0;1;0;1
16121;Žirniukas;Saulytės;2733313392;Taip;0;1;0;1
16122;Žirniukas;Saulytės;9707776533;Taip;1;1;0;2
16123;Žirniukas;Saulytės;7278153529;Taip;0;2;0;2
16124;Žirniukas;Saulytės;7927815250;Taip;0;2;0;2
16125;Žirniukas;Saulytės;2325139043;Taip;8;2;0;10
16126;Žirniukas;Saulytės;4527367786;Taip;0;1;0;1
16127;Žirniukas;Saulytės;9961947583;Taip;0;4;0;4
16128;Žirniukas;Saulytės;9656768968;Taip;0;1;0;1
16129;Žirniukas;Saulytės;1074945082;Taip;0;2;0;2
16130;Žirniukas;Saulytės;1594735501;Taip;0;1;0;1
16131;Žirniukas;Saulytės;4433579937;Ne;0;2;1;3
16132;Žirniukas;Saulytės;4229687519;Taip;0;2;1;3
16133;Žirniukas;Saulytės;8599313527;Ne;0;3;4;7
16134;Žirniukas;Saulytės;4320686646;Taip;0;2;0;2
16135;Žirniukas;Drugelių;9232828844;Taip;0;1;0;1
16136;Žirniukas;Drugelių;5269074776;Taip;5;0;2;7
16137;Žirniukas;Drugelių;3509857181;Ne;8;1;0;9
16138;Žirniukas;Drugelių;2517524802;Taip;0;1;0;1
16139;Žirniukas;Drugelių;9901196251;Taip;0;0;5;5
16140;Žirniukas;Drugelių;4762596462;Taip;0;0;4;4
16141;Žirniukas;Drugelių;5046469974;Taip;5;1;0;6
16142;Žirniukas;Drugelių;1826203483;Ne;5;1;0;6
16143;Žirniukas;Drugelių;4536071547;Taip;0;2;1;3
16144;Žirniukas;Drugelių;6501961029;Taip;0;1;0;1
16145;Žirniukas;Drugelių;3996393849;Taip;10;1;2;13
16146;Žirniukas;Drugelių;7240364379;Taip;0;0;6;6
16147;Žirniukas;Drugelių;6300372863;Taip;2;6;0;8
16148;Žirniukas;Drugelių;5670489807;Taip;0;5;0;5
16149;Žirniukas;Drugelių;9794535841;Taip;18;0;0;18
16150;Žirniukas;Drugelių;1018506580;Taip;21;0;0;21
16151;Žirniukas;Drugelių;6993784924;Taip;0;0;3;3
16152;Žirniukas;Drugelių;9384464752;Taip;0;3;7;10
16153;Žirniukas;Pelėdžiukai;7889803840;Taip;0;1;0;1
16154;Žirniukas;Pelėdžiukai;2895924102;Taip;8;0;0;8
16155;Žirniukas;Pelėdžiukai;4347695841;Taip;0;0;3;3
16156;Žirniukas;Pelėdžiukai;4847093256;Taip;0;2;0;2
16157;Žirniukas;Pelėdžiukai;7356213150;Ne;0;1;0;1
16158;Žirniukas;Pelėdžiukai;7545458622;Taip;10;1;0;11
16159;Žirniukas;Pelėdžiukai;5376080603;Taip;0;0;8;8
16160;Žirniukas;Pelėdžiukai;7755938379;Taip;0;2;0;2
16161;Žirniukas;Pelėdžiukai;5470692657;Taip;8;2;6;16
16162;Žirniukas;Pelėdžiukai;8690042163;Taip;0;2;0;2
16163;Žirniukas;Pelėdžiukai;8808445761;Ne;0;2;0;2
16164;Žirniukas;Pelėdžiukai;2332260494;Taip;10;0;0;10
16165;Žirniukas;Pelėdžiukai;6941160450;Taip;0;1;0;1
16166;Žirniukas;Pelėdžiukai;4464151713;Taip;0;0;1;1
16167;Žirniukas;Pelėdžiukai;3907578167;Ne;1;0;0;1
16168;Žirniukas;Pelėdžiukai;4069128550;Taip;6;0;3;9
16169;Žirniukas;Pelėdžiukai;7767762079;Taip;8;0;0;8
16170;Žirniukas;ZUIKUČIAI;5613818351;Ne;7;1;0;8
16171;Žirniukas;ZUIKUČIAI;1345594362;Taip;0;0;3;3
16172;Žirniukas;ZUIKUČIAI;1005139737;Taip;1;0;0;1
16173;Žirniukas;ZUIKUČIAI;7081683726;Taip;9;4;0;13
16174;Žirniukas;ZUIKUČIAI;7021496832;Taip;0;0;5;5
16175;Žirniukas;ZUIKUČIAI;4860680720;Taip;1;2;2;5
16176;Žirniukas;ZUIKUČIAI;7269948694;Taip;0;2;2;4
16177;Žirniukas;ZUIKUČIAI;6594686128;Taip;8;0;0;8
16178;Žirniukas;ZUIKUČIAI;9993119353;Taip;0;3;0;3
16179;Žirniukas;ZUIKUČIAI;1679864330;Taip;14;1;0;15
16180;Žirniukas;ZUIKUČIAI;3438394768;Taip;0;0;1;1
16181;Žirniukas;ZUIKUČIAI;9569187800;Taip;9;2;0;11
16182;Aušra;Kodėlčiukai;2611563172;Taip;0;12;0;12
16183;Aušra;Kodėlčiukai;3420851059;Taip;0;1;0;1
16184;Aušra;Kodėlčiukai;2199083085;Taip;0;1;0;1
16185;Aušra;Kodėlčiukai;4720749995;Taip;0;1;4;5
16186;Aušra;Kodėlčiukai;6139706771;Taip;12;0;0;12
16187;Aušra;Kodėlčiukai;7314273812;Taip;8;3;2;13
16188;Aušra;Kodėlčiukai;5046439805;Taip;0;1;0;1
16189;Aušra;Kodėlčiukai;4540040693;Taip;10;3;0;13
16190;Aušra;Kodėlčiukai;1423840991;Ne;0;2;0;2
16191;Aušra;Kodėlčiukai;5013135853;Taip;10;2;0;12
16192;Aušra;Kodėlčiukai;9728140172;Taip;0;1;0;1
16193;Aušra;Kodėlčiukai;7765504789;Taip;10;8;0;18
16194;Aušra;Kodėlčiukai;8108663467;Taip;1;2;0;3
16195;Aušra;Kodėlčiukai;4824773027;Ne;0;1;0;1
16196;Aušra;Kodėlčiukai;1897365632;Taip;0;2;0;2
16197;Aušra;Kodėlčiukai;7469266085;Taip;0;18;0;18
16198;Aušra;Kodėlčiukai;1010721404;Taip;10;4;0;14
16199;Aušra;Kodėlčiukai;1883185016;Ne;0;1;0;1
16200;Aušra;Kodėlčiukai;1773343262;Taip;3;0;0;3
16201;Aušra;Kodėlčiukai;9437530221;Taip;0;1;7;8
16202;Aušra;Kodėlčiukai;7367602247;Taip;0;1;0;1
16203;Aušra;Kodėlčiukai;3627487971;Taip;7;1;0;8
16204;Aušra;"4B klasė";92119607174;Taip;15;1;0;16
16205;Aušra;"4B klasė";22923377435;Taip;13;1;0;14
16206;Aušra;"4B klasė";41852924528;Taip;0;21;0;21
16207;Aušra;"4B klasė";58526614808;Taip;0;21;0;21
16208;Aušra;"4B klasė";41039525379;Ne;3;1;0;4
16209;Aušra;"4B klasė";37339481276;Taip;3;1;0;4
16210;Aušra;"4B klasė";45165946624;Taip;3;1;0;4
16211;Aušra;"4B klasė";59107169775;Taip;4;1;0;5
16212;Aušra;"4B klasė";48349819906;Taip;12;1;0;13
16213;Aušra;"4B klasė";71596384638;Taip;3;1;0;4
16214;Aušra;"4B klasė";52332096506;Taip;3;1;0;4
16215;Aušra;"4B klasė";35703433862;Taip;3;1;0;4
16216;Aušra;"4B klasė";6201728036;Taip;0;21;0;21
16217;Aušra;"4B klasė";36889923728;Taip;20;1;0;21
16218;Aušra;"4B klasė";39957179831;Taip;3;1;0;4
16219;Aušra;"4B klasė";52909474598;Ne;3;1;0;4
16220;Aušra;"4B klasė";8901585006;Taip;0;21;0;21
16221;Aušra;"4B klasė";64562667133;Taip;0;21;0;21
16222;Aušra;"4B klasė";95076478544;Ne;3;1;0;4
16223;Aušra;"4B klasė";36899257479;Ne;4;1;0;5
16224;Aušra;"4B klasė";57520886724;Taip;4;1;0;5
16225;Aušra;"4B klasė";1815771421;Taip;3;1;0;4
16226;Aušra;"4B klasė";75433637766;Taip;0;21;0;21
16227;Aušra;"4B klasė";83119050626;Taip;0;21;0;21
16228;Aušra;Smalsučiai;1450251779;Taip;0;5;0;5
16229;Aušra;Smalsučiai;5409157554;Taip;5;0;1;6
16230;Aušra;Smalsučiai;8176840834;Taip;0;2;0;2
16231;Aušra;Smalsučiai;3680329197;Taip;13;0;1;14
16232;Aušra;Smalsučiai;8740755922;Taip;0;1;2;3
16233;Aušra;Smalsučiai;3898178166;Taip;0;2;0;2
16234;Aušra;Smalsučiai;29499576216;Taip;0;1;0;1
16235;Aušra;Smalsučiai;1940882109;Taip;0;2;0;2
16236;Aušra;Smalsučiai;4404047456;Taip;0;1;0;1
16237;Aušra;Smalsučiai;97102749430;Taip;0;1;1;2
16238;Aušra;Smalsučiai;9702136789;Taip;4;2;1;7
16239;Aušra;Smalsučiai;8709340592;Taip;5;0;0;5
16240;Aušra;Smalsučiai;5673568541;Taip;0;1;3;4
16241;Aušra;Smalsučiai;5524681006;Taip;0;2;0;2
16242;Aušra;Smalsučiai;6384243597;Taip;0;7;0;7
16243;Aušra;Smalsučiai;19402768340;Taip;5;1;0;6
16244;Aušra;Smalsučiai;2523842161;Taip;5;1;0;6
16245;Aušra;Smalsučiai;1343532870;Taip;0;5;0;5
16246;Aušra;Smalsučiai;7043021721;Taip;0;13;0;13
16247;Aušra;Smalsučiai;1612662076;Taip;0;8;0;8
16248;Aušra;Smalsučiai;1387254053;Taip;0;1;2;3
16249;Aušra;Smalsučiai;1575761029;Taip;9;1;3;13
16250;Aušra;Smalsučiai;5777939563;Taip;10;1;0;11
16251;Aušra;Smalsučiai;7814902928;Taip;0;3;2;5
16252;Aušra;"1A klasė";3001784066;Taip;3;1;0;4
16253;Aušra;"1A klasė";84116863778;Taip;5;1;0;6
16254;Aušra;"1A klasė";2227238810;Taip;3;1;0;4
16255;Aušra;"1A klasė";59837942520;Taip;3;1;0;4
16256;Aušra;"1A klasė";11053850075;Taip;3;1;0;4
16257;Aušra;"1A klasė";23609052737;Taip;3;1;0;4
16258;Aušra;"1A klasė";41017803426;Taip;3;1;0;4
16259;Aušra;"1A klasė";21544489661;Taip;6;1;0;7
16260;Aušra;"1A klasė";24625925423;Taip;3;1;0;4
16261;Aušra;"1A klasė";62186117615;Taip;3;1;0;4
16262;Aušra;"1A klasė";3526237179;Taip;13;1;0;14
16263;Aušra;"1A klasė";1893586984;Taip;0;21;0;21
16264;Aušra;"1A klasė";8686777160;Taip;5;1;0;6
16265;Aušra;"1A klasė";15657824495;Taip;8;1;0;9
16266;Aušra;"1A klasė";5988529284;Taip;8;1;0;9
16267;Aušra;"1A klasė";79051821501;Taip;3;1;0;4
16268;Aušra;"1A klasė";2062470430;Ne;3;1;0;4
16269;Aušra;"1A klasė";5815377310;Taip;3;1;0;4
16270;Aušra;"1A klasė";58254707316;Taip;3;1;0;4
16271;Aušra;"1A klasė";1385844067;Taip;3;1;0;4
16272;Aušra;"1A klasė";2121418946;Ne;3;1;0;4
16273;Aušra;"1A klasė";1219257874;Taip;0;21;0;21
16274;Aušra;"1A klasė";4325224130;Ne;3;1;0;4
16275;Aušra;"1A klasė";59267104215;Taip;3;1;0;4
16276;Aušra;"1A klasė";1623803107;Taip;3;1;0;4
16277;Aušra;"1B klasė";1988459596;Taip;3;1;0;4
16278;Aušra;"1B klasė";4930807661;Ne;3;1;0;4
16279;Aušra;"1B klasė";86128256406;Taip;5;1;0;6
16280;Aušra;"1B klasė";50687988382;Taip;3;1;0;4
16281;Aušra;"1B klasė";1021183555;Taip;3;1;0;4
16282;Aušra;"1B klasė";41268510292;Taip;3;1;0;4
16283;Aušra;"1B klasė";8428069167;Taip;10;1;0;11
16284;Aušra;"1B klasė";3910688753;Taip;3;1;0;4
16285;Aušra;"1B klasė";4024898537;Taip;3;1;0;4
16286;Aušra;"1B klasė";1238171728;Taip;4;1;0;5
16287;Aušra;"1B klasė";4103951942;Taip;3;1;0;4
16288;Aušra;"1B klasė";46481555688;Taip;6;1;0;7
16289;Aušra;"1B klasė";1063755068;Taip;4;1;0;5
16290;Aušra;"1B klasė";70844824182;Ne;3;1;0;4
16291;Aušra;"1B klasė";17098859260;Taip;3;1;0;4
16292;Aušra;"1B klasė";9940683245;Taip;3;1;0;4
16293;Aušra;"1B klasė";2841526614;Ne;6;1;0;7
16294;Aušra;"1B klasė";8813044848;Taip;4;1;0;5
16295;Aušra;"1B klasė";58741201573;Taip;3;1;0;4
16296;Aušra;"1B klasė";2003368811;Ne;3;1;0;4
16297;Aušra;"1B klasė";65840410497;Taip;3;1;0;4
16298;Aušra;"1B klasė";1640356242;Taip;3;1;0;4
16299;Aušra;"1B klasė";90604001837;Ne;3;1;0;4
16300;Aušra;"1B klasė";7794899167;Taip;3;1;0;4
16301;Aušra;"2A klasė";5468993286;Taip;3;1;0;4
16302;Aušra;"2A klasė";1167565535;Ne;3;1;0;4
16303;Aušra;"2A klasė";75047415039;Ne;13;1;0;14
16304;Aušra;"2A klasė";85826303673;Taip;3;1;0;4
16305;Aušra;"2A klasė";1145863002;Taip;0;21;0;21
16306;Aušra;"2A klasė";77966124767;Taip;3;1;0;4
16307;Aušra;"2A klasė";1473962346;Taip;3;1;0;4
16308;Aušra;"2A klasė";1049364899;Taip;8;1;0;9
16309;Aušra;"2A klasė";1427235223;Taip;7;1;0;8
16310;Aušra;"2A klasė";97312326369;Ne;3;1;0;4
16311;Aušra;"2A klasė";2019480768;Taip;3;1;0;4
16312;Aušra;"2A klasė";48817619537;Taip;3;1;0;4
16313;Aušra;"2A klasė";55937499558;Taip;4;1;0;5
16314;Aušra;"2A klasė";35779814505;Taip;4;1;0;5
16315;Aušra;"2A klasė";76280361479;Taip;3;1;0;4
16316;Aušra;"2A klasė";2131349938;Taip;4;1;0;5
16317;Aušra;"2A klasė";36447115547;Taip;3;1;0;4
16318;Aušra;"2A klasė";1455625997;Taip;3;1;0;4
16319;Aušra;"2A klasė";1393006122;Taip;3;1;0;4
16320;Aušra;"2A klasė";7998332115;Taip;3;1;0;4
16321;Aušra;"2A klasė";14611425618;Ne;3;1;0;4
16322;Aušra;"2A klasė";31458685084;Taip;3;1;0;4
16323;Aušra;"2A klasė";9603569117;Ne;3;1;0;4
16324;Aušra;"2A klasė";1315930711;Ne;3;1;0;4
16325;Aušra;"2A klasė";42344686036;Taip;3;1;0;4
16326;Aušra;"2A klasė";2647629246;Taip;10;1;0;11
16327;Aušra;"2A klasė";95586246863;Taip;3;1;0;4
16328;Aušra;"2A klasė";4110537888;Taip;9;1;0;10
16329;Aušra;"3A klasė";8510995681;Ne;3;1;0;4
16330;Aušra;"3A klasė";9605206310;Taip;3;1;0;4
16331;Aušra;"3A klasė";1396233353;Taip;10;1;0;11
16332;Aušra;"3A klasė";3284383302;Taip;4;1;0;5
16333;Aušra;"3A klasė";13157844661;Taip;3;1;0;4
16334;Aušra;"3A klasė";14157070764;Taip;3;1;0;4
16335;Aušra;"3A klasė";99073448709;Taip;0;21;0;21
16336;Aušra;"3A klasė";68160889669;Taip;3;1;0;4
16337;Aušra;"3A klasė";1437126272;Ne;3;1;0;4
16338;Aušra;"3A klasė";15330844181;Taip;3;1;0;4
16339;Aušra;"3A klasė";39537089288;Taip;3;1;0;4
16340;Aušra;"3A klasė";2062775070;Taip;0;21;0;21
16341;Aušra;"3A klasė";3965445196;Taip;3;1;0;4
16342;Aušra;"3A klasė";85578471272;Taip;4;1;0;5
16343;Aušra;"3A klasė";88655846176;Taip;4;1;0;5
16344;Aušra;"3A klasė";73509864636;Ne;3;1;0;4
16345;Aušra;"3A klasė";27958163601;Taip;3;1;0;4
16346;Aušra;"3A klasė";40499781883;Taip;10;1;0;11
16347;Aušra;"3A klasė";68031503463;Taip;6;1;0;7
16348;Aušra;"3A klasė";81633973264;Taip;0;21;0;21
16349;Aušra;"3A klasė";70233681803;Taip;0;21;0;21
16350;Aušra;"3A klasė";1437385365;Taip;0;21;0;21
16351;Aušra;"3A klasė";51185323645;Ne;0;21;0;21
16352;Aušra;"3A klasė";52985512945;Taip;0;21;0;21
16353;Aušra;"3A klasė";97781409787;Taip;3;1;0;4
16354;Aušra;"3A klasė";474412140;Ne;3;1;0;4
16355;Aušra;"3A klasė";40714551025;Taip;6;1;0;7
16356;Aušra;"3A klasė";58699109274;Taip;3;1;0;4
16357;Aušra;"4A klasė";68481706412;Taip;0;21;0;21
16358;Aušra;"4A klasė";99886964420;Taip;0;21;0;21
16359;Aušra;"4A klasė";19920237804;Taip;9;1;0;10
16360;Aušra;"4A klasė";13361663464;Taip;5;1;0;6
16361;Aušra;"4A klasė";95948867937;Taip;7;1;0;8
16362;Aušra;"4A klasė";78030425432;Taip;6;1;0;7
16363;Aušra;"4A klasė";97596344387;Taip;10;1;0;11
16364;Aušra;"4A klasė";97596344387;Taip;10;1;0;11
16365;Aušra;"4A klasė";34795588283;Ne;0;21;0;21
16366;Aušra;"4A klasė";29636399665;Taip;7;1;0;8
16367;Aušra;"4A klasė";81428848455;Taip;3;1;0;4
16368;Aušra;"4A klasė";47725613978;Taip;3;1;0;4
16369;Aušra;"4A klasė";93365393803;Taip;3;1;0;4
16370;Aušra;"4A klasė";52864653926;Taip;6;1;0;7
16371;Aušra;"4A klasė";10272136932;Ne;3;1;0;4
16372;Aušra;"4A klasė";77425098448;Taip;0;21;0;21
16373;Aušra;"4A klasė";20550256232;Taip;3;1;0;4
16374;Aušra;"4A klasė";42015974556;Taip;3;1;0;4
16375;Aušra;"4A klasė";2113586354;Taip;14;1;0;15
16376;Aušra;"4A klasė";19718806057;Taip;0;21;0;21
16377;Aušra;"4A klasė";21856009403;Taip;0;21;0;21
16378;Aušra;"4A klasė";5166358753;Taip;3;1;0;4
16379;Aušra;Pabiručiai;7542690501;Taip;0;1;0;1
16380;Aušra;Pabiručiai;7476662446;Taip;5;2;0;7
16381;Aušra;Pabiručiai;9466807067;Taip;8;0;0;8
16382;Aušra;Pabiručiai;6508435821;Taip;6;2;0;8
16383;Aušra;Pabiručiai;7926621700;Taip;0;5;0;5
16384;Aušra;Pabiručiai;8665364744;Taip;21;0;0;21
16385;Aušra;Pabiručiai;6555345047;Taip;0;8;0;8
16386;Aušra;Pabiručiai;7888891808;Taip;9;0;0;9
16387;Aušra;Pabiručiai;8769357172;Taip;5;3;1;9
16388;Aušra;Pabiručiai;1306616759;Taip;0;3;1;4
16389;Aušra;Pabiručiai;3275288747;Taip;0;1;0;1
16390;Aušra;Pabiručiai;5797692122;Ne;0;4;2;6
16391;Aušra;Pabiručiai;4071233786;Taip;5;0;0;5
16392;Aušra;Pabiručiai;4646215025;Taip;12;0;4;16
16393;Aušra;Pabiručiai;7199483890;Ne;1;1;0;2
16394;Aušra;Pabiručiai;3008573040;Ne;5;2;1;8
16395;Aušra;Pabiručiai;7944904281;Taip;1;2;3;6
16396;Aušra;Pabiručiai;3336605264;Taip;2;0;0;2
16397;Aušra;Pabiručiai;7159809546;Taip;3;0;0;3
16398;Aušra;Pabiručiai;3553620602;Taip;5;1;0;6
16399;Aušra;Pabiručiai;3759593393;Taip;0;1;0;1
16400;Aušra;Pabiručiai;2904303784;Taip;5;0;0;5
16401;Aušra;Pabiručiai;6056923592;Taip;6;0;0;6
16402;Aušra;Pabiručiai;3953653896;Taip;8;6;0;14
16403;Aušra;Pabiručiai;2273160688;Taip;6;1;0;7
16404;Aušra;Pabiručiai;8462418277;Taip;9;1;0;10
16405;Aušra;Gudručiai;2271582954;Taip;6;0;0;6
16406;Aušra;Gudručiai;4564561993;Taip;0;1;0;1
16407;Aušra;Gudručiai;7783006852;Taip;0;2;0;2
16408;Aušra;Gudručiai;9614562473;Taip;0;1;0;1
16409;Aušra;Gudručiai;6658178519;Taip;0;1;0;1
16410;Aušra;Gudručiai;7921251819;Taip;13;1;0;14
16411;Aušra;Gudručiai;9628651723;Ne;10;3;0;13
16412;Aušra;Gudručiai;3343235857;Taip;0;0;2;2
16413;Aušra;Gudručiai;1337138547;Taip;10;1;0;11
16414;Aušra;Gudručiai;3530905126;Taip;0;0;21;21
16415;Aušra;Gudručiai;1429548355;Ne;0;13;0;13
16416;Aušra;Gudručiai;1933801749;Taip;0;0;3;3
16417;Aušra;Gudručiai;5955385407;Ne;4;2;1;7
16418;Aušra;Gudručiai;2243689816;Taip;0;3;0;3
16419;Aušra;Gudručiai;1693711284;Taip;4;0;0;4
16420;Aušra;Gudručiai;6935310711;Taip;0;3;1;4
16421;Aušra;Gudručiai;3698868934;Taip;16;0;1;17
16422;Aušra;Gudručiai;9079804366;Taip;7;1;0;8
16423;Aušra;Gudručiai;3498143162;Taip;7;1;0;8
16424;Aušra;Gudručiai;5053808615;Taip;0;1;0;1
16425;Aušra;Naminukai;5993984086;Taip;0;1;0;1
16426;Aušra;Naminukai;8884580599;Ne;10;0;0;10
16427;Aušra;Naminukai;6614027605;Ne;8;2;0;10
16428;Aušra;Naminukai;2039920706;Taip;0;3;0;3
16429;Aušra;Naminukai;6965081051;Taip;5;1;0;6
16430;Aušra;Naminukai;2768220823;Taip;3;1;3;7
16431;Aušra;Naminukai;5925213006;Taip;8;1;0;9
16432;Aušra;Naminukai;1630814772;Taip;2;2;0;4
16433;Aušra;Naminukai;9333701196;Taip;0;4;0;4
16434;Aušra;Naminukai;4010347313;Taip;0;21;0;21
16435;Aušra;Naminukai;3860755808;Taip;14;0;2;16
16436;Aušra;Naminukai;4339450816;Taip;5;2;0;7
16437;Aušra;Naminukai;4000881716;Taip;8;1;2;11
16438;Aušra;Naminukai;8021547491;Ne;6;1;0;7
16439;Aušra;Naminukai;5268479689;Taip;3;0;0;3
16440;Aušra;Naminukai;3526010606;Taip;2;0;0;2
16441;Aušra;Naminukai;4163605313;Taip;0;4;0;4
16442;Aušra;Naminukai;3468946868;Taip;12;0;1;13
16443;Aušra;Naminukai;7710131755;Taip;11;0;1;12
16444;Aušra;Naminukai;8584355573;Ne;0;1;0;1
16445;Aušra;Naminukai;2495610772;Taip;6;6;0;12
16446;Aušra;Naminukai;8489362814;Taip;5;0;5;10
16447;Aušra;Naminukai;3675175233;Taip;4;6;0;10
16448;Aušra;" 1C klasė";1426802917;Taip;3;1;0;4
16449;Aušra;" 1C klasė";26010333641;Taip;3;1;0;4
16450;Aušra;" 1C klasė";3133031845;Taip;4;1;0;5
16451;Aušra;" 1C klasė";11130172902;Ne;3;1;0;4
16452;Aušra;" 1C klasė";43737170074;Taip;3;1;0;4
16453;Aušra;" 1C klasė";1370336984;Taip;4;1;0;5
16454;Aušra;" 1C klasė";6483078840;Taip;9;1;0;10
16455;Aušra;" 1C klasė";1684481833;Taip;5;1;0;6
16456;Aušra;" 1C klasė";1198248619;Taip;3;1;0;4
16457;Aušra;" 1C klasė";4765125810;Taip;3;1;0;4
16458;Aušra;" 1C klasė";5704281727;Taip;3;1;0;4
16459;Aušra;" 1C klasė";1479311429;Taip;3;1;0;4
16460;Aušra;" 1C klasė";1542575012;Ne;3;1;0;4
16461;Aušra;" 1C klasė";1291782232;Taip;3;1;0;4
16462;Aušra;" 1C klasė";90520726029;Taip;3;1;0;4
16463;Aušra;" 1C klasė";1844632980;Ne;3;1;0;4
16464;Aušra;" 1C klasė";94478599707;Taip;3;1;0;4
16465;Aušra;" 1C klasė";78489473446;Taip;3;1;0;4
16466;Aušra;" 1C klasė";29328876924;Taip;3;1;0;4
16467;Aušra;" 1C klasė";7649832094;Taip;3;1;0;4
16468;Aušra;" 1C klasė";8225188274;Taip;3;1;0;4
16469;Aušra;" 1C klasė";1371282149;Taip;4;1;0;5
16470;Aušra;" 1C klasė";57559227292;Taip;3;1;0;4
16471;Berželis;PČIOLKI;9024992452;Taip;0;1;0;1
16472;Berželis;PČIOLKI;1521982237;Taip;11;1;1;13
16473;Berželis;PČIOLKI;3298044639;Taip;0;3;0;3
16474;Berželis;PČIOLKI;2615440913;Ne;10;6;0;16
16475;Berželis;PČIOLKI;4013215941;Taip;0;1;0;1
16476;Berželis;PČIOLKI;3772780161;Taip;5;3;0;8
16477;Berželis;PČIOLKI;4563582416;Taip;4;3;0;7
16478;Berželis;PČIOLKI;1225018351;Taip;0;1;0;1
16479;Berželis;PČIOLKI;9894751274;Taip;0;1;1;2
16480;Berželis;PČIOLKI;7526006253;Taip;3;1;0;4
16481;Berželis;PČIOLKI;1036370516;Taip;0;1;0;1
16482;Berželis;PČIOLKI;9644196870;Taip;0;1;2;3
16483;Berželis;PČIOLKI;2214171136;Taip;2;1;1;4
16484;Berželis;PČIOLKI;6473498471;Taip;4;1;0;5
16485;Berželis;PČIOLKI;97218091736;Taip;0;1;1;2
16486;Berželis;PČIOLKI;5798989689;Taip;0;1;0;1
16487;Berželis;PČIOLKI;2007064959;Taip;0;1;2;3
16488;Berželis;PČIOLKI;5084171353;Taip;0;1;0;1
16489;Berželis;PČIOLKI;4521372127;Taip;0;1;0;1
16490;Berželis;PČIOLKI;1067618571;Taip;0;1;1;2
16491;Berželis;PČIOLKI;7287552286;Taip;0;0;1;1
16492;Berželis;"BOŽJI KOROVKI";3162044236;Taip;4;0;0;4
16493;Berželis;"BOŽJI KOROVKI";9132058594;Taip;0;0;1;1
16494;Berželis;"BOŽJI KOROVKI";7421059780;Taip;6;0;0;6
16495;Berželis;"BOŽJI KOROVKI";5739847580;Taip;12;0;5;17
16496;Berželis;"BOŽJI KOROVKI";4100740863;Taip;9;5;0;14
16497;Berželis;"BOŽJI KOROVKI";1750209600;Taip;0;1;0;1
16498;Berželis;"BOŽJI KOROVKI";5953387226;Taip;0;7;0;7
16499;Berželis;"BOŽJI KOROVKI";3070917065;Ne;7;3;0;10
16500;Berželis;"BOŽJI KOROVKI";8118040960;Taip;0;2;0;2
16501;Berželis;"BOŽJI KOROVKI";5692603837;Taip;0;6;0;6
16502;Berželis;"BOŽJI KOROVKI";5194480946;Taip;6;1;0;7
16503;Berželis;"BOŽJI KOROVKI";9848723402;Taip;12;1;0;13
16504;Berželis;"BOŽJI KOROVKI";5551459997;Taip;0;1;0;1
16505;Berželis;"BOŽJI KOROVKI";6651007152;Taip;0;1;0;1
16506;Berželis;"BOŽJI KOROVKI";8451877584;Taip;10;0;1;11
16507;Berželis;"BOŽJI KOROVKI";7080168105;Taip;9;0;0;9
16508;Berželis;"BOŽJI KOROVKI";9438498834;Ne;0;3;0;3
16509;Berželis;"BOŽJI KOROVKI";1132252592;Taip;10;0;1;11
16510;Berželis;"BOŽJI KOROVKI";5550598069;Taip;2;0;0;2
16511;Berželis;"BOŽJI KOROVKI";1852964349;Taip;5;0;0;5
16512;Berželis;"BOŽJI KOROVKI";8871199713;Taip;0;7;0;7
16513;Berželis;"BOŽJI KOROVKI";9466461910;Taip;16;0;0;16
16514;Berželis;SOLNYŠKO;1498165322;Taip;0;0;2;2
16515;Berželis;SOLNYŠKO;8737788279;Taip;6;0;0;6
16516;Berželis;SOLNYŠKO;2901168499;Ne;16;0;0;16
16517;Berželis;SOLNYŠKO;7411282628;Taip;20;0;0;20
16518;Berželis;SOLNYŠKO;8957312159;Taip;11;0;0;11
16519;Berželis;SOLNYŠKO;4910899296;Taip;0;0;16;16
16520;Berželis;SOLNYŠKO;1167103292;Taip;2;3;0;5
16521;Berželis;SOLNYŠKO;5408368340;Taip;0;0;3;3
16522;Berželis;SOLNYŠKO;1070751052;Taip;14;0;0;14
16523;Berželis;SOLNYŠKO;5464385395;Taip;10;2;0;12
16524;Berželis;SOLNYŠKO;1424868444;Taip;8;3;0;11
16525;Berželis;SOLNYŠKO;1146976812;Ne;6;2;0;8
16526;Berželis;SOLNYŠKO;6774460279;Taip;16;0;0;16
16527;Berželis;BABOČKI;4923631429;Taip;0;0;2;2
16528;Berželis;BABOČKI;2016194182;Taip;9;0;0;9
16529;Berželis;BABOČKI;2030770943;Taip;1;0;0;1
16530;Berželis;BABOČKI;2667957070;Taip;0;1;0;1
16531;Berželis;BABOČKI;7781031211;Taip;0;8;0;8
16532;Berželis;BABOČKI;2493612905;Ne;0;1;0;1
16533;Berželis;BABOČKI;5688897783;Taip;0;6;0;6
16534;Berželis;BABOČKI;6942559693;Taip;6;0;0;6
16535;Berželis;BABOČKI;9245706377;Taip;7;0;0;7
16536;Berželis;BABOČKI;6352635742;Taip;0;1;0;1
16537;Berželis;BABOČKI;3613459846;Taip;0;1;0;1
16538;Berželis;BABOČKI;8448872491;Taip;1;0;0;1
16539;Berželis;BABOČKI;5069322062;Taip;7;1;4;12
16540;Berželis;BABOČKI;2954451168;Taip;0;0;2;2
16541;Berželis;BABOČKI;9585609150;Taip;8;3;0;11
16542;Berželis;BABOČKI;9091691636;Taip;0;0;2;2
16543;Berželis;BABOČKI;7940591009;Taip;0;0;5;5
16544;Berželis;BABOČKI;4546285993;Taip;0;0;18;18
16545;Berželis;BABOČKI;5876182759;Taip;0;1;0;1
16546;Berželis;BABOČKI;9568910880;Taip;10;1;0;11
16547;Berželis;BABOČKI;6577232093;Taip;1;0;6;7
16548;Berželis;SOVUŠKI;5350402890;Taip;0;0;3;3
16549;Berželis;SOVUŠKI;8185887403;Taip;21;0;0;21
16550;Berželis;SOVUŠKI;1289333809;Taip;6;2;0;8
16551;Berželis;SOVUŠKI;8086074279;Taip;0;3;0;3
16552;Berželis;SOVUŠKI;9273819928;Taip;1;3;0;4
16553;Berželis;SOVUŠKI;9750863775;Taip;6;3;0;9
16554;Berželis;SOVUŠKI;1769470120;Taip;0;1;1;2
16555;Berželis;SOVUŠKI;6706273205;Taip;3;0;2;5
16556;Berželis;SOVUŠKI;2895332184;Ne;3;0;0;3
16557;Berželis;SOVUŠKI;1464998584;Taip;9;0;0;9
16558;Berželis;SOVUŠKI;2844736188;Taip;2;0;0;2
16559;Berželis;SOVUŠKI;3835273594;Taip;0;2;0;2
16560;Berželis;SOVUŠKI;2632535013;Taip;6;0;0;6
16561;Berželis;SOVUŠKI;6698849108;Taip;6;0;1;7
16562;Berželis;SOVUŠKI;1583268041;Taip;15;0;0;15
16563;Berželis;PODSOLNUŠKI;1044720859;Taip;0;0;3;3
16564;Berželis;PODSOLNUŠKI;3157906472;Taip;15;0;0;15
16565;Berželis;PODSOLNUŠKI;9945124824;Taip;0;0;4;4
16566;Berželis;PODSOLNUŠKI;5925726854;Taip;0;0;2;2
16567;Berželis;PODSOLNUŠKI;8168498937;Taip;1;0;0;1
16568;Berželis;PODSOLNUŠKI;9072126286;Taip;1;0;0;1
16569;Berželis;PODSOLNUŠKI;8633724383;Taip;14;0;0;14
16570;Berželis;PODSOLNUŠKI;2259367998;Taip;0;0;1;1
16571;Berželis;PODSOLNUŠKI;3033042487;Ne;12;0;0;12
16572;Berželis;PODSOLNUŠKI;2136455625;Taip;0;0;5;5
16573;Berželis;PODSOLNUŠKI;1964320071;Taip;4;0;2;6
16574;Berželis;PODSOLNUŠKI;2615832804;Taip;8;0;0;8
16575;Berželis;PODSOLNUŠKI;9133988149;Taip;0;1;1;2
16576;Berželis;PODSOLNUŠKI;6686248053;Taip;0;2;0;2
16577;Berželis;PODSOLNUŠKI;1081582842;Ne;3;3;0;6
16578;Berželis;PODSOLNUŠKI;5963915092;Taip;0;0;1;1
16579;Berželis;PODSOLNUŠKI;3378237475;Taip;0;0;1;1
16580;Berželis;LAPIUKAI;2971765753;Taip;0;0;6;6
16581;Berželis;LAPIUKAI;3813964138;Taip;0;0;1;1
16582;Berželis;LAPIUKAI;7947225506;Ne;0;5;0;5
16583;Berželis;LAPIUKAI;2144796691;Taip;12;2;0;14
16584;Berželis;LAPIUKAI;1834920753;Taip;0;0;8;8
16585;Berželis;LAPIUKAI;6384939601;Taip;0;0;1;1
16586;Berželis;LAPIUKAI;2410514408;Taip;0;0;6;6
16587;Berželis;LAPIUKAI;2794074071;Ne;0;0;1;1
16588;Berželis;LAPIUKAI;9681310544;Taip;0;0;5;5
16589;Berželis;LAPIUKAI;4254592648;Taip;5;0;2;7
16590;Berželis;LAPIUKAI;9543499205;Taip;0;3;0;3
16591;Berželis;LAPIUKAI;9749516260;Taip;8;0;0;8
16592;Berželis;LAPIUKAI;2947072348;Ne;0;1;0;1
16593;Berželis;MEŠKIUKAI;8994102218;Ne;3;7;0;10
16594;Berželis;MEŠKIUKAI;4854931959;Ne;3;0;0;3
16595;Berželis;MEŠKIUKAI;7902774064;Taip;10;0;0;10
16596;Berželis;MEŠKIUKAI;2062794406;Taip;0;0;1;1
16597;Berželis;MEŠKIUKAI;9459031158;Taip;8;0;0;8
16598;Berželis;MEŠKIUKAI;4243086262;Taip;0;0;1;1
16599;Berželis;MEŠKIUKAI;9178527605;Taip;0;4;0;4
16600;Berželis;MEŠKIUKAI;1235617054;Taip;6;4;0;10
16601;Berželis;MEŠKIUKAI;1178588907;Taip;8;0;0;8
16602;Berželis;MEŠKIUKAI;5100214127;Taip;0;0;2;2
16603;Berželis;MEŠKIUKAI;3535856504;Ne;0;1;1;2
16604;Berželis;MEŠKIUKAI;1673524685;Taip;7;0;0;7
16605;Berželis;MEŠKIUKAI;2762946143;Taip;0;9;0;9
16606;Berželis;ŽIEDELIAI;3786609012;Ne;5;0;2;7
16607;Berželis;ŽIEDELIAI;9805181733;Taip;0;0;5;5
16608;Berželis;ŽIEDELIAI;1165300871;Taip;4;0;4;8
16609;Berželis;ŽIEDELIAI;2016827207;Ne;5;0;2;7
16610;Berželis;ŽIEDELIAI;9979442772;Ne;0;0;2;2
16611;Berželis;ŽIEDELIAI;9881246268;Taip;4;0;0;4
16612;Berželis;ŽIEDELIAI;7042967329;Taip;6;0;1;7
16613;Berželis;ŽIEDELIAI;9925865228;Taip;0;4;0;4
16614;Berželis;ŽIEDELIAI;1402975280;Taip;5;0;0;5
16615;Berželis;ŽIEDELIAI;1535940949;Ne;0;15;0;15
16616;Berželis;ŽIEDELIAI;2030492491;Taip;4;0;2;6
16617;Berželis;ŽIEDELIAI;3351114197;Taip;2;0;5;7
16618;Berželis;ŽIEDELIAI;5248880873;Taip;18;0;0;18
16619;Berželis;ŽIEDELIAI;2508532190;Taip;13;0;0;13
16620;Berželis;NYKŠTUKAI;8148104183;Ne;0;0;3;3
16621;Berželis;NYKŠTUKAI;7935684899;Ne;5;0;6;11
16622;Berželis;NYKŠTUKAI;1403664386;Taip;0;4;0;4
16623;Berželis;NYKŠTUKAI;5637168259;Taip;4;0;1;5
16624;Berželis;NYKŠTUKAI;9666648116;Taip;1;0;0;1
16625;Berželis;NYKŠTUKAI;3559065542;Ne;6;1;1;8
16626;Berželis;NYKŠTUKAI;3556594755;Taip;0;0;2;2
16627;Berželis;NYKŠTUKAI;2933069798;Taip;0;0;2;2
16628;Berželis;NYKŠTUKAI;8430372047;Taip;0;1;3;4
16629;Berželis;NYKŠTUKAI;5099275362;Ne;0;0;2;2
16630;Berželis;NYKŠTUKAI;5101382213;Taip;4;0;1;5
16631;Berželis;NYKŠTUKAI;2425621326;Ne;2;0;1;3
16632;Berželis;NYKŠTUKAI;7676141462;Ne;0;9;0;9
16633;Berželis;NYKŠTUKAI;3852021563;Taip;5;0;2;7
16634;Berželis;NYKŠTUKAI;3379227410;Taip;17;0;1;18
16635;Berželis;NYKŠTUKAI;4032178538;Taip;0;4;0;4
16636;Berželis;NYKŠTUKAI;5839964720;Taip;5;0;0;5
16637;Berželis;UOGELĖS;8164697203;Ne;0;2;0;2
16638;Berželis;UOGELĖS;8735934456;Taip;5;0;7;12
16639;Berželis;UOGELĖS;5304917030;Ne;0;1;1;2
16640;Berželis;UOGELĖS;6136155301;Taip;16;0;0;16
16641;Berželis;UOGELĖS;9950641759;Taip;3;0;1;4
16642;Berželis;UOGELĖS;5851732944;Taip;6;0;2;8
16643;Berželis;UOGELĖS;2321608974;Ne;0;1;1;2
16644;Berželis;UOGELĖS;3229996417;Taip;0;0;1;1
16645;Berželis;UOGELĖS;6773760208;Ne;11;0;0;11
16646;Berželis;UOGELĖS;7750905743;Taip;0;4;0;4
16647;Berželis;UOGELĖS;4607486516;Ne;1;0;3;4
16648;Berželis;UOGELĖS;8814953641;Ne;7;0;0;7
16649;Berželis;UOGELĖS;5197350105;Taip;7;7;0;14
16650;Berželis;KODĖLČIUKAI;5786052354;Ne;0;0;7;7
16651;Berželis;KODĖLČIUKAI;5134372871;Taip;5;2;2;9
16652;Berželis;KODĖLČIUKAI;7852089381;Taip;1;0;1;2
16653;Berželis;KODĖLČIUKAI;5751995154;Ne;6;1;0;7
16654;Berželis;KODĖLČIUKAI;3589890886;Taip;0;2;3;5
16655;Berželis;KODĖLČIUKAI;7986744784;Ne;1;0;0;1
16656;Berželis;KODĖLČIUKAI;1127524998;Taip;3;0;2;5
16657;Berželis;KODĖLČIUKAI;3951962738;Ne;0;2;2;4
16658;Berželis;KODĖLČIUKAI;2193392844;Ne;1;0;2;3
16659;Berželis;KODĖLČIUKAI;9696962207;Taip;2;0;0;2
16660;Berželis;KODĖLČIUKAI;8286301258;Taip;0;9;0;9
16661;Berželis;KODĖLČIUKAI;8875116641;Taip;0;13;0;13
16662;Berželis;KODĖLČIUKAI;9282593781;Taip;0;10;0;10
16663;Berželis;KODĖLČIUKAI;6500588668;Taip;9;1;0;10
16664;Berželis;KODĖLČIUKAI;3327751482;Ne;6;0;2;8
16665;Saulutė;Drugeliai;5943795519;Taip;0;1;0;1
16666;Saulutė;Drugeliai;4067009709;Taip;9;1;5;15
16667;Saulutė;Drugeliai;3991128892;Taip;13;0;0;13
16668;Saulutė;Drugeliai;4781756849;Taip;1;0;2;3
16669;Saulutė;Drugeliai;7689842018;Taip;0;0;2;2
16670;Saulutė;Drugeliai;4288298305;Taip;5;1;1;7
16671;Saulutė;Drugeliai;9133269796;Ne;6;1;2;9
16672;Saulutė;Drugeliai;6057938367;Taip;21;0;0;21
16673;Saulutė;Drugeliai;1268204445;Taip;10;1;0;11
16674;Saulutė;Drugeliai;1585403702;Taip;10;0;2;12
16675;Saulutė;Drugeliai;4915192103;Taip;0;0;1;1
16676;Saulutė;Drugeliai;8003855875;Taip;0;0;2;2
16677;Saulutė;Drugeliai;2301903550;Taip;21;0;0;21
16678;Saulutė;Drugeliai;3265401334;Taip;2;0;4;6
16679;Saulutė;Drugeliai;2337702344;Ne;0;6;0;6
16680;Saulutė;Drugeliai;3662919521;Taip;10;1;0;11
16681;Saulutė;Drugeliai;6455593653;Taip;0;1;1;2
16682;Saulutė;Drugeliai;9410517602;Taip;5;0;0;5
16683;Saulutė;Drugeliai;1088813143;Taip;11;0;0;11
16684;Saulutė;Drugeliai;8409958782;Taip;8;1;5;14
16685;Saulutė;Drugeliai;6304028361;Taip;5;0;1;6
16686;Saulutė;"Saulės zuikučiai";8946107286;Taip;0;1;0;1
16687;Saulutė;"Saulės zuikučiai";2397257894;Taip;0;1;2;3
16688;Saulutė;"Saulės zuikučiai";5148542811;Taip;21;0;0;21
16689;Saulutė;"Saulės zuikučiai";2259917151;Taip;0;1;0;1
16690;Saulutė;"Saulės zuikučiai";3749374270;Taip;0;2;0;2
16691;Saulutė;"Saulės zuikučiai";8242602551;Ne;0;1;0;1
16692;Saulutė;"Saulės zuikučiai";5247769309;Taip;15;0;0;15
16693;Saulutė;"Saulės zuikučiai";2816806902;Taip;10;1;0;11
16694;Saulutė;"Saulės zuikučiai";2781003892;Taip;0;3;0;3
16695;Saulutė;"Saulės zuikučiai";7888435573;Taip;0;1;1;2
16696;Saulutė;"Saulės zuikučiai";9521155670;Taip;0;0;1;1
16697;Saulutė;"Saulės zuikučiai";3089541630;Taip;0;3;0;3
16698;Saulutė;"Saulės zuikučiai";5326279083;Taip;0;2;0;2
16699;Saulutė;"Saulės zuikučiai";1562393383;Taip;0;1;6;7
16700;Saulutė;"Saulės zuikučiai";3272296969;Ne;0;2;0;2
16701;Saulutė;"Saulės zuikučiai";6924891265;Taip;0;0;5;5
16702;Saulutė;"Saulės zuikučiai";4663795223;Taip;0;0;1;1
16703;Saulutė;"Saulės zuikučiai";5931269521;Taip;11;5;0;16
16704;Saulutė;"Saulės zuikučiai";7839168221;Taip;8;0;0;8
16705;Saulutė;"Saulės zuikučiai";4945943570;Ne;0;0;6;6
16706;Saulutė;"Saulės zuikučiai";3730442890;Taip;13;1;0;14
16707;Saulutė;"Saulės zuikučiai";3620722907;Taip;0;1;0;1
16708;Saulutė;Boružėlės;3295289082;Taip;0;2;0;2
16709;Saulutė;Boružėlės;1587328722;Taip;6;1;0;7
16710;Saulutė;Boružėlės;8390767549;Taip;0;1;0;1
16711;Saulutė;Boružėlės;7576532632;Taip;0;0;3;3
16712;Saulutė;Boružėlės;2725491887;Taip;8;0;2;10
16713;Saulutė;Boružėlės;9314889468;Taip;2;1;0;3
16714;Saulutė;Boružėlės;7764493159;Taip;0;1;0;1
16715;Saulutė;Boružėlės;5565832676;Taip;0;1;0;1
16716;Saulutė;Boružėlės;5811810714;Taip;0;2;0;2
16717;Saulutė;Boružėlės;8643975544;Ne;0;0;1;1
16718;Saulutė;Boružėlės;7081700501;Taip;0;0;1;1
16719;Saulutė;Boružėlės;7474989619;Ne;0;1;15;16
16720;Saulutė;Boružėlės;7574225926;Taip;0;0;1;1
16721;Saulutė;Boružėlės;1803710557;Taip;0;0;2;2
16722;Saulutė;Boružėlės;9098663596;Taip;0;0;1;1
16723;Saulutė;Boružėlės;7425789805;Taip;0;0;4;4
16724;Saulutė;Boružėlės;1265174091;Taip;0;0;2;2
16725;Saulutė;Boružėlės;2527027536;Taip;0;1;2;3
16726;Saulutė;Boružėlės;2988010963;Taip;4;0;0;4
16727;Saulutė;Boružėlės;3852862834;Taip;0;0;5;5
16728;Saulutė;Boružėlės;1275552038;Taip;0;0;8;8
16729;Saulutė;Nykštukai;2601822200;Taip;0;5;1;6
16730;Saulutė;Nykštukai;3244850673;Taip;0;6;0;6
16731;Saulutė;Nykštukai;9497439410;Taip;0;4;0;4
16732;Saulutė;Nykštukai;5607937410;Taip;0;4;0;4
16733;Saulutė;Nykštukai;3571751974;Taip;12;0;1;13
16734;Saulutė;Nykštukai;3221612665;Ne;0;14;1;15
16735;Saulutė;Nykštukai;2140277182;Taip;1;0;3;4
16736;Saulutė;Nykštukai;4510990261;Taip;18;0;0;18
16737;Saulutė;Nykštukai;4800144085;Taip;0;10;0;10
16738;Saulutė;Nykštukai;8257363228;Taip;2;0;2;4
16739;Saulutė;Nykštukai;9664809396;Taip;1;0;0;1
16740;Saulutė;Nykštukai;8984040932;Taip;4;5;0;9
16741;Saulutė;Nykštukai;3463428772;Taip;4;1;0;5
16742;Saulutė;Nykštukai;4390098560;Taip;0;1;2;3
16743;Saulutė;Nykštukai;3363212754;Taip;0;7;0;7
16744;Saulutė;Nykštukai;5442075474;Taip;6;0;2;8
16745;Saulutė;Nykštukai;4298556244;Taip;3;0;5;8
16746;Saulutė;Nykštukai;8722717930;Ne;0;21;0;21
16747;Saulutė;Nykštukai;9930330487;Taip;12;0;0;12
16748;Saulutė;Nykštukai;7158455528;Taip;9;1;1;11
16749;Saulutė;Nykštukai;2669711574;Ne;1;0;0;1
16750;Saulutė;Nykštukai;6982979199;Taip;0;0;2;2
16751;Saulutė;Meškiukai;8952893819;Taip;0;15;0;15
16752;Saulutė;Meškiukai;1229624643;Taip;6;3;0;9
16753;Saulutė;Meškiukai;9572394489;Taip;15;0;1;16
16754;Saulutė;Meškiukai;9567511354;Taip;12;0;3;15
16755;Saulutė;Meškiukai;6126870829;Taip;15;0;0;15
16756;Saulutė;Meškiukai;6579874077;Taip;0;9;0;9
16757;Saulutė;Meškiukai;6178908581;Taip;0;1;0;1
16758;Saulutė;Meškiukai;8472510151;Taip;0;1;2;3
16759;Saulutė;Meškiukai;6955061957;Taip;9;10;0;19
16760;Saulutė;Meškiukai;7478215328;Taip;0;1;1;2
16761;Saulutė;Meškiukai;9727366891;Taip;4;0;5;9
16762;Saulutė;Meškiukai;3565818383;Taip;0;0;2;2
16763;Saulutė;Meškiukai;5219429911;Taip;0;11;8;19
16764;Saulutė;Meškiukai;3125186472;Taip;8;0;2;10
16765;Saulutė;Meškiukai;8919457259;Taip;0;0;1;1
16766;Saulutė;Meškiukai;5509365461;Taip;8;0;0;8
16767;Saulutė;Ežiukai;2813274509;Taip;11;0;2;13
16768;Saulutė;Ežiukai;3410606033;Ne;0;9;0;9
16769;Saulutė;Ežiukai;2315812734;Taip;13;0;1;14
16770;Saulutė;Ežiukai;2059342403;Ne;5;0;3;8
16771;Saulutė;Ežiukai;8736917541;Taip;4;0;0;4
16772;Saulutė;Ežiukai;5999318972;Taip;0;0;1;1
16773;Saulutė;Ežiukai;4363210987;Taip;0;0;2;2
16774;Saulutė;Ežiukai;5972503001;Taip;2;0;5;7
16775;Saulutė;Ežiukai;6884472677;Taip;7;0;3;10
16776;Saulutė;Ežiukai;4194586403;Taip;10;0;0;10
16777;Saulutė;Ežiukai;1853984777;Taip;11;0;4;15
16778;Saulutė;Ežiukai;1666301750;Ne;0;1;5;6
16779;Saulutė;Ežiukai;3133714991;Taip;0;13;1;14
16780;Saulutė;Ežiukai;4039065925;Ne;0;0;4;4
16781;Saulutė;Ežiukai;7967532537;Taip;4;0;1;5
16782;Saulutė;Ežiukai;1370201372;Taip;0;8;0;8
16783;Saulutė;Ežiukai;5335820652;Taip;4;0;0;4
16784;Saulutė;Ežiukai;2728669975;Taip;10;0;1;11
16785;Saulutė;Ežiukai;9892855816;Ne;5;0;1;6
16786;Saulutė;Ežiukai;9398356470;Taip;0;0;8;8
16787;Saulutė;Bitutės;5200638523;Taip;0;2;0;2
16788;Saulutė;Bitutės;5448950324;Taip;13;0;3;16
16789;Saulutė;Bitutės;4130972647;Taip;0;0;3;3
16790;Saulutė;Bitutės;3242810449;Taip;10;4;0;14
16791;Saulutė;Bitutės;7032417938;Ne;21;0;0;21
16792;Saulutė;Bitutės;5897526863;Taip;13;0;0;13
16793;Saulutė;Bitutės;1648978545;Taip;14;6;0;20
16794;Saulutė;Bitutės;6927834443;Taip;1;15;0;16
16795;Saulutė;Bitutės;8714520840;Ne;0;1;20;21
16796;Saulutė;Bitutės;9726675673;Taip;21;0;0;21
16797;Saulutė;Bitutės;8520474896;Taip;21;0;0;21
16798;Saulutė;Bitutės;6189637986;Taip;4;0;1;5
16799;Saulutė;Bitutės;7132125341;Taip;0;0;2;2
16800;Saulutė;Bitutės;3215349379;Taip;0;0;10;10
16801;Saulutė;Bitutės;3259790911;Taip;0;0;3;3
16802;Saulutė;Bitutės;7311594119;Taip;12;0;0;12
16803;Saulutė;Pelėdžiukai;8512137633;Taip;0;0;1;1
16804;Saulutė;Pelėdžiukai;2373409300;Taip;0;0;10;10
16805;Saulutė;Pelėdžiukai;8405262902;Taip;6;0;3;9
16806;Saulutė;Pelėdžiukai;4123500930;Ne;0;1;5;6
16807;Saulutė;Pelėdžiukai;1056158093;Taip;0;0;3;3
16808;Saulutė;Pelėdžiukai;8371366346;Taip;0;0;2;2
16809;Saulutė;Pelėdžiukai;6842585310;Taip;6;1;2;9
16810;Saulutė;Pelėdžiukai;1776164273;Taip;0;0;4;4
16811;Saulutė;Pelėdžiukai;5850783789;Taip;0;7;0;7
16812;Saulutė;Pelėdžiukai;6608003946;Taip;0;16;5;21
16813;Saulutė;Pelėdžiukai;7243072252;Taip;6;1;0;7
16814;Saulutė;Pelėdžiukai;9903380188;Taip;0;0;2;2
16815;Saulutė;Pelėdžiukai;6046611248;Taip;0;13;0;13
16816;Saulutė;Pelėdžiukai;4301516165;Taip;0;21;0;21
16817;Saulutė;Pelėdžiukai;2566263680;Ne;12;0;0;12
16818;Saulutė;Pelėdžiukai;9106119465;Ne;5;0;0;5
16819;Saulutė;Zylutės;3228226715;Taip;11;1;3;15
16820;Saulutė;Zylutės;8040751073;Ne;0;0;2;2
16821;Saulutė;Zylutės;2074473832;Taip;0;1;0;1
16822;Saulutė;Zylutės;8041118115;Taip;0;21;0;21
16823;Saulutė;Zylutės;5198558993;Taip;21;0;0;21
16824;Saulutė;Zylutės;6109527712;Ne;0;0;5;5
16825;Saulutė;Zylutės;4686825392;Taip;0;1;1;2
16826;Saulutė;Zylutės;7446423510;Taip;0;1;0;1
16827;Saulutė;Zylutės;8717210130;Taip;0;15;0;15
16828;Saulutė;Zylutės;2885398200;Taip;2;2;0;4
16829;Saulutė;Zylutės;9146298505;Ne;0;1;0;1
16830;Saulutė;Zylutės;1324799653;Taip;0;8;0;8
16831;Saulutė;Zylutės;3691381351;Taip;0;1;0;1
16832;Saulutė;Zylutės;2010774109;Taip;2;1;0;3
16833;Saulutė;Zylutės;1546200973;Taip;2;0;5;7
16834;Saulutė;Zylutės;8379304869;Ne;0;1;2;3
16835;Saulutė;Zylutės;66108847230;Taip;0;6;0;6
16836;Saulutė;Zylutės;95439358242;Ne;0;1;0;1
16837;Saulutė;Zylutės;9947607411;Ne;0;1;2;3
16838;Saulutė;Zylutės;3408369823;Taip;0;1;0;1
16839;Saulutė;"1 klasė";1717909005;Taip;2;1;0;3
16840;Saulutė;"1 klasė";87814849917;Taip;2;1;0;3
16841;Saulutė;"1 klasė";84919478493;Taip;2;1;0;3
16842;Saulutė;"1 klasė";1320018338;Taip;0;1;0;1
16843;Saulutė;"1 klasė";8599199376;Taip;0;1;0;1
16844;Saulutė;"1 klasė";8944601874;Taip;2;1;0;3
16845;Saulutė;"1 klasė";3064199909;Taip;4;1;0;5
16846;Saulutė;"1 klasė";1556270046;Taip;1;1;0;2
16847;Saulutė;"1 klasė";4272320685;Taip;1;1;0;2
16848;Saulutė;"1 klasė";1291318940;Taip;0;1;0;1
16849;Saulutė;"1 klasė";1391904744;Taip;0;1;0;1
16850;Saulutė;"1 klasė";6096297366;Ne;2;1;0;3
16851;Saulutė;"1 klasė";1609952589;Taip;0;1;0;1
16852;Saulutė;"1 klasė";1513449225;Taip;3;1;0;4
16853;Saulutė;"1 klasė";7281873166;Taip;4;1;0;5
16854;Saulutė;"1 klasė";1911318708;Taip;2;1;0;3
16855;Saulutė;"1 klasė";28772515317;Taip;1;1;0;2
16856;Saulutė;"1 klasė";1786491396;Taip;0;1;0;1
16857;Saulutė;"1 klasė";1332002470;Taip;0;1;0;1
16858;Saulutė;"1 klasė";16622528829;Taip;0;1;0;1
16859;Saulutė;"1 klasė";61073095949;Taip;0;1;0;1
16860;Saulutė;"1 klasė";3505492809;Taip;6;1;0;7
16861;Saulutė;"1 klasė";8952155496;Ne;0;1;0;1
16862;Saulutė;"1 klasė";9235972927;Taip;0;1;0;1
16863;Saulutė;"1 klasė";2677995903;Taip;0;1;0;1
16864;Saulutė;"1 klasė";1386800520;Ne;3;1;0;4
16865;Saulutė;"1 klasė";89920419797;Taip;1;1;0;2
16866;Saulutė;"2 klasė";45306237230;Taip;0;2;0;2
16867;Saulutė;"2 klasė";79438946697;Taip;0;1;0;1
16868;Saulutė;"2 klasė";79919438191;Ne;6;1;0;7
16869;Saulutė;"2 klasė";29074930927;Taip;10;1;0;11
16870;Saulutė;"2 klasė";8369703027;Taip;3;1;0;4
16871;Saulutė;"2 klasė";21605684303;Taip;2;1;0;3
16872;Saulutė;"2 klasė";31705050946;Taip;8;1;0;9
16873;Saulutė;"2 klasė";2622662153;Taip;5;1;0;6
16874;Saulutė;"2 klasė";9612975694;Taip;3;1;0;4
16875;Saulutė;"2 klasė";37315117916;Taip;0;1;0;1
16876;Saulutė;"2 klasė";3445723020;Ne;0;1;0;1
16877;Saulutė;"2 klasė";14195215027;Taip;12;1;0;13
16878;Saulutė;"2 klasė";2098990667;Taip;0;1;0;1
16879;Saulutė;"2 klasė";27386434894;Taip;0;1;0;1
16880;Saulutė;"2 klasė";77923802656;Taip;2;1;0;3
16881;Saulutė;"2 klasė";46280382280;Taip;3;1;0;4
16882;Saulutė;"2 klasė";1935503629;Taip;0;1;0;1
16883;Saulutė;"2 klasė";75405796772;Taip;2;1;0;3
16884;Saulutė;"2 klasė";1277263391;Taip;0;1;0;1
16885;Saulutė;"2 klasė";97145959022;Taip;4;1;0;5
16886;Saulutė;"2 klasė";64418469679;Taip;0;1;0;1
16887;Saulutė;"2 klasė";77170708225;Taip;4;1;0;5
16888;Saulutė;"2 klasė";4640909915;Ne;4;1;0;5
16889;Saulutė;"2 klasė";65492344097;Taip;0;1;0;1
16890;Saulutė;"2 klasė";1704733670;Ne;0;1;0;1
16891;Saulutė;"2 klasė";1534183935;Taip;0;1;0;1
16892;Saulutė;"2 klasė";5574049005;Taip;0;1;0;1
16893;Saulutė;"2 klasė";1510434265;Taip;5;1;0;6
16894;Saulutė;"3 klasė";1005459768;Taip;6;1;0;7
16895;Saulutė;"3 klasė";1804521229;Taip;1;1;0;2
16896;Saulutė;"3 klasė";76108591835;Ne;0;1;0;1
16897;Saulutė;"3 klasė";1475031090;Taip;4;1;0;5
16898;Saulutė;"3 klasė";3156830821;Taip;7;1;0;8
16899;Saulutė;"3 klasė";5741276602;Taip;0;1;0;1
16900;Saulutė;"3 klasė";3246485288;Taip;0;1;0;1
16901;Saulutė;"3 klasė";44452051978;Ne;0;1;0;1
16902;Saulutė;"3 klasė";78967475616;Ne;1;1;0;2
16903;Saulutė;"3 klasė";89710141573;Taip;0;1;0;1
16904;Saulutė;"3 klasė";25124975646;Taip;1;1;0;2
16905;Saulutė;"3 klasė";3450668814;Taip;3;1;0;4
16906;Saulutė;"3 klasė";8168961080;Ne;0;1;0;1
16907;Saulutė;"3 klasė";57283533169;Taip;0;1;0;1
16908;Saulutė;"3 klasė";76744652185;Taip;1;1;0;2
16909;Saulutė;"3 klasė";97296161595;Taip;1;1;0;2
16910;Saulutė;"3 klasė";87409240076;Taip;0;1;0;1
16911;Saulutė;"3 klasė";1205642335;Taip;3;1;0;4
16912;Saulutė;"3 klasė";2426509692;Ne;5;1;0;6
16913;Saulutė;"3 klasė";36414547943;Taip;0;1;0;1
16914;Saulutė;"3 klasė";99841176399;Taip;1;1;0;2
16915;Saulutė;"3 klasė";21703177024;Taip;1;1;0;2
16916;Saulutė;"3 klasė";1337654926;Taip;3;1;0;4
16917;Saulutė;"3 klasė";54950572289;Taip;1;1;0;2
16918;Saulutė;"3 klasė";13147367113;Taip;0;1;0;1
16919;Saulutė;"3 klasė";2216383015;Taip;0;1;0;1
16920;Saulutė;"3 klasė";1644704074;Taip;0;1;0;1
16921;Saulutė;"3 klasė";96497471950;Taip;3;1;0;4
16922;Saulutė;"3 klasė";6557918941;Ne;0;1;0;1
16923;Saulutė;"4 klasė";5822529731;Taip;2;1;0;3
16924;Saulutė;"4 klasė";67739063665;Ne;5;1;0;6
16925;Saulutė;"4 klasė";13916981850;Taip;1;1;0;2
16926;Saulutė;"4 klasė";39606108938;Ne;1;1;0;2
16927;Saulutė;"4 klasė";81191097069;Taip;2;1;0;3
16928;Saulutė;"4 klasė";92198716772;Taip;6;1;0;7
16929;Saulutė;"4 klasė";16523279366;Taip;1;1;0;2
16930;Saulutė;"4 klasė";2262536579;Taip;10;1;0;11
16931;Saulutė;"4 klasė";2095347468;Ne;3;1;0;4
16932;Saulutė;"4 klasė";2819521168;Taip;0;1;0;1
16933;Saulutė;"4 klasė";37839378248;Taip;2;1;0;3
16934;Saulutė;"4 klasė";8308288099;Ne;0;1;0;1
16935;Saulutė;"4 klasė";30863736694;Taip;6;1;0;7
16936;Saulutė;"4 klasė";12964000357;Taip;1;1;0;2
16937;Saulutė;"4 klasė";54726632101;Taip;0;1;0;1
16938;Saulutė;"4 klasė";25720655179;Taip;0;1;0;1
16939;Saulutė;"4 klasė";45877127245;Taip;1;1;0;2
16940;Saulutė;"4 klasė";82106514982;Taip;0;1;0;1
16941;Saulutė;"4 klasė";61113930769;Taip;0;1;0;1
16942;Saulutė;"4 klasė";5213320470;Ne;8;1;0;9
16943;Saulutė;"4 klasė";90078805222;Taip;0;1;0;1
16944;Saulutė;"4 klasė";50110262859;Taip;4;1;0;5
16945;Saulutė;"4 klasė";42204884890;Ne;5;1;0;6
16946;Svaja;SAULĖGRĄŽA;4189290919;Taip;0;21;0;21
16947;Svaja;SAULĖGRĄŽA;4333001830;Taip;2;0;0;2
16948;Svaja;SAULĖGRĄŽA;1579441289;Taip;0;0;1;1
16949;Svaja;SAULĖGRĄŽA;9811110367;Taip;0;0;1;1
16950;Svaja;SAULĖGRĄŽA;3912426942;Taip;4;0;1;5
16951;Svaja;SAULĖGRĄŽA;9680766688;Taip;9;0;1;10
16952;Svaja;SAULĖGRĄŽA;3809817617;Ne;7;0;1;8
16953;Svaja;SAULĖGRĄŽA;3792660330;Taip;6;1;0;7
16954;Svaja;SAULĖGRĄŽA;3563842321;Taip;1;0;1;2
16955;Svaja;SAULĖGRĄŽA;4253831334;Taip;4;2;0;6
16956;Svaja;SAULĖGRĄŽA;3461282516;Taip;10;0;2;12
16957;Svaja;SAULĖGRĄŽA;9240037050;Taip;13;0;0;13
16958;Svaja;SAULĖGRĄŽA;7089640807;Taip;7;3;0;10
16959;Svaja;SAULĖGRĄŽA;6963684639;Taip;0;6;0;6
16960;Svaja;SAULĖGRĄŽA;4510147045;Taip;0;8;0;8
16961;Svaja;SAULĖGRĄŽA;6928763381;Taip;4;0;4;8
16962;Svaja;SAULĖGRĄŽA;3501620040;Taip;2;9;1;12
16963;Svaja;SAULĖGRĄŽA;7575922215;Taip;5;0;1;6
16964;Svaja;SAULĖGRĄŽA;7408966637;Taip;0;2;2;4
16965;Svaja;SAULĖGRĄŽA;7747251736;Taip;0;0;1;1
16966;Svaja;"STEBUKLINGAS ŽIBINTAS";9814969596;Taip;7;1;11;19
16967;Svaja;"STEBUKLINGAS ŽIBINTAS";2200408537;Taip;0;0;2;2
16968;Svaja;"STEBUKLINGAS ŽIBINTAS";3940123543;Taip;5;1;2;8
16969;Svaja;"STEBUKLINGAS ŽIBINTAS";9843726794;Taip;0;1;2;3
16970;Svaja;"STEBUKLINGAS ŽIBINTAS";4237592104;Ne;18;0;0;18
16971;Svaja;"STEBUKLINGAS ŽIBINTAS";2658828200;Taip;0;1;1;2
16972;Svaja;"STEBUKLINGAS ŽIBINTAS";4290716676;Taip;16;0;0;16
16973;Svaja;"STEBUKLINGAS ŽIBINTAS";1558093905;Taip;0;1;2;3
16974;Svaja;"STEBUKLINGAS ŽIBINTAS";9102872020;Taip;6;0;0;6
16975;Svaja;"STEBUKLINGAS ŽIBINTAS";8827421660;Taip;0;3;0;3
16976;Svaja;"STEBUKLINGAS ŽIBINTAS";7277217069;Taip;7;1;0;8
16977;Svaja;"STEBUKLINGAS ŽIBINTAS";9259478140;Ne;0;0;2;2
16978;Svaja;"STEBUKLINGAS ŽIBINTAS";1050291871;Ne;10;1;0;11
16979;Svaja;"STEBUKLINGAS ŽIBINTAS";2188430052;Taip;11;0;0;11
16980;Svaja;"STEBUKLINGAS ŽIBINTAS";1860076171;Ne;7;0;3;10
16981;Svaja;"STEBUKLINGAS ŽIBINTAS";8363418532;Taip;7;0;4;11
16982;Svaja;"STEBUKLINGAS ŽIBINTAS";8172396846;Taip;11;0;2;13
16983;Svaja;"STEBUKLINGAS ŽIBINTAS";9545690301;Taip;3;1;1;5
16984;Svaja;"STEBUKLINGAS ŽIBINTAS";4004383843;Taip;0;2;0;2
16985;Svaja;"STEBUKLINGAS ŽIBINTAS";6128350581;Taip;5;1;0;6
16986;Svaja;"STEBUKLINGAS ŽIBINTAS";1150040935;Taip;0;9;2;11
16987;Svaja;SAULUTĖ;50207734108;Ne;0;1;0;1
16988;Svaja;SAULUTĖ;20473739993;Taip;1;0;0;1
16989;Svaja;SAULUTĖ;30719991872;Ne;8;0;1;9
16990;Svaja;SAULUTĖ;4968201186;Ne;0;6;0;6
16991;Svaja;SAULUTĖ;8689706130;Taip;6;2;0;8
16992;Svaja;SAULUTĖ;6807834176;Taip;0;1;2;3
16993;Svaja;SAULUTĖ;7020342969;Taip;5;3;0;8
16994;Svaja;SAULUTĖ;3633996231;Taip;0;0;1;1
16995;Svaja;SAULUTĖ;2750615517;Taip;8;0;0;8
16996;Svaja;SAULUTĖ;3049808328;Ne;8;0;0;8
16997;Svaja;SAULUTĖ;4341042027;Taip;0;1;0;1
16998;Svaja;SAULUTĖ;3802996573;Ne;6;0;5;11
16999;Svaja;SAULUTĖ;7936765752;Taip;0;1;0;1
17000;Svaja;SAULUTĖ;4293339784;Taip;10;2;1;13
17001;Svaja;SAULUTĖ;5479482244;Ne;11;0;0;11
17002;Svaja;SAULUTĖ;7473493846;Taip;9;0;0;9
17003;Svaja;SAULUTĖ;5443682744;Taip;5;1;0;6
17004;Svaja;SAULUTĖ;9112198914;Taip;0;1;1;2
17005;Svaja;SAULUTĖ;2166382346;Ne;0;1;0;1
17006;Svaja;SAULUTĖ;8656417794;Taip;0;1;1;2
17007;Svaja;SAULUTĖ;1377813636;Taip;5;0;2;7
17008;Svaja;"AUKSINĖ ŽUVELĖ";9091970902;Taip;0;0;1;1
17009;Svaja;"AUKSINĖ ŽUVELĖ";9826552657;Ne;0;0;2;2
17010;Svaja;"AUKSINĖ ŽUVELĖ";6028471687;Taip;0;0;3;3
17011;Svaja;"AUKSINĖ ŽUVELĖ";1877749103;Taip;8;2;0;10
17012;Svaja;"AUKSINĖ ŽUVELĖ";5033214011;Taip;15;0;0;15
17013;Svaja;"AUKSINĖ ŽUVELĖ";5224855138;Taip;0;0;1;1
17014;Svaja;"AUKSINĖ ŽUVELĖ";5908440171;Taip;0;0;2;2
17015;Svaja;"AUKSINĖ ŽUVELĖ";5230444195;Taip;5;0;2;7
17016;Svaja;"AUKSINĖ ŽUVELĖ";1914129062;Taip;11;0;1;12
17017;Svaja;"AUKSINĖ ŽUVELĖ";3567924341;Taip;11;0;3;14
17018;Svaja;"AUKSINĖ ŽUVELĖ";2427918378;Taip;5;0;1;6
17019;Svaja;"AUKSINĖ ŽUVELĖ";3377044908;Taip;10;0;2;12
17020;Svaja;"AUKSINĖ ŽUVELĖ";7605002899;Taip;0;0;5;5
17021;Svaja;"AUKSINĖ ŽUVELĖ";5198482539;Taip;8;1;0;9
17022;Svaja;"AUKSINĖ ŽUVELĖ";7562678317;Taip;11;0;1;12
17023;Svaja;"AUKSINĖ ŽUVELĖ";2641473764;Taip;3;0;0;3
17024;Svaja;"AUKSINĖ ŽUVELĖ";7434898745;Taip;0;1;0;1
17025;Svaja;"PRIE ĮLANKOS";5595087767;Taip;0;1;1;2
17026;Svaja;"PRIE ĮLANKOS";8503177793;Taip;1;0;0;1
17027;Svaja;"PRIE ĮLANKOS";1633236289;Taip;7;5;0;12
17028;Svaja;"PRIE ĮLANKOS";9414846817;Taip;8;0;2;10
17029;Svaja;"PRIE ĮLANKOS";9311520300;Taip;5;0;1;6
17030;Svaja;"PRIE ĮLANKOS";9864664937;Taip;0;1;0;1
17031;Svaja;"PRIE ĮLANKOS";4014493868;Taip;2;2;0;4
17032;Svaja;"PRIE ĮLANKOS";6388514464;Taip;2;2;0;4
17033;Svaja;"PRIE ĮLANKOS";5862570666;Taip;7;0;0;7
17034;Svaja;"PRIE ĮLANKOS";2018689468;Taip;0;1;0;1
17035;Svaja;"PRIE ĮLANKOS";3459060550;Taip;15;0;0;15
17036;Svaja;"PRIE ĮLANKOS";1392455608;Taip;0;1;0;1
17037;Svaja;"PRIE ĮLANKOS";1617844709;Taip;10;0;2;12
17038;Svaja;"PRIE ĮLANKOS";3458374439;Taip;0;0;1;1
17039;Svaja;"PRIE ĮLANKOS";1044733634;Taip;0;1;1;2
17040;Svaja;"PRIE ĮLANKOS";6676145522;Ne;0;3;0;3
17041;Svaja;"PRIE ĮLANKOS";1671495181;Taip;0;1;0;1
17042;Svaja;"PRIE ĮLANKOS";9950569499;Taip;6;0;0;6
17043;Svaja;"PRIE ĮLANKOS";4284157599;Taip;2;0;0;2
17044;Svaja;"PRIE ĮLANKOS";3868254757;Taip;5;0;0;5
17045;Svaja;"PRIE ĮLANKOS";6361228838;Taip;8;0;0;8
17046;Svaja;"PRIE ĮLANKOS";7514587933;Ne;15;1;1;17
17047;Svaja;"1 B klasė";24863928147;Taip;0;1;0;1
17048;Svaja;"1 B klasė";1865658456;Taip;0;6;0;6
17049;Svaja;"1 B klasė";8279605005;Taip;0;21;0;21
17050;Svaja;"1 B klasė";55925058866;Taip;0;21;0;21
17051;Svaja;"1 B klasė";1437557657;Taip;0;2;0;2
17052;Svaja;"1 B klasė";25194696146;Taip;0;11;0;11
17053;Svaja;"1 B klasė";1704075006;Taip;0;3;0;3
17054;Svaja;"1 B klasė";8875237023;Taip;0;1;0;1
17055;Svaja;"1 B klasė";64196174690;Taip;0;21;0;21
17056;Svaja;"1 B klasė";8491275729;Taip;0;2;0;2
17057;Svaja;"1 B klasė";21871530266;Taip;0;1;0;1
17058;Svaja;"1 B klasė";7753488216;Taip;0;1;0;1
17059;Svaja;"1 B klasė";36505115395;Taip;0;21;0;21
17060;Svaja;"1 B klasė";7911488445;Taip;0;1;0;1
17061;Svaja;"1 B klasė";6593047776;Taip;0;3;0;3
17062;Svaja;"1 B klasė";15159708127;Taip;0;16;0;16
17063;Svaja;"1 B klasė";2985196852;Taip;0;3;0;3
17064;Svaja;"1 B klasė";9110985103;Taip;0;9;0;9
17065;Svaja;"1 B klasė";3562817807;Taip;0;10;0;10
17066;Svaja;"1 B klasė";2069150261;Ne;0;4;0;4
17067;Svaja;"1 B klasė";1191494598;Taip;0;1;0;1
17068;Svaja;"1 B klasė";11671380984;Taip;0;3;0;3
17069;Svaja;"1 B klasė";99183628764;Taip;0;3;0;3
17070;Svaja;"1 B klasė";1369637618;Taip;0;1;0;1
17071;Svaja;"1 B klasė";3660152224;Taip;0;1;0;1
17072;Svaja;"1 A klasė";5337604370;Taip;0;1;0;1
17073;Svaja;"1 A klasė";1046879533;Taip;0;1;0;1
17074;Svaja;"1 A klasė";2147266053;Taip;0;1;0;1
17075;Svaja;"1 A klasė";4846025153;Taip;0;2;0;2
17076;Svaja;"1 A klasė";1714711904;Taip;0;5;0;5
17077;Svaja;"1 A klasė";47457128214;Taip;0;3;0;3
17078;Svaja;"1 A klasė";65917456866;Ne;0;1;0;1
17079;Svaja;"1 A klasė";1197826066;Taip;0;1;0;1
17080;Svaja;"1 A klasė";73679997517;Taip;0;21;0;21
17081;Svaja;"1 A klasė";7669562010;Ne;0;2;0;2
17082;Svaja;"1 A klasė";5335776957;Taip;0;21;0;21
17083;Svaja;"1 A klasė";56117509354;Taip;0;2;0;2
17084;Svaja;"1 A klasė";27445299450;Taip;0;2;0;2
17085;Svaja;"1 A klasė";1576498450;Taip;0;4;0;4
17086;Svaja;"1 A klasė";43307670660;Taip;0;1;0;1
17087;Svaja;"1 A klasė";22702341083;Taip;0;9;0;9
17088;Svaja;"1 A klasė";70641067006;Taip;0;1;0;1
17089;Svaja;"1 A klasė";58102699652;Taip;0;4;0;4
17090;Svaja;"1 A klasė";2076060840;Taip;0;1;0;1
17091;Svaja;"1 A klasė";4900757614;Taip;0;3;0;3
17092;Svaja;"1 A klasė";1061894314;Taip;0;8;0;8
17093;Svaja;"1 A klasė";8697355813;Ne;0;5;0;5
17094;Svaja;"1 A klasė";193181908;Ne;0;1;0;1
17095;Svaja;"1 A klasė";193181908;Ne;0;1;0;1
17096;Svaja;"2 A klasė";9628146488;Ne;0;6;0;6
17097;Svaja;"2 A klasė";1562041360;Taip;0;2;0;2
17098;Svaja;"2 A klasė";43223177664;Taip;0;2;0;2
17099;Svaja;"2 A klasė";1017471747;Taip;0;1;0;1
17100;Svaja;"2 A klasė";26500981786;Taip;0;3;0;3
17101;Svaja;"2 A klasė";5522433229;Ne;0;6;0;6
17102;Svaja;"2 A klasė";1400892707;Taip;0;1;0;1
17103;Svaja;"2 A klasė";30027404222;Taip;0;1;0;1
17104;Svaja;"2 A klasė";23112873505;Taip;0;1;0;1
17105;Svaja;"2 A klasė";15246943974;Ne;0;2;0;2
17106;Svaja;"2 A klasė";1297727288;Taip;0;1;0;1
17107;Svaja;"2 A klasė";1304775332;Taip;0;1;0;1
17108;Svaja;"2 A klasė";8198614500;Taip;0;7;0;7
17109;Svaja;"2 A klasė";67462299886;Taip;0;5;0;5
17110;Svaja;"2 A klasė";40856210635;Taip;0;1;0;1
17111;Svaja;"2 A klasė";18733824395;Taip;0;1;0;1
17112;Svaja;"2 A klasė";84508228457;Taip;0;1;0;1
17113;Svaja;"2 A klasė";2058827699;Taip;0;1;0;1
17114;Svaja;"2 A klasė";1352488176;Taip;0;1;0;1
17115;Svaja;"2 A klasė";1660742385;Taip;0;1;0;1
17116;Svaja;"2 A klasė";89042677798;Taip;0;1;0;1
17117;Svaja;"2 A klasė";26902749194;Taip;0;3;0;3
17118;Svaja;"2 A klasė";3022690832;Taip;0;1;0;1
17119;Svaja;"2 A klasė";1943166503;Taip;0;4;0;4
17120;Svaja;"2 A klasė";1048576329;Taip;0;1;0;1
17121;Svaja;"2 B klasė";4804779327;Taip;0;1;0;1
17122;Svaja;"2 B klasė";7719185632;Taip;0;2;0;2
17123;Svaja;"2 B klasė";69028070656;Taip;0;5;0;5
17124;Svaja;"2 B klasė";54745410330;Taip;0;8;0;8
17125;Svaja;"2 B klasė";30036722764;Taip;5;1;0;6
17126;Svaja;"2 B klasė";1509272327;Taip;0;1;0;1
17127;Svaja;"2 B klasė";1601648171;Ne;0;5;0;5
17128;Svaja;"2 B klasė";89316574266;Taip;0;1;0;1
17129;Svaja;"2 B klasė";78293798850;Taip;0;1;0;1
17130;Svaja;"2 B klasė";40814723278;Taip;0;1;0;1
17131;Svaja;"2 B klasė";1967394949;Taip;0;4;0;4
17132;Svaja;"2 B klasė";4881476441;Taip;0;1;0;1
17133;Svaja;"2 B klasė";87432529423;Taip;0;1;0;1
17134;Svaja;"2 B klasė";19887874988;Ne;0;1;0;1
17135;Svaja;"2 B klasė";69413101571;Taip;0;1;0;1
17136;Svaja;"2 B klasė";57216954289;Taip;0;7;0;7
17137;Svaja;"2 B klasė";1655551042;Taip;0;1;0;1
17138;Svaja;"2 B klasė";76618850202;Taip;0;2;0;2
17139;Svaja;"2 B klasė";21608020858;Taip;0;1;0;1
17140;Svaja;"2 B klasė";3077814152;Taip;0;1;0;1
17141;Svaja;"2 B klasė";809734624;Taip;0;1;0;1
17142;Svaja;"2 B klasė";44989143252;Taip;0;6;0;6
17143;Svaja;"2 B klasė";6056157113;Taip;0;3;0;3
17144;Svaja;"2 B klasė";30360097999;Taip;0;1;0;1
17145;Svaja;"2 B klasė";1378219785;Taip;0;1;0;1
17146;Svaja;"3 A klasė";72752022712;Taip;0;3;0;3
17147;Svaja;"3 A klasė";8828911320;Taip;0;1;0;1
17148;Svaja;"3 A klasė";60448774566;Taip;0;4;0;4
17149;Svaja;"3 A klasė";75104768118;Taip;0;7;0;7
17150;Svaja;"3 A klasė";1649920341;Taip;0;1;0;1
17151;Svaja;"3 A klasė";30754812113;Taip;0;1;0;1
17152;Svaja;"3 A klasė";64487515384;Taip;0;21;0;21
17153;Svaja;"3 A klasė";34216516886;Taip;0;1;0;1
17154;Svaja;"3 A klasė";3474439050;Taip;0;7;0;7
17155;Svaja;"3 A klasė";63346231562;Taip;0;21;0;21
17156;Svaja;"3 A klasė";75296600945;Ne;0;1;0;1
17157;Svaja;"3 A klasė";6057524892;Taip;0;21;0;21
17158;Svaja;"3 A klasė";2321739150;Ne;0;2;0;2
17159;Svaja;"3 A klasė";4617061890;Ne;4;3;0;7
17160;Svaja;"3 A klasė";89695643588;Taip;0;5;0;5
17161;Svaja;"3 A klasė";3604946305;Taip;0;21;0;21
17162;Svaja;"3 A klasė";25578518444;Taip;0;3;0;3
17163;Svaja;"3 A klasė";1168637823;Taip;0;1;0;1
17164;Svaja;"3 A klasė";4906784415;Taip;0;1;0;1
17165;Svaja;"3 A klasė";15252353189;Taip;0;1;0;1
17166;Svaja;"3 B klasė";6905550313;Ne;0;21;0;21
17167;Svaja;"3 B klasė";62971657427;Taip;0;1;0;1
17168;Svaja;"3 B klasė";1367687415;Taip;0;4;0;4
17169;Svaja;"3 B klasė";4416877973;Taip;0;1;0;1
17170;Svaja;"3 B klasė";1847775266;Taip;0;21;0;21
17171;Svaja;"3 B klasė";17947580061;Taip;0;1;0;1
17172;Svaja;"3 B klasė";6969692916;Taip;0;2;0;2
17173;Svaja;"3 B klasė";44418402260;Taip;0;1;0;1
17174;Svaja;"3 B klasė";50649509868;Taip;0;1;0;1
17175;Svaja;"3 B klasė";73391331150;Taip;0;1;0;1
17176;Svaja;"3 B klasė";70507326327;Taip;0;21;0;21
17177;Svaja;"3 B klasė";80772711351;Taip;0;1;0;1
17178;Svaja;"3 B klasė";54328462992;Taip;0;21;0;21
17179;Svaja;"3 B klasė";1470843400;Taip;0;1;0;1
17180;Svaja;"3 B klasė";92044111261;Taip;0;1;0;1
17181;Svaja;"3 B klasė";11937575740;Taip;0;1;0;1
17182;Svaja;"3 B klasė";8011137572;Taip;0;2;0;2
17183;Svaja;"3 B klasė";71708072632;Taip;0;2;0;2
17184;Svaja;"3 B klasė";56506642672;Taip;0;1;0;1
17185;Svaja;"3 B klasė";3526873547;Ne;0;21;0;21
17186;Svaja;"3 B klasė";70506691027;Taip;0;21;0;21
17187;Svaja;"3 B klasė";4282243865;Taip;0;21;0;21
17188;Svaja;"4 A klasė";96680395594;Taip;0;5;0;5
17189;Svaja;"4 A klasė";31604152893;Ne;0;1;0;1
17190;Svaja;"4 A klasė";70513111186;Ne;0;1;0;1
17191;Svaja;"4 A klasė";72655912805;Taip;0;14;0;14
17192;Svaja;"4 A klasė";20363553383;Taip;0;4;0;4
17193;Svaja;"4 A klasė";8876971658;Taip;0;11;0;11
17194;Svaja;"4 A klasė";69928474471;Taip;0;1;0;1
17195;Svaja;"4 A klasė";49184638535;Taip;0;21;0;21
17196;Svaja;"4 A klasė";3775578708;Taip;0;1;0;1
17197;Svaja;"4 A klasė";58497063533;Taip;0;6;0;6
17198;Svaja;"4 A klasė";89075087937;Taip;0;21;0;21
17199;Svaja;"4 A klasė";99157757025;Ne;0;1;0;1
17200;Svaja;"4 A klasė";16955510836;Ne;0;5;0;5
17201;Svaja;"4 A klasė";24812635291;Taip;0;1;0;1
17202;Svaja;"4 A klasė";21534170175;Taip;0;1;0;1
17203;Svaja;"4 A klasė";28311552445;Ne;0;6;0;6
17204;Svaja;"4 A klasė";38781141060;Taip;0;1;0;1
17205;Svaja;"4 A klasė";88447528808;Taip;0;1;0;1
17206;Svaja;"4 A klasė";66507774550;Taip;0;5;0;5
17207;Svaja;"4 A klasė";76101749947;Taip;0;21;0;21
17208;Svaja;"4 A klasė";18432518932;Taip;0;4;0;4
17209;Svaja;"4 B klasė";61996055386;Taip;0;21;0;21
17210;Svaja;"4 B klasė";57983452414;Taip;0;21;0;21
17211;Svaja;"4 B klasė";30200636424;Ne;0;21;0;21
17212;Svaja;"4 B klasė";8802243719;Taip;0;21;0;21
17213;Svaja;"4 B klasė";7747921362;Taip;0;21;0;21
17214;Svaja;"4 B klasė";38464012322;Taip;0;6;0;6
17215;Svaja;"4 B klasė";5712106350;Taip;0;1;0;1
17216;Svaja;"4 B klasė";9401605132;Taip;0;3;0;3
17217;Svaja;"4 B klasė";27313057222;Ne;0;21;0;21
17218;Svaja;"4 B klasė";68894832324;Taip;0;21;0;21
17219;Svaja;"4 B klasė";29972474690;Taip;0;21;0;21
17220;Svaja;"4 B klasė";47441661801;Ne;0;1;0;1
17221;Svaja;"4 B klasė";62579722313;Taip;0;5;0;5
17222;Svaja;"4 B klasė";21035820496;Taip;0;21;0;21
17223;Svaja;"4 B klasė";71840791098;Taip;0;6;0;6
17224;Svaja;"4 B klasė";59707838958;Taip;0;21;0;21
17225;Svaja;"4 B klasė";71086654007;Taip;0;21;0;21
17226;Svaja;"4 B klasė";15871540340;Taip;0;21;0;21
17227;Svaja;"4 B klasė";97651620085;Taip;0;1;0;1
17228;Svaja;"4 B klasė";77796846388;Taip;0;21;0;21
17229;Svaja;"4 C klasė";79260508923;Taip;0;21;0;21
17230;Svaja;"4 C klasė";94437606762;Taip;0;21;0;21
17231;Svaja;"4 C klasė";73440582394;Taip;0;21;0;21
17232;Svaja;"4 C klasė";60982723867;Taip;0;21;0;21
17233;Svaja;"4 C klasė";70157518595;Taip;0;21;0;21
17234;Svaja;"4 C klasė";5975083034;Taip;0;21;0;21
17235;Svaja;"4 C klasė";76871144487;Taip;0;21;0;21
17236;Svaja;"4 C klasė";6613028133;Taip;0;21;0;21
17237;Svaja;"4 C klasė";48888360976;Taip;0;2;0;2
17238;Svaja;"4 C klasė";12226488343;Taip;0;21;0;21
17239;Svaja;"4 C klasė";3909240894;Taip;0;3;0;3
17240;Svaja;"4 C klasė";53352329988;Taip;0;1;0;1
17241;Svaja;"4 C klasė";59917024948;Taip;0;1;0;1
17242;Svaja;"4 C klasė";73691352138;Ne;0;1;0;1
17243;Svaja;"4 C klasė";66967032561;Taip;0;3;0;3
17244;Svaja;"4 C klasė";77712240909;Taip;0;1;0;1
17245;Svaja;"4 C klasė";82358174131;Taip;0;1;0;1
17246;Svaja;"4 C klasė";25585032766;Taip;0;21;0;21
17247;Svaja;"4 C klasė";79572045341;Taip;0;21;0;21
17248;Svaja;"3 C klasė";1848422504;Taip;0;10;0;10
17249;Svaja;"3 C klasė";3743948734;Taip;0;9;0;9
17250;Svaja;"3 C klasė";25934507261;Ne;0;6;0;6
17251;Svaja;"3 C klasė";89047123808;Taip;0;13;0;13
17252;Svaja;"3 C klasė";74904581010;Taip;0;21;0;21
17253;Svaja;"3 C klasė";50510924690;Taip;0;1;0;1
17254;Svaja;"3 C klasė";41183537732;Taip;0;8;0;8
17255;Svaja;"3 C klasė";70714898590;Taip;0;1;0;1
17256;Svaja;"3 C klasė";54852358913;Ne;0;21;0;21
17257;Svaja;"3 C klasė";57253216255;Taip;0;3;0;3
17258;Svaja;"3 C klasė";34995551069;Taip;0;21;0;21
17259;Svaja;"3 C klasė";1795682827;Taip;0;3;0;3
17260;Svaja;"3 C klasė";93651139102;Taip;0;1;0;1
17261;Svaja;"3 C klasė";1742951527;Taip;0;2;0;2
17262;Svaja;"3 C klasė";91855230473;Taip;0;6;0;6
17263;Svaja;"3 C klasė";1855559693;Taip;0;21;0;21
17264;Svaja;"3 C klasė";2165716699;Taip;0;8;0;8
17265;Svaja;"3 C klasė";31216445971;Ne;0;21;0;21
17266;Svaja;"3 C klasė";20342193231;Taip;0;1;0;1
17267;Svaja;"3 C klasė";54462393937;Taip;0;4;0;4
17268;Svaja;"3 C klasė";36001411632;Taip;0;2;0;2
17269;Svaja;"3 C klasė";94449039022;Taip;0;21;0;21
17270;Svaja;"3 C klasė";85150525696;Taip;0;1;0;1
17271;Svaja;"3 C klasė";91088224294;Taip;0;2;0;2
17272;Šilelis;PAUKŠTELIAI;6128379060;Taip;7;3;0;10
17273;Šilelis;PAUKŠTELIAI;9653439873;Taip;8;1;0;9
17274;Šilelis;PAUKŠTELIAI;2823486581;Taip;0;3;0;3
17275;Šilelis;PAUKŠTELIAI;6369443270;Taip;0;6;0;6
17276;Šilelis;PAUKŠTELIAI;7595774842;Taip;0;0;1;1
17277;Šilelis;PAUKŠTELIAI;6614686867;Taip;12;0;1;13
17278;Šilelis;PAUKŠTELIAI;3053443777;Taip;8;0;1;9
17279;Šilelis;PAUKŠTELIAI;4960501068;Taip;6;10;0;16
17280;Šilelis;PAUKŠTELIAI;7072057348;Taip;3;2;0;5
17281;Šilelis;PAUKŠTELIAI;5974537364;Taip;9;8;0;17
17282;Šilelis;PAUKŠTELIAI;8166061969;Taip;1;0;0;1
17283;Šilelis;PAUKŠTELIAI;2051644210;Taip;1;0;5;6
17284;Šilelis;PAUKŠTELIAI;1124854378;Taip;4;1;0;5
17285;Šilelis;PAUKŠTELIAI;8184170908;Taip;2;0;1;3
17286;Šilelis;PAUKŠTELIAI;7197420388;Ne;10;5;0;15
17287;Šilelis;PAUKŠTELIAI;9107920165;Ne;10;5;0;15
17288;Šilelis;PAUKŠTELIAI;4432542988;Taip;5;1;0;6
17289;Šilelis;PAUKŠTELIAI;6852463814;Ne;5;7;0;12
17290;Šilelis;PAUKŠTELIAI;9799198904;Taip;0;0;3;3
17291;Šilelis;PAUKŠTELIAI;5493811298;Taip;4;0;0;4
17292;Šilelis;SKRUZDELIUKAI;7502057552;Taip;0;1;0;1
17293;Šilelis;SKRUZDELIUKAI;6099940488;Taip;6;0;0;6
17294;Šilelis;SKRUZDELIUKAI;6139976105;Ne;0;5;0;5
17295;Šilelis;SKRUZDELIUKAI;3823958567;Taip;0;5;0;5
17296;Šilelis;SKRUZDELIUKAI;1887013803;Taip;0;1;2;3
17297;Šilelis;SKRUZDELIUKAI;6359318134;Taip;0;1;0;1
17298;Šilelis;SKRUZDELIUKAI;5598152793;Ne;8;0;0;8
17299;Šilelis;SKRUZDELIUKAI;8090773379;Taip;5;3;0;8
17300;Šilelis;SKRUZDELIUKAI;1200024379;Ne;0;0;1;1
17301;Šilelis;SKRUZDELIUKAI;7299084520;Taip;0;3;0;3
17302;Šilelis;SKRUZDELIUKAI;8578620603;Taip;0;0;1;1
17303;Šilelis;SKRUZDELIUKAI;9589138527;Taip;19;0;0;19
17304;Šilelis;SKRUZDELIUKAI;3967932407;Taip;0;4;0;4
17305;Šilelis;SKRUZDELIUKAI;4629917226;Taip;0;1;0;1
17306;Šilelis;SKRUZDELIUKAI;2972202874;Ne;1;4;0;5
17307;Šilelis;SKRUZDELIUKAI;9461117894;Taip;10;1;0;11
17308;Šilelis;SKRUZDELIUKAI;5817818596;Taip;1;0;4;5
17309;Šilelis;SKRUZDELIUKAI;5091571136;Ne;0;4;0;4
17310;Šilelis;SKRUZDELIUKAI;8297975308;Taip;0;6;0;6
17311;Šilelis;SKRUZDELIUKAI;3381053227;Taip;3;7;0;10
17312;Šilelis;SKRUZDELIUKAI;9276607554;Ne;0;1;0;1
17313;Šilelis;SMERFY;3247333567;Taip;0;5;0;5
17314;Šilelis;SMERFY;6999088222;Taip;9;1;0;10
17315;Šilelis;SMERFY;3089270468;Taip;0;5;0;5
17316;Šilelis;SMERFY;7824279279;Ne;0;3;0;3
17317;Šilelis;SMERFY;4504627601;Taip;4;1;0;5
17318;Šilelis;SMERFY;7534468539;Taip;0;1;1;2
17319;Šilelis;SMERFY;6390855924;Ne;0;5;0;5
17320;Šilelis;SMERFY;1821827154;Taip;1;1;1;3
17321;Šilelis;SMERFY;4196893379;Taip;0;7;0;7
17322;Šilelis;SMERFY;1890114622;Taip;8;1;0;9
17323;Šilelis;SMERFY;5025956218;Taip;9;1;0;10
17324;Šilelis;EŽIUKAI;9266061396;Taip;5;0;2;7
17325;Šilelis;EŽIUKAI;4494932923;Taip;0;0;2;2
17326;Šilelis;EŽIUKAI;7074963804;Taip;0;5;0;5
17327;Šilelis;EŽIUKAI;1165219272;Taip;0;5;0;5
17328;Šilelis;EŽIUKAI;4702068672;Taip;0;1;0;1
17329;Šilelis;EŽIUKAI;2295849333;Taip;0;4;0;4
17330;Šilelis;EŽIUKAI;1883483049;Taip;0;2;0;2
17331;Šilelis;EŽIUKAI;6854997486;Ne;4;0;0;4
17332;Šilelis;EŽIUKAI;6386996498;Taip;0;3;2;5
17333;Šilelis;EŽIUKAI;4822495270;Taip;4;0;1;5
17334;Šilelis;EŽIUKAI;2681063256;Taip;0;0;3;3
17335;Šilelis;EŽIUKAI;7208757038;Taip;8;0;3;11
17336;Šilelis;NYKŠTUKAI;3046954717;Taip;5;0;1;6
17337;Šilelis;NYKŠTUKAI;3158708835;Taip;9;1;0;10
17338;Šilelis;NYKŠTUKAI;6195580698;Taip;6;0;3;9
17339;Šilelis;NYKŠTUKAI;6107771932;Taip;4;1;0;5
17340;Šilelis;NYKŠTUKAI;4323998445;Taip;0;0;1;1
17341;Šilelis;NYKŠTUKAI;2095572561;Ne;10;0;4;14
17342;Šilelis;NYKŠTUKAI;2161973782;Taip;15;1;0;16
17343;Šilelis;NYKŠTUKAI;4459114205;Taip;0;3;0;3
17344;Šilelis;NYKŠTUKAI;3728633100;Taip;14;1;0;15
17345;Šilelis;NYKŠTUKAI;3999426414;Taip;0;4;0;4
17346;Šilelis;NYKŠTUKAI;5745874033;Taip;2;0;1;3
17347;Šilelis;NYKŠTUKAI;9769483899;Taip;16;1;0;17
17348;Šilelis;NYKŠTUKAI;2908840424;Taip;10;0;0;10
17349;Šilelis;NYKŠTUKAI;6980045156;Taip;7;1;0;8
17350;Šilelis;NYKŠTUKAI;9685227636;Taip;5;0;1;6
17351;Šilelis;NYKŠTUKAI;4868465692;Taip;3;3;0;6
17352;Šilelis;NYKŠTUKAI;4754544277;Taip;17;0;0;17
17353;Šilelis;NYKŠTUKAI;7480611069;Ne;3;0;0;3
17354;Šilelis;ANČIUKAI;1726944289;Taip;13;0;5;18
17355;Šilelis;ANČIUKAI;4336942500;Taip;11;0;5;16
17356;Šilelis;ANČIUKAI;9661578871;Taip;15;1;2;18
17357;Šilelis;ANČIUKAI;6616262730;Taip;0;1;2;3
17358;Šilelis;ANČIUKAI;4323750313;Taip;12;1;7;20
17359;Šilelis;ANČIUKAI;3221398692;Taip;5;0;0;5
17360;Šilelis;ANČIUKAI;6364741317;Taip;4;0;3;7
17361;Šilelis;ANČIUKAI;1325857464;Taip;12;0;6;18
17362;Šilelis;ANČIUKAI;9407916190;Ne;5;0;5;10
17363;Šilelis;ANČIUKAI;8188160849;Taip;8;0;0;8
17364;Šilelis;ANČIUKAI;7128670936;Taip;12;0;0;12
17365;Šilelis;ANČIUKAI;8613748314;Taip;7;4;0;11
17366;Šilelis;ANČIUKAI;5381213051;Taip;14;0;0;14
17367;Šilelis;ANČIUKAI;8807755852;Taip;0;6;0;6
17368;Šilelis;ANČIUKAI;4135383684;Taip;0;1;0;1
17369;Šilelis;ANČIUKAI;5926624138;Taip;5;0;3;8
17370;Šilelis;ANČIUKAI;8603589758;Taip;6;0;1;7
17371;Šilelis;KAČIUKAI;9899047136;Taip;0;6;0;6
17372;Šilelis;KAČIUKAI;3216168797;Taip;11;0;0;11
17373;Šilelis;KAČIUKAI;9848760151;Ne;0;4;0;4
17374;Šilelis;KAČIUKAI;4743459915;Taip;0;1;0;1
17375;Šilelis;KAČIUKAI;8387022157;Taip;0;5;0;5
17376;Šilelis;KAČIUKAI;3393466953;Ne;0;7;0;7
17377;Šilelis;KAČIUKAI;2111979474;Taip;0;1;0;1
17378;Šilelis;KAČIUKAI;8064905796;Taip;0;8;0;8
17379;Šilelis;KAČIUKAI;5176259940;Ne;0;0;1;1
17380;Šilelis;KAČIUKAI;5589764935;Taip;12;0;2;14
17381;Šilelis;KAČIUKAI;7123048946;Taip;0;1;1;2
17382;Šilelis;KAČIUKAI;6479728064;Taip;0;6;0;6
17383;Šilelis;KAČIUKAI;3686287802;Ne;0;2;1;3
17384;Šilelis;KAČIUKAI;2906501601;Taip;0;2;0;2
17385;Šilelis;KAČIUKAI;6510813364;Taip;0;5;0;5
17386;Šilelis;KAČIUKAI;8319185507;Taip;0;1;0;1
17387;Šilelis;KAČIUKAI;8504187981;Ne;0;1;3;4
17388;Šilelis;KAČIUKAI;3419284228;Taip;0;1;0;1
17389;Šilelis;KAČIUKAI;3712001932;Taip;0;16;0;16
17390;Šilelis;KAČIUKAI;9106999969;Taip;0;9;0;9
17391;Šilelis;KAČIUKAI;5030871828;Taip;0;0;7;7
17392;Šilelis;KAČIUKAI;6894466509;Taip;13;0;3;16
17393;Šilelis;KAČIUKAI;5026203678;Taip;3;3;0;6
17394;Šilelis;KIŠKUČIAI;2209552706;Taip;1;0;2;3
17395;Šilelis;KIŠKUČIAI;4386065478;Taip;0;1;0;1
17396;Šilelis;KIŠKUČIAI;7043644521;Taip;10;11;0;21
17397;Šilelis;KIŠKUČIAI;8096868221;Taip;0;1;0;1
17398;Šilelis;KIŠKUČIAI;3382252131;Taip;16;0;0;16
17399;Šilelis;KIŠKUČIAI;9746722034;Taip;2;0;0;2
17400;Šilelis;KIŠKUČIAI;2551747888;Taip;8;0;0;8
17401;Šilelis;KIŠKUČIAI;8598321310;Taip;12;0;2;14
17402;Šilelis;KREGŽDUTĖS;9715544798;Taip;11;0;3;14
17403;Šilelis;KREGŽDUTĖS;1025643459;Taip;2;0;3;5
17404;Šilelis;KREGŽDUTĖS;2896605690;Taip;6;0;1;7
17405;Šilelis;KREGŽDUTĖS;8453070684;Ne;8;0;3;11
17406;Šilelis;KREGŽDUTĖS;1286082219;Taip;8;0;4;12
17407;Šilelis;KREGŽDUTĖS;3068950702;Taip;9;0;0;9
17408;Šilelis;KREGŽDUTĖS;8665357907;Taip;13;3;0;16
17409;Šilelis;KREGŽDUTĖS;1152159735;Ne;11;0;0;11
17410;Šilelis;KREGŽDUTĖS;6630114847;Taip;13;0;0;13
17411;Šilelis;KREGŽDUTĖS;3953114161;Taip;11;0;0;11
17412;Šilelis;KREGŽDUTĖS;2499322761;Taip;18;0;0;18
17413;Šilelis;KREGŽDUTĖS;8659845107;Taip;6;0;9;15
17414;Šilelis;KREGŽDUTĖS;5868594049;Taip;16;0;1;17
17415;Šilelis;KREGŽDUTĖS;3235890717;Taip;16;0;0;16
17416;Šilelis;KREGŽDUTĖS;8855625488;Taip;7;5;0;12
17417;Šilelis;KREGŽDUTĖS;5223262925;Taip;9;1;0;10
17418;Šilelis;KREGŽDUTĖS;1279361795;Taip;6;1;0;7
17419;Šilelis;PAGRANDUKAI;9922962130;Taip;0;11;0;11
17420;Šilelis;PAGRANDUKAI;4814863979;Taip;5;2;0;7
17421;Šilelis;PAGRANDUKAI;8357287467;Taip;4;0;0;4
17422;Šilelis;PAGRANDUKAI;20525573092;Taip;0;5;0;5
17423;Šilelis;PAGRANDUKAI;2897196188;Ne;6;0;0;6
17424;Šilelis;PAGRANDUKAI;3583955729;Taip;0;4;0;4
17425;Šilelis;PAGRANDUKAI;9113098594;Taip;0;0;1;1
17426;Šilelis;PAGRANDUKAI;7623203279;Taip;10;0;1;11
17427;Šilelis;PAGRANDUKAI;3807787648;Taip;0;0;6;6
17428;Šilelis;PAGRANDUKAI;8416126751;Taip;0;0;1;1
17429;Šilelis;PAGRANDUKAI;2397366916;Ne;0;2;0;2
17430;Šilelis;PAGRANDUKAI;7936978436;Taip;0;6;0;6
17431;Šilelis;PAGRANDUKAI;1747920772;Taip;0;3;0;3
17432;Šilelis;PAGRANDUKAI;3843999609;Taip;0;4;0;4
17433;Šilelis;PAGRANDUKAI;1898004894;Taip;10;0;2;12
17434;Šilelis;BITUTĖS;2948291866;Taip;0;2;1;3
17435;Šilelis;BITUTĖS;7512731255;Taip;0;4;1;5
17436;Šilelis;BITUTĖS;1268335563;Taip;0;0;2;2
17437;Šilelis;BITUTĖS;9035595952;Taip;0;0;2;2
17438;Šilelis;BITUTĖS;7814807923;Taip;9;2;0;11
17439;Šilelis;BITUTĖS;5305660046;Taip;0;0;1;1
17440;Šilelis;BITUTĖS;9071963194;Ne;0;0;1;1
17441;Šilelis;BITUTĖS;5843337891;Taip;5;0;1;6
17442;Šilelis;BITUTĖS;1960952604;Taip;8;1;1;10
17443;Šilelis;BITUTĖS;3954379433;Taip;11;3;0;14
17444;Šilelis;BITUTĖS;7350013139;Taip;14;0;0;14
17445;Šilelis;BITUTĖS;3879234745;Taip;0;0;2;2
17446;Šilelis;BITUTĖS;3062557053;Taip;0;0;1;1
17447;Šilelis;BITUTĖS;1390916076;Taip;10;0;2;12
17448;Šilelis;BITUTĖS;2667785768;Taip;5;0;0;5
17449;Šilelis;BITUTĖS;2023309512;Ne;6;0;0;6
17450;Šilelis;BITUTĖS;5210301367;Taip;14;0;0;14
17451;Šilelis;BITUTĖS;5375413045;Taip;0;7;0;7
17452;Šilelis;BITUTĖS;6297546907;Ne;9;0;6;15
17453;Šilelis;BITUTĖS;4682742121;Taip;2;0;3;5
17454;Šilelis;DRUGELIAI;3598370884;Taip;8;1;0;9
17455;Šilelis;DRUGELIAI;1347150938;Taip;3;0;0;3
17456;Šilelis;DRUGELIAI;7636725161;Taip;0;2;0;2
17457;Šilelis;DRUGELIAI;1891388542;Taip;5;2;0;7
17458;Šilelis;DRUGELIAI;5759824196;Taip;0;4;0;4
17459;Šilelis;DRUGELIAI;4115738520;Taip;0;1;0;1
17460;Šilelis;DRUGELIAI;3824174896;Taip;0;1;0;1
17461;Šilelis;DRUGELIAI;8090765017;Taip;0;7;0;7
17462;Šilelis;DRUGELIAI;54633547799;Taip;12;2;0;14
17463;Šilelis;DRUGELIAI;9100047520;Taip;8;1;0;9
17464;Šilelis;DRUGELIAI;1019874215;Taip;0;3;5;8
17465;Šilelis;DRUGELIAI;1638362625;Taip;5;3;0;8
17466;Šilelis;DRUGELIAI;9482667810;Taip;0;1;1;2
17467;Šilelis;DRUGELIAI;5379171382;Taip;0;1;0;1
17468;Šilelis;DRUGELIAI;6230566495;Taip;8;0;0;8
17469;Šilelis;DRUGELIAI;6523676718;Taip;0;15;0;15
17470;Šilelis;DRUGELIAI;5766702969;Taip;0;3;0;3
17471;Šilelis;DRUGELIAI;8915228012;Taip;0;1;1;2
17472;Šilelis;DRUGELIAI;1984731000;Taip;5;1;0;6
17473;Šilelis;DRUGELIAI;6104538160;Taip;5;2;0;7
17474;Šilelis;DRUGELIAI;7542121945;Ne;0;2;0;2
17475;Vaivorykštė;Vasilki;3636826798;Ne;5;0;0;5
17476;Vaduvos;PAGRANDUKAI;1431863758;Taip;0;1;0;1
17477;Vaduvos;PAGRANDUKAI;8408017356;Taip;0;11;6;17
17478;Vaduvos;PAGRANDUKAI;72724196791;Taip;0;11;2;13
17479;Vaduvos;PAGRANDUKAI;9371067563;Taip;0;2;0;2
17480;Vaduvos;PAGRANDUKAI;6425640531;Taip;5;0;0;5
17481;Vaduvos;PAGRANDUKAI;4029586203;Taip;0;1;0;1
17482;Vaduvos;PAGRANDUKAI;73800920781;Taip;13;1;1;15
17483;Vaduvos;PAGRANDUKAI;18035723255;Taip;4;1;0;5
17484;Vaduvos;PAGRANDUKAI;5954492368;Taip;0;4;0;4
17485;Vaduvos;PAGRANDUKAI;7397068779;Ne;0;3;0;3
17486;Vaduvos;PAGRANDUKAI;8875709110;Taip;0;1;0;1
17487;Vaduvos;PAGRANDUKAI;7305111076;Taip;0;1;1;2
17488;Vaduvos;PAGRANDUKAI;2897226343;Taip;0;1;0;1
17489;Vaduvos;PAGRANDUKAI;68848152670;Ne;0;7;0;7
17490;Vaduvos;PAGRANDUKAI;4105978403;Taip;0;1;0;1
17491;Vaduvos;PAGRANDUKAI;5428067167;Taip;0;1;4;5
17492;Vaduvos;PAGRANDUKAI;3699578284;Taip;0;4;0;4
17493;Vaduvos;PAGRANDUKAI;8299189235;Taip;21;0;0;21
17494;Vaduvos;PAGRANDUKAI;9540008495;Taip;0;2;0;2
17495;Vaduvos;KODĖLČIUKAI;3010510262;Taip;0;3;0;3
17496;Vaduvos;KODĖLČIUKAI;9429028460;Taip;0;1;0;1
17497;Vaduvos;KODĖLČIUKAI;6210729584;Taip;7;1;0;8
17498;Vaduvos;KODĖLČIUKAI;4177935331;Taip;4;2;0;6
17499;Vaduvos;KODĖLČIUKAI;9983148737;Taip;0;1;0;1
17500;Vaduvos;KODĖLČIUKAI;9072097216;Taip;0;0;2;2
17501;Vaduvos;KODĖLČIUKAI;6810198013;Taip;2;2;0;4
17502;Vaduvos;KODĖLČIUKAI;3641822841;Taip;0;0;6;6
17503;Vaduvos;KODĖLČIUKAI;4270137614;Taip;4;0;0;4
17504;Vaduvos;KODĖLČIUKAI;5262165284;Taip;6;0;0;6
17505;Vaduvos;KODĖLČIUKAI;8603418399;Taip;21;0;0;21
17506;Vaduvos;KODĖLČIUKAI;3096104197;Taip;16;0;0;16
17507;Vaduvos;KODĖLČIUKAI;5761137540;Taip;0;6;0;6
17508;Vaduvos;KODĖLČIUKAI;9597857664;Taip;8;0;0;8
17509;Vaduvos;KODĖLČIUKAI;1054097622;Ne;11;0;0;11
17510;Vaduvos;KODĖLČIUKAI;6013737546;Taip;0;0;10;10
17511;Vaduvos;KODĖLČIUKAI;6991960029;Taip;0;1;0;1
17512;Vaduvos;KODĖLČIUKAI;4789480822;Taip;16;0;0;16
17513;Vaduvos;KODĖLČIUKAI;3164402142;Taip;0;0;1;1
17514;Vaduvos;SMALSUČIAI;3555513755;Taip;0;10;0;10
17515;Vaduvos;SMALSUČIAI;2184711783;Taip;0;0;1;1
17516;Vaduvos;SMALSUČIAI;7537754249;Taip;4;1;0;5
17517;Vaduvos;SMALSUČIAI;5573145836;Taip;0;1;2;3
17518;Vaduvos;SMALSUČIAI;7337663549;Taip;5;1;0;6
17519;Vaduvos;SMALSUČIAI;5055972872;Taip;12;2;0;14
17520;Vaduvos;SMALSUČIAI;1423148023;Taip;0;4;0;4
17521;Vaduvos;SMALSUČIAI;3091707832;Ne;8;6;0;14
17522;Vaduvos;SMALSUČIAI;87008942241;Taip;0;1;1;2
17523;Vaduvos;SMALSUČIAI;7181151562;Ne;3;1;0;4
17524;Vaduvos;SMALSUČIAI;7431411663;Taip;0;3;0;3
17525;Vaduvos;SMALSUČIAI;2257135127;Taip;11;0;4;15
17526;Vaduvos;SMALSUČIAI;6462126837;Taip;0;1;0;1
17527;Vaduvos;SMALSUČIAI;1434871968;Taip;7;0;0;7
17528;Vaduvos;SMALSUČIAI;3948025914;Taip;7;0;4;11
17529;Vaduvos;SMALSUČIAI;6253552951;Ne;0;0;1;1
17530;Vaduvos;SMALSUČIAI;7508333714;Ne;5;7;0;12
17531;Vaduvos;GILIUKAI;1277811729;Taip;11;2;0;13
17532;Vaduvos;GILIUKAI;1969325922;Taip;0;2;0;2
17533;Vaduvos;GILIUKAI;2835635250;Taip;0;0;1;1
17534;Vaduvos;GILIUKAI;2939561403;Taip;0;0;1;1
17535;Vaduvos;GILIUKAI;8188374113;Taip;0;1;0;1
17536;Vaduvos;GILIUKAI;3057729267;Taip;9;2;0;11
17537;Vaduvos;GILIUKAI;6346625714;Taip;0;1;0;1
17538;Vaduvos;GILIUKAI;8580834401;Taip;0;0;6;6
17539;Vaduvos;GILIUKAI;9167796462;Taip;3;1;0;4
17540;Vaduvos;GILIUKAI;6276149710;Taip;0;0;7;7
17541;Vaduvos;GILIUKAI;6572776966;Taip;0;0;2;2
17542;Vaduvos;GILIUKAI;2957685586;Taip;16;0;0;16
17543;Vaduvos;GILIUKAI;3540548094;Taip;1;0;1;2
17544;Vaduvos;GILIUKAI;8964194121;Taip;12;0;0;12
17545;Vaduvos;GILIUKAI;5297217576;Taip;0;5;0;5
17546;Vaduvos;GILIUKAI;5010914832;Taip;7;3;0;10
17547;Vaduvos;GILIUKAI;4030891958;Taip;0;0;1;1
17548;Vaduvos;GILIUKAI;7730737705;Taip;9;0;0;9
17549;Vaduvos;GILIUKAI;2011976336;Taip;14;0;0;14
17550;Vaduvos;BORUŽĖLĖS;6439773886;Taip;5;4;0;9
17551;Vaduvos;BORUŽĖLĖS;5634252033;Taip;0;2;0;2
17552;Vaduvos;BORUŽĖLĖS;6593754016;Taip;10;7;0;17
17553;Vaduvos;BORUŽĖLĖS;5356902834;Taip;0;0;1;1
17554;Vaduvos;BORUŽĖLĖS;7521846747;Taip;10;1;0;11
17555;Vaduvos;BORUŽĖLĖS;1422507884;Taip;0;10;0;10
17556;Vaduvos;BORUŽĖLĖS;3461756429;Taip;0;1;2;3
17557;Vaduvos;BORUŽĖLĖS;8324927031;Taip;5;4;0;9
17558;Vaduvos;BORUŽĖLĖS;4465504676;Taip;13;0;0;13
17559;Vaduvos;BORUŽĖLĖS;7904713344;Taip;0;3;0;3
17560;Vaduvos;BORUŽĖLĖS;2417613291;Taip;1;0;0;1
17561;Vaduvos;BORUŽĖLĖS;5717064754;Ne;0;0;6;6
17562;Vaduvos;BORUŽĖLĖS;8064111922;Taip;3;9;3;15
17563;Vaduvos;BORUŽĖLĖS;6552763746;Taip;0;1;0;1
17564;Vaduvos;BORUŽĖLĖS;3255011809;Taip;10;2;0;12
17565;Vaduvos;BORUŽĖLĖS;8946940285;Taip;0;1;0;1
17566;Vaduvos;BORUŽĖLĖS;9188471756;Taip;1;0;2;3
17567;Vaduvos;BORUŽĖLĖS;7169054113;Taip;0;1;0;1
17568;Vaduvos;BORUŽĖLĖS;2366843609;Taip;2;1;0;3
17569;Vaduvos;BORUŽĖLĖS;1924714755;Taip;7;0;0;7
17570;Vaduvos;DRUGELIAI;4936598927;Taip;10;1;0;11
17571;Vaduvos;DRUGELIAI;2341467486;Taip;0;1;1;2
17572;Vaduvos;DRUGELIAI;5510687497;Ne;0;1;0;1
17573;Vaduvos;DRUGELIAI;9824469881;Taip;0;0;1;1
17574;Vaduvos;DRUGELIAI;5915272436;Ne;12;0;0;12
17575;Vaduvos;DRUGELIAI;4238942070;Taip;5;0;1;6
17576;Vaduvos;DRUGELIAI;1539465611;Taip;2;0;0;2
17577;Vaduvos;DRUGELIAI;8384302877;Taip;11;0;0;11
17578;Vaduvos;DRUGELIAI;6770559352;Taip;5;1;1;7
17579;Vaduvos;DRUGELIAI;4856601924;Taip;0;5;0;5
17580;Vaduvos;DRUGELIAI;3477273224;Taip;0;4;0;4
17581;Vaduvos;DRUGELIAI;2452309232;Taip;16;0;0;16
17582;Vaduvos;DRUGELIAI;4587836073;Taip;0;3;0;3
17583;Vaduvos;DRUGELIAI;9333495119;Taip;5;3;0;8
17584;Vaduvos;DRUGELIAI;7597268115;Taip;6;0;0;6
17585;Vaduvos;DRUGELIAI;8400344609;Taip;4;1;1;6
17586;Vaduvos;DRUGELIAI;2789503381;Taip;3;1;0;4
17587;Vaduvos;DRUGELIAI;1987969267;Taip;9;3;0;12
17588;Vaduvos;DRUGELIAI;8990472878;Ne;8;0;3;11
17589;Vaduvos;DRUGELIAI;2717887489;Taip;15;0;0;15
17590;Vaduvos;DRUGELIAI;5881009426;Taip;13;0;0;13
17591;Vaduvos;RIEŠUTĖLIAI;1466282653;Taip;11;0;0;11
17592;Vaduvos;RIEŠUTĖLIAI;3206096414;Taip;3;0;0;3
17593;Vaduvos;RIEŠUTĖLIAI;8055108164;Taip;5;0;2;7
17594;Vaduvos;RIEŠUTĖLIAI;5509202519;Taip;7;0;0;7
17595;Vaduvos;RIEŠUTĖLIAI;5775152939;Taip;15;0;1;16
17596;Vaduvos;RIEŠUTĖLIAI;3060409258;Taip;0;2;0;2
17597;Vaduvos;RIEŠUTĖLIAI;9232960362;Taip;9;0;1;10
17598;Vaduvos;RIEŠUTĖLIAI;7425991335;Taip;7;0;0;7
17599;Vaduvos;RIEŠUTĖLIAI;7592658267;Taip;8;0;0;8
17600;Vaduvos;RIEŠUTĖLIAI;8533315132;Taip;5;6;0;11
17601;Vaduvos;RIEŠUTĖLIAI;2508650990;Taip;0;4;0;4
17602;Vaduvos;RIEŠUTĖLIAI;6943057114;Taip;0;11;1;12
17603;Vaduvos;RIEŠUTĖLIAI;8669267296;Taip;14;0;0;14
17604;Vaduvos;RIEŠUTĖLIAI;1736248725;Taip;5;5;0;10
17605;Vaduvos;"1 klasė";3174998523;Ne;0;1;0;1
17606;Vaduvos;"1 klasė";1825188497;Taip;0;1;0;1
17607;Vaduvos;"1 klasė";3722349868;Taip;0;1;0;1
17608;Vaduvos;"1 klasė";13888236429;Taip;0;6;0;6
17609;Vaduvos;"1 klasė";5307128703;Taip;0;3;0;3
17610;Vaduvos;"1 klasė";6128582180;Taip;0;4;0;4
17611;Vaduvos;"1 klasė";62183976729;Taip;0;1;0;1
17612;Vaduvos;"1 klasė";93702732546;Taip;0;1;0;1
17613;Vaduvos;"1 klasė";15757662594;Taip;0;1;0;1
17614;Vaduvos;"1 klasė";41870343319;Taip;0;4;0;4
17615;Vaduvos;"1 klasė";4513707989;Ne;0;1;0;1
17616;Vaduvos;"1 klasė";68937983441;Taip;0;1;0;1
17617;Vaduvos;"1 klasė";59616893535;Taip;0;1;0;1
17618;Vaduvos;"1 klasė";22641388717;Taip;0;1;0;1
17619;Vaduvos;"1 klasė";21499108813;Taip;0;1;0;1
17620;Vaduvos;"1 klasė";79437154441;Taip;0;1;0;1
17621;Vaduvos;"1 klasė";46608435244;Taip;0;2;0;2
17622;Vaduvos;"1 klasė";61046090149;Taip;0;1;0;1
17623;Vaduvos;"1 klasė";56280470781;Ne;0;1;0;1
17624;Vaduvos;"1 klasė";11202010413;Taip;0;21;0;21
17625;Vaduvos;"1 klasė";1370696345;Taip;0;3;0;3
17626;Vaduvos;"1 klasė";4342471835;Taip;0;1;0;1
17627;Vaduvos;"1 klasė";9112649520;Taip;0;1;0;1
17628;Vaduvos;"1 klasė";1599595256;Taip;0;1;0;1
17629;Vaduvos;"1 klasė";5435336235;Taip;0;3;0;3
17630;Vaduvos;"1 klasė";1681367373;Taip;0;8;0;8
17631;Vaduvos;"3 klasė";97423576166;Taip;0;2;0;2
17632;Vaduvos;"3 klasė";38504924027;Taip;0;2;0;2
17633;Vaduvos;"3 klasė";96148085691;Taip;0;2;0;2
17634;Vaduvos;"3 klasė";12330772986;Ne;0;6;0;6
17635;Vaduvos;"3 klasė";33277362439;Ne;0;4;0;4
17636;Vaduvos;"3 klasė";32138087379;Taip;0;22;0;22
17637;Vaduvos;"3 klasė";67324784528;Taip;0;1;0;1
17638;Vaduvos;"3 klasė";4807104855;Taip;0;6;0;6
17639;Vaduvos;"3 klasė";2181614424;Taip;0;1;0;1
17640;Vaduvos;"3 klasė";2019573643;Taip;0;1;0;1
17641;Vaduvos;"3 klasė";27419094487;Taip;0;1;0;1
17642;Vaduvos;"3 klasė";89793734700;Taip;0;5;0;5
17643;Vaduvos;"3 klasė";17473821556;Taip;0;1;0;1
17644;Vaduvos;"3 klasė";53866301875;Ne;0;21;0;21
17645;Vaduvos;"3 klasė";7786986697;Taip;0;3;0;3
17646;Vaduvos;"3 klasė";9147332638;Taip;0;3;0;3
17647;Vaduvos;"3 klasė";1532675814;Taip;0;1;0;1
17648;Vaduvos;"3 klasė";98259624669;Taip;0;1;0;1
17649;Vaduvos;"3 klasė";36931517006;Taip;0;1;0;1
17650;Vaduvos;"3 klasė";61243424057;Taip;0;1;0;1
17651;Vaduvos;"3 klasė";30979103892;Taip;0;2;0;2
17652;Vaduvos;"3 klasė";78245732319;Taip;0;1;0;1
17653;Vaduvos;"3 klasė";48433447683;Taip;0;13;0;13
17654;Vaduvos;"3 klasė";85090873161;Ne;0;21;0;21
17655;Vaduvos;"3 klasė";41272273463;Ne;0;1;0;1
17656;Vaduvos;"4 klasė";96473212525;Taip;0;1;0;1
17657;Vaduvos;"4 klasė";75428164558;Taip;0;1;0;1
17658;Vaduvos;"4 klasė";63286903462;Taip;0;1;0;1
17659;Vaduvos;"4 klasė";13721939854;Taip;0;1;0;1
17660;Vaduvos;"4 klasė";1171210935;Ne;0;2;0;2
17661;Vaduvos;"4 klasė";7172286009;Taip;0;8;0;8
17662;Vaduvos;"4 klasė";6049882391;Ne;0;21;0;21
17663;Vaduvos;"4 klasė";38013859931;Taip;0;1;0;1
17664;Vaduvos;"4 klasė";4591744662;Taip;0;2;0;2
17665;Vaduvos;"4 klasė";9149523910;Taip;0;2;0;2
17666;Vaduvos;"4 klasė";76662161382;Taip;0;1;0;1
17667;Vaduvos;"4 klasė";26934740147;Taip;0;4;0;4
17668;Vaduvos;"4 klasė";18300713872;Taip;0;21;0;21
17669;Vaduvos;"4 klasė";768455288;Taip;0;3;0;3
17670;Vaduvos;"4 klasė";1768173501;Taip;0;1;0;1
17671;Vaduvos;"4 klasė";60531886576;Taip;0;1;0;1
17672;Vaduvos;"4 klasė";38462664426;Ne;0;8;0;8
17673;Vaduvos;"4 klasė";1821644443;Ne;0;9;0;9
17674;Vaduvos;"2 B klasė";95104294893;Taip;0;2;0;2
17675;Vaduvos;"2 B klasė";40872193458;Taip;0;1;0;1
17676;Vaduvos;"2 B klasė";6500567162;Taip;0;7;0;7
17677;Vaduvos;"2 B klasė";78931952732;Ne;0;1;0;1
17678;Vaduvos;"2 B klasė";1241148402;Ne;0;1;0;1
17679;Vaduvos;"2 B klasė";66359913774;Taip;0;9;0;9
17680;Vaduvos;"2 B klasė";24887196729;Ne;0;1;0;1
17681;Vaduvos;"2 B klasė";39687066893;Taip;0;1;0;1
17682;Vaduvos;"2 B klasė";64074141491;Taip;0;1;0;1
17683;Vaduvos;"2 B klasė";93924290247;Taip;0;5;0;5
17684;Vaduvos;"2 B klasė";47465933557;Taip;0;15;0;15
17685;Vaduvos;"2 B klasė";62521006557;Taip;0;1;0;1
17686;Vaduvos;"2 B klasė";16882774330;Taip;0;1;0;1
17687;Vaduvos;"2 B klasė";3259114583;Taip;0;8;0;8
17688;Vaduvos;"2 B klasė";87671358423;Taip;0;21;0;21
17689;Vaduvos;"2 B klasė";55138588393;Taip;0;1;0;1
17690;Vaduvos;"2 B klasė";3310156076;Ne;0;3;0;3
17691;Vaduvos;"2 A klasė";6279678482;Ne;0;1;0;1
17692;Vaduvos;"2 A klasė";96892752634;Taip;0;8;0;8
17693;Vaduvos;"2 A klasė";61243200177;Taip;0;1;0;1
17694;Vaduvos;"2 A klasė";62703428759;Taip;0;1;0;1
17695;Vaduvos;"2 A klasė";68420568339;Taip;0;1;0;1
17696;Vaduvos;"2 A klasė";49738318631;Taip;0;1;0;1
17697;Vaduvos;"2 A klasė";65647119496;Taip;0;1;0;1
17698;Vaduvos;"2 A klasė";19390879176;Taip;0;1;0;1
17699;Vaduvos;"2 A klasė";6155494370;Ne;0;1;0;1
17700;Vaduvos;"2 A klasė";1139509471;Taip;0;21;0;21
17701;Vaduvos;"2 A klasė";70693742936;Taip;0;4;0;4
17702;Vaduvos;"2 A klasė";1010061503;Taip;0;9;0;9
17703;Vaduvos;"2 A klasė";1107557891;Taip;0;21;0;21
17704;Vaduvos;"2 A klasė";8802765960;Ne;0;1;0;1
17705;Vaduvos;"2 A klasė";3172047211;Taip;0;1;0;1
17706;Vilkpėdės;BORUŽĖLĖS;8002436634;Taip;7;1;0;8
17707;Vilkpėdės;BORUŽĖLĖS;1249504082;Taip;4;1;6;11
17708;Vilkpėdės;BORUŽĖLĖS;4052026470;Taip;0;0;8;8
17709;Vilkpėdės;BORUŽĖLĖS;4726171678;Taip;5;1;0;6
17710;Vilkpėdės;BORUŽĖLĖS;7519472444;Taip;10;0;0;10
17711;Vilkpėdės;BORUŽĖLĖS;3991785883;Taip;6;0;6;12
17712;Vilkpėdės;BORUŽĖLĖS;9334610111;Taip;0;1;3;4
17713;Vilkpėdės;BORUŽĖLĖS;7992484314;Taip;7;1;0;8
17714;Vilkpėdės;BORUŽĖLĖS;5050493757;Taip;10;1;3;14
17715;Vilkpėdės;BORUŽĖLĖS;8217972925;Taip;2;0;2;4
17716;Vilkpėdės;BORUŽĖLĖS;7805866055;Taip;5;2;0;7
17717;Vilkpėdės;BORUŽĖLĖS;3994451071;Taip;13;0;0;13
17718;Vilkpėdės;BORUŽĖLĖS;2529188623;Taip;5;1;5;11
17719;Vilkpėdės;BORUŽĖLĖS;5569182344;Taip;10;1;0;11
17720;Vilkpėdės;BORUŽĖLĖS;5677284428;Taip;2;0;0;2
17721;Vilkpėdės;SKRUZDĖLIUKAI;4018140154;Taip;0;0;5;5
17722;Vilkpėdės;SKRUZDĖLIUKAI;7114183123;Taip;0;0;1;1
17723;Vilkpėdės;SKRUZDĖLIUKAI;8804335248;Taip;1;0;0;1
17724;Vilkpėdės;SKRUZDĖLIUKAI;4656475161;Taip;5;0;3;8
17725;Vilkpėdės;SKRUZDĖLIUKAI;4031175523;Ne;0;0;4;4
17726;Vilkpėdės;SKRUZDĖLIUKAI;6198736925;Ne;9;0;2;11
17727;Vilkpėdės;SKRUZDĖLIUKAI;5812430367;Taip;3;1;0;4
17728;Vilkpėdės;SKRUZDĖLIUKAI;1478022307;Taip;4;10;0;14
17729;Vilkpėdės;SKRUZDĖLIUKAI;2205143759;Ne;11;1;0;12
17730;Vilkpėdės;SKRUZDĖLIUKAI;6598572049;Ne;0;0;3;3
17731;Vilkpėdės;SKRUZDĖLIUKAI;7931496783;Ne;0;1;0;1
17732;Vilkpėdės;SKRUZDĖLIUKAI;2418313731;Taip;0;5;5;10
17733;Vilkpėdės;SKRUZDĖLIUKAI;1342167313;Taip;0;12;0;12
17734;Vilkpėdės;SKRUZDĖLIUKAI;5334238235;Taip;0;0;1;1
17735;Vilkpėdės;SKRUZDĖLIUKAI;2703704892;Ne;0;0;3;3
17736;Vilkpėdės;SKRUZDĖLIUKAI;8385974099;Ne;11;0;2;13
17737;Vilkpėdės;SKRUZDĖLIUKAI;6671311193;Ne;0;0;3;3
17738;Vilkpėdės;DRUGELIAI;1040357501;Taip;8;0;1;9
17739;Vilkpėdės;DRUGELIAI;6876470245;Taip;8;0;1;9
17740;Vilkpėdės;DRUGELIAI;8431620518;Taip;8;0;1;9
17741;Vilkpėdės;DRUGELIAI;5076206526;Taip;1;0;0;1
17742;Vilkpėdės;DRUGELIAI;3611416887;Taip;1;0;0;1
17743;Vilkpėdės;DRUGELIAI;7008659662;Taip;4;0;1;5
17744;Vilkpėdės;DRUGELIAI;9501254301;Taip;0;5;0;5
17745;Vilkpėdės;DRUGELIAI;4998396593;Taip;0;0;2;2
17746;Vilkpėdės;DRUGELIAI;1278300322;Taip;0;7;0;7
17747;Vilkpėdės;DRUGELIAI;9797550851;Taip;19;0;0;19
17748;Vilkpėdės;DRUGELIAI;2379571797;Taip;6;6;0;12
17749;Vilkpėdės;ŽIOGELIAI;1396827668;Taip;8;0;0;8
17750;Vilkpėdės;ŽIOGELIAI;5551822633;Taip;9;0;0;9
17751;Vilkpėdės;ŽIOGELIAI;1063740772;Taip;0;1;0;1
17752;Vilkpėdės;ŽIOGELIAI;3666145718;Taip;8;2;0;10
17753;Vilkpėdės;ŽIOGELIAI;5633014328;Taip;7;3;0;10
17754;Vilkpėdės;ŽIOGELIAI;5422061533;Taip;7;0;0;7
17755;Vilkpėdės;ŽIOGELIAI;4311938034;Taip;3;0;0;3
17756;Vilkpėdės;ŽIOGELIAI;5346798201;Taip;8;2;0;10
17757;Vilkpėdės;ŽIOGELIAI;3720639726;Taip;6;0;0;6
17758;Vilkpėdės;ŽIOGELIAI;1609823694;Taip;0;0;5;5
17759;Vilkpėdės;ŽIOGELIAI;1655985778;Taip;16;2;1;19
17760;Vilkpėdės;ŽIOGELIAI;3664125930;Ne;13;0;0;13
17761;Vilkpėdės;ŽIOGELIAI;3737265597;Taip;10;1;0;11
17762;Vilkpėdės;ŽIOGELIAI;2241104719;Taip;1;5;0;6
17763;Vilkpėdės;ŽIOGELIAI;8423972962;Taip;0;2;0;2
17764;Vilkpėdės;ŽIOGELIAI;1537270256;Taip;6;7;0;13
17765;Vilkpėdės;ŽIOGELIAI;3229559339;Taip;6;7;0;13
17766;Vilkpėdės;ŽIOGELIAI;8783790519;Taip;0;4;0;4
17767;Vilkpėdės;BITUTĖS;6418829930;Taip;0;8;0;8
17768;Vilkpėdės;BITUTĖS;1633942236;Taip;5;0;12;17
17769;Vilkpėdės;BITUTĖS;8484873068;Taip;1;0;1;2
17770;Vilkpėdės;BITUTĖS;2503128176;Ne;2;6;1;9
17771;Vilkpėdės;BITUTĖS;9570469277;Ne;0;1;11;12
17772;Vilkpėdės;BITUTĖS;5420512675;Taip;2;0;2;4
17773;Vilkpėdės;BITUTĖS;8613778606;Taip;17;1;0;18
17774;Vilkpėdės;BITUTĖS;7991758361;Taip;0;1;0;1
17775;Vilkpėdės;BITUTĖS;2736318576;Taip;0;0;1;1
17776;Vilkpėdės;BITUTĖS;5577199802;Taip;5;0;0;5
17777;Vilkpėdės;BITUTĖS;8930504912;Taip;0;0;2;2
17778;Vilkpėdės;BITUTĖS;3303872633;Taip;3;4;0;7
17779;Vilkpėdės;BITUTĖS;5972405023;Ne;6;3;0;9
17780;Vilkpėdės;BITUTĖS;4485811377;Ne;5;1;0;6
17781;Vilkpėdės;BITUTĖS;5274855225;Taip;21;0;0;21
17782;Vilkpėdės;BITUTĖS;8860791478;Taip;9;1;0;10
17783;Vilkpėdės;BITUTĖS;7829343719;Taip;0;0;6;6
17784;Vilkpėdės;"4 klasė";14499651046;Ne;0;1;0;1
17785;Vilkpėdės;"4 klasė";90217345315;Taip;0;1;0;1
17786;Vilkpėdės;"4 klasė";51286525404;Taip;0;1;0;1
17787;Vilkpėdės;"4 klasė";49513181091;Ne;1;5;0;6
17788;Vilkpėdės;"4 klasė";37450374921;Taip;0;5;0;5
17789;Vilkpėdės;"4 klasė";36704555745;Taip;4;1;0;5
17790;Vilkpėdės;"4 klasė";1024429836;Taip;0;1;0;1
17791;Vilkpėdės;"4 klasė";66356984763;Taip;0;5;0;5
17792;Vilkpėdės;"4 klasė";88279045901;Taip;17;2;0;19
17793;Vilkpėdės;"4 klasė";66451097025;Taip;1;1;0;2
17794;Vilkpėdės;"4 klasė";2806307083;Taip;0;1;0;1
17795;Vilkpėdės;"4 klasė";51799865091;Taip;0;9;0;9
17796;Vilkpėdės;"4 klasė";79269485254;Taip;0;1;0;1
17797;Vilkpėdės;"4 klasė";61833757576;Taip;0;3;0;3
17798;Vilkpėdės;"4 klasė";64216245300;Taip;0;1;0;1
17799;Vilkpėdės;GUDRUČIAI;1451102218;Taip;13;0;0;13
17800;Vilkpėdės;GUDRUČIAI;2065010940;Ne;0;4;0;4
17801;Vilkpėdės;GUDRUČIAI;2181146968;Taip;8;1;0;9
17802;Vilkpėdės;GUDRUČIAI;4515945951;Taip;1;1;1;3
17803;Vilkpėdės;GUDRUČIAI;2736368118;Taip;6;1;0;7
17804;Vilkpėdės;GUDRUČIAI;7527929277;Ne;9;0;0;9
17805;Vilkpėdės;GUDRUČIAI;46561435465;Taip;8;2;0;10
17806;Vilkpėdės;GUDRUČIAI;48059844727;Taip;0;2;0;2
17807;Vilkpėdės;GUDRUČIAI;8865545376;Taip;0;2;0;2
17808;Vilkpėdės;GUDRUČIAI;4735164204;Taip;4;0;0;4
17809;Vilkpėdės;GUDRUČIAI;7889480219;Ne;13;0;0;13
17810;Vilkpėdės;GUDRUČIAI;9867411687;Ne;5;2;0;7
17811;Vilkpėdės;GUDRUČIAI;2900581406;Ne;0;2;0;2
17812;Vilkpėdės;GUDRUČIAI;7875898177;Taip;7;4;0;11
17813;Vilkpėdės;GUDRUČIAI;1195392132;Taip;0;2;1;3
17814;Vilkpėdės;GUDRUČIAI;9605399822;Ne;2;1;0;3
17815;Vilkpėdės;GUDRUČIAI;4276158771;Taip;14;1;0;15
17816;Vilkpėdės;GUDRUČIAI;2604179994;Taip;0;2;0;2
17817;Vilkpėdės;SMALSUČIAI;9294350205;Ne;2;0;0;2
17818;Vilkpėdės;SMALSUČIAI;4095366279;Taip;0;7;0;7
17819;Vilkpėdės;SMALSUČIAI;5048931309;Ne;0;6;0;6
17820;Vilkpėdės;SMALSUČIAI;7698759895;Taip;6;4;0;10
17821;Vilkpėdės;SMALSUČIAI;1217929358;Taip;4;3;0;7
17822;Vilkpėdės;SMALSUČIAI;1807884737;Taip;4;6;0;10
17823;Vilkpėdės;SMALSUČIAI;2251274741;Taip;17;1;0;18
17824;Vilkpėdės;SMALSUČIAI;6816745585;Ne;0;1;0;1
17825;Vilkpėdės;SMALSUČIAI;9460356725;Ne;0;1;0;1
17826;Vilkpėdės;SMALSUČIAI;8128254701;Taip;0;6;0;6
17827;Vilkpėdės;SMALSUČIAI;8015392054;Ne;9;0;0;9
17828;Vilkpėdės;SMALSUČIAI;2320350937;Ne;3;0;0;3
17829;Vilkpėdės;SMALSUČIAI;7747013579;Taip;0;4;0;4
17830;Vilkpėdės;SMALSUČIAI;7894766629;Taip;3;2;0;5
17831;Vilkpėdės;SMALSUČIAI;3987021185;Taip;9;3;0;12
17832;Vilkpėdės;SMALSUČIAI;7010024061;Taip;6;0;0;6
17833;Vilkpėdės;SMALSUČIAI;7908813288;Ne;0;1;0;1
17834;Vilkpėdės;SMALSUČIAI;6522707709;Taip;0;1;0;1
17835;Vilkpėdės;SMALSUČIAI;9795696242;Taip;12;1;0;13
17836;Vilkpėdės;SMALSUČIAI;8581661608;Taip;0;3;0;3
17837;Vilkpėdės;SMALSUČIAI;6261547304;Taip;0;1;0;1
17838;Vilkpėdės;SMALSUČIAI;2420271759;Taip;12;2;0;14
17839;Vilkpėdės;KODĖLČIUKŲ;9605430333;Taip;19;0;0;19
17840;Vilkpėdės;KODĖLČIUKŲ;7745776486;Taip;2;7;0;9
17841;Vilkpėdės;KODĖLČIUKŲ;8969001990;Taip;2;1;0;3
17842;Vilkpėdės;KODĖLČIUKŲ;7158737372;Taip;13;1;0;14
17843;Vilkpėdės;KODĖLČIUKŲ;3785308006;Taip;5;0;0;5
17844;Vilkpėdės;KODĖLČIUKŲ;6744834487;Taip;4;0;0;4
17845;Vilkpėdės;KODĖLČIUKŲ;4166416292;Taip;0;11;0;11
17846;Vilkpėdės;KODĖLČIUKŲ;3888880306;Taip;0;4;0;4
17847;Vilkpėdės;KODĖLČIUKŲ;9601934563;Taip;0;1;0;1
17848;Vilkpėdės;KODĖLČIUKŲ;7401886306;Ne;15;1;0;16
17849;Vilkpėdės;KODĖLČIUKŲ;1528619779;Taip;1;1;0;2
17850;Vilkpėdės;KODĖLČIUKŲ;2359315281;Ne;1;0;0;1
17851;Vilkpėdės;KODĖLČIUKŲ;1571869318;Ne;7;7;0;14
17852;Vilkpėdės;KODĖLČIUKŲ;6820236577;Taip;0;6;0;6
17853;Vilkpėdės;KODĖLČIUKŲ;4255757333;Ne;10;1;0;11
17854;Vilkpėdės;KODĖLČIUKŲ;1063561954;Taip;5;6;0;11
17855;Vilkpėdės;KODĖLČIUKŲ;5053032081;Taip;0;1;0;1
17856;Vilkpėdės;KODĖLČIUKŲ;6778288398;Ne;7;1;0;8
17857;Žiburėlis;Nykštukai;6696156248;Taip;0;1;0;1
17858;Žiburėlis;Nykštukai;7163594513;Taip;9;1;0;10
17859;Žiburėlis;Nykštukai;5174211773;Taip;0;2;0;2
17860;Žiburėlis;Nykštukai;5408766721;Taip;7;1;0;8
17861;Žiburėlis;Nykštukai;3646988912;Taip;0;2;0;2
17862;Žiburėlis;Nykštukai;7211961512;Taip;0;1;0;1
17863;Žiburėlis;Nykštukai;7862546963;Taip;0;2;0;2
17864;Žiburėlis;Nykštukai;8902837168;Taip;0;2;0;2
17865;Žiburėlis;Nykštukai;7465939429;Taip;5;4;0;9
17866;Žiburėlis;Nykštukai;7307386173;Taip;13;1;0;14
17867;Žiburėlis;Nykštukai;8215816053;Taip;0;1;0;1
17868;Žiburėlis;Nykštukai;4710995351;Taip;0;2;0;2
17869;Žiburėlis;Nykštukai;7633450988;Ne;8;3;0;11
17870;Žiburėlis;Nykštukai;2292895729;Taip;0;7;0;7
17871;Žiburėlis;Nykštukai;7273838695;Taip;0;3;1;4
17872;Žiburėlis;Nykštukai;9806454408;Ne;5;11;0;16
17873;Žiburėlis;Nykštukai;3938379566;Taip;8;1;0;9
17874;Žiburėlis;Nykštukai;9932264675;Taip;0;2;0;2
17875;Žiburėlis;Nykštukai;8480167191;Taip;0;6;0;6
17876;Žiburėlis;Nykštukai;1559091567;Taip;0;7;0;7
17877;Žiburėlis;Nykštukai;3750024153;Taip;0;7;0;7
17878;Žiburėlis;"Žiniukai ";5816890413;Taip;13;1;0;14
17879;Žiburėlis;"Žiniukai ";2624326930;Taip;20;1;0;21
17880;Žiburėlis;"Žiniukai ";6300247811;Taip;0;1;0;1
17881;Žiburėlis;"Žiniukai ";3033049328;Taip;0;3;0;3
17882;Žiburėlis;"Žiniukai ";3262856058;Taip;0;1;0;1
17883;Žiburėlis;"Žiniukai ";7424129974;Taip;5;1;0;6
17884;Žiburėlis;"Žiniukai ";4187381976;Taip;1;3;0;4
17885;Žiburėlis;"Žiniukai ";5006361324;Taip;8;1;0;9
17886;Žiburėlis;"Žiniukai ";2956339420;Taip;14;3;0;17
17887;Žiburėlis;"Žiniukai ";2999365435;Ne;0;2;0;2
17888;Žiburėlis;"Žiniukai ";7070952018;Taip;0;4;0;4
17889;Žiburėlis;"Žiniukai ";8438876806;Taip;0;6;0;6
17890;Žiburėlis;"Žiniukai ";3687703187;Ne;8;1;0;9
17891;Žiburėlis;"Žiniukai ";8535429783;Taip;5;1;0;6
17892;Žiburėlis;"Žiniukai ";1543314096;Taip;15;0;0;15
17893;Žiburėlis;"Žiniukai ";1061646244;Ne;0;2;0;2
17894;Žiburėlis;"Žiniukai ";2741301903;Ne;5;1;0;6
17895;Žiburėlis;"Smalsiukai ";5438697081;Taip;4;1;1;6
17896;Žiburėlis;"Smalsiukai ";1126972447;Ne;8;2;0;10
17897;Žiburėlis;"Smalsiukai ";5114554577;Taip;0;6;0;6
17898;Žiburėlis;"Smalsiukai ";3936418539;Taip;7;0;0;7
17899;Žiburėlis;"Smalsiukai ";2072972990;Taip;6;0;0;6
17900;Žiburėlis;"Smalsiukai ";3835820013;Taip;0;1;0;1
17901;Žiburėlis;"Smalsiukai ";4355778076;Taip;5;1;0;6
17902;Žiburėlis;"Smalsiukai ";92490398630;Taip;0;1;0;1
17903;Žiburėlis;"Smalsiukai ";67168630669;Taip;0;1;0;1
17904;Žiburėlis;"Smalsiukai ";9253393819;Taip;0;1;0;1
17905;Žiburėlis;"Smalsiukai ";1599112927;Taip;3;3;0;6
17906;Žiburėlis;"Smalsiukai ";2796489509;Taip;0;1;0;1
17907;Žiburėlis;"Smalsiukai ";18739941845;Taip;0;1;0;1
17908;Žiburėlis;"Smalsiukai ";24639355056;Taip;0;1;0;1
17909;Žiburėlis;"Smalsiukai ";6519139977;Taip;0;18;0;18
17910;Žiburėlis;"Smalsiukai ";7861704875;Taip;5;1;0;6
17911;Žiburėlis;"Smalsiukai ";34873231652;Taip;6;3;0;9
17912;Žiburėlis;"Smalsiukai ";1125662904;Taip;8;2;0;10
17913;Žiburėlis;"Smalsiukai ";2175751377;Ne;0;1;2;3
17914;Žiburėlis;"Smalsiukai ";28985997205;Taip;4;4;0;8
17915;Žiburėlis;"Giliukai ";7310274376;Taip;0;3;0;3
17916;Žiburėlis;"Giliukai ";1090883494;Ne;13;0;0;13
17917;Žiburėlis;"Giliukai ";9215654134;Taip;0;1;0;1
17918;Žiburėlis;"Giliukai ";2866098551;Ne;16;0;0;16
17919;Žiburėlis;"Giliukai ";6918525245;Ne;7;2;0;9
17920;Žiburėlis;"Giliukai ";6946621147;Taip;0;6;0;6
17921;Žiburėlis;"Giliukai ";5148264064;Ne;6;4;0;10
17922;Žiburėlis;"Giliukai ";6733333096;Ne;10;1;0;11
17923;Žiburėlis;"Giliukai ";1943162133;Taip;0;1;0;1
17924;Žiburėlis;"Giliukai ";6232492947;Taip;2;1;0;3
17925;Žiburėlis;"Giliukai ";3807588865;Ne;10;0;0;10
17926;Žiburėlis;"Giliukai ";4016969144;Taip;0;9;0;9
17927;Žiburėlis;"Giliukai ";3776569251;Taip;9;2;0;11
17928;Žiburėlis;"Giliukai ";9494271740;Taip;5;3;0;8
17929;Žiburėlis;"Giliukai ";3992503848;Taip;4;2;0;6
17930;Žiburėlis;"Giliukai ";8440073413;Taip;2;0;0;2
17931;Žiburėlis;"Giliukai ";6121237159;Taip;2;0;0;2
17932;Žiburėlis;"Giliukai ";6289338466;Taip;3;1;0;4
17933;Žiburėlis;"Giliukai ";7977098545;Taip;1;0;0;1
17934;Žiburėlis;"Giliukai ";2990465012;Taip;6;0;0;6
17935;Žiburėlis;Meškiukai;3593851196;Taip;5;1;0;6
17936;Žiburėlis;Meškiukai;9470154520;Taip;10;3;0;13
17937;Žiburėlis;Meškiukai;2285666668;Ne;5;0;1;6
17938;Žiburėlis;Meškiukai;2836519241;Taip;13;0;0;13
17939;Žiburėlis;Meškiukai;9731661697;Ne;6;0;0;6
17940;Žiburėlis;Meškiukai;2186032732;Taip;5;1;0;6
17941;Žiburėlis;Meškiukai;9321467329;Taip;13;0;0;13
17942;Žiburėlis;Meškiukai;2254407798;Taip;1;1;1;3
17943;Žiburėlis;Meškiukai;4887304311;Taip;6;0;1;7
17944;Žiburėlis;Meškiukai;1651713696;Taip;4;1;0;5
17945;Žiburėlis;Meškiukai;1105220246;Taip;0;0;3;3
17946;Žiburėlis;Meškiukai;8415647388;Taip;5;4;0;9
17947;Žiburėlis;Meškiukai;2371990135;Taip;0;0;4;4
17948;Žiburėlis;Meškiukai;6218255066;Taip;17;1;0;18
17949;Žiburėlis;Meškiukai;3522480911;Taip;10;0;2;12
17950;Žiburėlis;Meškiukai;5683969627;Taip;15;0;0;15
17951;Žiburėlis;Meškiukai;4667559315;Taip;3;2;0;5
17952;Žiburėlis;Viščiukai;7485768254;Taip;20;0;0;20
17953;Žiburėlis;Viščiukai;7364102991;Taip;18;0;0;18
17954;Žiburėlis;Viščiukai;2506620539;Taip;20;0;0;20
17955;Žiburėlis;Viščiukai;9553194981;Taip;20;0;0;20
17956;Žiburėlis;Viščiukai;8179414341;Taip;1;0;0;1
17957;Žiburėlis;Viščiukai;7140031765;Taip;13;0;0;13
17958;Žiburėlis;Viščiukai;1758251348;Taip;0;1;0;1
17959;Žiburėlis;Viščiukai;1121755119;Taip;7;1;0;8
17960;Žiburėlis;Viščiukai;3738184802;Taip;18;0;0;18
17961;Žiburėlis;Viščiukai;8603154782;Taip;11;1;0;12
17962;Žiburėlis;Viščiukai;4727673956;Taip;9;0;0;9
17963;Žiburėlis;Viščiukai;1606332622;Ne;17;0;0;17
17964;Žiburėlis;Viščiukai;8284913889;Taip;10;0;0;10
17965;Žiburėlis;Viščiukai;2851350451;Taip;12;1;0;13
17966;Žiburėlis;Viščiukai;6206770019;Taip;1;1;3;5
17967;Žiburėlis;Viščiukai;5314676261;Taip;13;0;0;13
17968;Žiburėlis;"Drambliukai ";5724506894;Taip;3;1;0;4
17969;Žiburėlis;"Drambliukai ";2102574423;Taip;0;1;0;1
17970;Žiburėlis;"Drambliukai ";4937518207;Taip;10;1;0;11
17971;Žiburėlis;"Drambliukai ";9041469393;Taip;0;1;0;1
17972;Žiburėlis;"Drambliukai ";8285987095;Taip;3;0;0;3
17973;Žiburėlis;"Drambliukai ";2805244671;Taip;0;2;0;2
17974;Žiburėlis;"Drambliukai ";5025452484;Taip;9;0;0;9
17975;Žiburėlis;"Drambliukai ";9344950711;Taip;9;1;0;10
17976;Žiburėlis;"Drambliukai ";8082088504;Taip;0;1;0;1
17977;Žiburėlis;"Drambliukai ";4656467260;Taip;0;1;0;1
17978;Žiburėlis;"Drambliukai ";9771442035;Ne;7;3;0;10
17979;Žiburėlis;"Drambliukai ";6274583813;Taip;8;0;0;8
17980;Žiburėlis;"Drambliukai ";5194593598;Taip;21;0;0;21
17981;Žiburėlis;"Drambliukai ";3821663597;Taip;15;0;0;15
17982;Žiburėlis;"Drambliukai ";8752098051;Taip;0;2;0;2
17983;Žiburėlis;"Drambliukai ";8207315673;Ne;0;1;0;1
17984;Žiburėlis;"Drambliukai ";6751043071;Taip;13;0;0;13
17985;Žiburėlis;"Drambliukai ";1449541244;Taip;9;0;0;9
17986;Žiburėlis;BORUŽIUKAI;3723613593;Taip;3;0;1;4
17987;Žiburėlis;BORUŽIUKAI;9964255985;Taip;0;0;1;1
17988;Žiburėlis;BORUŽIUKAI;7895148630;Taip;0;0;21;21
17989;Žiburėlis;BORUŽIUKAI;8936912406;Taip;1;0;0;1
17990;Žiburėlis;BORUŽIUKAI;2500898625;Taip;6;0;1;7
17991;Žiburėlis;BORUŽIUKAI;1422951221;Ne;0;2;0;2
17992;Žiburėlis;BORUŽIUKAI;4631232618;Taip;4;0;6;10
17993;Žiburėlis;BORUŽIUKAI;5793531526;Taip;0;10;0;10
17994;Žiburėlis;BORUŽIUKAI;4578828135;Taip;0;0;2;2
17995;Žiburėlis;BORUŽIUKAI;6128571259;Taip;0;0;4;4
17996;Žiburėlis;BORUŽIUKAI;3760039280;Taip;6;1;0;7
17997;Žiburėlis;BORUŽIUKAI;8373944614;Taip;16;0;1;17
17998;Žiburėlis;BORUŽIUKAI;9256751455;Taip;9;0;0;9
17999;Žiburėlis;BORUŽIUKAI;2077823704;Taip;0;0;1;1
18000;Žiburėlis;BORUŽIUKAI;9357376188;Taip;5;0;3;8
18001;Žiburėlis;BORUŽIUKAI;4233222771;Taip;0;2;1;3
18002;Žiburėlis;BORUŽIUKAI;9029039015;Taip;0;0;1;1
18003;Žiburėlis;BORUŽIUKAI;7017574924;Taip;0;0;3;3
18004;Žiburėlis;SPINDULIUKAI;2995697464;Taip;1;1;0;2
18005;Žiburėlis;SPINDULIUKAI;7856708616;Taip;5;2;0;7
18006;Žiburėlis;SPINDULIUKAI;5205959106;Taip;5;1;0;6
18007;Žiburėlis;SPINDULIUKAI;2491972986;Taip;16;4;0;20
18008;Žiburėlis;SPINDULIUKAI;1190058462;Taip;4;3;0;7
18009;Žiburėlis;SPINDULIUKAI;8970153523;Taip;0;0;3;3
18010;Žiburėlis;SPINDULIUKAI;7402647048;Taip;5;1;0;6
18011;Žiburėlis;SPINDULIUKAI;6830200578;Taip;9;2;0;11
18012;Žiburėlis;SPINDULIUKAI;5951659866;Taip;4;2;0;6
18013;Žiburėlis;SPINDULIUKAI;8346571253;Taip;0;1;0;1
18014;Žiburėlis;SPINDULIUKAI;4720567144;Taip;12;1;0;13
18015;Žiburėlis;SPINDULIUKAI;8973307069;Taip;0;1;0;1
18016;Žiburėlis;SPINDULIUKAI;5098955523;Taip;0;12;0;12
18017;Žiburėlis;SPINDULIUKAI;5629404179;Taip;0;1;0;1
18018;Žiburėlis;SPINDULIUKAI;8686565770;Taip;6;3;0;9
18019;Žiburėlis;SPINDULIUKAI;7111530833;Taip;0;1;0;1
18020;Žiburėlis;SPINDULIUKAI;7825665451;Taip;14;2;0;16
18021;Žiburėlis;SPINDULIUKAI;5556807335;Taip;4;3;0;7
18022;Žiburėlis;SPINDULIUKAI;2808361570;Taip;16;1;0;17
18023;Žiburėlis;KIŠKUČIAI;6492467281;Taip;2;1;0;3
18024;Žiburėlis;KIŠKUČIAI;3352845095;Taip;0;1;0;1
18025;Žiburėlis;KIŠKUČIAI;1004953300;Taip;5;2;0;7
18026;Žiburėlis;KIŠKUČIAI;3296994981;Taip;0;8;0;8
18027;Žiburėlis;KIŠKUČIAI;1887550130;Ne;16;2;0;18
18028;Žiburėlis;KIŠKUČIAI;6019278045;Taip;6;1;0;7
18029;Žiburėlis;KIŠKUČIAI;4079793067;Taip;0;1;0;1
18030;Žiburėlis;KIŠKUČIAI;5418413225;Taip;0;2;0;2
18031;Žiburėlis;KIŠKUČIAI;6044837042;Taip;0;1;3;4
18032;Žiburėlis;KIŠKUČIAI;1334695206;Taip;0;1;20;21
18033;Žiburėlis;KIŠKUČIAI;7597762608;Taip;9;1;0;10
18034;Žiburėlis;KIŠKUČIAI;6562748977;Ne;5;1;1;7
18035;Žiburėlis;KIŠKUČIAI;5145195661;Taip;5;1;4;10
18036;Žiburėlis;KIŠKUČIAI;4477396434;Ne;15;3;0;18
18037;Žiburėlis;KIŠKUČIAI;2712358146;Taip;1;0;7;8
18038;Žiburėlis;KIŠKUČIAI;5410394172;Taip;0;1;1;2
18039;Žiburėlis;KIŠKUČIAI;2117995780;Taip;15;1;0;16
18040;Žiburėlis;KIŠKUČIAI;4003368130;Taip;8;0;1;9
18041;Žiburėlis;KIŠKUČIAI;2456703958;Taip;8;1;0;9
18042;Žiburėlis;KIŠKUČIAI;1868558773;Taip;11;1;0;12
18043;Žiburėlis;KIŠKUČIAI;2083500905;Taip;0;3;2;5
18044;Žiburėlis;KIŠKUČIAI;6577061306;Taip;0;1;2;3
18045;Žiburėlis;DRUGELIAI;9783567484;Ne;8;1;0;9
18046;Žiburėlis;DRUGELIAI;4109288891;Ne;0;2;13;15
18047;Žiburėlis;DRUGELIAI;1015624216;Taip;10;2;0;12
18048;Žiburėlis;DRUGELIAI;9526477121;Ne;13;1;0;14
18049;Žiburėlis;DRUGELIAI;4387021429;Taip;0;6;0;6
18050;Žiburėlis;DRUGELIAI;8018718405;Taip;5;6;0;11
18051;Žiburėlis;DRUGELIAI;4910787530;Taip;0;16;0;16
18052;Žiburėlis;DRUGELIAI;5324852807;Ne;6;3;0;9
18053;Žiburėlis;DRUGELIAI;4916545915;Taip;0;4;0;4
18054;Žiburėlis;DRUGELIAI;8133371774;Taip;12;4;0;16
18055;Žiburėlis;DRUGELIAI;7278242428;Taip;8;1;0;9
18056;Žiburėlis;DRUGELIAI;5732540560;Ne;0;6;0;6
18057;Žiburėlis;DRUGELIAI;1833704617;Ne;3;0;0;3
18058;Žiburėlis;DRUGELIAI;2163018032;Taip;0;6;0;6
18059;Žiburėlis;DRUGELIAI;4581800760;Taip;1;0;0;1
18060;Bangelė;Aštuonkojai;6026399355;Taip;0;1;3;4
18061;Bangelė;Aštuonkojai;5476753511;Taip;0;0;2;2
18062;Bangelė;Aštuonkojai;9168310196;Taip;8;3;0;11
18063;Bangelė;Aštuonkojai;1351714626;Taip;5;0;0;5
18064;Bangelė;Aštuonkojai;1754002501;Taip;0;0;1;1
18065;Bangelė;Aštuonkojai;8336001702;Ne;0;1;0;1
18066;Bangelė;Aštuonkojai;8875703109;Taip;0;3;0;3
18067;Bangelė;Aštuonkojai;6953698592;Ne;0;0;1;1
18068;Bangelė;Aštuonkojai;3063439996;Taip;0;5;0;5
18069;Bangelė;Aštuonkojai;2156837975;Taip;0;0;1;1
18070;Bangelė;Aštuonkojai;9143945953;Taip;0;1;0;1
18071;Bangelė;Aštuonkojai;3022508446;Ne;0;0;2;2
18072;Bangelė;Aštuonkojai;5546256869;Taip;5;0;2;7
18073;Bangelė;Aštuonkojai;6980232224;Ne;3;0;2;5
18074;Bangelė;Aštuonkojai;6145050734;Taip;0;2;0;2
18075;Bangelė;Aštuonkojai;1390623903;Taip;0;7;0;7
18076;Bangelė;Aštuonkojai;9788923823;Taip;6;10;0;16
18077;Bangelė;Aštuonkojai;7136625230;Taip;0;11;1;12
18078;Bangelė;Aštuonkojai;6216334243;Taip;0;1;0;1
18079;Bangelė;Delfinukai,;3471355267;Taip;3;0;0;3
18080;Bangelė;Delfinukai,;6978215876;Taip;4;0;2;6
18081;Bangelė;Delfinukai,;7434358474;Taip;10;7;0;17
18082;Bangelė;Delfinukai,;2575806242;Taip;0;0;1;1
18083;Bangelė;Delfinukai,;7434879947;Taip;0;0;1;1
18084;Bangelė;Delfinukai,;5994720767;Taip;0;2;0;2
18085;Bangelė;Delfinukai,;4532810332;Taip;0;0;3;3
18086;Bangelė;Delfinukai,;4036461205;Taip;0;2;0;2
18087;Bangelė;Delfinukai,;3344441441;Taip;6;1;1;8
18088;Bangelė;Delfinukai,;2858929915;Taip;0;0;1;1
18089;Bangelė;Delfinukai,;7068305612;Taip;17;0;0;17
18090;Bangelė;Delfinukai,;4412780063;Taip;10;2;0;12
18091;Bangelė;Delfinukai,;9608900293;Taip;5;0;0;5
18092;Bangelė;Delfinukai,;4080993439;Taip;0;2;0;2
18093;Bangelė;"Saulės spindulėliai";55668308050;Taip;0;12;0;12
18094;Bangelė;"Saulės spindulėliai";9150185864;Taip;0;0;5;5
18095;Bangelė;"Saulės spindulėliai";2863118434;Ne;7;3;0;10
18096;Bangelė;"Saulės spindulėliai";9167286651;Taip;13;1;1;15
18097;Bangelė;"Saulės spindulėliai";43740476077;Taip;0;4;0;4
18098;Bangelė;"Saulės spindulėliai";9846780259;Ne;0;0;4;4
18099;Bangelė;"Saulės spindulėliai";1377734102;Taip;3;1;0;4
18100;Bangelė;"Saulės spindulėliai";5950451237;Taip;0;3;0;3
18101;Bangelė;"Saulės spindulėliai";9488932192;Taip;0;5;0;5
18102;Bangelė;"Saulės spindulėliai";1728085772;Ne;5;1;0;6
18103;Bangelė;"Saulės spindulėliai";1447396084;Taip;0;1;0;1
18104;Bangelė;"Saulės spindulėliai";6173470021;Taip;0;1;0;1
18105;Bangelė;"Saulės spindulėliai";6927540308;Ne;0;0;2;2
18106;Bangelė;"Saulės spindulėliai";9464115339;Taip;10;1;0;11
18107;Bangelė;"Saulės spindulėliai";4122927034;Ne;3;5;0;8
18108;Bangelė;"Saulės spindulėliai";3338203753;Taip;0;3;0;3
18109;Bangelė;"Saulės spindulėliai";3206495858;Taip;7;1;0;8
18110;Bangelė;"Saulės spindulėliai";7861208185;Taip;7;1;0;8
18111;Bangelė;"Saulės spindulėliai";2027892816;Taip;0;1;0;1
18112;Bangelė;"Saulės spindulėliai";2503946448;Taip;5;1;0;6
18113;Bangelė;"Saulės spindulėliai";2872188915;Ne;9;1;1;11
18114;Bangelė;"Saulės spindulėliai";3132827429;Taip;4;1;0;5
18115;Bangelė;"Pingvinukai ";2518820268;Ne;5;0;0;5
18116;Bangelė;"Pingvinukai ";4317054990;Taip;0;1;0;1
18117;Bangelė;"Pingvinukai ";8943721679;Taip;12;0;0;12
18118;Bangelė;"Pingvinukai ";6566277472;Taip;6;0;3;9
18119;Bangelė;"Pingvinukai ";7362196984;Ne;11;0;1;12
18120;Bangelė;"Pingvinukai ";4940247006;Taip;7;1;0;8
18121;Bangelė;"Pingvinukai ";8335931279;Taip;0;2;0;2
18122;Bangelė;"Pingvinukai ";9311379746;Taip;0;0;1;1
18123;Bangelė;"Pingvinukai ";9955097720;Taip;9;0;0;9
18124;Bangelė;"Pingvinukai ";4851593235;Taip;5;0;1;6
18125;Bangelė;"Pingvinukai ";8998648968;Taip;0;1;0;1
18126;Bangelė;"Pingvinukai ";7016039389;Taip;0;3;0;3
18127;Bangelė;"Pingvinukai ";2127734178;Taip;0;0;1;1
18128;Bangelė;"Pingvinukai ";2107766301;Taip;11;0;0;11
18129;Bangelė;"Pingvinukai ";5237434283;Taip;11;1;0;12
18130;Bangelė;"Pingvinukai ";4651237403;Taip;5;0;0;5
18131;Bangelė;"Jūros žvaigždutės ";5673493708;Taip;6;2;0;8
18132;Bangelė;"Jūros žvaigždutės ";9447145378;Taip;0;3;0;3
18133;Bangelė;"Jūros žvaigždutės ";4086446380;Taip;8;3;0;11
18134;Bangelė;"Jūros žvaigždutės ";8745595583;Ne;8;1;0;9
18135;Bangelė;"Jūros žvaigždutės ";9268294844;Taip;0;1;1;2
18136;Bangelė;"Jūros žvaigždutės ";5229147553;Taip;0;0;2;2
18137;Bangelė;"Jūros žvaigždutės ";4831656996;Taip;0;0;5;5
18138;Bangelė;"Jūros žvaigždutės ";9267349375;Taip;0;12;0;12
18139;Bangelė;"Jūros žvaigždutės ";3069288815;Taip;8;0;2;10
18140;Bangelė;"Jūros žvaigždutės ";9729929020;Taip;10;0;0;10
18141;Bangelė;"Jūros žvaigždutės ";8563674709;Taip;13;1;0;14
18142;Bangelė;"Jūros žvaigždutės ";6705583340;Taip;10;0;1;11
18143;Bangelė;"Jūros žvaigždutės ";2662758502;Taip;15;1;0;16
18144;Bangelė;"Jūros žvaigždutės ";6174617493;Taip;5;0;4;9
18145;Bangelė;"Jūros žvaigždutės ";9633372201;Ne;9;2;0;11
18146;Bangelė;"Jūros žvaigždutės ";8075810032;Taip;0;6;0;6
18147;Bangelė;"Jūros žvaigždutės ";3500097405;Taip;21;0;0;21
18148;Bangelė;Žuvytės;9009809585;Ne;14;1;0;15
18149;Bangelė;Žuvytės;6496580354;Taip;15;0;1;16
18150;Bangelė;Žuvytės;6480681705;Taip;0;3;0;3
18151;Bangelė;Žuvytės;7142694888;Ne;5;0;4;9
18152;Bangelė;Žuvytės;8734511431;Taip;0;2;0;2
18153;Bangelė;Žuvytės;9765268154;Taip;4;9;0;13
18154;Bangelė;Žuvytės;8495423628;Taip;13;0;1;14
18155;Bangelė;Žuvytės;7419016784;Ne;3;0;5;8
18156;Bangelė;Žuvytės;5190563034;Taip;13;0;0;13
18157;Bangelė;Žuvytės;3991021350;Taip;1;0;3;4
18158;Bangelė;Žuvytės;9954762483;Taip;5;2;0;7
18159;Bangelė;Žuvytės;9493465898;Ne;10;1;0;11
18160;Bangelė;Žuvytės;5597329949;Taip;11;0;0;11
18161;Bangelė;Žuvytės;2134225414;Taip;5;0;0;5
18162;Bangelė;Žuvytės;4494049529;Taip;5;0;2;7
18163;Bangelė;Žuvytės;3334029244;Taip;5;0;0;5
18164;Bangelė;Žuvytės;6165322599;Taip;0;8;0;8
18165;Bangelė;Žuvytės;1898671487;Taip;5;1;1;7
18166;Bangelė;Žuvytės;7174742281;Taip;21;0;0;21
18167;Bangelė;Žuvytės;6806911810;Ne;1;0;4;5
18168;Bangelė;Ruoniai;8149880453;Taip;0;4;0;4
18169;Bangelė;Ruoniai;8836861853;Taip;0;1;0;1
18170;Bangelė;Ruoniai;4571869439;Taip;0;3;0;3
18171;Bangelė;Ruoniai;9672505885;Taip;0;1;2;3
18172;Bangelė;Ruoniai;8990701154;Taip;6;0;4;10
18173;Bangelė;Ruoniai;6861123988;Taip;0;3;0;3
18174;Bangelė;Ruoniai;7233139048;Taip;0;1;0;1
18175;Bangelė;Ruoniai;6044653707;Taip;0;9;0;9
18176;Bangelė;Ruoniai;1915827035;Taip;0;9;0;9
18177;Bangelė;Ruoniai;7685394517;Taip;0;0;1;1
18178;Bangelė;Ruoniai;9041585534;Taip;0;1;0;1
18179;Bangelė;Ruoniai;9706351115;Taip;0;1;0;1
18180;Bangelė;Ruoniai;6693019825;Taip;0;5;0;5
18181;Bangelė;Ruoniai;2764009011;Taip;1;0;0;1
18182;Bangelė;Ruoniai;4338067260;Taip;11;0;3;14
18183;Bangelė;Ruoniai;8758933649;Taip;12;0;1;13
18184;Bangelė;Ruoniai;3900236858;Taip;0;1;0;1
18185;Bangelė;Ruoniai;7230987338;Taip;0;3;1;4
18186;Bangelė;Ruoniai;7337449523;Taip;4;0;1;5
18187;Bangelė;Ruoniai;1528387105;Taip;0;6;0;6
18188;Bangelė;Ruoniai;6712145066;Taip;0;0;4;4
18189;Bangelė;"Pagrandukai ";9561221619;Taip;0;5;0;5
18190;Bangelė;"Pagrandukai ";9128326823;Taip;1;0;1;2
18191;Bangelė;"Pagrandukai ";9992207035;Ne;21;0;0;21
18192;Bangelė;"Pagrandukai ";5625257865;Taip;0;0;2;2
18193;Bangelė;"Pagrandukai ";6415607960;Taip;7;0;2;9
18194;Bangelė;"Pagrandukai ";1182624046;Taip;0;6;0;6
18195;Bangelė;"Pagrandukai ";9355348960;Taip;16;0;0;16
18196;Bangelė;"Pagrandukai ";1467390411;Taip;0;0;2;2
18197;Bangelė;"Pagrandukai ";2730545639;Taip;10;0;1;11
18198;Bangelė;"Pagrandukai ";4041276015;Taip;8;0;0;8
18199;Bangelė;"Pagrandukai ";7503518328;Taip;8;0;2;10
18200;Bangelė;"Pagrandukai ";9010238689;Taip;6;3;0;9
18201;Bangelė;"Pagrandukai ";5829865386;Taip;2;0;3;5
18202;Bangelė;"Zuikučiai ";9705672732;Taip;0;0;1;1
18203;Bangelė;"Zuikučiai ";7364368699;Taip;9;1;0;10
18204;Bangelė;"Zuikučiai ";6400785821;Ne;0;3;0;3
18205;Bangelė;"Zuikučiai ";5961647252;Taip;8;1;0;9
18206;Bangelė;"Zuikučiai ";9092263358;Ne;17;0;0;17
18207;Bangelė;"Zuikučiai ";8493650050;Taip;6;4;0;10
18208;Bangelė;"Zuikučiai ";3851738513;Taip;11;0;2;13
18209;Bangelė;"Zuikučiai ";3452984649;Taip;21;0;0;21
18210;Bangelė;"Zuikučiai ";2362345363;Taip;11;0;0;11
18211;Bangelė;"Zuikučiai ";4891131242;Taip;19;0;0;19
18212;Bangelė;"Zuikučiai ";7445583512;Taip;0;4;0;4
18213;Bangelė;"Zuikučiai ";8931569423;Ne;10;0;1;11
18214;Bangelė;"Zuikučiai ";2382714949;Ne;10;0;1;11
18215;Bangelė;"Zuikučiai ";7755966282;Taip;0;1;3;4
18216;Bangelė;"Zuikučiai ";4480762963;Taip;4;0;2;6
18217;Bangelė;"Zuikučiai ";8765892966;Taip;0;5;0;5
18218;Bangelė;Vėžliukai;9142460659;Taip;6;0;0;6
18219;Bangelė;Vėžliukai;7862345122;Taip;10;0;7;17
18220;Bangelė;Vėžliukai;1869389013;Taip;21;0;0;21
18221;Bangelė;Vėžliukai;8243377854;Ne;0;1;0;1
18222;Bangelė;Vėžliukai;2630571748;Taip;7;2;0;9
18223;Bangelė;Vėžliukai;6003859569;Taip;0;2;0;2
18224;Bangelė;Vėžliukai;3978683237;Taip;3;1;0;4
18225;Bangelė;Vėžliukai;5779198855;Taip;11;2;0;13
18226;Bangelė;Vėžliukai;5746189515;Ne;9;1;0;10
18227;Bangelė;Vėžliukai;6312356331;Taip;0;0;3;3
18228;Gėlynas;PAKALNUTĖ;4557380282;Taip;1;10;0;11
18229;Gėlynas;PAKALNUTĖ;6884111634;Taip;1;0;0;1
18230;Gėlynas;PAKALNUTĖ;3470963396;Taip;0;8;0;8
18231;Gėlynas;PAKALNUTĖ;6053841081;Taip;0;4;0;4
18232;Gėlynas;PAKALNUTĖ;2171064300;Taip;12;0;0;12
18233;Gėlynas;PAKALNUTĖ;2404562144;Taip;0;2;0;2
18234;Gėlynas;PAKALNUTĖ;7504469409;Taip;0;2;0;2
18235;Gėlynas;PAKALNUTĖ;8693415786;Taip;0;1;0;1
18236;Gėlynas;PAKALNUTĖ;4366442459;Taip;19;0;0;19
18237;Gėlynas;PAKALNUTĖ;1463783538;Taip;9;0;0;9
18238;Gėlynas;PAKALNUTĖ;7064068912;Ne;10;6;0;16
18239;Gėlynas;PAKALNUTĖ;1822933936;Taip;6;0;0;6
18240;Gėlynas;PAKALNUTĖ;4668195919;Taip;3;1;0;4
18241;Gėlynas;PAKALNUTĖ;8555408466;Ne;0;5;0;5
18242;Gėlynas;PAKALNUTĖ;2377323648;Taip;6;0;0;6
18243;Gėlynas;PAKALNUTĖ;5382148888;Taip;12;1;0;13
18244;Gėlynas;PAKALNUTĖ;6296728638;Taip;10;0;0;10
18245;Gėlynas;PAKALNUTĖ;5826067446;Taip;4;0;0;4
18246;Gėlynas;PAKALNUTĖ;2273705177;Ne;19;0;0;19
18247;Gėlynas;PAKALNUTĖ;2520140743;Taip;4;0;0;4
18248;Gėlynas;VARPELIS;2769668641;Taip;0;5;0;5
18249;Gėlynas;VARPELIS;1004866224;Taip;6;1;0;7
18250;Gėlynas;VARPELIS;2417880374;Taip;0;1;5;6
18251;Gėlynas;VARPELIS;4382465307;Taip;0;5;0;5
18252;Gėlynas;VARPELIS;5135747448;Taip;0;1;0;1
18253;Gėlynas;VARPELIS;1754734306;Taip;0;2;0;2
18254;Gėlynas;VARPELIS;1774829898;Taip;8;6;1;15
18255;Gėlynas;VARPELIS;7562201835;Taip;0;1;0;1
18256;Gėlynas;VARPELIS;4445250490;Taip;0;0;3;3
18257;Gėlynas;VARPELIS;2132298690;Taip;0;6;0;6
18258;Gėlynas;VARPELIS;7877521812;Taip;0;1;0;1
18259;Gėlynas;VARPELIS;8464074679;Taip;0;1;3;4
18260;Gėlynas;VARPELIS;9911225363;Taip;4;1;1;6
18261;Gėlynas;VARPELIS;5395474698;Ne;3;1;2;6
18262;Gėlynas;VARPELIS;1257113113;Taip;0;1;1;2
18263;Gėlynas;VARPELIS;3365442661;Taip;6;1;1;8
18264;Gėlynas;VARPELIS;5145396320;Taip;0;15;0;15
18265;Gėlynas;VARPELIS;90046802421;Taip;0;1;1;2
18266;Gėlynas;VARPELIS;7814357385;Ne;0;3;1;4
18267;Gėlynas;VARPELIS;1674569569;Taip;0;2;0;2
18268;Gėlynas;VARPELIS;1036951275;Ne;0;1;1;2
18269;Gėlynas;VARPELIS;7808971151;Taip;0;1;1;2
18270;Gėlynas;VARPELIS;4916885450;Taip;11;1;2;14
18271;Gėlynas;RAKTAŽOLĖ;3572020585;Taip;0;1;0;1
18272;Gėlynas;RAKTAŽOLĖ;5634213306;Taip;0;0;1;1
18273;Gėlynas;RAKTAŽOLĖ;3491517766;Taip;0;4;0;4
18274;Gėlynas;RAKTAŽOLĖ;4505012978;Ne;0;3;0;3
18275;Gėlynas;RAKTAŽOLĖ;5541707540;Taip;9;0;0;9
18276;Gėlynas;RAKTAŽOLĖ;5124029118;Taip;1;8;0;9
18277;Gėlynas;RAKTAŽOLĖ;9508507084;Taip;4;0;0;4
18278;Gėlynas;RAKTAŽOLĖ;8999346908;Taip;2;2;0;4
18279;Gėlynas;RAKTAŽOLĖ;8458276300;Taip;0;2;0;2
18280;Gėlynas;RAKTAŽOLĖ;9382160515;Ne;0;3;0;3
18281;Gėlynas;RAKTAŽOLĖ;7730322729;Taip;2;2;0;4
18282;Gėlynas;RAKTAŽOLĖ;2348787949;Taip;0;1;1;2
18283;Gėlynas;RAKTAŽOLĖ;6528464599;Taip;13;2;0;15
18284;Gėlynas;RAKTAŽOLĖ;8615943743;Taip;5;2;0;7
18285;Gėlynas;RAKTAŽOLĖ;7389502638;Ne;14;1;0;15
18286;Gėlynas;RAKTAŽOLĖ;1590299264;Taip;0;7;0;7
18287;Gėlynas;RAKTAŽOLĖ;5751256561;Taip;17;0;0;17
18288;Gėlynas;RAKTAŽOLĖ;1015554617;Taip;1;1;0;2
18289;Gėlynas;RAKTAŽOLĖ;9252696260;Taip;6;0;0;6
18290;Gėlynas;RAKTAŽOLĖ;8444505017;Taip;6;3;0;9
18291;Gėlynas;RAKTAŽOLĖ;5695333666;Taip;0;1;0;1
18292;Gėlynas;SAULĖGRĄŽA;1505666690;Taip;1;0;3;4
18293;Gėlynas;SAULĖGRĄŽA;3492361041;Taip;5;1;0;6
18294;Gėlynas;SAULĖGRĄŽA;6451922757;Taip;0;2;5;7
18295;Gėlynas;SAULĖGRĄŽA;2141722631;Taip;0;4;0;4
18296;Gėlynas;SAULĖGRĄŽA;2742456983;Taip;10;0;1;11
18297;Gėlynas;SAULĖGRĄŽA;4983822000;Taip;0;0;4;4
18298;Gėlynas;SAULĖGRĄŽA;3549079170;Taip;0;1;0;1
18299;Gėlynas;SAULĖGRĄŽA;9305282699;Taip;11;1;0;12
18300;Gėlynas;SAULĖGRĄŽA;6815740588;Taip;3;0;1;4
18301;Gėlynas;SAULĖGRĄŽA;3606076029;Taip;4;5;0;9
18302;Gėlynas;SAULĖGRĄŽA;5964419627;Taip;5;0;0;5
18303;Gėlynas;SAULĖGRĄŽA;4824667762;Taip;0;2;0;2
18304;Gėlynas;SAULĖGRĄŽA;9330385153;Taip;3;3;0;6
18305;Gėlynas;SAULĖGRĄŽA;9724668402;Taip;0;4;0;4
18306;Gėlynas;SAULĖGRĄŽA;9462822190;Taip;3;10;0;13
18307;Gėlynas;SAULĖGRĄŽA;2784709117;Taip;1;0;1;2
18308;Gėlynas;SAULĖGRĄŽA;6114995335;Taip;2;0;0;2
18309;Gėlynas;SAULĖGRĄŽA;5291444399;Taip;0;0;1;1
18310;Gėlynas;SAULĖGRĄŽA;5320531856;Taip;10;0;0;10
18311;Gėlynas;SAULĖGRĄŽA;7998013477;Taip;0;1;0;1
18312;Gėlynas;SAULĖGRĄŽA;6244314445;Taip;10;1;0;11
18313;Gėlynas;RAMUNĖLĖ;1665668966;Taip;15;0;0;15
18314;Gėlynas;RAMUNĖLĖ;9707677931;Taip;8;0;0;8
18315;Gėlynas;RAMUNĖLĖ;1235384604;Taip;0;3;0;3
18316;Gėlynas;RAMUNĖLĖ;9230984365;Taip;0;0;2;2
18317;Gėlynas;RAMUNĖLĖ;5813156578;Taip;12;3;0;15
18318;Gėlynas;RAMUNĖLĖ;6221721945;Taip;2;0;4;6
18319;Gėlynas;RAMUNĖLĖ;7005278902;Taip;6;0;2;8
18320;Gėlynas;RAMUNĖLĖ;1468588114;Taip;0;3;0;3
18321;Gėlynas;RAMUNĖLĖ;6790040590;Ne;10;0;0;10
18322;Gėlynas;RAMUNĖLĖ;4854709904;Taip;6;6;0;12
18323;Gėlynas;RAMUNĖLĖ;2434552926;Ne;10;2;0;12
18324;Gėlynas;RAMUNĖLĖ;1570975863;Taip;13;0;0;13
18325;Gėlynas;RAMUNĖLĖ;8550986498;Taip;10;0;0;10
18326;Gėlynas;RAMUNĖLĖ;6342888072;Ne;9;6;0;15
18327;Gėlynas;RAMUNĖLĖ;9973824348;Ne;16;0;0;16
18328;Gėlynas;RAMUNĖLĖ;1681208354;Taip;0;0;6;6
18329;Gėlynas;ŽIBUTĖ;4192292896;Taip;10;6;0;16
18330;Gėlynas;ŽIBUTĖ;6826311903;Taip;1;2;0;3
18331;Gėlynas;ŽIBUTĖ;8447789767;Taip;10;2;0;12
18332;Gėlynas;ŽIBUTĖ;1862266440;Taip;12;0;2;14
18333;Gėlynas;ŽIBUTĖ;3746597878;Taip;2;4;0;6
18334;Gėlynas;ŽIBUTĖ;9182072776;Taip;8;0;0;8
18335;Gėlynas;ŽIBUTĖ;4292724541;Taip;6;2;0;8
18336;Gėlynas;ŽIBUTĖ;8681345327;Taip;4;2;0;6
18337;Gėlynas;ŽIBUTĖ;7988094745;Taip;0;0;2;2
18338;Gėlynas;ŽIBUTĖ;9552677108;Taip;16;2;0;18
18339;Gėlynas;ŽIBUTĖ;2608369575;Taip;16;2;0;18
18340;Gėlynas;ŽIBUTĖ;1949260962;Taip;12;2;0;14
18341;Gėlynas;ŽIBUTĖ;6635004996;Taip;13;2;0;15
18342;Gėlynas;ŽIBUTĖ;1556683639;Taip;1;0;0;1
18343;Gėlynas;ŽIBUTĖ;5942466822;Taip;20;0;0;20
18344;Gėlynas;ŽIBUTĖ;2193861056;Taip;3;0;6;9
18345;Gėlynas;ŽIBUTĖ;8743722205;Taip;1;0;1;2
18346;Gėlynas;ŽIBUTĖ;2790269385;Taip;9;0;1;10
18347;Gėlynas;ŽIBUTĖ;2885148633;Taip;14;0;0;14
18348;Obelėlė;Gudručiai;2014314139;Ne;21;0;0;21
18349;Obelėlė;Gudručiai;9900484892;Taip;5;1;0;6
18350;Obelėlė;Gudručiai;6145113624;Taip;10;0;1;11
18351;Obelėlė;Gudručiai;9586720282;Taip;1;0;6;7
18352;Obelėlė;Gudručiai;9567704282;Taip;4;0;0;4
18353;Obelėlė;Gudručiai;4015702815;Taip;21;0;0;21
18354;Obelėlė;Gudručiai;5141585309;Taip;5;0;0;5
18355;Obelėlė;Gudručiai;9736557012;Taip;0;0;3;3
18356;Obelėlė;Gudručiai;6720058972;Taip;6;0;0;6
18357;Obelėlė;Gudručiai;2053807216;Taip;16;0;0;16
18358;Obelėlė;Gudručiai;2204293216;Ne;0;16;0;16
18359;Obelėlė;Gudručiai;1184082097;Taip;21;0;0;21
18360;Obelėlė;Gudručiai;2533715287;Taip;0;0;1;1
18361;Obelėlė;Gudručiai;1312484983;Taip;19;0;0;19
18362;Obelėlė;Gudručiai;1565630870;Taip;0;6;0;6
18363;Obelėlė;Gudručiai;1598785483;Taip;9;2;0;11
18364;Obelėlė;Pasakaitė;1695933896;Ne;21;0;0;21
18365;Obelėlė;Pasakaitė;1555780072;Taip;3;1;0;4
18366;Obelėlė;Pasakaitė;77743243622;Taip;4;1;0;5
18367;Obelėlė;Pasakaitė;1543298097;Taip;3;1;0;4
18368;Obelėlė;Pasakaitė;79601449969;Taip;0;1;0;1
18369;Obelėlė;Pasakaitė;3330983614;Taip;0;1;0;1
18370;Obelėlė;Pasakaitė;4257479486;Taip;0;0;4;4
18371;Obelėlė;Pasakaitė;8394566707;Taip;0;1;1;2
18372;Obelėlė;Pasakaitė;9527363918;Taip;0;1;2;3
18373;Obelėlė;Pasakaitė;10939948244;Taip;0;1;4;5
18374;Obelėlė;Pasakaitė;1707652145;Taip;0;1;0;1
18375;Obelėlė;Pasakaitė;1141707374;Taip;0;1;0;1
18376;Obelėlė;Pasakaitė;6789881144;Taip;3;1;0;4
18377;Obelėlė;Pasakaitė;6036130112;Taip;0;1;5;6
18378;Obelėlė;Pasakaitė;1893470952;Taip;0;1;3;4
18379;Obelėlė;Pasakaitė;7754276632;Taip;0;21;0;21
18380;Obelėlė;Pasakaitė;69055416041;Taip;0;1;3;4
18381;Obelėlė;Pasakaitė;3517342646;Taip;5;0;1;6
18382;Obelėlė;Pasakaitė;4220808775;Taip;0;0;3;3
18383;Obelėlė;Pasakaitė;1507072248;Taip;0;1;3;4
18384;Obelėlė;Pasakaitė;7934760271;Taip;6;0;1;7
18385;Obelėlė;Svajokliai;9981446556;Taip;3;1;3;7
18386;Obelėlė;Svajokliai;4849499826;Taip;9;0;1;10
18387;Obelėlė;Svajokliai;1469593267;Taip;7;1;1;9
18388;Obelėlė;Svajokliai;9819048265;Ne;5;0;4;9
18389;Obelėlė;Svajokliai;1010954005;Taip;8;0;2;10
18390;Obelėlė;Svajokliai;4489212434;Taip;17;0;0;17
18391;Obelėlė;Svajokliai;5620250331;Taip;1;0;1;2
18392;Obelėlė;Svajokliai;1705232474;Taip;0;0;1;1
18393;Obelėlė;Svajokliai;5588467580;Taip;9;1;4;14
18394;Obelėlė;Svajokliai;7094715237;Taip;0;21;0;21
18395;Obelėlė;Svajokliai;9070960601;Taip;0;1;0;1
18396;Obelėlė;Svajokliai;8231489868;Taip;6;1;0;7
18397;Obelėlė;Svajokliai;3986892111;Taip;0;1;0;1
18398;Obelėlė;Svajokliai;7003947655;Taip;5;1;0;6
18399;Obelėlė;Svajokliai;9641297002;Taip;0;1;0;1
18400;Obelėlė;Svajokliai;8918176312;Taip;0;1;6;7
18401;Obelėlė;Svajokliai;8604451971;Taip;3;0;0;3
18402;Obelėlė;Svajokliai;7794072582;Taip;6;0;0;6
18403;Obelėlė;Svajokliai;6785654280;Taip;0;0;6;6
18404;Obelėlė;Svajokliai;6311322617;Taip;2;1;4;7
18405;Obelėlė;Svajokliai;2813927086;Taip;5;1;0;6
18406;Obelėlė;Smalsučiai;6497584911;Taip;3;5;1;9
18407;Obelėlė;Smalsučiai;7687093936;Taip;0;1;0;1
18408;Obelėlė;Smalsučiai;1469375976;Taip;4;0;0;4
18409;Obelėlė;Smalsučiai;7108517080;Taip;11;0;2;13
18410;Obelėlė;Smalsučiai;4987747783;Taip;5;0;2;7
18411;Obelėlė;Smalsučiai;5085970254;Taip;5;0;1;6
18412;Obelėlė;Smalsučiai;8709758561;Taip;5;0;1;6
18413;Obelėlė;Smalsučiai;4318546408;Taip;0;1;0;1
18414;Obelėlė;Smalsučiai;2631405243;Taip;6;0;1;7
18415;Obelėlė;Smalsučiai;8173307704;Taip;6;0;1;7
18416;Obelėlė;Smalsučiai;9796759067;Taip;7;3;0;10
18417;Obelėlė;Smalsučiai;6720808705;Taip;8;0;1;9
18418;Obelėlė;Smalsučiai;7850656031;Taip;5;0;4;9
18419;Obelėlė;Smalsučiai;9084969712;Taip;6;0;0;6
18420;Obelėlė;Smalsučiai;6364101139;Taip;10;0;0;10
18421;Obelėlė;Smalsučiai;6064646690;Taip;0;0;6;6
18422;Obelėlė;Smalsučiai;8183287212;Taip;6;0;0;6
18423;Obelėlė;Smalsučiai;2574840626;Taip;15;2;0;17
18424;Obelėlė;Smalsučiai;8981403984;Taip;15;0;1;16
18425;Obelėlė;Pabiručiai;5763713052;Taip;0;21;0;21
18426;Obelėlė;Pabiručiai;7667966704;Taip;5;0;0;5
18427;Obelėlė;Pabiručiai;1819480590;Ne;0;0;2;2
18428;Obelėlė;Pabiručiai;8579887226;Taip;16;0;0;16
18429;Obelėlė;Pabiručiai;6946457363;Taip;4;0;1;5
18430;Obelėlė;Pabiručiai;8948297718;Taip;0;0;3;3
18431;Obelėlė;Pabiručiai;3951816174;Taip;8;0;3;11
18432;Obelėlė;Pabiručiai;5599466885;Taip;3;0;5;8
18433;Obelėlė;Pabiručiai;9634414572;Taip;8;0;0;8
18434;Obelėlė;Pabiručiai;2262107831;Taip;0;0;3;3
18435;Obelėlė;Pabiručiai;4851824672;Taip;13;0;0;13
18436;Obelėlė;Pabiručiai;3526079444;Ne;8;0;0;8
18437;Obelėlė;Pabiručiai;9731565368;Taip;0;14;0;14
18438;Obelėlė;Pabiručiai;8827515572;Taip;4;0;0;4
18439;Obelėlė;Pabiručiai;2399173200;Taip;4;10;0;14
18440;Obelėlė;Pabiručiai;8443192155;Taip;16;0;0;16
18441;Obelėlė;Pabiručiai;9627134967;Ne;0;11;0;11
18442;Obelėlė;Pabiručiai;5368376431;Ne;6;0;2;8
18443;Obelėlė;Strakaliukai;1706102918;Ne;0;0;6;6
18444;Obelėlė;Strakaliukai;2770477678;Taip;11;2;1;14
18445;Obelėlė;Strakaliukai;8682794598;Taip;0;0;1;1
18446;Obelėlė;Strakaliukai;8754552660;Taip;0;0;2;2
18447;Obelėlė;Strakaliukai;8092024850;Taip;8;0;1;9
18448;Obelėlė;Strakaliukai;9716500560;Ne;0;1;0;1
18449;Obelėlė;Strakaliukai;4251418414;Ne;10;0;0;10
18450;Obelėlė;Strakaliukai;7128421330;Taip;13;0;1;14
18451;Obelėlė;Strakaliukai;5943314566;Taip;0;0;4;4
18452;Obelėlė;Strakaliukai;5741823041;Taip;0;5;1;6
18453;Obelėlė;Strakaliukai;8050551266;Taip;10;0;1;11
18454;Obelėlė;Strakaliukai;7468335279;Ne;16;0;1;17
18455;Obelėlė;Strakaliukai;1180508643;Taip;0;1;3;4
18456;Obelėlė;Strakaliukai;7124393375;Taip;0;0;8;8
18457;Obelėlė;Strakaliukai;5001844064;Taip;9;1;0;10
18458;Obelėlė;Strakaliukai;9976694313;Taip;0;0;6;6
18459;Obelėlė;Saulutė;2772753891;Taip;5;0;4;9
18460;Obelėlė;Saulutė;8486560892;Taip;9;1;1;11
18461;Obelėlė;Saulutė;1858251094;Taip;10;0;3;13
18462;Obelėlė;Saulutė;2893378990;Taip;10;0;1;11
18463;Obelėlė;Saulutė;6874039388;Taip;0;0;4;4
18464;Obelėlė;Saulutė;7491934262;Taip;0;0;9;9
18465;Obelėlė;Saulutė;9043542844;Taip;5;0;2;7
18466;Obelėlė;Saulutė;4321210604;Taip;7;0;0;7
18467;Obelėlė;Saulutė;4209489251;Taip;0;0;7;7
18468;Obelėlė;Saulutė;4309622934;Taip;10;0;0;10
18469;Obelėlė;Saulutė;3590915973;Taip;0;0;3;3
18470;Obelėlė;Saulutė;6470533765;Taip;7;1;0;8
18471;Obelėlė;Saulutė;8223715886;Taip;7;1;0;8
18472;Obelėlė;Saulutė;8461505586;Taip;0;0;7;7
18473;Obelėlė;Saulutė;2730569223;Taip;15;0;0;15
18474;Obelėlė;Saulutė;4218895290;Taip;0;0;5;5
18475;Obelėlė;Saulutė;3460171136;Taip;0;0;10;10
18476;Obelėlė;Rieduliukai;9008900055;Taip;13;0;0;13
18477;Obelėlė;Rieduliukai;9332534001;Taip;13;0;0;13
18478;Obelėlė;Rieduliukai;2465101384;Ne;13;0;0;13
18479;Obelėlė;Rieduliukai;7403160073;Taip;0;0;5;5
18480;Obelėlė;Rieduliukai;2663004768;Taip;9;0;2;11
18481;Obelėlė;Rieduliukai;8060994250;Taip;16;0;0;16
18482;Obelėlė;Rieduliukai;1788880520;Taip;6;0;7;13
18483;Obelėlė;Rieduliukai;3452970142;Ne;0;1;0;1
18484;Obelėlė;Rieduliukai;4505857257;Taip;4;0;0;4
18485;Obelėlė;Rieduliukai;9995891955;Taip;6;0;4;10
18486;Obelėlė;Rieduliukai;4707488292;Taip;11;10;0;21
18487;Obelėlė;Rieduliukai;3646359565;Taip;15;0;0;15
18488;Obelėlė;Rieduliukai;5366112771;Taip;1;1;0;2
18489;Obelėlė;Rieduliukai;6945301927;Taip;0;0;1;1
18490;Obelėlė;Rieduliukai;5603904852;Taip;5;0;1;6
18491;Obelėlė;Rieduliukai;2031637374;Ne;0;0;12;12
18492;Obelėlė;Rieduliukai;4678269928;Taip;9;0;2;11
18493;Obelėlė;Žirniukai;5209482838;Taip;21;0;0;21
18494;Obelėlė;Žirniukai;8422696011;Taip;5;0;1;6
18495;Obelėlė;Žirniukai;5503843905;Ne;4;1;1;6
18496;Obelėlė;Žirniukai;6133596410;Taip;10;0;1;11
18497;Obelėlė;Žirniukai;2702773541;Taip;5;0;6;11
18498;Obelėlė;Žirniukai;2769784741;Taip;0;0;3;3
18499;Obelėlė;Žirniukai;8982197866;Taip;11;0;2;13
18500;Obelėlė;Žirniukai;1222183008;Taip;3;1;0;4
18501;Obelėlė;Žirniukai;7813350634;Taip;3;0;1;4
18502;Obelėlė;Žirniukai;3568124213;Taip;11;0;1;12
18503;Obelėlė;Žirniukai;5478392319;Taip;5;1;0;6
18504;Obelėlė;Žirniukai;4223995429;Taip;0;1;1;2
18505;Obelėlė;Žirniukai;3287262204;Taip;5;1;1;7
18506;Obelėlė;Žirniukai;9005520809;Taip;3;0;3;6
18507;Obelėlė;Žirniukai;5192989376;Taip;9;1;0;10
18508;Obelėlė;Žirniukai;1799603610;Taip;15;0;3;18
18509;Obelėlė;Bičiuliai;3425736276;Taip;0;1;0;1
18510;Obelėlė;Bičiuliai;5776116844;Taip;6;0;2;8
18511;Obelėlė;Bičiuliai;8487088625;Taip;0;1;5;6
18512;Obelėlė;Bičiuliai;1537769810;Taip;6;0;5;11
18513;Obelėlė;Bičiuliai;8371648703;Taip;6;0;0;6
18514;Obelėlė;Bičiuliai;2329734472;Taip;0;0;2;2
18515;Obelėlė;Bičiuliai;1419189517;Taip;0;0;3;3
18516;Obelėlė;Bičiuliai;8155712451;Taip;0;1;1;2
18517;Obelėlė;Bičiuliai;4849175527;Ne;0;0;1;1
18518;Obelėlė;Bičiuliai;1362135757;Taip;1;0;0;1
18519;Obelėlė;Bičiuliai;3769993089;Taip;5;0;0;5
18520;Obelėlė;Bičiuliai;5374979248;Taip;0;0;3;3
18521;Obelėlė;Bičiuliai;2170134084;Taip;0;0;2;2
18522;Obelėlė;Bičiuliai;1909459236;Taip;0;1;1;2
18523;Obelėlė;Bičiuliai;8757731600;Taip;0;0;2;2
18524;Obelėlė;Kodėlčiukai;9960526051;Taip;8;0;1;9
18525;Obelėlė;Kodėlčiukai;1050919659;Taip;10;1;0;11
18526;Obelėlė;Kodėlčiukai;7014872044;Taip;2;0;1;3
18527;Obelėlė;Kodėlčiukai;3028107343;Taip;13;0;1;14
18528;Obelėlė;Kodėlčiukai;4717038536;Taip;0;0;6;6
18529;Obelėlė;Kodėlčiukai;4840134079;Taip;6;0;0;6
18530;Obelėlė;Kodėlčiukai;8762518354;Taip;0;0;1;1
18531;Obelėlė;Kodėlčiukai;3320493372;Taip;5;0;0;5
18532;Obelėlė;Kodėlčiukai;8366162313;Taip;10;0;0;10
18533;Obelėlė;Kodėlčiukai;7901070568;Taip;0;0;1;1
18534;Obelėlė;Kodėlčiukai;6481365666;Taip;12;0;0;12
18535;Obelėlė;Kodėlčiukai;2227383487;Taip;2;0;1;3
18536;Obelėlė;Kodėlčiukai;8818153952;Taip;2;0;3;5
18537;Obelėlė;Kodėlčiukai;4887103549;Taip;10;0;0;10
18538;Obelėlė;Kodėlčiukai;5221918341;Taip;13;0;1;14
18539;Obelėlė;Kodėlčiukai;3748406335;Taip;4;0;1;5
18540;Obelėlė;Kodėlčiukai;7696478568;Taip;4;0;3;7
18541;Obelėlė;Kodėlčiukai;7422668691;Ne;17;0;0;17
18542;Obelėlė;Kodėlčiukai;5233321854;Ne;8;0;3;11
18543;Obelėlė;Kodėlčiukai;1472630240;Taip;8;0;1;9
18544;Obelėlė;Pagrandukai;3467743802;Taip;0;21;0;21
18545;Obelėlė;Pagrandukai;7934967787;Taip;8;0;0;8
18546;Obelėlė;Pagrandukai;4673426170;Taip;10;1;3;14
18547;Obelėlė;Pagrandukai;6436061438;Taip;19;0;1;20
18548;Obelėlė;Pagrandukai;8711370875;Taip;5;0;0;5
18549;Obelėlė;Pagrandukai;6938326798;Taip;0;21;0;21
18550;Obelėlė;Pagrandukai;9258651395;Taip;8;0;1;9
18551;Obelėlė;Pagrandukai;4974008654;Taip;0;21;0;21
18552;Obelėlė;Pagrandukai;3563701047;Taip;17;0;0;17
18553;Obelėlė;Pagrandukai;8319899105;Taip;0;10;0;10
18554;Obelėlė;Pagrandukai;8664564820;Taip;0;15;0;15
18555;Obelėlė;Pagrandukai;9170515841;Taip;0;15;0;15
18556;Obelėlė;Pagrandukai;9514739912;Taip;1;0;2;3
18557;Obelėlė;Pagrandukai;7368698046;Taip;7;0;2;9
18558;Obelėlė;Pagrandukai;3738932600;Taip;0;9;0;9
18559;Spygliukas;Bitutės;8272537768;Ne;0;0;1;1
18560;Spygliukas;Bitutės;1283097421;Taip;11;6;2;19
18561;Spygliukas;Bitutės;9444569348;Taip;8;3;0;11
18562;Spygliukas;Bitutės;8404929784;Taip;0;2;0;2
18563;Spygliukas;Bitutės;4835818382;Taip;0;3;0;3
18564;Spygliukas;Bitutės;3041184642;Taip;0;1;1;2
18565;Spygliukas;Bitutės;9070219319;Taip;0;8;0;8
18566;Spygliukas;Bitutės;9413950200;Taip;9;1;0;10
18567;Spygliukas;Bitutės;1664878188;Taip;5;2;1;8
18568;Spygliukas;Bitutės;5134327772;Taip;0;1;1;2
18569;Spygliukas;Bitutės;8869320003;Taip;3;1;1;5
18570;Spygliukas;Bitutės;8476882854;Taip;1;8;0;9
18571;Spygliukas;Bitutės;1333556956;Ne;0;5;2;7
18572;Spygliukas;Bitutės;3761715811;Taip;9;0;0;9
18573;Spygliukas;Bitutės;8270525839;Taip;5;7;0;12
18574;Spygliukas;Bitutės;3697691132;Taip;2;2;0;4
18575;Spygliukas;Bitutės;1550737449;Taip;4;0;1;5
18576;Spygliukas;Bitutės;4053158210;Taip;0;3;0;3
18577;Spygliukas;Bitutės;2395961015;Taip;5;0;1;6
18578;Spygliukas;Bitutės;5180736358;Taip;3;0;2;5
18579;Spygliukas;Bitutės;9431217584;Taip;0;1;0;1
18580;Spygliukas;Kiškučiai;6195903792;Taip;0;0;1;1
18581;Spygliukas;Kiškučiai;1927028026;Taip;6;1;0;7
18582;Spygliukas;Kiškučiai;3094528907;Taip;0;1;0;1
18583;Spygliukas;Kiškučiai;8981549891;Taip;0;5;0;5
18584;Spygliukas;Kiškučiai;9813995933;Taip;0;4;0;4
18585;Spygliukas;Kiškučiai;4013601534;Taip;13;0;0;13
18586;Spygliukas;Kiškučiai;3959136555;Taip;4;0;0;4
18587;Spygliukas;Kiškučiai;6383264068;Taip;5;1;0;6
18588;Spygliukas;Kiškučiai;5369930705;Taip;11;0;0;11
18589;Spygliukas;Kiškučiai;6246925536;Taip;11;0;1;12
18590;Spygliukas;Kiškučiai;1037321774;Ne;4;2;2;8
18591;Spygliukas;Kiškučiai;5615854225;Taip;0;3;0;3
18592;Spygliukas;Kiškučiai;7261580644;Taip;0;5;0;5
18593;Spygliukas;Kiškučiai;7243104877;Taip;5;1;0;6
18594;Spygliukas;Kiškučiai;1436452804;Taip;10;2;3;15
18595;Spygliukas;Kiškučiai;8347377310;Taip;11;0;0;11
18596;Spygliukas;Kiškučiai;1330384915;Taip;13;0;0;13
18597;Spygliukas;Kiškučiai;8299276429;Ne;10;1;0;11
18598;Spygliukas;Boružėlės;5493599614;Taip;1;0;0;1
18599;Spygliukas;Boružėlės;6931145017;Taip;12;0;0;12
18600;Spygliukas;Boružėlės;9285259322;Taip;8;2;0;10
18601;Spygliukas;Boružėlės;1341333016;Taip;16;0;0;16
18602;Spygliukas;Boružėlės;5561426508;Taip;10;0;0;10
18603;Spygliukas;Boružėlės;8806126755;Ne;5;2;0;7
18604;Spygliukas;Boružėlės;4477402331;Taip;9;0;0;9
18605;Spygliukas;Boružėlės;2772801133;Taip;4;0;1;5
18606;Spygliukas;Boružėlės;6332646009;Taip;0;3;0;3
18607;Spygliukas;Boružėlės;3706443395;Taip;0;1;0;1
18608;Spygliukas;Boružėlės;5765106914;Taip;0;1;1;2
18609;Spygliukas;Boružėlės;3416275094;Taip;6;2;1;9
18610;Spygliukas;Boružėlės;1401951658;Taip;8;1;0;9
18611;Spygliukas;Boružėlės;6248409896;Taip;0;2;1;3
18612;Spygliukas;Boružėlės;8708083787;Taip;0;4;0;4
18613;Spygliukas;Boružėlės;8825264090;Ne;0;3;8;11
18614;Spygliukas;Boružėlės;3919560072;Taip;3;0;1;4
18615;Spygliukas;Boružėlės;4577592862;Taip;8;2;0;10
18616;Spygliukas;Boružėlės;6835488489;Taip;0;1;0;1
18617;Spygliukas;Boružėlės;7900652746;Taip;0;1;0;1
18618;Spygliukas;Ežiukai;2164549239;Taip;0;0;3;3
18619;Spygliukas;Ežiukai;1983112873;Taip;5;1;1;7
18620;Spygliukas;Ežiukai;4615217628;Taip;8;2;0;10
18621;Spygliukas;Ežiukai;2184487073;Taip;0;1;1;2
18622;Spygliukas;Ežiukai;5612894706;Taip;5;4;0;9
18623;Spygliukas;Ežiukai;6552944183;Ne;6;0;1;7
18624;Spygliukas;Ežiukai;7749937772;Taip;0;11;8;19
18625;Spygliukas;Ežiukai;2719100414;Taip;5;2;0;7
18626;Spygliukas;Ežiukai;1429613380;Taip;0;1;4;5
18627;Spygliukas;Ežiukai;4026252608;Taip;0;1;0;1
18628;Spygliukas;Ežiukai;4098112375;Taip;0;0;1;1
18629;Spygliukas;Ežiukai;9321493897;Taip;0;0;6;6
18630;Spygliukas;Ežiukai;7908419787;Ne;13;0;0;13
18631;Spygliukas;Ežiukai;5366783639;Taip;0;5;0;5
18632;Spygliukas;Ežiukai;3088387895;Taip;6;0;1;7
18633;Spygliukas;Ežiukai;7287543571;Taip;0;0;6;6
18634;Spygliukas;Geniukai;8821434815;Taip;0;0;1;1
18635;Spygliukas;Geniukai;2713999021;Taip;11;0;0;11
18636;Spygliukas;Geniukai;5782501698;Taip;4;0;2;6
18637;Spygliukas;Geniukai;6700076900;Taip;0;0;5;5
18638;Spygliukas;Geniukai;8338260940;Taip;0;0;2;2
18639;Spygliukas;Geniukai;1863442354;Taip;0;1;3;4
18640;Spygliukas;Geniukai;9945315122;Taip;3;3;3;9
18641;Spygliukas;Geniukai;1291429206;Taip;2;1;0;3
18642;Spygliukas;Geniukai;7477731865;Taip;6;0;1;7
18643;Spygliukas;Geniukai;7561072315;Taip;2;0;2;4
18644;Spygliukas;Geniukai;2950722789;Taip;6;0;0;6
18645;Spygliukas;Geniukai;8093949301;Taip;5;0;0;5
18646;Spygliukas;Geniukai;9141146733;Taip;4;0;0;4
18647;Spygliukas;Geniukai;6363991196;Taip;3;0;0;3
18648;Spygliukas;Geniukai;8308394841;Taip;8;1;0;9
18649;Spygliukas;Geniukai;1127941700;Taip;0;1;0;1
18650;Spygliukas;Geniukai;8581453160;Taip;1;0;3;4
18651;Spygliukas;Geniukai;7573756485;Taip;5;0;3;8
18652;Spygliukas;Geniukai;7531515854;Taip;0;7;0;7
18653;Spygliukas;Riešutėliai;29449834997;Taip;2;1;2;5
18654;Spygliukas;Riešutėliai;47977103711;Taip;0;1;0;1
18655;Spygliukas;Riešutėliai;1855897974;Taip;9;1;1;11
18656;Spygliukas;Riešutėliai;1940209166;Taip;1;1;0;2
18657;Spygliukas;Riešutėliai;8992822256;Taip;1;2;0;3
18658;Spygliukas;Riešutėliai;1939828587;Taip;0;11;0;11
18659;Spygliukas;Riešutėliai;1238940921;Taip;0;1;1;2
18660;Spygliukas;Riešutėliai;9797138740;Taip;0;1;8;9
18661;Spygliukas;Riešutėliai;9001243644;Taip;0;14;5;19
18662;Spygliukas;Riešutėliai;1679263120;Taip;0;1;0;1
18663;Spygliukas;Riešutėliai;7250958367;Taip;4;2;0;6
18664;Spygliukas;Riešutėliai;9975117461;Taip;0;1;3;4
18665;Spygliukas;Riešutėliai;5022615426;Ne;4;0;0;4
18666;Spygliukas;Riešutėliai;7114613140;Taip;0;1;0;1
18667;Spygliukas;Riešutėliai;4430242310;Taip;0;1;0;1
18668;Spygliukas;Riešutėliai;8103481313;Taip;8;5;0;13
18669;Spygliukas;Riešutėliai;2980459339;Taip;0;1;0;1
18670;Spygliukas;Riešutėliai;5827455834;Taip;0;1;7;8
18671;Spygliukas;Riešutėliai;4653108810;Taip;0;5;0;5
18672;Spygliukas;Riešutėliai;16828631895;Taip;5;1;1;7
18673;Spygliukas;Pelėdžiukai;1260920726;Taip;11;1;0;12
18674;Spygliukas;Pelėdžiukai;4355472423;Ne;0;1;1;2
18675;Spygliukas;Pelėdžiukai;8686118262;Taip;10;0;0;10
18676;Spygliukas;Pelėdžiukai;6242194100;Taip;0;3;1;4
18677;Spygliukas;Pelėdžiukai;8048474808;Ne;5;1;2;8
18678;Spygliukas;Pelėdžiukai;5778081118;Taip;5;1;3;9
18679;Spygliukas;Pelėdžiukai;4721066953;Taip;0;1;1;2
18680;Spygliukas;Pelėdžiukai;8331205164;Taip;9;1;1;11
18681;Spygliukas;Pelėdžiukai;4949371837;Taip;0;4;0;4
18682;Spygliukas;Pelėdžiukai;4650693672;Taip;0;0;3;3
18683;Spygliukas;Pelėdžiukai;3658613027;Ne;1;0;0;1
18684;Spygliukas;Pelėdžiukai;1662885055;Ne;6;0;0;6
18685;Spygliukas;Pelėdžiukai;6457632191;Taip;0;5;0;5
18686;Spygliukas;Pelėdžiukai;9178184431;Taip;0;1;3;4
18687;Spygliukas;Pelėdžiukai;5962360012;Taip;0;1;2;3
18688;Spygliukas;Pelėdžiukai;2739564216;Taip;3;1;1;5
18689;Spygliukas;Pelėdžiukai;4610504338;Taip;0;5;0;5
18690;Spygliukas;Pelėdžiukai;89044575245;Taip;0;1;0;1
18691;Spygliukas;Zylutės;9465470810;Ne;16;0;0;16
18692;Spygliukas;Zylutės;4417471958;Ne;12;9;0;21
18693;Spygliukas;Zylutės;3811864870;Taip;2;0;1;3
18694;Spygliukas;Zylutės;4177369871;Taip;0;0;3;3
18695;Spygliukas;Zylutės;8105507156;Taip;0;4;0;4
18696;Spygliukas;Zylutės;6858338620;Taip;11;0;0;11
18697;Spygliukas;Zylutės;9601530981;Taip;10;0;0;10
18698;Spygliukas;Zylutės;3066293772;Ne;1;0;2;3
18699;Spygliukas;Zylutės;3988253265;Taip;8;0;0;8
18700;Spygliukas;Zylutės;3268222954;Taip;7;0;0;7
18701;Spygliukas;Zylutės;5006372835;Taip;9;0;0;9
18702;Spygliukas;Zylutės;3317395260;Taip;5;0;0;5
18703;Spygliukas;Zylutės;6343141973;Taip;8;1;2;11
18704;Spygliukas;Zylutės;2632672131;Taip;4;1;0;5
18705;Spygliukas;Zylutės;5638595939;Taip;17;2;0;19
18706;Spygliukas;Skruzdėliukai;8246739374;Taip;7;0;0;7
18707;Spygliukas;Skruzdėliukai;8509447147;Taip;8;0;1;9
18708;Spygliukas;Skruzdėliukai;5739075961;Taip;1;0;1;2
18709;Spygliukas;Skruzdėliukai;7324915516;Taip;21;0;0;21
18710;Spygliukas;Skruzdėliukai;6414439254;Taip;21;0;0;21
18711;Spygliukas;Skruzdėliukai;7663839690;Taip;6;1;0;7
18712;Spygliukas;Skruzdėliukai;8426426785;Taip;5;0;0;5
18713;Spygliukas;Skruzdėliukai;1243647769;Taip;0;1;1;2
18714;Spygliukas;Skruzdėliukai;6680699873;Taip;0;0;5;5
18715;Spygliukas;Skruzdėliukai;2955219028;Ne;0;4;0;4
18716;Spygliukas;Skruzdėliukai;1823720183;Ne;10;1;1;12
18717;Spygliukas;Skruzdėliukai;8565217488;Taip;6;0;1;7
18718;Spygliukas;Skruzdėliukai;2367685286;Taip;11;0;2;13
18719;Spygliukas;Skruzdėliukai;3065727701;Ne;21;0;0;21
18720;Spygliukas;Voveraitės;9112172144;Taip;8;1;2;11
18721;Spygliukas;Voveraitės;7897603878;Taip;0;10;0;10
18722;Spygliukas;Voveraitės;7741841634;Taip;0;5;0;5
18723;Spygliukas;Voveraitės;3077468722;Taip;15;1;1;17
18724;Spygliukas;Voveraitės;1177439438;Taip;0;1;2;3
18725;Spygliukas;Voveraitės;4948147941;Taip;0;0;1;1
18726;Spygliukas;Voveraitės;2272141731;Taip;0;0;3;3
18727;Spygliukas;Voveraitės;6587957213;Taip;10;0;0;10
18728;Spygliukas;Voveraitės;6758336405;Ne;0;3;1;4
18729;Spygliukas;Voveraitės;1426267001;Taip;0;0;1;1
18730;Spygliukas;Voveraitės;8189748611;Taip;18;1;0;19
18731;Spygliukas;Voveraitės;8877911083;Taip;12;2;0;14
18732;Spygliukas;Voveraitės;6405496193;Taip;7;0;5;12
18733;Spygliukas;Voveraitės;7113913750;Ne;5;1;0;6
18734;Spygliukas;Voveraitės;9231097598;Taip;2;1;3;6
18735;Spygliukas;Voveraitės;4681061579;Taip;10;1;1;12
18736;Spygliukas;Voveraitės;7313828707;Taip;2;0;0;2
18737;Spygliukas;Voveraitės;1234195733;Taip;0;4;0;4
18738;Spygliukas;Voveraitės;4508351101;Taip;0;1;0;1
18739;Spygliukas;Giliukų;6015646417;Taip;0;21;0;21
18740;Spygliukas;Giliukų;1761340174;Taip;8;2;0;10
18741;Spygliukas;Giliukų;7522567241;Taip;0;1;0;1
18742;Spygliukas;Giliukų;7460280684;Taip;10;0;1;11
18743;Spygliukas;Giliukų;4429961491;Taip;17;0;0;17
18744;Spygliukas;Giliukų;8821028259;Taip;15;1;0;16
18745;Spygliukas;Giliukų;6485350404;Taip;0;21;0;21
18746;Spygliukas;Giliukų;3237501537;Taip;7;0;4;11
18747;Spygliukas;Giliukų;8722863277;Taip;6;0;3;9
18748;Spygliukas;Giliukų;9025238241;Taip;17;1;0;18
18749;Spygliukas;Giliukų;3603606800;Taip;0;21;0;21
18750;Spygliukas;Giliukų;6290439938;Taip;0;21;0;21
18751;Spygliukas;Giliukų;7776811391;Taip;7;0;0;7
18752;Spygliukas;Giliukų;3777763305;Taip;5;0;0;5
18753;Spygliukas;Giliukų;4626877679;Taip;0;21;0;21
18754;Spygliukas;Giliukų;5255993275;Taip;0;0;1;1
18755;Spygliukas;Drugeliai;7271659513;Taip;0;10;0;10
18756;Spygliukas;Drugeliai;8604767396;Ne;0;4;1;5
18757;Spygliukas;Drugeliai;4634660174;Taip;1;1;2;4
18758;Spygliukas;Drugeliai;7924880159;Taip;0;3;1;4
18759;Spygliukas;Drugeliai;4368224847;Ne;0;0;9;9
18760;Spygliukas;Drugeliai;9316731983;Taip;0;0;8;8
18761;Spygliukas;Drugeliai;6630979640;Ne;6;0;0;6
18762;Spygliukas;Drugeliai;5012876830;Taip;1;0;0;1
18763;Spygliukas;Drugeliai;2315421636;Taip;0;6;2;8
18764;Spygliukas;Drugeliai;7125425492;Taip;0;1;1;2
18765;Spygliukas;Drugeliai;5214431060;Ne;0;1;0;1
18766;Spygliukas;Drugeliai;7928675053;Taip;1;1;0;2
18767;Spygliukas;Drugeliai;9052337501;Taip;5;1;0;6
18768;Spygliukas;Drugeliai;1974541155;Taip;2;1;1;4
18769;Spygliukas;Drugeliai;4505044604;Taip;0;8;0;8
18770;Spygliukas;Drugeliai;2989701249;Taip;10;0;1;11
18771;Spygliukas;Drugeliai;9086986643;Taip;3;1;0;4
18772;Spygliukas;Drugeliai;9392554576;Taip;2;1;0;3
18773;Spygliukas;Drugeliai;8646122773;Taip;2;2;0;4
18774;Vieversys;Žirniukai;5365334453;Taip;18;0;0;18
18775;Vieversys;Žirniukai;7029322013;Ne;6;0;0;6
18776;Vieversys;Žirniukai;2266222087;Taip;7;0;0;7
18777;Vieversys;Žirniukai;2869545222;Taip;2;0;0;2
18778;Vieversys;Žirniukai;2024837493;Taip;7;0;0;7
18779;Vieversys;Žirniukai;8129566710;Taip;0;1;0;1
18780;Vieversys;Žirniukai;5576923685;Taip;10;0;2;12
18781;Vieversys;Žirniukai;6052943894;Taip;5;0;2;7
18782;Vieversys;Žirniukai;3295424711;Taip;2;0;0;2
18783;Vieversys;Žirniukai;7309040730;Taip;2;0;0;2
18784;Vieversys;Žirniukai;3575906273;Taip;4;0;1;5
18785;Vieversys;Žirniukai;9856798869;Taip;0;18;0;18
18786;Vieversys;Žirniukai;1724543625;Ne;1;0;0;1
18787;Vieversys;Žirniukai;6530685517;Taip;1;0;0;1
18788;Vieversys;Žirniukai;3533711179;Ne;7;1;0;8
18789;Vieversys;Žirniukai;2242368843;Taip;7;0;1;8
18790;Vieversys;Varpelių;9463693741;Ne;0;0;3;3
18791;Vieversys;Varpelių;1924774817;Ne;10;4;0;14
18792;Vieversys;Varpelių;3595005599;Taip;0;0;1;1
18793;Vieversys;Varpelių;9155896981;Taip;0;1;0;1
18794;Vieversys;Varpelių;5160814541;Taip;0;6;0;6
18795;Vieversys;Varpelių;9580031042;Taip;0;2;0;2
18796;Vieversys;Varpelių;2635722489;Taip;0;1;1;2
18797;Vieversys;Varpelių;3262738994;Taip;0;5;0;5
18798;Vieversys;Varpelių;8350070741;Taip;8;0;3;11
18799;Vieversys;Varpelių;2805682329;Taip;6;0;0;6
18800;Vieversys;Varpelių;9453100342;Taip;0;0;1;1
18801;Vieversys;Varpelių;2956566201;Taip;0;1;0;1
18802;Vieversys;Varpelių;1727558984;Taip;0;0;7;7
18803;Vieversys;Varpelių;3297728501;Taip;0;1;0;1
18804;Vieversys;Varpelių;3780226431;Taip;1;0;4;5
18805;Vieversys;Varpelių;3572628491;Taip;0;0;2;2
18806;Vieversys;Varpelių;1128991679;Ne;0;0;2;2
18807;Vieversys;Kiškučių;5922485482;Taip;0;1;0;1
18808;Vieversys;Kiškučių;3917758713;Taip;0;1;2;3
18809;Vieversys;Kiškučių;9387421639;Taip;3;1;1;5
18810;Vieversys;Kiškučių;2383765752;Taip;0;1;1;2
18811;Vieversys;Kiškučių;1247565595;Taip;0;1;5;6
18812;Vieversys;Kiškučių;7812227428;Taip;0;1;0;1
18813;Vieversys;Kiškučių;53977164888;Taip;5;3;0;8
18814;Vieversys;Kiškučių;5810605263;Taip;0;2;2;4
18815;Vieversys;Kiškučių;3205204176;Taip;0;1;1;2
18816;Vieversys;Kiškučių;82594887399;Taip;0;1;0;1
18817;Vieversys;Kiškučių;6787960120;Ne;0;1;3;4
18818;Vieversys;Kiškučių;9612415733;Taip;0;2;0;2
18819;Vieversys;Kiškučių;1728554204;Taip;0;1;0;1
18820;Vieversys;Kiškučių;5286521728;Ne;0;1;5;6
18821;Vieversys;Kiškučių;1149316471;Taip;0;3;0;3
18822;Vieversys;Kiškučių;7500147648;Taip;0;2;0;2
18823;Vieversys;Kiškučių;95891054066;Ne;2;1;0;3
18824;Vieversys;Kiškučių;8038341998;Ne;0;1;0;1
18825;Vieversys;Kiškučių;5917328379;Taip;0;1;0;1
18826;Vieversys;Kiškučių;6720355390;Ne;5;1;5;11
18827;Vieversys;Kiškučių;1933907389;Taip;0;2;0;2
18828;Vieversys;Pelėdžiukų;8421719030;Taip;0;2;2;4
18829;Vieversys;Pelėdžiukų;77272293257;Taip;7;0;0;7
18830;Vieversys;Pelėdžiukų;94463134058;Taip;0;3;0;3
18831;Vieversys;Pelėdžiukų;7578552471;Taip;0;1;0;1
18832;Vieversys;Pelėdžiukų;2193074123;Taip;0;1;0;1
18833;Vieversys;Pelėdžiukų;9499315463;Taip;0;1;0;1
18834;Vieversys;Pelėdžiukų;9774365819;Taip;0;3;0;3
18835;Vieversys;Pelėdžiukų;2521488728;Taip;0;1;3;4
18836;Vieversys;Pelėdžiukų;6473759470;Taip;0;1;0;1
18837;Vieversys;Pelėdžiukų;1273951001;Taip;0;6;0;6
18838;Vieversys;Pelėdžiukų;48430863473;Taip;0;2;0;2
18839;Vieversys;Pelėdžiukų;50181034746;Taip;3;0;0;3
18840;Vieversys;Pelėdžiukų;1027693153;Taip;0;2;0;2
18841;Vieversys;Pelėdžiukų;5871715452;Taip;0;0;1;1
18842;Vieversys;Pelėdžiukų;1361156816;Taip;1;1;0;2
18843;Vieversys;Pelėdžiukų;4216521988;Taip;0;0;2;2
18844;Vieversys;Pelėdžiukų;3755410640;Taip;0;1;0;1
18845;Vieversys;Pelėdžiukų;1322495361;Taip;5;1;1;7
18846;Vieversys;Pelėdžiukų;1757028935;Ne;4;0;0;4
18847;Vieversys;Pelėdžiukų;4488027554;Ne;4;0;0;4
18848;Vieversys;Saulučių;3164280186;Taip;0;0;4;4
18849;Vieversys;Saulučių;3405502715;Taip;0;1;0;1
18850;Vieversys;Saulučių;6127272124;Taip;0;1;1;2
18851;Vieversys;Saulučių;5654533451;Taip;0;1;0;1
18852;Vieversys;Saulučių;9972526744;Taip;0;0;1;1
18853;Vieversys;Saulučių;9985374057;Taip;5;4;0;9
18854;Vieversys;Saulučių;9308040716;Taip;0;0;1;1
18855;Vieversys;Saulučių;4741252829;Taip;0;0;1;1
18856;Vieversys;Saulučių;2140887757;Taip;0;0;1;1
18857;Vieversys;Saulučių;1748006118;Taip;17;0;1;18
18858;Vieversys;Saulučių;4690095102;Taip;11;0;0;11
18859;Vieversys;Saulučių;7048475906;Taip;11;0;1;12
18860;Vieversys;Saulučių;4072323869;Taip;5;1;0;6
18861;Vieversys;Saulučių;2663322242;Ne;14;0;0;14
18862;Vieversys;Saulučių;7596355010;Taip;0;0;7;7
18863;Vieversys;Saulučių;9322322737;Taip;10;0;1;11
18864;Vieversys;Kregždučių;5645852451;Taip;0;1;0;1
18865;Vieversys;Kregždučių;9088171869;Taip;5;0;0;5
18866;Vieversys;Kregždučių;7998100115;Taip;0;2;0;2
18867;Vieversys;Kregždučių;9093088054;Taip;4;3;0;7
18868;Vieversys;Kregždučių;4870401841;Taip;0;0;1;1
18869;Vieversys;Kregždučių;2849852593;Taip;0;2;0;2
18870;Vieversys;Kregždučių;6808541662;Taip;0;1;0;1
18871;Vieversys;Kregždučių;2529690060;Taip;5;1;1;7
18872;Vieversys;Kregždučių;2230503026;Taip;0;1;0;1
18873;Vieversys;Kregždučių;8141710663;Taip;0;1;2;3
18874;Vieversys;Kregždučių;6157594693;Taip;0;3;0;3
18875;Vieversys;Kregždučių;1322953831;Taip;0;1;0;1
18876;Vieversys;Kregždučių;9090281352;Taip;6;0;0;6
18877;Vieversys;Kregždučių;4308330177;Ne;0;0;3;3
18878;Vieversys;Kregždučių;4347494053;Ne;0;0;1;1
18879;Vieversys;Kregždučių;3122763958;Taip;0;3;0;3
18880;Vieversys;Kregždučių;2938302462;Taip;0;1;0;1
18881;Vieversys;Kregždučių;9577869269;Taip;0;0;3;3
18882;Vieversys;Boružėlių;6838828193;Taip;0;0;1;1
18883;Vieversys;Boružėlių;8587368497;Taip;0;1;7;8
18884;Vieversys;Boružėlių;5683183310;Taip;10;1;1;12
18885;Vieversys;Boružėlių;4565799599;Taip;0;1;0;1
18886;Vieversys;Boružėlių;7399326463;Taip;5;1;0;6
18887;Vieversys;Boružėlių;4088189914;Taip;4;1;2;7
18888;Vieversys;Boružėlių;7364582681;Taip;0;1;0;1
18889;Vieversys;Boružėlių;8084767846;Taip;0;1;0;1
18890;Vieversys;Boružėlių;9826657384;Taip;0;0;1;1
18891;Vieversys;Boružėlių;9255292099;Taip;0;3;3;6
18892;Vieversys;Boružėlių;7429565381;Taip;10;0;4;14
18893;Vieversys;Boružėlių;4297477514;Taip;0;0;2;2
18894;Vieversys;Boružėlių;8816714193;Taip;5;0;2;7
18895;Vieversys;Boružėlių;6148482625;Taip;6;0;5;11
18896;Vieversys;Boružėlių;2701284187;Taip;0;4;0;4
18897;Vieversys;Boružėlių;9911792407;Taip;18;0;0;18
18898;Vieversys;Boružėlių;6234199996;Taip;1;13;0;14
18899;Vieversys;Bitučių;9268459013;Taip;5;1;0;6
18900;Vieversys;Bitučių;8706336322;Taip;2;0;0;2
18901;Vieversys;Bitučių;5966170543;Taip;1;0;0;1
18902;Vieversys;Bitučių;5210732072;Taip;18;0;0;18
18903;Vieversys;Bitučių;9188208330;Taip;1;0;0;1
18904;Vieversys;Bitučių;2072413459;Taip;0;0;1;1
18905;Vieversys;Bitučių;9454017990;Ne;18;0;0;18
18906;Vieversys;Bitučių;9476611261;Taip;12;0;5;17
18907;Vieversys;Bitučių;6083402842;Taip;2;0;0;2
18908;Vieversys;Bitučių;9978867863;Taip;6;0;0;6
18909;Vieversys;Bitučių;9092693925;Taip;0;1;0;1
18910;Vieversys;Bitučių;2661027772;Taip;6;1;0;7
18911;Vieversys;Bitučių;3601928285;Taip;10;0;0;10
18912;Vieversys;Bitučių;8492908398;Taip;7;0;0;7
18913;Vieversys;Bitučių;5479620291;Ne;12;0;1;13
18914;Vieversys;Bitučių;2931875387;Ne;5;0;0;5
18915;Vieversys;Bitučių;6983906287;Taip;0;0;1;1
18916;Vieversys;Bitučių;5417413393;Taip;12;1;0;13
18917;Vieversys;Smalsučių;3681120339;Taip;0;8;0;8
18918;Vieversys;Smalsučių;9164615794;Taip;0;5;0;5
18919;Vieversys;Smalsučių;3684937630;Taip;10;0;0;10
18920;Vieversys;Smalsučių;6563139211;Taip;0;4;2;6
18921;Vieversys;Smalsučių;4294676988;Taip;5;1;5;11
18922;Vieversys;Smalsučių;4835022593;Taip;0;0;1;1
18923;Vieversys;Smalsučių;3249717073;Taip;3;6;1;10
18924;Vieversys;Smalsučių;7120329258;Taip;0;5;0;5
18925;Vieversys;Smalsučių;8174124875;Ne;4;3;0;7
18926;Vieversys;Smalsučių;5769453869;Taip;0;5;0;5
18927;Vieversys;Smalsučių;5907903394;Taip;0;1;0;1
18928;Vieversys;Smalsučių;3946609345;Taip;5;0;3;8
18929;Vieversys;Smalsučių;9686787125;Ne;0;3;0;3
18930;Vieversys;Smalsučių;4455039401;Taip;5;1;0;6
18931;Vieversys;Smalsučių;8129139979;Taip;2;0;0;2
18932;Vieversys;Smalsučių;9835682858;Taip;0;11;0;11
18933;Vieversys;Smalsučių;6486852268;Ne;13;0;3;16
18934;Vieversys;Smalsučių;7007620994;Taip;2;1;6;9
18935;Vieversys;Smalsučių;9494957750;Taip;4;2;0;6
18936;Vieversys;Kodėlčiukų;9217208794;Taip;0;18;0;18
18937;Vieversys;Kodėlčiukų;5037806018;Taip;3;0;1;4
18938;Vieversys;Kodėlčiukų;1752359969;Ne;0;3;0;3
18939;Vieversys;Kodėlčiukų;6791121542;Taip;0;0;1;1
18940;Vieversys;Kodėlčiukų;5912306325;Ne;0;15;0;15
18941;Vieversys;Kodėlčiukų;5898422871;Taip;2;5;0;7
18942;Vieversys;Kodėlčiukų;6709556873;Taip;0;0;3;3
18943;Vieversys;Kodėlčiukų;7453156612;Taip;0;0;1;1
18944;Vieversys;Kodėlčiukų;6926960486;Taip;4;1;0;5
18945;Vieversys;Kodėlčiukų;3180687885;Taip;13;0;0;13
18946;Vieversys;Kodėlčiukų;1881076551;Taip;0;0;2;2
18947;Vieversys;Kodėlčiukų;1384388802;Taip;2;6;0;8
18948;Vieversys;Kodėlčiukų;2562413607;Ne;0;0;1;1
18949;Vieversys;Kodėlčiukų;9965162863;Taip;0;2;0;2
18950;Vieversys;Kodėlčiukų;4702339508;Ne;0;3;3;6
18951;Vieversys;Kodėlčiukų;4631238425;Taip;0;1;0;1
18952;Vieversys;Kodėlčiukų;8512643926;Taip;9;0;0;9
18953;Vieversys;Kodėlčiukų;7967372524;Ne;4;0;3;7
18954;Vieversys;Kodėlčiukų;4703696958;Taip;16;0;2;18
18955;Vieversys;NYKŠTUKAI;3332069842;Taip;0;1;0;1
18956;Vieversys;NYKŠTUKAI;7611047781;Taip;0;2;0;2
18957;Vieversys;NYKŠTUKAI;2107000312;Taip;0;13;1;14
18958;Vieversys;NYKŠTUKAI;1963481567;Taip;1;0;4;5
18959;Vieversys;NYKŠTUKAI;7539934804;Taip;5;0;0;5
18960;Vieversys;NYKŠTUKAI;1714096583;Taip;12;0;0;12
18961;Vieversys;NYKŠTUKAI;8371839883;Taip;11;0;0;11
18962;Vieversys;NYKŠTUKAI;6474334564;Taip;3;0;0;3
18963;Vieversys;NYKŠTUKAI;6631296204;Taip;0;0;2;2
18964;Vieversys;NYKŠTUKAI;2092872414;Taip;0;0;1;1
18965;Vieversys;NYKŠTUKAI;5394635510;Taip;3;0;1;4
18966;Vieversys;NYKŠTUKAI;1160455554;Taip;1;0;1;2
18967;Vieversys;NYKŠTUKAI;8200432952;Taip;0;1;3;4
18968;Vieversys;NYKŠTUKAI;2535992834;Taip;5;0;1;6
18969;Vieversys;NYKŠTUKAI;4974924858;Taip;0;1;2;3
18970;Vieversys;NYKŠTUKAI;4087823915;Taip;11;0;0;11
18971;Vieversys;NYKŠTUKAI;7111551694;Ne;6;0;0;6
18972;Vieversys;DRUGELIAI;9412299328;Taip;6;0;0;6
18973;Vieversys;DRUGELIAI;1552959751;Taip;1;0;0;1
18974;Vieversys;DRUGELIAI;5384977888;Taip;16;0;0;16
18975;Vieversys;DRUGELIAI;9813883328;Taip;12;0;1;13
18976;Vieversys;DRUGELIAI;7708807923;Taip;1;0;0;1
18977;Vieversys;DRUGELIAI;5580265718;Ne;16;0;0;16
18978;Vieversys;DRUGELIAI;8199984460;Taip;0;0;4;4
18979;Vieversys;DRUGELIAI;6581002790;Taip;3;0;1;4
18980;Vieversys;DRUGELIAI;9666764935;Taip;5;0;3;8
18981;Vieversys;DRUGELIAI;8966020793;Taip;6;4;0;10
18982;Vieversys;DRUGELIAI;5164567779;Taip;2;1;0;3
18983;Žirmūnėliai;SAULUTĖS;5560694124;Taip;0;1;0;1
18984;Žirmūnėliai;SAULUTĖS;6116321928;Taip;6;0;1;7
18985;Žirmūnėliai;SAULUTĖS;2310523676;Taip;0;1;0;1
18986;Žirmūnėliai;SAULUTĖS;4922028935;Taip;10;1;0;11
18987;Žirmūnėliai;SAULUTĖS;1948299433;Taip;8;1;0;9
18988;Žirmūnėliai;SAULUTĖS;4763350308;Taip;0;0;4;4
18989;Žirmūnėliai;SAULUTĖS;5626711530;Taip;0;1;0;1
18990;Žirmūnėliai;SAULUTĖS;6072407337;Taip;0;1;0;1
18991;Žirmūnėliai;SAULUTĖS;4338673048;Taip;2;4;4;10
18992;Žirmūnėliai;SAULUTĖS;4793967980;Taip;0;3;1;4
18993;Žirmūnėliai;SAULUTĖS;8242112212;Taip;0;3;3;6
18994;Žirmūnėliai;SAULUTĖS;1940552890;Taip;0;2;0;2
18995;Žirmūnėliai;SAULUTĖS;2392106040;Taip;10;0;0;10
18996;Žirmūnėliai;SAULUTĖS;4343419766;Taip;0;1;1;2
18997;Žirmūnėliai;SAULUTĖS;9145626116;Taip;10;2;2;14
18998;Žirmūnėliai;SAULUTĖS;7675488865;Taip;5;1;3;9
18999;Žirmūnėliai;SAULUTĖS;8345632807;Taip;0;3;0;3
19000;Žirmūnėliai;SAULUTĖS;8592714547;Taip;7;3;0;10
19001;Žirmūnėliai;GILIUKAI;6430944858;Taip;0;1;0;1
19002;Žirmūnėliai;GILIUKAI;3562689670;Taip;0;5;0;5
19003;Žirmūnėliai;GILIUKAI;5929166560;Taip;3;2;2;7
19004;Žirmūnėliai;GILIUKAI;3767421827;Taip;0;2;2;4
19005;Žirmūnėliai;GILIUKAI;4327504033;Taip;5;1;0;6
19006;Žirmūnėliai;GILIUKAI;5104310002;Taip;11;2;0;13
19007;Žirmūnėliai;GILIUKAI;1025809131;Ne;3;1;0;4
19008;Žirmūnėliai;GILIUKAI;6899109664;Taip;0;3;3;6
19009;Žirmūnėliai;GILIUKAI;1473482823;Ne;0;0;1;1
19010;Žirmūnėliai;GILIUKAI;7410921362;Taip;0;4;0;4
19011;Žirmūnėliai;GILIUKAI;6597451758;Taip;0;3;1;4
19012;Žirmūnėliai;GILIUKAI;8627403283;Taip;6;0;0;6
19013;Žirmūnėliai;GILIUKAI;5089884149;Taip;0;0;1;1
19014;Žirmūnėliai;GILIUKAI;1791977446;Taip;0;2;0;2
19015;Žirmūnėliai;GILIUKAI;6875484657;Taip;3;0;6;9
19016;Žirmūnėliai;GILIUKAI;9871163622;Taip;5;0;1;6
19017;Žirmūnėliai;GILIUKAI;3532895278;Ne;0;1;0;1
19018;Žirmūnėliai;GILIUKAI;8459217612;Taip;2;0;1;3
19019;Žirmūnėliai;GILIUKAI;2959090234;Taip;11;0;0;11
19020;Žirmūnėliai;GILIUKAI;5486475468;Taip;0;1;0;1
19021;Žirmūnėliai;GILIUKAI;8618410295;Taip;11;2;0;13
19022;Žirmūnėliai;GILIUKAI;1941509002;Taip;3;0;4;7
19023;Žirmūnėliai;DRUGELIAI;4218266688;Taip;5;0;0;5
19024;Žirmūnėliai;DRUGELIAI;7020486370;Taip;0;1;0;1
19025;Žirmūnėliai;DRUGELIAI;3449815783;Taip;0;1;0;1
19026;Žirmūnėliai;DRUGELIAI;9541122034;Taip;0;3;1;4
19027;Žirmūnėliai;DRUGELIAI;5736502380;Taip;0;2;0;2
19028;Žirmūnėliai;DRUGELIAI;9154874729;Taip;4;0;0;4
19029;Žirmūnėliai;DRUGELIAI;9378860669;Taip;0;2;0;2
19030;Žirmūnėliai;DRUGELIAI;8607934394;Taip;1;3;0;4
19031;Žirmūnėliai;DRUGELIAI;7892626521;Taip;0;9;0;9
19032;Žirmūnėliai;DRUGELIAI;8999160836;Taip;0;2;0;2
19033;Žirmūnėliai;DRUGELIAI;8209309240;Taip;0;3;0;3
19034;Žirmūnėliai;DRUGELIAI;2837129621;Taip;0;1;0;1
19035;Žirmūnėliai;DRUGELIAI;1273684243;Taip;0;0;1;1
19036;Žirmūnėliai;DRUGELIAI;2971175236;Taip;5;1;0;6
19037;Žirmūnėliai;DRUGELIAI;7422544482;Taip;0;6;0;6
19038;Žirmūnėliai;DRUGELIAI;4336415033;Ne;5;1;1;7
19039;Žirmūnėliai;DRUGELIAI;9241738140;Taip;1;1;0;2
19040;Žirmūnėliai;DRUGELIAI;4778339658;Taip;0;5;0;5
19041;Žirmūnėliai;BORUŽIUKAI;52420072025;Taip;0;1;1;2
19042;Žirmūnėliai;BORUŽIUKAI;4796654075;Taip;0;1;0;1
19043;Žirmūnėliai;BORUŽIUKAI;1234956674;Taip;0;2;0;2
19044;Žirmūnėliai;BORUŽIUKAI;9926432375;Taip;0;6;0;6
19045;Žirmūnėliai;BORUŽIUKAI;2739395691;Taip;0;5;0;5
19046;Žirmūnėliai;BORUŽIUKAI;3351861764;Taip;0;9;0;9
19047;Žirmūnėliai;BORUŽIUKAI;6161223611;Taip;0;1;0;1
19048;Žirmūnėliai;BORUŽIUKAI;5611315994;Taip;0;11;0;11
19049;Žirmūnėliai;BORUŽIUKAI;7528704460;Taip;0;11;0;11
19050;Žirmūnėliai;BORUŽIUKAI;1618573494;Taip;11;9;0;20
19051;Žirmūnėliai;BORUŽIUKAI;31403739893;Ne;16;1;0;17
19052;Žirmūnėliai;BORUŽIUKAI;6647641423;Taip;10;0;0;10
19053;Žirmūnėliai;BORUŽIUKAI;5367009184;Taip;0;1;5;6
19054;Žirmūnėliai;BORUŽIUKAI;3540307559;Taip;0;2;0;2
19055;Žirmūnėliai;BORUŽIUKAI;5125341440;Taip;0;2;1;3
19056;Žirmūnėliai;BORUŽIUKAI;1865240339;Taip;10;0;0;10
19057;Žirmūnėliai;BORUŽIUKAI;6337036947;Taip;6;1;0;7
19058;Žirmūnėliai;BORUŽIUKAI;3274576752;Taip;5;1;0;6
19059;Žirmūnėliai;BORUŽIUKAI;5209700153;Taip;5;0;1;6
19060;Žirmūnėliai;BORUŽIUKAI;8339819296;Taip;6;1;0;7
19061;Žirmūnėliai;BORUŽIUKAI;2033271165;Taip;0;2;4;6
19062;Žirmūnėliai;EŽIUKAI;7011701994;Taip;0;5;0;5
19063;Žirmūnėliai;EŽIUKAI;2661052835;Taip;0;8;0;8
19064;Žirmūnėliai;EŽIUKAI;1655437833;Taip;0;2;4;6
19065;Žirmūnėliai;EŽIUKAI;3640979388;Taip;6;2;0;8
19066;Žirmūnėliai;EŽIUKAI;6878528100;Taip;0;0;7;7
19067;Žirmūnėliai;EŽIUKAI;8440187348;Taip;8;2;0;10
19068;Žirmūnėliai;EŽIUKAI;4565479092;Taip;0;0;2;2
19069;Žirmūnėliai;EŽIUKAI;4968278870;Taip;14;0;1;15
19070;Žirmūnėliai;EŽIUKAI;2693415717;Taip;0;2;1;3
19071;Žirmūnėliai;EŽIUKAI;7953019230;Taip;10;7;0;17
19072;Žirmūnėliai;EŽIUKAI;1832367936;Taip;0;0;1;1
19073;Žirmūnėliai;EŽIUKAI;3180116136;Taip;0;5;2;7
19074;Žirmūnėliai;EŽIUKAI;9759491055;Taip;0;8;2;10
19075;Žirmūnėliai;EŽIUKAI;1127214387;Ne;0;2;1;3
19076;Žirmūnėliai;EŽIUKAI;4101748829;Taip;5;4;0;9
19077;Žirmūnėliai;EŽIUKAI;2379638934;Taip;5;6;0;11
19078;Žirmūnėliai;EŽIUKAI;6448582622;Taip;11;1;0;12
19079;Žirmūnėliai;EŽIUKAI;4710829908;Taip;0;2;1;3
19080;Žirmūnėliai;EŽIUKAI;7580002502;Taip;10;1;1;12
19081;Žirmūnėliai;EŽIUKAI;4638575301;Taip;0;1;0;1
19082;Žirmūnėliai;EŽIUKAI;3310847619;Taip;0;0;5;5
19083;Žirmūnėliai;EŽIUKAI;1977798059;Taip;0;1;8;9
19084;Žirmūnėliai;ŽVIRBLIUKAI;6896145409;Taip;0;3;3;6
19085;Žirmūnėliai;ŽVIRBLIUKAI;1255857051;Taip;0;0;5;5
19086;Žirmūnėliai;ŽVIRBLIUKAI;1347664230;Taip;5;1;0;6
19087;Žirmūnėliai;ŽVIRBLIUKAI;3166454638;Taip;0;1;0;1
19088;Žirmūnėliai;ŽVIRBLIUKAI;4517290068;Taip;2;1;0;3
19089;Žirmūnėliai;ŽVIRBLIUKAI;1582563837;Taip;0;3;0;3
19090;Žirmūnėliai;ŽVIRBLIUKAI;1381923106;Taip;5;3;2;10
19091;Žirmūnėliai;ŽVIRBLIUKAI;1725143117;Taip;4;1;0;5
19092;Žirmūnėliai;ŽVIRBLIUKAI;1478039469;Taip;0;1;1;2
19093;Žirmūnėliai;ŽVIRBLIUKAI;5037669167;Taip;5;2;0;7
19094;Žirmūnėliai;ŽVIRBLIUKAI;4598761492;Taip;5;1;0;6
19095;Žirmūnėliai;ŽVIRBLIUKAI;1435743911;Taip;0;1;0;1
19096;Žirmūnėliai;ŽVIRBLIUKAI;2007790746;Taip;0;1;0;1
19097;Žirmūnėliai;ŽVIRBLIUKAI;8308074932;Taip;0;3;0;3
19098;Žirmūnėliai;ŽVIRBLIUKAI;1761284228;Taip;0;2;1;3
19099;Žirmūnėliai;ŽVIRBLIUKAI;41018224936;Taip;5;6;0;11
19100;Žirmūnėliai;ŽVIRBLIUKAI;1894070647;Ne;0;3;4;7
19101;Žirmūnėliai;ŽVIRBLIUKAI;7062967491;Taip;5;3;0;8
19102;Žirmūnėliai;ŽVIRBLIUKAI;9482910388;Taip;0;3;0;3
19103;Žirmūnėliai;ŽVIRBLIUKAI;1569772948;Ne;0;1;0;1
19104;Žirmūnėliai;SPALVELĖS;4815427530;Taip;4;0;0;4
19105;Žirmūnėliai;SPALVELĖS;6641667315;Taip;0;1;0;1
19106;Žirmūnėliai;SPALVELĖS;9936156579;Ne;0;1;0;1
19107;Žirmūnėliai;SPALVELĖS;2985092368;Ne;9;2;0;11
19108;Žirmūnėliai;SPALVELĖS;5154076629;Ne;0;1;0;1
19109;Žirmūnėliai;SPALVELĖS;1401001989;Taip;0;1;0;1
19110;Žirmūnėliai;SPALVELĖS;2841958534;Taip;0;1;0;1
19111;Žirmūnėliai;SPALVELĖS;6259368139;Taip;0;2;0;2
19112;Žirmūnėliai;SPALVELĖS;1356219744;Taip;0;6;0;6
19113;Žirmūnėliai;SPALVELĖS;8538773532;Taip;0;8;0;8
19114;Žirmūnėliai;SPALVELĖS;3051025147;Taip;0;0;4;4
19115;Žirmūnėliai;SPALVELĖS;6934204209;Taip;3;0;0;3
19116;Žirmūnėliai;SPALVELĖS;9306935083;Taip;9;1;0;10
19117;Žirmūnėliai;SPALVELĖS;7067837709;Ne;2;0;0;2
19118;Žirmūnėliai;SPALVELĖS;5316869112;Taip;3;0;0;3
19119;Žirmūnėliai;SPALVELĖS;4807331877;Taip;0;0;10;10
19120;Žirmūnėliai;SPALVELĖS;8742911909;Taip;0;10;0;10
19121;Žirmūnėliai;SPALVELĖS;6817236579;Taip;0;1;0;1
19122;Žirmūnėliai;SPALVELĖS;9042509512;Taip;10;1;0;11
19123;Žirmūnėliai;SPALVELĖS;5076712824;Taip;7;2;0;9
19124;Žirmūnėliai;SPALVELĖS;8444883234;Ne;4;0;1;5
19125;Žirmūnėliai;DEBESĖLIAI;6908512961;Taip;14;1;0;15
19126;Žirmūnėliai;DEBESĖLIAI;1571242696;Taip;0;2;0;2
19127;Žirmūnėliai;DEBESĖLIAI;2866010286;Taip;0;2;2;4
19128;Žirmūnėliai;DEBESĖLIAI;2904787614;Taip;6;0;0;6
19129;Žirmūnėliai;DEBESĖLIAI;3431320961;Taip;0;1;2;3
19130;Žirmūnėliai;DEBESĖLIAI;7087770068;Taip;0;5;0;5
19131;Žirmūnėliai;DEBESĖLIAI;4347548125;Taip;12;0;0;12
19132;Žirmūnėliai;DEBESĖLIAI;3330603362;Taip;11;1;0;12
19133;Žirmūnėliai;DEBESĖLIAI;5440814849;Taip;10;2;0;12
19134;Žirmūnėliai;DEBESĖLIAI;7680479258;Taip;2;0;0;2
19135;Žirmūnėliai;DEBESĖLIAI;8136265008;Taip;0;14;0;14
19136;Žirmūnėliai;DEBESĖLIAI;7568228423;Taip;7;2;1;10
19137;Žirmūnėliai;DEBESĖLIAI;9813507899;Taip;6;0;1;7
19138;Žirmūnėliai;DEBESĖLIAI;8687642039;Taip;0;0;5;5
19139;Žirmūnėliai;DEBESĖLIAI;5982848146;Taip;12;1;0;13
19140;Žirmūnėliai;DEBESĖLIAI;3646039695;Taip;0;2;0;2
19141;Žirmūnėliai;DEBESĖLIAI;5676730437;Taip;0;0;1;1
19142;Žirmūnėliai;DEBESĖLIAI;4653124134;Taip;10;0;1;11
19143;Žirmūnėliai;DEBESĖLIAI;4501490189;Taip;0;0;3;3
19144;Žirmūnėliai;DEBESĖLIAI;8239982682;Taip;1;0;3;4
19145;Žirmūnėliai;VIŠČIUKAI;2270868598;Taip;3;2;1;6
19146;Žirmūnėliai;VIŠČIUKAI;2802717644;Taip;11;0;0;11
19147;Žirmūnėliai;VIŠČIUKAI;3029428022;Taip;6;0;0;6
19148;Žirmūnėliai;VIŠČIUKAI;9759504463;Taip;2;0;0;2
19149;Žirmūnėliai;VIŠČIUKAI;4134541560;Taip;11;0;0;11
19150;Žirmūnėliai;VIŠČIUKAI;8481357052;Taip;8;0;3;11
19151;Žirmūnėliai;VIŠČIUKAI;6892941066;Taip;8;0;4;12
19152;Žirmūnėliai;VIŠČIUKAI;9858198555;Taip;1;0;0;1
19153;Žirmūnėliai;VIŠČIUKAI;3641319043;Taip;8;1;1;10
19154;Žirmūnėliai;VIŠČIUKAI;6523502376;Taip;0;0;1;1
19155;Žirmūnėliai;VIŠČIUKAI;9280663182;Taip;0;7;0;7
19156;Žirmūnėliai;VIŠČIUKAI;5281338626;Taip;0;2;0;2
19157;Žirmūnėliai;VIŠČIUKAI;9688006040;Taip;21;0;0;21
19158;Žirmūnėliai;VIŠČIUKAI;5622319185;Taip;18;0;0;18
19159;Žirmūnėliai;VIŠČIUKAI;7053321410;Taip;13;0;0;13
19160;Žirmūnėliai;ZUIKUČIŲ;4291114238;Taip;5;1;0;6
19161;Žirmūnėliai;ZUIKUČIŲ;3762889366;Taip;6;3;0;9
19162;Žirmūnėliai;ZUIKUČIŲ;3977279181;Taip;10;0;0;10
19163;Žirmūnėliai;ZUIKUČIŲ;8002655555;Taip;0;13;0;13
19164;Žirmūnėliai;ZUIKUČIŲ;6427861912;Taip;6;0;3;9
19165;Žirmūnėliai;ZUIKUČIŲ;2736632324;Taip;5;2;4;11
19166;Žirmūnėliai;ZUIKUČIŲ;5892153807;Taip;6;1;1;8
19167;Žirmūnėliai;ZUIKUČIŲ;2870069039;Taip;6;1;0;7
19168;Žirmūnėliai;ZUIKUČIŲ;6543834058;Taip;11;0;1;12
19169;Žirmūnėliai;ZUIKUČIŲ;8271996884;Taip;1;1;0;2
19170;Žirmūnėliai;ZUIKUČIŲ;3012945005;Ne;8;0;0;8
19171;Žirmūnėliai;ZUIKUČIŲ;8782085662;Taip;13;1;2;16
19172;Žirmūnėliai;ZUIKUČIŲ;3174613910;Taip;0;1;3;4
19173;Žirmūnėliai;ZUIKUČIŲ;5668266601;Taip;9;0;1;10
19174;Žirmūnėliai;ZUIKUČIŲ;9472372819;Ne;0;2;0;2
19175;Žirmūnėliai;ZUIKUČIŲ;6812682361;Taip;5;0;0;5
19176;Žirmūnėliai;OBUOLIUKAI;4575123456;Taip;7;3;0;10
19177;Žirmūnėliai;OBUOLIUKAI;3795476732;Ne;8;0;0;8
19178;Žirmūnėliai;OBUOLIUKAI;1917500190;Taip;11;3;0;14
19179;Žirmūnėliai;OBUOLIUKAI;9002868728;Taip;6;0;0;6
19180;Žirmūnėliai;OBUOLIUKAI;2073922023;Ne;0;1;1;2
19181;Žirmūnėliai;OBUOLIUKAI;7059249540;Taip;18;0;0;18
19182;Žirmūnėliai;OBUOLIUKAI;4999561481;Taip;3;2;0;5
19183;Žirmūnėliai;OBUOLIUKAI;4802771311;Taip;12;1;0;13
19184;Žirmūnėliai;OBUOLIUKAI;6358006462;Taip;6;0;0;6
19185;Žirmūnėliai;OBUOLIUKAI;2497258407;Taip;10;1;0;11
19186;Žirmūnėliai;OBUOLIUKAI;3949374730;Taip;7;1;0;8
19187;Žirmūnėliai;OBUOLIUKAI;6869102228;Taip;7;1;0;8
19188;Žirmūnėliai;OBUOLIUKAI;9367849317;Taip;2;0;0;2
19189;Žirmūnėliai;OBUOLIUKAI;9892620134;Taip;0;1;0;1
19190;Žirmūnėliai;OBUOLIUKAI;6450412481;Taip;10;1;0;11
19191;Žirmūnėliai;OBUOLIUKAI;1523231731;Taip;11;1;0;12
19192;Žirmūnėliai;OBUOLIUKAI;9225654910;Taip;8;4;0;12
19193;Žirmūnėliai;OBUOLIUKAI;5483418311;Taip;0;2;0;2
19194;Žirmūnėliai;OBUOLIUKAI;7945713337;Taip;5;1;0;6
19195;Žirmūnėliai;OBUOLIUKAI;8823426998;Taip;14;0;0;14
19196;Žirmūnėliai;DAINORĖLIAI;1255294064;Taip;16;1;0;17
19197;Žirmūnėliai;DAINORĖLIAI;5616289290;Taip;11;0;0;11
19198;Žirmūnėliai;DAINORĖLIAI;3520677404;Taip;6;2;3;11
19199;Žirmūnėliai;DAINORĖLIAI;9978718231;Taip;4;1;2;7
19200;Žirmūnėliai;DAINORĖLIAI;6066212109;Taip;5;0;0;5
19201;Žirmūnėliai;DAINORĖLIAI;7589155099;Taip;0;2;3;5
19202;Žirmūnėliai;DAINORĖLIAI;4641264260;Taip;5;0;0;5
19203;Žirmūnėliai;DAINORĖLIAI;8794707243;Taip;0;1;4;5
19204;Žirmūnėliai;DAINORĖLIAI;1724203157;Taip;3;0;1;4
19205;Žirmūnėliai;DAINORĖLIAI;5646794795;Taip;3;0;0;3
19206;Žirmūnėliai;DAINORĖLIAI;5901940160;Taip;10;0;0;10
19207;Žirmūnėliai;DAINORĖLIAI;9908958250;Taip;6;3;0;9
19208;Žirmūnėliai;DAINORĖLIAI;1116572386;Taip;4;0;0;4
19209;Žirmūnėliai;DAINORĖLIAI;6991062262;Taip;5;0;0;5
19210;"Dainorėliai (Ankštoji g. 11)";VARPELIAI;87242570532;Taip;0;1;0;1
19211;"Dainorėliai (Ankštoji g. 11)";VARPELIAI;18233813290;Taip;0;1;0;1
19212;"Dainorėliai (Ankštoji g. 11)";VARPELIAI;6176171443;Taip;0;2;0;2
19213;"Dainorėliai (Ankštoji g. 11)";VARPELIAI;88781762328;Taip;4;2;0;6
19214;"Dainorėliai (Ankštoji g. 11)";VARPELIAI;5693385617;Taip;0;3;0;3
19215;"Dainorėliai (Ankštoji g. 11)";VARPELIAI;8267213392;Taip;0;1;0;1
19216;"Dainorėliai (Ankštoji g. 11)";VARPELIAI;5959380807;Taip;5;1;0;6
19217;"Dainorėliai (Ankštoji g. 11)";VARPELIAI;2938732886;Taip;0;3;0;3
19218;"Dainorėliai (Ankštoji g. 11)";VARPELIAI;3183793211;Taip;0;1;0;1
19219;"Dainorėliai (Ankštoji g. 11)";VARPELIAI;65467351140;Taip;4;2;0;6
19220;"Dainorėliai (Ankštoji g. 11)";VARPELIAI;8521878734;Taip;0;3;0;3
19221;"Dainorėliai (Ankštoji g. 11)";VARPELIAI;1928369859;Ne;0;2;0;2
19222;"Dainorėliai (Ankštoji g. 11)";VARPELIAI;6430425182;Taip;0;2;0;2
19223;"Dainorėliai (Ankštoji g. 11)";VARPELIAI;4269946363;Taip;0;1;0;1
19224;"Dainorėliai (Ankštoji g. 11)";VARPELIAI;1088248393;Taip;0;2;0;2
19225;"Dainorėliai (Ankštoji g. 11)";VARPELIAI;2070086316;Taip;0;2;0;2
19226;"Dainorėliai (Ankštoji g. 11)";VARPELIAI;2074070030;Taip;0;7;0;7
19227;"Dainorėliai (Ankštoji g. 11)";VARPELIAI;4591161640;Taip;0;1;0;1
19228;"Dainorėliai (Ankštoji g. 11)";VARPELIAI;6898685834;Taip;0;1;0;1
19229;"Dainorėliai (Ankštoji g. 11)";VARPELIAI;6909583023;Taip;0;2;0;2
19230;"Dainorėliai (Ankštoji g. 11)";VARPELIAI;9319771186;Taip;2;3;0;5
19231;"Dainorėliai (Ankštoji g. 11)";VARPELIAI;68134437706;Taip;0;1;0;1
19232;"Dainorėliai (Ankštoji g. 11)";ŽIOGELIAI;5591598390;Taip;2;2;0;4
19233;"Dainorėliai (Ankštoji g. 11)";ŽIOGELIAI;6481621329;Ne;5;1;0;6
19234;"Dainorėliai (Ankštoji g. 11)";ŽIOGELIAI;5715129088;Taip;6;0;1;7
19235;"Dainorėliai (Ankštoji g. 11)";ŽIOGELIAI;9132532505;Taip;8;0;0;8
19236;"Dainorėliai (Ankštoji g. 11)";ŽIOGELIAI;2450726148;Taip;0;3;0;3
19237;"Dainorėliai (Ankštoji g. 11)";ŽIOGELIAI;5793828922;Taip;0;1;0;1
19238;"Dainorėliai (Ankštoji g. 11)";ŽIOGELIAI;7591953671;Taip;0;21;0;21
19239;"Dainorėliai (Ankštoji g. 11)";ŽIOGELIAI;6169434322;Taip;3;2;0;5
19240;"Dainorėliai (Ankštoji g. 11)";ŽIOGELIAI;2094849111;Taip;0;1;0;1
19241;"Dainorėliai (Ankštoji g. 11)";ŽIOGELIAI;6659114730;Taip;9;0;1;10
19242;"Dainorėliai (Ankštoji g. 11)";ŽIOGELIAI;3887433142;Taip;14;1;0;15
19243;"Dainorėliai (Ankštoji g. 11)";ŽIOGELIAI;2541781620;Taip;3;0;0;3
19244;"Dainorėliai (Ankštoji g. 11)";ŽIOGELIAI;8239000041;Taip;0;8;0;8
19245;"Dainorėliai (Ankštoji g. 11)";ŽIOGELIAI;7984447187;Taip;13;0;0;13
19246;"Dainorėliai (Ankštoji g. 11)";ŽIOGELIAI;3897725337;Taip;3;0;0;3
19247;"Dainorėliai (Ankštoji g. 11)";ŽIOGELIAI;3598951899;Taip;5;1;0;6
19248;"Dainorėliai (Ankštoji g. 11)";ŽIOGELIAI;4973241539;Taip;12;8;0;20
19249;"Dainorėliai (Ankštoji g. 11)";ŽIOGELIAI;4969782237;Taip;0;1;0;1
19250;"Dainorėliai (Ankštoji g. 11)";DRUGELIAI;9592384914;Taip;0;0;1;1
19251;"Dainorėliai (Ankštoji g. 11)";DRUGELIAI;6403389248;Taip;0;1;0;1
19252;"Dainorėliai (Ankštoji g. 11)";DRUGELIAI;4900234806;Taip;0;0;3;3
19253;"Dainorėliai (Ankštoji g. 11)";DRUGELIAI;8962657389;Taip;0;1;4;5
19254;"Dainorėliai (Ankštoji g. 11)";DRUGELIAI;2703267758;Taip;0;2;0;2
19255;"Dainorėliai (Ankštoji g. 11)";DRUGELIAI;6899629612;Taip;0;2;2;4
19256;"Dainorėliai (Ankštoji g. 11)";DRUGELIAI;2605119306;Taip;4;1;0;5
19257;"Dainorėliai (Ankštoji g. 11)";DRUGELIAI;9976869100;Taip;4;0;2;6
19258;"Dainorėliai (Ankštoji g. 11)";DRUGELIAI;3063825996;Taip;5;2;2;9
19259;"Dainorėliai (Ankštoji g. 11)";DRUGELIAI;9303046800;Taip;0;0;1;1
19260;"Dainorėliai (Ankštoji g. 11)";DRUGELIAI;3573324654;Taip;0;2;0;2
19261;"Dainorėliai (Ankštoji g. 11)";DRUGELIAI;3741337791;Taip;0;1;0;1
19262;"Dainorėliai (Ankštoji g. 11)";DRUGELIAI;8088948564;Taip;0;2;0;2
19263;"Dainorėliai (Ankštoji g. 11)";DRUGELIAI;1718576253;Taip;0;2;0;2
19264;"Dainorėliai (Ankštoji g. 11)";DRUGELIAI;2803571247;Taip;0;2;3;5
19265;"Dainorėliai (Ankštoji g. 11)";DRUGELIAI;5084474142;Taip;0;1;0;1
19266;"Dainorėliai (Ankštoji g. 11)";DRUGELIAI;1332165159;Taip;17;1;0;18
19267;"Dainorėliai (Ankštoji g. 11)";DRUGELIAI;8684975630;Taip;8;4;0;12
19268;"Dainorėliai (Ankštoji g. 11)";DRUGELIAI;2740773904;Taip;4;2;1;7
19269;"Dainorėliai (Ankštoji g. 11)";DRUGELIAI;6460217912;Taip;0;21;0;21
19270;"Dainorėliai (Ankštoji g. 11)";"1 klasė";50432354832;Taip;1;0;0;1
19271;"Dainorėliai (Ankštoji g. 11)";"1 klasė";1626877066;Taip;9;0;0;9
19272;"Dainorėliai (Ankštoji g. 11)";"1 klasė";1158895670;Taip;3;0;0;3
19273;"Dainorėliai (Ankštoji g. 11)";"1 klasė";73386013083;Taip;9;0;0;9
19274;"Dainorėliai (Ankštoji g. 11)";"1 klasė";27521381629;Taip;1;0;0;1
19275;"Dainorėliai (Ankštoji g. 11)";"1 klasė";6411939690;Taip;5;0;0;5
19276;"Dainorėliai (Ankštoji g. 11)";"1 klasė";2287353933;Taip;5;0;0;5
19277;"Dainorėliai (Ankštoji g. 11)";"1 klasė";36313982965;Taip;2;0;0;2
19278;"Dainorėliai (Ankštoji g. 11)";"1 klasė";5479496104;Ne;1;0;0;1
19279;"Dainorėliai (Ankštoji g. 11)";"1 klasė";49483881135;Taip;1;0;0;1
19280;"Dainorėliai (Ankštoji g. 11)";"1 klasė";7114409929;Taip;3;0;0;3
19281;"Dainorėliai (Ankštoji g. 11)";"1 klasė";1531362555;Ne;5;0;0;5
19282;"Dainorėliai (Ankštoji g. 11)";"2 klasė";67124516230;Ne;0;1;0;1
19283;"Dainorėliai (Ankštoji g. 11)";"2 klasė";7506194777;Taip;0;1;0;1
19284;"Dainorėliai (Ankštoji g. 11)";"2 klasė";1829858221;Taip;0;1;0;1
19285;"Dainorėliai (Ankštoji g. 11)";"2 klasė";1470784692;Taip;0;1;0;1
19286;"Dainorėliai (Ankštoji g. 11)";"2 klasė";7569146994;Taip;4;1;0;5
19287;"Dainorėliai (Ankštoji g. 11)";"2 klasė";45577031767;Taip;0;1;0;1
19288;"Dainorėliai (Ankštoji g. 11)";"2 klasė";58071607976;Ne;5;1;0;6
19289;"Dainorėliai (Ankštoji g. 11)";"2 klasė";1646521870;Taip;0;1;0;1
19290;"Dainorėliai (Ankštoji g. 11)";"2 klasė";29132059636;Taip;0;1;0;1
19291;"Dainorėliai (Ankštoji g. 11)";"2 klasė";32573583030;Taip;0;1;0;1
19292;"Dainorėliai (Ankštoji g. 11)";"2 klasė";97947842490;Taip;0;1;0;1
19293;"Dainorėliai (Ankštoji g. 11)";"2 klasė";63211091321;Taip;0;1;0;1
19294;"Dainorėliai (Ankštoji g. 11)";"2 klasė";87717571411;Taip;0;1;0;1
19295;"Dainorėliai (Ankštoji g. 11)";"2 klasė";18936645521;Ne;0;1;0;1
19296;"Dainorėliai (Ankštoji g. 11)";"2 klasė";80499999855;Ne;0;1;0;1
19297;"Dainorėliai (Ankštoji g. 11)";"2 klasė";6948863728;Taip;11;1;0;12
19298;"Dainorėliai (Ankštoji g. 11)";"2 klasė";2531690903;Taip;10;1;0;11
19299;"Dainorėliai (Ankštoji g. 11)";"2 klasė";35134511946;Taip;1;1;0;2
19300;"Dainorėliai (Ankštoji g. 11)";"2 klasė";1121139222;Taip;0;1;0;1
19301;"Dainorėliai (Ankštoji g. 11)";"2 klasė";99597416067;Taip;0;1;0;1
19302;"Dainorėliai (Ankštoji g. 11)";"2 klasė";77718940253;Taip;0;1;0;1
19303;"Dainorėliai (Ankštoji g. 11)";"2 klasė";5236797727;Taip;0;1;0;1
19304;"Dainorėliai (Ankštoji g. 11)";"3 klasė";2045625141;Taip;10;1;0;11
19305;"Dainorėliai (Ankštoji g. 11)";"3 klasė";84084897419;Taip;1;1;0;2
19306;"Dainorėliai (Ankštoji g. 11)";"3 klasė";34219208558;Taip;3;1;0;4
19307;"Dainorėliai (Ankštoji g. 11)";"3 klasė";13138644060;Taip;2;1;0;3
19308;"Dainorėliai (Ankštoji g. 11)";"3 klasė";49342277188;Taip;0;1;0;1
19309;"Dainorėliai (Ankštoji g. 11)";"3 klasė";42402953271;Taip;0;1;0;1
19310;"Dainorėliai (Ankštoji g. 11)";"3 klasė";2441164154;Taip;0;1;0;1
19311;"Dainorėliai (Ankštoji g. 11)";"3 klasė";69556449215;Taip;3;1;0;4
19312;"Dainorėliai (Ankštoji g. 11)";"3 klasė";8244355193;Taip;0;1;0;1
19313;"Dainorėliai (Ankštoji g. 11)";"3 klasė";2142553899;Taip;0;1;0;1
19314;"Dainorėliai (Ankštoji g. 11)";"3 klasė";37660372564;Taip;5;1;0;6
19315;"Dainorėliai (Ankštoji g. 11)";"3 klasė";1889037823;Taip;0;1;0;1
19316;"Dainorėliai (Ankštoji g. 11)";"3 klasė";98796240124;Taip;0;1;0;1
19317;"Dainorėliai (Ankštoji g. 11)";"3 klasė";98830139164;Taip;1;1;0;2
19318;"Dainorėliai (Ankštoji g. 11)";"3 klasė";37708779599;Taip;0;1;0;1
19319;"Dainorėliai (Ankštoji g. 11)";"3 klasė";18741625569;Taip;0;1;0;1
19320;"Dainorėliai (Ankštoji g. 11)";"3 klasė";84424772471;Taip;0;1;0;1
19321;"Dainorėliai (Ankštoji g. 11)";"3 klasė";34686211072;Taip;1;1;0;2
19322;"Dainorėliai (Ankštoji g. 11)";"3 klasė";79461209783;Taip;0;1;0;1
19323;"Dainorėliai (Ankštoji g. 11)";"3 klasė";47323045857;Taip;2;1;0;3
19324;"Dainorėliai (Ankštoji g. 11)";"3 klasė";10679627657;Taip;0;1;0;1
19325;"Dainorėliai (Ankštoji g. 11)";"3 klasė";25073134850;Taip;0;1;0;1
19326;"Dainorėliai (Ankštoji g. 11)";"3 klasė";65118883315;Taip;0;1;0;1
19327;"Dainorėliai (Ankštoji g. 11)";"3 klasė";84999972369;Taip;0;1;0;1
19328;"Dainorėliai (Ankštoji g. 11)";"3 klasė";1209781483;Taip;0;1;0;1
19329;"Dainorėliai (Ankštoji g. 11)";"3 klasė";69732047046;Taip;1;1;0;2
19330;"Dainorėliai (Ankštoji g. 11)";"4 klasė";29726515194;Taip;6;1;0;7
19331;"Dainorėliai (Ankštoji g. 11)";"4 klasė";8562371599;Taip;0;1;0;1
19332;"Dainorėliai (Ankštoji g. 11)";"4 klasė";19292860218;Taip;0;1;0;1
19333;"Dainorėliai (Ankštoji g. 11)";"4 klasė";97182565649;Taip;0;1;0;1
19334;"Dainorėliai (Ankštoji g. 11)";"4 klasė";65982869126;Ne;2;1;0;3
19335;"Dainorėliai (Ankštoji g. 11)";"4 klasė";93738984644;Taip;0;1;0;1
19336;"Dainorėliai (Ankštoji g. 11)";"4 klasė";69409530494;Taip;0;1;0;1
19337;"Dainorėliai (Ankštoji g. 11)";"4 klasė";57179351170;Taip;0;1;0;1
19338;"Dainorėliai (Ankštoji g. 11)";"4 klasė";77907054102;Taip;0;1;0;1
19339;"Dainorėliai (Ankštoji g. 11)";"4 klasė";24048489264;Ne;0;1;0;1
19340;"Dainorėliai (Ankštoji g. 11)";"4 klasė";4773358825;Taip;0;1;0;1
19341;"Dainorėliai (Ankštoji g. 11)";"4 klasė";91457137356;Taip;0;1;0;1
19342;"Dainorėliai (Ankštoji g. 11)";"4 klasė";5010994621;Taip;0;1;0;1
19343;"Dainorėliai (Ankštoji g. 11)";"4 klasė";13846131820;Taip;1;1;0;2
19344;"Dainorėliai (Ankštoji g. 11)";"4 klasė";23144978287;Taip;1;1;0;2
19345;"Dainorėliai (Ankštoji g. 11)";"4 klasė";6203511535;Taip;0;1;0;1
19346;"Dainorėliai (Ankštoji g. 11)";"4 klasė";81956978417;Taip;1;1;0;2
19347;"Dainorėliai (Ankštoji g. 11)";"4 klasė";3018657993;Taip;0;1;0;1
19348;"Dainorėliai (Ankštoji g. 11)";"4 klasė";48245075123;Taip;0;1;0;1
19349;"Dainorėliai (Ankštoji g. 11)";"4 klasė";57618865048;Taip;1;1;0;2
19350;"Dainorėliai (Ankštoji g. 11)";"4 klasė";84749521489;Taip;0;1;0;1
19351;"Dainorėliai (Ankštoji g. 11)";"4 klasė";26315465923;Taip;1;1;0;2
19352;"Dainorėliai (Ankštoji g. 11)";SAULUTĖS;4798415786;Ne;0;2;0;2
19353;"Dainorėliai (Ankštoji g. 11)";SAULUTĖS;6385439136;Taip;0;2;0;2
19354;"Dainorėliai (Ankštoji g. 11)";SAULUTĖS;6704354150;Taip;0;1;0;1
19355;"Dainorėliai (Ankštoji g. 11)";SAULUTĖS;4612995336;Ne;10;1;0;11
19356;"Dainorėliai (Ankštoji g. 11)";SAULUTĖS;5687390372;Taip;0;1;0;1
19357;"Dainorėliai (Ankštoji g. 11)";SAULUTĖS;7118473669;Taip;2;0;0;2
19358;"Dainorėliai (Ankštoji g. 11)";SAULUTĖS;4307591123;Taip;0;4;0;4
19359;"Dainorėliai (Ankštoji g. 11)";SAULUTĖS;5632663846;Taip;0;1;0;1
19360;"Dainorėliai (Ankštoji g. 11)";SAULUTĖS;7804441689;Taip;7;1;0;8
19361;"Dainorėliai (Ankštoji g. 11)";SAULUTĖS;6090746954;Taip;0;1;0;1
19362;"Dainorėliai (Ankštoji g. 11)";SAULUTĖS;5410183494;Taip;8;1;0;9
19363;"Dainorėliai (Ankštoji g. 11)";SAULUTĖS;9130473411;Taip;7;1;1;9
19364;"Dainorėliai (Ankštoji g. 11)";SAULUTĖS;5587907483;Ne;14;1;0;15
19365;"Dainorėliai (Ankštoji g. 11)";SAULUTĖS;1552829080;Taip;0;2;0;2
19366;"Dainorėliai (Ankštoji g. 11)";SAULUTĖS;3762178533;Taip;0;1;0;1
19367;"Dainorėliai (Ankštoji g. 11)";SAULUTĖS;2064843848;Taip;5;3;0;8
19368;"Dainorėliai (Ankštoji g. 11)";SAULUTĖS;4431804759;Taip;0;4;0;4
19369;"Dainorėliai (Ankštoji g. 11)";SAULUTĖS;8857018998;Taip;5;1;0;6
19370;"Dainorėliai (Ankštoji g. 11)";SAULUTĖS;1547686786;Taip;0;4;0;4
19371;"Dainorėliai (Ankštoji g. 11)";SAULUTĖS;6697149560;Taip;2;1;1;4
19372;"Dainorėliai (Ankštoji g. 11)";PUMPURĖLIŲ;4560328911;Taip;7;0;0;7
19373;"Dainorėliai (Ankštoji g. 11)";PUMPURĖLIŲ;4435310580;Taip;10;0;17;27
19374;"Dainorėliai (Ankštoji g. 11)";PUMPURĖLIŲ;7197089520;Taip;0;0;1;1
19375;"Dainorėliai (Ankštoji g. 11)";PUMPURĖLIŲ;6362265057;Taip;0;1;0;1
19376;"Dainorėliai (Ankštoji g. 11)";PUMPURĖLIŲ;2215481883;Taip;0;1;0;1
19377;"Dainorėliai (Ankštoji g. 11)";PUMPURĖLIŲ;1233029451;Taip;7;3;4;14
19378;"Dainorėliai (Ankštoji g. 11)";PUMPURĖLIŲ;3561729784;Taip;3;0;0;3
19379;"Dainorėliai (Ankštoji g. 11)";PUMPURĖLIŲ;5534783929;Taip;6;0;0;6
19380;"Dainorėliai (Ankštoji g. 11)";PUMPURĖLIŲ;3705286231;Taip;4;1;0;5
19381;"Dainorėliai (Ankštoji g. 11)";PUMPURĖLIŲ;4826994208;Taip;0;2;0;2
19382;"Dainorėliai (Ankštoji g. 11)";DEBESĖLIŲ;2095914442;Taip;0;1;0;1
19383;"Dainorėliai (Ankštoji g. 11)";DEBESĖLIŲ;3271090533;Taip;7;6;0;13
19384;"Dainorėliai (Ankštoji g. 11)";DEBESĖLIŲ;6284140548;Ne;0;10;0;10
19385;"Dainorėliai (Ankštoji g. 11)";DEBESĖLIŲ;5605084046;Taip;0;6;0;6
19386;"Dainorėliai (Ankštoji g. 11)";DEBESĖLIŲ;5283566263;Taip;0;3;0;3
19387;"Dainorėliai (Ankštoji g. 11)";DEBESĖLIŲ;9285865812;Taip;0;1;0;1
19388;"Dainorėliai (Ankštoji g. 11)";DEBESĖLIŲ;2823401633;Taip;0;3;0;3
19389;"Dainorėliai (Ankštoji g. 11)";DEBESĖLIŲ;6513417505;Taip;10;3;0;13
19390;"Dainorėliai (Ankštoji g. 11)";DEBESĖLIŲ;1873415679;Ne;7;1;0;8
19391;"Dainorėliai (Ankštoji g. 11)";DEBESĖLIŲ;1554081754;Taip;7;1;0;8
19392;"Dainorėliai (Ankštoji g. 11)";DEBESĖLIŲ;6449332338;Taip;0;3;0;3
19393;"Dainorėliai (Ankštoji g. 11)";DEBESĖLIŲ;2534758615;Taip;11;2;0;13
19394;"Dainorėliai (Ankštoji g. 11)";DEBESĖLIŲ;4255893222;Taip;0;1;0;1
19395;"Dainorėliai (Ankštoji g. 11)";DEBESĖLIŲ;4033317616;Taip;17;2;0;19
19396;Lokiukas;BITUTĖS;3329205450;Taip;0;1;7;8
19397;Lokiukas;BITUTĖS;7920238202;Taip;7;1;5;13
19398;Lokiukas;BITUTĖS;1376124245;Taip;0;21;0;21
19399;Lokiukas;BITUTĖS;2181315008;Taip;0;0;1;1
19400;Lokiukas;BITUTĖS;3896883842;Taip;15;1;0;16
19401;Lokiukas;BITUTĖS;8656751314;Taip;5;1;2;8
19402;Lokiukas;BITUTĖS;4551069961;Taip;0;1;3;4
19403;Lokiukas;BITUTĖS;5794303981;Taip;0;1;3;4
19404;Lokiukas;BITUTĖS;2671053309;Taip;3;1;0;4
19405;Lokiukas;BITUTĖS;5217458476;Taip;0;1;0;1
19406;Lokiukas;BITUTĖS;6883994020;Taip;7;1;0;8
19407;Lokiukas;BITUTĖS;8209165996;Taip;5;3;0;8
19408;Lokiukas;BITUTĖS;1647778939;Taip;0;1;3;4
19409;Lokiukas;BITUTĖS;6260486656;Taip;0;11;2;13
19410;Lokiukas;BITUTĖS;8334800302;Taip;0;1;3;4
19411;Lokiukas;BITUTĖS;1987485885;Ne;6;1;2;9
19412;Lokiukas;BITUTĖS;8378138411;Ne;0;1;1;2
19413;Lokiukas;BITUTĖS;3397999534;Taip;0;1;1;2
19414;Lokiukas;BITUTĖS;8994257898;Taip;0;1;3;4
19415;Lokiukas;"1 B klasė";14605095801;Taip;2;1;0;3
19416;Lokiukas;"1 B klasė";8036643654;Taip;0;1;0;1
19417;Lokiukas;"1 B klasė";5879386524;Taip;0;1;0;1
19418;Lokiukas;"1 B klasė";9625041533;Ne;0;1;0;1
19419;Lokiukas;"1 B klasė";2476231041;Ne;0;1;0;1
19420;Lokiukas;"1 B klasė";2548712970;Taip;4;1;0;5
19421;Lokiukas;"1 B klasė";1570438208;Taip;20;1;0;21
19422;Lokiukas;"1 B klasė";2673522432;Taip;20;1;0;21
19423;Lokiukas;"1 B klasė";47399326083;Taip;2;1;0;3
19424;Lokiukas;"1 B klasė";7591418969;Ne;0;1;0;1
19425;Lokiukas;"1 B klasė";4569798381;Taip;20;1;0;21
19426;Lokiukas;"1 B klasė";8399364170;Taip;1;1;0;2
19427;Lokiukas;"1 B klasė";97284171512;Taip;10;1;0;11
19428;Lokiukas;"1 B klasė";5943583254;Taip;0;1;0;1
19429;Lokiukas;"1 B klasė";3070998871;Taip;4;1;0;5
19430;Lokiukas;"1 B klasė";5453470660;Taip;0;1;0;1
19431;Lokiukas;"1 B klasė";4427448272;Taip;20;1;0;21
19432;Lokiukas;"1 B klasė";20659573470;Taip;20;1;0;21
19433;Lokiukas;"1 B klasė";5437008837;Taip;5;1;0;6
19434;Lokiukas;"1 B klasė";4580716838;Taip;0;1;0;1
19435;Lokiukas;"1 B klasė";39975872119;Taip;0;1;0;1
19436;Lokiukas;"1 B klasė";8568285232;Taip;0;1;0;1
19437;Lokiukas;"1 B klasė";9501202273;Taip;5;1;0;6
19438;Lokiukas;"1 B klasė";8943496964;Ne;20;1;0;21
19439;Lokiukas;"1 A klasė";56069293343;Taip;0;1;0;1
19440;Lokiukas;"1 A klasė";69364831994;Ne;2;1;0;3
19441;Lokiukas;"1 A klasė";1230490562;Ne;12;1;0;13
19442;Lokiukas;"1 A klasė";8452600632;Taip;3;1;0;4
19443;Lokiukas;"1 A klasė";39222094073;Taip;5;1;0;6
19444;Lokiukas;"1 A klasė";74169282323;Taip;0;1;0;1
19445;Lokiukas;"1 A klasė";35890122494;Taip;0;1;0;1
19446;Lokiukas;"1 A klasė";1626698185;Taip;0;1;0;1
19447;Lokiukas;"1 A klasė";8455869600;Taip;0;1;0;1
19448;Lokiukas;"1 A klasė";1625137322;Taip;1;1;0;2
19449;Lokiukas;"1 A klasė";2170176922;Ne;1;1;0;2
19450;Lokiukas;"1 A klasė";8270572748;Ne;0;1;0;1
19451;Lokiukas;"1 A klasė";34800098950;Taip;1;1;0;2
19452;Lokiukas;"1 A klasė";3825101647;Ne;30;1;0;31
19453;Lokiukas;"1 A klasė";8618280811;Ne;20;1;0;21
19454;Lokiukas;"1 A klasė";8323172347;Taip;6;1;0;7
19455;Lokiukas;"1 A klasė";7844351275;Ne;1;1;0;2
19456;Lokiukas;"1 A klasė";2045735700;Taip;0;1;0;1
19457;Lokiukas;"1 A klasė";3981653153;Ne;0;1;0;1
19458;Lokiukas;"1 A klasė";6318538591;Taip;0;1;0;1
19459;Lokiukas;"1 A klasė";43500434912;Taip;2;1;0;3
19460;Lokiukas;"1 A klasė";25141529581;Taip;0;1;0;1
19461;Lokiukas;"1 A klasė";3369746590;Taip;10;1;0;11
19462;Lokiukas;"1 A klasė";3004895246;Ne;20;1;0;21
19463;Lokiukas;"1 A klasė";3061816821;Ne;2;1;0;3
19464;Lokiukas;GUDRUČIAI;1604886863;Ne;5;0;1;6
19465;Lokiukas;GUDRUČIAI;3826815202;Taip;0;0;1;1
19466;Lokiukas;GUDRUČIAI;8687864179;Ne;0;1;1;2
19467;Lokiukas;GUDRUČIAI;5446430319;Taip;0;1;0;1
19468;Lokiukas;GUDRUČIAI;5995034919;Taip;2;1;1;4
19469;Lokiukas;GUDRUČIAI;2354942164;Ne;5;2;0;7
19470;Lokiukas;GUDRUČIAI;35364823312;Taip;0;1;0;1
19471;Lokiukas;GUDRUČIAI;5076773045;Taip;0;0;3;3
19472;Lokiukas;GUDRUČIAI;1188049956;Taip;0;1;0;1
19473;Lokiukas;GUDRUČIAI;1620856143;Ne;0;1;0;1
19474;Lokiukas;GUDRUČIAI;1733486244;Taip;0;1;1;2
19475;Lokiukas;GUDRUČIAI;4633366779;Taip;0;1;0;1
19476;Lokiukas;GUDRUČIAI;3485639108;Taip;0;1;2;3
19477;Lokiukas;GUDRUČIAI;3991821717;Taip;0;1;0;1
19478;Lokiukas;GUDRUČIAI;1606617694;Taip;0;6;0;6
19479;Lokiukas;GUDRUČIAI;8243342948;Taip;0;1;1;2
19480;Lokiukas;GUDRUČIAI;1210407640;Taip;5;1;0;6
19481;Lokiukas;BORUŽĖLĖS;4849031542;Taip;0;1;0;1
19482;Lokiukas;BORUŽĖLĖS;2625981190;Taip;0;1;0;1
19483;Lokiukas;BORUŽĖLĖS;4585621105;Taip;0;1;0;1
19484;Lokiukas;BORUŽĖLĖS;8576418875;Taip;0;11;0;11
19485;Lokiukas;BORUŽĖLĖS;4617372387;Taip;14;1;0;15
19486;Lokiukas;BORUŽĖLĖS;6869785650;Taip;0;2;0;2
19487;Lokiukas;BORUŽĖLĖS;8630112458;Taip;0;3;0;3
19488;Lokiukas;BORUŽĖLĖS;3930463578;Taip;0;1;3;4
19489;Lokiukas;BORUŽĖLĖS;6277388612;Taip;0;1;0;1
19490;Lokiukas;BORUŽĖLĖS;2660616022;Taip;5;1;0;6
19491;Lokiukas;BORUŽĖLĖS;9798351980;Taip;0;5;0;5
19492;Lokiukas;BORUŽĖLĖS;5401463671;Ne;7;2;0;9
19493;Lokiukas;BORUŽĖLĖS;9996442005;Ne;7;2;0;9
19494;Lokiukas;BORUŽĖLĖS;1226376844;Taip;0;2;2;4
19495;Lokiukas;BORUŽĖLĖS;4840187188;Taip;16;1;0;17
19496;Lokiukas;BORUŽĖLĖS;1724976098;Taip;0;6;0;6
19497;Lokiukas;BORUŽĖLĖS;7426579018;Taip;0;1;0;1
19498;Lokiukas;BORUŽĖLĖS;1974049743;Ne;6;2;1;9
19499;Lokiukas;BORUŽĖLĖS;3733581089;Taip;0;1;2;3
19500;Lokiukas;BORUŽĖLĖS;3876368364;Taip;0;2;0;2
19501;Lokiukas;BORUŽĖLĖS;9354491312;Taip;13;1;0;14
19502;Lokiukas;BORUŽĖLĖS;6091878190;Taip;0;1;0;1
19503;Lokiukas;BORUŽĖLĖS;1076719080;Taip;5;1;0;6
19504;Lokiukas;ANČIUKAI;5982831490;Ne;10;1;0;11
19505;Lokiukas;ANČIUKAI;5670185948;Ne;0;1;8;9
19506;Lokiukas;ANČIUKAI;5843699073;Taip;0;1;1;2
19507;Lokiukas;ANČIUKAI;4788062781;Ne;6;1;0;7
19508;Lokiukas;ANČIUKAI;8758248334;Taip;3;1;2;6
19509;Lokiukas;ANČIUKAI;2466354050;Taip;0;1;1;2
19510;Lokiukas;ANČIUKAI;3849212461;Taip;8;1;3;12
19511;Lokiukas;ANČIUKAI;1756658146;Taip;0;1;1;2
19512;Lokiukas;ANČIUKAI;3668903653;Taip;0;1;4;5
19513;Lokiukas;ANČIUKAI;7509043689;Taip;6;1;0;7
19514;Lokiukas;ANČIUKAI;9673257342;Taip;0;0;1;1
19515;Lokiukas;ANČIUKAI;2266747745;Taip;7;1;1;9
19516;Lokiukas;ANČIUKAI;4417116107;Taip;0;0;5;5
19517;Lokiukas;ANČIUKAI;5893844708;Taip;9;0;0;9
19518;Lokiukas;ANČIUKAI;3015119335;Taip;10;1;0;11
19519;Lokiukas;ANČIUKAI;1712365476;Taip;0;21;0;21
19520;Lokiukas;ANČIUKAI;6827710384;Taip;0;21;0;21
19521;Lokiukas;KODĖLČIUKAI;2642065594;Taip;12;1;0;13
19522;Lokiukas;KODĖLČIUKAI;5943412920;Taip;0;1;0;1
19523;Lokiukas;KODĖLČIUKAI;6758550653;Taip;10;1;3;14
19524;Lokiukas;KODĖLČIUKAI;6336140882;Taip;15;4;1;20
19525;Lokiukas;KODĖLČIUKAI;8796640190;Taip;0;3;1;4
19526;Lokiukas;KODĖLČIUKAI;8775608581;Taip;5;1;0;6
19527;Lokiukas;KODĖLČIUKAI;8915504279;Taip;0;2;0;2
19528;Lokiukas;KODĖLČIUKAI;4379238557;Taip;4;1;0;5
19529;Lokiukas;KODĖLČIUKAI;3694653020;Ne;0;3;6;9
19530;Lokiukas;KODĖLČIUKAI;4060641736;Ne;9;1;0;10
19531;Lokiukas;KODĖLČIUKAI;1025576053;Taip;13;1;0;14
19532;Lokiukas;KODĖLČIUKAI;1040288021;Taip;5;1;1;7
19533;Lokiukas;KODĖLČIUKAI;34546519642;Taip;2;1;0;3
19534;Lokiukas;KODĖLČIUKAI;9336617879;Taip;0;1;0;1
19535;Lokiukas;KODĖLČIUKAI;7943213321;Taip;0;4;0;4
19536;Lokiukas;KODĖLČIUKAI;6069516217;Taip;0;1;3;4
19537;Lokiukas;KODĖLČIUKAI;1752784666;Taip;0;1;0;1
19538;Lokiukas;KODĖLČIUKAI;4007839265;Taip;3;1;0;4
19539;Lokiukas;KODĖLČIUKAI;5467387832;Taip;3;3;0;6
19540;Lokiukas;KODĖLČIUKAI;9307491947;Taip;10;1;0;11
19541;Lokiukas;KODĖLČIUKAI;3744484616;Ne;0;1;0;1
19542;Lokiukas;KODĖLČIUKAI;8286358519;Taip;0;1;2;3
19543;Lokiukas;KODĖLČIUKAI;1886540733;Taip;4;1;0;5
19544;Lokiukas;KODĖLČIUKAI;8902619265;Taip;2;0;1;3
19545;Lokiukas;DRUGELIAI;1170293017;Taip;3;1;7;11
19546;Lokiukas;DRUGELIAI;4442073527;Taip;0;2;0;2
19547;Lokiukas;DRUGELIAI;2021477393;Taip;5;0;0;5
19548;Lokiukas;DRUGELIAI;4206181176;Taip;4;1;0;5
19549;Lokiukas;DRUGELIAI;7006828256;Taip;7;1;0;8
19550;Lokiukas;DRUGELIAI;7532603655;Taip;0;4;0;4
19551;Lokiukas;DRUGELIAI;4858829710;Taip;0;7;0;7
19552;Lokiukas;DRUGELIAI;2782818158;Taip;0;1;2;3
19553;Lokiukas;DRUGELIAI;4197547631;Taip;10;2;0;12
19554;Lokiukas;DRUGELIAI;8596706753;Taip;9;2;0;11
19555;Lokiukas;DRUGELIAI;4272205822;Taip;3;1;0;4
19556;Lokiukas;DRUGELIAI;2374601283;Taip;9;1;0;10
19557;Lokiukas;DRUGELIAI;7195184433;Taip;3;1;0;4
19558;Lokiukas;DRUGELIAI;4919744559;Taip;16;1;0;17
19559;Lokiukas;DRUGELIAI;6226281752;Taip;5;2;0;7
19560;Lokiukas;DRUGELIAI;1390586527;Taip;10;0;3;13
19561;Lokiukas;DRUGELIAI;8266708371;Taip;0;1;0;1
19562;Lokiukas;DRUGELIAI;2093224908;Taip;0;4;0;4
19563;Lokiukas;DRUGELIAI;1341265560;Taip;0;3;0;3
19564;Lokiukas;DRUGELIAI;5131662172;Ne;7;0;0;7
19565;Lokiukas;DRUGELIAI;1913742619;Ne;0;1;0;1
19566;Lokiukas;DRUGELIAI;4284574166;Ne;13;1;0;14
19567;Lokiukas;"2 A klasė";1201125655;Taip;0;1;0;1
19568;Lokiukas;"2 A klasė";2502465398;Taip;5;1;0;6
19569;Lokiukas;"2 A klasė";67133709394;Taip;2;1;0;3
19570;Lokiukas;"2 A klasė";73696992182;Ne;0;1;0;1
19571;Lokiukas;"2 A klasė";1056075876;Taip;0;1;0;1
19572;Lokiukas;"2 A klasė";9890308887;Taip;4;1;0;5
19573;Lokiukas;"2 A klasė";82025637099;Ne;13;1;0;14
19574;Lokiukas;"2 A klasė";8846527481;Taip;0;1;0;1
19575;Lokiukas;"2 A klasė";4353695640;Ne;0;1;0;1
19576;Lokiukas;"2 A klasė";73515179103;Taip;3;1;0;4
19577;Lokiukas;"2 A klasė";36677665098;Taip;1;1;0;2
19578;Lokiukas;"2 A klasė";131300206;Taip;2;1;0;3
19579;Lokiukas;"2 A klasė";77512682081;Taip;0;1;0;1
19580;Lokiukas;"2 A klasė";66528256040;Taip;0;1;0;1
19581;Lokiukas;"2 A klasė";86120193313;Taip;0;1;0;1
19582;Lokiukas;"2 A klasė";45028887854;Taip;4;1;0;5
19583;Lokiukas;"2 A klasė";83528495608;Taip;3;1;0;4
19584;Lokiukas;"2 A klasė";51237034253;Taip;1;1;0;2
19585;Lokiukas;"2 A klasė";52940830874;Taip;3;1;0;4
19586;Lokiukas;"2 A klasė";8240261104;Taip;0;1;0;1
19587;Lokiukas;"2 A klasė";27403835292;Taip;0;1;0;1
19588;Lokiukas;"2 A klasė";83086633109;Taip;1;1;0;2
19589;Lokiukas;"2 A klasė";38884246104;Taip;7;1;0;8
19590;Lokiukas;"2 B klasė";7235277422;Taip;11;1;0;12
19591;Lokiukas;"2 B klasė";1133294157;Taip;0;1;0;1
19592;Lokiukas;"2 B klasė";1072148409;Taip;4;1;0;5
19593;Lokiukas;"2 B klasė";92373834478;Ne;6;1;0;7
19594;Lokiukas;"2 B klasė";2054450461;Taip;0;1;0;1
19595;Lokiukas;"2 B klasė";3255141230;Taip;20;1;0;21
19596;Lokiukas;"2 B klasė";3255141230;Taip;20;1;0;21
19597;Lokiukas;"2 B klasė";14234831040;Taip;1;1;0;2
19598;Lokiukas;"2 B klasė";57505829630;Taip;0;1;0;1
19599;Lokiukas;"2 B klasė";7334971595;Taip;0;1;0;1
19600;Lokiukas;"2 B klasė";51059574159;Taip;0;1;0;1
19601;Lokiukas;"2 B klasė";4662981914;Taip;0;1;0;1
19602;Lokiukas;"2 B klasė";2959877846;Taip;20;1;0;21
19603;Lokiukas;"2 B klasė";6414861823;Taip;20;1;0;21
19604;Lokiukas;"2 B klasė";7130407913;Taip;20;1;0;21
19605;Lokiukas;"2 B klasė";98045145204;Taip;2;1;0;3
19606;Lokiukas;"2 B klasė";68390568000;Taip;2;1;0;3
19607;Lokiukas;"2 B klasė";8980902068;Taip;1;1;0;2
19608;Lokiukas;"2 B klasė";4164426360;Taip;1;1;0;2
19609;Lokiukas;"2 B klasė";14937983736;Taip;5;1;0;6
19610;Lokiukas;"2 B klasė";8996622650;Taip;1;1;0;2
19611;Lokiukas;"2 B klasė";61807094999;Taip;0;1;0;1
19612;Lokiukas;"2 B klasė";2078673522;Taip;5;1;0;6
19613;Lokiukas;"2 B klasė";40006848965;Taip;0;1;0;1
19614;Lokiukas;"2 B klasė";32714964224;Taip;0;1;0;1
19615;Lokiukas;"2 B klasė";8920359311;Taip;0;1;0;1
19616;Lokiukas;"2 B klasė";38001876942;Taip;1;1;0;2
19617;Lokiukas;"3 A klasė";25170045140;Taip;20;1;0;21
19618;Lokiukas;"3 A klasė";15406362908;Taip;3;1;0;4
19619;Lokiukas;"3 A klasė";45122233067;Taip;2;1;0;3
19620;Lokiukas;"3 A klasė";15685936471;Taip;0;1;0;1
19621;Lokiukas;"3 A klasė";10948160841;Taip;20;1;0;21
19622;Lokiukas;"3 A klasė";21802863853;Taip;3;1;0;4
19623;Lokiukas;"3 A klasė";29577495646;Taip;1;1;0;2
19624;Lokiukas;"3 A klasė";22979689191;Taip;0;1;0;1
19625;Lokiukas;"3 A klasė";80754592972;Taip;0;1;0;1
19626;Lokiukas;"3 A klasė";14903100496;Taip;0;1;0;1
19627;Lokiukas;"3 A klasė";97609897018;Taip;1;1;0;2
19628;Lokiukas;"3 A klasė";4608275224;Taip;3;1;0;4
19629;Lokiukas;"3 A klasė";99706061553;Taip;4;1;0;5
19630;Lokiukas;"3 A klasė";7785940412;Taip;3;1;0;4
19631;Lokiukas;"3 A klasė";24099693663;Taip;1;1;0;2
19632;Lokiukas;"3 A klasė";72092394330;Taip;0;1;0;1
19633;Lokiukas;"3 A klasė";35769782473;Taip;5;1;0;6
19634;Lokiukas;"3 A klasė";23688235312;Taip;0;1;0;1
19635;Lokiukas;"3 A klasė";43070670534;Taip;0;1;0;1
19636;Lokiukas;"3 A klasė";38531751377;Taip;1;1;0;2
19637;Lokiukas;"3 A klasė";15574258138;Taip;0;1;0;1
19638;Lokiukas;"3 A klasė";59840033826;Taip;0;1;0;1
19639;Lokiukas;"3 A klasė";24523198513;Taip;20;1;0;21
19640;Lokiukas;"3 A klasė";84273668685;Taip;0;1;0;1
19641;Lokiukas;"3 A klasė";9077016953;Taip;3;1;0;4
19642;Lokiukas;"3 A klasė";9747265775;Taip;20;1;0;21
19643;Lokiukas;"3 A klasė";5198408183;Taip;1;1;0;2
19644;Lokiukas;"3 A klasė";80793623068;Ne;5;1;0;6
19645;Lokiukas;"3 A klasė";93374754851;Taip;0;1;0;1
19646;Lokiukas;"3 B klasė";5311341721;Taip;20;1;0;21
19647;Lokiukas;"3 B klasė";61890775725;Taip;7;1;0;8
19648;Lokiukas;"3 B klasė";32506466236;Taip;3;1;0;4
19649;Lokiukas;"3 B klasė";24221829774;Taip;11;1;0;12
19650;Lokiukas;"3 B klasė";96046361641;Taip;4;1;0;5
19651;Lokiukas;"3 B klasė";7324496782;Taip;10;1;0;11
19652;Lokiukas;"3 B klasė";95910336503;Taip;2;1;0;3
19653;Lokiukas;"3 B klasė";58513885211;Taip;5;1;0;6
19654;Lokiukas;"3 B klasė";57958699478;Taip;1;1;0;2
19655;Lokiukas;"3 B klasė";10811780420;Taip;3;1;0;4
19656;Lokiukas;"3 B klasė";18646642032;Taip;2;1;0;3
19657;Lokiukas;"3 B klasė";79109699217;Taip;0;1;0;1
19658;Lokiukas;"3 B klasė";50713289266;Taip;20;1;0;21
19659;Lokiukas;"3 B klasė";20231469825;Taip;9;1;0;10
19660;Lokiukas;"3 B klasė";18336619115;Ne;1;1;0;2
19661;Lokiukas;"3 B klasė";2105377652;Taip;4;1;0;5
19662;Lokiukas;"3 B klasė";39867459515;Taip;6;1;0;7
19663;Lokiukas;"3 B klasė";1146878499;Taip;1;1;0;2
19664;Lokiukas;"3 B klasė";46587243900;Taip;4;1;0;5
19665;Lokiukas;"3 B klasė";62268017779;Taip;1;1;0;2
19666;Lokiukas;"3 B klasė";28796727185;Taip;16;1;0;17
19667;Lokiukas;"3 B klasė";88415635113;Taip;9;1;0;10
19668;Lokiukas;"3 B klasė";9141446821;Taip;4;1;0;5
19669;Lokiukas;"3 B klasė";7497324442;Taip;20;1;0;21
19670;Lokiukas;"3 B klasė";7903535850;Taip;4;1;0;5
19671;Lokiukas;"3 B klasė";75507005694;Taip;4;1;0;5
19672;Lokiukas;"3 B klasė";73426072972;Taip;4;1;0;5
19673;Lokiukas;"3 B klasė";59913848400;Taip;4;1;0;5
19674;Lokiukas;"4 A klasė";67818191566;Ne;4;1;0;5
19675;Lokiukas;"4 A klasė";45280536946;Taip;20;1;0;21
19676;Lokiukas;"4 A klasė";53087036306;Taip;0;1;0;1
19677;Lokiukas;"4 A klasė";79223457439;Taip;1;1;0;2
19678;Lokiukas;"4 A klasė";75613665040;Taip;0;1;0;1
19679;Lokiukas;"4 A klasė";10240586503;Taip;2;1;0;3
19680;Lokiukas;"4 A klasė";86623153797;Taip;0;1;0;1
19681;Lokiukas;"4 A klasė";27050402360;Taip;0;1;0;1
19682;Lokiukas;"4 A klasė";43389930516;Taip;0;1;0;1
19683;Lokiukas;"4 A klasė";23222644824;Taip;6;1;0;7
19684;Lokiukas;"4 A klasė";52296454506;Taip;0;1;0;1
19685;Lokiukas;"4 A klasė";66999644935;Taip;20;1;0;21
19686;Lokiukas;"4 A klasė";72167964645;Taip;8;1;0;9
19687;Lokiukas;"4 A klasė";2143040924;Taip;20;1;0;21
19688;Lokiukas;"4 A klasė";3206276637;Ne;20;1;0;21
19689;Lokiukas;"4 A klasė";5775631777;Taip;5;1;0;6
19690;Lokiukas;"4 A klasė";3703002168;Taip;2;1;0;3
19691;Lokiukas;"4 A klasė";38636200254;Taip;0;1;0;1
19692;Lokiukas;"4 A klasė";47410036889;Taip;0;1;0;1
19693;Lokiukas;"4 A klasė";53544600623;Taip;0;1;0;1
19694;Lokiukas;"4 A klasė";6702448475;Taip;0;1;0;1
19695;Lokiukas;"4 A klasė";82966541165;Taip;6;1;0;7
19696;Lokiukas;"4 A klasė";42292408557;Taip;20;1;0;21
19697;Lokiukas;"4 B klasė";35018370441;Taip;2;1;0;3
19698;Lokiukas;"4 B klasė";60370754283;Taip;5;1;0;6
19699;Lokiukas;"4 B klasė";98289469398;Taip;3;1;0;4
19700;Lokiukas;"4 B klasė";15445053855;Taip;1;1;0;2
19701;Lokiukas;"4 B klasė";3262579895;Taip;0;1;0;1
19702;Lokiukas;"4 B klasė";51554951703;Taip;20;1;0;21
19703;Lokiukas;"4 B klasė";88947878548;Taip;2;1;0;3
19704;Lokiukas;"4 B klasė";29198900240;Taip;1;1;0;2
19705;Lokiukas;"4 B klasė";77441549037;Taip;4;1;0;5
19706;Lokiukas;"4 B klasė";79301547085;Taip;0;1;0;1
19707;Lokiukas;"4 B klasė";10897713744;Taip;5;1;0;6
19708;Lokiukas;"4 B klasė";16889795010;Taip;20;1;0;21
19709;Lokiukas;"4 B klasė";5067673212;Taip;0;1;0;1
19710;Lokiukas;"4 B klasė";1424195731;Taip;20;1;0;21
19711;Lokiukas;"4 B klasė";1104333637;Taip;0;1;0;1
19712;Lokiukas;"4 B klasė";69089214980;Taip;0;1;0;1
19713;Lokiukas;"4 B klasė";45735190114;Taip;20;1;0;21
19714;Lokiukas;"4 B klasė";2353550739;Taip;2;1;0;3
19715;Lokiukas;"4 B klasė";15004419516;Taip;1;1;0;2
19716;Lokiukas;"4 B klasė";1245850082;Taip;20;1;0;21
19717;Šaltinėlis;Ančiukų;1312785137;Taip;6;3;0;9
19718;Šaltinėlis;Ančiukų;9209105445;Taip;0;6;0;6
19719;Šaltinėlis;Ančiukų;9112527921;Taip;0;2;0;2
19720;Šaltinėlis;Ančiukų;9398488555;Taip;2;2;0;4
19721;Šaltinėlis;Ančiukų;2027779524;Taip;0;8;0;8
19722;Šaltinėlis;Ančiukų;5498764523;Taip;9;0;1;10
19723;Šaltinėlis;Ančiukų;4226929875;Taip;10;1;0;11
19724;Šaltinėlis;Ančiukų;1489377928;Taip;0;9;0;9
19725;Šaltinėlis;Ančiukų;7325258256;Ne;1;0;6;7
19726;Šaltinėlis;Ančiukų;5005394548;Taip;1;15;0;16
19727;Šaltinėlis;Ančiukų;1102861619;Ne;4;2;0;6
19728;Šaltinėlis;Ančiukų;1928794692;Taip;10;0;0;10
19729;Šaltinėlis;Ančiukų;1742421427;Taip;4;2;0;6
19730;Šaltinėlis;Ančiukų;9581384663;Taip;6;0;0;6
19731;Šaltinėlis;Ančiukų;9465174636;Taip;9;5;0;14
19732;Šaltinėlis;Ančiukų;8034195267;Taip;0;0;4;4
19733;Šaltinėlis;Ančiukų;5455997139;Ne;0;3;0;3
19734;Šaltinėlis;Ančiukų;9588260206;Taip;11;0;0;11
19735;Šaltinėlis;Ančiukų;8116985061;Ne;12;2;0;14
19736;Šaltinėlis;Bitučių;9983153464;Taip;5;3;0;8
19737;Šaltinėlis;Bitučių;6487378225;Taip;0;1;0;1
19738;Šaltinėlis;Bitučių;56396772538;Taip;0;2;1;3
19739;Šaltinėlis;Bitučių;5251390843;Ne;6;1;1;8
19740;Šaltinėlis;Bitučių;8500790262;Taip;14;1;0;15
19741;Šaltinėlis;Bitučių;4332884673;Taip;9;1;0;10
19742;Šaltinėlis;Bitučių;3493429067;Taip;0;1;0;1
19743;Šaltinėlis;Bitučių;9362495172;Taip;0;6;0;6
19744;Šaltinėlis;Bitučių;6462738640;Taip;0;2;0;2
19745;Šaltinėlis;Bitučių;77872075694;Taip;0;1;0;1
19746;Šaltinėlis;Bitučių;7133143923;Taip;0;7;0;7
19747;Šaltinėlis;Bitučių;6887838949;Taip;7;4;0;11
19748;Šaltinėlis;Bitučių;2630875135;Taip;0;1;0;1
19749;Šaltinėlis;Bitučių;9218883174;Taip;12;0;0;12
19750;Šaltinėlis;Bitučių;2973820849;Taip;0;3;0;3
19751;Šaltinėlis;Bitučių;9820788524;Taip;0;10;0;10
19752;Šaltinėlis;Bitučių;9769491789;Taip;0;2;0;2
19753;Šaltinėlis;Bitučių;9274165569;Taip;0;3;0;3
19754;Šaltinėlis;Bitučių;2084451705;Taip;0;1;2;3
19755;Šaltinėlis;Bitučių;8555517284;Taip;6;2;0;8
19756;Šaltinėlis;Bitučių;1543331408;Taip;0;1;0;1
19757;Šaltinėlis;Bitučių;7483928256;Taip;4;4;0;8
19758;Šaltinėlis;Bitučių;2646901307;Taip;10;1;0;11
19759;Šaltinėlis;Bitučių;7737797979;Taip;5;1;0;6
19760;Šaltinėlis;Bitučių;3017437426;Taip;5;1;0;6
19761;Šaltinėlis;Saulutės;7311831014;Ne;23;0;0;23
19762;Šaltinėlis;Saulutės;5854723120;Taip;0;11;0;11
19763;Šaltinėlis;Saulutės;5833136956;Taip;0;1;0;1
19764;Šaltinėlis;Saulutės;3483756240;Taip;0;1;0;1
19765;Šaltinėlis;Saulutės;6380346298;Taip;0;1;0;1
19766;Šaltinėlis;Saulutės;5799032398;Taip;9;3;0;12
19767;Šaltinėlis;Saulutės;5525740049;Ne;0;3;0;3
19768;Šaltinėlis;Saulutės;5382567842;Taip;0;8;0;8
19769;Šaltinėlis;Saulutės;1978469605;Ne;0;9;0;9
19770;Šaltinėlis;Saulutės;4743907195;Taip;0;6;0;6
19771;Šaltinėlis;Saulutės;5343279219;Taip;0;8;0;8
19772;Šaltinėlis;Saulutės;7118672118;Ne;4;1;0;5
19773;Šaltinėlis;Saulutės;2465009553;Taip;1;2;0;3
19774;Šaltinėlis;Saulutės;5345738219;Taip;6;2;0;8
19775;Šaltinėlis;Saulutės;6721510313;Ne;0;1;0;1
19776;Šaltinėlis;Saulutės;7650840990;Taip;0;3;0;3
19777;Šaltinėlis;Saulutės;1678450741;Taip;6;1;0;7
19778;Šaltinėlis;Saulutės;5774391181;Ne;0;2;0;2
19779;Šaltinėlis;Saulutės;4681460322;Taip;11;2;0;13
19780;Šaltinėlis;Saulutės;3968514430;Taip;0;1;0;1
19781;Šaltinėlis;Saulutės;8950694484;Ne;0;2;0;2
19782;Šaltinėlis;Saulutės;2499890317;Taip;12;0;0;12
19783;Šaltinėlis;Saulutės;3579974049;Taip;0;8;0;8
19784;Šaltinėlis;Meškiukų;6915625306;Taip;0;6;0;6
19785;Šaltinėlis;Meškiukų;6645807642;Taip;8;2;0;10
19786;Šaltinėlis;Meškiukų;9759912102;Ne;11;0;0;11
19787;Šaltinėlis;Meškiukų;4664741207;Taip;10;1;0;11
19788;Šaltinėlis;Meškiukų;1400918201;Ne;13;1;0;14
19789;Šaltinėlis;Meškiukų;5420067622;Taip;0;13;0;13
19790;Šaltinėlis;Meškiukų;1656674673;Taip;6;1;0;7
19791;Šaltinėlis;Meškiukų;4248763165;Taip;4;1;0;5
19792;Šaltinėlis;Meškiukų;5982018366;Ne;6;1;0;7
19793;Šaltinėlis;Meškiukų;9922223978;Taip;6;2;0;8
19794;Šaltinėlis;Meškiukų;8995077908;Taip;0;9;0;9
19795;Šaltinėlis;Meškiukų;5982188743;Ne;0;3;0;3
19796;Šaltinėlis;Meškiukų;6586783795;Taip;8;2;2;12
19797;Šaltinėlis;Meškiukų;7468640592;Taip;0;2;0;2
19798;Šaltinėlis;Meškiukų;4064231806;Taip;7;0;0;7
19799;Šaltinėlis;Meškiukų;4159654434;Taip;0;0;2;2
19800;Šaltinėlis;Meškiukų;6688536661;Taip;0;5;0;5
19801;Šaltinėlis;Meškiukų;8880659539;Ne;0;8;0;8
19802;Šaltinėlis;Meškiukų;3228788999;Taip;0;1;0;1
19803;Šaltinėlis;Meškiukų;5905345563;Taip;6;2;0;8
19804;Šaltinėlis;Meškiukų;2332065937;Taip;21;0;0;21
19805;Šaltinėlis;Nykštukai;9766640995;Ne;12;0;0;12
19806;Šaltinėlis;Nykštukai;3356138058;Taip;5;1;1;7
19807;Šaltinėlis;Nykštukai;5434349511;Ne;28;0;0;28
19808;Šaltinėlis;Nykštukai;4226068669;Taip;7;3;0;10
19809;Šaltinėlis;Nykštukai;2976773344;Ne;8;3;0;11
19810;Šaltinėlis;Nykštukai;3687243030;Taip;5;8;0;13
19811;Šaltinėlis;Nykštukai;4364256563;Taip;3;0;0;3
19812;Šaltinėlis;Nykštukai;9333013048;Taip;5;0;0;5
19813;Šaltinėlis;Nykštukai;4029616063;Taip;10;1;0;11
19814;Šaltinėlis;Nykštukai;6530797082;Taip;2;0;0;2
19815;Šaltinėlis;Nykštukai;7534585887;Taip;8;0;0;8
19816;Šaltinėlis;Nykštukai;8977029692;Taip;5;3;0;8
19817;Šaltinėlis;Nykštukai;7120592596;Taip;8;0;0;8
19818;Šaltinėlis;Nykštukai;6244924079;Taip;12;0;0;12
19819;Šaltinėlis;Nykštukai;3806267811;Taip;13;1;1;15
19820;Šaltinėlis;Nykštukai;3497881408;Ne;8;2;0;10
19821;Šaltinėlis;Nykštukai;6383844995;Taip;11;1;0;12
19822;Šaltinėlis;Perliukų;2825412170;Taip;6;1;0;7
19823;Šaltinėlis;Perliukų;1686009371;Taip;0;3;0;3
19824;Šaltinėlis;Perliukų;9522524163;Taip;0;3;3;6
19825;Šaltinėlis;Perliukų;7068058767;Taip;2;3;0;5
19826;Šaltinėlis;Perliukų;2189112609;Taip;0;3;1;4
19827;Šaltinėlis;Perliukų;8914777163;Taip;12;5;0;17
19828;Šaltinėlis;Perliukų;7387221265;Taip;2;2;0;4
19829;Šaltinėlis;Perliukų;9674923143;Taip;7;1;0;8
19830;Šaltinėlis;Perliukų;1823048790;Taip;0;1;0;1
19831;Šaltinėlis;Perliukų;3073692882;Taip;5;8;0;13
19832;Šaltinėlis;Perliukų;5325974488;Taip;5;3;1;9
19833;Šaltinėlis;Perliukų;2126751248;Taip;0;1;0;1
19834;Šaltinėlis;Perliukų;3271931810;Taip;5;0;2;7
19835;Šaltinėlis;Perliukų;7955094634;Taip;0;1;0;1
19836;Šaltinėlis;Perliukų;1445108285;Taip;0;9;0;9
19837;Šaltinėlis;Perliukų;7133044918;Taip;9;1;1;11
19838;Šaltinėlis;Perliukų;2806453623;Taip;0;1;2;3
19839;Šaltinėlis;Perliukų;9691993251;Taip;0;1;0;1
19840;Šaltinėlis;Perliukų;8695191968;Taip;0;4;0;4
19841;Šaltinėlis;Perliukų;4430546695;Ne;23;0;0;23
19842;Šaltinėlis;BORUŽĖLĖS;3505001330;Taip;9;1;0;10
19843;Šaltinėlis;BORUŽĖLĖS;8973369897;Taip;0;5;0;5
19844;Šaltinėlis;BORUŽĖLĖS;3780870805;Taip;7;0;0;7
19845;Šaltinėlis;BORUŽĖLĖS;2157520281;Taip;10;1;0;11
19846;Šaltinėlis;BORUŽĖLĖS;1441937630;Taip;5;0;0;5
19847;Šaltinėlis;BORUŽĖLĖS;8995954572;Taip;9;0;0;9
19848;Šaltinėlis;BORUŽĖLĖS;4742849747;Taip;0;5;0;5
19849;Šaltinėlis;BORUŽĖLĖS;5996579651;Taip;0;1;0;1
19850;Šaltinėlis;BORUŽĖLĖS;5331397179;Ne;8;2;0;10
19851;Šaltinėlis;BORUŽĖLĖS;1238867065;Taip;5;3;0;8
19852;Šaltinėlis;BORUŽĖLĖS;9218436977;Taip;9;1;0;10
19853;Šaltinėlis;BORUŽĖLĖS;2353630084;Taip;0;0;1;1
19854;Šaltinėlis;BORUŽĖLĖS;5593692486;Taip;10;0;0;10
19855;Šaltinėlis;BORUŽĖLĖS;1496105338;Taip;0;4;0;4
19856;Šaltinėlis;1A;9188065549;Ne;0;1;0;1
19857;Šaltinėlis;1A;9305706589;Ne;0;1;0;1
19858;Šaltinėlis;1A;1580090516;Taip;0;2;0;2
19859;Šaltinėlis;1A;2034838765;Taip;0;1;0;1
19860;Šaltinėlis;1A;2105963102;Taip;0;4;0;4
19861;Šaltinėlis;1A;3582666579;Taip;0;3;0;3
19862;Šaltinėlis;1A;46569341613;Taip;0;1;0;1
19863;Šaltinėlis;1A;2801321116;Taip;0;3;0;3
19864;Šaltinėlis;1A;1091056386;Taip;0;1;0;1
19865;Šaltinėlis;1A;52142182972;Taip;0;1;0;1
19866;Šaltinėlis;1A;6880337593;Ne;0;1;0;1
19867;Šaltinėlis;1A;3516760367;Taip;0;1;0;1
19868;Šaltinėlis;1A;56542341895;Ne;0;1;0;1
19869;Šaltinėlis;1A;1910670134;Taip;0;1;0;1
19870;Šaltinėlis;1A;9595350871;Taip;0;6;0;6
19871;Šaltinėlis;1A;15925823621;Taip;0;1;0;1
19872;Šaltinėlis;1A;8902634958;Taip;0;3;0;3
19873;Šaltinėlis;1A;9757246434;Taip;0;9;0;9
19874;Šaltinėlis;1A;7262120071;Ne;0;2;0;2
19875;Šaltinėlis;1A;1004445904;Taip;0;1;0;1
19876;Šaltinėlis;"2A klasė";32264290873;Taip;0;6;0;6
19877;Šaltinėlis;"2A klasė";1767635282;Taip;0;1;0;1
19878;Šaltinėlis;"2A klasė";1390316465;Taip;0;3;0;3
19879;Šaltinėlis;"2A klasė";5442943843;Taip;0;1;0;1
19880;Šaltinėlis;"2A klasė";6764006747;Taip;0;1;0;1
19881;Šaltinėlis;"2A klasė";1658370782;Taip;0;1;0;1
19882;Šaltinėlis;"2A klasė";10918276041;Taip;0;1;0;1
19883;Šaltinėlis;"2A klasė";3455754351;Taip;0;21;0;21
19884;Šaltinėlis;"2A klasė";66575684640;Taip;5;1;0;6
19885;Šaltinėlis;"2A klasė";86592374576;Taip;0;21;0;21
19886;Šaltinėlis;"2A klasė";13808708760;Taip;0;2;0;2
19887;Šaltinėlis;"2A klasė";1614411921;Ne;0;3;0;3
19888;Šaltinėlis;"2A klasė";79406746980;Taip;0;7;0;7
19889;Šaltinėlis;"2A klasė";3577137327;Taip;0;6;0;6
19890;Šaltinėlis;"2A klasė";1224027643;Taip;0;1;0;1
19891;Šaltinėlis;"2A klasė";48525545812;Taip;0;12;0;12
19892;Šaltinėlis;"2A klasė";7073644279;Taip;0;1;0;1
19893;Šaltinėlis;"2A klasė";3022926855;Ne;0;1;0;1
19894;Šaltinėlis;"2A klasė";1190394855;Taip;0;1;0;1
19895;Šaltinėlis;"2A klasė";40186714037;Taip;0;1;0;1
19896;Šaltinėlis;"2A klasė";1456486363;Taip;0;1;0;1
19897;Šaltinėlis;"2A klasė";32949623652;Taip;0;8;0;8
19898;Šaltinėlis;"3A klasė";14213856824;Taip;0;1;0;1
19899;Šaltinėlis;"3A klasė";80649337160;Taip;0;6;0;6
19900;Šaltinėlis;"3A klasė";92958012146;Taip;0;2;0;2
19901;Šaltinėlis;"3A klasė";84656960510;Taip;0;1;0;1
19902;Šaltinėlis;"3A klasė";83621946293;Taip;0;21;0;21
19903;Šaltinėlis;"3A klasė";67808618878;Ne;10;19;0;29
19904;Šaltinėlis;"3A klasė";1278910777;Taip;0;1;0;1
19905;Šaltinėlis;"3A klasė";9647785988;Taip;0;21;0;21
19906;Šaltinėlis;"3A klasė";82671662416;Taip;5;1;0;6
19907;Šaltinėlis;"3A klasė";54025577281;Taip;0;6;0;6
19908;Šaltinėlis;"3A klasė";488285764;Taip;0;1;0;1
19909;Šaltinėlis;"3A klasė";29482180151;Taip;0;1;0;1
19910;Šaltinėlis;"3A klasė";54753218491;Taip;0;21;0;21
19911;Šaltinėlis;"3A klasė";86029472773;Taip;0;21;0;21
19912;Šaltinėlis;"3A klasė";64821172553;Taip;0;5;0;5
19913;Šaltinėlis;"3A klasė";5744976843;Taip;0;3;0;3
19914;Šaltinėlis;"3A klasė";25459069972;Ne;0;1;0;1
19915;Šaltinėlis;"3A klasė";6669392157;Taip;0;1;0;1
19916;Šaltinėlis;"3A klasė";89358384113;Taip;0;2;0;2
19917;Šaltinėlis;"3A klasė";28956971978;Taip;0;2;0;2
19918;Šaltinėlis;"3A klasė";4050444191;Taip;5;1;0;6
19919;Šaltinėlis;"3A klasė";89093437170;Taip;0;1;0;1
19920;Šaltinėlis;"3A klasė";51872331010;Taip;0;6;0;6
19921;Šaltinėlis;"4A klasė";83657465071;Taip;0;1;0;1
19922;Šaltinėlis;"4A klasė";86309198604;Taip;0;4;0;4
19923;Šaltinėlis;"4A klasė";9705941341;Taip;0;21;0;21
19924;Šaltinėlis;"4A klasė";38496350161;Taip;0;21;0;21
19925;Šaltinėlis;"4A klasė";62612067151;Taip;0;1;0;1
19926;Šaltinėlis;"4A klasė";96133834896;Taip;0;21;0;21
19927;Šaltinėlis;"4A klasė";73466313766;Taip;0;1;0;1
19928;Šaltinėlis;"4A klasė";2323456393;Taip;0;21;0;21
19929;Šaltinėlis;"4A klasė";56279691365;Taip;0;1;0;1
19930;Šaltinėlis;"4A klasė";4587186145;Taip;0;3;0;3
19931;Šaltinėlis;"4A klasė";70948186548;Taip;0;1;0;1
19932;Šaltinėlis;"4A klasė";47045578599;Ne;0;3;0;3
19933;Šaltinėlis;"4A klasė";36718328105;Taip;0;1;0;1
19934;Šaltinėlis;"4A klasė";86995081866;Taip;0;1;0;1
19935;Šaltinėlis;"4A klasė";7929809205;Ne;0;1;0;1
19936;Šaltinėlis;"4A klasė";29683761586;Ne;0;1;0;1
19937;Šaltinėlis;"4A klasė";9842958341;Ne;0;2;0;2
19938;Šaltinėlis;"4A klasė";40769315138;Taip;0;4;0;4
19939;Šaltinėlis;"4A klasė";7563879445;Taip;0;1;0;1
19940;Šaltinėlis;"4A klasė";66754907606;Ne;0;21;0;21
19941;Šaltinėlis;"4A klasė";35387543586;Taip;0;2;0;2
19942;Šaltinėlis;"4A klasė";6056572441;Ne;0;4;0;4
19943;Šaltinėlis;"4A klasė";9927833966;Ne;0;3;0;3
19944;Šaltinėlis;3B;93256161233;Taip;0;1;0;1
19945;Šaltinėlis;3B;83173349544;Taip;0;1;0;1
19946;Šaltinėlis;3B;39088869084;Taip;0;4;0;4
19947;Šaltinėlis;3B;1422035829;Taip;0;6;0;6
19948;Šaltinėlis;3B;7711903999;Ne;0;2;0;2
19949;Šaltinėlis;3B;95542489944;Ne;0;1;0;1
19950;Šaltinėlis;3B;3072314714;Taip;0;2;0;2
19951;Šaltinėlis;3B;1220687492;Taip;0;3;0;3
19952;Šaltinėlis;3B;74337710550;Taip;0;2;0;2
19953;Šaltinėlis;3B;35401075864;Taip;0;1;0;1
19954;Šaltinėlis;3B;19630605543;Taip;0;3;0;3
19955;Šaltinėlis;3B;84522552145;Taip;0;4;0;4
19956;Šaltinėlis;3B;3626545396;Ne;0;2;0;2
19957;Šaltinėlis;3B;6317111400;Taip;0;3;0;3
19958;Šaltinėlis;3B;4762756751;Ne;0;1;0;1
19959;Šaltinėlis;3B;72372808270;Taip;0;1;0;1
19960;Šaltinėlis;3B;1924418657;Taip;2;6;0;8
19961;Šaltinėlis;3B;77194317310;Taip;0;13;0;13
19962;Šaltinėlis;3B;57847832778;Taip;0;3;0;3
19963;Šaltinėlis;3B;2099800744;Taip;0;3;0;3
19964;Šaltinėlis;3B;70315400705;Taip;0;1;0;1
19965;Šaltinėlis;3B;81082410620;Taip;0;1;0;1
19966;Šaltinėlis;1B;84494627465;Taip;0;1;0;1
19967;Šaltinėlis;1B;2146141461;Taip;0;1;0;1
19968;Šaltinėlis;1B;6068980312;Taip;0;7;0;7
19969;Šaltinėlis;1B;9425353041;Taip;0;1;0;1
19970;Šaltinėlis;1B;17147527171;Taip;0;21;0;21
19971;Šaltinėlis;1B;1935762293;Taip;0;2;0;2
19972;Šaltinėlis;1B;1716801722;Taip;0;1;0;1
19973;Šaltinėlis;1B;2333071711;Taip;0;7;0;7
19974;Šaltinėlis;1B;23301579810;Taip;0;8;0;8
19975;Šaltinėlis;1B;52507085619;Taip;0;2;0;2
19976;Šaltinėlis;1B;1023238509;Taip;0;6;0;6
19977;Šaltinėlis;1B;526307704;Taip;0;4;0;4
19978;Šaltinėlis;1B;1958647188;Taip;0;1;0;1
19979;Šaltinėlis;1B;1583520894;Taip;0;21;0;21
19980;Šaltinėlis;1B;11083638216;Taip;0;1;0;1
19981;Šaltinėlis;PELĖDŽIUKAI;8973208195;Taip;0;1;0;1
19982;Šaltinėlis;PELĖDŽIUKAI;1367082230;Taip;6;0;2;8
19983;Šaltinėlis;PELĖDŽIUKAI;4387568448;Taip;0;2;0;2
19984;Šaltinėlis;PELĖDŽIUKAI;7723290276;Taip;0;5;0;5
19985;Šaltinėlis;PELĖDŽIUKAI;1348724947;Taip;3;21;0;24
19986;Šaltinėlis;PELĖDŽIUKAI;2658414287;Taip;8;1;0;9
19987;Šaltinėlis;PELĖDŽIUKAI;3638565578;Taip;1;1;0;2
19988;Šaltinėlis;PELĖDŽIUKAI;8721116918;Taip;5;1;0;6
19989;Šaltinėlis;PELĖDŽIUKAI;7211267255;Taip;0;1;0;1
19990;Šaltinėlis;PELĖDŽIUKAI;1040333590;Taip;0;1;0;1
19991;Šaltinėlis;PELĖDŽIUKAI;3660687688;Taip;0;3;0;3
19992;Šaltinėlis;PELĖDŽIUKAI;5869977541;Ne;5;1;5;11
19993;Šaltinėlis;PELĖDŽIUKAI;3609939325;Ne;0;3;1;4
19994;Šaltinėlis;PELĖDŽIUKAI;9108653045;Taip;0;1;0;1
19995;Šaltinėlis;PELĖDŽIUKAI;9762392403;Taip;0;2;0;2
19996;Šaltinėlis;PELĖDŽIUKAI;2230403251;Ne;0;1;0;1
19997;Šaltinėlis;PELĖDŽIUKAI;7918995181;Taip;8;1;0;9
19998;Šaltinėlis;PELĖDŽIUKAI;9673105905;Ne;5;1;0;6
19999;Šaltinėlis;PELĖDŽIUKAI;5099997904;Taip;7;1;0;8
20000;Gabijėlė;GANDRIUKŲ;4498088417;Taip;0;1;5;6
20001;Gabijėlė;GANDRIUKŲ;7087892822;Taip;0;0;4;4
20002;Gabijėlė;GANDRIUKŲ;5057272847;Taip;0;1;10;11
20003;Gabijėlė;GANDRIUKŲ;3548399391;Taip;0;1;3;4
20004;Gabijėlė;GANDRIUKŲ;3532989398;Taip;0;1;0;1
20005;Gabijėlė;GANDRIUKŲ;2215880644;Taip;0;1;1;2
20006;Gabijėlė;GANDRIUKŲ;3799003783;Taip;0;1;0;1
20007;Gabijėlė;GANDRIUKŲ;5513530983;Ne;0;1;1;2
20008;Gabijėlė;GANDRIUKŲ;9581539166;Taip;11;1;0;12
20009;Gabijėlė;GANDRIUKŲ;6004026516;Taip;0;3;0;3
20010;Gabijėlė;GANDRIUKŲ;4634029418;Taip;0;1;0;1
20011;Gabijėlė;GANDRIUKŲ;4328252445;Taip;5;2;0;7
20012;Gabijėlė;GANDRIUKŲ;9706026832;Taip;4;3;0;7
20013;Gabijėlė;GANDRIUKŲ;2491503656;Taip;0;7;0;7
20014;Gabijėlė;GANDRIUKŲ;8904768332;Taip;3;0;4;7
20015;Gabijėlė;GANDRIUKŲ;5715645968;Taip;7;0;0;7
20016;Gabijėlė;GANDRIUKŲ;8572833698;Taip;3;0;0;3
20017;Gabijėlė;GANDRIUKŲ;7433142478;Taip;0;0;1;1
20018;Gabijėlė;GANDRIUKŲ;8646572151;Taip;0;0;6;6
20019;Gabijėlė;GANDRIUKŲ;5054419205;Ne;20;1;0;21
20020;Gabijėlė;GANDRIUKŲ;7530976246;Taip;9;0;1;10
20021;Gabijėlė;GANDRIUKŲ;3920525584;Taip;0;0;3;3
20022;Gabijėlė;GANDRIUKŲ;2682112101;Taip;0;1;0;1
20023;Gabijėlė;LAKŠTINGALIUKŲ;7019425859;Taip;6;8;0;14
20024;Gabijėlė;LAKŠTINGALIUKŲ;1611004144;Taip;10;3;3;16
20025;Gabijėlė;LAKŠTINGALIUKŲ;5862882027;Taip;8;0;1;9
20026;Gabijėlė;LAKŠTINGALIUKŲ;8798786098;Taip;9;1;1;11
20027;Gabijėlė;LAKŠTINGALIUKŲ;8035360208;Taip;9;4;0;13
20028;Gabijėlė;LAKŠTINGALIUKŲ;2384469423;Taip;0;0;2;2
20029;Gabijėlė;LAKŠTINGALIUKŲ;8167646385;Taip;0;0;2;2
20030;Gabijėlė;LAKŠTINGALIUKŲ;8926268619;Taip;18;0;0;18
20031;Gabijėlė;LAKŠTINGALIUKŲ;9480021589;Taip;0;1;0;1
20032;Gabijėlė;LAKŠTINGALIUKŲ;3215569531;Ne;4;0;1;5
20033;Gabijėlė;LAKŠTINGALIUKŲ;5992403900;Taip;0;0;2;2
20034;Gabijėlė;LAKŠTINGALIUKŲ;9116943443;Taip;0;2;4;6
20035;Gabijėlė;LAKŠTINGALIUKŲ;8383489040;Taip;0;2;0;2
20036;Gabijėlė;LAKŠTINGALIUKŲ;6927730664;Taip;5;0;0;5
20037;Gabijėlė;LAKŠTINGALIUKŲ;9398722388;Taip;8;1;0;9
20038;Gabijėlė;LAKŠTINGALIUKŲ;9491327802;Ne;0;0;1;1
20039;Gabijėlė;LAKŠTINGALIUKŲ;6730947751;Taip;10;1;2;13
20040;Gabijėlė;LAKŠTINGALIUKŲ;2550300871;Taip;3;5;0;8
20041;Gabijėlė;LAKŠTINGALIUKŲ;9324498850;Taip;0;10;3;13
20042;Gabijėlė;LAKŠTINGALIUKŲ;8314088016;Taip;2;2;0;4
20043;Gabijėlė;LAKŠTINGALIUKŲ;6295299651;Taip;2;2;0;4
20044;Gabijėlė;LAKŠTINGALIUKŲ;9694544564;Taip;0;0;6;6
20045;Gabijėlė;LAKŠTINGALIUKŲ;4827797140;Taip;0;7;0;7
20046;Gabijėlė;LAKŠTINGALIUKŲ;6931780900;Taip;13;2;0;15
20047;Gabijėlė;LAKŠTINGALIUKŲ;2030555139;Ne;10;2;0;12
20048;Gabijėlė;ŽVIRBLIUKŲ;7043775905;Taip;0;2;0;2
20049;Gabijėlė;ŽVIRBLIUKŲ;4475530177;Taip;0;1;2;3
20050;Gabijėlė;ŽVIRBLIUKŲ;5743861607;Taip;3;1;0;4
20051;Gabijėlė;ŽVIRBLIUKŲ;7410541320;Taip;0;5;0;5
20052;Gabijėlė;ŽVIRBLIUKŲ;4493192224;Ne;4;0;1;5
20053;Gabijėlė;ŽVIRBLIUKŲ;9259964641;Taip;0;0;1;1
20054;Gabijėlė;ŽVIRBLIUKŲ;3268231136;Taip;0;10;0;10
20055;Gabijėlė;ŽVIRBLIUKŲ;5332825339;Ne;0;0;9;9
20056;Gabijėlė;ŽVIRBLIUKŲ;2264669298;Taip;0;1;0;1
20057;Gabijėlė;ŽVIRBLIUKŲ;5942625633;Taip;0;0;4;4
20058;Gabijėlė;ŽVIRBLIUKŲ;3155403180;Taip;5;0;1;6
20059;Gabijėlė;ŽVIRBLIUKŲ;1158461185;Taip;0;0;2;2
20060;Gabijėlė;ŽVIRBLIUKŲ;3218415151;Taip;0;0;7;7
20061;Gabijėlė;ŽVIRBLIUKŲ;8823299212;Taip;0;1;1;2
20062;Gabijėlė;ŽVIRBLIUKŲ;8879972953;Taip;0;8;0;8
20063;Gabijėlė;ŽVIRBLIUKŲ;9627906252;Taip;0;0;1;1
20064;Gabijėlė;ŽVIRBLIUKŲ;1725665169;Taip;0;1;0;1
20065;Gabijėlė;ŽVIRBLIUKŲ;8292463617;Taip;0;1;0;1
20066;Gabijėlė;ŽVIRBLIUKŲ;6674038058;Taip;4;1;0;5
20067;Gabijėlė;ŽVIRBLIUKŲ;4146051969;Taip;5;0;0;5
20068;Gabijėlė;ŽVIRBLIUKŲ;6604681536;Taip;4;0;0;4
20069;Gabijėlė;ŽVIRBLIUKŲ;1273722177;Ne;1;0;3;4
20070;Gabijėlė;ŽVIRBLIUKŲ;6310234092;Taip;0;1;0;1
20071;Gabijėlė;ŽVIRBLIUKŲ;8384795164;Taip;0;1;1;2
20072;Gabijėlė;ŽVIRBLIUKŲ;3209491491;Taip;13;2;0;15
20073;Gabijėlė;GENIUKŲ;3445433386;Taip;0;10;0;10
20074;Gabijėlė;GENIUKŲ;2980295345;Taip;6;1;1;8
20075;Gabijėlė;GENIUKŲ;1862655595;Taip;0;3;0;3
20076;Gabijėlė;GENIUKŲ;7312628876;Taip;0;9;0;9
20077;Gabijėlė;GENIUKŲ;1581688238;Taip;0;1;0;1
20078;Gabijėlė;GENIUKŲ;5301905117;Taip;0;3;0;3
20079;Gabijėlė;GENIUKŲ;3176075887;Taip;0;1;0;1
20080;Gabijėlė;GENIUKŲ;9972967198;Taip;0;3;0;3
20081;Gabijėlė;GENIUKŲ;1589534853;Taip;15;1;0;16
20082;Gabijėlė;GENIUKŲ;6482824000;Taip;10;0;0;10
20083;Gabijėlė;GENIUKŲ;5962852108;Taip;5;1;2;8
20084;Gabijėlė;GENIUKŲ;7178676049;Taip;0;1;1;2
20085;Gabijėlė;GENIUKŲ;1974388885;Ne;0;3;3;6
20086;Gabijėlė;GENIUKŲ;5418276275;Taip;15;1;1;17
20087;Gabijėlė;GENIUKŲ;2407507314;Taip;10;1;0;11
20088;Gabijėlė;GENIUKŲ;3827747057;Taip;0;1;0;1
20089;Gabijėlė;GENIUKŲ;8305098808;Taip;11;2;0;13
20090;Gabijėlė;GENIUKŲ;4234733280;Taip;7;1;0;8
20091;Gabijėlė;GENIUKŲ;6375754699;Ne;5;1;1;7
20092;Gabijėlė;GENIUKŲ;2009199650;Taip;8;0;0;8
20093;Gabijėlė;GENIUKŲ;6869951613;Taip;0;1;0;1
20094;Gabijėlė;GENIUKŲ;7173852168;Ne;10;1;0;11
20095;Gabijėlė;GENIUKŲ;8036572198;Taip;0;21;0;21
20096;Gabijėlė;DAGILIUKŲ;9348393550;Taip;0;1;0;1
20097;Gabijėlė;DAGILIUKŲ;4264925447;Taip;0;1;0;1
20098;Gabijėlė;DAGILIUKŲ;9120107749;Taip;1;0;1;2
20099;Gabijėlė;DAGILIUKŲ;9494313873;Taip;0;1;0;1
20100;Gabijėlė;DAGILIUKŲ;9783343968;Taip;0;1;0;1
20101;Gabijėlė;DAGILIUKŲ;3017939983;Taip;0;1;0;1
20102;Gabijėlė;DAGILIUKŲ;4462129182;Taip;5;0;0;5
20103;Gabijėlė;DAGILIUKŲ;9503639471;Ne;0;0;1;1
20104;Gabijėlė;DAGILIUKŲ;1988597157;Taip;5;1;0;6
20105;Gabijėlė;DAGILIUKŲ;9895518740;Taip;16;0;0;16
20106;Gabijėlė;DAGILIUKŲ;9449023766;Taip;0;1;0;1
20107;Gabijėlė;DAGILIUKŲ;1286688629;Taip;0;1;2;3
20108;Gabijėlė;DAGILIUKŲ;1455856766;Ne;0;0;9;9
20109;Gabijėlė;DAGILIUKŲ;3700639354;Taip;0;0;1;1
20110;Gabijėlė;DAGILIUKŲ;6438144206;Taip;0;0;6;6
20111;Gabijėlė;DAGILIUKŲ;8662914262;Taip;3;4;0;7
20112;Gabijėlė;DAGILIUKŲ;9280283478;Taip;5;1;0;6
20113;Gabijėlė;DAGILIUKŲ;2254104149;Taip;3;3;0;6
20114;Gabijėlė;DAGILIUKŲ;8078326688;Taip;0;1;0;1
20115;Gabijėlė;DAGILIUKŲ;4490619514;Taip;0;0;4;4
20116;Gabijėlė;DAGILIUKŲ;2386980295;Taip;0;0;7;7
20117;Gabijėlė;DAGILIUKŲ;4664011011;Taip;11;7;0;18
20118;Gabijėlė;PELEDŽIUKŲ;6794056622;Taip;0;0;2;2
20119;Gabijėlė;PELEDŽIUKŲ;4170105224;Taip;10;2;0;12
20120;Gabijėlė;PELEDŽIUKŲ;5675574534;Ne;0;0;3;3
20121;Gabijėlė;PELEDŽIUKŲ;5163460269;Taip;0;0;1;1
20122;Gabijėlė;PELEDŽIUKŲ;1356830225;Taip;5;0;4;9
20123;Gabijėlė;PELEDŽIUKŲ;9265103627;Taip;1;0;0;1
20124;Gabijėlė;PELEDŽIUKŲ;9451897367;Taip;11;0;3;14
20125;Gabijėlė;PELEDŽIUKŲ;1583034900;Taip;5;0;0;5
20126;Gabijėlė;PELEDŽIUKŲ;2128428173;Taip;6;0;2;8
20127;Gabijėlė;PELEDŽIUKŲ;7028670164;Taip;11;0;3;14
20128;Gabijėlė;PELEDŽIUKŲ;5481472116;Taip;8;0;1;9
20129;Gabijėlė;PELEDŽIUKŲ;2885913045;Taip;0;4;0;4
20130;Gabijėlė;PELEDŽIUKŲ;5869580147;Taip;0;0;6;6
20131;Gabijėlė;PELEDŽIUKŲ;7096789623;Taip;0;0;5;5
20132;Gabijėlė;PELEDŽIUKŲ;4724322463;Taip;6;2;0;8
20133;Gabijėlė;PELEDŽIUKŲ;1810898809;Taip;7;0;1;8
20134;Gabijėlė;PELEDŽIUKŲ;5801792404;Taip;12;0;1;13
20135;Gabijėlė;PELEDŽIUKŲ;8550877260;Ne;0;10;0;10
20136;Gabijėlė;PELEDŽIUKŲ;5579070948;Taip;0;0;3;3
20137;Gabijėlė;PELEDŽIUKŲ;1076369632;Taip;0;0;1;1
20138;Gabijėlė;PELEDŽIUKŲ;8549800358;Taip;15;0;1;16
20139;Gabijėlė;PELEDŽIUKŲ;8133131896;Taip;4;0;1;5
20140;Gabijėlė;PELEDŽIUKŲ;2048046055;Taip;2;0;1;3
20141;Gabijėlė;PELEDŽIUKŲ;7261932151;Ne;10;0;0;10
20142;Gabijėlė;KREGZDŽIUKŲ;1759118326;Taip;7;4;0;11
20143;Gabijėlė;KREGZDŽIUKŲ;9533325351;Taip;7;4;0;11
20144;Gabijėlė;KREGZDŽIUKŲ;5407565441;Taip;17;0;0;17
20145;Gabijėlė;KREGZDŽIUKŲ;6845038692;Taip;0;1;0;1
20146;Gabijėlė;KREGZDŽIUKŲ;9683202312;Ne;0;1;2;3
20147;Gabijėlė;KREGZDŽIUKŲ;2357515455;Taip;0;0;1;1
20148;Gabijėlė;KREGZDŽIUKŲ;1574272380;Taip;9;2;0;11
20149;Gabijėlė;KREGZDŽIUKŲ;9675186834;Ne;13;0;2;15
20150;Gabijėlė;KREGZDŽIUKŲ;2634722171;Taip;11;0;1;12
20151;Gabijėlė;KREGZDŽIUKŲ;4317708029;Taip;0;10;0;10
20152;Gabijėlė;KREGZDŽIUKŲ;8555272917;Taip;0;1;4;5
20153;Gabijėlė;KREGZDŽIUKŲ;1142939183;Taip;0;5;0;5
20154;Gabijėlė;KREGZDŽIUKŲ;9676186208;Taip;0;6;0;6
20155;Gabijėlė;KREGZDŽIUKŲ;3584692524;Taip;18;1;0;19
20156;Gabijėlė;KREGZDŽIUKŲ;8613821848;Taip;6;0;2;8
20157;Gabijėlė;KREGZDŽIUKŲ;7038167942;Taip;0;6;0;6
20158;Gabijėlė;KREGZDŽIUKŲ;6570702235;Taip;4;0;0;4
20159;Gabijėlė;KREGZDŽIUKŲ;9528783892;Taip;0;10;0;10
20160;Gabijėlė;KREGZDŽIUKŲ;9358478209;Taip;0;0;1;1
20161;Gabijėlė;KREGZDŽIUKŲ;9030890792;Taip;14;0;5;19
20162;Gabijėlė;KREGZDŽIUKŲ;3031333199;Taip;14;0;5;19
20163;Gabijėlė;KREGZDŽIUKŲ;9116153981;Taip;4;2;2;8
20164;Gabijėlė;KREGZDŽIUKŲ;7447079902;Taip;0;5;4;9
20165;Gabijėlė;KREGZDŽIUKŲ;2289016022;Taip;10;0;1;11
20166;Gabijėlė;KREGZDŽIUKŲ;1230236612;Taip;0;0;2;2
20167;Gabijėlė;KREGZDŽIUKŲ;4575230225;Taip;13;0;0;13
20168;Gabijėlė;ZYLIUKŲ;6154378055;Taip;17;1;0;18
20169;Gabijėlė;ZYLIUKŲ;7700700293;Taip;13;0;2;15
20170;Gabijėlė;ZYLIUKŲ;6759447513;Taip;0;6;0;6
20171;Gabijėlė;ZYLIUKŲ;1090635644;Taip;5;0;5;10
20172;Gabijėlė;ZYLIUKŲ;9893869150;Taip;11;0;0;11
20173;Gabijėlė;ZYLIUKŲ;2764185879;Taip;0;0;6;6
20174;Gabijėlė;ZYLIUKŲ;6463161337;Taip;0;0;2;2
20175;Gabijėlė;ZYLIUKŲ;7921467223;Taip;0;4;3;7
20176;Gabijėlė;ZYLIUKŲ;6446842432;Taip;5;0;1;6
20177;Gabijėlė;ZYLIUKŲ;6562965816;Taip;6;0;0;6
20178;Gabijėlė;ZYLIUKŲ;4376486874;Taip;0;0;1;1
20179;Gabijėlė;ZYLIUKŲ;7047606048;Taip;9;0;2;11
20180;Gabijėlė;ZYLIUKŲ;6983092888;Taip;4;0;1;5
20181;Gabijėlė;ZYLIUKŲ;2727329238;Taip;0;0;1;1
20182;Gabijėlė;ZYLIUKŲ;4267803371;Taip;0;4;2;6
20183;Gabijėlė;ZYLIUKŲ;9259673720;Taip;0;0;5;5
20184;Gabijėlė;ZYLIUKŲ;8362509831;Taip;0;0;1;1
20185;Gabijėlė;ZYLIUKŲ;4907669556;Taip;0;15;0;15
20186;Gabijėlė;ZYLIUKŲ;1947898190;Taip;15;0;1;16
20187;Gabijėlė;ZYLIUKŲ;2384174631;Taip;3;0;4;7
20188;Gabijėlė;ZYLIUKŲ;6393256426;Taip;11;0;0;11
20189;Gabijėlė;ZYLIUKŲ;4166561084;Taip;0;0;1;1
20190;Gabijėlė;ZYLIUKŲ;5736012194;Taip;16;0;5;21
20191;Gabijėlė;ZYLIUKŲ;4712780337;Taip;10;1;5;16
20192;Gabijėlė;ZYLIUKŲ;1004297369;Taip;11;0;3;14
20193;Gabijėlė;ZYLIUKŲ;7180444215;Taip;11;0;2;13
20194;Gabijėlė;VOLUNGĖLIŲ;4000838897;Ne;4;7;1;12
20195;Gabijėlė;VOLUNGĖLIŲ;2099510027;Taip;5;1;1;7
20196;Gabijėlė;VOLUNGĖLIŲ;6842537434;Taip;5;5;0;10
20197;Gabijėlė;VOLUNGĖLIŲ;2227816651;Taip;15;1;0;16
20198;Gabijėlė;VOLUNGĖLIŲ;6956030813;Taip;11;2;0;13
20199;Gabijėlė;VOLUNGĖLIŲ;3902737481;Taip;0;4;0;4
20200;Gabijėlė;VOLUNGĖLIŲ;8733551230;Taip;11;1;1;13
20201;Gabijėlė;VOLUNGĖLIŲ;3763595874;Taip;5;0;0;5
20202;Gabijėlė;VOLUNGĖLIŲ;5360985745;Taip;10;1;0;11
20203;Gabijėlė;VOLUNGĖLIŲ;4580305437;Taip;0;9;0;9
20204;Gabijėlė;VOLUNGĖLIŲ;5737066080;Taip;5;2;1;8
20205;Gabijėlė;VOLUNGĖLIŲ;3972933727;Ne;0;1;1;2
20206;Gabijėlė;VOLUNGĖLIŲ;6643563560;Taip;15;2;0;17
20207;Gabijėlė;VOLUNGĖLIŲ;8312753333;Taip;5;4;0;9
20208;Gabijėlė;VOLUNGĖLIŲ;2523400466;Taip;2;0;0;2
20209;Gabijėlė;VOLUNGĖLIŲ;8569742033;Taip;4;1;0;5
20210;Gabijėlė;VOLUNGĖLIŲ;8327903800;Taip;9;1;0;10
20211;Gabijėlė;VOLUNGĖLIŲ;4160646449;Taip;0;6;0;6
20212;Gabijėlė;VOLUNGĖLIŲ;5290200767;Taip;17;1;0;18
20213;Gabijėlė;VOLUNGĖLIŲ;5060265729;Taip;0;1;0;1
20214;Gabijėlė;VOLUNGĖLIŲ;6960725029;Taip;13;2;3;18
20215;Gabijėlė;VOLUNGĖLIŲ;3098846537;Taip;3;0;0;3
20216;Gabijėlė;VOLUNGĖLIŲ;3995459990;Taip;0;2;0;2
20217;Gabijėlė;VOLUNGĖLIŲ;8320449381;Taip;0;12;0;12
20218;Gabijėlė;ANČIUKŲ;2036978425;Taip;0;7;0;7
20219;Gabijėlė;ANČIUKŲ;5219706067;Taip;0;6;0;6
20220;Gabijėlė;ANČIUKŲ;3454412432;Taip;0;2;0;2
20221;Gabijėlė;ANČIUKŲ;9822093084;Taip;0;4;0;4
20222;Gabijėlė;ANČIUKŲ;1415184607;Taip;0;1;3;4
20223;Gabijėlė;ANČIUKŲ;85836097485;Taip;0;0;5;5
20224;Gabijėlė;ANČIUKŲ;28017865889;Taip;0;2;0;2
20225;Gabijėlė;ANČIUKŲ;1917587420;Taip;9;2;0;11
20226;Gabijėlė;ANČIUKŲ;1465584524;Taip;3;1;0;4
20227;Gabijėlė;ANČIUKŲ;6198439092;Taip;5;1;0;6
20228;Gabijėlė;ANČIUKŲ;7948343328;Taip;0;2;0;2
20229;Gabijėlė;ANČIUKŲ;2052892422;Taip;5;1;0;6
20230;Gabijėlė;ANČIUKŲ;8111239476;Taip;0;7;0;7
20231;Gabijėlė;ANČIUKŲ;8778396292;Taip;2;0;3;5
20232;Gabijėlė;ANČIUKŲ;4085049535;Taip;0;10;0;10
20233;Gabijėlė;ANČIUKŲ;8893637755;Taip;0;11;0;11
20234;Gabijėlė;ANČIUKŲ;8874692591;Ne;6;1;0;7
20235;Gabijėlė;ANČIUKŲ;4752631976;Taip;5;0;0;5
20236;Gabijėlė;ANČIUKŲ;5783373671;Taip;0;3;0;3
20237;Gabijėlė;ANČIUKŲ;10796114623;Taip;0;7;0;7
20238;Gabijėlė;ANČIUKŲ;43123279348;Taip;0;12;0;12
20239;Gabijėlė;BALANDŽIUKŲ;6719097956;Taip;0;1;0;1
20240;Gabijėlė;BALANDŽIUKŲ;9157819780;Taip;0;5;0;5
20241;Gabijėlė;BALANDŽIUKŲ;1045338865;Taip;0;4;0;4
20242;Gabijėlė;BALANDŽIUKŲ;2097260657;Ne;0;2;1;3
20243;Gabijėlė;BALANDŽIUKŲ;8131229306;Taip;0;2;0;2
20244;Gabijėlė;BALANDŽIUKŲ;8525869648;Taip;6;3;0;9
20245;Gabijėlė;BALANDŽIUKŲ;2070050969;Taip;0;2;0;2
20246;Gabijėlė;BALANDŽIUKŲ;15049855022;Taip;0;1;0;1
20247;Gabijėlė;BALANDŽIUKŲ;2776579713;Ne;6;2;0;8
20248;Gabijėlė;BALANDŽIUKŲ;7977751362;Taip;1;1;0;2
20249;Gabijėlė;BALANDŽIUKŲ;5906952432;Taip;1;1;0;2
20250;Gabijėlė;BALANDŽIUKŲ;9197020006;Taip;0;5;0;5
20251;Gabijėlė;BALANDŽIUKŲ;1615940996;Taip;8;2;0;10
20252;Gabijėlė;BALANDŽIUKŲ;65735862964;Taip;7;1;0;8
20253;Gabijėlė;BALANDŽIUKŲ;8746641978;Taip;3;4;2;9
20254;Gabijėlė;BALANDŽIUKŲ;56914218692;Taip;0;1;0;1
20255;Gabijėlė;BALANDŽIUKŲ;4330624300;Taip;0;0;4;4
20256;Gabijėlė;BALANDŽIUKŲ;2921208571;Taip;0;1;1;2
20257;Gabijėlė;BALANDŽIUKŲ;9501202207;Taip;0;11;0;11
20258;Gabijėlė;BALANDŽIUKŲ;6145720452;Ne;0;5;0;5
20259;Gabijėlė;BALANDŽIUKŲ;7563741123;Taip;0;7;0;7
20260;Gabijėlė;BALANDŽIUKŲ;3694447705;Taip;0;2;5;7
20261;Gabijėlė;VYTURIUKŲ;6131649116;Taip;6;0;5;11
20262;Gabijėlė;VYTURIUKŲ;8461048184;Taip;0;0;2;2
20263;Gabijėlė;VYTURIUKŲ;7894667201;Taip;7;2;0;9
20264;Gabijėlė;VYTURIUKŲ;3973977318;Taip;0;0;3;3
20265;Gabijėlė;VYTURIUKŲ;3454061135;Taip;0;0;3;3
20266;Gabijėlė;VYTURIUKŲ;5652244967;Taip;6;2;2;10
20267;Gabijėlė;VYTURIUKŲ;3343196830;Taip;0;0;6;6
20268;Gabijėlė;VYTURIUKŲ;9021225516;Taip;0;0;2;2
20269;Gabijėlė;VYTURIUKŲ;6728495961;Taip;7;0;1;8
20270;Gabijėlė;VYTURIUKŲ;1523190444;Taip;1;0;1;2
20271;Gabijėlė;VYTURIUKŲ;6834871835;Taip;5;0;1;6
20272;Gabijėlė;VYTURIUKŲ;8749080961;Taip;6;0;0;6
20273;Gabijėlė;VYTURIUKŲ;1185216449;Taip;1;0;1;2
20274;Gabijėlė;VYTURIUKŲ;5297866989;Taip;0;0;6;6
20275;Gabijėlė;VYTURIUKŲ;4278783863;Taip;4;0;0;4
20276;Gabijėlė;VYTURIUKŲ;7509112343;Ne;4;0;2;6
20277;Gabijėlė;VYTURIUKŲ;4248856615;Taip;0;1;0;1
20278;Gabijėlė;VYTURIUKŲ;6539078572;Ne;0;9;0;9
20279;Saulėgrąža;Bitutės;8660677159;Taip;0;0;6;6
20280;Saulėgrąža;Bitutės;6641588877;Taip;9;0;1;10
20281;Saulėgrąža;Bitutės;8505655534;Taip;5;0;3;8
20282;Saulėgrąža;Bitutės;2809788049;Taip;9;0;5;14
20283;Saulėgrąža;Bitutės;4733063461;Taip;0;1;2;3
20284;Saulėgrąža;Bitutės;3899237871;Taip;0;1;0;1
20285;Saulėgrąža;Bitutės;1381240000;Taip;1;0;4;5
20286;Saulėgrąža;Bitutės;8766433391;Ne;0;1;3;4
20287;Saulėgrąža;Bitutės;7283302671;Taip;9;0;1;10
20288;Saulėgrąža;Bitutės;4265356484;Ne;0;0;1;1
20289;Saulėgrąža;Bitutės;2042826101;Ne;8;0;5;13
20290;Saulėgrąža;Bitutės;4471740960;Taip;4;0;1;5
20291;Saulėgrąža;Bitutės;1345079291;Taip;0;1;2;3
20292;Saulėgrąža;Bitutės;3319538368;Ne;5;1;5;11
20293;Saulėgrąža;Bitutės;8597567633;Taip;0;0;2;2
20294;Saulėgrąža;Bitutės;7387477589;Taip;0;2;5;7
20295;Saulėgrąža;Bitutės;5221286194;Taip;0;1;4;5
20296;Saulėgrąža;Bitutės;9481319116;Taip;0;1;0;1
20297;Saulėgrąža;Bitutės;8531862400;Ne;0;0;1;1
20298;Saulėgrąža;"Boruželės ";3889868838;Taip;11;0;1;12
20299;Saulėgrąža;"Boruželės ";1613110580;Taip;5;0;3;8
20300;Saulėgrąža;"Boruželės ";6802366478;Taip;3;0;4;7
20301;Saulėgrąža;"Boruželės ";9604238128;Taip;11;0;7;18
20302;Saulėgrąža;"Boruželės ";4587532777;Ne;5;0;3;8
20303;Saulėgrąža;"Boruželės ";1008547550;Taip;9;0;1;10
20304;Saulėgrąža;"Boruželės ";4930162914;Taip;4;0;4;8
20305;Saulėgrąža;"Boruželės ";8986368849;Taip;0;0;4;4
20306;Saulėgrąža;"Boruželės ";3080026762;Taip;8;0;0;8
20307;Saulėgrąža;"Boruželės ";9328524382;Ne;16;0;0;16
20308;Saulėgrąža;"Boruželės ";2598768766;Taip;13;0;0;13
20309;Saulėgrąža;"Boruželės ";5734857301;Taip;10;0;2;12
20310;Saulėgrąža;"Boruželės ";9658060059;Taip;16;0;0;16
20311;Saulėgrąža;"Boruželės ";3594593787;Taip;15;0;1;16
20312;Saulėgrąža;"Boruželės ";2455622343;Taip;9;0;0;9
20313;Saulėgrąža;Drugeliai;8155080474;Taip;8;0;10;18
20314;Saulėgrąža;Drugeliai;1955944355;Taip;1;0;0;1
20315;Saulėgrąža;Drugeliai;8337203952;Taip;0;0;3;3
20316;Saulėgrąža;Drugeliai;6127496900;Taip;7;0;1;8
20317;Saulėgrąža;Drugeliai;7267854768;Taip;5;1;2;8
20318;Saulėgrąža;Drugeliai;8841882983;Taip;31;0;0;31
20319;Saulėgrąža;Drugeliai;6608001857;Taip;0;6;2;8
20320;Saulėgrąža;Drugeliai;4663169787;Taip;6;0;5;11
20321;Saulėgrąža;Drugeliai;6981928727;Taip;11;0;2;13
20322;Saulėgrąža;Drugeliai;8873608939;Taip;10;1;1;12
20323;Saulėgrąža;Drugeliai;7281353368;Taip;0;1;2;3
20324;Saulėgrąža;Drugeliai;8138991066;Taip;1;0;1;2
20325;Saulėgrąža;Drugeliai;1379283244;Taip;0;4;2;6
20326;Saulėgrąža;Drugeliai;4767744537;Ne;12;0;4;16
20327;Saulėgrąža;Drugeliai;1564385864;Taip;0;0;1;1
20328;Saulėgrąža;Drugeliai;4361365993;Taip;0;0;6;6
20329;Saulėgrąža;Drugeliai;8882080945;Taip;0;0;15;15
20330;Saulėgrąža;Drugeliai;1080500584;Taip;11;1;3;15
20331;Saulėgrąža;Drugeliai;1386348080;Taip;0;0;11;11
20332;Saulėgrąža;Drugeliai;3318222372;Taip;6;1;0;7
20333;Saulėgrąža;Drugeliai;8148900529;Taip;3;0;1;4
20334;Saulėgrąža;Drugeliai;3988854847;Taip;0;0;3;3
20335;Saulėgrąža;Pabiručiai;1193968905;Taip;5;0;0;5
20336;Saulėgrąža;Pabiručiai;6924492377;Ne;0;0;1;1
20337;Saulėgrąža;Pabiručiai;9812784697;Taip;0;0;1;1
20338;Saulėgrąža;Pabiručiai;1732823416;Taip;5;0;1;6
20339;Saulėgrąža;Pabiručiai;2063366170;Taip;1;0;5;6
20340;Saulėgrąža;Pabiručiai;5417303387;Taip;11;0;0;11
20341;Saulėgrąža;Pabiručiai;4113866451;Taip;1;0;0;1
20342;Saulėgrąža;Pabiručiai;5759064166;Taip;0;1;0;1
20343;Saulėgrąža;Pabiručiai;3014850439;Taip;0;0;11;11
20344;Saulėgrąža;Pabiručiai;7563907981;Taip;6;0;6;12
20345;Saulėgrąža;Pabiručiai;7110805205;Taip;7;0;0;7
20346;Saulėgrąža;Pabiručiai;6489291407;Ne;6;0;0;6
20347;Saulėgrąža;Pabiručiai;5302001715;Taip;4;0;2;6
20348;Saulėgrąža;Pabiručiai;4869924215;Taip;5;0;0;5
20349;Pilaitukas;BITUTĖS;3519198814;Taip;5;2;0;7
20350;Pilaitukas;BITUTĖS;8169484415;Taip;4;4;1;9
20351;Pilaitukas;BITUTĖS;1729494874;Taip;0;1;0;1
20352;Pilaitukas;BITUTĖS;2242454299;Taip;0;2;0;2
20353;Pilaitukas;BITUTĖS;9793278788;Taip;0;1;0;1
20354;Pilaitukas;BITUTĖS;4082490488;Taip;2;2;0;4
20355;Pilaitukas;BITUTĖS;3345387791;Taip;0;0;2;2
20356;Pilaitukas;BITUTĖS;3913169122;Taip;4;1;0;5
20357;Pilaitukas;BITUTĖS;3541354283;Taip;0;3;0;3
20358;Pilaitukas;BITUTĖS;5740951665;Taip;4;1;3;8
20359;Pilaitukas;BITUTĖS;4591799893;Taip;21;0;0;21
20360;Pilaitukas;BITUTĖS;6308557885;Taip;18;0;0;18
20361;Pilaitukas;BITUTĖS;6514731102;Taip;15;2;0;17
20362;Pilaitukas;BITUTĖS;3037850837;Taip;0;1;0;1
20363;Pilaitukas;BITUTĖS;9126553732;Taip;0;2;1;3
20364;Pilaitukas;BITUTĖS;7438112270;Taip;12;0;1;13
20365;Pilaitukas;BITUTĖS;1295215465;Ne;0;1;0;1
20366;Pilaitukas;BITUTĖS;5331915157;Taip;0;0;2;2
20367;Pilaitukas;BITUTĖS;6099109886;Taip;0;3;0;3
20368;Pilaitukas;BITUTĖS;3159733673;Taip;13;1;0;14
20369;Pilaitukas;BITUTĖS;2122392982;Taip;0;7;0;7
20370;Pilaitukas;BITUTĖS;7082099968;Taip;10;1;0;11
20371;Pilaitukas;ZUIKUČIAI;8993885764;Ne;0;6;1;7
20372;Pilaitukas;ZUIKUČIAI;5206637809;Taip;2;0;0;2
20373;Pilaitukas;ZUIKUČIAI;5288784331;Taip;0;1;2;3
20374;Pilaitukas;ZUIKUČIAI;8255398803;Taip;0;8;1;9
20375;Pilaitukas;ZUIKUČIAI;2862447956;Taip;0;2;0;2
20376;Pilaitukas;ZUIKUČIAI;8727175656;Taip;0;2;0;2
20377;Pilaitukas;ZUIKUČIAI;8207194955;Taip;4;0;3;7
20378;Pilaitukas;ZUIKUČIAI;5640802570;Taip;1;1;1;3
20379;Pilaitukas;ZUIKUČIAI;4623818227;Taip;5;1;0;6
20380;Pilaitukas;ZUIKUČIAI;9260893320;Taip;0;2;0;2
20381;Pilaitukas;ZUIKUČIAI;9988041515;Ne;2;1;0;3
20382;Pilaitukas;ZUIKUČIAI;9108428738;Ne;2;1;0;3
20383;Pilaitukas;ZUIKUČIAI;1607454890;Taip;5;0;0;5
20384;Pilaitukas;ZUIKUČIAI;9878890346;Taip;0;8;0;8
20385;Pilaitukas;ZUIKUČIAI;5710747769;Taip;0;2;3;5
20386;Pilaitukas;ZUIKUČIAI;7568744500;Taip;3;1;2;6
20387;Pilaitukas;ZUIKUČIAI;5407354218;Taip;0;5;0;5
20388;Pilaitukas;ZUIKUČIAI;1704055907;Taip;0;1;11;12
20389;Pilaitukas;ZUIKUČIAI;7853910193;Taip;0;0;1;1
20390;Pilaitukas;ZUIKUČIAI;6426415533;Taip;0;2;1;3
20391;Pilaitukas;ZUIKUČIAI;2705235576;Taip;0;10;1;11
20392;Pilaitukas;ZUIKUČIAI;9688421636;Taip;0;5;1;6
20393;Pilaitukas;ANČIUKAI;3357097410;Taip;10;0;0;10
20394;Pilaitukas;ANČIUKAI;7773318230;Taip;0;10;0;10
20395;Pilaitukas;ANČIUKAI;4097742120;Ne;1;4;0;5
20396;Pilaitukas;ANČIUKAI;2923272767;Ne;0;5;0;5
20397;Pilaitukas;ANČIUKAI;8620858011;Taip;3;1;0;4
20398;Pilaitukas;ANČIUKAI;4286388920;Taip;7;0;0;7
20399;Pilaitukas;ANČIUKAI;3761827714;Taip;1;1;0;2
20400;Pilaitukas;ANČIUKAI;8643066116;Taip;0;1;0;1
20401;Pilaitukas;ANČIUKAI;1120549352;Taip;16;0;0;16
20402;Pilaitukas;ANČIUKAI;6888607864;Taip;0;9;0;9
20403;Pilaitukas;ANČIUKAI;5490465905;Taip;4;0;0;4
20404;Pilaitukas;ANČIUKAI;7876850509;Taip;13;0;1;14
20405;Pilaitukas;ANČIUKAI;3035456834;Taip;0;2;0;2
20406;Pilaitukas;ANČIUKAI;2476942319;Taip;0;2;0;2
20407;Pilaitukas;ANČIUKAI;8033540052;Taip;11;1;0;12
20408;Pilaitukas;ANČIUKAI;1781762820;Taip;9;1;0;10
20409;Pilaitukas;ANČIUKAI;3005101776;Taip;5;0;3;8
20410;Pilaitukas;ANČIUKAI;8787181006;Taip;5;2;0;7
20411;Pilaitukas;ANČIUKAI;7189824054;Ne;5;1;0;6
20412;Pilaitukas;ANČIUKAI;9332831979;Taip;0;1;1;2
20413;Pilaitukas;ANČIUKAI;5706918634;Taip;13;0;0;13
20414;Pilaitukas;ANČIUKAI;8954370321;Taip;1;0;2;3
20415;Pilaitukas;ANČIUKAI;1660462256;Taip;0;8;0;8
20416;Pilaitukas;MEŠKIUKAI;8577357264;Taip;1;1;1;3
20417;Pilaitukas;MEŠKIUKAI;5297214263;Taip;7;1;0;8
20418;Pilaitukas;MEŠKIUKAI;8268790017;Ne;4;0;0;4
20419;Pilaitukas;MEŠKIUKAI;2054626415;Taip;5;4;0;9
20420;Pilaitukas;MEŠKIUKAI;9742268665;Taip;9;0;0;9
20421;Pilaitukas;MEŠKIUKAI;8322980583;Taip;0;1;0;1
20422;Pilaitukas;MEŠKIUKAI;1610122884;Taip;8;0;0;8
20423;Pilaitukas;MEŠKIUKAI;3867660147;Taip;8;0;0;8
20424;Pilaitukas;MEŠKIUKAI;2365387089;Taip;3;0;0;3
20425;Pilaitukas;MEŠKIUKAI;9670329628;Taip;3;4;0;7
20426;Pilaitukas;MEŠKIUKAI;7750575554;Taip;21;0;0;21
20427;Pilaitukas;MEŠKIUKAI;9397435605;Taip;5;1;0;6
20428;Pilaitukas;MEŠKIUKAI;9187961584;Taip;0;1;0;1
20429;Pilaitukas;MEŠKIUKAI;7781507786;Taip;8;0;0;8
20430;Pilaitukas;MEŠKIUKAI;4171896175;Taip;6;0;0;6
20431;Pilaitukas;MEŠKIUKAI;1362132769;Taip;1;0;0;1
20432;Pilaitukas;MEŠKIUKAI;3027792710;Taip;0;8;0;8
20433;Pilaitukas;MEŠKIUKAI;6807166920;Taip;6;0;0;6
20434;Pilaitukas;MEŠKIUKAI;1591276987;Taip;7;0;0;7
20435;Pilaitukas;MEŠKIUKAI;2830212921;Taip;5;3;0;8
20436;Pilaitukas;MEŠKIUKAI;9930306085;Taip;16;0;0;16
20437;Pilaitukas;MEŠKIUKAI;8279288250;Taip;16;0;0;16
20438;Pilaitukas;ŽUVYTĖS;48011638560;Taip;1;1;0;2
20439;Pilaitukas;ŽUVYTĖS;8109335587;Taip;0;2;0;2
20440;Pilaitukas;ŽUVYTĖS;8319676743;Taip;3;1;0;4
20441;Pilaitukas;ŽUVYTĖS;36338976218;Taip;5;7;0;12
20442;Pilaitukas;ŽUVYTĖS;9224653856;Taip;5;0;0;5
20443;Pilaitukas;ŽUVYTĖS;4694691187;Taip;0;1;0;1
20444;Pilaitukas;ŽUVYTĖS;5252233127;Taip;1;6;0;7
20445;Pilaitukas;ŽUVYTĖS;5206439753;Taip;3;1;1;5
20446;Pilaitukas;ŽUVYTĖS;6222888898;Taip;0;1;0;1
20447;Pilaitukas;ŽUVYTĖS;5211988291;Taip;0;1;1;2
20448;Pilaitukas;ŽUVYTĖS;1512181401;Taip;3;1;0;4
20449;Pilaitukas;ŽUVYTĖS;2298935154;Taip;8;0;0;8
20450;Pilaitukas;ŽUVYTĖS;5949185075;Taip;9;1;0;10
20451;Pilaitukas;ŽUVYTĖS;2117570444;Taip;5;0;0;5
20452;Pilaitukas;ŽUVYTĖS;79485847381;Taip;3;1;0;4
20453;Pilaitukas;ŽUVYTĖS;7909465673;Taip;0;1;0;1
20454;Pilaitukas;ŽUVYTĖS;92108889661;Taip;6;0;0;6
20455;Pilaitukas;ŽUVYTĖS;4505384039;Taip;0;1;0;1
20456;Pilaitukas;ŽUVYTĖS;58250008277;Taip;13;1;0;14
20457;Pilaitukas;ŽUVYTĖS;1618432877;Taip;5;1;0;6
20458;Pilaitukas;ŽUVYTĖS;9724892897;Taip;1;1;0;2
20459;Pilaitukas;ŽUVYTĖS;3821748678;Taip;0;1;0;1
20460;Pilaitukas;ŽUVYTĖS;1114477688;Taip;3;6;0;9
20461;Pilaitukas;PAUKŠTELIAI;3325511140;Taip;7;3;0;10
20462;Pilaitukas;PAUKŠTELIAI;6514784647;Taip;0;1;0;1
20463;Pilaitukas;PAUKŠTELIAI;4505147961;Taip;1;1;0;2
20464;Pilaitukas;PAUKŠTELIAI;1135880899;Taip;0;1;0;1
20465;Pilaitukas;PAUKŠTELIAI;18466900688;Taip;0;8;0;8
20466;Pilaitukas;PAUKŠTELIAI;4038320896;Taip;1;3;0;4
20467;Pilaitukas;PAUKŠTELIAI;3794882532;Taip;1;1;0;2
20468;Pilaitukas;PAUKŠTELIAI;5689385925;Taip;7;2;0;9
20469;Pilaitukas;PAUKŠTELIAI;5405252621;Taip;0;2;1;3
20470;Pilaitukas;PAUKŠTELIAI;5939557073;Taip;0;1;0;1
20471;Pilaitukas;PAUKŠTELIAI;39600380611;Taip;1;1;0;2
20472;Pilaitukas;PAUKŠTELIAI;3214740183;Taip;0;1;0;1
20473;Pilaitukas;PAUKŠTELIAI;2929868229;Ne;0;1;0;1
20474;Pilaitukas;PAUKŠTELIAI;9924612250;Taip;0;1;5;6
20475;Pilaitukas;PAUKŠTELIAI;6117985788;Taip;0;1;0;1
20476;Pilaitukas;PAUKŠTELIAI;57931719105;Taip;0;2;0;2
20477;Pilaitukas;PAUKŠTELIAI;9618329726;Taip;10;1;0;11
20478;Pilaitukas;PAUKŠTELIAI;1003278169;Taip;0;2;0;2
20479;Pilaitukas;PAUKŠTELIAI;9450834035;Taip;0;5;0;5
20480;Pilaitukas;PAUKŠTELIAI;5604992163;Taip;0;5;0;5
20481;Pilaitukas;PAUKŠTELIAI;1693309238;Taip;0;5;0;5
20482;Pilaitukas;BORUŽĖLĖS;8364902911;Taip;9;1;0;10
20483;Pilaitukas;BORUŽĖLĖS;5063602139;Taip;6;0;0;6
20484;Pilaitukas;BORUŽĖLĖS;5984878126;Taip;4;5;0;9
20485;Pilaitukas;BORUŽĖLĖS;6024861998;Taip;0;0;1;1
20486;Pilaitukas;BORUŽĖLĖS;9898379569;Taip;0;1;4;5
20487;Pilaitukas;BORUŽĖLĖS;5324806808;Ne;5;1;3;9
20488;Pilaitukas;BORUŽĖLĖS;5185051301;Taip;0;1;1;2
20489;Pilaitukas;BORUŽĖLĖS;5326258755;Taip;0;5;0;5
20490;Pilaitukas;BORUŽĖLĖS;6838035491;Taip;2;0;0;2
20491;Pilaitukas;BORUŽĖLĖS;1731106179;Taip;1;8;0;9
20492;Pilaitukas;BORUŽĖLĖS;3784944532;Taip;13;0;1;14
20493;Pilaitukas;BORUŽĖLĖS;5186675623;Taip;1;0;1;2
20494;Pilaitukas;BORUŽĖLĖS;4317406707;Taip;5;0;2;7
20495;Pilaitukas;BORUŽĖLĖS;8380819975;Taip;5;3;0;8
20496;Pilaitukas;BORUŽĖLĖS;4589130143;Taip;0;0;1;1
20497;Pilaitukas;BORUŽĖLĖS;1944443723;Taip;11;0;1;12
20498;Pilaitukas;DRUGELIAI;1677962644;Ne;4;6;0;10
20499;Pilaitukas;DRUGELIAI;4745358362;Ne;4;6;0;10
20500;Pilaitukas;DRUGELIAI;2917197418;Ne;2;0;3;5
20501;Pilaitukas;DRUGELIAI;6712878938;Taip;6;1;1;8
20502;Pilaitukas;DRUGELIAI;3298272815;Taip;15;0;1;16
20503;Pilaitukas;DRUGELIAI;3772830210;Taip;14;0;1;15
20504;Pilaitukas;DRUGELIAI;4719223490;Taip;8;0;0;8
20505;Pilaitukas;DRUGELIAI;9414051187;Taip;12;0;0;12
20506;Pilaitukas;DRUGELIAI;6280870972;Taip;3;0;6;9
20507;Pilaitukas;DRUGELIAI;9741985709;Ne;19;0;0;19
20508;Pilaitukas;DRUGELIAI;5215800828;Taip;5;4;0;9
20509;Pilaitukas;DRUGELIAI;2414941263;Ne;4;0;1;5
20510;Pilaitukas;DRUGELIAI;2210253038;Taip;15;3;0;18
20511;Pilaitukas;DRUGELIAI;7222856683;Taip;4;4;0;8
20512;Pilaitukas;DRUGELIAI;8710069256;Ne;2;0;3;5
20513;Pilaitukas;DRUGELIAI;7830059468;Taip;6;1;1;8
20514;Pilaitukas;DRUGELIAI;7479542200;Taip;1;1;3;5
20515;Pilaitukas;DRUGELIAI;5901884512;Taip;7;0;0;7
20516;Pilaitukas;PELIUKAI;9246925227;Taip;10;0;2;12
20517;Pilaitukas;PELIUKAI;7808204054;Taip;10;0;0;10
20518;Pilaitukas;PELIUKAI;4810825253;Taip;5;1;0;6
20519;Pilaitukas;PELIUKAI;8769116377;Taip;0;0;3;3
20520;Pilaitukas;PELIUKAI;8501376663;Taip;8;1;0;9
20521;Pilaitukas;PELIUKAI;3395656390;Taip;1;0;0;1
20522;Pilaitukas;PELIUKAI;5421602723;Ne;1;10;0;11
20523;Pilaitukas;PELIUKAI;8168228529;Taip;7;1;0;8
20524;Pilaitukas;PELIUKAI;4014329370;Taip;10;0;1;11
20525;Pilaitukas;PELIUKAI;6833933586;Taip;0;2;0;2
20526;Pilaitukas;PELIUKAI;8877142428;Taip;0;0;1;1
20527;Pilaitukas;PELIUKAI;2416277190;Taip;6;0;0;6
20528;Pilaitukas;PELIUKAI;9774222130;Taip;0;0;1;1
20529;Pilaitukas;PELIUKAI;1270365948;Taip;11;1;1;13
20530;Pilaitukas;PELIUKAI;7604004800;Taip;3;0;0;3
20531;Pilaitukas;PELIUKAI;9556421129;Taip;6;0;1;7
20532;Pilaitukas;PELIUKAI;3954210452;Ne;1;2;0;3
20533;Pilaitukas;PELIUKAI;5223336496;Taip;2;0;6;8
20534;Pilaitukas;PELIUKAI;3651140874;Taip;5;1;1;7
20535;Pilaitukas;PELIUKAI;2823859128;Taip;8;0;0;8
20536;Pilaitukas;PELIUKAI;7750936973;Taip;16;0;0;16
20537;Pilaitukas;KAČIUKAI;2406183145;Taip;0;2;3;5
20538;Pilaitukas;KAČIUKAI;2379660463;Taip;0;2;3;5
20539;Pilaitukas;KAČIUKAI;1585341963;Taip;5;7;0;12
20540;Pilaitukas;KAČIUKAI;9038324313;Taip;0;1;0;1
20541;Pilaitukas;KAČIUKAI;7594484959;Taip;6;0;0;6
20542;Pilaitukas;KAČIUKAI;2463482642;Taip;0;1;0;1
20543;Pilaitukas;KAČIUKAI;3080014745;Taip;11;2;0;13
20544;Pilaitukas;KAČIUKAI;5353687011;Taip;0;6;0;6
20545;Pilaitukas;KAČIUKAI;6525191057;Taip;5;0;0;5
20546;Pilaitukas;KAČIUKAI;8009040109;Taip;0;2;0;2
20547;Pilaitukas;KAČIUKAI;2105380328;Taip;0;0;21;21
20548;Pilaitukas;KAČIUKAI;5326689274;Taip;7;0;1;8
20549;Pilaitukas;KAČIUKAI;9653647227;Taip;7;0;1;8
20550;Pilaitukas;KAČIUKAI;1999942175;Taip;7;0;1;8
20551;Pilaitukas;KAČIUKAI;3825942473;Taip;0;13;0;13
20552;Pilaitukas;KAČIUKAI;1611371690;Taip;21;0;0;21
20553;Pilaitukas;KAČIUKAI;9247501721;Taip;0;0;1;1
20554;Pilaitukas;KAČIUKAI;6436694057;Taip;0;0;2;2
20555;Pilaitukas;KAČIUKAI;9974310580;Taip;5;1;0;6
20556;Pilaitukas;KAČIUKAI;6235375235;Taip;13;1;0;14
20557;Pilaitukas;KAČIUKAI;9914575692;Taip;2;1;0;3
20558;Pilaitukas;KAČIUKAI;4341157841;Taip;5;0;2;7
20559;Pilaitukas;SAULUTĖS;8047683859;Taip;9;0;0;9
20560;Pilaitukas;SAULUTĖS;8694369154;Taip;9;0;0;9
20561;Pilaitukas;SAULUTĖS;9405479859;Taip;4;0;0;4
20562;Pilaitukas;SAULUTĖS;1052452915;Taip;7;0;0;7
20563;Pilaitukas;SAULUTĖS;2336933998;Taip;3;0;0;3
20564;Pilaitukas;SAULUTĖS;1134083816;Taip;14;0;0;14
20565;Pilaitukas;SAULUTĖS;2110996493;Taip;17;0;0;17
20566;Pilaitukas;SAULUTĖS;1452645899;Taip;0;0;4;4
20567;Pilaitukas;SAULUTĖS;9587140991;Taip;19;0;0;19
20568;Pilaitukas;SAULUTĖS;2215317686;Taip;6;0;0;6
20569;Pilaitukas;MENULIUKAI;6337917448;Taip;0;2;0;2
20570;Pilaitukas;MENULIUKAI;3636976107;Taip;0;2;0;2
20571;Pilaitukas;MENULIUKAI;5026344198;Taip;5;0;0;5
20572;Pilaitukas;MENULIUKAI;5564784922;Taip;0;2;0;2
20573;Pilaitukas;MENULIUKAI;1290017967;Taip;0;6;0;6
20574;Pilaitukas;MENULIUKAI;5691854235;Taip;0;2;0;2
20575;Pilaitukas;MENULIUKAI;6054821801;Taip;0;10;0;10
20576;Pilaitukas;MENULIUKAI;1620231835;Taip;7;0;0;7
20577;Pilaitukas;MENULIUKAI;8207648026;Taip;6;0;1;7
20578;Pilaitukas;MENULIUKAI;3921932673;Taip;6;0;1;7
20579;Pilaitukas;MENULIUKAI;5682244165;Taip;5;1;0;6
20580;Pilaitukas;MENULIUKAI;3952708917;Taip;21;0;0;21
20581;Pilaitukas;ĖŽIUKAI;1568651642;Taip;0;1;7;8
20582;Pilaitukas;ĖŽIUKAI;2892275540;Taip;0;2;0;2
20583;Pilaitukas;ĖŽIUKAI;1746050808;Taip;7;1;0;8
20584;Pilaitukas;ĖŽIUKAI;2633256935;Taip;9;0;1;10
20585;Pilaitukas;ĖŽIUKAI;8747053041;Taip;9;0;1;10
20586;Pilaitukas;ĖŽIUKAI;7555601497;Taip;5;0;1;6
20587;Pilaitukas;ĖŽIUKAI;6019760696;Taip;5;0;2;7
20588;Pilaitukas;ĖŽIUKAI;5979852431;Taip;16;1;0;17
20589;Pilaitukas;ĖŽIUKAI;6271751691;Taip;0;0;3;3
20590;Pilaitukas;ĖŽIUKAI;9306169443;Taip;11;0;0;11
20591;Pilaitukas;ĖŽIUKAI;5155899628;Taip;5;0;2;7
20592;Pilaitukas;ĖŽIUKAI;5340877261;Taip;5;0;2;7
20593;Pilaitukas;ĖŽIUKAI;2342453729;Taip;0;2;2;4
20594;Pilaitukas;ĖŽIUKAI;6064545501;Taip;5;4;0;9
20595;Pilaitukas;ĖŽIUKAI;9441608677;Taip;12;0;0;12
20596;Pilaitukas;"ŠNEKUČIAI (ĮSRŪTIES G. 27-101)";2883122532;Taip;1;1;0;2
20597;Pilaitukas;"ŠNEKUČIAI (ĮSRŪTIES G. 27-101)";2883122532;Taip;1;1;0;2
20598;Pilaitukas;"ŠNEKUČIAI (ĮSRŪTIES G. 27-101)";2883122532;Taip;1;1;0;2
20599;Pilaitukas;"ŠNEKUČIAI (ĮSRŪTIES G. 27-101)";8801482035;Taip;5;1;0;6
20600;Pilaitukas;"ŠNEKUČIAI (ĮSRŪTIES G. 27-101)";7224121082;Taip;16;0;0;16
20601;Pilaitukas;"ŠNEKUČIAI (ĮSRŪTIES G. 27-101)";9622989196;Taip;9;2;0;11
20602;Pilaitukas;"SMALSUČIAI (ĮSRŪTIES G. 27-101)";1793393776;Taip;8;9;3;20
20603;Pilaitukas;"SMALSUČIAI (ĮSRŪTIES G. 27-101)";3273127718;Taip;6;0;0;6
20604;Pilaitukas;"SMALSUČIAI (ĮSRŪTIES G. 27-101)";7034013577;Taip;8;0;0;8
20605;Pilaitukas;"SMALSUČIAI (ĮSRŪTIES G. 27-101)";4898803794;Taip;21;0;0;21
20606;Pilaitukas;"GUDRUČIAI (ĮSRŪTIES G. 27-101)";1571691020;Ne;5;0;0;5
20607;Pilaitukas;"GUDRUČIAI (ĮSRŪTIES G. 27-101)";3068325053;Ne;5;0;0;5
20608;Pilaitukas;"GUDRUČIAI (ĮSRŪTIES G. 27-101)";1430155044;Ne;1;0;3;4
20609;Pilaitukas;"GUDRUČIAI (ĮSRŪTIES G. 27-101)";1517834246;Taip;1;0;0;1
20610;Pilaitukas;"GUDRUČIAI (ĮSRŪTIES G. 27-101)";93271260871;Taip;0;7;0;7
20611;Pilaitukas;"GUDRUČIAI (ĮSRŪTIES G. 27-101)";7904142328;Taip;0;1;5;6
20612;Pilaitukas;"GUDRUČIAI (ĮSRŪTIES G. 27-101)";3674481373;Taip;11;0;1;12
20613;Pilaitukas;"GUDRUČIAI (ĮSRŪTIES G. 27-101)";2682252810;Taip;0;1;3;4
20614;Pilaitukas;"GUDRUČIAI (ĮSRŪTIES G. 27-101)";8928237970;Taip;0;1;1;2
20615;Pilaitukas;"GUDRUČIAI (ĮSRŪTIES G. 27-101)";7290732562;Taip;11;1;0;12
20616;Pilaitukas;"GUDRUČIAI (ĮSRŪTIES G. 27-101)";3489297719;Taip;0;1;0;1
20617;Pilaitukas;"GUDRUČIAI (ĮSRŪTIES G. 27-101)";87035008129;Taip;9;1;1;11
20618;Pilaitukas;"GUDRUČIAI (ĮSRŪTIES G. 27-101)";2819283284;Taip;7;1;2;10
20619;Pilaitukas;"GUDRUČIAI (ĮSRŪTIES G. 27-101)";7380303098;Taip;0;6;0;6
20620;Pilaitukas;"GUDRUČIAI (ĮSRŪTIES G. 27-101)";9186679454;Taip;0;1;0;1
20621;Pilaitukas;"GUDRUČIAI (ĮSRŪTIES G. 27-101)";9921730735;Taip;3;1;0;4
20622;Pilaitukas;"GUDRUČIAI (ĮSRŪTIES G. 27-101)";8584321345;Taip;0;0;1;1
20623;Pilaitukas;"GUDRUČIAI (ĮSRŪTIES G. 27-101)";3483758882;Ne;7;1;0;8
20624;Pilaitukas;"GUDRUČIAI (ĮSRŪTIES G. 27-101)";87760608710;Ne;5;0;0;5
20625;Pilaitukas;"GUDRUČIAI (ĮSRŪTIES G. 27-101)";5574732283;Taip;6;0;3;9
20626;Pilaitukas;"GUDRUČIAI (ĮSRŪTIES G. 27-101)";5464065587;Taip;6;0;1;7
20627;Pilaitukas;"GUDRUČIAI (ĮSRŪTIES G. 27-101)";3621245783;Taip;11;0;1;12
20628;Vilija;BORUŽĖLĖS;6611278346;Taip;1;2;0;3
20629;Vilija;BORUŽĖLĖS;5979446899;Taip;6;0;2;8
20630;Vilija;BORUŽĖLĖS;3386809866;Taip;14;0;0;14
20631;Vilija;BORUŽĖLĖS;7980759563;Taip;10;0;4;14
20632;Vilija;BORUŽĖLĖS;3301367418;Taip;6;1;0;7
20633;Vilija;BORUŽĖLĖS;6115055683;Taip;6;0;1;7
20634;Vilija;BORUŽĖLĖS;8995800590;Taip;9;0;1;10
20635;Vilija;BORUŽĖLĖS;4577389098;Taip;0;6;0;6
20636;Vilija;BORUŽĖLĖS;9806725516;Taip;0;1;7;8
20637;Vilija;BORUŽĖLĖS;6665382535;Taip;0;0;2;2
20638;Vilija;BORUŽĖLĖS;4791053946;Taip;0;1;0;1
20639;Vilija;BORUŽĖLĖS;4755512150;Taip;0;11;0;11
20640;Vilija;BORUŽĖLĖS;3391689045;Taip;18;0;0;18
20641;Vilija;BORUŽĖLĖS;7464020972;Taip;1;1;0;2
20642;Vilija;NYKŠTUKAI;8248774222;Taip;5;1;0;6
20643;Vilija;NYKŠTUKAI;7009463901;Taip;0;2;0;2
20644;Vilija;NYKŠTUKAI;66817455759;Taip;0;6;0;6
20645;Vilija;NYKŠTUKAI;3201809038;Taip;0;1;0;1
20646;Vilija;NYKŠTUKAI;7469836390;Taip;3;4;0;7
20647;Vilija;NYKŠTUKAI;8364033602;Taip;8;1;0;9
20648;Vilija;NYKŠTUKAI;3544848804;Taip;7;1;0;8
20649;Vilija;NYKŠTUKAI;6136579994;Taip;5;1;1;7
20650;Vilija;NYKŠTUKAI;1116822936;Taip;0;1;0;1
20651;Vilija;NYKŠTUKAI;5563356449;Ne;9;1;0;10
20652;Vilija;NYKŠTUKAI;8756465854;Taip;0;1;8;9
20653;Vilija;NYKŠTUKAI;1717847351;Taip;10;1;0;11
20654;Vilija;NYKŠTUKAI;1751533938;Taip;0;1;0;1
20655;Vilija;NYKŠTUKAI;2532658333;Taip;0;1;6;7
20656;Vilija;ANČIUKAI;5776170550;Taip;0;0;1;1
20657;Vilija;ANČIUKAI;5643311237;Taip;0;2;0;2
20658;Vilija;ANČIUKAI;9176710135;Taip;10;0;0;10
20659;Vilija;ANČIUKAI;8073341597;Taip;0;4;0;4
20660;Vilija;ANČIUKAI;8493278100;Taip;4;7;0;11
20661;Vilija;ANČIUKAI;3556336263;Taip;8;0;1;9
20662;Vilija;ANČIUKAI;4291690659;Taip;4;1;0;5
20663;Vilija;ANČIUKAI;3857271014;Taip;1;0;0;1
20664;Vilija;ANČIUKAI;3552472323;Taip;0;3;0;3
20665;Vilija;ANČIUKAI;5683016588;Taip;3;0;2;5
20666;Vilija;ANČIUKAI;3489127587;Taip;10;5;0;15
20667;Vilija;ANČIUKAI;4780760918;Taip;0;1;0;1
20668;Vilija;ANČIUKAI;7012683174;Taip;10;0;0;10
20669;Vilija;ANČIUKAI;4412011292;Taip;0;0;1;1
20670;Vilija;ANČIUKAI;6385918522;Taip;0;6;0;6
20671;Vilija;ANČIUKAI;9531574134;Taip;0;1;0;1
20672;Vilija;ANČIUKAI;4400813531;Taip;0;3;0;3
20673;Vilija;ANČIUKAI;5454031929;Taip;21;0;0;21
20674;Vilija;ANČIUKAI;4858617162;Taip;0;5;0;5
20675;Vilija;ANČIUKAI;8318388772;Taip;0;6;0;6
20676;Vilija;ANČIUKAI;3677313088;Taip;0;2;0;2
20677;Vilija;ANČIUKAI;6815408748;Taip;4;1;0;5
20678;Vilija;ANČIUKAI;2371667380;Taip;0;1;0;1
20679;Vilija;DRUGELIAI;2205400512;Taip;0;1;0;1
20680;Vilija;DRUGELIAI;5530078264;Taip;0;1;2;3
20681;Vilija;DRUGELIAI;3131712783;Taip;1;6;0;7
20682;Vilija;DRUGELIAI;2807100092;Taip;1;0;0;1
20683;Vilija;DRUGELIAI;5340772605;Taip;10;1;2;13
20684;Vilija;DRUGELIAI;8429923120;Taip;7;1;1;9
20685;Vilija;DRUGELIAI;7418104659;Taip;0;0;3;3
20686;Vilija;DRUGELIAI;3667953591;Taip;0;0;1;1
20687;Vilija;DRUGELIAI;9740915508;Taip;0;0;1;1
20688;Vilija;DRUGELIAI;7836199284;Taip;0;6;0;6
20689;Vilija;DRUGELIAI;7482818685;Taip;0;0;1;1
20690;Vilija;DRUGELIAI;5455278072;Taip;0;0;2;2
20691;Vilija;DRUGELIAI;3349199472;Taip;0;5;0;5
20692;Vilija;DRUGELIAI;6057668143;Taip;0;1;0;1
20693;Vilija;DRUGELIAI;8420744276;Taip;0;8;0;8
20694;Vilija;SMERFAI;7927617851;Taip;0;5;0;5
20695;Vilija;SMERFAI;5508269515;Ne;0;4;0;4
20696;Vilija;SMERFAI;1270627404;Taip;0;1;0;1
20697;Vilija;SMERFAI;2575398136;Taip;0;1;0;1
20698;Vilija;SMERFAI;2164009051;Taip;0;2;0;2
20699;Vilija;SMERFAI;3021504467;Taip;13;1;1;15
20700;Vilija;SMERFAI;5617568215;Taip;10;1;0;11
20701;Vilija;SMERFAI;5056566642;Taip;0;8;0;8
20702;Vilija;SMERFAI;3058713381;Taip;10;1;0;11
20703;Vilija;SMERFAI;4297107641;Taip;0;1;2;3
20704;Vilija;SMERFAI;6165754839;Taip;0;2;0;2
20705;Vilija;SMERFAI;6477644899;Taip;0;2;0;2
20706;Vilija;SMERFAI;25857686522;Taip;0;1;0;1
20707;Vilija;SMERFAI;6937555692;Taip;0;1;3;4
20708;Vilija;SMERFAI;1580316618;Taip;7;1;0;8
20709;Vilija;SMERFAI;5976988338;Ne;0;1;1;2
20710;Vilija;SMERFAI;7606434084;Taip;0;1;0;1
20711;Vilija;SMERFAI;5825920843;Taip;8;1;0;9
20712;Vilija;SAULUTĖS;1442878380;Taip;0;1;2;3
20713;Vilija;SAULUTĖS;7052024709;Ne;0;1;1;2
20714;Vilija;SAULUTĖS;5075219269;Ne;0;1;1;2
20715;Vilija;SAULUTĖS;1161738361;Taip;0;1;1;2
20716;Vilija;SAULUTĖS;7749592467;Ne;7;1;0;8
20717;Vilija;SAULUTĖS;5653564054;Taip;0;1;6;7
20718;Vilija;SAULUTĖS;6706924324;Taip;0;1;0;1
20719;Vilija;SAULUTĖS;5561043797;Taip;0;4;0;4
20720;Vilija;SAULUTĖS;6825500779;Taip;0;1;0;1
20721;Vilija;SAULUTĖS;7860102120;Taip;0;1;1;2
20722;Vilija;SAULUTĖS;7673248841;Ne;0;5;0;5
20723;Vilija;SAULUTĖS;4481147539;Taip;0;4;0;4
20724;Vilija;SAULUTĖS;7915451529;Taip;10;1;0;11
20725;Vilija;SAULUTĖS;4253910558;Taip;0;1;2;3
20726;Vilija;SAULUTĖS;1290880830;Taip;5;1;0;6
20727;Vilija;SAULUTĖS;7880863171;Taip;2;1;0;3
20728;Vilija;SAULUTĖS;6792458439;Taip;0;1;5;6
20729;Vilija;SAULUTĖS;7603226092;Taip;0;2;0;2
20730;Vilija;SAULUTĖS;2551070326;Taip;0;1;1;2
20731;Vilija;SAULUTĖS;3363035704;Ne;0;1;3;4
20732;Vilija;ZUIKUČIAI;5128863532;Taip;0;0;2;2
20733;Vilija;ZUIKUČIAI;7194803557;Taip;0;1;0;1
20734;Vilija;ZUIKUČIAI;9726826566;Taip;0;2;0;2
20735;Vilija;ZUIKUČIAI;6857688873;Taip;7;0;0;7
20736;Vilija;ZUIKUČIAI;8586835095;Taip;10;0;0;10
20737;Vilija;ZUIKUČIAI;4985952177;Taip;16;0;0;16
20738;Vilija;ZUIKUČIAI;4774836050;Taip;0;0;3;3
20739;Vilija;ZUIKUČIAI;9414667437;Taip;0;7;0;7
20740;Vilija;ZUIKUČIAI;9264550987;Taip;8;0;0;8
20741;Vilija;ZUIKUČIAI;5381198018;Taip;9;0;0;9
20742;Vilija;ZUIKUČIAI;4355138593;Taip;0;0;5;5
20743;Vilija;ZUIKUČIAI;5735417577;Taip;7;0;1;8
20744;Vilija;ZUIKUČIAI;9370046849;Taip;0;0;2;2
20745;Vilija;ZUIKUČIAI;7109895494;Taip;0;0;1;1
20746;Vilija;ZUIKUČIAI;4902127595;Taip;0;0;1;1
20747;Vilija;ZUIKUČIAI;4444129040;Taip;0;3;0;3
20748;Vilija;ZUIKUČIAI;3168061557;Taip;0;1;3;4
20749;Vilija;ZUIKUČIAI;7813580782;Taip;0;0;1;1
20750;Vilija;ZUIKUČIAI;6469187290;Ne;5;1;1;7
20751;Vilija;ZUIKUČIAI;5492194393;Taip;5;1;0;6
20752;Vilija;ZUIKUČIAI;4818901769;Taip;18;0;0;18
20753;Vilija;ZUIKUČIAI;6759928420;Taip;0;1;6;7
20754;Vilija;ZUIKUČIAI;4839841253;Taip;0;6;0;6
20755;Vilija;ZUIKUČIAI;8590755333;Taip;16;0;3;19
20756;Vilija;BITUTĖS;4973314993;Taip;12;1;0;13
20757;Vilija;BITUTĖS;4897301808;Ne;0;1;0;1
20758;Vilija;BITUTĖS;9419794080;Taip;9;1;3;13
20759;Vilija;BITUTĖS;1019420340;Taip;0;0;6;6
20760;Vilija;BITUTĖS;5132828941;Taip;10;1;0;11
20761;Vilija;BITUTĖS;9218278301;Taip;5;1;0;6
20762;Vilija;BITUTĖS;9174484523;Taip;4;0;1;5
20763;Vilija;BITUTĖS;5102754179;Taip;10;0;1;11
20764;Vilija;BITUTĖS;4743123463;Taip;11;1;0;12
20765;Vilija;BITUTĖS;8220360728;Taip;0;1;0;1
20766;Vilija;BITUTĖS;3432349973;Taip;7;1;0;8
20767;Vilija;BITUTĖS;8499318976;Taip;0;5;0;5
20768;Vilija;BITUTĖS;8426011190;Taip;0;1;4;5
20769;Vilija;BITUTĖS;8173954240;Taip;14;0;0;14
20770;Vilija;BITUTĖS;1804898751;Taip;12;0;0;12
20771;Vilija;BITUTĖS;5651708105;Taip;5;1;0;6
20772;Vilija;BITUTĖS;9250902486;Taip;3;1;0;4
20773;Vilija;BITUTĖS;6655890861;Taip;0;9;0;9
20774;Vilija;BITUTĖS;4137025486;Taip;1;0;1;2
20775;Vilija;BITUTĖS;7004389875;Taip;0;1;0;1
20776;Vilija;"Pingviniukai (Laisvės pr. 57)";2731415182;Taip;7;0;5;12
20777;Vilija;"Pingviniukai (Laisvės pr. 57)";7015909066;Taip;0;1;0;1
20778;Vilija;"Pingviniukai (Laisvės pr. 57)";4639407305;Taip;8;0;3;11
20779;Vilija;"Pingviniukai (Laisvės pr. 57)";2859663283;Taip;8;0;2;10
20780;Vilija;"Pingviniukai (Laisvės pr. 57)";2903151334;Taip;0;2;0;2
20781;Vilija;"Pingviniukai (Laisvės pr. 57)";7815069972;Taip;0;1;0;1
20782;Vilija;"Pingviniukai (Laisvės pr. 57)";6625339545;Taip;8;0;5;13
20783;Vilija;"Pingviniukai (Laisvės pr. 57)";1840182282;Taip;0;1;0;1
20784;Vilija;"Pingviniukai (Laisvės pr. 57)";4179106082;Taip;5;0;1;6
20785;Vilija;"Pingviniukai (Laisvės pr. 57)";2442272908;Taip;14;0;0;14
20786;Vilija;"Pingviniukai (Laisvės pr. 57)";1845561597;Taip;0;1;4;5
20787;Vilija;"Pingviniukai (Laisvės pr. 57)";1354769998;Taip;4;1;0;5
20788;Vilija;"Pingviniukai (Laisvės pr. 57)";2872066559;Taip;3;0;1;4
20789;Vilija;"Pingviniukai (Laisvės pr. 57)";7219010961;Taip;0;1;0;1
20790;Vilija;"Pingviniukai (Laisvės pr. 57)";5840005178;Taip;5;0;0;5
20791;Vilija;"Pingviniukai (Laisvės pr. 57)";2012412360;Taip;2;0;2;4
20792;Vilija;"Pingviniukai (Laisvės pr. 57)";6855296751;Taip;3;0;2;5
20793;Vilija;"Pingviniukai (Laisvės pr. 57)";2506766222;Taip;0;5;0;5
20794;Vilija;"Pingviniukai (Laisvės pr. 57)";2076388581;Taip;15;1;0;16
20795;Vilija;"Meškiukai (Laisvės pr. 57)";1337656706;Ne;8;0;0;8
20796;Vilija;"Meškiukai (Laisvės pr. 57)";7518841522;Ne;8;0;0;8
20797;Vilija;"Meškiukai (Laisvės pr. 57)";3225442553;Taip;0;1;7;8
20798;Vilija;"Meškiukai (Laisvės pr. 57)";3700333490;Taip;21;0;0;21
20799;Vilija;"Meškiukai (Laisvės pr. 57)";2725051611;Taip;11;2;0;13
20800;Vilija;"Meškiukai (Laisvės pr. 57)";7889810385;Taip;5;0;2;7
20801;Vilija;"Meškiukai (Laisvės pr. 57)";1233653513;Taip;0;0;3;3
20802;Vilija;"Meškiukai (Laisvės pr. 57)";2294228885;Taip;11;0;1;12
20803;Vilija;"Meškiukai (Laisvės pr. 57)";7735728034;Taip;0;0;4;4
20804;Vilija;"Meškiukai (Laisvės pr. 57)";7947071463;Taip;0;1;4;5
20805;Vilija;"Meškiukai (Laisvės pr. 57)";4921409780;Taip;5;13;0;18
20806;Vilija;"Meškiukai (Laisvės pr. 57)";6557918266;Taip;0;0;1;1
20807;Vilija;"Meškiukai (Laisvės pr. 57)";5698897949;Taip;0;1;1;2
20808;Vilija;"Meškiukai (Laisvės pr. 57)";9163803569;Taip;7;0;1;8
20809;Vilija;"Meškiukai (Laisvės pr. 57)";2501118611;Ne;4;1;0;5
20810;Vilija;"Meškiukai (Laisvės pr. 57)";7001209450;Ne;5;7;0;12
20811;Vilija;"Meškiukai (Laisvės pr. 57)";5166455649;Taip;0;1;2;3
20812;Vilija;"Ramunėlės (Laisvės pr. 57)";7707208780;Ne;0;12;0;12
20813;Vilija;"Ramunėlės (Laisvės pr. 57)";7226615203;Taip;8;0;4;12
20814;Vilija;"Ramunėlės (Laisvės pr. 57)";9261213181;Taip;0;1;1;2
20815;Vilija;"Ramunėlės (Laisvės pr. 57)";5034597412;Taip;8;6;0;14
20816;Vilija;"Ramunėlės (Laisvės pr. 57)";6439233139;Taip;0;0;2;2
20817;Vilija;"Ramunėlės (Laisvės pr. 57)";5999958057;Taip;6;7;0;13
20818;Vilija;"Ramunėlės (Laisvės pr. 57)";6142340523;Taip;10;0;1;11
20819;Vilija;"Ramunėlės (Laisvės pr. 57)";4798370162;Taip;6;0;0;6
20820;Vilija;"Ramunėlės (Laisvės pr. 57)";1902217772;Taip;2;0;4;6
20821;Vilija;"Ramunėlės (Laisvės pr. 57)";9377088075;Taip;16;0;0;16
20822;Vilija;"Ramunėlės (Laisvės pr. 57)";6177733291;Taip;8;0;0;8
20823;Vilija;"Ramunėlės (Laisvės pr. 57)";2455384784;Taip;3;2;0;5
20824;Vilija;"Ramunėlės (Laisvės pr. 57)";1760083113;Taip;0;0;3;3
20825;Vilija;"Ramunėlės (Laisvės pr. 57)";9278725667;Taip;1;0;0;1
20826;Vilija;"Ramunėlės (Laisvės pr. 57)";7288035130;Taip;0;0;4;4
20827;Vilija;"Varpeliai (Laisvės pr. 57)";6742119549;Taip;4;9;0;13
20828;Vilija;"Varpeliai (Laisvės pr. 57)";9641020899;Ne;5;2;0;7
20829;Vilija;"Varpeliai (Laisvės pr. 57)";2948716989;Taip;5;1;0;6
20830;Vilija;"Varpeliai (Laisvės pr. 57)";6525761466;Taip;0;0;1;1
20831;Vilija;"Varpeliai (Laisvės pr. 57)";5277217733;Taip;6;0;1;7
20832;Vilija;"Varpeliai (Laisvės pr. 57)";3346154143;Taip;4;3;0;7
20833;Vilija;"Varpeliai (Laisvės pr. 57)";1502013942;Taip;20;1;0;21
20834;Vilija;"Varpeliai (Laisvės pr. 57)";2190583964;Ne;17;0;0;17
20835;Vilija;"Varpeliai (Laisvės pr. 57)";3920229653;Taip;0;0;1;1
20836;Vilija;"Varpeliai (Laisvės pr. 57)";4969561425;Taip;6;1;2;9
20837;Vilija;"Varpeliai (Laisvės pr. 57)";8092890260;Ne;0;1;0;1
20838;Vilija;"Varpeliai (Laisvės pr. 57)";3998988004;Taip;3;0;4;7
20839;Vilija;"Varpeliai (Laisvės pr. 57)";6756184787;Taip;0;1;0;1
20840;Vilija;"Varpeliai (Laisvės pr. 57)";3589001032;Taip;11;5;0;16
20841;Vilija;"Varpeliai (Laisvės pr. 57)";4692443164;Taip;0;8;2;10
20842;Vilija;"Varpeliai (Laisvės pr. 57)";7426713153;Ne;11;0;1;12
20843;Vilija;"Varpeliai (Laisvės pr. 57)";5734602455;Ne;0;0;4;4
20844;Vilija;"Varpeliai (Laisvės pr. 57)";1440531672;Ne;0;1;0;1
20845;Vilija;"Varpeliai (Laisvės pr. 57)";4562536818;Ne;10;0;1;11
20846;Vilija;"Varpeliai (Laisvės pr. 57)";6226967695;Ne;0;0;2;2
20847;Vilija;"Varpeliai (Laisvės pr. 57)";3062594197;Taip;0;0;8;8
20848;Vilija;"Varpeliai (Laisvės pr. 57)";9226214856;Ne;5;0;2;7
20849;Vilija;"Voveraitės (Laisvės pr. 57)";9640071277;Taip;5;2;0;7
20850;Vilija;"Voveraitės (Laisvės pr. 57)";7522129675;Taip;8;5;1;14
20851;Vilija;"Voveraitės (Laisvės pr. 57)";1807028630;Taip;2;0;2;4
20852;Vilija;"Voveraitės (Laisvės pr. 57)";4868770355;Taip;4;0;1;5
20853;Vilija;"Voveraitės (Laisvės pr. 57)";8923074604;Taip;6;4;0;10
20854;Vilija;"Voveraitės (Laisvės pr. 57)";3948140208;Taip;0;0;3;3
20855;Vilija;"Voveraitės (Laisvės pr. 57)";9809985578;Taip;0;0;2;2
20856;Vilija;"Voveraitės (Laisvės pr. 57)";3464990457;Taip;0;0;5;5
20857;Vilija;"Voveraitės (Laisvės pr. 57)";5229557734;Taip;16;0;1;17
20858;Vilija;"Voveraitės (Laisvės pr. 57)";8758253294;Taip;6;0;1;7
20859;Vilija;"Voveraitės (Laisvės pr. 57)";5694927471;Taip;0;1;0;1
20860;Vilija;"Voveraitės (Laisvės pr. 57)";6496861835;Ne;10;0;0;10
20861;Vilija;"Voveraitės (Laisvės pr. 57)";6782229835;Taip;19;1;0;20
20862;Vilija;"Voveraitės (Laisvės pr. 57)";2910501252;Taip;14;0;0;14
20863;Vilija;"Voveraitės (Laisvės pr. 57)";3899016982;Taip;0;0;1;1
20864;Vilija;"Voveraitės (Laisvės pr. 57)";4936982698;Taip;9;0;0;9
20865;Vilija;"Voveraitės (Laisvės pr. 57)";4873345183;Taip;5;0;2;7
20866;Vilija;"Voveraitės (Laisvės pr. 57)";9638268554;Taip;0;0;1;1
20867;Vilija;"Voveraitės (Laisvės pr. 57)";3654655172;Taip;0;3;0;3
20868;Vilija;"Voveraitės (Laisvės pr. 57)";7184118489;Taip;10;1;1;12
20869;Vilija;"Voveraitės (Laisvės pr. 57)";3095065890;Taip;13;1;0;14
20870;Vilija;"Voveraitės (Laisvės pr. 57)";5450812526;Taip;10;1;1;12
20871;Vilija;"Voveraitės (Laisvės pr. 57)";7389324585;Ne;10;0;1;11
20872;Vilija;"Pelėdžiukai (Laisvės pr. 57)";3269357241;Taip;6;0;5;11
20873;Vilija;"Pelėdžiukai (Laisvės pr. 57)";2055282010;Taip;0;1;6;7
20874;Vilija;"Pelėdžiukai (Laisvės pr. 57)";7358925256;Taip;0;2;0;2
20875;Vilija;"Pelėdžiukai (Laisvės pr. 57)";2778931038;Taip;6;0;3;9
20876;Vilija;"Pelėdžiukai (Laisvės pr. 57)";8465864375;Taip;6;0;0;6
20877;Vilija;"Pelėdžiukai (Laisvės pr. 57)";7784329873;Taip;3;1;2;6
20878;Vilija;"Pelėdžiukai (Laisvės pr. 57)";4437786689;Taip;6;0;3;9
20879;Vilija;"Pelėdžiukai (Laisvės pr. 57)";7089883250;Taip;0;0;2;2
20880;Vilija;"Pelėdžiukai (Laisvės pr. 57)";5043122065;Ne;0;0;4;4
20881;Vilija;"Pelėdžiukai (Laisvės pr. 57)";3581180895;Taip;0;1;1;2
20882;Vilija;"Pelėdžiukai (Laisvės pr. 57)";1306244736;Ne;1;2;0;3
20883;Vilija;"Pelėdžiukai (Laisvės pr. 57)";8608907350;Taip;2;0;2;4
20884;Vilija;"Pelėdžiukai (Laisvės pr. 57)";9117896572;Taip;14;3;0;17
20885;Vilija;"Pelėdžiukai (Laisvės pr. 57)";5821077318;Taip;14;2;0;16
20886;Vilija;"Pelėdžiukai (Laisvės pr. 57)";9471287834;Taip;0;0;4;4
20887;Vilija;"Pelėdžiukai (Laisvės pr. 57)";8186421282;Taip;0;0;3;3
20888;Vilija;"Pelėdžiukai (Laisvės pr. 57)";8815055819;Taip;8;2;0;10
20889;Vilija;"Pelėdžiukai (Laisvės pr. 57)";9750688419;Taip;0;7;0;7
20890;Vilija;"Pelėdžiukai (Laisvės pr. 57)";1778722493;Taip;4;0;1;5
20891;Vilija;"Pelėdžiukai (Laisvės pr. 57)";9915113607;Taip;6;0;2;8
20892;Vilija;"Pelėdžiukai (Laisvės pr. 57)";6581404954;Ne;6;1;0;7
20893;Vilija;"Pelėdžiukai (Laisvės pr. 57)";7869675895;Taip;6;13;0;19
20894;Vilija;"Pelėdžiukai (Laisvės pr. 57)";7697727530;Taip;0;0;3;3
20895;Vilija;"1 A klasė";3262118748;Taip;0;0;1;1
20896;Vilija;"1 A klasė";25927573409;Taip;0;0;1;1
20897;Vilija;"1 A klasė";12341614604;Taip;0;0;6;6
20898;Vilija;"1 A klasė";93217431744;Taip;0;0;5;5
20899;Vilija;"1 A klasė";96736842214;Taip;0;0;1;1
20900;Vilija;"1 A klasė";1130096158;Taip;0;0;1;1
20901;Vilija;"1 A klasė";61428440730;Taip;0;0;5;5
20902;Vilija;"1 A klasė";5904760231;Taip;0;0;4;4
20903;Vilija;"1 A klasė";2060024184;Taip;0;0;4;4
20904;Vilija;"1 A klasė";6265909152;Taip;0;0;1;1
20905;Vilija;"1 B klasė";50372098009;Taip;0;0;7;7
20906;Vilija;"1 B klasė";96636312334;Taip;0;0;1;1
20907;Vilija;"1 B klasė";46757944454;Taip;0;0;2;2
20908;Vilija;"1 B klasė";20003910788;Ne;0;0;1;1
20909;Vilija;"1 B klasė";3645300574;Taip;0;0;3;3
20910;Vilija;"1 B klasė";6657294393;Taip;0;0;4;4
20911;Vilija;"1 B klasė";40990687217;Taip;0;0;7;7
20912;Vilija;"1 B klasė";6405741006;Taip;0;0;3;3
20913;Vilija;"1 B klasė";7595977304;Taip;0;0;1;1
20914;Vilija;"1 B klasė";22204555252;Taip;0;0;1;1
20915;Vilija;"1 B klasė";3541189470;Taip;0;0;1;1
20916;Vilija;"1 B klasė";42973327518;Taip;0;0;2;2
20917;Vilija;"1 B klasė";1567546511;Taip;0;0;5;5
20918;Vilija;"2 A klasė";33063987306;Taip;0;0;5;5
20919;Vilija;"2 A klasė";33063987306;Taip;0;0;5;5
20920;Vilija;"2 A klasė";98476858512;Taip;0;0;3;3
20921;Vilija;"2 A klasė";98476858512;Taip;0;0;3;3
20922;Vilija;"2 A klasė";1890319177;Taip;0;0;2;2
20923;Vilija;"2 A klasė";1890319177;Taip;0;0;2;2
20924;Vilija;"2 A klasė";98553857685;Taip;0;0;1;1
20925;Vilija;"2 A klasė";98553857685;Taip;0;0;1;1
20926;Vilija;"2 A klasė";13479943342;Taip;0;0;6;6
20927;Vilija;"2 A klasė";13479943342;Taip;0;0;6;6
20928;Vilija;"2 A klasė";1372699042;Taip;0;0;1;1
20929;Vilija;"2 A klasė";1372699042;Taip;0;0;1;1
20930;Vilija;"2 A klasė";8867152773;Taip;0;0;1;1
20931;Vilija;"2 A klasė";89880758183;Taip;0;0;3;3
20932;Vilija;"2 A klasė";89880758183;Taip;0;0;3;3
20933;Vilija;"2 A klasė";61636842808;Taip;0;0;1;1
20934;Vilija;"2 A klasė";3216714595;Taip;0;0;1;1
20935;Vilija;"2 A klasė";3216714595;Taip;0;0;1;1
20936;Vilija;"2 B klasė";9641600096;Taip;0;0;5;5
20937;Vilija;"2 B klasė";9641600096;Taip;0;0;5;5
20938;Vilija;"2 B klasė";9641600096;Taip;0;0;5;5
20939;Vilija;"2 B klasė";96355926476;Taip;0;0;3;3
20940;Vilija;"2 B klasė";96355926476;Taip;0;0;3;3
20941;Vilija;"2 B klasė";77737606304;Taip;0;0;9;9
20942;Vilija;"2 B klasė";1110951690;Taip;0;0;3;3
20943;Vilija;"2 B klasė";1110951690;Taip;0;0;3;3
20944;Vilija;"2 B klasė";72120808860;Taip;0;0;2;2
20945;Vilija;"2 B klasė";72120808860;Taip;0;0;2;2
20946;Vilija;"2 B klasė";72120808860;Taip;0;0;2;2
20947;Vilija;"2 B klasė";72120808860;Taip;0;0;2;2
20948;Vilija;"2 B klasė";9396618279;Ne;0;0;2;2
20949;Vilija;"2 B klasė";8687001991;Taip;0;0;5;5
20950;Vilija;"2 B klasė";8687001991;Taip;0;0;5;5
20951;Vilija;"2 B klasė";3553109625;Ne;0;0;5;5
20952;Vilija;"2 B klasė";40987081532;Taip;0;0;4;4
20953;Vilija;"2 B klasė";40987081532;Taip;0;0;4;4
20954;Vilija;"2 B klasė";40987081532;Taip;0;0;4;4
20955;Vilija;"2 B klasė";40987081532;Taip;0;0;4;4
20956;Vilija;"3 A klasė";35617359110;Taip;0;0;1;1
20957;Vilija;"3 A klasė";8290409889;Taip;0;0;5;5
20958;Vilija;"3 A klasė";8119923809;Ne;0;0;5;5
20959;Vilija;"3 A klasė";18111520082;Taip;0;0;3;3
20960;Vilija;"3 A klasė";18111520082;Taip;0;0;3;3
20961;Vilija;"3 A klasė";18111520082;Taip;0;0;3;3
20962;Vilija;"3 A klasė";4642044129;Taip;0;0;2;2
20963;Vilija;"3 A klasė";4642044129;Taip;0;0;2;2
20964;Vilija;"3 A klasė";4642044129;Taip;0;0;2;2
20965;Vilija;"3 A klasė";4642044129;Taip;0;0;2;2
20966;Vilija;"3 A klasė";86867736047;Ne;0;0;2;2
20967;Vilija;"3 A klasė";1236191042;Taip;0;0;5;5
20968;Vilija;"3 A klasė";45551453665;Taip;0;0;1;1
20969;Vilija;"3 A klasė";45551453665;Taip;0;0;1;1
20970;Vilija;"3 B klasė";1023494497;Taip;0;0;7;7
20971;Vilija;"3 B klasė";1023494497;Taip;0;0;7;7
20972;Vilija;"3 B klasė";48393620450;Taip;0;0;5;5
20973;Vilija;"3 B klasė";48393620450;Taip;0;0;5;5
20974;Vilija;"3 B klasė";94879856163;Taip;0;0;3;3
20975;Vilija;"3 B klasė";94879856163;Taip;0;0;3;3
20976;Vilija;"3 B klasė";48578028107;Taip;0;0;3;3
20977;Vilija;"3 B klasė";48578028107;Taip;0;0;3;3
20978;Vilija;"3 B klasė";48578028107;Taip;0;0;3;3
20979;Vilija;"3 B klasė";72919494405;Taip;0;0;1;1
20980;Vilija;"3 B klasė";64276710131;Ne;0;0;3;3
20981;Vilija;"3 B klasė";64276710131;Ne;0;0;3;3
20982;Vilija;"3 B klasė";81065447875;Taip;0;0;3;3
20983;Vilija;"3 B klasė";81065447875;Taip;0;0;3;3
20984;Vilija;"3 B klasė";56568361276;Taip;0;0;2;2
20985;Vilija;"3 B klasė";26012264791;Ne;0;0;1;1
20986;Vilija;"3 B klasė";26012264791;Ne;0;0;1;1
20987;Vilija;"3 B klasė";65450791871;Ne;0;0;3;3
20988;Vilija;"3 B klasė";65450791871;Ne;0;0;3;3
20989;Vilija;"3 B klasė";65450791871;Ne;0;0;3;3
20990;Vilija;"3 B klasė";65450791871;Ne;0;0;3;3
20991;Vilija;"3 B klasė";44674068414;Taip;0;0;8;8
20992;Vilija;"3 B klasė";44674068414;Taip;0;0;8;8
20993;Vilija;"3 B klasė";44674068414;Taip;0;0;8;8
20994;Vilija;"3 B klasė";98541698293;Ne;0;0;2;2
20995;Vilija;"3 B klasė";98541698293;Ne;0;0;2;2
20996;Vilija;"4 A klasė";70378983845;Taip;0;0;1;1
20997;Vilija;"4 A klasė";70378983845;Taip;0;0;1;1
20998;Vilija;"4 A klasė";24867618982;Ne;0;0;2;2
20999;Vilija;"4 A klasė";11585786511;Taip;0;0;2;2
21000;Vilija;"4 A klasė";45522084009;Taip;0;0;2;2
21001;Vilija;"4 A klasė";45522084009;Taip;0;0;2;2
21002;Vilija;"4 A klasė";28561188828;Taip;0;0;3;3
21003;Vilija;"4 A klasė";28561188828;Taip;0;0;3;3
21004;Vilija;"4 A klasė";82559433799;Taip;0;0;7;7
21005;Vilija;"4 A klasė";8309162906;Taip;0;0;1;1
21006;Vilija;"4 A klasė";43088504714;Ne;0;0;2;2
21007;Vilija;"4 A klasė";43088504714;Ne;0;0;2;2
21008;Vilija;"4 A klasė";43088504714;Ne;0;0;2;2
21009;Vilija;"4 A klasė";43088504714;Ne;0;0;2;2
21010;Vilija;"4 A klasė";72966804906;Taip;0;0;1;1
21011;Vilija;"4 A klasė";88456677238;Ne;0;0;2;2
21012;Vilija;"4 A klasė";5843488337;Taip;0;0;2;2
21013;Vilija;"4 A klasė";5843488337;Taip;0;0;2;2
21014;Vilija;"4 A klasė";5843488337;Taip;0;0;2;2
21015;Vilija;"4 A klasė";5843488337;Taip;0;0;2;2
21016;Vilija;"4 A klasė";5933198621;Ne;0;0;3;3
21017;Vilija;"4 A klasė";3184088380;Taip;0;0;3;3
21018;Vilija;"4 A klasė";3184088380;Taip;0;0;3;3
21019;Vilija;"4 A klasė";92413925752;Taip;0;0;2;2
21020;Vilija;"4 A klasė";92413925752;Taip;0;0;2;2
21021;Vilija;"4 A klasė";6443793437;Taip;0;0;1;1
21022;Vilija;"4 A klasė";1546363831;Taip;0;0;1;1
21023;Vilija;"4 A klasė";55064836651;Taip;0;0;2;2
21024;Vilija;"4 B klasė";40286409640;Taip;0;0;2;2
21025;Vilija;"4 B klasė";40286409640;Taip;0;0;2;2
21026;Vilija;"4 B klasė";8344052767;Ne;0;0;1;1
21027;Vilija;"4 B klasė";21575700026;Taip;0;0;2;2
21028;Vilija;"4 B klasė";21575700026;Taip;0;0;2;2
21029;Vilija;"4 B klasė";38841935509;Taip;0;0;1;1
21030;Vilija;"4 B klasė";68319399217;Taip;0;0;3;3
21031;Vilija;"4 B klasė";68319399217;Taip;0;0;3;3
21032;Vilija;"4 B klasė";70597034584;Taip;0;0;9;9
21033;Vilija;"4 B klasė";70597034584;Taip;0;0;9;9
21034;Švelnukas;Pelėdžiukai;8016531082;Taip;0;17;4;21
21035;Švelnukas;Pelėdžiukai;8219071968;Taip;5;1;6;12
21036;Švelnukas;Pelėdžiukai;3235768013;Taip;0;1;1;2
21037;Švelnukas;Pelėdžiukai;9008722163;Taip;11;2;0;13
21038;Švelnukas;Pelėdžiukai;1116279011;Ne;0;2;0;2
21039;Švelnukas;Pelėdžiukai;3892058023;Ne;0;2;0;2
21040;Švelnukas;Pelėdžiukai;5681611554;Taip;5;0;0;5
21041;Švelnukas;Pelėdžiukai;8589226595;Taip;8;0;1;9
21042;Švelnukas;Pelėdžiukai;9802064955;Taip;0;2;0;2
21043;Švelnukas;Pelėdžiukai;5041138716;Taip;10;0;0;10
21044;Švelnukas;Pelėdžiukai;3804532959;Taip;0;1;0;1
21045;Švelnukas;Pelėdžiukai;1462620951;Taip;0;1;0;1
21046;Švelnukas;Pelėdžiukai;8650902343;Taip;2;0;1;3
21047;Švelnukas;Pelėdžiukai;1409803554;Taip;0;1;0;1
21048;Švelnukas;Pelėdžiukai;1991507109;Ne;0;1;2;3
21049;Švelnukas;Pelėdžiukai;9808833734;Taip;0;0;6;6
21050;Švelnukas;Pelėdžiukai;9814032171;Taip;0;2;0;2
21051;Švelnukas;Ežiukai;25374873288;Taip;0;1;1;2
21052;Švelnukas;Ežiukai;6282389058;Taip;5;1;0;6
21053;Švelnukas;Ežiukai;23795609183;Taip;0;1;0;1
21054;Švelnukas;Ežiukai;8399963483;Taip;0;1;0;1
21055;Švelnukas;Ežiukai;4711482287;Taip;0;2;0;2
21056;Švelnukas;Ežiukai;8681264696;Taip;0;1;0;1
21057;Švelnukas;Ežiukai;4373567509;Taip;0;1;1;2
21058;Švelnukas;Ežiukai;2521009631;Taip;1;0;1;2
21059;Švelnukas;Ežiukai;1165172787;Taip;0;1;0;1
21060;Švelnukas;Ežiukai;7308701231;Taip;0;1;2;3
21061;Švelnukas;Ežiukai;2400781175;Taip;0;0;2;2
21062;Švelnukas;Ežiukai;6209334207;Taip;14;0;0;14
21063;Švelnukas;Ežiukai;1201550386;Taip;0;0;1;1
21064;Švelnukas;Ežiukai;7266255326;Taip;0;1;0;1
21065;Švelnukas;Ežiukai;2348752207;Taip;0;21;0;21
21066;Švelnukas;Ežiukai;1143579276;Taip;0;0;1;1
21067;Švelnukas;Ežiukai;5409130195;Taip;1;0;0;1
21068;Švelnukas;Ežiukai;3645855145;Taip;5;1;0;6
21069;Švelnukas;Ežiukai;9402567487;Ne;4;0;5;9
21070;Švelnukas;Ežiukai;8569985034;Ne;0;0;10;10
21071;Švelnukas;Švelnukai;4681584014;Taip;6;0;2;8
21072;Švelnukas;Švelnukai;8847738918;Taip;0;1;0;1
21073;Švelnukas;Švelnukai;1982267458;Taip;0;0;2;2
21074;Švelnukas;Švelnukai;9766734938;Taip;7;1;2;10
21075;Švelnukas;Švelnukai;3020524039;Taip;5;1;4;10
21076;Švelnukas;Švelnukai;9829912750;Taip;0;1;3;4
21077;Švelnukas;Švelnukai;5032829856;Taip;0;0;1;1
21078;Švelnukas;Švelnukai;5213589179;Taip;0;6;0;6
21079;Švelnukas;Švelnukai;1963518457;Taip;0;1;4;5
21080;Švelnukas;Švelnukai;4194249709;Taip;0;6;5;11
21081;Švelnukas;Švelnukai;5936821902;Taip;0;0;1;1
21082;Švelnukas;Švelnukai;3228293160;Taip;0;1;0;1
21083;Švelnukas;Švelnukai;7607215137;Taip;2;1;0;3
21084;Švelnukas;Švelnukai;4629757899;Taip;0;4;0;4
21085;Švelnukas;Švelnukai;6964997767;Taip;11;1;0;12
21086;Švelnukas;Švelnukai;8951810066;Taip;18;0;0;18
21087;Švelnukas;Švelnukai;2663990082;Taip;1;0;3;4
21088;Švelnukas;Švelnukai;6204286255;Taip;0;0;7;7
21089;Švelnukas;Švelnukai;5960966542;Taip;0;2;0;2
21090;Švelnukas;Boružiukai;1951447127;Taip;0;0;5;5
21091;Švelnukas;Boružiukai;3849957906;Ne;0;0;5;5
21092;Švelnukas;Boružiukai;5550841477;Taip;1;0;4;5
21093;Švelnukas;Boružiukai;1264256177;Taip;0;2;0;2
21094;Švelnukas;Boružiukai;1332533332;Taip;4;0;5;9
21095;Švelnukas;Boružiukai;8787505507;Ne;0;1;3;4
21096;Švelnukas;Boružiukai;4134678301;Taip;0;0;1;1
21097;Švelnukas;Boružiukai;8458233793;Taip;4;0;2;6
21098;Švelnukas;Boružiukai;7967996032;Taip;0;0;4;4
21099;Švelnukas;Boružiukai;8951980999;Taip;0;0;1;1
21100;Švelnukas;Boružiukai;4990399144;Taip;0;4;0;4
21101;Švelnukas;Boružiukai;9575767514;Ne;0;0;9;9
21102;Švelnukas;Boružiukai;6282137936;Taip;5;3;0;8
21103;Švelnukas;Boružiukai;2088128734;Taip;0;4;0;4
21104;Švelnukas;Boružiukai;2077614498;Ne;0;0;1;1
21105;Švelnukas;Boružiukai;3145935641;Taip;5;1;0;6
21106;Švelnukas;Boružiukai;4404904322;Taip;0;0;8;8
21107;Švelnukas;Boružiukai;3561920685;Taip;0;0;1;1
21108;Švelnukas;Boružiukai;8895028305;Taip;0;1;1;2
21109;Švelnukas;Boružiukai;4961854528;Taip;5;1;0;6
21110;Švelnukas;Smalsučiai;9558811523;Taip;0;0;4;4
21111;Švelnukas;Smalsučiai;5085517759;Taip;0;1;0;1
21112;Švelnukas;Smalsučiai;1661019352;Taip;0;4;0;4
21113;Švelnukas;Smalsučiai;5554625346;Taip;0;0;3;3
21114;Švelnukas;Smalsučiai;3282020958;Taip;0;0;3;3
21115;Švelnukas;Smalsučiai;2730288544;Taip;0;2;0;2
21116;Švelnukas;Smalsučiai;5805289419;Taip;0;0;2;2
21117;Švelnukas;Smalsučiai;1415899173;Taip;8;0;0;8
21118;Švelnukas;Smalsučiai;7987715134;Taip;0;0;2;2
21119;Švelnukas;Smalsučiai;3455801077;Taip;0;21;0;21
21120;Švelnukas;Smalsučiai;8193690277;Taip;0;2;0;2
21121;Švelnukas;Smalsučiai;9371102717;Taip;0;21;0;21
21122;Švelnukas;Smalsučiai;3472774028;Taip;11;0;0;11
21123;Švelnukas;Smalsučiai;5845744917;Taip;11;1;0;12
21124;Švelnukas;Smalsučiai;6764222588;Taip;0;0;16;16
21125;Švelnukas;Smalsučiai;1840752560;Taip;8;6;0;14
21126;Švelnukas;Smalsučiai;8268391509;Taip;1;0;3;4
21127;Švelnukas;Smalsučiai;4467095100;Taip;0;0;6;6
21128;Švelnukas;Nykštukai;1293700097;Taip;0;1;2;3
21129;Švelnukas;Nykštukai;8221642452;Taip;0;1;0;1
21130;Švelnukas;Nykštukai;2141519946;Taip;0;2;0;2
21131;Švelnukas;Nykštukai;8771953161;Taip;0;1;4;5
21132;Švelnukas;Nykštukai;5327209876;Taip;0;2;0;2
21133;Švelnukas;Nykštukai;2282356211;Taip;10;0;0;10
21134;Švelnukas;Nykštukai;4697253853;Taip;0;1;2;3
21135;Švelnukas;Nykštukai;7387060610;Taip;0;1;0;1
21136;Švelnukas;Nykštukai;1762528313;Taip;0;1;4;5
21137;Švelnukas;Nykštukai;3370028567;Taip;0;1;1;2
21138;Švelnukas;Nykštukai;6633233824;Taip;10;1;1;12
21139;Švelnukas;Nykštukai;2106591525;Taip;0;0;1;1
21140;Švelnukas;Nykštukai;93497358197;Taip;0;6;0;6
21141;Švelnukas;Nykštukai;2971380970;Taip;0;1;0;1
21142;Švelnukas;Nykštukai;3389897065;Taip;0;1;0;1
21143;Švelnukas;Nykštukai;4302735157;Taip;2;1;0;3
21144;Švelnukas;Nykštukai;2785396019;Taip;6;0;4;10
21145;Švelnukas;Nykštukai;6195335543;Taip;0;1;0;1
21146;Boružėlė;"Nykštukai gudručiai";7736917485;Taip;11;3;0;14
21147;Boružėlė;"Nykštukai gudručiai";9520696660;Taip;0;0;4;4
21148;Boružėlė;"Nykštukai gudručiai";5691884576;Ne;11;0;0;11
21149;Boružėlė;"Nykštukai gudručiai";9193273478;Taip;1;0;0;1
21150;Boružėlė;"Nykštukai gudručiai";3237771499;Taip;7;3;0;10
21151;Boružėlė;"Nykštukai gudručiai";8359957290;Ne;0;12;2;14
21152;Boružėlė;"Nykštukai gudručiai";8141240094;Taip;0;15;0;15
21153;Boružėlė;"Nykštukai gudručiai";2349571778;Taip;0;1;0;1
21154;Boružėlė;"Nykštukai gudručiai";1894170218;Taip;9;1;0;10
21155;Boružėlė;"Nykštukai gudručiai";3509512899;Taip;17;0;0;17
21156;Boružėlė;"Nykštukai gudručiai";8888151470;Taip;17;0;0;17
21157;Boružėlė;"Nykštukai gudručiai";3430953692;Taip;5;1;0;6
21158;Boružėlė;"Nykštukai gudručiai";8365962523;Taip;0;1;0;1
21159;Boružėlė;"Nykštukai gudručiai";3592853535;Taip;0;1;0;1
21160;Boružėlė;"Nykštukai gudručiai";6876323023;Taip;0;3;0;3
21161;Boružėlė;"Nykštukai gudručiai";2744894565;Taip;0;3;4;7
21162;Boružėlė;"Nykštukai gudručiai";6590829182;Ne;1;2;3;6
21163;Boružėlė;"Nykštukai gudručiai";3129825206;Ne;0;10;0;10
21164;Boružėlė;"Nykštukai gudručiai";9771767352;Taip;10;1;0;11
21165;Boružėlė;"Nykštukai gudručiai";8789209196;Taip;10;0;0;10
21166;Boružėlė;"Nykštukai gudručiai";2571360077;Taip;4;2;0;6
21167;Boružėlė;"Nykštukai gudručiai";9078805020;Taip;0;2;0;2
21168;Boružėlė;"Saulės zuikučiai";4554260776;Taip;11;1;0;12
21169;Boružėlė;"Saulės zuikučiai";5298170118;Taip;1;0;0;1
21170;Boružėlė;"Saulės zuikučiai";2133849514;Taip;0;4;1;5
21171;Boružėlė;"Saulės zuikučiai";1116012068;Taip;7;2;1;10
21172;Boružėlė;"Saulės zuikučiai";1292298259;Taip;1;0;1;2
21173;Boružėlė;"Saulės zuikučiai";3130977416;Taip;6;0;0;6
21174;Boružėlė;"Saulės zuikučiai";7256396576;Taip;1;0;0;1
21175;Boružėlė;"Saulės zuikučiai";4323998138;Taip;19;0;0;19
21176;Boružėlė;"Saulės zuikučiai";2087238951;Taip;6;1;0;7
21177;Boružėlė;"Saulės zuikučiai";3952645542;Ne;9;1;0;10
21178;Boružėlė;"Saulės zuikučiai";5516103398;Taip;7;0;7;14
21179;Boružėlė;"Saulės zuikučiai";8259586236;Taip;1;0;0;1
21180;Boružėlė;"Saulės zuikučiai";3955841578;Taip;1;3;0;4
21181;Boružėlė;"Saulės zuikučiai";1583223569;Taip;1;3;0;4
21182;Boružėlė;"Saulės zuikučiai";4433248526;Taip;0;6;1;7
21183;Boružėlė;"Saulės zuikučiai";1547802140;Taip;0;0;3;3
21184;Boružėlė;"Saulės zuikučiai";4020348640;Taip;0;0;3;3
21185;Boružėlė;"Saulės zuikučiai";2842256033;Taip;1;2;0;3
21186;Boružėlė;"Saulės zuikučiai";2561969142;Taip;0;0;11;11
21187;Boružėlė;"Saulės zuikučiai";7262515868;Taip;0;6;0;6
21188;Boružėlė;"Saulės zuikučiai";6527254253;Taip;7;3;0;10
21189;Boružėlė;"Saulės zuikučiai";7942043844;Taip;0;7;2;9
21190;Boružėlė;Gėlytės;1146297996;Taip;8;0;0;8
21191;Boružėlė;Gėlytės;3288141024;Taip;10;5;0;15
21192;Boružėlė;Gėlytės;1166207929;Taip;0;1;0;1
21193;Boružėlė;Gėlytės;7956982615;Ne;5;3;0;8
21194;Boružėlė;Gėlytės;4637656311;Taip;6;0;1;7
21195;Boružėlė;Gėlytės;3226733236;Taip;5;3;0;8
21196;Boružėlė;Gėlytės;6070356395;Taip;5;7;0;12
21197;Boružėlė;Gėlytės;4180537253;Taip;16;1;0;17
21198;Boružėlė;Gėlytės;6722353853;Taip;6;1;5;12
21199;Boružėlė;Gėlytės;8376436755;Taip;2;3;8;13
21200;Boružėlė;Gėlytės;3300678477;Taip;5;1;0;6
21201;Boružėlė;Gėlytės;7763958937;Taip;9;0;3;12
21202;Boružėlė;Gėlytės;9855354210;Taip;14;0;1;15
21203;Boružėlė;Gėlytės;2515608520;Ne;17;1;0;18
21204;Boružėlė;Gėlytės;3354291446;Taip;13;0;1;14
21205;Boružėlė;Gėlytės;8520403894;Taip;8;1;0;9
21206;Boružėlė;Gėlytės;4268486154;Ne;9;0;0;9
21207;Boružėlė;Gėlytės;7614216150;Taip;7;3;0;10
21208;Boružėlė;Gėlytės;4448964310;Taip;0;10;0;10
21209;Boružėlė;Gėlytės;8205706322;Taip;6;1;5;12
21210;Boružėlė;Gėlytės;8834231529;Ne;19;0;2;21
21211;Boružėlė;Gėlytės;8929444125;Taip;9;0;0;9
21212;Boružėlė;Smalsutis;2086485441;Taip;0;0;2;2
21213;Boružėlė;Smalsutis;5129244830;Taip;7;0;3;10
21214;Boružėlė;Smalsutis;6927100979;Taip;9;0;0;9
21215;Boružėlė;Smalsutis;2887130633;Taip;7;0;2;9
21216;Boružėlė;Smalsutis;4947670606;Taip;8;0;1;9
21217;Boružėlė;Smalsutis;2917508421;Taip;1;0;0;1
21218;Boružėlė;Smalsutis;7263730692;Taip;10;0;0;10
21219;Boružėlė;Smalsutis;5708558321;Taip;11;1;0;12
21220;Boružėlė;Smalsutis;6484173786;Taip;0;1;0;1
21221;Boružėlė;Smalsutis;6742157071;Taip;7;0;1;8
21222;Boružėlė;Smalsutis;2132904457;Taip;11;0;0;11
21223;Boružėlė;Smalsutis;39553430808;Taip;7;0;1;8
21224;Boružėlė;Smalsutis;4958704459;Taip;11;1;0;12
21225;Boružėlė;Smalsutis;5618586722;Taip;7;0;1;8
21226;Boružėlė;Smalsutis;8493908653;Taip;0;9;0;9
21227;Boružėlė;Smalsutis;4283064680;Taip;8;0;6;14
21228;Boružėlė;Smalsutis;2447148171;Ne;0;1;0;1
21229;Boružėlė;Smalsutis;7386694567;Taip;5;0;3;8
21230;Boružėlė;Smalsutis;9634967237;Taip;16;0;0;16
21231;Boružėlė;Smalsutis;3592594142;Taip;16;0;0;16
21232;Boružėlė;Drugeliai;8357946299;Taip;4;0;0;4
21233;Boružėlė;Drugeliai;1130980139;Taip;0;1;0;1
21234;Boružėlė;Drugeliai;6463583187;Taip;0;3;2;5
21235;Boružėlė;Drugeliai;3136028536;Taip;0;6;0;6
21236;Boružėlė;Drugeliai;2211576663;Taip;0;5;0;5
21237;Boružėlė;Drugeliai;1559001916;Taip;0;3;0;3
21238;Boružėlė;Drugeliai;4233602822;Taip;5;1;0;6
21239;Boružėlė;Drugeliai;9463322491;Taip;0;2;0;2
21240;Boružėlė;Drugeliai;3108758436;Taip;0;1;0;1
21241;Boružėlė;Drugeliai;8482813204;Taip;0;1;6;7
21242;Boružėlė;Drugeliai;6902130914;Taip;9;0;0;9
21243;Boružėlė;Drugeliai;3459207879;Taip;0;2;0;2
21244;Boružėlė;Drugeliai;6980022864;Taip;0;1;0;1
21245;Boružėlė;Drugeliai;5726187445;Taip;5;1;0;6
21246;Boružėlė;Drugeliai;2308405580;Taip;0;0;1;1
21247;Boružėlė;Drugeliai;3405184929;Taip;0;1;4;5
21248;Boružėlė;Drugeliai;8213060214;Taip;1;0;0;1
21249;Boružėlė;Drugeliai;3331238309;Taip;6;0;0;6
21250;Boružėlė;Drugeliai;2783338563;Taip;0;2;0;2
21251;Boružėlė;Vyturėliai;1913540317;Taip;0;6;0;6
21252;Boružėlė;Vyturėliai;1950269258;Taip;0;1;0;1
21253;Boružėlė;Vyturėliai;1591582954;Taip;7;2;0;9
21254;Boružėlė;Vyturėliai;9180459278;Taip;0;1;0;1
21255;Boružėlė;Vyturėliai;3322567969;Taip;0;1;1;2
21256;Boružėlė;Vyturėliai;8311383437;Ne;5;3;0;8
21257;Boružėlė;Vyturėliai;7534482245;Ne;4;3;0;7
21258;Boružėlė;Vyturėliai;3310676316;Ne;0;6;0;6
21259;Boružėlė;Vyturėliai;87834777247;Taip;1;0;0;1
21260;Boružėlė;Vyturėliai;50071056728;Taip;6;5;0;11
21261;Boružėlė;Vyturėliai;43300167107;Taip;0;1;0;1
21262;Boružėlė;Vyturėliai;2098408445;Taip;4;1;0;5
21263;Boružėlė;Vyturėliai;8706461730;Ne;0;1;0;1
21264;Boružėlė;Vyturėliai;5337704114;Taip;0;1;0;1
21265;Boružėlė;Vyturėliai;8146684259;Taip;4;3;0;7
21266;Boružėlė;Vyturėliai;8225622711;Taip;0;1;0;1
21267;Boružėlė;Vyturėliai;67504667512;Taip;0;1;0;1
21268;Boružėlė;Vyturėliai;9150703371;Taip;0;2;0;2
21269;Boružėlė;Vyturėliai;5811751925;Taip;0;3;0;3
21270;Boružėlė;Vyturėliai;7136428795;Taip;3;1;0;4
21271;Boružėlė;Vyturėliai;6978158667;Taip;0;1;0;1
21272;Boružėlė;Vyturėliai;9640681773;Taip;0;1;10;11
21273;Boružėlė;Vyturėliai;5576016171;Taip;15;2;0;17
21274;Boružėlė;Žvaigždutės;4990831292;Taip;8;0;1;9
21275;Boružėlė;Žvaigždutės;9838823214;Taip;7;3;0;10
21276;Boružėlė;Žvaigždutės;7825636053;Taip;8;1;0;9
21277;Boružėlė;Žvaigždutės;7901880926;Taip;9;0;0;9
21278;Boružėlė;Žvaigždutės;6242220139;Taip;7;1;0;8
21279;Boružėlė;Žvaigždutės;3489498503;Taip;6;3;0;9
21280;Boružėlė;Žvaigždutės;5274016839;Taip;0;1;0;1
21281;Boružėlė;Žvaigždutės;9720535449;Taip;7;2;0;9
21282;Boružėlė;Žvaigždutės;6435556131;Taip;10;2;1;13
21283;Boružėlė;Žvaigždutės;3140264242;Taip;6;3;0;9
21284;Boružėlė;Žvaigždutės;5307997577;Taip;0;0;1;1
21285;Boružėlė;Žvaigždutės;6724101421;Taip;0;1;0;1
21286;Boružėlė;Žvaigždutės;7078709057;Taip;0;1;0;1
21287;Boružėlė;Žvaigždutės;6972646373;Taip;9;0;0;9
21288;Boružėlė;Žvaigždutės;8820827882;Taip;15;1;0;16
21289;Boružėlė;Žvaigždutės;2857645329;Taip;9;0;0;9
21290;Boružėlė;Žvaigždutės;5242187638;Taip;1;0;0;1
21291;Boružėlė;Žvaigždutės;1799882790;Taip;0;3;2;5
21292;Boružėlė;Žvaigždutės;5420788580;Taip;8;0;2;10
21293;Boružėlė;Žvaigždutės;6130634131;Taip;7;0;0;7
21294;Boružėlė;Ąžuoliukai;5774358876;Taip;0;3;0;3
21295;Boružėlė;Ąžuoliukai;4519645340;Taip;0;1;0;1
21296;Boružėlė;Ąžuoliukai;24315678618;Taip;8;1;0;9
21297;Boružėlė;Ąžuoliukai;4994696176;Taip;0;2;0;2
21298;Boružėlė;Ąžuoliukai;5138737297;Taip;0;1;0;1
21299;Boružėlė;Ąžuoliukai;6439902117;Taip;0;3;0;3
21300;Boružėlė;Ąžuoliukai;3040376382;Taip;0;1;5;6
21301;Boružėlė;Ąžuoliukai;3912668735;Taip;0;1;0;1
21302;Boružėlė;Ąžuoliukai;3840860155;Taip;5;6;1;12
21303;Boružėlė;Ąžuoliukai;7722277859;Taip;0;1;0;1
21304;Boružėlė;Ąžuoliukai;6954794465;Taip;8;1;1;10
21305;Boružėlė;Ąžuoliukai;5832223872;Taip;0;2;0;2
21306;Boružėlė;Ąžuoliukai;3695411422;Taip;0;1;0;1
21307;Boružėlė;Ąžuoliukai;5148410392;Taip;0;1;0;1
21308;Boružėlė;Ąžuoliukai;76222777017;Taip;0;7;0;7
21309;Boružėlė;Ąžuoliukai;45181369655;Taip;5;1;0;6
21310;Boružėlė;Ąžuoliukai;2077228543;Taip;0;15;0;15
21311;Boružėlė;Ąžuoliukai;6022191251;Ne;0;2;0;2
21312;Boružėlė;Ąžuoliukai;3869817904;Taip;6;3;0;9
21313;Boružėlė;Ąžuoliukai;9269501176;Taip;10;1;0;11
21314;Boružėlė;Ąžuoliukai;8029389952;Taip;2;1;2;5
21315;Boružėlė;Ąžuoliukai;8683282162;Taip;0;1;0;1
21316;Boružėlė;Ąžuoliukai;9999252614;Taip;0;0;2;2
21317;Boružėlė;Saulutės;9492548829;Taip;0;2;5;7
21318;Boružėlė;Saulutės;5437943626;Taip;6;3;0;9
21319;Boružėlė;Saulutės;3503931241;Taip;6;3;0;9
21320;Boružėlė;Saulutės;8882070834;Taip;6;0;0;6
21321;Boružėlė;Saulutės;7882386455;Ne;5;2;1;8
21322;Boružėlė;Saulutės;6265279517;Taip;0;7;0;7
21323;Boružėlė;Saulutės;6275425512;Taip;7;0;0;7
21324;Boružėlė;Saulutės;2879726579;Taip;5;4;0;9
21325;Boružėlė;Saulutės;8804878419;Taip;6;4;0;10
21326;Boružėlė;Saulutės;3871593172;Taip;5;3;0;8
21327;Boružėlė;Saulutės;3953507461;Taip;17;0;0;17
21328;Boružėlė;Saulutės;1492091211;Taip;12;0;0;12
21329;Boružėlė;Saulutės;1830043506;Taip;6;0;0;6
21330;Boružėlė;Saulutės;5680510186;Taip;18;0;0;18
21331;Boružėlė;Saulutės;1152697871;Taip;0;4;0;4
21332;Boružėlė;Saulutės;1779839709;Ne;6;1;0;7
21333;Boružėlė;Saulutės;7652740249;Taip;17;1;0;18
21334;Boružėlė;Saulutės;5508064424;Ne;14;1;0;15
21335;Boružėlė;Saulutės;5064892417;Taip;1;0;0;1
21336;Boružėlė;Ežiukai;9342498392;Taip;11;0;0;11
21337;Boružėlė;Ežiukai;8195442951;Taip;0;3;5;8
21338;Boružėlė;Ežiukai;6448688592;Taip;11;1;0;12
21339;Boružėlė;Ežiukai;2429696310;Taip;11;1;0;12
21340;Boružėlė;Ežiukai;9893643199;Taip;0;12;0;12
21341;Boružėlė;Ežiukai;3112016309;Taip;11;0;0;11
21342;Boružėlė;Ežiukai;5394149649;Taip;11;0;0;11
21343;Boružėlė;Ežiukai;9391811395;Taip;8;3;0;11
21344;Boružėlė;Ežiukai;8167376712;Taip;6;3;0;9
21345;Boružėlė;Ežiukai;1784594085;Taip;10;2;0;12
21346;Boružėlė;Ežiukai;9423458813;Taip;0;0;2;2
21347;Boružėlė;Ežiukai;5825164520;Taip;3;0;1;4
21348;Boružėlė;Ežiukai;7190980006;Taip;0;2;0;2
21349;Boružėlė;Ežiukai;7459531236;Taip;0;1;0;1
21350;Boružėlė;Ežiukai;8818358360;Taip;0;1;0;1
21351;Boružėlė;Ežiukai;2926620929;Taip;13;1;0;14
21352;Boružėlė;Ežiukai;6609156790;Taip;0;4;5;9
21353;Boružėlė;Ežiukai;5768415821;Taip;9;1;0;10
21354;Boružėlė;Ežiukai;8291389794;Taip;2;0;0;2
21355;Boružėlė;Ežiukai;5492228053;Taip;6;4;0;10
21356;Boružėlė;Ežiukai;6087811262;Taip;21;0;0;21
21357;Boružėlė;Boružiukai;7068409148;Taip;3;2;1;6
21358;Boružėlė;Boružiukai;8434178580;Taip;10;4;0;14
21359;Boružėlė;Boružiukai;8752343077;Taip;5;0;0;5
21360;Boružėlė;Boružiukai;8944790932;Taip;5;0;0;5
21361;Boružėlė;Boružiukai;7065907155;Taip;14;4;0;18
21362;Boružėlė;Boružiukai;4113917886;Taip;3;0;1;4
21363;Boružėlė;Boružiukai;1608652924;Taip;5;0;0;5
21364;Boružėlė;Boružiukai;7149439740;Taip;11;1;0;12
21365;Boružėlė;Boružiukai;3005601935;Taip;2;5;0;7
21366;Boružėlė;Boružiukai;4497753570;Taip;16;0;0;16
21367;Boružėlė;Boružiukai;1865891989;Ne;9;0;0;9
21368;Boružėlė;Boružiukai;8739264310;Taip;4;1;0;5
21369;Boružėlė;Boružiukai;3097874340;Taip;0;1;1;2
21370;Boružėlė;Boružiukai;1551933321;Taip;1;1;0;2
21371;Boružėlė;Boružiukai;3097217902;Taip;5;0;0;5
21372;Boružėlė;Boružiukai;2084361709;Taip;8;2;0;10
21373;Boružėlė;Boružiukai;4727351240;Taip;5;2;1;8
21374;Boružėlė;Nykštukai;1047419932;Taip;8;1;0;9
21375;Boružėlė;Nykštukai;8377410278;Taip;8;0;1;9
21376;Boružėlė;Nykštukai;4928818565;Taip;7;5;0;12
21377;Boružėlė;Nykštukai;5619719965;Taip;0;4;0;4
21378;Boružėlė;Nykštukai;1966066642;Taip;5;0;0;5
21379;Boružėlė;Nykštukai;6267999965;Taip;19;0;0;19
21380;Boružėlė;Nykštukai;8073918985;Ne;2;1;0;3
21381;Boružėlė;Nykštukai;3595998843;Taip;8;1;0;9
21382;Boružėlė;Nykštukai;1929202434;Taip;5;0;1;6
21383;Boružėlė;Nykštukai;4217116059;Taip;2;2;2;6
21384;Boružėlė;Nykštukai;8165748779;Taip;0;1;6;7
21385;Žaliakalnio;Drugeliai;6379145626;Ne;2;3;0;5
21386;Žaliakalnio;Drugeliai;7094914749;Taip;0;9;0;9
21387;Žaliakalnio;Drugeliai;7449949339;Ne;0;3;1;4
21388;Žaliakalnio;Drugeliai;2607433844;Taip;3;2;0;5
21389;Žaliakalnio;Drugeliai;1413563085;Ne;0;2;0;2
21390;Žaliakalnio;Drugeliai;2432935088;Ne;0;1;0;1
21391;Žaliakalnio;Drugeliai;4806478786;Taip;0;1;0;1
21392;Žaliakalnio;Drugeliai;9032003195;Ne;5;1;0;6
21393;Žaliakalnio;Drugeliai;7566429633;Taip;0;10;0;10
21394;Žaliakalnio;Drugeliai;3835667120;Taip;0;5;0;5
21395;Žaliakalnio;Drugeliai;6341640909;Taip;0;2;0;2
21396;Žaliakalnio;Drugeliai;4059753894;Ne;0;1;0;1
21397;Žaliakalnio;Drugeliai;2305496316;Ne;0;2;0;2
21398;Žaliakalnio;Drugeliai;9984857605;Taip;5;2;0;7
21399;Žaliakalnio;Drugeliai;5764128482;Taip;0;2;0;2
21400;Žaliakalnio;Drugeliai;4497938258;Taip;0;3;2;5
21401;Žaliakalnio;Drugeliai;1673321992;Taip;0;2;0;2
21402;Žaliakalnio;Boružėlių;5843020412;Taip;5;5;0;10
21403;Žaliakalnio;Boružėlių;9625531462;Taip;0;15;0;15
21404;Žaliakalnio;Boružėlių;6699373334;Taip;0;15;0;15
21405;Žaliakalnio;Boružėlių;7087535800;Taip;0;3;0;3
21406;Žaliakalnio;Boružėlių;1528111839;Taip;0;3;0;3
21407;Žaliakalnio;Boružėlių;7023886811;Taip;0;4;0;4
21408;Žaliakalnio;Boružėlių;2284465378;Taip;5;2;0;7
21409;Žaliakalnio;Boružėlių;7977009681;Taip;0;1;0;1
21410;Žaliakalnio;Boružėlių;2808776865;Taip;10;0;1;11
21411;Žaliakalnio;Boružėlių;2278681435;Taip;6;0;0;6
21412;Žaliakalnio;Boružėlių;9421259943;Taip;2;0;0;2
21413;Žaliakalnio;Boružėlių;3445649442;Ne;0;5;0;5
21414;Žaliakalnio;Boružėlių;3105500733;Taip;0;1;0;1
21415;Žaliakalnio;Boružėlių;1200844791;Taip;0;6;0;6
21416;Žaliakalnio;Boružėlių;8052539476;Taip;10;11;0;21
21417;Žaliakalnio;Boružėlių;6590016097;Ne;0;8;0;8
21418;Žaliakalnio;Boružėlių;8304431519;Ne;15;1;2;18
21419;Žaliakalnio;Boružėlių;8429135626;Taip;0;11;0;11
21420;Žaliakalnio;Boružėlių;8073554707;Ne;5;0;3;8
21421;Žaliakalnio;Boružėlių;8534973941;Ne;15;2;0;17
21422;Žaliakalnio;Boružėlių;2987217910;Taip;5;7;1;13
21423;Žaliakalnio;Boružėlių;5157814568;Taip;0;1;0;1
21424;Žaliakalnio;Zuikučiai;1592051491;Taip;4;1;0;5
21425;Žaliakalnio;Zuikučiai;6088333997;Taip;12;2;0;14
21426;Žaliakalnio;Zuikučiai;2673619031;Taip;5;2;0;7
21427;Žaliakalnio;Zuikučiai;5843314345;Taip;10;2;0;12
21428;Žaliakalnio;Zuikučiai;2180165053;Taip;0;2;0;2
21429;Žaliakalnio;Zuikučiai;6823528666;Taip;0;3;0;3
21430;Žaliakalnio;Zuikučiai;3509064089;Taip;0;3;0;3
21431;Žaliakalnio;Zuikučiai;7000429934;Taip;0;3;0;3
21432;Žaliakalnio;Zuikučiai;5730610895;Taip;0;2;0;2
21433;Žaliakalnio;Zuikučiai;6881070397;Taip;0;7;0;7
21434;Žaliakalnio;Zuikučiai;8209559343;Taip;12;2;1;15
21435;Žaliakalnio;Zuikučiai;9799056285;Taip;0;1;0;1
21436;Žaliakalnio;Zuikučiai;1321592040;Ne;0;1;0;1
21437;Žaliakalnio;Zuikučiai;8298313285;Ne;0;1;0;1
21438;Žaliakalnio;Zuikučiai;9331287916;Taip;3;3;0;6
21439;Žaliakalnio;Zuikučiai;6726832258;Ne;0;3;0;3
21440;Žaliakalnio;Zuikučiai;4607456527;Taip;8;2;0;10
21441;Žaliakalnio;Zuikučiai;9363615751;Taip;3;6;0;9
21442;Žaliakalnio;Zuikučiai;6727442688;Ne;11;1;0;12
21443;Žaliakalnio;Bitutė;5744370516;Taip;0;5;0;5
21444;Žaliakalnio;Bitutė;3619817569;Taip;12;1;1;14
21445;Žaliakalnio;Bitutė;3905448562;Taip;7;1;0;8
21446;Žaliakalnio;Bitutė;8481665290;Taip;2;0;0;2
21447;Žaliakalnio;Bitutė;8950583202;Taip;6;0;0;6
21448;Žaliakalnio;Bitutė;6324315523;Taip;5;2;0;7
21449;Žaliakalnio;Bitutė;6877235095;Taip;6;2;0;8
21450;Žaliakalnio;Bitutė;2280683252;Ne;0;1;0;1
21451;Žaliakalnio;Bitutė;7711347723;Taip;1;0;2;3
21452;Žaliakalnio;Bitutė;4561672875;Taip;0;1;0;1
21453;Žaliakalnio;Bitutė;8185190219;Taip;1;0;0;1
21454;Žaliakalnio;Bitutė;7830692152;Taip;0;2;0;2
21455;Žaliakalnio;Bitutė;1423481154;Taip;0;4;0;4
21456;Žaliakalnio;Bitutė;4928400872;Taip;0;7;0;7
21457;Žaliakalnio;Bitutė;2613771302;Taip;9;0;0;9
21458;Žaliakalnio;Bitutė;3976548663;Taip;4;5;0;9
21459;Žaliakalnio;Bitutė;8599646291;Taip;6;0;1;7
21460;Žaliakalnio;Bitutė;1343293430;Taip;0;4;0;4
21461;Žaliakalnio;Bitutė;3721878250;Ne;15;1;0;16
21462;Žaliakalnio;Bitutė;6291287113;Taip;2;1;3;6
21463;Žaliakalnio;Bitutė;4412760433;Taip;4;0;0;4
21464;Žaliakalnio;Bitutė;7989372873;Ne;2;1;0;3
21465;Žaliakalnio;Bitutė;1173977434;Taip;14;1;0;15
21466;Žaliakalnio;Nykštukų;9069518153;Taip;5;11;0;16
21467;Žaliakalnio;Nykštukų;8142435757;Taip;16;1;0;17
21468;Žaliakalnio;Nykštukų;3446593135;Taip;0;1;10;11
21469;Žaliakalnio;Nykštukų;1064854294;Taip;9;12;0;21
21470;Žaliakalnio;Nykštukų;4891656355;Ne;0;8;0;8
21471;Žaliakalnio;Nykštukų;1632465983;Taip;8;2;0;10
21472;Žaliakalnio;Nykštukų;8472945857;Taip;0;1;0;1
21473;Žaliakalnio;Nykštukų;9521104462;Taip;13;1;0;14
21474;Žaliakalnio;Nykštukų;5565027085;Ne;6;1;3;10
21475;Žaliakalnio;Nykštukų;2242604156;Ne;8;1;0;9
21476;Žaliakalnio;Nykštukų;8852165484;Taip;1;1;9;11
21477;Žaliakalnio;Nykštukų;9801618806;Taip;0;14;0;14
21478;Žaliakalnio;Nykštukų;2225778044;Taip;0;1;6;7
21479;Žaliakalnio;Nykštukų;4255734788;Taip;10;2;1;13
21480;Žaliakalnio;Nykštukų;7793937917;Taip;3;9;0;12
21481;Žaliakalnio;Nykštukų;8117013474;Ne;25;1;0;26
21482;Žaliakalnio;Nykštukų;7205368281;Taip;5;5;0;10
21483;Žaliakalnio;Nykštukų;8360480591;Taip;16;1;7;24
21484;Žaliakalnio;Nykštukų;4036239701;Taip;15;0;0;15
21485;Žaliakalnio;Nykštukų;5258266970;Taip;16;0;1;17
21486;Žaliakalnio;Nykštukų;6166482260;Taip;6;3;2;11
21487;Žaliakalnio;Nykštukų;3041002600;Taip;1;1;1;3
21488;Žaliakalnio;ŽIOGELIAI;5752912101;Ne;1;3;0;4
21489;Žaliakalnio;ŽIOGELIAI;9967098834;Ne;12;0;0;12
21490;Žaliakalnio;ŽIOGELIAI;1133557422;Taip;6;1;0;7
21491;Žaliakalnio;ŽIOGELIAI;3464935314;Ne;10;4;0;14
21492;Žaliakalnio;ŽIOGELIAI;7648422668;Ne;0;1;0;1
21493;Žaliakalnio;ŽIOGELIAI;4702470511;Taip;0;7;0;7
21494;Žaliakalnio;ŽIOGELIAI;2272043654;Taip;0;3;0;3
21495;Žaliakalnio;ŽIOGELIAI;8518422934;Taip;0;2;0;2
21496;Žaliakalnio;ŽIOGELIAI;6674631040;Ne;6;0;0;6
21497;Žaliakalnio;ŽIOGELIAI;8245784590;Taip;21;0;0;21
21498;Žaliakalnio;ŽIOGELIAI;9485995178;Taip;0;3;0;3
21499;Žaliakalnio;ŽIOGELIAI;8179329874;Ne;6;0;0;6
21500;Žaliakalnio;ŽIOGELIAI;8383425712;Ne;2;0;3;5
21501;Žaliakalnio;ŽIOGELIAI;1309236035;Ne;0;21;0;21
21502;Žaliakalnio;ŽIOGELIAI;7025195076;Taip;7;2;0;9
21503;Žaliakalnio;ŽIOGELIAI;2514763739;Ne;0;1;0;1
21504;Žaliakalnio;ŽIOGELIAI;8891815592;Ne;17;0;0;17
21505;Žaliakalnio;ŽIOGELIAI;6294045755;Taip;0;9;0;9
21506;Žaliakalnio;ŽIOGELIAI;8232697563;Taip;0;7;0;7
21507;Žaliakalnio;ŽIOGELIAI;2694424532;Taip;11;4;0;15
21508;Žaliakalnio;ŽIOGELIAI;6136717862;Ne;6;1;0;7
21509;Žaliakalnio;ŽIOGELIAI;8316505307;Taip;4;1;0;5
21510;Žaliakalnio;SAULUTĖS;5602734465;Taip;0;15;0;15
21511;Žaliakalnio;SAULUTĖS;1253655689;Taip;3;3;0;6
21512;Žaliakalnio;SAULUTĖS;3016537413;Taip;5;1;0;6
21513;Žaliakalnio;SAULUTĖS;6795532166;Taip;4;0;0;4
21514;Žaliakalnio;SAULUTĖS;4154737541;Ne;14;0;0;14
21515;Žaliakalnio;SAULUTĖS;7913029369;Taip;6;1;0;7
21516;Žaliakalnio;SAULUTĖS;7793917852;Taip;0;2;0;2
21517;Žaliakalnio;SAULUTĖS;3018398546;Taip;10;1;0;11
21518;Žaliakalnio;SAULUTĖS;8765159796;Taip;2;0;0;2
21519;Žaliakalnio;SAULUTĖS;3028921540;Taip;10;1;0;11
21520;Žaliakalnio;SAULUTĖS;7636933790;Taip;13;8;0;21
21521;Žaliakalnio;SAULUTĖS;4355433666;Taip;10;1;0;11
21522;Žaliakalnio;SAULUTĖS;1975313368;Taip;13;1;4;18
21523;Žaliakalnio;SAULUTĖS;9016032548;Taip;3;2;0;5
21524;Žaliakalnio;SAULUTĖS;1715385224;Taip;12;2;0;14
21525;Žaliakalnio;SAULUTĖS;3304186400;Taip;14;4;0;18
21526;Žaliakalnio;SAULUTĖS;3434815790;Taip;2;1;0;3
21527;Žaliakalnio;SAULUTĖS;3832291926;Taip;1;0;0;1
21528;Žaliakalnio;SAULUTĖS;7071209465;Taip;8;0;0;8
21529;Žaliakalnio;SAULUTĖS;7543073516;Taip;0;2;0;2
21530;Žaliakalnio;SAULUTĖS;9379373983;Taip;0;1;0;1
21531;Volungė;Bitutės;6661730121;Taip;2;0;0;2
21532;Volungė;Bitutės;5791161943;Taip;4;0;0;4
21533;Volungė;Bitutės;3307326410;Taip;5;0;4;9
21534;Volungė;Bitutės;5300334761;Taip;16;1;0;17
21535;Volungė;Bitutės;6755366051;Taip;11;0;5;16
21536;Volungė;Bitutės;4013639324;Taip;0;0;3;3
21537;Volungė;Bitutės;8470433743;Taip;0;0;11;11
21538;Volungė;Bitutės;2599441104;Taip;11;0;2;13
21539;Volungė;Bitutės;5892600735;Taip;0;6;5;11
21540;Volungė;Bitutės;1902122510;Taip;10;1;0;11
21541;Volungė;Bitutės;1752817125;Taip;0;0;21;21
21542;Volungė;Bitutės;3515725398;Taip;5;1;0;6
21543;Volungė;Bitutės;3666364101;Taip;0;1;2;3
21544;Volungė;Bitutės;7151952679;Taip;6;2;2;10
21545;Volungė;Bitutės;5960027749;Taip;0;0;4;4
21546;Volungė;Bitutės;5149291935;Taip;13;0;0;13
21547;Volungė;Bitutės;8166517073;Taip;5;0;0;5
21548;Volungė;Bitutės;3106135598;Taip;3;0;0;3
21549;Volungė;Boružiukai;6431477042;Taip;0;0;2;2
21550;Volungė;Boružiukai;1137713075;Taip;0;6;0;6
21551;Volungė;Boružiukai;2322594823;Taip;0;2;0;2
21552;Volungė;Boružiukai;7965601199;Taip;0;1;1;2
21553;Volungė;Boružiukai;3746978206;Taip;0;0;3;3
21554;Volungė;Boružiukai;1528289101;Taip;0;1;0;1
21555;Volungė;Boružiukai;9188994935;Taip;0;5;4;9
21556;Volungė;Boružiukai;8285309230;Taip;5;1;1;7
21557;Volungė;Boružiukai;7149986415;Taip;0;0;1;1
21558;Volungė;Boružiukai;4598763851;Taip;6;1;0;7
21559;Volungė;Boružiukai;7867741556;Taip;10;0;3;13
21560;Volungė;Boružiukai;8459167833;Taip;0;1;1;2
21561;Volungė;Boružiukai;6028582927;Taip;6;1;0;7
21562;Volungė;Boružiukai;3832613221;Taip;7;1;1;9
21563;Volungė;Boružiukai;1757041481;Taip;0;0;12;12
21564;Volungė;Boružiukai;7971287899;Ne;0;4;0;4
21565;Volungė;Boružiukai;2627555750;Taip;6;0;2;8
21566;Volungė;Boružiukai;1974650443;Taip;0;0;5;5
21567;Volungė;Boružiukai;2603335248;Ne;3;0;1;4
21568;Volungė;Boružiukai;2068447339;Taip;0;0;5;5
21569;Volungė;Boružiukai;3528581949;Taip;9;0;1;10
21570;Volungė;Žvirbliukai;2360026330;Taip;0;0;1;1
21571;Volungė;Žvirbliukai;8414351815;Taip;12;0;3;15
21572;Volungė;Žvirbliukai;2051410463;Taip;0;0;9;9
21573;Volungė;Žvirbliukai;5074093178;Taip;0;0;8;8
21574;Volungė;Žvirbliukai;9575894080;Ne;5;0;3;8
21575;Volungė;Žvirbliukai;8927595898;Taip;10;0;2;12
21576;Volungė;Žvirbliukai;9384821249;Taip;13;0;1;14
21577;Volungė;Žvirbliukai;5361410157;Taip;17;0;0;17
21578;Volungė;Žvirbliukai;4235842588;Ne;5;0;1;6
21579;Volungė;Žvirbliukai;3028611395;Taip;0;0;14;14
21580;Volungė;Žvirbliukai;2949033093;Ne;5;0;5;10
21581;Volungė;Žvirbliukai;2159667991;Taip;12;0;2;14
21582;Volungė;Žvirbliukai;4337994278;Taip;0;0;2;2
21583;Volungė;Žvirbliukai;3282765504;Taip;0;0;11;11
21584;Volungė;Žvirbliukai;5470252589;Taip;0;0;5;5
21585;Volungė;Žvirbliukai;7923029388;Taip;0;0;9;9
21586;Volungė;Žiogeliai;6360834021;Taip;0;0;3;3
21587;Volungė;Žiogeliai;4856240879;Ne;5;0;2;7
21588;Volungė;Žiogeliai;4694016281;Taip;2;0;1;3
21589;Volungė;Žiogeliai;9816038480;Ne;3;0;0;3
21590;Volungė;Žiogeliai;8640511964;Taip;0;0;7;7
21591;Volungė;Žiogeliai;5170536566;Taip;0;1;0;1
21592;Volungė;Žiogeliai;8421730419;Taip;6;6;0;12
21593;Volungė;Žiogeliai;6532202782;Taip;0;0;4;4
21594;Volungė;Žiogeliai;2712034356;Taip;0;6;0;6
21595;Volungė;Žiogeliai;2246291631;Taip;4;0;1;5
21596;Volungė;Žiogeliai;2456643081;Taip;4;0;3;7
21597;Volungė;Žiogeliai;6920821813;Taip;0;0;3;3
21598;Volungė;Žiogeliai;8299305464;Taip;5;0;9;14
21599;Volungė;Žiogeliai;1781838937;Taip;0;0;1;1
21600;Volungė;Žiogeliai;7859381467;Taip;0;21;0;21
21601;Volungė;Žiogeliai;1988082807;Taip;5;1;0;6
21602;Volungė;Žiogeliai;3091641738;Ne;0;0;2;2
21603;Volungė;Žiogeliai;8578521969;Taip;4;1;0;5
21604;Volungė;Žiogeliai;5710662590;Taip;0;1;1;2
21605;Volungė;Žiogeliai;4839484528;Taip;0;1;0;1
21606;Volungė;Žiogeliai;5174427959;Taip;0;0;1;1
21607;Volungė;Žiogeliai;4726043862;Taip;0;0;1;1
21608;Volungė;Pelėdžiukai;1099216923;Taip;0;1;8;9
21609;Volungė;Pelėdžiukai;3430719834;Taip;0;1;2;3
21610;Volungė;Pelėdžiukai;2566901599;Taip;5;0;0;5
21611;Volungė;Pelėdžiukai;2420242319;Taip;0;1;1;2
21612;Volungė;Pelėdžiukai;7973680488;Taip;0;1;0;1
21613;Volungė;Pelėdžiukai;3356901662;Taip;0;1;2;3
21614;Volungė;Pelėdžiukai;1225378067;Ne;0;0;5;5
21615;Volungė;Pelėdžiukai;7281448136;Taip;0;2;2;4
21616;Volungė;Pelėdžiukai;3215314804;Taip;0;1;1;2
21617;Volungė;Pelėdžiukai;9629567682;Taip;0;1;4;5
21618;Volungė;Pelėdžiukai;1120682487;Taip;0;2;1;3
21619;Volungė;Pelėdžiukai;9082860913;Taip;6;1;1;8
21620;Volungė;Pelėdžiukai;8174587725;Taip;0;3;4;7
21621;Volungė;Pelėdžiukai;17534618616;Taip;0;1;0;1
21622;Volungė;Pelėdžiukai;2187800215;Taip;0;1;0;1
21623;Volungė;Pelėdžiukai;7521910384;Taip;3;1;0;4
21624;Volungė;Pelėdžiukai;6565522808;Taip;0;1;0;1
21625;Volungė;Pelėdžiukai;9068889427;Taip;9;1;1;11
21626;Volungė;Pelėdžiukai;4123080241;Taip;0;1;2;3
21627;Volungė;Pelėdžiukai;8268202101;Taip;0;1;4;5
21628;Volungė;Pelėdžiukai;1366066359;Taip;0;1;1;2
21629;Volungė;Drugeliai;6280208510;Taip;12;0;3;15
21630;Volungė;Drugeliai;4032261812;Taip;0;1;7;8
21631;Volungė;Drugeliai;6488473384;Taip;17;0;1;18
21632;Volungė;Drugeliai;8045459660;Taip;11;0;3;14
21633;Volungė;Drugeliai;1402200673;Taip;11;0;3;14
21634;Volungė;Drugeliai;7574856429;Taip;15;0;0;15
21635;Volungė;Drugeliai;5284011092;Taip;0;0;1;1
21636;Volungė;Drugeliai;9729285419;Ne;0;1;8;9
21637;Volungė;Drugeliai;2686827560;Taip;0;0;3;3
21638;Volungė;Drugeliai;9973604148;Taip;0;0;1;1
21639;Volungė;Drugeliai;8905401944;Taip;21;0;0;21
21640;Volungė;Drugeliai;1164632050;Taip;0;1;0;1
21641;Volungė;Drugeliai;2923810441;Ne;6;0;0;6
21642;Volungė;Drugeliai;6782622442;Taip;6;0;6;12
21643;Volungė;Drugeliai;3020629341;Taip;0;0;1;1
21644;Volungė;Drugeliai;4252713086;Taip;0;1;1;2
21645;Volungė;Drugeliai;2530804242;Taip;0;0;1;1
21646;Volungė;Drugeliai;5354511593;Taip;6;0;0;6
21647;Volungė;Drugeliai;9343118795;Taip;2;0;1;3
21648;Volungė;Drugeliai;4745609424;Ne;6;0;11;17
21649;Volungė;Drugeliai;7584598377;Taip;10;1;0;11
21650;Volungė;"SKRUZDĖLIUKAI ";3394646139;Taip;12;6;0;18
21651;Volungė;"SKRUZDĖLIUKAI ";4223287277;Taip;3;0;0;3
21652;Volungė;"SKRUZDĖLIUKAI ";6464890465;Taip;12;0;1;13
21653;Volungė;"SKRUZDĖLIUKAI ";2493541457;Taip;7;0;9;16
21654;Volungė;"SKRUZDĖLIUKAI ";1948015523;Ne;0;0;2;2
21655;Volungė;"SKRUZDĖLIUKAI ";1101228927;Taip;7;0;0;7
21656;Volungė;"SKRUZDĖLIUKAI ";5332306628;Taip;0;0;11;11
21657;Volungė;"SKRUZDĖLIUKAI ";9319825151;Ne;5;0;2;7
21658;Volungė;"SKRUZDĖLIUKAI ";6370584522;Taip;0;2;0;2
21659;Volungė;"SKRUZDĖLIUKAI ";8168630107;Taip;0;0;8;8
21660;Volungė;"SKRUZDĖLIUKAI ";8992514683;Taip;8;5;1;14
21661;Volungė;"SKRUZDĖLIUKAI ";5833091791;Taip;0;0;2;2
21662;Volungė;"SKRUZDĖLIUKAI ";5994884455;Ne;3;0;1;4
21663;Volungė;"SKRUZDĖLIUKAI ";3818924175;Taip;17;0;2;19
21664;Volungė;"SKRUZDĖLIUKAI ";8244731771;Taip;0;1;4;5
21665;Volungė;"SKRUZDĖLIUKAI ";6110117105;Taip;0;0;7;7
21666;Volungė;"SKRUZDĖLIUKAI ";4944556574;Taip;0;0;15;15
21667;Volungė;"SKRUZDĖLIUKAI ";2212423676;Taip;6;0;6;12
21668;Volungė;"SKRUZDĖLIUKAI ";5942497397;Taip;21;0;0;21
21669;Volungė;"SKRUZDĖLIUKAI ";4991465781;Taip;0;0;1;1
21670;Volungė;"SKRUZDĖLIUKAI ";8613580206;Taip;6;1;0;7
21671;Volungė;Zylutės;6127398531;Taip;0;1;1;2
21672;Volungė;Zylutės;4664635246;Ne;6;0;10;16
21673;Volungė;Zylutės;9382043452;Taip;0;0;4;4
21674;Volungė;Zylutės;1125730734;Taip;0;0;4;4
21675;Volungė;Zylutės;5650558154;Taip;15;0;0;15
21676;Volungė;Zylutės;5588544003;Taip;9;1;0;10
21677;Volungė;Zylutės;3758750922;Taip;10;0;8;18
21678;Volungė;Zylutės;2663288986;Taip;11;0;0;11
21679;Volungė;Zylutės;3460701723;Taip;4;0;2;6
21680;Volungė;Zylutės;9562426487;Taip;6;4;0;10
21681;Volungė;Zylutės;4136178027;Taip;10;1;0;11
21682;Volungė;Zylutės;5882826586;Ne;3;9;0;12
21683;Volungė;Zylutės;6969633765;Taip;0;0;5;5
21684;Volungė;Zylutės;6445614647;Taip;7;0;1;8
21685;Volungė;Zylutės;5561683986;Taip;6;0;5;11
21686;Volungė;Zylutės;5338942678;Taip;16;0;0;16
21687;Volungė;Zylutės;8987748481;Taip;0;0;6;6
21688;Giliukas;SMALSUČIAI;9134734376;Taip;10;0;0;10
21689;Giliukas;SMALSUČIAI;3728323646;Taip;20;0;0;20
21690;Giliukas;SMALSUČIAI;6742406486;Taip;1;0;0;1
21691;Giliukas;SMALSUČIAI;9556962586;Ne;5;0;0;5
21692;Giliukas;SMALSUČIAI;2840410579;Taip;6;0;2;8
21693;Giliukas;SMALSUČIAI;2378721717;Taip;0;0;2;2
21694;Giliukas;SMALSUČIAI;7316126011;Taip;11;0;3;14
21695;Giliukas;SMALSUČIAI;6489845832;Taip;9;0;0;9
21696;Giliukas;SMALSUČIAI;6203352124;Taip;17;0;0;17
21697;Giliukas;SMALSUČIAI;9704885611;Taip;6;1;2;9
21698;Giliukas;SMALSUČIAI;7993049824;Ne;7;2;0;9
21699;Giliukas;SMALSUČIAI;2700296404;Taip;3;0;0;3
21700;Giliukas;SMALSUČIAI;7412960823;Ne;9;1;0;10
21701;Giliukas;SMALSUČIAI;9160815037;Taip;3;0;0;3
21702;Giliukas;SMALSUČIAI;5452941895;Taip;0;0;4;4
21703;Giliukas;SMALSUČIAI;3819765572;Ne;10;0;0;10
21704;Giliukas;SMALSUČIAI;2787116787;Taip;3;4;0;7
21705;Giliukas;SMALSUČIAI;4347883309;Taip;3;0;0;3
21706;Giliukas;GUDRUČIAI;2335031800;Taip;0;1;0;1
21707;Giliukas;GUDRUČIAI;3847358328;Taip;0;2;0;2
21708;Giliukas;GUDRUČIAI;6165618131;Ne;11;6;0;17
21709;Giliukas;GUDRUČIAI;9608331265;Taip;0;3;0;3
21710;Giliukas;GUDRUČIAI;3691791222;Taip;0;1;0;1
21711;Giliukas;GUDRUČIAI;1870173947;Taip;2;1;1;4
21712;Giliukas;GUDRUČIAI;9644050818;Taip;18;1;0;19
21713;Giliukas;GUDRUČIAI;3252419072;Ne;0;1;1;2
21714;Giliukas;GUDRUČIAI;3983555939;Taip;0;2;0;2
21715;Giliukas;GUDRUČIAI;2951628295;Ne;0;3;0;3
21716;Giliukas;GUDRUČIAI;9408948207;Taip;0;8;0;8
21717;Giliukas;GUDRUČIAI;2003990493;Taip;0;3;4;7
21718;Giliukas;GUDRUČIAI;4960232685;Taip;0;1;0;1
21719;Giliukas;GUDRUČIAI;4916844983;Taip;0;1;1;2
21720;Giliukas;GUDRUČIAI;5787041097;Taip;3;2;0;5
21721;Giliukas;GUDRUČIAI;9458151965;Taip;0;1;1;2
21722;Giliukas;GUDRUČIAI;7159681896;Taip;0;1;1;2
21723;Giliukas;GUDRUČIAI;6942029629;Taip;4;2;0;6
21724;Giliukas;PABIRUČIAI;4183026763;Taip;3;0;0;3
21725;Giliukas;PABIRUČIAI;1221640023;Taip;0;0;1;1
21726;Giliukas;PABIRUČIAI;2362785562;Ne;6;0;6;12
21727;Giliukas;PABIRUČIAI;4247090684;Taip;0;0;6;6
21728;Giliukas;PABIRUČIAI;9824315755;Taip;6;4;6;16
21729;Giliukas;PABIRUČIAI;2379370477;Taip;0;0;1;1
21730;Giliukas;PABIRUČIAI;3054591644;Taip;0;0;1;1
21731;Giliukas;PABIRUČIAI;3870143024;Taip;10;0;1;11
21732;Giliukas;PABIRUČIAI;6914013230;Taip;0;0;3;3
21733;Giliukas;PABIRUČIAI;2512831288;Taip;10;0;2;12
21734;Giliukas;PABIRUČIAI;7013767174;Taip;2;0;0;2
21735;Giliukas;PABIRUČIAI;4810236703;Ne;1;0;1;2
21736;Giliukas;PABIRUČIAI;4105974682;Taip;4;0;1;5
21737;Giliukas;PABIRUČIAI;8874804636;Taip;9;0;0;9
21738;Giliukas;ŠVELNUKAI;7402797271;Taip;16;0;0;16
21739;Giliukas;ŠVELNUKAI;3839624551;Ne;0;0;1;1
21740;Giliukas;ŠVELNUKAI;2012365132;Taip;0;0;6;6
21741;Giliukas;ŠVELNUKAI;9270743786;Taip;0;0;2;2
21742;Giliukas;ŠVELNUKAI;1710286878;Taip;0;0;6;6
21743;Giliukas;ŠVELNUKAI;4565216956;Taip;5;0;2;7
21744;Giliukas;ŠVELNUKAI;5834233526;Taip;7;0;1;8
21745;Giliukas;ŠVELNUKAI;5000654626;Taip;1;0;0;1
21746;Giliukas;ŠVELNUKAI;8973584424;Taip;3;0;2;5
21747;Giliukas;ŠVELNUKAI;9679421414;Taip;10;0;2;12
21748;Giliukas;ŠVELNUKAI;2881704755;Taip;13;0;2;15
21749;Giliukas;ŠVELNUKAI;3238820351;Taip;13;0;1;14
21750;Giliukas;ŠVELNUKAI;4340602792;Taip;0;0;2;2
21751;Giliukas;ŠVELNUKAI;2229737837;Taip;0;0;7;7
21752;Giliukas;ŽINIUKAI;6422178450;Taip;0;1;0;1
21753;Giliukas;ŽINIUKAI;2502801547;Taip;10;3;0;13
21754;Giliukas;ŽINIUKAI;9617542456;Taip;0;1;0;1
21755;Giliukas;ŽINIUKAI;2562809633;Taip;0;3;0;3
21756;Giliukas;ŽINIUKAI;5326178821;Ne;8;3;0;11
21757;Giliukas;ŽINIUKAI;2692141913;Taip;9;1;1;11
21758;Giliukas;ŽINIUKAI;9152432124;Taip;11;0;0;11
21759;Giliukas;ŽINIUKAI;4854370266;Taip;0;3;0;3
21760;Giliukas;ŽINIUKAI;6703080106;Taip;11;1;0;12
21761;Giliukas;ŽINIUKAI;6956862865;Taip;0;2;0;2
21762;Giliukas;ŽINIUKAI;3150981084;Ne;3;2;0;5
21763;Giliukas;ŽINIUKAI;6134554678;Taip;6;5;0;11
21764;Giliukas;ŽINIUKAI;6338583515;Taip;0;2;0;2
21765;Giliukas;ŽINIUKAI;2064182165;Taip;0;0;1;1
21766;Giliukas;ŽINIUKAI;5201020765;Taip;20;1;0;21
21767;Giliukas;ŽINIUKAI;2042324002;Taip;0;1;0;1
21768;Giliukas;ŽINIUKAI;3137768675;Taip;15;1;0;16
21769;Giliukas;ŽINIUKAI;3718774263;Taip;12;0;1;13
21770;Giliukas;MYLIMUKAI;7205807049;Taip;16;2;1;19
21771;Giliukas;MYLIMUKAI;1165810193;Taip;16;2;1;19
21772;Giliukas;MYLIMUKAI;3055598917;Taip;0;2;3;5
21773;Giliukas;MYLIMUKAI;6953123617;Taip;0;3;0;3
21774;Giliukas;MYLIMUKAI;4207939009;Taip;0;0;3;3
21775;Giliukas;MYLIMUKAI;2742106493;Taip;0;6;5;11
21776;Giliukas;MYLIMUKAI;1916905497;Taip;1;2;1;4
21777;Giliukas;MYLIMUKAI;7053406257;Taip;11;3;2;16
21778;Giliukas;MYLIMUKAI;5222092567;Taip;7;1;0;8
21779;Giliukas;MYLIMUKAI;4581414740;Ne;0;2;4;6
21780;Giliukas;MYLIMUKAI;2226855971;Taip;0;6;8;14
21781;Giliukas;MYLIMUKAI;7431116067;Taip;6;0;6;12
21782;Giliukas;MYLIMUKAI;6748766233;Taip;10;0;1;11
21783;Giliukas;MYLIMUKAI;5298822890;Taip;9;2;0;11
21784;Giliukas;MYLIMUKAI;3726149759;Taip;7;2;1;10
21785;Giliukas;MYLIMUKAI;5300517567;Ne;0;7;0;7
21786;Giliukas;MYLIMUKAI;5625404051;Taip;9;0;3;12
21787;Giliukas;MYLIMUKAI;9224387185;Taip;0;21;0;21
21788;Giliukas;ČIAUŠKUČIAI;1762536884;Taip;10;1;0;11
21789;Giliukas;ČIAUŠKUČIAI;8701216181;Taip;6;2;1;9
21790;Giliukas;ČIAUŠKUČIAI;7646966187;Taip;6;1;0;7
21791;Giliukas;ČIAUŠKUČIAI;2801731379;Taip;0;8;0;8
21792;Giliukas;ČIAUŠKUČIAI;8499893356;Ne;15;2;0;17
21793;Giliukas;ČIAUŠKUČIAI;9205911152;Taip;4;0;0;4
21794;Giliukas;ČIAUŠKUČIAI;3720032249;Taip;4;0;0;4
21795;Giliukas;ČIAUŠKUČIAI;3659105022;Taip;0;6;1;7
21796;Giliukas;ČIAUŠKUČIAI;4940718205;Ne;6;0;0;6
21797;Giliukas;ČIAUŠKUČIAI;8491008130;Ne;11;1;0;12
21798;Giliukas;ČIAUŠKUČIAI;4163383707;Taip;6;2;0;8
21799;Giliukas;ČIAUŠKUČIAI;2612551188;Taip;1;0;0;1
21800;Giliukas;ČIAUŠKUČIAI;9366734581;Ne;11;0;0;11
21801;Giliukas;ČIAUŠKUČIAI;9462634699;Taip;3;2;0;5
21802;Giliukas;ČIAUŠKUČIAI;8106782330;Taip;13;0;8;21
21803;Giliukas;ČIAUŠKUČIAI;9274289812;Taip;1;0;0;1
21804;Giliukas;ČIAUŠKUČIAI;1332725572;Taip;8;4;0;12
21805;Giliukas;ŠNEKUČIAI;9229086918;Taip;5;0;3;8
21806;Giliukas;ŠNEKUČIAI;3274313536;Ne;0;1;0;1
21807;Giliukas;ŠNEKUČIAI;9287193955;Taip;9;2;0;11
21808;Giliukas;ŠNEKUČIAI;5527212334;Taip;10;0;1;11
21809;Giliukas;ŠNEKUČIAI;2099575372;Taip;0;0;4;4
21810;Giliukas;ŠNEKUČIAI;6157459742;Ne;0;11;0;11
21811;Giliukas;ŠNEKUČIAI;4258921446;Taip;7;0;0;7
21812;Giliukas;ŠNEKUČIAI;1439350058;Taip;5;0;1;6
21813;Giliukas;ŠNEKUČIAI;4843920452;Taip;10;0;1;11
21814;Giliukas;ŠNEKUČIAI;8977247073;Taip;0;0;1;1
21815;Giliukas;ŠNEKUČIAI;8147492951;Taip;0;0;3;3
21816;Giliukas;ŠNEKUČIAI;2349166172;Taip;6;0;0;6
21817;Giliukas;ŠNEKUČIAI;8241215831;Taip;8;0;0;8
21818;Giliukas;ŠNEKUČIAI;9475918013;Taip;0;0;1;1
21819;Giliukas;ŠNEKUČIAI;7944198886;Taip;18;0;0;18
21820;"Lazdynų mokykla (Žėručio g. 4)";Drugeliai;4520091712;Taip;4;0;0;4
21821;"Lazdynų mokykla (Žėručio g. 4)";Drugeliai;8472834181;Taip;6;2;0;8
21822;"Lazdynų mokykla (Žėručio g. 4)";Drugeliai;9196184984;Taip;1;0;0;1
21823;"Lazdynų mokykla (Žėručio g. 4)";Drugeliai;6394098306;Taip;0;0;13;13
21824;"Lazdynų mokykla (Žėručio g. 4)";Drugeliai;2027751624;Taip;0;1;0;1
21825;"Lazdynų mokykla (Žėručio g. 4)";Drugeliai;2767732459;Ne;0;8;0;8
21826;"Lazdynų mokykla (Žėručio g. 4)";Drugeliai;5902104981;Taip;0;4;0;4
21827;"Lazdynų mokykla (Žėručio g. 4)";Drugeliai;7590111138;Taip;6;2;0;8
21828;"Lazdynų mokykla (Žėručio g. 4)";Drugeliai;7524849851;Taip;1;0;0;1
21829;"Lazdynų mokykla (Žėručio g. 4)";Drugeliai;1951041742;Ne;0;5;0;5
21830;"Lazdynų mokykla (Žėručio g. 4)";Drugeliai;9309081745;Taip;2;0;1;3
21831;"Lazdynų mokykla (Žėručio g. 4)";Drugeliai;8650496265;Taip;0;1;1;2
21832;"Lazdynų mokykla (Žėručio g. 4)";Drugeliai;8001610972;Ne;5;3;0;8
21833;"Lazdynų mokykla (Žėručio g. 4)";Drugeliai;4684618253;Taip;15;0;0;15
21834;"Lazdynų mokykla (Žėručio g. 4)";Drugeliai;6658025277;Ne;9;0;0;9
21835;"Lazdynų mokykla (Žėručio g. 4)";Drugeliai;7074859809;Taip;14;2;0;16
21836;"Lazdynų mokykla (Žėručio g. 4)";Drugeliai;4097980299;Ne;5;3;0;8
21837;"Lazdynų mokykla (Žėručio g. 4)";Drugeliai;1365362641;Taip;0;1;0;1
21838;"Lazdynų mokykla (Žėručio g. 4)";Zuikučiai;3435025978;Taip;11;0;1;12
21839;"Lazdynų mokykla (Žėručio g. 4)";Zuikučiai;8899186547;Taip;3;0;5;8
21840;"Lazdynų mokykla (Žėručio g. 4)";Zuikučiai;5465094647;Taip;0;5;0;5
21841;"Lazdynų mokykla (Žėručio g. 4)";Zuikučiai;1044630813;Taip;0;1;0;1
21842;"Lazdynų mokykla (Žėručio g. 4)";Zuikučiai;3535244441;Taip;0;1;4;5
21843;"Lazdynų mokykla (Žėručio g. 4)";Zuikučiai;1336503878;Ne;1;1;0;2
21844;"Lazdynų mokykla (Žėručio g. 4)";Zuikučiai;5181200460;Taip;1;0;1;2
21845;"Lazdynų mokykla (Žėručio g. 4)";Zuikučiai;8669630986;Ne;2;1;0;3
21846;"Lazdynų mokykla (Žėručio g. 4)";Zuikučiai;4166599533;Taip;0;0;3;3
21847;"Lazdynų mokykla (Žėručio g. 4)";Zuikučiai;3715070791;Taip;0;2;1;3
21848;"Lazdynų mokykla (Žėručio g. 4)";Zuikučiai;7232402011;Taip;0;4;0;4
21849;"Lazdynų mokykla (Žėručio g. 4)";Zuikučiai;7229926614;Taip;14;0;1;15
21850;"Lazdynų mokykla (Žėručio g. 4)";Zuikučiai;2624013880;Taip;2;0;3;5
21851;"Lazdynų mokykla (Žėručio g. 4)";RUPG;6038907328;Taip;1;1;1;3
21852;"Lazdynų mokykla (Žėručio g. 4)";RUPG;4086774324;Taip;0;21;0;21
21853;"Lazdynų mokykla (Žėručio g. 4)";RUPG;6070629454;Taip;0;21;0;21
21854;"Lazdynų mokykla (Žėručio g. 4)";RUPG;1118653070;Ne;0;6;0;6
21855;"Lazdynų mokykla (Žėručio g. 4)";RUPG;3367804873;Ne;0;1;2;3
21856;"Lazdynų mokykla (Žėručio g. 4)";RUPG;5806696915;Taip;0;1;1;2
21857;"Lazdynų mokykla (Žėručio g. 4)";RUPG;2209697834;Taip;0;21;0;21
21858;"Lazdynų mokykla (Žėručio g. 4)";RUPG;6638804854;Ne;0;21;0;21
21859;"Lazdynų mokykla (Žėručio g. 4)";RUPG;3634678954;Taip;0;6;0;6
21860;"Lazdynų mokykla (Žėručio g. 4)";RUPG;1910570858;Taip;0;4;0;4
21861;"Lazdynų mokykla (Žėručio g. 4)";RUPG;8318567916;Taip;0;2;0;2
21862;"Lazdynų mokykla (Žėručio g. 4)";RUPG;5982019255;Taip;10;1;0;11
21863;"Lazdynų mokykla (Žėručio g. 4)";RUPG;2160440145;Taip;0;1;0;1
21864;"Lazdynų mokykla (Žėručio g. 4)";RUPG;1025406111;Taip;0;1;2;3
21865;"Lazdynų mokykla (Žėručio g. 4)";RUPG;5095782784;Taip;13;1;0;14
21866;"Lazdynų mokykla (Žėručio g. 4)";LEPG;9656050113;Ne;0;1;0;1
21867;"Lazdynų mokykla (Žėručio g. 4)";LEPG;6822686126;Taip;5;1;0;6
21868;"Lazdynų mokykla (Žėručio g. 4)";LEPG;2070196225;Taip;0;1;0;1
21869;"Lazdynų mokykla (Žėručio g. 4)";LEPG;2613078582;Taip;0;2;0;2
21870;"Lazdynų mokykla (Žėručio g. 4)";LEPG;7059075747;Taip;7;1;0;8
21871;"Lazdynų mokykla (Žėručio g. 4)";LEPG;5438716880;Taip;0;1;0;1
21872;"Lazdynų mokykla (Žėručio g. 4)";LEPG;7487278074;Taip;0;1;4;5
21873;"Lazdynų mokykla (Žėručio g. 4)";LEPG;7320049068;Taip;0;1;3;4
21874;"Lazdynų mokykla (Žėručio g. 4)";LEPG;1396367371;Taip;6;1;3;10
21875;"Lazdynų mokykla (Žėručio g. 4)";LEPG;7324846434;Taip;0;1;1;2
21876;"Lazdynų mokykla (Žėručio g. 4)";LEPG;1532248269;Taip;0;1;0;1
21877;"Lazdynų mokykla (Žėručio g. 4)";LEPG;3675401775;Taip;0;1;0;1
21878;"Lazdynų mokykla (Žėručio g. 4)";LEPG;6794153377;Taip;5;1;2;8
21879;"Lazdynų mokykla (Žėručio g. 4)";LEPG;2825614921;Ne;11;1;0;12
21880;"Lazdynų mokykla (Žėručio g. 4)";LEPG;8866490265;Ne;0;1;6;7
21881;"Lazdynų mokykla (Žėručio g. 4)";LEPG;9592456683;Taip;0;1;2;3
21882;"Lazdynų mokykla (Žėručio g. 4)";LEPG;6117542654;Taip;0;1;0;1
21883;"Lazdynų mokykla (Žėručio g. 4)";LEPG;4149212470;Taip;7;1;0;8
21884;"Lazdynų mokykla (Žėručio g. 4)";LEPG;8324750958;Ne;0;1;1;2
21885;"Lazdynų mokykla (Žėručio g. 4)";LEPG;7659209862;Taip;15;1;0;16
21886;"Lazdynų mokykla (Žėručio g. 4)";RUPG;3631150576;Taip;0;1;0;1
21887;"Lazdynų mokykla (Žėručio g. 4)";RUPG;5015519090;Taip;10;1;0;11
21888;"Lazdynų mokykla (Žėručio g. 4)";RUPG;1745679183;Taip;0;1;0;1
21889;"Lazdynų mokykla (Žėručio g. 4)";RUPG;9255723192;Ne;3;1;2;6
21890;"Lazdynų mokykla (Žėručio g. 4)";RUPG;9639587601;Taip;0;1;0;1
21891;"Lazdynų mokykla (Žėručio g. 4)";RUPG;4087148273;Taip;0;1;1;2
21892;"Lazdynų mokykla (Žėručio g. 4)";RUPG;2740942924;Taip;0;1;2;3
21893;"Lazdynų mokykla (Žėručio g. 4)";RUPG;2700475528;Taip;0;1;1;2
21894;"Lazdynų mokykla (Žėručio g. 4)";RUPG;7180617984;Ne;0;1;0;1
21895;"Lazdynų mokykla (Žėručio g. 4)";RUPG;4023257875;Taip;0;1;0;1
21896;"Lazdynų mokykla (Žėručio g. 4)";RUPG;2308739823;Taip;0;1;0;1
21897;"Lazdynų mokykla (Žėručio g. 4)";RUPG;9123178095;Taip;0;3;0;3
21898;"Lazdynų mokykla (Žėručio g. 4)";RUPG;3000676765;Taip;0;1;2;3
21899;"Lazdynų mokykla (Žėručio g. 4)";RUPG;9968637187;Taip;5;1;0;6
21900;"Lazdynų mokykla (Žėručio g. 4)";RUPG;8886654664;Taip;20;1;0;21
21901;Santariškių;Vyšniukai;9819079431;Taip;20;0;0;20
21902;Santariškių;Vyšniukai;8749265990;Taip;20;0;0;20
21903;"Vilnios pagrindinė mokykla";EŽIUKAI;5939264188;Taip;10;0;0;10
21904;"„Atžalyno” mokykla-darželis";Giliukai;1209960122;Taip;0;0;1;1
21905;"„Atžalyno” mokykla-darželis";Giliukai;1579954367;Taip;0;1;0;1
21906;"„Atžalyno” mokykla-darželis";Giliukai;9655000018;Taip;3;1;0;4
21907;"„Atžalyno” mokykla-darželis";Giliukai;8826921260;Ne;3;1;0;4
21908;"„Atžalyno” mokykla-darželis";Giliukai;2773253032;Taip;7;1;0;8
21909;"„Atžalyno” mokykla-darželis";Giliukai;3170216428;Taip;0;1;1;2
21910;"„Atžalyno” mokykla-darželis";Giliukai;2772290605;Taip;0;1;1;2
21911;"„Atžalyno” mokykla-darželis";Giliukai;5596753512;Taip;0;1;2;3
21912;"„Atžalyno” mokykla-darželis";Giliukai;1958519966;Ne;11;1;1;13
21913;"„Atžalyno” mokykla-darželis";Giliukai;9806203065;Ne;0;1;2;3
21914;"„Atžalyno” mokykla-darželis";Giliukai;8688627865;Ne;0;1;0;1
21915;"„Atžalyno” mokykla-darželis";Giliukai;2601122166;Taip;13;0;0;13
21916;"„Atžalyno” mokykla-darželis";Giliukai;3529875728;Taip;10;1;1;12
21917;"„Atžalyno” mokykla-darželis";Giliukai;1311162040;Taip;0;1;0;1
21918;"„Atžalyno” mokykla-darželis";Giliukai;4427232735;Taip;0;1;11;12
21919;"„Atžalyno” mokykla-darželis";Giliukai;9013323901;Ne;16;1;1;18
21920;"„Atžalyno” mokykla-darželis";Giliukai;5503766544;Taip;0;1;0;1
21921;"„Atžalyno” mokykla-darželis";Giliukai;9215658103;Taip;4;0;0;4
21922;"„Atžalyno” mokykla-darželis";Giliukai;5030879885;Taip;15;1;0;16
21923;"„Atžalyno” mokykla-darželis";Giliukai;3484401937;Taip;2;1;6;9
21924;"„Atžalyno” mokykla-darželis";Riešutėliai;4360099345;Taip;10;5;0;15
21925;"„Atžalyno” mokykla-darželis";Riešutėliai;5947938371;Ne;15;0;6;21
21926;"„Atžalyno” mokykla-darželis";Riešutėliai;5384245347;Taip;0;6;0;6
21927;"„Atžalyno” mokykla-darželis";Riešutėliai;4246430352;Taip;18;0;1;19
21928;"„Atžalyno” mokykla-darželis";Riešutėliai;8574494664;Ne;8;4;0;12
21929;"„Atžalyno” mokykla-darželis";Riešutėliai;5815412814;Taip;8;2;0;10
21930;"„Atžalyno” mokykla-darželis";Riešutėliai;4161658496;Ne;9;1;0;10
21931;"„Atžalyno” mokykla-darželis";Riešutėliai;8942132574;Taip;12;2;0;14
21932;"„Atžalyno” mokykla-darželis";Riešutėliai;7109850241;Taip;0;13;0;13
21933;"„Atžalyno” mokykla-darželis";Riešutėliai;7368616441;Ne;7;0;6;13
21934;"„Atžalyno” mokykla-darželis";Riešutėliai;5242752663;Taip;3;0;0;3
21935;"„Atžalyno” mokykla-darželis";Riešutėliai;5709028342;Taip;17;0;0;17
21936;"„Atžalyno” mokykla-darželis";Riešutėliai;8803555426;Ne;5;1;1;7
21937;"„Atžalyno” mokykla-darželis";Riešutėliai;5994983369;Ne;8;1;0;9
21938;"„Atžalyno” mokykla-darželis";Riešutėliai;1041363325;Taip;0;1;14;15
21939;"„Atžalyno” mokykla-darželis";Riešutėliai;7676614240;Taip;0;0;1;1
21940;"„Atžalyno” mokykla-darželis";Riešutėliai;3751729666;Taip;6;0;5;11
21941;"„Atžalyno” mokykla-darželis";Riešutėliai;3441950153;Taip;12;0;4;16
21942;"„Atžalyno” mokykla-darželis";Riešutėliai;4223591454;Taip;0;1;4;5
21943;"„Atžalyno” mokykla-darželis";Žirniukai;6903825217;Taip;17;4;3;24
21944;"„Atžalyno” mokykla-darželis";Žirniukai;9101301819;Ne;4;0;6;10
21945;"„Atžalyno” mokykla-darželis";Žirniukai;6602037942;Taip;0;0;1;1
21946;"„Atžalyno” mokykla-darželis";Žirniukai;7579781779;Taip;0;7;0;7
21947;"„Atžalyno” mokykla-darželis";Žirniukai;1915676392;Ne;6;0;0;6
21948;"„Atžalyno” mokykla-darželis";Žirniukai;7669725276;Taip;3;9;0;12
21949;"„Atžalyno” mokykla-darželis";Žirniukai;5986664970;Taip;0;10;2;12
21950;"„Atžalyno” mokykla-darželis";Žirniukai;9913048992;Taip;0;12;2;14
21951;"„Atžalyno” mokykla-darželis";Žirniukai;4616870552;Taip;0;0;3;3
21952;"„Atžalyno” mokykla-darželis";Žirniukai;4107946143;Taip;0;6;1;7
21953;"„Atžalyno” mokykla-darželis";Žirniukai;7883570492;Ne;0;7;0;7
21954;"„Atžalyno” mokykla-darželis";Žirniukai;8320161812;Taip;17;3;0;20
21955;"„Atžalyno” mokykla-darželis";Žirniukai;5335059675;Taip;6;4;1;11
21956;"„Atžalyno” mokykla-darželis";Žirniukai;6922776405;Taip;0;1;15;16
21957;"„Atžalyno” mokykla-darželis";Žirniukai;9690554753;Taip;16;0;2;18
21958;"„Atžalyno” mokykla-darželis";Žirniukai;1961428224;Ne;13;0;4;17
21959;"„Atžalyno” mokykla-darželis";Žirniukai;8070499557;Taip;6;6;0;12
21960;"„Atžalyno” mokykla-darželis";Žirniukai;2446697763;Taip;4;0;9;13
21961;"„Atžalyno” mokykla-darželis";Žirniukai;2462839180;Taip;3;0;1;4
21962;"„Atžalyno” mokykla-darželis";Žirniukai;4784990018;Taip;18;6;0;24
21963;"„Atžalyno” mokykla-darželis";VYŠNIUKAI;6120955217;Ne;11;0;1;12
21964;"„Atžalyno” mokykla-darželis";VYŠNIUKAI;1787256844;Ne;15;1;3;19
21965;"„Atžalyno” mokykla-darželis";VYŠNIUKAI;2547003287;Ne;15;1;3;19
21966;"„Atžalyno” mokykla-darželis";VYŠNIUKAI;4503448206;Taip;7;1;0;8
21967;"„Atžalyno” mokykla-darželis";VYŠNIUKAI;3664056583;Taip;7;8;0;15
21968;"„Atžalyno” mokykla-darželis";VYŠNIUKAI;5456248305;Taip;15;0;1;16
21969;"„Atžalyno” mokykla-darželis";VYŠNIUKAI;3719072139;Taip;0;1;3;4
21970;"„Atžalyno” mokykla-darželis";VYŠNIUKAI;9245994735;Taip;13;10;0;23
21971;"„Atžalyno” mokykla-darželis";VYŠNIUKAI;3770167696;Taip;20;1;3;24
21972;"„Atžalyno” mokykla-darželis";VYŠNIUKAI;2000352986;Taip;8;0;1;9
21973;"„Atžalyno” mokykla-darželis";VYŠNIUKAI;2177213062;Taip;13;1;1;15
21974;"„Atžalyno” mokykla-darželis";VYŠNIUKAI;4635394632;Ne;15;1;0;16
21975;"„Atžalyno” mokykla-darželis";VYŠNIUKAI;3524131672;Taip;10;0;1;11
21976;"„Atžalyno” mokykla-darželis";VYŠNIUKAI;4840490901;Taip;15;1;3;19
21977;"„Atžalyno” mokykla-darželis";VYŠNIUKAI;4796052680;Taip;10;0;3;13
21978;"„Atžalyno” mokykla-darželis";VYŠNIUKAI;3181675972;Taip;8;0;2;10
21979;"„Atžalyno” mokykla-darželis";VYŠNIUKAI;8163063211;Taip;3;0;3;6
21980;"„Atžalyno” mokykla-darželis";VYŠNIUKAI;4431437971;Taip;22;1;1;24
21981;"„Atžalyno” mokykla-darželis";PIPIRIUKAI;8357021249;Ne;5;10;5;20
21982;"„Atžalyno” mokykla-darželis";PIPIRIUKAI;4582284727;Taip;0;1;0;1
21983;"„Atžalyno” mokykla-darželis";PIPIRIUKAI;4785607785;Ne;5;0;3;8
21984;"„Atžalyno” mokykla-darželis";PIPIRIUKAI;5615246040;Taip;0;0;4;4
21985;"„Atžalyno” mokykla-darželis";PIPIRIUKAI;1988657552;Taip;25;0;1;26
21986;"„Atžalyno” mokykla-darželis";PIPIRIUKAI;6721771665;Ne;15;1;0;16
21987;"„Atžalyno” mokykla-darželis";PIPIRIUKAI;7946139474;Taip;4;0;6;10
21988;"„Atžalyno” mokykla-darželis";PIPIRIUKAI;2921181385;Ne;5;0;6;11
21989;"„Atžalyno” mokykla-darželis";PIPIRIUKAI;2108706876;Taip;5;0;15;20
21990;"„Atžalyno” mokykla-darželis";PIPIRIUKAI;1228919159;Taip;13;5;0;18
21991;"„Atžalyno” mokykla-darželis";PIPIRIUKAI;3919301151;Taip;10;0;10;20
21992;"„Atžalyno” mokykla-darželis";PIPIRIUKAI;3624299098;Taip;0;5;2;7
21993;"„Atžalyno” mokykla-darželis";PIPIRIUKAI;2537063401;Taip;4;1;10;15
21994;"„Atžalyno” mokykla-darželis";PIPIRIUKAI;4166521512;Taip;14;0;0;14
21995;"„Atžalyno” mokykla-darželis";PIPIRIUKAI;8372179128;Taip;0;1;2;3
21996;"„Atžalyno” mokykla-darželis";PIPIRIUKAI;3204191459;Taip;10;8;0;18
21997;"„Atžalyno” mokykla-darželis";PIPIRIUKAI;5321475187;Taip;0;1;1;2
21998;"„Atžalyno” mokykla-darželis";PIPIRIUKAI;3015863723;Taip;16;4;0;20
21999;"„Atžalyno” mokykla-darželis";PIPIRIUKAI;3323233525;Taip;16;4;0;20
22000;"„Atžalyno” mokykla-darželis";PIPIRIUKAI;4596770586;Taip;17;1;0;18
22001;"„Atžalyno” mokykla-darželis";PIPIRIUKAI;7652421432;Taip;1;2;0;3
22002;"Vilniaus Naujininkų mokykla";"SAULĖS ZUIKUČIAI";1096474672;Taip;12;1;0;13
22003;"Vilniaus Naujininkų mokykla";"SAULĖS ZUIKUČIAI";9856315057;Ne;9;1;0;10
22004;"Vilniaus Naujininkų mokykla";"SAULĖS ZUIKUČIAI";6894804166;Taip;1;10;0;11
22005;"Vilniaus Naujininkų mokykla";"SAULĖS ZUIKUČIAI";3192556582;Taip;3;7;0;10
22006;"Vilniaus Naujininkų mokykla";"SAULĖS ZUIKUČIAI";1901250406;Ne;0;6;0;6
22007;"Vilniaus Naujininkų mokykla";"SAULĖS ZUIKUČIAI";9427388681;Taip;3;3;0;6
22008;"Vilniaus Naujininkų mokykla";"SAULĖS ZUIKUČIAI";5512321795;Taip;0;2;0;2
22009;"Vilniaus Naujininkų mokykla";"SAULĖS ZUIKUČIAI";9411054207;Ne;7;2;0;9
22010;"Vilniaus Naujininkų mokykla";"SAULĖS ZUIKUČIAI";3810550099;Taip;0;8;0;8
22011;"Vilniaus Naujininkų mokykla";"SAULĖS ZUIKUČIAI";7692387379;Taip;0;1;0;1
22012;"Vilniaus Naujininkų mokykla";"SAULĖS ZUIKUČIAI";8935072613;Taip;6;1;0;7
22013;"Vilniaus Naujininkų mokykla";"SAULĖS ZUIKUČIAI";9544088525;Ne;10;1;0;11
22014;"Vilniaus Naujininkų mokykla";"SAULĖS ZUIKUČIAI";9488762308;Taip;5;1;11;17
22015;"Vilniaus Naujininkų mokykla";"SAULĖS ZUIKUČIAI";2437553321;Ne;0;0;21;21
22016;"Vilniaus Naujininkų mokykla";"SAULĖS ZUIKUČIAI";5148002236;Taip;3;2;1;6
22017;"Vilniaus Naujininkų mokykla";SMALSUČIAI;2428447892;Taip;0;1;0;1
22018;"Vilniaus Naujininkų mokykla";SMALSUČIAI;1224054771;Taip;0;1;0;1
22019;"Vilniaus Naujininkų mokykla";SMALSUČIAI;79174984189;Taip;0;0;3;3
22020;"Vilniaus Naujininkų mokykla";SMALSUČIAI;1662993666;Taip;0;1;0;1
22021;"Vilniaus Naujininkų mokykla";SMALSUČIAI;7144596269;Ne;0;1;2;3
22022;"Vilniaus Naujininkų mokykla";SMALSUČIAI;6362889550;Taip;6;6;0;12
22023;"Vilniaus Naujininkų mokykla";SMALSUČIAI;1980755137;Taip;0;1;4;5
22024;"Vilniaus Naujininkų mokykla";SMALSUČIAI;1920917916;Taip;15;1;0;16
22025;"Vilniaus Naujininkų mokykla";SMALSUČIAI;8828658544;Ne;1;1;0;2
22026;"Vilniaus Naujininkų mokykla";SMALSUČIAI;5633127620;Taip;5;1;1;7
22027;"Vilniaus Naujininkų mokykla";SMALSUČIAI;3867799187;Taip;5;1;3;9
22028;"Vilniaus Naujininkų mokykla";SMALSUČIAI;1350744949;Taip;5;1;2;8
22029;"Vilniaus Naujininkų mokykla";SMALSUČIAI;63557632023;Taip;0;1;0;1
22030;"Vilniaus Naujininkų mokykla";SMALSUČIAI;8280826634;Ne;0;1;2;3
22031;"Vilniaus Naujininkų mokykla";SMALSUČIAI;5302103644;Ne;0;8;0;8
22032;"Vilniaus Naujininkų mokykla";SMALSUČIAI;5638817349;Taip;0;1;2;3
22033;"Vilniaus Naujininkų mokykla";SMALSUČIAI;1880254518;Taip;9;1;0;10
22034;"Vilniaus Karaliaus Mindaugo pagrindinė mokykla";"PUG 2";8957131694;Taip;2;0;0;2
22035;"Vilniaus Karaliaus Mindaugo pagrindinė mokykla";"PUG 2";1146561649;Taip;0;0;1;1
22036;"Vilniaus Karaliaus Mindaugo pagrindinė mokykla";"PUG 2";1159232792;Taip;13;0;0;13
22037;"Vilniaus Karaliaus Mindaugo pagrindinė mokykla";"PUG 2";1835450318;Taip;1;0;1;2
22038;"Vilniaus Karaliaus Mindaugo pagrindinė mokykla";"PUG 2";6754580614;Taip;1;0;1;2
22039;"Vilniaus Karaliaus Mindaugo pagrindinė mokykla";"PUG 2";2248658930;Taip;5;0;6;11
22040;"Vilniaus Karaliaus Mindaugo pagrindinė mokykla";"PUG 2";47454787439;Taip;0;0;2;2
22041;"Vilniaus Karaliaus Mindaugo pagrindinė mokykla";"PUG 2";2092637040;Taip;0;0;2;2
22042;"Vilniaus Karaliaus Mindaugo pagrindinė mokykla";"PUG 2";5029631107;Taip;0;1;6;7
22043;"Vilniaus Karaliaus Mindaugo pagrindinė mokykla";"PUG 2";6196554287;Taip;0;1;0;1
22044;"Vilniaus Karaliaus Mindaugo pagrindinė mokykla";"PUG 2";4661051023;Taip;0;1;2;3
22045;"Vilniaus Karaliaus Mindaugo pagrindinė mokykla";"PUG 2";1507200600;Taip;9;1;0;10
22046;"Vilniaus Karaliaus Mindaugo pagrindinė mokykla";"PUG 2";7440474403;Taip;6;0;1;7
22047;"Vilniaus Karaliaus Mindaugo pagrindinė mokykla";"PUG 2";8860314164;Taip;0;1;1;2
22048;"Vilniaus Karaliaus Mindaugo pagrindinė mokykla";"PUG 2";4684525618;Taip;4;0;0;4
22049;"Vilniaus Karaliaus Mindaugo pagrindinė mokykla";"PUG 2";2876837284;Ne;0;0;2;2
22050;"Vilniaus Karaliaus Mindaugo pagrindinė mokykla";"PUG 1";8879549409;Taip;0;0;6;6
22051;"Vilniaus Karaliaus Mindaugo pagrindinė mokykla";"PUG 1";3860781857;Taip;5;0;1;6
22052;"Vilniaus Karaliaus Mindaugo pagrindinė mokykla";"PUG 1";1904462840;Taip;0;1;0;1
22053;"Vilniaus Karaliaus Mindaugo pagrindinė mokykla";"PUG 1";24287759126;Taip;0;3;1;4
22054;"Vilniaus Karaliaus Mindaugo pagrindinė mokykla";"PUG 1";1781442182;Taip;1;0;2;3
22055;"Vilniaus Karaliaus Mindaugo pagrindinė mokykla";"PUG 1";6299298199;Taip;0;0;1;1
22056;"Vilniaus Karaliaus Mindaugo pagrindinė mokykla";"PUG 1";35830862363;Taip;0;0;1;1
22057;"Vilniaus Karaliaus Mindaugo pagrindinė mokykla";"PUG 1";1830572633;Taip;0;0;1;1
22058;"Vilniaus Karaliaus Mindaugo pagrindinė mokykla";"PUG 1";4143153535;Taip;6;0;1;7
22059;"Vilniaus Karaliaus Mindaugo pagrindinė mokykla";"PUG 1";9329518124;Taip;6;0;0;6
22060;"Vilniaus Karaliaus Mindaugo pagrindinė mokykla";"PUG 1";1505918280;Taip;0;0;7;7
22061;"Vilniaus Karaliaus Mindaugo pagrindinė mokykla";"PUG 1";1445657342;Taip;0;1;0;1
22062;"Vilniaus Karaliaus Mindaugo pagrindinė mokykla";"PUG 1";9313380552;Taip;3;1;0;4
22063;"Vilniaus Karaliaus Mindaugo pagrindinė mokykla";"PUG 1";7782678159;Ne;0;2;1;3
22064;"Vilniaus Karaliaus Mindaugo pagrindinė mokykla";"PUG 1";14043704729;Taip;3;0;1;4
22065;"Vilniaus Karaliaus Mindaugo pagrindinė mokykla";"PUG 1";7876029445;Taip;0;0;2;2
22066;"Vilniaus Karaliaus Mindaugo pagrindinė mokykla";"PUG 1";1376514473;Taip;6;0;2;8
22067;"Vilniaus Karaliaus Mindaugo pagrindinė mokykla";"PUG 1";7543795007;Taip;0;0;1;1
22068;"Vilniaus Karaliaus Mindaugo pagrindinė mokykla";"PUG 1";9522269582;Taip;0;1;1;2
22069;"Vilniaus Karaliaus Mindaugo pagrindinė mokykla";"PUG 3";1799477959;Taip;4;0;0;4
22070;"Vilniaus Karaliaus Mindaugo pagrindinė mokykla";"PUG 3";3490705425;Taip;0;0;2;2
22071;"Vilniaus Karaliaus Mindaugo pagrindinė mokykla";"PUG 3";7433354196;Ne;0;0;4;4
22072;"Vilniaus Karaliaus Mindaugo pagrindinė mokykla";"PUG 3";2836206893;Taip;6;0;1;7
22073;"Vilniaus Karaliaus Mindaugo pagrindinė mokykla";"PUG 3";38426234048;Taip;0;0;3;3
22074;"Vilniaus Karaliaus Mindaugo pagrindinė mokykla";"PUG 3";1502213914;Taip;0;0;4;4
22075;"Vilniaus Karaliaus Mindaugo pagrindinė mokykla";"PUG 3";1929838733;Taip;0;0;8;8
22076;"Vilniaus Karaliaus Mindaugo pagrindinė mokykla";"PUG 3";3344717003;Taip;8;0;0;8
22077;"Vilniaus Karaliaus Mindaugo pagrindinė mokykla";"PUG 3";9638976786;Taip;0;0;1;1
22078;"Vilniaus Karaliaus Mindaugo pagrindinė mokykla";"PUG 3";4677405885;Taip;2;0;0;2
22079;"Vilniaus Karaliaus Mindaugo pagrindinė mokykla";"PUG 3";6406285034;Taip;12;0;0;12
22080;"Vilniaus Karaliaus Mindaugo pagrindinė mokykla";"PUG 3";7132574496;Taip;0;0;6;6
22081;"Vilniaus Levo Karsavino vidurinė mokykla";PELEDŽIUKAI;2149830021;Taip;0;1;1;2
22082;"Vilniaus Levo Karsavino vidurinė mokykla";PELEDŽIUKAI;2718046390;Taip;5;1;1;7
22083;"Vilniaus Levo Karsavino vidurinė mokykla";PELEDŽIUKAI;9094287056;Taip;0;1;2;3
22084;"Vilniaus Levo Karsavino vidurinė mokykla";PELEDŽIUKAI;8721423900;Taip;0;1;1;2
22085;"Vilniaus Levo Karsavino vidurinė mokykla";PELEDŽIUKAI;6917007871;Taip;11;1;1;13
22086;"Vilniaus Levo Karsavino vidurinė mokykla";PELEDŽIUKAI;3452236805;Taip;0;21;0;21
22087;"Vilniaus Levo Karsavino vidurinė mokykla";PELEDŽIUKAI;4066969586;Taip;0;1;2;3
22088;"Vilniaus Levo Karsavino vidurinė mokykla";PELEDŽIUKAI;8564433463;Ne;0;1;0;1
22089;"Vilniaus Levo Karsavino vidurinė mokykla";PELEDŽIUKAI;1067737206;Taip;0;14;0;14
22090;"Vilniaus Levo Karsavino vidurinė mokykla";PELEDŽIUKAI;1288690113;Taip;0;3;0;3
22091;"Vilniaus Levo Karsavino vidurinė mokykla";PELEDŽIUKAI;55396452032;Taip;0;1;1;2
22092;"Vilniaus Levo Karsavino vidurinė mokykla";PELEDŽIUKAI;2276463136;Taip;0;1;0;1
22093;"Vilniaus Levo Karsavino vidurinė mokykla";PELEDŽIUKAI;43259107285;Taip;0;1;0;1
22094;"Vilniaus Levo Karsavino vidurinė mokykla";PELEDŽIUKAI;9947263640;Taip;12;1;1;14
22095;"Vilniaus Levo Karsavino vidurinė mokykla";PELEDŽIUKAI;3641595127;Taip;0;1;0;1
22096;"Vilniaus Levo Karsavino vidurinė mokykla";PELEDŽIUKAI;3254847545;Taip;0;21;0;21
22097;"Vilniaus Levo Karsavino vidurinė mokykla";PELEDŽIUKAI;3381954095;Taip;0;1;3;4
22098;"Vilniaus Levo Karsavino vidurinė mokykla";PELEDŽIUKAI;7227603702;Taip;0;1;1;2
22099;"Vilniaus Levo Karsavino vidurinė mokykla";PELEDŽIUKAI;57138305703;Taip;3;1;3;7
22100;"Vilniaus Levo Karsavino vidurinė mokykla";Žiniukai;3333990952;Taip;0;1;0;1
22101;"Vilniaus Levo Karsavino vidurinė mokykla";Žiniukai;5548875714;Taip;0;1;0;1
22102;"Vilniaus Levo Karsavino vidurinė mokykla";Žiniukai;5452659798;Taip;0;1;0;1
22103;"Vilniaus Levo Karsavino vidurinė mokykla";Žiniukai;5803032683;Taip;17;1;0;18
22104;"Vilniaus Levo Karsavino vidurinė mokykla";Žiniukai;2306517891;Taip;0;21;0;21
22105;"Vilniaus Levo Karsavino vidurinė mokykla";Žiniukai;1428614163;Taip;0;1;3;4
22106;"Vilniaus Levo Karsavino vidurinė mokykla";Žiniukai;9801214344;Ne;0;21;0;21
22107;"Vilniaus Levo Karsavino vidurinė mokykla";Žiniukai;8180889070;Taip;2;1;0;3
22108;"Vilniaus Levo Karsavino vidurinė mokykla";Žiniukai;7023565057;Taip;5;1;0;6
22109;"Vilniaus Levo Karsavino vidurinė mokykla";Žiniukai;2157398751;Taip;0;1;0;1
22110;"Vilniaus Levo Karsavino vidurinė mokykla";Žiniukai;7804533930;Taip;0;1;0;1
22111;"Vilniaus Levo Karsavino vidurinė mokykla";Žiniukai;3379725202;Taip;0;1;0;1
22112;"Vilniaus Levo Karsavino vidurinė mokykla";Žiniukai;7298260831;Taip;0;1;1;2
22113;"Vilniaus Levo Karsavino vidurinė mokykla";Žiniukai;4302751308;Taip;0;1;0;1
22114;"Vilniaus Levo Karsavino vidurinė mokykla";Žiniukai;7920182730;Taip;0;1;1;2
22115;"Vilniaus Levo Karsavino vidurinė mokykla";Žiniukai;12377363480;Taip;0;1;1;2
22116;"Vilniaus Levo Karsavino vidurinė mokykla";Žiniukai;8199573104;Taip;4;1;5;10
22117;"Vilniaus Levo Karsavino vidurinė mokykla";Žiniukai;9589810356;Taip;0;3;0;3
22118;"Vilniaus Levo Karsavino vidurinė mokykla";Žiniukai;64214150955;Taip;9;1;0;10
22119;"Vilniaus Levo Karsavino vidurinė mokykla";Žiniukai;6340289012;Ne;0;0;1;1
22120;"Vilniaus Liepkalnio Pagrindinė Mokykla";Bitutės;5597152556;Taip;5;1;1;7
22121;"Vilniaus Liepkalnio Pagrindinė Mokykla";Bitutės;4115995882;Ne;0;1;7;8
22122;"Vilniaus Liepkalnio Pagrindinė Mokykla";Bitutės;6136792125;Taip;5;1;1;7
22123;"Vilniaus Liepkalnio Pagrindinė Mokykla";Bitutės;9293634828;Taip;16;1;1;18
22124;"Vilniaus Liepkalnio Pagrindinė Mokykla";Bitutės;8324581018;Ne;9;1;1;11
22125;"Vilniaus Liepkalnio Pagrindinė Mokykla";Bitutės;1599633295;Taip;2;1;0;3
22126;"Vilniaus Liepkalnio Pagrindinė Mokykla";Bitutės;9589525954;Taip;4;1;0;5
22127;"Vilniaus Liepkalnio Pagrindinė Mokykla";Bitutės;7052487356;Taip;15;1;2;18
22128;"Vilniaus Liepkalnio Pagrindinė Mokykla";Bitutės;2080390421;Ne;9;1;5;15
22129;"Vilniaus Liepkalnio Pagrindinė Mokykla";Bitutės;5323726165;Taip;5;1;1;7
22130;"Vilniaus Liepkalnio Pagrindinė Mokykla";Bitutės;7922755136;Taip;5;1;5;11
22131;"Vilniaus Liepkalnio Pagrindinė Mokykla";Bitutės;1578956182;Taip;0;1;2;3
22132;"Vilniaus Liepkalnio Pagrindinė Mokykla";Bitutės;3721504364;Taip;0;1;0;1
22133;"Vilniaus Liepkalnio Pagrindinė Mokykla";Bitutės;1795366502;Taip;0;1;6;7
22134;"Vilniaus Liepkalnio Pagrindinė Mokykla";Bitutės;9211966929;Taip;0;1;3;4
22135;"Vilniaus Liepkalnio Pagrindinė Mokykla";Bitutės;4112888719;Taip;5;1;1;7
22136;"Vilniaus Liepkalnio Pagrindinė Mokykla";Bitutės;8809471063;Taip;4;1;4;9
22137;"Vilniaus Liepkalnio Pagrindinė Mokykla";Bitutės;5197037585;Ne;0;1;0;1
22138;"Vilniaus Liepkalnio Pagrindinė Mokykla";Bitutės;9771780358;Taip;0;1;8;9
22139;"Vilniaus Liepkalnio Pagrindinė Mokykla";Bitutės;4973569038;Taip;0;1;0;1
22140;"Vilniaus Pranciškaus Skorinos gimnazija";Saulytė;5194059497;Taip;1;2;6;9
22141;"Vilniaus Pranciškaus Skorinos gimnazija";Saulytė;5034268767;Taip;8;1;3;12
22142;"Vilniaus Pranciškaus Skorinos gimnazija";Saulytė;3036582121;Taip;0;2;0;2
22143;"Vilniaus Pranciškaus Skorinos gimnazija";Saulytė;5304082676;Ne;12;1;0;13
22144;"Vilniaus Pranciškaus Skorinos gimnazija";Saulytė;7055894770;Taip;3;2;0;5
22145;"Vilniaus Pranciškaus Skorinos gimnazija";Saulytė;6995285377;Ne;4;5;0;9
22146;"Vilniaus Pranciškaus Skorinos gimnazija";Saulytė;6336168033;Taip;0;1;0;1
22147;"Vilniaus Pranciškaus Skorinos gimnazija";Saulytė;3984446381;Taip;15;2;0;17
22148;"Vilniaus Pranciškaus Skorinos gimnazija";Saulytė;8641919789;Ne;6;1;1;8
22149;"Vilniaus Pranciškaus Skorinos gimnazija";Saulytė;5733610359;Taip;8;7;0;15
22150;"Vilniaus Pranciškaus Skorinos gimnazija";Saulytė;4501408366;Taip;14;1;0;15
22151;"Vilniaus Pranciškaus Skorinos gimnazija";Saulytė;4705514590;Ne;0;3;0;3
22152;"Vilniaus Pranciškaus Skorinos gimnazija";Saulytė;4165354124;Taip;3;3;0;6
22153;"Vilniaus Pranciškaus Skorinos gimnazija";Saulytė;6940231858;Ne;0;2;0;2
22154;"Vilniaus Pranciškaus Skorinos gimnazija";Saulytė;8572069816;Taip;3;2;0;5
22155;"Vilniaus Pranciškaus Skorinos gimnazija";Saulytė;4810459063;Taip;3;2;0;5
22156;"Vilniaus Pranciškaus Skorinos gimnazija";Saulytė;3354419392;Taip;0;29;0;29
22157;"Vilniaus Pranciškaus Skorinos gimnazija";Saulytė;9176198859;Ne;0;1;1;2
22158;"Vilniaus Pranciškaus Skorinos gimnazija";Saulytė;3234612149;Taip;13;7;0;20
22159;"Vilniaus Simono Konarskio mokykla";"1 GR.";1464992631;Taip;5;1;0;6
22160;"Vilniaus Simono Konarskio mokykla";"1 GR.";7375004714;Taip;0;1;0;1
22161;"Vilniaus Simono Konarskio mokykla";"1 GR.";9822287576;Taip;0;1;0;1
22162;"Vilniaus Simono Konarskio mokykla";"1 GR.";7052198958;Taip;0;1;0;1
22163;"Vilniaus Simono Konarskio mokykla";"1 GR.";1498329448;Taip;0;1;0;1
22164;"Vilniaus Simono Konarskio mokykla";"1 GR.";3593323270;Taip;0;1;0;1
22165;"Vilniaus Simono Konarskio mokykla";"1 GR.";4463822099;Ne;8;1;0;9
22166;"Vilniaus Simono Konarskio mokykla";"1 GR.";9079781265;Taip;10;1;0;11
22167;"Vilniaus Simono Konarskio mokykla";"1 GR.";1048630061;Taip;10;1;0;11
22168;"Vilniaus Simono Konarskio mokykla";"1 GR.";4286223155;Taip;0;1;0;1
22169;"Vilniaus Simono Konarskio mokykla";"1 GR.";5073378325;Taip;16;1;0;17
22170;"Vilniaus Simono Konarskio mokykla";"1 GR.";8552079735;Ne;0;1;0;1
22171;"Vilniaus Simono Konarskio mokykla";"1 GR.";9093492513;Ne;0;1;0;1
22172;"Vilniaus Simono Konarskio mokykla";"1 GR.";7701956270;Taip;0;1;0;1
22173;"Vilniaus Trakų Vokės gimnazija";Priešmokyklinė;9386629495;Taip;9;1;0;10
22174;"Vilniaus Trakų Vokės gimnazija";Priešmokyklinė;6209271043;Taip;0;1;4;5
22175;"Vilniaus Trakų Vokės gimnazija";Priešmokyklinė;3406479364;Taip;0;1;2;3
22176;"Vilniaus Trakų Vokės gimnazija";Priešmokyklinė;5526830430;Taip;0;2;1;3
22177;"Vilniaus Trakų Vokės gimnazija";Priešmokyklinė;4849992906;Taip;0;5;1;6
22178;"Vilniaus Trakų Vokės gimnazija";Priešmokyklinė;50553766116;Taip;0;1;0;1
22179;"Vilniaus Trakų Vokės gimnazija";Priešmokyklinė;8542147751;Taip;0;1;0;1
22180;"Vilniaus Trakų Vokės gimnazija";Priešmokyklinė;2672165297;Ne;5;0;12;17
22181;"Vilniaus Trakų Vokės gimnazija";Priešmokyklinė;2955411131;Taip;6;0;0;6
22182;"Vilniaus Trakų Vokės gimnazija";Priešmokyklinė;4846130117;Taip;0;1;2;3
22183;"Vilniaus Trakų Vokės gimnazija";Priešmokyklinė;1433982328;Taip;2;6;1;9
22184;"Vilniaus Trakų Vokės gimnazija";Priešmokyklinė;8658085249;Taip;0;1;2;3
22185;"Vilniaus Trakų Vokės gimnazija";Priešmokyklinė;39255784762;Taip;5;0;1;6
22186;"Vilniaus Trakų Vokės gimnazija";Priešmokyklinė;4599632235;Taip;0;0;3;3
22187;"Vilniaus Trakų Vokės gimnazija";Priešmokyklinė;2839396687;Taip;0;1;1;2
22188;"Vilniaus Trakų Vokės gimnazija";Priešmokyklinė;8857529726;Taip;0;11;4;15
22189;"Vilniaus Trakų Vokės gimnazija";Priešmokyklinė;7566567901;Taip;8;1;11;20
22190;"Vilniaus Trakų Vokės gimnazija";"Priešmokyklinė 2";4362066941;Taip;0;0;11;11
22191;"Vilniaus Trakų Vokės gimnazija";"Priešmokyklinė 2";1074730366;Ne;4;1;3;8
22192;"Vilniaus Trakų Vokės gimnazija";"Priešmokyklinė 2";6593654477;Taip;7;1;1;9
22193;"Vilniaus Trakų Vokės gimnazija";"Priešmokyklinė 2";9582511053;Taip;0;10;0;10
22194;"Vilniaus Trakų Vokės gimnazija";"Priešmokyklinė 2";3775081619;Taip;0;1;1;2
22195;"Vilniaus Trakų Vokės gimnazija";"Priešmokyklinė 2";4615315809;Taip;15;1;2;18
22196;"Vilniaus Trakų Vokės gimnazija";"Priešmokyklinė 2";25106446270;Taip;0;5;0;5
22197;"Vilniaus Trakų Vokės gimnazija";"Priešmokyklinė 2";18963190527;Taip;0;1;0;1
22198;"Vilniaus Trakų Vokės gimnazija";"Priešmokyklinė 2";4914675622;Taip;0;1;1;2
22199;"Vilniaus Trakų Vokės gimnazija";"Priešmokyklinė 2";5251929660;Taip;6;4;0;10
22200;"Vilniaus Trakų Vokės gimnazija";"Priešmokyklinė 2";3690179876;Taip;12;1;9;22
22201;"Vilniaus Trakų Vokės gimnazija";"Priešmokyklinė 2";8218370873;Ne;9;1;0;10
22202;"Vilniaus Trakų Vokės gimnazija";"Priešmokyklinė 2";6615724604;Taip;0;2;0;2
22203;"Vilniaus Trakų Vokės gimnazija";"Priešmokyklinė 2";4720226790;Taip;4;0;0;4
22204;"Vilniaus Trakų Vokės gimnazija";"Priešmokyklinė 2";1057189769;Taip;0;1;6;7
22205;"Vilniaus Trakų Vokės gimnazija";"Priešmokyklinė 2";2149804129;Ne;0;1;1;2
22206;"Vilniaus Trakų Vokės gimnazija";"Priešmokyklinė 2";1590598232;Taip;0;1;14;15
22207;"Vilniaus Trakų Vokės gimnazija";"Priešmokyklinė 2";8168960897;Ne;3;9;3;15
22208;"Vilniaus Trakų Vokės gimnazija";"Priešmokyklinė 2";9960520926;Ne;0;1;0;1
22209;"Vilniaus Trakų Vokės gimnazija";"Priešmokyklinė 2";9039274775;Taip;5;1;0;6
22210;"Vilniaus Trakų Vokės gimnazija";"Priešmokyklinė 3";7547303829;Taip;10;1;11;22
22211;"Vilniaus Trakų Vokės gimnazija";"Priešmokyklinė 3";2301758912;Taip;5;1;3;9
22212;"Vilniaus Trakų Vokės gimnazija";"Priešmokyklinė 3";7792654474;Taip;0;1;0;1
22213;"Vilniaus Trakų Vokės gimnazija";"Priešmokyklinė 3";3449317958;Taip;0;0;6;6
22214;"Vilniaus Trakų Vokės gimnazija";"Priešmokyklinė 3";9268558715;Taip;5;1;3;9
22215;"Vilniaus Trakų Vokės gimnazija";"Priešmokyklinė 3";9668538340;Taip;0;0;3;3
22216;"Vilniaus Trakų Vokės gimnazija";"Priešmokyklinė 3";2469486746;Taip;0;0;4;4
22217;"Vilniaus Trakų Vokės gimnazija";"Priešmokyklinė 3";95320712086;Taip;0;0;1;1
22218;"Vilniaus Trakų Vokės gimnazija";"Priešmokyklinė 3";1053286928;Taip;5;0;6;11
22219;"Vilniaus Trakų Vokės gimnazija";"Priešmokyklinė 3";5115117246;Ne;16;0;11;27
22220;"Vilniaus Trakų Vokės gimnazija";"Priešmokyklinė 3";6765094662;Taip;0;2;0;2
22221;"Vilniaus Trakų Vokės gimnazija";"Priešmokyklinė 3";6835150864;Taip;0;8;0;8
22222;"Vilniaus Trakų Vokės gimnazija";"Priešmokyklinė 3";1940148622;Taip;9;1;6;16
22223;"Vilniaus Trakų Vokės gimnazija";"Priešmokyklinė 3";9051697544;Ne;2;0;1;3
22224;"Vilniaus Trakų Vokės gimnazija";"Priešmokyklinė 3";1398572100;Taip;5;0;5;10
22225;"Vilniaus Trakų Vokės gimnazija";"Priešmokyklinė 3";2730385281;Taip;0;0;4;4
22226;"Vilniaus Trakų Vokės gimnazija";"Priešmokyklinė 3";2906094725;Ne;0;0;2;2
22227;"Vilniaus Trakų Vokės gimnazija";"Priešmokyklinė 3";9819489467;Ne;0;0;2;2
22228;"Vilniaus Salininkų gimnazija";"Priešmokyklinė A";22167560908;Taip;0;1;0;1
22229;"Vilniaus Salininkų gimnazija";"Priešmokyklinė A";10335028421;Taip;0;1;0;1
22230;"Vilniaus Salininkų gimnazija";"Priešmokyklinė A";8683841956;Taip;0;2;0;2
22231;"Vilniaus Salininkų gimnazija";"Priešmokyklinė A";1180792335;Taip;0;1;0;1
22232;"Vilniaus Salininkų gimnazija";"Priešmokyklinė A";5063792784;Taip;10;1;0;11
22233;"Vilniaus Salininkų gimnazija";"Priešmokyklinė A";1704033440;Taip;2;1;0;3
22234;"Vilniaus Salininkų gimnazija";"Priešmokyklinė A";46867660097;Taip;0;6;0;6
22235;"Vilniaus Salininkų gimnazija";"Priešmokyklinė A";3692008687;Taip;0;8;0;8
22236;"Vilniaus Salininkų gimnazija";"Priešmokyklinė A";2292919406;Taip;25;1;0;26
22237;"Vilniaus Salininkų gimnazija";"Priešmokyklinė A";35611320012;Taip;0;3;0;3
22238;"Vilniaus Salininkų gimnazija";"Priešmokyklinė A";4269202761;Taip;10;3;0;13
22239;"Vilniaus Salininkų gimnazija";"Priešmokyklinė A";9375550172;Taip;3;2;0;5
22240;"Vilniaus Salininkų gimnazija";"Priešmokyklinė A";7160091629;Taip;5;6;0;11
22241;"Vilniaus Salininkų gimnazija";"Priešmokyklinė A";41023354439;Taip;0;2;0;2
22242;"Vilniaus Salininkų gimnazija";"Priešmokyklinė A";1642658060;Taip;0;1;0;1
22243;"Vilniaus Salininkų gimnazija";"Priešmokyklinė A";3848448401;Taip;10;1;0;11
22244;"Vilniaus Salininkų gimnazija";"Priešmokyklinė A";3737786832;Ne;0;1;0;1
22245;"Vilniaus Salininkų gimnazija";"Priešmokyklinė A";8025611655;Taip;0;2;0;2
22246;"Vilniaus Salininkų gimnazija";"Priešmokyklinė A";4939261324;Taip;4;4;0;8
22247;"Vilniaus Salininkų gimnazija";"Priešmokyklinė A";6738902611;Taip;0;21;0;21
22248;"Vilniaus Salininkų gimnazija";"Priešmokyklinė A";2989580886;Taip;0;1;0;1
22249;"Vilniaus Salininkų gimnazija";"Priešmokyklinė A";3661928980;Taip;7;2;0;9
22250;"Vilniaus Salininkų gimnazija";"PRIEŠMOKYKLINĖ B";7378039370;Taip;0;1;0;1
22251;"Vilniaus Salininkų gimnazija";"PRIEŠMOKYKLINĖ B";98941037508;Taip;4;1;0;5
22252;"Vilniaus Salininkų gimnazija";"PRIEŠMOKYKLINĖ B";1355032282;Taip;0;1;0;1
22253;"Vilniaus Salininkų gimnazija";"PRIEŠMOKYKLINĖ B";8018093186;Ne;0;1;0;1
22254;"Vilniaus Salininkų gimnazija";"PRIEŠMOKYKLINĖ B";9216372353;Taip;0;1;0;1
22255;"Vilniaus Salininkų gimnazija";"PRIEŠMOKYKLINĖ B";3015424614;Taip;15;1;0;16
22256;"Vilniaus Salininkų gimnazija";"PRIEŠMOKYKLINĖ B";8488127476;Ne;5;1;0;6
22257;"Vilniaus Salininkų gimnazija";"PRIEŠMOKYKLINĖ B";8410624264;Taip;5;4;0;9
22258;"Vilniaus Salininkų gimnazija";"PRIEŠMOKYKLINĖ B";1544346282;Taip;0;1;0;1
22259;"Vilniaus Salininkų gimnazija";"PRIEŠMOKYKLINĖ B";2066091911;Taip;3;1;0;4
22260;"Vilniaus Salininkų gimnazija";"PRIEŠMOKYKLINĖ B";1723241116;Taip;2;1;0;3
22261;"Vilniaus Salininkų gimnazija";"PRIEŠMOKYKLINĖ B";30123603107;Taip;3;1;0;4
22262;"Vilniaus Salininkų gimnazija";"PRIEŠMOKYKLINĖ B";8659656902;Taip;0;1;0;1
22263;"Vilniaus Salininkų gimnazija";"PRIEŠMOKYKLINĖ B";8288199783;Taip;0;1;0;1
22264;"Vilniaus Salininkų gimnazija";"PRIEŠMOKYKLINĖ B";1065549119;Taip;9;1;0;10
22265;"Vilniaus Salininkų gimnazija";"PRIEŠMOKYKLINĖ B";1460694577;Taip;0;2;0;2
22266;"Vilniaus Salininkų gimnazija";"PRIEŠMOKYKLINĖ B";2786775879;Taip;8;2;0;10
22267;"Vilniaus Salininkų gimnazija";"PRIEŠMOKYKLINĖ B";5689344488;Taip;0;1;0;1
22268;"Vilniaus Salininkų gimnazija";"PRIEŠMOKYKLINĖ B";9513785510;Taip;3;1;0;4
22269;"Vilniaus Salininkų gimnazija";"PRIEŠMOKYKLINĖ B";91859774311;Taip;0;1;0;1
22270;"Vilniaus Salininkų gimnazija";"PRIEŠMOKYKLINĖ B";9026612929;Taip;0;2;0;2
22271;"Vilniaus „Spindulio“ progimnazija";PM2;3093606855;Taip;5;1;0;6
22272;"Vilniaus „Spindulio“ progimnazija";PM2;6304295422;Taip;0;1;1;2
22273;"Vilniaus „Spindulio“ progimnazija";PM2;5078945984;Taip;5;1;0;6
22274;"Vilniaus „Spindulio“ progimnazija";PM2;9099945815;Taip;0;1;0;1
22275;"Vilniaus „Spindulio“ progimnazija";PM2;75538036055;Taip;0;1;0;1
22276;"Vilniaus „Spindulio“ progimnazija";PM2;15583558585;Taip;12;1;0;13
22277;"Vilniaus „Spindulio“ progimnazija";PM2;2427349194;Ne;8;1;0;9
22278;"Vilniaus „Spindulio“ progimnazija";PM2;7445566160;Taip;0;1;1;2
22279;"Vilniaus „Spindulio“ progimnazija";PM2;6561536457;Taip;0;2;3;5
22280;"Vilniaus „Spindulio“ progimnazija";PM2;8023936861;Ne;6;10;0;16
22281;"Vilniaus „Spindulio“ progimnazija";PM2;7277680544;Taip;5;1;0;6
22282;"Vilniaus „Spindulio“ progimnazija";PM2;6479094819;Taip;0;1;0;1
22283;"Vilniaus „Spindulio“ progimnazija";PM2;6016791282;Taip;0;1;1;2
22284;"Vilniaus „Spindulio“ progimnazija";PM2;2356833740;Taip;5;1;2;8
22285;"Vilniaus „Spindulio“ progimnazija";PM2;1338287524;Taip;0;4;0;4
22286;"Vilniaus „Spindulio“ progimnazija";PM2;9516852657;Taip;9;1;1;11
22287;"Vilniaus „Spindulio“ progimnazija";PM2;1364873935;Taip;9;1;0;10
22288;"Vilniaus „Spindulio“ progimnazija";PM2;7528505426;Taip;3;1;0;4
22289;"Vilniaus „Spindulio“ progimnazija";PM2;7120717682;Taip;0;2;0;2
22290;"Vilniaus „Spindulio“ progimnazija";PM2;6201567680;Taip;0;1;3;4
22291;"Vilniaus „Spindulio“ progimnazija";PM2;8012626513;Taip;0;1;0;1
22292;"Vilniaus „Spindulio“ progimnazija";PM2;52216192635;Taip;16;0;0;16
22293;"Vilniaus „Spindulio“ progimnazija";PM2;4791752179;Taip;0;1;0;1
22294;"Vilniaus „Spindulio“ progimnazija";PM1;1948438336;Taip;0;3;3;6
22295;"Vilniaus „Spindulio“ progimnazija";PM1;43859975789;Taip;0;1;0;1
22296;"Vilniaus „Spindulio“ progimnazija";PM1;4701887030;Taip;0;2;0;2
22297;"Vilniaus „Spindulio“ progimnazija";PM1;60320557464;Taip;0;1;0;1
22298;"Vilniaus „Spindulio“ progimnazija";PM1;2531571615;Taip;0;2;0;2
22299;"Vilniaus „Spindulio“ progimnazija";PM1;1421633312;Ne;0;1;0;1
22300;"Vilniaus „Spindulio“ progimnazija";PM1;3678131609;Taip;0;1;0;1
22301;"Vilniaus „Spindulio“ progimnazija";PM1;1194444282;Taip;0;2;0;2
22302;"Vilniaus „Spindulio“ progimnazija";PM1;56885383122;Taip;0;1;0;1
22303;"Vilniaus „Spindulio“ progimnazija";PM1;1338476746;Taip;5;1;0;6
22304;"Vilniaus „Spindulio“ progimnazija";PM1;2402204674;Taip;0;1;0;1
22305;"Vilniaus „Spindulio“ progimnazija";PM1;6700068320;Taip;4;1;0;5
22306;"Vilniaus „Spindulio“ progimnazija";PM1;9347513042;Taip;0;2;0;2
22307;"Vilniaus „Spindulio“ progimnazija";PM1;1153333591;Taip;0;1;0;1
22308;"Vilniaus „Spindulio“ progimnazija";PM1;1650166115;Taip;0;1;0;1
22309;"Vilniaus „Spindulio“ progimnazija";PM1;9573336239;Taip;0;1;0;1
22310;"Vilniaus „Spindulio“ progimnazija";PM1;4239224971;Taip;0;1;0;1
22311;"Vilniaus „Spindulio“ progimnazija";PM1;9502789660;Taip;0;1;0;1
22312;"Vilniaus „Spindulio“ progimnazija";PM1;1454101129;Taip;0;1;0;1
22313;"Vilniaus „Spindulio“ progimnazija";PM1;1325054642;Taip;0;1;0;1
22314;"Vilniaus „Spindulio“ progimnazija";PM1;1160537966;Taip;6;1;0;7
22315;"Vilniaus „Spindulio“ progimnazija";PM1;91028452879;Ne;0;1;0;1
22316;"Vilniaus „Spindulio“ progimnazija";PM1;1789047913;Taip;0;1;0;1
22317;"Vilniaus Vladislavo Sirokomlės gimnazija";Nykštukai;1797237248;Taip;0;1;0;1
22318;"Vilniaus Vladislavo Sirokomlės gimnazija";Nykštukai;6031408197;Taip;9;1;3;13
22319;"Vilniaus Vladislavo Sirokomlės gimnazija";Nykštukai;1947403400;Taip;0;1;1;2
22320;"Vilniaus Vladislavo Sirokomlės gimnazija";Nykštukai;1499061139;Taip;0;31;0;31
22321;"Vilniaus Vladislavo Sirokomlės gimnazija";Nykštukai;2219712757;Taip;11;4;0;15
22322;"Vilniaus Vladislavo Sirokomlės gimnazija";Nykštukai;5544613599;Taip;7;1;1;9
22323;"Vilniaus Vladislavo Sirokomlės gimnazija";Nykštukai;25415760747;Taip;8;3;0;11
22324;"Vilniaus Vladislavo Sirokomlės gimnazija";Nykštukai;17201639406;Taip;5;6;0;11
22325;"Vilniaus Vladislavo Sirokomlės gimnazija";Nykštukai;8302624354;Taip;10;1;0;11
22326;"Vilniaus Vladislavo Sirokomlės gimnazija";Nykštukai;1492328724;Taip;0;2;1;3
22327;"Vilniaus Vladislavo Sirokomlės gimnazija";Nykštukai;4436165764;Taip;0;1;0;1
22328;"Vilniaus Vladislavo Sirokomlės gimnazija";Nykštukai;1837566431;Ne;15;2;0;17
22329;"Vilniaus Vladislavo Sirokomlės gimnazija";Nykštukai;8016643568;Taip;0;1;0;1
22330;"Vilniaus Vladislavo Sirokomlės gimnazija";Nykštukai;4534828670;Taip;0;31;0;31
22331;"Vilniaus Vladislavo Sirokomlės gimnazija";Nykštukai;4069044269;Taip;0;1;0;1
22332;"Vilniaus Vladislavo Sirokomlės gimnazija";Nykštukai;9391697537;Taip;9;2;0;11
22333;"Vilniaus Vladislavo Sirokomlės gimnazija";Nykštukai;5422289286;Taip;0;1;0;1
22334;"Vilniaus Vladislavo Sirokomlės gimnazija";Nykštukai;5625943720;Taip;3;1;1;5
22335;"Vilniaus Vladislavo Sirokomlės gimnazija";Nykštukai;2946297529;Taip;0;1;0;1
22336;"Vilniaus Vladislavo Sirokomlės gimnazija";Smurfai;5844437769;Taip;8;2;0;10
22337;"Vilniaus Vladislavo Sirokomlės gimnazija";Smurfai;9751494612;Taip;4;3;0;7
22338;"Vilniaus Vladislavo Sirokomlės gimnazija";Smurfai;4727265555;Taip;0;10;0;10
22339;"Vilniaus Vladislavo Sirokomlės gimnazija";Smurfai;7071043164;Taip;5;3;0;8
22340;"Vilniaus Vladislavo Sirokomlės gimnazija";Smurfai;1493604303;Taip;0;1;0;1
22341;"Vilniaus Vladislavo Sirokomlės gimnazija";Smurfai;4830374546;Taip;0;6;0;6
22342;"Vilniaus Vladislavo Sirokomlės gimnazija";Smurfai;4506651162;Taip;1;3;0;4
22343;"Vilniaus Vladislavo Sirokomlės gimnazija";Smurfai;1817869518;Taip;12;2;0;14
22344;"Vilniaus Vladislavo Sirokomlės gimnazija";Smurfai;1512245903;Taip;0;1;0;1
22345;"Vilniaus Vladislavo Sirokomlės gimnazija";Smurfai;7904983228;Ne;0;4;0;4
22346;"Vilniaus Vladislavo Sirokomlės gimnazija";Smurfai;1570206034;Ne;4;6;0;10
22347;"Vilniaus Vladislavo Sirokomlės gimnazija";Smurfai;1820583792;Taip;0;6;0;6
22348;"Vilniaus Vladislavo Sirokomlės gimnazija";Smurfai;2386927970;Taip;12;1;0;13
22349;"Vilniaus Vladislavo Sirokomlės gimnazija";Smurfai;92356998180;Taip;6;3;0;9
22350;"Vilniaus Vladislavo Sirokomlės gimnazija";Smurfai;4990982790;Taip;3;4;0;7
22351;"Vilniaus Vladislavo Sirokomlės gimnazija";Smurfai;3795927209;Taip;0;2;0;2
22352;"Vilniaus Vladislavo Sirokomlės gimnazija";Smurfai;3880578523;Taip;0;2;0;2
22353;"Vilniaus Vladislavo Sirokomlės gimnazija";Smurfai;9868386182;Taip;7;2;0;9
22354;"Vilniaus Vladislavo Sirokomlės gimnazija";Smurfai;1090204906;Ne;6;3;0;9
22355;"Vilniaus „Pelėdos” pradinė mokykla";Bitutės;3131930907;Taip;5;1;0;6
22356;"Vilniaus „Pelėdos” pradinė mokykla";Bitutės;2023718424;Taip;8;1;0;9
22357;"Vilniaus „Pelėdos” pradinė mokykla";Bitutės;13170636069;Taip;0;1;1;2
22358;"Vilniaus „Pelėdos” pradinė mokykla";Bitutės;1627717901;Taip;0;1;0;1
22359;"Vilniaus „Pelėdos” pradinė mokykla";Bitutės;49343952061;Taip;0;1;0;1
22360;"Vilniaus „Pelėdos” pradinė mokykla";Bitutės;8281005516;Ne;0;1;1;2
22361;"Vilniaus „Pelėdos” pradinė mokykla";Bitutės;7678062264;Taip;0;7;2;9
22362;"Vilniaus „Pelėdos” pradinė mokykla";Bitutės;20602164053;Taip;4;1;0;5
22363;"Vilniaus „Pelėdos” pradinė mokykla";Bitutės;6610166355;Taip;3;0;0;3
22364;"Vilniaus „Pelėdos” pradinė mokykla";Bitutės;5282345380;Taip;5;0;0;5
22365;"Vilniaus „Pelėdos” pradinė mokykla";Bitutės;4427123314;Taip;4;1;0;5
22366;"Vilniaus „Pelėdos” pradinė mokykla";Bitutės;5610993611;Taip;0;1;0;1
22367;"Vilniaus „Pelėdos” pradinė mokykla";Bitutės;1121936989;Taip;0;2;0;2
22368;"Vilniaus „Pelėdos” pradinė mokykla";Bitutės;4268531240;Taip;0;1;0;1
22369;"Vilniaus „Pelėdos” pradinė mokykla";Bitutės;3312575449;Taip;0;1;0;1
22370;"Vilniaus „Pelėdos” pradinė mokykla";Bitutės;9558483512;Taip;0;1;0;1
22371;"Vilniaus „Pelėdos” pradinė mokykla";Bitutės;7907026349;Ne;0;0;1;1
22372;"Vilniaus „Pelėdos” pradinė mokykla";Bitutės;9343761295;Taip;0;2;0;2
22373;"Vilniaus „Pelėdos” pradinė mokykla";Bitutės;7006338378;Taip;0;1;1;2
22374;"Vilniaus „Pelėdos” pradinė mokykla";Bitutės;3030820917;Ne;0;1;4;5
22375;"Vilniaus „Pelėdos” pradinė mokykla";Bitutės;3768735503;Taip;4;0;4;8
22376;"Vilniaus „Pelėdos” pradinė mokykla";Bitutės;6597383913;Taip;0;1;0;1
22377;"Vilniaus „Pelėdos” pradinė mokykla";Bitutės;7972395014;Taip;5;1;1;7
22378;"Vilniaus „Pelėdos” pradinė mokykla";Boružėlės;3284613284;Taip;2;1;0;3
22379;"Vilniaus „Pelėdos” pradinė mokykla";Boružėlės;1032549174;Taip;0;1;0;1
22380;"Vilniaus „Pelėdos” pradinė mokykla";Boružėlės;1314392095;Ne;0;1;2;3
22381;"Vilniaus „Pelėdos” pradinė mokykla";Boružėlės;1398976932;Taip;0;1;0;1
22382;"Vilniaus „Pelėdos” pradinė mokykla";Boružėlės;5169736542;Taip;0;1;0;1
22383;"Vilniaus „Pelėdos” pradinė mokykla";Boružėlės;6897988246;Taip;0;8;0;8
22384;"Vilniaus „Pelėdos” pradinė mokykla";Boružėlės;1830060403;Taip;5;2;0;7
22385;"Vilniaus „Pelėdos” pradinė mokykla";Boružėlės;4347647695;Taip;0;1;1;2
22386;"Vilniaus „Pelėdos” pradinė mokykla";Boružėlės;9823188609;Taip;0;1;0;1
22387;"Vilniaus „Pelėdos” pradinė mokykla";Boružėlės;1153781469;Taip;12;1;1;14
22388;"Vilniaus „Pelėdos” pradinė mokykla";Boružėlės;93600065957;Taip;0;1;0;1
22389;"Vilniaus „Pelėdos” pradinė mokykla";Boružėlės;3970413055;Taip;0;1;0;1
22390;"Vilniaus „Pelėdos” pradinė mokykla";Boružėlės;9279913053;Ne;0;1;1;2
22391;"Vilniaus „Pelėdos” pradinė mokykla";Boružėlės;1616324236;Ne;0;1;0;1
22392;"Vilniaus „Pelėdos” pradinė mokykla";Boružėlės;1704933971;Taip;0;1;0;1
22393;"Vilniaus „Pelėdos” pradinė mokykla";Boružėlės;6623852620;Ne;0;1;1;2
22394;"Vilniaus „Pelėdos” pradinė mokykla";Boružėlės;3118698712;Taip;0;1;0;1
22395;"Vilniaus „Pelėdos” pradinė mokykla";Boružėlės;5140876051;Ne;5;1;3;9
22396;"Vilniaus „Pelėdos” pradinė mokykla";Boružėlės;8086378912;Taip;5;1;0;6
22397;"Vilniaus Joachimo Lelevelio inžinerijos mokykla";0A;57362664278;Taip;1;1;0;2
22398;"Vilniaus Joachimo Lelevelio inžinerijos mokykla";0A;1694423628;Taip;20;1;0;21
22399;"Vilniaus Joachimo Lelevelio inžinerijos mokykla";0A;19420482998;Taip;0;2;0;2
22400;"Vilniaus Joachimo Lelevelio inžinerijos mokykla";0A;1546251543;Taip;0;21;0;21
22401;"Vilniaus Joachimo Lelevelio inžinerijos mokykla";0A;9130637883;Taip;0;7;0;7
22402;"Vilniaus Joachimo Lelevelio inžinerijos mokykla";0A;6217540064;Taip;0;2;0;2
22403;"Vilniaus Joachimo Lelevelio inžinerijos mokykla";0A;1954888655;Taip;5;1;3;9
22404;"Vilniaus Joachimo Lelevelio inžinerijos mokykla";0A;7776071299;Taip;0;2;0;2
22405;"Vilniaus Joachimo Lelevelio inžinerijos mokykla";0A;9215070593;Taip;0;1;0;1
22406;"Vilniaus Joachimo Lelevelio inžinerijos mokykla";0A;3039980710;Taip;0;4;0;4
22407;"Vilniaus Joachimo Lelevelio inžinerijos mokykla";0A;1826015013;Taip;0;2;1;3
22408;"Vilniaus Joachimo Lelevelio inžinerijos mokykla";0A;5630659056;Taip;0;4;0;4
22409;"Vilniaus Joachimo Lelevelio inžinerijos mokykla";0A;9171690612;Taip;3;2;0;5
22410;"Vilniaus Joachimo Lelevelio inžinerijos mokykla";0A;3271832822;Taip;0;1;0;1
22411;"Vilniaus Joachimo Lelevelio inžinerijos mokykla";0A;2797443202;Ne;5;1;1;7
22412;"Vilniaus Joachimo Lelevelio inžinerijos mokykla";0B;6404064049;Taip;0;1;1;2
22413;"Vilniaus Joachimo Lelevelio inžinerijos mokykla";0B;2324578741;Taip;0;1;4;5
22414;"Vilniaus Joachimo Lelevelio inžinerijos mokykla";0B;6132569107;Taip;0;1;0;1
22415;"Vilniaus Joachimo Lelevelio inžinerijos mokykla";0B;64247830728;Taip;0;31;0;31
22416;"Vilniaus Joachimo Lelevelio inžinerijos mokykla";0B;2601103834;Taip;0;17;0;17
22417;"Vilniaus Joachimo Lelevelio inžinerijos mokykla";0B;65960895249;Taip;0;4;0;4
22418;"Vilniaus Joachimo Lelevelio inžinerijos mokykla";0B;5722934228;Taip;0;3;0;3
22419;"Vilniaus Joachimo Lelevelio inžinerijos mokykla";0B;1385352925;Taip;0;3;0;3
22420;"Vilniaus Joachimo Lelevelio inžinerijos mokykla";0B;4209118353;Taip;0;1;1;2
22421;"Vilniaus Joachimo Lelevelio inžinerijos mokykla";0B;6883982889;Taip;22;1;2;25
22422;"Vilniaus Joachimo Lelevelio inžinerijos mokykla";0B;9595277597;Taip;0;2;0;2
22423;"Vilniaus Joachimo Lelevelio inžinerijos mokykla";0B;2842587194;Taip;0;2;0;2
22424;"Vilniaus Joachimo Lelevelio inžinerijos mokykla";0B;8042807487;Taip;2;3;0;5
22425;"Vilniaus Joachimo Lelevelio inžinerijos mokykla";0B;6501930436;Taip;4;1;0;5
22426;"Vilniaus Joachimo Lelevelio inžinerijos mokykla";0B;71081903240;Taip;0;1;0;1
22427;"Vilniaus Juzefo Ignacijaus Kraševskio gimnazija";Priešmokyklinė;2201538495;Taip;0;1;0;1
22428;"Vilniaus Juzefo Ignacijaus Kraševskio gimnazija";Priešmokyklinė;9114472645;Ne;0;5;2;7
22429;"Vilniaus Juzefo Ignacijaus Kraševskio gimnazija";Priešmokyklinė;5261769707;Taip;0;1;0;1
22430;"Vilniaus Juzefo Ignacijaus Kraševskio gimnazija";Priešmokyklinė;5255617339;Ne;7;1;1;9
22431;"Vilniaus Juzefo Ignacijaus Kraševskio gimnazija";Priešmokyklinė;1600495468;Taip;0;6;0;6
22432;"Vilniaus Juzefo Ignacijaus Kraševskio gimnazija";Priešmokyklinė;3733665122;Taip;0;9;0;9
22433;"Vilniaus Juzefo Ignacijaus Kraševskio gimnazija";Priešmokyklinė;2168987649;Taip;5;1;0;6
22434;"Vilniaus Juzefo Ignacijaus Kraševskio gimnazija";Priešmokyklinė;4499924331;Taip;5;1;0;6
22435;"Vilniaus Juzefo Ignacijaus Kraševskio gimnazija";Priešmokyklinė;6048337545;Taip;0;1;1;2
22436;"Vilniaus Juzefo Ignacijaus Kraševskio gimnazija";Priešmokyklinė;9948555227;Taip;0;1;3;4
22437;"Vilniaus Juzefo Ignacijaus Kraševskio gimnazija";Priešmokyklinė;7993975989;Taip;0;5;0;5
22438;"Vilniaus Juzefo Ignacijaus Kraševskio gimnazija";Priešmokyklinė;2684151591;Taip;0;3;0;3
22439;"Vilniaus Juzefo Ignacijaus Kraševskio gimnazija";Priešmokyklinė;7670166244;Taip;4;1;3;8
22440;"Vilniaus Juzefo Ignacijaus Kraševskio gimnazija";Priešmokyklinė;4864834075;Taip;4;3;0;7
22441;"Vilniaus Juzefo Ignacijaus Kraševskio gimnazija";Priešmokyklinė;1837140329;Ne;0;1;1;2
22442;"Vilniaus Juzefo Ignacijaus Kraševskio gimnazija";Priešmokyklinė;1460429651;Taip;0;2;0;2
22443;"Vilniaus Juzefo Ignacijaus Kraševskio gimnazija";Priešmokyklinė;9501262918;Ne;0;1;2;3
22444;"Vilniaus Juzefo Ignacijaus Kraševskio gimnazija";Priešmokyklinė;9333766622;Ne;5;6;0;11
22445;"Vilniaus Juzefo Ignacijaus Kraševskio gimnazija";Priešmokyklinė;3507672150;Taip;0;7;0;7
22446;"Vilniaus Juzefo Ignacijaus Kraševskio gimnazija";Priešmokyklinė;7305350540;Taip;0;2;0;2
22447;"Vilniaus Juzefo Ignacijaus Kraševskio gimnazija";Priešmokyklinė;3698808100;Taip;0;2;0;2
22448;"Vilniaus Jono Pauliaus II progimnazija";Nykštukai;2055530718;Taip;0;1;0;1
22449;"Vilniaus Jono Pauliaus II progimnazija";Nykštukai;7140223126;Taip;0;1;0;1
22450;"Vilniaus Jono Pauliaus II progimnazija";Nykštukai;48694326383;Taip;0;1;0;1
22451;"Vilniaus Jono Pauliaus II progimnazija";Nykštukai;4831426440;Taip;6;1;0;7
22452;"Vilniaus Jono Pauliaus II progimnazija";Nykštukai;3762141936;Taip;0;1;0;1
22453;"Vilniaus Jono Pauliaus II progimnazija";Nykštukai;8703046661;Taip;0;1;0;1
22454;"Vilniaus Jono Pauliaus II progimnazija";Nykštukai;6724813553;Taip;0;1;0;1
22455;"Vilniaus Jono Pauliaus II progimnazija";Nykštukai;51629266891;Taip;0;1;1;2
22456;"Vilniaus Jono Pauliaus II progimnazija";Nykštukai;7268811782;Taip;0;1;0;1
22457;"Vilniaus Jono Pauliaus II progimnazija";Nykštukai;8998452731;Taip;11;1;0;12
22458;"Vilniaus Jono Pauliaus II progimnazija";Nykštukai;4071338645;Taip;0;9;0;9
22459;"Vilniaus Jono Pauliaus II progimnazija";Nykštukai;3637409607;Taip;8;2;0;10
22460;"Vilniaus Jono Pauliaus II progimnazija";Nykštukai;4607613986;Taip;0;21;0;21
22461;"Vilniaus Jono Pauliaus II progimnazija";Nykštukai;6988819614;Taip;0;1;0;1
22462;"Vilniaus Jono Pauliaus II progimnazija";Nykštukai;9672929606;Taip;0;1;3;4
22463;"Vilniaus Jono Pauliaus II progimnazija";Nykštukai;9457189905;Taip;0;1;2;3
22464;"Vilniaus Jono Pauliaus II progimnazija";Nykštukai;2013905907;Taip;0;1;0;1
22465;"Vilniaus Jono Pauliaus II progimnazija";Nykštukai;2095972347;Taip;0;2;0;2
22466;"Vilniaus Jono Pauliaus II progimnazija";Nykštukai;1624125024;Taip;4;2;0;6
22467;"Vilniaus Jono Pauliaus II progimnazija";Nykštukai;8796557675;Taip;0;3;0;3
22468;"Vilniaus Jono Pauliaus II progimnazija";Nykštukai;5902455219;Taip;0;1;0;1
22469;"Vilniaus Jono Pauliaus II progimnazija";Žiniukai;36350993825;Taip;0;2;0;2
22470;"Vilniaus Jono Pauliaus II progimnazija";Žiniukai;8607110629;Taip;11;1;1;13
22471;"Vilniaus Jono Pauliaus II progimnazija";Žiniukai;6779413882;Taip;15;1;0;16
22472;"Vilniaus Jono Pauliaus II progimnazija";Žiniukai;1897451825;Taip;0;3;0;3
22473;"Vilniaus Jono Pauliaus II progimnazija";Žiniukai;49110267692;Taip;0;1;3;4
22474;"Vilniaus Jono Pauliaus II progimnazija";Žiniukai;7947148051;Taip;0;7;0;7
22475;"Vilniaus Jono Pauliaus II progimnazija";Žiniukai;9246391309;Taip;0;1;0;1
22476;"Vilniaus Jono Pauliaus II progimnazija";Žiniukai;35673258175;Taip;0;1;1;2
22477;"Vilniaus Jono Pauliaus II progimnazija";Žiniukai;4472742569;Taip;0;1;1;2
22478;"Vilniaus Jono Pauliaus II progimnazija";Žiniukai;69245659818;Taip;0;10;1;11
22479;"Vilniaus Jono Pauliaus II progimnazija";Žiniukai;9664467134;Taip;15;1;0;16
22480;"Vilniaus Jono Pauliaus II progimnazija";Žiniukai;7838787153;Taip;7;1;1;9
22481;"Vilniaus Jono Pauliaus II progimnazija";Žiniukai;8922195998;Taip;0;2;2;4
22482;"Vilniaus Jono Pauliaus II progimnazija";Žiniukai;1429139157;Taip;4;1;0;5
22483;"Vilniaus Jono Pauliaus II progimnazija";Žiniukai;3042409414;Taip;0;12;0;12
22484;"Vilniaus Jono Pauliaus II progimnazija";Žiniukai;8245310502;Taip;8;2;1;11
22485;"Vilniaus Jono Pauliaus II progimnazija";Žiniukai;5593546668;Taip;0;1;0;1
22486;"Vilniaus Jono Pauliaus II progimnazija";Žiniukai;1460444785;Taip;0;5;0;5
22487;"Vilniaus Jono Pauliaus II progimnazija";Žiniukai;9262869284;Taip;6;1;2;9
22488;"Vilniaus Jono Pauliaus II progimnazija";Žiniukai;38456484551;Taip;0;1;0;1
22489;"Vilniaus Jono Pauliaus II progimnazija";Žiniukai;6646474196;Taip;2;1;1;4
22490;"Vilniaus Jono Pauliaus II progimnazija";Spindulėlis;2391924358;Taip;0;1;0;1
22491;"Vilniaus Jono Pauliaus II progimnazija";Spindulėlis;9953834483;Taip;0;1;0;1
22492;"Vilniaus Jono Pauliaus II progimnazija";Spindulėlis;1950514819;Taip;0;31;0;31
22493;"Vilniaus Jono Pauliaus II progimnazija";Spindulėlis;1298127839;Ne;5;2;1;8
22494;"Vilniaus Jono Pauliaus II progimnazija";Spindulėlis;4034847901;Taip;0;1;0;1
22495;"Vilniaus Jono Pauliaus II progimnazija";Spindulėlis;8980788109;Taip;0;1;0;1
22496;"Vilniaus Jono Pauliaus II progimnazija";Spindulėlis;1009453682;Taip;6;2;0;8
22497;"Vilniaus Jono Pauliaus II progimnazija";Spindulėlis;4579700769;Taip;0;6;0;6
22498;"Vilniaus Jono Pauliaus II progimnazija";Spindulėlis;7136135394;Taip;0;3;0;3
22499;"Vilniaus Jono Pauliaus II progimnazija";Spindulėlis;2244921301;Taip;0;1;0;1
22500;"Vilniaus Jono Pauliaus II progimnazija";Spindulėlis;1133359254;Taip;5;1;0;6
22501;"Vilniaus Jono Pauliaus II progimnazija";Spindulėlis;8336138549;Taip;0;2;1;3
22502;"Vilniaus Jono Pauliaus II progimnazija";Spindulėlis;1831094707;Taip;0;1;0;1
22503;"Vilniaus Jono Pauliaus II progimnazija";Spindulėlis;5036549574;Taip;5;1;0;6
22504;"Vilniaus Jono Pauliaus II progimnazija";Spindulėlis;5451923881;Taip;7;1;1;9
22505;"Vilniaus Jono Pauliaus II progimnazija";Spindulėlis;8100789958;Taip;0;1;0;1
22506;"Vilniaus Jono Pauliaus II progimnazija";Spindulėlis;6964047214;Taip;10;1;0;11
22507;"Vilniaus Jono Pauliaus II progimnazija";Spindulėlis;2445444641;Taip;16;1;0;17
22508;"Vilniaus Jono Pauliaus II progimnazija";Spindulėlis;5079107907;Taip;0;2;0;2
22509;"Vilniaus Jono Pauliaus II progimnazija";Spindulėlis;9908198854;Taip;0;2;0;2
22510;"Vilniaus Jono Pauliaus II progimnazija";Spindulėlis;6595165722;Taip;0;1;0;1
22511;Gluosnis;KIŠKUČIAI;8689557248;Taip;0;1;0;1
22512;Gluosnis;KIŠKUČIAI;2984134115;Taip;0;0;6;6
22513;Gluosnis;KIŠKUČIAI;6955695422;Taip;0;0;1;1
22514;Gluosnis;KIŠKUČIAI;1305651237;Taip;1;0;0;1
22515;Gluosnis;KIŠKUČIAI;4285562600;Taip;1;3;0;4
22516;Gluosnis;KIŠKUČIAI;5432102004;Taip;9;0;0;9
22517;Gluosnis;KIŠKUČIAI;8009719622;Taip;0;0;1;1
22518;Gluosnis;KIŠKUČIAI;9833971809;Taip;2;0;0;2
22519;Gluosnis;KIŠKUČIAI;6883663577;Taip;0;1;0;1
22520;Gluosnis;KIŠKUČIAI;1512855055;Taip;6;1;0;7
22521;Gluosnis;KIŠKUČIAI;8337313448;Taip;0;0;1;1
22522;Gluosnis;KIŠKUČIAI;4632419177;Taip;10;0;3;13
22523;Gluosnis;KIŠKUČIAI;7769522093;Taip;16;0;0;16
22524;Gluosnis;KIŠKUČIAI;8928597187;Taip;0;1;0;1
22525;Gluosnis;KIŠKUČIAI;9993638596;Taip;0;11;1;12
22526;Gluosnis;KIŠKUČIAI;6994005000;Ne;0;1;0;1
22527;Gluosnis;KIŠKUČIAI;9221983318;Taip;0;0;1;1
22528;Gluosnis;KIŠKUČIAI;2187312618;Taip;0;1;1;2
22529;Gluosnis;KIŠKUČIAI;7073637619;Taip;0;0;2;2
22530;Gluosnis;KIŠKUČIAI;1391404073;Taip;0;0;1;1
22531;Gluosnis;KIŠKUČIAI;4591550636;Taip;16;2;0;18
22532;Gluosnis;EŽIUKAI;4153713911;Ne;2;0;4;6
22533;Gluosnis;EŽIUKAI;5350702449;Taip;5;0;1;6
22534;Gluosnis;EŽIUKAI;8577271806;Taip;0;1;0;1
22535;Gluosnis;EŽIUKAI;6622415563;Taip;0;1;0;1
22536;Gluosnis;EŽIUKAI;3988305400;Taip;0;2;0;2
22537;Gluosnis;EŽIUKAI;9788278155;Taip;8;2;0;10
22538;Gluosnis;EŽIUKAI;7974944779;Taip;0;0;1;1
22539;Gluosnis;EŽIUKAI;7526020668;Taip;0;1;0;1
22540;Gluosnis;EŽIUKAI;5522411084;Taip;0;0;3;3
22541;Gluosnis;EŽIUKAI;6681653921;Taip;0;7;0;7
22542;Gluosnis;EŽIUKAI;4902627153;Ne;16;0;5;21
22543;Gluosnis;EŽIUKAI;2525780494;Taip;0;11;0;11
22544;Gluosnis;EŽIUKAI;9389736360;Taip;0;2;3;5
22545;Gluosnis;EŽIUKAI;2707855273;Taip;0;1;0;1
22546;Gluosnis;EŽIUKAI;7523459118;Taip;0;0;1;1
22547;Gluosnis;EŽIUKAI;2794163383;Ne;0;0;3;3
22548;Gluosnis;EŽIUKAI;7264550578;Taip;0;1;3;4
22549;Gluosnis;EŽIUKAI;5368171142;Taip;0;9;0;9
22550;Gluosnis;EŽIUKAI;6754799196;Taip;1;0;0;1
22551;Gluosnis;EŽIUKAI;9888037899;Taip;7;0;4;11
22552;Gluosnis;MEŠKIUKAI;8981904827;Taip;0;0;3;3
22553;Gluosnis;MEŠKIUKAI;8998776286;Taip;2;0;2;4
22554;Gluosnis;MEŠKIUKAI;1846499141;Taip;17;0;2;19
22555;Gluosnis;MEŠKIUKAI;7935750427;Taip;5;0;3;8
22556;Gluosnis;MEŠKIUKAI;4905002832;Taip;0;2;0;2
22557;Gluosnis;MEŠKIUKAI;9102081648;Ne;0;0;5;5
22558;Gluosnis;MEŠKIUKAI;4498429439;Taip;12;0;0;12
22559;Gluosnis;MEŠKIUKAI;8259160584;Taip;3;2;0;5
22560;Gluosnis;MEŠKIUKAI;1235091885;Taip;4;8;1;13
22561;Gluosnis;MEŠKIUKAI;1165636758;Taip;5;0;3;8
22562;Gluosnis;MEŠKIUKAI;2867319899;Taip;5;0;0;5
22563;Gluosnis;MEŠKIUKAI;9699577397;Taip;0;0;5;5
22564;Gluosnis;MEŠKIUKAI;4107344313;Taip;3;0;0;3
22565;Gluosnis;MEŠKIUKAI;1101472999;Taip;0;0;4;4
22566;Gluosnis;MEŠKIUKAI;7995558671;Taip;6;0;0;6
22567;Gluosnis;MEŠKIUKAI;1602556462;Taip;6;0;0;6
22568;Gluosnis;MEŠKIUKAI;8842139496;Taip;12;0;4;16
22569;Gluosnis;MEŠKIUKAI;4060859156;Taip;0;1;0;1
22570;Gluosnis;MEŠKIUKAI;6428753580;Taip;7;0;0;7
22571;Gluosnis;MEŠKIUKAI;3323237449;Taip;0;5;0;5
22572;Gluosnis;MEŠKIUKAI;6246512101;Taip;0;0;1;1
22573;Gluosnis;MEŠKIUKAI;3038732180;Taip;15;1;1;17
22574;Gluosnis;MEŠKIUKAI;1712795835;Taip;0;2;0;2
22575;Gluosnis;BORUŽĖLĖS;8840658383;Ne;0;2;0;2
22576;Gluosnis;BORUŽĖLĖS;1102935178;Taip;0;0;7;7
22577;Gluosnis;BORUŽĖLĖS;2167312808;Taip;0;0;1;1
22578;Gluosnis;BORUŽĖLĖS;4204797742;Taip;0;9;0;9
22579;Gluosnis;BORUŽĖLĖS;6302765948;Taip;0;0;2;2
22580;Gluosnis;BORUŽĖLĖS;9938235476;Taip;0;5;0;5
22581;Gluosnis;BORUŽĖLĖS;2173191971;Taip;6;0;1;7
22582;Gluosnis;BORUŽĖLĖS;4237053702;Ne;0;3;0;3
22583;Gluosnis;BORUŽĖLĖS;7731887361;Taip;0;0;1;1
22584;Gluosnis;BORUŽĖLĖS;8502947568;Taip;0;0;1;1
22585;Gluosnis;BORUŽĖLĖS;1335152703;Taip;1;2;0;3
22586;Gluosnis;BORUŽĖLĖS;1314992969;Ne;4;0;3;7
22587;Gluosnis;BORUŽĖLĖS;7833136455;Taip;5;1;0;6
22588;Gluosnis;BORUŽĖLĖS;2515646510;Ne;10;0;1;11
22589;Gluosnis;BORUŽĖLĖS;2603201633;Taip;0;2;3;5
22590;Gluosnis;BORUŽĖLĖS;6086258054;Taip;4;4;0;8
22591;Gluosnis;BORUŽĖLĖS;1351519995;Taip;16;0;0;16
22592;Gluosnis;BORUŽĖLĖS;6960673767;Taip;10;0;0;10
22593;Gluosnis;LAPIUKAI;7025815772;Taip;1;0;0;1
22594;Gluosnis;LAPIUKAI;5266206726;Taip;21;0;0;21
22595;Gluosnis;LAPIUKAI;2968946946;Taip;9;0;2;11
22596;Gluosnis;LAPIUKAI;8976032500;Taip;0;0;2;2
22597;Gluosnis;LAPIUKAI;3190331209;Taip;16;0;0;16
22598;Gluosnis;LAPIUKAI;5376108804;Taip;3;0;0;3
22599;Gluosnis;LAPIUKAI;2258921960;Taip;10;0;3;13
22600;Gluosnis;LAPIUKAI;1664508998;Taip;16;0;0;16
22601;Gluosnis;LAPIUKAI;1296975213;Taip;16;0;0;16
22602;Gluosnis;LAPIUKAI;8227732558;Taip;7;0;5;12
22603;Gluosnis;LAPIUKAI;6518579198;Taip;9;0;2;11
22604;Gluosnis;LAPIUKAI;5633386146;Taip;9;0;8;17
22605;Gluosnis;LAPIUKAI;4616132460;Taip;0;0;2;2
22606;Gluosnis;LAPIUKAI;4280829038;Ne;4;0;0;4
22607;Gluosnis;LAPIUKAI;6273179300;Taip;11;0;0;11
22608;Gluosnis;LAPIUKAI;7090336454;Taip;0;2;0;2
22609;Gluosnis;PELĖDŽIUKAI;1933496033;Taip;0;2;1;3
22610;Gluosnis;PELĖDŽIUKAI;8259035822;Taip;5;3;0;8
22611;Gluosnis;PELĖDŽIUKAI;4960167173;Taip;9;0;0;9
22612;Gluosnis;PELĖDŽIUKAI;2181550091;Taip;0;1;0;1
22613;Gluosnis;PELĖDŽIUKAI;6163009686;Taip;0;2;0;2
22614;Gluosnis;PELĖDŽIUKAI;1671693932;Taip;5;1;0;6
22615;Gluosnis;PELĖDŽIUKAI;4005023841;Ne;8;1;3;12
22616;Gluosnis;PELĖDŽIUKAI;9497547057;Taip;2;1;0;3
22617;Gluosnis;PELĖDŽIUKAI;6865973084;Taip;0;1;0;1
22618;Gluosnis;PELĖDŽIUKAI;1298724775;Ne;0;2;0;2
22619;Gluosnis;PELĖDŽIUKAI;1185903576;Taip;0;0;5;5
22620;Gluosnis;PELĖDŽIUKAI;7537587118;Ne;10;1;0;11
22621;Gluosnis;PELĖDŽIUKAI;7761376910;Taip;5;1;0;6
22622;Gluosnis;PELĖDŽIUKAI;3434902234;Taip;0;1;1;2
22623;Gluosnis;PELĖDŽIUKAI;6944918504;Taip;4;5;2;11
22624;Gluosnis;PELĖDŽIUKAI;7842723958;Taip;6;2;0;8
22625;Gluosnis;PELĖDŽIUKAI;94487630173;Ne;0;3;0;3
22626;Gluosnis;PELĖDŽIUKAI;1076538028;Taip;0;2;0;2
22627;Gluosnis;VOVERIUKAI;6747244713;Taip;3;0;2;5
22628;Gluosnis;VOVERIUKAI;3900322680;Taip;13;0;0;13
22629;Gluosnis;VOVERIUKAI;2423433989;Taip;4;0;6;10
22630;Gluosnis;VOVERIUKAI;1263019496;Taip;16;0;0;16
22631;Gluosnis;VOVERIUKAI;4564193030;Taip;7;1;0;8
22632;Gluosnis;VOVERIUKAI;4224637208;Taip;2;0;1;3
22633;Gluosnis;VOVERIUKAI;1144177849;Taip;13;0;1;14
22634;Gluosnis;VOVERIUKAI;6729016081;Taip;8;0;0;8
22635;Gluosnis;VOVERIUKAI;4069584911;Taip;0;1;4;5
22636;Gluosnis;VOVERIUKAI;6119618742;Taip;10;0;1;11
22637;Gluosnis;VOVERIUKAI;2794080237;Taip;4;1;0;5
22638;Gluosnis;VOVERIUKAI;5623135790;Taip;20;0;0;20
22639;Gluosnis;VOVERIUKAI;2310874591;Taip;1;2;1;4
22640;Gluosnis;VOVERIUKAI;5210930032;Taip;2;0;3;5
22641;Gluosnis;VOVERIUKAI;5008836118;Taip;15;0;2;17
22642;Gluosnis;VOVERIUKAI;4361177196;Taip;16;0;1;17
22643;Gluosnis;VOVERIUKAI;9484423786;Taip;14;0;0;14
22644;Gluosnis;VOVERIUKAI;8109714321;Ne;13;0;0;13
22645;Gluosnis;DRUGELIAI;5949954525;Taip;2;0;1;3
22646;Gluosnis;DRUGELIAI;1716235604;Taip;0;3;0;3
22647;Gluosnis;DRUGELIAI;8430102757;Taip;0;1;0;1
22648;Gluosnis;DRUGELIAI;4125830926;Ne;0;7;0;7
22649;Gluosnis;DRUGELIAI;6358187113;Taip;5;0;2;7
22650;Gluosnis;DRUGELIAI;9084785666;Taip;0;0;5;5
22651;Gluosnis;DRUGELIAI;4940563623;Taip;0;0;3;3
22652;Gluosnis;DRUGELIAI;4653963373;Taip;8;2;0;10
22653;Gluosnis;DRUGELIAI;2458662117;Taip;9;0;1;10
22654;Gluosnis;DRUGELIAI;8314366921;Taip;0;0;1;1
22655;Gluosnis;DRUGELIAI;4220504133;Taip;5;0;0;5
22656;Gluosnis;DRUGELIAI;9931766935;Taip;0;10;1;11
22657;Gluosnis;DRUGELIAI;3527418865;Taip;14;0;0;14
22658;Gluosnis;DRUGELIAI;6914171069;Taip;0;0;6;6
22659;Gluosnis;DRUGELIAI;1848647593;Taip;0;7;0;7
22660;Gluosnis;DRUGELIAI;7756397778;Taip;5;0;0;5
22661;Gluosnis;DRUGELIAI;5943955268;Taip;7;0;1;8
22662;Gluosnis;DRUGELIAI;8690911930;Taip;0;0;3;3
22663;Gluosnis;DRUGELIAI;1543842220;Taip;12;0;3;15
22664;Gluosnis;DRUGELIAI;1787206205;Taip;0;1;0;1
22665;Gluosnis;DRUGELIAI;5264930854;Taip;0;1;0;1
22666;Gluosnis;BITUTĖS;4176300773;Taip;0;0;1;1
22667;Gluosnis;BITUTĖS;2554790908;Taip;0;2;0;2
22668;Gluosnis;BITUTĖS;8281499182;Taip;20;0;0;20
22669;Gluosnis;BITUTĖS;2403029153;Taip;0;1;0;1
22670;Gluosnis;BITUTĖS;9542889575;Taip;0;2;0;2
22671;Gluosnis;BITUTĖS;1966484574;Taip;0;1;2;3
22672;Gluosnis;BITUTĖS;4353195155;Ne;0;8;5;13
22673;Gluosnis;BITUTĖS;5889360726;Taip;0;0;7;7
22674;Gluosnis;BITUTĖS;3362089746;Taip;0;1;6;7
22675;Gluosnis;BITUTĖS;7390361159;Taip;2;0;1;3
22676;Gluosnis;BITUTĖS;8380310240;Taip;0;1;1;2
22677;Gluosnis;BITUTĖS;4481544177;Taip;0;0;1;1
22678;Gluosnis;BITUTĖS;3673702157;Taip;0;1;0;1
22679;Gluosnis;BITUTĖS;9098141563;Taip;3;0;3;6
22680;Gluosnis;BITUTĖS;9201769624;Taip;0;1;2;3
22681;Gluosnis;BITUTĖS;6767500085;Ne;0;0;1;1
22682;Gluosnis;BITUTĖS;6001358241;Taip;4;0;4;8
22683;Gluosnis;BITUTĖS;5380755693;Ne;0;1;4;5
22684;Gluosnis;BITUTĖS;6197840105;Taip;7;1;0;8
22685;Gluosnis;BITUTĖS;5204445760;Ne;0;0;1;1
22686;"Vilniaus Saulėtekio mokykla-daugiafunkcinis centras";Priešmokyklinė;1029813471;Taip;0;1;1;2
22687;"Vilniaus Saulėtekio mokykla-daugiafunkcinis centras";Priešmokyklinė;8760467524;Taip;0;1;0;1
22688;"Vilniaus Saulėtekio mokykla-daugiafunkcinis centras";Priešmokyklinė;6738279023;Taip;0;10;0;10
22689;"Vilniaus Saulėtekio mokykla-daugiafunkcinis centras";Priešmokyklinė;1739797553;Taip;0;5;0;5
22690;"Vilniaus Saulėtekio mokykla-daugiafunkcinis centras";Priešmokyklinė;2159833613;Taip;11;2;0;13
22691;"Vilniaus Saulėtekio mokykla-daugiafunkcinis centras";Priešmokyklinė;1193336600;Taip;7;8;0;15
22692;"Vilniaus Saulėtekio mokykla-daugiafunkcinis centras";Priešmokyklinė;5914721966;Taip;0;1;1;2
22693;"Vilniaus Saulėtekio mokykla-daugiafunkcinis centras";Priešmokyklinė;8852228006;Ne;0;1;20;21
22694;"Vilniaus Saulėtekio mokykla-daugiafunkcinis centras";Priešmokyklinė;4159716896;Taip;0;1;0;1
22695;"Vilniaus Saulėtekio mokykla-daugiafunkcinis centras";Priešmokyklinė;1667714484;Taip;5;1;14;20
22696;"Vilniaus Saulėtekio mokykla-daugiafunkcinis centras";Priešmokyklinė;6589058061;Taip;0;1;1;2
22697;"Vilniaus Saulėtekio mokykla-daugiafunkcinis centras";Priešmokyklinė;3048310276;Taip;0;1;0;1
22698;"Vilniaus Saulėtekio mokykla-daugiafunkcinis centras";Priešmokyklinė;6991187086;Ne;0;8;0;8
22699;"Vilniaus Saulėtekio mokykla-daugiafunkcinis centras";Priešmokyklinė;1698381959;Taip;0;1;0;1
22700;"Vilniaus Saulėtekio mokykla-daugiafunkcinis centras";Priešmokyklinė;2500332755;Taip;0;1;0;1
22701;"Vilniaus Saulėtekio mokykla-daugiafunkcinis centras";Priešmokyklinė;2074102166;Taip;0;1;0;1
22702;"Vilniaus Saulėtekio mokykla-daugiafunkcinis centras";Priešmokyklinė;2906786855;Taip;0;1;1;2
22703;"Vilniaus Saulėtekio mokykla-daugiafunkcinis centras";Priešmokyklinė;3108520221;Taip;5;10;0;15
22704;"Vilniaus Saulėtekio mokykla-daugiafunkcinis centras";Priešmokyklinė;8815534200;Taip;0;1;3;4
22705;"Vilniaus Saulėtekio mokykla-daugiafunkcinis centras";Priešmokyklinė;4751570183;Taip;9;1;0;10
22706;"Vilniaus Saulėtekio mokykla-daugiafunkcinis centras";Priešmokyklinė;9164075226;Ne;0;8;0;8
22707;"Vilniaus Saulėtekio mokykla-daugiafunkcinis centras";Priešmokyklinė;2020364455;Taip;3;3;0;6
22708;"Vilniaus Saulėtekio mokykla-daugiafunkcinis centras";Priešmokyklinė;4787974814;Taip;0;1;3;4
22709;"Vilniaus Saulėtekio mokykla-daugiafunkcinis centras";Priešmokyklinė;6553762186;Taip;2;10;0;12
22710;"Vilniaus Saulėtekio mokykla-daugiafunkcinis centras";Priešmokyklinė;9057726203;Taip;20;2;0;22
22711;"Vilniaus Saulėtekio mokykla-daugiafunkcinis centras";Priešmokyklinė;6492909546;Taip;2;6;0;8
22712;"Vilniaus Saulėtekio mokykla-daugiafunkcinis centras";"PRIEŠMOKYKLINĖ 2";9963290362;Ne;5;1;1;7
22713;"Vilniaus Saulėtekio mokykla-daugiafunkcinis centras";"PRIEŠMOKYKLINĖ 2";1342094235;Taip;0;1;0;1
22714;"Vilniaus Saulėtekio mokykla-daugiafunkcinis centras";"PRIEŠMOKYKLINĖ 2";2628936055;Taip;0;5;0;5
22715;"Vilniaus Saulėtekio mokykla-daugiafunkcinis centras";"PRIEŠMOKYKLINĖ 2";1224648193;Taip;0;1;4;5
22716;"Vilniaus Saulėtekio mokykla-daugiafunkcinis centras";"PRIEŠMOKYKLINĖ 2";4542122478;Taip;3;1;2;6
22717;"Vilniaus Saulėtekio mokykla-daugiafunkcinis centras";"PRIEŠMOKYKLINĖ 2";4010917080;Taip;0;1;0;1
22718;"Vilniaus Saulėtekio mokykla-daugiafunkcinis centras";"PRIEŠMOKYKLINĖ 2";5927071864;Taip;0;1;1;2
22719;"Vilniaus Saulėtekio mokykla-daugiafunkcinis centras";"PRIEŠMOKYKLINĖ 2";4970499391;Ne;15;1;0;16
22720;"Vilniaus Saulėtekio mokykla-daugiafunkcinis centras";"PRIEŠMOKYKLINĖ 2";6593824471;Ne;11;1;2;14
22721;"Vilniaus Saulėtekio mokykla-daugiafunkcinis centras";"PRIEŠMOKYKLINĖ 2";8669346247;Taip;8;1;4;13
22722;"Vilniaus Saulėtekio mokykla-daugiafunkcinis centras";"PRIEŠMOKYKLINĖ 2";1924079984;Taip;1;1;0;2
22723;"Vilniaus Saulėtekio mokykla-daugiafunkcinis centras";"PRIEŠMOKYKLINĖ 2";5590376570;Ne;0;1;1;2
22724;"Vilniaus Saulėtekio mokykla-daugiafunkcinis centras";"PRIEŠMOKYKLINĖ 2";8766410254;Taip;0;1;0;1
22725;"Vilniaus Saulėtekio mokykla-daugiafunkcinis centras";"PRIEŠMOKYKLINĖ 2";4151582358;Taip;7;2;0;9
22726;"Vilniaus Saulėtekio mokykla-daugiafunkcinis centras";"PRIEŠMOKYKLINĖ 2";1376656872;Taip;0;1;6;7
22727;"Vilniaus Saulėtekio mokykla-daugiafunkcinis centras";"PRIEŠMOKYKLINĖ 2";3639632543;Taip;10;2;0;12
22728;"Vilniaus Saulėtekio mokykla-daugiafunkcinis centras";"PRIEŠMOKYKLINĖ 2";6865962441;Taip;10;2;0;12
22729;"Vilniaus Saulėtekio mokykla-daugiafunkcinis centras";"PRIEŠMOKYKLINĖ 2";3982877012;Taip;12;1;0;13
22730;"Vilniaus Saulėtekio mokykla-daugiafunkcinis centras";"PRIEŠMOKYKLINĖ 2";1660650556;Taip;0;2;0;2
22731;"Vilniaus Saulėtekio mokykla-daugiafunkcinis centras";"PRIEŠMOKYKLINĖ 2";4890393582;Taip;8;1;1;10
22732;"Vilniaus Saulėtekio mokykla-daugiafunkcinis centras";"PRIEŠMOKYKLINĖ 2";5304096806;Taip;10;1;1;12
22733;"Vilniaus Saulėtekio mokykla-daugiafunkcinis centras";"PRIEŠMOKYKLINĖ 2";1648983304;Taip;0;1;1;2
22734;"Vilniaus Saulėtekio mokykla-daugiafunkcinis centras";"PRIEŠMOKYKLINĖ 2";1913663230;Taip;0;1;0;1
22735;"Vilniaus Saulėtekio mokykla-daugiafunkcinis centras";"PRIEŠMOKYKLINĖ 2";1543123485;Taip;8;1;2;11
22736;"Vilniaus Saulėtekio mokykla-daugiafunkcinis centras";"PRIEŠMOKYKLINĖ 2";4176208765;Taip;0;7;0;7
22737;"Vilniaus Saulėtekio mokykla-daugiafunkcinis centras";"PRIEŠMOKYKLINĖ 2";8458361084;Taip;4;1;2;7
22738;"Vilniaus „Genio“ progimnazija";NYKŠTUKAI;6545116373;Taip;0;1;0;1
22739;"Vilniaus „Genio“ progimnazija";NYKŠTUKAI;1666616466;Taip;0;1;0;1
22740;"Vilniaus „Genio“ progimnazija";NYKŠTUKAI;3008272979;Taip;0;1;0;1
22741;"Vilniaus „Genio“ progimnazija";NYKŠTUKAI;96416364735;Taip;0;1;0;1
22742;"Vilniaus „Genio“ progimnazija";NYKŠTUKAI;2036966277;Taip;0;1;0;1
22743;"Vilniaus „Genio“ progimnazija";NYKŠTUKAI;1807466584;Taip;5;1;0;6
22744;"Vilniaus „Genio“ progimnazija";NYKŠTUKAI;4680264973;Taip;0;1;0;1
22745;"Vilniaus „Genio“ progimnazija";NYKŠTUKAI;5850506831;Taip;3;1;0;4
22746;"Vilniaus „Genio“ progimnazija";NYKŠTUKAI;3667800006;Taip;0;1;0;1
22747;"Vilniaus „Genio“ progimnazija";NYKŠTUKAI;2176438968;Taip;6;1;1;8
22748;"Vilniaus „Genio“ progimnazija";NYKŠTUKAI;7509276953;Taip;0;1;0;1
22749;"Vilniaus „Genio“ progimnazija";NYKŠTUKAI;1258769646;Taip;0;1;0;1
22750;"Vilniaus „Genio“ progimnazija";NYKŠTUKAI;2593226897;Ne;8;1;0;9
22751;"Vilniaus „Genio“ progimnazija";NYKŠTUKAI;7005815238;Ne;0;1;0;1
22752;"Vilniaus „Genio“ progimnazija";NYKŠTUKAI;3333552585;Taip;0;1;0;1
22753;"Vilniaus „Genio“ progimnazija";NYKŠTUKAI;5372809413;Taip;0;1;0;1
22754;"Vilniaus „Genio“ progimnazija";NYKŠTUKAI;1089753966;Taip;0;1;0;1
22755;"Vilniaus „Genio“ progimnazija";NYKŠTUKAI;6154837614;Taip;0;1;0;1
22756;"Vilniaus „Genio“ progimnazija";NYKŠTUKAI;2865995680;Taip;0;1;0;1
22757;"Vilniaus „Genio“ progimnazija";NYKŠTUKAI;1432694920;Taip;0;1;0;1
22758;"Vilniaus „Genio“ progimnazija";NYKŠTUKAI;1663216529;Taip;0;1;0;1
22759;"Gintarėlis (Popieriaus g. 46A)";SKRUZDĖLIUKAI;3825572125;Taip;0;1;0;1
22760;"Gintarėlis (Popieriaus g. 46A)";SKRUZDĖLIUKAI;5738933125;Taip;7;12;0;19
22761;"Gintarėlis (Popieriaus g. 46A)";SKRUZDĖLIUKAI;1994856959;Taip;0;1;0;1
22762;"Gintarėlis (Popieriaus g. 46A)";SKRUZDĖLIUKAI;8223747534;Taip;4;2;0;6
22763;"Gintarėlis (Popieriaus g. 46A)";SKRUZDĖLIUKAI;1045355492;Taip;10;3;0;13
22764;"Gintarėlis (Popieriaus g. 46A)";SKRUZDĖLIUKAI;6193540660;Ne;9;3;0;12
22765;"Gintarėlis (Popieriaus g. 46A)";SKRUZDĖLIUKAI;9153589128;Taip;6;1;0;7
22766;"Gintarėlis (Popieriaus g. 46A)";SKRUZDĖLIUKAI;3459439843;Taip;5;3;0;8
22767;"Gintarėlis (Popieriaus g. 46A)";SKRUZDĖLIUKAI;7510541192;Taip;6;0;0;6
22768;"Gintarėlis (Popieriaus g. 46A)";SKRUZDĖLIUKAI;9045108717;Taip;15;6;0;21
22769;"Gintarėlis (Popieriaus g. 46A)";SKRUZDĖLIUKAI;1955719034;Taip;11;1;0;12
22770;"Gintarėlis (Popieriaus g. 46A)";SKRUZDĖLIUKAI;1215549844;Taip;0;2;2;4
22771;"Gintarėlis (Popieriaus g. 46A)";SKRUZDĖLIUKAI;5379858630;Taip;0;1;8;9
22772;"Gintarėlis (Popieriaus g. 46A)";SKRUZDĖLIUKAI;8710469480;Taip;0;1;0;1
22773;"Gintarėlis (Popieriaus g. 46A)";SKRUZDĖLIUKAI;5961603860;Taip;0;4;0;4
22774;"Gintarėlis (Popieriaus g. 46A)";SKRUZDĖLIUKAI;8068499156;Taip;0;5;0;5
22775;"Gintarėlis (Popieriaus g. 46A)";PELĖDŽIUKAI;6506180216;Ne;0;5;0;5
22776;"Gintarėlis (Popieriaus g. 46A)";PELĖDŽIUKAI;9200073539;Ne;15;0;0;15
22777;"Gintarėlis (Popieriaus g. 46A)";PELĖDŽIUKAI;3254739432;Taip;0;0;1;1
22778;"Gintarėlis (Popieriaus g. 46A)";PELĖDŽIUKAI;8019543081;Taip;0;4;0;4
22779;"Gintarėlis (Popieriaus g. 46A)";PELĖDŽIUKAI;1628276472;Ne;2;1;0;3
22780;"Gintarėlis (Popieriaus g. 46A)";PELĖDŽIUKAI;5223116373;Taip;11;0;0;11
22781;"Gintarėlis (Popieriaus g. 46A)";PELĖDŽIUKAI;8792175474;Ne;4;2;1;7
22782;"Gintarėlis (Popieriaus g. 46A)";PELĖDŽIUKAI;3304191482;Taip;0;2;0;2
22783;"Gintarėlis (Popieriaus g. 46A)";PELĖDŽIUKAI;2731865977;Taip;0;2;0;2
22784;"Gintarėlis (Popieriaus g. 46A)";PELĖDŽIUKAI;4181430769;Taip;0;7;0;7
22785;"Gintarėlis (Popieriaus g. 46A)";PELĖDŽIUKAI;3202819190;Taip;0;0;2;2
22786;"Gintarėlis (Popieriaus g. 46A)";PELĖDŽIUKAI;9807784148;Ne;7;0;0;7
22787;"Gintarėlis (Popieriaus g. 46A)";PELĖDŽIUKAI;2546360134;Taip;6;0;0;6
22788;"Gintarėlis (Popieriaus g. 46A)";PELĖDŽIUKAI;6883573289;Ne;14;2;0;16
22789;"Gintarėlis (Popieriaus g. 46A)";PELĖDŽIUKAI;3127881266;Taip;0;0;1;1
22790;"Gintarėlis (Popieriaus g. 46A)";PELĖDŽIUKAI;2052962147;Taip;9;0;4;13
22791;"Gintarėlis (Popieriaus g. 46A)";"LINKSMASIS AVILYS";7872515649;Taip;11;1;0;12
22792;"Gintarėlis (Popieriaus g. 46A)";"LINKSMASIS AVILYS";7256557310;Taip;0;8;0;8
22793;"Gintarėlis (Popieriaus g. 46A)";"LINKSMASIS AVILYS";6425840559;Taip;0;0;14;14
22794;"Gintarėlis (Popieriaus g. 46A)";"LINKSMASIS AVILYS";3572188688;Taip;10;2;2;14
22795;"Gintarėlis (Popieriaus g. 46A)";"LINKSMASIS AVILYS";7010430969;Taip;0;7;0;7
22796;"Gintarėlis (Popieriaus g. 46A)";"LINKSMASIS AVILYS";7734802846;Taip;0;5;0;5
22797;"Gintarėlis (Popieriaus g. 46A)";"LINKSMASIS AVILYS";1070119148;Taip;0;6;0;6
22798;"Gintarėlis (Popieriaus g. 46A)";"LINKSMASIS AVILYS";3738678648;Taip;0;6;0;6
22799;"Gintarėlis (Popieriaus g. 46A)";"LINKSMASIS AVILYS";77906464117;Taip;0;3;0;3
22800;"Gintarėlis (Popieriaus g. 46A)";"LINKSMASIS AVILYS";8680339493;Taip;0;4;0;4
22801;"Gintarėlis (Popieriaus g. 46A)";Varliukai;6821929306;Taip;0;9;0;9
22802;"Gintarėlis (Popieriaus g. 46A)";Varliukai;7274616480;Taip;0;6;0;6
22803;"Gintarėlis (Popieriaus g. 46A)";Varliukai;1362980885;Taip;14;3;0;17
22804;"Gintarėlis (Popieriaus g. 46A)";Varliukai;9762364250;Taip;0;3;0;3
22805;"Gintarėlis (Popieriaus g. 46A)";Varliukai;4263315669;Taip;15;0;0;15
22806;"Gintarėlis (Popieriaus g. 46A)";Varliukai;5190355636;Taip;3;1;0;4
22807;"Gintarėlis (Popieriaus g. 46A)";Varliukai;7206593645;Ne;5;0;6;11
22808;"Gintarėlis (Popieriaus g. 46A)";Varliukai;7400455090;Taip;0;13;0;13
22809;"Gintarėlis (Popieriaus g. 46A)";Varliukai;3702588434;Taip;0;0;9;9
22810;"Gintarėlis (Popieriaus g. 46A)";Varliukai;7413074674;Ne;11;0;1;12
22811;"Gintarėlis (Popieriaus g. 46A)";Varliukai;7031945895;Taip;8;5;0;13
22812;"Gintarėlis (Popieriaus g. 46A)";Varliukai;6514247750;Taip;0;0;1;1
22813;"Gintarėlis (Popieriaus g. 46A)";Varliukai;1166720069;Taip;5;0;0;5
22814;"Gintarėlis (Popieriaus g. 46A)";Varliukai;4556644354;Taip;4;0;0;4
22815;"Gintarėlis (Popieriaus g. 46A)";Varliukai;7510641510;Taip;0;0;3;3
22816;"Pušynėlis (A. Mickevičiaus g. 21)";DAIGIUKAI;5317547220;Taip;11;0;1;12
22817;"Pušynėlis (A. Mickevičiaus g. 21)";DAIGIUKAI;9025539389;Taip;11;0;4;15
22818;"Pušynėlis (A. Mickevičiaus g. 21)";DAIGIUKAI;5512586591;Taip;12;0;0;12
22819;"Pušynėlis (A. Mickevičiaus g. 21)";DAIGIUKAI;6594473055;Taip;8;1;0;9
22820;"Pušynėlis (A. Mickevičiaus g. 21)";DAIGIUKAI;8211464695;Taip;9;0;1;10
22821;"Pušynėlis (A. Mickevičiaus g. 21)";DAIGIUKAI;6321178561;Taip;12;2;0;14
22822;"Pušynėlis (A. Mickevičiaus g. 21)";DAIGIUKAI;8457384507;Ne;1;0;5;6
22823;"Pušynėlis (A. Mickevičiaus g. 21)";DAIGIUKAI;1085678424;Taip;15;0;3;18
22824;"Pušynėlis (A. Mickevičiaus g. 21)";DAIGIUKAI;9710499937;Taip;11;5;0;16
22825;"Pušynėlis (A. Mickevičiaus g. 21)";DAIGIUKAI;4685125111;Taip;11;0;1;12
22826;"Pušynėlis (A. Mickevičiaus g. 21)";DAIGIUKAI;9717473430;Taip;5;4;0;9
22827;"Pušynėlis (A. Mickevičiaus g. 21)";DAIGIUKAI;2763762463;Taip;0;1;7;8
22828;"Pušynėlis (A. Mickevičiaus g. 21)";NYKŠTUKAI;1050710006;Ne;16;0;0;16
22829;"Pušynėlis (A. Mickevičiaus g. 21)";NYKŠTUKAI;1758632291;Ne;10;1;0;11
22830;"Pušynėlis (A. Mickevičiaus g. 21)";NYKŠTUKAI;8699085292;Taip;4;1;0;5
22831;"Pušynėlis (A. Mickevičiaus g. 21)";NYKŠTUKAI;8327830781;Taip;9;0;3;12
22832;"Pušynėlis (A. Mickevičiaus g. 21)";NYKŠTUKAI;8820865805;Taip;11;3;0;14
22833;"Pušynėlis (A. Mickevičiaus g. 21)";NYKŠTUKAI;9520423020;Taip;11;3;0;14
22834;"Pušynėlis (A. Mickevičiaus g. 21)";NYKŠTUKAI;1177938753;Taip;5;1;0;6
22835;"Pušynėlis (A. Mickevičiaus g. 21)";NYKŠTUKAI;9450347140;Taip;0;3;1;4
22836;"Pušynėlis (A. Mickevičiaus g. 21)";NYKŠTUKAI;2222790161;Taip;0;4;6;10
22837;"Pušynėlis (A. Mickevičiaus g. 21)";NYKŠTUKAI;7596876368;Taip;8;2;1;11
22838;"Pušynėlis (A. Mickevičiaus g. 21)";NYKŠTUKAI;2892213973;Taip;0;1;0;1
22839;"Pušynėlis (A. Mickevičiaus g. 21)";NYKŠTUKAI;7429853563;Taip;0;3;0;3
22840;"Pušynėlis (A. Mickevičiaus g. 21)";NYKŠTUKAI;8464672994;Taip;3;2;0;5
22841;"Pušynėlis (A. Mickevičiaus g. 21)";NYKŠTUKAI;1904434730;Taip;2;0;5;7
22842;"Pušynėlis (A. Mickevičiaus g. 21)";NYKŠTUKAI;3574446664;Ne;0;2;3;5
22843;"Pušynėlis (A. Mickevičiaus g. 21)";NYKŠTUKAI;3362971538;Taip;3;2;3;8
22844;"Pušynėlis (A. Mickevičiaus g. 21)";NYKŠTUKAI;9055713601;Taip;0;0;1;1
22845;"Pušynėlis (A. Mickevičiaus g. 21)";NYKŠTUKAI;5364537212;Taip;2;3;4;9
22846;"Pušynėlis (A. Mickevičiaus g. 21)";NYKŠTUKAI;7172604103;Taip;0;0;2;2
22847;"Pušynėlis (A. Mickevičiaus g. 21)";NYKŠTUKAI;8839614928;Ne;3;2;6;11
22848;"Pušynėlis (A. Mickevičiaus g. 21)";GILIUKAI;9401101407;Taip;0;1;0;1
22849;"Pušynėlis (A. Mickevičiaus g. 21)";GILIUKAI;4997004998;Ne;5;1;0;6
22850;"Pušynėlis (A. Mickevičiaus g. 21)";GILIUKAI;9517319856;Taip;3;1;0;4
22851;"Pušynėlis (A. Mickevičiaus g. 21)";GILIUKAI;9028515427;Taip;5;3;2;10
22852;"Pušynėlis (A. Mickevičiaus g. 21)";GILIUKAI;2825756894;Taip;16;1;0;17
22853;"Pušynėlis (A. Mickevičiaus g. 21)";GILIUKAI;1134325833;Taip;0;1;5;6
22854;"Pušynėlis (A. Mickevičiaus g. 21)";GILIUKAI;3158789663;Ne;0;2;1;3
22855;"Pušynėlis (A. Mickevičiaus g. 21)";GILIUKAI;5668765825;Taip;10;3;0;13
22856;"Pušynėlis (A. Mickevičiaus g. 21)";GILIUKAI;3954867816;Taip;0;3;1;4
22857;"Pušynėlis (A. Mickevičiaus g. 21)";GILIUKAI;7685809238;Taip;4;8;0;12
22858;"Pušynėlis (A. Mickevičiaus g. 21)";GILIUKAI;2712755125;Taip;0;2;3;5
22859;"Pušynėlis (A. Mickevičiaus g. 21)";GILIUKAI;7011836009;Taip;1;10;0;11
22860;"Pušynėlis (A. Mickevičiaus g. 21)";GILIUKAI;3301741162;Taip;7;1;0;8
22861;"Pušynėlis (A. Mickevičiaus g. 21)";GILIUKAI;6735037523;Taip;0;2;1;3
22862;"Pušynėlis (A. Mickevičiaus g. 21)";GILIUKAI;9147558926;Taip;0;1;0;1
22863;"Pušynėlis (A. Mickevičiaus g. 21)";GILIUKAI;7881263225;Taip;4;6;0;10
22864;"Pušynėlis (A. Mickevičiaus g. 21)";GILIUKAI;1612049897;Taip;10;2;0;12
22865;"Pušynėlis (A. Mickevičiaus g. 21)";GILIUKAI;9920959446;Taip;0;1;0;1
22866;"Pušynėlis (A. Mickevičiaus g. 21)";GILIUKAI;4898147530;Taip;4;1;0;5
22867;"Pušynėlis (A. Mickevičiaus g. 21)";GILIUKAI;2228682366;Ne;8;6;0;14
22868;"Pušynėlis (A. Mickevičiaus g. 21)";GILIUKAI;4464615995;Taip;0;1;0;1
22869;"Naminukas (Klinikų g. 5)";VARPELIAI;2089455192;Taip;11;1;0;12
22870;"Naminukas (Klinikų g. 5)";VARPELIAI;3281707263;Ne;0;0;5;5
22871;"Naminukas (Klinikų g. 5)";VARPELIAI;1828220049;Taip;3;0;3;6
22872;"Naminukas (Klinikų g. 5)";VARPELIAI;7328682222;Taip;0;0;7;7
22873;"Naminukas (Klinikų g. 5)";VARPELIAI;7772300667;Taip;9;0;0;9
22874;"Naminukas (Klinikų g. 5)";VARPELIAI;1086919259;Taip;14;0;1;15
22875;"Naminukas (Klinikų g. 5)";VARPELIAI;5991261279;Taip;4;0;5;9
22876;"Naminukas (Klinikų g. 5)";VARPELIAI;8694425584;Taip;13;0;0;13
22877;"Naminukas (Klinikų g. 5)";VARPELIAI;8782832803;Taip;5;0;0;5
22878;"Naminukas (Klinikų g. 5)";VARPELIAI;5172385044;Taip;6;0;0;6
22879;"Naminukas (Klinikų g. 5)";VARPELIAI;5465843371;Taip;0;3;2;5
22880;"Naminukas (Klinikų g. 5)";VARPELIAI;6515021073;Taip;7;0;0;7
22881;"Naminukas (Klinikų g. 5)";VARPELIAI;9894306360;Taip;4;0;3;7
22882;"Naminukas (Klinikų g. 5)";VARPELIAI;8052458976;Taip;16;0;4;20
22883;"Naminukas (Klinikų g. 5)";SAULUTĖS;9215327479;Taip;18;0;0;18
22884;"Naminukas (Klinikų g. 5)";SAULUTĖS;7947598191;Taip;0;1;0;1
22885;"Naminukas (Klinikų g. 5)";SAULUTĖS;1635395128;Taip;0;10;0;10
22886;"Naminukas (Klinikų g. 5)";SAULUTĖS;3911352454;Taip;14;0;1;15
22887;"Naminukas (Klinikų g. 5)";SAULUTĖS;7107337857;Taip;0;0;3;3
22888;"Naminukas (Klinikų g. 5)";SAULUTĖS;3079900548;Taip;19;0;0;19
22889;"Naminukas (Klinikų g. 5)";SAULUTĖS;7301768930;Ne;0;0;3;3
22890;"Naminukas (Klinikų g. 5)";SAULUTĖS;2516513740;Taip;0;1;6;7
22891;"Naminukas (Klinikų g. 5)";SAULUTĖS;2336627398;Taip;0;0;2;2
22892;"Naminukas (Klinikų g. 5)";SAULUTĖS;1879925655;Taip;3;1;1;5
22893;"Naminukas (Klinikų g. 5)";SAULUTĖS;2881576194;Ne;5;0;3;8
22894;"Naminukas (Klinikų g. 5)";SAULUTĖS;6901818921;Ne;15;0;0;15
22895;"Naminukas (Klinikų g. 5)";SAULUTĖS;4836599508;Taip;0;0;3;3
22896;"Naminukas (Klinikų g. 5)";SAULUTĖS;1563213488;Taip;5;0;1;6
22897;"Naminukas (Klinikų g. 5)";SAULUTĖS;4709625816;Ne;0;0;1;1
22898;"Naminukas (Klinikų g. 5)";SAULUTĖS;1932169696;Taip;6;0;0;6
22899;"Naminukas (Klinikų g. 5)";DRUGELIAI;2339599448;Taip;1;7;0;8
22900;"Naminukas (Klinikų g. 5)";DRUGELIAI;4077985773;Taip;0;1;5;6
22901;"Naminukas (Klinikų g. 5)";DRUGELIAI;3276656641;Taip;0;0;7;7
22902;"Naminukas (Klinikų g. 5)";DRUGELIAI;6633031473;Taip;5;0;1;6
22903;"Naminukas (Klinikų g. 5)";DRUGELIAI;4116151797;Ne;0;0;4;4
22904;"Naminukas (Klinikų g. 5)";DRUGELIAI;7033053271;Taip;6;0;2;8
22905;"Naminukas (Klinikų g. 5)";DRUGELIAI;1454039572;Ne;13;0;1;14
22906;"Naminukas (Klinikų g. 5)";DRUGELIAI;9740815635;Taip;7;0;0;7
22907;"Naminukas (Klinikų g. 5)";DRUGELIAI;7184471307;Taip;0;0;2;2
22908;"Naminukas (Klinikų g. 5)";DRUGELIAI;6949857110;Taip;5;0;0;5
22909;"Naminukas (Klinikų g. 5)";DRUGELIAI;8039086094;Taip;0;0;3;3
22910;"Naminukas (Klinikų g. 5)";DRUGELIAI;8432194383;Taip;14;1;0;15
22911;"Naminukas (Klinikų g. 5)";DRUGELIAI;7463647806;Taip;0;0;1;1
22912;"Naminukas (Klinikų g. 5)";DRUGELIAI;4171789569;Taip;0;11;0;11
22913;"Naminukas (Klinikų g. 5)";DRUGELIAI;6880075874;Taip;2;2;0;4
22914;"Naminukas (Klinikų g. 5)";DRUGELIAI;8793327541;Taip;0;1;0;1
22915;"Naminukas (Klinikų g. 5)";DRUGELIAI;9835701381;Ne;0;0;1;1
22916;"Naminukas (Klinikų g. 5)";BITUTĖS;21152690883;Taip;0;1;0;1
22917;"Naminukas (Klinikų g. 5)";BITUTĖS;1679106754;Taip;0;7;0;7
22918;"Naminukas (Klinikų g. 5)";BITUTĖS;1528496272;Taip;1;1;0;2
22919;"Naminukas (Klinikų g. 5)";BITUTĖS;92417802345;Taip;0;1;0;1
22920;"Naminukas (Klinikų g. 5)";BITUTĖS;1180176295;Taip;0;2;0;2
22921;"Naminukas (Klinikų g. 5)";BITUTĖS;9903990297;Taip;0;1;0;1
22922;"Naminukas (Klinikų g. 5)";BITUTĖS;6592057292;Taip;8;1;0;9
22923;"Naminukas (Klinikų g. 5)";BITUTĖS;5578151523;Taip;1;0;1;2
22924;"Naminukas (Klinikų g. 5)";BITUTĖS;4353031174;Taip;1;1;0;2
22925;"Naminukas (Klinikų g. 5)";BITUTĖS;9178907705;Taip;2;1;2;5
22926;"Naminukas (Klinikų g. 5)";BITUTĖS;5288557629;Taip;5;4;0;9
22927;"Naminukas (Klinikų g. 5)";BITUTĖS;5233044803;Ne;2;0;0;2
22928;"Naminukas (Klinikų g. 5)";BITUTĖS;1346035733;Taip;0;3;0;3
22929;"Naminukas (Klinikų g. 5)";BITUTĖS;1730248631;Taip;0;1;0;1
22930;"Naminukas (Klinikų g. 5)";BITUTĖS;3791118736;Taip;5;0;1;6
22931;"Naminukas (Klinikų g. 5)";BITUTĖS;1394918021;Taip;2;0;0;2
22932;"Naminukas (Klinikų g. 5)";BITUTĖS;7099787230;Taip;5;1;0;6
22933;"Naminukas (Klinikų g. 5)";BITUTĖS;3088386659;Taip;0;1;0;1
22934;"Gervelė (Stadiono g. 5)";BORUŽĖLĖS;6427072260;Taip;3;0;0;3
22935;"Gervelė (Stadiono g. 5)";BORUŽĖLĖS;9777308731;Taip;6;0;0;6
22936;"Gervelė (Stadiono g. 5)";BORUŽĖLĖS;5285868851;Taip;2;0;0;2
22937;"Gervelė (Stadiono g. 5)";BORUŽĖLĖS;2712133300;Taip;4;0;0;4
22938;"Gervelė (Stadiono g. 5)";BORUŽĖLĖS;2622183564;Ne;2;15;0;17
22939;"Gervelė (Stadiono g. 5)";BORUŽĖLĖS;1006720360;Taip;5;1;0;6
22940;"Gervelė (Stadiono g. 5)";BORUŽĖLĖS;8190190100;Taip;0;8;0;8
22941;"Gervelė (Stadiono g. 5)";BORUŽĖLĖS;6338612770;Taip;1;0;0;1
22942;"Gervelė (Stadiono g. 5)";BORUŽĖLĖS;6004269553;Taip;13;0;0;13
22943;"Gervelė (Stadiono g. 5)";BORUŽĖLĖS;6573919007;Ne;14;0;0;14
22944;"Gervelė (Stadiono g. 5)";BORUŽĖLĖS;8797608822;Ne;0;5;0;5
22945;"Gervelė (Stadiono g. 5)";PAUKŠTELIAI;8423813651;Ne;2;0;1;3
22946;"Gervelė (Stadiono g. 5)";PAUKŠTELIAI;7959839478;Ne;0;1;0;1
22947;"Gervelė (Stadiono g. 5)";PAUKŠTELIAI;2031118410;Taip;0;10;0;10
22948;"Gervelė (Stadiono g. 5)";PAUKŠTELIAI;5966215998;Taip;14;0;0;14
22949;"Gervelė (Stadiono g. 5)";PAUKŠTELIAI;7463376031;Taip;0;17;0;17
22950;"Gervelė (Stadiono g. 5)";PAUKŠTELIAI;3567687304;Taip;0;5;0;5
22951;"Gervelė (Stadiono g. 5)";PAUKŠTELIAI;6372245141;Taip;0;1;0;1
22952;"Gervelė (Stadiono g. 5)";PAUKŠTELIAI;2892214705;Taip;6;0;0;6
22953;"Gervelė (Stadiono g. 5)";PAUKŠTELIAI;7952102572;Taip;16;0;0;16
22954;"Gervelė (Stadiono g. 5)";PAUKŠTELIAI;2372820133;Taip;6;0;0;6
22955;"Gervelė (Stadiono g. 5)";PAUKŠTELIAI;9154032804;Ne;0;10;0;10
22956;"Gervelė (Stadiono g. 5)";PAUKŠTELIAI;3676856569;Taip;0;1;0;1
22957;"Gervelė (Stadiono g. 5)";PAUKŠTELIAI;4588890423;Taip;0;12;0;12
22958;"Gervelė (Stadiono g. 5)";SPINDULĖLIAI;4508176017;Ne;0;0;2;2
22959;"Gervelė (Stadiono g. 5)";SPINDULĖLIAI;4051246539;Ne;6;0;0;6
22960;"Gervelė (Stadiono g. 5)";SPINDULĖLIAI;1020095914;Taip;7;1;0;8
22961;"Gervelė (Stadiono g. 5)";SPINDULĖLIAI;5705915729;Taip;2;0;0;2
22962;"Gervelė (Stadiono g. 5)";SPINDULĖLIAI;6241611652;Taip;0;1;0;1
22963;"Gervelė (Stadiono g. 5)";SPINDULĖLIAI;2207041148;Taip;1;0;3;4
22964;"Gervelė (Stadiono g. 5)";SPINDULĖLIAI;8472436632;Ne;0;15;0;15
22965;"Gervelė (Stadiono g. 5)";SPINDULĖLIAI;1204513844;Taip;3;1;0;4
22966;"Gervelė (Stadiono g. 5)";SPINDULĖLIAI;7419432731;Taip;1;0;0;1
22967;"Gervelė (Stadiono g. 5)";SPINDULĖLIAI;1611114179;Ne;0;1;3;4
22968;"Gervelė (Stadiono g. 5)";SPINDULĖLIAI;8710469480;Taip;5;0;0;5
22969;"Gervelė (Stadiono g. 5)";GĖLYTĖS;6172016747;Taip;5;1;0;6
22970;"Gervelė (Stadiono g. 5)";GĖLYTĖS;3873345138;Ne;0;5;0;5
22971;"Gervelė (Stadiono g. 5)";GĖLYTĖS;5518309115;Taip;16;1;0;17
22972;"Gervelė (Stadiono g. 5)";GĖLYTĖS;2744433344;Taip;0;7;0;7
22973;"Gervelė (Stadiono g. 5)";GĖLYTĖS;4930308435;Taip;0;1;0;1
22974;"Gervelė (Stadiono g. 5)";GĖLYTĖS;6621769160;Taip;9;3;0;12
22975;"Gervelė (Stadiono g. 5)";GĖLYTĖS;7115198351;Taip;6;0;0;6
22976;"Gervelė (Stadiono g. 5)";GĖLYTĖS;4505873061;Ne;0;1;0;1
22977;"Gervelė (Stadiono g. 5)";GĖLYTĖS;4832348492;Taip;5;1;0;6
22978;"Gervelė (Stadiono g. 5)";GĖLYTĖS;7855598075;Taip;0;6;0;6
22979;"Gervelė (Stadiono g. 5)";GĖLYTĖS;4424095457;Taip;20;1;0;21
22980;"Gervelė (Stadiono g. 5)";GĖLYTĖS;8777858708;Ne;0;5;0;5
22981;"Gervelė (Stadiono g. 5)";GĖLYTĖS;6488139414;Taip;5;0;0;5
22982;"Gervelė (Stadiono g. 5)";GĖLYTĖS;3216423543;Taip;5;1;0;6
22983;"Gervelė (Stadiono g. 5)";GĖLYTĖS;4925983616;Taip;7;1;0;8
22984;"Gervelė (Stadiono g. 5)";GĖLYTĖS;4895554383;Taip;0;0;1;1
22985;"Gervelė (Stadiono g. 5)";GĖLYTĖS;7387250891;Ne;5;1;0;6
22986;"Gervelė (Stadiono g. 5)";GĖLYTĖS;3490370918;Ne;0;4;0;4
22987;"Gervelė (Stadiono g. 5)";GĖLYTĖS;9183582003;Ne;0;4;0;4
22988;"Kūlverstukas (Mindaugo g. 7)";GNOMIKI;1720671485;Ne;1;0;0;1
22989;"Kūlverstukas (Mindaugo g. 7)";GNOMIKI;4894478262;Taip;18;0;0;18
22990;"Kūlverstukas (Mindaugo g. 7)";GNOMIKI;2501327054;Ne;0;5;0;5
22991;"Kūlverstukas (Mindaugo g. 7)";GNOMIKI;8348978878;Taip;6;4;0;10
22992;"Kūlverstukas (Mindaugo g. 7)";GNOMIKI;8927489885;Taip;9;0;3;12
22993;"Kūlverstukas (Mindaugo g. 7)";GNOMIKI;2709547427;Ne;5;1;0;6
22994;"Kūlverstukas (Mindaugo g. 7)";GNOMIKI;5532063862;Taip;11;0;0;11
22995;"Kūlverstukas (Mindaugo g. 7)";GNOMIKI;5747277587;Taip;0;1;0;1
22996;"Kūlverstukas (Mindaugo g. 7)";GNOMIKI;1848018684;Taip;0;1;0;1
22997;"Kūlverstukas (Mindaugo g. 7)";GNOMIKI;1166429762;Taip;13;0;0;13
22998;"Kūlverstukas (Mindaugo g. 7)";GNOMIKI;6514730230;Taip;9;1;0;10
22999;"Kūlverstukas (Mindaugo g. 7)";GNOMIKI;5298776235;Taip;8;3;0;11
23000;"Kūlverstukas (Mindaugo g. 7)";GNOMIKI;4116831802;Ne;12;0;0;12
23001;"Kūlverstukas (Mindaugo g. 7)";GNOMIKI;4677564389;Ne;0;4;0;4
23002;"Kūlverstukas (Mindaugo g. 7)";GNOMIKI;1916522637;Taip;0;0;2;2
23003;"Kūlverstukas (Mindaugo g. 7)";GNOMIKI;3239566139;Taip;0;9;0;9
23004;"Kūlverstukas (Mindaugo g. 7)";ZAIČIATA;8994705290;Taip;5;7;0;12
23005;"Kūlverstukas (Mindaugo g. 7)";ZAIČIATA;8496678513;Taip;1;0;0;1
23006;"Kūlverstukas (Mindaugo g. 7)";ZAIČIATA;7933156766;Ne;0;7;1;8
23007;"Kūlverstukas (Mindaugo g. 7)";ZAIČIATA;2494202134;Ne;0;2;0;2
23008;"Kūlverstukas (Mindaugo g. 7)";ZAIČIATA;4998847820;Ne;0;0;10;10
23009;"Kūlverstukas (Mindaugo g. 7)";ZAIČIATA;4271185150;Ne;1;0;3;4
23010;"Kūlverstukas (Mindaugo g. 7)";ZAIČIATA;3660002342;Taip;0;0;5;5
23011;"Kūlverstukas (Mindaugo g. 7)";ZAIČIATA;5079635330;Taip;0;2;0;2
23012;"Kūlverstukas (Mindaugo g. 7)";ZAIČIATA;5879283662;Taip;0;0;1;1
23013;"Kūlverstukas (Mindaugo g. 7)";ZAIČIATA;3067918179;Ne;5;2;0;7
23014;"Kūlverstukas (Mindaugo g. 7)";ZAIČIATA;1776176097;Taip;15;0;0;15
23015;"Kūlverstukas (Mindaugo g. 7)";ZAIČIATA;6685524805;Taip;0;12;0;12
23016;"Kūlverstukas (Mindaugo g. 7)";SVETLIAČKI;6219872984;Taip;0;0;3;3
23017;"Kūlverstukas (Mindaugo g. 7)";SVETLIAČKI;9098427210;Taip;4;0;9;13
23018;"Kūlverstukas (Mindaugo g. 7)";SVETLIAČKI;2091204077;Ne;4;5;0;9
23019;"Kūlverstukas (Mindaugo g. 7)";SVETLIAČKI;70033583066;Taip;0;6;0;6
23020;"Kūlverstukas (Mindaugo g. 7)";SVETLIAČKI;2154916232;Taip;0;8;0;8
23021;"Kūlverstukas (Mindaugo g. 7)";SVETLIAČKI;9535522910;Ne;0;0;3;3
23022;"Kūlverstukas (Mindaugo g. 7)";SVETLIAČKI;6376189019;Taip;17;2;0;19
23023;"Kūlverstukas (Mindaugo g. 7)";SVETLIAČKI;1557237011;Taip;0;2;6;8
23024;"Kūlverstukas (Mindaugo g. 7)";SVETLIAČKI;7829384850;Ne;2;1;0;3
23025;"Kūlverstukas (Mindaugo g. 7)";SVETLIAČKI;8577197481;Ne;5;2;7;14
23026;"Kūlverstukas (Mindaugo g. 7)";SVETLIAČKI;3449300504;Taip;5;7;0;12
23027;"Kūlverstukas (Mindaugo g. 7)";SVETLIAČKI;1102996499;Taip;0;3;0;3
23028;"Kūlverstukas (Mindaugo g. 7)";SVETLIAČKI;6311116034;Taip;0;3;0;3
23029;"Kūlverstukas (Mindaugo g. 7)";SVETLIAČKI;5546604017;Taip;0;2;6;8
23030;"Kūlverstukas (Mindaugo g. 7)";SVETLIAČKI;1635418112;Taip;0;0;1;1
23031;"Kūlverstukas (Mindaugo g. 7)";ZVONOČKI;1486878343;Taip;4;0;1;5
23032;"Kūlverstukas (Mindaugo g. 7)";ZVONOČKI;8835111916;Taip;0;2;0;2
23033;"Kūlverstukas (Mindaugo g. 7)";ZVONOČKI;5724787637;Taip;0;1;0;1
23034;"Kūlverstukas (Mindaugo g. 7)";ZVONOČKI;4377803110;Taip;0;3;0;3
23035;"Kūlverstukas (Mindaugo g. 7)";ZVONOČKI;7898746258;Taip;0;0;6;6
23036;"Kūlverstukas (Mindaugo g. 7)";ZVONOČKI;9835391223;Taip;0;1;0;1
23037;"Kūlverstukas (Mindaugo g. 7)";ZVONOČKI;2429527586;Taip;0;0;6;6
23038;"Kūlverstukas (Mindaugo g. 7)";ZVONOČKI;5217751936;Taip;0;15;0;15
23039;"Kūlverstukas (Mindaugo g. 7)";ZVONOČKI;1566191212;Taip;0;2;1;3
23040;"Kūlverstukas (Mindaugo g. 7)";ZVONOČKI;9569296370;Taip;15;4;0;19
23041;"Kūlverstukas (Mindaugo g. 7)";ZVONOČKI;1047459617;Taip;0;1;0;1
23042;"Kūlverstukas (Mindaugo g. 7)";ZVONOČKI;9756326725;Taip;10;0;6;16
23043;"Kūlverstukas (Mindaugo g. 7)";ZVONOČKI;9156801640;Taip;12;2;4;18
23044;"Kūlverstukas (Mindaugo g. 7)";ZVONOČKI;1125206576;Taip;0;9;0;9
23045;"Kūlverstukas (Mindaugo g. 7)";ZVONOČKI;5728941778;Ne;0;8;4;12
23046;"Kūlverstukas (Mindaugo g. 7)";ZVONOČKI;5938022496;Ne;7;2;0;9
23047;"Vilniaus Pavilnio pagrindinė mokykla";"PRIEŠMOKYKLINĖ PL";2738553283;Taip;17;1;0;18
23048;"Vilniaus Pavilnio pagrindinė mokykla";"PRIEŠMOKYKLINĖ PL";2101902207;Taip;0;21;0;21
23049;"Vilniaus Pavilnio pagrindinė mokykla";"PRIEŠMOKYKLINĖ PL";1957926887;Taip;0;21;0;21
23050;"Vilniaus Pavilnio pagrindinė mokykla";"PRIEŠMOKYKLINĖ RU";4339607826;Ne;6;1;0;7
23051;"Vilniaus Pavilnio pagrindinė mokykla";"PRIEŠMOKYKLINĖ RU";3609961581;Taip;12;1;0;13
23052;"Vilniaus Pavilnio pagrindinė mokykla";"PRIEŠMOKYKLINĖ RU";1568915914;Taip;10;1;2;13
23053;"Vilniaus Pavilnio pagrindinė mokykla";"PRIEŠMOKYKLINĖ RU";5619763557;Ne;0;21;0;21
23054;"Vilniaus Pavilnio pagrindinė mokykla";"PRIEŠMOKYKLINĖ RU";9759761725;Ne;0;21;0;21
23055;"Vilniaus Pavilnio pagrindinė mokykla";"PRIEŠMOKYKLINĖ RU";3058369504;Ne;2;11;0;13
23056;"Vilniaus Pavilnio pagrindinė mokykla";"PRIEŠMOKYKLINĖ RU";9142513631;Taip;11;1;0;12
23057;"Vilniaus Pavilnio pagrindinė mokykla";"PRIEŠMOKYKLINĖ RU";5972567526;Taip;0;1;1;2
23058;"Vilniaus Pavilnio pagrindinė mokykla";"PRIEŠMOKYKLINĖ RU";2846917348;Taip;10;1;0;11
23059;"Vilniaus Pavilnio pagrindinė mokykla";"PRIEŠMOKYKLINĖ RU";6067622823;Taip;0;1;4;5
23060;"Vilniaus Pavilnio pagrindinė mokykla";"PRIEŠMOKYKLINĖ RU";3243226933;Ne;6;1;2;9
23061;"Vilniaus Pavilnio pagrindinė mokykla";"PRIEŠMOKYKLINĖ RU";7544963724;Taip;8;1;1;10
23062;"Vilniaus Pavilnio pagrindinė mokykla";"PRIEŠMOKYKLINĖ RU";6216663291;Taip;4;1;0;5
23063;"Vilniaus Pavilnio pagrindinė mokykla";"PRIEŠMOKYKLINĖ RU";3282845685;Taip;0;1;8;9
23064;"Vilniaus Šilo mokykla";Boružėlės;7122041826;Taip;1;1;0;2
23065;"Vilniaus Šilo mokykla";Boružėlės;9967276147;Taip;10;1;0;11
23066;"Vilniaus Šilo mokykla";Boružėlės;5962551687;Ne;15;1;0;16
23067;"Vilniaus Šilo mokykla";Boružėlės;1196172221;Ne;6;1;0;7
23068;"Vilniaus Šilo mokykla";Boružėlės;1538635985;Taip;30;1;0;31
23069;"Vilniaus Šilo mokykla";Boružėlės;6136087920;Taip;0;21;0;21
23070;"Vilniaus Šilo mokykla";Boružėlės;4544126354;Taip;9;1;0;10
23071;"Vilniaus Šilo mokykla";"1 spec.";1153167430;Taip;2;0;0;2
23072;"Vilniaus Šilo mokykla";"1 spec.";8863021708;Taip;4;1;0;5
23073;"Vilniaus Šilo mokykla";"1 spec.";4438939800;Taip;8;1;0;9
23074;"Vilniaus Šilo mokykla";"1 spec.";1971717759;Taip;6;1;0;7
23075;"Vilniaus Šilo mokykla";"1 spec.";2290889395;Taip;0;1;0;1
23076;"Vilniaus Šilo mokykla";"1 spec.";1180183091;Ne;0;21;0;21
23077;"Vilniaus Šilo mokykla";"6 lav.";29353956408;Taip;6;1;0;7
23078;"Vilniaus Šilo mokykla";"6 lav.";83007167743;Ne;1;1;0;2
23079;"Vilniaus Šilo mokykla";"6 lav.";67989956617;Taip;0;21;0;21
23080;"Vilniaus Šilo mokykla";"6 lav.";49892720109;Taip;0;1;0;1
23081;"Vilniaus Šilo mokykla";"6 lav.";3612746646;Taip;0;1;0;1
23082;"Vilniaus Šilo mokykla";"6 lav.";9054390753;Taip;4;1;0;5
23083;"Vilniaus Šilo mokykla";"6 lav.";2862598950;Ne;0;1;0;1
23084;"Vilniaus Šilo mokykla";"Priešmokyklinė grupė";5311183877;Taip;15;1;0;16
23085;"Vilniaus Šilo mokykla";"Priešmokyklinė grupė";1675384533;Taip;12;1;0;13
23086;"Vilniaus Šilo mokykla";"Priešmokyklinė grupė";3237698420;Taip;0;1;0;1
23087;"Vilniaus Šilo mokykla";"Priešmokyklinė grupė";2070454339;Ne;7;1;0;8
23088;"Vilniaus Šilo mokykla";"Priešmokyklinė grupė";8915901727;Taip;7;1;0;8
23089;"Vilniaus Šilo mokykla";"Priešmokyklinė grupė";9906750269;Taip;0;21;0;21
23090;Malūnėlis;BITUTĖS;1001575740;Taip;0;3;4;7
23091;Malūnėlis;BITUTĖS;8618778205;Taip;0;12;0;12
23092;Malūnėlis;BITUTĖS;2545930114;Taip;2;1;0;3
23093;Malūnėlis;BITUTĖS;3329510128;Taip;11;0;2;13
23094;Malūnėlis;BITUTĖS;5402027714;Taip;0;3;0;3
23095;Malūnėlis;BITUTĖS;6199265600;Taip;5;2;0;7
23096;Malūnėlis;BITUTĖS;5244586185;Ne;7;1;0;8
23097;Malūnėlis;BITUTĖS;7144098762;Taip;12;1;0;13
23098;Malūnėlis;BITUTĖS;1146723570;Taip;1;5;0;6
23099;Malūnėlis;BITUTĖS;9891418762;Taip;1;15;0;16
23100;Malūnėlis;BITUTĖS;8642960989;Taip;0;1;1;2
23101;Malūnėlis;BITUTĖS;5959610426;Ne;8;1;0;9
23102;Malūnėlis;BITUTĖS;4367009696;Ne;0;8;0;8
23103;Malūnėlis;BITUTĖS;5770511204;Ne;6;2;0;8
23104;Malūnėlis;BITUTĖS;9936144392;Taip;0;0;2;2
23105;Malūnėlis;BITUTĖS;1944670796;Taip;8;5;0;13
23106;Malūnėlis;BITUTĖS;5421090978;Taip;5;2;0;7
23107;Malūnėlis;BITUTĖS;8643210289;Ne;13;0;1;14
23108;Malūnėlis;BITUTĖS;1528972517;Taip;8;5;0;13
23109;Malūnėlis;BITUTĖS;4202723476;Ne;3;1;0;4
23110;Malūnėlis;BITUTĖS;8007350745;Taip;0;1;1;2
23111;Malūnėlis;VOVERIUKAI;4307232411;Taip;0;1;0;1
23112;Malūnėlis;VOVERIUKAI;3293082023;Taip;18;1;0;19
23113;Malūnėlis;VOVERIUKAI;6575258889;Ne;3;0;0;3
23114;Malūnėlis;VOVERIUKAI;1003043129;Taip;5;0;0;5
23115;Malūnėlis;VOVERIUKAI;3779723692;Taip;0;2;0;2
23116;Malūnėlis;VOVERIUKAI;7983537913;Ne;7;0;0;7
23117;Malūnėlis;VOVERIUKAI;9592117637;Taip;0;1;0;1
23118;Malūnėlis;VOVERIUKAI;9894452403;Ne;8;4;0;12
23119;Malūnėlis;VOVERIUKAI;2029506037;Taip;0;2;1;3
23120;Malūnėlis;VOVERIUKAI;9342720464;Ne;0;5;0;5
23121;Malūnėlis;VOVERIUKAI;2246526281;Taip;1;0;0;1
23122;Malūnėlis;VOVERIUKAI;2192305527;Taip;4;1;3;8
23123;Malūnėlis;VOVERIUKAI;6805587761;Taip;4;1;3;8
23124;Malūnėlis;VOVERIUKAI;3371260811;Taip;5;4;0;9
23125;Malūnėlis;VOVERIUKAI;5061720786;Taip;9;0;2;11
23126;Malūnėlis;VOVERIUKAI;5232728972;Taip;11;0;0;11
23127;Malūnėlis;VOVERIUKAI;2574604828;Taip;3;0;0;3
23128;Malūnėlis;VOVERIUKAI;3898518306;Taip;0;0;9;9
23129;Malūnėlis;VOVERIUKAI;1770049356;Taip;6;1;0;7
23130;Malūnėlis;VOVERIUKAI;5909022614;Ne;12;1;0;13
23131;Malūnėlis;VOVERIUKAI;8751365673;Ne;4;1;3;8
23132;Malūnėlis;BORUŽĖLĖS;7556990784;Taip;10;0;0;10
23133;Malūnėlis;BORUŽĖLĖS;1574941416;Taip;3;8;1;12
23134;Malūnėlis;BORUŽĖLĖS;1100719254;Ne;6;1;1;8
23135;Malūnėlis;BORUŽĖLĖS;2525923211;Ne;6;0;11;17
23136;Malūnėlis;BORUŽĖLĖS;9304119075;Taip;3;0;0;3
23137;Malūnėlis;BORUŽĖLĖS;6928976717;Ne;0;0;1;1
23138;Malūnėlis;BORUŽĖLĖS;6531364407;Taip;7;0;0;7
23139;Malūnėlis;BORUŽĖLĖS;8551271848;Taip;0;0;1;1
23140;Malūnėlis;BORUŽĖLĖS;8277245773;Ne;10;3;1;14
23141;Malūnėlis;BORUŽĖLĖS;5686301875;Taip;0;0;5;5
23142;Malūnėlis;BORUŽĖLĖS;1407908511;Ne;0;1;0;1
23143;Malūnėlis;BORUŽĖLĖS;4787212056;Ne;0;12;3;15
23144;Malūnėlis;BORUŽĖLĖS;7740957549;Taip;0;0;2;2
23145;Malūnėlis;Skruzdėliukų;9798968369;Taip;5;0;0;5
23146;Malūnėlis;Skruzdėliukų;9300944734;Taip;5;0;0;5
23147;Malūnėlis;Skruzdėliukų;9153589128;Taip;4;0;0;4
23148;Malūnėlis;Skruzdėliukų;9207327884;Ne;1;0;0;1
23149;Malūnėlis;Žirniukų;1398391534;Taip;2;0;1;3
23150;Malūnėlis;Žirniukų;3315571256;Taip;2;0;0;2
23151;Malūnėlis;Žirniukų;3315571256;Taip;2;0;0;2
23152;Malūnėlis;Žirniukų;3315571256;Taip;2;0;0;2
23153;Malūnėlis;Žirniukų;6047042736;Taip;0;0;1;1
