Nr.;"Darželio pavadinimas";"Grupės pavadinimas";"Vaiko Identifikacinis Nr.";"Deklaruotas mieste";"Pateisintos dėl ligos";"Pateisintos dėl kitų priežasčių";"Nepateisintos dienos";"Praleistos dienos Viso"
1;Aitvaras;"VIJURKAI (ALERG.)";6936031222;Ne;0;0;12;12
2;Aitvaras;"VIJURKAI (ALERG.)";6214880713;Ne;0;1;0;1
3;Aitvaras;"VIJURKAI (ALERG.)";2566375128;Ne;0;2;0;2
4;Aitvaras;"VIJURKAI (ALERG.)";1879540041;Ne;0;5;0;5
5;Aitvaras;"VIJURKAI (ALERG.)";1532588441;Ne;4;1;0;5
6;Aitvaras;"VIJURKAI (ALERG.)";8206046301;Ne;4;0;0;4
7;Aitvaras;"VIJURKAI (ALERG.)";1347364985;Ne;0;0;3;3
8;Aitvaras;"VIJURKAI (ALERG.)";9157794193;Ne;16;0;0;16
9;Aitvaras;"VIJURKAI (ALERG.)";9562494357;Ne;8;3;0;11
10;Aitvaras;"VIJURKAI (ALERG.)";6021342178;Ne;0;6;0;6
11;Aitvaras;"VIJURKAI (ALERG.)";2650483861;Ne;4;2;0;6
12;Aitvaras;"VIJURKAI (ALERG.)";4426643908;Ne;4;0;0;4
13;Aitvaras;"VIJURKAI (ALERG.)";2601983670;Ne;7;0;0;7
14;Aitvaras;"VIJURKAI (ALERG.)";3570820823;Ne;5;0;0;5
15;Aitvaras;"VIJURKAI (ALERG.)";6444377924;Ne;6;2;0;8
16;Aitvaras;"VIJURKAI (ALERG.)";4702400490;Ne;2;4;0;6
17;Aitvaras;"SMALSUČIAI (ALERG.)";4868552034;Ne;0;11;0;11
18;Aitvaras;"SMALSUČIAI (ALERG.)";4480921300;Ne;0;0;1;1
19;Aitvaras;"SMALSUČIAI (ALERG.)";1019661577;Ne;0;6;0;6
20;Aitvaras;"SMALSUČIAI (ALERG.)";5425259260;Ne;0;4;0;4
21;Aitvaras;"SMALSUČIAI (ALERG.)";6201118021;Ne;10;4;0;14
22;Aitvaras;"SMALSUČIAI (ALERG.)";5750154036;Ne;0;6;0;6
23;Aitvaras;"SMALSUČIAI (ALERG.)";1275561645;Ne;3;2;0;5
24;Aitvaras;"SMALSUČIAI (ALERG.)";6084096300;Ne;0;6;0;6
25;Aitvaras;"SMALSUČIAI (ALERG.)";2004112424;Ne;3;6;0;9
26;Aitvaras;"SMALSUČIAI (ALERG.)";5330618557;Ne;0;6;0;6
27;Aitvaras;"SMALSUČIAI (ALERG.)";3488467265;Ne;0;6;2;8
28;Aitvaras;"SMALSUČIAI (ALERG.)";9745864667;Ne;0;2;0;2
29;Aitvaras;"SMALSUČIAI (ALERG.)";9810370596;Ne;0;2;0;2
30;Aitvaras;"SMALSUČIAI (ALERG.)";1954364886;Ne;0;1;0;1
31;Aitvaras;"SMALSUČIAI (ALERG.)";3535659630;Ne;0;0;3;3
32;Aitvaras;"SMALSUČIAI (ALERG.)";4833313373;Ne;0;0;1;1
33;Aitvaras;"SMALSUČIAI (ALERG.)";24247118884;Ne;0;2;0;2
34;Aitvaras;"SMALSUČIAI (ALERG.)";5504431748;Ne;4;0;1;5
35;Aitvaras;"SMALSUČIAI (ALERG.)";5389627560;Ne;9;2;0;11
36;Aitvaras;"SMALSUČIAI (ALERG.)";2953536545;Ne;0;1;0;1
37;Aitvaras;"SMALSUČIAI (ALERG.)";1636794584;Ne;0;4;0;4
38;Aitvaras;"SMALSUČIAI (ALERG.)";5956333024;Ne;0;1;0;1
39;Aitvaras;"SMALSUČIAI (ALERG.)";5595233402;Ne;0;1;1;2
40;Aitvaras;PADAUŽIUKAI;1494094426;Ne;0;4;0;4
41;Aitvaras;PADAUŽIUKAI;9332771711;Ne;0;2;0;2
42;Aitvaras;PADAUŽIUKAI;6550426644;Ne;6;11;0;17
43;Aitvaras;PADAUŽIUKAI;5818794912;Ne;0;1;0;1
44;Aitvaras;PADAUŽIUKAI;58780461337;Ne;0;4;3;7
45;Aitvaras;PADAUŽIUKAI;2034293999;Ne;21;0;0;21
46;Aitvaras;PADAUŽIUKAI;1116271183;Ne;0;1;0;1
47;Aitvaras;PADAUŽIUKAI;44046627149;Ne;5;0;0;5
48;Aitvaras;PADAUŽIUKAI;43711349817;Ne;9;0;1;10
49;Aitvaras;PADAUŽIUKAI;2804106417;Ne;0;7;0;7
50;Aitvaras;PADAUŽIUKAI;1996524718;Ne;5;4;0;9
51;Aitvaras;PADAUŽIUKAI;7469656671;Ne;0;5;0;5
52;Aitvaras;PADAUŽIUKAI;2408952971;Ne;2;2;0;4
53;Aitvaras;PADAUŽIUKAI;47875842134;Ne;0;4;2;6
54;Aitvaras;PADAUŽIUKAI;40799643122;Ne;0;2;0;2
55;Aitvaras;PADAUŽIUKAI;9015675095;Ne;2;4;0;6
56;Aitvaras;PADAUŽIUKAI;8503279655;Ne;0;3;3;6
57;Aitvaras;PADAUŽIUKAI;8121858940;Ne;5;0;0;5
58;Aitvaras;"AITVARIUKAI (ALERG.)";3639102842;Ne;0;7;0;7
59;Aitvaras;"AITVARIUKAI (ALERG.)";7243387750;Ne;0;12;0;12
60;Aitvaras;"AITVARIUKAI (ALERG.)";6587437949;Ne;0;3;0;3
61;Aitvaras;"AITVARIUKAI (ALERG.)";7461284958;Ne;0;2;0;2
62;Aitvaras;"AITVARIUKAI (ALERG.)";3394251305;Ne;0;3;0;3
63;Aitvaras;"AITVARIUKAI (ALERG.)";6459307767;Ne;8;2;0;10
64;Aitvaras;"AITVARIUKAI (ALERG.)";5635576679;Ne;0;7;0;7
65;Aitvaras;"AITVARIUKAI (ALERG.)";7988247429;Ne;3;1;0;4
66;Aitvaras;"AITVARIUKAI (ALERG.)";8770777328;Ne;9;3;0;12
67;Aitvaras;"AITVARIUKAI (ALERG.)";3653879553;Ne;0;6;0;6
68;Aitvaras;"AITVARIUKAI (ALERG.)";9721273154;Ne;3;0;1;4
69;Aitvaras;"AITVARIUKAI (ALERG.)";5103105065;Ne;24;0;0;24
70;Aitvaras;"AITVARIUKAI (ALERG.)";8543644000;Ne;0;1;0;1
71;Aitvaras;"AITVARIUKAI (ALERG.)";1859647003;Ne;14;0;0;14
72;Aitvaras;"AITVARIUKAI (ALERG.)";4204923580;Ne;0;1;0;1
73;Aitvaras;"AITVARIUKAI (ALERG.)";4777266938;Ne;9;5;0;14
74;Aitvaras;"AITVARIUKAI (ALERG.)";7568388141;Ne;8;9;0;17
75;Aitvaras;"AITVARIUKAI (ALERG.)";3954840915;Ne;0;7;0;7
76;Aitvaras;"AITVARIUKAI (ALERG.)";2146963673;Ne;16;0;0;16
77;Aitvaras;"AITVARIUKAI (ALERG.)";9763502346;Ne;12;2;0;14
78;Aitvaras;"AITVARIUKAI (ALERG.)";9228736015;Ne;4;3;0;7
79;Aitvaras;"AITVARIUKAI (ALERG.)";3775634117;Ne;0;1;0;1
80;Aitvaras;"AITVARIUKAI (ALERG.)";2615576367;Ne;10;0;0;10
81;Aitvaras;"SAULĖS ZUIKUČIAI  (ALERG.)";5619137905;Ne;0;3;0;3
82;Aitvaras;"SAULĖS ZUIKUČIAI  (ALERG.)";4106097701;Ne;0;6;0;6
83;Aitvaras;"SAULĖS ZUIKUČIAI  (ALERG.)";2184231202;Ne;13;0;1;14
84;Aitvaras;"SAULĖS ZUIKUČIAI  (ALERG.)";2478737835;Ne;8;1;5;14
85;Aitvaras;"SAULĖS ZUIKUČIAI  (ALERG.)";1136438927;Ne;5;2;1;8
86;Aitvaras;"SAULĖS ZUIKUČIAI  (ALERG.)";8137900398;Ne;0;2;1;3
87;Aitvaras;"SAULĖS ZUIKUČIAI  (ALERG.)";9147954612;Ne;7;0;2;9
88;Aitvaras;"SAULĖS ZUIKUČIAI  (ALERG.)";2511844613;Ne;17;0;0;17
89;Aitvaras;"SAULĖS ZUIKUČIAI  (ALERG.)";7907357058;Ne;10;0;0;10
90;Aitvaras;"SAULĖS ZUIKUČIAI  (ALERG.)";9534206000;Ne;12;3;0;15
91;Aitvaras;"SAULĖS ZUIKUČIAI  (ALERG.)";3737054758;Ne;12;1;0;13
92;Aitvaras;"SAULĖS ZUIKUČIAI  (ALERG.)";4646876966;Ne;1;1;0;2
93;Aitvaras;"SAULĖS ZUIKUČIAI  (ALERG.)";9271534775;Ne;15;0;3;18
94;Aitvaras;"SAULĖS ZUIKUČIAI  (ALERG.)";8849563638;Ne;0;1;0;1
95;Aitvaras;"SAULĖS ZUIKUČIAI  (ALERG.)";5283056036;Ne;0;1;0;1
96;Aitvaras;"SAULĖS ZUIKUČIAI  (ALERG.)";2744696131;Ne;0;4;0;4
97;Aitvaras;"SAULĖS ZUIKUČIAI  (ALERG.)";2373509019;Ne;10;7;0;17
98;Aitvaras;"SAULĖS ZUIKUČIAI  (ALERG.)";2624566766;Ne;10;0;0;10
99;Aitvaras;"SAULĖS ZUIKUČIAI  (ALERG.)";3677551059;Ne;0;2;0;2
100;Aitvaras;"ŽEMYNUKAI (ALERG.)";8567255042;Ne;0;0;2;2
101;Aitvaras;"ŽEMYNUKAI (ALERG.)";6218019092;Ne;0;12;2;14
102;Aitvaras;"ŽEMYNUKAI (ALERG.)";7560642918;Ne;0;1;0;1
103;Aitvaras;"ŽEMYNUKAI (ALERG.)";3820930777;Ne;31;0;0;31
104;Aitvaras;"ŽEMYNUKAI (ALERG.)";6624986090;Ne;9;0;1;10
105;Aitvaras;"ŽEMYNUKAI (ALERG.)";4733627644;Ne;15;6;0;21
106;Aitvaras;"ŽEMYNUKAI (ALERG.)";3104109370;Ne;0;0;14;14
107;Aitvaras;"ŽEMYNUKAI (ALERG.)";7853714142;Ne;7;4;5;16
108;Aitvaras;"ŽEMYNUKAI (ALERG.)";1949144346;Ne;8;4;0;12
109;Aitvaras;"ŽEMYNUKAI (ALERG.)";8641433486;Ne;18;0;1;19
110;Aitvaras;"ŽEMYNUKAI (ALERG.)";3961423273;Ne;1;0;0;1
111;Aitvaras;"ŽEMYNUKAI (ALERG.)";9947610763;Ne;0;4;0;4
112;Aitvaras;"ŽEMYNUKAI (ALERG.)";7113016866;Ne;4;0;0;4
113;Aitvaras;"ŽEMYNUKAI (ALERG.)";4377666052;Ne;11;6;0;17
114;Aitvaras;"ŽEMYNUKAI (ALERG.)";8333823078;Ne;3;2;0;5
115;Aitvaras;"ŽEMYNUKAI (ALERG.)";5623106419;Ne;5;4;1;10
116;Aitvaras;"ŽEMYNUKAI (ALERG.)";5351333397;Ne;0;4;0;4
117;Aitvaras;"ŽEMYNUKAI (ALERG.)";2065988478;Ne;8;0;3;11
118;Aitvaras;"ŽEMYNUKAI (ALERG.)";3635354769;Ne;2;2;1;5
119;Aitvaras;"ŽEMYNUKAI (ALERG.)";3851322849;Ne;0;0;8;8
120;Aitvaras;"ŽEMYNUKAI (ALERG.)";7889947603;Ne;9;5;1;15
121;Aitvaras;"ŽEMYNUKAI (ALERG.)";2839442228;Ne;3;0;5;8
122;Aitvaras;"LINKSMUČIAI (ALERG.)";5238819066;Ne;2;0;0;2
123;Aitvaras;"LINKSMUČIAI (ALERG.)";7109001184;Ne;6;0;1;7
124;Aitvaras;"LINKSMUČIAI (ALERG.)";5378212904;Ne;6;4;0;10
125;Aitvaras;"LINKSMUČIAI (ALERG.)";1091372798;Ne;0;6;0;6
126;Aitvaras;"LINKSMUČIAI (ALERG.)";8666824607;Ne;5;4;0;9
127;Aitvaras;"LINKSMUČIAI (ALERG.)";5612991255;Ne;0;4;0;4
128;Aitvaras;"LINKSMUČIAI (ALERG.)";7260577885;Ne;0;7;3;10
129;Aitvaras;"LINKSMUČIAI (ALERG.)";1115202169;Ne;3;2;0;5
130;Aitvaras;"LINKSMUČIAI (ALERG.)";4613894944;Ne;0;2;5;7
131;Aitvaras;"LINKSMUČIAI (ALERG.)";2760970218;Ne;0;1;0;1
132;Aitvaras;"LINKSMUČIAI (ALERG.)";4120515569;Ne;6;3;3;12
133;Aitvaras;"LINKSMUČIAI (ALERG.)";9885781306;Ne;6;0;0;6
134;Aitvaras;"LINKSMUČIAI (ALERG.)";4564723798;Ne;0;0;2;2
135;Aitvaras;"LINKSMUČIAI (ALERG.)";4612994715;Ne;4;5;3;12
136;Aitvaras;"LINKSMUČIAI (ALERG.)";4176681907;Ne;0;10;0;10
137;Aitvaras;"LINKSMUČIAI (ALERG.)";2547934790;Ne;12;0;1;13
138;Aitvaras;"LINKSMUČIAI (ALERG.)";2357399981;Ne;5;2;0;7
139;Aitvaras;"LINKSMUČIAI (ALERG.)";5572538840;Ne;0;2;0;2
140;Aitvaras;"LINKSMUČIAI (ALERG.)";4114397590;Ne;6;4;0;10
141;Aitvaras;NAMINUKAI;3053557807;Ne;8;0;2;10
142;Aitvaras;NAMINUKAI;6126913961;Ne;9;0;0;9
143;Aitvaras;NAMINUKAI;3347213578;Ne;0;4;1;5
144;Aitvaras;NAMINUKAI;9024245490;Ne;5;4;0;9
145;Aitvaras;NAMINUKAI;8512502118;Ne;0;4;0;4
146;Aitvaras;NAMINUKAI;1376605323;Ne;5;0;1;6
147;Aitvaras;NAMINUKAI;6060880045;Ne;1;0;1;2
148;Aitvaras;NAMINUKAI;2821221241;Ne;0;2;0;2
149;Aitvaras;NAMINUKAI;9039303562;Ne;1;1;2;4
150;Aitvaras;NAMINUKAI;6080549524;Ne;1;1;2;4
151;Aitvaras;NAMINUKAI;6048701733;Ne;0;4;0;4
152;Aitvaras;NAMINUKAI;6110226958;Ne;7;0;1;8
153;Aitvaras;NAMINUKAI;4555281655;Ne;9;2;0;11
154;Aitvaras;NAMINUKAI;8043062737;Ne;0;2;2;4
155;Aitvaras;NAMINUKAI;3005447572;Ne;0;4;0;4
156;Aitvaras;NAMINUKAI;1549552392;Ne;13;1;0;14
157;Aitvaras;NAMINUKAI;4498792867;Ne;3;0;0;3
158;Aitvaras;NAMINUKAI;9490714865;Ne;9;2;1;12
159;Aitvaras;NAMINUKAI;1498630458;Ne;0;1;7;8
160;Aitvaras;NAMINUKAI;5967188507;Ne;7;1;0;8
161;Aitvaras;NAMINUKAI;5161069611;Ne;0;0;1;1
162;Aitvaras;NAMINUKAI;7934344218;Ne;8;0;2;10
163;Aitvaras;NAMINUKAI;6279152796;Ne;0;6;0;6
164;Aitvaras;ŠELMIAI;4984058405;Ne;0;5;0;5
165;Aitvaras;ŠELMIAI;9725401255;Ne;16;0;0;16
166;Aitvaras;ŠELMIAI;4547342872;Ne;2;6;1;9
167;Aitvaras;ŠELMIAI;5684526288;Ne;5;2;0;7
168;Aitvaras;ŠELMIAI;7764574135;Ne;16;0;0;16
169;Aitvaras;ŠELMIAI;5601517340;Ne;8;3;0;11
170;Aitvaras;ŠELMIAI;1019103539;Ne;0;3;0;3
171;Aitvaras;ŠELMIAI;2185746898;Ne;9;0;0;9
172;Aitvaras;ŠELMIAI;8756012613;Ne;0;9;0;9
173;Aitvaras;ŠELMIAI;1203732956;Ne;22;0;0;22
174;Aitvaras;ŠELMIAI;5782609781;Ne;21;1;0;22
175;Aitvaras;ŠELMIAI;7805819121;Ne;0;1;0;1
176;Aitvaras;ŠELMIAI;8558414510;Ne;5;0;0;5
177;Aitvaras;ŠELMIAI;4551774368;Ne;5;0;0;5
178;Aitvaras;ŠELMIAI;4158520145;Ne;0;7;0;7
179;Aitvaras;ŠELMIAI;7352233454;Ne;2;0;0;2
180;Aitvaras;ŠELMIAI;1901118931;Ne;4;4;0;8
181;Aitvaras;ŠELMIAI;4812423010;Ne;11;5;0;16
182;Aitvaras;ŠELMIAI;8644983502;Ne;6;4;0;10
183;Aitvaras;ŠELMIAI;9295561516;Ne;0;6;0;6
184;Aitvaras;ŠELMIAI;6188186413;Ne;17;4;3;24
185;Aitvaras;KODĖLČIUKAI;6214572150;Ne;12;5;0;17
186;Aitvaras;KODĖLČIUKAI;3323458595;Ne;0;0;8;8
187;Aitvaras;KODĖLČIUKAI;8065540507;Ne;2;2;0;4
188;Aitvaras;KODĖLČIUKAI;1288810999;Ne;11;0;2;13
189;Aitvaras;KODĖLČIUKAI;6501943902;Ne;0;10;0;10
190;Aitvaras;KODĖLČIUKAI;3101015381;Ne;0;0;2;2
191;Aitvaras;KODĖLČIUKAI;4350590529;Ne;0;4;1;5
192;Aitvaras;KODĖLČIUKAI;7777235021;Ne;6;2;0;8
193;Aitvaras;KODĖLČIUKAI;5641224483;Ne;0;6;0;6
194;Aitvaras;KODĖLČIUKAI;1830134108;Ne;0;2;2;4
195;Aitvaras;KODĖLČIUKAI;3178965623;Ne;0;3;0;3
196;Aitvaras;KODĖLČIUKAI;5905456814;Ne;0;2;4;6
197;Aitvaras;KODĖLČIUKAI;6739827530;Ne;2;0;2;4
198;Aitvaras;KODĖLČIUKAI;2807595769;Ne;1;5;0;6
199;Aitvaras;KODĖLČIUKAI;1252145346;Ne;0;0;1;1
200;Aitvaras;KODĖLČIUKAI;8439586875;Ne;3;4;0;7
201;Aitvaras;KODĖLČIUKAI;2328771385;Ne;10;4;0;14
202;Aitvaras;KODĖLČIUKAI;3735941659;Ne;5;0;0;5
203;Aitvaras;KODĖLČIUKAI;1594675221;Ne;0;1;0;1
204;Aitvaras;KODĖLČIUKAI;5922357091;Ne;8;3;0;11
205;Aitvaras;PABIRUČIAI;7136674662;Ne;0;6;0;6
206;Aitvaras;PABIRUČIAI;9949206639;Ne;0;0;6;6
207;Aitvaras;PABIRUČIAI;4613021421;Ne;0;2;0;2
208;Aitvaras;PABIRUČIAI;2887681961;Ne;0;8;0;8
209;Aitvaras;PABIRUČIAI;7922937851;Ne;3;1;2;6
210;Aitvaras;PABIRUČIAI;4085134058;Ne;14;0;0;14
211;Aitvaras;PABIRUČIAI;8746884740;Ne;5;0;0;5
212;Aitvaras;PABIRUČIAI;4163871634;Ne;16;0;0;16
213;Aitvaras;PABIRUČIAI;3988226974;Ne;16;0;0;16
214;Aitvaras;PABIRUČIAI;2239387580;Ne;0;2;1;3
215;Aitvaras;PABIRUČIAI;6119148164;Ne;2;1;3;6
216;Aitvaras;PABIRUČIAI;2892898328;Ne;0;9;0;9
217;Aitvaras;PABIRUČIAI;3749008647;Ne;11;2;0;13
218;Aitvaras;PABIRUČIAI;4760801928;Ne;8;0;12;20
219;Aitvaras;PABIRUČIAI;1599296739;Ne;0;0;14;14
220;Aitvaras;PABIRUČIAI;4987412561;Ne;8;0;0;8
221;Aitvaras;"SVAJOKLIAI  (ALERG.)";3429046261;Ne;2;2;0;4
222;Aitvaras;"SVAJOKLIAI  (ALERG.)";5659897032;Ne;1;0;0;1
223;Aitvaras;"SVAJOKLIAI  (ALERG.)";4618560397;Ne;9;0;0;9
224;Aitvaras;"SVAJOKLIAI  (ALERG.)";9209862610;Ne;14;2;0;16
225;Aitvaras;"SVAJOKLIAI  (ALERG.)";6191938291;Ne;14;0;0;14
226;Aitvaras;"SVAJOKLIAI  (ALERG.)";7006713502;Ne;5;8;0;13
227;Aitvaras;"SVAJOKLIAI  (ALERG.)";3923601422;Ne;18;1;0;19
228;Aitvaras;"SVAJOKLIAI  (ALERG.)";5790551266;Ne;9;1;0;10
229;Aitvaras;"SVAJOKLIAI  (ALERG.)";2975696317;Ne;8;0;0;8
230;Aitvaras;"SVAJOKLIAI  (ALERG.)";3891067128;Ne;3;5;0;8
231;Aitvaras;"SVAJOKLIAI  (ALERG.)";1030872812;Ne;12;6;0;18
232;Aitvaras;"SVAJOKLIAI  (ALERG.)";8352951885;Ne;8;0;0;8
233;Aitvaras;"SVAJOKLIAI  (ALERG.)";5255843693;Ne;3;0;0;3
234;Aitvaras;"SVAJOKLIAI  (ALERG.)";1448307414;Ne;5;0;0;5
235;Aitvaras;"SVAJOKLIAI  (ALERG.)";5593105541;Ne;0;2;5;7
236;Aitvaras;"SVAJOKLIAI  (ALERG.)";8963214183;Ne;19;1;0;20
237;Aitvaras;"SVAJOKLIAI  (ALERG.)";6319953077;Ne;0;1;0;1
238;Aitvaras;"SVAJOKLIAI  (ALERG.)";1131690624;Ne;0;3;0;3
239;Aitvaras;"SVAJOKLIAI  (ALERG.)";4801034095;Ne;1;6;0;7
240;Aitvaras;"SVAJOKLIAI  (ALERG.)";6916032116;Ne;5;1;0;6
241;Atžalėlės;Gėlytės;4284673729;Ne;0;9;12;21
242;Atžalėlės;Gėlytės;8695865604;Ne;0;6;0;6
243;Atžalėlės;Gėlytės;2385614957;Ne;2;0;0;2
244;Atžalėlės;Gėlytės;5432433423;Ne;0;6;0;6
245;Atžalėlės;Gėlytės;9715625283;Ne;6;11;4;21
246;Atžalėlės;Gėlytės;2131592139;Ne;6;0;0;6
247;Atžalėlės;Gėlytės;3191066669;Ne;0;0;5;5
248;Atžalėlės;Gėlytės;1500456945;Ne;0;0;5;5
249;Atžalėlės;Gėlytės;1722233272;Ne;0;10;0;10
250;Atžalėlės;Gėlytės;5310990513;Ne;0;4;0;4
251;Atžalėlės;Gėlytės;7702502252;Ne;0;10;0;10
252;Atžalėlės;Gėlytės;9189223222;Ne;0;8;0;8
253;Atžalėlės;Gėlytės;3283415814;Ne;0;8;0;8
254;Atžalėlės;Gėlytės;1146492807;Ne;0;0;4;4
255;Atžalėlės;Gėlytės;3870758086;Ne;0;5;0;5
256;Atžalėlės;Gėlytės;6202250600;Ne;12;0;0;12
257;Atžalėlės;Gėlytės;4098210138;Ne;0;0;1;1
258;Atžalėlės;Gėlytės;6177038838;Ne;0;1;0;1
259;Atžalėlės;Gėlytės;5742471497;Ne;10;0;1;11
260;Atžalėlės;Gėlytės;1137741059;Ne;4;9;1;14
261;Atžalėlės;Gėlytės;4238773173;Ne;0;4;0;4
262;Atžalėlės;Gėlytės;1450609695;Ne;0;3;0;3
263;Atžalėlės;Drugeliai;4643154006;Ne;1;4;0;5
264;Atžalėlės;Drugeliai;6903666624;Ne;0;4;2;6
265;Atžalėlės;Drugeliai;2315790531;Ne;0;2;0;2
266;Atžalėlės;Drugeliai;6782007470;Ne;0;11;0;11
267;Atžalėlės;Drugeliai;1805496887;Ne;0;5;5;10
268;Atžalėlės;Drugeliai;7953922166;Ne;0;2;0;2
269;Atžalėlės;Drugeliai;5147078840;Ne;0;8;0;8
270;Atžalėlės;Drugeliai;9222670655;Ne;0;14;0;14
271;Atžalėlės;Drugeliai;77261118958;Ne;0;4;0;4
272;Atžalėlės;Drugeliai;1429493246;Ne;0;4;0;4
273;Atžalėlės;Drugeliai;6114426973;Ne;0;15;0;15
274;Atžalėlės;Drugeliai;1456979448;Ne;0;5;0;5
275;Atžalėlės;Drugeliai;4032519781;Ne;8;9;0;17
276;Atžalėlės;Drugeliai;7756889911;Ne;0;5;1;6
277;Atžalėlės;Drugeliai;5063094678;Ne;5;0;0;5
278;Atžalėlės;Drugeliai;3422605135;Ne;0;0;1;1
279;Atžalėlės;Drugeliai;8718036014;Ne;0;7;9;16
280;Atžalėlės;Drugeliai;4884599397;Ne;0;7;9;16
281;Atžalėlės;Drugeliai;4902947406;Ne;0;1;0;1
282;Atžalėlės;Drugeliai;9463215947;Ne;0;2;0;2
283;Atžalėlės;Drugeliai;6570245757;Ne;0;2;1;3
284;Atžalėlės;Drugeliai;6695872204;Ne;0;5;0;5
285;Atžalėlės;Drugeliai;6393090675;Ne;0;4;1;5
286;Atžalėlės;Gandriukai;2083260403;Ne;5;12;0;17
287;Atžalėlės;Gandriukai;2078549599;Ne;0;0;4;4
288;Atžalėlės;Gandriukai;5119260525;Ne;0;0;2;2
289;Atžalėlės;Gandriukai;1024559742;Ne;2;0;0;2
290;Atžalėlės;Gandriukai;7510951079;Ne;0;5;0;5
291;Atžalėlės;Gandriukai;6594440062;Ne;5;0;1;6
292;Atžalėlės;Gandriukai;4293557144;Ne;0;8;0;8
293;Atžalėlės;Gandriukai;6211002805;Ne;6;0;0;6
294;Atžalėlės;Gandriukai;1305611902;Ne;0;0;4;4
295;Atžalėlės;Voveriukai;1865339755;Ne;0;1;0;1
296;Atžalėlės;Voveriukai;4467364336;Ne;0;4;2;6
297;Atžalėlės;Voveriukai;9699811980;Ne;0;1;0;1
298;Atžalėlės;Voveriukai;8847754477;Ne;0;2;0;2
299;Atžalėlės;Voveriukai;3795729265;Ne;8;0;2;10
300;Atžalėlės;Voveriukai;8201582382;Ne;0;4;5;9
301;Atžalėlės;Voveriukai;4362058013;Ne;0;4;5;9
302;Atžalėlės;Voveriukai;8819893830;Ne;2;2;2;6
303;Atžalėlės;Voveriukai;3069192413;Ne;0;0;4;4
304;Atžalėlės;Voveriukai;2067246260;Ne;1;4;14;19
305;Atžalėlės;Voveriukai;5705303891;Ne;6;3;0;9
306;Atžalėlės;Voveriukai;1316154666;Ne;0;0;1;1
307;Atžalėlės;Voveriukai;6975941393;Ne;3;1;1;5
308;Atžalėlės;Voveriukai;8138683218;Ne;0;11;0;11
309;Atžalėlės;Voveriukai;7689394485;Ne;0;3;4;7
310;Atžalėlės;Voveriukai;1804802235;Ne;0;4;0;4
311;Atžalėlės;Voveriukai;2662384275;Ne;0;1;0;1
312;Atžalėlės;Voveriukai;4996777116;Ne;0;0;2;2
313;Atžalėlės;Voveriukai;1426744251;Ne;0;1;0;1
314;Atžalėlės;Voveriukai;6684979914;Ne;5;4;0;9
315;Atžalėlės;Voveriukai;8470059012;Ne;0;4;12;16
316;Atžalėlės;Voveriukai;5767549779;Ne;0;1;0;1
317;Atžalėlės;Žirniukai;2374624441;Ne;0;2;0;2
318;Atžalėlės;Žirniukai;5584105084;Ne;0;0;2;2
319;Atžalėlės;Žirniukai;9967641617;Ne;0;6;0;6
320;Atžalėlės;Žirniukai;9508110719;Ne;2;0;2;4
321;Atžalėlės;Žirniukai;1538643591;Ne;0;15;6;21
322;Atžalėlės;Žirniukai;3143856911;Ne;0;12;0;12
323;Atžalėlės;Žirniukai;1212074068;Ne;10;5;0;15
324;Atžalėlės;Žirniukai;4661388894;Ne;2;0;0;2
325;Atžalėlės;Žirniukai;7196464328;Ne;0;5;0;5
326;Atžalėlės;Žirniukai;7522643082;Ne;1;1;1;3
327;Atžalėlės;Žirniukai;7613931447;Ne;1;1;0;2
328;Atžalėlės;Žirniukai;6723689098;Ne;0;0;5;5
329;Atžalėlės;Žirniukai;9281138840;Taip;0;2;1;3
330;Atžalėlės;Žirniukai;7018297883;Ne;0;5;3;8
331;Atžalėlės;Ežiukai;9053620501;Ne;0;0;5;5
332;Atžalėlės;Ežiukai;9054589111;Ne;3;1;0;4
333;Atžalėlės;Ežiukai;9346744866;Ne;10;0;1;11
334;Atžalėlės;Ežiukai;1505286928;Ne;0;8;0;8
335;Atžalėlės;Ežiukai;4148412941;Ne;0;5;0;5
336;Atžalėlės;Ežiukai;3333808381;Ne;0;0;1;1
337;Atžalėlės;Ežiukai;1710646812;Ne;2;2;2;6
338;Atžalėlės;Ežiukai;9481268935;Ne;0;3;2;5
339;Atžalėlės;Ežiukai;6447615639;Ne;0;4;1;5
340;Atžalėlės;Ežiukai;5972419628;Ne;0;1;0;1
341;Atžalėlės;Ežiukai;1423254771;Ne;5;4;0;9
342;Atžalėlės;Ežiukai;6665199013;Ne;0;2;0;2
343;Atžalėlės;Ežiukai;6108989129;Ne;0;0;1;1
344;Atžalėlės;Ežiukai;5174826594;Ne;2;0;0;2
345;Atžalėlės;Ežiukai;7501772398;Ne;0;1;2;3
346;Atžalėlės;Paukšteliai;7807313362;Ne;9;0;0;9
347;Atžalėlės;Paukšteliai;6537864486;Ne;0;0;1;1
348;Atžalėlės;Paukšteliai;8768704484;Ne;0;11;1;12
349;Atžalėlės;Paukšteliai;6675588261;Ne;0;11;1;12
350;Atžalėlės;Paukšteliai;8524244526;Ne;9;0;3;12
351;Atžalėlės;Paukšteliai;6873507667;Ne;0;2;1;3
352;Atžalėlės;Paukšteliai;7321516783;Ne;0;0;2;2
353;Atžalėlės;Paukšteliai;6265777690;Ne;0;2;0;2
354;Atžalėlės;Paukšteliai;1844980319;Ne;0;1;0;1
355;Atžalėlės;Paukšteliai;8512283024;Ne;4;2;0;6
356;Atžalėlės;Paukšteliai;2078781673;Ne;0;1;0;1
357;Atžalėlės;Paukšteliai;1520206753;Ne;5;0;16;21
358;Atžalėlės;Paukšteliai;4790322154;Ne;2;2;0;4
359;Atžalėlės;Paukšteliai;4081717007;Ne;0;0;4;4
360;Atžalėlės;Paukšteliai;1089221288;Ne;0;0;1;1
361;Atžalėlės;Paukšteliai;7356877676;Ne;0;3;0;3
362;Atžalėlės;Paukšteliai;4392352210;Ne;0;0;4;4
363;Atžalėlės;Paukšteliai;1774212280;Ne;16;0;5;21
364;Atžalėlės;Meškiukai;8586739429;Ne;0;0;1;1
365;Atžalėlės;Meškiukai;9925178685;Ne;0;1;2;3
366;Atžalėlės;Meškiukai;2617568019;Ne;3;0;5;8
367;Atžalėlės;Meškiukai;4233689945;Ne;0;0;3;3
368;Atžalėlės;Meškiukai;8619613890;Ne;0;1;1;2
369;Atžalėlės;Meškiukai;3281114596;Ne;0;12;0;12
370;Atžalėlės;Meškiukai;5466374223;Ne;0;0;1;1
371;Atžalėlės;Meškiukai;2433029299;Ne;6;0;2;8
372;Atžalėlės;Meškiukai;5682652546;Ne;0;0;21;21
373;Atžalėlės;Meškiukai;9631336340;Ne;6;0;0;6
374;Atžalėlės;Meškiukai;2930612059;Ne;6;5;10;21
375;Atžalėlės;Meškiukai;6385777303;Ne;0;4;0;4
376;Atžalėlės;Meškiukai;1431197358;Ne;0;17;0;17
377;Atžalėlės;Meškiukai;4177753994;Ne;0;0;3;3
378;Atžalėlės;Meškiukai;3982090601;Ne;4;2;1;7
379;Atžalėlės;Meškiukai;3743308789;Ne;0;3;5;8
380;Atžalėlės;Meškiukai;7936991925;Ne;5;0;0;5
381;Atžalėlės;Meškiukai;8976815736;Ne;0;1;0;1
382;Atžalėlės;"BITUTĖS (MODULINĖ)";8707875125;Ne;5;8;0;13
383;Atžalėlės;"BITUTĖS (MODULINĖ)";8060332402;Ne;13;0;0;13
384;Atžalėlės;"BITUTĖS (MODULINĖ)";8396693160;Ne;4;1;1;6
385;Atžalėlės;"BITUTĖS (MODULINĖ)";6253257539;Ne;4;0;3;7
386;Atžalėlės;"BITUTĖS (MODULINĖ)";7052938312;Ne;0;1;1;2
387;Atžalėlės;"BITUTĖS (MODULINĖ)";3559977339;Ne;4;5;0;9
388;Atžalėlės;"BITUTĖS (MODULINĖ)";5593774275;Ne;17;1;0;18
389;Atžalėlės;"BITUTĖS (MODULINĖ)";1939076303;Ne;6;0;0;6
390;Atžalėlės;"BITUTĖS (MODULINĖ)";2322329918;Ne;4;0;0;4
391;Atžalėlės;"BITUTĖS (MODULINĖ)";6368553568;Ne;1;2;1;4
392;Atžalėlės;"BITUTĖS (MODULINĖ)";5148142239;Ne;4;0;0;4
393;Atžalėlės;"ŠYPSENĖLĖS (MODULINĖ)";1943349835;Ne;0;0;6;6
394;Atžalėlės;"ŠYPSENĖLĖS (MODULINĖ)";8564143904;Ne;6;4;5;15
395;Atžalėlės;"ŠYPSENĖLĖS (MODULINĖ)";3299724612;Ne;0;1;0;1
396;Atžalėlės;"BORUŽIUKAI (MODULINĖ)";7104671423;Ne;12;0;1;13
397;Atžalėlės;"BORUŽIUKAI (MODULINĖ)";3198845538;Ne;4;0;0;4
398;Atžalėlės;"BORUŽIUKAI (MODULINĖ)";8681809797;Ne;9;0;1;10
399;Atžalėlės;"BORUŽIUKAI (MODULINĖ)";3590987364;Ne;15;0;3;18
400;Atžalėlės;"BORUŽIUKAI (MODULINĖ)";6237597328;Ne;0;4;4;8
401;Atžalėlės;"BORUŽIUKAI (MODULINĖ)";1383944713;Ne;8;0;0;8
402;Atžalėlės;"BORUŽIUKAI (MODULINĖ)";5582697993;Ne;0;1;0;1
403;Atžalėlės;"BORUŽIUKAI (MODULINĖ)";7980775632;Ne;5;0;0;5
404;Atžalėlės;"SAULUTĖS (MODULINĖ)";4268941401;Ne;0;0;6;6
405;Atžalėlės;"SAULUTĖS (MODULINĖ)";2306086573;Ne;5;0;6;11
406;Atžalėlės;"SAULUTĖS (MODULINĖ)";8460997063;Ne;0;2;0;2
407;Atžalėlės;"SAULUTĖS (MODULINĖ)";5490741021;Ne;0;2;4;6
408;Atžalėlės;"SAULUTĖS (MODULINĖ)";8208908249;Ne;2;6;0;8
409;Atžalėlės;"SAULUTĖS (MODULINĖ)";6048763811;Ne;9;0;3;12
410;Aušrelė;PASAKIUKAI;1659335142;Ne;0;1;0;1
411;Aušrelė;PASAKIUKAI;1327431679;Ne;0;3;0;3
412;Aušrelė;PASAKIUKAI;6037757548;Ne;0;4;1;5
413;Aušrelė;PASAKIUKAI;7682402576;Ne;0;1;0;1
414;Aušrelė;PASAKIUKAI;1408751702;Ne;2;7;0;9
415;Aušrelė;PASAKIUKAI;6995749373;Ne;0;9;0;9
416;Aušrelė;PASAKIUKAI;8372554796;Ne;0;4;0;4
417;Aušrelė;PASAKIUKAI;8341539501;Ne;0;3;0;3
418;Aušrelė;PASAKIUKAI;8230362307;Ne;0;4;0;4
419;Aušrelė;PASAKIUKAI;4306578299;Ne;13;4;0;17
420;Aušrelė;PASAKIUKAI;5777214701;Ne;0;4;0;4
421;Aušrelė;PASAKIUKAI;6277405405;Ne;0;2;0;2
422;Aušrelė;PASAKIUKAI;3682523696;Ne;0;7;0;7
423;Aušrelė;PASAKIUKAI;34891640909;Ne;0;6;0;6
424;Aušrelė;PASAKIUKAI;3165692699;Ne;0;2;0;2
425;Aušrelė;BORUŽĖLĖS;6673034329;Ne;7;6;0;13
426;Aušrelė;BORUŽĖLĖS;4957581753;Ne;0;4;0;4
427;Aušrelė;BORUŽĖLĖS;1928260563;Ne;0;6;0;6
428;Aušrelė;BORUŽĖLĖS;8243716759;Ne;0;8;0;8
429;Aušrelė;BORUŽĖLĖS;1549962200;Ne;0;14;0;14
430;Aušrelė;BORUŽĖLĖS;4505922394;Ne;1;5;2;8
431;Aušrelė;BORUŽĖLĖS;7190665397;Ne;1;3;1;5
432;Aušrelė;BORUŽĖLĖS;2991828434;Ne;0;1;1;2
433;Aušrelė;BORUŽĖLĖS;8030685444;Ne;9;4;0;13
434;Aušrelė;BORUŽĖLĖS;1814972981;Ne;5;4;0;9
435;Aušrelė;BORUŽĖLĖS;3397741232;Ne;11;0;0;11
436;Aušrelė;SMALSUČIAI;6761263775;Ne;0;10;0;10
437;Aušrelė;SMALSUČIAI;3015028879;Ne;0;21;0;21
438;Aušrelė;SMALSUČIAI;2863655361;Ne;8;4;0;12
439;Aušrelė;SMALSUČIAI;2390128933;Ne;0;4;2;6
440;Aušrelė;SMALSUČIAI;8503309819;Ne;2;6;0;8
441;Aušrelė;SMALSUČIAI;2827216981;Ne;0;4;0;4
442;Aušrelė;SMALSUČIAI;9443641849;Ne;0;5;0;5
443;Aušrelė;SMALSUČIAI;7930717076;Ne;14;2;0;16
444;Aušrelė;SMALSUČIAI;7609339123;Ne;0;4;0;4
445;Aušrelė;SMALSUČIAI;1556010005;Ne;3;0;0;3
446;Aušrelė;SMALSUČIAI;5478028396;Ne;9;0;0;9
447;Aušrelė;SMALSUČIAI;7070013052;Ne;13;0;1;14
448;Aušrelė;SMALSUČIAI;6507218940;Ne;0;4;1;5
449;Aušrelė;SMALSUČIAI;2266390402;Ne;0;6;2;8
450;Aušrelė;SMALSUČIAI;8032661062;Ne;0;4;12;16
451;Aušrelė;SMALSUČIAI;1976613166;Ne;0;1;1;2
452;Aušrelė;KODĖLČIUKAI;7723159748;Ne;0;1;0;1
453;Aušrelė;KODĖLČIUKAI;7367268748;Ne;0;1;0;1
454;Aušrelė;KODĖLČIUKAI;3623813061;Ne;0;5;0;5
455;Aušrelė;KODĖLČIUKAI;4288695809;Ne;0;1;0;1
456;Aušrelė;KODĖLČIUKAI;8693750994;Ne;0;3;0;3
457;Aušrelė;KODĖLČIUKAI;6308519574;Ne;3;1;0;4
458;Aušrelė;KODĖLČIUKAI;3320399046;Ne;0;4;0;4
459;Aušrelė;KODĖLČIUKAI;6911735462;Ne;6;7;0;13
460;Aušrelė;KODĖLČIUKAI;8338569001;Ne;0;3;0;3
461;Aušrelė;KODĖLČIUKAI;2766357229;Ne;0;2;1;3
462;Aušrelė;KODĖLČIUKAI;7515666888;Ne;4;0;0;4
463;Aušrelė;KODĖLČIUKAI;8862488358;Ne;0;1;0;1
464;Aušrelė;KODĖLČIUKAI;4882556718;Ne;0;1;0;1
465;Aušrelė;KODĖLČIUKAI;6321332888;Ne;0;0;7;7
466;Aušrelė;PELĖDŽIUKAI;4725588671;Ne;0;1;0;1
467;Aušrelė;PELĖDŽIUKAI;3223092149;Ne;0;16;0;16
468;Aušrelė;PELĖDŽIUKAI;8580241126;Ne;0;0;5;5
469;Aušrelė;PELĖDŽIUKAI;2545065554;Ne;0;12;0;12
470;Aušrelė;PELĖDŽIUKAI;4227228548;Ne;0;1;0;1
471;Aušrelė;PELĖDŽIUKAI;8996445434;Ne;0;1;0;1
472;Aušrelė;PELĖDŽIUKAI;8411336992;Ne;0;2;7;9
473;Aušrelė;PELĖDŽIUKAI;8917907028;Ne;7;0;1;8
474;Aušrelė;PELĖDŽIUKAI;4012186237;Ne;0;0;1;1
475;Aušrelė;PELĖDŽIUKAI;5312189552;Ne;0;5;0;5
476;Aušrelė;PELĖDŽIUKAI;1642358593;Ne;0;6;2;8
477;Aušrelė;PELĖDŽIUKAI;2294224426;Ne;0;4;1;5
478;Aušrelė;PELĖDŽIUKAI;1276792874;Ne;0;0;3;3
479;Aušrelė;AITVARIUKAI;6833654667;Ne;0;4;0;4
480;Aušrelė;AITVARIUKAI;8102749675;Ne;0;6;0;6
481;Aušrelė;AITVARIUKAI;4595435635;Ne;0;10;0;10
482;Aušrelė;AITVARIUKAI;9608444990;Ne;0;4;0;4
483;Aušrelė;AITVARIUKAI;6434548772;Ne;23;0;0;23
484;Aušrelė;AITVARIUKAI;9158248746;Ne;8;1;0;9
485;Aušrelė;AITVARIUKAI;7978186455;Ne;0;21;0;21
486;Aušrelė;AITVARIUKAI;5708459561;Ne;16;0;0;16
487;Aušrelė;AITVARIUKAI;1039180129;Ne;9;1;0;10
488;Aušrelė;AITVARIUKAI;5125295651;Ne;7;0;0;7
489;Aušrelė;AITVARIUKAI;7847650967;Ne;0;4;0;4
490;Aušrelė;AITVARIUKAI;5727081833;Ne;0;3;0;3
491;Aušrelė;AITVARIUKAI;8210698019;Ne;0;21;0;21
492;Aušrelė;AITVARIUKAI;4942168388;Ne;2;3;1;6
493;Aušrelė;BITUTĖS;1741716341;Ne;0;21;0;21
494;Aušrelė;BITUTĖS;4989544273;Ne;0;6;0;6
495;Aušrelė;BITUTĖS;9960201865;Ne;0;5;0;5
496;Aušrelė;BITUTĖS;2071674661;Ne;0;13;0;13
497;Aušrelė;BITUTĖS;1450827353;Ne;4;0;0;4
498;Aušrelė;BITUTĖS;4935192851;Ne;0;12;0;12
499;Aušrelė;BITUTĖS;5614774250;Ne;0;3;0;3
500;Aušrelė;BITUTĖS;6591538425;Ne;10;11;0;21
501;Aušrelė;BITUTĖS;8203256528;Ne;13;5;0;18
502;Aušrelė;BITUTĖS;5741252819;Ne;13;5;0;18
503;Aušrelė;BITUTĖS;1243825974;Ne;0;8;0;8
504;Aušrelė;BITUTĖS;5266959731;Ne;5;0;0;5
505;Aušrelė;ŽIRNIUKAI;9733877752;Ne;0;2;0;2
506;Aušrelė;ŽIRNIUKAI;1544869163;Ne;2;1;0;3
507;Aušrelė;ŽIRNIUKAI;6577540623;Ne;18;0;0;18
508;Aušrelė;ŽIRNIUKAI;5460833944;Ne;24;0;2;26
509;Aušrelė;ŽIRNIUKAI;6372004855;Ne;9;0;0;9
510;Aušrelė;ŽIRNIUKAI;3713528812;Ne;0;4;0;4
511;Aušrelė;ŽIRNIUKAI;2107898976;Ne;6;4;0;10
512;Aušrelė;ŽIRNIUKAI;1607338052;Ne;0;6;1;7
513;Aušrelė;ŽIRNIUKAI;8573348956;Ne;0;21;0;21
514;Aušrelė;ŽIRNIUKAI;6463141345;Ne;0;4;0;4
515;Aušrelė;ŽIRNIUKAI;1798478023;Ne;5;0;0;5
516;Aušrelė;ŽIRNIUKAI;1754138341;Ne;0;9;0;9
517;Aušrelė;ŽIRNIUKAI;6913824678;Ne;0;1;0;1
518;Aušrelė;ŽIRNIUKAI;8797157671;Ne;0;1;0;1
519;Aušrelė;ŽIRNIUKAI;4591518039;Ne;0;5;0;5
520;Aušrelė;ŽIRNIUKAI;8126701466;Ne;0;2;0;2
521;Aušrelė;GRYBUKAI;7406063630;Ne;0;2;0;2
522;Aušrelė;GRYBUKAI;8438945369;Ne;0;5;0;5
523;Aušrelė;GRYBUKAI;6672975558;Ne;0;2;3;5
524;Aušrelė;GRYBUKAI;4565813136;Ne;8;0;0;8
525;Aušrelė;GRYBUKAI;9877307844;Ne;9;1;0;10
526;Aušrelė;GRYBUKAI;8947695521;Ne;12;0;0;12
527;Aušrelė;GRYBUKAI;7130040621;Ne;0;2;0;2
528;Aušrelė;GRYBUKAI;2311552230;Ne;0;1;0;1
529;Aušrelė;GRYBUKAI;1458580523;Ne;0;5;0;5
530;Aušrelė;GRYBUKAI;1871799626;Ne;2;1;0;3
531;Aušrelė;GRYBUKAI;5733298006;Ne;0;3;0;3
532;Aušrelė;GRYBUKAI;4924950592;Ne;0;3;0;3
533;Aušrelė;GRYBUKAI;2466858636;Ne;0;21;0;21
534;Aušrelė;GRYBUKAI;2873845920;Ne;0;1;0;1
535;Aušrelė;GRYBUKAI;5904797250;Ne;8;0;0;8
536;Aušrelė;DRUGELIAI;9763241451;Ne;2;0;1;3
537;Aušrelė;DRUGELIAI;1209824814;Ne;0;0;3;3
538;Aušrelė;DRUGELIAI;7948024164;Ne;0;4;6;10
539;Aušrelė;DRUGELIAI;5429867368;Ne;0;12;0;12
540;Aušrelė;DRUGELIAI;3831695455;Ne;0;21;0;21
541;Aušrelė;DRUGELIAI;2737402297;Ne;0;0;8;8
542;Aušrelė;DRUGELIAI;3813270658;Ne;0;4;0;4
543;Aušrelė;DRUGELIAI;4254737302;Ne;0;0;1;1
544;Aušrelė;DRUGELIAI;4464947621;Ne;13;2;0;15
545;Aušrelė;DRUGELIAI;9126040500;Ne;12;0;0;12
546;Aušrelė;DRUGELIAI;7286960315;Ne;8;5;0;13
547;Aušrelė;DRUGELIAI;8102293098;Ne;0;1;0;1
548;Aušrelė;DRUGELIAI;2266835623;Ne;10;3;0;13
549;Aušrelė;DRUGELIAI;1094141305;Ne;11;0;2;13
550;Aušrelė;DRUGELIAI;9514049590;Ne;6;0;0;6
551;Aušrelė;DRUGELIAI;5709799539;Ne;14;0;0;14
552;Aušrelė;DRUGELIAI;8724802289;Ne;14;0;0;14
553;Aušrelė;DRUGELIAI;5668908532;Ne;0;0;1;1
554;Aušrelė;NYKŠTUKAI;9914518299;Ne;0;1;0;1
555;Aušrelė;NYKŠTUKAI;8427699400;Ne;0;10;0;10
556;Aušrelė;NYKŠTUKAI;4297417711;Ne;5;0;0;5
557;Aušrelė;NYKŠTUKAI;4004600465;Ne;7;1;0;8
558;Aušrelė;NYKŠTUKAI;7964156691;Ne;0;7;0;7
559;Aušrelė;NYKŠTUKAI;7140465960;Ne;13;1;0;14
560;Aušrelė;NYKŠTUKAI;8099338305;Ne;3;0;0;3
561;Aušrelė;NYKŠTUKAI;6513026989;Ne;0;6;0;6
562;Aušrelė;NYKŠTUKAI;4282189556;Ne;9;4;0;13
563;Aušrelė;NYKŠTUKAI;4252475967;Ne;0;1;0;1
564;Aušrelė;NYKŠTUKAI;8829298943;Ne;6;0;0;6
565;Aušrelė;NYKŠTUKAI;8378225406;Ne;0;2;2;4
566;Aušrelė;NYKŠTUKAI;5018495543;Ne;16;0;0;16
567;Aušrelė;NYKŠTUKAI;3259828075;Ne;0;2;3;5
568;Aušrelė;SPINDULIUKAI;8848358559;Ne;0;21;0;21
569;Aušrelė;SPINDULIUKAI;3194122285;Ne;0;21;0;21
570;Aušrelė;SPINDULIUKAI;5358736178;Ne;7;0;1;8
571;Aušrelė;SPINDULIUKAI;8801906679;Ne;7;2;0;9
572;Aušrelė;SPINDULIUKAI;7208341200;Ne;0;21;0;21
573;Aušrelė;SPINDULIUKAI;1446194971;Ne;9;1;0;10
574;Aušrelė;SPINDULIUKAI;2319188134;Ne;3;2;0;5
575;Aušrelė;SPINDULIUKAI;9251919940;Ne;0;0;21;21
576;Aušrelė;SPINDULIUKAI;8997650487;Ne;0;1;1;2
577;Aušrelė;SPINDULIUKAI;1805615293;Ne;0;8;0;8
578;Aušrelė;SPINDULIUKAI;7966060521;Ne;0;9;0;9
579;Aušrelė;SPINDULIUKAI;6418762623;Ne;0;0;4;4
580;Aušrelė;SPINDULIUKAI;8835689988;Ne;4;8;0;12
581;Aušrelė;SPINDULIUKAI;2981314491;Ne;0;2;0;2
582;Aušrelė;SPINDULIUKAI;2441221298;Ne;0;21;0;21
583;Beržynėlis;SVIRPLIUKAI;7360345539;Ne;0;6;0;6
584;Beržynėlis;SVIRPLIUKAI;4134371415;Ne;5;1;0;6
585;Beržynėlis;SVIRPLIUKAI;7278860816;Ne;0;6;0;6
586;Beržynėlis;SVIRPLIUKAI;4013099670;Ne;15;1;0;16
587;Beržynėlis;SVIRPLIUKAI;8404801225;Ne;3;0;0;3
588;Beržynėlis;SVIRPLIUKAI;8303684788;Ne;10;0;0;10
589;Beržynėlis;SVIRPLIUKAI;7953957525;Ne;6;5;0;11
590;Beržynėlis;SVIRPLIUKAI;3841363368;Ne;1;0;0;1
591;Beržynėlis;SVIRPLIUKAI;3418730586;Ne;0;2;0;2
592;Beržynėlis;SVIRPLIUKAI;2221708263;Ne;15;0;0;15
593;Beržynėlis;SVIRPLIUKAI;8880151537;Ne;0;1;0;1
594;Beržynėlis;SVIRPLIUKAI;6516665294;Ne;7;0;0;7
595;Beržynėlis;SVIRPLIUKAI;9580286493;Ne;0;9;0;9
596;Beržynėlis;SVIRPLIUKAI;6673910279;Ne;3;0;0;3
597;Beržynėlis;SVIRPLIUKAI;8701990625;Ne;0;3;0;3
598;Beržynėlis;SVIRPLIUKAI;5027712732;Ne;4;2;0;6
599;Beržynėlis;SVIRPLIUKAI;7788532819;Ne;0;6;0;6
600;Beržynėlis;SVIRPLIUKAI;3315079004;Ne;17;0;0;17
601;Beržynėlis;SVIRPLIUKAI;8533912024;Ne;10;3;0;13
602;Beržynėlis;PELEDŽIUKAI;3278699117;Ne;0;2;0;2
603;Beržynėlis;PELEDŽIUKAI;1516309509;Ne;0;6;0;6
604;Beržynėlis;PELEDŽIUKAI;1395819329;Ne;0;0;1;1
605;Beržynėlis;PELEDŽIUKAI;1838631438;Ne;1;0;0;1
606;Beržynėlis;PELEDŽIUKAI;1682929565;Ne;2;0;0;2
607;Beržynėlis;PELEDŽIUKAI;7248602510;Ne;0;2;0;2
608;Beržynėlis;PELEDŽIUKAI;2681482042;Ne;5;0;0;5
609;Beržynėlis;PELEDŽIUKAI;5196910604;Ne;6;0;0;6
610;Beržynėlis;PELEDŽIUKAI;7649359221;Ne;0;6;0;6
611;Beržynėlis;PELEDŽIUKAI;6395436937;Ne;0;18;0;18
612;Beržynėlis;PELEDŽIUKAI;3641421009;Ne;0;1;0;1
613;Beržynėlis;PELEDŽIUKAI;2791734213;Ne;0;2;2;4
614;Beržynėlis;PELEDŽIUKAI;1136091326;Ne;9;0;0;9
615;Beržynėlis;PELEDŽIUKAI;1176943273;Ne;21;0;0;21
616;Beržynėlis;PELEDŽIUKAI;7929997884;Ne;0;5;0;5
617;Beržynėlis;PELEDŽIUKAI;8688852668;Ne;5;7;0;12
618;Beržynėlis;ŽIOGELIAI;5308596559;Ne;0;7;0;7
619;Beržynėlis;ŽIOGELIAI;4035764376;Ne;0;4;0;4
620;Beržynėlis;ŽIOGELIAI;4970999989;Ne;0;4;0;4
621;Beržynėlis;ŽIOGELIAI;1325972861;Ne;0;0;1;1
622;Beržynėlis;ŽIOGELIAI;9088059487;Ne;0;2;0;2
623;Beržynėlis;ŽIOGELIAI;5473666098;Ne;0;3;0;3
624;Beržynėlis;ŽIOGELIAI;8591800387;Ne;0;5;0;5
625;Beržynėlis;ŽIOGELIAI;6739927917;Ne;0;2;2;4
626;Beržynėlis;ŽIOGELIAI;2971686368;Ne;0;2;0;2
627;Beržynėlis;ŽIOGELIAI;9409317403;Ne;0;7;2;9
628;Beržynėlis;ŽIOGELIAI;9305279614;Ne;6;4;0;10
629;Beržynėlis;ŽIOGELIAI;9511051386;Ne;19;2;0;21
630;Beržynėlis;ŽIOGELIAI;8114761925;Ne;0;0;1;1
631;Beržynėlis;ŽIOGELIAI;5856519538;Ne;5;5;0;10
632;Beržynėlis;ŽIOGELIAI;3339522259;Ne;0;2;5;7
633;Beržynėlis;ŽIOGELIAI;6337962165;Ne;0;6;0;6
634;Beržynėlis;ŽIOGELIAI;6864823739;Ne;0;6;6;12
635;Beržynėlis;ŽIOGELIAI;9896122318;Ne;0;2;5;7
636;Beržynėlis;ŽIOGELIAI;6837130893;Ne;0;1;3;4
637;Beržynėlis;ŽIOGELIAI;3484188772;Ne;0;4;0;4
638;Beržynėlis;ŽVIRBLIUKAI;2193460960;Ne;0;2;0;2
639;Beržynėlis;ŽVIRBLIUKAI;2482395208;Ne;0;2;0;2
640;Beržynėlis;ŽVIRBLIUKAI;7057284039;Ne;0;4;0;4
641;Beržynėlis;ŽVIRBLIUKAI;2892553878;Ne;0;2;0;2
642;Beržynėlis;ŽVIRBLIUKAI;4774769217;Ne;0;0;1;1
643;Beržynėlis;ŽVIRBLIUKAI;9503352345;Ne;1;2;0;3
644;Beržynėlis;ŽVIRBLIUKAI;8881566865;Ne;0;0;10;10
645;Beržynėlis;ŽVIRBLIUKAI;8280378527;Ne;5;2;0;7
646;Beržynėlis;ŽVIRBLIUKAI;5593146590;Ne;0;2;0;2
647;Beržynėlis;ŽVIRBLIUKAI;9754455116;Ne;0;1;0;1
648;Beržynėlis;ŽVIRBLIUKAI;3334994408;Ne;21;0;0;21
649;Beržynėlis;ŽVIRBLIUKAI;6293884233;Ne;0;2;4;6
650;Beržynėlis;ŽVIRBLIUKAI;4161974847;Ne;5;1;0;6
651;Beržynėlis;ŽVIRBLIUKAI;3209966996;Ne;0;7;0;7
652;Beržynėlis;ŽVIRBLIUKAI;5194416351;Ne;0;2;0;2
653;Beržynėlis;ŽIRNIUKAI;5864265458;Ne;0;21;0;21
654;Beržynėlis;ŽIRNIUKAI;2583982025;Ne;0;4;0;4
655;Beržynėlis;ŽIRNIUKAI;1558469002;Ne;3;6;0;9
656;Beržynėlis;ŽIRNIUKAI;9603272698;Ne;21;0;0;21
657;Beržynėlis;ŽIRNIUKAI;9493489114;Ne;21;0;0;21
658;Beržynėlis;ŽIRNIUKAI;4786786104;Ne;0;5;0;5
659;Beržynėlis;ŽIRNIUKAI;4944466205;Ne;0;2;3;5
660;Beržynėlis;ŽIRNIUKAI;6392773584;Ne;0;2;2;4
661;Beržynėlis;ŽIRNIUKAI;2155662035;Ne;4;2;0;6
662;Beržynėlis;ŽIRNIUKAI;4978363316;Ne;13;1;0;14
663;Beržynėlis;ŽIRNIUKAI;7806800327;Taip;5;2;12;19
664;Beržynėlis;ŽIRNIUKAI;9899702275;Ne;0;4;0;4
665;Beržynėlis;VIŠČIUKAI;7016454952;Ne;4;0;0;4
666;Beržynėlis;VIŠČIUKAI;7903644161;Ne;9;0;1;10
667;Beržynėlis;VIŠČIUKAI;1707585750;Ne;5;0;1;6
668;Beržynėlis;VIŠČIUKAI;4382068779;Ne;5;0;0;5
669;Beržynėlis;VIŠČIUKAI;2272661119;Ne;0;3;0;3
670;Beržynėlis;VIŠČIUKAI;1831776326;Ne;1;0;1;2
671;Beržynėlis;VIŠČIUKAI;1118349439;Ne;10;0;0;10
672;Beržynėlis;VIŠČIUKAI;4369803044;Ne;6;3;0;9
673;Beržynėlis;VIŠČIUKAI;1503903200;Ne;0;0;1;1
674;Beržynėlis;VIŠČIUKAI;3593785967;Ne;2;0;0;2
675;Beržynėlis;VIŠČIUKAI;7972993168;Ne;3;0;0;3
676;Beržynėlis;VIŠČIUKAI;5049057730;Ne;5;0;0;5
677;Beržynėlis;VIŠČIUKAI;7084666673;Ne;0;4;0;4
678;Beržynėlis;VIŠČIUKAI;6592330036;Ne;5;6;0;11
679;Beržynėlis;VIŠČIUKAI;3100097647;Ne;11;0;0;11
680;Birutės;SKRUZDELIUKŲ;1761065941;Ne;7;4;0;11
681;Birutės;SKRUZDELIUKŲ;4027700332;Ne;0;2;0;2
682;Birutės;SKRUZDELIUKŲ;7685356079;Ne;13;0;0;13
683;Birutės;SKRUZDELIUKŲ;8636113039;Ne;0;8;0;8
684;Birutės;SKRUZDELIUKŲ;9411016611;Ne;0;6;0;6
685;Birutės;SKRUZDELIUKŲ;7119951690;Ne;16;4;0;20
686;Birutės;SKRUZDELIUKŲ;1945532852;Ne;0;6;0;6
687;Birutės;SKRUZDELIUKŲ;5154903444;Ne;0;1;0;1
688;Birutės;SKRUZDELIUKŲ;9541516589;Ne;0;0;2;2
689;Birutės;SKRUZDELIUKŲ;6815916679;Ne;10;3;0;13
690;Birutės;SKRUZDELIUKŲ;9187671201;Ne;13;1;3;17
691;Birutės;SKRUZDELIUKŲ;7404631298;Ne;9;0;0;9
692;Birutės;SKRUZDELIUKŲ;8432173636;Ne;4;1;0;5
693;Birutės;SKRUZDELIUKŲ;9904827482;Ne;0;3;0;3
694;Birutės;SKRUZDELIUKŲ;2140552221;Ne;0;3;0;3
695;Birutės;SKRUZDELIUKŲ;7940403585;Ne;5;5;0;10
696;Birutės;SKRUZDELIUKŲ;2859160609;Ne;0;3;0;3
697;Birutės;SKRUZDELIUKŲ;4375683234;Ne;0;4;0;4
698;Birutės;BITUČIŲ;33770983649;Ne;7;6;1;14
699;Birutės;BITUČIŲ;87693588654;Ne;0;5;0;5
700;Birutės;BITUČIŲ;2975442228;Ne;6;2;0;8
701;Birutės;BITUČIŲ;98391790116;Ne;1;0;1;2
702;Birutės;BITUČIŲ;5947971037;Ne;0;2;0;2
703;Birutės;BITUČIŲ;3870702348;Ne;0;3;0;3
704;Birutės;BITUČIŲ;3436637062;Ne;0;5;0;5
705;Birutės;BITUČIŲ;8465645434;Ne;13;0;0;13
706;Birutės;BITUČIŲ;9722922540;Ne;2;1;3;6
707;Birutės;BITUČIŲ;3061210677;Ne;0;4;1;5
708;Birutės;BITUČIŲ;6431396285;Ne;0;0;1;1
709;Birutės;BITUČIŲ;6081472534;Ne;0;3;0;3
710;Birutės;BITUČIŲ;2674259453;Ne;0;9;2;11
711;Birutės;BITUČIŲ;17865476849;Ne;7;0;0;7
712;Birutės;BITUČIŲ;2329522074;Ne;0;0;1;1
713;Birutės;BITUČIŲ;5164196372;Ne;0;0;1;1
714;Birutės;BITUČIŲ;6006110601;Ne;0;1;0;1
715;Birutės;BITUČIŲ;1243603625;Taip;0;4;0;4
716;Birutės;BITUČIŲ;4253571334;Ne;2;5;0;7
717;Birutės;BITUČIŲ;1447494370;Ne;4;0;2;6
718;Birutės;BORUŽIUKAI;5893851353;Ne;7;4;1;12
719;Birutės;BORUŽIUKAI;5457357625;Ne;1;0;1;2
720;Birutės;BORUŽIUKAI;5869137292;Ne;10;1;0;11
721;Birutės;BORUŽIUKAI;5026442722;Ne;0;10;0;10
722;Birutės;BORUŽIUKAI;6977276295;Ne;9;7;0;16
723;Birutės;BORUŽIUKAI;9289922622;Ne;0;0;3;3
724;Birutės;BORUŽIUKAI;8011210158;Ne;13;0;0;13
725;Birutės;BORUŽIUKAI;4906874758;Ne;0;1;1;2
726;Birutės;BORUŽIUKAI;9263238557;Ne;0;3;0;3
727;Birutės;BORUŽIUKAI;4488481136;Ne;7;0;0;7
728;Birutės;BORUŽIUKAI;6460415179;Ne;6;4;0;10
729;Birutės;BORUŽIUKAI;6973898557;Ne;0;1;0;1
730;Birutės;BORUŽIUKAI;7033907787;Ne;7;0;0;7
731;Birutės;BORUŽIUKAI;5745377474;Ne;5;1;1;7
732;Birutės;BORUŽIUKAI;2016711225;Ne;6;0;1;7
733;Birutės;BORUŽIUKAI;1400510886;Ne;7;0;0;7
734;Birutės;BORUŽIUKAI;5875585426;Ne;5;0;0;5
735;Birutės;BORUŽIUKAI;7398022393;Ne;0;0;3;3
736;Birutės;BORUŽIUKAI;7712882120;Ne;8;2;0;10
737;Birutės;BORUŽIUKAI;7741922416;Ne;6;6;0;12
738;Birutės;BORUŽIUKAI;2681370776;Ne;0;0;2;2
739;Birutės;DRUGELIAI;8854957814;Ne;0;0;11;11
740;Birutės;DRUGELIAI;6263985683;Ne;9;0;0;9
741;Birutės;DRUGELIAI;4995437657;Ne;0;7;0;7
742;Birutės;DRUGELIAI;5957267018;Ne;0;0;3;3
743;Birutės;DRUGELIAI;1442496209;Ne;12;1;0;13
744;Birutės;DRUGELIAI;2318034045;Ne;5;0;2;7
745;Birutės;DRUGELIAI;9727836236;Ne;4;0;0;4
746;Birutės;DRUGELIAI;3516719248;Ne;0;0;2;2
747;Birutės;DRUGELIAI;5688633357;Ne;0;3;8;11
748;Birutės;DRUGELIAI;8559820030;Ne;11;0;8;19
749;Birutės;DRUGELIAI;9863681147;Ne;0;0;1;1
750;Birutės;DRUGELIAI;9307655828;Ne;19;0;0;19
751;Birutės;DRUGELIAI;3115571205;Ne;11;0;0;11
752;Birutės;DRUGELIAI;4674152995;Ne;15;0;0;15
753;Birutės;DRUGELIAI;5177528200;Ne;0;0;9;9
754;Birutės;DRUGELIAI;3391101786;Ne;10;0;0;10
755;Birutės;DRUGELIAI;7876057712;Ne;2;0;1;3
756;Birutės;DRUGELIAI;6765257633;Ne;6;0;0;6
757;Birutės;DRUGELIAI;7336936451;Ne;0;12;0;12
758;Bitutė;Aitvariukų;4474600934;Ne;7;1;0;8
759;Bitutė;Aitvariukų;5606049201;Ne;8;1;0;9
760;Bitutė;Aitvariukų;6035394425;Taip;8;5;0;13
761;Bitutė;Aitvariukų;7132616264;Ne;0;15;0;15
762;Bitutė;Aitvariukų;8796728627;Ne;4;12;0;16
763;Bitutė;Aitvariukų;6030674568;Ne;11;0;2;13
764;Bitutė;Aitvariukų;9747786638;Ne;7;0;3;10
765;Bitutė;Aitvariukų;8259512455;Ne;0;10;0;10
766;Bitutė;Aitvariukų;9106644834;Ne;0;4;0;4
767;Bitutė;Aitvariukų;2899217019;Ne;2;0;3;5
768;Bitutė;Aitvariukų;8670124052;Ne;4;4;0;8
769;Bitutė;Aitvariukų;1340530611;Ne;0;6;0;6
770;Bitutė;Aitvariukų;6759511692;Ne;5;0;0;5
771;Bitutė;Aitvariukų;4164058783;Ne;10;0;6;16
772;Bitutė;Aitvariukų;8908052679;Ne;13;6;0;19
773;Bitutė;Aitvariukų;4924483609;Ne;0;8;0;8
774;Bitutė;Aitvariukų;7447624247;Ne;0;7;0;7
775;Bitutė;Aitvariukų;5880651175;Ne;0;6;0;6
776;Bitutė;Ežiukų;56287634684;Ne;5;4;1;10
777;Bitutė;Ežiukų;5126303823;Ne;4;2;0;6
778;Bitutė;Ežiukų;4764586168;Ne;8;4;0;12
779;Bitutė;Ežiukų;8905075899;Ne;0;0;1;1
780;Bitutė;Ežiukų;3600670185;Taip;5;0;0;5
781;Bitutė;Ežiukų;6341806464;Ne;0;4;4;8
782;Bitutė;Ežiukų;7456328992;Ne;0;6;0;6
783;Bitutė;Ežiukų;2812580726;Ne;0;4;1;5
784;Bitutė;Ežiukų;8186706520;Ne;0;21;0;21
785;Bitutė;Ežiukų;1904108612;Ne;0;5;0;5
786;Bitutė;Ežiukų;5378885117;Ne;0;3;1;4
787;Bitutė;Ežiukų;2122052883;Ne;4;4;0;8
788;Bitutė;Ežiukų;4444523140;Ne;0;2;0;2
789;Bitutė;Ežiukų;4468366941;Ne;3;1;0;4
790;Bitutė;Ežiukų;3156654672;Ne;5;4;1;10
791;Bitutė;Žvirbliukų;7047262367;Ne;3;4;1;8
792;Bitutė;Žvirbliukų;3804171750;Ne;0;3;0;3
793;Bitutė;Žvirbliukų;5406667195;Ne;0;4;0;4
794;Bitutė;Žvirbliukų;4458990772;Ne;7;2;1;10
795;Bitutė;Žvirbliukų;3723040682;Ne;0;4;0;4
796;Bitutė;Žvirbliukų;2190439190;Ne;0;2;0;2
797;Bitutė;Žvirbliukų;7113693496;Ne;11;0;0;11
798;Bitutė;Žvirbliukų;4177331531;Ne;0;1;0;1
799;Bitutė;Žvirbliukų;2483462846;Ne;0;3;0;3
800;Bitutė;Žvirbliukų;6044969600;Ne;0;4;0;4
801;Bitutė;Žvirbliukų;2444289145;Ne;0;12;0;12
802;Bitutė;Žvirbliukų;3517750478;Ne;0;1;0;1
803;Bitutė;Žvirbliukų;5291764696;Ne;0;0;1;1
804;Bitutė;Žvirbliukų;9523588597;Ne;5;0;0;5
805;Bitutė;Žvirbliukų;8373105196;Ne;0;6;0;6
806;Bitutė;Žvirbliukų;6014726741;Ne;0;3;0;3
807;Bitutė;Žvirbliukų;4527880105;Ne;9;2;0;11
808;Bitutė;Žvirbliukų;9834697190;Ne;7;0;1;8
809;Bitutė;Gandriukų;8519978626;Ne;0;12;0;12
810;Bitutė;Gandriukų;1809034174;Ne;0;10;0;10
811;Bitutė;Gandriukų;6586888742;Ne;5;9;0;14
812;Bitutė;Gandriukų;5783154071;Ne;2;5;0;7
813;Bitutė;Gandriukų;7387822939;Ne;0;1;1;2
814;Bitutė;Gandriukų;6052204491;Ne;0;5;0;5
815;Bitutė;Gandriukų;37105491775;Ne;0;3;0;3
816;Bitutė;Gandriukų;90943054285;Ne;5;5;0;10
817;Bitutė;Gandriukų;6659750060;Ne;0;4;0;4
818;Bitutė;Gandriukų;9683582019;Ne;5;1;0;6
819;Bitutė;Gandriukų;11567978993;Ne;0;6;0;6
820;Bitutė;Gandriukų;7352524951;Ne;5;4;0;9
821;Bitutė;Gandriukų;2350260809;Ne;0;2;0;2
822;Bitutė;Gandriukų;27144303911;Ne;0;4;0;4
823;Bitutė;Gandriukų;1942685472;Ne;5;1;0;6
824;Bitutė;Gandriukų;1307749129;Ne;0;3;0;3
825;Bitutė;Gandriukų;5653055907;Ne;8;11;0;19
826;Bitutė;Gandriukų;6678928989;Ne;4;1;0;5
827;Bitutė;Gandriukų;1802887869;Ne;9;3;0;12
828;Bitutė;Gandriukų;4574673585;Ne;0;7;0;7
829;Bitutė;Gandriukų;47316276655;Ne;0;8;0;8
830;Bitutė;Pelėdžiukai;3254061362;Ne;0;0;1;1
831;Bitutė;Pelėdžiukai;5455919343;Ne;0;5;0;5
832;Bitutė;Pelėdžiukai;8743734366;Ne;0;6;0;6
833;Bitutė;Pelėdžiukai;6674923740;Ne;0;4;0;4
834;Bitutė;Pelėdžiukai;2804203556;Ne;5;10;0;15
835;Bitutė;Pelėdžiukai;8394685672;Ne;0;4;1;5
836;Bitutė;Pelėdžiukai;7056737587;Ne;4;0;0;4
837;Bitutė;Pelėdžiukai;4985270536;Ne;0;6;0;6
838;Bitutė;Pelėdžiukai;1590501589;Ne;0;6;0;6
839;Bitutė;Pelėdžiukai;3796188100;Ne;2;4;0;6
840;Bitutė;Pelėdžiukai;1564763789;Ne;0;6;0;6
841;Bitutė;Pelėdžiukai;1846974702;Ne;0;4;0;4
842;Bitutė;Pelėdžiukai;5679397165;Ne;10;4;0;14
843;Bitutė;Pelėdžiukai;1162903905;Ne;4;0;0;4
844;Bitutė;Pelėdžiukai;3432065233;Ne;0;14;0;14
845;Bitutė;Pelėdžiukai;1560715159;Ne;0;6;0;6
846;Bitutė;Pelėdžiukai;6204566294;Ne;0;4;0;4
847;Bitutė;Pelėdžiukai;2518730247;Ne;15;5;0;20
848;Bitutė;Pelėdžiukai;5810344229;Ne;0;1;0;1
849;Bitutė;Pelėdžiukai;4315172747;Ne;0;8;0;8
850;Bitutė;Pelėdžiukai;9838379838;Ne;0;14;0;14
851;Bitutė;Pelėdžiukai;3227252972;Ne;0;4;0;4
852;Bitutė;Boružėlių;8276590981;Ne;11;0;8;19
853;Bitutė;Boružėlių;7503203424;Ne;19;0;0;19
854;Bitutė;Boružėlių;8355346371;Ne;8;0;1;9
855;Bitutė;Boružėlių;2583001947;Ne;11;0;3;14
856;Bitutė;Boružėlių;9545405359;Ne;0;0;2;2
857;Bitutė;Boružėlių;2129484313;Ne;7;3;0;10
858;Bitutė;Boružėlių;9691450767;Ne;0;0;9;9
859;Bitutė;Boružėlių;3170266155;Ne;3;0;7;10
860;Bitutė;Boružėlių;6455582149;Ne;9;0;0;9
861;Bitutė;Boružėlių;2144809294;Ne;6;4;0;10
862;Bitutė;Boružėlių;8011051470;Ne;12;0;1;13
863;Bitutė;Boružėlių;9521938997;Ne;5;3;1;9
864;Bitutė;Boružėlių;9668365838;Ne;12;1;0;13
865;Bitutė;Boružėlių;3870675531;Ne;3;0;1;4
866;Bitutė;Boružėlių;7095475821;Taip;0;0;1;1
867;Bitutė;Boružėlių;6255439813;Ne;14;0;0;14
868;Bitutė;Boružėlių;2623999429;Ne;0;3;1;4
869;Bitutė;Boružėlių;6840722112;Ne;5;0;7;12
870;Bitutė;Boružėlių;4884898917;Ne;0;1;0;1
871;Bitutė;Boružėlių;4869423833;Ne;0;4;1;5
872;Bitutė;Boružėlių;5071978105;Ne;10;0;0;10
873;Bitutė;Šokliukų;8211710975;Ne;0;10;0;10
874;Bitutė;Šokliukų;8872286273;Ne;0;5;1;6
875;Bitutė;Šokliukų;5169768042;Ne;16;4;0;20
876;Bitutė;Šokliukų;4917599786;Ne;10;0;1;11
877;Bitutė;Šokliukų;1348548294;Ne;5;0;0;5
878;Bitutė;Šokliukų;7318555933;Ne;0;3;0;3
879;Bitutė;Šokliukų;1012702386;Ne;0;0;5;5
880;Bitutė;Šokliukų;9924340801;Ne;11;0;0;11
881;Bitutė;Šokliukų;7979566741;Ne;0;1;0;1
882;Bitutė;Šokliukų;7165511381;Ne;0;10;0;10
883;Bitutė;Šokliukų;9465186207;Ne;10;2;0;12
884;Bitutė;Šokliukų;2853616585;Ne;0;4;6;10
885;Bitutė;Šokliukų;5109258680;Ne;0;6;0;6
886;Bitutė;Šokliukų;8439759353;Ne;0;1;0;1
887;Bitutė;Šokliukų;3417576747;Ne;8;1;0;9
888;Bitutė;Šokliukų;8422448947;Ne;0;4;0;4
889;Bitutė;Šokliukų;7926482326;Ne;0;7;0;7
890;Bitutė;Šokliukų;5876700984;Ne;0;1;0;1
891;Bitutė;Šokliukų;2177537591;Ne;12;0;0;12
892;Bitutė;Šokliukų;5759407291;Ne;0;6;0;6
893;Bitutė;Šokliukų;9234090775;Ne;6;2;0;8
894;Bitutė;Drugelių;9094567866;Ne;0;0;6;6
895;Bitutė;Drugelių;5759595005;Ne;6;0;4;10
896;Bitutė;Drugelių;2085899696;Ne;0;1;0;1
897;Bitutė;Drugelių;7376746010;Ne;0;4;3;7
898;Bitutė;Drugelių;5845408472;Ne;2;1;0;3
899;Bitutė;Drugelių;3611348253;Ne;5;3;1;9
900;Bitutė;Drugelių;8727525320;Ne;5;3;0;8
901;Bitutė;Drugelių;5796600501;Ne;0;0;3;3
902;Bitutė;Drugelių;1558826102;Ne;7;0;0;7
903;Bitutė;Drugelių;6325890676;Ne;11;0;2;13
904;Bitutė;Drugelių;2748400429;Ne;0;10;0;10
905;Bitutė;Drugelių;5146691157;Ne;2;2;0;4
906;Bitutė;Drugelių;2848732083;Ne;9;0;1;10
907;Bitutė;Drugelių;5278510767;Ne;3;4;0;7
908;Bitutė;Drugelių;8962725357;Ne;6;0;2;8
909;Bitutė;Drugelių;5471241132;Ne;0;1;5;6
910;Bitutė;Drugelių;1218462939;Ne;0;4;0;4
911;Bitutė;Drugelių;5081300818;Ne;10;0;0;10
912;Bitutė;Drugelių;7013249141;Ne;2;0;7;9
913;Bitutė;Drugelių;1397711778;Ne;0;0;6;6
914;Bitutė;Drugelių;8008237092;Ne;5;4;2;11
915;Bitutė;Drugelių;4545188971;Ne;0;17;2;19
916;Bitutė;Kiškučių;9451529077;Ne;0;2;0;2
917;Bitutė;Kiškučių;1907876695;Ne;0;4;0;4
918;Bitutė;Kiškučių;7720798466;Ne;0;4;0;4
919;Bitutė;Kiškučių;1662815358;Ne;1;2;0;3
920;Bitutė;Kiškučių;1733189730;Ne;2;5;0;7
921;Bitutė;Kiškučių;9966437881;Ne;0;4;0;4
922;Bitutė;Kiškučių;1985958540;Ne;2;0;0;2
923;Bitutė;Kiškučių;2806899030;Ne;0;10;0;10
924;Bitutė;Kiškučių;5443722813;Ne;0;3;0;3
925;Bitutė;Kiškučių;1241863345;Ne;8;0;0;8
926;Bitutė;Kiškučių;8789574593;Ne;0;1;0;1
927;Bitutė;Kiškučių;4639968278;Ne;4;1;0;5
928;Bitutė;Kiškučių;5490753578;Ne;10;0;0;10
929;Bitutė;"Viščiukų ";3603716923;Ne;18;0;0;18
930;Bitutė;"Viščiukų ";5181958187;Ne;7;0;0;7
931;Bitutė;"Viščiukų ";7694916340;Ne;13;1;0;14
932;Bitutė;"Viščiukų ";8303932330;Ne;0;8;1;9
933;Bitutė;"Viščiukų ";8642411661;Ne;0;2;0;2
934;Bitutė;"Viščiukų ";1198024852;Ne;0;2;0;2
935;Bitutė;"Viščiukų ";9909017070;Ne;0;2;0;2
936;Bitutė;"Viščiukų ";3811028304;Ne;13;0;0;13
937;Bitutė;"Viščiukų ";9592567172;Ne;0;2;0;2
938;Bitutė;"Viščiukų ";7619112317;Ne;0;1;0;1
939;Bitutė;"Viščiukų ";1715987321;Ne;3;0;0;3
940;Bitutė;"Viščiukų ";4926289620;Ne;0;21;0;21
941;Bitutė;"Viščiukų ";8130382253;Ne;6;0;0;6
942;Bitutė;"Viščiukų ";5869737425;Ne;11;0;0;11
943;Bitutė;"Viščiukų ";5220694242;Ne;0;2;0;2
944;Bitutė;"Viščiukų ";4480187618;Ne;0;0;1;1
945;Bitutė;"Viščiukų ";5061164237;Ne;0;3;0;3
946;Bitutė;"Skruzdėliukai ";5686278261;Ne;0;4;1;5
947;Bitutė;"Skruzdėliukai ";1423694056;Ne;0;2;0;2
948;Bitutė;"Skruzdėliukai ";5942493696;Ne;0;1;0;1
949;Bitutė;"Skruzdėliukai ";6311396261;Ne;0;1;0;1
950;Bitutė;"Skruzdėliukai ";7145036085;Ne;5;0;1;6
951;Bitutė;"Skruzdėliukai ";2252157473;Ne;6;0;1;7
952;Bitutė;"Skruzdėliukai ";4513783927;Ne;0;7;0;7
953;Bitutė;"Skruzdėliukai ";8667259778;Ne;2;0;6;8
954;Bitutė;"Skruzdėliukai ";8607718704;Ne;0;0;3;3
955;Bitutė;"Skruzdėliukai ";4413880918;Ne;9;0;0;9
956;Bitutė;"Skruzdėliukai ";9436414962;Ne;5;2;0;7
957;Bitutė;"Skruzdėliukai ";9864771568;Ne;6;0;3;9
958;Bitutė;"Skruzdėliukai ";6353690252;Ne;8;0;2;10
959;Bitutė;"Skruzdėliukai ";2160735504;Ne;8;0;0;8
960;Bitutė;"Skruzdėliukai ";1387310054;Ne;5;0;0;5
961;Bitutė;"Skruzdėliukai ";7245807233;Ne;7;0;4;11
962;Bitutė;"Skruzdėliukai ";4467090141;Ne;7;0;0;7
963;Bitutė;"Skruzdėliukai ";5433617195;Ne;0;3;0;3
964;Bitutė;"Skruzdėliukai ";2391170362;Ne;0;2;1;3
965;Bitutė;"Nykštukų ";1290146001;Taip;17;0;0;17
966;Bitutė;"Nykštukų ";3359918177;Ne;5;0;0;5
967;Bitutė;"Nykštukų ";9352292654;Ne;6;0;2;8
968;Bitutė;"Nykštukų ";5421744666;Ne;0;1;0;1
969;Bitutė;"Nykštukų ";9780599803;Ne;5;3;0;8
970;Bitutė;"Nykštukų ";7741454857;Ne;0;0;2;2
971;Bitutė;"Nykštukų ";6226996242;Ne;10;2;0;12
972;Bitutė;"Nykštukų ";1460746240;Ne;5;0;0;5
973;Bitutė;"Nykštukų ";8896842164;Ne;0;21;0;21
974;Bitutė;"Nykštukų ";2819417600;Ne;0;4;1;5
975;Bitutė;"Nykštukų ";8561037889;Ne;0;3;0;3
976;Bitutė;"Nykštukų ";6091108131;Ne;3;2;0;5
977;Bitutė;"Nykštukų ";3528436838;Ne;7;1;0;8
978;Bitutė;"Nykštukų ";4617493676;Ne;6;0;9;15
979;Bitutė;"Nykštukų ";3806852067;Ne;10;8;0;18
980;Coliukė;DRUGELIAI;3151183436;Ne;0;0;1;1
981;Coliukė;DRUGELIAI;6675290003;Ne;10;5;0;15
982;Coliukė;DRUGELIAI;9890663421;Ne;3;1;0;4
983;Coliukė;DRUGELIAI;7763035106;Ne;4;1;0;5
984;Coliukė;DRUGELIAI;9688432169;Ne;10;0;0;10
985;Coliukė;DRUGELIAI;7513522378;Ne;5;4;0;9
986;Coliukė;DRUGELIAI;8478006305;Ne;6;4;1;11
987;Coliukė;DRUGELIAI;9352547729;Ne;0;2;1;3
988;Coliukė;DRUGELIAI;3908791146;Ne;5;0;0;5
989;Coliukė;DRUGELIAI;9750447455;Ne;9;2;0;11
990;Coliukė;DRUGELIAI;3367789231;Ne;11;0;2;13
991;Coliukė;DRUGELIAI;3392367716;Ne;3;2;1;6
992;Coliukė;DRUGELIAI;7621095517;Ne;0;0;1;1
993;Coliukė;DRUGELIAI;4140716483;Ne;5;0;0;5
994;Coliukė;DRUGELIAI;2385917598;Ne;3;2;0;5
995;Coliukė;DRUGELIAI;1390751418;Ne;15;4;0;19
996;Coliukė;DRUGELIAI;4881447596;Ne;0;8;0;8
997;Coliukė;DRUGELIAI;7284465232;Ne;7;4;0;11
998;Coliukė;DRUGELIAI;8756465257;Ne;14;4;0;18
999;Coliukė;BITUTĖS;6725408547;Ne;5;3;1;9
1000;Coliukė;BITUTĖS;2167230398;Ne;0;2;0;2
1001;Coliukė;BITUTĖS;5349969025;Ne;0;0;2;2
1002;Coliukė;BITUTĖS;1960898805;Ne;0;8;0;8
1003;Coliukė;BITUTĖS;7920728387;Ne;4;11;0;15
1004;Coliukė;BITUTĖS;8767261039;Ne;6;6;0;12
1005;Coliukė;BITUTĖS;1968467455;Ne;9;1;0;10
1006;Coliukė;BITUTĖS;9462610674;Ne;4;2;0;6
1007;Coliukė;BITUTĖS;4188233426;Ne;6;7;0;13
1008;Coliukė;BITUTĖS;8457120425;Ne;0;1;0;1
1009;Coliukė;BITUTĖS;1240946719;Ne;0;6;0;6
1010;Coliukė;BITUTĖS;9331485675;Ne;4;4;0;8
1011;Coliukė;BITUTĖS;9311775782;Ne;0;4;0;4
1012;Coliukė;BITUTĖS;2275327607;Ne;0;1;0;1
1013;Coliukė;BITUTĖS;9879369365;Ne;13;5;0;18
1014;Coliukė;BITUTĖS;4845247006;Ne;6;0;0;6
1015;Coliukė;BITUTĖS;9885547263;Ne;1;0;0;1
1016;Coliukė;BITUTĖS;36554487034;Ne;0;5;0;5
1017;Coliukė;BITUTĖS;6860757091;Ne;0;14;0;14
1018;Coliukė;BITUTĖS;8517128464;Ne;0;4;0;4
1019;Coliukė;BITUTĖS;8149118599;Ne;0;2;0;2
1020;Coliukė;BITUTĖS;7345905007;Ne;6;6;0;12
1021;Coliukė;BITUTĖS;7358018315;Ne;16;0;0;16
1022;Coliukė;VABALIUKAI;1105879142;Ne;0;1;0;1
1023;Coliukė;VABALIUKAI;1537341012;Ne;7;0;3;10
1024;Coliukė;VABALIUKAI;6984254334;Ne;15;0;0;15
1025;Coliukė;VABALIUKAI;5835199087;Ne;0;5;0;5
1026;Coliukė;VABALIUKAI;4626722910;Ne;3;0;1;4
1027;Coliukė;VABALIUKAI;9526108197;Ne;0;8;0;8
1028;Coliukė;VABALIUKAI;1318558913;Ne;0;4;3;7
1029;Coliukė;VABALIUKAI;6475497234;Ne;6;1;1;8
1030;Coliukė;VABALIUKAI;5596775091;Ne;6;1;1;8
1031;Coliukė;VABALIUKAI;4172517506;Ne;0;3;0;3
1032;Coliukė;VABALIUKAI;4493314926;Ne;7;3;0;10
1033;Coliukė;VABALIUKAI;2469993058;Ne;5;4;0;9
1034;Coliukė;VABALIUKAI;4739310916;Ne;7;5;0;12
1035;Coliukė;VABALIUKAI;5541328815;Ne;0;1;0;1
1036;Coliukė;VABALIUKAI;4649987214;Ne;6;5;0;11
1037;Coliukė;VABALIUKAI;3905904092;Ne;1;1;2;4
1038;Coliukė;VABALIUKAI;9083546061;Ne;5;1;0;6
1039;Coliukė;VABALIUKAI;1476750428;Ne;0;2;0;2
1040;Coliukė;VABALIUKAI;7622526793;Ne;0;7;0;7
1041;Coliukė;VABALIUKAI;1328505569;Ne;0;10;0;10
1042;Coliukė;VABALIUKAI;9268436167;Ne;0;4;0;4
1043;Coliukė;VABALIUKAI;9368334915;Ne;10;1;0;11
1044;Coliukė;VABALIUKAI;5108993131;Ne;5;4;0;9
1045;Coliukė;NYKŠTUKAI;6441253648;Ne;2;0;0;2
1046;Coliukė;NYKŠTUKAI;4537756081;Ne;0;7;0;7
1047;Coliukė;NYKŠTUKAI;3719547522;Ne;11;1;0;12
1048;Coliukė;NYKŠTUKAI;6403149921;Ne;11;1;0;12
1049;Coliukė;NYKŠTUKAI;5450167562;Ne;0;1;0;1
1050;Coliukė;NYKŠTUKAI;9498557347;Ne;5;0;0;5
1051;Coliukė;NYKŠTUKAI;3384332079;Ne;11;1;0;12
1052;Coliukė;NYKŠTUKAI;1198781036;Ne;0;1;0;1
1053;Coliukė;NYKŠTUKAI;5283583324;Ne;5;3;0;8
1054;Coliukė;NYKŠTUKAI;9334564869;Ne;5;10;0;15
1055;Coliukė;NYKŠTUKAI;6781303455;Ne;0;5;0;5
1056;Coliukė;NYKŠTUKAI;3140659021;Ne;0;0;17;17
1057;Coliukė;NYKŠTUKAI;4845049639;Ne;19;0;0;19
1058;Coliukė;NYKŠTUKAI;3221157300;Ne;19;2;0;21
1059;Coliukė;NYKŠTUKAI;7870865302;Ne;0;12;0;12
1060;Coliukė;NYKŠTUKAI;1575061659;Ne;12;0;0;12
1061;Coliukė;NYKŠTUKAI;7502911642;Ne;7;4;0;11
1062;Coliukė;NYKŠTUKAI;4635299740;Ne;5;6;0;11
1063;Coliukė;GĖLYTĖS;9442511803;Ne;0;4;17;21
1064;Coliukė;GĖLYTĖS;6611713551;Ne;9;2;0;11
1065;Coliukė;GĖLYTĖS;6755886435;Ne;12;0;2;14
1066;Coliukė;GĖLYTĖS;1220385522;Ne;9;0;0;9
1067;Coliukė;GĖLYTĖS;8601059431;Ne;4;4;1;9
1068;Coliukė;GĖLYTĖS;1452034828;Ne;12;0;0;12
1069;Coliukė;GĖLYTĖS;6816085304;Ne;0;4;0;4
1070;Coliukė;GĖLYTĖS;6941719947;Ne;0;4;0;4
1071;Coliukė;GĖLYTĖS;9107676840;Ne;0;1;1;2
1072;Coliukė;GĖLYTĖS;8606195508;Ne;10;0;2;12
1073;Coliukė;"BORUŽĖLĖS (SPEC.)";2080118127;Ne;5;3;0;8
1074;Coliukė;"BORUŽĖLĖS (SPEC.)";2617816991;Ne;5;5;0;10
1075;Coliukė;"BORUŽĖLĖS (SPEC.)";1233731506;Ne;0;10;1;11
1076;Coliukė;"BORUŽĖLĖS (SPEC.)";1644303265;Ne;10;2;3;15
1077;Coliukė;"BORUŽĖLĖS (SPEC.)";5706671963;Ne;0;9;2;11
1078;Coliukė;"BORUŽĖLĖS (SPEC.)";7826554599;Ne;13;0;1;14
1079;Coliukė;"BORUŽĖLĖS (SPEC.)";6920961967;Ne;0;4;0;4
1080;Coliukė;"BORUŽĖLĖS (SPEC.)";1134875499;Ne;0;1;0;1
1081;Coliukė;"BORUŽĖLĖS (SPEC.)";2351866339;Ne;3;0;9;12
1082;Coliukė;"BORUŽĖLĖS (SPEC.)";5756690199;Ne;11;3;0;14
1083;Coliukė;"BORUŽĖLĖS (SPEC.)";2947495861;Ne;9;1;2;12
1084;Coliukė;"BORUŽĖLĖS (SPEC.)";6246392335;Ne;6;2;1;9
1085;Coliukė;"BORUŽĖLĖS (SPEC.)";8347206534;Ne;0;1;0;1
1086;Coliukė;"BORUŽĖLĖS (SPEC.)";5008183731;Ne;7;1;0;8
1087;Čiauškutis;BITUTĖS;7893181156;Ne;6;1;0;7
1088;Čiauškutis;BITUTĖS;7976738303;Ne;0;1;5;6
1089;Čiauškutis;BITUTĖS;4026881335;Ne;3;1;1;5
1090;Čiauškutis;BITUTĖS;9753680961;Ne;0;7;0;7
1091;Čiauškutis;BITUTĖS;4652951382;Ne;0;12;9;21
1092;Čiauškutis;BITUTĖS;2319237497;Ne;7;0;0;7
1093;Čiauškutis;BITUTĖS;1765857419;Ne;4;3;0;7
1094;Čiauškutis;BITUTĖS;7282041196;Ne;6;15;0;21
1095;Čiauškutis;ŽVIRBLIUKAI;7654242839;Ne;18;0;0;18
1096;Čiauškutis;ŽVIRBLIUKAI;9565722619;Ne;0;20;1;21
1097;Čiauškutis;ŽVIRBLIUKAI;5125518366;Ne;11;0;0;11
1098;Čiauškutis;ŽVIRBLIUKAI;9294208012;Ne;0;0;3;3
1099;Čiauškutis;ŽVIRBLIUKAI;4962200863;Ne;21;0;0;21
1100;Čiauškutis;ŽVIRBLIUKAI;7468763527;Ne;0;0;6;6
1101;Čiauškutis;ŽVIRBLIUKAI;7324659239;Ne;0;1;0;1
1102;Čiauškutis;ŽVIRBLIUKAI;4216443034;Ne;0;0;1;1
1103;Čiauškutis;ŽVIRBLIUKAI;2096533965;Ne;14;1;0;15
1104;Čiauškutis;ŽVIRBLIUKAI;8297774828;Ne;5;1;0;6
1105;Čiauškutis;SAULUTĖS;7027181377;Ne;0;19;2;21
1106;Čiauškutis;SAULUTĖS;43313173294;Ne;0;21;0;21
1107;Čiauškutis;SAULUTĖS;9052859205;Ne;0;1;0;1
1108;Čiauškutis;SAULUTĖS;7367933940;Ne;0;1;1;2
1109;Čiauškutis;SAULUTĖS;4658994599;Ne;4;0;0;4
1110;Čiauškutis;SAULUTĖS;6115354862;Ne;9;3;2;14
1111;Čiauškutis;SAULUTĖS;5759367884;Ne;0;7;2;9
1112;Čiauškutis;EŽIUKAI;2686038029;Ne;0;0;4;4
1113;Čiauškutis;EŽIUKAI;7489733038;Ne;0;0;2;2
1114;Čiauškutis;EŽIUKAI;5404165993;Ne;0;3;0;3
1115;Čiauškutis;EŽIUKAI;5910818962;Ne;12;0;0;12
1116;Čiauškutis;EŽIUKAI;1234494170;Ne;7;0;0;7
1117;Čiauškutis;DRUGELIAI;7080320173;Ne;0;0;1;1
1118;Čiauškutis;DRUGELIAI;9072764004;Ne;12;0;0;12
1119;Čiauškutis;DRUGELIAI;1036358147;Ne;10;1;0;11
1120;Čiauškutis;DRUGELIAI;1750040659;Ne;4;0;1;5
1121;Čiauškutis;DRUGELIAI;8346845876;Ne;0;4;2;6
1122;Čiauškutis;DRUGELIAI;3724324861;Ne;5;16;0;21
1123;Čiauškutis;DRUGELIAI;2237570705;Ne;0;1;6;7
1124;Čiauškutis;DRUGELIAI;9073514151;Ne;8;0;1;9
1125;Čiauškutis;DRUGELIAI;4681902267;Ne;0;0;3;3
1126;Čiauškutis;GENELIAI;76449285846;Ne;4;2;0;6
1127;Čiauškutis;GENELIAI;6435287215;Ne;0;1;0;1
1128;Čiauškutis;GENELIAI;1456067541;Ne;3;0;0;3
1129;Čiauškutis;GENELIAI;1657452686;Ne;0;6;1;7
1130;Čiauškutis;GENELIAI;1739403100;Ne;0;21;0;21
1131;Čiauškutis;GENELIAI;6994301415;Ne;4;4;2;10
1132;Čiauškutis;GENELIAI;1224986101;Ne;0;1;1;2
1133;Čiauškutis;GENELIAI;1809511815;Ne;0;4;6;10
1134;Čiauškutis;LINKSMUČIAI;73016259669;Ne;3;4;1;8
1135;Čiauškutis;LINKSMUČIAI;8689127061;Ne;20;1;0;21
1136;Čiauškutis;LINKSMUČIAI;9062135043;Ne;0;10;3;13
1137;Čiauškutis;LINKSMUČIAI;1533938659;Ne;7;0;0;7
1138;Čiauškutis;LINKSMUČIAI;1306672095;Ne;0;0;2;2
1139;Čiauškutis;LINKSMUČIAI;8857039064;Ne;0;0;1;1
1140;Čiauškutis;KIŠKUČIAI;1396093940;Ne;1;0;1;2
1141;Čiauškutis;KIŠKUČIAI;3465024013;Ne;0;20;1;21
1142;Čiauškutis;KIŠKUČIAI;9754417066;Ne;10;0;2;12
1143;Čiauškutis;KIŠKUČIAI;8580034134;Ne;0;0;6;6
1144;Čiauškutis;KIŠKUČIAI;3650541072;Ne;0;0;3;3
1145;Čiauškutis;KIŠKUČIAI;2445742257;Ne;6;13;2;21
1146;Čiauškutis;KIŠKUČIAI;6785604459;Ne;21;0;0;21
1147;Čiauškutis;LAPIUKAI;5052137859;Ne;0;20;1;21
1148;Čiauškutis;LAPIUKAI;7428833348;Ne;0;0;1;1
1149;Čiauškutis;LAPIUKAI;9897499968;Ne;0;21;0;21
1150;Čiauškutis;LAPIUKAI;2737503753;Ne;0;0;1;1
1151;Čiauškutis;LAPIUKAI;8876608072;Ne;5;2;5;12
1152;Čiauškutis;LAPIUKAI;4881821738;Ne;5;1;0;6
1153;Čiauškutis;LAPIUKAI;4881821738;Ne;5;1;0;6
1154;Čiauškutis;LAPIUKAI;6810906239;Ne;0;20;1;21
1155;Čiauškutis;LAPIUKAI;9460608737;Ne;0;0;8;8
1156;Čiauškutis;MEŠKUČIAI;7135435979;Ne;0;4;4;8
1157;Čiauškutis;MEŠKUČIAI;7274368180;Ne;3;0;3;6
1158;Čiauškutis;MEŠKUČIAI;6146321785;Ne;0;20;1;21
1159;Čiauškutis;MEŠKUČIAI;6434727608;Ne;5;16;0;21
1160;Čiauškutis;MEŠKUČIAI;2172687454;Ne;9;0;1;10
1161;Čiauškutis;MEŠKUČIAI;3660195990;Ne;4;0;0;4
1162;Čiauškutis;PELĖDŽIUKAI;9228568063;Ne;4;0;0;4
1163;Čiauškutis;PELĖDŽIUKAI;1561833758;Ne;0;0;1;1
1164;Čiauškutis;PELĖDŽIUKAI;7931998640;Ne;0;0;1;1
1165;Čiauškutis;PELĖDŽIUKAI;6615319751;Ne;4;0;1;5
1166;Čiauškutis;PELĖDŽIUKAI;2377986721;Ne;6;0;0;6
1167;Čiauškutis;NYKŠTUKAI;8948893335;Ne;5;4;0;9
1168;Čiauškutis;NYKŠTUKAI;2633243682;Ne;7;1;0;8
1169;Čiauškutis;NYKŠTUKAI;6726124641;Ne;0;5;0;5
1170;Čiauškutis;NYKŠTUKAI;6705934636;Ne;0;2;0;2
1171;Čiauškutis;NYKŠTUKAI;5957587644;Ne;8;0;5;13
1172;Čiauškutis;NYKŠTUKAI;1733251156;Ne;10;0;0;10
1173;Čiauškutis;NYKŠTUKAI;5575614158;Ne;2;2;1;5
1174;Čiauškutis;NYKŠTUKAI;2044220236;Ne;0;1;0;1
1175;Čiauškutis;NYKŠTUKAI;7335655769;Ne;7;0;0;7
1176;Delfinukas;Boružėlių;9184207705;Ne;0;2;2;4
1177;Delfinukas;Boružėlių;2819680099;Ne;5;2;0;7
1178;Delfinukas;Boružėlių;3205671100;Ne;0;2;0;2
1179;Delfinukas;Boružėlių;1119373532;Ne;9;0;1;10
1180;Delfinukas;Boružėlių;4488260667;Ne;3;5;0;8
1181;Delfinukas;Boružėlių;7737665102;Ne;2;2;0;4
1182;Delfinukas;Boružėlių;4985159933;Ne;4;0;0;4
1183;Delfinukas;Boružėlių;5443027988;Ne;0;6;0;6
1184;Delfinukas;Boružėlių;4567479900;Ne;11;0;1;12
1185;Delfinukas;Boružėlių;9747075687;Ne;0;2;0;2
1186;Delfinukas;Boružėlių;5585334518;Ne;3;2;0;5
1187;Delfinukas;Boružėlių;4327924499;Ne;4;0;0;4
1188;Delfinukas;Boružėlių;6301767635;Ne;0;10;0;10
1189;Delfinukas;Saulytės;8315269427;Ne;2;0;4;6
1190;Delfinukas;Saulytės;4215887291;Ne;0;1;0;1
1191;Delfinukas;Saulytės;3631520143;Ne;0;0;3;3
1192;Delfinukas;Saulytės;9424966984;Ne;0;0;7;7
1193;Delfinukas;Saulytės;6069600728;Ne;3;0;1;4
1194;Delfinukas;Saulytės;9729550922;Taip;0;6;0;6
1195;Delfinukas;Saulytės;1404270345;Ne;4;1;1;6
1196;Delfinukas;Saulytės;8402529296;Ne;5;4;0;9
1197;Delfinukas;Saulytės;5125346405;Ne;0;1;0;1
1198;Delfinukas;Saulytės;5642328792;Ne;15;1;0;16
1199;Delfinukas;Saulytės;8176576958;Ne;2;0;0;2
1200;Delfinukas;Saulytės;8275943176;Ne;0;0;7;7
1201;Delfinukas;Saulytės;8085530134;Taip;0;11;0;11
1202;Delfinukas;Saulytės;8148610460;Ne;0;5;1;6
1203;Delfinukas;Saulytės;6935992202;Ne;0;0;1;1
1204;Delfinukas;Saulytės;8186312409;Ne;0;4;0;4
1205;Delfinukas;Saulytės;5665463557;Ne;0;3;0;3
1206;Delfinukas;Saulytės;5397241026;Ne;14;4;0;18
1207;Delfinukas;Pelėdžiukų;3940838205;Ne;6;2;0;8
1208;Delfinukas;Pelėdžiukų;8774145277;Ne;0;4;0;4
1209;Delfinukas;Pelėdžiukų;6113662246;Ne;0;16;5;21
1210;Delfinukas;Pelėdžiukų;4710894128;Ne;5;1;3;9
1211;Delfinukas;Pelėdžiukų;1526129772;Ne;0;1;4;5
1212;Delfinukas;Pelėdžiukų;8659309242;Ne;7;0;0;7
1213;Delfinukas;Pelėdžiukų;8267992425;Ne;0;13;0;13
1214;Delfinukas;Pelėdžiukų;9319874239;Taip;0;2;0;2
1215;Delfinukas;Pelėdžiukų;2809947323;Ne;8;0;0;8
1216;Delfinukas;Pelėdžiukų;3465186420;Ne;0;1;10;11
1217;Delfinukas;Pelėdžiukų;4096274346;Taip;10;2;3;15
1218;Delfinukas;Pelėdžiukų;5246300518;Ne;0;0;7;7
1219;Delfinukas;Pelėdžiukų;3702341009;Ne;0;4;0;4
1220;Delfinukas;Pelėdžiukų;2420308954;Ne;0;0;6;6
1221;Delfinukas;Pelėdžiukų;6286748047;Ne;2;9;0;11
1222;Delfinukas;Pelėdžiukų;1918878505;Ne;0;2;0;2
1223;Delfinukas;Pelėdžiukų;1575125658;Ne;4;3;0;7
1224;Delfinukas;Pelėdžiukų;3633392440;Ne;9;0;7;16
1225;Delfinukas;Varliukų;4949220786;Ne;8;6;2;16
1226;Delfinukas;Varliukų;2792051636;Taip;11;2;7;20
1227;Delfinukas;Varliukų;3577180085;Ne;6;0;7;13
1228;Delfinukas;Varliukų;6115370195;Ne;5;0;0;5
1229;Delfinukas;Varliukų;3050258185;Ne;8;0;0;8
1230;Delfinukas;Varliukų;7976681530;Ne;7;0;2;9
1231;Delfinukas;Varliukų;9360553910;Ne;6;9;0;15
1232;Delfinukas;Varliukų;6301601832;Ne;0;2;0;2
1233;Delfinukas;Varliukų;5095713834;Ne;15;1;0;16
1234;Delfinukas;Varliukų;5964021733;Ne;19;6;0;25
1235;Delfinukas;Varliukų;5821591959;Ne;0;5;0;5
1236;Delfinukas;Varliukų;9095895182;Ne;5;0;0;5
1237;Delfinukas;Varliukų;5138840297;Ne;0;2;0;2
1238;Delfinukas;Varliukų;7072060541;Ne;9;1;0;10
1239;Delfinukas;Varliukų;3797355501;Ne;6;4;3;13
1240;Delfinukas;Varliukų;4751611934;Taip;0;7;0;7
1241;Delfinukas;Varliukų;4254414928;Taip;10;2;1;13
1242;Delfinukas;Varliukų;7359531377;Ne;6;0;0;6
1243;Delfinukas;Varpelių;8913681176;Ne;0;1;0;1
1244;Delfinukas;Varpelių;9514189769;Ne;0;6;0;6
1245;Delfinukas;Varpelių;4713803167;Ne;9;7;0;16
1246;Delfinukas;Varpelių;3818558339;Ne;5;10;1;16
1247;Delfinukas;Varpelių;1484123788;Ne;0;1;5;6
1248;Delfinukas;Varpelių;8829835426;Ne;1;0;3;4
1249;Delfinukas;Varpelių;4500756171;Ne;2;0;0;2
1250;Delfinukas;Varpelių;8953230752;Ne;0;1;0;1
1251;Delfinukas;Varpelių;7780893730;Ne;0;1;2;3
1252;Delfinukas;Varpelių;2730512600;Ne;0;5;0;5
1253;Delfinukas;Drugeliai;7615519932;Ne;6;1;0;7
1254;Delfinukas;Drugeliai;6604115681;Ne;4;9;0;13
1255;Delfinukas;Drugeliai;5990192934;Ne;6;6;0;12
1256;Delfinukas;Drugeliai;9635669748;Ne;4;1;0;5
1257;Delfinukas;Drugeliai;8526813977;Ne;4;1;0;5
1258;Delfinukas;Drugeliai;6873181103;Ne;0;4;0;4
1259;Delfinukas;Drugeliai;4484804360;Ne;0;1;0;1
1260;Delfinukas;Drugeliai;8328481987;Ne;0;2;4;6
1261;Delfinukas;Drugeliai;6992505341;Ne;0;2;5;7
1262;Delfinukas;Drugeliai;2756574162;Ne;11;1;0;12
1263;Delfinukas;Drugeliai;2985669766;Ne;8;1;3;12
1264;Delfinukas;Drugeliai;6457042338;Ne;0;8;0;8
1265;Delfinukas;Drugeliai;5060445169;Ne;0;1;0;1
1266;Delfinukas;Drugeliai;3134897964;Ne;3;5;3;11
1267;Delfinukas;Drugeliai;8411289299;Ne;0;4;0;4
1268;Delfinukas;Drugeliai;2683746435;Ne;0;0;2;2
1269;Delfinukas;Žuvytės;8160982025;Ne;0;2;0;2
1270;Delfinukas;Žuvytės;6949000708;Ne;0;0;6;6
1271;Delfinukas;Žuvytės;6572690788;Ne;0;6;0;6
1272;Delfinukas;Žuvytės;7873373923;Ne;0;0;2;2
1273;Delfinukas;Žuvytės;2066127119;Ne;5;6;0;11
1274;Delfinukas;Žuvytės;8702718951;Taip;0;2;1;3
1275;Delfinukas;Žuvytės;6844500395;Ne;2;3;4;9
1276;Delfinukas;Žuvytės;6445868759;Ne;0;3;2;5
1277;Delfinukas;Žuvytės;4678970810;Ne;10;0;0;10
1278;Delfinukas;Delfinai;2890469172;Ne;0;0;5;5
1279;Delfinukas;Delfinai;9628317328;Ne;0;5;2;7
1280;Delfinukas;Delfinai;8038737019;Ne;0;0;4;4
1281;Delfinukas;Delfinai;5797308373;Ne;8;0;0;8
1282;Delfinukas;Delfinai;5241426445;Ne;7;0;8;15
1283;Delfinukas;Delfinai;3108430680;Ne;0;3;0;3
1284;Delfinukas;Delfinai;7663934825;Ne;0;0;2;2
1285;Delfinukas;Delfinai;2382077576;Ne;0;2;1;3
1286;Delfinukas;Delfinai;7629622746;Ne;7;0;2;9
1287;Delfinukas;Delfinai;4347116918;Ne;10;5;0;15
1288;Delfinukas;Delfinai;1922513830;Ne;7;0;0;7
1289;Delfinukas;Delfinai;6270012707;Ne;3;6;0;9
1290;Delfinukas;Delfinai;8085481968;Ne;0;4;0;4
1291;Delfinukas;Delfinai;9605756229;Ne;0;1;0;1
1292;Delfinukas;Delfinai;3407321091;Ne;10;2;0;12
1293;Delfinukas;Delfinai;7354837777;Ne;7;0;0;7
1294;Delfinukas;Delfinai;9903010418;Ne;0;5;0;5
1295;Delfinukas;Delfinai;6522639028;Taip;9;0;3;12
1296;Delfinukas;Paukšteliai;7366145460;Ne;8;0;0;8
1297;Delfinukas;Paukšteliai;5278689745;Ne;5;5;0;10
1298;Delfinukas;Paukšteliai;6002086491;Ne;0;4;0;4
1299;Delfinukas;Paukšteliai;1164720538;Ne;7;4;0;11
1300;Delfinukas;Paukšteliai;9629225917;Ne;1;1;0;2
1301;Delfinukas;Paukšteliai;9332794060;Ne;4;2;2;8
1302;Delfinukas;Paukšteliai;6650725760;Ne;11;0;7;18
1303;Delfinukas;Paukšteliai;7968869585;Ne;17;1;0;18
1304;Delfinukas;Paukšteliai;5164599763;Ne;15;0;0;15
1305;Delfinukas;Paukšteliai;9776618488;Ne;7;1;1;9
1306;Delfinukas;Paukšteliai;9586646352;Ne;13;6;0;19
1307;Delfinukas;Paukšteliai;4561911078;Ne;18;0;9;27
1308;Delfinukas;Paukšteliai;4755699845;Ne;14;0;0;14
1309;Delfinukas;Kiškučiai;2094258481;Ne;0;2;0;2
1310;Delfinukas;Kiškučiai;4119370256;Ne;0;6;0;6
1311;Delfinukas;Kiškučiai;9602317911;Taip;0;2;0;2
1312;Delfinukas;Kiškučiai;8625023976;Ne;5;0;0;5
1313;Delfinukas;Kiškučiai;3284212595;Ne;0;0;1;1
1314;Delfinukas;Kiškučiai;6531930806;Ne;0;4;1;5
1315;Delfinukas;Kiškučiai;8439204095;Ne;9;1;0;10
1316;Delfinukas;Kiškučiai;5783537897;Ne;5;0;1;6
1317;Delfinukas;Kiškučiai;8728791932;Ne;6;1;1;8
1318;Delfinukas;Kiškučiai;2883959240;Ne;0;2;1;3
1319;Delfinukas;Kiškučiai;4179507316;Ne;0;7;0;7
1320;Delfinukas;Kiškučiai;8440546956;Ne;5;4;0;9
1321;Delfinukas;Kiškučiai;1030958414;Ne;4;3;0;7
1322;Delfinukas;Kiškučiai;6577214344;Ne;0;10;1;11
1323;Delfinukas;BITUTĖS;9719348837;Ne;12;0;0;12
1324;Delfinukas;BITUTĖS;6601922746;Ne;0;9;0;9
1325;Delfinukas;BITUTĖS;8896957908;Ne;0;0;2;2
1326;Delfinukas;BITUTĖS;3239635507;Ne;0;0;1;1
1327;Delfinukas;BITUTĖS;6929926768;Ne;4;1;0;5
1328;Delfinukas;BITUTĖS;5179080544;Ne;0;9;0;9
1329;Delfinukas;BITUTĖS;9941631164;Ne;0;9;0;9
1330;Delfinukas;BITUTĖS;4198261848;Ne;2;0;8;10
1331;Delfinukas;BITUTĖS;8081895401;Ne;2;0;1;3
1332;Delfinukas;BITUTĖS;5600320855;Ne;7;9;5;21
1333;Delfinukas;BITUTĖS;2377204734;Ne;0;7;5;12
1334;Delfinukas;BITUTĖS;6243471374;Ne;0;9;0;9
1335;Delfinukas;BITUTĖS;4303234827;Ne;21;0;0;21
1336;Delfinukas;BITUTĖS;6325092903;Ne;8;0;0;8
1337;Drevinukas;ZUIKUČIAI;5500759834;Ne;0;5;0;5
1338;Drevinukas;ZUIKUČIAI;1595081335;Ne;2;0;2;4
1339;Drevinukas;ZUIKUČIAI;2646799484;Ne;0;0;7;7
1340;Drevinukas;ZUIKUČIAI;2772424629;Ne;0;10;5;15
1341;Drevinukas;ZUIKUČIAI;5928234487;Ne;0;4;1;5
1342;Drevinukas;ZUIKUČIAI;1567790084;Ne;2;0;2;4
1343;Drevinukas;ZUIKUČIAI;3293457412;Ne;0;6;3;9
1344;Drevinukas;ZUIKUČIAI;6243097297;Ne;0;4;2;6
1345;Drevinukas;ZUIKUČIAI;5704489483;Ne;5;2;1;8
1346;Drevinukas;ZUIKUČIAI;7054681115;Ne;0;2;6;8
1347;Drevinukas;ZUIKUČIAI;3381363132;Ne;4;1;0;5
1348;Drevinukas;ZUIKUČIAI;6462582301;Ne;5;0;0;5
1349;Drevinukas;ZUIKUČIAI;3070518153;Ne;0;0;1;1
1350;Drevinukas;ZUIKUČIAI;9174977150;Ne;0;4;0;4
1351;Drevinukas;ZUIKUČIAI;4243045398;Ne;9;0;0;9
1352;Drevinukas;ZUIKUČIAI;4309475233;Ne;9;0;0;9
1353;Drevinukas;ZUIKUČIAI;6393960467;Ne;0;2;1;3
1354;Drevinukas;AŽUOLIUKŲ;1644656704;Ne;10;0;0;10
1355;Drevinukas;AŽUOLIUKŲ;5721031754;Ne;15;0;0;15
1356;Drevinukas;AŽUOLIUKŲ;4714478955;Ne;5;1;0;6
1357;Drevinukas;AŽUOLIUKŲ;8701250912;Ne;11;0;0;11
1358;Drevinukas;AŽUOLIUKŲ;8143614891;Ne;0;7;0;7
1359;Drevinukas;AŽUOLIUKŲ;4213259879;Ne;15;6;0;21
1360;Drevinukas;AŽUOLIUKŲ;5673244101;Ne;6;2;0;8
1361;Drevinukas;AŽUOLIUKŲ;3643007998;Ne;8;7;0;15
1362;Drevinukas;AŽUOLIUKŲ;4262951360;Ne;21;0;0;21
1363;Drevinukas;AŽUOLIUKŲ;5959004452;Ne;5;5;0;10
1364;Drevinukas;AŽUOLIUKŲ;7689145214;Ne;0;6;0;6
1365;Drevinukas;AŽUOLIUKŲ;4572837478;Ne;0;6;0;6
1366;Drevinukas;AŽUOLIUKŲ;1564065835;Ne;0;6;0;6
1367;Drevinukas;AŽUOLIUKŲ;9289471118;Ne;5;0;0;5
1368;Drevinukas;AŽUOLIUKŲ;9915130747;Ne;12;5;0;17
1369;Drevinukas;AŽUOLIUKŲ;6891793135;Ne;0;7;0;7
1370;Drevinukas;AŽUOLIUKŲ;1058927778;Ne;0;1;0;1
1371;Drevinukas;AŽUOLIUKŲ;9534007163;Ne;4;0;0;4
1372;Drevinukas;AŽUOLIUKŲ;2300338724;Ne;15;1;0;16
1373;Drevinukas;AŽUOLIUKŲ;3725760478;Ne;0;2;0;2
1374;Drevinukas;AŽUOLIUKŲ;9513405583;Ne;0;5;0;5
1375;Drevinukas;AŽUOLIUKŲ;5436821826;Ne;4;0;0;4
1376;Drevinukas;AŽUOLIUKŲ;8896207423;Ne;0;2;0;2
1377;Drevinukas;PELĖDŽIUKAI;1123115847;Ne;11;0;0;11
1378;Drevinukas;PELĖDŽIUKAI;1987939679;Ne;0;4;1;5
1379;Drevinukas;PELĖDŽIUKAI;9336227821;Ne;0;4;4;8
1380;Drevinukas;PELĖDŽIUKAI;4784716615;Ne;0;2;0;2
1381;Drevinukas;PELĖDŽIUKAI;2070374746;Ne;4;0;0;4
1382;Drevinukas;PELĖDŽIUKAI;8661862777;Ne;0;0;1;1
1383;Drevinukas;PELĖDŽIUKAI;9803670483;Ne;0;4;7;11
1384;Drevinukas;PELĖDŽIUKAI;7519369167;Ne;12;0;0;12
1385;Drevinukas;PELĖDŽIUKAI;3657451903;Ne;0;4;3;7
1386;Drevinukas;PELĖDŽIUKAI;8180027849;Ne;0;1;5;6
1387;Drevinukas;PELĖDŽIUKAI;4332606643;Ne;0;1;4;5
1388;Drevinukas;PELĖDŽIUKAI;7632515230;Ne;0;19;0;19
1389;Drevinukas;PELĖDŽIUKAI;6304169257;Ne;0;0;2;2
1390;Drevinukas;PELĖDŽIUKAI;5686116320;Ne;7;0;0;7
1391;Drevinukas;PELĖDŽIUKAI;56028675283;Ne;0;4;10;14
1392;Drevinukas;PELĖDŽIUKAI;85288014888;Ne;0;2;0;2
1393;Drevinukas;PELĖDŽIUKAI;1019214451;Ne;0;2;0;2
1394;Drevinukas;PELĖDŽIUKAI;6954102486;Ne;1;0;3;4
1395;Drevinukas;PELĖDŽIUKAI;3086451968;Ne;0;0;1;1
1396;Drevinukas;PELĖDŽIUKAI;6833120798;Ne;0;1;5;6
1397;Drevinukas;PELĖDŽIUKAI;7607135647;Ne;0;4;1;5
1398;Drevinukas;BORUŽĖLĖS;3046196006;Ne;4;0;0;4
1399;Drevinukas;BORUŽĖLĖS;3032536983;Ne;0;2;0;2
1400;Drevinukas;BORUŽĖLĖS;5524567803;Ne;0;0;6;6
1401;Drevinukas;BORUŽĖLĖS;4076576850;Ne;0;0;14;14
1402;Drevinukas;BORUŽĖLĖS;6373230526;Ne;0;1;1;2
1403;Drevinukas;BORUŽĖLĖS;4312429104;Ne;0;0;2;2
1404;Drevinukas;BORUŽĖLĖS;7642022439;Ne;2;0;2;4
1405;Drevinukas;BORUŽĖLĖS;4404254932;Ne;0;0;1;1
1406;Drevinukas;BORUŽĖLĖS;2378493422;Ne;0;4;0;4
1407;Drevinukas;BORUŽĖLĖS;1859208322;Ne;9;0;1;10
1408;Drevinukas;BORUŽĖLĖS;5620887702;Ne;0;1;0;1
1409;Drevinukas;BORUŽĖLĖS;2281463885;Ne;0;4;0;4
1410;Drevinukas;BORUŽĖLĖS;4662426451;Ne;0;5;0;5
1411;Drevinukas;BORUŽĖLĖS;5875459639;Ne;5;0;0;5
1412;Drevinukas;BORUŽĖLĖS;6582186497;Ne;1;6;0;7
1413;Drevinukas;BORUŽĖLĖS;7218201733;Ne;0;1;0;1
1414;Drevinukas;BITUTĖS;3981507849;Ne;2;3;0;5
1415;Drevinukas;BITUTĖS;7753238387;Ne;0;4;1;5
1416;Drevinukas;BITUTĖS;3617570755;Ne;0;4;3;7
1417;Drevinukas;BITUTĖS;5679723776;Ne;3;2;1;6
1418;Drevinukas;BITUTĖS;1720464417;Ne;0;3;0;3
1419;Drevinukas;BITUTĖS;6095020718;Ne;3;0;0;3
1420;Drevinukas;BITUTĖS;1099462840;Ne;0;7;0;7
1421;Drevinukas;BITUTĖS;1152161183;Ne;0;0;3;3
1422;Drevinukas;BITUTĖS;8611131264;Ne;5;3;0;8
1423;Drevinukas;BITUTĖS;8936058501;Ne;0;4;3;7
1424;Drevinukas;BITUTĖS;9772484901;Ne;0;1;0;1
1425;Drevinukas;BITUTĖS;5348609358;Ne;0;1;0;1
1426;Drevinukas;BITUTĖS;1098647410;Ne;0;0;3;3
1427;Drevinukas;BITUTĖS;2312241894;Ne;0;4;0;4
1428;Drevinukas;BITUTĖS;5394143000;Ne;0;7;0;7
1429;Drevinukas;BITUTĖS;3871506691;Ne;17;0;0;17
1430;Drevinukas;BITUTĖS;6914111231;Ne;17;0;0;17
1431;Drevinukas;BITUTĖS;3377957769;Ne;0;7;0;7
1432;Drevinukas;BITUTĖS;2423143170;Ne;7;1;2;10
1433;Drevinukas;BITUTĖS;1343431478;Ne;4;0;3;7
1434;Drevinukas;BITUTĖS;1829421385;Ne;0;3;0;3
1435;Drevinukas;BITUTĖS;8262224710;Ne;2;2;0;4
1436;Drevinukas;BITUTĖS;8479979176;Ne;0;1;0;1
1437;Drevinukas;BITUTĖS;2531207946;Ne;0;1;2;3
1438;Drevinukas;NYKŠTUKAI;6165662595;Ne;0;6;1;7
1439;Drevinukas;NYKŠTUKAI;4203106313;Ne;5;0;0;5
1440;Drevinukas;NYKŠTUKAI;4147987057;Ne;4;12;0;16
1441;Drevinukas;NYKŠTUKAI;6645506336;Ne;5;5;0;10
1442;Drevinukas;NYKŠTUKAI;3240313747;Ne;0;0;1;1
1443;Drevinukas;NYKŠTUKAI;8940838262;Ne;0;0;1;1
1444;Drevinukas;NYKŠTUKAI;8719022482;Ne;0;1;1;2
1445;Drevinukas;NYKŠTUKAI;9695419813;Ne;0;2;1;3
1446;Drevinukas;NYKŠTUKAI;9517560132;Ne;0;0;6;6
1447;Drevinukas;NYKŠTUKAI;6895472558;Ne;17;0;1;18
1448;Drevinukas;NYKŠTUKAI;2571295179;Ne;0;12;0;12
1449;Drevinukas;NYKŠTUKAI;2820241608;Ne;0;6;0;6
1450;Drevinukas;NYKŠTUKAI;5999370094;Ne;2;2;0;4
1451;Drevinukas;NYKŠTUKAI;9845207619;Ne;12;0;2;14
1452;Drevinukas;NYKŠTUKAI;6680003214;Ne;0;0;1;1
1453;Drevinukas;NYKŠTUKAI;3192583690;Ne;0;1;0;1
1454;Drevinukas;NYKŠTUKAI;6659263391;Ne;0;1;0;1
1455;Drevinukas;NYKŠTUKAI;4588368596;Ne;6;0;0;6
1456;Drevinukas;SMALSUČIAI;4242944055;Ne;5;1;0;6
1457;Drevinukas;SMALSUČIAI;1094428951;Ne;0;2;0;2
1458;Drevinukas;SMALSUČIAI;2179736991;Ne;0;0;2;2
1459;Drevinukas;SMALSUČIAI;9105675010;Ne;0;2;0;2
1460;Drevinukas;SMALSUČIAI;9283862598;Ne;9;1;0;10
1461;Drevinukas;SMALSUČIAI;3611870655;Ne;5;6;0;11
1462;Drevinukas;SMALSUČIAI;7241671439;Ne;5;0;0;5
1463;Drevinukas;SMALSUČIAI;2246885419;Ne;5;6;0;11
1464;Drevinukas;SMALSUČIAI;4089351543;Ne;0;4;0;4
1465;Drevinukas;SMALSUČIAI;2201342382;Ne;4;4;0;8
1466;Drevinukas;SMALSUČIAI;4759293403;Ne;7;2;0;9
1467;Drevinukas;SMALSUČIAI;7863529560;Ne;11;0;0;11
1468;Drevinukas;SMALSUČIAI;9715586195;Ne;0;1;0;1
1469;Drevinukas;SMALSUČIAI;1368495173;Ne;0;5;0;5
1470;Drevinukas;SMALSUČIAI;8284025903;Ne;2;1;0;3
1471;Drevinukas;SMALSUČIAI;6492987985;Ne;4;0;0;4
1472;Drevinukas;ŽVIRBLIUKAI;8654858364;Ne;11;0;1;12
1473;Drevinukas;ŽVIRBLIUKAI;5445104383;Ne;0;0;2;2
1474;Drevinukas;ŽVIRBLIUKAI;2662147175;Ne;6;6;0;12
1475;Drevinukas;ŽVIRBLIUKAI;7801920518;Ne;10;6;5;21
1476;Drevinukas;ŽVIRBLIUKAI;1570356979;Ne;17;0;0;17
1477;Drevinukas;ŽVIRBLIUKAI;9123131368;Ne;4;0;0;4
1478;Drevinukas;ŽVIRBLIUKAI;8877080179;Ne;3;0;0;3
1479;Drevinukas;ŽVIRBLIUKAI;2274377462;Ne;0;14;3;17
1480;Drevinukas;ŽVIRBLIUKAI;7316996793;Ne;0;6;0;6
1481;Drevinukas;ŽVIRBLIUKAI;3408981880;Ne;6;0;0;6
1482;Drevinukas;ŽVIRBLIUKAI;8953871512;Ne;7;0;0;7
1483;Drevinukas;ŽVIRBLIUKAI;3983656958;Ne;11;0;0;11
1484;Drevinukas;ŽVIRBLIUKAI;1957961770;Ne;0;0;5;5
1485;Drevinukas;ŽVIRBLIUKAI;5702650036;Ne;0;2;0;2
1486;Drugelis;NYKŠTUKŲ;9316073597;Ne;0;1;0;1
1487;Drugelis;NYKŠTUKŲ;3551095669;Ne;7;4;0;11
1488;Drugelis;NYKŠTUKŲ;1785724340;Ne;0;4;0;4
1489;Drugelis;NYKŠTUKŲ;6632884258;Taip;0;6;7;13
1490;Drugelis;NYKŠTUKŲ;7447519502;Ne;0;1;0;1
1491;Drugelis;NYKŠTUKŲ;4523513611;Ne;0;4;0;4
1492;Drugelis;NYKŠTUKŲ;6594452094;Ne;0;6;0;6
1493;Drugelis;NYKŠTUKŲ;5122256823;Ne;4;1;0;5
1494;Drugelis;NYKŠTUKŲ;4825232236;Ne;0;1;0;1
1495;Drugelis;NYKŠTUKŲ;7477547789;Ne;0;1;0;1
1496;Drugelis;NYKŠTUKŲ;8717445483;Ne;2;3;0;5
1497;Drugelis;NYKŠTUKŲ;4471405682;Ne;0;0;3;3
1498;Drugelis;NYKŠTUKŲ;4867387611;Ne;0;11;0;11
1499;Drugelis;NYKŠTUKŲ;7609530453;Ne;0;2;3;5
1500;Drugelis;NYKŠTUKŲ;8070030439;Ne;0;1;0;1
1501;Drugelis;NYKŠTUKŲ;3061896520;Ne;0;1;0;1
1502;Drugelis;NYKŠTUKŲ;5692743298;Ne;5;2;4;11
1503;Drugelis;NYKŠTUKŲ;6452921695;Ne;0;2;2;4
1504;Drugelis;NYKŠTUKŲ;5902687211;Ne;0;0;2;2
1505;Drugelis;NYKŠTUKŲ;8591548746;Ne;0;1;0;1
1506;Drugelis;SMALSUČIŲ;5121351234;Ne;15;0;0;15
1507;Drugelis;SMALSUČIŲ;6626437352;Ne;2;2;0;4
1508;Drugelis;SMALSUČIŲ;5000965458;Ne;11;4;0;15
1509;Drugelis;SMALSUČIŲ;9683350741;Ne;0;6;0;6
1510;Drugelis;SMALSUČIŲ;1617833459;Ne;0;6;5;11
1511;Drugelis;SMALSUČIŲ;4058293462;Ne;2;0;0;2
1512;Drugelis;SMALSUČIŲ;6533325098;Ne;0;9;0;9
1513;Drugelis;SMALSUČIŲ;4805858183;Ne;2;4;5;11
1514;Drugelis;SMALSUČIŲ;9650052415;Ne;0;0;2;2
1515;Drugelis;SMALSUČIŲ;5533529267;Ne;0;1;0;1
1516;Drugelis;SMALSUČIŲ;3372145698;Ne;0;7;1;8
1517;Drugelis;SMALSUČIŲ;2644563881;Ne;0;1;0;1
1518;Drugelis;SMALSUČIŲ;6613520046;Ne;0;0;1;1
1519;Drugelis;SMALSUČIŲ;6890441262;Ne;0;5;0;5
1520;Drugelis;MUMINUKŲ;7390061272;Ne;0;2;0;2
1521;Drugelis;MUMINUKŲ;3311620018;Ne;0;1;0;1
1522;Drugelis;MUMINUKŲ;5661335344;Ne;4;0;0;4
1523;Drugelis;MUMINUKŲ;6038184222;Ne;0;2;1;3
1524;Drugelis;MUMINUKŲ;9851124145;Ne;8;0;0;8
1525;Drugelis;MUMINUKŲ;7253876812;Ne;0;0;1;1
1526;Drugelis;MUMINUKŲ;1666992752;Ne;2;0;0;2
1527;Drugelis;MUMINUKŲ;9510744779;Ne;0;6;1;7
1528;Drugelis;MUMINUKŲ;9907121223;Ne;0;3;0;3
1529;Drugelis;MUMINUKŲ;8500348389;Ne;0;2;0;2
1530;Drugelis;MUMINUKŲ;1858504360;Ne;13;1;0;14
1531;Drugelis;MUMINUKŲ;8366330478;Ne;0;4;0;4
1532;Drugelis;MUMINUKŲ;8107970910;Ne;0;6;0;6
1533;Drugelis;MUMINUKŲ;5515894973;Ne;0;1;0;1
1534;Drugelis;MUMINUKŲ;8282807535;Ne;0;0;1;1
1535;Drugelis;MUMINUKŲ;3293212749;Ne;0;0;2;2
1536;Drugelis;MUMINUKŲ;2256221485;Ne;0;1;0;1
1537;Drugelis;MUMINUKŲ;9588931333;Ne;0;5;0;5
1538;Drugelis;MUMINUKŲ;3176174057;Ne;0;1;0;1
1539;Drugelis;MUMINUKŲ;1761596625;Ne;2;7;0;9
1540;Drugelis;PŪKUOTUKAI;9149748841;Ne;0;4;0;4
1541;Drugelis;PŪKUOTUKAI;1217635751;Ne;0;9;0;9
1542;Drugelis;PŪKUOTUKAI;9612696781;Ne;0;4;0;4
1543;Drugelis;PŪKUOTUKAI;1888002607;Ne;0;4;0;4
1544;Drugelis;PŪKUOTUKAI;27569805506;Ne;0;14;0;14
1545;Drugelis;PŪKUOTUKAI;1961898730;Ne;0;1;0;1
1546;Drugelis;PŪKUOTUKAI;7406396614;Ne;0;2;0;2
1547;Drugelis;PŪKUOTUKAI;1901608445;Ne;0;3;0;3
1548;Drugelis;PŪKUOTUKAI;1506988472;Ne;0;5;0;5
1549;Drugelis;PŪKUOTUKAI;1991420008;Ne;0;5;0;5
1550;Drugelis;PŪKUOTUKAI;1255124184;Ne;0;0;1;1
1551;Drugelis;PŪKUOTUKAI;1856912386;Ne;0;2;0;2
1552;Drugelis;PŪKUOTUKAI;1576853049;Ne;0;8;1;9
1553;Drugelis;PŪKUOTUKAI;68223183150;Ne;0;5;0;5
1554;Drugelis;PŪKUOTUKAI;3202149560;Ne;0;6;0;6
1555;Drugelis;PŪKUOTUKAI;1421438458;Ne;0;8;0;8
1556;Drugelis;PŪKUOTUKAI;5954059321;Ne;5;3;0;8
1557;Drugelis;PŪKUOTUKAI;53874036107;Ne;0;5;0;5
1558;Drugelis;PŪKUOTUKAI;4788423265;Ne;0;9;0;9
1559;Drugelis;PŪKUOTUKAI;3096906506;Ne;2;5;0;7
1560;Drugelis;SPINDULIUKAI;3081918342;Ne;7;4;1;12
1561;Drugelis;SPINDULIUKAI;3560294703;Ne;11;0;0;11
1562;Drugelis;SPINDULIUKAI;1215586620;Ne;2;0;0;2
1563;Drugelis;SPINDULIUKAI;9005448398;Ne;0;4;17;21
1564;Drugelis;SPINDULIUKAI;7775085427;Ne;0;16;0;16
1565;Drugelis;SPINDULIUKAI;2926662708;Ne;1;0;0;1
1566;Drugelis;SPINDULIUKAI;6504082488;Ne;0;4;0;4
1567;Drugelis;SPINDULIUKAI;7321544601;Ne;9;0;0;9
1568;Drugelis;SPINDULIUKAI;9296067137;Ne;0;0;18;18
1569;Drugelis;SPINDULIUKAI;9855121078;Ne;10;2;0;12
1570;Drugelis;SPINDULIUKAI;6068102133;Ne;0;5;0;5
1571;Drugelis;SPINDULIUKAI;7825151440;Ne;0;1;0;1
1572;Drugelis;SPINDULIUKAI;4812322553;Ne;0;7;0;7
1573;Drugelis;SPINDULIUKAI;6032568621;Ne;0;1;0;1
1574;Drugelis;SPINDULIUKAI;4580456500;Ne;5;0;0;5
1575;Drugelis;SPINDULIUKAI;8259051898;Ne;6;1;2;9
1576;Drugelis;SPINDULIUKAI;3567930528;Ne;6;5;0;11
1577;Drugelis;SPINDULIUKAI;2573357635;Ne;0;0;3;3
1578;Drugelis;KIŠKUČIAI;3603051567;Ne;11;0;0;11
1579;Drugelis;KIŠKUČIAI;4628926113;Ne;13;0;0;13
1580;Drugelis;KIŠKUČIAI;7307032077;Ne;0;0;1;1
1581;Drugelis;KIŠKUČIAI;4871624566;Ne;4;0;0;4
1582;Drugelis;KIŠKUČIAI;1213610973;Ne;10;0;0;10
1583;Drugelis;KIŠKUČIAI;9211760307;Ne;0;0;4;4
1584;Drugelis;KIŠKUČIAI;6071997970;Ne;16;4;0;20
1585;Drugelis;KIŠKUČIAI;8819853863;Ne;6;0;0;6
1586;Drugelis;KIŠKUČIAI;5950704328;Ne;3;0;1;4
1587;Drugelis;KIŠKUČIAI;9900296726;Ne;9;0;0;9
1588;Drugelis;KIŠKUČIAI;6997707085;Ne;5;1;0;6
1589;Drugelis;KIŠKUČIAI;1375535260;Ne;7;0;0;7
1590;Drugelis;KIŠKUČIAI;5857726963;Ne;2;5;0;7
1591;Drugelis;KIŠKUČIAI;1817932444;Ne;0;0;4;4
1592;Drugelis;KIŠKUČIAI;8891228382;Ne;4;0;0;4
1593;Drugelis;KIŠKUČIAI;1074913909;Ne;7;0;5;12
1594;"Du gaideliai";Uodelių;8896316882;Ne;0;2;0;2
1595;"Du gaideliai";Uodelių;6704167983;Ne;1;0;1;2
1596;"Du gaideliai";Uodelių;6942798420;Ne;0;8;0;8
1597;"Du gaideliai";Uodelių;8420400705;Ne;3;8;0;11
1598;"Du gaideliai";Uodelių;2826490663;Ne;5;0;0;5
1599;"Du gaideliai";Uodelių;4157021754;Ne;0;0;6;6
1600;"Du gaideliai";Uodelių;7193151965;Ne;2;6;0;8
1601;"Du gaideliai";Uodelių;1968978650;Ne;0;2;0;2
1602;"Du gaideliai";Uodelių;2564259600;Ne;5;0;2;7
1603;"Du gaideliai";Uodelių;6132405512;Ne;0;11;0;11
1604;"Du gaideliai";Uodelių;2756525592;Ne;5;1;0;6
1605;"Du gaideliai";Uodelių;7563789811;Ne;2;1;0;3
1606;"Du gaideliai";Uodelių;9126780620;Ne;3;0;0;3
1607;"Du gaideliai";Uodelių;9374869616;Ne;0;1;0;1
1608;"Du gaideliai";Uodelių;4408537397;Ne;0;1;0;1
1609;"Du gaideliai";Uodelių;1527839162;Ne;0;5;0;5
1610;"Du gaideliai";Uodelių;5809089345;Ne;0;4;0;4
1611;"Du gaideliai";Uodelių;8174023197;Ne;10;1;0;11
1612;"Du gaideliai";Uodelių;7372149799;Ne;4;7;0;11
1613;"Du gaideliai";Uodelių;5291934919;Ne;0;2;0;2
1614;"Du gaideliai";OŽIUKŲ;7033276798;Ne;0;7;0;7
1615;"Du gaideliai";OŽIUKŲ;5788923258;Ne;0;4;0;4
1616;"Du gaideliai";OŽIUKŲ;2100449108;Ne;0;0;1;1
1617;"Du gaideliai";OŽIUKŲ;7575534590;Ne;2;0;0;2
1618;"Du gaideliai";OŽIUKŲ;3019797369;Ne;6;0;0;6
1619;"Du gaideliai";OŽIUKŲ;9356275460;Ne;0;0;2;2
1620;"Du gaideliai";OŽIUKŲ;6204233540;Ne;0;4;0;4
1621;"Du gaideliai";OŽIUKŲ;2845145754;Ne;0;7;0;7
1622;"Du gaideliai";OŽIUKŲ;7726490359;Ne;19;0;0;19
1623;"Du gaideliai";OŽIUKŲ;5728374219;Ne;7;0;0;7
1624;"Du gaideliai";OŽIUKŲ;5611102395;Ne;0;4;0;4
1625;"Du gaideliai";OŽIUKŲ;8410547195;Ne;0;2;0;2
1626;"Du gaideliai";OŽIUKŲ;2905083899;Ne;10;0;0;10
1627;"Du gaideliai";OŽIUKŲ;9585785202;Ne;5;5;0;10
1628;"Du gaideliai";OŽIUKŲ;2151825222;Ne;0;2;0;2
1629;"Du gaideliai";OŽIUKŲ;8043896286;Ne;6;0;0;6
1630;"Du gaideliai";OŽIUKŲ;6053941133;Ne;0;1;0;1
1631;"Du gaideliai";OŽIUKŲ;6120647567;Ne;5;1;0;6
1632;"Du gaideliai";OŽIUKŲ;5668878259;Ne;2;3;0;5
1633;"Du gaideliai";Vištyčių;1135098595;Ne;0;0;1;1
1634;"Du gaideliai";Vištyčių;3370029981;Ne;0;14;0;14
1635;"Du gaideliai";Vištyčių;3507387826;Ne;3;3;0;6
1636;"Du gaideliai";Vištyčių;4144269068;Ne;15;3;0;18
1637;"Du gaideliai";Vištyčių;1785976627;Ne;0;4;1;5
1638;"Du gaideliai";Vištyčių;8047413507;Ne;0;6;3;9
1639;"Du gaideliai";Vištyčių;9568647033;Ne;0;0;7;7
1640;"Du gaideliai";Vištyčių;5894974508;Ne;6;5;0;11
1641;"Du gaideliai";Vištyčių;6247706405;Ne;19;0;0;19
1642;"Du gaideliai";Vištyčių;1751328192;Ne;0;1;0;1
1643;"Du gaideliai";Vištyčių;5652662610;Ne;9;0;0;9
1644;"Du gaideliai";Vištyčių;6870356241;Ne;8;0;0;8
1645;"Du gaideliai";Vištyčių;5103483956;Ne;0;5;0;5
1646;"Du gaideliai";Vištyčių;6348951959;Ne;0;0;2;2
1647;"Du gaideliai";Vištyčių;1268479215;Ne;5;1;0;6
1648;"Du gaideliai";Vištyčių;3854355215;Ne;0;0;5;5
1649;"Du gaideliai";Vištyčių;3849899284;Ne;0;4;0;4
1650;"Du gaideliai";GAIDŽIUKŲ;1758546983;Ne;0;14;0;14
1651;"Du gaideliai";GAIDŽIUKŲ;7783203480;Ne;0;13;0;13
1652;"Du gaideliai";GAIDŽIUKŲ;94639433266;Ne;0;5;0;5
1653;"Du gaideliai";GAIDŽIUKŲ;6715434585;Ne;2;5;0;7
1654;"Du gaideliai";GAIDŽIUKŲ;7084763712;Ne;5;4;0;9
1655;"Du gaideliai";GAIDŽIUKŲ;1500684755;Ne;0;19;0;19
1656;"Du gaideliai";GAIDŽIUKŲ;6750787450;Ne;3;6;1;10
1657;"Du gaideliai";GAIDŽIUKŲ;5430986033;Ne;0;4;1;5
1658;"Du gaideliai";GAIDŽIUKŲ;27733314504;Ne;2;4;0;6
1659;"Du gaideliai";GAIDŽIUKŲ;5167460184;Ne;0;4;0;4
1660;"Du gaideliai";GAIDŽIUKŲ;1549762923;Ne;0;1;0;1
1661;"Du gaideliai";GAIDŽIUKŲ;6203383711;Ne;0;14;0;14
1662;"Du gaideliai";GAIDŽIUKŲ;6170362846;Ne;2;4;0;6
1663;"Du gaideliai";GAIDŽIUKŲ;1962859229;Ne;0;1;0;1
1664;"Du gaideliai";GAIDŽIUKŲ;7373413569;Ne;0;8;0;8
1665;"Du gaideliai";GAIDŽIUKŲ;1557413692;Ne;0;6;0;6
1666;"Du gaideliai";GAIDŽIUKŲ;3273574176;Ne;4;2;0;6
1667;"Du gaideliai";GAIDŽIUKŲ;7471332824;Ne;0;8;0;8
1668;"Du gaideliai";GAIDŽIUKŲ;4378924981;Ne;2;5;0;7
1669;"Du gaideliai";Musyčių;9506572113;Ne;9;3;0;12
1670;"Du gaideliai";Musyčių;6224116229;Ne;7;0;0;7
1671;"Du gaideliai";Musyčių;6630053388;Ne;6;4;2;12
1672;"Du gaideliai";Musyčių;5867716168;Ne;8;0;0;8
1673;"Du gaideliai";Musyčių;3654057453;Ne;11;1;0;12
1674;"Du gaideliai";Musyčių;8921985681;Ne;0;17;4;21
1675;"Du gaideliai";Musyčių;1882241729;Ne;6;0;2;8
1676;"Du gaideliai";Musyčių;5225949099;Ne;0;1;0;1
1677;"Du gaideliai";Musyčių;4204930257;Ne;11;0;4;15
1678;"Du gaideliai";Musyčių;3206388799;Ne;0;16;0;16
1679;"Du gaideliai";Musyčių;2616106413;Ne;8;0;0;8
1680;"Du gaideliai";Musyčių;2084660815;Ne;5;0;0;5
1681;"Du gaideliai";Musyčių;9934568135;Ne;0;12;0;12
1682;"Du gaideliai";Musyčių;4799107717;Ne;0;3;0;3
1683;"Du gaideliai";Musyčių;8624394105;Ne;9;7;0;16
1684;"Du gaideliai";Musyčių;2122841302;Ne;0;17;4;21
1685;"Du gaideliai";Musyčių;7153424410;Ne;0;6;0;6
1686;"Du gaideliai";Musyčių;5514521078;Ne;0;4;0;4
1687;"Du gaideliai";MALŪNO;9561040908;Ne;12;0;0;12
1688;"Du gaideliai";MALŪNO;2266999698;Ne;0;3;0;3
1689;"Du gaideliai";MALŪNO;1048130675;Ne;0;16;3;19
1690;"Du gaideliai";MALŪNO;3601150560;Ne;0;4;1;5
1691;"Du gaideliai";MALŪNO;3519099395;Ne;0;0;3;3
1692;"Du gaideliai";MALŪNO;1777283565;Ne;13;0;0;13
1693;"Du gaideliai";MALŪNO;1940981083;Ne;17;0;0;17
1694;"Du gaideliai";MALŪNO;5113352673;Ne;0;4;0;4
1695;"Du gaideliai";MALŪNO;9477645505;Ne;6;1;1;8
1696;"Du gaideliai";MALŪNO;5142411841;Ne;6;0;3;9
1697;"Du gaideliai";MALŪNO;7855653537;Ne;12;0;0;12
1698;"Du gaideliai";MALŪNO;9832883242;Ne;7;0;0;7
1699;"Du gaideliai";MALŪNO;9619723983;Ne;5;1;0;6
1700;"Du gaideliai";MALŪNO;5016914497;Ne;0;0;1;1
1701;"Du gaideliai";MALŪNO;4759244471;Ne;6;3;0;9
1702;"Du gaideliai";MALŪNO;6054058539;Ne;0;1;0;1
1703;"Du gaideliai";MALŪNO;7389148136;Ne;10;0;0;10
1704;Eglutė;RAMUNĖ;1422631723;Ne;5;15;0;20
1705;Eglutė;RAMUNĖ;6093932811;Ne;0;4;0;4
1706;Eglutė;RAMUNĖ;3473388722;Ne;0;3;0;3
1707;Eglutė;RAMUNĖ;2597978713;Ne;0;5;0;5
1708;Eglutė;RAMUNĖ;4451772812;Ne;4;1;2;7
1709;Eglutė;RAMUNĖ;8493750509;Ne;3;0;0;3
1710;Eglutė;RAMUNĖ;9929681000;Ne;0;0;2;2
1711;Eglutė;RAMUNĖ;6105927493;Ne;0;0;2;2
1712;Eglutė;RAMUNĖ;4560670047;Ne;0;0;4;4
1713;Eglutė;RAMUNĖ;1048451048;Ne;0;1;0;1
1714;Eglutė;RAMUNĖ;6142326330;Ne;0;11;0;11
1715;Eglutė;RAMUNĖ;1534556744;Ne;0;2;0;2
1716;Eglutė;RAMUNĖ;4047404616;Ne;0;4;0;4
1717;Eglutė;RAMUNĖ;4230594049;Ne;0;0;14;14
1718;Eglutė;RAMUNĖ;2998190195;Ne;0;2;2;4
1719;Eglutė;RAMUNĖ;9402686801;Ne;0;8;0;8
1720;Eglutė;RAMUNĖ;6279703448;Ne;0;11;0;11
1721;Eglutė;RAMUNĖ;7598993411;Ne;7;5;0;12
1722;Eglutė;PELĖDŽIUKAI;9066178904;Ne;0;3;0;3
1723;Eglutė;PELĖDŽIUKAI;7149060118;Ne;0;21;0;21
1724;Eglutė;PELĖDŽIUKAI;6518497374;Ne;5;1;0;6
1725;Eglutė;PELĖDŽIUKAI;3203786388;Ne;0;2;0;2
1726;Eglutė;PELĖDŽIUKAI;3178489517;Ne;0;0;12;12
1727;Eglutė;PELĖDŽIUKAI;1510706652;Ne;0;1;0;1
1728;Eglutė;PELĖDŽIUKAI;1695732622;Ne;0;1;0;1
1729;Eglutė;PELĖDŽIUKAI;9333028072;Ne;0;5;2;7
1730;Eglutė;PELĖDŽIUKAI;2082716398;Ne;4;2;0;6
1731;Eglutė;PELĖDŽIUKAI;3616979217;Ne;0;6;0;6
1732;Eglutė;PELĖDŽIUKAI;9950953029;Ne;2;6;0;8
1733;Eglutė;PELĖDŽIUKAI;6835296034;Ne;0;1;0;1
1734;Eglutė;PELĖDŽIUKAI;7148210944;Ne;0;8;0;8
1735;Eglutė;PELĖDŽIUKAI;1324622835;Ne;0;4;0;4
1736;Eglutė;PELĖDŽIUKAI;3275796441;Ne;0;4;4;8
1737;Eglutė;PELĖDŽIUKAI;3390360525;Ne;8;0;1;9
1738;Eglutė;KODĖLČIUKAI;4490295754;Ne;5;4;0;9
1739;Eglutė;KODĖLČIUKAI;3883122650;Ne;0;10;0;10
1740;Eglutė;KODĖLČIUKAI;7859815752;Ne;0;6;0;6
1741;Eglutė;KODĖLČIUKAI;4176597208;Ne;0;1;0;1
1742;Eglutė;KODĖLČIUKAI;7758643349;Ne;0;9;0;9
1743;Eglutė;KODĖLČIUKAI;6483580751;Ne;0;6;0;6
1744;Eglutė;KODĖLČIUKAI;5924994736;Ne;0;2;0;2
1745;Eglutė;KODĖLČIUKAI;1759383841;Ne;0;2;0;2
1746;Eglutė;KODĖLČIUKAI;6597261061;Ne;0;5;0;5
1747;Eglutė;KODĖLČIUKAI;9046652370;Ne;0;0;4;4
1748;Eglutė;KODĖLČIUKAI;9356785605;Ne;0;4;0;4
1749;Eglutė;KODĖLČIUKAI;8943684351;Ne;0;3;1;4
1750;Eglutė;KODĖLČIUKAI;8165126017;Ne;0;1;0;1
1751;Eglutė;KODĖLČIUKAI;9967488317;Ne;0;4;0;4
1752;Eglutė;KODĖLČIUKAI;3584247594;Ne;0;3;0;3
1753;Eglutė;KODĖLČIUKAI;9758104910;Ne;5;5;2;12
1754;Eglutė;KODĖLČIUKAI;1531942494;Ne;0;13;0;13
1755;Eglutė;KODĖLČIUKAI;5840014240;Ne;0;7;0;7
1756;Eglutė;KODĖLČIUKAI;5678727198;Ne;0;0;6;6
1757;Eglutė;OBUOLIUKAI;3799824061;Taip;13;2;0;15
1758;Eglutė;OBUOLIUKAI;1744942011;Ne;0;5;0;5
1759;Eglutė;OBUOLIUKAI;7027121333;Ne;7;0;0;7
1760;Eglutė;OBUOLIUKAI;6679186715;Ne;18;0;0;18
1761;Eglutė;OBUOLIUKAI;8655425408;Ne;3;2;0;5
1762;Eglutė;OBUOLIUKAI;8384141923;Ne;10;6;0;16
1763;Eglutė;OBUOLIUKAI;3112281182;Ne;7;2;5;14
1764;Eglutė;OBUOLIUKAI;1432716037;Ne;0;2;0;2
1765;Eglutė;OBUOLIUKAI;4876032787;Ne;0;6;0;6
1766;Eglutė;OBUOLIUKAI;9542684993;Ne;4;5;0;9
1767;Eglutė;OBUOLIUKAI;6967074765;Ne;9;8;0;17
1768;Eglutė;OBUOLIUKAI;9054104040;Ne;12;0;0;12
1769;Eglutė;OBUOLIUKAI;9193920390;Ne;10;6;0;16
1770;Eglutė;OBUOLIUKAI;8246870069;Ne;4;0;0;4
1771;Eglutė;OBUOLIUKAI;1380219881;Ne;0;0;5;5
1772;Eglutė;OBUOLIUKAI;8721209423;Ne;9;0;0;9
1773;Eglutė;OBUOLIUKAI;1774538642;Ne;3;0;0;3
1774;Eglutė;OBUOLIUKAI;3903612086;Ne;0;1;0;1
1775;Eglutė;OBUOLIUKAI;7789753835;Ne;5;2;0;7
1776;Eglutė;KAŠTONAS;4099257155;Ne;7;5;2;14
1777;Eglutė;KAŠTONAS;6009794480;Ne;0;9;0;9
1778;Eglutė;KAŠTONAS;4252256130;Ne;0;0;1;1
1779;Eglutė;KAŠTONAS;8534997648;Ne;0;1;0;1
1780;Eglutė;KAŠTONAS;7234851379;Ne;2;2;0;4
1781;Eglutė;KAŠTONAS;5636437290;Ne;0;2;1;3
1782;Eglutė;KAŠTONAS;5190045146;Ne;0;8;0;8
1783;Eglutė;KAŠTONAS;3985929379;Ne;1;0;0;1
1784;Eglutė;KAŠTONAS;1842517164;Ne;8;0;6;14
1785;Eglutė;KAŠTONAS;7703290039;Ne;0;8;0;8
1786;Eglutė;KAŠTONAS;7530638623;Ne;0;4;0;4
1787;Eglutė;KAŠTONAS;2121177107;Ne;0;0;1;1
1788;Eglutė;KAŠTONAS;2357276888;Ne;0;0;1;1
1789;Eglutė;KAŠTONAS;2816913563;Ne;0;2;1;3
1790;Eglutė;KAŠTONAS;6146679388;Ne;3;7;0;10
1791;Eglutė;KAŠTONAS;5166183300;Ne;0;9;0;9
1792;Eglutė;KAŠTONAS;7984911632;Ne;0;8;1;9
1793;Eglutė;KAŠTONAS;7811667336;Ne;8;0;0;8
1794;Eglutė;EŽIUKAI;7491022301;Ne;0;1;0;1
1795;Eglutė;EŽIUKAI;5943856319;Ne;0;6;0;6
1796;Eglutė;EŽIUKAI;1436966647;Ne;0;3;0;3
1797;Eglutė;EŽIUKAI;6891834971;Ne;0;8;0;8
1798;Eglutė;EŽIUKAI;7307564177;Ne;0;4;8;12
1799;Eglutė;EŽIUKAI;7354260503;Ne;3;7;0;10
1800;Eglutė;EŽIUKAI;9439309687;Ne;0;2;2;4
1801;Eglutė;EŽIUKAI;1122308715;Ne;0;1;0;1
1802;Eglutė;EŽIUKAI;8523618773;Ne;0;21;0;21
1803;Eglutė;EŽIUKAI;3856651647;Ne;0;5;0;5
1804;Eglutė;EŽIUKAI;8421062747;Ne;0;6;2;8
1805;Eglutė;EŽIUKAI;9992438336;Ne;2;6;3;11
1806;Eglutė;EŽIUKAI;5731355126;Ne;4;4;0;8
1807;Eglutė;EŽIUKAI;8364693548;Ne;0;11;0;11
1808;Eglutė;EŽIUKAI;1265463853;Ne;0;1;0;1
1809;Eglutė;EŽIUKAI;1321901982;Ne;0;3;0;3
1810;Eglutė;EŽIUKAI;9527732584;Ne;0;3;0;3
1811;Eglutė;EŽIUKAI;8162972897;Ne;0;6;0;6
1812;Eglutė;EŽIUKAI;4348313801;Ne;0;5;0;5
1813;Eglutė;EŽIUKAI;9042793284;Ne;0;7;0;7
1814;Eglutė;GILĖ;1550045866;Ne;0;0;2;2
1815;Eglutė;GILĖ;8325288373;Ne;16;0;0;16
1816;Eglutė;GILĖ;6272115803;Taip;0;2;1;3
1817;Eglutė;GILĖ;6550999480;Ne;6;0;0;6
1818;Eglutė;GILĖ;2857760751;Ne;7;0;0;7
1819;Eglutė;GILĖ;5650957826;Ne;3;6;0;9
1820;Eglutė;GILĖ;8129230197;Ne;5;5;1;11
1821;Eglutė;GILĖ;1835565594;Ne;5;1;0;6
1822;Eglutė;GILĖ;1393626624;Ne;0;2;0;2
1823;Eglutė;GILĖ;2917925763;Ne;6;0;1;7
1824;Eglutė;GILĖ;3740322448;Ne;8;6;0;14
1825;Eglutė;GILĖ;9746021019;Ne;9;0;0;9
1826;Eglutė;GILĖ;1814323427;Ne;11;0;0;11
1827;Eglutė;GILĖ;5013664843;Ne;1;7;0;8
1828;Eglutė;GILĖ;2276311106;Ne;0;3;0;3
1829;Eglutė;GILĖ;6924344686;Ne;6;0;0;6
1830;Eglutė;GILĖ;5645197324;Ne;9;0;0;9
1831;Eglutė;GILĖ;9098132159;Ne;0;2;0;2
1832;Eglutė;GILĖ;2615824395;Ne;9;1;0;10
1833;Eglutė;GILĖ;1899379269;Ne;5;0;2;7
1834;Eglutė;GILĖ;3605053253;Ne;3;4;0;7
1835;Eglutė;SAULUTĖ;9741776217;Ne;10;1;0;11
1836;Eglutė;SAULUTĖ;5285593057;Ne;7;0;0;7
1837;Eglutė;SAULUTĖ;3091324735;Ne;0;5;1;6
1838;Eglutė;SAULUTĖ;8739346084;Ne;0;4;0;4
1839;Eglutė;SAULUTĖ;5518570006;Ne;10;1;0;11
1840;Eglutė;SAULUTĖ;9084576953;Ne;0;4;5;9
1841;Eglutė;SAULUTĖ;6309529738;Ne;5;5;0;10
1842;Eglutė;SAULUTĖ;2259077568;Ne;3;5;2;10
1843;Eglutė;SAULUTĖ;4489150480;Ne;7;2;6;15
1844;Eglutė;SAULUTĖ;2425927050;Ne;12;2;3;17
1845;Eglutė;SAULUTĖ;3006381069;Ne;0;2;0;2
1846;Eglutė;SAULUTĖ;5006042568;Ne;0;21;0;21
1847;Eglutė;SAULUTĖ;5275306818;Ne;0;0;7;7
1848;Eglutė;SAULUTĖ;2621445549;Ne;5;1;5;11
1849;Eglutė;SAULUTĖ;6328900251;Ne;5;1;0;6
1850;Eglutė;SAULUTĖ;9661883776;Ne;7;0;0;7
1851;Eglutė;SAULUTĖ;8799063905;Ne;0;4;0;4
1852;Eglutė;SAULUTĖ;1923176808;Ne;4;0;0;4
1853;Eglutė;SAULUTĖ;2872597971;Ne;5;0;1;6
1854;Eglutė;SAULUTĖ;6424893248;Ne;13;5;0;18
1855;Eglutė;ŠARKELĖ;7831541089;Ne;0;6;4;10
1856;Eglutė;ŠARKELĖ;3430016771;Ne;15;6;0;21
1857;Eglutė;ŠARKELĖ;6382927775;Ne;0;14;0;14
1858;Eglutė;ŠARKELĖ;7229612001;Ne;0;5;0;5
1859;Eglutė;ŠARKELĖ;4932945207;Ne;10;5;0;15
1860;Eglutė;ŠARKELĖ;5407757245;Ne;0;2;0;2
1861;Eglutė;ŠARKELĖ;9542103745;Ne;5;2;0;7
1862;Eglutė;ŠARKELĖ;1122907387;Ne;0;4;0;4
1863;Eglutė;ŠARKELĖ;9686836846;Ne;2;5;0;7
1864;Eglutė;ŠARKELĖ;7735192219;Ne;8;0;0;8
1865;Eglutė;ŠARKELĖ;5779671024;Ne;0;5;0;5
1866;Eglutė;ŠARKELĖ;5783776734;Ne;0;2;0;2
1867;Eglutė;ŠARKELĖ;4490541539;Ne;0;1;1;2
1868;Eglutė;ŠARKELĖ;5947727288;Ne;0;4;0;4
1869;Eglutė;ŠARKELĖ;6653111225;Ne;2;5;3;10
1870;Eglutė;NYKŠTUKAI;3011330968;Ne;0;2;0;2
1871;Eglutė;NYKŠTUKAI;8037564034;Ne;0;10;0;10
1872;Eglutė;NYKŠTUKAI;8749425471;Ne;7;2;0;9
1873;Eglutė;NYKŠTUKAI;4151258155;Ne;1;7;0;8
1874;Eglutė;NYKŠTUKAI;6965837585;Ne;0;2;0;2
1875;Eglutė;NYKŠTUKAI;5103022009;Ne;0;8;2;10
1876;Eglutė;NYKŠTUKAI;8542684582;Ne;0;0;21;21
1877;Eglutė;NYKŠTUKAI;3091697091;Ne;0;2;0;2
1878;Eglutė;NYKŠTUKAI;4823811890;Ne;4;5;0;9
1879;Eglutė;NYKŠTUKAI;9292940501;Ne;6;2;0;8
1880;Eglutė;NYKŠTUKAI;3210398495;Ne;0;2;0;2
1881;Eglutė;NYKŠTUKAI;3051637136;Ne;0;2;0;2
1882;Eglutė;NYKŠTUKAI;4056836413;Ne;0;2;0;2
1883;Eglutė;NYKŠTUKAI;5810733285;Ne;0;0;21;21
1884;Eglutė;NYKŠTUKAI;3089527202;Ne;0;4;0;4
1885;Eglutė;NYKŠTUKAI;2669400743;Ne;0;9;0;9
1886;Eglutė;NYKŠTUKAI;1460628870;Ne;6;2;0;8
1887;Eglutė;NYKŠTUKAI;4427853197;Ne;9;0;0;9
1888;Eglutė;ŽIRNIUKAI;3706904006;Ne;9;0;0;9
1889;Eglutė;ŽIRNIUKAI;8698242107;Ne;0;0;21;21
1890;Eglutė;ŽIRNIUKAI;2666894761;Ne;4;3;0;7
1891;Eglutė;ŽIRNIUKAI;2546506486;Taip;0;0;13;13
1892;Eglutė;ŽIRNIUKAI;4465995209;Ne;6;2;0;8
1893;Eglutė;ŽIRNIUKAI;9795027066;Ne;0;2;4;6
1894;Eglutė;ŽIRNIUKAI;3006002253;Ne;0;0;13;13
1895;Eglutė;ŽIRNIUKAI;4539946535;Ne;12;0;0;12
1896;Eglutė;ŽIRNIUKAI;4697026463;Ne;10;6;0;16
1897;Eglutė;ŽIRNIUKAI;3974970972;Taip;0;7;0;7
1898;Eglutė;ŽIRNIUKAI;2107488723;Ne;10;0;1;11
1899;Eglutė;ŽIRNIUKAI;9381529574;Ne;11;0;2;13
1900;Eglutė;ŽIRNIUKAI;9150254806;Ne;0;2;2;4
1901;Eglutė;ŽIRNIUKAI;7256251859;Ne;0;15;0;15
1902;Eglutė;ŽIRNIUKAI;6336987111;Ne;5;7;0;12
1903;Eglutė;ŽIRNIUKAI;2950414583;Ne;0;0;15;15
1904;Eglutė;ŽIRNIUKAI;1630732306;Ne;0;5;0;5
1905;Eglutė;BORUŽIUKAI;5592515139;Ne;3;0;0;3
1906;Eglutė;BORUŽIUKAI;1630903587;Taip;6;10;0;16
1907;Eglutė;BORUŽIUKAI;7254436716;Ne;0;5;0;5
1908;Eglutė;BORUŽIUKAI;5982037450;Ne;7;0;0;7
1909;Eglutė;BORUŽIUKAI;7994301287;Ne;5;7;0;12
1910;Eglutė;BORUŽIUKAI;9300315869;Ne;9;1;0;10
1911;Eglutė;BORUŽIUKAI;7231828805;Ne;0;13;0;13
1912;Eglutė;BORUŽIUKAI;5704418881;Ne;6;0;5;11
1913;Eglutė;BORUŽIUKAI;8410302338;Ne;6;2;0;8
1914;Eglutė;BORUŽIUKAI;1715411901;Ne;0;4;5;9
1915;Eglutė;BORUŽIUKAI;9875724921;Ne;0;0;2;2
1916;Eglutė;BORUŽIUKAI;7564179845;Ne;10;1;0;11
1917;Eglutė;BORUŽIUKAI;9178835404;Ne;0;16;0;16
1918;Eglutė;BORUŽIUKAI;5146804510;Ne;5;1;2;8
1919;Eglutė;BORUŽIUKAI;7618937988;Ne;0;3;0;3
1920;Eglutė;BORUŽIUKAI;6805213753;Ne;10;0;4;14
1921;"Geniukų kalvė";SAULUTĖS;9557055841;Ne;19;0;0;19
1922;"Geniukų kalvė";SAULUTĖS;4329782598;Ne;8;6;0;14
1923;"Geniukų kalvė";SAULUTĖS;8932671578;Ne;12;9;0;21
1924;"Geniukų kalvė";SAULUTĖS;9711047774;Ne;15;0;0;15
1925;"Geniukų kalvė";SAULUTĖS;9522911738;Ne;15;1;1;17
1926;"Geniukų kalvė";SAULUTĖS;5348211316;Ne;0;7;0;7
1927;"Geniukų kalvė";SAULUTĖS;7886553419;Ne;1;0;0;1
1928;"Geniukų kalvė";SAULUTĖS;6384832317;Ne;0;4;17;21
1929;"Geniukų kalvė";SAULUTĖS;4946218794;Ne;3;2;0;5
1930;"Geniukų kalvė";SAULUTĖS;4745451344;Ne;6;0;1;7
1931;"Geniukų kalvė";SAULUTĖS;9768077014;Ne;0;4;0;4
1932;"Geniukų kalvė";SAULUTĖS;3889643236;Ne;17;2;0;19
1933;"Geniukų kalvė";SAULUTĖS;6102906310;Ne;5;4;0;9
1934;"Geniukų kalvė";SAULUTĖS;6016735700;Ne;15;0;0;15
1935;"Geniukų kalvė";SAULUTĖS;9976423099;Ne;9;0;0;9
1936;"Geniukų kalvė";SAULUTĖS;5180240547;Ne;8;4;0;12
1937;"Geniukų kalvė";BITUTĖS;5587035951;Ne;6;3;0;9
1938;"Geniukų kalvė";BITUTĖS;9323779212;Ne;8;0;1;9
1939;"Geniukų kalvė";BITUTĖS;8577323715;Ne;0;4;1;5
1940;"Geniukų kalvė";BITUTĖS;7453065865;Ne;2;0;1;3
1941;"Geniukų kalvė";BITUTĖS;8570015975;Ne;0;2;0;2
1942;"Geniukų kalvė";BITUTĖS;9455124402;Ne;10;0;0;10
1943;"Geniukų kalvė";BITUTĖS;4633553106;Ne;0;4;1;5
1944;"Geniukų kalvė";BITUTĖS;3669378459;Ne;0;1;0;1
1945;"Geniukų kalvė";BITUTĖS;4201333532;Ne;1;4;1;6
1946;"Geniukų kalvė";BITUTĖS;5102325807;Ne;4;7;0;11
1947;"Geniukų kalvė";BITUTĖS;1492140432;Ne;5;0;4;9
1948;"Geniukų kalvė";BITUTĖS;1426555835;Ne;0;2;0;2
1949;"Geniukų kalvė";BITUTĖS;6138451393;Ne;0;1;0;1
1950;"Geniukų kalvė";BITUTĖS;7747615302;Ne;0;12;0;12
1951;"Geniukų kalvė";BITUTĖS;4691978116;Ne;5;0;0;5
1952;"Geniukų kalvė";BITUTĖS;6111168227;Ne;13;0;0;13
1953;"Geniukų kalvė";BITUTĖS;1209268848;Ne;0;0;1;1
1954;"Geniukų kalvė";BITUTĖS;6351861630;Ne;5;4;0;9
1955;"Geniukų kalvė";BITUTĖS;6214681079;Ne;0;2;0;2
1956;"Geniukų kalvė";BITUTĖS;3221034847;Ne;5;0;3;8
1957;"Geniukų kalvė";KIŠKUČIAI;5253380852;Ne;21;0;0;21
1958;"Geniukų kalvė";KIŠKUČIAI;2684344984;Ne;4;8;0;12
1959;"Geniukų kalvė";KIŠKUČIAI;9075192344;Ne;0;9;0;9
1960;"Geniukų kalvė";KIŠKUČIAI;5078771341;Ne;19;0;0;19
1961;"Geniukų kalvė";KIŠKUČIAI;4849740486;Ne;3;0;1;4
1962;"Geniukų kalvė";KIŠKUČIAI;9730758999;Ne;0;2;0;2
1963;"Geniukų kalvė";KIŠKUČIAI;9579750299;Ne;5;0;2;7
1964;"Geniukų kalvė";KIŠKUČIAI;9543553237;Ne;5;0;0;5
1965;"Geniukų kalvė";KIŠKUČIAI;2032408983;Ne;5;0;0;5
1966;"Geniukų kalvė";KIŠKUČIAI;9386761753;Ne;7;1;0;8
1967;"Geniukų kalvė";KIŠKUČIAI;6188518268;Ne;0;0;5;5
1968;"Geniukų kalvė";KIŠKUČIAI;3887137828;Ne;19;0;0;19
1969;"Geniukų kalvė";VYTURĖLIAI;5945583960;Ne;0;10;0;10
1970;"Geniukų kalvė";VYTURĖLIAI;1568133009;Ne;0;4;0;4
1971;"Geniukų kalvė";VYTURĖLIAI;8939171238;Ne;0;5;0;5
1972;"Geniukų kalvė";VYTURĖLIAI;2337226175;Ne;0;3;0;3
1973;"Geniukų kalvė";VYTURĖLIAI;2140334255;Ne;0;8;3;11
1974;"Geniukų kalvė";VYTURĖLIAI;7664689396;Ne;0;0;1;1
1975;"Geniukų kalvė";VYTURĖLIAI;4844734556;Ne;0;4;0;4
1976;"Geniukų kalvė";VYTURĖLIAI;8635708009;Ne;7;0;2;9
1977;"Geniukų kalvė";VYTURĖLIAI;4758435835;Ne;0;10;0;10
1978;"Geniukų kalvė";VYTURĖLIAI;9081596975;Ne;0;3;0;3
1979;"Geniukų kalvė";VYTURĖLIAI;2262014110;Ne;0;2;0;2
1980;"Geniukų kalvė";VYTURĖLIAI;2890934301;Ne;0;5;0;5
1981;"Geniukų kalvė";VYTURĖLIAI;2904091819;Ne;0;1;0;1
1982;"Geniukų kalvė";VYTURĖLIAI;43097490633;Ne;0;7;0;7
1983;"Geniukų kalvė";VYTURĖLIAI;1460456166;Ne;0;1;0;1
1984;"Geniukų kalvė";VYTURĖLIAI;30932565379;Ne;0;3;0;3
1985;"Geniukų kalvė";VYTURĖLIAI;3826265557;Ne;1;2;0;3
1986;"Geniukų kalvė";VYTURĖLIAI;5756909142;Ne;0;1;0;1
1987;"Geniukų kalvė";DRUGELIAI;9676782662;Ne;0;3;0;3
1988;"Geniukų kalvė";DRUGELIAI;7745656622;Ne;1;0;0;1
1989;"Geniukų kalvė";DRUGELIAI;6520429663;Ne;5;4;0;9
1990;"Geniukų kalvė";DRUGELIAI;5542539934;Ne;0;14;0;14
1991;"Geniukų kalvė";DRUGELIAI;6466912385;Ne;0;6;0;6
1992;"Geniukų kalvė";DRUGELIAI;2718961466;Ne;0;6;0;6
1993;"Geniukų kalvė";DRUGELIAI;2016254460;Ne;0;7;0;7
1994;"Geniukų kalvė";DRUGELIAI;3984265624;Ne;0;15;0;15
1995;"Geniukų kalvė";DRUGELIAI;4813232640;Ne;0;4;0;4
1996;"Geniukų kalvė";DRUGELIAI;5776314197;Ne;0;4;0;4
1997;"Geniukų kalvė";DRUGELIAI;1897809684;Ne;0;4;0;4
1998;"Geniukų kalvė";DRUGELIAI;8872900558;Ne;0;5;0;5
1999;"Geniukų kalvė";DRUGELIAI;2031800114;Ne;0;1;0;1
2000;"Geniukų kalvė";DRUGELIAI;1451190239;Ne;0;6;0;6
2001;"Geniukų kalvė";DRUGELIAI;6511955882;Ne;0;4;0;4
2002;"Geniukų kalvė";DRUGELIAI;6500641378;Ne;0;3;0;3
2003;"Geniukų kalvė";DRUGELIAI;2143334688;Ne;0;4;0;4
2004;"Geniukų kalvė";DRUGELIAI;9990243525;Ne;0;2;3;5
2005;"Geniukų kalvė";DRUGELIAI;4105170344;Ne;0;2;0;2
2006;"Geniukų kalvė";"SAULĖS ZUIKUČIAI";7082945033;Ne;0;4;0;4
2007;"Geniukų kalvė";"SAULĖS ZUIKUČIAI";2313382307;Ne;0;3;2;5
2008;"Geniukų kalvė";"SAULĖS ZUIKUČIAI";8309953586;Ne;5;0;0;5
2009;"Geniukų kalvė";"SAULĖS ZUIKUČIAI";7500079028;Ne;0;12;0;12
2010;"Geniukų kalvė";"SAULĖS ZUIKUČIAI";8071493871;Ne;2;4;0;6
2011;"Geniukų kalvė";"SAULĖS ZUIKUČIAI";1718428600;Ne;3;0;0;3
2012;"Geniukų kalvė";"SAULĖS ZUIKUČIAI";8914605154;Ne;0;4;1;5
2013;"Geniukų kalvė";"SAULĖS ZUIKUČIAI";6016585056;Ne;0;0;4;4
2014;"Geniukų kalvė";"SAULĖS ZUIKUČIAI";2816691996;Ne;1;4;1;6
2015;"Geniukų kalvė";"SAULĖS ZUIKUČIAI";5512172533;Ne;0;12;0;12
2016;"Geniukų kalvė";"SAULĖS ZUIKUČIAI";1375674317;Ne;0;1;0;1
2017;"Geniukų kalvė";"SAULĖS ZUIKUČIAI";4722801116;Ne;7;0;0;7
2018;"Geniukų kalvė";"SAULĖS ZUIKUČIAI";5763009912;Ne;0;5;0;5
2019;"Geniukų kalvė";"SAULĖS ZUIKUČIAI";5245434552;Ne;0;6;0;6
2020;"Geniukų kalvė";"SAULĖS ZUIKUČIAI";5725034297;Ne;0;1;0;1
2021;"Geniukų kalvė";"SAULĖS ZUIKUČIAI";1499735818;Ne;12;0;0;12
2022;"Geniukų kalvė";"SAULĖS ZUIKUČIAI";4186376527;Ne;0;2;0;2
2023;"Geniukų kalvė";"SAULĖS ZUIKUČIAI";5161600326;Ne;0;0;4;4
2024;"Geniukų kalvė";SMALSUČIAI;2499796674;Ne;0;3;0;3
2025;"Geniukų kalvė";SMALSUČIAI;5974481787;Ne;11;0;0;11
2026;"Geniukų kalvė";SMALSUČIAI;7915720190;Ne;6;0;0;6
2027;"Geniukų kalvė";SMALSUČIAI;7384802397;Ne;6;0;0;6
2028;"Geniukų kalvė";SMALSUČIAI;5993223458;Ne;6;0;0;6
2029;"Geniukų kalvė";SMALSUČIAI;8985466295;Ne;0;4;0;4
2030;"Geniukų kalvė";SMALSUČIAI;5129841490;Ne;0;6;0;6
2031;"Geniukų kalvė";SMALSUČIAI;5705917381;Ne;2;6;0;8
2032;"Geniukų kalvė";SMALSUČIAI;2300947427;Ne;0;5;0;5
2033;"Geniukų kalvė";SMALSUČIAI;1028242614;Ne;0;1;0;1
2034;"Geniukų kalvė";SMALSUČIAI;2596680448;Ne;0;1;0;1
2035;"Geniukų kalvė";SMALSUČIAI;4405381922;Ne;7;1;0;8
2036;"Geniukų kalvė";SMALSUČIAI;6473724074;Ne;6;0;0;6
2037;"Geniukų kalvė";SMALSUČIAI;3627418555;Ne;0;7;0;7
2038;"Geniukų kalvė";SMALSUČIAI;9155681194;Ne;9;0;0;9
2039;"Geniukų kalvė";SMALSUČIAI;7440029486;Ne;4;1;0;5
2040;"Geniukų kalvė";SMALSUČIAI;7140298387;Ne;0;6;0;6
2041;"Geniukų kalvė";SMALSUČIAI;6168422514;Ne;21;0;0;21
2042;"Geniukų kalvė";SMALSUČIAI;6757580298;Ne;3;0;0;3
2043;"Geniukų kalvė";RUDNOSIUKAI;6060825704;Ne;10;0;0;10
2044;"Geniukų kalvė";RUDNOSIUKAI;6149037133;Ne;0;14;0;14
2045;"Geniukų kalvė";RUDNOSIUKAI;5883913787;Ne;0;3;0;3
2046;"Geniukų kalvė";RUDNOSIUKAI;2426186771;Ne;7;0;0;7
2047;"Geniukų kalvė";RUDNOSIUKAI;5205178173;Ne;0;9;0;9
2048;"Geniukų kalvė";RUDNOSIUKAI;2836282651;Ne;0;2;0;2
2049;"Geniukų kalvė";RUDNOSIUKAI;9847003556;Ne;0;2;0;2
2050;"Geniukų kalvė";RUDNOSIUKAI;7300853810;Ne;0;5;0;5
2051;"Geniukų kalvė";RUDNOSIUKAI;2839299179;Ne;0;1;0;1
2052;"Geniukų kalvė";RUDNOSIUKAI;2165793561;Ne;0;9;0;9
2053;"Geniukų kalvė";RUDNOSIUKAI;8973285553;Ne;4;0;0;4
2054;"Geniukų kalvė";RUDNOSIUKAI;4985606198;Ne;0;0;2;2
2055;"Geniukų kalvė";RUDNOSIUKAI;3152130511;Ne;0;6;9;15
2056;"Geniukų kalvė";RUDNOSIUKAI;2798750158;Ne;0;4;0;4
2057;"Geniukų kalvė";RUDNOSIUKAI;6373989816;Ne;0;2;0;2
2058;"Geniukų kalvė";PELĖDŽIUKAI;2217221922;Ne;0;0;1;1
2059;"Geniukų kalvė";PELĖDŽIUKAI;8271041553;Ne;0;4;0;4
2060;"Geniukų kalvė";PELĖDŽIUKAI;1237228692;Ne;0;4;0;4
2061;"Geniukų kalvė";PELĖDŽIUKAI;3055777730;Ne;0;0;5;5
2062;"Geniukų kalvė";PELĖDŽIUKAI;6070945557;Ne;1;5;0;6
2063;"Geniukų kalvė";PELĖDŽIUKAI;1051563985;Ne;0;4;0;4
2064;"Geniukų kalvė";PELĖDŽIUKAI;6174114461;Ne;1;1;0;2
2065;"Geniukų kalvė";PELĖDŽIUKAI;2659298240;Ne;0;9;0;9
2066;"Geniukų kalvė";PELĖDŽIUKAI;6737863183;Ne;0;1;0;1
2067;"Geniukų kalvė";PELĖDŽIUKAI;5704223824;Taip;0;6;0;6
2068;"Geniukų kalvė";PELĖDŽIUKAI;6410008429;Ne;0;1;0;1
2069;"Geniukų kalvė";PELĖDŽIUKAI;8770345339;Ne;8;0;3;11
2070;"Geniukų kalvė";PELĖDŽIUKAI;9677583445;Ne;0;2;0;2
2071;"Geniukų kalvė";PELĖDŽIUKAI;6237208661;Ne;0;0;3;3
2072;"Geniukų kalvė";BORUŽĖLĖS;9613720001;Ne;4;0;0;4
2073;"Geniukų kalvė";BORUŽĖLĖS;4958738745;Ne;0;7;0;7
2074;"Geniukų kalvė";BORUŽĖLĖS;9069256760;Ne;10;0;0;10
2075;"Geniukų kalvė";BORUŽĖLĖS;5161535756;Ne;8;1;0;9
2076;"Geniukų kalvė";BORUŽĖLĖS;3493492581;Ne;9;1;0;10
2077;"Geniukų kalvė";BORUŽĖLĖS;3085228868;Ne;0;5;1;6
2078;"Geniukų kalvė";BORUŽĖLĖS;4777155321;Ne;3;5;0;8
2079;"Geniukų kalvė";BORUŽĖLĖS;1037854104;Ne;0;1;0;1
2080;"Geniukų kalvė";BORUŽĖLĖS;2180860623;Ne;0;4;0;4
2081;"Geniukų kalvė";BORUŽĖLĖS;8769761434;Ne;2;0;1;3
2082;"Geniukų kalvė";BORUŽĖLĖS;1891205998;Ne;0;3;0;3
2083;"Geniukų kalvė";BORUŽĖLĖS;9643242164;Ne;4;2;0;6
2084;"Geniukų kalvė";BORUŽĖLĖS;2665955524;Ne;0;5;0;5
2085;"Geniukų kalvė";BORUŽĖLĖS;4872435715;Ne;5;0;1;6
2086;"Geniukų kalvė";BORUŽĖLĖS;3297360222;Ne;0;10;0;10
2087;"Geniukų kalvė";BORUŽĖLĖS;6828079735;Ne;10;0;1;11
2088;"Geniukų kalvė";BORUŽĖLĖS;2710207578;Ne;3;1;0;4
2089;"Geniukų kalvė";BORUŽĖLĖS;1046406910;Ne;13;5;0;18
2090;"Geniukų kalvė";BORUŽĖLĖS;1454724752;Ne;0;6;0;6
2091;"Geniukų kalvė";BORUŽĖLĖS;3193006249;Ne;2;1;0;3
2092;"Geniukų kalvė";PAGRANDUKAI;1844495906;Ne;1;0;0;1
2093;"Geniukų kalvė";PAGRANDUKAI;7234620406;Ne;9;0;0;9
2094;"Geniukų kalvė";PAGRANDUKAI;4890413509;Ne;21;0;0;21
2095;"Geniukų kalvė";PAGRANDUKAI;2490231586;Ne;0;0;3;3
2096;"Geniukų kalvė";PAGRANDUKAI;7310171451;Ne;0;8;1;9
2097;"Geniukų kalvė";PAGRANDUKAI;8214399001;Ne;4;0;0;4
2098;"Geniukų kalvė";PAGRANDUKAI;9820642056;Ne;3;1;1;5
2099;"Geniukų kalvė";PAGRANDUKAI;5115570519;Ne;7;0;0;7
2100;"Geniukų kalvė";PAGRANDUKAI;6783296167;Ne;6;1;0;7
2101;"Geniukų kalvė";PAGRANDUKAI;8525540366;Ne;11;0;0;11
2102;"Geniukų kalvė";PAGRANDUKAI;5744371590;Ne;0;0;2;2
2103;"Geniukų kalvė";PAGRANDUKAI;5847488152;Ne;0;1;6;7
2104;"Geniukų kalvė";PAGRANDUKAI;3676717541;Ne;0;0;1;1
2105;"Geniukų kalvė";NYKŠTUKAI;7561521903;Ne;9;0;4;13
2106;"Geniukų kalvė";NYKŠTUKAI;2312298671;Ne;21;0;0;21
2107;"Geniukų kalvė";NYKŠTUKAI;8217855034;Ne;11;0;0;11
2108;"Geniukų kalvė";NYKŠTUKAI;1068112116;Ne;0;1;0;1
2109;"Geniukų kalvė";NYKŠTUKAI;1421857914;Ne;3;1;0;4
2110;"Geniukų kalvė";NYKŠTUKAI;1558977259;Ne;0;4;0;4
2111;"Geniukų kalvė";NYKŠTUKAI;4805806745;Ne;20;0;0;20
2112;"Geniukų kalvė";NYKŠTUKAI;1383717352;Ne;20;0;0;20
2113;"Geniukų kalvė";NYKŠTUKAI;2302465593;Ne;10;0;0;10
2114;"Geniukų kalvė";NYKŠTUKAI;3024701779;Ne;0;1;0;1
2115;"Geniukų kalvė";NYKŠTUKAI;3015544833;Ne;8;2;1;11
2116;"Geniukų kalvė";NYKŠTUKAI;6680434763;Ne;0;3;0;3
2117;"Geniukų kalvė";NYKŠTUKAI;7736527608;Ne;7;0;0;7
2118;"Geniukų kalvė";NYKŠTUKAI;6860580488;Ne;0;21;0;21
2119;"Geniukų kalvė";NYKŠTUKAI;9322790214;Ne;4;0;0;4
2120;Gelvonėlis;ĄŽUOLIUKAI;2329699993;Ne;0;5;0;5
2121;Gelvonėlis;ĄŽUOLIUKAI;9058956012;Ne;0;6;0;6
2122;Gelvonėlis;ĄŽUOLIUKAI;4111774915;Ne;5;0;0;5
2123;Gelvonėlis;ĄŽUOLIUKAI;3677100165;Ne;8;0;0;8
2124;Gelvonėlis;ĄŽUOLIUKAI;7449710008;Ne;9;4;0;13
2125;Gelvonėlis;ĄŽUOLIUKAI;9492898584;Ne;0;9;0;9
2126;Gelvonėlis;ĄŽUOLIUKAI;3942630720;Ne;0;11;0;11
2127;Gelvonėlis;ĄŽUOLIUKAI;1453271708;Ne;0;11;0;11
2128;Gelvonėlis;ĄŽUOLIUKAI;9756155028;Ne;14;0;0;14
2129;Gelvonėlis;ĄŽUOLIUKAI;8206816148;Ne;11;0;0;11
2130;Gelvonėlis;ĄŽUOLIUKAI;1274119900;Ne;0;6;0;6
2131;Gelvonėlis;ĄŽUOLIUKAI;5901499708;Ne;9;0;0;9
2132;Gelvonėlis;ĄŽUOLIUKAI;1403890893;Taip;0;13;0;13
2133;Gelvonėlis;ŽVIRBLIUKAI;6604992169;Ne;0;9;0;9
2134;Gelvonėlis;ŽVIRBLIUKAI;6556472766;Ne;0;4;8;12
2135;Gelvonėlis;ŽVIRBLIUKAI;8885088900;Ne;0;3;3;6
2136;Gelvonėlis;ŽVIRBLIUKAI;2400289466;Ne;0;4;5;9
2137;Gelvonėlis;ŽVIRBLIUKAI;9493536517;Ne;0;0;5;5
2138;Gelvonėlis;ŽVIRBLIUKAI;9059244134;Ne;0;1;0;1
2139;Gelvonėlis;ŽVIRBLIUKAI;1987204544;Ne;0;7;0;7
2140;Gelvonėlis;ŽVIRBLIUKAI;2288951845;Ne;0;4;0;4
2141;Gelvonėlis;ŽVIRBLIUKAI;2515471132;Ne;0;0;1;1
2142;Gelvonėlis;ŽVIRBLIUKAI;1085845218;Ne;0;0;1;1
2143;Gelvonėlis;ŽVIRBLIUKAI;6319058542;Ne;0;0;1;1
2144;Gelvonėlis;ŽVIRBLIUKAI;9538571448;Ne;0;6;0;6
2145;Gelvonėlis;ŽVIRBLIUKAI;9147186080;Ne;0;2;0;2
2146;Gelvonėlis;ŽVIRBLIUKAI;7620280474;Ne;2;0;0;2
2147;Gelvonėlis;ŽVIRBLIUKAI;7195164378;Ne;0;1;1;2
2148;Gelvonėlis;ŽVIRBLIUKAI;6598178467;Ne;6;6;2;14
2149;Gelvonėlis;ŽVIRBLIUKAI;6068473734;Ne;0;0;3;3
2150;Gelvonėlis;ŽVIRBLIUKAI;8508450500;Ne;0;6;0;6
2151;Gelvonėlis;ŽVIRBLIUKAI;8704971956;Ne;0;0;10;10
2152;Gelvonėlis;ŽVIRBLIUKAI;4281431471;Ne;0;0;4;4
2153;Gelvonėlis;ŽVIRBLIUKAI;8976258838;Ne;0;1;4;5
2154;Gelvonėlis;RASELĖS;9667024635;Ne;0;3;1;4
2155;Gelvonėlis;RASELĖS;2119550116;Ne;0;4;0;4
2156;Gelvonėlis;RASELĖS;3788522708;Ne;0;2;0;2
2157;Gelvonėlis;RASELĖS;6317822775;Ne;7;2;0;9
2158;Gelvonėlis;RASELĖS;5047022305;Ne;8;3;0;11
2159;Gelvonėlis;RASELĖS;6189110767;Ne;2;4;1;7
2160;Gelvonėlis;RASELĖS;7983982378;Ne;0;11;0;11
2161;Gelvonėlis;RASELĖS;2108690954;Ne;10;0;1;11
2162;Gelvonėlis;RASELĖS;1753617545;Ne;0;2;3;5
2163;Gelvonėlis;RASELĖS;7759317220;Ne;0;4;1;5
2164;Gelvonėlis;RASELĖS;5721858659;Ne;0;4;1;5
2165;Gelvonėlis;RASELĖS;1399518471;Ne;0;4;4;8
2166;Gelvonėlis;RASELĖS;5283207520;Ne;0;4;0;4
2167;Gelvonėlis;RASELĖS;3059903126;Ne;0;3;2;5
2168;Gelvonėlis;RASELĖS;6226970200;Ne;0;1;0;1
2169;Gelvonėlis;RASELĖS;1246591538;Ne;0;4;5;9
2170;Gelvonėlis;RASELĖS;6256962184;Ne;0;4;3;7
2171;Gelvonėlis;RASELĖS;91441127098;Ne;0;4;0;4
2172;Gelvonėlis;RASELĖS;1610362831;Ne;0;2;4;6
2173;Gelvonėlis;RASELĖS;9387523651;Ne;0;10;0;10
2174;Gelvonėlis;RASELĖS;75676389361;Ne;0;4;2;6
2175;Gelvonėlis;RASELĖS;4120103012;Ne;5;4;0;9
2176;Gelvonėlis;SAULUTĖ;9396676137;Ne;6;0;0;6
2177;Gelvonėlis;SAULUTĖ;9353066785;Ne;9;0;0;9
2178;Gelvonėlis;SAULUTĖ;3121251271;Ne;5;7;0;12
2179;Gelvonėlis;SAULUTĖ;7429739147;Ne;0;21;0;21
2180;Gelvonėlis;SAULUTĖ;8228796927;Ne;0;2;0;2
2181;Gelvonėlis;SAULUTĖ;4550077609;Ne;2;0;0;2
2182;Gelvonėlis;SAULUTĖ;1734685590;Ne;3;0;0;3
2183;Gelvonėlis;SAULUTĖ;7936622964;Ne;16;0;0;16
2184;Gelvonėlis;SAULUTĖ;3719670896;Ne;9;3;0;12
2185;Gelvonėlis;SAULUTĖ;1672409070;Ne;0;6;0;6
2186;Gelvonėlis;SAULUTĖ;3771796903;Ne;0;3;0;3
2187;Gelvonėlis;SAULUTĖ;8022270555;Ne;0;4;0;4
2188;Gelvonėlis;SAULUTĖ;4268590631;Ne;10;4;0;14
2189;Gelvonėlis;SAULUTĖ;5598186460;Ne;5;6;0;11
2190;Gelvonėlis;SAULUTĖ;9767254134;Ne;3;0;0;3
2191;Gelvonėlis;SAULUTĖ;2452711535;Ne;0;5;0;5
2192;Gelvonėlis;PELĖDŽIUKAI;3830940009;Ne;0;4;2;6
2193;Gelvonėlis;PELĖDŽIUKAI;2742000725;Ne;0;1;2;3
2194;Gelvonėlis;PELĖDŽIUKAI;3147489259;Ne;0;2;0;2
2195;Gelvonėlis;PELĖDŽIUKAI;1284359362;Ne;0;1;0;1
2196;Gelvonėlis;PELĖDŽIUKAI;9798684265;Ne;0;0;1;1
2197;Gelvonėlis;PELĖDŽIUKAI;4855800131;Ne;0;5;0;5
2198;Gelvonėlis;PELĖDŽIUKAI;8775661719;Ne;0;4;0;4
2199;Gelvonėlis;PELĖDŽIUKAI;21684706944;Ne;0;3;0;3
2200;Gelvonėlis;PELĖDŽIUKAI;3089755141;Ne;0;9;0;9
2201;Gelvonėlis;PELĖDŽIUKAI;1408313697;Ne;0;12;1;13
2202;Gelvonėlis;PELĖDŽIUKAI;3670612781;Ne;4;3;0;7
2203;Gelvonėlis;PELĖDŽIUKAI;69073786634;Ne;0;0;4;4
2204;Gelvonėlis;PELĖDŽIUKAI;29928181395;Ne;0;3;0;3
2205;Gelvonėlis;PELĖDŽIUKAI;6255253658;Ne;7;4;0;11
2206;Gelvonėlis;PELĖDŽIUKAI;9323579468;Ne;0;1;0;1
2207;Gelvonėlis;PELĖDŽIUKAI;7919814808;Ne;0;7;0;7
2208;Gelvonėlis;PELĖDŽIUKAI;1355742622;Ne;5;8;0;13
2209;Gelvonėlis;DRUGELIAI;3371560338;Ne;10;1;0;11
2210;Gelvonėlis;DRUGELIAI;2407650243;Ne;7;4;0;11
2211;Gelvonėlis;DRUGELIAI;2896360160;Ne;5;2;0;7
2212;Gelvonėlis;DRUGELIAI;8365647638;Ne;0;2;0;2
2213;Gelvonėlis;DRUGELIAI;3618681535;Ne;14;0;0;14
2214;Gelvonėlis;DRUGELIAI;2114734415;Ne;21;0;0;21
2215;Gelvonėlis;DRUGELIAI;5882430535;Ne;0;3;0;3
2216;Gelvonėlis;DRUGELIAI;9140900868;Ne;5;2;0;7
2217;Gelvonėlis;DRUGELIAI;3813000890;Ne;0;3;0;3
2218;Gelvonėlis;DRUGELIAI;6662081736;Ne;0;1;0;1
2219;Gelvonėlis;DRUGELIAI;5379820728;Ne;10;0;0;10
2220;Gelvonėlis;DRUGELIAI;7938324572;Ne;7;0;0;7
2221;Gelvonėlis;DRUGELIAI;4162701876;Ne;21;0;0;21
2222;Gelvonėlis;DRUGELIAI;2407650243;Ne;7;4;0;11
2223;Gelvonėlis;VARPELIAI;9149117970;Ne;0;2;0;2
2224;Gelvonėlis;VARPELIAI;6225854165;Ne;0;4;1;5
2225;Gelvonėlis;VARPELIAI;2791652988;Ne;5;2;1;8
2226;Gelvonėlis;VARPELIAI;2638430817;Ne;7;3;3;13
2227;Gelvonėlis;VARPELIAI;9600526942;Ne;0;11;0;11
2228;Gelvonėlis;VARPELIAI;1387948936;Ne;0;4;0;4
2229;Gelvonėlis;VARPELIAI;1462716950;Ne;0;2;0;2
2230;Gelvonėlis;VARPELIAI;6949090250;Ne;0;0;1;1
2231;Gelvonėlis;VARPELIAI;9622818893;Ne;10;0;0;10
2232;Gelvonėlis;VARPELIAI;6869418701;Ne;5;0;0;5
2233;Gelvonėlis;VARPELIAI;5207153784;Ne;6;0;0;6
2234;Gelvonėlis;VARPELIAI;9963769327;Ne;0;2;0;2
2235;Gelvonėlis;VARPELIAI;3192542909;Ne;4;0;4;8
2236;Gelvonėlis;VARPELIAI;1802520150;Ne;0;0;2;2
2237;Gelvonėlis;BORUŽĖLĖS;8209225630;Ne;0;5;0;5
2238;Gelvonėlis;BORUŽĖLĖS;6554989142;Ne;5;4;0;9
2239;Gelvonėlis;BORUŽĖLĖS;8056058298;Ne;0;1;2;3
2240;Gelvonėlis;BORUŽĖLĖS;2434789595;Ne;4;0;1;5
2241;Gelvonėlis;BORUŽĖLĖS;2698853686;Ne;0;2;0;2
2242;Gelvonėlis;BORUŽĖLĖS;4112607183;Ne;0;6;0;6
2243;Gelvonėlis;BORUŽĖLĖS;6243360625;Ne;0;11;0;11
2244;Gelvonėlis;BORUŽĖLĖS;5790038422;Ne;0;3;0;3
2245;Gelvonėlis;BORUŽĖLĖS;1712926391;Ne;7;4;2;13
2246;Gelvonėlis;BORUŽĖLĖS;1107633909;Ne;0;9;0;9
2247;Gelvonėlis;BORUŽĖLĖS;8973272332;Ne;0;1;0;1
2248;Gelvonėlis;BORUŽĖLĖS;9849765037;Ne;0;4;0;4
2249;Gelvonėlis;BORUŽĖLĖS;3846916445;Ne;7;1;0;8
2250;Gelvonėlis;BORUŽĖLĖS;4749071286;Ne;0;3;0;3
2251;Gelvonėlis;BORUŽĖLĖS;8806934077;Ne;0;0;21;21
2252;Gelvonėlis;BORUŽĖLĖS;3926733474;Ne;7;0;7;14
2253;Gelvonėlis;BORUŽĖLĖS;4620517551;Ne;0;0;4;4
2254;Gelvonėlis;BORUŽĖLĖS;6598688551;Ne;0;9;0;9
2255;Gelvonėlis;NYKŠTUKAI;8987012601;Ne;5;0;1;6
2256;Gelvonėlis;NYKŠTUKAI;7632523330;Ne;0;0;1;1
2257;Gelvonėlis;NYKŠTUKAI;1112841066;Ne;5;7;0;12
2258;Gelvonėlis;NYKŠTUKAI;2553846157;Ne;5;0;2;7
2259;Gelvonėlis;NYKŠTUKAI;8003522011;Ne;4;4;0;8
2260;Gelvonėlis;NYKŠTUKAI;5713586282;Ne;8;0;1;9
2261;Gelvonėlis;NYKŠTUKAI;3217646353;Ne;3;7;0;10
2262;Gelvonėlis;NYKŠTUKAI;8560940316;Ne;0;4;0;4
2263;Gelvonėlis;NYKŠTUKAI;8540204705;Ne;0;1;0;1
2264;Gelvonėlis;NYKŠTUKAI;8124516993;Ne;14;0;2;16
2265;Gelvonėlis;NYKŠTUKAI;9751580494;Ne;3;1;5;9
2266;Gelvonėlis;NYKŠTUKAI;4156493586;Ne;0;5;1;6
2267;Gelvonėlis;NYKŠTUKAI;5124211917;Ne;0;6;0;6
2268;Gelvonėlis;NYKŠTUKAI;5305480599;Ne;5;0;0;5
2269;Gelvonėlis;NYKŠTUKAI;5874473596;Ne;7;1;0;8
2270;Gelvonėlis;NYKŠTUKAI;9900244859;Ne;12;0;2;14
2271;Gelvonėlis;NYKŠTUKAI;9597033956;Ne;4;0;1;5
2272;Gelvonėlis;NYKŠTUKAI;4027647695;Ne;9;0;2;11
2273;Gelvonėlis;BITUTĖS;6534527571;Ne;0;7;0;7
2274;Gelvonėlis;BITUTĖS;1105838340;Ne;10;0;0;10
2275;Gelvonėlis;BITUTĖS;5444127599;Ne;15;0;0;15
2276;Gelvonėlis;BITUTĖS;1980703633;Ne;0;6;0;6
2277;Gelvonėlis;BITUTĖS;6710189985;Ne;0;8;0;8
2278;Gelvonėlis;BITUTĖS;5281400074;Ne;0;0;4;4
2279;Gelvonėlis;BITUTĖS;3514762919;Ne;0;4;2;6
2280;Gelvonėlis;BITUTĖS;8792171281;Ne;2;2;0;4
2281;Gelvonėlis;BITUTĖS;7850553299;Ne;13;0;0;13
2282;Gelvonėlis;BITUTĖS;8480138654;Ne;0;6;0;6
2283;Gelvonėlis;BITUTĖS;7725313260;Ne;0;18;1;19
2284;Gelvonėlis;BITUTĖS;5816373550;Ne;10;0;3;13
2285;Gelvonėlis;BITUTĖS;4380468764;Ne;0;16;0;16
2286;Gelvonėlis;RAMUNĖLĖS;1104204810;Ne;4;0;0;4
2287;Gelvonėlis;RAMUNĖLĖS;1355774181;Ne;8;0;0;8
2288;Gelvonėlis;RAMUNĖLĖS;2774170680;Ne;0;2;0;2
2289;Gelvonėlis;RAMUNĖLĖS;3269417874;Ne;0;0;2;2
2290;Gelvonėlis;RAMUNĖLĖS;9403505858;Ne;5;0;0;5
2291;Gelvonėlis;RAMUNĖLĖS;7686930719;Ne;0;0;1;1
2292;Gelvonėlis;RAMUNĖLĖS;4450990418;Ne;15;4;1;20
2293;Gelvonėlis;RAMUNĖLĖS;6883156109;Ne;2;0;0;2
2294;Gelvonėlis;RAMUNĖLĖS;1562829157;Ne;15;0;0;15
2295;Gelvonėlis;RAMUNĖLĖS;4211228746;Ne;0;4;0;4
2296;Gelvonėlis;RAMUNĖLĖS;6365451610;Ne;2;1;0;3
2297;Gelvonėlis;RAMUNĖLĖS;1661034338;Ne;17;0;0;17
2298;Gelvonėlis;RAMUNĖLĖS;6851036864;Ne;8;0;0;8
2299;Gelvonėlis;RAMUNĖLĖS;2821485779;Ne;14;0;0;14
2300;Gelvonėlis;RAMUNĖLĖS;6518583809;Ne;0;0;18;18
2301;Gelvonėlis;RAMUNĖLĖS;2818319130;Ne;0;3;0;3
2302;Gelvonėlis;RIEŠUTĖLIAI;3368423382;Ne;0;1;0;1
2303;Gelvonėlis;RIEŠUTĖLIAI;3973248307;Ne;0;7;0;7
2304;Gelvonėlis;RIEŠUTĖLIAI;5461812139;Ne;0;21;0;21
2305;Gelvonėlis;RIEŠUTĖLIAI;5986018609;Ne;0;4;2;6
2306;Gelvonėlis;RIEŠUTĖLIAI;4208103106;Ne;0;0;2;2
2307;Gelvonėlis;RIEŠUTĖLIAI;8766702456;Ne;9;4;2;15
2308;Gelvonėlis;RIEŠUTĖLIAI;6305084811;Ne;15;0;1;16
2309;Gelvonėlis;RIEŠUTĖLIAI;2005647155;Ne;0;1;1;2
2310;Gelvonėlis;RIEŠUTĖLIAI;1266479895;Ne;2;0;0;2
2311;Gelvonėlis;RIEŠUTĖLIAI;5934077931;Ne;0;2;0;2
2312;Gelvonėlis;RIEŠUTĖLIAI;4280463938;Ne;0;1;0;1
2313;Gelvonėlis;RIEŠUTĖLIAI;6471921512;Ne;5;1;0;6
2314;Gelvonėlis;RIEŠUTĖLIAI;3448444552;Ne;6;6;0;12
2315;Gelvonėlis;RIEŠUTĖLIAI;4832167372;Ne;0;9;0;9
2316;Gelvonėlis;RIEŠUTĖLIAI;9301814935;Ne;2;0;0;2
2317;Gelvonėlis;RIEŠUTĖLIAI;2015807805;Ne;0;15;0;15
2318;Gelvonėlis;RIEŠUTĖLIAI;9323228591;Ne;12;0;3;15
2319;Gelvonėlis;RIEŠUTĖLIAI;2360728722;Ne;16;0;0;16
2320;Gelvonėlis;RIEŠUTĖLIAI;9132529216;Ne;2;3;0;5
2321;"Gervelė (Dzūkų g. 32)";ŽIRNIUKAI;2523056808;Ne;0;0;1;1
2322;"Gervelė (Dzūkų g. 32)";ŽIRNIUKAI;8533480337;Ne;0;1;0;1
2323;"Gervelė (Dzūkų g. 32)";ŽIRNIUKAI;6227091658;Ne;2;0;0;2
2324;"Gervelė (Dzūkų g. 32)";ŽIRNIUKAI;8439479958;Ne;0;6;0;6
2325;"Gervelė (Dzūkų g. 32)";ŽIRNIUKAI;6844406500;Ne;0;8;0;8
2326;"Gervelė (Dzūkų g. 32)";ŽIRNIUKAI;2359854614;Ne;0;6;0;6
2327;"Gervelė (Dzūkų g. 32)";ŽIRNIUKAI;8811086908;Ne;0;3;0;3
2328;"Gervelė (Dzūkų g. 32)";ŽIRNIUKAI;1573560581;Ne;4;0;0;4
2329;"Gervelė (Dzūkų g. 32)";ŽIRNIUKAI;9133101055;Ne;9;0;2;11
2330;"Gervelė (Dzūkų g. 32)";ŽIRNIUKAI;1783612448;Ne;6;5;4;15
2331;"Gervelė (Dzūkų g. 32)";ŽIRNIUKAI;6650473677;Ne;0;2;0;2
2332;"Gervelė (Dzūkų g. 32)";ŽIRNIUKAI;2563081304;Ne;10;0;0;10
2333;"Gervelė (Dzūkų g. 32)";ŽIRNIUKAI;1101877666;Ne;18;0;1;19
2334;"Gervelė (Dzūkų g. 32)";ŽIRNIUKAI;2046282471;Ne;17;0;0;17
2335;"Gervelė (Dzūkų g. 32)";ŽIRNIUKAI;1024397071;Ne;0;0;4;4
2336;"Gervelė (Dzūkų g. 32)";ŽIRNIUKAI;7040713170;Ne;0;3;0;3
2337;"Gervelė (Dzūkų g. 32)";ŽIRNIUKAI;4075328330;Ne;0;0;5;5
2338;"Gervelė (Dzūkų g. 32)";LAŠIUKAI;3647044817;Ne;2;0;1;3
2339;"Gervelė (Dzūkų g. 32)";LAŠIUKAI;6431701403;Ne;2;0;4;6
2340;"Gervelė (Dzūkų g. 32)";LAŠIUKAI;2413995770;Ne;6;5;1;12
2341;"Gervelė (Dzūkų g. 32)";LAŠIUKAI;1637204236;Ne;0;0;3;3
2342;"Gervelė (Dzūkų g. 32)";LAŠIUKAI;8157865822;Ne;0;12;1;13
2343;"Gervelė (Dzūkų g. 32)";LAŠIUKAI;7924884022;Ne;10;6;0;16
2344;"Gervelė (Dzūkų g. 32)";LAŠIUKAI;1323074335;Ne;5;0;1;6
2345;"Gervelė (Dzūkų g. 32)";LAŠIUKAI;6058944385;Ne;0;3;0;3
2346;"Gervelė (Dzūkų g. 32)";LAŠIUKAI;2446758975;Ne;5;3;0;8
2347;"Gervelė (Dzūkų g. 32)";LAŠIUKAI;1353920541;Ne;0;0;1;1
2348;"Gervelė (Dzūkų g. 32)";LAŠIUKAI;5799823801;Ne;7;0;1;8
2349;"Gervelė (Dzūkų g. 32)";LAŠIUKAI;4899690598;Ne;7;0;7;14
2350;"Gervelė (Dzūkų g. 32)";LAŠIUKAI;6895415337;Ne;5;0;0;5
2351;"Gervelė (Dzūkų g. 32)";PABIRUČIAI;7317091881;Ne;16;0;0;16
2352;"Gervelė (Dzūkų g. 32)";PABIRUČIAI;6951455424;Ne;4;0;1;5
2353;"Gervelė (Dzūkų g. 32)";PABIRUČIAI;1112844296;Ne;0;0;3;3
2354;"Gervelė (Dzūkų g. 32)";PABIRUČIAI;6287806975;Ne;0;4;0;4
2355;"Gervelė (Dzūkų g. 32)";PABIRUČIAI;6228025635;Ne;0;0;5;5
2356;"Gervelė (Dzūkų g. 32)";PABIRUČIAI;9977349707;Ne;0;7;0;7
2357;"Gervelė (Dzūkų g. 32)";PABIRUČIAI;3333885493;Ne;5;2;0;7
2358;"Gervelė (Dzūkų g. 32)";PABIRUČIAI;4295743997;Ne;0;1;0;1
2359;"Gervelė (Dzūkų g. 32)";PABIRUČIAI;7935059565;Ne;0;5;1;6
2360;"Gervelė (Dzūkų g. 32)";PABIRUČIAI;5267617723;Ne;6;2;0;8
2361;"Gervelė (Dzūkų g. 32)";PABIRUČIAI;5953552777;Ne;0;2;0;2
2362;"Gervelė (Dzūkų g. 32)";PABIRUČIAI;4038179503;Ne;7;4;2;13
2363;"Gervelė (Dzūkų g. 32)";PABIRUČIAI;1160084928;Ne;5;0;2;7
2364;"Gervelė (Dzūkų g. 32)";PABIRUČIAI;6987657237;Ne;0;0;2;2
2365;"Gervelė (Dzūkų g. 32)";PABIRUČIAI;5685222621;Ne;10;0;0;10
2366;"Gervelė (Dzūkų g. 32)";PABIRUČIAI;4294916559;Ne;7;1;0;8
2367;"Gervelė (Dzūkų g. 32)";PABIRUČIAI;3449674095;Ne;5;10;0;15
2368;"Gervelė (Dzūkų g. 32)";BITUTĖS;6448855055;Ne;0;0;1;1
2369;"Gervelė (Dzūkų g. 32)";BITUTĖS;6090290046;Ne;0;1;1;2
2370;"Gervelė (Dzūkų g. 32)";BITUTĖS;75080308291;Ne;0;7;0;7
2371;"Gervelė (Dzūkų g. 32)";BITUTĖS;6737174004;Ne;0;4;0;4
2372;"Gervelė (Dzūkų g. 32)";BITUTĖS;1616949023;Ne;13;0;1;14
2373;"Gervelė (Dzūkų g. 32)";BITUTĖS;3427400844;Ne;0;1;6;7
2374;"Gervelė (Dzūkų g. 32)";BITUTĖS;8152446576;Ne;6;0;0;6
2375;"Gervelė (Dzūkų g. 32)";BITUTĖS;7302238728;Ne;0;1;0;1
2376;"Gervelė (Dzūkų g. 32)";BITUTĖS;1400044294;Ne;2;2;8;12
2377;"Gervelė (Dzūkų g. 32)";BITUTĖS;8062089041;Ne;0;9;0;9
2378;"Gervelė (Dzūkų g. 32)";BITUTĖS;7697761552;Ne;0;4;1;5
2379;"Gervelė (Dzūkų g. 32)";BITUTĖS;5989713844;Ne;0;6;0;6
2380;"Gervelė (Dzūkų g. 32)";BITUTĖS;4560752068;Ne;0;10;0;10
2381;"Gervelė (Dzūkų g. 32)";BITUTĖS;89076506192;Ne;4;6;0;10
2382;"Gervelė (Dzūkų g. 32)";BITUTĖS;87619285504;Ne;0;0;6;6
2383;"Gervelė (Dzūkų g. 32)";BITUTĖS;1991238577;Ne;0;2;7;9
2384;"Gervelė (Dzūkų g. 32)";BITUTĖS;2167744244;Ne;5;4;0;9
2385;"Gervelė (Dzūkų g. 32)";BITUTĖS;3525060645;Ne;7;0;0;7
2386;"Gervelė (Dzūkų g. 32)";BITUTĖS;7162551366;Ne;0;21;0;21
2387;"Gervelė (Dzūkų g. 32)";BITUTĖS;9970293084;Ne;0;1;0;1
2388;"Gervelė (Dzūkų g. 32)";BURATINO;3946391650;Ne;0;1;2;3
2389;"Gervelė (Dzūkų g. 32)";BURATINO;7620764911;Ne;9;4;0;13
2390;"Gervelė (Dzūkų g. 32)";BURATINO;9239897472;Ne;0;4;0;4
2391;"Gervelė (Dzūkų g. 32)";BURATINO;3359793310;Ne;6;0;0;6
2392;"Gervelė (Dzūkų g. 32)";BURATINO;9982951468;Ne;14;0;2;16
2393;"Gervelė (Dzūkų g. 32)";BURATINO;5900623823;Ne;5;5;0;10
2394;"Gervelė (Dzūkų g. 32)";BURATINO;4775822341;Ne;5;9;0;14
2395;"Gervelė (Dzūkų g. 32)";BURATINO;8012122042;Ne;0;8;0;8
2396;"Gervelė (Dzūkų g. 32)";BURATINO;2541771432;Ne;11;6;0;17
2397;"Gervelė (Dzūkų g. 32)";BURATINO;2913622440;Ne;0;0;1;1
2398;"Gervelė (Dzūkų g. 32)";BURATINO;4434618210;Ne;0;0;1;1
2399;"Gervelė (Dzūkų g. 32)";BURATINO;1108744283;Ne;0;8;0;8
2400;"Gervelė (Dzūkų g. 32)";BURATINO;4516538272;Ne;0;4;2;6
2401;"Gervelė (Dzūkų g. 32)";BURATINO;9256422807;Ne;2;4;1;7
2402;"Gervelė (Dzūkų g. 32)";BURATINO;3723783633;Ne;0;4;1;5
2403;"Gervelė (Dzūkų g. 32)";BURATINO;9997346812;Ne;5;4;1;10
2404;"Gervelė (Dzūkų g. 32)";BURATINO;8472436632;Ne;0;0;3;3
2405;"Gervelė (Dzūkų g. 32)";VIŠČIUKŲ;1020706652;Ne;0;0;1;1
2406;"Gervelė (Dzūkų g. 32)";VIŠČIUKŲ;9532470407;Ne;5;0;0;5
2407;"Gervelė (Dzūkų g. 32)";VIŠČIUKŲ;7205673717;Ne;0;0;3;3
2408;"Gervelė (Dzūkų g. 32)";VIŠČIUKŲ;7140356352;Ne;16;0;0;16
2409;"Gervelė (Dzūkų g. 32)";VIŠČIUKŲ;8598429197;Ne;0;0;3;3
2410;"Gervelė (Dzūkų g. 32)";VIŠČIUKŲ;9294388176;Ne;0;0;3;3
2411;"Gervelė (Dzūkų g. 32)";VIŠČIUKŲ;3230279203;Ne;4;0;0;4
2412;"Gervelė (Dzūkų g. 32)";VIŠČIUKŲ;8392147716;Ne;16;0;0;16
2413;"Gervelė (Dzūkų g. 32)";VIŠČIUKŲ;5608916470;Ne;0;17;0;17
2414;"Gervelė (Dzūkų g. 32)";VIŠČIUKŲ;8098158634;Ne;2;0;0;2
2415;"Gervelė (Dzūkų g. 32)";VIŠČIUKŲ;9478720027;Ne;19;0;0;19
2416;"Gervelė (Dzūkų g. 32)";VIŠČIUKŲ;3170062234;Ne;0;0;6;6
2417;"Gilužis (Vydūno g. 11A)";Skruzdėliukų;35511006307;Ne;0;6;0;6
2418;"Gilužis (Vydūno g. 11A)";Skruzdėliukų;1615293331;Ne;0;12;1;13
2419;"Gilužis (Vydūno g. 11A)";Skruzdėliukų;9474400084;Ne;0;1;0;1
2420;"Gilužis (Vydūno g. 11A)";Skruzdėliukų;5161095299;Ne;0;4;0;4
2421;"Gilužis (Vydūno g. 11A)";Skruzdėliukų;70959404439;Ne;0;4;0;4
2422;"Gilužis (Vydūno g. 11A)";Skruzdėliukų;8120898865;Ne;0;6;0;6
2423;"Gilužis (Vydūno g. 11A)";Skruzdėliukų;8840822243;Ne;0;3;0;3
2424;"Gilužis (Vydūno g. 11A)";Skruzdėliukų;4611735601;Ne;0;5;0;5
2425;"Gilužis (Vydūno g. 11A)";Skruzdėliukų;4747769984;Ne;0;4;0;4
2426;"Gilužis (Vydūno g. 11A)";Skruzdėliukų;5920357223;Ne;0;5;1;6
2427;"Gilužis (Vydūno g. 11A)";Skruzdėliukų;8595541498;Ne;2;4;0;6
2428;"Gilužis (Vydūno g. 11A)";Skruzdėliukų;5365582271;Ne;10;6;1;17
2429;"Gilužis (Vydūno g. 11A)";Skruzdėliukų;7364297673;Ne;1;0;0;1
2430;"Gilužis (Vydūno g. 11A)";Skruzdėliukų;4362244070;Ne;0;1;0;1
2431;"Gilužis (Vydūno g. 11A)";Skruzdėliukų;2042514241;Ne;0;1;0;1
2432;"Gilužis (Vydūno g. 11A)";Skruzdėliukų;3216004438;Ne;0;3;1;4
2433;"Gilužis (Vydūno g. 11A)";Skruzdėliukų;48365991937;Ne;2;9;0;11
2434;"Gilužis (Vydūno g. 11A)";Skruzdėliukų;29586826889;Ne;3;4;0;7
2435;"Gilužis (Vydūno g. 11A)";Skruzdėliukų;3071312399;Ne;2;9;0;11
2436;"Gilužis (Vydūno g. 11A)";Skruzdėliukų;6233020671;Ne;0;7;0;7
2437;"Gilužis (Vydūno g. 11A)";Nykštukų;3132445117;Ne;0;1;0;1
2438;"Gilužis (Vydūno g. 11A)";Nykštukų;4147821853;Ne;0;5;0;5
2439;"Gilužis (Vydūno g. 11A)";Nykštukų;7937643339;Ne;0;4;0;4
2440;"Gilužis (Vydūno g. 11A)";Nykštukų;3473889426;Ne;7;0;0;7
2441;"Gilužis (Vydūno g. 11A)";Nykštukų;9362581908;Ne;7;0;0;7
2442;"Gilužis (Vydūno g. 11A)";Nykštukų;2661894041;Ne;7;0;0;7
2443;"Gilužis (Vydūno g. 11A)";Nykštukų;7228498662;Ne;1;1;0;2
2444;"Gilužis (Vydūno g. 11A)";Nykštukų;3335512812;Ne;0;8;0;8
2445;"Gilužis (Vydūno g. 11A)";Nykštukų;1459273692;Ne;0;4;0;4
2446;"Gilužis (Vydūno g. 11A)";Nykštukų;4156613717;Ne;0;1;0;1
2447;"Gilužis (Vydūno g. 11A)";Nykštukų;5713786735;Ne;0;1;0;1
2448;"Gilužis (Vydūno g. 11A)";Nykštukų;4956685016;Ne;0;2;0;2
2449;"Gilužis (Vydūno g. 11A)";Nykštukų;4541291716;Ne;10;0;0;10
2450;"Gilužis (Vydūno g. 11A)";Nykštukų;8522552650;Ne;14;3;0;17
2451;"Gilužis (Vydūno g. 11A)";Nykštukų;3176305306;Ne;0;7;0;7
2452;"Gilužis (Vydūno g. 11A)";Nykštukų;4094486541;Ne;0;1;0;1
2453;"Gilužis (Vydūno g. 11A)";Bitučių;4841014668;Ne;0;8;0;8
2454;"Gilužis (Vydūno g. 11A)";Bitučių;3399162399;Ne;5;10;0;15
2455;"Gilužis (Vydūno g. 11A)";Bitučių;5973671038;Ne;0;10;0;10
2456;"Gilužis (Vydūno g. 11A)";Bitučių;5728341732;Ne;0;2;2;4
2457;"Gilužis (Vydūno g. 11A)";Bitučių;6931726275;Ne;0;4;0;4
2458;"Gilužis (Vydūno g. 11A)";Bitučių;1867185320;Ne;0;4;0;4
2459;"Gilužis (Vydūno g. 11A)";Bitučių;3429435736;Ne;7;0;0;7
2460;"Gilužis (Vydūno g. 11A)";Bitučių;8539946703;Taip;0;21;0;21
2461;"Gilužis (Vydūno g. 11A)";Bitučių;9000351000;Ne;0;9;0;9
2462;"Gilužis (Vydūno g. 11A)";Bitučių;5162397237;Ne;10;0;0;10
2463;"Gilužis (Vydūno g. 11A)";Bitučių;7250617867;Ne;4;1;0;5
2464;"Gilužis (Vydūno g. 11A)";Bitučių;9053608903;Ne;0;10;0;10
2465;"Gilužis (Vydūno g. 11A)";Bitučių;6115776872;Ne;0;0;9;9
2466;"Gilužis (Vydūno g. 11A)";Bitučių;5651799121;Ne;8;0;2;10
2467;"Gilužis (Vydūno g. 11A)";Bitučių;1334619137;Ne;0;2;0;2
2468;"Gilužis (Vydūno g. 11A)";Bitučių;2950813185;Ne;0;4;0;4
2469;"Gilužis (Vydūno g. 11A)";Bitučių;6515525848;Ne;0;9;0;9
2470;"Gilužis (Vydūno g. 11A)";Bitučių;2345403784;Ne;9;2;0;11
2471;"Gilužis (Vydūno g. 11A)";Kačiukų;1273655212;Ne;0;1;0;1
2472;"Gilužis (Vydūno g. 11A)";Kačiukų;4978922821;Ne;10;1;0;11
2473;"Gilužis (Vydūno g. 11A)";Kačiukų;2945406185;Ne;10;1;0;11
2474;"Gilužis (Vydūno g. 11A)";Kačiukų;1582241363;Ne;8;8;2;18
2475;"Gilužis (Vydūno g. 11A)";Kačiukų;7330938312;Ne;10;0;4;14
2476;"Gilužis (Vydūno g. 11A)";Kačiukų;6571132974;Ne;0;21;0;21
2477;"Gilužis (Vydūno g. 11A)";Kačiukų;7001112696;Ne;7;0;1;8
2478;"Gilužis (Vydūno g. 11A)";Kačiukų;9034842169;Ne;5;0;1;6
2479;"Gilužis (Vydūno g. 11A)";Kačiukų;6966795180;Ne;0;2;0;2
2480;"Gilužis (Vydūno g. 11A)";Kačiukų;5128383851;Ne;6;2;0;8
2481;"Gilužis (Vydūno g. 11A)";Kačiukų;8318405114;Ne;1;9;0;10
2482;"Gilužis (Vydūno g. 11A)";Kačiukų;7826015897;Ne;3;0;0;3
2483;"Gilužis (Vydūno g. 11A)";Kačiukų;4403218878;Ne;10;6;0;16
2484;"Gilužis (Vydūno g. 11A)";Kačiukų;9186274541;Ne;10;0;1;11
2485;"Gilužis (Vydūno g. 11A)";Kačiukų;1862524255;Ne;0;2;0;2
2486;"Gilužis (Vydūno g. 11A)";Kačiukų;9421351780;Ne;9;0;0;9
2487;"Gilužis (Vydūno g. 11A)";Kačiukų;4128387076;Ne;5;0;0;5
2488;"Gilužis (Vydūno g. 11A)";Kačiukų;7042664923;Ne;0;4;2;6
2489;"Gilužis (Vydūno g. 11A)";Kačiukų;9097165155;Ne;9;0;0;9
2490;"Gilužis (Vydūno g. 11A)";Kačiukų;8762534617;Ne;0;8;0;8
2491;"Gilužis (Vydūno g. 11A)";Pelėdžiukų;5217748032;Ne;0;1;0;1
2492;"Gilužis (Vydūno g. 11A)";Pelėdžiukų;5989314494;Ne;0;4;1;5
2493;"Gilužis (Vydūno g. 11A)";Pelėdžiukų;7358572344;Ne;0;4;1;5
2494;"Gilužis (Vydūno g. 11A)";Pelėdžiukų;4617259961;Ne;2;1;0;3
2495;"Gilužis (Vydūno g. 11A)";Pelėdžiukų;1222370750;Ne;0;7;0;7
2496;"Gilužis (Vydūno g. 11A)";Pelėdžiukų;9503516686;Ne;6;1;0;7
2497;"Gilužis (Vydūno g. 11A)";Pelėdžiukų;9833451628;Ne;4;3;0;7
2498;"Gilužis (Vydūno g. 11A)";Pelėdžiukų;6270071724;Ne;0;6;0;6
2499;"Gilužis (Vydūno g. 11A)";Pelėdžiukų;4051726208;Ne;2;4;1;7
2500;"Gilužis (Vydūno g. 11A)";Pelėdžiukų;7092060789;Ne;0;4;0;4
2501;"Gilužis (Vydūno g. 11A)";Pelėdžiukų;4435227217;Ne;0;1;0;1
2502;"Gilužis (Vydūno g. 11A)";Pelėdžiukų;1804218972;Ne;0;4;0;4
2503;"Gilužis (Vydūno g. 11A)";Pelėdžiukų;1832039250;Ne;2;4;0;6
2504;"Gilužis (Vydūno g. 11A)";Pelėdžiukų;3166161973;Ne;1;3;0;4
2505;"Gilužis (Vydūno g. 11A)";Pelėdžiukų;5070988982;Ne;10;1;0;11
2506;"Gilužis (Vydūno g. 11A)";Pelėdžiukų;7899274495;Ne;0;1;5;6
2507;"Gilužis (Vydūno g. 11A)";Pelėdžiukų;6093514885;Ne;4;0;1;5
2508;"Gilužis (Vydūno g. 11A)";Pelėdžiukų;2869506388;Ne;0;6;0;6
2509;"Gilužis (Vydūno g. 11A)";Pelėdžiukų;9520409342;Ne;0;2;0;2
2510;"Gilužis (Vydūno g. 11A)";Drugelių;6121625070;Ne;0;6;0;6
2511;"Gilužis (Vydūno g. 11A)";Drugelių;1770064694;Ne;0;2;0;2
2512;"Gilužis (Vydūno g. 11A)";Drugelių;9092013248;Ne;10;1;0;11
2513;"Gilužis (Vydūno g. 11A)";Drugelių;9109883577;Ne;10;0;4;14
2514;"Gilužis (Vydūno g. 11A)";Drugelių;8006465211;Ne;0;1;9;10
2515;"Gilužis (Vydūno g. 11A)";Drugelių;5118401707;Ne;0;0;2;2
2516;"Gilužis (Vydūno g. 11A)";Drugelių;3190597262;Ne;3;4;1;8
2517;"Gilužis (Vydūno g. 11A)";Drugelių;2988856911;Ne;8;4;0;12
2518;"Gilužis (Vydūno g. 11A)";Drugelių;3532863024;Ne;0;21;0;21
2519;"Gilužis (Vydūno g. 11A)";Drugelių;1376645277;Ne;0;5;1;6
2520;"Gilužis (Vydūno g. 11A)";Drugelių;1410870589;Ne;0;8;0;8
2521;"Gilužis (Vydūno g. 11A)";Drugelių;6786334223;Ne;4;0;0;4
2522;"Gilužis (Vydūno g. 11A)";Drugelių;9112993465;Ne;0;0;1;1
2523;"Gilužis (Vydūno g. 11A)";Drugelių;4909329417;Ne;5;0;0;5
2524;"Gilužis (Vydūno g. 11A)";Drugelių;8244385001;Ne;13;0;0;13
2525;"Gilužis (Vydūno g. 11A)";Drugelių;6429142049;Ne;5;0;0;5
2526;"Gilužis (Vydūno g. 11A)";Drugelių;7731169885;Ne;2;1;0;3
2527;"Gilužis (Vydūno g. 11A)";Drugelių;1093643746;Ne;2;4;0;6
2528;"Gilužis (Vydūno g. 11A)";Drugelių;3902713866;Ne;4;0;0;4
2529;"Gilužis (Vydūno g. 11A)";Drugelių;6950139609;Ne;0;0;3;3
2530;"Gilužis (Vydūno g. 11A)";Drugelių;2397231165;Ne;0;2;0;2
2531;"Gilužis (Vydūno g. 11A)";Saulučių;17896774143;Ne;3;3;3;9
2532;"Gilužis (Vydūno g. 11A)";Saulučių;9918995545;Ne;0;2;0;2
2533;"Gilužis (Vydūno g. 11A)";Saulučių;4209000927;Ne;0;4;0;4
2534;"Gilužis (Vydūno g. 11A)";Saulučių;8595551150;Ne;0;6;0;6
2535;"Gilužis (Vydūno g. 11A)";Saulučių;4575619425;Ne;0;4;0;4
2536;"Gilužis (Vydūno g. 11A)";Saulučių;4473810097;Ne;0;3;0;3
2537;"Gilužis (Vydūno g. 11A)";Saulučių;1649256496;Ne;0;5;0;5
2538;"Gilužis (Vydūno g. 11A)";Saulučių;96550272401;Ne;0;4;1;5
2539;"Gilužis (Vydūno g. 11A)";Saulučių;69504888193;Ne;0;6;0;6
2540;"Gilužis (Vydūno g. 11A)";Saulučių;2391630554;Ne;0;6;1;7
2541;"Gilužis (Vydūno g. 11A)";Saulučių;18997894859;Ne;0;2;0;2
2542;"Gilužis (Vydūno g. 11A)";Saulučių;7744997250;Ne;10;9;0;19
2543;"Gilužis (Vydūno g. 11A)";Saulučių;32730847948;Ne;4;0;0;4
2544;"Gilužis (Vydūno g. 11A)";Saulučių;3181765606;Ne;0;4;0;4
2545;"Gilužis (Vydūno g. 11A)";Saulučių;5905237803;Ne;0;4;1;5
2546;"Gilužis (Vydūno g. 11A)";Saulučių;79805583046;Ne;0;0;1;1
2547;"Gilužis (Vydūno g. 11A)";Saulučių;2872439079;Ne;0;1;1;2
2548;"Gilužis (Vydūno g. 11A)";Saulučių;35650138667;Ne;0;3;0;3
2549;"Gilužis (Vydūno g. 11A)";Saulučių;1453976300;Ne;0;6;0;6
2550;"Gilužis (Vydūno g. 11A)";Saulučių;1211233315;Ne;0;0;2;2
2551;"Gilužis (Vydūno g. 11A)";Saulučių;5621912516;Ne;0;1;0;1
2552;"Gilužis (Vydūno g. 11A)";Paukštelių;46597815116;Ne;0;1;0;1
2553;"Gilužis (Vydūno g. 11A)";Paukštelių;1146713023;Ne;0;3;0;3
2554;"Gilužis (Vydūno g. 11A)";Paukštelių;1980250599;Ne;0;4;4;8
2555;"Gilužis (Vydūno g. 11A)";Paukštelių;1962914764;Ne;0;1;10;11
2556;"Gilužis (Vydūno g. 11A)";Paukštelių;7636249706;Ne;0;0;1;1
2557;"Gilužis (Vydūno g. 11A)";Paukštelių;2508958685;Ne;0;2;12;14
2558;"Gilužis (Vydūno g. 11A)";Paukštelių;8875479631;Ne;5;8;0;13
2559;"Gilužis (Vydūno g. 11A)";Paukštelių;5759145600;Ne;0;21;0;21
2560;"Gilužis (Vydūno g. 11A)";Paukštelių;8662424856;Ne;0;4;0;4
2561;"Gilužis (Vydūno g. 11A)";Paukštelių;2436416327;Ne;0;3;3;6
2562;"Gilužis (Vydūno g. 11A)";Paukštelių;6218943275;Ne;0;1;0;1
2563;"Gilužis (Vydūno g. 11A)";Paukštelių;2754594238;Ne;0;2;1;3
2564;"Gilužis (Vydūno g. 11A)";Paukštelių;4297300799;Ne;5;4;5;14
2565;"Gilužis (Vydūno g. 11A)";Paukštelių;8531121002;Ne;1;3;2;6
2566;"Gilužis (Vydūno g. 11A)";Paukštelių;9314893329;Ne;2;0;0;2
2567;"Gilužis (Vydūno g. 11A)";Paukštelių;46276990963;Ne;4;1;0;5
2568;"Gilužis (Vydūno g. 11A)";Paukštelių;5303511810;Ne;11;4;0;15
2569;"Gilužis (Vydūno g. 11A)";Obuoliukų;8201769917;Ne;0;1;0;1
2570;"Gilužis (Vydūno g. 11A)";Obuoliukų;9892608223;Ne;0;10;0;10
2571;"Gilužis (Vydūno g. 11A)";Obuoliukų;4058698645;Ne;13;0;0;13
2572;"Gilužis (Vydūno g. 11A)";Obuoliukų;1540018160;Ne;14;0;0;14
2573;"Gilužis (Vydūno g. 11A)";Obuoliukų;7716908903;Ne;5;1;0;6
2574;"Gilužis (Vydūno g. 11A)";Obuoliukų;3131597174;Ne;21;0;0;21
2575;"Gilužis (Vydūno g. 11A)";Obuoliukų;6239369861;Ne;13;0;0;13
2576;"Gilužis (Vydūno g. 11A)";Obuoliukų;6172360933;Ne;10;2;0;12
2577;"Gilužis (Vydūno g. 11A)";Obuoliukų;7398446674;Ne;8;1;0;9
2578;"Gilužis (Vydūno g. 11A)";Obuoliukų;4592380105;Ne;20;1;0;21
2579;"Gilužis (Vydūno g. 11A)";Obuoliukų;4242362889;Ne;0;5;0;5
2580;"Gilužis (Vydūno g. 11A)";Obuoliukų;7560732216;Ne;0;5;0;5
2581;"Gilužis (Vydūno g. 11A)";Obuoliukų;5476140202;Ne;6;0;0;6
2582;"Gilužis (Vydūno g. 11A)";Obuoliukų;8194444043;Ne;10;0;0;10
2583;"Gilužis (Vydūno g. 11A)";Obuoliukų;7606394325;Ne;14;5;0;19
2584;"Gilužis (Vydūno g. 11A)";Obuoliukų;6737884137;Ne;4;10;0;14
2585;"Gilužis (Vydūno g. 11A)";Obuoliukų;6825745985;Ne;0;1;0;1
2586;"Gilužis (Vydūno g. 11A)";Obuoliukų;3458957423;Ne;6;0;0;6
2587;"Gilužis (Vydūno g. 11A)";Obuoliukų;8900414658;Ne;1;5;0;6
2588;"Gilužis (Vydūno g. 11A)";Obuoliukų;3219101391;Ne;16;1;0;17
2589;"Gilužis (Vydūno g. 11A)";Obuoliukų;4528131001;Ne;0;12;0;12
2590;"Gilužis (Vydūno g. 11A)";Obuoliukų;5895659747;Ne;0;17;0;17
2591;"Gilužis (Vydūno g. 11A)";KIŠKUČIŲ;5744027226;Ne;0;4;0;4
2592;"Gilužis (Vydūno g. 11A)";KIŠKUČIŲ;8639633038;Ne;14;0;0;14
2593;"Gilužis (Vydūno g. 11A)";KIŠKUČIŲ;5721924532;Ne;5;0;0;5
2594;"Gilužis (Vydūno g. 11A)";KIŠKUČIŲ;9484221435;Ne;0;0;1;1
2595;"Gilužis (Vydūno g. 11A)";KIŠKUČIŲ;6323747855;Ne;0;0;1;1
2596;"Gilužis (Vydūno g. 11A)";KIŠKUČIŲ;2680643896;Ne;0;7;0;7
2597;"Gilužis (Vydūno g. 11A)";KIŠKUČIŲ;5685074731;Ne;15;0;0;15
2598;"Gilužis (Vydūno g. 11A)";KIŠKUČIŲ;7632771776;Ne;3;0;0;3
2599;"Gilužis (Vydūno g. 11A)";KIŠKUČIŲ;7477282548;Ne;0;2;3;5
2600;"Gilužis (Vydūno g. 11A)";KIŠKUČIŲ;7560574633;Ne;12;0;0;12
2601;"Gilužis (Vydūno g. 11A)";KIŠKUČIŲ;4199633620;Ne;5;2;6;13
2602;"Gilužis (Vydūno g. 11A)";KIŠKUČIŲ;9851612698;Ne;14;3;0;17
2603;"Gilužis (Vydūno g. 11A)";KIŠKUČIŲ;1391410955;Ne;0;21;0;21
2604;"Gilužis (Vydūno g. 11A)";KIŠKUČIŲ;6383469680;Ne;18;2;0;20
2605;"Gilužis (Vydūno g. 11A)";KIŠKUČIŲ;8341597766;Ne;5;0;3;8
2606;"Gilužis (Vydūno g. 11A)";KIŠKUČIŲ;3171560628;Ne;11;0;0;11
2607;"Gilužis (Vydūno g. 11A)";KIŠKUČIŲ;4347319425;Ne;4;4;2;10
2608;"Gilužis (Vydūno g. 11A)";KIŠKUČIŲ;8591741716;Ne;3;3;2;8
2609;"Gilužis (Vydūno g. 11A)";KIŠKUČIŲ;8877445672;Ne;13;0;0;13
2610;"Gilužis (Vydūno g. 11A)";KIŠKUČIŲ;9489594782;Ne;0;6;0;6
2611;"Gilužis (Vydūno g. 11A)";Meškučių;7263432152;Ne;10;1;0;11
2612;"Gilužis (Vydūno g. 11A)";Meškučių;4655266106;Ne;5;2;0;7
2613;"Gilužis (Vydūno g. 11A)";Meškučių;3800593189;Ne;0;6;0;6
2614;"Gilužis (Vydūno g. 11A)";Meškučių;4174307847;Ne;7;0;0;7
2615;"Gilužis (Vydūno g. 11A)";Meškučių;8393554697;Ne;10;3;0;13
2616;"Gilužis (Vydūno g. 11A)";Meškučių;8301535013;Ne;6;0;0;6
2617;"Gilužis (Vydūno g. 11A)";Meškučių;2939982311;Ne;2;2;0;4
2618;"Gilužis (Vydūno g. 11A)";Meškučių;3365778697;Ne;7;3;0;10
2619;"Gilužis (Vydūno g. 11A)";Meškučių;7912093880;Taip;7;2;0;9
2620;"Gilužis (Vydūno g. 11A)";Meškučių;2389277783;Ne;0;6;3;9
2621;"Gilužis (Vydūno g. 11A)";Meškučių;2500949029;Ne;0;6;0;6
2622;"Gilužis (Vydūno g. 11A)";Meškučių;4741129495;Ne;9;3;0;12
2623;"Gilužis (Vydūno g. 11A)";Meškučių;7992750316;Ne;6;2;8;16
2624;"Gilužis (Vydūno g. 11A)";Meškučių;2577554894;Ne;3;3;0;6
2625;"Gilužis (Vydūno g. 11A)";Meškučių;3148477315;Ne;4;1;0;5
2626;"Gilužis (Vydūno g. 11A)";Meškučių;1068375927;Ne;16;0;0;16
2627;"Gilužis (Vydūno g. 11A)";Meškučių;8476240141;Ne;0;0;3;3
2628;"Gilužis (Vydūno g. 11A)";Meškučių;6185280967;Ne;9;1;0;10
2629;"Gilužis (Vydūno g. 11A)";Meškučių;5177805719;Ne;9;2;0;11
2630;"Gilužis (Vydūno g. 11A)";Meškučių;7045940267;Ne;0;1;0;1
2631;"Gilužis (Vydūno g. 11A)";Pagrandukai;6884146146;Ne;0;21;0;21
2632;"Gilužis (Vydūno g. 11A)";Pagrandukai;6920910054;Ne;5;16;0;21
2633;"Gilužis (Vydūno g. 11A)";Pagrandukai;5705945483;Ne;6;8;0;14
2634;"Gilužis (Vydūno g. 11A)";Pagrandukai;6501973647;Ne;10;0;0;10
2635;"Gilužis (Vydūno g. 11A)";Pagrandukai;5397975739;Ne;10;0;0;10
2636;"Gilužis (Vydūno g. 11A)";Pagrandukai;6109205159;Ne;8;0;0;8
2637;"Gilužis (Vydūno g. 11A)";Pagrandukai;2328338059;Ne;8;0;0;8
2638;"Gilužis (Vydūno g. 11A)";Pagrandukai;5376639182;Ne;0;1;0;1
2639;"Gilužis (Vydūno g. 11A)";Pagrandukai;5378701300;Ne;2;0;0;2
2640;"Gilužis (Vydūno g. 11A)";Pagrandukai;3366788027;Ne;2;0;0;2
2641;"Gilužis (Vydūno g. 11A)";Pagrandukai;9676661005;Ne;15;0;0;15
2642;"Gilužis (Vydūno g. 11A)";Pagrandukai;1306757860;Ne;7;2;0;9
2643;"Gilužis (Vydūno g. 11A)";Pagrandukai;2706629834;Ne;0;9;0;9
2644;"Gilužis (Vydūno g. 11A)";Pagrandukai;1604096952;Ne;5;1;0;6
2645;"Gilužis (Vydūno g. 11A)";Pagrandukai;5184511012;Ne;10;0;0;10
2646;"Gilužis (Vydūno g. 11A)";Pagrandukai;9587502317;Ne;10;0;0;10
2647;"Gilužis (Vydūno g. 11A)";Pagrandukai;4266998302;Ne;10;4;0;14
2648;"Gilužis (Vydūno g. 11A)";Pagrandukai;5334441484;Ne;3;0;0;3
2649;"Gilužis (Vydūno g. 11A)";Pagrandukai;6831107153;Ne;10;0;0;10
2650;"Gilužis (Vydūno g. 11A)";Pagrandukai;8852862161;Ne;10;0;0;10
2651;"Gilužis (Vydūno g. 11A)";Pagrandukai;2955779117;Ne;10;0;0;10
2652;"Gilužis (Vydūno g. 11A)";Boružėlių;5497242500;Ne;0;3;0;3
2653;"Gilužis (Vydūno g. 11A)";Boružėlių;2516315604;Ne;2;7;0;9
2654;"Gilužis (Vydūno g. 11A)";Boružėlių;9783700319;Ne;7;0;0;7
2655;"Gilužis (Vydūno g. 11A)";Boružėlių;5394693502;Ne;4;4;0;8
2656;"Gilužis (Vydūno g. 11A)";Boružėlių;4455977087;Ne;0;1;0;1
2657;"Gilužis (Vydūno g. 11A)";Boružėlių;4876074981;Ne;0;1;0;1
2658;"Gilužis (Vydūno g. 11A)";Boružėlių;2633680406;Ne;0;2;0;2
2659;"Gilužis (Vydūno g. 11A)";Boružėlių;2221786284;Ne;7;5;0;12
2660;"Gilužis (Vydūno g. 11A)";Boružėlių;3002266577;Ne;5;7;0;12
2661;"Gilužis (Vydūno g. 11A)";Boružėlių;5190752112;Ne;5;1;1;7
2662;"Gilužis (Vydūno g. 11A)";Boružėlių;2440762487;Ne;5;1;1;7
2663;"Gilužis (Vydūno g. 11A)";Boružėlių;4509741536;Ne;14;2;0;16
2664;"Gilužis (Vydūno g. 11A)";Boružėlių;9707968228;Ne;2;1;0;3
2665;"Gilužis (Vydūno g. 11A)";Boružėlių;8628253655;Ne;10;1;0;11
2666;"Gilužis (Vydūno g. 11A)";Boružėlių;9104005195;Ne;8;0;0;8
2667;"Gilužis (Vydūno g. 11A)";Boružėlių;5581417252;Ne;0;21;0;21
2668;"Gilužis (Vydūno g. 11A)";Boružėlių;4475698906;Ne;4;0;0;4
2669;"Gilužis (Vydūno g. 11A)";Boružėlių;1085130813;Ne;0;4;0;4
2670;"Gilužis (Vydūno g. 11A)";Boružėlių;2615087717;Ne;5;0;0;5
2671;"Gintarėlis (Didlaukio g. 35)";PAPŪGĖLĖS;8498936096;Ne;3;1;0;4
2672;"Gintarėlis (Didlaukio g. 35)";PAPŪGĖLĖS;8913652291;Ne;3;0;10;13
2673;"Gintarėlis (Didlaukio g. 35)";PAPŪGĖLĖS;2485750596;Ne;0;3;1;4
2674;"Gintarėlis (Didlaukio g. 35)";PAPŪGĖLĖS;1033624080;Ne;0;2;0;2
2675;"Gintarėlis (Didlaukio g. 35)";PAPŪGĖLĖS;2919700367;Ne;0;2;2;4
2676;"Gintarėlis (Didlaukio g. 35)";PAPŪGĖLĖS;1768789948;Ne;4;0;0;4
2677;"Gintarėlis (Didlaukio g. 35)";PAPŪGĖLĖS;2595566032;Ne;0;7;0;7
2678;"Gintarėlis (Didlaukio g. 35)";PAPŪGĖLĖS;9141438560;Ne;0;7;0;7
2679;"Gintarėlis (Didlaukio g. 35)";PAPŪGĖLĖS;9494521554;Ne;0;13;0;13
2680;"Gintarėlis (Didlaukio g. 35)";PAPŪGĖLĖS;7494884360;Ne;0;4;0;4
2681;"Gintarėlis (Didlaukio g. 35)";PAPŪGĖLĖS;7147842224;Ne;0;3;0;3
2682;"Gintarėlis (Didlaukio g. 35)";PAPŪGĖLĖS;5783939567;Ne;0;5;0;5
2683;"Gintarėlis (Didlaukio g. 35)";PAPŪGĖLĖS;7674351459;Ne;0;4;0;4
2684;"Gintarėlis (Didlaukio g. 35)";PAPŪGĖLĖS;6292664833;Ne;0;0;4;4
2685;"Gintarėlis (Didlaukio g. 35)";PAPŪGĖLĖS;8610886062;Ne;0;4;0;4
2686;"Gintarėlis (Didlaukio g. 35)";PAPŪGĖLĖS;5811396263;Ne;0;2;0;2
2687;"Gintarėlis (Didlaukio g. 35)";PAPŪGĖLĖS;1648843117;Ne;0;2;2;4
2688;"Gintarėlis (Didlaukio g. 35)";PAPŪGĖLĖS;1861324153;Ne;0;4;0;4
2689;"Gintarėlis (Didlaukio g. 35)";PAPŪGĖLĖS;3457974670;Ne;20;2;0;22
2690;"Gintarėlis (Didlaukio g. 35)";PAPŪGĖLĖS;1511718436;Ne;0;2;4;6
2691;"Gintarėlis (Didlaukio g. 35)";PAPŪGĖLĖS;4484711857;Ne;0;4;1;5
2692;"Gintarėlis (Didlaukio g. 35)";PAPŪGĖLĖS;6080108998;Ne;0;2;2;4
2693;"Gintarėlis (Didlaukio g. 35)";PAPŪGĖLĖS;6655645997;Ne;0;2;0;2
2694;"Gintarėlis (Didlaukio g. 35)";SPINDULIUKAI;3600181974;Ne;0;1;0;1
2695;"Gintarėlis (Didlaukio g. 35)";SPINDULIUKAI;6091264509;Ne;0;6;0;6
2696;"Gintarėlis (Didlaukio g. 35)";SPINDULIUKAI;56124970238;Ne;0;5;0;5
2697;"Gintarėlis (Didlaukio g. 35)";SPINDULIUKAI;4902086873;Ne;1;0;1;2
2698;"Gintarėlis (Didlaukio g. 35)";SPINDULIUKAI;22394648690;Ne;0;5;0;5
2699;"Gintarėlis (Didlaukio g. 35)";SPINDULIUKAI;34606130829;Ne;0;4;0;4
2700;"Gintarėlis (Didlaukio g. 35)";SPINDULIUKAI;21658913551;Ne;0;3;0;3
2701;"Gintarėlis (Didlaukio g. 35)";SPINDULIUKAI;8405210216;Ne;0;2;0;2
2702;"Gintarėlis (Didlaukio g. 35)";SPINDULIUKAI;18715625324;Ne;0;12;0;12
2703;"Gintarėlis (Didlaukio g. 35)";SPINDULIUKAI;2721386855;Ne;0;10;0;10
2704;"Gintarėlis (Didlaukio g. 35)";SPINDULIUKAI;2914156353;Ne;0;4;9;13
2705;"Gintarėlis (Didlaukio g. 35)";SPINDULIUKAI;4612041848;Ne;0;0;3;3
2706;"Gintarėlis (Didlaukio g. 35)";SPINDULIUKAI;5916948150;Ne;0;6;0;6
2707;"Gintarėlis (Didlaukio g. 35)";SPINDULIUKAI;45480802894;Ne;0;6;0;6
2708;"Gintarėlis (Didlaukio g. 35)";SPINDULIUKAI;3978892232;Ne;0;1;0;1
2709;"Gintarėlis (Didlaukio g. 35)";SPINDULIUKAI;1770479969;Ne;0;1;0;1
2710;"Gintarėlis (Didlaukio g. 35)";SPINDULIUKAI;1441282039;Ne;0;3;4;7
2711;"Gintarėlis (Didlaukio g. 35)";SPINDULIUKAI;8206947475;Ne;0;0;1;1
2712;"Gintarėlis (Didlaukio g. 35)";SPINDULIUKAI;9539570835;Ne;0;9;0;9
2713;"Gintarėlis (Didlaukio g. 35)";SPINDULIUKAI;7878911379;Ne;0;2;0;2
2714;"Gintarėlis (Didlaukio g. 35)";LAŠIUKAI;6142819210;Ne;0;6;0;6
2715;"Gintarėlis (Didlaukio g. 35)";LAŠIUKAI;7971810025;Ne;7;0;0;7
2716;"Gintarėlis (Didlaukio g. 35)";LAŠIUKAI;28704617970;Ne;0;5;0;5
2717;"Gintarėlis (Didlaukio g. 35)";LAŠIUKAI;5577759167;Ne;0;3;1;4
2718;"Gintarėlis (Didlaukio g. 35)";LAŠIUKAI;8247701603;Ne;0;1;0;1
2719;"Gintarėlis (Didlaukio g. 35)";LAŠIUKAI;4498326942;Ne;0;6;1;7
2720;"Gintarėlis (Didlaukio g. 35)";LAŠIUKAI;4641943773;Ne;0;16;0;16
2721;"Gintarėlis (Didlaukio g. 35)";LAŠIUKAI;6288086420;Ne;0;0;1;1
2722;"Gintarėlis (Didlaukio g. 35)";LAŠIUKAI;1655837441;Ne;0;4;3;7
2723;"Gintarėlis (Didlaukio g. 35)";LAŠIUKAI;1690400583;Ne;5;6;2;13
2724;"Gintarėlis (Didlaukio g. 35)";LAŠIUKAI;8186804032;Ne;5;3;0;8
2725;"Gintarėlis (Didlaukio g. 35)";LAŠIUKAI;5434952733;Ne;0;6;2;8
2726;"Gintarėlis (Didlaukio g. 35)";LAŠIUKAI;5018151097;Ne;10;4;0;14
2727;"Gintarėlis (Didlaukio g. 35)";LAŠIUKAI;9230924100;Ne;0;1;1;2
2728;"Gintarėlis (Didlaukio g. 35)";LAŠIUKAI;4333780287;Ne;0;8;0;8
2729;"Gintarėlis (Didlaukio g. 35)";LAŠIUKAI;7286562743;Ne;5;5;0;10
2730;"Gintarėlis (Didlaukio g. 35)";LAŠIUKAI;8000297636;Ne;6;2;1;9
2731;"Gintarėlis (Didlaukio g. 35)";LAŠIUKAI;3359584322;Ne;0;2;1;3
2732;"Gintarėlis (Didlaukio g. 35)";LAŠIUKAI;3820683506;Ne;5;2;0;7
2733;"Gintarėlis (Didlaukio g. 35)";MEŠKUČIAI;2926488239;Ne;3;9;0;12
2734;"Gintarėlis (Didlaukio g. 35)";MEŠKUČIAI;6618240550;Ne;5;4;0;9
2735;"Gintarėlis (Didlaukio g. 35)";MEŠKUČIAI;8790078624;Ne;8;0;0;8
2736;"Gintarėlis (Didlaukio g. 35)";MEŠKUČIAI;2518840573;Ne;5;0;0;5
2737;"Gintarėlis (Didlaukio g. 35)";MEŠKUČIAI;5187894822;Ne;0;6;0;6
2738;"Gintarėlis (Didlaukio g. 35)";MEŠKUČIAI;3630567294;Ne;10;2;0;12
2739;"Gintarėlis (Didlaukio g. 35)";MEŠKUČIAI;5181872438;Ne;5;7;0;12
2740;"Gintarėlis (Didlaukio g. 35)";MEŠKUČIAI;1565802953;Ne;0;21;0;21
2741;"Gintarėlis (Didlaukio g. 35)";MEŠKUČIAI;2072435242;Ne;21;0;0;21
2742;"Gintarėlis (Didlaukio g. 35)";MEŠKUČIAI;7989239799;Ne;0;4;0;4
2743;"Gintarėlis (Didlaukio g. 35)";MEŠKUČIAI;4356211536;Ne;4;0;0;4
2744;"Gintarėlis (Didlaukio g. 35)";MEŠKUČIAI;1502740714;Ne;10;4;0;14
2745;"Gintarėlis (Didlaukio g. 35)";MEŠKUČIAI;6636835034;Ne;0;6;0;6
2746;"Gintarėlis (Didlaukio g. 35)";MEŠKUČIAI;3830154353;Ne;9;0;0;9
2747;"Gintarėlis (Didlaukio g. 35)";MEŠKUČIAI;3947405446;Ne;15;0;0;15
2748;"Gintarėlis (Didlaukio g. 35)";MEŠKUČIAI;7948438165;Ne;0;9;0;9
2749;"Gintarėlis (Didlaukio g. 35)";MEŠKUČIAI;4642142931;Ne;10;1;0;11
2750;"Gintarėlis (Didlaukio g. 35)";MEŠKUČIAI;6711753930;Ne;0;1;0;1
2751;"Gintarėlis (Didlaukio g. 35)";MEŠKUČIAI;9017592249;Ne;7;2;0;9
2752;"Gintarėlis (Didlaukio g. 35)";MEŠKUČIAI;8375475174;Ne;0;16;0;16
2753;"Gintarėlis (Didlaukio g. 35)";MEŠKUČIAI;7029401386;Ne;9;0;0;9
2754;"Gintarėlis (Didlaukio g. 35)";MEŠKUČIAI;1790629500;Ne;4;0;0;4
2755;"Gintarėlis (Didlaukio g. 35)";MEŠKUČIAI;7320085613;Ne;0;6;0;6
2756;"Gintarėlis (Didlaukio g. 35)";DRUGELIAI;9737200226;Ne;0;6;4;10
2757;"Gintarėlis (Didlaukio g. 35)";DRUGELIAI;6655809299;Ne;0;1;2;3
2758;"Gintarėlis (Didlaukio g. 35)";DRUGELIAI;2614258442;Ne;4;6;0;10
2759;"Gintarėlis (Didlaukio g. 35)";DRUGELIAI;4217329880;Ne;0;5;0;5
2760;"Gintarėlis (Didlaukio g. 35)";DRUGELIAI;7571352126;Ne;0;4;0;4
2761;"Gintarėlis (Didlaukio g. 35)";DRUGELIAI;7449437199;Ne;0;5;0;5
2762;"Gintarėlis (Didlaukio g. 35)";DRUGELIAI;2016067859;Ne;0;10;0;10
2763;"Gintarėlis (Didlaukio g. 35)";DRUGELIAI;9579497944;Ne;3;4;0;7
2764;"Gintarėlis (Didlaukio g. 35)";DRUGELIAI;3341850450;Ne;0;0;2;2
2765;"Gintarėlis (Didlaukio g. 35)";DRUGELIAI;1759218238;Ne;2;2;0;4
2766;"Gintarėlis (Didlaukio g. 35)";DRUGELIAI;1248017244;Ne;5;4;0;9
2767;"Gintarėlis (Didlaukio g. 35)";DRUGELIAI;2792618575;Ne;0;6;0;6
2768;"Gintarėlis (Didlaukio g. 35)";DRUGELIAI;8171192401;Ne;2;4;0;6
2769;"Gintarėlis (Didlaukio g. 35)";DRUGELIAI;7694587246;Ne;2;0;0;2
2770;"Gintarėlis (Didlaukio g. 35)";DRUGELIAI;4904966263;Ne;0;3;0;3
2771;"Gintarėlis (Didlaukio g. 35)";KAČIUKAI;5569843168;Ne;6;5;0;11
2772;"Gintarėlis (Didlaukio g. 35)";KAČIUKAI;3665764153;Ne;5;4;2;11
2773;"Gintarėlis (Didlaukio g. 35)";KAČIUKAI;9774056578;Ne;5;4;2;11
2774;"Gintarėlis (Didlaukio g. 35)";KAČIUKAI;2212296954;Ne;2;0;3;5
2775;"Gintarėlis (Didlaukio g. 35)";KAČIUKAI;3825700024;Ne;0;1;0;1
2776;"Gintarėlis (Didlaukio g. 35)";KAČIUKAI;7057877483;Ne;0;1;0;1
2777;"Gintarėlis (Didlaukio g. 35)";KAČIUKAI;9825811100;Ne;2;0;2;4
2778;"Gintarėlis (Didlaukio g. 35)";KAČIUKAI;7875981690;Ne;0;11;0;11
2779;"Gintarėlis (Didlaukio g. 35)";KAČIUKAI;2544338275;Ne;0;11;0;11
2780;"Gintarėlis (Didlaukio g. 35)";KAČIUKAI;9963329170;Taip;5;0;0;5
2781;"Gintarėlis (Didlaukio g. 35)";KAČIUKAI;5214984111;Ne;0;1;0;1
2782;"Gintarėlis (Didlaukio g. 35)";KAČIUKAI;1011749698;Ne;5;6;4;15
2783;"Gintarėlis (Didlaukio g. 35)";KAČIUKAI;8261770154;Ne;0;12;0;12
2784;"Gintarėlis (Didlaukio g. 35)";KAČIUKAI;7061545258;Ne;0;6;4;10
2785;"Gintarėlis (Didlaukio g. 35)";KAČIUKAI;5436695400;Ne;0;5;0;5
2786;"Gintarėlis (Didlaukio g. 35)";KAČIUKAI;5921751507;Ne;0;1;0;1
2787;"Gintarėlis (Didlaukio g. 35)";KAČIUKAI;9450900915;Ne;7;0;0;7
2788;"Gintarėlis (Didlaukio g. 35)";KAČIUKAI;5153948767;Ne;0;6;0;6
2789;"Gintarėlis (Didlaukio g. 35)";KAČIUKAI;3814485627;Ne;0;5;0;5
2790;"Gintarėlis (Didlaukio g. 35)";KAČIUKAI;1571260478;Ne;0;6;0;6
2791;"Gintarėlis (Didlaukio g. 35)";KAČIUKAI;9244715396;Ne;0;7;1;8
2792;"Gintarėlis (Didlaukio g. 35)";KAČIUKAI;3015327416;Ne;0;3;0;3
2793;"Gintarėlis (Didlaukio g. 35)";KIŠKUČIAI;9279399214;Ne;0;1;0;1
2794;"Gintarėlis (Didlaukio g. 35)";KIŠKUČIAI;3921015919;Ne;0;1;0;1
2795;"Gintarėlis (Didlaukio g. 35)";KIŠKUČIAI;2814569415;Ne;0;2;4;6
2796;"Gintarėlis (Didlaukio g. 35)";KIŠKUČIAI;7143014339;Ne;5;1;0;6
2797;"Gintarėlis (Didlaukio g. 35)";KIŠKUČIAI;9915887420;Ne;0;1;0;1
2798;"Gintarėlis (Didlaukio g. 35)";KIŠKUČIAI;8287685690;Ne;0;6;0;6
2799;"Gintarėlis (Didlaukio g. 35)";KIŠKUČIAI;7815317644;Ne;0;1;0;1
2800;"Gintarėlis (Didlaukio g. 35)";KIŠKUČIAI;2165332442;Ne;0;1;0;1
2801;"Gintarėlis (Didlaukio g. 35)";KIŠKUČIAI;6914904213;Ne;0;1;0;1
2802;"Gintarėlis (Didlaukio g. 35)";KIŠKUČIAI;1696337909;Ne;0;1;0;1
2803;"Gintarėlis (Didlaukio g. 35)";KIŠKUČIAI;6862629244;Ne;0;5;0;5
2804;"Gintarėlis (Didlaukio g. 35)";KIŠKUČIAI;1918879534;Ne;11;0;0;11
2805;"Gintarėlis (Didlaukio g. 35)";KIŠKUČIAI;7509100750;Ne;0;12;0;12
2806;"Gintarėlis (Didlaukio g. 35)";KIŠKUČIAI;6239242631;Ne;7;0;0;7
2807;"Gintarėlis (Didlaukio g. 35)";KIŠKUČIAI;5965570522;Ne;0;2;0;2
2808;"Gintarėlis (Didlaukio g. 35)";KIŠKUČIAI;4623909811;Ne;0;2;0;2
2809;"Gintarėlis (Didlaukio g. 35)";KIŠKUČIAI;3357866319;Ne;0;5;0;5
2810;"Gintarėlis (Didlaukio g. 35)";KIŠKUČIAI;8116557698;Taip;0;2;0;2
2811;"Gintarėlis (Didlaukio g. 35)";KIŠKUČIAI;8704248985;Ne;10;6;0;16
2812;"Gintarėlis (Didlaukio g. 35)";KIŠKUČIAI;5355691986;Ne;0;4;0;4
2813;"Gintarėlis (Didlaukio g. 35)";KIŠKUČIAI;5919205817;Ne;0;6;0;6
2814;"Gintarėlis (Didlaukio g. 35)";VYTURIUKAI;8768094601;Ne;5;0;0;5
2815;"Gintarėlis (Didlaukio g. 35)";VYTURIUKAI;5834772263;Ne;5;2;0;7
2816;"Gintarėlis (Didlaukio g. 35)";VYTURIUKAI;9533972547;Ne;0;0;19;19
2817;"Gintarėlis (Didlaukio g. 35)";BORUŽĖLĖS;7372735642;Ne;0;6;1;7
2818;"Gintarėlis (Didlaukio g. 35)";BORUŽĖLĖS;6402043654;Ne;3;4;1;8
2819;"Gintarėlis (Didlaukio g. 35)";BORUŽĖLĖS;6558614008;Ne;7;3;0;10
2820;"Gintarėlis (Didlaukio g. 35)";BORUŽĖLĖS;4348245746;Ne;0;2;0;2
2821;"Gintarėlis (Didlaukio g. 35)";BORUŽĖLĖS;3091731769;Ne;9;1;0;10
2822;"Gintarėlis (Didlaukio g. 35)";BORUŽĖLĖS;6484966941;Ne;0;6;0;6
2823;"Gintarėlis (Didlaukio g. 35)";BORUŽĖLĖS;9004590065;Ne;0;2;3;5
2824;"Gintarėlis (Didlaukio g. 35)";BORUŽĖLĖS;2624469768;Ne;2;0;0;2
2825;"Gintarėlis (Didlaukio g. 35)";BORUŽĖLĖS;8784796186;Ne;0;6;1;7
2826;"Gintarėlis (Didlaukio g. 35)";BORUŽĖLĖS;8516817506;Ne;0;7;0;7
2827;"Gintarėlis (Didlaukio g. 35)";BORUŽĖLĖS;3235154374;Ne;0;21;0;21
2828;"Gintarėlis (Didlaukio g. 35)";BORUŽĖLĖS;7059730814;Ne;12;0;0;12
2829;"Gintarėlis (Didlaukio g. 35)";BORUŽĖLĖS;9179216093;Ne;0;4;0;4
2830;"Gintarėlis (Didlaukio g. 35)";BORUŽĖLĖS;9970786396;Ne;0;6;0;6
2831;"Gintarėlis (Didlaukio g. 35)";BORUŽĖLĖS;9622824643;Ne;18;0;0;18
2832;"Gintarėlis (Didlaukio g. 35)";BORUŽĖLĖS;9476258741;Ne;2;1;0;3
2833;"Gintarėlis (Didlaukio g. 35)";BORUŽĖLĖS;1400817076;Ne;4;5;0;9
2834;"Gintarėlis (Didlaukio g. 35)";BORUŽĖLĖS;1371258551;Ne;9;1;0;10
2835;"Gintarėlis (Didlaukio g. 35)";BORUŽĖLĖS;4334349824;Ne;0;2;1;3
2836;"Gintarėlis (Didlaukio g. 35)";BORUŽĖLĖS;8410642485;Ne;14;0;0;14
2837;"Gintarėlis (Didlaukio g. 35)";BORUŽĖLĖS;9501012756;Ne;15;6;0;21
2838;"Gintarėlis (Didlaukio g. 35)";EŽIUKAI;4487346983;Ne;0;4;0;4
2839;"Gintarėlis (Didlaukio g. 35)";EŽIUKAI;2263102527;Ne;3;5;1;9
2840;"Gintarėlis (Didlaukio g. 35)";EŽIUKAI;7919771693;Ne;0;1;0;1
2841;"Gintarėlis (Didlaukio g. 35)";EŽIUKAI;8055928882;Ne;0;1;0;1
2842;"Gintarėlis (Didlaukio g. 35)";EŽIUKAI;5024727902;Ne;0;4;0;4
2843;"Gintarėlis (Didlaukio g. 35)";EŽIUKAI;2088008759;Ne;5;1;0;6
2844;"Gintarėlis (Didlaukio g. 35)";EŽIUKAI;3799412062;Ne;0;5;0;5
2845;"Gintarėlis (Didlaukio g. 35)";EŽIUKAI;6457288028;Ne;0;5;0;5
2846;"Gintarėlis (Didlaukio g. 35)";EŽIUKAI;4660854883;Ne;0;2;0;2
2847;"Gintarėlis (Didlaukio g. 35)";EŽIUKAI;94354056029;Ne;5;8;0;13
2848;"Gintarėlis (Didlaukio g. 35)";EŽIUKAI;1002155392;Ne;0;2;0;2
2849;"Gintarėlis (Didlaukio g. 35)";EŽIUKAI;9130659549;Ne;0;2;0;2
2850;"Gintarėlis (Didlaukio g. 35)";EŽIUKAI;2036488789;Ne;0;1;0;1
2851;"Gintarėlis (Didlaukio g. 35)";EŽIUKAI;7644607132;Ne;0;4;0;4
2852;"Gintarėlis (Didlaukio g. 35)";EŽIUKAI;78359050717;Ne;0;4;5;9
2853;"Gintarėlis (Didlaukio g. 35)";EŽIUKAI;7192722296;Ne;0;1;0;1
2854;"Gintarėlis (Didlaukio g. 35)";EŽIUKAI;2970527490;Ne;0;3;0;3
2855;"Gintarėlis (Didlaukio g. 35)";EŽIUKAI;1028456578;Ne;0;0;2;2
2856;"Gintarėlis (Didlaukio g. 35)";EŽIUKAI;1066741732;Ne;0;2;4;6
2857;"Gintarėlis (Didlaukio g. 35)";EŽIUKAI;1778573935;Ne;0;4;0;4
2858;"Gintarėlis (Didlaukio g. 35)";EŽIUKAI;9917367735;Ne;6;0;0;6
2859;"Gintarėlis (Didlaukio g. 35)";EŽIUKAI;4514340634;Ne;4;0;0;4
2860;"Gintarėlis (Didlaukio g. 35)";VIŠČIUKAI;1981825456;Ne;0;2;0;2
2861;"Gintarėlis (Didlaukio g. 35)";VIŠČIUKAI;3973889495;Ne;5;0;0;5
2862;"Gintarėlis (Didlaukio g. 35)";VIŠČIUKAI;4749559606;Ne;7;2;0;9
2863;"Gintarėlis (Didlaukio g. 35)";VIŠČIUKAI;4458703839;Ne;3;1;0;4
2864;"Gintarėlis (Didlaukio g. 35)";VIŠČIUKAI;2178808286;Ne;0;18;0;18
2865;"Gintarėlis (Didlaukio g. 35)";VIŠČIUKAI;9073499040;Ne;7;6;0;13
2866;"Gintarėlis (Didlaukio g. 35)";VIŠČIUKAI;6547060300;Ne;0;5;0;5
2867;"Gintarėlis (Didlaukio g. 35)";VIŠČIUKAI;5930354746;Ne;0;4;0;4
2868;"Gintarėlis (Didlaukio g. 35)";VIŠČIUKAI;4535071342;Ne;0;1;0;1
2869;"Gintarėlis (Didlaukio g. 35)";VIŠČIUKAI;8448725884;Ne;0;1;0;1
2870;"Gintarėlis (Didlaukio g. 35)";VIŠČIUKAI;6251670953;Ne;2;14;0;16
2871;"Gintarėlis (Didlaukio g. 35)";VIŠČIUKAI;8805356168;Ne;0;9;0;9
2872;"Gintarėlis (Didlaukio g. 35)";VIŠČIUKAI;4751066825;Ne;0;2;1;3
2873;"Gintarėlis (Didlaukio g. 35)";VIŠČIUKAI;1039098192;Ne;0;6;8;14
2874;"Gintarėlis (Didlaukio g. 35)";VIŠČIUKAI;6042885133;Ne;21;1;0;22
2875;"Gintarėlis (Didlaukio g. 35)";VIŠČIUKAI;7562170082;Ne;0;19;0;19
2876;"Gintarėlis (Didlaukio g. 35)";VIŠČIUKAI;1367305617;Ne;9;0;0;9
2877;"Gintarėlis (Didlaukio g. 35)";VIŠČIUKAI;6711773127;Ne;0;14;0;14
2878;"Gintarėlis (Didlaukio g. 35)";VIŠČIUKAI;7537009709;Ne;3;2;1;6
2879;"Gintarėlis (Didlaukio g. 35)";VIŠČIUKAI;9191264261;Ne;3;0;1;4
2880;"Gintarėlis (Didlaukio g. 35)";VIŠČIUKAI;2920734274;Ne;0;0;2;2
2881;"Gintarėlis (Didlaukio g. 35)";VIŠČIUKAI;3232990779;Ne;5;4;0;9
2882;"Gintarėlis (Didlaukio g. 35)";"SAULĖS ZUIKUČIAI";4278770021;Ne;0;4;0;4
2883;"Gintarėlis (Didlaukio g. 35)";"SAULĖS ZUIKUČIAI";9915228593;Ne;0;1;0;1
2884;"Gintarėlis (Didlaukio g. 35)";"SAULĖS ZUIKUČIAI";2499727321;Ne;13;4;0;17
2885;"Gintarėlis (Didlaukio g. 35)";"SAULĖS ZUIKUČIAI";2949035147;Ne;6;0;0;6
2886;"Gintarėlis (Didlaukio g. 35)";"SAULĖS ZUIKUČIAI";3839660368;Ne;0;5;3;8
2887;"Gintarėlis (Didlaukio g. 35)";"SAULĖS ZUIKUČIAI";6563281778;Ne;0;8;1;9
2888;"Gintarėlis (Didlaukio g. 35)";"SAULĖS ZUIKUČIAI";6133476137;Ne;5;0;0;5
2889;"Gintarėlis (Didlaukio g. 35)";"SAULĖS ZUIKUČIAI";6751822184;Ne;5;4;0;9
2890;"Gintarėlis (Didlaukio g. 35)";"SAULĖS ZUIKUČIAI";8721340357;Ne;4;0;5;9
2891;"Gintarėlis (Didlaukio g. 35)";"SAULĖS ZUIKUČIAI";3876016666;Ne;11;0;2;13
2892;"Gintarėlis (Didlaukio g. 35)";"SAULĖS ZUIKUČIAI";8403881160;Ne;16;4;0;20
2893;"Gintarėlis (Didlaukio g. 35)";"SAULĖS ZUIKUČIAI";4087751760;Ne;5;0;0;5
2894;"Gintarėlis (Didlaukio g. 35)";"SAULĖS ZUIKUČIAI";4462515146;Ne;9;0;0;9
2895;"Gintarėlis (Didlaukio g. 35)";"SAULĖS ZUIKUČIAI";6138593853;Ne;9;0;0;9
2896;"Gintarėlis (Didlaukio g. 35)";"SAULĖS ZUIKUČIAI";5338409090;Ne;0;1;0;1
2897;"Gintarėlis (Didlaukio g. 35)";"SAULĖS ZUIKUČIAI";7004430575;Ne;2;1;0;3
2898;"Gintarėlis (Didlaukio g. 35)";"SAULĖS ZUIKUČIAI";5509394003;Ne;16;0;0;16
2899;"Gintarėlis (Didlaukio g. 35)";"SAULĖS ZUIKUČIAI";1482227839;Ne;10;1;0;11
2900;"Gintarėlis (Didlaukio g. 35)";Pabiručiai;8286814809;Ne;0;6;0;6
2901;"Gintarėlis (Didlaukio g. 35)";Pabiručiai;4757160835;Ne;0;0;2;2
2902;"Gintarėlis (Didlaukio g. 35)";Pabiručiai;1158055621;Ne;0;1;0;1
2903;"Gintarėlis (Didlaukio g. 35)";Pabiručiai;1474802737;Ne;0;6;1;7
2904;"Gintarėlis (Didlaukio g. 35)";Pabiručiai;6578588403;Ne;2;5;0;7
2905;"Gintarėlis (Didlaukio g. 35)";Šypsenėlės;3575375401;Taip;0;0;13;13
2906;"Gintarėlis (Didlaukio g. 35)";Šypsenėlės;3575375401;Taip;0;0;13;13
2907;"Gintarėlis (Didlaukio g. 35)";Šypsenėlės;3575375401;Taip;0;0;13;13
2908;"Gintarėlis (Didlaukio g. 35)";Šypsenėlės;9020619501;Ne;0;2;0;2
2909;"Gintarėlis (Didlaukio g. 35)";Šypsenėlės;2904118045;Ne;13;0;3;16
2910;"Gintarėlis (Didlaukio g. 35)";Šypsenėlės;5120761293;Ne;0;4;0;4
2911;"Gintarėlis (Didlaukio g. 35)";Šypsenėlės;9413836091;Ne;0;2;0;2
2912;"Gintarėlis (Didlaukio g. 35)";Šypsenėlės;7337543180;Ne;3;0;0;3
2913;"Gintarėlis (Didlaukio g. 35)";Šypsenėlės;7337543180;Ne;3;0;0;3
2914;"Gintarėlis (Didlaukio g. 35)";Šypsenėlės;7337543180;Ne;3;0;0;3
2915;"Gintarėlis (Didlaukio g. 35)";Šypsenėlės;1567290856;Ne;0;0;5;5
2916;"Gintarėlis (Didlaukio g. 35)";Šypsenėlės;7661638176;Ne;0;2;0;2
2917;"Gintarėlis (Didlaukio g. 35)";Šypsenėlės;9477018713;Ne;5;1;0;6
2918;"Gintarėlis (Didlaukio g. 35)";Šypsenėlės;9477018713;Ne;5;1;0;6
2919;"Gintarėlis (Didlaukio g. 35)";Šypsenėlės;9477018713;Ne;5;1;0;6
2920;"Gintarėlis (Didlaukio g. 35)";Šypsenėlės;3088663209;Ne;0;6;0;6
2921;"Gintarėlis (Didlaukio g. 35)";Šypsenėlės;3794027499;Ne;9;4;0;13
2922;"Gintarėlis (Didlaukio g. 35)";Šypsenėlės;7813187438;Ne;0;2;1;3
2923;"Gintarėlis (Didlaukio g. 35)";Šypsenėlės;9234476307;Ne;2;0;0;2
2924;"Gintarėlis (Didlaukio g. 35)";Šypsenėlės;6561070982;Ne;0;4;0;4
2925;"Gintarėlis (Didlaukio g. 35)";Šypsenėlės;2203238888;Ne;3;4;0;7
2926;"Gintarėlis (Didlaukio g. 35)";Šypsenėlės;3484172382;Ne;8;0;0;8
2927;"Gintarėlis (Didlaukio g. 35)";Šypsenėlės;2256002308;Ne;0;2;0;2
2928;"Gintarėlis (Didlaukio g. 35)";Šypsenėlės;6607854244;Ne;0;2;2;4
2929;"Gintarėlis (Didlaukio g. 35)";Šypsenėlės;1327681704;Ne;0;1;0;1
2930;"Gintarėlis (Didlaukio g. 35)";Šypsenėlės;7123016029;Ne;0;2;2;4
2931;"Gintarėlis (Didlaukio g. 35)";Šypsenėlės;3000371147;Ne;0;6;0;6
2932;"Gintarėlis (Didlaukio g. 35)";Šypsenėlės;5717123412;Ne;0;2;0;2
2933;"Gintarėlis (Didlaukio g. 35)";Šypsenėlės;1480486900;Ne;8;2;1;11
2934;"Gintarėlis (Didlaukio g. 35)";Šypsenėlės;3459439843;Ne;2;5;0;7
2935;"Gintarėlis (Didlaukio g. 35)";Smalsučiai;7486822380;Ne;0;2;4;6
2936;"Gintarėlis (Didlaukio g. 35)";Smalsučiai;7377510928;Ne;4;0;0;4
2937;"Gintarėlis (Didlaukio g. 35)";Smalsučiai;8387819754;Ne;0;6;0;6
2938;"Gintarėlis (Didlaukio g. 35)";Smalsučiai;1875958358;Ne;4;6;0;10
2939;"Gintarėlis (Didlaukio g. 35)";Smalsučiai;8292698645;Ne;0;4;1;5
2940;"Gintarėlis (Didlaukio g. 35)";Smalsučiai;5748677965;Ne;8;0;0;8
2941;"Gintarėlis (Didlaukio g. 35)";Smalsučiai;1876292168;Ne;3;7;0;10
2942;"Gintarėlis (Didlaukio g. 35)";Smalsučiai;9980747501;Ne;2;0;0;2
2943;"Gintarėlis (Didlaukio g. 35)";Smalsučiai;8754068506;Ne;0;2;0;2
2944;"Gintarėlis (Didlaukio g. 35)";Smalsučiai;7690748176;Ne;5;1;0;6
2945;"Gintarėlis (Didlaukio g. 35)";Smalsučiai;8355089218;Ne;0;2;1;3
2946;"Gintarėlis (Didlaukio g. 35)";Kodėlčiukai;1537528341;Ne;10;0;0;10
2947;"Gintarėlis (Didlaukio g. 35)";Kodėlčiukai;7976989629;Ne;9;0;0;9
2948;"Gintarėlis (Didlaukio g. 35)";Kodėlčiukai;3444997417;Ne;0;1;0;1
2949;"Gintarėlis (Didlaukio g. 35)";Kodėlčiukai;8982034601;Ne;0;3;0;3
2950;"Gintarėlis (Didlaukio g. 35)";Kodėlčiukai;6545866812;Ne;0;2;1;3
2951;"Gintarėlis (Didlaukio g. 35)";Kodėlčiukai;5824210469;Ne;11;0;0;11
2952;"Gintarėlis (Didlaukio g. 35)";Kodėlčiukai;5202442681;Ne;0;1;0;1
2953;"Gintarėlis (Didlaukio g. 35)";Gintariukai;5103780852;Ne;0;0;3;3
2954;"Gintarėlis (Didlaukio g. 35)";Gintariukai;5109775795;Ne;11;0;0;11
2955;"Gintarėlis (Didlaukio g. 35)";Gintariukai;6056471440;Ne;0;22;0;22
2956;"Gintarėlis (Didlaukio g. 35)";Gintariukai;9374716095;Ne;7;0;3;10
2957;"Gintarėlis (Didlaukio g. 35)";Gintariukai;8815001033;Ne;0;2;0;2
2958;"Gintarėlis (Didlaukio g. 35)";Gintariukai;9787141660;Ne;13;0;0;13
2959;Giraitė;Aviliukas;4292730355;Ne;0;0;1;1
2960;Giraitė;Aviliukas;7001163828;Ne;0;4;2;6
2961;Giraitė;Aviliukas;5456658087;Ne;0;0;2;2
2962;Giraitė;Aviliukas;6159650070;Ne;0;4;1;5
2963;Giraitė;Aviliukas;5275912609;Ne;0;1;1;2
2964;Giraitė;Aviliukas;4758750245;Ne;5;2;0;7
2965;Giraitė;Aviliukas;2219854347;Ne;9;0;1;10
2966;Giraitė;Aviliukas;3719285343;Ne;5;0;1;6
2967;Giraitė;Aviliukas;7807844145;Ne;0;4;0;4
2968;Giraitė;Aviliukas;3757900478;Ne;0;0;1;1
2969;Giraitė;Aviliukas;3992069614;Ne;0;5;1;6
2970;Giraitė;Aviliukas;6121586335;Ne;0;0;6;6
2971;Giraitė;Aviliukas;4440444700;Ne;5;0;0;5
2972;Giraitė;Aviliukas;6296485105;Ne;6;0;0;6
2973;Giraitė;Aviliukas;5356944812;Ne;0;0;7;7
2974;Giraitė;Aviliukas;4554565631;Ne;11;1;0;12
2975;Giraitė;Aviliukas;2340866110;Ne;10;1;4;15
2976;Giraitė;LapiukaI;6141730004;Ne;0;1;0;1
2977;Giraitė;LapiukaI;6325909670;Ne;0;0;4;4
2978;Giraitė;LapiukaI;7831526566;Ne;0;0;1;1
2979;Giraitė;LapiukaI;2740656695;Ne;0;4;0;4
2980;Giraitė;LapiukaI;5030697729;Ne;3;3;1;7
2981;Giraitė;LapiukaI;1921430434;Ne;0;1;1;2
2982;Giraitė;LapiukaI;4663343304;Ne;7;0;0;7
2983;Giraitė;LapiukaI;4811513778;Ne;15;0;0;15
2984;Giraitė;LapiukaI;4296449093;Ne;0;2;0;2
2985;Giraitė;LapiukaI;1974159110;Ne;5;4;0;9
2986;Giraitė;LapiukaI;5532639133;Ne;1;5;1;7
2987;Giraitė;LapiukaI;4076402180;Ne;0;1;0;1
2988;Giraitė;LapiukaI;5902161665;Ne;0;7;0;7
2989;Giraitė;LapiukaI;4955786826;Taip;0;4;0;4
2990;Giraitė;LapiukaI;4260343903;Ne;5;0;0;5
2991;Giraitė;LapiukaI;9088123796;Ne;5;0;0;5
2992;Giraitė;LapiukaI;7772177095;Ne;0;4;0;4
2993;Giraitė;LapiukaI;8492822889;Ne;0;6;0;6
2994;Giraitė;LapiukaI;2880342138;Ne;12;0;2;14
2995;Giraitė;Voveriukai;4387282125;Ne;0;1;0;1
2996;Giraitė;Voveriukai;4822168634;Ne;0;5;0;5
2997;Giraitė;Voveriukai;2074303013;Ne;1;1;0;2
2998;Giraitė;Voveriukai;2088867630;Ne;0;4;0;4
2999;Giraitė;Voveriukai;3875214088;Ne;2;8;0;10
3000;Giraitė;Voveriukai;7441871219;Ne;3;4;0;7
3001;Giraitė;Voveriukai;7481895278;Ne;0;0;2;2
3002;Giraitė;Voveriukai;3607198556;Ne;0;8;0;8
3003;Giraitė;Voveriukai;8799195526;Ne;0;0;1;1
3004;Giraitė;Voveriukai;6225092500;Ne;0;0;2;2
3005;Giraitė;Voveriukai;4137699629;Ne;5;0;0;5
3006;Giraitė;Voveriukai;7919088987;Ne;2;4;1;7
3007;Giraitė;Voveriukai;5616242311;Ne;0;4;1;5
3008;Giraitė;Voveriukai;7739516049;Ne;0;2;1;3
3009;Giraitė;Voveriukai;4773517160;Ne;11;0;1;12
3010;Giraitė;Grybukai;2990968206;Ne;3;0;0;3
3011;Giraitė;Grybukai;1312761239;Ne;0;4;0;4
3012;Giraitė;Grybukai;5892950503;Ne;1;0;0;1
3013;Giraitė;Grybukai;4839351300;Ne;8;2;0;10
3014;Giraitė;Grybukai;9495968363;Ne;6;0;0;6
3015;Giraitė;Grybukai;1253151830;Ne;6;0;0;6
3016;Giraitė;Grybukai;6836412890;Ne;1;0;0;1
3017;Giraitė;Grybukai;9224845723;Ne;0;4;0;4
3018;Giraitė;Grybukai;9918028862;Ne;5;5;0;10
3019;Giraitė;Grybukai;5167002022;Ne;5;0;0;5
3020;Giraitė;Grybukai;4785524898;Ne;3;2;0;5
3021;Giraitė;Grybukai;8596389737;Ne;0;1;2;3
3022;Giraitė;Grybukai;1111614295;Ne;0;1;0;1
3023;Giraitė;Grybukai;5029839281;Ne;0;1;1;2
3024;Giraitė;Grybukai;8869728241;Ne;3;0;2;5
3025;Giraitė;Grybukai;3683700626;Ne;6;0;0;6
3026;Giraitė;Grybukai;9026736929;Ne;0;8;0;8
3027;Giraitė;Riešutėliai;5365264259;Ne;0;0;11;11
3028;Giraitė;Riešutėliai;7179656901;Ne;0;5;0;5
3029;Giraitė;Riešutėliai;3158451613;Ne;0;0;9;9
3030;Giraitė;Riešutėliai;7910736839;Ne;21;0;0;21
3031;Giraitė;Riešutėliai;3308792461;Ne;21;0;0;21
3032;Giraitė;Riešutėliai;7423115504;Ne;0;0;1;1
3033;Giraitė;Riešutėliai;3116241918;Ne;0;2;2;4
3034;Giraitė;Riešutėliai;6838184704;Ne;12;4;0;16
3035;Giraitė;Riešutėliai;5161383686;Ne;5;0;0;5
3036;Giraitė;Riešutėliai;7566944002;Ne;7;4;0;11
3037;Giraitė;Riešutėliai;3839432744;Ne;5;0;0;5
3038;Giraitė;Riešutėliai;9144465313;Ne;8;0;0;8
3039;Giraitė;Riešutėliai;6288016799;Ne;0;2;0;2
3040;Giraitė;Riešutėliai;3278871662;Ne;4;3;0;7
3041;Giraitė;Riešutėliai;4168934880;Ne;14;1;0;15
3042;Giraitė;Riešutėliai;6337090583;Ne;4;0;8;12
3043;Giraitė;Riešutėliai;3843211767;Ne;0;0;4;4
3044;Giraitė;Meškiukai;27501094616;Ne;0;2;0;2
3045;Giraitė;Meškiukai;2513312448;Ne;0;2;0;2
3046;Giraitė;Meškiukai;5367392810;Ne;0;6;0;6
3047;Giraitė;Meškiukai;5461837332;Ne;0;3;0;3
3048;Giraitė;Meškiukai;1355594003;Ne;0;9;0;9
3049;Giraitė;Meškiukai;1050699551;Ne;7;0;0;7
3050;Giraitė;Meškiukai;1876815077;Ne;0;4;0;4
3051;Giraitė;Meškiukai;1063628206;Ne;0;6;0;6
3052;Giraitė;Meškiukai;9195735923;Ne;0;5;0;5
3053;Giraitė;Meškiukai;65251975467;Ne;11;0;1;12
3054;Giraitė;Meškiukai;1704154980;Ne;0;0;5;5
3055;Giraitė;Meškiukai;1512384599;Ne;0;1;0;1
3056;Giraitė;Meškiukai;2571892050;Ne;0;4;2;6
3057;Giraitė;Meškiukai;6156715234;Ne;11;0;1;12
3058;Giraitė;Meškiukai;1594965200;Ne;0;0;3;3
3059;Giraitė;Meškiukai;9723242940;Ne;2;5;0;7
3060;Giraitė;Meškiukai;5726182600;Ne;0;17;0;17
3061;Giraitė;Meškiukai;1772790396;Ne;5;0;0;5
3062;Giraitė;Meškiukai;2551280794;Ne;0;18;0;18
3063;Giraitė;Uogelės;8908602761;Ne;5;3;0;8
3064;Giraitė;Uogelės;1729871315;Ne;0;3;0;3
3065;Giraitė;Uogelės;9503157590;Ne;0;6;0;6
3066;Giraitė;Uogelės;4317544803;Ne;7;0;0;7
3067;Giraitė;Uogelės;9927102264;Ne;16;0;0;16
3068;Giraitė;Uogelės;4121361794;Ne;0;11;0;11
3069;Giraitė;Uogelės;4843415587;Ne;0;4;0;4
3070;Giraitė;Uogelės;5471577047;Ne;8;2;0;10
3071;Giraitė;Uogelės;2307307454;Ne;15;0;0;15
3072;Giraitė;Uogelės;7094750784;Taip;0;4;1;5
3073;Giraitė;Uogelės;1356340471;Ne;3;4;2;9
3074;Giraitė;Uogelės;7377939409;Ne;16;0;0;16
3075;Giraitė;Uogelės;4288937528;Ne;6;0;2;8
3076;Giraitė;Uogelės;6293111179;Ne;10;5;0;15
3077;Giraitė;Uogelės;7390702355;Ne;5;1;0;6
3078;Giraitė;Šaltinėlis;5876711899;Ne;7;0;0;7
3079;Giraitė;Šaltinėlis;2076989836;Ne;8;0;2;10
3080;Giraitė;Šaltinėlis;9589760939;Ne;1;0;0;1
3081;Giraitė;Šaltinėlis;4500393769;Ne;0;3;0;3
3082;Giraitė;Šaltinėlis;3144724475;Ne;0;1;2;3
3083;Giraitė;Šaltinėlis;5525538498;Ne;4;0;1;5
3084;Giraitė;Šaltinėlis;4681342624;Ne;5;0;2;7
3085;Giraitė;Šaltinėlis;1170698327;Ne;0;4;0;4
3086;Giraitė;Šaltinėlis;3108521607;Ne;0;0;6;6
3087;Giraitė;Šaltinėlis;8139743188;Ne;5;0;0;5
3088;Giraitė;Šaltinėlis;2867735227;Ne;10;0;0;10
3089;Giraitė;Šaltinėlis;9669849051;Ne;0;0;5;5
3090;Giraitė;Boružėlės;6378362980;Ne;2;0;0;2
3091;Giraitė;Boružėlės;8612554184;Ne;6;0;0;6
3092;Giraitė;Boružėlės;2064019596;Ne;0;4;0;4
3093;Giraitė;Boružėlės;7260229442;Ne;5;6;0;11
3094;Giraitė;Boružėlės;1126576745;Ne;6;0;0;6
3095;Giraitė;Boružėlės;6333747274;Ne;25;0;0;25
3096;Giraitė;Boružėlės;9281071794;Ne;0;1;0;1
3097;Giraitė;Boružėlės;9386943162;Ne;8;3;0;11
3098;Giraitė;Boružėlės;4749790368;Ne;5;0;1;6
3099;Giraitė;Boružėlės;3039445733;Ne;12;0;1;13
3100;Giraitė;Boružėlės;4719547384;Ne;5;0;0;5
3101;Giraitė;Boružėlės;4008393576;Ne;0;1;0;1
3102;Giraitė;Boružėlės;9766107773;Ne;11;0;0;11
3103;Giraitė;Gandriukai;4680913596;Ne;10;0;0;10
3104;Giraitė;Gandriukai;7384795349;Ne;8;0;2;10
3105;Giraitė;Gandriukai;3643426944;Ne;9;0;0;9
3106;Giraitė;Gandriukai;8525380061;Ne;10;1;0;11
3107;Giraitė;Gandriukai;4851987149;Ne;5;0;0;5
3108;Giraitė;Gandriukai;2205108811;Ne;4;0;1;5
3109;Giraitė;Gandriukai;7008670489;Ne;4;4;0;8
3110;Giraitė;Gandriukai;6277788515;Ne;9;4;0;13
3111;Giraitė;Gandriukai;7767820565;Ne;23;0;0;23
3112;Giraitė;Gandriukai;7269074498;Ne;5;4;0;9
3113;Giraitė;Gandriukai;9850432917;Ne;28;0;0;28
3114;Giraitė;Gandriukai;2313273738;Ne;9;1;0;10
3115;Giraitė;Gandriukai;9625436756;Ne;0;1;0;1
3116;Giraitė;Gandriukai;8101302584;Ne;16;0;0;16
3117;Giraitė;Gandriukai;9307640828;Ne;14;0;0;14
3118;Giraitė;Gandriukai;3027761044;Ne;0;0;1;1
3119;Giraitė;Gandriukai;1125863541;Ne;4;1;0;5
3120;Giraitė;Gandriukai;4371263826;Ne;10;3;0;13
3121;Giraitė;ŽVIRBLIUKAI;6715354865;Ne;6;0;1;7
3122;Giraitė;ŽVIRBLIUKAI;8461725999;Ne;0;0;2;2
3123;Giraitė;ŽVIRBLIUKAI;7395332578;Ne;6;0;0;6
3124;Giraitė;ŽVIRBLIUKAI;5086296808;Ne;0;8;0;8
3125;Giraitė;ŽVIRBLIUKAI;9669916418;Ne;5;0;1;6
3126;Giraitė;ŽVIRBLIUKAI;3481695682;Ne;11;0;0;11
3127;Giraitė;ŽVIRBLIUKAI;7551981095;Ne;0;0;1;1
3128;Giraitė;ŽVIRBLIUKAI;9471560738;Ne;5;2;0;7
3129;Giraitė;ŽVIRBLIUKAI;6677278422;Ne;0;0;1;1
3130;Giraitė;ŽVIRBLIUKAI;7230351549;Ne;9;1;1;11
3131;Giraitė;ŽVIRBLIUKAI;9728453316;Ne;0;2;0;2
3132;Giraitė;ŽVIRBLIUKAI;2416162886;Ne;0;0;5;5
3133;Giraitė;ŽVIRBLIUKAI;7543605905;Ne;6;6;0;12
3134;Giraitė;ŽVIRBLIUKAI;8128401630;Ne;3;0;0;3
3135;Giraitė;ŽVIRBLIUKAI;4233170371;Ne;18;0;2;20
3136;Giraitė;ŽVIRBLIUKAI;8871979627;Ne;8;0;1;9
3137;Giraitė;ŽVIRBLIUKAI;3214528809;Ne;0;0;2;2
3138;Giraitė;ŽVIRBLIUKAI;4450822125;Ne;0;0;1;1
3139;Giraitė;ŽVIRBLIUKAI;6474975269;Ne;5;0;1;6
3140;Giraitė;Kiškeliai;1227555563;Ne;21;0;0;21
3141;Giraitė;Kiškeliai;3613828494;Ne;16;0;0;16
3142;Giraitė;Kiškeliai;5447466102;Ne;5;5;0;10
3143;Giraitė;Kiškeliai;2686885139;Taip;2;0;0;2
3144;Giraitė;Kiškeliai;9764802294;Ne;10;0;0;10
3145;Giraitė;Kiškeliai;5574589536;Ne;4;0;1;5
3146;Giraitė;Kiškeliai;2726766768;Taip;0;0;2;2
3147;Giraitė;Kiškeliai;6565165993;Ne;0;6;3;9
3148;Giraitė;Kiškeliai;1456726379;Ne;0;0;1;1
3149;Giraitė;Kiškeliai;7392324344;Taip;17;0;0;17
3150;Giraitė;Kiškeliai;9751078590;Ne;6;0;1;7
3151;Gudrutis;Gandriukų;2197278086;Ne;5;2;2;9
3152;Gudrutis;Gandriukų;6358318238;Ne;5;0;0;5
3153;Gudrutis;Gandriukų;7942601528;Ne;0;2;0;2
3154;Gudrutis;Gandriukų;1701035039;Ne;0;5;0;5
3155;Gudrutis;Gandriukų;4844838728;Ne;7;2;0;9
3156;Gudrutis;Gandriukų;1685531183;Ne;0;0;4;4
3157;Gudrutis;Gandriukų;9253468183;Ne;8;2;2;12
3158;Gudrutis;Gandriukų;1051407930;Ne;0;0;3;3
3159;Gudrutis;Gandriukų;7755882832;Ne;3;2;0;5
3160;Gudrutis;Gandriukų;2487363252;Ne;5;5;4;14
3161;Gudrutis;Gandriukų;7663746093;Ne;11;1;0;12
3162;Gudrutis;Gandriukų;1012579870;Ne;0;2;2;4
3163;Gudrutis;Gandriukų;8512130106;Ne;0;2;2;4
3164;Gudrutis;Gandriukų;3919786807;Ne;0;1;2;3
3165;Gudrutis;Gandriukų;8165828215;Ne;7;5;0;12
3166;Gudrutis;Gandriukų;1485530468;Ne;7;0;2;9
3167;Gudrutis;Gandriukų;5508723821;Ne;10;4;0;14
3168;Gudrutis;Gandriukų;9044566825;Ne;5;5;1;11
3169;Gudrutis;Gandriukų;8774935740;Ne;9;3;0;12
3170;Gudrutis;Gandriukų;9297898193;Ne;11;0;0;11
3171;Gudrutis;Gandriukų;9784116399;Ne;0;6;5;11
3172;Gudrutis;"Saulės zuikučių";7934673005;Ne;16;0;0;16
3173;Gudrutis;"Saulės zuikučių";2199222671;Ne;0;0;7;7
3174;Gudrutis;"Saulės zuikučių";1587454709;Ne;11;0;0;11
3175;Gudrutis;"Saulės zuikučių";1670550212;Ne;7;1;0;8
3176;Gudrutis;"Saulės zuikučių";5241856014;Ne;3;0;0;3
3177;Gudrutis;"Saulės zuikučių";1225698076;Ne;12;0;0;12
3178;Gudrutis;"Saulės zuikučių";8500911420;Ne;0;6;4;10
3179;Gudrutis;"Saulės zuikučių";5408444872;Ne;2;0;0;2
3180;Gudrutis;"Saulės zuikučių";5728436444;Ne;0;0;3;3
3181;Gudrutis;"Saulės zuikučių";9041133527;Ne;0;4;0;4
3182;Gudrutis;"Saulės zuikučių";8240340213;Ne;0;5;1;6
3183;Gudrutis;"Saulės zuikučių";6846653547;Ne;4;0;2;6
3184;Gudrutis;"Saulės zuikučių";3281890659;Ne;0;3;0;3
3185;Gudrutis;"Saulės zuikučių";2291393238;Ne;14;0;2;16
3186;Gudrutis;"Saulės zuikučių";9752360809;Ne;0;5;2;7
3187;Gudrutis;"Saulės zuikučių";5585248878;Ne;10;0;0;10
3188;Gudrutis;"Saulės zuikučių";1384696362;Ne;5;0;1;6
3189;Gudrutis;"Saulės zuikučių";2666772437;Ne;7;9;0;16
3190;Gudrutis;"Saulės zuikučių";2994309084;Ne;0;2;5;7
3191;Gudrutis;"Saulės zuikučių";3743529726;Ne;11;0;1;12
3192;Gudrutis;Pelėdžiukų;2293472716;Ne;5;0;0;5
3193;Gudrutis;Pelėdžiukų;6835038962;Ne;0;0;7;7
3194;Gudrutis;Pelėdžiukų;6731806925;Ne;0;1;3;4
3195;Gudrutis;Pelėdžiukų;2118727861;Ne;2;0;1;3
3196;Gudrutis;Pelėdžiukų;9701111916;Ne;0;0;6;6
3197;Gudrutis;Pelėdžiukų;1725920873;Ne;1;4;3;8
3198;Gudrutis;Pelėdžiukų;1901358996;Ne;0;0;6;6
3199;Gudrutis;Pelėdžiukų;7664517480;Ne;0;0;3;3
3200;Gudrutis;Pelėdžiukų;9847597133;Ne;0;1;0;1
3201;Gudrutis;Pelėdžiukų;3646335609;Ne;0;0;13;13
3202;Gudrutis;Pelėdžiukų;7871991275;Ne;0;0;13;13
3203;Gudrutis;Pelėdžiukų;5580618896;Ne;0;0;8;8
3204;Gudrutis;Pelėdžiukų;2468434676;Ne;0;0;1;1
3205;Gudrutis;Pelėdžiukų;3625838131;Ne;0;4;0;4
3206;Gudrutis;Pelėdžiukų;2337493193;Ne;0;5;0;5
3207;Gudrutis;Pelėdžiukų;2408038213;Ne;0;0;5;5
3208;Gudrutis;Pelėdžiukų;2764843216;Ne;0;4;0;4
3209;Gudrutis;Pelėdžiukų;7955353991;Ne;0;5;0;5
3210;Gudrutis;Pelėdžiukų;2118820249;Ne;0;10;0;10
3211;Gudrutis;BITUČIŲ;4193661251;Ne;3;2;0;5
3212;Gudrutis;BITUČIŲ;7443277768;Ne;0;10;0;10
3213;Gudrutis;BITUČIŲ;9797417587;Ne;0;5;0;5
3214;Gudrutis;BITUČIŲ;5574287734;Ne;0;4;2;6
3215;Gudrutis;BITUČIŲ;2431077357;Ne;5;0;0;5
3216;Gudrutis;BITUČIŲ;7116979528;Ne;0;1;0;1
3217;Gudrutis;BITUČIŲ;1228190677;Ne;0;4;2;6
3218;Gudrutis;BITUČIŲ;6700254479;Ne;0;4;0;4
3219;Gudrutis;BITUČIŲ;1693306014;Ne;10;4;0;14
3220;Gudrutis;BITUČIŲ;8398961969;Ne;0;2;2;4
3221;Gudrutis;BITUČIŲ;2074151024;Ne;0;4;0;4
3222;Gudrutis;BITUČIŲ;1991658503;Ne;0;4;0;4
3223;Gudrutis;BITUČIŲ;2592224860;Ne;0;5;0;5
3224;Gudrutis;BITUČIŲ;9841172472;Ne;5;2;0;7
3225;Gudrutis;BITUČIŲ;3359028602;Ne;0;4;0;4
3226;Gudrutis;BITUČIŲ;4945755164;Ne;4;0;4;8
3227;Gudrutis;BITUČIŲ;6443631536;Ne;0;4;0;4
3228;Gudrutis;BITUČIŲ;7773150642;Ne;18;0;0;18
3229;Gudrutis;BITUČIŲ;6198012431;Ne;11;0;0;11
3230;Gudrutis;Boružėlių;2497248749;Ne;1;0;0;1
3231;Gudrutis;Boružėlių;6284712576;Ne;10;0;0;10
3232;Gudrutis;Boružėlių;9096764346;Ne;0;1;0;1
3233;Gudrutis;Boružėlių;5306281458;Ne;0;0;8;8
3234;Gudrutis;Boružėlių;8783180638;Ne;0;0;8;8
3235;Gudrutis;Boružėlių;8525851058;Ne;0;0;6;6
3236;Gudrutis;Boružėlių;8080976400;Ne;0;0;7;7
3237;Gudrutis;Boružėlių;6101410750;Ne;0;2;3;5
3238;Gudrutis;Boružėlių;5710348070;Ne;21;0;0;21
3239;Gudrutis;Boružėlių;8843761360;Ne;21;0;0;21
3240;Gudrutis;Boružėlių;5590297232;Ne;0;0;7;7
3241;Gudrutis;Boružėlių;2145834885;Ne;0;0;10;10
3242;Gudrutis;Boružėlių;5093267385;Ne;5;3;1;9
3243;Gudrutis;Boružėlių;1364145110;Ne;5;0;2;7
3244;Gudrutis;Boružėlių;1737001982;Ne;1;10;2;13
3245;Gudrutis;Boružėlių;9200644104;Ne;0;0;1;1
3246;Gudrutis;Boružėlių;3797656483;Ne;0;0;1;1
3247;Gudrutis;Drugeliai;7930414623;Ne;0;1;0;1
3248;Gudrutis;Drugeliai;6458053920;Ne;0;2;1;3
3249;Gudrutis;Drugeliai;5498218329;Ne;1;2;0;3
3250;Gudrutis;Drugeliai;4600814480;Ne;14;0;0;14
3251;Gudrutis;Drugeliai;9454206104;Ne;1;2;0;3
3252;Gudrutis;Drugeliai;5054363773;Ne;4;2;3;9
3253;Gudrutis;Drugeliai;7531077386;Ne;0;1;0;1
3254;Gudrutis;Drugeliai;5931281687;Ne;0;1;4;5
3255;Gudrutis;Drugeliai;3264829331;Ne;15;0;0;15
3256;Gudrutis;Drugeliai;7143849852;Ne;24;0;2;26
3257;Gudrutis;Drugeliai;3760014407;Ne;0;1;2;3
3258;Gudrutis;Drugeliai;1588396018;Ne;1;0;0;1
3259;Gudrutis;Drugeliai;3316297441;Ne;9;2;0;11
3260;Gudrutis;Drugeliai;6307643172;Ne;0;2;1;3
3261;Gudrutis;Drugeliai;2256458624;Ne;10;1;0;11
3262;Gudrutis;Drugeliai;2278368966;Ne;1;1;0;2
3263;Gudrutis;Drugeliai;5911423362;Ne;12;0;0;12
3264;Gudrutis;Drugeliai;2784392885;Ne;5;1;1;7
3265;Gudrutis;Drugeliai;1170008457;Ne;14;0;2;16
3266;Jurginėlis;Ąžuoliukai;7309052653;Ne;0;21;0;21
3267;Jurginėlis;Ąžuoliukai;2501462080;Ne;4;0;3;7
3268;Jurginėlis;Ąžuoliukai;8571054905;Ne;13;0;0;13
3269;Jurginėlis;Ąžuoliukai;8969526123;Ne;3;0;0;3
3270;Jurginėlis;Ąžuoliukai;6168508647;Ne;17;0;1;18
3271;Jurginėlis;Ąžuoliukai;5861832676;Ne;9;5;0;14
3272;Jurginėlis;Ąžuoliukai;3933113321;Ne;0;10;0;10
3273;Jurginėlis;Ąžuoliukai;5861418459;Ne;0;6;0;6
3274;Jurginėlis;Ąžuoliukai;5869170503;Ne;0;0;2;2
3275;Jurginėlis;Ąžuoliukai;3562210465;Ne;0;3;1;4
3276;Jurginėlis;Ąžuoliukai;6202225321;Ne;7;2;2;11
3277;Jurginėlis;Ąžuoliukai;7081618073;Ne;9;1;1;11
3278;Jurginėlis;Ąžuoliukai;6851855147;Ne;6;1;1;8
3279;Jurginėlis;Ąžuoliukai;9029587175;Ne;3;0;1;4
3280;Jurginėlis;Ąžuoliukai;9889620429;Ne;4;0;0;4
3281;Jurginėlis;Ąžuoliukai;3324811458;Ne;4;4;0;8
3282;Jurginėlis;Ąžuoliukai;6153432639;Ne;5;1;0;6
3283;Jurginėlis;Ąžuoliukai;9850874714;Ne;0;3;0;3
3284;Jurginėlis;Ąžuoliukai;8174251359;Ne;14;0;2;16
3285;Jurginėlis;Ąžuoliukai;2447025385;Ne;7;0;4;11
3286;Jurginėlis;Ąžuoliukai;5313627252;Ne;11;5;1;17
3287;Jurginėlis;Žiogeliai;8159210242;Ne;0;14;0;14
3288;Jurginėlis;Žiogeliai;9934831745;Ne;0;8;0;8
3289;Jurginėlis;Žiogeliai;7251598691;Ne;16;0;0;16
3290;Jurginėlis;Žiogeliai;3083045137;Ne;6;6;0;12
3291;Jurginėlis;Žiogeliai;6906225772;Ne;6;2;0;8
3292;Jurginėlis;Žiogeliai;7010130915;Ne;0;0;1;1
3293;Jurginėlis;Žiogeliai;7907096012;Ne;0;6;0;6
3294;Jurginėlis;Žiogeliai;7250246853;Ne;0;5;0;5
3295;Jurginėlis;Žiogeliai;5160581631;Ne;0;4;0;4
3296;Jurginėlis;Žiogeliai;5037980414;Ne;0;2;0;2
3297;Jurginėlis;Žiogeliai;7300018733;Ne;0;3;0;3
3298;Jurginėlis;Žiogeliai;4674128568;Ne;0;18;0;18
3299;Jurginėlis;Žiogeliai;9305884152;Ne;8;4;4;16
3300;Jurginėlis;Žiogeliai;9716328349;Ne;0;21;0;21
3301;Jurginėlis;Žiogeliai;4441183185;Ne;7;0;0;7
3302;Jurginėlis;Žiogeliai;4502564783;Ne;6;1;0;7
3303;Jurginėlis;Žiogeliai;1937927553;Ne;0;0;2;2
3304;Jurginėlis;Žiogeliai;7527178332;Ne;5;0;0;5
3305;Jurginėlis;Žiogeliai;4682125116;Ne;9;2;0;11
3306;Jurginėlis;Žiogeliai;3920971621;Ne;10;0;0;10
3307;Jurginėlis;Pelėdžiukų;9882919290;Ne;0;2;0;2
3308;Jurginėlis;Pelėdžiukų;5984893389;Ne;0;6;0;6
3309;Jurginėlis;Pelėdžiukų;3079495897;Ne;12;2;0;14
3310;Jurginėlis;Pelėdžiukų;8727844649;Ne;0;4;10;14
3311;Jurginėlis;Pelėdžiukų;1455749921;Ne;0;6;0;6
3312;Jurginėlis;Pelėdžiukų;7809274980;Ne;2;5;0;7
3313;Jurginėlis;Pelėdžiukų;2417314519;Ne;5;5;0;10
3314;Jurginėlis;Pelėdžiukų;6968528293;Ne;0;5;0;5
3315;Jurginėlis;Pelėdžiukų;4292932046;Ne;0;1;0;1
3316;Jurginėlis;Pelėdžiukų;9507571301;Ne;5;0;0;5
3317;Jurginėlis;Pelėdžiukų;8779807396;Ne;7;4;0;11
3318;Jurginėlis;Pelėdžiukų;8443412187;Ne;5;1;0;6
3319;Jurginėlis;Pelėdžiukų;4967548277;Ne;0;17;0;17
3320;Jurginėlis;Pelėdžiukų;2925253653;Ne;6;3;0;9
3321;Jurginėlis;Pelėdžiukų;1340689348;Ne;0;2;0;2
3322;Jurginėlis;Pelėdžiukų;2221708420;Ne;0;2;1;3
3323;Jurginėlis;Pelėdžiukų;6181547354;Ne;0;21;0;21
3324;Jurginėlis;Pelėdžiukų;2490875633;Ne;0;10;0;10
3325;Jurginėlis;Pelėdžiukų;9760394658;Ne;9;0;0;9
3326;Jurginėlis;Pelėdžiukų;3786379532;Ne;7;2;3;12
3327;Jurginėlis;Boružėlių;4295285885;Ne;16;2;0;18
3328;Jurginėlis;Boružėlių;8920304044;Ne;0;5;0;5
3329;Jurginėlis;Boružėlių;2171115974;Ne;0;1;0;1
3330;Jurginėlis;Boružėlių;3027573572;Ne;7;5;0;12
3331;Jurginėlis;Boružėlių;8338173095;Ne;0;1;0;1
3332;Jurginėlis;Boružėlių;1758862051;Ne;0;2;0;2
3333;Jurginėlis;Boružėlių;1467200002;Ne;0;4;0;4
3334;Jurginėlis;Boružėlių;4851923549;Ne;0;4;0;4
3335;Jurginėlis;Boružėlių;6111863896;Ne;0;11;0;11
3336;Jurginėlis;Boružėlių;47243459592;Ne;0;1;0;1
3337;Jurginėlis;Boružėlių;2446630485;Ne;0;6;0;6
3338;Jurginėlis;Boružėlių;1361108271;Ne;0;5;0;5
3339;Jurginėlis;Boružėlių;5386710069;Ne;0;4;0;4
3340;Jurginėlis;Boružėlių;8972814655;Ne;3;5;0;8
3341;Jurginėlis;Boružėlių;4852619394;Ne;0;4;0;4
3342;Jurginėlis;Boružėlių;7753784918;Ne;0;21;0;21
3343;Jurginėlis;Bitučių;9589394406;Ne;0;4;3;7
3344;Jurginėlis;Bitučių;3708774681;Ne;10;4;1;15
3345;Jurginėlis;Bitučių;6413324051;Ne;0;6;0;6
3346;Jurginėlis;Bitučių;7297672386;Ne;4;3;1;8
3347;Jurginėlis;Bitučių;1586599624;Ne;0;4;1;5
3348;Jurginėlis;Bitučių;2710889915;Ne;0;4;0;4
3349;Jurginėlis;Bitučių;1175441410;Ne;0;5;0;5
3350;Jurginėlis;Bitučių;1082593212;Ne;6;0;0;6
3351;Jurginėlis;Bitučių;903039398;Ne;0;1;0;1
3352;Jurginėlis;Bitučių;9646318532;Ne;0;1;0;1
3353;Jurginėlis;Bitučių;8227660508;Ne;7;0;0;7
3354;Jurginėlis;Bitučių;77480957625;Ne;0;4;0;4
3355;Jurginėlis;Bitučių;1547101731;Ne;0;3;0;3
3356;Jurginėlis;Bitučių;2624313807;Ne;2;0;0;2
3357;Jurginėlis;Bitučių;7928799065;Ne;0;0;1;1
3358;Jurginėlis;Bitučių;5892180334;Ne;0;4;0;4
3359;Jurginėlis;Bitučių;3018576350;Ne;5;1;4;10
3360;Jurginėlis;Skruzdeliukų;1351306981;Ne;6;0;0;6
3361;Jurginėlis;Skruzdeliukų;9146039217;Ne;5;0;0;5
3362;Jurginėlis;Skruzdeliukų;1885598986;Ne;8;3;0;11
3363;Jurginėlis;Skruzdeliukų;3558752347;Ne;0;5;0;5
3364;Jurginėlis;Skruzdeliukų;5734506036;Ne;0;3;0;3
3365;Jurginėlis;Skruzdeliukų;3699180485;Ne;0;4;0;4
3366;Jurginėlis;Skruzdeliukų;1763849354;Ne;3;0;1;4
3367;Jurginėlis;Skruzdeliukų;4944292549;Ne;5;7;0;12
3368;Jurginėlis;Skruzdeliukų;9506129699;Ne;11;0;0;11
3369;Jurginėlis;Skruzdeliukų;3822916547;Ne;14;0;0;14
3370;Jurginėlis;Skruzdeliukų;1204999684;Ne;13;1;0;14
3371;Jurginėlis;Skruzdeliukų;9937405742;Ne;22;2;0;24
3372;Jurginėlis;Skruzdeliukų;1726968598;Ne;0;17;0;17
3373;Jurginėlis;Skruzdeliukų;2332714713;Ne;1;0;0;1
3374;Jurginėlis;Skruzdeliukų;9961083854;Ne;0;9;0;9
3375;Jurginėlis;Skruzdeliukų;6542567172;Ne;0;7;0;7
3376;Jurginėlis;Drugelių;9065349248;Ne;4;0;0;4
3377;Jurginėlis;Drugelių;8341951659;Ne;4;9;0;13
3378;Jurginėlis;Drugelių;7795042485;Taip;14;0;5;19
3379;Jurginėlis;Drugelių;5138832895;Ne;6;0;0;6
3380;Jurginėlis;Drugelių;5751977493;Ne;0;3;1;4
3381;Jurginėlis;Drugelių;3466562781;Ne;0;2;0;2
3382;Jurginėlis;Drugelių;6068645621;Ne;0;10;0;10
3383;Jurginėlis;Drugelių;4276237094;Ne;6;1;1;8
3384;Jurginėlis;Drugelių;2689492215;Ne;10;0;0;10
3385;Jurginėlis;Drugelių;3527520303;Ne;5;0;0;5
3386;Jurginėlis;Drugelių;1208882528;Ne;0;0;2;2
3387;Jurginėlis;Drugelių;5874949368;Ne;18;0;0;18
3388;Jurginėlis;Drugelių;7349309693;Ne;0;6;0;6
3389;Jurginėlis;Drugelių;3063084253;Ne;16;0;0;16
3390;Jurginėlis;Drugelių;7409019574;Ne;21;0;0;21
3391;Jurginėlis;Drugelių;5928303681;Ne;0;21;0;21
3392;Jurginėlis;Žibučių;4979618298;Ne;15;0;0;15
3393;Jurginėlis;Žibučių;6636147085;Ne;6;3;0;9
3394;Jurginėlis;Žibučių;1438159631;Ne;1;4;0;5
3395;Jurginėlis;Žibučių;1336429135;Ne;0;6;0;6
3396;Jurginėlis;Žibučių;6948834218;Ne;9;4;0;13
3397;Jurginėlis;Žibučių;7721612113;Ne;7;0;0;7
3398;Jurginėlis;Žibučių;6988386438;Ne;7;0;0;7
3399;Jurginėlis;Žibučių;8111158692;Ne;6;0;0;6
3400;Jurginėlis;Žibučių;5936508522;Taip;16;3;0;19
3401;Jurginėlis;Žibučių;6717892969;Ne;0;4;0;4
3402;Jurginėlis;Žibučių;7977676733;Ne;12;0;0;12
3403;Jurginėlis;Žibučių;3899526893;Ne;3;0;0;3
3404;Jurginėlis;Žibučių;3861311860;Ne;12;0;0;12
3405;Jurginėlis;Žibučių;1263601087;Ne;0;2;0;2
3406;Jurginėlis;Žibučių;5549766339;Ne;7;5;0;12
3407;Jurginėlis;Žibučių;4429780802;Ne;0;6;0;6
3408;Jurginėlis;Žibučių;8968718021;Ne;15;1;0;16
3409;Jurginėlis;Žibučių;2782553941;Ne;13;0;0;13
3410;Jurginėlis;Žibučių;6259461257;Ne;3;0;2;5
3411;Jurginėlis;Žibučių;7252041334;Ne;7;3;0;10
3412;Jurginėlis;Zuikučių;5958832413;Ne;3;0;0;3
3413;Jurginėlis;Zuikučių;4432849717;Ne;0;6;0;6
3414;Jurginėlis;Zuikučių;6587382160;Ne;0;1;1;2
3415;Jurginėlis;Zuikučių;8097652962;Ne;0;4;0;4
3416;Jurginėlis;Zuikučių;4763313715;Ne;10;1;4;15
3417;Jurginėlis;Zuikučių;6671759364;Ne;6;0;0;6
3418;Jurginėlis;Zuikučių;6197396872;Ne;0;0;4;4
3419;Jurginėlis;Zuikučių;8937404520;Ne;0;0;2;2
3420;Jurginėlis;Zuikučių;2820249307;Ne;4;0;0;4
3421;Jurginėlis;Zuikučių;8823175066;Ne;0;2;0;2
3422;Jurginėlis;Zuikučių;8161347781;Ne;0;10;0;10
3423;Jurginėlis;Zuikučių;7283697595;Ne;0;0;2;2
3424;Jurginėlis;Zuikučių;4113264904;Ne;0;0;2;2
3425;Jurginėlis;Zuikučių;8117563141;Ne;0;2;1;3
3426;Jurginėlis;Zuikučių;5652597514;Ne;7;0;5;12
3427;Jurginėlis;Zuikučių;6341896288;Ne;5;0;4;9
3428;Jurginėlis;Zuikučių;4180071775;Ne;0;0;1;1
3429;Jurginėlis;Viščiukų;7193314762;Ne;0;0;2;2
3430;Jurginėlis;Viščiukų;5474358669;Ne;0;32;0;32
3431;Jurginėlis;Viščiukų;2595002682;Ne;8;0;0;8
3432;Jurginėlis;Viščiukų;5866358319;Ne;3;0;2;5
3433;Jurginėlis;Viščiukų;4648875524;Ne;10;0;0;10
3434;Jurginėlis;Viščiukų;4644476606;Ne;0;0;1;1
3435;Jurginėlis;Viščiukų;3230200231;Ne;0;1;0;1
3436;Jurginėlis;Viščiukų;7636442845;Ne;6;0;0;6
3437;Jurginėlis;Viščiukų;1286603999;Ne;15;0;0;15
3438;Jurginėlis;Viščiukų;4617952912;Ne;9;0;0;9
3439;Jurginėlis;Viščiukų;9603380131;Ne;4;0;0;4
3440;Jurginėlis;Meškiukų;8844614653;Ne;0;4;0;4
3441;Jurginėlis;Meškiukų;1303323955;Ne;7;0;0;7
3442;Jurginėlis;Meškiukų;4466955830;Ne;6;5;2;13
3443;Jurginėlis;Meškiukų;6932501634;Ne;0;0;1;1
3444;Jurginėlis;Meškiukų;3675820817;Ne;10;0;1;11
3445;Jurginėlis;Meškiukų;6285599044;Ne;10;4;4;18
3446;Jurginėlis;Meškiukų;5043815909;Ne;8;2;0;10
3447;Jurginėlis;Meškiukų;9901171406;Ne;8;0;0;8
3448;Jurginėlis;Meškiukų;2982526236;Ne;0;1;0;1
3449;Jurginėlis;Meškiukų;4233910766;Ne;9;1;1;11
3450;Jurginėlis;Meškiukų;1537710974;Ne;14;7;0;21
3451;Jurginėlis;Meškiukų;6594025023;Ne;10;1;0;11
3452;Jurginėlis;Meškiukų;6648657850;Ne;0;4;0;4
3453;Jurginėlis;Meškiukų;6856023398;Ne;10;3;1;14
3454;Jurginėlis;Meškiukų;6124147401;Ne;0;4;0;4
3455;Jurginėlis;Gandriukų;3530906368;Ne;0;4;10;14
3456;Jurginėlis;Gandriukų;6806704355;Ne;18;0;0;18
3457;Jurginėlis;Gandriukų;9288380246;Ne;0;0;10;10
3458;Jurginėlis;Gandriukų;2548920722;Ne;8;3;5;16
3459;Jurginėlis;Gandriukų;7288921301;Ne;0;6;0;6
3460;Jurginėlis;Gandriukų;4827340942;Ne;12;0;3;15
3461;Jurginėlis;Gandriukų;4463258777;Ne;0;6;4;10
3462;Jurginėlis;Gandriukų;1414888906;Ne;0;4;1;5
3463;Jurginėlis;Gandriukų;2225892248;Ne;1;0;5;6
3464;Jurginėlis;Gandriukų;6579565337;Ne;4;7;0;11
3465;Jurginėlis;Gandriukų;7990015623;Ne;0;4;0;4
3466;Jurginėlis;Gandriukų;4158502752;Ne;4;3;0;7
3467;Jurginėlis;Gandriukų;2214809186;Ne;0;0;1;1
3468;Jurginėlis;Gandriukų;3284464951;Ne;0;21;0;21
3469;Jurginėlis;Gandriukų;2263818210;Ne;6;2;0;8
3470;Jurginėlis;Gandriukų;3091019969;Ne;13;0;0;13
3471;Jurginėlis;Gandriukų;2837099502;Ne;0;0;1;1
3472;Jurginėlis;Gandriukų;3462969423;Ne;0;6;0;6
3473;Jurginėlis;Gandriukų;7486778826;Ne;11;0;0;11
3474;Jurginėlis;Gandriukų;5242359650;Ne;0;7;0;7
3475;Jurginėlis;Gandriukų;8144038013;Ne;0;9;0;9
3476;Karuselė;PAGRANDUKAS;1621482372;Ne;7;4;0;11
3477;Karuselė;PAGRANDUKAS;3330374479;Ne;14;4;0;18
3478;Karuselė;PAGRANDUKAS;6183785840;Ne;0;5;0;5
3479;Karuselė;PAGRANDUKAS;3984262482;Ne;10;0;0;10
3480;Karuselė;PAGRANDUKAS;9130534156;Ne;8;0;0;8
3481;Karuselė;PAGRANDUKAS;3660843696;Ne;5;0;0;5
3482;Karuselė;PAGRANDUKAS;5132581245;Ne;7;6;0;13
3483;Karuselė;PAGRANDUKAS;2412418335;Ne;0;1;0;1
3484;Karuselė;PAGRANDUKAS;7013765804;Ne;14;1;0;15
3485;Karuselė;PAGRANDUKAS;3429495073;Ne;0;1;0;1
3486;Karuselė;PAGRANDUKAS;6252613489;Ne;11;3;0;14
3487;Karuselė;PAGRANDUKAS;5595950213;Ne;10;0;0;10
3488;Karuselė;PAGRANDUKAS;6004882312;Ne;5;5;0;10
3489;Karuselė;PAGRANDUKAS;6856800484;Ne;9;0;0;9
3490;Karuselė;PAGRANDUKAS;5028265234;Ne;7;3;0;10
3491;Karuselė;PAGRANDUKAS;3972815393;Ne;1;2;0;3
3492;Karuselė;PAGRANDUKAS;8157193503;Ne;4;4;0;8
3493;Karuselė;PAGRANDUKAS;8656806219;Ne;5;0;0;5
3494;Karuselė;PAGRANDUKAS;9651192437;Ne;0;0;2;2
3495;Karuselė;NYKŠTUKAS;4910899296;Ne;10;0;0;10
3496;Karuselė;NYKŠTUKAS;4966362343;Ne;7;0;1;8
3497;Karuselė;NYKŠTUKAS;9997776739;Ne;18;0;0;18
3498;Karuselė;NYKŠTUKAS;4445214427;Ne;0;11;0;11
3499;Karuselė;NYKŠTUKAS;5216815933;Ne;0;3;0;3
3500;Karuselė;NYKŠTUKAS;7817417459;Ne;8;5;0;13
3501;Karuselė;NYKŠTUKAS;9654804545;Ne;0;8;0;8
3502;Karuselė;NYKŠTUKAS;6581798125;Ne;0;0;2;2
3503;Karuselė;NYKŠTUKAS;1486577955;Ne;15;2;0;17
3504;Karuselė;NYKŠTUKAS;5697305819;Ne;0;4;0;4
3505;Karuselė;NYKŠTUKAS;8007341411;Ne;5;2;0;7
3506;Karuselė;NYKŠTUKAS;4363388969;Ne;0;10;0;10
3507;Karuselė;NYKŠTUKAS;4296509304;Ne;10;1;0;11
3508;Karuselė;NYKŠTUKAS;9243932017;Ne;5;2;2;9
3509;Karuselė;NYKŠTUKAS;5986973796;Ne;17;0;0;17
3510;Karuselė;NYKŠTUKAS;4856589410;Ne;0;2;1;3
3511;Karuselė;NYKŠTUKAS;9999461542;Ne;0;2;1;3
3512;Karuselė;NYKŠTUKAS;9385698812;Ne;0;4;0;4
3513;Karuselė;NYKŠTUKAS;5328762735;Ne;12;3;0;15
3514;Karuselė;BITUTĖ;1593728369;Ne;0;2;0;2
3515;Karuselė;BITUTĖ;2426822679;Ne;0;6;1;7
3516;Karuselė;BITUTĖ;1205498782;Ne;0;10;0;10
3517;Karuselė;BITUTĖ;7824913364;Ne;7;4;0;11
3518;Karuselė;BITUTĖ;5651238035;Ne;0;2;0;2
3519;Karuselė;BITUTĖ;5960946826;Ne;5;4;0;9
3520;Karuselė;BITUTĖ;8175498192;Ne;0;4;1;5
3521;Karuselė;BITUTĖ;5951045233;Ne;0;6;4;10
3522;Karuselė;BITUTĖ;1487641646;Ne;0;5;0;5
3523;Karuselė;BITUTĖ;1211005513;Ne;0;2;0;2
3524;Karuselė;BITUTĖ;2160071272;Ne;0;5;0;5
3525;Karuselė;BITUTĖ;1691769088;Ne;0;6;0;6
3526;Karuselė;BITUTĖ;7167895711;Ne;5;2;0;7
3527;Karuselė;BITUTĖ;3116403256;Ne;0;2;0;2
3528;Karuselė;BITUTĖ;4435125556;Ne;0;5;0;5
3529;Karuselė;BITUTĖ;3049506194;Ne;0;1;0;1
3530;Karuselė;BITUTĖ;7733032142;Ne;0;1;0;1
3531;Karuselė;BORUŽĖLĖ;1705790474;Ne;5;5;0;10
3532;Karuselė;BORUŽĖLĖ;8608177987;Ne;0;2;0;2
3533;Karuselė;BORUŽĖLĖ;1311907441;Ne;9;4;0;13
3534;Karuselė;BORUŽĖLĖ;6313010762;Ne;5;2;2;9
3535;Karuselė;BORUŽĖLĖ;5859827168;Ne;6;0;1;7
3536;Karuselė;BORUŽĖLĖ;37349219339;Ne;0;1;0;1
3537;Karuselė;BORUŽĖLĖ;6811862463;Ne;3;10;0;13
3538;Karuselė;BORUŽĖLĖ;5471989295;Ne;18;0;0;18
3539;Karuselė;BORUŽĖLĖ;9753876554;Ne;9;0;2;11
3540;Karuselė;BORUŽĖLĖ;8717484092;Ne;4;2;0;6
3541;Karuselė;BORUŽĖLĖ;1994682683;Ne;11;1;0;12
3542;Karuselė;BORUŽĖLĖ;5632697184;Ne;7;5;1;13
3543;Karuselė;BORUŽĖLĖ;2247913568;Ne;1;5;1;7
3544;Karuselė;BORUŽĖLĖ;4262640017;Ne;5;2;0;7
3545;Karuselė;BORUŽĖLĖ;8406462155;Ne;0;1;1;2
3546;Karuselė;BORUŽĖLĖ;6495631086;Ne;2;2;0;4
3547;Karuselė;BORUŽĖLĖ;1183484176;Ne;0;0;3;3
3548;Karuselė;BORUŽĖLĖ;3389843421;Ne;12;1;0;13
3549;Karuselė;BORUŽĖLĖ;4818655110;Ne;8;0;0;8
3550;Karuselė;UOGELĖ;9805481603;Ne;5;1;0;6
3551;Karuselė;UOGELĖ;9992989896;Ne;0;9;0;9
3552;Karuselė;UOGELĖ;2084276906;Ne;5;1;0;6
3553;Karuselė;UOGELĖ;8665314366;Ne;0;12;0;12
3554;Karuselė;UOGELĖ;5504719953;Ne;0;12;0;12
3555;Karuselė;UOGELĖ;5919009583;Ne;21;0;0;21
3556;Karuselė;UOGELĖ;4199597984;Ne;0;7;0;7
3557;Karuselė;UOGELĖ;2383023280;Ne;5;4;0;9
3558;Karuselė;UOGELĖ;1575408822;Ne;0;4;0;4
3559;Karuselė;UOGELĖ;3917113787;Ne;0;2;0;2
3560;Karuselė;UOGELĖ;4638918427;Ne;0;8;0;8
3561;Karuselė;UOGELĖ;3615957761;Ne;11;1;0;12
3562;Karuselė;UOGELĖ;3514026443;Ne;8;0;0;8
3563;Karuselė;UOGELĖ;1891147022;Ne;0;3;5;8
3564;Karuselė;UOGELĖ;9389017016;Ne;0;1;0;1
3565;Karuselė;UOGELĖ;3872322338;Ne;0;4;0;4
3566;Karuselė;UOGELĖ;3963576314;Ne;0;4;10;14
3567;Karuselė;GINTARĖLIS;3773170060;Ne;7;2;0;9
3568;Karuselė;GINTARĖLIS;3904453423;Ne;0;10;0;10
3569;Karuselė;GINTARĖLIS;7489136297;Ne;0;8;0;8
3570;Karuselė;GINTARĖLIS;3534074990;Ne;0;10;0;10
3571;Karuselė;GINTARĖLIS;7540323186;Ne;5;1;1;7
3572;Karuselė;GINTARĖLIS;1019322763;Ne;7;0;2;9
3573;Karuselė;GINTARĖLIS;8481143199;Ne;0;0;2;2
3574;Karuselė;GINTARĖLIS;3157893936;Ne;8;0;0;8
3575;Karuselė;GINTARĖLIS;8409412605;Ne;0;11;1;12
3576;Karuselė;GINTARĖLIS;3136606610;Ne;0;13;0;13
3577;Karuselė;GINTARĖLIS;2688863117;Ne;0;4;0;4
3578;Karuselė;GINTARĖLIS;7439791054;Ne;5;4;5;14
3579;Karuselė;GINTARĖLIS;3696384277;Ne;4;0;2;6
3580;Karuselė;GINTARĖLIS;2945027875;Ne;4;0;0;4
3581;Karuselė;GINTARĖLIS;8855096080;Ne;0;2;5;7
3582;Karuselė;GINTARĖLIS;9116238924;Ne;0;0;3;3
3583;Karuselė;GINTARĖLIS;6433987745;Ne;0;0;2;2
3584;Karuselė;GINTARĖLIS;9479962436;Ne;9;0;0;9
3585;Karuselė;GINTARĖLIS;6232570825;Ne;0;3;0;3
3586;Karuselė;GINTARĖLIS;3460470459;Ne;0;4;0;4
3587;Karuselė;SAULUTĖ;5627583683;Ne;13;0;0;13
3588;Karuselė;SAULUTĖ;2242659064;Ne;0;12;0;12
3589;Karuselė;SAULUTĖ;5704218177;Ne;0;4;0;4
3590;Karuselė;SAULUTĖ;5146709341;Ne;0;2;0;2
3591;Karuselė;SAULUTĖ;7814525717;Ne;0;2;0;2
3592;Karuselė;SAULUTĖ;9996567374;Ne;0;7;0;7
3593;Karuselė;SAULUTĖ;8331985564;Ne;0;2;0;2
3594;Karuselė;SAULUTĖ;9400171357;Ne;0;4;0;4
3595;Karuselė;SAULUTĖ;9656723409;Ne;4;1;0;5
3596;Karuselė;SAULUTĖ;5803808409;Ne;0;14;0;14
3597;Karuselė;SAULUTĖ;3149575456;Ne;9;0;0;9
3598;Karuselė;SAULUTĖ;5640656442;Ne;0;5;1;6
3599;Karuselė;SAULUTĖ;9451789237;Ne;15;1;0;16
3600;Karuselė;SAULUTĖ;9450841251;Ne;16;1;0;17
3601;Karuselė;SAULUTĖ;6338379641;Ne;5;3;0;8
3602;Karuselė;SAULUTĖ;8830559511;Ne;1;0;0;1
3603;Karuselė;SAULUTĖ;3228100488;Ne;6;0;4;10
3604;Karuselė;TIGRIUKAS;8946147763;Ne;0;6;0;6
3605;Karuselė;TIGRIUKAS;8076851284;Ne;3;1;0;4
3606;Karuselė;TIGRIUKAS;4426462711;Ne;10;0;0;10
3607;Karuselė;TIGRIUKAS;9484773068;Ne;0;2;0;2
3608;Karuselė;TIGRIUKAS;1698478530;Ne;4;5;0;9
3609;Karuselė;TIGRIUKAS;9561892809;Ne;8;1;0;9
3610;Karuselė;TIGRIUKAS;9726299722;Ne;0;8;0;8
3611;Karuselė;TIGRIUKAS;1576201225;Ne;0;4;0;4
3612;Karuselė;TIGRIUKAS;9344514262;Ne;10;0;0;10
3613;Karuselė;TIGRIUKAS;9065247151;Ne;4;4;2;10
3614;Karuselė;TIGRIUKAS;7131255599;Ne;1;7;0;8
3615;Karuselė;TIGRIUKAS;4180604225;Ne;1;7;0;8
3616;Karuselė;TIGRIUKAS;2397938004;Ne;5;5;0;10
3617;Karuselė;TIGRIUKAS;3605966015;Ne;4;0;0;4
3618;Karuselė;TIGRIUKAS;9633656827;Ne;2;0;0;2
3619;Karuselė;TIGRIUKAS;9252093125;Ne;5;1;1;7
3620;Karuselė;TIGRIUKAS;5176597751;Ne;3;1;0;4
3621;Karuselė;TIGRIUKAS;6656808100;Ne;4;0;0;4
3622;Karuselė;VAIVORYKŠTĖ;1289442716;Ne;8;0;1;9
3623;Karuselė;VAIVORYKŠTĖ;9855242602;Ne;0;0;1;1
3624;Karuselė;VAIVORYKŠTĖ;6546648346;Ne;0;10;0;10
3625;Karuselė;VAIVORYKŠTĖ;8063412271;Ne;14;4;0;18
3626;Karuselė;VAIVORYKŠTĖ;3514315636;Ne;4;1;0;5
3627;Karuselė;VAIVORYKŠTĖ;8085919723;Ne;4;1;0;5
3628;Karuselė;VAIVORYKŠTĖ;5444753290;Ne;0;10;0;10
3629;Karuselė;VAIVORYKŠTĖ;1581504806;Ne;16;0;0;16
3630;Karuselė;VAIVORYKŠTĖ;2215367063;Ne;8;1;0;9
3631;Karuselė;VAIVORYKŠTĖ;6424622497;Ne;9;4;1;14
3632;Karuselė;VAIVORYKŠTĖ;5855430678;Ne;6;1;0;7
3633;Karuselė;VAIVORYKŠTĖ;5128774216;Ne;0;6;0;6
3634;Karuselė;VAIVORYKŠTĖ;1604997207;Ne;10;4;0;14
3635;Karuselė;VAIVORYKŠTĖ;2757263085;Ne;0;1;1;2
3636;Karuselė;VAIVORYKŠTĖ;4110024673;Ne;0;6;0;6
3637;Karuselė;VAIVORYKŠTĖ;9400856559;Ne;10;6;0;16
3638;Karuselė;VAIVORYKŠTĖ;1083786182;Ne;10;6;0;16
3639;Karuselė;VAIVORYKŠTĖ;5998868204;Ne;0;1;1;2
3640;Karuselė;VAIVORYKŠTĖ;6734936247;Ne;0;4;0;4
3641;Karuselė;VAIVORYKŠTĖ;3082636224;Ne;7;1;0;8
3642;Karuselė;VAIVORYKŠTĖ;4749086136;Ne;11;1;0;12
3643;Karuselė;"AUKSINĖ ŽUVELĖ";2993499990;Ne;9;0;0;9
3644;Karuselė;"AUKSINĖ ŽUVELĖ";3622914118;Ne;0;2;0;2
3645;Karuselė;"AUKSINĖ ŽUVELĖ";8671884362;Ne;5;1;0;6
3646;Karuselė;"AUKSINĖ ŽUVELĖ";6341570221;Ne;6;0;1;7
3647;Karuselė;"AUKSINĖ ŽUVELĖ";2135332292;Ne;5;0;0;5
3648;Karuselė;"AUKSINĖ ŽUVELĖ";8441520423;Ne;0;0;2;2
3649;Karuselė;"AUKSINĖ ŽUVELĖ";9463553056;Ne;0;1;0;1
3650;Karuselė;"AUKSINĖ ŽUVELĖ";4566201460;Ne;3;0;2;5
3651;Karuselė;"AUKSINĖ ŽUVELĖ";3551143062;Ne;5;1;1;7
3652;Karuselė;"AUKSINĖ ŽUVELĖ";8257771271;Ne;0;3;0;3
3653;Karuselė;"AUKSINĖ ŽUVELĖ";7749015193;Ne;0;9;0;9
3654;Karuselė;"AUKSINĖ ŽUVELĖ";3075592618;Ne;0;0;3;3
3655;Karuselė;"AUKSINĖ ŽUVELĖ";2450390957;Ne;10;4;0;14
3656;Karuselė;"AUKSINĖ ŽUVELĖ";4871960780;Ne;17;0;0;17
3657;Karuselė;"AUKSINĖ ŽUVELĖ";8848085495;Ne;8;3;0;11
3658;Karuselė;RAMUNĖ;8362740639;Ne;0;2;2;4
3659;Karuselė;RAMUNĖ;4302662341;Ne;0;12;0;12
3660;Karuselė;RAMUNĖ;9415377698;Ne;0;2;0;2
3661;Karuselė;RAMUNĖ;8474027736;Ne;5;3;0;8
3662;Karuselė;RAMUNĖ;9394220081;Ne;18;0;0;18
3663;Karuselė;RAMUNĖ;7535451590;Ne;0;7;0;7
3664;Karuselė;RAMUNĖ;4865727149;Ne;17;0;0;17
3665;Karuselė;RAMUNĖ;2842034472;Ne;5;4;0;9
3666;Karuselė;RAMUNĖ;8952114853;Ne;0;6;5;11
3667;Karuselė;RAMUNĖ;4757820179;Ne;12;1;0;13
3668;Karuselė;RAMUNĖ;9649615834;Ne;5;0;5;10
3669;Karuselė;RAMUNĖ;3885475525;Ne;17;0;0;17
3670;Karuselė;RAMUNĖ;4196250786;Ne;10;3;0;13
3671;Karuselė;RAMUNĖ;2260731421;Ne;0;2;1;3
3672;Karuselė;VILKELIS;1412890120;Ne;0;15;0;15
3673;Karuselė;VILKELIS;4951249625;Ne;0;0;3;3
3674;Karuselė;VILKELIS;4130693235;Ne;0;1;8;9
3675;Karuselė;VILKELIS;8012963667;Ne;0;4;0;4
3676;Karuselė;VILKELIS;9340167973;Ne;4;2;0;6
3677;Karuselė;VILKELIS;9985033530;Ne;0;0;1;1
3678;Karuselė;VILKELIS;6826455161;Ne;0;2;0;2
3679;Karuselė;VILKELIS;2727440190;Ne;2;0;1;3
3680;Karuselė;VILKELIS;5802996641;Taip;0;1;0;1
3681;Karuselė;VILKELIS;2306922755;Ne;0;4;0;4
3682;Karuselė;VILKELIS;4103816990;Ne;0;0;1;1
3683;Karuselė;VILKELIS;4325959483;Ne;0;4;0;4
3684;Karuselė;VILKELIS;3271464159;Taip;0;1;0;1
3685;Karuselė;VILKELIS;6062361348;Ne;0;2;2;4
3686;Karuselė;VILKELIS;7501323454;Ne;0;4;4;8
3687;Karuselė;VILKELIS;6785226197;Ne;0;1;0;1
3688;Kaštonas;NYKŠTUKAI;7703842464;Ne;0;0;6;6
3689;Kaštonas;NYKŠTUKAI;1262404954;Ne;0;0;7;7
3690;Kaštonas;NYKŠTUKAI;6254250706;Ne;0;0;7;7
3691;Kaštonas;NYKŠTUKAI;8145965849;Ne;5;7;0;12
3692;Kaštonas;NYKŠTUKAI;8775608339;Ne;0;3;0;3
3693;Kaštonas;NYKŠTUKAI;6613837801;Ne;0;0;1;1
3694;Kaštonas;NYKŠTUKAI;6934262510;Ne;0;10;0;10
3695;Kaštonas;NYKŠTUKAI;6589898580;Ne;11;0;1;12
3696;Kaštonas;NYKŠTUKAI;4824511567;Ne;8;5;0;13
3697;Kaštonas;NYKŠTUKAI;4384907654;Ne;9;2;0;11
3698;Kaštonas;NYKŠTUKAI;3961661158;Ne;0;7;0;7
3699;Kaštonas;NYKŠTUKAI;8318869054;Ne;4;4;0;8
3700;Kaštonas;NYKŠTUKAI;2434765663;Ne;0;4;0;4
3701;Kaštonas;NYKŠTUKAI;2178971789;Ne;5;3;0;8
3702;Kaštonas;NYKŠTUKAI;4444087861;Ne;13;0;0;13
3703;Kaštonas;NYKŠTUKAI;9379171183;Ne;0;0;1;1
3704;Kaštonas;NYKŠTUKAI;9014726465;Ne;5;3;0;8
3705;Kaštonas;NYKŠTUKAI;2361839733;Ne;3;5;0;8
3706;Kaštonas;NYKŠTUKAI;3383390078;Ne;0;8;0;8
3707;Kaštonas;DRUGELIAI;8486955652;Ne;4;9;0;13
3708;Kaštonas;DRUGELIAI;2106924435;Ne;0;5;0;5
3709;Kaštonas;DRUGELIAI;8483888152;Ne;0;4;0;4
3710;Kaštonas;DRUGELIAI;3059036526;Ne;0;2;0;2
3711;Kaštonas;DRUGELIAI;2165890763;Ne;0;2;0;2
3712;Kaštonas;DRUGELIAI;7408901858;Ne;6;1;0;7
3713;Kaštonas;DRUGELIAI;5099098185;Ne;0;1;0;1
3714;Kaštonas;DRUGELIAI;8582453109;Ne;0;2;0;2
3715;Kaštonas;DRUGELIAI;2832688622;Ne;0;11;0;11
3716;Kaštonas;DRUGELIAI;9061158412;Ne;0;11;0;11
3717;Kaštonas;DRUGELIAI;9168456496;Ne;0;4;0;4
3718;Kaštonas;DRUGELIAI;5884427036;Ne;0;6;0;6
3719;Kaštonas;DRUGELIAI;1141693073;Ne;0;1;0;1
3720;Kaštonas;DRUGELIAI;6251564828;Ne;0;1;0;1
3721;Kaštonas;DRUGELIAI;1249299633;Ne;3;1;0;4
3722;Kaštonas;DRUGELIAI;5969052108;Ne;16;0;0;16
3723;Kaštonas;DRUGELIAI;8166925991;Ne;0;13;0;13
3724;Kaštonas;DRUGELIAI;4215759647;Ne;0;7;0;7
3725;Kaštonas;DRUGELIAI;5307755844;Ne;3;3;0;6
3726;Kaštonas;DRUGELIAI;9985164505;Ne;13;9;0;22
3727;Kaštonas;DRUGELIAI;2417951642;Ne;0;4;0;4
3728;Kaštonas;DRUGELIAI;8257643251;Ne;7;7;0;14
3729;Kaštonas;KIŠKUČIAI;2020612346;Ne;7;0;0;7
3730;Kaštonas;KIŠKUČIAI;6585977073;Ne;14;4;0;18
3731;Kaštonas;KIŠKUČIAI;1761520786;Ne;9;1;0;10
3732;Kaštonas;KIŠKUČIAI;9298372326;Ne;0;5;0;5
3733;Kaštonas;KIŠKUČIAI;9778140363;Ne;6;4;0;10
3734;Kaštonas;KIŠKUČIAI;8250964197;Ne;0;10;0;10
3735;Kaštonas;KIŠKUČIAI;7290414209;Ne;0;6;0;6
3736;Kaštonas;KIŠKUČIAI;9356018629;Ne;7;1;0;8
3737;Kaštonas;KIŠKUČIAI;4115242811;Ne;7;3;0;10
3738;Kaštonas;KIŠKUČIAI;1684641447;Ne;12;2;0;14
3739;Kaštonas;KIŠKUČIAI;1207372235;Ne;0;5;0;5
3740;Kaštonas;KIŠKUČIAI;4570064071;Ne;5;0;2;7
3741;Kaštonas;KIŠKUČIAI;4020980625;Ne;0;1;0;1
3742;Kaštonas;KIŠKUČIAI;2898327157;Ne;6;0;1;7
3743;Kaštonas;KIŠKUČIAI;9320223622;Ne;0;7;0;7
3744;Kaštonas;KIŠKUČIAI;3544696101;Ne;1;3;0;4
3745;Kaštonas;BITUTĖS;7946379086;Ne;0;0;5;5
3746;Kaštonas;BITUTĖS;9285927858;Ne;6;10;0;16
3747;Kaštonas;BITUTĖS;5328263421;Ne;0;4;0;4
3748;Kaštonas;BITUTĖS;9903176616;Ne;8;0;0;8
3749;Kaštonas;BITUTĖS;4033866425;Ne;18;3;0;21
3750;Kaštonas;BITUTĖS;4061364544;Ne;9;0;0;9
3751;Kaštonas;BITUTĖS;8275673303;Ne;0;1;0;1
3752;Kaštonas;BITUTĖS;1614180834;Ne;5;0;1;6
3753;Kaštonas;BITUTĖS;6711295699;Ne;8;3;0;11
3754;Kaštonas;BITUTĖS;2877124424;Ne;0;9;0;9
3755;Kaštonas;BITUTĖS;1031628633;Ne;10;1;0;11
3756;Kaštonas;BITUTĖS;4551111709;Ne;10;1;0;11
3757;Kaštonas;BITUTĖS;8906976150;Ne;0;5;0;5
3758;Kaštonas;BITUTĖS;8151333699;Ne;10;6;0;16
3759;Kaštonas;BITUTĖS;8152577445;Ne;4;0;2;6
3760;Kaštonas;BITUTĖS;7291448857;Ne;10;2;0;12
3761;Kaštonas;BITUTĖS;4837002666;Ne;7;0;4;11
3762;Kaštonas;BITUTĖS;6175014441;Ne;5;0;0;5
3763;Kaštonas;BITUTĖS;1748975865;Ne;5;1;0;6
3764;Kaštonas;MEŠKIUKAI;2228759708;Ne;0;0;1;1
3765;Kaštonas;MEŠKIUKAI;5350239917;Ne;4;5;0;9
3766;Kaštonas;MEŠKIUKAI;7956422880;Ne;8;6;0;14
3767;Kaštonas;MEŠKIUKAI;3554337770;Ne;0;1;0;1
3768;Kaštonas;MEŠKIUKAI;6289073634;Ne;0;9;0;9
3769;Kaštonas;MEŠKIUKAI;4616084852;Ne;0;5;0;5
3770;Kaštonas;MEŠKIUKAI;1801371129;Ne;0;4;0;4
3771;Kaštonas;MEŠKIUKAI;5157500600;Ne;4;1;0;5
3772;Kaštonas;MEŠKIUKAI;6606094891;Ne;0;8;0;8
3773;Kaštonas;MEŠKIUKAI;1364391105;Ne;0;5;0;5
3774;Kaštonas;MEŠKIUKAI;6967725663;Ne;6;8;0;14
3775;Kaštonas;MEŠKIUKAI;4308169582;Ne;4;2;1;7
3776;Kaštonas;MEŠKIUKAI;1196590128;Ne;0;2;2;4
3777;Kaštonas;BORUŽĖLĖS;1501441973;Ne;12;0;0;12
3778;Kaštonas;BORUŽĖLĖS;1612086010;Ne;13;1;0;14
3779;Kaštonas;BORUŽĖLĖS;1027896631;Ne;0;5;0;5
3780;Kaštonas;BORUŽĖLĖS;9034859988;Ne;9;1;0;10
3781;Kaštonas;BORUŽĖLĖS;9249007247;Ne;7;17;0;24
3782;Kaštonas;BORUŽĖLĖS;2057499534;Ne;13;0;0;13
3783;Kaštonas;BORUŽĖLĖS;6896372095;Ne;10;4;0;14
3784;Kaštonas;BORUŽĖLĖS;1976138680;Ne;5;6;0;11
3785;Kaštonas;BORUŽĖLĖS;9807554365;Ne;0;3;0;3
3786;Kaštonas;BORUŽĖLĖS;4708114402;Ne;6;4;0;10
3787;Kaštonas;BORUŽĖLĖS;7992154554;Ne;0;4;2;6
3788;Kaštonas;BORUŽĖLĖS;4641535612;Ne;0;14;0;14
3789;Kaštonas;BORUŽĖLĖS;7383219978;Ne;11;4;0;15
3790;Kaštonas;BORUŽĖLĖS;3251132542;Ne;3;0;0;3
3791;Kaštonas;BORUŽĖLĖS;6425908247;Ne;12;0;0;12
3792;Kaštonas;BORUŽĖLĖS;3860613494;Ne;4;8;0;12
3793;Kaštonas;BORUŽĖLĖS;5948707303;Ne;0;21;0;21
3794;Kaštonas;BORUŽĖLĖS;7698074598;Ne;25;1;1;27
3795;Kaštonas;BORUŽĖLĖS;6749679348;Ne;11;0;0;11
3796;Kaštonas;BORUŽĖLĖS;5060824071;Ne;11;2;0;13
3797;Kaštonas;BITUTĖS;3279850526;Ne;4;0;0;4
3798;"Krivūlė (Lydos g. 5)";SPINDULIUKAI;3913058095;Ne;11;0;0;11
3799;"Krivūlė (Lydos g. 5)";SPINDULIUKAI;1840809151;Ne;3;0;0;3
3800;"Krivūlė (Lydos g. 5)";SPINDULIUKAI;7335245963;Ne;3;0;0;3
3801;"Krivūlė (Lydos g. 5)";SPINDULIUKAI;5802739148;Ne;0;11;0;11
3802;"Krivūlė (Lydos g. 5)";SPINDULIUKAI;5667934115;Ne;0;4;1;5
3803;"Krivūlė (Lydos g. 5)";SPINDULIUKAI;7155162698;Ne;0;4;5;9
3804;"Krivūlė (Lydos g. 5)";SPINDULIUKAI;1151179495;Ne;0;0;1;1
3805;"Krivūlė (Lydos g. 5)";SPINDULIUKAI;9320613086;Ne;15;0;4;19
3806;"Krivūlė (Lydos g. 5)";SPINDULIUKAI;4750075323;Ne;9;0;0;9
3807;"Krivūlė (Lydos g. 5)";SPINDULIUKAI;3852793979;Ne;4;4;0;8
3808;"Krivūlė (Lydos g. 5)";SPINDULIUKAI;3184820008;Ne;11;0;1;12
3809;"Krivūlė (Lydos g. 5)";SPINDULIUKAI;7149268223;Ne;0;0;5;5
3810;"Krivūlė (Lydos g. 5)";SPINDULIUKAI;7025398689;Ne;0;21;0;21
3811;"Krivūlė (Lydos g. 5)";BORUŽĖLĖS;3605506478;Ne;0;0;1;1
3812;"Krivūlė (Lydos g. 5)";BORUŽĖLĖS;4896656209;Ne;0;0;1;1
3813;"Krivūlė (Lydos g. 5)";BORUŽĖLĖS;4845515196;Ne;13;0;0;13
3814;"Krivūlė (Lydos g. 5)";BORUŽĖLĖS;5676562063;Ne;2;0;0;2
3815;"Krivūlė (Lydos g. 5)";BORUŽĖLĖS;6935969502;Ne;5;0;0;5
3816;"Krivūlė (Lydos g. 5)";BORUŽĖLĖS;4972360440;Ne;0;0;3;3
3817;"Krivūlė (Lydos g. 5)";BORUŽĖLĖS;7318064702;Ne;15;0;2;17
3818;"Krivūlė (Lydos g. 5)";BORUŽĖLĖS;3912620138;Ne;0;0;7;7
3819;"Krivūlė (Lydos g. 5)";BORUŽĖLĖS;3246787504;Ne;0;0;3;3
3820;"Krivūlė (Lydos g. 5)";BORUŽĖLĖS;2386053480;Ne;0;0;5;5
3821;"Krivūlė (Lydos g. 5)";BORUŽĖLĖS;4540069843;Ne;18;0;0;18
3822;"Krivūlė (Lydos g. 5)";BORUŽĖLĖS;4297876008;Ne;0;1;0;1
3823;"Krivūlė (Lydos g. 5)";BORUŽĖLĖS;2138125571;Ne;0;4;1;5
3824;"Krivūlė (Lydos g. 5)";BORUŽĖLĖS;4177660973;Ne;0;4;0;4
3825;"Krivūlė (Lydos g. 5)";BORUŽĖLĖS;2711010212;Ne;0;3;8;11
3826;"Krivūlė (Lydos g. 5)";BORUŽĖLĖS;4025821636;Ne;3;0;0;3
3827;"Krivūlė (Lydos g. 5)";BORUŽĖLĖS;7781918674;Ne;0;2;0;2
3828;"Krivūlė (Lydos g. 5)";DRUGELIŲ;5966543639;Ne;0;0;15;15
3829;"Krivūlė (Lydos g. 5)";DRUGELIŲ;6004925249;Ne;0;4;1;5
3830;"Krivūlė (Lydos g. 5)";DRUGELIŲ;5818988913;Ne;0;3;7;10
3831;"Krivūlė (Lydos g. 5)";DRUGELIŲ;7873123757;Ne;0;7;0;7
3832;"Krivūlė (Lydos g. 5)";DRUGELIŲ;19674882649;Ne;0;4;1;5
3833;"Krivūlė (Lydos g. 5)";DRUGELIŲ;2903062788;Ne;0;0;3;3
3834;"Krivūlė (Lydos g. 5)";DRUGELIŲ;10005041572;Ne;0;5;0;5
3835;"Krivūlė (Lydos g. 5)";DRUGELIŲ;2109315338;Ne;0;0;1;1
3836;"Krivūlė (Lydos g. 5)";DRUGELIŲ;6861483854;Ne;19;0;0;19
3837;"Krivūlė (Lydos g. 5)";DRUGELIŲ;1515185307;Ne;0;5;4;9
3838;"Krivūlė (Lydos g. 5)";DRUGELIŲ;9267414141;Ne;0;4;0;4
3839;"Krivūlė (Lydos g. 5)";DRUGELIŲ;9311270695;Ne;0;1;1;2
3840;"Krivūlė (Lydos g. 5)";DRUGELIŲ;6753080815;Ne;0;4;4;8
3841;"Krivūlė (Lydos g. 5)";DRUGELIŲ;4261133734;Ne;0;1;2;3
3842;"Krivūlė (Lydos g. 5)";DRUGELIŲ;6429160371;Ne;0;10;2;12
3843;"Krivūlė (Lydos g. 5)";DRUGELIŲ;3924127476;Ne;5;4;0;9
3844;"Krivūlė (Lydos g. 5)";"BITUTĖS (VALDOFRO)";18486357195;Ne;0;2;0;2
3845;"Krivūlė (Lydos g. 5)";"BITUTĖS (VALDOFRO)";3769812444;Ne;0;1;0;1
3846;"Krivūlė (Lydos g. 5)";"BITUTĖS (VALDOFRO)";5128760019;Ne;0;1;0;1
3847;"Krivūlė (Lydos g. 5)";"BITUTĖS (VALDOFRO)";7789248863;Ne;0;1;2;3
3848;"Krivūlė (Lydos g. 5)";"BITUTĖS (VALDOFRO)";5113297248;Ne;0;4;3;7
3849;"Krivūlė (Lydos g. 5)";"BITUTĖS (VALDOFRO)";7848471009;Ne;0;0;3;3
3850;"Krivūlė (Lydos g. 5)";"BITUTĖS (VALDOFRO)";5405660104;Ne;1;4;1;6
3851;"Krivūlė (Lydos g. 5)";"BITUTĖS (VALDOFRO)";8834855616;Ne;1;3;0;4
3852;"Krivūlė (Lydos g. 5)";"BITUTĖS (VALDOFRO)";3655576855;Ne;0;0;2;2
3853;"Krivūlė (Lydos g. 5)";"BITUTĖS (VALDOFRO)";1561180871;Ne;0;9;0;9
3854;"Krivūlė (Lydos g. 5)";"BITUTĖS (VALDOFRO)";9702372816;Ne;0;0;6;6
3855;"Krivūlė (Lydos g. 5)";"BITUTĖS (VALDOFRO)";4619224314;Ne;0;21;0;21
3856;"Krivūlė (Lydos g. 5)";"BITUTĖS (VALDOFRO)";1932209134;Ne;0;0;3;3
3857;"Krivūlė (Lydos g. 5)";"BITUTĖS (VALDOFRO)";7768827505;Ne;0;0;5;5
3858;"Krivūlė (Lydos g. 5)";"BITUTĖS (VALDOFRO)";7199431924;Ne;0;0;2;2
3859;"Krivūlė (Lydos g. 5)";"BITUTĖS (VALDOFRO)";7714519095;Ne;12;0;0;12
3860;"Krivūlė (Lydos g. 5)";"BITUTĖS (VALDOFRO)";6365743037;Ne;0;1;1;2
3861;"Krivūlė (Lydos g. 5)";"BITUTĖS (VALDOFRO)";6217494808;Ne;0;4;2;6
3862;"Krivūlė (Lydos g. 5)";EŽIUKAI;8042185027;Ne;5;0;1;6
3863;"Krivūlė (Lydos g. 5)";EŽIUKAI;7242596817;Ne;0;0;3;3
3864;"Krivūlė (Lydos g. 5)";EŽIUKAI;5369083173;Ne;0;21;0;21
3865;"Krivūlė (Lydos g. 5)";EŽIUKAI;3144577262;Ne;5;0;2;7
3866;"Krivūlė (Lydos g. 5)";EŽIUKAI;1898389557;Ne;0;0;2;2
3867;"Krivūlė (Lydos g. 5)";EŽIUKAI;6830712749;Ne;6;0;3;9
3868;"Krivūlė (Lydos g. 5)";EŽIUKAI;8873132189;Ne;0;0;9;9
3869;"Krivūlė (Lydos g. 5)";EŽIUKAI;2430372719;Ne;0;3;0;3
3870;"Krivūlė (Lydos g. 5)";EŽIUKAI;1893542120;Ne;0;21;0;21
3871;"Krivūlė (Lydos g. 5)";EŽIUKAI;1622229289;Ne;0;0;6;6
3872;"Krivūlė (Lydos g. 5)";EŽIUKAI;2157856704;Ne;0;0;1;1
3873;"Krivūlė (Lydos g. 5)";NYKŠTUKAI;9820383193;Ne;0;4;1;5
3874;"Krivūlė (Lydos g. 5)";NYKŠTUKAI;2742783991;Ne;0;1;3;4
3875;"Krivūlė (Lydos g. 5)";NYKŠTUKAI;9401810791;Ne;0;0;4;4
3876;"Krivūlė (Lydos g. 5)";NYKŠTUKAI;8713384668;Ne;0;21;0;21
3877;"Krivūlė (Lydos g. 5)";NYKŠTUKAI;9553953446;Ne;0;0;3;3
3878;"Krivūlė (Lydos g. 5)";NYKŠTUKAI;5268832682;Ne;20;0;1;21
3879;"Krivūlė (Lydos g. 5)";NYKŠTUKAI;8767554721;Ne;0;1;0;1
3880;"Krivūlė (Lydos g. 5)";NYKŠTUKAI;9529242858;Ne;3;0;0;3
3881;"Krivūlė (Lydos g. 5)";NYKŠTUKAI;8898023612;Ne;0;0;1;1
3882;"Krivūlė (Lydos g. 5)";NYKŠTUKAI;5768244312;Ne;6;1;0;7
3883;"Krivūlė (Lydos g. 5)";NYKŠTUKAI;5870153336;Ne;0;4;1;5
3884;"Krivūlė (Lydos g. 5)";NYKŠTUKAI;7540940063;Ne;0;4;2;6
3885;"Krivūlė (Lydos g. 5)";NYKŠTUKAI;7262017017;Ne;0;1;0;1
3886;"Krivūlė (Lydos g. 5)";NYKŠTUKAI;9773092651;Ne;0;0;5;5
3887;"Krivūlė (Lydos g. 5)";NYKŠTUKAI;6548893885;Ne;0;0;21;21
3888;"Krivūlė (Lydos g. 5)";NYKŠTUKAI;8674468359;Ne;0;21;0;21
3889;"Krivūlė (Lydos g. 5)";NYKŠTUKAI;8047735389;Ne;3;0;0;3
3890;Kodėlčiukas;Saulutės;1725624698;Ne;5;1;0;6
3891;Kodėlčiukas;Saulutės;7509476161;Ne;0;0;1;1
3892;Kodėlčiukas;Saulutės;7327247516;Ne;10;0;0;10
3893;Kodėlčiukas;Saulutės;1645680526;Ne;0;1;0;1
3894;Kodėlčiukas;Saulutės;8992265000;Ne;0;0;1;1
3895;Kodėlčiukas;Saulutės;6285018663;Ne;0;3;0;3
3896;Kodėlčiukas;Saulutės;1033969800;Ne;10;0;0;10
3897;Kodėlčiukas;Saulutės;2433094435;Ne;0;1;0;1
3898;Kodėlčiukas;Saulutės;9042404309;Ne;0;4;2;6
3899;Kodėlčiukas;Saulutės;3276075664;Ne;9;0;0;9
3900;Kodėlčiukas;Saulutės;9476376350;Ne;1;0;1;2
3901;Kodėlčiukas;Saulutės;7611485881;Ne;0;4;0;4
3902;Kodėlčiukas;Saulutės;7561763602;Ne;11;0;1;12
3903;Kodėlčiukas;Saulutės;6476445296;Ne;0;3;0;3
3904;Kodėlčiukas;Saulutės;1992569595;Ne;2;0;0;2
3905;Kodėlčiukas;Saulutės;9527296531;Ne;6;0;10;16
3906;Kodėlčiukas;Saulutės;8447045958;Ne;5;2;1;8
3907;Kodėlčiukas;Saulutės;2542104903;Ne;0;6;0;6
3908;Kodėlčiukas;Nežiniukai;6045564826;Ne;0;0;1;1
3909;Kodėlčiukas;Nežiniukai;7971932716;Ne;7;0;0;7
3910;Kodėlčiukas;Nežiniukai;7282579315;Ne;0;0;1;1
3911;Kodėlčiukas;Nežiniukai;6905424567;Ne;3;0;1;4
3912;Kodėlčiukas;Nežiniukai;5443377251;Ne;0;4;0;4
3913;Kodėlčiukas;Nežiniukai;3150006441;Ne;10;0;1;11
3914;Kodėlčiukas;Nežiniukai;7626940433;Ne;0;9;0;9
3915;Kodėlčiukas;Nežiniukai;4917910801;Ne;0;1;0;1
3916;Kodėlčiukas;Nežiniukai;3473981974;Ne;0;0;1;1
3917;Kodėlčiukas;Nežiniukai;4038168647;Ne;10;3;0;13
3918;Kodėlčiukas;Nežiniukai;8378295683;Ne;14;0;3;17
3919;Kodėlčiukas;Nežiniukai;6000831611;Ne;0;4;0;4
3920;Kodėlčiukas;Nežiniukai;7286497455;Ne;5;4;1;10
3921;Kodėlčiukas;Nežiniukai;1603752483;Ne;0;0;3;3
3922;Kodėlčiukas;Nežiniukai;6074758814;Ne;0;11;0;11
3923;Kodėlčiukas;Nežiniukai;1699358514;Ne;0;10;2;12
3924;Kodėlčiukas;Nežiniukai;1302383608;Ne;0;0;8;8
3925;Kodėlčiukas;Nežiniukai;1160612316;Ne;10;4;0;14
3926;Kodėlčiukas;Nežiniukai;3470151604;Ne;0;0;2;2
3927;Kodėlčiukas;Nežiniukai;5729391456;Ne;11;5;1;17
3928;Kodėlčiukas;Gintarėliai;2560864315;Ne;5;1;1;7
3929;Kodėlčiukas;Gintarėliai;58406224468;Ne;0;4;9;13
3930;Kodėlčiukas;Gintarėliai;1485012710;Ne;0;2;0;2
3931;Kodėlčiukas;Gintarėliai;4884104023;Ne;0;4;6;10
3932;Kodėlčiukas;Gintarėliai;9332136116;Ne;2;1;0;3
3933;Kodėlčiukas;Gintarėliai;8219424737;Ne;0;4;0;4
3934;Kodėlčiukas;Gintarėliai;4849314647;Ne;0;2;0;2
3935;Kodėlčiukas;Gintarėliai;5202375085;Ne;0;5;0;5
3936;Kodėlčiukas;Gintarėliai;5093139270;Ne;5;2;1;8
3937;Kodėlčiukas;Gintarėliai;4738357524;Ne;0;0;10;10
3938;Kodėlčiukas;Gintarėliai;8873629130;Ne;5;4;0;9
3939;Kodėlčiukas;Gintarėliai;1190408818;Ne;0;4;17;21
3940;Kodėlčiukas;Gintarėliai;2162480212;Ne;0;1;0;1
3941;Kodėlčiukas;Gintarėliai;6764015170;Ne;6;7;0;13
3942;Kodėlčiukas;Gintarėliai;6248137523;Ne;0;4;0;4
3943;Kodėlčiukas;Šnekučiai;1844016431;Ne;10;0;0;10
3944;Kodėlčiukas;Šnekučiai;1935757837;Ne;16;0;0;16
3945;Kodėlčiukas;Šnekučiai;41123326737;Ne;4;2;2;8
3946;Kodėlčiukas;Šnekučiai;8114859362;Ne;0;16;0;16
3947;Kodėlčiukas;Šnekučiai;1666743304;Ne;0;3;0;3
3948;Kodėlčiukas;Šnekučiai;1432342305;Ne;0;1;2;3
3949;Kodėlčiukas;Šnekučiai;9178209049;Ne;0;5;1;6
3950;Kodėlčiukas;Šnekučiai;5988863934;Ne;0;4;0;4
3951;Kodėlčiukas;Šnekučiai;76164689333;Ne;3;1;0;4
3952;Kodėlčiukas;Šnekučiai;5386820408;Ne;0;2;0;2
3953;Kodėlčiukas;Šnekučiai;6194726931;Ne;0;7;0;7
3954;Kodėlčiukas;Šnekučiai;7074381835;Ne;0;7;0;7
3955;Kodėlčiukas;Šnekučiai;2988674717;Ne;0;6;3;9
3956;Kodėlčiukas;Šnekučiai;4273202718;Ne;0;4;0;4
3957;Kodėlčiukas;Šnekučiai;2244326972;Ne;0;2;3;5
3958;Kodėlčiukas;Šnekučiai;6761903865;Ne;0;1;0;1
3959;Kodėlčiukas;Šnekučiai;3778271049;Ne;10;4;0;14
3960;Kodėlčiukas;Šnekučiai;7647582987;Ne;0;4;2;6
3961;Kodėlčiukas;Šnekučiai;7510273691;Ne;4;2;0;6
3962;Kodėlčiukas;Pabiručiai;9278139998;Ne;6;1;0;7
3963;Kodėlčiukas;Pabiručiai;6008027505;Ne;7;4;0;11
3964;Kodėlčiukas;Pabiručiai;5894631257;Ne;7;0;1;8
3965;Kodėlčiukas;Pabiručiai;6065858518;Ne;10;0;0;10
3966;Kodėlčiukas;Pabiručiai;8586746296;Ne;5;2;0;7
3967;Kodėlčiukas;Pabiručiai;9480926599;Ne;16;1;0;17
3968;Kodėlčiukas;Pabiručiai;9511144369;Ne;8;3;2;13
3969;Kodėlčiukas;Pabiručiai;7246943802;Ne;10;0;2;12
3970;Kodėlčiukas;Pabiručiai;8189938439;Ne;5;0;1;6
3971;Kodėlčiukas;Pabiručiai;5587200800;Ne;0;0;2;2
3972;Kodėlčiukas;Pabiručiai;1433623973;Ne;10;0;0;10
3973;Kodėlčiukas;Pabiručiai;1087808091;Ne;0;11;1;12
3974;Kodėlčiukas;Pabiručiai;7570122834;Ne;18;0;0;18
3975;Kodėlčiukas;Pabiručiai;5359866071;Ne;0;1;0;1
3976;Kodėlčiukas;Pabiručiai;5801430256;Ne;8;2;0;10
3977;Kodėlčiukas;Pabiručiai;7455949617;Ne;4;4;0;8
3978;Kodėlčiukas;Pabiručiai;1039982141;Ne;5;0;2;7
3979;Kodėlčiukas;Pabiručiai;4507928289;Ne;0;0;1;1
3980;Kodėlčiukas;Pabiručiai;9830842598;Ne;13;0;1;14
3981;Kodėlčiukas;Pabiručiai;8291672306;Ne;0;0;3;3
3982;Kodėlčiukas;Pabiručiai;3882838712;Ne;12;0;2;14
3983;Kodėlčiukas;Pabiručiai;8635107742;Ne;0;0;3;3
3984;Kodėlčiukas;Smalsučiai;7630180473;Ne;0;5;2;7
3985;Kodėlčiukas;Smalsučiai;8140940288;Ne;0;4;2;6
3986;Kodėlčiukas;Smalsučiai;7246243975;Ne;0;5;0;5
3987;Kodėlčiukas;Smalsučiai;1600501494;Ne;2;1;0;3
3988;Kodėlčiukas;Smalsučiai;3880019350;Ne;4;3;0;7
3989;Kodėlčiukas;Smalsučiai;4818678923;Ne;3;3;0;6
3990;Kodėlčiukas;Smalsučiai;9589692031;Ne;16;0;0;16
3991;Kodėlčiukas;Smalsučiai;1906128091;Ne;0;2;2;4
3992;Kodėlčiukas;Smalsučiai;8302606312;Ne;0;6;0;6
3993;Kodėlčiukas;Smalsučiai;9460792167;Ne;7;1;1;9
3994;Kodėlčiukas;Smalsučiai;7324303899;Ne;5;4;3;12
3995;Kodėlčiukas;Smalsučiai;9794875862;Ne;0;4;8;12
3996;Kodėlčiukas;Smalsučiai;9528997865;Ne;0;5;4;9
3997;Kodėlčiukas;Smalsučiai;8879977943;Ne;0;9;0;9
3998;Kodėlčiukas;Smalsučiai;8647609373;Ne;5;5;0;10
3999;Kodėlčiukas;Smalsučiai;2062878300;Ne;8;4;1;13
4000;Kodėlčiukas;Smalsučiai;6950802941;Ne;17;0;0;17
4001;Kodėlčiukas;Smalsučiai;1233880820;Ne;8;0;3;11
4002;Kodėlčiukas;Giliukai;9754425363;Ne;10;0;0;10
4003;Kodėlčiukas;Giliukai;5587782917;Ne;7;0;0;7
4004;Kodėlčiukas;Giliukai;8100861190;Ne;14;1;0;15
4005;Kodėlčiukas;Giliukai;7639341503;Ne;0;3;0;3
4006;Kodėlčiukas;Giliukai;8017465692;Ne;0;6;0;6
4007;Kodėlčiukas;Giliukai;7937365710;Ne;10;1;3;14
4008;Kodėlčiukas;Giliukai;9733831323;Ne;9;0;2;11
4009;Kodėlčiukas;Giliukai;7007386353;Ne;5;1;0;6
4010;Kodėlčiukas;Giliukai;9721353724;Ne;5;0;0;5
4011;Kodėlčiukas;Giliukai;2943146610;Ne;0;5;0;5
4012;Kodėlčiukas;Giliukai;5573845415;Taip;12;0;2;14
4013;Kodėlčiukas;Giliukai;2122779530;Ne;7;1;0;8
4014;Kodėlčiukas;Giliukai;8785157050;Ne;2;13;0;15
4015;Kodėlčiukas;Giliukai;5770748359;Ne;3;3;0;6
4016;Kodėlčiukas;Giliukai;6643473339;Ne;0;4;0;4
4017;Kodėlčiukas;Giliukai;8107869258;Ne;5;0;2;7
4018;Kodėlčiukas;Giliukai;5909222351;Ne;5;10;0;15
4019;Kodėlčiukas;Giliukai;3130715310;Ne;16;0;0;16
4020;Kodėlčiukas;Gudručiai;6988515253;Ne;0;10;0;10
4021;Kodėlčiukas;Gudručiai;3385551650;Ne;15;0;0;15
4022;Kodėlčiukas;Gudručiai;7318908956;Ne;0;7;0;7
4023;Kodėlčiukas;Gudručiai;9865803714;Ne;15;0;0;15
4024;Kodėlčiukas;Gudručiai;7430239198;Ne;0;0;1;1
4025;Kodėlčiukas;Gudručiai;8400610717;Ne;6;0;2;8
4026;Kodėlčiukas;Gudručiai;7116594055;Ne;2;0;1;3
4027;Kodėlčiukas;Gudručiai;7326475644;Ne;7;0;0;7
4028;Kodėlčiukas;Gudručiai;1801366890;Ne;0;0;1;1
4029;Kodėlčiukas;Gudručiai;9483378853;Ne;0;5;0;5
4030;Kodėlčiukas;Gudručiai;8890987483;Ne;0;0;10;10
4031;Kodėlčiukas;Gudručiai;4687333060;Ne;8;4;0;12
4032;Kodėlčiukas;Gudručiai;1491160730;Ne;10;0;0;10
4033;Kodėlčiukas;Gudručiai;4543838852;Ne;0;2;0;2
4034;Kodėlčiukas;Gudručiai;2216791610;Ne;3;0;0;3
4035;Kodėlčiukas;Gudručiai;2987907651;Ne;10;0;0;10
4036;Kodėlčiukas;Gudručiai;9028856983;Ne;18;0;0;18
4037;Kodėlčiukas;Gudručiai;1588132166;Ne;7;1;1;9
4038;Kodėlčiukas;Gudručiai;6014084915;Ne;0;4;3;7
4039;Kodėlčiukas;Gudručiai;3068084704;Ne;5;4;0;9
4040;Kodėlčiukas;Gudručiai;3427610168;Ne;10;0;2;12
4041;Kodėlčiukas;Žirniukai;2402290604;Ne;10;0;0;10
4042;Kodėlčiukas;Žirniukai;6522019070;Ne;12;0;0;12
4043;Kodėlčiukas;Žirniukai;1050905569;Ne;6;2;0;8
4044;Kodėlčiukas;Žirniukai;3053949510;Ne;13;0;0;13
4045;Kodėlčiukas;Žirniukai;5325660102;Ne;0;4;0;4
4046;Kodėlčiukas;Žirniukai;8429572505;Ne;5;10;2;17
4047;Kodėlčiukas;Žirniukai;4321485862;Ne;0;0;4;4
4048;Kodėlčiukas;Žirniukai;1550287298;Ne;0;0;1;1
4049;Kodėlčiukas;Žirniukai;4341694264;Ne;2;0;2;4
4050;Kodėlčiukas;Žirniukai;4597473929;Ne;10;0;2;12
4051;Kodėlčiukas;Žirniukai;9702236745;Ne;2;0;2;4
4052;Kodėlčiukas;Žirniukai;7189930025;Ne;8;4;0;12
4053;Kodėlčiukas;Žirniukai;2002468844;Ne;6;0;2;8
4054;Kodėlčiukas;Žirniukai;4187856743;Ne;8;0;0;8
4055;Kodėlčiukas;Katinėliai;4730433849;Ne;0;0;3;3
4056;Kodėlčiukas;Katinėliai;6474867237;Ne;0;0;6;6
4057;Kodėlčiukas;Katinėliai;4995538090;Ne;0;0;2;2
4058;Kodėlčiukas;Katinėliai;8045906704;Ne;8;0;0;8
4059;Kodėlčiukas;Katinėliai;7306085848;Ne;7;0;0;7
4060;Kodėlčiukas;Katinėliai;6576466300;Ne;15;1;0;16
4061;Kodėlčiukas;Katinėliai;5650077893;Ne;10;1;0;11
4062;Kodėlčiukas;Katinėliai;3239314295;Ne;11;0;0;11
4063;Kodėlčiukas;Katinėliai;6355536268;Ne;3;0;0;3
4064;Kodėlčiukas;Katinėliai;2147517344;Ne;15;4;0;19
4065;Kodėlčiukas;Katinėliai;2119041584;Ne;0;4;5;9
4066;Kodėlčiukas;Katinėliai;1570599010;Ne;0;5;0;5
4067;Kodėlčiukas;Katinėliai;9670055064;Ne;1;1;0;2
4068;Kodėlčiukas;Katinėliai;4727546035;Ne;0;1;0;1
4069;Kodėlčiukas;Nykštukai;6670171992;Ne;0;4;0;4
4070;Kodėlčiukas;Nykštukai;6935233288;Ne;12;0;0;12
4071;Kodėlčiukas;Nykštukai;7686420784;Ne;13;0;1;14
4072;Kodėlčiukas;Nykštukai;8348024909;Taip;7;0;0;7
4073;Kodėlčiukas;Nykštukai;8759498015;Ne;5;0;2;7
4074;Kodėlčiukas;Nykštukai;9418778626;Ne;3;0;0;3
4075;Kodėlčiukas;Nykštukai;8911944991;Ne;0;0;10;10
4076;Kodėlčiukas;Nykštukai;2465920649;Ne;16;0;0;16
4077;Kodėlčiukas;Nykštukai;4293763647;Ne;5;0;0;5
4078;Kodėlčiukas;Nykštukai;3878358193;Ne;6;0;0;6
4079;Kodėlčiukas;Nykštukai;6097922310;Ne;0;7;1;8
4080;Kodėlčiukas;Nykštukai;1835522972;Ne;6;2;0;8
4081;Kodėlčiukas;Nykštukai;4986413731;Ne;9;0;3;12
4082;Kodėlčiukas;Nykštukai;2802895479;Ne;4;6;0;10
4083;Kodėlčiukas;Nykštukai;9914565606;Ne;10;0;1;11
4084;Kodėlčiukas;Nykštukai;2543628770;Ne;9;0;0;9
4085;Kodėlčiukas;Nykštukai;5541555127;Ne;15;1;0;16
4086;Kodėlčiukas;ŽIOGELIAI;8769409404;Ne;10;0;2;12
4087;Kodėlčiukas;ŽIOGELIAI;5189091564;Ne;5;4;0;9
4088;Kodėlčiukas;ŽIOGELIAI;6745245907;Ne;7;0;0;7
4089;Kodėlčiukas;ŽIOGELIAI;9055399463;Ne;6;0;0;6
4090;Kodėlčiukas;ŽIOGELIAI;4672108384;Ne;2;0;2;4
4091;Kodėlčiukas;ŽIOGELIAI;2081199093;Ne;0;0;21;21
4092;Kodėlčiukas;ŽIOGELIAI;4779994281;Ne;2;1;0;3
4093;Kodėlčiukas;ŽIOGELIAI;5115939251;Ne;18;0;0;18
4094;Kodėlčiukas;ŽIOGELIAI;3223461282;Ne;12;0;0;12
4095;Kodėlčiukas;ŽIOGELIAI;3603781385;Ne;0;6;0;6
4096;Kodėlčiukas;ŽIOGELIAI;6749972956;Ne;10;0;0;10
4097;Kodėlčiukas;ŽIOGELIAI;2189949450;Ne;6;6;0;12
4098;Kodėlčiukas;ŽIOGELIAI;7497358286;Ne;11;5;1;17
4099;Kodėlčiukas;ŽIOGELIAI;4089558399;Ne;8;0;1;9
4100;Kodėlčiukas;ŽIOGELIAI;6843492891;Ne;5;0;0;5
4101;Kodėlčiukas;ŽIOGELIAI;2933909503;Ne;18;0;0;18
4102;Kodėlčiukas;ŽIOGELIAI;4969181023;Ne;6;0;0;6
4103;Kodėlčiukas;BITUTĖS;2313607716;Ne;9;1;0;10
4104;Kodėlčiukas;BITUTĖS;2438891967;Ne;5;0;2;7
4105;Kodėlčiukas;BITUTĖS;8829986201;Ne;0;0;4;4
4106;Kodėlčiukas;BITUTĖS;8144034996;Ne;0;0;1;1
4107;Kodėlčiukas;BITUTĖS;3156788328;Ne;3;0;0;3
4108;Kodėlčiukas;BITUTĖS;7910205296;Ne;10;0;1;11
4109;Kodėlčiukas;BITUTĖS;9736751250;Ne;0;5;2;7
4110;Kodėlčiukas;BITUTĖS;8037386529;Ne;0;8;0;8
4111;Kodėlčiukas;BITUTĖS;1047209628;Ne;10;0;3;13
4112;Kodėlčiukas;BITUTĖS;5068611716;Ne;0;1;10;11
4113;Kodėlčiukas;BITUTĖS;4529565626;Ne;0;0;1;1
4114;Kodėlčiukas;BITUTĖS;7227149646;Ne;0;0;3;3
4115;Kodėlčiukas;BITUTĖS;1568628843;Ne;0;7;0;7
4116;Kodėlčiukas;BITUTĖS;9209671311;Ne;17;0;0;17
4117;Kodėlčiukas;BITUTĖS;6726383331;Ne;2;2;0;4
4118;Kodėlčiukas;BITUTĖS;1197049907;Ne;0;0;4;4
4119;Kodėlčiukas;VYŠNIUKAI;7705057116;Ne;0;0;1;1
4120;Kodėlčiukas;VYŠNIUKAI;7643398934;Ne;5;4;4;13
4121;Kodėlčiukas;VYŠNIUKAI;8799798070;Ne;0;0;3;3
4122;Kodėlčiukas;VYŠNIUKAI;7119815662;Ne;14;0;2;16
4123;Kodėlčiukas;VYŠNIUKAI;9398732476;Ne;0;0;13;13
4124;Kodėlčiukas;VYŠNIUKAI;2720748563;Ne;10;0;0;10
4125;Kodėlčiukas;VYŠNIUKAI;2871111867;Ne;8;0;0;8
4126;Kodėlčiukas;VYŠNIUKAI;9914322177;Ne;2;0;1;3
4127;Kodėlčiukas;VYŠNIUKAI;1925590099;Ne;0;2;0;2
4128;Kodėlčiukas;VYŠNIUKAI;7242653444;Ne;4;0;0;4
4129;Kodėlčiukas;VYŠNIUKAI;2298734536;Ne;0;2;1;3
4130;Kodėlčiukas;VYŠNIUKAI;2549153581;Ne;18;0;1;19
4131;Kodėlčiukas;VYŠNIUKAI;1808211253;Ne;4;2;0;6
4132;Kodėlčiukas;VYŠNIUKAI;5178305435;Ne;2;0;3;5
4133;Kodėlčiukas;VYŠNIUKAI;5061852590;Ne;0;6;0;6
4134;Kodėlčiukas;VYŠNIUKAI;4782931414;Ne;4;6;0;10
4135;Kodėlčiukas;VYŠNIUKAI;1803320085;Ne;0;0;1;1
4136;Kodėlčiukas;VYŠNIUKAI;3938536446;Ne;4;0;5;9
4137;Kodėlčiukas;VYŠNIUKAI;5752818911;Ne;0;13;0;13
4138;Kodėlčiukas;BORUŽĖLĖS;9109362006;Ne;0;1;0;1
4139;Kodėlčiukas;BORUŽĖLĖS;9169500252;Ne;0;6;0;6
4140;Kodėlčiukas;BORUŽĖLĖS;9724373368;Ne;12;2;0;14
4141;Kodėlčiukas;BORUŽĖLĖS;5075801618;Ne;0;4;4;8
4142;Kodėlčiukas;BORUŽĖLĖS;4941186694;Ne;0;6;2;8
4143;Kodėlčiukas;BORUŽĖLĖS;4866089623;Ne;0;1;1;2
4144;Kodėlčiukas;BORUŽĖLĖS;5952121209;Ne;5;7;0;12
4145;Kodėlčiukas;BORUŽĖLĖS;4230906452;Ne;4;4;0;8
4146;Kodėlčiukas;BORUŽĖLĖS;9208137169;Ne;11;0;0;11
4147;Kodėlčiukas;BORUŽĖLĖS;6587593805;Ne;0;0;3;3
4148;Kodėlčiukas;BORUŽĖLĖS;1827752731;Ne;6;4;2;12
4149;Kodėlčiukas;BORUŽĖLĖS;1005178052;Ne;5;4;2;11
4150;Kodėlčiukas;BORUŽĖLĖS;9252478832;Ne;0;0;1;1
4151;Kodėlčiukas;BORUŽĖLĖS;1889809198;Ne;0;7;0;7
4152;Kodėlčiukas;BORUŽĖLĖS;4490196764;Ne;3;2;0;5
4153;Kodėlčiukas;BORUŽĖLĖS;1074477043;Ne;0;6;0;6
4154;Kodėlčiukas;BORUŽĖLĖS;2351468626;Ne;0;4;0;4
4155;Kodėlčiukas;BORUŽĖLĖS;3403889915;Ne;0;3;0;3
4156;Kodėlčiukas;VYTURĖLIAI;6714818379;Ne;0;6;0;6
4157;Kodėlčiukas;VYTURĖLIAI;4218096561;Ne;0;6;0;6
4158;Kodėlčiukas;VYTURĖLIAI;4514764005;Ne;0;1;0;1
4159;Kodėlčiukas;VYTURĖLIAI;2169307879;Ne;15;0;0;15
4160;Kodėlčiukas;VYTURĖLIAI;2448536092;Ne;0;1;0;1
4161;Kodėlčiukas;VYTURĖLIAI;4884233329;Ne;0;0;2;2
4162;Kodėlčiukas;VYTURĖLIAI;8263945732;Ne;13;0;1;14
4163;Kodėlčiukas;VYTURĖLIAI;4937929385;Ne;5;0;0;5
4164;Kodėlčiukas;VYTURĖLIAI;2904858964;Ne;2;4;2;8
4165;Kodėlčiukas;VYTURĖLIAI;9673271313;Ne;11;0;0;11
4166;Kodėlčiukas;VYTURĖLIAI;5710301153;Ne;0;0;8;8
4167;Kodėlčiukas;VYTURĖLIAI;1746835627;Ne;0;0;8;8
4168;Kodėlčiukas;VYTURĖLIAI;5474125905;Ne;15;0;0;15
4169;Kodėlčiukas;VYTURĖLIAI;2298099102;Ne;7;0;0;7
4170;Kodėlčiukas;VYTURĖLIAI;5181211722;Ne;5;0;1;6
4171;Kodėlčiukas;VYTURĖLIAI;3472862544;Ne;0;0;1;1
4172;Kodėlčiukas;VYTURĖLIAI;5921714669;Ne;5;1;0;6
4173;Kodėlčiukas;VYTURĖLIAI;7778188733;Ne;0;2;0;2
4174;Kodėlčiukas;DRUGELIAI;4165123345;Ne;5;0;0;5
4175;Kodėlčiukas;DRUGELIAI;1149682376;Ne;10;0;0;10
4176;Kodėlčiukas;DRUGELIAI;7587203481;Ne;0;2;4;6
4177;Kodėlčiukas;DRUGELIAI;2353960861;Ne;0;8;0;8
4178;Kodėlčiukas;DRUGELIAI;6103959702;Ne;5;0;1;6
4179;Kodėlčiukas;DRUGELIAI;3267687337;Ne;4;0;2;6
4180;Kodėlčiukas;DRUGELIAI;5505788210;Ne;11;0;0;11
4181;Kodėlčiukas;DRUGELIAI;5577154148;Ne;12;6;0;18
4182;Kodėlčiukas;DRUGELIAI;8547039654;Ne;5;0;1;6
4183;Kodėlčiukas;DRUGELIAI;4202423480;Ne;0;0;7;7
4184;Kodėlčiukas;DRUGELIAI;9979034031;Ne;5;2;0;7
4185;Kodėlčiukas;DRUGELIAI;3240221130;Ne;0;0;1;1
4186;Kodėlčiukas;DRUGELIAI;9139424911;Ne;0;0;1;1
4187;Kodėlčiukas;DRUGELIAI;9664432781;Ne;8;0;0;8
4188;Kodėlčiukas;DRUGELIAI;5197946954;Ne;6;0;5;11
4189;Kodėlčiukas;DRUGELIAI;8315176054;Ne;9;1;1;11
4190;Kodėlčiukas;DRUGELIAI;3651073383;Ne;0;0;1;1
4191;Kodėlčiukas;DRUGELIAI;3854719881;Ne;13;2;0;15
4192;Kodėlčiukas;DRUGELIAI;7908217415;Ne;0;0;11;11
4193;Kodėlčiukas;OBUOLIUKAI;8784531004;Ne;9;0;0;9
4194;Kodėlčiukas;OBUOLIUKAI;1289342844;Ne;4;3;0;7
4195;Kodėlčiukas;OBUOLIUKAI;7318196860;Ne;0;1;0;1
4196;Kodėlčiukas;OBUOLIUKAI;8208448849;Ne;4;0;0;4
4197;Kodėlčiukas;OBUOLIUKAI;1683506414;Ne;0;0;2;2
4198;Kodėlčiukas;OBUOLIUKAI;3315862631;Ne;6;9;0;15
4199;Kodėlčiukas;OBUOLIUKAI;3168418461;Ne;3;4;0;7
4200;Kodėlčiukas;OBUOLIUKAI;9645987751;Ne;8;2;0;10
4201;Kodėlčiukas;OBUOLIUKAI;5860975805;Ne;4;0;0;4
4202;Kodėlčiukas;OBUOLIUKAI;8782155591;Ne;0;3;2;5
4203;Kodėlčiukas;OBUOLIUKAI;8104220950;Ne;0;6;0;6
4204;Kodėlčiukas;OBUOLIUKAI;2005453189;Ne;10;1;0;11
4205;Kodėlčiukas;OBUOLIUKAI;1180399735;Ne;15;0;0;15
4206;Kodėlčiukas;OBUOLIUKAI;5173730926;Ne;12;5;1;18
4207;Kodėlčiukas;OBUOLIUKAI;3442449482;Ne;10;0;0;10
4208;Kodėlčiukas;OBUOLIUKAI;7946010973;Ne;0;7;0;7
4209;Kodėlčiukas;OBUOLIUKAI;5342852235;Ne;0;0;1;1
4210;Kodėlčiukas;OBUOLIUKAI;8563412043;Ne;10;1;1;12
4211;Kodėlčiukas;OBUOLIUKAI;4026784012;Ne;13;0;1;14
4212;Kodėlčiukas;OBUOLIUKAI;2114176689;Ne;0;21;0;21
4213;Kodėlčiukas;OBUOLIUKAI;3033687110;Ne;1;4;0;5
4214;Kurpaitė;Viščiukų;2157581956;Ne;0;19;0;19
4215;Kurpaitė;Viščiukų;3481813493;Ne;0;4;0;4
4216;Kurpaitė;Viščiukų;8402747029;Ne;0;6;0;6
4217;Kurpaitė;Viščiukų;2373582223;Ne;0;21;0;21
4218;Kurpaitė;Viščiukų;7194351335;Ne;21;0;0;21
4219;Kurpaitė;Viščiukų;5701318496;Ne;0;1;0;1
4220;Kurpaitė;Viščiukų;2744439309;Ne;8;0;0;8
4221;Kurpaitė;Viščiukų;5557028481;Ne;0;1;0;1
4222;Kurpaitė;Viščiukų;5447826458;Ne;0;16;0;16
4223;Kurpaitė;Viščiukų;2867842844;Ne;10;0;0;10
4224;Kurpaitė;Viščiukų;6859316204;Ne;2;0;0;2
4225;Kurpaitė;Gėlyčių;9922582884;Ne;8;1;0;9
4226;Kurpaitė;Gėlyčių;9769835612;Ne;0;2;0;2
4227;Kurpaitė;Gėlyčių;7703075096;Ne;0;11;0;11
4228;Kurpaitė;Gėlyčių;5745448950;Ne;0;0;21;21
4229;Kurpaitė;Gėlyčių;5952306163;Ne;0;5;0;5
4230;Kurpaitė;Gėlyčių;3989274600;Ne;0;7;0;7
4231;Kurpaitė;Gėlyčių;3139272175;Ne;0;9;0;9
4232;Kurpaitė;Gėlyčių;4769611100;Ne;0;3;0;3
4233;Kurpaitė;Gėlyčių;1927773278;Ne;0;9;0;9
4234;Kurpaitė;Gėlyčių;3456815576;Ne;0;15;0;15
4235;Kurpaitė;Gėlyčių;8361612709;Ne;0;13;0;13
4236;Kurpaitė;Gėlyčių;4754807319;Ne;0;5;0;5
4237;Kurpaitė;Gėlyčių;4607835570;Ne;3;1;0;4
4238;Kurpaitė;Gėlyčių;1964193512;Ne;0;5;0;5
4239;Kurpaitė;Drugelių;5844470373;Ne;5;0;0;5
4240;Kurpaitė;Drugelių;5609161523;Ne;0;4;0;4
4241;Kurpaitė;Drugelių;3003517700;Ne;0;1;0;1
4242;Kurpaitė;Drugelių;9915241987;Ne;0;6;0;6
4243;Kurpaitė;Drugelių;9200404698;Ne;0;6;0;6
4244;Kurpaitė;Drugelių;4592795281;Ne;11;6;0;17
4245;Kurpaitė;Drugelių;9480290430;Ne;5;0;0;5
4246;Kurpaitė;Drugelių;8868415451;Ne;0;5;0;5
4247;Kurpaitė;Drugelių;2290343066;Ne;0;13;0;13
4248;Kurpaitė;Drugelių;4188925256;Ne;0;7;0;7
4249;Kurpaitė;Drugelių;1273426668;Ne;0;5;0;5
4250;Kurpaitė;Drugelių;5220314051;Ne;5;0;0;5
4251;Kurpaitė;Drugelių;1413326858;Ne;0;0;1;1
4252;Kurpaitė;Drugelių;3634641300;Ne;3;4;1;8
4253;Kurpaitė;Drugelių;4602268315;Ne;0;2;0;2
4254;Kurpaitė;Drugelių;6568580994;Ne;0;14;0;14
4255;Kurpaitė;Drugelių;5396599834;Ne;5;0;0;5
4256;Kurpaitė;Pelyčių;4964063637;Ne;0;0;2;2
4257;Kurpaitė;Pelyčių;7546409044;Ne;0;10;0;10
4258;Kurpaitė;Pelyčių;7249931704;Ne;0;2;0;2
4259;Kurpaitė;Pelyčių;1218040871;Ne;5;11;0;16
4260;Kurpaitė;Pelyčių;1505783589;Ne;0;2;0;2
4261;Kurpaitė;Pelyčių;2359555461;Ne;0;4;0;4
4262;Kurpaitė;Pelyčių;65434834152;Ne;0;3;0;3
4263;Kurpaitė;Pelyčių;9063294667;Ne;0;1;0;1
4264;Kurpaitė;Pelyčių;2827617670;Ne;0;1;0;1
4265;Kurpaitė;Pelyčių;1457318954;Ne;0;1;0;1
4266;Kurpaitė;Pelyčių;7897713994;Ne;0;2;0;2
4267;Kurpaitė;Pelyčių;4168882748;Ne;0;12;0;12
4268;Kurpaitė;Pelyčių;72710210157;Ne;6;4;3;13
4269;Kurpaitė;Pelyčių;1094620507;Ne;0;4;2;6
4270;Kurpaitė;Pelyčių;58127430940;Ne;10;8;0;18
4271;Kurpaitė;Pelyčių;2116580903;Ne;0;6;0;6
4272;Kurpaitė;Pelyčių;24410351286;Ne;0;10;0;10
4273;"Kūlverstukas (Suvalkų g. 6)";Saulutės;7449993309;Ne;10;6;1;17
4274;"Kūlverstukas (Suvalkų g. 6)";Saulutės;2450625415;Ne;5;0;2;7
4275;"Kūlverstukas (Suvalkų g. 6)";Saulutės;2101490038;Ne;5;0;2;7
4276;"Kūlverstukas (Suvalkų g. 6)";Saulutės;9096819614;Ne;2;0;0;2
4277;"Kūlverstukas (Suvalkų g. 6)";Saulutės;2762230590;Ne;0;0;4;4
4278;"Kūlverstukas (Suvalkų g. 6)";Saulutės;5103259175;Ne;6;0;0;6
4279;"Kūlverstukas (Suvalkų g. 6)";Saulutės;9167460438;Ne;0;5;0;5
4280;"Kūlverstukas (Suvalkų g. 6)";Saulutės;8319255735;Ne;5;0;3;8
4281;"Kūlverstukas (Suvalkų g. 6)";Saulutės;4846324136;Ne;0;0;1;1
4282;"Kūlverstukas (Suvalkų g. 6)";Saulutės;7505926208;Ne;13;0;0;13
4283;"Kūlverstukas (Suvalkų g. 6)";Saulutės;1014630718;Ne;13;0;0;13
4284;"Kūlverstukas (Suvalkų g. 6)";Saulutės;1795306946;Ne;12;0;0;12
4285;"Kūlverstukas (Suvalkų g. 6)";Saulutės;1898905623;Ne;6;0;1;7
4286;"Kūlverstukas (Suvalkų g. 6)";Saulutės;5340239466;Ne;0;0;1;1
4287;"Kūlverstukas (Suvalkų g. 6)";Saulutės;3448880105;Ne;5;4;1;10
4288;"Kūlverstukas (Suvalkų g. 6)";Saulutės;8294873714;Ne;7;0;1;8
4289;"Kūlverstukas (Suvalkų g. 6)";Saulutės;7970898546;Ne;6;0;0;6
4290;"Kūlverstukas (Suvalkų g. 6)";Saulutės;4532151103;Ne;10;0;0;10
4291;"Kūlverstukas (Suvalkų g. 6)";Saulutės;8353856412;Ne;11;0;0;11
4292;"Kūlverstukas (Suvalkų g. 6)";Peledžiukai;6287636806;Ne;0;0;3;3
4293;"Kūlverstukas (Suvalkų g. 6)";Peledžiukai;5488011852;Ne;0;0;1;1
4294;"Kūlverstukas (Suvalkų g. 6)";Peledžiukai;3937419139;Ne;0;1;0;1
4295;"Kūlverstukas (Suvalkų g. 6)";Peledžiukai;6975324309;Ne;0;8;6;14
4296;"Kūlverstukas (Suvalkų g. 6)";Peledžiukai;1452422691;Ne;0;4;0;4
4297;"Kūlverstukas (Suvalkų g. 6)";Peledžiukai;5372936730;Ne;0;0;1;1
4298;"Kūlverstukas (Suvalkų g. 6)";Peledžiukai;4396230034;Ne;0;21;0;21
4299;"Kūlverstukas (Suvalkų g. 6)";Peledžiukai;8853848991;Ne;0;0;1;1
4300;"Kūlverstukas (Suvalkų g. 6)";Peledžiukai;6287636806;Ne;0;0;3;3
4301;"Kūlverstukas (Suvalkų g. 6)";Peledžiukai;4073233921;Ne;0;0;1;1
4302;"Kūlverstukas (Suvalkų g. 6)";Peledžiukai;8092104136;Taip;0;4;7;11
4303;"Kūlverstukas (Suvalkų g. 6)";Peledžiukai;3238807604;Ne;0;5;5;10
4304;"Kūlverstukas (Suvalkų g. 6)";Peledžiukai;1932066021;Ne;0;2;0;2
4305;"Kūlverstukas (Suvalkų g. 6)";Peledžiukai;9655585527;Ne;3;0;0;3
4306;"Kūlverstukas (Suvalkų g. 6)";Peledžiukai;5488852698;Ne;0;1;0;1
4307;"Kūlverstukas (Suvalkų g. 6)";Peledžiukai;7480593611;Ne;0;2;3;5
4308;"Kūlverstukas (Suvalkų g. 6)";Peledžiukai;5345423038;Ne;8;2;0;10
4309;"Kūlverstukas (Suvalkų g. 6)";Peledžiukai;4285624305;Ne;2;0;0;2
4310;"Kūlverstukas (Suvalkų g. 6)";Peledžiukai;6894291912;Ne;9;1;0;10
4311;"Kūlverstukas (Suvalkų g. 6)";Gelytės;3811616695;Ne;0;4;3;7
4312;"Kūlverstukas (Suvalkų g. 6)";Gelytės;8346712630;Ne;8;0;0;8
4313;"Kūlverstukas (Suvalkų g. 6)";Gelytės;1939668692;Ne;10;0;3;13
4314;"Kūlverstukas (Suvalkų g. 6)";Gelytės;7112217569;Ne;0;0;10;10
4315;"Kūlverstukas (Suvalkų g. 6)";Gelytės;5391554530;Ne;0;3;2;5
4316;"Kūlverstukas (Suvalkų g. 6)";Gelytės;8701405518;Ne;0;21;0;21
4317;"Kūlverstukas (Suvalkų g. 6)";Gelytės;4111966910;Ne;0;0;1;1
4318;"Kūlverstukas (Suvalkų g. 6)";Gelytės;8964753108;Ne;11;0;0;11
4319;"Kūlverstukas (Suvalkų g. 6)";Gelytės;1067182820;Ne;0;0;2;2
4320;"Kūlverstukas (Suvalkų g. 6)";Gelytės;2316978273;Ne;0;8;6;14
4321;"Kūlverstukas (Suvalkų g. 6)";Gelytės;8333084277;Ne;0;7;0;7
4322;"Kūlverstukas (Suvalkų g. 6)";Gelytės;6710735721;Ne;10;8;1;19
4323;"Kūlverstukas (Suvalkų g. 6)";Gelytės;8618967238;Ne;5;0;3;8
4324;"Kūlverstukas (Suvalkų g. 6)";Gelytės;1679412281;Ne;3;0;0;3
4325;"Kūlverstukas (Suvalkų g. 6)";Bitutės;9777005699;Ne;0;0;3;3
4326;"Kūlverstukas (Suvalkų g. 6)";Bitutės;8599785196;Ne;5;4;0;9
4327;"Kūlverstukas (Suvalkų g. 6)";Bitutės;2082087440;Ne;14;0;0;14
4328;"Kūlverstukas (Suvalkų g. 6)";Bitutės;9976311692;Ne;3;0;0;3
4329;"Kūlverstukas (Suvalkų g. 6)";Bitutės;6319075079;Ne;10;0;0;10
4330;"Kūlverstukas (Suvalkų g. 6)";Bitutės;3712773480;Ne;15;0;0;15
4331;"Kūlverstukas (Suvalkų g. 6)";Bitutės;1985177751;Ne;0;4;11;15
4332;"Kūlverstukas (Suvalkų g. 6)";Bitutės;2924333435;Ne;2;0;5;7
4333;"Kūlverstukas (Suvalkų g. 6)";Bitutės;9787833724;Ne;17;0;0;17
4334;"Kūlverstukas (Suvalkų g. 6)";Bitutės;3370339665;Ne;4;0;0;4
4335;"Kūlverstukas (Suvalkų g. 6)";Bitutės;6916013898;Ne;4;0;0;4
4336;"Kūlverstukas (Suvalkų g. 6)";Bitutės;4694784301;Ne;0;0;5;5
4337;Lakštingala;Saulutės;2156571482;Ne;0;10;0;10
4338;Lakštingala;Saulutės;2084960114;Ne;0;0;4;4
4339;Lakštingala;Saulutės;3911509979;Ne;0;2;0;2
4340;Lakštingala;Saulutės;1598639284;Ne;0;5;0;5
4341;Lakštingala;Saulutės;1243254166;Ne;0;9;0;9
4342;Lakštingala;Saulutės;4344553248;Ne;0;0;8;8
4343;Lakštingala;Saulutės;6567480562;Ne;0;2;1;3
4344;Lakštingala;Saulutės;9495341480;Ne;3;4;0;7
4345;Lakštingala;Saulutės;2543779273;Ne;0;2;2;4
4346;Lakštingala;Saulutės;2093953744;Ne;0;3;0;3
4347;Lakštingala;Saulutės;1074616528;Ne;6;0;0;6
4348;Lakštingala;Saulutės;2626498928;Ne;0;4;0;4
4349;Lakštingala;Saulutės;9441296489;Ne;5;2;8;15
4350;Lakštingala;Saulutės;6369696598;Ne;0;2;1;3
4351;Lakštingala;Saulutės;3618452008;Ne;5;0;0;5
4352;Lakštingala;Saulutės;9297542026;Ne;0;12;0;12
4353;Lakštingala;Saulutės;9899997020;Ne;0;2;6;8
4354;Lakštingala;Saulutės;8130468345;Ne;5;1;0;6
4355;Lakštingala;Nykštukai;9725851433;Ne;0;4;6;10
4356;Lakštingala;Nykštukai;8217315818;Ne;5;0;0;5
4357;Lakštingala;Nykštukai;2769474812;Ne;0;4;9;13
4358;Lakštingala;Nykštukai;2941128360;Ne;0;1;0;1
4359;Lakštingala;Nykštukai;9912622093;Ne;0;0;3;3
4360;Lakštingala;Nykštukai;3509165175;Ne;4;1;0;5
4361;Lakštingala;Nykštukai;3993759015;Ne;10;2;0;12
4362;Lakštingala;Nykštukai;5445945319;Ne;0;12;0;12
4363;Lakštingala;Nykštukai;6332498461;Ne;0;4;1;5
4364;Lakštingala;Nykštukai;1655202909;Ne;0;1;9;10
4365;Lakštingala;Nykštukai;6009631424;Ne;0;1;0;1
4366;Lakštingala;Nykštukai;5162605666;Ne;0;4;0;4
4367;Lakštingala;Nykštukai;2073818724;Ne;15;0;2;17
4368;Lakštingala;Nykštukai;7994475429;Ne;0;6;1;7
4369;Lakštingala;Nykštukai;1863034132;Ne;0;0;16;16
4370;Lakštingala;Nykštukai;6292331193;Ne;0;0;6;6
4371;Lakštingala;Nykštukai;9489982241;Ne;0;4;0;4
4372;Lakštingala;Nykštukai;4032030375;Ne;7;4;0;11
4373;Lakštingala;Nykštukai;2652305131;Ne;0;0;1;1
4374;Lakštingala;Nykštukai;7963839249;Ne;0;4;3;7
4375;Lakštingala;Nykštukai;9375002191;Ne;0;19;0;19
4376;Lakštingala;Nykštukai;4179366572;Ne;5;0;12;17
4377;Lakštingala;Nykštukai;4857448665;Ne;0;2;0;2
4378;Lakštingala;Bitutės;8890852891;Ne;8;0;0;8
4379;Lakštingala;Bitutės;5851957031;Ne;5;4;0;9
4380;Lakštingala;Bitutės;7918688955;Ne;3;5;0;8
4381;Lakštingala;Bitutės;9395512638;Ne;0;4;0;4
4382;Lakštingala;Bitutės;9958821769;Ne;2;6;3;11
4383;Lakštingala;Bitutės;7953724873;Ne;0;4;0;4
4384;Lakštingala;Bitutės;7900597697;Ne;0;4;0;4
4385;Lakštingala;Bitutės;8470575927;Ne;0;3;0;3
4386;Lakštingala;Bitutės;9497327995;Ne;10;0;0;10
4387;Lakštingala;Bitutės;1411121466;Ne;1;5;1;7
4388;Lakštingala;Bitutės;8944088082;Ne;0;5;8;13
4389;Lakštingala;Bitutės;9897713625;Ne;1;2;0;3
4390;Lakštingala;Bitutės;2104150466;Ne;0;5;0;5
4391;Lakštingala;Bitutės;70798601578;Ne;0;5;0;5
4392;Lakštingala;Bitutės;1265027238;Ne;0;4;0;4
4393;Lakštingala;Bitutės;1736130324;Ne;0;2;0;2
4394;Lakštingala;Bitutės;2039579203;Ne;0;2;0;2
4395;Lakštingala;Bitutės;5672932116;Ne;0;1;5;6
4396;Lakštingala;Bitutės;5598711072;Ne;0;0;6;6
4397;Lakštingala;Bitutės;9346986726;Ne;0;4;3;7
4398;Lakštingala;Bitutės;3872205876;Ne;7;0;0;7
4399;Lakštingala;Bitutės;5920907667;Ne;0;4;8;12
4400;Lakštingala;Bitutės;8679582358;Ne;21;0;0;21
4401;Lakštingala;Bitutės;2266870318;Ne;0;1;1;2
4402;Lakštingala;Pūkeliai;9774836470;Ne;2;4;0;6
4403;Lakštingala;Pūkeliai;1958696382;Ne;0;4;2;6
4404;Lakštingala;Pūkeliai;4542992319;Ne;0;4;0;4
4405;Lakštingala;Pūkeliai;2593030897;Ne;0;2;0;2
4406;Lakštingala;Pūkeliai;6908873466;Ne;0;4;0;4
4407;Lakštingala;Pūkeliai;7929034243;Ne;2;3;0;5
4408;Lakštingala;Pūkeliai;2130192341;Ne;10;7;0;17
4409;Lakštingala;Pūkeliai;8165998647;Ne;12;0;0;12
4410;Lakštingala;Pūkeliai;1458348357;Ne;21;0;0;21
4411;Lakštingala;Pūkeliai;4465752871;Ne;0;0;4;4
4412;Lakštingala;Pūkeliai;5379344261;Ne;0;0;1;1
4413;Lakštingala;Pūkeliai;4722328994;Ne;5;0;0;5
4414;Lakštingala;Pūkeliai;7272454093;Ne;1;5;0;6
4415;Lakštingala;Pūkeliai;6234559044;Ne;14;0;0;14
4416;Lakštingala;Pūkeliai;5727308039;Ne;0;8;0;8
4417;Lakštingala;Pūkeliai;5051773825;Ne;3;0;0;3
4418;Lakštingala;Pūkeliai;9390342572;Ne;5;4;0;9
4419;Lakštingala;Pūkeliai;9694524137;Ne;0;5;2;7
4420;Lakštingala;Pūkeliai;5949665703;Ne;7;0;0;7
4421;Lakštingala;Pūkeliai;6565318145;Ne;0;5;0;5
4422;Lakštingala;Pūkeliai;4384468922;Ne;11;0;1;12
4423;Lakštingala;Pūkeliai;2423761155;Ne;9;0;2;11
4424;Lakštingala;Pūkeliai;8171357606;Ne;0;10;0;10
4425;Lakštingala;Aitvariukai;1474796466;Ne;4;1;2;7
4426;Lakštingala;Aitvariukai;9629855134;Ne;0;2;0;2
4427;Lakštingala;Aitvariukai;4546036762;Ne;0;10;0;10
4428;Lakštingala;Aitvariukai;6219896499;Ne;11;0;0;11
4429;Lakštingala;Aitvariukai;7876311404;Ne;5;0;0;5
4430;Lakštingala;Aitvariukai;1248909711;Ne;1;7;0;8
4431;Lakštingala;Aitvariukai;9676872125;Ne;9;0;0;9
4432;Lakštingala;Aitvariukai;7879280198;Ne;8;3;0;11
4433;Lakštingala;Aitvariukai;4403673558;Ne;5;8;0;13
4434;Lakštingala;Aitvariukai;5693413287;Ne;0;4;0;4
4435;Lakštingala;Aitvariukai;7240426529;Ne;5;2;0;7
4436;Lakštingala;Aitvariukai;8558000223;Ne;8;0;0;8
4437;Lakštingala;Aitvariukai;5244646855;Ne;1;1;0;2
4438;Lakštingala;Aitvariukai;5602079341;Ne;10;2;0;12
4439;Lakštingala;Aitvariukai;7404386777;Ne;3;1;0;4
4440;Lakštingala;Aitvariukai;3166474163;Ne;0;14;0;14
4441;Lakštingala;Aitvariukai;8609822839;Ne;0;1;0;1
4442;Lakštingala;Aitvariukai;6180443056;Ne;19;0;0;19
4443;Lakštingala;Aitvariukai;3113050690;Ne;3;6;0;9
4444;Lakštingala;Boružiukai;9004336424;Ne;0;10;0;10
4445;Lakštingala;Boružiukai;87470014156;Ne;0;0;9;9
4446;Lakštingala;Boružiukai;8820053026;Ne;0;1;0;1
4447;Lakštingala;Boružiukai;2072883878;Ne;0;4;0;4
4448;Lakštingala;Boružiukai;4811759034;Ne;5;3;0;8
4449;Lakštingala;Boružiukai;1898853302;Ne;0;13;1;14
4450;Lakštingala;Boružiukai;7443563000;Ne;0;0;7;7
4451;Lakštingala;Boružiukai;4818524423;Ne;0;4;3;7
4452;Lakštingala;Boružiukai;9724531753;Ne;0;4;0;4
4453;Lakštingala;Boružiukai;1783776913;Ne;0;3;0;3
4454;Lakštingala;Boružiukai;1106475925;Ne;0;0;1;1
4455;Lakštingala;Boružiukai;1667277983;Ne;0;3;0;3
4456;Lakštingala;Boružiukai;6947565845;Ne;0;3;0;3
4457;Lakštingala;Boružiukai;3009692491;Ne;7;5;2;14
4458;Lakštingala;Boružiukai;1800927281;Ne;7;6;0;13
4459;Lakštingala;Boružiukai;9998322501;Ne;0;1;0;1
4460;Lakštingala;Boružiukai;2304340938;Ne;0;1;0;1
4461;Lakštingala;Boružiukai;8284565948;Ne;5;16;0;21
4462;Lakštingala;Boružiukai;2423651716;Ne;0;1;0;1
4463;Lakštingala;Boružiukai;9445476887;Ne;0;3;11;14
4464;Lakštingala;Boružiukai;8899572475;Ne;0;4;1;5
4465;Lakštingala;Boružiukai;9492056071;Ne;0;5;0;5
4466;Lakštingala;Žiogeliai;5048686136;Ne;0;6;0;6
4467;Lakštingala;Žiogeliai;8404025659;Ne;0;0;15;15
4468;Lakštingala;Žiogeliai;4113993067;Ne;5;2;0;7
4469;Lakštingala;Žiogeliai;6981178960;Ne;0;0;15;15
4470;Lakštingala;Žiogeliai;3908175786;Ne;15;0;6;21
4471;Lakštingala;Žiogeliai;9860169528;Ne;11;0;0;11
4472;Lakštingala;Žiogeliai;4935753482;Ne;0;0;7;7
4473;Lakštingala;Žiogeliai;5008933316;Ne;5;0;0;5
4474;Lakštingala;Žiogeliai;3439681068;Ne;0;0;1;1
4475;Lakštingala;Žiogeliai;3766986041;Ne;5;0;8;13
4476;Lakštingala;Žiogeliai;1974950823;Ne;0;0;2;2
4477;Lakštingala;Žiogeliai;6561743084;Ne;0;6;2;8
4478;Lakštingala;Žiogeliai;1226908540;Ne;0;0;9;9
4479;Lakštingala;Žiogeliai;3951057865;Ne;4;0;2;6
4480;Lakštingala;Žiogeliai;7661973162;Ne;10;0;0;10
4481;Lakštingala;Žiogeliai;7104398627;Ne;11;0;2;13
4482;Lakštingala;Žiogeliai;7361353346;Ne;7;0;0;7
4483;Lakštingala;Žiogeliai;4790291839;Ne;3;0;0;3
4484;Lakštingala;Žiogeliai;8351970017;Ne;0;1;1;2
4485;Lakštingala;Žiogeliai;8333832673;Ne;0;10;0;10
4486;Lakštingala;Žiogeliai;6872095965;Ne;0;0;4;4
4487;Lakštingala;SPINDULIUKAI;4365413054;Ne;3;0;3;6
4488;Lakštingala;SPINDULIUKAI;9762500668;Ne;4;0;0;4
4489;Lakštingala;SPINDULIUKAI;7640007392;Ne;0;11;0;11
4490;Lakštingala;SPINDULIUKAI;4784677514;Ne;6;1;0;7
4491;Lakštingala;SPINDULIUKAI;1619201521;Ne;3;0;0;3
4492;Lakštingala;SPINDULIUKAI;2022621678;Ne;4;0;0;4
4493;Lakštingala;SPINDULIUKAI;8429523368;Ne;6;0;0;6
4494;Lakštingala;SPINDULIUKAI;6668075753;Ne;4;0;10;14
4495;Lakštingala;SPINDULIUKAI;9081653166;Ne;0;5;0;5
4496;Lakštingala;SPINDULIUKAI;8160825203;Ne;16;0;0;16
4497;Lakštingala;SPINDULIUKAI;6780591792;Ne;0;10;0;10
4498;Lakštingala;SPINDULIUKAI;4698879435;Ne;6;0;0;6
4499;Lakštingala;SPINDULIUKAI;8722490845;Ne;6;0;0;6
4500;Lakštingala;SPINDULIUKAI;1220858944;Ne;0;4;0;4
4501;Lakštingala;SPINDULIUKAI;3823860988;Ne;4;5;2;11
4502;Lakštingala;SPINDULIUKAI;7141840160;Ne;0;4;0;4
4503;Lakštingala;SPINDULIUKAI;3282771613;Ne;2;1;0;3
4504;Lakštingala;SPINDULIUKAI;2795341401;Ne;0;5;0;5
4505;Lakštingala;SPINDULIUKAI;5815240975;Ne;6;1;0;7
4506;Lakštingala;SPINDULIUKAI;9052256710;Ne;5;0;0;5
4507;Lakštingala;Pėledžiukai;3520592784;Ne;0;3;0;3
4508;Lakštingala;Pėledžiukai;5258588961;Ne;4;0;1;5
4509;Lakštingala;Pėledžiukai;4774354751;Ne;3;2;7;12
4510;Lakštingala;Pėledžiukai;3369263112;Ne;12;1;1;14
4511;Lakštingala;Pėledžiukai;8375506323;Ne;0;5;0;5
4512;Lakštingala;Pėledžiukai;8717764626;Ne;5;0;1;6
4513;Lakštingala;Pėledžiukai;8075192528;Ne;3;4;9;16
4514;Lakštingala;Pėledžiukai;3766779594;Ne;0;3;0;3
4515;Lakštingala;Pėledžiukai;6161860331;Ne;5;0;0;5
4516;Lakštingala;Pėledžiukai;6866935290;Ne;14;0;0;14
4517;Lakštingala;Pėledžiukai;8787118512;Ne;7;6;0;13
4518;Lakštingala;Pėledžiukai;6805882038;Ne;0;2;1;3
4519;Lakštingala;Pėledžiukai;7139669240;Ne;0;5;0;5
4520;Lakštingala;Pėledžiukai;9502994399;Ne;0;0;1;1
4521;Lakštingala;Pėledžiukai;9431022632;Ne;0;1;1;2
4522;Lakštingala;Pėledžiukai;9856189053;Ne;10;2;0;12
4523;Lakštingala;Pėledžiukai;5391954600;Ne;0;1;0;1
4524;Lakštingala;Katinėliai;2346497467;Ne;5;0;0;5
4525;Lakštingala;Katinėliai;9894103692;Ne;19;0;0;19
4526;Lakštingala;Katinėliai;8800538473;Ne;13;0;0;13
4527;Lakštingala;Katinėliai;9093654437;Ne;8;0;1;9
4528;Lakštingala;Katinėliai;6011421835;Ne;5;0;7;12
4529;Lakštingala;Katinėliai;2673030043;Ne;8;0;0;8
4530;Lakštingala;Katinėliai;2010478542;Ne;17;0;1;18
4531;Lakštingala;Katinėliai;3877448215;Ne;14;0;0;14
4532;Lakštingala;Katinėliai;1903292595;Ne;15;4;0;19
4533;Lakštingala;Katinėliai;6764453371;Ne;0;10;0;10
4534;Lakštingala;Katinėliai;4184814075;Ne;0;0;1;1
4535;Lakštingala;Deimantėliai;8310446552;Ne;16;0;0;16
4536;Lakštingala;Deimantėliai;8063735934;Ne;0;4;0;4
4537;Lakštingala;Deimantėliai;7396235662;Ne;3;1;0;4
4538;Lakštingala;Deimantėliai;4725848201;Ne;16;0;0;16
4539;Lakštingala;Deimantėliai;6930466455;Taip;0;8;0;8
4540;Lakštingala;Deimantėliai;2165808562;Ne;0;0;10;10
4541;Lakštingala;Deimantėliai;3352073562;Ne;0;0;18;18
4542;Lakštingala;Deimantėliai;5539054769;Ne;0;0;1;1
4543;Lakštingala;Deimantėliai;8421786788;Ne;0;6;0;6
4544;Lakštingala;Deimantėliai;6974936332;Ne;13;0;0;13
4545;Lakštingala;Deimantėliai;8764728846;Ne;6;0;0;6
4546;Lakštingala;Deimantėliai;8663938939;Ne;11;0;0;11
4547;Lakštingala;Deimantėliai;5165517709;Ne;4;0;0;4
4548;Lakštingala;Deimantėliai;5965026791;Ne;0;5;0;5
4549;Lakštingala;KIŠKUČIAI;6520436055;Ne;9;0;0;9
4550;Lakštingala;KIŠKUČIAI;3208321841;Ne;2;2;0;4
4551;Lakštingala;KIŠKUČIAI;6970022417;Ne;5;1;5;11
4552;Lakštingala;KIŠKUČIAI;5730122965;Ne;10;5;0;15
4553;Lakštingala;KIŠKUČIAI;4140403601;Ne;0;2;1;3
4554;Lakštingala;KIŠKUČIAI;5119365443;Ne;0;2;0;2
4555;Lakštingala;KIŠKUČIAI;6689018476;Ne;5;4;0;9
4556;Lakštingala;KIŠKUČIAI;7017047366;Ne;0;0;4;4
4557;Lakštingala;KIŠKUČIAI;9539081376;Ne;0;0;1;1
4558;Lakštingala;KIŠKUČIAI;4854843534;Ne;0;0;12;12
4559;Lakštingala;KIŠKUČIAI;9162902701;Ne;0;0;5;5
4560;Lakštingala;KIŠKUČIAI;1113674539;Ne;0;5;0;5
4561;Lakštingala;KIŠKUČIAI;4370431439;Ne;4;0;0;4
4562;Lakštingala;KIŠKUČIAI;1898108870;Ne;0;0;18;18
4563;Lakštingala;KIŠKUČIAI;2998581623;Ne;0;11;0;11
4564;Lakštingala;KIŠKUČIAI;8414220381;Ne;5;0;4;9
4565;Lakštingala;KIŠKUČIAI;7817830649;Ne;8;6;0;14
4566;Lašelis;VIŠČIUKAI;6477439886;Ne;0;6;1;7
4567;Lašelis;VIŠČIUKAI;6912802425;Ne;21;0;0;21
4568;Lašelis;VIŠČIUKAI;6857428142;Ne;7;0;0;7
4569;Lašelis;VIŠČIUKAI;5759317067;Ne;0;3;0;3
4570;Lašelis;VIŠČIUKAI;9884946783;Ne;9;15;0;24
4571;Lašelis;VIŠČIUKAI;1367955273;Ne;0;10;0;10
4572;Lašelis;VIŠČIUKAI;2702582486;Ne;12;0;0;12
4573;Lašelis;VIŠČIUKAI;2824852871;Ne;0;20;0;20
4574;Lašelis;VIŠČIUKAI;1517104634;Ne;19;0;0;19
4575;Lašelis;VIŠČIUKAI;9440665009;Ne;1;0;0;1
4576;Lašelis;VIŠČIUKAI;3003679103;Ne;8;0;4;12
4577;Lašelis;VIŠČIUKAI;4427263877;Ne;0;0;7;7
4578;Lašelis;VIŠČIUKAI;4748156580;Ne;7;0;1;8
4579;Lašelis;VIŠČIUKAI;4860925464;Ne;10;0;0;10
4580;Lašelis;VIŠČIUKAI;8287867336;Ne;0;6;1;7
4581;Lašelis;ŠYPSENA;7137348151;Ne;0;0;2;2
4582;Lašelis;ŠYPSENA;1808067249;Ne;0;7;0;7
4583;Lašelis;ŠYPSENA;4933598046;Ne;8;0;0;8
4584;Lašelis;ŠYPSENA;1060784180;Ne;14;2;0;16
4585;Lašelis;ŠYPSENA;2509469243;Ne;0;4;9;13
4586;Lašelis;ŠYPSENA;4832223461;Ne;3;0;1;4
4587;Lašelis;ŠYPSENA;5416590600;Ne;2;14;2;18
4588;Lašelis;ŠYPSENA;1490179832;Ne;0;5;0;5
4589;Lašelis;ŠYPSENA;6836452490;Ne;7;0;2;9
4590;Lašelis;ŠYPSENA;1983312896;Ne;8;4;0;12
4591;Lašelis;ŠYPSENA;1279052767;Ne;0;0;9;9
4592;Lašelis;ŠYPSENA;8906479495;Ne;0;0;12;12
4593;Lašelis;ŠYPSENA;2593126568;Ne;14;0;0;14
4594;Lašelis;ŠYPSENA;3995905195;Ne;0;21;0;21
4595;Lašelis;ŠYPSENA;6137626795;Ne;0;0;3;3
4596;Lašelis;ŠYPSENA;1635921119;Ne;0;5;0;5
4597;Lašelis;ŠYPSENA;9664015801;Ne;6;1;0;7
4598;Lašelis;ŠYPSENA;2306501498;Ne;10;0;0;10
4599;Lašelis;ŠYPSENA;2606193652;Ne;0;0;1;1
4600;Lašelis;ŠYPSENA;9434932943;Ne;0;15;1;16
4601;Lašelis;NYKŠTUKAI;5931015581;Ne;0;3;4;7
4602;Lašelis;NYKŠTUKAI;1175045927;Ne;9;0;0;9
4603;Lašelis;NYKŠTUKAI;8132517365;Ne;5;4;0;9
4604;Lašelis;NYKŠTUKAI;1244168190;Ne;0;3;2;5
4605;Lašelis;NYKŠTUKAI;4566547120;Ne;0;1;0;1
4606;Lašelis;NYKŠTUKAI;1035888733;Ne;0;4;0;4
4607;Lašelis;NYKŠTUKAI;1926439959;Ne;0;3;0;3
4608;Lašelis;NYKŠTUKAI;8318512396;Ne;7;3;0;10
4609;Lašelis;NYKŠTUKAI;2886967297;Ne;9;4;0;13
4610;Lašelis;NYKŠTUKAI;3805049682;Ne;18;0;0;18
4611;Lašelis;NYKŠTUKAI;2401058384;Ne;17;0;0;17
4612;Lašelis;NYKŠTUKAI;1042560186;Ne;0;2;0;2
4613;Lašelis;NYKŠTUKAI;8814796010;Ne;0;0;3;3
4614;Lašelis;NYKŠTUKAI;3675606390;Ne;0;21;0;21
4615;Lašelis;NYKŠTUKAI;9647340725;Ne;10;4;0;14
4616;Lašelis;NYKŠTUKAI;3297005183;Ne;0;2;1;3
4617;Lašelis;SAULUTĖ;1460027521;Ne;0;1;0;1
4618;Lašelis;SAULUTĖ;3144718477;Ne;10;0;0;10
4619;Lašelis;SAULUTĖ;1777442316;Ne;5;0;1;6
4620;Lašelis;SAULUTĖ;7998812497;Ne;18;0;0;18
4621;Lašelis;SAULUTĖ;3239288878;Ne;0;4;2;6
4622;Lašelis;SAULUTĖ;6829438486;Ne;0;9;2;11
4623;Lašelis;SAULUTĖ;6080664872;Ne;15;1;0;16
4624;Lašelis;SAULUTĖ;2204859014;Ne;10;2;0;12
4625;Lašelis;SAULUTĖ;1515920896;Ne;3;0;0;3
4626;Lašelis;SAULUTĖ;1085400709;Ne;0;6;2;8
4627;Lašelis;SAULUTĖ;1646912457;Ne;8;1;0;9
4628;Lašelis;SAULUTĖ;2034007263;Ne;0;8;0;8
4629;Lašelis;SAULUTĖ;5731394231;Ne;5;0;3;8
4630;Lašelis;SAULUTĖ;1085950130;Ne;4;0;0;4
4631;Lašelis;BORUŽĖLĖS;1343964112;Ne;6;0;2;8
4632;Lašelis;BORUŽĖLĖS;7502668870;Ne;2;1;0;3
4633;Lašelis;BORUŽĖLĖS;7418586100;Ne;2;0;3;5
4634;Lašelis;BORUŽĖLĖS;8394290574;Ne;12;1;0;13
4635;Lašelis;BORUŽĖLĖS;7811809908;Ne;0;2;0;2
4636;Lašelis;BORUŽĖLĖS;4113842551;Ne;2;1;0;3
4637;Lašelis;BORUŽĖLĖS;1882188961;Ne;9;0;0;9
4638;Lašelis;BORUŽĖLĖS;6317716501;Ne;0;0;1;1
4639;Lašelis;BORUŽĖLĖS;8905080707;Ne;0;0;1;1
4640;Lašelis;BORUŽĖLĖS;2991487552;Ne;0;0;5;5
4641;Lašelis;BORUŽĖLĖS;2210081848;Ne;7;1;0;8
4642;Lašelis;BORUŽĖLĖS;1131591230;Ne;16;0;0;16
4643;Lašelis;BORUŽĖLĖS;4051058266;Ne;0;7;0;7
4644;Lašelis;BORUŽĖLĖS;7784416134;Ne;0;7;0;7
4645;Lašelis;SKRUZDELIUKAI;8212250478;Ne;2;3;0;5
4646;Lašelis;SKRUZDELIUKAI;5000188106;Ne;0;8;0;8
4647;Lašelis;SKRUZDELIUKAI;6203027620;Ne;2;0;3;5
4648;Lašelis;SKRUZDELIUKAI;9954809499;Taip;1;0;0;1
4649;Lašelis;SKRUZDELIUKAI;6158377421;Ne;5;5;0;10
4650;Lašelis;SKRUZDELIUKAI;3130271837;Ne;0;7;0;7
4651;Lašelis;SKRUZDELIUKAI;2871149756;Ne;26;0;0;26
4652;Lašelis;SKRUZDELIUKAI;7920615797;Ne;12;0;1;13
4653;Lašelis;SKRUZDELIUKAI;3146611814;Ne;0;5;0;5
4654;Lašelis;SKRUZDELIUKAI;7619426839;Ne;0;11;0;11
4655;Lašelis;SKRUZDELIUKAI;8718481664;Ne;3;0;1;4
4656;Lazdynėlis;BITUTĖS;4881322530;Ne;4;10;0;14
4657;Lazdynėlis;BITUTĖS;1748260780;Ne;10;1;0;11
4658;Lazdynėlis;BITUTĖS;4462819848;Ne;0;2;3;5
4659;Lazdynėlis;BITUTĖS;1574847460;Ne;0;2;0;2
4660;Lazdynėlis;BITUTĖS;5030400578;Ne;0;2;0;2
4661;Lazdynėlis;BITUTĖS;8159928299;Ne;8;0;3;11
4662;Lazdynėlis;BITUTĖS;9761942869;Ne;0;1;2;3
4663;Lazdynėlis;BITUTĖS;7911328294;Ne;10;0;0;10
4664;Lazdynėlis;BITUTĖS;1450181711;Ne;0;6;1;7
4665;Lazdynėlis;BITUTĖS;2032759165;Ne;5;0;0;5
4666;Lazdynėlis;BITUTĖS;2802505435;Ne;0;4;0;4
4667;Lazdynėlis;BITUTĖS;2586187455;Ne;5;9;0;14
4668;Lazdynėlis;BITUTĖS;2013752858;Ne;0;3;4;7
4669;Lazdynėlis;BITUTĖS;5562900372;Ne;0;19;0;19
4670;Lazdynėlis;BITUTĖS;6963058612;Ne;9;0;0;9
4671;Lazdynėlis;BITUTĖS;6920441303;Ne;3;0;0;3
4672;Lazdynėlis;BITUTĖS;4153294595;Ne;0;6;0;6
4673;Lazdynėlis;BITUTĖS;4809829190;Ne;0;4;0;4
4674;Lazdynėlis;EŽIUKAI;1039874409;Ne;0;0;1;1
4675;Lazdynėlis;EŽIUKAI;9362249595;Ne;8;1;0;9
4676;Lazdynėlis;EŽIUKAI;7135087818;Ne;7;4;0;11
4677;Lazdynėlis;EŽIUKAI;6352480127;Ne;5;0;0;5
4678;Lazdynėlis;EŽIUKAI;6814362584;Ne;5;0;3;8
4679;Lazdynėlis;EŽIUKAI;9219327706;Ne;8;4;0;12
4680;Lazdynėlis;EŽIUKAI;8229454863;Ne;10;2;5;17
4681;Lazdynėlis;EŽIUKAI;4747688220;Ne;5;0;0;5
4682;Lazdynėlis;EŽIUKAI;1312649234;Ne;5;4;1;10
4683;Lazdynėlis;EŽIUKAI;3097254722;Ne;0;0;1;1
4684;Lazdynėlis;EŽIUKAI;3040417651;Ne;0;0;2;2
4685;Lazdynėlis;EŽIUKAI;2354549025;Ne;3;0;0;3
4686;Lazdynėlis;EŽIUKAI;5407785006;Ne;5;2;0;7
4687;Lazdynėlis;EŽIUKAI;7208223612;Ne;0;0;1;1
4688;Lazdynėlis;EŽIUKAI;4293473176;Ne;7;4;0;11
4689;Lazdynėlis;EŽIUKAI;2723284353;Ne;0;1;0;1
4690;Lazdynėlis;EŽIUKAI;6008610525;Ne;10;1;1;12
4691;Lazdynėlis;EŽIUKAI;3879017767;Ne;10;0;0;10
4692;Lazdynėlis;EŽIUKAI;4031719765;Ne;5;1;0;6
4693;Lazdynėlis;BORUŽIUKAI;8337458289;Ne;0;21;0;21
4694;Lazdynėlis;BORUŽIUKAI;2592852361;Ne;0;21;0;21
4695;Lazdynėlis;BORUŽIUKAI;7692056055;Ne;6;0;0;6
4696;Lazdynėlis;BORUŽIUKAI;6394994841;Ne;0;1;3;4
4697;Lazdynėlis;BORUŽIUKAI;2009941344;Ne;7;0;2;9
4698;Lazdynėlis;BORUŽIUKAI;1653216959;Ne;6;0;0;6
4699;Lazdynėlis;BORUŽIUKAI;4190852647;Ne;5;0;2;7
4700;Lazdynėlis;BORUŽIUKAI;2058909635;Ne;0;6;0;6
4701;Lazdynėlis;BORUŽIUKAI;3105363578;Ne;8;13;0;21
4702;Lazdynėlis;BORUŽIUKAI;5622254334;Ne;10;0;0;10
4703;Lazdynėlis;BORUŽIUKAI;7587041613;Ne;5;0;3;8
4704;Lazdynėlis;BORUŽIUKAI;2632078843;Ne;17;4;0;21
4705;Lazdynėlis;BORUŽIUKAI;5756228709;Ne;0;0;3;3
4706;Lazdynėlis;BORUŽIUKAI;6824473598;Ne;0;0;3;3
4707;Lazdynėlis;BORUŽIUKAI;1707231039;Ne;0;21;0;21
4708;Lazdynėlis;BORUŽIUKAI;4642875037;Ne;0;6;0;6
4709;Lazdynėlis;BORUŽIUKAI;1722503577;Ne;8;0;0;8
4710;Lazdynėlis;BORUŽIUKAI;4595080695;Ne;0;21;0;21
4711;Lazdynėlis;BORUŽIUKAI;4958640516;Ne;0;0;3;3
4712;Lazdynėlis;BORUŽIUKAI;3351966091;Ne;0;21;0;21
4713;Lazdynėlis;BORUŽIUKAI;9548866880;Ne;7;1;0;8
4714;Lazdynėlis;KAČIUKAI;5888646355;Ne;0;1;0;1
4715;Lazdynėlis;KAČIUKAI;3678422730;Ne;0;0;1;1
4716;Lazdynėlis;KAČIUKAI;5708643953;Ne;0;2;0;2
4717;Lazdynėlis;KAČIUKAI;8295967906;Ne;0;1;1;2
4718;Lazdynėlis;KAČIUKAI;1424382629;Ne;16;0;0;16
4719;Lazdynėlis;KAČIUKAI;6787228086;Ne;0;4;17;21
4720;Lazdynėlis;KAČIUKAI;7313399153;Ne;1;0;0;1
4721;Lazdynėlis;KAČIUKAI;4842228703;Ne;3;11;0;14
4722;Lazdynėlis;KAČIUKAI;6542840562;Ne;8;0;0;8
4723;Lazdynėlis;KAČIUKAI;1265404063;Ne;1;2;0;3
4724;Lazdynėlis;KAČIUKAI;6086766393;Ne;0;2;0;2
4725;Lazdynėlis;KAČIUKAI;2958520599;Ne;0;4;12;16
4726;Lazdynėlis;KAČIUKAI;73057057862;Ne;0;6;0;6
4727;Lazdynėlis;KAČIUKAI;5030460904;Ne;0;5;0;5
4728;Lazdynėlis;KAČIUKAI;5031826548;Ne;0;1;1;2
4729;Lazdynėlis;KAČIUKAI;7237629135;Ne;0;3;4;7
4730;Lazdynėlis;VOVERIUKAI;8159724466;Ne;0;0;2;2
4731;Lazdynėlis;VOVERIUKAI;5051632567;Ne;15;0;2;17
4732;Lazdynėlis;VOVERIUKAI;6276697479;Ne;0;5;0;5
4733;Lazdynėlis;VOVERIUKAI;1335000592;Ne;1;2;0;3
4734;Lazdynėlis;VOVERIUKAI;2514035189;Ne;13;0;2;15
4735;Lazdynėlis;VOVERIUKAI;9477491360;Ne;0;0;1;1
4736;Lazdynėlis;VOVERIUKAI;5256157552;Ne;7;3;1;11
4737;Lazdynėlis;VOVERIUKAI;5889772626;Ne;7;0;3;10
4738;Lazdynėlis;VOVERIUKAI;6559543013;Ne;0;6;0;6
4739;Lazdynėlis;VOVERIUKAI;9231049001;Ne;0;1;0;1
4740;Lazdynėlis;VOVERIUKAI;9886856760;Ne;8;0;2;10
4741;Lazdynėlis;VOVERIUKAI;2998606948;Ne;9;1;0;10
4742;Lazdynėlis;VOVERIUKAI;5796381191;Ne;10;1;0;11
4743;Lazdynėlis;VOVERIUKAI;3062408541;Ne;0;4;0;4
4744;Lazdynėlis;VOVERIUKAI;3779983775;Ne;3;1;0;4
4745;Lazdynėlis;VOVERIUKAI;4550819172;Ne;5;0;0;5
4746;Lazdynėlis;VOVERIUKAI;4771173060;Ne;4;14;0;18
4747;Lazdynėlis;VOVERIUKAI;8314002741;Ne;5;0;0;5
4748;Lazdynėlis;VOVERIUKAI;3365726271;Ne;8;0;2;10
4749;Lazdynėlis;VOVERIUKAI;1355954767;Ne;1;1;2;4
4750;Lazdynėlis;VOVERIUKAI;7941793866;Ne;21;0;0;21
4751;Lazdynėlis;RIEŠUTĖLIAI;3086059608;Ne;5;5;1;11
4752;Lazdynėlis;RIEŠUTĖLIAI;9693153118;Ne;0;3;0;3
4753;Lazdynėlis;RIEŠUTĖLIAI;6056618348;Ne;0;21;0;21
4754;Lazdynėlis;RIEŠUTĖLIAI;5987500024;Ne;0;0;3;3
4755;Lazdynėlis;RIEŠUTĖLIAI;2453740823;Ne;5;1;0;6
4756;Lazdynėlis;RIEŠUTĖLIAI;4552505857;Ne;0;2;0;2
4757;Lazdynėlis;RIEŠUTĖLIAI;7545621720;Ne;0;2;1;3
4758;Lazdynėlis;RIEŠUTĖLIAI;8179584161;Ne;0;1;0;1
4759;Lazdynėlis;RIEŠUTĖLIAI;3239107488;Ne;0;7;0;7
4760;Lazdynėlis;RIEŠUTĖLIAI;4055450300;Ne;2;0;0;2
4761;Lazdynėlis;RIEŠUTĖLIAI;8942906327;Ne;7;1;0;8
4762;Lazdynėlis;RIEŠUTĖLIAI;3362193379;Ne;0;4;0;4
4763;Lazdynėlis;RIEŠUTĖLIAI;9582702244;Ne;1;2;0;3
4764;Lazdynėlis;RIEŠUTĖLIAI;3062924645;Ne;0;2;1;3
4765;Lazdynėlis;RIEŠUTĖLIAI;3667994076;Ne;10;4;0;14
4766;Lazdynėlis;RIEŠUTĖLIAI;1668899344;Ne;5;0;0;5
4767;Lazdynėlis;RIEŠUTĖLIAI;4092363029;Ne;10;0;0;10
4768;Lazdynėlis;RIEŠUTĖLIAI;3250913116;Ne;11;0;0;11
4769;Lazdynėlis;RIEŠUTĖLIAI;8529192130;Ne;6;0;0;6
4770;Lazdynėlis;RIEŠUTĖLIAI;7719697394;Ne;5;5;1;11
4771;Lazdynėlis;ANČIUKAI;9519409694;Ne;3;1;0;4
4772;Lazdynėlis;ANČIUKAI;2526260625;Ne;3;0;0;3
4773;Lazdynėlis;ANČIUKAI;8340712398;Ne;5;0;0;5
4774;Lazdynėlis;ANČIUKAI;6031442797;Ne;0;3;0;3
4775;Lazdynėlis;ANČIUKAI;7552873109;Ne;16;0;0;16
4776;Lazdynėlis;ANČIUKAI;7655218276;Ne;0;4;0;4
4777;Lazdynėlis;ANČIUKAI;7561833526;Ne;5;2;0;7
4778;Lazdynėlis;ANČIUKAI;6817162699;Ne;5;9;0;14
4779;Lazdynėlis;ANČIUKAI;2294873565;Ne;10;0;0;10
4780;Lazdynėlis;ANČIUKAI;1499729462;Ne;0;1;0;1
4781;Lazdynėlis;ANČIUKAI;4745610579;Ne;0;1;0;1
4782;Lazdynėlis;ANČIUKAI;3036055537;Ne;6;0;0;6
4783;Lazdynėlis;ANČIUKAI;2911152510;Ne;8;4;0;12
4784;Lazdynėlis;ANČIUKAI;2933025284;Ne;10;0;1;11
4785;Lazdynėlis;ANČIUKAI;5832624944;Ne;16;0;0;16
4786;Lazdynėlis;ANČIUKAI;1168433014;Ne;0;6;0;6
4787;Lazdynėlis;ANČIUKAI;3764854654;Ne;0;0;2;2
4788;Lazdynėlis;ANČIUKAI;1961540377;Ne;3;6;0;9
4789;Lazdynėlis;GUDRUČIAI;4928593615;Ne;0;2;0;2
4790;Lazdynėlis;GUDRUČIAI;6684940385;Ne;0;4;0;4
4791;Lazdynėlis;GUDRUČIAI;9187681789;Ne;0;1;6;7
4792;Lazdynėlis;GUDRUČIAI;6307407620;Ne;0;4;0;4
4793;Lazdynėlis;GUDRUČIAI;24978945607;Ne;5;1;0;6
4794;Lazdynėlis;GUDRUČIAI;18498032472;Ne;0;1;0;1
4795;Lazdynėlis;GUDRUČIAI;158059657;Ne;0;0;2;2
4796;Lazdynėlis;GUDRUČIAI;1852865534;Ne;3;0;2;5
4797;Lazdynėlis;GUDRUČIAI;2587142646;Ne;4;10;0;14
4798;Lazdynėlis;GUDRUČIAI;3902772678;Ne;0;2;0;2
4799;Lazdynėlis;GUDRUČIAI;8822378464;Ne;3;0;0;3
4800;Lazdynėlis;GUDRUČIAI;2441835588;Ne;0;5;0;5
4801;Lazdynėlis;GUDRUČIAI;1386686123;Ne;3;4;0;7
4802;Lazdynėlis;GUDRUČIAI;2603427970;Ne;0;19;0;19
4803;Lazdynėlis;GUDRUČIAI;7965433882;Ne;0;4;0;4
4804;Lazdynėlis;GUDRUČIAI;6863715428;Ne;0;5;0;5
4805;Lazdynėlis;GUDRUČIAI;4779025603;Ne;7;4;3;14
4806;Lazdynėlis;GUDRUČIAI;44510351979;Ne;0;1;2;3
4807;Lazdynėlis;GUDRUČIAI;5182241318;Ne;1;10;1;12
4808;Lazdynėlis;GUDRUČIAI;8008332680;Ne;0;1;0;1
4809;Lazdynėlis;MEŠKIUKAI;4094713096;Ne;4;4;1;9
4810;Lazdynėlis;MEŠKIUKAI;4267469349;Ne;9;0;0;9
4811;Lazdynėlis;MEŠKIUKAI;5354852979;Ne;0;21;0;21
4812;Lazdynėlis;MEŠKIUKAI;3427972329;Ne;7;3;0;10
4813;Lazdynėlis;MEŠKIUKAI;6941986839;Ne;12;0;0;12
4814;Lazdynėlis;MEŠKIUKAI;3697808826;Ne;3;2;0;5
4815;Lazdynėlis;MEŠKIUKAI;2812633983;Ne;5;0;0;5
4816;Lazdynėlis;MEŠKIUKAI;9590507486;Ne;0;2;0;2
4817;Lazdynėlis;MEŠKIUKAI;1488371861;Ne;0;0;1;1
4818;Lazdynėlis;MEŠKIUKAI;5982766841;Ne;0;21;0;21
4819;Lazdynėlis;MEŠKIUKAI;6831456807;Ne;10;5;0;15
4820;Lazdynėlis;MEŠKIUKAI;4795464133;Ne;5;1;0;6
4821;Lazdynėlis;MEŠKIUKAI;8567304224;Ne;5;0;0;5
4822;Lazdynėlis;MEŠKIUKAI;7754329238;Ne;0;2;2;4
4823;Lazdynėlis;MEŠKIUKAI;4366502064;Ne;0;0;1;1
4824;Lazdynėlis;MEŠKIUKAI;1331380925;Ne;0;21;0;21
4825;Markučiai;Žirniukų;3525681034;Ne;7;3;1;11
4826;Markučiai;Žirniukų;7312533881;Ne;9;4;0;13
4827;Markučiai;Žirniukų;5250815223;Ne;0;0;2;2
4828;Markučiai;Žirniukų;8934965409;Ne;0;4;0;4
4829;Markučiai;Žirniukų;8360526946;Ne;6;12;0;18
4830;Markučiai;Žirniukų;2096169972;Ne;7;0;0;7
4831;Markučiai;Žirniukų;3073404128;Ne;0;7;0;7
4832;Markučiai;Žirniukų;6674351628;Taip;0;0;5;5
4833;Markučiai;Žirniukų;2367999201;Ne;2;0;5;7
4834;Markučiai;Žirniukų;4223653505;Ne;10;4;0;14
4835;Markučiai;Žirniukų;2099285475;Ne;2;4;11;17
4836;Markučiai;Žirniukų;2344252204;Ne;5;0;11;16
4837;Markučiai;Žirniukų;9576412366;Ne;8;6;0;14
4838;Markučiai;Žirniukų;1395241501;Ne;5;0;1;6
4839;Markučiai;Žirniukų;2526619144;Ne;5;1;0;6
4840;Markučiai;Nykštukų;7507551844;Ne;0;2;1;3
4841;Markučiai;Nykštukų;9545967631;Ne;0;1;0;1
4842;Markučiai;Nykštukų;6121911851;Ne;0;0;2;2
4843;Markučiai;Nykštukų;6898055631;Ne;5;1;3;9
4844;Markučiai;Nykštukų;3378749042;Ne;0;13;0;13
4845;Markučiai;Nykštukų;2170380827;Ne;0;2;2;4
4846;Markučiai;Nykštukų;5183244346;Ne;0;6;0;6
4847;Markučiai;Nykštukų;7624913025;Ne;0;16;0;16
4848;Markučiai;Nykštukų;4679710493;Ne;1;0;0;1
4849;Markučiai;Nykštukų;2994895532;Ne;0;2;0;2
4850;Markučiai;Nykštukų;4846899377;Ne;0;1;2;3
4851;Markučiai;Nykštukų;7680126946;Ne;0;0;2;2
4852;Markučiai;Nykštukų;4222017733;Ne;4;0;0;4
4853;Markučiai;Nykštukų;3414015064;Ne;10;0;0;10
4854;Markučiai;Nykštukų;7642401516;Ne;0;0;4;4
4855;Markučiai;Pelėdžiukų;9180404247;Ne;0;0;3;3
4856;Markučiai;Pelėdžiukų;3386071459;Ne;3;0;10;13
4857;Markučiai;Pelėdžiukų;4653663237;Ne;0;0;3;3
4858;Markučiai;Pelėdžiukų;5727655114;Ne;0;4;0;4
4859;Markučiai;Pelėdžiukų;6740434675;Ne;2;0;1;3
4860;Markučiai;Pelėdžiukų;6707310242;Ne;0;0;4;4
4861;Markučiai;Pelėdžiukų;4418580273;Ne;0;0;2;2
4862;Markučiai;Pelėdžiukų;5522654429;Ne;9;5;0;14
4863;Markučiai;Pelėdžiukų;9219710045;Ne;0;0;4;4
4864;Markučiai;Pelėdžiukų;7539605426;Ne;6;0;0;6
4865;Markučiai;Pelėdžiukų;1799946177;Ne;7;0;0;7
4866;Markučiai;Pelėdžiukų;7809719827;Ne;0;0;1;1
4867;Markučiai;Pelėdžiukų;4860961508;Ne;0;0;1;1
4868;Markučiai;Pelėdžiukų;6260010822;Ne;8;1;0;9
4869;Markučiai;Pelėdžiukų;6569807889;Ne;0;2;0;2
4870;Markučiai;Pelėdžiukų;5269411010;Ne;0;0;5;5
4871;Markučiai;Boružėlių;1171899107;Ne;0;4;1;5
4872;Markučiai;Boružėlių;8078777204;Ne;4;6;1;11
4873;Markučiai;Boružėlių;8244065962;Ne;0;7;0;7
4874;Markučiai;Boružėlių;5981692282;Ne;0;2;0;2
4875;Markučiai;Boružėlių;3739566642;Ne;19;0;0;19
4876;Markučiai;Boružėlių;6868394315;Ne;0;4;0;4
4877;Markučiai;Boružėlių;5663147778;Ne;0;4;3;7
4878;Markučiai;Boružėlių;8271830626;Ne;0;2;0;2
4879;Markučiai;Boružėlių;8046320044;Ne;5;0;0;5
4880;Markučiai;Boružėlių;3315824027;Ne;5;11;0;16
4881;Markučiai;Boružėlių;2060024771;Ne;8;0;3;11
4882;Markučiai;Boružėlių;2539486337;Ne;0;2;0;2
4883;Markučiai;Boružėlių;5562960498;Ne;4;5;2;11
4884;Markučiai;Boružėlių;3296423510;Ne;10;0;3;13
4885;Markučiai;Boružėlių;2543313198;Ne;0;0;1;1
4886;Markučiai;Bitučių;1720541082;Ne;3;2;2;7
4887;Markučiai;Bitučių;8792524832;Ne;1;3;0;4
4888;Markučiai;Bitučių;1717624510;Ne;0;0;1;1
4889;Markučiai;Bitučių;9518247571;Ne;5;4;0;9
4890;Markučiai;Bitučių;4836298058;Ne;6;0;7;13
4891;Markučiai;Bitučių;9027071539;Ne;3;1;0;4
4892;Markučiai;Bitučių;8748794886;Ne;0;0;1;1
4893;Markučiai;Bitučių;7387460586;Ne;0;4;0;4
4894;Markučiai;Bitučių;8950442843;Ne;12;0;1;13
4895;Markučiai;Bitučių;2840564082;Ne;0;10;0;10
4896;Markučiai;Bitučių;3926993383;Ne;0;0;6;6
4897;Markučiai;Bitučių;6530101961;Ne;4;6;5;15
4898;Markučiai;Bitučių;1908302738;Ne;0;4;9;13
4899;Markučiai;Bitučių;7056367646;Ne;14;4;1;19
4900;Markučiai;Bitučių;2049497686;Ne;6;9;0;15
4901;Markučiai;Bitučių;8541042547;Ne;0;0;5;5
4902;Markučiai;Bitučių;1447116821;Ne;0;0;4;4
4903;Markučiai;Bitučių;2931958829;Ne;0;3;1;4
4904;Markučiai;Drugelių;2537459830;Ne;0;5;0;5
4905;Markučiai;Drugelių;2288910885;Ne;6;0;8;14
4906;Markučiai;Drugelių;3544565354;Ne;0;0;3;3
4907;Markučiai;Drugelių;6992161129;Ne;11;0;0;11
4908;Markučiai;Drugelių;5024860112;Ne;0;1;0;1
4909;Markučiai;Drugelių;9412129807;Ne;6;0;0;6
4910;Markučiai;Drugelių;6979218594;Ne;6;0;0;6
4911;Markučiai;Drugelių;3491734422;Ne;0;0;4;4
4912;Markučiai;Drugelių;3491734422;Ne;0;0;4;4
4913;Markučiai;Drugelių;3491734422;Ne;0;0;4;4
4914;Markučiai;Drugelių;3832641521;Ne;0;0;1;1
4915;Markučiai;Drugelių;4520724770;Ne;5;0;4;9
4916;Markučiai;Drugelių;8050852518;Ne;0;0;3;3
4917;Markučiai;Drugelių;9391866085;Ne;0;0;5;5
4918;Markučiai;Drugelių;9073616238;Ne;0;0;2;2
4919;Markučiai;Drugelių;4918717178;Ne;5;0;16;21
4920;Markučiai;Drugelių;2967726802;Ne;11;0;0;11
4921;Markučiai;Drugelių;6684544229;Ne;0;0;5;5
4922;Markučiai;Drugelių;8230148662;Ne;16;0;2;18
4923;Markučiai;Drugelių;3487571241;Ne;11;0;0;11
4924;Markučiai;Skruzdėliukų;8105747904;Ne;11;4;0;15
4925;Markučiai;Skruzdėliukų;6617799980;Ne;0;11;0;11
4926;Markučiai;Skruzdėliukų;4369408254;Ne;0;0;1;1
4927;Markučiai;Skruzdėliukų;7580249913;Ne;12;0;0;12
4928;Markučiai;Skruzdėliukų;2246646548;Ne;12;0;1;13
4929;Markučiai;Skruzdėliukų;9921530582;Ne;0;0;3;3
4930;Markučiai;Skruzdėliukų;6759427415;Ne;2;0;0;2
4931;Markučiai;Skruzdėliukų;4820576711;Ne;2;0;0;2
4932;Markučiai;Skruzdėliukų;1527620947;Ne;2;16;0;18
4933;Markučiai;Skruzdėliukų;8774323234;Ne;3;0;2;5
4934;Markučiai;Skruzdėliukų;7881183912;Ne;10;4;0;14
4935;Markučiai;Skruzdėliukų;9338996275;Ne;15;0;0;15
4936;Markučiai;Skruzdėliukų;5180034556;Ne;3;0;1;4
4937;Markučiai;Skruzdėliukų;4383128686;Ne;6;0;0;6
4938;Markučiai;Skruzdėliukų;1929417022;Ne;5;0;0;5
4939;Markučiai;Skruzdėliukų;8679791696;Ne;0;1;0;1
4940;Markučiai;ZUIKUČIŲ;82320812575;Ne;0;1;1;2
4941;Markučiai;ZUIKUČIŲ;4861535057;Ne;0;5;0;5
4942;Markučiai;ZUIKUČIŲ;1482203905;Ne;0;3;0;3
4943;Markučiai;ZUIKUČIŲ;11751635395;Ne;0;3;0;3
4944;Markučiai;ZUIKUČIŲ;1184908076;Ne;0;0;3;3
4945;Markučiai;ZUIKUČIŲ;7729045227;Ne;11;4;0;15
4946;Markučiai;ZUIKUČIŲ;8061880631;Ne;0;1;0;1
4947;Markučiai;ZUIKUČIŲ;1392582514;Ne;0;2;0;2
4948;Markučiai;ZUIKUČIŲ;7691410556;Ne;5;5;0;10
4949;Markučiai;ZUIKUČIŲ;6453095915;Ne;6;4;0;10
4950;Markučiai;ZUIKUČIŲ;6808291628;Ne;0;16;0;16
4951;Markučiai;ZUIKUČIŲ;5387571295;Ne;0;4;2;6
4952;Markučiai;ZUIKUČIŲ;3794643964;Ne;0;14;0;14
4953;Markučiai;ZUIKUČIŲ;91228262895;Ne;0;1;0;1
4954;Markučiai;ZUIKUČIŲ;5749873170;Ne;0;4;0;4
4955;Markučiai;ZUIKUČIŲ;6055058096;Ne;0;1;0;1
4956;Markučiai;ZUIKUČIŲ;1956224017;Ne;0;11;0;11
4957;Markučiai;ŽIOGELIŲ;3163226803;Ne;0;5;2;7
4958;Markučiai;ŽIOGELIŲ;1244026489;Ne;0;3;0;3
4959;Markučiai;ŽIOGELIŲ;76025616287;Ne;0;4;0;4
4960;Markučiai;ŽIOGELIŲ;54892037118;Ne;0;5;7;12
4961;Markučiai;ŽIOGELIŲ;1054802708;Ne;0;2;1;3
4962;Markučiai;ŽIOGELIŲ;67074776419;Ne;0;4;0;4
4963;Markučiai;ŽIOGELIŲ;1007919702;Ne;0;14;0;14
4964;Markučiai;ŽIOGELIŲ;1923521405;Ne;0;5;0;5
4965;Markučiai;ŽIOGELIŲ;1164386108;Ne;0;5;0;5
4966;Markučiai;ŽIOGELIŲ;2169583290;Ne;0;5;0;5
4967;Markučiai;ŽIOGELIŲ;3340385503;Ne;5;4;1;10
4968;Markučiai;ŽIOGELIŲ;1742944578;Ne;0;1;0;1
4969;Markučiai;ŽIOGELIŲ;23267867195;Ne;0;1;0;1
4970;Markučiai;ŽIOGELIŲ;7481923902;Ne;0;5;0;5
4971;Markučiai;ŽIOGELIŲ;4324776209;Ne;0;1;1;2
4972;Markučiai;ŽIOGELIŲ;3893711315;Ne;0;5;0;5
4973;Markučiai;Ežiukių;1827829954;Ne;0;6;0;6
4974;Markučiai;Ežiukių;4925856706;Ne;8;4;0;12
4975;Markučiai;Ežiukių;6570638672;Ne;16;5;0;21
4976;Markučiai;Ežiukių;5975331223;Ne;0;9;0;9
4977;Markučiai;Ežiukių;2687320408;Ne;9;3;0;12
4978;Markučiai;Ežiukių;8990923872;Ne;0;17;0;17
4979;Markučiai;Ežiukių;5246980173;Ne;3;1;0;4
4980;Markučiai;Ežiukių;6308368050;Ne;6;2;0;8
4981;Markučiai;Ežiukių;4249158803;Ne;4;2;0;6
4982;Markučiai;Ežiukių;5958705106;Ne;9;0;0;9
4983;Markučiai;Ežiukių;1769984489;Ne;0;4;1;5
4984;Markučiai;Ežiukių;7791500322;Ne;0;5;0;5
4985;Markučiai;Ežiukių;9059302464;Ne;8;6;5;19
4986;Markučiai;Ežiukių;2962530721;Ne;4;0;0;4
4987;Markučiai;Ežiukių;6574037877;Ne;2;0;0;2
4988;Markučiai;Ežiukių;5752762229;Ne;0;1;0;1
4989;Markučiai;Ežiukių;4383421917;Ne;0;3;0;3
4990;Markučiai;Ežiukių;9789274040;Ne;6;15;0;21
4991;Mažylis;"4 PRIEŠMOKYKLINĖ GR.";9411559447;Ne;0;0;6;6
4992;Mažylis;"4 PRIEŠMOKYKLINĖ GR.";4252408251;Ne;3;0;1;4
4993;Mažylis;"4 PRIEŠMOKYKLINĖ GR.";4503734408;Ne;0;0;6;6
4994;Mažylis;"4 PRIEŠMOKYKLINĖ GR.";8352202912;Ne;0;0;1;1
4995;Mažylis;"4 PRIEŠMOKYKLINĖ GR.";38277640135;Ne;5;4;1;10
4996;Mažylis;"4 PRIEŠMOKYKLINĖ GR.";1663347167;Ne;0;4;5;9
4997;Mažylis;"4 PRIEŠMOKYKLINĖ GR.";6854350717;Ne;0;0;9;9
4998;Mažylis;"4 PRIEŠMOKYKLINĖ GR.";6920129837;Ne;3;0;1;4
4999;Mažylis;"4 PRIEŠMOKYKLINĖ GR.";1460572347;Ne;0;0;1;1
5000;Mažylis;"4 PRIEŠMOKYKLINĖ GR.";7185347381;Ne;0;4;0;4
5001;Mažylis;"4 PRIEŠMOKYKLINĖ GR.";3344476309;Ne;0;0;2;2
5002;Mažylis;"4 PRIEŠMOKYKLINĖ GR.";6851169340;Ne;5;0;0;5
5003;Mažylis;"4 PRIEŠMOKYKLINĖ GR.";3217527771;Ne;9;0;0;9
5004;Mažylis;"4 PRIEŠMOKYKLINĖ GR.";7416381505;Ne;7;0;4;11
5005;Mažylis;"4 PRIEŠMOKYKLINĖ GR.";1514640197;Ne;0;0;4;4
5006;Mažylis;"4 PRIEŠMOKYKLINĖ GR.";1002832487;Ne;0;0;4;4
5007;Mažylis;"4 PRIEŠMOKYKLINĖ GR.";9608529135;Ne;0;0;8;8
5008;Mažylis;"4 PRIEŠMOKYKLINĖ GR.";4645411379;Ne;4;1;0;5
5009;Mažylis;"3 DARŽELIO GR.";3081814579;Ne;0;0;4;4
5010;Mažylis;"3 DARŽELIO GR.";6100650710;Ne;0;0;3;3
5011;Mažylis;"3 DARŽELIO GR.";9401388775;Ne;0;0;6;6
5012;Mažylis;"3 DARŽELIO GR.";4817146074;Ne;9;0;0;9
5013;Mažylis;"3 DARŽELIO GR.";7106648054;Ne;9;0;0;9
5014;Mažylis;"3 DARŽELIO GR.";6809320247;Ne;0;4;6;10
5015;Mažylis;"3 DARŽELIO GR.";7652390515;Ne;0;0;5;5
5016;Mažylis;"3 DARŽELIO GR.";9341935211;Ne;0;0;8;8
5017;Mažylis;"3 DARŽELIO GR.";2989562406;Ne;9;0;2;11
5018;Mažylis;"3 DARŽELIO GR.";1151737098;Ne;6;1;0;7
5019;Mažylis;"3 DARŽELIO GR.";7642914458;Ne;5;4;0;9
5020;Mažylis;"3 DARŽELIO GR.";5938312001;Ne;0;0;5;5
5021;Mažylis;"3 DARŽELIO GR.";2119733659;Ne;0;0;5;5
5022;Mažylis;"3 DARŽELIO GR.";6904083734;Ne;5;0;1;6
5023;Mažylis;"3 DARŽELIO GR.";2319506343;Ne;0;1;1;2
5024;Mažylis;"3 DARŽELIO GR.";9416161833;Ne;10;0;0;10
5025;Mažylis;"3 DARŽELIO GR.";9807376076;Ne;0;0;3;3
5026;Mažylis;"6 DARŽELIO GR.";5388105083;Ne;4;0;4;8
5027;Mažylis;"6 DARŽELIO GR.";8589124394;Ne;10;0;0;10
5028;Mažylis;"6 DARŽELIO GR.";3641990617;Ne;5;1;0;6
5029;Mažylis;"6 DARŽELIO GR.";1892136590;Ne;0;4;0;4
5030;Mažylis;"6 DARŽELIO GR.";9479398581;Ne;0;1;0;1
5031;Mažylis;"6 DARŽELIO GR.";1381828313;Ne;0;0;4;4
5032;Mažylis;"6 DARŽELIO GR.";7725286603;Ne;0;4;5;9
5033;Mažylis;"6 DARŽELIO GR.";9894955253;Ne;0;0;3;3
5034;Mažylis;"6 DARŽELIO GR.";6270840529;Ne;8;0;0;8
5035;Mažylis;"6 DARŽELIO GR.";4100492642;Ne;11;0;6;17
5036;Mažylis;"6 DARŽELIO GR.";6492768766;Ne;0;0;5;5
5037;Mažylis;"6 DARŽELIO GR.";6423910850;Ne;0;2;5;7
5038;Mažylis;"6 DARŽELIO GR.";1555305826;Ne;0;0;1;1
5039;Mažylis;"6 DARŽELIO GR.";5977423702;Ne;0;0;4;4
5040;Mažylis;"6 DARŽELIO GR.";5990843024;Ne;5;0;3;8
5041;Mažylis;"6 DARŽELIO GR.";9981751097;Ne;0;0;9;9
5042;Mažylis;"6 DARŽELIO GR.";5137132420;Ne;0;0;2;2
5043;Mažylis;"1 NAUJA (LOPŠELIS)";4985161657;Ne;0;4;0;4
5044;Mažylis;"1 NAUJA (LOPŠELIS)";5297935198;Ne;1;1;0;2
5045;Mažylis;"1 NAUJA (LOPŠELIS)";1993916098;Ne;0;0;1;1
5046;Mažylis;"1 NAUJA (LOPŠELIS)";5727207294;Ne;0;0;1;1
5047;Mažylis;"1 NAUJA (LOPŠELIS)";3064367996;Ne;0;9;0;9
5048;Mažylis;"1 NAUJA (LOPŠELIS)";2110320072;Ne;3;0;1;4
5049;Mažylis;"1 NAUJA (LOPŠELIS)";7810360699;Ne;5;0;0;5
5050;Mažylis;"1 NAUJA (LOPŠELIS)";3911343193;Ne;0;0;4;4
5051;Mažylis;"1 NAUJA (LOPŠELIS)";5225388496;Ne;0;4;0;4
5052;Mažylis;"1 NAUJA (LOPŠELIS)";6500577246;Ne;0;0;4;4
5053;Mažylis;"1 NAUJA (LOPŠELIS)";3098913589;Ne;0;0;2;2
5054;Mažylis;"1 NAUJA (LOPŠELIS)";4201114033;Ne;7;0;1;8
5055;Mažylis;"1 NAUJA (LOPŠELIS)";8871998701;Ne;0;0;5;5
5056;Mažylis;"1 NAUJA (LOPŠELIS)";4347489809;Ne;3;0;6;9
5057;Mažylis;"1 NAUJA (LOPŠELIS)";4557902728;Ne;5;0;1;6
5058;Mažylis;"5 DARŽELIO GR.";2935175014;Ne;15;0;2;17
5059;Mažylis;"5 DARŽELIO GR.";2979849055;Ne;0;0;10;10
5060;Mažylis;"5 DARŽELIO GR.";6162880220;Ne;0;4;2;6
5061;Mažylis;"5 DARŽELIO GR.";1762105763;Ne;0;4;1;5
5062;Mažylis;"5 DARŽELIO GR.";2672500259;Ne;0;0;8;8
5063;Mažylis;"5 DARŽELIO GR.";8135596731;Ne;0;0;3;3
5064;Mažylis;"5 DARŽELIO GR.";8866980930;Ne;3;1;0;4
5065;Mažylis;"5 DARŽELIO GR.";2704741847;Ne;0;4;0;4
5066;Mažylis;"5 DARŽELIO GR.";4280547746;Ne;0;5;4;9
5067;Mažylis;"5 DARŽELIO GR.";9447747294;Ne;0;0;11;11
5068;Mažylis;"5 DARŽELIO GR.";4542742002;Ne;0;0;7;7
5069;Mažylis;"5 DARŽELIO GR.";2126108232;Ne;0;4;0;4
5070;Mažylis;"5 DARŽELIO GR.";5685988186;Ne;0;0;1;1
5071;Mažylis;"5 DARŽELIO GR.";5870983755;Ne;0;0;3;3
5072;Mažylis;"5 DARŽELIO GR.";8999239172;Ne;0;0;2;2
5073;Mažylis;"5 DARŽELIO GR.";3365026025;Ne;6;0;5;11
5074;Mažylis;"DARŽELIS 2 GR.";2795618410;Ne;14;0;0;14
5075;Mažylis;"DARŽELIS 2 GR.";9727982334;Ne;5;0;0;5
5076;Mažylis;"DARŽELIS 2 GR.";8655053217;Ne;4;0;0;4
5077;Mažylis;"DARŽELIS 2 GR.";7414398772;Ne;0;0;4;4
5078;Mažylis;"DARŽELIS 2 GR.";1058725505;Ne;5;3;1;9
5079;Mažylis;"DARŽELIS 2 GR.";4880415881;Ne;0;0;1;1
5080;Mažylis;"DARŽELIS 2 GR.";1219174313;Ne;5;0;1;6
5081;Mažylis;"DARŽELIS 2 GR.";9111101357;Ne;17;0;0;17
5082;Mažylis;"DARŽELIS 2 GR.";1533948576;Ne;0;5;3;8
5083;Mažylis;"DARŽELIS 2 GR.";6728351360;Ne;0;0;1;1
5084;Mažylis;"DARŽELIS 2 GR.";7255856938;Ne;0;14;1;15
5085;Mažylis;"DARŽELIS 2 GR.";4987487972;Ne;15;0;2;17
5086;Mažylis;"DARŽELIS 2 GR.";9555408203;Ne;2;0;0;2
5087;Mažylis;"DARŽELIS 2 GR.";5165268747;Ne;0;0;4;4
5088;Mažylis;"DARŽELIS 2 GR.";2425437724;Ne;0;0;8;8
5089;Mažylis;"DARŽELIS 2 GR.";2723677422;Ne;2;0;5;7
5090;Mažylis;"DARŽELIS 2 GR.";9875575387;Ne;0;0;1;1
5091;Mažylis;"DARŽELIS 2 GR.";5658868407;Ne;6;0;5;11
5092;Mažylis;"DARŽELIS 2 GR.";9025867358;Ne;0;0;11;11
5093;Medynėlis;BITUTĖS;6238256156;Ne;0;8;0;8
5094;Medynėlis;BITUTĖS;2993705115;Ne;0;4;7;11
5095;Medynėlis;BITUTĖS;1504612730;Ne;0;1;1;2
5096;Medynėlis;BITUTĖS;5522261530;Ne;0;1;0;1
5097;Medynėlis;BITUTĖS;6576401514;Ne;0;0;1;1
5098;Medynėlis;BITUTĖS;4107846958;Ne;2;7;0;9
5099;Medynėlis;BITUTĖS;7296044569;Ne;0;4;0;4
5100;Medynėlis;BITUTĖS;4418330478;Ne;9;0;0;9
5101;Medynėlis;BITUTĖS;6074296305;Ne;0;1;0;1
5102;Medynėlis;BITUTĖS;6815521895;Ne;0;0;6;6
5103;Medynėlis;BITUTĖS;4374464298;Ne;7;0;0;7
5104;Medynėlis;BITUTĖS;8107171123;Ne;0;9;0;9
5105;Medynėlis;BITUTĖS;4545707752;Ne;2;0;1;3
5106;Medynėlis;BITUTĖS;4419503239;Ne;5;0;0;5
5107;Medynėlis;BITUTĖS;7870261906;Ne;0;4;0;4
5108;Medynėlis;BITUTĖS;6466874318;Ne;1;6;2;9
5109;Medynėlis;BITUTĖS;2798305000;Ne;3;1;0;4
5110;Medynėlis;BITUTĖS;5440233814;Taip;0;0;1;1
5111;Medynėlis;BITUTĖS;4598267411;Ne;9;1;2;12
5112;Medynėlis;BITUTĖS;5194220650;Ne;2;0;0;2
5113;Medynėlis;BITUTĖS;4243521511;Ne;0;0;6;6
5114;Medynėlis;DRUGELIAI;7886801955;Ne;0;1;0;1
5115;Medynėlis;DRUGELIAI;6127747445;Ne;0;2;0;2
5116;Medynėlis;DRUGELIAI;33981260502;Ne;0;6;4;10
5117;Medynėlis;DRUGELIAI;4581683292;Ne;0;9;0;9
5118;Medynėlis;DRUGELIAI;7633674694;Ne;0;3;0;3
5119;Medynėlis;DRUGELIAI;5530782065;Ne;0;4;0;4
5120;Medynėlis;DRUGELIAI;6343851636;Ne;0;4;0;4
5121;Medynėlis;DRUGELIAI;8948133343;Ne;0;3;0;3
5122;Medynėlis;DRUGELIAI;9413309043;Ne;0;6;0;6
5123;Medynėlis;DRUGELIAI;3773215372;Ne;3;10;0;13
5124;Medynėlis;DRUGELIAI;1795479738;Ne;20;0;0;20
5125;Medynėlis;DRUGELIAI;4024866819;Ne;0;1;0;1
5126;Medynėlis;DRUGELIAI;7244497661;Ne;0;1;0;1
5127;Medynėlis;DRUGELIAI;8775219704;Ne;0;1;0;1
5128;Medynėlis;DRUGELIAI;5269927048;Ne;5;2;0;7
5129;Medynėlis;DRUGELIAI;2540325264;Ne;0;2;0;2
5130;Medynėlis;DRUGELIAI;3870665108;Ne;0;5;0;5
5131;Medynėlis;DRUGELIAI;9670396828;Ne;0;1;0;1
5132;Medynėlis;DRUGELIAI;5551121950;Ne;0;4;0;4
5133;Medynėlis;DRUGELIAI;2627421550;Ne;0;4;0;4
5134;Medynėlis;DRUGELIAI;2794274146;Ne;0;4;0;4
5135;Medynėlis;SKRUZDĖLIUKAI;4783894465;Ne;0;14;0;14
5136;Medynėlis;SKRUZDĖLIUKAI;3905440176;Ne;0;0;2;2
5137;Medynėlis;SKRUZDĖLIUKAI;1142044361;Ne;2;4;1;7
5138;Medynėlis;SKRUZDĖLIUKAI;8719860414;Ne;8;0;2;10
5139;Medynėlis;SKRUZDĖLIUKAI;4645171858;Ne;6;2;1;9
5140;Medynėlis;SKRUZDĖLIUKAI;3947494044;Ne;0;1;0;1
5141;Medynėlis;SKRUZDĖLIUKAI;3295727210;Ne;3;5;0;8
5142;Medynėlis;SKRUZDĖLIUKAI;8441629302;Ne;0;1;0;1
5143;Medynėlis;SKRUZDĖLIUKAI;3761140697;Ne;14;0;1;15
5144;Medynėlis;SKRUZDĖLIUKAI;5330900656;Ne;10;0;2;12
5145;Medynėlis;SKRUZDĖLIUKAI;4897227188;Ne;1;4;3;8
5146;Medynėlis;SKRUZDĖLIUKAI;9705185906;Ne;0;0;1;1
5147;Medynėlis;SKRUZDĖLIUKAI;9873696787;Taip;10;4;0;14
5148;Medynėlis;SKRUZDĖLIUKAI;2218838971;Ne;0;0;5;5
5149;Medynėlis;SKRUZDĖLIUKAI;1206480760;Ne;14;0;0;14
5150;Medynėlis;SKRUZDĖLIUKAI;3790099536;Ne;4;0;2;6
5151;Medynėlis;VOVERIUKAI;6826790492;Ne;0;7;4;11
5152;Medynėlis;VOVERIUKAI;2627655353;Ne;0;0;5;5
5153;Medynėlis;VOVERIUKAI;4488439037;Ne;19;0;0;19
5154;Medynėlis;VOVERIUKAI;6101613567;Ne;6;0;0;6
5155;Medynėlis;VOVERIUKAI;1056744101;Ne;0;4;5;9
5156;Medynėlis;VOVERIUKAI;6485314750;Ne;0;4;4;8
5157;Medynėlis;VOVERIUKAI;7455041214;Ne;0;4;0;4
5158;Medynėlis;VOVERIUKAI;2234994999;Ne;0;6;0;6
5159;Medynėlis;VOVERIUKAI;3761845905;Taip;0;0;10;10
5160;Medynėlis;VOVERIUKAI;4217263449;Ne;0;4;0;4
5161;Medynėlis;VOVERIUKAI;9825580191;Ne;0;2;0;2
5162;Medynėlis;VOVERIUKAI;4092824377;Ne;5;5;0;10
5163;Medynėlis;VOVERIUKAI;1475701065;Ne;0;4;0;4
5164;Medynėlis;VOVERIUKAI;3674134340;Ne;10;0;1;11
5165;Medynėlis;VOVERIUKAI;5028189785;Ne;0;2;3;5
5166;Medynėlis;VOVERIUKAI;2784942324;Taip;1;4;0;5
5167;Medynėlis;MEŠKIUKAI;7740591575;Ne;0;3;0;3
5168;Medynėlis;MEŠKIUKAI;9304002459;Ne;0;1;3;4
5169;Medynėlis;MEŠKIUKAI;90556319090;Ne;0;1;1;2
5170;Medynėlis;MEŠKIUKAI;9800678364;Ne;0;3;8;11
5171;Medynėlis;MEŠKIUKAI;2057309788;Ne;0;0;1;1
5172;Medynėlis;MEŠKIUKAI;5982453884;Ne;0;0;2;2
5173;Medynėlis;MEŠKIUKAI;2310200034;Ne;2;1;0;3
5174;Medynėlis;MEŠKIUKAI;1750775033;Ne;0;1;0;1
5175;Medynėlis;MEŠKIUKAI;2335108073;Ne;0;1;0;1
5176;Medynėlis;MEŠKIUKAI;1237589979;Ne;4;0;0;4
5177;Medynėlis;MEŠKIUKAI;1820113382;Ne;0;5;0;5
5178;Medynėlis;MEŠKIUKAI;6406459222;Ne;17;0;0;17
5179;Medynėlis;MEŠKIUKAI;4985243068;Ne;15;0;1;16
5180;Medynėlis;MEŠKIUKAI;7108619017;Ne;0;0;2;2
5181;Medynėlis;MEŠKIUKAI;6999562417;Ne;17;0;0;17
5182;Medynėlis;MEŠKIUKAI;7140184593;Ne;8;0;0;8
5183;Medynėlis;PELĖDŽIUKAI;2932544910;Ne;17;0;0;17
5184;Medynėlis;PELĖDŽIUKAI;9079900803;Ne;0;0;3;3
5185;Medynėlis;PELĖDŽIUKAI;5571641847;Ne;11;0;0;11
5186;Medynėlis;PELĖDŽIUKAI;2103255454;Ne;4;2;0;6
5187;Medynėlis;PELĖDŽIUKAI;9355165862;Ne;4;3;0;7
5188;Medynėlis;PELĖDŽIUKAI;9184868565;Ne;14;0;0;14
5189;Medynėlis;PELĖDŽIUKAI;6955467123;Ne;3;0;0;3
5190;Medynėlis;PELĖDŽIUKAI;6073797962;Ne;10;0;0;10
5191;Medynėlis;PELĖDŽIUKAI;5785463517;Ne;10;0;0;10
5192;Medynėlis;PELĖDŽIUKAI;4222917765;Ne;0;9;0;9
5193;Medynėlis;PELĖDŽIUKAI;1621499650;Ne;0;9;0;9
5194;Medynėlis;PELĖDŽIUKAI;6681155625;Ne;0;0;1;1
5195;Medynėlis;PELĖDŽIUKAI;9438854582;Ne;8;0;5;13
5196;Medynėlis;PELĖDŽIUKAI;1901805808;Ne;0;1;2;3
5197;Medynėlis;PELĖDŽIUKAI;5784691118;Ne;0;1;2;3
5198;Medynėlis;PELĖDŽIUKAI;3856908872;Ne;0;0;2;2
5199;Medynėlis;PELĖDŽIUKAI;4468967036;Ne;0;4;0;4
5200;Medynėlis;PELĖDŽIUKAI;2702814930;Ne;5;0;0;5
5201;Medynėlis;BORUŽIUKAI;3787172254;Ne;0;2;1;3
5202;Medynėlis;BORUŽIUKAI;7232396755;Ne;0;4;0;4
5203;Medynėlis;BORUŽIUKAI;7651663404;Ne;1;1;0;2
5204;Medynėlis;BORUŽIUKAI;1463263793;Ne;0;5;0;5
5205;Medynėlis;BORUŽIUKAI;9764215406;Ne;6;0;1;7
5206;Medynėlis;BORUŽIUKAI;5532880670;Ne;0;12;0;12
5207;Medynėlis;BORUŽIUKAI;1525185037;Ne;0;3;0;3
5208;Medynėlis;BORUŽIUKAI;1333848517;Ne;0;1;1;2
5209;Medynėlis;BORUŽIUKAI;9919108302;Ne;3;2;0;5
5210;Medynėlis;BORUŽIUKAI;1162859552;Ne;0;10;0;10
5211;Medynėlis;BORUŽIUKAI;6032067904;Ne;0;9;0;9
5212;Medynėlis;BORUŽIUKAI;4315717555;Ne;0;5;0;5
5213;Medynėlis;BORUŽIUKAI;8276864168;Ne;0;1;5;6
5214;Medynėlis;BORUŽIUKAI;5544663829;Ne;0;1;0;1
5215;Medynėlis;BORUŽIUKAI;2701448160;Ne;19;0;0;19
5216;Medynėlis;BORUŽIUKAI;1658457155;Ne;0;1;1;2
5217;Medynėlis;BORUŽIUKAI;5158507933;Ne;3;0;0;3
5218;Medynėlis;BORUŽIUKAI;7501831333;Ne;0;8;0;8
5219;Medynėlis;BORUŽIUKAI;2097758483;Ne;0;8;0;8
5220;Medynėlis;BORUŽIUKAI;4267654911;Ne;0;0;1;1
5221;Medynėlis;EŽIUKAI;9729505759;Ne;0;13;0;13
5222;Medynėlis;EŽIUKAI;8125271445;Ne;0;13;0;13
5223;Medynėlis;EŽIUKAI;9847006679;Ne;12;0;0;12
5224;Medynėlis;EŽIUKAI;7317307957;Ne;5;1;3;9
5225;Medynėlis;EŽIUKAI;7860869675;Ne;1;0;1;2
5226;Medynėlis;EŽIUKAI;4471168173;Ne;0;1;0;1
5227;Medynėlis;EŽIUKAI;1062269215;Ne;0;9;2;11
5228;Medynėlis;EŽIUKAI;5197757730;Ne;0;4;0;4
5229;Medynėlis;EŽIUKAI;5333502849;Ne;0;0;4;4
5230;Medynėlis;EŽIUKAI;6536626390;Ne;9;0;0;9
5231;Medynėlis;EŽIUKAI;8953622684;Ne;4;0;0;4
5232;Medynėlis;EŽIUKAI;3230747109;Ne;0;1;0;1
5233;Medynėlis;EŽIUKAI;9175884049;Ne;5;0;0;5
5234;Medynėlis;EŽIUKAI;8609650186;Ne;0;0;4;4
5235;Medynėlis;EŽIUKAI;6826409129;Ne;1;7;5;13
5236;Medynėlis;EŽIUKAI;2929100410;Ne;10;0;0;10
5237;Medynėlis;EŽIUKAI;6359536923;Ne;0;2;1;3
5238;Medynėlis;EŽIUKAI;2676262920;Ne;0;0;2;2
5239;Medynėlis;EŽIUKAI;5339084041;Taip;17;0;0;17
5240;Medynėlis;EŽIUKAI;5766492584;Ne;0;2;1;3
5241;Medynėlis;EŽIUKAI;6561927001;Ne;0;4;0;4
5242;Medynėlis;EŽIUKAI;8838774666;Ne;21;0;0;21
5243;Medynėlis;EŽIUKAI;6349817783;Ne;0;0;7;7
5244;Medynėlis;ZUIKUČIAI;6614028601;Ne;9;0;0;9
5245;Medynėlis;ZUIKUČIAI;8439619837;Ne;9;0;0;9
5246;Medynėlis;ZUIKUČIAI;5389909872;Ne;6;1;0;7
5247;Medynėlis;ZUIKUČIAI;9352391583;Ne;2;4;2;8
5248;Medynėlis;ZUIKUČIAI;4941353702;Ne;0;0;6;6
5249;Medynėlis;ZUIKUČIAI;4040542730;Ne;0;6;0;6
5250;Medynėlis;ZUIKUČIAI;6989524053;Ne;21;0;0;21
5251;Medynėlis;ZUIKUČIAI;9774213537;Ne;3;0;0;3
5252;Medynėlis;ZUIKUČIAI;7129951535;Ne;0;0;1;1
5253;Medynėlis;ZUIKUČIAI;9977590259;Ne;0;7;0;7
5254;Medynėlis;ZUIKUČIAI;9373849916;Ne;8;0;0;8
5255;Medynėlis;ZUIKUČIAI;8678054784;Ne;0;6;0;6
5256;Medynėlis;ZUIKUČIAI;6462589513;Ne;0;1;0;1
5257;Medynėlis;ZUIKUČIAI;4204366008;Ne;0;4;0;4
5258;Medynėlis;ZUIKUČIAI;6569938649;Ne;5;0;3;8
5259;Medynėlis;ZUIKUČIAI;3480190692;Taip;7;0;0;7
5260;Medynėlis;ZUIKUČIAI;5581973770;Ne;0;0;4;4
5261;Medynėlis;KAČIUKAI;8275097931;Ne;2;6;0;8
5262;Medynėlis;KAČIUKAI;5302122600;Ne;10;0;1;11
5263;Medynėlis;KAČIUKAI;6609111216;Ne;0;0;1;1
5264;Medynėlis;KAČIUKAI;6624835214;Ne;0;0;1;1
5265;Medynėlis;KAČIUKAI;2160081492;Ne;0;5;0;5
5266;Medynėlis;KAČIUKAI;4035587227;Ne;9;2;0;11
5267;Medynėlis;KAČIUKAI;8162771849;Ne;7;0;3;10
5268;Medynėlis;KAČIUKAI;9725019515;Ne;4;0;0;4
5269;Medynėlis;KAČIUKAI;5610660982;Ne;0;0;1;1
5270;Medynėlis;KAČIUKAI;6282113738;Ne;0;0;3;3
5271;Medynėlis;KAČIUKAI;4153545500;Ne;8;7;0;15
5272;Medynėlis;KAČIUKAI;8299034970;Ne;0;5;0;5
5273;Medynėlis;KAČIUKAI;7675101600;Ne;0;4;0;4
5274;Medynėlis;KAČIUKAI;1668143166;Ne;6;0;2;8
5275;Medynėlis;KAČIUKAI;4010058673;Ne;5;0;0;5
5276;Medynėlis;KAČIUKAI;6502531749;Taip;0;0;1;1
5277;Medynėlis;KAČIUKAI;9076139419;Ne;0;0;11;11
5278;Medynėlis;KAČIUKAI;1608019909;Ne;0;2;0;2
5279;Medynėlis;KAČIUKAI;1404831377;Ne;5;0;3;8
5280;Medynėlis;KAČIUKAI;2523474347;Ne;7;6;0;13
5281;Medynėlis;PELIUKAI;6622963662;Ne;0;6;0;6
5282;Medynėlis;PELIUKAI;3638155321;Ne;0;4;3;7
5283;Medynėlis;PELIUKAI;9290099536;Taip;0;2;0;2
5284;Medynėlis;PELIUKAI;1500986498;Ne;15;0;0;15
5285;Medynėlis;PELIUKAI;6924524346;Ne;0;2;0;2
5286;Medynėlis;PELIUKAI;2379829985;Ne;0;1;0;1
5287;Medynėlis;PELIUKAI;6926408544;Ne;0;0;5;5
5288;Medynėlis;PELIUKAI;5391199861;Ne;10;0;0;10
5289;Medynėlis;PELIUKAI;6095795724;Ne;11;0;0;11
5290;Medynėlis;PELIUKAI;7914358405;Ne;0;0;1;1
5291;Medynėlis;PELIUKAI;7695626630;Ne;0;2;1;3
5292;Medynėlis;PELIUKAI;3538656650;Ne;0;4;17;21
5293;Medynėlis;PELIUKAI;6993176904;Ne;5;0;0;5
5294;Medynėlis;PELIUKAI;2877881247;Ne;15;0;0;15
5295;Medynėlis;PELIUKAI;4145591997;Ne;0;5;0;5
5296;Medynėlis;PELIUKAI;8382537735;Ne;6;0;0;6
5297;Medynėlis;PELIUKAI;6470879334;Ne;3;4;0;7
5298;Medynėlis;PELIUKAI;2816510180;Ne;6;0;0;6
5299;Medynėlis;PELIUKAI;3709984586;Ne;5;0;4;9
5300;Medynėlis;ANČIUKAI;9857514451;Ne;18;0;0;18
5301;Medynėlis;ANČIUKAI;6730475188;Ne;4;4;0;8
5302;Medynėlis;ANČIUKAI;6824842361;Ne;10;0;0;10
5303;Medynėlis;ANČIUKAI;4498233742;Ne;0;0;2;2
5304;Medynėlis;ANČIUKAI;5049081242;Ne;3;0;3;6
5305;Medynėlis;ANČIUKAI;4817353132;Ne;12;0;0;12
5306;Medynėlis;ANČIUKAI;7613699868;Taip;15;0;0;15
5307;Medynėlis;ANČIUKAI;9336656351;Ne;0;0;4;4
5308;Medynėlis;ANČIUKAI;7085226543;Ne;0;0;1;1
5309;Medynėlis;ANČIUKAI;1283602655;Ne;4;0;3;7
5310;Medynėlis;ANČIUKAI;3556203620;Ne;9;0;0;9
5311;Medynėlis;ANČIUKAI;2896713695;Ne;0;0;1;1
5312;Medynėlis;ANČIUKAI;4626655069;Ne;10;0;0;10
5313;Medynėlis;ANČIUKAI;6641009653;Ne;11;0;0;11
5314;Medynėlis;ANČIUKAI;8887092965;Ne;4;7;0;11
5315;Medynėlis;LAPIUKAI;2259408744;Ne;6;0;0;6
5316;Molinukas;NYKŠTUKAI;6353165459;Ne;0;1;0;1
5317;Molinukas;NYKŠTUKAI;5876669121;Ne;0;4;0;4
5318;Molinukas;NYKŠTUKAI;6087698882;Ne;0;4;1;5
5319;Molinukas;NYKŠTUKAI;2211909678;Ne;19;0;0;19
5320;Molinukas;NYKŠTUKAI;2348120316;Ne;0;1;0;1
5321;Molinukas;NYKŠTUKAI;8053608348;Ne;0;4;2;6
5322;Molinukas;NYKŠTUKAI;7623051674;Ne;0;2;0;2
5323;Molinukas;NYKŠTUKAI;9448910819;Ne;0;4;0;4
5324;Molinukas;NYKŠTUKAI;5580968328;Ne;0;5;0;5
5325;Molinukas;NYKŠTUKAI;8536615996;Ne;2;0;0;2
5326;Molinukas;NYKŠTUKAI;1849018608;Ne;0;4;0;4
5327;Molinukas;NYKŠTUKAI;4171978721;Ne;0;6;2;8
5328;Molinukas;NYKŠTUKAI;9293819449;Ne;0;3;1;4
5329;Molinukas;NYKŠTUKAI;5525772579;Ne;0;4;0;4
5330;Molinukas;NYKŠTUKAI;4475594896;Ne;0;7;0;7
5331;Molinukas;NYKŠTUKAI;7248705010;Ne;14;2;0;16
5332;Molinukas;NYKŠTUKAI;4101644021;Ne;0;10;0;10
5333;Molinukas;NYKŠTUKAI;6681397435;Ne;11;0;5;16
5334;Molinukas;ZUIKUČIŲ;9203375647;Ne;2;4;1;7
5335;Molinukas;ZUIKUČIŲ;2982968605;Ne;4;1;0;5
5336;Molinukas;ZUIKUČIŲ;4225457772;Ne;9;0;0;9
5337;Molinukas;ZUIKUČIŲ;8114735116;Ne;0;5;0;5
5338;Molinukas;ZUIKUČIŲ;5597119459;Ne;2;1;0;3
5339;Molinukas;ZUIKUČIŲ;8582985479;Ne;12;0;0;12
5340;Molinukas;ZUIKUČIŲ;8490020853;Ne;12;0;0;12
5341;Molinukas;ZUIKUČIŲ;2651732418;Ne;0;5;0;5
5342;Molinukas;ZUIKUČIŲ;8988478990;Ne;6;0;0;6
5343;Molinukas;ZUIKUČIŲ;1059002689;Ne;5;6;3;14
5344;Molinukas;ZUIKUČIŲ;5302191209;Ne;11;0;5;16
5345;Molinukas;ZUIKUČIŲ;1605039166;Ne;5;1;0;6
5346;Molinukas;ZUIKUČIŲ;6804127471;Ne;5;1;0;6
5347;Molinukas;ZUIKUČIŲ;2878262979;Ne;0;3;0;3
5348;Molinukas;ZUIKUČIŲ;4733315902;Ne;0;0;2;2
5349;Molinukas;ZUIKUČIŲ;3516132254;Ne;0;0;1;1
5350;Molinukas;ZUIKUČIŲ;4718396549;Ne;4;7;2;13
5351;Molinukas;ZUIKUČIŲ;3577613732;Ne;9;0;0;9
5352;Molinukas;ZUIKUČIŲ;9972204424;Ne;2;0;0;2
5353;Molinukas;SRAIGIUKŲ;8416644024;Ne;0;0;3;3
5354;Molinukas;SRAIGIUKŲ;1686122652;Ne;0;1;0;1
5355;Molinukas;SRAIGIUKŲ;9948685221;Ne;0;1;0;1
5356;Molinukas;SRAIGIUKŲ;6326031969;Ne;0;3;8;11
5357;Molinukas;SRAIGIUKŲ;8393217418;Ne;0;3;0;3
5358;Molinukas;SRAIGIUKŲ;6636118069;Ne;0;1;0;1
5359;Molinukas;SRAIGIUKŲ;1469884686;Ne;0;2;0;2
5360;Molinukas;SRAIGIUKŲ;1856269656;Ne;0;3;0;3
5361;Molinukas;SRAIGIUKŲ;7377137582;Ne;0;4;1;5
5362;Molinukas;SRAIGIUKŲ;6084682084;Ne;0;3;0;3
5363;Molinukas;SRAIGIUKŲ;8913137310;Ne;0;4;4;8
5364;Molinukas;SRAIGIUKŲ;5387818175;Ne;0;2;1;3
5365;Molinukas;SRAIGIUKŲ;1138255845;Ne;0;1;0;1
5366;Molinukas;SRAIGIUKŲ;8604288346;Ne;0;5;2;7
5367;Molinukas;SRAIGIUKŲ;4806350914;Ne;0;0;3;3
5368;Molinukas;SRAIGIUKŲ;8617979245;Ne;0;1;1;2
5369;Molinukas;SRAIGIUKŲ;4534279257;Ne;0;1;0;1
5370;Molinukas;SRAIGIUKŲ;4918181437;Ne;5;0;2;7
5371;Molinukas;SRAIGIUKŲ;7451224160;Ne;0;9;0;9
5372;Molinukas;SRAIGIUKŲ;8688180482;Ne;10;2;1;13
5373;Molinukas;SRAIGIUKŲ;3917187380;Ne;0;1;0;1
5374;Molinukas;SRAIGIUKŲ;1927843089;Ne;0;3;1;4
5375;Molinukas;VOVERIUKAI;3469196411;Ne;8;0;0;8
5376;Molinukas;VOVERIUKAI;4583155940;Ne;0;0;4;4
5377;Molinukas;VOVERIUKAI;8541456847;Ne;0;0;8;8
5378;Molinukas;VOVERIUKAI;2286586693;Ne;6;1;12;19
5379;Molinukas;VOVERIUKAI;6898958282;Ne;0;0;4;4
5380;Molinukas;VOVERIUKAI;4000190261;Ne;0;0;1;1
5381;Molinukas;VOVERIUKAI;5685582215;Ne;0;6;1;7
5382;Molinukas;VOVERIUKAI;2356814145;Ne;0;0;3;3
5383;Molinukas;VOVERIUKAI;7446607510;Ne;1;8;0;9
5384;Molinukas;VOVERIUKAI;9667704959;Ne;4;1;5;10
5385;Molinukas;VOVERIUKAI;8516451290;Ne;0;0;2;2
5386;Molinukas;VOVERIUKAI;3030169626;Ne;0;2;0;2
5387;Molinukas;VOVERIUKAI;3207373459;Ne;0;0;4;4
5388;Molinukas;VOVERIUKAI;4209143136;Ne;8;1;0;9
5389;Molinukas;VOVERIUKAI;5648861702;Ne;8;1;0;9
5390;Molinukas;VOVERIUKAI;8865966572;Ne;8;0;1;9
5391;Molinukas;VOVERIUKAI;4950808381;Ne;0;7;3;10
5392;Molinukas;VOVERIUKAI;7378643086;Ne;0;5;3;8
5393;Molinukas;VOVERIUKAI;2779700726;Ne;0;0;21;21
5394;Molinukas;VOVERIUKAI;6832647220;Ne;0;0;6;6
5395;Molinukas;VOVERIUKAI;8247270556;Ne;0;1;0;1
5396;Molinukas;ŽVIRBLIUKŲ;2935945686;Ne;6;0;0;6
5397;Molinukas;ŽVIRBLIUKŲ;6190443233;Ne;7;1;0;8
5398;Molinukas;ŽVIRBLIUKŲ;4122429163;Ne;5;1;0;6
5399;Molinukas;ŽVIRBLIUKŲ;8660958288;Ne;0;0;2;2
5400;Molinukas;ŽVIRBLIUKŲ;2862680065;Ne;0;3;0;3
5401;Molinukas;ŽVIRBLIUKŲ;3382913312;Ne;5;0;7;12
5402;Molinukas;ŽVIRBLIUKŲ;3331982964;Ne;0;0;1;1
5403;Molinukas;ŽVIRBLIUKŲ;2448588784;Ne;17;4;0;21
5404;Molinukas;ŽVIRBLIUKŲ;2842168450;Ne;14;4;0;18
5405;Molinukas;KAČIUKŲ;8769667823;Ne;0;3;0;3
5406;Molinukas;KAČIUKŲ;8313486714;Ne;5;4;0;9
5407;Molinukas;KAČIUKŲ;3043679624;Ne;3;0;0;3
5408;Molinukas;KAČIUKŲ;4974513900;Ne;1;0;0;1
5409;Molinukas;KAČIUKŲ;1826463800;Ne;0;2;0;2
5410;Molinukas;KAČIUKŲ;6947938890;Ne;0;0;2;2
5411;Molinukas;KAČIUKŲ;1970929144;Ne;0;0;1;1
5412;Molinukas;KAČIUKŲ;3510936830;Ne;0;0;2;2
5413;Molinukas;KAČIUKŲ;8608465121;Ne;5;0;2;7
5414;Molinukas;KAČIUKŲ;1651103318;Ne;0;0;2;2
5415;Molinukas;KAČIUKŲ;8973341322;Ne;0;2;0;2
5416;"Naminukas (Smėlio g. 13)";Drugeliai;6776805494;Ne;0;3;0;3
5417;"Naminukas (Smėlio g. 13)";Drugeliai;2395070574;Ne;10;4;0;14
5418;"Naminukas (Smėlio g. 13)";Drugeliai;5534073614;Ne;0;4;0;4
5419;"Naminukas (Smėlio g. 13)";Drugeliai;2132345627;Ne;0;5;0;5
5420;"Naminukas (Smėlio g. 13)";Drugeliai;1302119260;Ne;0;6;1;7
5421;"Naminukas (Smėlio g. 13)";Drugeliai;2864905392;Ne;7;9;0;16
5422;"Naminukas (Smėlio g. 13)";Drugeliai;1333462200;Ne;0;0;2;2
5423;"Naminukas (Smėlio g. 13)";Drugeliai;5468218968;Ne;0;4;0;4
5424;"Naminukas (Smėlio g. 13)";Drugeliai;5713661641;Ne;0;1;0;1
5425;"Naminukas (Smėlio g. 13)";Drugeliai;6581925461;Ne;0;3;0;3
5426;"Naminukas (Smėlio g. 13)";Drugeliai;2198493034;Ne;0;2;1;3
5427;"Naminukas (Smėlio g. 13)";Drugeliai;8141324449;Ne;0;1;13;14
5428;"Naminukas (Smėlio g. 13)";Drugeliai;8564586014;Ne;4;0;0;4
5429;"Naminukas (Smėlio g. 13)";Drugeliai;3236525642;Ne;0;3;0;3
5430;"Naminukas (Smėlio g. 13)";Drugeliai;7347998152;Ne;0;4;0;4
5431;"Naminukas (Smėlio g. 13)";Drugeliai;7272465847;Ne;17;0;0;17
5432;"Naminukas (Smėlio g. 13)";Drugeliai;7450368045;Ne;0;0;8;8
5433;"Naminukas (Smėlio g. 13)";Bitutės;4419568254;Ne;0;2;0;2
5434;"Naminukas (Smėlio g. 13)";Bitutės;1956749138;Ne;0;5;0;5
5435;"Naminukas (Smėlio g. 13)";Bitutės;6503569633;Ne;0;3;4;7
5436;"Naminukas (Smėlio g. 13)";Bitutės;3192885665;Ne;9;1;2;12
5437;"Naminukas (Smėlio g. 13)";Bitutės;9530232649;Ne;0;0;2;2
5438;"Naminukas (Smėlio g. 13)";Bitutės;8131328042;Ne;0;5;4;9
5439;"Naminukas (Smėlio g. 13)";Bitutės;7888950723;Ne;0;5;1;6
5440;"Naminukas (Smėlio g. 13)";Bitutės;3994190066;Ne;0;3;0;3
5441;"Naminukas (Smėlio g. 13)";Bitutės;5195078101;Ne;0;5;0;5
5442;"Naminukas (Smėlio g. 13)";Bitutės;9541388086;Ne;0;5;0;5
5443;"Naminukas (Smėlio g. 13)";Bitutės;2424412518;Ne;0;9;0;9
5444;"Naminukas (Smėlio g. 13)";Bitutės;41538301616;Ne;0;4;0;4
5445;"Naminukas (Smėlio g. 13)";Bitutės;5493709688;Ne;0;4;11;15
5446;"Naminukas (Smėlio g. 13)";Bitutės;2769848640;Ne;0;1;0;1
5447;"Naminukas (Smėlio g. 13)";Bitutės;9821244713;Ne;5;0;2;7
5448;"Naminukas (Smėlio g. 13)";Bitutės;7847923107;Ne;6;0;0;6
5449;"Naminukas (Smėlio g. 13)";Bitutės;1480152104;Ne;8;0;1;9
5450;"Naminukas (Smėlio g. 13)";Bitutės;4331408714;Ne;2;0;0;2
5451;"Naminukas (Smėlio g. 13)";Paukšteliai;3501921619;Ne;7;0;0;7
5452;"Naminukas (Smėlio g. 13)";Paukšteliai;7297661383;Ne;0;2;0;2
5453;"Naminukas (Smėlio g. 13)";Paukšteliai;5056487802;Ne;0;5;0;5
5454;"Naminukas (Smėlio g. 13)";Paukšteliai;3438010199;Ne;0;0;6;6
5455;"Naminukas (Smėlio g. 13)";Paukšteliai;4998565160;Ne;0;19;0;19
5456;"Naminukas (Smėlio g. 13)";Paukšteliai;9405784626;Ne;0;10;3;13
5457;"Naminukas (Smėlio g. 13)";Paukšteliai;2583886896;Ne;0;4;0;4
5458;"Naminukas (Smėlio g. 13)";Paukšteliai;4778385421;Ne;6;10;0;16
5459;"Naminukas (Smėlio g. 13)";Paukšteliai;1406418130;Ne;5;0;2;7
5460;"Naminukas (Smėlio g. 13)";Paukšteliai;9891722891;Ne;0;10;0;10
5461;"Naminukas (Smėlio g. 13)";Paukšteliai;2012656186;Ne;0;0;7;7
5462;"Naminukas (Smėlio g. 13)";Paukšteliai;8470716196;Ne;2;0;0;2
5463;"Naminukas (Smėlio g. 13)";Paukšteliai;3727828033;Ne;0;1;0;1
5464;"Naminukas (Smėlio g. 13)";Paukšteliai;9657786543;Ne;8;0;6;14
5465;"Naminukas (Smėlio g. 13)";Paukšteliai;2652538212;Ne;5;0;4;9
5466;"Naminukas (Smėlio g. 13)";Paukšteliai;5280419144;Ne;12;0;1;13
5467;"Naminukas (Smėlio g. 13)";"NYKŠTUKAI ";7646186458;Ne;4;4;0;8
5468;"Naminukas (Smėlio g. 13)";"NYKŠTUKAI ";5519447152;Ne;13;5;0;18
5469;"Naminukas (Smėlio g. 13)";"NYKŠTUKAI ";5741698937;Ne;4;4;0;8
5470;"Naminukas (Smėlio g. 13)";"NYKŠTUKAI ";1286329245;Ne;10;5;0;15
5471;"Naminukas (Smėlio g. 13)";"NYKŠTUKAI ";7717132979;Ne;0;18;0;18
5472;"Naminukas (Smėlio g. 13)";"NYKŠTUKAI ";3355811632;Ne;4;0;0;4
5473;"Naminukas (Smėlio g. 13)";"NYKŠTUKAI ";1618802271;Ne;10;0;1;11
5474;"Naminukas (Smėlio g. 13)";"NYKŠTUKAI ";1591540165;Ne;6;0;1;7
5475;"Naminukas (Smėlio g. 13)";"NYKŠTUKAI ";9537360943;Ne;16;0;0;16
5476;"Naminukas (Smėlio g. 13)";"NYKŠTUKAI ";1118193598;Ne;9;0;0;9
5477;"Naminukas (Smėlio g. 13)";"NYKŠTUKAI ";8102805098;Ne;0;8;1;9
5478;"Naminukas (Smėlio g. 13)";"NYKŠTUKAI ";9357758815;Ne;6;0;3;9
5479;"Naminukas (Smėlio g. 13)";"NYKŠTUKAI ";4422173848;Ne;21;0;0;21
5480;"Naminukas (Smėlio g. 13)";"NYKŠTUKAI ";1095955939;Ne;9;0;0;9
5481;Nykštukas;SMAGURIAI;9842748132;Ne;10;9;2;21
5482;Nykštukas;SMAGURIAI;4830484167;Ne;6;1;0;7
5483;Nykštukas;SMAGURIAI;4949895196;Ne;8;1;0;9
5484;Nykštukas;SMAGURIAI;9713859038;Ne;0;6;0;6
5485;Nykštukas;SMAGURIAI;7954996421;Ne;6;2;0;8
5486;Nykštukas;SMAGURIAI;6139988523;Ne;15;0;0;15
5487;Nykštukas;SMAGURIAI;8310484267;Ne;10;0;0;10
5488;Nykštukas;SMAGURIAI;1707956308;Ne;8;5;0;13
5489;Nykštukas;SMAGURIAI;9326131725;Ne;1;0;0;1
5490;Nykštukas;SMAGURIAI;7911842707;Ne;17;4;0;21
5491;Nykštukas;SMAGURIAI;6102907953;Ne;12;2;0;14
5492;Nykštukas;SMAGURIAI;7529677915;Ne;0;6;0;6
5493;Nykštukas;SMAGURIAI;4994727422;Ne;0;12;0;12
5494;Nykštukas;SMAGURIAI;3007541327;Ne;6;0;0;6
5495;Nykštukas;SMAGURIAI;9312935803;Ne;4;6;0;10
5496;Nykštukas;SMALSIUKAI;5121027981;Ne;3;1;0;4
5497;Nykštukas;SMALSIUKAI;6958596223;Ne;0;4;0;4
5498;Nykštukas;SMALSIUKAI;4612171029;Ne;5;4;0;9
5499;Nykštukas;SMALSIUKAI;3120577264;Ne;0;17;0;17
5500;Nykštukas;SMALSIUKAI;1386798219;Ne;15;4;0;19
5501;Nykštukas;SMALSIUKAI;9532956150;Ne;0;5;0;5
5502;Nykštukas;SMALSIUKAI;3273579005;Ne;9;0;0;9
5503;Nykštukas;SMALSIUKAI;1102555964;Ne;0;1;0;1
5504;Nykštukas;SMALSIUKAI;4331906712;Ne;0;1;0;1
5505;Nykštukas;SMALSIUKAI;6112448299;Ne;0;1;0;1
5506;Nykštukas;SMALSIUKAI;1930357859;Ne;0;4;0;4
5507;Nykštukas;SMALSIUKAI;9100510105;Ne;0;1;0;1
5508;Nykštukas;SMALSIUKAI;2143857296;Ne;5;1;0;6
5509;Nykštukas;SMALSIUKAI;9303832542;Ne;2;0;0;2
5510;Nykštukas;SMALSIUKAI;2571249434;Ne;0;14;0;14
5511;Nykštukas;AITVARIUKAI;6923345088;Ne;0;3;0;3
5512;Nykštukas;AITVARIUKAI;8580777381;Ne;6;10;0;16
5513;Nykštukas;AITVARIUKAI;9216544103;Ne;11;6;0;17
5514;Nykštukas;AITVARIUKAI;9319066179;Ne;0;9;0;9
5515;Nykštukas;AITVARIUKAI;2177539882;Ne;19;0;1;20
5516;Nykštukas;AITVARIUKAI;9595654681;Ne;8;6;0;14
5517;Nykštukas;AITVARIUKAI;9894698453;Ne;13;0;0;13
5518;Nykštukas;AITVARIUKAI;6351178752;Ne;11;0;0;11
5519;Nykštukas;AITVARIUKAI;2232317366;Ne;10;0;1;11
5520;Nykštukas;AITVARIUKAI;7332769878;Ne;19;0;0;19
5521;Nykštukas;AITVARIUKAI;7896338372;Ne;12;0;0;12
5522;Nykštukas;AITVARIUKAI;2208319289;Ne;11;0;0;11
5523;Nykštukas;AITVARIUKAI;5285669371;Ne;8;0;0;8
5524;Nykštukas;AITVARIUKAI;8548820023;Ne;5;6;4;15
5525;Nykštukas;AITVARIUKAI;9545178064;Ne;6;0;1;7
5526;Nykštukas;AITVARIUKAI;3561627809;Ne;9;1;0;10
5527;Nykštukas;AITVARIUKAI;5972246871;Ne;10;3;0;13
5528;Nykštukas;AITVARIUKAI;5538446312;Ne;10;0;0;10
5529;Nykštukas;AITVARIUKAI;4822304386;Ne;6;3;0;9
5530;Nykštukas;AITVARIUKAI;4177690371;Ne;0;0;2;2
5531;Nykštukas;AITVARIUKAI;5292127770;Ne;11;0;2;13
5532;Nykštukas;DAINORĖLIAI;7730918105;Ne;7;0;0;7
5533;Nykštukas;DAINORĖLIAI;8475127245;Ne;2;5;4;11
5534;Nykštukas;DAINORĖLIAI;1122600949;Ne;12;0;0;12
5535;Nykštukas;DAINORĖLIAI;9776630115;Ne;6;2;0;8
5536;Nykštukas;DAINORĖLIAI;9524639831;Ne;0;1;4;5
5537;Nykštukas;DAINORĖLIAI;3367348573;Ne;9;3;0;12
5538;Nykštukas;DAINORĖLIAI;5961945345;Ne;7;0;3;10
5539;Nykštukas;DAINORĖLIAI;6561696818;Ne;6;0;1;7
5540;Nykštukas;DAINORĖLIAI;1283453188;Ne;8;0;0;8
5541;Nykštukas;DAINORĖLIAI;1167614164;Ne;0;10;0;10
5542;Nykštukas;DAINORĖLIAI;7473124310;Taip;0;1;0;1
5543;Nykštukas;DAINORĖLIAI;8681884252;Ne;7;5;0;12
5544;Nykštukas;DAINORĖLIAI;5255726742;Ne;15;1;0;16
5545;Nykštukas;DAINORĖLIAI;9027355399;Ne;0;11;0;11
5546;Nykštukas;DAINORĖLIAI;4893494144;Ne;0;6;0;6
5547;Nykštukas;DAINORĖLIAI;8318089070;Ne;4;0;0;4
5548;Nykštukas;DAINORĖLIAI;2727074729;Ne;15;4;0;19
5549;Nykštukas;DAINORĖLIAI;9437700329;Ne;10;0;0;10
5550;Nykštukas;POKŠTUKAI;7382271765;Ne;11;0;0;11
5551;Nykštukas;POKŠTUKAI;1655428422;Ne;10;0;0;10
5552;Nykštukas;POKŠTUKAI;2649916049;Ne;5;7;0;12
5553;Nykštukas;POKŠTUKAI;1796016501;Ne;10;3;0;13
5554;Nykštukas;POKŠTUKAI;5958711585;Ne;19;0;0;19
5555;Nykštukas;POKŠTUKAI;3999004312;Ne;8;0;0;8
5556;Nykštukas;POKŠTUKAI;6719999304;Ne;19;0;0;19
5557;Nykštukas;POKŠTUKAI;8148163137;Ne;10;1;0;11
5558;Nykštukas;POKŠTUKAI;8708184278;Taip;10;0;0;10
5559;Nykštukas;POKŠTUKAI;5699671696;Ne;0;2;0;2
5560;Nykštukas;POKŠTUKAI;3843163586;Ne;21;0;0;21
5561;Nykštukas;POKŠTUKAI;3507649457;Ne;6;0;0;6
5562;Nykštukas;POKŠTUKAI;3428031037;Ne;0;4;0;4
5563;Nykštukas;POKŠTUKAI;4508625009;Ne;6;2;0;8
5564;Nykštukas;POKŠTUKAI;6698622575;Ne;7;3;0;10
5565;Nykštukas;POKŠTUKAI;2982662650;Ne;10;1;0;11
5566;Nykštukas;POKŠTUKAI;2627736026;Ne;0;13;0;13
5567;Nykštukas;POKŠTUKAI;4401103119;Ne;10;2;0;12
5568;Nykštukas;POKŠTUKAI;5287713634;Ne;5;0;0;5
5569;Nykštukas;KODĖLČIUKAI;9285820767;Ne;3;0;0;3
5570;Nykštukas;KODĖLČIUKAI;2685400939;Ne;21;0;0;21
5571;Nykštukas;KODĖLČIUKAI;3278960733;Ne;10;0;0;10
5572;Nykštukas;KODĖLČIUKAI;5934979528;Ne;0;0;2;2
5573;Nykštukas;KODĖLČIUKAI;3760617860;Ne;6;0;0;6
5574;Nykštukas;KODĖLČIUKAI;6927545099;Ne;4;2;0;6
5575;Nykštukas;KODĖLČIUKAI;8042479133;Ne;0;3;0;3
5576;Nykštukas;KODĖLČIUKAI;6794885966;Ne;0;2;0;2
5577;Nykštukas;KODĖLČIUKAI;7616459970;Ne;0;3;0;3
5578;Nykštukas;KODĖLČIUKAI;2623254163;Ne;21;0;0;21
5579;Nykštukas;KODĖLČIUKAI;9296449928;Ne;9;0;0;9
5580;Nykštukas;KODĖLČIUKAI;2992219360;Ne;21;0;0;21
5581;Nykštukas;KODĖLČIUKAI;4667303597;Ne;6;0;0;6
5582;Nykštukas;KODĖLČIUKAI;8804969886;Ne;6;0;0;6
5583;Nykštukas;KODĖLČIUKAI;3552386621;Ne;8;1;0;9
5584;Nykštukas;KODĖLČIUKAI;2692551262;Ne;0;2;0;2
5585;Nykštukas;PASAKORIAI;2661110617;Ne;5;5;0;10
5586;Nykštukas;PASAKORIAI;8640715657;Ne;0;5;0;5
5587;Nykštukas;PASAKORIAI;5504584349;Ne;0;2;2;4
5588;Nykštukas;PASAKORIAI;7990462246;Ne;0;8;0;8
5589;Nykštukas;PASAKORIAI;1379378120;Ne;7;0;0;7
5590;Nykštukas;PASAKORIAI;9413198245;Ne;0;5;0;5
5591;Nykštukas;PASAKORIAI;2518342041;Ne;0;4;0;4
5592;Nykštukas;PASAKORIAI;7828733135;Ne;0;2;2;4
5593;Nykštukas;PASAKORIAI;4480184458;Ne;5;7;0;12
5594;Nykštukas;PASAKORIAI;4090494707;Ne;0;4;0;4
5595;Nykštukas;PASAKORIAI;9714310539;Ne;0;7;0;7
5596;Nykštukas;PASAKORIAI;4795301170;Ne;0;6;0;6
5597;Nykštukas;PASAKORIAI;1579064341;Ne;0;6;0;6
5598;Nykštukas;PASAKORIAI;4992654449;Ne;0;0;5;5
5599;Nykštukas;PASAKORIAI;5337728911;Ne;6;5;0;11
5600;Nykštukas;PASAKORIAI;2231375994;Ne;21;0;0;21
5601;Nykštukas;PASAKORIAI;8371081106;Taip;8;7;0;15
5602;Nykštukas;PASAKORIAI;3496434361;Ne;0;4;0;4
5603;Nykštukas;GUDRUČIAI;9871410323;Ne;0;5;0;5
5604;Nykštukas;GUDRUČIAI;4559818614;Ne;0;3;0;3
5605;Nykštukas;GUDRUČIAI;9250827058;Ne;0;1;0;1
5606;Nykštukas;GUDRUČIAI;7447202642;Ne;0;3;0;3
5607;Nykštukas;GUDRUČIAI;1714708754;Ne;0;0;2;2
5608;Nykštukas;GUDRUČIAI;4325369395;Ne;6;1;0;7
5609;Nykštukas;GUDRUČIAI;6630804505;Ne;0;7;0;7
5610;Nykštukas;GUDRUČIAI;8363202198;Ne;0;1;0;1
5611;Nykštukas;GUDRUČIAI;7326535810;Ne;0;3;0;3
5612;Nykštukas;GUDRUČIAI;9712596180;Ne;0;1;0;1
5613;Nykštukas;GUDRUČIAI;9941937734;Ne;0;2;0;2
5614;Nykštukas;GUDRUČIAI;2494482185;Ne;0;4;0;4
5615;Nykštukas;GUDRUČIAI;3619459404;Ne;0;0;3;3
5616;Nykštukas;GUDRUČIAI;1934596739;Ne;0;1;3;4
5617;Nykštukas;GUDRUČIAI;7604740418;Ne;4;4;0;8
5618;Nykštukas;GUDRUČIAI;2970293467;Ne;0;18;0;18
5619;Nykštukas;GUDRUČIAI;2881323571;Ne;4;3;0;7
5620;Nykštukas;GUDRUČIAI;2872277381;Ne;2;4;0;6
5621;Nykštukas;GUDRUČIAI;9940519259;Ne;6;0;0;6
5622;Nykštukas;NAMINUKAI;7456007276;Ne;10;1;0;11
5623;Nykštukas;NAMINUKAI;7176519994;Ne;7;0;0;7
5624;Nykštukas;NAMINUKAI;2440574056;Ne;7;0;0;7
5625;Nykštukas;NAMINUKAI;4064016871;Ne;0;2;0;2
5626;Nykštukas;NAMINUKAI;9054070492;Ne;0;3;0;3
5627;Nykštukas;NAMINUKAI;6519078450;Ne;8;5;0;13
5628;Nykštukas;NAMINUKAI;5032283848;Ne;14;1;0;15
5629;Nykštukas;NAMINUKAI;7494444468;Ne;4;1;0;5
5630;Nykštukas;NAMINUKAI;3925958632;Ne;4;1;0;5
5631;Nykštukas;NAMINUKAI;7976689381;Ne;5;6;0;11
5632;Nykštukas;NAMINUKAI;9686815141;Ne;0;3;0;3
5633;Nykštukas;NAMINUKAI;9575291096;Ne;0;2;0;2
5634;Nykštukas;NAMINUKAI;4503830456;Ne;0;1;3;4
5635;Nykštukas;NAMINUKAI;4040123876;Ne;0;7;0;7
5636;Nykštukas;NAMINUKAI;1088633575;Ne;0;2;0;2
5637;Nykštukas;NAMINUKAI;5088668786;Ne;11;7;0;18
5638;Nykštukas;NAMINUKAI;8874850019;Ne;0;9;0;9
5639;Nykštukas;NAMINUKAI;1510338621;Ne;6;0;0;6
5640;Nykštukas;NAMINUKAI;9067774103;Ne;21;0;0;21
5641;Nykštukas;NAMINUKAI;3405633312;Ne;0;1;0;1
5642;Nykštukas;KŪLVERSTUKAI;8827094160;Ne;6;5;0;11
5643;Nykštukas;KŪLVERSTUKAI;7320458031;Ne;4;4;0;8
5644;Nykštukas;KŪLVERSTUKAI;1148800623;Taip;8;0;0;8
5645;Nykštukas;KŪLVERSTUKAI;7078264994;Ne;12;0;0;12
5646;Nykštukas;KŪLVERSTUKAI;6786896381;Ne;2;4;0;6
5647;Nykštukas;KŪLVERSTUKAI;7432373335;Ne;9;2;0;11
5648;Nykštukas;KŪLVERSTUKAI;3660330885;Ne;10;2;0;12
5649;Nykštukas;KŪLVERSTUKAI;6883272732;Ne;11;0;0;11
5650;Nykštukas;KŪLVERSTUKAI;8919778025;Ne;0;4;0;4
5651;Nykštukas;KŪLVERSTUKAI;6337924089;Ne;5;2;0;7
5652;Nykštukas;KŪLVERSTUKAI;4323166473;Ne;12;0;0;12
5653;Nykštukas;KŪLVERSTUKAI;2748970206;Ne;21;0;0;21
5654;Nykštukas;KŪLVERSTUKAI;4490310109;Ne;0;5;0;5
5655;Nykštukas;KŪLVERSTUKAI;2947976429;Ne;11;0;0;11
5656;Nykštukas;KŪLVERSTUKAI;2763268154;Ne;0;6;0;6
5657;Nykštukas;KŪLVERSTUKAI;9887096503;Ne;5;9;0;14
5658;Nykštukas;KŪLVERSTUKAI;7562216310;Ne;0;3;0;3
5659;Nykštukas;TREPSIUKAI;2052451745;Ne;2;0;0;2
5660;Nykštukas;TREPSIUKAI;4955003100;Ne;5;6;0;11
5661;Nykštukas;TREPSIUKAI;5103512898;Ne;0;4;0;4
5662;Nykštukas;TREPSIUKAI;7603500691;Ne;0;1;0;1
5663;Nykštukas;TREPSIUKAI;7266550834;Ne;0;11;0;11
5664;Nykštukas;TREPSIUKAI;6563871327;Ne;6;2;0;8
5665;Nykštukas;TREPSIUKAI;5085577592;Ne;7;0;0;7
5666;Nykštukas;TREPSIUKAI;8819485547;Ne;0;0;5;5
5667;Nykštukas;TREPSIUKAI;5281616311;Ne;10;0;0;10
5668;Nykštukas;TREPSIUKAI;8372380734;Ne;0;2;2;4
5669;Nykštukas;TREPSIUKAI;6672148719;Ne;9;4;0;13
5670;Nykštukas;TREPSIUKAI;5718555692;Ne;1;2;2;5
5671;Nykštukas;TREPSIUKAI;4499337321;Ne;16;0;0;16
5672;Nykštukas;TREPSIUKAI;4622095064;Ne;7;0;0;7
5673;Nykštukas;TREPSIUKAI;8667489439;Ne;2;0;0;2
5674;Nykštukas;TREPSIUKAI;8047072198;Ne;0;1;0;1
5675;Nykštukas;TREPSIUKAI;9790322329;Ne;10;0;0;10
5676;Nykštukas;TREPSIUKAI;8695794490;Ne;15;0;0;15
5677;Nykštukas;ŽIRNIUKAI;9661862689;Ne;11;0;0;11
5678;Nykštukas;ŽIRNIUKAI;1671340074;Ne;13;0;0;13
5679;Nykštukas;ŽIRNIUKAI;3339707558;Ne;6;1;0;7
5680;Nykštukas;ŽIRNIUKAI;7908029688;Ne;0;4;0;4
5681;Nykštukas;ŽIRNIUKAI;7299329150;Ne;5;0;0;5
5682;Nykštukas;ŽIRNIUKAI;9174636607;Ne;5;0;0;5
5683;Nykštukas;ŽIRNIUKAI;1218443707;Ne;5;1;0;6
5684;Nykštukas;ŽIRNIUKAI;6709760898;Ne;6;0;0;6
5685;Nykštukas;ŽIRNIUKAI;2670682135;Ne;11;1;0;12
5686;Nykštukas;ŽIRNIUKAI;1202614927;Ne;6;0;0;6
5687;Nykštukas;ŽIRNIUKAI;2800783215;Ne;0;21;0;21
5688;Nykštukas;ŽIRNIUKAI;2620150024;Ne;0;4;17;21
5689;Nykštukas;ŽIRNIUKAI;3032028847;Ne;14;0;0;14
5690;Nykštukas;ŽIRNIUKAI;4144437365;Ne;12;0;0;12
5691;Nykštukas;ŽIRNIUKAI;6884714823;Ne;7;0;0;7
5692;Nykštukas;ŽIRNIUKAI;1616644404;Ne;7;3;0;10
5693;Nykštukas;ŽIRNIUKAI;9270615518;Ne;5;1;0;6
5694;Nykštukas;ŽIRNIUKAI;2078586374;Ne;11;0;0;11
5695;Nykštukas;ŽIRNIUKAI;1102203704;Ne;0;10;0;10
5696;Ozas;Smalsučiai;2641398988;Ne;6;5;0;11
5697;Ozas;Smalsučiai;9227939420;Ne;0;2;0;2
5698;Ozas;Smalsučiai;87218067796;Ne;0;4;0;4
5699;Ozas;Smalsučiai;1974320330;Ne;0;6;0;6
5700;Ozas;Smalsučiai;1173284700;Ne;0;2;0;2
5701;Ozas;Smalsučiai;67987032400;Ne;0;1;1;2
5702;Ozas;Smalsučiai;71695973592;Ne;0;6;0;6
5703;Ozas;Smalsučiai;57069047630;Ne;9;6;0;15
5704;Ozas;Smalsučiai;5150746885;Ne;0;7;0;7
5705;Ozas;Smalsučiai;1893257809;Ne;4;0;0;4
5706;Ozas;Smalsučiai;6540803077;Ne;0;4;0;4
5707;Ozas;Smalsučiai;8072802467;Ne;0;1;0;1
5708;Ozas;Smalsučiai;1248092034;Ne;0;4;0;4
5709;Ozas;Smalsučiai;43381497677;Ne;2;8;0;10
5710;Ozas;Smalsučiai;7351651916;Ne;0;3;0;3
5711;Ozas;Smalsučiai;3286170280;Ne;0;0;2;2
5712;Ozas;Smalsučiai;9521048381;Ne;11;0;0;11
5713;Ozas;Smalsučiai;5342394742;Ne;0;2;0;2
5714;Ozas;Drugeliai;7802699257;Ne;0;1;0;1
5715;Ozas;Drugeliai;6668470892;Ne;0;1;0;1
5716;Ozas;Drugeliai;2302999759;Ne;0;2;0;2
5717;Ozas;Drugeliai;8088330187;Ne;2;15;0;17
5718;Ozas;Drugeliai;9073973849;Ne;0;0;2;2
5719;Ozas;Drugeliai;9322806566;Ne;0;8;0;8
5720;Ozas;Drugeliai;2676747542;Ne;7;0;10;17
5721;Ozas;Drugeliai;2812687451;Ne;0;8;0;8
5722;Ozas;Drugeliai;8289643065;Ne;0;2;0;2
5723;Ozas;Drugeliai;4726019355;Ne;0;1;0;1
5724;Ozas;Drugeliai;9987863302;Ne;0;2;2;4
5725;Ozas;Drugeliai;2980799420;Ne;4;4;2;10
5726;Ozas;Drugeliai;8318380547;Ne;8;2;0;10
5727;Ozas;Drugeliai;4884054504;Ne;0;1;0;1
5728;Ozas;Drugeliai;43660054250;Ne;0;17;0;17
5729;Ozas;Drugeliai;7565002863;Ne;0;9;0;9
5730;Ozas;Drugeliai;1871542885;Ne;3;0;0;3
5731;Ozas;Drugeliai;15262583232;Ne;0;12;0;12
5732;Ozas;Drugeliai;1103685699;Ne;0;2;0;2
5733;Ozas;Drugeliai;1335655483;Ne;0;1;0;1
5734;Ozas;Drugeliai;4207160323;Ne;6;0;0;6
5735;Ozas;Boružėlės;1348960421;Ne;0;4;9;13
5736;Ozas;Boružėlės;1375643969;Ne;0;4;3;7
5737;Ozas;Boružėlės;63852147122;Ne;12;4;0;16
5738;Ozas;Boružėlės;8190314087;Ne;5;4;1;10
5739;Ozas;Boružėlės;3803998816;Ne;0;6;0;6
5740;Ozas;Boružėlės;1212358423;Ne;7;1;0;8
5741;Ozas;Boružėlės;7615907271;Ne;11;2;0;13
5742;Ozas;Boružėlės;1560342499;Ne;0;4;1;5
5743;Ozas;Boružėlės;8529654920;Ne;0;1;0;1
5744;Ozas;Boružėlės;2527574646;Ne;0;8;0;8
5745;Ozas;Boružėlės;36523514229;Ne;0;4;1;5
5746;Ozas;Boružėlės;1367050160;Ne;6;2;0;8
5747;Ozas;Boružėlės;2678629892;Ne;0;1;2;3
5748;Ozas;Boružėlės;1826499734;Ne;0;4;0;4
5749;Ozas;Boružėlės;6432357144;Ne;0;2;1;3
5750;Ozas;Boružėlės;1498656201;Ne;1;10;0;11
5751;Ozas;Boružėlės;9130645878;Ne;8;2;1;11
5752;Ozas;Boružėlės;60194872867;Ne;5;2;0;7
5753;Ozas;Boružėlės;7172573921;Ne;0;2;1;3
5754;Ozas;Boružėlės;1109113859;Ne;0;0;1;1
5755;Ozas;Boružėlės;68364031736;Ne;0;4;1;5
5756;Ozas;Žiogeliai;7461521320;Ne;0;4;0;4
5757;Ozas;Žiogeliai;6257625501;Ne;0;3;0;3
5758;Ozas;Žiogeliai;7402290524;Taip;5;2;0;7
5759;Ozas;Žiogeliai;1562277866;Ne;0;4;2;6
5760;Ozas;Žiogeliai;4571583671;Ne;0;6;3;9
5761;Ozas;Žiogeliai;5682027094;Ne;0;12;9;21
5762;Ozas;Žiogeliai;4966355020;Ne;2;0;0;2
5763;Ozas;Žiogeliai;9324647606;Ne;9;0;0;9
5764;Ozas;Žiogeliai;9392526836;Ne;0;0;1;1
5765;Ozas;Žiogeliai;4942550213;Ne;0;0;10;10
5766;Ozas;Žiogeliai;8676986286;Ne;2;0;0;2
5767;Ozas;Žiogeliai;2345112767;Ne;0;5;0;5
5768;Ozas;Žiogeliai;5420952391;Ne;4;6;0;10
5769;Ozas;Žiogeliai;9929822317;Ne;0;0;2;2
5770;Ozas;Žiogeliai;2837228320;Ne;5;1;0;6
5771;Ozas;Žiogeliai;5156383727;Ne;0;6;0;6
5772;Ozas;Žiogeliai;2617258206;Ne;0;14;0;14
5773;Ozas;Bitutės;4220780257;Ne;3;1;0;4
5774;Ozas;Bitutės;1161776624;Ne;0;2;0;2
5775;Ozas;Bitutės;4227555342;Ne;0;0;1;1
5776;Ozas;Bitutės;7499756171;Ne;3;12;1;16
5777;Ozas;Bitutės;2705294874;Ne;0;1;0;1
5778;Ozas;Bitutės;2369544599;Ne;0;5;0;5
5779;Ozas;Bitutės;3329391600;Ne;0;2;1;3
5780;Ozas;Bitutės;8304671844;Taip;0;2;0;2
5781;Ozas;Bitutės;5968428143;Ne;0;1;0;1
5782;Ozas;Bitutės;9772085405;Ne;0;5;1;6
5783;Ozas;Bitutės;7051699003;Ne;13;0;0;13
5784;Ozas;Bitutės;5383877034;Ne;0;0;4;4
5785;Ozas;Bitutės;1117208248;Ne;0;4;0;4
5786;Ozas;Bitutės;6811181735;Ne;13;6;0;19
5787;Ozas;Bitutės;8622621570;Ne;11;0;1;12
5788;Ozas;Bitutės;4260123123;Ne;0;0;1;1
5789;Ozas;Bitutės;7494307084;Ne;4;2;0;6
5790;Ozas;Bitutės;1475005204;Ne;0;1;0;1
5791;Ozas;Bitutės;1895519949;Ne;0;0;6;6
5792;Ozas;Aitvarėliai;1144679735;Ne;6;0;0;6
5793;Ozas;Aitvarėliai;2773182934;Ne;8;0;1;9
5794;Ozas;Aitvarėliai;4357737538;Ne;0;0;4;4
5795;Ozas;Aitvarėliai;5642468671;Ne;0;1;1;2
5796;Ozas;Aitvarėliai;1045890394;Ne;0;3;0;3
5797;Ozas;Aitvarėliai;7686706482;Ne;0;1;1;2
5798;Ozas;Aitvarėliai;2395567376;Ne;0;0;2;2
5799;Ozas;Aitvarėliai;2922370952;Ne;0;0;3;3
5800;Ozas;Aitvarėliai;5383739203;Ne;0;11;0;11
5801;Ozas;Aitvarėliai;4583818638;Ne;3;0;2;5
5802;Ozas;Aitvarėliai;1543683077;Ne;2;0;0;2
5803;Ozas;Aitvarėliai;2165291778;Ne;0;11;0;11
5804;Ozas;Aitvarėliai;8754244281;Ne;15;2;0;17
5805;Ozas;Aitvarėliai;6646671212;Ne;0;0;1;1
5806;Ozas;Aitvarėliai;9443843603;Ne;4;6;2;12
5807;Ozas;Aitvarėliai;3238019756;Ne;3;7;0;10
5808;Ozas;Aitvarėliai;8987796218;Ne;0;11;5;16
5809;Ozas;Aitvarėliai;2544858937;Ne;6;0;0;6
5810;Ozas;Aitvarėliai;3783477511;Ne;0;16;0;16
5811;Ozas;Aitvarėliai;6778987483;Ne;9;1;0;10
5812;Ozas;Aitvarėliai;4891451748;Ne;0;5;0;5
5813;Ozas;Aitvarėliai;7009893338;Ne;12;0;1;13
5814;Ozas;Voveraitės;8178298861;Ne;0;6;3;9
5815;Ozas;Voveraitės;6263062055;Ne;4;1;1;6
5816;Ozas;Voveraitės;9195536968;Ne;0;5;2;7
5817;Ozas;Voveraitės;2991511872;Ne;0;4;0;4
5818;Ozas;Voveraitės;5016547315;Ne;6;2;0;8
5819;Ozas;Voveraitės;1564826076;Ne;0;0;2;2
5820;Ozas;Voveraitės;2511477658;Ne;0;0;3;3
5821;Ozas;Voveraitės;1240233169;Ne;0;0;7;7
5822;Ozas;Voveraitės;6088757991;Ne;0;2;0;2
5823;Ozas;Voveraitės;5822871838;Ne;0;1;0;1
5824;Ozas;Voveraitės;6499549095;Ne;0;4;0;4
5825;Ozas;Voveraitės;6666591428;Ne;0;0;2;2
5826;Ozas;Voveraitės;2297650260;Ne;16;0;5;21
5827;Ozas;Voveraitės;7908028909;Ne;2;7;0;9
5828;Ozas;Voveraitės;9762737217;Ne;0;2;0;2
5829;Ozas;Voveraitės;7421484648;Ne;12;0;9;21
5830;Ozas;Voveraitės;1997125531;Ne;7;1;0;8
5831;Ozas;Voveraitės;6053885086;Ne;5;1;0;6
5832;Ozas;Voveraitės;7978092840;Ne;0;2;0;2
5833;Ozas;Voveraitės;5751808248;Ne;6;4;0;10
5834;Ozas;Voveraitės;4556076744;Ne;9;0;3;12
5835;Ozas;Voveraitės;8503041003;Ne;0;0;1;1
5836;Ozas;Kodelčiukai;8743467101;Ne;0;8;0;8
5837;Ozas;Kodelčiukai;2964318343;Ne;10;2;1;13
5838;Ozas;Kodelčiukai;8696127374;Ne;10;1;0;11
5839;Ozas;Kodelčiukai;3704303636;Ne;7;7;0;14
5840;Ozas;Kodelčiukai;2573702751;Ne;0;4;0;4
5841;Ozas;Kodelčiukai;3412369198;Ne;6;0;0;6
5842;Ozas;Kodelčiukai;2951875705;Ne;0;9;0;9
5843;Ozas;Kodelčiukai;7305274617;Ne;11;0;0;11
5844;Ozas;Kodelčiukai;9306887706;Ne;13;0;0;13
5845;Ozas;Kodelčiukai;9084187344;Ne;0;3;0;3
5846;Ozas;Kodelčiukai;1348751454;Ne;14;1;0;15
5847;Ozas;Kodelčiukai;9322080266;Ne;0;7;0;7
5848;Ozas;Kodelčiukai;6809992664;Ne;4;12;0;16
5849;Ozas;Kodelčiukai;4516291572;Ne;6;1;0;7
5850;Ozas;Kodelčiukai;4287719751;Ne;0;5;0;5
5851;Ozas;Kodelčiukai;9620747099;Ne;0;9;0;9
5852;Ozas;Kodelčiukai;5216695220;Ne;2;4;0;6
5853;Ozas;Kodelčiukai;8779047802;Ne;13;0;0;13
5854;Ozas;Kodelčiukai;6783755555;Ne;0;6;0;6
5855;Ozas;Kodelčiukai;8222112564;Ne;6;0;0;6
5856;Ozas;Kodelčiukai;8797919230;Ne;9;0;0;9
5857;Ozas;Pelėdžiukai;4640897674;Ne;0;0;1;1
5858;Ozas;Pelėdžiukai;9277208213;Ne;0;3;0;3
5859;Ozas;Pelėdžiukai;2281337233;Taip;0;0;5;5
5860;Ozas;Pelėdžiukai;8040293681;Ne;0;0;3;3
5861;Ozas;Pelėdžiukai;1856258542;Ne;6;0;1;7
5862;Ozas;Pelėdžiukai;5922569280;Ne;0;2;1;3
5863;Ozas;Pelėdžiukai;7640409923;Ne;0;5;0;5
5864;Ozas;Pelėdžiukai;4601869799;Ne;0;4;3;7
5865;Ozas;Pelėdžiukai;5958055645;Ne;2;0;7;9
5866;Ozas;Pelėdžiukai;7125754645;Ne;0;0;2;2
5867;Ozas;Pelėdžiukai;2824133388;Ne;7;1;0;8
5868;Ozas;Pelėdžiukai;7287989663;Ne;5;0;0;5
5869;Ozas;Pelėdžiukai;6819000895;Ne;0;2;0;2
5870;Ozas;Pelėdžiukai;5950860889;Ne;0;4;3;7
5871;Ozas;Pelėdžiukai;4886045470;Ne;0;8;0;8
5872;Ozas;Pelėdžiukai;3711403511;Ne;5;0;2;7
5873;Ozas;Pelėdžiukai;5392929222;Ne;21;0;0;21
5874;Ozas;"Kačiukai ";7776754188;Ne;10;0;3;13
5875;Ozas;"Kačiukai ";5097380041;Ne;10;0;0;10
5876;Ozas;"Kačiukai ";2522810593;Ne;1;0;0;1
5877;Ozas;"Kačiukai ";3109261153;Ne;2;4;0;6
5878;Ozas;"Kačiukai ";9781398468;Ne;21;0;0;21
5879;Ozas;"Kačiukai ";2512535949;Ne;15;0;0;15
5880;Ozas;"Kačiukai ";4595986358;Ne;0;0;2;2
5881;Ozas;"Kačiukai ";5421245991;Ne;3;0;0;3
5882;Ozas;"Kačiukai ";9781527964;Ne;15;2;0;17
5883;Ozas;"Kačiukai ";6456146804;Ne;0;0;1;1
5884;Ozas;"Kačiukai ";4514798132;Ne;9;3;6;18
5885;Ozas;"Kačiukai ";9655492678;Ne;4;0;7;11
5886;Ozas;"Kačiukai ";2729524188;Ne;0;0;7;7
5887;Ozas;Ančiukų;2869987587;Ne;9;3;0;12
5888;Ozas;Ančiukų;5926100815;Ne;11;0;3;14
5889;Ozas;Ančiukų;9178967858;Ne;11;0;1;12
5890;Ozas;Ančiukų;2248812743;Ne;0;1;5;6
5891;Ozas;Ančiukų;2454569369;Ne;4;0;2;6
5892;Ozas;Ančiukų;3133776891;Ne;0;0;1;1
5893;Ozas;Ančiukų;2139224651;Ne;5;0;3;8
5894;Ozas;Ančiukų;8713970306;Ne;6;0;0;6
5895;Ozas;Ančiukų;2819545359;Ne;11;0;0;11
5896;Ozas;Ančiukų;1803782282;Taip;1;8;0;9
5897;Ozas;Ančiukų;5172367556;Ne;5;5;0;10
5898;Ozas;Ančiukų;7617839839;Ne;5;2;0;7
5899;Ozas;Ančiukų;6346123124;Ne;0;6;2;8
5900;Ozas;Nykškukų;3139289643;Ne;2;1;0;3
5901;Ozas;Nykškukų;7585213159;Ne;6;1;0;7
5902;Ozas;Nykškukų;6392066805;Ne;10;0;0;10
5903;Ozas;Nykškukų;3902722274;Ne;5;1;1;7
5904;Ozas;Nykškukų;7922667688;Ne;10;0;2;12
5905;Ozas;Nykškukų;8781771299;Ne;8;0;0;8
5906;Ozas;Nykškukų;3817138493;Ne;5;4;1;10
5907;Ozas;Nykškukų;8371368881;Ne;10;0;1;11
5908;Ozas;Nykškukų;6476147361;Ne;0;0;2;2
5909;Ozas;Nykškukų;4994121247;Ne;8;0;0;8
5910;Ozas;Nykškukų;6315443248;Ne;10;1;0;11
5911;Ozas;Nykškukų;3723247420;Ne;5;0;0;5
5912;Ozas;Nykškukų;6318419889;Taip;1;0;2;3
5913;Ozas;Nykškukų;6186850614;Ne;9;0;0;9
5914;Ozas;Nykškukų;5182160089;Ne;11;0;4;15
5915;Ozas;Nykškukų;1536889312;Ne;12;0;2;14
5916;Ozas;Nykškukų;8897904793;Ne;6;0;0;6
5917;Pabiručiai;Voveriukų;4539246865;Ne;0;3;0;3
5918;Pabiručiai;Voveriukų;2349337471;Ne;0;1;0;1
5919;Pabiručiai;Voveriukų;9564303781;Ne;6;0;3;9
5920;Pabiručiai;Voveriukų;4312364951;Ne;0;9;0;9
5921;Pabiručiai;Voveriukų;3756731363;Ne;0;0;8;8
5922;Pabiručiai;Voveriukų;7985360502;Ne;0;0;1;1
5923;Pabiručiai;Voveriukų;3936426174;Ne;0;0;2;2
5924;Pabiručiai;Voveriukų;4069564285;Ne;0;4;0;4
5925;Pabiručiai;Voveriukų;7278334800;Ne;0;4;0;4
5926;Pabiručiai;Voveriukų;9468698553;Ne;3;0;1;4
5927;Pabiručiai;Voveriukų;5232678556;Ne;0;2;0;2
5928;Pabiručiai;Voveriukų;7066037017;Ne;2;4;0;6
5929;Pabiručiai;Voveriukų;2514312233;Ne;0;1;0;1
5930;Pabiručiai;Voveriukų;7606274875;Ne;0;1;0;1
5931;Pabiručiai;Voveriukų;9356327400;Ne;0;5;0;5
5932;Pabiručiai;Voveriukų;4813206044;Ne;0;9;0;9
5933;Pabiručiai;Voveriukų;7846758352;Ne;0;6;0;6
5934;Pabiručiai;Boružiukų;6401188653;Ne;0;1;0;1
5935;Pabiručiai;Boružiukų;1673473814;Ne;5;0;0;5
5936;Pabiručiai;Boružiukų;5686769648;Ne;0;14;0;14
5937;Pabiručiai;Boružiukų;7524993271;Ne;2;4;0;6
5938;Pabiručiai;Boružiukų;5708597471;Ne;0;1;0;1
5939;Pabiručiai;Boružiukų;4006783343;Ne;4;0;0;4
5940;Pabiručiai;Boružiukų;7046122545;Ne;0;7;0;7
5941;Pabiručiai;Boružiukų;3096466200;Ne;0;5;0;5
5942;Pabiručiai;Boružiukų;4301904533;Ne;0;6;3;9
5943;Pabiručiai;Boružiukų;8236964683;Ne;0;5;0;5
5944;Pabiručiai;Boružiukų;1240057541;Ne;0;2;0;2
5945;Pabiručiai;Boružiukų;1671027282;Ne;4;2;0;6
5946;Pabiručiai;Boružiukų;3759350345;Ne;0;1;0;1
5947;Pabiručiai;Boružiukų;3151360288;Ne;0;10;0;10
5948;Pabiručiai;Boružiukų;9299393363;Ne;0;7;0;7
5949;Pabiručiai;Boružiukų;1484291546;Ne;0;2;0;2
5950;Pabiručiai;Boružiukų;2771769336;Ne;0;2;0;2
5951;Pabiručiai;Boružiukų;2607840684;Ne;0;7;0;7
5952;Pabiručiai;Boružiukų;4681771534;Ne;0;3;0;3
5953;Pabiručiai;Boružiukų;7050339198;Ne;14;2;0;16
5954;Pabiručiai;Boružiukų;4798503931;Ne;0;0;1;1
5955;Pabiručiai;Katinėlių;8284711578;Ne;0;3;0;3
5956;Pabiručiai;Katinėlių;8710389714;Ne;0;4;0;4
5957;Pabiručiai;Katinėlių;1670938208;Ne;6;1;0;7
5958;Pabiručiai;Katinėlių;3756365293;Ne;1;2;0;3
5959;Pabiručiai;Katinėlių;6283372742;Ne;0;2;0;2
5960;Pabiručiai;Katinėlių;4205107384;Ne;0;1;1;2
5961;Pabiručiai;Katinėlių;4501176225;Ne;0;3;0;3
5962;Pabiručiai;Katinėlių;1749155319;Ne;0;6;1;7
5963;Pabiručiai;Katinėlių;2572570925;Ne;5;1;0;6
5964;Pabiručiai;Katinėlių;34883375155;Ne;0;7;0;7
5965;Pabiručiai;Katinėlių;8306688649;Ne;0;6;3;9
5966;Pabiručiai;Katinėlių;1705085006;Ne;0;3;0;3
5967;Pabiručiai;Katinėlių;58112415466;Ne;0;5;2;7
5968;Pabiručiai;Katinėlių;95695057362;Ne;0;4;0;4
5969;Pabiručiai;Katinėlių;42877891797;Ne;0;6;0;6
5970;Pabiručiai;Katinėlių;6285940478;Ne;0;4;0;4
5971;Pabiručiai;Katinėlių;1122183123;Ne;0;4;6;10
5972;Pabiručiai;Žiogelių;3272576627;Ne;0;3;0;3
5973;Pabiručiai;Žiogelių;5522447437;Ne;0;4;5;9
5974;Pabiručiai;Žiogelių;3585198013;Ne;0;2;0;2
5975;Pabiručiai;Žiogelių;7974345478;Ne;5;4;0;9
5976;Pabiručiai;Žiogelių;3206962828;Ne;4;4;1;9
5977;Pabiručiai;Žiogelių;3355875364;Ne;0;4;0;4
5978;Pabiručiai;Žiogelių;5311762824;Ne;6;1;1;8
5979;Pabiručiai;Žiogelių;1587905929;Ne;0;6;0;6
5980;Pabiručiai;Žiogelių;4667769378;Ne;0;3;0;3
5981;Pabiručiai;Žiogelių;7085036701;Ne;0;6;0;6
5982;Pabiručiai;Žiogelių;8367889753;Ne;0;3;0;3
5983;Pabiručiai;Žiogelių;8736658575;Ne;0;4;0;4
5984;Pabiručiai;Žiogelių;8106446562;Ne;0;4;0;4
5985;Pabiručiai;Žiogelių;8421025940;Ne;0;4;0;4
5986;Pabiručiai;Žiogelių;1311650644;Ne;0;4;0;4
5987;Pabiručiai;Žiogelių;3028063887;Ne;0;4;0;4
5988;Pabiručiai;Smalsiukai;2869383175;Ne;5;0;0;5
5989;Pabiručiai;Smalsiukai;7677235214;Ne;0;0;1;1
5990;Pabiručiai;Smalsiukai;9676561758;Ne;0;3;0;3
5991;Pabiručiai;Smalsiukai;7632969321;Ne;0;6;0;6
5992;Pabiručiai;Smalsiukai;7090116276;Ne;0;4;2;6
5993;Pabiručiai;Smalsiukai;6935913132;Ne;5;2;0;7
5994;Pabiručiai;Smalsiukai;7663581089;Ne;0;6;1;7
5995;Pabiručiai;Smalsiukai;9610623364;Ne;6;1;0;7
5996;Pabiručiai;Smalsiukai;8897462614;Ne;0;4;0;4
5997;Pabiručiai;Smalsiukai;2332338995;Ne;15;0;0;15
5998;Pabiručiai;Smalsiukai;4258226042;Ne;0;4;0;4
5999;Pabiručiai;Smalsiukai;3511851810;Ne;0;1;0;1
6000;Pabiručiai;Smalsiukai;6686039601;Ne;10;4;0;14
6001;Pabiručiai;Smalsiukai;5420231066;Ne;10;1;0;11
6002;Pabiručiai;Smalsiukai;9779260044;Ne;3;0;0;3
6003;Pabiručiai;Smalsiukai;2771891999;Ne;7;0;1;8
6004;Pabiručiai;Smalsiukai;7295052694;Ne;0;10;0;10
6005;Pabiručiai;Smalsiukai;6834663627;Ne;6;5;0;11
6006;Pabiručiai;Kiškučiai;3368607302;Ne;6;1;0;7
6007;Pabiručiai;Kiškučiai;9589005897;Ne;0;5;0;5
6008;Pabiručiai;Kiškučiai;6648966721;Ne;0;2;0;2
6009;Pabiručiai;Kiškučiai;9353062804;Ne;9;0;0;9
6010;Pabiručiai;Kiškučiai;1582754284;Ne;21;0;0;21
6011;Pabiručiai;Kiškučiai;4462744848;Ne;5;8;0;13
6012;Pabiručiai;Kiškučiai;5497318373;Ne;4;0;0;4
6013;Pabiručiai;Kiškučiai;1515270273;Ne;10;0;0;10
6014;Pabiručiai;Kiškučiai;2688728915;Ne;10;5;0;15
6015;Pabiručiai;Kiškučiai;5166525832;Ne;0;10;0;10
6016;Pabiručiai;Kiškučiai;8409455566;Ne;0;10;0;10
6017;Pabiručiai;Kiškučiai;1028312285;Ne;2;4;0;6
6018;Pabiručiai;Kiškučiai;5346249456;Ne;9;6;0;15
6019;Pabiručiai;Kiškučiai;5717534175;Ne;0;10;0;10
6020;Pabiručiai;Kiškučiai;3408518493;Ne;0;4;0;4
6021;Pabiručiai;Kiškučiai;7653129291;Ne;2;7;0;9
6022;Pabiručiai;Kiškučiai;7073230645;Ne;0;7;0;7
6023;Pabiručiai;Kiškučiai;8820585407;Ne;0;6;0;6
6024;Pabiručiai;Kiškučiai;7572077461;Ne;0;5;0;5
6025;Pabiručiai;Kiškučiai;5767879226;Ne;0;5;0;5
6026;Pabiručiai;"Pėledžiukai ";9834824219;Ne;1;9;0;10
6027;Pabiručiai;"Pėledžiukai ";6831569546;Ne;12;0;0;12
6028;Pabiručiai;"Pėledžiukai ";7961879916;Ne;3;2;0;5
6029;Pabiručiai;"Pėledžiukai ";9050994322;Ne;2;4;2;8
6030;Pabiručiai;"Pėledžiukai ";6697518151;Ne;0;2;0;2
6031;Pabiručiai;"Pėledžiukai ";2596301235;Ne;5;0;0;5
6032;Pabiručiai;"Pėledžiukai ";4333645528;Ne;5;0;0;5
6033;Pabiručiai;"Pėledžiukai ";6289025538;Ne;0;11;0;11
6034;Pabiručiai;"Pėledžiukai ";2343561322;Ne;0;2;0;2
6035;Pabiručiai;"Pėledžiukai ";3674583662;Ne;0;4;0;4
6036;Pabiručiai;"Pėledžiukai ";8268101318;Ne;0;4;0;4
6037;Pabiručiai;"Pėledžiukai ";2147165934;Ne;7;10;0;17
6038;Pabiručiai;"Pėledžiukai ";7385149524;Ne;6;0;0;6
6039;Pabiručiai;"Pėledžiukai ";7203091216;Ne;0;5;0;5
6040;Pabiručiai;"Pėledžiukai ";3224195892;Ne;4;6;0;10
6041;Pabiručiai;"Kodelčiūkai ";5950654594;Ne;0;2;0;2
6042;Pabiručiai;"Kodelčiūkai ";8775727677;Ne;0;3;0;3
6043;Pabiručiai;"Kodelčiūkai ";4317656984;Ne;5;0;0;5
6044;Pabiručiai;"Kodelčiūkai ";4785878572;Ne;0;4;0;4
6045;Pabiručiai;"Kodelčiūkai ";2295503584;Ne;0;11;0;11
6046;Pabiručiai;"Kodelčiūkai ";4595458527;Ne;0;1;0;1
6047;Pabiručiai;"Kodelčiūkai ";8716879106;Ne;0;2;2;4
6048;Pabiručiai;"Kodelčiūkai ";9067653417;Ne;0;0;4;4
6049;Pabiručiai;"Kodelčiūkai ";5247780866;Ne;0;2;0;2
6050;Pabiručiai;"Kodelčiūkai ";3433419710;Ne;2;1;1;4
6051;Pabiručiai;"Kodelčiūkai ";6386335808;Ne;6;0;6;12
6052;Pabiručiai;"Kodelčiūkai ";5010271037;Ne;0;4;0;4
6053;Pabiručiai;"Kodelčiūkai ";9538339883;Ne;0;6;1;7
6054;Pabiručiai;"Kodelčiūkai ";7289131864;Ne;0;3;0;3
6055;Pabiručiai;"Kodelčiūkai ";6209553290;Ne;21;0;0;21
6056;Pabiručiai;"Kodelčiūkai ";3748657353;Ne;0;4;3;7
6057;Pabiručiai;"Kodelčiūkai ";3497466298;Ne;5;4;0;9
6058;Pabiručiai;"Kodelčiūkai ";8179285338;Ne;0;6;0;6
6059;Pabiručiai;"Kodelčiūkai ";1234230729;Ne;5;0;4;9
6060;Pabiručiai;"Peliukų ";3702521810;Ne;10;0;2;12
6061;Pabiručiai;"Peliukų ";4894380231;Ne;5;0;0;5
6062;Pabiručiai;"Peliukų ";1947729077;Ne;8;0;0;8
6063;Pabiručiai;"Peliukų ";6678717039;Ne;0;4;2;6
6064;Pabiručiai;"Peliukų ";7182565608;Ne;11;1;0;12
6065;Pabiručiai;"Peliukų ";1776325000;Ne;12;0;0;12
6066;Pabiručiai;"Peliukų ";1099080685;Ne;5;12;0;17
6067;Pabiručiai;"Peliukų ";5990497129;Ne;5;2;0;7
6068;Pabiručiai;"Peliukų ";9890225918;Ne;5;0;1;6
6069;Pabiručiai;"Peliukų ";7644854044;Ne;0;15;0;15
6070;Pabiručiai;"Peliukų ";3826505104;Ne;5;0;0;5
6071;Pabiručiai;"Peliukų ";4852287574;Ne;5;0;0;5
6072;Pabiručiai;"Peliukų ";1206012259;Ne;0;1;0;1
6073;Pabiručiai;"Peliukų ";9790360371;Ne;4;0;1;5
6074;Pabiručiai;"Peliukų ";7980170279;Ne;0;8;0;8
6075;Pabiručiai;"Peliukų ";9806520732;Ne;5;0;2;7
6076;Pabiručiai;"Peliukų ";5923385276;Ne;5;4;0;9
6077;Pabiručiai;"Viščiukų ";8571325340;Ne;3;1;0;4
6078;Pabiručiai;"Viščiukų ";2849357495;Ne;4;0;0;4
6079;Pabiručiai;"Viščiukų ";8254676845;Ne;6;11;0;17
6080;Pabiručiai;"Viščiukų ";6742744014;Ne;0;4;0;4
6081;Pabiručiai;"Viščiukų ";7339565412;Ne;6;0;0;6
6082;Pabiručiai;"Viščiukų ";4880717493;Ne;21;0;0;21
6083;Pabiručiai;"Viščiukų ";1138743823;Ne;3;5;0;8
6084;Pabiručiai;"Viščiukų ";3011601512;Ne;15;0;0;15
6085;Pabiručiai;"Viščiukų ";7798837336;Ne;0;0;1;1
6086;Pabiručiai;"Viščiukų ";7914642744;Ne;10;0;0;10
6087;Pabiručiai;"Viščiukų ";5737214746;Ne;0;4;0;4
6088;Pabiručiai;"Viščiukų ";2141365015;Ne;11;0;0;11
6089;Pabiručiai;"Viščiukų ";6361966325;Ne;0;0;3;3
6090;Pabiručiai;"Viščiukų ";6508093808;Ne;0;3;0;3
6091;Pabiručiai;"Viščiukų ";8649685325;Ne;0;8;0;8
6092;Pabiručiai;"Viščiukų ";4929129093;Ne;5;4;0;9
6093;Pabiručiai;"Drugelių ";6014791534;Ne;3;0;0;3
6094;Pabiručiai;"Drugelių ";9890868992;Ne;12;0;2;14
6095;Pabiručiai;"Drugelių ";6601800828;Ne;15;0;0;15
6096;Pabiručiai;"Drugelių ";3491721002;Ne;11;0;1;12
6097;Pabiručiai;"Drugelių ";2556330147;Ne;6;7;0;13
6098;Pabiručiai;"Drugelių ";3004152898;Ne;7;5;0;12
6099;Pabiručiai;"Drugelių ";5050966784;Ne;9;0;0;9
6100;Pabiručiai;"Drugelių ";5019580409;Ne;5;0;0;5
6101;Pabiručiai;"Drugelių ";3531292373;Ne;0;4;0;4
6102;Pabiručiai;"Drugelių ";7561916887;Ne;0;6;0;6
6103;Pabiručiai;"Drugelių ";8668524776;Ne;0;1;0;1
6104;Pabiručiai;"Drugelių ";9878655387;Ne;10;0;0;10
6105;Pabiručiai;"Drugelių ";4876140467;Ne;16;2;0;18
6106;Pabiručiai;"Drugelių ";6481162347;Ne;6;0;0;6
6107;Pabiručiai;"Drugelių ";4012537474;Ne;0;8;5;13
6108;Pabiručiai;"Drugelių ";4701982784;Ne;6;0;0;6
6109;Pabiručiai;"Drugelių ";5147367745;Ne;4;0;2;6
6110;Pabiručiai;ŽIRNIUKŲ;2924005478;Ne;0;1;0;1
6111;Pabiručiai;ŽIRNIUKŲ;1852744763;Ne;0;0;3;3
6112;Pabiručiai;ŽIRNIUKŲ;4851108740;Ne;0;2;0;2
6113;Pabiručiai;ŽIRNIUKŲ;2794484633;Ne;8;2;0;10
6114;Pabiručiai;ŽIRNIUKŲ;8870657682;Ne;0;5;0;5
6115;Pabiručiai;ŽIRNIUKŲ;4096412988;Ne;5;2;0;7
6116;Pabiručiai;ŽIRNIUKŲ;3262687187;Ne;0;1;0;1
6117;Pabiručiai;ŽIRNIUKŲ;8092886420;Ne;0;11;0;11
6118;Pabiručiai;ŽIRNIUKŲ;7873575929;Ne;4;8;0;12
6119;Pabiručiai;ŽIRNIUKŲ;5862643827;Ne;0;6;2;8
6120;Pabiručiai;ŽIRNIUKŲ;5184688482;Ne;6;0;0;6
6121;Pabiručiai;ŽIRNIUKŲ;9507212682;Ne;0;1;0;1
6122;Pabiručiai;ŽIRNIUKŲ;9651695086;Ne;14;0;0;14
6123;Pabiručiai;ŽIRNIUKŲ;5899880680;Ne;10;0;2;12
6124;Pagrandukas;Saulytės;6915087488;Ne;2;4;0;6
6125;Pagrandukas;Saulytės;7605508460;Ne;0;4;0;4
6126;Pagrandukas;Saulytės;6349387692;Ne;16;0;0;16
6127;Pagrandukas;Saulytės;8186092469;Ne;0;8;0;8
6128;Pagrandukas;Saulytės;2934300533;Ne;21;0;0;21
6129;Pagrandukas;Saulytės;1548697124;Ne;0;5;0;5
6130;Pagrandukas;Saulytės;6711830251;Ne;0;1;0;1
6131;Pagrandukas;Saulytės;7146697128;Ne;5;1;2;8
6132;Pagrandukas;Saulytės;3157676207;Ne;4;4;0;8
6133;Pagrandukas;Saulytės;7511097160;Ne;0;7;0;7
6134;Pagrandukas;Saulytės;3783160018;Ne;0;4;0;4
6135;Pagrandukas;Saulytės;1766912463;Ne;4;5;0;9
6136;Pagrandukas;Saulytės;9849054467;Ne;2;0;0;2
6137;Pagrandukas;Saulytės;8024910647;Ne;0;6;0;6
6138;Pagrandukas;Saulytės;8481502330;Ne;0;3;0;3
6139;Pagrandukas;Saulytės;7160305478;Ne;0;2;0;2
6140;Pagrandukas;Saulytės;3008997793;Ne;0;3;0;3
6141;Pagrandukas;Saulytės;6388805960;Ne;0;6;6;12
6142;Pagrandukas;Saulytės;3050207849;Ne;0;2;0;2
6143;Pagrandukas;Saulytės;8836178193;Ne;2;1;0;3
6144;Pagrandukas;Saulytės;7157549179;Ne;5;0;0;5
6145;Pagrandukas;Zuikučiai;7834436515;Ne;0;9;0;9
6146;Pagrandukas;Zuikučiai;5903416384;Ne;0;4;2;6
6147;Pagrandukas;Zuikučiai;2439891231;Ne;0;2;0;2
6148;Pagrandukas;Zuikučiai;6710887776;Ne;0;2;0;2
6149;Pagrandukas;Zuikučiai;7665811353;Ne;11;0;0;11
6150;Pagrandukas;Zuikučiai;2212787835;Ne;0;2;0;2
6151;Pagrandukas;Zuikučiai;2711590019;Ne;9;0;0;9
6152;Pagrandukas;Zuikučiai;6449029299;Ne;6;0;0;6
6153;Pagrandukas;Zuikučiai;1405820070;Ne;0;4;0;4
6154;Pagrandukas;Zuikučiai;1795582354;Ne;10;0;0;10
6155;Pagrandukas;Zuikučiai;2822538227;Ne;5;0;0;5
6156;Pagrandukas;Zuikučiai;1587839122;Ne;13;0;0;13
6157;Pagrandukas;Zuikučiai;2101505576;Ne;19;0;2;21
6158;Pagrandukas;Zuikučiai;6765346578;Ne;8;0;0;8
6159;Pagrandukas;Zuikučiai;5922595170;Ne;11;0;0;11
6160;Pagrandukas;Zuikučiai;5030928303;Ne;0;5;0;5
6161;Pagrandukas;Zuikučiai;9139212151;Ne;0;4;4;8
6162;Pagrandukas;Zuikučiai;8643993939;Ne;0;5;5;10
6163;Pagrandukas;Zuikučiai;5021106231;Ne;5;0;0;5
6164;Pagrandukas;Zuikučiai;3494047045;Ne;6;1;0;7
6165;Pagrandukas;Boružėlių;3398225200;Ne;0;5;2;7
6166;Pagrandukas;Boružėlių;5752454925;Ne;0;2;0;2
6167;Pagrandukas;Boružėlių;3587941684;Ne;0;4;0;4
6168;Pagrandukas;Boružėlių;6304701617;Ne;0;4;0;4
6169;Pagrandukas;Boružėlių;5511396314;Ne;0;10;0;10
6170;Pagrandukas;Boružėlių;6911951786;Ne;0;3;0;3
6171;Pagrandukas;Boružėlių;2926077771;Ne;0;8;0;8
6172;Pagrandukas;Bitutės;6044667668;Ne;0;1;5;6
6173;Pagrandukas;Bitutės;8529974367;Ne;0;2;2;4
6174;Pagrandukas;Bitutės;1938604743;Ne;0;1;0;1
6175;Pagrandukas;Bitutės;8625382465;Ne;0;0;1;1
6176;Pagrandukas;Bitutės;2923517578;Ne;0;11;0;11
6177;Pagrandukas;Bitutės;4322675634;Ne;0;5;0;5
6178;Pagrandukas;Bitutės;3875062228;Ne;0;8;0;8
6179;Pagrandukas;Bitutės;1583104760;Ne;6;5;0;11
6180;Pagrandukas;Bitutės;5649084353;Ne;5;0;0;5
6181;Pagrandukas;Bitutės;8719834064;Ne;5;4;0;9
6182;Pagrandukas;Bitutės;5821945401;Ne;0;0;11;11
6183;Pagrandukas;Bitutės;7675694987;Ne;3;1;1;5
6184;Pagrandukas;Bitutės;3709131197;Ne;7;0;0;7
6185;Pagrandukas;Bitutės;2098182423;Ne;0;4;0;4
6186;Pagrandukas;Bitutės;8280877177;Taip;0;1;1;2
6187;Pagrandukas;Bitutės;2764732768;Ne;10;0;2;12
6188;Pagrandukas;Pelėdžiukai;1714449109;Ne;10;6;0;16
6189;Pagrandukas;Pelėdžiukai;3160109801;Ne;0;2;1;3
6190;Pagrandukas;Pelėdžiukai;7764147734;Ne;0;1;0;1
6191;Pagrandukas;Pelėdžiukai;8633116370;Ne;0;1;0;1
6192;Pagrandukas;Pelėdžiukai;2877401332;Ne;9;1;0;10
6193;Pagrandukas;Pelėdžiukai;8167118045;Ne;12;0;0;12
6194;Pagrandukas;Pelėdžiukai;3390664086;Ne;0;4;0;4
6195;Pagrandukas;Pelėdžiukai;1733723373;Ne;15;0;0;15
6196;Pagrandukas;Pelėdžiukai;6011346969;Ne;16;0;0;16
6197;Pagrandukas;Pelėdžiukai;9583471280;Ne;0;3;0;3
6198;Pagrandukas;Pelėdžiukai;2481532396;Ne;8;0;0;8
6199;Pagrandukas;Pelėdžiukai;4398016119;Ne;0;9;0;9
6200;Pagrandukas;Pelėdžiukai;2640777376;Ne;15;0;0;15
6201;Pagrandukas;Pelėdžiukai;4910151924;Ne;6;0;0;6
6202;Pagrandukas;Pelėdžiukai;1977974235;Ne;9;2;1;12
6203;Pagrandukas;Pelėdžiukai;7238694532;Ne;0;7;6;13
6204;Pagrandukas;ŠYPSENĖLIŲ;4627387596;Ne;0;0;3;3
6205;Pagrandukas;ŠYPSENĖLIŲ;7173561328;Ne;13;0;0;13
6206;Pagrandukas;ŠYPSENĖLIŲ;1101989969;Ne;0;5;0;5
6207;Pagrandukas;ŠYPSENĖLIŲ;5701479990;Ne;6;5;0;11
6208;Pagrandukas;ŠYPSENĖLIŲ;9981610798;Ne;0;5;0;5
6209;Pagrandukas;ŠYPSENĖLIŲ;8027783692;Ne;5;0;0;5
6210;Pagrandukas;ŠYPSENĖLIŲ;6248684084;Ne;7;1;0;8
6211;Pagrandukas;ŠYPSENĖLIŲ;2904880156;Ne;0;10;0;10
6212;Pagrandukas;ŠYPSENĖLIŲ;5173633710;Ne;5;0;0;5
6213;Pagrandukas;ŠYPSENĖLIŲ;6057078416;Ne;5;0;7;12
6214;Pagrandukas;ŠYPSENĖLIŲ;1475375452;Ne;0;0;2;2
6215;Pagrandukas;ŠYPSENĖLIŲ;8475724797;Ne;0;0;2;2
6216;Pagrandukas;ŠYPSENĖLIŲ;6517393406;Ne;9;0;0;9
6217;Pagrandukas;ŠYPSENĖLIŲ;4094086585;Ne;6;6;0;12
6218;Pagrandukas;ŠYPSENĖLIŲ;6306635507;Ne;0;3;0;3
6219;Pagrandukas;ŠYPSENĖLIŲ;5060059491;Ne;12;0;0;12
6220;Pakalnutė;Pagrandukai;7475119623;Ne;0;3;0;3
6221;Pakalnutė;Pagrandukai;9677810607;Ne;5;0;1;6
6222;Pakalnutė;Pagrandukai;5275833872;Ne;19;1;0;20
6223;Pakalnutė;Pagrandukai;5943686565;Ne;17;0;0;17
6224;Pakalnutė;Pagrandukai;2296079246;Ne;10;0;2;12
6225;Pakalnutė;Pagrandukai;9313588621;Ne;6;0;1;7
6226;Pakalnutė;Pagrandukai;7962849592;Ne;0;1;0;1
6227;Pakalnutė;Pagrandukai;5180015882;Ne;12;0;0;12
6228;Pakalnutė;Pagrandukai;3794283102;Ne;2;1;0;3
6229;Pakalnutė;Pagrandukai;3070652992;Ne;14;0;0;14
6230;Pakalnutė;Pagrandukai;7477188659;Ne;5;0;0;5
6231;Pakalnutė;Pagrandukai;2642359967;Ne;2;1;0;3
6232;Pakalnutė;Pagrandukai;7417131378;Ne;21;0;0;21
6233;Pakalnutė;Pagrandukai;6396963609;Ne;21;0;0;21
6234;Pakalnutė;Pagrandukai;6708041407;Ne;7;0;0;7
6235;Pakalnutė;Pagrandukai;1883500676;Ne;1;0;0;1
6236;Pakalnutė;"Pelėdžiukų ";7110858765;Ne;0;0;2;2
6237;Pakalnutė;"Pelėdžiukų ";8553182620;Ne;3;1;1;5
6238;Pakalnutė;"Pelėdžiukų ";3840499737;Ne;10;2;0;12
6239;Pakalnutė;"Pelėdžiukų ";4523766424;Ne;0;3;3;6
6240;Pakalnutė;"Pelėdžiukų ";7151877991;Ne;0;0;2;2
6241;Pakalnutė;"Pelėdžiukų ";2992768162;Ne;0;5;1;6
6242;Pakalnutė;"Pelėdžiukų ";9505524183;Ne;4;0;0;4
6243;Pakalnutė;"Pelėdžiukų ";8823232039;Ne;0;1;0;1
6244;Pakalnutė;"Pelėdžiukų ";4220368864;Ne;0;4;0;4
6245;Pakalnutė;"Pelėdžiukų ";1330092247;Ne;2;10;0;12
6246;Pakalnutė;"Pelėdžiukų ";3267680599;Ne;8;4;0;12
6247;Pakalnutė;"Pelėdžiukų ";4452372238;Ne;5;0;0;5
6248;Pakalnutė;Ežiukai;5058727058;Ne;0;4;0;4
6249;Pakalnutė;Ežiukai;4052166895;Ne;3;0;0;3
6250;Pakalnutė;Ežiukai;1070172991;Taip;0;4;0;4
6251;Pakalnutė;Ežiukai;9323200833;Ne;0;11;0;11
6252;Pakalnutė;Ežiukai;9781993614;Ne;0;6;1;7
6253;Pakalnutė;Ežiukai;4317305712;Ne;5;5;0;10
6254;Pakalnutė;Ežiukai;6029905101;Ne;4;0;0;4
6255;Pakalnutė;Ežiukai;7734657452;Ne;3;2;0;5
6256;Pakalnutė;Ežiukai;8081932074;Ne;9;1;0;10
6257;Pakalnutė;Ežiukai;7881545979;Ne;0;4;0;4
6258;Pakalnutė;Ežiukai;8080989574;Ne;0;8;0;8
6259;Pakalnutė;Ežiukai;5911381706;Ne;0;5;0;5
6260;Pakalnutė;Ežiukai;2755412687;Ne;10;0;0;10
6261;Pakalnutė;Ežiukai;8236718590;Ne;6;0;0;6
6262;Pakalnutė;Ežiukai;3064391379;Ne;16;0;0;16
6263;Pakalnutė;Ežiukai;2015778005;Ne;0;4;3;7
6264;Pakalnutė;Skruzdėliukų;4033813807;Ne;23;0;0;23
6265;Pakalnutė;Skruzdėliukų;7503936754;Ne;6;0;0;6
6266;Pakalnutė;Skruzdėliukų;5409476517;Ne;0;17;0;17
6267;Pakalnutė;Skruzdėliukų;2670302354;Ne;1;0;0;1
6268;Pakalnutė;Skruzdėliukų;7105369111;Ne;9;0;0;9
6269;Pakalnutė;Skruzdėliukų;6944726166;Ne;4;0;0;4
6270;Pakalnutė;Skruzdėliukų;1195872320;Ne;5;1;0;6
6271;Pakalnutė;Skruzdėliukų;3211633472;Ne;0;4;0;4
6272;Pakalnutė;Skruzdėliukų;4423348418;Ne;5;4;0;9
6273;Pakalnutė;Skruzdėliukų;6055727963;Taip;0;0;1;1
6274;Pakalnutė;Skruzdėliukų;5619262190;Ne;10;1;0;11
6275;Pakalnutė;Skruzdėliukų;3215438452;Ne;6;2;0;8
6276;Pakalnutė;Skruzdėliukų;9681515221;Ne;13;0;1;14
6277;Pakalnutė;Skruzdėliukų;8496839980;Ne;10;0;0;10
6278;Pakalnutė;Skruzdėliukų;9336711927;Ne;4;0;0;4
6279;Pakalnutė;Skruzdėliukų;5356902834;Ne;2;0;2;4
6280;Pakalnutė;Skruzdėliukų;3288449407;Ne;5;0;0;5
6281;Pakalnutė;Bitučių;8461220770;Ne;0;0;1;1
6282;Pakalnutė;Bitučių;2367683002;Ne;5;0;0;5
6283;Pakalnutė;Bitučių;2765220889;Ne;17;1;0;18
6284;Pakalnutė;Bitučių;9445909071;Ne;4;2;0;6
6285;Pakalnutė;Bitučių;5532458706;Ne;0;12;0;12
6286;Pakalnutė;Bitučių;7526989580;Ne;8;0;0;8
6287;Pakalnutė;Bitučių;5941955322;Ne;4;0;2;6
6288;Pakalnutė;Bitučių;2095540372;Ne;10;0;1;11
6289;Pakalnutė;Bitučių;5342592825;Ne;10;1;0;11
6290;Pakalnutė;Bitučių;2932205226;Ne;10;0;1;11
6291;Pakalnutė;Bitučių;5464143742;Ne;12;0;2;14
6292;Pakalnutė;Bitučių;3965390135;Ne;8;4;1;13
6293;Pakalnutė;Bitučių;4533467194;Ne;0;0;5;5
6294;Pakalnutė;Boružiukų;5120176374;Ne;0;5;0;5
6295;Pakalnutė;Boružiukų;6798939288;Ne;0;6;0;6
6296;Pakalnutė;Boružiukų;7357431226;Ne;0;5;0;5
6297;Pakalnutė;Boružiukų;5039000154;Ne;0;6;0;6
6298;Pakalnutė;Boružiukų;2835611316;Ne;5;0;6;11
6299;Pakalnutė;Boružiukų;4950195858;Ne;4;0;1;5
6300;Pakalnutė;Boružiukų;4927086034;Ne;12;0;0;12
6301;Pakalnutė;Boružiukų;6557165567;Ne;4;2;1;7
6302;Pakalnutė;Boružiukų;3677709759;Ne;5;0;2;7
6303;Pakalnutė;Boružiukų;2597900983;Ne;0;5;0;5
6304;Pakalnutė;Boružiukų;2062721289;Ne;0;1;0;1
6305;Pakalnutė;Boružiukų;1340022702;Ne;10;3;0;13
6306;Pakalnutė;Boružiukų;6228196996;Ne;16;0;0;16
6307;Pakalnutė;Boružiukų;7563201788;Ne;2;0;0;2
6308;Pakalnutė;Meškiukų;2666441234;Ne;28;0;0;28
6309;Pakalnutė;Meškiukų;2101821362;Ne;3;1;0;4
6310;Pakalnutė;Meškiukų;4069910346;Ne;0;0;1;1
6311;Pakalnutė;Meškiukų;4313652059;Ne;0;3;0;3
6312;Pakalnutė;Meškiukų;7084798190;Ne;6;2;0;8
6313;Pakalnutė;Meškiukų;3693337607;Ne;21;0;0;21
6314;Pakalnutė;Meškiukų;2923698853;Ne;19;0;0;19
6315;Pakalnutė;Meškiukų;1369906621;Ne;0;0;1;1
6316;Pakalnutė;Nykštukai;9918277117;Ne;9;0;0;9
6317;Pakalnutė;Nykštukai;6633585181;Ne;0;0;3;3
6318;Pakalnutė;Nykštukai;3870628774;Ne;6;0;0;6
6319;Pakalnutė;Nykštukai;8324219868;Ne;4;0;0;4
6320;Pakalnutė;Nykštukai;1236187157;Ne;4;0;2;6
6321;Pakalnutė;Nykštukai;2063766287;Ne;0;6;0;6
6322;Pakalnutė;Nykštukai;8217779439;Ne;4;1;0;5
6323;Pakalnutė;Nykštukai;6206296685;Ne;0;6;0;6
6324;Pakalnutė;Nykštukai;8855237588;Taip;5;6;0;11
6325;Pakalnutė;Nykštukai;1561411767;Ne;0;7;0;7
6326;Pakalnutė;Nykštukai;9443826616;Ne;10;1;0;11
6327;Pakalnutė;Nykštukai;7024440142;Ne;0;2;0;2
6328;Pakalnutė;Nykštukai;2578170222;Ne;5;0;1;6
6329;Pakalnutė;Nykštukai;3967515235;Ne;6;0;0;6
6330;Pakalnutė;Nykštukai;5377715404;Ne;5;3;0;8
6331;Pakalnutė;Nykštukai;3938091521;Ne;4;0;0;4
6332;Pakalnutė;"Zuikučių ";1198230323;Ne;0;3;0;3
6333;Pakalnutė;"Zuikučių ";3609982613;Ne;0;6;0;6
6334;Pakalnutė;"Zuikučių ";5958653847;Ne;0;3;0;3
6335;Pakalnutė;"Zuikučių ";1147843795;Ne;13;0;0;13
6336;Pakalnutė;"Zuikučių ";1583462733;Ne;0;1;0;1
6337;Pakalnutė;"Zuikučių ";6377564215;Ne;6;0;1;7
6338;Pakalnutė;"Zuikučių ";8813262660;Ne;12;0;0;12
6339;Pakalnutė;"Zuikučių ";7949588551;Ne;5;0;0;5
6340;Pakalnutė;"Zuikučių ";81578522887;Ne;0;5;0;5
6341;Pakalnutė;"Zuikučių ";2002555659;Ne;0;0;5;5
6342;Pakalnutė;"Zuikučių ";4681267749;Ne;0;2;0;2
6343;Pakalnutė;"Zuikučių ";6884488772;Ne;0;0;1;1
6344;Pakalnutė;"Zuikučių ";9934596750;Ne;0;4;0;4
6345;Pakalnutė;"Zuikučių ";5912904296;Ne;6;2;0;8
6346;Pakalnutė;"Drugelių ";5441477374;Ne;0;4;0;4
6347;Pakalnutė;"Drugelių ";7369661890;Ne;11;0;1;12
6348;Pakalnutė;"Drugelių ";5135811550;Ne;15;0;0;15
6349;Pakalnutė;"Drugelių ";7766653114;Ne;0;0;7;7
6350;Pakalnutė;"Drugelių ";7709684372;Ne;0;2;0;2
6351;Pakalnutė;"Drugelių ";9620000116;Ne;0;16;0;16
6352;Pakalnutė;"Drugelių ";5502444590;Ne;1;0;0;1
6353;Pakalnutė;"Drugelių ";3730712580;Ne;0;0;4;4
6354;Pakalnutė;"Drugelių ";1824418095;Ne;0;1;0;1
6355;Pakalnutė;"Drugelių ";9461133636;Ne;5;0;2;7
6356;Pakalnutė;"Drugelių ";4220406978;Ne;2;0;4;6
6357;Pakalnutė;"Drugelių ";5069038636;Ne;0;21;0;21
6358;Pakalnutė;"Drugelių ";7047587606;Ne;7;5;0;12
6359;Pakalnutė;"Drugelių ";2653667596;Ne;0;12;0;12
6360;Pakalnutė;"Drugelių ";2197533802;Ne;11;0;0;11
6361;Pakalnutė;"Drugelių ";1791607977;Ne;0;5;0;5
6362;Pakalnutė;"Drugelių ";4127500142;Ne;0;0;3;3
6363;Pakalnutė;"Drugelių ";9295709508;Taip;16;0;0;16
6364;Pakalnutė;"Drugelių ";6924023022;Ne;10;0;0;10
6365;Pakalnutė;Žvirbliukų;7421275778;Ne;5;0;2;7
6366;Pakalnutė;Žvirbliukų;8329725085;Ne;4;2;3;9
6367;Pakalnutė;Žvirbliukų;3190067149;Taip;0;4;0;4
6368;Pakalnutė;Žvirbliukų;7548659665;Ne;7;0;0;7
6369;Pakalnutė;Žvirbliukų;8010667913;Ne;16;0;0;16
6370;Pakalnutė;Žvirbliukų;1662773049;Ne;6;2;5;13
6371;Pakalnutė;Žvirbliukų;5531209454;Ne;15;0;0;15
6372;Pakalnutė;Žvirbliukų;3342793992;Ne;5;0;1;6
6373;Pakalnutė;Žvirbliukų;7258417347;Ne;21;0;0;21
6374;Pakalnutė;Žvirbliukų;4961361687;Ne;13;0;0;13
6375;Pakalnutė;Žvirbliukų;5878352514;Ne;9;0;0;9
6376;Pakalnutė;Žvirbliukų;5685361033;Ne;9;1;0;10
6377;Pakalnutė;Žvirbliukų;7782295402;Ne;7;10;0;17
6378;Pakalnutė;Žvirbliukų;7547661599;Taip;24;0;0;24
6379;Pakalnutė;Žvirbliukų;4469974699;Ne;6;2;0;8
6380;Pakalnutė;Žvirbliukų;6159955311;Ne;11;0;0;11
6381;Pakalnutė;Žvirbliukų;3903972025;Ne;11;0;0;11
6382;Pakalnutė;Žvirbliukų;8567965305;Ne;0;0;10;10
6383;Pakalnutė;Žvirbliukų;3458404368;Ne;8;1;0;9
6384;Panerių;Rūtelė;3438863665;Ne;0;5;0;5
6385;Panerių;Rūtelė;4689913361;Ne;0;0;5;5
6386;Panerių;Rūtelė;2195332401;Ne;0;4;8;12
6387;Panerių;Rūtelė;6908487075;Ne;9;4;0;13
6388;Panerių;Rūtelė;8771264170;Ne;0;0;5;5
6389;Panerių;Rūtelė;7805429137;Ne;0;0;8;8
6390;Panerių;Rūtelė;9268618414;Ne;0;0;2;2
6391;Panerių;Rūtelė;6411372006;Ne;17;0;1;18
6392;Panerių;Rūtelė;1419817211;Ne;13;0;0;13
6393;Panerių;Rūtelė;2333355325;Ne;0;0;1;1
6394;Panerių;Rūtelė;2235123048;Ne;10;0;3;13
6395;Panerių;Rūtelė;3190117304;Ne;0;12;0;12
6396;Panerių;Rūtelė;8693113275;Ne;18;0;0;18
6397;Panerių;Rūtelė;6468190149;Ne;0;10;0;10
6398;Panerių;Rūtelė;9630302749;Ne;5;1;0;6
6399;Panerių;Gėlytės;1339256258;Ne;10;0;2;12
6400;Panerių;Gėlytės;9729731866;Ne;0;5;0;5
6401;Panerių;Gėlytės;6583134855;Ne;4;0;4;8
6402;Panerių;Gėlytės;3948776877;Ne;6;0;0;6
6403;Panerių;Gėlytės;2751334281;Ne;0;1;1;2
6404;Panerių;Gėlytės;9432171719;Ne;0;1;0;1
6405;Panerių;Gėlytės;5452996791;Ne;5;0;0;5
6406;Panerių;Gėlytės;1717129076;Ne;21;0;0;21
6407;Panerių;Gėlytės;2035822976;Ne;0;0;2;2
6408;Panerių;Gėlytės;8447920373;Ne;2;0;1;3
6409;Panerių;Gėlytės;4161189870;Ne;0;7;7;14
6410;Panerių;Gėlytės;9004310393;Ne;16;0;0;16
6411;Panerių;Gėlytės;3112608087;Ne;0;0;7;7
6412;Panerių;Gėlytės;5100874548;Ne;7;0;0;7
6413;Panerių;Gėlytės;6304387432;Ne;0;0;10;10
6414;Panerių;Gėlytės;7166964095;Ne;0;0;3;3
6415;Panerių;Gėlytės;8109366029;Ne;0;0;1;1
6416;Panerių;Boružė;7657860513;Ne;16;2;0;18
6417;Panerių;Boružė;9014387764;Ne;5;0;0;5
6418;Panerių;Boružė;4369979548;Ne;16;0;0;16
6419;Panerių;Boružė;3273655606;Ne;20;0;0;20
6420;Panerių;Boružė;8067240250;Ne;12;0;2;14
6421;Panerių;Boružė;3526636673;Ne;10;0;0;10
6422;Panerių;Boružė;8407995549;Ne;12;2;0;14
6423;Panerių;Boružė;3502494751;Ne;6;0;6;12
6424;Panerių;Boružė;6574858142;Ne;16;0;0;16
6425;Panerių;Boružė;6653710644;Ne;0;7;0;7
6426;Panerių;Boružė;9288515724;Ne;15;0;6;21
6427;Panerių;Boružė;7976634590;Ne;4;0;0;4
6428;Panerių;Boružė;4716214117;Ne;14;0;0;14
6429;Panerių;Boružė;4957564440;Ne;10;0;2;12
6430;Panerių;Boružė;1985780685;Ne;5;0;4;9
6431;Panerių;BORUŽĖ;1519192757;Ne;4;0;0;4
6432;Papartis;ZUIKUČIAI;8874222586;Ne;6;0;0;6
6433;Papartis;ZUIKUČIAI;2446379598;Ne;0;0;6;6
6434;Papartis;ZUIKUČIAI;3054883426;Ne;10;0;0;10
6435;Papartis;ZUIKUČIAI;1191546794;Ne;7;1;1;9
6436;Papartis;ZUIKUČIAI;7619963429;Ne;0;1;0;1
6437;Papartis;ZUIKUČIAI;8958880558;Ne;4;9;0;13
6438;Papartis;ZUIKUČIAI;4380030213;Ne;14;0;0;14
6439;Papartis;ZUIKUČIAI;4906248064;Ne;6;0;3;9
6440;Papartis;ZUIKUČIAI;8447326505;Ne;0;4;0;4
6441;Papartis;ZUIKUČIAI;4640068595;Ne;0;2;0;2
6442;Papartis;ZUIKUČIAI;5361925390;Ne;0;0;5;5
6443;Papartis;ZUIKUČIAI;5796928317;Ne;0;0;7;7
6444;Papartis;ZUIKUČIAI;9375751990;Ne;0;10;0;10
6445;Papartis;ZUIKUČIAI;6266095782;Ne;5;0;0;5
6446;Papartis;ZUIKUČIAI;5786648402;Ne;0;0;2;2
6447;Papartis;ZUIKUČIAI;5776038830;Ne;10;0;1;11
6448;Papartis;ZUIKUČIAI;5579899922;Ne;5;0;0;5
6449;Papartis;ZUIKUČIAI;8808902528;Ne;0;4;0;4
6450;Papartis;ZUIKUČIAI;9358310527;Ne;0;8;0;8
6451;Papartis;ZUIKUČIAI;5363926529;Ne;0;8;0;8
6452;Papartis;ZUIKUČIAI;1722192450;Ne;8;0;0;8
6453;Papartis;DRUGELIAI;8005876431;Ne;11;0;0;11
6454;Papartis;DRUGELIAI;6664178454;Ne;0;1;1;2
6455;Papartis;DRUGELIAI;2432516496;Ne;0;7;0;7
6456;Papartis;DRUGELIAI;7742769931;Ne;3;0;2;5
6457;Papartis;DRUGELIAI;8305560946;Ne;0;0;5;5
6458;Papartis;DRUGELIAI;4778327620;Ne;0;9;0;9
6459;Papartis;DRUGELIAI;7331682622;Ne;11;0;0;11
6460;Papartis;DRUGELIAI;2824078830;Ne;4;0;5;9
6461;Papartis;DRUGELIAI;8782882575;Ne;0;2;0;2
6462;Papartis;DRUGELIAI;1405767603;Ne;0;5;1;6
6463;Papartis;DRUGELIAI;6435625940;Ne;0;4;0;4
6464;Papartis;DRUGELIAI;3411472740;Ne;15;4;1;20
6465;Papartis;DRUGELIAI;8277830926;Ne;0;4;0;4
6466;Papartis;DRUGELIAI;1759982543;Ne;0;9;0;9
6467;Papartis;DRUGELIAI;4689046394;Ne;2;1;0;3
6468;Papartis;DRUGELIAI;5430993785;Ne;5;1;0;6
6469;Papartis;ŽVIRBLIUKAI;7590170146;Ne;0;1;5;6
6470;Papartis;ŽVIRBLIUKAI;42803013754;Ne;0;4;0;4
6471;Papartis;ŽVIRBLIUKAI;3408756311;Ne;0;4;0;4
6472;Papartis;ŽVIRBLIUKAI;7067369268;Ne;7;0;3;10
6473;Papartis;ŽVIRBLIUKAI;1836914270;Ne;0;4;0;4
6474;Papartis;ŽVIRBLIUKAI;4508053349;Ne;0;2;3;5
6475;Papartis;ŽVIRBLIUKAI;2778629398;Ne;0;2;7;9
6476;Papartis;ŽVIRBLIUKAI;2535412635;Ne;0;0;3;3
6477;Papartis;ŽVIRBLIUKAI;7102350653;Ne;0;4;3;7
6478;Papartis;ŽVIRBLIUKAI;1205854439;Ne;0;1;4;5
6479;Papartis;ŽVIRBLIUKAI;1672028156;Ne;0;3;2;5
6480;Papartis;ŽVIRBLIUKAI;8148483438;Ne;0;1;0;1
6481;Papartis;ŽVIRBLIUKAI;3295731801;Ne;0;3;6;9
6482;Papartis;ŽVIRBLIUKAI;6797687614;Ne;0;1;8;9
6483;Papartis;ŽVIRBLIUKAI;3475745012;Ne;0;4;4;8
6484;Papartis;ŽVIRBLIUKAI;4634683589;Ne;0;2;6;8
6485;Papartis;ŽVIRBLIUKAI;5265293240;Ne;0;4;0;4
6486;Papartis;ŽVIRBLIUKAI;9134335737;Ne;0;4;0;4
6487;Papartis;ŽVIRBLIUKAI;7387281720;Ne;0;1;0;1
6488;Papartis;PELĖDŽIUKAI;7606939822;Ne;0;1;0;1
6489;Papartis;PELĖDŽIUKAI;2447926422;Ne;0;8;0;8
6490;Papartis;PELĖDŽIUKAI;1260151691;Ne;6;1;0;7
6491;Papartis;PELĖDŽIUKAI;4346817695;Ne;6;4;1;11
6492;Papartis;PELĖDŽIUKAI;1527263538;Ne;5;2;0;7
6493;Papartis;PELĖDŽIUKAI;1219140467;Ne;5;3;0;8
6494;Papartis;PELĖDŽIUKAI;5410369044;Ne;4;8;0;12
6495;Papartis;PELĖDŽIUKAI;1065128993;Ne;0;9;0;9
6496;Papartis;PELĖDŽIUKAI;6126912448;Ne;0;4;0;4
6497;Papartis;PELĖDŽIUKAI;8952917454;Ne;0;4;3;7
6498;Papartis;PELĖDŽIUKAI;3182457453;Ne;21;0;0;21
6499;Papartis;PELĖDŽIUKAI;5675537250;Ne;0;4;0;4
6500;Papartis;PELĖDŽIUKAI;72182866449;Ne;0;4;0;4
6501;Papartis;PELĖDŽIUKAI;4992305227;Ne;0;2;0;2
6502;Papartis;PELĖDŽIUKAI;7703070601;Ne;0;5;2;7
6503;Papartis;PELĖDŽIUKAI;7902130389;Ne;6;1;4;11
6504;Papartis;PELĖDŽIUKAI;4279580382;Ne;7;0;0;7
6505;Papartis;PELĖDŽIUKAI;1974159967;Ne;5;3;0;8
6506;Papartis;PELĖDŽIUKAI;5732853976;Ne;12;4;0;16
6507;Papartis;PELĖDŽIUKAI;1554777403;Ne;2;0;6;8
6508;Papartis;PELĖDŽIUKAI;7768672610;Ne;3;0;0;3
6509;Papartis;PELĖDŽIUKAI;9939850340;Ne;0;4;0;4
6510;Papartis;SAULUTĖS;5538433120;Ne;3;1;0;4
6511;Papartis;SAULUTĖS;6585372451;Ne;8;1;0;9
6512;Papartis;SAULUTĖS;6734567714;Ne;0;1;0;1
6513;Papartis;SAULUTĖS;1231594320;Ne;7;1;0;8
6514;Papartis;SAULUTĖS;3539507686;Ne;0;4;0;4
6515;Papartis;SAULUTĖS;3595627659;Ne;6;0;0;6
6516;Papartis;SAULUTĖS;6977513472;Ne;0;9;0;9
6517;Papartis;SAULUTĖS;5070767260;Ne;3;2;0;5
6518;Papartis;SAULUTĖS;9380951144;Ne;13;0;0;13
6519;Papartis;SAULUTĖS;4016297254;Ne;8;0;4;12
6520;Papartis;SAULUTĖS;5323875279;Ne;0;5;0;5
6521;Papartis;SAULUTĖS;5465955537;Ne;5;2;3;10
6522;Papartis;SAULUTĖS;2812347963;Ne;8;1;0;9
6523;Papartis;SAULUTĖS;4597039190;Ne;8;0;0;8
6524;Papartis;SAULUTĖS;8420752169;Ne;0;2;7;9
6525;Papartis;SAULUTĖS;6346776139;Ne;14;0;0;14
6526;Papartis;SAULUTĖS;1352401881;Ne;0;6;0;6
6527;Papartis;SAULUTĖS;3685642787;Ne;11;1;0;12
6528;Papartis;SAULUTĖS;6136213985;Ne;0;2;0;2
6529;Papartis;SAULUTĖS;7107692314;Ne;0;1;0;1
6530;Papartis;GANDRIUKAI;4878190663;Ne;5;0;0;5
6531;Papartis;GANDRIUKAI;9900023788;Ne;7;0;1;8
6532;Papartis;GANDRIUKAI;2783708905;Ne;5;0;0;5
6533;Papartis;GANDRIUKAI;6883101103;Ne;10;0;0;10
6534;Papartis;GANDRIUKAI;9384670351;Ne;0;0;3;3
6535;Papartis;GANDRIUKAI;9968072478;Ne;0;2;4;6
6536;Papartis;GANDRIUKAI;9704930584;Ne;2;16;0;18
6537;Papartis;GANDRIUKAI;9072635586;Ne;0;9;1;10
6538;Papartis;GANDRIUKAI;1442806517;Ne;4;0;0;4
6539;Papartis;GANDRIUKAI;7252265838;Ne;0;4;3;7
6540;Papartis;GANDRIUKAI;5883751305;Ne;0;1;0;1
6541;Papartis;GANDRIUKAI;4509843536;Ne;1;0;9;10
6542;Papartis;AITVARELIAI;6889782462;Taip;8;1;3;12
6543;Papartis;AITVARELIAI;5736456872;Ne;0;5;0;5
6544;Papartis;AITVARELIAI;3040269026;Ne;0;5;0;5
6545;Papartis;AITVARELIAI;8532558577;Ne;4;3;0;7
6546;Papartis;AITVARELIAI;4918854899;Ne;0;3;0;3
6547;Papartis;AITVARELIAI;5252947502;Ne;0;5;0;5
6548;Papartis;AITVARELIAI;1916222143;Ne;0;8;0;8
6549;Papartis;AITVARELIAI;7018190169;Ne;6;1;0;7
6550;Papartis;AITVARELIAI;7803854703;Ne;0;8;0;8
6551;Papartis;AITVARELIAI;4261270064;Ne;6;4;0;10
6552;Papartis;AITVARELIAI;6416605464;Ne;10;0;0;10
6553;Papartis;AITVARELIAI;1266338760;Ne;0;1;0;1
6554;Papartis;AITVARELIAI;7504793827;Ne;6;0;0;6
6555;Papartis;AITVARELIAI;7156767639;Ne;7;0;2;9
6556;Papartis;AITVARELIAI;5268226380;Ne;4;1;0;5
6557;Papartis;AITVARELIAI;2116140075;Ne;0;2;0;2
6558;Papartis;AITVARELIAI;3896803048;Ne;4;1;0;5
6559;Papartis;AITVARELIAI;4138926711;Ne;0;0;1;1
6560;Papartis;AITVARELIAI;8989172483;Ne;0;0;15;15
6561;Papartis;AITVARELIAI;9384475270;Ne;0;4;0;4
6562;Papartis;SMALSUČIAI;4969807705;Ne;0;1;0;1
6563;Papartis;SMALSUČIAI;5383936595;Ne;0;6;0;6
6564;Papartis;SMALSUČIAI;1698871014;Ne;0;2;0;2
6565;Papartis;SMALSUČIAI;6274608449;Ne;3;1;0;4
6566;Papartis;SMALSUČIAI;6664773988;Ne;0;6;1;7
6567;Papartis;SMALSUČIAI;8875490564;Ne;7;4;0;11
6568;Papartis;SMALSUČIAI;2921187615;Ne;0;8;0;8
6569;Papartis;SMALSUČIAI;4500675679;Ne;0;3;0;3
6570;Papartis;SMALSUČIAI;7203919287;Ne;0;6;0;6
6571;Papartis;SMALSUČIAI;1486770896;Ne;0;3;0;3
6572;Papartis;SMALSUČIAI;5132031416;Ne;11;2;0;13
6573;Papartis;SMALSUČIAI;3395306653;Ne;7;3;0;10
6574;Papartis;SMALSUČIAI;5964232886;Ne;0;0;4;4
6575;Papartis;SMALSUČIAI;7149853209;Ne;4;0;1;5
6576;Papartis;SMALSUČIAI;1616537800;Ne;0;8;0;8
6577;Papartis;"ŽIRNIUKAI ";8897061283;Ne;0;0;3;3
6578;Papartis;"ŽIRNIUKAI ";1073755384;Ne;0;0;7;7
6579;Papartis;"ŽIRNIUKAI ";7647225316;Ne;5;7;0;12
6580;Papartis;"ŽIRNIUKAI ";1210592579;Ne;0;4;2;6
6581;Papartis;"ŽIRNIUKAI ";1519815331;Ne;14;1;0;15
6582;Papartis;"ŽIRNIUKAI ";4158525314;Ne;5;0;1;6
6583;Papartis;"ŽIRNIUKAI ";4978398085;Ne;0;7;0;7
6584;Papartis;"ŽIRNIUKAI ";9746397380;Ne;3;0;3;6
6585;Papartis;"ŽIRNIUKAI ";4952279543;Ne;0;8;0;8
6586;Papartis;"ŽIRNIUKAI ";5276806556;Ne;1;0;0;1
6587;Papartis;"ŽIRNIUKAI ";2521609574;Ne;4;0;6;10
6588;Papartis;"ŽIRNIUKAI ";7617558492;Ne;0;0;15;15
6589;Papartis;"ŽIRNIUKAI ";2772758899;Ne;0;4;5;9
6590;Papartis;"ŽIRNIUKAI ";1183123161;Ne;7;0;0;7
6591;Papartis;"ŽIRNIUKAI ";1150772988;Ne;0;0;1;1
6592;Papartis;"ŽIRNIUKAI ";9518392031;Ne;4;0;0;4
6593;Papartis;"ŽIRNIUKAI ";6615368741;Ne;0;0;4;4
6594;Papartis;"ŽIRNIUKAI ";7108606229;Ne;5;0;0;5
6595;Papartis;"ŽIRNIUKAI ";8834463589;Ne;4;1;0;5
6596;Papartis;BORUŽĖLĖS;3576856223;Ne;6;3;0;9
6597;Papartis;BORUŽĖLĖS;7492923318;Ne;6;0;0;6
6598;Papartis;BORUŽĖLĖS;1157298413;Ne;0;4;0;4
6599;Papartis;BORUŽĖLĖS;2079105902;Ne;0;4;0;4
6600;Papartis;BORUŽĖLĖS;1159418157;Ne;0;1;0;1
6601;Papartis;BORUŽĖLĖS;3490370261;Ne;16;0;0;16
6602;Papartis;BORUŽĖLĖS;3107245976;Ne;8;3;0;11
6603;Papartis;BORUŽĖLĖS;1566259150;Ne;5;0;0;5
6604;Papartis;BORUŽĖLĖS;1381195839;Ne;0;2;1;3
6605;Papartis;BORUŽĖLĖS;6107558090;Ne;0;2;1;3
6606;Papartis;BORUŽĖLĖS;6776383676;Ne;0;16;0;16
6607;Papartis;BORUŽĖLĖS;9838432144;Ne;0;5;0;5
6608;Papartis;BORUŽĖLĖS;1511111597;Ne;10;2;0;12
6609;Papartis;BORUŽĖLĖS;8055310718;Ne;2;2;0;4
6610;Papartis;BORUŽĖLĖS;5259754395;Ne;0;8;0;8
6611;Papartis;BORUŽĖLĖS;5959006739;Ne;7;6;0;13
6612;Papartis;BORUŽĖLĖS;5660932637;Ne;5;1;0;6
6613;Papartis;VARPELIAI;7260304487;Ne;9;0;0;9
6614;Papartis;VARPELIAI;9581159294;Ne;0;4;3;7
6615;Papartis;VARPELIAI;6710049689;Ne;5;3;0;8
6616;Papartis;VARPELIAI;2777359899;Taip;5;6;0;11
6617;Papartis;VARPELIAI;1993893368;Ne;2;1;0;3
6618;Papartis;VARPELIAI;3345085436;Ne;0;3;1;4
6619;Papartis;VARPELIAI;7189999679;Ne;2;2;0;4
6620;Papartis;VARPELIAI;8443731277;Ne;9;0;0;9
6621;Papartis;VARPELIAI;3419374226;Ne;3;0;18;21
6622;Papartis;VARPELIAI;2600724041;Ne;8;1;0;9
6623;Papartis;VARPELIAI;2053568874;Ne;10;1;0;11
6624;Papartis;VARPELIAI;3173271837;Ne;0;1;0;1
6625;Papartis;VARPELIAI;4952700737;Ne;14;0;1;15
6626;Papartis;VARPELIAI;8642079824;Ne;14;0;0;14
6627;Papartis;VARPELIAI;2421158534;Ne;3;0;0;3
6628;Papartis;VARPELIAI;8872914372;Ne;7;5;0;12
6629;Papartis;NYKŠTUKAI;5942160584;Ne;5;0;0;5
6630;Papartis;NYKŠTUKAI;9922091482;Ne;0;2;0;2
6631;Papartis;NYKŠTUKAI;1680412204;Ne;0;0;1;1
6632;Papartis;NYKŠTUKAI;9285319899;Ne;0;0;2;2
6633;Papartis;NYKŠTUKAI;9502229005;Ne;0;5;0;5
6634;Papartis;NYKŠTUKAI;6794076631;Ne;0;4;0;4
6635;Papartis;NYKŠTUKAI;5608868738;Ne;0;6;0;6
6636;Papartis;NYKŠTUKAI;4203241118;Ne;3;5;2;10
6637;Papartis;NYKŠTUKAI;4806652727;Ne;0;4;1;5
6638;Papartis;NYKŠTUKAI;6423401656;Ne;0;1;0;1
6639;Papartis;NYKŠTUKAI;8932290803;Ne;2;2;0;4
6640;Papartis;NYKŠTUKAI;5652560002;Ne;10;0;1;11
6641;Papartis;NYKŠTUKAI;1559196767;Ne;11;0;3;14
6642;Papartis;NYKŠTUKAI;6360881137;Ne;0;1;0;1
6643;Papartis;NYKŠTUKAI;6941978169;Ne;0;7;0;7
6644;Pasaka;Drugelių;5665758011;Ne;0;4;0;4
6645;Pasaka;Drugelių;3092993659;Ne;0;3;0;3
6646;Pasaka;Drugelių;5027755073;Ne;0;2;0;2
6647;Pasaka;Drugelių;1300996831;Ne;0;6;0;6
6648;Pasaka;Drugelių;1313576071;Ne;0;5;0;5
6649;Pasaka;Drugelių;2621046003;Ne;0;2;0;2
6650;Pasaka;Drugelių;7040953491;Ne;0;4;0;4
6651;Pasaka;Drugelių;7455544922;Ne;0;1;0;1
6652;Pasaka;Drugelių;8963465320;Ne;0;4;0;4
6653;Pasaka;Drugelių;4743331873;Ne;10;7;4;21
6654;Pasaka;Drugelių;1583090840;Ne;5;6;1;12
6655;Pasaka;Drugelių;2774371800;Ne;5;5;2;12
6656;Pasaka;Drugelių;5547931812;Ne;5;2;0;7
6657;Pasaka;Drugelių;7685589423;Ne;0;1;0;1
6658;Pasaka;Drugelių;3088081091;Ne;0;0;3;3
6659;Pasaka;Drugelių;9060396476;Ne;0;3;0;3
6660;Pasaka;Drugelių;7078492847;Ne;5;6;0;11
6661;Pasaka;Nykštukų;7546205285;Ne;2;4;0;6
6662;Pasaka;Nykštukų;5687494160;Ne;0;4;0;4
6663;Pasaka;Nykštukų;3151916774;Ne;0;5;0;5
6664;Pasaka;Nykštukų;4773893970;Ne;5;4;0;9
6665;Pasaka;Nykštukų;4082752808;Ne;2;0;2;4
6666;Pasaka;Nykštukų;6788771605;Ne;0;5;0;5
6667;Pasaka;Nykštukų;5412931969;Ne;5;0;1;6
6668;Pasaka;Nykštukų;1813068555;Ne;0;8;0;8
6669;Pasaka;Nykštukų;9567521319;Ne;0;2;0;2
6670;Pasaka;Nykštukų;6326056771;Ne;0;4;0;4
6671;Pasaka;Nykštukų;4175157894;Ne;8;0;0;8
6672;Pasaka;Nykštukų;5768958388;Ne;5;0;4;9
6673;Pasaka;Nykštukų;2797217440;Ne;0;2;1;3
6674;Pasaka;Nykštukų;7292437626;Ne;0;5;0;5
6675;Pasaka;Montesori;16974081144;Ne;0;4;2;6
6676;Pasaka;Montesori;1514381003;Ne;0;4;0;4
6677;Pasaka;Montesori;5812041166;Ne;0;2;3;5
6678;Pasaka;Montesori;4305485747;Ne;0;0;1;1
6679;Pasaka;Montesori;3047931231;Ne;0;0;6;6
6680;Pasaka;Montesori;3195380938;Ne;0;0;1;1
6681;Pasaka;Montesori;5031538468;Ne;3;4;0;7
6682;Pasaka;Montesori;6625690696;Ne;15;4;0;19
6683;Pasaka;Montesori;4548601585;Ne;10;0;0;10
6684;Pasaka;Montesori;7887326763;Ne;0;0;1;1
6685;Pasaka;Montesori;9850592463;Ne;6;4;0;10
6686;Pasaka;Montesori;2995831258;Ne;0;0;3;3
6687;Pasaka;Montesori;6248810027;Ne;0;0;6;6
6688;Pasaka;Montesori;3620395122;Ne;0;0;1;1
6689;Pasaka;Montesori;5689164477;Ne;0;0;1;1
6690;Pasaka;Montesori;6484610418;Ne;0;0;2;2
6691;Pasaka;Žirniukų;3783869856;Ne;3;0;0;3
6692;Pasaka;Žirniukų;2815348652;Ne;0;0;3;3
6693;Pasaka;Žirniukų;5651025350;Ne;13;0;0;13
6694;Pasaka;Žirniukų;2422958320;Ne;1;4;2;7
6695;Pasaka;Žirniukų;9438006825;Ne;0;0;2;2
6696;Pasaka;Žirniukų;9136524816;Ne;5;0;1;6
6697;Pasaka;Žirniukų;9766432049;Ne;9;2;2;13
6698;Pasaka;Žirniukų;6387972576;Ne;4;0;0;4
6699;Pasaka;Žirniukų;4948174745;Ne;11;0;7;18
6700;Pasaka;Žirniukų;2144975281;Ne;2;0;1;3
6701;Pasaka;Žirniukų;4629119214;Ne;0;0;1;1
6702;Pasaka;Žirniukų;8519108324;Ne;12;4;1;17
6703;Pasaka;Žirniukų;9654507441;Ne;0;0;8;8
6704;Pasaka;Žirniukų;9654507441;Ne;0;0;8;8
6705;Pasaka;Žirniukų;9654507441;Ne;0;0;8;8
6706;Pasaka;Žirniukų;5921553817;Ne;0;0;8;8
6707;Pasaka;Žirniukų;2569560383;Ne;2;9;0;11
6708;Pasaka;"Voveriukų ";3606141216;Ne;0;9;0;9
6709;Pasaka;"Voveriukų ";5217688848;Ne;0;9;0;9
6710;Pasaka;"Voveriukų ";4171004263;Ne;5;4;0;9
6711;Pasaka;"Voveriukų ";8504575043;Ne;0;0;5;5
6712;Pasaka;"Voveriukų ";1488711275;Ne;0;0;1;1
6713;Pasaka;"Voveriukų ";2854919649;Ne;0;0;2;2
6714;Pasaka;"Voveriukų ";1950145441;Ne;10;0;0;10
6715;Pasaka;"Voveriukų ";4466963221;Ne;0;0;1;1
6716;Pasaka;"Voveriukų ";9588247759;Ne;0;0;8;8
6717;Pasaka;"Voveriukų ";4915357646;Ne;0;0;4;4
6718;Pasaka;"Voveriukų ";7176272684;Ne;5;9;0;14
6719;Pasaka;"Voveriukų ";9687385445;Ne;0;2;1;3
6720;Pasaka;"Voveriukų ";4799036184;Ne;0;0;8;8
6721;Pasaka;"Voveriukų ";6684234474;Ne;4;0;1;5
6722;Pasaka;"Voveriukų ";6925961600;Ne;3;0;0;3
6723;Pasaka;"Voveriukų ";8421404290;Ne;5;0;0;5
6724;Pasaka;"Voveriukų ";1745181416;Ne;1;0;13;14
6725;Pasaka;"Voveriukų ";9780490338;Ne;21;0;0;21
6726;Pasaka;"Voveriukų ";6315362421;Ne;5;5;0;10
6727;Pasaka;"Voveriukų ";6315362421;Ne;5;5;0;10
6728;Pasaka;"VALDOFRO 12";7010681103;Ne;0;3;1;4
6729;Pasaka;"VALDOFRO 12";56766427323;Ne;0;2;2;4
6730;Pasaka;"VALDOFRO 12";4680456848;Ne;3;0;0;3
6731;Pasaka;"VALDOFRO 12";5141156728;Ne;0;4;1;5
6732;Pasaka;"VALDOFRO 12";2268625523;Ne;11;0;0;11
6733;Pasaka;"VALDOFRO 12";8976424908;Ne;0;2;2;4
6734;Pasaka;"VALDOFRO 12";8701112181;Ne;6;0;1;7
6735;Pasaka;"VALDOFRO 12";1305541319;Ne;0;3;2;5
6736;Pasaka;"VALDOFRO 12";7682903999;Ne;4;0;0;4
6737;Pasaka;"VALDOFRO 12";4325198579;Ne;0;4;2;6
6738;Pasaka;"VALDOFRO 12";6448940090;Ne;0;4;1;5
6739;Pasaka;"VALDOFRO 12";8411025450;Ne;5;4;2;11
6740;Pasaka;"VALDOFRO 12";1756831961;Ne;0;1;0;1
6741;Pasaka;"VALDOFRO 12";3840053722;Ne;0;10;1;11
6742;Pasaka;"VALDOFRO 12";8995205555;Ne;0;4;0;4
6743;Pasaka;"VALDOFRO 12";4548945364;Ne;0;0;16;16
6744;Pasaka;"VALDOFRO 12";8912822936;Ne;0;6;0;6
6745;Pasaka;"VALDOFRO 12";4301573328;Ne;0;0;3;3
6746;Pasaka;"VALDOFRO 12";5244582148;Ne;10;0;0;10
6747;Pasaka;"VALDOFRO 12";2650797982;Ne;0;1;0;1
6748;Pasaka;"VALDOFRO 12";9065016148;Ne;0;0;3;3
6749;Pasaka;"VALDOFRO 12";9809498406;Ne;4;0;0;4
6750;Pasaka;"VALDOFRO 12";5040348350;Ne;10;0;3;13
6751;Pasaka;"VALDORFO 2";71365777764;Ne;0;1;0;1
6752;Pasaka;"VALDORFO 2";77904202630;Ne;0;4;0;4
6753;Pasaka;"VALDORFO 2";4752117533;Ne;8;1;0;9
6754;Pasaka;"VALDORFO 2";7950962252;Ne;0;4;4;8
6755;Pasaka;"VALDORFO 2";8590385693;Ne;0;0;1;1
6756;Pasaka;"VALDORFO 2";4620573687;Ne;0;4;0;4
6757;Pasaka;"VALDORFO 2";4825373152;Ne;0;3;1;4
6758;Pasaka;"VALDORFO 2";5399148997;Ne;0;4;0;4
6759;Pasaka;"VALDORFO 2";1799326151;Ne;3;0;1;4
6760;Pasaka;"VALDORFO 2";2273629510;Ne;3;0;1;4
6761;Pasaka;"VALDORFO 2";5903270845;Ne;5;4;1;10
6762;Pasaka;"VALDORFO 2";3778182691;Ne;0;4;0;4
6763;Pasaka;"VALDORFO 2";8947139321;Ne;0;2;0;2
6764;Pasaka;"VALDORFO 2";5742479853;Ne;0;1;1;2
6765;Pasaka;"VALDORFO 2";3049361712;Ne;2;1;3;6
6766;Pasaka;"VALDORFO 2";6497042042;Ne;5;0;3;8
6767;Pasaka;"VALDORFO 2";9821858308;Ne;6;0;6;12
6768;Pasaka;"VALDORFO 2";1648043715;Ne;8;0;1;9
6769;Pasaka;Gudručiai;6253266504;Ne;0;0;1;1
6770;Pasaka;Gudručiai;4137222204;Ne;6;0;1;7
6771;Pasaka;Gudručiai;7103485358;Ne;0;2;0;2
6772;Pasaka;Gudručiai;2400455036;Ne;0;4;0;4
6773;Pasaka;Gudručiai;9722435751;Ne;0;1;0;1
6774;Pasaka;Gudručiai;73703706115;Ne;0;4;1;5
6775;Pasaka;Gudručiai;79170702319;Ne;0;5;0;5
6776;Pasaka;Gudručiai;5965121999;Ne;0;0;2;2
6777;Pasaka;Gudručiai;7286419663;Ne;0;0;12;12
6778;Pasaka;Gudručiai;5973028582;Ne;0;3;5;8
6779;Pasaka;Gudručiai;2788679885;Ne;4;4;0;8
6780;Pasaka;Gudručiai;7445696309;Ne;0;3;1;4
6781;Pasaka;Gudručiai;1565873178;Ne;0;0;1;1
6782;Pasaka;Gudručiai;2697014098;Ne;0;4;0;4
6783;Pasaka;Gudručiai;5651452381;Ne;0;4;2;6
6784;Pasaka;Gudručiai;6441884677;Ne;0;4;3;7
6785;Pasaka;Gudručiai;2018620389;Ne;0;6;2;8
6786;Pasaka;Gudručiai;2671403814;Ne;0;0;3;3
6787;Pasaka;Gudručiai;42548487389;Ne;0;0;2;2
6788;Pasaka;Gudručiai;8448558788;Ne;6;4;2;12
6789;Pasaka;Bitelių;5351364328;Ne;0;0;17;17
6790;Pasaka;Bitelių;4635912654;Ne;0;0;17;17
6791;Pasaka;Bitelių;7248640367;Ne;9;0;0;9
6792;Pasaka;Bitelių;8277245475;Ne;0;5;7;12
6793;Pasaka;Bitelių;6868519179;Ne;0;3;0;3
6794;Pasaka;Bitelių;6759415053;Ne;0;3;0;3
6795;Pasaka;Bitelių;5723970763;Ne;0;4;0;4
6796;Pasaka;Bitelių;9136521759;Ne;0;6;2;8
6797;Pasaka;Bitelių;2638182985;Ne;0;4;2;6
6798;Pasaka;Bitelių;2293613528;Ne;0;3;0;3
6799;Pasaka;Bitelių;3367346582;Ne;0;7;0;7
6800;Pasaka;Bitelių;3351338617;Ne;0;1;0;1
6801;Pasaka;Bitelių;5371046207;Ne;3;9;0;12
6802;Pasaka;Bitelių;6139825302;Ne;5;2;0;7
6803;Pasaka;Bitelių;4970812899;Ne;0;0;1;1
6804;Pasaka;Bitelių;8873115041;Ne;0;0;1;1
6805;Pasaka;Bitelių;1720511696;Ne;14;0;0;14
6806;Pasaka;Bitelių;2963373430;Ne;0;0;5;5
6807;Pasaka;"Pabiručių ";4846146925;Ne;0;0;2;2
6808;Pasaka;"Pabiručių ";9770811826;Ne;0;0;1;1
6809;Pasaka;"Pabiručių ";9471447977;Ne;0;4;3;7
6810;Pasaka;"Pabiručių ";7751618911;Ne;9;1;0;10
6811;Pasaka;"Pabiručių ";7696383564;Ne;2;2;3;7
6812;Pasaka;"Pabiručių ";3796844193;Ne;4;0;0;4
6813;Pasaka;"Pabiručių ";7240424576;Ne;0;3;0;3
6814;Pasaka;"Pabiručių ";4910817298;Ne;2;0;1;3
6815;Pasaka;"Pabiručių ";7127138831;Ne;2;0;0;2
6816;Pasaka;"Pabiručių ";9813397639;Ne;2;0;0;2
6817;Pasaka;"Pabiručių ";4222952044;Ne;0;0;14;14
6818;Pasaka;"Pabiručių ";4994426702;Ne;13;0;0;13
6819;Pasaka;"Pabiručių ";8289010515;Ne;13;0;0;13
6820;Pasaka;"Pabiručių ";5111195289;Ne;16;0;0;16
6821;Pasaka;"Pabiručių ";6182223896;Ne;16;0;0;16
6822;Pasaka;"Pabiručių ";8558563996;Ne;19;0;0;19
6823;Pasaka;"Pabiručių ";3557547656;Ne;14;4;3;21
6824;Pasaka;Šnekučių;3709664132;Ne;4;1;0;5
6825;Pasaka;Šnekučių;1512874567;Ne;0;1;0;1
6826;Pasaka;Šnekučių;1793176485;Ne;0;6;1;7
6827;Pasaka;Šnekučių;4296539838;Taip;0;0;1;1
6828;Pasaka;Šnekučių;1590306118;Ne;0;3;0;3
6829;Pasaka;Šnekučių;6795580569;Ne;5;1;1;7
6830;Pasaka;Šnekučių;3240292756;Ne;8;0;0;8
6831;Pasaka;Šnekučių;4215568107;Ne;2;1;0;3
6832;Pasaka;Šnekučių;8365256755;Ne;0;4;0;4
6833;Pasaka;Šnekučių;4816441219;Ne;5;2;2;9
6834;Pasaka;Šnekučių;1795497567;Ne;6;2;0;8
6835;Pasaka;Šnekučių;8347051587;Ne;0;1;0;1
6836;Pasaka;Šnekučių;8841669113;Ne;0;4;5;9
6837;Pasaka;Šnekučių;4975045894;Ne;8;0;6;14
6838;Pasaka;Šnekučių;3588073618;Ne;6;0;1;7
6839;Pasaka;Šnekučių;1749821746;Ne;12;1;0;13
6840;Pasaka;Šnekučių;1723076060;Ne;0;4;0;4
6841;Pasaka;Šnekučių;8475365713;Ne;0;2;1;3
6842;Pasaka;"KIŠKUČIŲ (Žirmūnų g. 92)";7311929329;Ne;4;0;2;6
6843;Pasaka;"KIŠKUČIŲ (Žirmūnų g. 92)";2368681819;Ne;3;0;0;3
6844;Pasaka;"KIŠKUČIŲ (Žirmūnų g. 92)";5134067973;Ne;5;0;0;5
6845;Pasaka;"KIŠKUČIŲ (Žirmūnų g. 92)";2135527938;Ne;5;0;0;5
6846;Pasaka;"KIŠKUČIŲ (Žirmūnų g. 92)";5073970913;Ne;5;0;8;13
6847;Pasaka;"KIŠKUČIŲ (Žirmūnų g. 92)";5255764606;Ne;5;4;11;20
6848;Pasaka;"KIŠKUČIŲ (Žirmūnų g. 92)";6950137606;Ne;9;0;2;11
6849;Pasaka;"KIŠKUČIŲ (Žirmūnų g. 92)";2575986215;Ne;0;0;3;3
6850;Pasaka;"KIŠKUČIŲ (Žirmūnų g. 92)";4924664211;Ne;3;0;0;3
6851;Pasaka;"KIŠKUČIŲ (Žirmūnų g. 92)";5632714212;Ne;6;0;0;6
6852;Pasaka;"KIŠKUČIŲ (Žirmūnų g. 92)";4572517095;Ne;0;0;4;4
6853;Pasaka;"KIŠKUČIŲ (Žirmūnų g. 92)";9928518840;Ne;5;7;0;12
6854;Pasaka;"EŽIUKŲ (Žirmūnų g. 92)";9369336996;Ne;0;0;2;2
6855;Pasaka;"EŽIUKŲ (Žirmūnų g. 92)";8866484797;Ne;6;0;8;14
6856;Pasaka;"EŽIUKŲ (Žirmūnų g. 92)";3735117473;Ne;0;0;1;1
6857;Pasaka;"EŽIUKŲ (Žirmūnų g. 92)";6280303158;Ne;0;0;2;2
6858;Pasaka;"EŽIUKŲ (Žirmūnų g. 92)";9324220807;Ne;4;0;0;4
6859;Pasaka;"EŽIUKŲ (Žirmūnų g. 92)";5630598566;Ne;7;0;14;21
6860;Pasaka;"EŽIUKŲ (Žirmūnų g. 92)";1083785206;Ne;3;0;2;5
6861;Pasaka;"EŽIUKŲ (Žirmūnų g. 92)";3587648653;Ne;12;0;5;17
6862;Pasaka;"EŽIUKŲ (Žirmūnų g. 92)";6388657745;Ne;5;0;12;17
6863;Pasaka;"EŽIUKŲ (Žirmūnų g. 92)";8082395844;Ne;0;3;0;3
6864;Pasaka;"EŽIUKŲ (Žirmūnų g. 92)";9403892434;Ne;22;0;1;23
6865;Pasaka;"EŽIUKŲ (Žirmūnų g. 92)";6498432810;Ne;4;0;5;9
6866;Pasaka;"SAULUČIŲ (Žirmūnų g. 92)";1963481567;Ne;0;0;4;4
6867;Pasaka;"SAULUČIŲ (Žirmūnų g. 92)";8164697203;Ne;0;4;1;5
6868;Pasaka;"SAULUČIŲ (Žirmūnų g. 92)";6991062262;Ne;8;0;0;8
6869;Pasaka;"SAULUČIŲ (Žirmūnų g. 92)";1214817944;Ne;10;0;0;10
6870;Pasaka;"SAULUČIŲ (Žirmūnų g. 92)";2211744442;Ne;12;0;0;12
6871;Pasaka;"SAULUČIŲ (Žirmūnų g. 92)";5912306325;Ne;9;5;3;17
6872;Pasaka;"SAULUČIŲ (Žirmūnų g. 92)";6087447128;Ne;10;0;0;10
6873;Pasaka;"SAULUČIŲ (Žirmūnų g. 92)";3066438231;Ne;0;5;8;13
6874;Pasaka;"SAULUČIŲ (Žirmūnų g. 92)";3066438231;Ne;0;5;8;13
6875;Pasaka;"SAULUČIŲ (Žirmūnų g. 92)";3066438231;Ne;0;5;8;13
6876;Pasaka;"SAULUČIŲ (Žirmūnų g. 92)";6157459742;Ne;0;0;21;21
6877;Pasaka;"SAULUČIŲ (Žirmūnų g. 92)";3424189866;Ne;4;0;0;4
6878;Pasaka;"SAULUČIŲ (Žirmūnų g. 92)";5969883817;Ne;0;0;4;4
6879;Pasaka;"SAULUČIŲ (Žirmūnų g. 92)";6821289069;Ne;17;0;0;17
6880;Pasaka;"SAULUČIŲ (Žirmūnų g. 92)";5414186755;Ne;0;1;8;9
6881;Paslaptis;MONTIKI;4683384309;Ne;0;5;0;5
6882;Paslaptis;MONTIKI;9929877115;Ne;0;6;0;6
6883;Paslaptis;MONTIKI;6860366087;Ne;4;0;0;4
6884;Paslaptis;MONTIKI;3572102816;Ne;9;0;0;9
6885;Paslaptis;MONTIKI;2927014406;Ne;10;1;1;12
6886;Paslaptis;MONTIKI;8453213193;Ne;0;1;0;1
6887;Paslaptis;MONTIKI;7053452493;Ne;11;0;0;11
6888;Paslaptis;MONTIKI;8909545951;Ne;0;1;0;1
6889;Paslaptis;MONTIKI;3963816472;Ne;4;0;8;12
6890;Paslaptis;MONTIKI;5809630456;Ne;0;4;0;4
6891;Paslaptis;MONTIKI;6764142182;Ne;0;1;2;3
6892;Paslaptis;MONTIKI;9497654214;Ne;0;4;0;4
6893;Paslaptis;MONTIKI;1080710834;Ne;4;0;0;4
6894;Paslaptis;MONTIKI;5480407965;Ne;0;4;0;4
6895;Paslaptis;FRUTIKI;9100003209;Ne;16;0;0;16
6896;Paslaptis;FRUTIKI;4130010071;Ne;0;4;0;4
6897;Paslaptis;FRUTIKI;3984799090;Ne;5;1;0;6
6898;Paslaptis;FRUTIKI;5886364670;Ne;5;3;0;8
6899;Paslaptis;FRUTIKI;5406800599;Ne;16;0;0;16
6900;Paslaptis;FRUTIKI;2675089401;Ne;7;1;0;8
6901;Paslaptis;FRUTIKI;1557783684;Ne;5;6;0;11
6902;Paslaptis;FRUTIKI;5206529350;Ne;0;1;0;1
6903;Paslaptis;FRUTIKI;2105441745;Ne;12;1;1;14
6904;Paslaptis;FRUTIKI;6686352764;Ne;20;0;0;20
6905;Paslaptis;FRUTIKI;5456011928;Ne;0;5;0;5
6906;Paslaptis;FRUTIKI;8717111488;Ne;10;3;0;13
6907;Paslaptis;FRUTIKI;5756338103;Ne;0;1;0;1
6908;Paslaptis;FRUTIKI;5646806136;Ne;0;11;0;11
6909;Paslaptis;FRUTIKI;6513238386;Ne;0;0;1;1
6910;Paslaptis;FRUTIKI;4810686225;Ne;6;1;0;7
6911;Paslaptis;FRUTIKI;8296575784;Ne;0;5;0;5
6912;Paslaptis;FRUTIKI;1754621741;Ne;8;2;0;10
6913;Paslaptis;FRUTIKI;7638521198;Ne;4;4;0;8
6914;Paslaptis;KALAMBURIKI;1029321312;Ne;0;5;0;5
6915;Paslaptis;KALAMBURIKI;3093280943;Ne;11;1;0;12
6916;Paslaptis;KALAMBURIKI;2705751628;Ne;0;0;1;1
6917;Paslaptis;KALAMBURIKI;2879752620;Ne;0;9;0;9
6918;Paslaptis;KALAMBURIKI;8280740387;Ne;4;0;2;6
6919;Paslaptis;KALAMBURIKI;5852939221;Ne;0;4;0;4
6920;Paslaptis;KALAMBURIKI;2693910134;Ne;0;5;0;5
6921;Paslaptis;KALAMBURIKI;3104525540;Ne;6;1;4;11
6922;Paslaptis;KALAMBURIKI;1186681520;Ne;0;9;0;9
6923;Paslaptis;KALAMBURIKI;3415869190;Ne;5;7;0;12
6924;Paslaptis;KALAMBURIKI;1983773762;Ne;0;1;0;1
6925;Paslaptis;KALAMBURIKI;5557019619;Ne;0;1;0;1
6926;Paslaptis;KALAMBURIKI;3549998192;Ne;0;5;3;8
6927;Paslaptis;KALAMBURIKI;1782398974;Ne;0;5;0;5
6928;Paslaptis;KALAMBURIKI;8146824196;Ne;0;0;1;1
6929;Paslaptis;KALAMBURIKI;4109288950;Ne;5;0;0;5
6930;Paslaptis;KALAMBURIKI;3398729758;Ne;9;0;5;14
6931;Paslaptis;KALAMBURIKI;8083478190;Ne;0;0;6;6
6932;Paslaptis;KALAMBURIKI;2089780119;Ne;18;0;3;21
6933;Pasakaitė;Vieversėlių;7685647972;Ne;0;0;1;1
6934;Pasakaitė;Vieversėlių;6459145539;Ne;4;2;0;6
6935;Pasakaitė;Vieversėlių;2194313054;Ne;0;1;0;1
6936;Pasakaitė;Vieversėlių;9587489514;Ne;9;1;1;11
6937;Pasakaitė;Vieversėlių;3444442287;Ne;22;0;1;23
6938;Pasakaitė;Vieversėlių;5485965486;Ne;9;9;0;18
6939;Pasakaitė;Vieversėlių;2849753418;Ne;0;7;2;9
6940;Pasakaitė;Vieversėlių;7963057831;Ne;0;4;0;4
6941;Pasakaitė;Vieversėlių;9543991684;Ne;0;6;0;6
6942;Pasakaitė;Vieversėlių;3680596008;Ne;0;5;0;5
6943;Pasakaitė;Vieversėlių;4882856664;Ne;0;2;1;3
6944;Pasakaitė;Vieversėlių;5953162958;Ne;0;0;3;3
6945;Pasakaitė;Vieversėlių;5948958906;Ne;5;3;0;8
6946;Pasakaitė;Vieversėlių;1060914693;Ne;9;2;0;11
6947;Pasakaitė;Vieversėlių;7761162338;Ne;7;6;0;13
6948;Pasakaitė;Vieversėlių;8463220257;Ne;0;2;0;2
6949;Pasakaitė;Vieversėlių;9018830962;Ne;14;7;0;21
6950;Pasakaitė;Vieversėlių;6736879757;Ne;30;0;0;30
6951;Pasakaitė;Vieversėlių;4191875802;Ne;0;0;1;1
6952;Pasakaitė;Vieversėlių;5020801150;Ne;11;0;0;11
6953;Pasakaitė;Spindulėlių;1962693480;Ne;0;10;0;10
6954;Pasakaitė;Spindulėlių;4758073190;Ne;1;4;0;5
6955;Pasakaitė;Spindulėlių;6714500298;Ne;0;7;0;7
6956;Pasakaitė;Spindulėlių;1697755753;Ne;2;5;0;7
6957;Pasakaitė;Spindulėlių;1056358241;Ne;1;10;0;11
6958;Pasakaitė;Spindulėlių;8105641645;Ne;0;4;0;4
6959;Pasakaitė;Spindulėlių;5791927811;Ne;5;26;0;31
6960;Pasakaitė;Spindulėlių;5094404397;Ne;5;26;0;31
6961;Pasakaitė;Spindulėlių;9870015737;Ne;2;5;0;7
6962;Pasakaitė;Spindulėlių;1449037968;Ne;5;9;0;14
6963;Pasakaitė;Spindulėlių;7474100735;Ne;4;2;0;6
6964;Pasakaitė;Spindulėlių;6015360076;Ne;0;28;0;28
6965;Pasakaitė;Spindulėlių;2733800758;Ne;0;0;2;2
6966;Pasakaitė;Spindulėlių;6256000265;Ne;11;4;1;16
6967;Pasakaitė;Spindulėlių;2891089579;Ne;11;4;0;15
6968;Pasakaitė;Spindulėlių;3381303531;Ne;0;0;2;2
6969;Pasakaitė;Spindulėlių;3652896053;Ne;5;3;0;8
6970;Pasakaitė;Spindulėlių;7265623955;Ne;14;1;0;15
6971;Pasakaitė;Spindulėlių;1564611671;Ne;8;4;0;12
6972;Pasakaitė;Spindulėlių;3283593388;Ne;13;0;0;13
6973;Pasakaitė;Spindulėlių;2652882309;Ne;2;0;3;5
6974;Pasakaitė;Spindulėlių;4268438476;Ne;9;0;0;9
6975;Pasakaitė;Spindulėlių;2340908210;Ne;8;1;0;9
6976;Pasakaitė;Pasagėlių;2810892060;Ne;4;0;1;5
6977;Pasakaitė;Pasagėlių;9895144528;Ne;0;0;3;3
6978;Pasakaitė;Pasagėlių;9409907631;Ne;0;1;0;1
6979;Pasakaitė;Pasagėlių;5589440439;Ne;0;0;3;3
6980;Pasakaitė;Pasagėlių;5959875562;Ne;5;0;0;5
6981;Pasakaitė;Pasagėlių;3355268509;Ne;11;1;0;12
6982;Pasakaitė;Pasagėlių;1959599606;Ne;0;12;0;12
6983;Pasakaitė;Pasagėlių;7440327561;Ne;4;2;0;6
6984;Pasakaitė;Pasagėlių;6325408070;Ne;10;0;0;10
6985;Pasakaitė;Pasagėlių;9238905834;Ne;0;10;0;10
6986;Pasakaitė;Pasagėlių;7666033916;Ne;4;3;0;7
6987;Pasakaitė;Pasagėlių;5540251866;Ne;4;0;0;4
6988;Pasakaitė;Pasagėlių;7219080600;Ne;4;6;0;10
6989;Pasakaitė;Pasagėlių;2341175137;Ne;6;0;2;8
6990;Pasakaitė;Pasagėlių;8905681529;Ne;0;0;1;1
6991;Pasakaitė;Pasagėlių;8165055476;Ne;6;0;2;8
6992;Pasakaitė;Pasagėlių;7360801624;Ne;0;1;0;1
6993;Pasakaitė;Pasagėlių;5617173998;Ne;0;4;0;4
6994;Pasakaitė;Pasagėlių;5034077389;Ne;0;3;1;4
6995;Pasakaitė;Švyturėlių;7702359586;Ne;0;1;0;1
6996;Pasakaitė;Švyturėlių;2721048424;Ne;5;0;0;5
6997;Pasakaitė;Švyturėlių;6847782430;Ne;0;6;0;6
6998;Pasakaitė;Švyturėlių;4728731352;Ne;3;0;0;3
6999;Pasakaitė;Švyturėlių;9821617981;Ne;9;0;1;10
7000;Pasakaitė;Švyturėlių;1619513932;Ne;0;0;2;2
7001;Pasakaitė;Švyturėlių;1184513606;Ne;0;0;7;7
7002;Pasakaitė;Švyturėlių;4864779439;Ne;0;9;0;9
7003;Pasakaitė;Švyturėlių;8223662339;Ne;0;4;1;5
7004;Pasakaitė;Švyturėlių;3710143250;Ne;0;0;2;2
7005;Pasakaitė;Švyturėlių;2329827275;Ne;3;0;1;4
7006;Pasakaitė;Švyturėlių;2933474317;Ne;11;0;0;11
7007;Pasakaitė;Švyturėlių;5498393070;Ne;0;21;0;21
7008;Pasakaitė;Švyturėlių;9012098645;Ne;0;21;0;21
7009;Pasakaitė;Švyturėlių;4604843442;Ne;0;4;0;4
7010;Pasakaitė;Švyturėlių;3417077517;Ne;3;0;0;3
7011;Pasakaitė;Švyturėlių;1793453325;Ne;0;4;2;6
7012;Pasakaitė;Kodėlčiukų;8662488739;Ne;0;0;2;2
7013;Pasakaitė;Kodėlčiukų;9972985920;Ne;0;0;3;3
7014;Pasakaitė;Kodėlčiukų;5699688792;Ne;20;0;0;20
7015;Pasakaitė;Kodėlčiukų;9441990175;Ne;0;0;5;5
7016;Pasakaitė;Kodėlčiukų;4485053261;Ne;10;0;0;10
7017;Pasakaitė;Kodėlčiukų;9351971114;Ne;0;0;5;5
7018;Pasakaitė;Kodėlčiukų;2303884875;Ne;11;2;0;13
7019;Pasakaitė;Kodėlčiukų;4878562841;Ne;10;0;2;12
7020;Pasakaitė;Kodėlčiukų;2994653871;Ne;7;0;1;8
7021;Pasakaitė;Kodėlčiukų;4328440534;Ne;2;0;2;4
7022;Pasakaitė;Kodėlčiukų;4881361200;Ne;6;0;1;7
7023;Pasakaitė;Kodėlčiukų;2389832646;Ne;0;6;0;6
7024;Pasakaitė;Kodėlčiukų;7138417196;Ne;5;1;0;6
7025;Pasakaitė;Kodėlčiukų;5581264184;Ne;0;1;0;1
7026;Pasakaitė;Kodėlčiukų;8037316673;Ne;15;0;0;15
7027;Pasakaitė;Kodėlčiukų;5732009054;Ne;0;7;0;7
7028;Pasakaitė;Kodėlčiukų;2407824666;Ne;0;7;0;7
7029;Pasakaitė;Kodėlčiukų;6755983130;Ne;10;0;0;10
7030;Pasakaitė;Kodėlčiukų;2476010561;Ne;11;0;0;11
7031;Pasakaitė;Kodėlčiukų;3925034196;Ne;5;6;0;11
7032;Pasakaitė;Gudručių;6568538767;Ne;3;2;0;5
7033;Pasakaitė;Gudručių;5369558652;Ne;4;5;0;9
7034;Pasakaitė;Gudručių;1019010454;Ne;8;1;0;9
7035;Pasakaitė;Gudručių;4703375416;Ne;0;2;0;2
7036;Pasakaitė;Gudručių;1707428977;Ne;14;4;0;18
7037;Pasakaitė;Gudručių;9680682204;Ne;0;1;0;1
7038;Pasakaitė;Gudručių;3345955615;Ne;0;2;1;3
7039;Pasakaitė;Gudručių;1791015854;Ne;10;2;1;13
7040;Pasakaitė;Gudručių;67374677045;Ne;8;3;1;12
7041;Pasakaitė;Gudručių;4959175420;Ne;5;3;0;8
7042;Pasakaitė;Gudručių;6839399035;Ne;6;2;0;8
7043;Pasakaitė;Gudručių;3778906698;Ne;0;1;4;5
7044;Pasakaitė;Gudručių;1940545723;Ne;0;3;0;3
7045;Pasakaitė;Gudručių;1809383469;Ne;6;4;0;10
7046;Pasakaitė;Gudručių;1592521766;Ne;5;1;0;6
7047;Pasakaitė;Gudručių;4008826950;Ne;0;9;3;12
7048;Pasakaitė;Gudručių;9031690002;Ne;2;4;0;6
7049;Pasakaitė;Gudručių;2742595829;Ne;4;4;0;8
7050;Pasakaitė;Gudručių;1513903341;Ne;10;1;0;11
7051;Pasakaitė;Gudručių;3231283338;Ne;0;0;1;1
7052;Pasakaitė;Čiulbonėlių;4680949976;Ne;0;2;0;2
7053;Pasakaitė;Čiulbonėlių;7152349570;Ne;0;13;0;13
7054;Pasakaitė;Čiulbonėlių;1458338379;Ne;8;6;0;14
7055;Pasakaitė;Čiulbonėlių;7526264241;Ne;0;4;6;10
7056;Pasakaitė;Čiulbonėlių;3541877287;Ne;0;3;0;3
7057;Pasakaitė;Čiulbonėlių;4974486850;Ne;0;4;1;5
7058;Pasakaitė;Čiulbonėlių;7607522887;Ne;2;9;0;11
7059;Pasakaitė;Čiulbonėlių;3606601644;Ne;0;8;0;8
7060;Pasakaitė;Čiulbonėlių;5313360864;Ne;0;1;0;1
7061;Pasakaitė;Čiulbonėlių;3579498202;Ne;0;16;0;16
7062;Pasakaitė;Čiulbonėlių;1220619991;Ne;0;0;1;1
7063;Pasakaitė;Čiulbonėlių;7790937149;Ne;0;2;6;8
7064;Pasakaitė;Čiulbonėlių;3400305768;Ne;0;2;6;8
7065;Pasakaitė;Čiulbonėlių;3165658822;Ne;0;5;0;5
7066;Pasakaitė;Čiulbonėlių;4013900094;Ne;0;3;0;3
7067;Pasakaitė;Čiulbonėlių;5605619860;Ne;0;1;1;2
7068;Pasakaitė;Čiulbonėlių;61230317080;Ne;4;7;0;11
7069;Pasakaitė;Čiulbonėlių;8466086339;Ne;0;4;1;5
7070;Pasakaitė;Čiulbonėlių;5467179333;Ne;0;4;0;4
7071;Pasakaitė;Čiulbonėlių;1740419218;Ne;0;13;0;13
7072;Pasakaitė;Čiulbonėlių;8469043564;Ne;0;1;2;3
7073;Pasakaitė;"Verpstelių ";7621306769;Ne;0;9;0;9
7074;Pasakaitė;"Verpstelių ";4946855684;Ne;0;7;0;7
7075;Pasakaitė;"Verpstelių ";5556362727;Ne;0;0;5;5
7076;Pasakaitė;"Verpstelių ";7759051761;Ne;5;3;0;8
7077;Pasakaitė;"Verpstelių ";8315840473;Ne;0;0;2;2
7078;Pasakaitė;"Verpstelių ";1744216870;Ne;0;1;0;1
7079;Pasakaitė;"Verpstelių ";1425166722;Ne;0;6;0;6
7080;Pasakaitė;"Verpstelių ";7813221735;Ne;0;8;0;8
7081;Pasakaitė;"Verpstelių ";9166649594;Ne;0;1;0;1
7082;Pasakaitė;"Verpstelių ";4246461594;Ne;8;0;4;12
7083;Pasakaitė;"Verpstelių ";1963102227;Ne;0;4;1;5
7084;Pasakaitė;"Verpstelių ";8267725352;Ne;0;0;1;1
7085;Pasakaitė;"Verpstelių ";8562284745;Ne;12;6;0;18
7086;Pasakaitė;"Verpstelių ";1041405418;Ne;0;11;0;11
7087;Pasakaitė;"Verpstelių ";7976921380;Ne;0;1;0;1
7088;Pasakaitė;"Verpstelių ";2505815026;Ne;14;0;0;14
7089;Pasakaitė;"Verpstelių ";5413457806;Ne;5;1;0;6
7090;Pasakaitė;"Verpstelių ";2714905466;Ne;6;0;1;7
7091;Pasakaitė;"Verpstelių ";9226989209;Ne;0;3;0;3
7092;Pasakaitė;"Verpstelių ";8927014508;Ne;0;0;6;6
7093;Pasakaitė;Smalsučiai;7539851375;Ne;10;0;0;10
7094;Pasakaitė;Smalsučiai;9114337491;Ne;0;4;0;4
7095;Pasakaitė;Smalsučiai;2278658674;Ne;10;4;2;16
7096;Pasakaitė;Smalsučiai;7557414266;Ne;0;4;0;4
7097;Pasakaitė;Smalsučiai;6522727154;Ne;14;0;0;14
7098;Pasakaitė;Smalsučiai;1122248122;Ne;0;9;5;14
7099;Pasakaitė;Smalsučiai;9982451343;Ne;4;0;6;10
7100;Pasakaitė;Smalsučiai;4977052991;Ne;4;3;0;7
7101;Pasakaitė;Smalsučiai;7604996145;Ne;16;0;0;16
7102;Pasakaitė;Smalsučiai;4144569088;Ne;3;0;1;4
7103;Pasakaitė;Smalsučiai;4307883488;Ne;6;0;7;13
7104;Pasakaitė;Smalsučiai;7994712153;Ne;5;0;5;10
7105;Pasakaitė;"Čiauškučiai ";7399335037;Ne;5;0;0;5
7106;Pasakaitė;"Čiauškučiai ";4098119950;Ne;0;1;0;1
7107;Pasakaitė;"Čiauškučiai ";9512782063;Ne;0;7;0;7
7108;Pasakaitė;"Čiauškučiai ";6229020982;Ne;0;9;1;10
7109;Pasakaitė;"Čiauškučiai ";5279719152;Ne;10;4;0;14
7110;Pasakaitė;"Čiauškučiai ";6160327808;Ne;6;0;0;6
7111;Pasakaitė;"Čiauškučiai ";1705913604;Ne;6;0;0;6
7112;Pasakaitė;"Čiauškučiai ";4898974534;Ne;2;0;0;2
7113;Pasakaitė;"Čiauškučiai ";3691817711;Ne;13;3;0;16
7114;Pasakaitė;"Čiauškučiai ";7885958426;Ne;2;0;1;3
7115;Pasakaitė;"Čiauškučiai ";2902368705;Ne;0;16;0;16
7116;Pasakaitė;"Čiauškučiai ";2041179927;Ne;8;0;0;8
7117;Pasakaitė;"Čiauškučiai ";6745120294;Ne;0;1;0;1
7118;Pasakaitė;"Čiauškučiai ";4120765793;Ne;0;5;0;5
7119;Pasakaitė;Pabiručiai;5180059311;Ne;0;5;0;5
7120;Pasakaitė;Pabiručiai;5162170061;Ne;4;0;0;4
7121;Pasakaitė;Pabiručiai;8478538959;Ne;0;0;5;5
7122;Pasakaitė;Pabiručiai;6795204239;Ne;0;0;3;3
7123;Pasakaitė;Pabiručiai;5058070480;Ne;11;0;0;11
7124;Pasakaitė;Pabiručiai;1453976284;Ne;9;9;2;20
7125;Pasakaitė;Pabiručiai;8559244062;Ne;6;0;0;6
7126;Pasakaitė;Pabiručiai;9790988677;Ne;14;0;0;14
7127;Pasakaitė;Pabiručiai;5439936572;Ne;4;6;1;11
7128;Pasakaitė;Pabiručiai;4316883215;Ne;0;1;0;1
7129;Pasakaitė;Pabiručiai;6682010485;Ne;6;0;0;6
7130;Pasakaitė;Pabiručiai;3466308130;Ne;5;0;2;7
7131;Pasakaitė;Pabiručiai;9402238675;Ne;12;0;1;13
7132;Pasakaitė;Pabiručiai;9311649698;Ne;6;2;0;8
7133;Pasakaitė;Pabiručiai;5499373802;Ne;6;0;4;10
7134;Pasakaitė;Linksmučiai;7965916747;Ne;11;0;0;11
7135;Pasakaitė;Linksmučiai;1279728451;Ne;7;0;1;8
7136;Pasakaitė;Linksmučiai;2584717150;Ne;6;0;4;10
7137;Pasakaitė;Linksmučiai;4397797616;Ne;11;0;1;12
7138;Pasakaitė;Linksmučiai;4659277297;Ne;8;0;1;9
7139;Pasakaitė;Linksmučiai;8381083251;Ne;5;0;1;6
7140;Pasakaitė;Linksmučiai;8252123824;Ne;6;0;0;6
7141;Pasakaitė;Linksmučiai;4444725869;Ne;3;0;2;5
7142;Pasakaitė;Linksmučiai;2801785334;Ne;10;0;0;10
7143;Pasakaitė;Linksmučiai;9606533767;Ne;6;5;3;14
7144;Pasakaitė;Linksmučiai;2899659479;Ne;2;0;0;2
7145;Pasakaitė;Linksmučiai;8160163060;Ne;9;0;1;10
7146;Pasakaitė;Linksmučiai;8350808883;Ne;0;0;5;5
7147;Pasakaitė;Linksmučiai;5745073940;Ne;0;4;4;8
7148;Pelenė;Varpelis;2647876561;Ne;7;1;0;8
7149;Pelenė;Varpelis;8807342148;Ne;14;4;0;18
7150;Pelenė;Varpelis;5697826755;Ne;0;0;1;1
7151;Pelenė;Varpelis;8239650471;Ne;0;0;1;1
7152;Pelenė;Varpelis;4004975235;Ne;9;0;0;9
7153;Pelenė;Varpelis;8790613872;Ne;9;0;0;9
7154;Pelenė;Varpelis;2487632125;Ne;1;0;10;11
7155;Pelenė;Varpelis;5228983908;Ne;5;0;1;6
7156;Pelenė;Varpelis;3174009848;Ne;0;0;2;2
7157;Pelenė;Varpelis;6524101295;Ne;10;4;1;15
7158;Pelenė;Varpelis;4373886054;Ne;6;1;1;8
7159;Pelenė;Varpelis;8038559319;Ne;10;0;0;10
7160;Pelenė;Varpelis;7578318198;Ne;0;15;0;15
7161;Pelenė;Varpelis;7164790060;Ne;0;3;4;7
7162;Pelenė;Varpelis;1080017906;Ne;0;0;1;1
7163;Pelenė;Varpelis;4777496709;Ne;0;0;2;2
7164;Pelenė;Varpelis;9447223913;Ne;11;0;11;22
7165;Pelenė;Varpelis;6894978459;Ne;11;8;0;19
7166;Pelenė;Varpelis;2103177773;Ne;0;0;1;1
7167;Pelenė;Varpelis;6864263698;Ne;18;0;9;27
7168;Pelenė;Varpelis;4521556853;Ne;0;0;1;1
7169;Pelenė;Saulutės;7880284433;Ne;2;8;3;13
7170;Pelenė;Saulutės;1468658102;Ne;0;0;31;31
7171;Pelenė;Saulutės;5389865440;Ne;3;5;2;10
7172;Pelenė;Saulutės;6191899254;Ne;4;0;3;7
7173;Pelenė;Saulutės;6481466282;Ne;0;0;4;4
7174;Pelenė;Saulutės;6707167720;Ne;0;3;0;3
7175;Pelenė;Saulutės;8466974910;Ne;5;11;0;16
7176;Pelenė;Saulutės;2393964666;Ne;0;6;0;6
7177;Pelenė;Saulutės;5780697554;Ne;0;3;0;3
7178;Pelenė;Saulutės;4989239822;Ne;0;10;1;11
7179;Pelenė;Saulutės;6221703608;Ne;0;0;3;3
7180;Pelenė;Saulutės;1278011268;Ne;3;0;0;3
7181;Pelenė;Saulutės;2426412323;Ne;0;3;1;4
7182;Pelenė;Saulutės;6267178572;Ne;0;10;0;10
7183;Pelenė;Raktelis;9195113444;Ne;9;10;0;19
7184;Pelenė;Raktelis;9075193730;Ne;8;0;0;8
7185;Pelenė;Raktelis;4591637887;Ne;0;12;0;12
7186;Pelenė;Raktelis;7088493729;Ne;19;0;1;20
7187;Pelenė;Raktelis;4090532624;Ne;9;9;0;18
7188;Pelenė;Raktelis;8123162647;Ne;0;5;0;5
7189;Pelenė;Raktelis;3573543545;Ne;0;8;0;8
7190;Pelenė;Raktelis;7659625628;Ne;0;0;6;6
7191;Pelenė;Raktelis;6375060159;Ne;9;9;0;18
7192;Pelenė;Raktelis;2210314952;Ne;6;1;0;7
7193;Pelenė;Raktelis;6419661741;Ne;11;5;0;16
7194;Pelenė;Raktelis;4089199552;Ne;19;0;2;21
7195;Pelenė;Raktelis;6038229659;Ne;0;4;8;12
7196;Pelenė;Raktelis;5749399210;Ne;19;0;1;20
7197;Pelenė;Raktelis;4448592497;Ne;6;0;0;6
7198;Pelenė;Raktelis;5333802902;Ne;3;12;0;15
7199;Pelenė;Raktelis;2241816838;Ne;10;0;1;11
7200;Pelenė;Raktelis;5063098703;Ne;5;0;3;8
7201;Pelenė;Raktelis;6007163187;Ne;18;0;0;18
7202;Pelenė;Žvaigždutės;9473901831;Ne;8;0;0;8
7203;Pelenė;Žvaigždutės;2476080951;Ne;0;0;1;1
7204;Pelenė;Žvaigždutės;5587759166;Ne;0;0;2;2
7205;Pelenė;Žvaigždutės;5548367924;Ne;5;0;8;13
7206;Pelenė;Žvaigždutės;5031778158;Ne;0;10;0;10
7207;Pelenė;Žvaigždutės;4056676361;Ne;0;0;7;7
7208;Pelenė;Žvaigždutės;4602503400;Ne;0;0;1;1
7209;Pelenė;Žvaigždutės;2555464779;Ne;3;5;0;8
7210;Pelenė;Žvaigždutės;9530531472;Ne;7;12;0;19
7211;Pelenė;Žvaigždutės;2040256240;Ne;7;0;0;7
7212;Pelenė;Žvaigždutės;4870187198;Ne;0;7;0;7
7213;Pelenė;Žvaigždutės;7640768043;Ne;27;0;0;27
7214;Pelenė;Žvaigždutės;7614130590;Ne;12;3;0;15
7215;Pelenė;Žvaigždutės;4856039707;Ne;0;4;0;4
7216;Pelenė;Žvaigždutės;5894429453;Ne;9;0;1;10
7217;Pelenė;Žvaigždutės;4737217659;Ne;0;0;4;4
7218;Pelenė;Žvaigždutės;4109516555;Ne;5;9;0;14
7219;Pelenė;Žvaigždutės;5357701072;Ne;0;0;31;31
7220;Pelenė;Nykštukas;4541391191;Ne;8;3;3;14
7221;Pelenė;Nykštukas;9584503078;Ne;3;2;6;11
7222;Pelenė;Nykštukas;8770771520;Ne;0;5;3;8
7223;Pelenė;Nykštukas;10457480694;Ne;0;4;9;13
7224;Pelenė;Nykštukas;7254981715;Ne;6;10;0;16
7225;Pelenė;Nykštukas;6579504852;Ne;0;14;4;18
7226;Pelenė;Nykštukas;6021833025;Ne;0;10;0;10
7227;Pelenė;Nykštukas;1978481168;Ne;0;10;0;10
7228;Pelenė;Nykštukas;3596386480;Ne;10;5;0;15
7229;Pelenė;Nykštukas;3385568839;Ne;3;4;0;7
7230;Pelenė;Nykštukas;3189305906;Ne;0;12;0;12
7231;Pelenė;Nykštukas;1750366978;Ne;13;1;0;14
7232;Pelenė;Nykštukas;2092775878;Ne;0;17;0;17
7233;Pelenė;Nykštukas;8675348688;Ne;7;4;0;11
7234;Pelenė;Nykštukas;1142014148;Ne;2;3;4;9
7235;Pelenė;Nykštukas;1605794833;Ne;0;7;0;7
7236;Pelenė;Nykštukas;9063588699;Ne;0;13;0;13
7237;Pelenė;Nykštukas;9621197758;Ne;0;10;0;10
7238;Pelenė;Nykštukas;3296147024;Ne;0;13;0;13
7239;Pelenė;Žirniukai;8529178313;Ne;10;5;3;18
7240;Pelenė;Žirniukai;6046921077;Ne;0;0;1;1
7241;Pelenė;Žirniukai;9601582419;Ne;4;0;0;4
7242;Pelenė;Žirniukai;7057752202;Ne;5;4;1;10
7243;Pelenė;Žirniukai;7399112026;Ne;0;17;3;20
7244;Pelenė;Žirniukai;2443906444;Ne;4;0;0;4
7245;Pelenė;Žirniukai;5922348478;Ne;15;0;0;15
7246;Pelenė;Žirniukai;1313425695;Ne;4;4;0;8
7247;Pelenė;Žirniukai;5211115955;Ne;0;0;13;13
7248;Pelenė;Žirniukai;1595627222;Ne;0;13;0;13
7249;Pelenė;Žirniukai;2438266396;Ne;0;10;0;10
7250;Pelenė;Žirniukai;2590035984;Ne;0;1;0;1
7251;Pelenė;Žirniukai;5686182866;Ne;6;0;1;7
7252;Pelenė;Žirniukai;7383544475;Ne;0;18;0;18
7253;Pelenė;Žirniukai;6661371876;Ne;4;0;0;4
7254;Pelenė;Žirniukai;2270989478;Ne;0;29;0;29
7255;Pelenė;Žirniukai;7959433937;Ne;5;0;3;8
7256;Pelenė;Žirniukai;4703442187;Ne;3;0;3;6
7257;Pelenė;Lašeliai;7017031073;Ne;4;0;0;4
7258;Pelenė;Lašeliai;9018211726;Ne;0;0;3;3
7259;Pelenė;Lašeliai;9313153383;Ne;0;20;0;20
7260;Pelenė;Lašeliai;5836118223;Ne;14;0;0;14
7261;Pelenė;Lašeliai;6316640679;Ne;3;0;2;5
7262;Pelenė;Lašeliai;1711603372;Ne;31;0;0;31
7263;Pelenė;Lašeliai;1944933777;Ne;0;22;0;22
7264;Pelenė;Lašeliai;2303618074;Ne;5;0;8;13
7265;Pelenė;Lašeliai;6167965418;Ne;7;0;1;8
7266;Pelenė;Lašeliai;2765650058;Ne;0;3;0;3
7267;Pelenė;Lašeliai;4431474395;Ne;0;6;0;6
7268;Pelenė;Lašeliai;9097123374;Ne;5;6;0;11
7269;Pelenė;Lašeliai;9162252512;Ne;0;0;10;10
7270;Pelenė;Lašeliai;4695104609;Ne;15;1;0;16
7271;Pelenė;Lašeliai;7148956863;Ne;11;3;0;14
7272;Pelenė;Lašeliai;3663288138;Ne;0;0;2;2
7273;Pelenė;Lašeliai;4148108151;Ne;0;10;0;10
7274;Pelenė;Lašeliai;1303066945;Ne;9;5;0;14
7275;Pelenė;Lašeliai;3563882751;Ne;0;19;0;19
7276;Pelenė;Grūdelis;4624325473;Ne;0;17;0;17
7277;Pelenė;Grūdelis;1868951268;Ne;0;11;0;11
7278;Pelenė;Grūdelis;1902314385;Ne;0;4;0;4
7279;Pelenė;Grūdelis;1140030742;Ne;0;10;1;11
7280;Pelenė;Grūdelis;1336431888;Ne;0;4;6;10
7281;Pelenė;Grūdelis;6632188229;Ne;5;12;1;18
7282;Pelenė;Grūdelis;5356756237;Ne;0;4;5;9
7283;Pelenė;Grūdelis;39705461573;Ne;0;6;1;7
7284;Pelenė;Grūdelis;1781704945;Ne;0;4;0;4
7285;Pelenė;Grūdelis;2154553741;Ne;0;8;0;8
7286;Pelenė;Grūdelis;3497915398;Ne;0;4;0;4
7287;Pelenė;Grūdelis;8598498275;Ne;0;13;0;13
7288;Pelenė;Grūdelis;8404317146;Ne;0;4;1;5
7289;Pelenė;Grūdelis;4307283949;Ne;0;4;12;16
7290;Pelenė;Grūdelis;1710249888;Ne;0;2;3;5
7291;Pelenė;Grūdelis;5325176433;Ne;5;9;1;15
7292;Pelenė;Grūdelis;1114786936;Ne;0;4;1;5
7293;Pelenė;Grūdelis;1245955282;Ne;0;14;0;14
7294;Pelenė;Grūdelis;6790396551;Ne;6;0;0;6
7295;Pelenė;Braškytė;7602432318;Ne;0;10;0;10
7296;Pelenė;Braškytė;2689903631;Ne;0;19;0;19
7297;Pelenė;Braškytė;4982869687;Ne;7;0;4;11
7298;Pelenė;Braškytė;3499827987;Ne;7;0;0;7
7299;Pelenė;Braškytė;8165766331;Ne;12;0;0;12
7300;Pelenė;Braškytė;1384382692;Ne;15;1;0;16
7301;Pelenė;Braškytė;4734502322;Ne;23;0;1;24
7302;Pelenė;Braškytė;8504675439;Ne;0;18;0;18
7303;Pelenė;Braškytė;2407328091;Ne;0;5;0;5
7304;Pelenė;Braškytė;8861981715;Ne;4;0;3;7
7305;Pelenė;Braškytė;6306403720;Ne;26;2;0;28
7306;Pelenė;Braškytė;9490816122;Ne;11;0;2;13
7307;Pelenė;Braškytė;2096373376;Ne;7;11;0;18
7308;Pelenė;Boružėlės;9639135363;Ne;4;0;0;4
7309;Pelenė;Boružėlės;4961852594;Ne;7;0;0;7
7310;Pelenė;Boružėlės;1975574464;Ne;18;0;0;18
7311;Pelenė;Boružėlės;3549088727;Ne;9;0;1;10
7312;Pelenė;Boružėlės;5024793693;Ne;5;0;0;5
7313;Pelenė;Boružėlės;6567413229;Ne;9;0;1;10
7314;Pelenė;Boružėlės;6231387335;Ne;0;27;0;27
7315;Pelenė;Boružėlės;3700618977;Ne;9;0;0;9
7316;Pelenė;Boružėlės;5872711862;Ne;5;1;3;9
7317;Pelenė;Boružėlės;6081335781;Ne;5;8;0;13
7318;Pelenė;Boružėlės;3060502977;Ne;0;0;2;2
7319;Pelenė;Boružėlės;2083848693;Ne;10;0;0;10
7320;Pelenė;Boružėlės;1268615831;Ne;0;0;5;5
7321;Pelenė;Boružėlės;4396011355;Ne;0;0;1;1
7322;Pelenė;Boružėlės;6304818782;Ne;0;1;0;1
7323;Pelenė;Boružėlės;8718308575;Ne;0;28;0;28
7324;Pelenė;Boružėlės;6867256280;Ne;0;0;7;7
7325;Pelenė;Boružėlės;7341814322;Ne;5;0;0;5
7326;Pelenė;Saldainiukai;5028095861;Ne;7;0;2;9
7327;Pelenė;Saldainiukai;9505945890;Ne;13;0;2;15
7328;Pelenė;Saldainiukai;8202196292;Ne;4;0;6;10
7329;Pelenė;Saldainiukai;5066227318;Ne;9;0;0;9
7330;Pelenė;Saldainiukai;7926586349;Ne;12;0;1;13
7331;Pelenė;Saldainiukai;4305733824;Ne;5;0;1;6
7332;Pelenė;Saldainiukai;2986690431;Ne;16;0;6;22
7333;Pelenė;Saldainiukai;4051874126;Ne;0;4;0;4
7334;Pelenė;Saldainiukai;4660385383;Ne;10;0;0;10
7335;Pelenė;Saldainiukai;8862429244;Ne;11;0;4;15
7336;Pelenė;Saldainiukai;9969975097;Ne;5;0;5;10
7337;Pelenė;Saldainiukai;5762403752;Ne;0;5;0;5
7338;Pelenė;Saldainiukai;5926700157;Ne;8;0;0;8
7339;Pelenė;Saldainiukai;2882716674;Ne;0;0;7;7
7340;Pelenė;Saldainiukai;4859437855;Ne;17;0;4;21
7341;Pelenė;Saldainiukai;4023923887;Ne;0;0;12;12
7342;Pelenė;Drugeliai;2540405047;Ne;0;0;10;10
7343;Pelenė;Drugeliai;3603352172;Ne;7;0;4;11
7344;Pelenė;Drugeliai;5084452088;Ne;0;6;0;6
7345;Pelenė;Drugeliai;2628676128;Ne;0;0;3;3
7346;Pelenė;Drugeliai;6834792589;Ne;0;1;2;3
7347;Pelenė;Drugeliai;9810123679;Ne;0;2;0;2
7348;Pelenė;Drugeliai;1048899958;Ne;0;0;1;1
7349;Pelenė;Drugeliai;3327213856;Ne;0;5;0;5
7350;Pelenė;Drugeliai;6252972353;Ne;0;0;6;6
7351;Pelenė;Drugeliai;1584256570;Ne;0;0;1;1
7352;Pelenė;Drugeliai;3205331614;Ne;0;0;1;1
7353;Pelenė;Drugeliai;5631629419;Ne;0;9;0;9
7354;Pelenė;Drugeliai;2163737781;Ne;0;20;0;20
7355;Pelenė;Drugeliai;9004080625;Ne;2;0;15;17
7356;Pelenė;Drugeliai;7565331966;Ne;0;17;0;17
7357;Pelenė;Drugeliai;5074054534;Ne;0;4;0;4
7358;Pelenė;Drugeliai;8194354176;Ne;0;0;3;3
7359;Pelenė;Drugeliai;5579900958;Ne;4;0;1;5
7360;Pipiras;EŽIUKAI;1876870081;Ne;6;4;0;10
7361;Pipiras;EŽIUKAI;9275905384;Ne;6;1;0;7
7362;Pipiras;EŽIUKAI;41585818819;Ne;0;12;0;12
7363;Pipiras;EŽIUKAI;6153579332;Ne;9;0;0;9
7364;Pipiras;EŽIUKAI;1391958633;Ne;16;1;0;17
7365;Pipiras;EŽIUKAI;5637557921;Ne;0;1;0;1
7366;Pipiras;EŽIUKAI;7799786844;Ne;0;7;0;7
7367;Pipiras;EŽIUKAI;5014457985;Ne;6;4;0;10
7368;Pipiras;EŽIUKAI;1050430252;Ne;0;5;0;5
7369;Pipiras;EŽIUKAI;4927845000;Ne;5;0;0;5
7370;Pipiras;EŽIUKAI;1904376366;Ne;0;3;0;3
7371;Pipiras;EŽIUKAI;3008358842;Ne;0;7;0;7
7372;Pipiras;EŽIUKAI;2024777430;Ne;6;2;0;8
7373;Pipiras;EŽIUKAI;2402351134;Ne;7;3;0;10
7374;Pipiras;EŽIUKAI;2255644686;Ne;0;4;7;11
7375;Pipiras;EŽIUKAI;7736031786;Ne;0;7;0;7
7376;Pipiras;EŽIUKAI;4959823035;Ne;0;2;0;2
7377;Pipiras;EŽIUKAI;1128674099;Ne;0;16;0;16
7378;Pipiras;EŽIUKAI;6339186940;Ne;0;4;0;4
7379;Pipiras;EŽIUKAI;3422170541;Ne;0;2;0;2
7380;Pipiras;EŽIUKAI;3314276870;Ne;0;3;0;3
7381;Pipiras;EŽIUKAI;7784343130;Ne;0;4;0;4
7382;Pipiras;BITUTĖS;3851239592;Ne;5;6;0;11
7383;Pipiras;BITUTĖS;1645482584;Ne;5;0;0;5
7384;Pipiras;BITUTĖS;7891664385;Ne;0;12;0;12
7385;Pipiras;BITUTĖS;9050423801;Ne;0;3;0;3
7386;Pipiras;BITUTĖS;3794537946;Ne;2;0;0;2
7387;Pipiras;BITUTĖS;5047070127;Ne;13;0;6;19
7388;Pipiras;BITUTĖS;2645772675;Ne;10;0;0;10
7389;Pipiras;BITUTĖS;9394456452;Ne;18;0;0;18
7390;Pipiras;BITUTĖS;9610070604;Ne;0;8;0;8
7391;Pipiras;BITUTĖS;7009194986;Ne;5;0;3;8
7392;Pipiras;BITUTĖS;6362968454;Ne;3;2;0;5
7393;Pipiras;BITUTĖS;6273958740;Ne;2;0;0;2
7394;Pipiras;BITUTĖS;2887703782;Ne;0;10;0;10
7395;Pipiras;BITUTĖS;9950318827;Ne;0;3;0;3
7396;Pipiras;BITUTĖS;9733577233;Ne;0;0;3;3
7397;Pipiras;NYKŠTUKAI;6696824728;Ne;9;3;0;12
7398;Pipiras;NYKŠTUKAI;2016718354;Ne;0;3;0;3
7399;Pipiras;NYKŠTUKAI;1169481984;Ne;6;5;2;13
7400;Pipiras;NYKŠTUKAI;4198534687;Ne;0;1;0;1
7401;Pipiras;NYKŠTUKAI;4458730479;Ne;2;6;1;9
7402;Pipiras;NYKŠTUKAI;4510888337;Ne;3;8;0;11
7403;Pipiras;NYKŠTUKAI;3980950261;Ne;0;4;0;4
7404;Pipiras;NYKŠTUKAI;7828638329;Ne;0;2;0;2
7405;Pipiras;NYKŠTUKAI;6775489564;Ne;0;10;3;13
7406;Pipiras;NYKŠTUKAI;8689174023;Ne;7;0;0;7
7407;Pipiras;NYKŠTUKAI;7747049622;Ne;0;4;1;5
7408;Pipiras;NYKŠTUKAI;9892201598;Ne;0;12;0;12
7409;Pipiras;NYKŠTUKAI;1019753152;Ne;0;5;0;5
7410;Pipiras;NYKŠTUKAI;9499869533;Ne;0;9;1;10
7411;Pipiras;NYKŠTUKAI;5141447649;Ne;0;6;1;7
7412;Pipiras;NYKŠTUKAI;9877682150;Ne;0;0;1;1
7413;Pipiras;NYKŠTUKAI;9248925267;Ne;0;5;0;5
7414;Pipiras;PELĖDŽIUKAI;6342044341;Ne;8;6;0;14
7415;Pipiras;PELĖDŽIUKAI;5725956659;Ne;8;0;0;8
7416;Pipiras;PELĖDŽIUKAI;3852848863;Ne;10;0;0;10
7417;Pipiras;PELĖDŽIUKAI;3882437376;Ne;7;0;0;7
7418;Pipiras;PELĖDŽIUKAI;9157870634;Ne;0;5;0;5
7419;Pipiras;PELĖDŽIUKAI;5235868332;Ne;7;1;0;8
7420;Pipiras;PELĖDŽIUKAI;3554786173;Ne;10;0;0;10
7421;Pipiras;PELĖDŽIUKAI;1034182352;Ne;12;1;0;13
7422;Pipiras;PELĖDŽIUKAI;2075041950;Ne;6;1;0;7
7423;Pipiras;PELĖDŽIUKAI;6792777396;Ne;8;6;0;14
7424;Pipiras;PELĖDŽIUKAI;6780333972;Ne;13;0;0;13
7425;Pipiras;PELĖDŽIUKAI;5622119207;Ne;3;4;0;7
7426;Pipiras;PELĖDŽIUKAI;7934365114;Ne;3;0;0;3
7427;Pipiras;PELĖDŽIUKAI;9770780973;Ne;11;0;0;11
7428;Pipiras;PELĖDŽIUKAI;5845498558;Ne;0;6;0;6
7429;Pipiras;PELĖDŽIUKAI;9840040112;Ne;6;5;0;11
7430;Pipiras;PELĖDŽIUKAI;1784839485;Ne;0;7;0;7
7431;Pipiras;PELĖDŽIUKAI;3775916247;Ne;0;4;0;4
7432;Pipiras;PELĖDŽIUKAI;7350131214;Ne;13;1;0;14
7433;Pipiras;DRUGELIAI;5908707752;Ne;16;0;1;17
7434;Pipiras;DRUGELIAI;5856735452;Ne;4;0;0;4
7435;Pipiras;DRUGELIAI;2267192782;Ne;0;6;0;6
7436;Pipiras;DRUGELIAI;1045583136;Ne;0;2;6;8
7437;Pipiras;DRUGELIAI;1711168196;Ne;0;1;0;1
7438;Pipiras;DRUGELIAI;9479697733;Ne;11;0;0;11
7439;Pipiras;DRUGELIAI;4017042461;Ne;0;8;0;8
7440;Pipiras;DRUGELIAI;4725221169;Ne;0;3;0;3
7441;Pipiras;DRUGELIAI;5059203266;Ne;4;0;0;4
7442;Pipiras;DRUGELIAI;8140314304;Ne;0;4;0;4
7443;Pipiras;DRUGELIAI;8422419380;Ne;0;2;0;2
7444;Pipiras;DRUGELIAI;6791495556;Ne;0;4;0;4
7445;Pipiras;DRUGELIAI;4811029230;Ne;0;9;0;9
7446;Pipiras;DRUGELIAI;6363349541;Ne;0;4;0;4
7447;Pipiras;DRUGELIAI;6685567970;Ne;0;1;0;1
7448;Pipiras;DRUGELIAI;1353114929;Ne;0;7;2;9
7449;Pipiras;DRUGELIAI;4426479971;Ne;2;5;0;7
7450;Pipiras;DRUGELIAI;5512049762;Ne;0;1;0;1
7451;Pipiras;GĖLYTĖS;9670710691;Ne;0;0;8;8
7452;Pipiras;GĖLYTĖS;8965139441;Ne;0;2;0;2
7453;Pipiras;GĖLYTĖS;2095794125;Ne;9;5;0;14
7454;Pipiras;GĖLYTĖS;8675473349;Ne;4;0;0;4
7455;Pipiras;GĖLYTĖS;4945164161;Ne;5;7;0;12
7456;Pipiras;GĖLYTĖS;7362002646;Ne;8;0;0;8
7457;Pipiras;GĖLYTĖS;3755824911;Ne;0;2;8;10
7458;Pipiras;GĖLYTĖS;6453274205;Ne;5;1;0;6
7459;Pipiras;GĖLYTĖS;4559954910;Ne;14;1;0;15
7460;Pipiras;GĖLYTĖS;7157187063;Ne;11;2;0;13
7461;Pipiras;GĖLYTĖS;4021613243;Ne;0;1;0;1
7462;Pipiras;GĖLYTĖS;1611488078;Ne;0;2;2;4
7463;Pipiras;GĖLYTĖS;4236597883;Ne;6;0;2;8
7464;Pipiras;GĖLYTĖS;4289497197;Ne;6;0;0;6
7465;Pipiras;GĖLYTĖS;2474548836;Ne;2;5;0;7
7466;Pipiras;GĖLYTĖS;8553422709;Ne;10;0;0;10
7467;Pipiras;GĖLYTĖS;5738334591;Ne;0;5;0;5
7468;Pipiras;GĖLYTĖS;6428525902;Ne;13;0;0;13
7469;Pipiras;GĖLYTĖS;8354158722;Ne;11;0;0;11
7470;Pipiras;BORUŽĖLĖS;9127154444;Ne;0;2;0;2
7471;Pipiras;BORUŽĖLĖS;4707794599;Ne;4;0;0;4
7472;Pipiras;BORUŽĖLĖS;8673271201;Ne;0;3;1;4
7473;Pipiras;BORUŽĖLĖS;4086728233;Ne;9;0;0;9
7474;Pipiras;BORUŽĖLĖS;8508292428;Ne;16;1;0;17
7475;Pipiras;BORUŽĖLĖS;1210940213;Ne;0;2;4;6
7476;Pipiras;BORUŽĖLĖS;8260680662;Ne;0;4;0;4
7477;Pipiras;BORUŽĖLĖS;9097987789;Ne;0;7;0;7
7478;Pipiras;BORUŽĖLĖS;8959946514;Ne;0;0;5;5
7479;Pipiras;BORUŽĖLĖS;9396979045;Ne;2;0;0;2
7480;Pipiras;BORUŽĖLĖS;8443786510;Ne;0;4;0;4
7481;Pipiras;BORUŽĖLĖS;1146369304;Ne;5;2;0;7
7482;Pipiras;BORUŽĖLĖS;9970587185;Ne;6;0;0;6
7483;Pipiras;BORUŽĖLĖS;6034298583;Ne;0;4;2;6
7484;Pipiras;BORUŽĖLĖS;6344932171;Ne;0;0;4;4
7485;Pipiras;BORUŽĖLĖS;1550959705;Ne;14;0;0;14
7486;Pipiras;SKRUZDĖLIUKAI;7969837759;Ne;0;14;0;14
7487;Pipiras;SKRUZDĖLIUKAI;2483867901;Ne;0;3;0;3
7488;Pipiras;SKRUZDĖLIUKAI;1315372873;Ne;0;7;0;7
7489;Pipiras;SKRUZDĖLIUKAI;9372109848;Ne;0;0;5;5
7490;Pipiras;SKRUZDĖLIUKAI;9968182443;Ne;10;0;0;10
7491;Pipiras;SKRUZDĖLIUKAI;2296702730;Ne;0;0;3;3
7492;Pipiras;SKRUZDĖLIUKAI;3768825314;Ne;10;0;0;10
7493;Pipiras;SKRUZDĖLIUKAI;5888429623;Ne;10;0;0;10
7494;Pipiras;SKRUZDĖLIUKAI;4309096743;Ne;5;0;1;6
7495;Pipiras;SKRUZDĖLIUKAI;7212820879;Ne;2;0;0;2
7496;Pipiras;SKRUZDĖLIUKAI;8081343184;Ne;0;14;0;14
7497;Pipiras;SKRUZDĖLIUKAI;9852475056;Ne;16;0;0;16
7498;Pipiras;SKRUZDĖLIUKAI;6176818802;Ne;4;6;0;10
7499;Pipiras;SKRUZDĖLIUKAI;6570068615;Ne;0;1;0;1
7500;Pipiras;SKRUZDĖLIUKAI;1215623527;Ne;0;1;0;1
7501;Pipiras;SKRUZDĖLIUKAI;1998249512;Ne;0;0;6;6
7502;Pipiras;SKRUZDĖLIUKAI;9625933545;Ne;8;3;0;11
7503;Pipiras;SKRUZDĖLIUKAI;7211189491;Ne;0;7;1;8
7504;Pipiras;ŽVIRBLIUKŲ;5445858240;Ne;0;6;0;6
7505;Pipiras;ŽVIRBLIUKŲ;1242260242;Ne;7;1;0;8
7506;Pipiras;ŽVIRBLIUKŲ;3421769229;Ne;0;4;0;4
7507;Pipiras;ŽVIRBLIUKŲ;8520454289;Ne;0;8;0;8
7508;Pipiras;ŽVIRBLIUKŲ;5422547144;Ne;0;6;0;6
7509;Pipiras;ŽVIRBLIUKŲ;6136423200;Ne;0;0;2;2
7510;Pipiras;ŽVIRBLIUKŲ;6694920607;Ne;0;10;0;10
7511;Pipiras;ŽVIRBLIUKŲ;7912217889;Ne;0;4;0;4
7512;Pipiras;ŽVIRBLIUKŲ;3141822820;Ne;1;6;0;7
7513;Pipiras;ŽVIRBLIUKŲ;7870521230;Ne;0;2;8;10
7514;Pipiras;ŽVIRBLIUKŲ;4428216634;Ne;2;1;1;4
7515;Pipiras;ŽVIRBLIUKŲ;5502001191;Ne;5;4;1;10
7516;Pipiras;ŽVIRBLIUKŲ;5778300856;Ne;0;6;0;6
7517;Pipiras;ŽVIRBLIUKŲ;2240865490;Ne;7;0;0;7
7518;Pipiras;ŽVIRBLIUKŲ;7026118693;Ne;0;4;0;4
7519;Pipiras;ŽVIRBLIUKŲ;1391682850;Ne;2;4;0;6
7520;Pipiras;ŽVIRBLIUKŲ;87924002679;Ne;0;5;2;7
7521;Pipiras;ŽVIRBLIUKŲ;4456861303;Ne;0;10;0;10
7522;Pipiras;ŽVIRBLIUKŲ;4496076326;Ne;0;1;1;2
7523;Pipiras;ZUIKUČIŲ;3641496225;Ne;0;5;0;5
7524;Pipiras;ZUIKUČIŲ;6925577945;Ne;0;2;2;4
7525;Pipiras;ZUIKUČIŲ;2159315426;Ne;17;1;0;18
7526;Pipiras;ZUIKUČIŲ;8404246568;Ne;0;4;0;4
7527;Pipiras;ZUIKUČIŲ;7200147039;Ne;6;0;0;6
7528;Pipiras;ZUIKUČIŲ;5035593032;Ne;7;5;0;12
7529;Pipiras;ZUIKUČIŲ;6361544649;Ne;6;0;0;6
7530;Pipiras;ZUIKUČIŲ;1079088070;Ne;6;0;0;6
7531;Pipiras;ZUIKUČIŲ;4743474665;Ne;6;0;0;6
7532;Pipiras;ZUIKUČIŲ;9422467047;Ne;8;0;1;9
7533;Pipiras;ZUIKUČIŲ;4991725638;Ne;4;2;0;6
7534;Pipiras;ZUIKUČIŲ;9552763906;Ne;6;0;0;6
7535;Pipiras;VARLIUKŲ;7446225835;Ne;11;2;0;13
7536;Pipiras;VARLIUKŲ;8800890503;Ne;4;2;0;6
7537;Pipiras;VARLIUKŲ;6184943213;Ne;5;5;0;10
7538;Pipiras;VARLIUKŲ;8028360748;Ne;4;2;0;6
7539;Pipiras;VARLIUKŲ;1238280105;Ne;0;1;0;1
7540;Pipiras;VARLIUKŲ;3299099535;Ne;0;7;0;7
7541;Pipiras;VARLIUKŲ;8364783015;Ne;2;0;19;21
7542;Pipiras;VARLIUKŲ;5502186385;Ne;4;0;0;4
7543;Pipiras;VARLIUKŲ;8707560610;Ne;5;0;0;5
7544;Pipiras;VARLIUKŲ;4940053409;Ne;4;0;0;4
7545;Pipiras;VARLIUKŲ;2588075386;Ne;4;1;0;5
7546;Pipiras;VARLIUKŲ;6666112357;Ne;0;2;3;5
7547;Pipiras;VARLIUKŲ;9473056714;Ne;2;17;2;21
7548;Pipiras;VARLIUKŲ;8040520887;Ne;0;1;0;1
7549;Pipiras;ŽIOGELIŲ;7510719254;Ne;0;0;1;1
7550;Pipiras;ŽIOGELIŲ;7802812858;Ne;11;0;0;11
7551;Pipiras;ŽIOGELIŲ;8697732892;Ne;0;0;18;18
7552;Pipiras;ŽIOGELIŲ;1466527534;Ne;0;2;8;10
7553;Pipiras;ŽIOGELIŲ;1172225661;Ne;0;3;0;3
7554;Pipiras;ŽIOGELIŲ;3825960148;Ne;0;10;0;10
7555;Pipiras;ŽIOGELIŲ;9747219629;Ne;7;4;0;11
7556;Pipiras;ŽIOGELIŲ;8445608419;Ne;3;0;0;3
7557;Pipiras;ŽIOGELIŲ;6602780166;Ne;0;2;0;2
7558;Pipiras;ŽIOGELIŲ;4229548366;Ne;0;0;6;6
7559;Pipiras;ŽIOGELIŲ;8666908143;Ne;4;5;0;9
7560;Pipiras;ŽIOGELIŲ;4083110785;Ne;5;4;0;9
7561;Pipiras;ŽIOGELIŲ;7011969610;Ne;7;0;0;7
7562;Pipiras;ŽIOGELIŲ;2784222529;Ne;10;0;0;10
7563;"Prie pasakų parko";ZUIKUČIAI;8493622886;Ne;14;0;0;14
7564;"Prie pasakų parko";ZUIKUČIAI;3998970024;Ne;4;1;2;7
7565;"Prie pasakų parko";ZUIKUČIAI;3907016976;Ne;13;0;1;14
7566;"Prie pasakų parko";ZUIKUČIAI;4904562817;Ne;9;0;0;9
7567;"Prie pasakų parko";ZUIKUČIAI;9659710840;Ne;4;2;0;6
7568;"Prie pasakų parko";ZUIKUČIAI;8781483295;Ne;6;0;1;7
7569;"Prie pasakų parko";ZUIKUČIAI;5394554484;Ne;3;3;0;6
7570;"Prie pasakų parko";ZUIKUČIAI;9707694441;Ne;7;0;0;7
7571;"Prie pasakų parko";ZUIKUČIAI;7220229641;Ne;2;3;0;5
7572;"Prie pasakų parko";ZUIKUČIAI;8616467675;Ne;11;0;5;16
7573;"Prie pasakų parko";ZUIKUČIAI;8215496569;Ne;5;0;1;6
7574;"Prie pasakų parko";ZUIKUČIAI;9742058853;Ne;6;0;0;6
7575;"Prie pasakų parko";PAUKŠČIUKŲ;4860316199;Ne;0;3;0;3
7576;"Prie pasakų parko";PAUKŠČIUKŲ;3907578461;Ne;15;0;1;16
7577;"Prie pasakų parko";PAUKŠČIUKŲ;7359935733;Ne;18;0;0;18
7578;"Prie pasakų parko";PAUKŠČIUKŲ;7330033315;Ne;0;0;1;1
7579;"Prie pasakų parko";PAUKŠČIUKŲ;9061639276;Ne;13;0;0;13
7580;"Prie pasakų parko";PAUKŠČIUKŲ;1476515947;Ne;8;2;0;10
7581;"Prie pasakų parko";PAUKŠČIUKŲ;6601363351;Ne;3;0;1;4
7582;"Prie pasakų parko";PAUKŠČIUKŲ;9784398441;Ne;1;0;0;1
7583;"Prie pasakų parko";PAUKŠČIUKŲ;4891232161;Ne;3;0;0;3
7584;"Prie pasakų parko";PAUKŠČIUKŲ;9550985822;Ne;6;0;0;6
7585;"Prie pasakų parko";PAUKŠČIUKŲ;5737517940;Ne;12;0;2;14
7586;"Prie pasakų parko";PAUKŠČIUKŲ;7693728136;Taip;3;2;0;5
7587;"Prie pasakų parko";"LINKSMOJI ŠEIMYNĖLĖ (SPEC)";2820889357;Ne;5;6;2;13
7588;"Prie pasakų parko";"LINKSMOJI ŠEIMYNĖLĖ (SPEC)";29445903073;Ne;0;0;6;6
7589;"Prie pasakų parko";"LINKSMOJI ŠEIMYNĖLĖ (SPEC)";1549137154;Ne;3;0;0;3
7590;"Prie pasakų parko";"LINKSMOJI ŠEIMYNĖLĖ (SPEC)";9469871636;Ne;10;4;1;15
7591;"Prie pasakų parko";"LINKSMOJI ŠEIMYNĖLĖ (SPEC)";5641148690;Ne;2;19;0;21
7592;"Prie pasakų parko";"LINKSMOJI ŠEIMYNĖLĖ (SPEC)";9594976173;Ne;6;0;1;7
7593;"Prie pasakų parko";"LINKSMOJI ŠEIMYNĖLĖ (SPEC)";5356005675;Ne;10;0;0;10
7594;"Prie pasakų parko";"LINKSMOJI ŠEIMYNĖLĖ (SPEC)";9789977863;Ne;3;0;2;5
7595;"Prie pasakų parko";NYKŠTUKŲ;2287711014;Ne;0;3;3;6
7596;"Prie pasakų parko";NYKŠTUKŲ;6491435655;Ne;0;4;0;4
7597;"Prie pasakų parko";NYKŠTUKŲ;1743429440;Ne;0;1;0;1
7598;"Prie pasakų parko";NYKŠTUKŲ;1811994592;Taip;8;0;2;10
7599;"Prie pasakų parko";NYKŠTUKŲ;7739970115;Ne;13;0;7;20
7600;"Prie pasakų parko";NYKŠTUKŲ;6700916147;Ne;4;0;2;6
7601;"Prie pasakų parko";NYKŠTUKŲ;6733793491;Ne;10;0;0;10
7602;"Prie pasakų parko";NYKŠTUKŲ;2515928623;Ne;3;0;2;5
7603;"Prie pasakų parko";NYKŠTUKŲ;4726737519;Ne;0;0;3;3
7604;"Prie pasakų parko";NYKŠTUKŲ;1316127369;Ne;7;0;0;7
7605;"Prie pasakų parko";NYKŠTUKŲ;2654978735;Ne;13;0;8;21
7606;"Prie pasakų parko";NYKŠTUKŲ;4457827262;Ne;5;0;0;5
7607;"Prie pasakų parko";LAŠELIŲ;6865751947;Ne;0;0;4;4
7608;"Prie pasakų parko";LAŠELIŲ;1588062393;Ne;0;0;4;4
7609;"Prie pasakų parko";LAŠELIŲ;1278065349;Ne;0;1;0;1
7610;"Prie pasakų parko";LAŠELIŲ;8574432191;Ne;0;1;0;1
7611;"Prie pasakų parko";LAŠELIŲ;4181676762;Ne;0;4;0;4
7612;"Prie pasakų parko";LAŠELIŲ;4548803933;Ne;0;0;3;3
7613;"Prie pasakų parko";LAŠELIŲ;6250610187;Ne;1;6;0;7
7614;"Prie pasakų parko";LAŠELIŲ;9190379838;Ne;3;3;1;7
7615;"Prie pasakų parko";LAŠELIŲ;8189217660;Ne;0;3;0;3
7616;"Prie pasakų parko";LAŠELIŲ;8215830508;Ne;0;6;0;6
7617;"Prie pasakų parko";LAŠELIŲ;2731544174;Ne;9;0;0;9
7618;"Prie pasakų parko";LAŠELIŲ;5494350183;Ne;0;0;6;6
7619;"Prie pasakų parko";"KAČIUKAI (SPEC)";6772736175;Ne;10;0;3;13
7620;"Prie pasakų parko";"KAČIUKAI (SPEC)";5847625697;Ne;7;0;6;13
7621;"Prie pasakų parko";"KAČIUKAI (SPEC)";2590693851;Ne;0;0;4;4
7622;"Prie pasakų parko";"KAČIUKAI (SPEC)";3949671257;Ne;15;0;0;15
7623;"Prie pasakų parko";"KAČIUKAI (SPEC)";2583331243;Ne;5;0;1;6
7624;"Prie pasakų parko";"KAČIUKAI (SPEC)";1370201372;Ne;10;0;1;11
7625;"Prie pasakų parko";"KAČIUKAI (SPEC)";8056265378;Ne;4;0;0;4
7626;"Prie pasakų parko";"ŽVAIGŽDUTĖS  (SPEC)";7216751216;Ne;16;0;0;16
7627;"Prie pasakų parko";"ŽVAIGŽDUTĖS  (SPEC)";9072312203;Ne;0;1;0;1
7628;"Prie pasakų parko";"ŽVAIGŽDUTĖS  (SPEC)";6989235061;Ne;10;0;3;13
7629;"Prie pasakų parko";"ŽVAIGŽDUTĖS  (SPEC)";5009168398;Ne;1;0;4;5
7630;"Prie pasakų parko";"ŽVAIGŽDUTĖS  (SPEC)";6585504578;Ne;9;0;4;13
7631;"Prie pasakų parko";"ŽVAIGŽDUTĖS  (SPEC)";8203595449;Ne;12;0;4;16
7632;"Prie pasakų parko";"ŽVAIGŽDUTĖS  (SPEC)";7476984763;Ne;11;0;2;13
7633;"Prie pasakų parko";"ANČIUKAI (SPEC)";8339335908;Ne;11;0;1;12
7634;"Prie pasakų parko";"ANČIUKAI (SPEC)";6802898184;Ne;0;0;1;1
7635;"Prie pasakų parko";"ANČIUKAI (SPEC)";9529949992;Ne;0;0;6;6
7636;"Prie pasakų parko";"ANČIUKAI (SPEC)";4309482351;Ne;13;1;0;14
7637;"Prie pasakų parko";"ANČIUKAI (SPEC)";2047018335;Ne;15;0;3;18
7638;"Prie pasakų parko";"ANČIUKAI (SPEC)";2731902356;Ne;9;0;1;10
7639;"Prie pasakų parko";"ANČIUKAI (SPEC)";5627477370;Ne;4;0;3;7
7640;"Prie pasakų parko";TIGRIUKAI;7858530013;Ne;15;2;0;17
7641;"Prie pasakų parko";TIGRIUKAI;3918269702;Ne;3;4;2;9
7642;"Prie pasakų parko";TIGRIUKAI;6446562388;Ne;0;0;5;5
7643;"Prie pasakų parko";TIGRIUKAI;8899375521;Ne;21;0;0;21
7644;"Prie pasakų parko";TIGRIUKAI;6561145380;Taip;4;0;1;5
7645;"Prie pasakų parko";TIGRIUKAI;9476448601;Ne;0;3;0;3
7646;"Prie pasakų parko";TIGRIUKAI;8029428034;Ne;5;1;0;6
7647;"Prie pasakų parko";TIGRIUKAI;8715851643;Ne;0;0;1;1
7648;"Prie pasakų parko";TIGRIUKAI;7776961789;Ne;4;0;1;5
7649;"Prie pasakų parko";TIGRIUKAI;8285260113;Ne;0;0;6;6
7650;"Prie pasakų parko";TIGRIUKAI;3373275644;Ne;21;0;0;21
7651;"Prie pasakų parko";TIGRIUKAI;5518041213;Ne;0;0;1;1
7652;"Prie pasakų parko";TIGRIUKAI;8738488104;Ne;0;0;2;2
7653;"Prie pasakų parko";TIGRIUKAI;8406002339;Ne;0;0;4;4
7654;"Prie pasakų parko";"EŽIUKŲ (SPEC)";7115825217;Ne;3;0;4;7
7655;"Prie pasakų parko";"EŽIUKŲ (SPEC)";2952868428;Ne;7;0;2;9
7656;"Prie pasakų parko";"EŽIUKŲ (SPEC)";5159105661;Ne;10;0;2;12
7657;"Prie pasakų parko";"EŽIUKŲ (SPEC)";9632354317;Ne;0;0;2;2
7658;"Prie pasakų parko";"EŽIUKŲ (SPEC)";5944113879;Ne;2;0;2;4
7659;"Prie pasakų parko";"EŽIUKŲ (SPEC)";4799789212;Ne;1;0;2;3
7660;"Prie pasakų parko";"EŽIUKŲ (SPEC)";5834070970;Ne;5;0;4;9
7661;"Prie pasakų parko";"EŽIUKŲ (SPEC)";3579773269;Ne;1;5;0;6
7662;"Prie pasakų parko";"BORUŽIUKŲ (SPEC)";9715586563;Ne;0;5;0;5
7663;"Prie pasakų parko";"BORUŽIUKŲ (SPEC)";28574450739;Ne;0;3;0;3
7664;"Prie pasakų parko";"BORUŽIUKŲ (SPEC)";6215345468;Ne;0;2;0;2
7665;"Prie pasakų parko";"BORUŽIUKŲ (SPEC)";7000191099;Ne;5;3;0;8
7666;"Prie pasakų parko";SAULYTĖS;8685140364;Ne;0;13;1;14
7667;"Prie pasakų parko";SAULYTĖS;6606867989;Ne;0;0;6;6
7668;"Prie pasakų parko";SAULYTĖS;3038164555;Ne;0;0;1;1
7669;"Prie pasakų parko";SAULYTĖS;4183640714;Ne;21;0;0;21
7670;"Prie pasakų parko";SAULYTĖS;1738732866;Ne;6;1;0;7
7671;"Pumpurėlis (Kalvarijų g. 186)";RAMUNĖLIŲ;7610949816;Ne;2;0;0;2
7672;"Pumpurėlis (Kalvarijų g. 186)";RAMUNĖLIŲ;6977710645;Ne;0;0;1;1
7673;"Pumpurėlis (Kalvarijų g. 186)";RAMUNĖLIŲ;9431295796;Ne;0;0;2;2
7674;"Pumpurėlis (Kalvarijų g. 186)";RAMUNĖLIŲ;1395380236;Ne;0;4;0;4
7675;"Pumpurėlis (Kalvarijų g. 186)";RAMUNĖLIŲ;9424449290;Ne;0;12;0;12
7676;"Pumpurėlis (Kalvarijų g. 186)";RAMUNĖLIŲ;6955168163;Ne;0;3;0;3
7677;"Pumpurėlis (Kalvarijų g. 186)";RAMUNĖLIŲ;5171198109;Ne;0;4;0;4
7678;"Pumpurėlis (Kalvarijų g. 186)";RAMUNĖLIŲ;9726028397;Ne;0;0;1;1
7679;"Pumpurėlis (Kalvarijų g. 186)";RAMUNĖLIŲ;7229289985;Ne;16;0;0;16
7680;"Pumpurėlis (Kalvarijų g. 186)";RAMUNĖLIŲ;7559071945;Ne;0;5;0;5
7681;"Pumpurėlis (Kalvarijų g. 186)";RAMUNĖLIŲ;6574415196;Ne;0;4;0;4
7682;"Pumpurėlis (Kalvarijų g. 186)";RAMUNĖLIŲ;3953103488;Ne;19;0;0;19
7683;"Pumpurėlis (Kalvarijų g. 186)";RAMUNĖLIŲ;6511527480;Ne;0;3;0;3
7684;"Pumpurėlis (Kalvarijų g. 186)";RAMUNĖLIŲ;3838705973;Ne;6;0;4;10
7685;"Pumpurėlis (Kalvarijų g. 186)";RAMUNĖLIŲ;6726875853;Ne;0;8;0;8
7686;"Pumpurėlis (Kalvarijų g. 186)";RAMUNĖLIŲ;8667762689;Ne;0;4;0;4
7687;"Pumpurėlis (Kalvarijų g. 186)";RAMUNĖLIŲ;3874188848;Ne;15;0;0;15
7688;"Pumpurėlis (Kalvarijų g. 186)";RAMUNĖLIŲ;7619709360;Ne;0;0;3;3
7689;"Pumpurėlis (Kalvarijų g. 186)";VARPELIŲ;3101133244;Ne;11;0;0;11
7690;"Pumpurėlis (Kalvarijų g. 186)";VARPELIŲ;3893768713;Ne;0;16;0;16
7691;"Pumpurėlis (Kalvarijų g. 186)";VARPELIŲ;5023658988;Ne;0;1;6;7
7692;"Pumpurėlis (Kalvarijų g. 186)";VARPELIŲ;2668855786;Ne;0;9;0;9
7693;"Pumpurėlis (Kalvarijų g. 186)";VARPELIŲ;8258560345;Ne;0;1;0;1
7694;"Pumpurėlis (Kalvarijų g. 186)";VARPELIŲ;9612924972;Ne;2;6;1;9
7695;"Pumpurėlis (Kalvarijų g. 186)";VARPELIŲ;9884099545;Ne;0;5;0;5
7696;"Pumpurėlis (Kalvarijų g. 186)";VARPELIŲ;3733509497;Ne;0;0;2;2
7697;"Pumpurėlis (Kalvarijų g. 186)";VARPELIŲ;4508966729;Ne;0;0;5;5
7698;"Pumpurėlis (Kalvarijų g. 186)";VARPELIŲ;9552913910;Ne;0;2;5;7
7699;"Pumpurėlis (Kalvarijų g. 186)";VARPELIŲ;5196733185;Ne;0;4;0;4
7700;"Pumpurėlis (Kalvarijų g. 186)";VARPELIŲ;4928495108;Ne;0;1;0;1
7701;"Pumpurėlis (Kalvarijų g. 186)";VARPELIŲ;8886730333;Ne;0;6;0;6
7702;"Pumpurėlis (Kalvarijų g. 186)";VARPELIŲ;2247300456;Ne;0;2;2;4
7703;"Pumpurėlis (Kalvarijų g. 186)";VARPELIŲ;5564680653;Ne;0;0;7;7
7704;"Pumpurėlis (Kalvarijų g. 186)";VARPELIŲ;8525537588;Ne;10;0;0;10
7705;"Pumpurėlis (Kalvarijų g. 186)";VARPELIŲ;2103139845;Ne;8;0;0;8
7706;"Pumpurėlis (Kalvarijų g. 186)";VARPELIŲ;6780042929;Ne;0;21;0;21
7707;"Pumpurėlis (Kalvarijų g. 186)";VARPELIŲ;7182107790;Ne;4;0;0;4
7708;"Pumpurėlis (Kalvarijų g. 186)";VARPELIŲ;4629544683;Ne;0;1;0;1
7709;"Pumpurėlis (Kalvarijų g. 186)";VARPELIŲ;9224879966;Ne;5;0;2;7
7710;"Pumpurėlis (Kalvarijų g. 186)";DRUGELIŲ;5928552565;Ne;0;0;2;2
7711;"Pumpurėlis (Kalvarijų g. 186)";DRUGELIŲ;5897036076;Ne;0;4;0;4
7712;"Pumpurėlis (Kalvarijų g. 186)";DRUGELIŲ;7055989095;Ne;0;12;0;12
7713;"Pumpurėlis (Kalvarijų g. 186)";DRUGELIŲ;7078621340;Ne;11;1;0;12
7714;"Pumpurėlis (Kalvarijų g. 186)";DRUGELIŲ;1538548768;Ne;0;0;3;3
7715;"Pumpurėlis (Kalvarijų g. 186)";DRUGELIŲ;2368226822;Ne;0;0;2;2
7716;"Pumpurėlis (Kalvarijų g. 186)";DRUGELIŲ;3088476130;Ne;0;0;1;1
7717;"Pumpurėlis (Kalvarijų g. 186)";DRUGELIŲ;9640790401;Ne;0;0;10;10
7718;"Pumpurėlis (Kalvarijų g. 186)";DRUGELIŲ;7832408524;Ne;0;1;2;3
7719;"Pumpurėlis (Kalvarijų g. 186)";DRUGELIŲ;8644853849;Ne;0;9;0;9
7720;"Pumpurėlis (Kalvarijų g. 186)";DRUGELIŲ;9417688597;Ne;0;0;4;4
7721;"Pumpurėlis (Kalvarijų g. 186)";DRUGELIŲ;9032255874;Ne;19;0;2;21
7722;"Pumpurėlis (Kalvarijų g. 186)";DRUGELIŲ;5835115428;Ne;0;4;0;4
7723;"Pumpurėlis (Kalvarijų g. 186)";DRUGELIŲ;2132563531;Ne;0;4;0;4
7724;"Pumpurėlis (Kalvarijų g. 186)";DRUGELIŲ;4506063812;Ne;0;4;2;6
7725;"Pumpurėlis (Kalvarijų g. 186)";DRUGELIŲ;2165141865;Ne;5;0;0;5
7726;"Pumpurėlis (Kalvarijų g. 186)";DRUGELIŲ;8671697745;Ne;0;0;9;9
7727;"Pumpurėlis (Kalvarijų g. 186)";DRUGELIŲ;3187815703;Ne;8;0;9;17
7728;"Pumpurėlis (Kalvarijų g. 186)";KODĖLČIUKŲ;8214602054;Ne;0;0;5;5
7729;"Pumpurėlis (Kalvarijų g. 186)";KODĖLČIUKŲ;5564844211;Ne;5;0;4;9
7730;"Pumpurėlis (Kalvarijų g. 186)";KODĖLČIUKŲ;1215117598;Ne;11;0;0;11
7731;"Pumpurėlis (Kalvarijų g. 186)";KODĖLČIUKŲ;6978091765;Ne;0;0;6;6
7732;"Pumpurėlis (Kalvarijų g. 186)";KODĖLČIUKŲ;6433757421;Ne;3;0;1;4
7733;"Pumpurėlis (Kalvarijų g. 186)";KODĖLČIUKŲ;3328647987;Ne;5;0;0;5
7734;"Pumpurėlis (Kalvarijų g. 186)";KODĖLČIUKŲ;3748601124;Ne;5;0;0;5
7735;"Pumpurėlis (Kalvarijų g. 186)";KODĖLČIUKŲ;6004234378;Ne;0;0;1;1
7736;"Pumpurėlis (Kalvarijų g. 186)";KODĖLČIUKŲ;4196409137;Ne;0;0;2;2
7737;"Pumpurėlis (Kalvarijų g. 186)";KODĖLČIUKŲ;6117720533;Ne;0;4;0;4
7738;"Pumpurėlis (Kalvarijų g. 186)";KODĖLČIUKŲ;8070486897;Ne;0;0;4;4
7739;"Pumpurėlis (Kalvarijų g. 186)";KODĖLČIUKŲ;3534133061;Ne;0;1;0;1
7740;"Pumpurėlis (Kalvarijų g. 186)";KODĖLČIUKŲ;2307819108;Ne;0;1;0;1
7741;"Pumpurėlis (Kalvarijų g. 186)";KODĖLČIUKŲ;9650395309;Ne;0;8;0;8
7742;"Pumpurėlis (Kalvarijų g. 186)";KODĖLČIUKŲ;3563609848;Ne;0;0;12;12
7743;"Pumpurėlis (Kalvarijų g. 186)";KODĖLČIUKŲ;6702744879;Ne;2;0;1;3
7744;"Pumpurėlis (Kalvarijų g. 186)";KODĖLČIUKŲ;2890596967;Ne;8;0;1;9
7745;"Pumpurėlis (Kalvarijų g. 186)";KODĖLČIUKŲ;9839285886;Ne;0;1;0;1
7746;"Pumpurėlis (Kalvarijų g. 186)";LINELIS;1017483419;Ne;0;2;0;2
7747;"Pumpurėlis (Kalvarijų g. 186)";LINELIS;6957047759;Ne;0;2;0;2
7748;"Pumpurėlis (Kalvarijų g. 186)";LINELIS;1492810528;Ne;0;5;0;5
7749;"Pumpurėlis (Kalvarijų g. 186)";LINELIS;9138883172;Ne;0;1;0;1
7750;"Pumpurėlis (Kalvarijų g. 186)";LINELIS;1835168438;Ne;0;5;0;5
7751;"Pumpurėlis (Kalvarijų g. 186)";LINELIS;4344595328;Ne;9;6;0;15
7752;"Pumpurėlis (Kalvarijų g. 186)";LINELIS;7566451857;Ne;0;2;0;2
7753;"Pumpurėlis (Kalvarijų g. 186)";LINELIS;9583257172;Ne;0;9;0;9
7754;"Pumpurėlis (Kalvarijų g. 186)";LINELIS;13952236905;Ne;0;4;0;4
7755;"Pumpurėlis (Kalvarijų g. 186)";LINELIS;7533555059;Ne;0;1;0;1
7756;"Pumpurėlis (Kalvarijų g. 186)";LINELIS;5615260965;Ne;0;2;0;2
7757;"Pumpurėlis (Kalvarijų g. 186)";LINELIS;6669327226;Ne;0;4;0;4
7758;"Pumpurėlis (Kalvarijų g. 186)";LINELIS;3298821054;Ne;0;3;2;5
7759;"Pumpurėlis (Kalvarijų g. 186)";LINELIS;8830261792;Ne;0;4;0;4
7760;"Pumpurėlis (Kalvarijų g. 186)";LINELIS;87061817106;Ne;0;5;0;5
7761;"Pumpurėlis (Kalvarijų g. 186)";LINELIS;8806961007;Ne;7;0;0;7
7762;"Pumpurėlis (Kalvarijų g. 186)";LINELIS;18928851032;Ne;0;2;0;2
7763;"Pumpurėlis (Kalvarijų g. 186)";LINELIS;8747439652;Ne;7;1;0;8
7764;"Pumpurėlis (Kalvarijų g. 186)";LINELIS;2629702959;Ne;0;9;0;9
7765;"Pumpurėlis (Kalvarijų g. 186)";LINELIS;5964953923;Ne;0;7;0;7
7766;"Pumpurėlis (Kalvarijų g. 186)";SAULUTĖS;3751769136;Ne;5;0;0;5
7767;"Pumpurėlis (Kalvarijų g. 186)";SAULUTĖS;5013491568;Ne;0;4;2;6
7768;"Pumpurėlis (Kalvarijų g. 186)";SAULUTĖS;7488342792;Ne;0;1;2;3
7769;"Pumpurėlis (Kalvarijų g. 186)";SAULUTĖS;6412442729;Ne;1;4;6;11
7770;"Pumpurėlis (Kalvarijų g. 186)";SAULUTĖS;2129779614;Ne;0;1;1;2
7771;"Pumpurėlis (Kalvarijų g. 186)";SAULUTĖS;1053338730;Ne;5;0;0;5
7772;"Pumpurėlis (Kalvarijų g. 186)";SAULUTĖS;7123915287;Ne;0;0;3;3
7773;"Pumpurėlis (Kalvarijų g. 186)";SAULUTĖS;83388662869;Ne;0;4;0;4
7774;"Pumpurėlis (Kalvarijų g. 186)";SAULUTĖS;1690424790;Ne;9;4;0;13
7775;"Pumpurėlis (Kalvarijų g. 186)";SAULUTĖS;1397924008;Ne;0;4;1;5
7776;"Pumpurėlis (Kalvarijų g. 186)";SAULUTĖS;6230500803;Ne;0;3;0;3
7777;"Pumpurėlis (Kalvarijų g. 186)";SAULUTĖS;1306102772;Ne;0;4;1;5
7778;"Pumpurėlis (Kalvarijų g. 186)";SAULUTĖS;1230058211;Ne;0;10;0;10
7779;"Pumpurėlis (Kalvarijų g. 186)";SAULUTĖS;25029630023;Ne;0;2;0;2
7780;"Pumpurėlis (Kalvarijų g. 186)";SAULUTĖS;6535398274;Ne;0;1;2;3
7781;"Pumpurėlis (Kalvarijų g. 186)";SAULUTĖS;8262886949;Ne;0;4;0;4
7782;"Pumpurėlis (Kalvarijų g. 186)";SAULUTĖS;1261919194;Ne;0;1;2;3
7783;"Pumpurėlis (Kalvarijų g. 186)";SAULUTĖS;9733380187;Ne;0;4;0;4
7784;"Pumpurėlis (Kalvarijų g. 186)";SAULUTĖS;2102427499;Ne;0;1;0;1
7785;"Pumpurėlis (Kalvarijų g. 186)";SAULUTĖS;1225377038;Ne;0;2;0;2
7786;"Pumpurėlis (Kalvarijų g. 186)";SAULUTĖS;9317495169;Ne;0;1;0;1
7787;"Pumpurėlis (Kalvarijų g. 186)";BITUTĖS;4419940231;Ne;5;2;0;7
7788;"Pumpurėlis (Kalvarijų g. 186)";BITUTĖS;4985045047;Ne;6;0;0;6
7789;"Pumpurėlis (Kalvarijų g. 186)";BITUTĖS;2651037375;Ne;4;0;0;4
7790;"Pumpurėlis (Kalvarijų g. 186)";BITUTĖS;1768239820;Ne;3;0;0;3
7791;"Pumpurėlis (Kalvarijų g. 186)";BITUTĖS;2566557351;Ne;7;0;1;8
7792;"Pumpurėlis (Kalvarijų g. 186)";BITUTĖS;4426697956;Ne;0;0;5;5
7793;"Pumpurėlis (Kalvarijų g. 186)";BITUTĖS;7363814444;Ne;0;9;0;9
7794;"Pumpurėlis (Kalvarijų g. 186)";BITUTĖS;3405169131;Ne;8;0;1;9
7795;"Pumpurėlis (Kalvarijų g. 186)";BITUTĖS;3951445693;Ne;0;0;2;2
7796;"Pumpurėlis (Kalvarijų g. 186)";BITUTĖS;9612924316;Ne;0;10;0;10
7797;"Pumpurėlis (Kalvarijų g. 186)";BITUTĖS;5194285627;Ne;13;6;0;19
7798;"Pumpurėlis (Kalvarijų g. 186)";BITUTĖS;8655389224;Ne;0;2;0;2
7799;"Pumpurėlis (Kalvarijų g. 186)";BITUTĖS;1674341906;Ne;0;0;1;1
7800;"Pumpurėlis (Kalvarijų g. 186)";BITUTĖS;3842632260;Ne;0;4;1;5
7801;"Pumpurėlis (Kalvarijų g. 186)";BITUTĖS;1933502038;Ne;2;4;0;6
7802;"Pumpurėlis (Kalvarijų g. 186)";BITUTĖS;2230191718;Ne;3;0;0;3
7803;"Pumpurėlis (Kalvarijų g. 186)";BITUTĖS;7062090879;Ne;2;0;2;4
7804;"Pumpurėlis (Kalvarijų g. 186)";BITUTĖS;9245739052;Ne;0;0;2;2
7805;"Pumpurėlis (Kalvarijų g. 186)";BITUTĖS;8470433743;Ne;0;0;21;21
7806;"Pumpurėlis (Kalvarijų g. 186)";BITUTĖS;6474918016;Ne;5;0;0;5
7807;"Pumpurėlis (Kalvarijų g. 186)";DOBILIUKAI;9179780392;Ne;3;1;0;4
7808;"Pumpurėlis (Kalvarijų g. 186)";DOBILIUKAI;1839505206;Ne;0;8;0;8
7809;"Pumpurėlis (Kalvarijų g. 186)";DOBILIUKAI;3970253545;Ne;9;0;2;11
7810;"Pumpurėlis (Kalvarijų g. 186)";DOBILIUKAI;1808734330;Ne;2;2;0;4
7811;"Pumpurėlis (Kalvarijų g. 186)";DOBILIUKAI;6968264923;Ne;7;3;0;10
7812;"Pumpurėlis (Kalvarijų g. 186)";DOBILIUKAI;2700017433;Ne;0;6;0;6
7813;"Pumpurėlis (Kalvarijų g. 186)";DOBILIUKAI;7038597556;Ne;0;4;0;4
7814;"Pumpurėlis (Kalvarijų g. 186)";DOBILIUKAI;4130539703;Ne;0;2;0;2
7815;"Pumpurėlis (Kalvarijų g. 186)";DOBILIUKAI;6307988067;Ne;0;2;5;7
7816;"Pumpurėlis (Kalvarijų g. 186)";DOBILIUKAI;3374174445;Ne;0;3;0;3
7817;"Pumpurėlis (Kalvarijų g. 186)";DOBILIUKAI;3398517047;Ne;5;4;0;9
7818;"Pumpurėlis (Kalvarijų g. 186)";DOBILIUKAI;1961282282;Ne;4;0;0;4
7819;"Pumpurėlis (Kalvarijų g. 186)";DOBILIUKAI;7276322999;Ne;7;0;0;7
7820;"Pumpurėlis (Kalvarijų g. 186)";DOBILIUKAI;5587118874;Ne;5;0;0;5
7821;"Pumpurėlis (Kalvarijų g. 186)";DOBILIUKAI;9058493247;Ne;9;1;0;10
7822;"Pumpurėlis (Kalvarijų g. 186)";DOBILIUKAI;2028068230;Ne;3;0;0;3
7823;"Pumpurėlis (Kalvarijų g. 186)";DOBILIUKAI;5444879430;Ne;0;7;4;11
7824;"Pumpurėlis (Kalvarijų g. 186)";DOBILIUKAI;7825190756;Ne;11;0;0;11
7825;"Pumpurėlis (Kalvarijų g. 186)";DOBILIUKAI;1438740562;Ne;5;0;0;5
7826;"Pumpurėlis (Kalvarijų g. 186)";DOBILIUKAI;9740660699;Ne;11;3;0;14
7827;"Pumpurėlis (Kalvarijų g. 186)";PUPYČIŲ;7652642088;Ne;5;0;0;5
7828;"Pumpurėlis (Kalvarijų g. 186)";PUPYČIŲ;9317274035;Ne;8;0;2;10
7829;"Pumpurėlis (Kalvarijų g. 186)";PUPYČIŲ;1555441484;Ne;8;0;2;10
7830;"Pumpurėlis (Kalvarijų g. 186)";PUPYČIŲ;9052267552;Ne;0;4;1;5
7831;"Pumpurėlis (Kalvarijų g. 186)";PUPYČIŲ;9372725707;Ne;2;2;0;4
7832;"Pumpurėlis (Kalvarijų g. 186)";PUPYČIŲ;4249039048;Ne;0;2;1;3
7833;"Pumpurėlis (Kalvarijų g. 186)";PUPYČIŲ;1082775039;Ne;0;0;8;8
7834;"Pumpurėlis (Kalvarijų g. 186)";PUPYČIŲ;6982600785;Ne;4;0;0;4
7835;"Pumpurėlis (Kalvarijų g. 186)";PUPYČIŲ;1667602636;Ne;5;0;1;6
7836;"Pumpurėlis (Kalvarijų g. 186)";PUPYČIŲ;1448399754;Ne;0;0;2;2
7837;"Pumpurėlis (Kalvarijų g. 186)";PUPYČIŲ;6795405194;Ne;5;0;0;5
7838;"Pumpurėlis (Kalvarijų g. 186)";PUPYČIŲ;7443152469;Ne;0;4;17;21
7839;"Pumpurėlis (Kalvarijų g. 186)";PUPYČIŲ;9306426978;Ne;5;0;1;6
7840;"Pumpurėlis (Kalvarijų g. 186)";PUPYČIŲ;3259416263;Ne;10;0;6;16
7841;"Pumpurėlis (Kalvarijų g. 186)";PUPYČIŲ;6939412463;Ne;6;2;0;8
7842;"Pumpurėlis (Kalvarijų g. 186)";PUPYČIŲ;2715059752;Ne;0;0;5;5
7843;"Pumpurėlis (Kalvarijų g. 186)";PUPYČIŲ;8458676611;Ne;0;0;1;1
7844;"Pumpurėlis (Kalvarijų g. 186)";ŽIRNIUKŲ;9903981454;Ne;0;0;3;3
7845;"Pumpurėlis (Kalvarijų g. 186)";ŽIRNIUKŲ;3537534154;Ne;2;5;0;7
7846;"Pumpurėlis (Kalvarijų g. 186)";ŽIRNIUKŲ;1782842327;Ne;17;0;0;17
7847;"Pumpurėlis (Kalvarijų g. 186)";ŽIRNIUKŲ;6647331393;Ne;1;0;2;3
7848;"Pumpurėlis (Kalvarijų g. 186)";ŽIRNIUKŲ;3001331278;Ne;8;0;0;8
7849;"Pumpurėlis (Kalvarijų g. 186)";ŽIRNIUKŲ;9735493140;Ne;5;0;0;5
7850;"Pumpurėlis (Kalvarijų g. 186)";ŽIRNIUKŲ;3964441086;Ne;5;0;0;5
7851;"Pumpurėlis (Kalvarijų g. 186)";ŽIRNIUKŲ;8550119831;Ne;2;0;0;2
7852;"Pumpurėlis (Kalvarijų g. 186)";ŽIRNIUKŲ;6860128064;Ne;12;0;0;12
7853;"Pumpurėlis (Kalvarijų g. 186)";ŽIRNIUKŲ;5968577443;Ne;0;0;2;2
7854;"Pumpurėlis (Kalvarijų g. 186)";ŽIRNIUKŲ;8083674991;Ne;11;0;0;11
7855;"Pumpurėlis (Kalvarijų g. 186)";ŽIRNIUKŲ;9750242149;Ne;11;1;0;12
7856;"Pumpurėlis (Kalvarijų g. 186)";ŽIRNIUKŲ;5420222684;Ne;0;2;0;2
7857;"Pumpurėlis (Kalvarijų g. 186)";ŽIRNIUKŲ;4198532140;Ne;10;1;0;11
7858;"Pumpurėlis (Kalvarijų g. 186)";ŽIRNIUKŲ;6422203618;Ne;7;0;0;7
7859;"Pumpurėlis (Kalvarijų g. 186)";BORUŽĖLIŲ;2269864490;Ne;9;0;0;9
7860;"Pumpurėlis (Kalvarijų g. 186)";BORUŽĖLIŲ;6223338814;Ne;4;3;1;8
7861;"Pumpurėlis (Kalvarijų g. 186)";BORUŽĖLIŲ;5659508302;Ne;5;0;0;5
7862;"Pumpurėlis (Kalvarijų g. 186)";BORUŽĖLIŲ;5998858670;Ne;0;0;4;4
7863;"Pumpurėlis (Kalvarijų g. 186)";BORUŽĖLIŲ;7398363498;Ne;1;4;0;5
7864;"Pumpurėlis (Kalvarijų g. 186)";BORUŽĖLIŲ;5835545051;Ne;10;3;0;13
7865;"Pumpurėlis (Kalvarijų g. 186)";BORUŽĖLIŲ;4188020534;Ne;4;0;1;5
7866;"Pumpurėlis (Kalvarijų g. 186)";BORUŽĖLIŲ;6256781298;Ne;0;0;1;1
7867;"Pumpurėlis (Kalvarijų g. 186)";BORUŽĖLIŲ;9136771401;Ne;5;0;0;5
7868;"Pumpurėlis (Kalvarijų g. 186)";BORUŽĖLIŲ;7045349032;Ne;0;3;12;15
7869;"Pumpurėlis (Kalvarijų g. 186)";BORUŽĖLIŲ;1017838338;Ne;9;0;0;9
7870;"Pumpurėlis (Kalvarijų g. 186)";BORUŽĖLIŲ;1648249689;Ne;2;0;0;2
7871;"Pumpurėlis (Kalvarijų g. 186)";BORUŽĖLIŲ;7535098093;Ne;6;0;0;6
7872;"Pumpurėlis (Kalvarijų g. 186)";BORUŽĖLIŲ;7843280418;Ne;18;0;0;18
7873;"Pumpurėlis (Kalvarijų g. 186)";BORUŽĖLIŲ;3531862496;Ne;5;1;4;10
7874;"Pumpurėlis (Kalvarijų g. 186)";BORUŽĖLIŲ;1441993078;Ne;9;1;2;12
7875;"Pumpurėlis (Kalvarijų g. 186)";BORUŽĖLIŲ;2768082342;Ne;5;0;0;5
7876;"Pumpurėlis (Kalvarijų g. 186)";BORUŽĖLIŲ;3407251558;Ne;12;0;1;13
7877;"Pumpurėlis (Kalvarijų g. 186)";BORUŽĖLIŲ;4355867863;Ne;0;4;2;6
7878;"Pumpurėlis (Kalvarijų g. 186)";SMALSUČIŲ;6212212516;Ne;0;2;1;3
7879;"Pumpurėlis (Kalvarijų g. 186)";SMALSUČIŲ;6604801631;Ne;0;0;2;2
7880;"Pumpurėlis (Kalvarijų g. 186)";SMALSUČIŲ;6988369637;Ne;0;0;1;1
7881;"Pumpurėlis (Kalvarijų g. 186)";SMALSUČIŲ;9363610488;Ne;0;7;3;10
7882;"Pumpurėlis (Kalvarijų g. 186)";SMALSUČIŲ;8380689261;Ne;0;0;1;1
7883;"Pumpurėlis (Kalvarijų g. 186)";SMALSUČIŲ;6483338028;Ne;10;0;2;12
7884;"Pumpurėlis (Kalvarijų g. 186)";SMALSUČIŲ;6959214331;Ne;0;2;1;3
7885;"Pumpurėlis (Kalvarijų g. 186)";SMALSUČIŲ;3085309902;Ne;0;0;1;1
7886;"Pumpurėlis (Kalvarijų g. 186)";SMALSUČIŲ;4964949574;Ne;0;0;4;4
7887;"Pumpurėlis (Kalvarijų g. 186)";SMALSUČIŲ;2905797053;Ne;5;0;0;5
7888;"Pumpurėlis (Kalvarijų g. 186)";SMALSUČIŲ;2026021360;Ne;0;2;0;2
7889;"Pumpurėlis (Kalvarijų g. 186)";SMALSUČIŲ;3871151401;Ne;2;0;5;7
7890;"Pumpurėlis (Kalvarijų g. 186)";SMALSUČIŲ;6557857672;Ne;0;4;1;5
7891;"Pumpurėlis (Kalvarijų g. 186)";SMALSUČIŲ;5212827184;Ne;5;6;1;12
7892;"Pumpurėlis (Kalvarijų g. 186)";SMALSUČIŲ;5278250113;Ne;5;0;1;6
7893;"Pumpurėlis (Kalvarijų g. 186)";SMALSUČIŲ;5236515914;Ne;0;2;2;4
7894;"Pumpurėlis (Kalvarijų g. 186)";SMALSUČIŲ;5456922203;Ne;3;4;1;8
7895;Puriena;Ančiukų;1658720269;Ne;0;1;6;7
7896;Puriena;Ančiukų;6158842119;Ne;0;9;0;9
7897;Puriena;Ančiukų;3557013127;Ne;2;1;0;3
7898;Puriena;Ančiukų;4100466337;Ne;10;0;3;13
7899;Puriena;Ančiukų;9251058353;Ne;4;0;0;4
7900;Puriena;Ančiukų;4060087185;Ne;0;4;5;9
7901;Puriena;Ančiukų;6280465748;Ne;12;0;0;12
7902;Puriena;Ančiukų;3033562627;Ne;0;17;0;17
7903;Puriena;Ančiukų;5777076971;Ne;0;17;0;17
7904;Puriena;Ančiukų;8310231540;Ne;0;6;0;6
7905;Puriena;Ančiukų;4460575818;Ne;0;4;0;4
7906;Puriena;Ančiukų;7967288875;Ne;0;0;3;3
7907;Puriena;Ančiukų;4605662701;Ne;11;4;0;15
7908;Puriena;Ančiukų;1819876614;Ne;0;4;1;5
7909;Puriena;Ančiukų;4776745276;Ne;0;0;7;7
7910;Puriena;Ančiukų;6496291933;Ne;0;0;7;7
7911;Puriena;Ančiukų;7769252165;Ne;0;5;0;5
7912;Puriena;Ančiukų;2170025682;Ne;5;0;1;6
7913;Puriena;Ančiukų;3772941726;Ne;0;6;0;6
7914;Puriena;Ančiukų;1428098802;Ne;0;7;0;7
7915;Puriena;Drugeliai;2966464432;Ne;4;0;0;4
7916;Puriena;Drugeliai;4760827000;Ne;0;5;0;5
7917;Puriena;Drugeliai;4812271011;Ne;0;21;0;21
7918;Puriena;Drugeliai;1521955898;Ne;0;2;2;4
7919;Puriena;Drugeliai;8881337164;Ne;0;4;0;4
7920;Puriena;Drugeliai;5478026060;Ne;0;0;3;3
7921;Puriena;Drugeliai;6914613438;Ne;0;1;0;1
7922;Puriena;Drugeliai;8159342676;Ne;4;0;0;4
7923;Puriena;Drugeliai;1121312813;Ne;0;2;0;2
7924;Puriena;Drugeliai;2321753665;Ne;0;0;2;2
7925;Puriena;Drugeliai;7021756459;Ne;6;1;0;7
7926;Puriena;Drugeliai;1564155036;Ne;0;6;1;7
7927;Puriena;Drugeliai;9098291788;Ne;0;3;0;3
7928;Puriena;Drugeliai;6613654824;Ne;0;0;16;16
7929;Puriena;Drugeliai;3738277048;Ne;0;8;0;8
7930;Puriena;Drugeliai;7562458336;Ne;0;0;1;1
7931;Puriena;Drugeliai;3579008577;Ne;11;1;1;13
7932;Puriena;Drugeliai;4248701232;Ne;21;0;0;21
7933;Puriena;Drugeliai;7477278612;Ne;0;3;0;3
7934;Puriena;Drugeliai;9847768390;Ne;10;0;3;13
7935;Puriena;Drugeliai;1455237224;Ne;0;0;4;4
7936;Puriena;Drugeliai;6212693015;Ne;1;3;0;4
7937;Puriena;Drugeliai;5593526943;Ne;8;4;0;12
7938;Puriena;Pelėdžiukai;2013783668;Ne;0;6;0;6
7939;Puriena;Pelėdžiukai;8874823029;Ne;7;0;3;10
7940;Puriena;Pelėdžiukai;3149718901;Ne;0;4;3;7
7941;Puriena;Pelėdžiukai;3175917649;Ne;0;0;4;4
7942;Puriena;Pelėdžiukai;5619637663;Ne;0;2;0;2
7943;Puriena;Pelėdžiukai;8061605125;Ne;9;2;3;14
7944;Puriena;Pelėdžiukai;2579402981;Ne;1;3;0;4
7945;Puriena;Pelėdžiukai;3671297035;Ne;6;2;0;8
7946;Puriena;Pelėdžiukai;2701942325;Ne;0;6;0;6
7947;Puriena;Pelėdžiukai;2267225709;Ne;5;0;0;5
7948;Puriena;Pelėdžiukai;6413337915;Ne;5;0;0;5
7949;Puriena;Pelėdžiukai;4858971990;Ne;0;2;4;6
7950;Puriena;Pelėdžiukai;1417566073;Ne;0;1;0;1
7951;Puriena;Pelėdžiukai;6463129806;Ne;4;0;0;4
7952;Puriena;Pelėdžiukai;4501239330;Ne;0;0;5;5
7953;Puriena;Pelėdžiukai;5341228269;Ne;8;0;0;8
7954;Puriena;Pelėdžiukai;6352605894;Ne;6;0;0;6
7955;Puriena;Pelėdžiukai;6786694796;Ne;15;0;1;16
7956;Puriena;Pelėdžiukai;8952508230;Ne;8;0;0;8
7957;Puriena;Pelėdžiukai;5080805225;Ne;11;0;0;11
7958;Puriena;Pelėdžiukai;1158768017;Ne;0;4;0;4
7959;Puriena;Voveriukai;9911792407;Ne;3;0;1;4
7960;Puriena;Voveriukai;3826282438;Taip;2;4;1;7
7961;Puriena;Voveriukai;9453994213;Ne;2;0;0;2
7962;Puriena;Voveriukai;8497070167;Ne;10;2;1;13
7963;Puriena;Voveriukai;4517020977;Ne;0;6;0;6
7964;Puriena;Voveriukai;4283608124;Ne;2;2;0;4
7965;Puriena;Voveriukai;8144488922;Ne;0;7;0;7
7966;Puriena;Voveriukai;8476986855;Ne;4;6;0;10
7967;Puriena;Voveriukai;3627403517;Ne;8;0;1;9
7968;Puriena;Voveriukai;2813562677;Ne;3;0;3;6
7969;Puriena;Voveriukai;7120683581;Ne;0;1;1;2
7970;Puriena;Voveriukai;4653085762;Ne;0;16;0;16
7971;Puriena;Voveriukai;3542374463;Ne;0;1;0;1
7972;Puriena;Voveriukai;6150437624;Ne;0;10;0;10
7973;Puriena;Voveriukai;8772936125;Ne;0;0;5;5
7974;Puriena;Voveriukai;6428413592;Ne;11;0;0;11
7975;Puriena;Voveriukai;8242140541;Ne;4;0;1;5
7976;Puriena;Voveriukai;4498919764;Ne;5;0;6;11
7977;Puriena;Voveriukai;9729644429;Ne;0;0;4;4
7978;Puriena;Voveriukai;6140294839;Ne;2;0;0;2
7979;Puriena;Voveriukai;3455291312;Ne;5;5;0;10
7980;Puriena;Bitučių;1621772702;Ne;4;0;3;7
7981;Puriena;Bitučių;9413672989;Ne;10;0;0;10
7982;Puriena;Bitučių;5224135638;Ne;0;5;0;5
7983;Puriena;Bitučių;1175665781;Taip;0;0;8;8
7984;Puriena;Bitučių;6853706997;Ne;0;4;0;4
7985;Puriena;Bitučių;9962011647;Ne;0;0;21;21
7986;Puriena;Bitučių;1339162214;Ne;0;6;0;6
7987;Puriena;Bitučių;9543884311;Ne;0;4;0;4
7988;Puriena;Bitučių;8022809059;Ne;0;0;3;3
7989;Puriena;Bitučių;5395382717;Ne;10;2;0;12
7990;Puriena;Bitučių;8237149969;Ne;0;1;0;1
7991;Puriena;Bitučių;7481642656;Ne;0;21;0;21
7992;Puriena;Bitučių;8512814466;Ne;0;4;0;4
7993;Puriena;Bitučių;7622407056;Ne;4;0;4;8
7994;Puriena;Bitučių;4017644414;Ne;0;1;5;6
7995;Puriena;Bitučių;8416003733;Ne;0;2;3;5
7996;Puriena;Bitučių;8199607793;Ne;0;0;8;8
7997;Puriena;Bitučių;9854244405;Ne;0;6;1;7
7998;Puriena;Bitučių;6780164845;Ne;5;0;1;6
7999;Puriena;Zylutės;7337038503;Ne;0;7;0;7
8000;Puriena;Zylutės;5891404983;Ne;7;3;0;10
8001;Puriena;Zylutės;63196502622;Ne;8;1;0;9
8002;Puriena;Zylutės;9239618299;Ne;0;15;0;15
8003;Puriena;Zylutės;2083071198;Ne;0;10;0;10
8004;Puriena;Zylutės;20286870431;Ne;5;7;0;12
8005;Puriena;Zylutės;8618298134;Ne;8;6;0;14
8006;Puriena;Zylutės;1748337587;Ne;2;0;0;2
8007;Puriena;Zylutės;1820719083;Ne;2;0;0;2
8008;Puriena;Zylutės;2089174669;Ne;0;5;0;5
8009;Puriena;Zylutės;11497629767;Ne;0;10;0;10
8010;Puriena;Zylutės;2146036332;Ne;0;1;0;1
8011;Puriena;Zylutės;2378865002;Ne;0;10;0;10
8012;Puriena;Zylutės;2131343339;Ne;0;2;0;2
8013;Puriena;Zylutės;8213725698;Ne;11;0;0;11
8014;Puriena;Zylutės;8707076857;Ne;2;0;0;2
8015;Puriena;Zylutės;48468411549;Ne;0;1;0;1
8016;Puriena;Zylutės;1703078658;Ne;2;13;0;15
8017;Puriena;Zylutės;1756611673;Ne;3;0;0;3
8018;Puriena;Zylutės;6416145396;Ne;3;0;0;3
8019;Puriena;Zylutės;3031725530;Ne;0;2;1;3
8020;Puriena;Zylutės;6813480086;Ne;13;4;0;17
8021;Puriena;Meškučių;6234132927;Ne;0;2;2;4
8022;Puriena;Meškučių;4563681164;Ne;0;2;2;4
8023;Puriena;Meškučių;3153330970;Ne;0;1;0;1
8024;Puriena;Meškučių;9500729561;Ne;0;5;0;5
8025;Puriena;Meškučių;1238475246;Ne;0;2;2;4
8026;Puriena;Meškučių;5591189546;Ne;5;0;0;5
8027;Puriena;Meškučių;5323549829;Ne;0;1;0;1
8028;Puriena;Meškučių;7466163131;Ne;0;1;0;1
8029;Puriena;Meškučių;2466609635;Ne;0;2;0;2
8030;Puriena;Meškučių;3309219271;Ne;0;2;0;2
8031;Puriena;Meškučių;5176663365;Ne;0;2;0;2
8032;Puriena;Meškučių;9961074983;Ne;0;1;6;7
8033;Puriena;Meškučių;3011629747;Ne;0;0;1;1
8034;Puriena;Meškučių;2029981617;Ne;3;1;0;4
8035;Puriena;Meškučių;6185080390;Ne;19;0;0;19
8036;Puriena;Meškučių;3526684967;Ne;8;2;1;11
8037;Puriena;Meškučių;1513909923;Ne;0;0;7;7
8038;Puriena;Meškučių;7556975480;Ne;7;0;2;9
8039;Puriena;Meškučių;8093664167;Ne;5;2;1;8
8040;Puriena;Nykštukų;1053386081;Ne;5;1;0;6
8041;Puriena;Nykštukų;5469827031;Ne;6;0;1;7
8042;Puriena;Nykštukų;7649596096;Taip;17;0;4;21
8043;Puriena;Nykštukų;2762325241;Ne;11;1;3;15
8044;Puriena;Nykštukų;9907142348;Ne;5;0;2;7
8045;Puriena;Nykštukų;9369786639;Ne;4;0;2;6
8046;Puriena;Nykštukų;4728991133;Ne;8;0;2;10
8047;Puriena;Nykštukų;2344061847;Ne;5;1;0;6
8048;Puriena;Nykštukų;3630564604;Ne;7;4;0;11
8049;Puriena;Nykštukų;9438604106;Ne;5;0;0;5
8050;Puriena;Nykštukų;9379314578;Ne;12;0;0;12
8051;Puriena;Nykštukų;4211784186;Ne;0;0;10;10
8052;Puriena;Nykštukų;1610219365;Ne;9;4;0;13
8053;Puriena;Nykštukų;2146727759;Ne;0;2;2;4
8054;Puriena;Nykštukų;1988826809;Ne;0;3;0;3
8055;Puriena;Nykštukų;6605817147;Ne;10;0;0;10
8056;Puriena;Nykštukų;6271951373;Ne;0;4;0;4
8057;Puriena;Nykštukų;7869104640;Ne;0;9;0;9
8058;Puriena;Ežiukai;6451492815;Ne;0;3;0;3
8059;Puriena;Ežiukai;6612468095;Ne;14;0;0;14
8060;Puriena;Ežiukai;7913847170;Ne;15;2;1;18
8061;Puriena;Ežiukai;8089081251;Ne;5;6;0;11
8062;Puriena;Ežiukai;2830409862;Ne;10;3;0;13
8063;Puriena;Ežiukai;5550321808;Ne;13;0;0;13
8064;Puriena;Ežiukai;8038573068;Ne;0;1;6;7
8065;Puriena;Ežiukai;2624283930;Ne;11;0;0;11
8066;Puriena;Ežiukai;6001659356;Ne;0;4;3;7
8067;Puriena;Ežiukai;5539708916;Ne;7;1;0;8
8068;Puriena;Ežiukai;7335537384;Ne;14;0;0;14
8069;Puriena;Ežiukai;3204824116;Ne;10;0;3;13
8070;Puriena;Ežiukai;4954787474;Ne;10;0;0;10
8071;Puriena;Ežiukai;7720549981;Ne;17;0;1;18
8072;Puriena;Ežiukai;5555076926;Ne;0;4;0;4
8073;Puriena;Ežiukai;2312297583;Ne;0;2;0;2
8074;Puriena;Ežiukai;3232981406;Ne;10;0;0;10
8075;Puriena;Ežiukai;9228372078;Ne;10;0;1;11
8076;Puriena;Ežiukai;5374864513;Ne;10;0;0;10
8077;Puriena;Ežiukai;1737249860;Ne;0;4;0;4
8078;Puriena;Ežiukai;4608801156;Ne;3;0;0;3
8079;Puriena;Ežiukai;6991740430;Ne;3;1;0;4
8080;Puriena;"Boružiukų ";9600515308;Ne;16;0;0;16
8081;Puriena;"Boružiukų ";7985332838;Ne;0;21;0;21
8082;Puriena;"Boružiukų ";9671916745;Ne;2;1;0;3
8083;Puriena;"Boružiukų ";8195902319;Ne;7;0;0;7
8084;Puriena;"Boružiukų ";4587892949;Ne;7;0;4;11
8085;Puriena;"Boružiukų ";9497287421;Ne;11;1;0;12
8086;Puriena;"Boružiukų ";2818282875;Ne;0;0;3;3
8087;Puriena;"Boružiukų ";3215364967;Ne;0;1;4;5
8088;Puriena;"Boružiukų ";7016498639;Ne;2;0;0;2
8089;Puriena;"Boružiukų ";5797970231;Ne;10;4;0;14
8090;Puriena;"Boružiukų ";3382737176;Ne;2;4;1;7
8091;Puriena;"Boružiukų ";8110665629;Ne;0;4;0;4
8092;Puriena;"Boružiukų ";4006267650;Ne;15;1;0;16
8093;Puriena;"Boružiukų ";3440488785;Ne;0;0;4;4
8094;Puriena;"Boružiukų ";4016228982;Ne;0;4;0;4
8095;Puriena;"Boružiukų ";5277351784;Ne;0;4;0;4
8096;Puriena;"Boružiukų ";9931397038;Ne;6;1;0;7
8097;Puriena;"Zuikučių ";3252190329;Ne;6;0;0;6
8098;Puriena;"Zuikučių ";9907972536;Ne;8;1;0;9
8099;Puriena;"Zuikučių ";7634536770;Ne;2;3;6;11
8100;Puriena;"Zuikučių ";9423229931;Ne;0;2;0;2
8101;Puriena;"Zuikučių ";8284860687;Ne;0;2;2;4
8102;Puriena;"Zuikučių ";7334787183;Ne;0;3;3;6
8103;Puriena;"Zuikučių ";9176303276;Ne;5;9;2;16
8104;Puriena;"Zuikučių ";6941251095;Ne;21;0;0;21
8105;Puriena;"Zuikučių ";4193710604;Ne;0;0;3;3
8106;Puriena;"Zuikučių ";8474426340;Ne;2;0;0;2
8107;Puriena;"Zuikučių ";6227990580;Ne;7;0;0;7
8108;Puriena;"Zuikučių ";2172109284;Ne;7;4;0;11
8109;Puriena;"Zuikučių ";8239919265;Ne;9;0;0;9
8110;Puriena;"Zuikučių ";3094722037;Ne;4;0;0;4
8111;Puriena;"Zuikučių ";6308393533;Ne;0;4;10;14
8112;Puriena;Skruzdėliukai;2203259310;Ne;0;0;5;5
8113;Puriena;Skruzdėliukai;8478901457;Ne;5;3;0;8
8114;Puriena;Skruzdėliukai;4647433927;Ne;0;21;0;21
8115;Puriena;Skruzdėliukai;5257713434;Ne;0;21;0;21
8116;Puriena;Skruzdėliukai;11242620566;Ne;0;5;0;5
8117;Puriena;Skruzdėliukai;6285846517;Ne;0;4;0;4
8118;Puriena;Skruzdėliukai;6053657231;Ne;0;2;0;2
8119;Puriena;Skruzdėliukai;9139110598;Ne;0;1;0;1
8120;Puriena;Skruzdėliukai;5501308683;Ne;1;5;0;6
8121;Puriena;Skruzdėliukai;2663832596;Ne;5;4;0;9
8122;Puriena;Skruzdėliukai;6057477307;Ne;0;0;8;8
8123;Puriena;Skruzdėliukai;4966293604;Ne;0;4;2;6
8124;Puriena;Skruzdėliukai;92604925140;Ne;0;2;0;2
8125;Puriena;Skruzdėliukai;23746358787;Ne;0;1;0;1
8126;Puriena;Skruzdėliukai;1263637124;Ne;0;7;0;7
8127;Puriena;Skruzdėliukai;1290933817;Ne;0;7;0;7
8128;Puriena;Skruzdėliukai;8112003551;Ne;0;2;0;2
8129;Pušaitė;Kodėlčiukai;4838345510;Ne;0;1;1;2
8130;Pušaitė;Kodėlčiukai;8750774616;Ne;0;4;0;4
8131;Pušaitė;Kodėlčiukai;4198571222;Ne;0;0;1;1
8132;Pušaitė;Kodėlčiukai;9391350218;Ne;0;7;0;7
8133;Pušaitė;Kodėlčiukai;2793941689;Ne;0;2;0;2
8134;Pušaitė;Kodėlčiukai;9364887123;Ne;0;4;0;4
8135;Pušaitė;Kodėlčiukai;4326967247;Ne;6;1;0;7
8136;Pušaitė;Kodėlčiukai;5922053969;Ne;0;2;0;2
8137;Pušaitė;Kodėlčiukai;4473930703;Ne;0;4;0;4
8138;Pušaitė;Kodėlčiukai;6775428321;Ne;0;0;5;5
8139;Pušaitė;Kodėlčiukai;4615270419;Ne;0;3;0;3
8140;Pušaitė;Kodėlčiukai;7117784038;Ne;5;3;1;9
8141;Pušaitė;Kodėlčiukai;2253477550;Ne;0;1;0;1
8142;Pušaitė;Kodėlčiukai;6186545163;Ne;0;6;0;6
8143;Pušaitė;Kodėlčiukai;6115556675;Ne;6;1;0;7
8144;Pušaitė;Saulutės;4511258460;Ne;4;0;0;4
8145;Pušaitė;Saulutės;5422616450;Ne;4;0;4;8
8146;Pušaitė;Saulutės;7237345427;Ne;4;0;0;4
8147;Pušaitė;Saulutės;5819186055;Ne;4;0;2;6
8148;Pušaitė;Saulutės;8931688329;Ne;18;0;1;19
8149;Pušaitė;Saulutės;5981944481;Ne;2;0;0;2
8150;Pušaitė;Saulutės;2254269292;Ne;0;0;6;6
8151;Pušaitė;Saulutės;5306237557;Ne;1;0;16;17
8152;Pušaitė;Saulutės;4234318548;Ne;0;4;3;7
8153;Pušaitė;Saulutės;4883211957;Ne;0;21;0;21
8154;Pušaitė;Saulutės;1384820994;Ne;0;5;0;5
8155;Pušaitė;Saulutės;7480846917;Ne;5;4;0;9
8156;Pušaitė;Saulutės;8355083823;Ne;0;0;1;1
8157;Pušaitė;Saulutės;7291412329;Ne;0;0;5;5
8158;Pušaitė;Saulutės;2543188867;Ne;5;5;0;10
8159;Pušaitė;Saulutės;9577925438;Ne;12;1;0;13
8160;Pušaitė;Zuikučiai;2115591523;Ne;5;0;2;7
8161;Pušaitė;Zuikučiai;8738827821;Ne;0;0;2;2
8162;Pušaitė;Zuikučiai;7477429922;Ne;0;3;0;3
8163;Pušaitė;Zuikučiai;6306133416;Ne;0;2;1;3
8164;Pušaitė;Zuikučiai;2099169654;Ne;0;1;1;2
8165;Pušaitė;Zuikučiai;6355379926;Ne;0;0;1;1
8166;Pušaitė;Zuikučiai;80743691769;Ne;8;0;0;8
8167;Pušaitė;Zuikučiai;51500717235;Ne;0;4;0;4
8168;Pušaitė;Zuikučiai;2125574493;Ne;0;3;1;4
8169;Pušaitė;Zuikučiai;5398532705;Ne;0;0;6;6
8170;Pušaitė;Zuikučiai;3718196299;Ne;0;1;0;1
8171;Pušaitė;Zuikučiai;1295203136;Ne;7;1;0;8
8172;Pušaitė;Zuikučiai;2944418714;Ne;18;0;2;20
8173;Pušaitė;Zuikučiai;3813761666;Ne;14;1;1;16
8174;Pušaitė;Zuikučiai;4762094720;Ne;0;4;0;4
8175;Pušaitė;Zuikučiai;6600314608;Ne;0;4;0;4
8176;Pušaitė;Zuikučiai;2130767942;Ne;0;3;4;7
8177;Pušaitė;Zuikučiai;9179757395;Ne;3;2;6;11
8178;Pušaitė;Zuikučiai;8592426606;Ne;0;0;1;1
8179;Pušaitė;Zuikučiai;7251064118;Ne;0;3;7;10
8180;Pušaitė;Vėžliukai;8412276797;Ne;0;4;0;4
8181;Pušaitė;Vėžliukai;1326581025;Ne;0;6;0;6
8182;Pušaitė;Vėžliukai;8135552679;Ne;0;3;0;3
8183;Pušaitė;Vėžliukai;5161142520;Ne;5;0;2;7
8184;Pušaitė;Vėžliukai;3485234259;Ne;3;3;0;6
8185;Pušaitė;Vėžliukai;3014867515;Ne;2;0;1;3
8186;Pušaitė;Vėžliukai;9414554800;Ne;4;1;0;5
8187;Pušaitė;Vėžliukai;6739253961;Ne;0;4;0;4
8188;Pušaitė;Vėžliukai;3014180020;Ne;0;0;4;4
8189;Pušaitė;Vėžliukai;7890577174;Ne;0;4;0;4
8190;Pušaitė;Vėžliukai;5318602924;Ne;0;21;0;21
8191;Pušaitė;Vėžliukai;6794867560;Ne;2;0;1;3
8192;Pušaitė;Vėžliukai;5296435012;Ne;0;1;4;5
8193;Pušaitė;Vėžliukai;5512786073;Ne;10;4;0;14
8194;Pušaitė;Vėžliukai;8399589954;Ne;0;1;0;1
8195;Pušaitė;Vėžliukai;4281125486;Ne;0;0;9;9
8196;Pušaitė;Vėžliukai;2777222076;Ne;10;1;0;11
8197;Pušaitė;Vėžliukai;8459530338;Ne;0;2;0;2
8198;Pušaitė;"Linksmieji nykštukai";9265357004;Ne;0;1;0;1
8199;Pušaitė;"Linksmieji nykštukai";3150144924;Ne;5;2;0;7
8200;Pušaitė;"Linksmieji nykštukai";7520393710;Ne;2;0;2;4
8201;Pušaitė;"Linksmieji nykštukai";4517181474;Ne;0;4;0;4
8202;Pušaitė;"Linksmieji nykštukai";9033615485;Ne;0;2;0;2
8203;Pušaitė;"Linksmieji nykštukai";3130824742;Ne;0;5;0;5
8204;Pušaitė;"Linksmieji nykštukai";1024996364;Ne;0;3;1;4
8205;Pušaitė;"Linksmieji nykštukai";4662871524;Ne;0;7;0;7
8206;Pušaitė;"Linksmieji nykštukai";8438652029;Ne;0;0;2;2
8207;Pušaitė;"Linksmieji nykštukai";6578483902;Ne;12;1;0;13
8208;Pušaitė;"Linksmieji nykštukai";3350461304;Ne;2;2;1;5
8209;Pušaitė;"Linksmieji nykštukai";9327636862;Ne;0;1;0;1
8210;Pušaitė;"Linksmieji nykštukai";4175909754;Ne;4;0;4;8
8211;Pušaitė;"Linksmieji nykštukai";3788392895;Ne;0;4;0;4
8212;Pušaitė;"Linksmieji nykštukai";3195191374;Ne;5;2;0;7
8213;Pušaitė;"Linksmieji nykštukai";9127444013;Ne;0;4;0;4
8214;Pušaitė;"Linksmieji nykštukai";5422784898;Ne;0;2;3;5
8215;Pušaitė;"Linksmieji nykštukai";5104111840;Ne;4;2;1;7
8216;Pušaitė;"Linksmieji nykštukai";9866431097;Ne;0;6;0;6
8217;Pušaitė;"Linksmieji nykštukai";4564478833;Ne;3;1;0;4
8218;Pušaitė;"Linksmieji nykštukai";4374232593;Ne;3;0;0;3
8219;Pušaitė;"Linksmieji nykštukai";8378313810;Ne;0;6;0;6
8220;Pušaitė;"Kačiukų trobelė";3695016765;Ne;5;7;1;13
8221;Pušaitė;"Kačiukų trobelė";7983115812;Ne;9;2;0;11
8222;Pušaitė;"Kačiukų trobelė";1122112207;Ne;0;8;0;8
8223;Pušaitė;"Kačiukų trobelė";1635528919;Ne;0;0;2;2
8224;Pušaitė;"Kačiukų trobelė";2837439334;Ne;11;0;0;11
8225;Pušaitė;"Kačiukų trobelė";7014914682;Ne;0;5;0;5
8226;Pušaitė;"Kačiukų trobelė";1624587173;Ne;0;2;0;2
8227;Pušaitė;"Kačiukų trobelė";8793102437;Ne;0;15;0;15
8228;Pušaitė;"Kačiukų trobelė";9056933586;Ne;10;4;0;14
8229;Pušaitė;"Kačiukų trobelė";7898355721;Ne;0;0;1;1
8230;Pušaitė;"Kačiukų trobelė";6323180798;Ne;0;1;0;1
8231;Pušaitė;"Kačiukų trobelė";5191894075;Ne;0;2;0;2
8232;Pušaitė;"Kačiukų trobelė";1161519408;Ne;7;1;0;8
8233;Pušaitė;"Kačiukų trobelė";8822285103;Ne;0;2;0;2
8234;Pušaitė;"Kačiukų trobelė";9313564235;Ne;0;5;0;5
8235;Pušaitė;"Kačiukų trobelė";2865062081;Ne;0;1;0;1
8236;Pušaitė;"Kačiukų trobelė";2430891944;Ne;1;0;0;1
8237;Pušaitė;"Kačiukų trobelė";1978339054;Ne;0;1;0;1
8238;Pušaitė;"Kačiukų trobelė";6189116357;Ne;0;0;7;7
8239;Pušaitė;Ežiukai;2951618391;Ne;0;6;1;7
8240;Pušaitė;Ežiukai;9524002395;Ne;0;5;0;5
8241;Pušaitė;Ežiukai;1111143593;Ne;4;4;1;9
8242;Pušaitė;Ežiukai;5394378197;Ne;0;4;1;5
8243;Pušaitė;Ežiukai;15270671089;Ne;0;4;0;4
8244;Pušaitė;Ežiukai;69869396094;Ne;0;4;0;4
8245;Pušaitė;Ežiukai;3359574190;Ne;0;5;2;7
8246;Pušaitė;Ežiukai;9461292576;Ne;0;2;1;3
8247;Pušaitė;Ežiukai;5185787803;Ne;0;4;0;4
8248;Pušaitė;Ežiukai;4671293211;Ne;0;2;0;2
8249;Pušaitė;Ežiukai;4101326122;Ne;2;0;0;2
8250;Pušaitė;Ežiukai;8958364766;Ne;0;1;0;1
8251;Pušaitė;Ežiukai;2983890410;Ne;0;4;0;4
8252;Pušaitė;Ežiukai;7575143890;Ne;0;4;2;6
8253;Pušaitė;Ežiukai;7808186865;Ne;0;11;0;11
8254;Pušaitė;Ežiukai;4842783897;Ne;0;2;2;4
8255;Pušaitė;Ežiukai;5436168234;Ne;0;1;0;1
8256;Pušaitė;Ežiukai;8021494509;Ne;6;0;1;7
8257;Pušaitė;Ežiukai;2172342063;Ne;0;5;0;5
8258;Pušaitė;Ežiukai;8309000712;Ne;0;2;1;3
8259;Pušaitė;"Gudručių šalis";2321256048;Ne;2;0;0;2
8260;Pušaitė;"Gudručių šalis";5488507646;Ne;0;0;1;1
8261;Pušaitė;"Gudručių šalis";1305526154;Ne;7;1;5;13
8262;Pušaitė;"Gudručių šalis";6205900423;Ne;0;21;0;21
8263;Pušaitė;"Gudručių šalis";2078734161;Ne;0;0;2;2
8264;Pušaitė;"Gudručių šalis";8790959900;Ne;0;11;0;11
8265;Pušaitė;"Gudručių šalis";2397106198;Ne;0;1;2;3
8266;Pušaitė;"Gudručių šalis";3694667637;Ne;0;0;2;2
8267;Pušaitė;"Gudručių šalis";8343949011;Ne;0;5;2;7
8268;Pušaitė;"Gudručių šalis";4101285889;Ne;10;0;3;13
8269;Pušaitė;"Gudručių šalis";3959838346;Ne;12;0;0;12
8270;Pušaitė;"Gudručių šalis";5563772495;Ne;0;4;1;5
8271;Pušaitė;"Gudručių šalis";6356263503;Ne;0;0;7;7
8272;Pušaitė;"Gudručių šalis";2333176054;Ne;0;0;1;1
8273;Pušaitė;"Gudručių šalis";7066207306;Ne;4;0;0;4
8274;Pušaitė;"Gudručių šalis";4918124423;Ne;0;0;1;1
8275;Pušaitė;"Gudručių šalis";7992567219;Ne;4;0;5;9
8276;Pušaitė;"Lapučių mokyklėlė";9337726482;Ne;4;1;0;5
8277;Pušaitė;"Lapučių mokyklėlė";5139525557;Ne;3;0;0;3
8278;Pušaitė;"Lapučių mokyklėlė";2666541612;Ne;0;2;0;2
8279;Pušaitė;"Lapučių mokyklėlė";8343225451;Ne;0;2;3;5
8280;Pušaitė;"Lapučių mokyklėlė";8218991320;Ne;0;2;1;3
8281;Pušaitė;"Lapučių mokyklėlė";1994898058;Ne;0;21;0;21
8282;Pušaitė;"Lapučių mokyklėlė";8551426938;Ne;8;0;0;8
8283;Pušaitė;"Lapučių mokyklėlė";4444972517;Ne;9;0;0;9
8284;Pušaitė;"Lapučių mokyklėlė";7615253880;Ne;15;5;1;21
8285;Pušaitė;"Lapučių mokyklėlė";4508356130;Ne;0;2;3;5
8286;Pušaitė;"Lapučių mokyklėlė";4857214952;Ne;0;5;0;5
8287;Pušaitė;"Lapučių mokyklėlė";4138386134;Ne;0;6;0;6
8288;Pušaitė;"Lapučių mokyklėlė";4103149433;Ne;0;2;0;2
8289;Pušaitė;"Lapučių mokyklėlė";4747611989;Ne;0;1;0;1
8290;Pušaitė;"Lapučių mokyklėlė";3387165403;Ne;0;2;0;2
8291;Pušaitė;"Lapučių mokyklėlė";5339878948;Ne;6;4;0;10
8292;Pušaitė;"Lapučių mokyklėlė";3610256789;Ne;14;2;1;17
8293;Pušaitė;"Lapučių mokyklėlė";6576647982;Ne;0;2;1;3
8294;Pušaitė;"Lapučių mokyklėlė";1395577340;Ne;0;2;2;4
8295;Pušaitė;"Lapučių mokyklėlė";1534764228;Ne;0;1;0;1
8296;Pušaitė;"Lapučių mokyklėlė";5328083339;Ne;0;2;2;4
8297;Pušaitė;"Lapučių mokyklėlė";3200968850;Ne;14;6;0;20
8298;Pušaitė;"VOVERIUKAI ";7891007708;Ne;9;1;0;10
8299;Pušaitė;"VOVERIUKAI ";6767281906;Ne;0;5;0;5
8300;Pušaitė;"VOVERIUKAI ";3732377309;Ne;5;0;0;5
8301;Pušaitė;"VOVERIUKAI ";5270528758;Ne;12;0;0;12
8302;Pušaitė;"VOVERIUKAI ";4344634837;Ne;0;21;0;21
8303;Pušaitė;"VOVERIUKAI ";1665030028;Ne;12;0;0;12
8304;Pušaitė;"VOVERIUKAI ";5013833636;Ne;0;0;1;1
8305;Pušaitė;"VOVERIUKAI ";4769806128;Ne;8;0;0;8
8306;Pušaitė;"VOVERIUKAI ";6511940816;Ne;0;21;0;21
8307;Pušaitė;"VOVERIUKAI ";4818407739;Ne;6;0;3;9
8308;Pušaitė;"VOVERIUKAI ";8876092901;Ne;0;1;3;4
8309;Pušaitė;"VOVERIUKAI ";9546541248;Ne;0;0;2;2
8310;Pušaitė;"VOVERIUKAI ";4767321724;Ne;15;0;2;17
8311;Pušaitė;"VOVERIUKAI ";1542239525;Ne;0;2;0;2
8312;Pušaitė;"VOVERIUKAI ";4529006786;Ne;5;0;0;5
8313;Pušaitė;MEŠKUČIAI;5002710062;Ne;0;12;3;15
8314;Pušaitė;MEŠKUČIAI;3052743933;Ne;0;21;0;21
8315;Pušaitė;MEŠKUČIAI;3646346787;Ne;0;21;0;21
8316;Pušaitė;MEŠKUČIAI;6754402783;Ne;6;0;1;7
8317;Pušaitė;MEŠKUČIAI;9180309936;Ne;5;0;0;5
8318;Pušaitė;MEŠKUČIAI;4754791489;Ne;3;3;0;6
8319;Pušaitė;MEŠKUČIAI;2264047794;Ne;0;9;0;9
8320;Pušaitė;MEŠKUČIAI;4278699624;Ne;0;2;1;3
8321;Pušaitė;MEŠKUČIAI;8244793037;Ne;8;2;0;10
8322;Pušaitė;MEŠKUČIAI;3508664946;Ne;0;1;0;1
8323;Pušaitė;MEŠKUČIAI;3239486674;Taip;0;0;2;2
8324;Pušaitė;MEŠKUČIAI;9339706754;Ne;1;0;1;2
8325;Pušaitė;MEŠKUČIAI;7583243031;Ne;0;7;0;7
8326;Pušaitė;MEŠKUČIAI;9418440677;Ne;9;0;0;9
8327;Pušaitė;MEŠKUČIAI;4082173648;Ne;5;4;0;9
8328;Pušaitė;PELIUKAI;9177861202;Ne;4;2;0;6
8329;Pušaitė;PELIUKAI;9164927041;Ne;0;21;0;21
8330;Pušaitė;PELIUKAI;2454348536;Ne;6;0;0;6
8331;Pušaitė;PELIUKAI;6645711171;Ne;17;0;0;17
8332;Pušaitė;PELIUKAI;9031289300;Ne;6;0;1;7
8333;Pušaitė;PELIUKAI;7210529114;Ne;7;1;0;8
8334;Pušaitė;PELIUKAI;2758026755;Ne;0;2;0;2
8335;Pušaitė;PELIUKAI;6851908671;Ne;3;1;1;5
8336;Pušaitė;PELIUKAI;7737524017;Ne;5;0;0;5
8337;Pušaitė;PELIUKAI;2618038364;Ne;0;2;0;2
8338;Pušaitė;PELIUKAI;1180343204;Ne;10;5;0;15
8339;Pušaitė;PELIUKAI;1069369636;Ne;0;5;0;5
8340;Pušaitė;PELIUKAI;5112517007;Ne;6;1;7;14
8341;Pušaitė;PELIUKAI;9261546370;Ne;4;0;0;4
8342;Pušaitė;PELIUKAI;6059415475;Ne;0;21;0;21
8343;"Pušynėlis (Miglos g. 53)";PUMPURĖLIAI;5725602894;Ne;0;0;21;21
8344;"Pušynėlis (Miglos g. 53)";PUMPURĖLIAI;2718421498;Ne;5;4;0;9
8345;"Pušynėlis (Miglos g. 53)";PUMPURĖLIAI;7787646910;Ne;0;1;0;1
8346;"Pušynėlis (Miglos g. 53)";PUMPURĖLIAI;4526807309;Ne;0;6;0;6
8347;"Pušynėlis (Miglos g. 53)";PUMPURĖLIAI;5568838550;Ne;0;0;1;1
8348;"Pušynėlis (Miglos g. 53)";PUMPURĖLIAI;2553444832;Ne;0;0;4;4
8349;"Pušynėlis (Miglos g. 53)";PUMPURĖLIAI;2509111066;Ne;0;4;0;4
8350;"Pušynėlis (Miglos g. 53)";PUMPURĖLIAI;8902047615;Ne;0;5;0;5
8351;"Pušynėlis (Miglos g. 53)";PUMPURĖLIAI;3483639540;Ne;0;2;0;2
8352;"Pušynėlis (Miglos g. 53)";PUMPURĖLIAI;2861000826;Ne;0;3;0;3
8353;"Pušynėlis (Miglos g. 53)";PUMPURĖLIAI;8845728723;Ne;7;0;0;7
8354;"Pušynėlis (Miglos g. 53)";PUMPURĖLIAI;5802582694;Ne;3;1;0;4
8355;"Pušynėlis (Miglos g. 53)";PUMPURĖLIAI;9465619945;Ne;0;0;1;1
8356;"Pušynėlis (Miglos g. 53)";PUMPURĖLIAI;9883505094;Ne;0;2;0;2
8357;"Pušynėlis (Miglos g. 53)";PUMPURĖLIAI;7438923710;Ne;12;1;0;13
8358;"Pušynėlis (Miglos g. 53)";PUMPURĖLIAI;8803766149;Ne;14;0;0;14
8359;"Pušynėlis (Miglos g. 53)";PUMPURĖLIAI;8462742834;Ne;16;5;0;21
8360;"Pušynėlis (Miglos g. 53)";PUMPURĖLIAI;6962705842;Ne;0;0;21;21
8361;"Pušynėlis (Miglos g. 53)";PUMPURĖLIAI;6110878898;Ne;9;2;0;11
8362;"Pušynėlis (Miglos g. 53)";SAULUTĖS;3483007385;Ne;5;9;0;14
8363;"Pušynėlis (Miglos g. 53)";SAULUTĖS;1891728904;Ne;0;2;0;2
8364;"Pušynėlis (Miglos g. 53)";SAULUTĖS;5236219294;Ne;0;6;0;6
8365;"Pušynėlis (Miglos g. 53)";SAULUTĖS;4052132379;Ne;0;4;1;5
8366;"Pušynėlis (Miglos g. 53)";SAULUTĖS;4052365035;Ne;10;0;0;10
8367;"Pušynėlis (Miglos g. 53)";SAULUTĖS;7401066252;Ne;0;0;3;3
8368;"Pušynėlis (Miglos g. 53)";SAULUTĖS;6036296660;Ne;3;0;0;3
8369;"Pušynėlis (Miglos g. 53)";SAULUTĖS;1251787066;Ne;0;0;1;1
8370;"Pušynėlis (Miglos g. 53)";SAULUTĖS;6709692748;Ne;0;7;0;7
8371;"Pušynėlis (Miglos g. 53)";SAULUTĖS;5318223378;Ne;4;2;2;8
8372;"Pušynėlis (Miglos g. 53)";SAULUTĖS;3100230874;Ne;0;21;0;21
8373;"Pušynėlis (Miglos g. 53)";SAULUTĖS;7896617995;Ne;6;0;1;7
8374;"Pušynėlis (Miglos g. 53)";SAULUTĖS;8799095053;Ne;0;1;0;1
8375;"Pušynėlis (Miglos g. 53)";SAULUTĖS;5501281051;Ne;0;0;5;5
8376;"Pušynėlis (Miglos g. 53)";PRIEŠMOKYKLINĖ;25261143142;Ne;0;9;0;9
8377;"Pušynėlis (Miglos g. 53)";PRIEŠMOKYKLINĖ;8742287326;Ne;0;10;0;10
8378;"Pušynėlis (Miglos g. 53)";PRIEŠMOKYKLINĖ;6549217377;Ne;14;0;1;15
8379;"Pušynėlis (Miglos g. 53)";PRIEŠMOKYKLINĖ;2012089695;Ne;0;12;0;12
8380;"Pušynėlis (Miglos g. 53)";PRIEŠMOKYKLINĖ;35538053975;Ne;0;5;0;5
8381;"Pušynėlis (Miglos g. 53)";PRIEŠMOKYKLINĖ;76597184985;Ne;0;6;0;6
8382;"Pušynėlis (Miglos g. 53)";PRIEŠMOKYKLINĖ;7729392498;Ne;0;4;0;4
8383;"Pušynėlis (Miglos g. 53)";PRIEŠMOKYKLINĖ;9192206804;Ne;0;6;0;6
8384;"Pušynėlis (Miglos g. 53)";PRIEŠMOKYKLINĖ;6077698697;Ne;0;5;1;6
8385;"Pušynėlis (Miglos g. 53)";PRIEŠMOKYKLINĖ;4668634909;Ne;0;5;0;5
8386;"Pušynėlis (Miglos g. 53)";PRIEŠMOKYKLINĖ;6560054869;Ne;0;10;0;10
8387;"Pušynėlis (Miglos g. 53)";PRIEŠMOKYKLINĖ;3037031809;Ne;12;0;0;12
8388;"Pušynėlis (Miglos g. 53)";PRIEŠMOKYKLINĖ;4030500100;Ne;2;2;1;5
8389;"Pušynėlis (Miglos g. 53)";PRIEŠMOKYKLINĖ;8172450090;Ne;0;1;4;5
8390;"Pušynėlis (Miglos g. 53)";PRIEŠMOKYKLINĖ;2019210609;Ne;0;2;0;2
8391;"Pušynėlis (Miglos g. 53)";PRIEŠMOKYKLINĖ;2793982816;Ne;0;0;2;2
8392;"Pušynėlis (Miglos g. 53)";PRIEŠMOKYKLINĖ;7046421581;Ne;0;2;1;3
8393;"Pušynėlis (Miglos g. 53)";PRIEŠMOKYKLINĖ;9466109315;Ne;0;4;0;4
8394;"Pušynėlis (Miglos g. 53)";PRIEŠMOKYKLINĖ;9154108688;Ne;6;2;2;10
8395;"Pušynėlis (Miglos g. 53)";PRIEŠMOKYKLINĖ;1573574250;Ne;0;2;1;3
8396;"Pušynėlis (Miglos g. 53)";PRIEŠMOKYKLINĖ;3510202379;Ne;0;3;0;3
8397;"Pušynėlis (Miglos g. 53)";PRIEŠMOKYKLINĖ;2765869141;Ne;11;0;0;11
8398;"Pušynėlis (Miglos g. 53)";PRIEŠMOKYKLINĖ;2141785580;Ne;1;4;0;5
8399;"Pušynėlis (Miglos g. 53)";"TREPSIUKAI (2018.09)";7732546085;Ne;11;0;0;11
8400;"Pušynėlis (Miglos g. 53)";"TREPSIUKAI (2018.09)";4449613959;Ne;0;0;21;21
8401;"Pušynėlis (Miglos g. 53)";"TREPSIUKAI (2018.09)";8933840402;Ne;14;0;0;14
8402;"Pušynėlis (Miglos g. 53)";"TREPSIUKAI (2018.09)";5488832089;Ne;11;0;0;11
8403;"Pušynėlis (Miglos g. 53)";"TREPSIUKAI (2018.09)";6414064067;Ne;0;2;0;2
8404;"Pušynėlis (Miglos g. 53)";"TREPSIUKAI (2018.09)";5670094788;Ne;6;0;0;6
8405;"Pušynėlis (Miglos g. 53)";"TREPSIUKAI (2018.09)";5264481173;Ne;9;2;0;11
8406;"Pušynėlis (Miglos g. 53)";"TREPSIUKAI (2018.09)";4468698630;Ne;0;2;6;8
8407;"Pušynėlis (Miglos g. 53)";"TREPSIUKAI (2018.09)";1240222214;Ne;4;0;0;4
8408;"Pušynėlis (Miglos g. 53)";"TREPSIUKAI (2018.09)";6318952845;Ne;0;0;1;1
8409;"Pušynėlis (Miglos g. 53)";"TREPSIUKAI (2018.09)";1508282873;Ne;0;10;0;10
8410;"Pušynėlis (Miglos g. 53)";"TREPSIUKAI (2018.09)";7745507151;Ne;0;0;1;1
8411;"Pušynėlis (Miglos g. 53)";"TREPSIUKAI (2018.09)";8372033449;Ne;6;3;0;9
8412;"Pušynėlis (Miglos g. 53)";"TREPSIUKAI (2018.09)";4603625624;Ne;0;2;3;5
8413;"Pušynėlis (Miglos g. 53)";"TREPSIUKAI (2018.09)";3682719098;Ne;0;0;1;1
8414;"Pušynėlis (Miglos g. 53)";"TREPSIUKAI (2018.09)";5038740377;Ne;5;0;0;5
8415;Raktelis;LAŠIUKAI;4671391106;Ne;0;2;0;2
8416;Raktelis;LAŠIUKAI;8117871963;Ne;0;12;0;12
8417;Raktelis;LAŠIUKAI;1192775994;Ne;0;1;0;1
8418;Raktelis;LAŠIUKAI;6854111162;Ne;0;5;0;5
8419;Raktelis;LAŠIUKAI;9230053040;Ne;17;0;0;17
8420;Raktelis;LAŠIUKAI;3713386556;Ne;12;2;0;14
8421;Raktelis;LAŠIUKAI;9584164290;Ne;0;2;1;3
8422;Raktelis;LAŠIUKAI;6049420030;Ne;0;6;0;6
8423;Raktelis;LAŠIUKAI;3345708690;Ne;0;1;0;1
8424;Raktelis;LAŠIUKAI;54221331553;Ne;11;3;0;14
8425;Raktelis;LAŠIUKAI;5802689482;Ne;7;1;0;8
8426;Raktelis;LAŠIUKAI;5000264125;Ne;0;5;0;5
8427;Raktelis;LAŠIUKAI;1457880868;Ne;0;2;0;2
8428;Raktelis;LAŠIUKAI;5711863758;Ne;0;2;2;4
8429;Raktelis;LAŠIUKAI;53034039807;Ne;0;7;0;7
8430;Raktelis;LAŠIUKAI;7248631013;Ne;5;0;0;5
8431;Raktelis;LAŠIUKAI;8559758812;Ne;0;7;0;7
8432;Raktelis;BITUTĖS;7265543701;Ne;3;1;0;4
8433;Raktelis;BITUTĖS;5627179884;Ne;0;7;1;8
8434;Raktelis;BITUTĖS;5405322552;Ne;21;0;0;21
8435;Raktelis;BITUTĖS;5492437864;Ne;0;8;0;8
8436;Raktelis;BITUTĖS;9139322116;Ne;0;0;9;9
8437;Raktelis;BITUTĖS;6929358401;Ne;0;4;0;4
8438;Raktelis;BITUTĖS;9965855682;Ne;0;5;1;6
8439;Raktelis;BITUTĖS;4319176525;Ne;0;2;1;3
8440;Raktelis;BITUTĖS;4317705126;Ne;0;2;0;2
8441;Raktelis;BITUTĖS;4187804340;Ne;0;0;3;3
8442;Raktelis;BITUTĖS;5820028619;Ne;0;4;0;4
8443;Raktelis;BITUTĖS;2652125338;Ne;0;0;1;1
8444;Raktelis;BITUTĖS;3821849812;Ne;2;0;0;2
8445;Raktelis;BITUTĖS;3308623522;Ne;15;2;0;17
8446;Raktelis;BITUTĖS;4059286631;Ne;4;4;0;8
8447;Raktelis;BITUTĖS;5913060415;Ne;0;5;0;5
8448;Raktelis;BITUTĖS;6932820066;Ne;5;0;1;6
8449;Raktelis;BITUTĖS;2410682193;Ne;0;0;1;1
8450;Raktelis;BITUTĖS;5705825231;Ne;0;0;4;4
8451;Raktelis;BITUTĖS;4615337759;Ne;5;1;0;6
8452;Raktelis;BITUTĖS;4962251215;Ne;0;7;0;7
8453;Raktelis;BITUTĖS;8282429202;Ne;0;1;0;1
8454;Raktelis;BORUŽĖLĖS;7068061170;Ne;21;0;0;21
8455;Raktelis;BORUŽĖLĖS;2361477092;Ne;4;0;0;4
8456;Raktelis;BORUŽĖLĖS;4226277600;Ne;10;3;0;13
8457;Raktelis;BORUŽĖLĖS;2599670832;Ne;8;2;0;10
8458;Raktelis;BORUŽĖLĖS;1757601091;Ne;5;6;0;11
8459;Raktelis;BORUŽĖLĖS;5865484633;Ne;0;5;0;5
8460;Raktelis;BORUŽĖLĖS;4529213150;Ne;6;0;0;6
8461;Raktelis;BORUŽĖLĖS;4936637343;Ne;0;1;0;1
8462;Raktelis;BORUŽĖLĖS;4333191842;Ne;10;0;0;10
8463;Raktelis;BORUŽĖLĖS;9529797517;Ne;5;0;0;5
8464;Raktelis;BORUŽĖLĖS;4442395100;Ne;15;0;1;16
8465;Raktelis;BORUŽĖLĖS;5150954686;Ne;20;0;0;20
8466;Raktelis;BORUŽĖLĖS;3490428062;Ne;4;2;0;6
8467;Raktelis;BORUŽĖLĖS;5404673733;Ne;0;0;1;1
8468;Raktelis;BORUŽĖLĖS;1314972335;Ne;0;7;0;7
8469;Raktelis;BORUŽĖLĖS;3343352568;Ne;0;1;4;5
8470;Raktelis;BORUŽĖLĖS;2698820718;Ne;9;2;0;11
8471;Raktelis;BORUŽĖLĖS;7990626447;Ne;5;6;0;11
8472;Raktelis;BORUŽĖLĖS;5046450478;Ne;7;1;0;8
8473;Raktelis;BORUŽĖLĖS;1141447274;Ne;5;6;0;11
8474;Raktelis;BORUŽĖLĖS;3456093273;Ne;0;2;3;5
8475;Raktelis;BORUŽĖLĖS;5576511314;Ne;1;2;0;3
8476;Raktelis;KAČIUKAI;5270430511;Ne;6;0;0;6
8477;Raktelis;KAČIUKAI;4622683599;Ne;0;3;0;3
8478;Raktelis;KAČIUKAI;8600632097;Ne;0;12;0;12
8479;Raktelis;KAČIUKAI;7630501672;Ne;0;3;0;3
8480;Raktelis;KAČIUKAI;6007823584;Ne;9;0;0;9
8481;Raktelis;KAČIUKAI;4676213966;Ne;15;0;0;15
8482;Raktelis;KAČIUKAI;4631375439;Ne;0;11;0;11
8483;Raktelis;KAČIUKAI;6265489540;Ne;0;5;0;5
8484;Raktelis;KAČIUKAI;4160091258;Ne;12;0;0;12
8485;Raktelis;KAČIUKAI;3775306030;Ne;6;2;1;9
8486;Raktelis;KAČIUKAI;4009105487;Ne;7;0;0;7
8487;Raktelis;KAČIUKAI;1843086151;Ne;11;0;4;15
8488;Raktelis;KAČIUKAI;1983808547;Ne;18;0;0;18
8489;Raktelis;KAČIUKAI;5042538956;Ne;8;0;0;8
8490;Raktelis;KAČIUKAI;7260767942;Ne;0;2;0;2
8491;Raktelis;KAČIUKAI;1123693990;Ne;12;1;0;13
8492;Raktelis;KAČIUKAI;4979657165;Ne;1;1;0;2
8493;Raktelis;KIŠKUČIAI;9390692206;Ne;18;1;0;19
8494;Raktelis;KIŠKUČIAI;7847787737;Ne;0;0;1;1
8495;Raktelis;KIŠKUČIAI;7046291082;Ne;10;2;0;12
8496;Raktelis;KIŠKUČIAI;2278227649;Ne;9;3;0;12
8497;Raktelis;KIŠKUČIAI;8992797384;Ne;0;6;3;9
8498;Raktelis;KIŠKUČIAI;9803505110;Ne;6;1;1;8
8499;Raktelis;KIŠKUČIAI;6587878165;Ne;0;5;0;5
8500;Raktelis;KIŠKUČIAI;9169797346;Ne;5;1;0;6
8501;Raktelis;KIŠKUČIAI;2262854947;Ne;9;1;0;10
8502;Raktelis;KIŠKUČIAI;3493159224;Ne;7;0;1;8
8503;Raktelis;KIŠKUČIAI;1810732707;Ne;5;4;0;9
8504;Raktelis;KIŠKUČIAI;5293558630;Ne;5;1;0;6
8505;Raktelis;KIŠKUČIAI;7605822626;Ne;5;0;4;9
8506;Raktelis;NYKŠTUKAI;7865593006;Ne;9;0;0;9
8507;Raktelis;NYKŠTUKAI;7058612493;Ne;4;0;0;4
8508;Raktelis;NYKŠTUKAI;8817859592;Ne;5;0;2;7
8509;Raktelis;NYKŠTUKAI;4578445282;Ne;0;8;0;8
8510;Raktelis;NYKŠTUKAI;9164539135;Ne;0;3;0;3
8511;Raktelis;NYKŠTUKAI;4147382341;Ne;21;0;0;21
8512;Raktelis;NYKŠTUKAI;2234892629;Ne;0;0;2;2
8513;Raktelis;NYKŠTUKAI;8507551381;Ne;0;0;1;1
8514;Raktelis;NYKŠTUKAI;4764915486;Ne;3;0;0;3
8515;Raktelis;NYKŠTUKAI;9114203596;Ne;0;4;0;4
8516;Raktelis;NYKŠTUKAI;2803146830;Ne;18;2;4;24
8517;Raktelis;NYKŠTUKAI;1002851704;Ne;6;0;0;6
8518;Raktelis;NYKŠTUKAI;7202523804;Ne;0;3;0;3
8519;Raktelis;NYKŠTUKAI;6718159439;Ne;3;11;0;14
8520;Raktelis;PELIUKAI;9599034285;Ne;0;6;1;7
8521;Raktelis;PELIUKAI;1604357851;Ne;0;9;8;17
8522;Raktelis;PELIUKAI;6393143566;Ne;7;1;0;8
8523;Raktelis;PELIUKAI;4014822452;Ne;3;8;0;11
8524;Raktelis;PELIUKAI;5758873229;Ne;5;1;0;6
8525;Raktelis;PELIUKAI;2141128125;Ne;0;0;7;7
8526;Raktelis;PELIUKAI;4502236264;Ne;7;2;0;9
8527;Raktelis;PELIUKAI;3311870918;Ne;6;2;0;8
8528;Raktelis;PELIUKAI;6826993779;Ne;0;2;6;8
8529;Raktelis;PELIUKAI;8698736569;Ne;0;2;2;4
8530;Raktelis;PELIUKAI;2044812301;Ne;0;4;0;4
8531;Raktelis;PELIUKAI;2301442262;Ne;3;0;1;4
8532;Raktelis;PELIUKAI;6853881405;Ne;0;2;0;2
8533;Raktelis;PELIUKAI;9983004779;Taip;1;0;0;1
8534;Raktelis;PELIUKAI;7389910330;Ne;11;0;0;11
8535;Raktelis;PELIUKAI;4513031164;Ne;4;2;0;6
8536;Raktelis;AGUONOS;6102196040;Ne;0;2;0;2
8537;Raktelis;AGUONOS;6199212999;Ne;13;3;0;16
8538;Raktelis;AGUONOS;7334310944;Ne;3;10;0;13
8539;Raktelis;AGUONOS;1975411457;Ne;13;1;0;14
8540;Raktelis;AGUONOS;6367875352;Ne;0;0;11;11
8541;Raktelis;AGUONOS;7170546710;Ne;13;5;0;18
8542;Raktelis;AGUONOS;4905982507;Ne;0;6;0;6
8543;Raktelis;AGUONOS;9779789133;Ne;0;2;0;2
8544;Raktelis;AGUONOS;9593639791;Ne;4;4;0;8
8545;Raktelis;AGUONOS;1392036584;Ne;6;5;0;11
8546;Raktelis;AGUONOS;6608224825;Ne;5;11;0;16
8547;Raktelis;AGUONOS;4658530212;Ne;0;2;2;4
8548;Raktelis;AGUONOS;9357757604;Ne;12;3;0;15
8549;Raktelis;AGUONOS;8459980712;Ne;9;2;0;11
8550;Raktelis;AGUONOS;7973137015;Ne;0;7;0;7
8551;Raktelis;AGUONOS;9591285702;Ne;9;4;0;13
8552;Raktelis;AGUONOS;8767785444;Ne;3;2;0;5
8553;Raktelis;LAPIUKŲ;6894769625;Ne;6;7;0;13
8554;Raktelis;LAPIUKŲ;7142823740;Ne;0;6;0;6
8555;Raktelis;LAPIUKŲ;3395720463;Ne;0;5;0;5
8556;Raktelis;LAPIUKŲ;4167194960;Ne;0;3;0;3
8557;Raktelis;LAPIUKŲ;2809458453;Ne;0;5;0;5
8558;Raktelis;LAPIUKŲ;6892006495;Ne;0;4;0;4
8559;Raktelis;LAPIUKŲ;3884068578;Ne;0;2;0;2
8560;Raktelis;LAPIUKŲ;4755892641;Ne;0;5;0;5
8561;Raktelis;LAPIUKŲ;7440866459;Ne;0;2;0;2
8562;Raktelis;LAPIUKŲ;3517484891;Ne;6;0;0;6
8563;Raktelis;LAPIUKŲ;5688795147;Ne;0;1;0;1
8564;Raktelis;LAPIUKŲ;8035618134;Ne;9;0;0;9
8565;Raktelis;LAPIUKŲ;6822021176;Ne;21;0;0;21
8566;Raktelis;LAPIUKŲ;8146076115;Ne;0;6;0;6
8567;Raktelis;LAPIUKŲ;2731096860;Ne;5;0;0;5
8568;Raktelis;LAPIUKŲ;4353473162;Ne;0;1;0;1
8569;Raktelis;LAPIUKŲ;8700012974;Ne;2;0;0;2
8570;Raktelis;LAPIUKŲ;1263150004;Ne;5;6;0;11
8571;Raktelis;LAPIUKŲ;1445359221;Ne;4;0;0;4
8572;Raktelis;LAPIUKŲ;9497620710;Ne;1;0;0;1
8573;Raktelis;LAPIUKŲ;1120263625;Ne;6;0;0;6
8574;Raktelis;PELĖDŽIUKAI;5275588088;Ne;0;10;0;10
8575;Raktelis;PELĖDŽIUKAI;3602722744;Ne;0;10;0;10
8576;Raktelis;PELĖDŽIUKAI;54341630847;Ne;0;4;0;4
8577;Raktelis;PELĖDŽIUKAI;4583377785;Ne;0;2;0;2
8578;Raktelis;PELĖDŽIUKAI;8320696048;Ne;0;6;1;7
8579;Raktelis;PELĖDŽIUKAI;67304194087;Ne;5;5;0;10
8580;Raktelis;PELĖDŽIUKAI;2753402906;Ne;0;7;0;7
8581;Raktelis;PELĖDŽIUKAI;7962509432;Ne;0;1;0;1
8582;Raktelis;PELĖDŽIUKAI;9053427316;Ne;0;3;2;5
8583;Raktelis;PELĖDŽIUKAI;3423529085;Ne;0;3;0;3
8584;Raktelis;PELĖDŽIUKAI;9716191639;Ne;0;1;4;5
8585;Raktelis;PELĖDŽIUKAI;1322912585;Ne;0;6;2;8
8586;Raktelis;PELĖDŽIUKAI;6877934219;Ne;5;1;0;6
8587;Raktelis;PELĖDŽIUKAI;9130613710;Ne;0;6;0;6
8588;Raktelis;PELĖDŽIUKAI;9151796053;Ne;2;0;0;2
8589;Raktelis;PELĖDŽIUKAI;2282754345;Ne;0;3;0;3
8590;Raktelis;PELĖDŽIUKAI;8207675881;Ne;0;1;0;1
8591;Raktelis;PELĖDŽIUKAI;5925441742;Ne;0;4;0;4
8592;Raktelis;PELĖDŽIUKAI;5082785025;Ne;0;0;6;6
8593;Raktelis;MEŠKIUKAI;6703168910;Ne;0;2;0;2
8594;Raktelis;MEŠKIUKAI;8851021346;Ne;2;0;1;3
8595;Raktelis;MEŠKIUKAI;4185763817;Ne;6;0;0;6
8596;Raktelis;MEŠKIUKAI;6685891017;Ne;0;5;1;6
8597;Raktelis;MEŠKIUKAI;3484991718;Ne;9;0;0;9
8598;Raktelis;MEŠKIUKAI;6855863189;Ne;12;1;0;13
8599;Raktelis;MEŠKIUKAI;1026592738;Ne;0;1;0;1
8600;Raktelis;MEŠKIUKAI;7900644404;Ne;21;0;0;21
8601;Raktelis;MEŠKIUKAI;9718355271;Ne;0;5;0;5
8602;Raktelis;MEŠKIUKAI;2171952119;Ne;0;0;1;1
8603;Raktelis;MEŠKIUKAI;6358227532;Ne;0;8;0;8
8604;Raktelis;MEŠKIUKAI;8341026400;Ne;0;1;0;1
8605;Raktelis;MEŠKIUKAI;8608093349;Ne;2;8;2;12
8606;Raktelis;MEŠKIUKAI;2103900090;Ne;4;0;1;5
8607;Rasa;Nykštukai;5176175108;Ne;0;3;1;4
8608;Rasa;Nykštukai;3979273111;Ne;0;5;0;5
8609;Rasa;Nykštukai;4847544355;Ne;2;6;1;9
8610;Rasa;Nykštukai;9723040721;Ne;0;6;0;6
8611;Rasa;Nykštukai;7004232909;Ne;0;6;0;6
8612;Rasa;Nykštukai;1223962374;Ne;0;0;3;3
8613;Rasa;Nykštukai;3200377629;Ne;0;6;0;6
8614;Rasa;Nykštukai;1336291828;Ne;0;14;0;14
8615;Rasa;Nykštukai;5861229664;Ne;0;6;0;6
8616;Rasa;Nykštukai;1386880644;Ne;2;5;1;8
8617;Rasa;Nykštukai;7228037580;Ne;0;1;0;1
8618;Rasa;Nykštukai;2093263887;Ne;0;0;7;7
8619;Rasa;Nykštukai;2540124793;Ne;0;2;0;2
8620;Rasa;Nykštukai;5363748728;Ne;0;6;3;9
8621;Rasa;Nykštukai;8310400946;Ne;0;5;0;5
8622;Rasa;Nykštukai;7520665472;Ne;0;10;0;10
8623;Rasa;Nykštukai;7534306402;Ne;0;5;0;5
8624;Rasa;Nykštukai;3755794133;Ne;0;4;0;4
8625;Rasa;Meškiukai;8378755600;Ne;0;11;0;11
8626;Rasa;Meškiukai;3073804713;Ne;0;0;1;1
8627;Rasa;Meškiukai;6691161322;Ne;5;0;1;6
8628;Rasa;Meškiukai;8740659600;Ne;0;21;0;21
8629;Rasa;Meškiukai;6874601830;Ne;12;9;0;21
8630;Rasa;Meškiukai;4127921417;Ne;0;4;4;8
8631;Rasa;Meškiukai;7357915584;Ne;0;3;0;3
8632;Rasa;Meškiukai;8314522373;Ne;6;2;0;8
8633;Rasa;Meškiukai;3548008659;Ne;0;21;0;21
8634;Rasa;Meškiukai;3773600344;Ne;8;2;1;11
8635;Rasa;Meškiukai;2371282781;Ne;8;2;1;11
8636;Rasa;Meškiukai;2555108465;Ne;0;1;0;1
8637;Rasa;Meškiukai;1992726664;Ne;0;3;1;4
8638;Rasa;Meškiukai;7843789214;Ne;0;3;0;3
8639;Rasa;Meškiukai;7637404588;Ne;0;4;4;8
8640;Rasa;Meškiukai;7502435359;Ne;3;7;0;10
8641;Rasa;Meškiukai;6853285570;Ne;0;4;5;9
8642;Rasa;Meškiukai;8674133653;Ne;0;21;0;21
8643;Rasa;Meškiukai;2840437821;Ne;0;2;0;2
8644;Rasa;Sauliukai;72772661373;Ne;0;3;0;3
8645;Rasa;Sauliukai;6879558965;Ne;0;14;1;15
8646;Rasa;Sauliukai;6356448094;Ne;9;0;0;9
8647;Rasa;Sauliukai;2683897055;Ne;0;5;0;5
8648;Rasa;Sauliukai;2982016133;Ne;0;1;0;1
8649;Rasa;Sauliukai;7534548604;Ne;0;11;0;11
8650;Rasa;Sauliukai;3567565920;Ne;3;3;0;6
8651;Rasa;Sauliukai;7565880116;Ne;0;7;0;7
8652;Rasa;Sauliukai;2110008545;Ne;3;0;0;3
8653;Rasa;Sauliukai;5932187584;Ne;0;5;0;5
8654;Rasa;Sauliukai;4837280374;Ne;0;1;0;1
8655;Rasa;Sauliukai;4260142706;Ne;0;6;0;6
8656;Rasa;Sauliukai;5145978804;Ne;12;9;0;21
8657;Rasa;Sauliukai;8818450386;Ne;2;0;0;2
8658;Rasa;Sauliukai;6734478649;Ne;0;4;9;13
8659;Rasa;Sauliukai;5606722133;Ne;0;5;1;6
8660;Rasa;Sauliukai;63673920646;Ne;0;2;0;2
8661;Rasa;Sauliukai;8953448462;Ne;0;4;0;4
8662;Rasa;Smalsučiai;5599182715;Ne;0;8;0;8
8663;Rasa;Smalsučiai;9648034081;Ne;0;4;0;4
8664;Rasa;Smalsučiai;2626361958;Ne;0;3;0;3
8665;Rasa;Smalsučiai;2132535297;Ne;0;1;3;4
8666;Rasa;Smalsučiai;8866896989;Ne;0;16;0;16
8667;Rasa;Smalsučiai;9938280570;Ne;0;4;0;4
8668;Rasa;Smalsučiai;1690518970;Ne;0;4;0;4
8669;Rasa;Smalsučiai;3023088027;Ne;0;8;0;8
8670;Rasa;Smalsučiai;4758605343;Ne;0;4;0;4
8671;Rasa;Smalsučiai;3091012313;Ne;0;3;1;4
8672;Rasa;Smalsučiai;7558966891;Ne;6;3;1;10
8673;Rasa;Smalsučiai;6345614521;Ne;0;1;0;1
8674;Rasa;Smalsučiai;1651905746;Ne;0;10;0;10
8675;Rasa;Smalsučiai;1823276800;Ne;5;4;0;9
8676;Rasa;Smalsučiai;6773004268;Ne;0;3;2;5
8677;Rasa;Smalsučiai;1457384318;Ne;2;3;0;5
8678;Rasa;Smalsučiai;5325275053;Ne;0;4;6;10
8679;Rasa;Smalsučiai;2121070882;Ne;0;20;1;21
8680;Rasa;Smalsučiai;6704162447;Ne;0;6;0;6
8681;Rasa;Smalsučiai;4603188598;Ne;2;4;3;9
8682;Rasa;"Pelėdžiukai ";3387615841;Ne;1;3;0;4
8683;Rasa;"Pelėdžiukai ";8816116600;Ne;2;2;0;4
8684;Rasa;"Pelėdžiukai ";8455168346;Ne;6;0;4;10
8685;Rasa;"Pelėdžiukai ";3381468321;Ne;0;5;0;5
8686;Rasa;"Pelėdžiukai ";1261868339;Ne;0;5;6;11
8687;Rasa;"Pelėdžiukai ";6553479199;Ne;10;0;0;10
8688;Rasa;"Pelėdžiukai ";4947382314;Ne;0;2;0;2
8689;Rasa;"Pelėdžiukai ";2968464121;Ne;0;4;0;4
8690;Rasa;"Pelėdžiukai ";5816940902;Ne;9;0;1;10
8691;Rasa;"Pelėdžiukai ";4389917247;Ne;0;21;0;21
8692;Rasa;"Pelėdžiukai ";2123838514;Ne;0;17;0;17
8693;Rasa;"Pelėdžiukai ";1288177637;Ne;0;20;0;20
8694;Rasa;"Pelėdžiukai ";8403268732;Ne;0;8;0;8
8695;Rasa;"Pelėdžiukai ";4855210006;Ne;0;4;0;4
8696;Rasa;Katinėliai;5885520521;Ne;0;1;1;2
8697;Rasa;Katinėliai;5426981046;Ne;0;2;0;2
8698;Rasa;Katinėliai;6891623055;Ne;8;1;0;9
8699;Rasa;Katinėliai;9010812748;Ne;0;4;0;4
8700;Rasa;Katinėliai;7220007488;Ne;0;4;0;4
8701;Rasa;Katinėliai;8235869241;Ne;8;6;0;14
8702;Rasa;Katinėliai;2984661168;Ne;0;0;2;2
8703;Rasa;Katinėliai;4913483444;Ne;0;10;4;14
8704;Rasa;Katinėliai;4734775151;Ne;0;11;0;11
8705;Rasa;Katinėliai;4758138905;Ne;0;0;1;1
8706;Rasa;Katinėliai;9447346901;Ne;0;8;0;8
8707;Rasa;Katinėliai;3631124501;Ne;10;2;0;12
8708;Rasa;Katinėliai;9343039995;Ne;0;6;0;6
8709;Rasa;Katinėliai;4084236196;Ne;4;0;0;4
8710;Rasa;Katinėliai;4498966097;Ne;0;5;0;5
8711;Rasa;Katinėliai;3428261829;Ne;0;7;1;8
8712;Rasa;Katinėliai;2477057223;Ne;0;9;0;9
8713;Rasa;Katinėliai;5134342817;Ne;0;1;0;1
8714;Rasa;Katinėliai;9220749889;Ne;0;1;0;1
8715;Rasa;Ančiukai;6755131948;Ne;0;0;1;1
8716;Rasa;Ančiukai;1477018184;Ne;5;0;3;8
8717;Rasa;Ančiukai;4018241056;Ne;5;0;2;7
8718;Rasa;Ančiukai;1736903037;Ne;0;5;3;8
8719;Rasa;Ančiukai;4762348187;Ne;5;0;0;5
8720;Rasa;Ančiukai;7568880413;Ne;0;0;4;4
8721;Rasa;Ančiukai;8622210603;Ne;3;6;0;9
8722;Rasa;Ančiukai;1521328997;Ne;0;0;5;5
8723;Rasa;Ančiukai;3884782148;Ne;0;0;2;2
8724;Rasa;Ančiukai;8574946856;Ne;6;2;0;8
8725;Rasa;Ančiukai;6442933249;Ne;7;12;0;19
8726;Rasa;Ančiukai;4979105526;Ne;10;0;0;10
8727;Rasa;"Vyturiukai ";7028605422;Ne;5;0;0;5
8728;Rasa;"Vyturiukai ";9599510902;Ne;0;1;0;1
8729;Rasa;"Vyturiukai ";2800420481;Ne;0;7;0;7
8730;Rasa;"Vyturiukai ";5869253167;Ne;6;0;6;12
8731;Rasa;"Vyturiukai ";7037958994;Ne;3;5;0;8
8732;Rasa;"Vyturiukai ";8236785255;Ne;0;5;1;6
8733;Rasa;"Vyturiukai ";6887471189;Ne;0;1;3;4
8734;Rasa;"Vyturiukai ";4694111253;Ne;0;9;0;9
8735;Rasa;"Vyturiukai ";2347639286;Ne;0;1;4;5
8736;Rasa;"Vyturiukai ";1206005039;Ne;0;4;0;4
8737;Rasa;"Vyturiukai ";9788282861;Ne;14;4;0;18
8738;Rasa;"Vyturiukai ";2711923397;Ne;0;11;0;11
8739;Rasa;"Vyturiukai ";2769096357;Ne;12;0;0;12
8740;Rasa;"Vyturiukai ";6883073764;Ne;0;0;4;4
8741;Rasa;"Vyturiukai ";9706428782;Ne;8;3;0;11
8742;Rasa;"Vyturiukai ";7043271718;Ne;0;12;3;15
8743;Rasa;"Vyturiukai ";6575864256;Ne;12;0;1;13
8744;Rasa;Voveriukai;4111850024;Ne;0;3;0;3
8745;Rasa;Voveriukai;2190948879;Ne;0;17;0;17
8746;Rasa;Voveriukai;3546684695;Ne;5;5;0;10
8747;Rasa;Voveriukai;4010262461;Ne;9;0;0;9
8748;Rasa;Voveriukai;5740754301;Ne;0;0;2;2
8749;Rasa;Voveriukai;5977524939;Ne;1;0;5;6
8750;Rasa;Voveriukai;1592174114;Ne;0;0;10;10
8751;Rasa;Voveriukai;1564194649;Ne;10;0;0;10
8752;Rasa;Voveriukai;1764959761;Ne;0;0;9;9
8753;Rasa;Voveriukai;1765617605;Ne;0;0;1;1
8754;Rasa;Voveriukai;1733179752;Ne;0;1;0;1
8755;Rasa;Voveriukai;2895124729;Ne;0;12;0;12
8756;Rasa;Voveriukai;1679709767;Ne;0;4;0;4
8757;Rasa;Voveriukai;5622110823;Ne;0;6;1;7
8758;Rasa;Voveriukai;6221754830;Ne;11;2;0;13
8759;Rasa;Voveriukai;7218250981;Ne;0;13;0;13
8760;Rasa;"DRUGELIAI ";6621628020;Ne;8;0;1;9
8761;Rasa;"DRUGELIAI ";9959160342;Ne;8;0;1;9
8762;Rasa;"DRUGELIAI ";5761013588;Ne;6;0;1;7
8763;Rasa;"DRUGELIAI ";9506388242;Ne;0;14;0;14
8764;Rasa;"DRUGELIAI ";4188303400;Ne;7;0;0;7
8765;Rasa;"DRUGELIAI ";5483943978;Ne;0;3;0;3
8766;Rasa;"DRUGELIAI ";7251815682;Ne;18;0;0;18
8767;Rasa;"DRUGELIAI ";6291089659;Ne;0;0;8;8
8768;Rasa;"DRUGELIAI ";1575522555;Ne;18;0;1;19
8769;Rasa;Zuikučiai;7265752821;Ne;7;0;0;7
8770;Rasa;Zuikučiai;8027532547;Ne;0;3;5;8
8771;Rasa;Zuikučiai;3470054190;Ne;10;0;2;12
8772;Rasa;Zuikučiai;8180141204;Ne;0;5;0;5
8773;Rasa;Zuikučiai;7253736220;Ne;13;5;0;18
8774;Rasa;Zuikučiai;4940758709;Ne;13;4;0;17
8775;Rasa;Zuikučiai;7091899236;Ne;13;4;0;17
8776;Rasa;Zuikučiai;6574998939;Ne;5;4;0;9
8777;Rasa;Zuikučiai;4212798846;Ne;14;2;0;16
8778;Rasa;Zuikučiai;6505001743;Ne;7;0;0;7
8779;Rasa;Zuikučiai;6780996150;Ne;3;0;1;4
8780;Rasa;Zuikučiai;8159411349;Ne;3;5;0;8
8781;Rasa;Zuikučiai;8992548689;Ne;4;2;2;8
8782;Rasa;Širdelė;8424049317;Ne;5;1;1;7
8783;Rasa;Širdelė;8236464670;Ne;0;4;0;4
8784;Rasa;Širdelė;3668598028;Ne;0;10;0;10
8785;Rasa;Širdelė;2333938367;Ne;4;5;0;9
8786;Rasa;Širdelė;9560289781;Ne;0;1;0;1
8787;Rasa;Širdelė;5719253028;Ne;5;2;1;8
8788;Rasa;Širdelė;9140875020;Ne;10;12;0;22
8789;Rasa;Širdelė;5710220699;Ne;0;4;0;4
8790;Rasa;Širdelė;4694382836;Ne;1;2;0;3
8791;Rasa;Širdelė;1796573723;Ne;0;8;0;8
8792;Rasa;Širdelė;3535655117;Ne;0;4;0;4
8793;Rasa;Širdelė;4361959446;Ne;0;2;3;5
8794;Rasa;Širdelė;3215464914;Ne;7;6;0;13
8795;Rasa;Širdelė;6760723624;Ne;7;3;0;10
8796;Rasa;Širdelė;6606982242;Ne;0;4;0;4
8797;Rasa;Širdelė;1447258806;Ne;5;0;4;9
8798;Rasa;Širdelė;1627996663;Ne;7;13;0;20
8799;Riešutėlis;Viščiukų;7666200219;Ne;0;21;0;21
8800;Riešutėlis;Viščiukų;7071757771;Ne;2;0;0;2
8801;Riešutėlis;Viščiukų;6626441225;Ne;10;0;0;10
8802;Riešutėlis;Viščiukų;5013456470;Ne;12;0;0;12
8803;Riešutėlis;Viščiukų;6906373822;Ne;0;2;0;2
8804;Riešutėlis;Viščiukų;4636191548;Ne;5;0;1;6
8805;Riešutėlis;Viščiukų;2493171003;Ne;11;0;2;13
8806;Riešutėlis;Viščiukų;5133625078;Ne;4;4;0;8
8807;Riešutėlis;Viščiukų;2235912189;Ne;0;0;1;1
8808;Riešutėlis;Viščiukų;9864636983;Ne;12;0;0;12
8809;Riešutėlis;Viščiukų;4429903561;Ne;5;0;0;5
8810;Riešutėlis;Viščiukų;5317904812;Ne;0;0;2;2
8811;Riešutėlis;Viščiukų;8235524536;Ne;15;0;0;15
8812;Riešutėlis;Viščiukų;7795124495;Ne;5;0;2;7
8813;Riešutėlis;Viščiukų;2832538856;Ne;16;5;0;21
8814;Riešutėlis;Viščiukų;3730909181;Ne;12;0;0;12
8815;Riešutėlis;Viščiukų;9341748384;Ne;0;8;3;11
8816;Riešutėlis;"Riešutėliai ";3800733442;Ne;3;2;1;6
8817;Riešutėlis;"Riešutėliai ";2117939721;Ne;9;0;1;10
8818;Riešutėlis;"Riešutėliai ";1343776985;Ne;10;0;0;10
8819;Riešutėlis;"Riešutėliai ";5915019363;Ne;6;2;0;8
8820;Riešutėlis;"Riešutėliai ";2207907790;Ne;5;1;0;6
8821;Riešutėlis;"Riešutėliai ";9699503472;Ne;0;0;10;10
8822;Riešutėlis;"Riešutėliai ";2098369052;Ne;17;0;0;17
8823;Riešutėlis;"Riešutėliai ";1426700414;Ne;15;0;0;15
8824;Riešutėlis;"Riešutėliai ";8539906445;Ne;1;1;0;2
8825;Riešutėlis;"Riešutėliai ";5873443383;Ne;8;0;0;8
8826;Riešutėlis;"Riešutėliai ";2301247729;Ne;0;3;0;3
8827;Riešutėlis;"Riešutėliai ";3602707130;Ne;11;1;0;12
8828;Riešutėlis;"Riešutėliai ";8991963843;Ne;5;2;1;8
8829;Riešutėlis;"Riešutėliai ";9318640304;Ne;0;0;3;3
8830;Riešutėlis;"Riešutėliai ";4293402095;Ne;9;2;2;13
8831;Riešutėlis;"Riešutėliai ";8917451081;Ne;14;0;0;14
8832;Riešutėlis;"Riešutėliai ";4698338374;Ne;5;4;0;9
8833;Riešutėlis;"Riešutėliai ";3345064565;Ne;15;0;0;15
8834;Riešutėlis;"Riešutėliai ";2560507294;Ne;2;0;0;2
8835;Riešutėlis;"Riešutėliai ";9078282526;Ne;0;1;6;7
8836;Riešutėlis;"Riešutėliai ";6762306583;Ne;11;1;0;12
8837;Riešutėlis;Ežiukai;7030346495;Ne;5;15;0;20
8838;Riešutėlis;Ežiukai;9750713954;Ne;11;0;0;11
8839;Riešutėlis;Ežiukai;7601776182;Ne;0;1;0;1
8840;Riešutėlis;Ežiukai;7381623086;Ne;9;0;0;9
8841;Riešutėlis;Ežiukai;9964688413;Ne;5;0;0;5
8842;Riešutėlis;Ežiukai;8954127616;Ne;12;2;1;15
8843;Riešutėlis;Ežiukai;2092933906;Ne;0;10;0;10
8844;Riešutėlis;Ežiukai;6813024366;Ne;0;5;0;5
8845;Riešutėlis;Ežiukai;3460145784;Ne;9;0;0;9
8846;Riešutėlis;Ežiukai;8480059272;Ne;3;5;0;8
8847;Riešutėlis;Ežiukai;5728858361;Ne;3;0;0;3
8848;Riešutėlis;Ežiukai;5327627748;Ne;0;4;0;4
8849;Riešutėlis;Ežiukai;6259158270;Ne;9;0;0;9
8850;Riešutėlis;Ežiukai;6194259707;Ne;3;0;0;3
8851;Riešutėlis;Ežiukai;2837471235;Ne;0;10;0;10
8852;Riešutėlis;Ežiukai;2699984170;Ne;0;11;0;11
8853;Riešutėlis;Ežiukai;7050440691;Ne;0;1;10;11
8854;Riešutėlis;Ežiukai;3577669231;Ne;0;6;0;6
8855;Riešutėlis;Ežiukai;9670912357;Ne;6;2;0;8
8856;Riešutėlis;Ežiukai;1818130297;Ne;0;1;0;1
8857;Riešutėlis;Ežiukai;6284614328;Ne;0;1;3;4
8858;Riešutėlis;Pelėdžiukai;1705599429;Ne;15;4;1;20
8859;Riešutėlis;Pelėdžiukai;2467739101;Ne;7;2;0;9
8860;Riešutėlis;Pelėdžiukai;2587460110;Ne;22;0;0;22
8861;Riešutėlis;Pelėdžiukai;6147780439;Ne;11;1;0;12
8862;Riešutėlis;Pelėdžiukai;3287685792;Ne;6;0;0;6
8863;Riešutėlis;Pelėdžiukai;1811701628;Ne;8;0;0;8
8864;Riešutėlis;Pelėdžiukai;5183264581;Ne;7;2;0;9
8865;Riešutėlis;Pelėdžiukai;4866613045;Ne;7;0;2;9
8866;Riešutėlis;Pelėdžiukai;6121386391;Ne;21;0;0;21
8867;Riešutėlis;Pelėdžiukai;4448024452;Ne;6;0;0;6
8868;Riešutėlis;Pelėdžiukai;3251066115;Ne;0;7;0;7
8869;Riešutėlis;Pelėdžiukai;4808684145;Ne;4;6;1;11
8870;Riešutėlis;Pelėdžiukai;4897581681;Ne;21;0;0;21
8871;Riešutėlis;Pelėdžiukai;7256075146;Ne;0;6;0;6
8872;Riešutėlis;Pelėdžiukai;5443448616;Ne;9;3;0;12
8873;Riešutėlis;Pelėdžiukai;9598824163;Ne;8;1;0;9
8874;Riešutėlis;Pelėdžiukai;8839482370;Ne;12;0;0;12
8875;Riešutėlis;Pelėdžiukai;4692384639;Ne;0;0;6;6
8876;Riešutėlis;Meškiukai;5537309549;Ne;0;1;0;1
8877;Riešutėlis;Meškiukai;1091941952;Ne;0;3;0;3
8878;Riešutėlis;Meškiukai;8271632629;Ne;0;4;0;4
8879;Riešutėlis;Meškiukai;2097580659;Ne;0;1;0;1
8880;Riešutėlis;Meškiukai;8313605541;Ne;0;5;0;5
8881;Riešutėlis;Meškiukai;7987368969;Ne;0;6;0;6
8882;Riešutėlis;Meškiukai;65873300738;Ne;0;9;0;9
8883;Riešutėlis;Meškiukai;26781529460;Ne;5;1;2;8
8884;Riešutėlis;Meškiukai;1936519033;Ne;0;9;1;10
8885;Riešutėlis;Meškiukai;4131218911;Ne;7;9;0;16
8886;Riešutėlis;Meškiukai;4276034784;Ne;0;2;0;2
8887;Riešutėlis;Meškiukai;4344185375;Ne;0;1;0;1
8888;Riešutėlis;Meškiukai;6594928740;Ne;3;4;0;7
8889;Riešutėlis;Meškiukai;1623681835;Ne;0;2;0;2
8890;Riešutėlis;Meškiukai;2566084613;Ne;2;4;0;6
8891;Riešutėlis;Meškiukai;1640383686;Ne;5;0;0;5
8892;Riešutėlis;Meškiukai;8087180983;Ne;5;4;2;11
8893;Riešutėlis;Meškiukai;16561622902;Ne;2;4;0;6
8894;Riešutėlis;Meškiukai;2611705234;Ne;0;8;0;8
8895;Riešutėlis;Meškiukai;4404544549;Ne;5;7;0;12
8896;Riešutėlis;Meškiukai;1709857621;Ne;0;2;0;2
8897;Riešutėlis;Kiškučiai;9297835044;Ne;7;0;0;7
8898;Riešutėlis;Kiškučiai;9086474785;Ne;7;5;0;12
8899;Riešutėlis;Kiškučiai;3363757821;Ne;16;0;0;16
8900;Riešutėlis;Kiškučiai;2581250615;Ne;0;0;7;7
8901;Riešutėlis;Kiškučiai;8445984114;Ne;21;1;0;22
8902;Riešutėlis;Kiškučiai;5266946070;Ne;9;0;0;9
8903;Riešutėlis;Kiškučiai;9357375649;Ne;7;4;0;11
8904;Riešutėlis;Kiškučiai;9548551553;Ne;2;0;0;2
8905;Riešutėlis;Kiškučiai;9500744921;Ne;7;1;0;8
8906;Riešutėlis;Kiškučiai;4851336076;Ne;0;13;0;13
8907;Riešutėlis;Kiškučiai;6705754238;Ne;10;0;0;10
8908;Riešutėlis;Kiškučiai;1111543507;Ne;0;2;0;2
8909;Riešutėlis;Kiškučiai;9964105252;Ne;9;1;1;11
8910;Riešutėlis;Kiškučiai;5846061115;Ne;0;2;0;2
8911;Riešutėlis;Kiškučiai;2618556733;Ne;9;7;5;21
8912;Riešutėlis;Kiškučiai;9995814717;Ne;6;0;2;8
8913;Riešutėlis;Kiškučiai;5738764214;Ne;0;0;3;3
8914;Riešutėlis;Voveriukų;5995176001;Ne;0;7;0;7
8915;Riešutėlis;Voveriukų;5598052531;Ne;0;1;0;1
8916;Riešutėlis;Voveriukų;8751571852;Ne;5;0;0;5
8917;Riešutėlis;Voveriukų;5282039544;Ne;0;1;0;1
8918;Riešutėlis;Voveriukų;2430518637;Ne;2;4;1;7
8919;Riešutėlis;Voveriukų;1457008581;Ne;0;4;0;4
8920;Riešutėlis;Voveriukų;1638021880;Ne;0;2;0;2
8921;Riešutėlis;Voveriukų;7225365172;Ne;0;2;0;2
8922;Riešutėlis;Voveriukų;8750531305;Ne;2;5;0;7
8923;Riešutėlis;Voveriukų;5479780116;Ne;0;6;0;6
8924;Riešutėlis;Voveriukų;9839084885;Ne;0;4;0;4
8925;Riešutėlis;Voveriukų;4451419273;Ne;0;15;0;15
8926;Riešutėlis;Voveriukų;9040123535;Ne;0;2;0;2
8927;Riešutėlis;Voveriukų;6928558714;Ne;0;1;0;1
8928;Riešutėlis;Voveriukų;8012201566;Ne;5;7;0;12
8929;Riešutėlis;Voveriukų;4581184004;Ne;8;4;0;12
8930;Riešutėlis;Voveriukų;1941869661;Ne;0;2;0;2
8931;Riešutėlis;Voveriukų;9023304543;Ne;0;7;0;7
8932;Riešutėlis;Saulutės;4004669930;Taip;0;6;4;10
8933;Riešutėlis;Saulutės;7177632315;Ne;5;0;0;5
8934;Riešutėlis;Saulutės;6721758785;Ne;0;2;2;4
8935;Riešutėlis;Saulutės;3694146893;Ne;0;2;0;2
8936;Riešutėlis;Saulutės;1748151109;Ne;0;4;1;5
8937;Riešutėlis;Saulutės;8504832383;Ne;2;5;0;7
8938;Riešutėlis;Saulutės;6292679662;Ne;0;0;2;2
8939;Riešutėlis;Saulutės;8738716660;Ne;0;4;4;8
8940;Riešutėlis;Saulutės;4828635362;Ne;5;0;0;5
8941;Riešutėlis;Saulutės;6635909614;Ne;0;4;0;4
8942;Riešutėlis;Saulutės;1196740726;Ne;0;6;1;7
8943;Riešutėlis;Saulutės;4498718519;Ne;0;9;1;10
8944;Riešutėlis;Saulutės;5753609922;Ne;12;2;0;14
8945;Riešutėlis;Saulutės;1860995033;Ne;0;13;8;21
8946;Riešutėlis;Saulutės;5013754772;Ne;0;1;6;7
8947;Riešutėlis;Saulutės;7154361660;Ne;14;6;0;20
8948;Riešutėlis;Saulutės;2395391926;Ne;0;6;0;6
8949;Riešutėlis;Saulutės;2572642260;Ne;13;0;0;13
8950;Riešutėlis;Saulutės;3544780386;Ne;0;0;6;6
8951;Riešutėlis;"Boruželės ";4118652467;Taip;0;21;0;21
8952;Riešutėlis;"Boruželės ";5662911204;Ne;0;1;5;6
8953;Riešutėlis;"Boruželės ";7663823906;Ne;7;5;0;12
8954;Riešutėlis;"Boruželės ";7327578507;Ne;3;0;0;3
8955;Riešutėlis;"Boruželės ";6368610810;Ne;11;0;0;11
8956;Riešutėlis;"Boruželės ";7313602281;Ne;0;0;5;5
8957;Riešutėlis;"Boruželės ";9296178632;Ne;0;7;0;7
8958;Riešutėlis;"Boruželės ";6681930005;Ne;7;0;0;7
8959;Riešutėlis;"Boruželės ";2352984379;Ne;5;11;5;21
8960;Riešutėlis;"Boruželės ";3152100512;Ne;10;0;0;10
8961;Riešutėlis;"Boruželės ";2238641969;Ne;5;1;0;6
8962;Riešutėlis;"Boruželės ";6217500325;Ne;0;21;0;21
8963;Riešutėlis;"Boruželės ";1058206787;Ne;10;0;0;10
8964;Riešutėlis;"Boruželės ";9198289423;Ne;11;1;0;12
8965;Riešutėlis;"Boruželės ";1282121190;Ne;7;1;0;8
8966;Riešutėlis;"Boruželės ";7259198785;Ne;4;0;0;4
8967;Riešutėlis;"Boruželės ";2875416610;Ne;5;0;0;5
8968;Riešutėlis;"Bitutės ";2498093110;Taip;5;1;0;6
8969;Riešutėlis;"Bitutės ";2459494071;Ne;0;0;2;2
8970;Riešutėlis;"Bitutės ";3931422170;Ne;0;0;11;11
8971;Riešutėlis;"Bitutės ";8265627960;Ne;0;8;0;8
8972;Riešutėlis;"Bitutės ";4591910912;Ne;6;1;0;7
8973;Riešutėlis;"Bitutės ";9285782325;Ne;0;11;0;11
8974;Riešutėlis;"Bitutės ";8996456595;Ne;0;1;0;1
8975;Riešutėlis;"Bitutės ";3475897400;Ne;9;0;0;9
8976;Riešutėlis;"Bitutės ";3592271009;Taip;13;3;0;16
8977;Riešutėlis;"Bitutės ";6815804556;Ne;6;0;2;8
8978;Riešutėlis;"Bitutės ";1626888090;Ne;0;1;2;3
8979;Riešutėlis;"Bitutės ";4358354602;Ne;0;2;0;2
8980;Riešutėlis;Drugelių;8266735624;Ne;0;6;0;6
8981;Riešutėlis;Drugelių;4776231497;Ne;5;4;0;9
8982;Riešutėlis;Drugelių;4221375847;Ne;0;2;0;2
8983;Riešutėlis;Drugelių;1075842434;Ne;0;4;0;4
8984;Riešutėlis;Drugelių;1942944625;Ne;0;2;0;2
8985;Riešutėlis;Drugelių;8845709386;Ne;0;11;0;11
8986;Riešutėlis;Drugelių;8128352818;Ne;1;0;0;1
8987;Riešutėlis;Drugelių;8352146446;Ne;10;0;0;10
8988;Riešutėlis;Drugelių;8180618419;Ne;0;5;0;5
8989;Riešutėlis;Drugelių;5412882446;Ne;0;1;7;8
8990;Riešutėlis;Drugelių;8020533200;Ne;8;4;2;14
8991;Riešutėlis;Drugelių;1164273595;Ne;0;1;0;1
8992;Riešutėlis;Drugelių;8918753084;Ne;0;1;2;3
8993;Riešutėlis;Drugelių;3836374000;Ne;0;4;0;4
8994;Riešutėlis;Drugelių;3975091711;Ne;3;0;0;3
8995;Riešutėlis;Drugelių;3071643137;Ne;1;0;0;1
8996;Riešutėlis;Drugelių;2599147931;Ne;0;4;3;7
8997;Riešutėlis;Drugelių;3151689985;Ne;0;1;0;1
8998;Riešutėlis;Nykštukų;1858791074;Ne;19;0;0;19
8999;Riešutėlis;Nykštukų;1006119133;Ne;0;0;5;5
9000;Riešutėlis;Nykštukų;3759837057;Ne;3;0;5;8
9001;Riešutėlis;Nykštukų;4740516426;Ne;10;0;0;10
9002;Riešutėlis;Nykštukų;3150141050;Ne;7;5;0;12
9003;Riešutėlis;Nykštukų;6580050526;Ne;6;1;0;7
9004;Riešutėlis;Nykštukų;4810919435;Ne;0;1;5;6
9005;Riešutėlis;Nykštukų;2736824231;Ne;12;0;0;12
9006;Riešutėlis;Nykštukų;2378301886;Ne;14;0;1;15
9007;Riešutėlis;Nykštukų;2483793992;Ne;9;0;1;10
9008;Riešutėlis;Nykštukų;5262881964;Ne;0;0;2;2
9009;Riešutėlis;Nykštukų;4328166135;Ne;8;2;1;11
9010;Riešutėlis;Nykštukų;9052991215;Ne;0;8;4;12
9011;Riešutėlis;Nykštukų;6582898708;Taip;8;0;0;8
9012;Riešutėlis;Nykštukų;6318150385;Ne;20;0;0;20
9013;Riešutėlis;Nykštukų;4042719626;Ne;6;0;0;6
9014;Riešutėlis;Nykštukų;5078051087;Ne;10;0;0;10
9015;Riešutėlis;Nykštukų;3249196007;Ne;6;0;1;7
9016;Ramunėlė;SAULUTĖS;3852734401;Ne;5;1;0;6
9017;Ramunėlė;SAULUTĖS;1192743154;Ne;0;7;0;7
9018;Ramunėlė;SAULUTĖS;5714771643;Ne;0;4;0;4
9019;Ramunėlė;SAULUTĖS;1483391590;Ne;0;6;1;7
9020;Ramunėlė;SAULUTĖS;9927068798;Ne;0;1;0;1
9021;Ramunėlė;SAULUTĖS;7219400182;Ne;0;4;0;4
9022;Ramunėlė;SAULUTĖS;3779769727;Ne;0;9;0;9
9023;Ramunėlė;SAULUTĖS;5605444408;Ne;0;2;0;2
9024;Ramunėlė;SAULUTĖS;1618282165;Ne;0;0;6;6
9025;Ramunėlė;SAULUTĖS;9533155706;Ne;5;2;0;7
9026;Ramunėlė;SAULUTĖS;6595858698;Ne;0;1;0;1
9027;Ramunėlė;SAULUTĖS;3109623760;Ne;1;0;3;4
9028;Ramunėlė;SAULUTĖS;2697757513;Ne;14;0;1;15
9029;Ramunėlė;ŽIBUTĖ;4715809064;Ne;0;5;0;5
9030;Ramunėlė;ŽIBUTĖ;5315953299;Ne;0;5;0;5
9031;Ramunėlė;ŽIBUTĖ;2173425836;Ne;0;4;1;5
9032;Ramunėlė;ŽIBUTĖ;2686455030;Ne;5;2;1;8
9033;Ramunėlė;ŽIBUTĖ;5650659504;Ne;0;1;0;1
9034;Ramunėlė;ŽIBUTĖ;6627399830;Ne;0;2;8;10
9035;Ramunėlė;ŽIBUTĖ;8726443989;Ne;4;0;0;4
9036;Ramunėlė;ŽIBUTĖ;5801760033;Ne;0;4;0;4
9037;Ramunėlė;ŽIBUTĖ;6389008823;Ne;7;2;0;9
9038;Ramunėlė;ŽIBUTĖ;9136437288;Ne;0;1;0;1
9039;Ramunėlė;ŽIBUTĖ;6040461460;Ne;4;2;0;6
9040;Ramunėlė;ŽIBUTĖ;2605941371;Ne;2;1;0;3
9041;Ramunėlė;ŽIBUTĖ;7010828978;Ne;2;0;0;2
9042;Ramunėlė;ŽIBUTĖ;3879563193;Ne;5;4;0;9
9043;Ramunėlė;ŽIBUTĖ;2591052434;Ne;0;2;0;2
9044;Ramunėlė;ŽIBUTĖ;2446375037;Ne;0;4;3;7
9045;Ramunėlė;ŽIBUTĖ;6606802660;Ne;6;0;0;6
9046;Ramunėlė;ŽIBUTĖ;3525444906;Ne;0;1;0;1
9047;Ramunėlė;ŽIBUTĖ;8055844166;Ne;4;4;0;8
9048;Ramunėlė;ŽIRNIUKAI;7721421570;Ne;0;7;0;7
9049;Ramunėlė;ŽIRNIUKAI;8942483792;Ne;5;0;7;12
9050;Ramunėlė;ŽIRNIUKAI;9994445948;Ne;5;0;0;5
9051;Ramunėlė;ŽIRNIUKAI;6674467484;Ne;0;14;0;14
9052;Ramunėlė;ŽIRNIUKAI;7593855877;Ne;0;1;0;1
9053;Ramunėlė;ŽIRNIUKAI;2177200537;Ne;0;2;1;3
9054;Ramunėlė;ŽIRNIUKAI;7026935746;Ne;0;1;0;1
9055;Ramunėlė;ŽIRNIUKAI;5581693652;Ne;0;1;0;1
9056;Ramunėlė;ŽIRNIUKAI;4269170508;Ne;11;0;5;16
9057;Ramunėlė;ŽIRNIUKAI;4076525701;Ne;0;0;6;6
9058;Ramunėlė;ŽIRNIUKAI;4139935502;Ne;14;0;0;14
9059;Ramunėlė;ŽIRNIUKAI;1833069020;Ne;13;4;0;17
9060;Ramunėlė;ŽIRNIUKAI;4875011312;Ne;4;1;0;5
9061;Ramunėlė;ŽIRNIUKAI;4084046207;Ne;19;2;0;21
9062;Ramunėlė;ŽIRNIUKAI;5017020616;Ne;0;1;0;1
9063;Ramunėlė;ŽIRNIUKAI;6458458913;Ne;0;1;0;1
9064;Ramunėlė;ŽIRNIUKAI;4805808663;Ne;12;2;0;14
9065;Ramunėlė;BITUTĖS;8098492540;Ne;0;8;0;8
9066;Ramunėlė;BITUTĖS;6329943991;Ne;0;4;13;17
9067;Ramunėlė;BITUTĖS;2225787182;Ne;0;9;0;9
9068;Ramunėlė;BITUTĖS;6166192468;Ne;0;2;0;2
9069;Ramunėlė;BITUTĖS;5865482869;Ne;0;9;0;9
9070;Ramunėlė;BITUTĖS;6843262303;Ne;0;0;4;4
9071;Ramunėlė;BITUTĖS;7692958269;Ne;0;7;5;12
9072;Ramunėlė;BITUTĖS;5822045625;Ne;0;0;6;6
9073;Ramunėlė;BITUTĖS;9789690425;Ne;0;10;0;10
9074;Ramunėlė;BITUTĖS;1182350830;Ne;8;0;4;12
9075;Ramunėlė;BITUTĖS;6342801407;Ne;0;6;2;8
9076;Ramunėlė;BITUTĖS;4022818032;Ne;9;1;0;10
9077;Ramunėlė;BITUTĖS;7220407572;Ne;10;0;0;10
9078;Ramunėlė;BITUTĖS;1916520056;Ne;15;5;0;20
9079;Ramunėlė;BITUTĖS;2245564567;Ne;0;2;0;2
9080;Ramunėlė;BITUTĖS;6870110390;Ne;0;2;0;2
9081;Ramunėlė;BITUTĖS;6892481929;Ne;0;6;0;6
9082;Ramunėlė;BITUTĖS;2558296296;Ne;5;0;4;9
9083;Ramunėlė;BITUTĖS;6881228078;Ne;0;11;0;11
9084;Ramunėlė;DRUGELIAI;9584620339;Ne;0;0;10;10
9085;Ramunėlė;DRUGELIAI;6930505887;Ne;0;2;1;3
9086;Ramunėlė;DRUGELIAI;8402889872;Ne;2;6;1;9
9087;Ramunėlė;DRUGELIAI;7228065409;Ne;0;11;0;11
9088;Ramunėlė;DRUGELIAI;5170325023;Ne;0;1;3;4
9089;Ramunėlė;DRUGELIAI;3617897977;Ne;0;1;1;2
9090;Ramunėlė;DRUGELIAI;8768539595;Ne;0;9;0;9
9091;Ramunėlė;DRUGELIAI;7955507702;Ne;7;0;0;7
9092;Ramunėlė;DRUGELIAI;1078618047;Ne;1;19;0;20
9093;Ramunėlė;DRUGELIAI;9984243153;Ne;5;1;0;6
9094;Ramunėlė;DRUGELIAI;1199673371;Ne;0;1;2;3
9095;Ramunėlė;DRUGELIAI;5049415445;Ne;0;0;1;1
9096;Ramunėlė;DRUGELIAI;8460527225;Ne;0;13;0;13
9097;Ramunėlė;DRUGELIAI;1800967823;Ne;2;0;0;2
9098;Ramunėlė;DRUGELIAI;8205893352;Ne;5;2;0;7
9099;Ramunėlė;DRUGELIAI;6809164145;Ne;5;2;0;7
9100;Ramunėlė;DRUGELIAI;6837877393;Ne;16;2;0;18
9101;Ramunėlė;NEUŽMIRŠTUOLĖS;1797997937;Ne;8;0;0;8
9102;Ramunėlė;NEUŽMIRŠTUOLĖS;9326288662;Ne;3;0;0;3
9103;Ramunėlė;NEUŽMIRŠTUOLĖS;9928703066;Ne;3;2;0;5
9104;Ramunėlė;NEUŽMIRŠTUOLĖS;4756689520;Ne;0;6;0;6
9105;Ramunėlė;NEUŽMIRŠTUOLĖS;2070729684;Ne;0;2;0;2
9106;Ramunėlė;NEUŽMIRŠTUOLĖS;4329292281;Ne;8;4;0;12
9107;Ramunėlė;NEUŽMIRŠTUOLĖS;6613469006;Ne;0;9;0;9
9108;Ramunėlė;NEUŽMIRŠTUOLĖS;3742982547;Ne;0;5;0;5
9109;Ramunėlė;NEUŽMIRŠTUOLĖS;3106987206;Ne;5;0;0;5
9110;Ramunėlė;NEUŽMIRŠTUOLĖS;2281370785;Ne;0;1;0;1
9111;Ramunėlė;NEUŽMIRŠTUOLĖS;8643188779;Ne;14;0;2;16
9112;Ramunėlė;NEUŽMIRŠTUOLĖS;9012749913;Ne;13;3;0;16
9113;Ramunėlė;NEUŽMIRŠTUOLĖS;1728034615;Ne;5;0;0;5
9114;Ramunėlė;NEUŽMIRŠTUOLĖS;1579527330;Ne;0;23;0;23
9115;Ramunėlė;NEUŽMIRŠTUOLĖS;7519551613;Ne;0;10;0;10
9116;Ramunėlė;NEUŽMIRŠTUOLĖS;2880352109;Ne;19;0;2;21
9117;Ramunėlė;NEUŽMIRŠTUOLĖS;3949246652;Ne;20;0;0;20
9118;Ramunėlė;NEUŽMIRŠTUOLĖS;3045477012;Ne;7;8;0;15
9119;Ramunėlė;NEUŽMIRŠTUOLĖS;5267145991;Ne;1;10;0;11
9120;Ramunėlė;NEUŽMIRŠTUOLĖS;1181787182;Ne;9;0;0;9
9121;Ramunėlė;OBUOLIUKAI;3683181174;Ne;0;4;1;5
9122;Ramunėlė;OBUOLIUKAI;7364976547;Ne;3;4;2;9
9123;Ramunėlė;OBUOLIUKAI;6156792400;Ne;0;9;0;9
9124;Ramunėlė;OBUOLIUKAI;4233978236;Ne;0;5;0;5
9125;Ramunėlė;OBUOLIUKAI;2983986428;Ne;0;23;0;23
9126;Ramunėlė;OBUOLIUKAI;5548358138;Ne;0;1;0;1
9127;Ramunėlė;OBUOLIUKAI;2422656007;Ne;0;6;4;10
9128;Ramunėlė;OBUOLIUKAI;8623311748;Ne;4;7;0;11
9129;Ramunėlė;OBUOLIUKAI;6849205606;Ne;4;0;0;4
9130;Ramunėlė;OBUOLIUKAI;6604244856;Ne;0;1;0;1
9131;Ramunėlė;OBUOLIUKAI;8617271247;Ne;10;2;0;12
9132;Ramunėlė;OBUOLIUKAI;6413888803;Ne;0;2;0;2
9133;Ramunėlė;OBUOLIUKAI;5610672420;Ne;11;3;0;14
9134;Ramunėlė;OBUOLIUKAI;4400154355;Ne;0;0;1;1
9135;Ramunėlė;OBUOLIUKAI;7250951221;Ne;0;2;0;2
9136;Ramunėlė;OBUOLIUKAI;3802924434;Ne;5;4;2;11
9137;Ramunėlė;OBUOLIUKAI;6981729247;Ne;13;2;1;16
9138;Ramunėlė;SAULĖGRĄŽA;7836959157;Ne;6;0;0;6
9139;Ramunėlė;SAULĖGRĄŽA;9663304288;Ne;10;0;4;14
9140;Ramunėlė;SAULĖGRĄŽA;5398069413;Ne;10;0;2;12
9141;Ramunėlė;SAULĖGRĄŽA;7873462803;Ne;4;0;1;5
9142;Ramunėlė;SAULĖGRĄŽA;3793779715;Ne;0;0;2;2
9143;Ramunėlė;SAULĖGRĄŽA;6775947111;Ne;0;0;26;26
9144;Ramunėlė;SAULĖGRĄŽA;1102946363;Ne;7;0;6;13
9145;Ramunėlė;SAULĖGRĄŽA;3801952385;Ne;5;1;0;6
9146;Ramunėlė;SAULĖGRĄŽA;9120142666;Ne;3;0;1;4
9147;Ramunėlė;SAULĖGRĄŽA;6942789511;Ne;6;0;0;6
9148;Ramunėlė;SAULĖGRĄŽA;2415377154;Ne;0;7;0;7
9149;Ramunėlė;SAULĖGRĄŽA;9076692864;Ne;3;2;0;5
9150;Ramunėlė;BORUŽĖLĖS;7825538259;Ne;4;3;0;7
9151;Ramunėlė;BORUŽĖLĖS;8496322672;Ne;0;1;0;1
9152;Ramunėlė;BORUŽĖLĖS;6695672297;Ne;5;2;0;7
9153;Ramunėlė;BORUŽĖLĖS;7295041630;Ne;0;1;0;1
9154;Ramunėlė;BORUŽĖLĖS;58028743912;Ne;3;2;1;6
9155;Ramunėlė;BORUŽĖLĖS;7750405604;Ne;6;0;0;6
9156;Ramunėlė;BORUŽĖLĖS;1216101539;Ne;0;9;0;9
9157;Ramunėlė;BORUŽĖLĖS;2499280049;Ne;0;2;0;2
9158;Ramunėlė;BORUŽĖLĖS;4677819736;Ne;8;0;1;9
9159;Ramunėlė;BORUŽĖLĖS;4349250416;Ne;0;5;0;5
9160;Ramunėlė;BORUŽĖLĖS;3554787356;Ne;0;5;3;8
9161;Ramunėlė;BORUŽĖLĖS;6310921755;Ne;0;3;0;3
9162;Ramunėlė;BORUŽĖLĖS;3685786758;Ne;0;6;0;6
9163;Ramunėlė;BORUŽĖLĖS;3566074517;Ne;0;4;0;4
9164;Ramunėlė;BORUŽĖLĖS;6837072361;Ne;4;6;0;10
9165;Ramunėlė;BORUŽĖLĖS;1534723406;Ne;0;5;2;7
9166;Ramunėlė;BORUŽĖLĖS;8323020864;Ne;6;0;0;6
9167;Ramunėlė;BORUŽĖLĖS;10704826206;Ne;5;3;0;8
9168;Ramunėlė;BORUŽĖLĖS;3065727741;Ne;8;0;0;8
9169;Ramunėlė;BORUŽĖLĖS;9924675250;Ne;0;4;0;4
9170;Ramunėlė;BORUŽĖLĖS;6251432968;Ne;0;2;0;2
9171;Ramunėlė;NYKŠTUKAS;3166386231;Ne;2;2;0;4
9172;Ramunėlė;NYKŠTUKAS;8045080504;Ne;6;3;0;9
9173;Ramunėlė;NYKŠTUKAS;7955197522;Ne;0;2;0;2
9174;Ramunėlė;NYKŠTUKAS;6983139076;Ne;14;0;0;14
9175;Ramunėlė;NYKŠTUKAS;7639613472;Ne;0;17;0;17
9176;Ramunėlė;NYKŠTUKAS;4642590173;Ne;6;6;0;12
9177;Ramunėlė;NYKŠTUKAS;9549605315;Ne;3;0;0;3
9178;Ramunėlė;NYKŠTUKAS;4491147309;Ne;8;0;2;10
9179;Ramunėlė;NYKŠTUKAS;4040520907;Ne;3;1;0;4
9180;Ramunėlė;NYKŠTUKAS;1215510902;Ne;5;3;0;8
9181;Ramunėlė;NYKŠTUKAS;8218201930;Ne;3;14;0;17
9182;Ramunėlė;NYKŠTUKAS;2760710235;Ne;4;0;0;4
9183;Ramunėlė;NYKŠTUKAS;5573083546;Ne;0;2;1;3
9184;Ramunėlė;NYKŠTUKAS;4376812983;Taip;7;0;1;8
9185;Ramunėlė;NYKŠTUKAS;1802650607;Ne;12;0;0;12
9186;Ramunėlė;UOGELĖ;6294697776;Ne;5;9;0;14
9187;Ramunėlė;UOGELĖ;7005354909;Ne;0;1;0;1
9188;Ramunėlė;UOGELĖ;5665429647;Ne;9;2;0;11
9189;Ramunėlė;UOGELĖ;9180197156;Ne;9;0;0;9
9190;Ramunėlė;UOGELĖ;5108864184;Ne;8;0;0;8
9191;Ramunėlė;UOGELĖ;4321527067;Taip;12;11;1;24
9192;Ramunėlė;UOGELĖ;2202879286;Ne;0;1;0;1
9193;Ramunėlė;UOGELĖ;7896711579;Ne;10;3;0;13
9194;Ramunėlė;UOGELĖ;5726947811;Ne;0;3;0;3
9195;Ramunėlė;UOGELĖ;4171905362;Ne;0;2;0;2
9196;Ramunėlė;UOGELĖ;1729152997;Ne;5;5;0;10
9197;Ramunėlė;UOGELĖ;8764042799;Ne;0;1;0;1
9198;Ramunėlė;UOGELĖ;7926168752;Ne;5;0;3;8
9199;Ramunėlė;UOGELĖ;5498856861;Ne;19;0;0;19
9200;Ramunėlė;UOGELĖ;3024065664;Ne;0;10;0;10
9201;Ramunėlė;UOGELĖ;1666033483;Ne;4;1;0;5
9202;Ramunėlė;UOGELĖ;9994601365;Ne;7;8;3;18
9203;Ramunėlė;UOGELĖ;2620747378;Ne;19;0;0;19
9204;Ramunėlė;VARPELIAI;1159457001;Ne;7;2;2;11
9205;Ramunėlė;VARPELIAI;9292235402;Ne;4;0;1;5
9206;Ramunėlė;VARPELIAI;1811931985;Ne;0;8;0;8
9207;Ramunėlė;VARPELIAI;1818513881;Ne;8;3;1;12
9208;Ramunėlė;VARPELIAI;4581826404;Ne;3;2;0;5
9209;Ramunėlė;VARPELIAI;8310875815;Ne;4;5;0;9
9210;Ramunėlė;VARPELIAI;1491688322;Ne;0;6;0;6
9211;Ramunėlė;VARPELIAI;5703289545;Ne;0;0;2;2
9212;Ramunėlė;VARPELIAI;9934852622;Ne;0;10;0;10
9213;Ramunėlė;VARPELIAI;4968998913;Ne;0;0;2;2
9214;Ramunėlė;VARPELIAI;3996453947;Ne;0;6;0;6
9215;Ramunėlė;VARPELIAI;3461269451;Ne;5;5;0;10
9216;Ramunėlė;VARPELIAI;3474578046;Ne;0;4;0;4
9217;Ramunėlė;VARPELIAI;7544671346;Ne;0;5;0;5
9218;Ramunėlė;VARPELIAI;5544992493;Ne;0;6;0;6
9219;Ramunėlė;VARPELIAI;6433856416;Ne;0;5;0;5
9220;Ramunėlė;VARPELIAI;3542912372;Ne;18;2;0;20
9221;Ramunėlė;VARPELIAI;3735308599;Ne;8;5;0;13
9222;Ramunėlė;VARPELIAI;3272747656;Ne;6;1;0;7
9223;Ramunėlė;VARPELIAI;6347893013;Ne;2;1;0;3
9224;Rūta;SMALSUČIAI;7649756034;Ne;0;0;3;3
9225;Rūta;SMALSUČIAI;5899860543;Ne;0;12;0;12
9226;Rūta;SMALSUČIAI;1346124133;Ne;0;0;2;2
9227;Rūta;SMALSUČIAI;4728904136;Ne;0;10;0;10
9228;Rūta;SMALSUČIAI;9791861646;Ne;1;0;0;1
9229;Rūta;SMALSUČIAI;2928803089;Ne;0;2;0;2
9230;Rūta;SMALSUČIAI;1951202550;Ne;0;0;5;5
9231;Rūta;SMALSUČIAI;3875136625;Ne;0;2;0;2
9232;Rūta;SMALSUČIAI;9911151238;Ne;6;0;0;6
9233;Rūta;SMALSUČIAI;7434152435;Ne;0;1;0;1
9234;Rūta;SMALSUČIAI;3843325181;Ne;0;0;11;11
9235;Rūta;SMALSUČIAI;8182243701;Ne;0;1;0;1
9236;Rūta;SMALSUČIAI;9386595365;Ne;6;0;2;8
9237;Rūta;SMALSUČIAI;7680605199;Ne;0;5;0;5
9238;Rūta;SMALSUČIAI;6075632046;Ne;0;1;0;1
9239;Rūta;SMALSUČIAI;1035527190;Ne;0;0;7;7
9240;Rūta;KŪLVERSTUKAI;4423305209;Ne;0;4;0;4
9241;Rūta;KŪLVERSTUKAI;9736567509;Ne;0;4;1;5
9242;Rūta;KŪLVERSTUKAI;7222494215;Ne;0;1;0;1
9243;Rūta;KŪLVERSTUKAI;7519931138;Ne;0;4;7;11
9244;Rūta;KŪLVERSTUKAI;4880804625;Ne;0;2;1;3
9245;Rūta;KŪLVERSTUKAI;3055345528;Ne;0;2;0;2
9246;Rūta;KŪLVERSTUKAI;3499727608;Ne;0;1;0;1
9247;Rūta;KŪLVERSTUKAI;9765301038;Ne;0;1;0;1
9248;Rūta;KŪLVERSTUKAI;9638495757;Taip;8;0;4;12
9249;Rūta;KŪLVERSTUKAI;1962172243;Ne;0;0;2;2
9250;Rūta;KŪLVERSTUKAI;8605070655;Ne;0;1;1;2
9251;Rūta;KŪLVERSTUKAI;7553844890;Ne;0;12;0;12
9252;Rūta;KŪLVERSTUKAI;3964922552;Ne;19;0;0;19
9253;Rūta;KŪLVERSTUKAI;9400586178;Ne;11;0;1;12
9254;Rūta;KŪLVERSTUKAI;3956912957;Ne;0;1;0;1
9255;Rūta;KŪLVERSTUKAI;2890569107;Ne;0;4;3;7
9256;Rūta;KŪLVERSTUKAI;2474991135;Ne;0;5;0;5
9257;Rūta;KŪLVERSTUKAI;1216786487;Ne;0;5;0;5
9258;Rūta;KŪLVERSTUKAI;9245618776;Ne;0;17;0;17
9259;Rūta;KŪLVERSTUKAI;5109138407;Ne;0;0;1;1
9260;Rūta;KODĖLČIUKAI;4347678781;Ne;10;0;2;12
9261;Rūta;KODĖLČIUKAI;3736279705;Ne;0;0;9;9
9262;Rūta;KODĖLČIUKAI;8416455711;Ne;0;3;0;3
9263;Rūta;KODĖLČIUKAI;8668510009;Ne;6;0;0;6
9264;Rūta;KODĖLČIUKAI;2547849837;Ne;0;0;1;1
9265;Rūta;KODĖLČIUKAI;9501101073;Ne;0;1;4;5
9266;Rūta;KODĖLČIUKAI;1000645885;Ne;0;2;0;2
9267;Rūta;KODĖLČIUKAI;5766392854;Ne;0;12;0;12
9268;Rūta;KODĖLČIUKAI;4944413811;Ne;4;0;0;4
9269;Rūta;KODĖLČIUKAI;9916296056;Ne;1;6;0;7
9270;Rūta;KODĖLČIUKAI;1605412505;Ne;11;0;0;11
9271;Rūta;KODĖLČIUKAI;2492891254;Ne;0;0;4;4
9272;Rūta;BORUŽĖLĖS;7712500278;Ne;0;6;0;6
9273;Rūta;BORUŽĖLĖS;3898579878;Ne;0;0;3;3
9274;Rūta;BORUŽĖLĖS;8945868791;Ne;0;0;9;9
9275;Rūta;BORUŽĖLĖS;8023404173;Ne;7;1;0;8
9276;Rūta;BORUŽĖLĖS;3348066709;Ne;3;0;1;4
9277;Rūta;BORUŽĖLĖS;4279367893;Ne;5;0;1;6
9278;Rūta;BORUŽĖLĖS;5141290453;Ne;9;4;0;13
9279;Rūta;BORUŽĖLĖS;7006165453;Ne;0;0;1;1
9280;Rūta;BORUŽĖLĖS;6587625933;Ne;0;1;2;3
9281;Rūta;BORUŽĖLĖS;8303314520;Ne;0;2;0;2
9282;Rūta;BORUŽĖLĖS;3470052541;Ne;2;4;1;7
9283;Rūta;BORUŽĖLĖS;2625691851;Ne;0;0;3;3
9284;Rūta;BORUŽĖLĖS;1804222979;Taip;2;0;2;4
9285;Rūta;VYTURĖLIAI;1967141665;Ne;0;4;6;10
9286;Rūta;VYTURĖLIAI;3873876608;Ne;5;6;0;11
9287;Rūta;VYTURĖLIAI;8851591109;Ne;4;0;0;4
9288;Rūta;VYTURĖLIAI;1180144866;Ne;0;5;0;5
9289;Rūta;VYTURĖLIAI;3478456813;Ne;0;4;0;4
9290;Rūta;VYTURĖLIAI;1276704331;Ne;0;1;5;6
9291;Rūta;VYTURĖLIAI;6207902435;Ne;0;3;0;3
9292;Rūta;VYTURĖLIAI;8889388348;Ne;0;0;4;4
9293;Rūta;VYTURĖLIAI;1346367896;Ne;0;6;0;6
9294;Rūta;VYTURĖLIAI;4363571135;Ne;0;4;0;4
9295;Rūta;VYTURĖLIAI;6006094035;Ne;0;1;0;1
9296;Rūta;VYTURĖLIAI;1521231573;Ne;0;1;0;1
9297;Rūta;VYTURĖLIAI;7552644990;Ne;0;3;0;3
9298;Rūta;VYTURĖLIAI;1092908255;Ne;6;0;1;7
9299;Rūta;VYTURĖLIAI;8673942478;Ne;0;5;0;5
9300;Rūta;VYTURĖLIAI;4754142240;Ne;0;5;0;5
9301;Rūta;VYTURĖLIAI;6136733410;Ne;0;1;0;1
9302;Rūta;VYTURĖLIAI;1565896222;Ne;4;0;0;4
9303;Rūta;VYTURĖLIAI;7631229177;Ne;0;2;0;2
9304;Rūta;"PABIRUČIAI (LOGOPEDINĖ)";8763382361;Ne;2;1;1;4
9305;Rūta;"PABIRUČIAI (LOGOPEDINĖ)";9171781646;Ne;0;0;1;1
9306;Rūta;"PABIRUČIAI (LOGOPEDINĖ)";1029871210;Ne;0;0;1;1
9307;Rūta;"PABIRUČIAI (LOGOPEDINĖ)";3814794448;Ne;0;4;2;6
9308;Rūta;GUDRUČIAI;4044349935;Ne;5;0;4;9
9309;Rūta;GUDRUČIAI;3998791775;Ne;0;1;1;2
9310;Rūta;GUDRUČIAI;3462986405;Ne;0;0;7;7
9311;Rūta;GUDRUČIAI;8548089843;Ne;9;0;0;9
9312;Rūta;GUDRUČIAI;4293920701;Ne;0;4;0;4
9313;Rūta;GUDRUČIAI;4473591998;Ne;0;4;0;4
9314;Rūta;GUDRUČIAI;9419809946;Ne;0;3;0;3
9315;Rūta;GUDRUČIAI;3044976169;Ne;0;0;2;2
9316;Rūta;GUDRUČIAI;2546023973;Ne;0;0;5;5
9317;Rūta;GUDRUČIAI;8273644943;Ne;0;1;0;1
9318;Rūta;GUDRUČIAI;8963959004;Ne;0;4;7;11
9319;Rūta;GUDRUČIAI;1510268514;Ne;0;6;1;7
9320;Rūta;GUDRUČIAI;6814051598;Ne;0;2;1;3
9321;Rūta;GUDRUČIAI;2702537976;Ne;0;5;0;5
9322;Rūta;GUDRUČIAI;1623968580;Ne;0;2;0;2
9323;Rūta;GUDRUČIAI;8592528906;Ne;2;4;4;10
9324;Rūta;SEKLYTĖLĖ;4823677957;Ne;0;4;0;4
9325;Rūta;SEKLYTĖLĖ;1301573542;Ne;0;2;0;2
9326;Rūta;SEKLYTĖLĖ;5009619812;Ne;0;9;0;9
9327;Rūta;SEKLYTĖLĖ;3567273206;Ne;0;14;0;14
9328;Rūta;SEKLYTĖLĖ;1671913833;Ne;0;2;0;2
9329;Rūta;SEKLYTĖLĖ;1186493111;Ne;0;10;0;10
9330;Rūta;SEKLYTĖLĖ;9675482322;Ne;0;10;0;10
9331;Rūta;SEKLYTĖLĖ;3820689725;Ne;0;2;0;2
9332;Rūta;SEKLYTĖLĖ;1415664888;Ne;0;8;0;8
9333;Rūta;SEKLYTĖLĖ;4426456302;Ne;0;1;0;1
9334;Rūta;SEKLYTĖLĖ;5114985659;Ne;0;3;0;3
9335;Rūta;SEKLYTĖLĖ;4282074540;Ne;0;1;0;1
9336;Rūta;SEKLYTĖLĖ;4168356825;Ne;0;0;3;3
9337;Rūta;SEKLYTĖLĖ;9569447586;Ne;0;3;0;3
9338;Rūta;SEKLYTĖLĖ;1579573872;Ne;0;5;0;5
9339;Rūta;SEKLYTĖLĖ;2677062861;Ne;6;1;0;7
9340;Rūta;SEKLYTĖLĖ;1390207547;Ne;0;4;0;4
9341;Rūta;SEKLYTĖLĖ;32004750783;Ne;0;5;0;5
9342;Rūta;SEKLYTĖLĖ;1368317570;Ne;0;1;0;1
9343;Rūta;SEKLYTĖLĖ;2912054049;Ne;3;1;0;4
9344;Rūta;"VARPELIAI (LOGOPEDINĖ)";3055294324;Ne;0;7;0;7
9345;Rūta;"VARPELIAI (LOGOPEDINĖ)";3810636967;Ne;0;1;0;1
9346;Rūta;"VARPELIAI (LOGOPEDINĖ)";8992775168;Ne;0;2;0;2
9347;Rūta;"VARPELIAI (LOGOPEDINĖ)";8026402652;Ne;0;1;0;1
9348;Rūta;"VARPELIAI (LOGOPEDINĖ)";2584812163;Ne;2;1;0;3
9349;Rūta;"VARPELIAI (LOGOPEDINĖ)";6032985748;Ne;0;1;0;1
9350;Rūta;"VARPELIAI (LOGOPEDINĖ)";6891385410;Ne;0;4;0;4
9351;Rūta;"VARPELIAI (LOGOPEDINĖ)";4858914868;Ne;2;4;0;6
9352;Rūta;KIŠKUČIŲ;7837861265;Ne;0;0;2;2
9353;Rūta;KIŠKUČIŲ;2601011765;Ne;21;0;0;21
9354;Rūta;KIŠKUČIŲ;5579794648;Ne;0;11;0;11
9355;Rūta;KIŠKUČIŲ;4165080541;Ne;4;0;0;4
9356;Rūta;KIŠKUČIŲ;3877807687;Ne;5;0;3;8
9357;Rūta;KIŠKUČIŲ;8483916287;Ne;14;0;0;14
9358;Rūta;KIŠKUČIŲ;2733932207;Taip;0;17;0;17
9359;Rūta;KIŠKUČIŲ;5902965224;Ne;0;4;0;4
9360;Rūta;KIŠKUČIŲ;9471291067;Ne;0;9;0;9
9361;Rūta;KIŠKUČIŲ;8012225409;Ne;0;2;6;8
9362;Rūta;KIŠKUČIŲ;1290867375;Ne;0;10;0;10
9363;Rūta;KIŠKUČIŲ;2084935094;Ne;11;0;1;12
9364;Rūta;KIŠKUČIŲ;8320791295;Ne;2;4;0;6
9365;Rūta;KIŠKUČIŲ;3109709043;Ne;0;0;1;1
9366;Rūta;KIŠKUČIŲ;2830990163;Ne;0;0;2;2
9367;Rūta;KIŠKUČIŲ;4780828296;Ne;0;0;2;2
9368;Rūta;ŽVIRBLIUKAI;3352007694;Ne;0;2;1;3
9369;Rūta;ŽVIRBLIUKAI;1059126758;Ne;0;6;0;6
9370;Rūta;ŽVIRBLIUKAI;6417693659;Ne;0;0;13;13
9371;Rūta;ŽVIRBLIUKAI;4090915728;Ne;11;0;0;11
9372;Rūta;ŽVIRBLIUKAI;4466522924;Ne;0;4;11;15
9373;Rūta;ŽVIRBLIUKAI;7905893575;Ne;7;4;7;18
9374;Rūta;ŽVIRBLIUKAI;4436482805;Ne;0;6;0;6
9375;Rūta;ŽVIRBLIUKAI;1260386759;Ne;0;4;1;5
9376;Rūta;ŽVIRBLIUKAI;4208678278;Ne;5;0;0;5
9377;Rūta;ŽVIRBLIUKAI;6044060646;Ne;0;6;0;6
9378;Rūta;ŽVIRBLIUKAI;4776631890;Ne;6;0;0;6
9379;Rūta;ŽVIRBLIUKAI;4440148328;Ne;0;1;0;1
9380;Rūta;ŽVIRBLIUKAI;1671179652;Ne;5;4;7;16
9381;Rūta;ŽVIRBLIUKAI;1152453609;Ne;9;0;2;11
9382;Rūta;SAULUTĖS;6585842434;Ne;7;0;3;10
9383;Rūta;SAULUTĖS;6620957022;Ne;3;0;0;3
9384;Rūta;SAULUTĖS;8806743371;Ne;0;3;2;5
9385;Rūta;SAULUTĖS;8320521011;Ne;0;8;1;9
9386;Rūta;SAULUTĖS;3765741047;Ne;0;5;1;6
9387;Rūta;SAULUTĖS;2685515977;Ne;12;1;0;13
9388;Rūta;SAULUTĖS;5512946296;Ne;0;2;0;2
9389;Rūta;SAULUTĖS;9308127402;Ne;0;0;7;7
9390;Rūta;SAULUTĖS;7422059414;Ne;0;9;0;9
9391;Rūta;SAULUTĖS;6186413364;Ne;0;4;0;4
9392;Rūta;SAULUTĖS;8571905994;Ne;2;0;0;2
9393;Rūta;SAULUTĖS;8479424939;Ne;11;0;0;11
9394;Rūta;SAULUTĖS;9014433476;Ne;0;1;0;1
9395;Rūta;SAULUTĖS;1207463357;Ne;6;0;0;6
9396;Rūta;SAULUTĖS;1131910047;Ne;0;21;0;21
9397;Rūta;SAULUTĖS;8715921452;Ne;0;0;1;1
9398;Sadutė;Kiškučiai;6645848193;Ne;1;0;4;5
9399;Sadutė;Kiškučiai;1589424708;Ne;0;4;0;4
9400;Sadutė;Kiškučiai;5992865266;Ne;7;0;2;9
9401;Sadutė;Kiškučiai;3568132830;Ne;0;21;0;21
9402;Sadutė;Kiškučiai;2340908210;Ne;0;2;0;2
9403;Sadutė;Kiškučiai;2087489114;Ne;2;0;0;2
9404;Sadutė;Kiškučiai;6652070415;Ne;19;0;0;19
9405;Sadutė;Kiškučiai;4360361866;Ne;4;0;0;4
9406;Sadutė;Kiškučiai;6493110772;Ne;0;0;5;5
9407;Sadutė;Kiškučiai;8397295024;Ne;0;6;0;6
9408;Sadutė;Kiškučiai;4075714061;Ne;0;2;0;2
9409;Sadutė;Kiškučiai;3285448692;Ne;0;4;0;4
9410;Sadutė;Kiškučiai;2845125335;Ne;0;4;0;4
9411;Sadutė;Kiškučiai;4135398332;Ne;0;5;0;5
9412;Sadutė;Kiškučiai;3954151590;Ne;2;0;0;2
9413;Sadutė;Kiškučiai;5326000400;Ne;0;5;0;5
9414;Sadutė;Kiškučiai;1860645542;Ne;13;0;0;13
9415;Sadutė;Kiškučiai;2472471722;Ne;0;0;3;3
9416;Sadutė;Boružėlės;9115304973;Ne;6;0;0;6
9417;Sadutė;Boružėlės;1273355194;Ne;0;0;3;3
9418;Sadutė;Boružėlės;3119547420;Ne;0;0;3;3
9419;Sadutė;Boružėlės;8987528237;Ne;0;4;1;5
9420;Sadutė;Boružėlės;6994383907;Ne;2;0;0;2
9421;Sadutė;Boružėlės;7242188081;Ne;0;0;2;2
9422;Sadutė;Boružėlės;3244211391;Ne;0;0;2;2
9423;Sadutė;Boružėlės;3875265137;Ne;0;4;7;11
9424;Sadutė;Boružėlės;5992119777;Ne;5;4;3;12
9425;Sadutė;Boružėlės;5682745869;Ne;0;1;0;1
9426;Sadutė;Boružėlės;7072437339;Ne;5;0;0;5
9427;Sadutė;Boružėlės;5579040052;Ne;8;0;0;8
9428;Sadutė;Boružėlės;3362830536;Ne;0;4;6;10
9429;Sadutė;Boružėlės;5395676303;Ne;21;0;0;21
9430;Sadutė;Boružėlės;1923014145;Ne;9;2;5;16
9431;Sadutė;Boružėlės;5698462283;Ne;2;0;0;2
9432;Sadutė;Boružėlės;3845369333;Ne;0;0;11;11
9433;Sadutė;Boružėlės;8200891038;Ne;10;0;2;12
9434;Sadutė;Boružėlės;4696990344;Ne;6;3;1;10
9435;Sadutė;Bitutės;1759479328;Ne;0;6;0;6
9436;Sadutė;Bitutės;4245873513;Ne;0;2;0;2
9437;Sadutė;Bitutės;1873928395;Ne;6;3;0;9
9438;Sadutė;Bitutės;5866461096;Ne;0;3;2;5
9439;Sadutė;Bitutės;4883934480;Ne;2;0;0;2
9440;Sadutė;Bitutės;4479315578;Ne;0;4;0;4
9441;Sadutė;Bitutės;2020766695;Ne;0;21;0;21
9442;Sadutė;Bitutės;5011320850;Ne;3;0;4;7
9443;Sadutė;Bitutės;4161502667;Ne;3;5;0;8
9444;Sadutė;Bitutės;5973513916;Ne;0;4;0;4
9445;Sadutė;Bitutės;5169694660;Ne;4;1;0;5
9446;Sadutė;Bitutės;3361904803;Ne;7;0;0;7
9447;Sadutė;Bitutės;1231048342;Ne;0;6;0;6
9448;Sadutė;Bitutės;2355177889;Ne;1;0;3;4
9449;Sadutė;Bitutės;8556086501;Ne;0;2;0;2
9450;Sadutė;Bitutės;6066145909;Ne;7;7;0;14
9451;Sadutė;Bitutės;5142566738;Ne;0;8;2;10
9452;Sadutė;Bitutės;8662375739;Ne;16;1;0;17
9453;Sadutė;Bitutės;9692905987;Ne;6;3;4;13
9454;Sadutė;Bitutės;9107727583;Ne;0;0;5;5
9455;Sadutė;Bitutės;6138604955;Ne;2;4;0;6
9456;Sadutė;Drugeliai;9090754149;Ne;0;1;0;1
9457;Sadutė;Drugeliai;1552350084;Ne;4;6;1;11
9458;Sadutė;Drugeliai;7910380894;Ne;0;5;0;5
9459;Sadutė;Drugeliai;4402558234;Ne;0;3;0;3
9460;Sadutė;Drugeliai;8713575864;Ne;0;5;0;5
9461;Sadutė;Drugeliai;6994547344;Ne;0;4;0;4
9462;Sadutė;Drugeliai;1782594187;Ne;5;7;0;12
9463;Sadutė;Drugeliai;5816844295;Ne;0;5;0;5
9464;Sadutė;Drugeliai;8803249656;Ne;3;7;1;11
9465;Sadutė;Drugeliai;6196282159;Ne;4;5;0;9
9466;Sadutė;Drugeliai;5139219626;Ne;3;5;0;8
9467;Sadutė;Drugeliai;1735450955;Ne;0;1;0;1
9468;Sadutė;Drugeliai;2064784580;Ne;0;1;0;1
9469;Sadutė;Drugeliai;2883991326;Ne;0;7;0;7
9470;Sadutė;Drugeliai;7731164484;Ne;0;1;0;1
9471;Sadutė;Drugeliai;6124376554;Ne;1;0;0;1
9472;Sadutė;Drugeliai;36769610742;Ne;0;4;3;7
9473;Sadutė;Drugeliai;4623727349;Ne;0;6;0;6
9474;Sadutė;Drugeliai;7940706717;Ne;7;4;0;11
9475;Sadutė;Pėledžiukai;9136727429;Ne;0;0;1;1
9476;Sadutė;Pėledžiukai;5616756293;Ne;0;21;0;21
9477;Sadutė;Pėledžiukai;2705458480;Ne;2;0;4;6
9478;Sadutė;Pėledžiukai;6314488650;Ne;0;0;1;1
9479;Sadutė;Pėledžiukai;6126235707;Ne;0;0;7;7
9480;Sadutė;Pėledžiukai;1537482438;Ne;0;0;4;4
9481;Sadutė;Pėledžiukai;6716550703;Ne;6;0;0;6
9482;Sadutė;Pėledžiukai;7730645448;Ne;0;5;0;5
9483;Sadutė;Pėledžiukai;7551299839;Ne;0;0;2;2
9484;Sadutė;Pėledžiukai;8914706717;Ne;0;4;3;7
9485;Sadutė;Pėledžiukai;6379705269;Ne;3;2;0;5
9486;Sadutė;Pėledžiukai;5385678913;Ne;16;0;0;16
9487;Sadutė;Pėledžiukai;2055127699;Ne;5;0;1;6
9488;Sadutė;Pėledžiukai;2747256989;Ne;0;0;1;1
9489;Sadutė;Pėledžiukai;3277826759;Ne;0;0;1;1
9490;Sadutė;Pėledžiukai;4791750087;Ne;3;0;0;3
9491;Sadutė;Kačiukų;1507052440;Ne;0;4;0;4
9492;Sadutė;Kačiukų;1903961488;Ne;0;4;0;4
9493;Sadutė;Kačiukų;2890916313;Ne;0;4;1;5
9494;Sadutė;Kačiukų;2733633163;Ne;0;2;0;2
9495;Sadutė;Kačiukų;3993181500;Ne;0;4;0;4
9496;Sadutė;Kačiukų;8835627470;Ne;0;5;0;5
9497;Sadutė;Kačiukų;2532626934;Ne;0;4;0;4
9498;Sadutė;Kačiukų;2466024649;Ne;0;5;0;5
9499;Sadutė;Kačiukų;6253351299;Ne;0;1;0;1
9500;Sadutė;Kačiukų;2426974464;Ne;3;4;0;7
9501;Sadutė;Kačiukų;8974374101;Ne;0;5;5;10
9502;Sadutė;Kačiukų;4401870028;Ne;0;5;0;5
9503;Sadutė;Kačiukų;3927044011;Taip;4;0;4;8
9504;Sadutė;Kačiukų;8770727233;Ne;15;6;0;21
9505;Sadutė;Kačiukų;8556218971;Ne;1;0;2;3
9506;Sadutė;Kačiukų;5267093203;Ne;0;3;12;15
9507;Sadutė;Kačiukų;6538356822;Ne;0;0;6;6
9508;Sadutė;Kačiukų;5614758320;Ne;0;15;0;15
9509;Sadutė;Kačiukų;2194387139;Ne;0;6;0;6
9510;Sakalėlis;GIRINUKŲ;9566176151;Ne;3;0;3;6
9511;Sakalėlis;GIRINUKŲ;8606714134;Ne;0;0;2;2
9512;Sakalėlis;GIRINUKŲ;5405669698;Ne;4;1;5;10
9513;Sakalėlis;GIRINUKŲ;2474164013;Ne;4;0;0;4
9514;Sakalėlis;GIRINUKŲ;9493905856;Ne;0;0;5;5
9515;Sakalėlis;GIRINUKŲ;5496044442;Ne;13;0;1;14
9516;Sakalėlis;GIRINUKŲ;3165387995;Ne;0;5;3;8
9517;Sakalėlis;GIRINUKŲ;6603105354;Ne;0;0;14;14
9518;Sakalėlis;GIRINUKŲ;3418702674;Ne;0;1;0;1
9519;Sakalėlis;GIRINUKŲ;6700169944;Ne;0;0;4;4
9520;Sakalėlis;GIRINUKŲ;3333037807;Ne;0;4;1;5
9521;Sakalėlis;GIRINUKŲ;4596727938;Ne;0;0;1;1
9522;Sakalėlis;GIRINUKŲ;4209146744;Ne;0;4;0;4
9523;Sakalėlis;GIRINUKŲ;2780141413;Ne;0;8;0;8
9524;Sakalėlis;GIRINUKŲ;1347171934;Ne;21;0;0;21
9525;Sakalėlis;GIRINUKŲ;9250470549;Ne;0;3;1;4
9526;Sakalėlis;VYTURIUKŲ;3927487265;Ne;0;0;4;4
9527;Sakalėlis;VYTURIUKŲ;3680732318;Ne;4;8;1;13
9528;Sakalėlis;VYTURIUKŲ;4862004373;Ne;10;1;0;11
9529;Sakalėlis;VYTURIUKŲ;8381310908;Ne;0;1;1;2
9530;Sakalėlis;VYTURIUKŲ;7285833058;Ne;0;0;1;1
9531;Sakalėlis;VYTURIUKŲ;1742362136;Ne;0;4;0;4
9532;Sakalėlis;VYTURIUKŲ;5795250727;Ne;0;4;1;5
9533;Sakalėlis;VYTURIUKŲ;2985239904;Ne;12;4;0;16
9534;Sakalėlis;VYTURIUKŲ;9120873899;Ne;1;4;6;11
9535;Sakalėlis;VYTURIUKŲ;4136266629;Ne;0;0;4;4
9536;Sakalėlis;VYTURIUKŲ;5991029760;Ne;5;0;3;8
9537;Sakalėlis;VYTURIUKŲ;1736303381;Ne;6;4;2;12
9538;Sakalėlis;VYTURIUKŲ;1200252225;Ne;0;10;0;10
9539;Sakalėlis;VYTURIUKŲ;7280513854;Ne;0;0;3;3
9540;Sakalėlis;DRUGELIŲ;8095359035;Ne;8;0;12;20
9541;Sakalėlis;DRUGELIŲ;6515519140;Ne;2;4;1;7
9542;Sakalėlis;DRUGELIŲ;7706606275;Ne;2;0;1;3
9543;Sakalėlis;DRUGELIŲ;5911341542;Ne;2;0;0;2
9544;Sakalėlis;DRUGELIŲ;9272347788;Ne;8;0;0;8
9545;Sakalėlis;DRUGELIŲ;8331612396;Ne;0;0;2;2
9546;Sakalėlis;DRUGELIŲ;7542322748;Ne;19;0;0;19
9547;Sakalėlis;DRUGELIŲ;1201086815;Ne;0;0;6;6
9548;Sakalėlis;DRUGELIŲ;3934295338;Ne;5;1;0;6
9549;Sakalėlis;DRUGELIŲ;1117800518;Ne;10;0;2;12
9550;Sakalėlis;DRUGELIŲ;2515169899;Ne;0;4;0;4
9551;Sakalėlis;DRUGELIŲ;9836193857;Ne;12;0;0;12
9552;Sakalėlis;DRUGELIŲ;4004006771;Ne;8;4;0;12
9553;Sakalėlis;DRUGELIŲ;1833573491;Ne;5;0;5;10
9554;Sakalėlis;DRUGELIŲ;8713298648;Ne;0;8;0;8
9555;Sakalėlis;DRUGELIŲ;2889638745;Ne;0;0;5;5
9556;Sakalėlis;DRUGELIŲ;7540098033;Ne;0;0;5;5
9557;Sakalėlis;GENIUKŲ;4763858893;Ne;0;4;4;8
9558;Sakalėlis;GENIUKŲ;3337299648;Ne;0;3;0;3
9559;Sakalėlis;GENIUKŲ;9830907922;Ne;5;5;0;10
9560;Sakalėlis;GENIUKŲ;43677485606;Ne;0;4;3;7
9561;Sakalėlis;GENIUKŲ;5717022080;Ne;0;3;2;5
9562;Sakalėlis;GENIUKŲ;4515180509;Ne;0;1;0;1
9563;Sakalėlis;GENIUKŲ;96053733139;Ne;4;4;1;9
9564;Sakalėlis;GENIUKŲ;4612388683;Ne;0;7;0;7
9565;Sakalėlis;GENIUKŲ;7159705304;Ne;0;2;0;2
9566;Sakalėlis;GENIUKŲ;4775685174;Ne;0;1;0;1
9567;Sakalėlis;GENIUKŲ;69916351348;Ne;0;4;0;4
9568;Sakalėlis;GENIUKŲ;8936933971;Ne;0;1;1;2
9569;Sakalėlis;GENIUKŲ;2829386777;Ne;5;4;1;10
9570;Sakalėlis;GENIUKŲ;3371763993;Ne;0;4;0;4
9571;Sakalėlis;GENIUKŲ;7085108710;Ne;14;1;0;15
9572;Sakalėlis;GENIUKŲ;2902195855;Ne;0;2;0;2
9573;Sakalėlis;GENIUKŲ;6301366135;Ne;0;3;3;6
9574;Sakalėlis;GENIUKŲ;4364341933;Ne;12;3;1;16
9575;Sakalėlis;VOVERIUKŲ;5172421763;Ne;0;0;5;5
9576;Sakalėlis;VOVERIUKŲ;5233697077;Ne;0;4;3;7
9577;Sakalėlis;VOVERIUKŲ;6414564366;Taip;9;0;5;14
9578;Sakalėlis;VOVERIUKŲ;1953356983;Ne;0;0;1;1
9579;Sakalėlis;VOVERIUKŲ;4358313171;Ne;10;0;1;11
9580;Sakalėlis;VOVERIUKŲ;6806170544;Ne;0;0;2;2
9581;Sakalėlis;VOVERIUKŲ;2557089391;Ne;7;0;0;7
9582;Sakalėlis;VOVERIUKŲ;8133985842;Ne;0;0;1;1
9583;Sakalėlis;VOVERIUKŲ;3574956316;Ne;3;4;0;7
9584;Sakalėlis;VOVERIUKŲ;1403384561;Ne;2;0;1;3
9585;Sakalėlis;VOVERIUKŲ;3927363997;Ne;0;3;0;3
9586;Sakalėlis;VOVERIUKŲ;6293226507;Ne;14;0;0;14
9587;Sakalėlis;VOVERIUKŲ;2699844937;Ne;5;4;0;9
9588;Sakalėlis;VOVERIUKŲ;1273843302;Ne;2;2;1;5
9589;Sakalėlis;VOVERIUKŲ;6217643065;Ne;0;0;6;6
9590;Sakalėlis;VOVERIUKŲ;1669610397;Ne;0;0;10;10
9591;Sakalėlis;VOVERIUKŲ;4344537391;Ne;0;0;4;4
9592;Sakalėlis;VOVERIUKŲ;6016854405;Ne;10;2;0;12
9593;Sakalėlis;VOVERIUKŲ;2531146677;Ne;14;0;3;17
9594;Sakalėlis;VOVERIUKŲ;2575873447;Ne;4;0;1;5
9595;Sakalėlis;VOVERIUKŲ;4968216193;Ne;0;0;2;2
9596;Sakalėlis;PĖLEDŽIUKŲ;1133377117;Ne;0;4;6;10
9597;Sakalėlis;PĖLEDŽIUKŲ;6190741162;Ne;0;1;0;1
9598;Sakalėlis;PĖLEDŽIUKŲ;4430763418;Ne;0;12;0;12
9599;Sakalėlis;PĖLEDŽIUKŲ;1104881142;Ne;0;3;0;3
9600;Sakalėlis;PĖLEDŽIUKŲ;6321575268;Ne;0;1;1;2
9601;Sakalėlis;PĖLEDŽIUKŲ;30987215315;Ne;0;2;0;2
9602;Sakalėlis;PĖLEDŽIUKŲ;2796230671;Ne;0;4;3;7
9603;Sakalėlis;PĖLEDŽIUKŲ;3962436122;Ne;0;2;2;4
9604;Sakalėlis;PĖLEDŽIUKŲ;1912068116;Ne;7;4;0;11
9605;Sakalėlis;PĖLEDŽIUKŲ;1141943082;Ne;0;1;0;1
9606;Sakalėlis;PĖLEDŽIUKŲ;46629941288;Ne;0;4;0;4
9607;Sakalėlis;PĖLEDŽIUKŲ;5782214279;Ne;0;2;0;2
9608;Sakalėlis;PĖLEDŽIUKŲ;8852001037;Ne;0;4;3;7
9609;Sakalėlis;PĖLEDŽIUKŲ;6180987643;Ne;3;4;3;10
9610;Sakalėlis;PĖLEDŽIUKŲ;3678172501;Ne;21;0;0;21
9611;Sakalėlis;PĖLEDŽIUKŲ;7567476424;Ne;0;4;0;4
9612;Sakalėlis;PĖLEDŽIUKŲ;2055710873;Ne;0;5;0;5
9613;Sakalėlis;PĖLEDŽIUKŲ;1839096675;Ne;0;0;2;2
9614;Sakalėlis;PĖLEDŽIUKŲ;1339314644;Ne;0;0;1;1
9615;Sakalėlis;PĖLEDŽIUKŲ;5884781964;Ne;0;2;1;3
9616;Sakalėlis;PĖLEDŽIUKŲ;4495453007;Ne;0;4;0;4
9617;Sakalėlis;"BITUČIŲ (LOGOPEDINĖ)";7241416465;Ne;0;4;3;7
9618;Sakalėlis;"BITUČIŲ (LOGOPEDINĖ)";4857211754;Ne;0;4;0;4
9619;Sakalėlis;"BITUČIŲ (LOGOPEDINĖ)";8610668395;Ne;7;1;0;8
9620;Sakalėlis;"BITUČIŲ (LOGOPEDINĖ)";4986131090;Ne;0;1;0;1
9621;Sakalėlis;"BITUČIŲ (LOGOPEDINĖ)";1723436498;Ne;5;4;2;11
9622;Sakalėlis;"BITUČIŲ (LOGOPEDINĖ)";3938470708;Ne;6;0;0;6
9623;Sakalėlis;"BITUČIŲ (LOGOPEDINĖ)";5376872141;Ne;0;0;1;1
9624;Sakalėlis;"BITUČIŲ (LOGOPEDINĖ)";4303490614;Ne;0;8;0;8
9625;Sakalėlis;"BORUŽIUKŲ (LOGOPEDINĖ)";4514546151;Ne;5;5;0;10
9626;Sakalėlis;"BORUŽIUKŲ (LOGOPEDINĖ)";3972897839;Ne;5;1;2;8
9627;Sakalėlis;"BORUŽIUKŲ (LOGOPEDINĖ)";2124857941;Ne;16;0;0;16
9628;Sakalėlis;"BORUŽIUKŲ (LOGOPEDINĖ)";1806698668;Ne;0;4;0;4
9629;Sakalėlis;"BORUŽIUKŲ (LOGOPEDINĖ)";6727251397;Ne;5;4;0;9
9630;Sakalėlis;"BORUŽIUKŲ (LOGOPEDINĖ)";6250400609;Ne;5;0;0;5
9631;Sakalėlis;"BORUŽIUKŲ (LOGOPEDINĖ)";7602249339;Ne;0;0;5;5
9632;Sakalėlis;"BORUŽIUKŲ (LOGOPEDINĖ)";8263169658;Ne;0;0;3;3
9633;Sakalėlis;MEŠKUČIŲ;9546779717;Ne;19;4;0;23
9634;Sakalėlis;MEŠKUČIŲ;8535457018;Ne;0;9;0;9
9635;Sakalėlis;MEŠKUČIŲ;7154383856;Ne;21;0;0;21
9636;Sakalėlis;MEŠKUČIŲ;5082756444;Taip;8;1;0;9
9637;Sakalėlis;MEŠKUČIŲ;7839893402;Ne;6;0;0;6
9638;Sakalėlis;MEŠKUČIŲ;3092760315;Ne;0;8;0;8
9639;Sakalėlis;MEŠKUČIŲ;3524545708;Ne;0;7;0;7
9640;Sakalėlis;MEŠKUČIŲ;5961207419;Ne;0;0;2;2
9641;Sakalėlis;MEŠKUČIŲ;5677280944;Ne;4;0;7;11
9642;Sakalėlis;MEŠKUČIŲ;2389541483;Taip;4;2;0;6
9643;Sakalėlis;MEŠKUČIŲ;4063074948;Ne;0;0;4;4
9644;Sakalėlis;MEŠKUČIŲ;8108456923;Ne;14;0;0;14
9645;Sakalėlis;MEŠKUČIŲ;7285230768;Ne;5;2;0;7
9646;Sakalėlis;MEŠKUČIŲ;8888784168;Ne;0;4;0;4
9647;Sakalėlis;MEŠKUČIŲ;2090313887;Ne;15;0;0;15
9648;Sakalėlis;MEŠKUČIŲ;9794245922;Ne;15;4;0;19
9649;Sakalėlis;MEŠKUČIŲ;8106231242;Ne;21;0;0;21
9650;Sakalėlis;MEŠKUČIŲ;4520212128;Ne;0;2;3;5
9651;Sakalėlis;MEŠKUČIŲ;7228559861;Ne;0;10;0;10
9652;Sakalėlis;MEŠKUČIŲ;1208798798;Ne;3;0;1;4
9653;Sakalėlis;KIŠKUČIŲ;5865993835;Ne;4;0;4;8
9654;Sakalėlis;KIŠKUČIŲ;2003090775;Ne;0;10;1;11
9655;Sakalėlis;KIŠKUČIŲ;8228039819;Ne;0;0;1;1
9656;Sakalėlis;KIŠKUČIŲ;6029443196;Ne;0;0;10;10
9657;Sakalėlis;KIŠKUČIŲ;4633296169;Ne;0;0;1;1
9658;Sakalėlis;KIŠKUČIŲ;4611384179;Ne;0;2;0;2
9659;Sakalėlis;KIŠKUČIŲ;4490632523;Ne;9;0;0;9
9660;Sakalėlis;KIŠKUČIŲ;8015985605;Ne;2;2;0;4
9661;Sakalėlis;KIŠKUČIŲ;5052638078;Ne;21;0;0;21
9662;Sakalėlis;KIŠKUČIŲ;5327382009;Ne;21;0;0;21
9663;Sakalėlis;KIŠKUČIŲ;6897550418;Ne;14;0;1;15
9664;Sakalėlis;KIŠKUČIŲ;5387119771;Taip;18;0;0;18
9665;Sakalėlis;KIŠKUČIŲ;6328924318;Ne;12;0;5;17
9666;Sakalėlis;KIŠKUČIŲ;8868588637;Taip;9;0;3;12
9667;Sakalėlis;SVIRPLIUKŲ;5500248048;Ne;6;1;5;12
9668;Sakalėlis;SVIRPLIUKŲ;8562164673;Ne;5;0;0;5
9669;Sakalėlis;SVIRPLIUKŲ;2537030533;Ne;0;0;10;10
9670;Sakalėlis;SVIRPLIUKŲ;3719351129;Ne;10;1;0;11
9671;Sakalėlis;SVIRPLIUKŲ;3570413330;Ne;0;0;8;8
9672;Sakalėlis;SVIRPLIUKŲ;6889888573;Ne;0;10;1;11
9673;Sakalėlis;SVIRPLIUKŲ;7852255204;Ne;0;0;2;2
9674;Sakalėlis;SVIRPLIUKŲ;9926328835;Ne;4;0;4;8
9675;Sakalėlis;SVIRPLIUKŲ;1253452975;Ne;0;0;1;1
9676;Sakalėlis;SVIRPLIUKŲ;8328069876;Ne;0;0;11;11
9677;Sakalėlis;SVIRPLIUKŲ;7480286509;Ne;0;4;0;4
9678;Sakalėlis;SVIRPLIUKŲ;2250828607;Ne;16;1;1;18
9679;Sakalėlis;SVIRPLIUKŲ;2672429406;Ne;16;1;1;18
9680;Sakalėlis;SVIRPLIUKŲ;6851247779;Ne;5;4;0;9
9681;Sakalėlis;SVIRPLIUKŲ;9776767584;Ne;0;0;4;4
9682;Sakalėlis;SVIRPLIUKŲ;8501785305;Ne;0;0;1;1
9683;Sakalėlis;SVIRPLIUKŲ;1121818878;Ne;0;1;0;1
9684;Sakalėlis;SVIRPLIUKŲ;5465596207;Ne;7;0;0;7
9685;Sakalėlis;SVIRPLIUKŲ;2233966176;Ne;0;4;9;13
9686;Sakalėlis;SVIRPLIUKŲ;7079300418;Ne;0;0;4;4
9687;Sakalėlis;SVIRPLIUKŲ;8659925528;Ne;4;0;2;6
9688;Sakalėlis;GANDRIUKŲ;8502289806;Ne;0;5;1;6
9689;Sakalėlis;GANDRIUKŲ;9368758708;Ne;16;0;0;16
9690;Sakalėlis;GANDRIUKŲ;8326977226;Ne;2;0;5;7
9691;Sakalėlis;GANDRIUKŲ;7384400795;Ne;0;11;0;11
9692;Sakalėlis;GANDRIUKŲ;3644413861;Ne;6;4;0;10
9693;Sakalėlis;GANDRIUKŲ;4576495786;Ne;0;1;0;1
9694;Sakalėlis;GANDRIUKŲ;4230762388;Taip;10;0;0;10
9695;Sakalėlis;GANDRIUKŲ;3228617971;Ne;5;0;0;5
9696;Sakalėlis;GANDRIUKŲ;5748438461;Ne;5;2;0;7
9697;Sakalėlis;GANDRIUKŲ;2734462553;Ne;0;0;2;2
9698;Sakalėlis;GANDRIUKŲ;2481285439;Ne;0;0;4;4
9699;Sakalėlis;GANDRIUKŲ;7345113972;Ne;0;3;0;3
9700;Sakalėlis;GANDRIUKŲ;6069544792;Ne;9;0;1;10
9701;Sakalėlis;GANDRIUKŲ;8869621812;Ne;2;0;0;2
9702;Sakalėlis;GANDRIUKŲ;5460619168;Ne;2;0;0;2
9703;Sakalėlis;GANDRIUKŲ;1560077883;Ne;5;2;0;7
9704;Salininkų;BORUŽIUKAI;8329495685;Ne;0;1;0;1
9705;Salininkų;BORUŽIUKAI;1005025619;Ne;0;7;0;7
9706;Salininkų;BORUŽIUKAI;3925860408;Ne;8;0;0;8
9707;Salininkų;BORUŽIUKAI;2146404021;Ne;5;2;0;7
9708;Salininkų;BORUŽIUKAI;8718514114;Ne;10;0;0;10
9709;Salininkų;BORUŽIUKAI;8930622266;Ne;5;7;0;12
9710;Salininkų;BORUŽIUKAI;5447236646;Ne;7;4;0;11
9711;Salininkų;BORUŽIUKAI;2208793412;Ne;0;8;0;8
9712;Salininkų;BORUŽIUKAI;5045064069;Ne;5;0;1;6
9713;Salininkų;BORUŽIUKAI;1647401700;Ne;5;0;3;8
9714;Salininkų;BORUŽIUKAI;9817285587;Ne;10;0;0;10
9715;Salininkų;BORUŽIUKAI;8823595510;Ne;0;4;0;4
9716;Salininkų;BORUŽIUKAI;9416926474;Ne;4;4;0;8
9717;Salininkų;BORUŽIUKAI;1254843449;Ne;6;4;0;10
9718;Salininkų;BORUŽIUKAI;3231379271;Ne;10;4;1;15
9719;Salininkų;BORUŽIUKAI;1346133493;Ne;5;0;0;5
9720;Salininkų;BORUŽIUKAI;2273407270;Ne;5;0;0;5
9721;Salininkų;BORUŽIUKAI;9855014750;Ne;5;0;0;5
9722;Salininkų;BORUŽIUKAI;8911016037;Ne;8;1;0;9
9723;Salininkų;GĖLYTĖS;8602489420;Ne;0;6;0;6
9724;Salininkų;GĖLYTĖS;2895782373;Ne;0;8;0;8
9725;Salininkų;GĖLYTĖS;4971070998;Ne;0;0;1;1
9726;Salininkų;GĖLYTĖS;9893985732;Ne;9;0;0;9
9727;Salininkų;GĖLYTĖS;3686372180;Ne;14;0;0;14
9728;Salininkų;GĖLYTĖS;9892443649;Ne;0;2;0;2
9729;Salininkų;GĖLYTĖS;3703729963;Ne;6;0;0;6
9730;Salininkų;GĖLYTĖS;3338213592;Ne;0;2;0;2
9731;Salininkų;GĖLYTĖS;6506819265;Ne;0;4;0;4
9732;Salininkų;GĖLYTĖS;6510096414;Ne;0;5;0;5
9733;Salininkų;GĖLYTĖS;2491796874;Ne;6;0;0;6
9734;Salininkų;GĖLYTĖS;3464228778;Ne;8;0;0;8
9735;Salininkų;GĖLYTĖS;8141168894;Ne;16;0;0;16
9736;Salininkų;GĖLYTĖS;2440831687;Ne;0;9;0;9
9737;Salininkų;GĖLYTĖS;1284909139;Ne;6;8;0;14
9738;Salininkų;GĖLYTĖS;5164367382;Ne;0;2;4;6
9739;Salininkų;GĖLYTĖS;2798153926;Ne;0;4;0;4
9740;Salininkų;GĖLYTĖS;2726813574;Ne;4;0;0;4
9741;Salininkų;GĖLYTĖS;1453214735;Ne;0;1;0;1
9742;Salininkų;DRUGELIAI;4333027447;Ne;0;9;0;9
9743;Salininkų;DRUGELIAI;3115232507;Ne;0;0;1;1
9744;Salininkų;DRUGELIAI;2009246885;Ne;0;0;2;2
9745;Salininkų;DRUGELIAI;3420217477;Ne;8;0;2;10
9746;Salininkų;DRUGELIAI;3890914603;Ne;0;13;0;13
9747;Salininkų;DRUGELIAI;3181932118;Ne;0;3;0;3
9748;Salininkų;DRUGELIAI;5017068344;Ne;4;0;1;5
9749;Salininkų;DRUGELIAI;3761217912;Ne;0;8;0;8
9750;Salininkų;DRUGELIAI;2208607684;Ne;0;12;0;12
9751;Salininkų;DRUGELIAI;3963410827;Ne;5;0;0;5
9752;Salininkų;DRUGELIAI;5539560359;Ne;2;2;4;8
9753;Salininkų;DRUGELIAI;5375668400;Ne;0;3;0;3
9754;Salininkų;DRUGELIAI;4529253958;Ne;0;2;1;3
9755;Salininkų;DRUGELIAI;7063718023;Ne;7;0;6;13
9756;Salininkų;DRUGELIAI;9018366347;Ne;7;1;0;8
9757;Salininkų;ŽIRNIUKAI;7643665643;Ne;1;3;0;4
9758;Salininkų;ŽIRNIUKAI;9198411540;Ne;0;4;0;4
9759;Salininkų;ŽIRNIUKAI;6885580632;Ne;0;3;0;3
9760;Salininkų;ŽIRNIUKAI;7409604480;Ne;0;2;0;2
9761;Salininkų;ŽIRNIUKAI;3677558828;Ne;0;3;0;3
9762;Salininkų;ŽIRNIUKAI;8095820690;Ne;3;0;0;3
9763;Salininkų;ŽIRNIUKAI;6482437251;Ne;0;2;0;2
9764;Salininkų;ŽIRNIUKAI;1380797788;Ne;0;8;0;8
9765;Salininkų;ŽIRNIUKAI;2495782496;Ne;0;5;2;7
9766;Salininkų;ŽIRNIUKAI;9896357816;Ne;2;4;0;6
9767;Salininkų;ŽIRNIUKAI;4568462071;Ne;0;0;1;1
9768;Salininkų;ŽIRNIUKAI;9137783249;Ne;6;6;0;12
9769;Salininkų;ŽIRNIUKAI;8524400656;Ne;6;6;0;12
9770;Salininkų;ŽIRNIUKAI;7463713798;Ne;5;0;0;5
9771;Salininkų;ŽIRNIUKAI;9617873735;Ne;9;2;0;11
9772;Salininkų;ŽIRNIUKAI;1111197633;Ne;0;1;0;1
9773;Salininkų;ŽIRNIUKAI;6143967744;Ne;0;0;1;1
9774;Salininkų;ŽIRNIUKAI;8552427446;Ne;0;0;6;6
9775;Salininkų;ŽIRNIUKAI;6586988786;Ne;0;0;3;3
9776;Salininkų;ŽIRNIUKAI;1587485662;Ne;0;0;1;1
9777;Salininkų;ŽIRNIUKAI;9611858211;Ne;0;0;3;3
9778;Salininkų;PAUKŠČIUKAI;8047582970;Ne;5;0;1;6
9779;Salininkų;PAUKŠČIUKAI;5867676844;Ne;0;0;1;1
9780;Salininkų;PAUKŠČIUKAI;3585435095;Ne;0;1;0;1
9781;Salininkų;PAUKŠČIUKAI;2760231414;Ne;0;5;0;5
9782;Salininkų;PAUKŠČIUKAI;9724367035;Ne;0;6;0;6
9783;Salininkų;PAUKŠČIUKAI;7383557807;Ne;0;11;0;11
9784;Salininkų;PAUKŠČIUKAI;9344614003;Ne;0;2;0;2
9785;Salininkų;PAUKŠČIUKAI;6656578271;Ne;14;4;0;18
9786;Salininkų;PAUKŠČIUKAI;7737045952;Ne;0;6;1;7
9787;Salininkų;PAUKŠČIUKAI;7782972361;Ne;0;2;0;2
9788;Salininkų;PAUKŠČIUKAI;8394582546;Ne;0;11;0;11
9789;Salininkų;PAUKŠČIUKAI;6327046935;Ne;0;4;0;4
9790;Salininkų;PAUKŠČIUKAI;9813360176;Ne;0;2;0;2
9791;Salininkų;BITUTĖS;3252151974;Ne;10;0;2;12
9792;Salininkų;BITUTĖS;6845471044;Ne;0;0;9;9
9793;Salininkų;BITUTĖS;7253347059;Ne;11;0;0;11
9794;Salininkų;BITUTĖS;2467926286;Ne;5;3;0;8
9795;Salininkų;BITUTĖS;6551489987;Ne;0;4;0;4
9796;Salininkų;BITUTĖS;1928897962;Ne;13;0;0;13
9797;Salininkų;BITUTĖS;3527495230;Ne;0;4;0;4
9798;Salininkų;BITUTĖS;5582091833;Ne;0;1;1;2
9799;Salininkų;BITUTĖS;2073939432;Ne;5;0;0;5
9800;Salininkų;BITUTĖS;9996809930;Ne;0;0;7;7
9801;Salininkų;BITUTĖS;3915336062;Ne;20;0;0;20
9802;Salininkų;BITUTĖS;7639362434;Ne;0;0;3;3
9803;Salininkų;BITUTĖS;2370778977;Ne;0;0;4;4
9804;Salininkų;BITUTĖS;1020073382;Ne;0;0;4;4
9805;Salininkų;BITUTĖS;4480303856;Ne;0;1;3;4
9806;Salvija;Daigelis(šatil);1062662192;Ne;0;0;1;1
9807;Salvija;Daigelis(šatil);4577248630;Ne;12;0;2;14
9808;Salvija;Daigelis(šatil);9978634888;Ne;0;10;2;12
9809;Salvija;Daigelis(šatil);1676795179;Ne;0;0;8;8
9810;Salvija;Daigelis(šatil);6509829735;Ne;7;0;0;7
9811;Salvija;Daigelis(šatil);4665919836;Ne;2;0;2;4
9812;Salvija;Daigelis(šatil);1511271658;Ne;7;0;0;7
9813;Salvija;Daigelis(šatil);3345231579;Ne;11;0;0;11
9814;Salvija;Daigelis(šatil);3640213912;Ne;0;0;5;5
9815;Salvija;Daigelis(šatil);1509182157;Ne;0;0;2;2
9816;Salvija;Daigelis(šatil);8337554678;Ne;5;0;5;10
9817;Salvija;Daigelis(šatil);5327735648;Ne;0;15;1;16
9818;Salvija;Daigelis(šatil);5805537864;Ne;0;11;0;11
9819;Salvija;Daigelis(šatil);6323383244;Ne;12;0;2;14
9820;Salvija;Daigelis(šatil);3857916185;Ne;5;0;5;10
9821;Salvija;Daigelis(šatil);4719344565;Ne;0;0;5;5
9822;Salvija;Daigelis(šatil);5554431690;Ne;0;4;12;16
9823;Salvija;Daigelis(šatil);1065575041;Ne;0;4;12;16
9824;Salvija;Daigelis(šatil);1168900211;Ne;9;0;1;10
9825;Salvija;Daigelis(šatil);5761622263;Ne;8;0;2;10
9826;Salvija;Daigelis(šatil);6797777730;Ne;0;0;7;7
9827;Salvija;"Pienė (savjon)";5494438837;Ne;10;5;0;15
9828;Salvija;"Pienė (savjon)";8023422294;Ne;0;0;1;1
9829;Salvija;"Pienė (savjon)";4152602039;Ne;0;4;2;6
9830;Salvija;"Pienė (savjon)";8981331532;Ne;0;4;4;8
9831;Salvija;"Pienė (savjon)";8306404275;Ne;10;0;1;11
9832;Salvija;"Pienė (savjon)";1261005294;Ne;0;0;2;2
9833;Salvija;"Pienė (savjon)";8013023311;Ne;0;1;1;2
9834;Salvija;"Pienė (savjon)";1653831148;Ne;0;5;0;5
9835;Salvija;"Pienė (savjon)";4325636377;Ne;4;0;2;6
9836;Salvija;"Pienė (savjon)";1625197280;Ne;6;3;0;9
9837;Salvija;"Pienė (savjon)";8892646200;Ne;7;4;5;16
9838;Salvija;"Pienė (savjon)";7477171133;Ne;7;0;1;8
9839;Salvija;"Pienė (savjon)";6706565915;Ne;5;0;2;7
9840;Salvija;"Pienė (savjon)";8853389268;Ne;17;0;0;17
9841;Salvija;"Pienė (savjon)";3856351749;Ne;7;3;0;10
9842;Salvija;"Pienė (savjon)";8158680641;Ne;10;0;0;10
9843;Salvija;"Pienė (savjon)";7862619996;Ne;0;8;0;8
9844;Salvija;"Pienė (savjon)";3487446998;Ne;9;0;0;9
9845;Salvija;"Pienė (savjon)";5816893736;Ne;7;0;2;9
9846;Salvija;"Pienė (savjon)";1975032693;Ne;10;3;0;13
9847;Saulėtekis;BERŽELIS;3493175211;Ne;0;4;0;4
9848;Saulėtekis;BERŽELIS;8023603198;Ne;12;0;0;12
9849;Saulėtekis;BERŽELIS;9351122147;Ne;10;0;1;11
9850;Saulėtekis;BERŽELIS;6667804855;Ne;0;2;0;2
9851;Saulėtekis;BERŽELIS;1852180633;Ne;8;0;5;13
9852;Saulėtekis;BERŽELIS;4704426104;Ne;11;0;1;12
9853;Saulėtekis;BERŽELIS;7407540257;Ne;7;0;0;7
9854;Saulėtekis;BERŽELIS;6920619390;Ne;2;0;4;6
9855;Saulėtekis;BERŽELIS;5194925689;Ne;0;0;1;1
9856;Saulėtekis;BERŽELIS;7494641077;Ne;0;1;0;1
9857;Saulėtekis;BERŽELIS;1577609727;Ne;0;1;0;1
9858;Saulėtekis;BERŽELIS;9579088485;Ne;6;5;0;11
9859;Saulėtekis;BERŽELIS;2568544418;Ne;11;0;0;11
9860;Saulėtekis;BERŽELIS;8927598999;Ne;21;0;0;21
9861;Saulėtekis;BERŽELIS;9734188792;Ne;17;0;3;20
9862;Saulėtekis;BERŽELIS;7436158953;Ne;8;4;0;12
9863;Saulėtekis;ŠYPSENA;9972687066;Ne;2;8;1;11
9864;Saulėtekis;ŠYPSENA;7346852524;Ne;1;1;0;2
9865;Saulėtekis;ŠYPSENA;6072030240;Ne;0;6;0;6
9866;Saulėtekis;ŠYPSENA;7893982893;Ne;0;5;1;6
9867;Saulėtekis;ŠYPSENA;7505040675;Ne;2;4;0;6
9868;Saulėtekis;ŠYPSENA;9791926936;Ne;0;0;3;3
9869;Saulėtekis;ŠYPSENA;8620689981;Ne;0;6;0;6
9870;Saulėtekis;ŠYPSENA;8143793642;Ne;0;6;0;6
9871;Saulėtekis;ŠYPSENA;7673965242;Ne;17;0;1;18
9872;Saulėtekis;ŠYPSENA;3166959569;Ne;0;0;1;1
9873;Saulėtekis;ŠYPSENA;9383567339;Ne;8;0;2;10
9874;Saulėtekis;ŠYPSENA;6608831217;Ne;0;5;0;5
9875;Saulėtekis;ŠYPSENA;7730889108;Ne;0;4;6;10
9876;Saulėtekis;ŠYPSENA;7435424899;Ne;4;4;0;8
9877;Saulėtekis;ŠYPSENA;7803735686;Ne;0;1;0;1
9878;Saulėtekis;ŠYPSENA;9694119292;Ne;6;0;0;6
9879;Saulėtekis;ŠYPSENA;8881524909;Ne;10;4;2;16
9880;Saulėtekis;ŠYPSENA;5518726567;Ne;1;1;0;2
9881;Saulėtekis;ŠYPSENA;2177470008;Ne;0;0;1;1
9882;Saulėtekis;ŠYPSENA;4250589212;Ne;0;0;10;10
9883;Saulėtekis;ŠYPSENA;2686041419;Ne;0;10;3;13
9884;Saulėtekis;NYKŠTUKAI;1896847801;Ne;0;2;0;2
9885;Saulėtekis;NYKŠTUKAI;5748816813;Ne;6;2;0;8
9886;Saulėtekis;NYKŠTUKAI;1416983683;Ne;11;1;0;12
9887;Saulėtekis;NYKŠTUKAI;4758423356;Ne;0;1;0;1
9888;Saulėtekis;NYKŠTUKAI;9270109327;Ne;0;6;0;6
9889;Saulėtekis;NYKŠTUKAI;5183297420;Ne;0;2;0;2
9890;Saulėtekis;NYKŠTUKAI;8007704080;Ne;18;0;0;18
9891;Saulėtekis;NYKŠTUKAI;8683571534;Ne;5;2;0;7
9892;Saulėtekis;NYKŠTUKAI;9481578412;Ne;10;0;0;10
9893;Saulėtekis;NYKŠTUKAI;8167740525;Ne;4;0;1;5
9894;Saulėtekis;NYKŠTUKAI;3371045145;Ne;4;0;1;5
9895;Saulėtekis;NYKŠTUKAI;9818660340;Ne;4;4;0;8
9896;Saulėtekis;NYKŠTUKAI;3729811521;Ne;5;0;0;5
9897;Saulėtekis;NYKŠTUKAI;5888979911;Ne;0;1;0;1
9898;Saulėtekis;NYKŠTUKAI;8090571664;Ne;6;0;0;6
9899;Saulėtekis;NYKŠTUKAI;3957655772;Ne;10;4;1;15
9900;Saulėtekis;NYKŠTUKAI;3270283626;Ne;6;9;0;15
9901;Saulėtekis;PAGRANDUKAS;8102360466;Ne;0;4;0;4
9902;Saulėtekis;PAGRANDUKAS;2371396923;Ne;0;4;0;4
9903;Saulėtekis;PAGRANDUKAS;4152255439;Ne;10;0;1;11
9904;Saulėtekis;PAGRANDUKAS;2209156661;Ne;0;4;1;5
9905;Saulėtekis;PAGRANDUKAS;5552614092;Ne;12;0;1;13
9906;Saulėtekis;PAGRANDUKAS;9497129509;Ne;0;0;1;1
9907;Saulėtekis;PAGRANDUKAS;7186085219;Ne;0;4;0;4
9908;Saulėtekis;PAGRANDUKAS;1020209414;Ne;4;1;0;5
9909;Saulėtekis;PAGRANDUKAS;8745921541;Ne;0;1;0;1
9910;Saulėtekis;PAGRANDUKAS;2728836108;Ne;16;0;1;17
9911;Saulėtekis;PAGRANDUKAS;7164579375;Ne;0;4;1;5
9912;Saulėtekis;PAGRANDUKAS;8574702901;Ne;6;0;0;6
9913;Saulėtekis;PAGRANDUKAS;9941731250;Ne;5;0;0;5
9914;Saulėtekis;PAGRANDUKAS;4038684284;Ne;21;0;0;21
9915;Saulėtekis;PAGRANDUKAS;2935641362;Ne;10;0;5;15
9916;Saulėtekis;PAGRANDUKAS;4676218435;Ne;0;4;1;5
9917;Saulėtekis;PAGRANDUKAS;7598254324;Ne;9;0;1;10
9918;Saulėtekis;PAGRANDUKAS;6026600803;Ne;0;0;1;1
9919;Saulėtekis;PAGRANDUKAS;9737568538;Ne;1;0;0;1
9920;Saulėtekis;PAGRANDUKAS;8468491266;Ne;17;0;0;17
9921;Saulėtekis;PAGRANDUKAS;6181992249;Ne;0;0;3;3
9922;Saulėtekis;PAGRANDUKAS;8390615573;Ne;0;0;5;5
9923;Saulėtekis;PAGRANDUKAS;3366064429;Ne;0;5;0;5
9924;Saulėtekis;PAGRANDUKAS;5824537129;Ne;0;0;4;4
9925;Saulėtekis;RAMUNĖLIŲ;8739919774;Ne;0;11;0;11
9926;Saulėtekis;RAMUNĖLIŲ;4681031693;Ne;5;0;4;9
9927;Saulėtekis;RAMUNĖLIŲ;2316817605;Ne;0;3;1;4
9928;Saulėtekis;RAMUNĖLIŲ;3987535802;Ne;19;1;0;20
9929;Saulėtekis;RAMUNĖLIŲ;6979741482;Ne;0;0;6;6
9930;Saulėtekis;RAMUNĖLIŲ;8348456528;Ne;4;4;0;8
9931;Saulėtekis;RAMUNĖLIŲ;5980690239;Ne;12;4;0;16
9932;Saulėtekis;RAMUNĖLIŲ;2786112846;Ne;4;5;0;9
9933;Saulėtekis;RAMUNĖLIŲ;8876580678;Ne;4;5;0;9
9934;Saulėtekis;RAMUNĖLIŲ;1427323748;Ne;0;0;2;2
9935;Saulėtekis;RAMUNĖLIŲ;3224110585;Ne;0;17;0;17
9936;Saulėtekis;RAMUNĖLIŲ;2002180753;Ne;19;0;0;19
9937;Saulėtekis;RAMUNĖLIŲ;5685176596;Ne;7;0;0;7
9938;Saulėtekis;RAMUNĖLIŲ;9668125862;Ne;5;0;1;6
9939;Saulėtekis;RAMUNĖLIŲ;4736430248;Ne;0;11;0;11
9940;Saulėtekis;RAMUNĖLIŲ;1108736588;Ne;8;0;0;8
9941;Saulėtekis;RAMUNĖLIŲ;3680199463;Ne;10;4;1;15
9942;Saulėtekis;RAMUNĖLIŲ;2383861394;Ne;0;1;0;1
9943;Saulėtekis;RAMUNĖLIŲ;2872732978;Ne;17;2;0;19
9944;Saulėtekis;RAMUNĖLIŲ;9732352141;Ne;5;0;0;5
9945;Saulėtekis;PASAKAITĖ;8033763960;Ne;0;6;0;6
9946;Saulėtekis;PASAKAITĖ;9428709415;Ne;5;0;0;5
9947;Saulėtekis;PASAKAITĖ;5086871001;Ne;6;0;0;6
9948;Saulėtekis;PASAKAITĖ;2446282019;Ne;0;2;0;2
9949;Saulėtekis;PASAKAITĖ;8572701238;Ne;0;2;0;2
9950;Saulėtekis;PASAKAITĖ;6063956790;Ne;6;4;0;10
9951;Saulėtekis;PASAKAITĖ;4437540996;Ne;0;5;0;5
9952;Saulėtekis;PASAKAITĖ;9226317303;Ne;0;1;0;1
9953;Saulėtekis;PASAKAITĖ;9267790598;Ne;15;4;0;19
9954;Saulėtekis;PASAKAITĖ;6670590135;Ne;10;4;0;14
9955;Saulėtekis;PASAKAITĖ;6720758829;Ne;10;1;0;11
9956;Saulėtekis;PASAKAITĖ;7966714585;Ne;7;2;0;9
9957;Saulėtekis;PASAKAITĖ;3224883243;Ne;0;1;0;1
9958;Saulėtekis;PASAKAITĖ;9382031144;Ne;11;4;0;15
9959;Saulėtekis;PASAKAITĖ;3371914339;Ne;0;2;0;2
9960;Saulėtekis;PASAKAITĖ;6214539956;Ne;9;4;0;13
9961;Saulėtekis;PASAKAITĖ;9584556476;Ne;11;4;0;15
9962;Saulėtekis;PASAKAITĖ;9799880235;Ne;0;4;0;4
9963;Saulėtekis;PASAKAITĖ;2469458604;Ne;3;0;0;3
9964;Saulėtekis;PASAKAITĖ;3499575148;Ne;0;3;2;5
9965;Saulėtekis;PASAKAITĖ;2206038658;Ne;11;0;0;11
9966;Saulėtekis;VARPELIAI;3303064486;Ne;8;0;0;8
9967;Saulėtekis;VARPELIAI;1355354514;Ne;6;0;2;8
9968;Saulėtekis;VARPELIAI;8195320453;Ne;0;0;13;13
9969;Saulėtekis;VARPELIAI;6534433593;Ne;10;0;1;11
9970;Saulėtekis;VARPELIAI;5997903066;Ne;5;0;0;5
9971;Saulėtekis;VARPELIAI;7338301696;Ne;5;1;0;6
9972;Saulėtekis;VARPELIAI;9383203972;Ne;0;0;1;1
9973;Saulėtekis;VARPELIAI;7171550857;Ne;13;0;1;14
9974;Saulėtekis;VARPELIAI;3157110037;Ne;11;0;0;11
9975;Saulėtekis;VARPELIAI;8331659142;Ne;0;8;13;21
9976;Saulėtekis;VARPELIAI;3832717108;Ne;12;0;1;13
9977;Saulėtekis;VARPELIAI;1198692142;Ne;10;0;1;11
9978;Saulėtekis;VARPELIAI;1240595768;Ne;10;0;0;10
9979;Saulėtekis;VARPELIAI;9246555859;Ne;0;0;4;4
9980;Saulėtekis;VARPELIAI;1479530265;Ne;5;4;3;12
9981;Saulėtekis;VARPELIAI;1164913351;Ne;0;0;3;3
9982;Saulėtekis;GRŪDELIS;1864236745;Ne;0;3;0;3
9983;Saulėtekis;GRŪDELIS;6535620172;Ne;9;0;1;10
9984;Saulėtekis;GRŪDELIS;8252953405;Ne;0;2;4;6
9985;Saulėtekis;GRŪDELIS;8219644557;Ne;0;0;2;2
9986;Saulėtekis;GRŪDELIS;5161940030;Ne;9;0;0;9
9987;Saulėtekis;GRŪDELIS;9646060606;Ne;0;5;0;5
9988;Saulėtekis;GRŪDELIS;1934900185;Ne;21;0;0;21
9989;Saulėtekis;GRŪDELIS;1331793286;Ne;10;7;4;21
9990;Saulėtekis;GRŪDELIS;9995919137;Ne;6;3;0;9
9991;Saulėtekis;GRŪDELIS;8138047893;Ne;7;6;0;13
9992;Saulėtekis;GRŪDELIS;3953501167;Ne;2;1;3;6
9993;Saulėtekis;GRŪDELIS;6482182524;Ne;0;4;0;4
9994;Saulėtekis;GRŪDELIS;6779891385;Ne;10;4;0;14
9995;Saulėtekis;GRŪDELIS;9743690247;Ne;5;0;0;5
9996;Saulėtekis;GRŪDELIS;7666624373;Ne;2;0;0;2
9997;Saulėtekis;JONVABALIS;1715634399;Ne;0;4;0;4
9998;Saulėtekis;JONVABALIS;7227802003;Ne;0;5;0;5
9999;Saulėtekis;JONVABALIS;4613040294;Ne;0;5;0;5
10000;Saulėtekis;JONVABALIS;1655720839;Ne;0;6;0;6
10001;Saulėtekis;JONVABALIS;3166181835;Ne;2;8;0;10
10002;Saulėtekis;JONVABALIS;6599452886;Ne;2;4;0;6
10003;Saulėtekis;JONVABALIS;8896065807;Ne;11;2;0;13
10004;Saulėtekis;JONVABALIS;3207128776;Ne;0;1;0;1
10005;Saulėtekis;JONVABALIS;2311184444;Ne;0;11;0;11
10006;Saulėtekis;JONVABALIS;9618342480;Ne;0;4;3;7
10007;Saulėtekis;JONVABALIS;1516164123;Ne;10;0;0;10
10008;Saulėtekis;JONVABALIS;60462712074;Ne;0;4;2;6
10009;Saulėtekis;JONVABALIS;1902333363;Ne;4;4;1;9
10010;Saulėtekis;JONVABALIS;4610536784;Ne;3;5;0;8
10011;Saulėtekis;JONVABALIS;8239855620;Ne;0;3;1;4
10012;Saulėtekis;JONVABALIS;6501250875;Ne;0;4;14;18
10013;Saulėtekis;JONVABALIS;8231869593;Ne;0;11;0;11
10014;Saulėtekis;JONVABALIS;8603952810;Ne;2;4;1;7
10015;Saulėtekis;JONVABALIS;9657195627;Ne;10;4;0;14
10016;Saulėtekis;JONVABALIS;3541535891;Ne;0;4;4;8
10017;Saulėtekis;JONVABALIS;4663268649;Ne;6;6;0;12
10018;Saulėtekis;JONVABALIS;25199011812;Ne;0;4;0;4
10019;Saulėtekis;JONVABALIS;9228189399;Ne;0;3;3;6
10020;Saulėtekis;SMALSUČIAI;2474900044;Ne;0;6;0;6
10021;Saulėtekis;SMALSUČIAI;2021901593;Ne;0;3;0;3
10022;Saulėtekis;SMALSUČIAI;5954194843;Ne;0;1;0;1
10023;Saulėtekis;SMALSUČIAI;2546789906;Ne;0;1;0;1
10024;Saulėtekis;SMALSUČIAI;8002806189;Ne;2;1;2;5
10025;Saulėtekis;SMALSUČIAI;4832534190;Ne;9;4;0;13
10026;Saulėtekis;SMALSUČIAI;2238947856;Ne;0;5;2;7
10027;Saulėtekis;SMALSUČIAI;5678858566;Ne;0;7;0;7
10028;Saulėtekis;SMALSUČIAI;2407911405;Ne;0;0;1;1
10029;Saulėtekis;SMALSUČIAI;9634949452;Ne;0;4;1;5
10030;Saulėtekis;SMALSUČIAI;3450907715;Ne;13;6;0;19
10031;Saulėtekis;SMALSUČIAI;4338502152;Ne;2;1;2;5
10032;Saulėtekis;SMALSUČIAI;81153273188;Ne;3;4;0;7
10033;Saulėtekis;SMALSUČIAI;6102064617;Ne;8;4;0;12
10034;Saulėtekis;SMALSUČIAI;7842280836;Ne;0;1;0;1
10035;Saulėtekis;SMALSUČIAI;9945647968;Ne;0;4;0;4
10036;Saulėtekis;SMALSUČIAI;9983577817;Ne;0;1;0;1
10037;Saulėtekis;SMALSUČIAI;84982517658;Ne;0;1;0;1
10038;Saulėtekis;SMALSUČIAI;5487547105;Ne;0;21;0;21
10039;Saulėtekis;SMALSUČIAI;1922979974;Ne;5;1;0;6
10040;Saulėtekis;BITUTĖS;1699576940;Ne;1;3;1;5
10041;Saulėtekis;BITUTĖS;1481503733;Ne;8;0;0;8
10042;Saulėtekis;BITUTĖS;8302260087;Ne;0;1;2;3
10043;Saulėtekis;BITUTĖS;2593106154;Ne;0;7;1;8
10044;Saulėtekis;BITUTĖS;2813949848;Ne;11;1;1;13
10045;Saulėtekis;BITUTĖS;6643388548;Ne;0;1;0;1
10046;Saulėtekis;BITUTĖS;3058991890;Ne;0;10;0;10
10047;Saulėtekis;BITUTĖS;7986712728;Ne;0;7;0;7
10048;Saulėtekis;BITUTĖS;6087170055;Ne;0;2;8;10
10049;Saulėtekis;BITUTĖS;7758268674;Ne;0;1;0;1
10050;Saulėtekis;BITUTĖS;2077976415;Ne;0;2;1;3
10051;Saulėtekis;BITUTĖS;7075757274;Ne;0;9;0;9
10052;Saulėtekis;BITUTĖS;2154590089;Ne;6;4;0;10
10053;Saulėtekis;BITUTĖS;3220993253;Ne;1;0;0;1
10054;Saulėtekis;BITUTĖS;9918219913;Ne;0;3;4;7
10055;Saulėtekis;BITUTĖS;2698535938;Ne;0;4;0;4
10056;Saulėtekis;BITUTĖS;8517049464;Ne;2;2;1;5
10057;Saulėtekis;BITUTĖS;2656659133;Ne;0;7;0;7
10058;Saulėtekis;BITUTĖS;7027103276;Ne;5;4;3;12
10059;Saulėtekis;BITUTĖS;9605052795;Ne;0;4;1;5
10060;Saulėtekis;RIEŠUTĖLIAI;8767786444;Ne;7;0;0;7
10061;Saulėtekis;RIEŠUTĖLIAI;2224626144;Ne;15;0;0;15
10062;Saulėtekis;RIEŠUTĖLIAI;3356705340;Ne;15;0;2;17
10063;Saulėtekis;RIEŠUTĖLIAI;7824492464;Ne;6;0;0;6
10064;Saulėtekis;RIEŠUTĖLIAI;3935935671;Ne;8;0;0;8
10065;Saulėtekis;RIEŠUTĖLIAI;7807096583;Ne;6;0;0;6
10066;Saulėtekis;RIEŠUTĖLIAI;2548612572;Ne;6;0;0;6
10067;Saulėtekis;RIEŠUTĖLIAI;2908714227;Ne;16;0;2;18
10068;Saulėtekis;RIEŠUTĖLIAI;7305619721;Ne;0;10;10;20
10069;Saulėtekis;RIEŠUTĖLIAI;9516841263;Ne;10;0;1;11
10070;Saulėtekis;RIEŠUTĖLIAI;6183384994;Ne;6;0;0;6
10071;Saulėtekis;RIEŠUTĖLIAI;1540848694;Ne;0;3;0;3
10072;Saulėtekis;RIEŠUTĖLIAI;3559882322;Ne;0;0;2;2
10073;Saulėtekis;RIEŠUTĖLIAI;4767842376;Ne;9;0;2;11
10074;Skroblinukas;SVIRPLIUKŲ;5433647187;Ne;8;5;0;13
10075;Skroblinukas;SVIRPLIUKŲ;2195112297;Ne;5;1;1;7
10076;Skroblinukas;SVIRPLIUKŲ;4198512202;Ne;9;5;15;29
10077;Skroblinukas;SVIRPLIUKŲ;7750501815;Ne;11;0;2;13
10078;Skroblinukas;SVIRPLIUKŲ;4960825597;Ne;7;4;1;12
10079;Skroblinukas;SVIRPLIUKŲ;1544598440;Ne;2;0;0;2
10080;Skroblinukas;SVIRPLIUKŲ;6574558658;Ne;7;1;1;9
10081;Skroblinukas;SVIRPLIUKŲ;4861971439;Ne;8;1;4;13
10082;Skroblinukas;SVIRPLIUKŲ;7817632987;Ne;0;5;3;8
10083;Skroblinukas;SVIRPLIUKŲ;7675772872;Ne;0;0;4;4
10084;Skroblinukas;SVIRPLIUKŲ;4266945644;Ne;0;0;4;4
10085;Skroblinukas;SVIRPLIUKŲ;9003855190;Ne;0;19;0;19
10086;Skroblinukas;SVIRPLIUKŲ;7216760382;Ne;5;1;3;9
10087;Skroblinukas;SVIRPLIUKŲ;5154111867;Ne;0;11;0;11
10088;Skroblinukas;SVIRPLIUKŲ;8622930871;Ne;10;0;1;11
10089;Skroblinukas;SVIRPLIUKŲ;9661609284;Ne;1;0;0;1
10090;Skroblinukas;SVIRPLIUKŲ;3260267388;Ne;6;0;2;8
10091;Skroblinukas;SVIRPLIUKŲ;7761972818;Ne;0;1;0;1
10092;Skroblinukas;SVIRPLIUKŲ;9629502585;Ne;0;8;0;8
10093;Skroblinukas;SVIRPLIUKŲ;6461678336;Ne;0;8;0;8
10094;Skroblinukas;SVIRPLIUKŲ;8283516422;Ne;17;0;0;17
10095;Skroblinukas;GANDRIUKŲ;2197158518;Ne;0;5;6;11
10096;Skroblinukas;GANDRIUKŲ;2406619611;Ne;11;4;1;16
10097;Skroblinukas;GANDRIUKŲ;9572912046;Ne;0;20;0;20
10098;Skroblinukas;GANDRIUKŲ;5646847921;Ne;5;0;0;5
10099;Skroblinukas;GANDRIUKŲ;1851920334;Ne;0;5;1;6
10100;Skroblinukas;GANDRIUKŲ;9377215921;Ne;0;12;0;12
10101;Skroblinukas;GANDRIUKŲ;6235844690;Ne;0;6;1;7
10102;Skroblinukas;GANDRIUKŲ;6489976163;Ne;0;10;1;11
10103;Skroblinukas;GANDRIUKŲ;1159546580;Ne;0;2;0;2
10104;Skroblinukas;GANDRIUKŲ;2630699296;Ne;0;3;0;3
10105;Skroblinukas;GANDRIUKŲ;2310750833;Ne;0;8;5;13
10106;Skroblinukas;GANDRIUKŲ;9888115079;Ne;0;2;0;2
10107;Skroblinukas;GANDRIUKŲ;9475514959;Ne;0;8;0;8
10108;Skroblinukas;GANDRIUKŲ;9031598603;Ne;5;2;5;12
10109;Skroblinukas;GANDRIUKŲ;5251903769;Ne;0;15;1;16
10110;Skroblinukas;GANDRIUKŲ;7385271438;Ne;9;0;2;11
10111;Skroblinukas;VYTURIUKŲ;3954228349;Ne;0;0;3;3
10112;Skroblinukas;VYTURIUKŲ;6879979868;Ne;8;0;0;8
10113;Skroblinukas;VYTURIUKŲ;4560580022;Ne;0;4;4;8
10114;Skroblinukas;VYTURIUKŲ;3065235192;Ne;0;0;2;2
10115;Skroblinukas;VYTURIUKŲ;5902713448;Ne;5;3;0;8
10116;Skroblinukas;VYTURIUKŲ;3594000419;Ne;0;7;0;7
10117;Skroblinukas;VYTURIUKŲ;3512297435;Ne;0;7;0;7
10118;Skroblinukas;VYTURIUKŲ;2481980627;Ne;19;0;0;19
10119;Skroblinukas;VYTURIUKŲ;6293879765;Ne;0;0;1;1
10120;Skroblinukas;VYTURIUKŲ;9725125130;Ne;0;4;0;4
10121;Skroblinukas;VYTURIUKŲ;2978284436;Ne;0;7;0;7
10122;Skroblinukas;VYTURIUKŲ;7068452970;Ne;0;0;4;4
10123;Skroblinukas;VYTURIUKŲ;3292517112;Ne;0;2;0;2
10124;Skroblinukas;VYTURIUKŲ;3461165182;Ne;0;0;21;21
10125;Skroblinukas;VYTURIUKŲ;4129726208;Ne;0;0;2;2
10126;Skroblinukas;VYTURIUKŲ;3351309750;Ne;7;0;1;8
10127;Skroblinukas;VYTURIUKŲ;5101136022;Ne;0;4;3;7
10128;Skroblinukas;VYTURIUKŲ;9828486832;Ne;0;0;1;1
10129;Skroblinukas;GENIUKŲ;48655837755;Ne;0;4;0;4
10130;Skroblinukas;GENIUKŲ;2323980730;Ne;0;0;4;4
10131;Skroblinukas;GENIUKŲ;1325903217;Ne;0;7;2;9
10132;Skroblinukas;GENIUKŲ;8380073853;Ne;0;0;3;3
10133;Skroblinukas;GENIUKŲ;4436698905;Ne;4;0;0;4
10134;Skroblinukas;GENIUKŲ;1905085978;Ne;0;0;6;6
10135;Skroblinukas;GENIUKŲ;1557733803;Ne;9;3;0;12
10136;Skroblinukas;GENIUKŲ;9433465007;Ne;3;2;1;6
10137;Skroblinukas;GENIUKŲ;1395950886;Ne;10;4;0;14
10138;Skroblinukas;GENIUKŲ;1696303051;Ne;2;5;0;7
10139;Skroblinukas;GENIUKŲ;9846569195;Ne;0;4;1;5
10140;Skroblinukas;GENIUKŲ;4773576465;Ne;0;4;0;4
10141;Skroblinukas;GENIUKŲ;2704157855;Ne;0;4;0;4
10142;Skroblinukas;GENIUKŲ;9564385215;Ne;4;2;3;9
10143;Skroblinukas;GENIUKŲ;6129591146;Ne;6;5;0;11
10144;Skroblinukas;GENIUKŲ;3128337104;Ne;0;2;0;2
10145;Skroblinukas;GENIUKŲ;4272941994;Ne;6;4;2;12
10146;Skroblinukas;GENIUKŲ;3864043251;Ne;0;4;1;5
10147;Skroblinukas;GENIUKŲ;1064449916;Ne;5;4;0;9
10148;Skroblinukas;GENIUKŲ;2071447940;Ne;5;0;0;5
10149;Skroblinukas;BITUČIŲ;1255323441;Ne;0;1;0;1
10150;Skroblinukas;BITUČIŲ;1934804499;Ne;6;4;0;10
10151;Skroblinukas;BITUČIŲ;2134821488;Ne;15;0;0;15
10152;Skroblinukas;BITUČIŲ;6604496585;Ne;0;2;0;2
10153;Skroblinukas;BITUČIŲ;3736883850;Ne;2;2;0;4
10154;Skroblinukas;BITUČIŲ;7191689856;Ne;0;14;1;15
10155;Skroblinukas;BITUČIŲ;8778072326;Ne;4;0;0;4
10156;Skroblinukas;BITUČIŲ;2032621707;Ne;10;3;1;14
10157;Skroblinukas;BITUČIŲ;8277152812;Ne;0;1;1;2
10158;Skroblinukas;BITUČIŲ;8374103872;Ne;0;8;0;8
10159;Skroblinukas;BITUČIŲ;8618587013;Ne;2;2;0;4
10160;Skroblinukas;BITUČIŲ;4945107862;Ne;0;2;1;3
10161;Skroblinukas;BITUČIŲ;9594078223;Ne;0;8;0;8
10162;Skroblinukas;BITUČIŲ;1688990637;Ne;6;1;0;7
10163;Skroblinukas;BITUČIŲ;1957488412;Ne;0;5;2;7
10164;Skroblinukas;BITUČIŲ;1000804920;Ne;0;1;0;1
10165;Skroblinukas;BITUČIŲ;1711568129;Ne;0;9;3;12
10166;Skroblinukas;BITUČIŲ;1293348150;Ne;0;0;1;1
10167;Skroblinukas;BITUČIŲ;9664357125;Ne;0;2;9;11
10168;Skroblinukas;BITUČIŲ;6227583229;Ne;5;4;1;10
10169;Skroblinukas;BORUŽĖLIŲ;8715188878;Ne;0;19;7;26
10170;Skroblinukas;BORUŽĖLIŲ;7407601996;Ne;0;1;0;1
10171;Skroblinukas;BORUŽĖLIŲ;5841866621;Ne;1;3;4;8
10172;Skroblinukas;BORUŽĖLIŲ;9341501143;Ne;6;0;1;7
10173;Skroblinukas;BORUŽĖLIŲ;2523742608;Ne;2;0;2;4
10174;Skroblinukas;BORUŽĖLIŲ;2311459579;Ne;5;0;2;7
10175;Skroblinukas;BORUŽĖLIŲ;3490684777;Ne;15;0;0;15
10176;Skroblinukas;BORUŽĖLIŲ;2717586232;Ne;0;4;0;4
10177;Skroblinukas;BORUŽĖLIŲ;4840767748;Ne;5;6;0;11
10178;Skroblinukas;BORUŽĖLIŲ;5694105568;Ne;7;0;1;8
10179;Skroblinukas;BORUŽĖLIŲ;7771969055;Ne;0;1;9;10
10180;Skroblinukas;BORUŽĖLIŲ;4631657273;Ne;9;0;6;15
10181;Skroblinukas;BORUŽĖLIŲ;8711201474;Ne;0;4;5;9
10182;Skroblinukas;BORUŽĖLIŲ;9513546028;Ne;11;0;13;24
10183;Skroblinukas;SKRUZDĖLIUKŲ;5688453546;Ne;0;4;0;4
10184;Skroblinukas;SKRUZDĖLIUKŲ;6890306112;Ne;0;5;0;5
10185;Skroblinukas;SKRUZDĖLIUKŲ;6445065388;Ne;8;5;0;13
10186;Skroblinukas;SKRUZDĖLIUKŲ;3006521657;Ne;0;2;0;2
10187;Skroblinukas;SKRUZDĖLIUKŲ;9448253468;Ne;0;0;2;2
10188;Skroblinukas;SKRUZDĖLIUKŲ;3771045336;Ne;0;1;0;1
10189;Skroblinukas;SKRUZDĖLIUKŲ;9353353289;Ne;0;5;0;5
10190;Skroblinukas;SKRUZDĖLIUKŲ;5252389111;Ne;5;3;0;8
10191;Skroblinukas;SKRUZDĖLIUKŲ;5157913924;Ne;0;13;0;13
10192;Skroblinukas;SKRUZDĖLIUKŲ;9958188318;Ne;0;6;0;6
10193;Skroblinukas;SKRUZDĖLIUKŲ;8576448571;Ne;0;10;0;10
10194;Skroblinukas;SKRUZDĖLIUKŲ;1002570367;Ne;0;3;1;4
10195;Skroblinukas;SKRUZDĖLIUKŲ;3290115134;Ne;0;5;6;11
10196;Skroblinukas;SKRUZDĖLIUKŲ;9813249677;Ne;0;7;0;7
10197;Skroblinukas;SKRUZDĖLIUKŲ;2101748012;Ne;0;0;1;1
10198;Skroblinukas;SKRUZDĖLIUKŲ;2706526326;Ne;0;0;1;1
10199;Skroblinukas;SKRUZDĖLIUKŲ;6640062847;Ne;8;2;0;10
10200;Skroblinukas;ŽVIRBLIUKŲ;9162582460;Ne;7;0;0;7
10201;Skroblinukas;ŽVIRBLIUKŲ;7955574061;Ne;4;2;0;6
10202;Skroblinukas;ŽVIRBLIUKŲ;1232121301;Ne;5;2;0;7
10203;Skroblinukas;ŽVIRBLIUKŲ;1014993354;Ne;0;7;0;7
10204;Skroblinukas;ŽVIRBLIUKŲ;1167332689;Ne;0;1;0;1
10205;Skroblinukas;ŽVIRBLIUKŲ;7527177120;Ne;0;3;0;3
10206;Skroblinukas;ŽVIRBLIUKŲ;4002729040;Ne;2;0;0;2
10207;Skroblinukas;ŽVIRBLIUKŲ;4197050176;Ne;0;7;0;7
10208;Skroblinukas;ŽVIRBLIUKŲ;4390614970;Ne;2;0;0;2
10209;Skroblinukas;ŽVIRBLIUKŲ;6070633607;Ne;2;0;0;2
10210;Skroblinukas;ŽVIRBLIUKŲ;6135412007;Ne;14;0;3;17
10211;Skroblinukas;ŽVIRBLIUKŲ;2312400921;Ne;14;0;3;17
10212;Skroblinukas;ŽVIRBLIUKŲ;4491947846;Ne;17;3;0;20
10213;Skroblinukas;ŽVIRBLIUKŲ;7804920443;Ne;8;0;1;9
10214;Skroblinukas;ŽIOGELIŲ;2885814517;Ne;6;6;0;12
10215;Skroblinukas;ŽIOGELIŲ;2363368201;Ne;4;8;0;12
10216;Skroblinukas;ŽIOGELIŲ;4639384934;Ne;7;1;1;9
10217;Skroblinukas;ŽIOGELIŲ;5206925237;Ne;20;0;0;20
10218;Skroblinukas;ŽIOGELIŲ;7581372511;Ne;0;0;3;3
10219;Skroblinukas;ŽIOGELIŲ;6279909049;Ne;13;0;0;13
10220;Skroblinukas;ŽIOGELIŲ;8998236911;Ne;8;4;0;12
10221;Skroblinukas;ŽIOGELIŲ;6791969485;Ne;9;5;0;14
10222;Skroblinukas;ŽIOGELIŲ;9737310101;Ne;0;0;4;4
10223;Skroblinukas;ŽIOGELIŲ;8680329175;Ne;11;1;4;16
10224;Skroblinukas;ŽIOGELIŲ;7028068342;Ne;6;6;1;13
10225;Skroblinukas;ŽIOGELIŲ;8118284793;Ne;9;0;1;10
10226;Skroblinukas;ŽIOGELIŲ;1844211217;Ne;11;0;2;13
10227;Skroblinukas;ŽIOGELIŲ;5354832150;Ne;3;3;0;6
10228;Skroblinukas;ŽIOGELIŲ;3689247672;Ne;2;1;1;4
10229;Skroblinukas;ŽIOGELIŲ;6717008836;Ne;5;4;0;9
10230;Skroblinukas;STRAZDELIŲ;1820748152;Ne;7;5;0;12
10231;Skroblinukas;STRAZDELIŲ;5946356374;Ne;26;0;0;26
10232;Skroblinukas;STRAZDELIŲ;5274898590;Ne;0;10;0;10
10233;Skroblinukas;STRAZDELIŲ;8629189405;Taip;9;0;0;9
10234;Skroblinukas;STRAZDELIŲ;4091852305;Ne;0;5;0;5
10235;Skroblinukas;STRAZDELIŲ;9809817630;Ne;24;0;0;24
10236;Skroblinukas;STRAZDELIŲ;6475609065;Ne;5;0;5;10
10237;Skroblinukas;STRAZDELIŲ;1762416639;Ne;0;0;1;1
10238;Skroblinukas;STRAZDELIŲ;3705638869;Ne;11;7;0;18
10239;Skroblinukas;STRAZDELIŲ;2511496284;Ne;6;0;7;13
10240;Skroblinukas;STRAZDELIŲ;7153774246;Ne;6;0;0;6
10241;Skroblinukas;STRAZDELIŲ;7045587415;Ne;1;0;3;4
10242;Skroblinukas;STRAZDELIŲ;8734405028;Ne;0;13;0;13
10243;Skroblinukas;STRAZDELIŲ;3885884265;Ne;0;6;8;14
10244;Skroblinukas;STRAZDELIŲ;8544069746;Ne;11;2;1;14
10245;Skroblinukas;STRAZDELIŲ;6011466024;Ne;7;0;1;8
10246;Skroblinukas;DRUGELIŲ;8305867345;Ne;0;0;4;4
10247;Skroblinukas;DRUGELIŲ;7400908711;Ne;0;10;2;12
10248;Skroblinukas;DRUGELIŲ;3889890374;Ne;0;1;0;1
10249;Skroblinukas;DRUGELIŲ;9481718833;Ne;4;0;0;4
10250;Skroblinukas;DRUGELIŲ;8864594520;Ne;11;0;0;11
10251;Skroblinukas;DRUGELIŲ;2772360168;Ne;0;1;0;1
10252;Skroblinukas;DRUGELIŲ;3624518310;Ne;6;1;1;8
10253;Skroblinukas;DRUGELIŲ;4831370981;Ne;0;5;0;5
10254;Skroblinukas;DRUGELIŲ;5957417413;Ne;0;6;0;6
10255;Skroblinukas;DRUGELIŲ;3226115050;Ne;3;0;1;4
10256;Skroblinukas;DRUGELIŲ;2887161771;Ne;0;1;0;1
10257;Skroblinukas;DRUGELIŲ;4737605061;Ne;0;14;5;19
10258;Skroblinukas;DRUGELIŲ;8390240445;Ne;4;0;0;4
10259;Skroblinukas;DRUGELIŲ;2948231687;Ne;13;1;0;14
10260;Skroblinukas;DRUGELIŲ;5912771080;Ne;10;0;0;10
10261;Skroblinukas;DRUGELIŲ;7528824951;Ne;10;0;0;10
10262;Skroblinukas;DRUGELIŲ;2987938909;Ne;11;4;0;15
10263;Skroblinukas;DRUGELIŲ;8286842648;Ne;10;1;0;11
10264;Skroblinukas;DRUGELIŲ;1453029732;Ne;13;3;0;16
10265;Skroblinukas;PELĖDŽIUKŲ;8953844650;Ne;0;1;0;1
10266;Skroblinukas;PELĖDŽIUKŲ;3646325903;Ne;0;2;1;3
10267;Skroblinukas;PELĖDŽIUKŲ;9292990596;Ne;3;1;0;4
10268;Skroblinukas;PELĖDŽIUKŲ;8202855376;Ne;8;1;8;17
10269;Skroblinukas;PELĖDŽIUKŲ;8312341293;Ne;0;6;1;7
10270;Skroblinukas;PELĖDŽIUKŲ;3658815079;Ne;3;0;0;3
10271;Skroblinukas;PELĖDŽIUKŲ;5418212729;Ne;7;0;0;7
10272;Skroblinukas;PELĖDŽIUKŲ;4168542339;Ne;8;0;7;15
10273;Skroblinukas;PELĖDŽIUKŲ;8958893525;Ne;3;2;1;6
10274;Skroblinukas;PELĖDŽIUKŲ;6675716937;Ne;4;0;2;6
10275;Skroblinukas;PELĖDŽIUKŲ;1009065470;Ne;14;3;0;17
10276;Skroblinukas;PELĖDŽIUKŲ;9699407871;Ne;5;0;0;5
10277;Skroblinukas;PELĖDŽIUKŲ;9553242594;Ne;0;7;0;7
10278;Skroblinukas;PELĖDŽIUKŲ;3532258904;Ne;9;0;0;9
10279;Skroblinukas;PELĖDŽIUKŲ;1758987652;Ne;0;6;2;8
10280;Skroblinukas;PELĖDŽIUKŲ;8465074037;Ne;0;0;5;5
10281;Skroblinukas;PELĖDŽIUKŲ;2071093890;Ne;0;4;0;4
10282;Skroblinukas;PELĖDŽIUKŲ;9523720873;Ne;8;0;8;16
10283;Skroblinukas;PELĖDŽIUKŲ;7920117036;Ne;5;1;0;6
10284;Skroblinukas;PELĖDŽIUKŲ;2215428081;Ne;0;2;0;2
10285;Smalsučiai;Žibuoklės;6535494814;Ne;0;0;2;2
10286;Smalsučiai;Žibuoklės;3309134310;Ne;5;9;0;14
10287;Smalsučiai;Žibuoklės;4094037708;Ne;0;0;6;6
10288;Smalsučiai;Žibuoklės;5893045664;Ne;4;0;0;4
10289;Smalsučiai;Žibuoklės;5482692473;Ne;0;4;2;6
10290;Smalsučiai;Žibuoklės;2742992400;Ne;0;0;1;1
10291;Smalsučiai;Žibuoklės;6299355505;Ne;0;3;0;3
10292;Smalsučiai;Žibuoklės;3877274360;Ne;10;1;0;11
10293;Smalsučiai;Žibuoklės;9988599126;Ne;1;0;0;1
10294;Smalsučiai;Žibuoklės;5489140006;Ne;0;1;1;2
10295;Smalsučiai;Žibuoklės;5900294530;Ne;0;0;3;3
10296;Smalsučiai;Žibuoklės;1380214235;Ne;5;0;1;6
10297;Smalsučiai;Žibuoklės;8644849194;Ne;21;0;0;21
10298;Smalsučiai;Žibuoklės;4506058735;Ne;5;1;0;6
10299;Smalsučiai;Žibuoklės;6931092874;Ne;11;0;1;12
10300;Smalsučiai;Žibuoklės;7070240693;Ne;0;1;0;1
10301;Smalsučiai;Aitvarų;3349726106;Ne;11;1;0;12
10302;Smalsučiai;Aitvarų;2219168902;Ne;0;0;5;5
10303;Smalsučiai;Aitvarų;9305837033;Ne;8;0;1;9
10304;Smalsučiai;Aitvarų;9305837033;Ne;8;0;1;9
10305;Smalsučiai;Aitvarų;9305837033;Ne;8;0;1;9
10306;Smalsučiai;Aitvarų;8284740122;Ne;9;0;4;13
10307;Smalsučiai;Aitvarų;1309254661;Ne;0;4;2;6
10308;Smalsučiai;Aitvarų;8985656809;Ne;0;0;5;5
10309;Smalsučiai;Aitvarų;6032887449;Ne;4;2;0;6
10310;Smalsučiai;Aitvarų;9821259659;Ne;3;0;0;3
10311;Smalsučiai;Aitvarų;4054278651;Ne;10;0;0;10
10312;Smalsučiai;Aitvarų;6232068532;Ne;8;1;5;14
10313;Smalsučiai;Aitvarų;3157534923;Ne;9;0;0;9
10314;Smalsučiai;Aitvarų;6825499095;Ne;3;0;3;6
10315;Smalsučiai;Aitvarų;4832292565;Ne;11;0;0;11
10316;Smalsučiai;Aitvarų;2835117069;Ne;5;0;0;5
10317;Smalsučiai;Sraigiukų;7933302912;Ne;4;4;0;8
10318;Smalsučiai;Sraigiukų;1471941426;Ne;0;9;0;9
10319;Smalsučiai;Sraigiukų;1458544456;Ne;0;7;0;7
10320;Smalsučiai;Sraigiukų;5406430393;Ne;7;6;0;13
10321;Smalsučiai;Sraigiukų;9582225178;Ne;0;3;0;3
10322;Smalsučiai;Sraigiukų;9604182559;Ne;0;19;0;19
10323;Smalsučiai;Sraigiukų;6469604093;Ne;0;2;0;2
10324;Smalsučiai;Sraigiukų;4364810458;Ne;0;4;0;4
10325;Smalsučiai;Sraigiukų;4566816316;Ne;5;5;0;10
10326;Smalsučiai;Sraigiukų;5184903287;Ne;0;4;0;4
10327;Smalsučiai;Sraigiukų;7396172351;Ne;0;2;0;2
10328;Smalsučiai;Sraigiukų;6358800570;Ne;3;5;0;8
10329;Smalsučiai;Sraigiukų;2327930850;Ne;0;1;0;1
10330;Smalsučiai;Sraigiukų;3787937467;Ne;8;6;0;14
10331;Smalsučiai;Sraigiukų;4824786207;Ne;0;1;0;1
10332;Smalsučiai;Sraigiukų;3399798448;Ne;0;4;0;4
10333;Smalsučiai;Sraigiukų;1997966082;Ne;0;3;0;3
10334;Smalsučiai;Sraigiukų;4585930202;Ne;0;9;0;9
10335;Smalsučiai;Sraigiukų;9155011285;Ne;0;4;0;4
10336;Smalsučiai;Saulučių;1776385691;Ne;3;2;0;5
10337;Smalsučiai;Saulučių;2259361924;Ne;3;0;6;9
10338;Smalsučiai;Saulučių;1162964613;Ne;0;0;7;7
10339;Smalsučiai;Saulučių;9934952886;Ne;9;1;1;11
10340;Smalsučiai;Saulučių;9556433086;Ne;0;11;0;11
10341;Smalsučiai;Saulučių;1904973393;Ne;10;1;0;11
10342;Smalsučiai;Saulučių;3252901131;Ne;5;0;4;9
10343;Smalsučiai;Saulučių;9743116843;Ne;0;0;10;10
10344;Smalsučiai;Saulučių;2392217952;Ne;15;0;0;15
10345;Smalsučiai;Saulučių;1447512509;Ne;2;0;17;19
10346;Smalsučiai;Saulučių;7774766882;Ne;0;0;2;2
10347;Smalsučiai;Saulučių;2034284973;Ne;7;4;0;11
10348;Smalsučiai;Saulučių;7423419934;Ne;9;0;0;9
10349;Smalsučiai;Saulučių;7049101015;Ne;0;5;1;6
10350;Smalsučiai;Saulučių;9183519167;Ne;11;0;2;13
10351;Smalsučiai;Saulučių;5708986552;Ne;13;0;0;13
10352;Smalsučiai;Saulučių;8630411244;Ne;0;3;0;3
10353;Smalsučiai;Saulučių;5541908981;Ne;6;0;3;9
10354;Smalsučiai;Viščiukų;6006832443;Ne;0;3;2;5
10355;Smalsučiai;Viščiukų;9864518144;Ne;0;7;0;7
10356;Smalsučiai;Viščiukų;8128348060;Ne;9;5;1;15
10357;Smalsučiai;Viščiukų;6415906523;Ne;7;0;0;7
10358;Smalsučiai;Viščiukų;9732075162;Ne;0;2;0;2
10359;Smalsučiai;Viščiukų;6090391818;Ne;15;4;0;19
10360;Smalsučiai;Viščiukų;7023531176;Ne;0;5;0;5
10361;Smalsučiai;Viščiukų;8259056296;Ne;5;0;0;5
10362;Smalsučiai;Viščiukų;9637877396;Ne;4;0;4;8
10363;Smalsučiai;Viščiukų;7137550663;Ne;4;0;0;4
10364;Smalsučiai;Viščiukų;2958335372;Ne;0;6;0;6
10365;Smalsučiai;Viščiukų;3582805599;Ne;0;3;0;3
10366;Smalsučiai;Viščiukų;3757955200;Ne;7;5;0;12
10367;Smalsučiai;Viščiukų;7874635165;Ne;0;4;8;12
10368;Smalsučiai;Viščiukų;5098291946;Ne;0;6;0;6
10369;Smalsučiai;Viščiukų;8578693978;Ne;0;10;0;10
10370;Smalsučiai;Viščiukų;4379645417;Ne;0;7;0;7
10371;Smalsučiai;Viščiukų;5536697307;Ne;0;4;17;21
10372;Smalsučiai;Boružėlių;9426629964;Ne;0;1;0;1
10373;Smalsučiai;Boružėlių;1703679877;Ne;0;1;1;2
10374;Smalsučiai;Boružėlių;2208462326;Ne;0;6;0;6
10375;Smalsučiai;Boružėlių;6643253926;Ne;0;1;0;1
10376;Smalsučiai;Boružėlių;1473016908;Ne;0;1;0;1
10377;Smalsučiai;Boružėlių;7226242747;Ne;0;6;0;6
10378;Smalsučiai;Boružėlių;6085020049;Ne;0;6;0;6
10379;Smalsučiai;Boružėlių;8340768848;Ne;0;1;0;1
10380;Smalsučiai;Boružėlių;6578328053;Ne;0;0;1;1
10381;Smalsučiai;Boružėlių;69450514879;Ne;0;6;1;7
10382;Smalsučiai;Boružėlių;2694575252;Ne;0;1;0;1
10383;Smalsučiai;Boružėlių;3063127699;Ne;0;6;0;6
10384;Smalsučiai;Boružėlių;2737886714;Ne;0;7;0;7
10385;Smalsučiai;Boružėlių;8523742213;Ne;0;4;5;9
10386;Smalsučiai;Boružėlių;2034790691;Ne;0;0;7;7
10387;Smalsučiai;Boružėlių;5325706638;Ne;0;4;0;4
10388;Smalsučiai;Boružėlių;9314811354;Ne;0;6;0;6
10389;Smalsučiai;Boružėlių;9196634595;Ne;0;3;0;3
10390;Smalsučiai;Zuikių;2802867649;Ne;0;3;0;3
10391;Smalsučiai;Zuikių;96002139110;Ne;0;2;1;3
10392;Smalsučiai;Zuikių;2953239027;Ne;0;10;0;10
10393;Smalsučiai;Zuikių;2638709634;Ne;0;1;0;1
10394;Smalsučiai;Zuikių;5441966713;Ne;5;1;0;6
10395;Smalsučiai;Zuikių;9632022271;Ne;0;7;0;7
10396;Smalsučiai;Zuikių;8306946163;Ne;0;9;0;9
10397;Smalsučiai;Zuikių;6469044880;Ne;0;9;0;9
10398;Smalsučiai;Zuikių;99467576480;Ne;0;3;0;3
10399;Smalsučiai;Zuikių;2136420967;Ne;0;1;0;1
10400;Smalsučiai;Zuikių;2059832436;Ne;0;2;0;2
10401;Smalsučiai;Zuikių;1316590100;Ne;0;5;0;5
10402;Smalsučiai;Zuikių;1372591510;Ne;0;4;0;4
10403;Smalsučiai;Zuikių;8810690546;Ne;0;9;0;9
10404;Smalsučiai;Zuikių;9703726869;Ne;0;4;0;4
10405;Smalsučiai;Zuikių;2365835087;Ne;0;4;0;4
10406;Smalsučiai;Zuikių;9481692900;Ne;0;3;0;3
10407;Smalsučiai;Zuikių;4909226602;Ne;0;4;2;6
10408;Smalsučiai;Zuikių;6536165801;Ne;0;1;0;1
10409;Smalsučiai;Zuikių;3644256220;Ne;0;1;0;1
10410;Smalsučiai;Nykštukų;9181601713;Ne;7;3;0;10
10411;Smalsučiai;Nykštukų;1247774684;Ne;6;0;0;6
10412;Smalsučiai;Nykštukų;2375360937;Ne;0;6;0;6
10413;Smalsučiai;Nykštukų;2015172985;Ne;0;1;0;1
10414;Smalsučiai;Nykštukų;8893480054;Ne;7;0;0;7
10415;Smalsučiai;Nykštukų;6996192450;Ne;0;1;6;7
10416;Smalsučiai;Nykštukų;9378696084;Ne;10;0;0;10
10417;Smalsučiai;Nykštukų;7267389695;Ne;21;0;0;21
10418;Smalsučiai;Nykštukų;6996901033;Ne;0;0;1;1
10419;Smalsučiai;Nykštukų;4847212069;Ne;0;0;4;4
10420;Smalsučiai;Nykštukų;1344461213;Ne;3;0;1;4
10421;Smalsučiai;Nykštukų;1224857159;Ne;0;3;0;3
10422;Smalsučiai;Nykštukų;8690626891;Ne;0;15;0;15
10423;Smalsučiai;Nykštukų;5719056997;Ne;19;1;1;21
10424;Smalsučiai;Nykštukų;3646740184;Ne;5;1;6;12
10425;Smalsučiai;Nykštukų;6642882883;Ne;15;0;1;16
10426;Smalsučiai;Nykštukų;7143824796;Ne;0;0;1;1
10427;Smalsučiai;Nykštukų;4457317471;Ne;7;0;2;9
10428;Smalsučiai;Katinėlių;4760366724;Ne;0;3;0;3
10429;Smalsučiai;Katinėlių;2045283348;Ne;7;0;0;7
10430;Smalsučiai;Katinėlių;9710944054;Ne;0;0;4;4
10431;Smalsučiai;Katinėlių;5213319192;Ne;15;0;0;15
10432;Smalsučiai;Katinėlių;3782502443;Ne;0;2;0;2
10433;Smalsučiai;Katinėlių;6358968221;Ne;0;3;0;3
10434;Smalsučiai;Katinėlių;9984878984;Ne;17;2;0;19
10435;Smalsučiai;Katinėlių;5535858303;Ne;0;2;0;2
10436;Smalsučiai;Katinėlių;8724759192;Ne;1;4;0;5
10437;Smalsučiai;Katinėlių;2662588310;Ne;6;1;2;9
10438;Smalsučiai;Katinėlių;2668720481;Ne;0;1;0;1
10439;Smalsučiai;Katinėlių;4030955447;Ne;0;2;1;3
10440;Smalsučiai;Katinėlių;2926560092;Ne;0;1;0;1
10441;Smalsučiai;Katinėlių;8210141253;Ne;5;1;0;6
10442;Smalsučiai;Katinėlių;6131743288;Ne;0;0;2;2
10443;Smalsučiai;Katinėlių;7318218997;Ne;11;0;0;11
10444;Smalsučiai;PELĖDŽIUKAI;1668692281;Ne;4;1;0;5
10445;Smalsučiai;PELĖDŽIUKAI;7794541741;Ne;0;4;6;10
10446;Smalsučiai;PELĖDŽIUKAI;1181574676;Ne;7;7;0;14
10447;Smalsučiai;PELĖDŽIUKAI;1599488035;Ne;0;4;0;4
10448;Smalsučiai;PELĖDŽIUKAI;4727475042;Ne;0;1;0;1
10449;Smalsučiai;PELĖDŽIUKAI;8520753848;Ne;0;4;0;4
10450;Smalsučiai;PELĖDŽIUKAI;22791221635;Ne;0;4;0;4
10451;Smalsučiai;PELĖDŽIUKAI;3607226859;Ne;0;11;0;11
10452;Smalsučiai;PELĖDŽIUKAI;1467603676;Ne;0;3;0;3
10453;Smalsučiai;PELĖDŽIUKAI;5159799570;Ne;0;7;0;7
10454;Smalsučiai;PELĖDŽIUKAI;19592364606;Ne;0;14;0;14
10455;Smalsučiai;PELĖDŽIUKAI;1824321380;Ne;0;4;0;4
10456;Smalsučiai;PELĖDŽIUKAI;6207026048;Ne;0;8;0;8
10457;Smalsučiai;PELĖDŽIUKAI;4145769042;Ne;0;4;0;4
10458;Smalsučiai;PELĖDŽIUKAI;6529889121;Ne;4;3;0;7
10459;Smalsučiai;PELĖDŽIUKAI;1673246147;Ne;0;9;0;9
10460;Smalsučiai;PELĖDŽIUKAI;7713078413;Ne;0;3;0;3
10461;Smalsučiai;PELĖDŽIUKAI;3627324317;Ne;0;4;0;4
10462;Smalsučiai;PELĖDŽIUKAI;5730866119;Ne;0;4;0;4
10463;Smalsučiai;PELĖDŽIUKAI;5611487967;Ne;0;4;0;4
10464;Smalsučiai;Pingvinukai;1305808180;Ne;4;4;0;8
10465;Smalsučiai;Pingvinukai;9222858199;Ne;11;0;0;11
10466;Smalsučiai;Pingvinukai;1909797307;Ne;6;0;1;7
10467;Smalsučiai;Pingvinukai;7400990599;Ne;12;0;0;12
10468;Smalsučiai;Pingvinukai;2673224420;Ne;8;0;0;8
10469;Smalsučiai;Pingvinukai;9771532192;Ne;16;2;0;18
10470;Smalsučiai;Pingvinukai;3746193901;Ne;0;6;0;6
10471;Smalsučiai;Pingvinukai;8499612926;Ne;20;0;0;20
10472;Smalsučiai;Pingvinukai;3625628040;Taip;6;0;0;6
10473;Smalsučiai;Pingvinukai;3045521655;Ne;9;0;0;9
10474;Smalsučiai;Pingvinukai;8615789381;Ne;5;0;0;5
10475;Smalsučiai;Voverikų;4811022648;Ne;0;7;0;7
10476;Smalsučiai;Voverikų;4973651632;Ne;0;0;2;2
10477;Smalsučiai;Voverikų;3509573985;Ne;13;2;0;15
10478;Smalsučiai;Voverikų;2878060759;Ne;0;1;0;1
10479;Smalsučiai;Voverikų;1485450504;Ne;6;0;0;6
10480;Smalsučiai;Voverikų;3042578767;Ne;3;3;0;6
10481;Smalsučiai;Voverikų;2070248478;Ne;9;2;1;12
10482;Smalsučiai;Voverikų;7205498813;Ne;15;0;0;15
10483;Smalsučiai;Voverikų;2612579099;Ne;0;20;0;20
10484;Smalsučiai;Voverikų;1559069582;Ne;3;0;1;4
10485;Smalsučiai;Voverikų;2885279828;Ne;0;3;0;3
10486;Smalsučiai;Voverikų;1162035522;Ne;5;0;2;7
10487;Smalsučiai;Voverikų;5964344820;Ne;10;0;0;10
10488;Smalsučiai;Voverikų;4105866680;Ne;10;1;0;11
10489;Smalsučiai;Voverikų;8493718326;Ne;4;0;0;4
10490;Spragtukas;NYKŠTUKAI;8551195766;Ne;0;0;2;2
10491;Spragtukas;NYKŠTUKAI;2943832694;Ne;11;0;1;12
10492;Spragtukas;NYKŠTUKAI;8297700739;Ne;6;0;0;6
10493;Spragtukas;NYKŠTUKAI;9595221494;Ne;0;3;0;3
10494;Spragtukas;NYKŠTUKAI;6185016824;Ne;8;10;0;18
10495;Spragtukas;NYKŠTUKAI;8715073512;Ne;9;0;0;9
10496;Spragtukas;NYKŠTUKAI;1710184531;Ne;8;0;0;8
10497;Spragtukas;NYKŠTUKAI;2076126173;Ne;0;10;0;10
10498;Spragtukas;NYKŠTUKAI;3012345413;Ne;8;1;0;9
10499;Spragtukas;NYKŠTUKAI;8698492694;Ne;6;4;0;10
10500;Spragtukas;NYKŠTUKAI;1150002524;Ne;0;1;0;1
10501;Spragtukas;NYKŠTUKAI;4493810276;Ne;0;0;1;1
10502;Spragtukas;NYKŠTUKAI;8288793522;Ne;0;7;0;7
10503;Spragtukas;NYKŠTUKAI;6986034864;Ne;0;5;0;5
10504;Spragtukas;NYKŠTUKAI;9665371858;Ne;0;9;0;9
10505;Spragtukas;SAULUTĖ;3337355440;Ne;0;4;0;4
10506;Spragtukas;SAULUTĖ;4669257062;Ne;0;1;0;1
10507;Spragtukas;SAULUTĖ;3692960591;Taip;2;1;0;3
10508;Spragtukas;SAULUTĖ;4586034709;Ne;5;0;1;6
10509;Spragtukas;SAULUTĖ;2305568596;Ne;0;8;0;8
10510;Spragtukas;SAULUTĖ;1150727381;Ne;0;18;0;18
10511;Spragtukas;SAULUTĖ;9191831532;Ne;0;2;1;3
10512;Spragtukas;SAULUTĖ;3948232692;Ne;4;6;2;12
10513;Spragtukas;SAULUTĖ;9149954373;Ne;0;10;0;10
10514;Spragtukas;SAULUTĖ;7511680722;Ne;0;4;0;4
10515;Spragtukas;SAULUTĖ;8235791891;Ne;8;0;0;8
10516;Spragtukas;SAULUTĖ;2987638580;Ne;0;6;0;6
10517;Spragtukas;SAULUTĖ;5687853390;Ne;8;0;0;8
10518;Spragtukas;SAULUTĖ;6679886985;Ne;12;0;2;14
10519;Spragtukas;SAULUTĖ;2879077913;Ne;5;4;0;9
10520;Spragtukas;SAULUTĖ;1998148708;Ne;0;11;0;11
10521;Spragtukas;SAULUTĖ;8227086854;Ne;0;11;0;11
10522;Spragtukas;SAULUTĖ;5697451914;Ne;0;1;0;1
10523;Spragtukas;SAULUTĖ;3086399458;Ne;0;2;0;2
10524;Spragtukas;SAULUTĖ;2879614195;Ne;0;16;0;16
10525;Spragtukas;SPINDULĖLIAI;4675031453;Ne;0;4;4;8
10526;Spragtukas;SPINDULĖLIAI;9781727236;Ne;6;4;3;13
10527;Spragtukas;SPINDULĖLIAI;1029392579;Ne;0;1;1;2
10528;Spragtukas;SPINDULĖLIAI;6417098461;Ne;0;5;0;5
10529;Spragtukas;SPINDULĖLIAI;4485715299;Ne;0;4;0;4
10530;Spragtukas;SPINDULĖLIAI;4224693184;Ne;0;1;0;1
10531;Spragtukas;SPINDULĖLIAI;2493749424;Ne;0;0;1;1
10532;Spragtukas;SPINDULĖLIAI;3411349574;Ne;0;4;0;4
10533;Spragtukas;SPINDULĖLIAI;1323065222;Ne;0;4;1;5
10534;Spragtukas;SPINDULĖLIAI;1827458781;Ne;3;2;2;7
10535;Spragtukas;SPINDULĖLIAI;4764295850;Ne;0;0;2;2
10536;Spragtukas;SPINDULĖLIAI;6385589724;Ne;2;1;0;3
10537;Spragtukas;SPINDULĖLIAI;8912031554;Ne;0;17;0;17
10538;Spragtukas;SPINDULĖLIAI;6634972088;Ne;0;21;0;21
10539;Spragtukas;SPINDULĖLIAI;7326816081;Ne;0;21;0;21
10540;Spragtukas;SPINDULĖLIAI;5864894208;Ne;0;21;0;21
10541;Spragtukas;GINTARĖLIAI;8339926929;Ne;5;5;0;10
10542;Spragtukas;GINTARĖLIAI;1525489137;Ne;8;0;0;8
10543;Spragtukas;GINTARĖLIAI;5724874569;Ne;13;4;0;17
10544;Spragtukas;GINTARĖLIAI;1430632638;Ne;7;11;0;18
10545;Spragtukas;GINTARĖLIAI;8625143071;Ne;0;3;0;3
10546;Spragtukas;GINTARĖLIAI;2255007161;Ne;7;3;0;10
10547;Spragtukas;GINTARĖLIAI;6493380877;Ne;0;1;0;1
10548;Spragtukas;GINTARĖLIAI;9664130733;Ne;0;5;1;6
10549;Spragtukas;GINTARĖLIAI;2316071393;Ne;5;0;0;5
10550;Spragtukas;GINTARĖLIAI;8698469979;Ne;0;10;0;10
10551;Spragtukas;GINTARĖLIAI;1747417905;Ne;4;0;3;7
10552;Spragtukas;GINTARĖLIAI;6388163866;Ne;0;9;0;9
10553;Spragtukas;GINTARĖLIAI;8191270443;Ne;0;4;4;8
10554;Spragtukas;GINTARĖLIAI;3684183344;Ne;0;9;0;9
10555;Spragtukas;GINTARĖLIAI;7806145224;Ne;3;5;0;8
10556;Spragtukas;GINTARĖLIAI;2992201984;Ne;0;2;0;2
10557;Spragtukas;GINTARĖLIAI;2217627240;Ne;1;11;0;12
10558;Spragtukas;ČIPOLINO;2371848091;Ne;13;4;0;17
10559;Spragtukas;ČIPOLINO;6582680700;Ne;0;6;0;6
10560;Spragtukas;ČIPOLINO;1547670082;Ne;0;3;0;3
10561;Spragtukas;ČIPOLINO;7504632314;Ne;0;2;0;2
10562;Spragtukas;ČIPOLINO;1597988501;Ne;0;6;0;6
10563;Spragtukas;ČIPOLINO;6526633051;Ne;0;1;0;1
10564;Spragtukas;ČIPOLINO;1058970799;Ne;0;2;0;2
10565;Spragtukas;ČIPOLINO;45661532130;Ne;0;2;0;2
10566;Spragtukas;ČIPOLINO;3045382299;Ne;0;3;0;3
10567;Spragtukas;ČIPOLINO;7640805299;Ne;0;13;0;13
10568;Spragtukas;ČIPOLINO;1365907314;Ne;0;4;0;4
10569;Spragtukas;ČIPOLINO;4941531443;Ne;10;1;0;11
10570;Spragtukas;ČIPOLINO;3566797064;Ne;0;4;0;4
10571;Spragtukas;ČIPOLINO;2902550587;Ne;0;1;0;1
10572;Spragtukas;ČIPOLINO;69114720307;Ne;0;1;0;1
10573;Spragtukas;ČIPOLINO;1044112039;Ne;10;1;0;11
10574;Spragtukas;ČIPOLINO;5707084920;Ne;0;12;0;12
10575;Spragtukas;ČIPOLINO;1482803930;Ne;0;5;0;5
10576;Spragtukas;ČIPOLINO;3356307067;Ne;0;13;0;13
10577;Spragtukas;ČIPOLINO;2691004546;Ne;0;21;0;21
10578;Spragtukas;BORUŽĖLĖS;8614890958;Ne;0;9;0;9
10579;Spragtukas;BORUŽĖLĖS;6548270099;Ne;0;4;0;4
10580;Spragtukas;BORUŽĖLĖS;2356476212;Ne;0;0;5;5
10581;Spragtukas;BORUŽĖLĖS;8287102733;Ne;10;0;0;10
10582;Spragtukas;BORUŽĖLĖS;6584145176;Ne;0;12;0;12
10583;Spragtukas;BORUŽĖLĖS;9965087132;Ne;0;1;0;1
10584;Spragtukas;BORUŽĖLĖS;5150028968;Ne;0;1;0;1
10585;Spragtukas;BORUŽĖLĖS;9754594384;Ne;10;0;0;10
10586;Spragtukas;BORUŽĖLĖS;6824861247;Ne;5;2;0;7
10587;Spragtukas;BORUŽĖLĖS;7264683147;Ne;11;0;3;14
10588;Spragtukas;BORUŽĖLĖS;5556920140;Ne;0;1;0;1
10589;Spragtukas;BORUŽĖLĖS;6547167325;Ne;9;0;0;9
10590;Spragtukas;BORUŽĖLĖS;7073092344;Ne;13;8;0;21
10591;Spragtukas;BORUŽĖLĖS;1046613540;Ne;8;4;0;12
10592;Spragtukas;DRUGELIAI;1336973131;Ne;0;2;0;2
10593;Spragtukas;DRUGELIAI;1514277186;Ne;19;0;0;19
10594;Spragtukas;DRUGELIAI;1326603216;Ne;5;2;0;7
10595;Spragtukas;DRUGELIAI;5306883933;Ne;4;0;0;4
10596;Spragtukas;DRUGELIAI;6322121173;Ne;2;1;0;3
10597;Spragtukas;DRUGELIAI;6573750143;Ne;0;7;0;7
10598;Spragtukas;DRUGELIAI;6800727630;Ne;0;4;0;4
10599;Spragtukas;DRUGELIAI;72636559695;Ne;0;4;0;4
10600;Spragtukas;DRUGELIAI;1384812263;Ne;9;1;0;10
10601;Spragtukas;DRUGELIAI;3654640843;Ne;0;3;0;3
10602;Spragtukas;DRUGELIAI;4929866385;Ne;9;0;0;9
10603;Spragtukas;DRUGELIAI;8246512283;Ne;0;6;0;6
10604;Spragtukas;DRUGELIAI;9045185920;Ne;10;1;0;11
10605;Spragtukas;DRUGELIAI;1627243902;Ne;7;1;0;8
10606;Spragtukas;DRUGELIAI;3113106252;Ne;0;4;0;4
10607;Spragtukas;DRUGELIAI;4131998934;Ne;0;2;0;2
10608;Spragtukas;DRUGELIAI;8463747761;Ne;0;4;0;4
10609;Spragtukas;DRUGELIAI;5477997543;Ne;0;4;0;4
10610;Spragtukas;DRUGELIAI;70413855110;Ne;0;0;1;1
10611;Spragtukas;GAIDELIAI;2541126095;Ne;0;21;0;21
10612;Spragtukas;GAIDELIAI;4097458544;Ne;7;0;0;7
10613;Spragtukas;GAIDELIAI;8957903306;Ne;3;2;5;10
10614;Spragtukas;GAIDELIAI;1326714513;Ne;0;2;6;8
10615;Spragtukas;GAIDELIAI;4676052255;Ne;0;19;0;19
10616;Spragtukas;GAIDELIAI;7108640957;Ne;10;0;0;10
10617;Spragtukas;GAIDELIAI;7911124524;Ne;0;2;0;2
10618;Spragtukas;GAIDELIAI;9509296936;Ne;9;0;0;9
10619;Spragtukas;GAIDELIAI;3216796441;Ne;15;1;0;16
10620;Spragtukas;GAIDELIAI;8440836721;Ne;7;12;0;19
10621;Spragtukas;GAIDELIAI;4535021524;Ne;0;2;0;2
10622;Spragtukas;GAIDELIAI;2679834328;Ne;0;2;2;4
10623;Spragtukas;ŽUVELĖS;9078163633;Ne;7;2;0;9
10624;Spragtukas;ŽUVELĖS;8652973900;Ne;10;3;0;13
10625;Spragtukas;ŽUVELĖS;3261213140;Ne;4;11;0;15
10626;Spragtukas;ŽUVELĖS;5689392663;Ne;12;4;0;16
10627;Spragtukas;ŽUVELĖS;9592271053;Ne;0;4;0;4
10628;Spragtukas;ŽUVELĖS;1272075883;Ne;0;5;0;5
10629;Spragtukas;ŽUVELĖS;6465991136;Ne;0;9;0;9
10630;Spragtukas;ŽUVELĖS;9282940430;Ne;0;4;0;4
10631;Spragtukas;ŽUVELĖS;6503842956;Ne;3;3;0;6
10632;Spragtukas;ŽUVELĖS;2578400770;Ne;0;6;0;6
10633;Spragtukas;ŽUVELĖS;3139748724;Ne;7;4;2;13
10634;Spragtukas;ŽUVELĖS;8640877497;Ne;8;1;0;9
10635;Spragtukas;ŽUVELĖS;2025314314;Ne;5;0;0;5
10636;Spragtukas;ŽUVELĖS;4848647219;Ne;5;0;0;5
10637;Spragtukas;ŽUVELĖS;3491418162;Ne;0;1;0;1
10638;Spragtukas;ŽUVELĖS;5836788916;Ne;0;4;0;4
10639;Spragtukas;ŽUVELĖS;5704941595;Ne;10;3;0;13
10640;Spragtukas;ŽUVELĖS;3286456855;Ne;0;3;0;3
10641;Spragtukas;ŽUVELĖS;9662188102;Ne;5;3;0;8
10642;Spragtukas;ŽUVELĖS;2539660577;Ne;1;1;0;2
10643;Spragtukas;ŽUVELĖS;6836232179;Ne;0;6;0;6
10644;Spragtukas;ŽUVELĖS;6757604305;Ne;5;2;0;7
10645;Spragtukas;RIEŠUTĖLIAI;8684246143;Ne;5;0;5;10
10646;Spragtukas;RIEŠUTĖLIAI;1407611561;Ne;6;0;0;6
10647;Spragtukas;RIEŠUTĖLIAI;8773952377;Ne;0;5;0;5
10648;Spragtukas;RIEŠUTĖLIAI;1977526177;Ne;3;4;0;7
10649;Spragtukas;RIEŠUTĖLIAI;7615522850;Taip;6;2;0;8
10650;Spragtukas;RIEŠUTĖLIAI;6797841737;Ne;0;2;0;2
10651;Spragtukas;RIEŠUTĖLIAI;8342098575;Ne;5;0;0;5
10652;Spragtukas;RIEŠUTĖLIAI;1992850470;Ne;4;0;0;4
10653;Spragtukas;RIEŠUTĖLIAI;6158327941;Ne;0;5;0;5
10654;Spragtukas;RIEŠUTĖLIAI;4134127256;Ne;5;0;3;8
10655;Spragtukas;RIEŠUTĖLIAI;3009567338;Ne;0;2;0;2
10656;Spragtukas;RIEŠUTĖLIAI;2648358901;Ne;0;5;0;5
10657;Spragtukas;RIEŠUTĖLIAI;3822599790;Ne;0;11;0;11
10658;Spragtukas;RIEŠUTĖLIAI;7767940027;Ne;3;6;0;9
10659;Spragtukas;RIEŠUTĖLIAI;4625065223;Ne;6;0;1;7
10660;Spragtukas;RIEŠUTĖLIAI;8732886749;Ne;4;1;0;5
10661;Spragtukas;RIEŠUTĖLIAI;9975308171;Ne;1;0;0;1
10662;Spragtukas;VIŠČIUKAI;8473814776;Ne;5;0;0;5
10663;Spragtukas;VIŠČIUKAI;9951226210;Ne;0;3;0;3
10664;Spragtukas;VIŠČIUKAI;9443091032;Ne;0;7;0;7
10665;Spragtukas;VIŠČIUKAI;4461217748;Ne;0;8;0;8
10666;Spragtukas;VIŠČIUKAI;7412489884;Ne;0;21;0;21
10667;Spragtukas;VIŠČIUKAI;9579825533;Ne;15;0;0;15
10668;Spragtukas;VIŠČIUKAI;2087416420;Ne;0;1;0;1
10669;Spragtukas;VIŠČIUKAI;1545887575;Ne;0;2;0;2
10670;Spragtukas;VIŠČIUKAI;8110631015;Ne;0;2;0;2
10671;Spragtukas;VIŠČIUKAI;3110077272;Ne;15;0;0;15
10672;Spragtukas;MEŠKIUKAI;7271482702;Ne;7;6;5;18
10673;Spragtukas;MEŠKIUKAI;9099921999;Ne;6;0;0;6
10674;Spragtukas;MEŠKIUKAI;8307801987;Ne;9;2;2;13
10675;Spragtukas;MEŠKIUKAI;1493711333;Ne;0;1;0;1
10676;Spragtukas;MEŠKIUKAI;4742132709;Ne;7;7;0;14
10677;Spragtukas;MEŠKIUKAI;7256772984;Ne;5;2;0;7
10678;Spragtukas;MEŠKIUKAI;1487259291;Ne;16;0;3;19
10679;Spragtukas;MEŠKIUKAI;5225669850;Ne;3;2;2;7
10680;Spragtukas;MEŠKIUKAI;8109894184;Ne;7;0;0;7
10681;Spragtukas;MEŠKIUKAI;8396134652;Ne;14;0;0;14
10682;Spragtukas;MEŠKIUKAI;1784758799;Ne;7;4;0;11
10683;Spragtukas;MEŠKIUKAI;4441290823;Ne;0;2;0;2
10684;Spragtukas;MEŠKIUKAI;9310818975;Ne;10;0;0;10
10685;Spragtukas;MEŠKIUKAI;8486415968;Ne;0;3;0;3
10686;Spragtukas;MEŠKIUKAI;2026249018;Ne;4;3;0;7
10687;Spragtukas;MEŠKIUKAI;3423699840;Ne;0;2;0;2
10688;Strazdelis;Žiogelių;5346485534;Ne;0;1;0;1
10689;Strazdelis;Žiogelių;9933042249;Ne;0;4;0;4
10690;Strazdelis;Žiogelių;8581533423;Ne;2;4;0;6
10691;Strazdelis;Žiogelių;8209625399;Ne;0;12;0;12
10692;Strazdelis;Žiogelių;1141752802;Ne;10;1;0;11
10693;Strazdelis;Žiogelių;1228651165;Ne;1;6;0;7
10694;Strazdelis;Žiogelių;7768700192;Ne;15;1;0;16
10695;Strazdelis;Žiogelių;3596394112;Ne;11;0;0;11
10696;Strazdelis;Žiogelių;4563247013;Ne;21;0;0;21
10697;Strazdelis;Žiogelių;6437928004;Ne;0;2;2;4
10698;Strazdelis;Žiogelių;5600979545;Ne;0;10;0;10
10699;Strazdelis;Žiogelių;8971395173;Ne;2;0;0;2
10700;Strazdelis;Žiogelių;4955907851;Ne;0;0;2;2
10701;Strazdelis;Žiogelių;7425818775;Ne;0;1;1;2
10702;Strazdelis;Žiogelių;9567476872;Ne;8;0;0;8
10703;Strazdelis;Žiogelių;3028208428;Ne;0;0;1;1
10704;Strazdelis;Žiogelių;2753635198;Ne;0;1;3;4
10705;Strazdelis;Žiogelių;1194918926;Ne;0;0;4;4
10706;Strazdelis;Žiogelių;6651360492;Ne;0;9;0;9
10707;Strazdelis;Žiogelių;8686828982;Ne;0;3;0;3
10708;Strazdelis;Žiogelių;7913526787;Ne;8;0;1;9
10709;Strazdelis;Šeimynėlės;3848288765;Ne;0;2;0;2
10710;Strazdelis;Šeimynėlės;5033799225;Ne;0;2;0;2
10711;Strazdelis;Šeimynėlės;1683900907;Ne;0;4;0;4
10712;Strazdelis;Šeimynėlės;2990771887;Ne;0;7;0;7
10713;Strazdelis;Šeimynėlės;2185364583;Ne;4;0;0;4
10714;Strazdelis;Šeimynėlės;7905687363;Ne;7;3;0;10
10715;Strazdelis;Šeimynėlės;4501391298;Ne;0;4;0;4
10716;Strazdelis;Šeimynėlės;9057914477;Ne;6;3;0;9
10717;Strazdelis;Šeimynėlės;1012692326;Ne;17;2;0;19
10718;Strazdelis;Šeimynėlės;8899530711;Ne;19;2;0;21
10719;Strazdelis;Šeimynėlės;8336759173;Ne;16;0;0;16
10720;Strazdelis;Šeimynėlės;5784406335;Ne;0;5;0;5
10721;Strazdelis;Šeimynėlės;2068793184;Ne;8;3;0;11
10722;Strazdelis;Šeimynėlės;5296218650;Ne;13;0;0;13
10723;Strazdelis;Šeimynėlės;1754106518;Ne;0;4;0;4
10724;Strazdelis;Šeimynėlės;9806107189;Ne;10;4;0;14
10725;Strazdelis;Šeimynėlės;9209201954;Ne;3;1;0;4
10726;Strazdelis;Šeimynėlės;5924324241;Ne;15;0;6;21
10727;Strazdelis;Šeimynėlės;1553329770;Ne;0;2;0;2
10728;Strazdelis;Genelio;8277333786;Ne;0;4;1;5
10729;Strazdelis;Genelio;9586256979;Ne;0;1;0;1
10730;Strazdelis;Genelio;3084249678;Ne;0;7;0;7
10731;Strazdelis;Genelio;5499310072;Ne;0;2;3;5
10732;Strazdelis;Genelio;6271193831;Ne;0;4;0;4
10733;Strazdelis;Genelio;6480803618;Ne;5;2;1;8
10734;Strazdelis;Genelio;9490861272;Ne;0;9;0;9
10735;Strazdelis;Genelio;6071502600;Ne;0;5;0;5
10736;Strazdelis;Genelio;3713797440;Ne;0;5;0;5
10737;Strazdelis;Genelio;3456287323;Ne;0;7;0;7
10738;Strazdelis;Genelio;1034497200;Ne;0;0;1;1
10739;Strazdelis;Genelio;2459718449;Ne;1;6;0;7
10740;Strazdelis;Genelio;8956634754;Ne;0;4;0;4
10741;Strazdelis;Genelio;8762859576;Ne;2;5;1;8
10742;Strazdelis;Genelio;2306665561;Ne;0;3;0;3
10743;Strazdelis;Genelio;7680242840;Ne;6;3;0;9
10744;Strazdelis;Genelio;5742215922;Ne;0;6;0;6
10745;Strazdelis;Genelio;6954336739;Ne;0;10;0;10
10746;Strazdelis;Vikruolių;2078150337;Ne;5;0;0;5
10747;Strazdelis;Vikruolių;8182994112;Ne;4;0;0;4
10748;Strazdelis;Vikruolių;1362428967;Ne;0;1;0;1
10749;Strazdelis;Vikruolių;9198429790;Ne;0;1;0;1
10750;Strazdelis;Vikruolių;4655931716;Ne;0;4;6;10
10751;Strazdelis;Vikruolių;8754275576;Ne;0;1;0;1
10752;Strazdelis;Vikruolių;6147183190;Ne;6;5;0;11
10753;Strazdelis;Vikruolių;7216768880;Ne;2;6;0;8
10754;Strazdelis;Vikruolių;7823110477;Ne;0;7;0;7
10755;Strazdelis;Vikruolių;1187534672;Ne;5;9;0;14
10756;Strazdelis;Vikruolių;9904719582;Ne;0;2;0;2
10757;Strazdelis;Vikruolių;7308925265;Ne;2;8;0;10
10758;Strazdelis;Vikruolių;50350281905;Ne;0;4;0;4
10759;Strazdelis;Vikruolių;8038163444;Ne;0;4;0;4
10760;Strazdelis;Vikruolių;1540973269;Ne;0;1;0;1
10761;Strazdelis;Vikruolių;8801420992;Ne;0;5;0;5
10762;Strazdelis;Vikruolių;5580738386;Ne;0;7;0;7
10763;Strazdelis;Vikruolių;3955783379;Ne;0;7;0;7
10764;Strazdelis;Vikruolių;4430183106;Ne;16;0;2;18
10765;Strazdelis;Vikruolių;4076266466;Ne;7;1;0;8
10766;Strazdelis;Vyturėlių;4454199703;Ne;2;2;0;4
10767;Strazdelis;Vyturėlių;3662217925;Ne;7;1;0;8
10768;Strazdelis;Vyturėlių;8274897977;Ne;0;5;0;5
10769;Strazdelis;Vyturėlių;1665134387;Ne;5;3;0;8
10770;Strazdelis;Vyturėlių;45083023033;Ne;1;3;0;4
10771;Strazdelis;Vyturėlių;43314069648;Ne;0;4;0;4
10772;Strazdelis;Vyturėlių;1481671624;Ne;0;1;1;2
10773;Strazdelis;Vyturėlių;4697537943;Ne;5;5;0;10
10774;Strazdelis;Vyturėlių;6014213362;Ne;5;0;0;5
10775;Strazdelis;Vyturėlių;9835716116;Ne;0;1;0;1
10776;Strazdelis;Vyturėlių;2802486859;Ne;0;3;0;3
10777;Strazdelis;Vyturėlių;3482802557;Ne;0;2;0;2
10778;Strazdelis;Vyturėlių;5749300013;Ne;0;5;0;5
10779;Strazdelis;Vyturėlių;7215063033;Ne;10;1;0;11
10780;Strazdelis;Vyturėlių;7149827850;Ne;8;0;0;8
10781;Strazdelis;Vyturėlių;5834348507;Ne;0;10;0;10
10782;Strazdelis;Vyturėlių;2238875354;Ne;0;1;0;1
10783;Strazdelis;Varpelio;4159072583;Ne;0;5;0;5
10784;Strazdelis;Varpelio;2662549392;Ne;4;1;0;5
10785;Strazdelis;Varpelio;9502341478;Ne;0;3;0;3
10786;Strazdelis;Varpelio;6311710825;Ne;0;4;0;4
10787;Strazdelis;Varpelio;1955166372;Ne;0;1;0;1
10788;Strazdelis;Varpelio;4873707286;Ne;0;4;0;4
10789;Strazdelis;Varpelio;6527855940;Ne;0;5;0;5
10790;Strazdelis;Varpelio;2824416350;Ne;0;4;0;4
10791;Strazdelis;Varpelio;3610250359;Ne;0;4;0;4
10792;Strazdelis;Varpelio;2766970956;Ne;0;8;0;8
10793;Strazdelis;Varpelio;1173067724;Ne;0;4;0;4
10794;Strazdelis;Varpelio;1021364759;Ne;3;7;0;10
10795;Strazdelis;Varpelio;7469848482;Ne;6;3;0;9
10796;Strazdelis;Varpelio;1841285441;Ne;18;1;0;19
10797;Strazdelis;Varpelio;7393083827;Ne;0;5;0;5
10798;Strazdelis;Varpelio;1706026100;Ne;2;5;0;7
10799;Strazdelis;Varpelio;8035603341;Ne;2;5;0;7
10800;Strazdelis;Varpelio;2789987994;Ne;0;4;0;4
10801;Strazdelis;Varpelio;2251157025;Ne;3;8;0;11
10802;Strazdelis;Varpelio;5904388732;Ne;5;4;0;9
10803;Strazdelis;Varpelio;3460993302;Ne;4;5;0;9
10804;Strazdelis;Varpelio;9776075027;Ne;0;1;0;1
10805;Strazdelis;Pelėdžiukų;5892430004;Ne;3;5;0;8
10806;Strazdelis;Pelėdžiukų;8637386316;Ne;0;2;0;2
10807;Strazdelis;Pelėdžiukų;1704292727;Ne;0;7;0;7
10808;Strazdelis;Pelėdžiukų;8371999002;Ne;8;0;0;8
10809;Strazdelis;Pelėdžiukų;6046139859;Ne;2;0;0;2
10810;Strazdelis;Pelėdžiukų;8287554571;Ne;0;1;0;1
10811;Strazdelis;Pelėdžiukų;4448556404;Ne;0;2;0;2
10812;Strazdelis;Pelėdžiukų;8854150040;Ne;4;4;0;8
10813;Strazdelis;Pelėdžiukų;5768674837;Ne;0;0;5;5
10814;Strazdelis;Pelėdžiukų;9761595867;Ne;0;0;2;2
10815;Strazdelis;Pelėdžiukų;7876385010;Ne;5;0;0;5
10816;Strazdelis;Pelėdžiukų;2848984531;Ne;0;6;0;6
10817;Strazdelis;Pelėdžiukų;1420438624;Taip;0;4;0;4
10818;Strazdelis;Pelėdžiukų;1901641517;Ne;5;0;0;5
10819;Strazdelis;Pelėdžiukų;4617237063;Ne;0;3;0;3
10820;Strazdelis;Pelėdžiukų;3036380561;Ne;0;3;0;3
10821;Strazdelis;Pelėdžiukų;7471890377;Ne;0;0;1;1
10822;Strazdelis;Pelėdžiukų;3943914976;Ne;0;5;0;5
10823;Strazdelis;Pelėdžiukų;8938997208;Ne;0;5;0;5
10824;Strazdelis;Pelėdžiukų;4562530311;Ne;0;1;2;3
10825;Strazdelis;Saulutės;27177757900;Ne;5;2;0;7
10826;Strazdelis;Saulutės;40932140069;Ne;0;9;0;9
10827;Strazdelis;Saulutės;1523471662;Ne;0;4;0;4
10828;Strazdelis;Saulutės;7578229276;Ne;0;1;0;1
10829;Strazdelis;Saulutės;8710848483;Ne;0;2;0;2
10830;Strazdelis;Saulutės;6614184499;Ne;0;4;0;4
10831;Strazdelis;Saulutės;4129957131;Ne;8;4;0;12
10832;Strazdelis;Saulutės;3425430317;Ne;0;14;0;14
10833;Strazdelis;Saulutės;7081517417;Ne;0;5;0;5
10834;Strazdelis;Saulutės;15298412755;Ne;5;1;0;6
10835;Strazdelis;Saulutės;1802092125;Ne;0;2;0;2
10836;Strazdelis;Saulutės;1391009140;Ne;6;5;0;11
10837;Strazdelis;Saulutės;8808299050;Ne;5;4;0;9
10838;Strazdelis;Saulutės;3270413614;Ne;5;0;0;5
10839;Strazdelis;Saulutės;3753612757;Ne;3;0;0;3
10840;Strazdelis;Saulutės;1474503932;Ne;0;0;3;3
10841;Strazdelis;Saulutės;9662566992;Ne;0;2;0;2
10842;Strazdelis;Bitutės;8485509145;Ne;4;4;0;8
10843;Strazdelis;Bitutės;6508933324;Ne;0;3;0;3
10844;Strazdelis;Bitutės;4020547762;Ne;0;7;0;7
10845;Strazdelis;Bitutės;8753316532;Ne;0;2;0;2
10846;Strazdelis;Bitutės;5232064496;Ne;0;7;0;7
10847;Strazdelis;Bitutės;9555240419;Ne;0;8;0;8
10848;Strazdelis;Bitutės;3043580835;Ne;0;2;0;2
10849;Strazdelis;Bitutės;4400849922;Ne;0;2;0;2
10850;Strazdelis;Bitutės;7890064837;Ne;0;9;0;9
10851;Strazdelis;Bitutės;1881071425;Taip;0;4;0;4
10852;Strazdelis;Bitutės;2908567982;Ne;0;6;2;8
10853;Strazdelis;Bitutės;9548465554;Ne;0;5;0;5
10854;Strazdelis;Bitutės;7466648222;Ne;4;1;0;5
10855;Strazdelis;Bitutės;4463378251;Ne;0;2;0;2
10856;Strazdelis;Bitutės;8443837176;Ne;6;0;0;6
10857;Strazdelis;Bitutės;4369569609;Ne;0;7;0;7
10858;Strazdelis;Bitutės;1005082012;Ne;3;2;0;5
10859;Strazdelis;Bitutės;2589303722;Ne;0;2;0;2
10860;Strazdelis;Bitutės;2081538505;Ne;0;8;0;8
10861;Strazdelis;Bitutės;4784401449;Ne;0;1;0;1
10862;Strazdelis;Mažylių;9357195019;Ne;0;0;3;3
10863;Strazdelis;Mažylių;5256750516;Ne;12;0;0;12
10864;Strazdelis;Mažylių;4740153387;Ne;19;0;0;19
10865;Strazdelis;Mažylių;2378910473;Ne;0;16;0;16
10866;Strazdelis;Mažylių;4699373769;Ne;3;0;0;3
10867;Strazdelis;Mažylių;3648883435;Ne;13;1;0;14
10868;Strazdelis;Mažylių;6788732053;Ne;0;2;0;2
10869;Strazdelis;Mažylių;2764495554;Ne;2;0;0;2
10870;Strazdelis;Mažylių;7039347901;Ne;0;0;4;4
10871;Strazdelis;Mažylių;3082900425;Ne;0;2;1;3
10872;Strazdelis;Mažylių;3900225484;Ne;10;1;0;11
10873;Strazdelis;Mažylių;8734458997;Ne;7;3;1;11
10874;Strazdelis;Mažylių;3561551193;Ne;6;6;0;12
10875;Strazdelis;Mažylių;1932428439;Ne;15;0;0;15
10876;Strazdelis;Mažylių;2871841427;Ne;0;2;1;3
10877;Strazdelis;Mažylių;3572665646;Ne;0;0;2;2
10878;Strazdelis;Mažylių;8699020650;Ne;10;0;0;10
10879;Strazdelis;Pabiručių;7087235151;Ne;4;6;2;12
10880;Strazdelis;Pabiručių;6853311266;Ne;0;8;0;8
10881;Strazdelis;Pabiručių;3030445367;Ne;2;4;0;6
10882;Strazdelis;Pabiručių;4966668662;Ne;0;0;1;1
10883;Strazdelis;Pabiručių;8484672456;Ne;1;0;0;1
10884;Strazdelis;Pabiručių;8953577585;Ne;3;0;0;3
10885;Strazdelis;Pabiručių;1823053560;Ne;22;0;2;24
10886;Strazdelis;Pabiručių;8677659019;Ne;0;2;0;2
10887;Strazdelis;Pabiručių;4848650799;Ne;0;2;0;2
10888;Strazdelis;Pabiručių;7716476995;Ne;4;0;2;6
10889;Strazdelis;Pabiručių;4174940099;Ne;2;6;0;8
10890;Strazdelis;Pabiručių;7065489134;Ne;5;2;0;7
10891;Strazdelis;Pabiručių;8554043784;Ne;6;11;0;17
10892;Strazdelis;Pabiručių;1952086370;Ne;3;4;3;10
10893;Strazdelis;Pabiručių;7802337169;Ne;7;0;0;7
10894;Strazdelis;Pabiručių;8356680705;Ne;0;4;0;4
10895;Strazdelis;Pabiručių;6457478289;Ne;1;0;0;1
10896;Strazdelis;Pabiručių;3426039979;Ne;1;11;8;20
10897;Strazdelis;Pabiručių;4715198107;Ne;17;0;0;17
10898;Strazdelis;Pabiručių;4334385271;Ne;0;0;1;1
10899;Šermukšnėlė;MOLINUKAI;9746313951;Ne;4;0;0;4
10900;Šermukšnėlė;MOLINUKAI;4638109666;Ne;0;0;2;2
10901;Šermukšnėlė;MOLINUKAI;9329824053;Ne;0;6;0;6
10902;Šermukšnėlė;MOLINUKAI;2714018690;Ne;11;0;0;11
10903;Šermukšnėlė;MOLINUKAI;5262882873;Ne;7;2;0;9
10904;Šermukšnėlė;MOLINUKAI;2985284699;Ne;0;1;4;5
10905;Šermukšnėlė;MOLINUKAI;4983510683;Ne;5;1;0;6
10906;Šermukšnėlė;MOLINUKAI;7385114026;Ne;3;4;0;7
10907;Šermukšnėlė;MOLINUKAI;2784732759;Ne;0;0;1;1
10908;Šermukšnėlė;MOLINUKAI;3342919832;Ne;2;5;1;8
10909;Šermukšnėlė;MOLINUKAI;9337047371;Ne;5;4;1;10
10910;Šermukšnėlė;MOLINUKAI;2098090763;Ne;0;4;2;6
10911;Šermukšnėlė;MOLINUKAI;5835100042;Ne;8;0;1;9
10912;Šermukšnėlė;MOLINUKAI;8000479161;Ne;0;4;3;7
10913;Šermukšnėlė;MOLINUKAI;4952285322;Ne;0;6;0;6
10914;Šermukšnėlė;MOLINUKAI;8104182167;Ne;0;6;1;7
10915;Šermukšnėlė;MOLINUKAI;6988120570;Ne;0;15;0;15
10916;Šermukšnėlė;MOLINUKAI;8728441474;Ne;2;4;0;6
10917;Šermukšnėlė;MOLINUKAI;4075151928;Ne;0;0;4;4
10918;Šermukšnėlė;MOLINUKAI;4968522498;Ne;12;4;0;16
10919;Šermukšnėlė;ŠIAUDINUKAI;7002917737;Ne;12;0;0;12
10920;Šermukšnėlė;ŠIAUDINUKAI;7785671936;Ne;14;0;0;14
10921;Šermukšnėlė;ŠIAUDINUKAI;3637882900;Ne;0;5;0;5
10922;Šermukšnėlė;ŠIAUDINUKAI;1159472154;Ne;0;4;0;4
10923;Šermukšnėlė;ŠIAUDINUKAI;4956414941;Ne;0;4;1;5
10924;Šermukšnėlė;ŠIAUDINUKAI;3499394539;Ne;15;2;0;17
10925;Šermukšnėlė;ŠIAUDINUKAI;1157979179;Ne;0;7;0;7
10926;Šermukšnėlė;ŠIAUDINUKAI;3701053997;Taip;6;0;2;8
10927;Šermukšnėlė;ŠIAUDINUKAI;8048598135;Ne;0;4;0;4
10928;Šermukšnėlė;ŠIAUDINUKAI;3082272196;Ne;8;1;1;10
10929;Šermukšnėlė;ŠIAUDINUKAI;9903310024;Ne;0;1;0;1
10930;Šermukšnėlė;ŠIAUDINUKAI;9012757607;Ne;0;4;0;4
10931;Šermukšnėlė;ŠIAUDINUKAI;5627334876;Ne;11;0;1;12
10932;Šermukšnėlė;ŠIAUDINUKAI;3550736579;Ne;19;0;1;20
10933;Šermukšnėlė;ŠIAUDINUKAI;5993599994;Ne;0;0;4;4
10934;Šermukšnėlė;ŠIAUDINUKAI;6077798297;Ne;2;0;2;4
10935;Šermukšnėlė;ŠIAUDINUKAI;1437314920;Ne;0;4;0;4
10936;Šermukšnėlė;TOŠINUKAI;2160616078;Ne;0;0;4;4
10937;Šermukšnėlė;TOŠINUKAI;1661977128;Ne;13;0;1;14
10938;Šermukšnėlė;TOŠINUKAI;3994316729;Ne;0;4;1;5
10939;Šermukšnėlė;TOŠINUKAI;5140264695;Ne;5;2;0;7
10940;Šermukšnėlė;TOŠINUKAI;78341448188;Ne;4;4;1;9
10941;Šermukšnėlė;TOŠINUKAI;8279692394;Ne;5;4;0;9
10942;Šermukšnėlė;TOŠINUKAI;5096946133;Ne;0;4;2;6
10943;Šermukšnėlė;TOŠINUKAI;2380988728;Ne;5;1;3;9
10944;Šermukšnėlė;TOŠINUKAI;8956573129;Ne;0;4;0;4
10945;Šermukšnėlė;TOŠINUKAI;4981204674;Ne;0;1;0;1
10946;Šermukšnėlė;TOŠINUKAI;7229632099;Ne;4;4;1;9
10947;Šermukšnėlė;TOŠINUKAI;2529526401;Ne;0;4;2;6
10948;Šermukšnėlė;TOŠINUKAI;7038705221;Ne;2;4;0;6
10949;Šermukšnėlė;TOŠINUKAI;6413821285;Ne;0;8;0;8
10950;Šermukšnėlė;TOŠINUKAI;9035625467;Ne;3;0;3;6
10951;Šermukšnėlė;TOŠINUKAI;3081548524;Ne;0;4;1;5
10952;Šermukšnėlė;TOŠINUKAI;5832072195;Ne;0;13;0;13
10953;Šermukšnėlė;TOŠINUKAI;3222466449;Ne;0;4;3;7
10954;Šermukšnėlė;TOŠINUKAI;1753169856;Ne;3;0;0;3
10955;Šermukšnėlė;TOŠINUKAI;6430627501;Ne;0;5;0;5
10956;Šermukšnėlė;TOŠINUKAI;9442514813;Ne;0;4;0;4
10957;Šermukšnėlė;ODINUKAI;4422415026;Ne;2;4;2;8
10958;Šermukšnėlė;ODINUKAI;5545018656;Ne;0;8;0;8
10959;Šermukšnėlė;ODINUKAI;2176788727;Ne;0;0;6;6
10960;Šermukšnėlė;ODINUKAI;5575518612;Ne;3;0;0;3
10961;Šermukšnėlė;ODINUKAI;5733540837;Ne;10;0;4;14
10962;Šermukšnėlė;ODINUKAI;7262199284;Ne;0;1;0;1
10963;Šermukšnėlė;ODINUKAI;5159461963;Ne;0;2;0;2
10964;Šermukšnėlė;ODINUKAI;5354978646;Ne;0;1;3;4
10965;Šermukšnėlė;ODINUKAI;1882432812;Ne;0;1;3;4
10966;Šermukšnėlė;ODINUKAI;3949629658;Ne;16;1;0;17
10967;Šermukšnėlė;ODINUKAI;6105915822;Ne;0;4;0;4
10968;Šermukšnėlė;ODINUKAI;9742208172;Ne;0;0;2;2
10969;Šermukšnėlė;ODINUKAI;7667114310;Ne;21;0;0;21
10970;Šermukšnėlė;ODINUKAI;5397385093;Ne;0;5;2;7
10971;Šermukšnėlė;ODINUKAI;6718242890;Ne;0;4;4;8
10972;Šermukšnėlė;ODINUKAI;9664249364;Ne;0;6;0;6
10973;Šermukšnėlė;ODINUKAI;1064222922;Ne;17;0;1;18
10974;Šermukšnėlė;ODINUKAI;7770630580;Ne;0;0;3;3
10975;Šermukšnėlė;ODINUKAI;6194188831;Ne;0;3;2;5
10976;Šermukšnėlė;KRIAUKLELĖS;3613456202;Ne;10;0;1;11
10977;Šermukšnėlė;KRIAUKLELĖS;8541743148;Ne;8;0;0;8
10978;Šermukšnėlė;KRIAUKLELĖS;8709426669;Ne;18;1;0;19
10979;Šermukšnėlė;KRIAUKLELĖS;6585484701;Ne;8;0;0;8
10980;Šermukšnėlė;KRIAUKLELĖS;6599779539;Ne;3;7;0;10
10981;Šermukšnėlė;KRIAUKLELĖS;9876533442;Ne;4;0;4;8
10982;Šermukšnėlė;KRIAUKLELĖS;3653792683;Ne;0;6;4;10
10983;Šermukšnėlė;KRIAUKLELĖS;2506945279;Ne;5;0;2;7
10984;Šermukšnėlė;KRIAUKLELĖS;7266947985;Ne;7;0;0;7
10985;Šermukšnėlė;KRIAUKLELĖS;4256630681;Ne;2;0;0;2
10986;Šermukšnėlė;KRIAUKLELĖS;8117261716;Ne;10;0;0;10
10987;Šermukšnėlė;KRIAUKLELĖS;7458930634;Ne;10;0;0;10
10988;Šermukšnėlė;KRIAUKLELĖS;3245643086;Ne;11;0;0;11
10989;Šermukšnėlė;KRIAUKLELĖS;6342714998;Ne;8;0;0;8
10990;Šermukšnėlė;KRIAUKLELĖS;6946711443;Ne;4;0;0;4
10991;Šermukšnėlė;KRIAUKLELĖS;9074111563;Ne;7;0;0;7
10992;Šermukšnėlė;KRIAUKLELĖS;9908568127;Ne;10;1;0;11
10993;Šermukšnėlė;KRIAUKLELĖS;9783673534;Ne;0;0;2;2
10994;Šermukšnėlė;KRIAUKLELĖS;5408843906;Ne;10;0;0;10
10995;Šermukšnėlė;VYTINUKAI;1523361932;Ne;0;0;3;3
10996;Šermukšnėlė;VYTINUKAI;8531953934;Ne;0;2;1;3
10997;Šermukšnėlė;VYTINUKAI;25189813939;Ne;6;4;0;10
10998;Šermukšnėlė;VYTINUKAI;83123267733;Ne;4;4;4;12
10999;Šermukšnėlė;VYTINUKAI;20028832329;Ne;0;7;0;7
11000;Šermukšnėlė;VYTINUKAI;3959795064;Ne;1;5;0;6
11001;Šermukšnėlė;VYTINUKAI;8498288021;Ne;0;4;3;7
11002;Šermukšnėlė;VYTINUKAI;6291531570;Ne;0;3;0;3
11003;Šermukšnėlė;VYTINUKAI;1244964311;Ne;3;2;1;6
11004;Šermukšnėlė;VYTINUKAI;83882579952;Ne;0;2;0;2
11005;Šermukšnėlė;VYTINUKAI;60840526220;Ne;0;2;0;2
11006;Šermukšnėlė;VYTINUKAI;1025787925;Ne;0;6;3;9
11007;Šermukšnėlė;VYTINUKAI;1519623099;Ne;0;4;1;5
11008;Šermukšnėlė;VYTINUKAI;9654198217;Ne;2;4;0;6
11009;Šermukšnėlė;VYTINUKAI;1670047548;Ne;0;9;2;11
11010;Šermukšnėlė;VYTINUKAI;5281637612;Ne;0;6;0;6
11011;Šermukšnėlė;VYTINUKAI;1685592290;Ne;10;0;0;10
11012;Šermukšnėlė;VYTINUKAI;8123096990;Ne;0;2;3;5
11013;Šermukšnėlė;VYTINUKAI;8511421692;Ne;0;1;1;2
11014;Šermukšnėlė;VYTINUKAI;3883861823;Ne;0;8;0;8
11015;Šermukšnėlė;VYTINUKAI;2163955454;Ne;0;0;1;1
11016;Šermukšnėlė;VYTINUKAI;5225263863;Ne;0;1;0;1
11017;Šermukšnėlė;GINTARĖLIAI;5069572637;Ne;0;4;0;4
11018;Šermukšnėlė;GINTARĖLIAI;8249749948;Ne;0;3;0;3
11019;Šermukšnėlė;GINTARĖLIAI;2989011150;Ne;0;1;1;2
11020;Šermukšnėlė;GINTARĖLIAI;3747531232;Ne;5;1;3;9
11021;Šermukšnėlė;GINTARĖLIAI;1996859146;Ne;0;2;1;3
11022;Šermukšnėlė;GINTARĖLIAI;4176986876;Ne;0;10;0;10
11023;Šermukšnėlė;GINTARĖLIAI;7036078780;Ne;10;0;0;10
11024;Šermukšnėlė;GINTARĖLIAI;1994737857;Ne;3;6;0;9
11025;Šermukšnėlė;GINTARĖLIAI;4619811264;Ne;3;5;0;8
11026;Šermukšnėlė;GINTARĖLIAI;5886893562;Ne;12;5;0;17
11027;Šermukšnėlė;GINTARĖLIAI;4783726095;Ne;4;3;0;7
11028;Šermukšnėlė;GINTARĖLIAI;9714566919;Ne;0;1;4;5
11029;Šermukšnėlė;GINTARĖLIAI;5172187141;Ne;0;7;0;7
11030;Šermukšnėlė;GINTARĖLIAI;3688946505;Ne;1;0;8;9
11031;Šermukšnėlė;GINTARĖLIAI;5905330617;Ne;0;0;1;1
11032;Šermukšnėlė;GINTARĖLIAI;1636944853;Ne;0;8;0;8
11033;Šermukšnėlė;GINTARĖLIAI;7053319091;Ne;0;7;0;7
11034;Šermukšnėlė;GINTARĖLIAI;6351841889;Ne;19;0;0;19
11035;Šermukšnėlė;GINTARĖLIAI;6698650179;Ne;0;0;1;1
11036;Šermukšnėlė;GINTARĖLIAI;7106405983;Ne;10;0;0;10
11037;Šermukšnėlė;GINTARĖLIAI;8639470631;Ne;0;0;1;1
11038;Šermukšnėlė;AKMENUKAI;3543061360;Ne;5;1;0;6
11039;Šermukšnėlė;AKMENUKAI;7564745299;Ne;0;9;0;9
11040;Šermukšnėlė;AKMENUKAI;9617044855;Ne;2;9;0;11
11041;Šermukšnėlė;AKMENUKAI;1856012121;Ne;0;4;2;6
11042;Šermukšnėlė;AKMENUKAI;8407947566;Ne;0;0;2;2
11043;Šermukšnėlė;AKMENUKAI;1902848560;Ne;0;5;0;5
11044;Šermukšnėlė;AKMENUKAI;3513568460;Ne;0;4;2;6
11045;Šermukšnėlė;AKMENUKAI;6896990721;Ne;8;1;0;9
11046;Šermukšnėlė;AKMENUKAI;8669676262;Ne;0;5;0;5
11047;Šermukšnėlė;AKMENUKAI;3148857617;Ne;0;8;0;8
11048;Šermukšnėlė;AKMENUKAI;4965640386;Ne;4;0;1;5
11049;Šermukšnėlė;AKMENUKAI;3639954786;Ne;14;0;5;19
11050;Šermukšnėlė;AKMENUKAI;7843128263;Ne;0;1;0;1
11051;Šermukšnėlė;AKMENUKAI;9805841777;Ne;4;5;0;9
11052;Šermukšnėlė;AKMENUKAI;3945291560;Ne;2;0;0;2
11053;Šermukšnėlė;AKMENUKAI;5660238634;Ne;10;4;0;14
11054;Šermukšnėlė;AKMENUKAI;6067298318;Ne;6;3;0;9
11055;Šermukšnėlė;AKMENUKAI;5678559268;Ne;8;0;1;9
11056;Šermukšnėlė;AKMENUKAI;8479230675;Ne;10;3;0;13
11057;Šermukšnėlė;AKMENUKAI;6162830167;Ne;18;0;0;18
11058;Šermukšnėlė;SIŪLINUKAI;4619600451;Ne;0;0;1;1
11059;Šermukšnėlė;SIŪLINUKAI;2967000352;Ne;6;4;4;14
11060;Šermukšnėlė;SIŪLINUKAI;4528448735;Ne;0;0;1;1
11061;Šermukšnėlė;SIŪLINUKAI;2740644605;Ne;6;4;0;10
11062;Šermukšnėlė;SIŪLINUKAI;6429038861;Ne;0;0;1;1
11063;Šermukšnėlė;SIŪLINUKAI;6429038861;Ne;0;0;1;1
11064;Šermukšnėlė;SIŪLINUKAI;6429038861;Ne;0;0;1;1
11065;Šermukšnėlė;SIŪLINUKAI;6429038861;Ne;0;0;1;1
11066;Šermukšnėlė;SIŪLINUKAI;1819553019;Ne;16;0;0;16
11067;Šermukšnėlė;SIŪLINUKAI;7568969509;Ne;21;0;0;21
11068;Šermukšnėlė;SIŪLINUKAI;7758886713;Ne;0;5;0;5
11069;Šermukšnėlė;SIŪLINUKAI;4390650081;Ne;0;4;2;6
11070;Šermukšnėlė;SIŪLINUKAI;5072021867;Ne;10;0;0;10
11071;Šermukšnėlė;SIŪLINUKAI;7934772640;Ne;0;2;0;2
11072;Šermukšnėlė;SIŪLINUKAI;3994075596;Ne;0;0;1;1
11073;Šermukšnėlė;SIŪLINUKAI;3098629992;Ne;0;1;0;1
11074;Šermukšnėlė;SIŪLINUKAI;6231057889;Ne;3;0;0;3
11075;Šermukšnėlė;SIŪLINUKAI;3106890807;Ne;0;1;0;1
11076;Šermukšnėlė;SIŪLINUKAI;9534316724;Ne;0;4;6;10
11077;Šermukšnėlė;SIŪLINUKAI;2705569653;Ne;7;0;0;7
11078;Šermukšnėlė;MEDINUKAi;8558117857;Ne;0;0;3;3
11079;Šermukšnėlė;MEDINUKAi;1318170904;Ne;0;0;5;5
11080;Šermukšnėlė;MEDINUKAi;6149973884;Ne;0;0;5;5
11081;Šermukšnėlė;MEDINUKAi;5874725607;Ne;5;0;1;6
11082;Šermukšnėlė;MEDINUKAi;7532979465;Ne;0;4;0;4
11083;Šermukšnėlė;MEDINUKAi;7834844175;Ne;0;4;0;4
11084;Šermukšnėlė;MEDINUKAi;7211488009;Ne;0;0;3;3
11085;Šermukšnėlė;MEDINUKAi;3359398381;Ne;0;1;0;1
11086;Šermukšnėlė;MEDINUKAi;8437052600;Ne;4;0;0;4
11087;Šermukšnėlė;MEDINUKAi;8200175951;Ne;5;6;1;12
11088;Šermukšnėlė;MEDINUKAi;7546040491;Ne;7;0;0;7
11089;Šermukšnėlė;MEDINUKAi;9872479998;Ne;10;0;0;10
11090;Šermukšnėlė;MEDINUKAi;5605191023;Ne;8;0;2;10
11091;Šermukšnėlė;MEDINUKAi;2698741674;Ne;0;3;0;3
11092;Šermukšnėlė;SKUDURINUKAI;7523588943;Ne;0;8;1;9
11093;Šermukšnėlė;SKUDURINUKAI;2235123503;Ne;0;0;2;2
11094;Šermukšnėlė;SKUDURINUKAI;3138507073;Ne;6;0;4;10
11095;Šermukšnėlė;SKUDURINUKAI;5162694179;Ne;3;4;0;7
11096;Šermukšnėlė;SKUDURINUKAI;9247356229;Ne;8;9;0;17
11097;Šermukšnėlė;SKUDURINUKAI;3206222470;Ne;10;0;0;10
11098;Šermukšnėlė;SKUDURINUKAI;5751303170;Ne;17;0;0;17
11099;Šermukšnėlė;SKUDURINUKAI;2810624440;Ne;10;1;0;11
11100;Šermukšnėlė;SKUDURINUKAI;3955219247;Ne;0;5;0;5
11101;Šermukšnėlė;SKUDURINUKAI;5564759354;Ne;19;0;0;19
11102;Šermukšnėlė;SKUDURINUKAI;1931894084;Ne;9;0;0;9
11103;Šermukšnėlė;SKUDURINUKAI;6778901855;Ne;12;0;5;17
11104;Šermukšnėlė;SKUDURINUKAI;1502704170;Ne;15;4;0;19
11105;Šermukšnėlė;PAGRANDUKAI;8802335133;Ne;0;1;4;5
11106;Šermukšnėlė;PAGRANDUKAI;6797936390;Ne;5;3;0;8
11107;Šermukšnėlė;PAGRANDUKAI;1312471779;Ne;3;0;0;3
11108;Šermukšnėlė;PAGRANDUKAI;6286235756;Ne;7;0;0;7
11109;Šermukšnėlė;PAGRANDUKAI;4219655802;Ne;4;0;0;4
11110;Šermukšnėlė;PAGRANDUKAI;4337084152;Taip;11;5;1;17
11111;Šermukšnėlė;PAGRANDUKAI;8092422909;Ne;16;0;1;17
11112;Šermukšnėlė;PAGRANDUKAI;9246072554;Ne;7;0;0;7
11113;Šermukšnėlė;PAGRANDUKAI;6185588116;Ne;3;0;1;4
11114;Šermukšnėlė;PAGRANDUKAI;1209135668;Ne;17;0;1;18
11115;Šermukšnėlė;PAGRANDUKAI;9080074486;Ne;11;1;0;12
11116;Šermukšnėlė;PAGRANDUKAI;7098953763;Ne;0;0;5;5
11117;Šermukšnėlė;PAGRANDUKAI;5081685546;Ne;5;0;4;9
11118;Šermukšnėlė;PAGRANDUKAI;5456669766;Ne;1;0;0;1
11119;Šermukšnėlė;PAGRANDUKAI;8641098720;Ne;5;0;2;7
11120;Šermukšnėlė;PAGRANDUKAI;4810571143;Ne;11;0;0;11
11121;Šermukšnėlė;PAGRANDUKAI;8130815072;Ne;3;1;0;4
11122;Šypsena;NYKŠTUKAI;5818211923;Ne;5;0;0;5
11123;Šypsena;NYKŠTUKAI;8665786789;Ne;13;0;0;13
11124;Šypsena;NYKŠTUKAI;6724776618;Ne;5;4;2;11
11125;Šypsena;NYKŠTUKAI;2790906806;Ne;0;0;2;2
11126;Šypsena;NYKŠTUKAI;9363618080;Ne;5;1;0;6
11127;Šypsena;NYKŠTUKAI;9702364620;Ne;0;6;0;6
11128;Šypsena;NYKŠTUKAI;3733757483;Ne;6;0;0;6
11129;Šypsena;NYKŠTUKAI;2900195046;Ne;4;1;1;6
11130;Šypsena;NYKŠTUKAI;3003901966;Ne;0;4;0;4
11131;Šypsena;NYKŠTUKAI;2182189246;Ne;5;0;0;5
11132;Šypsena;NYKŠTUKAI;1431850136;Ne;0;1;0;1
11133;Šypsena;NYKŠTUKAI;5142969776;Ne;15;0;0;15
11134;Šypsena;NYKŠTUKAI;8439694239;Ne;7;0;0;7
11135;Šypsena;NYKŠTUKAI;6377979434;Ne;5;4;0;9
11136;Šypsena;NYKŠTUKAI;7074211876;Ne;0;3;0;3
11137;Šypsena;SPINDULIUKAI;1324902555;Ne;3;1;1;5
11138;Šypsena;SPINDULIUKAI;7120597034;Ne;5;4;3;12
11139;Šypsena;SPINDULIUKAI;5879506651;Ne;0;0;1;1
11140;Šypsena;SPINDULIUKAI;3823623458;Ne;5;4;0;9
11141;Šypsena;SPINDULIUKAI;4695547847;Ne;2;0;0;2
11142;Šypsena;SPINDULIUKAI;6713182218;Ne;0;8;0;8
11143;Šypsena;SPINDULIUKAI;8215278033;Ne;0;0;1;1
11144;Šypsena;SPINDULIUKAI;7537442618;Ne;0;5;0;5
11145;Šypsena;SPINDULIUKAI;2584574423;Ne;5;0;0;5
11146;Šypsena;SPINDULIUKAI;9704350208;Ne;0;3;5;8
11147;Šypsena;SPINDULIUKAI;5906001927;Ne;0;0;4;4
11148;Šypsena;SPINDULIUKAI;6951845385;Ne;5;0;0;5
11149;Šypsena;SPINDULIUKAI;7877396588;Ne;5;1;0;6
11150;Šypsena;SPINDULIUKAI;4520148322;Ne;0;2;0;2
11151;Šypsena;SPINDULIUKAI;3901424559;Ne;0;4;0;4
11152;Šypsena;SPINDULIUKAI;8765509994;Ne;5;2;1;8
11153;Šypsena;SPINDULIUKAI;3429836513;Ne;0;4;17;21
11154;Šypsena;SPINDULIUKAI;8566236342;Ne;15;0;0;15
11155;Šypsena;SKRUZDELIUKAI;5611440056;Ne;11;0;0;11
11156;Šypsena;SKRUZDELIUKAI;1114341518;Ne;0;0;1;1
11157;Šypsena;SKRUZDELIUKAI;1558614852;Ne;7;0;0;7
11158;Šypsena;SKRUZDELIUKAI;1897176871;Ne;0;2;0;2
11159;Šypsena;SKRUZDELIUKAI;1181590127;Ne;0;7;0;7
11160;Šypsena;SKRUZDELIUKAI;4808041625;Ne;0;4;2;6
11161;Šypsena;SKRUZDELIUKAI;4038279267;Ne;5;4;0;9
11162;Šypsena;SKRUZDELIUKAI;5834057370;Ne;0;4;0;4
11163;Šypsena;SKRUZDELIUKAI;1515803985;Ne;0;4;0;4
11164;Šypsena;SKRUZDELIUKAI;3809171499;Ne;0;3;0;3
11165;Šypsena;SKRUZDELIUKAI;4344780723;Ne;0;0;4;4
11166;Šypsena;SKRUZDELIUKAI;5928432220;Ne;0;0;4;4
11167;Šypsena;SKRUZDELIUKAI;5504570516;Ne;0;0;3;3
11168;Šypsena;SKRUZDELIUKAI;5369445077;Ne;0;9;1;10
11169;Šypsena;SKRUZDELIUKAI;2798819321;Ne;1;2;0;3
11170;Šypsena;SKRUZDELIUKAI;7519967594;Ne;7;0;0;7
11171;Šypsena;Bitutės;6590285866;Ne;0;1;0;1
11172;Šypsena;Bitutės;4766170132;Ne;6;0;0;6
11173;Šypsena;Bitutės;1422418997;Ne;0;4;0;4
11174;Šypsena;Bitutės;6832433711;Ne;0;1;0;1
11175;Šypsena;Bitutės;2995753269;Ne;0;5;0;5
11176;Šypsena;Bitutės;2248628927;Ne;0;11;0;11
11177;Šypsena;Bitutės;2706678026;Ne;2;0;0;2
11178;Šypsena;Bitutės;7413098580;Ne;2;8;0;10
11179;Šypsena;Bitutės;3063226692;Ne;5;4;0;9
11180;Šypsena;Bitutės;5985974927;Ne;11;0;0;11
11181;Šypsena;Bitutės;3387625466;Ne;4;1;2;7
11182;Šypsena;Bitutės;1669768648;Ne;9;1;0;10
11183;Šypsena;Bitutės;1575413188;Ne;0;1;0;1
11184;Šypsena;Bitutės;6511231991;Ne;0;2;1;3
11185;Šypsena;Bitutės;5568502083;Ne;0;2;0;2
11186;Šypsena;MEŠKIUKAI;7876871684;Ne;11;0;0;11
11187;Šypsena;MEŠKIUKAI;6055482561;Ne;11;0;0;11
11188;Šypsena;MEŠKIUKAI;6028006499;Ne;10;6;5;21
11189;Šypsena;MEŠKIUKAI;3724483762;Ne;14;0;0;14
11190;Šypsena;MEŠKIUKAI;7817486488;Ne;11;4;0;15
11191;Šypsena;MEŠKIUKAI;9862387726;Ne;5;0;0;5
11192;Šypsena;MEŠKIUKAI;8001187137;Ne;0;0;1;1
11193;Šypsena;MEŠKIUKAI;3663446767;Ne;5;4;0;9
11194;Šypsena;MEŠKIUKAI;5094556499;Ne;5;0;0;5
11195;Šypsena;MEŠKIUKAI;4496704989;Ne;6;2;0;8
11196;Šypsena;MEŠKIUKAI;7471913547;Ne;8;0;0;8
11197;Šypsena;MEŠKIUKAI;7174068697;Ne;3;0;1;4
11198;Šypsena;BORUŽĖLĖS;6738149077;Ne;11;6;2;19
11199;Šypsena;BORUŽĖLĖS;7905089772;Ne;0;4;3;7
11200;Šypsena;BORUŽĖLĖS;4011596895;Ne;0;4;3;7
11201;Šypsena;BORUŽĖLĖS;7234904026;Ne;12;0;0;12
11202;Šypsena;BORUŽĖLĖS;8963484558;Ne;6;4;0;10
11203;Šypsena;BORUŽĖLĖS;3951000812;Ne;0;11;0;11
11204;Šypsena;BORUŽĖLĖS;2177181171;Ne;17;0;1;18
11205;Šypsena;BORUŽĖLĖS;7960872132;Ne;5;6;0;11
11206;Šypsena;BORUŽĖLĖS;4260693029;Ne;16;5;0;21
11207;Šypsena;BORUŽĖLĖS;1657019248;Ne;10;0;1;11
11208;Šypsena;BORUŽĖLĖS;8756079118;Ne;10;2;0;12
11209;Šnekutis;DRUGELIŲ;1504945841;Ne;13;7;0;20
11210;Šnekutis;DRUGELIŲ;6305168453;Ne;0;0;2;2
11211;Šnekutis;DRUGELIŲ;9543014297;Ne;3;0;2;5
11212;Šnekutis;DRUGELIŲ;3096125224;Ne;0;12;0;12
11213;Šnekutis;DRUGELIŲ;3386995244;Ne;0;0;1;1
11214;Šnekutis;DRUGELIŲ;2131948397;Ne;0;2;0;2
11215;Šnekutis;DRUGELIŲ;1902486846;Ne;0;7;2;9
11216;Šnekutis;DRUGELIŲ;8984597121;Ne;9;0;0;9
11217;Šnekutis;DRUGELIŲ;8810371475;Ne;0;4;0;4
11218;Šnekutis;DRUGELIŲ;7680962037;Ne;0;21;0;21
11219;Šnekutis;DRUGELIŲ;3611064172;Ne;0;9;0;9
11220;Šnekutis;DRUGELIŲ;8209686459;Ne;6;2;0;8
11221;Šnekutis;DRUGELIŲ;8036600501;Ne;0;1;0;1
11222;Šnekutis;DRUGELIŲ;6071004512;Ne;0;1;0;1
11223;Šnekutis;DRUGELIŲ;8570372260;Ne;0;6;0;6
11224;Šnekutis;DRUGELIŲ;1556960616;Ne;5;1;0;6
11225;Šnekutis;DRUGELIŲ;3177449195;Ne;3;5;0;8
11226;Šnekutis;DRUGELIŲ;7954240439;Ne;6;1;2;9
11227;Šnekutis;DRUGELIŲ;6330033887;Ne;5;4;0;9
11228;Šnekutis;Kačiukų;9780684867;Ne;0;17;0;17
11229;Šnekutis;Kačiukų;3166309530;Taip;2;3;0;5
11230;Šnekutis;Kačiukų;7638626055;Taip;0;0;8;8
11231;Šnekutis;Kačiukų;9157136735;Ne;0;5;0;5
11232;Šnekutis;Kačiukų;4920263429;Ne;9;1;2;12
11233;Šnekutis;Kačiukų;2914145045;Ne;17;0;0;17
11234;Šnekutis;Kačiukų;8340697546;Ne;0;1;0;1
11235;Šnekutis;Kačiukų;2656152037;Ne;10;5;0;15
11236;Šnekutis;Kačiukų;9051956302;Ne;3;4;14;21
11237;Šnekutis;Kačiukų;5521822696;Ne;0;0;10;10
11238;Šnekutis;Kačiukų;9942669058;Ne;0;1;3;4
11239;Šnekutis;Kačiukų;2144568225;Ne;10;4;0;14
11240;Šnekutis;Kačiukų;4624075875;Ne;0;0;1;1
11241;Šnekutis;Pėlėdžiukų;5188035949;Ne;0;4;5;9
11242;Šnekutis;Pėlėdžiukų;4334155280;Ne;0;4;0;4
11243;Šnekutis;Pėlėdžiukų;77534335117;Ne;0;0;2;2
11244;Šnekutis;Pėlėdžiukų;3312928478;Ne;0;4;0;4
11245;Šnekutis;Pėlėdžiukų;8866360301;Ne;1;0;0;1
11246;Šnekutis;Pėlėdžiukų;8745465796;Ne;2;4;15;21
11247;Šnekutis;Pėlėdžiukų;3578045341;Ne;2;3;0;5
11248;Šnekutis;Pėlėdžiukų;5117544317;Ne;4;0;1;5
11249;Šnekutis;Pėlėdžiukų;5615869149;Ne;3;0;0;3
11250;Šnekutis;Pėlėdžiukų;1329958641;Ne;0;3;1;4
11251;Šnekutis;Pėlėdžiukų;9511116249;Ne;10;4;0;14
11252;Šnekutis;Pėlėdžiukų;1369660223;Ne;0;1;0;1
11253;Šnekutis;Pėlėdžiukų;1682748852;Ne;0;2;0;2
11254;Šnekutis;Pėlėdžiukų;9601932777;Ne;0;4;6;10
11255;Šnekutis;Pėlėdžiukų;4302555600;Ne;0;4;6;10
11256;Šnekutis;Pėlėdžiukų;7507857415;Ne;0;1;1;2
11257;Šnekutis;Pėlėdžiukų;7514753023;Ne;0;17;0;17
11258;Šnekutis;Pėlėdžiukų;54532738133;Ne;0;1;0;1
11259;Šnekutis;Boružėlių;4835202527;Ne;0;4;0;4
11260;Šnekutis;Boružėlių;9326455786;Ne;0;0;1;1
11261;Šnekutis;Boružėlių;9054899440;Ne;0;0;1;1
11262;Šnekutis;Boružėlių;9862362744;Ne;0;0;4;4
11263;Šnekutis;Boružėlių;2843483435;Ne;8;0;0;8
11264;Šnekutis;Boružėlių;6405894763;Ne;0;6;0;6
11265;Šnekutis;Boružėlių;3889176018;Ne;0;0;2;2
11266;Šnekutis;Boružėlių;6749848086;Ne;0;0;4;4
11267;Šnekutis;Boružėlių;6544973632;Ne;0;0;6;6
11268;Šnekutis;Boružėlių;6146988521;Ne;0;2;0;2
11269;Šnekutis;Boružėlių;3628210526;Ne;0;7;0;7
11270;Šnekutis;Boružėlių;7344776758;Ne;0;0;5;5
11271;Šnekutis;Boružėlių;3344425033;Ne;0;0;2;2
11272;Šnekutis;Boružėlių;3937465849;Ne;0;17;0;17
11273;Šnekutis;Boružėlių;8219465079;Ne;0;1;0;1
11274;Šnekutis;Boružėlių;7307895397;Ne;0;10;1;11
11275;Šnekutis;Boružėlių;2779793970;Ne;13;0;0;13
11276;Šnekutis;Meškučių;3214549246;Ne;12;0;0;12
11277;Šnekutis;Meškučių;6306269165;Ne;3;2;0;5
11278;Šnekutis;Meškučių;2626247219;Ne;9;0;1;10
11279;Šnekutis;Meškučių;7707897830;Ne;11;0;0;11
11280;Šnekutis;Meškučių;2140099519;Ne;0;1;0;1
11281;Šnekutis;Meškučių;1219175855;Ne;5;1;0;6
11282;Šnekutis;Meškučių;9574210410;Ne;0;6;0;6
11283;Šnekutis;Meškučių;7980166125;Ne;0;4;0;4
11284;Šnekutis;Meškučių;8456957469;Ne;0;5;0;5
11285;Šnekutis;Meškučių;8417485561;Ne;1;0;0;1
11286;Šnekutis;Meškučių;1475304511;Ne;5;0;0;5
11287;Šnekutis;Viščiukų;9790241725;Ne;4;0;0;4
11288;Šnekutis;Viščiukų;9322106995;Ne;3;0;0;3
11289;Šnekutis;Viščiukų;3842436406;Ne;0;4;0;4
11290;Šnekutis;Viščiukų;3115675798;Ne;7;0;0;7
11291;Šnekutis;Viščiukų;9385583890;Ne;19;2;0;21
11292;Šnekutis;Viščiukų;4848437026;Ne;0;0;1;1
11293;Šnekutis;Viščiukų;9772257715;Ne;0;2;0;2
11294;Šnekutis;Viščiukų;3593766968;Ne;5;0;1;6
11295;Šnekutis;Viščiukų;1833392181;Ne;0;1;1;2
11296;Šnekutis;Viščiukų;1805259980;Ne;4;0;2;6
11297;Šnekutis;Viščiukų;3588737003;Ne;12;0;0;12
11298;Šnekutis;Viščiukų;7200356364;Ne;4;0;0;4
11299;Šnekutis;Viščiukų;1248466603;Ne;6;0;0;6
11300;Šnekutis;Viščiukų;7006343288;Ne;17;0;0;17
11301;Užupiukas;VYTURĖLIŲ;7443013255;Ne;0;0;4;4
11302;Užupiukas;VYTURĖLIŲ;3656400244;Ne;0;13;1;14
11303;Užupiukas;VYTURĖLIŲ;3829013911;Ne;7;3;1;11
11304;Užupiukas;VYTURĖLIŲ;9212428150;Ne;0;0;1;1
11305;Užupiukas;VYTURĖLIŲ;8001099421;Ne;3;0;4;7
11306;Užupiukas;VYTURĖLIŲ;4401569800;Ne;0;4;6;10
11307;Užupiukas;VYTURĖLIŲ;1391826582;Ne;7;7;0;14
11308;Užupiukas;VYTURĖLIŲ;5021163099;Ne;0;0;6;6
11309;Užupiukas;VYTURĖLIŲ;8960813016;Ne;0;1;0;1
11310;Užupiukas;VYTURĖLIŲ;9132605734;Ne;7;7;0;14
11311;Užupiukas;VYTURĖLIŲ;8245876832;Ne;0;4;5;9
11312;Užupiukas;VYTURĖLIŲ;7532497390;Ne;2;0;1;3
11313;Užupiukas;VYTURĖLIŲ;5168946019;Ne;0;0;5;5
11314;Užupiukas;VYTURĖLIŲ;5718382826;Ne;0;3;7;10
11315;Užupiukas;VYTURĖLIŲ;9209209113;Ne;13;0;3;16
11316;Užupiukas;VYTURĖLIŲ;9070732925;Ne;5;3;0;8
11317;Užupiukas;VYTURĖLIŲ;1146968021;Ne;0;1;0;1
11318;Užupiukas;VYTURĖLIŲ;1647271985;Ne;0;0;1;1
11319;Užupiukas;VYTURĖLIŲ;8347350503;Ne;0;4;7;11
11320;Užupiukas;VYTURĖLIŲ;2580733127;Ne;0;4;1;5
11321;Užupiukas;KAČIUKŲ;3905448176;Ne;0;0;1;1
11322;Užupiukas;KAČIUKŲ;3567963511;Ne;0;9;3;12
11323;Užupiukas;KAČIUKŲ;9991552624;Ne;0;5;2;7
11324;Užupiukas;KAČIUKŲ;3048959458;Ne;1;5;1;7
11325;Užupiukas;KAČIUKŲ;3080668107;Ne;0;5;0;5
11326;Užupiukas;KAČIUKŲ;1809036046;Ne;0;7;0;7
11327;Užupiukas;KAČIUKŲ;1102468034;Ne;0;4;1;5
11328;Užupiukas;KAČIUKŲ;1464016943;Ne;0;5;0;5
11329;Užupiukas;KAČIUKŲ;4485435274;Ne;0;0;1;1
11330;Užupiukas;KAČIUKŲ;1102293237;Ne;0;4;2;6
11331;Užupiukas;KAČIUKŲ;9386211193;Ne;0;8;2;10
11332;Užupiukas;KAČIUKŲ;7048114101;Ne;0;0;2;2
11333;Užupiukas;KAČIUKŲ;1388346927;Ne;0;7;1;8
11334;Užupiukas;KAČIUKŲ;9333587467;Ne;0;0;1;1
11335;Užupiukas;KAČIUKŲ;7092857844;Ne;0;0;1;1
11336;Užupiukas;KAČIUKŲ;2606742144;Ne;6;1;0;7
11337;Užupiukas;KAČIUKŲ;5233447872;Ne;0;0;21;21
11338;Užupiukas;KAČIUKŲ;9719845726;Ne;0;9;0;9
11339;Užupiukas;KAČIUKŲ;3543913063;Ne;0;8;1;9
11340;Užupiukas;KAČIUKŲ;4920190785;Ne;0;0;21;21
11341;Užupiukas;DRUGELIŲ;8876174256;Ne;15;0;3;18
11342;Užupiukas;DRUGELIŲ;5239006321;Ne;0;1;10;11
11343;Užupiukas;DRUGELIŲ;7581152903;Ne;0;0;8;8
11344;Užupiukas;DRUGELIŲ;4680027403;Ne;0;0;8;8
11345;Užupiukas;DRUGELIŲ;9577167600;Ne;5;0;1;6
11346;Užupiukas;DRUGELIŲ;3419182422;Ne;4;11;0;15
11347;Užupiukas;DRUGELIŲ;4854016957;Ne;4;0;3;7
11348;Užupiukas;DRUGELIŲ;8692826414;Ne;4;0;2;6
11349;Užupiukas;DRUGELIŲ;7169272175;Ne;5;0;1;6
11350;Užupiukas;DRUGELIŲ;1156471313;Ne;4;0;0;4
11351;Užupiukas;DRUGELIŲ;4595291532;Ne;0;0;5;5
11352;Užupiukas;DRUGELIŲ;3383643388;Ne;0;0;5;5
11353;Užupiukas;DRUGELIŲ;3961733676;Ne;0;0;17;17
11354;Užupiukas;DRUGELIŲ;5006880916;Ne;1;0;5;6
11355;Užupiukas;DRUGELIŲ;4075611307;Ne;0;0;3;3
11356;Užupiukas;DRUGELIŲ;9715624372;Ne;0;0;13;13
11357;Užupiukas;DRUGELIŲ;1108429907;Ne;0;0;9;9
11358;Užupiukas;DRUGELIŲ;9295230331;Ne;0;0;3;3
11359;Užupiukas;DRUGELIŲ;3940029893;Ne;3;0;0;3
11360;Užupiukas;EŽIUKŲ;1526296386;Ne;0;0;2;2
11361;Užupiukas;EŽIUKŲ;9774124589;Ne;0;0;1;1
11362;Užupiukas;EŽIUKŲ;2724216446;Ne;0;10;0;10
11363;Užupiukas;EŽIUKŲ;1651249962;Ne;0;4;1;5
11364;Užupiukas;EŽIUKŲ;1100574872;Ne;0;4;1;5
11365;Užupiukas;EŽIUKŲ;5204808398;Ne;0;2;4;6
11366;Užupiukas;EŽIUKŲ;7860601571;Ne;10;0;0;10
11367;Užupiukas;EŽIUKŲ;3611922301;Ne;0;4;3;7
11368;Užupiukas;EŽIUKŲ;8020138690;Ne;0;0;1;1
11369;Užupiukas;EŽIUKŲ;6823724962;Ne;30;0;0;30
11370;Užupiukas;EŽIUKŲ;5538327364;Ne;8;0;1;9
11371;Užupiukas;EŽIUKŲ;3057147440;Ne;4;4;4;12
11372;Užupiukas;EŽIUKŲ;6370918943;Ne;0;0;2;2
11373;Užupiukas;EŽIUKŲ;6512355340;Ne;0;0;3;3
11374;Užupiukas;EŽIUKŲ;4356736070;Ne;0;0;5;5
11375;Užupiukas;EŽIUKŲ;9906475253;Ne;0;0;7;7
11376;Užupiukas;EŽIUKŲ;8127218866;Ne;0;0;21;21
11377;Užupiukas;EŽIUKŲ;8720638097;Ne;5;0;3;8
11378;Užupiukas;BORUŽĖLIŲ;4781598862;Ne;0;15;0;15
11379;Užupiukas;BORUŽĖLIŲ;7861121290;Ne;0;0;1;1
11380;Užupiukas;BORUŽĖLIŲ;6526550727;Ne;0;0;2;2
11381;Užupiukas;BORUŽĖLIŲ;1582921323;Ne;0;0;7;7
11382;Užupiukas;BORUŽĖLIŲ;9791681813;Ne;0;1;1;2
11383;Užupiukas;BORUŽĖLIŲ;1503714343;Ne;0;4;1;5
11384;Užupiukas;BORUŽĖLIŲ;8313812681;Ne;0;0;3;3
11385;Užupiukas;BORUŽĖLIŲ;9677572224;Ne;3;0;0;3
11386;Užupiukas;BORUŽĖLIŲ;2445335267;Ne;0;0;3;3
11387;Užupiukas;BORUŽĖLIŲ;38066177076;Ne;0;0;2;2
11388;Užupiukas;BORUŽĖLIŲ;1514268763;Ne;0;4;0;4
11389;Užupiukas;BORUŽĖLIŲ;2307600884;Ne;0;4;2;6
11390;Užupiukas;BORUŽĖLIŲ;6073039842;Ne;6;5;0;11
11391;Užupiukas;BORUŽĖLIŲ;3038973312;Ne;0;1;0;1
11392;Užupiukas;BORUŽĖLIŲ;6601099182;Ne;0;6;0;6
11393;Užupiukas;BORUŽĖLIŲ;3940264504;Ne;0;2;1;3
11394;Užupiukas;BORUŽĖLIŲ;5517458323;Ne;0;9;1;10
11395;Užupiukas;BORUŽĖLIŲ;7427702848;Ne;4;4;0;8
11396;Užupiukas;SPINDULIUKŲ;1718518621;Ne;3;1;1;5
11397;Užupiukas;SPINDULIUKŲ;7140606152;Ne;0;1;5;6
11398;Užupiukas;SPINDULIUKŲ;1679324943;Ne;7;6;0;13
11399;Užupiukas;SPINDULIUKŲ;7298322865;Ne;1;1;0;2
11400;Užupiukas;SPINDULIUKŲ;8734960045;Ne;0;7;5;12
11401;Užupiukas;SPINDULIUKŲ;9863097416;Ne;4;0;1;5
11402;Užupiukas;SPINDULIUKŲ;3579499796;Ne;2;0;0;2
11403;Užupiukas;SPINDULIUKŲ;1772019951;Ne;0;0;3;3
11404;Užupiukas;SPINDULIUKŲ;3298267311;Ne;0;5;0;5
11405;Užupiukas;SPINDULIUKŲ;9617597828;Ne;0;1;0;1
11406;Užupiukas;SPINDULIUKŲ;8915159672;Ne;5;3;0;8
11407;Užupiukas;SPINDULIUKŲ;1554333137;Ne;0;4;17;21
11408;Užupiukas;SPINDULIUKŲ;9723966502;Ne;0;1;7;8
11409;Užupiukas;SPINDULIUKŲ;9655636851;Ne;3;0;0;3
11410;Užupiukas;SPINDULIUKŲ;8724566014;Ne;17;0;0;17
11411;Užupiukas;SPINDULIUKŲ;8870229834;Ne;3;4;6;13
11412;Užupiukas;SPINDULIUKŲ;9096157655;Ne;8;1;3;12
11413;Užupiukas;SPINDULIUKŲ;9782972949;Ne;0;0;3;3
11414;Užupiukas;SPINDULIUKŲ;3958071677;Ne;9;0;8;17
11415;Užupiukas;SPINDULIUKŲ;3231001225;Ne;0;2;0;2
11416;Užupiukas;SPINDULIUKŲ;5406866873;Ne;0;2;0;2
11417;Užupiukas;ŽVIRBLIUKŲ;8519118225;Ne;0;0;4;4
11418;Užupiukas;ŽVIRBLIUKŲ;7549628277;Ne;0;0;4;4
11419;Užupiukas;ŽVIRBLIUKŲ;5085660507;Ne;4;4;0;8
11420;Užupiukas;ŽVIRBLIUKŲ;9925592494;Ne;0;0;1;1
11421;Užupiukas;ŽVIRBLIUKŲ;7345579721;Ne;5;5;1;11
11422;Užupiukas;ŽVIRBLIUKŲ;4710910251;Ne;0;6;1;7
11423;Užupiukas;ŽVIRBLIUKŲ;9428884149;Ne;0;0;10;10
11424;Užupiukas;ŽVIRBLIUKŲ;4054724625;Ne;0;3;0;3
11425;Užupiukas;ŽVIRBLIUKŲ;2210437775;Ne;0;4;0;4
11426;Užupiukas;ŽVIRBLIUKŲ;1995228207;Ne;0;1;4;5
11427;Užupiukas;ŽVIRBLIUKŲ;1496541880;Ne;0;11;8;19
11428;Užupiukas;ŽVIRBLIUKŲ;1684901495;Ne;0;1;0;1
11429;Užupiukas;ŽVIRBLIUKŲ;2390955083;Ne;0;0;1;1
11430;Užupiukas;ŽVIRBLIUKŲ;6001766518;Ne;0;1;0;1
11431;Užupiukas;ŽVIRBLIUKŲ;3768945773;Ne;0;1;0;1
11432;Užupiukas;ŽVIRBLIUKŲ;3224193396;Ne;0;1;0;1
11433;Užupiukas;ŽVIRBLIUKŲ;1843171673;Ne;0;1;0;1
11434;Užupiukas;ŽVIRBLIUKŲ;4785494419;Ne;0;9;8;17
11435;Užupiukas;ŽVIRBLIUKŲ;8119142600;Ne;1;0;7;8
11436;Užupiukas;PELĖDŽIUKŲ;2938276316;Ne;0;4;0;4
11437;Užupiukas;PELĖDŽIUKŲ;40704768956;Ne;0;4;0;4
11438;Užupiukas;PELĖDŽIUKŲ;5665323444;Ne;0;4;11;15
11439;Užupiukas;PELĖDŽIUKŲ;4880828482;Ne;0;0;8;8
11440;Užupiukas;PELĖDŽIUKŲ;6478702476;Ne;0;4;8;12
11441;Užupiukas;PELĖDŽIUKŲ;6110869303;Ne;0;0;2;2
11442;Užupiukas;PELĖDŽIUKŲ;3205769002;Ne;0;0;5;5
11443;Užupiukas;PELĖDŽIUKŲ;79442829922;Ne;0;4;1;5
11444;Užupiukas;PELĖDŽIUKŲ;4247280316;Ne;0;4;5;9
11445;Užupiukas;PELĖDŽIUKŲ;4608233152;Ne;5;0;0;5
11446;Užupiukas;PELĖDŽIUKŲ;5498369850;Ne;0;4;7;11
11447;Užupiukas;PELĖDŽIUKŲ;2821350355;Ne;14;0;0;14
11448;Užupiukas;PELĖDŽIUKŲ;3309195572;Ne;0;4;8;12
11449;Užupiukas;PELĖDŽIUKŲ;4132760111;Ne;0;4;0;4
11450;Užupiukas;PELĖDŽIUKŲ;22401995674;Ne;0;4;0;4
11451;Užupiukas;PELĖDŽIUKŲ;53412835151;Ne;0;5;0;5
11452;Užupiukas;PELĖDŽIUKŲ;6236652118;Ne;0;2;0;2
11453;Užupiukas;PELĖDŽIUKŲ;3774364829;Ne;0;3;2;5
11454;Užupiukas;PELĖDŽIUKŲ;9197242545;Ne;5;0;2;7
11455;Užupiukas;PELĖDŽIUKŲ;5357731534;Ne;0;1;1;2
11456;Užupiukas;PELĖDŽIUKŲ;5046355276;Ne;1;0;0;1
11457;Užupiukas;PELĖDŽIUKŲ;1091861376;Ne;0;0;5;5
11458;Užupiukas;VARPELIŲ;7107441792;Ne;0;0;2;2
11459;Užupiukas;VARPELIŲ;7895825571;Ne;0;0;1;1
11460;Užupiukas;VARPELIŲ;7919242126;Ne;0;4;1;5
11461;Užupiukas;VARPELIŲ;9310238442;Ne;0;0;1;1
11462;Užupiukas;VARPELIŲ;2769924857;Ne;0;0;2;2
11463;Užupiukas;VARPELIŲ;5941280824;Ne;0;0;15;15
11464;Užupiukas;VARPELIŲ;7105857162;Ne;3;0;4;7
11465;Užupiukas;VARPELIŲ;2485426055;Ne;4;0;0;4
11466;Užupiukas;VARPELIŲ;7314085267;Ne;7;7;0;14
11467;Užupiukas;VARPELIŲ;2752139377;Ne;5;0;4;9
11468;Užupiukas;VARPELIŲ;4106614478;Ne;0;1;0;1
11469;Užupiukas;VARPELIŲ;1407429980;Ne;0;0;1;1
11470;Užupiukas;VARPELIŲ;4811619739;Ne;7;2;0;9
11471;Užupiukas;VARPELIŲ;9523512906;Ne;12;0;0;12
11472;Užupiukas;VARPELIŲ;3745080560;Ne;0;4;0;4
11473;Užupiukas;VARPELIŲ;5148672602;Ne;0;0;2;2
11474;Užupiukas;SAULUČIŲ;5704945892;Ne;0;0;10;10
11475;Užupiukas;SAULUČIŲ;2681679016;Ne;0;6;0;6
11476;Užupiukas;SAULUČIŲ;3684774901;Ne;0;0;2;2
11477;Užupiukas;SAULUČIŲ;8163092636;Ne;0;0;8;8
11478;Užupiukas;SAULUČIŲ;1976775494;Ne;0;0;12;12
11479;Užupiukas;SAULUČIŲ;5874450724;Ne;0;0;7;7
11480;Užupiukas;SAULUČIŲ;3341292382;Ne;5;2;1;8
11481;Užupiukas;SAULUČIŲ;5570569874;Ne;4;1;0;5
11482;Užupiukas;SAULUČIŲ;7643286183;Ne;0;0;3;3
11483;Užupiukas;SAULUČIŲ;2814556305;Ne;5;1;3;9
11484;Užupiukas;SAULUČIŲ;7209853233;Ne;0;0;4;4
11485;Užupiukas;SAULUČIŲ;9953994943;Ne;0;8;0;8
11486;Užupiukas;SAULUČIŲ;6849149197;Ne;0;0;1;1
11487;Užupiukas;SAULUČIŲ;7956550754;Ne;0;0;11;11
11488;Užupiukas;SAULUČIŲ;5469735455;Ne;6;1;6;13
11489;Užupiukas;SAULUČIŲ;8489545569;Ne;0;1;4;5
11490;Užupiukas;SAULUČIŲ;7990479988;Ne;0;0;2;2
11491;Užupiukas;SAULUČIŲ;4691413468;Ne;0;0;6;6
11492;Užupiukas;SAULUČIŲ;7423292334;Ne;2;9;0;11
11493;Užupiukas;SAULUČIŲ;9216626936;Ne;0;4;4;8
11494;Užupiukas;SAULUČIŲ;9962455415;Ne;0;0;2;2
11495;Užupiukas;LAPIUKŲ;9833934299;Ne;2;5;0;7
11496;Užupiukas;LAPIUKŲ;4963679583;Ne;0;0;4;4
11497;Užupiukas;LAPIUKŲ;2679915982;Ne;0;0;9;9
11498;Užupiukas;LAPIUKŲ;6004467875;Ne;0;1;1;2
11499;Užupiukas;LAPIUKŲ;1718048938;Ne;0;1;9;10
11500;Užupiukas;LAPIUKŲ;7986962850;Ne;0;1;8;9
11501;Užupiukas;LAPIUKŲ;5965564175;Ne;0;1;2;3
11502;Užupiukas;LAPIUKŲ;5680350014;Ne;0;1;1;2
11503;Užupiukas;LAPIUKŲ;7161001771;Ne;0;1;0;1
11504;Užupiukas;LAPIUKŲ;1886792898;Ne;5;4;0;9
11505;Užupiukas;LAPIUKŲ;4900699267;Ne;0;10;0;10
11506;Užupiukas;LAPIUKŲ;1178152392;Ne;15;1;0;16
11507;Užupiukas;LAPIUKŲ;7029091978;Ne;0;1;0;1
11508;Užupiukas;LAPIUKŲ;1041972540;Ne;0;1;0;1
11509;Užupiukas;LAPIUKŲ;8252575784;Ne;5;0;0;5
11510;Užupiukas;LAPIUKŲ;3333547785;Ne;10;1;2;13
11511;Užupiukas;LAPIUKŲ;8529259340;Ne;0;2;6;8
11512;Užupiukas;NYKŠTUKŲ;4895744524;Ne;7;0;4;11
11513;Užupiukas;NYKŠTUKŲ;3811750547;Ne;0;0;11;11
11514;Užupiukas;NYKŠTUKŲ;2158976125;Ne;0;0;11;11
11515;Užupiukas;NYKŠTUKŲ;6857321547;Ne;25;0;5;30
11516;Užupiukas;NYKŠTUKŲ;5381329362;Ne;0;0;2;2
11517;Užupiukas;NYKŠTUKŲ;6206118484;Ne;0;0;1;1
11518;Užupiukas;NYKŠTUKŲ;1399112659;Ne;12;0;9;21
11519;Užupiukas;NYKŠTUKŲ;4379182756;Ne;0;0;13;13
11520;Užupiukas;NYKŠTUKŲ;9785674147;Ne;0;0;13;13
11521;Užupiukas;NYKŠTUKŲ;3094320206;Ne;0;0;13;13
11522;Užupiukas;NYKŠTUKŲ;9714322911;Ne;0;0;4;4
11523;Užupiukas;NYKŠTUKŲ;3014087333;Ne;0;6;0;6
11524;Užupiukas;NYKŠTUKŲ;7589905741;Ne;0;0;9;9
11525;Užupiukas;NYKŠTUKŲ;4570457987;Ne;5;2;6;13
11526;Užupiukas;NYKŠTUKŲ;9312234251;Ne;0;0;1;1
11527;Vaidilutė;Žiogelis;7779630805;Ne;2;3;0;5
11528;Vaidilutė;Žiogelis;45949026707;Ne;1;4;1;6
11529;Vaidilutė;Žiogelis;1853463568;Ne;1;7;7;15
11530;Vaidilutė;Žiogelis;5620009051;Ne;0;0;2;2
11531;Vaidilutė;Žiogelis;5203062837;Ne;0;4;1;5
11532;Vaidilutė;Žiogelis;3112025222;Ne;0;0;1;1
11533;Vaidilutė;Žiogelis;4334934114;Ne;0;4;2;6
11534;Vaidilutė;Žiogelis;7843388119;Ne;0;2;0;2
11535;Vaidilutė;Žiogelis;2041126370;Ne;0;0;1;1
11536;Vaidilutė;Žiogelis;5991149222;Ne;0;3;2;5
11537;Vaidilutė;Žiogelis;1786022030;Ne;0;0;4;4
11538;Vaidilutė;Žiogelis;1266927367;Ne;0;3;0;3
11539;Vaidilutė;Žiogelis;1430802591;Ne;0;4;0;4
11540;Vaidilutė;Žiogelis;4259585225;Ne;0;4;0;4
11541;Vaidilutė;Žiogelis;1769926207;Ne;0;1;1;2
11542;Vaidilutė;Rūtelė;8789527552;Ne;0;1;0;1
11543;Vaidilutė;Rūtelė;7319037375;Ne;0;0;4;4
11544;Vaidilutė;Rūtelė;4838951446;Ne;0;1;0;1
11545;Vaidilutė;Rūtelė;7494818866;Ne;0;4;1;5
11546;Vaidilutė;Rūtelė;5500950179;Ne;0;2;0;2
11547;Vaidilutė;Rūtelė;1140011879;Ne;0;4;4;8
11548;Vaidilutė;Rūtelė;9563257771;Ne;0;6;0;6
11549;Vaidilutė;Rūtelė;2024078532;Ne;0;0;10;10
11550;Vaidilutė;Rūtelė;5482030284;Ne;0;4;2;6
11551;Vaidilutė;Rūtelė;8505156287;Ne;7;0;0;7
11552;Vaidilutė;Rūtelė;9568450630;Ne;0;5;2;7
11553;Vaidilutė;Rūtelė;7306768961;Ne;0;4;0;4
11554;Vaidilutė;Rūtelė;7532115462;Ne;19;0;0;19
11555;Vaidilutė;Rūtelė;6896047075;Ne;0;0;1;1
11556;Vaidilutė;Rūtelė;3059654988;Ne;7;4;2;13
11557;Vaidilutė;Rūtelė;1341696594;Ne;5;0;2;7
11558;Vaidilutė;Rūtelė;1141947715;Ne;7;4;8;19
11559;Vaidilutė;Rūtelė;2014160468;Ne;0;1;3;4
11560;Vaidilutė;Voveraitė;3248203941;Ne;0;0;3;3
11561;Vaidilutė;Voveraitė;1608646909;Ne;21;0;0;21
11562;Vaidilutė;Voveraitė;9429544108;Taip;0;0;5;5
11563;Vaidilutė;Voveraitė;5652381296;Ne;0;0;2;2
11564;Vaidilutė;Voveraitė;8377824920;Ne;5;8;0;13
11565;Vaidilutė;Voveraitė;5296146822;Ne;0;0;1;1
11566;Vaidilutė;Voveraitė;3299081380;Ne;6;6;0;12
11567;Vaidilutė;Voveraitė;3634285869;Ne;6;0;9;15
11568;Vaidilutė;Voveraitė;7703578508;Ne;0;0;16;16
11569;Vaidilutė;Voveraitė;3150642420;Ne;19;0;3;22
11570;Vaidilutė;Voveraitė;8177787790;Ne;0;0;2;2
11571;Vaidilutė;Voveraitė;7327131165;Ne;0;6;5;11
11572;Vaidilutė;Voveraitė;2318578603;Ne;3;4;6;13
11573;Vaidilutė;Voveraitė;9372280434;Ne;5;1;0;6
11574;Vaidilutė;Voveraitė;1372767364;Ne;18;0;0;18
11575;Vaidilutė;Voveraitė;7478943531;Ne;4;0;5;9
11576;Vaidilutė;Voveraitė;4738318120;Ne;0;12;0;12
11577;Vaidilutė;Voveraitė;3319615121;Ne;0;0;4;4
11578;Vaidilutė;Voveraitė;6299324271;Ne;0;0;5;5
11579;Vaidilutė;Voveraitė;4186708502;Ne;0;0;11;11
11580;Vaidilutė;Voveraitė;2855672500;Ne;5;10;0;15
11581;Vaidilutė;Voveraitė;8053548602;Ne;5;0;1;6
11582;Vaidilutė;Saulutė;8492055287;Ne;0;0;8;8
11583;Vaidilutė;Saulutė;6844372910;Ne;12;0;0;12
11584;Vaidilutė;Saulutė;1355005114;Ne;11;0;0;11
11585;Vaidilutė;Saulutė;4680645841;Ne;0;0;9;9
11586;Vaidilutė;Saulutė;2662468804;Ne;0;1;0;1
11587;Vaidilutė;Saulutė;5217609332;Ne;0;4;3;7
11588;Vaidilutė;Saulutė;2864731541;Ne;17;0;1;18
11589;Vaidilutė;Saulutė;1998872078;Ne;0;0;3;3
11590;Vaidilutė;Saulutė;2468220275;Ne;0;0;4;4
11591;Vaidilutė;Saulutė;1610262589;Ne;0;0;4;4
11592;Vaidilutė;Saulutė;2356037175;Ne;0;0;1;1
11593;Vaidilutė;Saulutė;5054640268;Ne;11;0;2;13
11594;Vaidilutė;Saulutė;6885473308;Ne;0;2;0;2
11595;Vaidilutė;Saulutė;7826111890;Ne;7;0;0;7
11596;Vaidilutė;Saulutė;9870763434;Ne;0;5;0;5
11597;Vaidilutė;Saulutė;5945744595;Ne;0;5;9;14
11598;Vaidilutė;Saulutė;6674238265;Ne;0;4;4;8
11599;Vaidilutė;Saulutė;1092821241;Ne;4;0;1;5
11600;Vaidilutė;Saulutė;2294802783;Ne;3;4;1;8
11601;Vaidilutė;Žibutė;5668493994;Ne;4;5;0;9
11602;Vaidilutė;Žibutė;4085959509;Ne;0;0;6;6
11603;Vaidilutė;Žibutė;1001320466;Ne;0;0;1;1
11604;Vaidilutė;Žibutė;3051006765;Ne;0;0;1;1
11605;Vaidilutė;Žibutė;9189713003;Ne;10;3;0;13
11606;Vaidilutė;Žibutė;7903242996;Ne;0;0;19;19
11607;Vaidilutė;Žibutė;7400197367;Ne;5;1;0;6
11608;Vaidilutė;Žibutė;3980894528;Ne;1;0;3;4
11609;Vaidilutė;Žibutė;1362256314;Ne;0;15;0;15
11610;Vaidilutė;Žibutė;7940581813;Ne;2;0;0;2
11611;Vaidilutė;Žibutė;2767482145;Ne;6;0;1;7
11612;Vaidilutė;Žibutė;7765298370;Ne;0;0;1;1
11613;Vaidilutė;Žibutė;8769601956;Ne;0;0;1;1
11614;Vaidilutė;Žibutė;1726638921;Ne;7;4;2;13
11615;Vaidilutė;Žibutė;5415279154;Ne;0;3;0;3
11616;Vaidilutė;Žibutė;4124217264;Ne;0;0;6;6
11617;Vaidilutė;Žibutė;7429825620;Ne;11;0;1;12
11618;Vaidilutė;Žibutė;7690470762;Ne;5;10;0;15
11619;Vaidilutė;"Ąžuoliukas ";3463112472;Ne;0;0;4;4
11620;Vaidilutė;"Ąžuoliukas ";3730573432;Ne;0;8;1;9
11621;Vaidilutė;"Ąžuoliukas ";6586072228;Ne;0;2;0;2
11622;Vaidilutė;"Ąžuoliukas ";5988376676;Ne;9;4;0;13
11623;Vaidilutė;"Ąžuoliukas ";4954285515;Ne;0;3;0;3
11624;Vaidilutė;"Ąžuoliukas ";5439973183;Ne;8;0;0;8
11625;Vaidilutė;"Ąžuoliukas ";4761992071;Ne;2;0;2;4
11626;Vaidilutė;"Ąžuoliukas ";3381544575;Ne;2;0;1;3
11627;Vaidilutė;"Ąžuoliukas ";5307486959;Ne;0;7;0;7
11628;Vaidilutė;"Ąžuoliukas ";1653497170;Ne;0;7;0;7
11629;Vaidilutė;"Ąžuoliukas ";1440819171;Ne;7;8;0;15
11630;Vaidilutė;"Ąžuoliukas ";2668758195;Ne;0;4;0;4
11631;Vaidilutė;"Ąžuoliukas ";4901387311;Ne;4;4;0;8
11632;Vaidilutė;"Ąžuoliukas ";2997948252;Ne;21;0;0;21
11633;Vaidilutė;"Ąžuoliukas ";9723156071;Ne;0;0;7;7
11634;Vaidilutė;"Ąžuoliukas ";3782651091;Ne;4;0;0;4
11635;Vaidilutė;"Ąžuoliukas ";6637224510;Ne;0;0;4;4
11636;Vaidilutė;"Ąžuoliukas ";6067801976;Ne;7;0;1;8
11637;Vaidilutė;"Žemuogėlė ";1993403692;Ne;0;0;1;1
11638;Vaidilutė;"Žemuogėlė ";42503303158;Ne;0;4;1;5
11639;Vaidilutė;"Žemuogėlė ";9869134464;Ne;0;1;0;1
11640;Vaidilutė;"Žemuogėlė ";29153363263;Ne;17;1;0;18
11641;Vaidilutė;"Žemuogėlė ";3069613102;Ne;0;4;0;4
11642;Vaidilutė;"Žemuogėlė ";5177060346;Ne;0;6;0;6
11643;Vaidilutė;"Žemuogėlė ";4671287016;Ne;0;1;0;1
11644;Vaidilutė;"Žemuogėlė ";9124975928;Ne;0;5;1;6
11645;Vaidilutė;"Žemuogėlė ";7419525100;Ne;0;5;0;5
11646;Vaidilutė;"Žemuogėlė ";1363913645;Ne;0;4;0;4
11647;Vaidilutė;"Žemuogėlė ";5252637701;Ne;0;4;0;4
11648;Vaidilutė;"Žemuogėlė ";3202508790;Ne;0;0;1;1
11649;Vaidilutė;"Žemuogėlė ";1320999237;Ne;0;6;0;6
11650;Vaidilutė;"Žemuogėlė ";9769645272;Ne;0;1;0;1
11651;Vaidilutė;"Žemuogėlė ";1315347184;Ne;0;6;0;6
11652;Vaidilutė;"Žemuogėlė ";1704155743;Ne;2;5;0;7
11653;Vaidilutė;"Žemuogėlė ";5276088687;Ne;0;4;2;6
11654;Vaidilutė;"Žemuogėlė ";1477508451;Ne;0;0;2;2
11655;Vaidilutė;"Vyturėlis ";3121914268;Ne;15;0;0;15
11656;Vaidilutė;"Vyturėlis ";5050251048;Ne;14;1;0;15
11657;Vaidilutė;"Vyturėlis ";7106410219;Ne;0;0;2;2
11658;Vaidilutė;"Vyturėlis ";9558983004;Ne;7;6;0;13
11659;Vaidilutė;"Vyturėlis ";5326935037;Ne;0;4;6;10
11660;Vaidilutė;"Vyturėlis ";2189753894;Ne;0;3;1;4
11661;Vaidilutė;"Vyturėlis ";9689388330;Ne;0;2;0;2
11662;Vaidilutė;"Vyturėlis ";9584702487;Ne;0;0;2;2
11663;Vaidilutė;"Vyturėlis ";2081959307;Ne;0;9;2;11
11664;Vaidilutė;"Vyturėlis ";8882402632;Ne;0;4;11;15
11665;Vaidilutė;"Vyturėlis ";1539700521;Ne;7;0;0;7
11666;Vaidilutė;"Vyturėlis ";4230076320;Ne;0;4;0;4
11667;Vaidilutė;"Vyturėlis ";8628545847;Ne;0;7;0;7
11668;Vaidilutė;"Vyturėlis ";2058071219;Ne;0;4;0;4
11669;Vaidilutė;"Vyturėlis ";4388069915;Ne;0;1;2;3
11670;Vaidilutė;"Vyturėlis ";1401180999;Ne;0;2;1;3
11671;Vaidilutė;"Vyturėlis ";1417828163;Ne;0;0;2;2
11672;Vaidilutė;"Vyturėlis ";5651628204;Ne;0;4;0;4
11673;Vaidilutė;"Vyturėlis ";7914006128;Ne;6;0;1;7
11674;Vaidilutė;"Vyturėlis ";7131561558;Ne;3;0;2;5
11675;Vaidilutė;"Vyturėlis ";2194984060;Ne;0;3;6;9
11676;Vaidilutė;"Vyturėlis ";3351968717;Ne;3;7;0;10
11677;Vaidilutė;"Varpelis ";6250831269;Ne;0;1;0;1
11678;Vaidilutė;"Varpelis ";2763266518;Ne;0;1;0;1
11679;Vaidilutė;"Varpelis ";6037349527;Ne;0;4;1;5
11680;Vaidilutė;"Varpelis ";5867501558;Ne;0;4;0;4
11681;Vaidilutė;"Varpelis ";5448014291;Ne;0;2;0;2
11682;Vaidilutė;"Varpelis ";3497795848;Ne;0;0;1;1
11683;Vaidilutė;"Varpelis ";4280822951;Ne;0;2;2;4
11684;Vaidilutė;"Varpelis ";6107554047;Ne;6;0;0;6
11685;Vaidilutė;"Varpelis ";3453045619;Ne;0;0;1;1
11686;Vaidilutė;"Varpelis ";6022130248;Ne;0;2;0;2
11687;Vaidilutė;"Varpelis ";5101104226;Ne;0;1;0;1
11688;Vaidilutė;"Varpelis ";1882829340;Ne;0;6;4;10
11689;Vaidilutė;"Varpelis ";6097229427;Ne;4;0;1;5
11690;Vaidilutė;"Varpelis ";3353827105;Ne;2;0;6;8
11691;Vaidilutė;"Varpelis ";4362797606;Ne;0;4;0;4
11692;Vaidilutė;"Varpelis ";6322986820;Ne;5;0;0;5
11693;Vaidilutė;"Varpelis ";2941550026;Ne;0;4;2;6
11694;Vaidilutė;"Boružėlių ";6928815317;Ne;15;0;1;16
11695;Vaidilutė;"Boružėlių ";2164241264;Ne;4;0;0;4
11696;Vaidilutė;"Boružėlių ";4648985217;Ne;2;0;0;2
11697;Vaidilutė;"Boružėlių ";4805621473;Ne;0;4;0;4
11698;Vaidilutė;"Boružėlių ";4348206726;Ne;5;0;0;5
11699;Vaidilutė;"Boružėlių ";5405461987;Ne;0;0;1;1
11700;Vaidilutė;"Boružėlių ";8629789128;Ne;2;5;0;7
11701;Vaidilutė;"Boružėlių ";8413764934;Ne;0;1;0;1
11702;Vaidilutė;"Boružėlių ";2315322608;Ne;13;0;1;14
11703;Vaidilutė;"Boružėlių ";7019245743;Ne;3;6;0;9
11704;Vaidilutė;"Boružėlių ";7075509397;Ne;0;4;1;5
11705;Vaidilutė;"Boružėlių ";8012451263;Ne;0;7;0;7
11706;Vaidilutė;"Boružėlių ";5205356977;Ne;0;4;0;4
11707;Vaidilutė;"Boružėlių ";5095161432;Ne;8;0;0;8
11708;Vaidilutė;"Boružėlių ";6239494382;Ne;2;0;0;2
11709;Vaidilutė;"Malūnelis ";4887753072;Ne;4;7;0;11
11710;Vaidilutė;"Malūnelis ";7726116370;Ne;0;0;1;1
11711;Vaidilutė;"Malūnelis ";8444010416;Ne;5;0;7;12
11712;Vaidilutė;"Malūnelis ";4568108299;Ne;0;0;1;1
11713;Vaidilutė;"Malūnelis ";5026620305;Ne;0;5;0;5
11714;Vaidilutė;"Malūnelis ";3826303389;Ne;5;0;0;5
11715;Vaidilutė;"Malūnelis ";5918039529;Ne;2;0;16;18
11716;Vaidilutė;"Malūnelis ";3850868701;Ne;0;0;1;1
11717;Vaidilutė;"Malūnelis ";7660273021;Ne;0;6;0;6
11718;Vaidilutė;"Malūnelis ";6449710777;Ne;10;0;2;12
11719;Vaidilutė;"Malūnelis ";2444426554;Ne;8;0;2;10
11720;Vaidilutė;"Riešutėlis ";1161455376;Ne;7;0;1;8
11721;Vaidilutė;"Riešutėlis ";4518002596;Ne;0;1;5;6
11722;Vaidilutė;"Riešutėlis ";4657952465;Ne;9;0;0;9
11723;Vaidilutė;"Riešutėlis ";8756807918;Ne;0;0;12;12
11724;Vaidilutė;"Riešutėlis ";1206696843;Ne;0;3;6;9
11725;Vaidilutė;"Riešutėlis ";9872915544;Ne;0;8;0;8
11726;Vaidilutė;"Riešutėlis ";2976615414;Ne;0;0;10;10
11727;Vaidilutė;"Riešutėlis ";2409760986;Ne;0;0;6;6
11728;Vaidilutė;"Riešutėlis ";2564536281;Ne;4;0;0;4
11729;Vaidilutė;"Riešutėlis ";9025469107;Ne;4;0;0;4
11730;Vaidilutė;"Riešutėlis ";3862444839;Ne;5;0;10;15
11731;Vaidilutė;"Riešutėlis ";9567786222;Ne;12;0;0;12
11732;Vaidilutė;"Riešutėlis ";3321127541;Ne;0;0;1;1
11733;Vaidilutė;"Riešutėlis ";3064988592;Ne;4;0;10;14
11734;Vaidilutė;"Riešutėlis ";8296567629;Ne;0;0;2;2
11735;Vaidilutė;"Riešutėlis ";7871629009;Ne;0;0;8;8
11736;Vandenis;ŽUVĖDRŲ;5362078687;Ne;0;6;0;6
11737;Vandenis;ŽUVĖDRŲ;6784010746;Ne;4;2;0;6
11738;Vandenis;ŽUVĖDRŲ;9334958945;Ne;0;6;0;6
11739;Vandenis;ŽUVĖDRŲ;7646133208;Ne;5;0;0;5
11740;Vandenis;ŽUVĖDRŲ;4303303483;Ne;2;5;0;7
11741;Vandenis;ŽUVĖDRŲ;2325465812;Ne;0;1;0;1
11742;Vandenis;ŽUVĖDRŲ;2649542586;Ne;2;5;0;7
11743;Vandenis;ŽUVĖDRŲ;1144490168;Ne;1;7;2;10
11744;Vandenis;ŽUVĖDRŲ;7948161881;Ne;6;0;0;6
11745;Vandenis;ŽUVĖDRŲ;7391206543;Ne;0;1;0;1
11746;Vandenis;ŽUVĖDRŲ;6068154206;Ne;0;2;0;2
11747;Vandenis;ŽUVĖDRŲ;7296608892;Ne;0;9;0;9
11748;Vandenis;ŽUVĖDRŲ;4117091634;Ne;0;10;0;10
11749;Vandenis;ŽUVĖDRŲ;6063181697;Ne;0;1;0;1
11750;Vandenis;ŽUVĖDRŲ;6661117114;Ne;13;2;0;15
11751;Vandenis;ŽUVĖDRŲ;5112768778;Ne;0;9;0;9
11752;Vandenis;RUONIUKŲ;2422642232;Ne;0;7;0;7
11753;Vandenis;RUONIUKŲ;1051281257;Ne;0;7;0;7
11754;Vandenis;RUONIUKŲ;1120907086;Ne;9;5;0;14
11755;Vandenis;RUONIUKŲ;7702272913;Ne;0;2;0;2
11756;Vandenis;RUONIUKŲ;6476051751;Ne;0;10;0;10
11757;Vandenis;RUONIUKŲ;9162936403;Ne;6;3;0;9
11758;Vandenis;RUONIUKŲ;4713395766;Ne;0;6;0;6
11759;Vandenis;RUONIUKŲ;6986724058;Ne;0;4;0;4
11760;Vandenis;RUONIUKŲ;7754158588;Ne;0;0;1;1
11761;Vandenis;RUONIUKŲ;9527253920;Ne;2;4;0;6
11762;Vandenis;RUONIUKŲ;8971291182;Ne;5;0;1;6
11763;Vandenis;RUONIUKŲ;6330187732;Ne;6;1;0;7
11764;Vandenis;RUONIUKŲ;9688954631;Ne;0;2;0;2
11765;Vandenis;RUONIUKŲ;4971165639;Ne;4;1;0;5
11766;Vandenis;RUONIUKŲ;3664560833;Ne;0;3;0;3
11767;Vandenis;RUONIUKŲ;5535901447;Ne;0;1;0;1
11768;Vandenis;ŽUVYČIŲ;55421695186;Ne;0;4;0;4
11769;Vandenis;ŽUVYČIŲ;43933878402;Ne;0;4;0;4
11770;Vandenis;ŽUVYČIŲ;9608871155;Ne;0;3;0;3
11771;Vandenis;ŽUVYČIŲ;7381695975;Ne;0;5;0;5
11772;Vandenis;ŽUVYČIŲ;8430706407;Ne;0;6;0;6
11773;Vandenis;ŽUVYČIŲ;8689134931;Ne;0;4;0;4
11774;Vandenis;ŽUVYČIŲ;4085256182;Ne;1;1;0;2
11775;Vandenis;ŽUVYČIŲ;6828175620;Ne;0;3;0;3
11776;Vandenis;ŽUVYČIŲ;7408758565;Ne;5;2;0;7
11777;Vandenis;ŽUVYČIŲ;1568158992;Ne;0;5;1;6
11778;Vandenis;ŽUVYČIŲ;1598122777;Ne;0;4;0;4
11779;Vandenis;ŽUVYČIŲ;18336904438;Ne;0;4;0;4
11780;Vandenis;ŽUVYČIŲ;5549292096;Ne;3;7;0;10
11781;Vandenis;ŽUVYČIŲ;8705188652;Ne;3;16;0;19
11782;Vandenis;ŽUVYČIŲ;71513217054;Ne;0;4;0;4
11783;Vandenis;ŽUVYČIŲ;24217366528;Ne;0;6;0;6
11784;Vandenis;ŽUVYČIŲ;9994373029;Ne;0;4;0;4
11785;Vandenis;ŽUVYČIŲ;3544717790;Ne;0;2;0;2
11786;Vandenis;ŽUVYČIŲ;4643267945;Ne;0;3;0;3
11787;Vandenis;ŽUVYČIŲ;27409922803;Ne;5;0;0;5
11788;Vandenis;ŽUVYČIŲ;9518434896;Ne;0;13;0;13
11789;Vandenis;ŽUVYČIŲ;2638433939;Ne;0;1;0;1
11790;Vandenis;PERLIUKŲ;6295009202;Ne;0;3;0;3
11791;Vandenis;PERLIUKŲ;7598257845;Ne;0;6;0;6
11792;Vandenis;PERLIUKŲ;7473692892;Ne;0;5;0;5
11793;Vandenis;PERLIUKŲ;5323428164;Ne;0;2;0;2
11794;Vandenis;PERLIUKŲ;6073002418;Ne;0;4;0;4
11795;Vandenis;PERLIUKŲ;2576575249;Ne;5;0;0;5
11796;Vandenis;PERLIUKŲ;7832674282;Ne;0;2;0;2
11797;Vandenis;PERLIUKŲ;9798192239;Ne;0;5;0;5
11798;Vandenis;PERLIUKŲ;1975385430;Ne;0;4;0;4
11799;Vandenis;PERLIUKŲ;3061606138;Ne;0;3;0;3
11800;Vandenis;PERLIUKŲ;5613067534;Ne;0;6;4;10
11801;Vandenis;PERLIUKŲ;2321919298;Ne;17;2;2;21
11802;Vandenis;PERLIUKŲ;3239754791;Ne;0;7;0;7
11803;Vandenis;ANČIUKŲ;4607196473;Ne;0;0;3;3
11804;Vandenis;ANČIUKŲ;6189862061;Ne;0;9;0;9
11805;Vandenis;ANČIUKŲ;4345021061;Ne;0;9;0;9
11806;Vandenis;ANČIUKŲ;9763300020;Ne;9;1;1;11
11807;Vandenis;ANČIUKŲ;9968877035;Ne;0;4;0;4
11808;Vandenis;ANČIUKŲ;3639160500;Ne;3;5;0;8
11809;Vandenis;ANČIUKŲ;9458613523;Ne;0;8;0;8
11810;Vandenis;ANČIUKŲ;1213743099;Ne;0;4;0;4
11811;Vandenis;ANČIUKŲ;4954121871;Ne;6;0;0;6
11812;Vandenis;ANČIUKŲ;4983424940;Ne;6;0;0;6
11813;Vandenis;ANČIUKŲ;4978712442;Ne;8;4;0;12
11814;Vandenis;ANČIUKŲ;7581114286;Ne;6;3;0;9
11815;Vandenis;ANČIUKŲ;9679010239;Ne;6;2;0;8
11816;Vandenis;ANČIUKŲ;1132534461;Ne;6;5;0;11
11817;Vandenis;ANČIUKŲ;9498231306;Ne;0;5;0;5
11818;Vandenis;ANČIUKŲ;3544764716;Ne;3;2;3;8
11819;Vandenis;ANČIUKŲ;4530824157;Ne;0;4;0;4
11820;Vandenis;VĖŽLIUKŲ;2309166304;Ne;15;1;1;17
11821;Vandenis;VĖŽLIUKŲ;2872343656;Ne;4;0;4;8
11822;Vandenis;VĖŽLIUKŲ;5454049563;Ne;12;1;1;14
11823;Vandenis;VĖŽLIUKŲ;9805578141;Ne;12;1;1;14
11824;Vandenis;VĖŽLIUKŲ;8921666108;Ne;8;4;0;12
11825;Vandenis;VĖŽLIUKŲ;7069369080;Ne;0;1;0;1
11826;Vandenis;VĖŽLIUKŲ;7924399684;Ne;0;7;0;7
11827;Vandenis;VĖŽLIUKŲ;1187395353;Ne;0;5;0;5
11828;Vandenis;VĖŽLIUKŲ;7091356848;Ne;0;2;0;2
11829;Vandenis;VĖŽLIUKŲ;7059385610;Ne;0;11;0;11
11830;Vandenis;VĖŽLIUKŲ;9158541919;Ne;5;0;0;5
11831;Vandenis;VĖŽLIUKŲ;5959181898;Ne;5;0;0;5
11832;Vandenis;VĖŽLIUKŲ;1707354287;Ne;0;5;0;5
11833;Vandenis;VĖŽLIUKŲ;9704394568;Ne;2;0;0;2
11834;Vandenis;VĖŽLIUKŲ;4177166475;Ne;0;4;0;4
11835;Vandenis;VĖŽLIUKŲ;5218101579;Ne;2;1;0;3
11836;Vandenis;VĖŽLIUKŲ;8416839037;Ne;0;6;0;6
11837;Vandenis;VĖŽLIUKŲ;2936885357;Ne;7;0;2;9
11838;Vandenis;VĖŽLIUKŲ;8879608849;Ne;0;15;0;15
11839;Vandenis;AŠTUNKOJŲ;2077783219;Ne;0;2;0;2
11840;Vandenis;AŠTUNKOJŲ;8511948282;Ne;10;4;0;14
11841;Vandenis;AŠTUNKOJŲ;2096950367;Ne;0;4;0;4
11842;Vandenis;AŠTUNKOJŲ;71786730314;Ne;0;2;0;2
11843;Vandenis;AŠTUNKOJŲ;6181866272;Ne;0;3;0;3
11844;Vandenis;AŠTUNKOJŲ;5395847317;Ne;0;1;0;1
11845;Vandenis;AŠTUNKOJŲ;33317650043;Ne;0;4;0;4
11846;Vandenis;AŠTUNKOJŲ;7522472652;Ne;0;5;0;5
11847;Vandenis;AŠTUNKOJŲ;3243079651;Ne;0;2;0;2
11848;Vandenis;AŠTUNKOJŲ;3067868099;Ne;0;5;0;5
11849;Vandenis;AŠTUNKOJŲ;61120985165;Ne;5;4;1;10
11850;Vandenis;AŠTUNKOJŲ;8251169901;Ne;0;3;0;3
11851;Vandenis;AŠTUNKOJŲ;4750141780;Ne;0;5;0;5
11852;Vandenis;AŠTUNKOJŲ;1621481561;Ne;0;2;0;2
11853;Vandenis;AŠTUNKOJŲ;1314724267;Ne;5;0;0;5
11854;Vandenis;AŠTUNKOJŲ;1282499654;Ne;0;5;0;5
11855;Vandenis;AŠTUNKOJŲ;1739780612;Ne;0;10;0;10
11856;Vandenis;AŠTUNKOJŲ;8233407105;Ne;0;6;1;7
11857;Vandenis;AŠTUNKOJŲ;7168910452;Ne;0;3;0;3
11858;Vandenis;AŠTUNKOJŲ;2489776665;Ne;0;6;9;15
11859;Vandenis;AŠTUNKOJŲ;3938359901;Ne;0;4;0;4
11860;Vandenis;AŠTUNKOJŲ;33782837791;Ne;0;4;0;4
11861;Vandenis;AŠTUNKOJŲ;1633589144;Ne;3;1;0;4
11862;Vandenis;GANDRIUKŲ;4753416316;Ne;14;6;0;20
11863;Vandenis;GANDRIUKŲ;8264797886;Ne;18;0;0;18
11864;Vandenis;GANDRIUKŲ;9936940067;Ne;4;0;0;4
11865;Vandenis;GANDRIUKŲ;6153669587;Ne;9;0;0;9
11866;Vandenis;GANDRIUKŲ;6260893699;Ne;0;1;0;1
11867;Vandenis;GANDRIUKŲ;1919577714;Ne;8;2;1;11
11868;Vandenis;GANDRIUKŲ;7019646962;Ne;0;4;0;4
11869;Vandenis;GANDRIUKŲ;2078767085;Ne;7;0;3;10
11870;Vandenis;GANDRIUKŲ;2976505868;Ne;16;0;2;18
11871;Vandenis;GANDRIUKŲ;6558155968;Ne;0;4;0;4
11872;Vandenis;GANDRIUKŲ;6691874473;Ne;0;4;5;9
11873;Vandenis;GANDRIUKŲ;6483030616;Ne;14;0;0;14
11874;Vandenis;GANDRIUKŲ;8144830789;Ne;9;0;0;9
11875;Vandenis;GANDRIUKŲ;2381566229;Ne;9;4;0;13
11876;Vandenis;GANDRIUKŲ;5899846599;Ne;12;0;0;12
11877;Vandenis;GANDRIUKŲ;8127873607;Ne;5;0;0;5
11878;Vandenis;GANDRIUKŲ;1606103904;Ne;3;11;0;14
11879;Vandenis;GANDRIUKŲ;1753180703;Ne;0;1;0;1
11880;Vandenis;GANDRIUKŲ;7303512055;Ne;5;1;0;6
11881;Vandenis;GANDRIUKŲ;7311677107;Ne;0;5;2;7
11882;Vandenis;GANDRIUKŲ;6586215199;Ne;0;4;0;4
11883;Vandenis;GANDRIUKŲ;5985915835;Ne;0;0;2;2
11884;Vandenis;ŽĄSIUKAI;8034690071;Ne;8;4;0;12
11885;Vandenis;ŽĄSIUKAI;9937317687;Ne;5;0;0;5
11886;Vandenis;ŽĄSIUKAI;4984723792;Ne;0;2;0;2
11887;Vandenis;ŽĄSIUKAI;1333381525;Taip;0;1;0;1
11888;Vandenis;ŽĄSIUKAI;7071349847;Ne;0;4;0;4
11889;Vandenis;ŽĄSIUKAI;7070234429;Ne;0;5;0;5
11890;Vandenis;ŽĄSIUKAI;4072405890;Ne;9;1;0;10
11891;Vandenis;ŽĄSIUKAI;5684262347;Ne;3;0;0;3
11892;Vandenis;ŽĄSIUKAI;4349464804;Ne;0;1;0;1
11893;Vandenis;ŽĄSIUKAI;7596199296;Ne;6;1;0;7
11894;Vandenis;ŽĄSIUKAI;6876019354;Ne;7;2;0;9
11895;Vandenis;ŽĄSIUKAI;5607412408;Ne;18;0;0;18
11896;Vandenis;ŽĄSIUKAI;1925178245;Ne;0;3;0;3
11897;Vandenis;ŽĄSIUKAI;5641929490;Ne;8;4;0;12
11898;Vandenis;ŽĄSIUKAI;1850352131;Ne;0;2;0;2
11899;Vandenis;ŽĄSIUKAI;2454959791;Ne;13;0;0;13
11900;Vandenis;PURIENŲ;6851178154;Ne;0;11;0;11
11901;Vandenis;PURIENŲ;5440027798;Ne;9;0;0;9
11902;Vandenis;PURIENŲ;4455886780;Ne;6;0;3;9
11903;Vandenis;PURIENŲ;1031451445;Ne;4;6;0;10
11904;Vandenis;PURIENŲ;4815210197;Ne;5;5;0;10
11905;Vandenis;PURIENŲ;3337286021;Ne;11;0;0;11
11906;Vandenis;PURIENŲ;7020534318;Ne;0;0;3;3
11907;Vandenis;PURIENŲ;6027680514;Ne;12;2;0;14
11908;Vandenis;PURIENŲ;2960005490;Ne;0;2;4;6
11909;Vandenis;PURIENŲ;1180322026;Ne;0;2;4;6
11910;Vandenis;PURIENŲ;3633805607;Ne;0;3;0;3
11911;Vandenis;PURIENŲ;6332179750;Ne;0;2;2;4
11912;Vandenis;PURIENŲ;5540306590;Ne;0;2;0;2
11913;Vandenis;PURIENŲ;2719678617;Ne;3;4;0;7
11914;Vandenis;PURIENŲ;7171302906;Ne;10;0;0;10
11915;Vandenis;PURIENŲ;8085633453;Ne;10;0;0;10
11916;Vandenis;PURIENŲ;2614561762;Ne;0;2;0;2
11917;Vandenis;PURIENŲ;1244502945;Ne;0;4;0;4
11918;Vandenis;VARLIUKAI;2661339448;Ne;11;0;0;11
11919;Vandenis;VARLIUKAI;2451901210;Ne;0;6;0;6
11920;Vandenis;VARLIUKAI;1786146371;Ne;0;4;0;4
11921;Vandenis;VARLIUKAI;2506411643;Ne;2;0;0;2
11922;Vandenis;VARLIUKAI;8841954633;Ne;10;2;0;12
11923;Vandenis;VARLIUKAI;7001613448;Ne;10;2;0;12
11924;Vandenis;VARLIUKAI;1983972864;Ne;16;1;0;17
11925;Vandenis;VARLIUKAI;6067408982;Ne;5;1;0;6
11926;Vandenis;VARLIUKAI;8239664149;Ne;14;9;0;23
11927;Vandenis;VARLIUKAI;9380306986;Ne;0;2;0;2
11928;Vandenis;VARLIUKAI;1799139825;Ne;6;0;0;6
11929;Vandenis;VARLIUKAI;3038533882;Ne;11;5;0;16
11930;Vandenis;VARLIUKAI;3173213991;Ne;0;3;0;3
11931;Vandenis;VARLIUKAI;5675840354;Ne;0;2;0;2
11932;Vandenis;VARLIUKAI;6570331247;Ne;18;0;0;18
11933;Vandenis;VARLIUKAI;7233484054;Ne;10;0;0;10
11934;Vandenis;PINGVINAI;9856199548;Ne;14;0;0;14
11935;Vandenis;PINGVINAI;2209513000;Ne;4;1;0;5
11936;Vandenis;PINGVINAI;2665865704;Ne;5;0;0;5
11937;Vandenis;PINGVINAI;8755050997;Ne;12;0;0;12
11938;Vandenis;PINGVINAI;1780124964;Ne;0;1;0;1
11939;Vandenis;PINGVINAI;9609168578;Ne;2;9;0;11
11940;Vandenis;PINGVINAI;2156775779;Ne;0;3;0;3
11941;Vandenis;PINGVINAI;3360623444;Ne;1;3;0;4
11942;Vandenis;PINGVINAI;5191604973;Ne;7;1;0;8
11943;Vandenis;PINGVINAI;6992750701;Ne;0;3;0;3
11944;Vandenis;PINGVINAI;6731336385;Ne;6;0;0;6
11945;Vandenis;PINGVINAI;3933306911;Ne;10;7;0;17
11946;Vandenis;PINGVINAI;2534991705;Ne;15;0;0;15
11947;Vandenis;PINGVINAI;7267965471;Ne;0;1;0;1
11948;Vandenis;PINGVINAI;5632082019;Ne;6;0;0;6
11949;Vandenis;PINGVINAI;9717294497;Ne;9;1;0;10
11950;Vandenis;PINGVINAI;7770227772;Ne;0;21;0;21
11951;Vandenis;PINGVINAI;8560123112;Ne;0;5;0;5
11952;Vandenis;PINGVINAI;4091633411;Ne;10;0;0;10
11953;Vandenis;Debesėlių;6555465114;Ne;6;4;0;10
11954;Vandenis;Debesėlių;4226028904;Ne;0;1;0;1
11955;Vandenis;Debesėlių;2844636823;Ne;0;0;3;3
11956;Vandenis;Debesėlių;9521927635;Ne;6;0;0;6
11957;Vandenis;Debesėlių;2953842982;Ne;0;1;0;1
11958;Vandenis;Gintarėlių;5560529824;Ne;6;0;0;6
11959;Vandenis;Gintarėlių;7884422309;Ne;5;0;0;5
11960;Vandenis;Gintarėlių;4611293254;Ne;0;0;5;5
11961;Vandenis;Gintarėlių;5071489844;Ne;2;0;0;2
11962;Vandenis;Gintarėlių;5081501601;Ne;11;0;1;12
11963;Vandenis;Gintarėlių;3968719760;Ne;0;1;0;1
11964;Vandenis;Lašelių;1969144957;Ne;0;1;0;1
11965;Vandenis;Lašelių;8001157954;Ne;0;3;0;3
11966;Vandenis;Lašelių;9095152994;Ne;0;0;4;4
11967;Vandenis;Lašelių;9756750533;Ne;0;3;0;3
11968;Vandenis;Lašelių;6851036864;Ne;9;0;0;9
11969;Vandenis;Burbuliukų;3750162497;Ne;8;0;0;8
11970;Vandenis;Burbuliukų;6068144373;Ne;0;0;3;3
11971;Vandenis;Burbuliukų;2998970043;Ne;0;0;1;1
11972;Vandenis;Burbuliukų;7080129095;Ne;0;4;0;4
11973;Vandenis;Burbuliukų;1035549424;Ne;4;0;2;6
11974;Vandenis;Kriauklyčių;7736505435;Ne;5;0;0;5
11975;Vandenis;Kriauklyčių;4219981694;Ne;1;0;2;3
11976;Vandenis;Kriauklyčių;8703465445;Ne;10;0;0;10
11977;Vandenis;Kriauklyčių;4373688502;Ne;6;0;0;6
11978;Vandenis;Kriauklyčių;6848032146;Ne;1;0;0;1
11979;Vandenis;Kriauklyčių;2945086818;Ne;5;0;0;5
11980;Vandenis;Kriauklyčių;4168391832;Ne;2;0;1;3
11981;Vėjelis;Pumpurėliai;2541077369;Ne;8;0;0;8
11982;Vėjelis;Pumpurėliai;3125815427;Ne;0;0;2;2
11983;Vėjelis;Pumpurėliai;5516672613;Ne;0;5;0;5
11984;Vėjelis;Pumpurėliai;2866394056;Ne;3;0;0;3
11985;Vėjelis;Pumpurėliai;1084415930;Ne;0;2;0;2
11986;Vėjelis;Pumpurėliai;9071878406;Ne;0;2;0;2
11987;Vėjelis;Pumpurėliai;3206025676;Ne;0;1;0;1
11988;Vėjelis;Pumpurėliai;1057586168;Ne;6;1;0;7
11989;Vėjelis;Pumpurėliai;9583495324;Ne;0;3;0;3
11990;Vėjelis;Pumpurėliai;7539681314;Ne;0;4;0;4
11991;Vėjelis;Pumpurėliai;6168648640;Ne;0;2;0;2
11992;Vėjelis;Pumpurėliai;1876663813;Ne;5;2;1;8
11993;Vėjelis;Pumpurėliai;6840643273;Ne;4;0;0;4
11994;Vėjelis;Pumpurėliai;9824130744;Ne;5;6;0;11
11995;Vėjelis;Pumpurėliai;1842552329;Ne;0;0;14;14
11996;Vėjelis;Pumpurėliai;9986867356;Ne;0;5;0;5
11997;Vėjelis;Pumpurėliai;8467887788;Ne;2;11;0;13
11998;Vėjelis;Pumpurėliai;8994680698;Ne;0;2;0;2
11999;Vėjelis;Pumpurėliai;2656895893;Ne;6;0;0;6
12000;Vėjelis;Drugeliai;4746932126;Ne;8;6;2;16
12001;Vėjelis;Drugeliai;1978952781;Ne;0;4;0;4
12002;Vėjelis;Drugeliai;8353084814;Ne;0;4;0;4
12003;Vėjelis;Drugeliai;2416832899;Ne;0;4;0;4
12004;Vėjelis;Drugeliai;2734024890;Ne;0;11;0;11
12005;Vėjelis;Drugeliai;7981032872;Ne;0;21;0;21
12006;Vėjelis;Drugeliai;7594586198;Ne;0;4;1;5
12007;Vėjelis;Drugeliai;7697394469;Ne;0;6;3;9
12008;Vėjelis;Drugeliai;4066956765;Ne;0;2;0;2
12009;Vėjelis;Drugeliai;2788205363;Ne;0;6;4;10
12010;Vėjelis;Drugeliai;1331334220;Ne;0;2;2;4
12011;Vėjelis;Drugeliai;2151737048;Ne;0;3;0;3
12012;Vėjelis;Drugeliai;1862173525;Ne;0;1;0;1
12013;Vėjelis;Drugeliai;4988352741;Ne;3;0;0;3
12014;Vėjelis;Drugeliai;3982318250;Ne;0;6;0;6
12015;Vėjelis;Drugeliai;4473677352;Ne;0;4;0;4
12016;Vėjelis;Drugeliai;4506243333;Ne;0;4;0;4
12017;Vėjelis;Drugeliai;3524350131;Ne;0;4;1;5
12018;Vėjelis;Drugeliai;6061966626;Ne;0;4;0;4
12019;Vėjelis;Drugeliai;3453119286;Ne;4;0;1;5
12020;Vėjelis;Drugeliai;6891260701;Ne;0;12;0;12
12021;Vėjelis;Malūnėlis;1994035417;Ne;14;1;0;15
12022;Vėjelis;Malūnėlis;1448699738;Ne;5;2;4;11
12023;Vėjelis;Malūnėlis;3275186042;Ne;3;1;0;4
12024;Vėjelis;Malūnėlis;1882750621;Ne;10;0;0;10
12025;Vėjelis;Malūnėlis;5109441799;Ne;11;0;0;11
12026;Vėjelis;Malūnėlis;4171024976;Ne;0;0;7;7
12027;Vėjelis;Malūnėlis;1871467392;Ne;10;0;1;11
12028;Vėjelis;Malūnėlis;1342200813;Ne;3;0;0;3
12029;Vėjelis;Malūnėlis;8221349174;Ne;0;2;0;2
12030;Vėjelis;Malūnėlis;6600504736;Ne;5;2;0;7
12031;Vėjelis;Malūnėlis;8063276082;Ne;0;2;3;5
12032;Vėjelis;Malūnėlis;6244227830;Ne;11;0;1;12
12033;Vėjelis;Malūnėlis;1417987860;Ne;9;0;4;13
12034;Vėjelis;Malūnėlis;9636946669;Ne;13;0;0;13
12035;Vėjelis;Malūnėlis;5066748621;Ne;10;0;0;10
12036;Vėjelis;Malūnėlis;8822873586;Ne;5;0;0;5
12037;Vėjelis;Žvaigždutės;9492690970;Ne;4;1;0;5
12038;Vėjelis;Žvaigždutės;1436893015;Ne;6;0;0;6
12039;Vėjelis;Žvaigždutės;2117924725;Ne;12;0;0;12
12040;Vėjelis;Žvaigždutės;8866974952;Ne;0;7;0;7
12041;Vėjelis;Žvaigždutės;1549518622;Ne;15;0;6;21
12042;Vėjelis;Žvaigždutės;6386092350;Ne;0;19;0;19
12043;Vėjelis;Žvaigždutės;6844704326;Ne;0;4;3;7
12044;Vėjelis;Žvaigždutės;4353239658;Ne;2;1;0;3
12045;Vėjelis;Žvaigždutės;3315240387;Ne;0;12;0;12
12046;Vėjelis;Žvaigždutės;9557135813;Ne;0;1;0;1
12047;Vėjelis;Žvaigždutės;2132551615;Ne;10;0;10;20
12048;Vėjelis;Žvaigždutės;2522750651;Ne;6;0;0;6
12049;Vėjelis;Žvaigždutės;6777528441;Ne;0;7;0;7
12050;Vėjelis;Žvaigždutės;9135807341;Ne;10;5;0;15
12051;Vėjelis;Žvaigždutės;4101161670;Ne;5;0;0;5
12052;Vėjelis;Žvaigždutės;7247057946;Ne;0;4;7;11
12053;Vėjelis;Žvaigždutės;7046938604;Ne;0;5;0;5
12054;Vėjelis;Žvaigždutės;3495322620;Ne;16;0;0;16
12055;Vėjelis;Žvaigždutės;1956418258;Ne;0;9;0;9
12056;Vėjelis;Žvaigždutės;7203026860;Ne;15;0;0;15
12057;Vėjelis;Žvaigždutės;8300497094;Ne;1;5;1;7
12058;Vėjelis;Varpeliai;7274745807;Ne;0;7;4;11
12059;Vėjelis;Varpeliai;5931553549;Ne;0;1;0;1
12060;Vėjelis;Varpeliai;9926991259;Ne;0;7;1;8
12061;Vėjelis;Varpeliai;6608657740;Ne;10;1;0;11
12062;Vėjelis;Varpeliai;2794205377;Ne;0;2;0;2
12063;Vėjelis;Varpeliai;7507448059;Ne;0;5;0;5
12064;Vėjelis;Varpeliai;2363974247;Ne;9;4;0;13
12065;Vėjelis;Varpeliai;8379298947;Ne;9;3;0;12
12066;Vėjelis;Varpeliai;1205392813;Ne;0;5;0;5
12067;Vėjelis;Varpeliai;98588113289;Ne;0;5;0;5
12068;Vėjelis;Varpeliai;5396347620;Ne;0;7;0;7
12069;Vėjelis;Varpeliai;5031781196;Ne;0;4;0;4
12070;Vėjelis;Varpeliai;4219672982;Ne;0;3;0;3
12071;Vėjelis;Varpeliai;50124109589;Ne;0;4;0;4
12072;Vėjelis;Varpeliai;4853650350;Ne;0;11;0;11
12073;Vėjelis;Varpeliai;4521161684;Ne;0;10;0;10
12074;Vėjelis;Varpeliai;60890519853;Ne;0;4;0;4
12075;Vėjelis;Varpeliai;8684461171;Ne;0;7;0;7
12076;Vėjelis;Varpeliai;7133454882;Ne;0;9;0;9
12077;Vėjelis;Varpeliai;1863210064;Ne;0;6;0;6
12078;Vėjelis;Varpeliai;6221257045;Ne;10;4;0;14
12079;Vėjelis;Varpeliai;1534169381;Ne;0;8;0;8
12080;Vėjelis;Varpeliai;2957105835;Ne;0;1;2;3
12081;Vėjelis;Varpeliai;8748218387;Ne;0;1;0;1
12082;Vėjelis;Pelėdžiukų;3067215309;Ne;3;4;0;7
12083;Vėjelis;Pelėdžiukų;7211756910;Ne;0;2;0;2
12084;Vėjelis;Pelėdžiukų;2302652824;Ne;7;2;3;12
12085;Vėjelis;Pelėdžiukų;4852532740;Ne;0;21;0;21
12086;Vėjelis;Pelėdžiukų;4450739919;Ne;0;1;0;1
12087;Vėjelis;Pelėdžiukų;9202471939;Ne;1;6;0;7
12088;Vėjelis;Pelėdžiukų;1615837863;Ne;1;6;0;7
12089;Vėjelis;Pelėdžiukų;9852892338;Ne;0;9;0;9
12090;Vėjelis;Pelėdžiukų;8433853523;Ne;5;0;0;5
12091;Vėjelis;Pelėdžiukų;4746355716;Ne;0;0;1;1
12092;Vėjelis;Pelėdžiukų;5507017221;Ne;4;4;0;8
12093;Vėjelis;Pelėdžiukų;1259743374;Ne;8;2;4;14
12094;Vėjelis;Pelėdžiukų;6226234271;Ne;0;21;0;21
12095;Vėjelis;Pelėdžiukų;7559733997;Ne;0;5;0;5
12096;Vėjelis;Pelėdžiukų;3764096742;Ne;0;0;2;2
12097;Vėjelis;Pelėdžiukų;8153021028;Ne;7;0;0;7
12098;Vėjelis;Pelėdžiukų;8067153728;Ne;0;4;0;4
12099;Vėjelis;Pelėdžiukų;2283628712;Ne;0;2;2;4
12100;Vėjelis;Pelėdžiukų;4318295503;Ne;4;0;3;7
12101;Vėjelis;Pelėdžiukų;9867392835;Ne;0;9;0;9
12102;Vėjelis;Pelėdžiukų;5662728912;Ne;0;0;7;7
12103;Vėjelis;Skruzdeliukų;2167025998;Ne;0;2;0;2
12104;Vėjelis;Skruzdeliukų;2467377103;Ne;0;3;2;5
12105;Vėjelis;Skruzdeliukų;8470977526;Ne;4;0;0;4
12106;Vėjelis;Skruzdeliukų;9434737088;Ne;0;5;0;5
12107;Vėjelis;Skruzdeliukų;1952141664;Ne;13;3;1;17
12108;Vėjelis;Skruzdeliukų;3264153232;Ne;0;3;0;3
12109;Vėjelis;Skruzdeliukų;4992783345;Ne;0;9;0;9
12110;Vėjelis;Skruzdeliukų;4997987762;Ne;7;0;1;8
12111;Vėjelis;Skruzdeliukų;8356715925;Ne;0;2;3;5
12112;Vėjelis;Skruzdeliukų;4946988585;Ne;5;2;1;8
12113;Vėjelis;Skruzdeliukų;7240155487;Ne;0;4;6;10
12114;Vėjelis;Skruzdeliukų;7695719991;Ne;0;5;6;11
12115;Vėjelis;Skruzdeliukų;6618114389;Ne;0;2;0;2
12116;Vėjelis;Skruzdeliukų;1381923971;Ne;0;10;0;10
12117;Vėjelis;Skruzdeliukų;8630131152;Ne;7;4;0;11
12118;Vėjelis;Skruzdeliukų;6431589805;Ne;0;5;1;6
12119;Vėjelis;Skruzdeliukų;9177137585;Ne;2;0;0;2
12120;Vėjelis;Skruzdeliukų;4906958328;Ne;3;1;2;6
12121;Vėjelis;Skruzdeliukų;4080198912;Ne;0;1;3;4
12122;Vėjelis;Skruzdeliukų;1555270425;Ne;0;1;1;2
12123;Vėjelis;Skruzdeliukų;1467023330;Ne;0;2;1;3
12124;Vėjelis;Pieštukų;8995478684;Ne;4;1;0;5
12125;Vėjelis;Pieštukų;7860576967;Ne;14;0;0;14
12126;Vėjelis;Pieštukų;9546928491;Ne;1;0;1;2
12127;Vėjelis;Pieštukų;9675488924;Ne;1;0;0;1
12128;Vėjelis;Pieštukų;4884057836;Ne;0;0;3;3
12129;Vėjelis;Pieštukų;3898751303;Ne;0;21;0;21
12130;Vėjelis;Pieštukų;8281508498;Ne;0;11;4;15
12131;Vėjelis;Pieštukų;6909799367;Ne;0;4;0;4
12132;Vėjelis;Pieštukų;7748975870;Ne;5;0;0;5
12133;Vėjelis;Pieštukų;1075188861;Ne;13;0;3;16
12134;Vėjelis;Pieštukų;7854614677;Ne;8;0;0;8
12135;Vėjelis;Pieštukų;9451358807;Ne;10;0;1;11
12136;Vėjelis;Pieštukų;6453605110;Ne;0;21;0;21
12137;Vėjelis;Pieštukų;2720886612;Ne;0;2;0;2
12138;Vėjelis;Pieštukų;2734891342;Ne;12;3;0;15
12139;Vėjelis;Pieštukų;7101585528;Ne;0;0;7;7
12140;Vėjelis;Ramunėlių;6996900411;Ne;7;1;0;8
12141;Vėjelis;Ramunėlių;4733227215;Ne;0;2;0;2
12142;Vėjelis;Ramunėlių;5909697341;Ne;0;5;0;5
12143;Vėjelis;Ramunėlių;6451722893;Ne;0;6;0;6
12144;Vėjelis;Ramunėlių;1381191703;Ne;0;4;0;4
12145;Vėjelis;Ramunėlių;6660799519;Ne;1;1;0;2
12146;Vėjelis;Ramunėlių;4745262277;Ne;0;6;0;6
12147;Vėjelis;Ramunėlių;7790713917;Ne;1;1;0;2
12148;Vėjelis;Ramunėlių;8986581196;Ne;3;1;0;4
12149;Vėjelis;Ramunėlių;3123360955;Ne;0;3;0;3
12150;Vėjelis;Nykštukai;6741600874;Ne;9;0;0;9
12151;Vėjelis;Nykštukai;9957614551;Ne;0;4;0;4
12152;Vėjelis;Nykštukai;7233448544;Ne;19;2;0;21
12153;Vėjelis;Nykštukai;6602964509;Ne;6;1;0;7
12154;Vėjelis;Nykštukai;2573683778;Ne;1;4;0;5
12155;Vėjelis;Nykštukai;3843601190;Ne;0;8;0;8
12156;Vėjelis;Nykštukai;3574432129;Ne;3;0;0;3
12157;Vėjelis;Nykštukai;4713754452;Ne;0;1;0;1
12158;Vėjelis;Nykštukai;7889625599;Ne;7;5;0;12
12159;Vėjelis;Nykštukai;7763996061;Ne;0;4;0;4
12160;Vėjelis;Nykštukai;3813509637;Ne;0;0;2;2
12161;Vėjelis;Nykštukai;8755889077;Ne;0;0;3;3
12162;Vėjelis;Nykštukai;2763569936;Ne;0;13;0;13
12163;Vėjelis;Nykštukai;9979979480;Ne;19;0;0;19
12164;Vėjelis;Nykštukai;4063795811;Ne;0;5;2;7
12165;Vėjelis;Nykštukai;8698788528;Ne;3;0;0;3
12166;Vėjelis;BITUTĖS;6824919005;Ne;3;2;1;6
12167;Vėjelis;BITUTĖS;4276237884;Ne;0;8;0;8
12168;Vėjelis;BITUTĖS;3772706363;Ne;0;7;0;7
12169;Vėjelis;BITUTĖS;1834203833;Ne;6;2;2;10
12170;Vėjelis;BITUTĖS;8452132066;Ne;0;21;0;21
12171;Vėjelis;BITUTĖS;6283428333;Ne;9;0;0;9
12172;Vėjelis;BITUTĖS;1112394040;Ne;6;0;0;6
12173;Vėjelis;BITUTĖS;3767625080;Ne;2;2;0;4
12174;Vėjelis;BITUTĖS;6569848405;Ne;5;4;0;9
12175;Vėjelis;BITUTĖS;1457373815;Ne;21;0;0;21
12176;Vėjelis;BITUTĖS;8571757635;Ne;9;4;0;13
12177;Vėjelis;BITUTĖS;1022888418;Ne;2;1;0;3
12178;Vėjelis;BITUTĖS;9625857378;Ne;1;1;0;2
12179;Vėjelis;BITUTĖS;1116238331;Ne;5;1;0;6
12180;Vėjelis;BITUTĖS;8286070405;Ne;0;5;0;5
12181;Vėjelis;BITUTĖS;1674810054;Ne;14;0;0;14
12182;Vėjelis;BITUTĖS;6581265682;Ne;6;2;0;8
12183;Vėjelis;BITUTĖS;4348246825;Ne;4;0;0;4
12184;Vėjelis;BITUTĖS;8273890475;Ne;4;2;1;7
12185;Vėjelis;Boruželės;5325081841;Ne;0;4;0;4
12186;Vėjelis;Boruželės;5381588565;Ne;4;0;0;4
12187;Vėjelis;Boruželės;9037622738;Ne;2;0;0;2
12188;Vėjelis;Boruželės;1588345134;Ne;0;1;10;11
12189;Vėjelis;Boruželės;1429496839;Ne;0;6;0;6
12190;Vėjelis;Boruželės;1931659200;Ne;10;1;0;11
12191;Vėjelis;Boruželės;3844131154;Ne;2;1;1;4
12192;Vėjelis;Boruželės;4747466651;Ne;0;4;0;4
12193;Vėjelis;Boruželės;3473416323;Ne;0;2;0;2
12194;Vėjelis;Boruželės;8141198449;Ne;0;3;0;3
12195;Vėjelis;Boruželės;8121537795;Ne;0;4;0;4
12196;Vėjelis;Boruželės;5517128872;Ne;0;2;0;2
12197;Vėjelis;Boruželės;8938491367;Ne;3;2;0;5
12198;Vėjelis;Boruželės;6108049183;Ne;4;2;0;6
12199;Vėjelis;Boruželės;3276062426;Ne;0;1;1;2
12200;Vėjelis;Boruželės;4132824111;Ne;5;4;0;9
12201;Vėjelis;Boruželės;2000277444;Ne;0;0;2;2
12202;Vėjelis;Boruželės;7752923796;Ne;0;1;4;5
12203;Vėtrungė;Debesėlių;3655025938;Ne;4;0;3;7
12204;Vėtrungė;Debesėlių;2825732654;Ne;5;5;0;10
12205;Vėtrungė;Debesėlių;7863176604;Ne;0;4;0;4
12206;Vėtrungė;Debesėlių;3179715496;Ne;0;4;0;4
12207;Vėtrungė;Debesėlių;6439014588;Ne;6;0;6;12
12208;Vėtrungė;Debesėlių;9423361592;Ne;6;4;0;10
12209;Vėtrungė;Debesėlių;1191007983;Ne;0;6;0;6
12210;Vėtrungė;Debesėlių;3745680607;Ne;5;5;1;11
12211;Vėtrungė;Debesėlių;9359012317;Ne;11;0;3;14
12212;Vėtrungė;Debesėlių;1807742144;Ne;10;4;7;21
12213;Vėtrungė;Debesėlių;9893842192;Ne;5;0;1;6
12214;Vėtrungė;Debesėlių;3433811829;Ne;0;9;1;10
12215;Vėtrungė;Debesėlių;2447851565;Ne;0;6;0;6
12216;Vėtrungė;Debesėlių;2136966687;Ne;0;7;0;7
12217;Vėtrungė;Debesėlių;5545581078;Ne;0;5;0;5
12218;Vėtrungė;Debesėlių;7185104341;Ne;2;10;0;12
12219;Vėtrungė;Debesėlių;6374739740;Ne;0;4;6;10
12220;Vėtrungė;Debesėlių;5939537473;Ne;0;2;0;2
12221;Vėtrungė;Debesėlių;1871358961;Ne;0;0;5;5
12222;Vėtrungė;Zuikių;9332362038;Ne;0;0;4;4
12223;Vėtrungė;Zuikių;9407558097;Ne;0;10;0;10
12224;Vėtrungė;Zuikių;2985829593;Ne;0;0;1;1
12225;Vėtrungė;Zuikių;4121886031;Ne;0;2;0;2
12226;Vėtrungė;Zuikių;7573021445;Ne;0;0;3;3
12227;Vėtrungė;Zuikių;3335047815;Ne;0;5;0;5
12228;Vėtrungė;Zuikių;8157356569;Ne;0;5;0;5
12229;Vėtrungė;Zuikių;9742099165;Ne;0;2;0;2
12230;Vėtrungė;Zuikių;1215953192;Ne;6;1;0;7
12231;Vėtrungė;Zuikių;3908259010;Ne;0;0;1;1
12232;Vėtrungė;Zuikių;1729819557;Ne;9;0;1;10
12233;Vėtrungė;Zuikių;4916692634;Ne;0;0;5;5
12234;Vėtrungė;Zuikių;6416245099;Ne;0;0;1;1
12235;Vėtrungė;Zuikių;1007578933;Ne;6;1;0;7
12236;Vėtrungė;Zuikių;7558548846;Ne;6;1;0;7
12237;Vėtrungė;Zuikių;8742161467;Ne;5;2;1;8
12238;Vėtrungė;Zuikių;2537221101;Ne;12;1;0;13
12239;Vėtrungė;Zuikių;7342250921;Ne;0;7;0;7
12240;Vėtrungė;Zuikių;7435005821;Ne;0;5;5;10
12241;Vėtrungė;Zuikių;1280823326;Ne;9;2;1;12
12242;Vėtrungė;Drugelių;5622109033;Ne;0;1;0;1
12243;Vėtrungė;Drugelių;7943682529;Ne;0;0;2;2
12244;Vėtrungė;Drugelių;9090873546;Ne;6;0;1;7
12245;Vėtrungė;Drugelių;2970067995;Ne;4;0;0;4
12246;Vėtrungė;Drugelių;5251308945;Ne;13;0;0;13
12247;Vėtrungė;Drugelių;9812496068;Ne;0;2;0;2
12248;Vėtrungė;Drugelių;8753387108;Ne;0;0;12;12
12249;Vėtrungė;Drugelių;3634995652;Ne;0;4;0;4
12250;Vėtrungė;Drugelių;2123410772;Ne;0;1;0;1
12251;Vėtrungė;Drugelių;3744377479;Ne;0;0;3;3
12252;Vėtrungė;Drugelių;8905533826;Ne;0;1;0;1
12253;Vėtrungė;Drugelių;7186353024;Ne;1;1;0;2
12254;Vėtrungė;Drugelių;2933312366;Ne;0;12;0;12
12255;Vėtrungė;Drugelių;2508501223;Ne;0;7;0;7
12256;Vėtrungė;Drugelių;6538402680;Ne;0;1;0;1
12257;Vėtrungė;Do-re-mi;6449124019;Ne;0;0;1;1
12258;Vėtrungė;Do-re-mi;9324733839;Ne;4;0;0;4
12259;Vėtrungė;Do-re-mi;2928868412;Ne;0;6;0;6
12260;Vėtrungė;Do-re-mi;2883254822;Ne;0;0;2;2
12261;Vėtrungė;Do-re-mi;9518734260;Ne;6;1;0;7
12262;Vėtrungė;Do-re-mi;7496582551;Ne;0;0;4;4
12263;Vėtrungė;Do-re-mi;5430818470;Ne;0;5;0;5
12264;Vėtrungė;Do-re-mi;5832298824;Ne;0;6;0;6
12265;Vėtrungė;Do-re-mi;7895027909;Ne;0;0;1;1
12266;Vėtrungė;Do-re-mi;7807708310;Ne;0;0;10;10
12267;Vėtrungė;Do-re-mi;3369970611;Ne;0;5;0;5
12268;Vėtrungė;Do-re-mi;1808699695;Ne;0;4;2;6
12269;Vėtrungė;Do-re-mi;9079483362;Ne;3;0;4;7
12270;Vėtrungė;Do-re-mi;9271869305;Ne;0;0;13;13
12271;Vėtrungė;Do-re-mi;4709068324;Ne;5;4;3;12
12272;Vėtrungė;Do-re-mi;5452337780;Ne;9;0;0;9
12273;Vėtrungė;Do-re-mi;8956375453;Ne;2;0;3;5
12274;Vėtrungė;Smalsučių;7803736567;Ne;0;15;0;15
12275;Vėtrungė;Smalsučių;3249689008;Ne;10;6;0;16
12276;Vėtrungė;Smalsučių;7295216791;Ne;0;5;0;5
12277;Vėtrungė;Smalsučių;9795630131;Ne;0;4;0;4
12278;Vėtrungė;Smalsučių;7363490503;Ne;2;4;0;6
12279;Vėtrungė;Smalsučių;16216365941;Ne;0;4;0;4
12280;Vėtrungė;Smalsučių;2471926240;Ne;0;4;0;4
12281;Vėtrungė;Smalsučių;7813907852;Ne;4;4;0;8
12282;Vėtrungė;Smalsučių;2440001662;Ne;0;11;0;11
12283;Vėtrungė;Smalsučių;4000379945;Ne;2;6;0;8
12284;Vėtrungė;Smalsučių;5367369908;Ne;0;5;0;5
12285;Vėtrungė;Smalsučių;4154712272;Ne;0;6;0;6
12286;Vėtrungė;Smalsučių;3278452234;Ne;0;4;0;4
12287;Vėtrungė;Smalsučių;7483624989;Ne;0;6;0;6
12288;Vėtrungė;Smalsučių;4394100006;Ne;0;10;0;10
12289;Vėtrungė;Smalsučių;7730716483;Ne;6;5;0;11
12290;Vėtrungė;Smalsučių;5786557195;Ne;0;0;1;1
12291;Vėtrungė;Gudručių;6732632515;Ne;10;6;1;17
12292;Vėtrungė;Gudručių;8721035192;Ne;0;3;0;3
12293;Vėtrungė;Gudručių;1970034012;Ne;13;1;0;14
12294;Vėtrungė;Gudručių;3404120492;Ne;0;1;0;1
12295;Vėtrungė;Gudručių;7921863675;Ne;0;9;0;9
12296;Vėtrungė;Gudručių;8154023892;Ne;0;4;0;4
12297;Vėtrungė;Gudručių;1522141057;Ne;0;8;0;8
12298;Vėtrungė;Gudručių;9962435598;Ne;11;2;0;13
12299;Vėtrungė;Gudručių;2864217098;Ne;0;2;0;2
12300;Vėtrungė;Gudručių;6964225210;Ne;0;1;0;1
12301;Vėtrungė;Gudručių;2482436192;Ne;0;4;0;4
12302;Vėtrungė;Gudručių;1551989977;Ne;0;5;0;5
12303;Vėtrungė;Gudručių;4091719904;Ne;0;5;0;5
12304;Vėtrungė;Gudručių;5994465833;Ne;0;2;0;2
12305;Vėtrungė;Gudručių;4347810256;Ne;0;2;2;4
12306;Vėtrungė;Gudručių;7704497739;Ne;0;5;0;5
12307;Vėtrungė;Gudručių;8643181832;Ne;0;1;1;2
12308;Vėtrungė;Gudručių;1520846063;Ne;0;6;4;10
12309;Vėtrungė;Kodėlčių;9172488122;Ne;0;4;0;4
12310;Vėtrungė;Kodėlčių;2739382736;Ne;5;6;2;13
12311;Vėtrungė;Kodėlčių;3903604247;Ne;10;0;0;10
12312;Vėtrungė;Kodėlčių;3500551575;Ne;0;3;0;3
12313;Vėtrungė;Kodėlčių;7872043253;Ne;7;0;0;7
12314;Vėtrungė;Kodėlčių;9852609222;Ne;0;4;0;4
12315;Vėtrungė;Kodėlčių;8859592174;Ne;5;0;0;5
12316;Vėtrungė;Kodėlčių;7862615352;Ne;5;6;0;11
12317;Vėtrungė;Kodėlčių;9211406129;Ne;8;2;0;10
12318;Vėtrungė;Kodėlčių;7511121411;Ne;5;1;0;6
12319;Vėtrungė;Kodėlčių;9127735773;Ne;5;0;1;6
12320;Vėtrungė;Kodėlčių;5830221727;Ne;0;2;0;2
12321;Vėtrungė;Kodėlčių;4756863295;Ne;15;3;0;18
12322;Vėtrungė;Kodėlčių;8985054558;Ne;4;4;0;8
12323;Vėtrungė;Kodėlčių;3922749661;Ne;0;2;0;2
12324;Vėtrungė;Kodėlčių;8013249618;Ne;13;0;0;13
12325;Vėtrungė;Kodėlčių;3887230224;Ne;2;4;0;6
12326;Vėtrungė;Kodėlčių;7740260264;Ne;0;1;0;1
12327;Vėtrungė;Kodėlčių;6807838878;Ne;0;1;0;1
12328;Vėtrungė;Kodėlčių;3638303693;Ne;0;2;0;2
12329;Vėtrungė;Paukštelių;6983172988;Ne;12;1;0;13
12330;Vėtrungė;Paukštelių;3957148270;Ne;1;6;0;7
12331;Vėtrungė;Paukštelių;3466149991;Ne;9;0;0;9
12332;Vėtrungė;Paukštelių;7258995031;Ne;0;6;1;7
12333;Vėtrungė;Paukštelių;5338424871;Ne;0;3;4;7
12334;Vėtrungė;Paukštelių;6812588777;Ne;4;5;0;9
12335;Vėtrungė;Paukštelių;2798915063;Ne;5;0;1;6
12336;Vėtrungė;Paukštelių;2981610749;Ne;0;0;11;11
12337;Vėtrungė;Paukštelių;6146327857;Ne;3;0;2;5
12338;Vėtrungė;Paukštelių;8149563485;Ne;10;0;0;10
12339;Vėtrungė;Viščiukų;5021830780;Ne;5;1;1;7
12340;Vėtrungė;Viščiukų;5808423634;Ne;6;2;4;12
12341;Vėtrungė;Viščiukų;6190900822;Ne;0;0;2;2
12342;Vėtrungė;Viščiukų;3834510410;Ne;0;10;3;13
12343;Vėtrungė;Viščiukų;4597361099;Ne;4;0;6;10
12344;Vėtrungė;Viščiukų;2490075899;Ne;0;2;1;3
12345;Vėtrungė;Viščiukų;4712052283;Ne;5;10;1;16
12346;Vėtrungė;Viščiukų;8761701511;Ne;14;0;0;14
12347;Vėtrungė;Viščiukų;3527585648;Ne;6;0;2;8
12348;Vėtrungė;Viščiukų;9684184905;Ne;0;0;16;16
12349;Vėtrungė;Viščiukų;4145172377;Ne;0;0;7;7
12350;Vėtrungė;Viščiukų;1568598938;Ne;0;4;2;6
12351;Vėtrungė;Viščiukų;8577668542;Ne;16;0;0;16
12352;Vėtrungė;Nykštukų;9696984346;Ne;0;9;0;9
12353;Vėtrungė;Nykštukų;7819147751;Ne;5;4;0;9
12354;Vėtrungė;Nykštukų;6990506209;Ne;0;1;0;1
12355;Vėtrungė;Nykštukų;2348557463;Ne;0;0;4;4
12356;Vėtrungė;Nykštukų;2309821873;Ne;8;0;0;8
12357;Vėtrungė;Nykštukų;2364156362;Ne;0;11;0;11
12358;Vėtrungė;Nykštukų;8059553343;Ne;3;4;0;7
12359;Vėtrungė;Nykštukų;4020987532;Ne;0;2;0;2
12360;Vėtrungė;Nykštukų;9569555731;Ne;3;0;0;3
12361;Vėtrungė;Nykštukų;7699392279;Ne;0;13;0;13
12362;Vėtrungė;Nykštukų;9773838651;Ne;0;3;0;3
12363;Vėtrungė;Nykštukų;6866720274;Ne;2;1;0;3
12364;Vėtrungė;Nykštukų;3869546285;Ne;1;0;0;1
12365;Vėtrungė;Nykštukų;6783756347;Ne;0;2;0;2
12366;Vėtrungė;Nykštukų;4289435509;Ne;7;4;0;11
12367;Vėtrungė;Meškiukų;2510763357;Ne;7;1;0;8
12368;Vėtrungė;Meškiukų;4713420194;Ne;7;1;0;8
12369;Vėtrungė;Meškiukų;2226654309;Ne;0;3;0;3
12370;Vėtrungė;Meškiukų;9207846866;Ne;11;0;1;12
12371;Vėtrungė;Meškiukų;9685389270;Ne;0;11;0;11
12372;Vėtrungė;Meškiukų;9313438768;Ne;0;6;0;6
12373;Vėtrungė;Meškiukų;3122948974;Ne;0;7;0;7
12374;Vėtrungė;Meškiukų;2520926439;Ne;0;4;0;4
12375;Vėtrungė;Meškiukų;7143997258;Ne;0;4;0;4
12376;Vėtrungė;Meškiukų;8961791293;Ne;0;10;0;10
12377;Vėtrungė;Meškiukų;2809555356;Ne;0;10;0;10
12378;Vėtrungė;Meškiukų;4624264759;Ne;0;1;0;1
12379;Vėtrungė;Meškiukų;1766599777;Ne;5;7;0;12
12380;Vėtrungė;Meškiukų;9642541034;Ne;5;1;0;6
12381;Vėtrungė;Meškiukų;8958748086;Ne;0;5;0;5
12382;Vėtrungė;Meškiukų;1480035015;Ne;2;0;0;2
12383;Vėtrungė;Ąžuoliukų;8775969909;Ne;0;6;5;11
12384;Vėtrungė;Ąžuoliukų;1034537691;Ne;5;0;2;7
12385;Vėtrungė;Ąžuoliukų;6363761237;Ne;0;2;3;5
12386;Vėtrungė;Ąžuoliukų;3073965379;Ne;6;5;0;11
12387;Vėtrungė;Ąžuoliukų;3938684888;Ne;5;0;0;5
12388;Vėtrungė;Ąžuoliukų;2977116563;Ne;10;0;0;10
12389;Vėtrungė;Ąžuoliukų;4925843510;Ne;10;0;0;10
12390;Vėtrungė;Ąžuoliukų;8867794275;Ne;2;0;0;2
12391;Vėtrungė;Ąžuoliukų;7096106273;Ne;10;0;11;21
12392;Vėtrungė;Ąžuoliukų;8026065367;Ne;0;1;1;2
12393;Vėtrungė;Ąžuoliukų;6476717645;Ne;11;0;0;11
12394;Vėtrungė;Ąžuoliukų;5167580818;Ne;21;0;0;21
12395;Vėtrungė;Ąžuoliukų;1169648551;Ne;0;0;2;2
12396;Vilnelė;Lakštutė;8843094480;Ne;5;1;0;6
12397;Vilnelė;Lakštutė;6249731759;Ne;0;16;0;16
12398;Vilnelė;Lakštutė;5554451335;Ne;0;3;0;3
12399;Vilnelė;Lakštutė;1762024490;Ne;14;0;1;15
12400;Vilnelė;Lakštutė;8201829887;Ne;0;11;0;11
12401;Vilnelė;Lakštutė;7702217893;Ne;0;0;1;1
12402;Vilnelė;Lakštutė;4427383755;Ne;5;8;0;13
12403;Vilnelė;Lakštutė;1547117566;Ne;5;8;0;13
12404;Vilnelė;Lakštutė;3231387543;Ne;0;1;1;2
12405;Vilnelė;Lakštutė;1734277231;Ne;0;11;0;11
12406;Vilnelė;Lakštutė;8837662451;Ne;0;18;0;18
12407;Vilnelė;Lakštutė;3900484348;Ne;0;2;3;5
12408;Vilnelė;Lakštutė;5498574366;Ne;0;12;0;12
12409;Vilnelė;Lakštutė;6686896190;Ne;9;6;2;17
12410;Vilnelė;Lakštutė;3032273912;Ne;0;1;0;1
12411;Vilnelė;Lakštutė;4017436910;Ne;0;4;1;5
12412;Vilnelė;Lakštutė;6156838553;Ne;0;4;2;6
12413;Vilnelė;Lakštutė;9843449060;Ne;0;2;6;8
12414;Vilnelė;Lakštutė;2803880424;Ne;0;2;0;2
12415;Vilnelė;Lakštutė;5913967803;Ne;0;0;1;1
12416;Vilnelė;Vyturėlis;5091272908;Ne;0;2;0;2
12417;Vilnelė;Vyturėlis;1133945467;Ne;0;4;0;4
12418;Vilnelė;Vyturėlis;3009064105;Ne;0;5;0;5
12419;Vilnelė;Vyturėlis;3743740372;Ne;0;4;0;4
12420;Vilnelė;Vyturėlis;2131599015;Ne;7;4;0;11
12421;Vilnelė;Vyturėlis;18740103706;Ne;0;11;0;11
12422;Vilnelė;Vyturėlis;7057183482;Ne;2;4;1;7
12423;Vilnelė;Vyturėlis;8725191514;Ne;0;1;0;1
12424;Vilnelė;Vyturėlis;6308015852;Ne;0;8;0;8
12425;Vilnelė;Vyturėlis;1545570307;Ne;7;0;1;8
12426;Vilnelė;Vyturėlis;5540359276;Ne;2;1;0;3
12427;Vilnelė;Vyturėlis;1966090625;Ne;4;4;0;8
12428;Vilnelė;Vyturėlis;8740717061;Ne;2;5;0;7
12429;Vilnelė;Vyturėlis;3772263873;Ne;0;6;0;6
12430;Vilnelė;Vyturėlis;2159103903;Ne;0;1;0;1
12431;Vilnelė;Vyturėlis;9183391434;Ne;0;8;0;8
12432;Vilnelė;Vyturėlis;9369955153;Ne;0;1;0;1
12433;Vilnelė;Vyturėlis;5558584030;Ne;0;2;0;2
12434;Vilnelė;Vyturėlis;1151879281;Ne;0;2;4;6
12435;Vilnelė;Vyturėlis;8820091584;Ne;0;0;2;2
12436;Vilnelė;Vyturėlis;8270866998;Ne;0;16;3;19
12437;Vilnelė;Vyturėlis;28447690974;Ne;0;4;0;4
12438;Vilnelė;Vyturėlis;1462397783;Ne;3;4;0;7
12439;Vilnelė;Pagrandukas;5508759323;Ne;0;1;2;3
12440;Vilnelė;Pagrandukas;2144925171;Ne;7;1;0;8
12441;Vilnelė;Pagrandukas;4295816753;Ne;0;7;0;7
12442;Vilnelė;Pagrandukas;3844066232;Ne;0;15;0;15
12443;Vilnelė;Pagrandukas;6659537454;Ne;0;7;0;7
12444;Vilnelė;Pagrandukas;5953205533;Ne;0;17;0;17
12445;Vilnelė;Pagrandukas;4448413194;Ne;0;1;9;10
12446;Vilnelė;Pagrandukas;6830433856;Ne;0;1;5;6
12447;Vilnelė;Pagrandukas;4664946923;Ne;6;0;0;6
12448;Vilnelė;Pagrandukas;6982847450;Ne;0;6;1;7
12449;Vilnelė;Pagrandukas;7560124407;Ne;0;0;11;11
12450;Vilnelė;Pagrandukas;3685294539;Ne;6;3;0;9
12451;Vilnelė;Pagrandukas;4931943297;Ne;0;4;0;4
12452;Vilnelė;Pagrandukas;7882756938;Ne;0;6;0;6
12453;Vilnelė;Pagrandukas;7348404699;Ne;0;3;0;3
12454;Vilnelė;Pagrandukas;3323738649;Ne;6;0;0;6
12455;Vilnelė;Pagrandukas;8116613831;Ne;0;4;0;4
12456;Vilnelė;Pagrandukas;9489760844;Ne;0;4;0;4
12457;Vilnelė;Pagrandukas;6466321228;Ne;0;3;0;3
12458;Vilnelė;Pagrandukas;4478847902;Ne;0;13;0;13
12459;Vilnelė;Pagrandukas;9635159885;Ne;0;1;5;6
12460;Vilnelė;Pagrandukas;6448119003;Ne;0;2;0;2
12461;Vilnelė;Bitutė;1720695615;Ne;0;3;0;3
12462;Vilnelė;Bitutė;7387394504;Ne;0;9;0;9
12463;Vilnelė;Bitutė;8593060923;Ne;0;1;0;1
12464;Vilnelė;Bitutė;1882520335;Ne;0;2;0;2
12465;Vilnelė;Bitutė;85074719873;Ne;0;1;0;1
12466;Vilnelė;Bitutė;2990112955;Ne;0;4;0;4
12467;Vilnelė;Bitutė;6318246517;Ne;9;10;0;19
12468;Vilnelė;Bitutė;1281521052;Ne;0;1;0;1
12469;Vilnelė;Bitutė;9058632601;Ne;0;1;0;1
12470;Vilnelė;Bitutė;8615257084;Ne;0;0;2;2
12471;Vilnelė;Bitutė;98028664140;Ne;0;4;0;4
12472;Vilnelė;Bitutė;1507865281;Ne;0;1;0;1
12473;Vilnelė;Bitutė;2130482375;Ne;0;3;0;3
12474;Vilnelė;Bitutė;7292043157;Ne;0;7;0;7
12475;Vilnelė;Bitutė;4480175299;Ne;0;3;0;3
12476;Vilnelė;Bitutė;39494954188;Ne;0;15;0;15
12477;Vilnelė;Bitutė;6327531229;Ne;0;2;0;2
12478;Vilnelė;Bitutė;42835212158;Ne;0;5;0;5
12479;Vilnelė;Bitutė;6146514112;Ne;0;11;0;11
12480;Vilnelė;Bitutė;5013418313;Ne;0;2;0;2
12481;Vilnelė;Bitutė;5932200003;Ne;0;0;1;1
12482;Vilnelė;Bitutė;1783854203;Ne;0;1;0;1
12483;Vilnelė;Bitutė;9016832316;Ne;0;0;1;1
12484;Vilnelė;Šaltinėlis;7752502124;Ne;17;0;0;17
12485;Vilnelė;Šaltinėlis;3064118212;Ne;11;0;0;11
12486;Vilnelė;Šaltinėlis;5813090771;Ne;2;0;0;2
12487;Vilnelė;Šaltinėlis;9317041585;Ne;15;0;0;15
12488;Vilnelė;Šaltinėlis;4670933970;Ne;0;0;2;2
12489;Vilnelė;Šaltinėlis;4817502971;Ne;11;0;0;11
12490;Vilnelė;Šaltinėlis;3712463891;Ne;0;3;0;3
12491;Vilnelė;Šaltinėlis;2343750614;Ne;0;0;1;1
12492;Vilnelė;Šaltinėlis;2700153185;Ne;0;0;3;3
12493;Vilnelė;Šaltinėlis;7698638698;Ne;0;0;1;1
12494;Vilnelė;Šaltinėlis;7231998656;Ne;21;0;0;21
12495;Vilnelė;Šaltinėlis;2683662906;Ne;6;0;0;6
12496;Vilnelė;Šaltinėlis;3142594542;Taip;0;1;0;1
12497;Vilnelė;Šaltinėlis;5487729159;Ne;0;0;3;3
12498;Vilnelė;Šaltinėlis;1108529953;Ne;5;0;0;5
12499;Vilnelė;Riešutėllis;1027463000;Ne;3;1;0;4
12500;Vilnelė;Riešutėllis;7020707723;Ne;8;2;0;10
12501;Vilnelė;Riešutėllis;1960860528;Ne;0;0;1;1
12502;Vilnelė;Riešutėllis;4203549404;Ne;4;0;3;7
12503;Vilnelė;Riešutėllis;3290952017;Ne;5;0;0;5
12504;Vilnelė;Riešutėllis;8588430578;Ne;0;8;0;8
12505;Vilnelė;Riešutėllis;7957695470;Ne;5;0;2;7
12506;Vilnelė;Riešutėllis;4780827432;Ne;8;4;0;12
12507;Vilnelė;Riešutėllis;4455099179;Ne;3;3;0;6
12508;Vilnelė;Riešutėllis;2367127222;Ne;8;2;0;10
12509;Vilnelė;Riešutėllis;5306723959;Ne;0;5;0;5
12510;Vilnelė;Riešutėllis;3670613082;Ne;0;6;4;10
12511;Vilnelė;Riešutėllis;6417545510;Ne;5;1;0;6
12512;Vilnelė;Riešutėllis;3211657057;Ne;0;4;1;5
12513;Vilnelė;Riešutėllis;9016866597;Ne;13;5;0;18
12514;Vilnelė;Riešutėllis;7087798406;Ne;2;1;0;3
12515;Vilnelė;Riešutėllis;4254744025;Ne;0;14;0;14
12516;Vilnelė;Riešutėllis;3730997665;Ne;5;2;0;7
12517;Vilnelė;Riešutėllis;2706699572;Ne;0;4;0;4
12518;Vilnelė;Riešutėllis;8774842903;Ne;0;0;3;3
12519;Vilnelė;Riešutėllis;3031790547;Ne;1;0;0;1
12520;Vilnelė;Nykštukas;4210511566;Ne;14;0;0;14
12521;Vilnelė;Nykštukas;2891787022;Ne;0;6;0;6
12522;Vilnelė;Nykštukas;4734511521;Ne;6;4;0;10
12523;Vilnelė;Nykštukas;6344134620;Ne;0;2;0;2
12524;Vilnelė;Nykštukas;4295630317;Ne;0;32;0;32
12525;Vilnelė;Nykštukas;1554473199;Ne;8;1;0;9
12526;Vilnelė;Nykštukas;1819154122;Ne;6;1;0;7
12527;Vilnelė;Nykštukas;4060927733;Ne;25;0;0;25
12528;Vilnelė;Nykštukas;2299381653;Ne;0;17;0;17
12529;Vilnelė;Nykštukas;5041031750;Ne;7;2;2;11
12530;Vilnelė;Nykštukas;2157793186;Ne;9;0;1;10
12531;Vilnelė;Nykštukas;4516818999;Ne;13;10;0;23
12532;Vilnelė;Nykštukas;8579294202;Ne;0;17;0;17
12533;Vilnelė;Nykštukas;7161529969;Ne;9;1;0;10
12534;Vilnelė;Nykštukas;3720979747;Ne;4;2;0;6
12535;Vilnelė;Nykštukas;6048991617;Ne;2;0;0;2
12536;Vilnelė;Nykštukas;6054488692;Ne;8;5;0;13
12537;Vilnelė;Nykštukas;8630048961;Ne;10;11;0;21
12538;Vilnelė;Nykštukas;7592040226;Ne;16;6;0;22
12539;Vilnelė;Nykštukas;1515873552;Ne;10;0;0;10
12540;Vilnelė;Nykštukas;5629086127;Ne;12;0;0;12
12541;Vilnelė;Pieštukas;9879688569;Ne;4;2;0;6
12542;Vilnelė;Pieštukas;5473379559;Ne;5;6;0;11
12543;Vilnelė;Pieštukas;3781595939;Ne;0;8;0;8
12544;Vilnelė;Pieštukas;9884955712;Ne;2;6;0;8
12545;Vilnelė;Pieštukas;2479090686;Ne;0;12;0;12
12546;Vilnelė;Pieštukas;3945921490;Ne;0;16;0;16
12547;Vilnelė;Pieštukas;1975954784;Ne;0;2;0;2
12548;Vilnelė;Pieštukas;7199490431;Ne;0;4;0;4
12549;Vilnelė;Pieštukas;1730149127;Ne;5;6;0;11
12550;Vilnelė;Pieštukas;5778176840;Ne;0;1;0;1
12551;Vilnelė;Pieštukas;6355912551;Ne;0;12;0;12
12552;Vilnelė;Pieštukas;7976798775;Ne;0;5;0;5
12553;Vilnelė;Pieštukas;3811289758;Ne;0;9;0;9
12554;Vilnelė;Pieštukas;3529718234;Ne;0;4;0;4
12555;Vilnelė;Pieštukas;1880318663;Ne;0;5;0;5
12556;Vilnelė;Pieštukas;9589410276;Ne;0;5;0;5
12557;Vilnelė;Pieštukas;4718994967;Ne;0;12;0;12
12558;Vilnelė;Pieštukas;3856917286;Ne;0;12;0;12
12559;Vilnelė;Pieštukas;6132739519;Ne;0;12;0;12
12560;Vilnelė;Pieštukas;8162191913;Ne;0;2;0;2
12561;Vilnelė;Pieštukas;3791258264;Ne;9;0;0;9
12562;Vilnelė;Voverytė;7536603663;Ne;0;5;3;8
12563;Vilnelė;Voverytė;3503461211;Ne;0;1;0;1
12564;Vilnelė;Voverytė;7388336851;Ne;0;6;0;6
12565;Vilnelė;Voverytė;8667403338;Ne;13;1;0;14
12566;Vilnelė;Voverytė;7883724600;Ne;0;8;0;8
12567;Vilnelė;Voverytė;1351798589;Ne;0;4;0;4
12568;Vilnelė;Voverytė;9162681538;Ne;0;2;0;2
12569;Vilnelė;Voverytė;3075681823;Ne;0;2;0;2
12570;Vilnelė;Voverytė;6342242777;Ne;0;2;0;2
12571;Vilnelė;Voverytė;3843064564;Ne;0;7;1;8
12572;Vilnelė;Voverytė;2923012145;Ne;0;1;2;3
12573;Vilnelė;Voverytė;2841315531;Ne;0;0;2;2
12574;Vilnelė;Voverytė;9804772168;Ne;0;0;2;2
12575;Vilnelė;Voverytė;1596625263;Ne;7;10;0;17
12576;Vilnelė;Voverytė;7338573817;Ne;0;0;2;2
12577;Vilnelė;Voverytė;8121075430;Ne;0;3;0;3
12578;Vilnelė;Voverytė;1574809879;Ne;0;3;0;3
12579;Vilnelė;Voverytė;6083082959;Ne;0;5;0;5
12580;Vilnelė;Voverytė;2788449626;Ne;0;1;0;1
12581;Vilnelė;Kodėlčiukas;4642378600;Ne;9;0;0;9
12582;Vilnelė;Kodėlčiukas;6618109352;Ne;0;12;0;12
12583;Vilnelė;Kodėlčiukas;6715997340;Ne;4;1;0;5
12584;Vilnelė;Kodėlčiukas;9482133396;Ne;9;0;0;9
12585;Vilnelė;Kodėlčiukas;8439505238;Ne;0;2;0;2
12586;Vilnelė;Kodėlčiukas;1580287517;Ne;0;3;0;3
12587;Vilnelė;Kodėlčiukas;5558378376;Ne;0;2;0;2
12588;Vilnelė;Kodėlčiukas;4328263940;Ne;0;12;0;12
12589;Vilnelė;Kodėlčiukas;3056845279;Ne;0;9;0;9
12590;Vilnelė;Kodėlčiukas;9537740492;Ne;5;0;1;6
12591;Vilnelė;Kodėlčiukas;9640330864;Ne;4;3;1;8
12592;Vilnelė;Kodėlčiukas;3848720970;Ne;0;0;4;4
12593;Vilnelė;Kodėlčiukas;7833531435;Ne;0;6;0;6
12594;Vilnelė;Kodėlčiukas;5961910077;Ne;9;0;0;9
12595;Vilnelė;Kodėlčiukas;3115242919;Ne;14;2;0;16
12596;Vilnelė;Kodėlčiukas;8543995029;Ne;7;7;0;14
12597;Vilnelė;Kodėlčiukas;5398303580;Ne;10;0;0;10
12598;Vilnelė;Kodėlčiukas;5180951251;Ne;5;2;5;12
12599;Vilnelė;Žirniukas;5612501291;Ne;0;0;8;8
12600;Vilnelė;Žirniukas;2576381995;Ne;4;8;0;12
12601;Vilnelė;Žirniukas;3654833067;Ne;9;2;2;13
12602;Vilnelė;Žirniukas;4322462166;Ne;9;2;2;13
12603;Vilnelė;Žirniukas;9817054571;Ne;0;1;0;1
12604;Vilnelė;Žirniukas;9316933315;Ne;0;1;0;1
12605;Vilnelė;Žirniukas;1598555488;Ne;6;0;0;6
12606;Vilnelė;Žirniukas;5960725916;Ne;0;3;0;3
12607;Vilnelė;Žirniukas;8329253118;Ne;0;0;21;21
12608;Vilnelė;Žirniukas;9476510950;Ne;1;1;7;9
12609;Vilnelė;Žirniukas;3234028667;Ne;9;3;0;12
12610;Vilnelė;Žirniukas;7870509810;Ne;9;0;0;9
12611;Vilnelė;Žirniukas;6569980514;Ne;11;3;0;14
12612;Vilnelė;Žirniukas;6634526716;Ne;10;5;0;15
12613;Vilnelė;Žirniukas;8848138564;Ne;0;10;0;10
12614;Vilnelė;Žirniukas;5649725693;Ne;0;5;4;9
12615;Vilnelė;Žirniukas;7568755715;Ne;0;2;11;13
12616;Vilnelė;Žirniukas;1371066506;Ne;0;4;0;4
12617;Vilnelė;Žirniukas;4758117005;Ne;7;0;1;8
12618;Vilnelė;Pipiras;1414168531;Ne;0;6;1;7
12619;Vilnelė;Pipiras;2918624119;Ne;7;0;0;7
12620;Vilnelė;Pipiras;3432602015;Ne;5;0;0;5
12621;Vilnelė;Pipiras;9660305163;Ne;0;6;0;6
12622;Vilnelė;Pipiras;2964672357;Ne;16;0;0;16
12623;Vilnelė;Pipiras;1566734465;Ne;4;0;0;4
12624;Vilnelė;Pipiras;9882766915;Ne;7;9;0;16
12625;Vilnelė;Pipiras;9016135318;Ne;12;1;0;13
12626;Vilnelė;Pipiras;8015908754;Ne;5;12;0;17
12627;Vilnelė;Pipiras;7968029402;Ne;0;1;0;1
12628;Vilnelė;Pipiras;7221712624;Ne;0;2;0;2
12629;Vilnelė;Pipiras;9950598582;Ne;0;0;11;11
12630;Vilnelė;Pipiras;5444967820;Ne;0;2;3;5
12631;Vilnelė;Pipiras;3828623778;Ne;7;0;0;7
12632;Vilnelė;Pipiras;5273665901;Ne;3;0;0;3
12633;Vilnelė;Pipiras;5173602064;Taip;0;2;0;2
12634;Vėrinėlis;GAIDELIAI;7069247393;Ne;0;0;2;2
12635;Vėrinėlis;GAIDELIAI;6162461750;Ne;3;0;5;8
12636;Vėrinėlis;GAIDELIAI;3500287869;Ne;26;0;0;26
12637;Vėrinėlis;GAIDELIAI;9370715798;Ne;0;10;0;10
12638;Vėrinėlis;GAIDELIAI;6500266853;Ne;22;0;2;24
12639;Vėrinėlis;GAIDELIAI;5891690000;Ne;18;0;2;20
12640;Vėrinėlis;GAIDELIAI;4401001009;Ne;7;7;0;14
12641;Vėrinėlis;GAIDELIAI;1685329004;Ne;1;0;0;1
12642;Vėrinėlis;GAIDELIAI;4498096701;Ne;4;3;1;8
12643;Vėrinėlis;GAIDELIAI;6055921178;Ne;0;14;0;14
12644;Vėrinėlis;GAIDELIAI;9144004655;Ne;6;0;2;8
12645;Vėrinėlis;GAIDELIAI;8272531606;Ne;12;0;0;12
12646;Vėrinėlis;GAIDELIAI;2114637828;Ne;10;1;2;13
12647;Vėrinėlis;GAIDELIAI;6159725406;Ne;0;0;4;4
12648;Vėrinėlis;GAIDELIAI;1844862699;Ne;0;0;1;1
12649;Vėrinėlis;GAIDELIAI;7455948332;Ne;10;1;0;11
12650;Vėrinėlis;GAIDELIAI;4965735537;Ne;8;0;0;8
12651;Vėrinėlis;SAULUTĖ;7224418233;Ne;5;0;0;5
12652;Vėrinėlis;SAULUTĖ;9612956692;Ne;6;2;0;8
12653;Vėrinėlis;SAULUTĖ;8238013636;Ne;4;0;0;4
12654;Vėrinėlis;SAULUTĖ;2337883071;Ne;0;0;5;5
12655;Vėrinėlis;SAULUTĖ;3882915774;Ne;10;2;0;12
12656;Vėrinėlis;SAULUTĖ;7440020169;Ne;7;3;0;10
12657;Vėrinėlis;SAULUTĖ;7913975075;Ne;0;4;0;4
12658;Vėrinėlis;SAULUTĖ;9967737864;Ne;17;0;0;17
12659;Vėrinėlis;SAULUTĖ;7364698713;Ne;0;0;3;3
12660;Vėrinėlis;SAULUTĖ;9009344779;Ne;0;7;0;7
12661;Vėrinėlis;SAULUTĖ;4059906525;Ne;0;4;1;5
12662;Vėrinėlis;SAULUTĖ;3832662507;Ne;7;1;0;8
12663;Vėrinėlis;SAULUTĖ;3291922401;Ne;0;2;0;2
12664;Vėrinėlis;SAULUTĖ;1007705906;Ne;2;7;0;9
12665;Vėrinėlis;SAULUTĖ;9289003583;Ne;0;2;0;2
12666;Vėrinėlis;SAULUTĖ;1684203955;Ne;0;2;0;2
12667;Vėrinėlis;SAULUTĖ;5942475043;Ne;8;3;0;11
12668;Vėrinėlis;SAULUTĖ;9310629340;Ne;0;0;2;2
12669;Vėrinėlis;SAULUTĖ;2369434537;Ne;0;4;1;5
12670;Vėrinėlis;NYKŠTUKAI;1865151493;Ne;0;0;1;1
12671;Vėrinėlis;NYKŠTUKAI;8755231814;Ne;0;1;1;2
12672;Vėrinėlis;NYKŠTUKAI;9604483237;Ne;0;0;6;6
12673;Vėrinėlis;NYKŠTUKAI;6220653152;Ne;0;5;0;5
12674;Vėrinėlis;NYKŠTUKAI;6644892686;Ne;6;2;0;8
12675;Vėrinėlis;NYKŠTUKAI;7981261038;Ne;4;2;0;6
12676;Vėrinėlis;NYKŠTUKAI;1395590011;Ne;10;2;0;12
12677;Vėrinėlis;NYKŠTUKAI;19865450007;Ne;7;2;0;9
12678;Vėrinėlis;NYKŠTUKAI;3975934329;Ne;0;3;3;6
12679;Vėrinėlis;NYKŠTUKAI;5511584499;Ne;10;1;0;11
12680;Vėrinėlis;NYKŠTUKAI;4958359640;Ne;5;0;0;5
12681;Vėrinėlis;NYKŠTUKAI;3562371502;Ne;8;1;1;10
12682;Vėrinėlis;NYKŠTUKAI;9751037428;Ne;0;2;0;2
12683;Vėrinėlis;NYKŠTUKAI;4089567420;Ne;0;3;0;3
12684;Vėrinėlis;NYKŠTUKAI;8579819581;Ne;0;6;0;6
12685;Vėrinėlis;NYKŠTUKAI;5209398043;Ne;2;2;0;4
12686;Vėrinėlis;NYKŠTUKAI;3074835599;Ne;9;1;0;10
12687;Vėrinėlis;NYKŠTUKAI;6779005350;Ne;0;0;3;3
12688;Vėrinėlis;NYKŠTUKAI;8824435889;Ne;8;1;2;11
12689;Vėrinėlis;BURATINAS;7093959212;Ne;3;4;0;7
12690;Vėrinėlis;BURATINAS;7078114492;Ne;0;1;0;1
12691;Vėrinėlis;BURATINAS;6280508974;Ne;0;2;0;2
12692;Vėrinėlis;BURATINAS;4666918175;Ne;0;0;6;6
12693;Vėrinėlis;BURATINAS;2774618380;Ne;0;5;0;5
12694;Vėrinėlis;BURATINAS;2857591912;Ne;0;3;0;3
12695;Vėrinėlis;BURATINAS;5429955166;Ne;0;5;0;5
12696;Vėrinėlis;BURATINAS;5429372946;Ne;8;1;0;9
12697;Vėrinėlis;BURATINAS;4183077476;Ne;5;10;0;15
12698;Vėrinėlis;BURATINAS;2529641529;Ne;2;5;0;7
12699;Vėrinėlis;BURATINAS;2467700639;Ne;15;2;0;17
12700;Vėrinėlis;BURATINAS;6136232912;Ne;9;1;0;10
12701;Vėrinėlis;BURATINAS;7092421890;Ne;0;1;0;1
12702;Vėrinėlis;BURATINAS;6058712578;Ne;5;6;0;11
12703;Vėrinėlis;BURATINAS;1164396960;Ne;0;1;0;1
12704;Vėrinėlis;BURATINAS;6413701823;Ne;0;2;0;2
12705;Vėrinėlis;BURATINAS;2364117224;Ne;0;5;0;5
12706;Vėrinėlis;BURATINAS;5206206080;Ne;0;18;0;18
12707;Vėrinėlis;BURATINAS;3947650381;Ne;0;7;0;7
12708;Vėrinėlis;GINTARĖLIAI;5987029334;Taip;0;0;8;8
12709;Vėrinėlis;GINTARĖLIAI;8372084728;Ne;6;6;0;12
12710;Vėrinėlis;GINTARĖLIAI;6054398276;Ne;1;1;0;2
12711;Vėrinėlis;GINTARĖLIAI;7432965615;Ne;13;2;0;15
12712;Vėrinėlis;GINTARĖLIAI;3457199716;Ne;8;2;0;10
12713;Vėrinėlis;GINTARĖLIAI;7743951577;Ne;3;1;3;7
12714;Vėrinėlis;GINTARĖLIAI;2006432327;Ne;0;3;0;3
12715;Vėrinėlis;GINTARĖLIAI;6785519869;Taip;13;0;2;15
12716;Vėrinėlis;GINTARĖLIAI;3363388500;Ne;15;4;0;19
12717;Vėrinėlis;GINTARĖLIAI;1872534206;Ne;0;3;0;3
12718;Vėrinėlis;GINTARĖLIAI;8545392429;Ne;3;0;0;3
12719;Vėrinėlis;GINTARĖLIAI;9171173116;Ne;0;2;0;2
12720;Vėrinėlis;GINTARĖLIAI;3192625484;Ne;11;0;0;11
12721;Vėrinėlis;GINTARĖLIAI;8343196405;Ne;5;2;2;9
12722;Vėrinėlis;GINTARĖLIAI;2284527544;Ne;9;0;0;9
12723;Vėrinėlis;GINTARĖLIAI;5644772729;Ne;0;2;3;5
12724;Vėrinėlis;GINTARĖLIAI;4034106321;Ne;7;0;0;7
12725;Vėrinėlis;RAMUNĖLĖS;4415030161;Ne;0;1;0;1
12726;Vėrinėlis;RAMUNĖLĖS;8620836106;Ne;2;2;1;5
12727;Vėrinėlis;RAMUNĖLĖS;5003344894;Ne;0;1;1;2
12728;Vėrinėlis;RAMUNĖLĖS;8922728881;Ne;0;2;0;2
12729;Vėrinėlis;RAMUNĖLĖS;5434506594;Ne;2;5;0;7
12730;Vėrinėlis;RAMUNĖLĖS;5041189990;Ne;0;1;0;1
12731;Vėrinėlis;RAMUNĖLĖS;1047139776;Ne;0;4;0;4
12732;Vėrinėlis;RAMUNĖLĖS;3130841241;Ne;9;5;0;14
12733;Vėrinėlis;RAMUNĖLĖS;9798993200;Ne;0;3;0;3
12734;Vėrinėlis;RAMUNĖLĖS;6866592245;Ne;0;4;0;4
12735;Vėrinėlis;RAMUNĖLĖS;4728119881;Ne;0;4;0;4
12736;Vėrinėlis;RAMUNĖLĖS;3316897176;Ne;10;6;0;16
12737;Vėrinėlis;RAMUNĖLĖS;1386916991;Ne;0;7;0;7
12738;Vėrinėlis;RAMUNĖLĖS;2090334618;Ne;0;10;0;10
12739;Vėrinėlis;RAMUNĖLĖS;3810261864;Ne;0;3;0;3
12740;Vėrinėlis;RAMUNĖLĖS;4191386053;Ne;0;1;0;1
12741;Vėrinėlis;KODELČIUKŲ;7070058961;Ne;0;7;0;7
12742;Vėrinėlis;KODELČIUKŲ;3308843618;Ne;0;3;0;3
12743;Vėrinėlis;KODELČIUKŲ;1535567719;Ne;0;8;0;8
12744;Vėrinėlis;KODELČIUKŲ;8755941866;Ne;0;5;0;5
12745;Vėrinėlis;KODELČIUKŲ;8709714647;Ne;0;0;6;6
12746;Vėrinėlis;KODELČIUKŲ;6108187043;Ne;0;2;0;2
12747;Vėrinėlis;KODELČIUKŲ;9119967823;Ne;5;0;0;5
12748;Vėrinėlis;KODELČIUKŲ;4067153819;Ne;0;4;1;5
12749;Vėrinėlis;KODELČIUKŲ;5712568063;Ne;0;4;0;4
12750;Vėrinėlis;KODELČIUKŲ;1467899937;Ne;0;1;0;1
12751;Vėrinėlis;KODELČIUKŲ;8885866108;Ne;0;1;3;4
12752;Vėrinėlis;KODELČIUKŲ;3049346950;Ne;9;4;4;17
12753;Vėrinėlis;KODELČIUKŲ;8652292752;Ne;0;0;1;1
12754;Vėrinėlis;KODELČIUKŲ;4039903678;Ne;0;4;1;5
12755;Vėrinėlis;KODELČIUKŲ;3729926575;Ne;16;0;3;19
12756;Vėrinėlis;KODELČIUKŲ;7167034587;Ne;0;5;0;5
12757;Vėrinėlis;KODELČIUKŲ;9511678036;Ne;0;0;1;1
12758;Vėrinėlis;KODELČIUKŲ;3369668445;Ne;0;6;0;6
12759;Vėrinėlis;KODELČIUKŲ;8728166391;Ne;0;1;0;1
12760;Vėrinėlis;KODELČIUKŲ;5720076968;Ne;6;4;2;12
12761;Vėrinėlis;ŽIRNIUKAI;1769852084;Ne;6;2;1;9
12762;Vėrinėlis;ŽIRNIUKAI;4718732261;Ne;0;3;0;3
12763;Vėrinėlis;ŽIRNIUKAI;4981127515;Ne;0;4;2;6
12764;Vėrinėlis;ŽIRNIUKAI;8329989952;Ne;6;0;2;8
12765;Vėrinėlis;ŽIRNIUKAI;3202518504;Ne;0;4;1;5
12766;Vėrinėlis;ŽIRNIUKAI;4752902173;Ne;5;2;0;7
12767;Vėrinėlis;ŽIRNIUKAI;7237945125;Ne;0;2;0;2
12768;Vėrinėlis;ŽIRNIUKAI;5600815908;Ne;8;0;3;11
12769;Vėrinėlis;ŽIRNIUKAI;7367485961;Ne;0;0;1;1
12770;Vėrinėlis;ŽIRNIUKAI;2633143128;Ne;0;0;13;13
12771;Vėrinėlis;ŽIRNIUKAI;9419245081;Ne;0;5;1;6
12772;Vėrinėlis;ŽIRNIUKAI;7817387800;Ne;13;0;0;13
12773;Vėrinėlis;ŽIRNIUKAI;6377447141;Ne;14;0;1;15
12774;Vėrinėlis;ŽIRNIUKAI;7371908331;Ne;8;2;1;11
12775;Vėrinėlis;ŽIRNIUKAI;2087129236;Ne;0;4;0;4
12776;Vėrinėlis;ŽIRNIUKAI;6392625405;Ne;0;5;0;5
12777;Vėrinėlis;ŽIRNIUKAI;1896980533;Ne;7;0;1;8
12778;Vėrinėlis;ŽIRNIUKAI;2732572235;Ne;5;3;1;9
12779;Vėrinėlis;ŽIRNIUKAI;8483525051;Ne;0;0;3;3
12780;Vėrinėlis;VARPELIAI;7416041207;Ne;0;3;0;3
12781;Vėrinėlis;VARPELIAI;8655158155;Ne;0;9;0;9
12782;Vėrinėlis;VARPELIAI;3829146401;Ne;4;0;0;4
12783;Vėrinėlis;VARPELIAI;6177784856;Ne;0;1;0;1
12784;Vėrinėlis;VARPELIAI;9388153932;Ne;8;0;7;15
12785;Vėrinėlis;VARPELIAI;6362125404;Ne;0;6;0;6
12786;Vėrinėlis;VARPELIAI;9599724421;Ne;0;4;0;4
12787;Vėrinėlis;VARPELIAI;7216867683;Ne;5;3;0;8
12788;Vėrinėlis;VARPELIAI;8336694468;Ne;0;3;0;3
12789;Vėrinėlis;VARPELIAI;2731207996;Ne;6;0;1;7
12790;Vėrinėlis;VARPELIAI;9522506115;Ne;0;9;0;9
12791;Vėrinėlis;VARPELIAI;2561255096;Ne;6;0;7;13
12792;Vėrinėlis;VARPELIAI;5821107898;Ne;18;0;0;18
12793;Vėrinėlis;VARPELIAI;9351658311;Ne;0;13;0;13
12794;Vėrinėlis;VARPELIAI;3392458614;Ne;0;2;2;4
12795;Vėrinėlis;BORUŽĖLĖS;8759487574;Ne;10;2;0;12
12796;Vėrinėlis;BORUŽĖLĖS;4819016753;Ne;0;0;1;1
12797;Vėrinėlis;BORUŽĖLĖS;1910385020;Ne;0;2;0;2
12798;Vėrinėlis;BORUŽĖLĖS;2078857084;Ne;0;1;0;1
12799;Vėrinėlis;BORUŽĖLĖS;3934652683;Ne;16;0;0;16
12800;Vėrinėlis;BORUŽĖLĖS;6904733283;Ne;13;0;1;14
12801;Vėrinėlis;BORUŽĖLĖS;4446546335;Ne;0;5;3;8
12802;Vėrinėlis;BORUŽĖLĖS;3718510933;Ne;3;1;0;4
12803;Vėrinėlis;BORUŽĖLĖS;2501287529;Ne;0;3;0;3
12804;Vėrinėlis;BORUŽĖLĖS;8904833339;Ne;5;3;0;8
12805;Vėrinėlis;BORUŽĖLĖS;3312501759;Ne;5;3;0;8
12806;Vėrinėlis;BORUŽĖLĖS;9217188911;Ne;6;11;4;21
12807;Vėrinėlis;BORUŽĖLĖS;7414937335;Ne;10;4;0;14
12808;Vėrinėlis;BORUŽĖLĖS;2574507205;Ne;0;5;0;5
12809;Vėrinėlis;BORUŽĖLĖS;4852563692;Ne;0;0;3;3
12810;Vėrinėlis;BORUŽĖLĖS;5865529907;Ne;5;0;0;5
12811;Vėrinėlis;BORUŽĖLĖS;9613642664;Ne;0;13;0;13
12812;Vėrinėlis;BORUŽĖLĖS;2467242845;Ne;0;4;0;4
12813;Vėrinėlis;SVEIKUOLIAI;1909742394;Ne;5;0;0;5
12814;Vėrinėlis;SVEIKUOLIAI;6176308531;Ne;0;3;0;3
12815;Vėrinėlis;SVEIKUOLIAI;3070965434;Ne;0;2;0;2
12816;Vėrinėlis;SVEIKUOLIAI;3563114419;Ne;8;5;0;13
12817;Vėrinėlis;SVEIKUOLIAI;3973272659;Ne;0;1;1;2
12818;Vėrinėlis;SVEIKUOLIAI;8716965452;Ne;5;6;2;13
12819;Vėrinėlis;SVEIKUOLIAI;7584124339;Ne;12;1;0;13
12820;Vėrinėlis;SVEIKUOLIAI;9352630743;Ne;0;1;1;2
12821;Vėrinėlis;SVEIKUOLIAI;4859330774;Ne;9;1;0;10
12822;Vėrinėlis;SVEIKUOLIAI;8543081245;Ne;0;2;0;2
12823;Vėrinėlis;SVEIKUOLIAI;1800434426;Ne;0;1;0;1
12824;Vėrinėlis;SVEIKUOLIAI;5614185158;Ne;0;3;1;4
12825;Vėrinėlis;SVEIKUOLIAI;5539714292;Ne;0;9;0;9
12826;Vėrinėlis;SVEIKUOLIAI;2516474825;Ne;6;0;0;6
12827;Vėrinėlis;SVEIKUOLIAI;9058127692;Ne;0;2;0;2
12828;Vėrinėlis;SVEIKUOLIAI;1278914183;Ne;4;0;0;4
12829;Vėrinėlis;SVEIKUOLIAI;7573209012;Ne;8;1;0;9
12830;Vėrinėlis;SVEIKUOLIAI;3084117432;Ne;6;0;3;9
12831;Vėrinėlis;SVEIKUOLIAI;2015928440;Ne;4;1;1;6
12832;Vėrinėlis;ŠIRDELĖS;7734163541;Ne;6;0;1;7
12833;Vėrinėlis;ŠIRDELĖS;7811024382;Taip;4;0;0;4
12834;Vėrinėlis;ŠIRDELĖS;4378592116;Ne;7;0;8;15
12835;Vėrinėlis;ŠIRDELĖS;7517113022;Ne;0;1;0;1
12836;Vėrinėlis;ŠIRDELĖS;1841277321;Ne;5;1;0;6
12837;Vėrinėlis;ŠIRDELĖS;5588658517;Ne;9;0;0;9
12838;Vėrinėlis;ŠIRDELĖS;5653635907;Ne;19;2;0;21
12839;Vėrinėlis;ŠIRDELĖS;1152010178;Ne;5;4;2;11
12840;Vėrinėlis;ŠIRDELĖS;2038169885;Ne;7;5;0;12
12841;Vėrinėlis;ŠIRDELĖS;9375922889;Ne;12;2;0;14
12842;Vėrinėlis;ŠIRDELĖS;5813009126;Ne;0;4;0;4
12843;Vėrinėlis;ŠIRDELĖS;3511809411;Ne;0;6;0;6
12844;Vėrinėlis;ŠIRDELĖS;3535652648;Ne;3;0;2;5
12845;Vėrinėlis;ŠIRDELĖS;9217815657;Ne;0;6;0;6
12846;Vėrinėlis;ŠIRDELĖS;4403875733;Ne;6;0;0;6
12847;Vėrinėlis;ŠIRDELĖS;4700093328;Ne;3;0;0;3
12848;Vėrinėlis;ŠIRDELĖS;3687250255;Ne;6;0;0;6
12849;Vėrinėlis;ŠIRDELĖS;2847839917;Ne;10;4;0;14
12850;Vėrinėlis;ŠIRDELĖS;7311740859;Ne;0;7;0;7
12851;Vėrinėlis;ŠIRDELĖS;6905591549;Ne;7;5;0;12
12852;Viltenė;Drugeliai;3625763429;Ne;0;3;0;3
12853;Viltenė;Drugeliai;2392304909;Ne;0;3;0;3
12854;Viltenė;Drugeliai;5781655552;Ne;5;0;0;5
12855;Viltenė;Drugeliai;2410868015;Ne;0;21;0;21
12856;Viltenė;Drugeliai;4616047113;Ne;7;0;0;7
12857;Viltenė;Drugeliai;6810811656;Ne;0;5;0;5
12858;Viltenė;Drugeliai;3905014810;Ne;0;11;0;11
12859;Viltenė;Drugeliai;4121448859;Ne;8;0;0;8
12860;Viltenė;Drugeliai;9157616307;Ne;0;1;0;1
12861;Viltenė;Drugeliai;9476132305;Ne;4;6;0;10
12862;Viltenė;Drugeliai;3052677157;Ne;0;2;0;2
12863;Viltenė;Drugeliai;5522245968;Ne;0;3;0;3
12864;Viltenė;Drugeliai;7401460248;Ne;11;0;0;11
12865;Viltenė;Drugeliai;9820462941;Ne;0;4;0;4
12866;Viltenė;Drugeliai;9756519374;Ne;6;1;0;7
12867;Viltenė;Drugeliai;7928894276;Ne;0;7;0;7
12868;Viltenė;Drugeliai;8527270437;Ne;0;6;0;6
12869;Viltenė;Drugeliai;4195708756;Ne;14;0;0;14
12870;Viltenė;Drugeliai;1267187553;Ne;3;1;0;4
12871;Viltenė;Drugeliai;1081603034;Ne;16;0;0;16
12872;Viltenė;Drugeliai;7500965165;Ne;4;5;0;9
12873;Viltenė;Bitučių;2846574130;Ne;12;4;0;16
12874;Viltenė;Bitučių;8336855920;Ne;0;11;0;11
12875;Viltenė;Bitučių;2656363650;Ne;5;0;0;5
12876;Viltenė;Bitučių;2841144656;Ne;0;4;0;4
12877;Viltenė;Bitučių;7810374329;Ne;4;3;0;7
12878;Viltenė;Bitučių;4724382069;Ne;15;0;0;15
12879;Viltenė;Bitučių;7717223673;Ne;16;0;0;16
12880;Viltenė;Bitučių;4001205912;Ne;13;0;0;13
12881;Viltenė;Bitučių;7266522399;Ne;2;1;0;3
12882;Viltenė;Bitučių;4379784712;Ne;4;2;0;6
12883;Viltenė;Bitučių;9095458948;Ne;19;0;0;19
12884;Viltenė;Bitučių;5241075224;Ne;3;0;2;5
12885;Viltenė;Boružėlių;6642790962;Ne;5;3;0;8
12886;Viltenė;Boružėlių;9572407405;Ne;0;5;0;5
12887;Viltenė;Boružėlių;3738838707;Ne;0;1;0;1
12888;Viltenė;Boružėlių;8473588098;Ne;0;9;0;9
12889;Viltenė;Boružėlių;1399653129;Ne;8;8;0;16
12890;Viltenė;Boružėlių;7526555727;Ne;0;4;0;4
12891;Viltenė;Boružėlių;5379804362;Ne;0;1;0;1
12892;Viltenė;Boružėlių;1936628249;Ne;3;1;0;4
12893;Viltenė;Boružėlių;4003018966;Ne;4;0;0;4
12894;Viltenė;Boružėlių;4036109404;Ne;2;1;0;3
12895;Viltenė;Boružėlių;4604298036;Ne;0;9;0;9
12896;Viltenė;Boružėlių;9197007374;Ne;0;6;0;6
12897;Viltenė;Boružėlių;9242034622;Ne;0;4;0;4
12898;Viltenė;Boružėlių;6621273812;Ne;3;2;0;5
12899;Viltenė;Boružėlių;2383607612;Taip;0;6;0;6
12900;Viltenė;Boružėlių;1496943250;Ne;0;2;0;2
12901;Viltenė;Gandriukų;6481491422;Ne;0;2;6;8
12902;Viltenė;Gandriukų;1126409020;Ne;0;2;0;2
12903;Viltenė;Gandriukų;2884698447;Ne;0;2;0;2
12904;Viltenė;Gandriukų;6060648988;Ne;0;5;0;5
12905;Viltenė;Gandriukų;1840626621;Ne;0;3;0;3
12906;Viltenė;Gandriukų;8549631247;Ne;7;3;0;10
12907;Viltenė;Gandriukų;7796422726;Ne;0;2;0;2
12908;Viltenė;Gandriukų;6511850468;Ne;0;7;0;7
12909;Viltenė;Gandriukų;5850652322;Ne;4;3;0;7
12910;Viltenė;Gandriukų;8110413064;Ne;5;0;0;5
12911;Viltenė;Gandriukų;1243595112;Ne;0;4;0;4
12912;Viltenė;Gandriukų;3073228245;Ne;29;0;0;29
12913;Viltenė;Gandriukų;4468743044;Ne;8;0;0;8
12914;Viltenė;Gandriukų;6355857716;Ne;4;1;0;5
12915;Viltenė;Gandriukų;5929135840;Ne;6;0;0;6
12916;Viltenė;Gandriukų;8458769051;Ne;0;13;0;13
12917;Viltenė;Aitvariukai;5083515613;Ne;0;1;0;1
12918;Viltenė;Aitvariukai;2137929911;Ne;3;0;0;3
12919;Viltenė;Aitvariukai;9185054066;Ne;2;1;0;3
12920;Viltenė;Aitvariukai;2036902795;Ne;0;1;0;1
12921;Viltenė;Aitvariukai;5599943846;Ne;10;0;0;10
12922;Viltenė;Aitvariukai;6721689684;Ne;8;0;0;8
12923;Viltenė;Aitvariukai;6296509460;Ne;7;2;0;9
12924;Viltenė;Aitvariukai;9101795131;Ne;0;7;0;7
12925;Viltenė;Aitvariukai;8439859449;Ne;0;4;0;4
12926;Viltenė;Aitvariukai;2976705872;Ne;10;4;0;14
12927;Viltenė;Aitvariukai;2192086488;Ne;5;4;0;9
12928;Viltenė;Aitvariukai;2026654467;Ne;0;6;0;6
12929;Viltenė;Aitvariukai;4641365031;Ne;4;3;0;7
12930;Viltenė;Aitvariukai;7277455268;Ne;0;14;0;14
12931;Viltenė;Aitvariukai;3245284852;Ne;7;0;0;7
12932;Viltenė;Aitvariukai;2786572522;Ne;0;8;0;8
12933;Viltenė;Geniukų;5604263567;Ne;0;10;0;10
12934;Viltenė;Geniukų;1822220265;Ne;0;2;0;2
12935;Viltenė;Geniukų;1423254631;Ne;0;9;0;9
12936;Viltenė;Geniukų;3002690526;Ne;0;1;0;1
12937;Viltenė;Geniukų;6276349499;Ne;0;1;0;1
12938;Viltenė;Geniukų;1054469254;Ne;0;4;0;4
12939;Viltenė;Geniukų;6063181025;Ne;0;1;0;1
12940;Viltenė;Geniukų;1672091332;Ne;10;0;0;10
12941;Viltenė;Geniukų;49998813869;Ne;0;4;0;4
12942;Viltenė;Geniukų;3389110405;Ne;4;7;0;11
12943;Viltenė;Geniukų;4319685140;Ne;6;0;0;6
12944;Viltenė;Geniukų;8125023386;Ne;0;5;0;5
12945;Viltenė;Geniukų;9035687504;Ne;2;4;0;6
12946;Viltenė;Geniukų;1629377078;Ne;0;2;0;2
12947;Viltenė;Geniukų;3746923185;Ne;0;9;0;9
12948;Viltenė;Geniukų;1557503831;Ne;0;11;0;11
12949;Viltenė;Saulutės;2044754943;Ne;7;6;0;13
12950;Viltenė;Saulutės;6848403057;Ne;0;6;0;6
12951;Viltenė;Saulutės;1615415742;Ne;0;5;0;5
12952;Viltenė;Saulutės;9935236068;Ne;0;9;0;9
12953;Viltenė;Saulutės;6664059418;Ne;0;8;0;8
12954;Viltenė;Saulutės;2141002432;Ne;0;6;0;6
12955;Viltenė;Saulutės;1362308882;Ne;0;5;0;5
12956;Viltenė;Saulutės;8920533673;Ne;0;3;0;3
12957;Viltenė;Saulutės;5024192785;Ne;0;11;0;11
12958;Viltenė;Saulutės;1918867591;Ne;1;6;0;7
12959;Viltenė;Saulutės;7559243300;Ne;0;12;0;12
12960;Viltenė;Saulutės;3560474943;Ne;0;5;0;5
12961;Viltenė;Saulutės;1252657362;Ne;7;0;0;7
12962;Viltenė;Saulutės;2559945034;Ne;0;4;0;4
12963;Viltenė;Saulutės;9055821628;Ne;0;3;0;3
12964;Viltenė;Saulutės;7726650894;Ne;7;3;0;10
12965;Viltenė;Saulutės;3709362712;Ne;0;8;0;8
12966;Viltenė;Saulutės;1841732416;Ne;0;2;0;2
12967;Viltenė;Lapiukų;2034259692;Ne;5;11;0;16
12968;Viltenė;Lapiukų;3473533533;Ne;1;5;0;6
12969;Viltenė;Lapiukų;8696698257;Ne;4;0;0;4
12970;Viltenė;Lapiukų;8248514570;Ne;0;8;0;8
12971;Viltenė;Lapiukų;2878124826;Taip;6;3;0;9
12972;Viltenė;Lapiukų;2660622296;Ne;6;1;0;7
12973;Viltenė;Lapiukų;4550915388;Ne;0;12;0;12
12974;Viltenė;Lapiukų;8122878153;Ne;7;4;0;11
12975;Viltenė;Lapiukų;9573891616;Ne;0;9;0;9
12976;Viltenė;Lapiukų;4243501722;Ne;0;6;0;6
12977;Viltenė;Lapiukų;5818645490;Ne;4;0;0;4
12978;Viltenė;Lapiukų;6429905246;Ne;0;9;0;9
12979;Viltenė;Lapiukų;6070264006;Ne;5;1;0;6
12980;Viltenė;Lapiukų;8187712849;Ne;7;4;1;12
12981;Viltenė;Lapiukų;3679704404;Ne;0;13;0;13
12982;Viltenė;Lapiukų;1507287948;Taip;0;6;0;6
12983;Viltenė;Lapiukų;9846205631;Ne;3;2;0;5
12984;Viltenė;Lapiukų;9063994291;Ne;0;6;0;6
12985;Viltenė;Voveriukai;6888346135;Ne;0;13;0;13
12986;Viltenė;Voveriukai;2936670828;Ne;0;0;6;6
12987;Viltenė;Voveriukai;5816623708;Ne;0;21;0;21
12988;Viltenė;Voveriukai;5611839058;Ne;0;4;0;4
12989;Viltenė;Voveriukai;4414192600;Ne;0;5;1;6
12990;Viltenė;Voveriukai;2483760198;Ne;1;0;0;1
12991;Viltenė;Voveriukai;8341211836;Ne;12;0;0;12
12992;Viltenė;Voveriukai;6954065006;Ne;11;1;0;12
12993;Viltenė;Voveriukai;6741521720;Ne;1;14;0;15
12994;Viltenė;Voveriukai;2642080849;Ne;6;1;1;8
12995;Viltenė;Voveriukai;6040634853;Ne;0;1;0;1
12996;Viltenė;Voveriukai;7322841332;Ne;6;1;2;9
12997;Viltenė;Voveriukai;1888167096;Ne;0;2;0;2
12998;Viltenė;Voveriukai;3291926243;Ne;0;8;0;8
12999;Viltenė;Voveriukai;2894570917;Taip;9;1;0;10
13000;Viltenė;Voveriukai;7158824421;Ne;0;2;0;2
13001;Viltenė;Voveriukai;1890096287;Ne;0;1;0;1
13002;Viltenė;Kiškučiai;6595715908;Ne;15;0;0;15
13003;Viltenė;Kiškučiai;3347380524;Ne;5;4;0;9
13004;Viltenė;Kiškučiai;1641406030;Ne;1;1;0;2
13005;Viltenė;Kiškučiai;2192673126;Ne;9;2;0;11
13006;Viltenė;Kiškučiai;3157417614;Ne;9;0;0;9
13007;Viltenė;Kiškučiai;5974408492;Ne;2;4;0;6
13008;Viltenė;Kiškučiai;9578037239;Ne;5;1;0;6
13009;Viltenė;Kiškučiai;4615393852;Ne;0;6;0;6
13010;Viltenė;Kiškučiai;2903596382;Ne;9;0;0;9
13011;Viltenė;Kiškučiai;8091905944;Ne;4;0;0;4
13012;Viltenė;Kiškučiai;7314937470;Ne;5;0;0;5
13013;Viltenė;Kiškučiai;8150583354;Ne;10;0;0;10
13014;Viltenė;Kiškučiai;9760364123;Ne;5;0;0;5
13015;Viltenė;Kiškučiai;6021086235;Ne;16;0;0;16
13016;Viltenė;Kiškučiai;9862698928;Ne;1;0;0;1
13017;Viltenė;Kiškučiai;3501209955;Ne;4;1;0;5
13018;Viltenė;Nykštukų;4981225829;Ne;7;4;0;11
13019;Viltenė;Nykštukų;9424773418;Ne;8;0;0;8
13020;Viltenė;Nykštukų;3343045604;Ne;1;1;0;2
13021;Viltenė;Nykštukų;4537287677;Ne;14;2;1;17
13022;Viltenė;Nykštukų;3306285115;Ne;0;1;0;1
13023;Viltenė;Nykštukų;6992120038;Ne;1;6;0;7
13024;Viltenė;Nykštukų;7331321780;Ne;1;0;0;1
13025;Viltenė;Nykštukų;5707049797;Ne;0;0;1;1
13026;Viltenė;Nykštukų;3853518656;Ne;5;1;0;6
13027;Viltenė;Nykštukų;9263941853;Ne;14;3;0;17
13028;Viltenė;Nykštukų;7370710652;Ne;5;0;0;5
13029;Viltenė;Nykštukų;9582577013;Ne;10;5;0;15
13030;Viltenė;Triušiukai;6379567497;Ne;0;1;0;1
13031;Viltenė;Triušiukai;8346933997;Ne;0;0;2;2
13032;Viltenė;Triušiukai;1587868835;Ne;7;0;0;7
13033;Viltenė;Triušiukai;8258247750;Ne;16;0;0;16
13034;Viltenė;Triušiukai;6635474168;Ne;12;0;0;12
13035;Viltenė;Triušiukai;7754951374;Ne;5;0;0;5
13036;Viltenė;Triušiukai;7058586628;Ne;15;0;0;15
13037;Viltenė;Triušiukai;7005219570;Ne;5;0;0;5
13038;Viltenė;Triušiukai;2850146424;Ne;14;2;0;16
13039;Viltenė;Triušiukai;1318750938;Ne;0;4;0;4
13040;Viltenė;Triušiukai;1788524515;Ne;0;1;0;1
13041;Voveraitė;ŽVIRBLIUKŲ;6684234832;Ne;0;14;4;18
13042;Voveraitė;ŽVIRBLIUKŲ;8119493388;Ne;0;0;4;4
13043;Voveraitė;ŽVIRBLIUKŲ;9715405072;Ne;0;3;0;3
13044;Voveraitė;ŽVIRBLIUKŲ;5804351872;Ne;0;0;4;4
13045;Voveraitė;ŽVIRBLIUKŲ;5510544648;Ne;0;0;2;2
13046;Voveraitė;ŽVIRBLIUKŲ;6959751328;Ne;3;1;2;6
13047;Voveraitė;ŽVIRBLIUKŲ;8257748589;Ne;0;7;0;7
13048;Voveraitė;ŽVIRBLIUKŲ;3811230983;Ne;0;0;14;14
13049;Voveraitė;ŽVIRBLIUKŲ;2142507659;Ne;0;0;6;6
13050;Voveraitė;ŽVIRBLIUKŲ;5395915359;Ne;0;0;1;1
13051;Voveraitė;ŽVIRBLIUKŲ;3247101840;Ne;0;0;3;3
13052;Voveraitė;ŽVIRBLIUKŲ;6643600680;Ne;0;0;4;4
13053;Voveraitė;ŽVIRBLIUKŲ;4460047281;Ne;0;4;0;4
13054;Voveraitė;ŽVIRBLIUKŲ;3877673172;Ne;0;6;0;6
13055;Voveraitė;ŽVIRBLIUKŲ;9117809080;Ne;3;0;1;4
13056;Voveraitė;ŽVIRBLIUKŲ;7861722125;Ne;9;0;7;16
13057;Voveraitė;ŽVIRBLIUKŲ;6994680282;Ne;0;3;0;3
13058;Voveraitė;VOVERIUKŲ;1515087924;Ne;0;4;0;4
13059;Voveraitė;VOVERIUKŲ;9195700962;Ne;5;9;0;14
13060;Voveraitė;VOVERIUKŲ;5138855000;Ne;4;0;0;4
13061;Voveraitė;VOVERIUKŲ;1340379090;Ne;1;4;0;5
13062;Voveraitė;VOVERIUKŲ;9912862474;Ne;0;1;0;1
13063;Voveraitė;VOVERIUKŲ;1960385335;Ne;13;1;0;14
13064;Voveraitė;VOVERIUKŲ;2594535017;Ne;0;5;0;5
13065;Voveraitė;VOVERIUKŲ;4563198733;Ne;0;7;0;7
13066;Voveraitė;VOVERIUKŲ;8373093305;Ne;0;9;0;9
13067;Voveraitė;VOVERIUKŲ;9514425475;Ne;0;5;0;5
13068;Voveraitė;VOVERIUKŲ;6891841301;Ne;0;13;0;13
13069;Voveraitė;VOVERIUKŲ;5935777154;Ne;0;1;0;1
13070;Voveraitė;VOVERIUKŲ;6007396459;Ne;0;1;0;1
13071;Voveraitė;VOVERIUKŲ;4054841724;Ne;0;8;0;8
13072;Voveraitė;VOVERIUKŲ;5956830012;Ne;6;4;0;10
13073;Voveraitė;VOVERIUKŲ;8344323109;Ne;0;1;0;1
13074;Voveraitė;VOVERIUKŲ;1141304286;Ne;0;5;0;5
13075;Voveraitė;VOVERIUKŲ;1663784931;Ne;5;1;0;6
13076;Voveraitė;VOVERIUKŲ;3276295199;Ne;0;2;0;2
13077;Voveraitė;VOVERIUKŲ;6113913885;Ne;0;2;0;2
13078;Voveraitė;KIŠKUČIŲ;9537862791;Ne;0;1;0;1
13079;Voveraitė;KIŠKUČIŲ;4478984171;Ne;0;1;0;1
13080;Voveraitė;KIŠKUČIŲ;3736638759;Ne;0;5;0;5
13081;Voveraitė;KIŠKUČIŲ;9011096222;Ne;5;0;16;21
13082;Voveraitė;KIŠKUČIŲ;8084986328;Ne;0;4;0;4
13083;Voveraitė;KIŠKUČIŲ;6261152304;Ne;0;1;0;1
13084;Voveraitė;KIŠKUČIŲ;5069929376;Ne;10;0;0;10
13085;Voveraitė;KIŠKUČIŲ;7379045686;Ne;0;10;0;10
13086;Voveraitė;KIŠKUČIŲ;1961699588;Ne;9;0;0;9
13087;Voveraitė;KIŠKUČIŲ;1979839656;Ne;0;1;0;1
13088;Voveraitė;KIŠKUČIŲ;9599137158;Ne;6;2;0;8
13089;Voveraitė;KIŠKUČIŲ;8121423914;Ne;0;3;0;3
13090;Voveraitė;KIŠKUČIŲ;4379372200;Ne;1;0;0;1
13091;Voveraitė;KIŠKUČIŲ;8528435385;Ne;6;0;0;6
13092;Voveraitė;KIŠKUČIŲ;8937070276;Ne;10;0;0;10
13093;Voveraitė;KIŠKUČIŲ;3859125174;Taip;0;3;0;3
13094;Voveraitė;KODĖLČIUKŲ;3274422598;Ne;3;2;0;5
13095;Voveraitė;KODĖLČIUKŲ;8438808999;Ne;5;1;2;8
13096;Voveraitė;KODĖLČIUKŲ;8818603905;Ne;11;0;0;11
13097;Voveraitė;KODĖLČIUKŲ;9397887760;Ne;0;6;9;15
13098;Voveraitė;KODĖLČIUKŲ;4151144278;Ne;0;1;4;5
13099;Voveraitė;KODĖLČIUKŲ;5598685365;Ne;5;5;0;10
13100;Voveraitė;KODĖLČIUKŲ;1482908802;Ne;7;0;0;7
13101;Voveraitė;KODĖLČIUKŲ;9887747925;Ne;5;0;0;5
13102;Voveraitė;KODĖLČIUKŲ;7605427741;Ne;0;5;0;5
13103;Voveraitė;KODĖLČIUKŲ;3344886524;Ne;5;0;0;5
13104;Voveraitė;KODĖLČIUKŲ;1046297151;Ne;0;4;6;10
13105;Voveraitė;KODĖLČIUKŲ;4996778855;Ne;0;4;6;10
13106;Voveraitė;KODĖLČIUKŲ;3432886020;Ne;6;0;0;6
13107;Voveraitė;KODĖLČIUKŲ;8154347030;Ne;5;8;0;13
13108;Voveraitė;KODĖLČIUKŲ;2482908027;Ne;0;5;0;5
13109;Voveraitė;KODĖLČIUKŲ;8692155848;Ne;0;0;4;4
13110;Voveraitė;KODĖLČIUKŲ;1040007977;Ne;4;2;0;6
13111;Voveraitė;KODĖLČIUKŲ;3881039538;Ne;10;0;0;10
13112;Voveraitė;KODĖLČIUKŲ;7281753415;Ne;9;1;0;10
13113;Voveraitė;KODĖLČIUKŲ;8021563060;Ne;3;5;0;8
13114;Voveraitė;KODĖLČIUKŲ;9816971493;Ne;0;1;5;6
13115;Voveraitė;MEŠKIUKŲ;7499150201;Ne;0;1;0;1
13116;Voveraitė;MEŠKIUKŲ;3217609712;Ne;2;5;0;7
13117;Voveraitė;MEŠKIUKŲ;3088866739;Ne;0;2;0;2
13118;Voveraitė;MEŠKIUKŲ;4207949414;Ne;0;8;0;8
13119;Voveraitė;MEŠKIUKŲ;4547087565;Ne;0;3;0;3
13120;Voveraitė;MEŠKIUKŲ;7474214701;Ne;10;1;0;11
13121;Voveraitė;MEŠKIUKŲ;9729735431;Ne;0;3;0;3
13122;Voveraitė;MEŠKIUKŲ;6853358062;Ne;0;6;0;6
13123;Voveraitė;MEŠKIUKŲ;3539069705;Ne;0;1;0;1
13124;Voveraitė;MEŠKIUKŲ;9544043839;Taip;0;2;0;2
13125;Voveraitė;MEŠKIUKŲ;6609235703;Ne;2;1;0;3
13126;Voveraitė;MEŠKIUKŲ;1528968162;Ne;1;0;0;1
13127;Voveraitė;MEŠKIUKŲ;3159659638;Ne;15;4;0;19
13128;Voveraitė;MEŠKIUKŲ;3532178114;Ne;15;4;0;19
13129;Voveraitė;MEŠKIUKŲ;5196036817;Ne;0;2;0;2
13130;Voveraitė;MEŠKIUKŲ;1813440087;Ne;0;10;0;10
13131;Voveraitė;MEŠKIUKŲ;8534405352;Ne;21;0;0;21
13132;Voveraitė;MEŠKIUKŲ;5018335921;Ne;19;0;0;19
13133;Voveraitė;BORUŽĖLIŲ;3703062195;Ne;0;1;0;1
13134;Voveraitė;BORUŽĖLIŲ;5437283673;Ne;4;4;2;10
13135;Voveraitė;BORUŽĖLIŲ;3029983180;Ne;0;10;0;10
13136;Voveraitė;BORUŽĖLIŲ;5576058454;Ne;0;11;0;11
13137;Voveraitė;BORUŽĖLIŲ;7797966139;Ne;0;0;4;4
13138;Voveraitė;BORUŽĖLIŲ;4079618555;Ne;0;4;0;4
13139;Voveraitė;BORUŽĖLIŲ;6886337758;Ne;0;14;0;14
13140;Voveraitė;BORUŽĖLIŲ;1592633500;Ne;0;1;0;1
13141;Voveraitė;BORUŽĖLIŲ;1629942114;Ne;0;6;0;6
13142;Voveraitė;BORUŽĖLIŲ;1058273156;Ne;0;9;0;9
13143;Voveraitė;BORUŽĖLIŲ;9933037872;Ne;0;2;0;2
13144;Voveraitė;BORUŽĖLIŲ;65926130735;Ne;3;0;0;3
13145;Voveraitė;BORUŽĖLIŲ;6277010268;Ne;5;0;0;5
13146;Voveraitė;BORUŽĖLIŲ;2831224400;Ne;7;4;6;17
13147;Voveraitė;BORUŽĖLIŲ;2763656717;Ne;0;4;6;10
13148;Voveraitė;PELĖDŽIUKŲ;9491132884;Ne;4;0;0;4
13149;Voveraitė;PELĖDŽIUKŲ;1775800865;Ne;3;6;0;9
13150;Voveraitė;PELĖDŽIUKŲ;1959958256;Ne;0;4;9;13
13151;Voveraitė;PELĖDŽIUKŲ;6649068571;Ne;0;1;0;1
13152;Voveraitė;PELĖDŽIUKŲ;9231751171;Ne;0;2;0;2
13153;Voveraitė;PELĖDŽIUKŲ;9007031372;Ne;4;5;0;9
13154;Voveraitė;PELĖDŽIUKŲ;7069780513;Ne;6;0;0;6
13155;Voveraitė;PELĖDŽIUKŲ;6369860178;Ne;3;0;0;3
13156;Voveraitė;PELĖDŽIUKŲ;6433760749;Ne;0;2;0;2
13157;Voveraitė;PELĖDŽIUKŲ;6460834118;Ne;5;1;1;7
13158;Voveraitė;PELĖDŽIUKŲ;4338861332;Ne;0;4;0;4
13159;Voveraitė;PELĖDŽIUKŲ;7314148938;Ne;0;2;0;2
13160;Voveraitė;PELĖDŽIUKŲ;4511771924;Ne;0;2;0;2
13161;Voveraitė;PELĖDŽIUKŲ;602726070;Ne;0;5;0;5
13162;Voveraitė;PELĖDŽIUKŲ;4163635632;Ne;0;6;1;7
13163;Voveraitė;PELĖDŽIUKŲ;1397274691;Ne;0;3;0;3
13164;Voveraitė;DRUGELIŲ;7531020548;Ne;0;4;0;4
13165;Voveraitė;DRUGELIŲ;4300235743;Ne;2;0;0;2
13166;Voveraitė;DRUGELIŲ;3388547792;Ne;0;1;0;1
13167;Voveraitė;DRUGELIŲ;8719547570;Ne;1;2;1;4
13168;Voveraitė;DRUGELIŲ;3475601049;Ne;9;0;0;9
13169;Voveraitė;DRUGELIŲ;4017408873;Ne;5;0;0;5
13170;Voveraitė;DRUGELIŲ;1550830434;Ne;4;4;0;8
13171;Voveraitė;DRUGELIŲ;5114768009;Ne;0;1;0;1
13172;Voveraitė;DRUGELIŲ;4605007814;Ne;5;2;0;7
13173;Voveraitė;DRUGELIŲ;4911291891;Ne;0;2;12;14
13174;Voveraitė;DRUGELIŲ;4782336282;Ne;0;4;0;4
13175;Voveraitė;DRUGELIŲ;6415024059;Ne;0;2;0;2
13176;Voveraitė;DRUGELIŲ;4350450125;Ne;0;3;0;3
13177;Voveraitė;DRUGELIŲ;8913940646;Ne;0;8;0;8
13178;Voveraitė;DRUGELIŲ;1201270622;Ne;0;2;6;8
13179;Voveraitė;DRUGELIŲ;7238482039;Ne;15;0;0;15
13180;Voveraitė;DRUGELIŲ;5605614222;Ne;0;0;1;1
13181;Voveraitė;NYKŠTUKŲ;6579193196;Ne;3;0;0;3
13182;Voveraitė;NYKŠTUKŲ;8940421826;Ne;8;0;0;8
13183;Voveraitė;NYKŠTUKŲ;9332936763;Ne;9;5;1;15
13184;Voveraitė;NYKŠTUKŲ;6206817227;Ne;7;0;2;9
13185;Voveraitė;NYKŠTUKŲ;8206634977;Ne;7;2;0;9
13186;Voveraitė;NYKŠTUKŲ;3068683904;Ne;0;1;3;4
13187;Voveraitė;NYKŠTUKŲ;3600230896;Ne;5;0;0;5
13188;Voveraitė;NYKŠTUKŲ;1294012085;Ne;0;7;0;7
13189;Voveraitė;NYKŠTUKŲ;9363490578;Ne;5;7;0;12
13190;Voveraitė;NYKŠTUKŲ;8217771158;Ne;3;7;0;10
13191;Voveraitė;NYKŠTUKŲ;3409709168;Ne;6;0;0;6
13192;Voveraitė;NYKŠTUKŲ;1045121363;Ne;0;4;0;4
13193;Voveraitė;NYKŠTUKŲ;4319786615;Ne;5;2;0;7
13194;Voveraitė;NYKŠTUKŲ;4430631207;Ne;11;0;3;14
13195;Voveraitė;NYKŠTUKŲ;1237440400;Ne;11;0;3;14
13196;Voveraitė;NYKŠTUKŲ;3261542931;Ne;7;1;5;13
13197;Voveraitė;GENIUKŲ;5467979968;Ne;0;1;0;1
13198;Voveraitė;GENIUKŲ;51213803814;Ne;0;6;0;6
13199;Voveraitė;GENIUKŲ;36749754999;Ne;0;4;0;4
13200;Voveraitė;GENIUKŲ;46205148458;Ne;0;2;0;2
13201;Voveraitė;GENIUKŲ;4468214107;Ne;0;3;0;3
13202;Voveraitė;GENIUKŲ;9921313716;Ne;0;3;0;3
13203;Voveraitė;GENIUKŲ;4045121781;Ne;10;0;0;10
13204;Voveraitė;GENIUKŲ;7786378018;Ne;0;1;0;1
13205;Voveraitė;GENIUKŲ;5449490074;Ne;0;6;3;9
13206;Voveraitė;GENIUKŲ;2208396431;Ne;0;1;0;1
13207;Voveraitė;LAPIUKŲ;5104290434;Ne;5;0;16;21
13208;Voveraitė;LAPIUKŲ;6648733729;Ne;0;21;0;21
13209;Voveraitė;LAPIUKŲ;8405238812;Ne;4;0;2;6
13210;Voveraitė;LAPIUKŲ;8152541593;Ne;13;0;1;14
13211;Voveraitė;LAPIUKŲ;4891757467;Ne;0;0;8;8
13212;Voveraitė;LAPIUKŲ;9218074631;Ne;0;0;10;10
13213;Voveraitė;LAPIUKŲ;1921260351;Ne;17;0;0;17
13214;Voveraitė;LAPIUKŲ;9120975451;Ne;2;0;1;3
13215;Voveraitė;LAPIUKŲ;3452040361;Ne;4;5;1;10
13216;Voveraitė;LAPIUKŲ;8382950248;Ne;0;1;1;2
13217;Voveraitė;LAPIUKŲ;8695525951;Ne;2;0;4;6
13218;Voveraitė;LAPIUKŲ;6443288864;Ne;0;1;13;14
13219;Voveraitė;LAPIUKŲ;6650343917;Ne;0;2;0;2
13220;Voveraitė;LAPIUKŲ;8451803815;Ne;3;0;2;5
13221;Voveraitė;LAPIUKŲ;9327593792;Ne;14;3;0;17
13222;Voveraitė;LAPIUKŲ;4139239328;Ne;14;3;0;17
13223;Voveraitė;EŽIUKŲ;5420123208;Ne;17;0;0;17
13224;Voveraitė;EŽIUKŲ;7969862374;Ne;0;1;1;2
13225;Voveraitė;EŽIUKŲ;1692829228;Ne;6;3;0;9
13226;Voveraitė;EŽIUKŲ;4233627593;Ne;0;0;8;8
13227;Voveraitė;EŽIUKŲ;2446269570;Ne;0;4;1;5
13228;Voveraitė;EŽIUKŲ;8074808131;Ne;3;0;2;5
13229;Voveraitė;EŽIUKŲ;8675606844;Ne;0;4;1;5
13230;Voveraitė;EŽIUKŲ;3168493145;Ne;0;0;1;1
13231;Voveraitė;EŽIUKŲ;3971484538;Ne;0;0;3;3
13232;Voveraitė;EŽIUKŲ;1542869765;Ne;0;0;6;6
13233;Voveraitė;EŽIUKŲ;2755043670;Ne;0;4;0;4
13234;"Trakų Vokė";Voveriukų;1252962923;Ne;23;0;0;23
13235;"Trakų Vokė";Voveriukų;6076083379;Ne;4;5;0;9
13236;"Trakų Vokė";Voveriukų;7656305410;Ne;16;0;1;17
13237;"Trakų Vokė";Voveriukų;5626732539;Ne;0;7;1;8
13238;"Trakų Vokė";Voveriukų;2163756512;Ne;8;0;0;8
13239;"Trakų Vokė";Voveriukų;7706665420;Ne;13;0;0;13
13240;"Trakų Vokė";Voveriukų;7346128036;Ne;6;0;0;6
13241;"Trakų Vokė";Voveriukų;2318712376;Ne;0;0;4;4
13242;"Trakų Vokė";Voveriukų;2812442474;Ne;10;0;0;10
13243;"Trakų Vokė";Voveriukų;7671121106;Ne;13;0;7;20
13244;"Trakų Vokė";Voveriukų;9140597911;Ne;11;0;6;17
13245;"Trakų Vokė";Voveriukų;5741852704;Ne;11;0;0;11
13246;"Trakų Vokė";Voveriukų;8636196544;Ne;5;0;0;5
13247;"Trakų Vokė";Voveriukų;4516714702;Ne;7;0;0;7
13248;"Trakų Vokė";Voveriukų;7797516793;Ne;0;4;0;4
13249;"Trakų Vokė";Voveriukų;3445611475;Ne;5;0;8;13
13250;"Trakų Vokė";Voveriukų;3422308444;Ne;0;4;10;14
13251;"Trakų Vokė";Boružėlių;1039690987;Ne;0;0;3;3
13252;"Trakų Vokė";Boružėlių;7909596435;Ne;12;0;0;12
13253;"Trakų Vokė";Boružėlių;6751625456;Ne;5;1;0;6
13254;"Trakų Vokė";Boružėlių;7752786907;Ne;13;0;0;13
13255;"Trakų Vokė";Boružėlių;2475068032;Ne;0;0;7;7
13256;"Trakų Vokė";Boružėlių;4438127190;Ne;7;0;9;16
13257;"Trakų Vokė";Boružėlių;2388817616;Ne;0;5;0;5
13258;"Trakų Vokė";Boružėlių;1080300137;Ne;0;2;1;3
13259;"Trakų Vokė";Boružėlių;3209594216;Ne;0;0;1;1
13260;"Trakų Vokė";Boružėlių;4014027030;Ne;0;5;1;6
13261;"Trakų Vokė";Boružėlių;7660240598;Ne;0;9;0;9
13262;"Trakų Vokė";KIŠKUČIŲ;9483709021;Ne;0;0;2;2
13263;"Trakų Vokė";KIŠKUČIŲ;8605461082;Ne;0;4;3;7
13264;"Trakų Vokė";KIŠKUČIŲ;6369848950;Ne;0;0;2;2
13265;"Trakų Vokė";KIŠKUČIŲ;4854440884;Taip;19;0;0;19
13266;"Trakų Vokė";KIŠKUČIŲ;2761614687;Taip;18;0;0;18
13267;"Trakų Vokė";KIŠKUČIŲ;9233090228;Ne;0;0;3;3
13268;"Trakų Vokė";KIŠKUČIŲ;6277305384;Ne;4;0;1;5
13269;"Trakų Vokė";KIŠKUČIŲ;1360046096;Ne;5;4;2;11
13270;"Trakų Vokė";KIŠKUČIŲ;3611639112;Ne;0;3;0;3
13271;"Trakų Vokė";KIŠKUČIŲ;3328527700;Ne;9;0;0;9
13272;"Trakų Vokė";KIŠKUČIŲ;5206616285;Ne;0;4;0;4
13273;"Trakų Vokė";KIŠKUČIŲ;2869217654;Ne;0;1;0;1
13274;"Trakų Vokė";KIŠKUČIŲ;4535167417;Ne;0;6;0;6
13275;"Trakų Vokė";KIŠKUČIŲ;2539647111;Ne;0;0;1;1
13276;"Trakų Vokė";KIŠKUČIŲ;3278842582;Ne;0;0;3;3
13277;"Trakų Vokė";KIŠKUČIŲ;2453791555;Ne;4;0;10;14
13278;"Trakų Vokė";KIŠKUČIŲ;9506008651;Ne;5;0;0;5
13279;"Trakų Vokė";BITUČIŲ;3686108421;Ne;0;2;3;5
13280;"Trakų Vokė";BITUČIŲ;3333979364;Ne;5;0;0;5
13281;"Trakų Vokė";BITUČIŲ;5031669549;Ne;10;3;1;14
13282;"Trakų Vokė";BITUČIŲ;8703806519;Ne;21;0;0;21
13283;"Trakų Vokė";BITUČIŲ;4531294784;Ne;5;0;0;5
13284;"Trakų Vokė";BITUČIŲ;2133793458;Ne;8;1;0;9
13285;"Trakų Vokė";BITUČIŲ;3023545645;Ne;0;4;0;4
13286;"Trakų Vokė";BITUČIŲ;5720994041;Ne;5;0;1;6
13287;"Trakų Vokė";BITUČIŲ;6428645462;Ne;0;6;0;6
13288;"Trakų Vokė";BITUČIŲ;7459132887;Ne;3;2;0;5
13289;"Trakų Vokė";BITUČIŲ;1808420447;Ne;0;2;0;2
13290;"Trakų Vokė";BITUČIŲ;3536227018;Ne;0;0;1;1
13291;"Trakų Vokė";BITUČIŲ;6787506848;Ne;0;1;0;1
13292;"Trakų Vokė";BITUČIŲ;1359519176;Ne;0;4;0;4
13293;"Trakų Vokė";BITUČIŲ;1039317931;Ne;0;8;13;21
13294;Zylutė;Katerok;8749296671;Ne;4;4;0;8
13295;Zylutė;Katerok;4592825972;Ne;5;0;0;5
13296;Zylutė;Katerok;8747721198;Ne;13;0;0;13
13297;Zylutė;Katerok;8212030518;Ne;0;5;3;8
13298;Zylutė;Katerok;7706833089;Ne;0;6;0;6
13299;Zylutė;Katerok;3115223229;Ne;5;0;3;8
13300;Zylutė;Katerok;2968625045;Ne;0;0;4;4
13301;Zylutė;Katerok;1897871944;Ne;7;0;0;7
13302;Zylutė;Katerok;5687201052;Ne;0;5;0;5
13303;Zylutė;Katerok;3055559237;Ne;3;4;0;7
13304;Zylutė;Katerok;2792217953;Ne;1;3;0;4
13305;Zylutė;Katerok;5948147748;Ne;3;0;2;5
13306;Zylutė;Katerok;7851423851;Ne;0;10;0;10
13307;Zylutė;Katerok;9986289837;Taip;10;11;0;21
13308;Zylutė;Katerok;1164530815;Ne;0;4;2;6
13309;Zylutė;Katerok;1423890598;Ne;10;5;2;17
13310;Zylutė;Katerok;2558354198;Ne;0;1;0;1
13311;Zylutė;Katerok;8618778936;Ne;0;4;0;4
13312;Zylutė;"Vesole misiaki";9162232979;Ne;11;0;0;11
13313;Zylutė;"Vesole misiaki";4715704693;Ne;8;0;0;8
13314;Zylutė;"Vesole misiaki";9457457032;Ne;10;2;0;12
13315;Zylutė;"Vesole misiaki";4543822765;Ne;15;0;0;15
13316;Zylutė;"Vesole misiaki";9737308076;Ne;0;6;0;6
13317;Zylutė;"Vesole misiaki";1290248125;Ne;9;0;0;9
13318;Zylutė;"Vesole misiaki";5589330186;Ne;11;0;1;12
13319;Zylutė;"Vesole misiaki";3848401615;Ne;4;1;0;5
13320;Zylutė;"Vesole misiaki";2913504349;Ne;7;6;0;13
13321;Zylutė;"Vesole misiaki";2501761963;Ne;0;7;0;7
13322;Zylutė;"Vesole misiaki";6833822248;Ne;15;0;0;15
13323;Zylutė;"Vesole misiaki";3976277394;Ne;5;2;1;8
13324;Zylutė;"Vesole misiaki";2489898107;Ne;9;3;0;12
13325;Zylutė;"Vesole misiaki";2313423907;Ne;0;11;0;11
13326;Zylutė;NYKŠTUKAI;3371202491;Ne;0;0;2;2
13327;Zylutė;NYKŠTUKAI;8820121776;Ne;4;3;0;7
13328;Zylutė;NYKŠTUKAI;4611555689;Ne;0;3;0;3
13329;Zylutė;NYKŠTUKAI;1169490002;Ne;6;3;0;9
13330;Zylutė;NYKŠTUKAI;3994691080;Ne;5;4;0;9
13331;Zylutė;NYKŠTUKAI;4894611078;Ne;0;2;0;2
13332;Zylutė;NYKŠTUKAI;7648922403;Ne;1;0;0;1
13333;Zylutė;NYKŠTUKAI;2113594059;Ne;14;2;0;16
13334;Zylutė;NYKŠTUKAI;9615779237;Ne;5;0;0;5
13335;Zylutė;NYKŠTUKAI;2604844156;Ne;13;0;0;13
13336;Zylutė;NYKŠTUKAI;2511658462;Ne;8;0;0;8
13337;Zylutė;NYKŠTUKAI;3035745273;Ne;7;0;3;10
13338;Zylutė;NYKŠTUKAI;2620903587;Ne;7;6;0;13
13339;Zylutė;NYKŠTUKAI;4706933533;Ne;9;0;0;9
13340;Zylutė;NYKŠTUKAI;9951774752;Ne;7;1;0;8
13341;Zylutė;Ručijok;5096881585;Ne;10;6;1;17
13342;Zylutė;Ručijok;3201966434;Ne;8;0;0;8
13343;Zylutė;Ručijok;9904758615;Ne;11;0;0;11
13344;Zylutė;Ručijok;4874246039;Ne;7;1;0;8
13345;Zylutė;Ručijok;6607670962;Ne;21;0;0;21
13346;Zylutė;Ručijok;2769424439;Ne;10;0;5;15
13347;Zylutė;Ručijok;1145229045;Ne;10;0;1;11
13348;Zylutė;Ručijok;3058040516;Ne;11;1;0;12
13349;Zylutė;Ručijok;2916622808;Ne;12;0;0;12
13350;Zylutė;Ručijok;5673557301;Ne;6;0;1;7
13351;Zylutė;Ručijok;5038936878;Ne;21;0;0;21
13352;Zylutė;Ručijok;2491905840;Ne;8;0;0;8
13353;Zylutė;Ručijok;7742044835;Ne;3;1;0;4
13354;Zylutė;Ručijok;5956114459;Ne;0;1;0;1
13355;Zylutė;Ručijok;6276017610;Ne;4;1;0;5
13356;Zylutė;Ručijok;3128535871;Ne;12;1;1;14
13357;Zylutė;Raduga;4811667497;Ne;5;4;2;11
13358;Zylutė;Raduga;5408157164;Ne;0;4;7;11
13359;Zylutė;"Miki Maus";9159342804;Ne;6;1;0;7
13360;Zylutė;"Miki Maus";8023418946;Ne;0;8;0;8
13361;Zylutė;"Miki Maus";5369354390;Ne;5;10;0;15
13362;Zylutė;"Miki Maus";9507157625;Ne;5;0;0;5
13363;Zylutė;"Miki Maus";8101232865;Ne;0;4;0;4
13364;Zylutė;"Miki Maus";9018673580;Ne;5;0;0;5
13365;Zylutė;"Miki Maus";7762245887;Ne;14;0;0;14
13366;Zylutė;"Miki Maus";9213491152;Ne;3;0;0;3
13367;Zylutė;"Miki Maus";3928932787;Ne;6;2;0;8
13368;Zylutė;"Miki Maus";4057419108;Ne;0;12;0;12
13369;Zylutė;"Miki Maus";3668160578;Ne;0;6;0;6
13370;Zylutė;"Miki Maus";9093777086;Ne;1;4;0;5
13371;Zylutė;"Miki Maus";7123399601;Ne;4;2;0;6
13372;Zylutė;"Miki Maus";5975875502;Ne;3;0;0;3
13373;Zylutė;"Miki Maus";2201317313;Ne;7;0;0;7
13374;Zylutė;Solnyško;8379932761;Ne;1;4;0;5
13375;Zylutė;Solnyško;5556769710;Ne;0;0;2;2
13376;Zylutė;Solnyško;2088316489;Ne;4;4;0;8
13377;Zylutė;Solnyško;1076803315;Ne;0;6;0;6
13378;Zylutė;Solnyško;7616444695;Ne;10;0;0;10
13379;Zylutė;Solnyško;5234846079;Ne;7;0;0;7
13380;Zylutė;Solnyško;5939522435;Ne;0;7;0;7
13381;Zylutė;Solnyško;5826813410;Ne;0;9;0;9
13382;Zylutė;Solnyško;7447067072;Ne;5;0;3;8
13383;Zylutė;Solnyško;1386683435;Ne;4;8;0;12
13384;Zylutė;Solnyško;4669449744;Ne;0;0;2;2
13385;Zylutė;Solnyško;4478652694;Ne;0;0;1;1
13386;Zylutė;Solnyško;6573541087;Ne;7;0;0;7
13387;Zylutė;Solnyško;2520744071;Ne;4;0;1;5
13388;Zylutė;Solnyško;3894885445;Ne;3;0;5;8
13389;Zylutė;Motyliok;7241045507;Ne;19;0;0;19
13390;Zylutė;Motyliok;9913001904;Ne;0;4;2;6
13391;Zylutė;Motyliok;5891900062;Ne;0;11;0;11
13392;Zylutė;Motyliok;8178488164;Ne;7;0;0;7
13393;Zylutė;Motyliok;5045652581;Ne;0;14;0;14
13394;Zylutė;Motyliok;9586800176;Ne;12;0;1;13
13395;Zylutė;Motyliok;4497904128;Ne;0;9;0;9
13396;Zylutė;Motyliok;9995791665;Ne;0;4;0;4
13397;Zylutė;Motyliok;1455822427;Ne;10;0;0;10
13398;Zylutė;Motyliok;3455374127;Ne;11;6;0;17
13399;Zylutė;Motyliok;1632490481;Ne;8;4;0;12
13400;Zylutė;Motyliok;1726060015;Ne;6;0;0;6
13401;Zylutė;Motyliok;6051657134;Ne;11;3;1;15
13402;Zylutė;Motyliok;3271366684;Ne;12;0;0;12
13403;Zylutė;Motyliok;3633983359;Ne;12;0;0;12
13404;Zylutė;Motyliok;9155513221;Ne;11;0;0;11
13405;Zylutė;ŽVIRBLIUKAI;6282501549;Ne;0;4;13;17
13406;Zylutė;ŽVIRBLIUKAI;1319040747;Ne;0;4;8;12
13407;Zylutė;ŽVIRBLIUKAI;8326987895;Ne;0;10;0;10
13408;Zylutė;ŽVIRBLIUKAI;9330583784;Ne;14;0;0;14
13409;Zylutė;ŽVIRBLIUKAI;9150157724;Ne;2;0;0;2
13410;Zylutė;ŽVIRBLIUKAI;8268700439;Ne;0;3;17;20
13411;Zylutė;ŽVIRBLIUKAI;1220439948;Ne;12;4;0;16
13412;Zylutė;ŽVIRBLIUKAI;4646273830;Ne;5;0;0;5
13413;Zylutė;ŽVIRBLIUKAI;9580188426;Ne;8;0;0;8
13414;Zylutė;ŽVIRBLIUKAI;1797701777;Ne;0;1;0;1
13415;Zylutė;ŽVIRBLIUKAI;2966482773;Ne;0;3;0;3
13416;Zylutė;ŽVIRBLIUKAI;1452384017;Ne;13;0;0;13
13417;Zylutė;ŽVIRBLIUKAI;8262929231;Ne;1;0;0;1
13418;Zylutė;ŽVIRBLIUKAI;8152140523;Ne;9;2;0;11
13419;Zylutė;ŽVIRBLIUKAI;8346794629;Ne;0;0;1;1
13420;Zylutė;ŽVIRBLIUKAI;2061747513;Ne;5;0;5;10
13421;Zylutė;"DRUŽNYJE REBIATA";5332039406;Ne;5;12;2;19
13422;Zylutė;"DRUŽNYJE REBIATA";9039665233;Ne;9;0;0;9
13423;Zylutė;"DRUŽNYJE REBIATA";6075614020;Ne;0;13;0;13
13424;Zylutė;"DRUŽNYJE REBIATA";9518714240;Ne;5;4;0;9
13425;Zylutė;"DRUŽNYJE REBIATA";2693961315;Ne;11;0;0;11
13426;Zylutė;"DRUŽNYJE REBIATA";3372639449;Ne;2;0;0;2
13427;Zylutė;"DRUŽNYJE REBIATA";4916625058;Ne;5;2;0;7
13428;Zylutė;"DRUŽNYJE REBIATA";3447644735;Ne;9;0;0;9
13429;Zylutė;"DRUŽNYJE REBIATA";3174042441;Ne;10;0;0;10
13430;Zylutė;"DRUŽNYJE REBIATA";6848387941;Ne;7;1;2;10
13431;Zylutė;"DRUŽNYJE REBIATA";1404949829;Ne;0;1;0;1
13432;Zylutė;"DRUŽNYJE REBIATA";4548205666;Ne;5;4;0;9
13433;Zylutė;"DRUŽNYJE REBIATA";6962852787;Ne;5;4;0;9
13434;Zylutė;"DRUŽNYJE REBIATA";9220918504;Ne;5;4;0;9
13435;Zylutė;"DRUŽNYJE REBIATA";9193349264;Ne;14;1;0;15
13436;Zylutė;"DRUŽNYJE REBIATA";2444440430;Ne;3;4;0;7
13437;Zylutė;"DRUŽNYJE REBIATA";8204885376;Ne;0;0;5;5
13438;Zylutė;"DRUŽNYJE REBIATA";6281989117;Ne;5;3;0;8
13439;Zylutė;"DRUŽNYJE REBIATA";9769201088;Ne;3;8;0;11
13440;Zylutė;"DRUŽNYJE REBIATA";5233163416;Ne;0;4;0;4
13441;Zylutė;"DRUŽNYJE REBIATA";6784471792;Ne;1;8;0;9
13442;Zylutė;VIEVERSĖLIAI;2125519672;Ne;2;0;0;2
13443;Zylutė;VIEVERSĖLIAI;4505081448;Ne;10;4;0;14
13444;Zylutė;VIEVERSĖLIAI;72716975865;Ne;7;6;0;13
13445;Zylutė;VIEVERSĖLIAI;6275164528;Ne;0;4;0;4
13446;Zylutė;VIEVERSĖLIAI;5172154642;Ne;0;4;0;4
13447;Zylutė;VIEVERSĖLIAI;2943888466;Ne;0;4;0;4
13448;Zylutė;VIEVERSĖLIAI;6907378757;Ne;2;6;0;8
13449;Zylutė;VIEVERSĖLIAI;4016518230;Ne;0;7;0;7
13450;Zylutė;VIEVERSĖLIAI;9660898505;Ne;0;13;0;13
13451;Zylutė;VIEVERSĖLIAI;5544338521;Ne;0;4;0;4
13452;Zylutė;VIEVERSĖLIAI;3246229837;Ne;0;2;0;2
13453;Zylutė;VIEVERSĖLIAI;27488840113;Ne;0;4;0;4
13454;Zylutė;VIEVERSĖLIAI;5162635301;Ne;7;2;0;9
13455;Zylutė;VIEVERSĖLIAI;1939618217;Ne;1;1;0;2
13456;Zylutė;VIEVERSĖLIAI;20569748356;Ne;5;3;0;8
13457;Zylutė;VIEVERSĖLIAI;1048279422;Ne;0;9;0;9
13458;Zylutė;VIEVERSĖLIAI;3919565034;Ne;0;6;0;6
13459;Zylutė;VIEVERSĖLIAI;6548786007;Ne;5;9;0;14
13460;Zylutė;VIEVERSĖLIAI;4154010905;Ne;2;0;0;2
13461;Zylutė;VIEVERSĖLIAI;3074954453;Ne;5;1;0;6
13462;Zylutė;VIEVERSĖLIAI;2364890732;Ne;1;4;0;5
13463;Želmenėliai;Bitučių;4681686872;Taip;0;1;0;1
13464;Želmenėliai;Bitučių;3268310531;Ne;9;0;0;9
13465;Želmenėliai;Bitučių;2122665619;Ne;5;7;0;12
13466;Želmenėliai;Bitučių;2563117992;Ne;9;0;0;9
13467;Želmenėliai;Bitučių;6799702725;Ne;0;3;0;3
13468;Želmenėliai;Bitučių;8358780570;Ne;0;4;3;7
13469;Želmenėliai;Bitučių;9006406225;Ne;4;6;0;10
13470;Želmenėliai;Bitučių;2102401372;Ne;0;4;0;4
13471;Želmenėliai;Bitučių;4931835807;Ne;3;5;0;8
13472;Želmenėliai;Bitučių;6481952132;Ne;0;5;0;5
13473;Želmenėliai;Bitučių;9611741258;Ne;5;6;0;11
13474;Želmenėliai;Bitučių;1619143702;Ne;7;0;0;7
13475;Želmenėliai;Bitučių;5314438217;Ne;0;5;0;5
13476;Želmenėliai;Bitučių;4927030144;Ne;16;2;0;18
13477;Želmenėliai;Bitučių;3739751121;Ne;8;2;0;10
13478;Želmenėliai;Bitučių;8028761330;Ne;2;0;0;2
13479;Želmenėliai;Bitučių;2853659708;Ne;5;1;0;6
13480;Želmenėliai;Bitučių;9207984505;Ne;0;16;0;16
13481;Želmenėliai;Kačiukų;1292462938;Ne;2;0;0;2
13482;Želmenėliai;Kačiukų;2350936740;Ne;12;2;0;14
13483;Želmenėliai;Kačiukų;3063417708;Ne;0;10;6;16
13484;Želmenėliai;Kačiukų;2570248893;Ne;0;3;0;3
13485;Želmenėliai;Kačiukų;2577850672;Ne;0;2;0;2
13486;Želmenėliai;Kačiukų;7197717698;Ne;15;0;3;18
13487;Želmenėliai;Kačiukų;7849682820;Ne;19;1;0;20
13488;Želmenėliai;Kačiukų;2111008869;Ne;5;4;2;11
13489;Želmenėliai;Kačiukų;4589396143;Ne;9;0;0;9
13490;Želmenėliai;Kačiukų;4198085732;Ne;4;0;0;4
13491;Želmenėliai;Kačiukų;6509783586;Ne;0;4;0;4
13492;Želmenėliai;Kačiukų;4126499046;Ne;0;6;0;6
13493;Želmenėliai;Kačiukų;4758240577;Ne;13;0;0;13
13494;Želmenėliai;Kačiukų;7094853897;Ne;13;0;0;13
13495;Želmenėliai;Kačiukų;9493581034;Ne;0;11;0;11
13496;Želmenėliai;Kačiukų;4931664953;Ne;13;1;0;14
13497;Želmenėliai;Kačiukų;4376978921;Ne;0;16;0;16
13498;Želmenėliai;Kačiukų;9313666706;Ne;8;0;0;8
13499;Želmenėliai;Kačiukų;8590129703;Ne;10;0;0;10
13500;Želmenėliai;Kačiukų;3959066963;Ne;0;2;2;4
13501;Želmenėliai;Kačiukų;6761848439;Ne;0;0;15;15
13502;Želmenėliai;Voveriukų;6343814445;Ne;0;2;0;2
13503;Želmenėliai;Voveriukų;7833143421;Ne;0;2;1;3
13504;Želmenėliai;Voveriukų;8418427863;Ne;0;4;0;4
13505;Želmenėliai;Voveriukų;5360157217;Ne;0;17;0;17
13506;Želmenėliai;Voveriukų;2545133678;Ne;2;0;0;2
13507;Želmenėliai;Voveriukų;7423900312;Ne;0;7;0;7
13508;Želmenėliai;Voveriukų;4968328834;Ne;10;0;0;10
13509;Želmenėliai;Voveriukų;2025424742;Ne;7;0;0;7
13510;Želmenėliai;Voveriukų;2924134152;Ne;15;1;0;16
13511;Želmenėliai;Voveriukų;5975166975;Ne;21;0;0;21
13512;Želmenėliai;Voveriukų;6857922902;Ne;11;1;0;12
13513;Želmenėliai;Voveriukų;9811131936;Ne;11;0;0;11
13514;Želmenėliai;Voveriukų;8968533318;Ne;0;11;0;11
13515;Želmenėliai;Voveriukų;6264955603;Ne;13;6;0;19
13516;Želmenėliai;Voveriukų;8952421941;Ne;6;5;0;11
13517;Želmenėliai;Voveriukų;7345540758;Ne;6;0;0;6
13518;Želmenėliai;Voveriukų;9709599805;Ne;0;4;0;4
13519;Želmenėliai;Voveriukų;4248374729;Ne;0;2;0;2
13520;Želmenėliai;Ežiukų;1652131150;Ne;0;2;0;2
13521;Želmenėliai;Ežiukų;5795735579;Ne;3;4;0;7
13522;Želmenėliai;Ežiukų;2311169187;Ne;0;5;0;5
13523;Želmenėliai;Ežiukų;3572462731;Ne;2;1;0;3
13524;Želmenėliai;Ežiukų;3353793939;Ne;9;0;2;11
13525;Želmenėliai;Ežiukų;7495157523;Ne;5;6;0;11
13526;Želmenėliai;Ežiukų;3972980949;Ne;0;7;0;7
13527;Želmenėliai;Ežiukų;6779746783;Ne;18;0;0;18
13528;Želmenėliai;Ežiukų;6876147546;Ne;0;5;0;5
13529;Želmenėliai;Ežiukų;9126715074;Ne;0;1;0;1
13530;Želmenėliai;Ežiukų;1260607572;Ne;0;1;0;1
13531;Želmenėliai;Ežiukų;5638248652;Ne;0;2;0;2
13532;Želmenėliai;Ežiukų;8154713582;Ne;0;0;1;1
13533;Želmenėliai;Ežiukų;2296870749;Ne;0;6;0;6
13534;Želmenėliai;Ežiukų;6180553648;Ne;0;6;0;6
13535;Želmenėliai;Ežiukų;5171736943;Ne;0;3;0;3
13536;Želmenėliai;Ežiukų;7294722095;Ne;20;6;0;26
13537;Želmenėliai;Ežiukų;4120125150;Ne;9;0;0;9
13538;Želmenėliai;Ežiukų;5281861477;Ne;0;5;0;5
13539;Želmenėliai;Ežiukų;8987377791;Ne;0;7;0;7
13540;Želmenėliai;Ežiukų;7373892344;Ne;0;1;0;1
13541;Želmenėliai;Peledžiukų;8491797555;Ne;11;8;0;19
13542;Želmenėliai;Peledžiukų;7058759730;Ne;0;4;0;4
13543;Želmenėliai;Peledžiukų;4485249321;Ne;6;4;0;10
13544;Želmenėliai;Peledžiukų;3869372021;Ne;0;3;0;3
13545;Želmenėliai;Peledžiukų;4374898642;Ne;9;0;0;9
13546;Želmenėliai;Peledžiukų;7751609462;Ne;2;0;0;2
13547;Želmenėliai;Peledžiukų;5929410363;Ne;0;1;0;1
13548;Želmenėliai;Peledžiukų;5205425589;Ne;0;1;0;1
13549;Želmenėliai;Peledžiukų;5362390260;Ne;3;1;0;4
13550;Želmenėliai;Peledžiukų;1580370689;Ne;0;2;0;2
13551;Želmenėliai;Peledžiukų;7672980212;Ne;0;12;0;12
13552;Želmenėliai;Peledžiukų;6260153299;Ne;5;0;0;5
13553;Želmenėliai;Peledžiukų;6187661667;Ne;3;2;0;5
13554;Želmenėliai;Peledžiukų;6109546917;Ne;7;9;0;16
13555;Želmenėliai;Peledžiukų;8118696261;Ne;7;1;0;8
13556;Želmenėliai;Peledžiukų;4746898209;Ne;0;2;0;2
13557;Želmenėliai;Peledžiukų;9929149682;Ne;0;3;0;3
13558;Želmenėliai;Peledžiukų;3723155757;Ne;0;8;0;8
13559;Želmenėliai;Peledžiukų;6662439747;Ne;0;4;0;4
13560;Želmenėliai;Drugelių;7664430346;Ne;4;5;0;9
13561;Želmenėliai;Drugelių;3417538909;Ne;0;3;0;3
13562;Želmenėliai;Drugelių;3295852546;Ne;11;6;0;17
13563;Želmenėliai;Drugelių;3379266015;Ne;4;11;0;15
13564;Želmenėliai;Drugelių;1984105453;Ne;19;4;0;23
13565;Želmenėliai;Drugelių;4652412483;Ne;0;5;0;5
13566;Želmenėliai;Drugelių;1652949383;Ne;0;3;0;3
13567;Želmenėliai;Drugelių;5046836398;Ne;4;8;0;12
13568;Želmenėliai;Drugelių;9237611484;Ne;0;0;1;1
13569;Želmenėliai;Drugelių;13558387807;Ne;5;2;0;7
13570;Želmenėliai;Drugelių;5143554665;Ne;0;4;0;4
13571;Želmenėliai;Drugelių;7585159351;Ne;0;4;0;4
13572;Želmenėliai;Drugelių;4634346755;Ne;3;8;0;11
13573;Želmenėliai;Drugelių;4916436238;Ne;0;8;0;8
13574;Želmenėliai;Drugelių;5558795651;Ne;0;7;0;7
13575;Želmenėliai;Drugelių;7572597061;Ne;6;0;3;9
13576;Želmenėliai;Voriukų;4264751761;Ne;0;8;0;8
13577;Želmenėliai;Voriukų;1203343580;Ne;0;5;0;5
13578;Želmenėliai;Voriukų;9351650342;Ne;0;3;0;3
13579;Želmenėliai;Voriukų;6916426436;Ne;0;5;0;5
13580;Želmenėliai;Voriukų;7563461821;Ne;0;3;0;3
13581;Želmenėliai;Voriukų;4534946646;Ne;12;0;0;12
13582;Želmenėliai;Voriukų;4075533071;Ne;0;3;0;3
13583;Želmenėliai;Voriukų;4545012342;Ne;0;1;0;1
13584;Želmenėliai;Voriukų;7505996978;Ne;9;10;0;19
13585;Želmenėliai;Voriukų;2722619508;Ne;17;2;0;19
13586;Želmenėliai;Voriukų;5025345647;Ne;9;4;0;13
13587;Želmenėliai;Voriukų;8892137326;Ne;0;2;0;2
13588;Želmenėliai;Voriukų;7700521261;Ne;0;5;0;5
13589;Želmenėliai;Voriukų;1649724696;Ne;0;1;0;1
13590;Želmenėliai;Voriukų;5794346039;Ne;7;1;0;8
13591;Želmenėliai;Voriukų;8273301992;Ne;11;0;5;16
13592;Želmenėliai;Boružėlių;7792850272;Ne;4;0;0;4
13593;Želmenėliai;Boružėlių;1764468979;Ne;0;5;0;5
13594;Želmenėliai;Boružėlių;5161934903;Ne;0;5;0;5
13595;Želmenėliai;Boružėlių;8722573513;Ne;0;3;0;3
13596;Želmenėliai;Boružėlių;3516695805;Ne;6;10;0;16
13597;Želmenėliai;Boružėlių;5949535657;Ne;9;0;0;9
13598;Želmenėliai;Boružėlių;7077832687;Ne;0;8;0;8
13599;Želmenėliai;Boružėlių;3896171121;Ne;4;12;0;16
13600;Želmenėliai;Boružėlių;2951719129;Ne;9;5;0;14
13601;Želmenėliai;Boružėlių;2066439950;Ne;0;4;0;4
13602;Želmenėliai;Boružėlių;5207899503;Ne;0;16;0;16
13603;Želmenėliai;Boružėlių;2111705047;Ne;0;1;0;1
13604;Želmenėliai;Boružėlių;5514167627;Ne;5;17;0;22
13605;Želmenėliai;Boružėlių;8474210476;Ne;1;0;0;1
13606;Želmenėliai;Boružėlių;2179165096;Ne;6;12;0;18
13607;Želmenėliai;Pūkuotukų;3258904017;Ne;0;1;0;1
13608;Želmenėliai;Pūkuotukų;8667865301;Ne;0;4;8;12
13609;Želmenėliai;Pūkuotukų;1952686295;Ne;0;5;0;5
13610;Želmenėliai;Pūkuotukų;5787772212;Ne;0;7;0;7
13611;Želmenėliai;Pūkuotukų;2727113833;Ne;4;5;0;9
13612;Želmenėliai;Pūkuotukų;9359070885;Ne;0;1;2;3
13613;Želmenėliai;Pūkuotukų;6816346946;Ne;0;1;0;1
13614;Želmenėliai;Pūkuotukų;37152467004;Ne;5;5;0;10
13615;Želmenėliai;Pūkuotukų;5842563754;Ne;0;7;0;7
13616;Želmenėliai;Pūkuotukų;1941723687;Ne;0;3;0;3
13617;Želmenėliai;Pūkuotukų;1239398642;Ne;0;1;0;1
13618;Želmenėliai;Pūkuotukų;5616709457;Ne;8;11;0;19
13619;Želmenėliai;Pūkuotukų;4206128805;Ne;0;1;0;1
13620;Želmenėliai;Pūkuotukų;1248541555;Ne;0;5;0;5
13621;Želmenėliai;Pūkuotukų;8300887366;Ne;5;7;0;12
13622;Želmenėliai;Pūkuotukų;1582618217;Ne;0;6;0;6
13623;Želmenėliai;Ančiukų;4979494010;Ne;5;2;0;7
13624;Želmenėliai;Ančiukų;7925266303;Ne;8;1;0;9
13625;Želmenėliai;Ančiukų;9377359390;Ne;5;0;6;11
13626;Želmenėliai;Ančiukų;2578675950;Ne;15;0;0;15
13627;Želmenėliai;Ančiukų;8060048377;Ne;19;0;0;19
13628;Želmenėliai;Ančiukų;1606079948;Ne;9;3;0;12
13629;Želmenėliai;Ančiukų;9250666159;Ne;31;0;0;31
13630;Želmenėliai;Ančiukų;5569699398;Ne;31;0;0;31
13631;Želmenėliai;Ančiukų;3926238501;Ne;13;13;0;26
13632;Želmenėliai;Ančiukų;4207070475;Ne;0;10;0;10
13633;Želmenėliai;Ančiukų;8409831053;Ne;8;0;0;8
13634;Želmenėliai;Ančiukų;3608041516;Ne;1;1;1;3
13635;Želmenėliai;Ančiukų;8165683014;Ne;11;0;3;14
13636;Želmenėliai;Ančiukų;3172645969;Ne;22;1;0;23
13637;Želmenėliai;Ančiukų;7128213908;Ne;8;12;0;20
13638;Želmenėliai;Nykštukų;6230010537;Ne;0;5;0;5
13639;Želmenėliai;Nykštukų;4722890143;Ne;0;2;0;2
13640;Želmenėliai;Nykštukų;5052052744;Ne;18;0;1;19
13641;Želmenėliai;Nykštukų;6764567873;Ne;8;10;0;18
13642;Želmenėliai;Nykštukų;1025894534;Ne;0;8;0;8
13643;Želmenėliai;Nykštukų;9901320882;Ne;11;0;1;12
13644;Želmenėliai;Nykštukų;4526936339;Ne;16;0;1;17
13645;Želmenėliai;Nykštukų;8276857357;Ne;0;4;0;4
13646;Želmenėliai;Nykštukų;3232996198;Ne;18;0;0;18
13647;Želmenėliai;Nykštukų;2878494111;Ne;11;3;0;14
13648;Želmenėliai;Nykštukų;5169813205;Ne;2;0;0;2
13649;Želmenėliai;Nykštukų;7341132501;Ne;13;0;0;13
13650;Želmenėliai;Nykštukų;9661692350;Ne;0;7;0;7
13651;Želmenėliai;Nykštukų;3003922213;Ne;13;0;0;13
13652;Želmenėliai;Nykštukų;7123290599;Ne;20;0;0;20
13653;Želmenėliai;Lašelių;8654298177;Ne;4;0;0;4
13654;Želmenėliai;Lašelių;4451798870;Ne;5;0;0;5
13655;Želmenėliai;Lašelių;4485851428;Ne;6;5;0;11
13656;Želmenėliai;Lašelių;2501163903;Ne;0;4;0;4
13657;Želmenėliai;Lašelių;9076874685;Ne;5;7;0;12
13658;Želmenėliai;Lašelių;3346680108;Ne;8;10;0;18
13659;Želmenėliai;Lašelių;4679930998;Ne;0;9;0;9
13660;Želmenėliai;Lašelių;3344426717;Ne;3;0;0;3
13661;Želmenėliai;Lašelių;9483665065;Ne;9;2;0;11
13662;Želmenėliai;Lašelių;9182208354;Ne;5;5;0;10
13663;Želmenėliai;Lašelių;8104790589;Ne;9;0;0;9
13664;Želmenėliai;Lašelių;9544233589;Ne;5;0;0;5
13665;Želmenėliai;Lašelių;3979635800;Ne;9;0;0;9
13666;Žemyna;Čiauškučiai;9985529041;Ne;1;1;2;4
13667;Žemyna;Čiauškučiai;9570187081;Ne;1;0;6;7
13668;Žemyna;Čiauškučiai;2547436771;Ne;0;12;0;12
13669;Žemyna;Čiauškučiai;6051208732;Ne;0;1;0;1
13670;Žemyna;Čiauškučiai;6346173832;Ne;5;0;1;6
13671;Žemyna;Čiauškučiai;8694608716;Ne;7;1;0;8
13672;Žemyna;Čiauškučiai;3074391266;Ne;6;0;4;10
13673;Žemyna;Čiauškučiai;4693414703;Ne;5;0;0;5
13674;Žemyna;Čiauškučiai;1365045512;Ne;6;0;0;6
13675;Žemyna;Čiauškučiai;7620179886;Ne;5;0;3;8
13676;Žemyna;Čiauškučiai;2792702536;Ne;9;0;1;10
13677;Žemyna;Čiauškučiai;7376806308;Ne;0;4;0;4
13678;Žemyna;Čiauškučiai;7277970673;Ne;13;0;2;15
13679;Žemyna;Čiauškučiai;5069437469;Ne;7;6;1;14
13680;Žemyna;Čiauškučiai;7427119736;Ne;0;5;1;6
13681;Žemyna;Čiauškučiai;4642600915;Ne;0;4;1;5
13682;Žemyna;Čiauškučiai;2354265632;Ne;6;0;2;8
13683;Žemyna;Čiauškučiai;2887459684;Ne;0;4;2;6
13684;Žemyna;Čiauškučiai;1654157342;Ne;0;11;0;11
13685;Žemyna;Čiauškučiai;4652384557;Ne;12;0;0;12
13686;Žemyna;Čiauškučiai;7352868453;Ne;3;4;0;7
13687;Žemyna;Čiauškučiai;4501408683;Ne;10;4;2;16
13688;Žemyna;Čiauškučiai;4613946229;Ne;5;4;1;10
13689;Žemyna;Čiauškučiai;7675699775;Ne;2;5;0;7
13690;Žemyna;Nykštukai;5114094924;Ne;2;6;0;8
13691;Žemyna;Nykštukai;3874855308;Ne;6;0;0;6
13692;Žemyna;Nykštukai;2461700030;Ne;0;5;0;5
13693;Žemyna;Nykštukai;1725771976;Ne;0;0;8;8
13694;Žemyna;Nykštukai;3643594001;Ne;0;4;0;4
13695;Žemyna;Nykštukai;9182709647;Ne;0;3;0;3
13696;Žemyna;Nykštukai;7121742098;Ne;0;6;0;6
13697;Žemyna;Nykštukai;3519840747;Ne;0;4;0;4
13698;Žemyna;Nykštukai;1468040559;Ne;2;0;1;3
13699;Žemyna;Nykštukai;4322192775;Ne;0;4;0;4
13700;Žemyna;Nykštukai;4444870782;Ne;0;5;0;5
13701;Žemyna;Nykštukai;7781924111;Ne;0;3;0;3
13702;Žemyna;Nykštukai;4257096808;Ne;5;2;0;7
13703;Žemyna;Nykštukai;2860210906;Ne;0;0;12;12
13704;Žemyna;Nykštukai;7832066079;Ne;5;3;0;8
13705;Žemyna;Nykštukai;9653530823;Ne;0;6;0;6
13706;Žemyna;Nykštukai;7508491119;Ne;0;5;1;6
13707;Žemyna;Nykštukai;2928125522;Ne;0;1;0;1
13708;Žemyna;Nykštukai;4524929331;Ne;0;1;0;1
13709;Žemyna;Nykštukai;4759403487;Ne;0;5;0;5
13710;Žemyna;Voveriukai;9855080887;Ne;0;1;0;1
13711;Žemyna;Voveriukai;6912605631;Ne;0;5;0;5
13712;Žemyna;Voveriukai;8525229514;Ne;5;1;1;7
13713;Žemyna;Voveriukai;1846287760;Ne;4;4;0;8
13714;Žemyna;Voveriukai;8775518984;Ne;1;1;1;3
13715;Žemyna;Voveriukai;8926045231;Ne;10;8;0;18
13716;Žemyna;Voveriukai;3860791215;Ne;0;3;0;3
13717;Žemyna;Voveriukai;8185243991;Ne;0;13;0;13
13718;Žemyna;Voveriukai;9471382383;Ne;0;2;0;2
13719;Žemyna;Voveriukai;4549562657;Ne;21;0;0;21
13720;Žemyna;Voveriukai;8882641275;Ne;0;13;0;13
13721;Žemyna;Voveriukai;7121061078;Ne;3;1;0;4
13722;Žemyna;Voveriukai;4900914346;Ne;1;0;0;1
13723;Žemyna;Voveriukai;8241038433;Ne;0;7;0;7
13724;Žemyna;Voveriukai;5450351549;Ne;0;4;0;4
13725;Žemyna;Voveriukai;5189603013;Ne;6;0;0;6
13726;Žemyna;Voveriukai;3500358886;Ne;3;0;1;4
13727;Žemyna;Voveriukai;6592356004;Ne;9;0;0;9
13728;Žemyna;Kiškučiai;8622780639;Ne;13;0;0;13
13729;Žemyna;Kiškučiai;1575505075;Ne;0;4;3;7
13730;Žemyna;Kiškučiai;39916867354;Ne;0;1;1;2
13731;Žemyna;Kiškučiai;4317779866;Ne;8;0;0;8
13732;Žemyna;Kiškučiai;5258444578;Ne;0;4;1;5
13733;Žemyna;Kiškučiai;7785889259;Ne;0;4;1;5
13734;Žemyna;Kiškučiai;7676796264;Ne;0;7;0;7
13735;Žemyna;Kiškučiai;6536698798;Ne;11;4;0;15
13736;Žemyna;Kiškučiai;8139714064;Ne;0;4;0;4
13737;Žemyna;Kiškučiai;2090395417;Ne;0;7;0;7
13738;Žemyna;Kiškučiai;3895238312;Ne;12;0;1;13
13739;Žemyna;Kiškučiai;4519502372;Ne;0;4;10;14
13740;Žemyna;Kiškučiai;2137718635;Ne;0;1;0;1
13741;Žemyna;Kiškučiai;8018865138;Ne;0;6;0;6
13742;Žemyna;Kiškučiai;1717797530;Ne;2;4;2;8
13743;Žemyna;Kiškučiai;1058705875;Ne;0;7;0;7
13744;Žemyna;Kiškučiai;5233574060;Ne;19;0;0;19
13745;Žemyna;Kiškučiai;15110117571;Ne;12;1;0;13
13746;Žemyna;Kiškučiai;9219519029;Ne;0;9;0;9
13747;Žemyna;Kiškučiai;3875204515;Ne;0;1;0;1
13748;Žemyna;Kiškučiai;7638038269;Ne;0;1;0;1
13749;Žemyna;Vyturiukai;2526949655;Ne;10;1;0;11
13750;Žemyna;Vyturiukai;1417007895;Ne;0;4;0;4
13751;Žemyna;Vyturiukai;5355845891;Ne;0;0;5;5
13752;Žemyna;Vyturiukai;1481273689;Ne;15;0;0;15
13753;Žemyna;Vyturiukai;7781332622;Ne;0;9;0;9
13754;Žemyna;Vyturiukai;9366133892;Ne;0;2;0;2
13755;Žemyna;Vyturiukai;5204349188;Ne;8;0;0;8
13756;Žemyna;Vyturiukai;1345704379;Ne;0;0;1;1
13757;Žemyna;Vyturiukai;6097681172;Ne;0;6;0;6
13758;Žemyna;Vyturiukai;5133115712;Ne;3;2;0;5
13759;Žemyna;Vyturiukai;5416338054;Ne;3;2;0;5
13760;Žemyna;Vyturiukai;3446774478;Ne;12;0;0;12
13761;Žemyna;Vyturiukai;6271057561;Ne;0;2;0;2
13762;Žemyna;Vyturiukai;2304633263;Ne;0;0;8;8
13763;Žemyna;Vyturiukai;3679990879;Ne;0;0;6;6
13764;Žemyna;Vyturiukai;8461326396;Ne;0;0;21;21
13765;Žemyna;Vyturiukai;8681308720;Ne;0;2;1;3
13766;Žemyna;Vyturiukai;8577299116;Ne;14;0;3;17
13767;Žemyna;Vyturiukai;9646494715;Ne;0;1;0;1
13768;Žemyna;Vyturiukai;4863350801;Ne;10;0;0;10
13769;Žemyna;Vyturiukai;5655302107;Ne;0;6;0;6
13770;Žemyna;Pelėdžiukai;8040359407;Ne;5;0;0;5
13771;Žemyna;Pelėdžiukai;37570629861;Ne;5;9;0;14
13772;Žemyna;Pelėdžiukai;55161890341;Ne;5;0;0;5
13773;Žemyna;Pelėdžiukai;59506345859;Ne;0;7;0;7
13774;Žemyna;Pelėdžiukai;85135645557;Ne;0;4;0;4
13775;Žemyna;Pelėdžiukai;38769607968;Ne;0;4;0;4
13776;Žemyna;Pelėdžiukai;4235160760;Ne;2;3;1;6
13777;Žemyna;Pelėdžiukai;3622634119;Ne;2;4;1;7
13778;Žemyna;Pelėdžiukai;6618285685;Ne;0;4;0;4
13779;Žemyna;Pelėdžiukai;5306392307;Ne;3;6;2;11
13780;Žemyna;Pelėdžiukai;5508251792;Ne;0;10;0;10
13781;Žemyna;Pelėdžiukai;9018138289;Ne;2;0;5;7
13782;Žemyna;Pelėdžiukai;8096035110;Ne;14;0;0;14
13783;Žemyna;Pelėdžiukai;1687206394;Ne;0;1;0;1
13784;Žemyna;Pelėdžiukai;93423088394;Ne;0;1;0;1
13785;Žemyna;Pelėdžiukai;5933910526;Ne;5;4;0;9
13786;Žemyna;Pelėdžiukai;5506889213;Ne;0;3;0;3
13787;Žemyna;Pelėdžiukai;5815116293;Ne;3;3;1;7
13788;Žemyna;Pelėdžiukai;13242930752;Ne;0;4;0;4
13789;Žemyna;Pelėdžiukai;89787441782;Ne;5;4;0;9
13790;Žemyna;Pelėdžiukai;9224203811;Ne;0;1;7;8
13791;Žemyna;Pelėdžiukai;2527337934;Ne;21;0;0;21
13792;Žemyna;Pelėdžiukai;1867198805;Ne;0;8;0;8
13793;Žemyna;Vijurkai;8500642069;Ne;0;3;0;3
13794;Žemyna;Vijurkai;9148594407;Ne;5;4;1;10
13795;Žemyna;Vijurkai;6812823390;Ne;0;4;0;4
13796;Žemyna;Vijurkai;3938938667;Ne;0;2;0;2
13797;Žemyna;Vijurkai;7125026803;Ne;0;4;1;5
13798;Žemyna;Vijurkai;7693278353;Ne;0;9;0;9
13799;Žemyna;Vijurkai;6430348135;Ne;0;3;0;3
13800;Žemyna;Vijurkai;2976467316;Ne;0;1;0;1
13801;Žemyna;Vijurkai;3357339710;Ne;2;4;1;7
13802;Žemyna;Vijurkai;7341750699;Ne;0;0;1;1
13803;Žemyna;Vijurkai;5940619734;Ne;0;3;0;3
13804;Žemyna;Vijurkai;7925774308;Ne;2;3;4;9
13805;Žemyna;Vijurkai;9958040413;Ne;0;4;0;4
13806;Žemyna;Vijurkai;1531980297;Ne;0;3;1;4
13807;Žemyna;Vijurkai;9866110744;Ne;0;0;2;2
13808;Žemyna;Vijurkai;2412956023;Ne;0;13;0;13
13809;Žemyna;Vijurkai;1118997229;Ne;0;0;1;1
13810;Žemyna;Vijurkai;1114714466;Ne;0;4;4;8
13811;Žemyna;Vijurkai;5318574856;Ne;0;1;5;6
13812;Žemyna;Vijurkai;1264659113;Ne;0;14;0;14
13813;Žemyna;Vijurkai;4410293832;Ne;0;4;1;5
13814;Žemyna;Vijurkai;1652681820;Ne;0;4;2;6
13815;Žemyna;Šnekučiai;9501126807;Ne;4;4;0;8
13816;Žemyna;Šnekučiai;6735720135;Ne;10;0;0;10
13817;Žemyna;Šnekučiai;2006173745;Ne;0;5;0;5
13818;Žemyna;Šnekučiai;6116581655;Ne;1;0;0;1
13819;Žemyna;Šnekučiai;6419974691;Ne;2;4;3;9
13820;Žemyna;Šnekučiai;7764615445;Ne;0;1;6;7
13821;Žemyna;Šnekučiai;5868208651;Ne;0;11;0;11
13822;Žemyna;Šnekučiai;3992383447;Ne;4;0;1;5
13823;Žemyna;Šnekučiai;9668975591;Ne;0;1;0;1
13824;Žemyna;Šnekučiai;5188496664;Ne;0;4;0;4
13825;Žemyna;Šnekučiai;4872348199;Ne;2;1;2;5
13826;Žemyna;Šnekučiai;6878669773;Ne;0;9;0;9
13827;Žemyna;Šnekučiai;4502958166;Ne;8;4;0;12
13828;Žemyna;Šnekučiai;6728229865;Ne;0;3;0;3
13829;Žemyna;Šnekučiai;2710551760;Ne;0;0;3;3
13830;Žemyna;Šnekučiai;4612112289;Ne;0;0;4;4
13831;Žemyna;Šnekučiai;9568886284;Ne;14;0;1;15
13832;Žemyna;Šnekučiai;3982766622;Ne;0;6;2;8
13833;Žemyna;Pabiručiai;9827401825;Ne;0;4;1;5
13834;Žemyna;Pabiručiai;5743535463;Ne;0;19;0;19
13835;Žemyna;Pabiručiai;7005045961;Ne;0;5;0;5
13836;Žemyna;Pabiručiai;1745197274;Ne;0;9;0;9
13837;Žemyna;Pabiručiai;6041223291;Ne;5;0;6;11
13838;Žemyna;Pabiručiai;9094718595;Ne;0;4;2;6
13839;Žemyna;Pabiručiai;6208953341;Ne;0;4;0;4
13840;Žemyna;Pabiručiai;1656335765;Ne;0;3;0;3
13841;Žemyna;Pabiručiai;5127174926;Ne;0;9;1;10
13842;Žemyna;Pabiručiai;8559870965;Ne;0;2;1;3
13843;Žemyna;Pabiručiai;1850100203;Ne;5;3;3;11
13844;Žemyna;Pabiručiai;6450681255;Ne;4;0;0;4
13845;Žemyna;Pabiručiai;4237778022;Ne;0;0;2;2
13846;Žemyna;Pabiručiai;2414400761;Ne;0;9;0;9
13847;Žemyna;Pabiručiai;9511935264;Ne;0;7;0;7
13848;Žemyna;Pabiručiai;4176386795;Ne;9;3;0;12
13849;Žemyna;Pabiručiai;4960936366;Ne;11;0;10;21
13850;Žemyna;Drugeliai;7564693757;Ne;0;0;2;2
13851;Žemyna;Drugeliai;8302345911;Ne;10;4;1;15
13852;Žemyna;Drugeliai;3505551915;Ne;2;0;4;6
13853;Žemyna;Drugeliai;2231967652;Ne;0;0;10;10
13854;Žemyna;Drugeliai;3755964840;Ne;9;4;0;13
13855;Žemyna;Drugeliai;9171823612;Ne;0;0;16;16
13856;Žemyna;Drugeliai;5518125715;Ne;0;0;2;2
13857;Žemyna;Drugeliai;9589582451;Ne;0;4;5;9
13858;Žemyna;Drugeliai;2102920661;Ne;7;0;1;8
13859;Žemyna;Drugeliai;6575272457;Ne;8;0;0;8
13860;Žemyna;Drugeliai;6164541167;Ne;5;0;0;5
13861;Žemyna;Drugeliai;7461187735;Ne;7;0;0;7
13862;Žemyna;Drugeliai;3390442637;Ne;12;0;4;16
13863;Žemyna;Drugeliai;2139103576;Ne;0;0;4;4
13864;Žemyna;Drugeliai;7920398415;Ne;5;3;0;8
13865;Žemyna;Drugeliai;1695063377;Ne;6;0;1;7
13866;Žemyna;Drugeliai;7745383607;Ne;6;0;0;6
13867;Žemyna;Drugeliai;7661182825;Ne;0;0;1;1
13868;Žemyna;Drugeliai;4861799571;Ne;0;0;2;2
13869;Žemyna;Drugeliai;8709792653;Ne;10;0;0;10
13870;Žemyna;"ŽIRNIUKAI ";4540472310;Ne;5;9;0;14
13871;Žemyna;"ŽIRNIUKAI ";9647706055;Ne;5;4;2;11
13872;Žemyna;"ŽIRNIUKAI ";2883862675;Ne;5;0;0;5
13873;Žemyna;"ŽIRNIUKAI ";8638419172;Ne;9;0;2;11
13874;Žemyna;"ŽIRNIUKAI ";7537145330;Ne;19;0;0;19
13875;Žemyna;"ŽIRNIUKAI ";7683443675;Ne;19;0;0;19
13876;Žemyna;"ŽIRNIUKAI ";5262196604;Ne;12;0;0;12
13877;Žemyna;"ŽIRNIUKAI ";9796331127;Ne;0;3;0;3
13878;Žemyna;"ŽIRNIUKAI ";3996577758;Ne;3;0;0;3
13879;Žemyna;"ŽIRNIUKAI ";6783675344;Ne;16;0;0;16
13880;Žemyna;"ŽIRNIUKAI ";9082375371;Ne;16;0;0;16
13881;Žemyna;"ŽIRNIUKAI ";1795919515;Ne;0;0;6;6
13882;Žemyna;"ŽIRNIUKAI ";3899901920;Ne;0;21;0;21
13883;Žemyna;"ŽIRNIUKAI ";7831778620;Ne;5;3;5;13
13884;Žemyna;"ŽIRNIUKAI ";8319442149;Ne;0;0;5;5
13885;Žemyna;"ŽIOGELIAI ";5193466394;Ne;5;7;0;12
13886;Žemyna;"ŽIOGELIAI ";5968816137;Ne;5;0;0;5
13887;Žemyna;"ŽIOGELIAI ";4238528111;Ne;4;0;0;4
13888;Žemyna;"ŽIOGELIAI ";3741459808;Ne;4;0;0;4
13889;Žemyna;"ŽIOGELIAI ";3164469202;Ne;0;5;0;5
13890;Žemyna;"ŽIOGELIAI ";3870917221;Ne;0;0;2;2
13891;Žemyna;"ŽIOGELIAI ";6571952468;Ne;0;0;1;1
13892;Žemyna;"ŽIOGELIAI ";6632827240;Ne;16;0;0;16
13893;Žemyna;"ŽIOGELIAI ";3935318882;Ne;14;0;0;14
13894;Žemyna;"ŽIOGELIAI ";2010676445;Ne;14;0;0;14
13895;Žemyna;"ŽIOGELIAI ";8365200813;Ne;0;0;3;3
13896;Žemyna;"ŽIOGELIAI ";1581399038;Ne;2;0;1;3
13897;Žemyna;"ŽIOGELIAI ";8611258788;Ne;12;0;0;12
13898;Žemyna;"ŽIOGELIAI ";9788890112;Ne;17;0;0;17
13899;Žemyna;"ŽIOGELIAI ";3324631994;Ne;1;3;0;4
13900;Žemuogėlė;Boružiukai;1350671777;Ne;14;0;0;14
13901;Žemuogėlė;Boružiukai;9344628661;Ne;5;4;0;9
13902;Žemuogėlė;Boružiukai;2158359435;Ne;14;0;0;14
13903;Žemuogėlė;Boružiukai;1639634300;Taip;12;1;0;13
13904;Žemuogėlė;Boružiukai;5521993938;Ne;0;0;11;11
13905;Žemuogėlė;Boružiukai;1267222057;Ne;5;8;0;13
13906;Žemuogėlė;Boružiukai;9562512849;Ne;14;2;0;16
13907;Žemuogėlė;Boružiukai;8661864424;Ne;4;1;0;5
13908;Žemuogėlė;Boružiukai;1150466286;Ne;4;4;0;8
13909;Žemuogėlė;Boružiukai;8040255583;Ne;3;4;1;8
13910;Žemuogėlė;Boružiukai;2190458676;Ne;7;0;0;7
13911;Žemuogėlė;Boružiukai;6073591450;Ne;0;0;6;6
13912;Žemuogėlė;Boružiukai;7328566035;Taip;0;0;5;5
13913;Žemuogėlė;Boružiukai;8557325116;Ne;13;1;2;16
13914;Žemuogėlė;Boružiukai;1350383125;Ne;4;0;0;4
13915;Žemuogėlė;Boružiukai;7050896262;Ne;9;2;0;11
13916;Žemuogėlė;Boružiukai;3413805578;Ne;0;0;1;1
13917;Žemuogėlė;Boružiukai;1187953952;Ne;6;0;0;6
13918;Žemuogėlė;Boružiukai;3677459716;Ne;0;9;0;9
13919;Žemuogėlė;Boružiukai;8426601160;Ne;1;0;4;5
13920;Žemuogėlė;Boružiukai;5911215640;Ne;12;1;1;14
13921;Žemuogėlė;Šviesuliukai;3837424301;Ne;2;6;0;8
13922;Žemuogėlė;Šviesuliukai;5499401648;Ne;0;3;0;3
13923;Žemuogėlė;Šviesuliukai;9599829363;Ne;0;5;0;5
13924;Žemuogėlė;Šviesuliukai;3746045950;Ne;0;12;0;12
13925;Žemuogėlė;Šviesuliukai;4663181188;Ne;11;3;0;14
13926;Žemuogėlė;Šviesuliukai;8492878852;Taip;11;1;0;12
13927;Žemuogėlė;Šviesuliukai;7603740057;Ne;19;4;0;23
13928;Žemuogėlė;Šviesuliukai;6755278376;Ne;4;0;2;6
13929;Žemuogėlė;Šviesuliukai;4506847669;Ne;6;2;0;8
13930;Žemuogėlė;Šviesuliukai;7837251012;Ne;5;1;0;6
13931;Žemuogėlė;Šviesuliukai;7189855370;Ne;0;11;0;11
13932;Žemuogėlė;Šviesuliukai;3801534195;Ne;0;10;0;10
13933;Žemuogėlė;Šviesuliukai;1341637008;Ne;0;2;0;2
13934;Žemuogėlė;Šviesuliukai;8890454460;Ne;0;1;0;1
13935;Žemuogėlė;Šviesuliukai;7288060676;Ne;28;0;0;28
13936;Žemuogėlė;Šviesuliukai;6086270618;Ne;9;2;0;11
13937;Žemuogėlė;Šviesuliukai;7551522580;Ne;4;0;1;5
13938;Žemuogėlė;Lašiukai;3190523750;Ne;5;0;2;7
13939;Žemuogėlė;Lašiukai;1251497003;Ne;0;5;0;5
13940;Žemuogėlė;Lašiukai;3706531223;Ne;7;5;0;12
13941;Žemuogėlė;Lašiukai;8029484123;Ne;11;2;0;13
13942;Žemuogėlė;Lašiukai;5992802843;Ne;0;9;0;9
13943;Žemuogėlė;Lašiukai;3753156044;Ne;2;2;0;4
13944;Žemuogėlė;Lašiukai;7592566602;Ne;8;0;2;10
13945;Žemuogėlė;Lašiukai;3546429231;Ne;0;14;0;14
13946;Žemuogėlė;Lašiukai;9579921777;Ne;0;15;0;15
13947;Žemuogėlė;Lašiukai;7137182934;Ne;0;0;2;2
13948;Žemuogėlė;Lašiukai;3073956225;Taip;5;2;0;7
13949;Žemuogėlė;Lašiukai;3825509486;Ne;0;6;0;6
13950;Žemuogėlė;Lašiukai;3059525247;Ne;5;4;0;9
13951;Žemuogėlė;Lašiukai;6747566307;Ne;3;2;0;5
13952;Žemuogėlė;Lašiukai;2115883173;Ne;18;0;1;19
13953;Žemuogėlė;Skambaliukai;54663750186;Ne;0;4;0;4
13954;Žemuogėlė;Skambaliukai;4231767115;Ne;0;3;0;3
13955;Žemuogėlė;Skambaliukai;3977351017;Ne;1;2;1;4
13956;Žemuogėlė;Skambaliukai;5147617128;Ne;7;10;0;17
13957;Žemuogėlė;Skambaliukai;1058207935;Ne;11;4;0;15
13958;Žemuogėlė;Skambaliukai;6962103028;Ne;0;5;0;5
13959;Žemuogėlė;Skambaliukai;7714826773;Ne;0;8;2;10
13960;Žemuogėlė;Skambaliukai;3134493860;Ne;4;9;0;13
13961;Žemuogėlė;Skambaliukai;1907004376;Ne;0;18;0;18
13962;Žemuogėlė;Skambaliukai;7403172794;Ne;0;8;7;15
13963;Žemuogėlė;Skambaliukai;9315711142;Ne;0;4;4;8
13964;Žemuogėlė;Skambaliukai;2102057496;Ne;0;6;1;7
13965;Žemuogėlė;Skambaliukai;4421397490;Ne;0;4;0;4
13966;Žemuogėlė;Skambaliukai;94792383091;Ne;0;15;0;15
13967;Žemuogėlė;Spinduliukai;5971652934;Ne;0;8;0;8
13968;Žemuogėlė;Spinduliukai;5127370193;Ne;0;0;1;1
13969;Žemuogėlė;Spinduliukai;4578291476;Ne;0;11;0;11
13970;Žemuogėlė;Spinduliukai;9534937419;Ne;3;2;0;5
13971;Žemuogėlė;Spinduliukai;2481547868;Ne;0;2;0;2
13972;Žemuogėlė;Spinduliukai;3612833383;Ne;19;0;0;19
13973;Žemuogėlė;Spinduliukai;6707522989;Ne;0;4;0;4
13974;Žemuogėlė;Spinduliukai;6059069293;Ne;0;14;0;14
13975;Žemuogėlė;Spinduliukai;5770044886;Ne;5;11;0;16
13976;Žemuogėlė;Spinduliukai;7669457695;Ne;0;2;0;2
13977;Žemuogėlė;Spinduliukai;3041461125;Ne;0;3;0;3
13978;Žemuogėlė;Spinduliukai;8675089149;Ne;0;2;0;2
13979;Žemuogėlė;Spinduliukai;4933948491;Ne;9;1;0;10
13980;Žemuogėlė;Perliukai;4629107942;Ne;0;15;0;15
13981;Žemuogėlė;Perliukai;1306065826;Ne;0;3;0;3
13982;Žemuogėlė;Perliukai;8106709288;Ne;0;2;0;2
13983;Žemuogėlė;Perliukai;1060986850;Ne;4;0;0;4
13984;Žemuogėlė;Perliukai;7794377881;Ne;5;6;2;13
13985;Žemuogėlė;Perliukai;1658954821;Ne;2;2;0;4
13986;Žemuogėlė;Perliukai;4698671798;Ne;5;1;0;6
13987;Žemuogėlė;Perliukai;2922827304;Ne;12;3;0;15
13988;Žemuogėlė;Perliukai;7415364637;Ne;11;6;2;19
13989;Žemuogėlė;Perliukai;3710681463;Ne;7;3;0;10
13990;Žemuogėlė;Perliukai;1796489729;Ne;7;1;0;8
13991;Žemuogėlė;Perliukai;8215763877;Ne;4;1;0;5
13992;Žemuogėlė;Perliukai;2934225120;Ne;10;0;0;10
13993;Žemuogėlė;Perliukai;3426685084;Ne;5;2;2;9
13994;Žemuogėlė;Perliukai;9150335499;Ne;11;1;1;13
13995;Žemuogėlė;Perliukai;1079114347;Ne;13;2;0;15
13996;Žemuogėlė;Perliukai;5902241163;Ne;0;3;0;3
13997;Žemuogėlė;Perliukai;7879519193;Taip;12;0;0;12
13998;Žemuogėlė;Perliukai;2109195565;Ne;6;1;0;7
13999;Žemuogėlė;Drugeliai;2745609317;Ne;8;8;0;16
14000;Žemuogėlė;Drugeliai;9694133286;Ne;5;0;0;5
14001;Žemuogėlė;Drugeliai;5557409350;Ne;3;6;0;9
14002;Žemuogėlė;Drugeliai;7668200447;Ne;4;3;0;7
14003;Žemuogėlė;Drugeliai;7148244029;Ne;1;8;0;9
14004;Žemuogėlė;Drugeliai;1901423257;Ne;12;4;0;16
14005;Žemuogėlė;Drugeliai;4862145385;Ne;12;1;0;13
14006;Žemuogėlė;Drugeliai;4368183799;Ne;0;4;0;4
14007;Žemuogėlė;Drugeliai;9902953729;Ne;9;10;0;19
14008;Žemuogėlė;Drugeliai;9537297860;Ne;9;1;0;10
14009;Žemuogėlė;Drugeliai;5170205929;Ne;19;0;0;19
14010;Žemuogėlė;Drugeliai;2428043195;Ne;18;3;0;21
14011;Žemuogėlė;Drugeliai;1716114524;Taip;18;2;0;20
14012;Žemuogėlė;Drugeliai;8137567729;Ne;7;3;0;10
14013;Žemuogėlė;Drugeliai;8348185761;Ne;0;16;0;16
14014;Žemuogėlė;Drugeliai;7974688217;Ne;9;2;3;14
14015;Žemuogėlė;Drugeliai;9273896998;Ne;22;0;0;22
14016;Žemuogėlė;"VIEVERSIUKAI ";6520776378;Ne;0;1;0;1
14017;Žemuogėlė;"VIEVERSIUKAI ";8048818368;Ne;5;0;3;8
14018;Žemuogėlė;"VIEVERSIUKAI ";6577040746;Ne;17;0;0;17
14019;Žemuogėlė;"VIEVERSIUKAI ";9872387354;Ne;13;5;1;19
14020;Žemuogėlė;"VIEVERSIUKAI ";2674188340;Ne;9;7;0;16
14021;Žemuogėlė;"VIEVERSIUKAI ";5300388726;Ne;5;0;0;5
14022;Žemuogėlė;"VIEVERSIUKAI ";7823828526;Ne;0;0;2;2
14023;Žemuogėlė;"VIEVERSIUKAI ";4172356209;Taip;15;0;0;15
14024;Žemuogėlė;"VIEVERSIUKAI ";6379837644;Ne;4;0;0;4
14025;Žemuogėlė;"VIEVERSIUKAI ";3104276726;Ne;2;4;1;7
14026;Žemuogėlė;"VIEVERSIUKAI ";3419907292;Ne;9;0;0;9
14027;Žemuogėlė;"VIEVERSIUKAI ";7323868051;Ne;0;2;1;3
14028;Žemuogėlė;"VIEVERSIUKAI ";2800160529;Ne;16;0;0;16
14029;Žemuogėlė;"VIEVERSIUKAI ";8934779062;Ne;17;0;0;17
14030;Žemuogėlė;"VIEVERSIUKAI ";3090630899;Ne;9;2;3;14
14031;Žemuogėlė;"VIEVERSIUKAI ";8091000121;Ne;8;4;0;12
14032;Žemuogėlė;"VIEVERSIUKAI ";2110963483;Ne;12;6;7;25
14033;Žemuogėlė;"VIEVERSIUKAI ";2574719380;Ne;26;1;0;27
14034;Žemuogėlė;"NYKŠTUKAI ";6504659145;Ne;0;0;1;1
14035;Žemuogėlė;"NYKŠTUKAI ";3505090532;Ne;15;0;0;15
14036;Žemuogėlė;"NYKŠTUKAI ";5208043522;Ne;3;0;0;3
14037;Žemuogėlė;"NYKŠTUKAI ";3740127955;Ne;6;0;0;6
14038;Žemuogėlė;"NYKŠTUKAI ";5614510812;Ne;13;2;0;15
14039;Žemuogėlė;"NYKŠTUKAI ";9584172565;Ne;5;1;0;6
14040;Žemuogėlė;"NYKŠTUKAI ";8706379207;Ne;10;0;0;10
14041;Žemuogėlė;"NYKŠTUKAI ";1790341419;Ne;5;0;0;5
14042;Žemuogėlė;"NYKŠTUKAI ";4998981337;Ne;0;3;0;3
14043;Žemuogėlė;"NYKŠTUKAI ";6045257180;Ne;6;0;1;7
14044;Žemuogėlė;"NYKŠTUKAI ";8301927361;Ne;6;0;2;8
14045;Žemuogėlė;"NYKŠTUKAI ";2496321184;Ne;9;2;0;11
14046;Žemuogėlė;"NYKŠTUKAI ";2139102266;Ne;24;0;0;24
14047;Žemuogėlė;"NYKŠTUKAI ";9735379466;Ne;10;3;0;13
14048;Žemuogėlė;KIŠKUČIAI;4654060157;Taip;8;0;3;11
14049;Žemuogėlė;KIŠKUČIAI;2652630375;Ne;10;10;3;23
14050;Žemuogėlė;KIŠKUČIAI;1250186598;Ne;13;0;0;13
14051;Žemuogėlė;KIŠKUČIAI;3287415964;Ne;0;11;0;11
14052;Žemuogėlė;KIŠKUČIAI;5094867109;Ne;0;0;5;5
14053;Žemuogėlė;KIŠKUČIAI;5186248897;Ne;24;1;0;25
14054;Žemuogėlė;KIŠKUČIAI;5125826172;Ne;11;5;0;16
14055;Žemuogėlė;KIŠKUČIAI;8262862183;Ne;21;2;0;23
14056;Žemuogėlė;KIŠKUČIAI;8798113318;Ne;8;0;4;12
14057;Žemuogėlė;KIŠKUČIAI;1280794094;Ne;6;0;1;7
14058;Žemuogėlė;KIŠKUČIAI;2251142510;Ne;5;4;0;9
14059;Žemuogėlė;KIŠKUČIAI;1417355297;Ne;21;0;0;21
14060;Žemuogėlė;KIŠKUČIAI;4974793430;Ne;5;0;13;18
14061;Žemuogėlė;KIŠKUČIAI;6659616731;Ne;4;0;0;4
14062;Žemuogėlė;KIŠKUČIAI;3459960812;Ne;11;0;1;12
14063;Žemuogėlė;Žiniukai;7804015060;Ne;0;6;0;6
14064;Žemuogėlė;Žiniukai;3765022476;Ne;5;4;0;9
14065;Žemuogėlė;Žiniukai;9476688736;Ne;0;4;0;4
14066;Žemuogėlė;Žiniukai;2001471529;Ne;0;5;0;5
14067;Žemuogėlė;Žiniukai;9519563708;Ne;0;9;0;9
14068;Žemuogėlė;Žiniukai;5266493632;Ne;4;2;0;6
14069;Žemuogėlė;Žiniukai;2841634296;Ne;0;2;0;2
14070;Žemuogėlė;Žiniukai;3237083654;Ne;9;2;0;11
14071;Žemuogėlė;Žiniukai;2259779058;Ne;0;1;0;1
14072;Žemuogėlė;Žiniukai;9693894254;Ne;4;6;2;12
14073;Žemuogėlė;Žiniukai;9378432383;Ne;3;1;0;4
14074;Žemuogėlė;Žiniukai;6073971598;Ne;7;3;0;10
14075;Žemuogėlė;Žiniukai;6913038845;Ne;4;9;0;13
14076;Žemuogėlė;Žiniukai;6581889641;Ne;8;2;0;10
14077;Žemuogėlė;Žiniukai;2555902309;Ne;0;16;0;16
14078;Žemuogėlė;Žiniukai;8757701456;Ne;0;9;0;9
14079;Žemuogėlė;Žiniukai;2132549536;Ne;5;2;0;7
14080;Žemuogėlė;Žiniukai;8496353410;Ne;5;2;0;7
14081;Žemuogėlė;Žiniukai;1733808230;Ne;0;12;0;12
14082;Žemuogėlė;Žiniukai;4660479216;Ne;3;1;0;4
14083;Žemuogėlė;Žiniukai;1469759840;Ne;5;0;2;7
14084;Žibutė;PELĖDŽIUKAI;3496675605;Ne;0;1;0;1
14085;Žibutė;PELĖDŽIUKAI;2361682400;Ne;3;5;0;8
14086;Žibutė;PELĖDŽIUKAI;1826763192;Ne;0;6;4;10
14087;Žibutė;PELĖDŽIUKAI;1259481487;Ne;0;3;0;3
14088;Žibutė;PELĖDŽIUKAI;3826875107;Ne;0;7;0;7
14089;Žibutė;PELĖDŽIUKAI;3186792146;Ne;0;0;4;4
14090;Žibutė;PELĖDŽIUKAI;7344095020;Ne;3;0;0;3
14091;Žibutė;PELĖDŽIUKAI;1078105287;Ne;0;4;0;4
14092;Žibutė;PELĖDŽIUKAI;2152452830;Ne;3;0;2;5
14093;Žibutė;PELĖDŽIUKAI;1394895695;Ne;0;2;1;3
14094;Žibutė;PELĖDŽIUKAI;2236930916;Ne;13;0;0;13
14095;Žibutė;PELĖDŽIUKAI;7095870173;Ne;5;6;0;11
14096;Žibutė;PELĖDŽIUKAI;2840754631;Ne;0;7;0;7
14097;Žibutė;PELĖDŽIUKAI;6089325755;Ne;0;0;1;1
14098;Žibutė;PELĖDŽIUKAI;1274409680;Ne;14;0;0;14
14099;Žibutė;PELĖDŽIUKAI;8278928396;Ne;0;8;0;8
14100;Žibutė;PELĖDŽIUKAI;2957525481;Ne;5;3;1;9
14101;Žibutė;PELĖDŽIUKAI;6495108202;Ne;0;0;10;10
14102;Žibutė;KREGŽDUTĖS;7036454359;Ne;11;0;1;12
14103;Žibutė;KREGŽDUTĖS;2406005105;Ne;0;0;1;1
14104;Žibutė;KREGŽDUTĖS;3555071718;Ne;13;0;5;18
14105;Žibutė;KREGŽDUTĖS;5412917352;Ne;0;0;1;1
14106;Žibutė;KREGŽDUTĖS;5190377896;Ne;15;0;1;16
14107;Žibutė;KREGŽDUTĖS;6013340521;Ne;5;1;0;6
14108;Žibutė;KREGŽDUTĖS;3574946816;Ne;8;0;0;8
14109;Žibutė;KREGŽDUTĖS;6194464236;Ne;6;0;8;14
14110;Žibutė;KREGŽDUTĖS;3777544301;Ne;0;10;0;10
14111;Žibutė;KREGŽDUTĖS;9923687090;Ne;18;6;3;27
14112;Žibutė;KREGŽDUTĖS;4847295068;Ne;11;0;11;22
14113;Žibutė;KREGŽDUTĖS;9700866512;Ne;0;3;0;3
14114;Žibutė;KREGŽDUTĖS;7774532200;Ne;0;12;0;12
14115;Žibutė;KREGŽDUTĖS;2607509585;Ne;1;2;0;3
14116;Žibutė;KREGŽDUTĖS;8944042589;Ne;10;11;0;21
14117;Žibutė;KREGŽDUTĖS;2438980348;Ne;0;8;0;8
14118;Žibutė;KREGŽDUTĖS;9918283923;Ne;2;0;0;2
14119;Žibutė;KREGŽDUTĖS;5126232169;Ne;23;0;0;23
14120;Žibutė;KREGŽDUTĖS;8792292819;Ne;17;0;7;24
14121;Žibutė;KREGŽDUTĖS;7668484415;Ne;0;5;0;5
14122;Žibutė;KREGŽDUTĖS;2516448580;Ne;0;4;9;13
14123;Žibutė;BORUŽĖLĖS;4278832423;Ne;3;0;0;3
14124;Žibutė;BORUŽĖLĖS;3066580779;Ne;1;0;3;4
14125;Žibutė;BORUŽĖLĖS;1786332689;Ne;3;0;2;5
14126;Žibutė;BORUŽĖLĖS;8879347884;Ne;0;4;5;9
14127;Žibutė;BORUŽĖLĖS;7764376193;Ne;11;0;0;11
14128;Žibutė;BORUŽĖLĖS;3618347199;Ne;3;1;0;4
14129;Žibutė;BORUŽĖLĖS;5186839413;Ne;0;2;3;5
14130;Žibutė;BORUŽĖLĖS;2374119662;Ne;18;2;0;20
14131;Žibutė;BORUŽĖLĖS;1381488132;Ne;0;0;4;4
14132;Žibutė;BORUŽĖLĖS;5591970907;Ne;12;0;2;14
14133;Žibutė;BORUŽĖLĖS;6672033757;Ne;6;1;0;7
14134;Žibutė;BORUŽĖLĖS;7481695788;Ne;1;0;0;1
14135;Žibutė;BORUŽĖLĖS;1112295932;Ne;2;3;0;5
14136;Žibutė;BORUŽĖLĖS;8155327668;Ne;9;2;0;11
14137;Žibutė;BORUŽĖLĖS;5632520305;Ne;0;0;3;3
14138;Žibutė;BORUŽĖLĖS;4622674814;Ne;0;6;0;6
14139;Žibutė;BORUŽĖLĖS;7805758264;Ne;3;0;1;4
14140;Žibutė;BORUŽĖLĖS;8640664660;Ne;6;0;2;8
14141;Žibutė;BORUŽĖLĖS;7608622330;Ne;0;0;4;4
14142;Žibutė;BITUTĖS;7023683517;Ne;13;0;0;13
14143;Žibutė;BITUTĖS;7853531467;Ne;0;1;0;1
14144;Žibutė;BITUTĖS;3687123871;Ne;8;0;2;10
14145;Žibutė;BITUTĖS;2312717334;Ne;7;5;0;12
14146;Žibutė;BITUTĖS;6361543454;Ne;14;0;0;14
14147;Žibutė;BITUTĖS;1297347740;Ne;3;0;0;3
14148;Žibutė;BITUTĖS;6934760468;Ne;7;2;0;9
14149;Žibutė;BITUTĖS;4455757640;Ne;0;2;0;2
14150;Žibutė;BITUTĖS;8797870379;Ne;5;1;0;6
14151;Žibutė;BITUTĖS;7792267540;Ne;10;1;0;11
14152;Žibutė;BITUTĖS;9221523836;Ne;5;5;5;15
14153;Žibutė;BITUTĖS;3632745935;Ne;10;1;0;11
14154;Žibutė;BITUTĖS;7611641692;Ne;6;0;1;7
14155;Žibutė;BITUTĖS;5112512917;Ne;0;0;15;15
14156;Žibutė;BITUTĖS;8276724226;Ne;0;0;1;1
14157;Žibutė;BITUTĖS;1515636796;Ne;0;9;0;9
14158;Žibutė;BITUTĖS;7872636200;Ne;10;1;0;11
14159;Žibutė;BITUTĖS;6833179680;Ne;5;0;1;6
14160;Žibutė;BITUTĖS;1614551884;Ne;11;0;3;14
14161;Žibutė;KAČIUKAI;6978977383;Ne;0;4;2;6
14162;Žibutė;KAČIUKAI;9634311146;Ne;0;4;0;4
14163;Žibutė;KAČIUKAI;9868621666;Ne;0;0;6;6
14164;Žibutė;KAČIUKAI;1366469428;Ne;14;0;0;14
14165;Žibutė;KAČIUKAI;4825064521;Ne;19;0;2;21
14166;Žibutė;KAČIUKAI;5826523148;Ne;0;4;0;4
14167;Žibutė;KAČIUKAI;3957898269;Ne;0;2;0;2
14168;Žibutė;KAČIUKAI;4382812297;Ne;2;0;0;2
14169;Žibutė;KAČIUKAI;5591698130;Ne;0;0;5;5
14170;Žibutė;KAČIUKAI;1004098038;Ne;2;0;0;2
14171;Žibutė;KAČIUKAI;2880593326;Ne;0;0;1;1
14172;Žibutė;KAČIUKAI;7479437931;Ne;18;1;0;19
14173;Žibutė;KAČIUKAI;1362419302;Ne;0;2;3;5
14174;Žibutė;KAČIUKAI;7531027545;Ne;0;0;5;5
14175;Žibutė;KAČIUKAI;3645481894;Ne;0;8;0;8
14176;Žibutė;KAČIUKAI;8880329060;Ne;0;3;7;10
14177;Žibutė;KAČIUKAI;5009495840;Ne;0;1;0;1
14178;Žibutė;KAČIUKAI;7136145033;Ne;9;3;3;15
14179;Žibutė;KAČIUKAI;5677389434;Ne;4;5;1;10
14180;Žibutė;KAČIUKAI;5416015554;Ne;0;0;4;4
14181;Žibutė;ZUIKIAI;4741505387;Ne;0;3;1;4
14182;Žibutė;ZUIKIAI;6209156111;Ne;11;2;0;13
14183;Žibutė;ZUIKIAI;2787326978;Ne;5;0;1;6
14184;Žibutė;ZUIKIAI;9856822557;Ne;6;0;0;6
14185;Žibutė;ZUIKIAI;4787010953;Ne;5;1;0;6
14186;Žibutė;ZUIKIAI;3875455223;Ne;7;0;0;7
14187;Žibutė;ZUIKIAI;3449188614;Ne;5;9;1;15
14188;Žibutė;ZUIKIAI;4434623264;Ne;0;7;0;7
14189;Žibutė;ZUIKIAI;9769180056;Ne;17;4;0;21
14190;Žibutė;ZUIKIAI;2013724729;Ne;8;0;0;8
14191;Žibutė;ZUIKIAI;3786933891;Ne;5;0;0;5
14192;Žibutė;ZUIKIAI;9379539151;Ne;6;2;0;8
14193;Žibutė;ZUIKIAI;9439026609;Ne;0;10;7;17
14194;Žibutė;ZUIKIAI;6234135622;Ne;6;9;0;15
14195;Žibutė;ZUIKIAI;8585964720;Ne;12;0;0;12
14196;Žibutė;ZUIKIAI;9793570682;Ne;5;0;0;5
14197;Žibutė;ZUIKIAI;6618315401;Ne;8;5;0;13
14198;Žiedas;Bitutės;1484464986;Ne;0;0;1;1
14199;Žiedas;Bitutės;4807479784;Ne;0;2;1;3
14200;Žiedas;Bitutės;6945326867;Ne;0;1;0;1
14201;Žiedas;Bitutės;5513311280;Ne;0;4;4;8
14202;Žiedas;Bitutės;1529988412;Ne;0;5;1;6
14203;Žiedas;Bitutės;1007894628;Ne;4;6;4;14
14204;Žiedas;Bitutės;1625009666;Ne;0;2;0;2
14205;Žiedas;Bitutės;1550350520;Ne;0;1;0;1
14206;Žiedas;Bitutės;9058688663;Ne;0;9;0;9
14207;Žiedas;Bitutės;7150433256;Ne;0;1;0;1
14208;Žiedas;Bitutės;3414702993;Ne;3;5;5;13
14209;Žiedas;Bitutės;2507543124;Ne;0;11;0;11
14210;Žiedas;Bitutės;88471315730;Ne;0;6;1;7
14211;Žiedas;Bitutės;34193530;Ne;0;4;0;4
14212;Žiedas;Bitutės;69485023219;Ne;0;4;0;4
14213;Žiedas;Bitutės;86877563124;Ne;0;4;4;8
14214;Žiedas;Bitutės;78720591915;Ne;0;4;6;10
14215;Žiedas;Bitutės;2026728639;Ne;2;0;0;2
14216;Žiedas;Bitutės;5108263139;Ne;10;4;0;14
14217;Žiedas;Bitutės;5885209631;Ne;0;4;2;6
14218;Žiedas;Bitutės;1737296046;Ne;0;4;0;4
14219;Žiedas;Bitutės;1048272199;Ne;0;4;0;4
14220;Žiedas;Bitutės;5007348884;Ne;0;4;1;5
14221;Žiedas;Varpeliai;7097790025;Ne;2;1;0;3
14222;Žiedas;Varpeliai;3230107921;Ne;0;2;0;2
14223;Žiedas;Varpeliai;3178778438;Ne;13;4;2;19
14224;Žiedas;Varpeliai;9602083568;Ne;15;4;0;19
14225;Žiedas;Varpeliai;5628720422;Ne;2;7;0;9
14226;Žiedas;Varpeliai;1582961378;Ne;0;2;1;3
14227;Žiedas;Varpeliai;1878050384;Ne;5;0;0;5
14228;Žiedas;Varpeliai;6882614465;Ne;7;0;0;7
14229;Žiedas;Varpeliai;5578227349;Ne;1;2;0;3
14230;Žiedas;Varpeliai;6914059680;Ne;0;3;0;3
14231;Žiedas;Varpeliai;7771247056;Ne;0;2;0;2
14232;Žiedas;Varpeliai;6515510381;Ne;2;5;0;7
14233;Žiedas;Varpeliai;3842589827;Ne;20;0;0;20
14234;Žiedas;Varpeliai;5835309107;Ne;5;2;0;7
14235;Žiedas;Varpeliai;3387263016;Ne;0;1;0;1
14236;Žiedas;Varpeliai;3178580610;Ne;0;2;0;2
14237;Žiedas;Varpeliai;1043230748;Ne;0;4;2;6
14238;Žiedas;Varpeliai;5061575884;Ne;15;0;0;15
14239;Žiedas;Varpeliai;1333233100;Ne;5;5;0;10
14240;Žiedas;Varpeliai;9020540780;Ne;5;0;0;5
14241;Žiedas;Varpeliai;8148831014;Ne;0;3;0;3
14242;Žiedas;Ramunėlės;3055218791;Ne;0;4;0;4
14243;Žiedas;Ramunėlės;1333555044;Ne;1;4;0;5
14244;Žiedas;Ramunėlės;2092319455;Ne;5;3;0;8
14245;Žiedas;Ramunėlės;5789261620;Ne;0;1;0;1
14246;Žiedas;Ramunėlės;8753972322;Ne;0;5;0;5
14247;Žiedas;Ramunėlės;1583038469;Ne;0;6;0;6
14248;Žiedas;Ramunėlės;8208331527;Ne;3;3;0;6
14249;Žiedas;Ramunėlės;9037835899;Ne;0;3;0;3
14250;Žiedas;Ramunėlės;5577339739;Ne;1;4;0;5
14251;Žiedas;Ramunėlės;6884933845;Ne;7;7;0;14
14252;Žiedas;Ramunėlės;7548653053;Ne;0;2;0;2
14253;Žiedas;Ramunėlės;1659873036;Ne;0;3;0;3
14254;Žiedas;Ramunėlės;2843328732;Ne;1;0;1;2
14255;Žiedas;Ramunėlės;1580781723;Ne;0;6;0;6
14256;Žiedas;Ramunėlės;5920211041;Ne;0;1;0;1
14257;Žiedas;Ramunėlės;4933650089;Ne;0;5;0;5
14258;Žiedas;Ramunėlės;4044156905;Ne;0;0;3;3
14259;Žiedas;Ramunėlės;4844442247;Ne;0;7;0;7
14260;Žiedas;Ramunėlės;7294671324;Ne;0;2;0;2
14261;Žiedas;Ramunėlės;8812316692;Ne;6;0;0;6
14262;Žiedas;Pakalnutės;7798930533;Ne;0;11;0;11
14263;Žiedas;Pakalnutės;1094506858;Ne;9;3;0;12
14264;Žiedas;Pakalnutės;9375048835;Ne;0;8;0;8
14265;Žiedas;Pakalnutės;5266048033;Ne;12;6;0;18
14266;Žiedas;Pakalnutės;5804334198;Ne;0;1;0;1
14267;Žiedas;Pakalnutės;1721956438;Ne;2;0;0;2
14268;Žiedas;Pakalnutės;4808020243;Ne;0;2;0;2
14269;Žiedas;Pakalnutės;3742949697;Ne;10;0;0;10
14270;Žiedas;Pakalnutės;6343634478;Ne;0;9;0;9
14271;Žiedas;Pakalnutės;8015880569;Ne;0;4;0;4
14272;Žiedas;Pakalnutės;8857150598;Ne;13;1;0;14
14273;Žiedas;Pakalnutės;2416234016;Ne;10;0;0;10
14274;Žiedas;Pakalnutės;9054709268;Ne;0;5;0;5
14275;Žiedas;Pakalnutės;9964883646;Ne;0;2;0;2
14276;Žiedas;Pakalnutės;4917324037;Ne;0;5;0;5
14277;Žiedas;Pakalnutės;4021189767;Ne;1;2;0;3
14278;Žiedas;Pakalnutės;1346658299;Ne;0;7;0;7
14279;Žiedas;Pakalnutės;4697477761;Ne;5;4;0;9
14280;Žiedas;Pakalnutės;9207945616;Ne;2;8;0;10
14281;Žiedas;Pakalnutės;7221702677;Ne;0;1;0;1
14282;Žiedas;Rožytės;8846443535;Ne;0;1;0;1
14283;Žiedas;Rožytės;8645771800;Ne;7;0;4;11
14284;Žiedas;Rožytės;7942276632;Ne;0;5;0;5
14285;Žiedas;Rožytės;7799489700;Ne;0;18;0;18
14286;Žiedas;Rožytės;8163645535;Ne;8;0;0;8
14287;Žiedas;Rožytės;2182381160;Ne;4;0;0;4
14288;Žiedas;Rožytės;8822472312;Ne;0;2;0;2
14289;Žiedas;Rožytės;9021286246;Ne;0;10;0;10
14290;Žiedas;Rožytės;1777501190;Ne;3;0;0;3
14291;Žiedas;Rožytės;1219634640;Ne;0;7;0;7
14292;Žiedas;Rožytės;6459679214;Ne;0;15;0;15
14293;Žiedas;Rožytės;3984607857;Ne;0;7;2;9
14294;Žiedas;Pumpurėliai;5830738378;Ne;20;0;0;20
14295;Žiedas;Pumpurėliai;2320543511;Ne;0;6;0;6
14296;Žiedas;Pumpurėliai;2149342412;Ne;10;0;0;10
14297;Žiedas;Pumpurėliai;4360175072;Ne;16;0;0;16
14298;Žiedas;Pumpurėliai;7780469974;Ne;15;0;0;15
14299;Žiedas;Pumpurėliai;9337317396;Ne;10;4;0;14
14300;Žiedas;Pumpurėliai;1086714229;Ne;14;5;0;19
14301;Žiedas;Pumpurėliai;2320411618;Ne;0;4;0;4
14302;Žiedas;Pumpurėliai;8861734370;Ne;5;5;0;10
14303;Žiedas;Pumpurėliai;5635958124;Ne;0;4;0;4
14304;Žiedas;Pumpurėliai;7677595571;Ne;9;5;0;14
14305;Žiedas;Pumpurėliai;4699833757;Ne;5;2;0;7
14306;Žiedas;Pumpurėliai;2633676360;Ne;0;3;5;8
14307;Žiedas;Pumpurėliai;8797245208;Ne;9;0;1;10
14308;Žiedas;DOBILIUKAI;9750690920;Ne;10;0;0;10
14309;Žiedas;"Dobiliukai ";1612957739;Ne;6;0;0;6
14310;Žiedas;"Dobiliukai ";9413654318;Ne;14;0;3;17
14311;Žiedas;"Dobiliukai ";6066566242;Ne;5;2;0;7
14312;Žiedas;"Dobiliukai ";8436592169;Ne;0;2;1;3
14313;Žiedas;"Dobiliukai ";3654878543;Ne;0;0;1;1
14314;Žiedas;"Dobiliukai ";8794003030;Ne;2;2;3;7
14315;Žiedas;"Dobiliukai ";8444690698;Ne;9;0;5;14
14316;Žiedas;"Dobiliukai ";2715554681;Taip;20;1;2;23
14317;Žiedas;"Dobiliukai ";2132564079;Ne;16;0;1;17
14318;Žiedas;"Dobiliukai ";9586578606;Ne;0;5;0;5
14319;Žiedas;"Dobiliukai ";3940002957;Ne;9;0;0;9
14320;Žiedas;"Dobiliukai ";5353507617;Ne;11;0;1;12
14321;Žiedas;"Dobiliukai ";4087903129;Ne;5;1;0;6
14322;Žiedas;"Dobiliukai ";8185042446;Ne;0;0;1;1
14323;Žiedas;"Dobiliukai ";7049399327;Ne;0;0;3;3
14324;Žiedas;"Dobiliukai ";8388297947;Ne;0;1;0;1
14325;Žiedas;"Dobiliukai ";3011163947;Ne;9;0;3;12
14326;Žiedas;"Dobiliukai ";6748378606;Ne;15;4;0;19
14327;Žiedas;"Dobiliukai ";7558307454;Ne;8;0;0;8
14328;Žiedas;"Dobiliukai ";6795173519;Ne;7;0;0;7
14329;Žiedas;RŪTELĖS;2134466899;Ne;6;0;0;6
14330;Žiedas;RŪTELĖS;5914428064;Ne;0;8;0;8
14331;Žiedas;RŪTELĖS;3857121753;Ne;5;6;1;12
14332;Žiedas;RŪTELĖS;6443633568;Ne;14;4;0;18
14333;Žiedas;RŪTELĖS;7491134119;Ne;10;0;0;10
14334;Žiedas;RŪTELĖS;5959899914;Ne;0;7;0;7
14335;Žiedas;RŪTELĖS;7333813704;Ne;0;2;0;2
14336;Žiedas;RŪTELĖS;6658762922;Ne;0;4;0;4
14337;Žiedas;RŪTELĖS;5126173608;Ne;3;5;0;8
14338;Žiedas;RŪTELĖS;1738121071;Ne;10;0;0;10
14339;Žiedas;RŪTELĖS;5420327672;Ne;4;3;4;11
14340;Žiedas;RŪTELĖS;1253833615;Ne;0;5;0;5
14341;Žiedas;RŪTELĖS;9218388800;Ne;3;9;0;12
14342;Žiedas;RŪTELĖS;7072578987;Ne;10;4;0;14
14343;Žiedas;RŪTELĖS;3715928992;Ne;3;1;0;4
14344;Žiedas;RŪTELĖS;9352485926;Ne;0;0;1;1
14345;Žiedas;RŪTELĖS;7578964555;Ne;0;2;0;2
14346;Žiedas;RŪTELĖS;5647232875;Ne;0;5;0;5
14347;Žiedas;RŪTELĖS;5928377774;Ne;7;2;0;9
14348;Žiedas;SAULĖGRĄŽOS;1011602827;Ne;0;7;0;7
14349;Žiedas;SAULĖGRĄŽOS;8887021328;Ne;11;0;0;11
14350;Žiedas;SAULĖGRĄŽOS;2932857132;Ne;5;0;3;8
14351;Žiedas;SAULĖGRĄŽOS;5552786845;Ne;4;6;4;14
14352;Žiedas;SAULĖGRĄŽOS;8833895006;Ne;0;3;0;3
14353;Žiedas;SAULĖGRĄŽOS;5658235821;Ne;9;0;0;9
14354;Žiedas;SAULĖGRĄŽOS;4992446383;Ne;3;0;0;3
14355;Žiedas;SAULĖGRĄŽOS;9057761408;Ne;0;4;3;7
14356;Žiedas;SAULĖGRĄŽOS;1645402434;Ne;4;1;0;5
14357;Žiedas;SAULĖGRĄŽOS;2026540724;Ne;0;6;0;6
14358;Žiedas;SAULĖGRĄŽOS;4564268323;Ne;10;7;0;17
14359;Žiedas;SAULĖGRĄŽOS;8801900486;Ne;0;1;2;3
14360;Žiedas;SAULĖGRĄŽOS;1609487830;Ne;0;1;0;1
14361;Žiedas;SAULĖGRĄŽOS;3437651010;Ne;10;0;9;19
14362;Žiedas;SAULĖGRĄŽOS;3422053505;Ne;8;4;0;12
14363;Žiedas;SAULĖGRĄŽOS;5274845525;Ne;5;1;0;6
14364;Žiedas;SAULĖGRĄŽOS;6053010050;Ne;3;1;0;4
14365;Žiedas;SAULĖGRĄŽOS;7057747531;Ne;0;2;0;2
14366;Žiedas;SAULĖGRĄŽOS;9685152753;Ne;0;1;4;5
14367;Žiedas;SAULĖGRĄŽOS;8819018248;Ne;0;6;5;11
14368;Žiedas;SAULĖGRĄŽOS;7604200899;Ne;4;0;0;4
14369;Žiedas;SAULĖGRĄŽOS;3303581707;Ne;2;3;0;5
14370;Žiedas;RUGIAGĖLĖS;1035854293;Ne;6;0;2;8
14371;Žiedas;RUGIAGĖLĖS;1917085385;Ne;0;1;0;1
14372;Žiedas;RUGIAGĖLĖS;5987689515;Ne;6;5;3;14
14373;Žiedas;RUGIAGĖLĖS;1826599535;Ne;5;0;0;5
14374;Žiedas;RUGIAGĖLĖS;3477341028;Ne;10;0;0;10
14375;Žiedas;RUGIAGĖLĖS;2124086277;Ne;15;0;0;15
14376;Žiedas;RUGIAGĖLĖS;2642760082;Ne;0;2;0;2
14377;Žiedas;RUGIAGĖLĖS;1093479755;Ne;14;0;0;14
14378;Žiedas;RUGIAGĖLĖS;7381658912;Ne;10;3;0;13
14379;Žiedas;RUGIAGĖLĖS;7228139235;Ne;5;0;0;5
14380;Žiedas;RUGIAGĖLĖS;1975718197;Ne;7;0;3;10
14381;Žiedas;RUGIAGĖLĖS;2312361963;Ne;21;0;0;21
14382;Žiedas;RUGIAGĖLĖS;6859410675;Ne;0;4;0;4
14383;Žiedas;RUGIAGĖLĖS;2148027253;Ne;6;0;0;6
14384;Žiedas;RUGIAGĖLĖS;1758868055;Ne;7;0;1;8
14385;Žiedas;RUGIAGĖLĖS;2182340305;Ne;8;0;0;8
14386;Žiedas;RUGIAGĖLĖS;1958481432;Ne;5;0;0;5
14387;Žiedas;RUGIAGĖLĖS;3099608553;Ne;19;0;0;19
14388;Žiedas;RUGIAGĖLĖS;1390431397;Ne;9;0;0;9
14389;Žiedas;RUGIAGĖLĖS;9393499257;Ne;8;0;0;8
14390;Žiedas;RUGIAGĖLĖS;2170318597;Ne;10;1;0;11
14391;Žiedas;RUGIAGĖLĖS;8276022676;Ne;17;0;0;17
14392;Žiedas;RUGIAGĖLĖS;7584712202;Ne;8;2;0;10
14393;Žiedas;Boružėlės;4922560649;Ne;0;3;0;3
14394;Žiedas;Boružėlės;2095655987;Ne;4;2;0;6
14395;Žiedas;Boružėlės;7814504623;Ne;5;0;0;5
14396;Žiedas;Boružėlės;9648580306;Ne;0;10;0;10
14397;Žiedas;Boružėlės;5653785844;Ne;2;0;0;2
14398;Žiedas;Boružėlės;9247088735;Ne;6;0;1;7
14399;Žiedas;Boružėlės;7396006218;Ne;0;2;0;2
14400;Žiedas;Boružėlės;5588136738;Ne;2;13;0;15
14401;Žiedas;Boružėlės;6786526552;Ne;15;0;0;15
14402;Žiedas;Boružėlės;2511423525;Ne;0;3;0;3
14403;Žiedas;Boružėlės;6432090199;Ne;5;2;0;7
14404;Žiedas;Boružėlės;5626494892;Ne;16;0;0;16
14405;Žiedas;Boružėlės;7708360056;Ne;0;0;2;2
14406;Žiedas;Boružėlės;7954517383;Ne;0;5;0;5
14407;Žiedas;Boružėlės;1794393042;Ne;0;2;2;4
14408;Žiedas;Boružėlės;2849254119;Ne;12;5;0;17
14409;Žiedas;Boružėlės;9736967156;Ne;7;5;0;12
14410;Žiedas;Boružėlės;3586376571;Ne;0;1;0;1
14411;Žiedas;Boružėlės;1139186052;Ne;7;5;0;12
14412;Žiedas;Boružėlės;3704491209;Ne;0;4;3;7
14413;Žiedas;AGUONĖLĖS;1885623466;Ne;12;1;0;13
14414;Žiedas;AGUONĖLĖS;9464217926;Ne;11;0;0;11
14415;Žiedas;AGUONĖLĖS;9543860953;Ne;9;0;0;9
14416;Žiedas;AGUONĖLĖS;3247328978;Ne;15;0;0;15
14417;Žiedas;AGUONĖLĖS;4250009129;Ne;0;6;1;7
14418;Žiedas;AGUONĖLĖS;7399937598;Ne;5;2;0;7
14419;Žiedas;AGUONĖLĖS;9111149805;Ne;8;2;0;10
14420;Žiedas;AGUONĖLĖS;4695900874;Ne;3;2;0;5
14421;Žiedas;AGUONĖLĖS;3258241663;Ne;0;1;0;1
14422;Žiedas;AGUONĖLĖS;6700593422;Ne;19;0;0;19
14423;Žiedas;AGUONĖLĖS;3835714894;Ne;0;1;0;1
14424;Žiedas;AGUONĖLĖS;7535993061;Ne;0;7;0;7
14425;Žiedas;AGUONĖLĖS;1956219718;Ne;0;2;0;2
14426;Žiedas;AGUONĖLĖS;4809093267;Ne;9;0;0;9
14427;Žiedas;AGUONĖLĖS;1874460511;Ne;5;3;0;8
14428;Žiedas;AGUONĖLĖS;6245366671;Ne;1;1;0;2
14429;Žiedas;AGUONĖLĖS;6856477482;Ne;21;0;0;21
14430;Žiedas;ŽIBUTĖS;8638720939;Ne;7;0;0;7
14431;Žiedas;ŽIBUTĖS;3654749109;Ne;4;3;0;7
14432;Žiedas;ŽIBUTĖS;4039958043;Ne;7;1;0;8
14433;Žiedas;ŽIBUTĖS;1835893385;Ne;11;0;5;16
14434;Žiedas;ŽIBUTĖS;2913328259;Ne;11;0;0;11
14435;Žiedas;ŽIBUTĖS;7418985667;Ne;10;0;0;10
14436;Žiedas;ŽIBUTĖS;4568189195;Ne;7;4;0;11
14437;Žiedas;ŽIBUTĖS;2097392327;Ne;6;1;0;7
14438;Žiedas;ŽIBUTĖS;9269909624;Ne;9;0;0;9
14439;Žiedas;ŽIBUTĖS;7114207461;Ne;5;4;0;9
14440;Žiedas;ŽIBUTĖS;5106427067;Ne;10;0;0;10
14441;Žiedas;ŽIBUTĖS;3407247493;Ne;11;0;0;11
14442;Žiedas;ŽIBUTĖS;8084555994;Ne;15;0;0;15
14443;Žiedas;ŽIBUTĖS;7613786936;Ne;21;0;0;21
14444;Žiedas;ŽIBUTĖS;1669599543;Ne;15;4;0;19
14445;Žiedas;ŽIBUTĖS;7498211984;Ne;16;0;0;16
14446;Žiedas;ŽIBUTĖS;3948942801;Ne;0;8;0;8
14447;Žiedas;DRUGELIAI;8517250094;Ne;0;10;0;10
14448;Žiedas;DRUGELIAI;9894489800;Ne;0;2;0;2
14449;Žiedas;DRUGELIAI;2763469583;Ne;0;1;0;1
14450;Žiedas;DRUGELIAI;9757771445;Ne;2;4;0;6
14451;Žiedas;DRUGELIAI;4222689492;Ne;0;6;0;6
14452;Žiedas;DRUGELIAI;2763996098;Ne;15;0;0;15
14453;Žiedas;DRUGELIAI;4983852075;Ne;0;4;0;4
14454;Žiedas;DRUGELIAI;9129315784;Ne;0;8;0;8
14455;Žiedas;DRUGELIAI;7952899220;Ne;0;8;0;8
14456;Žiedas;DRUGELIAI;2679205188;Ne;2;0;0;2
14457;Žiedas;DRUGELIAI;2026462074;Ne;0;4;0;4
14458;Žiedas;DRUGELIAI;4749655084;Ne;3;2;0;5
14459;Žiedas;DRUGELIAI;9587581470;Ne;0;4;0;4
14460;Žiedas;DRUGELIAI;9415269410;Ne;0;3;0;3
14461;Žiogelis;SKRUZDELYTĖS;2959983278;Ne;8;4;0;12
14462;Žiogelis;SKRUZDELYTĖS;4677024422;Ne;6;6;0;12
14463;Žiogelis;SKRUZDELYTĖS;6165380986;Ne;0;0;2;2
14464;Žiogelis;SKRUZDELYTĖS;5281321968;Ne;4;2;0;6
14465;Žiogelis;SKRUZDELYTĖS;3214640817;Ne;16;5;0;21
14466;Žiogelis;SKRUZDELYTĖS;1937740173;Ne;10;4;0;14
14467;Žiogelis;SKRUZDELYTĖS;4115425880;Ne;0;1;0;1
14468;Žiogelis;SKRUZDELYTĖS;5737326104;Ne;13;0;0;13
14469;Žiogelis;SKRUZDELYTĖS;2614574694;Ne;0;1;0;1
14470;Žiogelis;SKRUZDELYTĖS;7107814348;Ne;0;15;0;15
14471;Žiogelis;SKRUZDELYTĖS;9243862028;Ne;0;4;0;4
14472;Žiogelis;SKRUZDELYTĖS;7395901559;Ne;0;5;0;5
14473;Žiogelis;SKRUZDELYTĖS;9819352425;Ne;16;0;0;16
14474;Žiogelis;SKRUZDELYTĖS;8780773039;Ne;0;11;0;11
14475;Žiogelis;SKRUZDELYTĖS;7881734492;Ne;9;0;0;9
14476;Žiogelis;SKRUZDELYTĖS;9120836406;Ne;0;0;2;2
14477;Žiogelis;SKRUZDELYTĖS;6742462116;Ne;0;1;0;1
14478;Žiogelis;SKRUZDELYTĖS;8763533677;Ne;10;4;0;14
14479;Žiogelis;SKRUZDELYTĖS;6608146625;Ne;17;0;0;17
14480;Žiogelis;SKRUZDELYTĖS;9035254979;Ne;2;0;11;13
14481;Žiogelis;ŽIRNIUKAI;2348525913;Ne;7;0;1;8
14482;Žiogelis;ŽIRNIUKAI;4561384361;Ne;3;0;0;3
14483;Žiogelis;ŽIRNIUKAI;9142952548;Ne;0;4;0;4
14484;Žiogelis;ŽIRNIUKAI;4450344120;Ne;0;2;0;2
14485;Žiogelis;ŽIRNIUKAI;8998694866;Ne;5;5;0;10
14486;Žiogelis;ŽIRNIUKAI;3472310047;Ne;0;1;0;1
14487;Žiogelis;ŽIRNIUKAI;8018943297;Ne;0;1;0;1
14488;Žiogelis;ŽIRNIUKAI;9421670525;Ne;9;0;0;9
14489;Žiogelis;ŽIRNIUKAI;2463360858;Ne;4;0;0;4
14490;Žiogelis;ŽIRNIUKAI;1067136657;Ne;5;0;0;5
14491;Žiogelis;ŽIRNIUKAI;9672307977;Ne;0;2;0;2
14492;Žiogelis;ŽIRNIUKAI;5337641310;Ne;7;0;0;7
14493;Žiogelis;ŽIRNIUKAI;4755709634;Ne;0;0;5;5
14494;Žiogelis;ŽIRNIUKAI;2833768296;Ne;5;0;0;5
14495;Žiogelis;ŽIRNIUKAI;6857937795;Ne;13;1;0;14
14496;Žiogelis;ŽIRNIUKAI;3516143432;Ne;6;0;3;9
14497;Žiogelis;ŽIRNIUKAI;5223426277;Ne;0;1;0;1
14498;Žiogelis;ŽIRNIUKAI;3628571567;Ne;0;1;0;1
14499;Žiogelis;DOBILĖLIAI;8683148826;Ne;0;10;0;10
14500;Žiogelis;DOBILĖLIAI;3308563362;Ne;0;2;0;2
14501;Žiogelis;DOBILĖLIAI;2117192553;Ne;0;1;0;1
14502;Žiogelis;DOBILĖLIAI;1190395481;Ne;0;7;0;7
14503;Žiogelis;DOBILĖLIAI;1465027680;Ne;0;0;2;2
14504;Žiogelis;DOBILĖLIAI;6495456608;Ne;0;5;0;5
14505;Žiogelis;DOBILĖLIAI;5364996984;Ne;9;0;3;12
14506;Žiogelis;DOBILĖLIAI;9568208184;Ne;9;0;3;12
14507;Žiogelis;DOBILĖLIAI;6340620973;Ne;0;0;3;3
14508;Žiogelis;DOBILĖLIAI;5961630249;Ne;5;1;0;6
14509;Žiogelis;DOBILĖLIAI;6532218580;Ne;2;1;0;3
14510;Žiogelis;DOBILĖLIAI;9610249055;Ne;0;3;0;3
14511;Žiogelis;DOBILĖLIAI;6115834138;Ne;0;5;0;5
14512;Žiogelis;DOBILĖLIAI;3887222613;Ne;5;0;0;5
14513;Žiogelis;DOBILĖLIAI;7065052244;Ne;10;8;1;19
14514;Žiogelis;DOBILĖLIAI;3427704550;Ne;0;1;0;1
14515;Žiogelis;DOBILĖLIAI;4103035195;Ne;10;1;0;11
14516;Žiogelis;DOBILĖLIAI;3392582853;Ne;0;2;0;2
14517;Žiogelis;DOBILĖLIAI;5557800297;Ne;0;2;0;2
14518;Žiogelis;BORUŽĖLĖS;9295720241;Ne;5;0;0;5
14519;Žiogelis;BORUŽĖLĖS;24941867247;Ne;2;2;0;4
14520;Žiogelis;BORUŽĖLĖS;8819549855;Ne;0;5;1;6
14521;Žiogelis;BORUŽĖLĖS;3189872952;Ne;0;10;0;10
14522;Žiogelis;BORUŽĖLĖS;2883732914;Ne;0;10;0;10
14523;Žiogelis;BORUŽĖLĖS;3503872654;Ne;0;4;1;5
14524;Žiogelis;BORUŽĖLĖS;4445888917;Ne;0;5;0;5
14525;Žiogelis;BORUŽĖLĖS;7881358741;Ne;0;5;0;5
14526;Žiogelis;BORUŽĖLĖS;64865699245;Ne;0;2;0;2
14527;Žiogelis;BORUŽĖLĖS;8702710674;Ne;0;10;0;10
14528;Žiogelis;BORUŽĖLĖS;4671356872;Ne;3;3;0;6
14529;Žiogelis;BORUŽĖLĖS;18018505301;Ne;0;1;0;1
14530;Žiogelis;BORUŽĖLĖS;3750023611;Ne;0;3;1;4
14531;Žiogelis;BORUŽĖLĖS;4343510173;Ne;0;7;0;7
14532;Žiogelis;BORUŽĖLĖS;6659086172;Ne;0;4;1;5
14533;Žiogelis;BORUŽĖLĖS;95713316600;Ne;0;4;0;4
14534;Žiogelis;BORUŽĖLĖS;3203359908;Ne;2;2;0;4
14535;Žiogelis;BORUŽĖLĖS;3320077143;Ne;0;3;0;3
14536;Žiogelis;BORUŽĖLĖS;1160064257;Ne;0;5;0;5
14537;Žiogelis;BORUŽĖLĖS;6346503991;Ne;0;3;5;8
14538;Žiogelis;BORUŽĖLĖS;3560637865;Ne;9;1;0;10
14539;Žiogelis;BORUŽĖLĖS;3420228264;Ne;0;0;3;3
14540;Žiogelis;BORUŽĖLĖS;1996517542;Ne;8;6;0;14
14541;Žiogelis;BORUŽĖLĖS;6760074113;Ne;0;10;0;10
14542;Žiogelis;DRUGELIAI;2797078863;Ne;0;0;15;15
14543;Žiogelis;DRUGELIAI;3813592739;Ne;0;4;0;4
14544;Žiogelis;DRUGELIAI;3820406417;Ne;0;15;1;16
14545;Žiogelis;DRUGELIAI;9533670829;Ne;8;0;0;8
14546;Žiogelis;DRUGELIAI;1673279182;Ne;19;0;0;19
14547;Žiogelis;DRUGELIAI;9964121573;Ne;0;4;11;15
14548;Žiogelis;DRUGELIAI;5104952346;Ne;0;2;2;4
14549;Žiogelis;DRUGELIAI;9717527407;Ne;5;0;1;6
14550;Žiogelis;DRUGELIAI;2622354022;Ne;13;0;0;13
14551;Žiogelis;DRUGELIAI;2243541285;Ne;20;0;0;20
14552;Žiogelis;DRUGELIAI;3810309354;Ne;17;0;0;17
14553;Žiogelis;DRUGELIAI;7974212517;Ne;5;11;0;16
14554;Žiogelis;DRUGELIAI;9423979719;Ne;5;11;0;16
14555;Žiogelis;DRUGELIAI;1833992163;Ne;10;0;0;10
14556;Žiogelis;DRUGELIAI;2529171444;Ne;0;1;0;1
14557;Žiogelis;DRUGELIAI;4946802677;Ne;11;0;0;11
14558;Žiogelis;PELĖDŽIUKAI;6709029770;Ne;0;1;0;1
14559;Žiogelis;PELĖDŽIUKAI;7502572217;Ne;6;0;0;6
14560;Žiogelis;PELĖDŽIUKAI;1134384178;Ne;3;0;1;4
14561;Žiogelis;PELĖDŽIUKAI;5876904663;Ne;6;0;1;7
14562;Žiogelis;PELĖDŽIUKAI;8217782981;Ne;10;7;0;17
14563;Žiogelis;PELĖDŽIUKAI;7120126547;Ne;0;5;0;5
14564;Žiogelis;PELĖDŽIUKAI;9387048672;Ne;12;2;0;14
14565;Žiogelis;PELĖDŽIUKAI;3937261260;Ne;0;4;0;4
14566;Žiogelis;PELĖDŽIUKAI;8873231715;Ne;0;0;1;1
14567;Žiogelis;PELĖDŽIUKAI;8894068297;Ne;0;1;0;1
14568;Žiogelis;PELĖDŽIUKAI;4609861306;Ne;0;0;1;1
14569;Žiogelis;PELĖDŽIUKAI;2759766559;Ne;0;4;0;4
14570;Žiogelis;PELĖDŽIUKAI;7725494899;Ne;0;1;0;1
14571;Žiogelis;PELĖDŽIUKAI;1939672072;Ne;0;0;2;2
14572;Žiogelis;PELĖDŽIUKAI;8689074067;Ne;1;2;1;4
14573;Žiogelis;PELĖDŽIUKAI;4565342104;Ne;0;2;0;2
14574;Žiogelis;PELĖDŽIUKAI;1223396469;Ne;1;4;1;6
14575;Žiogelis;PELĖDŽIUKAI;3500076229;Ne;0;3;0;3
14576;Žiogelis;PELĖDŽIUKAI;8715501524;Ne;12;0;2;14
14577;Žiogelis;VARPELIAI;7888873296;Ne;9;2;0;11
14578;Žiogelis;VARPELIAI;8262619320;Ne;0;4;0;4
14579;Žiogelis;VARPELIAI;3520393042;Ne;4;3;0;7
14580;Žiogelis;VARPELIAI;8983731310;Ne;0;5;0;5
14581;Žiogelis;VARPELIAI;1954544417;Ne;0;3;0;3
14582;Žiogelis;VARPELIAI;6716558946;Ne;0;2;0;2
14583;Žiogelis;VARPELIAI;1035890284;Ne;0;5;0;5
14584;Žiogelis;VARPELIAI;9385596579;Ne;3;1;0;4
14585;Žiogelis;VARPELIAI;1447349850;Ne;0;8;0;8
14586;Žiogelis;VARPELIAI;3752358694;Ne;21;0;0;21
14587;Žiogelis;VARPELIAI;6402784913;Ne;0;5;0;5
14588;Žiogelis;VARPELIAI;4462189852;Ne;0;6;0;6
14589;Žiogelis;VARPELIAI;9470241656;Ne;21;0;0;21
14590;Žiogelis;VARPELIAI;8133583992;Ne;0;5;0;5
14591;Žiogelis;VARPELIAI;2346231162;Ne;0;4;0;4
14592;Žiogelis;VARPELIAI;6658457517;Ne;0;3;0;3
14593;Žiogelis;VARPELIAI;6650891980;Ne;10;1;0;11
14594;Žiogelis;VARPELIAI;5076511003;Ne;0;1;0;1
14595;Žiogelis;VARPELIAI;1139259000;Ne;17;0;0;17
14596;Žiogelis;VARPELIAI;7992701275;Ne;2;4;0;6
14597;Žiogelis;KREGŽDUTĖS;7704256764;Ne;6;2;0;8
14598;Žiogelis;KREGŽDUTĖS;1235203700;Ne;0;4;2;6
14599;Žiogelis;KREGŽDUTĖS;6697117406;Ne;0;5;0;5
14600;Žiogelis;KREGŽDUTĖS;2028383677;Ne;6;2;0;8
14601;Žiogelis;KREGŽDUTĖS;3910954904;Ne;11;1;0;12
14602;Žiogelis;KREGŽDUTĖS;2233244282;Ne;0;4;0;4
14603;Žiogelis;KREGŽDUTĖS;9862582346;Ne;0;1;0;1
14604;Žiogelis;KREGŽDUTĖS;9406830518;Ne;10;0;0;10
14605;Žiogelis;KREGŽDUTĖS;1320651707;Ne;0;7;0;7
14606;Žiogelis;KREGŽDUTĖS;85437321236;Ne;0;0;1;1
14607;Žiogelis;KREGŽDUTĖS;1320126836;Ne;0;4;0;4
14608;Žiogelis;KREGŽDUTĖS;3310492752;Ne;0;6;0;6
14609;Žiogelis;KREGŽDUTĖS;2366095661;Ne;0;6;0;6
14610;Žiogelis;KREGŽDUTĖS;8675451323;Ne;14;0;0;14
14611;Žiogelis;KREGŽDUTĖS;7087781379;Ne;0;9;0;9
14612;Žiogelis;KREGŽDUTĖS;4015109974;Ne;3;8;0;11
14613;Žiogelis;KREGŽDUTĖS;14932261911;Ne;0;6;1;7
14614;Žiogelis;KREGŽDUTĖS;4713696984;Ne;0;8;0;8
14615;Žiogelis;KREGŽDUTĖS;1442866468;Ne;0;4;0;4
14616;Žiogelis;KREGŽDUTĖS;1660784232;Ne;0;4;3;7
14617;Žiogelis;KREGŽDUTĖS;5579709130;Ne;0;1;0;1
14618;Žiogelis;KREGŽDUTĖS;9128728457;Ne;0;8;0;8
14619;Žiogelis;KREGŽDUTĖS;5340501392;Ne;13;0;0;13
14620;Žiogelis;KREGŽDUTĖS;8979747150;Ne;8;0;0;8
14621;Žiogelis;ŽVIRBLIUKAI;1106149118;Ne;0;6;0;6
14622;Žiogelis;ŽVIRBLIUKAI;6284764694;Ne;9;6;0;15
14623;Žiogelis;ŽVIRBLIUKAI;9842311161;Ne;9;5;0;14
14624;Žiogelis;ŽVIRBLIUKAI;5475797764;Ne;0;1;0;1
14625;Žiogelis;ŽVIRBLIUKAI;2036243422;Ne;12;1;0;13
14626;Žiogelis;ŽVIRBLIUKAI;9634291623;Ne;8;0;0;8
14627;Žiogelis;ŽVIRBLIUKAI;7802165127;Ne;0;4;0;4
14628;Žiogelis;ŽVIRBLIUKAI;6491130711;Ne;0;0;1;1
14629;Žiogelis;ŽVIRBLIUKAI;9378236361;Ne;7;2;0;9
14630;Žiogelis;ŽVIRBLIUKAI;5445409452;Ne;7;1;0;8
14631;Žiogelis;ŽVIRBLIUKAI;4155916507;Ne;4;0;0;4
14632;Žiogelis;ŽVIRBLIUKAI;6988180082;Ne;3;2;0;5
14633;Žiogelis;ŽVIRBLIUKAI;4677227753;Ne;3;2;0;5
14634;Žiogelis;ŽVIRBLIUKAI;9737574835;Ne;4;0;0;4
14635;Žiogelis;ŽVIRBLIUKAI;5996045442;Ne;3;1;0;4
14636;Žiogelis;BITUTĖS;4814936645;Ne;0;1;0;1
14637;Žiogelis;BITUTĖS;3752355139;Ne;0;0;4;4
14638;Žiogelis;BITUTĖS;4605250897;Ne;0;1;0;1
14639;Žiogelis;BITUTĖS;2173494736;Ne;9;0;2;11
14640;Žiogelis;BITUTĖS;5042341085;Ne;7;0;2;9
14641;Žiogelis;BITUTĖS;6347738933;Ne;5;5;0;10
14642;Žiogelis;BITUTĖS;9627583831;Ne;0;1;0;1
14643;Žiogelis;BITUTĖS;3296450902;Ne;0;4;0;4
14644;Žiogelis;BITUTĖS;3792114246;Ne;0;6;0;6
14645;Žiogelis;BITUTĖS;9981130790;Ne;0;7;0;7
14646;Žiogelis;BITUTĖS;3820534331;Ne;0;3;0;3
14647;Žiogelis;BITUTĖS;4630381709;Ne;0;3;0;3
14648;Žiogelis;BITUTĖS;9790463889;Ne;0;3;0;3
14649;Žiogelis;BITUTĖS;6024752960;Ne;0;4;0;4
14650;Žiogelis;BITUTĖS;8853905367;Ne;0;4;0;4
14651;Žiogelis;BITUTĖS;1397686161;Ne;0;12;0;12
14652;Žiogelis;BITUTĖS;2171351454;Ne;0;2;1;3
14653;Žiogelis;BITUTĖS;8835394030;Ne;0;2;0;2
14654;Žiogelis;BITUTĖS;4645245689;Ne;0;4;0;4
14655;Žiogelis;BITUTĖS;9874412804;Ne;0;2;0;2
14656;Žiogelis;BITUTĖS;5139645108;Ne;0;7;0;7
14657;Žiogelis;BITUTĖS;9766966628;Ne;0;2;0;2
14658;Žiogelis;RIEŠUTĖLIAI;8303283893;Ne;7;3;0;10
14659;Žiogelis;RIEŠUTĖLIAI;9863503924;Ne;0;5;0;5
14660;Žiogelis;RIEŠUTĖLIAI;6718866954;Ne;5;0;0;5
14661;Žiogelis;RIEŠUTĖLIAI;9144282935;Ne;0;0;6;6
14662;Žiogelis;RIEŠUTĖLIAI;8485973974;Ne;0;0;2;2
14663;Žiogelis;RIEŠUTĖLIAI;6039409252;Ne;0;5;0;5
14664;Žiogelis;RIEŠUTĖLIAI;2275123126;Ne;0;1;0;1
14665;Žiogelis;RIEŠUTĖLIAI;4994053705;Ne;12;2;0;14
14666;Žiogelis;RIEŠUTĖLIAI;6048534817;Ne;10;4;0;14
14667;Žiogelis;RIEŠUTĖLIAI;5133034709;Ne;10;1;0;11
14668;Žiogelis;RIEŠUTĖLIAI;2724389716;Ne;5;0;3;8
14669;Žiogelis;RIEŠUTĖLIAI;7763941077;Ne;0;1;1;2
14670;Žiogelis;RIEŠUTĖLIAI;7008807839;Ne;5;1;0;6
14671;Žiogelis;RIEŠUTĖLIAI;5984496369;Ne;5;2;0;7
14672;Žiogelis;RIEŠUTĖLIAI;4587838884;Ne;0;7;0;7
14673;Žiogelis;PAKALNUTĖS;1618384759;Ne;1;0;0;1
14674;Žiogelis;PAKALNUTĖS;5054228916;Ne;0;0;1;1
14675;Žiogelis;PAKALNUTĖS;8712788346;Ne;0;2;0;2
14676;Žiogelis;PAKALNUTĖS;1268908081;Ne;5;1;0;6
14677;Žiogelis;PAKALNUTĖS;3856321373;Ne;0;9;0;9
14678;Žiogelis;PAKALNUTĖS;6378295945;Ne;1;2;6;9
14679;Žiogelis;PAKALNUTĖS;8959934210;Ne;0;3;0;3
14680;Žiogelis;PAKALNUTĖS;8591680136;Ne;0;2;0;2
14681;Žiogelis;PAKALNUTĖS;7340918175;Ne;0;2;2;4
14682;Žiogelis;PAKALNUTĖS;6866685213;Ne;11;2;1;14
14683;Žiogelis;PAKALNUTĖS;5487213418;Ne;5;1;0;6
14684;Žiogelis;PAKALNUTĖS;8058231095;Ne;5;2;0;7
14685;Žiogelis;PAKALNUTĖS;6593794147;Ne;0;6;1;7
14686;Žiogelis;PAKALNUTĖS;1650284820;Ne;4;2;0;6
14687;Žiogelis;PAKALNUTĖS;6515890056;Ne;4;4;0;8
14688;Žiogelis;PAKALNUTĖS;7310459638;Ne;0;1;0;1
14689;Žiogelis;PAKALNUTĖS;1763603533;Ne;14;2;0;16
14690;Žiogelis;PAKALNUTĖS;9813150014;Ne;0;4;0;4
14691;Žiogelis;PAKALNUTĖS;5454676924;Ne;8;0;0;8
14692;Žolynėlis;Spanguolėlė;8810441600;Ne;0;3;3;6
14693;Žolynėlis;Spanguolėlė;6440991320;Ne;12;4;0;16
14694;Žolynėlis;Spanguolėlė;3631138915;Ne;0;1;0;1
14695;Žolynėlis;Spanguolėlė;5218448120;Ne;3;1;0;4
14696;Žolynėlis;Spanguolėlė;4076450179;Ne;0;6;0;6
14697;Žolynėlis;Spanguolėlė;4494255525;Ne;0;2;0;2
14698;Žolynėlis;Spanguolėlė;2493633505;Ne;0;0;4;4
14699;Žolynėlis;Spanguolėlė;5438607463;Ne;10;0;0;10
14700;Žolynėlis;Spanguolėlė;5208585298;Ne;0;1;0;1
14701;Žolynėlis;Spanguolėlė;7451189254;Ne;5;0;0;5
14702;Žolynėlis;Spanguolėlė;3498596516;Ne;5;0;0;5
14703;Žolynėlis;Spanguolėlė;9498369210;Ne;9;0;1;10
14704;Žolynėlis;Spanguolėlė;7260397656;Ne;0;1;2;3
14705;Žolynėlis;Spanguolėlė;2315947380;Ne;15;0;0;15
14706;Žolynėlis;Spanguolėlė;5074658392;Ne;12;2;1;15
14707;Žolynėlis;Spanguolėlė;6288526291;Ne;1;2;0;3
14708;Žolynėlis;Spanguolėlė;7234022613;Ne;0;1;0;1
14709;Žolynėlis;Spanguolėlė;1048782636;Ne;17;0;0;17
14710;Žolynėlis;"RŪTELĖ (spec)";1540454207;Ne;3;3;0;6
14711;Žolynėlis;"RŪTELĖ (spec)";4000928238;Ne;12;5;0;17
14712;Žolynėlis;"RŪTELĖ (spec)";5610113641;Ne;0;8;0;8
14713;Žolynėlis;"RŪTELĖ (spec)";9507509872;Ne;0;9;0;9
14714;Žolynėlis;"RŪTELĖ (spec)";2256262371;Ne;6;3;0;9
14715;Žolynėlis;"RŪTELĖ (spec)";1412336878;Ne;0;2;1;3
14716;Žolynėlis;"RŪTELĖ (spec)";8588753136;Ne;10;1;0;11
14717;Žolynėlis;"SAULUTĖ (spec)";9675783636;Ne;15;0;0;15
14718;Žolynėlis;"SAULUTĖ (spec)";7962304738;Ne;0;1;0;1
14719;Žolynėlis;"SAULUTĖ (spec)";6678697536;Ne;21;0;0;21
14720;Žolynėlis;"SAULUTĖ (spec)";6559029399;Ne;0;2;2;4
14721;Žolynėlis;"SAULUTĖ (spec)";3043560150;Ne;0;2;15;17
14722;Žolynėlis;"LINELIS (spec)";2665355759;Ne;0;6;4;10
14723;Žolynėlis;"LINELIS (spec)";2346018814;Ne;0;6;12;18
14724;Žolynėlis;"LINELIS (spec)";3337602618;Ne;5;2;4;11
14725;Žolynėlis;"LINELIS (spec)";2740906284;Ne;0;2;2;4
14726;Žolynėlis;"RASAKILA (spec)";6510930436;Ne;3;0;0;3
14727;Žolynėlis;"RASAKILA (spec)";6619551947;Ne;13;0;0;13
14728;Žolynėlis;"RASAKILA (spec)";4481343085;Ne;5;4;0;9
14729;Žolynėlis;"RAMUNĖLĖS (spec)";8552635547;Ne;9;1;0;10
14730;Žolynėlis;"RAMUNĖLĖS (spec)";4559404699;Ne;9;1;2;12
14731;Žolynėlis;"RAMUNĖLĖS (spec)";1703785525;Ne;5;2;0;7
14732;Žolynėlis;"RAMUNĖLĖS (spec)";2072569949;Ne;0;2;0;2
14733;Žolynėlis;"RAMUNĖLĖS (spec)";1090944316;Ne;5;1;5;11
14734;Žolynėlis;"RAMUNĖLĖS (spec)";5729519418;Ne;8;0;0;8
14735;Žolynėlis;Dobiliukai;2005661306;Ne;0;1;0;1
14736;Žolynėlis;Dobiliukai;2820649587;Ne;0;6;0;6
14737;Žolynėlis;Dobiliukai;7581436340;Ne;18;2;0;20
14738;Žolynėlis;Dobiliukai;3385748516;Ne;0;10;0;10
14739;Žolynėlis;Dobiliukai;4151633786;Ne;5;0;0;5
14740;Žolynėlis;Dobiliukai;2957426163;Ne;0;1;1;2
14741;Žolynėlis;Dobiliukai;5634886191;Ne;2;1;1;4
14742;Žolynėlis;Dobiliukai;3350246193;Ne;0;2;0;2
14743;Žolynėlis;Dobiliukai;5269388947;Ne;0;3;0;3
14744;Žolynėlis;Dobiliukai;1206144208;Ne;0;4;1;5
14745;Žolynėlis;Dobiliukai;1213384150;Ne;0;2;0;2
14746;Žolynėlis;Dobiliukai;4462289757;Ne;10;0;0;10
14747;Žolynėlis;Dobiliukai;7264446456;Ne;0;2;0;2
14748;Žolynėlis;Aguonėlė;3071570864;Ne;0;2;6;8
14749;Žolynėlis;Aguonėlė;1440666914;Ne;10;2;0;12
14750;Žolynėlis;Aguonėlė;1365534272;Ne;0;2;0;2
14751;Žolynėlis;Aguonėlė;2628636018;Ne;5;0;0;5
14752;Žolynėlis;Aguonėlė;6740105842;Ne;9;4;0;13
14753;Žolynėlis;Aguonėlė;3952731134;Ne;0;6;0;6
14754;Žolynėlis;Aguonėlė;6554864184;Ne;0;8;0;8
14755;Žolynėlis;Aguonėlė;9904373687;Ne;10;0;0;10
14756;Žolynėlis;Aguonėlė;9285539649;Ne;8;0;0;8
14757;Žolynėlis;Aguonėlė;5243624422;Ne;21;0;0;21
14758;Žolynėlis;Aguonėlė;6354832415;Ne;10;1;0;11
14759;Žolynėlis;Aguonėlė;9120786116;Ne;0;1;0;1
14760;Žolynėlis;Aguonėlė;1748987196;Ne;9;5;0;14
14761;Žolynėlis;Pienė;3520272555;Ne;0;4;0;4
14762;Žolynėlis;Pienė;2934361190;Ne;0;3;0;3
14763;Žolynėlis;Pienė;1163753820;Ne;2;0;0;2
14764;Žolynėlis;Pienė;9106152447;Ne;15;6;0;21
14765;Žolynėlis;Pienė;1879046798;Ne;5;0;0;5
14766;Žolynėlis;Pienė;9238832484;Ne;10;4;0;14
14767;Žolynėlis;Pienė;3877168024;Ne;15;4;0;19
14768;Žolynėlis;Pienė;6416217971;Ne;0;6;0;6
14769;Žolynėlis;Pienė;4618251201;Ne;0;2;0;2
14770;Žolynėlis;Pienė;5432464074;Ne;0;4;0;4
14771;Žolynėlis;Pienė;1264022895;Ne;0;4;0;4
14772;Žolynėlis;Pienė;8713225753;Ne;0;1;0;1
14773;Žolynėlis;Pienė;5332349177;Ne;0;7;0;7
14774;Žolynėlis;Pienė;5787331165;Ne;0;2;0;2
14775;Žolynėlis;Pienė;3091749692;Ne;0;11;0;11
14776;Žolynėlis;Pienė;2263679711;Ne;4;2;0;6
14777;Žolynėlis;Pienė;5973298389;Ne;0;4;0;4
14778;Žolynėlis;Čiobreliai;5564338170;Ne;15;0;0;15
14779;Žolynėlis;Čiobreliai;6543503409;Ne;0;7;0;7
14780;Žolynėlis;Čiobreliai;8215427354;Ne;5;2;0;7
14781;Žolynėlis;Čiobreliai;2565770471;Ne;12;0;0;12
14782;Žolynėlis;Čiobreliai;3198470147;Ne;0;4;0;4
14783;Žolynėlis;Čiobreliai;6829144389;Ne;0;5;0;5
14784;Žolynėlis;Čiobreliai;4545601535;Ne;0;5;0;5
14785;Žolynėlis;Čiobreliai;7256502393;Ne;3;5;0;8
14786;Žolynėlis;Čiobreliai;1901979061;Ne;0;2;0;2
14787;Žolynėlis;Čiobreliai;8027151284;Ne;0;5;0;5
14788;Žolynėlis;Čiobreliai;1933377698;Ne;0;7;0;7
14789;Žolynėlis;Čiobreliai;2108221942;Ne;2;6;0;8
14790;Žolynėlis;Čiobreliai;2881461471;Ne;0;4;0;4
14791;Žolynėlis;Čiobreliai;2460982987;Ne;0;6;0;6
14792;Žolynėlis;Čiobreliai;7980206574;Ne;0;4;0;4
14793;Žolynėlis;Čiobreliai;3088932720;Ne;3;4;0;7
14794;Žolynėlis;Čiobreliai;4758738231;Ne;0;7;0;7
14795;Žolynėlis;Čiobreliai;6024288147;Ne;0;4;0;4
14796;Žolynėlis;Čiobreliai;1485195267;Ne;0;4;0;4
14797;Žolynėlis;Avietėlė;4277871671;Ne;0;12;0;12
14798;Žolynėlis;Avietėlė;9404844632;Ne;0;12;0;12
14799;Žolynėlis;Avietėlė;5873931225;Ne;12;3;0;15
14800;Žolynėlis;Avietėlė;6124252688;Ne;5;0;1;6
14801;Žolynėlis;Avietėlė;1266614631;Ne;6;4;0;10
14802;Žolynėlis;Avietėlė;9993230229;Ne;0;2;0;2
14803;Žolynėlis;Avietėlė;7855260478;Ne;0;0;5;5
14804;Žolynėlis;Avietėlė;2727273826;Ne;2;0;0;2
14805;Žolynėlis;Avietėlė;2718255075;Ne;0;10;0;10
14806;Žolynėlis;Avietėlė;7201413203;Ne;0;2;0;2
14807;Žolynėlis;Avietėlė;6417150398;Ne;10;0;0;10
14808;Žolynėlis;Avietėlė;7517815798;Ne;1;0;0;1
14809;Žolynėlis;Avietėlė;4094173207;Ne;7;0;0;7
14810;Žolynėlis;Avietėlė;4229530366;Ne;0;4;0;4
14811;Žolynėlis;Avietėlė;9163883190;Ne;0;20;0;20
14812;Žuvėdra;"JŪROS ŽVAIGŽDUTĖS";7272717439;Ne;0;9;0;9
14813;Žuvėdra;"JŪROS ŽVAIGŽDUTĖS";9230342970;Ne;11;0;2;13
14814;Žuvėdra;"JŪROS ŽVAIGŽDUTĖS";2660909247;Ne;0;0;1;1
14815;Žuvėdra;"JŪROS ŽVAIGŽDUTĖS";2092890028;Ne;5;0;4;9
14816;Žuvėdra;"JŪROS ŽVAIGŽDUTĖS";5049101816;Ne;0;4;0;4
14817;Žuvėdra;"JŪROS ŽVAIGŽDUTĖS";1164464390;Ne;4;2;0;6
14818;Žuvėdra;"JŪROS ŽVAIGŽDUTĖS";1200084485;Ne;0;15;0;15
14819;Žuvėdra;"JŪROS ŽVAIGŽDUTĖS";4177319374;Ne;0;7;0;7
14820;Žuvėdra;"JŪROS ŽVAIGŽDUTĖS";7121154799;Ne;5;11;0;16
14821;Žuvėdra;"JŪROS ŽVAIGŽDUTĖS";2858729034;Ne;5;6;0;11
14822;Žuvėdra;"JŪROS ŽVAIGŽDUTĖS";7958768355;Ne;0;0;1;1
14823;Žuvėdra;"JŪROS ŽVAIGŽDUTĖS";6672289932;Ne;4;0;0;4
14824;Žuvėdra;"JŪROS ŽVAIGŽDUTĖS";9733979816;Ne;13;0;2;15
14825;Žuvėdra;"JŪROS ŽVAIGŽDUTĖS";5571732399;Ne;0;0;9;9
14826;Žuvėdra;"JŪROS ŽVAIGŽDUTĖS";3620753237;Ne;8;4;0;12
14827;Žuvėdra;DELFINUKAI;2582404760;Ne;0;3;0;3
14828;Žuvėdra;DELFINUKAI;5818639448;Ne;0;0;1;1
14829;Žuvėdra;DELFINUKAI;1171751803;Ne;0;0;1;1
14830;Žuvėdra;DELFINUKAI;7235005234;Ne;12;0;0;12
14831;Žuvėdra;DELFINUKAI;5876618912;Ne;0;6;9;15
14832;Žuvėdra;DELFINUKAI;6989906913;Ne;6;2;0;8
14833;Žuvėdra;DELFINUKAI;5002760763;Ne;5;0;0;5
14834;Žuvėdra;DELFINUKAI;6327915228;Ne;4;0;0;4
14835;Žuvėdra;DELFINUKAI;7803397430;Ne;0;0;3;3
14836;Žuvėdra;DELFINUKAI;7705946236;Ne;5;5;0;10
14837;Žuvėdra;DELFINUKAI;1974766090;Ne;0;11;3;14
14838;Žuvėdra;DELFINUKAI;8869169590;Ne;1;1;0;2
14839;Žuvėdra;DELFINUKAI;3069506904;Ne;3;7;0;10
14840;Žuvėdra;DELFINUKAI;9651268462;Ne;9;0;0;9
14841;Žuvėdra;DELFINUKAI;2082128566;Ne;0;0;4;4
14842;Žuvėdra;OSMINOŽKI;1340241206;Ne;8;0;0;8
14843;Žuvėdra;OSMINOŽKI;5021263583;Ne;0;9;0;9
14844;Žuvėdra;OSMINOŽKI;63053155507;Ne;0;8;0;8
14845;Žuvėdra;OSMINOŽKI;1941428466;Ne;5;0;0;5
14846;Žuvėdra;OSMINOŽKI;2731016281;Ne;0;10;0;10
14847;Žuvėdra;OSMINOŽKI;6612880861;Ne;0;3;0;3
14848;Žuvėdra;OSMINOŽKI;75901332720;Ne;1;0;0;1
14849;Žuvėdra;OSMINOŽKI;14760907606;Ne;17;0;1;18
14850;Žuvėdra;OSMINOŽKI;5684848140;Ne;0;8;0;8
14851;Žuvėdra;OSMINOŽKI;5489757084;Ne;6;4;0;10
14852;Žuvėdra;OSMINOŽKI;8408371550;Ne;11;0;0;11
14853;Žuvėdra;OSMINOŽKI;5496071972;Ne;0;9;0;9
14854;Žuvėdra;OSMINOŽKI;5273726957;Ne;6;2;0;8
14855;Žuvėdra;OSMINOŽKI;6537464526;Ne;0;12;0;12
14856;Žuvėdra;OSMINOŽKI;5674529681;Ne;0;1;0;1
14857;Žuvėdra;OSMINOŽKI;7368183516;Ne;0;8;0;8
14858;Žuvėdra;OSMINOŽKI;3853045274;Ne;2;4;0;6
14859;Žuvėdra;OSMINOŽKI;3185158741;Ne;9;2;0;11
14860;Žuvėdra;OSMINOŽKI;8822952385;Ne;10;4;0;14
14861;Žuvėdra;OSMINOŽKI;5198825127;Ne;3;0;6;9
14862;Žuvėdra;OSMINOŽKI;5561903903;Ne;13;0;0;13
14863;Žuvėdra;RUSALAČKA;2849503557;Ne;0;1;0;1
14864;Žuvėdra;RUSALAČKA;8700802853;Ne;0;11;0;11
14865;Žuvėdra;RUSALAČKA;1509519996;Ne;0;5;0;5
14866;Žuvėdra;RUSALAČKA;3613045982;Ne;4;0;0;4
14867;Žuvėdra;RUSALAČKA;7467154866;Ne;0;3;0;3
14868;Žuvėdra;RUSALAČKA;5151984122;Ne;0;2;0;2
14869;Žuvėdra;RUSALAČKA;4715123063;Ne;0;2;1;3
14870;Žuvėdra;RUSALAČKA;6715416675;Ne;0;0;3;3
14871;Žuvėdra;RUSALAČKA;3349158713;Ne;10;1;0;11
14872;Žuvėdra;RUSALAČKA;8942228415;Ne;0;1;2;3
14873;Žuvėdra;RUSALAČKA;1707519901;Ne;0;2;1;3
14874;Žuvėdra;RUSALAČKA;1810114962;Ne;10;1;0;11
14875;Žuvėdra;RUSALAČKA;1960306957;Ne;5;3;0;8
14876;Žuvėdra;RUSALAČKA;2640238143;Ne;0;8;0;8
14877;Žuvėdra;RUSALAČKA;2577280901;Ne;0;4;0;4
14878;Žuvėdra;RUSALAČKA;5481785360;Ne;7;0;0;7
14879;Žuvėdra;RUSALAČKA;9011276878;Ne;6;0;0;6
14880;Žuvėdra;RUSALAČKA;7387863175;Ne;0;4;0;4
14881;Žuvėdra;JANTARIKI;8111760611;Ne;5;0;0;5
14882;Žuvėdra;JANTARIKI;1219808187;Ne;0;2;0;2
14883;Žuvėdra;JANTARIKI;4881712317;Ne;4;17;0;21
14884;Žuvėdra;JANTARIKI;7464494386;Ne;0;2;0;2
14885;Žuvėdra;JANTARIKI;1072201019;Ne;0;1;0;1
14886;Žuvėdra;JANTARIKI;3058300342;Ne;0;2;0;2
14887;Žuvėdra;JANTARIKI;9256424331;Ne;15;3;0;18
14888;Žuvėdra;JANTARIKI;7908898376;Ne;6;1;0;7
14889;Žuvėdra;JANTARIKI;2789379055;Ne;6;1;0;7
14890;Žuvėdra;JANTARIKI;9838754800;Ne;0;1;0;1
14891;Žuvėdra;JANTARIKI;1039661177;Ne;0;5;0;5
14892;Žuvėdra;JANTARIKI;1604010000;Ne;6;0;0;6
14893;Žuvėdra;"AUKSINĖ ŽUVELĖ";9914814198;Ne;5;0;0;5
14894;Žuvėdra;"AUKSINĖ ŽUVELĖ";6287034023;Ne;0;0;2;2
14895;Žuvėdra;"AUKSINĖ ŽUVELĖ";2844920302;Ne;0;12;0;12
14896;Žuvėdra;"AUKSINĖ ŽUVELĖ";9460887312;Ne;8;1;3;12
14897;Žuvėdra;"AUKSINĖ ŽUVELĖ";2323431685;Ne;0;6;0;6
14898;Žuvėdra;"AUKSINĖ ŽUVELĖ";5009153711;Ne;6;0;0;6
14899;Žuvėdra;"AUKSINĖ ŽUVELĖ";7258677907;Ne;6;3;0;9
14900;Žuvėdra;"AUKSINĖ ŽUVELĖ";4739865462;Ne;0;0;3;3
14901;Žuvėdra;"AUKSINĖ ŽUVELĖ";7135848009;Ne;8;1;0;9
14902;Žuvėdra;"AUKSINĖ ŽUVELĖ";3781157324;Ne;16;0;1;17
14903;Žuvėdra;"AUKSINĖ ŽUVELĖ";7164457313;Ne;12;0;0;12
14904;Žvangutis;PELIUKŲ;7616874368;Ne;0;3;0;3
14905;Žvangutis;PELIUKŲ;3906808900;Ne;2;0;2;4
14906;Žvangutis;PELIUKŲ;7722153982;Ne;0;4;0;4
14907;Žvangutis;PELIUKŲ;4295016449;Ne;2;7;0;9
14908;Žvangutis;PELIUKŲ;9958554027;Ne;0;6;1;7
14909;Žvangutis;PELIUKŲ;5112520119;Ne;0;2;1;3
14910;Žvangutis;PELIUKŲ;5817402847;Ne;10;11;0;21
14911;Žvangutis;PELIUKŲ;4407484687;Ne;0;2;0;2
14912;Žvangutis;PELIUKŲ;4337928288;Ne;0;2;0;2
14913;Žvangutis;PELIUKŲ;6788355315;Ne;0;1;0;1
14914;Žvangutis;PELIUKŲ;8062689240;Ne;0;4;0;4
14915;Žvangutis;PELIUKŲ;3875906173;Ne;0;2;0;2
14916;Žvangutis;PELIUKŲ;1328464199;Ne;0;8;3;11
14917;Žvangutis;PELIUKŲ;4992231141;Ne;0;2;5;7
14918;Žvangutis;PELIUKŲ;3408933802;Ne;0;0;2;2
14919;Žvangutis;PELIUKŲ;8481666202;Ne;0;1;9;10
14920;Žvangutis;PELIUKŲ;4705131089;Ne;1;0;0;1
14921;Žvangutis;ANČIUKŲ;9134683276;Ne;0;2;0;2
14922;Žvangutis;ANČIUKŲ;9145365865;Ne;0;9;0;9
14923;Žvangutis;ANČIUKŲ;6701947168;Ne;0;4;0;4
14924;Žvangutis;ANČIUKŲ;3315858185;Ne;0;2;0;2
14925;Žvangutis;ANČIUKŲ;7320625500;Ne;0;5;0;5
14926;Žvangutis;ANČIUKŲ;6110958520;Ne;6;4;0;10
14927;Žvangutis;ANČIUKŲ;6989839997;Ne;6;4;0;10
14928;Žvangutis;ANČIUKŲ;7202747419;Ne;7;2;0;9
14929;Žvangutis;ANČIUKŲ;3817258555;Ne;3;1;0;4
14930;Žvangutis;ANČIUKŲ;3775960571;Ne;26;0;0;26
14931;Žvangutis;ANČIUKŲ;7267340112;Ne;0;3;0;3
14932;Žvangutis;ANČIUKŲ;50889154641;Ne;0;4;0;4
14933;Žvangutis;ANČIUKŲ;1310113034;Ne;0;2;0;2
14934;Žvangutis;ANČIUKŲ;3513746926;Ne;0;2;11;13
14935;Žvangutis;ANČIUKŲ;8511103595;Ne;0;5;0;5
14936;Žvangutis;ANČIUKŲ;6815104137;Ne;0;4;0;4
14937;Žvangutis;ANČIUKŲ;6844824726;Ne;0;4;0;4
14938;Žvangutis;ANČIUKŲ;9408369641;Ne;0;1;0;1
14939;Žvangutis;ANČIUKŲ;2600596320;Ne;0;2;0;2
14940;Žvangutis;ANČIUKŲ;1339151674;Ne;0;2;0;2
14941;Žvangutis;PELĖDŽIUKŲ;1322688456;Ne;0;3;0;3
14942;Žvangutis;PELĖDŽIUKŲ;9036869235;Ne;0;4;0;4
14943;Žvangutis;PELĖDŽIUKŲ;2570379643;Ne;0;4;0;4
14944;Žvangutis;PELĖDŽIUKŲ;2623107843;Ne;4;3;0;7
14945;Žvangutis;PELĖDŽIUKŲ;1185135525;Ne;5;6;0;11
14946;Žvangutis;PELĖDŽIUKŲ;2411307963;Ne;0;5;0;5
14947;Žvangutis;PELĖDŽIUKŲ;9468660351;Ne;0;4;0;4
14948;Žvangutis;PELĖDŽIUKŲ;1324948757;Ne;5;0;0;5
14949;Žvangutis;PELĖDŽIUKŲ;2922083476;Ne;0;6;0;6
14950;Žvangutis;PELĖDŽIUKŲ;1282567366;Ne;7;4;0;11
14951;Žvangutis;PELĖDŽIUKŲ;6068428687;Ne;0;5;0;5
14952;Žvangutis;PELĖDŽIUKŲ;9149037184;Ne;6;4;0;10
14953;Žvangutis;PELĖDŽIUKŲ;3665275100;Ne;0;1;0;1
14954;Žvangutis;PELĖDŽIUKŲ;5012996199;Ne;0;5;0;5
14955;Žvangutis;PELĖDŽIUKŲ;8295525284;Ne;0;1;0;1
14956;Žvangutis;PELĖDŽIUKŲ;6040986672;Ne;0;8;3;11
14957;Žvangutis;PELĖDŽIUKŲ;5723728310;Ne;0;1;2;3
14958;Žvangutis;PELĖDŽIUKŲ;1404378308;Ne;6;0;0;6
14959;Žvangutis;PELĖDŽIUKŲ;6207989105;Ne;0;1;0;1
14960;Žvangutis;PELĖDŽIUKŲ;5539992579;Ne;0;4;0;4
14961;Žvangutis;KAČIUKŲ;7213349517;Ne;0;1;0;1
14962;Žvangutis;KAČIUKŲ;7581320158;Ne;6;0;0;6
14963;Žvangutis;KAČIUKŲ;2296360416;Ne;0;8;0;8
14964;Žvangutis;KAČIUKŲ;7721746116;Ne;0;1;0;1
14965;Žvangutis;KAČIUKŲ;2598842770;Ne;0;4;5;9
14966;Žvangutis;KAČIUKŲ;1142315595;Ne;10;6;1;17
14967;Žvangutis;KAČIUKŲ;9239279639;Ne;0;6;0;6
14968;Žvangutis;KAČIUKŲ;4696437804;Ne;0;1;0;1
14969;Žvangutis;KAČIUKŲ;8492637734;Ne;0;2;0;2
14970;Žvangutis;KAČIUKŲ;2503355659;Ne;9;1;0;10
14971;Žvangutis;KAČIUKŲ;9235884407;Ne;4;5;0;9
14972;Žvangutis;KAČIUKŲ;8360356476;Ne;0;2;0;2
14973;Žvangutis;KAČIUKŲ;8863909185;Ne;5;6;0;11
14974;Žvangutis;KAČIUKŲ;3498584864;Ne;0;1;0;1
14975;Žvangutis;KAČIUKŲ;4408086513;Ne;0;12;0;12
14976;Žvangutis;KAČIUKŲ;1256264382;Ne;0;15;0;15
14977;Žvangutis;KAČIUKŲ;8030520477;Ne;0;5;4;9
14978;Žvangutis;KAČIUKŲ;8810739982;Ne;0;2;0;2
14979;Žvangutis;KAČIUKŲ;2740875969;Ne;0;0;6;6
14980;Žvangutis;KAČIUKŲ;8269992031;Ne;0;12;0;12
14981;Žvangutis;KAČIUKŲ;1224292338;Ne;7;0;0;7
14982;Žvangutis;MEŠKUČIŲ;8753815074;Ne;6;0;0;6
14983;Žvangutis;MEŠKUČIŲ;3781959962;Ne;0;5;5;10
14984;Žvangutis;MEŠKUČIŲ;8506809320;Ne;10;4;0;14
14985;Žvangutis;MEŠKUČIŲ;8376022173;Ne;0;1;4;5
14986;Žvangutis;MEŠKUČIŲ;6825952779;Ne;6;3;1;10
14987;Žvangutis;MEŠKUČIŲ;1590704985;Ne;7;2;0;9
14988;Žvangutis;MEŠKUČIŲ;5328547183;Ne;0;2;0;2
14989;Žvangutis;MEŠKUČIŲ;2298103025;Ne;0;1;0;1
14990;Žvangutis;MEŠKUČIŲ;9523189658;Ne;4;0;0;4
14991;Žvangutis;MEŠKUČIŲ;9406190681;Ne;3;1;0;4
14992;Žvangutis;MEŠKUČIŲ;5126809299;Ne;0;0;1;1
14993;Žvangutis;MEŠKUČIŲ;9883337991;Ne;21;0;0;21
14994;Žvangutis;MEŠKUČIŲ;8598396569;Ne;0;1;1;2
14995;Žvangutis;MEŠKUČIŲ;1706200292;Ne;0;0;1;1
14996;Žvangutis;KIŠKUČIŲ;8906823569;Ne;9;3;0;12
14997;Žvangutis;KIŠKUČIŲ;6094686500;Ne;0;0;1;1
14998;Žvangutis;KIŠKUČIŲ;2049990751;Ne;3;0;0;3
14999;Žvangutis;KIŠKUČIŲ;2308726385;Ne;0;0;1;1
15000;Žvangutis;KIŠKUČIŲ;9711017196;Ne;0;0;4;4
15001;Žvangutis;KIŠKUČIŲ;7051007224;Ne;4;0;0;4
15002;Žvangutis;KIŠKUČIŲ;3940893168;Ne;0;4;0;4
15003;Žvangutis;KIŠKUČIŲ;1592158260;Ne;12;0;1;13
15004;Žvangutis;KIŠKUČIŲ;5022657156;Ne;2;0;0;2
15005;Žvangutis;KIŠKUČIŲ;3029382724;Ne;4;3;0;7
15006;Žvangutis;KIŠKUČIŲ;4514606021;Ne;0;9;0;9
15007;Žvangutis;KIŠKUČIŲ;7844987649;Ne;0;0;2;2
15008;Žvangutis;KIŠKUČIŲ;7599491698;Ne;5;2;0;7
15009;Žvangutis;KIŠKUČIŲ;4968365511;Ne;16;0;1;17
15010;Žirniukas;Boružiukų;5311746004;Ne;0;0;8;8
15011;Žirniukas;Boružiukų;6466220057;Ne;5;1;0;6
15012;Žirniukas;Boružiukų;2785102131;Ne;0;6;0;6
15013;Žirniukas;Boružiukų;6624263476;Ne;0;6;0;6
15014;Žirniukas;Boružiukų;8213507698;Ne;0;5;0;5
15015;Žirniukas;Boružiukų;2528905738;Ne;0;2;0;2
15016;Žirniukas;Boružiukų;6268788036;Ne;0;1;0;1
15017;Žirniukas;Boružiukų;6363169823;Ne;0;7;0;7
15018;Žirniukas;Boružiukų;2636634198;Ne;0;4;0;4
15019;Žirniukas;Boružiukų;8148254025;Ne;5;6;0;11
15020;Žirniukas;Boružiukų;6531175340;Ne;8;0;0;8
15021;Žirniukas;Boružiukų;9647374339;Ne;0;2;0;2
15022;Žirniukas;Boružiukų;6641200341;Ne;0;1;0;1
15023;Žirniukas;Boružiukų;3022672028;Ne;11;2;0;13
15024;Žirniukas;Boružiukų;9896989995;Ne;0;2;0;2
15025;Žirniukas;Boružiukų;5420360864;Ne;0;5;0;5
15026;Žirniukas;Boružiukų;1873446232;Ne;0;0;5;5
15027;Žirniukas;Boružiukų;8294569569;Ne;0;2;4;6
15028;Žirniukas;Boružiukų;7397202752;Ne;0;5;0;5
15029;Žirniukas;Boružiukų;7190628011;Ne;7;0;7;14
15030;Žirniukas;Smalsučiai;2132625724;Ne;0;4;1;5
15031;Žirniukas;Smalsučiai;2557138057;Ne;0;12;3;15
15032;Žirniukas;Smalsučiai;8644938346;Ne;0;1;0;1
15033;Žirniukas;Smalsučiai;5761169841;Ne;7;2;2;11
15034;Žirniukas;Smalsučiai;5104110821;Ne;0;6;1;7
15035;Žirniukas;Smalsučiai;5471647472;Ne;0;1;0;1
15036;Žirniukas;Smalsučiai;2151329751;Ne;0;4;0;4
15037;Žirniukas;Smalsučiai;5939918015;Ne;5;3;3;11
15038;Žirniukas;Smalsučiai;2049123663;Ne;5;0;5;10
15039;Žirniukas;Smalsučiai;3010062747;Ne;0;2;0;2
15040;Žirniukas;Smalsučiai;2162238771;Ne;0;5;0;5
15041;Žirniukas;Smalsučiai;1064894307;Ne;0;5;0;5
15042;Žirniukas;Smalsučiai;4378877068;Ne;0;4;0;4
15043;Žirniukas;Smalsučiai;2029018108;Ne;2;8;1;11
15044;Žirniukas;Smalsučiai;2309995947;Ne;0;2;5;7
15045;Žirniukas;Smalsučiai;1162904969;Ne;0;2;0;2
15046;Žirniukas;Smalsučiai;1514504241;Ne;0;4;1;5
15047;Žirniukas;Smalsučiai;6180439078;Ne;0;2;1;3
15048;Žirniukas;Smalsučiai;5987510202;Ne;0;2;2;4
15049;Žirniukas;Smalsučiai;1944169398;Ne;0;3;0;3
15050;Žirniukas;Smalsučiai;7975957714;Ne;0;1;0;1
15051;Žirniukas;Smalsučiai;3808838764;Ne;0;5;0;5
15052;Žirniukas;Smalsučiai;1678041002;Ne;8;2;6;16
15053;Žirniukas;Gėlyčių;6121388208;Ne;0;0;1;1
15054;Žirniukas;Gėlyčių;6201949014;Ne;14;0;0;14
15055;Žirniukas;Gėlyčių;7872611724;Ne;0;1;2;3
15056;Žirniukas;Gėlyčių;9497414375;Ne;0;4;1;5
15057;Žirniukas;Gėlyčių;5422282267;Ne;0;3;3;6
15058;Žirniukas;Gėlyčių;3189741449;Ne;8;1;0;9
15059;Žirniukas;Gėlyčių;5427116799;Ne;8;0;4;12
15060;Žirniukas;Gėlyčių;3214136760;Ne;0;11;0;11
15061;Žirniukas;Gėlyčių;9021495553;Ne;0;0;8;8
15062;Žirniukas;Gėlyčių;6147030672;Ne;0;0;3;3
15063;Žirniukas;Nykštukų;5734197350;Ne;1;2;0;3
15064;Žirniukas;Nykštukų;2746074694;Ne;12;0;0;12
15065;Žirniukas;Nykštukų;4282344625;Ne;6;0;0;6
15066;Žirniukas;Nykštukų;3874713264;Ne;5;5;0;10
15067;Žirniukas;Nykštukų;1532129054;Ne;0;3;0;3
15068;Žirniukas;Nykštukų;7368124402;Ne;0;10;0;10
15069;Žirniukas;Nykštukų;1635353228;Ne;0;2;0;2
15070;Žirniukas;Nykštukų;2027344763;Ne;0;3;11;14
15071;Žirniukas;Nykštukų;9425682286;Ne;0;0;2;2
15072;Žirniukas;Nykštukų;4704879073;Ne;4;0;0;4
15073;Žirniukas;Nykštukų;4732089209;Ne;0;4;0;4
15074;Žirniukas;Nykštukų;9988669252;Ne;1;2;0;3
15075;Žirniukas;Nykštukų;8242086461;Ne;0;2;2;4
15076;Žirniukas;Nykštukų;8242086461;Ne;0;2;2;4
15077;Žirniukas;Nykštukų;8242086461;Ne;0;2;2;4
15078;Žirniukas;Nykštukų;6511802399;Ne;0;2;2;4
15079;Žirniukas;Nykštukų;6511802399;Ne;0;2;2;4
15080;Žirniukas;Nykštukų;6511802399;Ne;0;2;2;4
15081;Žirniukas;Saulytės;9649896460;Ne;0;12;3;15
15082;Žirniukas;Saulytės;5819443551;Ne;0;2;0;2
15083;Žirniukas;Saulytės;2733313392;Ne;0;4;3;7
15084;Žirniukas;Saulytės;9707776533;Ne;0;4;0;4
15085;Žirniukas;Saulytės;7278153529;Ne;0;4;0;4
15086;Žirniukas;Saulytės;2325139043;Ne;5;6;1;12
15087;Žirniukas;Saulytės;4527367786;Ne;0;1;0;1
15088;Žirniukas;Saulytės;6362626389;Ne;0;1;0;1
15089;Žirniukas;Saulytės;9961947583;Ne;0;7;0;7
15090;Žirniukas;Saulytės;9656768968;Ne;0;5;3;8
15091;Žirniukas;Saulytės;4045432303;Ne;9;1;0;10
15092;Žirniukas;Saulytės;1074945082;Ne;0;7;0;7
15093;Žirniukas;Saulytės;4433579937;Ne;3;2;0;5
15094;Žirniukas;Saulytės;4229687519;Ne;0;0;3;3
15095;Žirniukas;Saulytės;8151071354;Ne;0;1;0;1
15096;Žirniukas;Saulytės;8599313527;Ne;0;2;5;7
15097;Žirniukas;Saulytės;4320686646;Ne;0;3;0;3
15098;Žirniukas;Drugelių;9232828844;Ne;0;7;0;7
15099;Žirniukas;Drugelių;5269074776;Ne;5;0;4;9
15100;Žirniukas;Drugelių;3509857181;Ne;0;1;0;1
15101;Žirniukas;Drugelių;2517524802;Ne;5;5;0;10
15102;Žirniukas;Drugelių;9901196251;Ne;7;0;3;10
15103;Žirniukas;Drugelių;5046469974;Ne;0;0;1;1
15104;Žirniukas;Drugelių;4536071547;Ne;0;5;1;6
15105;Žirniukas;Drugelių;6501961029;Ne;2;4;0;6
15106;Žirniukas;Drugelių;3996393849;Ne;6;1;4;11
15107;Žirniukas;Drugelių;7240364379;Ne;0;0;4;4
15108;Žirniukas;Drugelių;6300372863;Ne;0;5;0;5
15109;Žirniukas;Drugelių;5670489807;Ne;0;2;0;2
15110;Žirniukas;Drugelių;9794535841;Ne;12;0;0;12
15111;Žirniukas;Drugelių;1031316325;Ne;0;0;1;1
15112;Žirniukas;Drugelių;1018506580;Ne;0;4;2;6
15113;Žirniukas;Drugelių;9384464752;Ne;0;4;0;4
15114;Žirniukas;Pelėdžiukai;7889803840;Ne;0;6;0;6
15115;Žirniukas;Pelėdžiukai;2895924102;Ne;10;0;2;12
15116;Žirniukas;Pelėdžiukai;4347695841;Ne;8;0;3;11
15117;Žirniukas;Pelėdžiukai;9381704756;Ne;5;0;0;5
15118;Žirniukas;Pelėdžiukai;7356213150;Ne;5;2;0;7
15119;Žirniukas;Pelėdžiukai;7545458622;Ne;0;2;2;4
15120;Žirniukas;Pelėdžiukai;8354728917;Ne;0;3;0;3
15121;Žirniukas;Pelėdžiukai;9511974432;Ne;0;1;0;1
15122;Žirniukas;Pelėdžiukai;7755938379;Ne;4;0;0;4
15123;Žirniukas;Pelėdžiukai;5470692657;Ne;0;0;9;9
15124;Žirniukas;Pelėdžiukai;8690042163;Ne;13;0;0;13
15125;Žirniukas;Pelėdžiukai;8808445761;Ne;11;8;1;20
15126;Žirniukas;Pelėdžiukai;2332260494;Ne;8;0;0;8
15127;Žirniukas;Pelėdžiukai;6941160450;Ne;7;1;0;8
15128;Žirniukas;Pelėdžiukai;4464151713;Ne;0;0;2;2
15129;Žirniukas;Pelėdžiukai;3907578167;Ne;0;2;0;2
15130;Žirniukas;Pelėdžiukai;4069128550;Ne;0;0;1;1
15131;Žirniukas;Pelėdžiukai;7767762079;Ne;8;1;0;9
15132;Žirniukas;ZUIKUČIAI;5613818351;Ne;0;1;0;1
15133;Žirniukas;ZUIKUČIAI;1345594362;Ne;0;4;0;4
15134;Žirniukas;ZUIKUČIAI;9847840127;Taip;0;2;0;2
15135;Žirniukas;ZUIKUČIAI;5212289551;Ne;0;0;1;1
15136;Žirniukas;ZUIKUČIAI;1005139737;Ne;10;0;1;11
15137;Žirniukas;ZUIKUČIAI;7968189099;Ne;5;3;1;9
15138;Žirniukas;ZUIKUČIAI;7081683726;Ne;3;3;0;6
15139;Žirniukas;ZUIKUČIAI;7021496832;Ne;0;0;4;4
15140;Žirniukas;ZUIKUČIAI;4860680720;Ne;17;1;0;18
15141;Žirniukas;ZUIKUČIAI;7269948694;Ne;0;2;0;2
15142;Žirniukas;ZUIKUČIAI;6594686128;Ne;5;0;0;5
15143;Žirniukas;ZUIKUČIAI;1679864330;Ne;5;0;0;5
15144;Žirniukas;ZUIKUČIAI;9569187800;Ne;20;0;0;20
15145;Aušra;Kodėlčiukai;2611563172;Ne;14;0;0;14
15146;Aušra;Kodėlčiukai;3420851059;Ne;5;0;0;5
15147;Aušra;Kodėlčiukai;2199083085;Ne;0;4;1;5
15148;Aušra;Kodėlčiukai;4720749995;Ne;4;0;3;7
15149;Aušra;Kodėlčiukai;6139706771;Ne;6;0;0;6
15150;Aušra;Kodėlčiukai;7314273812;Ne;13;4;0;17
15151;Aušra;Kodėlčiukai;5046439805;Ne;3;0;0;3
15152;Aušra;Kodėlčiukai;4540040693;Ne;6;2;0;8
15153;Aušra;Kodėlčiukai;1423840991;Ne;15;0;0;15
15154;Aušra;Kodėlčiukai;5013135853;Ne;12;0;0;12
15155;Aušra;Kodėlčiukai;9728140172;Ne;0;4;0;4
15156;Aušra;Kodėlčiukai;7765504789;Ne;9;2;0;11
15157;Aušra;Kodėlčiukai;8108663467;Ne;8;4;0;12
15158;Aušra;Kodėlčiukai;4824773027;Ne;12;1;0;13
15159;Aušra;Kodėlčiukai;1897365632;Ne;0;10;0;10
15160;Aušra;Kodėlčiukai;7469266085;Ne;0;17;0;17
15161;Aušra;Kodėlčiukai;1010721404;Ne;0;4;0;4
15162;Aušra;Kodėlčiukai;1883185016;Ne;10;0;0;10
15163;Aušra;Kodėlčiukai;1773343262;Ne;3;0;0;3
15164;Aušra;Kodėlčiukai;9437530221;Ne;10;5;1;16
15165;Aušra;Kodėlčiukai;7367602247;Ne;0;4;0;4
15166;Aušra;Kodėlčiukai;3627487971;Ne;7;0;0;7
15167;Aušra;"4B klasė";92119607174;Ne;9;4;0;13
15168;Aušra;"4B klasė";22923377435;Ne;0;4;0;4
15169;Aušra;"4B klasė";41852924528;Ne;0;21;0;21
15170;Aušra;"4B klasė";58526614808;Ne;0;21;0;21
15171;Aušra;"4B klasė";41039525379;Ne;0;4;0;4
15172;Aušra;"4B klasė";37339481276;Ne;0;21;0;21
15173;Aušra;"4B klasė";45165946624;Ne;0;21;0;21
15174;Aušra;"4B klasė";59107169775;Ne;1;4;0;5
15175;Aušra;"4B klasė";48349819906;Ne;6;4;0;10
15176;Aušra;"4B klasė";71596384638;Ne;0;4;0;4
15177;Aušra;"4B klasė";52332096506;Ne;0;4;0;4
15178;Aušra;"4B klasė";35703433862;Ne;4;4;0;8
15179;Aušra;"4B klasė";6201728036;Ne;0;21;0;21
15180;Aušra;"4B klasė";36889923728;Ne;0;21;0;21
15181;Aušra;"4B klasė";39957179831;Ne;4;4;0;8
15182;Aušra;"4B klasė";52909474598;Ne;0;4;0;4
15183;Aušra;"4B klasė";8901585006;Ne;0;21;0;21
15184;Aušra;"4B klasė";64562667133;Ne;0;21;0;21
15185;Aušra;"4B klasė";95076478544;Ne;5;4;0;9
15186;Aušra;"4B klasė";36899257479;Ne;3;4;0;7
15187;Aušra;"4B klasė";57520886724;Ne;4;4;0;8
15188;Aušra;"4B klasė";1815771421;Ne;1;4;0;5
15189;Aušra;"4B klasė";75433637766;Ne;0;21;0;21
15190;Aušra;"4B klasė";83119050626;Ne;0;21;0;21
15191;Aušra;"4B klasė";83119050626;Ne;0;21;0;21
15192;Aušra;Smalsučiai;1450251779;Ne;0;9;0;9
15193;Aušra;Smalsučiai;8176840834;Ne;0;3;0;3
15194;Aušra;Smalsučiai;3680329197;Ne;8;4;0;12
15195;Aušra;Smalsučiai;8740755922;Ne;0;0;2;2
15196;Aušra;Smalsučiai;3898178166;Ne;0;7;0;7
15197;Aušra;Smalsučiai;29499576216;Ne;0;1;3;4
15198;Aušra;Smalsučiai;1940882109;Ne;0;1;0;1
15199;Aušra;Smalsučiai;4404047456;Ne;0;1;3;4
15200;Aušra;Smalsučiai;97102749430;Ne;0;2;0;2
15201;Aušra;Smalsučiai;9702136789;Ne;0;4;0;4
15202;Aušra;Smalsučiai;8709340592;Ne;2;4;5;11
15203;Aušra;Smalsučiai;5673568541;Ne;0;2;0;2
15204;Aušra;Smalsučiai;5524681006;Ne;0;3;1;4
15205;Aušra;Smalsučiai;6384243597;Ne;0;14;0;14
15206;Aušra;Smalsučiai;19402768340;Ne;0;10;0;10
15207;Aušra;Smalsučiai;2523842161;Ne;3;3;4;10
15208;Aušra;Smalsučiai;1343532870;Ne;11;2;0;13
15209;Aušra;Smalsučiai;7043021721;Ne;0;14;0;14
15210;Aušra;Smalsučiai;1612662076;Ne;0;13;0;13
15211;Aušra;Smalsučiai;1387254053;Ne;0;1;2;3
15212;Aušra;Smalsučiai;1575761029;Ne;5;4;3;12
15213;Aušra;Smalsučiai;5777939563;Ne;0;5;1;6
15214;Aušra;Smalsučiai;7814902928;Ne;0;2;3;5
15215;Aušra;"1A klasė";3001784066;Ne;5;4;0;9
15216;Aušra;"1A klasė";84116863778;Ne;1;4;0;5
15217;Aušra;"1A klasė";2227238810;Ne;0;4;0;4
15218;Aušra;"1A klasė";59837942520;Ne;0;4;0;4
15219;Aušra;"1A klasė";11053850075;Ne;2;4;0;6
15220;Aušra;"1A klasė";23609052737;Ne;0;4;0;4
15221;Aušra;"1A klasė";41017803426;Ne;2;4;0;6
15222;Aušra;"1A klasė";21544489661;Ne;6;4;0;10
15223;Aušra;"1A klasė";24625925423;Ne;0;4;0;4
15224;Aušra;"1A klasė";62186117615;Ne;0;4;0;4
15225;Aušra;"1A klasė";3526237179;Ne;7;4;0;11
15226;Aušra;"1A klasė";1893586984;Ne;0;21;0;21
15227;Aušra;"1A klasė";8686777160;Ne;0;4;0;4
15228;Aušra;"1A klasė";15657824495;Ne;0;4;0;4
15229;Aušra;"1A klasė";5988529284;Ne;0;4;0;4
15230;Aušra;"1A klasė";79051821501;Ne;0;4;0;4
15231;Aušra;"1A klasė";2062470430;Ne;1;4;0;5
15232;Aušra;"1A klasė";5815377310;Ne;0;4;0;4
15233;Aušra;"1A klasė";58254707316;Ne;5;4;0;9
15234;Aušra;"1A klasė";1385844067;Ne;0;4;0;4
15235;Aušra;"1A klasė";2121418946;Ne;12;4;0;16
15236;Aušra;"1A klasė";1219257874;Ne;0;21;0;21
15237;Aušra;"1A klasė";4325224130;Ne;5;4;0;9
15238;Aušra;"1A klasė";59267104215;Ne;0;4;0;4
15239;Aušra;"1A klasė";1623803107;Ne;0;4;0;4
15240;Aušra;"1B klasė";1988459596;Ne;0;4;0;4
15241;Aušra;"1B klasė";4930807661;Ne;0;4;0;4
15242;Aušra;"1B klasė";86128256406;Ne;1;4;0;5
15243;Aušra;"1B klasė";50687988382;Ne;0;4;0;4
15244;Aušra;"1B klasė";1021183555;Ne;3;4;0;7
15245;Aušra;"1B klasė";41268510292;Ne;1;4;0;5
15246;Aušra;"1B klasė";8428069167;Ne;6;4;0;10
15247;Aušra;"1B klasė";3910688753;Ne;0;4;0;4
15248;Aušra;"1B klasė";4024898537;Ne;0;4;0;4
15249;Aušra;"1B klasė";1238171728;Ne;6;4;0;10
15250;Aušra;"1B klasė";4103951942;Ne;5;4;0;9
15251;Aušra;"1B klasė";46481555688;Ne;5;4;0;9
15252;Aušra;"1B klasė";1063755068;Ne;10;4;0;14
15253;Aušra;"1B klasė";70844824182;Ne;5;4;0;9
15254;Aušra;"1B klasė";17098859260;Ne;0;4;0;4
15255;Aušra;"1B klasė";9940683245;Ne;0;4;0;4
15256;Aušra;"1B klasė";2841526614;Ne;0;4;0;4
15257;Aušra;"1B klasė";8813044848;Ne;6;4;0;10
15258;Aušra;"1B klasė";58741201573;Ne;4;4;0;8
15259;Aušra;"1B klasė";2003368811;Ne;0;4;0;4
15260;Aušra;"1B klasė";65840410497;Ne;0;4;0;4
15261;Aušra;"1B klasė";1640356242;Ne;0;4;0;4
15262;Aušra;"1B klasė";90604001837;Ne;0;4;0;4
15263;Aušra;"1B klasė";7794899167;Ne;0;4;0;4
15264;Aušra;"2A klasė";5468993286;Ne;1;4;0;5
15265;Aušra;"2A klasė";1167565535;Ne;1;4;0;5
15266;Aušra;"2A klasė";75047415039;Ne;2;4;0;6
15267;Aušra;"2A klasė";85826303673;Ne;3;4;0;7
15268;Aušra;"2A klasė";1145863002;Ne;0;21;0;21
15269;Aušra;"2A klasė";77966124767;Ne;1;4;0;5
15270;Aušra;"2A klasė";1473962346;Ne;3;4;0;7
15271;Aušra;"2A klasė";1049364899;Ne;0;4;0;4
15272;Aušra;"2A klasė";1427235223;Ne;0;4;0;4
15273;Aušra;"2A klasė";97312326369;Ne;0;4;0;4
15274;Aušra;"2A klasė";2019480768;Ne;0;4;0;4
15275;Aušra;"2A klasė";48817619537;Ne;4;4;0;8
15276;Aušra;"2A klasė";55937499558;Ne;0;4;0;4
15277;Aušra;"2A klasė";35779814505;Ne;0;4;0;4
15278;Aušra;"2A klasė";76280361479;Ne;2;4;0;6
15279;Aušra;"2A klasė";2131349938;Ne;0;4;0;4
15280;Aušra;"2A klasė";36447115547;Ne;1;4;0;5
15281;Aušra;"2A klasė";1455625997;Ne;1;4;0;5
15282;Aušra;"2A klasė";1393006122;Ne;1;4;0;5
15283;Aušra;"2A klasė";7998332115;Ne;0;4;0;4
15284;Aušra;"2A klasė";14611425618;Ne;0;4;0;4
15285;Aušra;"2A klasė";31458685084;Ne;1;4;0;5
15286;Aušra;"2A klasė";9603569117;Ne;0;4;0;4
15287;Aušra;"2A klasė";1315930711;Ne;10;4;0;14
15288;Aušra;"2A klasė";42344686036;Ne;1;4;0;5
15289;Aušra;"2A klasė";2647629246;Ne;1;4;0;5
15290;Aušra;"2A klasė";95586246863;Ne;2;4;0;6
15291;Aušra;"2A klasė";4110537888;Ne;3;4;0;7
15292;Aušra;"3A klasė";8510995681;Ne;0;4;0;4
15293;Aušra;"3A klasė";9605206310;Ne;0;4;0;4
15294;Aušra;"3A klasė";3284383302;Ne;0;4;0;4
15295;Aušra;"3A klasė";13157844661;Ne;2;4;0;6
15296;Aušra;"3A klasė";14157070764;Ne;3;4;0;7
15297;Aušra;"3A klasė";99073448709;Ne;0;21;0;21
15298;Aušra;"3A klasė";68160889669;Ne;4;4;0;8
15299;Aušra;"3A klasė";1437126272;Ne;0;4;0;4
15300;Aušra;"3A klasė";15330844181;Ne;0;4;0;4
15301;Aušra;"3A klasė";39537089288;Ne;0;4;0;4
15302;Aušra;"3A klasė";2062775070;Ne;0;21;0;21
15303;Aušra;"3A klasė";3965445196;Ne;3;4;0;7
15304;Aušra;"3A klasė";85578471272;Ne;0;21;0;21
15305;Aušra;"3A klasė";88655846176;Ne;5;4;0;9
15306;Aušra;"3A klasė";73509864636;Ne;2;4;0;6
15307;Aušra;"3A klasė";27958163601;Ne;4;4;0;8
15308;Aušra;"3A klasė";40499781883;Ne;5;4;0;9
15309;Aušra;"3A klasė";68031503463;Ne;0;21;0;21
15310;Aušra;"3A klasė";81633973264;Ne;0;21;0;21
15311;Aušra;"3A klasė";70233681803;Ne;0;21;0;21
15312;Aušra;"3A klasė";1437385365;Ne;0;21;0;21
15313;Aušra;"3A klasė";51185323645;Ne;0;21;0;21
15314;Aušra;"3A klasė";52985512945;Ne;0;20;0;20
15315;Aušra;"3A klasė";97781409787;Ne;0;21;0;21
15316;Aušra;"3A klasė";474412140;Ne;0;4;0;4
15317;Aušra;"3A klasė";40714551025;Ne;0;4;0;4
15318;Aušra;"3A klasė";58699109274;Ne;0;4;0;4
15319;Aušra;"4A klasė";68481706412;Ne;0;21;0;21
15320;Aušra;"4A klasė";99886964420;Ne;0;21;0;21
15321;Aušra;"4A klasė";19920237804;Ne;0;4;0;4
15322;Aušra;"4A klasė";13361663464;Ne;7;4;0;11
15323;Aušra;"4A klasė";95948867937;Ne;0;21;0;21
15324;Aušra;"4A klasė";78030425432;Ne;0;4;0;4
15325;Aušra;"4A klasė";97596344387;Ne;0;21;0;21
15326;Aušra;"4A klasė";97596344387;Ne;0;21;0;21
15327;Aušra;"4A klasė";34795588283;Ne;0;21;0;21
15328;Aušra;"4A klasė";29636399665;Ne;0;21;0;21
15329;Aušra;"4A klasė";81428848455;Ne;0;21;0;21
15330;Aušra;"4A klasė";47725613978;Ne;0;21;0;21
15331;Aušra;"4A klasė";93365393803;Ne;0;21;0;21
15332;Aušra;"4A klasė";52864653926;Ne;1;4;0;5
15333;Aušra;"4A klasė";10272136932;Ne;8;4;0;12
15334;Aušra;"4A klasė";77425098448;Ne;0;21;0;21
15335;Aušra;"4A klasė";20550256232;Ne;0;21;0;21
15336;Aušra;"4A klasė";42015974556;Ne;0;4;0;4
15337;Aušra;"4A klasė";2113586354;Ne;0;4;0;4
15338;Aušra;"4A klasė";19718806057;Ne;0;21;0;21
15339;Aušra;"4A klasė";21856009403;Ne;0;21;0;21
15340;Aušra;"4A klasė";5166358753;Ne;0;4;0;4
15341;Aušra;Pabiručiai;9466807067;Ne;6;0;5;11
15342;Aušra;Pabiručiai;6508435821;Ne;0;2;0;2
15343;Aušra;Pabiručiai;7926621700;Ne;0;10;0;10
15344;Aušra;Pabiručiai;8665364744;Ne;21;0;0;21
15345;Aušra;Pabiručiai;6555345047;Ne;12;5;0;17
15346;Aušra;Pabiručiai;8769357172;Ne;3;2;0;5
15347;Aušra;Pabiručiai;1306616759;Ne;0;3;1;4
15348;Aušra;Pabiručiai;3275288747;Ne;5;0;0;5
15349;Aušra;Pabiručiai;5797692122;Ne;14;1;0;15
15350;Aušra;Pabiručiai;4646215025;Ne;9;0;2;11
15351;Aušra;Pabiručiai;7199483890;Ne;7;1;0;8
15352;Aušra;Pabiručiai;3008573040;Ne;0;2;3;5
15353;Aušra;Pabiručiai;7944904281;Ne;0;2;2;4
15354;Aušra;Pabiručiai;3336605264;Ne;0;0;2;2
15355;Aušra;Pabiručiai;3553620602;Ne;5;4;0;9
15356;Aušra;Pabiručiai;3759593393;Ne;0;5;4;9
15357;Aušra;Pabiručiai;2904303784;Ne;10;0;0;10
15358;Aušra;Pabiručiai;6056923592;Ne;19;0;0;19
15359;Aušra;Pabiručiai;3953653896;Ne;17;2;0;19
15360;Aušra;Pabiručiai;2273160688;Ne;16;0;0;16
15361;Aušra;Pabiručiai;8462418277;Ne;5;3;0;8
15362;Aušra;Gudručiai;2271582954;Ne;2;0;0;2
15363;Aušra;Gudručiai;4564561993;Ne;0;1;0;1
15364;Aušra;Gudručiai;8715912139;Ne;0;4;0;4
15365;Aušra;Gudručiai;7783006852;Ne;0;2;1;3
15366;Aušra;Gudručiai;9614562473;Ne;0;4;0;4
15367;Aušra;Gudručiai;6658178519;Ne;0;10;0;10
15368;Aušra;Gudručiai;7921251819;Ne;5;5;2;12
15369;Aušra;Gudručiai;9628651723;Ne;0;8;7;15
15370;Aušra;Gudručiai;3343235857;Ne;10;0;0;10
15371;Aušra;Gudručiai;1337138547;Ne;0;4;0;4
15372;Aušra;Gudručiai;1429548355;Ne;0;5;0;5
15373;Aušra;Gudručiai;1933801749;Ne;0;1;0;1
15374;Aušra;Gudručiai;5955385407;Ne;10;0;0;10
15375;Aušra;Gudručiai;2243689816;Ne;0;4;0;4
15376;Aušra;Gudručiai;1693711284;Ne;0;2;0;2
15377;Aušra;Gudručiai;6935310711;Ne;0;3;0;3
15378;Aušra;Gudručiai;3698868934;Ne;14;0;0;14
15379;Aušra;Gudručiai;9079804366;Ne;0;2;0;2
15380;Aušra;Gudručiai;3498143162;Ne;0;2;0;2
15381;Aušra;Gudručiai;5053808615;Ne;4;10;0;14
15382;Aušra;Naminukai;5993984086;Ne;4;0;0;4
15383;Aušra;Naminukai;8884580599;Ne;2;0;0;2
15384;Aušra;Naminukai;6614027605;Ne;11;1;0;12
15385;Aušra;Naminukai;2039920706;Ne;0;7;0;7
15386;Aušra;Naminukai;6965081051;Ne;0;9;0;9
15387;Aušra;Naminukai;2768220823;Ne;10;0;3;13
15388;Aušra;Naminukai;5925213006;Ne;12;0;0;12
15389;Aušra;Naminukai;1630814772;Ne;0;2;0;2
15390;Aušra;Naminukai;9333701196;Ne;4;3;0;7
15391;Aušra;Naminukai;4010347313;Ne;6;4;0;10
15392;Aušra;Naminukai;3860755808;Ne;13;0;0;13
15393;Aušra;Naminukai;4339450816;Ne;5;5;0;10
15394;Aušra;Naminukai;4000881716;Ne;7;4;1;12
15395;Aušra;Naminukai;8021547491;Ne;4;0;0;4
15396;Aušra;Naminukai;5268479689;Ne;10;0;0;10
15397;Aušra;Naminukai;3526010606;Ne;7;0;0;7
15398;Aušra;Naminukai;4163605313;Ne;10;1;0;11
15399;Aušra;Naminukai;3468946868;Ne;16;1;0;17
15400;Aušra;Naminukai;7710131755;Ne;5;1;6;12
15401;Aušra;Naminukai;8584355573;Ne;6;1;0;7
15402;Aušra;Naminukai;2495610772;Ne;0;6;0;6
15403;Aušra;Naminukai;8489362814;Ne;0;0;3;3
15404;Aušra;Naminukai;3675175233;Ne;7;3;0;10
15405;Aušra;" 1C klasė";1426802917;Ne;9;4;0;13
15406;Aušra;" 1C klasė";26010333641;Ne;1;4;0;5
15407;Aušra;" 1C klasė";3133031845;Ne;0;4;0;4
15408;Aušra;" 1C klasė";11130172902;Ne;2;4;0;6
15409;Aušra;" 1C klasė";43737170074;Ne;4;4;0;8
15410;Aušra;" 1C klasė";1370336984;Ne;0;4;0;4
15411;Aušra;" 1C klasė";6483078840;Ne;2;4;0;6
15412;Aušra;" 1C klasė";1684481833;Ne;5;4;0;9
15413;Aušra;" 1C klasė";1198248619;Ne;0;4;0;4
15414;Aušra;" 1C klasė";4765125810;Ne;1;4;0;5
15415;Aušra;" 1C klasė";5704281727;Ne;0;4;0;4
15416;Aušra;" 1C klasė";1479311429;Ne;0;4;0;4
15417;Aušra;" 1C klasė";1542575012;Ne;0;4;0;4
15418;Aušra;" 1C klasė";1291782232;Ne;2;4;0;6
15419;Aušra;" 1C klasė";90520726029;Ne;0;4;0;4
15420;Aušra;" 1C klasė";1844632980;Ne;0;4;0;4
15421;Aušra;" 1C klasė";94478599707;Ne;0;4;0;4
15422;Aušra;" 1C klasė";78489473446;Ne;0;4;0;4
15423;Aušra;" 1C klasė";29328876924;Ne;12;4;0;16
15424;Aušra;" 1C klasė";7649832094;Ne;0;4;0;4
15425;Aušra;" 1C klasė";8225188274;Ne;5;4;0;9
15426;Aušra;" 1C klasė";1371282149;Ne;0;4;0;4
15427;Aušra;" 1C klasė";57559227292;Ne;0;4;0;4
15428;Berželis;PČIOLKI;6113571093;Ne;0;4;2;6
15429;Berželis;PČIOLKI;9024992452;Ne;0;8;0;8
15430;Berželis;PČIOLKI;1521982237;Ne;0;4;3;7
15431;Berželis;PČIOLKI;3437712794;Ne;0;3;0;3
15432;Berželis;PČIOLKI;3298044639;Ne;0;3;0;3
15433;Berželis;PČIOLKI;2615440913;Ne;0;4;3;7
15434;Berželis;PČIOLKI;4013215941;Ne;0;4;0;4
15435;Berželis;PČIOLKI;3772780161;Ne;9;6;0;15
15436;Berželis;PČIOLKI;4563582416;Ne;0;9;0;9
15437;Berželis;PČIOLKI;1225018351;Ne;0;3;0;3
15438;Berželis;PČIOLKI;9894751274;Ne;0;2;2;4
15439;Berželis;PČIOLKI;7526006253;Ne;2;4;0;6
15440;Berželis;PČIOLKI;1036370516;Ne;10;3;0;13
15441;Berželis;PČIOLKI;9644196870;Ne;8;4;2;14
15442;Berželis;PČIOLKI;2214171136;Ne;0;2;0;2
15443;Berželis;PČIOLKI;6473498471;Ne;0;7;0;7
15444;Berželis;PČIOLKI;97218091736;Ne;0;6;0;6
15445;Berželis;PČIOLKI;5798989689;Ne;0;4;0;4
15446;Berželis;PČIOLKI;2007064959;Ne;2;4;4;10
15447;Berželis;PČIOLKI;5084171353;Ne;0;4;1;5
15448;Berželis;PČIOLKI;4521372127;Ne;0;5;0;5
15449;Berželis;PČIOLKI;1067618571;Ne;0;2;0;2
15450;Berželis;PČIOLKI;7287552286;Ne;0;4;0;4
15451;Berželis;"BOŽJI KOROVKI";3162044236;Ne;0;0;5;5
15452;Berželis;"BOŽJI KOROVKI";7421059780;Ne;11;0;0;11
15453;Berželis;"BOŽJI KOROVKI";5739847580;Ne;0;2;0;2
15454;Berželis;"BOŽJI KOROVKI";4100740863;Ne;0;12;0;12
15455;Berželis;"BOŽJI KOROVKI";5953387226;Ne;7;2;0;9
15456;Berželis;"BOŽJI KOROVKI";3070917065;Ne;0;3;0;3
15457;Berželis;"BOŽJI KOROVKI";8118040960;Ne;5;2;3;10
15458;Berželis;"BOŽJI KOROVKI";2005082089;Ne;0;1;0;1
15459;Berželis;"BOŽJI KOROVKI";9848723402;Ne;15;0;0;15
15460;Berželis;"BOŽJI KOROVKI";5551459997;Ne;0;5;0;5
15461;Berželis;"BOŽJI KOROVKI";6651007152;Ne;0;2;1;3
15462;Berželis;"BOŽJI KOROVKI";8451877584;Ne;8;0;0;8
15463;Berželis;"BOŽJI KOROVKI";7080168105;Ne;0;2;0;2
15464;Berželis;"BOŽJI KOROVKI";9438498834;Ne;0;1;0;1
15465;Berželis;"BOŽJI KOROVKI";1132252592;Ne;11;0;0;11
15466;Berželis;"BOŽJI KOROVKI";8871199713;Ne;5;0;2;7
15467;Berželis;"BOŽJI KOROVKI";1722262813;Ne;0;4;0;4
15468;Berželis;"BOŽJI KOROVKI";9466461910;Ne;5;4;0;9
15469;Berželis;SOLNYŠKO;1498165322;Ne;8;0;1;9
15470;Berželis;SOLNYŠKO;8737788279;Ne;0;5;1;6
15471;Berželis;SOLNYŠKO;2901168499;Ne;0;0;1;1
15472;Berželis;SOLNYŠKO;7411282628;Ne;17;4;0;21
15473;Berželis;SOLNYŠKO;8957312159;Ne;0;5;3;8
15474;Berželis;SOLNYŠKO;1167103292;Ne;11;0;0;11
15475;Berželis;SOLNYŠKO;5408368340;Ne;0;0;3;3
15476;Berželis;SOLNYŠKO;5464385395;Ne;9;2;0;11
15477;Berželis;SOLNYŠKO;1424868444;Ne;11;0;0;11
15478;Berželis;SOLNYŠKO;1146976812;Ne;0;3;0;3
15479;Berželis;SOLNYŠKO;6774460279;Ne;21;0;0;21
15480;Berželis;SOLNYŠKO;5866092980;Ne;6;0;1;7
15481;Berželis;SOLNYŠKO;9750863775;Ne;3;0;0;3
15482;Berželis;BABOČKI;4923631429;Ne;8;0;0;8
15483;Berželis;BABOČKI;2016194182;Ne;10;3;0;13
15484;Berželis;BABOČKI;2030770943;Ne;10;4;0;14
15485;Berželis;BABOČKI;2667957070;Ne;7;2;0;9
15486;Berželis;BABOČKI;7781031211;Ne;17;0;0;17
15487;Berželis;BABOČKI;5688897783;Ne;0;10;0;10
15488;Berželis;BABOČKI;6942559693;Ne;6;0;0;6
15489;Berželis;BABOČKI;9245706377;Ne;0;1;0;1
15490;Berželis;BABOČKI;6352635742;Ne;0;1;0;1
15491;Berželis;BABOČKI;3613459846;Ne;16;0;0;16
15492;Berželis;BABOČKI;8448872491;Ne;8;0;0;8
15493;Berželis;BABOČKI;5069322062;Ne;7;4;3;14
15494;Berželis;BABOČKI;2954451168;Ne;0;0;1;1
15495;Berželis;BABOČKI;9585609150;Ne;0;8;0;8
15496;Berželis;BABOČKI;9091691636;Ne;10;0;3;13
15497;Berželis;BABOČKI;7940591009;Ne;8;0;2;10
15498;Berželis;BABOČKI;4546285993;Ne;0;21;0;21
15499;Berželis;BABOČKI;6577232093;Ne;5;2;0;7
15500;Berželis;BABOČKI;6387242787;Ne;9;12;0;21
15501;Berželis;SOVUŠKI;5350402890;Ne;0;5;0;5
15502;Berželis;SOVUŠKI;8185887403;Ne;4;0;0;4
15503;Berželis;SOVUŠKI;8989621715;Ne;2;0;1;3
15504;Berželis;SOVUŠKI;1289333809;Ne;0;1;0;1
15505;Berželis;SOVUŠKI;8086074279;Ne;0;7;0;7
15506;Berželis;SOVUŠKI;9273819928;Ne;0;3;0;3
15507;Berželis;SOVUŠKI;1769470120;Ne;0;4;2;6
15508;Berželis;SOVUŠKI;3885474466;Ne;5;0;0;5
15509;Berželis;SOVUŠKI;6706273205;Ne;6;0;0;6
15510;Berželis;SOVUŠKI;2895332184;Ne;0;0;1;1
15511;Berželis;SOVUŠKI;1464998584;Ne;6;0;0;6
15512;Berželis;SOVUŠKI;2844736188;Ne;0;2;0;2
15513;Berželis;SOVUŠKI;3835273594;Ne;4;2;0;6
15514;Berželis;SOVUŠKI;2632535013;Ne;11;0;0;11
15515;Berželis;SOVUŠKI;6698849108;Ne;0;0;5;5
15516;Berželis;SOVUŠKI;1583268041;Ne;0;6;0;6
15517;Berželis;PODSOLNUŠKI;1044720859;Ne;0;0;3;3
15518;Berželis;PODSOLNUŠKI;3157906472;Ne;11;0;0;11
15519;Berželis;PODSOLNUŠKI;9945124824;Ne;10;0;0;10
15520;Berželis;PODSOLNUŠKI;5925726854;Ne;11;0;0;11
15521;Berželis;PODSOLNUŠKI;8168498937;Ne;11;0;0;11
15522;Berželis;PODSOLNUŠKI;8633724383;Ne;17;0;0;17
15523;Berželis;PODSOLNUŠKI;3033042487;Ne;7;0;1;8
15524;Berželis;PODSOLNUŠKI;2136455625;Ne;6;0;2;8
15525;Berželis;PODSOLNUŠKI;1964320071;Ne;0;6;1;7
15526;Berželis;PODSOLNUŠKI;2615832804;Ne;1;8;0;9
15527;Berželis;PODSOLNUŠKI;9133988149;Ne;1;4;1;6
15528;Berželis;PODSOLNUŠKI;5795151632;Ne;5;0;1;6
15529;Berželis;PODSOLNUŠKI;6686248053;Ne;7;1;0;8
15530;Berželis;PODSOLNUŠKI;1081582842;Ne;2;5;0;7
15531;Berželis;PODSOLNUŠKI;5963915092;Ne;2;0;0;2
15532;Berželis;PODSOLNUŠKI;3378237475;Ne;2;0;0;2
15533;Berželis;LAPIUKAI;3813964138;Ne;0;0;1;1
15534;Berželis;LAPIUKAI;2144796691;Ne;16;0;0;16
15535;Berželis;LAPIUKAI;1834920753;Taip;0;0;6;6
15536;Berželis;LAPIUKAI;6384939601;Ne;2;0;0;2
15537;Berželis;LAPIUKAI;2794074071;Ne;0;0;2;2
15538;Berželis;LAPIUKAI;9681310544;Ne;0;10;0;10
15539;Berželis;LAPIUKAI;9543499205;Ne;0;1;0;1
15540;Berželis;LAPIUKAI;9749516260;Ne;5;1;0;6
15541;Berželis;LAPIUKAI;2947072348;Ne;0;2;0;2
15542;Berželis;LAPIUKAI;8994102218;Ne;0;11;0;11
15543;Berželis;LAPIUKAI;4854931959;Ne;5;0;2;7
15544;Berželis;MEŠKIUKAI;7902774064;Taip;10;0;3;13
15545;Berželis;MEŠKIUKAI;2062794406;Ne;0;0;3;3
15546;Berželis;MEŠKIUKAI;9459031158;Ne;9;0;1;10
15547;Berželis;MEŠKIUKAI;9178527605;Ne;0;0;3;3
15548;Berželis;MEŠKIUKAI;1235617054;Ne;7;3;0;10
15549;Berželis;MEŠKIUKAI;1178588907;Ne;2;0;1;3
15550;Berželis;MEŠKIUKAI;5100214127;Ne;0;5;1;6
15551;Berželis;MEŠKIUKAI;3535856504;Ne;0;1;0;1
15552;Berželis;MEŠKIUKAI;6186408090;Ne;7;0;1;8
15553;Berželis;MEŠKIUKAI;1673524685;Ne;7;0;1;8
15554;Berželis;MEŠKIUKAI;3936106342;Taip;5;0;0;5
15555;Berželis;MEŠKIUKAI;6689893827;Ne;5;0;1;6
15556;Berželis;MEŠKIUKAI;8251510865;Ne;0;4;5;9
15557;Berželis;MEŠKIUKAI;7535016799;Ne;13;0;0;13
15558;Berželis;ŽIEDELIAI;3786609012;Ne;0;2;0;2
15559;Berželis;ŽIEDELIAI;9805181733;Ne;0;0;7;7
15560;Berželis;ŽIEDELIAI;1165300871;Ne;3;0;0;3
15561;Berželis;ŽIEDELIAI;2016827207;Ne;6;0;0;6
15562;Berželis;ŽIEDELIAI;9979442772;Ne;0;0;7;7
15563;Berželis;ŽIEDELIAI;9881246268;Ne;0;1;0;1
15564;Berželis;ŽIEDELIAI;7042967329;Ne;6;0;2;8
15565;Berželis;ŽIEDELIAI;9925865228;Ne;0;0;6;6
15566;Berželis;ŽIEDELIAI;1402975280;Ne;0;3;0;3
15567;Berželis;ŽIEDELIAI;1535940949;Ne;0;17;0;17
15568;Berželis;ŽIEDELIAI;2030492491;Ne;0;0;1;1
15569;Berželis;ŽIEDELIAI;3351114197;Ne;0;0;2;2
15570;Berželis;ŽIEDELIAI;5248880873;Ne;11;0;2;13
15571;Berželis;ŽIEDELIAI;2262911854;Ne;1;0;0;1
15572;Berželis;ŽIEDELIAI;2508532190;Ne;2;0;0;2
15573;Berželis;ŽIEDELIAI;5649793735;Ne;3;0;0;3
15574;Berželis;NYKŠTUKAI;8148104183;Ne;0;4;7;11
15575;Berželis;NYKŠTUKAI;7935684899;Ne;0;0;10;10
15576;Berželis;NYKŠTUKAI;1403664386;Ne;4;1;0;5
15577;Berželis;NYKŠTUKAI;9666648116;Ne;0;0;4;4
15578;Berželis;NYKŠTUKAI;3559065542;Ne;0;4;12;16
15579;Berželis;NYKŠTUKAI;3556594755;Ne;0;0;2;2
15580;Berželis;NYKŠTUKAI;2933069798;Ne;0;0;1;1
15581;Berželis;NYKŠTUKAI;8430372047;Ne;0;4;4;8
15582;Berželis;NYKŠTUKAI;5099275362;Ne;1;0;0;1
15583;Berželis;NYKŠTUKAI;2425621326;Ne;9;0;2;11
15584;Berželis;NYKŠTUKAI;7676141462;Ne;0;7;0;7
15585;Berželis;NYKŠTUKAI;3852021563;Ne;2;0;1;3
15586;Berželis;NYKŠTUKAI;3379227410;Ne;11;0;0;11
15587;Berželis;NYKŠTUKAI;4032178538;Ne;0;0;1;1
15588;Berželis;NYKŠTUKAI;5839964720;Ne;5;0;2;7
15589;Berželis;UOGELĖS;8735934456;Ne;5;0;0;5
15590;Berželis;UOGELĖS;5304917030;Ne;0;0;1;1
15591;Berželis;UOGELĖS;8907020701;Ne;0;4;0;4
15592;Berželis;UOGELĖS;6136155301;Ne;15;0;2;17
15593;Berželis;UOGELĖS;9034464618;Ne;11;0;0;11
15594;Berželis;UOGELĖS;5851732944;Ne;10;0;0;10
15595;Berželis;UOGELĖS;2321608974;Ne;0;4;3;7
15596;Berželis;UOGELĖS;3229996417;Ne;10;0;2;12
15597;Berželis;UOGELĖS;6773760208;Ne;13;0;0;13
15598;Berželis;UOGELĖS;7750905743;Ne;5;0;3;8
15599;Berželis;UOGELĖS;4607486516;Ne;5;0;5;10
15600;Berželis;UOGELĖS;8814953641;Ne;14;0;0;14
15601;Berželis;UOGELĖS;5197350105;Ne;12;2;0;14
15602;Berželis;KODĖLČIUKAI;5134372871;Ne;0;5;1;6
15603;Berželis;KODĖLČIUKAI;7852089381;Ne;0;0;7;7
15604;Berželis;KODĖLČIUKAI;5751995154;Ne;0;0;1;1
15605;Berželis;KODĖLČIUKAI;3589890886;Ne;0;4;2;6
15606;Berželis;KODĖLČIUKAI;7986744784;Ne;0;4;0;4
15607;Berželis;KODĖLČIUKAI;1127524998;Ne;0;0;3;3
15608;Berželis;KODĖLČIUKAI;2193392844;Ne;6;0;4;10
15609;Berželis;KODĖLČIUKAI;9696962207;Ne;12;0;0;12
15610;Berželis;KODĖLČIUKAI;8286301258;Ne;3;5;0;8
15611;Berželis;KODĖLČIUKAI;8875116641;Ne;10;0;5;15
15612;Berželis;KODĖLČIUKAI;6500588668;Ne;5;0;0;5
15613;Berželis;KODĖLČIUKAI;3327751482;Ne;7;0;8;15
15614;Berželis;KODĖLČIUKAI;9418230816;Ne;0;9;3;12
15615;Berželis;KODĖLČIUKAI;4254592648;Ne;10;0;3;13
15616;Saulutė;Drugeliai;5987478379;Ne;2;2;0;4
15617;Saulutė;Drugeliai;5943795519;Ne;3;1;1;5
15618;Saulutė;Drugeliai;4453610732;Ne;0;0;3;3
15619;Saulutė;Drugeliai;4067009709;Ne;0;1;0;1
15620;Saulutė;Drugeliai;3991128892;Ne;13;0;0;13
15621;Saulutė;Drugeliai;4781756849;Ne;0;21;0;21
15622;Saulutė;Drugeliai;4288298305;Ne;6;1;0;7
15623;Saulutė;Drugeliai;9133269796;Ne;5;1;0;6
15624;Saulutė;Drugeliai;6057938367;Ne;12;0;0;12
15625;Saulutė;Drugeliai;1585403702;Ne;3;0;3;6
15626;Saulutė;Drugeliai;8003855875;Ne;0;5;0;5
15627;Saulutė;Drugeliai;2301903550;Ne;6;5;0;11
15628;Saulutė;Drugeliai;3265401334;Ne;7;0;0;7
15629;Saulutė;Drugeliai;2337702344;Ne;0;8;0;8
15630;Saulutė;Drugeliai;3662919521;Ne;5;1;2;8
15631;Saulutė;Drugeliai;6455593653;Ne;0;2;0;2
15632;Saulutė;Drugeliai;9410517602;Ne;1;0;0;1
15633;Saulutė;Drugeliai;1088813143;Ne;5;0;1;6
15634;Saulutė;Drugeliai;8409958782;Ne;5;1;1;7
15635;Saulutė;Drugeliai;6304028361;Ne;3;1;0;4
15636;Saulutė;"Saulės zuikučiai";8946107286;Ne;4;2;0;6
15637;Saulutė;"Saulės zuikučiai";2397257894;Ne;0;4;0;4
15638;Saulutė;"Saulės zuikučiai";5148542811;Ne;23;0;0;23
15639;Saulutė;"Saulės zuikučiai";2259917151;Ne;14;0;0;14
15640;Saulutė;"Saulės zuikučiai";3749374270;Ne;0;4;0;4
15641;Saulutė;"Saulės zuikučiai";8242602551;Ne;0;3;0;3
15642;Saulutė;"Saulės zuikučiai";5247769309;Ne;1;5;0;6
15643;Saulutė;"Saulės zuikučiai";2781003892;Ne;0;4;0;4
15644;Saulutė;"Saulės zuikučiai";7888435573;Ne;0;7;0;7
15645;Saulutė;"Saulės zuikučiai";3089541630;Ne;0;1;0;1
15646;Saulutė;"Saulės zuikučiai";1562393383;Ne;5;0;3;8
15647;Saulutė;"Saulės zuikučiai";3272296969;Ne;0;0;6;6
15648;Saulutė;"Saulės zuikučiai";6924891265;Ne;8;0;0;8
15649;Saulutė;"Saulės zuikučiai";4663795223;Ne;26;0;0;26
15650;Saulutė;"Saulės zuikučiai";5931269521;Ne;0;9;0;9
15651;Saulutė;"Saulės zuikučiai";7839168221;Ne;5;0;2;7
15652;Saulutė;"Saulės zuikučiai";4945943570;Ne;0;0;2;2
15653;Saulutė;"Saulės zuikučiai";3730442890;Ne;8;5;0;13
15654;Saulutė;"Saulės zuikučiai";3620722907;Ne;4;4;0;8
15655;Saulutė;Boružėlės;3295289082;Ne;0;0;1;1
15656;Saulutė;Boružėlės;8390767549;Ne;0;4;1;5
15657;Saulutė;Boružėlės;7576532632;Ne;0;0;1;1
15658;Saulutė;Boružėlės;2725491887;Ne;9;0;1;10
15659;Saulutė;Boružėlės;9314889468;Ne;0;4;0;4
15660;Saulutė;Boružėlės;7764493159;Ne;0;4;2;6
15661;Saulutė;Boružėlės;5565832676;Ne;0;4;2;6
15662;Saulutė;Boružėlės;7081700501;Ne;1;1;0;2
15663;Saulutė;Boružėlės;7474989619;Ne;0;5;0;5
15664;Saulutė;Boružėlės;8619163154;Ne;6;0;2;8
15665;Saulutė;Boružėlės;7574225926;Ne;0;1;2;3
15666;Saulutė;Boružėlės;1803710557;Ne;0;0;5;5
15667;Saulutė;Boružėlės;9173336078;Ne;5;0;1;6
15668;Saulutė;Boružėlės;9098663596;Ne;8;0;0;8
15669;Saulutė;Boružėlės;7425789805;Ne;0;4;4;8
15670;Saulutė;Boružėlės;2527027536;Ne;0;4;4;8
15671;Saulutė;Boružėlės;2988010963;Ne;0;4;0;4
15672;Saulutė;Boružėlės;3852862834;Ne;0;0;1;1
15673;Saulutė;Boružėlės;1275552038;Ne;0;0;4;4
15674;Saulutė;Nykštukai;2601822200;Ne;0;7;0;7
15675;Saulutė;Nykštukai;3244850673;Ne;0;4;0;4
15676;Saulutė;Nykštukai;9497439410;Ne;0;3;0;3
15677;Saulutė;Nykštukai;5607937410;Ne;8;2;0;10
15678;Saulutė;Nykštukai;3571751974;Ne;0;5;0;5
15679;Saulutė;Nykštukai;3221612665;Ne;4;0;0;4
15680;Saulutė;Nykštukai;2140277182;Ne;12;3;0;15
15681;Saulutė;Nykštukai;4510990261;Ne;0;6;2;8
15682;Saulutė;Nykštukai;4800144085;Ne;0;15;0;15
15683;Saulutė;Nykštukai;8257363228;Ne;10;0;0;10
15684;Saulutė;Nykštukai;9664809396;Taip;6;0;0;6
15685;Saulutė;Nykštukai;8984040932;Ne;18;0;0;18
15686;Saulutė;Nykštukai;3463428772;Ne;6;4;0;10
15687;Saulutė;Nykštukai;4390098560;Ne;9;2;0;11
15688;Saulutė;Nykštukai;3363212754;Ne;0;3;0;3
15689;Saulutė;Nykštukai;5442075474;Ne;15;0;0;15
15690;Saulutė;Nykštukai;8722717930;Ne;0;0;21;21
15691;Saulutė;Nykštukai;9930330487;Ne;6;1;1;8
15692;Saulutė;Nykštukai;7158455528;Ne;8;1;0;9
15693;Saulutė;Nykštukai;2669711574;Ne;6;2;1;9
15694;Saulutė;Nykštukai;6982979199;Ne;0;0;4;4
15695;Saulutė;Meškiukai;8952893819;Ne;0;15;0;15
15696;Saulutė;Meškiukai;4222649372;Ne;10;0;2;12
15697;Saulutė;Meškiukai;1229624643;Ne;6;1;0;7
15698;Saulutė;Meškiukai;9572394489;Ne;0;0;20;20
15699;Saulutė;Meškiukai;9567511354;Ne;3;0;4;7
15700;Saulutė;Meškiukai;6579874077;Ne;0;12;0;12
15701;Saulutė;Meškiukai;6178908581;Ne;0;0;5;5
15702;Saulutė;Meškiukai;8472510151;Ne;2;9;2;13
15703;Saulutė;Meškiukai;6955061957;Ne;10;4;0;14
15704;Saulutė;Meškiukai;7478215328;Ne;8;1;0;9
15705;Saulutė;Meškiukai;9727366891;Ne;0;0;10;10
15706;Saulutė;Meškiukai;5219429911;Ne;0;3;0;3
15707;Saulutė;Meškiukai;3125186472;Ne;0;0;6;6
15708;Saulutė;Meškiukai;8919457259;Ne;0;0;3;3
15709;Saulutė;Meškiukai;5509365461;Ne;0;4;0;4
15710;Saulutė;Meškiukai;8787977881;Ne;0;0;3;3
15711;Saulutė;Meškiukai;8147755754;Ne;11;0;0;11
15712;Saulutė;Ežiukai;2813274509;Ne;0;0;10;10
15713;Saulutė;Ežiukai;2315812734;Ne;12;0;0;12
15714;Saulutė;Ežiukai;2059342403;Ne;5;0;0;5
15715;Saulutė;Ežiukai;8736917541;Ne;0;0;3;3
15716;Saulutė;Ežiukai;5999318972;Ne;0;0;3;3
15717;Saulutė;Ežiukai;4363210987;Ne;0;4;2;6
15718;Saulutė;Ežiukai;5972503001;Ne;11;0;0;11
15719;Saulutė;Ežiukai;6884472677;Ne;0;0;4;4
15720;Saulutė;Ežiukai;6219942114;Ne;5;0;0;5
15721;Saulutė;Ežiukai;4194586403;Ne;6;0;0;6
15722;Saulutė;Ežiukai;1853984777;Ne;0;0;4;4
15723;Saulutė;Ežiukai;1666301750;Ne;9;4;2;15
15724;Saulutė;Ežiukai;3133714991;Ne;0;0;2;2
15725;Saulutė;Ežiukai;4039065925;Ne;0;0;3;3
15726;Saulutė;Ežiukai;7967532537;Ne;0;0;1;1
15727;Saulutė;Ežiukai;5335820652;Ne;9;0;1;10
15728;Saulutė;Ežiukai;2728669975;Ne;1;4;0;5
15729;Saulutė;Ežiukai;9398356470;Ne;0;0;11;11
15730;Saulutė;Ežiukai;6126870829;Ne;0;4;1;5
15731;Saulutė;Ežiukai;3565818383;Ne;7;0;1;8
15732;Saulutė;Bitutės;5200638523;Ne;0;5;0;5
15733;Saulutė;Bitutės;5448950324;Ne;9;0;0;9
15734;Saulutė;Bitutės;3948540247;Ne;7;0;0;7
15735;Saulutė;Bitutės;4130972647;Ne;0;3;4;7
15736;Saulutė;Bitutės;3242810449;Ne;0;12;0;12
15737;Saulutė;Bitutės;7032417938;Taip;0;12;0;12
15738;Saulutė;Bitutės;5897526863;Ne;6;0;2;8
15739;Saulutė;Bitutės;9110162513;Ne;0;6;0;6
15740;Saulutė;Bitutės;1648978545;Ne;15;1;0;16
15741;Saulutė;Bitutės;6927834443;Ne;0;15;0;15
15742;Saulutė;Bitutės;8714520840;Ne;0;14;4;18
15743;Saulutė;Bitutės;9726675673;Ne;0;14;0;14
15744;Saulutė;Bitutės;8520474896;Ne;0;14;0;14
15745;Saulutė;Bitutės;6189637986;Ne;0;4;1;5
15746;Saulutė;Bitutės;7132125341;Ne;0;0;1;1
15747;Saulutė;Bitutės;3215349379;Ne;18;0;2;20
15748;Saulutė;Bitutės;3259790911;Ne;5;0;1;6
15749;Saulutė;Bitutės;7311594119;Ne;2;0;11;13
15750;Saulutė;Pelėdžiukai;8512137633;Ne;14;1;0;15
15751;Saulutė;Pelėdžiukai;7139492238;Ne;5;0;0;5
15752;Saulutė;Pelėdžiukai;4211866191;Ne;7;0;0;7
15753;Saulutė;Pelėdžiukai;2373409300;Ne;5;0;1;6
15754;Saulutė;Pelėdžiukai;8405262902;Ne;15;0;0;15
15755;Saulutė;Pelėdžiukai;1745754752;Ne;0;2;1;3
15756;Saulutė;Pelėdžiukai;4123500930;Ne;6;0;0;6
15757;Saulutė;Pelėdžiukai;1056158093;Ne;7;0;0;7
15758;Saulutė;Pelėdžiukai;8371366346;Ne;0;4;0;4
15759;Saulutė;Pelėdžiukai;6842585310;Ne;7;2;2;11
15760;Saulutė;Pelėdžiukai;1776164273;Ne;0;2;3;5
15761;Saulutė;Pelėdžiukai;5850783789;Ne;0;8;0;8
15762;Saulutė;Pelėdžiukai;6608003946;Ne;2;17;1;20
15763;Saulutė;Pelėdžiukai;7243072252;Ne;8;2;0;10
15764;Saulutė;Pelėdžiukai;9903380188;Ne;5;0;0;5
15765;Saulutė;Pelėdžiukai;7620841597;Ne;11;0;0;11
15766;Saulutė;Pelėdžiukai;7640441297;Ne;12;0;0;12
15767;Saulutė;Pelėdžiukai;6046611248;Ne;0;8;0;8
15768;Saulutė;Pelėdžiukai;4301516165;Ne;15;0;8;23
15769;Saulutė;Pelėdžiukai;7258180835;Ne;12;2;0;14
15770;Saulutė;Pelėdžiukai;2566263680;Ne;8;0;11;19
15771;Saulutė;Pelėdžiukai;9106119465;Ne;5;0;0;5
15772;Saulutė;Zylutės;3228226715;Ne;0;7;1;8
15773;Saulutė;Zylutės;8040751073;Ne;6;0;0;6
15774;Saulutė;Zylutės;2074473832;Ne;0;0;2;2
15775;Saulutė;Zylutės;8041118115;Ne;0;21;0;21
15776;Saulutė;Zylutės;5198558993;Ne;21;0;0;21
15777;Saulutė;Zylutės;6109527712;Ne;0;2;0;2
15778;Saulutė;Zylutės;7446423510;Ne;0;0;2;2
15779;Saulutė;Zylutės;8717210130;Ne;7;2;0;9
15780;Saulutė;Zylutės;5264813819;Ne;3;0;7;10
15781;Saulutė;Zylutės;2885398200;Ne;0;2;0;2
15782;Saulutė;Zylutės;7844396402;Ne;0;5;0;5
15783;Saulutė;Zylutės;7351477901;Ne;3;4;0;7
15784;Saulutė;Zylutės;1324799653;Ne;6;5;0;11
15785;Saulutė;Zylutės;3691381351;Ne;2;5;0;7
15786;Saulutė;Zylutės;2010774109;Ne;0;4;0;4
15787;Saulutė;Zylutės;1546200973;Ne;11;0;0;11
15788;Saulutė;Zylutės;8379304869;Ne;0;5;0;5
15789;Saulutė;Zylutės;66108847230;Ne;0;8;0;8
15790;Saulutė;Zylutės;95439358242;Ne;0;2;0;2
15791;Saulutė;Zylutės;9947607411;Ne;6;5;0;11
15792;Saulutė;Zylutės;3408369823;Ne;0;4;3;7
15793;Saulutė;"1 klasė";1717909005;Ne;3;4;0;7
15794;Saulutė;"1 klasė";87814849917;Ne;7;4;0;11
15795;Saulutė;"1 klasė";84919478493;Ne;0;4;0;4
15796;Saulutė;"1 klasė";1320018338;Ne;2;4;0;6
15797;Saulutė;"1 klasė";8599199376;Ne;0;4;0;4
15798;Saulutė;"1 klasė";8944601874;Ne;7;4;0;11
15799;Saulutė;"1 klasė";3064199909;Ne;3;4;0;7
15800;Saulutė;"1 klasė";1556270046;Ne;1;4;0;5
15801;Saulutė;"1 klasė";4272320685;Ne;1;4;0;5
15802;Saulutė;"1 klasė";1291318940;Ne;2;4;0;6
15803;Saulutė;"1 klasė";1391904744;Ne;0;4;0;4
15804;Saulutė;"1 klasė";6096297366;Ne;4;4;0;8
15805;Saulutė;"1 klasė";1609952589;Ne;0;4;0;4
15806;Saulutė;"1 klasė";1513449225;Ne;5;4;0;9
15807;Saulutė;"1 klasė";7281873166;Ne;5;4;0;9
15808;Saulutė;"1 klasė";1911318708;Ne;5;4;0;9
15809;Saulutė;"1 klasė";28772515317;Ne;0;4;0;4
15810;Saulutė;"1 klasė";1786491396;Ne;1;4;0;5
15811;Saulutė;"1 klasė";1332002470;Ne;8;4;0;12
15812;Saulutė;"1 klasė";16622528829;Ne;2;4;0;6
15813;Saulutė;"1 klasė";61073095949;Ne;0;4;0;4
15814;Saulutė;"1 klasė";3505492809;Ne;0;4;0;4
15815;Saulutė;"1 klasė";8952155496;Ne;0;4;0;4
15816;Saulutė;"1 klasė";9235972927;Ne;6;4;0;10
15817;Saulutė;"1 klasė";2677995903;Ne;0;4;0;4
15818;Saulutė;"1 klasė";1386800520;Ne;5;4;0;9
15819;Saulutė;"1 klasė";89920419797;Ne;2;4;0;6
15820;Saulutė;"1 klasė";1910653135;Ne;0;3;0;3
15821;Saulutė;"2 klasė";45306237230;Ne;2;4;0;6
15822;Saulutė;"2 klasė";79438946697;Ne;2;4;0;6
15823;Saulutė;"2 klasė";79919438191;Ne;3;4;0;7
15824;Saulutė;"2 klasė";29074930927;Ne;4;4;0;8
15825;Saulutė;"2 klasė";8369703027;Ne;0;4;0;4
15826;Saulutė;"2 klasė";21605684303;Ne;5;4;0;9
15827;Saulutė;"2 klasė";31705050946;Ne;5;4;0;9
15828;Saulutė;"2 klasė";2622662153;Ne;2;4;0;6
15829;Saulutė;"2 klasė";9612975694;Ne;15;4;0;19
15830;Saulutė;"2 klasė";37315117916;Ne;4;4;0;8
15831;Saulutė;"2 klasė";3445723020;Ne;10;4;0;14
15832;Saulutė;"2 klasė";14195215027;Ne;9;4;0;13
15833;Saulutė;"2 klasė";2098990667;Ne;3;4;0;7
15834;Saulutė;"2 klasė";27386434894;Ne;0;4;0;4
15835;Saulutė;"2 klasė";77923802656;Ne;6;4;0;10
15836;Saulutė;"2 klasė";46280382280;Ne;0;4;0;4
15837;Saulutė;"2 klasė";1935503629;Ne;3;4;0;7
15838;Saulutė;"2 klasė";75405796772;Ne;1;4;0;5
15839;Saulutė;"2 klasė";1277263391;Ne;1;4;0;5
15840;Saulutė;"2 klasė";97145959022;Ne;12;4;0;16
15841;Saulutė;"2 klasė";64418469679;Ne;0;4;0;4
15842;Saulutė;"2 klasė";77170708225;Ne;0;4;0;4
15843;Saulutė;"2 klasė";4640909915;Ne;0;4;0;4
15844;Saulutė;"2 klasė";65492344097;Ne;1;4;0;5
15845;Saulutė;"2 klasė";1704733670;Ne;0;4;0;4
15846;Saulutė;"2 klasė";1534183935;Ne;2;4;0;6
15847;Saulutė;"2 klasė";5574049005;Ne;6;4;0;10
15848;Saulutė;"2 klasė";1510434265;Ne;5;4;0;9
15849;Saulutė;"3 klasė";1005459768;Ne;3;4;0;7
15850;Saulutė;"3 klasė";1804521229;Ne;1;4;0;5
15851;Saulutė;"3 klasė";76108591835;Ne;3;4;0;7
15852;Saulutė;"3 klasė";1475031090;Ne;0;4;0;4
15853;Saulutė;"3 klasė";3156830821;Ne;0;4;0;4
15854;Saulutė;"3 klasė";5741276602;Ne;0;4;0;4
15855;Saulutė;"3 klasė";3246485288;Ne;1;4;0;5
15856;Saulutė;"3 klasė";44452051978;Ne;5;4;0;9
15857;Saulutė;"3 klasė";78967475616;Ne;0;4;0;4
15858;Saulutė;"3 klasė";89710141573;Ne;0;4;0;4
15859;Saulutė;"3 klasė";25124975646;Ne;2;4;0;6
15860;Saulutė;"3 klasė";3450668814;Ne;6;4;0;10
15861;Saulutė;"3 klasė";8168961080;Ne;2;4;0;6
15862;Saulutė;"3 klasė";57283533169;Ne;0;4;0;4
15863;Saulutė;"3 klasė";76744652185;Ne;5;4;0;9
15864;Saulutė;"3 klasė";97296161595;Ne;4;4;0;8
15865;Saulutė;"3 klasė";87409240076;Ne;0;4;0;4
15866;Saulutė;"3 klasė";1205642335;Ne;2;4;0;6
15867;Saulutė;"3 klasė";2426509692;Ne;0;4;0;4
15868;Saulutė;"3 klasė";36414547943;Ne;0;4;0;4
15869;Saulutė;"3 klasė";99841176399;Ne;6;4;0;10
15870;Saulutė;"3 klasė";21703177024;Ne;1;4;0;5
15871;Saulutė;"3 klasė";1337654926;Ne;0;4;0;4
15872;Saulutė;"3 klasė";54950572289;Ne;2;4;0;6
15873;Saulutė;"3 klasė";13147367113;Ne;2;4;0;6
15874;Saulutė;"3 klasė";2216383015;Ne;4;4;0;8
15875;Saulutė;"3 klasė";1644704074;Ne;0;4;0;4
15876;Saulutė;"3 klasė";96497471950;Ne;9;4;0;13
15877;Saulutė;"3 klasė";6557918941;Ne;0;4;0;4
15878;Saulutė;"3 klasė";2787531476;Ne;7;4;0;11
15879;Saulutė;"4 klasė";5822529731;Ne;1;4;0;5
15880;Saulutė;"4 klasė";67739063665;Ne;0;4;0;4
15881;Saulutė;"4 klasė";13916981850;Ne;0;4;0;4
15882;Saulutė;"4 klasė";39606108938;Ne;0;4;0;4
15883;Saulutė;"4 klasė";81191097069;Ne;0;4;0;4
15884;Saulutė;"4 klasė";92198716772;Ne;3;4;0;7
15885;Saulutė;"4 klasė";16523279366;Ne;0;4;0;4
15886;Saulutė;"4 klasė";2262536579;Ne;1;4;0;5
15887;Saulutė;"4 klasė";2095347468;Ne;28;4;0;32
15888;Saulutė;"4 klasė";2819521168;Ne;0;4;0;4
15889;Saulutė;"4 klasė";37839378248;Ne;0;4;0;4
15890;Saulutė;"4 klasė";8308288099;Ne;7;4;0;11
15891;Saulutė;"4 klasė";30863736694;Ne;0;4;0;4
15892;Saulutė;"4 klasė";12964000357;Ne;2;4;0;6
15893;Saulutė;"4 klasė";54726632101;Ne;5;4;0;9
15894;Saulutė;"4 klasė";25720655179;Ne;0;4;0;4
15895;Saulutė;"4 klasė";45877127245;Ne;2;4;0;6
15896;Saulutė;"4 klasė";82106514982;Ne;0;4;0;4
15897;Saulutė;"4 klasė";61113930769;Ne;0;4;0;4
15898;Saulutė;"4 klasė";5213320470;Ne;3;4;0;7
15899;Saulutė;"4 klasė";90078805222;Ne;1;4;0;5
15900;Saulutė;"4 klasė";50110262859;Ne;2;4;0;6
15901;Saulutė;"4 klasė";42204884890;Ne;1;4;0;5
15902;Svaja;SAULĖGRĄŽA;4189290919;Ne;0;21;0;21
15903;Svaja;SAULĖGRĄŽA;4333001830;Ne;10;0;3;13
15904;Svaja;SAULĖGRĄŽA;1579441289;Ne;13;0;0;13
15905;Svaja;SAULĖGRĄŽA;9811110367;Ne;13;0;0;13
15906;Svaja;SAULĖGRĄŽA;3912426942;Ne;15;0;0;15
15907;Svaja;SAULĖGRĄŽA;9680766688;Ne;4;4;1;9
15908;Svaja;SAULĖGRĄŽA;3809817617;Ne;10;4;0;14
15909;Svaja;SAULĖGRĄŽA;3792660330;Ne;7;5;0;12
15910;Svaja;SAULĖGRĄŽA;3563842321;Ne;6;6;0;12
15911;Svaja;SAULĖGRĄŽA;4253831334;Ne;7;0;2;9
15912;Svaja;SAULĖGRĄŽA;3461282516;Ne;9;0;0;9
15913;Svaja;SAULĖGRĄŽA;9240037050;Ne;0;4;0;4
15914;Svaja;SAULĖGRĄŽA;7089640807;Ne;18;6;0;24
15915;Svaja;SAULĖGRĄŽA;6963684639;Ne;0;4;0;4
15916;Svaja;SAULĖGRĄŽA;4510147045;Ne;4;6;0;10
15917;Svaja;SAULĖGRĄŽA;6928763381;Ne;19;0;0;19
15918;Svaja;SAULĖGRĄŽA;3501620040;Ne;5;4;0;9
15919;Svaja;SAULĖGRĄŽA;7575922215;Ne;0;0;2;2
15920;Svaja;SAULĖGRĄŽA;7408966637;Ne;15;0;0;15
15921;Svaja;SAULĖGRĄŽA;7747251736;Ne;0;5;0;5
15922;Svaja;"STEBUKLINGAS ŽIBINTAS";9814969596;Ne;0;5;0;5
15923;Svaja;"STEBUKLINGAS ŽIBINTAS";2200408537;Ne;4;0;1;5
15924;Svaja;"STEBUKLINGAS ŽIBINTAS";3940123543;Ne;0;4;2;6
15925;Svaja;"STEBUKLINGAS ŽIBINTAS";8353427144;Ne;0;0;2;2
15926;Svaja;"STEBUKLINGAS ŽIBINTAS";9843726794;Ne;0;4;1;5
15927;Svaja;"STEBUKLINGAS ŽIBINTAS";4237592104;Ne;0;2;2;4
15928;Svaja;"STEBUKLINGAS ŽIBINTAS";2658828200;Ne;2;4;0;6
15929;Svaja;"STEBUKLINGAS ŽIBINTAS";4290716676;Ne;5;0;3;8
15930;Svaja;"STEBUKLINGAS ŽIBINTAS";1558093905;Ne;0;4;0;4
15931;Svaja;"STEBUKLINGAS ŽIBINTAS";9102872020;Ne;0;0;2;2
15932;Svaja;"STEBUKLINGAS ŽIBINTAS";8827421660;Ne;4;0;0;4
15933;Svaja;"STEBUKLINGAS ŽIBINTAS";7277217069;Ne;0;4;0;4
15934;Svaja;"STEBUKLINGAS ŽIBINTAS";9259478140;Ne;0;0;2;2
15935;Svaja;"STEBUKLINGAS ŽIBINTAS";1050291871;Ne;7;4;0;11
15936;Svaja;"STEBUKLINGAS ŽIBINTAS";2188430052;Ne;10;4;0;14
15937;Svaja;"STEBUKLINGAS ŽIBINTAS";1860076171;Ne;7;0;1;8
15938;Svaja;"STEBUKLINGAS ŽIBINTAS";8363418532;Ne;7;4;0;11
15939;Svaja;"STEBUKLINGAS ŽIBINTAS";8172396846;Ne;11;4;5;20
15940;Svaja;"STEBUKLINGAS ŽIBINTAS";9545690301;Ne;9;4;2;15
15941;Svaja;"STEBUKLINGAS ŽIBINTAS";4004383843;Ne;0;3;0;3
15942;Svaja;"STEBUKLINGAS ŽIBINTAS";6128350581;Ne;0;4;0;4
15943;Svaja;"STEBUKLINGAS ŽIBINTAS";1150040935;Ne;3;0;2;5
15944;Svaja;SAULUTĖ;50207734108;Ne;8;4;0;12
15945;Svaja;SAULUTĖ;20473739993;Ne;10;4;0;14
15946;Svaja;SAULUTĖ;30719991872;Ne;21;0;0;21
15947;Svaja;SAULUTĖ;6665752307;Ne;7;3;0;10
15948;Svaja;SAULUTĖ;4968201186;Ne;0;7;0;7
15949;Svaja;SAULUTĖ;8689706130;Ne;6;5;0;11
15950;Svaja;SAULUTĖ;6807834176;Ne;3;3;0;6
15951;Svaja;SAULUTĖ;7020342969;Ne;0;6;0;6
15952;Svaja;SAULUTĖ;3633996231;Ne;11;0;0;11
15953;Svaja;SAULUTĖ;2750615517;Ne;8;0;0;8
15954;Svaja;SAULUTĖ;3049808328;Ne;10;0;0;10
15955;Svaja;SAULUTĖ;4341042027;Ne;5;3;0;8
15956;Svaja;SAULUTĖ;3802996573;Ne;8;0;2;10
15957;Svaja;SAULUTĖ;7936765752;Ne;8;4;0;12
15958;Svaja;SAULUTĖ;4293339784;Ne;11;1;0;12
15959;Svaja;SAULUTĖ;9475971731;Ne;0;0;1;1
15960;Svaja;SAULUTĖ;5479482244;Ne;17;0;0;17
15961;Svaja;SAULUTĖ;7473493846;Ne;10;0;4;14
15962;Svaja;SAULUTĖ;5443682744;Ne;10;0;0;10
15963;Svaja;SAULUTĖ;9112198914;Ne;6;0;0;6
15964;Svaja;SAULUTĖ;2166382346;Ne;0;4;0;4
15965;Svaja;SAULUTĖ;8656417794;Ne;5;4;1;10
15966;Svaja;SAULUTĖ;3630922360;Ne;8;0;0;8
15967;Svaja;SAULUTĖ;1377813636;Ne;9;0;0;9
15968;Svaja;"AUKSINĖ ŽUVELĖ";4565097904;Ne;8;0;1;9
15969;Svaja;"AUKSINĖ ŽUVELĖ";9091970902;Ne;0;0;1;1
15970;Svaja;"AUKSINĖ ŽUVELĖ";9826552657;Ne;5;4;1;10
15971;Svaja;"AUKSINĖ ŽUVELĖ";6028471687;Ne;6;0;2;8
15972;Svaja;"AUKSINĖ ŽUVELĖ";1877749103;Ne;0;4;0;4
15973;Svaja;"AUKSINĖ ŽUVELĖ";5033214011;Ne;13;0;0;13
15974;Svaja;"AUKSINĖ ŽUVELĖ";5224855138;Ne;11;0;0;11
15975;Svaja;"AUKSINĖ ŽUVELĖ";5013548619;Ne;9;3;2;14
15976;Svaja;"AUKSINĖ ŽUVELĖ";1914129062;Ne;15;4;2;21
15977;Svaja;"AUKSINĖ ŽUVELĖ";3567924341;Ne;8;4;2;14
15978;Svaja;"AUKSINĖ ŽUVELĖ";2427918378;Ne;7;3;0;10
15979;Svaja;"AUKSINĖ ŽUVELĖ";3377044908;Ne;9;0;1;10
15980;Svaja;"AUKSINĖ ŽUVELĖ";7605002899;Ne;0;0;2;2
15981;Svaja;"AUKSINĖ ŽUVELĖ";5198482539;Ne;0;1;0;1
15982;Svaja;"AUKSINĖ ŽUVELĖ";7562678317;Ne;15;4;2;21
15983;Svaja;"AUKSINĖ ŽUVELĖ";2641473764;Ne;0;0;2;2
15984;Svaja;"AUKSINĖ ŽUVELĖ";7434898745;Ne;4;1;0;5
15985;Svaja;"PRIE ĮLANKOS";5595087767;Ne;5;4;0;9
15986;Svaja;"PRIE ĮLANKOS";8503177793;Ne;8;0;0;8
15987;Svaja;"PRIE ĮLANKOS";1633236289;Ne;0;6;0;6
15988;Svaja;"PRIE ĮLANKOS";9414846817;Ne;8;0;5;13
15989;Svaja;"PRIE ĮLANKOS";9311520300;Ne;6;0;0;6
15990;Svaja;"PRIE ĮLANKOS";9864664937;Ne;0;4;0;4
15991;Svaja;"PRIE ĮLANKOS";4014493868;Ne;0;5;0;5
15992;Svaja;"PRIE ĮLANKOS";6388514464;Ne;0;5;0;5
15993;Svaja;"PRIE ĮLANKOS";5862570666;Ne;9;0;1;10
15994;Svaja;"PRIE ĮLANKOS";2018689468;Ne;8;4;2;14
15995;Svaja;"PRIE ĮLANKOS";3459060550;Ne;21;0;0;21
15996;Svaja;"PRIE ĮLANKOS";1392455608;Ne;0;4;0;4
15997;Svaja;"PRIE ĮLANKOS";1617844709;Ne;11;0;2;13
15998;Svaja;"PRIE ĮLANKOS";3102257512;Ne;5;0;0;5
15999;Svaja;"PRIE ĮLANKOS";4393041946;Ne;0;2;0;2
16000;Svaja;"PRIE ĮLANKOS";1044733634;Ne;0;0;2;2
16001;Svaja;"PRIE ĮLANKOS";6676145522;Ne;9;4;0;13
16002;Svaja;"PRIE ĮLANKOS";1671495181;Ne;0;1;1;2
16003;Svaja;"PRIE ĮLANKOS";9950569499;Ne;6;0;3;9
16004;Svaja;"PRIE ĮLANKOS";4284157599;Ne;11;0;0;11
16005;Svaja;"PRIE ĮLANKOS";6361228838;Ne;10;0;0;10
16006;Svaja;"PRIE ĮLANKOS";7514587933;Ne;0;12;2;14
16007;Svaja;"1 B klasė";24863928147;Ne;0;5;0;5
16008;Svaja;"1 B klasė";1865658456;Ne;0;9;0;9
16009;Svaja;"1 B klasė";8279605005;Ne;0;21;0;21
16010;Svaja;"1 B klasė";55925058866;Ne;0;21;0;21
16011;Svaja;"1 B klasė";1437557657;Ne;9;4;0;13
16012;Svaja;"1 B klasė";25194696146;Ne;0;5;0;5
16013;Svaja;"1 B klasė";1704075006;Ne;0;4;0;4
16014;Svaja;"1 B klasė";8875237023;Ne;0;4;0;4
16015;Svaja;"1 B klasė";64196174690;Ne;11;15;0;26
16016;Svaja;"1 B klasė";8491275729;Ne;0;4;0;4
16017;Svaja;"1 B klasė";21871530266;Ne;0;4;0;4
16018;Svaja;"1 B klasė";7753488216;Ne;0;7;0;7
16019;Svaja;"1 B klasė";36505115395;Ne;0;21;0;21
16020;Svaja;"1 B klasė";7911488445;Ne;3;4;0;7
16021;Svaja;"1 B klasė";6593047776;Ne;0;5;0;5
16022;Svaja;"1 B klasė";15159708127;Ne;0;6;0;6
16023;Svaja;"1 B klasė";2985196852;Ne;0;5;0;5
16024;Svaja;"1 B klasė";9110985103;Ne;0;7;0;7
16025;Svaja;"1 B klasė";3562817807;Ne;0;9;0;9
16026;Svaja;"1 B klasė";2069150261;Ne;0;10;0;10
16027;Svaja;"1 B klasė";1191494598;Ne;0;4;0;4
16028;Svaja;"1 B klasė";11671380984;Ne;0;10;0;10
16029;Svaja;"1 B klasė";99183628764;Ne;0;6;0;6
16030;Svaja;"1 B klasė";1369637618;Ne;0;4;0;4
16031;Svaja;"1 B klasė";3660152224;Ne;0;7;0;7
16032;Svaja;"1 A klasė";5337604370;Ne;0;18;0;18
16033;Svaja;"1 A klasė";1046879533;Ne;0;10;0;10
16034;Svaja;"1 A klasė";2147266053;Ne;0;6;0;6
16035;Svaja;"1 A klasė";4846025153;Ne;0;4;0;4
16036;Svaja;"1 A klasė";1714711904;Ne;0;7;0;7
16037;Svaja;"1 A klasė";47457128214;Ne;0;8;0;8
16038;Svaja;"1 A klasė";65917456866;Ne;0;4;0;4
16039;Svaja;"1 A klasė";1197826066;Ne;0;5;0;5
16040;Svaja;"1 A klasė";73679997517;Ne;0;21;0;21
16041;Svaja;"1 A klasė";7669562010;Ne;15;0;0;15
16042;Svaja;"1 A klasė";5335776957;Ne;0;21;0;21
16043;Svaja;"1 A klasė";56117509354;Ne;0;5;0;5
16044;Svaja;"1 A klasė";27445299450;Ne;0;4;0;4
16045;Svaja;"1 A klasė";1576498450;Ne;0;4;0;4
16046;Svaja;"1 A klasė";43307670660;Ne;0;21;0;21
16047;Svaja;"1 A klasė";22702341083;Ne;4;9;0;13
16048;Svaja;"1 A klasė";70641067006;Ne;0;21;0;21
16049;Svaja;"1 A klasė";58102699652;Ne;0;4;0;4
16050;Svaja;"1 A klasė";2076060840;Ne;0;5;0;5
16051;Svaja;"1 A klasė";4900757614;Ne;0;9;0;9
16052;Svaja;"1 A klasė";1061894314;Ne;0;8;0;8
16053;Svaja;"1 A klasė";8697355813;Ne;0;6;0;6
16054;Svaja;"1 A klasė";193181908;Ne;0;4;0;4
16055;Svaja;"1 A klasė";193181908;Ne;0;4;0;4
16056;Svaja;"2 A klasė";9628146488;Ne;0;11;0;11
16057;Svaja;"2 A klasė";1562041360;Ne;0;6;0;6
16058;Svaja;"2 A klasė";43223177664;Ne;0;6;0;6
16059;Svaja;"2 A klasė";1017471747;Ne;0;4;0;4
16060;Svaja;"2 A klasė";26500981786;Ne;0;4;0;4
16061;Svaja;"2 A klasė";5522433229;Ne;0;4;0;4
16062;Svaja;"2 A klasė";1400892707;Ne;0;9;0;9
16063;Svaja;"2 A klasė";30027404222;Ne;0;4;0;4
16064;Svaja;"2 A klasė";23112873505;Ne;0;4;0;4
16065;Svaja;"2 A klasė";15246943974;Ne;0;4;0;4
16066;Svaja;"2 A klasė";1297727288;Ne;4;1;0;5
16067;Svaja;"2 A klasė";1304775332;Ne;0;5;0;5
16068;Svaja;"2 A klasė";8198614500;Ne;0;5;0;5
16069;Svaja;"2 A klasė";67462299886;Ne;0;4;0;4
16070;Svaja;"2 A klasė";40856210635;Ne;0;5;0;5
16071;Svaja;"2 A klasė";18733824395;Ne;0;7;0;7
16072;Svaja;"2 A klasė";84508228457;Ne;0;4;0;4
16073;Svaja;"2 A klasė";2058827699;Ne;0;7;0;7
16074;Svaja;"2 A klasė";1352488176;Ne;0;4;0;4
16075;Svaja;"2 A klasė";1660742385;Ne;0;4;0;4
16076;Svaja;"2 A klasė";89042677798;Ne;0;4;0;4
16077;Svaja;"2 A klasė";26902749194;Ne;0;4;0;4
16078;Svaja;"2 A klasė";3022690832;Ne;0;4;0;4
16079;Svaja;"2 A klasė";1943166503;Ne;0;10;0;10
16080;Svaja;"2 A klasė";1048576329;Ne;0;5;0;5
16081;Svaja;"2 B klasė";4804779327;Ne;0;21;0;21
16082;Svaja;"2 B klasė";7719185632;Ne;0;4;0;4
16083;Svaja;"2 B klasė";69028070656;Ne;0;4;0;4
16084;Svaja;"2 B klasė";54745410330;Ne;0;4;0;4
16085;Svaja;"2 B klasė";30036722764;Ne;0;4;0;4
16086;Svaja;"2 B klasė";1509272327;Ne;6;5;0;11
16087;Svaja;"2 B klasė";1601648171;Ne;0;5;0;5
16088;Svaja;"2 B klasė";89316574266;Ne;0;4;0;4
16089;Svaja;"2 B klasė";78293798850;Ne;0;5;0;5
16090;Svaja;"2 B klasė";40814723278;Ne;0;4;0;4
16091;Svaja;"2 B klasė";1967394949;Ne;0;7;0;7
16092;Svaja;"2 B klasė";4881476441;Ne;0;4;0;4
16093;Svaja;"2 B klasė";87432529423;Ne;0;4;0;4
16094;Svaja;"2 B klasė";19887874988;Ne;0;6;0;6
16095;Svaja;"2 B klasė";69413101571;Ne;0;4;0;4
16096;Svaja;"2 B klasė";57216954289;Ne;0;5;0;5
16097;Svaja;"2 B klasė";1655551042;Ne;0;5;0;5
16098;Svaja;"2 B klasė";76618850202;Ne;0;4;0;4
16099;Svaja;"2 B klasė";21608020858;Ne;0;10;0;10
16100;Svaja;"2 B klasė";3077814152;Ne;0;4;0;4
16101;Svaja;"2 B klasė";809734624;Ne;0;4;0;4
16102;Svaja;"2 B klasė";44989143252;Ne;0;6;0;6
16103;Svaja;"2 B klasė";6056157113;Ne;0;4;0;4
16104;Svaja;"2 B klasė";30360097999;Ne;0;21;0;21
16105;Svaja;"2 B klasė";1378219785;Ne;0;6;0;6
16106;Svaja;"3 A klasė";72752022712;Ne;0;16;0;16
16107;Svaja;"3 A klasė";8828911320;Ne;0;11;0;11
16108;Svaja;"3 A klasė";60448774566;Ne;0;8;0;8
16109;Svaja;"3 A klasė";75104768118;Ne;0;4;0;4
16110;Svaja;"3 A klasė";1649920341;Ne;0;4;0;4
16111;Svaja;"3 A klasė";30754812113;Ne;0;4;0;4
16112;Svaja;"3 A klasė";64487515384;Ne;0;21;0;21
16113;Svaja;"3 A klasė";34216516886;Ne;0;4;0;4
16114;Svaja;"3 A klasė";3474439050;Ne;0;4;0;4
16115;Svaja;"3 A klasė";63346231562;Ne;0;5;0;5
16116;Svaja;"3 A klasė";75296600945;Ne;0;5;0;5
16117;Svaja;"3 A klasė";6057524892;Ne;0;21;0;21
16118;Svaja;"3 A klasė";2321739150;Ne;0;6;0;6
16119;Svaja;"3 A klasė";4617061890;Ne;0;7;0;7
16120;Svaja;"3 A klasė";89695643588;Ne;0;5;0;5
16121;Svaja;"3 A klasė";3604946305;Ne;0;21;0;21
16122;Svaja;"3 A klasė";25578518444;Ne;0;4;0;4
16123;Svaja;"3 A klasė";1168637823;Ne;0;6;0;6
16124;Svaja;"3 A klasė";4906784415;Ne;0;13;0;13
16125;Svaja;"3 A klasė";15252353189;Ne;0;4;0;4
16126;Svaja;"3 B klasė";6905550313;Ne;0;7;0;7
16127;Svaja;"3 B klasė";62971657427;Ne;0;4;0;4
16128;Svaja;"3 B klasė";1367687415;Ne;0;4;0;4
16129;Svaja;"3 B klasė";4416877973;Ne;0;5;0;5
16130;Svaja;"3 B klasė";1847775266;Ne;0;21;0;21
16131;Svaja;"3 B klasė";17947580061;Ne;0;4;0;4
16132;Svaja;"3 B klasė";6969692916;Ne;0;12;0;12
16133;Svaja;"3 B klasė";44418402260;Ne;0;4;0;4
16134;Svaja;"3 B klasė";50649509868;Ne;0;4;0;4
16135;Svaja;"3 B klasė";73391331150;Ne;0;5;0;5
16136;Svaja;"3 B klasė";70507326327;Ne;0;21;0;21
16137;Svaja;"3 B klasė";80772711351;Ne;0;4;0;4
16138;Svaja;"3 B klasė";54328462992;Ne;0;21;0;21
16139;Svaja;"3 B klasė";1470843400;Ne;0;6;0;6
16140;Svaja;"3 B klasė";92044111261;Ne;0;5;0;5
16141;Svaja;"3 B klasė";11937575740;Ne;0;14;0;14
16142;Svaja;"3 B klasė";8011137572;Ne;0;5;0;5
16143;Svaja;"3 B klasė";71708072632;Ne;0;9;0;9
16144;Svaja;"3 B klasė";56506642672;Ne;0;8;0;8
16145;Svaja;"3 B klasė";3526873547;Ne;0;21;0;21
16146;Svaja;"3 B klasė";70506691027;Ne;0;21;0;21
16147;Svaja;"3 B klasė";4282243865;Ne;0;21;0;21
16148;Svaja;"4 A klasė";96680395594;Ne;0;4;0;4
16149;Svaja;"4 A klasė";31604152893;Ne;0;5;0;5
16150;Svaja;"4 A klasė";70513111186;Ne;0;4;0;4
16151;Svaja;"4 A klasė";72655912805;Ne;0;21;0;21
16152;Svaja;"4 A klasė";20363553383;Ne;0;4;0;4
16153;Svaja;"4 A klasė";8876971658;Ne;0;4;0;4
16154;Svaja;"4 A klasė";69928474471;Ne;0;21;0;21
16155;Svaja;"4 A klasė";49184638535;Ne;0;21;0;21
16156;Svaja;"4 A klasė";3775578708;Taip;0;5;0;5
16157;Svaja;"4 A klasė";58497063533;Ne;0;5;0;5
16158;Svaja;"4 A klasė";89075087937;Ne;0;4;0;4
16159;Svaja;"4 A klasė";99157757025;Ne;0;6;0;6
16160;Svaja;"4 A klasė";16955510836;Ne;0;19;0;19
16161;Svaja;"4 A klasė";24812635291;Ne;0;7;0;7
16162;Svaja;"4 A klasė";21534170175;Ne;0;6;0;6
16163;Svaja;"4 A klasė";28311552445;Ne;0;5;0;5
16164;Svaja;"4 A klasė";38781141060;Ne;0;5;0;5
16165;Svaja;"4 A klasė";88447528808;Ne;0;4;0;4
16166;Svaja;"4 A klasė";66507774550;Ne;0;4;0;4
16167;Svaja;"4 A klasė";76101749947;Ne;0;21;0;21
16168;Svaja;"4 A klasė";18432518932;Ne;0;6;0;6
16169;Svaja;"4 B klasė";61996055386;Ne;0;21;0;21
16170;Svaja;"4 B klasė";57983452414;Ne;0;21;0;21
16171;Svaja;"4 B klasė";30200636424;Ne;0;21;0;21
16172;Svaja;"4 B klasė";8802243719;Ne;0;21;0;21
16173;Svaja;"4 B klasė";7747921362;Ne;0;21;0;21
16174;Svaja;"4 B klasė";38464012322;Ne;0;4;0;4
16175;Svaja;"4 B klasė";5712106350;Ne;0;4;0;4
16176;Svaja;"4 B klasė";9401605132;Ne;0;10;0;10
16177;Svaja;"4 B klasė";27313057222;Ne;0;21;0;21
16178;Svaja;"4 B klasė";68894832324;Ne;0;21;0;21
16179;Svaja;"4 B klasė";29972474690;Ne;0;21;0;21
16180;Svaja;"4 B klasė";47441661801;Ne;0;5;0;5
16181;Svaja;"4 B klasė";62579722313;Ne;0;5;0;5
16182;Svaja;"4 B klasė";21035820496;Ne;0;21;0;21
16183;Svaja;"4 B klasė";71840791098;Ne;0;7;0;7
16184;Svaja;"4 B klasė";59707838958;Ne;0;21;0;21
16185;Svaja;"4 B klasė";71086654007;Ne;0;21;0;21
16186;Svaja;"4 B klasė";15871540340;Ne;6;21;0;27
16187;Svaja;"4 B klasė";97651620085;Ne;0;4;0;4
16188;Svaja;"4 B klasė";77796846388;Ne;0;21;0;21
16189;Svaja;"4 C klasė";79260508923;Ne;14;2;0;16
16190;Svaja;"4 C klasė";94437606762;Ne;0;21;0;21
16191;Svaja;"4 C klasė";73440582394;Ne;0;21;0;21
16192;Svaja;"4 C klasė";60982723867;Ne;0;21;0;21
16193;Svaja;"4 C klasė";70157518595;Ne;0;21;0;21
16194;Svaja;"4 C klasė";5975083034;Ne;0;21;0;21
16195;Svaja;"4 C klasė";76871144487;Ne;0;21;0;21
16196;Svaja;"4 C klasė";6613028133;Ne;0;5;0;5
16197;Svaja;"4 C klasė";48888360976;Ne;0;4;0;4
16198;Svaja;"4 C klasė";12226488343;Ne;0;21;0;21
16199;Svaja;"4 C klasė";3909240894;Ne;0;4;0;4
16200;Svaja;"4 C klasė";53352329988;Ne;0;5;0;5
16201;Svaja;"4 C klasė";59917024948;Ne;0;4;0;4
16202;Svaja;"4 C klasė";73691352138;Ne;0;4;0;4
16203;Svaja;"4 C klasė";66967032561;Ne;4;5;0;9
16204;Svaja;"4 C klasė";77712240909;Ne;0;4;0;4
16205;Svaja;"4 C klasė";82358174131;Ne;0;4;0;4
16206;Svaja;"4 C klasė";25585032766;Ne;0;21;0;21
16207;Svaja;"4 C klasė";79572045341;Ne;0;21;0;21
16208;Svaja;"3 C klasė";1848422504;Ne;0;7;0;7
16209;Svaja;"3 C klasė";3743948734;Ne;0;7;0;7
16210;Svaja;"3 C klasė";25934507261;Ne;0;8;0;8
16211;Svaja;"3 C klasė";89047123808;Ne;0;15;0;15
16212;Svaja;"3 C klasė";74904581010;Ne;0;21;0;21
16213;Svaja;"3 C klasė";50510924690;Ne;0;4;0;4
16214;Svaja;"3 C klasė";41183537732;Ne;0;11;0;11
16215;Svaja;"3 C klasė";70714898590;Ne;0;5;0;5
16216;Svaja;"3 C klasė";54852358913;Ne;0;5;0;5
16217;Svaja;"3 C klasė";57253216255;Ne;0;4;0;4
16218;Svaja;"3 C klasė";34995551069;Ne;0;21;0;21
16219;Svaja;"3 C klasė";1795682827;Ne;0;4;0;4
16220;Svaja;"3 C klasė";93651139102;Ne;0;5;0;5
16221;Svaja;"3 C klasė";1742951527;Ne;0;11;0;11
16222;Svaja;"3 C klasė";91855230473;Ne;0;10;0;10
16223;Svaja;"3 C klasė";1855559693;Ne;0;21;0;21
16224;Svaja;"3 C klasė";2165716699;Ne;1;19;0;20
16225;Svaja;"3 C klasė";31216445971;Ne;0;21;0;21
16226;Svaja;"3 C klasė";20342193231;Ne;0;4;0;4
16227;Svaja;"3 C klasė";54462393937;Ne;0;7;0;7
16228;Svaja;"3 C klasė";36001411632;Ne;0;5;0;5
16229;Svaja;"3 C klasė";94449039022;Ne;0;21;0;21
16230;Svaja;"3 C klasė";85150525696;Ne;0;13;0;13
16231;Svaja;"3 C klasė";91088224294;Ne;0;14;0;14
16232;Šilelis;PAUKŠTELIAI;6128379060;Ne;21;0;0;21
16233;Šilelis;PAUKŠTELIAI;9653439873;Ne;6;0;0;6
16234;Šilelis;PAUKŠTELIAI;2823486581;Ne;0;4;0;4
16235;Šilelis;PAUKŠTELIAI;6369443270;Ne;0;2;0;2
16236;Šilelis;PAUKŠTELIAI;7595774842;Ne;3;2;0;5
16237;Šilelis;PAUKŠTELIAI;6614686867;Ne;12;0;0;12
16238;Šilelis;PAUKŠTELIAI;3053443777;Ne;5;0;1;6
16239;Šilelis;PAUKŠTELIAI;4960501068;Ne;5;5;0;10
16240;Šilelis;PAUKŠTELIAI;7072057348;Ne;0;1;0;1
16241;Šilelis;PAUKŠTELIAI;5974537364;Ne;0;7;8;15
16242;Šilelis;PAUKŠTELIAI;1124854378;Ne;11;0;0;11
16243;Šilelis;PAUKŠTELIAI;7197420388;Ne;0;11;0;11
16244;Šilelis;PAUKŠTELIAI;9107920165;Ne;0;11;0;11
16245;Šilelis;PAUKŠTELIAI;6852463814;Ne;9;6;0;15
16246;Šilelis;PAUKŠTELIAI;9799198904;Ne;7;0;0;7
16247;Šilelis;PAUKŠTELIAI;5493811298;Ne;2;5;0;7
16248;Šilelis;SKRUZDELIUKAI;6139976105;Ne;0;14;0;14
16249;Šilelis;SKRUZDELIUKAI;3823958567;Ne;0;9;0;9
16250;Šilelis;SKRUZDELIUKAI;6359318134;Ne;7;4;1;12
16251;Šilelis;SKRUZDELIUKAI;5598152793;Ne;15;0;1;16
16252;Šilelis;SKRUZDELIUKAI;8090773379;Ne;0;12;0;12
16253;Šilelis;SKRUZDELIUKAI;1200024379;Ne;11;0;0;11
16254;Šilelis;SKRUZDELIUKAI;8578620603;Ne;0;0;1;1
16255;Šilelis;SKRUZDELIUKAI;9589138527;Ne;10;9;0;19
16256;Šilelis;SKRUZDELIUKAI;3967932407;Ne;0;4;0;4
16257;Šilelis;SKRUZDELIUKAI;4629917226;Ne;6;0;0;6
16258;Šilelis;SKRUZDELIUKAI;2972202874;Taip;21;0;0;21
16259;Šilelis;SKRUZDELIUKAI;9461117894;Ne;21;0;0;21
16260;Šilelis;SKRUZDELIUKAI;5817818596;Ne;7;6;2;15
16261;Šilelis;SKRUZDELIUKAI;5091571136;Ne;7;0;0;7
16262;Šilelis;SKRUZDELIUKAI;8297975308;Ne;10;2;0;12
16263;Šilelis;SKRUZDELIUKAI;3381053227;Ne;0;10;0;10
16264;Šilelis;SKRUZDELIUKAI;9276607554;Ne;6;3;0;9
16265;Šilelis;SMERFY;3247333567;Ne;0;3;0;3
16266;Šilelis;SMERFY;6999088222;Ne;0;1;0;1
16267;Šilelis;SMERFY;9886134621;Ne;0;4;0;4
16268;Šilelis;SMERFY;6773906184;Ne;0;3;0;3
16269;Šilelis;SMERFY;3089270468;Ne;0;9;0;9
16270;Šilelis;SMERFY;7824279279;Ne;5;5;0;10
16271;Šilelis;SMERFY;4504627601;Ne;0;0;1;1
16272;Šilelis;SMERFY;7534468539;Ne;0;4;0;4
16273;Šilelis;SMERFY;6390855924;Ne;0;1;0;1
16274;Šilelis;SMERFY;4196893379;Ne;0;2;0;2
16275;Šilelis;SMERFY;1890114622;Ne;2;4;0;6
16276;Šilelis;SMERFY;5025956218;Ne;10;0;0;10
16277;Šilelis;EŽIUKAI;4494932923;Ne;0;4;0;4
16278;Šilelis;EŽIUKAI;7074963804;Ne;0;5;0;5
16279;Šilelis;EŽIUKAI;4702068672;Ne;0;10;0;10
16280;Šilelis;EŽIUKAI;5020209473;Ne;0;3;1;4
16281;Šilelis;EŽIUKAI;2295849333;Ne;0;5;0;5
16282;Šilelis;EŽIUKAI;5131051261;Ne;5;0;0;5
16283;Šilelis;EŽIUKAI;1883483049;Ne;0;2;0;2
16284;Šilelis;EŽIUKAI;6386996498;Ne;0;0;2;2
16285;Šilelis;NYKŠTUKAI;3046954717;Taip;0;0;1;1
16286;Šilelis;NYKŠTUKAI;3158708835;Ne;10;4;0;14
16287;Šilelis;NYKŠTUKAI;6195580698;Ne;4;0;0;4
16288;Šilelis;NYKŠTUKAI;6107771932;Ne;11;0;1;12
16289;Šilelis;NYKŠTUKAI;4323998445;Ne;0;0;6;6
16290;Šilelis;NYKŠTUKAI;2095572561;Ne;0;0;2;2
16291;Šilelis;NYKŠTUKAI;2161973782;Ne;7;6;0;13
16292;Šilelis;NYKŠTUKAI;4459114205;Ne;14;0;0;14
16293;Šilelis;NYKŠTUKAI;3728633100;Ne;0;1;0;1
16294;Šilelis;NYKŠTUKAI;3999426414;Ne;0;3;0;3
16295;Šilelis;NYKŠTUKAI;5745874033;Ne;0;0;2;2
16296;Šilelis;NYKŠTUKAI;9769483899;Ne;0;4;0;4
16297;Šilelis;NYKŠTUKAI;3120671593;Ne;0;0;3;3
16298;Šilelis;NYKŠTUKAI;2908840424;Ne;10;0;3;13
16299;Šilelis;NYKŠTUKAI;6980045156;Ne;5;0;0;5
16300;Šilelis;NYKŠTUKAI;9685227636;Ne;0;0;2;2
16301;Šilelis;NYKŠTUKAI;4868465692;Ne;5;1;0;6
16302;Šilelis;NYKŠTUKAI;4754544277;Ne;11;2;0;13
16303;Šilelis;NYKŠTUKAI;1222028604;Ne;0;21;0;21
16304;Šilelis;NYKŠTUKAI;7480611069;Ne;0;2;0;2
16305;Šilelis;ANČIUKAI;1726944289;Ne;4;0;0;4
16306;Šilelis;ANČIUKAI;4336942500;Ne;2;0;0;2
16307;Šilelis;ANČIUKAI;9661578871;Ne;9;1;2;12
16308;Šilelis;ANČIUKAI;6616262730;Ne;5;6;0;11
16309;Šilelis;ANČIUKAI;4323750313;Ne;19;0;0;19
16310;Šilelis;ANČIUKAI;3221398692;Ne;5;0;2;7
16311;Šilelis;ANČIUKAI;6364741317;Ne;6;0;0;6
16312;Šilelis;ANČIUKAI;1325857464;Taip;0;0;5;5
16313;Šilelis;ANČIUKAI;9407916190;Ne;0;5;0;5
16314;Šilelis;ANČIUKAI;7128670936;Ne;4;0;0;4
16315;Šilelis;ANČIUKAI;8613748314;Ne;4;1;3;8
16316;Šilelis;ANČIUKAI;5381213051;Ne;10;4;0;14
16317;Šilelis;ANČIUKAI;8807755852;Ne;0;6;0;6
16318;Šilelis;ANČIUKAI;4135383684;Ne;0;1;0;1
16319;Šilelis;ANČIUKAI;8603589758;Ne;0;0;2;2
16320;Šilelis;KAČIUKAI;9899047136;Ne;0;0;2;2
16321;Šilelis;KAČIUKAI;3216168797;Ne;5;0;3;8
16322;Šilelis;KAČIUKAI;9848760151;Ne;0;3;0;3
16323;Šilelis;KAČIUKAI;8387022157;Ne;11;2;0;13
16324;Šilelis;KAČIUKAI;3393466953;Ne;1;7;0;8
16325;Šilelis;KAČIUKAI;8064905796;Ne;0;3;0;3
16326;Šilelis;KAČIUKAI;5176259940;Ne;0;0;2;2
16327;Šilelis;KAČIUKAI;7123048946;Ne;4;4;0;8
16328;Šilelis;KAČIUKAI;6479728064;Ne;0;7;0;7
16329;Šilelis;KAČIUKAI;3686287802;Ne;0;3;0;3
16330;Šilelis;KAČIUKAI;2906501601;Ne;0;16;0;16
16331;Šilelis;KAČIUKAI;6510813364;Ne;0;1;0;1
16332;Šilelis;KAČIUKAI;8319185507;Ne;7;2;0;9
16333;Šilelis;KAČIUKAI;8504187981;Ne;0;8;0;8
16334;Šilelis;KAČIUKAI;6470073008;Ne;0;8;0;8
16335;Šilelis;KAČIUKAI;3419284228;Ne;9;2;0;11
16336;Šilelis;KAČIUKAI;3712001932;Ne;0;7;0;7
16337;Šilelis;KAČIUKAI;9106999969;Ne;0;9;0;9
16338;Šilelis;KAČIUKAI;6894466509;Ne;2;0;0;2
16339;Šilelis;KAČIUKAI;5026203678;Ne;5;1;0;6
16340;Šilelis;KIŠKUČIAI;9480895465;Ne;0;2;0;2
16341;Šilelis;KIŠKUČIAI;8632645047;Ne;4;0;1;5
16342;Šilelis;KIŠKUČIAI;8759694551;Ne;6;0;0;6
16343;Šilelis;KIŠKUČIAI;2209552706;Ne;2;2;5;9
16344;Šilelis;KIŠKUČIAI;3296197220;Ne;0;2;0;2
16345;Šilelis;KIŠKUČIAI;4386065478;Ne;0;1;0;1
16346;Šilelis;KIŠKUČIAI;7043644521;Ne;0;0;2;2
16347;Šilelis;KIŠKUČIAI;9746722034;Ne;5;0;0;5
16348;Šilelis;KIŠKUČIAI;2551747888;Ne;0;0;1;1
16349;Šilelis;KIŠKUČIAI;5815768693;Ne;7;0;0;7
16350;Šilelis;KIŠKUČIAI;8598321310;Ne;2;0;2;4
16351;Šilelis;KREGŽDUTĖS;1025643459;Ne;15;0;0;15
16352;Šilelis;KREGŽDUTĖS;2896605690;Ne;2;0;1;3
16353;Šilelis;KREGŽDUTĖS;8453070684;Ne;0;0;2;2
16354;Šilelis;KREGŽDUTĖS;1286082219;Ne;17;0;0;17
16355;Šilelis;KREGŽDUTĖS;3068950702;Ne;5;0;0;5
16356;Šilelis;KREGŽDUTĖS;8665357907;Ne;14;2;0;16
16357;Šilelis;KREGŽDUTĖS;1152159735;Ne;12;0;0;12
16358;Šilelis;KREGŽDUTĖS;6630114847;Taip;8;0;2;10
16359;Šilelis;KREGŽDUTĖS;3953114161;Taip;2;4;1;7
16360;Šilelis;KREGŽDUTĖS;2499322761;Ne;5;4;4;13
16361;Šilelis;KREGŽDUTĖS;8659845107;Ne;5;2;4;11
16362;Šilelis;KREGŽDUTĖS;5868594049;Ne;1;0;3;4
16363;Šilelis;KREGŽDUTĖS;8855625488;Ne;2;0;1;3
16364;Šilelis;KREGŽDUTĖS;5223262925;Ne;0;2;0;2
16365;Šilelis;KREGŽDUTĖS;9292761872;Ne;10;0;11;21
16366;Šilelis;KREGŽDUTĖS;9715544798;Ne;13;0;0;13
16367;Šilelis;PAGRANDUKAI;9922962130;Ne;10;0;0;10
16368;Šilelis;PAGRANDUKAI;4814863979;Ne;9;1;1;11
16369;Šilelis;PAGRANDUKAI;9670243727;Ne;0;2;0;2
16370;Šilelis;PAGRANDUKAI;8357287467;Ne;0;2;0;2
16371;Šilelis;PAGRANDUKAI;20525573092;Ne;0;3;0;3
16372;Šilelis;PAGRANDUKAI;2897196188;Ne;0;2;2;4
16373;Šilelis;PAGRANDUKAI;3583955729;Ne;0;3;0;3
16374;Šilelis;PAGRANDUKAI;9113098594;Ne;0;0;1;1
16375;Šilelis;PAGRANDUKAI;7623203279;Ne;0;0;2;2
16376;Šilelis;PAGRANDUKAI;3807787648;Ne;0;0;3;3
16377;Šilelis;PAGRANDUKAI;6276408187;Ne;6;0;0;6
16378;Šilelis;PAGRANDUKAI;8416126751;Ne;0;2;5;7
16379;Šilelis;PAGRANDUKAI;2397366916;Ne;0;3;0;3
16380;Šilelis;PAGRANDUKAI;7936978436;Ne;0;5;0;5
16381;Šilelis;PAGRANDUKAI;1747920772;Ne;0;4;0;4
16382;Šilelis;PAGRANDUKAI;3843999609;Ne;0;6;0;6
16383;Šilelis;PAGRANDUKAI;1898004894;Ne;6;2;0;8
16384;Šilelis;BITUTĖS;2948291866;Ne;0;3;0;3
16385;Šilelis;BITUTĖS;5835209357;Ne;0;0;2;2
16386;Šilelis;BITUTĖS;7512731255;Ne;3;1;2;6
16387;Šilelis;BITUTĖS;1268335563;Ne;0;1;1;2
16388;Šilelis;BITUTĖS;9035595952;Ne;4;0;1;5
16389;Šilelis;BITUTĖS;7814807923;Ne;7;2;0;9
16390;Šilelis;BITUTĖS;9071963194;Taip;17;0;0;17
16391;Šilelis;BITUTĖS;1960952604;Ne;0;1;0;1
16392;Šilelis;BITUTĖS;3954379433;Taip;6;10;0;16
16393;Šilelis;BITUTĖS;7350013139;Ne;0;1;0;1
16394;Šilelis;BITUTĖS;1390916076;Ne;6;0;0;6
16395;Šilelis;BITUTĖS;6143099736;Ne;0;0;3;3
16396;Šilelis;BITUTĖS;2667785768;Ne;5;0;1;6
16397;Šilelis;BITUTĖS;2023309512;Ne;3;0;0;3
16398;Šilelis;BITUTĖS;5375413045;Ne;0;0;15;15
16399;Šilelis;BITUTĖS;6297546907;Ne;7;0;3;10
16400;Šilelis;BITUTĖS;9234766553;Ne;0;0;2;2
16401;Šilelis;BITUTĖS;6830200578;Ne;15;0;0;15
16402;Šilelis;DRUGELIAI;2079073174;Ne;8;0;1;9
16403;Šilelis;DRUGELIAI;3598370884;Ne;10;4;0;14
16404;Šilelis;DRUGELIAI;1347150938;Ne;5;0;0;5
16405;Šilelis;DRUGELIAI;7636725161;Ne;4;4;0;8
16406;Šilelis;DRUGELIAI;1891388542;Ne;0;5;0;5
16407;Šilelis;DRUGELIAI;5759824196;Ne;0;1;0;1
16408;Šilelis;DRUGELIAI;31906089315;Ne;0;4;0;4
16409;Šilelis;DRUGELIAI;4115738520;Ne;0;2;0;2
16410;Šilelis;DRUGELIAI;3824174896;Ne;0;2;0;2
16411;Šilelis;DRUGELIAI;8090765017;Ne;6;0;0;6
16412;Šilelis;DRUGELIAI;54633547799;Ne;10;2;0;12
16413;Šilelis;DRUGELIAI;9100047520;Ne;0;5;0;5
16414;Šilelis;DRUGELIAI;1019874215;Ne;0;1;2;3
16415;Šilelis;DRUGELIAI;1638362625;Ne;1;10;0;11
16416;Šilelis;DRUGELIAI;9482667810;Ne;0;0;2;2
16417;Šilelis;DRUGELIAI;5379171382;Ne;0;1;0;1
16418;Šilelis;DRUGELIAI;6230566495;Ne;1;1;0;2
16419;Šilelis;DRUGELIAI;6523676718;Ne;0;7;0;7
16420;Šilelis;DRUGELIAI;5766702969;Ne;5;6;0;11
16421;Šilelis;DRUGELIAI;8915228012;Ne;0;0;1;1
16422;Šilelis;DRUGELIAI;1984731000;Ne;0;2;1;3
16423;Šilelis;DRUGELIAI;6104538160;Ne;6;2;0;8
16424;Šilelis;DRUGELIAI;7542121945;Ne;6;5;1;12
16425;Vaduvos;PAGRANDUKAI;1431863758;Ne;0;1;0;1
16426;Vaduvos;PAGRANDUKAI;8408017356;Ne;0;9;0;9
16427;Vaduvos;PAGRANDUKAI;72724196791;Ne;0;14;0;14
16428;Vaduvos;PAGRANDUKAI;9371067563;Ne;0;1;0;1
16429;Vaduvos;PAGRANDUKAI;4029586203;Ne;0;4;0;4
16430;Vaduvos;PAGRANDUKAI;73800920781;Ne;0;1;9;10
16431;Vaduvos;PAGRANDUKAI;18035723255;Ne;6;0;1;7
16432;Vaduvos;PAGRANDUKAI;5954492368;Ne;0;7;0;7
16433;Vaduvos;PAGRANDUKAI;7397068779;Ne;0;5;0;5
16434;Vaduvos;PAGRANDUKAI;8875709110;Ne;0;6;0;6
16435;Vaduvos;PAGRANDUKAI;7305111076;Ne;5;4;0;9
16436;Vaduvos;PAGRANDUKAI;2897226343;Ne;0;0;7;7
16437;Vaduvos;PAGRANDUKAI;68848152670;Ne;15;0;0;15
16438;Vaduvos;PAGRANDUKAI;4105978403;Ne;0;3;0;3
16439;Vaduvos;PAGRANDUKAI;5428067167;Ne;0;2;3;5
16440;Vaduvos;PAGRANDUKAI;3699578284;Ne;7;5;0;12
16441;Vaduvos;PAGRANDUKAI;8299189235;Ne;10;5;0;15
16442;Vaduvos;PAGRANDUKAI;9540008495;Ne;0;6;0;6
16443;Vaduvos;PAGRANDUKAI;7493037613;Ne;0;4;0;4
16444;Vaduvos;PAGRANDUKAI;7163839896;Ne;0;4;0;4
16445;Vaduvos;KODĖLČIUKAI;3010510262;Ne;5;4;0;9
16446;Vaduvos;KODĖLČIUKAI;9429028460;Ne;8;4;0;12
16447;Vaduvos;KODĖLČIUKAI;6210729584;Ne;8;4;0;12
16448;Vaduvos;KODĖLČIUKAI;4177935331;Ne;0;4;0;4
16449;Vaduvos;KODĖLČIUKAI;9983148737;Ne;0;2;0;2
16450;Vaduvos;KODĖLČIUKAI;6810198013;Ne;0;4;0;4
16451;Vaduvos;KODĖLČIUKAI;4270137614;Ne;6;0;0;6
16452;Vaduvos;KODĖLČIUKAI;5262165284;Ne;2;0;0;2
16453;Vaduvos;KODĖLČIUKAI;8603418399;Ne;10;6;0;16
16454;Vaduvos;KODĖLČIUKAI;3096104197;Ne;21;0;0;21
16455;Vaduvos;KODĖLČIUKAI;9597857664;Ne;9;0;0;9
16456;Vaduvos;KODĖLČIUKAI;1054097622;Ne;5;0;5;10
16457;Vaduvos;KODĖLČIUKAI;6013737546;Ne;0;0;19;19
16458;Vaduvos;KODĖLČIUKAI;6991960029;Ne;0;2;0;2
16459;Vaduvos;KODĖLČIUKAI;4789480822;Ne;0;2;0;2
16460;Vaduvos;SMALSUČIAI;3555513755;Ne;0;11;0;11
16461;Vaduvos;SMALSUČIAI;2184711783;Ne;5;0;0;5
16462;Vaduvos;SMALSUČIAI;7537754249;Ne;0;0;3;3
16463;Vaduvos;SMALSUČIAI;5573145836;Ne;0;3;10;13
16464;Vaduvos;SMALSUČIAI;7337663549;Ne;0;12;0;12
16465;Vaduvos;SMALSUČIAI;5055972872;Ne;1;3;2;6
16466;Vaduvos;SMALSUČIAI;1423148023;Ne;0;10;0;10
16467;Vaduvos;SMALSUČIAI;3091707832;Ne;5;5;0;10
16468;Vaduvos;SMALSUČIAI;87008942241;Ne;0;6;0;6
16469;Vaduvos;SMALSUČIAI;7181151562;Ne;0;4;0;4
16470;Vaduvos;SMALSUČIAI;7431411663;Ne;9;5;0;14
16471;Vaduvos;SMALSUČIAI;2257135127;Ne;7;0;0;7
16472;Vaduvos;SMALSUČIAI;6462126837;Ne;9;0;0;9
16473;Vaduvos;SMALSUČIAI;1265287458;Ne;13;0;0;13
16474;Vaduvos;SMALSUČIAI;1434871968;Ne;5;0;0;5
16475;Vaduvos;SMALSUČIAI;3948025914;Ne;3;0;1;4
16476;Vaduvos;SMALSUČIAI;6253552951;Ne;0;0;2;2
16477;Vaduvos;SMALSUČIAI;7508333714;Ne;0;10;0;10
16478;Vaduvos;SMALSUČIAI;3925021238;Ne;21;0;0;21
16479;Vaduvos;SMALSUČIAI;9384395948;Ne;11;1;0;12
16480;Vaduvos;GILIUKAI;1277811729;Ne;6;2;0;8
16481;Vaduvos;GILIUKAI;1969325922;Ne;5;6;0;11
16482;Vaduvos;GILIUKAI;5376707663;Ne;7;0;0;7
16483;Vaduvos;GILIUKAI;6409466338;Ne;11;0;0;11
16484;Vaduvos;GILIUKAI;2835635250;Ne;9;0;0;9
16485;Vaduvos;GILIUKAI;2939561403;Ne;6;0;0;6
16486;Vaduvos;GILIUKAI;8188374113;Ne;0;1;0;1
16487;Vaduvos;GILIUKAI;6514406042;Ne;11;0;0;11
16488;Vaduvos;GILIUKAI;3057729267;Ne;16;0;0;16
16489;Vaduvos;GILIUKAI;6346625714;Ne;6;0;0;6
16490;Vaduvos;GILIUKAI;8580834401;Ne;7;0;0;7
16491;Vaduvos;GILIUKAI;9167796462;Ne;13;1;0;14
16492;Vaduvos;GILIUKAI;6276149710;Ne;13;0;6;19
16493;Vaduvos;GILIUKAI;6572776966;Ne;11;2;1;14
16494;Vaduvos;GILIUKAI;6676167440;Ne;17;1;0;18
16495;Vaduvos;GILIUKAI;2957685586;Ne;9;9;0;18
16496;Vaduvos;GILIUKAI;3540548094;Ne;6;0;3;9
16497;Vaduvos;GILIUKAI;8964194121;Ne;16;0;0;16
16498;Vaduvos;GILIUKAI;5297217576;Ne;0;4;0;4
16499;Vaduvos;GILIUKAI;5010914832;Ne;5;4;0;9
16500;Vaduvos;GILIUKAI;4030891958;Ne;10;0;0;10
16501;Vaduvos;GILIUKAI;7730737705;Ne;5;0;0;5
16502;Vaduvos;GILIUKAI;2011976336;Ne;0;0;9;9
16503;Vaduvos;BORUŽĖLĖS;2277525837;Ne;6;0;0;6
16504;Vaduvos;BORUŽĖLĖS;6439773886;Ne;12;6;0;18
16505;Vaduvos;BORUŽĖLĖS;5634252033;Ne;0;6;0;6
16506;Vaduvos;BORUŽĖLĖS;6593754016;Ne;5;7;0;12
16507;Vaduvos;BORUŽĖLĖS;7521846747;Ne;13;1;0;14
16508;Vaduvos;BORUŽĖLĖS;1422507884;Ne;0;10;0;10
16509;Vaduvos;BORUŽĖLĖS;3461756429;Ne;0;4;0;4
16510;Vaduvos;BORUŽĖLĖS;8324927031;Ne;0;3;0;3
16511;Vaduvos;BORUŽĖLĖS;4465504676;Ne;5;2;0;7
16512;Vaduvos;BORUŽĖLĖS;7904713344;Ne;9;5;0;14
16513;Vaduvos;BORUŽĖLĖS;2417613291;Ne;12;0;0;12
16514;Vaduvos;BORUŽĖLĖS;5717064754;Ne;9;1;0;10
16515;Vaduvos;BORUŽĖLĖS;8064111922;Ne;19;0;0;19
16516;Vaduvos;BORUŽĖLĖS;3255011809;Ne;12;5;0;17
16517;Vaduvos;BORUŽĖLĖS;8946940285;Ne;9;1;0;10
16518;Vaduvos;BORUŽĖLĖS;9188471756;Ne;0;4;0;4
16519;Vaduvos;BORUŽĖLĖS;7169054113;Ne;5;1;0;6
16520;Vaduvos;BORUŽĖLĖS;2366843609;Ne;0;7;0;7
16521;Vaduvos;BORUŽĖLĖS;1924714755;Ne;3;0;0;3
16522;Vaduvos;DRUGELIAI;4936598927;Ne;10;4;2;16
16523;Vaduvos;DRUGELIAI;2341467486;Ne;9;0;1;10
16524;Vaduvos;DRUGELIAI;5510687497;Ne;9;2;0;11
16525;Vaduvos;DRUGELIAI;9824469881;Ne;9;0;0;9
16526;Vaduvos;DRUGELIAI;5915272436;Ne;10;0;0;10
16527;Vaduvos;DRUGELIAI;4238942070;Ne;15;0;0;15
16528;Vaduvos;DRUGELIAI;1539465611;Ne;10;0;0;10
16529;Vaduvos;DRUGELIAI;8384302877;Ne;1;3;4;8
16530;Vaduvos;DRUGELIAI;6770559352;Ne;10;1;0;11
16531;Vaduvos;DRUGELIAI;4856601924;Ne;13;1;0;14
16532;Vaduvos;DRUGELIAI;3477273224;Ne;0;9;0;9
16533;Vaduvos;DRUGELIAI;2452309232;Ne;8;3;0;11
16534;Vaduvos;DRUGELIAI;6776150749;Ne;0;6;0;6
16535;Vaduvos;DRUGELIAI;9333495119;Ne;14;3;0;17
16536;Vaduvos;DRUGELIAI;7597268115;Ne;10;0;0;10
16537;Vaduvos;DRUGELIAI;8400344609;Ne;10;0;1;11
16538;Vaduvos;DRUGELIAI;2789503381;Ne;7;2;0;9
16539;Vaduvos;DRUGELIAI;1987969267;Ne;16;0;0;16
16540;Vaduvos;DRUGELIAI;8990472878;Ne;10;0;5;15
16541;Vaduvos;DRUGELIAI;2717887489;Ne;6;0;1;7
16542;Vaduvos;DRUGELIAI;5881009426;Ne;7;0;0;7
16543;Vaduvos;RIEŠUTĖLIAI;6611531526;Ne;10;0;2;12
16544;Vaduvos;RIEŠUTĖLIAI;1466282653;Ne;5;0;0;5
16545;Vaduvos;RIEŠUTĖLIAI;3206096414;Ne;0;16;4;20
16546;Vaduvos;RIEŠUTĖLIAI;8055108164;Ne;6;2;0;8
16547;Vaduvos;RIEŠUTĖLIAI;5509202519;Ne;2;0;0;2
16548;Vaduvos;RIEŠUTĖLIAI;3855900628;Ne;4;0;1;5
16549;Vaduvos;RIEŠUTĖLIAI;4576510280;Ne;12;0;5;17
16550;Vaduvos;RIEŠUTĖLIAI;5775152939;Ne;7;0;1;8
16551;Vaduvos;RIEŠUTĖLIAI;3060409258;Ne;8;6;0;14
16552;Vaduvos;RIEŠUTĖLIAI;8070494719;Ne;0;0;10;10
16553;Vaduvos;RIEŠUTĖLIAI;9232960362;Ne;14;0;0;14
16554;Vaduvos;RIEŠUTĖLIAI;7425991335;Ne;6;0;4;10
16555;Vaduvos;RIEŠUTĖLIAI;7592658267;Ne;0;0;11;11
16556;Vaduvos;RIEŠUTĖLIAI;8533315132;Ne;17;1;0;18
16557;Vaduvos;RIEŠUTĖLIAI;2508650990;Ne;13;0;1;14
16558;Vaduvos;RIEŠUTĖLIAI;6943057114;Ne;6;0;0;6
16559;Vaduvos;RIEŠUTĖLIAI;8669267296;Ne;0;5;0;5
16560;Vaduvos;RIEŠUTĖLIAI;1736248725;Ne;11;7;0;18
16561;Vaduvos;"1 klasė";3174998523;Ne;0;4;0;4
16562;Vaduvos;"1 klasė";1825188497;Ne;0;4;0;4
16563;Vaduvos;"1 klasė";3722349868;Ne;0;4;0;4
16564;Vaduvos;"1 klasė";13888236429;Ne;0;6;0;6
16565;Vaduvos;"1 klasė";5307128703;Ne;0;4;0;4
16566;Vaduvos;"1 klasė";6128582180;Ne;0;4;0;4
16567;Vaduvos;"1 klasė";62183976729;Ne;0;4;0;4
16568;Vaduvos;"1 klasė";93702732546;Ne;0;6;0;6
16569;Vaduvos;"1 klasė";15757662594;Ne;0;4;0;4
16570;Vaduvos;"1 klasė";41870343319;Ne;0;4;0;4
16571;Vaduvos;"1 klasė";4513707989;Ne;0;11;0;11
16572;Vaduvos;"1 klasė";68937983441;Ne;0;4;0;4
16573;Vaduvos;"1 klasė";59616893535;Ne;0;4;0;4
16574;Vaduvos;"1 klasė";22641388717;Ne;0;4;0;4
16575;Vaduvos;"1 klasė";21499108813;Ne;0;4;0;4
16576;Vaduvos;"1 klasė";79437154441;Ne;0;4;0;4
16577;Vaduvos;"1 klasė";46608435244;Ne;0;4;0;4
16578;Vaduvos;"1 klasė";61046090149;Ne;0;4;0;4
16579;Vaduvos;"1 klasė";56280470781;Ne;0;4;0;4
16580;Vaduvos;"1 klasė";11202010413;Ne;0;4;0;4
16581;Vaduvos;"1 klasė";1370696345;Ne;0;6;0;6
16582;Vaduvos;"1 klasė";4342471835;Ne;0;4;0;4
16583;Vaduvos;"1 klasė";9112649520;Ne;0;14;0;14
16584;Vaduvos;"1 klasė";1599595256;Ne;0;9;0;9
16585;Vaduvos;"1 klasė";5435336235;Ne;0;4;0;4
16586;Vaduvos;"1 klasė";1681367373;Ne;0;4;0;4
16587;Vaduvos;"3 klasė";97423576166;Ne;0;4;0;4
16588;Vaduvos;"3 klasė";38504924027;Ne;0;5;0;5
16589;Vaduvos;"3 klasė";96148085691;Ne;0;5;0;5
16590;Vaduvos;"3 klasė";12330772986;Ne;0;6;0;6
16591;Vaduvos;"3 klasė";33277362439;Ne;0;7;0;7
16592;Vaduvos;"3 klasė";32138087379;Ne;0;21;0;21
16593;Vaduvos;"3 klasė";67324784528;Ne;0;4;0;4
16594;Vaduvos;"3 klasė";4807104855;Ne;0;7;0;7
16595;Vaduvos;"3 klasė";2181614424;Ne;0;4;0;4
16596;Vaduvos;"3 klasė";2019573643;Ne;0;5;0;5
16597;Vaduvos;"3 klasė";27419094487;Ne;0;4;0;4
16598;Vaduvos;"3 klasė";89793734700;Ne;0;6;0;6
16599;Vaduvos;"3 klasė";17473821556;Ne;0;21;0;21
16600;Vaduvos;"3 klasė";53866301875;Ne;0;21;0;21
16601;Vaduvos;"3 klasė";7786986697;Ne;0;4;0;4
16602;Vaduvos;"3 klasė";9147332638;Ne;0;4;0;4
16603;Vaduvos;"3 klasė";1532675814;Ne;0;5;0;5
16604;Vaduvos;"3 klasė";98259624669;Ne;0;4;0;4
16605;Vaduvos;"3 klasė";36931517006;Ne;0;5;0;5
16606;Vaduvos;"3 klasė";61243424057;Ne;0;5;0;5
16607;Vaduvos;"3 klasė";30979103892;Ne;0;5;0;5
16608;Vaduvos;"3 klasė";78245732319;Ne;0;4;0;4
16609;Vaduvos;"3 klasė";48433447683;Ne;0;4;0;4
16610;Vaduvos;"3 klasė";85090873161;Ne;0;21;0;21
16611;Vaduvos;"3 klasė";41272273463;Ne;0;7;0;7
16612;Vaduvos;"4 klasė";96473212525;Ne;0;7;0;7
16613;Vaduvos;"4 klasė";75428164558;Ne;0;4;0;4
16614;Vaduvos;"4 klasė";63286903462;Ne;0;4;0;4
16615;Vaduvos;"4 klasė";13721939854;Ne;0;4;0;4
16616;Vaduvos;"4 klasė";1171210935;Ne;0;4;0;4
16617;Vaduvos;"4 klasė";7172286009;Ne;0;4;0;4
16618;Vaduvos;"4 klasė";6049882391;Ne;0;21;0;21
16619;Vaduvos;"4 klasė";38013859931;Ne;0;8;0;8
16620;Vaduvos;"4 klasė";4591744662;Ne;0;4;0;4
16621;Vaduvos;"4 klasė";9149523910;Ne;0;4;0;4
16622;Vaduvos;"4 klasė";76662161382;Ne;0;4;0;4
16623;Vaduvos;"4 klasė";26934740147;Ne;0;10;0;10
16624;Vaduvos;"4 klasė";18300713872;Ne;0;21;0;21
16625;Vaduvos;"4 klasė";768455288;Ne;0;5;0;5
16626;Vaduvos;"4 klasė";1768173501;Ne;0;6;0;6
16627;Vaduvos;"4 klasė";60531886576;Ne;0;5;0;5
16628;Vaduvos;"4 klasė";38462664426;Ne;0;7;0;7
16629;Vaduvos;"4 klasė";1821644443;Ne;0;4;0;4
16630;Vaduvos;"2 B klasė";95104294893;Ne;0;5;0;5
16631;Vaduvos;"2 B klasė";40872193458;Ne;0;13;0;13
16632;Vaduvos;"2 B klasė";6500567162;Ne;0;12;0;12
16633;Vaduvos;"2 B klasė";78931952732;Ne;0;4;0;4
16634;Vaduvos;"2 B klasė";1241148402;Ne;0;7;0;7
16635;Vaduvos;"2 B klasė";66359913774;Ne;0;6;0;6
16636;Vaduvos;"2 B klasė";24887196729;Ne;0;6;0;6
16637;Vaduvos;"2 B klasė";39687066893;Ne;0;4;0;4
16638;Vaduvos;"2 B klasė";64074141491;Ne;6;4;0;10
16639;Vaduvos;"2 B klasė";93924290247;Ne;0;4;0;4
16640;Vaduvos;"2 B klasė";47465933557;Ne;0;4;0;4
16641;Vaduvos;"2 B klasė";62521006557;Ne;0;4;0;4
16642;Vaduvos;"2 B klasė";16882774330;Ne;0;5;0;5
16643;Vaduvos;"2 B klasė";3259114583;Ne;0;7;0;7
16644;Vaduvos;"2 B klasė";87671358423;Ne;0;21;0;21
16645;Vaduvos;"2 B klasė";55138588393;Ne;0;4;0;4
16646;Vaduvos;"2 B klasė";3310156076;Ne;0;21;0;21
16647;Vaduvos;"2 B klasė";8782782031;Ne;0;6;0;6
16648;Vaduvos;"2 A klasė";6279678482;Ne;0;6;0;6
16649;Vaduvos;"2 A klasė";96892752634;Ne;0;4;0;4
16650;Vaduvos;"2 A klasė";61243200177;Ne;0;4;0;4
16651;Vaduvos;"2 A klasė";62703428759;Ne;0;4;0;4
16652;Vaduvos;"2 A klasė";68420568339;Ne;0;5;0;5
16653;Vaduvos;"2 A klasė";49738318631;Ne;0;6;0;6
16654;Vaduvos;"2 A klasė";65647119496;Ne;0;4;0;4
16655;Vaduvos;"2 A klasė";19390879176;Ne;0;5;0;5
16656;Vaduvos;"2 A klasė";6155494370;Ne;0;5;0;5
16657;Vaduvos;"2 A klasė";1139509471;Ne;0;21;0;21
16658;Vaduvos;"2 A klasė";70693742936;Ne;0;5;0;5
16659;Vaduvos;"2 A klasė";1010061503;Ne;0;13;0;13
16660;Vaduvos;"2 A klasė";1107557891;Ne;0;21;0;21
16661;Vaduvos;"2 A klasė";8802765960;Ne;0;7;0;7
16662;Vaduvos;"2 A klasė";3172047211;Ne;0;4;0;4
16663;Vilkpėdės;BORUŽĖLĖS;8002436634;Taip;0;0;4;4
16664;Vilkpėdės;BORUŽĖLĖS;1249504082;Ne;10;0;1;11
16665;Vilkpėdės;BORUŽĖLĖS;4052026470;Ne;10;0;4;14
16666;Vilkpėdės;BORUŽĖLĖS;4726171678;Ne;2;0;0;2
16667;Vilkpėdės;BORUŽĖLĖS;3991785883;Ne;6;0;3;9
16668;Vilkpėdės;BORUŽĖLĖS;9334610111;Ne;4;0;3;7
16669;Vilkpėdės;BORUŽĖLĖS;7992484314;Ne;13;0;2;15
16670;Vilkpėdės;BORUŽĖLĖS;5050493757;Ne;0;6;3;9
16671;Vilkpėdės;BORUŽĖLĖS;8217972925;Ne;3;1;0;4
16672;Vilkpėdės;BORUŽĖLĖS;2232913117;Ne;14;0;0;14
16673;Vilkpėdės;BORUŽĖLĖS;7805866055;Ne;0;5;0;5
16674;Vilkpėdės;BORUŽĖLĖS;3994451071;Ne;8;0;12;20
16675;Vilkpėdės;BORUŽĖLĖS;2529188623;Ne;0;5;2;7
16676;Vilkpėdės;BORUŽĖLĖS;5569182344;Ne;2;0;0;2
16677;Vilkpėdės;BORUŽĖLĖS;5677284428;Ne;0;0;1;1
16678;Vilkpėdės;SKRUZDĖLIUKAI;4018140154;Ne;5;0;3;8
16679;Vilkpėdės;SKRUZDĖLIUKAI;2419661008;Ne;6;0;4;10
16680;Vilkpėdės;SKRUZDĖLIUKAI;7114183123;Ne;0;5;1;6
16681;Vilkpėdės;SKRUZDĖLIUKAI;8804335248;Ne;18;0;0;18
16682;Vilkpėdės;SKRUZDĖLIUKAI;2525399410;Ne;0;0;8;8
16683;Vilkpėdės;SKRUZDĖLIUKAI;5812430367;Ne;5;0;0;5
16684;Vilkpėdės;SKRUZDĖLIUKAI;1478022307;Ne;0;4;0;4
16685;Vilkpėdės;SKRUZDĖLIUKAI;2205143759;Ne;5;0;2;7
16686;Vilkpėdės;SKRUZDĖLIUKAI;2418313731;Ne;0;0;5;5
16687;Vilkpėdės;SKRUZDĖLIUKAI;1342167313;Ne;11;0;3;14
16688;Vilkpėdės;SKRUZDĖLIUKAI;5334238235;Ne;5;5;0;10
16689;Vilkpėdės;SKRUZDĖLIUKAI;2703704892;Ne;0;0;1;1
16690;Vilkpėdės;SKRUZDĖLIUKAI;8385974099;Ne;0;0;5;5
16691;Vilkpėdės;SKRUZDĖLIUKAI;6671311193;Ne;0;5;0;5
16692;Vilkpėdės;SKRUZDĖLIUKAI;1985540746;Ne;0;0;5;5
16693;Vilkpėdės;DRUGELIAI;1040357501;Ne;2;2;0;4
16694;Vilkpėdės;DRUGELIAI;6876470245;Ne;2;2;0;4
16695;Vilkpėdės;DRUGELIAI;8431620518;Ne;5;0;0;5
16696;Vilkpėdės;DRUGELIAI;1655396296;Ne;13;0;0;13
16697;Vilkpėdės;DRUGELIAI;9501254301;Ne;1;5;0;6
16698;Vilkpėdės;DRUGELIAI;4998396593;Ne;0;11;0;11
16699;Vilkpėdės;DRUGELIAI;6819447340;Ne;16;0;0;16
16700;Vilkpėdės;DRUGELIAI;9797550851;Ne;13;0;0;13
16701;Vilkpėdės;DRUGELIAI;2379571797;Ne;5;0;0;5
16702;Vilkpėdės;DRUGELIAI;2358685682;Ne;20;0;0;20
16703;Vilkpėdės;DRUGELIAI;7489143683;Ne;0;4;2;6
16704;Vilkpėdės;ŽIOGELIAI;5551822633;Ne;9;1;0;10
16705;Vilkpėdės;ŽIOGELIAI;9544418642;Ne;0;5;0;5
16706;Vilkpėdės;ŽIOGELIAI;3666145718;Ne;0;7;0;7
16707;Vilkpėdės;ŽIOGELIAI;5633014328;Ne;3;0;0;3
16708;Vilkpėdės;ŽIOGELIAI;5422061533;Ne;12;0;0;12
16709;Vilkpėdės;ŽIOGELIAI;4311938034;Ne;1;0;0;1
16710;Vilkpėdės;ŽIOGELIAI;5346798201;Ne;0;6;0;6
16711;Vilkpėdės;ŽIOGELIAI;3720639726;Ne;0;1;0;1
16712;Vilkpėdės;ŽIOGELIAI;1609823694;Ne;0;0;6;6
16713;Vilkpėdės;ŽIOGELIAI;7634076203;Ne;1;0;0;1
16714;Vilkpėdės;ŽIOGELIAI;6690742997;Ne;7;0;0;7
16715;Vilkpėdės;ŽIOGELIAI;3350784810;Ne;4;4;0;8
16716;Vilkpėdės;ŽIOGELIAI;1655985778;Ne;15;0;0;15
16717;Vilkpėdės;ŽIOGELIAI;3664125930;Ne;17;0;0;17
16718;Vilkpėdės;ŽIOGELIAI;3737265597;Ne;6;0;0;6
16719;Vilkpėdės;ŽIOGELIAI;2241104719;Ne;1;4;1;6
16720;Vilkpėdės;ŽIOGELIAI;8423972962;Ne;0;4;0;4
16721;Vilkpėdės;ŽIOGELIAI;1537270256;Ne;0;0;5;5
16722;Vilkpėdės;ŽIOGELIAI;3229559339;Ne;0;0;5;5
16723;Vilkpėdės;ŽIOGELIAI;8783790519;Ne;0;5;2;7
16724;Vilkpėdės;BITUTĖS;6418829930;Ne;2;6;0;8
16725;Vilkpėdės;BITUTĖS;1633942236;Ne;0;1;0;1
16726;Vilkpėdės;BITUTĖS;8484873068;Ne;3;0;0;3
16727;Vilkpėdės;BITUTĖS;2503128176;Ne;8;0;0;8
16728;Vilkpėdės;BITUTĖS;9570469277;Taip;0;3;0;3
16729;Vilkpėdės;BITUTĖS;5420512675;Ne;10;0;0;10
16730;Vilkpėdės;BITUTĖS;8613778606;Ne;8;1;0;9
16731;Vilkpėdės;BITUTĖS;7991758361;Ne;0;4;0;4
16732;Vilkpėdės;BITUTĖS;8930504912;Ne;6;0;0;6
16733;Vilkpėdės;BITUTĖS;3303872633;Ne;2;4;0;6
16734;Vilkpėdės;BITUTĖS;5972405023;Ne;14;0;0;14
16735;Vilkpėdės;BITUTĖS;4485811377;Ne;0;2;0;2
16736;Vilkpėdės;BITUTĖS;5274855225;Ne;14;0;0;14
16737;Vilkpėdės;BITUTĖS;8860791478;Ne;2;2;0;4
16738;Vilkpėdės;BITUTĖS;7829343719;Ne;15;0;0;15
16739;Vilkpėdės;"4 klasė";14499651046;Ne;0;4;0;4
16740;Vilkpėdės;"4 klasė";90217345315;Ne;0;4;0;4
16741;Vilkpėdės;"4 klasė";51286525404;Ne;0;4;0;4
16742;Vilkpėdės;"4 klasė";49513181091;Ne;4;4;0;8
16743;Vilkpėdės;"4 klasė";37450374921;Ne;0;4;0;4
16744;Vilkpėdės;"4 klasė";36704555745;Ne;0;4;0;4
16745;Vilkpėdės;"4 klasė";1024429836;Ne;1;4;0;5
16746;Vilkpėdės;"4 klasė";66356984763;Ne;5;13;0;18
16747;Vilkpėdės;"4 klasė";88279045901;Ne;1;6;0;7
16748;Vilkpėdės;"4 klasė";66451097025;Ne;2;4;0;6
16749;Vilkpėdės;"4 klasė";2806307083;Ne;0;10;0;10
16750;Vilkpėdės;"4 klasė";51799865091;Ne;0;4;0;4
16751;Vilkpėdės;"4 klasė";79269485254;Ne;1;4;0;5
16752;Vilkpėdės;"4 klasė";61833757576;Ne;0;6;0;6
16753;Vilkpėdės;"4 klasė";64216245300;Ne;0;4;0;4
16754;Vilkpėdės;GUDRUČIAI;1527272055;Ne;0;4;0;4
16755;Vilkpėdės;GUDRUČIAI;1451102218;Ne;7;4;0;11
16756;Vilkpėdės;GUDRUČIAI;2065010940;Ne;8;0;0;8
16757;Vilkpėdės;GUDRUČIAI;2181146968;Ne;0;4;2;6
16758;Vilkpėdės;GUDRUČIAI;4515945951;Ne;0;0;3;3
16759;Vilkpėdės;GUDRUČIAI;2736368118;Ne;1;2;2;5
16760;Vilkpėdės;GUDRUČIAI;7527929277;Ne;4;1;2;7
16761;Vilkpėdės;GUDRUČIAI;46561435465;Ne;0;4;0;4
16762;Vilkpėdės;GUDRUČIAI;48059844727;Ne;0;4;0;4
16763;Vilkpėdės;GUDRUČIAI;8865545376;Ne;0;4;0;4
16764;Vilkpėdės;GUDRUČIAI;4735164204;Ne;20;0;0;20
16765;Vilkpėdės;GUDRUČIAI;7889480219;Ne;0;1;0;1
16766;Vilkpėdės;GUDRUČIAI;9867411687;Ne;2;7;0;9
16767;Vilkpėdės;GUDRUČIAI;7875898177;Ne;0;7;0;7
16768;Vilkpėdės;GUDRUČIAI;1195392132;Ne;0;1;0;1
16769;Vilkpėdės;GUDRUČIAI;9605399822;Ne;0;6;0;6
16770;Vilkpėdės;GUDRUČIAI;4276158771;Ne;5;5;0;10
16771;Vilkpėdės;GUDRUČIAI;2604179994;Ne;9;0;0;9
16772;Vilkpėdės;GUDRUČIAI;3696611509;Ne;4;1;2;7
16773;Vilkpėdės;SMALSUČIAI;4095366279;Ne;0;2;0;2
16774;Vilkpėdės;SMALSUČIAI;5048931309;Ne;0;4;0;4
16775;Vilkpėdės;SMALSUČIAI;7698759895;Ne;3;5;0;8
16776;Vilkpėdės;SMALSUČIAI;1019057127;Ne;0;4;0;4
16777;Vilkpėdės;SMALSUČIAI;1217929358;Ne;0;6;0;6
16778;Vilkpėdės;SMALSUČIAI;1807884737;Ne;15;0;0;15
16779;Vilkpėdės;SMALSUČIAI;2251274741;Ne;9;0;0;9
16780;Vilkpėdės;SMALSUČIAI;9460356725;Ne;10;6;0;16
16781;Vilkpėdės;SMALSUČIAI;8128254701;Ne;0;4;0;4
16782;Vilkpėdės;SMALSUČIAI;8015392054;Ne;0;2;0;2
16783;Vilkpėdės;SMALSUČIAI;2320350937;Ne;0;4;0;4
16784;Vilkpėdės;SMALSUČIAI;7894766629;Ne;0;1;0;1
16785;Vilkpėdės;SMALSUČIAI;3987021185;Ne;0;2;0;2
16786;Vilkpėdės;SMALSUČIAI;7010024061;Ne;0;9;0;9
16787;Vilkpėdės;SMALSUČIAI;6522707709;Ne;0;4;0;4
16788;Vilkpėdės;SMALSUČIAI;2420271759;Ne;5;11;0;16
16789;Vilkpėdės;KODĖLČIUKŲ;9605430333;Ne;0;14;0;14
16790;Vilkpėdės;KODĖLČIUKŲ;7745776486;Ne;2;0;0;2
16791;Vilkpėdės;KODĖLČIUKŲ;8969001990;Ne;10;0;0;10
16792;Vilkpėdės;KODĖLČIUKŲ;7158737372;Ne;2;7;0;9
16793;Vilkpėdės;KODĖLČIUKŲ;3785308006;Ne;13;0;0;13
16794;Vilkpėdės;KODĖLČIUKŲ;6744834487;Ne;0;2;0;2
16795;Vilkpėdės;KODĖLČIUKŲ;4166416292;Ne;5;4;0;9
16796;Vilkpėdės;KODĖLČIUKŲ;3888880306;Ne;0;8;0;8
16797;Vilkpėdės;KODĖLČIUKŲ;9601934563;Ne;0;4;0;4
16798;Vilkpėdės;KODĖLČIUKŲ;7401886306;Ne;1;3;0;4
16799;Vilkpėdės;KODĖLČIUKŲ;1528619779;Ne;1;0;0;1
16800;Vilkpėdės;KODĖLČIUKŲ;2359315281;Ne;10;2;0;12
16801;Vilkpėdės;KODĖLČIUKŲ;1571869318;Ne;0;3;0;3
16802;Vilkpėdės;KODĖLČIUKŲ;6820236577;Ne;2;0;0;2
16803;Vilkpėdės;KODĖLČIUKŲ;4255757333;Ne;4;0;0;4
16804;Vilkpėdės;KODĖLČIUKŲ;1063561954;Ne;3;3;0;6
16805;Vilkpėdės;KODĖLČIUKŲ;5053032081;Ne;4;0;0;4
16806;Vilkpėdės;KODĖLČIUKŲ;6778288398;Ne;2;2;0;4
16807;Vilkpėdės;KODĖLČIUKŲ;7284081203;Ne;7;0;0;7
16808;Žiburėlis;Nykštukai;7163594513;Ne;3;4;2;9
16809;Žiburėlis;Nykštukai;5174211773;Ne;5;0;0;5
16810;Žiburėlis;Nykštukai;5408766721;Ne;7;1;0;8
16811;Žiburėlis;Nykštukai;3646988912;Ne;0;4;0;4
16812;Žiburėlis;Nykštukai;7211961512;Ne;0;2;0;2
16813;Žiburėlis;Nykštukai;7862546963;Ne;0;1;0;1
16814;Žiburėlis;Nykštukai;8902837168;Ne;0;1;0;1
16815;Žiburėlis;Nykštukai;7465939429;Ne;10;1;0;11
16816;Žiburėlis;Nykštukai;8215816053;Ne;0;1;1;2
16817;Žiburėlis;Nykštukai;7633450988;Ne;0;2;0;2
16818;Žiburėlis;Nykštukai;2292895729;Ne;6;2;0;8
16819;Žiburėlis;Nykštukai;9806454408;Ne;0;15;0;15
16820;Žiburėlis;Nykštukai;1764592065;Ne;0;3;0;3
16821;Žiburėlis;Nykštukai;9932264675;Ne;0;0;6;6
16822;Žiburėlis;Nykštukai;8480167191;Ne;0;17;0;17
16823;Žiburėlis;Nykštukai;1559091567;Ne;0;1;0;1
16824;Žiburėlis;Nykštukai;3750024153;Ne;0;1;0;1
16825;Žiburėlis;"Žiniukai ";5816890413;Ne;0;6;0;6
16826;Žiburėlis;"Žiniukai ";2928528630;Ne;5;0;0;5
16827;Žiburėlis;"Žiniukai ";2624326930;Ne;19;0;0;19
16828;Žiburėlis;"Žiniukai ";6300247811;Ne;5;3;0;8
16829;Žiburėlis;"Žiniukai ";3033049328;Ne;5;5;0;10
16830;Žiburėlis;"Žiniukai ";3262856058;Ne;5;1;0;6
16831;Žiburėlis;"Žiniukai ";1720078356;Ne;6;4;0;10
16832;Žiburėlis;"Žiniukai ";7424129974;Ne;2;0;0;2
16833;Žiburėlis;"Žiniukai ";4187381976;Ne;11;4;0;15
16834;Žiburėlis;"Žiniukai ";5006361324;Ne;2;0;0;2
16835;Žiburėlis;"Žiniukai ";2956339420;Ne;10;4;0;14
16836;Žiburėlis;"Žiniukai ";7070952018;Ne;5;5;0;10
16837;Žiburėlis;"Žiniukai ";8438876806;Ne;0;8;0;8
16838;Žiburėlis;"Žiniukai ";3687703187;Ne;0;5;0;5
16839;Žiburėlis;"Žiniukai ";1543314096;Ne;9;1;0;10
16840;Žiburėlis;"Žiniukai ";1061646244;Ne;5;2;0;7
16841;Žiburėlis;"Žiniukai ";2741301903;Ne;13;3;0;16
16842;Žiburėlis;"Smalsiukai ";5438697081;Taip;0;2;0;2
16843;Žiburėlis;"Smalsiukai ";1126972447;Ne;16;0;0;16
16844;Žiburėlis;"Smalsiukai ";5114554577;Ne;0;5;0;5
16845;Žiburėlis;"Smalsiukai ";3936418539;Ne;5;0;0;5
16846;Žiburėlis;"Smalsiukai ";2072972990;Ne;6;2;0;8
16847;Žiburėlis;"Smalsiukai ";3835820013;Ne;0;1;0;1
16848;Žiburėlis;"Smalsiukai ";67168630669;Ne;6;4;0;10
16849;Žiburėlis;"Smalsiukai ";7578655857;Ne;0;4;0;4
16850;Žiburėlis;"Smalsiukai ";9253393819;Ne;5;5;0;10
16851;Žiburėlis;"Smalsiukai ";1599112927;Ne;10;6;0;16
16852;Žiburėlis;"Smalsiukai ";2796489509;Ne;0;2;0;2
16853;Žiburėlis;"Smalsiukai ";18739941845;Ne;0;5;0;5
16854;Žiburėlis;"Smalsiukai ";24639355056;Ne;0;7;0;7
16855;Žiburėlis;"Smalsiukai ";6519139977;Ne;0;21;0;21
16856;Žiburėlis;"Smalsiukai ";7861704875;Ne;0;9;0;9
16857;Žiburėlis;"Smalsiukai ";34873231652;Ne;0;8;0;8
16858;Žiburėlis;"Smalsiukai ";2175751377;Ne;0;7;0;7
16859;Žiburėlis;"Smalsiukai ";28985997205;Ne;0;12;0;12
16860;Žiburėlis;"Giliukai ";1090883494;Taip;9;2;0;11
16861;Žiburėlis;"Giliukai ";9215654134;Ne;2;5;0;7
16862;Žiburėlis;"Giliukai ";2866098551;Ne;12;0;0;12
16863;Žiburėlis;"Giliukai ";6918525245;Ne;0;4;0;4
16864;Žiburėlis;"Giliukai ";6946621147;Ne;8;5;0;13
16865;Žiburėlis;"Giliukai ";5148264064;Taip;9;5;0;14
16866;Žiburėlis;"Giliukai ";6733333096;Ne;12;5;0;17
16867;Žiburėlis;"Giliukai ";1943162133;Ne;6;0;0;6
16868;Žiburėlis;"Giliukai ";3807588865;Ne;14;0;0;14
16869;Žiburėlis;"Giliukai ";4091901597;Ne;5;0;0;5
16870;Žiburėlis;"Giliukai ";4016969144;Ne;5;1;0;6
16871;Žiburėlis;"Giliukai ";3776569251;Ne;5;0;0;5
16872;Žiburėlis;"Giliukai ";9494271740;Ne;1;5;0;6
16873;Žiburėlis;"Giliukai ";3992503848;Ne;11;4;0;15
16874;Žiburėlis;"Giliukai ";8440073413;Ne;5;5;0;10
16875;Žiburėlis;"Giliukai ";6121237159;Ne;5;5;0;10
16876;Žiburėlis;"Giliukai ";6289338466;Ne;13;1;0;14
16877;Žiburėlis;"Giliukai ";7977098545;Ne;15;0;0;15
16878;Žiburėlis;"Giliukai ";2990465012;Ne;8;0;0;8
16879;Žiburėlis;"Giliukai ";8697451319;Ne;0;1;0;1
16880;Žiburėlis;"1 klasė";5778346952;Ne;3;0;0;3
16881;Žiburėlis;"1 klasė";67896676967;Ne;5;0;0;5
16882;Žiburėlis;Meškiukai;3593851196;Ne;6;0;0;6
16883;Žiburėlis;Meškiukai;9470154520;Ne;15;0;0;15
16884;Žiburėlis;Meškiukai;2186032732;Ne;0;1;0;1
16885;Žiburėlis;Meškiukai;9321467329;Ne;0;1;0;1
16886;Žiburėlis;Meškiukai;2254407798;Ne;11;0;0;11
16887;Žiburėlis;Meškiukai;4887304311;Ne;2;0;0;2
16888;Žiburėlis;Meškiukai;1105220246;Ne;4;1;0;5
16889;Žiburėlis;Meškiukai;8415647388;Ne;0;4;0;4
16890;Žiburėlis;Meškiukai;6218255066;Ne;10;0;0;10
16891;Žiburėlis;Meškiukai;3522480911;Taip;7;1;0;8
16892;Žiburėlis;Meškiukai;5683969627;Ne;5;0;1;6
16893;Žiburėlis;Viščiukai;5115160061;Taip;21;0;0;21
16894;Žiburėlis;Viščiukai;7485768254;Taip;21;0;0;21
16895;Žiburėlis;Viščiukai;7364102991;Ne;9;0;0;9
16896;Žiburėlis;Viščiukai;8179414341;Ne;8;0;1;9
16897;Žiburėlis;Viščiukai;7140031765;Taip;0;2;0;2
16898;Žiburėlis;Viščiukai;1758251348;Ne;7;0;0;7
16899;Žiburėlis;Viščiukai;3323538690;Ne;16;2;0;18
16900;Žiburėlis;Viščiukai;1121755119;Ne;3;0;0;3
16901;Žiburėlis;Viščiukai;3738184802;Ne;6;1;0;7
16902;Žiburėlis;Viščiukai;8603154782;Ne;9;0;0;9
16903;Žiburėlis;Viščiukai;5213049603;Ne;14;0;0;14
16904;Žiburėlis;Viščiukai;4727673956;Ne;4;2;0;6
16905;Žiburėlis;Viščiukai;1606332622;Ne;18;0;0;18
16906;Žiburėlis;Viščiukai;8284913889;Ne;12;0;0;12
16907;Žiburėlis;Viščiukai;2851350451;Ne;18;0;0;18
16908;Žiburėlis;Viščiukai;6206770019;Ne;4;3;0;7
16909;Žiburėlis;Viščiukai;5314676261;Ne;14;0;0;14
16910;Žiburėlis;"Drambliukai ";5724506894;Ne;0;1;0;1
16911;Žiburėlis;"Drambliukai ";2102574423;Ne;5;0;0;5
16912;Žiburėlis;"Drambliukai ";4937518207;Ne;0;5;0;5
16913;Žiburėlis;"Drambliukai ";9041469393;Taip;15;0;0;15
16914;Žiburėlis;"Drambliukai ";8285987095;Ne;16;3;0;19
16915;Žiburėlis;"Drambliukai ";2805244671;Taip;2;6;0;8
16916;Žiburėlis;"Drambliukai ";5025452484;Taip;6;3;0;9
16917;Žiburėlis;"Drambliukai ";9344950711;Ne;12;4;0;16
16918;Žiburėlis;"Drambliukai ";8082088504;Taip;14;0;0;14
16919;Žiburėlis;"Drambliukai ";4656467260;Ne;5;0;0;5
16920;Žiburėlis;"Drambliukai ";9771442035;Ne;5;6;0;11
16921;Žiburėlis;"Drambliukai ";6274583813;Ne;4;0;0;4
16922;Žiburėlis;"Drambliukai ";5194593598;Ne;21;10;0;31
16923;Žiburėlis;"Drambliukai ";8752098051;Ne;0;5;0;5
16924;Žiburėlis;"Drambliukai ";8207315673;Taip;5;2;0;7
16925;Žiburėlis;"Drambliukai ";6751043071;Ne;18;0;0;18
16926;Žiburėlis;"Drambliukai ";1449541244;Ne;14;5;0;19
16927;Žiburėlis;"2 klasė";19924188057;Ne;1;0;0;1
16928;Žiburėlis;BORUŽIUKAI;3723613593;Ne;3;1;0;4
16929;Žiburėlis;BORUŽIUKAI;7895148630;Ne;21;0;0;21
16930;Žiburėlis;BORUŽIUKAI;8936912406;Ne;5;2;0;7
16931;Žiburėlis;BORUŽIUKAI;4631232618;Ne;18;0;0;18
16932;Žiburėlis;BORUŽIUKAI;5793531526;Ne;1;5;0;6
16933;Žiburėlis;BORUŽIUKAI;6128571259;Ne;0;0;1;1
16934;Žiburėlis;BORUŽIUKAI;3760039280;Ne;0;2;2;4
16935;Žiburėlis;BORUŽIUKAI;5799439634;Ne;5;1;0;6
16936;Žiburėlis;BORUŽIUKAI;4229040996;Ne;0;2;0;2
16937;Žiburėlis;BORUŽIUKAI;8373944614;Ne;19;0;0;19
16938;Žiburėlis;BORUŽIUKAI;9256751455;Ne;4;0;0;4
16939;Žiburėlis;BORUŽIUKAI;2077823704;Ne;0;4;0;4
16940;Žiburėlis;BORUŽIUKAI;9357376188;Ne;0;4;0;4
16941;Žiburėlis;BORUŽIUKAI;4233222771;Ne;0;1;0;1
16942;Žiburėlis;BORUŽIUKAI;9029039015;Ne;0;1;2;3
16943;Žiburėlis;BORUŽIUKAI;7017574924;Ne;0;3;0;3
16944;Žiburėlis;BORUŽIUKAI;1661456806;Ne;5;0;0;5
16945;Žiburėlis;BORUŽIUKAI;2527837980;Ne;9;6;10;25
16946;Žiburėlis;BORUŽIUKAI;5828514911;Ne;6;0;0;6
16947;Žiburėlis;SPINDULIUKAI;5002691930;Ne;0;2;0;2
16948;Žiburėlis;SPINDULIUKAI;2995697464;Ne;7;0;0;7
16949;Žiburėlis;SPINDULIUKAI;7856708616;Ne;0;2;2;4
16950;Žiburėlis;SPINDULIUKAI;5205959106;Ne;5;1;0;6
16951;Žiburėlis;SPINDULIUKAI;2491972986;Ne;0;8;0;8
16952;Žiburėlis;SPINDULIUKAI;1190058462;Ne;0;2;3;5
16953;Žiburėlis;SPINDULIUKAI;8970153523;Ne;0;2;0;2
16954;Žiburėlis;SPINDULIUKAI;7402647048;Ne;0;2;5;7
16955;Žiburėlis;SPINDULIUKAI;5951659866;Ne;0;1;0;1
16956;Žiburėlis;SPINDULIUKAI;1775465307;Ne;0;4;0;4
16957;Žiburėlis;SPINDULIUKAI;8973307069;Ne;0;1;0;1
16958;Žiburėlis;SPINDULIUKAI;5098955523;Ne;0;8;0;8
16959;Žiburėlis;SPINDULIUKAI;5629404179;Ne;8;8;0;16
16960;Žiburėlis;SPINDULIUKAI;6647598068;Ne;5;0;0;5
16961;Žiburėlis;SPINDULIUKAI;8686565770;Ne;0;8;0;8
16962;Žiburėlis;SPINDULIUKAI;7825665451;Ne;2;6;0;8
16963;Žiburėlis;SPINDULIUKAI;2808361570;Ne;15;0;0;15
16964;Žiburėlis;KIŠKUČIAI;6492467281;Ne;6;0;0;6
16965;Žiburėlis;KIŠKUČIAI;3352845095;Ne;11;0;0;11
16966;Žiburėlis;KIŠKUČIAI;1004953300;Taip;0;1;0;1
16967;Žiburėlis;KIŠKUČIAI;3296994981;Ne;8;4;0;12
16968;Žiburėlis;KIŠKUČIAI;1887550130;Ne;11;2;2;15
16969;Žiburėlis;KIŠKUČIAI;6019278045;Ne;16;0;0;16
16970;Žiburėlis;KIŠKUČIAI;4079793067;Ne;0;0;1;1
16971;Žiburėlis;KIŠKUČIAI;5418413225;Ne;0;4;1;5
16972;Žiburėlis;KIŠKUČIAI;6044837042;Taip;0;6;3;9
16973;Žiburėlis;KIŠKUČIAI;1334695206;Ne;15;2;2;19
16974;Žiburėlis;KIŠKUČIAI;7597762608;Ne;10;4;0;14
16975;Žiburėlis;KIŠKUČIAI;6562748977;Ne;12;0;1;13
16976;Žiburėlis;KIŠKUČIAI;5145195661;Ne;12;0;0;12
16977;Žiburėlis;KIŠKUČIAI;4477396434;Ne;0;6;2;8
16978;Žiburėlis;KIŠKUČIAI;2712358146;Ne;11;0;2;13
16979;Žiburėlis;KIŠKUČIAI;5410394172;Ne;8;0;0;8
16980;Žiburėlis;KIŠKUČIAI;4003368130;Ne;18;6;0;24
16981;Žiburėlis;KIŠKUČIAI;2456703958;Ne;7;1;0;8
16982;Žiburėlis;KIŠKUČIAI;1868558773;Taip;0;4;0;4
16983;Žiburėlis;KIŠKUČIAI;2083500905;Ne;3;4;0;7
16984;Žiburėlis;KIŠKUČIAI;6577061306;Ne;9;2;0;11
16985;Žiburėlis;DRUGELIAI;9783567484;Ne;13;0;0;13
16986;Žiburėlis;DRUGELIAI;4109288891;Ne;21;0;0;21
16987;Žiburėlis;DRUGELIAI;1015624216;Ne;5;4;0;9
16988;Žiburėlis;DRUGELIAI;9526477121;Ne;6;4;0;10
16989;Žiburėlis;DRUGELIAI;4387021429;Ne;0;4;0;4
16990;Žiburėlis;DRUGELIAI;8018718405;Ne;0;6;0;6
16991;Žiburėlis;DRUGELIAI;4910787530;Ne;11;3;0;14
16992;Žiburėlis;DRUGELIAI;5324852807;Ne;0;6;0;6
16993;Žiburėlis;DRUGELIAI;4916545915;Ne;5;4;0;9
16994;Žiburėlis;DRUGELIAI;8133371774;Ne;6;12;0;18
16995;Žiburėlis;DRUGELIAI;7278242428;Taip;5;0;0;5
16996;Žiburėlis;DRUGELIAI;5732540560;Ne;0;12;0;12
16997;Žiburėlis;DRUGELIAI;1228806324;Ne;0;1;0;1
16998;Žiburėlis;DRUGELIAI;2163018032;Ne;9;3;0;12
16999;Žiburėlis;DRUGELIAI;4581800760;Ne;9;0;0;9
17000;Žiburėlis;DRUGELIAI;4168864882;Ne;0;3;0;3
17001;Bangelė;Aštuonkojai;6026399355;Ne;0;6;0;6
17002;Bangelė;Aštuonkojai;5476753511;Ne;0;0;9;9
17003;Bangelė;Aštuonkojai;9168310196;Ne;0;6;0;6
17004;Bangelė;Aštuonkojai;1351714626;Ne;6;0;0;6
17005;Bangelė;Aštuonkojai;3063439996;Ne;0;3;0;3
17006;Bangelė;Aštuonkojai;2156837975;Ne;4;0;0;4
17007;Bangelė;Aštuonkojai;9143945953;Ne;0;4;0;4
17008;Bangelė;Aštuonkojai;3022508446;Ne;0;0;2;2
17009;Bangelė;Aštuonkojai;5546256869;Ne;0;0;1;1
17010;Bangelė;Aštuonkojai;6980232224;Ne;1;0;1;2
17011;Bangelė;Aštuonkojai;6145050734;Ne;0;4;0;4
17012;Bangelė;Aštuonkojai;1390623903;Ne;0;5;0;5
17013;Bangelė;Aštuonkojai;9788923823;Ne;6;13;0;19
17014;Bangelė;Aštuonkojai;7136625230;Ne;0;3;0;3
17015;Bangelė;Aštuonkojai;6216334243;Ne;3;0;0;3
17016;Bangelė;Delfinukai,;6978215876;Ne;0;0;4;4
17017;Bangelė;Delfinukai,;7434358474;Ne;0;15;0;15
17018;Bangelė;Delfinukai,;2575806242;Ne;0;3;2;5
17019;Bangelė;Delfinukai,;9801978617;Ne;0;1;0;1
17020;Bangelė;Delfinukai,;7434879947;Ne;5;0;0;5
17021;Bangelė;Delfinukai,;5994720767;Ne;0;6;0;6
17022;Bangelė;Delfinukai,;4532810332;Ne;0;7;0;7
17023;Bangelė;Delfinukai,;8575020060;Ne;0;2;0;2
17024;Bangelė;Delfinukai,;3344441441;Ne;6;1;0;7
17025;Bangelė;Delfinukai,;2858929915;Ne;9;0;0;9
17026;Bangelė;Delfinukai,;7068305612;Ne;0;0;7;7
17027;Bangelė;Delfinukai,;4412780063;Ne;2;3;0;5
17028;Bangelė;"Saulės spindulėliai";55668308050;Ne;0;10;0;10
17029;Bangelė;"Saulės spindulėliai";9150185864;Ne;0;7;0;7
17030;Bangelė;"Saulės spindulėliai";2863118434;Ne;0;6;0;6
17031;Bangelė;"Saulės spindulėliai";9167286651;Ne;0;4;12;16
17032;Bangelė;"Saulės spindulėliai";43740476077;Ne;6;8;0;14
17033;Bangelė;"Saulės spindulėliai";9846780259;Ne;0;8;0;8
17034;Bangelė;"Saulės spindulėliai";1377734102;Ne;0;4;1;5
17035;Bangelė;"Saulės spindulėliai";5950451237;Ne;0;3;0;3
17036;Bangelė;"Saulės spindulėliai";9488932192;Ne;0;3;0;3
17037;Bangelė;"Saulės spindulėliai";1728085772;Ne;1;1;0;2
17038;Bangelė;"Saulės spindulėliai";1447396084;Ne;0;2;0;2
17039;Bangelė;"Saulės spindulėliai";6173470021;Ne;0;1;0;1
17040;Bangelė;"Saulės spindulėliai";6927540308;Ne;0;1;3;4
17041;Bangelė;"Saulės spindulėliai";9464115339;Ne;5;1;0;6
17042;Bangelė;"Saulės spindulėliai";4401389067;Ne;0;4;0;4
17043;Bangelė;"Saulės spindulėliai";3338203753;Ne;0;15;0;15
17044;Bangelė;"Saulės spindulėliai";3206495858;Ne;0;0;3;3
17045;Bangelė;"Saulės spindulėliai";7861208185;Ne;0;0;3;3
17046;Bangelė;"Saulės spindulėliai";2503946448;Ne;0;5;0;5
17047;Bangelė;"Saulės spindulėliai";2872188915;Ne;0;6;1;7
17048;Bangelė;"Saulės spindulėliai";3132827429;Ne;0;0;1;1
17049;Bangelė;"Pingvinukai ";4317054990;Ne;0;3;0;3
17050;Bangelė;"Pingvinukai ";8943721679;Ne;0;5;0;5
17051;Bangelė;"Pingvinukai ";6566277472;Ne;0;5;0;5
17052;Bangelė;"Pingvinukai ";7362196984;Ne;0;12;1;13
17053;Bangelė;"Pingvinukai ";4712616315;Ne;0;0;2;2
17054;Bangelė;"Pingvinukai ";4940247006;Ne;9;0;0;9
17055;Bangelė;"Pingvinukai ";8335931279;Ne;11;0;0;11
17056;Bangelė;"Pingvinukai ";9311379746;Ne;0;6;0;6
17057;Bangelė;"Pingvinukai ";9955097720;Ne;0;2;0;2
17058;Bangelė;"Pingvinukai ";4851593235;Ne;0;5;0;5
17059;Bangelė;"Pingvinukai ";8998648968;Ne;0;1;0;1
17060;Bangelė;"Pingvinukai ";7016039389;Ne;0;3;0;3
17061;Bangelė;"Pingvinukai ";2127734178;Ne;0;1;0;1
17062;Bangelė;"Pingvinukai ";4651237403;Ne;0;0;1;1
17063;Bangelė;"Pingvinukai ";8661284187;Ne;0;0;8;8
17064;Bangelė;"Pingvinukai ";1541525635;Ne;0;1;0;1
17065;Bangelė;"Jūros žvaigždutės ";9447145378;Ne;5;4;0;9
17066;Bangelė;"Jūros žvaigždutės ";4086446380;Ne;0;6;0;6
17067;Bangelė;"Jūros žvaigždutės ";8745595583;Ne;8;2;0;10
17068;Bangelė;"Jūros žvaigždutės ";9268294844;Ne;0;0;2;2
17069;Bangelė;"Jūros žvaigždutės ";4831656996;Ne;0;0;3;3
17070;Bangelė;"Jūros žvaigždutės ";9267349375;Ne;0;17;4;21
17071;Bangelė;"Jūros žvaigždutės ";3069288815;Ne;5;1;1;7
17072;Bangelė;"Jūros žvaigždutės ";9729929020;Ne;6;0;0;6
17073;Bangelė;"Jūros žvaigždutės ";8563674709;Ne;0;1;0;1
17074;Bangelė;"Jūros žvaigždutės ";3946690047;Ne;0;4;0;4
17075;Bangelė;"Jūros žvaigždutės ";6705583340;Ne;0;0;2;2
17076;Bangelė;"Jūros žvaigždutės ";6174617493;Ne;0;0;2;2
17077;Bangelė;"Jūros žvaigždutės ";8075810032;Ne;0;6;0;6
17078;Bangelė;"Jūros žvaigždutės ";3500097405;Ne;21;0;0;21
17079;Bangelė;"Jūros žvaigždutės ";2624013880;Ne;6;0;3;9
17080;Bangelė;Žuvytės;6496580354;Ne;1;0;11;12
17081;Bangelė;Žuvytės;6480681705;Ne;0;4;0;4
17082;Bangelė;Žuvytės;7142694888;Ne;0;0;2;2
17083;Bangelė;Žuvytės;8734511431;Ne;0;10;0;10
17084;Bangelė;Žuvytės;1895213200;Ne;0;0;3;3
17085;Bangelė;Žuvytės;9765268154;Ne;0;14;0;14
17086;Bangelė;Žuvytės;8495423628;Ne;5;0;0;5
17087;Bangelė;Žuvytės;7419016784;Ne;0;1;5;6
17088;Bangelė;Žuvytės;5190563034;Ne;0;0;3;3
17089;Bangelė;Žuvytės;3991021350;Ne;10;0;1;11
17090;Bangelė;Žuvytės;9954762483;Ne;6;3;0;9
17091;Bangelė;Žuvytės;9493465898;Ne;0;0;1;1
17092;Bangelė;Žuvytės;5597329949;Ne;5;8;0;13
17093;Bangelė;Žuvytės;2134225414;Ne;0;0;4;4
17094;Bangelė;Žuvytės;4494049529;Ne;0;0;4;4
17095;Bangelė;Žuvytės;3334029244;Ne;6;5;0;11
17096;Bangelė;Žuvytės;6165322599;Ne;0;2;0;2
17097;Bangelė;Žuvytės;3016778137;Ne;0;0;3;3
17098;Bangelė;Žuvytės;1898671487;Ne;0;1;2;3
17099;Bangelė;Žuvytės;7174742281;Ne;17;7;0;24
17100;Bangelė;Žuvytės;6806911810;Ne;0;0;6;6
17101;Bangelė;Ruoniai;8149880453;Ne;9;2;0;11
17102;Bangelė;Ruoniai;4571869439;Ne;4;1;0;5
17103;Bangelė;Ruoniai;9672505885;Ne;0;1;4;5
17104;Bangelė;Ruoniai;2017886238;Ne;0;1;0;1
17105;Bangelė;Ruoniai;8990701154;Ne;3;0;1;4
17106;Bangelė;Ruoniai;9706351115;Ne;0;4;0;4
17107;Bangelė;Ruoniai;8758933649;Ne;11;4;3;18
17108;Bangelė;Ruoniai;1528387105;Ne;0;4;0;4
17109;Bangelė;Ruoniai;6712145066;Ne;8;0;1;9
17110;Bangelė;"Pagrandukai ";9561221619;Ne;0;3;0;3
17111;Bangelė;"Pagrandukai ";9128326823;Ne;0;1;0;1
17112;Bangelė;"Pagrandukai ";5625257865;Ne;0;0;2;2
17113;Bangelė;"Pagrandukai ";6415607960;Ne;10;0;3;13
17114;Bangelė;"Pagrandukai ";1182624046;Ne;0;5;0;5
17115;Bangelė;"Pagrandukai ";9355348960;Ne;10;0;0;10
17116;Bangelė;"Pagrandukai ";1467390411;Ne;0;1;3;4
17117;Bangelė;"Pagrandukai ";2730545639;Ne;5;0;0;5
17118;Bangelė;"Pagrandukai ";4041276015;Ne;0;0;1;1
17119;Bangelė;"Pagrandukai ";7503518328;Ne;3;0;1;4
17120;Bangelė;"Pagrandukai ";9010238689;Ne;0;11;0;11
17121;Bangelė;"Pagrandukai ";5829865386;Ne;0;0;4;4
17122;Bangelė;"Zuikučiai ";7364368699;Ne;5;1;3;9
17123;Bangelė;"Zuikučiai ";6400785821;Ne;5;0;0;5
17124;Bangelė;"Zuikučiai ";5961647252;Ne;20;0;0;20
17125;Bangelė;"Zuikučiai ";8493650050;Ne;0;10;0;10
17126;Bangelė;"Zuikučiai ";3851738513;Ne;0;1;0;1
17127;Bangelė;"Zuikučiai ";3452984649;Ne;5;2;0;7
17128;Bangelė;"Zuikučiai ";2362345363;Ne;5;0;0;5
17129;Bangelė;"Zuikučiai ";4891131242;Ne;5;0;0;5
17130;Bangelė;"Zuikučiai ";7445583512;Ne;10;1;0;11
17131;Bangelė;"Zuikučiai ";2382714949;Ne;9;0;0;9
17132;Bangelė;"Zuikučiai ";7755966282;Ne;0;2;2;4
17133;Bangelė;"Zuikučiai ";4480762963;Ne;0;2;2;4
17134;Bangelė;"Zuikučiai ";8765892966;Ne;0;5;0;5
17135;Bangelė;Vėžliukai;9142460659;Ne;10;0;2;12
17136;Bangelė;Vėžliukai;2405364948;Ne;5;0;0;5
17137;Bangelė;Vėžliukai;7862345122;Ne;0;13;0;13
17138;Bangelė;Vėžliukai;1869389013;Ne;9;4;0;13
17139;Bangelė;Vėžliukai;2630571748;Ne;0;2;0;2
17140;Bangelė;Vėžliukai;5779198855;Ne;13;0;0;13
17141;Bangelė;Vėžliukai;5746189515;Ne;0;2;0;2
17142;Bangelė;Vėžliukai;6312356331;Ne;0;0;5;5
17143;Bangelė;Vėžliukai;8454369872;Ne;0;3;0;3
17144;Gėlynas;PAKALNUTĖ;4557380282;Ne;0;16;0;16
17145;Gėlynas;PAKALNUTĖ;6884111634;Taip;0;6;2;8
17146;Gėlynas;PAKALNUTĖ;1548317086;Ne;19;0;0;19
17147;Gėlynas;PAKALNUTĖ;3470963396;Ne;0;9;0;9
17148;Gėlynas;PAKALNUTĖ;2171064300;Ne;8;0;0;8
17149;Gėlynas;PAKALNUTĖ;2404562144;Ne;0;1;0;1
17150;Gėlynas;PAKALNUTĖ;7504469409;Ne;0;4;0;4
17151;Gėlynas;PAKALNUTĖ;8693415786;Ne;0;3;0;3
17152;Gėlynas;PAKALNUTĖ;4366442459;Ne;7;0;0;7
17153;Gėlynas;PAKALNUTĖ;1463783538;Ne;12;0;0;12
17154;Gėlynas;PAKALNUTĖ;7064068912;Ne;11;6;0;17
17155;Gėlynas;PAKALNUTĖ;1822933936;Ne;4;1;0;5
17156;Gėlynas;PAKALNUTĖ;4668195919;Ne;0;6;0;6
17157;Gėlynas;PAKALNUTĖ;8555408466;Ne;0;10;0;10
17158;Gėlynas;PAKALNUTĖ;5382148888;Ne;13;4;3;20
17159;Gėlynas;PAKALNUTĖ;6296728638;Ne;0;21;0;21
17160;Gėlynas;PAKALNUTĖ;5826067446;Ne;1;0;0;1
17161;Gėlynas;PAKALNUTĖ;2273705177;Ne;8;0;1;9
17162;Gėlynas;PAKALNUTĖ;5350834071;Ne;0;0;2;2
17163;Gėlynas;PAKALNUTĖ;2520140743;Ne;0;0;3;3
17164;Gėlynas;VARPELIS;2769668641;Ne;0;4;0;4
17165;Gėlynas;VARPELIS;1004866224;Ne;0;5;0;5
17166;Gėlynas;VARPELIS;2417880374;Ne;0;3;6;9
17167;Gėlynas;VARPELIS;4382465307;Ne;0;6;0;6
17168;Gėlynas;VARPELIS;5135747448;Ne;0;4;3;7
17169;Gėlynas;VARPELIS;1754734306;Ne;0;2;0;2
17170;Gėlynas;VARPELIS;1774829898;Ne;4;0;0;4
17171;Gėlynas;VARPELIS;7562201835;Ne;0;5;0;5
17172;Gėlynas;VARPELIS;4445250490;Ne;0;1;0;1
17173;Gėlynas;VARPELIS;2132298690;Ne;17;0;0;17
17174;Gėlynas;VARPELIS;8464074679;Ne;3;4;3;10
17175;Gėlynas;VARPELIS;9911225363;Ne;3;1;3;7
17176;Gėlynas;VARPELIS;5395474698;Ne;0;12;0;12
17177;Gėlynas;VARPELIS;1257113113;Ne;0;4;1;5
17178;Gėlynas;VARPELIS;6898127005;Ne;13;0;0;13
17179;Gėlynas;VARPELIS;3365442661;Ne;0;0;2;2
17180;Gėlynas;VARPELIS;5145396320;Ne;0;6;0;6
17181;Gėlynas;VARPELIS;90046802421;Ne;0;5;0;5
17182;Gėlynas;VARPELIS;7814357385;Ne;0;6;3;9
17183;Gėlynas;VARPELIS;1674569569;Ne;0;6;0;6
17184;Gėlynas;VARPELIS;7808971151;Ne;0;4;1;5
17185;Gėlynas;VARPELIS;4916885450;Ne;10;4;2;16
17186;Gėlynas;RAKTAŽOLĖ;3491517766;Ne;0;6;0;6
17187;Gėlynas;RAKTAŽOLĖ;4505012978;Ne;2;8;0;10
17188;Gėlynas;RAKTAŽOLĖ;5124029118;Ne;0;6;0;6
17189;Gėlynas;RAKTAŽOLĖ;9508507084;Ne;0;7;0;7
17190;Gėlynas;RAKTAŽOLĖ;8999346908;Ne;0;6;0;6
17191;Gėlynas;RAKTAŽOLĖ;8458276300;Ne;0;5;0;5
17192;Gėlynas;RAKTAŽOLĖ;7730322729;Ne;0;2;0;2
17193;Gėlynas;RAKTAŽOLĖ;2348787949;Ne;0;3;0;3
17194;Gėlynas;RAKTAŽOLĖ;6528464599;Ne;0;4;0;4
17195;Gėlynas;RAKTAŽOLĖ;8615943743;Ne;0;9;0;9
17196;Gėlynas;RAKTAŽOLĖ;7389502638;Ne;0;4;0;4
17197;Gėlynas;RAKTAŽOLĖ;1590299264;Ne;0;10;0;10
17198;Gėlynas;RAKTAŽOLĖ;5751256561;Ne;8;0;1;9
17199;Gėlynas;RAKTAŽOLĖ;1015554617;Ne;0;4;0;4
17200;Gėlynas;RAKTAŽOLĖ;9252696260;Ne;5;4;0;9
17201;Gėlynas;RAKTAŽOLĖ;6875794958;Ne;2;1;0;3
17202;Gėlynas;RAKTAŽOLĖ;8444505017;Ne;0;7;0;7
17203;Gėlynas;SAULĖGRĄŽA;1505666690;Ne;0;0;2;2
17204;Gėlynas;SAULĖGRĄŽA;3492361041;Ne;0;10;0;10
17205;Gėlynas;SAULĖGRĄŽA;2141722631;Ne;0;4;0;4
17206;Gėlynas;SAULĖGRĄŽA;2742456983;Ne;0;4;3;7
17207;Gėlynas;SAULĖGRĄŽA;3549079170;Ne;1;1;0;2
17208;Gėlynas;SAULĖGRĄŽA;9305282699;Ne;3;4;0;7
17209;Gėlynas;SAULĖGRĄŽA;6815740588;Ne;0;4;2;6
17210;Gėlynas;SAULĖGRĄŽA;3606076029;Ne;0;12;0;12
17211;Gėlynas;SAULĖGRĄŽA;4824667762;Ne;0;8;0;8
17212;Gėlynas;SAULĖGRĄŽA;9330385153;Ne;8;2;0;10
17213;Gėlynas;SAULĖGRĄŽA;9724668402;Ne;0;1;0;1
17214;Gėlynas;SAULĖGRĄŽA;9462822190;Ne;9;0;0;9
17215;Gėlynas;SAULĖGRĄŽA;2784709117;Ne;0;0;2;2
17216;Gėlynas;SAULĖGRĄŽA;6114995335;Ne;0;1;5;6
17217;Gėlynas;SAULĖGRĄŽA;5320531856;Ne;0;6;0;6
17218;Gėlynas;SAULĖGRĄŽA;7998013477;Ne;0;4;0;4
17219;Gėlynas;SAULĖGRĄŽA;6244314445;Ne;10;1;0;11
17220;Gėlynas;RAMUNĖLĖ;9707677931;Ne;2;0;2;4
17221;Gėlynas;RAMUNĖLĖ;1235384604;Ne;0;2;0;2
17222;Gėlynas;RAMUNĖLĖ;9230984365;Ne;0;0;3;3
17223;Gėlynas;RAMUNĖLĖ;6221721945;Ne;0;10;0;10
17224;Gėlynas;RAMUNĖLĖ;1468588114;Ne;0;3;0;3
17225;Gėlynas;RAMUNĖLĖ;6790040590;Ne;6;0;0;6
17226;Gėlynas;RAMUNĖLĖ;4854709904;Ne;0;3;0;3
17227;Gėlynas;RAMUNĖLĖ;2434552926;Ne;0;0;4;4
17228;Gėlynas;RAMUNĖLĖ;1570975863;Ne;0;0;5;5
17229;Gėlynas;RAMUNĖLĖ;9302757372;Ne;0;18;0;18
17230;Gėlynas;RAMUNĖLĖ;8550986498;Ne;11;0;0;11
17231;Gėlynas;RAMUNĖLĖ;6342888072;Ne;0;13;0;13
17232;Gėlynas;RAMUNĖLĖ;9973824348;Ne;12;0;2;14
17233;Gėlynas;RAMUNĖLĖ;1681208354;Ne;0;0;1;1
17234;Gėlynas;RAMUNĖLĖ;1003739544;Ne;8;0;10;18
17235;Gėlynas;ŽIBUTĖ;4192292896;Ne;0;11;0;11
17236;Gėlynas;ŽIBUTĖ;6826311903;Ne;0;5;0;5
17237;Gėlynas;ŽIBUTĖ;8447789767;Ne;0;10;0;10
17238;Gėlynas;ŽIBUTĖ;1862266440;Ne;0;4;0;4
17239;Gėlynas;ŽIBUTĖ;3746597878;Ne;0;2;0;2
17240;Gėlynas;ŽIBUTĖ;9182072776;Ne;0;8;4;12
17241;Gėlynas;ŽIBUTĖ;7988094745;Ne;0;7;0;7
17242;Gėlynas;ŽIBUTĖ;9552677108;Ne;0;6;0;6
17243;Gėlynas;ŽIBUTĖ;2608369575;Ne;0;6;0;6
17244;Gėlynas;ŽIBUTĖ;1949260962;Ne;0;5;0;5
17245;Gėlynas;ŽIBUTĖ;6635004996;Ne;5;3;0;8
17246;Gėlynas;ŽIBUTĖ;1556683639;Ne;0;4;0;4
17247;Gėlynas;ŽIBUTĖ;5942466822;Ne;5;0;0;5
17248;Gėlynas;ŽIBUTĖ;2193861056;Ne;0;0;2;2
17249;Gėlynas;ŽIBUTĖ;2790269385;Ne;8;6;1;15
17250;Gėlynas;ŽIBUTĖ;2885148633;Ne;6;0;0;6
17251;Obelėlė;Gudručiai;2014314139;Ne;3;0;4;7
17252;Obelėlė;Gudručiai;9900484892;Ne;0;4;6;10
17253;Obelėlė;Gudručiai;6145113624;Ne;0;4;0;4
17254;Obelėlė;Gudručiai;9586720282;Ne;0;5;0;5
17255;Obelėlė;Gudručiai;9567704282;Ne;3;0;0;3
17256;Obelėlė;Gudručiai;4015702815;Ne;14;0;0;14
17257;Obelėlė;Gudručiai;5141585309;Ne;0;14;0;14
17258;Obelėlė;Gudručiai;9736557012;Ne;0;5;0;5
17259;Obelėlė;Gudručiai;6720058972;Ne;0;4;0;4
17260;Obelėlė;Gudručiai;2204293216;Ne;0;0;2;2
17261;Obelėlė;Gudručiai;1184082097;Ne;14;0;0;14
17262;Obelėlė;Gudručiai;2533715287;Ne;0;0;4;4
17263;Obelėlė;Gudručiai;1312484983;Ne;15;0;0;15
17264;Obelėlė;Gudručiai;1565630870;Ne;0;3;0;3
17265;Obelėlė;Gudručiai;1598785483;Ne;0;9;0;9
17266;Obelėlė;Pasakaitė;1695933896;Ne;0;3;4;7
17267;Obelėlė;Pasakaitė;1555780072;Ne;0;0;2;2
17268;Obelėlė;Pasakaitė;77743243622;Ne;0;0;1;1
17269;Obelėlė;Pasakaitė;1543298097;Ne;3;0;0;3
17270;Obelėlė;Pasakaitė;3330983614;Ne;5;4;0;9
17271;Obelėlė;Pasakaitė;4257479486;Ne;0;0;1;1
17272;Obelėlė;Pasakaitė;8394566707;Ne;0;1;1;2
17273;Obelėlė;Pasakaitė;9527363918;Ne;0;0;1;1
17274;Obelėlė;Pasakaitė;10939948244;Ne;0;5;0;5
17275;Obelėlė;Pasakaitė;1707652145;Ne;0;2;0;2
17276;Obelėlė;Pasakaitė;1141707374;Ne;0;6;3;9
17277;Obelėlė;Pasakaitė;6789881144;Ne;0;4;0;4
17278;Obelėlė;Pasakaitė;6036130112;Ne;5;1;1;7
17279;Obelėlė;Pasakaitė;1893470952;Ne;0;0;1;1
17280;Obelėlė;Pasakaitė;7754276632;Ne;0;21;0;21
17281;Obelėlė;Pasakaitė;69055416041;Ne;0;4;6;10
17282;Obelėlė;Pasakaitė;3517342646;Ne;0;1;8;9
17283;Obelėlė;Pasakaitė;4220808775;Ne;0;4;6;10
17284;Obelėlė;Pasakaitė;1507072248;Ne;0;1;0;1
17285;Obelėlė;Pasakaitė;7934760271;Ne;2;0;0;2
17286;Obelėlė;Svajokliai;9981446556;Ne;0;4;1;5
17287;Obelėlė;Svajokliai;4849499826;Ne;5;0;0;5
17288;Obelėlė;Svajokliai;1469593267;Ne;0;5;2;7
17289;Obelėlė;Svajokliai;9819048265;Ne;9;6;2;17
17290;Obelėlė;Svajokliai;5588467580;Ne;15;4;2;21
17291;Obelėlė;Svajokliai;7094715237;Ne;0;0;6;6
17292;Obelėlė;Svajokliai;8231489868;Ne;1;3;0;4
17293;Obelėlė;Svajokliai;3986892111;Ne;0;4;0;4
17294;Obelėlė;Svajokliai;7003947655;Ne;0;1;0;1
17295;Obelėlė;Svajokliai;8918176312;Ne;0;0;4;4
17296;Obelėlė;Svajokliai;7794072582;Ne;2;0;0;2
17297;Obelėlė;Svajokliai;6785654280;Ne;0;0;3;3
17298;Obelėlė;Svajokliai;6311322617;Ne;0;3;1;4
17299;Obelėlė;Svajokliai;2813927086;Ne;0;4;0;4
17300;Obelėlė;Smalsučiai;7687093936;Ne;0;1;0;1
17301;Obelėlė;Smalsučiai;7108517080;Ne;0;0;2;2
17302;Obelėlė;Smalsučiai;4987747783;Ne;4;4;1;9
17303;Obelėlė;Smalsučiai;5085970254;Ne;17;0;0;17
17304;Obelėlė;Smalsučiai;8709758561;Ne;2;0;1;3
17305;Obelėlė;Smalsučiai;5739522736;Ne;0;3;1;4
17306;Obelėlė;Smalsučiai;2631405243;Ne;10;6;0;16
17307;Obelėlė;Smalsučiai;8173307704;Ne;7;0;0;7
17308;Obelėlė;Smalsučiai;9796759067;Ne;0;7;0;7
17309;Obelėlė;Smalsučiai;6720808705;Ne;0;4;0;4
17310;Obelėlė;Smalsučiai;7850656031;Ne;5;0;3;8
17311;Obelėlė;Smalsučiai;9084969712;Taip;0;0;1;1
17312;Obelėlė;Smalsučiai;6364101139;Ne;13;0;0;13
17313;Obelėlė;Smalsučiai;6064646690;Ne;0;0;3;3
17314;Obelėlė;Smalsučiai;6691540418;Ne;4;0;0;4
17315;Obelėlė;Smalsučiai;8183287212;Ne;0;1;4;5
17316;Obelėlė;Smalsučiai;2574840626;Ne;0;8;0;8
17317;Obelėlė;Smalsučiai;8981403984;Ne;0;21;0;21
17318;Obelėlė;Pabiručiai;5763713052;Taip;0;21;0;21
17319;Obelėlė;Pabiručiai;8579887226;Ne;5;0;2;7
17320;Obelėlė;Pabiručiai;3951816174;Ne;5;0;1;6
17321;Obelėlė;Pabiručiai;5599466885;Ne;0;0;5;5
17322;Obelėlė;Pabiručiai;9634414572;Ne;3;0;0;3
17323;Obelėlė;Pabiručiai;4851824672;Ne;7;3;0;10
17324;Obelėlė;Pabiručiai;3526079444;Ne;0;0;1;1
17325;Obelėlė;Pabiručiai;9731565368;Ne;5;7;0;12
17326;Obelėlė;Pabiručiai;8443192155;Ne;10;0;0;10
17327;Obelėlė;Pabiručiai;9627134967;Ne;5;0;0;5
17328;Obelėlė;Pabiručiai;5368376431;Ne;11;0;0;11
17329;Obelėlė;Strakaliukai;1706102918;Taip;0;0;2;2
17330;Obelėlė;Strakaliukai;8682794598;Ne;2;5;0;7
17331;Obelėlė;Strakaliukai;8754552660;Ne;0;0;8;8
17332;Obelėlė;Strakaliukai;8092024850;Ne;0;3;0;3
17333;Obelėlė;Strakaliukai;9716500560;Ne;10;0;1;11
17334;Obelėlė;Strakaliukai;4251418414;Ne;7;0;0;7
17335;Obelėlė;Strakaliukai;7128421330;Ne;12;0;0;12
17336;Obelėlė;Strakaliukai;5943314566;Ne;0;4;1;5
17337;Obelėlė;Strakaliukai;3116100694;Ne;4;0;0;4
17338;Obelėlė;Strakaliukai;5741823041;Ne;0;0;5;5
17339;Obelėlė;Strakaliukai;8050551266;Ne;0;0;1;1
17340;Obelėlė;Strakaliukai;7468335279;Ne;0;1;2;3
17341;Obelėlė;Strakaliukai;1180508643;Ne;0;7;0;7
17342;Obelėlė;Strakaliukai;7124393375;Ne;6;0;4;10
17343;Obelėlė;Strakaliukai;5001844064;Ne;6;4;1;11
17344;Obelėlė;Strakaliukai;9976694313;Ne;0;0;3;3
17345;Obelėlė;Saulutė;2772753891;Taip;9;6;2;17
17346;Obelėlė;Saulutė;8486560892;Ne;0;5;0;5
17347;Obelėlė;Saulutė;1858251094;Ne;0;0;10;10
17348;Obelėlė;Saulutė;2893378990;Ne;3;0;1;4
17349;Obelėlė;Saulutė;6874039388;Ne;0;0;1;1
17350;Obelėlė;Saulutė;7491934262;Ne;0;2;0;2
17351;Obelėlė;Saulutė;9043542844;Ne;2;0;0;2
17352;Obelėlė;Saulutė;4209489251;Ne;0;0;4;4
17353;Obelėlė;Saulutė;4309622934;Ne;15;0;1;16
17354;Obelėlė;Saulutė;3590915973;Ne;4;0;1;5
17355;Obelėlė;Saulutė;6470533765;Ne;4;5;0;9
17356;Obelėlė;Saulutė;8223715886;Ne;4;5;0;9
17357;Obelėlė;Saulutė;8461505586;Ne;0;0;1;1
17358;Obelėlė;Saulutė;2730569223;Ne;0;0;2;2
17359;Obelėlė;Saulutė;4218895290;Ne;6;0;0;6
17360;Obelėlė;Saulutė;3460171136;Taip;4;0;1;5
17361;Obelėlė;Rieduliukai;9008900055;Ne;15;0;0;15
17362;Obelėlė;Rieduliukai;9332534001;Ne;15;0;0;15
17363;Obelėlė;Rieduliukai;2465101384;Ne;11;2;0;13
17364;Obelėlė;Rieduliukai;7403160073;Ne;0;0;8;8
17365;Obelėlė;Rieduliukai;2663004768;Ne;11;0;1;12
17366;Obelėlė;Rieduliukai;8060994250;Ne;20;0;0;20
17367;Obelėlė;Rieduliukai;1788880520;Ne;0;0;16;16
17368;Obelėlė;Rieduliukai;3452970142;Ne;0;0;1;1
17369;Obelėlė;Rieduliukai;9995891955;Ne;9;0;0;9
17370;Obelėlė;Rieduliukai;4707488292;Ne;0;21;0;21
17371;Obelėlė;Rieduliukai;5617103957;Ne;17;4;0;21
17372;Obelėlė;Rieduliukai;3646359565;Ne;5;1;10;16
17373;Obelėlė;Rieduliukai;5366112771;Ne;4;0;0;4
17374;Obelėlė;Rieduliukai;6945301927;Ne;7;0;0;7
17375;Obelėlė;Rieduliukai;5603904852;Ne;0;0;6;6
17376;Obelėlė;Rieduliukai;2031637374;Ne;5;0;1;6
17377;Obelėlė;Rieduliukai;4678269928;Taip;0;0;5;5
17378;Obelėlė;Žirniukai;5209482838;Ne;18;0;0;18
17379;Obelėlė;Žirniukai;5503843905;Ne;0;4;1;5
17380;Obelėlė;Žirniukai;6133596410;Ne;5;0;0;5
17381;Obelėlė;Žirniukai;2702773541;Ne;0;0;5;5
17382;Obelėlė;Žirniukai;2769784741;Ne;5;0;0;5
17383;Obelėlė;Žirniukai;8982197866;Ne;16;0;0;16
17384;Obelėlė;Žirniukai;1222183008;Ne;8;0;0;8
17385;Obelėlė;Žirniukai;7813350634;Ne;6;0;2;8
17386;Obelėlė;Žirniukai;3568124213;Ne;0;0;3;3
17387;Obelėlė;Žirniukai;5478392319;Ne;0;0;3;3
17388;Obelėlė;Žirniukai;4223995429;Ne;0;4;6;10
17389;Obelėlė;Žirniukai;5073364608;Ne;4;4;0;8
17390;Obelėlė;Žirniukai;3287262204;Ne;0;0;1;1
17391;Obelėlė;Žirniukai;9005520809;Ne;6;6;0;12
17392;Obelėlė;Žirniukai;5192989376;Ne;15;6;0;21
17393;Obelėlė;Žirniukai;1799603610;Ne;0;21;0;21
17394;Obelėlė;Bičiuliai;3425736276;Ne;8;0;0;8
17395;Obelėlė;Bičiuliai;5776116844;Ne;0;3;0;3
17396;Obelėlė;Bičiuliai;8487088625;Ne;0;1;0;1
17397;Obelėlė;Bičiuliai;1630067014;Ne;0;5;0;5
17398;Obelėlė;Bičiuliai;1537769810;Ne;0;0;5;5
17399;Obelėlė;Bičiuliai;8371648703;Ne;0;4;0;4
17400;Obelėlė;Bičiuliai;1419189517;Ne;1;4;1;6
17401;Obelėlė;Bičiuliai;8155712451;Ne;0;4;0;4
17402;Obelėlė;Bičiuliai;4849175527;Ne;0;0;5;5
17403;Obelėlė;Bičiuliai;3769993089;Ne;0;0;3;3
17404;Obelėlė;Bičiuliai;5374979248;Ne;0;0;2;2
17405;Obelėlė;Bičiuliai;2170134084;Ne;0;0;1;1
17406;Obelėlė;Bičiuliai;1909459236;Ne;0;4;0;4
17407;Obelėlė;Kodėlčiukai;9960526051;Ne;3;0;1;4
17408;Obelėlė;Kodėlčiukai;1050919659;Ne;0;4;1;5
17409;Obelėlė;Kodėlčiukai;7014872044;Ne;0;0;2;2
17410;Obelėlė;Kodėlčiukai;3028107343;Ne;8;0;2;10
17411;Obelėlė;Kodėlčiukai;4717038536;Ne;9;0;2;11
17412;Obelėlė;Kodėlčiukai;4840134079;Ne;8;0;6;14
17413;Obelėlė;Kodėlčiukai;3320493372;Ne;0;13;0;13
17414;Obelėlė;Kodėlčiukai;8366162313;Ne;0;1;0;1
17415;Obelėlė;Kodėlčiukai;7901070568;Taip;0;0;1;1
17416;Obelėlė;Kodėlčiukai;6481365666;Ne;3;0;0;3
17417;Obelėlė;Kodėlčiukai;2227383487;Ne;0;1;0;1
17418;Obelėlė;Kodėlčiukai;8818153952;Ne;11;0;0;11
17419;Obelėlė;Kodėlčiukai;4887103549;Ne;14;0;0;14
17420;Obelėlė;Kodėlčiukai;5221918341;Taip;17;0;2;19
17421;Obelėlė;Kodėlčiukai;7696478568;Taip;0;0;2;2
17422;Obelėlė;Kodėlčiukai;7422668691;Ne;11;0;0;11
17423;Obelėlė;Kodėlčiukai;5233321854;Ne;0;0;6;6
17424;Obelėlė;Kodėlčiukai;1472630240;Ne;7;0;0;7
17425;Obelėlė;Pagrandukai;7934967787;Ne;11;0;0;11
17426;Obelėlė;Pagrandukai;4673426170;Ne;16;1;0;17
17427;Obelėlė;Pagrandukai;6436061438;Ne;10;0;0;10
17428;Obelėlė;Pagrandukai;8711370875;Ne;5;0;1;6
17429;Obelėlė;Pagrandukai;6938326798;Ne;12;0;0;12
17430;Obelėlė;Pagrandukai;9258651395;Ne;10;0;1;11
17431;Obelėlė;Pagrandukai;4974008654;Ne;0;21;0;21
17432;Obelėlė;Pagrandukai;3563701047;Ne;6;0;0;6
17433;Obelėlė;Pagrandukai;8664564820;Taip;6;0;0;6
17434;Obelėlė;Pagrandukai;4862765923;Ne;6;0;4;10
17435;Obelėlė;Pagrandukai;9170515841;Ne;16;0;1;17
17436;Obelėlė;Pagrandukai;4930485327;Ne;14;0;0;14
17437;Obelėlė;Pagrandukai;9514739912;Ne;7;0;0;7
17438;Obelėlė;Pagrandukai;8534759650;Ne;0;0;2;2
17439;Obelėlė;Pagrandukai;7368698046;Ne;10;0;5;15
17440;Obelėlė;Pagrandukai;3738932600;Ne;3;0;7;10
17441;Obelėlė;Pagrandukai;4065225586;Ne;4;0;1;5
17442;Spygliukas;Bitutės;9444569348;Ne;0;1;0;1
17443;Spygliukas;Bitutės;8404929784;Ne;0;4;0;4
17444;Spygliukas;Bitutės;4835818382;Ne;10;0;0;10
17445;Spygliukas;Bitutės;9070219319;Ne;0;6;0;6
17446;Spygliukas;Bitutės;9413950200;Ne;10;6;0;16
17447;Spygliukas;Bitutės;1664878188;Ne;0;1;0;1
17448;Spygliukas;Bitutės;8869320003;Ne;0;1;1;2
17449;Spygliukas;Bitutės;8476882854;Ne;9;3;0;12
17450;Spygliukas;Bitutės;1333556956;Ne;4;0;0;4
17451;Spygliukas;Bitutės;3761715811;Ne;0;5;0;5
17452;Spygliukas;Bitutės;8270525839;Ne;6;0;0;6
17453;Spygliukas;Bitutės;3697691132;Ne;8;1;0;9
17454;Spygliukas;Bitutės;1550737449;Ne;9;0;1;10
17455;Spygliukas;Bitutės;4053158210;Ne;0;2;0;2
17456;Spygliukas;Bitutės;2395961015;Ne;0;1;1;2
17457;Spygliukas;Bitutės;5180736358;Ne;8;0;0;8
17458;Spygliukas;Bitutės;9431217584;Ne;0;7;0;7
17459;Spygliukas;Bitutės;8289288541;Ne;5;0;0;5
17460;Spygliukas;Kiškučiai;6195903792;Ne;0;0;1;1
17461;Spygliukas;Kiškučiai;1927028026;Ne;7;1;0;8
17462;Spygliukas;Kiškučiai;3094528907;Ne;4;1;2;7
17463;Spygliukas;Kiškučiai;8981549891;Ne;0;0;3;3
17464;Spygliukas;Kiškučiai;9813995933;Taip;9;4;0;13
17465;Spygliukas;Kiškučiai;4013601534;Ne;15;0;0;15
17466;Spygliukas;Kiškučiai;6383264068;Ne;8;0;0;8
17467;Spygliukas;Kiškučiai;5369930705;Ne;5;0;0;5
17468;Spygliukas;Kiškučiai;6246925536;Taip;9;1;0;10
17469;Spygliukas;Kiškučiai;1037321774;Taip;0;3;0;3
17470;Spygliukas;Kiškučiai;5615854225;Ne;0;2;0;2
17471;Spygliukas;Kiškučiai;7261580644;Ne;10;2;0;12
17472;Spygliukas;Kiškučiai;7243104877;Ne;13;2;0;15
17473;Spygliukas;Kiškučiai;1436452804;Ne;4;5;4;13
17474;Spygliukas;Kiškučiai;1330384915;Ne;15;0;0;15
17475;Spygliukas;Kiškučiai;8299276429;Ne;5;6;0;11
17476;Spygliukas;Boružėlės;3569857813;Ne;0;0;1;1
17477;Spygliukas;Boružėlės;5493599614;Ne;5;0;1;6
17478;Spygliukas;Boružėlės;6931145017;Ne;4;0;0;4
17479;Spygliukas;Boružėlės;8802722601;Ne;0;3;4;7
17480;Spygliukas;Boružėlės;9285259322;Ne;0;9;0;9
17481;Spygliukas;Boružėlės;1341333016;Ne;21;0;0;21
17482;Spygliukas;Boružėlės;8806126755;Ne;5;4;0;9
17483;Spygliukas;Boružėlės;4477402331;Ne;0;0;2;2
17484;Spygliukas;Boružėlės;2772801133;Ne;1;1;1;3
17485;Spygliukas;Boružėlės;6332646009;Ne;5;4;0;9
17486;Spygliukas;Boružėlės;3706443395;Ne;1;4;0;5
17487;Spygliukas;Boružėlės;5765106914;Ne;0;0;1;1
17488;Spygliukas;Boružėlės;3416275094;Ne;0;0;4;4
17489;Spygliukas;Boružėlės;1401951658;Ne;0;1;0;1
17490;Spygliukas;Boružėlės;6248409896;Ne;3;1;0;4
17491;Spygliukas;Boružėlės;8708083787;Ne;0;7;0;7
17492;Spygliukas;Boružėlės;8825264090;Ne;0;21;0;21
17493;Spygliukas;Boružėlės;3919560072;Ne;0;0;1;1
17494;Spygliukas;Boružėlės;4577592862;Ne;0;5;0;5
17495;Spygliukas;Boružėlės;6835488489;Ne;0;2;0;2
17496;Spygliukas;Boružėlės;7900652746;Ne;0;8;0;8
17497;Spygliukas;Ežiukai;2164549239;Ne;0;0;1;1
17498;Spygliukas;Ežiukai;4340767624;Ne;6;0;1;7
17499;Spygliukas;Ežiukai;1983112873;Ne;0;1;1;2
17500;Spygliukas;Ežiukai;4615217628;Ne;0;5;0;5
17501;Spygliukas;Ežiukai;5612894706;Ne;0;4;0;4
17502;Spygliukas;Ežiukai;6552944183;Ne;2;0;0;2
17503;Spygliukas;Ežiukai;1353217998;Ne;5;1;0;6
17504;Spygliukas;Ežiukai;6459076295;Ne;0;3;0;3
17505;Spygliukas;Ežiukai;7749937772;Ne;2;11;8;21
17506;Spygliukas;Ežiukai;5160835235;Ne;0;1;0;1
17507;Spygliukas;Ežiukai;2719100414;Ne;15;0;0;15
17508;Spygliukas;Ežiukai;1429613380;Ne;15;3;0;18
17509;Spygliukas;Ežiukai;4026252608;Ne;12;1;3;16
17510;Spygliukas;Ežiukai;4098112375;Ne;0;3;0;3
17511;Spygliukas;Ežiukai;9321493897;Ne;5;0;0;5
17512;Spygliukas;Ežiukai;7908419787;Ne;0;0;1;1
17513;Spygliukas;Ežiukai;5366783639;Ne;0;4;0;4
17514;Spygliukas;Ežiukai;3088387895;Ne;9;0;0;9
17515;Spygliukas;Ežiukai;7287543571;Ne;5;0;1;6
17516;Spygliukas;Geniukai;8821434815;Ne;5;0;0;5
17517;Spygliukas;Geniukai;2713999021;Ne;17;0;0;17
17518;Spygliukas;Geniukai;5782501698;Ne;4;0;0;4
17519;Spygliukas;Geniukai;6700076900;Ne;0;0;6;6
17520;Spygliukas;Geniukai;8338260940;Ne;0;2;4;6
17521;Spygliukas;Geniukai;1863442354;Ne;7;1;0;8
17522;Spygliukas;Geniukai;9945315122;Ne;9;0;0;9
17523;Spygliukas;Geniukai;1291429206;Ne;0;7;0;7
17524;Spygliukas;Geniukai;7477731865;Ne;4;0;3;7
17525;Spygliukas;Geniukai;7561072315;Ne;0;0;1;1
17526;Spygliukas;Geniukai;2950722789;Ne;5;0;0;5
17527;Spygliukas;Geniukai;8093949301;Ne;0;0;1;1
17528;Spygliukas;Geniukai;9141146733;Ne;9;0;0;9
17529;Spygliukas;Geniukai;6363991196;Ne;12;3;0;15
17530;Spygliukas;Geniukai;8308394841;Ne;0;1;0;1
17531;Spygliukas;Geniukai;1127941700;Ne;2;3;0;5
17532;Spygliukas;Geniukai;9783154498;Ne;8;0;0;8
17533;Spygliukas;Geniukai;8581453160;Ne;4;0;0;4
17534;Spygliukas;Geniukai;7573756485;Ne;0;0;1;1
17535;Spygliukas;Geniukai;9770852356;Ne;5;0;2;7
17536;Spygliukas;Geniukai;1283097421;Ne;6;0;0;6
17537;Spygliukas;Riešutėliai;29449834997;Ne;5;5;5;15
17538;Spygliukas;Riešutėliai;47977103711;Ne;10;0;0;10
17539;Spygliukas;Riešutėliai;1855897974;Ne;0;2;0;2
17540;Spygliukas;Riešutėliai;1940209166;Ne;0;7;0;7
17541;Spygliukas;Riešutėliai;1939828587;Ne;0;4;2;6
17542;Spygliukas;Riešutėliai;1238940921;Ne;0;0;1;1
17543;Spygliukas;Riešutėliai;4933577424;Ne;0;4;0;4
17544;Spygliukas;Riešutėliai;9797138740;Ne;0;3;6;9
17545;Spygliukas;Riešutėliai;9001243644;Ne;10;0;5;15
17546;Spygliukas;Riešutėliai;1679263120;Ne;0;7;0;7
17547;Spygliukas;Riešutėliai;7250958367;Ne;5;4;0;9
17548;Spygliukas;Riešutėliai;9975117461;Ne;0;4;6;10
17549;Spygliukas;Riešutėliai;5022615426;Ne;6;1;1;8
17550;Spygliukas;Riešutėliai;1228469923;Ne;0;3;0;3
17551;Spygliukas;Riešutėliai;7114613140;Ne;0;4;0;4
17552;Spygliukas;Riešutėliai;4430242310;Ne;0;4;0;4
17553;Spygliukas;Riešutėliai;8103481313;Ne;0;5;0;5
17554;Spygliukas;Riešutėliai;7421000718;Ne;10;0;0;10
17555;Spygliukas;Riešutėliai;2980459339;Ne;0;1;0;1
17556;Spygliukas;Riešutėliai;4653108810;Ne;0;4;0;4
17557;Spygliukas;Riešutėliai;16828631895;Ne;0;4;0;4
17558;Spygliukas;Pelėdžiukai;1260920726;Ne;2;0;0;2
17559;Spygliukas;Pelėdžiukai;4355472423;Ne;0;2;2;4
17560;Spygliukas;Pelėdžiukai;8686118262;Ne;0;4;0;4
17561;Spygliukas;Pelėdžiukai;6242194100;Ne;5;4;0;9
17562;Spygliukas;Pelėdžiukai;8048474808;Ne;0;4;1;5
17563;Spygliukas;Pelėdžiukai;5778081118;Ne;10;0;2;12
17564;Spygliukas;Pelėdžiukai;4721066953;Ne;0;4;2;6
17565;Spygliukas;Pelėdžiukai;8331205164;Ne;13;0;0;13
17566;Spygliukas;Pelėdžiukai;4949371837;Ne;0;4;0;4
17567;Spygliukas;Pelėdžiukai;3658613027;Ne;2;0;0;2
17568;Spygliukas;Pelėdžiukai;1662885055;Ne;2;0;1;3
17569;Spygliukas;Pelėdžiukai;50047868918;Ne;2;0;1;3
17570;Spygliukas;Pelėdžiukai;3365209400;Ne;0;0;1;1
17571;Spygliukas;Pelėdžiukai;6457632191;Ne;0;0;2;2
17572;Spygliukas;Pelėdžiukai;9178184431;Ne;0;1;3;4
17573;Spygliukas;Pelėdžiukai;5962360012;Ne;0;1;0;1
17574;Spygliukas;Pelėdžiukai;2739564216;Ne;0;4;1;5
17575;Spygliukas;Pelėdžiukai;89044575245;Ne;0;7;0;7
17576;Spygliukas;Zylutės;9465470810;Ne;11;1;0;12
17577;Spygliukas;Zylutės;4417471958;Ne;11;6;4;21
17578;Spygliukas;Zylutės;4177369871;Ne;0;0;3;3
17579;Spygliukas;Zylutės;8105507156;Ne;4;1;0;5
17580;Spygliukas;Zylutės;6858338620;Ne;0;2;3;5
17581;Spygliukas;Zylutės;3066293772;Ne;0;1;0;1
17582;Spygliukas;Zylutės;3988253265;Taip;0;0;3;3
17583;Spygliukas;Zylutės;3268222954;Ne;0;1;2;3
17584;Spygliukas;Zylutės;5006372835;Ne;5;0;0;5
17585;Spygliukas;Zylutės;1729199382;Ne;4;0;0;4
17586;Spygliukas;Zylutės;8408234202;Ne;1;0;0;1
17587;Spygliukas;Zylutės;3317395260;Ne;0;2;0;2
17588;Spygliukas;Zylutės;6343141973;Ne;2;1;1;4
17589;Spygliukas;Zylutės;2632672131;Taip;0;1;0;1
17590;Spygliukas;Zylutės;5638595939;Ne;0;5;0;5
17591;Spygliukas;Skruzdėliukai;8246739374;Ne;13;0;0;13
17592;Spygliukas;Skruzdėliukai;8509447147;Ne;0;0;4;4
17593;Spygliukas;Skruzdėliukai;5739075961;Ne;11;0;0;11
17594;Spygliukas;Skruzdėliukai;7324915516;Ne;6;1;0;7
17595;Spygliukas;Skruzdėliukai;6414439254;Ne;6;1;0;7
17596;Spygliukas;Skruzdėliukai;7663839690;Ne;5;0;0;5
17597;Spygliukas;Skruzdėliukai;2738766977;Ne;5;0;0;5
17598;Spygliukas;Skruzdėliukai;8426426785;Ne;5;0;0;5
17599;Spygliukas;Skruzdėliukai;1243647769;Ne;6;0;0;6
17600;Spygliukas;Skruzdėliukai;6680699873;Ne;5;10;0;15
17601;Spygliukas;Skruzdėliukai;2955219028;Ne;11;4;0;15
17602;Spygliukas;Skruzdėliukai;1823720183;Ne;13;1;0;14
17603;Spygliukas;Skruzdėliukai;8565217488;Ne;6;0;6;12
17604;Spygliukas;Skruzdėliukai;2367685286;Ne;0;21;0;21
17605;Spygliukas;Skruzdėliukai;3065727701;Ne;8;1;0;9
17606;Spygliukas;Skruzdėliukai;1775612723;Ne;8;1;0;9
17607;Spygliukas;Skruzdėliukai;5043843336;Ne;7;0;0;7
17608;Spygliukas;Voveraitės;9112172144;Ne;6;0;3;9
17609;Spygliukas;Voveraitės;7897603878;Ne;0;6;0;6
17610;Spygliukas;Voveraitės;7741841634;Ne;0;1;0;1
17611;Spygliukas;Voveraitės;3077468722;Ne;0;5;2;7
17612;Spygliukas;Voveraitės;6587957213;Ne;0;4;0;4
17613;Spygliukas;Voveraitės;6758336405;Ne;9;1;0;10
17614;Spygliukas;Voveraitės;3668191959;Ne;4;0;0;4
17615;Spygliukas;Voveraitės;1426267001;Ne;0;1;1;2
17616;Spygliukas;Voveraitės;8189748611;Ne;0;4;0;4
17617;Spygliukas;Voveraitės;8877911083;Ne;0;5;0;5
17618;Spygliukas;Voveraitės;6405496193;Ne;0;1;3;4
17619;Spygliukas;Voveraitės;7113913750;Ne;0;3;0;3
17620;Spygliukas;Voveraitės;9231097598;Ne;0;5;2;7
17621;Spygliukas;Voveraitės;4681061579;Ne;8;0;0;8
17622;Spygliukas;Voveraitės;1234195733;Ne;0;7;0;7
17623;Spygliukas;Giliukų;6015646417;Ne;10;0;0;10
17624;Spygliukas;Giliukų;1761340174;Ne;5;0;0;5
17625;Spygliukas;Giliukų;4854168938;Taip;18;0;1;19
17626;Spygliukas;Giliukų;7460280684;Ne;13;0;0;13
17627;Spygliukas;Giliukų;4429961491;Ne;20;0;0;20
17628;Spygliukas;Giliukų;8821028259;Ne;9;0;1;10
17629;Spygliukas;Giliukų;6485350404;Ne;17;4;0;21
17630;Spygliukas;Giliukų;3237501537;Ne;5;6;0;11
17631;Spygliukas;Giliukų;8722863277;Ne;5;6;0;11
17632;Spygliukas;Giliukų;9025238241;Ne;5;4;0;9
17633;Spygliukas;Giliukų;3603606800;Ne;2;2;3;7
17634;Spygliukas;Giliukų;6290439938;Ne;6;1;0;7
17635;Spygliukas;Giliukų;7776811391;Ne;14;2;0;16
17636;Spygliukas;Giliukų;3777763305;Ne;0;1;0;1
17637;Spygliukas;Giliukų;4626877679;Ne;2;1;4;7
17638;Spygliukas;Giliukų;5255993275;Taip;1;0;8;9
17639;Spygliukas;Drugeliai;7271659513;Ne;4;7;0;11
17640;Spygliukas;Drugeliai;8604767396;Ne;3;1;0;4
17641;Spygliukas;Drugeliai;4634660174;Ne;0;2;5;7
17642;Spygliukas;Drugeliai;7924880159;Ne;10;0;0;10
17643;Spygliukas;Drugeliai;4368224847;Ne;2;1;5;8
17644;Spygliukas;Drugeliai;9316731983;Ne;6;0;1;7
17645;Spygliukas;Drugeliai;6630979640;Ne;5;1;0;6
17646;Spygliukas;Drugeliai;5012876830;Ne;0;0;1;1
17647;Spygliukas;Drugeliai;2315421636;Ne;0;4;1;5
17648;Spygliukas;Drugeliai;7125425492;Ne;0;4;0;4
17649;Spygliukas;Drugeliai;5214431060;Ne;4;0;0;4
17650;Spygliukas;Drugeliai;7928675053;Taip;5;0;0;5
17651;Spygliukas;Drugeliai;9052337501;Ne;4;4;4;12
17652;Spygliukas;Drugeliai;4505044604;Ne;0;6;0;6
17653;Spygliukas;Drugeliai;2989701249;Ne;4;0;1;5
17654;Spygliukas;Drugeliai;9086986643;Taip;0;1;0;1
17655;Spygliukas;Drugeliai;8646122773;Ne;9;4;0;13
17656;Vieversys;Žirniukai;7029322013;Ne;0;1;0;1
17657;Vieversys;Žirniukai;2266222087;Ne;6;0;0;6
17658;Vieversys;Žirniukai;2869545222;Ne;11;0;3;14
17659;Vieversys;Žirniukai;2024837493;Ne;0;9;1;10
17660;Vieversys;Žirniukai;8129566710;Ne;5;4;1;10
17661;Vieversys;Žirniukai;6052943894;Ne;0;5;0;5
17662;Vieversys;Žirniukai;3295424711;Ne;3;0;0;3
17663;Vieversys;Žirniukai;7309040730;Ne;0;0;1;1
17664;Vieversys;Žirniukai;3575906273;Ne;4;0;0;4
17665;Vieversys;Žirniukai;9856798869;Ne;0;5;0;5
17666;Vieversys;Žirniukai;3533711179;Ne;0;5;0;5
17667;Vieversys;Žirniukai;2242368843;Ne;0;0;2;2
17668;Vieversys;Varpelių;9463693741;Ne;6;0;1;7
17669;Vieversys;Varpelių;1924774817;Ne;4;2;0;6
17670;Vieversys;Varpelių;3595005599;Ne;0;0;4;4
17671;Vieversys;Varpelių;9155896981;Ne;3;1;0;4
17672;Vieversys;Varpelių;9580031042;Ne;0;4;0;4
17673;Vieversys;Varpelių;2635722489;Ne;0;5;0;5
17674;Vieversys;Varpelių;3262738994;Ne;0;2;0;2
17675;Vieversys;Varpelių;8350070741;Ne;5;0;0;5
17676;Vieversys;Varpelių;9453100342;Ne;0;0;1;1
17677;Vieversys;Varpelių;2956566201;Ne;10;0;0;10
17678;Vieversys;Varpelių;1727558984;Ne;0;0;10;10
17679;Vieversys;Varpelių;3297728501;Ne;0;1;0;1
17680;Vieversys;Varpelių;3780226431;Ne;4;0;0;4
17681;Vieversys;Varpelių;3572628491;Taip;0;0;2;2
17682;Vieversys;Varpelių;7611047781;Ne;4;0;0;4
17683;Vieversys;Varpelių;8079885165;Ne;4;17;0;21
17684;Vieversys;Kiškučių;5922485482;Ne;0;1;0;1
17685;Vieversys;Kiškučių;3917758713;Ne;2;5;0;7
17686;Vieversys;Kiškučių;9387421639;Ne;0;4;4;8
17687;Vieversys;Kiškučių;2383765752;Ne;0;4;0;4
17688;Vieversys;Kiškučių;1247565595;Ne;0;4;0;4
17689;Vieversys;Kiškučių;7812227428;Ne;0;5;0;5
17690;Vieversys;Kiškučių;53977164888;Ne;0;5;0;5
17691;Vieversys;Kiškučių;5810605263;Ne;0;6;0;6
17692;Vieversys;Kiškučių;3205204176;Ne;0;0;5;5
17693;Vieversys;Kiškučių;82594887399;Ne;0;4;0;4
17694;Vieversys;Kiškučių;6787960120;Ne;0;3;2;5
17695;Vieversys;Kiškučių;9612415733;Ne;0;4;0;4
17696;Vieversys;Kiškučių;1728554204;Ne;0;1;2;3
17697;Vieversys;Kiškučių;5286521728;Ne;5;4;3;12
17698;Vieversys;Kiškučių;1149316471;Ne;0;9;0;9
17699;Vieversys;Kiškučių;7500147648;Ne;1;5;0;6
17700;Vieversys;Kiškučių;4313822180;Ne;5;2;0;7
17701;Vieversys;Kiškučių;8038341998;Ne;5;0;0;5
17702;Vieversys;Kiškučių;5917328379;Ne;5;1;0;6
17703;Vieversys;Kiškučių;6720355390;Ne;0;0;6;6
17704;Vieversys;Kiškučių;1933907389;Ne;0;5;4;9
17705;Vieversys;Pelėdžiukų;8421719030;Ne;0;2;1;3
17706;Vieversys;Pelėdžiukų;77272293257;Ne;0;0;2;2
17707;Vieversys;Pelėdžiukų;94463134058;Ne;0;4;0;4
17708;Vieversys;Pelėdžiukų;7578552471;Ne;0;3;0;3
17709;Vieversys;Pelėdžiukų;2193074123;Ne;0;2;2;4
17710;Vieversys;Pelėdžiukų;9774365819;Ne;0;4;2;6
17711;Vieversys;Pelėdžiukų;2521488728;Ne;0;1;4;5
17712;Vieversys;Pelėdžiukų;6473759470;Ne;0;7;0;7
17713;Vieversys;Pelėdžiukų;1273951001;Ne;3;1;2;6
17714;Vieversys;Pelėdžiukų;48430863473;Ne;0;1;0;1
17715;Vieversys;Pelėdžiukų;50181034746;Ne;5;0;0;5
17716;Vieversys;Pelėdžiukų;1027693153;Ne;0;0;1;1
17717;Vieversys;Pelėdžiukų;5871715452;Ne;0;1;1;2
17718;Vieversys;Pelėdžiukų;3458399180;Ne;0;2;1;3
17719;Vieversys;Pelėdžiukų;1361156816;Ne;1;4;1;6
17720;Vieversys;Pelėdžiukų;4216521988;Ne;0;0;2;2
17721;Vieversys;Pelėdžiukų;3755410640;Ne;4;0;0;4
17722;Vieversys;Pelėdžiukų;1322495361;Ne;0;4;0;4
17723;Vieversys;Saulučių;3164280186;Ne;0;0;4;4
17724;Vieversys;Saulučių;3405502715;Ne;0;2;0;2
17725;Vieversys;Saulučių;6127272124;Ne;0;0;2;2
17726;Vieversys;Saulučių;4892622551;Ne;0;0;2;2
17727;Vieversys;Saulučių;5654533451;Ne;0;4;2;6
17728;Vieversys;Saulučių;9985374057;Ne;5;4;0;9
17729;Vieversys;Saulučių;1748006118;Ne;0;2;0;2
17730;Vieversys;Saulučių;4690095102;Ne;0;4;0;4
17731;Vieversys;Saulučių;7048475906;Ne;10;0;0;10
17732;Vieversys;Saulučių;7596355010;Ne;0;3;1;4
17733;Vieversys;Saulučių;3360981720;Ne;0;2;0;2
17734;Vieversys;Saulučių;9322322737;Ne;11;0;1;12
17735;Vieversys;Kregždučių;3156245273;Ne;0;1;4;5
17736;Vieversys;Kregždučių;5645852451;Ne;0;0;1;1
17737;Vieversys;Kregždučių;9088171869;Ne;8;0;5;13
17738;Vieversys;Kregždučių;7998100115;Ne;0;3;0;3
17739;Vieversys;Kregždučių;9093088054;Ne;0;8;0;8
17740;Vieversys;Kregždučių;2849852593;Ne;6;0;0;6
17741;Vieversys;Kregždučių;6808541662;Ne;0;2;0;2
17742;Vieversys;Kregždučių;2529690060;Ne;0;4;1;5
17743;Vieversys;Kregždučių;7568415178;Ne;6;0;0;6
17744;Vieversys;Kregždučių;8141710663;Ne;5;4;2;11
17745;Vieversys;Kregždučių;6157594693;Ne;4;6;0;10
17746;Vieversys;Kregždučių;1322953831;Ne;0;5;0;5
17747;Vieversys;Kregždučių;9090281352;Ne;4;0;0;4
17748;Vieversys;Kregždučių;4308330177;Ne;8;0;0;8
17749;Vieversys;Kregždučių;4347494053;Ne;0;0;2;2
17750;Vieversys;Kregždučių;3122763958;Ne;0;2;1;3
17751;Vieversys;Kregždučių;2938302462;Ne;0;5;0;5
17752;Vieversys;Kregždučių;9577869269;Ne;0;4;2;6
17753;Vieversys;Boružėlių;6838828193;Ne;5;4;0;9
17754;Vieversys;Boružėlių;8587368497;Ne;0;6;3;9
17755;Vieversys;Boružėlių;5683183310;Ne;4;4;0;8
17756;Vieversys;Boružėlių;4565799599;Ne;0;6;0;6
17757;Vieversys;Boružėlių;7399326463;Ne;14;0;0;14
17758;Vieversys;Boružėlių;4088189914;Ne;0;3;0;3
17759;Vieversys;Boružėlių;7364582681;Ne;0;4;0;4
17760;Vieversys;Boružėlių;9826657384;Ne;5;0;0;5
17761;Vieversys;Boružėlių;3731412573;Ne;5;1;0;6
17762;Vieversys;Boružėlių;9255292099;Taip;5;5;0;10
17763;Vieversys;Boružėlių;7429565381;Ne;0;5;4;9
17764;Vieversys;Boružėlių;4297477514;Taip;7;0;0;7
17765;Vieversys;Boružėlių;8816714193;Ne;0;2;1;3
17766;Vieversys;Boružėlių;2701284187;Ne;5;3;0;8
17767;Vieversys;Boružėlių;6234199996;Ne;5;0;0;5
17768;Vieversys;Bitučių;8706336322;Ne;0;5;0;5
17769;Vieversys;Bitučių;5966170543;Ne;0;1;0;1
17770;Vieversys;Bitučių;5210732072;Ne;5;1;1;7
17771;Vieversys;Bitučių;9188208330;Ne;0;1;2;3
17772;Vieversys;Bitučių;9454017990;Taip;0;0;21;21
17773;Vieversys;Bitučių;9476611261;Ne;21;0;0;21
17774;Vieversys;Bitučių;6083402842;Ne;0;0;1;1
17775;Vieversys;Bitučių;4428101863;Ne;0;2;0;2
17776;Vieversys;Bitučių;4335653911;Ne;4;0;0;4
17777;Vieversys;Bitučių;9978867863;Ne;0;7;0;7
17778;Vieversys;Bitučių;9092693925;Ne;0;0;1;1
17779;Vieversys;Bitučių;2661027772;Ne;2;0;0;2
17780;Vieversys;Bitučių;3601928285;Ne;0;2;0;2
17781;Vieversys;Bitučių;8492908398;Ne;0;11;0;11
17782;Vieversys;Bitučių;5479620291;Ne;15;0;0;15
17783;Vieversys;Bitučių;5417413393;Ne;0;0;5;5
17784;Vieversys;Smalsučių;3681120339;Ne;0;21;0;21
17785;Vieversys;Smalsučių;9164615794;Ne;6;1;0;7
17786;Vieversys;Smalsučių;3684937630;Ne;0;0;6;6
17787;Vieversys;Smalsučių;6563139211;Ne;0;4;2;6
17788;Vieversys;Smalsučių;4294676988;Ne;11;3;0;14
17789;Vieversys;Smalsučių;4835022593;Ne;5;0;1;6
17790;Vieversys;Smalsučių;3249717073;Ne;0;8;1;9
17791;Vieversys;Smalsučių;7120329258;Ne;0;1;0;1
17792;Vieversys;Smalsučių;8174124875;Ne;7;5;0;12
17793;Vieversys;Smalsučių;5769453869;Ne;0;4;0;4
17794;Vieversys;Smalsučių;5907903394;Ne;0;11;10;21
17795;Vieversys;Smalsučių;3946609345;Ne;0;5;8;13
17796;Vieversys;Smalsučių;9686787125;Ne;0;4;0;4
17797;Vieversys;Smalsučių;4455039401;Ne;8;4;2;14
17798;Vieversys;Smalsučių;8129139979;Ne;6;1;0;7
17799;Vieversys;Smalsučių;9835682858;Ne;0;19;1;20
17800;Vieversys;Smalsučių;7007620994;Ne;0;2;10;12
17801;Vieversys;Smalsučių;9494957750;Ne;0;3;2;5
17802;Vieversys;Kodėlčiukų;9217208794;Ne;0;21;0;21
17803;Vieversys;Kodėlčiukų;5037806018;Ne;0;4;0;4
17804;Vieversys;Kodėlčiukų;1752359969;Ne;0;3;0;3
17805;Vieversys;Kodėlčiukų;6791121542;Ne;0;6;1;7
17806;Vieversys;Kodėlčiukų;5898422871;Ne;4;4;0;8
17807;Vieversys;Kodėlčiukų;6709556873;Ne;0;2;0;2
17808;Vieversys;Kodėlčiukų;7453156612;Ne;0;0;1;1
17809;Vieversys;Kodėlčiukų;6926960486;Ne;0;1;0;1
17810;Vieversys;Kodėlčiukų;3180687885;Ne;2;4;0;6
17811;Vieversys;Kodėlčiukų;1881076551;Ne;0;0;4;4
17812;Vieversys;Kodėlčiukų;2562413607;Ne;0;0;3;3
17813;Vieversys;Kodėlčiukų;9965162863;Ne;0;1;0;1
17814;Vieversys;Kodėlčiukų;4702339508;Ne;6;5;3;14
17815;Vieversys;Kodėlčiukų;4631238425;Ne;0;1;0;1
17816;Vieversys;Kodėlčiukų;8512643926;Ne;4;6;1;11
17817;Vieversys;Kodėlčiukų;7967372524;Ne;14;5;0;19
17818;Vieversys;Kodėlčiukų;4703696958;Ne;0;5;0;5
17819;Vieversys;Kodėlčiukų;9747443326;Ne;5;0;0;5
17820;Vieversys;NYKŠTUKAI;3332069842;Ne;7;0;0;7
17821;Vieversys;NYKŠTUKAI;2107000312;Ne;18;2;1;21
17822;Vieversys;NYKŠTUKAI;7539934804;Ne;1;0;0;1
17823;Vieversys;NYKŠTUKAI;1714096583;Ne;5;0;0;5
17824;Vieversys;NYKŠTUKAI;8371839883;Ne;6;0;1;7
17825;Vieversys;NYKŠTUKAI;6631296204;Ne;5;0;0;5
17826;Vieversys;NYKŠTUKAI;5394635510;Ne;0;0;3;3
17827;Vieversys;NYKŠTUKAI;1160455554;Ne;0;5;2;7
17828;Vieversys;NYKŠTUKAI;8200432952;Ne;7;0;0;7
17829;Vieversys;NYKŠTUKAI;2535992834;Ne;9;0;0;9
17830;Vieversys;NYKŠTUKAI;4974924858;Ne;0;2;0;2
17831;Vieversys;NYKŠTUKAI;7111551694;Ne;10;0;0;10
17832;Vieversys;NYKŠTUKAI;7778432049;Ne;0;21;0;21
17833;Vieversys;NYKŠTUKAI;4952182897;Ne;2;0;0;2
17834;Vieversys;DRUGELIAI;2638813853;Ne;2;19;0;21
17835;Vieversys;DRUGELIAI;9412299328;Ne;11;0;0;11
17836;Vieversys;DRUGELIAI;7508850558;Ne;0;4;0;4
17837;Vieversys;DRUGELIAI;6669012722;Ne;16;0;0;16
17838;Vieversys;DRUGELIAI;6000875464;Ne;0;3;2;5
17839;Vieversys;DRUGELIAI;7708807923;Ne;5;0;0;5
17840;Vieversys;DRUGELIAI;5580265718;Ne;0;0;21;21
17841;Vieversys;DRUGELIAI;4129333932;Ne;0;21;0;21
17842;Vieversys;DRUGELIAI;8199984460;Ne;0;21;0;21
17843;Vieversys;DRUGELIAI;9666764935;Ne;0;0;16;16
17844;Vieversys;DRUGELIAI;8966020793;Ne;10;0;1;11
17845;Vieversys;DRUGELIAI;5164567779;Ne;0;1;0;1
17846;Vieversys;DRUGELIAI;1720061988;Ne;6;3;0;9
17847;Vieversys;DRUGELIAI;6014448044;Ne;8;3;0;11
17848;Žirmūnėliai;SAULUTĖS;5560694124;Ne;2;1;0;3
17849;Žirmūnėliai;SAULUTĖS;6116321928;Ne;2;0;0;2
17850;Žirmūnėliai;SAULUTĖS;2310523676;Ne;0;1;0;1
17851;Žirmūnėliai;SAULUTĖS;4922028935;Ne;0;5;0;5
17852;Žirmūnėliai;SAULUTĖS;1948299433;Ne;1;1;0;2
17853;Žirmūnėliai;SAULUTĖS;5626711530;Ne;5;6;0;11
17854;Žirmūnėliai;SAULUTĖS;3902161368;Ne;1;4;0;5
17855;Žirmūnėliai;SAULUTĖS;6072407337;Ne;4;0;0;4
17856;Žirmūnėliai;SAULUTĖS;4793967980;Ne;10;4;0;14
17857;Žirmūnėliai;SAULUTĖS;6177408775;Ne;1;1;0;2
17858;Žirmūnėliai;SAULUTĖS;8242112212;Ne;0;3;2;5
17859;Žirmūnėliai;SAULUTĖS;1940552890;Ne;0;4;0;4
17860;Žirmūnėliai;SAULUTĖS;2392106040;Ne;0;6;0;6
17861;Žirmūnėliai;SAULUTĖS;4343419766;Ne;0;7;0;7
17862;Žirmūnėliai;SAULUTĖS;9145626116;Ne;10;0;11;21
17863;Žirmūnėliai;SAULUTĖS;7675488865;Ne;0;7;0;7
17864;Žirmūnėliai;SAULUTĖS;8345632807;Ne;0;7;0;7
17865;Žirmūnėliai;GILIUKAI;6430944858;Ne;0;0;1;1
17866;Žirmūnėliai;GILIUKAI;3562689670;Ne;0;12;0;12
17867;Žirmūnėliai;GILIUKAI;5929166560;Ne;0;2;0;2
17868;Žirmūnėliai;GILIUKAI;3767421827;Ne;4;1;0;5
17869;Žirmūnėliai;GILIUKAI;5104310002;Ne;0;2;3;5
17870;Žirmūnėliai;GILIUKAI;1025809131;Ne;7;0;0;7
17871;Žirmūnėliai;GILIUKAI;6899109664;Ne;0;3;0;3
17872;Žirmūnėliai;GILIUKAI;1473482823;Ne;10;0;0;10
17873;Žirmūnėliai;GILIUKAI;7410921362;Ne;0;2;0;2
17874;Žirmūnėliai;GILIUKAI;8627403283;Ne;0;0;5;5
17875;Žirmūnėliai;GILIUKAI;5089884149;Ne;0;0;4;4
17876;Žirmūnėliai;GILIUKAI;1791977446;Ne;0;2;0;2
17877;Žirmūnėliai;GILIUKAI;6875484657;Ne;7;4;1;12
17878;Žirmūnėliai;GILIUKAI;9871163622;Ne;0;7;0;7
17879;Žirmūnėliai;GILIUKAI;3532895278;Ne;0;2;0;2
17880;Žirmūnėliai;GILIUKAI;8459217612;Ne;4;0;0;4
17881;Žirmūnėliai;GILIUKAI;2959090234;Ne;0;0;3;3
17882;Žirmūnėliai;GILIUKAI;8618410295;Ne;6;2;0;8
17883;Žirmūnėliai;GILIUKAI;1941509002;Ne;6;0;9;15
17884;Žirmūnėliai;DRUGELIAI;7020486370;Ne;0;4;0;4
17885;Žirmūnėliai;DRUGELIAI;3449815783;Ne;0;4;0;4
17886;Žirmūnėliai;DRUGELIAI;9541122034;Ne;0;4;0;4
17887;Žirmūnėliai;DRUGELIAI;5736502380;Ne;0;4;0;4
17888;Žirmūnėliai;DRUGELIAI;9378860669;Ne;0;1;0;1
17889;Žirmūnėliai;DRUGELIAI;8607934394;Ne;0;6;0;6
17890;Žirmūnėliai;DRUGELIAI;5723289396;Ne;8;0;0;8
17891;Žirmūnėliai;DRUGELIAI;7892626521;Ne;0;8;0;8
17892;Žirmūnėliai;DRUGELIAI;8999160836;Ne;0;4;0;4
17893;Žirmūnėliai;DRUGELIAI;8209309240;Ne;0;2;0;2
17894;Žirmūnėliai;DRUGELIAI;2837129621;Ne;6;5;0;11
17895;Žirmūnėliai;DRUGELIAI;1273684243;Ne;1;0;3;4
17896;Žirmūnėliai;DRUGELIAI;2971175236;Ne;0;5;0;5
17897;Žirmūnėliai;DRUGELIAI;6594728970;Ne;0;6;2;8
17898;Žirmūnėliai;DRUGELIAI;7422544482;Ne;0;3;0;3
17899;Žirmūnėliai;DRUGELIAI;4336415033;Ne;5;0;0;5
17900;Žirmūnėliai;DRUGELIAI;9241738140;Ne;0;4;0;4
17901;Žirmūnėliai;BORUŽIUKAI;52420072025;Ne;0;0;1;1
17902;Žirmūnėliai;BORUŽIUKAI;4796654075;Ne;0;1;2;3
17903;Žirmūnėliai;BORUŽIUKAI;1234956674;Ne;0;3;0;3
17904;Žirmūnėliai;BORUŽIUKAI;9926432375;Ne;0;8;0;8
17905;Žirmūnėliai;BORUŽIUKAI;2739395691;Ne;0;2;0;2
17906;Žirmūnėliai;BORUŽIUKAI;3351861764;Ne;0;17;0;17
17907;Žirmūnėliai;BORUŽIUKAI;6161223611;Ne;0;3;0;3
17908;Žirmūnėliai;BORUŽIUKAI;5611315994;Ne;0;1;0;1
17909;Žirmūnėliai;BORUŽIUKAI;7528704460;Ne;0;1;0;1
17910;Žirmūnėliai;BORUŽIUKAI;1618573494;Ne;0;4;7;11
17911;Žirmūnėliai;BORUŽIUKAI;31403739893;Ne;5;4;3;12
17912;Žirmūnėliai;BORUŽIUKAI;6647641423;Ne;0;0;6;6
17913;Žirmūnėliai;BORUŽIUKAI;5367009184;Ne;0;4;2;6
17914;Žirmūnėliai;BORUŽIUKAI;8623037038;Ne;0;1;0;1
17915;Žirmūnėliai;BORUŽIUKAI;3540307559;Ne;0;5;2;7
17916;Žirmūnėliai;BORUŽIUKAI;5125341440;Ne;0;1;0;1
17917;Žirmūnėliai;BORUŽIUKAI;1865240339;Ne;9;0;0;9
17918;Žirmūnėliai;BORUŽIUKAI;6337036947;Ne;0;6;1;7
17919;Žirmūnėliai;BORUŽIUKAI;3274576752;Ne;0;4;0;4
17920;Žirmūnėliai;BORUŽIUKAI;8339819296;Ne;0;1;0;1
17921;Žirmūnėliai;BORUŽIUKAI;2033271165;Ne;0;6;1;7
17922;Žirmūnėliai;EŽIUKAI;7011701994;Ne;0;1;0;1
17923;Žirmūnėliai;EŽIUKAI;2661052835;Ne;0;6;0;6
17924;Žirmūnėliai;EŽIUKAI;1655437833;Ne;0;4;0;4
17925;Žirmūnėliai;EŽIUKAI;3640979388;Ne;10;3;1;14
17926;Žirmūnėliai;EŽIUKAI;6878528100;Ne;0;8;3;11
17927;Žirmūnėliai;EŽIUKAI;8440187348;Ne;2;5;0;7
17928;Žirmūnėliai;EŽIUKAI;4565479092;Ne;0;3;0;3
17929;Žirmūnėliai;EŽIUKAI;4968278870;Ne;6;2;5;13
17930;Žirmūnėliai;EŽIUKAI;2693415717;Ne;0;7;0;7
17931;Žirmūnėliai;EŽIUKAI;7953019230;Ne;0;11;0;11
17932;Žirmūnėliai;EŽIUKAI;1832367936;Ne;0;0;6;6
17933;Žirmūnėliai;EŽIUKAI;3180116136;Ne;0;6;2;8
17934;Žirmūnėliai;EŽIUKAI;9759491055;Ne;0;0;4;4
17935;Žirmūnėliai;EŽIUKAI;1127214387;Ne;4;2;3;9
17936;Žirmūnėliai;EŽIUKAI;4101748829;Ne;0;5;0;5
17937;Žirmūnėliai;EŽIUKAI;2379638934;Ne;0;9;0;9
17938;Žirmūnėliai;EŽIUKAI;6448582622;Ne;11;6;0;17
17939;Žirmūnėliai;EŽIUKAI;4710829908;Ne;0;5;0;5
17940;Žirmūnėliai;EŽIUKAI;7996709950;Ne;0;6;0;6
17941;Žirmūnėliai;EŽIUKAI;7580002502;Ne;10;0;1;11
17942;Žirmūnėliai;EŽIUKAI;4638575301;Ne;0;2;0;2
17943;Žirmūnėliai;EŽIUKAI;3310847619;Ne;0;0;5;5
17944;Žirmūnėliai;EŽIUKAI;1977798059;Ne;0;4;15;19
17945;Žirmūnėliai;ŽVIRBLIUKAI;6896145409;Ne;2;1;0;3
17946;Žirmūnėliai;ŽVIRBLIUKAI;1255857051;Ne;0;4;3;7
17947;Žirmūnėliai;ŽVIRBLIUKAI;1347664230;Ne;0;4;9;13
17948;Žirmūnėliai;ŽVIRBLIUKAI;8030469722;Ne;4;0;0;4
17949;Žirmūnėliai;ŽVIRBLIUKAI;3166454638;Ne;2;3;0;5
17950;Žirmūnėliai;ŽVIRBLIUKAI;4517290068;Ne;3;1;0;4
17951;Žirmūnėliai;ŽVIRBLIUKAI;1582563837;Ne;6;2;0;8
17952;Žirmūnėliai;ŽVIRBLIUKAI;1381923106;Ne;0;6;0;6
17953;Žirmūnėliai;ŽVIRBLIUKAI;1725143117;Ne;2;6;4;12
17954;Žirmūnėliai;ŽVIRBLIUKAI;1478039469;Ne;6;0;0;6
17955;Žirmūnėliai;ŽVIRBLIUKAI;1073135587;Ne;0;4;0;4
17956;Žirmūnėliai;ŽVIRBLIUKAI;4598761492;Ne;0;4;0;4
17957;Žirmūnėliai;ŽVIRBLIUKAI;1435743911;Ne;0;3;0;3
17958;Žirmūnėliai;ŽVIRBLIUKAI;8308074932;Ne;0;6;1;7
17959;Žirmūnėliai;ŽVIRBLIUKAI;1761284228;Ne;0;4;0;4
17960;Žirmūnėliai;ŽVIRBLIUKAI;41018224936;Ne;5;3;0;8
17961;Žirmūnėliai;ŽVIRBLIUKAI;1894070647;Ne;5;2;1;8
17962;Žirmūnėliai;ŽVIRBLIUKAI;9482910388;Ne;0;8;0;8
17963;Žirmūnėliai;ŽVIRBLIUKAI;1569772948;Ne;0;4;0;4
17964;Žirmūnėliai;SPALVELĖS;4815427530;Ne;10;0;0;10
17965;Žirmūnėliai;SPALVELĖS;6641667315;Ne;0;5;0;5
17966;Žirmūnėliai;SPALVELĖS;9936156579;Ne;0;3;0;3
17967;Žirmūnėliai;SPALVELĖS;2985092368;Ne;4;2;1;7
17968;Žirmūnėliai;SPALVELĖS;5154076629;Ne;0;3;0;3
17969;Žirmūnėliai;SPALVELĖS;1401001989;Ne;0;1;0;1
17970;Žirmūnėliai;SPALVELĖS;2841958534;Ne;0;6;0;6
17971;Žirmūnėliai;SPALVELĖS;6259368139;Ne;9;0;0;9
17972;Žirmūnėliai;SPALVELĖS;1356219744;Ne;0;16;0;16
17973;Žirmūnėliai;SPALVELĖS;8538773532;Ne;0;5;0;5
17974;Žirmūnėliai;SPALVELĖS;6934204209;Ne;2;0;0;2
17975;Žirmūnėliai;SPALVELĖS;3458810185;Ne;0;2;1;3
17976;Žirmūnėliai;SPALVELĖS;9306935083;Ne;0;1;0;1
17977;Žirmūnėliai;SPALVELĖS;5316869112;Ne;0;13;0;13
17978;Žirmūnėliai;SPALVELĖS;4807331877;Ne;2;0;8;10
17979;Žirmūnėliai;SPALVELĖS;8742911909;Ne;0;9;0;9
17980;Žirmūnėliai;SPALVELĖS;6817236579;Ne;21;0;0;21
17981;Žirmūnėliai;SPALVELĖS;9042509512;Ne;15;3;0;18
17982;Žirmūnėliai;SPALVELĖS;5076712824;Ne;0;1;0;1
17983;Žirmūnėliai;SPALVELĖS;8444883234;Ne;0;5;0;5
17984;Žirmūnėliai;DEBESĖLIAI;6908512961;Ne;0;5;3;8
17985;Žirmūnėliai;DEBESĖLIAI;2866010286;Ne;3;0;0;3
17986;Žirmūnėliai;DEBESĖLIAI;3431320961;Ne;0;2;0;2
17987;Žirmūnėliai;DEBESĖLIAI;7087770068;Ne;0;6;0;6
17988;Žirmūnėliai;DEBESĖLIAI;4347548125;Ne;18;0;5;23
17989;Žirmūnėliai;DEBESĖLIAI;3330603362;Ne;8;0;5;13
17990;Žirmūnėliai;DEBESĖLIAI;5440814849;Ne;0;6;0;6
17991;Žirmūnėliai;DEBESĖLIAI;7680479258;Ne;0;0;6;6
17992;Žirmūnėliai;DEBESĖLIAI;8136265008;Ne;4;20;0;24
17993;Žirmūnėliai;DEBESĖLIAI;7568228423;Ne;0;0;3;3
17994;Žirmūnėliai;DEBESĖLIAI;9813507899;Ne;21;0;0;21
17995;Žirmūnėliai;DEBESĖLIAI;8687642039;Ne;6;0;3;9
17996;Žirmūnėliai;DEBESĖLIAI;5982848146;Ne;12;6;0;18
17997;Žirmūnėliai;DEBESĖLIAI;5676730437;Ne;5;0;0;5
17998;Žirmūnėliai;DEBESĖLIAI;4653124134;Ne;0;4;1;5
17999;Žirmūnėliai;DEBESĖLIAI;4501490189;Ne;21;0;1;22
18000;Žirmūnėliai;DEBESĖLIAI;8239982682;Ne;0;0;2;2
18001;Žirmūnėliai;VIŠČIUKAI;2270868598;Ne;0;1;0;1
18002;Žirmūnėliai;VIŠČIUKAI;2802717644;Ne;0;4;0;4
18003;Žirmūnėliai;VIŠČIUKAI;3029428022;Ne;14;0;1;15
18004;Žirmūnėliai;VIŠČIUKAI;9759504463;Ne;6;0;1;7
18005;Žirmūnėliai;VIŠČIUKAI;4134541560;Ne;5;0;0;5
18006;Žirmūnėliai;VIŠČIUKAI;8481357052;Ne;7;0;1;8
18007;Žirmūnėliai;VIŠČIUKAI;6892941066;Ne;0;2;1;3
18008;Žirmūnėliai;VIŠČIUKAI;9858198555;Ne;3;1;0;4
18009;Žirmūnėliai;VIŠČIUKAI;3641319043;Ne;5;0;0;5
18010;Žirmūnėliai;VIŠČIUKAI;6523502376;Ne;13;0;0;13
18011;Žirmūnėliai;VIŠČIUKAI;9280663182;Ne;0;5;0;5
18012;Žirmūnėliai;VIŠČIUKAI;5281338626;Ne;0;2;0;2
18013;Žirmūnėliai;VIŠČIUKAI;9688006040;Ne;16;0;2;18
18014;Žirmūnėliai;VIŠČIUKAI;5622319185;Ne;12;0;0;12
18015;Žirmūnėliai;VIŠČIUKAI;7053321410;Ne;17;0;1;18
18016;Žirmūnėliai;VIŠČIUKAI;4512970900;Ne;2;4;0;6
18017;Žirmūnėliai;ZUIKUČIŲ;4291114238;Ne;0;4;0;4
18018;Žirmūnėliai;ZUIKUČIŲ;3762889366;Ne;11;0;0;11
18019;Žirmūnėliai;ZUIKUČIŲ;3977279181;Ne;7;2;0;9
18020;Žirmūnėliai;ZUIKUČIŲ;8002655555;Ne;0;12;0;12
18021;Žirmūnėliai;ZUIKUČIŲ;2736632324;Ne;0;2;0;2
18022;Žirmūnėliai;ZUIKUČIŲ;5892153807;Ne;6;1;0;7
18023;Žirmūnėliai;ZUIKUČIŲ;2870069039;Ne;0;3;0;3
18024;Žirmūnėliai;ZUIKUČIŲ;8271996884;Ne;0;1;0;1
18025;Žirmūnėliai;ZUIKUČIŲ;3012945005;Ne;14;0;0;14
18026;Žirmūnėliai;ZUIKUČIŲ;8782085662;Ne;8;11;0;19
18027;Žirmūnėliai;ZUIKUČIŲ;3174613910;Ne;0;2;0;2
18028;Žirmūnėliai;ZUIKUČIŲ;5668266601;Ne;0;0;6;6
18029;Žirmūnėliai;ZUIKUČIŲ;9472372819;Ne;6;1;0;7
18030;Žirmūnėliai;ZUIKUČIŲ;6812682361;Ne;0;0;3;3
18031;Žirmūnėliai;OBUOLIUKAI;4575123456;Ne;4;1;0;5
18032;Žirmūnėliai;OBUOLIUKAI;3795476732;Ne;10;0;0;10
18033;Žirmūnėliai;OBUOLIUKAI;1917500190;Ne;10;0;0;10
18034;Žirmūnėliai;OBUOLIUKAI;9002868728;Ne;0;0;3;3
18035;Žirmūnėliai;OBUOLIUKAI;2073922023;Ne;10;0;0;10
18036;Žirmūnėliai;OBUOLIUKAI;7059249540;Ne;3;6;0;9
18037;Žirmūnėliai;OBUOLIUKAI;4999561481;Ne;0;2;0;2
18038;Žirmūnėliai;OBUOLIUKAI;6358006462;Ne;0;6;0;6
18039;Žirmūnėliai;OBUOLIUKAI;2497258407;Ne;0;8;0;8
18040;Žirmūnėliai;OBUOLIUKAI;3949374730;Ne;0;5;0;5
18041;Žirmūnėliai;OBUOLIUKAI;6869102228;Ne;0;2;0;2
18042;Žirmūnėliai;OBUOLIUKAI;9367849317;Ne;0;2;0;2
18043;Žirmūnėliai;OBUOLIUKAI;9892620134;Ne;0;0;1;1
18044;Žirmūnėliai;OBUOLIUKAI;6450412481;Ne;0;6;0;6
18045;Žirmūnėliai;OBUOLIUKAI;1523231731;Ne;11;0;0;11
18046;Žirmūnėliai;OBUOLIUKAI;9225654910;Ne;0;4;0;4
18047;Žirmūnėliai;OBUOLIUKAI;5483418311;Ne;0;1;0;1
18048;Žirmūnėliai;OBUOLIUKAI;7945713337;Ne;0;4;0;4
18049;Žirmūnėliai;OBUOLIUKAI;8823426998;Ne;11;0;0;11
18050;Žirmūnėliai;OBUOLIUKAI;2263820829;Ne;9;0;0;9
18051;Žirmūnėliai;OBUOLIUKAI;9732291476;Ne;0;0;1;1
18052;Žirmūnėliai;DAINORĖLIAI;1255294064;Ne;2;2;2;6
18053;Žirmūnėliai;DAINORĖLIAI;5616289290;Ne;8;2;0;10
18054;Žirmūnėliai;DAINORĖLIAI;3520677404;Ne;0;5;0;5
18055;Žirmūnėliai;DAINORĖLIAI;9978718231;Ne;0;1;0;1
18056;Žirmūnėliai;DAINORĖLIAI;6066212109;Ne;4;0;0;4
18057;Žirmūnėliai;DAINORĖLIAI;7589155099;Ne;10;0;0;10
18058;Žirmūnėliai;DAINORĖLIAI;4641264260;Ne;4;6;2;12
18059;Žirmūnėliai;DAINORĖLIAI;5646794795;Ne;0;0;8;8
18060;Žirmūnėliai;DAINORĖLIAI;5901940160;Ne;5;0;0;5
18061;Žirmūnėliai;DAINORĖLIAI;9908958250;Taip;0;0;14;14
18062;Žirmūnėliai;DAINORĖLIAI;1116572386;Ne;8;2;0;10
18063;Žirmūnėliai;DAINORĖLIAI;8615363279;Ne;5;1;1;7
18064;"Dainorėliai (Ankštoji g. 11)";VARPELIAI;87242570532;Ne;4;5;0;9
18065;"Dainorėliai (Ankštoji g. 11)";VARPELIAI;18233813290;Ne;0;4;0;4
18066;"Dainorėliai (Ankštoji g. 11)";VARPELIAI;6176171443;Ne;0;3;1;4
18067;"Dainorėliai (Ankštoji g. 11)";VARPELIAI;88781762328;Ne;12;4;0;16
18068;"Dainorėliai (Ankštoji g. 11)";VARPELIAI;7822546498;Ne;0;4;0;4
18069;"Dainorėliai (Ankštoji g. 11)";VARPELIAI;5693385617;Ne;0;8;0;8
18070;"Dainorėliai (Ankštoji g. 11)";VARPELIAI;8267213392;Ne;0;5;0;5
18071;"Dainorėliai (Ankštoji g. 11)";VARPELIAI;5959380807;Ne;0;4;0;4
18072;"Dainorėliai (Ankštoji g. 11)";VARPELIAI;2938732886;Ne;0;1;0;1
18073;"Dainorėliai (Ankštoji g. 11)";VARPELIAI;3183793211;Ne;0;5;8;13
18074;"Dainorėliai (Ankštoji g. 11)";VARPELIAI;65467351140;Ne;0;5;0;5
18075;"Dainorėliai (Ankštoji g. 11)";VARPELIAI;8521878734;Ne;4;5;0;9
18076;"Dainorėliai (Ankštoji g. 11)";VARPELIAI;6430425182;Ne;0;1;0;1
18077;"Dainorėliai (Ankštoji g. 11)";VARPELIAI;4269946363;Ne;0;5;0;5
18078;"Dainorėliai (Ankštoji g. 11)";VARPELIAI;1088248393;Ne;0;4;0;4
18079;"Dainorėliai (Ankštoji g. 11)";VARPELIAI;2070086316;Ne;0;2;0;2
18080;"Dainorėliai (Ankštoji g. 11)";VARPELIAI;2074070030;Ne;0;2;1;3
18081;"Dainorėliai (Ankštoji g. 11)";VARPELIAI;4591161640;Ne;0;4;0;4
18082;"Dainorėliai (Ankštoji g. 11)";VARPELIAI;6898685834;Ne;3;1;1;5
18083;"Dainorėliai (Ankštoji g. 11)";VARPELIAI;6909583023;Ne;0;3;0;3
18084;"Dainorėliai (Ankštoji g. 11)";VARPELIAI;9319771186;Ne;0;7;2;9
18085;"Dainorėliai (Ankštoji g. 11)";VARPELIAI;68134437706;Ne;0;3;0;3
18086;"Dainorėliai (Ankštoji g. 11)";ŽIOGELIAI;5591598390;Ne;10;4;0;14
18087;"Dainorėliai (Ankštoji g. 11)";ŽIOGELIAI;6481621329;Ne;0;3;0;3
18088;"Dainorėliai (Ankštoji g. 11)";ŽIOGELIAI;5715129088;Ne;6;1;5;12
18089;"Dainorėliai (Ankštoji g. 11)";ŽIOGELIAI;8140354445;Ne;0;4;0;4
18090;"Dainorėliai (Ankštoji g. 11)";ŽIOGELIAI;9132532505;Ne;0;2;0;2
18091;"Dainorėliai (Ankštoji g. 11)";ŽIOGELIAI;2450726148;Ne;0;5;0;5
18092;"Dainorėliai (Ankštoji g. 11)";ŽIOGELIAI;7591953671;Ne;16;0;2;18
18093;"Dainorėliai (Ankštoji g. 11)";ŽIOGELIAI;6169434322;Ne;7;2;0;9
18094;"Dainorėliai (Ankštoji g. 11)";ŽIOGELIAI;2094849111;Ne;7;0;0;7
18095;"Dainorėliai (Ankštoji g. 11)";ŽIOGELIAI;6659114730;Ne;5;0;2;7
18096;"Dainorėliai (Ankštoji g. 11)";ŽIOGELIAI;3887433142;Ne;4;5;0;9
18097;"Dainorėliai (Ankštoji g. 11)";ŽIOGELIAI;2541781620;Ne;2;5;0;7
18098;"Dainorėliai (Ankštoji g. 11)";ŽIOGELIAI;8239000041;Ne;0;2;1;3
18099;"Dainorėliai (Ankštoji g. 11)";ŽIOGELIAI;7984447187;Ne;7;2;2;11
18100;"Dainorėliai (Ankštoji g. 11)";ŽIOGELIAI;3897725337;Ne;6;0;0;6
18101;"Dainorėliai (Ankštoji g. 11)";ŽIOGELIAI;4307634491;Ne;0;5;0;5
18102;"Dainorėliai (Ankštoji g. 11)";ŽIOGELIAI;4973241539;Ne;10;0;0;10
18103;"Dainorėliai (Ankštoji g. 11)";ŽIOGELIAI;3592770633;Ne;7;0;0;7
18104;"Dainorėliai (Ankštoji g. 11)";ŽIOGELIAI;4969782237;Ne;0;3;0;3
18105;"Dainorėliai (Ankštoji g. 11)";DRUGELIAI;4900234806;Ne;9;0;0;9
18106;"Dainorėliai (Ankštoji g. 11)";DRUGELIAI;8962657389;Ne;0;6;0;6
18107;"Dainorėliai (Ankštoji g. 11)";DRUGELIAI;2703267758;Ne;19;0;0;19
18108;"Dainorėliai (Ankštoji g. 11)";DRUGELIAI;6899629612;Ne;14;1;0;15
18109;"Dainorėliai (Ankštoji g. 11)";DRUGELIAI;2605119306;Ne;0;4;0;4
18110;"Dainorėliai (Ankštoji g. 11)";DRUGELIAI;9976869100;Ne;0;6;0;6
18111;"Dainorėliai (Ankštoji g. 11)";DRUGELIAI;3063825996;Ne;6;0;0;6
18112;"Dainorėliai (Ankštoji g. 11)";DRUGELIAI;5854379630;Ne;0;6;0;6
18113;"Dainorėliai (Ankštoji g. 11)";DRUGELIAI;3711954197;Ne;7;0;0;7
18114;"Dainorėliai (Ankštoji g. 11)";DRUGELIAI;3573324654;Ne;5;0;0;5
18115;"Dainorėliai (Ankštoji g. 11)";DRUGELIAI;3741337791;Ne;0;6;0;6
18116;"Dainorėliai (Ankštoji g. 11)";DRUGELIAI;8088948564;Ne;5;1;0;6
18117;"Dainorėliai (Ankštoji g. 11)";DRUGELIAI;1718576253;Ne;0;2;0;2
18118;"Dainorėliai (Ankštoji g. 11)";DRUGELIAI;2803571247;Ne;0;8;0;8
18119;"Dainorėliai (Ankštoji g. 11)";DRUGELIAI;5084474142;Ne;0;7;0;7
18120;"Dainorėliai (Ankštoji g. 11)";DRUGELIAI;1332165159;Ne;16;2;0;18
18121;"Dainorėliai (Ankštoji g. 11)";DRUGELIAI;8684975630;Ne;0;10;0;10
18122;"Dainorėliai (Ankštoji g. 11)";DRUGELIAI;2740773904;Ne;0;5;0;5
18123;"Dainorėliai (Ankštoji g. 11)";DRUGELIAI;6460217912;Ne;0;6;0;6
18124;"Dainorėliai (Ankštoji g. 11)";"1 klasė";2520667095;Ne;1;4;0;5
18125;"Dainorėliai (Ankštoji g. 11)";"1 klasė";1333499160;Ne;1;4;0;5
18126;"Dainorėliai (Ankštoji g. 11)";"1 klasė";50432354832;Ne;0;4;0;4
18127;"Dainorėliai (Ankštoji g. 11)";"1 klasė";1626877066;Ne;0;4;0;4
18128;"Dainorėliai (Ankštoji g. 11)";"1 klasė";1158895670;Ne;0;4;0;4
18129;"Dainorėliai (Ankštoji g. 11)";"1 klasė";73649870571;Ne;2;4;0;6
18130;"Dainorėliai (Ankštoji g. 11)";"1 klasė";19286303769;Ne;0;4;0;4
18131;"Dainorėliai (Ankštoji g. 11)";"1 klasė";73386013083;Ne;4;4;0;8
18132;"Dainorėliai (Ankštoji g. 11)";"1 klasė";27521381629;Ne;3;4;0;7
18133;"Dainorėliai (Ankštoji g. 11)";"1 klasė";53935690864;Ne;0;4;0;4
18134;"Dainorėliai (Ankštoji g. 11)";"1 klasė";6411939690;Ne;0;4;0;4
18135;"Dainorėliai (Ankštoji g. 11)";"1 klasė";2287353933;Ne;7;4;0;11
18136;"Dainorėliai (Ankštoji g. 11)";"1 klasė";36313982965;Ne;4;4;0;8
18137;"Dainorėliai (Ankštoji g. 11)";"1 klasė";86659723162;Ne;0;4;0;4
18138;"Dainorėliai (Ankštoji g. 11)";"1 klasė";5479496104;Ne;0;4;0;4
18139;"Dainorėliai (Ankštoji g. 11)";"1 klasė";94480397292;Ne;0;4;0;4
18140;"Dainorėliai (Ankštoji g. 11)";"1 klasė";6404337541;Ne;1;4;0;5
18141;"Dainorėliai (Ankštoji g. 11)";"1 klasė";49483881135;Ne;0;4;0;4
18142;"Dainorėliai (Ankštoji g. 11)";"1 klasė";86187568203;Ne;3;4;0;7
18143;"Dainorėliai (Ankštoji g. 11)";"1 klasė";1015870220;Ne;4;4;0;8
18144;"Dainorėliai (Ankštoji g. 11)";"1 klasė";1515552402;Ne;0;4;0;4
18145;"Dainorėliai (Ankštoji g. 11)";"1 klasė";7114409929;Ne;0;4;0;4
18146;"Dainorėliai (Ankštoji g. 11)";"1 klasė";1084400276;Ne;1;4;0;5
18147;"Dainorėliai (Ankštoji g. 11)";"1 klasė";1531362555;Ne;10;4;0;14
18148;"Dainorėliai (Ankštoji g. 11)";"1 klasė";6195426672;Ne;1;4;0;5
18149;"Dainorėliai (Ankštoji g. 11)";"1 klasė";1120848949;Ne;0;4;0;4
18150;"Dainorėliai (Ankštoji g. 11)";"2 klasė";67124516230;Ne;0;4;0;4
18151;"Dainorėliai (Ankštoji g. 11)";"2 klasė";7506194777;Ne;0;4;0;4
18152;"Dainorėliai (Ankštoji g. 11)";"2 klasė";1829858221;Ne;0;4;0;4
18153;"Dainorėliai (Ankštoji g. 11)";"2 klasė";1470784692;Ne;0;4;0;4
18154;"Dainorėliai (Ankštoji g. 11)";"2 klasė";7569146994;Ne;0;4;0;4
18155;"Dainorėliai (Ankštoji g. 11)";"2 klasė";45577031767;Ne;0;4;0;4
18156;"Dainorėliai (Ankštoji g. 11)";"2 klasė";58071607976;Ne;7;4;0;11
18157;"Dainorėliai (Ankštoji g. 11)";"2 klasė";1646521870;Ne;0;4;0;4
18158;"Dainorėliai (Ankštoji g. 11)";"2 klasė";29132059636;Ne;0;4;0;4
18159;"Dainorėliai (Ankštoji g. 11)";"2 klasė";32573583030;Ne;3;4;0;7
18160;"Dainorėliai (Ankštoji g. 11)";"2 klasė";97947842490;Ne;0;4;0;4
18161;"Dainorėliai (Ankštoji g. 11)";"2 klasė";63211091321;Ne;4;4;0;8
18162;"Dainorėliai (Ankštoji g. 11)";"2 klasė";87717571411;Ne;0;4;0;4
18163;"Dainorėliai (Ankštoji g. 11)";"2 klasė";18936645521;Ne;0;4;0;4
18164;"Dainorėliai (Ankštoji g. 11)";"2 klasė";80499999855;Ne;0;4;0;4
18165;"Dainorėliai (Ankštoji g. 11)";"2 klasė";6948863728;Ne;0;4;0;4
18166;"Dainorėliai (Ankštoji g. 11)";"2 klasė";2531690903;Ne;10;4;0;14
18167;"Dainorėliai (Ankštoji g. 11)";"2 klasė";35134511946;Ne;0;4;0;4
18168;"Dainorėliai (Ankštoji g. 11)";"2 klasė";1121139222;Ne;0;4;0;4
18169;"Dainorėliai (Ankštoji g. 11)";"2 klasė";99597416067;Ne;0;4;0;4
18170;"Dainorėliai (Ankštoji g. 11)";"2 klasė";77718940253;Ne;4;4;0;8
18171;"Dainorėliai (Ankštoji g. 11)";"2 klasė";5236797727;Ne;0;4;0;4
18172;"Dainorėliai (Ankštoji g. 11)";"3 klasė";2045625141;Ne;4;4;0;8
18173;"Dainorėliai (Ankštoji g. 11)";"3 klasė";84084897419;Ne;0;4;0;4
18174;"Dainorėliai (Ankštoji g. 11)";"3 klasė";34219208558;Ne;0;4;0;4
18175;"Dainorėliai (Ankštoji g. 11)";"3 klasė";13138644060;Ne;1;4;0;5
18176;"Dainorėliai (Ankštoji g. 11)";"3 klasė";49342277188;Ne;1;4;0;5
18177;"Dainorėliai (Ankštoji g. 11)";"3 klasė";42402953271;Ne;0;4;0;4
18178;"Dainorėliai (Ankštoji g. 11)";"3 klasė";2441164154;Ne;22;4;0;26
18179;"Dainorėliai (Ankštoji g. 11)";"3 klasė";69556449215;Ne;0;4;0;4
18180;"Dainorėliai (Ankštoji g. 11)";"3 klasė";8244355193;Ne;2;4;0;6
18181;"Dainorėliai (Ankštoji g. 11)";"3 klasė";2142553899;Ne;4;4;0;8
18182;"Dainorėliai (Ankštoji g. 11)";"3 klasė";37660372564;Ne;0;4;0;4
18183;"Dainorėliai (Ankštoji g. 11)";"3 klasė";1889037823;Ne;0;4;0;4
18184;"Dainorėliai (Ankštoji g. 11)";"3 klasė";98796240124;Ne;0;4;0;4
18185;"Dainorėliai (Ankštoji g. 11)";"3 klasė";98830139164;Ne;1;4;0;5
18186;"Dainorėliai (Ankštoji g. 11)";"3 klasė";37708779599;Ne;0;4;0;4
18187;"Dainorėliai (Ankštoji g. 11)";"3 klasė";18741625569;Ne;0;4;0;4
18188;"Dainorėliai (Ankštoji g. 11)";"3 klasė";84424772471;Ne;0;4;0;4
18189;"Dainorėliai (Ankštoji g. 11)";"3 klasė";34686211072;Ne;0;4;0;4
18190;"Dainorėliai (Ankštoji g. 11)";"3 klasė";79461209783;Ne;0;4;0;4
18191;"Dainorėliai (Ankštoji g. 11)";"3 klasė";47323045857;Ne;1;4;0;5
18192;"Dainorėliai (Ankštoji g. 11)";"3 klasė";10679627657;Ne;0;4;0;4
18193;"Dainorėliai (Ankštoji g. 11)";"3 klasė";25073134850;Ne;0;4;0;4
18194;"Dainorėliai (Ankštoji g. 11)";"3 klasė";65118883315;Ne;0;4;0;4
18195;"Dainorėliai (Ankštoji g. 11)";"3 klasė";84999972369;Ne;1;4;0;5
18196;"Dainorėliai (Ankštoji g. 11)";"3 klasė";1209781483;Ne;0;4;0;4
18197;"Dainorėliai (Ankštoji g. 11)";"3 klasė";69732047046;Ne;3;4;0;7
18198;"Dainorėliai (Ankštoji g. 11)";"4 klasė";29726515194;Ne;0;7;0;7
18199;"Dainorėliai (Ankštoji g. 11)";"4 klasė";8562371599;Ne;2;4;0;6
18200;"Dainorėliai (Ankštoji g. 11)";"4 klasė";19292860218;Ne;1;4;0;5
18201;"Dainorėliai (Ankštoji g. 11)";"4 klasė";97182565649;Ne;0;7;0;7
18202;"Dainorėliai (Ankštoji g. 11)";"4 klasė";65982869126;Ne;1;5;0;6
18203;"Dainorėliai (Ankštoji g. 11)";"4 klasė";93738984644;Ne;1;4;0;5
18204;"Dainorėliai (Ankštoji g. 11)";"4 klasė";69409530494;Ne;2;4;0;6
18205;"Dainorėliai (Ankštoji g. 11)";"4 klasė";57179351170;Ne;0;4;0;4
18206;"Dainorėliai (Ankštoji g. 11)";"4 klasė";77907054102;Ne;0;6;0;6
18207;"Dainorėliai (Ankštoji g. 11)";"4 klasė";24048489264;Ne;2;4;0;6
18208;"Dainorėliai (Ankštoji g. 11)";"4 klasė";4773358825;Ne;0;4;0;4
18209;"Dainorėliai (Ankštoji g. 11)";"4 klasė";91457137356;Ne;0;4;0;4
18210;"Dainorėliai (Ankštoji g. 11)";"4 klasė";5010994621;Ne;0;4;0;4
18211;"Dainorėliai (Ankštoji g. 11)";"4 klasė";13846131820;Ne;2;4;0;6
18212;"Dainorėliai (Ankštoji g. 11)";"4 klasė";23144978287;Ne;1;4;0;5
18213;"Dainorėliai (Ankštoji g. 11)";"4 klasė";6203511535;Ne;1;4;0;5
18214;"Dainorėliai (Ankštoji g. 11)";"4 klasė";81956978417;Ne;0;6;0;6
18215;"Dainorėliai (Ankštoji g. 11)";"4 klasė";3018657993;Ne;0;4;0;4
18216;"Dainorėliai (Ankštoji g. 11)";"4 klasė";48245075123;Ne;0;4;0;4
18217;"Dainorėliai (Ankštoji g. 11)";"4 klasė";57618865048;Ne;4;4;0;8
18218;"Dainorėliai (Ankštoji g. 11)";"4 klasė";84749521489;Ne;0;4;0;4
18219;"Dainorėliai (Ankštoji g. 11)";"4 klasė";26315465923;Ne;0;4;0;4
18220;"Dainorėliai (Ankštoji g. 11)";SAULUTĖS;8857018998;Ne;0;1;0;1
18221;"Dainorėliai (Ankštoji g. 11)";SAULUTĖS;4612995336;Ne;0;4;0;4
18222;"Dainorėliai (Ankštoji g. 11)";SAULUTĖS;6704354150;Ne;0;2;0;2
18223;"Dainorėliai (Ankštoji g. 11)";SAULUTĖS;5632663846;Ne;0;5;0;5
18224;"Dainorėliai (Ankštoji g. 11)";SAULUTĖS;1547686786;Ne;0;4;0;4
18225;"Dainorėliai (Ankštoji g. 11)";SAULUTĖS;4307591123;Ne;11;4;0;15
18226;"Dainorėliai (Ankštoji g. 11)";SAULUTĖS;6385439136;Ne;0;4;0;4
18227;"Dainorėliai (Ankštoji g. 11)";SAULUTĖS;1552829080;Ne;0;6;0;6
18228;"Dainorėliai (Ankštoji g. 11)";SAULUTĖS;5410183494;Ne;4;0;0;4
18229;"Dainorėliai (Ankštoji g. 11)";SAULUTĖS;5587907483;Ne;19;0;0;19
18230;"Dainorėliai (Ankštoji g. 11)";SAULUTĖS;2064843848;Ne;5;4;0;9
18231;"Dainorėliai (Ankštoji g. 11)";SAULUTĖS;5687390372;Ne;0;4;0;4
18232;"Dainorėliai (Ankštoji g. 11)";SAULUTĖS;7804441689;Taip;6;0;0;6
18233;"Dainorėliai (Ankštoji g. 11)";SAULUTĖS;6090746954;Ne;0;6;0;6
18234;"Dainorėliai (Ankštoji g. 11)";SAULUTĖS;4798415786;Ne;0;3;0;3
18235;"Dainorėliai (Ankštoji g. 11)";SAULUTĖS;7118473669;Ne;1;2;0;3
18236;"Dainorėliai (Ankštoji g. 11)";SAULUTĖS;4431804759;Ne;0;6;0;6
18237;"Dainorėliai (Ankštoji g. 11)";SAULUTĖS;6697149560;Ne;4;5;0;9
18238;"Dainorėliai (Ankštoji g. 11)";SAULUTĖS;3762178533;Ne;6;1;0;7
18239;Lokiukas;BITUTĖS;3329205450;Ne;4;4;0;8
18240;Lokiukas;BITUTĖS;7920238202;Ne;0;0;4;4
18241;Lokiukas;BITUTĖS;1376124245;Ne;0;21;0;21
18242;Lokiukas;BITUTĖS;2181315008;Ne;0;4;5;9
18243;Lokiukas;BITUTĖS;3896883842;Ne;21;0;0;21
18244;Lokiukas;BITUTĖS;8656751314;Ne;1;4;8;13
18245;Lokiukas;BITUTĖS;4551069961;Ne;0;4;4;8
18246;Lokiukas;BITUTĖS;5794303981;Ne;10;0;1;11
18247;Lokiukas;BITUTĖS;2671053309;Taip;0;10;1;11
18248;Lokiukas;BITUTĖS;5217458476;Ne;0;0;1;1
18249;Lokiukas;BITUTĖS;6883994020;Ne;8;0;0;8
18250;Lokiukas;BITUTĖS;8209165996;Ne;0;4;0;4
18251;Lokiukas;BITUTĖS;9834746275;Ne;0;1;0;1
18252;Lokiukas;BITUTĖS;1647778939;Ne;0;0;1;1
18253;Lokiukas;BITUTĖS;9480025132;Ne;0;1;0;1
18254;Lokiukas;BITUTĖS;6260486656;Ne;0;6;0;6
18255;Lokiukas;BITUTĖS;2126391728;Ne;0;0;2;2
18256;Lokiukas;BITUTĖS;8334800302;Ne;0;3;0;3
18257;Lokiukas;BITUTĖS;1987485885;Ne;0;4;6;10
18258;Lokiukas;BITUTĖS;8378138411;Ne;4;0;4;8
18259;Lokiukas;BITUTĖS;3397999534;Ne;0;6;0;6
18260;Lokiukas;BITUTĖS;8994257898;Ne;21;0;0;21
18261;Lokiukas;"1 B klasė";14605095801;Ne;9;0;0;9
18262;Lokiukas;"1 B klasė";8036643654;Ne;9;0;0;9
18263;Lokiukas;"1 B klasė";5879386524;Ne;4;0;0;4
18264;Lokiukas;"1 B klasė";9625041533;Ne;10;0;0;10
18265;Lokiukas;"1 B klasė";2476231041;Ne;6;0;0;6
18266;Lokiukas;"1 B klasė";2548712970;Ne;4;0;0;4
18267;Lokiukas;"1 B klasė";1570438208;Ne;21;0;0;21
18268;Lokiukas;"1 B klasė";2673522432;Ne;21;0;0;21
18269;Lokiukas;"1 B klasė";47399326083;Ne;4;0;0;4
18270;Lokiukas;"1 B klasė";7591418969;Ne;6;0;0;6
18271;Lokiukas;"1 B klasė";4569798381;Ne;21;0;0;21
18272;Lokiukas;"1 B klasė";8399364170;Ne;9;0;0;9
18273;Lokiukas;"1 B klasė";97284171512;Ne;4;0;0;4
18274;Lokiukas;"1 B klasė";5943583254;Ne;5;0;0;5
18275;Lokiukas;"1 B klasė";3070998871;Ne;5;0;0;5
18276;Lokiukas;"1 B klasė";5453470660;Ne;5;0;0;5
18277;Lokiukas;"1 B klasė";4427448272;Ne;21;0;0;21
18278;Lokiukas;"1 B klasė";20659573470;Ne;21;0;0;21
18279;Lokiukas;"1 B klasė";5437008837;Ne;10;0;0;10
18280;Lokiukas;"1 B klasė";4580716838;Ne;7;0;0;7
18281;Lokiukas;"1 B klasė";39975872119;Ne;4;0;0;4
18282;Lokiukas;"1 B klasė";8568285232;Ne;8;0;0;8
18283;Lokiukas;"1 B klasė";9501202273;Ne;7;0;0;7
18284;Lokiukas;"1 B klasė";8943496964;Ne;21;0;0;21
18285;Lokiukas;"1 A klasė";56069293343;Ne;0;4;0;4
18286;Lokiukas;"1 A klasė";69364831994;Ne;0;4;0;4
18287;Lokiukas;"1 A klasė";1230490562;Ne;2;4;0;6
18288;Lokiukas;"1 A klasė";8452600632;Ne;1;4;0;5
18289;Lokiukas;"1 A klasė";39222094073;Ne;19;0;0;19
18290;Lokiukas;"1 A klasė";74169282323;Ne;0;4;0;4
18291;Lokiukas;"1 A klasė";35890122494;Ne;0;4;0;4
18292;Lokiukas;"1 A klasė";1626698185;Ne;7;0;0;7
18293;Lokiukas;"1 A klasė";8455869600;Ne;0;4;0;4
18294;Lokiukas;"1 A klasė";1625137322;Ne;1;4;0;5
18295;Lokiukas;"1 A klasė";2170176922;Ne;0;4;0;4
18296;Lokiukas;"1 A klasė";8270572748;Ne;1;4;0;5
18297;Lokiukas;"1 A klasė";34800098950;Ne;0;4;0;4
18298;Lokiukas;"1 A klasė";3825101647;Ne;21;0;0;21
18299;Lokiukas;"1 A klasė";8618280811;Ne;21;0;0;21
18300;Lokiukas;"1 A klasė";8323172347;Ne;8;0;0;8
18301;Lokiukas;"1 A klasė";7844351275;Ne;3;4;0;7
18302;Lokiukas;"1 A klasė";2045735700;Ne;9;0;0;9
18303;Lokiukas;"1 A klasė";3981653153;Ne;0;4;0;4
18304;Lokiukas;"1 A klasė";6318538591;Ne;2;4;0;6
18305;Lokiukas;"1 A klasė";43500434912;Ne;2;4;0;6
18306;Lokiukas;"1 A klasė";25141529581;Ne;1;4;0;5
18307;Lokiukas;"1 A klasė";3369746590;Ne;1;4;0;5
18308;Lokiukas;"1 A klasė";3004895246;Ne;21;0;0;21
18309;Lokiukas;"1 A klasė";3061816821;Ne;0;4;0;4
18310;Lokiukas;"1 A klasė";4677444685;Ne;10;4;0;14
18311;Lokiukas;GUDRUČIAI;1604886863;Ne;0;19;0;19
18312;Lokiukas;GUDRUČIAI;3826815202;Ne;5;4;0;9
18313;Lokiukas;GUDRUČIAI;8687864179;Ne;3;4;0;7
18314;Lokiukas;GUDRUČIAI;5446430319;Ne;8;4;0;12
18315;Lokiukas;GUDRUČIAI;5995034919;Ne;0;4;2;6
18316;Lokiukas;GUDRUČIAI;2354942164;Ne;0;4;1;5
18317;Lokiukas;GUDRUČIAI;35364823312;Ne;0;4;0;4
18318;Lokiukas;GUDRUČIAI;5076773045;Ne;0;7;0;7
18319;Lokiukas;GUDRUČIAI;1188049956;Ne;0;4;0;4
18320;Lokiukas;GUDRUČIAI;1620856143;Ne;0;6;0;6
18321;Lokiukas;GUDRUČIAI;1733486244;Ne;0;4;0;4
18322;Lokiukas;GUDRUČIAI;4633366779;Ne;0;4;0;4
18323;Lokiukas;GUDRUČIAI;3485639108;Ne;0;4;0;4
18324;Lokiukas;GUDRUČIAI;3991821717;Ne;0;4;1;5
18325;Lokiukas;GUDRUČIAI;1606617694;Ne;0;6;0;6
18326;Lokiukas;GUDRUČIAI;8243342948;Ne;3;4;0;7
18327;Lokiukas;GUDRUČIAI;1210407640;Ne;0;4;0;4
18328;Lokiukas;BORUŽĖLĖS;4849031542;Ne;0;4;1;5
18329;Lokiukas;BORUŽĖLĖS;2625981190;Ne;4;4;0;8
18330;Lokiukas;BORUŽĖLĖS;4585621105;Ne;0;3;0;3
18331;Lokiukas;BORUŽĖLĖS;8576418875;Ne;10;7;0;17
18332;Lokiukas;BORUŽĖLĖS;6869785650;Ne;0;8;0;8
18333;Lokiukas;BORUŽĖLĖS;8630112458;Ne;5;4;0;9
18334;Lokiukas;BORUŽĖLĖS;3930463578;Ne;0;4;2;6
18335;Lokiukas;BORUŽĖLĖS;6277388612;Ne;0;6;0;6
18336;Lokiukas;BORUŽĖLĖS;2660616022;Ne;0;5;1;6
18337;Lokiukas;BORUŽĖLĖS;9798351980;Ne;0;2;4;6
18338;Lokiukas;BORUŽĖLĖS;5401463671;Ne;5;4;0;9
18339;Lokiukas;BORUŽĖLĖS;9996442005;Ne;5;5;0;10
18340;Lokiukas;BORUŽĖLĖS;4317453894;Ne;0;0;2;2
18341;Lokiukas;BORUŽĖLĖS;1226376844;Ne;0;1;0;1
18342;Lokiukas;BORUŽĖLĖS;4840187188;Ne;21;0;0;21
18343;Lokiukas;BORUŽĖLĖS;1724976098;Ne;11;2;0;13
18344;Lokiukas;BORUŽĖLĖS;7426579018;Ne;0;5;1;6
18345;Lokiukas;BORUŽĖLĖS;1974049743;Ne;4;5;1;10
18346;Lokiukas;BORUŽĖLĖS;3733581089;Ne;0;4;2;6
18347;Lokiukas;BORUŽĖLĖS;3876368364;Ne;0;6;0;6
18348;Lokiukas;BORUŽĖLĖS;9354491312;Ne;21;0;0;21
18349;Lokiukas;BORUŽĖLĖS;6091878190;Ne;0;5;0;5
18350;Lokiukas;BORUŽĖLĖS;1076719080;Ne;8;2;1;11
18351;Lokiukas;ANČIUKAI;5473316050;Ne;1;0;0;1
18352;Lokiukas;ANČIUKAI;5670185948;Ne;0;9;3;12
18353;Lokiukas;ANČIUKAI;5843699073;Ne;6;3;4;13
18354;Lokiukas;ANČIUKAI;4788062781;Ne;2;1;0;3
18355;Lokiukas;ANČIUKAI;8758248334;Ne;0;4;1;5
18356;Lokiukas;ANČIUKAI;2466354050;Taip;2;0;1;3
18357;Lokiukas;ANČIUKAI;3849212461;Ne;5;4;5;14
18358;Lokiukas;ANČIUKAI;1756658146;Ne;5;4;2;11
18359;Lokiukas;ANČIUKAI;7509043689;Ne;2;1;3;6
18360;Lokiukas;ANČIUKAI;9673257342;Ne;0;4;1;5
18361;Lokiukas;ANČIUKAI;2266747745;Ne;14;4;0;18
18362;Lokiukas;ANČIUKAI;4417116107;Ne;0;2;0;2
18363;Lokiukas;ANČIUKAI;5893844708;Ne;16;0;0;16
18364;Lokiukas;ANČIUKAI;3015119335;Ne;9;0;1;10
18365;Lokiukas;ANČIUKAI;1712365476;Ne;21;0;0;21
18366;Lokiukas;ANČIUKAI;6827710384;Ne;17;0;0;17
18367;Lokiukas;KODĖLČIUKAI;2642065594;Ne;0;8;0;8
18368;Lokiukas;KODĖLČIUKAI;5943412920;Ne;0;4;0;4
18369;Lokiukas;KODĖLČIUKAI;6758550653;Ne;10;4;4;18
18370;Lokiukas;KODĖLČIUKAI;6336140882;Ne;13;5;0;18
18371;Lokiukas;KODĖLČIUKAI;8775608581;Ne;0;4;0;4
18372;Lokiukas;KODĖLČIUKAI;8915504279;Ne;0;4;0;4
18373;Lokiukas;KODĖLČIUKAI;4379238557;Ne;0;4;0;4
18374;Lokiukas;KODĖLČIUKAI;3694653020;Ne;0;1;0;1
18375;Lokiukas;KODĖLČIUKAI;4060641736;Ne;0;6;1;7
18376;Lokiukas;KODĖLČIUKAI;1025576053;Ne;0;3;0;3
18377;Lokiukas;KODĖLČIUKAI;1040288021;Ne;0;1;1;2
18378;Lokiukas;KODĖLČIUKAI;34546519642;Ne;3;2;0;5
18379;Lokiukas;KODĖLČIUKAI;9336617879;Ne;0;1;0;1
18380;Lokiukas;KODĖLČIUKAI;7943213321;Ne;0;7;0;7
18381;Lokiukas;KODĖLČIUKAI;6069516217;Ne;0;14;0;14
18382;Lokiukas;KODĖLČIUKAI;1752784666;Ne;0;4;0;4
18383;Lokiukas;KODĖLČIUKAI;4007839265;Ne;0;2;1;3
18384;Lokiukas;KODĖLČIUKAI;5467387832;Ne;0;5;0;5
18385;Lokiukas;KODĖLČIUKAI;9307491947;Ne;7;4;0;11
18386;Lokiukas;KODĖLČIUKAI;3744484616;Ne;0;4;0;4
18387;Lokiukas;KODĖLČIUKAI;8286358519;Ne;3;4;1;8
18388;Lokiukas;KODĖLČIUKAI;1886540733;Ne;5;5;0;10
18389;Lokiukas;KODĖLČIUKAI;8902619265;Ne;0;1;1;2
18390;Lokiukas;DRUGELIAI;1170293017;Ne;0;5;0;5
18391;Lokiukas;DRUGELIAI;4442073527;Ne;0;2;0;2
18392;Lokiukas;DRUGELIAI;2021477393;Ne;0;2;0;2
18393;Lokiukas;DRUGELIAI;7532603655;Ne;0;6;0;6
18394;Lokiukas;DRUGELIAI;4858829710;Ne;5;1;0;6
18395;Lokiukas;DRUGELIAI;2782818158;Ne;0;3;0;3
18396;Lokiukas;DRUGELIAI;4197547631;Ne;0;7;0;7
18397;Lokiukas;DRUGELIAI;8596706753;Ne;0;5;0;5
18398;Lokiukas;DRUGELIAI;4272205822;Taip;0;5;0;5
18399;Lokiukas;DRUGELIAI;2374601283;Ne;0;4;0;4
18400;Lokiukas;DRUGELIAI;7195184433;Ne;0;5;0;5
18401;Lokiukas;DRUGELIAI;4919744559;Ne;15;4;0;19
18402;Lokiukas;DRUGELIAI;6226281752;Ne;0;4;0;4
18403;Lokiukas;DRUGELIAI;1390586527;Ne;13;3;0;16
18404;Lokiukas;DRUGELIAI;2093224908;Ne;0;2;0;2
18405;Lokiukas;DRUGELIAI;1341265560;Ne;0;8;0;8
18406;Lokiukas;DRUGELIAI;5131662172;Ne;16;1;0;17
18407;Lokiukas;DRUGELIAI;1913742619;Ne;0;6;0;6
18408;Lokiukas;DRUGELIAI;4284574166;Ne;5;2;0;7
18409;Lokiukas;"2 A klasė";1201125655;Ne;5;0;0;5
18410;Lokiukas;"2 A klasė";2502465398;Ne;4;0;0;4
18411;Lokiukas;"2 A klasė";67133709394;Ne;6;0;0;6
18412;Lokiukas;"2 A klasė";4989577303;Ne;5;0;0;5
18413;Lokiukas;"2 A klasė";73696992182;Ne;4;0;0;4
18414;Lokiukas;"2 A klasė";1056075876;Ne;4;0;0;4
18415;Lokiukas;"2 A klasė";9890308887;Ne;5;0;0;5
18416;Lokiukas;"2 A klasė";82025637099;Ne;4;0;0;4
18417;Lokiukas;"2 A klasė";8846527481;Ne;9;0;0;9
18418;Lokiukas;"2 A klasė";4353695640;Ne;21;0;0;21
18419;Lokiukas;"2 A klasė";73515179103;Ne;12;0;0;12
18420;Lokiukas;"2 A klasė";36677665098;Ne;4;0;0;4
18421;Lokiukas;"2 A klasė";131300206;Ne;7;0;0;7
18422;Lokiukas;"2 A klasė";77512682081;Ne;4;0;0;4
18423;Lokiukas;"2 A klasė";66528256040;Ne;5;0;0;5
18424;Lokiukas;"2 A klasė";86120193313;Ne;4;0;0;4
18425;Lokiukas;"2 A klasė";45028887854;Ne;4;0;0;4
18426;Lokiukas;"2 A klasė";83528495608;Ne;7;0;0;7
18427;Lokiukas;"2 A klasė";51237034253;Ne;7;0;0;7
18428;Lokiukas;"2 A klasė";52940830874;Ne;6;0;0;6
18429;Lokiukas;"2 A klasė";8240261104;Ne;5;0;0;5
18430;Lokiukas;"2 A klasė";27403835292;Ne;4;0;0;4
18431;Lokiukas;"2 A klasė";5104259667;Ne;5;0;0;5
18432;Lokiukas;"2 A klasė";83086633109;Ne;9;0;0;9
18433;Lokiukas;"2 A klasė";38884246104;Ne;5;0;0;5
18434;Lokiukas;"2 B klasė";7235277422;Ne;6;0;0;6
18435;Lokiukas;"2 B klasė";1133294157;Ne;4;0;0;4
18436;Lokiukas;"2 B klasė";1072148409;Ne;4;0;0;4
18437;Lokiukas;"2 B klasė";92373834478;Ne;5;0;0;5
18438;Lokiukas;"2 B klasė";2054450461;Ne;5;0;0;5
18439;Lokiukas;"2 B klasė";3255141230;Ne;21;0;0;21
18440;Lokiukas;"2 B klasė";3255141230;Ne;21;0;0;21
18441;Lokiukas;"2 B klasė";14234831040;Ne;4;0;0;4
18442;Lokiukas;"2 B klasė";57505829630;Ne;4;0;0;4
18443;Lokiukas;"2 B klasė";7334971595;Ne;4;0;0;4
18444;Lokiukas;"2 B klasė";51059574159;Ne;21;0;0;21
18445;Lokiukas;"2 B klasė";4662981914;Ne;5;0;0;5
18446;Lokiukas;"2 B klasė";2959877846;Ne;21;0;0;21
18447;Lokiukas;"2 B klasė";6414861823;Ne;21;0;0;21
18448;Lokiukas;"2 B klasė";7130407913;Ne;21;0;0;21
18449;Lokiukas;"2 B klasė";98045145204;Ne;21;0;0;21
18450;Lokiukas;"2 B klasė";68390568000;Ne;5;0;0;5
18451;Lokiukas;"2 B klasė";8980902068;Ne;4;0;0;4
18452;Lokiukas;"2 B klasė";4164426360;Ne;4;0;0;4
18453;Lokiukas;"2 B klasė";14937983736;Ne;4;0;0;4
18454;Lokiukas;"2 B klasė";8996622650;Ne;5;0;0;5
18455;Lokiukas;"2 B klasė";61807094999;Ne;4;0;0;4
18456;Lokiukas;"2 B klasė";2078673522;Ne;7;0;0;7
18457;Lokiukas;"2 B klasė";40006848965;Ne;6;0;0;6
18458;Lokiukas;"2 B klasė";32714964224;Ne;8;0;0;8
18459;Lokiukas;"2 B klasė";8920359311;Ne;8;0;0;8
18460;Lokiukas;"2 B klasė";38001876942;Ne;4;0;0;4
18461;Lokiukas;"3 A klasė";25170045140;Ne;21;0;0;21
18462;Lokiukas;"3 A klasė";15406362908;Ne;5;0;0;5
18463;Lokiukas;"3 A klasė";45122233067;Ne;7;0;0;7
18464;Lokiukas;"3 A klasė";15685936471;Ne;5;0;0;5
18465;Lokiukas;"3 A klasė";10948160841;Ne;21;0;0;21
18466;Lokiukas;"3 A klasė";21802863853;Ne;5;0;0;5
18467;Lokiukas;"3 A klasė";29577495646;Ne;5;0;0;5
18468;Lokiukas;"3 A klasė";22979689191;Ne;6;0;0;6
18469;Lokiukas;"3 A klasė";80754592972;Ne;6;0;0;6
18470;Lokiukas;"3 A klasė";14903100496;Ne;5;0;0;5
18471;Lokiukas;"3 A klasė";97609897018;Ne;9;0;0;9
18472;Lokiukas;"3 A klasė";4608275224;Ne;8;0;0;8
18473;Lokiukas;"3 A klasė";99706061553;Ne;5;0;0;5
18474;Lokiukas;"3 A klasė";7785940412;Ne;6;0;0;6
18475;Lokiukas;"3 A klasė";24099693663;Ne;21;0;0;21
18476;Lokiukas;"3 A klasė";72092394330;Ne;11;0;0;11
18477;Lokiukas;"3 A klasė";35769782473;Ne;5;0;0;5
18478;Lokiukas;"3 A klasė";23688235312;Ne;6;0;0;6
18479;Lokiukas;"3 A klasė";43070670534;Ne;9;0;0;9
18480;Lokiukas;"3 A klasė";38531751377;Ne;8;0;0;8
18481;Lokiukas;"3 A klasė";15574258138;Ne;7;0;0;7
18482;Lokiukas;"3 A klasė";59840033826;Ne;7;0;0;7
18483;Lokiukas;"3 A klasė";24523198513;Ne;21;0;0;21
18484;Lokiukas;"3 A klasė";84273668685;Ne;6;0;0;6
18485;Lokiukas;"3 A klasė";9077016953;Ne;5;0;0;5
18486;Lokiukas;"3 A klasė";9747265775;Ne;21;0;0;21
18487;Lokiukas;"3 A klasė";5198408183;Ne;11;0;0;11
18488;Lokiukas;"3 A klasė";80793623068;Ne;7;0;0;7
18489;Lokiukas;"3 A klasė";93374754851;Ne;13;0;0;13
18490;Lokiukas;"3 B klasė";5311341721;Ne;21;0;0;21
18491;Lokiukas;"3 B klasė";61890775725;Ne;12;0;0;12
18492;Lokiukas;"3 B klasė";32506466236;Ne;6;0;0;6
18493;Lokiukas;"3 B klasė";24221829774;Ne;8;0;0;8
18494;Lokiukas;"3 B klasė";96046361641;Ne;8;0;0;8
18495;Lokiukas;"3 B klasė";7324496782;Ne;7;0;0;7
18496;Lokiukas;"3 B klasė";95910336503;Ne;17;0;0;17
18497;Lokiukas;"3 B klasė";58513885211;Ne;7;0;0;7
18498;Lokiukas;"3 B klasė";57958699478;Ne;5;0;0;5
18499;Lokiukas;"3 B klasė";10811780420;Ne;6;0;0;6
18500;Lokiukas;"3 B klasė";18646642032;Ne;4;0;0;4
18501;Lokiukas;"3 B klasė";79109699217;Ne;4;0;0;4
18502;Lokiukas;"3 B klasė";50713289266;Ne;21;0;0;21
18503;Lokiukas;"3 B klasė";20231469825;Ne;8;0;0;8
18504;Lokiukas;"3 B klasė";18336619115;Ne;4;0;0;4
18505;Lokiukas;"3 B klasė";2105377652;Ne;5;0;0;5
18506;Lokiukas;"3 B klasė";39867459515;Ne;8;0;0;8
18507;Lokiukas;"3 B klasė";1146878499;Ne;4;0;0;4
18508;Lokiukas;"3 B klasė";46587243900;Ne;8;0;0;8
18509;Lokiukas;"3 B klasė";62268017779;Ne;19;0;0;19
18510;Lokiukas;"3 B klasė";28796727185;Ne;21;0;0;21
18511;Lokiukas;"3 B klasė";88415635113;Ne;13;0;0;13
18512;Lokiukas;"3 B klasė";9141446821;Ne;9;0;0;9
18513;Lokiukas;"3 B klasė";7497324442;Ne;21;0;0;21
18514;Lokiukas;"3 B klasė";7903535850;Ne;8;0;0;8
18515;Lokiukas;"3 B klasė";75507005694;Ne;15;0;0;15
18516;Lokiukas;"3 B klasė";73426072972;Ne;14;0;0;14
18517;Lokiukas;"3 B klasė";59913848400;Ne;7;0;0;7
18518;Lokiukas;"3 B klasė";9516336072;Ne;4;0;0;4
18519;Lokiukas;"4 A klasė";67818191566;Ne;0;4;0;4
18520;Lokiukas;"4 A klasė";45280536946;Ne;21;0;0;21
18521;Lokiukas;"4 A klasė";53087036306;Ne;0;4;0;4
18522;Lokiukas;"4 A klasė";79223457439;Ne;0;4;0;4
18523;Lokiukas;"4 A klasė";75613665040;Ne;0;4;0;4
18524;Lokiukas;"4 A klasė";10240586503;Ne;21;0;0;21
18525;Lokiukas;"4 A klasė";86623153797;Ne;0;4;0;4
18526;Lokiukas;"4 A klasė";27050402360;Ne;0;4;0;4
18527;Lokiukas;"4 A klasė";43389930516;Ne;1;4;0;5
18528;Lokiukas;"4 A klasė";23222644824;Ne;0;4;0;4
18529;Lokiukas;"4 A klasė";52296454506;Ne;0;4;0;4
18530;Lokiukas;"4 A klasė";66999644935;Ne;21;0;0;21
18531;Lokiukas;"4 A klasė";72167964645;Ne;9;4;0;13
18532;Lokiukas;"4 A klasė";2143040924;Ne;21;0;0;21
18533;Lokiukas;"4 A klasė";3206276637;Ne;21;0;0;21
18534;Lokiukas;"4 A klasė";5775631777;Ne;0;4;0;4
18535;Lokiukas;"4 A klasė";3703002168;Ne;3;4;0;7
18536;Lokiukas;"4 A klasė";38636200254;Ne;2;4;0;6
18537;Lokiukas;"4 A klasė";47410036889;Ne;0;4;0;4
18538;Lokiukas;"4 A klasė";53544600623;Ne;0;4;0;4
18539;Lokiukas;"4 A klasė";6702448475;Ne;0;4;0;4
18540;Lokiukas;"4 A klasė";82966541165;Ne;4;4;0;8
18541;Lokiukas;"4 A klasė";42292408557;Ne;21;0;0;21
18542;Lokiukas;"4 B klasė";35018370441;Ne;0;4;0;4
18543;Lokiukas;"4 B klasė";60370754283;Ne;0;4;0;4
18544;Lokiukas;"4 B klasė";98289469398;Ne;16;0;0;16
18545;Lokiukas;"4 B klasė";15445053855;Ne;0;4;0;4
18546;Lokiukas;"4 B klasė";3262579895;Ne;0;4;0;4
18547;Lokiukas;"4 B klasė";51554951703;Ne;21;0;0;21
18548;Lokiukas;"4 B klasė";88947878548;Ne;0;4;0;4
18549;Lokiukas;"4 B klasė";29198900240;Ne;0;4;0;4
18550;Lokiukas;"4 B klasė";77441549037;Ne;2;4;0;6
18551;Lokiukas;"4 B klasė";79301547085;Ne;0;4;0;4
18552;Lokiukas;"4 B klasė";10897713744;Ne;0;4;0;4
18553;Lokiukas;"4 B klasė";16889795010;Ne;21;0;0;21
18554;Lokiukas;"4 B klasė";5067673212;Ne;0;4;0;4
18555;Lokiukas;"4 B klasė";1424195731;Ne;21;0;0;21
18556;Lokiukas;"4 B klasė";1104333637;Ne;5;0;0;5
18557;Lokiukas;"4 B klasė";69089214980;Ne;1;4;0;5
18558;Lokiukas;"4 B klasė";69089214980;Ne;1;4;0;5
18559;Lokiukas;"4 B klasė";45735190114;Ne;21;0;0;21
18560;Lokiukas;"4 B klasė";2353550739;Ne;4;0;0;4
18561;Lokiukas;"4 B klasė";15004419516;Ne;1;4;0;5
18562;Lokiukas;"4 B klasė";2388111003;Ne;0;4;0;4
18563;Šaltinėlis;Ančiukų;3901200729;Ne;12;0;0;12
18564;Šaltinėlis;Ančiukų;1312785137;Ne;8;0;0;8
18565;Šaltinėlis;Ančiukų;9209105445;Ne;10;2;0;12
18566;Šaltinėlis;Ančiukų;9112527921;Ne;0;4;0;4
18567;Šaltinėlis;Ančiukų;2027779524;Ne;17;0;0;17
18568;Šaltinėlis;Ančiukų;5498764523;Ne;0;4;0;4
18569;Šaltinėlis;Ančiukų;4226929875;Ne;9;2;0;11
18570;Šaltinėlis;Ančiukų;1489377928;Ne;6;9;0;15
18571;Šaltinėlis;Ančiukų;5005394548;Ne;13;5;0;18
18572;Šaltinėlis;Ančiukų;1102861619;Ne;0;3;0;3
18573;Šaltinėlis;Ančiukų;1742421427;Ne;8;1;0;9
18574;Šaltinėlis;Ančiukų;9581384663;Ne;14;0;0;14
18575;Šaltinėlis;Ančiukų;9465174636;Ne;9;1;0;10
18576;Šaltinėlis;Ančiukų;8034195267;Ne;0;3;0;3
18577;Šaltinėlis;Ančiukų;5455997139;Ne;15;2;0;17
18578;Šaltinėlis;Ančiukų;9588260206;Ne;11;0;0;11
18579;Šaltinėlis;Ančiukų;8116985061;Ne;8;0;0;8
18580;Šaltinėlis;Bitučių;9983153464;Ne;7;9;0;16
18581;Šaltinėlis;Bitučių;6487378225;Ne;0;2;0;2
18582;Šaltinėlis;Bitučių;56396772538;Ne;0;5;0;5
18583;Šaltinėlis;Bitučių;5251390843;Ne;8;4;0;12
18584;Šaltinėlis;Bitučių;8500790262;Ne;7;0;0;7
18585;Šaltinėlis;Bitučių;4332884673;Ne;4;5;0;9
18586;Šaltinėlis;Bitučių;3493429067;Ne;0;4;0;4
18587;Šaltinėlis;Bitučių;9362495172;Ne;6;5;0;11
18588;Šaltinėlis;Bitučių;6462738640;Ne;0;6;0;6
18589;Šaltinėlis;Bitučių;77872075694;Ne;1;1;0;2
18590;Šaltinėlis;Bitučių;7133143923;Ne;0;12;0;12
18591;Šaltinėlis;Bitučių;6887838949;Ne;11;6;0;17
18592;Šaltinėlis;Bitučių;2630875135;Ne;7;5;0;12
18593;Šaltinėlis;Bitučių;9218883174;Ne;0;3;0;3
18594;Šaltinėlis;Bitučių;2973820849;Ne;6;4;0;10
18595;Šaltinėlis;Bitučių;9820788524;Ne;0;7;0;7
18596;Šaltinėlis;Bitučių;9769491789;Ne;0;6;0;6
18597;Šaltinėlis;Bitučių;9274165569;Ne;0;10;0;10
18598;Šaltinėlis;Bitučių;2084451705;Ne;6;4;0;10
18599;Šaltinėlis;Bitučių;8555517284;Ne;0;4;0;4
18600;Šaltinėlis;Bitučių;1543331408;Ne;0;5;0;5
18601;Šaltinėlis;Bitučių;7483928256;Ne;3;8;0;11
18602;Šaltinėlis;Bitučių;2646901307;Ne;8;2;0;10
18603;Šaltinėlis;Bitučių;7737797979;Ne;0;6;0;6
18604;Šaltinėlis;Bitučių;3017437426;Ne;0;7;0;7
18605;Šaltinėlis;Saulutės;7311831014;Ne;2;4;0;6
18606;Šaltinėlis;Saulutės;5854723120;Ne;0;9;0;9
18607;Šaltinėlis;Saulutės;5833136956;Ne;0;3;0;3
18608;Šaltinėlis;Saulutės;3483756240;Ne;0;2;0;2
18609;Šaltinėlis;Saulutės;6380346298;Ne;0;2;0;2
18610;Šaltinėlis;Saulutės;5799032398;Ne;0;9;0;9
18611;Šaltinėlis;Saulutės;5525740049;Ne;0;7;0;7
18612;Šaltinėlis;Saulutės;5382567842;Ne;0;2;0;2
18613;Šaltinėlis;Saulutės;4743907195;Ne;5;7;0;12
18614;Šaltinėlis;Saulutės;5343279219;Ne;17;0;0;17
18615;Šaltinėlis;Saulutės;7118672118;Ne;19;0;0;19
18616;Šaltinėlis;Saulutės;2465009553;Ne;0;8;0;8
18617;Šaltinėlis;Saulutės;5345738219;Ne;6;4;0;10
18618;Šaltinėlis;Saulutės;6721510313;Ne;2;5;0;7
18619;Šaltinėlis;Saulutės;7650840990;Ne;5;5;0;10
18620;Šaltinėlis;Saulutės;1678450741;Ne;0;4;0;4
18621;Šaltinėlis;Saulutės;5774391181;Ne;0;8;0;8
18622;Šaltinėlis;Saulutės;4681460322;Ne;9;4;0;13
18623;Šaltinėlis;Saulutės;3968514430;Ne;0;8;0;8
18624;Šaltinėlis;Saulutės;8950694484;Ne;11;6;0;17
18625;Šaltinėlis;Saulutės;2499890317;Ne;10;1;0;11
18626;Šaltinėlis;Saulutės;3579974049;Ne;0;4;0;4
18627;Šaltinėlis;Meškiukų;6915625306;Ne;13;0;0;13
18628;Šaltinėlis;Meškiukų;6645807642;Ne;10;0;0;10
18629;Šaltinėlis;Meškiukų;9759912102;Ne;9;0;0;9
18630;Šaltinėlis;Meškiukų;4664741207;Ne;0;2;0;2
18631;Šaltinėlis;Meškiukų;1400918201;Ne;14;0;0;14
18632;Šaltinėlis;Meškiukų;5420067622;Ne;7;2;0;9
18633;Šaltinėlis;Meškiukų;1656674673;Ne;0;5;0;5
18634;Šaltinėlis;Meškiukų;4248763165;Ne;0;5;0;5
18635;Šaltinėlis;Meškiukų;5982018366;Ne;6;3;0;9
18636;Šaltinėlis;Meškiukų;9922223978;Ne;12;4;0;16
18637;Šaltinėlis;Meškiukų;8995077908;Ne;12;0;0;12
18638;Šaltinėlis;Meškiukų;5982188743;Ne;9;0;0;9
18639;Šaltinėlis;Meškiukų;6586783795;Ne;7;1;0;8
18640;Šaltinėlis;Meškiukų;7468640592;Ne;15;0;0;15
18641;Šaltinėlis;Meškiukų;4064231806;Ne;0;7;0;7
18642;Šaltinėlis;Meškiukų;4159654434;Ne;12;0;0;12
18643;Šaltinėlis;Meškiukų;6688536661;Ne;0;4;0;4
18644;Šaltinėlis;Meškiukų;8880659539;Ne;8;5;0;13
18645;Šaltinėlis;Meškiukų;3228788999;Ne;0;11;0;11
18646;Šaltinėlis;Meškiukų;5905345563;Ne;0;4;0;4
18647;Šaltinėlis;Meškiukų;2332065937;Ne;6;1;0;7
18648;Šaltinėlis;Nykštukai;9766640995;Ne;17;0;0;17
18649;Šaltinėlis;Nykštukai;3356138058;Ne;1;4;0;5
18650;Šaltinėlis;Nykštukai;5434349511;Ne;13;0;0;13
18651;Šaltinėlis;Nykštukai;4226068669;Ne;13;0;0;13
18652;Šaltinėlis;Nykštukai;2976773344;Ne;0;8;0;8
18653;Šaltinėlis;Nykštukai;3687243030;Ne;2;9;0;11
18654;Šaltinėlis;Nykštukai;4364256563;Ne;5;0;0;5
18655;Šaltinėlis;Nykštukai;9333013048;Ne;10;0;0;10
18656;Šaltinėlis;Nykštukai;4029616063;Ne;8;4;0;12
18657;Šaltinėlis;Nykštukai;6530797082;Ne;5;0;0;5
18658;Šaltinėlis;Nykštukai;7534585887;Ne;6;0;0;6
18659;Šaltinėlis;Nykštukai;8977029692;Ne;10;0;0;10
18660;Šaltinėlis;Nykštukai;7120592596;Ne;4;0;0;4
18661;Šaltinėlis;Nykštukai;6244924079;Ne;16;0;0;16
18662;Šaltinėlis;Nykštukai;3806267811;Ne;13;0;0;13
18663;Šaltinėlis;Nykštukai;3497881408;Ne;8;2;0;10
18664;Šaltinėlis;Nykštukai;6383844995;Ne;7;0;0;7
18665;Šaltinėlis;Perliukų;2825412170;Ne;5;4;0;9
18666;Šaltinėlis;Perliukų;1686009371;Ne;16;0;0;16
18667;Šaltinėlis;Perliukų;7068058767;Ne;6;5;0;11
18668;Šaltinėlis;Perliukų;2189112609;Ne;15;0;0;15
18669;Šaltinėlis;Perliukų;8914777163;Ne;12;1;0;13
18670;Šaltinėlis;Perliukų;7387221265;Ne;5;4;0;9
18671;Šaltinėlis;Perliukų;9674923143;Ne;0;8;0;8
18672;Šaltinėlis;Perliukų;1823048790;Ne;6;0;0;6
18673;Šaltinėlis;Perliukų;3073692882;Ne;18;0;0;18
18674;Šaltinėlis;Perliukų;5325974488;Ne;10;4;0;14
18675;Šaltinėlis;Perliukų;2022956307;Ne;11;3;0;14
18676;Šaltinėlis;Perliukų;2126751248;Ne;14;0;0;14
18677;Šaltinėlis;Perliukų;3271931810;Ne;17;1;0;18
18678;Šaltinėlis;Perliukų;1445108285;Ne;0;3;0;3
18679;Šaltinėlis;Perliukų;7133044918;Ne;16;1;0;17
18680;Šaltinėlis;Perliukų;2806453623;Ne;5;1;0;6
18681;Šaltinėlis;Perliukų;8695191968;Ne;19;0;0;19
18682;Šaltinėlis;Perliukų;4430546695;Ne;11;4;0;15
18683;Šaltinėlis;Perliukų;8506287076;Ne;3;0;0;3
18684;Šaltinėlis;BORUŽĖLĖS;9613234759;Ne;0;4;0;4
18685;Šaltinėlis;BORUŽĖLĖS;3505001330;Ne;17;0;0;17
18686;Šaltinėlis;BORUŽĖLĖS;8973369897;Ne;5;0;0;5
18687;Šaltinėlis;BORUŽĖLĖS;3780870805;Ne;6;0;0;6
18688;Šaltinėlis;BORUŽĖLĖS;2157520281;Ne;1;0;0;1
18689;Šaltinėlis;BORUŽĖLĖS;1441937630;Ne;7;0;0;7
18690;Šaltinėlis;BORUŽĖLĖS;4742849747;Ne;3;3;0;6
18691;Šaltinėlis;BORUŽĖLĖS;5996579651;Ne;21;0;0;21
18692;Šaltinėlis;BORUŽĖLĖS;5331397179;Ne;14;1;0;15
18693;Šaltinėlis;BORUŽĖLĖS;9218436977;Ne;10;1;0;11
18694;Šaltinėlis;BORUŽĖLĖS;2353630084;Ne;3;0;0;3
18695;Šaltinėlis;BORUŽĖLĖS;5593692486;Ne;0;5;0;5
18696;Šaltinėlis;1A;9188065549;Ne;0;5;0;5
18697;Šaltinėlis;1A;9305706589;Ne;0;4;0;4
18698;Šaltinėlis;1A;1580090516;Ne;0;5;0;5
18699;Šaltinėlis;1A;2034838765;Ne;0;4;0;4
18700;Šaltinėlis;1A;2105963102;Ne;0;4;0;4
18701;Šaltinėlis;1A;3582666579;Ne;0;8;0;8
18702;Šaltinėlis;1A;46569341613;Ne;0;6;0;6
18703;Šaltinėlis;1A;2801321116;Ne;0;4;0;4
18704;Šaltinėlis;1A;1091056386;Ne;0;5;0;5
18705;Šaltinėlis;1A;52142182972;Ne;0;21;0;21
18706;Šaltinėlis;1A;6880337593;Ne;0;4;0;4
18707;Šaltinėlis;1A;3516760367;Ne;0;4;0;4
18708;Šaltinėlis;1A;56542341895;Ne;0;7;0;7
18709;Šaltinėlis;1A;1910670134;Ne;0;9;0;9
18710;Šaltinėlis;1A;9595350871;Ne;0;5;0;5
18711;Šaltinėlis;1A;15925823621;Ne;0;4;0;4
18712;Šaltinėlis;1A;8902634958;Ne;0;12;0;12
18713;Šaltinėlis;1A;9757246434;Ne;0;15;0;15
18714;Šaltinėlis;1A;7262120071;Ne;0;5;0;5
18715;Šaltinėlis;1A;1004445904;Ne;0;7;0;7
18716;Šaltinėlis;"2A klasė";32264290873;Ne;0;4;0;4
18717;Šaltinėlis;"2A klasė";1767635282;Ne;0;4;0;4
18718;Šaltinėlis;"2A klasė";1390316465;Ne;0;9;0;9
18719;Šaltinėlis;"2A klasė";5442943843;Ne;0;4;0;4
18720;Šaltinėlis;"2A klasė";6764006747;Ne;0;4;0;4
18721;Šaltinėlis;"2A klasė";1658370782;Ne;0;4;0;4
18722;Šaltinėlis;"2A klasė";10918276041;Ne;0;5;0;5
18723;Šaltinėlis;"2A klasė";3455754351;Ne;0;21;0;21
18724;Šaltinėlis;"2A klasė";66575684640;Ne;0;7;0;7
18725;Šaltinėlis;"2A klasė";86592374576;Ne;0;21;0;21
18726;Šaltinėlis;"2A klasė";13808708760;Ne;0;4;0;4
18727;Šaltinėlis;"2A klasė";1614411921;Ne;0;5;0;5
18728;Šaltinėlis;"2A klasė";79406746980;Ne;0;6;0;6
18729;Šaltinėlis;"2A klasė";3577137327;Ne;0;9;0;9
18730;Šaltinėlis;"2A klasė";1224027643;Ne;0;5;0;5
18731;Šaltinėlis;"2A klasė";48525545812;Ne;0;6;0;6
18732;Šaltinėlis;"2A klasė";7073644279;Ne;0;4;0;4
18733;Šaltinėlis;"2A klasė";3022926855;Ne;0;8;0;8
18734;Šaltinėlis;"2A klasė";1190394855;Ne;0;14;0;14
18735;Šaltinėlis;"2A klasė";40186714037;Ne;0;4;0;4
18736;Šaltinėlis;"2A klasė";1456486363;Ne;0;4;0;4
18737;Šaltinėlis;"2A klasė";32949623652;Ne;0;5;0;5
18738;Šaltinėlis;"3A klasė";14213856824;Ne;0;4;0;4
18739;Šaltinėlis;"3A klasė";80649337160;Ne;0;5;0;5
18740;Šaltinėlis;"3A klasė";92958012146;Ne;0;5;0;5
18741;Šaltinėlis;"3A klasė";84656960510;Ne;0;21;0;21
18742;Šaltinėlis;"3A klasė";83621946293;Ne;0;21;0;21
18743;Šaltinėlis;"3A klasė";67808618878;Ne;0;21;0;21
18744;Šaltinėlis;"3A klasė";1278910777;Ne;0;4;0;4
18745;Šaltinėlis;"3A klasė";9647785988;Ne;2;19;0;21
18746;Šaltinėlis;"3A klasė";82671662416;Ne;0;4;0;4
18747;Šaltinėlis;"3A klasė";54025577281;Ne;0;5;0;5
18748;Šaltinėlis;"3A klasė";488285764;Ne;0;4;0;4
18749;Šaltinėlis;"3A klasė";29482180151;Ne;0;6;0;6
18750;Šaltinėlis;"3A klasė";54753218491;Ne;0;21;0;21
18751;Šaltinėlis;"3A klasė";86029472773;Ne;0;21;0;21
18752;Šaltinėlis;"3A klasė";64821172553;Ne;0;11;0;11
18753;Šaltinėlis;"3A klasė";5744976843;Ne;0;6;0;6
18754;Šaltinėlis;"3A klasė";25459069972;Ne;0;4;0;4
18755;Šaltinėlis;"3A klasė";6669392157;Ne;0;6;0;6
18756;Šaltinėlis;"3A klasė";89358384113;Ne;0;9;0;9
18757;Šaltinėlis;"3A klasė";28956971978;Ne;0;4;0;4
18758;Šaltinėlis;"3A klasė";4050444191;Ne;0;5;0;5
18759;Šaltinėlis;"3A klasė";89093437170;Ne;0;4;0;4
18760;Šaltinėlis;"3A klasė";51872331010;Ne;0;9;0;9
18761;Šaltinėlis;"4A klasė";83657465071;Ne;0;5;0;5
18762;Šaltinėlis;"4A klasė";86309198604;Ne;0;5;0;5
18763;Šaltinėlis;"4A klasė";9705941341;Ne;0;21;0;21
18764;Šaltinėlis;"4A klasė";38496350161;Ne;0;21;0;21
18765;Šaltinėlis;"4A klasė";62612067151;Ne;0;5;0;5
18766;Šaltinėlis;"4A klasė";96133834896;Ne;0;21;0;21
18767;Šaltinėlis;"4A klasė";73466313766;Ne;0;6;0;6
18768;Šaltinėlis;"4A klasė";2323456393;Ne;0;21;0;21
18769;Šaltinėlis;"4A klasė";56279691365;Ne;0;5;0;5
18770;Šaltinėlis;"4A klasė";4587186145;Ne;0;5;0;5
18771;Šaltinėlis;"4A klasė";70948186548;Ne;0;4;0;4
18772;Šaltinėlis;"4A klasė";47045578599;Ne;0;5;0;5
18773;Šaltinėlis;"4A klasė";36718328105;Ne;0;4;0;4
18774;Šaltinėlis;"4A klasė";86995081866;Ne;0;9;0;9
18775;Šaltinėlis;"4A klasė";7929809205;Ne;0;4;0;4
18776;Šaltinėlis;"4A klasė";29683761586;Ne;0;6;0;6
18777;Šaltinėlis;"4A klasė";9842958341;Ne;0;5;0;5
18778;Šaltinėlis;"4A klasė";40769315138;Ne;0;6;0;6
18779;Šaltinėlis;"4A klasė";7563879445;Ne;0;4;0;4
18780;Šaltinėlis;"4A klasė";66754907606;Ne;0;21;0;21
18781;Šaltinėlis;"4A klasė";35387543586;Ne;0;6;0;6
18782;Šaltinėlis;"4A klasė";6056572441;Ne;0;4;0;4
18783;Šaltinėlis;"4A klasė";9927833966;Ne;0;4;0;4
18784;Šaltinėlis;3B;93256161233;Ne;0;5;0;5
18785;Šaltinėlis;3B;83173349544;Ne;0;6;0;6
18786;Šaltinėlis;3B;39088869084;Ne;0;6;0;6
18787;Šaltinėlis;3B;1422035829;Ne;0;6;0;6
18788;Šaltinėlis;3B;7711903999;Ne;0;8;0;8
18789;Šaltinėlis;3B;95542489944;Ne;0;5;0;5
18790;Šaltinėlis;3B;3072314714;Ne;0;6;0;6
18791;Šaltinėlis;3B;1220687492;Ne;0;5;0;5
18792;Šaltinėlis;3B;74337710550;Ne;0;5;0;5
18793;Šaltinėlis;3B;35401075864;Ne;0;6;0;6
18794;Šaltinėlis;3B;19630605543;Ne;0;10;0;10
18795;Šaltinėlis;3B;84522552145;Ne;0;5;0;5
18796;Šaltinėlis;3B;3626545396;Ne;0;10;0;10
18797;Šaltinėlis;3B;6317111400;Ne;0;7;0;7
18798;Šaltinėlis;3B;4762756751;Ne;0;7;0;7
18799;Šaltinėlis;3B;72372808270;Ne;0;6;0;6
18800;Šaltinėlis;3B;1924418657;Ne;0;6;0;6
18801;Šaltinėlis;3B;77194317310;Ne;0;6;0;6
18802;Šaltinėlis;3B;57847832778;Ne;0;5;0;5
18803;Šaltinėlis;3B;2099800744;Ne;0;5;0;5
18804;Šaltinėlis;3B;70315400705;Ne;0;5;0;5
18805;Šaltinėlis;3B;81082410620;Ne;0;7;0;7
18806;Šaltinėlis;1B;84494627465;Ne;0;4;0;4
18807;Šaltinėlis;1B;2146141461;Ne;0;4;0;4
18808;Šaltinėlis;1B;6068980312;Ne;0;8;0;8
18809;Šaltinėlis;1B;9425353041;Ne;0;4;0;4
18810;Šaltinėlis;1B;17147527171;Ne;0;21;0;21
18811;Šaltinėlis;1B;1935762293;Ne;0;5;0;5
18812;Šaltinėlis;1B;1716801722;Ne;0;5;0;5
18813;Šaltinėlis;1B;2333071711;Ne;0;7;0;7
18814;Šaltinėlis;1B;23301579810;Ne;0;4;0;4
18815;Šaltinėlis;1B;52507085619;Ne;0;5;0;5
18816;Šaltinėlis;1B;1023238509;Ne;0;4;0;4
18817;Šaltinėlis;1B;526307704;Ne;0;7;0;7
18818;Šaltinėlis;1B;1958647188;Ne;0;7;0;7
18819;Šaltinėlis;1B;1583520894;Ne;0;21;0;21
18820;Šaltinėlis;1B;11083638216;Ne;0;7;0;7
18821;Šaltinėlis;PELĖDŽIUKAI;8973208195;Ne;5;4;0;9
18822;Šaltinėlis;PELĖDŽIUKAI;1367082230;Ne;0;9;1;10
18823;Šaltinėlis;PELĖDŽIUKAI;4387568448;Ne;0;5;0;5
18824;Šaltinėlis;PELĖDŽIUKAI;7723290276;Ne;9;8;0;17
18825;Šaltinėlis;PELĖDŽIUKAI;1348724947;Ne;0;21;0;21
18826;Šaltinėlis;PELĖDŽIUKAI;2658414287;Ne;2;6;0;8
18827;Šaltinėlis;PELĖDŽIUKAI;3638565578;Ne;0;9;0;9
18828;Šaltinėlis;PELĖDŽIUKAI;8721116918;Ne;0;4;0;4
18829;Šaltinėlis;PELĖDŽIUKAI;7211267255;Ne;7;4;0;11
18830;Šaltinėlis;PELĖDŽIUKAI;1040333590;Ne;0;4;0;4
18831;Šaltinėlis;PELĖDŽIUKAI;3660687688;Ne;0;8;0;8
18832;Šaltinėlis;PELĖDŽIUKAI;5869977541;Ne;2;4;5;11
18833;Šaltinėlis;PELĖDŽIUKAI;9108653045;Ne;0;7;0;7
18834;Šaltinėlis;PELĖDŽIUKAI;9762392403;Ne;9;1;0;10
18835;Šaltinėlis;PELĖDŽIUKAI;2230403251;Ne;0;4;0;4
18836;Šaltinėlis;PELĖDŽIUKAI;7918995181;Ne;12;4;0;16
18837;Šaltinėlis;PELĖDŽIUKAI;9673105905;Ne;5;4;2;11
18838;Šaltinėlis;PELĖDŽIUKAI;5099997904;Ne;10;3;1;14
18839;Gabijėlė;GANDRIUKŲ;4498088417;Ne;0;4;7;11
18840;Gabijėlė;GANDRIUKŲ;2277489032;Ne;9;6;0;15
18841;Gabijėlė;GANDRIUKŲ;8994076883;Ne;5;8;0;13
18842;Gabijėlė;GANDRIUKŲ;7087892822;Ne;5;1;3;9
18843;Gabijėlė;GANDRIUKŲ;5057272847;Ne;0;4;3;7
18844;Gabijėlė;GANDRIUKŲ;3548399391;Ne;0;4;2;6
18845;Gabijėlė;GANDRIUKŲ;2215880644;Ne;5;4;1;10
18846;Gabijėlė;GANDRIUKŲ;3799003783;Ne;5;4;0;9
18847;Gabijėlė;GANDRIUKŲ;5513530983;Ne;0;1;0;1
18848;Gabijėlė;GANDRIUKŲ;9581539166;Ne;3;3;2;8
18849;Gabijėlė;GANDRIUKŲ;6004026516;Ne;0;6;0;6
18850;Gabijėlė;GANDRIUKŲ;4634029418;Ne;4;5;0;9
18851;Gabijėlė;GANDRIUKŲ;4328252445;Ne;2;5;0;7
18852;Gabijėlė;GANDRIUKŲ;9706026832;Ne;0;2;0;2
18853;Gabijėlė;GANDRIUKŲ;2491503656;Ne;0;3;0;3
18854;Gabijėlė;GANDRIUKŲ;8904768332;Ne;2;0;2;4
18855;Gabijėlė;GANDRIUKŲ;5715645968;Ne;12;0;1;13
18856;Gabijėlė;GANDRIUKŲ;8572833698;Ne;2;0;1;3
18857;Gabijėlė;GANDRIUKŲ;8646572151;Ne;5;0;0;5
18858;Gabijėlė;GANDRIUKŲ;5054419205;Ne;0;17;0;17
18859;Gabijėlė;GANDRIUKŲ;7530976246;Ne;6;0;0;6
18860;Gabijėlė;GANDRIUKŲ;3920525584;Ne;3;0;0;3
18861;Gabijėlė;GANDRIUKŲ;2682112101;Ne;0;5;0;5
18862;Gabijėlė;LAKŠTINGALIUKŲ;7019425859;Ne;0;0;2;2
18863;Gabijėlė;LAKŠTINGALIUKŲ;1611004144;Ne;11;0;0;11
18864;Gabijėlė;LAKŠTINGALIUKŲ;5862882027;Ne;8;4;1;13
18865;Gabijėlė;LAKŠTINGALIUKŲ;8798786098;Ne;12;4;0;16
18866;Gabijėlė;LAKŠTINGALIUKŲ;8035360208;Ne;10;9;0;19
18867;Gabijėlė;LAKŠTINGALIUKŲ;2384469423;Ne;11;0;0;11
18868;Gabijėlė;LAKŠTINGALIUKŲ;8167646385;Ne;0;0;1;1
18869;Gabijėlė;LAKŠTINGALIUKŲ;8926268619;Ne;11;3;0;14
18870;Gabijėlė;LAKŠTINGALIUKŲ;9480021589;Ne;0;6;0;6
18871;Gabijėlė;LAKŠTINGALIUKŲ;3215569531;Ne;0;2;0;2
18872;Gabijėlė;LAKŠTINGALIUKŲ;5992403900;Ne;6;0;3;9
18873;Gabijėlė;LAKŠTINGALIUKŲ;9116943443;Ne;10;0;5;15
18874;Gabijėlė;LAKŠTINGALIUKŲ;8383489040;Ne;5;2;0;7
18875;Gabijėlė;LAKŠTINGALIUKŲ;6927730664;Ne;5;0;1;6
18876;Gabijėlė;LAKŠTINGALIUKŲ;7444385669;Ne;0;0;2;2
18877;Gabijėlė;LAKŠTINGALIUKŲ;9398722388;Ne;4;1;0;5
18878;Gabijėlė;LAKŠTINGALIUKŲ;9491327802;Ne;5;0;0;5
18879;Gabijėlė;LAKŠTINGALIUKŲ;2550300871;Ne;0;6;0;6
18880;Gabijėlė;LAKŠTINGALIUKŲ;9324498850;Ne;0;8;0;8
18881;Gabijėlė;LAKŠTINGALIUKŲ;9694544564;Ne;6;0;1;7
18882;Gabijėlė;LAKŠTINGALIUKŲ;4827797140;Ne;0;6;0;6
18883;Gabijėlė;LAKŠTINGALIUKŲ;6931780900;Ne;12;1;0;13
18884;Gabijėlė;LAKŠTINGALIUKŲ;2030555139;Ne;7;6;0;13
18885;Gabijėlė;ŽVIRBLIUKŲ;7043775905;Ne;9;0;0;9
18886;Gabijėlė;ŽVIRBLIUKŲ;4475530177;Ne;0;0;5;5
18887;Gabijėlė;ŽVIRBLIUKŲ;5743861607;Ne;0;0;5;5
18888;Gabijėlė;ŽVIRBLIUKŲ;7410541320;Ne;11;2;0;13
18889;Gabijėlė;ŽVIRBLIUKŲ;4493192224;Ne;8;0;0;8
18890;Gabijėlė;ŽVIRBLIUKŲ;9259964641;Ne;6;0;0;6
18891;Gabijėlė;ŽVIRBLIUKŲ;3268231136;Ne;0;8;0;8
18892;Gabijėlė;ŽVIRBLIUKŲ;5332825339;Ne;0;0;3;3
18893;Gabijėlė;ŽVIRBLIUKŲ;2264669298;Ne;5;1;0;6
18894;Gabijėlė;ŽVIRBLIUKŲ;5942625633;Ne;13;0;1;14
18895;Gabijėlė;ŽVIRBLIUKŲ;3155403180;Ne;0;0;4;4
18896;Gabijėlė;ŽVIRBLIUKŲ;1158461185;Ne;0;0;4;4
18897;Gabijėlė;ŽVIRBLIUKŲ;3218415151;Ne;11;0;1;12
18898;Gabijėlė;ŽVIRBLIUKŲ;8879972953;Ne;0;5;0;5
18899;Gabijėlė;ŽVIRBLIUKŲ;9627906252;Ne;3;0;8;11
18900;Gabijėlė;ŽVIRBLIUKŲ;1725665169;Ne;0;4;4;8
18901;Gabijėlė;ŽVIRBLIUKŲ;8292463617;Ne;8;6;0;14
18902;Gabijėlė;ŽVIRBLIUKŲ;6674038058;Ne;7;4;0;11
18903;Gabijėlė;ŽVIRBLIUKŲ;4146051969;Ne;0;0;1;1
18904;Gabijėlė;ŽVIRBLIUKŲ;6604681536;Ne;0;0;5;5
18905;Gabijėlė;ŽVIRBLIUKŲ;1273722177;Ne;14;0;0;14
18906;Gabijėlė;ŽVIRBLIUKŲ;6310234092;Ne;5;4;0;9
18907;Gabijėlė;ŽVIRBLIUKŲ;8384795164;Ne;5;0;0;5
18908;Gabijėlė;ŽVIRBLIUKŲ;3209491491;Ne;12;0;1;13
18909;Gabijėlė;GENIUKŲ;3445433386;Ne;0;8;0;8
18910;Gabijėlė;GENIUKŲ;2980295345;Ne;0;4;0;4
18911;Gabijėlė;GENIUKŲ;1862655595;Ne;0;4;0;4
18912;Gabijėlė;GENIUKŲ;7312628876;Ne;0;5;0;5
18913;Gabijėlė;GENIUKŲ;1581688238;Ne;0;4;3;7
18914;Gabijėlė;GENIUKŲ;3176075887;Ne;0;4;0;4
18915;Gabijėlė;GENIUKŲ;9972967198;Ne;0;2;1;3
18916;Gabijėlė;GENIUKŲ;1589534853;Ne;0;2;0;2
18917;Gabijėlė;GENIUKŲ;6482824000;Ne;0;6;4;10
18918;Gabijėlė;GENIUKŲ;5962852108;Ne;0;4;4;8
18919;Gabijėlė;GENIUKŲ;7178676049;Ne;0;4;0;4
18920;Gabijėlė;GENIUKŲ;1974388885;Ne;0;14;0;14
18921;Gabijėlė;GENIUKŲ;2407507314;Ne;0;4;4;8
18922;Gabijėlė;GENIUKŲ;3827747057;Ne;0;17;1;18
18923;Gabijėlė;GENIUKŲ;8305098808;Ne;1;5;0;6
18924;Gabijėlė;GENIUKŲ;4234733280;Ne;9;0;0;9
18925;Gabijėlė;GENIUKŲ;6375754699;Ne;0;4;0;4
18926;Gabijėlė;GENIUKŲ;2009199650;Ne;0;0;1;1
18927;Gabijėlė;GENIUKŲ;6869951613;Ne;0;5;0;5
18928;Gabijėlė;GENIUKŲ;7173852168;Ne;0;17;0;17
18929;Gabijėlė;GENIUKŲ;8036572198;Ne;0;5;0;5
18930;Gabijėlė;DAGILIUKŲ;9348393550;Ne;0;6;0;6
18931;Gabijėlė;DAGILIUKŲ;4264925447;Ne;0;6;0;6
18932;Gabijėlė;DAGILIUKŲ;9120107749;Ne;5;0;4;9
18933;Gabijėlė;DAGILIUKŲ;9494313873;Ne;0;2;0;2
18934;Gabijėlė;DAGILIUKŲ;3017939983;Ne;0;1;0;1
18935;Gabijėlė;DAGILIUKŲ;4462129182;Ne;5;1;1;7
18936;Gabijėlė;DAGILIUKŲ;9503639471;Ne;0;0;5;5
18937;Gabijėlė;DAGILIUKŲ;1988597157;Ne;10;0;1;11
18938;Gabijėlė;DAGILIUKŲ;9895518740;Ne;5;4;2;11
18939;Gabijėlė;DAGILIUKŲ;9449023766;Ne;0;4;0;4
18940;Gabijėlė;DAGILIUKŲ;1286688629;Ne;10;0;3;13
18941;Gabijėlė;DAGILIUKŲ;1455856766;Ne;0;0;2;2
18942;Gabijėlė;DAGILIUKŲ;6438144206;Ne;13;0;1;14
18943;Gabijėlė;DAGILIUKŲ;8662914262;Ne;0;11;0;11
18944;Gabijėlė;DAGILIUKŲ;9280283478;Ne;0;6;0;6
18945;Gabijėlė;DAGILIUKŲ;2254104149;Ne;0;6;0;6
18946;Gabijėlė;DAGILIUKŲ;8078326688;Ne;0;0;2;2
18947;Gabijėlė;DAGILIUKŲ;4490619514;Ne;10;0;0;10
18948;Gabijėlė;DAGILIUKŲ;2386980295;Ne;6;2;5;13
18949;Gabijėlė;DAGILIUKŲ;4664011011;Ne;11;0;0;11
18950;Gabijėlė;PELEDŽIUKŲ;4170105224;Ne;5;1;3;9
18951;Gabijėlė;PELEDŽIUKŲ;5675574534;Ne;5;0;0;5
18952;Gabijėlė;PELEDŽIUKŲ;5163460269;Ne;0;0;5;5
18953;Gabijėlė;PELEDŽIUKŲ;1356830225;Ne;5;1;0;6
18954;Gabijėlė;PELEDŽIUKŲ;9265103627;Ne;2;0;0;2
18955;Gabijėlė;PELEDŽIUKŲ;9451897367;Ne;8;0;1;9
18956;Gabijėlė;PELEDŽIUKŲ;2128428173;Ne;7;0;2;9
18957;Gabijėlė;PELEDŽIUKŲ;7028670164;Ne;5;0;7;12
18958;Gabijėlė;PELEDŽIUKŲ;5481472116;Ne;5;0;0;5
18959;Gabijėlė;PELEDŽIUKŲ;2885913045;Ne;4;2;0;6
18960;Gabijėlė;PELEDŽIUKŲ;5869580147;Ne;0;0;9;9
18961;Gabijėlė;PELEDŽIUKŲ;7096789623;Ne;7;0;5;12
18962;Gabijėlė;PELEDŽIUKŲ;4724322463;Ne;0;6;0;6
18963;Gabijėlė;PELEDŽIUKŲ;1810898809;Ne;4;0;4;8
18964;Gabijėlė;PELEDŽIUKŲ;5801792404;Ne;15;0;0;15
18965;Gabijėlė;PELEDŽIUKŲ;8550877260;Taip;5;0;0;5
18966;Gabijėlė;PELEDŽIUKŲ;5579070948;Ne;0;0;6;6
18967;Gabijėlė;PELEDŽIUKŲ;1076369632;Ne;11;0;0;11
18968;Gabijėlė;PELEDŽIUKŲ;8549800358;Ne;13;0;0;13
18969;Gabijėlė;PELEDŽIUKŲ;8133131896;Ne;0;0;1;1
18970;Gabijėlė;PELEDŽIUKŲ;2048046055;Ne;2;0;1;3
18971;Gabijėlė;PELEDŽIUKŲ;7261932151;Ne;4;0;0;4
18972;Gabijėlė;PELEDŽIUKŲ;8088806507;Ne;16;0;0;16
18973;Gabijėlė;PELEDŽIUKŲ;6728495961;Ne;11;0;0;11
18974;Gabijėlė;KREGZDŽIUKŲ;1759118326;Ne;0;15;0;15
18975;Gabijėlė;KREGZDŽIUKŲ;9533325351;Ne;0;15;0;15
18976;Gabijėlė;KREGZDŽIUKŲ;5407565441;Ne;10;0;0;10
18977;Gabijėlė;KREGZDŽIUKŲ;6845038692;Ne;0;3;0;3
18978;Gabijėlė;KREGZDŽIUKŲ;2357515455;Ne;6;0;0;6
18979;Gabijėlė;KREGZDŽIUKŲ;1574272380;Ne;0;18;0;18
18980;Gabijėlė;KREGZDŽIUKŲ;9675186834;Taip;7;5;0;12
18981;Gabijėlė;KREGZDŽIUKŲ;2634722171;Ne;0;5;0;5
18982;Gabijėlė;KREGZDŽIUKŲ;4317708029;Ne;0;8;0;8
18983;Gabijėlė;KREGZDŽIUKŲ;8555272917;Ne;0;4;0;4
18984;Gabijėlė;KREGZDŽIUKŲ;1142939183;Ne;0;8;0;8
18985;Gabijėlė;KREGZDŽIUKŲ;9676186208;Ne;0;3;0;3
18986;Gabijėlė;KREGZDŽIUKŲ;3584692524;Ne;4;0;0;4
18987;Gabijėlė;KREGZDŽIUKŲ;8613821848;Ne;0;10;2;12
18988;Gabijėlė;KREGZDŽIUKŲ;7038167942;Ne;0;7;0;7
18989;Gabijėlė;KREGZDŽIUKŲ;6570702235;Ne;0;1;0;1
18990;Gabijėlė;KREGZDŽIUKŲ;9528783892;Ne;0;12;0;12
18991;Gabijėlė;KREGZDŽIUKŲ;9358478209;Ne;0;0;1;1
18992;Gabijėlė;KREGZDŽIUKŲ;9030890792;Ne;9;0;1;10
18993;Gabijėlė;KREGZDŽIUKŲ;3031333199;Ne;9;0;1;10
18994;Gabijėlė;KREGZDŽIUKŲ;9116153981;Ne;0;6;0;6
18995;Gabijėlė;KREGZDŽIUKŲ;7447079902;Ne;12;0;0;12
18996;Gabijėlė;KREGZDŽIUKŲ;2289016022;Ne;0;12;5;17
18997;Gabijėlė;KREGZDŽIUKŲ;1230236612;Ne;0;0;4;4
18998;Gabijėlė;KREGZDŽIUKŲ;4575230225;Ne;14;0;0;14
18999;Gabijėlė;KREGZDŽIUKŲ;7224216275;Ne;0;0;4;4
19000;Gabijėlė;ZYLIUKŲ;6154378055;Ne;21;0;0;21
19001;Gabijėlė;ZYLIUKŲ;7700700293;Ne;10;4;1;15
19002;Gabijėlė;ZYLIUKŲ;6759447513;Ne;0;2;0;2
19003;Gabijėlė;ZYLIUKŲ;1090635644;Ne;11;0;0;11
19004;Gabijėlė;ZYLIUKŲ;9893869150;Ne;9;0;5;14
19005;Gabijėlė;ZYLIUKŲ;2764185879;Ne;5;0;5;10
19006;Gabijėlė;ZYLIUKŲ;7921467223;Ne;0;0;1;1
19007;Gabijėlė;ZYLIUKŲ;6446842432;Ne;0;10;0;10
19008;Gabijėlė;ZYLIUKŲ;4376486874;Ne;0;1;0;1
19009;Gabijėlė;ZYLIUKŲ;7047606048;Ne;0;0;3;3
19010;Gabijėlė;ZYLIUKŲ;6983092888;Ne;13;0;0;13
19011;Gabijėlė;ZYLIUKŲ;2727329238;Ne;0;2;0;2
19012;Gabijėlė;ZYLIUKŲ;8362509831;Ne;0;4;6;10
19013;Gabijėlė;ZYLIUKŲ;4907669556;Ne;0;4;5;9
19014;Gabijėlė;ZYLIUKŲ;1947898190;Ne;0;2;5;7
19015;Gabijėlė;ZYLIUKŲ;2384174631;Ne;2;0;9;11
19016;Gabijėlė;ZYLIUKŲ;6393256426;Ne;0;0;9;9
19017;Gabijėlė;ZYLIUKŲ;4166561084;Ne;0;2;0;2
19018;Gabijėlė;ZYLIUKŲ;5736012194;Ne;0;0;14;14
19019;Gabijėlė;ZYLIUKŲ;4712780337;Ne;6;0;0;6
19020;Gabijėlė;ZYLIUKŲ;7180444215;Ne;6;4;2;12
19021;Gabijėlė;ZYLIUKŲ;8965185578;Ne;0;10;0;10
19022;Gabijėlė;VOLUNGĖLIŲ;4000838897;Ne;3;1;4;8
19023;Gabijėlė;VOLUNGĖLIŲ;2099510027;Ne;11;1;1;13
19024;Gabijėlė;VOLUNGĖLIŲ;6842537434;Ne;0;4;0;4
19025;Gabijėlė;VOLUNGĖLIŲ;2227816651;Ne;0;2;0;2
19026;Gabijėlė;VOLUNGĖLIŲ;6956030813;Ne;7;1;0;8
19027;Gabijėlė;VOLUNGĖLIŲ;3902737481;Ne;0;4;0;4
19028;Gabijėlė;VOLUNGĖLIŲ;8733551230;Ne;16;0;0;16
19029;Gabijėlė;VOLUNGĖLIŲ;3763595874;Ne;10;5;0;15
19030;Gabijėlė;VOLUNGĖLIŲ;5360985745;Ne;8;0;0;8
19031;Gabijėlė;VOLUNGĖLIŲ;4580305437;Ne;0;7;0;7
19032;Gabijėlė;VOLUNGĖLIŲ;5737066080;Ne;6;0;0;6
19033;Gabijėlė;VOLUNGĖLIŲ;5972136800;Ne;0;1;1;2
19034;Gabijėlė;VOLUNGĖLIŲ;3972933727;Ne;13;0;0;13
19035;Gabijėlė;VOLUNGĖLIŲ;6643563560;Ne;0;10;0;10
19036;Gabijėlė;VOLUNGĖLIŲ;8312753333;Ne;0;7;0;7
19037;Gabijėlė;VOLUNGĖLIŲ;2523400466;Ne;3;1;1;5
19038;Gabijėlė;VOLUNGĖLIŲ;8569742033;Ne;0;5;6;11
19039;Gabijėlė;VOLUNGĖLIŲ;8327903800;Ne;5;0;0;5
19040;Gabijėlė;VOLUNGĖLIŲ;2251276876;Ne;0;6;0;6
19041;Gabijėlė;VOLUNGĖLIŲ;4160646449;Ne;0;1;0;1
19042;Gabijėlė;VOLUNGĖLIŲ;5060265729;Ne;6;0;0;6
19043;Gabijėlė;VOLUNGĖLIŲ;6960725029;Ne;19;0;0;19
19044;Gabijėlė;VOLUNGĖLIŲ;3098846537;Ne;6;0;0;6
19045;Gabijėlė;VOLUNGĖLIŲ;3995459990;Ne;0;2;0;2
19046;Gabijėlė;VOLUNGĖLIŲ;8320449381;Ne;0;11;0;11
19047;Gabijėlė;VOLUNGĖLIŲ;3267339129;Ne;6;1;1;8
19048;Gabijėlė;VOLUNGĖLIŲ;4304012457;Ne;13;0;1;14
19049;Gabijėlė;ANČIUKŲ;2036978425;Ne;0;12;0;12
19050;Gabijėlė;ANČIUKŲ;5219706067;Ne;0;8;0;8
19051;Gabijėlė;ANČIUKŲ;3454412432;Ne;1;2;0;3
19052;Gabijėlė;ANČIUKŲ;9822093084;Ne;0;5;0;5
19053;Gabijėlė;ANČIUKŲ;1415184607;Ne;12;4;0;16
19054;Gabijėlė;ANČIUKŲ;85836097485;Ne;0;5;2;7
19055;Gabijėlė;ANČIUKŲ;28017865889;Ne;0;6;0;6
19056;Gabijėlė;ANČIUKŲ;1917587420;Ne;0;15;0;15
19057;Gabijėlė;ANČIUKŲ;1465584524;Ne;4;4;0;8
19058;Gabijėlė;ANČIUKŲ;6198439092;Ne;4;7;0;11
19059;Gabijėlė;ANČIUKŲ;7948343328;Ne;0;10;0;10
19060;Gabijėlė;ANČIUKŲ;2052892422;Ne;0;2;2;4
19061;Gabijėlė;ANČIUKŲ;8111239476;Ne;0;11;0;11
19062;Gabijėlė;ANČIUKŲ;8778396292;Ne;3;4;1;8
19063;Gabijėlė;ANČIUKŲ;4085049535;Ne;0;1;0;1
19064;Gabijėlė;ANČIUKŲ;8893637755;Ne;19;1;0;20
19065;Gabijėlė;ANČIUKŲ;8874692591;Ne;5;4;0;9
19066;Gabijėlė;ANČIUKŲ;4752631976;Ne;0;0;1;1
19067;Gabijėlė;ANČIUKŲ;5783373671;Ne;0;8;0;8
19068;Gabijėlė;ANČIUKŲ;6766770793;Ne;0;5;0;5
19069;Gabijėlė;ANČIUKŲ;10796114623;Ne;0;5;0;5
19070;Gabijėlė;ANČIUKŲ;43123279348;Ne;0;11;0;11
19071;Gabijėlė;BALANDŽIUKŲ;6719097956;Ne;0;4;1;5
19072;Gabijėlė;BALANDŽIUKŲ;9157819780;Ne;0;7;0;7
19073;Gabijėlė;BALANDŽIUKŲ;1045338865;Ne;0;7;0;7
19074;Gabijėlė;BALANDŽIUKŲ;2097260657;Ne;3;7;0;10
19075;Gabijėlė;BALANDŽIUKŲ;8525869648;Ne;0;8;0;8
19076;Gabijėlė;BALANDŽIUKŲ;2070050969;Ne;0;10;0;10
19077;Gabijėlė;BALANDŽIUKŲ;15049855022;Ne;0;9;0;9
19078;Gabijėlė;BALANDŽIUKŲ;2776579713;Ne;0;6;0;6
19079;Gabijėlė;BALANDŽIUKŲ;7977751362;Ne;0;1;0;1
19080;Gabijėlė;BALANDŽIUKŲ;5906952432;Ne;0;1;0;1
19081;Gabijėlė;BALANDŽIUKŲ;9197020006;Ne;10;5;0;15
19082;Gabijėlė;BALANDŽIUKŲ;1615940996;Ne;0;6;0;6
19083;Gabijėlė;BALANDŽIUKŲ;65735862964;Ne;0;1;0;1
19084;Gabijėlė;BALANDŽIUKŲ;56914218692;Ne;0;5;0;5
19085;Gabijėlė;BALANDŽIUKŲ;4110081664;Ne;9;1;0;10
19086;Gabijėlė;BALANDŽIUKŲ;4330624300;Ne;3;4;0;7
19087;Gabijėlė;BALANDŽIUKŲ;2921208571;Ne;2;2;1;5
19088;Gabijėlė;BALANDŽIUKŲ;9501202207;Ne;0;12;0;12
19089;Gabijėlė;BALANDŽIUKŲ;6145720452;Ne;0;6;0;6
19090;Gabijėlė;BALANDŽIUKŲ;7563741123;Ne;0;6;0;6
19091;Gabijėlė;BALANDŽIUKŲ;3694447705;Ne;11;2;0;13
19092;Gabijėlė;BALANDŽIUKŲ;2189532651;Ne;0;3;0;3
19093;Gabijėlė;VYTURIUKŲ;6131649116;Ne;11;0;5;16
19094;Gabijėlė;VYTURIUKŲ;7894667201;Ne;16;0;0;16
19095;Gabijėlė;VYTURIUKŲ;3973977318;Ne;0;0;6;6
19096;Gabijėlė;VYTURIUKŲ;3454061135;Ne;0;0;1;1
19097;Gabijėlė;VYTURIUKŲ;5769331689;Ne;0;0;1;1
19098;Gabijėlė;VYTURIUKŲ;5652244967;Ne;10;0;0;10
19099;Gabijėlė;VYTURIUKŲ;6013482554;Ne;0;6;0;6
19100;Gabijėlė;VYTURIUKŲ;3343196830;Ne;0;0;4;4
19101;Gabijėlė;VYTURIUKŲ;9021225516;Ne;0;0;5;5
19102;Gabijėlė;VYTURIUKŲ;1523190444;Ne;0;0;2;2
19103;Gabijėlė;VYTURIUKŲ;7295985579;Ne;16;0;0;16
19104;Gabijėlė;VYTURIUKŲ;6834871835;Ne;16;0;0;16
19105;Gabijėlė;VYTURIUKŲ;8749080961;Ne;0;0;10;10
19106;Gabijėlė;VYTURIUKŲ;1185216449;Ne;7;0;0;7
19107;Gabijėlė;VYTURIUKŲ;6107630313;Ne;14;0;0;14
19108;Gabijėlė;VYTURIUKŲ;5297866989;Ne;0;0;2;2
19109;Gabijėlė;VYTURIUKŲ;4278783863;Ne;6;0;0;6
19110;Gabijėlė;VYTURIUKŲ;7509112343;Ne;18;0;0;18
19111;Gabijėlė;VYTURIUKŲ;4248856615;Ne;2;2;0;4
19112;Gabijėlė;VYTURIUKŲ;6539078572;Ne;0;5;0;5
19113;Gabijėlė;VYTURIUKŲ;9657713903;Ne;17;0;0;17
19114;Gabijėlė;VYTURIUKŲ;5310270057;Ne;3;0;1;4
19115;Saulėgrąža;Bitutės;8660677159;Ne;0;7;5;12
19116;Saulėgrąža;Bitutės;9437387272;Ne;6;0;2;8
19117;Saulėgrąža;Bitutės;5940167166;Ne;7;0;0;7
19118;Saulėgrąža;Bitutės;4380287979;Ne;0;4;0;4
19119;Saulėgrąža;Bitutės;6641588877;Ne;11;0;0;11
19120;Saulėgrąža;Bitutės;8505655534;Ne;0;2;1;3
19121;Saulėgrąža;Bitutės;2809788049;Ne;0;1;6;7
19122;Saulėgrąža;Bitutės;4733063461;Ne;0;4;2;6
19123;Saulėgrąža;Bitutės;3899237871;Ne;0;3;0;3
19124;Saulėgrąža;Bitutės;1381240000;Ne;4;2;6;12
19125;Saulėgrąža;Bitutės;8766433391;Ne;9;2;0;11
19126;Saulėgrąža;Bitutės;7283302671;Ne;0;0;2;2
19127;Saulėgrąža;Bitutės;4265356484;Ne;4;0;0;4
19128;Saulėgrąža;Bitutės;2042826101;Ne;0;0;4;4
19129;Saulėgrąža;Bitutės;4471740960;Ne;0;0;1;1
19130;Saulėgrąža;Bitutės;8384708422;Ne;5;0;2;7
19131;Saulėgrąža;Bitutės;1345079291;Ne;0;7;0;7
19132;Saulėgrąža;Bitutės;3319538368;Ne;2;4;0;6
19133;Saulėgrąža;Bitutės;8597567633;Ne;4;1;0;5
19134;Saulėgrąža;Bitutės;7387477589;Ne;6;1;0;7
19135;Saulėgrąža;Bitutės;5221286194;Ne;5;3;4;12
19136;Saulėgrąža;Bitutės;9481319116;Ne;0;1;2;3
19137;Saulėgrąža;Bitutės;8531862400;Ne;4;4;1;9
19138;Saulėgrąža;Šnekučiai;7666307601;Ne;1;0;0;1
19139;Saulėgrąža;Šnekučiai;1128467783;Ne;11;0;0;11
19140;Saulėgrąža;Skruzdėliukai;7211562324;Ne;0;2;1;3
19141;Saulėgrąža;Skruzdėliukai;7636592904;Ne;2;4;3;9
19142;Saulėgrąža;Skruzdėliukai;87694187780;Ne;0;4;1;5
19143;Saulėgrąža;Skruzdėliukai;8550558301;Ne;0;1;0;1
19144;Saulėgrąža;Skruzdėliukai;6036373745;Ne;3;9;1;13
19145;Saulėgrąža;Skruzdėliukai;2029367287;Ne;9;0;0;9
19146;Saulėgrąža;Skruzdėliukai;4904157108;Ne;0;4;2;6
19147;Saulėgrąža;Skruzdėliukai;2453261741;Ne;2;4;1;7
19148;Saulėgrąža;Skruzdėliukai;6867062357;Ne;0;3;0;3
19149;Saulėgrąža;Skruzdėliukai;9701242161;Ne;7;0;0;7
19150;Saulėgrąža;Skruzdėliukai;2123441401;Ne;5;0;0;5
19151;Saulėgrąža;Skruzdėliukai;6373141401;Ne;0;2;0;2
19152;Saulėgrąža;Skruzdėliukai;5674402704;Ne;0;14;0;14
19153;Saulėgrąža;Skruzdėliukai;8140258691;Ne;17;0;0;17
19154;Saulėgrąža;Skruzdėliukai;3839880985;Ne;0;0;6;6
19155;Saulėgrąža;Skruzdėliukai;1397888834;Ne;0;0;11;11
19156;Saulėgrąža;Skruzdėliukai;4902990966;Ne;6;0;2;8
19157;Saulėgrąža;Gudručiai;1557512232;Ne;0;0;2;2
19158;Saulėgrąža;Gudručiai;3334830210;Ne;11;0;1;12
19159;Saulėgrąža;Gudručiai;3460944414;Ne;1;0;0;1
19160;Saulėgrąža;Gudručiai;6087243776;Ne;5;6;0;11
19161;Saulėgrąža;Gudručiai;4656827505;Ne;11;4;0;15
19162;Saulėgrąža;Gudručiai;2325641957;Ne;6;0;0;6
19163;Saulėgrąža;Gudručiai;2142393859;Ne;13;0;1;14
19164;Saulėgrąža;Gudručiai;9377753981;Ne;0;6;0;6
19165;Saulėgrąža;Gudručiai;2811204521;Ne;5;0;0;5
19166;Saulėgrąža;Gudručiai;9703861091;Ne;5;0;4;9
19167;Saulėgrąža;Gudručiai;5493928884;Ne;11;0;0;11
19168;Saulėgrąža;Gudručiai;6925730672;Ne;0;10;0;10
19169;Saulėgrąža;Gudručiai;9537997340;Ne;0;5;0;5
19170;Saulėgrąža;Gudručiai;4593109666;Ne;7;2;0;9
19171;Saulėgrąža;Gudručiai;3455052574;Ne;4;0;1;5
19172;Saulėgrąža;Gudručiai;6803731510;Ne;5;0;2;7
19173;Saulėgrąža;Gudručiai;9235493036;Ne;6;0;0;6
19174;Saulėgrąža;Gudručiai;5230565797;Ne;0;4;0;4
19175;Saulėgrąža;Gudručiai;7499997676;Ne;0;0;7;7
19176;Saulėgrąža;Gudručiai;3178867955;Ne;5;0;0;5
19177;Saulėgrąža;Gudručiai;3178867955;Ne;5;0;0;5
19178;Saulėgrąža;Smalsučiai;1507699415;Ne;10;0;4;14
19179;Saulėgrąža;Smalsučiai;6415042057;Ne;0;3;0;3
19180;Saulėgrąža;Smalsučiai;2378071205;Ne;0;4;0;4
19181;Saulėgrąža;Smalsučiai;7374802873;Ne;11;4;0;15
19182;Saulėgrąža;Smalsučiai;2405382490;Ne;0;4;2;6
19183;Saulėgrąža;Smalsučiai;7236623241;Ne;5;4;0;9
19184;Saulėgrąža;Smalsučiai;4204112706;Ne;0;5;0;5
19185;Saulėgrąža;Smalsučiai;7804106261;Ne;13;0;0;13
19186;Saulėgrąža;Smalsučiai;6627868194;Ne;16;0;0;16
19187;Saulėgrąža;Smalsučiai;9859511749;Ne;4;2;0;6
19188;Saulėgrąža;Smalsučiai;3574399274;Ne;0;9;0;9
19189;Saulėgrąža;Smalsučiai;5201590576;Ne;0;5;0;5
19190;Saulėgrąža;Smalsučiai;12350048317;Ne;4;4;0;8
19191;Saulėgrąža;Smalsučiai;3214026239;Ne;0;0;2;2
19192;Saulėgrąža;Smalsučiai;1314754650;Ne;0;15;0;15
19193;Saulėgrąža;Smalsučiai;7964046826;Ne;0;4;0;4
19194;Saulėgrąža;Smalsučiai;3517616785;Ne;9;0;0;9
19195;Saulėgrąža;Smalsučiai;4252425680;Ne;10;0;0;10
19196;Saulėgrąža;Smalsučiai;1563002207;Ne;0;8;0;8
19197;Saulėgrąža;"Boruželės ";3889868838;Ne;14;0;0;14
19198;Saulėgrąža;"Boruželės ";1613110580;Ne;0;0;2;2
19199;Saulėgrąža;"Boruželės ";6802366478;Ne;0;0;3;3
19200;Saulėgrąža;"Boruželės ";9604238128;Ne;0;0;9;9
19201;Saulėgrąža;"Boruželės ";4587532777;Ne;6;0;0;6
19202;Saulėgrąža;"Boruželės ";4930162914;Ne;0;0;2;2
19203;Saulėgrąža;"Boruželės ";8986368849;Ne;8;0;0;8
19204;Saulėgrąža;"Boruželės ";3080026762;Ne;7;0;0;7
19205;Saulėgrąža;"Boruželės ";9328524382;Ne;17;0;0;17
19206;Saulėgrąža;"Boruželės ";2598768766;Ne;6;0;0;6
19207;Saulėgrąža;"Boruželės ";5734857301;Ne;18;0;0;18
19208;Saulėgrąža;"Boruželės ";9658060059;Ne;15;4;0;19
19209;Saulėgrąža;"Boruželės ";3594593787;Ne;5;5;0;10
19210;Saulėgrąža;"Boruželės ";2455622343;Ne;6;3;1;10
19211;Saulėgrąža;Žiogeliai;7399313501;Ne;5;0;0;5
19212;Saulėgrąža;Drugeliai;8155080474;Ne;4;0;6;10
19213;Saulėgrąža;Drugeliai;1955944355;Ne;6;0;0;6
19214;Saulėgrąža;Drugeliai;8337203952;Ne;0;0;7;7
19215;Saulėgrąža;Drugeliai;6127496900;Ne;14;0;0;14
19216;Saulėgrąža;Drugeliai;7267854768;Ne;0;4;0;4
19217;Saulėgrąža;Drugeliai;8841882983;Ne;14;4;0;18
19218;Saulėgrąža;Drugeliai;6608001857;Ne;0;4;0;4
19219;Saulėgrąža;Drugeliai;4663169787;Ne;0;0;8;8
19220;Saulėgrąža;Drugeliai;6981928727;Ne;0;0;4;4
19221;Saulėgrąža;Drugeliai;8873608939;Ne;0;4;0;4
19222;Saulėgrąža;Drugeliai;7281353368;Ne;4;5;0;9
19223;Saulėgrąža;Drugeliai;8138991066;Ne;12;0;0;12
19224;Saulėgrąža;Drugeliai;4767744537;Ne;10;0;1;11
19225;Saulėgrąža;Drugeliai;4361365993;Ne;0;0;7;7
19226;Saulėgrąža;Drugeliai;8882080945;Ne;0;0;7;7
19227;Saulėgrąža;Drugeliai;1080500584;Ne;0;6;0;6
19228;Saulėgrąža;Drugeliai;1386348080;Ne;0;0;7;7
19229;Saulėgrąža;Drugeliai;3318222372;Ne;0;6;0;6
19230;Saulėgrąža;Drugeliai;8148900529;Ne;0;0;1;1
19231;Saulėgrąža;Pabiručiai;2570007539;Ne;6;0;1;7
19232;Saulėgrąža;Pabiručiai;1193968905;Ne;15;0;0;15
19233;Saulėgrąža;Pabiručiai;6924492377;Ne;11;0;2;13
19234;Saulėgrąža;Pabiručiai;9812784697;Ne;8;10;0;18
19235;Saulėgrąža;Pabiručiai;1732823416;Ne;1;0;2;3
19236;Saulėgrąža;Pabiručiai;5417303387;Ne;0;0;2;2
19237;Saulėgrąža;Pabiručiai;4687158499;Ne;1;0;0;1
19238;Saulėgrąža;Pabiručiai;4113866451;Ne;9;0;1;10
19239;Saulėgrąža;Pabiručiai;5759064166;Ne;0;2;4;6
19240;Saulėgrąža;Pabiručiai;3014850439;Ne;13;0;0;13
19241;Saulėgrąža;Pabiručiai;7563907981;Ne;11;4;2;17
19242;Saulėgrąža;Pabiručiai;7110805205;Ne;11;0;1;12
19243;Saulėgrąža;Pabiručiai;6489291407;Ne;10;0;0;10
19244;Saulėgrąža;Pabiručiai;5302001715;Ne;7;0;9;16
19245;Saulėgrąža;Pabiručiai;6846627257;Ne;2;0;2;4
19246;Saulėgrąža;Pabiručiai;4869924215;Ne;0;0;2;2
19247;Saulėgrąža;Pabiručiai;7492804255;Ne;0;0;4;4
19248;Saulėgrąža;Žvirbliukai;4642639501;Ne;2;0;1;3
19249;Saulėgrąža;Žvirbliukai;2655671127;Ne;3;0;1;4
19250;Saulėgrąža;Žvirbliukai;7136064458;Ne;8;0;0;8
19251;Saulėgrąža;Žvirbliukai;9750125588;Ne;2;0;1;3
19252;Saulėgrąža;Žvirbliukai;6521035871;Ne;18;0;0;18
19253;Saulėgrąža;Žvirbliukai;2534711249;Ne;0;0;3;3
19254;Saulėgrąža;Žvirbliukai;4022011749;Ne;7;0;0;7
19255;Saulėgrąža;Žvirbliukai;7341460478;Ne;0;0;6;6
19256;Saulėgrąža;Žvirbliukai;3611547634;Ne;4;0;0;4
19257;Saulėgrąža;Žvirbliukai;6914492465;Ne;20;0;0;20
19258;Saulėgrąža;Žvirbliukai;4804554877;Ne;15;0;0;15
19259;Saulėgrąža;Žvirbliukai;7772718729;Ne;0;7;0;7
19260;Saulėgrąža;Žvirbliukai;2061821043;Ne;0;0;3;3
19261;Saulėgrąža;Žvirbliukai;2869737300;Ne;4;0;0;4
19262;Saulėgrąža;Žvirbliukai;4154566152;Ne;0;0;5;5
19263;Saulėgrąža;Pagrandukai;9226189126;Ne;0;0;5;5
19264;Saulėgrąža;Pagrandukai;7283179482;Ne;9;4;1;14
19265;Saulėgrąža;Pagrandukai;3060727219;Ne;0;0;13;13
19266;Saulėgrąža;Pagrandukai;4405035646;Ne;4;0;2;6
19267;Saulėgrąža;Pagrandukai;4017783391;Ne;12;0;0;12
19268;Saulėgrąža;Pagrandukai;3811142022;Ne;3;5;0;8
19269;Saulėgrąža;Pagrandukai;5584937620;Ne;0;0;9;9
19270;Saulėgrąža;Pagrandukai;3745791935;Ne;11;0;1;12
19271;Saulėgrąža;Pagrandukai;3785206644;Ne;3;2;5;10
19272;Saulėgrąža;Pagrandukai;2395186861;Ne;21;0;0;21
19273;Saulėgrąža;Pagrandukai;6130342214;Ne;0;1;11;12
19274;Saulėgrąža;Pagrandukai;3860139612;Ne;0;0;12;12
19275;Saulėgrąža;Pagrandukai;5633604322;Ne;0;1;9;10
19276;Saulėgrąža;Pagrandukai;2882565651;Ne;5;0;1;6
19277;Saulėgrąža;Pagrandukai;3122607003;Ne;0;0;3;3
19278;Saulėgrąža;ŽIRNIUKAI;3124081874;Ne;9;0;0;9
19279;"Pilaitukas (I. Kanto al. 7A)";BITUTĖS;3519198814;Ne;0;1;0;1
19280;"Pilaitukas (I. Kanto al. 7A)";BITUTĖS;8169484415;Ne;5;5;0;10
19281;"Pilaitukas (I. Kanto al. 7A)";BITUTĖS;1253300093;Ne;0;1;0;1
19282;"Pilaitukas (I. Kanto al. 7A)";BITUTĖS;2242454299;Ne;0;6;0;6
19283;"Pilaitukas (I. Kanto al. 7A)";BITUTĖS;4082490488;Ne;5;2;0;7
19284;"Pilaitukas (I. Kanto al. 7A)";BITUTĖS;3345387791;Ne;0;5;0;5
19285;"Pilaitukas (I. Kanto al. 7A)";BITUTĖS;3541354283;Ne;0;1;1;2
19286;"Pilaitukas (I. Kanto al. 7A)";BITUTĖS;5740951665;Ne;5;4;5;14
19287;"Pilaitukas (I. Kanto al. 7A)";BITUTĖS;4591799893;Ne;15;1;0;16
19288;"Pilaitukas (I. Kanto al. 7A)";BITUTĖS;6308557885;Ne;9;1;0;10
19289;"Pilaitukas (I. Kanto al. 7A)";BITUTĖS;6514731102;Ne;5;3;0;8
19290;"Pilaitukas (I. Kanto al. 7A)";BITUTĖS;5988165204;Ne;1;0;0;1
19291;"Pilaitukas (I. Kanto al. 7A)";BITUTĖS;3037850837;Ne;4;7;0;11
19292;"Pilaitukas (I. Kanto al. 7A)";BITUTĖS;9126553732;Ne;6;2;1;9
19293;"Pilaitukas (I. Kanto al. 7A)";BITUTĖS;7438112270;Ne;0;0;1;1
19294;"Pilaitukas (I. Kanto al. 7A)";BITUTĖS;1295215465;Ne;0;4;0;4
19295;"Pilaitukas (I. Kanto al. 7A)";BITUTĖS;5331915157;Ne;0;0;3;3
19296;"Pilaitukas (I. Kanto al. 7A)";BITUTĖS;6099109886;Ne;0;1;0;1
19297;"Pilaitukas (I. Kanto al. 7A)";BITUTĖS;3159733673;Ne;0;2;1;3
19298;"Pilaitukas (I. Kanto al. 7A)";BITUTĖS;2122392982;Ne;0;6;0;6
19299;"Pilaitukas (I. Kanto al. 7A)";BITUTĖS;7082099968;Ne;0;5;0;5
19300;"Pilaitukas (I. Kanto al. 7A)";ZUIKUČIAI;8993885764;Ne;0;8;0;8
19301;"Pilaitukas (I. Kanto al. 7A)";ZUIKUČIAI;5206637809;Ne;0;0;2;2
19302;"Pilaitukas (I. Kanto al. 7A)";ZUIKUČIAI;5288784331;Ne;0;1;1;2
19303;"Pilaitukas (I. Kanto al. 7A)";ZUIKUČIAI;8255398803;Ne;0;7;0;7
19304;"Pilaitukas (I. Kanto al. 7A)";ZUIKUČIAI;2862447956;Ne;0;9;0;9
19305;"Pilaitukas (I. Kanto al. 7A)";ZUIKUČIAI;8727175656;Ne;0;9;0;9
19306;"Pilaitukas (I. Kanto al. 7A)";ZUIKUČIAI;8207194955;Ne;0;2;3;5
19307;"Pilaitukas (I. Kanto al. 7A)";ZUIKUČIAI;5640802570;Ne;0;1;0;1
19308;"Pilaitukas (I. Kanto al. 7A)";ZUIKUČIAI;4623818227;Ne;9;4;0;13
19309;"Pilaitukas (I. Kanto al. 7A)";ZUIKUČIAI;9260893320;Ne;0;1;0;1
19310;"Pilaitukas (I. Kanto al. 7A)";ZUIKUČIAI;9988041515;Ne;0;1;2;3
19311;"Pilaitukas (I. Kanto al. 7A)";ZUIKUČIAI;9108428738;Ne;0;1;2;3
19312;"Pilaitukas (I. Kanto al. 7A)";ZUIKUČIAI;1607454890;Ne;0;1;9;10
19313;"Pilaitukas (I. Kanto al. 7A)";ZUIKUČIAI;9878890346;Ne;0;6;0;6
19314;"Pilaitukas (I. Kanto al. 7A)";ZUIKUČIAI;5710747769;Ne;8;2;0;10
19315;"Pilaitukas (I. Kanto al. 7A)";ZUIKUČIAI;7568744500;Ne;0;4;0;4
19316;"Pilaitukas (I. Kanto al. 7A)";ZUIKUČIAI;5407354218;Ne;6;7;0;13
19317;"Pilaitukas (I. Kanto al. 7A)";ZUIKUČIAI;1704055907;Ne;0;4;9;13
19318;"Pilaitukas (I. Kanto al. 7A)";ZUIKUČIAI;7853910193;Ne;2;0;4;6
19319;"Pilaitukas (I. Kanto al. 7A)";ZUIKUČIAI;6426415533;Ne;0;0;1;1
19320;"Pilaitukas (I. Kanto al. 7A)";ZUIKUČIAI;2705235576;Ne;0;16;0;16
19321;"Pilaitukas (I. Kanto al. 7A)";ZUIKUČIAI;9688421636;Ne;0;6;0;6
19322;"Pilaitukas (I. Kanto al. 7A)";ANČIUKAI;7773318230;Ne;0;7;0;7
19323;"Pilaitukas (I. Kanto al. 7A)";ANČIUKAI;4097742120;Ne;10;1;0;11
19324;"Pilaitukas (I. Kanto al. 7A)";ANČIUKAI;2923272767;Ne;10;1;0;11
19325;"Pilaitukas (I. Kanto al. 7A)";ANČIUKAI;8620858011;Ne;5;0;0;5
19326;"Pilaitukas (I. Kanto al. 7A)";ANČIUKAI;4286388920;Ne;0;8;0;8
19327;"Pilaitukas (I. Kanto al. 7A)";ANČIUKAI;3761827714;Ne;0;1;0;1
19328;"Pilaitukas (I. Kanto al. 7A)";ANČIUKAI;8643066116;Ne;0;2;0;2
19329;"Pilaitukas (I. Kanto al. 7A)";ANČIUKAI;1120549352;Ne;4;0;1;5
19330;"Pilaitukas (I. Kanto al. 7A)";ANČIUKAI;6888607864;Ne;0;6;0;6
19331;"Pilaitukas (I. Kanto al. 7A)";ANČIUKAI;7876850509;Ne;0;1;3;4
19332;"Pilaitukas (I. Kanto al. 7A)";ANČIUKAI;8033540052;Ne;6;2;1;9
19333;"Pilaitukas (I. Kanto al. 7A)";ANČIUKAI;1781762820;Ne;4;1;0;5
19334;"Pilaitukas (I. Kanto al. 7A)";ANČIUKAI;8787181006;Ne;0;2;0;2
19335;"Pilaitukas (I. Kanto al. 7A)";ANČIUKAI;7189824054;Ne;0;2;0;2
19336;"Pilaitukas (I. Kanto al. 7A)";ANČIUKAI;9332831979;Ne;0;4;0;4
19337;"Pilaitukas (I. Kanto al. 7A)";ANČIUKAI;5706918634;Ne;14;0;1;15
19338;"Pilaitukas (I. Kanto al. 7A)";ANČIUKAI;8954370321;Ne;0;0;1;1
19339;"Pilaitukas (I. Kanto al. 7A)";MEŠKIUKAI;8577357264;Ne;0;1;0;1
19340;"Pilaitukas (I. Kanto al. 7A)";MEŠKIUKAI;5297214263;Ne;8;2;0;10
19341;"Pilaitukas (I. Kanto al. 7A)";MEŠKIUKAI;8268790017;Ne;10;0;0;10
19342;"Pilaitukas (I. Kanto al. 7A)";MEŠKIUKAI;2054626415;Ne;8;7;0;15
19343;"Pilaitukas (I. Kanto al. 7A)";MEŠKIUKAI;9742268665;Ne;0;21;0;21
19344;"Pilaitukas (I. Kanto al. 7A)";MEŠKIUKAI;8322980583;Ne;0;4;0;4
19345;"Pilaitukas (I. Kanto al. 7A)";MEŠKIUKAI;1610122884;Ne;6;2;0;8
19346;"Pilaitukas (I. Kanto al. 7A)";MEŠKIUKAI;3867660147;Ne;4;1;0;5
19347;"Pilaitukas (I. Kanto al. 7A)";MEŠKIUKAI;2365387089;Ne;0;0;3;3
19348;"Pilaitukas (I. Kanto al. 7A)";MEŠKIUKAI;9670329628;Ne;0;10;0;10
19349;"Pilaitukas (I. Kanto al. 7A)";MEŠKIUKAI;7750575554;Ne;3;12;0;15
19350;"Pilaitukas (I. Kanto al. 7A)";MEŠKIUKAI;9397435605;Ne;0;5;0;5
19351;"Pilaitukas (I. Kanto al. 7A)";MEŠKIUKAI;4171896175;Ne;5;0;0;5
19352;"Pilaitukas (I. Kanto al. 7A)";MEŠKIUKAI;6807166920;Ne;0;4;0;4
19353;"Pilaitukas (I. Kanto al. 7A)";MEŠKIUKAI;1591276987;Ne;0;1;0;1
19354;"Pilaitukas (I. Kanto al. 7A)";MEŠKIUKAI;2830212921;Ne;9;1;0;10
19355;"Pilaitukas (I. Kanto al. 7A)";MEŠKIUKAI;9930306085;Ne;19;0;0;19
19356;"Pilaitukas (I. Kanto al. 7A)";MEŠKIUKAI;8279288250;Ne;19;0;0;19
19357;"Pilaitukas (I. Kanto al. 7A)";ŽUVYTĖS;48011638560;Ne;0;4;0;4
19358;"Pilaitukas (I. Kanto al. 7A)";ŽUVYTĖS;8109335587;Ne;0;1;0;1
19359;"Pilaitukas (I. Kanto al. 7A)";ŽUVYTĖS;8319676743;Ne;3;4;0;7
19360;"Pilaitukas (I. Kanto al. 7A)";ŽUVYTĖS;36338976218;Ne;1;4;0;5
19361;"Pilaitukas (I. Kanto al. 7A)";ŽUVYTĖS;9224653856;Ne;1;0;0;1
19362;"Pilaitukas (I. Kanto al. 7A)";ŽUVYTĖS;4694691187;Ne;3;0;0;3
19363;"Pilaitukas (I. Kanto al. 7A)";ŽUVYTĖS;5252233127;Ne;5;5;0;10
19364;"Pilaitukas (I. Kanto al. 7A)";ŽUVYTĖS;5206439753;Ne;9;2;0;11
19365;"Pilaitukas (I. Kanto al. 7A)";ŽUVYTĖS;6222888898;Ne;0;2;0;2
19366;"Pilaitukas (I. Kanto al. 7A)";ŽUVYTĖS;1512181401;Ne;1;4;0;5
19367;"Pilaitukas (I. Kanto al. 7A)";ŽUVYTĖS;2298935154;Ne;0;3;0;3
19368;"Pilaitukas (I. Kanto al. 7A)";ŽUVYTĖS;2117570444;Ne;1;0;0;1
19369;"Pilaitukas (I. Kanto al. 7A)";ŽUVYTĖS;79485847381;Ne;0;1;0;1
19370;"Pilaitukas (I. Kanto al. 7A)";ŽUVYTĖS;92108889661;Ne;0;5;0;5
19371;"Pilaitukas (I. Kanto al. 7A)";ŽUVYTĖS;4505384039;Ne;0;2;0;2
19372;"Pilaitukas (I. Kanto al. 7A)";ŽUVYTĖS;58250008277;Ne;0;8;0;8
19373;"Pilaitukas (I. Kanto al. 7A)";ŽUVYTĖS;1618432877;Ne;5;0;0;5
19374;"Pilaitukas (I. Kanto al. 7A)";ŽUVYTĖS;9724892897;Ne;6;4;0;10
19375;"Pilaitukas (I. Kanto al. 7A)";ŽUVYTĖS;3821748678;Ne;0;4;0;4
19376;"Pilaitukas (I. Kanto al. 7A)";ŽUVYTĖS;1114477688;Ne;0;5;0;5
19377;"Pilaitukas (I. Kanto al. 7A)";PAUKŠTELIAI;3325511140;Ne;0;7;0;7
19378;"Pilaitukas (I. Kanto al. 7A)";PAUKŠTELIAI;6514784647;Ne;0;6;0;6
19379;"Pilaitukas (I. Kanto al. 7A)";PAUKŠTELIAI;4505147961;Ne;0;4;0;4
19380;"Pilaitukas (I. Kanto al. 7A)";PAUKŠTELIAI;2736736697;Ne;0;5;0;5
19381;"Pilaitukas (I. Kanto al. 7A)";PAUKŠTELIAI;1135880899;Ne;7;0;0;7
19382;"Pilaitukas (I. Kanto al. 7A)";PAUKŠTELIAI;18466900688;Ne;0;5;0;5
19383;"Pilaitukas (I. Kanto al. 7A)";PAUKŠTELIAI;4038320896;Ne;0;5;1;6
19384;"Pilaitukas (I. Kanto al. 7A)";PAUKŠTELIAI;5689385925;Ne;0;5;0;5
19385;"Pilaitukas (I. Kanto al. 7A)";PAUKŠTELIAI;5405252621;Ne;0;4;0;4
19386;"Pilaitukas (I. Kanto al. 7A)";PAUKŠTELIAI;39600380611;Ne;0;5;0;5
19387;"Pilaitukas (I. Kanto al. 7A)";PAUKŠTELIAI;3214740183;Ne;0;4;0;4
19388;"Pilaitukas (I. Kanto al. 7A)";PAUKŠTELIAI;2929868229;Ne;0;5;0;5
19389;"Pilaitukas (I. Kanto al. 7A)";PAUKŠTELIAI;9924612250;Ne;0;4;5;9
19390;"Pilaitukas (I. Kanto al. 7A)";PAUKŠTELIAI;6117985788;Ne;0;4;0;4
19391;"Pilaitukas (I. Kanto al. 7A)";PAUKŠTELIAI;57931719105;Ne;0;12;0;12
19392;"Pilaitukas (I. Kanto al. 7A)";PAUKŠTELIAI;9618329726;Ne;5;4;0;9
19393;"Pilaitukas (I. Kanto al. 7A)";PAUKŠTELIAI;1003278169;Ne;0;5;0;5
19394;"Pilaitukas (I. Kanto al. 7A)";PAUKŠTELIAI;9450834035;Ne;0;1;0;1
19395;"Pilaitukas (I. Kanto al. 7A)";PAUKŠTELIAI;5604992163;Ne;0;1;0;1
19396;"Pilaitukas (I. Kanto al. 7A)";PAUKŠTELIAI;1693309238;Ne;0;4;0;4
19397;"Pilaitukas (I. Kanto al. 7A)";BORUŽĖLĖS;5984878126;Ne;0;3;0;3
19398;"Pilaitukas (I. Kanto al. 7A)";BORUŽĖLĖS;9898379569;Ne;0;0;2;2
19399;"Pilaitukas (I. Kanto al. 7A)";BORUŽĖLĖS;5324806808;Ne;0;0;2;2
19400;"Pilaitukas (I. Kanto al. 7A)";BORUŽĖLĖS;5185051301;Ne;0;3;0;3
19401;"Pilaitukas (I. Kanto al. 7A)";BORUŽĖLĖS;5326258755;Ne;0;6;0;6
19402;"Pilaitukas (I. Kanto al. 7A)";BORUŽĖLĖS;1731106179;Ne;5;3;0;8
19403;"Pilaitukas (I. Kanto al. 7A)";BORUŽĖLĖS;3784944532;Ne;11;6;0;17
19404;"Pilaitukas (I. Kanto al. 7A)";BORUŽĖLĖS;4317406707;Ne;12;0;0;12
19405;"Pilaitukas (I. Kanto al. 7A)";BORUŽĖLĖS;8380819975;Ne;0;2;0;2
19406;"Pilaitukas (I. Kanto al. 7A)";BORUŽĖLĖS;4589130143;Ne;5;0;0;5
19407;"Pilaitukas (I. Kanto al. 7A)";BORUŽĖLĖS;1944443723;Ne;0;0;3;3
19408;"Pilaitukas (I. Kanto al. 7A)";DRUGELIAI;1677962644;Ne;4;5;0;9
19409;"Pilaitukas (I. Kanto al. 7A)";DRUGELIAI;4745358362;Ne;4;5;0;9
19410;"Pilaitukas (I. Kanto al. 7A)";DRUGELIAI;2917197418;Ne;9;0;1;10
19411;"Pilaitukas (I. Kanto al. 7A)";DRUGELIAI;6712878938;Ne;4;0;0;4
19412;"Pilaitukas (I. Kanto al. 7A)";DRUGELIAI;3298272815;Ne;7;0;2;9
19413;"Pilaitukas (I. Kanto al. 7A)";DRUGELIAI;4719223490;Ne;0;0;3;3
19414;"Pilaitukas (I. Kanto al. 7A)";DRUGELIAI;6280870972;Ne;19;0;1;20
19415;"Pilaitukas (I. Kanto al. 7A)";DRUGELIAI;9741985709;Ne;6;0;0;6
19416;"Pilaitukas (I. Kanto al. 7A)";DRUGELIAI;7807341574;Ne;12;4;0;16
19417;"Pilaitukas (I. Kanto al. 7A)";DRUGELIAI;5215800828;Ne;5;1;0;6
19418;"Pilaitukas (I. Kanto al. 7A)";DRUGELIAI;2414941263;Ne;2;0;2;4
19419;"Pilaitukas (I. Kanto al. 7A)";DRUGELIAI;2210253038;Ne;21;0;0;21
19420;"Pilaitukas (I. Kanto al. 7A)";DRUGELIAI;7222856683;Ne;8;0;0;8
19421;"Pilaitukas (I. Kanto al. 7A)";DRUGELIAI;8710069256;Ne;8;0;1;9
19422;"Pilaitukas (I. Kanto al. 7A)";DRUGELIAI;7830059468;Ne;4;0;0;4
19423;"Pilaitukas (I. Kanto al. 7A)";DRUGELIAI;7479542200;Ne;4;1;1;6
19424;"Pilaitukas (I. Kanto al. 7A)";DRUGELIAI;5901884512;Ne;4;0;0;4
19425;"Pilaitukas (I. Kanto al. 7A)";DRUGELIAI;1747834520;Ne;12;4;0;16
19426;"Pilaitukas (I. Kanto al. 7A)";PELIUKAI;9246925227;Ne;6;0;2;8
19427;"Pilaitukas (I. Kanto al. 7A)";PELIUKAI;4810825253;Ne;0;6;0;6
19428;"Pilaitukas (I. Kanto al. 7A)";PELIUKAI;8769116377;Ne;4;0;0;4
19429;"Pilaitukas (I. Kanto al. 7A)";PELIUKAI;8501376663;Ne;0;1;0;1
19430;"Pilaitukas (I. Kanto al. 7A)";PELIUKAI;5421602723;Ne;0;6;0;6
19431;"Pilaitukas (I. Kanto al. 7A)";PELIUKAI;6754825353;Ne;0;5;0;5
19432;"Pilaitukas (I. Kanto al. 7A)";PELIUKAI;8168228529;Ne;3;4;0;7
19433;"Pilaitukas (I. Kanto al. 7A)";PELIUKAI;4014329370;Ne;5;0;1;6
19434;"Pilaitukas (I. Kanto al. 7A)";PELIUKAI;6833933586;Ne;0;1;0;1
19435;"Pilaitukas (I. Kanto al. 7A)";PELIUKAI;2416277190;Ne;11;0;0;11
19436;"Pilaitukas (I. Kanto al. 7A)";PELIUKAI;9774222130;Ne;0;1;0;1
19437;"Pilaitukas (I. Kanto al. 7A)";PELIUKAI;7604004800;Ne;0;1;0;1
19438;"Pilaitukas (I. Kanto al. 7A)";PELIUKAI;9556421129;Ne;9;0;0;9
19439;"Pilaitukas (I. Kanto al. 7A)";PELIUKAI;3954210452;Ne;0;1;0;1
19440;"Pilaitukas (I. Kanto al. 7A)";PELIUKAI;5223336496;Ne;6;0;2;8
19441;"Pilaitukas (I. Kanto al. 7A)";PELIUKAI;3651140874;Ne;0;4;0;4
19442;"Pilaitukas (I. Kanto al. 7A)";PELIUKAI;2823859128;Ne;0;4;0;4
19443;"Pilaitukas (I. Kanto al. 7A)";KAČIUKAI;1585341963;Ne;0;1;0;1
19444;"Pilaitukas (I. Kanto al. 7A)";KAČIUKAI;9038324313;Ne;0;6;0;6
19445;"Pilaitukas (I. Kanto al. 7A)";KAČIUKAI;7594484959;Ne;6;0;0;6
19446;"Pilaitukas (I. Kanto al. 7A)";KAČIUKAI;2463482642;Ne;6;0;0;6
19447;"Pilaitukas (I. Kanto al. 7A)";KAČIUKAI;3080014745;Ne;15;3;0;18
19448;"Pilaitukas (I. Kanto al. 7A)";KAČIUKAI;5353687011;Ne;14;2;0;16
19449;"Pilaitukas (I. Kanto al. 7A)";KAČIUKAI;6525191057;Ne;0;0;1;1
19450;"Pilaitukas (I. Kanto al. 7A)";KAČIUKAI;2105380328;Ne;0;0;1;1
19451;"Pilaitukas (I. Kanto al. 7A)";KAČIUKAI;5326689274;Ne;5;2;3;10
19452;"Pilaitukas (I. Kanto al. 7A)";KAČIUKAI;9653647227;Ne;5;4;3;12
19453;"Pilaitukas (I. Kanto al. 7A)";KAČIUKAI;4022543517;Ne;11;0;0;11
19454;"Pilaitukas (I. Kanto al. 7A)";KAČIUKAI;3825942473;Ne;0;18;0;18
19455;"Pilaitukas (I. Kanto al. 7A)";KAČIUKAI;1611371690;Ne;21;0;0;21
19456;"Pilaitukas (I. Kanto al. 7A)";KAČIUKAI;9247501721;Ne;0;6;1;7
19457;"Pilaitukas (I. Kanto al. 7A)";KAČIUKAI;6436694057;Ne;4;4;0;8
19458;"Pilaitukas (I. Kanto al. 7A)";KAČIUKAI;9974310580;Ne;10;0;0;10
19459;"Pilaitukas (I. Kanto al. 7A)";KAČIUKAI;6235375235;Ne;5;1;2;8
19460;"Pilaitukas (I. Kanto al. 7A)";KAČIUKAI;9914575692;Ne;0;4;0;4
19461;"Pilaitukas (I. Kanto al. 7A)";KAČIUKAI;4341157841;Ne;5;0;0;5
19462;"Pilaitukas (I. Kanto al. 7A)";SAULUTĖS;8047683859;Ne;14;0;0;14
19463;"Pilaitukas (I. Kanto al. 7A)";SAULUTĖS;8694369154;Ne;14;0;0;14
19464;"Pilaitukas (I. Kanto al. 7A)";SAULUTĖS;9405479859;Ne;0;4;0;4
19465;"Pilaitukas (I. Kanto al. 7A)";SAULUTĖS;1052452915;Ne;14;0;1;15
19466;"Pilaitukas (I. Kanto al. 7A)";SAULUTĖS;2336933998;Ne;16;0;3;19
19467;"Pilaitukas (I. Kanto al. 7A)";SAULUTĖS;1134083816;Ne;13;0;0;13
19468;"Pilaitukas (I. Kanto al. 7A)";SAULUTĖS;2110996493;Ne;1;0;5;6
19469;"Pilaitukas (I. Kanto al. 7A)";SAULUTĖS;1452645899;Ne;1;0;3;4
19470;"Pilaitukas (I. Kanto al. 7A)";SAULUTĖS;9587140991;Ne;0;10;0;10
19471;"Pilaitukas (I. Kanto al. 7A)";SAULUTĖS;8306015313;Ne;0;11;0;11
19472;"Pilaitukas (I. Kanto al. 7A)";SAULUTĖS;2215317686;Ne;1;0;1;2
19473;"Pilaitukas (I. Kanto al. 7A)";MENULIUKAI;6337917448;Ne;0;9;0;9
19474;"Pilaitukas (I. Kanto al. 7A)";MENULIUKAI;3636976107;Ne;0;9;0;9
19475;"Pilaitukas (I. Kanto al. 7A)";MENULIUKAI;5026344198;Ne;1;1;0;2
19476;"Pilaitukas (I. Kanto al. 7A)";MENULIUKAI;5564784922;Ne;0;6;0;6
19477;"Pilaitukas (I. Kanto al. 7A)";MENULIUKAI;1290017967;Ne;0;5;0;5
19478;"Pilaitukas (I. Kanto al. 7A)";MENULIUKAI;1841240800;Ne;2;0;0;2
19479;"Pilaitukas (I. Kanto al. 7A)";MENULIUKAI;4710865219;Ne;2;0;0;2
19480;"Pilaitukas (I. Kanto al. 7A)";MENULIUKAI;5691854235;Ne;7;0;1;8
19481;"Pilaitukas (I. Kanto al. 7A)";MENULIUKAI;6054821801;Ne;0;2;0;2
19482;"Pilaitukas (I. Kanto al. 7A)";MENULIUKAI;1620231835;Ne;6;0;0;6
19483;"Pilaitukas (I. Kanto al. 7A)";MENULIUKAI;8873155277;Ne;0;21;0;21
19484;"Pilaitukas (I. Kanto al. 7A)";MENULIUKAI;1532252453;Ne;21;0;0;21
19485;"Pilaitukas (I. Kanto al. 7A)";MENULIUKAI;8225571149;Ne;9;0;0;9
19486;"Pilaitukas (I. Kanto al. 7A)";MENULIUKAI;8207648026;Ne;3;0;0;3
19487;"Pilaitukas (I. Kanto al. 7A)";MENULIUKAI;3921932673;Ne;3;0;0;3
19488;"Pilaitukas (I. Kanto al. 7A)";MENULIUKAI;7855892595;Ne;9;0;0;9
19489;"Pilaitukas (I. Kanto al. 7A)";MENULIUKAI;8058057477;Ne;12;2;0;14
19490;"Pilaitukas (I. Kanto al. 7A)";MENULIUKAI;3952708917;Ne;6;4;1;11
19491;"Pilaitukas (I. Kanto al. 7A)";ĖŽIUKAI;1568651642;Ne;5;0;7;12
19492;"Pilaitukas (I. Kanto al. 7A)";ĖŽIUKAI;2892275540;Ne;5;2;0;7
19493;"Pilaitukas (I. Kanto al. 7A)";ĖŽIUKAI;1746050808;Ne;0;1;0;1
19494;"Pilaitukas (I. Kanto al. 7A)";ĖŽIUKAI;2633256935;Ne;0;5;0;5
19495;"Pilaitukas (I. Kanto al. 7A)";ĖŽIUKAI;8747053041;Ne;0;5;0;5
19496;"Pilaitukas (I. Kanto al. 7A)";ĖŽIUKAI;7555601497;Ne;6;0;0;6
19497;"Pilaitukas (I. Kanto al. 7A)";ĖŽIUKAI;6019760696;Ne;8;0;0;8
19498;"Pilaitukas (I. Kanto al. 7A)";ĖŽIUKAI;5979852431;Ne;21;0;0;21
19499;"Pilaitukas (I. Kanto al. 7A)";ĖŽIUKAI;9950619644;Ne;2;3;0;5
19500;"Pilaitukas (I. Kanto al. 7A)";ĖŽIUKAI;8682279246;Ne;0;21;0;21
19501;"Pilaitukas (I. Kanto al. 7A)";ĖŽIUKAI;6271751691;Ne;9;1;0;10
19502;"Pilaitukas (I. Kanto al. 7A)";ĖŽIUKAI;5155899628;Ne;2;0;1;3
19503;"Pilaitukas (I. Kanto al. 7A)";ĖŽIUKAI;5340877261;Ne;2;0;1;3
19504;"Pilaitukas (I. Kanto al. 7A)";ĖŽIUKAI;2342453729;Ne;3;0;0;3
19505;"Pilaitukas (I. Kanto al. 7A)";ĖŽIUKAI;6064545501;Ne;16;0;0;16
19506;"Pilaitukas (I. Kanto al. 7A)";ĖŽIUKAI;5904710385;Ne;3;1;0;4
19507;"Pilaitukas (I. Kanto al. 7A)";ĖŽIUKAI;1486895496;Ne;5;1;0;6
19508;"Pilaitukas (I. Kanto al. 7A)";ĖŽIUKAI;9441608677;Ne;8;0;0;8
19509;Vilija;BORUŽĖLĖS;6611278346;Ne;0;9;0;9
19510;Vilija;BORUŽĖLĖS;5979446899;Ne;6;0;0;6
19511;Vilija;BORUŽĖLĖS;3386809866;Ne;7;14;0;21
19512;Vilija;BORUŽĖLĖS;3301367418;Ne;8;4;0;12
19513;Vilija;BORUŽĖLĖS;6115055683;Ne;5;0;0;5
19514;Vilija;BORUŽĖLĖS;8995800590;Ne;2;0;0;2
19515;Vilija;BORUŽĖLĖS;4577389098;Ne;2;0;0;2
19516;Vilija;BORUŽĖLĖS;9806725516;Ne;0;4;0;4
19517;Vilija;BORUŽĖLĖS;6665382535;Ne;0;4;0;4
19518;Vilija;BORUŽĖLĖS;4791053946;Ne;0;4;0;4
19519;Vilija;BORUŽĖLĖS;4755512150;Ne;0;11;0;11
19520;Vilija;BORUŽĖLĖS;7464020972;Ne;0;4;0;4
19521;Vilija;NYKŠTUKAI;8248774222;Ne;0;4;0;4
19522;Vilija;NYKŠTUKAI;7009463901;Ne;0;5;0;5
19523;Vilija;NYKŠTUKAI;66817455759;Ne;0;3;0;3
19524;Vilija;NYKŠTUKAI;3201809038;Ne;0;4;0;4
19525;Vilija;NYKŠTUKAI;7469836390;Ne;9;2;0;11
19526;Vilija;NYKŠTUKAI;8364033602;Ne;0;4;0;4
19527;Vilija;NYKŠTUKAI;3544848804;Ne;0;4;0;4
19528;Vilija;NYKŠTUKAI;6136579994;Ne;8;0;0;8
19529;Vilija;NYKŠTUKAI;1116822936;Ne;10;1;0;11
19530;Vilija;NYKŠTUKAI;5563356449;Ne;0;2;0;2
19531;Vilija;NYKŠTUKAI;8756465854;Ne;11;0;0;11
19532;Vilija;NYKŠTUKAI;1717847351;Ne;0;4;0;4
19533;Vilija;NYKŠTUKAI;1751533938;Ne;0;4;0;4
19534;Vilija;NYKŠTUKAI;2532658333;Ne;0;4;0;4
19535;Vilija;ANČIUKAI;5776170550;Ne;0;4;0;4
19536;Vilija;ANČIUKAI;5643311237;Ne;5;4;0;9
19537;Vilija;ANČIUKAI;9176710135;Ne;9;0;0;9
19538;Vilija;ANČIUKAI;8073341597;Ne;8;5;0;13
19539;Vilija;ANČIUKAI;8493278100;Ne;0;15;0;15
19540;Vilija;ANČIUKAI;3857271014;Ne;10;0;0;10
19541;Vilija;ANČIUKAI;3552472323;Ne;9;0;0;9
19542;Vilija;ANČIUKAI;4780760918;Ne;15;4;0;19
19543;Vilija;ANČIUKAI;7012683174;Ne;5;0;0;5
19544;Vilija;ANČIUKAI;4412011292;Ne;9;0;0;9
19545;Vilija;ANČIUKAI;6385918522;Ne;0;6;0;6
19546;Vilija;ANČIUKAI;9531574134;Ne;0;4;0;4
19547;Vilija;ANČIUKAI;4400813531;Ne;0;4;0;4
19548;Vilija;ANČIUKAI;5454031929;Ne;0;2;0;2
19549;Vilija;ANČIUKAI;4858617162;Ne;2;6;0;8
19550;Vilija;ANČIUKAI;8318388772;Ne;0;8;0;8
19551;Vilija;ANČIUKAI;3677313088;Ne;0;7;0;7
19552;Vilija;ANČIUKAI;6815408748;Ne;0;2;0;2
19553;Vilija;ANČIUKAI;2371667380;Ne;0;4;0;4
19554;Vilija;DRUGELIAI;2205400512;Ne;10;4;0;14
19555;Vilija;DRUGELIAI;5530078264;Ne;3;4;0;7
19556;Vilija;DRUGELIAI;3131712783;Ne;0;8;0;8
19557;Vilija;DRUGELIAI;2807100092;Ne;0;5;0;5
19558;Vilija;DRUGELIAI;5340772605;Ne;10;4;0;14
19559;Vilija;DRUGELIAI;8429923120;Ne;0;4;0;4
19560;Vilija;DRUGELIAI;3667953591;Ne;3;0;0;3
19561;Vilija;DRUGELIAI;7836199284;Ne;0;4;0;4
19562;Vilija;DRUGELIAI;7482818685;Ne;4;0;0;4
19563;Vilija;DRUGELIAI;5455278072;Ne;0;2;0;2
19564;Vilija;DRUGELIAI;3349199472;Ne;0;7;0;7
19565;Vilija;DRUGELIAI;6057668143;Ne;0;4;0;4
19566;Vilija;DRUGELIAI;8420744276;Ne;10;5;0;15
19567;Vilija;SMERFAI;7927617851;Ne;0;4;0;4
19568;Vilija;SMERFAI;5508269515;Ne;0;5;0;5
19569;Vilija;SMERFAI;2164009051;Ne;5;0;0;5
19570;Vilija;SMERFAI;3021504467;Ne;7;0;0;7
19571;Vilija;SMERFAI;5617568215;Ne;0;4;0;4
19572;Vilija;SMERFAI;5056566642;Ne;10;0;0;10
19573;Vilija;SMERFAI;3058713381;Ne;2;0;0;2
19574;Vilija;SMERFAI;4297107641;Ne;12;0;0;12
19575;Vilija;SMERFAI;6165754839;Ne;3;4;0;7
19576;Vilija;SMERFAI;6477644899;Ne;0;4;0;4
19577;Vilija;SMERFAI;25857686522;Ne;0;4;0;4
19578;Vilija;SMERFAI;6937555692;Ne;13;4;0;17
19579;Vilija;SMERFAI;1580316618;Ne;2;4;0;6
19580;Vilija;SMERFAI;5976988338;Ne;9;0;0;9
19581;Vilija;SMERFAI;7606434084;Ne;0;4;0;4
19582;Vilija;SMERFAI;5825920843;Ne;6;4;0;10
19583;Vilija;SAULUTĖS;1442878380;Ne;0;4;0;4
19584;Vilija;SAULUTĖS;7052024709;Ne;0;4;0;4
19585;Vilija;SAULUTĖS;5075219269;Ne;0;4;0;4
19586;Vilija;SAULUTĖS;7749592467;Ne;3;4;0;7
19587;Vilija;SAULUTĖS;5653564054;Ne;8;2;0;10
19588;Vilija;SAULUTĖS;6706924324;Ne;0;4;0;4
19589;Vilija;SAULUTĖS;5561043797;Ne;4;4;0;8
19590;Vilija;SAULUTĖS;6825500779;Ne;0;4;0;4
19591;Vilija;SAULUTĖS;7673248841;Ne;0;7;0;7
19592;Vilija;SAULUTĖS;4481147539;Ne;12;4;0;16
19593;Vilija;SAULUTĖS;7915451529;Ne;0;4;0;4
19594;Vilija;SAULUTĖS;4253910558;Ne;5;4;0;9
19595;Vilija;SAULUTĖS;1290880830;Ne;0;4;0;4
19596;Vilija;SAULUTĖS;7880863171;Ne;0;4;0;4
19597;Vilija;SAULUTĖS;6792458439;Ne;0;4;0;4
19598;Vilija;SAULUTĖS;7603226092;Ne;4;4;0;8
19599;Vilija;SAULUTĖS;2551070326;Ne;5;4;0;9
19600;Vilija;SAULUTĖS;3363035704;Ne;0;4;0;4
19601;Vilija;ZUIKUČIAI;5128863532;Ne;4;0;0;4
19602;Vilija;ZUIKUČIAI;7194803557;Ne;0;4;0;4
19603;Vilija;ZUIKUČIAI;9726826566;Ne;0;4;0;4
19604;Vilija;ZUIKUČIAI;6857688873;Ne;0;3;0;3
19605;Vilija;ZUIKUČIAI;8586835095;Ne;11;0;0;11
19606;Vilija;ZUIKUČIAI;4985952177;Ne;5;0;0;5
19607;Vilija;ZUIKUČIAI;9414667437;Ne;0;5;0;5
19608;Vilija;ZUIKUČIAI;9264550987;Ne;10;0;0;10
19609;Vilija;ZUIKUČIAI;5381198018;Ne;0;5;0;5
19610;Vilija;ZUIKUČIAI;4355138593;Ne;0;5;0;5
19611;Vilija;ZUIKUČIAI;9370046849;Ne;0;1;0;1
19612;Vilija;ZUIKUČIAI;7109895494;Ne;0;4;0;4
19613;Vilija;ZUIKUČIAI;4444129040;Ne;4;0;0;4
19614;Vilija;ZUIKUČIAI;3168061557;Ne;0;4;0;4
19615;Vilija;ZUIKUČIAI;6469187290;Ne;0;4;0;4
19616;Vilija;ZUIKUČIAI;5492194393;Ne;0;8;0;8
19617;Vilija;ZUIKUČIAI;4818901769;Ne;13;0;0;13
19618;Vilija;ZUIKUČIAI;6759928420;Ne;5;4;0;9
19619;Vilija;ZUIKUČIAI;4839841253;Ne;0;3;0;3
19620;Vilija;BITUTĖS;4973314993;Ne;19;1;0;20
19621;Vilija;BITUTĖS;4897301808;Ne;2;4;0;6
19622;Vilija;BITUTĖS;9419794080;Ne;6;0;0;6
19623;Vilija;BITUTĖS;1019420340;Ne;1;0;0;1
19624;Vilija;BITUTĖS;5132828941;Ne;5;1;0;6
19625;Vilija;BITUTĖS;9218278301;Ne;0;5;0;5
19626;Vilija;BITUTĖS;9174484523;Ne;8;0;0;8
19627;Vilija;BITUTĖS;5102754179;Ne;7;2;0;9
19628;Vilija;BITUTĖS;4743123463;Ne;0;4;0;4
19629;Vilija;BITUTĖS;3371817727;Ne;5;0;0;5
19630;Vilija;BITUTĖS;8220360728;Ne;2;4;0;6
19631;Vilija;BITUTĖS;3432349973;Ne;0;4;0;4
19632;Vilija;BITUTĖS;8499318976;Ne;7;6;0;13
19633;Vilija;BITUTĖS;8426011190;Ne;7;4;0;11
19634;Vilija;BITUTĖS;8173954240;Ne;2;0;0;2
19635;Vilija;BITUTĖS;1804898751;Ne;6;0;0;6
19636;Vilija;BITUTĖS;9979578408;Ne;7;0;0;7
19637;Vilija;BITUTĖS;5651708105;Ne;0;4;0;4
19638;Vilija;BITUTĖS;9250902486;Ne;2;4;0;6
19639;Vilija;BITUTĖS;6655890861;Ne;0;7;0;7
19640;Vilija;BITUTĖS;4137025486;Ne;0;1;0;1
19641;Vilija;BITUTĖS;7004389875;Ne;0;1;0;1
19642;Vilija;"Pingviniukai (Laisvės pr. 57)";2731415182;Ne;10;0;0;10
19643;Vilija;"Pingviniukai (Laisvės pr. 57)";7015909066;Ne;0;1;0;1
19644;Vilija;"Pingviniukai (Laisvės pr. 57)";4639407305;Ne;4;0;0;4
19645;Vilija;"Pingviniukai (Laisvės pr. 57)";2859663283;Ne;7;0;0;7
19646;Vilija;"Pingviniukai (Laisvės pr. 57)";2903151334;Ne;0;4;0;4
19647;Vilija;"Pingviniukai (Laisvės pr. 57)";7815069972;Ne;0;4;0;4
19648;Vilija;"Pingviniukai (Laisvės pr. 57)";6625339545;Ne;12;0;0;12
19649;Vilija;"Pingviniukai (Laisvės pr. 57)";4179106082;Ne;10;0;0;10
19650;Vilija;"Pingviniukai (Laisvės pr. 57)";1845561597;Ne;0;4;0;4
19651;Vilija;"Pingviniukai (Laisvės pr. 57)";2872066559;Ne;6;0;0;6
19652;Vilija;"Pingviniukai (Laisvės pr. 57)";5840005178;Ne;13;0;0;13
19653;Vilija;"Pingviniukai (Laisvės pr. 57)";2012412360;Ne;5;0;0;5
19654;Vilija;"Pingviniukai (Laisvės pr. 57)";2506766222;Ne;2;6;0;8
19655;Vilija;"Pingviniukai (Laisvės pr. 57)";2076388581;Ne;21;0;0;21
19656;Vilija;"Meškiukai (Laisvės pr. 57)";1337656706;Ne;10;0;0;10
19657;Vilija;"Meškiukai (Laisvės pr. 57)";7518841522;Ne;12;0;0;12
19658;Vilija;"Meškiukai (Laisvės pr. 57)";3225442553;Ne;0;4;0;4
19659;Vilija;"Meškiukai (Laisvės pr. 57)";3700333490;Ne;16;0;0;16
19660;Vilija;"Meškiukai (Laisvės pr. 57)";2725051611;Ne;0;8;0;8
19661;Vilija;"Meškiukai (Laisvės pr. 57)";7889810385;Ne;2;0;0;2
19662;Vilija;"Meškiukai (Laisvės pr. 57)";2294228885;Ne;5;0;0;5
19663;Vilija;"Meškiukai (Laisvės pr. 57)";7735728034;Ne;2;2;0;4
19664;Vilija;"Meškiukai (Laisvės pr. 57)";4921409780;Ne;2;0;0;2
19665;Vilija;"Meškiukai (Laisvės pr. 57)";6557918266;Ne;4;0;0;4
19666;Vilija;"Meškiukai (Laisvės pr. 57)";5698897949;Ne;5;1;0;6
19667;Vilija;"Meškiukai (Laisvės pr. 57)";9163803569;Ne;7;0;0;7
19668;Vilija;"Meškiukai (Laisvės pr. 57)";2501118611;Ne;0;2;0;2
19669;Vilija;"Meškiukai (Laisvės pr. 57)";7001209450;Ne;0;5;0;5
19670;Vilija;"Ramunėlės (Laisvės pr. 57)";7707208780;Ne;0;6;0;6
19671;Vilija;"Ramunėlės (Laisvės pr. 57)";9261213181;Ne;0;1;0;1
19672;Vilija;"Ramunėlės (Laisvės pr. 57)";5034597412;Ne;0;7;0;7
19673;Vilija;"Ramunėlės (Laisvės pr. 57)";6142340523;Ne;2;4;0;6
19674;Vilija;"Ramunėlės (Laisvės pr. 57)";4798370162;Ne;7;5;0;12
19675;Vilija;"Ramunėlės (Laisvės pr. 57)";2036033312;Ne;1;0;0;1
19676;Vilija;"Ramunėlės (Laisvės pr. 57)";1902217772;Ne;5;0;0;5
19677;Vilija;"Ramunėlės (Laisvės pr. 57)";9377088075;Ne;8;0;0;8
19678;Vilija;"Ramunėlės (Laisvės pr. 57)";2455384784;Ne;0;1;0;1
19679;Vilija;"Varpeliai (Laisvės pr. 57)";6742119549;Ne;8;6;0;14
19680;Vilija;"Varpeliai (Laisvės pr. 57)";2948716989;Ne;0;6;0;6
19681;Vilija;"Varpeliai (Laisvės pr. 57)";6525761466;Ne;5;0;0;5
19682;Vilija;"Varpeliai (Laisvės pr. 57)";5277217733;Ne;4;0;0;4
19683;Vilija;"Varpeliai (Laisvės pr. 57)";1502013942;Ne;17;0;0;17
19684;Vilija;"Varpeliai (Laisvės pr. 57)";4969561425;Ne;9;0;0;9
19685;Vilija;"Varpeliai (Laisvės pr. 57)";3998988004;Ne;0;4;0;4
19686;Vilija;"Varpeliai (Laisvės pr. 57)";6756184787;Ne;0;4;0;4
19687;Vilija;"Varpeliai (Laisvės pr. 57)";5768470608;Ne;3;0;0;3
19688;Vilija;"Varpeliai (Laisvės pr. 57)";3589001032;Ne;14;2;0;16
19689;Vilija;"Varpeliai (Laisvės pr. 57)";5734602455;Ne;6;0;0;6
19690;Vilija;"Varpeliai (Laisvės pr. 57)";1440531672;Ne;0;6;0;6
19691;Vilija;"Varpeliai (Laisvės pr. 57)";4562536818;Ne;6;0;0;6
19692;Vilija;"Varpeliai (Laisvės pr. 57)";6226967695;Ne;0;1;0;1
19693;Vilija;"Varpeliai (Laisvės pr. 57)";3062594197;Ne;3;0;0;3
19694;Vilija;"Varpeliai (Laisvės pr. 57)";9226214856;Ne;2;0;0;2
19695;Vilija;"Voveraitės (Laisvės pr. 57)";9640071277;Ne;0;5;0;5
19696;Vilija;"Voveraitės (Laisvės pr. 57)";7522129675;Ne;17;2;0;19
19697;Vilija;"Voveraitės (Laisvės pr. 57)";8923074604;Ne;0;4;0;4
19698;Vilija;"Voveraitės (Laisvės pr. 57)";3948140208;Ne;10;0;0;10
19699;Vilija;"Voveraitės (Laisvės pr. 57)";9809985578;Ne;0;14;0;14
19700;Vilija;"Voveraitės (Laisvės pr. 57)";5229557734;Ne;5;0;0;5
19701;Vilija;"Voveraitės (Laisvės pr. 57)";8758253294;Ne;5;0;0;5
19702;Vilija;"Voveraitės (Laisvės pr. 57)";5694927471;Ne;0;4;0;4
19703;Vilija;"Voveraitės (Laisvės pr. 57)";6496861835;Ne;2;1;0;3
19704;Vilija;"Voveraitės (Laisvės pr. 57)";6782229835;Ne;0;11;0;11
19705;Vilija;"Voveraitės (Laisvės pr. 57)";2910501252;Ne;11;0;0;11
19706;Vilija;"Voveraitės (Laisvės pr. 57)";4873345183;Ne;10;0;0;10
19707;Vilija;"Voveraitės (Laisvės pr. 57)";3654655172;Ne;8;0;0;8
19708;Vilija;"Voveraitės (Laisvės pr. 57)";7184118489;Ne;0;4;0;4
19709;Vilija;"Voveraitės (Laisvės pr. 57)";3095065890;Ne;1;1;0;2
19710;Vilija;"Voveraitės (Laisvės pr. 57)";5450812526;Ne;0;2;0;2
19711;Vilija;"Voveraitės (Laisvės pr. 57)";7389324585;Ne;6;0;0;6
19712;Vilija;"Pelėdžiukai (Laisvės pr. 57)";2055282010;Ne;0;4;0;4
19713;Vilija;"Pelėdžiukai (Laisvės pr. 57)";8465864375;Ne;7;0;0;7
19714;Vilija;"Pelėdžiukai (Laisvės pr. 57)";7784329873;Ne;2;4;0;6
19715;Vilija;"Pelėdžiukai (Laisvės pr. 57)";4437786689;Ne;11;0;0;11
19716;Vilija;"Pelėdžiukai (Laisvės pr. 57)";7089883250;Ne;0;3;0;3
19717;Vilija;"Pelėdžiukai (Laisvės pr. 57)";3581180895;Ne;0;1;0;1
19718;Vilija;"Pelėdžiukai (Laisvės pr. 57)";1306244736;Ne;7;2;0;9
19719;Vilija;"Pelėdžiukai (Laisvės pr. 57)";8608907350;Ne;5;0;0;5
19720;Vilija;"Pelėdžiukai (Laisvės pr. 57)";9117896572;Ne;2;4;0;6
19721;Vilija;"Pelėdžiukai (Laisvės pr. 57)";5821077318;Ne;0;10;0;10
19722;Vilija;"Pelėdžiukai (Laisvės pr. 57)";9471287834;Ne;10;0;0;10
19723;Vilija;"Pelėdžiukai (Laisvės pr. 57)";8186421282;Ne;7;0;0;7
19724;Vilija;"Pelėdžiukai (Laisvės pr. 57)";8815055819;Ne;5;4;0;9
19725;Vilija;"Pelėdžiukai (Laisvės pr. 57)";9750688419;Ne;10;6;0;16
19726;Vilija;"Pelėdžiukai (Laisvės pr. 57)";1778722493;Ne;0;9;0;9
19727;Vilija;"Pelėdžiukai (Laisvės pr. 57)";6581404954;Ne;0;9;0;9
19728;Vilija;"Pelėdžiukai (Laisvės pr. 57)";7869675895;Ne;2;0;0;2
19729;Vilija;"Pelėdžiukai (Laisvės pr. 57)";7697727530;Ne;0;9;0;9
19730;Švelnukas;Pelėdžiukai;8016531082;Ne;0;12;6;18
19731;Švelnukas;Pelėdžiukai;8219071968;Ne;0;6;1;7
19732;Švelnukas;Pelėdžiukai;3235768013;Taip;2;3;0;5
19733;Švelnukas;Pelėdžiukai;9008722163;Ne;10;1;0;11
19734;Švelnukas;Pelėdžiukai;5699300764;Ne;6;0;0;6
19735;Švelnukas;Pelėdžiukai;1116279011;Ne;16;3;0;19
19736;Švelnukas;Pelėdžiukai;3892058023;Ne;16;3;0;19
19737;Švelnukas;Pelėdžiukai;5681611554;Ne;0;0;4;4
19738;Švelnukas;Pelėdžiukai;8589226595;Ne;8;0;2;10
19739;Švelnukas;Pelėdžiukai;9802064955;Ne;11;0;0;11
19740;Švelnukas;Pelėdžiukai;5041138716;Ne;5;0;0;5
19741;Švelnukas;Pelėdžiukai;3804532959;Ne;7;2;0;9
19742;Švelnukas;Pelėdžiukai;1462620951;Ne;0;3;0;3
19743;Švelnukas;Pelėdžiukai;8650902343;Ne;1;1;0;2
19744;Švelnukas;Pelėdžiukai;1409803554;Ne;5;4;0;9
19745;Švelnukas;Pelėdžiukai;1991507109;Ne;0;12;1;13
19746;Švelnukas;Pelėdžiukai;9808833734;Ne;0;0;2;2
19747;Švelnukas;Pelėdžiukai;6069027553;Ne;21;0;0;21
19748;Švelnukas;Pelėdžiukai;9814032171;Ne;11;0;1;12
19749;Švelnukas;Ežiukai;64192510147;Ne;0;2;0;2
19750;Švelnukas;Ežiukai;6282389058;Ne;0;1;1;2
19751;Švelnukas;Ežiukai;8399963483;Ne;5;0;1;6
19752;Švelnukas;Ežiukai;8681264696;Ne;0;5;0;5
19753;Švelnukas;Ežiukai;4373567509;Ne;0;0;1;1
19754;Švelnukas;Ežiukai;2521009631;Ne;0;0;4;4
19755;Švelnukas;Ežiukai;1165172787;Ne;9;1;0;10
19756;Švelnukas;Ežiukai;7308701231;Ne;0;4;0;4
19757;Švelnukas;Ežiukai;6209334207;Ne;13;0;0;13
19758;Švelnukas;Ežiukai;1201550386;Ne;5;0;0;5
19759;Švelnukas;Ežiukai;7266255326;Ne;0;0;11;11
19760;Švelnukas;Ežiukai;2348752207;Ne;0;21;0;21
19761;Švelnukas;Ežiukai;1143579276;Ne;3;0;1;4
19762;Švelnukas;Ežiukai;5409130195;Ne;9;0;0;9
19763;Švelnukas;Ežiukai;3645855145;Ne;0;0;1;1
19764;Švelnukas;Ežiukai;9402567487;Ne;4;0;5;9
19765;Švelnukas;Ežiukai;8569985034;Ne;0;4;1;5
19766;Švelnukas;Švelnukai;4681584014;Ne;4;0;3;7
19767;Švelnukas;Švelnukai;6607578153;Ne;5;0;1;6
19768;Švelnukas;Švelnukai;8847738918;Ne;3;0;1;4
19769;Švelnukas;Švelnukai;1982267458;Ne;0;4;0;4
19770;Švelnukas;Švelnukai;9766734938;Ne;8;2;0;10
19771;Švelnukas;Švelnukai;3020524039;Ne;14;0;0;14
19772;Švelnukas;Švelnukai;9829912750;Ne;11;0;0;11
19773;Švelnukas;Švelnukai;1411710913;Ne;4;4;0;8
19774;Švelnukas;Švelnukai;2464467471;Ne;7;0;0;7
19775;Švelnukas;Švelnukai;5032829856;Ne;0;2;1;3
19776;Švelnukas;Švelnukai;5213589179;Ne;5;2;0;7
19777;Švelnukas;Švelnukai;4544791546;Ne;0;1;0;1
19778;Švelnukas;Švelnukai;1963518457;Ne;0;4;2;6
19779;Švelnukas;Švelnukai;4194249709;Ne;0;2;7;9
19780;Švelnukas;Švelnukai;5936821902;Ne;0;0;9;9
19781;Švelnukas;Švelnukai;3228293160;Ne;0;1;0;1
19782;Švelnukas;Švelnukai;7607215137;Ne;5;0;0;5
19783;Švelnukas;Švelnukai;4629757899;Ne;0;9;0;9
19784;Švelnukas;Švelnukai;6964997767;Ne;10;4;0;14
19785;Švelnukas;Švelnukai;8951810066;Ne;16;0;0;16
19786;Švelnukas;Švelnukai;2663990082;Ne;2;0;4;6
19787;Švelnukas;Švelnukai;6204286255;Ne;0;1;5;6
19788;Švelnukas;Švelnukai;5960966542;Ne;7;1;0;8
19789;Švelnukas;Boružiukai;1951447127;Ne;0;5;1;6
19790;Švelnukas;Boružiukai;3849957906;Ne;0;0;6;6
19791;Švelnukas;Boružiukai;5550841477;Ne;12;0;0;12
19792;Švelnukas;Boružiukai;1264256177;Ne;0;4;0;4
19793;Švelnukas;Boružiukai;1332533332;Ne;0;0;2;2
19794;Švelnukas;Boružiukai;4134678301;Ne;0;0;1;1
19795;Švelnukas;Boružiukai;8458233793;Ne;0;0;2;2
19796;Švelnukas;Boružiukai;7967996032;Ne;0;2;0;2
19797;Švelnukas;Boružiukai;4990399144;Ne;0;6;0;6
19798;Švelnukas;Boružiukai;9575767514;Ne;0;0;16;16
19799;Švelnukas;Boružiukai;6282137936;Ne;0;2;0;2
19800;Švelnukas;Boružiukai;9479536507;Ne;2;0;0;2
19801;Švelnukas;Boružiukai;2077614498;Ne;12;1;0;13
19802;Švelnukas;Boružiukai;3145935641;Ne;0;6;0;6
19803;Švelnukas;Boružiukai;4404904322;Ne;0;0;8;8
19804;Švelnukas;Boružiukai;3561920685;Ne;2;0;0;2
19805;Švelnukas;Boružiukai;8895028305;Ne;16;0;1;17
19806;Švelnukas;Boružiukai;4961854528;Ne;0;0;2;2
19807;Švelnukas;Smalsučiai;9558811523;Ne;0;0;13;13
19808;Švelnukas;Smalsučiai;1661019352;Ne;0;2;0;2
19809;Švelnukas;Smalsučiai;5554625346;Ne;0;0;2;2
19810;Švelnukas;Smalsučiai;3282020958;Ne;0;0;2;2
19811;Švelnukas;Smalsučiai;2730288544;Ne;0;0;4;4
19812;Švelnukas;Smalsučiai;5805289419;Ne;0;0;5;5
19813;Švelnukas;Smalsučiai;1415899173;Ne;8;1;0;9
19814;Švelnukas;Smalsučiai;7987715134;Ne;0;0;1;1
19815;Švelnukas;Smalsučiai;3455801077;Ne;0;0;6;6
19816;Švelnukas;Smalsučiai;8193690277;Ne;5;1;3;9
19817;Švelnukas;Smalsučiai;9371102717;Ne;0;21;0;21
19818;Švelnukas;Smalsučiai;3472774028;Ne;10;0;3;13
19819;Švelnukas;Smalsučiai;5845744917;Ne;2;2;10;14
19820;Švelnukas;Smalsučiai;6764222588;Ne;5;0;9;14
19821;Švelnukas;Smalsučiai;1840752560;Ne;6;9;0;15
19822;Švelnukas;Smalsučiai;8268391509;Ne;8;0;0;8
19823;Švelnukas;Smalsučiai;4467095100;Ne;0;1;5;6
19824;Švelnukas;Nykštukai;5518267134;Ne;3;3;0;6
19825;Švelnukas;Nykštukai;1293700097;Ne;0;4;2;6
19826;Švelnukas;Nykštukai;8221642452;Ne;0;4;0;4
19827;Švelnukas;Nykštukai;2141519946;Ne;0;1;0;1
19828;Švelnukas;Nykštukai;8771953161;Ne;0;11;3;14
19829;Švelnukas;Nykštukai;5327209876;Ne;0;1;0;1
19830;Švelnukas;Nykštukai;2282356211;Ne;0;1;0;1
19831;Švelnukas;Nykštukai;4697253853;Ne;0;4;2;6
19832;Švelnukas;Nykštukai;7387060610;Ne;0;6;0;6
19833;Švelnukas;Nykštukai;1762528313;Ne;0;4;6;10
19834;Švelnukas;Nykštukai;3473146893;Ne;3;0;0;3
19835;Švelnukas;Nykštukai;3370028567;Ne;0;4;0;4
19836;Švelnukas;Nykštukai;62969317035;Ne;0;2;2;4
19837;Švelnukas;Nykštukai;6633233824;Ne;0;1;3;4
19838;Švelnukas;Nykštukai;2106591525;Ne;0;3;1;4
19839;Švelnukas;Nykštukai;93497358197;Ne;0;7;0;7
19840;Švelnukas;Nykštukai;2971380970;Ne;0;4;0;4
19841;Švelnukas;Nykštukai;3389897065;Ne;0;4;0;4
19842;Švelnukas;Nykštukai;4302735157;Ne;0;1;3;4
19843;Švelnukas;Nykštukai;2785396019;Ne;0;4;3;7
19844;Boružėlė;"Nykštukai gudručiai";3340082011;Ne;0;1;0;1
19845;Boružėlė;"Nykštukai gudručiai";7736917485;Ne;11;4;2;17
19846;Boružėlė;"Nykštukai gudručiai";9520696660;Ne;0;0;1;1
19847;Boružėlė;"Nykštukai gudručiai";5691884576;Ne;0;8;0;8
19848;Boružėlė;"Nykštukai gudručiai";9193273478;Ne;0;0;1;1
19849;Boružėlė;"Nykštukai gudručiai";3237771499;Ne;0;8;0;8
19850;Boružėlė;"Nykštukai gudručiai";8359957290;Ne;0;9;0;9
19851;Boružėlė;"Nykštukai gudručiai";8141240094;Ne;0;0;12;12
19852;Boružėlė;"Nykštukai gudručiai";2349571778;Ne;0;6;0;6
19853;Boružėlė;"Nykštukai gudručiai";1894170218;Ne;17;0;0;17
19854;Boružėlė;"Nykštukai gudručiai";3509512899;Ne;3;1;0;4
19855;Boružėlė;"Nykštukai gudručiai";8888151470;Ne;3;1;0;4
19856;Boružėlė;"Nykštukai gudručiai";3430953692;Ne;0;4;0;4
19857;Boružėlė;"Nykštukai gudručiai";3592853535;Ne;0;6;0;6
19858;Boružėlė;"Nykštukai gudručiai";6876323023;Ne;0;2;0;2
19859;Boružėlė;"Nykštukai gudručiai";2744894565;Ne;0;8;0;8
19860;Boružėlė;"Nykštukai gudručiai";6590829182;Ne;0;6;4;10
19861;Boružėlė;"Nykštukai gudručiai";3129825206;Ne;0;11;0;11
19862;Boružėlė;"Nykštukai gudručiai";9771767352;Ne;4;3;0;7
19863;Boružėlė;"Nykštukai gudručiai";2571360077;Ne;0;1;0;1
19864;Boružėlė;"Nykštukai gudručiai";9078805020;Ne;0;9;0;9
19865;Boružėlė;"Saulės zuikučiai";4554260776;Ne;12;4;0;16
19866;Boružėlė;"Saulės zuikučiai";5298170118;Ne;10;2;0;12
19867;Boružėlė;"Saulės zuikučiai";2133849514;Ne;0;4;0;4
19868;Boružėlė;"Saulės zuikučiai";1116012068;Ne;12;0;0;12
19869;Boružėlė;"Saulės zuikučiai";1292298259;Ne;13;0;0;13
19870;Boružėlė;"Saulės zuikučiai";3130977416;Ne;0;1;1;2
19871;Boružėlė;"Saulės zuikučiai";7256396576;Ne;0;2;0;2
19872;Boružėlė;"Saulės zuikučiai";4323998138;Ne;0;0;1;1
19873;Boružėlė;"Saulės zuikučiai";2087238951;Ne;0;1;0;1
19874;Boružėlė;"Saulės zuikučiai";3952645542;Ne;9;4;0;13
19875;Boružėlė;"Saulės zuikučiai";5516103398;Ne;0;0;4;4
19876;Boružėlė;"Saulės zuikučiai";8259586236;Ne;10;0;0;10
19877;Boružėlė;"Saulės zuikučiai";3955841578;Ne;2;0;0;2
19878;Boružėlė;"Saulės zuikučiai";1583223569;Ne;2;0;0;2
19879;Boružėlė;"Saulės zuikučiai";4433248526;Ne;5;0;0;5
19880;Boružėlė;"Saulės zuikučiai";1547802140;Ne;11;0;0;11
19881;Boružėlė;"Saulės zuikučiai";4020348640;Ne;6;0;1;7
19882;Boružėlė;"Saulės zuikučiai";2842256033;Ne;0;2;3;5
19883;Boružėlė;"Saulės zuikučiai";2561969142;Ne;16;0;0;16
19884;Boružėlė;"Saulės zuikučiai";7262515868;Ne;8;2;0;10
19885;Boružėlė;"Saulės zuikučiai";6527254253;Ne;0;8;2;10
19886;Boružėlė;"Saulės zuikučiai";7942043844;Ne;0;5;0;5
19887;Boružėlė;Gėlytės;1146297996;Ne;0;3;0;3
19888;Boružėlė;Gėlytės;3288141024;Ne;6;9;0;15
19889;Boružėlė;Gėlytės;1166207929;Ne;0;2;2;4
19890;Boružėlė;Gėlytės;7956982615;Ne;0;6;1;7
19891;Boružėlė;Gėlytės;4637656311;Ne;6;0;5;11
19892;Boružėlė;Gėlytės;3226733236;Ne;0;3;0;3
19893;Boružėlė;Gėlytės;6070356395;Ne;5;6;0;11
19894;Boružėlė;Gėlytės;4180537253;Ne;11;2;0;13
19895;Boružėlė;Gėlytės;6722353853;Ne;10;2;2;14
19896;Boružėlė;Gėlytės;8376436755;Ne;0;6;1;7
19897;Boružėlė;Gėlytės;3300678477;Ne;0;2;0;2
19898;Boružėlė;Gėlytės;7763958937;Ne;0;10;3;13
19899;Boružėlė;Gėlytės;9855354210;Ne;5;0;1;6
19900;Boružėlė;Gėlytės;3354291446;Ne;0;0;1;1
19901;Boružėlė;Gėlytės;8520403894;Ne;10;4;0;14
19902;Boružėlė;Gėlytės;4268486154;Ne;1;0;4;5
19903;Boružėlė;Gėlytės;7614216150;Ne;0;2;0;2
19904;Boružėlė;Gėlytės;4448964310;Ne;0;0;4;4
19905;Boružėlė;Gėlytės;8205706322;Ne;10;2;2;14
19906;Boružėlė;Gėlytės;8834231529;Ne;15;2;1;18
19907;Boružėlė;Gėlytės;8929444125;Ne;8;0;0;8
19908;Boružėlė;Gėlytės;3604658753;Ne;8;0;1;9
19909;Boružėlė;Smalsutis;5129244830;Ne;0;1;0;1
19910;Boružėlė;Smalsutis;6927100979;Ne;0;2;0;2
19911;Boružėlė;Smalsutis;4947670606;Ne;0;0;4;4
19912;Boružėlė;Smalsutis;5708558321;Ne;0;4;0;4
19913;Boružėlė;Smalsutis;6484173786;Ne;0;4;0;4
19914;Boružėlė;Smalsutis;2132904457;Ne;0;2;0;2
19915;Boružėlė;Smalsutis;39553430808;Ne;0;4;3;7
19916;Boružėlė;Smalsutis;4958704459;Ne;0;10;0;10
19917;Boružėlė;Smalsutis;5618586722;Ne;0;1;0;1
19918;Boružėlė;Smalsutis;8493908653;Ne;0;5;0;5
19919;Boružėlė;Smalsutis;4283064680;Ne;0;3;7;10
19920;Boružėlė;Smalsutis;2447148171;Ne;1;6;1;8
19921;Boružėlė;Smalsutis;7386694567;Ne;0;3;0;3
19922;Boružėlė;Smalsutis;9634967237;Ne;0;1;0;1
19923;Boružėlė;Smalsutis;3592594142;Ne;0;2;0;2
19924;Boružėlė;Drugeliai;8357946299;Ne;10;1;0;11
19925;Boružėlė;Drugeliai;1130980139;Ne;0;4;0;4
19926;Boružėlė;Drugeliai;6463583187;Ne;5;6;0;11
19927;Boružėlė;Drugeliai;3136028536;Ne;0;1;5;6
19928;Boružėlė;Drugeliai;2211576663;Ne;0;3;0;3
19929;Boružėlė;Drugeliai;1559001916;Ne;6;2;0;8
19930;Boružėlė;Drugeliai;4233602822;Ne;3;3;0;6
19931;Boružėlė;Drugeliai;9463322491;Ne;0;3;0;3
19932;Boružėlė;Drugeliai;3108758436;Ne;12;0;1;13
19933;Boružėlė;Drugeliai;8482813204;Ne;4;0;0;4
19934;Boružėlė;Drugeliai;6369070055;Ne;11;0;0;11
19935;Boružėlė;Drugeliai;6902130914;Ne;0;1;1;2
19936;Boružėlė;Drugeliai;3459207879;Ne;2;0;0;2
19937;Boružėlė;Drugeliai;6980022864;Ne;13;2;0;15
19938;Boružėlė;Drugeliai;7756929745;Ne;0;2;0;2
19939;Boružėlė;Drugeliai;5726187445;Ne;6;1;0;7
19940;Boružėlė;Drugeliai;2308405580;Ne;0;10;1;11
19941;Boružėlė;Drugeliai;3405184929;Ne;5;4;0;9
19942;Boružėlė;Drugeliai;8213060214;Ne;13;0;0;13
19943;Boružėlė;Drugeliai;3331238309;Ne;3;0;5;8
19944;Boružėlė;Drugeliai;2783338563;Ne;0;6;0;6
19945;Boružėlė;Vyturėliai;1913540317;Ne;2;6;0;8
19946;Boružėlė;Vyturėliai;1591582954;Ne;0;10;0;10
19947;Boružėlė;Vyturėliai;3322567969;Ne;2;4;0;6
19948;Boružėlė;Vyturėliai;8311383437;Ne;0;6;0;6
19949;Boružėlė;Vyturėliai;7534482245;Ne;0;6;1;7
19950;Boružėlė;Vyturėliai;3310676316;Ne;0;2;0;2
19951;Boružėlė;Vyturėliai;87834777247;Ne;0;1;0;1
19952;Boružėlė;Vyturėliai;50071056728;Ne;0;13;0;13
19953;Boružėlė;Vyturėliai;2098408445;Ne;0;6;0;6
19954;Boružėlė;Vyturėliai;8706461730;Ne;0;3;0;3
19955;Boružėlė;Vyturėliai;5337704114;Ne;0;4;0;4
19956;Boružėlė;Vyturėliai;8146684259;Ne;0;5;0;5
19957;Boružėlė;Vyturėliai;8225622711;Ne;0;4;0;4
19958;Boružėlė;Vyturėliai;9150703371;Ne;0;6;0;6
19959;Boružėlė;Vyturėliai;5811751925;Ne;0;6;0;6
19960;Boružėlė;Vyturėliai;6978158667;Ne;0;6;0;6
19961;Boružėlė;Vyturėliai;9640681773;Ne;0;0;21;21
19962;Boružėlė;Vyturėliai;5576016171;Ne;0;6;0;6
19963;Boružėlė;Žvaigždutės;4990831292;Ne;7;0;0;7
19964;Boružėlė;Žvaigždutės;9838823214;Ne;0;4;0;4
19965;Boružėlė;Žvaigždutės;7825636053;Ne;0;1;0;1
19966;Boružėlė;Žvaigždutės;6242220139;Ne;0;2;0;2
19967;Boružėlė;Žvaigždutės;3489498503;Ne;0;5;0;5
19968;Boružėlė;Žvaigždutės;5274016839;Ne;0;4;0;4
19969;Boružėlė;Žvaigždutės;3140264242;Ne;0;2;0;2
19970;Boružėlė;Žvaigždutės;5307997577;Ne;8;0;5;13
19971;Boružėlė;Žvaigždutės;7078709057;Ne;0;2;0;2
19972;Boružėlė;Žvaigždutės;6972646373;Ne;7;0;0;7
19973;Boružėlė;Žvaigždutės;8820827882;Ne;9;6;0;15
19974;Boružėlė;Žvaigždutės;2857645329;Ne;0;1;0;1
19975;Boružėlė;Žvaigždutės;5242187638;Ne;6;0;0;6
19976;Boružėlė;Žvaigždutės;1799882790;Ne;6;4;0;10
19977;Boružėlė;Žvaigždutės;5420788580;Ne;0;0;3;3
19978;Boružėlė;Žvaigždutės;6130634131;Ne;0;0;1;1
19979;Boružėlė;Ąžuoliukai;5774358876;Ne;0;6;0;6
19980;Boružėlė;Ąžuoliukai;4519645340;Ne;0;6;0;6
19981;Boružėlė;Ąžuoliukai;4994696176;Ne;0;1;0;1
19982;Boružėlė;Ąžuoliukai;5138737297;Ne;0;1;0;1
19983;Boružėlė;Ąžuoliukai;6439902117;Ne;0;5;0;5
19984;Boružėlė;Ąžuoliukai;3040376382;Ne;0;6;1;7
19985;Boružėlė;Ąžuoliukai;3840860155;Ne;0;0;1;1
19986;Boružėlė;Ąžuoliukai;7722277859;Ne;0;1;0;1
19987;Boružėlė;Ąžuoliukai;6954794465;Ne;0;5;4;9
19988;Boružėlė;Ąžuoliukai;5832223872;Ne;0;2;0;2
19989;Boružėlė;Ąžuoliukai;3695411422;Ne;0;1;0;1
19990;Boružėlė;Ąžuoliukai;2077228543;Ne;0;4;17;21
19991;Boružėlė;Ąžuoliukai;6022191251;Ne;0;2;0;2
19992;Boružėlė;Ąžuoliukai;3869817904;Ne;0;4;3;7
19993;Boružėlė;Ąžuoliukai;8029389952;Ne;0;2;0;2
19994;Boružėlė;Ąžuoliukai;8683282162;Ne;2;13;1;16
19995;Boružėlė;Ąžuoliukai;9999252614;Ne;0;4;2;6
19996;Boružėlė;Saulutės;9492548829;Ne;23;0;0;23
19997;Boružėlė;Saulutės;5437943626;Ne;4;2;2;8
19998;Boružėlė;Saulutės;3503931241;Ne;4;2;2;8
19999;Boružėlė;Saulutės;8882070834;Ne;15;0;0;15
20000;Boružėlė;Saulutės;2999335505;Ne;7;0;0;7
20001;Boružėlė;Saulutės;7882386455;Ne;0;2;2;4
20002;Boružėlė;Saulutės;6265279517;Ne;1;1;5;7
20003;Boružėlė;Saulutės;2879726579;Ne;0;0;1;1
20004;Boružėlė;Saulutės;8804878419;Ne;8;4;0;12
20005;Boružėlė;Saulutės;3871593172;Ne;8;4;0;12
20006;Boružėlė;Saulutės;3953507461;Ne;0;2;7;9
20007;Boružėlė;Saulutės;1492091211;Ne;5;2;0;7
20008;Boružėlė;Saulutės;1830043506;Ne;9;0;0;9
20009;Boružėlė;Saulutės;5680510186;Ne;5;2;0;7
20010;Boružėlė;Saulutės;1152697871;Ne;0;7;0;7
20011;Boružėlė;Saulutės;1779839709;Ne;0;10;0;10
20012;Boružėlė;Saulutės;7652740249;Ne;7;0;0;7
20013;Boružėlė;Saulutės;7260471712;Ne;0;4;4;8
20014;Boružėlė;Saulutės;5064892417;Ne;4;1;0;5
20015;Boružėlė;Saulutės;8577301586;Ne;0;4;1;5
20016;Boružėlė;Saulutės;8660954142;Ne;0;4;2;6
20017;Boružėlė;Ežiukai;9342498392;Ne;10;0;0;10
20018;Boružėlė;Ežiukai;8195442951;Ne;0;5;7;12
20019;Boružėlė;Ežiukai;6448688592;Ne;6;2;0;8
20020;Boružėlė;Ežiukai;2429696310;Ne;4;1;0;5
20021;Boružėlė;Ežiukai;9893643199;Ne;9;7;0;16
20022;Boružėlė;Ežiukai;3112016309;Ne;10;1;0;11
20023;Boružėlė;Ežiukai;5394149649;Ne;10;1;0;11
20024;Boružėlė;Ežiukai;9391811395;Ne;0;11;0;11
20025;Boružėlė;Ežiukai;8167376712;Ne;0;8;11;19
20026;Boružėlė;Ežiukai;1784594085;Ne;3;1;0;4
20027;Boružėlė;Ežiukai;9423458813;Ne;0;1;1;2
20028;Boružėlė;Ežiukai;5825164520;Ne;5;0;0;5
20029;Boružėlė;Ežiukai;7459531236;Ne;11;0;0;11
20030;Boružėlė;Ežiukai;8818358360;Ne;11;0;0;11
20031;Boružėlė;Ežiukai;1693082285;Ne;10;4;0;14
20032;Boružėlė;Ežiukai;2926620929;Ne;0;9;1;10
20033;Boružėlė;Ežiukai;6609156790;Ne;0;8;5;13
20034;Boružėlė;Ežiukai;5768415821;Ne;0;2;1;3
20035;Boružėlė;Ežiukai;8291389794;Ne;9;4;0;13
20036;Boružėlė;Ežiukai;2524469162;Ne;0;5;0;5
20037;Boružėlė;Ežiukai;5492228053;Ne;11;1;0;12
20038;Boružėlė;Ežiukai;6087811262;Ne;9;2;1;12
20039;Boružėlė;Boružiukai;7068409148;Ne;7;0;0;7
20040;Boružėlė;Boružiukai;8434178580;Ne;7;0;0;7
20041;Boružėlė;Boružiukai;8752343077;Ne;8;0;0;8
20042;Boružėlė;Boružiukai;8944790932;Ne;12;0;0;12
20043;Boružėlė;Boružiukai;4113917886;Ne;21;0;0;21
20044;Boružėlė;Boružiukai;1608652924;Ne;13;0;1;14
20045;Boružėlė;Boružiukai;7149439740;Ne;5;4;0;9
20046;Boružėlė;Boružiukai;3005601935;Ne;0;6;0;6
20047;Boružėlė;Boružiukai;4497753570;Ne;0;0;5;5
20048;Boružėlė;Boružiukai;1865891989;Ne;4;1;0;5
20049;Boružėlė;Boružiukai;2298750617;Ne;6;0;0;6
20050;Boružėlė;Boružiukai;8739264310;Ne;6;2;0;8
20051;Boružėlė;Boružiukai;3097874340;Ne;0;1;0;1
20052;Boružėlė;Boružiukai;1551933321;Ne;2;1;0;3
20053;Boružėlė;Boružiukai;3097217902;Ne;12;0;0;12
20054;Boružėlė;Boružiukai;4727351240;Ne;10;4;3;17
20055;Boružėlė;Nykštukai;3331139963;Ne;0;5;0;5
20056;Boružėlė;Nykštukai;1047419932;Ne;6;1;0;7
20057;Boružėlė;Nykštukai;2304719318;Ne;13;0;0;13
20058;Boružėlė;Nykštukai;2104101406;Ne;0;5;0;5
20059;Boružėlė;Nykštukai;8377410278;Ne;6;1;1;8
20060;Boružėlė;Nykštukai;4928818565;Ne;4;0;2;6
20061;Boružėlė;Nykštukai;5619719965;Ne;0;8;0;8
20062;Boružėlė;Nykštukai;1966066642;Ne;7;2;0;9
20063;Boružėlė;Nykštukai;6267999965;Ne;0;4;17;21
20064;Boružėlė;Nykštukai;8073918985;Ne;2;0;0;2
20065;Boružėlė;Nykštukai;3595998843;Ne;2;2;0;4
20066;Boružėlė;Nykštukai;4217116059;Ne;0;2;1;3
20067;Boružėlė;Nykštukai;8165748779;Ne;5;1;7;13
20068;Žaliakalnio;Drugeliai;6379145626;Ne;0;6;3;9
20069;Žaliakalnio;Drugeliai;7094914749;Ne;0;5;0;5
20070;Žaliakalnio;Drugeliai;7449949339;Ne;0;3;1;4
20071;Žaliakalnio;Drugeliai;1413563085;Ne;1;5;0;6
20072;Žaliakalnio;Drugeliai;2432935088;Ne;0;4;0;4
20073;Žaliakalnio;Drugeliai;1033910097;Ne;0;4;0;4
20074;Žaliakalnio;Drugeliai;9032003195;Ne;0;2;0;2
20075;Žaliakalnio;Drugeliai;7566429633;Ne;0;5;0;5
20076;Žaliakalnio;Drugeliai;3835667120;Ne;2;1;0;3
20077;Žaliakalnio;Drugeliai;6341640909;Ne;0;6;0;6
20078;Žaliakalnio;Drugeliai;4059753894;Ne;0;4;1;5
20079;Žaliakalnio;Drugeliai;2305496316;Ne;0;2;0;2
20080;Žaliakalnio;Drugeliai;9984857605;Ne;0;4;0;4
20081;Žaliakalnio;Drugeliai;5764128482;Ne;0;9;0;9
20082;Žaliakalnio;Drugeliai;4497938258;Ne;0;2;0;2
20083;Žaliakalnio;Drugeliai;1673321992;Ne;0;1;0;1
20084;Žaliakalnio;Boružėlių;5843020412;Ne;3;2;0;5
20085;Žaliakalnio;Boružėlių;9625531462;Ne;0;11;0;11
20086;Žaliakalnio;Boružėlių;6699373334;Ne;0;11;0;11
20087;Žaliakalnio;Boružėlių;7087535800;Ne;10;2;0;12
20088;Žaliakalnio;Boružėlių;1528111839;Ne;0;1;0;1
20089;Žaliakalnio;Boružėlių;7023886811;Ne;0;14;0;14
20090;Žaliakalnio;Boružėlių;2284465378;Ne;0;6;0;6
20091;Žaliakalnio;Boružėlių;7977009681;Ne;3;1;0;4
20092;Žaliakalnio;Boružėlių;2808776865;Ne;11;1;0;12
20093;Žaliakalnio;Boružėlių;2278681435;Ne;6;0;4;10
20094;Žaliakalnio;Boružėlių;9421259943;Ne;10;0;0;10
20095;Žaliakalnio;Boružėlių;3445649442;Ne;0;5;0;5
20096;Žaliakalnio;Boružėlių;3105500733;Ne;0;4;0;4
20097;Žaliakalnio;Boružėlių;1200844791;Ne;0;8;0;8
20098;Žaliakalnio;Boružėlių;8052539476;Ne;5;16;0;21
20099;Žaliakalnio;Boružėlių;6590016097;Ne;5;4;0;9
20100;Žaliakalnio;Boružėlių;8304431519;Ne;0;4;15;19
20101;Žaliakalnio;Boružėlių;5488964606;Ne;2;0;0;2
20102;Žaliakalnio;Boružėlių;8429135626;Ne;0;9;0;9
20103;Žaliakalnio;Boružėlių;8073554707;Ne;6;1;5;12
20104;Žaliakalnio;Boružėlių;8534973941;Ne;10;1;0;11
20105;Žaliakalnio;Boružėlių;2987217910;Ne;0;16;0;16
20106;Žaliakalnio;Zuikučiai;1592051491;Ne;0;4;0;4
20107;Žaliakalnio;Zuikučiai;6088333997;Ne;15;1;0;16
20108;Žaliakalnio;Zuikučiai;2673619031;Ne;0;4;0;4
20109;Žaliakalnio;Zuikučiai;5843314345;Ne;12;4;0;16
20110;Žaliakalnio;Zuikučiai;2180165053;Ne;0;3;0;3
20111;Žaliakalnio;Zuikučiai;6823528666;Ne;0;5;0;5
20112;Žaliakalnio;Zuikučiai;3509064089;Ne;0;8;0;8
20113;Žaliakalnio;Zuikučiai;7000429934;Ne;0;12;0;12
20114;Žaliakalnio;Zuikučiai;5730610895;Ne;17;0;0;17
20115;Žaliakalnio;Zuikučiai;6881070397;Ne;0;9;0;9
20116;Žaliakalnio;Zuikučiai;8209559343;Ne;1;4;0;5
20117;Žaliakalnio;Zuikučiai;9799056285;Ne;0;10;0;10
20118;Žaliakalnio;Zuikučiai;1321592040;Ne;0;5;0;5
20119;Žaliakalnio;Zuikučiai;8298313285;Ne;0;5;0;5
20120;Žaliakalnio;Zuikučiai;9331287916;Ne;0;6;0;6
20121;Žaliakalnio;Zuikučiai;6726832258;Ne;0;4;0;4
20122;Žaliakalnio;Zuikučiai;4607456527;Ne;10;4;0;14
20123;Žaliakalnio;Zuikučiai;9363615751;Ne;9;5;0;14
20124;Žaliakalnio;Zuikučiai;6727442688;Ne;9;0;0;9
20125;Žaliakalnio;Bitutė;5744370516;Ne;1;0;0;1
20126;Žaliakalnio;Bitutė;3619817569;Ne;0;0;1;1
20127;Žaliakalnio;Bitutė;3905448562;Ne;0;4;0;4
20128;Žaliakalnio;Bitutė;8481665290;Ne;5;5;0;10
20129;Žaliakalnio;Bitutė;8950583202;Ne;0;2;0;2
20130;Žaliakalnio;Bitutė;6324315523;Ne;0;5;0;5
20131;Žaliakalnio;Bitutė;6877235095;Ne;0;1;0;1
20132;Žaliakalnio;Bitutė;2280683252;Ne;0;2;0;2
20133;Žaliakalnio;Bitutė;7711347723;Ne;1;0;0;1
20134;Žaliakalnio;Bitutė;4561672875;Ne;0;4;0;4
20135;Žaliakalnio;Bitutė;7830692152;Ne;0;6;0;6
20136;Žaliakalnio;Bitutė;1423481154;Ne;0;8;0;8
20137;Žaliakalnio;Bitutė;4928400872;Ne;0;7;0;7
20138;Žaliakalnio;Bitutė;2613771302;Ne;2;4;0;6
20139;Žaliakalnio;Bitutė;3976548663;Ne;0;6;0;6
20140;Žaliakalnio;Bitutė;1343293430;Ne;0;3;0;3
20141;Žaliakalnio;Bitutė;3721878250;Ne;7;4;1;12
20142;Žaliakalnio;Bitutė;6291287113;Ne;0;4;0;4
20143;Žaliakalnio;Bitutė;4412760433;Ne;0;3;2;5
20144;Žaliakalnio;Bitutė;7989372873;Ne;1;6;0;7
20145;Žaliakalnio;Bitutė;1173977434;Ne;12;0;1;13
20146;Žaliakalnio;Nykštukų;9069518153;Ne;4;14;0;18
20147;Žaliakalnio;Nykštukų;8142435757;Ne;8;7;0;15
20148;Žaliakalnio;Nykštukų;3446593135;Ne;8;0;0;8
20149;Žaliakalnio;Nykštukų;1064854294;Ne;6;9;0;15
20150;Žaliakalnio;Nykštukų;4891656355;Ne;0;2;0;2
20151;Žaliakalnio;Nykštukų;1632465983;Ne;5;5;0;10
20152;Žaliakalnio;Nykštukų;9521104462;Ne;10;4;0;14
20153;Žaliakalnio;Nykštukų;5565027085;Ne;0;1;0;1
20154;Žaliakalnio;Nykštukų;2242604156;Ne;0;6;0;6
20155;Žaliakalnio;Nykštukų;8852165484;Ne;10;0;2;12
20156;Žaliakalnio;Nykštukų;9801618806;Ne;15;1;0;16
20157;Žaliakalnio;Nykštukų;2225778044;Ne;6;0;1;7
20158;Žaliakalnio;Nykštukų;4255734788;Ne;3;1;2;6
20159;Žaliakalnio;Nykštukų;7793937917;Ne;0;11;0;11
20160;Žaliakalnio;Nykštukų;8117013474;Ne;11;1;0;12
20161;Žaliakalnio;Nykštukų;7205368281;Ne;2;13;0;15
20162;Žaliakalnio;Nykštukų;7495990953;Ne;16;5;0;21
20163;Žaliakalnio;Nykštukų;4036239701;Ne;4;4;0;8
20164;Žaliakalnio;Nykštukų;5258266970;Ne;11;0;0;11
20165;Žaliakalnio;Nykštukų;6166482260;Ne;10;4;0;14
20166;Žaliakalnio;Nykštukų;3041002600;Ne;6;2;0;8
20167;Žaliakalnio;ŽIOGELIAI;2426844621;Ne;0;1;0;1
20168;Žaliakalnio;ŽIOGELIAI;5752912101;Ne;0;3;0;3
20169;Žaliakalnio;ŽIOGELIAI;9967098834;Ne;5;4;0;9
20170;Žaliakalnio;ŽIOGELIAI;3464935314;Ne;0;6;0;6
20171;Žaliakalnio;ŽIOGELIAI;7648422668;Ne;5;5;0;10
20172;Žaliakalnio;ŽIOGELIAI;4702470511;Ne;0;6;0;6
20173;Žaliakalnio;ŽIOGELIAI;8518422934;Ne;0;5;0;5
20174;Žaliakalnio;ŽIOGELIAI;6674631040;Ne;7;0;0;7
20175;Žaliakalnio;ŽIOGELIAI;8245784590;Ne;12;0;0;12
20176;Žaliakalnio;ŽIOGELIAI;9485995178;Ne;0;6;0;6
20177;Žaliakalnio;ŽIOGELIAI;8179329874;Ne;2;3;0;5
20178;Žaliakalnio;ŽIOGELIAI;8383425712;Ne;0;2;5;7
20179;Žaliakalnio;ŽIOGELIAI;1309236035;Ne;10;0;0;10
20180;Žaliakalnio;ŽIOGELIAI;7025195076;Ne;0;0;1;1
20181;Žaliakalnio;ŽIOGELIAI;2514763739;Ne;0;4;0;4
20182;Žaliakalnio;ŽIOGELIAI;8891815592;Ne;2;0;0;2
20183;Žaliakalnio;ŽIOGELIAI;6294045755;Ne;5;3;0;8
20184;Žaliakalnio;ŽIOGELIAI;8232697563;Ne;0;9;0;9
20185;Žaliakalnio;ŽIOGELIAI;2694424532;Ne;4;10;0;14
20186;Žaliakalnio;ŽIOGELIAI;6136717862;Ne;0;4;2;6
20187;Žaliakalnio;ŽIOGELIAI;8316505307;Ne;0;4;0;4
20188;Žaliakalnio;SAULUTĖS;5602734465;Ne;0;11;0;11
20189;Žaliakalnio;SAULUTĖS;1253655689;Ne;0;1;0;1
20190;Žaliakalnio;SAULUTĖS;3016537413;Ne;0;3;0;3
20191;Žaliakalnio;SAULUTĖS;4154737541;Ne;0;6;0;6
20192;Žaliakalnio;SAULUTĖS;7913029369;Ne;0;6;0;6
20193;Žaliakalnio;SAULUTĖS;3018398546;Ne;0;4;0;4
20194;Žaliakalnio;SAULUTĖS;8765159796;Ne;9;1;0;10
20195;Žaliakalnio;SAULUTĖS;3028921540;Ne;0;6;0;6
20196;Žaliakalnio;SAULUTĖS;7636933790;Ne;9;1;11;21
20197;Žaliakalnio;SAULUTĖS;4355433666;Ne;4;3;0;7
20198;Žaliakalnio;SAULUTĖS;1975313368;Ne;21;0;0;21
20199;Žaliakalnio;SAULUTĖS;9016032548;Ne;0;3;0;3
20200;Žaliakalnio;SAULUTĖS;1715385224;Ne;4;10;0;14
20201;Žaliakalnio;SAULUTĖS;3304186400;Ne;11;5;0;16
20202;Žaliakalnio;SAULUTĖS;3434815790;Ne;6;0;0;6
20203;Žaliakalnio;SAULUTĖS;3832291926;Ne;3;0;0;3
20204;Žaliakalnio;SAULUTĖS;7071209465;Ne;6;0;0;6
20205;Žaliakalnio;SAULUTĖS;7543073516;Ne;0;8;0;8
20206;Žaliakalnio;SAULUTĖS;9379373983;Ne;0;4;0;4
20207;Žaliakalnio;SAULUTĖS;2806386840;Ne;10;0;0;10
20208;Volungė;Bitutės;6661730121;Ne;9;0;0;9
20209;Volungė;Bitutės;5791161943;Ne;0;0;4;4
20210;Volungė;Bitutės;3307326410;Ne;0;0;4;4
20211;Volungė;Bitutės;5300334761;Ne;0;2;2;4
20212;Volungė;Bitutės;6755366051;Ne;12;0;0;12
20213;Volungė;Bitutės;4013639324;Ne;0;0;5;5
20214;Volungė;Bitutės;2599441104;Ne;0;0;1;1
20215;Volungė;Bitutės;5892600735;Ne;6;0;4;10
20216;Volungė;Bitutės;1902122510;Ne;0;0;14;14
20217;Volungė;Bitutės;1752817125;Ne;5;4;12;21
20218;Volungė;Bitutės;3515725398;Ne;2;4;0;6
20219;Volungė;Bitutės;3666364101;Ne;6;2;2;10
20220;Volungė;Bitutės;7151952679;Ne;0;4;6;10
20221;Volungė;Bitutės;5960027749;Ne;0;0;3;3
20222;Volungė;Bitutės;5149291935;Ne;0;0;5;5
20223;Volungė;Bitutės;3106135598;Ne;1;0;6;7
20224;Volungė;Bitutės;9842009354;Ne;5;0;4;9
20225;Volungė;Bitutės;4437625791;Ne;2;2;1;5
20226;Volungė;Bitutės;9933980783;Ne;0;21;0;21
20227;Volungė;Bitutės;4685227759;Ne;0;21;0;21
20228;Volungė;Boružiukai;6431477042;Ne;6;0;0;6
20229;Volungė;Boružiukai;1137713075;Ne;0;2;0;2
20230;Volungė;Boružiukai;2322594823;Ne;6;7;0;13
20231;Volungė;Boružiukai;7965601199;Ne;0;4;0;4
20232;Volungė;Boružiukai;3746978206;Ne;0;0;2;2
20233;Volungė;Boružiukai;1528289101;Ne;0;4;0;4
20234;Volungė;Boružiukai;9188994935;Ne;0;10;2;12
20235;Volungė;Boružiukai;8285309230;Ne;0;4;2;6
20236;Volungė;Boružiukai;7149986415;Ne;0;4;2;6
20237;Volungė;Boružiukai;4598763851;Ne;8;4;0;12
20238;Volungė;Boružiukai;7867741556;Ne;0;4;1;5
20239;Volungė;Boružiukai;8459167833;Ne;0;6;2;8
20240;Volungė;Boružiukai;6028582927;Ne;0;4;0;4
20241;Volungė;Boružiukai;3832613221;Ne;0;0;2;2
20242;Volungė;Boružiukai;1757041481;Ne;0;0;2;2
20243;Volungė;Boružiukai;7971287899;Ne;10;0;1;11
20244;Volungė;Boružiukai;2627555750;Ne;5;0;1;6
20245;Volungė;Boružiukai;1974650443;Ne;0;0;4;4
20246;Volungė;Boružiukai;9677732243;Ne;0;0;1;1
20247;Volungė;Boružiukai;2068447339;Ne;0;21;0;21
20248;Volungė;Boružiukai;3528581949;Ne;4;0;3;7
20249;Volungė;Žvirbliukai;2360026330;Ne;5;0;6;11
20250;Volungė;Žvirbliukai;8414351815;Ne;11;0;4;15
20251;Volungė;Žvirbliukai;2051410463;Ne;12;0;1;13
20252;Volungė;Žvirbliukai;5074093178;Ne;4;0;0;4
20253;Volungė;Žvirbliukai;5750385275;Ne;10;0;7;17
20254;Volungė;Žvirbliukai;8927595898;Ne;0;0;7;7
20255;Volungė;Žvirbliukai;9384821249;Ne;9;0;0;9
20256;Volungė;Žvirbliukai;5361410157;Ne;4;0;5;9
20257;Volungė;Žvirbliukai;4235842588;Ne;0;0;4;4
20258;Volungė;Žvirbliukai;3028611395;Ne;6;0;11;17
20259;Volungė;Žvirbliukai;2949033093;Ne;5;0;5;10
20260;Volungė;Žvirbliukai;2159667991;Ne;16;0;0;16
20261;Volungė;Žvirbliukai;5470252589;Ne;0;4;12;16
20262;Volungė;Žiogeliai;6360834021;Ne;4;0;1;5
20263;Volungė;Žiogeliai;4856240879;Ne;0;0;6;6
20264;Volungė;Žiogeliai;4694016281;Ne;0;0;3;3
20265;Volungė;Žiogeliai;9816038480;Ne;0;0;3;3
20266;Volungė;Žiogeliai;8640511964;Ne;0;0;6;6
20267;Volungė;Žiogeliai;5170536566;Ne;2;2;1;5
20268;Volungė;Žiogeliai;8421730419;Ne;5;0;6;11
20269;Volungė;Žiogeliai;6532202782;Ne;0;11;0;11
20270;Volungė;Žiogeliai;2712034356;Ne;0;4;2;6
20271;Volungė;Žiogeliai;2456643081;Ne;7;0;0;7
20272;Volungė;Žiogeliai;6920821813;Ne;6;0;0;6
20273;Volungė;Žiogeliai;8299305464;Ne;0;14;7;21
20274;Volungė;Žiogeliai;1781838937;Ne;0;8;0;8
20275;Volungė;Žiogeliai;1988082807;Ne;0;0;1;1
20276;Volungė;Žiogeliai;3091641738;Ne;0;3;0;3
20277;Volungė;Žiogeliai;8578521969;Ne;11;4;3;18
20278;Volungė;Žiogeliai;5710662590;Ne;0;4;0;4
20279;Volungė;Žiogeliai;4839484528;Ne;2;4;0;6
20280;Volungė;Žiogeliai;5174427959;Ne;9;0;2;11
20281;Volungė;Žiogeliai;4726043862;Ne;0;0;6;6
20282;Volungė;Pelėdžiukai;2890377876;Ne;0;0;10;10
20283;Volungė;Pelėdžiukai;1099216923;Ne;0;2;11;13
20284;Volungė;Pelėdžiukai;3430719834;Ne;0;4;1;5
20285;Volungė;Pelėdžiukai;2566901599;Ne;0;0;3;3
20286;Volungė;Pelėdžiukai;2420242319;Ne;0;4;8;12
20287;Volungė;Pelėdžiukai;7973680488;Ne;0;3;0;3
20288;Volungė;Pelėdžiukai;3356901662;Ne;13;0;1;14
20289;Volungė;Pelėdžiukai;1225378067;Ne;0;6;0;6
20290;Volungė;Pelėdžiukai;7281448136;Ne;0;1;1;2
20291;Volungė;Pelėdžiukai;9629567682;Ne;5;0;6;11
20292;Volungė;Pelėdžiukai;1120682487;Ne;0;4;2;6
20293;Volungė;Pelėdžiukai;9082860913;Ne;5;0;1;6
20294;Volungė;Pelėdžiukai;8174587725;Ne;10;0;0;10
20295;Volungė;Pelėdžiukai;17534618616;Ne;3;4;0;7
20296;Volungė;Pelėdžiukai;7521910384;Ne;0;2;0;2
20297;Volungė;Pelėdžiukai;6565522808;Ne;0;4;0;4
20298;Volungė;Pelėdžiukai;9068889427;Ne;8;1;0;9
20299;Volungė;Pelėdžiukai;4123080241;Ne;5;1;6;12
20300;Volungė;Pelėdžiukai;8268202101;Ne;0;4;8;12
20301;Volungė;Pelėdžiukai;1366066359;Ne;0;6;2;8
20302;Volungė;Drugeliai;6280208510;Ne;0;5;0;5
20303;Volungė;Drugeliai;4032261812;Ne;0;0;10;10
20304;Volungė;Drugeliai;6488473384;Ne;2;0;2;4
20305;Volungė;Drugeliai;8045459660;Ne;6;0;3;9
20306;Volungė;Drugeliai;1402200673;Ne;6;0;3;9
20307;Volungė;Drugeliai;7574856429;Ne;5;0;4;9
20308;Volungė;Drugeliai;5284011092;Ne;0;0;3;3
20309;Volungė;Drugeliai;9729285419;Ne;0;4;13;17
20310;Volungė;Drugeliai;2686827560;Ne;5;0;4;9
20311;Volungė;Drugeliai;9973604148;Ne;0;0;1;1
20312;Volungė;Drugeliai;8905401944;Ne;4;2;2;8
20313;Volungė;Drugeliai;2923810441;Ne;0;0;4;4
20314;Volungė;Drugeliai;6782622442;Ne;17;0;0;17
20315;Volungė;Drugeliai;3020629341;Ne;10;0;0;10
20316;Volungė;Drugeliai;4252713086;Ne;0;0;1;1
20317;Volungė;Drugeliai;5354511593;Ne;11;5;0;16
20318;Volungė;Drugeliai;3150532451;Ne;0;7;0;7
20319;Volungė;Drugeliai;9343118795;Ne;3;0;4;7
20320;Volungė;Drugeliai;4745609424;Ne;3;0;11;14
20321;Volungė;Drugeliai;7584598377;Ne;4;0;2;6
20322;Volungė;"SKRUZDĖLIUKAI ";3394646139;Ne;21;0;0;21
20323;Volungė;"SKRUZDĖLIUKAI ";6464890465;Ne;14;0;0;14
20324;Volungė;"SKRUZDĖLIUKAI ";2493541457;Ne;0;0;12;12
20325;Volungė;"SKRUZDĖLIUKAI ";1948015523;Ne;6;0;0;6
20326;Volungė;"SKRUZDĖLIUKAI ";1101228927;Ne;5;4;0;9
20327;Volungė;"SKRUZDĖLIUKAI ";5332306628;Ne;9;0;5;14
20328;Volungė;"SKRUZDĖLIUKAI ";9319825151;Ne;0;9;0;9
20329;Volungė;"SKRUZDĖLIUKAI ";6370584522;Ne;6;0;6;12
20330;Volungė;"SKRUZDĖLIUKAI ";8168630107;Ne;7;2;1;10
20331;Volungė;"SKRUZDĖLIUKAI ";8992514683;Ne;7;0;0;7
20332;Volungė;"SKRUZDĖLIUKAI ";5833091791;Ne;4;0;0;4
20333;Volungė;"SKRUZDĖLIUKAI ";5994884455;Ne;5;0;0;5
20334;Volungė;"SKRUZDĖLIUKAI ";3818924175;Ne;14;0;0;14
20335;Volungė;"SKRUZDĖLIUKAI ";8244731771;Ne;0;4;1;5
20336;Volungė;"SKRUZDĖLIUKAI ";6110117105;Ne;3;0;4;7
20337;Volungė;"SKRUZDĖLIUKAI ";4944556574;Ne;14;0;0;14
20338;Volungė;"SKRUZDĖLIUKAI ";2212423676;Ne;10;0;2;12
20339;Volungė;"SKRUZDĖLIUKAI ";5942497397;Ne;13;0;2;15
20340;Volungė;"SKRUZDĖLIUKAI ";8613580206;Ne;6;2;2;10
20341;Volungė;Zylutės;6127398531;Ne;4;0;0;4
20342;Volungė;Zylutės;4664635246;Taip;5;0;6;11
20343;Volungė;Zylutės;9382043452;Ne;0;0;1;1
20344;Volungė;Zylutės;1125730734;Ne;0;7;0;7
20345;Volungė;Zylutės;5650558154;Ne;10;0;0;10
20346;Volungė;Zylutės;1592634034;Ne;12;4;0;16
20347;Volungė;Zylutės;5588544003;Ne;1;1;2;4
20348;Volungė;Zylutės;3758750922;Ne;12;4;5;21
20349;Volungė;Zylutės;2663288986;Ne;2;0;0;2
20350;Volungė;Zylutės;3460701723;Ne;4;0;3;7
20351;Volungė;Zylutės;9562426487;Ne;0;0;8;8
20352;Volungė;Zylutės;4136178027;Ne;5;4;2;11
20353;Volungė;Zylutės;5882826586;Ne;0;18;3;21
20354;Volungė;Zylutės;6445614647;Ne;3;0;1;4
20355;Volungė;Zylutės;5561683986;Ne;0;0;5;5
20356;Volungė;Zylutės;5338942678;Ne;0;0;7;7
20357;Volungė;Zylutės;8987748481;Ne;5;0;2;7
20358;Volungė;"2 klasė";1605974968;Ne;0;2;0;2
20359;Giliukas;SMALSUČIAI;1710286878;Ne;5;0;4;9
20360;Giliukas;SMALSUČIAI;9134734376;Ne;0;0;2;2
20361;Giliukas;SMALSUČIAI;3728323646;Ne;12;0;0;12
20362;Giliukas;SMALSUČIAI;6742406486;Ne;9;0;0;9
20363;Giliukas;SMALSUČIAI;2840410579;Ne;14;2;0;16
20364;Giliukas;SMALSUČIAI;2378721717;Ne;2;0;1;3
20365;Giliukas;SMALSUČIAI;7316126011;Ne;7;1;1;9
20366;Giliukas;SMALSUČIAI;6489845832;Ne;21;0;0;21
20367;Giliukas;SMALSUČIAI;6203352124;Ne;11;0;0;11
20368;Giliukas;SMALSUČIAI;9704885611;Ne;0;0;1;1
20369;Giliukas;SMALSUČIAI;7993049824;Ne;4;3;2;9
20370;Giliukas;SMALSUČIAI;2700296404;Ne;0;0;3;3
20371;Giliukas;SMALSUČIAI;7412960823;Ne;3;0;0;3
20372;Giliukas;SMALSUČIAI;9160815037;Ne;15;1;0;16
20373;Giliukas;SMALSUČIAI;8701216181;Ne;8;0;0;8
20374;Giliukas;GUDRUČIAI;3847358328;Ne;10;2;0;12
20375;Giliukas;GUDRUČIAI;6165618131;Ne;5;7;0;12
20376;Giliukas;GUDRUČIAI;9608331265;Ne;0;4;0;4
20377;Giliukas;GUDRUČIAI;3691791222;Ne;12;0;0;12
20378;Giliukas;GUDRUČIAI;1870173947;Ne;0;6;0;6
20379;Giliukas;GUDRUČIAI;3983555939;Ne;10;4;0;14
20380;Giliukas;GUDRUČIAI;2951628295;Ne;0;3;0;3
20381;Giliukas;GUDRUČIAI;2003990493;Ne;0;10;0;10
20382;Giliukas;GUDRUČIAI;4960232685;Ne;6;0;0;6
20383;Giliukas;GUDRUČIAI;4916844983;Ne;8;4;0;12
20384;Giliukas;GUDRUČIAI;5787041097;Ne;12;4;0;16
20385;Giliukas;GUDRUČIAI;7159681896;Ne;14;0;1;15
20386;Giliukas;PABIRUČIAI;4183026763;Ne;0;0;5;5
20387;Giliukas;PABIRUČIAI;1221640023;Ne;7;4;0;11
20388;Giliukas;PABIRUČIAI;2362785562;Ne;7;10;0;17
20389;Giliukas;PABIRUČIAI;4247090684;Ne;3;0;0;3
20390;Giliukas;PABIRUČIAI;3054591644;Ne;5;0;0;5
20391;Giliukas;PABIRUČIAI;3870143024;Ne;14;0;4;18
20392;Giliukas;PABIRUČIAI;6914013230;Ne;14;0;1;15
20393;Giliukas;PABIRUČIAI;2512831288;Ne;21;0;0;21
20394;Giliukas;PABIRUČIAI;7013767174;Ne;1;9;0;10
20395;Giliukas;PABIRUČIAI;4105974682;Ne;9;6;0;15
20396;Giliukas;PABIRUČIAI;8874804636;Ne;0;1;0;1
20397;Giliukas;PABIRUČIAI;7012272912;Ne;0;0;1;1
20398;Giliukas;ŠVELNUKAI;9224387185;Ne;0;0;2;2
20399;Giliukas;ŠVELNUKAI;7402797271;Ne;23;0;0;23
20400;Giliukas;ŠVELNUKAI;3839624551;Taip;6;0;0;6
20401;Giliukas;ŠVELNUKAI;2012365132;Ne;2;0;7;9
20402;Giliukas;ŠVELNUKAI;4565216956;Ne;9;0;1;10
20403;Giliukas;ŠVELNUKAI;1075275967;Ne;5;0;2;7
20404;Giliukas;ŠVELNUKAI;5834233526;Ne;4;0;2;6
20405;Giliukas;ŠVELNUKAI;5000654626;Ne;2;0;0;2
20406;Giliukas;ŠVELNUKAI;8973584424;Ne;0;0;4;4
20407;Giliukas;ŠVELNUKAI;9679421414;Ne;2;0;8;10
20408;Giliukas;ŠVELNUKAI;2881704755;Ne;5;0;1;6
20409;Giliukas;ŠVELNUKAI;3238820351;Ne;11;0;7;18
20410;Giliukas;ŠVELNUKAI;4340602792;Ne;9;0;2;11
20411;Giliukas;ŠVELNUKAI;2229737837;Ne;2;0;7;9
20412;Giliukas;ŽINIUKAI;6422178450;Ne;9;0;0;9
20413;Giliukas;ŽINIUKAI;2502801547;Ne;10;2;0;12
20414;Giliukas;ŽINIUKAI;9617542456;Ne;0;6;0;6
20415;Giliukas;ŽINIUKAI;2562809633;Ne;0;4;0;4
20416;Giliukas;ŽINIUKAI;5326178821;Ne;9;4;0;13
20417;Giliukas;ŽINIUKAI;2692141913;Ne;16;0;1;17
20418;Giliukas;ŽINIUKAI;9152432124;Ne;10;0;0;10
20419;Giliukas;ŽINIUKAI;4854370266;Ne;0;1;0;1
20420;Giliukas;ŽINIUKAI;6703080106;Ne;8;1;0;9
20421;Giliukas;ŽINIUKAI;9274289812;Ne;5;0;0;5
20422;Giliukas;ŽINIUKAI;6956862865;Ne;0;2;1;3
20423;Giliukas;ŽINIUKAI;3150981084;Ne;2;8;0;10
20424;Giliukas;ŽINIUKAI;6134554678;Ne;15;6;0;21
20425;Giliukas;ŽINIUKAI;6338583515;Ne;0;4;0;4
20426;Giliukas;ŽINIUKAI;2064182165;Ne;0;0;1;1
20427;Giliukas;ŽINIUKAI;5201020765;Ne;15;4;0;19
20428;Giliukas;ŽINIUKAI;3137768675;Ne;5;5;0;10
20429;Giliukas;ŽINIUKAI;3718774263;Ne;5;16;0;21
20430;Giliukas;MYLIMUKAI;7205807049;Ne;19;1;0;20
20431;Giliukas;MYLIMUKAI;1165810193;Ne;10;1;8;19
20432;Giliukas;MYLIMUKAI;3055598917;Ne;0;2;1;3
20433;Giliukas;MYLIMUKAI;6953123617;Ne;0;2;0;2
20434;Giliukas;MYLIMUKAI;4207939009;Ne;0;0;2;2
20435;Giliukas;MYLIMUKAI;2742106493;Ne;5;6;0;11
20436;Giliukas;MYLIMUKAI;1916905497;Ne;3;0;2;5
20437;Giliukas;MYLIMUKAI;7053406257;Ne;16;0;0;16
20438;Giliukas;MYLIMUKAI;5222092567;Ne;0;4;0;4
20439;Giliukas;MYLIMUKAI;4581414740;Ne;13;7;5;25
20440;Giliukas;MYLIMUKAI;2226855971;Ne;21;11;0;32
20441;Giliukas;MYLIMUKAI;7431116067;Ne;5;0;4;9
20442;Giliukas;MYLIMUKAI;6748766233;Ne;0;4;0;4
20443;Giliukas;MYLIMUKAI;3726149759;Ne;0;8;0;8
20444;Giliukas;MYLIMUKAI;5300517567;Taip;0;2;0;2
20445;Giliukas;MYLIMUKAI;5625404051;Ne;3;5;2;10
20446;Giliukas;ČIAUŠKUČIAI;1762536884;Ne;0;9;6;15
20447;Giliukas;ČIAUŠKUČIAI;7646966187;Ne;0;6;0;6
20448;Giliukas;ČIAUŠKUČIAI;2801731379;Ne;10;0;0;10
20449;Giliukas;ČIAUŠKUČIAI;8499893356;Ne;7;3;0;10
20450;Giliukas;ČIAUŠKUČIAI;9205911152;Ne;10;0;0;10
20451;Giliukas;ČIAUŠKUČIAI;3720032249;Ne;0;0;1;1
20452;Giliukas;ČIAUŠKUČIAI;3659105022;Ne;0;2;0;2
20453;Giliukas;ČIAUŠKUČIAI;4940718205;Ne;0;2;0;2
20454;Giliukas;ČIAUŠKUČIAI;8491008130;Ne;0;2;0;2
20455;Giliukas;ČIAUŠKUČIAI;4163383707;Ne;7;1;0;8
20456;Giliukas;ČIAUŠKUČIAI;2612551188;Ne;10;0;1;11
20457;Giliukas;ČIAUŠKUČIAI;9366734581;Ne;2;0;0;2
20458;Giliukas;ČIAUŠKUČIAI;9462634699;Ne;9;0;0;9
20459;Giliukas;ČIAUŠKUČIAI;8106782330;Ne;13;0;0;13
20460;Giliukas;ČIAUŠKUČIAI;1332725572;Ne;8;1;0;9
20461;Giliukas;ČIAUŠKUČIAI;2787116787;Ne;3;0;0;3
20462;Giliukas;ŠNEKUČIAI;9229086918;Ne;10;2;0;12
20463;Giliukas;ŠNEKUČIAI;3274313536;Ne;0;1;0;1
20464;Giliukas;ŠNEKUČIAI;9287193955;Ne;17;4;0;21
20465;Giliukas;ŠNEKUČIAI;9499591494;Ne;0;0;2;2
20466;Giliukas;ŠNEKUČIAI;2099575372;Ne;0;0;1;1
20467;Giliukas;ŠNEKUČIAI;7195772641;Ne;11;0;0;11
20468;Giliukas;ŠNEKUČIAI;4258921446;Ne;5;1;0;6
20469;Giliukas;ŠNEKUČIAI;1439350058;Ne;0;0;4;4
20470;Giliukas;ŠNEKUČIAI;4843920452;Ne;5;0;0;5
20471;Giliukas;ŠNEKUČIAI;2004782696;Ne;0;1;3;4
20472;Giliukas;ŠNEKUČIAI;8147492951;Ne;0;0;2;2
20473;Giliukas;ŠNEKUČIAI;2349166172;Ne;8;0;2;10
20474;Giliukas;ŠNEKUČIAI;8241215831;Ne;9;2;1;12
20475;Giliukas;ŠNEKUČIAI;9475918013;Ne;0;0;3;3
20476;Giliukas;ŠNEKUČIAI;7944198886;Ne;4;0;1;5
20477;Giliukas;ŠNEKUČIAI;4347883309;Ne;0;4;0;4
20478;"Lazdynų mokykla (Žėručio g. 4)";RUPG;6038907328;Ne;0;4;0;4
20479;"Lazdynų mokykla (Žėručio g. 4)";RUPG;4086774324;Ne;0;21;0;21
20480;"Lazdynų mokykla (Žėručio g. 4)";RUPG;6070629454;Ne;0;21;0;21
20481;"Lazdynų mokykla (Žėručio g. 4)";RUPG;1118653070;Ne;8;4;2;14
20482;"Lazdynų mokykla (Žėručio g. 4)";RUPG;3367804873;Ne;0;4;0;4
20483;"Lazdynų mokykla (Žėručio g. 4)";RUPG;5806696915;Ne;0;4;3;7
20484;"Lazdynų mokykla (Žėručio g. 4)";RUPG;2209697834;Ne;0;21;0;21
20485;"Lazdynų mokykla (Žėručio g. 4)";RUPG;6638804854;Ne;0;21;0;21
20486;"Lazdynų mokykla (Žėručio g. 4)";RUPG;3634678954;Ne;4;4;0;8
20487;"Lazdynų mokykla (Žėručio g. 4)";RUPG;8318567916;Ne;0;4;1;5
20488;"Lazdynų mokykla (Žėručio g. 4)";RUPG;5982019255;Ne;0;4;0;4
20489;"Lazdynų mokykla (Žėručio g. 4)";RUPG;2160440145;Ne;0;4;0;4
20490;"Lazdynų mokykla (Žėručio g. 4)";RUPG;1025406111;Ne;0;6;0;6
20491;"Lazdynų mokykla (Žėručio g. 4)";RUPG;5095782784;Ne;4;4;8;16
20492;"Lazdynų mokykla (Žėručio g. 4)";LEPG;9656050113;Ne;0;4;0;4
20493;"Lazdynų mokykla (Žėručio g. 4)";LEPG;6822686126;Ne;0;4;1;5
20494;"Lazdynų mokykla (Žėručio g. 4)";LEPG;2070196225;Ne;4;4;0;8
20495;"Lazdynų mokykla (Žėručio g. 4)";LEPG;2613078582;Ne;6;4;0;10
20496;"Lazdynų mokykla (Žėručio g. 4)";LEPG;7059075747;Ne;0;4;2;6
20497;"Lazdynų mokykla (Žėručio g. 4)";LEPG;5438716880;Ne;2;4;2;8
20498;"Lazdynų mokykla (Žėručio g. 4)";LEPG;7487278074;Ne;6;4;0;10
20499;"Lazdynų mokykla (Žėručio g. 4)";LEPG;7320049068;Ne;8;4;0;12
20500;"Lazdynų mokykla (Žėručio g. 4)";LEPG;1396367371;Ne;3;4;0;7
20501;"Lazdynų mokykla (Žėručio g. 4)";LEPG;7324846434;Ne;6;4;0;10
20502;"Lazdynų mokykla (Žėručio g. 4)";LEPG;6794153377;Ne;13;4;0;17
20503;"Lazdynų mokykla (Žėručio g. 4)";LEPG;2825614921;Ne;17;4;0;21
20504;"Lazdynų mokykla (Žėručio g. 4)";LEPG;9592456683;Ne;5;4;0;9
20505;"Lazdynų mokykla (Žėručio g. 4)";LEPG;6117542654;Ne;14;4;0;18
20506;"Lazdynų mokykla (Žėručio g. 4)";LEPG;4149212470;Ne;0;4;2;6
20507;"Lazdynų mokykla (Žėručio g. 4)";LEPG;8324750958;Ne;6;4;2;12
20508;"Lazdynų mokykla (Žėručio g. 4)";LEPG;7659209862;Ne;9;4;0;13
20509;"Lazdynų mokykla (Žėručio g. 4)";LEPG;9654428418;Ne;0;4;0;4
20510;"Lazdynų mokykla (Žėručio g. 4)";RUPG;3631150576;Ne;0;4;0;4
20511;"Lazdynų mokykla (Žėručio g. 4)";RUPG;5015519090;Ne;3;4;2;9
20512;"Lazdynų mokykla (Žėručio g. 4)";RUPG;1745679183;Ne;0;4;0;4
20513;"Lazdynų mokykla (Žėručio g. 4)";RUPG;9255723192;Ne;0;4;0;4
20514;"Lazdynų mokykla (Žėručio g. 4)";RUPG;9639587601;Ne;0;4;0;4
20515;"Lazdynų mokykla (Žėručio g. 4)";RUPG;4087148273;Ne;9;4;2;15
20516;"Lazdynų mokykla (Žėručio g. 4)";RUPG;2740942924;Ne;8;4;0;12
20517;"Lazdynų mokykla (Žėručio g. 4)";RUPG;2700475528;Ne;10;4;0;14
20518;"Lazdynų mokykla (Žėručio g. 4)";RUPG;7180617984;Ne;0;4;0;4
20519;"Lazdynų mokykla (Žėručio g. 4)";RUPG;4023257875;Ne;8;4;0;12
20520;"Lazdynų mokykla (Žėručio g. 4)";RUPG;2308739823;Ne;9;4;0;13
20521;"Lazdynų mokykla (Žėručio g. 4)";RUPG;9123178095;Ne;0;11;0;11
20522;"Lazdynų mokykla (Žėručio g. 4)";RUPG;3000676765;Ne;5;4;0;9
20523;"Lazdynų mokykla (Žėručio g. 4)";RUPG;9968637187;Ne;10;4;0;14
20524;"Lazdynų mokykla (Žėručio g. 4)";RUPG;8886654664;Ne;14;4;0;18
20525;"Lazdynų mokykla (Žėručio g. 4)";RUPG;1910570858;Ne;14;4;0;18
20526;"„Atžalyno” mokykla-darželis";Giliukai;1209960122;Ne;0;0;2;2
20527;"„Atžalyno” mokykla-darželis";Giliukai;1579954367;Ne;0;4;1;5
20528;"„Atžalyno” mokykla-darželis";Giliukai;9655000018;Ne;0;4;1;5
20529;"„Atžalyno” mokykla-darželis";Giliukai;8826921260;Ne;1;4;1;6
20530;"„Atžalyno” mokykla-darželis";Giliukai;2773253032;Ne;3;4;3;10
20531;"„Atžalyno” mokykla-darželis";Giliukai;3170216428;Ne;0;4;2;6
20532;"„Atžalyno” mokykla-darželis";Giliukai;4345420422;Ne;7;0;0;7
20533;"„Atžalyno” mokykla-darželis";Giliukai;2772290605;Ne;10;1;1;12
20534;"„Atžalyno” mokykla-darželis";Giliukai;4422345256;Ne;0;4;0;4
20535;"„Atžalyno” mokykla-darželis";Giliukai;5596753512;Ne;1;1;0;2
20536;"„Atžalyno” mokykla-darželis";Giliukai;1958519966;Ne;0;0;7;7
20537;"„Atžalyno” mokykla-darželis";Giliukai;9806203065;Ne;0;4;2;6
20538;"„Atžalyno” mokykla-darželis";Giliukai;8688627865;Ne;1;4;0;5
20539;"„Atžalyno” mokykla-darželis";Giliukai;2601122166;Ne;15;0;0;15
20540;"„Atžalyno” mokykla-darželis";Giliukai;3529875728;Ne;0;1;1;2
20541;"„Atžalyno” mokykla-darželis";Giliukai;1311162040;Ne;0;4;0;4
20542;"„Atžalyno” mokykla-darželis";Giliukai;4427232735;Ne;0;4;7;11
20543;"„Atžalyno” mokykla-darželis";Giliukai;9013323901;Ne;5;4;1;10
20544;"„Atžalyno” mokykla-darželis";Giliukai;5503766544;Ne;0;4;0;4
20545;"„Atžalyno” mokykla-darželis";Giliukai;9215658103;Ne;0;1;0;1
20546;"„Atžalyno” mokykla-darželis";Giliukai;5030879885;Ne;5;4;3;12
20547;"„Atžalyno” mokykla-darželis";Giliukai;3484401937;Ne;0;1;6;7
20548;"„Atžalyno” mokykla-darželis";Riešutėliai;4360099345;Ne;10;5;0;15
20549;"„Atžalyno” mokykla-darželis";Riešutėliai;5947938371;Ne;5;0;13;18
20550;"„Atžalyno” mokykla-darželis";Riešutėliai;5384245347;Ne;0;7;0;7
20551;"„Atžalyno” mokykla-darželis";Riešutėliai;4246430352;Ne;14;2;2;18
20552;"„Atžalyno” mokykla-darželis";Riešutėliai;8574494664;Ne;0;9;0;9
20553;"„Atžalyno” mokykla-darželis";Riešutėliai;5815412814;Ne;6;0;0;6
20554;"„Atžalyno” mokykla-darželis";Riešutėliai;4161658496;Ne;0;0;8;8
20555;"„Atžalyno” mokykla-darželis";Riešutėliai;8942132574;Ne;0;6;0;6
20556;"„Atžalyno” mokykla-darželis";Riešutėliai;3564781987;Ne;0;1;1;2
20557;"„Atžalyno” mokykla-darželis";Riešutėliai;7109850241;Ne;0;12;0;12
20558;"„Atžalyno” mokykla-darželis";Riešutėliai;7368616441;Ne;0;0;11;11
20559;"„Atžalyno” mokykla-darželis";Riešutėliai;5242752663;Ne;0;5;0;5
20560;"„Atžalyno” mokykla-darželis";Riešutėliai;5709028342;Ne;8;2;0;10
20561;"„Atžalyno” mokykla-darželis";Riešutėliai;8803555426;Ne;4;1;0;5
20562;"„Atžalyno” mokykla-darželis";Riešutėliai;5994983369;Ne;5;5;0;10
20563;"„Atžalyno” mokykla-darželis";Riešutėliai;1041363325;Ne;0;1;15;16
20564;"„Atžalyno” mokykla-darželis";Riešutėliai;7676614240;Ne;0;0;6;6
20565;"„Atžalyno” mokykla-darželis";Riešutėliai;3751729666;Ne;0;0;5;5
20566;"„Atžalyno” mokykla-darželis";Riešutėliai;3441950153;Ne;0;0;7;7
20567;"„Atžalyno” mokykla-darželis";Riešutėliai;4223591454;Ne;0;0;1;1
20568;"„Atžalyno” mokykla-darželis";Žirniukai;6903825217;Ne;0;12;0;12
20569;"„Atžalyno” mokykla-darželis";Žirniukai;9101301819;Ne;0;0;3;3
20570;"„Atžalyno” mokykla-darželis";Žirniukai;6602037942;Ne;0;2;0;2
20571;"„Atžalyno” mokykla-darželis";Žirniukai;7579781779;Ne;1;3;0;4
20572;"„Atžalyno” mokykla-darželis";Žirniukai;1915676392;Ne;6;0;4;10
20573;"„Atžalyno” mokykla-darželis";Žirniukai;7669725276;Ne;0;15;0;15
20574;"„Atžalyno” mokykla-darželis";Žirniukai;5986664970;Ne;0;6;0;6
20575;"„Atžalyno” mokykla-darželis";Žirniukai;9913048992;Ne;0;10;0;10
20576;"„Atžalyno” mokykla-darželis";Žirniukai;4616870552;Ne;0;0;1;1
20577;"„Atžalyno” mokykla-darželis";Žirniukai;4107946143;Ne;0;0;1;1
20578;"„Atžalyno” mokykla-darželis";Žirniukai;7883570492;Ne;0;14;0;14
20579;"„Atžalyno” mokykla-darželis";Žirniukai;8320161812;Ne;9;5;0;14
20580;"„Atžalyno” mokykla-darželis";Žirniukai;5335059675;Ne;0;7;0;7
20581;"„Atžalyno” mokykla-darželis";Žirniukai;6922776405;Ne;0;1;15;16
20582;"„Atžalyno” mokykla-darželis";Žirniukai;9690554753;Ne;17;0;6;23
20583;"„Atžalyno” mokykla-darželis";Žirniukai;1961428224;Ne;11;0;4;15
20584;"„Atžalyno” mokykla-darželis";Žirniukai;8070499557;Ne;0;5;0;5
20585;"„Atžalyno” mokykla-darželis";Žirniukai;2446697763;Ne;0;1;0;1
20586;"„Atžalyno” mokykla-darželis";Žirniukai;2462839180;Ne;3;2;0;5
20587;"„Atžalyno” mokykla-darželis";Žirniukai;4784990018;Ne;0;4;0;4
20588;"„Atžalyno” mokykla-darželis";VYŠNIUKAI;6120955217;Ne;7;2;1;10
20589;"„Atžalyno” mokykla-darželis";VYŠNIUKAI;1787256844;Ne;24;0;0;24
20590;"„Atžalyno” mokykla-darželis";VYŠNIUKAI;2547003287;Ne;24;0;0;24
20591;"„Atžalyno” mokykla-darželis";VYŠNIUKAI;4503448206;Ne;9;0;0;9
20592;"„Atžalyno” mokykla-darželis";VYŠNIUKAI;3664056583;Ne;7;6;0;13
20593;"„Atžalyno” mokykla-darželis";VYŠNIUKAI;5456248305;Ne;17;0;0;17
20594;"„Atžalyno” mokykla-darželis";VYŠNIUKAI;3719072139;Ne;8;3;0;11
20595;"„Atžalyno” mokykla-darželis";VYŠNIUKAI;9245994735;Ne;21;4;0;25
20596;"„Atžalyno” mokykla-darželis";VYŠNIUKAI;3770167696;Ne;3;0;7;10
20597;"„Atžalyno” mokykla-darželis";VYŠNIUKAI;2000352986;Ne;5;6;0;11
20598;"„Atžalyno” mokykla-darželis";VYŠNIUKAI;2177213062;Ne;4;0;4;8
20599;"„Atžalyno” mokykla-darželis";VYŠNIUKAI;4635394632;Ne;9;0;0;9
20600;"„Atžalyno” mokykla-darželis";VYŠNIUKAI;3524131672;Ne;3;0;0;3
20601;"„Atžalyno” mokykla-darželis";VYŠNIUKAI;4840490901;Ne;29;0;0;29
20602;"„Atžalyno” mokykla-darželis";VYŠNIUKAI;4796052680;Ne;9;0;1;10
20603;"„Atžalyno” mokykla-darželis";VYŠNIUKAI;3181675972;Ne;15;0;4;19
20604;"„Atžalyno” mokykla-darželis";VYŠNIUKAI;8163063211;Ne;8;0;0;8
20605;"„Atžalyno” mokykla-darželis";VYŠNIUKAI;4431437971;Ne;7;4;0;11
20606;"„Atžalyno” mokykla-darželis";PIPIRIUKAI;8357021249;Ne;8;5;0;13
20607;"„Atžalyno” mokykla-darželis";PIPIRIUKAI;4582284727;Ne;9;0;0;9
20608;"„Atžalyno” mokykla-darželis";PIPIRIUKAI;4785607785;Ne;0;0;3;3
20609;"„Atžalyno” mokykla-darželis";PIPIRIUKAI;5615246040;Ne;0;1;4;5
20610;"„Atžalyno” mokykla-darželis";PIPIRIUKAI;1988657552;Ne;15;0;14;29
20611;"„Atžalyno” mokykla-darželis";PIPIRIUKAI;6721771665;Ne;8;4;0;12
20612;"„Atžalyno” mokykla-darželis";PIPIRIUKAI;7946139474;Ne;0;8;0;8
20613;"„Atžalyno” mokykla-darželis";PIPIRIUKAI;2921181385;Ne;12;0;0;12
20614;"„Atžalyno” mokykla-darželis";PIPIRIUKAI;2108706876;Ne;16;0;6;22
20615;"„Atžalyno” mokykla-darželis";PIPIRIUKAI;1228919159;Ne;12;10;0;22
20616;"„Atžalyno” mokykla-darželis";PIPIRIUKAI;3919301151;Ne;15;0;0;15
20617;"„Atžalyno” mokykla-darželis";PIPIRIUKAI;3624299098;Ne;0;9;0;9
20618;"„Atžalyno” mokykla-darželis";PIPIRIUKAI;2537063401;Ne;0;4;9;13
20619;"„Atžalyno” mokykla-darželis";PIPIRIUKAI;4166521512;Ne;8;2;2;12
20620;"„Atžalyno” mokykla-darželis";PIPIRIUKAI;8372179128;Ne;0;0;4;4
20621;"„Atžalyno” mokykla-darželis";PIPIRIUKAI;3204191459;Ne;0;11;0;11
20622;"„Atžalyno” mokykla-darželis";PIPIRIUKAI;5321475187;Ne;4;1;0;5
20623;"„Atžalyno” mokykla-darželis";PIPIRIUKAI;3015863723;Ne;10;3;0;13
20624;"„Atžalyno” mokykla-darželis";PIPIRIUKAI;3323233525;Ne;10;3;0;13
20625;"„Atžalyno” mokykla-darželis";PIPIRIUKAI;4596770586;Ne;0;5;0;5
20626;"„Atžalyno” mokykla-darželis";PIPIRIUKAI;7652421432;Ne;3;1;2;6
20627;"Vilniaus Naujininkų mokykla";"SAULĖS ZUIKUČIAI";1096474672;Ne;13;1;0;14
20628;"Vilniaus Naujininkų mokykla";"SAULĖS ZUIKUČIAI";9856315057;Ne;0;5;0;5
20629;"Vilniaus Naujininkų mokykla";"SAULĖS ZUIKUČIAI";1901250406;Ne;6;11;0;17
20630;"Vilniaus Naujininkų mokykla";"SAULĖS ZUIKUČIAI";9427388681;Ne;9;3;0;12
20631;"Vilniaus Naujininkų mokykla";"SAULĖS ZUIKUČIAI";5512321795;Ne;0;3;0;3
20632;"Vilniaus Naujininkų mokykla";"SAULĖS ZUIKUČIAI";9411054207;Ne;15;3;0;18
20633;"Vilniaus Naujininkų mokykla";"SAULĖS ZUIKUČIAI";3810550099;Ne;0;14;0;14
20634;"Vilniaus Naujininkų mokykla";"SAULĖS ZUIKUČIAI";8935072613;Ne;20;0;0;20
20635;"Vilniaus Naujininkų mokykla";"SAULĖS ZUIKUČIAI";9544088525;Ne;0;3;0;3
20636;"Vilniaus Naujininkų mokykla";"SAULĖS ZUIKUČIAI";9488762308;Ne;1;15;0;16
20637;"Vilniaus Naujininkų mokykla";"SAULĖS ZUIKUČIAI";5148002236;Ne;0;5;1;6
20638;"Vilniaus Naujininkų mokykla";"SAULĖS ZUIKUČIAI";8352550813;Ne;0;4;17;21
20639;"Vilniaus Naujininkų mokykla";SMALSUČIAI;2428447892;Ne;4;4;0;8
20640;"Vilniaus Naujininkų mokykla";SMALSUČIAI;1224054771;Ne;0;4;0;4
20641;"Vilniaus Naujininkų mokykla";SMALSUČIAI;1662993666;Ne;0;4;0;4
20642;"Vilniaus Naujininkų mokykla";SMALSUČIAI;7144596269;Ne;0;8;0;8
20643;"Vilniaus Naujininkų mokykla";SMALSUČIAI;6362889550;Ne;0;4;10;14
20644;"Vilniaus Naujininkų mokykla";SMALSUČIAI;1980755137;Ne;0;9;0;9
20645;"Vilniaus Naujininkų mokykla";SMALSUČIAI;1920917916;Ne;0;6;0;6
20646;"Vilniaus Naujininkų mokykla";SMALSUČIAI;8828658544;Ne;0;1;0;1
20647;"Vilniaus Naujininkų mokykla";SMALSUČIAI;5633127620;Ne;5;4;7;16
20648;"Vilniaus Naujininkų mokykla";SMALSUČIAI;3867799187;Ne;0;4;3;7
20649;"Vilniaus Naujininkų mokykla";SMALSUČIAI;1350744949;Ne;4;4;2;10
20650;"Vilniaus Naujininkų mokykla";SMALSUČIAI;63557632023;Ne;13;1;1;15
20651;"Vilniaus Naujininkų mokykla";SMALSUČIAI;8280826634;Ne;0;4;5;9
20652;"Vilniaus Naujininkų mokykla";SMALSUČIAI;5302103644;Ne;7;13;0;20
20653;"Vilniaus Naujininkų mokykla";SMALSUČIAI;5638817349;Ne;0;4;1;5
20654;"Vilniaus Naujininkų mokykla";SMALSUČIAI;1880254518;Ne;22;0;0;22
20655;"Vilniaus Naujininkų mokykla";SMALSUČIAI;2113295854;Ne;0;4;1;5
20656;"Vilniaus karaliaus Mindaugo mokykla";"PUG 2";8957131694;Ne;12;0;0;12
20657;"Vilniaus karaliaus Mindaugo mokykla";"PUG 2";1146561649;Ne;4;0;1;5
20658;"Vilniaus karaliaus Mindaugo mokykla";"PUG 2";1159232792;Ne;7;0;2;9
20659;"Vilniaus karaliaus Mindaugo mokykla";"PUG 2";1835450318;Ne;0;4;0;4
20660;"Vilniaus karaliaus Mindaugo mokykla";"PUG 2";6754580614;Ne;0;4;0;4
20661;"Vilniaus karaliaus Mindaugo mokykla";"PUG 2";2248658930;Ne;7;0;1;8
20662;"Vilniaus karaliaus Mindaugo mokykla";"PUG 2";47454787439;Ne;0;0;2;2
20663;"Vilniaus karaliaus Mindaugo mokykla";"PUG 2";2092637040;Ne;0;0;5;5
20664;"Vilniaus karaliaus Mindaugo mokykla";"PUG 2";5029631107;Ne;0;0;1;1
20665;"Vilniaus karaliaus Mindaugo mokykla";"PUG 2";6196554287;Ne;0;4;0;4
20666;"Vilniaus karaliaus Mindaugo mokykla";"PUG 2";4661051023;Ne;0;4;1;5
20667;"Vilniaus karaliaus Mindaugo mokykla";"PUG 2";1507200600;Ne;5;0;3;8
20668;"Vilniaus karaliaus Mindaugo mokykla";"PUG 2";7440474403;Ne;0;4;2;6
20669;"Vilniaus karaliaus Mindaugo mokykla";"PUG 2";8860314164;Ne;0;4;0;4
20670;"Vilniaus karaliaus Mindaugo mokykla";"PUG 2";2876837284;Ne;0;10;0;10
20671;"Vilniaus karaliaus Mindaugo mokykla";"PUG 1";8879549409;Ne;0;0;6;6
20672;"Vilniaus karaliaus Mindaugo mokykla";"PUG 1";3860781857;Ne;0;0;1;1
20673;"Vilniaus karaliaus Mindaugo mokykla";"PUG 1";1904462840;Ne;0;4;0;4
20674;"Vilniaus karaliaus Mindaugo mokykla";"PUG 1";24287759126;Ne;0;0;4;4
20675;"Vilniaus karaliaus Mindaugo mokykla";"PUG 1";1781442182;Ne;0;0;2;2
20676;"Vilniaus karaliaus Mindaugo mokykla";"PUG 1";6299298199;Ne;0;0;6;6
20677;"Vilniaus karaliaus Mindaugo mokykla";"PUG 1";35830862363;Ne;0;2;0;2
20678;"Vilniaus karaliaus Mindaugo mokykla";"PUG 1";1830572633;Ne;0;0;2;2
20679;"Vilniaus karaliaus Mindaugo mokykla";"PUG 1";4143153535;Ne;4;0;1;5
20680;"Vilniaus karaliaus Mindaugo mokykla";"PUG 1";1505918280;Ne;0;0;6;6
20681;"Vilniaus karaliaus Mindaugo mokykla";"PUG 1";1445657342;Ne;11;4;3;18
20682;"Vilniaus karaliaus Mindaugo mokykla";"PUG 1";9313380552;Ne;0;2;1;3
20683;"Vilniaus karaliaus Mindaugo mokykla";"PUG 1";7782678159;Ne;0;5;1;6
20684;"Vilniaus karaliaus Mindaugo mokykla";"PUG 1";14043704729;Ne;0;0;2;2
20685;"Vilniaus karaliaus Mindaugo mokykla";"PUG 1";7876029445;Ne;12;0;1;13
20686;"Vilniaus karaliaus Mindaugo mokykla";"PUG 1";4724383814;Ne;0;0;1;1
20687;"Vilniaus karaliaus Mindaugo mokykla";"PUG 1";1376514473;Ne;0;0;4;4
20688;"Vilniaus karaliaus Mindaugo mokykla";"PUG 1";7543795007;Ne;0;4;0;4
20689;"Vilniaus karaliaus Mindaugo mokykla";"PUG 1";9522269582;Ne;0;4;2;6
20690;"Vilniaus karaliaus Mindaugo mokykla";"PUG 3";23638266708;Ne;6;0;0;6
20691;"Vilniaus karaliaus Mindaugo mokykla";"PUG 3";1799477959;Ne;0;4;2;6
20692;"Vilniaus karaliaus Mindaugo mokykla";"PUG 3";3490705425;Ne;0;4;0;4
20693;"Vilniaus karaliaus Mindaugo mokykla";"PUG 3";7433354196;Ne;0;0;4;4
20694;"Vilniaus karaliaus Mindaugo mokykla";"PUG 3";2836206893;Ne;3;0;7;10
20695;"Vilniaus karaliaus Mindaugo mokykla";"PUG 3";38426234048;Ne;0;0;1;1
20696;"Vilniaus karaliaus Mindaugo mokykla";"PUG 3";1502213914;Ne;0;0;1;1
20697;"Vilniaus karaliaus Mindaugo mokykla";"PUG 3";1929838733;Ne;0;6;2;8
20698;"Vilniaus karaliaus Mindaugo mokykla";"PUG 3";3344717003;Ne;0;0;1;1
20699;"Vilniaus karaliaus Mindaugo mokykla";"PUG 3";9638976786;Ne;0;0;5;5
20700;"Vilniaus karaliaus Mindaugo mokykla";"PUG 3";4677405885;Ne;0;0;4;4
20701;"Vilniaus karaliaus Mindaugo mokykla";"PUG 3";6406285034;Ne;1;4;0;5
20702;"Vilniaus karaliaus Mindaugo mokykla";"PUG 3";7132574496;Ne;0;4;5;9
20703;"Vilniaus Levo Karsavino vidurinė mokykla";PELEDŽIUKAI;2149830021;Ne;5;4;3;12
20704;"Vilniaus Levo Karsavino vidurinė mokykla";PELEDŽIUKAI;2718046390;Ne;8;4;0;12
20705;"Vilniaus Levo Karsavino vidurinė mokykla";PELEDŽIUKAI;9094287056;Ne;0;4;2;6
20706;"Vilniaus Levo Karsavino vidurinė mokykla";PELEDŽIUKAI;8721423900;Ne;0;4;7;11
20707;"Vilniaus Levo Karsavino vidurinė mokykla";PELEDŽIUKAI;6917007871;Ne;0;4;8;12
20708;"Vilniaus Levo Karsavino vidurinė mokykla";PELEDŽIUKAI;3452236805;Ne;0;21;0;21
20709;"Vilniaus Levo Karsavino vidurinė mokykla";PELEDŽIUKAI;4066969586;Ne;0;4;9;13
20710;"Vilniaus Levo Karsavino vidurinė mokykla";PELEDŽIUKAI;8564433463;Ne;5;4;0;9
20711;"Vilniaus Levo Karsavino vidurinė mokykla";PELEDŽIUKAI;1067737206;Ne;0;17;0;17
20712;"Vilniaus Levo Karsavino vidurinė mokykla";PELEDŽIUKAI;1288690113;Ne;0;7;0;7
20713;"Vilniaus Levo Karsavino vidurinė mokykla";PELEDŽIUKAI;55396452032;Ne;7;4;1;12
20714;"Vilniaus Levo Karsavino vidurinė mokykla";PELEDŽIUKAI;2276463136;Ne;2;4;0;6
20715;"Vilniaus Levo Karsavino vidurinė mokykla";PELEDŽIUKAI;43259107285;Ne;5;4;0;9
20716;"Vilniaus Levo Karsavino vidurinė mokykla";PELEDŽIUKAI;9947263640;Ne;0;4;1;5
20717;"Vilniaus Levo Karsavino vidurinė mokykla";PELEDŽIUKAI;3641595127;Ne;2;4;0;6
20718;"Vilniaus Levo Karsavino vidurinė mokykla";PELEDŽIUKAI;3254847545;Ne;0;21;0;21
20719;"Vilniaus Levo Karsavino vidurinė mokykla";PELEDŽIUKAI;3381954095;Ne;4;4;2;10
20720;"Vilniaus Levo Karsavino vidurinė mokykla";PELEDŽIUKAI;7227603702;Ne;7;0;0;7
20721;"Vilniaus Levo Karsavino vidurinė mokykla";PELEDŽIUKAI;57138305703;Ne;0;4;4;8
20722;"Vilniaus Levo Karsavino vidurinė mokykla";PELEDŽIUKAI;5768653399;Ne;3;4;1;8
20723;"Vilniaus Levo Karsavino vidurinė mokykla";Žiniukai;3333990952;Ne;0;4;0;4
20724;"Vilniaus Levo Karsavino vidurinė mokykla";Žiniukai;5548875714;Ne;0;4;0;4
20725;"Vilniaus Levo Karsavino vidurinė mokykla";Žiniukai;5452659798;Ne;0;4;0;4
20726;"Vilniaus Levo Karsavino vidurinė mokykla";Žiniukai;5803032683;Ne;8;4;0;12
20727;"Vilniaus Levo Karsavino vidurinė mokykla";Žiniukai;2306517891;Ne;0;21;0;21
20728;"Vilniaus Levo Karsavino vidurinė mokykla";Žiniukai;1428614163;Ne;0;4;1;5
20729;"Vilniaus Levo Karsavino vidurinė mokykla";Žiniukai;9801214344;Ne;0;21;0;21
20730;"Vilniaus Levo Karsavino vidurinė mokykla";Žiniukai;8180889070;Ne;9;4;0;13
20731;"Vilniaus Levo Karsavino vidurinė mokykla";Žiniukai;7023565057;Ne;6;4;0;10
20732;"Vilniaus Levo Karsavino vidurinė mokykla";Žiniukai;2157398751;Ne;0;4;0;4
20733;"Vilniaus Levo Karsavino vidurinė mokykla";Žiniukai;7804533930;Ne;0;4;1;5
20734;"Vilniaus Levo Karsavino vidurinė mokykla";Žiniukai;3379725202;Ne;0;4;1;5
20735;"Vilniaus Levo Karsavino vidurinė mokykla";Žiniukai;7298260831;Ne;10;4;0;14
20736;"Vilniaus Levo Karsavino vidurinė mokykla";Žiniukai;4302751308;Ne;0;4;4;8
20737;"Vilniaus Levo Karsavino vidurinė mokykla";Žiniukai;7920182730;Ne;0;4;1;5
20738;"Vilniaus Levo Karsavino vidurinė mokykla";Žiniukai;12377363480;Ne;0;4;0;4
20739;"Vilniaus Levo Karsavino vidurinė mokykla";Žiniukai;8199573104;Ne;7;4;0;11
20740;"Vilniaus Levo Karsavino vidurinė mokykla";Žiniukai;9589810356;Ne;0;4;0;4
20741;"Vilniaus Levo Karsavino vidurinė mokykla";Žiniukai;64214150955;Ne;0;4;0;4
20742;"Vilniaus Levo Karsavino vidurinė mokykla";Žiniukai;6340289012;Ne;0;4;1;5
20743;"Vilniaus Levo Karsavino vidurinė mokykla";Žiniukai;3680925050;Ne;5;4;0;9
20744;"Vilniaus Liepkalnio Pagrindinė Mokykla";Bitutės;5597152556;Ne;0;4;1;5
20745;"Vilniaus Liepkalnio Pagrindinė Mokykla";Bitutės;4115995882;Ne;0;4;5;9
20746;"Vilniaus Liepkalnio Pagrindinė Mokykla";Bitutės;6136792125;Ne;7;4;1;12
20747;"Vilniaus Liepkalnio Pagrindinė Mokykla";Bitutės;9293634828;Ne;8;4;0;12
20748;"Vilniaus Liepkalnio Pagrindinė Mokykla";Bitutės;8324581018;Ne;0;4;9;13
20749;"Vilniaus Liepkalnio Pagrindinė Mokykla";Bitutės;1599633295;Ne;11;4;0;15
20750;"Vilniaus Liepkalnio Pagrindinė Mokykla";Bitutės;9589525954;Ne;0;4;2;6
20751;"Vilniaus Liepkalnio Pagrindinė Mokykla";Bitutės;7052487356;Ne;15;4;0;19
20752;"Vilniaus Liepkalnio Pagrindinė Mokykla";Bitutės;2080390421;Ne;0;4;6;10
20753;"Vilniaus Liepkalnio Pagrindinė Mokykla";Bitutės;5323726165;Ne;5;4;0;9
20754;"Vilniaus Liepkalnio Pagrindinė Mokykla";Bitutės;7922755136;Ne;10;4;1;15
20755;"Vilniaus Liepkalnio Pagrindinė Mokykla";Bitutės;1578956182;Ne;0;4;8;12
20756;"Vilniaus Liepkalnio Pagrindinė Mokykla";Bitutės;3721504364;Ne;12;4;0;16
20757;"Vilniaus Liepkalnio Pagrindinė Mokykla";Bitutės;1795366502;Ne;0;4;8;12
20758;"Vilniaus Liepkalnio Pagrindinė Mokykla";Bitutės;9211966929;Ne;0;4;6;10
20759;"Vilniaus Liepkalnio Pagrindinė Mokykla";Bitutės;4112888719;Ne;5;4;6;15
20760;"Vilniaus Liepkalnio Pagrindinė Mokykla";Bitutės;8809471063;Ne;2;4;0;6
20761;"Vilniaus Liepkalnio Pagrindinė Mokykla";Bitutės;5197037585;Ne;4;4;0;8
20762;"Vilniaus Liepkalnio Pagrindinė Mokykla";Bitutės;9771780358;Ne;0;4;8;12
20763;"Vilniaus Liepkalnio Pagrindinė Mokykla";Bitutės;4973569038;Ne;0;4;0;4
20764;"Vilniaus Pranciškaus Skorinos gimnazija";Saulytė;5194059497;Ne;6;4;4;14
20765;"Vilniaus Pranciškaus Skorinos gimnazija";Saulytė;5034268767;Ne;3;7;1;11
20766;"Vilniaus Pranciškaus Skorinos gimnazija";Saulytė;3036582121;Ne;0;4;0;4
20767;"Vilniaus Pranciškaus Skorinos gimnazija";Saulytė;5304082676;Ne;31;0;0;31
20768;"Vilniaus Pranciškaus Skorinos gimnazija";Saulytė;7055894770;Ne;0;6;0;6
20769;"Vilniaus Pranciškaus Skorinos gimnazija";Saulytė;6995285377;Ne;2;6;0;8
20770;"Vilniaus Pranciškaus Skorinos gimnazija";Saulytė;6336168033;Ne;0;4;0;4
20771;"Vilniaus Pranciškaus Skorinos gimnazija";Saulytė;3984446381;Ne;6;6;0;12
20772;"Vilniaus Pranciškaus Skorinos gimnazija";Saulytė;8641919789;Ne;0;8;3;11
20773;"Vilniaus Pranciškaus Skorinos gimnazija";Saulytė;4501408366;Ne;5;5;0;10
20774;"Vilniaus Pranciškaus Skorinos gimnazija";Saulytė;4705514590;Ne;0;4;0;4
20775;"Vilniaus Pranciškaus Skorinos gimnazija";Saulytė;4165354124;Ne;0;4;0;4
20776;"Vilniaus Pranciškaus Skorinos gimnazija";Saulytė;6940231858;Ne;10;8;0;18
20777;"Vilniaus Pranciškaus Skorinos gimnazija";Saulytė;8572069816;Ne;3;4;0;7
20778;"Vilniaus Pranciškaus Skorinos gimnazija";Saulytė;4810459063;Ne;3;4;0;7
20779;"Vilniaus Pranciškaus Skorinos gimnazija";Saulytė;3354419392;Ne;0;31;0;31
20780;"Vilniaus Pranciškaus Skorinos gimnazija";Saulytė;9176198859;Ne;1;4;1;6
20781;"Vilniaus Pranciškaus Skorinos gimnazija";Saulytė;3234612149;Ne;6;8;0;14
20782;"Vilniaus Simono Konarskio mokykla";"1 GR.";1464992631;Ne;0;4;0;4
20783;"Vilniaus Simono Konarskio mokykla";"1 GR.";7375004714;Ne;0;4;0;4
20784;"Vilniaus Simono Konarskio mokykla";"1 GR.";9822287576;Ne;0;4;0;4
20785;"Vilniaus Simono Konarskio mokykla";"1 GR.";7052198958;Ne;0;4;0;4
20786;"Vilniaus Simono Konarskio mokykla";"1 GR.";1498329448;Ne;0;4;0;4
20787;"Vilniaus Simono Konarskio mokykla";"1 GR.";3593323270;Ne;0;4;0;4
20788;"Vilniaus Simono Konarskio mokykla";"1 GR.";4463822099;Ne;0;4;0;4
20789;"Vilniaus Simono Konarskio mokykla";"1 GR.";9079781265;Ne;2;4;0;6
20790;"Vilniaus Simono Konarskio mokykla";"1 GR.";1048630061;Ne;0;4;0;4
20791;"Vilniaus Simono Konarskio mokykla";"1 GR.";4286223155;Ne;0;4;0;4
20792;"Vilniaus Simono Konarskio mokykla";"1 GR.";5073378325;Ne;1;4;0;5
20793;"Vilniaus Simono Konarskio mokykla";"1 GR.";8552079735;Ne;0;4;0;4
20794;"Vilniaus Simono Konarskio mokykla";"1 GR.";9093492513;Ne;0;4;0;4
20795;"Vilniaus Simono Konarskio mokykla";"1 GR.";7701956270;Ne;5;4;0;9
20796;"Vilniaus Trakų Vokės gimnazija";Priešmokyklinė;9386629495;Ne;3;4;0;7
20797;"Vilniaus Trakų Vokės gimnazija";Priešmokyklinė;6209271043;Ne;5;4;0;9
20798;"Vilniaus Trakų Vokės gimnazija";Priešmokyklinė;3406479364;Ne;3;2;2;7
20799;"Vilniaus Trakų Vokės gimnazija";Priešmokyklinė;1461337199;Ne;0;1;0;1
20800;"Vilniaus Trakų Vokės gimnazija";Priešmokyklinė;5526830430;Ne;0;2;0;2
20801;"Vilniaus Trakų Vokės gimnazija";Priešmokyklinė;4849992906;Ne;0;10;0;10
20802;"Vilniaus Trakų Vokės gimnazija";Priešmokyklinė;3098390989;Ne;1;0;0;1
20803;"Vilniaus Trakų Vokės gimnazija";Priešmokyklinė;50553766116;Ne;7;1;0;8
20804;"Vilniaus Trakų Vokės gimnazija";Priešmokyklinė;2672165297;Ne;6;6;1;13
20805;"Vilniaus Trakų Vokės gimnazija";Priešmokyklinė;2955411131;Ne;2;4;0;6
20806;"Vilniaus Trakų Vokės gimnazija";Priešmokyklinė;4846130117;Ne;0;5;0;5
20807;"Vilniaus Trakų Vokės gimnazija";Priešmokyklinė;1433982328;Ne;0;4;0;4
20808;"Vilniaus Trakų Vokės gimnazija";Priešmokyklinė;8658085249;Ne;0;0;3;3
20809;"Vilniaus Trakų Vokės gimnazija";Priešmokyklinė;39255784762;Ne;0;0;1;1
20810;"Vilniaus Trakų Vokės gimnazija";Priešmokyklinė;4599632235;Ne;0;5;0;5
20811;"Vilniaus Trakų Vokės gimnazija";Priešmokyklinė;2839396687;Ne;6;4;3;13
20812;"Vilniaus Trakų Vokės gimnazija";Priešmokyklinė;8857529726;Ne;4;0;1;5
20813;"Vilniaus Trakų Vokės gimnazija";Priešmokyklinė;7566567901;Ne;0;4;3;7
20814;"Vilniaus Trakų Vokės gimnazija";"Priešmokyklinė 2";4362066941;Ne;0;9;0;9
20815;"Vilniaus Trakų Vokės gimnazija";"Priešmokyklinė 2";1074730366;Ne;0;6;0;6
20816;"Vilniaus Trakų Vokės gimnazija";"Priešmokyklinė 2";6593654477;Ne;0;0;3;3
20817;"Vilniaus Trakų Vokės gimnazija";"Priešmokyklinė 2";9582511053;Ne;0;13;0;13
20818;"Vilniaus Trakų Vokės gimnazija";"Priešmokyklinė 2";3775081619;Ne;0;1;0;1
20819;"Vilniaus Trakų Vokės gimnazija";"Priešmokyklinė 2";4615315809;Ne;3;5;3;11
20820;"Vilniaus Trakų Vokės gimnazija";"Priešmokyklinė 2";25106446270;Ne;9;8;0;17
20821;"Vilniaus Trakų Vokės gimnazija";"Priešmokyklinė 2";18963190527;Ne;0;5;0;5
20822;"Vilniaus Trakų Vokės gimnazija";"Priešmokyklinė 2";4914675622;Ne;0;4;4;8
20823;"Vilniaus Trakų Vokės gimnazija";"Priešmokyklinė 2";5251929660;Ne;0;7;0;7
20824;"Vilniaus Trakų Vokės gimnazija";"Priešmokyklinė 2";3690179876;Ne;0;4;14;18
20825;"Vilniaus Trakų Vokės gimnazija";"Priešmokyklinė 2";8218370873;Ne;0;8;0;8
20826;"Vilniaus Trakų Vokės gimnazija";"Priešmokyklinė 2";6615724604;Ne;2;5;0;7
20827;"Vilniaus Trakų Vokės gimnazija";"Priešmokyklinė 2";4720226790;Ne;0;1;0;1
20828;"Vilniaus Trakų Vokės gimnazija";"Priešmokyklinė 2";1057189769;Ne;0;4;4;8
20829;"Vilniaus Trakų Vokės gimnazija";"Priešmokyklinė 2";2149804129;Ne;0;6;0;6
20830;"Vilniaus Trakų Vokės gimnazija";"Priešmokyklinė 2";1590598232;Ne;0;0;3;3
20831;"Vilniaus Trakų Vokės gimnazija";"Priešmokyklinė 2";8168960897;Ne;0;8;0;8
20832;"Vilniaus Trakų Vokės gimnazija";"Priešmokyklinė 2";9960520926;Ne;0;5;0;5
20833;"Vilniaus Trakų Vokės gimnazija";"Priešmokyklinė 2";9039274775;Ne;0;4;6;10
20834;"Vilniaus Trakų Vokės gimnazija";"Priešmokyklinė 3";7547303829;Ne;10;4;7;21
20835;"Vilniaus Trakų Vokės gimnazija";"Priešmokyklinė 3";2301758912;Ne;0;9;0;9
20836;"Vilniaus Trakų Vokės gimnazija";"Priešmokyklinė 3";7792654474;Ne;0;10;0;10
20837;"Vilniaus Trakų Vokės gimnazija";"Priešmokyklinė 3";3449317958;Ne;6;0;3;9
20838;"Vilniaus Trakų Vokės gimnazija";"Priešmokyklinė 3";9268558715;Ne;2;4;3;9
20839;"Vilniaus Trakų Vokės gimnazija";"Priešmokyklinė 3";9668538340;Ne;0;3;2;5
20840;"Vilniaus Trakų Vokės gimnazija";"Priešmokyklinė 3";2469486746;Ne;11;0;2;13
20841;"Vilniaus Trakų Vokės gimnazija";"Priešmokyklinė 3";95320712086;Ne;4;0;0;4
20842;"Vilniaus Trakų Vokės gimnazija";"Priešmokyklinė 3";1053286928;Ne;0;0;2;2
20843;"Vilniaus Trakų Vokės gimnazija";"Priešmokyklinė 3";5115117246;Ne;0;4;18;22
20844;"Vilniaus Trakų Vokės gimnazija";"Priešmokyklinė 3";6765094662;Ne;4;7;0;11
20845;"Vilniaus Trakų Vokės gimnazija";"Priešmokyklinė 3";6835150864;Ne;0;7;0;7
20846;"Vilniaus Trakų Vokės gimnazija";"Priešmokyklinė 3";1940148622;Ne;0;4;11;15
20847;"Vilniaus Trakų Vokės gimnazija";"Priešmokyklinė 3";8929514493;Ne;2;0;1;3
20848;"Vilniaus Trakų Vokės gimnazija";"Priešmokyklinė 3";9051697544;Ne;13;0;5;18
20849;"Vilniaus Trakų Vokės gimnazija";"Priešmokyklinė 3";1398572100;Ne;0;0;9;9
20850;"Vilniaus Trakų Vokės gimnazija";"Priešmokyklinė 3";2730385281;Ne;10;0;0;10
20851;"Vilniaus Trakų Vokės gimnazija";"Priešmokyklinė 3";2906094725;Ne;0;0;1;1
20852;"Vilniaus Trakų Vokės gimnazija";"Priešmokyklinė 3";9819489467;Ne;0;0;4;4
20853;"Vilniaus Salininkų gimnazija";"Priešmokyklinė A";22167560908;Ne;0;6;0;6
20854;"Vilniaus Salininkų gimnazija";"Priešmokyklinė A";10335028421;Ne;0;5;0;5
20855;"Vilniaus Salininkų gimnazija";"Priešmokyklinė A";8683841956;Ne;0;4;0;4
20856;"Vilniaus Salininkų gimnazija";"Priešmokyklinė A";1180792335;Ne;0;4;0;4
20857;"Vilniaus Salininkų gimnazija";"Priešmokyklinė A";5063792784;Ne;0;6;0;6
20858;"Vilniaus Salininkų gimnazija";"Priešmokyklinė A";1704033440;Ne;0;4;0;4
20859;"Vilniaus Salininkų gimnazija";"Priešmokyklinė A";46867660097;Ne;4;4;0;8
20860;"Vilniaus Salininkų gimnazija";"Priešmokyklinė A";3692008687;Ne;5;8;0;13
20861;"Vilniaus Salininkų gimnazija";"Priešmokyklinė A";2292919406;Ne;15;4;0;19
20862;"Vilniaus Salininkų gimnazija";"Priešmokyklinė A";35611320012;Ne;0;4;0;4
20863;"Vilniaus Salininkų gimnazija";"Priešmokyklinė A";4269202761;Ne;9;5;0;14
20864;"Vilniaus Salininkų gimnazija";"Priešmokyklinė A";9375550172;Ne;0;6;0;6
20865;"Vilniaus Salininkų gimnazija";"Priešmokyklinė A";7160091629;Ne;0;10;0;10
20866;"Vilniaus Salininkų gimnazija";"Priešmokyklinė A";41023354439;Ne;4;5;0;9
20867;"Vilniaus Salininkų gimnazija";"Priešmokyklinė A";1642658060;Ne;0;5;0;5
20868;"Vilniaus Salininkų gimnazija";"Priešmokyklinė A";3848448401;Ne;0;4;0;4
20869;"Vilniaus Salininkų gimnazija";"Priešmokyklinė A";3737786832;Ne;0;4;0;4
20870;"Vilniaus Salininkų gimnazija";"Priešmokyklinė A";8025611655;Ne;0;4;0;4
20871;"Vilniaus Salininkų gimnazija";"Priešmokyklinė A";4939261324;Ne;5;5;0;10
20872;"Vilniaus Salininkų gimnazija";"Priešmokyklinė A";6738902611;Ne;0;21;0;21
20873;"Vilniaus Salininkų gimnazija";"Priešmokyklinė A";2989580886;Ne;0;5;0;5
20874;"Vilniaus Salininkų gimnazija";"Priešmokyklinė A";3661928980;Ne;0;4;0;4
20875;"Vilniaus Salininkų gimnazija";"PRIEŠMOKYKLINĖ B";7378039370;Ne;1;4;0;5
20876;"Vilniaus Salininkų gimnazija";"PRIEŠMOKYKLINĖ B";98941037508;Ne;0;21;0;21
20877;"Vilniaus Salininkų gimnazija";"PRIEŠMOKYKLINĖ B";1355032282;Ne;0;4;0;4
20878;"Vilniaus Salininkų gimnazija";"PRIEŠMOKYKLINĖ B";8018093186;Ne;0;7;0;7
20879;"Vilniaus Salininkų gimnazija";"PRIEŠMOKYKLINĖ B";9216372353;Ne;5;4;0;9
20880;"Vilniaus Salininkų gimnazija";"PRIEŠMOKYKLINĖ B";3015424614;Ne;4;4;0;8
20881;"Vilniaus Salininkų gimnazija";"PRIEŠMOKYKLINĖ B";8488127476;Ne;5;4;0;9
20882;"Vilniaus Salininkų gimnazija";"PRIEŠMOKYKLINĖ B";8410624264;Ne;0;6;0;6
20883;"Vilniaus Salininkų gimnazija";"PRIEŠMOKYKLINĖ B";1544346282;Ne;4;4;0;8
20884;"Vilniaus Salininkų gimnazija";"PRIEŠMOKYKLINĖ B";2066091911;Ne;0;4;0;4
20885;"Vilniaus Salininkų gimnazija";"PRIEŠMOKYKLINĖ B";1723241116;Ne;11;4;0;15
20886;"Vilniaus Salininkų gimnazija";"PRIEŠMOKYKLINĖ B";30123603107;Ne;1;4;0;5
20887;"Vilniaus Salininkų gimnazija";"PRIEŠMOKYKLINĖ B";8659656902;Ne;0;4;0;4
20888;"Vilniaus Salininkų gimnazija";"PRIEŠMOKYKLINĖ B";8288199783;Ne;0;4;0;4
20889;"Vilniaus Salininkų gimnazija";"PRIEŠMOKYKLINĖ B";1065549119;Ne;0;4;0;4
20890;"Vilniaus Salininkų gimnazija";"PRIEŠMOKYKLINĖ B";1460694577;Ne;0;4;0;4
20891;"Vilniaus Salininkų gimnazija";"PRIEŠMOKYKLINĖ B";2786775879;Ne;9;4;0;13
20892;"Vilniaus Salininkų gimnazija";"PRIEŠMOKYKLINĖ B";5689344488;Ne;0;4;0;4
20893;"Vilniaus Salininkų gimnazija";"PRIEŠMOKYKLINĖ B";9513785510;Ne;0;4;0;4
20894;"Vilniaus Salininkų gimnazija";"PRIEŠMOKYKLINĖ B";91859774311;Ne;2;4;0;6
20895;"Vilniaus Salininkų gimnazija";"PRIEŠMOKYKLINĖ B";9026612929;Ne;0;21;0;21
20896;"Vilniaus Salininkų gimnazija";"PRIEŠMOKYKLINĖ B";4271670413;Ne;12;4;0;16
20897;"Vilniaus „Spindulio“ progimnazija";PM2;3093606855;Ne;1;4;2;7
20898;"Vilniaus „Spindulio“ progimnazija";PM2;6304295422;Ne;0;6;0;6
20899;"Vilniaus „Spindulio“ progimnazija";PM2;5078945984;Ne;0;4;0;4
20900;"Vilniaus „Spindulio“ progimnazija";PM2;9099945815;Ne;0;4;0;4
20901;"Vilniaus „Spindulio“ progimnazija";PM2;75538036055;Ne;0;5;0;5
20902;"Vilniaus „Spindulio“ progimnazija";PM2;15583558585;Ne;12;3;0;15
20903;"Vilniaus „Spindulio“ progimnazija";PM2;2427349194;Ne;0;5;0;5
20904;"Vilniaus „Spindulio“ progimnazija";PM2;7445566160;Ne;0;6;0;6
20905;"Vilniaus „Spindulio“ progimnazija";PM2;6561536457;Ne;0;4;0;4
20906;"Vilniaus „Spindulio“ progimnazija";PM2;8023936861;Ne;0;4;3;7
20907;"Vilniaus „Spindulio“ progimnazija";PM2;6479094819;Ne;0;1;0;1
20908;"Vilniaus „Spindulio“ progimnazija";PM2;6016791282;Ne;0;4;0;4
20909;"Vilniaus „Spindulio“ progimnazija";PM2;2356833740;Ne;0;4;2;6
20910;"Vilniaus „Spindulio“ progimnazija";PM2;1338287524;Ne;0;5;0;5
20911;"Vilniaus „Spindulio“ progimnazija";PM2;9516852657;Ne;0;4;0;4
20912;"Vilniaus „Spindulio“ progimnazija";PM2;7528505426;Ne;0;4;1;5
20913;"Vilniaus „Spindulio“ progimnazija";PM2;7120717682;Ne;0;6;0;6
20914;"Vilniaus „Spindulio“ progimnazija";PM2;1183272346;Ne;0;4;2;6
20915;"Vilniaus „Spindulio“ progimnazija";PM2;8012626513;Ne;2;3;0;5
20916;"Vilniaus „Spindulio“ progimnazija";PM2;52216192635;Ne;0;4;1;5
20917;"Vilniaus „Spindulio“ progimnazija";PM2;4791752179;Ne;0;4;0;4
20918;"Vilniaus „Spindulio“ progimnazija";PM1;1948438336;Ne;0;4;0;4
20919;"Vilniaus „Spindulio“ progimnazija";PM1;43859975789;Ne;0;4;0;4
20920;"Vilniaus „Spindulio“ progimnazija";PM1;4701887030;Ne;0;6;1;7
20921;"Vilniaus „Spindulio“ progimnazija";PM1;60320557464;Ne;11;4;0;15
20922;"Vilniaus „Spindulio“ progimnazija";PM1;2531571615;Ne;0;5;0;5
20923;"Vilniaus „Spindulio“ progimnazija";PM1;1421633312;Ne;0;4;0;4
20924;"Vilniaus „Spindulio“ progimnazija";PM1;3678131609;Ne;0;4;0;4
20925;"Vilniaus „Spindulio“ progimnazija";PM1;1194444282;Ne;0;6;0;6
20926;"Vilniaus „Spindulio“ progimnazija";PM1;56885383122;Ne;0;7;0;7
20927;"Vilniaus „Spindulio“ progimnazija";PM1;1338476746;Ne;10;7;0;17
20928;"Vilniaus „Spindulio“ progimnazija";PM1;1251961268;Ne;0;5;0;5
20929;"Vilniaus „Spindulio“ progimnazija";PM1;2402204674;Ne;6;4;0;10
20930;"Vilniaus „Spindulio“ progimnazija";PM1;6700068320;Ne;0;6;0;6
20931;"Vilniaus „Spindulio“ progimnazija";PM1;9347513042;Ne;0;6;0;6
20932;"Vilniaus „Spindulio“ progimnazija";PM1;1153333591;Ne;0;7;0;7
20933;"Vilniaus „Spindulio“ progimnazija";PM1;1650166115;Ne;0;4;0;4
20934;"Vilniaus „Spindulio“ progimnazija";PM1;9573336239;Ne;0;4;0;4
20935;"Vilniaus „Spindulio“ progimnazija";PM1;4239224971;Ne;0;4;0;4
20936;"Vilniaus „Spindulio“ progimnazija";PM1;9502789660;Ne;0;4;0;4
20937;"Vilniaus „Spindulio“ progimnazija";PM1;1454101129;Ne;0;7;0;7
20938;"Vilniaus „Spindulio“ progimnazija";PM1;1325054642;Ne;0;6;0;6
20939;"Vilniaus „Spindulio“ progimnazija";PM1;1160537966;Ne;3;4;0;7
20940;"Vilniaus „Spindulio“ progimnazija";PM1;91028452879;Ne;0;4;0;4
20941;"Vilniaus „Spindulio“ progimnazija";PM1;1789047913;Ne;0;9;0;9
20942;"Vilniaus Vladislavo Sirokomlės gimnazija";Nykštukai;1797237248;Ne;0;4;0;4
20943;"Vilniaus Vladislavo Sirokomlės gimnazija";Nykštukai;6031408197;Ne;3;4;4;11
20944;"Vilniaus Vladislavo Sirokomlės gimnazija";Nykštukai;1947403400;Ne;0;4;0;4
20945;"Vilniaus Vladislavo Sirokomlės gimnazija";Nykštukai;1499061139;Ne;12;18;0;30
20946;"Vilniaus Vladislavo Sirokomlės gimnazija";Nykštukai;2219712757;Ne;0;4;0;4
20947;"Vilniaus Vladislavo Sirokomlės gimnazija";Nykštukai;5544613599;Ne;0;6;0;6
20948;"Vilniaus Vladislavo Sirokomlės gimnazija";Nykštukai;25415760747;Ne;0;4;0;4
20949;"Vilniaus Vladislavo Sirokomlės gimnazija";Nykštukai;17201639406;Ne;0;4;0;4
20950;"Vilniaus Vladislavo Sirokomlės gimnazija";Nykštukai;8302624354;Ne;0;5;0;5
20951;"Vilniaus Vladislavo Sirokomlės gimnazija";Nykštukai;1492328724;Ne;0;9;1;10
20952;"Vilniaus Vladislavo Sirokomlės gimnazija";Nykštukai;4436165764;Ne;0;11;0;11
20953;"Vilniaus Vladislavo Sirokomlės gimnazija";Nykštukai;1837566431;Ne;0;5;0;5
20954;"Vilniaus Vladislavo Sirokomlės gimnazija";Nykštukai;8016643568;Ne;0;4;0;4
20955;"Vilniaus Vladislavo Sirokomlės gimnazija";Nykštukai;4534828670;Ne;5;25;0;30
20956;"Vilniaus Vladislavo Sirokomlės gimnazija";Nykštukai;4069044269;Ne;0;4;0;4
20957;"Vilniaus Vladislavo Sirokomlės gimnazija";Nykštukai;9391697537;Ne;0;4;0;4
20958;"Vilniaus Vladislavo Sirokomlės gimnazija";Nykštukai;5422289286;Ne;6;6;0;12
20959;"Vilniaus Vladislavo Sirokomlės gimnazija";Nykštukai;5625943720;Ne;5;14;0;19
20960;"Vilniaus Vladislavo Sirokomlės gimnazija";Nykštukai;2946297529;Ne;0;5;0;5
20961;"Vilniaus Vladislavo Sirokomlės gimnazija";Smurfai;5844437769;Ne;0;4;0;4
20962;"Vilniaus Vladislavo Sirokomlės gimnazija";Smurfai;9751494612;Ne;0;6;0;6
20963;"Vilniaus Vladislavo Sirokomlės gimnazija";Smurfai;4727265555;Ne;8;6;0;14
20964;"Vilniaus Vladislavo Sirokomlės gimnazija";Smurfai;7071043164;Ne;0;4;0;4
20965;"Vilniaus Vladislavo Sirokomlės gimnazija";Smurfai;1493604303;Ne;4;8;0;12
20966;"Vilniaus Vladislavo Sirokomlės gimnazija";Smurfai;4830374546;Ne;1;9;0;10
20967;"Vilniaus Vladislavo Sirokomlės gimnazija";Smurfai;4506651162;Ne;1;5;0;6
20968;"Vilniaus Vladislavo Sirokomlės gimnazija";Smurfai;1817869518;Ne;5;9;0;14
20969;"Vilniaus Vladislavo Sirokomlės gimnazija";Smurfai;1512245903;Ne;0;6;0;6
20970;"Vilniaus Vladislavo Sirokomlės gimnazija";Smurfai;7904983228;Ne;2;6;0;8
20971;"Vilniaus Vladislavo Sirokomlės gimnazija";Smurfai;1570206034;Ne;4;6;0;10
20972;"Vilniaus Vladislavo Sirokomlės gimnazija";Smurfai;1820583792;Ne;0;6;0;6
20973;"Vilniaus Vladislavo Sirokomlės gimnazija";Smurfai;2386927970;Ne;4;6;0;10
20974;"Vilniaus Vladislavo Sirokomlės gimnazija";Smurfai;92356998180;Ne;0;4;0;4
20975;"Vilniaus Vladislavo Sirokomlės gimnazija";Smurfai;4990982790;Ne;3;6;0;9
20976;"Vilniaus Vladislavo Sirokomlės gimnazija";Smurfai;3795927209;Ne;0;4;0;4
20977;"Vilniaus Vladislavo Sirokomlės gimnazija";Smurfai;3880578523;Ne;0;5;0;5
20978;"Vilniaus Vladislavo Sirokomlės gimnazija";Smurfai;9868386182;Ne;5;6;0;11
20979;"Vilniaus Vladislavo Sirokomlės gimnazija";Smurfai;1090204906;Ne;0;4;0;4
20980;"Vilniaus „Pelėdos” pradinė mokykla";Bitutės;3131930907;Ne;3;0;1;4
20981;"Vilniaus „Pelėdos” pradinė mokykla";Bitutės;2023718424;Ne;0;14;0;14
20982;"Vilniaus „Pelėdos” pradinė mokykla";Bitutės;13170636069;Ne;0;4;0;4
20983;"Vilniaus „Pelėdos” pradinė mokykla";Bitutės;1627717901;Ne;0;4;0;4
20984;"Vilniaus „Pelėdos” pradinė mokykla";Bitutės;49343952061;Ne;0;4;0;4
20985;"Vilniaus „Pelėdos” pradinė mokykla";Bitutės;8281005516;Ne;0;0;1;1
20986;"Vilniaus „Pelėdos” pradinė mokykla";Bitutės;7678062264;Ne;5;4;5;14
20987;"Vilniaus „Pelėdos” pradinė mokykla";Bitutės;6610166355;Ne;5;0;0;5
20988;"Vilniaus „Pelėdos” pradinė mokykla";Bitutės;4427123314;Ne;10;4;1;15
20989;"Vilniaus „Pelėdos” pradinė mokykla";Bitutės;5610993611;Ne;0;4;0;4
20990;"Vilniaus „Pelėdos” pradinė mokykla";Bitutės;1121936989;Ne;0;4;1;5
20991;"Vilniaus „Pelėdos” pradinė mokykla";Bitutės;4268531240;Ne;10;4;0;14
20992;"Vilniaus „Pelėdos” pradinė mokykla";Bitutės;3312575449;Ne;0;4;0;4
20993;"Vilniaus „Pelėdos” pradinė mokykla";Bitutės;9558483512;Ne;1;0;0;1
20994;"Vilniaus „Pelėdos” pradinė mokykla";Bitutės;7907026349;Ne;0;4;0;4
20995;"Vilniaus „Pelėdos” pradinė mokykla";Bitutės;9343761295;Ne;0;4;1;5
20996;"Vilniaus „Pelėdos” pradinė mokykla";Bitutės;7006338378;Ne;0;4;1;5
20997;"Vilniaus „Pelėdos” pradinė mokykla";Bitutės;3030820917;Ne;0;4;3;7
20998;"Vilniaus „Pelėdos” pradinė mokykla";Bitutės;3768735503;Ne;0;4;1;5
20999;"Vilniaus „Pelėdos” pradinė mokykla";Bitutės;6597383913;Ne;3;2;0;5
21000;"Vilniaus „Pelėdos” pradinė mokykla";Boružėlės;3284613284;Ne;7;0;0;7
21001;"Vilniaus „Pelėdos” pradinė mokykla";Boružėlės;1032549174;Ne;9;4;0;13
21002;"Vilniaus „Pelėdos” pradinė mokykla";Boružėlės;1314392095;Ne;0;4;0;4
21003;"Vilniaus „Pelėdos” pradinė mokykla";Boružėlės;1398976932;Ne;0;1;0;1
21004;"Vilniaus „Pelėdos” pradinė mokykla";Boružėlės;1249227477;Ne;0;3;0;3
21005;"Vilniaus „Pelėdos” pradinė mokykla";Boružėlės;5169736542;Ne;0;3;0;3
21006;"Vilniaus „Pelėdos” pradinė mokykla";Boružėlės;6897988246;Ne;0;1;0;1
21007;"Vilniaus „Pelėdos” pradinė mokykla";Boružėlės;1830060403;Ne;0;4;0;4
21008;"Vilniaus „Pelėdos” pradinė mokykla";Boružėlės;4347647695;Ne;1;4;0;5
21009;"Vilniaus „Pelėdos” pradinė mokykla";Boružėlės;3970413055;Ne;0;4;0;4
21010;"Vilniaus „Pelėdos” pradinė mokykla";Boružėlės;9279913053;Ne;0;4;0;4
21011;"Vilniaus „Pelėdos” pradinė mokykla";Boružėlės;1616324236;Ne;0;4;0;4
21012;"Vilniaus „Pelėdos” pradinė mokykla";Boružėlės;1704933971;Ne;0;4;0;4
21013;"Vilniaus „Pelėdos” pradinė mokykla";Boružėlės;8370864547;Ne;0;4;0;4
21014;"Vilniaus „Pelėdos” pradinė mokykla";Boružėlės;3790209561;Ne;0;4;0;4
21015;"Vilniaus „Pelėdos” pradinė mokykla";Boružėlės;3118698712;Ne;0;1;0;1
21016;"Vilniaus „Pelėdos” pradinė mokykla";Boružėlės;5140876051;Ne;0;4;0;4
21017;"Vilniaus „Pelėdos” pradinė mokykla";Boružėlės;8086378912;Ne;5;3;0;8
21018;"Vilniaus „Pelėdos” pradinė mokykla";Boružėlės;4740303929;Ne;0;4;0;4
21019;"Vilniaus „Pelėdos” pradinė mokykla";2b;43070360695;Ne;2;0;0;2
21020;"Vilniaus „Pelėdos” pradinė mokykla";3a;5526363776;Ne;2;0;0;2
21021;"Vilniaus Joachimo Lelevelio inžinerijos mokykla";0A;57362664278;Ne;0;4;0;4
21022;"Vilniaus Joachimo Lelevelio inžinerijos mokykla";0A;1694423628;Ne;2;12;0;14
21023;"Vilniaus Joachimo Lelevelio inžinerijos mokykla";0A;19420482998;Ne;0;5;0;5
21024;"Vilniaus Joachimo Lelevelio inžinerijos mokykla";0A;1546251543;Ne;0;21;0;21
21025;"Vilniaus Joachimo Lelevelio inžinerijos mokykla";0A;9130637883;Ne;7;5;0;12
21026;"Vilniaus Joachimo Lelevelio inžinerijos mokykla";0A;6217540064;Ne;0;5;0;5
21027;"Vilniaus Joachimo Lelevelio inžinerijos mokykla";0A;1954888655;Ne;0;4;0;4
21028;"Vilniaus Joachimo Lelevelio inžinerijos mokykla";0A;7776071299;Ne;0;6;0;6
21029;"Vilniaus Joachimo Lelevelio inžinerijos mokykla";0A;9215070593;Ne;0;4;0;4
21030;"Vilniaus Joachimo Lelevelio inžinerijos mokykla";0A;3039980710;Ne;0;4;0;4
21031;"Vilniaus Joachimo Lelevelio inžinerijos mokykla";0A;1826015013;Ne;0;6;0;6
21032;"Vilniaus Joachimo Lelevelio inžinerijos mokykla";0A;5630659056;Ne;0;6;4;10
21033;"Vilniaus Joachimo Lelevelio inžinerijos mokykla";0A;9171690612;Ne;0;6;6;12
21034;"Vilniaus Joachimo Lelevelio inžinerijos mokykla";0A;3271832822;Ne;0;4;0;4
21035;"Vilniaus Joachimo Lelevelio inžinerijos mokykla";0A;2797443202;Ne;0;4;1;5
21036;"Vilniaus Joachimo Lelevelio inžinerijos mokykla";0B;6404064049;Ne;0;4;1;5
21037;"Vilniaus Joachimo Lelevelio inžinerijos mokykla";0B;2324578741;Ne;0;4;1;5
21038;"Vilniaus Joachimo Lelevelio inžinerijos mokykla";0B;6132569107;Ne;0;4;0;4
21039;"Vilniaus Joachimo Lelevelio inžinerijos mokykla";0B;64247830728;Ne;0;29;0;29
21040;"Vilniaus Joachimo Lelevelio inžinerijos mokykla";0B;2601103834;Ne;0;4;10;14
21041;"Vilniaus Joachimo Lelevelio inžinerijos mokykla";0B;65960895249;Ne;0;4;0;4
21042;"Vilniaus Joachimo Lelevelio inžinerijos mokykla";0B;5722934228;Ne;0;7;0;7
21043;"Vilniaus Joachimo Lelevelio inžinerijos mokykla";0B;1385352925;Ne;0;4;0;4
21044;"Vilniaus Joachimo Lelevelio inžinerijos mokykla";0B;4209118353;Ne;0;8;2;10
21045;"Vilniaus Joachimo Lelevelio inžinerijos mokykla";0B;6883982889;Ne;0;4;0;4
21046;"Vilniaus Joachimo Lelevelio inžinerijos mokykla";0B;9595277597;Ne;4;5;0;9
21047;"Vilniaus Joachimo Lelevelio inžinerijos mokykla";0B;2842587194;Ne;3;4;0;7
21048;"Vilniaus Joachimo Lelevelio inžinerijos mokykla";0B;8042807487;Ne;0;8;0;8
21049;"Vilniaus Joachimo Lelevelio inžinerijos mokykla";0B;6501930436;Ne;2;4;1;7
21050;"Vilniaus Joachimo Lelevelio inžinerijos mokykla";0B;71081903240;Ne;0;4;0;4
21051;"Vilniaus Juzefo Ignacijaus Kraševskio gimnazija";Priešmokyklinė;2201538495;Ne;0;4;0;4
21052;"Vilniaus Juzefo Ignacijaus Kraševskio gimnazija";Priešmokyklinė;9114472645;Ne;5;4;0;9
21053;"Vilniaus Juzefo Ignacijaus Kraševskio gimnazija";Priešmokyklinė;5261769707;Ne;0;4;0;4
21054;"Vilniaus Juzefo Ignacijaus Kraševskio gimnazija";Priešmokyklinė;5255617339;Ne;12;4;0;16
21055;"Vilniaus Juzefo Ignacijaus Kraševskio gimnazija";Priešmokyklinė;1600495468;Ne;0;5;0;5
21056;"Vilniaus Juzefo Ignacijaus Kraševskio gimnazija";Priešmokyklinė;3733665122;Ne;8;7;0;15
21057;"Vilniaus Juzefo Ignacijaus Kraševskio gimnazija";Priešmokyklinė;2168987649;Ne;9;4;0;13
21058;"Vilniaus Juzefo Ignacijaus Kraševskio gimnazija";Priešmokyklinė;4499924331;Ne;0;8;0;8
21059;"Vilniaus Juzefo Ignacijaus Kraševskio gimnazija";Priešmokyklinė;6048337545;Ne;0;4;0;4
21060;"Vilniaus Juzefo Ignacijaus Kraševskio gimnazija";Priešmokyklinė;9948555227;Ne;8;4;4;16
21061;"Vilniaus Juzefo Ignacijaus Kraševskio gimnazija";Priešmokyklinė;7993975989;Ne;0;12;0;12
21062;"Vilniaus Juzefo Ignacijaus Kraševskio gimnazija";Priešmokyklinė;2684151591;Ne;0;6;0;6
21063;"Vilniaus Juzefo Ignacijaus Kraševskio gimnazija";Priešmokyklinė;7670166244;Ne;0;4;2;6
21064;"Vilniaus Juzefo Ignacijaus Kraševskio gimnazija";Priešmokyklinė;4864834075;Ne;0;9;0;9
21065;"Vilniaus Juzefo Ignacijaus Kraševskio gimnazija";Priešmokyklinė;1837140329;Ne;0;4;2;6
21066;"Vilniaus Juzefo Ignacijaus Kraševskio gimnazija";Priešmokyklinė;1460429651;Ne;0;7;0;7
21067;"Vilniaus Juzefo Ignacijaus Kraševskio gimnazija";Priešmokyklinė;9501262918;Ne;0;4;3;7
21068;"Vilniaus Juzefo Ignacijaus Kraševskio gimnazija";Priešmokyklinė;9333766622;Ne;0;12;0;12
21069;"Vilniaus Juzefo Ignacijaus Kraševskio gimnazija";Priešmokyklinė;3507672150;Ne;2;9;0;11
21070;"Vilniaus Juzefo Ignacijaus Kraševskio gimnazija";Priešmokyklinė;7305350540;Ne;0;6;0;6
21071;"Vilniaus Juzefo Ignacijaus Kraševskio gimnazija";Priešmokyklinė;3698808100;Ne;0;5;0;5
21072;"Vilniaus Juzefo Ignacijaus Kraševskio gimnazija";Priešmokyklinė;9754373141;Ne;10;4;4;18
21073;"Vilniaus Jono Pauliaus II progimnazija";Nykštukai;2055530718;Ne;1;4;0;5
21074;"Vilniaus Jono Pauliaus II progimnazija";Nykštukai;7140223126;Ne;0;4;0;4
21075;"Vilniaus Jono Pauliaus II progimnazija";Nykštukai;48694326383;Ne;0;4;0;4
21076;"Vilniaus Jono Pauliaus II progimnazija";Nykštukai;4831426440;Ne;0;5;3;8
21077;"Vilniaus Jono Pauliaus II progimnazija";Nykštukai;3762141936;Ne;0;4;0;4
21078;"Vilniaus Jono Pauliaus II progimnazija";Nykštukai;8703046661;Ne;0;4;0;4
21079;"Vilniaus Jono Pauliaus II progimnazija";Nykštukai;6724813553;Ne;0;4;0;4
21080;"Vilniaus Jono Pauliaus II progimnazija";Nykštukai;51629266891;Ne;11;4;0;15
21081;"Vilniaus Jono Pauliaus II progimnazija";Nykštukai;7268811782;Ne;0;8;0;8
21082;"Vilniaus Jono Pauliaus II progimnazija";Nykštukai;8998452731;Ne;8;4;0;12
21083;"Vilniaus Jono Pauliaus II progimnazija";Nykštukai;4071338645;Ne;3;8;0;11
21084;"Vilniaus Jono Pauliaus II progimnazija";Nykštukai;3637409607;Ne;0;15;0;15
21085;"Vilniaus Jono Pauliaus II progimnazija";Nykštukai;6988819614;Ne;4;4;0;8
21086;"Vilniaus Jono Pauliaus II progimnazija";Nykštukai;9672929606;Ne;10;4;1;15
21087;"Vilniaus Jono Pauliaus II progimnazija";Nykštukai;9457189905;Ne;0;4;2;6
21088;"Vilniaus Jono Pauliaus II progimnazija";Nykštukai;2013905907;Ne;0;4;0;4
21089;"Vilniaus Jono Pauliaus II progimnazija";Nykštukai;2095972347;Ne;0;4;0;4
21090;"Vilniaus Jono Pauliaus II progimnazija";Nykštukai;1624125024;Ne;4;4;0;8
21091;"Vilniaus Jono Pauliaus II progimnazija";Nykštukai;8796557675;Ne;0;6;0;6
21092;"Vilniaus Jono Pauliaus II progimnazija";Nykštukai;5902455219;Ne;0;4;0;4
21093;"Vilniaus Jono Pauliaus II progimnazija";Žiniukai;36350993825;Ne;2;5;0;7
21094;"Vilniaus Jono Pauliaus II progimnazija";Žiniukai;8607110629;Ne;5;4;2;11
21095;"Vilniaus Jono Pauliaus II progimnazija";Žiniukai;6779413882;Ne;11;4;0;15
21096;"Vilniaus Jono Pauliaus II progimnazija";Žiniukai;1897451825;Ne;0;14;0;14
21097;"Vilniaus Jono Pauliaus II progimnazija";Žiniukai;49110267692;Ne;0;4;1;5
21098;"Vilniaus Jono Pauliaus II progimnazija";Žiniukai;7947148051;Ne;0;6;0;6
21099;"Vilniaus Jono Pauliaus II progimnazija";Žiniukai;9246391309;Ne;0;4;0;4
21100;"Vilniaus Jono Pauliaus II progimnazija";Žiniukai;35673258175;Ne;0;4;3;7
21101;"Vilniaus Jono Pauliaus II progimnazija";Žiniukai;4472742569;Ne;11;4;0;15
21102;"Vilniaus Jono Pauliaus II progimnazija";Žiniukai;69245659818;Ne;5;8;0;13
21103;"Vilniaus Jono Pauliaus II progimnazija";Žiniukai;9664467134;Ne;8;4;0;12
21104;"Vilniaus Jono Pauliaus II progimnazija";Žiniukai;7838787153;Ne;10;4;0;14
21105;"Vilniaus Jono Pauliaus II progimnazija";Žiniukai;8922195998;Ne;0;4;0;4
21106;"Vilniaus Jono Pauliaus II progimnazija";Žiniukai;1429139157;Ne;7;5;0;12
21107;"Vilniaus Jono Pauliaus II progimnazija";Žiniukai;3042409414;Ne;0;7;1;8
21108;"Vilniaus Jono Pauliaus II progimnazija";Žiniukai;8245310502;Ne;7;6;0;13
21109;"Vilniaus Jono Pauliaus II progimnazija";Žiniukai;5593546668;Ne;0;4;1;5
21110;"Vilniaus Jono Pauliaus II progimnazija";Žiniukai;1460444785;Ne;2;7;0;9
21111;"Vilniaus Jono Pauliaus II progimnazija";Žiniukai;9262869284;Ne;9;5;2;16
21112;"Vilniaus Jono Pauliaus II progimnazija";Žiniukai;38456484551;Ne;0;11;0;11
21113;"Vilniaus Jono Pauliaus II progimnazija";Žiniukai;6646474196;Ne;3;4;1;8
21114;"Vilniaus Jono Pauliaus II progimnazija";Spindulėlis;2391924358;Ne;0;4;0;4
21115;"Vilniaus Jono Pauliaus II progimnazija";Spindulėlis;9953834483;Ne;0;4;0;4
21116;"Vilniaus Jono Pauliaus II progimnazija";Spindulėlis;1950514819;Ne;0;31;0;31
21117;"Vilniaus Jono Pauliaus II progimnazija";Spindulėlis;1298127839;Ne;0;5;0;5
21118;"Vilniaus Jono Pauliaus II progimnazija";Spindulėlis;4034847901;Ne;0;4;0;4
21119;"Vilniaus Jono Pauliaus II progimnazija";Spindulėlis;8980788109;Ne;0;4;1;5
21120;"Vilniaus Jono Pauliaus II progimnazija";Spindulėlis;1009453682;Ne;0;4;0;4
21121;"Vilniaus Jono Pauliaus II progimnazija";Spindulėlis;4579700769;Ne;0;4;0;4
21122;"Vilniaus Jono Pauliaus II progimnazija";Spindulėlis;7136135394;Ne;0;4;0;4
21123;"Vilniaus Jono Pauliaus II progimnazija";Spindulėlis;2244921301;Ne;2;4;0;6
21124;"Vilniaus Jono Pauliaus II progimnazija";Spindulėlis;1133359254;Ne;0;4;0;4
21125;"Vilniaus Jono Pauliaus II progimnazija";Spindulėlis;8336138549;Ne;0;9;0;9
21126;"Vilniaus Jono Pauliaus II progimnazija";Spindulėlis;1831094707;Ne;0;4;0;4
21127;"Vilniaus Jono Pauliaus II progimnazija";Spindulėlis;5036549574;Ne;5;4;0;9
21128;"Vilniaus Jono Pauliaus II progimnazija";Spindulėlis;5451923881;Ne;7;4;0;11
21129;"Vilniaus Jono Pauliaus II progimnazija";Spindulėlis;8100789958;Ne;5;4;0;9
21130;"Vilniaus Jono Pauliaus II progimnazija";Spindulėlis;6964047214;Ne;0;4;2;6
21131;"Vilniaus Jono Pauliaus II progimnazija";Spindulėlis;2445444641;Ne;0;4;0;4
21132;"Vilniaus Jono Pauliaus II progimnazija";Spindulėlis;5079107907;Ne;0;4;0;4
21133;"Vilniaus Jono Pauliaus II progimnazija";Spindulėlis;9908198854;Ne;8;5;0;13
21134;"Vilniaus Jono Pauliaus II progimnazija";Spindulėlis;6595165722;Ne;5;4;0;9
21135;"Vilniaus Verkių mokykla-daugiafunkcis centras";"&quot;MAŽIEJI VERKIUKAI&quot;";7942036741;Ne;0;4;0;4
21136;"Vilniaus Verkių mokykla-daugiafunkcis centras";"&quot;MAŽIEJI VERKIUKAI&quot;";5586925136;Ne;0;4;0;4
21137;"Vilniaus Verkių mokykla-daugiafunkcis centras";"1S, 3S, 3L, 4SK, 4LK klasė";42873989145;Ne;0;4;0;4
21138;"Vilniaus Verkių mokykla-daugiafunkcis centras";"1S, 3S, 3L, 4SK, 4LK klasė";5346078886;Ne;0;7;0;7
21139;"Vilniaus Verkių mokykla-daugiafunkcis centras";"1S, 3S, 3L, 4SK, 4LK klasė";8844612659;Ne;0;9;0;9
21140;"Vilniaus Verkių mokykla-daugiafunkcis centras";"1S, 3S, 3L, 4SK, 4LK klasė";1732370199;Ne;0;4;0;4
21141;"Vilniaus Verkių mokykla-daugiafunkcis centras";"1S, 3S, 3L, 4SK, 4LK klasė";4773060159;Ne;0;19;0;19
21142;"Vilniaus Verkių mokykla-daugiafunkcis centras";"1S, 3S, 3L, 4SK, 4LK klasė";2428312586;Ne;0;4;0;4
21143;"Vilniaus Verkių mokykla-daugiafunkcis centras";"1S, 3S, 3L, 4SK, 4LK klasė";4436123342;Ne;0;4;0;4
21144;"Vilniaus Verkių mokykla-daugiafunkcis centras";"1S, 3S, 3L, 4SK, 4LK klasė";3669076308;Ne;0;4;0;4
21145;"Vilniaus Verkių mokykla-daugiafunkcis centras";"1S, 3S, 3L, 4SK, 4LK klasė";67103811533;Ne;0;14;0;14
21146;"Vilniaus Verkių mokykla-daugiafunkcis centras";"1S, 3S, 3L, 4SK, 4LK klasė";9634174513;Ne;0;4;0;4
21147;"Vilniaus Verkių mokykla-daugiafunkcis centras";"1S, 3S, 3L, 4SK, 4LK klasė";62513475987;Ne;0;19;0;19
21148;"Vilniaus Verkių mokykla-daugiafunkcis centras";"1S, 3S, 3L, 4SK, 4LK klasė";1350580842;Ne;0;13;0;13
21149;"Vilniaus Verkių mokykla-daugiafunkcis centras";"1S, 3S, 3L, 4SK, 4LK klasė";6417342868;Ne;0;4;0;4
21150;"Vilniaus Verkių mokykla-daugiafunkcis centras";"1S, 2S, 2L, 3S, 4S, 4SK, 5L klasė ";6951842417;Ne;0;4;0;4
21151;"Vilniaus Verkių mokykla-daugiafunkcis centras";"1S, 2S, 2L, 3S, 4S, 4SK, 5L klasė ";1515290326;Ne;0;4;0;4
21152;"Vilniaus Verkių mokykla-daugiafunkcis centras";"1S, 2S, 2L, 3S, 4S, 4SK, 5L klasė ";4011623622;Ne;0;21;0;21
21153;"Vilniaus Verkių mokykla-daugiafunkcis centras";"1S, 2S, 2L, 3S, 4S, 4SK, 5L klasė ";8342540661;Ne;0;8;0;8
21154;"Vilniaus Verkių mokykla-daugiafunkcis centras";"1S, 2S, 2L, 3S, 4S, 4SK, 5L klasė ";24268622677;Ne;0;4;0;4
21155;"Vilniaus Verkių mokykla-daugiafunkcis centras";"1S, 2S, 2L, 3S, 4S, 4SK, 5L klasė ";24268622677;Ne;0;4;0;4
21156;"Vilniaus Verkių mokykla-daugiafunkcis centras";"1S, 2S, 2L, 3S, 4S, 4SK, 5L klasė ";24268622677;Ne;0;4;0;4
21157;"Vilniaus Verkių mokykla-daugiafunkcis centras";"1S, 2S, 2L, 3S, 4S, 4SK, 5L klasė ";24268622677;Ne;0;4;0;4
21158;"Vilniaus Verkių mokykla-daugiafunkcis centras";"1S, 2S, 2L, 3S, 4S, 4SK, 5L klasė ";37848550744;Ne;0;21;0;21
21159;"Vilniaus Verkių mokykla-daugiafunkcis centras";"1S, 2S, 2L, 3S, 4S, 4SK, 5L klasė ";7977250483;Ne;0;4;0;4
21160;"Vilniaus Verkių mokykla-daugiafunkcis centras";"1S, 2S, 2L, 3S, 4S, 4SK, 5L klasė ";2396841187;Ne;0;15;0;15
21161;"Vilniaus Verkių mokykla-daugiafunkcis centras";"1L, 4S, 4L, 6S, 6L, 6LK klasė";6813357731;Ne;0;7;0;7
21162;"Vilniaus Verkių mokykla-daugiafunkcis centras";"1L, 4S, 4L, 6S, 6L, 6LK klasė";7591511377;Ne;0;5;0;5
21163;"Vilniaus Verkių mokykla-daugiafunkcis centras";"1L, 4S, 4L, 6S, 6L, 6LK klasė";9355917461;Ne;0;9;0;9
21164;"Vilniaus Verkių mokykla-daugiafunkcis centras";"1L, 4S, 4L, 6S, 6L, 6LK klasė";4187084284;Ne;0;6;0;6
21165;"Vilniaus Verkių mokykla-daugiafunkcis centras";"1L, 4S, 4L, 6S, 6L, 6LK klasė";5603432321;Ne;0;4;0;4
21166;"Vilniaus Verkių mokykla-daugiafunkcis centras";"1L, 4S, 4L, 6S, 6L, 6LK klasė";6868531249;Ne;0;7;0;7
21167;"Vilniaus Verkių mokykla-daugiafunkcis centras";"1L, 4S, 4L, 6S, 6L, 6LK klasė";6868531249;Ne;0;7;0;7
21168;"Vilniaus Verkių mokykla-daugiafunkcis centras";"1L, 4S, 4L, 6S, 6L, 6LK klasė";6868531249;Ne;0;7;0;7
21169;"Vilniaus Verkių mokykla-daugiafunkcis centras";"1L, 4S, 4L, 6S, 6L, 6LK klasė";6868531249;Ne;0;7;0;7
21170;"Vilniaus Verkių mokykla-daugiafunkcis centras";"1L, 4S, 4L, 6S, 6L, 6LK klasė";6868531249;Ne;0;7;0;7
21171;"Vilniaus Verkių mokykla-daugiafunkcis centras";"1L, 4S, 4L, 6S, 6L, 6LK klasė";6868531249;Ne;0;7;0;7
21172;"Vilniaus Verkių mokykla-daugiafunkcis centras";"1L, 4S, 4L, 6S, 6L, 6LK klasė";1989565075;Ne;0;21;0;21
21173;"Vilniaus Verkių mokykla-daugiafunkcis centras";"1L, 4S, 4L, 6S, 6L, 6LK klasė";9259642351;Ne;0;21;0;21
21174;"Vilniaus Verkių mokykla-daugiafunkcis centras";"5L, 6L, 6LK, 7L, 7LK klasė ";64637387481;Ne;0;6;0;6
21175;"Vilniaus Verkių mokykla-daugiafunkcis centras";"5L, 6L, 6LK, 7L, 7LK klasė ";64637387481;Ne;0;6;0;6
21176;"Vilniaus Verkių mokykla-daugiafunkcis centras";"5L, 6L, 6LK, 7L, 7LK klasė ";1503792026;Ne;0;18;0;18
21177;"Vilniaus Verkių mokykla-daugiafunkcis centras";"5L, 6L, 6LK, 7L, 7LK klasė ";4066377955;Ne;0;16;0;16
21178;"Vilniaus Verkių mokykla-daugiafunkcis centras";"5L, 6L, 6LK, 7L, 7LK klasė ";55421735777;Ne;0;6;0;6
21179;"Vilniaus Verkių mokykla-daugiafunkcis centras";"5L, 6L, 6LK, 7L, 7LK klasė ";44372408680;Ne;0;4;0;4
21180;"Vilniaus Verkių mokykla-daugiafunkcis centras";"6LK, 7S, 7SK klasė";3631392717;Ne;0;5;0;5
21181;"Vilniaus Verkių mokykla-daugiafunkcis centras";"6LK, 7S, 7SK klasė";8779088808;Ne;0;6;0;6
21182;"Vilniaus Verkių mokykla-daugiafunkcis centras";"6LK, 7S, 7SK klasė";3444507772;Ne;0;5;0;5
21183;"Vilniaus Verkių mokykla-daugiafunkcis centras";"6LK, 7S, 7SK klasė";1514869108;Ne;0;6;0;6
21184;"Vilniaus Verkių mokykla-daugiafunkcis centras";"6LK, 7S, 7SK klasė";3145397791;Ne;0;15;0;15
21185;"Vilniaus Verkių mokykla-daugiafunkcis centras";"6LK, 7S, 7SK klasė";3870610295;Ne;0;21;0;21
21186;"Vilniaus Verkių mokykla-daugiafunkcis centras";"6LK, 7S, 7SK klasė";2415067230;Ne;0;6;0;6
21187;"Vilniaus Verkių mokykla-daugiafunkcis centras";"6LK, 7S, 7SK klasė";2360897023;Ne;0;5;0;5
21188;"Vilniaus Verkių mokykla-daugiafunkcis centras";"5S, 5SK, 5L, 6S klasė";7438765543;Ne;0;4;0;4
21189;"Vilniaus Verkių mokykla-daugiafunkcis centras";"5S, 5SK, 5L, 6S klasė";8272359516;Ne;0;7;0;7
21190;"Vilniaus Verkių mokykla-daugiafunkcis centras";"5S, 5SK, 5L, 6S klasė";9598385220;Ne;0;5;0;5
21191;"Vilniaus Verkių mokykla-daugiafunkcis centras";"5S, 5SK, 5L, 6S klasė";4914336091;Ne;0;4;0;4
21192;"Vilniaus Verkių mokykla-daugiafunkcis centras";"5S, 5SK, 5L, 6S klasė";4914336091;Ne;0;4;0;4
21193;"Vilniaus Verkių mokykla-daugiafunkcis centras";"5S, 5SK, 5L, 6S klasė";93185505974;Ne;0;4;0;4
21194;"Vilniaus Verkių mokykla-daugiafunkcis centras";"5S, 5SK, 5L, 6S klasė";5899020119;Ne;0;4;0;4
21195;"Vilniaus Verkių mokykla-daugiafunkcis centras";"5S, 5SK, 5L, 6S klasė";13432910676;Ne;0;6;0;6
21196;"Vilniaus Verkių mokykla-daugiafunkcis centras";"5S, 5SK, 5L, 6S klasė";11657021053;Ne;0;4;0;4
21197;"Vilniaus Verkių mokykla-daugiafunkcis centras";"6L, 7L, 7LK klasė";37572425955;Ne;0;7;0;7
21198;"Vilniaus Verkių mokykla-daugiafunkcis centras";"6L, 7L, 7LK klasė";5865808613;Ne;0;5;0;5
21199;"Vilniaus Verkių mokykla-daugiafunkcis centras";"6L, 7L, 7LK klasė";2261393560;Ne;0;12;0;12
21200;"Vilniaus Verkių mokykla-daugiafunkcis centras";"6L, 7L, 7LK klasė";5937487837;Ne;0;6;0;6
21201;"Vilniaus Verkių mokykla-daugiafunkcis centras";"6L, 7L, 7LK klasė";9362938835;Ne;0;4;0;4
21202;"Vilniaus Verkių mokykla-daugiafunkcis centras";"6L, 7L, 7LK klasė";44425437058;Ne;0;4;0;4
21203;"Vilniaus Verkių mokykla-daugiafunkcis centras";"8LK, 9L, 10L, 10LK klasė";1480378589;Ne;0;21;0;21
21204;"Vilniaus Verkių mokykla-daugiafunkcis centras";"8LK, 9L, 10L, 10LK klasė";3519068093;Ne;0;9;0;9
21205;"Vilniaus Verkių mokykla-daugiafunkcis centras";"8LK, 9L, 10L, 10LK klasė";2054806833;Ne;0;10;0;10
21206;"Vilniaus Verkių mokykla-daugiafunkcis centras";"8LK, 9L, 10L, 10LK klasė";7616694308;Ne;0;9;0;9
21207;"Vilniaus Verkių mokykla-daugiafunkcis centras";"8LK, 9L, 10L, 10LK klasė";2457359072;Ne;0;4;0;4
21208;"Vilniaus Verkių mokykla-daugiafunkcis centras";"8LK, 9L, 10L, 10LK klasė";1853931111;Ne;0;12;0;12
21209;"Vilniaus Verkių mokykla-daugiafunkcis centras";"8LK, 9L, 10L, 10LK klasė";7886245604;Ne;0;7;0;7
21210;"Vilniaus Verkių mokykla-daugiafunkcis centras";"8LK, 9L, 10L, 10LK klasė";6808441017;Ne;0;16;0;16
21211;"Vilniaus Verkių mokykla-daugiafunkcis centras";"8LK, 9L, 10L, 10LK klasė";9613466086;Ne;0;19;0;19
21212;"Vilniaus Verkių mokykla-daugiafunkcis centras";"8LK, 9L, 10L, 10LK klasė";9613466086;Ne;0;19;0;19
21213;"Vilniaus Verkių mokykla-daugiafunkcis centras";"10S, 10L klasė";6352988790;Ne;0;17;0;17
21214;"Vilniaus Verkių mokykla-daugiafunkcis centras";"10S, 10L klasė";3218545382;Ne;0;21;0;21
21215;"Vilniaus Verkių mokykla-daugiafunkcis centras";"10S, 10L klasė";3529185406;Ne;0;15;0;15
21216;"Vilniaus Verkių mokykla-daugiafunkcis centras";"10S, 10L klasė";3529185406;Ne;0;15;0;15
21217;"Vilniaus Verkių mokykla-daugiafunkcis centras";"10S, 10L klasė";3529185406;Ne;0;15;0;15
21218;"Vilniaus Verkių mokykla-daugiafunkcis centras";"10S, 10L klasė";9330275690;Ne;0;8;0;8
21219;"Vilniaus Verkių mokykla-daugiafunkcis centras";"10S, 10L klasė";2708620759;Ne;0;8;0;8
21220;"Vilniaus Verkių mokykla-daugiafunkcis centras";"6S, 8S, 9S, 9L, 10L klasė";1334357441;Ne;0;14;0;14
21221;"Vilniaus Verkių mokykla-daugiafunkcis centras";"6S, 8S, 9S, 9L, 10L klasė";3215674630;Ne;0;4;0;4
21222;"Vilniaus Verkių mokykla-daugiafunkcis centras";"6S, 8S, 9S, 9L, 10L klasė";5030855634;Ne;0;13;0;13
21223;"Vilniaus Verkių mokykla-daugiafunkcis centras";"6S, 8S, 9S, 9L, 10L klasė";7278736731;Ne;0;9;0;9
21224;"Vilniaus Verkių mokykla-daugiafunkcis centras";"6S, 8S, 9S, 9L, 10L klasė";2810286239;Ne;0;18;0;18
21225;"Vilniaus Verkių mokykla-daugiafunkcis centras";"6S, 8S, 9S, 9L, 10L klasė";5256639859;Ne;0;4;0;4
21226;"Vilniaus Verkių mokykla-daugiafunkcis centras";"10S, 10L, SĮUP I m.m. klasė ";3155197214;Ne;0;21;0;21
21227;"Vilniaus Verkių mokykla-daugiafunkcis centras";"10S, 10L, SĮUP I m.m. klasė ";1062601239;Ne;0;11;0;11
21228;"Vilniaus Verkių mokykla-daugiafunkcis centras";"10S, 10L, SĮUP I m.m. klasė ";6958157444;Ne;0;10;0;10
21229;"Vilniaus Verkių mokykla-daugiafunkcis centras";"10S, 10L, SĮUP I m.m. klasė ";6937513931;Ne;0;21;0;21
21230;"Vilniaus Verkių mokykla-daugiafunkcis centras";"10S, 10L, SĮUP I m.m. klasė ";2076640938;Ne;0;10;0;10
21231;"Vilniaus Verkių mokykla-daugiafunkcis centras";"10S, 10L, SĮUP I m.m. klasė ";2305478898;Ne;0;7;0;7
21232;"Vilniaus Verkių mokykla-daugiafunkcis centras";"10S, 10L, SĮUP I m.m. klasė ";2518928115;Ne;0;9;0;9
21233;"Vilniaus Verkių mokykla-daugiafunkcis centras";"10S, 10L, SĮUP I m.m. klasė ";7000432264;Ne;0;6;0;6
21234;"Vilniaus Verkių mokykla-daugiafunkcis centras";"10S, 10L, SĮUP I m.m. klasė ";9098854782;Ne;0;5;0;5
21235;"Vilniaus Verkių mokykla-daugiafunkcis centras";"10S, 10L, SĮUP I m.m. klasė ";1454746961;Ne;0;6;0;6
21236;"Vilniaus Verkių mokykla-daugiafunkcis centras";"SĮUP I m.m., SĮUP III m.m. klasė ";6301505187;Ne;0;4;0;4
21237;"Vilniaus Verkių mokykla-daugiafunkcis centras";"SĮUP I m.m., SĮUP III m.m. klasė ";8732243137;Ne;0;4;0;4
21238;"Vilniaus Verkių mokykla-daugiafunkcis centras";"SĮUP I m.m., SĮUP III m.m. klasė ";9975744237;Ne;0;7;0;7
21239;"Vilniaus Verkių mokykla-daugiafunkcis centras";"SĮUP I m.m., SĮUP III m.m. klasė ";5476038315;Ne;0;4;0;4
21240;"Vilniaus Verkių mokykla-daugiafunkcis centras";"SĮUP I m.m., SĮUP III m.m. klasė ";1548000907;Ne;0;4;0;4
21241;"Vilniaus Verkių mokykla-daugiafunkcis centras";"SĮUP I m.m., SĮUP III m.m. klasė ";1283606579;Ne;0;11;0;11
21242;"Vilniaus Verkių mokykla-daugiafunkcis centras";"SĮUP I m.m., SĮUP III m.m. klasė ";9500247903;Ne;0;9;0;9
21243;"Vilniaus Verkių mokykla-daugiafunkcis centras";"SĮUP I m.m., SĮUP III m.m. klasė ";6966632177;Ne;0;16;0;16
21244;"Vilniaus Verkių mokykla-daugiafunkcis centras";"SĮUP I m.m., SĮUP III m.m. klasė ";9513501805;Ne;0;7;0;7
21245;"Vilniaus Verkių mokykla-daugiafunkcis centras";"SĮUP I m.m., SĮUP II m.m. klasė";4054448861;Ne;0;4;0;4
21246;"Vilniaus Verkių mokykla-daugiafunkcis centras";"SĮUP I m.m., SĮUP II m.m. klasė";4518835802;Ne;0;6;0;6
21247;"Vilniaus Verkių mokykla-daugiafunkcis centras";"SĮUP I m.m., SĮUP II m.m. klasė";9666721487;Ne;0;10;0;10
21248;"Vilniaus Verkių mokykla-daugiafunkcis centras";"SĮUP I m.m., SĮUP II m.m. klasė";6901885288;Ne;0;4;0;4
21249;"Vilniaus Verkių mokykla-daugiafunkcis centras";"SĮUP I m.m., SĮUP II m.m. klasė";7381890668;Ne;0;7;0;7
21250;"Vilniaus Verkių mokykla-daugiafunkcis centras";"SĮUP I m.m., SĮUP II m.m. klasė";8495267789;Ne;0;8;0;8
21251;"Vilniaus Verkių mokykla-daugiafunkcis centras";"SĮUP I m.m., SĮUP II m.m. klasė";2714397701;Ne;0;4;0;4
21252;"Vilniaus Verkių mokykla-daugiafunkcis centras";"SĮUP I m.m., SĮUP II m.m., SĮUP III m.m. klasė ";7188084483;Ne;0;4;0;4
21253;"Vilniaus Verkių mokykla-daugiafunkcis centras";"SĮUP I m.m., SĮUP II m.m., SĮUP III m.m. klasė ";9963369886;Ne;0;4;0;4
21254;"Vilniaus Verkių mokykla-daugiafunkcis centras";"SĮUP I m.m., SĮUP II m.m., SĮUP III m.m. klasė ";2608900779;Ne;0;4;0;4
21255;"Vilniaus Verkių mokykla-daugiafunkcis centras";"SĮUP I m.m., SĮUP II m.m., SĮUP III m.m. klasė ";4901307502;Ne;0;9;0;9
21256;"Vilniaus Verkių mokykla-daugiafunkcis centras";"SĮUP I m.m., SĮUP II m.m., SĮUP III m.m. klasė ";7821183996;Ne;0;14;0;14
21257;"Vilniaus Verkių mokykla-daugiafunkcis centras";"8S, 8SK, 9S, 9SK klasė";1368271218;Ne;0;7;0;7
21258;"Vilniaus Verkių mokykla-daugiafunkcis centras";"8S, 8SK, 9S, 9SK klasė";7819002176;Ne;0;5;0;5
21259;"Vilniaus Verkių mokykla-daugiafunkcis centras";"8S, 8SK, 9S, 9SK klasė";6396691531;Ne;0;21;0;21
21260;"Vilniaus Verkių mokykla-daugiafunkcis centras";"8S, 8SK, 9S, 9SK klasė";9420292538;Ne;0;4;0;4
21261;"Vilniaus Verkių mokykla-daugiafunkcis centras";"8S, 8SK, 9S, 9SK klasė";1937996951;Ne;0;4;0;4
21262;"Vilniaus Verkių mokykla-daugiafunkcis centras";"8S, 8SK, 9S, 9SK klasė";7689301739;Ne;0;6;0;6
21263;"Vilniaus Verkių mokykla-daugiafunkcis centras";"8S, 8SK, 9S, 9SK klasė";8199430682;Ne;0;4;0;4
21264;Gluosnis;KIŠKUČIAI;8689557248;Ne;0;3;1;4
21265;Gluosnis;KIŠKUČIAI;6955695422;Ne;0;5;2;7
21266;Gluosnis;KIŠKUČIAI;1305651237;Ne;5;0;0;5
21267;Gluosnis;KIŠKUČIAI;4285562600;Ne;10;3;0;13
21268;Gluosnis;KIŠKUČIAI;5432102004;Ne;8;0;1;9
21269;Gluosnis;KIŠKUČIAI;8009719622;Ne;15;0;0;15
21270;Gluosnis;KIŠKUČIAI;9833971809;Ne;8;0;0;8
21271;Gluosnis;KIŠKUČIAI;6883663577;Ne;0;4;0;4
21272;Gluosnis;KIŠKUČIAI;1512855055;Ne;0;0;9;9
21273;Gluosnis;KIŠKUČIAI;8337313448;Ne;3;0;0;3
21274;Gluosnis;KIŠKUČIAI;4632419177;Ne;15;0;0;15
21275;Gluosnis;KIŠKUČIAI;7769522093;Ne;10;0;1;11
21276;Gluosnis;KIŠKUČIAI;8928597187;Ne;0;0;2;2
21277;Gluosnis;KIŠKUČIAI;9993638596;Ne;0;7;2;9
21278;Gluosnis;KIŠKUČIAI;6994005000;Ne;6;0;0;6
21279;Gluosnis;KIŠKUČIAI;9221983318;Ne;5;0;5;10
21280;Gluosnis;KIŠKUČIAI;2187312618;Ne;7;0;4;11
21281;Gluosnis;KIŠKUČIAI;5664156894;Ne;5;0;0;5
21282;Gluosnis;KIŠKUČIAI;7073637619;Ne;3;0;0;3
21283;Gluosnis;KIŠKUČIAI;1391404073;Ne;3;0;2;5
21284;Gluosnis;KIŠKUČIAI;4591550636;Ne;6;5;2;13
21285;Gluosnis;EŽIUKAI;4153713911;Ne;0;1;1;2
21286;Gluosnis;EŽIUKAI;4493877427;Ne;5;0;0;5
21287;Gluosnis;EŽIUKAI;5350702449;Ne;7;0;0;7
21288;Gluosnis;EŽIUKAI;6622415563;Ne;0;2;0;2
21289;Gluosnis;EŽIUKAI;9788278155;Ne;0;2;2;4
21290;Gluosnis;EŽIUKAI;7526020668;Ne;0;5;1;6
21291;Gluosnis;EŽIUKAI;5522411084;Ne;0;4;1;5
21292;Gluosnis;EŽIUKAI;5392759654;Ne;2;0;0;2
21293;Gluosnis;EŽIUKAI;6681653921;Ne;0;6;0;6
21294;Gluosnis;EŽIUKAI;4902627153;Ne;0;0;6;6
21295;Gluosnis;EŽIUKAI;2525780494;Ne;8;5;0;13
21296;Gluosnis;EŽIUKAI;9389736360;Ne;5;1;6;12
21297;Gluosnis;EŽIUKAI;2707855273;Ne;0;2;0;2
21298;Gluosnis;EŽIUKAI;7523459118;Ne;4;0;2;6
21299;Gluosnis;EŽIUKAI;2794163383;Ne;6;0;2;8
21300;Gluosnis;EŽIUKAI;7264550578;Ne;0;4;7;11
21301;Gluosnis;EŽIUKAI;5368171142;Ne;0;8;0;8
21302;Gluosnis;EŽIUKAI;6754799196;Ne;2;0;0;2
21303;Gluosnis;EŽIUKAI;9888037899;Ne;8;0;3;11
21304;Gluosnis;MEŠKIUKAI;8981904827;Ne;15;0;0;15
21305;Gluosnis;MEŠKIUKAI;8998776286;Ne;2;1;0;3
21306;Gluosnis;MEŠKIUKAI;1846499141;Ne;14;0;2;16
21307;Gluosnis;MEŠKIUKAI;7935750427;Ne;6;0;1;7
21308;Gluosnis;MEŠKIUKAI;4905002832;Ne;10;0;0;10
21309;Gluosnis;MEŠKIUKAI;9102081648;Ne;7;0;1;8
21310;Gluosnis;MEŠKIUKAI;4498429439;Ne;8;0;1;9
21311;Gluosnis;MEŠKIUKAI;8259160584;Ne;0;2;4;6
21312;Gluosnis;MEŠKIUKAI;1235091885;Ne;8;8;0;16
21313;Gluosnis;MEŠKIUKAI;1165636758;Ne;6;0;0;6
21314;Gluosnis;MEŠKIUKAI;8499748544;Ne;0;2;0;2
21315;Gluosnis;MEŠKIUKAI;9699577397;Ne;8;0;0;8
21316;Gluosnis;MEŠKIUKAI;4107344313;Ne;0;0;2;2
21317;Gluosnis;MEŠKIUKAI;1101472999;Ne;0;1;1;2
21318;Gluosnis;MEŠKIUKAI;7995558671;Ne;0;8;0;8
21319;Gluosnis;MEŠKIUKAI;1602556462;Ne;6;0;0;6
21320;Gluosnis;MEŠKIUKAI;8842139496;Ne;9;0;0;9
21321;Gluosnis;MEŠKIUKAI;4060859156;Ne;0;1;0;1
21322;Gluosnis;MEŠKIUKAI;6428753580;Ne;9;0;2;11
21323;Gluosnis;MEŠKIUKAI;3323237449;Ne;2;2;0;4
21324;Gluosnis;MEŠKIUKAI;6246512101;Ne;5;0;0;5
21325;Gluosnis;MEŠKIUKAI;3038732180;Ne;21;0;0;21
21326;Gluosnis;MEŠKIUKAI;1712795835;Ne;0;6;0;6
21327;Gluosnis;BORUŽĖLĖS;8840658383;Ne;7;0;0;7
21328;Gluosnis;BORUŽĖLĖS;1102935178;Ne;0;0;3;3
21329;Gluosnis;BORUŽĖLĖS;2167312808;Ne;5;0;0;5
21330;Gluosnis;BORUŽĖLĖS;4204797742;Ne;0;10;0;10
21331;Gluosnis;BORUŽĖLĖS;6302765948;Ne;0;0;2;2
21332;Gluosnis;BORUŽĖLĖS;9938235476;Ne;0;1;0;1
21333;Gluosnis;BORUŽĖLĖS;2945796648;Ne;5;0;0;5
21334;Gluosnis;BORUŽĖLĖS;2173191971;Ne;5;0;1;6
21335;Gluosnis;BORUŽĖLĖS;4237053702;Ne;13;0;0;13
21336;Gluosnis;BORUŽĖLĖS;7731887361;Ne;4;0;0;4
21337;Gluosnis;BORUŽĖLĖS;8502947568;Ne;10;0;2;12
21338;Gluosnis;BORUŽĖLĖS;1335152703;Ne;2;5;0;7
21339;Gluosnis;BORUŽĖLĖS;1314992969;Ne;7;0;2;9
21340;Gluosnis;BORUŽĖLĖS;7833136455;Ne;9;0;0;9
21341;Gluosnis;BORUŽĖLĖS;5556821953;Ne;6;0;0;6
21342;Gluosnis;BORUŽĖLĖS;2515646510;Ne;2;0;1;3
21343;Gluosnis;BORUŽĖLĖS;3212658311;Ne;0;11;1;12
21344;Gluosnis;BORUŽĖLĖS;2603201633;Ne;0;1;9;10
21345;Gluosnis;BORUŽĖLĖS;6086258054;Ne;11;4;0;15
21346;Gluosnis;BORUŽĖLĖS;1351519995;Ne;2;6;0;8
21347;Gluosnis;BORUŽĖLĖS;6960673767;Ne;19;0;0;19
21348;Gluosnis;LAPIUKAI;7025815772;Ne;14;0;0;14
21349;Gluosnis;LAPIUKAI;5266206726;Ne;21;0;0;21
21350;Gluosnis;LAPIUKAI;2968946946;Ne;11;2;0;13
21351;Gluosnis;LAPIUKAI;8976032500;Ne;0;0;1;1
21352;Gluosnis;LAPIUKAI;3190331209;Ne;21;0;0;21
21353;Gluosnis;LAPIUKAI;5376108804;Ne;12;0;0;12
21354;Gluosnis;LAPIUKAI;9386396460;Ne;8;1;0;9
21355;Gluosnis;LAPIUKAI;1664508998;Ne;11;0;0;11
21356;Gluosnis;LAPIUKAI;1296975213;Ne;16;0;0;16
21357;Gluosnis;LAPIUKAI;8227732558;Ne;14;0;0;14
21358;Gluosnis;LAPIUKAI;6518579198;Ne;5;0;2;7
21359;Gluosnis;LAPIUKAI;5633386146;Ne;16;0;0;16
21360;Gluosnis;LAPIUKAI;4146877525;Ne;5;10;2;17
21361;Gluosnis;LAPIUKAI;4616132460;Ne;3;0;4;7
21362;Gluosnis;LAPIUKAI;4280829038;Ne;5;0;0;5
21363;Gluosnis;LAPIUKAI;7090336454;Ne;0;5;0;5
21364;Gluosnis;LAPIUKAI;2889837198;Ne;10;0;2;12
21365;Gluosnis;PELĖDŽIUKAI;1933496033;Ne;0;5;0;5
21366;Gluosnis;PELĖDŽIUKAI;8259035822;Ne;0;6;2;8
21367;Gluosnis;PELĖDŽIUKAI;4960167173;Ne;0;2;0;2
21368;Gluosnis;PELĖDŽIUKAI;2181550091;Ne;4;0;2;6
21369;Gluosnis;PELĖDŽIUKAI;6163009686;Ne;0;6;0;6
21370;Gluosnis;PELĖDŽIUKAI;1671693932;Ne;0;4;2;6
21371;Gluosnis;PELĖDŽIUKAI;4005023841;Ne;2;4;4;10
21372;Gluosnis;PELĖDŽIUKAI;9497547057;Ne;4;0;0;4
21373;Gluosnis;PELĖDŽIUKAI;1298724775;Ne;0;0;1;1
21374;Gluosnis;PELĖDŽIUKAI;1185903576;Ne;0;0;2;2
21375;Gluosnis;PELĖDŽIUKAI;7537587118;Ne;0;2;3;5
21376;Gluosnis;PELĖDŽIUKAI;7075070566;Ne;0;3;0;3
21377;Gluosnis;PELĖDŽIUKAI;7761376910;Ne;0;1;1;2
21378;Gluosnis;PELĖDŽIUKAI;6944918504;Ne;12;1;0;13
21379;Gluosnis;PELĖDŽIUKAI;7842723958;Ne;0;5;0;5
21380;Gluosnis;PELĖDŽIUKAI;94487630173;Ne;9;0;0;9
21381;Gluosnis;PELĖDŽIUKAI;1076538028;Ne;0;5;0;5
21382;Gluosnis;VOVERIUKAI;6747244713;Ne;3;5;0;8
21383;Gluosnis;VOVERIUKAI;3900322680;Ne;11;0;0;11
21384;Gluosnis;VOVERIUKAI;2423433989;Ne;2;4;4;10
21385;Gluosnis;VOVERIUKAI;1263019496;Ne;12;4;0;16
21386;Gluosnis;VOVERIUKAI;4564193030;Ne;11;1;1;13
21387;Gluosnis;VOVERIUKAI;4224637208;Ne;11;0;1;12
21388;Gluosnis;VOVERIUKAI;1144177849;Ne;4;0;0;4
21389;Gluosnis;VOVERIUKAI;6729016081;Ne;0;6;3;9
21390;Gluosnis;VOVERIUKAI;6119618742;Ne;13;0;1;14
21391;Gluosnis;VOVERIUKAI;5623135790;Ne;13;0;0;13
21392;Gluosnis;VOVERIUKAI;2310874591;Ne;5;5;0;10
21393;Gluosnis;VOVERIUKAI;5210930032;Ne;2;0;2;4
21394;Gluosnis;VOVERIUKAI;5008836118;Ne;8;0;5;13
21395;Gluosnis;VOVERIUKAI;4361177196;Ne;9;0;8;17
21396;Gluosnis;VOVERIUKAI;9484423786;Ne;10;1;4;15
21397;Gluosnis;VOVERIUKAI;8109714321;Ne;13;0;0;13
21398;Gluosnis;DRUGELIAI;5949954525;Ne;2;0;0;2
21399;Gluosnis;DRUGELIAI;1716235604;Taip;0;4;0;4
21400;Gluosnis;DRUGELIAI;7642311375;Ne;2;7;0;9
21401;Gluosnis;DRUGELIAI;4125830926;Ne;0;11;0;11
21402;Gluosnis;DRUGELIAI;6358187113;Ne;6;0;1;7
21403;Gluosnis;DRUGELIAI;4940563623;Ne;2;0;4;6
21404;Gluosnis;DRUGELIAI;1113731535;Ne;0;2;0;2
21405;Gluosnis;DRUGELIAI;4653963373;Ne;0;2;2;4
21406;Gluosnis;DRUGELIAI;2458662117;Ne;10;0;0;10
21407;Gluosnis;DRUGELIAI;4220504133;Ne;9;0;0;9
21408;Gluosnis;DRUGELIAI;9931766935;Ne;11;0;1;12
21409;Gluosnis;DRUGELIAI;3527418865;Ne;5;4;0;9
21410;Gluosnis;DRUGELIAI;6914171069;Ne;0;5;0;5
21411;Gluosnis;DRUGELIAI;1848647593;Ne;6;8;0;14
21412;Gluosnis;DRUGELIAI;5943955268;Ne;4;0;5;9
21413;Gluosnis;DRUGELIAI;8690911930;Ne;0;0;4;4
21414;Gluosnis;DRUGELIAI;1543842220;Ne;0;0;1;1
21415;Gluosnis;DRUGELIAI;1787206205;Ne;0;2;0;2
21416;Gluosnis;BITUTĖS;4176300773;Ne;11;0;0;11
21417;Gluosnis;BITUTĖS;2554790908;Ne;4;4;0;8
21418;Gluosnis;BITUTĖS;8281499182;Ne;11;0;2;13
21419;Gluosnis;BITUTĖS;2403029153;Ne;16;0;0;16
21420;Gluosnis;BITUTĖS;6432475763;Ne;5;4;0;9
21421;Gluosnis;BITUTĖS;9542889575;Ne;0;1;0;1
21422;Gluosnis;BITUTĖS;1966484574;Ne;0;6;2;8
21423;Gluosnis;BITUTĖS;5889360726;Ne;0;2;2;4
21424;Gluosnis;BITUTĖS;8035097045;Ne;16;0;0;16
21425;Gluosnis;BITUTĖS;3362089746;Ne;0;9;3;12
21426;Gluosnis;BITUTĖS;7390361159;Ne;6;0;1;7
21427;Gluosnis;BITUTĖS;8380310240;Ne;10;4;0;14
21428;Gluosnis;BITUTĖS;4481544177;Ne;0;0;5;5
21429;Gluosnis;BITUTĖS;3673702157;Ne;13;0;1;14
21430;Gluosnis;BITUTĖS;9098141563;Ne;13;0;0;13
21431;Gluosnis;BITUTĖS;9201769624;Ne;0;4;0;4
21432;Gluosnis;BITUTĖS;1306381382;Ne;10;0;0;10
21433;Gluosnis;BITUTĖS;6767500085;Ne;16;0;0;16
21434;Gluosnis;BITUTĖS;6001358241;Ne;6;0;2;8
21435;Gluosnis;BITUTĖS;5380755693;Ne;12;2;1;15
21436;Gluosnis;BITUTĖS;6197840105;Ne;12;2;0;14
21437;Gluosnis;BITUTĖS;5204445760;Ne;21;0;0;21
21438;"Vilniaus Saulėtekio mokykla-daugiafunkcinis centras";Priešmokyklinė;1029813471;Ne;0;4;0;4
21439;"Vilniaus Saulėtekio mokykla-daugiafunkcinis centras";Priešmokyklinė;8760467524;Ne;6;4;0;10
21440;"Vilniaus Saulėtekio mokykla-daugiafunkcinis centras";Priešmokyklinė;6738279023;Ne;0;19;0;19
21441;"Vilniaus Saulėtekio mokykla-daugiafunkcinis centras";Priešmokyklinė;1739797553;Ne;0;8;0;8
21442;"Vilniaus Saulėtekio mokykla-daugiafunkcinis centras";Priešmokyklinė;2159833613;Ne;5;4;0;9
21443;"Vilniaus Saulėtekio mokykla-daugiafunkcinis centras";Priešmokyklinė;1193336600;Ne;0;11;0;11
21444;"Vilniaus Saulėtekio mokykla-daugiafunkcinis centras";Priešmokyklinė;5914721966;Ne;0;4;0;4
21445;"Vilniaus Saulėtekio mokykla-daugiafunkcinis centras";Priešmokyklinė;8852228006;Ne;0;4;16;20
21446;"Vilniaus Saulėtekio mokykla-daugiafunkcinis centras";Priešmokyklinė;4159716896;Ne;0;4;2;6
21447;"Vilniaus Saulėtekio mokykla-daugiafunkcinis centras";Priešmokyklinė;1667714484;Ne;0;4;10;14
21448;"Vilniaus Saulėtekio mokykla-daugiafunkcinis centras";Priešmokyklinė;6589058061;Ne;0;4;3;7
21449;"Vilniaus Saulėtekio mokykla-daugiafunkcinis centras";Priešmokyklinė;3048310276;Ne;0;4;0;4
21450;"Vilniaus Saulėtekio mokykla-daugiafunkcinis centras";Priešmokyklinė;6991187086;Ne;0;4;4;8
21451;"Vilniaus Saulėtekio mokykla-daugiafunkcinis centras";Priešmokyklinė;1698381959;Ne;5;8;0;13
21452;"Vilniaus Saulėtekio mokykla-daugiafunkcinis centras";Priešmokyklinė;2500332755;Ne;0;4;0;4
21453;"Vilniaus Saulėtekio mokykla-daugiafunkcinis centras";Priešmokyklinė;2074102166;Ne;5;4;0;9
21454;"Vilniaus Saulėtekio mokykla-daugiafunkcinis centras";Priešmokyklinė;2906786855;Ne;0;4;0;4
21455;"Vilniaus Saulėtekio mokykla-daugiafunkcinis centras";Priešmokyklinė;3108520221;Ne;0;13;0;13
21456;"Vilniaus Saulėtekio mokykla-daugiafunkcinis centras";Priešmokyklinė;8815534200;Ne;9;4;0;13
21457;"Vilniaus Saulėtekio mokykla-daugiafunkcinis centras";Priešmokyklinė;4751570183;Ne;5;4;0;9
21458;"Vilniaus Saulėtekio mokykla-daugiafunkcinis centras";Priešmokyklinė;9164075226;Ne;0;7;0;7
21459;"Vilniaus Saulėtekio mokykla-daugiafunkcinis centras";Priešmokyklinė;2020364455;Ne;5;4;0;9
21460;"Vilniaus Saulėtekio mokykla-daugiafunkcinis centras";Priešmokyklinė;4787974814;Ne;0;4;5;9
21461;"Vilniaus Saulėtekio mokykla-daugiafunkcinis centras";Priešmokyklinė;6553762186;Ne;5;8;0;13
21462;"Vilniaus Saulėtekio mokykla-daugiafunkcinis centras";Priešmokyklinė;9057726203;Ne;2;6;0;8
21463;"Vilniaus Saulėtekio mokykla-daugiafunkcinis centras";Priešmokyklinė;6492909546;Ne;0;7;0;7
21464;"Vilniaus Saulėtekio mokykla-daugiafunkcinis centras";Priešmokyklinė;4937714337;Ne;0;4;4;8
21465;"Vilniaus Saulėtekio mokykla-daugiafunkcinis centras";Priešmokyklinė;3745251439;Ne;0;4;4;8
21466;"Vilniaus Saulėtekio mokykla-daugiafunkcinis centras";"PRIEŠMOKYKLINĖ 2";9963290362;Ne;0;4;6;10
21467;"Vilniaus Saulėtekio mokykla-daugiafunkcinis centras";"PRIEŠMOKYKLINĖ 2";1342094235;Ne;0;4;2;6
21468;"Vilniaus Saulėtekio mokykla-daugiafunkcinis centras";"PRIEŠMOKYKLINĖ 2";2628936055;Ne;16;5;0;21
21469;"Vilniaus Saulėtekio mokykla-daugiafunkcinis centras";"PRIEŠMOKYKLINĖ 2";1224648193;Ne;0;4;4;8
21470;"Vilniaus Saulėtekio mokykla-daugiafunkcinis centras";"PRIEŠMOKYKLINĖ 2";4542122478;Ne;0;4;1;5
21471;"Vilniaus Saulėtekio mokykla-daugiafunkcinis centras";"PRIEŠMOKYKLINĖ 2";4010917080;Ne;0;4;2;6
21472;"Vilniaus Saulėtekio mokykla-daugiafunkcinis centras";"PRIEŠMOKYKLINĖ 2";5927071864;Ne;0;4;1;5
21473;"Vilniaus Saulėtekio mokykla-daugiafunkcinis centras";"PRIEŠMOKYKLINĖ 2";4970499391;Ne;6;4;4;14
21474;"Vilniaus Saulėtekio mokykla-daugiafunkcinis centras";"PRIEŠMOKYKLINĖ 2";6593824471;Ne;13;4;2;19
21475;"Vilniaus Saulėtekio mokykla-daugiafunkcinis centras";"PRIEŠMOKYKLINĖ 2";8669346247;Ne;0;4;6;10
21476;"Vilniaus Saulėtekio mokykla-daugiafunkcinis centras";"PRIEŠMOKYKLINĖ 2";1924079984;Ne;0;4;1;5
21477;"Vilniaus Saulėtekio mokykla-daugiafunkcinis centras";"PRIEŠMOKYKLINĖ 2";5590376570;Ne;5;4;1;10
21478;"Vilniaus Saulėtekio mokykla-daugiafunkcinis centras";"PRIEŠMOKYKLINĖ 2";8766410254;Ne;4;4;1;9
21479;"Vilniaus Saulėtekio mokykla-daugiafunkcinis centras";"PRIEŠMOKYKLINĖ 2";4151582358;Ne;7;4;1;12
21480;"Vilniaus Saulėtekio mokykla-daugiafunkcinis centras";"PRIEŠMOKYKLINĖ 2";1376656872;Ne;0;4;4;8
21481;"Vilniaus Saulėtekio mokykla-daugiafunkcinis centras";"PRIEŠMOKYKLINĖ 2";3639632543;Ne;0;4;1;5
21482;"Vilniaus Saulėtekio mokykla-daugiafunkcinis centras";"PRIEŠMOKYKLINĖ 2";6865962441;Ne;0;4;1;5
21483;"Vilniaus Saulėtekio mokykla-daugiafunkcinis centras";"PRIEŠMOKYKLINĖ 2";3982877012;Ne;13;4;0;17
21484;"Vilniaus Saulėtekio mokykla-daugiafunkcinis centras";"PRIEŠMOKYKLINĖ 2";1660650556;Ne;12;9;0;21
21485;"Vilniaus Saulėtekio mokykla-daugiafunkcinis centras";"PRIEŠMOKYKLINĖ 2";4890393582;Ne;0;4;2;6
21486;"Vilniaus Saulėtekio mokykla-daugiafunkcinis centras";"PRIEŠMOKYKLINĖ 2";5304096806;Ne;7;4;2;13
21487;"Vilniaus Saulėtekio mokykla-daugiafunkcinis centras";"PRIEŠMOKYKLINĖ 2";1648983304;Ne;14;4;1;19
21488;"Vilniaus Saulėtekio mokykla-daugiafunkcinis centras";"PRIEŠMOKYKLINĖ 2";1913663230;Ne;0;8;1;9
21489;"Vilniaus Saulėtekio mokykla-daugiafunkcinis centras";"PRIEŠMOKYKLINĖ 2";1543123485;Ne;0;4;0;4
21490;"Vilniaus Saulėtekio mokykla-daugiafunkcinis centras";"PRIEŠMOKYKLINĖ 2";4176208765;Ne;0;16;0;16
21491;"Vilniaus Saulėtekio mokykla-daugiafunkcinis centras";"PRIEŠMOKYKLINĖ 2";8458361084;Ne;22;0;1;23
21492;"Vilniaus „Genio“ progimnazija";NYKŠTUKAI;6545116373;Ne;0;4;0;4
21493;"Vilniaus „Genio“ progimnazija";NYKŠTUKAI;1666616466;Ne;5;5;0;10
21494;"Vilniaus „Genio“ progimnazija";NYKŠTUKAI;3008272979;Ne;0;6;0;6
21495;"Vilniaus „Genio“ progimnazija";NYKŠTUKAI;96416364735;Ne;0;4;0;4
21496;"Vilniaus „Genio“ progimnazija";NYKŠTUKAI;2036966277;Ne;0;4;0;4
21497;"Vilniaus „Genio“ progimnazija";NYKŠTUKAI;1807466584;Ne;0;7;0;7
21498;"Vilniaus „Genio“ progimnazija";NYKŠTUKAI;4680264973;Ne;0;6;0;6
21499;"Vilniaus „Genio“ progimnazija";NYKŠTUKAI;5850506831;Ne;0;4;0;4
21500;"Vilniaus „Genio“ progimnazija";NYKŠTUKAI;3667800006;Ne;0;4;0;4
21501;"Vilniaus „Genio“ progimnazija";NYKŠTUKAI;2176438968;Ne;0;5;0;5
21502;"Vilniaus „Genio“ progimnazija";NYKŠTUKAI;7509276953;Ne;0;4;0;4
21503;"Vilniaus „Genio“ progimnazija";NYKŠTUKAI;1258769646;Ne;0;4;0;4
21504;"Vilniaus „Genio“ progimnazija";NYKŠTUKAI;2593226897;Ne;4;6;0;10
21505;"Vilniaus „Genio“ progimnazija";NYKŠTUKAI;7005815238;Ne;0;4;0;4
21506;"Vilniaus „Genio“ progimnazija";NYKŠTUKAI;3333552585;Ne;5;4;0;9
21507;"Vilniaus „Genio“ progimnazija";NYKŠTUKAI;5372809413;Ne;0;4;0;4
21508;"Vilniaus „Genio“ progimnazija";NYKŠTUKAI;1089753966;Ne;0;8;0;8
21509;"Vilniaus „Genio“ progimnazija";NYKŠTUKAI;6154837614;Ne;8;4;0;12
21510;"Vilniaus „Genio“ progimnazija";NYKŠTUKAI;2865995680;Ne;0;4;0;4
21511;"Vilniaus „Genio“ progimnazija";NYKŠTUKAI;1432694920;Ne;0;4;0;4
21512;"Vilniaus „Genio“ progimnazija";NYKŠTUKAI;1663216529;Ne;0;4;0;4
21513;"Gintarėlis (Popieriaus g. 46A)";SKRUZDĖLIUKAI;6162836315;Ne;0;2;0;2
21514;"Gintarėlis (Popieriaus g. 46A)";SKRUZDĖLIUKAI;5738933125;Ne;0;9;0;9
21515;"Gintarėlis (Popieriaus g. 46A)";SKRUZDĖLIUKAI;1994856959;Ne;5;0;0;5
21516;"Gintarėlis (Popieriaus g. 46A)";SKRUZDĖLIUKAI;8223747534;Ne;0;1;0;1
21517;"Gintarėlis (Popieriaus g. 46A)";SKRUZDĖLIUKAI;1045355492;Ne;12;4;0;16
21518;"Gintarėlis (Popieriaus g. 46A)";SKRUZDĖLIUKAI;6193540660;Ne;9;2;0;11
21519;"Gintarėlis (Popieriaus g. 46A)";SKRUZDĖLIUKAI;7510541192;Ne;0;3;0;3
21520;"Gintarėlis (Popieriaus g. 46A)";SKRUZDĖLIUKAI;9045108717;Ne;6;11;4;21
21521;"Gintarėlis (Popieriaus g. 46A)";SKRUZDĖLIUKAI;1955719034;Ne;0;6;4;10
21522;"Gintarėlis (Popieriaus g. 46A)";SKRUZDĖLIUKAI;1215549844;Ne;6;0;0;6
21523;"Gintarėlis (Popieriaus g. 46A)";SKRUZDĖLIUKAI;5379858630;Ne;0;0;10;10
21524;"Gintarėlis (Popieriaus g. 46A)";SKRUZDĖLIUKAI;5961603860;Ne;6;7;0;13
21525;"Gintarėlis (Popieriaus g. 46A)";SKRUZDĖLIUKAI;8068499156;Ne;0;6;0;6
21526;"Gintarėlis (Popieriaus g. 46A)";SKRUZDĖLIUKAI;5190355636;Ne;4;0;0;4
21527;"Gintarėlis (Popieriaus g. 46A)";SKRUZDĖLIUKAI;4290033336;Ne;0;7;0;7
21528;"Gintarėlis (Popieriaus g. 46A)";PELĖDŽIUKAI;6506180216;Ne;5;6;0;11
21529;"Gintarėlis (Popieriaus g. 46A)";PELĖDŽIUKAI;9200073539;Ne;1;2;0;3
21530;"Gintarėlis (Popieriaus g. 46A)";PELĖDŽIUKAI;3254739432;Ne;0;0;3;3
21531;"Gintarėlis (Popieriaus g. 46A)";PELĖDŽIUKAI;8019543081;Ne;8;0;0;8
21532;"Gintarėlis (Popieriaus g. 46A)";PELĖDŽIUKAI;1628276472;Ne;0;6;0;6
21533;"Gintarėlis (Popieriaus g. 46A)";PELĖDŽIUKAI;8792175474;Ne;15;1;0;16
21534;"Gintarėlis (Popieriaus g. 46A)";PELĖDŽIUKAI;3304191482;Ne;0;1;0;1
21535;"Gintarėlis (Popieriaus g. 46A)";PELĖDŽIUKAI;2731865977;Ne;0;2;0;2
21536;"Gintarėlis (Popieriaus g. 46A)";PELĖDŽIUKAI;4181430769;Ne;0;11;0;11
21537;"Gintarėlis (Popieriaus g. 46A)";PELĖDŽIUKAI;3202819190;Ne;0;0;6;6
21538;"Gintarėlis (Popieriaus g. 46A)";PELĖDŽIUKAI;9807784148;Ne;5;2;0;7
21539;"Gintarėlis (Popieriaus g. 46A)";PELĖDŽIUKAI;2546360134;Ne;0;1;0;1
21540;"Gintarėlis (Popieriaus g. 46A)";PELĖDŽIUKAI;6883573289;Ne;10;0;4;14
21541;"Gintarėlis (Popieriaus g. 46A)";PELĖDŽIUKAI;3127881266;Ne;12;3;0;15
21542;"Gintarėlis (Popieriaus g. 46A)";PELĖDŽIUKAI;2052962147;Ne;0;0;7;7
21543;"Gintarėlis (Popieriaus g. 46A)";PELĖDŽIUKAI;8677500463;Ne;0;0;1;1
21544;"Gintarėlis (Popieriaus g. 46A)";PELĖDŽIUKAI;7031945895;Ne;0;6;0;6
21545;"Gintarėlis (Popieriaus g. 46A)";"LINKSMASIS AVILYS";7872515649;Ne;0;13;0;13
21546;"Gintarėlis (Popieriaus g. 46A)";"LINKSMASIS AVILYS";7256557310;Ne;0;8;0;8
21547;"Gintarėlis (Popieriaus g. 46A)";"LINKSMASIS AVILYS";6425840559;Ne;0;2;4;6
21548;"Gintarėlis (Popieriaus g. 46A)";"LINKSMASIS AVILYS";3572188688;Ne;0;4;2;6
21549;"Gintarėlis (Popieriaus g. 46A)";"LINKSMASIS AVILYS";7010430969;Ne;0;3;0;3
21550;"Gintarėlis (Popieriaus g. 46A)";"LINKSMASIS AVILYS";1070119148;Ne;0;6;0;6
21551;"Gintarėlis (Popieriaus g. 46A)";"LINKSMASIS AVILYS";3738678648;Ne;0;3;0;3
21552;"Gintarėlis (Popieriaus g. 46A)";"LINKSMASIS AVILYS";77906464117;Ne;0;3;0;3
21553;"Gintarėlis (Popieriaus g. 46A)";"LINKSMASIS AVILYS";8680339493;Ne;16;0;0;16
21554;"Gintarėlis (Popieriaus g. 46A)";"LINKSMASIS AVILYS";5223116373;Ne;13;0;0;13
21555;"Gintarėlis (Popieriaus g. 46A)";Varliukai;6821929306;Ne;0;16;0;16
21556;"Gintarėlis (Popieriaus g. 46A)";Varliukai;7274616480;Ne;0;1;0;1
21557;"Gintarėlis (Popieriaus g. 46A)";Varliukai;1362980885;Ne;0;11;0;11
21558;"Gintarėlis (Popieriaus g. 46A)";Varliukai;9762364250;Ne;0;4;0;4
21559;"Gintarėlis (Popieriaus g. 46A)";Varliukai;6849227110;Ne;0;0;2;2
21560;"Gintarėlis (Popieriaus g. 46A)";Varliukai;4263315669;Ne;18;0;0;18
21561;"Gintarėlis (Popieriaus g. 46A)";Varliukai;7206593645;Ne;0;0;3;3
21562;"Gintarėlis (Popieriaus g. 46A)";Varliukai;7400455090;Ne;0;12;0;12
21563;"Gintarėlis (Popieriaus g. 46A)";Varliukai;3702588434;Ne;0;0;5;5
21564;"Gintarėlis (Popieriaus g. 46A)";Varliukai;7413074674;Ne;0;1;3;4
21565;"Gintarėlis (Popieriaus g. 46A)";Varliukai;6514247750;Ne;0;1;0;1
21566;"Gintarėlis (Popieriaus g. 46A)";Varliukai;1166720069;Ne;0;1;0;1
21567;"Gintarėlis (Popieriaus g. 46A)";Varliukai;4556644354;Ne;15;1;0;16
21568;"Gintarėlis (Popieriaus g. 46A)";Varliukai;7510641510;Ne;0;1;1;2
21569;"Gintarėlis (Popieriaus g. 46A)";Varliukai;6534072038;Ne;15;0;3;18
21570;"Gintarėlis (Popieriaus g. 46A)";Varliukai;5478441530;Ne;5;4;2;11
21571;"Gintarėlis (Popieriaus g. 46A)";Varliukai;5771196440;Ne;6;0;0;6
21572;"Gintarėlis (Popieriaus g. 46A)";Varliukai;7783860076;Ne;6;1;0;7
21573;"Pušynėlis (A. Mickevičiaus g. 21)";DAIGIUKAI;5317547220;Ne;0;0;1;1
21574;"Pušynėlis (A. Mickevičiaus g. 21)";DAIGIUKAI;9025539389;Ne;12;0;3;15
21575;"Pušynėlis (A. Mickevičiaus g. 21)";DAIGIUKAI;5512586591;Ne;19;0;2;21
21576;"Pušynėlis (A. Mickevičiaus g. 21)";DAIGIUKAI;6594473055;Ne;5;2;1;8
21577;"Pušynėlis (A. Mickevičiaus g. 21)";DAIGIUKAI;8211464695;Ne;6;0;0;6
21578;"Pušynėlis (A. Mickevičiaus g. 21)";DAIGIUKAI;6321178561;Ne;7;0;0;7
21579;"Pušynėlis (A. Mickevičiaus g. 21)";DAIGIUKAI;6606436348;Ne;0;8;1;9
21580;"Pušynėlis (A. Mickevičiaus g. 21)";DAIGIUKAI;8457384507;Ne;0;3;1;4
21581;"Pušynėlis (A. Mickevičiaus g. 21)";DAIGIUKAI;1085678424;Ne;12;0;0;12
21582;"Pušynėlis (A. Mickevičiaus g. 21)";DAIGIUKAI;9710499937;Ne;2;10;0;12
21583;"Pušynėlis (A. Mickevičiaus g. 21)";DAIGIUKAI;9717473430;Ne;0;2;0;2
21584;"Pušynėlis (A. Mickevičiaus g. 21)";DAIGIUKAI;2763762463;Ne;9;0;0;9
21585;"Pušynėlis (A. Mickevičiaus g. 21)";DAIGIUKAI;8268273217;Ne;11;1;0;12
21586;"Pušynėlis (A. Mickevičiaus g. 21)";DAIGIUKAI;6573189496;Ne;2;6;0;8
21587;"Pušynėlis (A. Mickevičiaus g. 21)";DAIGIUKAI;9835049161;Ne;0;4;2;6
21588;"Pušynėlis (A. Mickevičiaus g. 21)";NYKŠTUKAI;1050710006;Ne;0;2;0;2
21589;"Pušynėlis (A. Mickevičiaus g. 21)";NYKŠTUKAI;1758632291;Ne;0;1;0;1
21590;"Pušynėlis (A. Mickevičiaus g. 21)";NYKŠTUKAI;8699085292;Ne;15;0;0;15
21591;"Pušynėlis (A. Mickevičiaus g. 21)";NYKŠTUKAI;8327830781;Ne;3;2;0;5
21592;"Pušynėlis (A. Mickevičiaus g. 21)";NYKŠTUKAI;8820865805;Ne;0;20;1;21
21593;"Pušynėlis (A. Mickevičiaus g. 21)";NYKŠTUKAI;9520423020;Ne;5;12;4;21
21594;"Pušynėlis (A. Mickevičiaus g. 21)";NYKŠTUKAI;1177938753;Ne;0;6;0;6
21595;"Pušynėlis (A. Mickevičiaus g. 21)";NYKŠTUKAI;9450347140;Ne;6;6;0;12
21596;"Pušynėlis (A. Mickevičiaus g. 21)";NYKŠTUKAI;2222790161;Ne;0;6;1;7
21597;"Pušynėlis (A. Mickevičiaus g. 21)";NYKŠTUKAI;7596876368;Taip;1;2;2;5
21598;"Pušynėlis (A. Mickevičiaus g. 21)";NYKŠTUKAI;7429853563;Ne;10;4;0;14
21599;"Pušynėlis (A. Mickevičiaus g. 21)";NYKŠTUKAI;8464672994;Ne;9;2;0;11
21600;"Pušynėlis (A. Mickevičiaus g. 21)";NYKŠTUKAI;1904434730;Ne;10;0;1;11
21601;"Pušynėlis (A. Mickevičiaus g. 21)";NYKŠTUKAI;5364537212;Ne;11;6;0;17
21602;"Pušynėlis (A. Mickevičiaus g. 21)";NYKŠTUKAI;7172604103;Ne;0;0;4;4
21603;"Pušynėlis (A. Mickevičiaus g. 21)";NYKŠTUKAI;8839614928;Ne;0;8;0;8
21604;"Pušynėlis (A. Mickevičiaus g. 21)";NYKŠTUKAI;8512699165;Ne;7;5;4;16
21605;"Pušynėlis (A. Mickevičiaus g. 21)";GILIUKAI;9401101407;Ne;0;8;0;8
21606;"Pušynėlis (A. Mickevičiaus g. 21)";GILIUKAI;4997004998;Ne;10;0;5;15
21607;"Pušynėlis (A. Mickevičiaus g. 21)";GILIUKAI;9517319856;Ne;8;2;8;18
21608;"Pušynėlis (A. Mickevičiaus g. 21)";GILIUKAI;9028515427;Ne;0;0;2;2
21609;"Pušynėlis (A. Mickevičiaus g. 21)";GILIUKAI;2825756894;Ne;21;0;0;21
21610;"Pušynėlis (A. Mickevičiaus g. 21)";GILIUKAI;1134325833;Ne;0;2;1;3
21611;"Pušynėlis (A. Mickevičiaus g. 21)";GILIUKAI;3158789663;Ne;0;2;2;4
21612;"Pušynėlis (A. Mickevičiaus g. 21)";GILIUKAI;5668765825;Ne;5;2;9;16
21613;"Pušynėlis (A. Mickevičiaus g. 21)";GILIUKAI;3954867816;Ne;0;1;3;4
21614;"Pušynėlis (A. Mickevičiaus g. 21)";GILIUKAI;7685809238;Ne;7;2;5;14
21615;"Pušynėlis (A. Mickevičiaus g. 21)";GILIUKAI;2712755125;Taip;5;0;0;5
21616;"Pušynėlis (A. Mickevičiaus g. 21)";GILIUKAI;7011836009;Ne;11;0;0;11
21617;"Pušynėlis (A. Mickevičiaus g. 21)";GILIUKAI;3301741162;Ne;7;0;0;7
21618;"Pušynėlis (A. Mickevičiaus g. 21)";GILIUKAI;6735037523;Ne;10;2;0;12
21619;"Pušynėlis (A. Mickevičiaus g. 21)";GILIUKAI;9147558926;Ne;0;1;0;1
21620;"Pušynėlis (A. Mickevičiaus g. 21)";GILIUKAI;7881263225;Ne;10;0;0;10
21621;"Pušynėlis (A. Mickevičiaus g. 21)";GILIUKAI;1612049897;Ne;5;0;0;5
21622;"Pušynėlis (A. Mickevičiaus g. 21)";GILIUKAI;4898147530;Ne;3;6;0;9
21623;"Pušynėlis (A. Mickevičiaus g. 21)";GILIUKAI;2228682366;Ne;2;9;0;11
21624;"Pušynėlis (A. Mickevičiaus g. 21)";GILIUKAI;4464615995;Ne;0;0;1;1
21625;"Naminukas (Klinikų g. 5)";VARPELIAI;2089455192;Ne;5;0;0;5
21626;"Naminukas (Klinikų g. 5)";VARPELIAI;3281707263;Ne;0;0;2;2
21627;"Naminukas (Klinikų g. 5)";VARPELIAI;3683089217;Ne;6;0;0;6
21628;"Naminukas (Klinikų g. 5)";VARPELIAI;1828220049;Ne;8;1;0;9
21629;"Naminukas (Klinikų g. 5)";VARPELIAI;7328682222;Ne;4;0;4;8
21630;"Naminukas (Klinikų g. 5)";VARPELIAI;7772300667;Ne;2;0;0;2
21631;"Naminukas (Klinikų g. 5)";VARPELIAI;1086919259;Ne;5;0;4;9
21632;"Naminukas (Klinikų g. 5)";VARPELIAI;3497829075;Ne;5;0;0;5
21633;"Naminukas (Klinikų g. 5)";VARPELIAI;3938225198;Ne;3;0;0;3
21634;"Naminukas (Klinikų g. 5)";VARPELIAI;5991261279;Ne;0;0;6;6
21635;"Naminukas (Klinikų g. 5)";VARPELIAI;2576516583;Ne;14;0;0;14
21636;"Naminukas (Klinikų g. 5)";VARPELIAI;8694425584;Ne;0;0;7;7
21637;"Naminukas (Klinikų g. 5)";VARPELIAI;8782832803;Ne;0;3;0;3
21638;"Naminukas (Klinikų g. 5)";VARPELIAI;5172385044;Ne;7;0;1;8
21639;"Naminukas (Klinikų g. 5)";VARPELIAI;5465843371;Ne;10;0;0;10
21640;"Naminukas (Klinikų g. 5)";VARPELIAI;6515021073;Ne;0;0;16;16
21641;"Naminukas (Klinikų g. 5)";VARPELIAI;9894306360;Ne;16;0;0;16
21642;"Naminukas (Klinikų g. 5)";SAULUTĖS;9212800864;Ne;0;5;0;5
21643;"Naminukas (Klinikų g. 5)";SAULUTĖS;9215327479;Ne;11;0;0;11
21644;"Naminukas (Klinikų g. 5)";SAULUTĖS;8595804874;Ne;0;0;5;5
21645;"Naminukas (Klinikų g. 5)";SAULUTĖS;7947598191;Ne;0;0;2;2
21646;"Naminukas (Klinikų g. 5)";SAULUTĖS;3911352454;Ne;7;0;4;11
21647;"Naminukas (Klinikų g. 5)";SAULUTĖS;7107337857;Ne;15;4;2;21
21648;"Naminukas (Klinikų g. 5)";SAULUTĖS;3079900548;Ne;0;0;21;21
21649;"Naminukas (Klinikų g. 5)";SAULUTĖS;7301768930;Ne;0;0;1;1
21650;"Naminukas (Klinikų g. 5)";SAULUTĖS;2516513740;Ne;0;5;0;5
21651;"Naminukas (Klinikų g. 5)";SAULUTĖS;2336627398;Ne;0;0;1;1
21652;"Naminukas (Klinikų g. 5)";SAULUTĖS;1879925655;Ne;0;1;1;2
21653;"Naminukas (Klinikų g. 5)";SAULUTĖS;2881576194;Ne;0;0;8;8
21654;"Naminukas (Klinikų g. 5)";SAULUTĖS;4836599508;Ne;0;0;4;4
21655;"Naminukas (Klinikų g. 5)";SAULUTĖS;1563213488;Ne;0;0;1;1
21656;"Naminukas (Klinikų g. 5)";SAULUTĖS;4709625816;Ne;0;4;1;5
21657;"Naminukas (Klinikų g. 5)";SAULUTĖS;6471277755;Ne;0;0;1;1
21658;"Naminukas (Klinikų g. 5)";SAULUTĖS;1932169696;Ne;17;0;1;18
21659;"Naminukas (Klinikų g. 5)";DRUGELIAI;2339599448;Ne;0;8;0;8
21660;"Naminukas (Klinikų g. 5)";DRUGELIAI;4077985773;Ne;5;0;5;10
21661;"Naminukas (Klinikų g. 5)";DRUGELIAI;3276656641;Ne;0;0;7;7
21662;"Naminukas (Klinikų g. 5)";DRUGELIAI;6633031473;Ne;0;0;1;1
21663;"Naminukas (Klinikų g. 5)";DRUGELIAI;4116151797;Ne;0;0;2;2
21664;"Naminukas (Klinikų g. 5)";DRUGELIAI;7033053271;Ne;4;6;0;10
21665;"Naminukas (Klinikų g. 5)";DRUGELIAI;1454039572;Ne;0;5;0;5
21666;"Naminukas (Klinikų g. 5)";DRUGELIAI;9740815635;Ne;5;0;0;5
21667;"Naminukas (Klinikų g. 5)";DRUGELIAI;7184471307;Ne;0;1;2;3
21668;"Naminukas (Klinikų g. 5)";DRUGELIAI;6949857110;Ne;5;0;4;9
21669;"Naminukas (Klinikų g. 5)";DRUGELIAI;8039086094;Ne;1;0;4;5
21670;"Naminukas (Klinikų g. 5)";DRUGELIAI;8432194383;Ne;0;4;0;4
21671;"Naminukas (Klinikų g. 5)";DRUGELIAI;7463647806;Ne;0;0;6;6
21672;"Naminukas (Klinikų g. 5)";DRUGELIAI;4171789569;Ne;0;3;0;3
21673;"Naminukas (Klinikų g. 5)";DRUGELIAI;6880075874;Ne;2;1;0;3
21674;"Naminukas (Klinikų g. 5)";DRUGELIAI;8793327541;Ne;0;1;0;1
21675;"Naminukas (Klinikų g. 5)";DRUGELIAI;9835701381;Ne;0;0;1;1
21676;"Naminukas (Klinikų g. 5)";DRUGELIAI;2004615252;Ne;0;6;0;6
21677;"Naminukas (Klinikų g. 5)";BITUTĖS;21152690883;Ne;5;6;0;11
21678;"Naminukas (Klinikų g. 5)";BITUTĖS;1679106754;Ne;0;5;0;5
21679;"Naminukas (Klinikų g. 5)";BITUTĖS;1528496272;Ne;0;4;0;4
21680;"Naminukas (Klinikų g. 5)";BITUTĖS;92417802345;Ne;1;0;0;1
21681;"Naminukas (Klinikų g. 5)";BITUTĖS;1424288192;Ne;0;0;5;5
21682;"Naminukas (Klinikų g. 5)";BITUTĖS;1180176295;Ne;1;5;0;6
21683;"Naminukas (Klinikų g. 5)";BITUTĖS;9903990297;Ne;0;1;1;2
21684;"Naminukas (Klinikų g. 5)";BITUTĖS;6592057292;Ne;15;4;0;19
21685;"Naminukas (Klinikų g. 5)";BITUTĖS;5578151523;Ne;0;0;3;3
21686;"Naminukas (Klinikų g. 5)";BITUTĖS;4353031174;Ne;0;1;1;2
21687;"Naminukas (Klinikų g. 5)";BITUTĖS;9244494109;Ne;0;4;0;4
21688;"Naminukas (Klinikų g. 5)";BITUTĖS;8923393066;Ne;0;4;0;4
21689;"Naminukas (Klinikų g. 5)";BITUTĖS;9178907705;Ne;0;1;3;4
21690;"Naminukas (Klinikų g. 5)";BITUTĖS;2234877411;Ne;0;1;0;1
21691;"Naminukas (Klinikų g. 5)";BITUTĖS;5288557629;Ne;4;1;0;5
21692;"Naminukas (Klinikų g. 5)";BITUTĖS;1346035733;Ne;0;3;0;3
21693;"Naminukas (Klinikų g. 5)";BITUTĖS;1730248631;Ne;0;2;1;3
21694;"Naminukas (Klinikų g. 5)";BITUTĖS;3791118736;Ne;0;0;10;10
21695;"Naminukas (Klinikų g. 5)";BITUTĖS;7099787230;Ne;11;0;5;16
21696;"Naminukas (Klinikų g. 5)";BITUTĖS;3088386659;Ne;0;1;0;1
21697;"Gervelė (Stadiono g. 5)";BORUŽĖLĖS;6427072260;Ne;4;0;0;4
21698;"Gervelė (Stadiono g. 5)";BORUŽĖLĖS;9777308731;Ne;4;0;0;4
21699;"Gervelė (Stadiono g. 5)";BORUŽĖLĖS;2622183564;Ne;5;9;0;14
21700;"Gervelė (Stadiono g. 5)";BORUŽĖLĖS;1006720360;Ne;5;0;4;9
21701;"Gervelė (Stadiono g. 5)";BORUŽĖLĖS;8190190100;Ne;5;0;0;5
21702;"Gervelė (Stadiono g. 5)";BORUŽĖLĖS;6338612770;Ne;5;0;1;6
21703;"Gervelė (Stadiono g. 5)";BORUŽĖLĖS;6004269553;Ne;21;0;0;21
21704;"Gervelė (Stadiono g. 5)";BORUŽĖLĖS;2770635568;Ne;0;0;1;1
21705;"Gervelė (Stadiono g. 5)";BORUŽĖLĖS;6573919007;Ne;0;3;0;3
21706;"Gervelė (Stadiono g. 5)";BORUŽĖLĖS;8797608822;Ne;13;0;3;16
21707;"Gervelė (Stadiono g. 5)";PAUKŠTELIAI;2031118410;Ne;0;1;2;3
21708;"Gervelė (Stadiono g. 5)";PAUKŠTELIAI;5966215998;Ne;6;0;4;10
21709;"Gervelė (Stadiono g. 5)";PAUKŠTELIAI;7463376031;Ne;0;12;0;12
21710;"Gervelė (Stadiono g. 5)";PAUKŠTELIAI;3567687304;Ne;8;0;0;8
21711;"Gervelė (Stadiono g. 5)";PAUKŠTELIAI;6372245141;Ne;11;0;2;13
21712;"Gervelė (Stadiono g. 5)";PAUKŠTELIAI;2892214705;Ne;0;4;2;6
21713;"Gervelė (Stadiono g. 5)";PAUKŠTELIAI;7952102572;Ne;1;0;3;4
21714;"Gervelė (Stadiono g. 5)";PAUKŠTELIAI;9154032804;Ne;0;14;0;14
21715;"Gervelė (Stadiono g. 5)";PAUKŠTELIAI;3676856569;Ne;0;5;0;5
21716;"Gervelė (Stadiono g. 5)";PAUKŠTELIAI;4588890423;Ne;0;10;0;10
21717;"Gervelė (Stadiono g. 5)";PAUKŠTELIAI;6822089289;Ne;0;0;1;1
21718;"Gervelė (Stadiono g. 5)";SPINDULĖLIAI;4508176017;Ne;0;0;1;1
21719;"Gervelė (Stadiono g. 5)";SPINDULĖLIAI;1020095914;Ne;2;0;0;2
21720;"Gervelė (Stadiono g. 5)";SPINDULĖLIAI;3306549764;Ne;0;3;0;3
21721;"Gervelė (Stadiono g. 5)";SPINDULĖLIAI;6241611652;Ne;7;0;0;7
21722;"Gervelė (Stadiono g. 5)";SPINDULĖLIAI;2207041148;Ne;0;6;0;6
21723;"Gervelė (Stadiono g. 5)";SPINDULĖLIAI;1204513844;Ne;0;0;1;1
21724;"Gervelė (Stadiono g. 5)";SPINDULĖLIAI;7419432731;Ne;6;0;4;10
21725;"Gervelė (Stadiono g. 5)";SPINDULĖLIAI;1611114179;Ne;0;1;4;5
21726;"Gervelė (Stadiono g. 5)";SPINDULĖLIAI;8710469480;Ne;0;4;0;4
21727;"Gervelė (Stadiono g. 5)";GĖLYTĖS;6172016747;Ne;0;1;0;1
21728;"Gervelė (Stadiono g. 5)";GĖLYTĖS;3873345138;Ne;0;6;0;6
21729;"Gervelė (Stadiono g. 5)";GĖLYTĖS;5518309115;Ne;12;4;0;16
21730;"Gervelė (Stadiono g. 5)";GĖLYTĖS;4930308435;Ne;2;3;0;5
21731;"Gervelė (Stadiono g. 5)";GĖLYTĖS;7115198351;Ne;7;0;0;7
21732;"Gervelė (Stadiono g. 5)";GĖLYTĖS;9291855374;Ne;0;5;0;5
21733;"Gervelė (Stadiono g. 5)";GĖLYTĖS;4832348492;Ne;0;7;0;7
21734;"Gervelė (Stadiono g. 5)";GĖLYTĖS;7855598075;Ne;1;6;0;7
21735;"Gervelė (Stadiono g. 5)";GĖLYTĖS;8777858708;Ne;8;0;0;8
21736;"Gervelė (Stadiono g. 5)";GĖLYTĖS;6488139414;Ne;6;0;0;6
21737;"Gervelė (Stadiono g. 5)";GĖLYTĖS;3216423543;Ne;5;0;0;5
21738;"Gervelė (Stadiono g. 5)";GĖLYTĖS;4925983616;Ne;0;3;0;3
21739;"Kūlverstukas (Mindaugo g. 7)";GNOMIKI;1720671485;Ne;0;11;0;11
21740;"Kūlverstukas (Mindaugo g. 7)";GNOMIKI;4894478262;Ne;4;0;0;4
21741;"Kūlverstukas (Mindaugo g. 7)";GNOMIKI;2501327054;Ne;0;6;0;6
21742;"Kūlverstukas (Mindaugo g. 7)";GNOMIKI;8348978878;Ne;6;1;0;7
21743;"Kūlverstukas (Mindaugo g. 7)";GNOMIKI;2709547427;Ne;0;6;0;6
21744;"Kūlverstukas (Mindaugo g. 7)";GNOMIKI;5532063862;Ne;0;0;1;1
21745;"Kūlverstukas (Mindaugo g. 7)";GNOMIKI;5747277587;Ne;0;4;0;4
21746;"Kūlverstukas (Mindaugo g. 7)";GNOMIKI;1848018684;Ne;0;9;0;9
21747;"Kūlverstukas (Mindaugo g. 7)";GNOMIKI;1166429762;Ne;8;4;0;12
21748;"Kūlverstukas (Mindaugo g. 7)";GNOMIKI;6514730230;Ne;28;0;0;28
21749;"Kūlverstukas (Mindaugo g. 7)";GNOMIKI;5298776235;Ne;11;5;0;16
21750;"Kūlverstukas (Mindaugo g. 7)";GNOMIKI;4116831802;Ne;4;0;0;4
21751;"Kūlverstukas (Mindaugo g. 7)";GNOMIKI;1916522637;Ne;10;0;8;18
21752;"Kūlverstukas (Mindaugo g. 7)";GNOMIKI;3239566139;Ne;0;19;0;19
21753;"Kūlverstukas (Mindaugo g. 7)";GNOMIKI;5260820316;Ne;4;2;0;6
21754;"Kūlverstukas (Mindaugo g. 7)";ZAIČIATA;8994705290;Ne;15;6;0;21
21755;"Kūlverstukas (Mindaugo g. 7)";ZAIČIATA;7933156766;Ne;15;0;0;15
21756;"Kūlverstukas (Mindaugo g. 7)";ZAIČIATA;2494202134;Ne;0;7;0;7
21757;"Kūlverstukas (Mindaugo g. 7)";ZAIČIATA;2714297182;Ne;0;2;0;2
21758;"Kūlverstukas (Mindaugo g. 7)";ZAIČIATA;4998847820;Ne;14;0;7;21
21759;"Kūlverstukas (Mindaugo g. 7)";ZAIČIATA;4271185150;Ne;0;0;1;1
21760;"Kūlverstukas (Mindaugo g. 7)";ZAIČIATA;6497373567;Ne;7;0;0;7
21761;"Kūlverstukas (Mindaugo g. 7)";ZAIČIATA;3660002342;Ne;5;7;0;12
21762;"Kūlverstukas (Mindaugo g. 7)";ZAIČIATA;5079635330;Ne;6;4;0;10
21763;"Kūlverstukas (Mindaugo g. 7)";ZAIČIATA;5879283662;Ne;1;0;2;3
21764;"Kūlverstukas (Mindaugo g. 7)";ZAIČIATA;3067918179;Ne;0;9;4;13
21765;"Kūlverstukas (Mindaugo g. 7)";ZAIČIATA;1776176097;Ne;10;0;0;10
21766;"Kūlverstukas (Mindaugo g. 7)";SVETLIAČKI;6219872984;Ne;0;0;6;6
21767;"Kūlverstukas (Mindaugo g. 7)";SVETLIAČKI;9098427210;Ne;0;0;9;9
21768;"Kūlverstukas (Mindaugo g. 7)";SVETLIAČKI;70033583066;Ne;0;5;0;5
21769;"Kūlverstukas (Mindaugo g. 7)";SVETLIAČKI;2154916232;Ne;0;6;0;6
21770;"Kūlverstukas (Mindaugo g. 7)";SVETLIAČKI;5794471794;Ne;0;0;2;2
21771;"Kūlverstukas (Mindaugo g. 7)";SVETLIAČKI;1557237011;Ne;0;4;0;4
21772;"Kūlverstukas (Mindaugo g. 7)";SVETLIAČKI;8577197481;Ne;14;0;3;17
21773;"Kūlverstukas (Mindaugo g. 7)";SVETLIAČKI;3449300504;Ne;0;7;0;7
21774;"Kūlverstukas (Mindaugo g. 7)";SVETLIAČKI;1102996499;Ne;2;4;0;6
21775;"Kūlverstukas (Mindaugo g. 7)";SVETLIAČKI;6311116034;Ne;0;3;0;3
21776;"Kūlverstukas (Mindaugo g. 7)";SVETLIAČKI;5546604017;Ne;0;4;0;4
21777;"Kūlverstukas (Mindaugo g. 7)";SVETLIAČKI;1635418112;Ne;0;0;2;2
21778;"Kūlverstukas (Mindaugo g. 7)";SVETLIAČKI;4352034102;Ne;0;0;1;1
21779;"Kūlverstukas (Mindaugo g. 7)";ZVONOČKI;8835111916;Ne;0;2;8;10
21780;"Kūlverstukas (Mindaugo g. 7)";ZVONOČKI;5724787637;Ne;0;3;0;3
21781;"Kūlverstukas (Mindaugo g. 7)";ZVONOČKI;4377803110;Ne;6;2;0;8
21782;"Kūlverstukas (Mindaugo g. 7)";ZVONOČKI;7898746258;Ne;0;0;2;2
21783;"Kūlverstukas (Mindaugo g. 7)";ZVONOČKI;9835391223;Ne;0;4;0;4
21784;"Kūlverstukas (Mindaugo g. 7)";ZVONOČKI;2429527586;Ne;0;0;6;6
21785;"Kūlverstukas (Mindaugo g. 7)";ZVONOČKI;5217751936;Ne;0;17;0;17
21786;"Kūlverstukas (Mindaugo g. 7)";ZVONOČKI;1566191212;Ne;0;6;0;6
21787;"Kūlverstukas (Mindaugo g. 7)";ZVONOČKI;9569296370;Ne;0;4;7;11
21788;"Kūlverstukas (Mindaugo g. 7)";ZVONOČKI;1047459617;Ne;6;0;0;6
21789;"Kūlverstukas (Mindaugo g. 7)";ZVONOČKI;1125206576;Ne;0;2;0;2
21790;"Kūlverstukas (Mindaugo g. 7)";ZVONOČKI;5938022496;Ne;0;6;0;6
21791;"Kūlverstukas (Mindaugo g. 7)";ZVONOČKI;2091204077;Ne;0;1;0;1
21792;"Vilniaus Pavilnio pagrindinė mokykla";"PRIEŠMOKYKLINĖ PL";2738553283;Ne;14;4;0;18
21793;"Vilniaus Pavilnio pagrindinė mokykla";"PRIEŠMOKYKLINĖ PL";2101902207;Ne;0;4;2;6
21794;"Vilniaus Pavilnio pagrindinė mokykla";"PRIEŠMOKYKLINĖ PL";1957926887;Ne;0;4;0;4
21795;"Vilniaus Pavilnio pagrindinė mokykla";"PRIEŠMOKYKLINĖ PL";1046606022;Ne;0;4;2;6
21796;"Vilniaus Pavilnio pagrindinė mokykla";"PRIEŠMOKYKLINĖ RU";4339607826;Ne;1;4;0;5
21797;"Vilniaus Pavilnio pagrindinė mokykla";"PRIEŠMOKYKLINĖ RU";3609961581;Ne;0;4;2;6
21798;"Vilniaus Pavilnio pagrindinė mokykla";"PRIEŠMOKYKLINĖ RU";1568915914;Ne;0;4;0;4
21799;"Vilniaus Pavilnio pagrindinė mokykla";"PRIEŠMOKYKLINĖ RU";5619763557;Ne;0;21;0;21
21800;"Vilniaus Pavilnio pagrindinė mokykla";"PRIEŠMOKYKLINĖ RU";9759761725;Ne;0;21;0;21
21801;"Vilniaus Pavilnio pagrindinė mokykla";"PRIEŠMOKYKLINĖ RU";3058369504;Ne;0;4;0;4
21802;"Vilniaus Pavilnio pagrindinė mokykla";"PRIEŠMOKYKLINĖ RU";9142513631;Ne;2;6;0;8
21803;"Vilniaus Pavilnio pagrindinė mokykla";"PRIEŠMOKYKLINĖ RU";5972567526;Ne;0;4;0;4
21804;"Vilniaus Pavilnio pagrindinė mokykla";"PRIEŠMOKYKLINĖ RU";2846917348;Ne;15;4;0;19
21805;"Vilniaus Pavilnio pagrindinė mokykla";"PRIEŠMOKYKLINĖ RU";6067622823;Ne;0;4;0;4
21806;"Vilniaus Pavilnio pagrindinė mokykla";"PRIEŠMOKYKLINĖ RU";3243226933;Ne;1;4;3;8
21807;"Vilniaus Pavilnio pagrindinė mokykla";"PRIEŠMOKYKLINĖ RU";7544963724;Ne;0;4;1;5
21808;"Vilniaus Pavilnio pagrindinė mokykla";"PRIEŠMOKYKLINĖ RU";6216663291;Ne;0;4;1;5
21809;"Vilniaus Pavilnio pagrindinė mokykla";"PRIEŠMOKYKLINĖ RU";7255617408;Ne;0;4;5;9
21810;"Lazdynų mokykla (Liudvinavo g.128)";DRUGELIAI;7524849851;Ne;0;2;3;5
21811;"Lazdynų mokykla (Liudvinavo g.128)";DRUGELIAI;9309081745;Ne;0;2;1;3
21812;"Lazdynų mokykla (Liudvinavo g.128)";DRUGELIAI;1951041742;Ne;5;2;0;7
21813;"Lazdynų mokykla (Liudvinavo g.128)";DRUGELIAI;9196184984;Ne;7;2;0;9
21814;"Lazdynų mokykla (Liudvinavo g.128)";DRUGELIAI;2767732459;Ne;0;5;0;5
21815;"Lazdynų mokykla (Liudvinavo g.128)";DRUGELIAI;6394098306;Ne;0;3;9;12
21816;"Lazdynų mokykla (Liudvinavo g.128)";DRUGELIAI;6627809171;Ne;0;21;0;21
21817;"Lazdynų mokykla (Liudvinavo g.128)";DRUGELIAI;4520091712;Ne;3;0;0;3
21818;"Lazdynų mokykla (Liudvinavo g.128)";DRUGELIAI;7074859809;Ne;7;2;5;14
21819;"Lazdynų mokykla (Liudvinavo g.128)";DRUGELIAI;4097980299;Ne;0;4;1;5
21820;"Lazdynų mokykla (Liudvinavo g.128)";DRUGELIAI;8001610972;Ne;0;4;1;5
21821;"Lazdynų mokykla (Liudvinavo g.128)";DRUGELIAI;5902104981;Ne;0;8;0;8
21822;"Lazdynų mokykla (Liudvinavo g.128)";DRUGELIAI;7590111138;Ne;10;1;0;11
21823;"Lazdynų mokykla (Liudvinavo g.128)";DRUGELIAI;8472834181;Ne;0;2;1;3
21824;"Lazdynų mokykla (Liudvinavo g.128)";DRUGELIAI;2027751624;Ne;0;11;1;12
21825;"Lazdynų mokykla (Liudvinavo g.128)";ZUIKUČIAI;7232402011;Ne;9;1;0;10
21826;"Lazdynų mokykla (Liudvinavo g.128)";ZUIKUČIAI;4166599533;Ne;0;0;1;1
21827;"Lazdynų mokykla (Liudvinavo g.128)";ZUIKUČIAI;3435025978;Ne;0;0;7;7
21828;"Lazdynų mokykla (Liudvinavo g.128)";ZUIKUČIAI;3715070791;Ne;0;0;19;19
21829;"Lazdynų mokykla (Liudvinavo g.128)";ZUIKUČIAI;3265099747;Ne;0;0;3;3
21830;"Lazdynų mokykla (Liudvinavo g.128)";ZUIKUČIAI;8669630986;Ne;0;1;0;1
21831;"Lazdynų mokykla (Liudvinavo g.128)";ZUIKUČIAI;1336503878;Ne;0;1;0;1
21832;"Lazdynų mokykla (Liudvinavo g.128)";ZUIKUČIAI;3535244441;Ne;0;3;3;6
21833;"Lazdynų mokykla (Liudvinavo g.128)";ZUIKUČIAI;7594978836;Ne;0;7;0;7
21834;"Lazdynų mokykla (Liudvinavo g.128)";ZUIKUČIAI;5465094647;Ne;0;10;0;10
21835;"Lazdynų mokykla (Liudvinavo g.128)";ZUIKUČIAI;1044630813;Ne;0;4;0;4
21836;"Lazdynų mokykla (Liudvinavo g.128)";ZUIKUČIAI;7229926614;Ne;6;0;0;6
21837;"Lazdynų mokykla (Liudvinavo g.128)";ZUIKUČIAI;8899186547;Ne;8;0;3;11
21838;"Lazdynų mokykla (Liudvinavo g.128)";ZUIKUČIAI;5181200460;Ne;14;0;3;17
21839;"Vilniaus Šilo mokykla";Boružėlės;7122041826;Ne;21;0;0;21
21840;"Vilniaus Šilo mokykla";Boružėlės;9967276147;Ne;1;0;0;1
21841;"Vilniaus Šilo mokykla";Boružėlės;5962551687;Ne;6;4;0;10
21842;"Vilniaus Šilo mokykla";Boružėlės;1196172221;Ne;7;4;0;11
21843;"Vilniaus Šilo mokykla";Boružėlės;1538635985;Ne;14;4;0;18
21844;"Vilniaus Šilo mokykla";Boružėlės;6136087920;Ne;0;21;0;21
21845;"Vilniaus Šilo mokykla";Boružėlės;4544126354;Ne;21;0;0;21
21846;"Vilniaus Šilo mokykla";"1 spec.";1153167430;Ne;5;4;0;9
21847;"Vilniaus Šilo mokykla";"1 spec.";8863021708;Ne;9;4;0;13
21848;"Vilniaus Šilo mokykla";"1 spec.";4438939800;Ne;1;4;0;5
21849;"Vilniaus Šilo mokykla";"1 spec.";1971717759;Ne;6;4;0;10
21850;"Vilniaus Šilo mokykla";"1 spec.";2290889395;Ne;0;4;0;4
21851;"Vilniaus Šilo mokykla";"1 spec.";1180183091;Ne;0;21;0;21
21852;"Vilniaus Šilo mokykla";"3-4 kl. RUS";11529512484;Ne;1;4;0;5
21853;"Vilniaus Šilo mokykla";"3-4 kl. RUS";13277011762;Ne;0;4;0;4
21854;"Vilniaus Šilo mokykla";"3-4 kl. RUS";34463714051;Ne;1;4;0;5
21855;"Vilniaus Šilo mokykla";"3-4 kl. RUS";4078721064;Ne;5;4;0;9
21856;"Vilniaus Šilo mokykla";"3-4 kl. RUS";9789373884;Ne;0;21;0;21
21857;"Vilniaus Šilo mokykla";"3-4 kl. RUS";3419495275;Ne;0;21;0;21
21858;"Vilniaus Šilo mokykla";"6 lav.";29353956408;Ne;5;4;0;9
21859;"Vilniaus Šilo mokykla";"6 lav.";83007167743;Ne;1;4;0;5
21860;"Vilniaus Šilo mokykla";"6 lav.";67989956617;Ne;0;21;0;21
21861;"Vilniaus Šilo mokykla";"6 lav.";49892720109;Ne;9;4;0;13
21862;"Vilniaus Šilo mokykla";"6 lav.";3612746646;Ne;0;4;0;4
21863;"Vilniaus Šilo mokykla";"6 lav.";9054390753;Ne;2;4;0;6
21864;"Vilniaus Šilo mokykla";"6 lav.";2862598950;Ne;5;4;0;9
21865;"Vilniaus Šilo mokykla";"6 lav.";3120638166;Ne;0;4;0;4
21866;"Vilniaus Šilo mokykla";"7-10 spec.";9944901942;Ne;1;4;0;5
21867;"Vilniaus Šilo mokykla";"7-10 spec.";3442250711;Ne;5;4;0;9
21868;"Vilniaus Šilo mokykla";"7-10 spec.";5083856935;Ne;3;4;0;7
21869;"Vilniaus Šilo mokykla";"7-10 spec.";3333634089;Ne;0;21;0;21
21870;"Vilniaus Šilo mokykla";"7-10 spec.";8548722736;Ne;0;4;0;4
21871;"Vilniaus Šilo mokykla";"7-10 spec.";1726056983;Ne;2;4;0;6
21872;"Vilniaus Šilo mokykla";"7-10 spec.";5255365063;Ne;1;4;0;5
21873;"Vilniaus Šilo mokykla";"7-10 spec.";9264140610;Ne;3;4;0;7
21874;"Vilniaus Šilo mokykla";"7-10 spec.";6452740859;Ne;1;4;0;5
21875;"Vilniaus Šilo mokykla";"SĮ A";6954467869;Ne;0;21;0;21
21876;"Vilniaus Šilo mokykla";"SĮ A";2755910347;Ne;0;4;0;4
21877;"Vilniaus Šilo mokykla";"SĮ A";9354191217;Ne;0;4;0;4
21878;"Vilniaus Šilo mokykla";"SĮ A";9471629029;Ne;9;4;0;13
21879;"Vilniaus Šilo mokykla";"SĮ A";6088433049;Ne;2;4;0;6
21880;"Vilniaus Šilo mokykla";"SĮ A";1819519275;Ne;3;4;0;7
21881;"Vilniaus Šilo mokykla";"SĮ A";9050305661;Ne;0;21;0;21
21882;"Vilniaus Šilo mokykla";"SĮ A";8625084837;Ne;0;21;0;21
21883;"Vilniaus Šilo mokykla";"SĮ A";9845575989;Ne;2;4;0;6
21884;"Vilniaus Šilo mokykla";"SĮ A";2504178906;Ne;0;4;0;4
21885;"Vilniaus Šilo mokykla";"SĮ A";3308772529;Ne;8;4;0;12
21886;"Vilniaus Šilo mokykla";"SĮ C";1322335360;Ne;2;4;0;6
21887;"Vilniaus Šilo mokykla";"SĮ C";3808707012;Ne;0;4;0;4
21888;"Vilniaus Šilo mokykla";"SĮ C";8642665550;Ne;0;4;0;4
21889;"Vilniaus Šilo mokykla";"SĮ C";5309862220;Ne;0;21;0;21
21890;"Vilniaus Šilo mokykla";"SĮ C";1010885560;Ne;0;4;0;4
21891;"Vilniaus Šilo mokykla";"SĮ C";8377829773;Ne;1;4;0;5
21892;"Vilniaus Šilo mokykla";"SĮ C";5138513395;Ne;11;4;0;15
21893;"Vilniaus Šilo mokykla";"SĮ C";1969540884;Ne;0;21;0;21
21894;"Vilniaus Šilo mokykla";"Priešmokyklinė grupė";5311183877;Ne;9;4;0;13
21895;"Vilniaus Šilo mokykla";"Priešmokyklinė grupė";1675384533;Ne;6;4;0;10
21896;"Vilniaus Šilo mokykla";"Priešmokyklinė grupė";3237698420;Ne;0;4;0;4
21897;"Vilniaus Šilo mokykla";"Priešmokyklinė grupė";2070454339;Ne;0;21;0;21
21898;"Vilniaus Šilo mokykla";"Priešmokyklinė grupė";8915901727;Ne;7;4;0;11
21899;"Vilniaus Šilo mokykla";"Priešmokyklinė grupė";9906750269;Ne;0;21;0;21
21900;"Vilniaus Šilo mokykla";"Priešmokyklinė grupė";8897729962;Ne;2;0;0;2
21901;Malūnėlis;BITUTĖS;1001575740;Ne;0;0;1;1
21902;Malūnėlis;BITUTĖS;8618778205;Ne;0;4;0;4
21903;Malūnėlis;BITUTĖS;2545930114;Ne;8;2;0;10
21904;Malūnėlis;BITUTĖS;3329510128;Ne;14;0;0;14
21905;Malūnėlis;BITUTĖS;5402027714;Ne;0;4;0;4
21906;Malūnėlis;BITUTĖS;6199265600;Ne;0;2;0;2
21907;Malūnėlis;BITUTĖS;6863437022;Ne;0;4;0;4
21908;Malūnėlis;BITUTĖS;5244586185;Ne;10;0;0;10
21909;Malūnėlis;BITUTĖS;7144098762;Ne;0;8;0;8
21910;Malūnėlis;BITUTĖS;1146723570;Ne;2;2;0;4
21911;Malūnėlis;BITUTĖS;9891418762;Ne;0;19;0;19
21912;Malūnėlis;BITUTĖS;5959610426;Ne;0;4;0;4
21913;Malūnėlis;BITUTĖS;4367009696;Ne;0;5;0;5
21914;Malūnėlis;BITUTĖS;5770511204;Ne;0;4;0;4
21915;Malūnėlis;BITUTĖS;9936144392;Ne;0;3;0;3
21916;Malūnėlis;BITUTĖS;1944670796;Ne;11;0;0;11
21917;Malūnėlis;BITUTĖS;5421090978;Ne;0;4;0;4
21918;Malūnėlis;BITUTĖS;8643210289;Ne;0;4;1;5
21919;Malūnėlis;BITUTĖS;8440160819;Ne;0;6;0;6
21920;Malūnėlis;BITUTĖS;1528972517;Ne;6;8;0;14
21921;Malūnėlis;BITUTĖS;4202723476;Ne;0;4;0;4
21922;Malūnėlis;BITUTĖS;8007350745;Ne;4;0;0;4
21923;Malūnėlis;BITUTĖS;9257812097;Ne;0;2;0;2
21924;Malūnėlis;BITUTĖS;3402561453;Ne;5;9;0;14
21925;Malūnėlis;VOVERIUKAI;4307232411;Ne;0;0;1;1
21926;Malūnėlis;VOVERIUKAI;3293082023;Ne;14;1;0;15
21927;Malūnėlis;VOVERIUKAI;6575258889;Ne;5;0;1;6
21928;Malūnėlis;VOVERIUKAI;1003043129;Ne;5;4;0;9
21929;Malūnėlis;VOVERIUKAI;3779723692;Ne;7;8;0;15
21930;Malūnėlis;VOVERIUKAI;7983537913;Ne;7;0;0;7
21931;Malūnėlis;VOVERIUKAI;9592117637;Ne;5;0;0;5
21932;Malūnėlis;VOVERIUKAI;9894452403;Ne;5;6;0;11
21933;Malūnėlis;VOVERIUKAI;2029506037;Ne;6;0;0;6
21934;Malūnėlis;VOVERIUKAI;9342720464;Ne;10;5;0;15
21935;Malūnėlis;VOVERIUKAI;2246526281;Ne;2;5;0;7
21936;Malūnėlis;VOVERIUKAI;2192305527;Ne;19;0;0;19
21937;Malūnėlis;VOVERIUKAI;6805587761;Ne;19;0;0;19
21938;Malūnėlis;VOVERIUKAI;3371260811;Ne;5;4;0;9
21939;Malūnėlis;VOVERIUKAI;5061720786;Ne;7;0;2;9
21940;Malūnėlis;VOVERIUKAI;5232728972;Ne;14;0;0;14
21941;Malūnėlis;VOVERIUKAI;2574604828;Ne;4;0;4;8
21942;Malūnėlis;VOVERIUKAI;3898518306;Ne;0;0;9;9
21943;Malūnėlis;VOVERIUKAI;1770049356;Ne;0;4;0;4
21944;Malūnėlis;VOVERIUKAI;5909022614;Ne;5;2;1;8
21945;Malūnėlis;VOVERIUKAI;6081634102;Ne;0;6;0;6
21946;Malūnėlis;VOVERIUKAI;5540120728;Ne;8;6;0;14
21947;Malūnėlis;BORUŽĖLĖS;7556990784;Ne;2;0;2;4
21948;Malūnėlis;BORUŽĖLĖS;1574941416;Ne;3;0;0;3
21949;Malūnėlis;BORUŽĖLĖS;1100719254;Ne;7;2;2;11
21950;Malūnėlis;BORUŽĖLĖS;2525923211;Ne;0;4;3;7
21951;Malūnėlis;BORUŽĖLĖS;9304119075;Ne;4;0;0;4
21952;Malūnėlis;BORUŽĖLĖS;6928976717;Ne;5;0;0;5
21953;Malūnėlis;BORUŽĖLĖS;6531364407;Ne;3;0;0;3
21954;Malūnėlis;BORUŽĖLĖS;2637299307;Ne;6;0;0;6
21955;Malūnėlis;BORUŽĖLĖS;8551271848;Ne;0;0;2;2
21956;Malūnėlis;BORUŽĖLĖS;8277245773;Ne;10;1;0;11
21957;Malūnėlis;BORUŽĖLĖS;5686301875;Ne;0;0;2;2
21958;Malūnėlis;BORUŽĖLĖS;1407908511;Ne;7;0;0;7
21959;Malūnėlis;BORUŽĖLĖS;4787212056;Ne;6;1;0;7
21960;Malūnėlis;BORUŽĖLĖS;9185138453;Ne;18;0;0;18
21961;Malūnėlis;BORUŽĖLĖS;5727725132;Ne;1;4;0;5
21962;Malūnėlis;BORUŽĖLĖS;9559372808;Ne;15;0;1;16
21963;Malūnėlis;Skruzdėliukų;2093908776;Ne;0;3;0;3
21964;Malūnėlis;Skruzdėliukų;9798968369;Ne;3;0;3;6
21965;Malūnėlis;Skruzdėliukų;4859886340;Ne;0;4;0;4
21966;Malūnėlis;Skruzdėliukų;1213476648;Ne;0;0;4;4
21967;Malūnėlis;Skruzdėliukų;9300944734;Ne;0;4;0;4
21968;Malūnėlis;Skruzdėliukų;5877882690;Ne;2;0;0;2
21969;Malūnėlis;Skruzdėliukų;9153589128;Ne;4;0;13;17
21970;Malūnėlis;Skruzdėliukų;5474437579;Ne;0;6;0;6
21971;Malūnėlis;Skruzdėliukų;1549241453;Ne;9;0;0;9
21972;Malūnėlis;Skruzdėliukų;5478561852;Ne;1;0;0;1
21973;Malūnėlis;Skruzdėliukų;4802771311;Ne;0;0;1;1
21974;Malūnėlis;Skruzdėliukų;9207327884;Ne;6;0;4;10
21975;Malūnėlis;Skruzdėliukų;6609446450;Ne;2;1;2;5
21976;Malūnėlis;Skruzdėliukų;5687585794;Ne;11;0;0;11
21977;Malūnėlis;Skruzdėliukų;8076487157;Ne;5;0;2;7
21978;Malūnėlis;Skruzdėliukų;2495112045;Ne;12;0;0;12
21979;Malūnėlis;Skruzdėliukų;3935474148;Ne;0;4;0;4
21980;Malūnėlis;Skruzdėliukų;8751365673;Ne;0;0;2;2
21981;Malūnėlis;Žirniukų;3791873303;Ne;0;7;0;7
21982;Malūnėlis;Žirniukų;3031849277;Ne;2;1;0;3
21983;Malūnėlis;Žirniukų;6747286787;Ne;0;5;0;5
21984;Malūnėlis;Žirniukų;4539998453;Ne;5;1;0;6
21985;Malūnėlis;Žirniukų;6943968536;Ne;2;0;0;2
21986;Malūnėlis;Žirniukų;4841028952;Ne;18;0;0;18
21987;Malūnėlis;Žirniukų;7097858329;Ne;0;4;0;4
21988;Malūnėlis;Žirniukų;5893575540;Ne;7;0;2;9
21989;Malūnėlis;Žirniukų;1398391534;Ne;3;0;2;5
21990;Malūnėlis;Žirniukų;2961972215;Ne;15;0;0;15
21991;Malūnėlis;Žirniukų;3315571256;Ne;0;0;4;4
21992;Malūnėlis;Žirniukų;3315571256;Ne;0;0;4;4
21993;Malūnėlis;Žirniukų;3315571256;Ne;0;0;4;4
21994;Malūnėlis;Žirniukų;9941335615;Ne;5;7;0;12
21995;Malūnėlis;Žirniukų;3464224841;Ne;2;3;0;5
21996;Malūnėlis;Žirniukų;6047042736;Ne;0;1;1;2
21997;Malūnėlis;Žirniukų;4875859413;Ne;11;1;0;12
21998;Malūnėlis;Žirniukų;6647872886;Ne;2;4;1;7
21999;"Dainorėliai (Goštauto g. 4)";PUMPURĖLIAI;8015545426;Ne;0;2;0;2
22000;"Dainorėliai (Goštauto g. 4)";PUMPURĖLIAI;6132543858;Ne;4;0;0;4
22001;"Dainorėliai (Goštauto g. 4)";PUMPURĖLIAI;4560328911;Ne;15;13;0;28
22002;"Dainorėliai (Goštauto g. 4)";PUMPURĖLIAI;4435310580;Ne;0;6;19;25
22003;"Dainorėliai (Goštauto g. 4)";PUMPURĖLIAI;7197089520;Ne;0;1;1;2
22004;"Dainorėliai (Goštauto g. 4)";PUMPURĖLIAI;3999214263;Ne;2;0;2;4
22005;"Dainorėliai (Goštauto g. 4)";PUMPURĖLIAI;6362265057;Ne;0;4;4;8
22006;"Dainorėliai (Goštauto g. 4)";PUMPURĖLIAI;2215481883;Ne;0;7;8;15
22007;"Dainorėliai (Goštauto g. 4)";PUMPURĖLIAI;1233029451;Ne;20;5;0;25
22008;"Dainorėliai (Goštauto g. 4)";PUMPURĖLIAI;3561729784;Ne;0;0;1;1
22009;"Dainorėliai (Goštauto g. 4)";PUMPURĖLIAI;5534783929;Ne;0;0;3;3
22010;"Dainorėliai (Goštauto g. 4)";PUMPURĖLIAI;3705286231;Ne;5;5;1;11
22011;"Dainorėliai (Goštauto g. 4)";PUMPURĖLIAI;4826994208;Ne;10;0;1;11
22012;"Dainorėliai (Goštauto g. 4)";PUMPURĖLIAI;4848146301;Ne;2;0;4;6
22013;"Dainorėliai (Goštauto g. 4)";DEBESĖLIŲ;6513417505;Ne;0;12;0;12
22014;"Dainorėliai (Goštauto g. 4)";DEBESĖLIŲ;5605084046;Ne;0;0;1;1
22015;"Dainorėliai (Goštauto g. 4)";DEBESĖLIŲ;1873415679;Ne;0;5;0;5
22016;"Dainorėliai (Goštauto g. 4)";DEBESĖLIŲ;4286864865;Ne;6;0;1;7
22017;"Dainorėliai (Goštauto g. 4)";DEBESĖLIŲ;1554081754;Ne;0;0;2;2
22018;"Dainorėliai (Goštauto g. 4)";DEBESĖLIŲ;6832582194;Ne;2;1;5;8
22019;"Dainorėliai (Goštauto g. 4)";DEBESĖLIŲ;2095914442;Ne;0;1;0;1
22020;"Dainorėliai (Goštauto g. 4)";DEBESĖLIŲ;4255893222;Ne;0;0;15;15
22021;"Dainorėliai (Goštauto g. 4)";DEBESĖLIŲ;3271090533;Ne;2;17;0;19
22022;"Dainorėliai (Goštauto g. 4)";DEBESĖLIŲ;4033317616;Ne;17;0;0;17
22023;"Dainorėliai (Goštauto g. 4)";DEBESĖLIŲ;6449332338;Ne;8;5;0;13
22024;"Dainorėliai (Goštauto g. 4)";DEBESĖLIŲ;9285865812;Ne;0;2;0;2
22025;"Dainorėliai (Goštauto g. 4)";DEBESĖLIŲ;6284140548;Ne;0;17;0;17
22026;"Dainorėliai (Goštauto g. 4)";DEBESĖLIŲ;2534758615;Ne;3;4;0;7
22027;"Dainorėliai (Goštauto g. 4)";DEBESĖLIŲ;5283566263;Ne;4;6;0;10
22028;"Krivūlė (Vokiečių g. 1)";PABIRUČIAI;9011102232;Ne;0;0;2;2
22029;"Krivūlė (Vokiečių g. 1)";PABIRUČIAI;5535822704;Ne;0;21;0;21
22030;"Krivūlė (Vokiečių g. 1)";PABIRUČIAI;3696403149;Ne;0;21;0;21
22031;"Krivūlė (Vokiečių g. 1)";PABIRUČIAI;5721252419;Ne;0;21;0;21
22032;"Krivūlė (Vokiečių g. 1)";PABIRUČIAI;4600688626;Ne;0;0;7;7
22033;"Krivūlė (Vokiečių g. 1)";PABIRUČIAI;4608957977;Ne;0;0;2;2
22034;"Krivūlė (Vokiečių g. 1)";PABIRUČIAI;4884789671;Ne;0;0;2;2
22035;"Krivūlė (Vokiečių g. 1)";PABIRUČIAI;8352493729;Ne;0;21;0;21
22036;"Krivūlė (Vokiečių g. 1)";PABIRUČIAI;8678565710;Ne;0;0;7;7
22037;"Krivūlė (Vokiečių g. 1)";PABIRUČIAI;9401191578;Ne;0;0;7;7
22038;"Krivūlė (Vokiečių g. 1)";PABIRUČIAI;3976974038;Ne;0;0;1;1
22039;"Krivūlė (Vokiečių g. 1)";PABIRUČIAI;2259139771;Ne;4;0;3;7
22040;"Krivūlė (Vokiečių g. 1)";PABIRUČIAI;3138555448;Ne;0;16;0;16
22041;"Krivūlė (Vokiečių g. 1)";PABIRUČIAI;2784118970;Ne;0;0;2;2
22042;"Krivūlė (Vokiečių g. 1)";PABIRUČIAI;3227555647;Ne;0;0;21;21
22043;"Krivūlė (Vokiečių g. 1)";PABIRUČIAI;4261770381;Ne;0;0;9;9
22044;"Krivūlė (Vokiečių g. 1)";SMALSUČIAI;5304221329;Ne;0;5;0;5
22045;"Krivūlė (Vokiečių g. 1)";SMALSUČIAI;7508079584;Ne;0;0;5;5
22046;"Krivūlė (Vokiečių g. 1)";SMALSUČIAI;5199600243;Ne;0;4;0;4
22047;"Krivūlė (Vokiečių g. 1)";SMALSUČIAI;7997564406;Ne;0;8;0;8
22048;"Krivūlė (Vokiečių g. 1)";SMALSUČIAI;8710938907;Ne;0;4;6;10
22049;"Krivūlė (Vokiečių g. 1)";SMALSUČIAI;4491462086;Ne;8;0;3;11
22050;"Krivūlė (Vokiečių g. 1)";SMALSUČIAI;4773564048;Ne;9;2;0;11
22051;"Krivūlė (Vokiečių g. 1)";SMALSUČIAI;3324090723;Ne;0;0;3;3
22052;"Krivūlė (Vokiečių g. 1)";SMALSUČIAI;4094383258;Ne;2;0;1;3
22053;"Krivūlė (Vokiečių g. 1)";SMALSUČIAI;9229817861;Ne;6;0;4;10
22054;"Krivūlė (Vokiečių g. 1)";SMALSUČIAI;8042469720;Ne;1;12;0;13
22055;"Krivūlė (Vokiečių g. 1)";SMALSUČIAI;4845066055;Ne;0;4;6;10
22056;"Krivūlė (Vokiečių g. 1)";SMALSUČIAI;9328365491;Ne;9;0;0;9
22057;"Krivūlė (Vokiečių g. 1)";SMALSUČIAI;1815336153;Ne;6;0;0;6
22058;"Krivūlė (Vokiečių g. 1)";SMALSUČIAI;7528273082;Ne;0;0;3;3
22059;"Krivūlė (Vokiečių g. 1)";SMALSUČIAI;6521798502;Ne;0;0;4;4
22060;"Krivūlė (Vokiečių g. 1)";SMALSUČIAI;1851097789;Ne;2;0;4;6
22061;"Krivūlė (Vokiečių g. 1)";GUDRUČIAI;8520470321;Ne;0;0;2;2
22062;"Krivūlė (Vokiečių g. 1)";GUDRUČIAI;5753204752;Ne;0;10;0;10
22063;"Krivūlė (Vokiečių g. 1)";GUDRUČIAI;2659604299;Ne;8;0;0;8
22064;"Krivūlė (Vokiečių g. 1)";GUDRUČIAI;2536472220;Ne;0;5;0;5
22065;"Krivūlė (Vokiečių g. 1)";GUDRUČIAI;1622495013;Ne;0;2;4;6
22066;"Krivūlė (Vokiečių g. 1)";GUDRUČIAI;4741154518;Ne;0;0;2;2
22067;"Krivūlė (Vokiečių g. 1)";GUDRUČIAI;7727246187;Ne;0;5;1;6
22068;"Krivūlė (Vokiečių g. 1)";GUDRUČIAI;5652936425;Ne;1;1;0;2
22069;"Krivūlė (Vokiečių g. 1)";GUDRUČIAI;6072261879;Ne;10;0;2;12
22070;"Krivūlė (Vokiečių g. 1)";GUDRUČIAI;7904390075;Ne;0;0;5;5
22071;"Krivūlė (Vokiečių g. 1)";GUDRUČIAI;6931566125;Ne;0;0;4;4
22072;"Krivūlė (Vokiečių g. 1)";GUDRUČIAI;5149419581;Ne;0;0;4;4
22073;"Krivūlė (Vokiečių g. 1)";GUDRUČIAI;5097101097;Ne;0;0;2;2
22074;"Krivūlė (Vokiečių g. 1)";GUDRUČIAI;9693693101;Ne;0;0;5;5
22075;"Krivūlė (Vokiečių g. 1)";GUDRUČIAI;5462491857;Ne;0;6;0;6
22076;"Krivūlė (Vokiečių g. 1)";GUDRUČIAI;8871794542;Ne;8;4;0;12
22077;"Krivūlė (Vokiečių g. 1)";GUDRUČIAI;5182563483;Ne;0;4;0;4
22078;"Pumpurėlis (Trinapolio g. 11)";GUDRUČIAI;7002569226;Ne;3;0;0;3
22079;"Pumpurėlis (Trinapolio g. 11)";GUDRUČIAI;9353403057;Ne;0;1;0;1
22080;"Pumpurėlis (Trinapolio g. 11)";GUDRUČIAI;9353403057;Ne;0;1;0;1
22081;"Pumpurėlis (Trinapolio g. 11)";GUDRUČIAI;6920353753;Ne;0;10;0;10
22082;"Pumpurėlis (Trinapolio g. 11)";GUDRUČIAI;6920353753;Ne;0;10;0;10
22083;"Pumpurėlis (Trinapolio g. 11)";GUDRUČIAI;1189960583;Ne;0;0;8;8
22084;"Pumpurėlis (Trinapolio g. 11)";GUDRUČIAI;3841134563;Ne;0;0;1;1
22085;"Pumpurėlis (Trinapolio g. 11)";GUDRUČIAI;3841134563;Ne;0;0;1;1
22086;"Pumpurėlis (Trinapolio g. 11)";GUDRUČIAI;3841134563;Ne;0;0;1;1
22087;"Pumpurėlis (Trinapolio g. 11)";GUDRUČIAI;5187890514;Ne;13;0;0;13
22088;"Pumpurėlis (Trinapolio g. 11)";GUDRUČIAI;9126312869;Ne;0;5;3;8
22089;"Pumpurėlis (Trinapolio g. 11)";GUDRUČIAI;3387386473;Ne;1;0;0;1
22090;"Pumpurėlis (Trinapolio g. 11)";GUDRUČIAI;7177681927;Ne;12;0;0;12
22091;"Pumpurėlis (Trinapolio g. 11)";GUDRUČIAI;2130008026;Ne;21;0;0;21
22092;"Pumpurėlis (Trinapolio g. 11)";GUDRUČIAI;8475215020;Ne;6;3;0;9
22093;"Pumpurėlis (Trinapolio g. 11)";GUDRUČIAI;3333547914;Ne;16;0;0;16
22094;"Pumpurėlis (Trinapolio g. 11)";GUDRUČIAI;9550967420;Ne;15;0;4;19
22095;"Pumpurėlis (Trinapolio g. 11)";GUDRUČIAI;8534897580;Ne;7;0;0;7
22096;"Pumpurėlis (Trinapolio g. 11)";GUDRUČIAI;1750311606;Ne;7;0;4;11
22097;"Pumpurėlis (Trinapolio g. 11)";PABIRUČIAI;9824315755;Ne;11;2;0;13
22098;"Pumpurėlis (Trinapolio g. 11)";PABIRUČIAI;4565317498;Ne;0;0;3;3
22099;"Pumpurėlis (Trinapolio g. 11)";PABIRUČIAI;7910361194;Ne;18;0;1;19
22100;"Pumpurėlis (Trinapolio g. 11)";PABIRUČIAI;5403012236;Ne;7;0;2;9
22101;"Pumpurėlis (Trinapolio g. 11)";PABIRUČIAI;7998027741;Ne;9;0;3;12
22102;"Pumpurėlis (Trinapolio g. 11)";PABIRUČIAI;4955734206;Ne;3;0;0;3
22103;"Pumpurėlis (Trinapolio g. 11)";PABIRUČIAI;8704865319;Ne;9;0;1;10
22104;"Pumpurėlis (Trinapolio g. 11)";PABIRUČIAI;4696006714;Ne;8;0;1;9
22105;"Pumpurėlis (Trinapolio g. 11)";PABIRUČIAI;9597889927;Ne;0;1;0;1
22106;"Pumpurėlis (Trinapolio g. 11)";PABIRUČIAI;2187090934;Ne;5;0;0;5
22107;"Pumpurėlis (Trinapolio g. 11)";PABIRUČIAI;1222204689;Ne;9;0;0;9
22108;"Pumpurėlis (Trinapolio g. 11)";PABIRUČIAI;9395698760;Ne;0;1;12;13
22109;"Gilužis (Įsruties g. 30)";"MEDYNĖLIO 1 GR.";8237963602;Ne;3;0;1;4
22110;"Gilužis (Įsruties g. 30)";"MEDYNĖLIO 1 GR.";9753512366;Ne;10;0;2;12
22111;"Gilužis (Įsruties g. 30)";"MEDYNĖLIO 1 GR.";6914566889;Ne;2;5;5;12
22112;"Gilužis (Įsruties g. 30)";"MEDYNĖLIO 1 GR.";1541283216;Ne;4;0;0;4
22113;"Gilužis (Įsruties g. 30)";"MEDYNĖLIO 1 GR.";5306278297;Ne;20;0;0;20
22114;"Gilužis (Įsruties g. 30)";"MEDYNĖLIO 1 GR.";1054809163;Ne;9;0;3;12
22115;"Gilužis (Įsruties g. 30)";"MEDYNĖLIO 1 GR.";7887970476;Ne;5;0;0;5
22116;"Gilužis (Įsruties g. 30)";"MEDYNĖLIO 1 GR.";6507021182;Ne;0;10;1;11
22117;"Gilužis (Įsruties g. 30)";"MEDYNĖLIO 1 GR.";4122073923;Ne;1;0;0;1
22118;"Gilužis (Įsruties g. 30)";"MEDYNĖLIO 1 GR.";2364391112;Ne;0;1;0;1
22119;"Gilužis (Įsruties g. 30)";"MEDYNĖLIO 1 GR.";6514483362;Ne;1;0;0;1
22120;"Gilužis (Įsruties g. 30)";"MEDYNĖLIO 1 GR.";3081351563;Ne;4;1;0;5
22121;"Gilužis (Įsruties g. 30)";"MEDYNĖLIO 2 GR.";4927117901;Ne;0;0;5;5
22122;"Gilužis (Įsruties g. 30)";"MEDYNĖLIO 2 GR.";7247606321;Ne;10;0;1;11
22123;"Gilužis (Įsruties g. 30)";"MEDYNĖLIO 2 GR.";5664892047;Ne;5;0;1;6
22124;"Gilužis (Įsruties g. 30)";"MEDYNĖLIO 2 GR.";3379889899;Ne;9;0;0;9
22125;"Gilužis (Įsruties g. 30)";"MEDYNĖLIO 2 GR.";2915024298;Ne;0;0;6;6
22126;"Gilužis (Įsruties g. 30)";"MEDYNĖLIO 2 GR.";8717811266;Ne;4;0;1;5
22127;"Gilužis (Įsruties g. 30)";"MEDYNĖLIO 2 GR.";5769955074;Ne;3;0;0;3
22128;"Gilužis (Įsruties g. 30)";"MEDYNĖLIO 2 GR.";7487731015;Ne;2;0;5;7
22129;"Gilužis (Įsruties g. 30)";"MEDYNĖLIO 2 GR.";5079154238;Ne;2;0;4;6
22130;"Gilužis (Įsruties g. 30)";"MEDYNĖLIO 2 GR.";8904873416;Ne;2;0;0;2
22131;"Gilužis (Įsruties g. 30)";"MEDYNĖLIO 2 GR.";2851682356;Ne;0;5;1;6
22132;"Gilužis (Įsruties g. 30)";"MEDYNĖLIO 2 GR.";3917385813;Ne;8;0;0;8
22133;"Gilužis (Įsruties g. 30)";"STRAZDELIO GR.";8477445384;Ne;7;0;6;13
22134;"Gilužis (Įsruties g. 30)";"STRAZDELIO GR.";6766559505;Taip;7;0;1;8
22135;"Gilužis (Įsruties g. 30)";"STRAZDELIO GR.";3194397689;Ne;8;6;0;14
22136;"Gilužis (Įsruties g. 30)";"STRAZDELIO GR.";5737505086;Ne;0;21;0;21
22137;"Gilužis (Įsruties g. 30)";"STRAZDELIO GR.";3414489196;Ne;5;4;2;11
22138;"Gilužis (Įsruties g. 30)";"STRAZDELIO GR.";6586605929;Ne;15;0;0;15
22139;"Gilužis (Įsruties g. 30)";"STRAZDELIO GR.";3331616067;Ne;0;0;3;3
22140;"Gilužis (Įsruties g. 30)";"STRAZDELIO GR.";3729538163;Ne;2;0;1;3
22141;"Gilužis (Įsruties g. 30)";"STRAZDELIO GR.";4325300253;Ne;5;0;1;6
22142;"Gilužis (Įsruties g. 30)";"STRAZDELIO GR.";6207304860;Ne;11;0;0;11
22143;"Gilužis (Įsruties g. 30)";"STRAZDELIO GR.";5921538837;Ne;5;0;0;5
22144;"Gilužis (Įsruties g. 30)";"STRAZDELIO GR.";7053810996;Ne;0;0;5;5
22145;"Gilužis (Įsruties g. 30)";"STRAZDELIO GR.";9846916206;Ne;18;0;0;18
22146;"Gilužis (Įsruties g. 30)";"STRAZDELIO GR.";2398220397;Ne;8;0;2;10
22147;"Gilužis (Įsruties g. 30)";"STRAZDELIO GR.";3187000487;Ne;2;4;0;6
22148;"Gilužis (Įsruties g. 30)";"STRAZDELIO GR.";1826248450;Ne;6;4;0;10
22149;"Gilužis (Įsruties g. 30)";"STRAZDELIO GR.";9325927745;Ne;0;0;17;17
22150;"Gilužis (Įsruties g. 30)";"STRAZDELIO GR.";1758670627;Ne;0;0;4;4
22151;"Pilaitukas (Įsruties g. 27)";ŠNEKUČIAI;9940643503;Ne;2;0;0;2
22152;"Pilaitukas (Įsruties g. 27)";ŠNEKUČIAI;1445759374;Ne;0;3;0;3
22153;"Pilaitukas (Įsruties g. 27)";ŠNEKUČIAI;1859101624;Ne;8;0;1;9
22154;"Pilaitukas (Įsruties g. 27)";ŠNEKUČIAI;8479229073;Ne;3;0;3;6
22155;"Pilaitukas (Įsruties g. 27)";ŠNEKUČIAI;9731380502;Ne;3;1;0;4
22156;"Pilaitukas (Įsruties g. 27)";ŠNEKUČIAI;7224121082;Ne;6;0;0;6
22157;"Pilaitukas (Įsruties g. 27)";ŠNEKUČIAI;1082342063;Ne;4;0;0;4
22158;"Pilaitukas (Įsruties g. 27)";ŠNEKUČIAI;8801482035;Ne;1;0;1;2
22159;"Pilaitukas (Įsruties g. 27)";ŠNEKUČIAI;9622989196;Ne;0;0;4;4
22160;"Pilaitukas (Įsruties g. 27)";ŠNEKUČIAI;1356473379;Ne;0;8;0;8
22161;"Pilaitukas (Įsruties g. 27)";ŠNEKUČIAI;1309209771;Ne;2;0;1;3
22162;"Pilaitukas (Įsruties g. 27)";SMALSUČIAI;1414751236;Ne;0;0;2;2
22163;"Pilaitukas (Įsruties g. 27)";SMALSUČIAI;3215689222;Ne;0;0;1;1
22164;"Pilaitukas (Įsruties g. 27)";SMALSUČIAI;1974429718;Ne;5;6;5;16
22165;"Pilaitukas (Įsruties g. 27)";SMALSUČIAI;4544849086;Ne;10;0;2;12
22166;"Pilaitukas (Įsruties g. 27)";SMALSUČIAI;6934677745;Ne;4;0;0;4
22167;"Pilaitukas (Įsruties g. 27)";SMALSUČIAI;4608105047;Ne;13;0;1;14
22168;"Pilaitukas (Įsruties g. 27)";SMALSUČIAI;8698639192;Ne;4;0;1;5
22169;"Pilaitukas (Įsruties g. 27)";SMALSUČIAI;3501783231;Ne;5;0;1;6
22170;"Pilaitukas (Įsruties g. 27)";SMALSUČIAI;4898803794;Ne;21;0;0;21
22171;"Pilaitukas (Įsruties g. 27)";SMALSUČIAI;3544734838;Ne;0;0;2;2
22172;"Pilaitukas (Įsruties g. 27)";SMALSUČIAI;7034013577;Ne;4;0;1;5
22173;"Pilaitukas (Įsruties g. 27)";SMALSUČIAI;1793393776;Ne;0;1;3;4
22174;"Pilaitukas (Įsruties g. 27)";SMALSUČIAI;6906821879;Ne;5;0;0;5
22175;"Pilaitukas (Įsruties g. 27)";" GUDRUČIAI";87035008129;Ne;0;4;0;4
22176;"Pilaitukas (Įsruties g. 27)";" GUDRUČIAI";9921730735;Ne;0;1;0;1
22177;"Pilaitukas (Įsruties g. 27)";" GUDRUČIAI";3489297719;Ne;0;0;1;1
22178;"Pilaitukas (Įsruties g. 27)";" GUDRUČIAI";3068325053;Ne;0;0;2;2
22179;"Pilaitukas (Įsruties g. 27)";" GUDRUČIAI";1571691020;Ne;0;0;2;2
22180;"Pilaitukas (Įsruties g. 27)";" GUDRUČIAI";7904142328;Ne;5;4;0;9
22181;"Pilaitukas (Įsruties g. 27)";" GUDRUČIAI";9186679454;Ne;0;0;1;1
22182;"Pilaitukas (Įsruties g. 27)";" GUDRUČIAI";8584321345;Ne;8;0;0;8
22183;"Pilaitukas (Įsruties g. 27)";" GUDRUČIAI";3483758882;Ne;0;4;2;6
22184;"Pilaitukas (Įsruties g. 27)";" GUDRUČIAI";3674481373;Ne;0;1;1;2
22185;"Pilaitukas (Įsruties g. 27)";" GUDRUČIAI";1517834246;Ne;3;0;0;3
22186;"Pilaitukas (Įsruties g. 27)";" GUDRUČIAI";87760608710;Ne;0;0;1;1
22187;"Pilaitukas (Įsruties g. 27)";" GUDRUČIAI";93271260871;Ne;10;0;0;10
22188;"Pilaitukas (Įsruties g. 27)";" GUDRUČIAI";8928237970;Ne;12;0;0;12
22189;"Pilaitukas (Įsruties g. 27)";" GUDRUČIAI";2819283284;Ne;7;0;0;7
22190;"Pilaitukas (Įsruties g. 27)";" GUDRUČIAI";5574732283;Ne;0;1;4;5
22191;"Pilaitukas (Įsruties g. 27)";" GUDRUČIAI";7380303098;Ne;0;7;0;7
22192;"Pilaitukas (Įsruties g. 27)";" GUDRUČIAI";1430155044;Ne;0;2;6;8
22193;"Pilaitukas (Įsruties g. 27)";" GUDRUČIAI";3621245783;Ne;0;0;4;4
22194;"Pilaitukas (Įsruties g. 27)";" GUDRUČIAI";2682252810;Ne;5;0;1;6
22195;"Pilaitukas (Įsruties g. 27)";" GUDRUČIAI";7290732562;Ne;0;4;2;6
22196;"Pilaitukas (Įsruties g. 27)";" GUDRUČIAI";3927118900;Ne;0;6;5;11
22197;"Pilaitukas (Įsruties g. 27)";" GUDRUČIAI";5464065587;Ne;0;2;0;2
