Nr.;"Darželio pavadinimas";"Grupės pavadinimas";"Vaiko Identifikacinis Nr.";"Deklaruotas mieste";"Pateisintos dėl ligos";"Pateisintos dėl kitų priežasčių";"Nepateisintos dienos";"Praleistos dienos Viso"
1;Aitvaras;"VIJURKAI (ALERG.)";6936031222;Ne;0;0;5;5
2;Aitvaras;"VIJURKAI (ALERG.)";6214880713;Ne;0;2;0;2
3;Aitvaras;"VIJURKAI (ALERG.)";2566375128;Ne;0;2;0;2
4;Aitvaras;"VIJURKAI (ALERG.)";1879540041;Ne;0;3;0;3
5;Aitvaras;"VIJURKAI (ALERG.)";8206046301;Ne;9;0;1;10
6;Aitvaras;"VIJURKAI (ALERG.)";9157794193;Ne;15;1;0;16
7;Aitvaras;"VIJURKAI (ALERG.)";9562494357;Ne;6;3;0;9
8;Aitvaras;"VIJURKAI (ALERG.)";6021342178;Ne;0;2;0;2
9;Aitvaras;"VIJURKAI (ALERG.)";2650483861;Ne;1;1;0;2
10;Aitvaras;"VIJURKAI (ALERG.)";2601983670;Ne;0;1;0;1
11;Aitvaras;"VIJURKAI (ALERG.)";6444377924;Ne;6;0;0;6
12;Aitvaras;"SMALSUČIAI (ALERG.)";6166757095;Ne;6;0;2;8
13;Aitvaras;"SMALSUČIAI (ALERG.)";4480921300;Ne;6;0;0;6
14;Aitvaras;"SMALSUČIAI (ALERG.)";1019661577;Ne;5;0;0;5
15;Aitvaras;"SMALSUČIAI (ALERG.)";6201118021;Ne;7;0;1;8
16;Aitvaras;"SMALSUČIAI (ALERG.)";5750154036;Ne;1;1;0;2
17;Aitvaras;"SMALSUČIAI (ALERG.)";1275561645;Ne;1;0;0;1
18;Aitvaras;"SMALSUČIAI (ALERG.)";2004112424;Ne;4;1;0;5
19;Aitvaras;"SMALSUČIAI (ALERG.)";5330618557;Ne;7;0;0;7
20;Aitvaras;"SMALSUČIAI (ALERG.)";3488467265;Ne;0;2;0;2
21;Aitvaras;"SMALSUČIAI (ALERG.)";9745864667;Ne;4;1;0;5
22;Aitvaras;"SMALSUČIAI (ALERG.)";9810370596;Ne;0;1;0;1
23;Aitvaras;"SMALSUČIAI (ALERG.)";3535659630;Ne;0;3;1;4
24;Aitvaras;"SMALSUČIAI (ALERG.)";4833313373;Ne;4;0;1;5
25;Aitvaras;"SMALSUČIAI (ALERG.)";24247118884;Ne;0;4;0;4
26;Aitvaras;"SMALSUČIAI (ALERG.)";5504431748;Ne;4;0;0;4
27;Aitvaras;"SMALSUČIAI (ALERG.)";5389627560;Ne;0;2;7;9
28;Aitvaras;"SMALSUČIAI (ALERG.)";1636794584;Ne;0;3;0;3
29;Aitvaras;"SMALSUČIAI (ALERG.)";5956333024;Ne;0;2;0;2
30;Aitvaras;"SMALSUČIAI (ALERG.)";5595233402;Ne;6;0;3;9
31;Aitvaras;PADAUŽIUKAI;9332771711;Ne;8;0;0;8
32;Aitvaras;PADAUŽIUKAI;6550426644;Ne;5;7;0;12
33;Aitvaras;PADAUŽIUKAI;5818794912;Ne;0;2;0;2
34;Aitvaras;PADAUŽIUKAI;58780461337;Ne;0;0;4;4
35;Aitvaras;PADAUŽIUKAI;2034293999;Ne;20;0;0;20
36;Aitvaras;PADAUŽIUKAI;43711349817;Ne;4;0;1;5
37;Aitvaras;PADAUŽIUKAI;2804106417;Ne;0;5;0;5
38;Aitvaras;PADAUŽIUKAI;2711888522;Ne;0;5;0;5
39;Aitvaras;PADAUŽIUKAI;1996524718;Ne;0;2;0;2
40;Aitvaras;PADAUŽIUKAI;4110585744;Ne;0;7;0;7
41;Aitvaras;PADAUŽIUKAI;2330782717;Ne;9;0;0;9
42;Aitvaras;PADAUŽIUKAI;40799643122;Ne;3;2;0;5
43;Aitvaras;PADAUŽIUKAI;9015675095;Ne;7;0;0;7
44;Aitvaras;PADAUŽIUKAI;8503279655;Ne;0;1;0;1
45;Aitvaras;PADAUŽIUKAI;8121858940;Ne;9;0;1;10
46;Aitvaras;"AITVARIUKAI (ALERG.)";7243387750;Ne;12;3;0;15
47;Aitvaras;"AITVARIUKAI (ALERG.)";6587437949;Ne;0;3;0;3
48;Aitvaras;"AITVARIUKAI (ALERG.)";7461284958;Ne;4;1;0;5
49;Aitvaras;"AITVARIUKAI (ALERG.)";3394251305;Ne;2;1;0;3
50;Aitvaras;"AITVARIUKAI (ALERG.)";6459307767;Ne;1;1;0;2
51;Aitvaras;"AITVARIUKAI (ALERG.)";5635576679;Ne;6;1;0;7
52;Aitvaras;"AITVARIUKAI (ALERG.)";7988247429;Ne;0;2;3;5
53;Aitvaras;"AITVARIUKAI (ALERG.)";8770777328;Ne;0;3;0;3
54;Aitvaras;"AITVARIUKAI (ALERG.)";3653879553;Ne;0;2;1;3
55;Aitvaras;"AITVARIUKAI (ALERG.)";9721273154;Ne;9;0;0;9
56;Aitvaras;"AITVARIUKAI (ALERG.)";5103105065;Ne;20;0;0;20
57;Aitvaras;"AITVARIUKAI (ALERG.)";8543644000;Ne;0;1;0;1
58;Aitvaras;"AITVARIUKAI (ALERG.)";1859647003;Ne;9;0;0;9
59;Aitvaras;"AITVARIUKAI (ALERG.)";4204923580;Ne;0;2;0;2
60;Aitvaras;"AITVARIUKAI (ALERG.)";4777266938;Ne;11;3;0;14
61;Aitvaras;"AITVARIUKAI (ALERG.)";7568388141;Ne;7;1;0;8
62;Aitvaras;"AITVARIUKAI (ALERG.)";3954840915;Ne;1;2;0;3
63;Aitvaras;"AITVARIUKAI (ALERG.)";2146963673;Ne;13;0;0;13
64;Aitvaras;"AITVARIUKAI (ALERG.)";9763502346;Ne;6;6;0;12
65;Aitvaras;"AITVARIUKAI (ALERG.)";9228736015;Ne;5;6;0;11
66;Aitvaras;"AITVARIUKAI (ALERG.)";3775634117;Ne;0;2;0;2
67;Aitvaras;"AITVARIUKAI (ALERG.)";2615576367;Ne;11;1;0;12
68;Aitvaras;"SAULĖS ZUIKUČIAI  (ALERG.)";5711324951;Ne;0;1;0;1
69;Aitvaras;"SAULĖS ZUIKUČIAI  (ALERG.)";5619137905;Ne;0;2;3;5
70;Aitvaras;"SAULĖS ZUIKUČIAI  (ALERG.)";4106097701;Ne;0;1;0;1
71;Aitvaras;"SAULĖS ZUIKUČIAI  (ALERG.)";2184231202;Ne;2;6;0;8
72;Aitvaras;"SAULĖS ZUIKUČIAI  (ALERG.)";2478737835;Ne;7;0;0;7
73;Aitvaras;"SAULĖS ZUIKUČIAI  (ALERG.)";1136438927;Ne;0;1;0;1
74;Aitvaras;"SAULĖS ZUIKUČIAI  (ALERG.)";8137900398;Ne;0;1;0;1
75;Aitvaras;"SAULĖS ZUIKUČIAI  (ALERG.)";9147954612;Ne;0;0;4;4
76;Aitvaras;"SAULĖS ZUIKUČIAI  (ALERG.)";2511844613;Ne;5;0;0;5
77;Aitvaras;"SAULĖS ZUIKUČIAI  (ALERG.)";7907357058;Ne;3;0;0;3
78;Aitvaras;"SAULĖS ZUIKUČIAI  (ALERG.)";9534206000;Ne;0;0;4;4
79;Aitvaras;"SAULĖS ZUIKUČIAI  (ALERG.)";3737054758;Ne;7;0;6;13
80;Aitvaras;"SAULĖS ZUIKUČIAI  (ALERG.)";9271534775;Ne;9;0;0;9
81;Aitvaras;"SAULĖS ZUIKUČIAI  (ALERG.)";8849563638;Ne;4;0;0;4
82;Aitvaras;"SAULĖS ZUIKUČIAI  (ALERG.)";6950820937;Ne;7;0;3;10
83;Aitvaras;"SAULĖS ZUIKUČIAI  (ALERG.)";5252728205;Ne;0;0;1;1
84;Aitvaras;"SAULĖS ZUIKUČIAI  (ALERG.)";2373509019;Ne;13;0;1;14
85;Aitvaras;"SAULĖS ZUIKUČIAI  (ALERG.)";2624566766;Ne;8;0;0;8
86;Aitvaras;"SAULĖS ZUIKUČIAI  (ALERG.)";3677551059;Ne;5;1;0;6
87;Aitvaras;"ŽEMYNUKAI (ALERG.)";8567255042;Ne;9;0;1;10
88;Aitvaras;"ŽEMYNUKAI (ALERG.)";6218019092;Ne;9;4;4;17
89;Aitvaras;"ŽEMYNUKAI (ALERG.)";3820930777;Ne;28;1;0;29
90;Aitvaras;"ŽEMYNUKAI (ALERG.)";4733627644;Ne;11;2;8;21
91;Aitvaras;"ŽEMYNUKAI (ALERG.)";3104109370;Ne;0;0;8;8
92;Aitvaras;"ŽEMYNUKAI (ALERG.)";7853714142;Ne;11;0;0;11
93;Aitvaras;"ŽEMYNUKAI (ALERG.)";1949144346;Ne;4;1;0;5
94;Aitvaras;"ŽEMYNUKAI (ALERG.)";8641433486;Ne;16;0;0;16
95;Aitvaras;"ŽEMYNUKAI (ALERG.)";3961423273;Ne;5;1;0;6
96;Aitvaras;"ŽEMYNUKAI (ALERG.)";9947610763;Ne;0;1;0;1
97;Aitvaras;"ŽEMYNUKAI (ALERG.)";7113016866;Ne;0;5;0;5
98;Aitvaras;"ŽEMYNUKAI (ALERG.)";4377666052;Ne;7;3;3;13
99;Aitvaras;"ŽEMYNUKAI (ALERG.)";8333823078;Ne;5;0;0;5
100;Aitvaras;"ŽEMYNUKAI (ALERG.)";5623106419;Ne;0;0;2;2
101;Aitvaras;"ŽEMYNUKAI (ALERG.)";5351333397;Ne;0;3;0;3
102;Aitvaras;"ŽEMYNUKAI (ALERG.)";2065988478;Ne;6;0;4;10
103;Aitvaras;"ŽEMYNUKAI (ALERG.)";3635354769;Ne;7;1;0;8
104;Aitvaras;"ŽEMYNUKAI (ALERG.)";3851322849;Ne;0;0;2;2
105;Aitvaras;"ŽEMYNUKAI (ALERG.)";7889947603;Ne;0;10;1;11
106;Aitvaras;"ŽEMYNUKAI (ALERG.)";1662289664;Ne;2;0;0;2
107;Aitvaras;"ŽEMYNUKAI (ALERG.)";2839442228;Taip;11;0;5;16
108;Aitvaras;"LINKSMUČIAI (ALERG.)";5378212904;Ne;10;1;0;11
109;Aitvaras;"LINKSMUČIAI (ALERG.)";1091372798;Ne;0;9;0;9
110;Aitvaras;"LINKSMUČIAI (ALERG.)";8666824607;Ne;3;1;0;4
111;Aitvaras;"LINKSMUČIAI (ALERG.)";1599183050;Ne;8;0;0;8
112;Aitvaras;"LINKSMUČIAI (ALERG.)";4613894944;Ne;0;1;1;2
113;Aitvaras;"LINKSMUČIAI (ALERG.)";4120515569;Ne;16;0;0;16
114;Aitvaras;"LINKSMUČIAI (ALERG.)";9885781306;Ne;0;2;1;3
115;Aitvaras;"LINKSMUČIAI (ALERG.)";4612994715;Ne;2;3;6;11
116;Aitvaras;"LINKSMUČIAI (ALERG.)";4176681907;Ne;0;5;0;5
117;Aitvaras;"LINKSMUČIAI (ALERG.)";6286268740;Ne;3;2;0;5
118;Aitvaras;"LINKSMUČIAI (ALERG.)";2547934790;Ne;8;0;0;8
119;Aitvaras;"LINKSMUČIAI (ALERG.)";4114397590;Ne;0;1;0;1
120;Aitvaras;NAMINUKAI;3053557807;Ne;6;1;1;8
121;Aitvaras;NAMINUKAI;6126913961;Ne;2;1;0;3
122;Aitvaras;NAMINUKAI;3347213578;Ne;1;0;4;5
123;Aitvaras;NAMINUKAI;9024245490;Ne;0;2;0;2
124;Aitvaras;NAMINUKAI;8512502118;Ne;0;1;0;1
125;Aitvaras;NAMINUKAI;9039303562;Ne;5;1;2;8
126;Aitvaras;NAMINUKAI;6080549524;Ne;3;1;2;6
127;Aitvaras;NAMINUKAI;4555281655;Ne;0;1;0;1
128;Aitvaras;NAMINUKAI;8043062737;Ne;0;4;0;4
129;Aitvaras;NAMINUKAI;1549552392;Ne;12;1;0;13
130;Aitvaras;NAMINUKAI;4498792867;Ne;2;6;0;8
131;Aitvaras;NAMINUKAI;9490714865;Ne;0;4;0;4
132;Aitvaras;NAMINUKAI;1498630458;Ne;0;2;1;3
133;Aitvaras;NAMINUKAI;5967188507;Ne;0;2;3;5
134;Aitvaras;NAMINUKAI;5161069611;Ne;0;2;2;4
135;Aitvaras;NAMINUKAI;7934344218;Ne;5;1;1;7
136;Aitvaras;NAMINUKAI;6279152796;Ne;4;0;0;4
137;Aitvaras;ŠELMIAI;4984058405;Ne;0;3;0;3
138;Aitvaras;ŠELMIAI;9725401255;Ne;19;0;1;20
139;Aitvaras;ŠELMIAI;4547342872;Ne;0;2;1;3
140;Aitvaras;ŠELMIAI;5684526288;Ne;15;1;0;16
141;Aitvaras;ŠELMIAI;7764574135;Ne;2;0;0;2
142;Aitvaras;ŠELMIAI;5601517340;Ne;4;9;0;13
143;Aitvaras;ŠELMIAI;1019103539;Ne;0;2;0;2
144;Aitvaras;ŠELMIAI;2185746898;Ne;1;0;0;1
145;Aitvaras;ŠELMIAI;8756012613;Ne;0;1;0;1
146;Aitvaras;ŠELMIAI;1203732956;Ne;14;2;3;19
147;Aitvaras;ŠELMIAI;5782609781;Ne;8;2;0;10
148;Aitvaras;ŠELMIAI;7805819121;Ne;0;2;0;2
149;Aitvaras;ŠELMIAI;8558414510;Ne;1;0;0;1
150;Aitvaras;ŠELMIAI;4551774368;Ne;1;0;0;1
151;Aitvaras;ŠELMIAI;4158520145;Ne;7;5;0;12
152;Aitvaras;ŠELMIAI;7352233454;Ne;2;0;0;2
153;Aitvaras;ŠELMIAI;1901118931;Ne;0;3;0;3
154;Aitvaras;ŠELMIAI;4812423010;Ne;3;3;1;7
155;Aitvaras;ŠELMIAI;1112142035;Ne;1;0;0;1
156;Aitvaras;ŠELMIAI;8644983502;Ne;8;1;0;9
157;Aitvaras;ŠELMIAI;9295561516;Ne;0;5;0;5
158;Aitvaras;ŠELMIAI;6188186413;Ne;0;4;11;15
159;Aitvaras;KODĖLČIUKAI;6214572150;Ne;10;1;0;11
160;Aitvaras;KODĖLČIUKAI;3323458595;Ne;0;2;0;2
161;Aitvaras;KODĖLČIUKAI;8065540507;Ne;0;1;5;6
162;Aitvaras;KODĖLČIUKAI;1288810999;Ne;0;0;1;1
163;Aitvaras;KODĖLČIUKAI;6501943902;Ne;0;6;0;6
164;Aitvaras;KODĖLČIUKAI;7777235021;Ne;1;1;0;2
165;Aitvaras;KODĖLČIUKAI;5641224483;Ne;0;2;0;2
166;Aitvaras;KODĖLČIUKAI;1830134108;Ne;0;1;6;7
167;Aitvaras;KODĖLČIUKAI;5905456814;Ne;0;1;0;1
168;Aitvaras;KODĖLČIUKAI;6739827530;Ne;5;0;0;5
169;Aitvaras;KODĖLČIUKAI;2807595769;Ne;0;2;1;3
170;Aitvaras;KODĖLČIUKAI;1252145346;Ne;11;0;0;11
171;Aitvaras;KODĖLČIUKAI;7455895024;Ne;0;0;1;1
172;Aitvaras;KODĖLČIUKAI;8439586875;Ne;0;2;0;2
173;Aitvaras;KODĖLČIUKAI;2328771385;Ne;0;10;0;10
174;Aitvaras;KODĖLČIUKAI;3735941659;Ne;11;0;0;11
175;Aitvaras;KODĖLČIUKAI;8360380303;Ne;4;0;0;4
176;Aitvaras;KODĖLČIUKAI;1594675221;Ne;0;2;1;3
177;Aitvaras;KODĖLČIUKAI;5922357091;Ne;2;1;0;3
178;Aitvaras;PABIRUČIAI;1495399113;Ne;4;0;0;4
179;Aitvaras;PABIRUČIAI;7136674662;Ne;0;1;0;1
180;Aitvaras;PABIRUČIAI;9949206639;Ne;0;0;5;5
181;Aitvaras;PABIRUČIAI;4613021421;Ne;0;1;0;1
182;Aitvaras;PABIRUČIAI;2887681961;Ne;0;11;0;11
183;Aitvaras;PABIRUČIAI;7922937851;Ne;4;0;0;4
184;Aitvaras;PABIRUČIAI;4085134058;Ne;9;4;0;13
185;Aitvaras;PABIRUČIAI;8746884740;Ne;5;0;0;5
186;Aitvaras;PABIRUČIAI;4163871634;Ne;14;2;0;16
187;Aitvaras;PABIRUČIAI;3988226974;Ne;14;2;0;16
188;Aitvaras;PABIRUČIAI;1070324386;Ne;4;0;0;4
189;Aitvaras;PABIRUČIAI;2239387580;Ne;5;1;1;7
190;Aitvaras;PABIRUČIAI;6119148164;Ne;0;2;1;3
191;Aitvaras;PABIRUČIAI;2892898328;Ne;0;8;0;8
192;Aitvaras;PABIRUČIAI;3749008647;Ne;7;0;5;12
193;Aitvaras;PABIRUČIAI;4760801928;Ne;10;0;6;16
194;Aitvaras;PABIRUČIAI;1599296739;Taip;0;0;9;9
195;Aitvaras;"SVAJOKLIAI  (ALERG.)";3429046261;Ne;5;0;0;5
196;Aitvaras;"SVAJOKLIAI  (ALERG.)";5659897032;Ne;20;0;0;20
197;Aitvaras;"SVAJOKLIAI  (ALERG.)";4618560397;Ne;8;1;0;9
198;Aitvaras;"SVAJOKLIAI  (ALERG.)";9209862610;Ne;0;11;0;11
199;Aitvaras;"SVAJOKLIAI  (ALERG.)";6191938291;Ne;15;0;0;15
200;Aitvaras;"SVAJOKLIAI  (ALERG.)";7006713502;Ne;2;0;3;5
201;Aitvaras;"SVAJOKLIAI  (ALERG.)";3923601422;Ne;3;2;0;5
202;Aitvaras;"SVAJOKLIAI  (ALERG.)";5790551266;Ne;8;0;0;8
203;Aitvaras;"SVAJOKLIAI  (ALERG.)";2975696317;Ne;5;0;0;5
204;Aitvaras;"SVAJOKLIAI  (ALERG.)";3891067128;Ne;0;0;3;3
205;Aitvaras;"SVAJOKLIAI  (ALERG.)";1030872812;Ne;0;1;0;1
206;Aitvaras;"SVAJOKLIAI  (ALERG.)";8352951885;Ne;5;0;3;8
207;Aitvaras;"SVAJOKLIAI  (ALERG.)";5593105541;Ne;12;1;0;13
208;Aitvaras;"SVAJOKLIAI  (ALERG.)";8963214183;Ne;0;0;2;2
209;Aitvaras;"SVAJOKLIAI  (ALERG.)";6319953077;Ne;6;0;0;6
210;Aitvaras;"SVAJOKLIAI  (ALERG.)";1131690624;Ne;0;4;0;4
211;Aitvaras;"SVAJOKLIAI  (ALERG.)";4801034095;Ne;7;1;0;8
212;Aitvaras;"SVAJOKLIAI  (ALERG.)";6916032116;Ne;0;1;0;1
213;Atžalėlės;Gėlytės;4284673729;Ne;4;10;6;20
214;Atžalėlės;Gėlytės;8695865604;Ne;6;2;0;8
215;Atžalėlės;Gėlytės;2385614957;Ne;5;0;0;5
216;Atžalėlės;Gėlytės;5432433423;Taip;1;6;0;7
217;Atžalėlės;Gėlytės;9715625283;Ne;9;5;0;14
218;Atžalėlės;Gėlytės;4682216852;Ne;0;4;0;4
219;Atžalėlės;Gėlytės;2131592139;Ne;11;0;0;11
220;Atžalėlės;Gėlytės;3191066669;Ne;4;0;0;4
221;Atžalėlės;Gėlytės;1500456945;Ne;3;0;7;10
222;Atžalėlės;Gėlytės;1722233272;Ne;6;6;0;12
223;Atžalėlės;Gėlytės;7702502252;Ne;0;12;0;12
224;Atžalėlės;Gėlytės;9189223222;Ne;0;16;0;16
225;Atžalėlės;Gėlytės;3283415814;Ne;0;4;0;4
226;Atžalėlės;Gėlytės;1146492807;Ne;1;0;1;2
227;Atžalėlės;Gėlytės;3870758086;Ne;0;1;0;1
228;Atžalėlės;Gėlytės;6202250600;Ne;9;0;3;12
229;Atžalėlės;Gėlytės;6177038838;Ne;1;0;0;1
230;Atžalėlės;Gėlytės;5742471497;Ne;5;0;0;5
231;Atžalėlės;Gėlytės;1137741059;Ne;19;0;0;19
232;Atžalėlės;Gėlytės;4238773173;Ne;0;0;3;3
233;Atžalėlės;Gėlytės;6597540627;Ne;3;0;1;4
234;Atžalėlės;Drugeliai;6903666624;Ne;0;0;5;5
235;Atžalėlės;Drugeliai;2315790531;Ne;3;7;0;10
236;Atžalėlės;Drugeliai;6782007470;Ne;1;12;0;13
237;Atžalėlės;Drugeliai;1805496887;Ne;5;0;4;9
238;Atžalėlės;Drugeliai;5147078840;Ne;0;2;0;2
239;Atžalėlės;Drugeliai;9222670655;Ne;0;5;0;5
240;Atžalėlės;Drugeliai;1429493246;Ne;0;1;0;1
241;Atžalėlės;Drugeliai;6114426973;Ne;0;4;0;4
242;Atžalėlės;Drugeliai;1456979448;Ne;0;5;0;5
243;Atžalėlės;Drugeliai;4032519781;Ne;0;2;0;2
244;Atžalėlės;Drugeliai;7756889911;Ne;0;1;0;1
245;Atžalėlės;Drugeliai;3422605135;Ne;0;0;2;2
246;Atžalėlės;Drugeliai;8718036014;Ne;17;0;0;17
247;Atžalėlės;Drugeliai;4884599397;Ne;17;0;0;17
248;Atžalėlės;Drugeliai;4902947406;Ne;0;0;2;2
249;Atžalėlės;Drugeliai;9463215947;Ne;0;1;0;1
250;Atžalėlės;Drugeliai;6570245757;Ne;5;0;2;7
251;Atžalėlės;Drugeliai;6695872204;Ne;9;1;0;10
252;Atžalėlės;Drugeliai;6393090675;Ne;2;0;0;2
253;Atžalėlės;Gandriukai;2083260403;Ne;8;2;0;10
254;Atžalėlės;Gandriukai;3692090073;Ne;1;0;0;1
255;Atžalėlės;Gandriukai;2078549599;Ne;1;0;10;11
256;Atžalėlės;Gandriukai;5119260525;Taip;9;0;0;9
257;Atžalėlės;Gandriukai;1024559742;Ne;1;0;0;1
258;Atžalėlės;Gandriukai;7510951079;Ne;11;1;0;12
259;Atžalėlės;Gandriukai;6594440062;Ne;15;0;0;15
260;Atžalėlės;Gandriukai;4293557144;Ne;0;9;0;9
261;Atžalėlės;Gandriukai;6211002805;Ne;2;0;0;2
262;Atžalėlės;Gandriukai;1305611902;Ne;11;0;0;11
263;Atžalėlės;Voveriukai;8847754477;Ne;0;3;0;3
264;Atžalėlės;Voveriukai;3795729265;Ne;0;0;1;1
265;Atžalėlės;Voveriukai;8201582382;Ne;0;0;6;6
266;Atžalėlės;Voveriukai;4362058013;Ne;0;0;6;6
267;Atžalėlės;Voveriukai;8819893830;Ne;5;0;4;9
268;Atžalėlės;Voveriukai;3069192413;Ne;0;0;2;2
269;Atžalėlės;Voveriukai;2067246260;Ne;13;0;4;17
270;Atžalėlės;Voveriukai;7532672266;Ne;0;0;1;1
271;Atžalėlės;Voveriukai;5705303891;Taip;1;4;0;5
272;Atžalėlės;Voveriukai;5650427433;Ne;0;1;0;1
273;Atžalėlės;Voveriukai;6975941393;Ne;0;0;1;1
274;Atžalėlės;Voveriukai;8138683218;Ne;0;2;0;2
275;Atžalėlės;Voveriukai;7689394485;Ne;12;0;1;13
276;Atžalėlės;Voveriukai;1804802235;Ne;1;0;0;1
277;Atžalėlės;Voveriukai;4996777116;Ne;0;0;2;2
278;Atžalėlės;Voveriukai;1426744251;Ne;0;4;0;4
279;Atžalėlės;Voveriukai;8470059012;Ne;0;0;2;2
280;Atžalėlės;Voveriukai;5767549779;Ne;0;1;0;1
281;Atžalėlės;Žirniukai;2374624441;Ne;3;4;0;7
282;Atžalėlės;Žirniukai;9707462467;Ne;0;0;1;1
283;Atžalėlės;Žirniukai;5584105084;Ne;2;0;0;2
284;Atžalėlės;Žirniukai;9677943321;Ne;0;0;4;4
285;Atžalėlės;Žirniukai;9967641617;Ne;0;3;0;3
286;Atžalėlės;Žirniukai;9508110719;Ne;4;0;0;4
287;Atžalėlės;Žirniukai;9085453655;Ne;4;0;0;4
288;Atžalėlės;Žirniukai;1538643591;Ne;0;14;6;20
289;Atžalėlės;Žirniukai;3143856911;Ne;2;6;0;8
290;Atžalėlės;Žirniukai;1212074068;Ne;20;0;0;20
291;Atžalėlės;Žirniukai;9736390705;Ne;11;0;0;11
292;Atžalėlės;Žirniukai;4661388894;Ne;4;0;0;4
293;Atžalėlės;Žirniukai;5319794176;Ne;0;0;1;1
294;Atžalėlės;Žirniukai;7196464328;Ne;0;4;0;4
295;Atžalėlės;Žirniukai;7522643082;Ne;15;2;3;20
296;Atžalėlės;Žirniukai;7613931447;Ne;17;1;2;20
297;Atžalėlės;Žirniukai;6723689098;Ne;0;0;5;5
298;Atžalėlės;Žirniukai;9281138840;Taip;12;0;5;17
299;Atžalėlės;Žirniukai;7018297883;Ne;11;0;0;11
300;Atžalėlės;Ežiukai;9053620501;Ne;0;0;5;5
301;Atžalėlės;Ežiukai;9054589111;Ne;5;0;1;6
302;Atžalėlės;Ežiukai;9346744866;Taip;15;0;0;15
303;Atžalėlės;Ežiukai;1505286928;Ne;10;6;0;16
304;Atžalėlės;Ežiukai;4148412941;Ne;0;3;0;3
305;Atžalėlės;Ežiukai;1710646812;Ne;6;0;1;7
306;Atžalėlės;Ežiukai;9481268935;Ne;6;5;1;12
307;Atžalėlės;Ežiukai;5972419628;Ne;13;3;0;16
308;Atžalėlės;Ežiukai;3738127350;Ne;7;0;0;7
309;Atžalėlės;Ežiukai;1423254771;Ne;11;0;3;14
310;Atžalėlės;Ežiukai;6665199013;Taip;11;3;0;14
311;Atžalėlės;Ežiukai;6108989129;Ne;0;0;2;2
312;Atžalėlės;Ežiukai;5174826594;Ne;0;0;4;4
313;Atžalėlės;Ežiukai;7501772398;Ne;0;0;3;3
314;Atžalėlės;Paukšteliai;7807313362;Ne;0;0;5;5
315;Atžalėlės;Paukšteliai;6537864486;Ne;9;0;0;9
316;Atžalėlės;Paukšteliai;8768704484;Ne;0;20;0;20
317;Atžalėlės;Paukšteliai;6675588261;Ne;0;20;0;20
318;Atžalėlės;Paukšteliai;8524244526;Ne;10;6;0;16
319;Atžalėlės;Paukšteliai;7321516783;Ne;9;0;4;13
320;Atžalėlės;Paukšteliai;6265777690;Ne;0;2;0;2
321;Atžalėlės;Paukšteliai;1844980319;Ne;4;0;1;5
322;Atžalėlės;Paukšteliai;8512283024;Ne;6;2;0;8
323;Atžalėlės;Paukšteliai;2078781673;Ne;5;0;0;5
324;Atžalėlės;Paukšteliai;1520206753;Ne;11;0;8;19
325;Atžalėlės;Paukšteliai;4790322154;Ne;0;1;0;1
326;Atžalėlės;Paukšteliai;4081717007;Ne;1;0;0;1
327;Atžalėlės;Paukšteliai;1089221288;Ne;5;0;0;5
328;Atžalėlės;Paukšteliai;4392352210;Ne;6;0;2;8
329;Atžalėlės;Paukšteliai;1774212280;Ne;15;0;5;20
330;Atžalėlės;Meškiukai;9925178685;Ne;0;0;2;2
331;Atžalėlės;Meškiukai;2617568019;Ne;1;6;0;7
332;Atžalėlės;Meškiukai;4233689945;Ne;3;0;2;5
333;Atžalėlės;Meškiukai;8619613890;Ne;1;0;5;6
334;Atžalėlės;Meškiukai;3281114596;Ne;0;13;7;20
335;Atžalėlės;Meškiukai;5466374223;Ne;0;0;4;4
336;Atžalėlės;Meškiukai;2433029299;Ne;1;0;0;1
337;Atžalėlės;Meškiukai;5682652546;Ne;2;0;8;10
338;Atžalėlės;Meškiukai;9631336340;Ne;8;1;0;9
339;Atžalėlės;Meškiukai;2930612059;Ne;0;0;20;20
340;Atžalėlės;Meškiukai;6385777303;Ne;4;0;3;7
341;Atžalėlės;Meškiukai;1431197358;Ne;15;5;0;20
342;Atžalėlės;Meškiukai;4177753994;Ne;0;0;4;4
343;Atžalėlės;Meškiukai;3743308789;Ne;5;0;0;5
344;Atžalėlės;Meškiukai;7936991925;Taip;0;0;1;1
345;Atžalėlės;"BITUTĖS (MODULINĖ)";8707875125;Ne;7;6;0;13
346;Atžalėlės;"BITUTĖS (MODULINĖ)";8060332402;Ne;6;0;2;8
347;Atžalėlės;"BITUTĖS (MODULINĖ)";8396693160;Ne;8;2;0;10
348;Atžalėlės;"BITUTĖS (MODULINĖ)";6253257539;Ne;1;0;0;1
349;Atžalėlės;"BITUTĖS (MODULINĖ)";7052938312;Ne;9;1;0;10
350;Atžalėlės;"BITUTĖS (MODULINĖ)";3559977339;Ne;12;0;0;12
351;Atžalėlės;"BITUTĖS (MODULINĖ)";5593774275;Ne;6;1;2;9
352;Atžalėlės;"BITUTĖS (MODULINĖ)";1939076303;Ne;5;0;0;5
353;Atžalėlės;"BITUTĖS (MODULINĖ)";2322329918;Ne;7;0;0;7
354;Atžalėlės;"BITUTĖS (MODULINĖ)";6368553568;Ne;4;0;3;7
355;Atžalėlės;"ŠYPSENĖLĖS (MODULINĖ)";4071402757;Ne;10;5;0;15
356;Atžalėlės;"ŠYPSENĖLĖS (MODULINĖ)";1943349835;Ne;6;1;0;7
357;Atžalėlės;"ŠYPSENĖLĖS (MODULINĖ)";8564143904;Ne;1;0;13;14
358;Atžalėlės;"ŠYPSENĖLĖS (MODULINĖ)";3299724612;Ne;10;2;0;12
359;Atžalėlės;"BORUŽIUKAI (MODULINĖ)";7104671423;Ne;0;0;1;1
360;Atžalėlės;"BORUŽIUKAI (MODULINĖ)";3198845538;Ne;6;0;0;6
361;Atžalėlės;"BORUŽIUKAI (MODULINĖ)";8681809797;Ne;10;0;0;10
362;Atžalėlės;"BORUŽIUKAI (MODULINĖ)";3590987364;Ne;4;0;3;7
363;Atžalėlės;"BORUŽIUKAI (MODULINĖ)";6237597328;Ne;0;0;12;12
364;Atžalėlės;"BORUŽIUKAI (MODULINĖ)";1383944713;Ne;15;0;0;15
365;Atžalėlės;"BORUŽIUKAI (MODULINĖ)";9201449702;Ne;3;0;0;3
366;Atžalėlės;"BORUŽIUKAI (MODULINĖ)";7980775632;Taip;5;9;0;14
367;Atžalėlės;"SAULUTĖS (MODULINĖ)";4268941401;Ne;14;0;1;15
368;Atžalėlės;"SAULUTĖS (MODULINĖ)";1797932125;Ne;3;0;0;3
369;Atžalėlės;"SAULUTĖS (MODULINĖ)";2306086573;Ne;9;0;7;16
370;Atžalėlės;"SAULUTĖS (MODULINĖ)";5490741021;Ne;0;2;9;11
371;Atžalėlės;"SAULUTĖS (MODULINĖ)";8208908249;Ne;8;5;0;13
372;Atžalėlės;"SAULUTĖS (MODULINĖ)";6048763811;Ne;9;0;10;19
373;Aušrelė;PASAKIUKAI;1659335142;Ne;9;2;0;11
374;Aušrelė;PASAKIUKAI;2974714806;Ne;0;2;0;2
375;Aušrelė;PASAKIUKAI;6037757548;Ne;10;0;0;10
376;Aušrelė;PASAKIUKAI;7682402576;Ne;0;1;0;1
377;Aušrelė;PASAKIUKAI;1408751702;Ne;2;2;0;4
378;Aušrelė;PASAKIUKAI;6995749373;Ne;0;2;0;2
379;Aušrelė;PASAKIUKAI;1502146844;Ne;13;2;0;15
380;Aušrelė;PASAKIUKAI;8230362307;Ne;4;0;3;7
381;Aušrelė;PASAKIUKAI;4306578299;Taip;16;1;0;17
382;Aušrelė;PASAKIUKAI;6277405405;Ne;3;0;0;3
383;Aušrelė;PASAKIUKAI;3682523696;Ne;0;0;5;5
384;Aušrelė;PASAKIUKAI;34891640909;Ne;0;5;0;5
385;Aušrelė;PASAKIUKAI;3165692699;Ne;8;3;0;11
386;Aušrelė;BORUŽĖLĖS;6673034329;Ne;0;2;0;2
387;Aušrelė;BORUŽĖLĖS;4957581753;Ne;9;5;0;14
388;Aušrelė;BORUŽĖLĖS;1928260563;Ne;1;2;0;3
389;Aušrelė;BORUŽĖLĖS;8243716759;Ne;4;0;0;4
390;Aušrelė;BORUŽĖLĖS;1549962200;Ne;0;5;0;5
391;Aušrelė;BORUŽĖLĖS;4505922394;Ne;14;2;0;16
392;Aušrelė;BORUŽĖLĖS;7190665397;Ne;1;6;0;7
393;Aušrelė;BORUŽĖLĖS;2991828434;Ne;5;0;0;5
394;Aušrelė;BORUŽĖLĖS;8030685444;Ne;0;2;0;2
395;Aušrelė;BORUŽĖLĖS;1814972981;Ne;20;0;0;20
396;Aušrelė;BORUŽĖLĖS;3397741232;Ne;5;7;0;12
397;Aušrelė;SMALSUČIAI;6761263775;Ne;4;4;0;8
398;Aušrelė;SMALSUČIAI;3015028879;Ne;0;20;0;20
399;Aušrelė;SMALSUČIAI;2863655361;Ne;9;0;0;9
400;Aušrelė;SMALSUČIAI;2390128933;Ne;0;2;1;3
401;Aušrelė;SMALSUČIAI;8503309819;Ne;0;4;0;4
402;Aušrelė;SMALSUČIAI;2827216981;Ne;8;1;0;9
403;Aušrelė;SMALSUČIAI;9443641849;Ne;10;0;0;10
404;Aušrelė;SMALSUČIAI;7930717076;Ne;4;2;0;6
405;Aušrelė;SMALSUČIAI;7609339123;Ne;10;0;0;10
406;Aušrelė;SMALSUČIAI;1556010005;Taip;11;0;0;11
407;Aušrelė;SMALSUČIAI;5478028396;Ne;5;1;0;6
408;Aušrelė;SMALSUČIAI;7070013052;Ne;12;0;0;12
409;Aušrelė;SMALSUČIAI;3581155949;Ne;5;1;0;6
410;Aušrelė;SMALSUČIAI;2266390402;Ne;0;2;0;2
411;Aušrelė;SMALSUČIAI;8032661062;Ne;5;0;3;8
412;Aušrelė;SMALSUČIAI;1976613166;Ne;5;2;1;8
413;Aušrelė;KODĖLČIUKAI;7723159748;Ne;16;2;0;18
414;Aušrelė;KODĖLČIUKAI;7367268748;Ne;6;0;0;6
415;Aušrelė;KODĖLČIUKAI;5712867880;Ne;9;0;0;9
416;Aušrelė;KODĖLČIUKAI;3623813061;Ne;4;2;0;6
417;Aušrelė;KODĖLČIUKAI;8693750994;Ne;8;1;0;9
418;Aušrelė;KODĖLČIUKAI;7327544406;Ne;0;2;0;2
419;Aušrelė;KODĖLČIUKAI;9566144610;Ne;11;0;0;11
420;Aušrelė;KODĖLČIUKAI;6308519574;Ne;1;1;0;2
421;Aušrelė;KODĖLČIUKAI;6911735462;Ne;5;4;0;9
422;Aušrelė;KODĖLČIUKAI;4248808572;Ne;18;2;0;20
423;Aušrelė;KODĖLČIUKAI;5046027475;Ne;0;10;0;10
424;Aušrelė;KODĖLČIUKAI;8338569001;Ne;3;2;0;5
425;Aušrelė;KODĖLČIUKAI;2766357229;Ne;3;0;0;3
426;Aušrelė;KODĖLČIUKAI;7515666888;Ne;0;0;1;1
427;Aušrelė;KODĖLČIUKAI;8862488358;Ne;11;0;0;11
428;Aušrelė;KODĖLČIUKAI;4882556718;Ne;0;1;0;1
429;Aušrelė;KODĖLČIUKAI;6321332888;Ne;11;0;2;13
430;Aušrelė;PELĖDŽIUKAI;6109859056;Taip;9;0;0;9
431;Aušrelė;PELĖDŽIUKAI;3223092149;Ne;0;7;0;7
432;Aušrelė;PELĖDŽIUKAI;8580241126;Ne;3;0;2;5
433;Aušrelė;PELĖDŽIUKAI;2545065554;Ne;6;0;0;6
434;Aušrelė;PELĖDŽIUKAI;4227228548;Ne;0;5;0;5
435;Aušrelė;PELĖDŽIUKAI;8996445434;Ne;0;6;0;6
436;Aušrelė;PELĖDŽIUKAI;8411336992;Ne;0;0;3;3
437;Aušrelė;PELĖDŽIUKAI;8917907028;Ne;9;0;0;9
438;Aušrelė;PELĖDŽIUKAI;7494298336;Ne;10;0;0;10
439;Aušrelė;PELĖDŽIUKAI;4012186237;Ne;0;0;2;2
440;Aušrelė;PELĖDŽIUKAI;3738923947;Ne;2;1;0;3
441;Aušrelė;PELĖDŽIUKAI;5312189552;Ne;0;1;0;1
442;Aušrelė;PELĖDŽIUKAI;1642358593;Ne;5;0;0;5
443;Aušrelė;PELĖDŽIUKAI;2294224426;Ne;9;0;0;9
444;Aušrelė;PELĖDŽIUKAI;1276792874;Ne;0;0;6;6
445;Aušrelė;AITVARIUKAI;6833654667;Ne;0;6;0;6
446;Aušrelė;AITVARIUKAI;8102749675;Ne;0;5;0;5
447;Aušrelė;AITVARIUKAI;4595435635;Ne;7;1;0;8
448;Aušrelė;AITVARIUKAI;9608444990;Ne;0;0;1;1
449;Aušrelė;AITVARIUKAI;6434548772;Ne;17;0;0;17
450;Aušrelė;AITVARIUKAI;9158248746;Ne;3;1;0;4
451;Aušrelė;AITVARIUKAI;7978186455;Ne;0;20;0;20
452;Aušrelė;AITVARIUKAI;5602774323;Ne;0;2;0;2
453;Aušrelė;AITVARIUKAI;5708459561;Ne;15;0;0;15
454;Aušrelė;AITVARIUKAI;1039180129;Ne;0;1;0;1
455;Aušrelė;AITVARIUKAI;5125295651;Ne;5;0;0;5
456;Aušrelė;AITVARIUKAI;3807967685;Ne;2;0;0;2
457;Aušrelė;AITVARIUKAI;6081100604;Ne;6;2;4;12
458;Aušrelė;AITVARIUKAI;7847650967;Ne;7;1;0;8
459;Aušrelė;AITVARIUKAI;5727081833;Ne;12;1;0;13
460;Aušrelė;AITVARIUKAI;8210698019;Ne;0;20;0;20
461;Aušrelė;AITVARIUKAI;4942168388;Ne;0;20;0;20
462;Aušrelė;AITVARIUKAI;7788139791;Ne;3;0;0;3
463;Aušrelė;BITUTĖS;1741716341;Ne;0;20;0;20
464;Aušrelė;BITUTĖS;4989544273;Ne;0;2;0;2
465;Aušrelė;BITUTĖS;9960201865;Ne;0;1;0;1
466;Aušrelė;BITUTĖS;2071674661;Ne;0;15;0;15
467;Aušrelė;BITUTĖS;5598494461;Ne;0;0;11;11
468;Aušrelė;BITUTĖS;4935192851;Ne;0;5;0;5
469;Aušrelė;BITUTĖS;9505496063;Ne;0;6;0;6
470;Aušrelė;BITUTĖS;1931955562;Ne;4;1;0;5
471;Aušrelė;BITUTĖS;6591538425;Ne;0;20;0;20
472;Aušrelė;BITUTĖS;8203256528;Ne;0;20;0;20
473;Aušrelė;BITUTĖS;5741252819;Ne;0;20;0;20
474;Aušrelė;BITUTĖS;1243825974;Ne;0;8;0;8
475;Aušrelė;BITUTĖS;2468245186;Ne;7;0;0;7
476;Aušrelė;BITUTĖS;5266959731;Ne;0;2;0;2
477;Aušrelė;ŽIRNIUKAI;1949809977;Ne;4;0;0;4
478;Aušrelė;ŽIRNIUKAI;9733877752;Ne;3;4;0;7
479;Aušrelė;ŽIRNIUKAI;8542012622;Ne;9;0;0;9
480;Aušrelė;ŽIRNIUKAI;2221714044;Ne;0;0;2;2
481;Aušrelė;ŽIRNIUKAI;1544869163;Ne;2;11;0;13
482;Aušrelė;ŽIRNIUKAI;6577540623;Ne;9;0;0;9
483;Aušrelė;ŽIRNIUKAI;5460833944;Ne;13;0;2;15
484;Aušrelė;ŽIRNIUKAI;6372004855;Ne;6;0;0;6
485;Aušrelė;ŽIRNIUKAI;3713528812;Ne;14;0;0;14
486;Aušrelė;ŽIRNIUKAI;2107898976;Taip;11;2;0;13
487;Aušrelė;ŽIRNIUKAI;8573348956;Ne;0;20;0;20
488;Aušrelė;ŽIRNIUKAI;6463141345;Ne;3;0;0;3
489;Aušrelė;ŽIRNIUKAI;1798478023;Ne;0;2;0;2
490;Aušrelė;ŽIRNIUKAI;1754138341;Ne;12;3;0;15
491;Aušrelė;ŽIRNIUKAI;6913824678;Ne;8;2;3;13
492;Aušrelė;ŽIRNIUKAI;8797157671;Ne;6;0;0;6
493;Aušrelė;ŽIRNIUKAI;4591518039;Taip;0;6;0;6
494;Aušrelė;ŽIRNIUKAI;8126701466;Ne;12;0;0;12
495;Aušrelė;GRYBUKAI;9938762910;Ne;3;1;0;4
496;Aušrelė;GRYBUKAI;6672975558;Ne;0;0;2;2
497;Aušrelė;GRYBUKAI;4565813136;Ne;0;0;1;1
498;Aušrelė;GRYBUKAI;9877307844;Ne;0;2;0;2
499;Aušrelė;GRYBUKAI;8947695521;Ne;4;0;0;4
500;Aušrelė;GRYBUKAI;7130040621;Ne;0;0;2;2
501;Aušrelė;GRYBUKAI;1458580523;Ne;15;0;0;15
502;Aušrelė;GRYBUKAI;1871799626;Ne;14;0;0;14
503;Aušrelė;GRYBUKAI;5733298006;Ne;0;2;0;2
504;Aušrelė;GRYBUKAI;4924950592;Ne;2;1;1;4
505;Aušrelė;GRYBUKAI;2466858636;Ne;0;20;0;20
506;Aušrelė;GRYBUKAI;2873845920;Ne;0;0;2;2
507;Aušrelė;GRYBUKAI;5904797250;Ne;8;0;1;9
508;Aušrelė;DRUGELIAI;9763241451;Ne;0;0;5;5
509;Aušrelė;DRUGELIAI;7948024164;Ne;0;0;8;8
510;Aušrelė;DRUGELIAI;5429867368;Ne;0;6;0;6
511;Aušrelė;DRUGELIAI;3831695455;Ne;0;20;0;20
512;Aušrelė;DRUGELIAI;2737402297;Ne;1;0;1;2
513;Aušrelė;DRUGELIAI;3813270658;Ne;0;5;0;5
514;Aušrelė;DRUGELIAI;4254737302;Ne;5;0;0;5
515;Aušrelė;DRUGELIAI;4464947621;Ne;12;2;0;14
516;Aušrelė;DRUGELIAI;9126040500;Ne;1;2;0;3
517;Aušrelė;DRUGELIAI;7286960315;Ne;4;8;0;12
518;Aušrelė;DRUGELIAI;8102293098;Ne;4;2;0;6
519;Aušrelė;DRUGELIAI;2266835623;Ne;5;2;0;7
520;Aušrelė;DRUGELIAI;1094141305;Ne;10;1;1;12
521;Aušrelė;DRUGELIAI;9514049590;Ne;4;0;0;4
522;Aušrelė;DRUGELIAI;5709799539;Ne;0;0;6;6
523;Aušrelė;DRUGELIAI;8724802289;Ne;0;0;6;6
524;Aušrelė;DRUGELIAI;5668908532;Ne;1;0;1;2
525;Aušrelė;NYKŠTUKAI;9914518299;Ne;15;0;0;15
526;Aušrelė;NYKŠTUKAI;8427699400;Ne;0;2;0;2
527;Aušrelė;NYKŠTUKAI;4297417711;Ne;4;0;0;4
528;Aušrelė;NYKŠTUKAI;4004600465;Ne;10;3;0;13
529;Aušrelė;NYKŠTUKAI;7964156691;Taip;13;2;0;15
530;Aušrelė;NYKŠTUKAI;7140465960;Ne;6;0;0;6
531;Aušrelė;NYKŠTUKAI;7937067384;Ne;4;0;0;4
532;Aušrelė;NYKŠTUKAI;8099338305;Ne;6;0;0;6
533;Aušrelė;NYKŠTUKAI;6513026989;Ne;2;0;0;2
534;Aušrelė;NYKŠTUKAI;4282189556;Ne;5;2;0;7
535;Aušrelė;NYKŠTUKAI;4252475967;Taip;1;2;2;5
536;Aušrelė;NYKŠTUKAI;8829298943;Ne;6;2;0;8
537;Aušrelė;NYKŠTUKAI;8378225406;Ne;10;0;0;10
538;Aušrelė;NYKŠTUKAI;5018495543;Ne;9;0;0;9
539;Aušrelė;NYKŠTUKAI;3259828075;Ne;2;1;4;7
540;Aušrelė;NYKŠTUKAI;4952876188;Ne;6;1;0;7
541;Aušrelė;SPINDULIUKAI;8848358559;Ne;0;20;0;20
542;Aušrelė;SPINDULIUKAI;3194122285;Ne;0;20;0;20
543;Aušrelė;SPINDULIUKAI;5358736178;Ne;5;1;0;6
544;Aušrelė;SPINDULIUKAI;8801906679;Ne;5;0;0;5
545;Aušrelė;SPINDULIUKAI;7208341200;Ne;0;20;0;20
546;Aušrelė;SPINDULIUKAI;1446194971;Ne;0;7;0;7
547;Aušrelė;SPINDULIUKAI;9251919940;Ne;0;0;20;20
548;Aušrelė;SPINDULIUKAI;8997650487;Ne;0;0;1;1
549;Aušrelė;SPINDULIUKAI;1805615293;Ne;4;0;0;4
550;Aušrelė;SPINDULIUKAI;7966060521;Ne;0;3;0;3
551;Aušrelė;SPINDULIUKAI;5866673884;Ne;4;2;1;7
552;Aušrelė;SPINDULIUKAI;8835689988;Ne;2;4;0;6
553;Aušrelė;SPINDULIUKAI;5274919078;Ne;0;10;0;10
554;Aušrelė;SPINDULIUKAI;2441221298;Ne;0;20;0;20
555;Beržynėlis;SVIRPLIUKAI;7360345539;Ne;15;0;0;15
556;Beržynėlis;SVIRPLIUKAI;4134371415;Ne;6;2;0;8
557;Beržynėlis;SVIRPLIUKAI;7278860816;Ne;7;1;0;8
558;Beržynėlis;SVIRPLIUKAI;4013099670;Ne;0;1;0;1
559;Beržynėlis;SVIRPLIUKAI;8404801225;Ne;4;0;0;4
560;Beržynėlis;SVIRPLIUKAI;8303684788;Ne;7;0;0;7
561;Beržynėlis;SVIRPLIUKAI;7953957525;Ne;2;1;0;3
562;Beržynėlis;SVIRPLIUKAI;3841363368;Ne;3;0;0;3
563;Beržynėlis;SVIRPLIUKAI;3418730586;Ne;6;1;0;7
564;Beržynėlis;SVIRPLIUKAI;1468551784;Ne;5;0;0;5
565;Beržynėlis;SVIRPLIUKAI;2221708263;Ne;15;0;0;15
566;Beržynėlis;SVIRPLIUKAI;8880151537;Ne;0;6;0;6
567;Beržynėlis;SVIRPLIUKAI;6516665294;Ne;2;0;0;2
568;Beržynėlis;SVIRPLIUKAI;9580286493;Ne;0;2;0;2
569;Beržynėlis;SVIRPLIUKAI;6673910279;Ne;8;0;0;8
570;Beržynėlis;SVIRPLIUKAI;5027712732;Ne;14;1;0;15
571;Beržynėlis;SVIRPLIUKAI;7555487759;Ne;1;0;0;1
572;Beržynėlis;SVIRPLIUKAI;7788532819;Ne;10;0;0;10
573;Beržynėlis;SVIRPLIUKAI;3315079004;Ne;8;0;0;8
574;Beržynėlis;SVIRPLIUKAI;8533912024;Ne;5;6;0;11
575;Beržynėlis;PELEDŽIUKAI;3278699117;Ne;0;10;0;10
576;Beržynėlis;PELEDŽIUKAI;1516309509;Ne;0;3;0;3
577;Beržynėlis;PELEDŽIUKAI;1395819329;Ne;0;0;2;2
578;Beržynėlis;PELEDŽIUKAI;1838631438;Ne;0;0;2;2
579;Beržynėlis;PELEDŽIUKAI;9566341884;Ne;3;0;0;3
580;Beržynėlis;PELEDŽIUKAI;1682929565;Ne;0;0;6;6
581;Beržynėlis;PELEDŽIUKAI;2681482042;Ne;0;0;2;2
582;Beržynėlis;PELEDŽIUKAI;5196910604;Ne;13;0;0;13
583;Beržynėlis;PELEDŽIUKAI;7649359221;Ne;11;0;0;11
584;Beržynėlis;PELEDŽIUKAI;6395436937;Ne;3;4;0;7
585;Beržynėlis;PELEDŽIUKAI;2791734213;Ne;0;0;20;20
586;Beržynėlis;PELEDŽIUKAI;1136091326;Ne;0;0;1;1
587;Beržynėlis;PELEDŽIUKAI;71505149611;Ne;0;1;0;1
588;Beržynėlis;PELEDŽIUKAI;1176943273;Ne;20;0;0;20
589;Beržynėlis;PELEDŽIUKAI;7929997884;Ne;17;1;0;18
590;Beržynėlis;PELEDŽIUKAI;8688852668;Ne;10;4;1;15
591;Beržynėlis;ŽIOGELIAI;5308596559;Ne;0;3;0;3
592;Beržynėlis;ŽIOGELIAI;4035764376;Ne;0;1;0;1
593;Beržynėlis;ŽIOGELIAI;1325972861;Ne;0;0;2;2
594;Beržynėlis;ŽIOGELIAI;7589778533;Ne;0;1;0;1
595;Beržynėlis;ŽIOGELIAI;6739927917;Ne;1;1;0;2
596;Beržynėlis;ŽIOGELIAI;2971686368;Ne;0;4;0;4
597;Beržynėlis;ŽIOGELIAI;9409317403;Ne;0;3;2;5
598;Beržynėlis;ŽIOGELIAI;9305279614;Ne;14;2;0;16
599;Beržynėlis;ŽIOGELIAI;9511051386;Ne;0;1;0;1
600;Beržynėlis;ŽIOGELIAI;8114761925;Ne;8;0;0;8
601;Beržynėlis;ŽIOGELIAI;5856519538;Ne;5;7;0;12
602;Beržynėlis;ŽIOGELIAI;6337962165;Ne;0;3;1;4
603;Beržynėlis;ŽIOGELIAI;6864823739;Ne;0;2;5;7
604;Beržynėlis;ŽIOGELIAI;9896122318;Ne;0;2;0;2
605;Beržynėlis;ŽIOGELIAI;6837130893;Ne;0;0;5;5
606;Beržynėlis;ŽIOGELIAI;3484188772;Ne;10;0;0;10
607;Beržynėlis;ŽVIRBLIUKAI;2193460960;Ne;0;1;0;1
608;Beržynėlis;ŽVIRBLIUKAI;2482395208;Ne;0;1;0;1
609;Beržynėlis;ŽVIRBLIUKAI;7057284039;Taip;0;2;4;6
610;Beržynėlis;ŽVIRBLIUKAI;2892553878;Ne;0;10;0;10
611;Beržynėlis;ŽVIRBLIUKAI;4466393687;Ne;0;1;0;1
612;Beržynėlis;ŽVIRBLIUKAI;9503352345;Ne;11;2;1;14
613;Beržynėlis;ŽVIRBLIUKAI;8881566865;Ne;0;0;10;10
614;Beržynėlis;ŽVIRBLIUKAI;8280378527;Ne;0;4;0;4
615;Beržynėlis;ŽVIRBLIUKAI;6713134631;Ne;0;1;0;1
616;Beržynėlis;ŽVIRBLIUKAI;5593146590;Ne;0;2;0;2
617;Beržynėlis;ŽVIRBLIUKAI;3334994408;Ne;20;0;0;20
618;Beržynėlis;ŽVIRBLIUKAI;9777841895;Ne;0;1;0;1
619;Beržynėlis;ŽVIRBLIUKAI;6293884233;Ne;0;1;0;1
620;Beržynėlis;ŽVIRBLIUKAI;4161974847;Ne;1;2;1;4
621;Beržynėlis;ŽVIRBLIUKAI;3209966996;Ne;0;2;6;8
622;Beržynėlis;ŽVIRBLIUKAI;1228384088;Ne;0;0;1;1
623;Beržynėlis;ŽVIRBLIUKAI;5189335842;Ne;7;2;3;12
624;Beržynėlis;ŽIRNIUKAI;6932094459;Ne;0;1;0;1
625;Beržynėlis;ŽIRNIUKAI;5864265458;Ne;0;16;4;20
626;Beržynėlis;ŽIRNIUKAI;2583982025;Ne;2;3;0;5
627;Beržynėlis;ŽIRNIUKAI;7870888327;Ne;5;0;0;5
628;Beržynėlis;ŽIRNIUKAI;9603272698;Ne;20;0;0;20
629;Beržynėlis;ŽIRNIUKAI;9493489114;Ne;20;0;0;20
630;Beržynėlis;ŽIRNIUKAI;4786786104;Ne;0;5;0;5
631;Beržynėlis;ŽIRNIUKAI;4944466205;Ne;0;2;0;2
632;Beržynėlis;ŽIRNIUKAI;6392773584;Ne;0;2;18;20
633;Beržynėlis;ŽIRNIUKAI;4978363316;Ne;15;0;0;15
634;Beržynėlis;ŽIRNIUKAI;7806800327;Taip;20;0;0;20
635;Beržynėlis;ŽIRNIUKAI;2154631640;Ne;6;0;3;9
636;Beržynėlis;ŽIRNIUKAI;9899702275;Ne;0;0;2;2
637;Beržynėlis;VIŠČIUKAI;7016454952;Ne;5;0;0;5
638;Beržynėlis;VIŠČIUKAI;7903644161;Ne;0;0;4;4
639;Beržynėlis;VIŠČIUKAI;1707585750;Ne;0;4;4;8
640;Beržynėlis;VIŠČIUKAI;4382068779;Ne;5;0;0;5
641;Beržynėlis;VIŠČIUKAI;2272661119;Ne;0;2;0;2
642;Beržynėlis;VIŠČIUKAI;1831776326;Ne;17;1;0;18
643;Beržynėlis;VIŠČIUKAI;1118349439;Ne;7;0;1;8
644;Beržynėlis;VIŠČIUKAI;4369803044;Taip;10;2;1;13
645;Beržynėlis;VIŠČIUKAI;3593785967;Ne;2;0;1;3
646;Beržynėlis;VIŠČIUKAI;7972993168;Taip;5;2;2;9
647;Beržynėlis;VIŠČIUKAI;3100097647;Ne;0;0;2;2
648;Birutės;SKRUZDELIUKŲ;4968068043;Ne;5;0;1;6
649;Birutės;SKRUZDELIUKŲ;1761065941;Ne;0;3;0;3
650;Birutės;SKRUZDELIUKŲ;7685356079;Ne;4;0;0;4
651;Birutės;SKRUZDELIUKŲ;1105133326;Taip;4;0;16;20
652;Birutės;SKRUZDELIUKŲ;8636113039;Ne;6;0;0;6
653;Birutės;SKRUZDELIUKŲ;9411016611;Ne;0;2;0;2
654;Birutės;SKRUZDELIUKŲ;7119951690;Ne;18;5;0;23
655;Birutės;SKRUZDELIUKŲ;9541516589;Ne;0;0;2;2
656;Birutės;SKRUZDELIUKŲ;6815916679;Ne;0;2;0;2
657;Birutės;SKRUZDELIUKŲ;9187671201;Ne;0;1;4;5
658;Birutės;SKRUZDELIUKŲ;7404631298;Ne;8;0;0;8
659;Birutės;SKRUZDELIUKŲ;9904827482;Ne;0;3;0;3
660;Birutės;SKRUZDELIUKŲ;8413760872;Taip;0;1;0;1
661;Birutės;SKRUZDELIUKŲ;7940403585;Ne;0;1;0;1
662;Birutės;SKRUZDELIUKŲ;7251592439;Taip;0;1;0;1
663;Birutės;SKRUZDELIUKŲ;4375683234;Ne;0;0;7;7
664;Birutės;BITUČIŲ;1599159924;Ne;0;0;1;1
665;Birutės;BITUČIŲ;33770983649;Ne;6;2;0;8
666;Birutės;BITUČIŲ;2975442228;Ne;0;1;0;1
667;Birutės;BITUČIŲ;98391790116;Ne;5;0;0;5
668;Birutės;BITUČIŲ;5947971037;Ne;0;2;0;2
669;Birutės;BITUČIŲ;3870702348;Ne;0;1;0;1
670;Birutės;BITUČIŲ;8465645434;Ne;6;0;0;6
671;Birutės;BITUČIŲ;9722922540;Ne;0;1;0;1
672;Birutės;BITUČIŲ;3061210677;Ne;0;0;1;1
673;Birutės;BITUČIŲ;6081472534;Ne;0;0;1;1
674;Birutės;BITUČIŲ;2674259453;Ne;0;0;1;1
675;Birutės;BITUČIŲ;17865476849;Ne;4;0;0;4
676;Birutės;BITUČIŲ;6006110601;Ne;0;5;3;8
677;Birutės;BITUČIŲ;1243603625;Ne;2;0;0;2
678;Birutės;BITUČIŲ;1447494370;Ne;7;0;0;7
679;Birutės;BORUŽIUKAI;5893851353;Ne;0;0;1;1
680;Birutės;BORUŽIUKAI;5457357625;Ne;0;0;1;1
681;Birutės;BORUŽIUKAI;5869137292;Ne;0;1;0;1
682;Birutės;BORUŽIUKAI;5026442722;Ne;0;2;0;2
683;Birutės;BORUŽIUKAI;6977276295;Ne;5;0;2;7
684;Birutės;BORUŽIUKAI;1776142202;Ne;0;0;5;5
685;Birutės;BORUŽIUKAI;8011210158;Ne;4;0;0;4
686;Birutės;BORUŽIUKAI;4906874758;Ne;0;5;0;5
687;Birutės;BORUŽIUKAI;9263238557;Ne;0;1;0;1
688;Birutės;BORUŽIUKAI;6973898557;Ne;0;2;0;2
689;Birutės;BORUŽIUKAI;5745377474;Ne;0;0;2;2
690;Birutės;BORUŽIUKAI;5897671273;Ne;0;0;3;3
691;Birutės;BORUŽIUKAI;2016711225;Ne;3;0;0;3
692;Birutės;BORUŽIUKAI;1400510886;Ne;2;0;0;2
693;Birutės;BORUŽIUKAI;7494879160;Taip;6;9;5;20
694;Birutės;BORUŽIUKAI;5875585426;Ne;3;0;0;3
695;Birutės;BORUŽIUKAI;7741922416;Ne;0;6;0;6
696;Birutės;BORUŽIUKAI;2681370776;Ne;0;0;1;1
697;Birutės;DRUGELIAI;8854957814;Ne;0;0;10;10
698;Birutės;DRUGELIAI;6263985683;Ne;7;0;0;7
699;Birutės;DRUGELIAI;4995437657;Ne;0;0;4;4
700;Birutės;DRUGELIAI;5957267018;Ne;0;0;3;3
701;Birutės;DRUGELIAI;1442496209;Ne;0;1;0;1
702;Birutės;DRUGELIAI;2318034045;Ne;0;0;6;6
703;Birutės;DRUGELIAI;9727836236;Ne;6;0;1;7
704;Birutės;DRUGELIAI;5688633357;Ne;0;5;7;12
705;Birutės;DRUGELIAI;8559820030;Ne;0;0;20;20
706;Birutės;DRUGELIAI;9863681147;Ne;0;0;1;1
707;Birutės;DRUGELIAI;9307655828;Ne;8;0;0;8
708;Birutės;DRUGELIAI;4674152995;Ne;0;0;3;3
709;Birutės;DRUGELIAI;5177528200;Ne;0;0;2;2
710;Birutės;DRUGELIAI;3391101786;Ne;13;0;1;14
711;Birutės;DRUGELIAI;7876057712;Ne;5;0;1;6
712;Birutės;DRUGELIAI;6765257633;Ne;0;0;3;3
713;Birutės;DRUGELIAI;7336936451;Ne;0;8;0;8
714;Bitutė;Aitvariukų;4474600934;Ne;0;1;0;1
715;Bitutė;Aitvariukų;5606049201;Ne;8;3;0;11
716;Bitutė;Aitvariukų;6035394425;Taip;12;3;0;15
717;Bitutė;Aitvariukų;7132616264;Ne;5;17;0;22
718;Bitutė;Aitvariukų;8796728627;Taip;0;12;0;12
719;Bitutė;Aitvariukų;6030674568;Ne;0;0;6;6
720;Bitutė;Aitvariukų;9747786638;Ne;6;0;2;8
721;Bitutė;Aitvariukų;8259512455;Ne;0;6;0;6
722;Bitutė;Aitvariukų;9106644834;Ne;0;6;0;6
723;Bitutė;Aitvariukų;2899217019;Ne;4;0;2;6
724;Bitutė;Aitvariukų;8670124052;Ne;3;0;0;3
725;Bitutė;Aitvariukų;1340530611;Taip;5;1;0;6
726;Bitutė;Aitvariukų;4164058783;Ne;13;0;4;17
727;Bitutė;Aitvariukų;8908052679;Ne;8;1;0;9
728;Bitutė;Aitvariukų;4924483609;Ne;0;10;0;10
729;Bitutė;Aitvariukų;7447624247;Taip;0;10;0;10
730;Bitutė;Ežiukų;56287634684;Ne;0;0;1;1
731;Bitutė;Ežiukų;5126303823;Ne;0;4;0;4
732;Bitutė;Ežiukų;4764586168;Ne;18;1;1;20
733;Bitutė;Ežiukų;8905075899;Ne;7;0;1;8
734;Bitutė;Ežiukų;6341806464;Ne;0;5;4;9
735;Bitutė;Ežiukų;7456328992;Ne;0;2;0;2
736;Bitutė;Ežiukų;2812580726;Ne;0;1;4;5
737;Bitutė;Ežiukų;8186706520;Ne;0;32;0;32
738;Bitutė;Ežiukų;1904108612;Ne;0;1;0;1
739;Bitutė;Ežiukų;5378885117;Ne;0;0;1;1
740;Bitutė;Ežiukų;2122052883;Ne;9;0;0;9
741;Bitutė;Ežiukų;4444523140;Ne;0;2;0;2
742;Bitutė;Ežiukų;4024758152;Ne;0;1;0;1
743;Bitutė;Ežiukų;6194712643;Ne;0;1;0;1
744;Bitutė;Ežiukų;4468366941;Ne;6;0;2;8
745;Bitutė;Ežiukų;5188828679;Ne;0;1;0;1
746;Bitutė;Ežiukų;8109028957;Ne;0;1;0;1
747;Bitutė;Ežiukų;3156654672;Ne;0;0;3;3
748;Bitutė;Žvirbliukų;7047262367;Ne;8;0;2;10
749;Bitutė;Žvirbliukų;4458990772;Ne;11;0;0;11
750;Bitutė;Žvirbliukų;3723040682;Ne;0;1;0;1
751;Bitutė;Žvirbliukų;2190439190;Ne;4;5;0;9
752;Bitutė;Žvirbliukų;7113693496;Ne;16;0;0;16
753;Bitutė;Žvirbliukų;4177331531;Ne;0;2;1;3
754;Bitutė;Žvirbliukų;2483462846;Ne;1;5;0;6
755;Bitutė;Žvirbliukų;2444289145;Ne;0;4;0;4
756;Bitutė;Žvirbliukų;5291764696;Ne;0;4;0;4
757;Bitutė;Žvirbliukų;9523588597;Ne;5;0;1;6
758;Bitutė;Žvirbliukų;8373105196;Ne;12;1;2;15
759;Bitutė;Žvirbliukų;6014726741;Ne;0;4;0;4
760;Bitutė;Žvirbliukų;4527880105;Ne;8;0;2;10
761;Bitutė;Žvirbliukų;9834697190;Ne;9;0;3;12
762;Bitutė;Gandriukų;8519978626;Ne;0;1;5;6
763;Bitutė;Gandriukų;1809034174;Ne;0;2;0;2
764;Bitutė;Gandriukų;6586888742;Ne;0;0;12;12
765;Bitutė;Gandriukų;5783154071;Ne;0;3;0;3
766;Bitutė;Gandriukų;7387822939;Ne;0;0;7;7
767;Bitutė;Gandriukų;6052204491;Ne;0;3;0;3
768;Bitutė;Gandriukų;37105491775;Ne;5;3;0;8
769;Bitutė;Gandriukų;90943054285;Ne;6;6;0;12
770;Bitutė;Gandriukų;6659750060;Ne;5;0;0;5
771;Bitutė;Gandriukų;9683582019;Ne;1;0;2;3
772;Bitutė;Gandriukų;11567978993;Ne;0;6;0;6
773;Bitutė;Gandriukų;7352524951;Ne;5;0;0;5
774;Bitutė;Gandriukų;2350260809;Ne;0;5;0;5
775;Bitutė;Gandriukų;27144303911;Ne;0;2;0;2
776;Bitutė;Gandriukų;1942685472;Ne;5;2;0;7
777;Bitutė;Gandriukų;5653055907;Ne;7;0;0;7
778;Bitutė;Gandriukų;6678928989;Ne;7;0;0;7
779;Bitutė;Gandriukų;1802887869;Ne;5;4;0;9
780;Bitutė;Gandriukų;51054491845;Ne;0;2;0;2
781;Bitutė;Gandriukų;4574673585;Ne;0;1;0;1
782;Bitutė;Gandriukų;47316276655;Ne;0;1;0;1
783;Bitutė;Pelėdžiukai;5455919343;Ne;0;1;0;1
784;Bitutė;Pelėdžiukai;8743734366;Ne;0;1;0;1
785;Bitutė;Pelėdžiukai;2804203556;Ne;10;6;0;16
786;Bitutė;Pelėdžiukai;8394685672;Ne;0;2;1;3
787;Bitutė;Pelėdžiukai;7056737587;Ne;7;0;0;7
788;Bitutė;Pelėdžiukai;4985270536;Ne;0;11;0;11
789;Bitutė;Pelėdžiukai;1590501589;Ne;0;11;0;11
790;Bitutė;Pelėdžiukai;3796188100;Ne;2;0;0;2
791;Bitutė;Pelėdžiukai;1564763789;Ne;0;2;0;2
792;Bitutė;Pelėdžiukai;5679397165;Ne;0;0;6;6
793;Bitutė;Pelėdžiukai;3432065233;Ne;0;5;1;6
794;Bitutė;Pelėdžiukai;1560715159;Ne;0;1;0;1
795;Bitutė;Pelėdžiukai;2518730247;Ne;30;0;0;30
796;Bitutė;Pelėdžiukai;4315172747;Ne;3;6;0;9
797;Bitutė;Pelėdžiukai;9838379838;Ne;4;13;0;17
798;Bitutė;Pelėdžiukai;3227252972;Ne;0;3;0;3
799;Bitutė;Boružėlių;8276590981;Ne;19;0;0;19
800;Bitutė;Boružėlių;3026526421;Ne;0;5;0;5
801;Bitutė;Boružėlių;7503203424;Ne;14;0;1;15
802;Bitutė;Boružėlių;8355346371;Ne;11;0;0;11
803;Bitutė;Boružėlių;2583001947;Ne;9;0;1;10
804;Bitutė;Boružėlių;9545405359;Ne;2;0;3;5
805;Bitutė;Boružėlių;2129484313;Ne;8;4;0;12
806;Bitutė;Boružėlių;9691450767;Ne;0;0;12;12
807;Bitutė;Boružėlių;3170266155;Ne;1;0;9;10
808;Bitutė;Boružėlių;6455582149;Ne;13;0;0;13
809;Bitutė;Boružėlių;2144809294;Ne;0;0;4;4
810;Bitutė;Boružėlių;8011051470;Ne;0;0;16;16
811;Bitutė;Boružėlių;9521938997;Ne;6;0;1;7
812;Bitutė;Boružėlių;9668365838;Ne;14;0;0;14
813;Bitutė;Boružėlių;7095475821;Taip;0;0;3;3
814;Bitutė;Boružėlių;6255439813;Ne;17;0;0;17
815;Bitutė;Boružėlių;2623999429;Ne;0;1;0;1
816;Bitutė;Boružėlių;6840722112;Ne;9;0;0;9
817;Bitutė;Boružėlių;4884898917;Ne;10;0;0;10
818;Bitutė;Boružėlių;4869423833;Ne;12;0;0;12
819;Bitutė;Boružėlių;5071978105;Ne;8;0;1;9
820;Bitutė;Šokliukų;8211710975;Ne;0;13;0;13
821;Bitutė;Šokliukų;8872286273;Ne;8;3;0;11
822;Bitutė;Šokliukų;5169768042;Ne;0;5;0;5
823;Bitutė;Šokliukų;4917599786;Taip;7;0;1;8
824;Bitutė;Šokliukų;1348548294;Ne;12;0;0;12
825;Bitutė;Šokliukų;7318555933;Ne;0;4;0;4
826;Bitutė;Šokliukų;1012702386;Ne;0;0;5;5
827;Bitutė;Šokliukų;9924340801;Ne;12;11;0;23
828;Bitutė;Šokliukų;7165511381;Ne;1;20;0;21
829;Bitutė;Šokliukų;9465186207;Ne;6;4;0;10
830;Bitutė;Šokliukų;2853616585;Ne;0;0;5;5
831;Bitutė;Šokliukų;5109258680;Ne;0;2;0;2
832;Bitutė;Šokliukų;3417576747;Ne;0;2;1;3
833;Bitutė;Šokliukų;8422448947;Ne;0;6;0;6
834;Bitutė;Šokliukų;7926482326;Ne;5;8;0;13
835;Bitutė;Šokliukų;2177537591;Ne;24;0;0;24
836;Bitutė;Šokliukų;5759407291;Ne;4;1;0;5
837;Bitutė;Šokliukų;4471813998;Ne;0;2;0;2
838;Bitutė;Šokliukų;9234090775;Ne;9;4;5;18
839;Bitutė;Drugelių;9094567866;Ne;2;0;6;8
840;Bitutė;Drugelių;5759595005;Ne;11;0;1;12
841;Bitutė;Drugelių;2085899696;Ne;4;0;0;4
842;Bitutė;Drugelių;2029309955;Ne;5;2;0;7
843;Bitutė;Drugelių;7376746010;Ne;0;0;5;5
844;Bitutė;Drugelių;5845408472;Ne;5;2;0;7
845;Bitutė;Drugelių;3611348253;Ne;6;0;2;8
846;Bitutė;Drugelių;8727525320;Ne;8;0;0;8
847;Bitutė;Drugelių;5796600501;Ne;0;0;6;6
848;Bitutė;Drugelių;1558826102;Ne;7;0;0;7
849;Bitutė;Drugelių;6325890676;Ne;20;0;4;24
850;Bitutė;Drugelių;2748400429;Ne;0;19;0;19
851;Bitutė;Drugelių;5146691157;Ne;7;0;0;7
852;Bitutė;Drugelių;2848732083;Taip;9;0;0;9
853;Bitutė;Drugelių;5278510767;Ne;0;6;0;6
854;Bitutė;Drugelių;8962725357;Ne;6;0;2;8
855;Bitutė;Drugelių;5471241132;Ne;1;2;2;5
856;Bitutė;Drugelių;5081300818;Ne;0;0;5;5
857;Bitutė;Drugelių;7013249141;Ne;5;0;8;13
858;Bitutė;Drugelių;1397711778;Ne;0;0;8;8
859;Bitutė;Drugelių;8008237092;Ne;10;0;3;13
860;Bitutė;Drugelių;4545188971;Ne;13;17;0;30
861;Bitutė;Kiškučių;9451529077;Ne;0;2;0;2
862;Bitutė;Kiškučių;1733189730;Ne;10;2;0;12
863;Bitutė;Kiškučių;9966437881;Ne;3;1;0;4
864;Bitutė;Kiškučių;1985958540;Ne;7;3;0;10
865;Bitutė;Kiškučių;8743960488;Taip;6;0;0;6
866;Bitutė;Kiškučių;9337144831;Taip;5;0;0;5
867;Bitutė;Kiškučių;4566919587;Ne;0;2;0;2
868;Bitutė;Kiškučių;2806899030;Ne;0;5;0;5
869;Bitutė;Kiškučių;5443722813;Ne;10;4;0;14
870;Bitutė;Kiškučių;1241863345;Ne;5;2;0;7
871;Bitutė;Kiškučių;8789574593;Ne;3;0;2;5
872;Bitutė;Kiškučių;8799003374;Ne;4;17;0;21
873;Bitutė;Kiškučių;5490753578;Ne;5;0;0;5
874;Bitutė;"Viščiukų ";3603716923;Ne;15;0;0;15
875;Bitutė;"Viščiukų ";5181958187;Ne;14;0;0;14
876;Bitutė;"Viščiukų ";7694916340;Ne;13;4;0;17
877;Bitutė;"Viščiukų ";8303932330;Ne;6;2;1;9
878;Bitutė;"Viščiukų ";8642411661;Ne;15;1;0;16
879;Bitutė;"Viščiukų ";1198024852;Ne;0;1;0;1
880;Bitutė;"Viščiukų ";9909017070;Ne;0;1;0;1
881;Bitutė;"Viščiukų ";3811028304;Ne;11;0;0;11
882;Bitutė;"Viščiukų ";9592567172;Ne;5;4;0;9
883;Bitutė;"Viščiukų ";7619112317;Ne;0;2;0;2
884;Bitutė;"Viščiukų ";1715987321;Ne;6;0;0;6
885;Bitutė;"Viščiukų ";4926289620;Ne;0;32;0;32
886;Bitutė;"Viščiukų ";8130382253;Ne;0;3;0;3
887;Bitutė;"Viščiukų ";5869737425;Ne;18;0;0;18
888;Bitutė;"Viščiukų ";7535583229;Ne;0;1;0;1
889;Bitutė;"Viščiukų ";4480187618;Ne;10;0;1;11
890;Bitutė;"Viščiukų ";5061164237;Ne;5;0;0;5
891;Bitutė;"Skruzdėliukai ";5686278261;Ne;0;0;2;2
892;Bitutė;"Skruzdėliukai ";1423694056;Ne;0;7;6;13
893;Bitutė;"Skruzdėliukai ";6311396261;Ne;19;0;0;19
894;Bitutė;"Skruzdėliukai ";7145036085;Ne;8;2;2;12
895;Bitutė;"Skruzdėliukai ";2252157473;Ne;0;2;0;2
896;Bitutė;"Skruzdėliukai ";6169426273;Ne;4;0;0;4
897;Bitutė;"Skruzdėliukai ";8667259778;Ne;7;0;1;8
898;Bitutė;"Skruzdėliukai ";8607718704;Ne;3;0;3;6
899;Bitutė;"Skruzdėliukai ";4413880918;Ne;0;0;5;5
900;Bitutė;"Skruzdėliukai ";9436414962;Ne;5;1;0;6
901;Bitutė;"Skruzdėliukai ";9864771568;Ne;8;4;1;13
902;Bitutė;"Skruzdėliukai ";6353690252;Ne;10;0;0;10
903;Bitutė;"Skruzdėliukai ";2160735504;Ne;23;0;0;23
904;Bitutė;"Skruzdėliukai ";1387310054;Ne;19;0;0;19
905;Bitutė;"Skruzdėliukai ";7245807233;Ne;0;0;6;6
906;Bitutė;"Skruzdėliukai ";4467090141;Ne;0;0;2;2
907;Bitutė;"Skruzdėliukai ";5433617195;Ne;0;4;0;4
908;Bitutė;"Skruzdėliukai ";2391170362;Ne;5;0;0;5
909;Bitutė;"Nykštukų ";1290146001;Taip;19;0;0;19
910;Bitutė;"Nykštukų ";3359918177;Ne;12;0;0;12
911;Bitutė;"Nykštukų ";9352292654;Ne;10;0;0;10
912;Bitutė;"Nykštukų ";5421744666;Ne;11;2;0;13
913;Bitutė;"Nykštukų ";9780599803;Ne;17;3;0;20
914;Bitutė;"Nykštukų ";7741454857;Ne;1;0;0;1
915;Bitutė;"Nykštukų ";3860047703;Taip;1;0;0;1
916;Bitutė;"Nykštukų ";6226996242;Ne;18;2;0;20
917;Bitutė;"Nykštukų ";1460746240;Ne;5;10;0;15
918;Bitutė;"Nykštukų ";8896842164;Ne;0;32;0;32
919;Bitutė;"Nykštukų ";2819417600;Ne;10;0;1;11
920;Bitutė;"Nykštukų ";8561037889;Ne;10;4;0;14
921;Bitutė;"Nykštukų ";6091108131;Ne;17;0;0;17
922;Bitutė;"Nykštukų ";5375847129;Ne;10;1;0;11
923;Bitutė;"Nykštukų ";3528436838;Ne;18;0;0;18
924;Bitutė;"Nykštukų ";8270270602;Ne;14;0;1;15
925;Bitutė;"Nykštukų ";4617493676;Ne;14;0;6;20
926;Bitutė;"Nykštukų ";3806852067;Ne;22;5;0;27
927;Coliukė;DRUGELIAI;3151183436;Ne;3;0;3;6
928;Coliukė;DRUGELIAI;6675290003;Ne;16;0;0;16
929;Coliukė;DRUGELIAI;9890663421;Ne;5;5;0;10
930;Coliukė;DRUGELIAI;7763035106;Ne;0;2;0;2
931;Coliukė;DRUGELIAI;9688432169;Ne;4;0;0;4
932;Coliukė;DRUGELIAI;7513522378;Ne;2;2;0;4
933;Coliukė;DRUGELIAI;8478006305;Ne;8;0;2;10
934;Coliukė;DRUGELIAI;9352547729;Ne;0;14;0;14
935;Coliukė;DRUGELIAI;3908791146;Ne;5;0;0;5
936;Coliukė;DRUGELIAI;9750447455;Ne;16;1;0;17
937;Coliukė;DRUGELIAI;3367789231;Ne;6;0;7;13
938;Coliukė;DRUGELIAI;1220834062;Ne;1;15;0;16
939;Coliukė;DRUGELIAI;3392367716;Ne;0;2;0;2
940;Coliukė;DRUGELIAI;2385917598;Ne;3;0;0;3
941;Coliukė;DRUGELIAI;1390751418;Ne;8;0;0;8
942;Coliukė;DRUGELIAI;4881447596;Ne;0;1;0;1
943;Coliukė;DRUGELIAI;6224089401;Ne;0;3;0;3
944;Coliukė;DRUGELIAI;7284465232;Ne;9;2;0;11
945;Coliukė;DRUGELIAI;8756465257;Ne;0;5;0;5
946;Coliukė;BITUTĖS;6725408547;Ne;7;0;3;10
947;Coliukė;BITUTĖS;2167230398;Ne;0;1;0;1
948;Coliukė;BITUTĖS;1960898805;Ne;0;6;0;6
949;Coliukė;BITUTĖS;7920728387;Ne;3;3;0;6
950;Coliukė;BITUTĖS;1968467455;Ne;0;1;0;1
951;Coliukė;BITUTĖS;9462610674;Ne;0;2;0;2
952;Coliukė;BITUTĖS;4188233426;Ne;4;2;3;9
953;Coliukė;BITUTĖS;8457120425;Ne;1;1;0;2
954;Coliukė;BITUTĖS;1240946719;Ne;0;3;0;3
955;Coliukė;BITUTĖS;9331485675;Ne;0;1;0;1
956;Coliukė;BITUTĖS;9311775782;Ne;0;1;0;1
957;Coliukė;BITUTĖS;2275327607;Ne;0;1;0;1
958;Coliukė;BITUTĖS;3346269598;Ne;9;2;0;11
959;Coliukė;BITUTĖS;9879369365;Ne;0;3;0;3
960;Coliukė;BITUTĖS;4845247006;Ne;0;1;0;1
961;Coliukė;BITUTĖS;9885547263;Ne;5;0;0;5
962;Coliukė;BITUTĖS;1458763954;Ne;0;15;0;15
963;Coliukė;BITUTĖS;6860757091;Ne;0;1;0;1
964;Coliukė;BITUTĖS;8517128464;Ne;2;0;0;2
965;Coliukė;BITUTĖS;7358018315;Ne;7;0;0;7
966;Coliukė;VABALIUKAI;1105879142;Ne;2;1;0;3
967;Coliukė;VABALIUKAI;1537341012;Ne;4;0;2;6
968;Coliukė;VABALIUKAI;6984254334;Ne;9;1;0;10
969;Coliukė;VABALIUKAI;5835199087;Ne;6;5;0;11
970;Coliukė;VABALIUKAI;4626722910;Ne;0;0;1;1
971;Coliukė;VABALIUKAI;9526108197;Ne;5;6;0;11
972;Coliukė;VABALIUKAI;1318558913;Ne;0;0;2;2
973;Coliukė;VABALIUKAI;6475497234;Ne;10;1;2;13
974;Coliukė;VABALIUKAI;5596775091;Ne;10;1;2;13
975;Coliukė;VABALIUKAI;4172517506;Ne;11;0;0;11
976;Coliukė;VABALIUKAI;4493314926;Ne;12;2;0;14
977;Coliukė;VABALIUKAI;2469993058;Ne;9;2;0;11
978;Coliukė;VABALIUKAI;4739310916;Ne;0;2;0;2
979;Coliukė;VABALIUKAI;5541328815;Ne;1;0;0;1
980;Coliukė;VABALIUKAI;4649987214;Ne;0;1;0;1
981;Coliukė;VABALIUKAI;3905904092;Ne;10;0;0;10
982;Coliukė;VABALIUKAI;9083546061;Ne;9;1;0;10
983;Coliukė;VABALIUKAI;1476750428;Ne;9;1;0;10
984;Coliukė;VABALIUKAI;8521846076;Ne;14;2;0;16
985;Coliukė;VABALIUKAI;7622526793;Ne;6;1;0;7
986;Coliukė;VABALIUKAI;1328505569;Ne;0;2;0;2
987;Coliukė;VABALIUKAI;9268436167;Ne;11;0;0;11
988;Coliukė;VABALIUKAI;9368334915;Ne;5;1;0;6
989;Coliukė;VABALIUKAI;5108993131;Ne;10;1;0;11
990;Coliukė;NYKŠTUKAI;6441253648;Ne;9;0;0;9
991;Coliukė;NYKŠTUKAI;4537756081;Ne;6;7;0;13
992;Coliukė;NYKŠTUKAI;4022408510;Ne;0;1;0;1
993;Coliukė;NYKŠTUKAI;6403149921;Ne;1;0;0;1
994;Coliukė;NYKŠTUKAI;9498557347;Ne;4;0;3;7
995;Coliukė;NYKŠTUKAI;3384332079;Ne;0;1;0;1
996;Coliukė;NYKŠTUKAI;5283583324;Ne;3;0;0;3
997;Coliukė;NYKŠTUKAI;9334564869;Ne;7;5;0;12
998;Coliukė;NYKŠTUKAI;6781303455;Ne;0;3;0;3
999;Coliukė;NYKŠTUKAI;3140659021;Ne;0;0;20;20
1000;Coliukė;NYKŠTUKAI;4845049639;Ne;2;0;6;8
1001;Coliukė;NYKŠTUKAI;3221157300;Ne;8;6;0;14
1002;Coliukė;NYKŠTUKAI;7870865302;Ne;6;5;0;11
1003;Coliukė;NYKŠTUKAI;1575061659;Ne;5;0;0;5
1004;Coliukė;NYKŠTUKAI;2321127662;Ne;0;0;5;5
1005;Coliukė;NYKŠTUKAI;7502911642;Ne;0;8;0;8
1006;Coliukė;NYKŠTUKAI;4635299740;Ne;0;8;0;8
1007;Coliukė;GĖLYTĖS;9442511803;Ne;0;0;19;19
1008;Coliukė;GĖLYTĖS;6611713551;Ne;0;0;2;2
1009;Coliukė;GĖLYTĖS;6755886435;Ne;6;0;0;6
1010;Coliukė;GĖLYTĖS;1220385522;Ne;0;1;0;1
1011;Coliukė;GĖLYTĖS;8601059431;Ne;5;0;1;6
1012;Coliukė;GĖLYTĖS;1452034828;Ne;0;2;2;4
1013;Coliukė;GĖLYTĖS;6816085304;Ne;0;6;0;6
1014;Coliukė;GĖLYTĖS;6941719947;Taip;4;1;2;7
1015;Coliukė;GĖLYTĖS;5347456579;Ne;3;0;0;3
1016;Coliukė;GĖLYTĖS;9834829829;Ne;0;0;3;3
1017;Coliukė;GĖLYTĖS;8606195508;Taip;2;0;9;11
1018;Coliukė;GĖLYTĖS;4880932369;Ne;0;0;2;2
1019;Coliukė;"BORUŽĖLĖS (SPEC.)";2617816991;Ne;3;2;0;5
1020;Coliukė;"BORUŽĖLĖS (SPEC.)";1233731506;Taip;4;3;0;7
1021;Coliukė;"BORUŽĖLĖS (SPEC.)";1644303265;Ne;0;0;15;15
1022;Coliukė;"BORUŽĖLĖS (SPEC.)";5706671963;Taip;4;5;0;9
1023;Coliukė;"BORUŽĖLĖS (SPEC.)";4961762841;Ne;5;0;0;5
1024;Coliukė;"BORUŽĖLĖS (SPEC.)";7826554599;Ne;0;0;5;5
1025;Coliukė;"BORUŽĖLĖS (SPEC.)";6920961967;Ne;0;5;0;5
1026;Coliukė;"BORUŽĖLĖS (SPEC.)";1134875499;Ne;0;1;0;1
1027;Coliukė;"BORUŽĖLĖS (SPEC.)";2351866339;Ne;0;0;3;3
1028;Coliukė;"BORUŽĖLĖS (SPEC.)";5756690199;Ne;10;0;0;10
1029;Coliukė;"BORUŽĖLĖS (SPEC.)";2947495861;Ne;1;0;6;7
1030;Coliukė;"BORUŽĖLĖS (SPEC.)";6246392335;Ne;0;1;0;1
1031;Coliukė;"BORUŽĖLĖS (SPEC.)";8347206534;Ne;3;0;0;3
1032;Čiauškutis;BITUTĖS;7976738303;Ne;0;0;5;5
1033;Čiauškutis;BITUTĖS;4026881335;Ne;0;0;10;10
1034;Čiauškutis;BITUTĖS;9753680961;Ne;0;2;1;3
1035;Čiauškutis;BITUTĖS;4852837431;Ne;3;0;0;3
1036;Čiauškutis;BITUTĖS;4652951382;Ne;0;11;9;20
1037;Čiauškutis;BITUTĖS;2319237497;Ne;3;1;0;4
1038;Čiauškutis;BITUTĖS;1765857419;Ne;14;0;0;14
1039;Čiauškutis;BITUTĖS;7282041196;Ne;2;18;0;20
1040;Čiauškutis;ŽVIRBLIUKAI;9565722619;Ne;0;20;0;20
1041;Čiauškutis;ŽVIRBLIUKAI;5125518366;Ne;6;0;5;11
1042;Čiauškutis;ŽVIRBLIUKAI;4962200863;Ne;20;0;0;20
1043;Čiauškutis;ŽVIRBLIUKAI;7468763527;Ne;0;0;1;1
1044;Čiauškutis;ŽVIRBLIUKAI;4216443034;Ne;5;0;0;5
1045;Čiauškutis;ŽVIRBLIUKAI;2096533965;Ne;9;1;0;10
1046;Čiauškutis;ŽVIRBLIUKAI;9759888353;Ne;0;0;1;1
1047;Čiauškutis;SAULUTĖS;7027181377;Ne;1;16;3;20
1048;Čiauškutis;SAULUTĖS;43313173294;Ne;0;18;2;20
1049;Čiauškutis;SAULUTĖS;7367933940;Ne;0;1;0;1
1050;Čiauškutis;SAULUTĖS;6115354862;Ne;0;2;4;6
1051;Čiauškutis;EŽIUKAI;7746580858;Ne;10;0;0;10
1052;Čiauškutis;EŽIUKAI;2686038029;Ne;0;0;4;4
1053;Čiauškutis;EŽIUKAI;1928404791;Ne;3;0;4;7
1054;Čiauškutis;EŽIUKAI;7489733038;Ne;5;0;2;7
1055;Čiauškutis;EŽIUKAI;5404165993;Ne;0;0;2;2
1056;Čiauškutis;EŽIUKAI;9959952114;Ne;0;0;1;1
1057;Čiauškutis;EŽIUKAI;1158816422;Ne;0;0;1;1
1058;Čiauškutis;EŽIUKAI;7239878097;Ne;0;1;0;1
1059;Čiauškutis;EŽIUKAI;5910818962;Ne;3;0;0;3
1060;Čiauškutis;DRUGELIAI;7080320173;Ne;1;0;3;4
1061;Čiauškutis;DRUGELIAI;7312776041;Ne;3;0;2;5
1062;Čiauškutis;DRUGELIAI;9072764004;Ne;0;1;3;4
1063;Čiauškutis;DRUGELIAI;1036358147;Ne;0;0;1;1
1064;Čiauškutis;DRUGELIAI;1750040659;Ne;8;0;0;8
1065;Čiauškutis;DRUGELIAI;8346845876;Ne;10;0;0;10
1066;Čiauškutis;DRUGELIAI;3724324861;Ne;0;20;0;20
1067;Čiauškutis;DRUGELIAI;2237570705;Ne;0;1;0;1
1068;Čiauškutis;DRUGELIAI;9073514151;Ne;10;0;0;10
1069;Čiauškutis;DRUGELIAI;4681902267;Ne;0;0;4;4
1070;Čiauškutis;GENELIAI;7440425102;Ne;5;1;1;7
1071;Čiauškutis;GENELIAI;76449285846;Ne;0;1;0;1
1072;Čiauškutis;GENELIAI;1456067541;Ne;6;0;0;6
1073;Čiauškutis;GENELIAI;1657452686;Ne;0;3;4;7
1074;Čiauškutis;GENELIAI;1739403100;Ne;0;18;2;20
1075;Čiauškutis;GENELIAI;6994301415;Ne;7;0;0;7
1076;Čiauškutis;GENELIAI;1224986101;Ne;4;1;0;5
1077;Čiauškutis;GENELIAI;1809511815;Ne;2;0;1;3
1078;Čiauškutis;LINKSMUČIAI;8689127061;Ne;12;3;0;15
1079;Čiauškutis;LINKSMUČIAI;9062135043;Ne;1;13;6;20
1080;Čiauškutis;LINKSMUČIAI;1533938659;Ne;8;1;0;9
1081;Čiauškutis;LINKSMUČIAI;2218793969;Ne;0;10;0;10
1082;Čiauškutis;LINKSMUČIAI;2672796261;Ne;0;0;2;2
1083;Čiauškutis;KIŠKUČIAI;1396093940;Ne;0;0;1;1
1084;Čiauškutis;KIŠKUČIAI;3465024013;Ne;0;20;0;20
1085;Čiauškutis;KIŠKUČIAI;2271458332;Ne;0;0;1;1
1086;Čiauškutis;KIŠKUČIAI;9754417066;Ne;4;0;2;6
1087;Čiauškutis;KIŠKUČIAI;8580034134;Taip;4;0;1;5
1088;Čiauškutis;KIŠKUČIAI;3650541072;Ne;0;0;2;2
1089;Čiauškutis;KIŠKUČIAI;2445742257;Ne;8;6;6;20
1090;Čiauškutis;KIŠKUČIAI;6785604459;Ne;20;0;0;20
1091;Čiauškutis;LAPIUKAI;5052137859;Ne;0;19;1;20
1092;Čiauškutis;LAPIUKAI;7428833348;Ne;0;0;1;1
1093;Čiauškutis;LAPIUKAI;9897499968;Ne;0;13;7;20
1094;Čiauškutis;LAPIUKAI;8876608072;Ne;6;0;6;12
1095;Čiauškutis;LAPIUKAI;4881821738;Ne;12;0;0;12
1096;Čiauškutis;LAPIUKAI;4881821738;Ne;12;0;0;12
1097;Čiauškutis;LAPIUKAI;6810906239;Ne;7;13;0;20
1098;Čiauškutis;LAPIUKAI;9460608737;Ne;9;0;5;14
1099;Čiauškutis;MEŠKUČIAI;7135435979;Ne;0;0;3;3
1100;Čiauškutis;MEŠKUČIAI;7274368180;Taip;7;0;0;7
1101;Čiauškutis;MEŠKUČIAI;6146321785;Ne;0;17;3;20
1102;Čiauškutis;MEŠKUČIAI;6434727608;Ne;8;7;5;20
1103;Čiauškutis;MEŠKUČIAI;7526975680;Ne;0;1;0;1
1104;Čiauškutis;MEŠKUČIAI;3660195990;Ne;10;0;0;10
1105;Čiauškutis;PELĖDŽIUKAI;7931998640;Ne;0;0;1;1
1106;Čiauškutis;PELĖDŽIUKAI;3833382641;Taip;0;0;1;1
1107;Čiauškutis;PELĖDŽIUKAI;6615319751;Ne;9;0;2;11
1108;Čiauškutis;PELĖDŽIUKAI;2377986721;Ne;9;0;0;9
1109;Čiauškutis;NYKŠTUKAI;8948893335;Ne;15;0;0;15
1110;Čiauškutis;NYKŠTUKAI;2633243682;Ne;11;1;0;12
1111;Čiauškutis;NYKŠTUKAI;6726124641;Ne;0;2;0;2
1112;Čiauškutis;NYKŠTUKAI;5957587644;Ne;20;0;0;20
1113;Čiauškutis;NYKŠTUKAI;1733251156;Ne;5;0;0;5
1114;Čiauškutis;NYKŠTUKAI;2044220236;Ne;0;1;0;1
1115;Čiauškutis;NYKŠTUKAI;7335655769;Ne;11;0;0;11
1116;Daigelis;Bitutės;2252139639;Ne;11;0;0;11
1117;Daigelis;Bitutės;1639589842;Ne;3;0;0;3
1118;Daigelis;Bitutės;1201983358;Taip;10;0;0;10
1119;Daigelis;Bitutės;8855668502;Ne;17;0;0;17
1120;Daigelis;Bitutės;6285764348;Ne;5;0;0;5
1121;Daigelis;Bitutės;1333421528;Ne;4;0;0;4
1122;Daigelis;Bitutės;3653331894;Ne;5;0;0;5
1123;Daigelis;"VIEVERSĖLIAI (SPEC)";9392290289;Ne;3;0;0;3
1124;Daigelis;"VIEVERSĖLIAI (SPEC)";7903833413;Ne;4;0;0;4
1125;Daigelis;"VIEVERSĖLIAI (SPEC)";4402503971;Ne;4;0;0;4
1126;Daigelis;"SAULUTĖ (SPEC.sav.)";8973215240;Ne;5;0;0;5
1127;Daigelis;"SAULUTĖ (SPEC.sav.)";8020718571;Ne;6;0;0;6
1128;Daigelis;Spinduliukai;1231703889;Ne;6;0;0;6
1129;Daigelis;Spinduliukai;5326415916;Taip;16;0;0;16
1130;Daigelis;Spinduliukai;6384314661;Ne;3;0;0;3
1131;Daigelis;Spinduliukai;3192556582;Ne;9;0;0;9
1132;Daigelis;Spinduliukai;6894804166;Ne;10;0;0;10
1133;Daigelis;Pelėdžiukai;6718987671;Ne;6;0;0;6
1134;Daigelis;Pelėdžiukai;2431435960;Ne;8;0;0;8
1135;Daigelis;Pelėdžiukai;4215451069;Ne;6;0;0;6
1136;Daigelis;Pelėdžiukai;7616571136;Ne;5;0;0;5
1137;Daigelis;Pelėdžiukai;1041144226;Ne;7;0;0;7
1138;Daigelis;Pelėdžiukai;6041192600;Ne;11;0;0;11
1139;Daigelis;Žvaigždutės;4498253271;Ne;5;0;0;5
1140;Daigelis;Žvaigždutės;9588934306;Ne;17;0;0;17
1141;Daigelis;Žvaigždutės;1284567777;Ne;11;0;0;11
1142;Daigelis;Skruzdėliukai;7722215336;Taip;8;0;0;8
1143;Daigelis;Skruzdėliukai;2609340865;Ne;2;0;0;2
1144;Daigelis;Skruzdėliukai;8535045138;Ne;2;0;0;2
1145;Daigelis;Skruzdėliukai;2958204022;Ne;5;0;0;5
1146;Daigelis;Skruzdėliukai;2303781119;Ne;8;0;0;8
1147;Daigelis;Skruzdėliukai;9962266890;Ne;8;0;0;8
1148;Daigelis;Skruzdėliukai;8317879752;Ne;2;0;0;2
1149;Daigelis;Lašeliai;3139261869;Ne;8;0;0;8
1150;Daigelis;Lašeliai;5826615344;Taip;6;0;0;6
1151;Daigelis;Lašeliai;5193951960;Ne;10;0;0;10
1152;Daigelis;Lašeliai;2068456116;Ne;8;0;0;8
1153;Daigelis;Lašeliai;9241073182;Ne;4;0;0;4
1154;Daigelis;Lašeliai;4415517674;Taip;5;0;0;5
1155;Daigelis;Lašeliai;5546501262;Ne;8;0;0;8
1156;Daigelis;Lašeliai;8826943868;Ne;5;0;0;5
1157;Daigelis;Gėlytės;8372290030;Ne;9;0;0;9
1158;Daigelis;Gėlytės;4630959295;Taip;1;0;0;1
1159;Daigelis;Gėlytės;9987516903;Ne;7;0;0;7
1160;Daigelis;Funtiki;4162501269;Ne;11;0;0;11
1161;Daigelis;Funtiki;8648385235;Ne;4;0;0;4
1162;Daigelis;Funtiki;1239215055;Ne;6;0;0;6
1163;Daigelis;Funtiki;1036163147;Ne;18;0;0;18
1164;Daigelis;Funtiki;8052793731;Ne;1;0;0;1
1165;Daigelis;Funtiki;5367788682;Ne;11;0;0;11
1166;Daigelis;Funtiki;5503176248;Ne;7;0;0;7
1167;Daigelis;Nevaliaški;6979105726;Ne;6;0;0;6
1168;Daigelis;Nevaliaški;2619313944;Ne;3;0;0;3
1169;Daigelis;Nevaliaški;1417334688;Ne;1;0;0;1
1170;Daigelis;Nevaliaški;4615798936;Ne;7;0;0;7
1171;Daigelis;Nevaliaški;1883094184;Ne;7;0;0;7
1172;Delfinukas;Boružėlių;4196156707;Ne;3;0;0;3
1173;Delfinukas;Boružėlių;9184207705;Ne;0;2;3;5
1174;Delfinukas;Boružėlių;3205671100;Ne;0;2;0;2
1175;Delfinukas;Boružėlių;1119373532;Ne;6;0;1;7
1176;Delfinukas;Boružėlių;4488260667;Ne;0;1;0;1
1177;Delfinukas;Boružėlių;7737665102;Ne;5;1;0;6
1178;Delfinukas;Boružėlių;4985159933;Ne;0;1;0;1
1179;Delfinukas;Boružėlių;5443027988;Ne;0;1;0;1
1180;Delfinukas;Boružėlių;4567479900;Ne;4;0;1;5
1181;Delfinukas;Boružėlių;7312438969;Taip;3;0;0;3
1182;Delfinukas;Boružėlių;5585334518;Ne;8;0;0;8
1183;Delfinukas;Boružėlių;4327924499;Ne;6;0;2;8
1184;Delfinukas;Boružėlių;6693756145;Ne;2;0;0;2
1185;Delfinukas;Boružėlių;6301767635;Ne;0;4;0;4
1186;Delfinukas;Saulytės;8315269427;Ne;0;0;1;1
1187;Delfinukas;Saulytės;4215887291;Ne;0;1;0;1
1188;Delfinukas;Saulytės;3631520143;Ne;10;0;0;10
1189;Delfinukas;Saulytės;9424966984;Taip;0;0;5;5
1190;Delfinukas;Saulytės;9729550922;Taip;0;3;0;3
1191;Delfinukas;Saulytės;1404270345;Ne;0;1;1;2
1192;Delfinukas;Saulytės;3842160990;Ne;0;2;0;2
1193;Delfinukas;Saulytės;8402529296;Taip;4;10;0;14
1194;Delfinukas;Saulytės;5642328792;Ne;7;0;0;7
1195;Delfinukas;Saulytės;8176576958;Ne;12;0;0;12
1196;Delfinukas;Saulytės;8275943176;Ne;6;0;0;6
1197;Delfinukas;Saulytės;8085530134;Ne;0;9;0;9
1198;Delfinukas;Saulytės;8148610460;Taip;0;2;2;4
1199;Delfinukas;Saulytės;6935992202;Taip;1;0;1;2
1200;Delfinukas;Saulytės;8186312409;Ne;3;2;0;5
1201;Delfinukas;Saulytės;7904803011;Taip;0;2;3;5
1202;Delfinukas;Saulytės;1296440609;Ne;0;0;4;4
1203;Delfinukas;Saulytės;5397241026;Ne;0;5;0;5
1204;Delfinukas;Pelėdžiukų;3940838205;Taip;0;2;1;3
1205;Delfinukas;Pelėdžiukų;8774145277;Ne;0;2;0;2
1206;Delfinukas;Pelėdžiukų;3770227955;Ne;0;4;0;4
1207;Delfinukas;Pelėdžiukų;6113662246;Ne;0;13;0;13
1208;Delfinukas;Pelėdžiukų;4710894128;Ne;5;5;0;10
1209;Delfinukas;Pelėdžiukų;1526129772;Ne;0;1;3;4
1210;Delfinukas;Pelėdžiukų;8659309242;Ne;0;6;0;6
1211;Delfinukas;Pelėdžiukų;8267992425;Ne;0;4;8;12
1212;Delfinukas;Pelėdžiukų;9319874239;Taip;0;2;0;2
1213;Delfinukas;Pelėdžiukų;2809947323;Ne;0;1;0;1
1214;Delfinukas;Pelėdžiukų;3465186420;Ne;0;1;6;7
1215;Delfinukas;Pelėdžiukų;4096274346;Taip;0;2;2;4
1216;Delfinukas;Pelėdžiukų;5246300518;Ne;9;1;0;10
1217;Delfinukas;Pelėdžiukų;3702341009;Ne;0;1;0;1
1218;Delfinukas;Pelėdžiukų;2420308954;Ne;5;0;3;8
1219;Delfinukas;Pelėdžiukų;6286748047;Ne;0;8;0;8
1220;Delfinukas;Pelėdžiukų;8432654056;Taip;1;1;3;5
1221;Delfinukas;Pelėdžiukų;3795705735;Taip;0;1;0;1
1222;Delfinukas;Pelėdžiukų;1575125658;Ne;0;5;0;5
1223;Delfinukas;Pelėdžiukų;4384995354;Ne;0;1;0;1
1224;Delfinukas;Pelėdžiukų;3633392440;Ne;15;1;0;16
1225;Delfinukas;Varliukų;4949220786;Ne;9;2;3;14
1226;Delfinukas;Varliukų;2792051636;Taip;9;1;0;10
1227;Delfinukas;Varliukų;4780352568;Ne;6;1;0;7
1228;Delfinukas;Varliukų;3577180085;Ne;8;0;0;8
1229;Delfinukas;Varliukų;6115370195;Taip;5;0;0;5
1230;Delfinukas;Varliukų;3050258185;Ne;5;0;0;5
1231;Delfinukas;Varliukų;7976681530;Ne;5;0;0;5
1232;Delfinukas;Varliukų;9360553910;Ne;2;1;0;3
1233;Delfinukas;Varliukų;6301601832;Ne;1;0;0;1
1234;Delfinukas;Varliukų;5095713834;Ne;20;0;0;20
1235;Delfinukas;Varliukų;5964021733;Ne;20;0;0;20
1236;Delfinukas;Varliukų;5821591959;Ne;0;2;0;2
1237;Delfinukas;Varliukų;9095895182;Ne;0;0;1;1
1238;Delfinukas;Varliukų;5138840297;Ne;0;1;0;1
1239;Delfinukas;Varliukų;7072060541;Ne;8;1;0;9
1240;Delfinukas;Varliukų;3797355501;Ne;11;3;0;14
1241;Delfinukas;Varliukų;4751611934;Taip;0;2;0;2
1242;Delfinukas;Varliukų;4254414928;Taip;7;1;0;8
1243;Delfinukas;Varliukų;7359531377;Ne;1;0;4;5
1244;Delfinukas;Varpelių;9514189769;Ne;0;2;0;2
1245;Delfinukas;Varpelių;4713803167;Ne;0;9;0;9
1246;Delfinukas;Varpelių;8936645508;Taip;5;3;0;8
1247;Delfinukas;Varpelių;6047881184;Taip;8;0;1;9
1248;Delfinukas;Varpelių;3818558339;Ne;3;0;1;4
1249;Delfinukas;Varpelių;1484123788;Ne;10;1;0;11
1250;Delfinukas;Varpelių;4877757730;Ne;4;0;0;4
1251;Delfinukas;Varpelių;7973858761;Ne;4;0;0;4
1252;Delfinukas;Varpelių;8950528288;Ne;7;0;0;7
1253;Delfinukas;Varpelių;8829835426;Ne;0;0;2;2
1254;Delfinukas;Varpelių;4500756171;Taip;2;0;0;2
1255;Delfinukas;Varpelių;8953230752;Ne;4;0;0;4
1256;Delfinukas;Varpelių;7780893730;Ne;0;1;2;3
1257;Delfinukas;Varpelių;2730512600;Ne;3;3;0;6
1258;Delfinukas;Varpelių;8911433659;Ne;0;0;1;1
1259;Delfinukas;Drugeliai;7615519932;Ne;5;1;1;7
1260;Delfinukas;Drugeliai;6604115681;Ne;8;5;0;13
1261;Delfinukas;Drugeliai;5990192934;Ne;7;0;0;7
1262;Delfinukas;Drugeliai;9635669748;Ne;0;3;0;3
1263;Delfinukas;Drugeliai;8526813977;Ne;0;3;0;3
1264;Delfinukas;Drugeliai;6873181103;Ne;0;2;0;2
1265;Delfinukas;Drugeliai;4484804360;Ne;0;1;0;1
1266;Delfinukas;Drugeliai;6992505341;Ne;0;2;0;2
1267;Delfinukas;Drugeliai;8129592398;Ne;1;1;0;2
1268;Delfinukas;Drugeliai;8606989493;Ne;0;0;2;2
1269;Delfinukas;Drugeliai;2756574162;Ne;0;1;0;1
1270;Delfinukas;Drugeliai;2985669766;Ne;6;8;0;14
1271;Delfinukas;Drugeliai;6457042338;Taip;0;7;0;7
1272;Delfinukas;Drugeliai;8411289299;Ne;4;0;0;4
1273;Delfinukas;Žuvytės;8160982025;Taip;0;3;0;3
1274;Delfinukas;Žuvytės;6578506861;Taip;4;0;0;4
1275;Delfinukas;Žuvytės;6322255194;Taip;2;1;0;3
1276;Delfinukas;Žuvytės;6572690788;Taip;0;5;0;5
1277;Delfinukas;Žuvytės;9898412288;Taip;6;1;0;7
1278;Delfinukas;Žuvytės;3397350274;Ne;14;1;0;15
1279;Delfinukas;Žuvytės;9520598359;Taip;7;6;0;13
1280;Delfinukas;Žuvytės;3804996594;Taip;0;2;1;3
1281;Delfinukas;Žuvytės;7487111570;Taip;0;3;0;3
1282;Delfinukas;Žuvytės;8702718951;Taip;0;1;3;4
1283;Delfinukas;Žuvytės;6844500395;Taip;6;0;0;6
1284;Delfinukas;Žuvytės;6445868759;Ne;0;2;1;3
1285;Delfinukas;Žuvytės;9074294473;Taip;0;0;5;5
1286;Delfinukas;Žuvytės;4678970810;Taip;4;0;0;4
1287;Delfinukas;Žuvytės;6478152041;Taip;8;1;0;9
1288;Delfinukas;Žuvytės;4784667239;Ne;0;1;0;1
1289;Delfinukas;Delfinai;2890469172;Ne;0;0;6;6
1290;Delfinukas;Delfinai;9628317328;Ne;5;0;0;5
1291;Delfinukas;Delfinai;5797308373;Ne;0;1;0;1
1292;Delfinukas;Delfinai;5241426445;Ne;7;1;2;10
1293;Delfinukas;Delfinai;3108430680;Ne;0;0;3;3
1294;Delfinukas;Delfinai;7663934825;Ne;0;1;0;1
1295;Delfinukas;Delfinai;2382077576;Ne;0;1;3;4
1296;Delfinukas;Delfinai;1200205376;Ne;7;0;0;7
1297;Delfinukas;Delfinai;7629622746;Ne;1;0;0;1
1298;Delfinukas;Delfinai;4347116918;Ne;0;13;0;13
1299;Delfinukas;Delfinai;1922513830;Ne;6;1;0;7
1300;Delfinukas;Delfinai;6270012707;Ne;12;2;0;14
1301;Delfinukas;Delfinai;8085481968;Ne;0;2;0;2
1302;Delfinukas;Delfinai;7354837777;Ne;20;0;0;20
1303;Delfinukas;Delfinai;9903010418;Ne;0;5;0;5
1304;Delfinukas;Delfinai;6522639028;Taip;6;0;2;8
1305;Delfinukas;Delfinai;9253061888;Ne;4;0;0;4
1306;Delfinukas;Paukšteliai;7366145460;Ne;6;0;0;6
1307;Delfinukas;Paukšteliai;5278689745;Ne;2;1;1;4
1308;Delfinukas;Paukšteliai;6002086491;Ne;0;1;3;4
1309;Delfinukas;Paukšteliai;1164720538;Ne;0;4;0;4
1310;Delfinukas;Paukšteliai;9332794060;Ne;9;0;2;11
1311;Delfinukas;Paukšteliai;5368435217;Taip;0;0;20;20
1312;Delfinukas;Paukšteliai;6650725760;Ne;0;0;20;20
1313;Delfinukas;Paukšteliai;7968869585;Taip;17;0;0;17
1314;Delfinukas;Paukšteliai;5164599763;Ne;13;0;0;13
1315;Delfinukas;Paukšteliai;9776618488;Ne;2;0;2;4
1316;Delfinukas;Paukšteliai;4561911078;Ne;10;0;1;11
1317;Delfinukas;Paukšteliai;4755699845;Ne;14;0;0;14
1318;Delfinukas;Kiškučiai;4119370256;Taip;0;2;0;2
1319;Delfinukas;Kiškučiai;3284212595;Taip;0;0;1;1
1320;Delfinukas;Kiškučiai;8439204095;Taip;0;1;0;1
1321;Delfinukas;Kiškučiai;5783537897;Taip;0;0;1;1
1322;Delfinukas;Kiškučiai;8728791932;Taip;0;0;9;9
1323;Delfinukas;Kiškučiai;7365398150;Ne;6;0;2;8
1324;Delfinukas;Kiškučiai;2883959240;Taip;0;2;0;2
1325;Delfinukas;Kiškučiai;4179507316;Taip;4;1;0;5
1326;Delfinukas;Kiškučiai;8440546956;Taip;0;2;0;2
1327;Delfinukas;Kiškučiai;1030958414;Taip;0;3;0;3
1328;Delfinukas;Kiškučiai;7638190553;Taip;0;2;0;2
1329;Delfinukas;Kiškučiai;6577214344;Ne;0;2;0;2
1330;Delfinukas;Kiškučiai;2537442505;Taip;0;2;0;2
1331;Delfinukas;BITUTĖS;9719348837;Ne;6;0;0;6
1332;Delfinukas;BITUTĖS;6601922746;Ne;0;7;0;7
1333;Delfinukas;BITUTĖS;8896957908;Ne;0;0;1;1
1334;Delfinukas;BITUTĖS;3239635507;Ne;0;0;4;4
1335;Delfinukas;BITUTĖS;6929926768;Ne;14;2;0;16
1336;Delfinukas;BITUTĖS;5557399916;Ne;9;0;0;9
1337;Delfinukas;BITUTĖS;5179080544;Taip;0;7;0;7
1338;Delfinukas;BITUTĖS;9941631164;Ne;0;6;0;6
1339;Delfinukas;BITUTĖS;4198261848;Ne;0;0;3;3
1340;Delfinukas;BITUTĖS;8081895401;Ne;11;0;0;11
1341;Delfinukas;BITUTĖS;5600320855;Ne;14;5;0;19
1342;Delfinukas;BITUTĖS;8552371520;Ne;0;0;1;1
1343;Delfinukas;BITUTĖS;2377204734;Ne;6;1;9;16
1344;Delfinukas;BITUTĖS;6243471374;Ne;6;6;0;12
1345;Delfinukas;BITUTĖS;4303234827;Ne;20;0;0;20
1346;Delfinukas;BITUTĖS;6325092903;Ne;6;0;0;6
1347;Drevinukas;ZUIKUČIAI;9817317105;Ne;0;0;6;6
1348;Drevinukas;ZUIKUČIAI;1595081335;Ne;6;0;4;10
1349;Drevinukas;ZUIKUČIAI;2646799484;Ne;0;0;2;2
1350;Drevinukas;ZUIKUČIAI;2772424629;Ne;5;1;3;9
1351;Drevinukas;ZUIKUČIAI;5928234487;Ne;0;0;4;4
1352;Drevinukas;ZUIKUČIAI;8873060121;Ne;4;0;1;5
1353;Drevinukas;ZUIKUČIAI;1567790084;Ne;3;0;1;4
1354;Drevinukas;ZUIKUČIAI;3293457412;Ne;0;0;1;1
1355;Drevinukas;ZUIKUČIAI;6243097297;Ne;0;1;7;8
1356;Drevinukas;ZUIKUČIAI;5704489483;Ne;1;1;4;6
1357;Drevinukas;ZUIKUČIAI;7054681115;Ne;2;1;2;5
1358;Drevinukas;ZUIKUČIAI;3381363132;Ne;11;1;2;14
1359;Drevinukas;ZUIKUČIAI;6462582301;Ne;7;0;0;7
1360;Drevinukas;ZUIKUČIAI;3070518153;Ne;0;1;1;2
1361;Drevinukas;ZUIKUČIAI;9174977150;Ne;10;0;2;12
1362;Drevinukas;ZUIKUČIAI;4243045398;Ne;9;0;5;14
1363;Drevinukas;ZUIKUČIAI;4309475233;Ne;9;0;5;14
1364;Drevinukas;AŽUOLIUKŲ;1644656704;Ne;7;2;0;9
1365;Drevinukas;AŽUOLIUKŲ;4714478955;Ne;5;2;0;7
1366;Drevinukas;AŽUOLIUKŲ;8701250912;Ne;0;0;1;1
1367;Drevinukas;AŽUOLIUKŲ;8143614891;Ne;0;7;0;7
1368;Drevinukas;AŽUOLIUKŲ;4213259879;Taip;7;4;0;11
1369;Drevinukas;AŽUOLIUKŲ;5673244101;Ne;5;1;0;6
1370;Drevinukas;AŽUOLIUKŲ;3643007998;Ne;0;16;0;16
1371;Drevinukas;AŽUOLIUKŲ;4262951360;Ne;8;0;0;8
1372;Drevinukas;AŽUOLIUKŲ;5959004452;Ne;0;2;0;2
1373;Drevinukas;AŽUOLIUKŲ;7689145214;Ne;0;2;0;2
1374;Drevinukas;AŽUOLIUKŲ;4572837478;Ne;0;1;0;1
1375;Drevinukas;AŽUOLIUKŲ;1564065835;Ne;0;4;0;4
1376;Drevinukas;AŽUOLIUKŲ;9289471118;Ne;1;2;0;3
1377;Drevinukas;AŽUOLIUKŲ;9915130747;Ne;10;5;0;15
1378;Drevinukas;AŽUOLIUKŲ;6891793135;Ne;0;2;0;2
1379;Drevinukas;AŽUOLIUKŲ;1058927778;Ne;0;2;0;2
1380;Drevinukas;AŽUOLIUKŲ;9534007163;Ne;10;0;0;10
1381;Drevinukas;AŽUOLIUKŲ;2300338724;Ne;4;0;0;4
1382;Drevinukas;AŽUOLIUKŲ;9513405583;Ne;3;1;0;4
1383;Drevinukas;AŽUOLIUKŲ;8896207423;Ne;8;0;0;8
1384;Drevinukas;PELĖDŽIUKAI;1123115847;Ne;9;0;0;9
1385;Drevinukas;PELĖDŽIUKAI;1987939679;Ne;2;0;0;2
1386;Drevinukas;PELĖDŽIUKAI;9336227821;Ne;0;0;3;3
1387;Drevinukas;PELĖDŽIUKAI;9803670483;Ne;0;0;3;3
1388;Drevinukas;PELĖDŽIUKAI;7519369167;Ne;4;0;0;4
1389;Drevinukas;PELĖDŽIUKAI;16952164778;Ne;0;0;2;2
1390;Drevinukas;PELĖDŽIUKAI;3657451903;Ne;4;0;1;5
1391;Drevinukas;PELĖDŽIUKAI;4332606643;Ne;5;0;0;5
1392;Drevinukas;PELĖDŽIUKAI;7632515230;Ne;0;3;2;5
1393;Drevinukas;PELĖDŽIUKAI;5686116320;Ne;0;0;3;3
1394;Drevinukas;PELĖDŽIUKAI;56028675283;Ne;5;9;2;16
1395;Drevinukas;PELĖDŽIUKAI;85288014888;Ne;0;0;1;1
1396;Drevinukas;PELĖDŽIUKAI;6954102486;Ne;0;0;1;1
1397;Drevinukas;PELĖDŽIUKAI;3086451968;Ne;0;0;5;5
1398;Drevinukas;PELĖDŽIUKAI;6833120798;Ne;0;0;3;3
1399;Drevinukas;PELĖDŽIUKAI;7607135647;Ne;4;2;0;6
1400;Drevinukas;BORUŽĖLĖS;3046196006;Ne;0;9;2;11
1401;Drevinukas;BORUŽĖLĖS;4134729710;Ne;0;1;1;2
1402;Drevinukas;BORUŽĖLĖS;5236292764;Ne;0;5;0;5
1403;Drevinukas;BORUŽĖLĖS;3032536983;Ne;0;0;2;2
1404;Drevinukas;BORUŽĖLĖS;3392249574;Ne;3;1;3;7
1405;Drevinukas;BORUŽĖLĖS;5524567803;Ne;0;0;6;6
1406;Drevinukas;BORUŽĖLĖS;9016985238;Ne;11;0;0;11
1407;Drevinukas;BORUŽĖLĖS;2929598743;Ne;0;7;0;7
1408;Drevinukas;BORUŽĖLĖS;4076576850;Ne;4;0;8;12
1409;Drevinukas;BORUŽĖLĖS;6373230526;Ne;10;2;3;15
1410;Drevinukas;BORUŽĖLĖS;7642022439;Ne;0;0;1;1
1411;Drevinukas;BORUŽĖLĖS;6316000019;Taip;0;0;1;1
1412;Drevinukas;BORUŽĖLĖS;4404254932;Ne;0;0;2;2
1413;Drevinukas;BORUŽĖLĖS;1859208322;Ne;11;0;0;11
1414;Drevinukas;BORUŽĖLĖS;5620887702;Ne;0;3;0;3
1415;Drevinukas;BORUŽĖLĖS;2281463885;Ne;0;0;2;2
1416;Drevinukas;BORUŽĖLĖS;4662426451;Ne;5;0;2;7
1417;Drevinukas;BORUŽĖLĖS;5875459639;Ne;7;0;0;7
1418;Drevinukas;BORUŽĖLĖS;6582186497;Ne;0;5;2;7
1419;Drevinukas;BITUTĖS;3981507849;Ne;0;4;0;4
1420;Drevinukas;BITUTĖS;7753238387;Ne;0;13;0;13
1421;Drevinukas;BITUTĖS;3617570755;Ne;14;1;0;15
1422;Drevinukas;BITUTĖS;5679723776;Ne;9;1;0;10
1423;Drevinukas;BITUTĖS;1720464417;Ne;3;6;0;9
1424;Drevinukas;BITUTĖS;6095020718;Ne;5;0;3;8
1425;Drevinukas;BITUTĖS;1099462840;Ne;0;0;1;1
1426;Drevinukas;BITUTĖS;1152161183;Ne;8;0;0;8
1427;Drevinukas;BITUTĖS;8611131264;Ne;0;4;0;4
1428;Drevinukas;BITUTĖS;8936058501;Ne;7;0;1;8
1429;Drevinukas;BITUTĖS;5348609358;Ne;0;1;1;2
1430;Drevinukas;BITUTĖS;1098647410;Ne;3;0;0;3
1431;Drevinukas;BITUTĖS;2312241894;Ne;7;0;0;7
1432;Drevinukas;BITUTĖS;5394143000;Ne;0;2;0;2
1433;Drevinukas;BITUTĖS;3871506691;Ne;12;4;0;16
1434;Drevinukas;BITUTĖS;6914111231;Ne;12;4;0;16
1435;Drevinukas;BITUTĖS;3377957769;Ne;0;4;1;5
1436;Drevinukas;BITUTĖS;2423143170;Ne;8;0;3;11
1437;Drevinukas;BITUTĖS;1343431478;Ne;5;0;0;5
1438;Drevinukas;BITUTĖS;1829421385;Ne;1;0;0;1
1439;Drevinukas;BITUTĖS;8262224710;Ne;0;7;0;7
1440;Drevinukas;NYKŠTUKAI;6165662595;Ne;0;7;2;9
1441;Drevinukas;NYKŠTUKAI;4147987057;Ne;2;2;0;4
1442;Drevinukas;NYKŠTUKAI;6645506336;Ne;14;1;2;17
1443;Drevinukas;NYKŠTUKAI;3240313747;Ne;6;0;1;7
1444;Drevinukas;NYKŠTUKAI;8940838262;Ne;5;1;0;6
1445;Drevinukas;NYKŠTUKAI;8719022482;Ne;3;0;1;4
1446;Drevinukas;NYKŠTUKAI;9695419813;Ne;10;3;1;14
1447;Drevinukas;NYKŠTUKAI;9517560132;Ne;6;4;7;17
1448;Drevinukas;NYKŠTUKAI;6895472558;Ne;20;0;0;20
1449;Drevinukas;NYKŠTUKAI;2571295179;Ne;12;4;0;16
1450;Drevinukas;NYKŠTUKAI;2820241608;Ne;0;4;0;4
1451;Drevinukas;NYKŠTUKAI;5860361695;Ne;5;0;2;7
1452;Drevinukas;NYKŠTUKAI;9845207619;Ne;0;0;7;7
1453;Drevinukas;NYKŠTUKAI;8694887879;Ne;0;1;0;1
1454;Drevinukas;NYKŠTUKAI;6680003214;Ne;0;0;2;2
1455;Drevinukas;NYKŠTUKAI;3192583690;Ne;0;1;1;2
1456;Drevinukas;NYKŠTUKAI;6659263391;Ne;0;1;1;2
1457;Drevinukas;NYKŠTUKAI;4588368596;Ne;6;0;2;8
1458;Drevinukas;SMALSUČIAI;1094428951;Ne;6;0;0;6
1459;Drevinukas;SMALSUČIAI;2179736991;Ne;3;2;0;5
1460;Drevinukas;SMALSUČIAI;9105675010;Ne;0;1;1;2
1461;Drevinukas;SMALSUČIAI;9004568476;Ne;5;0;1;6
1462;Drevinukas;SMALSUČIAI;9283862598;Ne;11;0;0;11
1463;Drevinukas;SMALSUČIAI;8578579808;Ne;1;0;0;1
1464;Drevinukas;SMALSUČIAI;3611870655;Ne;6;0;1;7
1465;Drevinukas;SMALSUČIAI;7241671439;Ne;8;0;2;10
1466;Drevinukas;SMALSUČIAI;2246885419;Ne;8;2;0;10
1467;Drevinukas;SMALSUČIAI;4089351543;Ne;0;13;0;13
1468;Drevinukas;SMALSUČIAI;2201342382;Taip;0;1;0;1
1469;Drevinukas;SMALSUČIAI;4759293403;Ne;15;0;0;15
1470;Drevinukas;SMALSUČIAI;7863529560;Ne;0;1;3;4
1471;Drevinukas;SMALSUČIAI;9715586195;Ne;1;0;0;1
1472;Drevinukas;SMALSUČIAI;1368495173;Ne;0;6;0;6
1473;Drevinukas;SMALSUČIAI;8284025903;Ne;0;2;0;2
1474;Drevinukas;SMALSUČIAI;6492987985;Ne;0;0;5;5
1475;Drevinukas;ŽVIRBLIUKAI;8654858364;Ne;6;0;4;10
1476;Drevinukas;ŽVIRBLIUKAI;2662147175;Ne;7;0;0;7
1477;Drevinukas;ŽVIRBLIUKAI;7801920518;Ne;0;0;20;20
1478;Drevinukas;ŽVIRBLIUKAI;1570356979;Ne;0;5;0;5
1479;Drevinukas;ŽVIRBLIUKAI;8877080179;Ne;0;0;3;3
1480;Drevinukas;ŽVIRBLIUKAI;6492711565;Ne;0;0;1;1
1481;Drevinukas;ŽVIRBLIUKAI;7316996793;Ne;3;1;0;4
1482;Drevinukas;ŽVIRBLIUKAI;3408981880;Ne;0;0;2;2
1483;Drevinukas;ŽVIRBLIUKAI;8953871512;Ne;4;0;0;4
1484;Drevinukas;ŽVIRBLIUKAI;3983656958;Ne;1;1;1;3
1485;Drevinukas;ŽVIRBLIUKAI;1957961770;Ne;2;2;2;6
1486;Drugelis;NYKŠTUKŲ;9316073597;Ne;0;1;0;1
1487;Drugelis;NYKŠTUKŲ;1785724340;Ne;5;1;0;6
1488;Drugelis;NYKŠTUKŲ;6632884258;Taip;6;2;2;10
1489;Drugelis;NYKŠTUKŲ;7447519502;Ne;4;0;0;4
1490;Drugelis;NYKŠTUKŲ;6594452094;Ne;1;2;0;3
1491;Drugelis;NYKŠTUKŲ;5122256823;Ne;4;0;0;4
1492;Drugelis;NYKŠTUKŲ;4825232236;Ne;0;1;0;1
1493;Drugelis;NYKŠTUKŲ;8717445483;Ne;0;3;0;3
1494;Drugelis;NYKŠTUKŲ;4471405682;Ne;0;0;2;2
1495;Drugelis;NYKŠTUKŲ;4867387611;Ne;0;11;0;11
1496;Drugelis;NYKŠTUKŲ;7609530453;Ne;0;1;0;1
1497;Drugelis;NYKŠTUKŲ;8070030439;Ne;0;1;0;1
1498;Drugelis;NYKŠTUKŲ;3061896520;Ne;0;1;0;1
1499;Drugelis;NYKŠTUKŲ;5692743298;Ne;0;2;4;6
1500;Drugelis;NYKŠTUKŲ;6452921695;Ne;5;2;1;8
1501;Drugelis;NYKŠTUKŲ;8591548746;Ne;0;4;0;4
1502;Drugelis;SMALSUČIŲ;5121351234;Ne;20;0;0;20
1503;Drugelis;SMALSUČIŲ;6626437352;Ne;0;2;0;2
1504;Drugelis;SMALSUČIŲ;5000965458;Ne;15;2;0;17
1505;Drugelis;SMALSUČIŲ;9683350741;Ne;7;5;0;12
1506;Drugelis;SMALSUČIŲ;4058293462;Ne;0;5;0;5
1507;Drugelis;SMALSUČIŲ;4805858183;Ne;5;1;0;6
1508;Drugelis;SMALSUČIŲ;9650052415;Ne;0;0;1;1
1509;Drugelis;SMALSUČIŲ;5533529267;Ne;0;3;1;4
1510;Drugelis;SMALSUČIŲ;3733097479;Ne;6;0;1;7
1511;Drugelis;SMALSUČIŲ;2196445523;Ne;0;1;0;1
1512;Drugelis;SMALSUČIŲ;8186338261;Ne;0;0;1;1
1513;Drugelis;SMALSUČIŲ;3372145698;Ne;0;8;0;8
1514;Drugelis;SMALSUČIŲ;2644563881;Ne;0;2;4;6
1515;Drugelis;SMALSUČIŲ;6613520046;Ne;0;0;3;3
1516;Drugelis;SMALSUČIŲ;6890441262;Ne;6;1;0;7
1517;Drugelis;MUMINUKŲ;3311620018;Ne;4;0;0;4
1518;Drugelis;MUMINUKŲ;8812550811;Ne;0;5;0;5
1519;Drugelis;MUMINUKŲ;5661335344;Ne;0;1;0;1
1520;Drugelis;MUMINUKŲ;6038184222;Ne;6;1;0;7
1521;Drugelis;MUMINUKŲ;7253876812;Ne;4;0;0;4
1522;Drugelis;MUMINUKŲ;1666992752;Ne;5;0;0;5
1523;Drugelis;MUMINUKŲ;9510744779;Ne;0;1;0;1
1524;Drugelis;MUMINUKŲ;9907121223;Ne;2;1;0;3
1525;Drugelis;MUMINUKŲ;1858504360;Ne;0;2;0;2
1526;Drugelis;MUMINUKŲ;8107970910;Ne;4;5;0;9
1527;Drugelis;MUMINUKŲ;3293212749;Ne;0;6;0;6
1528;Drugelis;MUMINUKŲ;2256221485;Ne;0;1;0;1
1529;Drugelis;MUMINUKŲ;9588931333;Ne;8;0;0;8
1530;Drugelis;MUMINUKŲ;1761596625;Ne;0;2;0;2
1531;Drugelis;PŪKUOTUKAI;9149748841;Ne;0;2;2;4
1532;Drugelis;PŪKUOTUKAI;1217635751;Ne;0;8;0;8
1533;Drugelis;PŪKUOTUKAI;9612696781;Ne;4;3;0;7
1534;Drugelis;PŪKUOTUKAI;27569805506;Ne;0;9;0;9
1535;Drugelis;PŪKUOTUKAI;1961898730;Ne;0;1;0;1
1536;Drugelis;PŪKUOTUKAI;7406396614;Ne;0;1;0;1
1537;Drugelis;PŪKUOTUKAI;1901608445;Ne;0;4;0;4
1538;Drugelis;PŪKUOTUKAI;1506988472;Ne;0;6;0;6
1539;Drugelis;PŪKUOTUKAI;1991420008;Ne;0;6;0;6
1540;Drugelis;PŪKUOTUKAI;1856912386;Ne;0;1;0;1
1541;Drugelis;PŪKUOTUKAI;1576853049;Ne;5;0;0;5
1542;Drugelis;PŪKUOTUKAI;68223183150;Ne;1;2;0;3
1543;Drugelis;PŪKUOTUKAI;3202149560;Ne;0;2;0;2
1544;Drugelis;PŪKUOTUKAI;1421438458;Ne;0;5;0;5
1545;Drugelis;PŪKUOTUKAI;5954059321;Ne;6;0;0;6
1546;Drugelis;PŪKUOTUKAI;53874036107;Ne;0;1;0;1
1547;Drugelis;PŪKUOTUKAI;3096906506;Ne;0;1;0;1
1548;Drugelis;SPINDULIUKAI;3081918342;Ne;2;0;1;3
1549;Drugelis;SPINDULIUKAI;3560294703;Ne;11;0;0;11
1550;Drugelis;SPINDULIUKAI;1215586620;Ne;3;0;0;3
1551;Drugelis;SPINDULIUKAI;9005448398;Ne;20;0;0;20
1552;Drugelis;SPINDULIUKAI;7775085427;Ne;0;10;0;10
1553;Drugelis;SPINDULIUKAI;2926662708;Taip;1;0;0;1
1554;Drugelis;SPINDULIUKAI;6504082488;Ne;0;2;0;2
1555;Drugelis;SPINDULIUKAI;7321544601;Ne;0;1;0;1
1556;Drugelis;SPINDULIUKAI;9296067137;Ne;20;0;0;20
1557;Drugelis;SPINDULIUKAI;9855121078;Ne;4;5;0;9
1558;Drugelis;SPINDULIUKAI;6068102133;Ne;0;2;0;2
1559;Drugelis;SPINDULIUKAI;7825151440;Ne;0;1;0;1
1560;Drugelis;SPINDULIUKAI;4812322553;Ne;1;3;0;4
1561;Drugelis;SPINDULIUKAI;6032568621;Ne;0;2;0;2
1562;Drugelis;SPINDULIUKAI;4580456500;Ne;16;0;0;16
1563;Drugelis;SPINDULIUKAI;8259051898;Ne;0;1;5;6
1564;Drugelis;SPINDULIUKAI;3567930528;Ne;4;2;0;6
1565;Drugelis;SPINDULIUKAI;2573357635;Ne;5;0;0;5
1566;Drugelis;KIŠKUČIAI;3603051567;Ne;12;0;0;12
1567;Drugelis;KIŠKUČIAI;4628926113;Ne;8;1;0;9
1568;Drugelis;KIŠKUČIAI;1213610973;Taip;4;0;4;8
1569;Drugelis;KIŠKUČIAI;9211760307;Ne;0;0;3;3
1570;Drugelis;KIŠKUČIAI;6071997970;Ne;10;4;3;17
1571;Drugelis;KIŠKUČIAI;8819853863;Ne;0;0;2;2
1572;Drugelis;KIŠKUČIAI;5950704328;Ne;0;4;0;4
1573;Drugelis;KIŠKUČIAI;9900296726;Ne;10;0;5;15
1574;Drugelis;KIŠKUČIAI;4898099506;Ne;0;1;0;1
1575;Drugelis;KIŠKUČIAI;6997707085;Ne;3;2;2;7
1576;Drugelis;KIŠKUČIAI;1375535260;Ne;5;0;2;7
1577;Drugelis;KIŠKUČIAI;5857726963;Ne;5;0;2;7
1578;Drugelis;KIŠKUČIAI;1817932444;Ne;8;0;6;14
1579;Drugelis;KIŠKUČIAI;8891228382;Ne;2;0;0;2
1580;Drugelis;KIŠKUČIAI;1074913909;Ne;10;3;0;13
1581;"Du gaideliai";Uodelių;6704167983;Ne;6;0;0;6
1582;"Du gaideliai";Uodelių;6942798420;Ne;0;6;0;6
1583;"Du gaideliai";Uodelių;8420400705;Ne;0;5;0;5
1584;"Du gaideliai";Uodelių;4157021754;Ne;10;0;3;13
1585;"Du gaideliai";Uodelių;7193151965;Ne;5;7;0;12
1586;"Du gaideliai";Uodelių;1968978650;Ne;4;0;3;7
1587;"Du gaideliai";Uodelių;2564259600;Ne;1;0;0;1
1588;"Du gaideliai";Uodelių;6132405512;Ne;0;9;0;9
1589;"Du gaideliai";Uodelių;7563789811;Ne;0;1;0;1
1590;"Du gaideliai";Uodelių;9126780620;Ne;0;2;2;4
1591;"Du gaideliai";Uodelių;9374869616;Ne;3;2;0;5
1592;"Du gaideliai";Uodelių;5726096980;Ne;9;0;1;10
1593;"Du gaideliai";Uodelių;4408537397;Ne;5;1;0;6
1594;"Du gaideliai";Uodelių;1527839162;Ne;0;0;11;11
1595;"Du gaideliai";Uodelių;5809089345;Ne;0;11;0;11
1596;"Du gaideliai";Uodelių;8174023197;Ne;6;5;0;11
1597;"Du gaideliai";Uodelių;7372149799;Ne;0;9;0;9
1598;"Du gaideliai";Uodelių;5291934919;Ne;2;0;0;2
1599;"Du gaideliai";OŽIUKŲ;7033276798;Ne;6;0;0;6
1600;"Du gaideliai";OŽIUKŲ;5788923258;Ne;0;3;0;3
1601;"Du gaideliai";OŽIUKŲ;2100449108;Ne;0;0;2;2
1602;"Du gaideliai";OŽIUKŲ;7575534590;Ne;0;5;0;5
1603;"Du gaideliai";OŽIUKŲ;3019797369;Ne;7;0;0;7
1604;"Du gaideliai";OŽIUKŲ;9356275460;Taip;0;0;6;6
1605;"Du gaideliai";OŽIUKŲ;6204233540;Ne;0;1;1;2
1606;"Du gaideliai";OŽIUKŲ;2845145754;Ne;0;2;0;2
1607;"Du gaideliai";OŽIUKŲ;7726490359;Ne;0;0;1;1
1608;"Du gaideliai";OŽIUKŲ;5728374219;Ne;2;2;0;4
1609;"Du gaideliai";OŽIUKŲ;5611102395;Ne;0;3;0;3
1610;"Du gaideliai";OŽIUKŲ;8410547195;Ne;5;1;0;6
1611;"Du gaideliai";OŽIUKŲ;2905083899;Taip;5;0;0;5
1612;"Du gaideliai";OŽIUKŲ;9585785202;Ne;12;3;0;15
1613;"Du gaideliai";OŽIUKŲ;2151825222;Ne;0;4;0;4
1614;"Du gaideliai";OŽIUKŲ;8043896286;Ne;0;0;2;2
1615;"Du gaideliai";OŽIUKŲ;6053941133;Ne;5;0;0;5
1616;"Du gaideliai";OŽIUKŲ;6120647567;Ne;10;1;0;11
1617;"Du gaideliai";OŽIUKŲ;5668878259;Ne;0;9;0;9
1618;"Du gaideliai";Vištyčių;1135098595;Ne;0;6;0;6
1619;"Du gaideliai";Vištyčių;3370029981;Taip;7;0;0;7
1620;"Du gaideliai";Vištyčių;2240947701;Ne;0;1;3;4
1621;"Du gaideliai";Vištyčių;3507387826;Ne;0;9;0;9
1622;"Du gaideliai";Vištyčių;4144269068;Ne;12;1;0;13
1623;"Du gaideliai";Vištyčių;1785976627;Ne;0;0;1;1
1624;"Du gaideliai";Vištyčių;8047413507;Ne;0;1;2;3
1625;"Du gaideliai";Vištyčių;9568647033;Ne;0;0;1;1
1626;"Du gaideliai";Vištyčių;5894974508;Ne;0;1;0;1
1627;"Du gaideliai";Vištyčių;5998344519;Taip;10;0;0;10
1628;"Du gaideliai";Vištyčių;6870356241;Ne;0;2;0;2
1629;"Du gaideliai";Vištyčių;5103483956;Ne;0;1;0;1
1630;"Du gaideliai";Vištyčių;6348951959;Ne;0;0;3;3
1631;"Du gaideliai";Vištyčių;1268479215;Ne;1;0;0;1
1632;"Du gaideliai";Vištyčių;3854355215;Ne;0;0;19;19
1633;"Du gaideliai";Vištyčių;2262425557;Taip;14;0;0;14
1634;"Du gaideliai";GAIDŽIUKŲ;1758546983;Ne;0;12;0;12
1635;"Du gaideliai";GAIDŽIUKŲ;7783203480;Ne;8;3;0;11
1636;"Du gaideliai";GAIDŽIUKŲ;9324740716;Ne;0;2;0;2
1637;"Du gaideliai";GAIDŽIUKŲ;6715434585;Ne;0;5;0;5
1638;"Du gaideliai";GAIDŽIUKŲ;7084763712;Ne;0;2;0;2
1639;"Du gaideliai";GAIDŽIUKŲ;1500684755;Ne;0;12;0;12
1640;"Du gaideliai";GAIDŽIUKŲ;6750787450;Ne;1;0;0;1
1641;"Du gaideliai";GAIDŽIUKŲ;5430986033;Ne;1;0;0;1
1642;"Du gaideliai";GAIDŽIUKŲ;27733314504;Ne;0;2;0;2
1643;"Du gaideliai";GAIDŽIUKŲ;5167460184;Ne;0;1;0;1
1644;"Du gaideliai";GAIDŽIUKŲ;1549762923;Ne;7;0;0;7
1645;"Du gaideliai";GAIDŽIUKŲ;6203383711;Ne;10;0;0;10
1646;"Du gaideliai";GAIDŽIUKŲ;6170362846;Ne;6;0;0;6
1647;"Du gaideliai";GAIDŽIUKŲ;1962859229;Ne;0;1;0;1
1648;"Du gaideliai";GAIDŽIUKŲ;7373413569;Ne;0;5;0;5
1649;"Du gaideliai";GAIDŽIUKŲ;1557413692;Ne;0;3;0;3
1650;"Du gaideliai";GAIDŽIUKŲ;7471332824;Ne;0;2;0;2
1651;"Du gaideliai";GAIDŽIUKŲ;4378924981;Ne;0;1;0;1
1652;"Du gaideliai";Musyčių;9506572113;Taip;0;8;0;8
1653;"Du gaideliai";Musyčių;6224116229;Ne;0;0;4;4
1654;"Du gaideliai";Musyčių;6630053388;Ne;8;0;6;14
1655;"Du gaideliai";Musyčių;3654057453;Ne;7;7;0;14
1656;"Du gaideliai";Musyčių;8921985681;Ne;0;16;4;20
1657;"Du gaideliai";Musyčių;1882241729;Taip;0;1;4;5
1658;"Du gaideliai";Musyčių;5225949099;Ne;0;1;0;1
1659;"Du gaideliai";Musyčių;4204930257;Ne;6;0;4;10
1660;"Du gaideliai";Musyčių;3206388799;Taip;0;16;0;16
1661;"Du gaideliai";Musyčių;2616106413;Ne;9;0;0;9
1662;"Du gaideliai";Musyčių;2084660815;Ne;10;0;0;10
1663;"Du gaideliai";Musyčių;9934568135;Ne;0;15;0;15
1664;"Du gaideliai";Musyčių;4799107717;Ne;0;1;0;1
1665;"Du gaideliai";Musyčių;8624394105;Ne;0;7;0;7
1666;"Du gaideliai";Musyčių;2122841302;Ne;2;13;0;15
1667;"Du gaideliai";Musyčių;7153424410;Ne;0;5;0;5
1668;"Du gaideliai";Musyčių;5514521078;Ne;0;3;0;3
1669;"Du gaideliai";MALŪNO;9561040908;Ne;4;0;0;4
1670;"Du gaideliai";MALŪNO;1048130675;Taip;0;12;4;16
1671;"Du gaideliai";MALŪNO;3601150560;Ne;0;2;0;2
1672;"Du gaideliai";MALŪNO;1777283565;Ne;20;0;0;20
1673;"Du gaideliai";MALŪNO;1940981083;Ne;18;0;0;18
1674;"Du gaideliai";MALŪNO;5113352673;Ne;7;0;0;7
1675;"Du gaideliai";MALŪNO;9477645505;Ne;0;1;4;5
1676;"Du gaideliai";MALŪNO;5142411841;Taip;0;0;1;1
1677;"Du gaideliai";MALŪNO;7855653537;Ne;7;0;0;7
1678;"Du gaideliai";MALŪNO;9832883242;Ne;1;0;0;1
1679;"Du gaideliai";MALŪNO;5016914497;Ne;10;0;1;11
1680;"Du gaideliai";MALŪNO;5060904810;Ne;6;0;0;6
1681;"Du gaideliai";MALŪNO;6054058539;Ne;0;6;0;6
1682;"Du gaideliai";MALŪNO;7389148136;Ne;9;0;1;10
1683;Eglutė;RAMUNĖ;1422631723;Ne;5;12;0;17
1684;Eglutė;RAMUNĖ;6709551046;Ne;0;1;0;1
1685;Eglutė;RAMUNĖ;6093932811;Ne;0;1;0;1
1686;Eglutė;RAMUNĖ;2651867769;Ne;0;0;1;1
1687;Eglutė;RAMUNĖ;2597978713;Ne;0;5;0;5
1688;Eglutė;RAMUNĖ;4451772812;Ne;1;1;0;2
1689;Eglutė;RAMUNĖ;8493750509;Ne;0;0;1;1
1690;Eglutė;RAMUNĖ;9929681000;Ne;4;0;1;5
1691;Eglutė;RAMUNĖ;6105927493;Ne;2;0;0;2
1692;Eglutė;RAMUNĖ;4560670047;Ne;3;0;0;3
1693;Eglutė;RAMUNĖ;6142326330;Ne;0;12;0;12
1694;Eglutė;RAMUNĖ;9728550000;Ne;0;0;3;3
1695;Eglutė;RAMUNĖ;1534556744;Ne;0;6;0;6
1696;Eglutė;RAMUNĖ;4047404616;Ne;0;3;0;3
1697;Eglutė;RAMUNĖ;4230594049;Ne;18;1;0;19
1698;Eglutė;RAMUNĖ;2998190195;Ne;0;4;0;4
1699;Eglutė;RAMUNĖ;9402686801;Ne;1;9;0;10
1700;Eglutė;RAMUNĖ;6279703448;Ne;0;12;0;12
1701;Eglutė;RAMUNĖ;7598993411;Ne;0;4;0;4
1702;Eglutė;PELĖDŽIUKAI;9066178904;Ne;0;1;0;1
1703;Eglutė;PELĖDŽIUKAI;7149060118;Ne;0;10;0;10
1704;Eglutė;PELĖDŽIUKAI;6518497374;Ne;0;1;0;1
1705;Eglutė;PELĖDŽIUKAI;3203786388;Ne;0;3;0;3
1706;Eglutė;PELĖDŽIUKAI;8033370429;Ne;0;2;0;2
1707;Eglutė;PELĖDŽIUKAI;3178489517;Ne;0;0;2;2
1708;Eglutė;PELĖDŽIUKAI;3393414294;Ne;0;1;0;1
1709;Eglutė;PELĖDŽIUKAI;2638807860;Ne;0;2;2;4
1710;Eglutė;PELĖDŽIUKAI;2082716398;Ne;0;1;0;1
1711;Eglutė;PELĖDŽIUKAI;3616979217;Ne;5;0;0;5
1712;Eglutė;PELĖDŽIUKAI;9950953029;Ne;0;0;4;4
1713;Eglutė;PELĖDŽIUKAI;7148210944;Ne;0;7;0;7
1714;Eglutė;PELĖDŽIUKAI;1324622835;Ne;0;2;1;3
1715;Eglutė;PELĖDŽIUKAI;1209962222;Ne;0;1;0;1
1716;Eglutė;PELĖDŽIUKAI;3275796441;Ne;5;0;1;6
1717;Eglutė;PELĖDŽIUKAI;3390360525;Ne;0;1;0;1
1718;Eglutė;PELĖDŽIUKAI;1806495674;Ne;0;0;1;1
1719;Eglutė;PELĖDŽIUKAI;6544877723;Taip;0;1;0;1
1720;Eglutė;KODĖLČIUKAI;4490295754;Ne;4;1;0;5
1721;Eglutė;KODĖLČIUKAI;3883122650;Ne;4;4;0;8
1722;Eglutė;KODĖLČIUKAI;7859815752;Ne;9;0;0;9
1723;Eglutė;KODĖLČIUKAI;4176597208;Ne;0;7;0;7
1724;Eglutė;KODĖLČIUKAI;7758643349;Ne;0;4;0;4
1725;Eglutė;KODĖLČIUKAI;6483580751;Ne;4;0;0;4
1726;Eglutė;KODĖLČIUKAI;1759383841;Ne;0;3;0;3
1727;Eglutė;KODĖLČIUKAI;6597261061;Ne;0;2;0;2
1728;Eglutė;KODĖLČIUKAI;9356785605;Ne;0;6;0;6
1729;Eglutė;KODĖLČIUKAI;8943684351;Ne;3;0;0;3
1730;Eglutė;KODĖLČIUKAI;8165126017;Ne;0;1;0;1
1731;Eglutė;KODĖLČIUKAI;9967488317;Ne;0;2;0;2
1732;Eglutė;KODĖLČIUKAI;3584247594;Ne;1;3;0;4
1733;Eglutė;KODĖLČIUKAI;9758104910;Ne;10;1;4;15
1734;Eglutė;KODĖLČIUKAI;1531942494;Ne;0;8;0;8
1735;Eglutė;KODĖLČIUKAI;9515238936;Ne;6;1;0;7
1736;Eglutė;KODĖLČIUKAI;5840014240;Ne;0;8;0;8
1737;Eglutė;KODĖLČIUKAI;5678727198;Ne;0;0;3;3
1738;Eglutė;OBUOLIUKAI;3799824061;Taip;7;0;0;7
1739;Eglutė;OBUOLIUKAI;1744942011;Ne;10;0;0;10
1740;Eglutė;OBUOLIUKAI;7027121333;Ne;0;8;0;8
1741;Eglutė;OBUOLIUKAI;6679186715;Ne;14;0;0;14
1742;Eglutė;OBUOLIUKAI;8655425408;Ne;0;2;1;3
1743;Eglutė;OBUOLIUKAI;8384141923;Ne;15;0;0;15
1744;Eglutė;OBUOLIUKAI;3112281182;Ne;12;2;2;16
1745;Eglutė;OBUOLIUKAI;4876032787;Ne;0;3;0;3
1746;Eglutė;OBUOLIUKAI;6967074765;Ne;3;5;0;8
1747;Eglutė;OBUOLIUKAI;9054104040;Ne;0;2;1;3
1748;Eglutė;OBUOLIUKAI;1380219881;Ne;0;0;1;1
1749;Eglutė;OBUOLIUKAI;8721209423;Ne;6;0;0;6
1750;Eglutė;OBUOLIUKAI;3903612086;Ne;5;0;0;5
1751;Eglutė;OBUOLIUKAI;7789753835;Ne;0;7;0;7
1752;Eglutė;KAŠTONAS;4099257155;Ne;0;0;1;1
1753;Eglutė;KAŠTONAS;6009794480;Ne;0;3;0;3
1754;Eglutė;KAŠTONAS;4252256130;Ne;3;0;0;3
1755;Eglutė;KAŠTONAS;7234851379;Ne;9;0;0;9
1756;Eglutė;KAŠTONAS;5636437290;Ne;0;2;0;2
1757;Eglutė;KAŠTONAS;5190045146;Ne;0;1;0;1
1758;Eglutė;KAŠTONAS;3985929379;Ne;3;0;0;3
1759;Eglutė;KAŠTONAS;8797889347;Ne;0;0;1;1
1760;Eglutė;KAŠTONAS;1842517164;Ne;10;0;3;13
1761;Eglutė;KAŠTONAS;7703290039;Ne;4;0;0;4
1762;Eglutė;KAŠTONAS;2121177107;Taip;5;0;0;5
1763;Eglutė;KAŠTONAS;7098548563;Ne;0;2;0;2
1764;Eglutė;KAŠTONAS;6146679388;Ne;9;1;0;10
1765;Eglutė;KAŠTONAS;5166183300;Ne;0;8;0;8
1766;Eglutė;KAŠTONAS;7984911632;Ne;0;2;0;2
1767;Eglutė;KAŠTONAS;7811667336;Ne;0;2;0;2
1768;Eglutė;EŽIUKAI;7491022301;Ne;0;2;1;3
1769;Eglutė;EŽIUKAI;5943856319;Ne;0;1;0;1
1770;Eglutė;EŽIUKAI;6891834971;Ne;0;1;0;1
1771;Eglutė;EŽIUKAI;7307564177;Ne;0;8;0;8
1772;Eglutė;EŽIUKAI;7823828202;Ne;0;1;0;1
1773;Eglutė;EŽIUKAI;7354260503;Ne;0;2;0;2
1774;Eglutė;EŽIUKAI;9439309687;Ne;0;2;2;4
1775;Eglutė;EŽIUKAI;1122308715;Ne;0;1;0;1
1776;Eglutė;EŽIUKAI;8523618773;Ne;0;16;0;16
1777;Eglutė;EŽIUKAI;3856651647;Ne;0;2;1;3
1778;Eglutė;EŽIUKAI;8421062747;Ne;8;0;1;9
1779;Eglutė;EŽIUKAI;9992438336;Ne;0;2;3;5
1780;Eglutė;EŽIUKAI;5731355126;Ne;0;1;0;1
1781;Eglutė;EŽIUKAI;8364693548;Ne;0;13;0;13
1782;Eglutė;EŽIUKAI;3081691175;Ne;0;1;0;1
1783;Eglutė;EŽIUKAI;1321901982;Ne;0;1;0;1
1784;Eglutė;EŽIUKAI;8162972897;Ne;0;6;0;6
1785;Eglutė;EŽIUKAI;4348313801;Ne;0;2;4;6
1786;Eglutė;EŽIUKAI;9042793284;Ne;0;5;0;5
1787;Eglutė;GILĖ;1550045866;Ne;3;1;0;4
1788;Eglutė;GILĖ;8325288373;Ne;0;0;3;3
1789;Eglutė;GILĖ;6550999480;Ne;4;0;0;4
1790;Eglutė;GILĖ;2857760751;Ne;4;0;0;4
1791;Eglutė;GILĖ;5650957826;Ne;0;3;0;3
1792;Eglutė;GILĖ;8129230197;Ne;0;1;0;1
1793;Eglutė;GILĖ;1835565594;Ne;0;2;3;5
1794;Eglutė;GILĖ;3740322448;Ne;0;4;0;4
1795;Eglutė;GILĖ;9746021019;Ne;3;0;0;3
1796;Eglutė;GILĖ;1814323427;Ne;0;0;15;15
1797;Eglutė;GILĖ;5013664843;Ne;7;1;0;8
1798;Eglutė;GILĖ;2276311106;Ne;0;2;0;2
1799;Eglutė;GILĖ;6924344686;Ne;4;1;0;5
1800;Eglutė;GILĖ;5645197324;Ne;6;0;5;11
1801;Eglutė;GILĖ;9098132159;Ne;0;9;0;9
1802;Eglutė;GILĖ;2615824395;Ne;0;2;0;2
1803;Eglutė;GILĖ;1899379269;Ne;0;1;0;1
1804;Eglutė;GILĖ;3605053253;Ne;8;0;0;8
1805;Eglutė;SAULUTĖ;9741776217;Ne;0;2;0;2
1806;Eglutė;SAULUTĖ;3091324735;Ne;0;2;0;2
1807;Eglutė;SAULUTĖ;8739346084;Ne;3;10;0;13
1808;Eglutė;SAULUTĖ;5518570006;Ne;0;1;0;1
1809;Eglutė;SAULUTĖ;9084576953;Ne;0;2;10;12
1810;Eglutė;SAULUTĖ;2259077568;Ne;0;2;0;2
1811;Eglutė;SAULUTĖ;4489150480;Ne;14;2;0;16
1812;Eglutė;SAULUTĖ;2425927050;Ne;1;10;0;11
1813;Eglutė;SAULUTĖ;5918429438;Ne;0;0;1;1
1814;Eglutė;SAULUTĖ;5006042568;Ne;0;11;0;11
1815;Eglutė;SAULUTĖ;5275306818;Ne;0;2;2;4
1816;Eglutė;SAULUTĖ;6328900251;Ne;0;2;1;3
1817;Eglutė;SAULUTĖ;5108928996;Ne;0;2;2;4
1818;Eglutė;SAULUTĖ;2872597971;Ne;3;1;0;4
1819;Eglutė;SAULUTĖ;6424893248;Ne;0;5;0;5
1820;Eglutė;SAULUTĖ;3690266358;Ne;0;2;0;2
1821;Eglutė;ŠARKELĖ;7831541089;Ne;9;1;2;12
1822;Eglutė;ŠARKELĖ;3430016771;Ne;0;16;0;16
1823;Eglutė;ŠARKELĖ;6382927775;Ne;0;13;0;13
1824;Eglutė;ŠARKELĖ;7919553451;Ne;0;4;0;4
1825;Eglutė;ŠARKELĖ;7658345479;Ne;0;4;0;4
1826;Eglutė;ŠARKELĖ;7229612001;Ne;3;2;0;5
1827;Eglutė;ŠARKELĖ;4932945207;Ne;18;0;0;18
1828;Eglutė;ŠARKELĖ;5407757245;Ne;3;0;0;3
1829;Eglutė;ŠARKELĖ;3237476593;Ne;9;1;0;10
1830;Eglutė;ŠARKELĖ;9542103745;Ne;4;2;0;6
1831;Eglutė;ŠARKELĖ;9686836846;Ne;14;0;0;14
1832;Eglutė;ŠARKELĖ;5783776734;Ne;0;9;0;9
1833;Eglutė;ŠARKELĖ;4490541539;Ne;7;0;0;7
1834;Eglutė;ŠARKELĖ;6653111225;Ne;8;0;0;8
1835;Eglutė;NYKŠTUKAI;3011330968;Ne;0;2;0;2
1836;Eglutė;NYKŠTUKAI;8037564034;Ne;9;3;0;12
1837;Eglutė;NYKŠTUKAI;8749425471;Ne;15;0;0;15
1838;Eglutė;NYKŠTUKAI;4151258155;Ne;7;2;0;9
1839;Eglutė;NYKŠTUKAI;6965837585;Ne;0;2;0;2
1840;Eglutė;NYKŠTUKAI;5103022009;Ne;0;4;5;9
1841;Eglutė;NYKŠTUKAI;8542684582;Ne;0;0;16;16
1842;Eglutė;NYKŠTUKAI;3091697091;Ne;0;2;4;6
1843;Eglutė;NYKŠTUKAI;4823811890;Ne;9;1;0;10
1844;Eglutė;NYKŠTUKAI;9292940501;Ne;0;2;3;5
1845;Eglutė;NYKŠTUKAI;3210398495;Ne;0;5;0;5
1846;Eglutė;NYKŠTUKAI;7313013331;Ne;4;0;0;4
1847;Eglutė;NYKŠTUKAI;3051637136;Ne;12;0;0;12
1848;Eglutė;NYKŠTUKAI;4056836413;Ne;0;2;0;2
1849;Eglutė;NYKŠTUKAI;5810733285;Ne;20;0;0;20
1850;Eglutė;NYKŠTUKAI;3089527202;Ne;0;0;1;1
1851;Eglutė;NYKŠTUKAI;2669400743;Ne;0;11;0;11
1852;Eglutė;NYKŠTUKAI;9845413768;Ne;9;0;0;9
1853;Eglutė;NYKŠTUKAI;1460628870;Ne;12;2;1;15
1854;Eglutė;NYKŠTUKAI;4427853197;Ne;0;2;0;2
1855;Eglutė;ŽIRNIUKAI;3706904006;Ne;0;0;2;2
1856;Eglutė;ŽIRNIUKAI;8698242107;Ne;0;0;17;17
1857;Eglutė;ŽIRNIUKAI;2666894761;Ne;6;0;0;6
1858;Eglutė;ŽIRNIUKAI;2546506486;Taip;0;0;16;16
1859;Eglutė;ŽIRNIUKAI;6103657328;Ne;1;0;0;1
1860;Eglutė;ŽIRNIUKAI;4465995209;Ne;0;1;0;1
1861;Eglutė;ŽIRNIUKAI;9795027066;Ne;7;2;4;13
1862;Eglutė;ŽIRNIUKAI;3006002253;Ne;0;0;16;16
1863;Eglutė;ŽIRNIUKAI;4539946535;Ne;5;0;0;5
1864;Eglutė;ŽIRNIUKAI;4697026463;Ne;7;1;0;8
1865;Eglutė;ŽIRNIUKAI;3974970972;Ne;5;0;0;5
1866;Eglutė;ŽIRNIUKAI;2107488723;Ne;0;0;4;4
1867;Eglutė;ŽIRNIUKAI;9381529574;Ne;6;0;12;18
1868;Eglutė;ŽIRNIUKAI;7256251859;Ne;5;0;0;5
1869;Eglutė;ŽIRNIUKAI;6336987111;Ne;0;2;2;4
1870;Eglutė;ŽIRNIUKAI;2950414583;Ne;0;0;17;17
1871;Eglutė;BORUŽIUKAI;5592515139;Ne;0;0;1;1
1872;Eglutė;BORUŽIUKAI;1630903587;Taip;0;20;0;20
1873;Eglutė;BORUŽIUKAI;7254436716;Ne;0;6;0;6
1874;Eglutė;BORUŽIUKAI;5982037450;Ne;5;0;0;5
1875;Eglutė;BORUŽIUKAI;7994301287;Ne;5;5;0;10
1876;Eglutė;BORUŽIUKAI;9300315869;Ne;7;0;0;7
1877;Eglutė;BORUŽIUKAI;7231828805;Ne;5;12;0;17
1878;Eglutė;BORUŽIUKAI;5704418881;Ne;0;0;17;17
1879;Eglutė;BORUŽIUKAI;8410302338;Ne;0;0;5;5
1880;Eglutė;BORUŽIUKAI;1667851586;Ne;9;0;3;12
1881;Eglutė;BORUŽIUKAI;1715411901;Ne;0;1;6;7
1882;Eglutė;BORUŽIUKAI;9875724921;Ne;0;0;1;1
1883;Eglutė;BORUŽIUKAI;7564179845;Ne;20;0;0;20
1884;Eglutė;BORUŽIUKAI;9178835404;Ne;0;18;0;18
1885;Eglutė;BORUŽIUKAI;5146804510;Ne;4;0;0;4
1886;Eglutė;BORUŽIUKAI;7618937988;Ne;0;5;0;5
1887;Eglutė;BORUŽIUKAI;6805213753;Ne;6;0;2;8
1888;Eglutė;BORUŽIUKAI;6773894090;Ne;5;0;0;5
1889;Gandriukas;Zylutės;5244657597;Ne;6;0;0;6
1890;Gandriukas;Geniukai;1450834523;Ne;10;0;0;10
1891;Gandriukas;Geniukai;1634602681;Ne;5;0;0;5
1892;Gandriukas;Sakalėliai;2694943666;Taip;3;0;0;3
1893;Gandriukas;Sakalėliai;4632752857;Ne;5;0;0;5
1894;Gandriukas;Bitutės;3468372935;Ne;6;0;0;6
1895;Gandriukas;Bitutės;5025106801;Ne;5;0;0;5
1896;Gandriukas;Bitutės;1036112431;Ne;10;0;0;10
1897;Gandriukas;Bitutės;1030537353;Ne;14;0;0;14
1898;Gandriukas;Bitutės;8660321931;Ne;7;0;0;7
1899;Gandriukas;Bitutės;5591809423;Ne;7;0;0;7
1900;Gandriukas;Boružiukai;7241024564;Ne;1;0;0;1
1901;Gandriukas;Žirniukai;3754384456;Ne;5;0;0;5
1902;Gandriukas;Žirniukai;6510642872;Ne;13;0;0;13
1903;Gandriukas;Žirniukai;1527093662;Ne;5;0;0;5
1904;Gandriukas;Spindulėliai;3708164152;Ne;10;0;0;10
1905;Gandriukas;Spindulėliai;8798650622;Ne;4;0;0;4
1906;Gandriukas;Spindulėliai;9084034983;Ne;5;0;0;5
1907;Gandriukas;Spindulėliai;7833043817;Ne;12;0;0;12
1908;Gandriukas;Meškiukai;4462806519;Ne;9;0;0;9
1909;Gandriukas;Meškiukai;2789579818;Ne;6;0;0;6
1910;Gandriukas;Meškiukai;7647792820;Ne;20;0;0;20
1911;Gandriukas;Meškiukai;7902095203;Ne;14;0;0;14
1912;Gandriukas;Meškiukai;7687725549;Ne;3;0;0;3
1913;Gandriukas;Pingvinukai;14669381175;Ne;6;0;0;6
1914;Gandriukas;Pingvinukai;9778951737;Ne;6;0;0;6
1915;Gandriukas;ŽVIRBLIUKAI;4892650395;Ne;5;0;0;5
1916;Gandriukas;ŽVIRBLIUKAI;7992400681;Ne;6;0;0;6
1917;Gandriukas;ŽVIRBLIUKAI;7206376730;Ne;14;0;0;14
1918;Gandriukas;ŽVIRBLIUKAI;2134508251;Ne;9;0;0;9
1919;Gandriukas;ŽVIRBLIUKAI;7636796574;Ne;10;0;0;10
1920;Gandriukas;ŽVIRBLIUKAI;2976460887;Ne;1;0;0;1
1921;Gandriukas;VIEVERSĖLIAI;1374657400;Ne;2;0;0;2
1922;Gandriukas;VIEVERSĖLIAI;3136926969;Ne;3;0;0;3
1923;Gandriukas;VIEVERSĖLIAI;9514634621;Ne;13;0;0;13
1924;Gandriukas;VIEVERSĖLIAI;8437534012;Ne;1;0;0;1
1925;Gandriukas;"IKIMOKYKKLINIO UGDYMO GRUPĖ";9240304636;Ne;7;0;0;7
1926;Gandriukas;"IKIMOKYKKLINIO UGDYMO GRUPĖ";7540612706;Ne;4;0;0;4
1927;"Geniukų kalvė";SAULUTĖS;9557055841;Ne;16;0;0;16
1928;"Geniukų kalvė";SAULUTĖS;4329782598;Ne;0;6;0;6
1929;"Geniukų kalvė";SAULUTĖS;8932671578;Ne;5;0;3;8
1930;"Geniukų kalvė";SAULUTĖS;9711047774;Ne;0;0;1;1
1931;"Geniukų kalvė";SAULUTĖS;1910363787;Taip;11;0;0;11
1932;"Geniukų kalvė";SAULUTĖS;9522911738;Ne;10;0;0;10
1933;"Geniukų kalvė";SAULUTĖS;5348211316;Ne;0;7;0;7
1934;"Geniukų kalvė";SAULUTĖS;7886553419;Ne;14;0;0;14
1935;"Geniukų kalvė";SAULUTĖS;6384832317;Ne;14;0;4;18
1936;"Geniukų kalvė";SAULUTĖS;4946218794;Ne;5;0;0;5
1937;"Geniukų kalvė";SAULUTĖS;4525874796;Ne;3;6;1;10
1938;"Geniukų kalvė";SAULUTĖS;4745451344;Ne;3;0;1;4
1939;"Geniukų kalvė";SAULUTĖS;9768077014;Ne;5;0;0;5
1940;"Geniukų kalvė";SAULUTĖS;3889643236;Ne;9;1;0;10
1941;"Geniukų kalvė";SAULUTĖS;6102906310;Ne;0;6;0;6
1942;"Geniukų kalvė";SAULUTĖS;5180240547;Ne;0;4;0;4
1943;"Geniukų kalvė";BITUTĖS;5587035951;Ne;9;0;0;9
1944;"Geniukų kalvė";BITUTĖS;9323779212;Ne;7;0;0;7
1945;"Geniukų kalvė";BITUTĖS;2110578252;Ne;0;0;1;1
1946;"Geniukų kalvė";BITUTĖS;8577323715;Ne;0;0;1;1
1947;"Geniukų kalvė";BITUTĖS;7453065865;Ne;0;0;2;2
1948;"Geniukų kalvė";BITUTĖS;9455124402;Ne;2;0;4;6
1949;"Geniukų kalvė";BITUTĖS;4633553106;Ne;5;0;2;7
1950;"Geniukų kalvė";BITUTĖS;3669378459;Ne;3;0;1;4
1951;"Geniukų kalvė";BITUTĖS;4201333532;Ne;15;0;1;16
1952;"Geniukų kalvė";BITUTĖS;5102325807;Ne;0;1;0;1
1953;"Geniukų kalvė";BITUTĖS;1492140432;Ne;8;0;3;11
1954;"Geniukų kalvė";BITUTĖS;1426555835;Ne;0;2;1;3
1955;"Geniukų kalvė";BITUTĖS;6138451393;Ne;3;0;0;3
1956;"Geniukų kalvė";BITUTĖS;7747615302;Ne;0;2;0;2
1957;"Geniukų kalvė";BITUTĖS;4691978116;Ne;15;0;1;16
1958;"Geniukų kalvė";BITUTĖS;6111168227;Ne;0;10;1;11
1959;"Geniukų kalvė";BITUTĖS;7744441981;Ne;4;0;7;11
1960;"Geniukų kalvė";BITUTĖS;1209268848;Ne;5;0;6;11
1961;"Geniukų kalvė";BITUTĖS;6351861630;Ne;5;0;0;5
1962;"Geniukų kalvė";BITUTĖS;6214681079;Ne;1;2;0;3
1963;"Geniukų kalvė";BITUTĖS;3221034847;Ne;10;0;3;13
1964;"Geniukų kalvė";KIŠKUČIAI;5253380852;Ne;9;1;3;13
1965;"Geniukų kalvė";KIŠKUČIAI;2684344984;Taip;8;0;0;8
1966;"Geniukų kalvė";KIŠKUČIAI;5824747638;Ne;2;0;0;2
1967;"Geniukų kalvė";KIŠKUČIAI;9075192344;Ne;11;0;0;11
1968;"Geniukų kalvė";KIŠKUČIAI;5078771341;Ne;17;0;0;17
1969;"Geniukų kalvė";KIŠKUČIAI;9579750299;Ne;10;0;0;10
1970;"Geniukų kalvė";KIŠKUČIAI;9543553237;Ne;5;0;0;5
1971;"Geniukų kalvė";KIŠKUČIAI;2032408983;Ne;3;0;0;3
1972;"Geniukų kalvė";KIŠKUČIAI;4639389587;Ne;18;0;0;18
1973;"Geniukų kalvė";KIŠKUČIAI;9386761753;Ne;9;0;1;10
1974;"Geniukų kalvė";KIŠKUČIAI;5604315555;Ne;2;0;0;2
1975;"Geniukų kalvė";KIŠKUČIAI;6188518268;Ne;0;0;1;1
1976;"Geniukų kalvė";KIŠKUČIAI;1945456486;Ne;0;0;5;5
1977;"Geniukų kalvė";KIŠKUČIAI;3887137828;Ne;12;0;1;13
1978;"Geniukų kalvė";VYTURĖLIAI;5945583960;Ne;0;3;0;3
1979;"Geniukų kalvė";VYTURĖLIAI;1568133009;Ne;12;0;0;12
1980;"Geniukų kalvė";VYTURĖLIAI;2337226175;Ne;1;1;0;2
1981;"Geniukų kalvė";VYTURĖLIAI;2140334255;Ne;6;4;1;11
1982;"Geniukų kalvė";VYTURĖLIAI;7664689396;Ne;6;0;0;6
1983;"Geniukų kalvė";VYTURĖLIAI;4844734556;Ne;0;1;0;1
1984;"Geniukų kalvė";VYTURĖLIAI;8635708009;Ne;0;16;0;16
1985;"Geniukų kalvė";VYTURĖLIAI;4758435835;Ne;5;3;0;8
1986;"Geniukų kalvė";VYTURĖLIAI;23023070502;Ne;0;1;0;1
1987;"Geniukų kalvė";VYTURĖLIAI;9081596975;Ne;3;1;0;4
1988;"Geniukų kalvė";VYTURĖLIAI;8668696743;Ne;5;0;0;5
1989;"Geniukų kalvė";VYTURĖLIAI;2262014110;Ne;0;2;0;2
1990;"Geniukų kalvė";VYTURĖLIAI;2890934301;Ne;0;2;0;2
1991;"Geniukų kalvė";VYTURĖLIAI;2904091819;Ne;3;0;0;3
1992;"Geniukų kalvė";VYTURĖLIAI;1947173142;Ne;10;0;0;10
1993;"Geniukų kalvė";VYTURĖLIAI;43097490633;Ne;0;5;0;5
1994;"Geniukų kalvė";VYTURĖLIAI;1460456166;Ne;0;2;0;2
1995;"Geniukų kalvė";VYTURĖLIAI;30932565379;Ne;0;2;1;3
1996;"Geniukų kalvė";VYTURĖLIAI;3826265557;Ne;10;1;0;11
1997;"Geniukų kalvė";VYTURĖLIAI;5756909142;Ne;3;1;0;4
1998;"Geniukų kalvė";DRUGELIAI;9676782662;Ne;0;1;0;1
1999;"Geniukų kalvė";DRUGELIAI;6520429663;Ne;12;0;0;12
2000;"Geniukų kalvė";DRUGELIAI;5542539934;Ne;0;20;0;20
2001;"Geniukų kalvė";DRUGELIAI;9666918437;Ne;0;1;0;1
2002;"Geniukų kalvė";DRUGELIAI;6466912385;Ne;0;1;0;1
2003;"Geniukų kalvė";DRUGELIAI;2718961466;Ne;9;0;0;9
2004;"Geniukų kalvė";DRUGELIAI;2016254460;Ne;0;2;0;2
2005;"Geniukų kalvė";DRUGELIAI;3984265624;Ne;0;8;0;8
2006;"Geniukų kalvė";DRUGELIAI;5776314197;Ne;1;0;0;1
2007;"Geniukų kalvė";DRUGELIAI;1897809684;Ne;3;0;0;3
2008;"Geniukų kalvė";DRUGELIAI;2233161242;Ne;0;1;0;1
2009;"Geniukų kalvė";DRUGELIAI;6500641378;Ne;0;4;0;4
2010;"Geniukų kalvė";DRUGELIAI;2143334688;Ne;1;0;0;1
2011;"Geniukų kalvė";DRUGELIAI;6498149304;Ne;0;1;0;1
2012;"Geniukų kalvė";DRUGELIAI;9990243525;Ne;0;0;1;1
2013;"Geniukų kalvė";DRUGELIAI;48818906299;Ne;0;11;0;11
2014;"Geniukų kalvė";"SAULĖS ZUIKUČIAI";7033628178;Ne;11;0;0;11
2015;"Geniukų kalvė";"SAULĖS ZUIKUČIAI";7082945033;Ne;0;0;5;5
2016;"Geniukų kalvė";"SAULĖS ZUIKUČIAI";2313382307;Ne;0;0;2;2
2017;"Geniukų kalvė";"SAULĖS ZUIKUČIAI";8309953586;Ne;0;5;0;5
2018;"Geniukų kalvė";"SAULĖS ZUIKUČIAI";2783285969;Ne;2;0;0;2
2019;"Geniukų kalvė";"SAULĖS ZUIKUČIAI";7500079028;Ne;0;16;0;16
2020;"Geniukų kalvė";"SAULĖS ZUIKUČIAI";8071493871;Ne;3;0;2;5
2021;"Geniukų kalvė";"SAULĖS ZUIKUČIAI";1718428600;Ne;2;0;0;2
2022;"Geniukų kalvė";"SAULĖS ZUIKUČIAI";8914605154;Ne;0;0;2;2
2023;"Geniukų kalvė";"SAULĖS ZUIKUČIAI";6016585056;Ne;13;0;5;18
2024;"Geniukų kalvė";"SAULĖS ZUIKUČIAI";2816691996;Ne;0;0;3;3
2025;"Geniukų kalvė";"SAULĖS ZUIKUČIAI";5512172533;Ne;10;4;0;14
2026;"Geniukų kalvė";"SAULĖS ZUIKUČIAI";1375674317;Ne;3;1;0;4
2027;"Geniukų kalvė";"SAULĖS ZUIKUČIAI";4722801116;Ne;1;1;1;3
2028;"Geniukų kalvė";"SAULĖS ZUIKUČIAI";5763009912;Ne;0;0;1;1
2029;"Geniukų kalvė";"SAULĖS ZUIKUČIAI";2952604528;Ne;8;0;0;8
2030;"Geniukų kalvė";"SAULĖS ZUIKUČIAI";1499735818;Ne;15;0;0;15
2031;"Geniukų kalvė";"SAULĖS ZUIKUČIAI";4186376527;Ne;5;0;0;5
2032;"Geniukų kalvė";"SAULĖS ZUIKUČIAI";5161600326;Ne;0;0;1;1
2033;"Geniukų kalvė";SMALSUČIAI;5974481787;Ne;4;0;0;4
2034;"Geniukų kalvė";SMALSUČIAI;7915720190;Ne;6;2;0;8
2035;"Geniukų kalvė";SMALSUČIAI;5129841490;Ne;0;2;0;2
2036;"Geniukų kalvė";SMALSUČIAI;5705917381;Ne;1;2;0;3
2037;"Geniukų kalvė";SMALSUČIAI;4231659246;Ne;12;0;0;12
2038;"Geniukų kalvė";SMALSUČIAI;2300947427;Ne;4;0;0;4
2039;"Geniukų kalvė";SMALSUČIAI;1028242614;Ne;6;0;0;6
2040;"Geniukų kalvė";SMALSUČIAI;2596680448;Ne;6;2;0;8
2041;"Geniukų kalvė";SMALSUČIAI;6730270449;Ne;6;2;0;8
2042;"Geniukų kalvė";SMALSUČIAI;4405381922;Ne;10;1;0;11
2043;"Geniukų kalvė";SMALSUČIAI;6473724074;Ne;10;1;0;11
2044;"Geniukų kalvė";SMALSUČIAI;3627418555;Ne;10;3;0;13
2045;"Geniukų kalvė";SMALSUČIAI;9155681194;Taip;18;0;0;18
2046;"Geniukų kalvė";SMALSUČIAI;7440029486;Ne;0;12;0;12
2047;"Geniukų kalvė";SMALSUČIAI;6168422514;Ne;20;0;0;20
2048;"Geniukų kalvė";RUDNOSIUKAI;7079072084;Ne;1;0;1;2
2049;"Geniukų kalvė";RUDNOSIUKAI;6060825704;Ne;10;0;0;10
2050;"Geniukų kalvė";RUDNOSIUKAI;6149037133;Ne;0;10;0;10
2051;"Geniukų kalvė";RUDNOSIUKAI;5883913787;Ne;1;0;0;1
2052;"Geniukų kalvė";RUDNOSIUKAI;9696452101;Ne;9;0;0;9
2053;"Geniukų kalvė";RUDNOSIUKAI;2426186771;Ne;8;0;0;8
2054;"Geniukų kalvė";RUDNOSIUKAI;5443596677;Ne;0;1;0;1
2055;"Geniukų kalvė";RUDNOSIUKAI;7300853810;Ne;0;6;0;6
2056;"Geniukų kalvė";RUDNOSIUKAI;2839299179;Ne;5;1;0;6
2057;"Geniukų kalvė";RUDNOSIUKAI;3852896932;Ne;1;1;2;4
2058;"Geniukų kalvė";RUDNOSIUKAI;2165793561;Ne;1;5;0;6
2059;"Geniukų kalvė";RUDNOSIUKAI;4985606198;Ne;0;0;2;2
2060;"Geniukų kalvė";RUDNOSIUKAI;3152130511;Ne;0;2;12;14
2061;"Geniukų kalvė";RUDNOSIUKAI;2798750158;Ne;2;2;2;6
2062;"Geniukų kalvė";RUDNOSIUKAI;6373989816;Ne;1;2;0;3
2063;"Geniukų kalvė";PELĖDŽIUKAI;8271041553;Ne;0;0;3;3
2064;"Geniukų kalvė";PELĖDŽIUKAI;1237228692;Ne;5;0;0;5
2065;"Geniukų kalvė";PELĖDŽIUKAI;2938446054;Taip;3;0;0;3
2066;"Geniukų kalvė";PELĖDŽIUKAI;3055777730;Ne;0;0;3;3
2067;"Geniukų kalvė";PELĖDŽIUKAI;6070945557;Taip;4;0;1;5
2068;"Geniukų kalvė";PELĖDŽIUKAI;1051563985;Ne;0;5;0;5
2069;"Geniukų kalvė";PELĖDŽIUKAI;6174114461;Ne;5;0;0;5
2070;"Geniukų kalvė";PELĖDŽIUKAI;2659298240;Ne;5;0;0;5
2071;"Geniukų kalvė";PELĖDŽIUKAI;6737863183;Ne;0;2;0;2
2072;"Geniukų kalvė";PELĖDŽIUKAI;5704223824;Taip;20;0;0;20
2073;"Geniukų kalvė";PELĖDŽIUKAI;1811866428;Ne;0;0;1;1
2074;"Geniukų kalvė";PELĖDŽIUKAI;8770345339;Ne;14;0;0;14
2075;"Geniukų kalvė";PELĖDŽIUKAI;1611845627;Ne;6;0;0;6
2076;"Geniukų kalvė";PELĖDŽIUKAI;9677583445;Ne;6;10;0;16
2077;"Geniukų kalvė";PELĖDŽIUKAI;6237208661;Ne;6;0;0;6
2078;"Geniukų kalvė";BORUŽĖLĖS;9613720001;Ne;7;1;0;8
2079;"Geniukų kalvė";BORUŽĖLĖS;4958738745;Ne;9;4;0;13
2080;"Geniukų kalvė";BORUŽĖLĖS;5161535756;Ne;0;2;0;2
2081;"Geniukų kalvė";BORUŽĖLĖS;3493492581;Ne;7;1;0;8
2082;"Geniukų kalvė";BORUŽĖLĖS;3085228868;Ne;5;0;0;5
2083;"Geniukų kalvė";BORUŽĖLĖS;4777155321;Ne;1;0;0;1
2084;"Geniukų kalvė";BORUŽĖLĖS;2180860623;Ne;5;1;0;6
2085;"Geniukų kalvė";BORUŽĖLĖS;2205515766;Ne;0;1;0;1
2086;"Geniukų kalvė";BORUŽĖLĖS;8769761434;Ne;4;0;1;5
2087;"Geniukų kalvė";BORUŽĖLĖS;1891205998;Ne;1;1;0;2
2088;"Geniukų kalvė";BORUŽĖLĖS;9643242164;Ne;3;3;0;6
2089;"Geniukų kalvė";BORUŽĖLĖS;2665955524;Ne;0;1;0;1
2090;"Geniukų kalvė";BORUŽĖLĖS;4872435715;Ne;0;0;6;6
2091;"Geniukų kalvė";BORUŽĖLĖS;3297360222;Ne;0;8;0;8
2092;"Geniukų kalvė";BORUŽĖLĖS;6828079735;Ne;0;1;0;1
2093;"Geniukų kalvė";BORUŽĖLĖS;2710207578;Ne;3;1;0;4
2094;"Geniukų kalvė";BORUŽĖLĖS;1046406910;Ne;0;13;0;13
2095;"Geniukų kalvė";BORUŽĖLĖS;1454724752;Ne;0;8;0;8
2096;"Geniukų kalvė";BORUŽĖLĖS;3193006249;Ne;1;0;0;1
2097;"Geniukų kalvė";PAGRANDUKAI;1844495906;Ne;4;0;0;4
2098;"Geniukų kalvė";PAGRANDUKAI;7234620406;Ne;4;0;0;4
2099;"Geniukų kalvė";PAGRANDUKAI;4890413509;Ne;16;0;0;16
2100;"Geniukų kalvė";PAGRANDUKAI;9319251542;Ne;4;0;0;4
2101;"Geniukų kalvė";PAGRANDUKAI;7310171451;Ne;0;5;3;8
2102;"Geniukų kalvė";PAGRANDUKAI;8214399001;Ne;1;0;0;1
2103;"Geniukų kalvė";PAGRANDUKAI;9820642056;Ne;2;0;2;4
2104;"Geniukų kalvė";PAGRANDUKAI;5115570519;Taip;5;0;0;5
2105;"Geniukų kalvė";PAGRANDUKAI;6783296167;Ne;1;2;1;4
2106;"Geniukų kalvė";PAGRANDUKAI;8525540366;Ne;5;0;0;5
2107;"Geniukų kalvė";PAGRANDUKAI;5847488152;Ne;1;0;19;20
2108;"Geniukų kalvė";PAGRANDUKAI;3676717541;Ne;0;0;3;3
2109;"Geniukų kalvė";NYKŠTUKAI;7561521903;Ne;10;0;1;11
2110;"Geniukų kalvė";NYKŠTUKAI;2312298671;Ne;11;0;0;11
2111;"Geniukų kalvė";NYKŠTUKAI;8217855034;Ne;6;0;0;6
2112;"Geniukų kalvė";NYKŠTUKAI;1068112116;Ne;5;1;0;6
2113;"Geniukų kalvė";NYKŠTUKAI;1421857914;Ne;5;0;0;5
2114;"Geniukų kalvė";NYKŠTUKAI;1558977259;Ne;8;0;0;8
2115;"Geniukų kalvė";NYKŠTUKAI;4805806745;Ne;14;0;0;14
2116;"Geniukų kalvė";NYKŠTUKAI;1383717352;Ne;14;0;0;14
2117;"Geniukų kalvė";NYKŠTUKAI;3071724778;Ne;7;1;0;8
2118;"Geniukų kalvė";NYKŠTUKAI;2302465593;Ne;8;0;0;8
2119;"Geniukų kalvė";NYKŠTUKAI;1822730314;Ne;20;0;0;20
2120;"Geniukų kalvė";NYKŠTUKAI;3015544833;Ne;20;0;0;20
2121;"Geniukų kalvė";NYKŠTUKAI;6680434763;Ne;1;2;0;3
2122;"Geniukų kalvė";NYKŠTUKAI;7736527608;Ne;1;2;0;3
2123;"Geniukų kalvė";NYKŠTUKAI;6860580488;Ne;0;20;0;20
2124;"Geniukų kalvė";NYKŠTUKAI;9322790214;Ne;7;0;0;7
2125;Gelvonėlis;ĄŽUOLIUKAI;2329699993;Taip;0;3;0;3
2126;Gelvonėlis;ĄŽUOLIUKAI;9058956012;Ne;0;6;0;6
2127;Gelvonėlis;ĄŽUOLIUKAI;3677100165;Ne;6;2;0;8
2128;Gelvonėlis;ĄŽUOLIUKAI;7449710008;Ne;0;3;0;3
2129;Gelvonėlis;ĄŽUOLIUKAI;9492898584;Taip;0;6;0;6
2130;Gelvonėlis;ĄŽUOLIUKAI;3942630720;Ne;0;12;0;12
2131;Gelvonėlis;ĄŽUOLIUKAI;9756155028;Ne;16;0;0;16
2132;Gelvonėlis;ĄŽUOLIUKAI;8206816148;Taip;9;0;0;9
2133;Gelvonėlis;ĄŽUOLIUKAI;3165015754;Ne;2;2;0;4
2134;Gelvonėlis;ĄŽUOLIUKAI;1274119900;Taip;0;5;0;5
2135;Gelvonėlis;ĄŽUOLIUKAI;5901499708;Ne;16;0;0;16
2136;Gelvonėlis;ĄŽUOLIUKAI;1403890893;Taip;0;3;0;3
2137;Gelvonėlis;ŽVIRBLIUKAI;6604992169;Ne;0;1;0;1
2138;Gelvonėlis;ŽVIRBLIUKAI;6556472766;Ne;13;1;1;15
2139;Gelvonėlis;ŽVIRBLIUKAI;7182180008;Ne;0;1;2;3
2140;Gelvonėlis;ŽVIRBLIUKAI;8885088900;Ne;0;1;1;2
2141;Gelvonėlis;ŽVIRBLIUKAI;2400289466;Ne;0;1;4;5
2142;Gelvonėlis;ŽVIRBLIUKAI;9493536517;Ne;0;0;4;4
2143;Gelvonėlis;ŽVIRBLIUKAI;1987204544;Ne;0;1;1;2
2144;Gelvonėlis;ŽVIRBLIUKAI;2515471132;Ne;0;0;1;1
2145;Gelvonėlis;ŽVIRBLIUKAI;1085845218;Ne;4;0;1;5
2146;Gelvonėlis;ŽVIRBLIUKAI;6319058542;Ne;0;0;2;2
2147;Gelvonėlis;ŽVIRBLIUKAI;9538571448;Ne;1;2;0;3
2148;Gelvonėlis;ŽVIRBLIUKAI;9147186080;Ne;0;2;0;2
2149;Gelvonėlis;ŽVIRBLIUKAI;7195164378;Ne;7;0;0;7
2150;Gelvonėlis;ŽVIRBLIUKAI;6598178467;Ne;0;2;1;3
2151;Gelvonėlis;ŽVIRBLIUKAI;6068473734;Ne;1;0;0;1
2152;Gelvonėlis;ŽVIRBLIUKAI;8508450500;Ne;3;3;0;6
2153;Gelvonėlis;ŽVIRBLIUKAI;8704971956;Ne;2;0;9;11
2154;Gelvonėlis;ŽVIRBLIUKAI;4281431471;Ne;4;0;1;5
2155;Gelvonėlis;ŽVIRBLIUKAI;8976258838;Ne;1;0;0;1
2156;Gelvonėlis;RASELĖS;9667024635;Ne;0;0;1;1
2157;Gelvonėlis;RASELĖS;2119550116;Ne;0;0;2;2
2158;Gelvonėlis;RASELĖS;3788522708;Ne;0;0;1;1
2159;Gelvonėlis;RASELĖS;6317822775;Ne;0;0;10;10
2160;Gelvonėlis;RASELĖS;5047022305;Ne;0;0;2;2
2161;Gelvonėlis;RASELĖS;6189110767;Ne;15;0;0;15
2162;Gelvonėlis;RASELĖS;1753617545;Ne;1;0;2;3
2163;Gelvonėlis;RASELĖS;1399518471;Ne;0;0;1;1
2164;Gelvonėlis;RASELĖS;6226970200;Ne;0;0;1;1
2165;Gelvonėlis;RASELĖS;1246591538;Ne;0;0;11;11
2166;Gelvonėlis;RASELĖS;6256962184;Ne;0;0;15;15
2167;Gelvonėlis;RASELĖS;91441127098;Ne;0;0;1;1
2168;Gelvonėlis;RASELĖS;1610362831;Ne;0;0;6;6
2169;Gelvonėlis;RASELĖS;9387523651;Ne;0;9;0;9
2170;Gelvonėlis;RASELĖS;75676389361;Ne;0;0;1;1
2171;Gelvonėlis;RASELĖS;4120103012;Ne;10;0;0;10
2172;Gelvonėlis;SAULUTĖ;3121251271;Taip;0;2;0;2
2173;Gelvonėlis;SAULUTĖ;7429739147;Taip;20;0;0;20
2174;Gelvonėlis;SAULUTĖ;7392743619;Ne;14;0;0;14
2175;Gelvonėlis;SAULUTĖ;8228796927;Ne;10;0;0;10
2176;Gelvonėlis;SAULUTĖ;1368982977;Ne;0;1;0;1
2177;Gelvonėlis;SAULUTĖ;4550077609;Ne;1;0;0;1
2178;Gelvonėlis;SAULUTĖ;1734685590;Ne;0;0;7;7
2179;Gelvonėlis;SAULUTĖ;7936622964;Ne;5;2;0;7
2180;Gelvonėlis;SAULUTĖ;3719670896;Ne;10;2;0;12
2181;Gelvonėlis;SAULUTĖ;1672409070;Ne;2;0;4;6
2182;Gelvonėlis;SAULUTĖ;3771796903;Ne;0;1;0;1
2183;Gelvonėlis;SAULUTĖ;8022270555;Ne;0;6;0;6
2184;Gelvonėlis;SAULUTĖ;4268590631;Ne;8;0;0;8
2185;Gelvonėlis;SAULUTĖ;5598186460;Ne;14;1;0;15
2186;Gelvonėlis;SAULUTĖ;9767254134;Ne;10;0;0;10
2187;Gelvonėlis;SAULUTĖ;2452711535;Ne;6;2;0;8
2188;Gelvonėlis;PELĖDŽIUKAI;2742000725;Ne;8;0;0;8
2189;Gelvonėlis;PELĖDŽIUKAI;3147489259;Ne;0;2;0;2
2190;Gelvonėlis;PELĖDŽIUKAI;1284359362;Ne;0;1;2;3
2191;Gelvonėlis;PELĖDŽIUKAI;8775661719;Ne;0;1;0;1
2192;Gelvonėlis;PELĖDŽIUKAI;21684706944;Ne;4;0;0;4
2193;Gelvonėlis;PELĖDŽIUKAI;3089755141;Ne;0;2;0;2
2194;Gelvonėlis;PELĖDŽIUKAI;1408313697;Ne;0;0;8;8
2195;Gelvonėlis;PELĖDŽIUKAI;3670612781;Ne;0;1;0;1
2196;Gelvonėlis;PELĖDŽIUKAI;69073786634;Ne;8;0;0;8
2197;Gelvonėlis;PELĖDŽIUKAI;9323579468;Ne;0;0;3;3
2198;Gelvonėlis;PELĖDŽIUKAI;7919814808;Ne;3;4;0;7
2199;Gelvonėlis;DRUGELIAI;3371560338;Ne;0;5;0;5
2200;Gelvonėlis;DRUGELIAI;2407650243;Ne;11;0;0;11
2201;Gelvonėlis;DRUGELIAI;2896360160;Ne;9;0;0;9
2202;Gelvonėlis;DRUGELIAI;8365647638;Ne;0;2;0;2
2203;Gelvonėlis;DRUGELIAI;3618681535;Ne;20;0;0;20
2204;Gelvonėlis;DRUGELIAI;9386056584;Ne;10;1;0;11
2205;Gelvonėlis;DRUGELIAI;2114734415;Ne;17;0;0;17
2206;Gelvonėlis;DRUGELIAI;5882430535;Ne;10;0;0;10
2207;Gelvonėlis;DRUGELIAI;9140900868;Ne;16;0;0;16
2208;Gelvonėlis;DRUGELIAI;2645337382;Taip;20;0;0;20
2209;Gelvonėlis;DRUGELIAI;3813000890;Ne;1;2;0;3
2210;Gelvonėlis;DRUGELIAI;6662081736;Ne;8;0;0;8
2211;Gelvonėlis;DRUGELIAI;5379820728;Ne;15;0;0;15
2212;Gelvonėlis;DRUGELIAI;7938324572;Ne;14;1;0;15
2213;Gelvonėlis;DRUGELIAI;4162701876;Ne;11;0;0;11
2214;Gelvonėlis;DRUGELIAI;2407650243;Ne;11;0;0;11
2215;Gelvonėlis;VARPELIAI;9149117970;Ne;3;1;0;4
2216;Gelvonėlis;VARPELIAI;6225854165;Taip;0;0;2;2
2217;Gelvonėlis;VARPELIAI;2791652988;Ne;12;0;0;12
2218;Gelvonėlis;VARPELIAI;2638430817;Ne;0;0;8;8
2219;Gelvonėlis;VARPELIAI;9600526942;Ne;0;13;0;13
2220;Gelvonėlis;VARPELIAI;1387948936;Ne;0;3;0;3
2221;Gelvonėlis;VARPELIAI;9650922918;Ne;0;2;0;2
2222;Gelvonėlis;VARPELIAI;1462716950;Ne;0;7;0;7
2223;Gelvonėlis;VARPELIAI;6949090250;Ne;1;0;3;4
2224;Gelvonėlis;VARPELIAI;9622818893;Ne;11;0;1;12
2225;Gelvonėlis;VARPELIAI;6869418701;Ne;3;0;0;3
2226;Gelvonėlis;VARPELIAI;5207153784;Taip;0;0;1;1
2227;Gelvonėlis;VARPELIAI;3192542909;Ne;6;0;1;7
2228;Gelvonėlis;VARPELIAI;1802520150;Ne;3;0;0;3
2229;Gelvonėlis;BORUŽĖLĖS;8209225630;Ne;8;0;0;8
2230;Gelvonėlis;BORUŽĖLĖS;2698853686;Ne;0;1;0;1
2231;Gelvonėlis;BORUŽĖLĖS;4112607183;Ne;0;1;0;1
2232;Gelvonėlis;BORUŽĖLĖS;6243360625;Ne;0;11;0;11
2233;Gelvonėlis;BORUŽĖLĖS;5790038422;Ne;1;0;0;1
2234;Gelvonėlis;BORUŽĖLĖS;1712926391;Ne;0;0;10;10
2235;Gelvonėlis;BORUŽĖLĖS;6647585785;Ne;4;0;0;4
2236;Gelvonėlis;BORUŽĖLĖS;1539850989;Ne;0;0;1;1
2237;Gelvonėlis;BORUŽĖLĖS;1107633909;Ne;5;3;0;8
2238;Gelvonėlis;BORUŽĖLĖS;8973272332;Ne;6;4;0;10
2239;Gelvonėlis;BORUŽĖLĖS;3846916445;Ne;0;4;0;4
2240;Gelvonėlis;BORUŽĖLĖS;8806934077;Ne;0;0;20;20
2241;Gelvonėlis;BORUŽĖLĖS;3926733474;Ne;0;0;8;8
2242;Gelvonėlis;BORUŽĖLĖS;4620517551;Ne;0;0;2;2
2243;Gelvonėlis;BORUŽĖLĖS;6598688551;Ne;14;2;0;16
2244;Gelvonėlis;NYKŠTUKAI;8987012601;Ne;11;0;0;11
2245;Gelvonėlis;NYKŠTUKAI;1112841066;Ne;3;0;0;3
2246;Gelvonėlis;NYKŠTUKAI;2553846157;Ne;5;0;0;5
2247;Gelvonėlis;NYKŠTUKAI;8003522011;Taip;11;0;0;11
2248;Gelvonėlis;NYKŠTUKAI;5713586282;Ne;12;0;0;12
2249;Gelvonėlis;NYKŠTUKAI;3217646353;Taip;0;4;0;4
2250;Gelvonėlis;NYKŠTUKAI;8560940316;Ne;2;2;0;4
2251;Gelvonėlis;NYKŠTUKAI;8540204705;Ne;0;0;3;3
2252;Gelvonėlis;NYKŠTUKAI;8124516993;Ne;10;0;8;18
2253;Gelvonėlis;NYKŠTUKAI;9751580494;Ne;0;1;1;2
2254;Gelvonėlis;NYKŠTUKAI;4156493586;Ne;0;3;0;3
2255;Gelvonėlis;NYKŠTUKAI;5124211917;Ne;0;2;0;2
2256;Gelvonėlis;NYKŠTUKAI;5305480599;Ne;5;0;0;5
2257;Gelvonėlis;NYKŠTUKAI;9900244859;Ne;1;0;9;10
2258;Gelvonėlis;NYKŠTUKAI;9597033956;Ne;4;0;0;4
2259;Gelvonėlis;NYKŠTUKAI;4027647695;Ne;1;0;2;3
2260;Gelvonėlis;BITUTĖS;6534527571;Ne;0;3;0;3
2261;Gelvonėlis;BITUTĖS;1105838340;Ne;1;0;3;4
2262;Gelvonėlis;BITUTĖS;5444127599;Ne;10;5;0;15
2263;Gelvonėlis;BITUTĖS;6330751030;Ne;6;0;0;6
2264;Gelvonėlis;BITUTĖS;6710189985;Ne;0;10;0;10
2265;Gelvonėlis;BITUTĖS;5281400074;Ne;7;0;2;9
2266;Gelvonėlis;BITUTĖS;3514762919;Ne;0;3;0;3
2267;Gelvonėlis;BITUTĖS;8792171281;Ne;0;1;0;1
2268;Gelvonėlis;BITUTĖS;7850553299;Ne;1;0;0;1
2269;Gelvonėlis;BITUTĖS;1730718430;Ne;0;0;20;20
2270;Gelvonėlis;BITUTĖS;8480138654;Ne;0;9;0;9
2271;Gelvonėlis;BITUTĖS;7725313260;Ne;0;20;0;20
2272;Gelvonėlis;BITUTĖS;5816373550;Ne;15;0;0;15
2273;Gelvonėlis;BITUTĖS;4380468764;Ne;0;18;0;18
2274;Gelvonėlis;RAMUNĖLĖS;1104204810;Ne;3;0;0;3
2275;Gelvonėlis;RAMUNĖLĖS;1355774181;Ne;5;0;0;5
2276;Gelvonėlis;RAMUNĖLĖS;9403505858;Taip;16;0;0;16
2277;Gelvonėlis;RAMUNĖLĖS;7686930719;Ne;4;0;0;4
2278;Gelvonėlis;RAMUNĖLĖS;4450990418;Ne;9;0;1;10
2279;Gelvonėlis;RAMUNĖLĖS;6883156109;Ne;0;1;0;1
2280;Gelvonėlis;RAMUNĖLĖS;1562829157;Ne;8;0;0;8
2281;Gelvonėlis;RAMUNĖLĖS;4211228746;Ne;1;0;0;1
2282;Gelvonėlis;RAMUNĖLĖS;1661034338;Ne;10;0;3;13
2283;Gelvonėlis;RAMUNĖLĖS;2821485779;Ne;8;0;0;8
2284;Gelvonėlis;RAMUNĖLĖS;6518583809;Ne;13;0;6;19
2285;Gelvonėlis;RIEŠUTĖLIAI;3368423382;Ne;0;3;0;3
2286;Gelvonėlis;RIEŠUTĖLIAI;3973248307;Ne;6;0;0;6
2287;Gelvonėlis;RIEŠUTĖLIAI;5461812139;Ne;0;16;0;16
2288;Gelvonėlis;RIEŠUTĖLIAI;5986018609;Ne;0;1;2;3
2289;Gelvonėlis;RIEŠUTĖLIAI;8532801167;Ne;0;0;1;1
2290;Gelvonėlis;RIEŠUTĖLIAI;8766702456;Ne;7;0;1;8
2291;Gelvonėlis;RIEŠUTĖLIAI;6305084811;Ne;3;0;1;4
2292;Gelvonėlis;RIEŠUTĖLIAI;2005647155;Ne;0;0;1;1
2293;Gelvonėlis;RIEŠUTĖLIAI;5934077931;Ne;0;6;0;6
2294;Gelvonėlis;RIEŠUTĖLIAI;4280463938;Ne;0;1;0;1
2295;Gelvonėlis;RIEŠUTĖLIAI;6471921512;Ne;4;0;0;4
2296;Gelvonėlis;RIEŠUTĖLIAI;4832167372;Ne;0;6;0;6
2297;Gelvonėlis;RIEŠUTĖLIAI;9301814935;Ne;1;2;0;3
2298;Gelvonėlis;RIEŠUTĖLIAI;1466616814;Ne;10;0;0;10
2299;Gelvonėlis;RIEŠUTĖLIAI;2015807805;Ne;1;11;0;12
2300;Gelvonėlis;RIEŠUTĖLIAI;9323228591;Ne;0;0;1;1
2301;Gelvonėlis;RIEŠUTĖLIAI;2360728722;Ne;10;0;5;15
2302;Gelvonėlis;RIEŠUTĖLIAI;9132529216;Ne;11;2;0;13
2303;"Gervelė (Dzūkų g. 32)";ŽIRNIUKAI;2523056808;Taip;0;0;5;5
2304;"Gervelė (Dzūkų g. 32)";ŽIRNIUKAI;8533480337;Ne;0;1;0;1
2305;"Gervelė (Dzūkų g. 32)";ŽIRNIUKAI;6227091658;Ne;0;1;0;1
2306;"Gervelė (Dzūkų g. 32)";ŽIRNIUKAI;8439479958;Ne;0;1;5;6
2307;"Gervelė (Dzūkų g. 32)";ŽIRNIUKAI;6844406500;Ne;8;0;0;8
2308;"Gervelė (Dzūkų g. 32)";ŽIRNIUKAI;2359854614;Ne;0;6;0;6
2309;"Gervelė (Dzūkų g. 32)";ŽIRNIUKAI;8811086908;Ne;0;2;0;2
2310;"Gervelė (Dzūkų g. 32)";ŽIRNIUKAI;1573560581;Ne;2;0;1;3
2311;"Gervelė (Dzūkų g. 32)";ŽIRNIUKAI;9133101055;Ne;11;0;1;12
2312;"Gervelė (Dzūkų g. 32)";ŽIRNIUKAI;7192663882;Ne;4;0;1;5
2313;"Gervelė (Dzūkų g. 32)";ŽIRNIUKAI;1783612448;Ne;0;0;8;8
2314;"Gervelė (Dzūkų g. 32)";ŽIRNIUKAI;6650473677;Ne;0;0;3;3
2315;"Gervelė (Dzūkų g. 32)";ŽIRNIUKAI;2563081304;Ne;7;0;1;8
2316;"Gervelė (Dzūkų g. 32)";ŽIRNIUKAI;1101877666;Ne;9;0;10;19
2317;"Gervelė (Dzūkų g. 32)";ŽIRNIUKAI;2046282471;Ne;19;0;1;20
2318;"Gervelė (Dzūkų g. 32)";ŽIRNIUKAI;1024397071;Ne;0;0;6;6
2319;"Gervelė (Dzūkų g. 32)";ŽIRNIUKAI;4075328330;Ne;5;0;2;7
2320;"Gervelė (Dzūkų g. 32)";LAŠIUKAI;3702908570;Ne;0;2;0;2
2321;"Gervelė (Dzūkų g. 32)";LAŠIUKAI;3647044817;Ne;0;0;1;1
2322;"Gervelė (Dzūkų g. 32)";LAŠIUKAI;6431701403;Ne;0;0;6;6
2323;"Gervelė (Dzūkų g. 32)";LAŠIUKAI;2413995770;Ne;0;1;0;1
2324;"Gervelė (Dzūkų g. 32)";LAŠIUKAI;1637204236;Ne;1;0;0;1
2325;"Gervelė (Dzūkų g. 32)";LAŠIUKAI;7924884022;Ne;0;15;0;15
2326;"Gervelė (Dzūkų g. 32)";LAŠIUKAI;6834663627;Ne;0;12;0;12
2327;"Gervelė (Dzūkų g. 32)";LAŠIUKAI;1323074335;Ne;4;0;2;6
2328;"Gervelė (Dzūkų g. 32)";LAŠIUKAI;6058944385;Ne;0;4;0;4
2329;"Gervelė (Dzūkų g. 32)";LAŠIUKAI;2446758975;Taip;6;1;0;7
2330;"Gervelė (Dzūkų g. 32)";LAŠIUKAI;1353920541;Ne;0;1;0;1
2331;"Gervelė (Dzūkų g. 32)";LAŠIUKAI;5799823801;Ne;5;0;0;5
2332;"Gervelė (Dzūkų g. 32)";LAŠIUKAI;4899690598;Ne;4;0;6;10
2333;"Gervelė (Dzūkų g. 32)";LAŠIUKAI;6895415337;Ne;7;0;1;8
2334;"Gervelė (Dzūkų g. 32)";PABIRUČIAI;7317091881;Ne;8;0;1;9
2335;"Gervelė (Dzūkų g. 32)";PABIRUČIAI;6951455424;Ne;5;0;3;8
2336;"Gervelė (Dzūkų g. 32)";PABIRUČIAI;1112844296;Ne;0;0;3;3
2337;"Gervelė (Dzūkų g. 32)";PABIRUČIAI;6287806975;Taip;0;6;0;6
2338;"Gervelė (Dzūkų g. 32)";PABIRUČIAI;6228025635;Ne;6;0;0;6
2339;"Gervelė (Dzūkų g. 32)";PABIRUČIAI;9977349707;Ne;0;8;0;8
2340;"Gervelė (Dzūkų g. 32)";PABIRUČIAI;6155979185;Taip;8;3;0;11
2341;"Gervelė (Dzūkų g. 32)";PABIRUČIAI;3333885493;Ne;0;1;0;1
2342;"Gervelė (Dzūkų g. 32)";PABIRUČIAI;4295743997;Ne;0;1;0;1
2343;"Gervelė (Dzūkų g. 32)";PABIRUČIAI;7935059565;Ne;0;1;1;2
2344;"Gervelė (Dzūkų g. 32)";PABIRUČIAI;5267617723;Ne;0;1;0;1
2345;"Gervelė (Dzūkų g. 32)";PABIRUČIAI;5953552777;Ne;0;2;0;2
2346;"Gervelė (Dzūkų g. 32)";PABIRUČIAI;4038179503;Ne;10;0;1;11
2347;"Gervelė (Dzūkų g. 32)";PABIRUČIAI;1160084928;Ne;4;0;8;12
2348;"Gervelė (Dzūkų g. 32)";PABIRUČIAI;6987657237;Taip;6;0;0;6
2349;"Gervelė (Dzūkų g. 32)";PABIRUČIAI;8016341646;Taip;2;0;0;2
2350;"Gervelė (Dzūkų g. 32)";PABIRUČIAI;5685222621;Ne;1;0;3;4
2351;"Gervelė (Dzūkų g. 32)";PABIRUČIAI;4294916559;Ne;6;1;0;7
2352;"Gervelė (Dzūkų g. 32)";PABIRUČIAI;3449674095;Ne;0;5;0;5
2353;"Gervelė (Dzūkų g. 32)";BITUTĖS;6090290046;Ne;0;0;2;2
2354;"Gervelė (Dzūkų g. 32)";BITUTĖS;75080308291;Ne;0;1;0;1
2355;"Gervelė (Dzūkų g. 32)";BITUTĖS;6737174004;Ne;0;7;0;7
2356;"Gervelė (Dzūkų g. 32)";BITUTĖS;1616949023;Ne;5;0;2;7
2357;"Gervelė (Dzūkų g. 32)";BITUTĖS;3427400844;Ne;0;0;7;7
2358;"Gervelė (Dzūkų g. 32)";BITUTĖS;8152446576;Ne;4;0;3;7
2359;"Gervelė (Dzūkų g. 32)";BITUTĖS;7302238728;Ne;0;1;1;2
2360;"Gervelė (Dzūkų g. 32)";BITUTĖS;1400044294;Ne;0;0;5;5
2361;"Gervelė (Dzūkų g. 32)";BITUTĖS;8062089041;Taip;0;10;0;10
2362;"Gervelė (Dzūkų g. 32)";BITUTĖS;7697761552;Ne;0;0;5;5
2363;"Gervelė (Dzūkų g. 32)";BITUTĖS;5989713844;Ne;8;0;0;8
2364;"Gervelė (Dzūkų g. 32)";BITUTĖS;4560752068;Ne;0;7;0;7
2365;"Gervelė (Dzūkų g. 32)";BITUTĖS;89076506192;Ne;0;1;0;1
2366;"Gervelė (Dzūkų g. 32)";BITUTĖS;87619285504;Ne;0;0;1;1
2367;"Gervelė (Dzūkų g. 32)";BITUTĖS;1991238577;Ne;0;0;8;8
2368;"Gervelė (Dzūkų g. 32)";BITUTĖS;2167744244;Ne;7;4;0;11
2369;"Gervelė (Dzūkų g. 32)";BITUTĖS;3525060645;Ne;7;0;0;7
2370;"Gervelė (Dzūkų g. 32)";BITUTĖS;7162551366;Ne;0;20;0;20
2371;"Gervelė (Dzūkų g. 32)";BITUTĖS;9970293084;Ne;0;1;0;1
2372;"Gervelė (Dzūkų g. 32)";BURATINO;7620764911;Ne;11;0;3;14
2373;"Gervelė (Dzūkų g. 32)";BURATINO;9239897472;Ne;7;2;0;9
2374;"Gervelė (Dzūkų g. 32)";BURATINO;3359793310;Ne;0;0;2;2
2375;"Gervelė (Dzūkų g. 32)";BURATINO;9982951468;Ne;9;0;4;13
2376;"Gervelė (Dzūkų g. 32)";BURATINO;5900623823;Ne;0;4;0;4
2377;"Gervelė (Dzūkų g. 32)";BURATINO;4775822341;Ne;0;6;0;6
2378;"Gervelė (Dzūkų g. 32)";BURATINO;2541771432;Ne;5;0;2;7
2379;"Gervelė (Dzūkų g. 32)";BURATINO;2913622440;Ne;5;0;1;6
2380;"Gervelė (Dzūkų g. 32)";BURATINO;1108744283;Ne;0;7;0;7
2381;"Gervelė (Dzūkų g. 32)";BURATINO;4516538272;Ne;9;0;1;10
2382;"Gervelė (Dzūkų g. 32)";BURATINO;9256422807;Ne;5;0;2;7
2383;"Gervelė (Dzūkų g. 32)";BURATINO;3723783633;Ne;8;0;0;8
2384;"Gervelė (Dzūkų g. 32)";BURATINO;9997346812;Ne;8;0;4;12
2385;"Gervelė (Dzūkų g. 32)";BURATINO;8472436632;Taip;14;0;0;14
2386;"Gervelė (Dzūkų g. 32)";VIŠČIUKŲ;9532470407;Ne;11;0;0;11
2387;"Gervelė (Dzūkų g. 32)";VIŠČIUKŲ;8792240321;Ne;10;0;0;10
2388;"Gervelė (Dzūkų g. 32)";VIŠČIUKŲ;7205673717;Ne;0;0;2;2
2389;"Gervelė (Dzūkų g. 32)";VIŠČIUKŲ;7140356352;Ne;1;0;1;2
2390;"Gervelė (Dzūkų g. 32)";VIŠČIUKŲ;8598429197;Ne;10;0;1;11
2391;"Gervelė (Dzūkų g. 32)";VIŠČIUKŲ;3230279203;Ne;3;0;0;3
2392;"Gervelė (Dzūkų g. 32)";VIŠČIUKŲ;8392147716;Ne;20;0;0;20
2393;"Gervelė (Dzūkų g. 32)";VIŠČIUKŲ;5608916470;Ne;10;0;0;10
2394;"Gervelė (Dzūkų g. 32)";VIŠČIUKŲ;8098158634;Ne;14;0;0;14
2395;"Gervelė (Dzūkų g. 32)";VIŠČIUKŲ;3554640994;Ne;0;0;2;2
2396;"Gervelė (Dzūkų g. 32)";VIŠČIUKŲ;9478720027;Ne;12;4;1;17
2397;"Gervelė (Dzūkų g. 32)";VIŠČIUKŲ;4552290778;Ne;1;0;0;1
2398;"Gervelė (Dzūkų g. 32)";VIŠČIUKŲ;3170062234;Ne;6;0;0;6
2399;"Gervelė (Dzūkų g. 32)";VIŠČIUKŲ;1226130732;Taip;1;0;2;3
2400;"Gilužis (Vydūno g. 11A)";Skruzdėliukų;35511006307;Ne;0;2;1;3
2401;"Gilužis (Vydūno g. 11A)";Skruzdėliukų;9474400084;Ne;0;3;0;3
2402;"Gilužis (Vydūno g. 11A)";Skruzdėliukų;70959404439;Ne;0;2;1;3
2403;"Gilužis (Vydūno g. 11A)";Skruzdėliukų;8120898865;Ne;0;1;0;1
2404;"Gilužis (Vydūno g. 11A)";Skruzdėliukų;8840822243;Ne;0;1;0;1
2405;"Gilužis (Vydūno g. 11A)";Skruzdėliukų;4611735601;Ne;0;2;0;2
2406;"Gilužis (Vydūno g. 11A)";Skruzdėliukų;5920357223;Ne;0;1;0;1
2407;"Gilužis (Vydūno g. 11A)";Skruzdėliukų;8595541498;Ne;12;0;0;12
2408;"Gilužis (Vydūno g. 11A)";Skruzdėliukų;5365582271;Ne;9;2;0;11
2409;"Gilužis (Vydūno g. 11A)";Skruzdėliukų;4362244070;Ne;1;0;0;1
2410;"Gilužis (Vydūno g. 11A)";Skruzdėliukų;3216004438;Ne;3;0;1;4
2411;"Gilužis (Vydūno g. 11A)";Skruzdėliukų;48365991937;Ne;10;2;0;12
2412;"Gilužis (Vydūno g. 11A)";Skruzdėliukų;29586826889;Ne;8;4;0;12
2413;"Gilužis (Vydūno g. 11A)";Skruzdėliukų;3071312399;Ne;6;4;1;11
2414;"Gilužis (Vydūno g. 11A)";Skruzdėliukų;6233020671;Ne;0;1;0;1
2415;"Gilužis (Vydūno g. 11A)";Nykštukų;3132445117;Ne;0;1;0;1
2416;"Gilužis (Vydūno g. 11A)";Nykštukų;4147821853;Ne;0;2;0;2
2417;"Gilužis (Vydūno g. 11A)";Nykštukų;3473889426;Ne;5;2;0;7
2418;"Gilužis (Vydūno g. 11A)";Nykštukų;9362581908;Ne;5;2;0;7
2419;"Gilužis (Vydūno g. 11A)";Nykštukų;8899557365;Ne;9;0;0;9
2420;"Gilužis (Vydūno g. 11A)";Nykštukų;2661894041;Ne;15;0;0;15
2421;"Gilužis (Vydūno g. 11A)";Nykštukų;7228498662;Ne;0;1;0;1
2422;"Gilužis (Vydūno g. 11A)";Nykštukų;1459273692;Ne;7;1;0;8
2423;"Gilužis (Vydūno g. 11A)";Nykštukų;4156613717;Ne;0;3;0;3
2424;"Gilužis (Vydūno g. 11A)";Nykštukų;5713786735;Ne;0;2;0;2
2425;"Gilužis (Vydūno g. 11A)";Nykštukų;4956685016;Ne;0;1;0;1
2426;"Gilužis (Vydūno g. 11A)";Nykštukų;6315155554;Ne;0;1;0;1
2427;"Gilužis (Vydūno g. 11A)";Nykštukų;4541291716;Ne;0;2;3;5
2428;"Gilužis (Vydūno g. 11A)";Nykštukų;8522552650;Ne;5;0;0;5
2429;"Gilužis (Vydūno g. 11A)";Nykštukų;3176305306;Ne;2;1;0;3
2430;"Gilužis (Vydūno g. 11A)";Nykštukų;4795108770;Ne;0;1;0;1
2431;"Gilužis (Vydūno g. 11A)";Nykštukų;4094486541;Ne;17;0;0;17
2432;"Gilužis (Vydūno g. 11A)";Nykštukų;6493142538;Ne;13;1;0;14
2433;"Gilužis (Vydūno g. 11A)";Nykštukų;5088561405;Ne;4;0;0;4
2434;"Gilužis (Vydūno g. 11A)";Bitučių;4841014668;Ne;0;2;0;2
2435;"Gilužis (Vydūno g. 11A)";Bitučių;3399162399;Ne;3;0;0;3
2436;"Gilužis (Vydūno g. 11A)";Bitučių;5973671038;Ne;0;1;0;1
2437;"Gilužis (Vydūno g. 11A)";Bitučių;5728341732;Ne;1;2;1;4
2438;"Gilužis (Vydūno g. 11A)";Bitučių;2780710383;Ne;7;0;0;7
2439;"Gilužis (Vydūno g. 11A)";Bitučių;6931726275;Ne;10;2;0;12
2440;"Gilužis (Vydūno g. 11A)";Bitučių;1867185320;Ne;0;1;0;1
2441;"Gilužis (Vydūno g. 11A)";Bitučių;3429435736;Ne;4;1;0;5
2442;"Gilužis (Vydūno g. 11A)";Bitučių;8539946703;Taip;0;20;0;20
2443;"Gilužis (Vydūno g. 11A)";Bitučių;9000351000;Ne;0;1;0;1
2444;"Gilužis (Vydūno g. 11A)";Bitučių;5162397237;Ne;7;0;0;7
2445;"Gilužis (Vydūno g. 11A)";Bitučių;9053608903;Ne;13;2;0;15
2446;"Gilužis (Vydūno g. 11A)";Bitučių;6115776872;Ne;7;0;1;8
2447;"Gilužis (Vydūno g. 11A)";Bitučių;5651799121;Ne;0;0;3;3
2448;"Gilužis (Vydūno g. 11A)";Bitučių;2950813185;Ne;9;2;0;11
2449;"Gilužis (Vydūno g. 11A)";Bitučių;6515525848;Ne;5;7;0;12
2450;"Gilužis (Vydūno g. 11A)";Kačiukų;1273655212;Ne;0;1;0;1
2451;"Gilužis (Vydūno g. 11A)";Kačiukų;4978922821;Ne;1;0;0;1
2452;"Gilužis (Vydūno g. 11A)";Kačiukų;2945406185;Ne;1;0;0;1
2453;"Gilužis (Vydūno g. 11A)";Kačiukų;1582241363;Ne;0;0;2;2
2454;"Gilužis (Vydūno g. 11A)";Kačiukų;7330938312;Ne;20;0;0;20
2455;"Gilužis (Vydūno g. 11A)";Kačiukų;6571132974;Ne;0;20;0;20
2456;"Gilužis (Vydūno g. 11A)";Kačiukų;7001112696;Ne;0;0;3;3
2457;"Gilužis (Vydūno g. 11A)";Kačiukų;9034842169;Ne;10;0;0;10
2458;"Gilužis (Vydūno g. 11A)";Kačiukų;6966795180;Ne;0;1;0;1
2459;"Gilužis (Vydūno g. 11A)";Kačiukų;5128383851;Ne;0;0;4;4
2460;"Gilužis (Vydūno g. 11A)";Kačiukų;8318405114;Ne;2;0;0;2
2461;"Gilužis (Vydūno g. 11A)";Kačiukų;4403218878;Ne;5;1;0;6
2462;"Gilužis (Vydūno g. 11A)";Kačiukų;9186274541;Ne;0;0;1;1
2463;"Gilužis (Vydūno g. 11A)";Kačiukų;9421351780;Ne;6;0;0;6
2464;"Gilužis (Vydūno g. 11A)";Kačiukų;6404411477;Ne;6;0;0;6
2465;"Gilužis (Vydūno g. 11A)";Kačiukų;4128387076;Ne;12;0;0;12
2466;"Gilužis (Vydūno g. 11A)";Kačiukų;7042664923;Ne;4;0;1;5
2467;"Gilužis (Vydūno g. 11A)";Kačiukų;9097165155;Ne;0;0;7;7
2468;"Gilužis (Vydūno g. 11A)";Kačiukų;8762534617;Ne;0;5;0;5
2469;"Gilužis (Vydūno g. 11A)";Pelėdžiukų;5217748032;Ne;0;1;0;1
2470;"Gilužis (Vydūno g. 11A)";Pelėdžiukų;5989314494;Ne;0;2;0;2
2471;"Gilužis (Vydūno g. 11A)";Pelėdžiukų;7998695149;Ne;14;0;0;14
2472;"Gilužis (Vydūno g. 11A)";Pelėdžiukų;7742783427;Ne;14;0;0;14
2473;"Gilužis (Vydūno g. 11A)";Pelėdžiukų;7358572344;Ne;0;4;0;4
2474;"Gilužis (Vydūno g. 11A)";Pelėdžiukų;1222370750;Ne;0;7;0;7
2475;"Gilužis (Vydūno g. 11A)";Pelėdžiukų;9503516686;Ne;3;1;0;4
2476;"Gilužis (Vydūno g. 11A)";Pelėdžiukų;9833451628;Ne;0;4;0;4
2477;"Gilužis (Vydūno g. 11A)";Pelėdžiukų;4051726208;Ne;0;4;0;4
2478;"Gilužis (Vydūno g. 11A)";Pelėdžiukų;7092060789;Ne;1;0;0;1
2479;"Gilužis (Vydūno g. 11A)";Pelėdžiukų;1804218972;Ne;0;0;1;1
2480;"Gilužis (Vydūno g. 11A)";Pelėdžiukų;1832039250;Ne;4;0;0;4
2481;"Gilužis (Vydūno g. 11A)";Pelėdžiukų;3166161973;Ne;2;2;1;5
2482;"Gilužis (Vydūno g. 11A)";Pelėdžiukų;5070988982;Ne;0;1;0;1
2483;"Gilužis (Vydūno g. 11A)";Pelėdžiukų;7899274495;Ne;0;0;10;10
2484;"Gilužis (Vydūno g. 11A)";Pelėdžiukų;6093514885;Ne;0;7;0;7
2485;"Gilužis (Vydūno g. 11A)";Pelėdžiukų;2869506388;Ne;0;2;0;2
2486;"Gilužis (Vydūno g. 11A)";Drugelių;6121625070;Ne;18;0;0;18
2487;"Gilužis (Vydūno g. 11A)";Drugelių;1770064694;Ne;0;2;0;2
2488;"Gilužis (Vydūno g. 11A)";Drugelių;9591229878;Ne;12;0;1;13
2489;"Gilužis (Vydūno g. 11A)";Drugelių;9092013248;Ne;9;2;0;11
2490;"Gilužis (Vydūno g. 11A)";Drugelių;9109883577;Ne;7;0;0;7
2491;"Gilužis (Vydūno g. 11A)";Drugelių;8006465211;Ne;0;0;3;3
2492;"Gilužis (Vydūno g. 11A)";Drugelių;5118401707;Ne;3;0;0;3
2493;"Gilužis (Vydūno g. 11A)";Drugelių;3190597262;Ne;3;0;1;4
2494;"Gilužis (Vydūno g. 11A)";Drugelių;2988856911;Ne;0;1;0;1
2495;"Gilužis (Vydūno g. 11A)";Drugelių;3532863024;Ne;0;20;0;20
2496;"Gilužis (Vydūno g. 11A)";Drugelių;1376645277;Ne;7;0;0;7
2497;"Gilužis (Vydūno g. 11A)";Drugelių;1410870589;Ne;0;7;0;7
2498;"Gilužis (Vydūno g. 11A)";Drugelių;9112993465;Ne;10;0;0;10
2499;"Gilužis (Vydūno g. 11A)";Drugelių;4909329417;Ne;6;0;1;7
2500;"Gilužis (Vydūno g. 11A)";Drugelių;8244385001;Ne;6;0;0;6
2501;"Gilužis (Vydūno g. 11A)";Drugelių;6429142049;Ne;1;0;2;3
2502;"Gilužis (Vydūno g. 11A)";Drugelių;7731169885;Ne;10;1;0;11
2503;"Gilužis (Vydūno g. 11A)";Drugelių;1093643746;Ne;8;6;0;14
2504;"Gilužis (Vydūno g. 11A)";Drugelių;3902713866;Ne;1;0;1;2
2505;"Gilužis (Vydūno g. 11A)";Drugelių;6950139609;Ne;1;0;7;8
2506;"Gilužis (Vydūno g. 11A)";Drugelių;2397231165;Ne;7;0;0;7
2507;"Gilužis (Vydūno g. 11A)";Saulučių;17896774143;Ne;9;0;3;12
2508;"Gilužis (Vydūno g. 11A)";Saulučių;9918995545;Ne;0;2;0;2
2509;"Gilužis (Vydūno g. 11A)";Saulučių;4575619425;Ne;3;0;0;3
2510;"Gilužis (Vydūno g. 11A)";Saulučių;4473810097;Ne;5;5;0;10
2511;"Gilužis (Vydūno g. 11A)";Saulučių;96550272401;Ne;3;0;0;3
2512;"Gilužis (Vydūno g. 11A)";Saulučių;69504888193;Ne;2;0;1;3
2513;"Gilužis (Vydūno g. 11A)";Saulučių;2391630554;Ne;4;1;0;5
2514;"Gilužis (Vydūno g. 11A)";Saulučių;18997894859;Ne;0;0;1;1
2515;"Gilužis (Vydūno g. 11A)";Saulučių;7744997250;Ne;0;7;0;7
2516;"Gilužis (Vydūno g. 11A)";Saulučių;32730847948;Ne;7;0;0;7
2517;"Gilužis (Vydūno g. 11A)";Saulučių;3181765606;Ne;1;1;0;2
2518;"Gilužis (Vydūno g. 11A)";Saulučių;79805583046;Ne;0;0;1;1
2519;"Gilužis (Vydūno g. 11A)";Saulučių;2872439079;Ne;0;0;7;7
2520;"Gilužis (Vydūno g. 11A)";Saulučių;87425898496;Ne;6;0;0;6
2521;"Gilužis (Vydūno g. 11A)";Saulučių;9367673896;Ne;11;0;0;11
2522;"Gilužis (Vydūno g. 11A)";Saulučių;1453976300;Ne;0;2;0;2
2523;"Gilužis (Vydūno g. 11A)";Saulučių;1211233315;Ne;0;0;1;1
2524;"Gilužis (Vydūno g. 11A)";Saulučių;5621912516;Ne;0;4;0;4
2525;"Gilužis (Vydūno g. 11A)";Paukštelių;46597815116;Ne;0;2;0;2
2526;"Gilužis (Vydūno g. 11A)";Paukštelių;1877467761;Ne;0;2;6;8
2527;"Gilužis (Vydūno g. 11A)";Paukštelių;1146713023;Ne;0;3;0;3
2528;"Gilužis (Vydūno g. 11A)";Paukštelių;1980250599;Ne;0;0;1;1
2529;"Gilužis (Vydūno g. 11A)";Paukštelių;1962914764;Ne;0;0;8;8
2530;"Gilužis (Vydūno g. 11A)";Paukštelių;7636249706;Ne;0;1;1;2
2531;"Gilužis (Vydūno g. 11A)";Paukštelių;2508958685;Ne;0;1;6;7
2532;"Gilužis (Vydūno g. 11A)";Paukštelių;72738770293;Ne;9;0;0;9
2533;"Gilužis (Vydūno g. 11A)";Paukštelių;8875479631;Ne;0;4;0;4
2534;"Gilužis (Vydūno g. 11A)";Paukštelių;5759145600;Ne;0;20;0;20
2535;"Gilužis (Vydūno g. 11A)";Paukštelių;2436416327;Ne;0;0;2;2
2536;"Gilužis (Vydūno g. 11A)";Paukštelių;6218943275;Ne;0;1;0;1
2537;"Gilužis (Vydūno g. 11A)";Paukštelių;2754594238;Ne;0;1;0;1
2538;"Gilužis (Vydūno g. 11A)";Paukštelių;4297300799;Ne;1;0;0;1
2539;"Gilužis (Vydūno g. 11A)";Paukštelių;8531121002;Ne;12;1;0;13
2540;"Gilužis (Vydūno g. 11A)";Paukštelių;46276990963;Ne;0;1;0;1
2541;"Gilužis (Vydūno g. 11A)";Paukštelių;5303511810;Ne;3;1;0;4
2542;"Gilužis (Vydūno g. 11A)";Obuoliukų;8201769917;Ne;5;2;0;7
2543;"Gilužis (Vydūno g. 11A)";Obuoliukų;9892608223;Ne;7;2;0;9
2544;"Gilužis (Vydūno g. 11A)";Obuoliukų;1540018160;Ne;7;0;0;7
2545;"Gilužis (Vydūno g. 11A)";Obuoliukų;7716908903;Ne;5;0;0;5
2546;"Gilužis (Vydūno g. 11A)";Obuoliukų;3131597174;Ne;8;2;0;10
2547;"Gilužis (Vydūno g. 11A)";Obuoliukų;6239369861;Ne;9;0;0;9
2548;"Gilužis (Vydūno g. 11A)";Obuoliukų;6172360933;Ne;0;3;0;3
2549;"Gilužis (Vydūno g. 11A)";Obuoliukų;7398446674;Ne;4;0;0;4
2550;"Gilužis (Vydūno g. 11A)";Obuoliukų;4592380105;Ne;4;5;0;9
2551;"Gilužis (Vydūno g. 11A)";Obuoliukų;4242362889;Ne;5;0;0;5
2552;"Gilužis (Vydūno g. 11A)";Obuoliukų;7560732216;Ne;5;0;0;5
2553;"Gilužis (Vydūno g. 11A)";Obuoliukų;5476140202;Ne;11;2;0;13
2554;"Gilužis (Vydūno g. 11A)";Obuoliukų;8194444043;Ne;6;0;0;6
2555;"Gilužis (Vydūno g. 11A)";Obuoliukų;7606394325;Ne;4;3;0;7
2556;"Gilužis (Vydūno g. 11A)";Obuoliukų;6737884137;Ne;0;11;0;11
2557;"Gilužis (Vydūno g. 11A)";Obuoliukų;6825745985;Ne;4;1;0;5
2558;"Gilužis (Vydūno g. 11A)";Obuoliukų;3458957423;Ne;6;0;1;7
2559;"Gilužis (Vydūno g. 11A)";Obuoliukų;8900414658;Ne;2;0;0;2
2560;"Gilužis (Vydūno g. 11A)";Obuoliukų;3219101391;Ne;10;0;0;10
2561;"Gilužis (Vydūno g. 11A)";Obuoliukų;4528131001;Ne;0;18;0;18
2562;"Gilužis (Vydūno g. 11A)";Obuoliukų;5895659747;Ne;0;18;0;18
2563;"Gilužis (Vydūno g. 11A)";KIŠKUČIŲ;5744027226;Ne;0;1;0;1
2564;"Gilužis (Vydūno g. 11A)";KIŠKUČIŲ;8639633038;Ne;0;0;3;3
2565;"Gilužis (Vydūno g. 11A)";KIŠKUČIŲ;5721924532;Ne;8;0;0;8
2566;"Gilužis (Vydūno g. 11A)";KIŠKUČIŲ;2680643896;Ne;0;7;0;7
2567;"Gilužis (Vydūno g. 11A)";KIŠKUČIŲ;5685074731;Ne;5;0;0;5
2568;"Gilužis (Vydūno g. 11A)";KIŠKUČIŲ;3649616461;Ne;0;1;0;1
2569;"Gilužis (Vydūno g. 11A)";KIŠKUČIŲ;7632771776;Ne;0;0;2;2
2570;"Gilužis (Vydūno g. 11A)";KIŠKUČIŲ;7560574633;Ne;13;0;0;13
2571;"Gilužis (Vydūno g. 11A)";KIŠKUČIŲ;4199633620;Ne;0;2;5;7
2572;"Gilužis (Vydūno g. 11A)";KIŠKUČIŲ;9851612698;Ne;7;7;0;14
2573;"Gilužis (Vydūno g. 11A)";KIŠKUČIŲ;1391410955;Ne;0;20;0;20
2574;"Gilužis (Vydūno g. 11A)";KIŠKUČIŲ;6383469680;Ne;9;5;0;14
2575;"Gilužis (Vydūno g. 11A)";KIŠKUČIŲ;3171560628;Ne;0;4;0;4
2576;"Gilužis (Vydūno g. 11A)";KIŠKUČIŲ;4347319425;Ne;9;0;2;11
2577;"Gilužis (Vydūno g. 11A)";KIŠKUČIŲ;8591741716;Ne;6;0;0;6
2578;"Gilužis (Vydūno g. 11A)";KIŠKUČIŲ;8877445672;Ne;16;0;0;16
2579;"Gilužis (Vydūno g. 11A)";KIŠKUČIŲ;9489594782;Ne;0;0;1;1
2580;"Gilužis (Vydūno g. 11A)";KIŠKUČIŲ;6185954940;Taip;10;0;0;10
2581;"Gilužis (Vydūno g. 11A)";Meškučių;7263432152;Ne;2;3;1;6
2582;"Gilužis (Vydūno g. 11A)";Meškučių;4655266106;Ne;5;2;0;7
2583;"Gilužis (Vydūno g. 11A)";Meškučių;3800593189;Ne;0;8;0;8
2584;"Gilužis (Vydūno g. 11A)";Meškučių;4174307847;Ne;20;0;0;20
2585;"Gilužis (Vydūno g. 11A)";Meškučių;8393554697;Ne;0;8;0;8
2586;"Gilužis (Vydūno g. 11A)";Meškučių;8301535013;Ne;5;0;0;5
2587;"Gilužis (Vydūno g. 11A)";Meškučių;2939982311;Ne;4;2;0;6
2588;"Gilužis (Vydūno g. 11A)";Meškučių;3365778697;Ne;11;6;0;17
2589;"Gilužis (Vydūno g. 11A)";Meškučių;7912093880;Taip;10;0;0;10
2590;"Gilužis (Vydūno g. 11A)";Meškučių;2500949029;Ne;0;4;0;4
2591;"Gilužis (Vydūno g. 11A)";Meškučių;4741129495;Ne;19;1;0;20
2592;"Gilužis (Vydūno g. 11A)";Meškučių;7992750316;Ne;7;1;0;8
2593;"Gilužis (Vydūno g. 11A)";Meškučių;2577554894;Ne;4;0;1;5
2594;"Gilužis (Vydūno g. 11A)";Meškučių;6303770262;Taip;15;0;0;15
2595;"Gilužis (Vydūno g. 11A)";Meškučių;1068375927;Ne;2;0;1;3
2596;"Gilužis (Vydūno g. 11A)";Meškučių;8780573054;Ne;5;5;0;10
2597;"Gilužis (Vydūno g. 11A)";Meškučių;6185280967;Ne;10;1;0;11
2598;"Gilužis (Vydūno g. 11A)";Meškučių;5177805719;Ne;3;5;0;8
2599;"Gilužis (Vydūno g. 11A)";Pagrandukai;6884146146;Ne;0;20;0;20
2600;"Gilužis (Vydūno g. 11A)";Pagrandukai;6920910054;Ne;11;9;0;20
2601;"Gilužis (Vydūno g. 11A)";Pagrandukai;5705945483;Ne;0;8;0;8
2602;"Gilužis (Vydūno g. 11A)";Pagrandukai;6501973647;Ne;12;1;0;13
2603;"Gilužis (Vydūno g. 11A)";Pagrandukai;5397975739;Ne;12;1;0;13
2604;"Gilužis (Vydūno g. 11A)";Pagrandukai;6109205159;Ne;2;0;0;2
2605;"Gilužis (Vydūno g. 11A)";Pagrandukai;2328338059;Ne;2;0;0;2
2606;"Gilužis (Vydūno g. 11A)";Pagrandukai;5376639182;Ne;0;3;0;3
2607;"Gilužis (Vydūno g. 11A)";Pagrandukai;5378701300;Ne;11;1;0;12
2608;"Gilužis (Vydūno g. 11A)";Pagrandukai;3366788027;Ne;11;1;0;12
2609;"Gilužis (Vydūno g. 11A)";Pagrandukai;9676661005;Ne;11;1;0;12
2610;"Gilužis (Vydūno g. 11A)";Pagrandukai;1306757860;Ne;11;1;0;12
2611;"Gilužis (Vydūno g. 11A)";Pagrandukai;2706629834;Ne;0;3;0;3
2612;"Gilužis (Vydūno g. 11A)";Pagrandukai;1604096952;Ne;13;0;0;13
2613;"Gilužis (Vydūno g. 11A)";Pagrandukai;5184511012;Ne;15;0;0;15
2614;"Gilužis (Vydūno g. 11A)";Pagrandukai;9587502317;Ne;15;0;0;15
2615;"Gilužis (Vydūno g. 11A)";Pagrandukai;4266998302;Ne;0;1;0;1
2616;"Gilužis (Vydūno g. 11A)";Pagrandukai;5334441484;Ne;20;0;0;20
2617;"Gilužis (Vydūno g. 11A)";Pagrandukai;6831107153;Ne;2;0;0;2
2618;"Gilužis (Vydūno g. 11A)";Pagrandukai;8852862161;Ne;2;0;0;2
2619;"Gilužis (Vydūno g. 11A)";Pagrandukai;2955779117;Ne;2;0;0;2
2620;"Gilužis (Vydūno g. 11A)";Boružėlių;5497242500;Ne;0;2;0;2
2621;"Gilužis (Vydūno g. 11A)";Boružėlių;2516315604;Ne;11;0;0;11
2622;"Gilužis (Vydūno g. 11A)";Boružėlių;9783700319;Ne;20;0;0;20
2623;"Gilužis (Vydūno g. 11A)";Boružėlių;5394693502;Ne;3;0;0;3
2624;"Gilužis (Vydūno g. 11A)";Boružėlių;4876074981;Ne;0;2;1;3
2625;"Gilužis (Vydūno g. 11A)";Boružėlių;2633680406;Ne;2;1;0;3
2626;"Gilužis (Vydūno g. 11A)";Boružėlių;2221786284;Ne;1;0;0;1
2627;"Gilužis (Vydūno g. 11A)";Boružėlių;3002266577;Ne;20;0;0;20
2628;"Gilužis (Vydūno g. 11A)";Boružėlių;5190752112;Ne;2;2;0;4
2629;"Gilužis (Vydūno g. 11A)";Boružėlių;2440762487;Ne;2;2;0;4
2630;"Gilužis (Vydūno g. 11A)";Boružėlių;4509741536;Ne;0;2;0;2
2631;"Gilužis (Vydūno g. 11A)";Boružėlių;9707968228;Ne;13;0;0;13
2632;"Gilužis (Vydūno g. 11A)";Boružėlių;8628253655;Ne;9;2;0;11
2633;"Gilužis (Vydūno g. 11A)";Boružėlių;5581417252;Ne;0;20;0;20
2634;"Gilužis (Vydūno g. 11A)";Boružėlių;4106792355;Ne;0;1;0;1
2635;"Gilužis (Vydūno g. 11A)";Boružėlių;1085130813;Ne;8;1;0;9
2636;"Gilužis (Vydūno g. 11A)";Boružėlių;2615087717;Ne;5;0;0;5
2637;"Gintarėlis (Didlaukio g. 35)";PAPŪGĖLĖS;8498936096;Ne;0;2;0;2
2638;"Gintarėlis (Didlaukio g. 35)";PAPŪGĖLĖS;8913652291;Ne;0;0;5;5
2639;"Gintarėlis (Didlaukio g. 35)";PAPŪGĖLĖS;2485750596;Ne;0;1;2;3
2640;"Gintarėlis (Didlaukio g. 35)";PAPŪGĖLĖS;1033624080;Ne;0;1;0;1
2641;"Gintarėlis (Didlaukio g. 35)";PAPŪGĖLĖS;1768789948;Ne;0;0;1;1
2642;"Gintarėlis (Didlaukio g. 35)";PAPŪGĖLĖS;2595566032;Ne;0;20;0;20
2643;"Gintarėlis (Didlaukio g. 35)";PAPŪGĖLĖS;9141438560;Ne;0;20;0;20
2644;"Gintarėlis (Didlaukio g. 35)";PAPŪGĖLĖS;9494521554;Ne;0;9;0;9
2645;"Gintarėlis (Didlaukio g. 35)";PAPŪGĖLĖS;5783939567;Ne;0;2;5;7
2646;"Gintarėlis (Didlaukio g. 35)";PAPŪGĖLĖS;7674351459;Ne;0;1;0;1
2647;"Gintarėlis (Didlaukio g. 35)";PAPŪGĖLĖS;8610886062;Ne;0;4;0;4
2648;"Gintarėlis (Didlaukio g. 35)";PAPŪGĖLĖS;5811396263;Ne;0;3;0;3
2649;"Gintarėlis (Didlaukio g. 35)";PAPŪGĖLĖS;1648843117;Ne;2;2;2;6
2650;"Gintarėlis (Didlaukio g. 35)";PAPŪGĖLĖS;1861324153;Ne;0;6;0;6
2651;"Gintarėlis (Didlaukio g. 35)";PAPŪGĖLĖS;3457974670;Ne;0;2;3;5
2652;"Gintarėlis (Didlaukio g. 35)";PAPŪGĖLĖS;1511718436;Ne;0;2;2;4
2653;"Gintarėlis (Didlaukio g. 35)";PAPŪGĖLĖS;4484711857;Ne;0;0;7;7
2654;"Gintarėlis (Didlaukio g. 35)";PAPŪGĖLĖS;6080108998;Ne;0;2;2;4
2655;"Gintarėlis (Didlaukio g. 35)";PAPŪGĖLĖS;6655645997;Ne;0;2;1;3
2656;"Gintarėlis (Didlaukio g. 35)";SPINDULIUKAI;6091264509;Ne;4;4;0;8
2657;"Gintarėlis (Didlaukio g. 35)";SPINDULIUKAI;56124970238;Ne;10;1;0;11
2658;"Gintarėlis (Didlaukio g. 35)";SPINDULIUKAI;4902086873;Ne;4;0;0;4
2659;"Gintarėlis (Didlaukio g. 35)";SPINDULIUKAI;21658913551;Ne;3;5;0;8
2660;"Gintarėlis (Didlaukio g. 35)";SPINDULIUKAI;8405210216;Ne;0;2;1;3
2661;"Gintarėlis (Didlaukio g. 35)";SPINDULIUKAI;18715625324;Ne;0;3;0;3
2662;"Gintarėlis (Didlaukio g. 35)";SPINDULIUKAI;2721386855;Ne;0;0;2;2
2663;"Gintarėlis (Didlaukio g. 35)";SPINDULIUKAI;2914156353;Ne;0;0;7;7
2664;"Gintarėlis (Didlaukio g. 35)";SPINDULIUKAI;5916948150;Ne;0;10;0;10
2665;"Gintarėlis (Didlaukio g. 35)";SPINDULIUKAI;45480802894;Ne;0;2;4;6
2666;"Gintarėlis (Didlaukio g. 35)";SPINDULIUKAI;3978892232;Ne;0;4;0;4
2667;"Gintarėlis (Didlaukio g. 35)";SPINDULIUKAI;1441282039;Ne;0;2;2;4
2668;"Gintarėlis (Didlaukio g. 35)";SPINDULIUKAI;9539570835;Ne;0;6;0;6
2669;"Gintarėlis (Didlaukio g. 35)";SPINDULIUKAI;7878911379;Ne;0;4;0;4
2670;"Gintarėlis (Didlaukio g. 35)";LAŠIUKAI;6142819210;Ne;0;6;0;6
2671;"Gintarėlis (Didlaukio g. 35)";LAŠIUKAI;7971810025;Ne;6;0;0;6
2672;"Gintarėlis (Didlaukio g. 35)";LAŠIUKAI;5577759167;Ne;14;5;0;19
2673;"Gintarėlis (Didlaukio g. 35)";LAŠIUKAI;8247701603;Ne;0;1;0;1
2674;"Gintarėlis (Didlaukio g. 35)";LAŠIUKAI;4498326942;Ne;0;2;0;2
2675;"Gintarėlis (Didlaukio g. 35)";LAŠIUKAI;4641943773;Ne;5;0;0;5
2676;"Gintarėlis (Didlaukio g. 35)";LAŠIUKAI;1655837441;Ne;0;2;0;2
2677;"Gintarėlis (Didlaukio g. 35)";LAŠIUKAI;1690400583;Ne;6;1;0;7
2678;"Gintarėlis (Didlaukio g. 35)";LAŠIUKAI;8186804032;Ne;3;8;0;11
2679;"Gintarėlis (Didlaukio g. 35)";LAŠIUKAI;1826743229;Ne;6;0;0;6
2680;"Gintarėlis (Didlaukio g. 35)";LAŠIUKAI;9560190761;Ne;6;0;0;6
2681;"Gintarėlis (Didlaukio g. 35)";LAŠIUKAI;5434952733;Ne;0;2;0;2
2682;"Gintarėlis (Didlaukio g. 35)";LAŠIUKAI;5018151097;Ne;5;0;0;5
2683;"Gintarėlis (Didlaukio g. 35)";LAŠIUKAI;9230924100;Ne;0;1;0;1
2684;"Gintarėlis (Didlaukio g. 35)";LAŠIUKAI;4333780287;Ne;0;14;0;14
2685;"Gintarėlis (Didlaukio g. 35)";LAŠIUKAI;7286562743;Ne;5;3;0;8
2686;"Gintarėlis (Didlaukio g. 35)";LAŠIUKAI;1675553097;Ne;0;0;1;1
2687;"Gintarėlis (Didlaukio g. 35)";LAŠIUKAI;8000297636;Ne;5;11;0;16
2688;"Gintarėlis (Didlaukio g. 35)";LAŠIUKAI;3359584322;Ne;0;1;2;3
2689;"Gintarėlis (Didlaukio g. 35)";LAŠIUKAI;6377674849;Ne;1;0;0;1
2690;"Gintarėlis (Didlaukio g. 35)";LAŠIUKAI;3820683506;Ne;5;7;0;12
2691;"Gintarėlis (Didlaukio g. 35)";MEŠKUČIAI;6618240550;Ne;5;0;0;5
2692;"Gintarėlis (Didlaukio g. 35)";MEŠKUČIAI;8790078624;Ne;2;2;0;4
2693;"Gintarėlis (Didlaukio g. 35)";MEŠKUČIAI;2518840573;Ne;10;0;0;10
2694;"Gintarėlis (Didlaukio g. 35)";MEŠKUČIAI;5187894822;Ne;0;1;0;1
2695;"Gintarėlis (Didlaukio g. 35)";MEŠKUČIAI;3630567294;Ne;0;2;0;2
2696;"Gintarėlis (Didlaukio g. 35)";MEŠKUČIAI;5181872438;Ne;0;1;0;1
2697;"Gintarėlis (Didlaukio g. 35)";MEŠKUČIAI;1565802953;Ne;0;20;0;20
2698;"Gintarėlis (Didlaukio g. 35)";MEŠKUČIAI;2072435242;Ne;20;0;0;20
2699;"Gintarėlis (Didlaukio g. 35)";MEŠKUČIAI;7989239799;Ne;5;1;0;6
2700;"Gintarėlis (Didlaukio g. 35)";MEŠKUČIAI;4356211536;Ne;10;1;0;11
2701;"Gintarėlis (Didlaukio g. 35)";MEŠKUČIAI;1502740714;Ne;5;0;0;5
2702;"Gintarėlis (Didlaukio g. 35)";MEŠKUČIAI;3830154353;Ne;1;1;0;2
2703;"Gintarėlis (Didlaukio g. 35)";MEŠKUČIAI;7948438165;Ne;0;6;0;6
2704;"Gintarėlis (Didlaukio g. 35)";MEŠKUČIAI;4642142931;Ne;9;4;0;13
2705;"Gintarėlis (Didlaukio g. 35)";MEŠKUČIAI;6711753930;Ne;5;1;0;6
2706;"Gintarėlis (Didlaukio g. 35)";MEŠKUČIAI;8375475174;Ne;0;8;0;8
2707;"Gintarėlis (Didlaukio g. 35)";MEŠKUČIAI;7029401386;Ne;10;0;0;10
2708;"Gintarėlis (Didlaukio g. 35)";MEŠKUČIAI;7320085613;Ne;6;4;0;10
2709;"Gintarėlis (Didlaukio g. 35)";DRUGELIAI;9737200226;Ne;0;2;1;3
2710;"Gintarėlis (Didlaukio g. 35)";DRUGELIAI;6655809299;Ne;0;0;1;1
2711;"Gintarėlis (Didlaukio g. 35)";DRUGELIAI;2614258442;Ne;0;5;0;5
2712;"Gintarėlis (Didlaukio g. 35)";DRUGELIAI;1452402931;Ne;0;2;0;2
2713;"Gintarėlis (Didlaukio g. 35)";DRUGELIAI;7571352126;Taip;0;1;0;1
2714;"Gintarėlis (Didlaukio g. 35)";DRUGELIAI;9687974376;Ne;0;4;0;4
2715;"Gintarėlis (Didlaukio g. 35)";DRUGELIAI;8419453060;Ne;0;0;2;2
2716;"Gintarėlis (Didlaukio g. 35)";DRUGELIAI;7449437199;Ne;0;1;0;1
2717;"Gintarėlis (Didlaukio g. 35)";DRUGELIAI;3341850450;Ne;4;0;0;4
2718;"Gintarėlis (Didlaukio g. 35)";DRUGELIAI;1759218238;Ne;0;2;0;2
2719;"Gintarėlis (Didlaukio g. 35)";DRUGELIAI;1248017244;Ne;0;3;0;3
2720;"Gintarėlis (Didlaukio g. 35)";DRUGELIAI;2792618575;Ne;0;6;0;6
2721;"Gintarėlis (Didlaukio g. 35)";DRUGELIAI;8171192401;Ne;0;0;1;1
2722;"Gintarėlis (Didlaukio g. 35)";DRUGELIAI;7694587246;Ne;3;0;0;3
2723;"Gintarėlis (Didlaukio g. 35)";DRUGELIAI;4904966263;Ne;0;2;0;2
2724;"Gintarėlis (Didlaukio g. 35)";KAČIUKAI;5569843168;Ne;0;4;0;4
2725;"Gintarėlis (Didlaukio g. 35)";KAČIUKAI;3665764153;Ne;7;1;0;8
2726;"Gintarėlis (Didlaukio g. 35)";KAČIUKAI;9774056578;Ne;0;4;4;8
2727;"Gintarėlis (Didlaukio g. 35)";KAČIUKAI;2212296954;Ne;0;3;1;4
2728;"Gintarėlis (Didlaukio g. 35)";KAČIUKAI;3825700024;Ne;0;1;0;1
2729;"Gintarėlis (Didlaukio g. 35)";KAČIUKAI;7057877483;Ne;0;1;0;1
2730;"Gintarėlis (Didlaukio g. 35)";KAČIUKAI;9825811100;Ne;0;5;0;5
2731;"Gintarėlis (Didlaukio g. 35)";KAČIUKAI;7875981690;Ne;0;7;0;7
2732;"Gintarėlis (Didlaukio g. 35)";KAČIUKAI;2544338275;Ne;0;7;0;7
2733;"Gintarėlis (Didlaukio g. 35)";KAČIUKAI;9963329170;Taip;0;2;4;6
2734;"Gintarėlis (Didlaukio g. 35)";KAČIUKAI;1011749698;Ne;14;2;3;19
2735;"Gintarėlis (Didlaukio g. 35)";KAČIUKAI;8261770154;Ne;0;12;0;12
2736;"Gintarėlis (Didlaukio g. 35)";KAČIUKAI;5436695400;Ne;0;7;0;7
2737;"Gintarėlis (Didlaukio g. 35)";KAČIUKAI;5921751507;Ne;0;1;0;1
2738;"Gintarėlis (Didlaukio g. 35)";KAČIUKAI;9450900915;Ne;0;0;1;1
2739;"Gintarėlis (Didlaukio g. 35)";KAČIUKAI;5153948767;Ne;0;2;0;2
2740;"Gintarėlis (Didlaukio g. 35)";KAČIUKAI;3814485627;Ne;0;1;0;1
2741;"Gintarėlis (Didlaukio g. 35)";KAČIUKAI;1571260478;Ne;9;0;0;9
2742;"Gintarėlis (Didlaukio g. 35)";KAČIUKAI;9244715396;Ne;6;2;1;9
2743;"Gintarėlis (Didlaukio g. 35)";KAČIUKAI;3015327416;Ne;0;2;0;2
2744;"Gintarėlis (Didlaukio g. 35)";KIŠKUČIAI;9279399214;Ne;0;2;1;3
2745;"Gintarėlis (Didlaukio g. 35)";KIŠKUČIAI;3921015919;Ne;0;2;0;2
2746;"Gintarėlis (Didlaukio g. 35)";KIŠKUČIAI;2814569415;Ne;1;2;2;5
2747;"Gintarėlis (Didlaukio g. 35)";KIŠKUČIAI;7143014339;Ne;0;4;0;4
2748;"Gintarėlis (Didlaukio g. 35)";KIŠKUČIAI;5796729245;Ne;0;5;0;5
2749;"Gintarėlis (Didlaukio g. 35)";KIŠKUČIAI;9915887420;Ne;0;5;0;5
2750;"Gintarėlis (Didlaukio g. 35)";KIŠKUČIAI;8287685690;Ne;0;1;0;1
2751;"Gintarėlis (Didlaukio g. 35)";KIŠKUČIAI;2165332442;Ne;0;3;0;3
2752;"Gintarėlis (Didlaukio g. 35)";KIŠKUČIAI;6914904213;Ne;0;2;0;2
2753;"Gintarėlis (Didlaukio g. 35)";KIŠKUČIAI;1696337909;Ne;0;2;0;2
2754;"Gintarėlis (Didlaukio g. 35)";KIŠKUČIAI;6862629244;Ne;0;4;0;4
2755;"Gintarėlis (Didlaukio g. 35)";KIŠKUČIAI;3398936974;Ne;0;2;0;2
2756;"Gintarėlis (Didlaukio g. 35)";KIŠKUČIAI;1918879534;Ne;6;0;0;6
2757;"Gintarėlis (Didlaukio g. 35)";KIŠKUČIAI;7509100750;Ne;0;4;0;4
2758;"Gintarėlis (Didlaukio g. 35)";KIŠKUČIAI;6991746305;Ne;1;1;0;2
2759;"Gintarėlis (Didlaukio g. 35)";KIŠKUČIAI;6239242631;Ne;1;0;0;1
2760;"Gintarėlis (Didlaukio g. 35)";KIŠKUČIAI;5965570522;Ne;13;0;0;13
2761;"Gintarėlis (Didlaukio g. 35)";KIŠKUČIAI;3357866319;Taip;0;4;0;4
2762;"Gintarėlis (Didlaukio g. 35)";KIŠKUČIAI;8116557698;Taip;5;2;0;7
2763;"Gintarėlis (Didlaukio g. 35)";KIŠKUČIAI;8704248985;Ne;9;3;0;12
2764;"Gintarėlis (Didlaukio g. 35)";KIŠKUČIAI;5919205817;Ne;0;5;0;5
2765;"Gintarėlis (Didlaukio g. 35)";VYTURIUKAI;9954282865;Ne;0;3;2;5
2766;"Gintarėlis (Didlaukio g. 35)";VYTURIUKAI;5834772263;Ne;0;2;0;2
2767;"Gintarėlis (Didlaukio g. 35)";VYTURIUKAI;9533972547;Ne;0;0;8;8
2768;"Gintarėlis (Didlaukio g. 35)";VYTURIUKAI;4915783145;Ne;0;0;8;8
2769;"Gintarėlis (Didlaukio g. 35)";BORUŽĖLĖS;7372735642;Ne;7;0;1;8
2770;"Gintarėlis (Didlaukio g. 35)";BORUŽĖLĖS;6402043654;Ne;0;10;0;10
2771;"Gintarėlis (Didlaukio g. 35)";BORUŽĖLĖS;6558614008;Ne;11;0;0;11
2772;"Gintarėlis (Didlaukio g. 35)";BORUŽĖLĖS;4348245746;Ne;0;1;0;1
2773;"Gintarėlis (Didlaukio g. 35)";BORUŽĖLĖS;3091731769;Ne;5;1;0;6
2774;"Gintarėlis (Didlaukio g. 35)";BORUŽĖLĖS;6484966941;Ne;5;1;0;6
2775;"Gintarėlis (Didlaukio g. 35)";BORUŽĖLĖS;9004590065;Ne;0;2;5;7
2776;"Gintarėlis (Didlaukio g. 35)";BORUŽĖLĖS;2624469768;Ne;8;0;0;8
2777;"Gintarėlis (Didlaukio g. 35)";BORUŽĖLĖS;8784796186;Ne;0;3;2;5
2778;"Gintarėlis (Didlaukio g. 35)";BORUŽĖLĖS;3538300416;Ne;0;1;0;1
2779;"Gintarėlis (Didlaukio g. 35)";BORUŽĖLĖS;8516817506;Ne;0;5;0;5
2780;"Gintarėlis (Didlaukio g. 35)";BORUŽĖLĖS;3235154374;Ne;0;20;0;20
2781;"Gintarėlis (Didlaukio g. 35)";BORUŽĖLĖS;9970786396;Ne;0;3;0;3
2782;"Gintarėlis (Didlaukio g. 35)";BORUŽĖLĖS;7118758040;Ne;9;2;4;15
2783;"Gintarėlis (Didlaukio g. 35)";BORUŽĖLĖS;9622824643;Ne;6;0;0;6
2784;"Gintarėlis (Didlaukio g. 35)";BORUŽĖLĖS;9476258741;Ne;0;1;0;1
2785;"Gintarėlis (Didlaukio g. 35)";BORUŽĖLĖS;1400817076;Ne;5;2;0;7
2786;"Gintarėlis (Didlaukio g. 35)";BORUŽĖLĖS;1371258551;Ne;0;1;1;2
2787;"Gintarėlis (Didlaukio g. 35)";BORUŽĖLĖS;4334349824;Ne;4;1;0;5
2788;"Gintarėlis (Didlaukio g. 35)";BORUŽĖLĖS;8410642485;Ne;0;0;2;2
2789;"Gintarėlis (Didlaukio g. 35)";BORUŽĖLĖS;9501012756;Ne;11;1;0;12
2790;"Gintarėlis (Didlaukio g. 35)";EŽIUKAI;4676321193;Ne;0;1;0;1
2791;"Gintarėlis (Didlaukio g. 35)";EŽIUKAI;2263102527;Ne;0;2;1;3
2792;"Gintarėlis (Didlaukio g. 35)";EŽIUKAI;7919771693;Ne;0;0;1;1
2793;"Gintarėlis (Didlaukio g. 35)";EŽIUKAI;8055928882;Ne;0;1;0;1
2794;"Gintarėlis (Didlaukio g. 35)";EŽIUKAI;5024727902;Ne;0;2;0;2
2795;"Gintarėlis (Didlaukio g. 35)";EŽIUKAI;2088008759;Ne;6;1;2;9
2796;"Gintarėlis (Didlaukio g. 35)";EŽIUKAI;4660854883;Ne;6;0;0;6
2797;"Gintarėlis (Didlaukio g. 35)";EŽIUKAI;94354056029;Ne;0;3;0;3
2798;"Gintarėlis (Didlaukio g. 35)";EŽIUKAI;1002155392;Ne;0;2;0;2
2799;"Gintarėlis (Didlaukio g. 35)";EŽIUKAI;9130659549;Ne;0;2;0;2
2800;"Gintarėlis (Didlaukio g. 35)";EŽIUKAI;2036488789;Ne;0;0;2;2
2801;"Gintarėlis (Didlaukio g. 35)";EŽIUKAI;7644607132;Ne;0;1;0;1
2802;"Gintarėlis (Didlaukio g. 35)";EŽIUKAI;78359050717;Ne;10;0;0;10
2803;"Gintarėlis (Didlaukio g. 35)";EŽIUKAI;7192722296;Ne;4;2;2;8
2804;"Gintarėlis (Didlaukio g. 35)";EŽIUKAI;2970527490;Ne;0;1;0;1
2805;"Gintarėlis (Didlaukio g. 35)";EŽIUKAI;1028456578;Ne;0;0;3;3
2806;"Gintarėlis (Didlaukio g. 35)";EŽIUKAI;1066741732;Ne;9;0;1;10
2807;"Gintarėlis (Didlaukio g. 35)";EŽIUKAI;1778573935;Ne;5;2;0;7
2808;"Gintarėlis (Didlaukio g. 35)";EŽIUKAI;9917367735;Ne;0;0;1;1
2809;"Gintarėlis (Didlaukio g. 35)";EŽIUKAI;4514340634;Ne;0;1;0;1
2810;"Gintarėlis (Didlaukio g. 35)";VIŠČIUKAI;1981825456;Ne;0;1;0;1
2811;"Gintarėlis (Didlaukio g. 35)";VIŠČIUKAI;3973889495;Ne;0;1;0;1
2812;"Gintarėlis (Didlaukio g. 35)";VIŠČIUKAI;4749559606;Ne;5;2;0;7
2813;"Gintarėlis (Didlaukio g. 35)";VIŠČIUKAI;2178808286;Ne;0;16;0;16
2814;"Gintarėlis (Didlaukio g. 35)";VIŠČIUKAI;9073499040;Ne;9;0;0;9
2815;"Gintarėlis (Didlaukio g. 35)";VIŠČIUKAI;6547060300;Ne;9;4;0;13
2816;"Gintarėlis (Didlaukio g. 35)";VIŠČIUKAI;4535071342;Ne;0;3;0;3
2817;"Gintarėlis (Didlaukio g. 35)";VIŠČIUKAI;8448725884;Ne;0;3;0;3
2818;"Gintarėlis (Didlaukio g. 35)";VIŠČIUKAI;6251670953;Ne;0;1;0;1
2819;"Gintarėlis (Didlaukio g. 35)";VIŠČIUKAI;8805356168;Ne;0;4;0;4
2820;"Gintarėlis (Didlaukio g. 35)";VIŠČIUKAI;4751066825;Ne;0;2;5;7
2821;"Gintarėlis (Didlaukio g. 35)";VIŠČIUKAI;1039098192;Ne;10;1;0;11
2822;"Gintarėlis (Didlaukio g. 35)";VIŠČIUKAI;6042885133;Ne;0;2;2;4
2823;"Gintarėlis (Didlaukio g. 35)";VIŠČIUKAI;7562170082;Ne;0;16;0;16
2824;"Gintarėlis (Didlaukio g. 35)";VIŠČIUKAI;1367305617;Ne;6;0;0;6
2825;"Gintarėlis (Didlaukio g. 35)";VIŠČIUKAI;6711773127;Ne;0;13;0;13
2826;"Gintarėlis (Didlaukio g. 35)";VIŠČIUKAI;7537009709;Ne;5;0;0;5
2827;"Gintarėlis (Didlaukio g. 35)";VIŠČIUKAI;2920734274;Ne;0;0;4;4
2828;"Gintarėlis (Didlaukio g. 35)";VIŠČIUKAI;3232990779;Ne;10;1;0;11
2829;"Gintarėlis (Didlaukio g. 35)";"SAULĖS ZUIKUČIAI";4278770021;Ne;0;2;0;2
2830;"Gintarėlis (Didlaukio g. 35)";"SAULĖS ZUIKUČIAI";9915228593;Ne;0;1;0;1
2831;"Gintarėlis (Didlaukio g. 35)";"SAULĖS ZUIKUČIAI";2499727321;Ne;5;1;0;6
2832;"Gintarėlis (Didlaukio g. 35)";"SAULĖS ZUIKUČIAI";2949035147;Ne;3;3;0;6
2833;"Gintarėlis (Didlaukio g. 35)";"SAULĖS ZUIKUČIAI";3839660368;Ne;0;4;1;5
2834;"Gintarėlis (Didlaukio g. 35)";"SAULĖS ZUIKUČIAI";5991638696;Ne;10;4;0;14
2835;"Gintarėlis (Didlaukio g. 35)";"SAULĖS ZUIKUČIAI";6563281778;Ne;0;1;0;1
2836;"Gintarėlis (Didlaukio g. 35)";"SAULĖS ZUIKUČIAI";6751822184;Ne;0;2;0;2
2837;"Gintarėlis (Didlaukio g. 35)";"SAULĖS ZUIKUČIAI";8721340357;Ne;11;0;2;13
2838;"Gintarėlis (Didlaukio g. 35)";"SAULĖS ZUIKUČIAI";3876016666;Ne;4;0;1;5
2839;"Gintarėlis (Didlaukio g. 35)";"SAULĖS ZUIKUČIAI";8403881160;Ne;8;5;0;13
2840;"Gintarėlis (Didlaukio g. 35)";"SAULĖS ZUIKUČIAI";5336654560;Ne;0;1;0;1
2841;"Gintarėlis (Didlaukio g. 35)";"SAULĖS ZUIKUČIAI";3732252177;Ne;0;1;0;1
2842;"Gintarėlis (Didlaukio g. 35)";"SAULĖS ZUIKUČIAI";4087751760;Ne;4;0;0;4
2843;"Gintarėlis (Didlaukio g. 35)";"SAULĖS ZUIKUČIAI";4462515146;Ne;6;0;0;6
2844;"Gintarėlis (Didlaukio g. 35)";"SAULĖS ZUIKUČIAI";6138593853;Ne;10;1;0;11
2845;"Gintarėlis (Didlaukio g. 35)";"SAULĖS ZUIKUČIAI";7004430575;Ne;8;0;0;8
2846;"Gintarėlis (Didlaukio g. 35)";"SAULĖS ZUIKUČIAI";5509394003;Ne;11;0;0;11
2847;"Gintarėlis (Didlaukio g. 35)";"SAULĖS ZUIKUČIAI";1482227839;Ne;0;1;0;1
2848;"Gintarėlis (Didlaukio g. 35)";Pabiručiai;8286814809;Ne;0;4;0;4
2849;"Gintarėlis (Didlaukio g. 35)";Pabiručiai;4757160835;Ne;0;0;1;1
2850;"Gintarėlis (Didlaukio g. 35)";Pabiručiai;1474802737;Ne;0;1;0;1
2851;"Gintarėlis (Didlaukio g. 35)";Pabiručiai;6578588403;Ne;0;7;0;7
2852;"Gintarėlis (Didlaukio g. 35)";Šypsenėlės;3575375401;Ne;0;2;4;6
2853;"Gintarėlis (Didlaukio g. 35)";Šypsenėlės;3575375401;Ne;0;2;4;6
2854;"Gintarėlis (Didlaukio g. 35)";Šypsenėlės;3575375401;Ne;0;2;4;6
2855;"Gintarėlis (Didlaukio g. 35)";Šypsenėlės;2904118045;Ne;3;0;3;6
2856;"Gintarėlis (Didlaukio g. 35)";Šypsenėlės;9413836091;Ne;0;2;1;3
2857;"Gintarėlis (Didlaukio g. 35)";Šypsenėlės;1567290856;Ne;0;0;5;5
2858;"Gintarėlis (Didlaukio g. 35)";Šypsenėlės;7661638176;Taip;0;2;5;7
2859;"Gintarėlis (Didlaukio g. 35)";Šypsenėlės;3088663209;Ne;0;10;0;10
2860;"Gintarėlis (Didlaukio g. 35)";Šypsenėlės;3794027499;Ne;3;2;0;5
2861;"Gintarėlis (Didlaukio g. 35)";Šypsenėlės;9234476307;Ne;6;2;0;8
2862;"Gintarėlis (Didlaukio g. 35)";Šypsenėlės;6561070982;Ne;0;2;0;2
2863;"Gintarėlis (Didlaukio g. 35)";Šypsenėlės;3484172382;Ne;5;0;0;5
2864;"Gintarėlis (Didlaukio g. 35)";Šypsenėlės;2256002308;Ne;0;1;0;1
2865;"Gintarėlis (Didlaukio g. 35)";Šypsenėlės;6607854244;Ne;0;2;1;3
2866;"Gintarėlis (Didlaukio g. 35)";Šypsenėlės;1327681704;Ne;0;2;1;3
2867;"Gintarėlis (Didlaukio g. 35)";Šypsenėlės;3000371147;Ne;0;1;0;1
2868;"Gintarėlis (Didlaukio g. 35)";Šypsenėlės;5717123412;Ne;0;4;0;4
2869;"Gintarėlis (Didlaukio g. 35)";Šypsenėlės;1480486900;Ne;0;2;2;4
2870;"Gintarėlis (Didlaukio g. 35)";Šypsenėlės;3459439843;Ne;15;1;0;16
2871;"Gintarėlis (Didlaukio g. 35)";Smalsučiai;7486822380;Ne;0;2;1;3
2872;"Gintarėlis (Didlaukio g. 35)";Smalsučiai;1875958358;Ne;6;0;0;6
2873;"Gintarėlis (Didlaukio g. 35)";Smalsučiai;8292698645;Ne;0;4;1;5
2874;"Gintarėlis (Didlaukio g. 35)";Smalsučiai;5748677965;Ne;0;0;1;1
2875;"Gintarėlis (Didlaukio g. 35)";Smalsučiai;1876292168;Ne;7;3;0;10
2876;"Gintarėlis (Didlaukio g. 35)";Smalsučiai;8754068506;Ne;9;0;0;9
2877;"Gintarėlis (Didlaukio g. 35)";Smalsučiai;7690748176;Ne;2;0;0;2
2878;"Gintarėlis (Didlaukio g. 35)";Smalsučiai;8355089218;Ne;5;2;1;8
2879;"Gintarėlis (Didlaukio g. 35)";Kodėlčiukai;7976989629;Ne;9;0;1;10
2880;"Gintarėlis (Didlaukio g. 35)";Kodėlčiukai;8982034601;Ne;2;6;0;8
2881;"Gintarėlis (Didlaukio g. 35)";Kodėlčiukai;2234295991;Ne;6;0;0;6
2882;"Gintarėlis (Didlaukio g. 35)";Kodėlčiukai;6545866812;Ne;5;1;0;6
2883;"Gintarėlis (Didlaukio g. 35)";Kodėlčiukai;5467958458;Ne;0;1;0;1
2884;"Gintarėlis (Didlaukio g. 35)";Gintariukai;6056471440;Ne;0;20;0;20
2885;"Gintarėlis (Didlaukio g. 35)";Gintariukai;2809388552;Ne;0;0;3;3
2886;"Gintarėlis (Didlaukio g. 35)";Gintariukai;9374716095;Ne;7;0;0;7
2887;Giraitė;Aviliukas;4292730355;Ne;0;0;1;1
2888;Giraitė;Aviliukas;7001163828;Ne;0;0;1;1
2889;Giraitė;Aviliukas;5456658087;Ne;0;0;1;1
2890;Giraitė;Aviliukas;6159650070;Ne;1;0;2;3
2891;Giraitė;Aviliukas;5275912609;Ne;0;1;0;1
2892;Giraitė;Aviliukas;4758750245;Ne;14;0;0;14
2893;Giraitė;Aviliukas;2219854347;Ne;12;0;4;16
2894;Giraitė;Aviliukas;2338867192;Ne;5;0;2;7
2895;Giraitė;Aviliukas;3719285343;Ne;15;0;2;17
2896;Giraitė;Aviliukas;3085107071;Ne;0;2;0;2
2897;Giraitė;Aviliukas;7807844145;Ne;10;0;0;10
2898;Giraitė;Aviliukas;7876457529;Ne;8;0;5;13
2899;Giraitė;Aviliukas;3992069614;Ne;2;0;5;7
2900;Giraitė;Aviliukas;6121586335;Ne;0;0;12;12
2901;Giraitė;Aviliukas;4440444700;Ne;12;0;1;13
2902;Giraitė;Aviliukas;6296485105;Ne;0;0;1;1
2903;Giraitė;Aviliukas;5356944812;Ne;7;0;4;11
2904;Giraitė;Aviliukas;4554565631;Ne;5;0;0;5
2905;Giraitė;Aviliukas;2340866110;Taip;0;0;14;14
2906;Giraitė;LapiukaI;6141730004;Ne;7;1;0;8
2907;Giraitė;LapiukaI;7831526566;Ne;4;0;0;4
2908;Giraitė;LapiukaI;2740656695;Ne;1;1;3;5
2909;Giraitė;LapiukaI;5030697729;Ne;5;0;1;6
2910;Giraitė;LapiukaI;1921430434;Ne;0;1;0;1
2911;Giraitė;LapiukaI;4663343304;Ne;9;1;4;14
2912;Giraitė;LapiukaI;4811513778;Ne;6;1;0;7
2913;Giraitė;LapiukaI;4296449093;Taip;0;2;0;2
2914;Giraitė;LapiukaI;1974159110;Ne;5;0;3;8
2915;Giraitė;LapiukaI;5532639133;Ne;2;1;2;5
2916;Giraitė;LapiukaI;4076402180;Ne;0;1;0;1
2917;Giraitė;LapiukaI;5902161665;Ne;0;1;0;1
2918;Giraitė;LapiukaI;4955786826;Taip;3;0;0;3
2919;Giraitė;LapiukaI;4260343903;Taip;10;0;0;10
2920;Giraitė;LapiukaI;9088123796;Ne;18;0;0;18
2921;Giraitė;LapiukaI;7772177095;Ne;4;0;0;4
2922;Giraitė;LapiukaI;8492822889;Ne;0;1;0;1
2923;Giraitė;LapiukaI;2880342138;Ne;9;0;0;9
2924;Giraitė;Voveriukai;7354834895;Ne;5;1;0;6
2925;Giraitė;Voveriukai;4387282125;Ne;0;0;1;1
2926;Giraitė;Voveriukai;2074303013;Ne;3;0;0;3
2927;Giraitė;Voveriukai;3875214088;Ne;7;1;0;8
2928;Giraitė;Voveriukai;5202562049;Ne;0;6;0;6
2929;Giraitė;Voveriukai;7441871219;Ne;8;0;0;8
2930;Giraitė;Voveriukai;7481895278;Ne;0;0;3;3
2931;Giraitė;Voveriukai;3607198556;Ne;0;4;4;8
2932;Giraitė;Voveriukai;1945918102;Ne;15;0;0;15
2933;Giraitė;Voveriukai;8799195526;Ne;4;0;1;5
2934;Giraitė;Voveriukai;6225092500;Ne;5;0;1;6
2935;Giraitė;Voveriukai;4137699629;Ne;10;4;0;14
2936;Giraitė;Voveriukai;4932174149;Ne;1;1;0;2
2937;Giraitė;Voveriukai;3896789232;Ne;0;0;2;2
2938;Giraitė;Voveriukai;7919088987;Ne;5;0;0;5
2939;Giraitė;Voveriukai;5616242311;Ne;0;0;3;3
2940;Giraitė;Voveriukai;4773517160;Ne;4;0;2;6
2941;Giraitė;Voveriukai;2177856916;Ne;1;0;0;1
2942;Giraitė;Grybukai;2990968206;Ne;2;0;1;3
2943;Giraitė;Grybukai;1312761239;Ne;0;2;0;2
2944;Giraitė;Grybukai;5892950503;Ne;0;1;0;1
2945;Giraitė;Grybukai;4839351300;Ne;6;3;0;9
2946;Giraitė;Grybukai;9495968363;Ne;0;1;0;1
2947;Giraitė;Grybukai;1253151830;Ne;0;1;0;1
2948;Giraitė;Grybukai;6836412890;Ne;4;0;0;4
2949;Giraitė;Grybukai;9224845723;Ne;0;1;1;2
2950;Giraitė;Grybukai;4687228561;Ne;4;0;0;4
2951;Giraitė;Grybukai;9918028862;Ne;0;2;0;2
2952;Giraitė;Grybukai;5167002022;Ne;7;1;0;8
2953;Giraitė;Grybukai;4785524898;Ne;0;1;0;1
2954;Giraitė;Grybukai;8596389737;Ne;0;0;5;5
2955;Giraitė;Grybukai;1111614295;Ne;0;3;0;3
2956;Giraitė;Grybukai;5029839281;Ne;0;0;4;4
2957;Giraitė;Grybukai;3683700626;Ne;0;2;0;2
2958;Giraitė;Grybukai;9026736929;Ne;0;6;0;6
2959;Giraitė;Riešutėliai;7179656901;Ne;0;1;0;1
2960;Giraitė;Riešutėliai;3158451613;Ne;5;1;0;6
2961;Giraitė;Riešutėliai;7910736839;Ne;5;0;2;7
2962;Giraitė;Riešutėliai;3308792461;Ne;5;0;2;7
2963;Giraitė;Riešutėliai;7423115504;Ne;0;0;1;1
2964;Giraitė;Riešutėliai;7580600719;Ne;2;0;1;3
2965;Giraitė;Riešutėliai;3116241918;Ne;0;0;1;1
2966;Giraitė;Riešutėliai;6838184704;Ne;7;3;0;10
2967;Giraitė;Riešutėliai;5161383686;Ne;0;1;0;1
2968;Giraitė;Riešutėliai;5148257412;Ne;3;0;1;4
2969;Giraitė;Riešutėliai;9144465313;Ne;0;0;3;3
2970;Giraitė;Riešutėliai;6288016799;Ne;5;0;1;6
2971;Giraitė;Riešutėliai;3278871662;Ne;0;2;1;3
2972;Giraitė;Riešutėliai;4168934880;Ne;7;1;0;8
2973;Giraitė;Riešutėliai;6337090583;Ne;0;0;1;1
2974;Giraitė;Riešutėliai;3843211767;Ne;1;0;0;1
2975;Giraitė;Meškiukai;27501094616;Ne;11;0;0;11
2976;Giraitė;Meškiukai;5461837332;Ne;0;1;0;1
2977;Giraitė;Meškiukai;1355594003;Ne;4;0;0;4
2978;Giraitė;Meškiukai;1560868105;Ne;1;9;0;10
2979;Giraitė;Meškiukai;1050699551;Ne;0;0;1;1
2980;Giraitė;Meškiukai;9195735923;Ne;7;3;0;10
2981;Giraitė;Meškiukai;65251975467;Ne;20;0;0;20
2982;Giraitė;Meškiukai;1704154980;Ne;0;6;4;10
2983;Giraitė;Meškiukai;1512384599;Ne;0;1;0;1
2984;Giraitė;Meškiukai;2571892050;Ne;0;0;3;3
2985;Giraitė;Meškiukai;1594965200;Ne;0;0;6;6
2986;Giraitė;Meškiukai;9723242940;Ne;10;0;0;10
2987;Giraitė;Meškiukai;5726182600;Ne;0;1;0;1
2988;Giraitė;Meškiukai;1772790396;Ne;1;0;1;2
2989;Giraitė;Meškiukai;2551280794;Ne;0;8;0;8
2990;Giraitė;Uogelės;8908602761;Ne;0;1;0;1
2991;Giraitė;Uogelės;4717851198;Ne;0;0;3;3
2992;Giraitė;Uogelės;1729871315;Ne;0;8;0;8
2993;Giraitė;Uogelės;9503157590;Ne;0;0;4;4
2994;Giraitė;Uogelės;9927102264;Ne;2;0;0;2
2995;Giraitė;Uogelės;4121361794;Ne;0;0;5;5
2996;Giraitė;Uogelės;4843415587;Ne;0;1;0;1
2997;Giraitė;Uogelės;5471577047;Ne;0;1;0;1
2998;Giraitė;Uogelės;2307307454;Ne;2;0;0;2
2999;Giraitė;Uogelės;2102237550;Ne;0;6;0;6
3000;Giraitė;Uogelės;6065010363;Ne;5;0;0;5
3001;Giraitė;Uogelės;5255040944;Ne;0;0;1;1
3002;Giraitė;Uogelės;7094750784;Taip;0;11;0;11
3003;Giraitė;Uogelės;1356340471;Ne;0;0;3;3
3004;Giraitė;Uogelės;7377939409;Ne;12;2;0;14
3005;Giraitė;Uogelės;4288937528;Ne;0;0;4;4
3006;Giraitė;Uogelės;6293111179;Ne;6;2;0;8
3007;Giraitė;Uogelės;7390702355;Ne;5;5;0;10
3008;Giraitė;Šaltinėlis;2076989836;Ne;6;0;0;6
3009;Giraitė;Šaltinėlis;9589760939;Ne;0;0;1;1
3010;Giraitė;Šaltinėlis;4500393769;Ne;0;1;0;1
3011;Giraitė;Šaltinėlis;3144724475;Taip;0;0;3;3
3012;Giraitė;Šaltinėlis;5525538498;Ne;0;0;2;2
3013;Giraitė;Šaltinėlis;4681342624;Ne;4;0;9;13
3014;Giraitė;Šaltinėlis;3108521607;Ne;0;0;3;3
3015;Giraitė;Šaltinėlis;2867735227;Ne;2;0;3;5
3016;Giraitė;Šaltinėlis;9669849051;Ne;0;0;1;1
3017;Giraitė;Boružėlės;8612554184;Ne;1;0;0;1
3018;Giraitė;Boružėlės;2064019596;Ne;0;1;0;1
3019;Giraitė;Boružėlės;7260229442;Ne;0;0;1;1
3020;Giraitė;Boružėlės;1126576745;Ne;1;0;0;1
3021;Giraitė;Boružėlės;1772997796;Ne;0;0;1;1
3022;Giraitė;Boružėlės;9281071794;Ne;0;1;0;1
3023;Giraitė;Boružėlės;9386943162;Ne;0;1;0;1
3024;Giraitė;Boružėlės;4749790368;Ne;4;0;1;5
3025;Giraitė;Boružėlės;3039445733;Ne;8;0;0;8
3026;Giraitė;Boružėlės;4719547384;Ne;1;0;0;1
3027;Giraitė;Boružėlės;4008393576;Ne;0;7;0;7
3028;Giraitė;Gandriukai;4680913596;Ne;1;0;0;1
3029;Giraitė;Gandriukai;3643426944;Ne;0;0;2;2
3030;Giraitė;Gandriukai;8525380061;Ne;2;3;2;7
3031;Giraitė;Gandriukai;4851987149;Ne;1;0;2;3
3032;Giraitė;Gandriukai;2205108811;Ne;0;14;1;15
3033;Giraitė;Gandriukai;7008670489;Ne;0;0;4;4
3034;Giraitė;Gandriukai;7767820565;Ne;0;0;11;11
3035;Giraitė;Gandriukai;8819218663;Ne;1;0;0;1
3036;Giraitė;Gandriukai;7269074498;Ne;5;0;0;5
3037;Giraitė;Gandriukai;1490748887;Ne;0;0;1;1
3038;Giraitė;Gandriukai;7789414361;Ne;6;4;6;16
3039;Giraitė;Gandriukai;9850432917;Ne;18;0;0;18
3040;Giraitė;Gandriukai;2313273738;Ne;5;5;0;10
3041;Giraitė;Gandriukai;9625436756;Ne;4;0;0;4
3042;Giraitė;Gandriukai;8101302584;Ne;16;0;0;16
3043;Giraitė;Gandriukai;9307640828;Ne;0;0;2;2
3044;Giraitė;Gandriukai;3027761044;Ne;0;0;1;1
3045;Giraitė;Gandriukai;1125863541;Taip;2;0;1;3
3046;Giraitė;Gandriukai;4371263826;Ne;6;0;0;6
3047;Giraitė;ŽVIRBLIUKAI;8461725999;Ne;0;0;1;1
3048;Giraitė;ŽVIRBLIUKAI;7395332578;Ne;1;0;1;2
3049;Giraitė;ŽVIRBLIUKAI;5086296808;Ne;6;4;0;10
3050;Giraitė;ŽVIRBLIUKAI;9669916418;Ne;15;0;2;17
3051;Giraitė;ŽVIRBLIUKAI;3481695682;Ne;7;0;1;8
3052;Giraitė;ŽVIRBLIUKAI;7551981095;Ne;0;1;0;1
3053;Giraitė;ŽVIRBLIUKAI;7678134658;Ne;0;0;2;2
3054;Giraitė;ŽVIRBLIUKAI;9471560738;Ne;0;1;0;1
3055;Giraitė;ŽVIRBLIUKAI;7230351549;Ne;0;0;5;5
3056;Giraitė;ŽVIRBLIUKAI;2416162886;Ne;0;6;4;10
3057;Giraitė;ŽVIRBLIUKAI;7543605905;Ne;4;7;0;11
3058;Giraitė;ŽVIRBLIUKAI;4233170371;Ne;6;0;2;8
3059;Giraitė;ŽVIRBLIUKAI;5548434439;Ne;0;0;1;1
3060;Giraitė;ŽVIRBLIUKAI;4450822125;Ne;0;0;1;1
3061;Giraitė;Kiškeliai;5870376620;Ne;14;0;0;14
3062;Giraitė;Kiškeliai;8138768065;Ne;12;0;1;13
3063;Giraitė;Kiškeliai;1227555563;Ne;20;0;0;20
3064;Giraitė;Kiškeliai;3613828494;Ne;5;0;0;5
3065;Giraitė;Kiškeliai;5447466102;Ne;5;2;0;7
3066;Giraitė;Kiškeliai;2686885139;Taip;1;1;0;2
3067;Giraitė;Kiškeliai;9764802294;Ne;2;2;0;4
3068;Giraitė;Kiškeliai;5574589536;Ne;11;0;0;11
3069;Giraitė;Kiškeliai;2726766768;Taip;15;0;0;15
3070;Giraitė;Kiškeliai;6565165993;Ne;7;0;0;7
3071;Giraitė;Kiškeliai;1456726379;Ne;1;0;0;1
3072;Giraitė;Kiškeliai;7392324344;Taip;20;0;0;20
3073;Giraitė;Kiškeliai;7744101334;Ne;5;0;0;5
3074;Gudrutis;Gandriukų;2197278086;Ne;0;2;0;2
3075;Gudrutis;Gandriukų;6358318238;Ne;0;2;0;2
3076;Gudrutis;Gandriukų;7942601528;Ne;0;1;0;1
3077;Gudrutis;Gandriukų;4844838728;Ne;0;2;0;2
3078;Gudrutis;Gandriukų;1685531183;Ne;0;0;1;1
3079;Gudrutis;Gandriukų;9253468183;Ne;9;0;0;9
3080;Gudrutis;Gandriukų;2487363252;Ne;0;1;0;1
3081;Gudrutis;Gandriukų;7663746093;Ne;0;1;3;4
3082;Gudrutis;Gandriukų;1012579870;Ne;0;1;0;1
3083;Gudrutis;Gandriukų;8512130106;Ne;0;2;4;6
3084;Gudrutis;Gandriukų;3919786807;Ne;0;1;3;4
3085;Gudrutis;Gandriukų;8165828215;Ne;5;0;0;5
3086;Gudrutis;Gandriukų;1485530468;Ne;10;0;0;10
3087;Gudrutis;Gandriukų;5508723821;Ne;4;4;0;8
3088;Gudrutis;Gandriukų;9044566825;Taip;3;1;0;4
3089;Gudrutis;Gandriukų;8774935740;Taip;5;1;5;11
3090;Gudrutis;Gandriukų;9297898193;Taip;4;0;0;4
3091;Gudrutis;Gandriukų;9784116399;Taip;0;2;4;6
3092;Gudrutis;"Saulės zuikučių";7934673005;Ne;12;0;1;13
3093;Gudrutis;"Saulės zuikučių";2199222671;Ne;0;0;5;5
3094;Gudrutis;"Saulės zuikučių";1587454709;Ne;0;2;0;2
3095;Gudrutis;"Saulės zuikučių";1670550212;Ne;0;2;0;2
3096;Gudrutis;"Saulės zuikučių";8500911420;Ne;6;2;0;8
3097;Gudrutis;"Saulės zuikučių";5408444872;Ne;0;0;15;15
3098;Gudrutis;"Saulės zuikučių";9041133527;Ne;0;2;0;2
3099;Gudrutis;"Saulės zuikučių";8621229735;Ne;0;0;1;1
3100;Gudrutis;"Saulės zuikučių";8240340213;Ne;0;0;2;2
3101;Gudrutis;"Saulės zuikučių";9697445037;Ne;4;2;0;6
3102;Gudrutis;"Saulės zuikučių";6846653547;Ne;4;0;0;4
3103;Gudrutis;"Saulės zuikučių";3281890659;Ne;0;2;0;2
3104;Gudrutis;"Saulės zuikučių";2291393238;Ne;3;0;5;8
3105;Gudrutis;"Saulės zuikučių";9752360809;Ne;0;1;2;3
3106;Gudrutis;"Saulės zuikučių";5585248878;Ne;5;0;1;6
3107;Gudrutis;"Saulės zuikučių";1384696362;Ne;7;0;0;7
3108;Gudrutis;"Saulės zuikučių";2666772437;Ne;13;0;0;13
3109;Gudrutis;"Saulės zuikučių";2994309084;Ne;0;0;2;2
3110;Gudrutis;Pelėdžiukų;2293472716;Ne;0;0;3;3
3111;Gudrutis;Pelėdžiukų;6835038962;Ne;7;0;3;10
3112;Gudrutis;Pelėdžiukų;2118727861;Ne;1;0;1;2
3113;Gudrutis;Pelėdžiukų;9701111916;Ne;0;0;6;6
3114;Gudrutis;Pelėdžiukų;1725920873;Ne;2;0;4;6
3115;Gudrutis;Pelėdžiukų;1901358996;Ne;0;0;1;1
3116;Gudrutis;Pelėdžiukų;7664517480;Ne;10;0;1;11
3117;Gudrutis;Pelėdžiukų;9847597133;Ne;0;1;0;1
3118;Gudrutis;Pelėdžiukų;3646335609;Ne;0;0;12;12
3119;Gudrutis;Pelėdžiukų;7871991275;Ne;0;0;4;4
3120;Gudrutis;Pelėdžiukų;5580618896;Ne;0;0;4;4
3121;Gudrutis;Pelėdžiukų;3625838131;Ne;0;2;1;3
3122;Gudrutis;Pelėdžiukų;2337493193;Ne;5;0;0;5
3123;Gudrutis;Pelėdžiukų;2408038213;Ne;0;0;1;1
3124;Gudrutis;Pelėdžiukų;7955353991;Ne;0;0;3;3
3125;Gudrutis;Pelėdžiukų;2118820249;Ne;0;0;1;1
3126;Gudrutis;BITUČIŲ;4193661251;Ne;9;1;0;10
3127;Gudrutis;BITUČIŲ;7443277768;Ne;6;0;0;6
3128;Gudrutis;BITUČIŲ;5574287734;Ne;0;0;2;2
3129;Gudrutis;BITUČIŲ;2431077357;Ne;0;1;0;1
3130;Gudrutis;BITUČIŲ;7116979528;Ne;2;1;0;3
3131;Gudrutis;BITUČIŲ;6700254479;Ne;0;0;5;5
3132;Gudrutis;BITUČIŲ;1693306014;Ne;0;0;3;3
3133;Gudrutis;BITUČIŲ;8398961969;Ne;0;2;4;6
3134;Gudrutis;BITUČIŲ;2074151024;Ne;0;1;0;1
3135;Gudrutis;BITUČIŲ;2592224860;Ne;0;2;0;2
3136;Gudrutis;BITUČIŲ;9841172472;Ne;2;1;0;3
3137;Gudrutis;BITUČIŲ;4945755164;Ne;0;0;2;2
3138;Gudrutis;BITUČIŲ;3363824185;Taip;0;0;1;1
3139;Gudrutis;BITUČIŲ;6198012431;Ne;0;2;0;2
3140;Gudrutis;Boružėlių;2497248749;Ne;8;0;2;10
3141;Gudrutis;Boružėlių;6284712576;Ne;4;1;0;5
3142;Gudrutis;Boružėlių;9096764346;Ne;0;1;0;1
3143;Gudrutis;Boružėlių;5306281458;Ne;0;0;13;13
3144;Gudrutis;Boružėlių;8783180638;Ne;0;0;13;13
3145;Gudrutis;Boružėlių;8525851058;Ne;0;0;6;6
3146;Gudrutis;Boružėlių;8080976400;Ne;5;0;0;5
3147;Gudrutis;Boružėlių;9808350750;Ne;3;2;0;5
3148;Gudrutis;Boružėlių;6101410750;Ne;3;1;0;4
3149;Gudrutis;Boružėlių;5710348070;Ne;1;0;11;12
3150;Gudrutis;Boružėlių;8843761360;Ne;1;0;11;12
3151;Gudrutis;Boružėlių;5590297232;Ne;0;0;1;1
3152;Gudrutis;Boružėlių;2145834885;Ne;0;0;17;17
3153;Gudrutis;Boružėlių;2827279258;Ne;5;0;0;5
3154;Gudrutis;Boružėlių;5093267385;Ne;6;3;2;11
3155;Gudrutis;Boružėlių;1364145110;Ne;6;0;1;7
3156;Gudrutis;Boružėlių;1737001982;Ne;6;1;1;8
3157;Gudrutis;Boružėlių;9200644104;Ne;0;0;11;11
3158;Gudrutis;Boružėlių;3797656483;Ne;0;0;11;11
3159;Gudrutis;Drugeliai;7930414623;Ne;0;4;0;4
3160;Gudrutis;Drugeliai;5498218329;Ne;0;1;0;1
3161;Gudrutis;Drugeliai;4600814480;Ne;0;1;0;1
3162;Gudrutis;Drugeliai;9454206104;Ne;1;2;0;3
3163;Gudrutis;Drugeliai;5054363773;Ne;0;2;0;2
3164;Gudrutis;Drugeliai;5931281687;Ne;7;1;0;8
3165;Gudrutis;Drugeliai;3264829331;Ne;0;2;1;3
3166;Gudrutis;Drugeliai;7143849852;Ne;8;0;6;14
3167;Gudrutis;Drugeliai;3760014407;Ne;0;2;0;2
3168;Gudrutis;Drugeliai;1588396018;Ne;0;1;2;3
3169;Gudrutis;Drugeliai;3316297441;Ne;3;1;0;4
3170;Gudrutis;Drugeliai;6307643172;Ne;0;0;7;7
3171;Gudrutis;Drugeliai;2256458624;Ne;0;2;0;2
3172;Gudrutis;Drugeliai;2278368966;Ne;0;0;15;15
3173;Gudrutis;Drugeliai;5911423362;Ne;5;0;1;6
3174;Gudrutis;Drugeliai;3000289515;Ne;1;1;0;2
3175;Gudrutis;Drugeliai;2784392885;Ne;11;5;0;16
3176;Gudrutis;Drugeliai;1170008457;Ne;5;0;0;5
3177;Jovarėlis;KIŠKUČIAI;1199562403;Ne;6;0;0;6
3178;Jovarėlis;KIŠKUČIAI;9704599206;Ne;9;0;0;9
3179;Jovarėlis;KIŠKUČIAI;6005722593;Ne;13;0;0;13
3180;Jovarėlis;KIŠKUČIAI;7558562002;Ne;12;0;0;12
3181;Jovarėlis;KIŠKUČIAI;8970192705;Ne;11;0;0;11
3182;Jovarėlis;DRUGELIAI;5201342733;Ne;5;0;0;5
3183;Jovarėlis;DRUGELIAI;5724777390;Ne;13;0;0;13
3184;Jovarėlis;DRUGELIAI;9989762395;Taip;9;0;0;9
3185;Jovarėlis;DRUGELIAI;2143481971;Taip;4;0;0;4
3186;Jovarėlis;DRUGELIAI;5619816900;Taip;11;0;0;11
3187;Jovarėlis;VOVERIUKAI;9329253682;Ne;9;0;0;9
3188;Jovarėlis;VOVERIUKAI;8423578580;Ne;3;0;0;3
3189;Jovarėlis;VOVERIUKAI;8200193975;Ne;1;0;0;1
3190;Jovarėlis;BITUTĖS;3349703664;Ne;10;0;0;10
3191;Jovarėlis;BITUTĖS;7437121728;Ne;9;0;0;9
3192;Jovarėlis;NYKŠTUKAI;7301592301;Ne;19;0;0;19
3193;Jovarėlis;NYKŠTUKAI;7381074763;Taip;13;0;0;13
3194;Jovarėlis;NYKŠTUKAI;1313937710;Ne;5;0;0;5
3195;Jovarėlis;NYKŠTUKAI;7194183817;Ne;12;0;0;12
3196;Jovarėlis;BORUŽĖLĖS;9366125740;Ne;2;0;0;2
3197;Jovarėlis;BORUŽĖLĖS;1222366115;Ne;4;0;0;4
3198;Jovarėlis;BORUŽĖLĖS;6249596318;Ne;5;0;0;5
3199;Jovarėlis;BORUŽĖLĖS;2781556241;Ne;1;0;0;1
3200;Jovarėlis;BORUŽĖLĖS;6303503283;Ne;4;0;0;4
3201;Jovarėlis;ŽIRNIUKAI;7534586762;Ne;6;0;0;6
3202;Jovarėlis;ŽIRNIUKAI;2848496566;Ne;2;0;0;2
3203;Jovarėlis;ŽIRNIUKAI;6005337326;Ne;10;0;0;10
3204;Jovarėlis;ŽIRNIUKAI;5138609373;Ne;6;0;0;6
3205;Jovarėlis;ŽIRNIUKAI;4055410462;Ne;5;0;0;5
3206;Jovarėlis;MEŠKUČIAI;4234563788;Taip;11;0;0;11
3207;Jovarėlis;MEŠKUČIAI;6551379627;Ne;12;0;0;12
3208;Jovarėlis;MEŠKUČIAI;1054238143;Ne;2;0;0;2
3209;Jovarėlis;MEŠKUČIAI;8285597164;Ne;5;0;0;5
3210;Jovarėlis;OBUOLIUKAI;4455462093;Ne;10;0;0;10
3211;Jovarėlis;OBUOLIUKAI;8470832744;Ne;3;0;0;3
3212;Jovarėlis;SKRUZDĖLIUKAI;1038855467;Ne;6;0;0;6
3213;Jovarėlis;KATINĖLIAI;4546573044;Ne;3;0;0;3
3214;Jovarėlis;KATINĖLIAI;3557348554;Ne;15;0;0;15
3215;Jovarėlis;PELĖDŽIUKAI;5646434388;Ne;8;0;0;8
3216;Jovarėlis;PELĖDŽIUKAI;2723487680;Ne;10;0;0;10
3217;Jovarėlis;PELĖDŽIUKAI;4773542772;Ne;9;0;0;9
3218;Jovarėlis;PELĖDŽIUKAI;6406866195;Ne;5;0;0;5
3219;Jurginėlis;Ąžuoliukai;7309052653;Ne;0;20;0;20
3220;Jurginėlis;Ąžuoliukai;2501462080;Ne;0;0;1;1
3221;Jurginėlis;Ąžuoliukai;6168508647;Ne;12;0;2;14
3222;Jurginėlis;Ąžuoliukai;3933113321;Ne;0;13;0;13
3223;Jurginėlis;Ąžuoliukai;5861418459;Ne;14;2;0;16
3224;Jurginėlis;Ąžuoliukai;3562210465;Ne;0;0;1;1
3225;Jurginėlis;Ąžuoliukai;6202225321;Ne;6;0;0;6
3226;Jurginėlis;Ąžuoliukai;7081618073;Ne;2;2;0;4
3227;Jurginėlis;Ąžuoliukai;6851855147;Ne;0;0;1;1
3228;Jurginėlis;Ąžuoliukai;9029587175;Ne;0;1;0;1
3229;Jurginėlis;Ąžuoliukai;9889620429;Ne;0;1;0;1
3230;Jurginėlis;Ąžuoliukai;3324811458;Ne;2;2;0;4
3231;Jurginėlis;Ąžuoliukai;6153432639;Ne;9;0;0;9
3232;Jurginėlis;Ąžuoliukai;9850874714;Ne;0;0;1;1
3233;Jurginėlis;Ąžuoliukai;8174251359;Ne;0;0;3;3
3234;Jurginėlis;Ąžuoliukai;2447025385;Ne;14;0;1;15
3235;Jurginėlis;Ąžuoliukai;5313627252;Ne;1;0;4;5
3236;Jurginėlis;Žiogeliai;8159210242;Ne;6;15;0;21
3237;Jurginėlis;Žiogeliai;9934831745;Taip;11;5;0;16
3238;Jurginėlis;Žiogeliai;7251598691;Ne;0;8;0;8
3239;Jurginėlis;Žiogeliai;3083045137;Ne;0;13;1;14
3240;Jurginėlis;Žiogeliai;6906225772;Ne;0;10;0;10
3241;Jurginėlis;Žiogeliai;7010130915;Ne;0;0;1;1
3242;Jurginėlis;Žiogeliai;7907096012;Ne;15;0;0;15
3243;Jurginėlis;Žiogeliai;7250246853;Ne;0;3;0;3
3244;Jurginėlis;Žiogeliai;5160581631;Ne;3;0;0;3
3245;Jurginėlis;Žiogeliai;6438669072;Ne;0;0;6;6
3246;Jurginėlis;Žiogeliai;5037980414;Ne;0;2;1;3
3247;Jurginėlis;Žiogeliai;7300018733;Ne;0;2;0;2
3248;Jurginėlis;Žiogeliai;4674128568;Ne;0;14;0;14
3249;Jurginėlis;Žiogeliai;9305884152;Ne;12;4;6;22
3250;Jurginėlis;Žiogeliai;9716328349;Ne;0;32;0;32
3251;Jurginėlis;Žiogeliai;4441183185;Ne;6;0;0;6
3252;Jurginėlis;Žiogeliai;4502564783;Ne;12;1;0;13
3253;Jurginėlis;Žiogeliai;1937927553;Ne;0;0;3;3
3254;Jurginėlis;Žiogeliai;7527178332;Ne;9;0;0;9
3255;Jurginėlis;Žiogeliai;4682125116;Ne;1;4;0;5
3256;Jurginėlis;Žiogeliai;3920971621;Ne;13;2;0;15
3257;Jurginėlis;Pelėdžiukų;5984893389;Ne;0;1;0;1
3258;Jurginėlis;Pelėdžiukų;3079495897;Ne;8;3;0;11
3259;Jurginėlis;Pelėdžiukų;8727844649;Ne;8;0;6;14
3260;Jurginėlis;Pelėdžiukų;1455749921;Ne;14;2;0;16
3261;Jurginėlis;Pelėdžiukų;2417314519;Ne;0;2;0;2
3262;Jurginėlis;Pelėdžiukų;6968528293;Ne;0;1;0;1
3263;Jurginėlis;Pelėdžiukų;4292932046;Ne;1;0;0;1
3264;Jurginėlis;Pelėdžiukų;9507571301;Ne;0;2;0;2
3265;Jurginėlis;Pelėdžiukų;8779807396;Ne;6;0;0;6
3266;Jurginėlis;Pelėdžiukų;8443412187;Ne;0;2;2;4
3267;Jurginėlis;Pelėdžiukų;4967548277;Ne;15;2;0;17
3268;Jurginėlis;Pelėdžiukų;2925253653;Ne;0;5;0;5
3269;Jurginėlis;Pelėdžiukų;1340689348;Ne;0;5;0;5
3270;Jurginėlis;Pelėdžiukų;2221708420;Ne;0;7;0;7
3271;Jurginėlis;Pelėdžiukų;6181547354;Ne;0;20;0;20
3272;Jurginėlis;Pelėdžiukų;9760394658;Ne;0;0;8;8
3273;Jurginėlis;Pelėdžiukų;3786379532;Ne;12;1;0;13
3274;Jurginėlis;Boružėlių;4295285885;Ne;5;0;0;5
3275;Jurginėlis;Boružėlių;8920304044;Ne;0;4;0;4
3276;Jurginėlis;Boružėlių;3027573572;Ne;18;1;0;19
3277;Jurginėlis;Boružėlių;1758862051;Ne;0;1;0;1
3278;Jurginėlis;Boružėlių;1467200002;Ne;5;6;0;11
3279;Jurginėlis;Boružėlių;6111863896;Ne;0;9;0;9
3280;Jurginėlis;Boružėlių;1701720412;Ne;0;1;0;1
3281;Jurginėlis;Boružėlių;1563317396;Ne;0;2;0;2
3282;Jurginėlis;Boružėlių;2133447073;Ne;0;1;0;1
3283;Jurginėlis;Boružėlių;8784076886;Ne;1;0;0;1
3284;Jurginėlis;Boružėlių;2446630485;Ne;5;1;0;6
3285;Jurginėlis;Boružėlių;1829089083;Ne;0;1;0;1
3286;Jurginėlis;Boružėlių;5386710069;Ne;2;5;0;7
3287;Jurginėlis;Boružėlių;7753784918;Ne;0;20;0;20
3288;Jurginėlis;Bitučių;9589394406;Ne;10;0;1;11
3289;Jurginėlis;Bitučių;3708774681;Ne;0;0;8;8
3290;Jurginėlis;Bitučių;6413324051;Ne;0;2;0;2
3291;Jurginėlis;Bitučių;2639125463;Ne;1;0;0;1
3292;Jurginėlis;Bitučių;7297672386;Ne;2;0;1;3
3293;Jurginėlis;Bitučių;1586599624;Ne;0;0;2;2
3294;Jurginėlis;Bitučių;1175441410;Ne;0;3;0;3
3295;Jurginėlis;Bitučių;1082593212;Ne;0;1;0;1
3296;Jurginėlis;Bitučių;4806248290;Ne;0;2;0;2
3297;Jurginėlis;Bitučių;9646318532;Ne;0;1;0;1
3298;Jurginėlis;Bitučių;8227660508;Ne;5;0;6;11
3299;Jurginėlis;Bitučių;77480957625;Ne;1;0;1;2
3300;Jurginėlis;Bitučių;2624313807;Ne;2;0;0;2
3301;Jurginėlis;Bitučių;5892180334;Ne;1;0;0;1
3302;Jurginėlis;Bitučių;3018576350;Ne;15;0;1;16
3303;Jurginėlis;Skruzdeliukų;1351306981;Ne;9;0;0;9
3304;Jurginėlis;Skruzdeliukų;3558752347;Ne;0;6;0;6
3305;Jurginėlis;Skruzdeliukų;5734506036;Ne;5;1;0;6
3306;Jurginėlis;Skruzdeliukų;3699180485;Ne;6;3;0;9
3307;Jurginėlis;Skruzdeliukų;4981043400;Ne;6;0;0;6
3308;Jurginėlis;Skruzdeliukų;1763849354;Ne;0;0;2;2
3309;Jurginėlis;Skruzdeliukų;4944292549;Ne;0;5;0;5
3310;Jurginėlis;Skruzdeliukų;9506129699;Ne;15;0;0;15
3311;Jurginėlis;Skruzdeliukų;9550110246;Ne;4;0;0;4
3312;Jurginėlis;Skruzdeliukų;3822916547;Ne;7;1;0;8
3313;Jurginėlis;Skruzdeliukų;1204999684;Ne;12;0;0;12
3314;Jurginėlis;Skruzdeliukų;9937405742;Ne;21;0;0;21
3315;Jurginėlis;Skruzdeliukų;1726968598;Ne;0;15;0;15
3316;Jurginėlis;Skruzdeliukų;2332714713;Ne;13;0;0;13
3317;Jurginėlis;Skruzdeliukų;9961083854;Ne;0;5;0;5
3318;Jurginėlis;Skruzdeliukų;6542567172;Ne;14;3;0;17
3319;Jurginėlis;Drugelių;2025403481;Ne;0;0;3;3
3320;Jurginėlis;Drugelių;9065349248;Ne;0;0;1;1
3321;Jurginėlis;Drugelių;8341951659;Ne;0;5;0;5
3322;Jurginėlis;Drugelių;7795042485;Taip;7;0;6;13
3323;Jurginėlis;Drugelių;5138832895;Ne;1;0;0;1
3324;Jurginėlis;Drugelių;5751977493;Taip;6;2;0;8
3325;Jurginėlis;Drugelių;6068645621;Taip;10;5;0;15
3326;Jurginėlis;Drugelių;4276237094;Ne;14;0;0;14
3327;Jurginėlis;Drugelių;3527520303;Ne;5;0;1;6
3328;Jurginėlis;Drugelių;9736737788;Ne;0;0;2;2
3329;Jurginėlis;Drugelių;1208882528;Ne;4;0;0;4
3330;Jurginėlis;Drugelių;5874949368;Ne;10;0;0;10
3331;Jurginėlis;Drugelių;3063084253;Ne;13;0;0;13
3332;Jurginėlis;Drugelių;7409019574;Ne;15;2;0;17
3333;Jurginėlis;Drugelių;5928303681;Ne;0;20;0;20
3334;Jurginėlis;Žibučių;4979618298;Ne;4;0;0;4
3335;Jurginėlis;Žibučių;6636147085;Ne;3;0;0;3
3336;Jurginėlis;Žibučių;1438159631;Ne;3;2;0;5
3337;Jurginėlis;Žibučių;1336429135;Ne;10;0;0;10
3338;Jurginėlis;Žibučių;6948834218;Ne;0;0;3;3
3339;Jurginėlis;Žibučių;7721612113;Ne;0;1;0;1
3340;Jurginėlis;Žibučių;8111158692;Ne;0;1;0;1
3341;Jurginėlis;Žibučių;5936508522;Ne;6;11;0;17
3342;Jurginėlis;Žibučių;6717892969;Ne;6;1;0;7
3343;Jurginėlis;Žibučių;7977676733;Ne;9;0;0;9
3344;Jurginėlis;Žibučių;3899526893;Ne;0;2;2;4
3345;Jurginėlis;Žibučių;3861311860;Ne;5;0;0;5
3346;Jurginėlis;Žibučių;1263601087;Ne;0;7;0;7
3347;Jurginėlis;Žibučių;5549766339;Ne;0;2;0;2
3348;Jurginėlis;Žibučių;4429780802;Ne;0;8;0;8
3349;Jurginėlis;Žibučių;8968718021;Ne;15;0;0;15
3350;Jurginėlis;Žibučių;2782553941;Ne;17;0;0;17
3351;Jurginėlis;Žibučių;6259461257;Ne;5;0;3;8
3352;Jurginėlis;Žibučių;7252041334;Ne;9;1;1;11
3353;Jurginėlis;Zuikučių;5958832413;Ne;5;1;0;6
3354;Jurginėlis;Zuikučių;6587382160;Ne;0;0;3;3
3355;Jurginėlis;Zuikučių;4763313715;Ne;12;0;1;13
3356;Jurginėlis;Zuikučių;6671759364;Ne;5;0;0;5
3357;Jurginėlis;Zuikučių;8937404520;Ne;0;0;1;1
3358;Jurginėlis;Zuikučių;2820249307;Ne;9;0;0;9
3359;Jurginėlis;Zuikučių;8823175066;Ne;0;0;1;1
3360;Jurginėlis;Zuikučių;8161347781;Ne;0;5;0;5
3361;Jurginėlis;Zuikučių;7283697595;Ne;4;0;1;5
3362;Jurginėlis;Zuikučių;4113264904;Ne;2;0;0;2
3363;Jurginėlis;Zuikučių;8117563141;Ne;0;2;2;4
3364;Jurginėlis;Zuikučių;5652597514;Ne;5;0;0;5
3365;Jurginėlis;Zuikučių;6341896288;Ne;5;0;0;5
3366;Jurginėlis;Zuikučių;4180071775;Ne;6;0;0;6
3367;Jurginėlis;Viščiukų;7193314762;Ne;5;0;3;8
3368;Jurginėlis;Viščiukų;6306274502;Taip;0;2;0;2
3369;Jurginėlis;Viščiukų;4506484183;Ne;1;0;0;1
3370;Jurginėlis;Viščiukų;5474358669;Ne;0;32;0;32
3371;Jurginėlis;Viščiukų;2595002682;Ne;8;0;0;8
3372;Jurginėlis;Viščiukų;5866358319;Taip;1;0;5;6
3373;Jurginėlis;Viščiukų;1598578487;Ne;0;6;0;6
3374;Jurginėlis;Viščiukų;4644476606;Ne;10;0;0;10
3375;Jurginėlis;Viščiukų;3230200231;Ne;0;3;0;3
3376;Jurginėlis;Viščiukų;7636442845;Ne;0;0;9;9
3377;Jurginėlis;Viščiukų;1286603999;Ne;6;0;2;8
3378;Jurginėlis;Viščiukų;4617952912;Ne;8;0;0;8
3379;Jurginėlis;Viščiukų;9603380131;Ne;12;0;3;15
3380;Jurginėlis;Meškiukų;4466955830;Ne;6;1;5;12
3381;Jurginėlis;Meškiukų;6932501634;Ne;1;0;0;1
3382;Jurginėlis;Meškiukų;2248773321;Ne;1;0;0;1
3383;Jurginėlis;Meškiukų;3675820817;Ne;18;0;1;19
3384;Jurginėlis;Meškiukų;6285599044;Ne;25;0;2;27
3385;Jurginėlis;Meškiukų;5043815909;Ne;0;0;3;3
3386;Jurginėlis;Meškiukų;9901171406;Ne;5;0;0;5
3387;Jurginėlis;Meškiukų;2982526236;Ne;0;2;0;2
3388;Jurginėlis;Meškiukų;4233910766;Ne;5;3;1;9
3389;Jurginėlis;Meškiukų;1537710974;Ne;23;2;0;25
3390;Jurginėlis;Meškiukų;6594025023;Ne;7;2;0;9
3391;Jurginėlis;Meškiukų;3573167647;Ne;6;0;1;7
3392;Jurginėlis;Meškiukų;6648657850;Ne;9;0;0;9
3393;Jurginėlis;Meškiukų;6856023398;Ne;13;0;3;16
3394;Jurginėlis;Gandriukų;8017976529;Ne;6;0;0;6
3395;Jurginėlis;Gandriukų;3530906368;Ne;0;0;3;3
3396;Jurginėlis;Gandriukų;6806704355;Ne;4;0;0;4
3397;Jurginėlis;Gandriukų;9288380246;Ne;3;0;6;9
3398;Jurginėlis;Gandriukų;2548920722;Ne;9;3;2;14
3399;Jurginėlis;Gandriukų;7288921301;Ne;6;0;3;9
3400;Jurginėlis;Gandriukų;4827340942;Ne;1;0;1;2
3401;Jurginėlis;Gandriukų;4463258777;Ne;3;0;2;5
3402;Jurginėlis;Gandriukų;1414888906;Ne;0;0;1;1
3403;Jurginėlis;Gandriukų;2225892248;Ne;0;0;1;1
3404;Jurginėlis;Gandriukų;6579565337;Ne;0;0;4;4
3405;Jurginėlis;Gandriukų;7990015623;Ne;0;1;0;1
3406;Jurginėlis;Gandriukų;4158502752;Ne;0;2;0;2
3407;Jurginėlis;Gandriukų;2214809186;Ne;0;0;1;1
3408;Jurginėlis;Gandriukų;3284464951;Ne;0;21;0;21
3409;Jurginėlis;Gandriukų;2263818210;Ne;0;1;0;1
3410;Jurginėlis;Gandriukų;3091019969;Taip;10;0;0;10
3411;Jurginėlis;Gandriukų;2837099502;Ne;0;0;1;1
3412;Jurginėlis;Gandriukų;3462969423;Ne;0;1;0;1
3413;Jurginėlis;Gandriukų;7486778826;Ne;1;4;0;5
3414;Jurginėlis;Gandriukų;5242359650;Taip;0;6;0;6
3415;Jurginėlis;Gandriukų;8144038013;Ne;0;6;0;6
3416;Karuselė;PAGRANDUKAS;1621482372;Ne;0;9;0;9
3417;Karuselė;PAGRANDUKAS;3330374479;Ne;11;0;0;11
3418;Karuselė;PAGRANDUKAS;6183785840;Ne;1;4;0;5
3419;Karuselė;PAGRANDUKAS;3984262482;Ne;0;0;2;2
3420;Karuselė;PAGRANDUKAS;9130534156;Ne;7;0;0;7
3421;Karuselė;PAGRANDUKAS;3660843696;Ne;5;0;0;5
3422;Karuselė;PAGRANDUKAS;5132581245;Ne;0;3;0;3
3423;Karuselė;PAGRANDUKAS;2412418335;Ne;12;0;0;12
3424;Karuselė;PAGRANDUKAS;7393434659;Ne;4;0;0;4
3425;Karuselė;PAGRANDUKAS;5695697634;Ne;0;2;0;2
3426;Karuselė;PAGRANDUKAS;7013765804;Ne;0;8;0;8
3427;Karuselė;PAGRANDUKAS;3429495073;Ne;0;2;0;2
3428;Karuselė;PAGRANDUKAS;6252613489;Ne;4;5;0;9
3429;Karuselė;PAGRANDUKAS;5595950213;Ne;9;0;0;9
3430;Karuselė;PAGRANDUKAS;6004882312;Ne;16;0;0;16
3431;Karuselė;PAGRANDUKAS;5028265234;Taip;14;0;0;14
3432;Karuselė;PAGRANDUKAS;3972815393;Ne;7;0;0;7
3433;Karuselė;PAGRANDUKAS;8157193503;Ne;3;5;0;8
3434;Karuselė;PAGRANDUKAS;8656806219;Taip;18;0;0;18
3435;Karuselė;PAGRANDUKAS;9651192437;Ne;6;0;0;6
3436;Karuselė;NYKŠTUKAS;4966362343;Ne;9;0;1;10
3437;Karuselė;NYKŠTUKAS;9997776739;Ne;0;10;0;10
3438;Karuselė;NYKŠTUKAS;4445214427;Ne;0;9;0;9
3439;Karuselė;NYKŠTUKAS;9354431582;Ne;0;6;0;6
3440;Karuselė;NYKŠTUKAS;5216815933;Ne;6;2;0;8
3441;Karuselė;NYKŠTUKAS;7817417459;Ne;6;2;0;8
3442;Karuselė;NYKŠTUKAS;9654804545;Ne;0;11;0;11
3443;Karuselė;NYKŠTUKAS;6581798125;Ne;4;1;0;5
3444;Karuselė;NYKŠTUKAS;1486577955;Ne;8;1;1;10
3445;Karuselė;NYKŠTUKAS;5697305819;Taip;0;1;0;1
3446;Karuselė;NYKŠTUKAS;8007341411;Ne;6;2;0;8
3447;Karuselė;NYKŠTUKAS;4296509304;Ne;0;2;0;2
3448;Karuselė;NYKŠTUKAS;9243932017;Ne;0;2;2;4
3449;Karuselė;NYKŠTUKAS;5986973796;Ne;13;0;0;13
3450;Karuselė;NYKŠTUKAS;4856589410;Ne;0;2;0;2
3451;Karuselė;NYKŠTUKAS;9999461542;Ne;15;0;0;15
3452;Karuselė;NYKŠTUKAS;9385698812;Ne;10;3;0;13
3453;Karuselė;NYKŠTUKAS;5328762735;Ne;10;0;0;10
3454;Karuselė;BITUTĖ;1593728369;Ne;6;0;0;6
3455;Karuselė;BITUTĖ;6417699445;Ne;0;3;0;3
3456;Karuselė;BITUTĖ;2426822679;Ne;0;2;0;2
3457;Karuselė;BITUTĖ;1205498782;Ne;5;3;0;8
3458;Karuselė;BITUTĖ;7824913364;Ne;7;0;0;7
3459;Karuselė;BITUTĖ;5960946826;Ne;0;2;0;2
3460;Karuselė;BITUTĖ;8175498192;Ne;5;0;0;5
3461;Karuselė;BITUTĖ;5951045233;Ne;3;2;2;7
3462;Karuselė;BITUTĖ;1487641646;Ne;5;2;0;7
3463;Karuselė;BITUTĖ;6692345915;Ne;0;1;0;1
3464;Karuselė;BITUTĖ;1211005513;Ne;0;1;4;5
3465;Karuselė;BITUTĖ;2160071272;Ne;1;2;2;5
3466;Karuselė;BITUTĖ;1691769088;Ne;0;6;0;6
3467;Karuselė;BITUTĖ;7167895711;Ne;0;6;0;6
3468;Karuselė;BITUTĖ;3116403256;Ne;1;1;0;2
3469;Karuselė;BITUTĖ;7977133699;Taip;4;1;0;5
3470;Karuselė;BITUTĖ;1204919995;Ne;0;0;20;20
3471;Karuselė;BORUŽĖLĖ;1705790474;Ne;0;2;0;2
3472;Karuselė;BORUŽĖLĖ;8608177987;Ne;0;4;0;4
3473;Karuselė;BORUŽĖLĖ;1311907441;Ne;4;0;0;4
3474;Karuselė;BORUŽĖLĖ;6313010762;Ne;6;1;0;7
3475;Karuselė;BORUŽĖLĖ;5859827168;Ne;6;1;0;7
3476;Karuselė;BORUŽĖLĖ;37349219339;Ne;0;1;1;2
3477;Karuselė;BORUŽĖLĖ;6811862463;Ne;0;7;0;7
3478;Karuselė;BORUŽĖLĖ;5471989295;Ne;11;2;0;13
3479;Karuselė;BORUŽĖLĖ;9753876554;Ne;4;0;2;6
3480;Karuselė;BORUŽĖLĖ;8717484092;Ne;9;0;2;11
3481;Karuselė;BORUŽĖLĖ;1994682683;Ne;1;1;0;2
3482;Karuselė;BORUŽĖLĖ;5632697184;Ne;0;1;2;3
3483;Karuselė;BORUŽĖLĖ;2247913568;Ne;4;1;1;6
3484;Karuselė;BORUŽĖLĖ;4262640017;Ne;4;0;0;4
3485;Karuselė;BORUŽĖLĖ;4845558814;Ne;11;7;0;18
3486;Karuselė;BORUŽĖLĖ;8406462155;Ne;0;1;0;1
3487;Karuselė;BORUŽĖLĖ;1183484176;Ne;4;0;1;5
3488;Karuselė;BORUŽĖLĖ;3389843421;Ne;7;3;0;10
3489;Karuselė;BORUŽĖLĖ;4818655110;Ne;8;0;0;8
3490;Karuselė;UOGELĖ;9805481603;Ne;5;0;0;5
3491;Karuselė;UOGELĖ;8182071103;Ne;10;2;0;12
3492;Karuselė;UOGELĖ;9992989896;Ne;4;5;0;9
3493;Karuselė;UOGELĖ;2084276906;Ne;4;2;0;6
3494;Karuselė;UOGELĖ;8665314366;Ne;10;6;0;16
3495;Karuselė;UOGELĖ;8316147204;Ne;0;2;0;2
3496;Karuselė;UOGELĖ;5504719953;Ne;0;15;0;15
3497;Karuselė;UOGELĖ;5919009583;Ne;20;0;0;20
3498;Karuselė;UOGELĖ;4199597984;Ne;6;2;0;8
3499;Karuselė;UOGELĖ;2383023280;Ne;11;2;0;13
3500;Karuselė;UOGELĖ;1575408822;Ne;2;1;1;4
3501;Karuselė;UOGELĖ;3917113787;Ne;0;1;0;1
3502;Karuselė;UOGELĖ;4638918427;Ne;0;2;0;2
3503;Karuselė;UOGELĖ;3615957761;Ne;15;5;0;20
3504;Karuselė;UOGELĖ;3514026443;Ne;4;0;0;4
3505;Karuselė;UOGELĖ;1891147022;Ne;0;0;2;2
3506;Karuselė;UOGELĖ;9389017016;Ne;4;1;0;5
3507;Karuselė;UOGELĖ;3963576314;Ne;0;0;4;4
3508;Karuselė;GINTARĖLIS;3773170060;Ne;5;4;0;9
3509;Karuselė;GINTARĖLIS;3904453423;Ne;1;0;6;7
3510;Karuselė;GINTARĖLIS;7489136297;Ne;1;2;0;3
3511;Karuselė;GINTARĖLIS;3534074990;Ne;2;1;7;10
3512;Karuselė;GINTARĖLIS;7540323186;Ne;6;0;2;8
3513;Karuselė;GINTARĖLIS;1019322763;Ne;10;0;2;12
3514;Karuselė;GINTARĖLIS;8481143199;Ne;0;4;0;4
3515;Karuselė;GINTARĖLIS;3157893936;Ne;0;1;1;2
3516;Karuselė;GINTARĖLIS;8409412605;Ne;6;10;1;17
3517;Karuselė;GINTARĖLIS;3136606610;Ne;4;6;0;10
3518;Karuselė;GINTARĖLIS;7599328323;Ne;4;0;0;4
3519;Karuselė;GINTARĖLIS;2688863117;Ne;6;2;0;8
3520;Karuselė;GINTARĖLIS;7439791054;Ne;17;0;0;17
3521;Karuselė;GINTARĖLIS;3696384277;Ne;0;1;0;1
3522;Karuselė;GINTARĖLIS;2945027875;Ne;4;0;1;5
3523;Karuselė;GINTARĖLIS;8855096080;Ne;0;0;2;2
3524;Karuselė;GINTARĖLIS;9116238924;Ne;12;0;3;15
3525;Karuselė;GINTARĖLIS;6433987745;Ne;0;0;4;4
3526;Karuselė;GINTARĖLIS;9479962436;Taip;8;0;0;8
3527;Karuselė;GINTARĖLIS;6232570825;Ne;0;0;1;1
3528;Karuselė;GINTARĖLIS;3460470459;Ne;2;6;0;8
3529;Karuselė;SAULUTĖ;5627583683;Ne;10;1;0;11
3530;Karuselė;SAULUTĖ;2242659064;Ne;1;12;0;13
3531;Karuselė;SAULUTĖ;5704218177;Ne;0;1;0;1
3532;Karuselė;SAULUTĖ;5146709341;Ne;0;1;3;4
3533;Karuselė;SAULUTĖ;9996567374;Ne;0;5;0;5
3534;Karuselė;SAULUTĖ;9400171357;Ne;0;1;0;1
3535;Karuselė;SAULUTĖ;5766390337;Ne;0;2;0;2
3536;Karuselė;SAULUTĖ;4879654321;Ne;0;2;0;2
3537;Karuselė;SAULUTĖ;5803808409;Ne;0;2;0;2
3538;Karuselė;SAULUTĖ;3149575456;Ne;5;0;1;6
3539;Karuselė;SAULUTĖ;5640656442;Ne;7;1;2;10
3540;Karuselė;SAULUTĖ;9451789237;Ne;10;3;0;13
3541;Karuselė;SAULUTĖ;9450841251;Ne;6;1;3;10
3542;Karuselė;SAULUTĖ;6338379641;Ne;11;0;0;11
3543;Karuselė;SAULUTĖ;8830559511;Ne;11;0;0;11
3544;Karuselė;SAULUTĖ;3228100488;Ne;8;0;0;8
3545;Karuselė;TIGRIUKAS;8946147763;Ne;0;5;0;5
3546;Karuselė;TIGRIUKAS;8076851284;Ne;7;1;0;8
3547;Karuselė;TIGRIUKAS;4426462711;Ne;2;0;0;2
3548;Karuselė;TIGRIUKAS;9484773068;Ne;8;0;0;8
3549;Karuselė;TIGRIUKAS;8678437720;Taip;0;1;0;1
3550;Karuselė;TIGRIUKAS;1698478530;Taip;4;2;0;6
3551;Karuselė;TIGRIUKAS;9561892809;Ne;8;0;0;8
3552;Karuselė;TIGRIUKAS;9726299722;Ne;0;1;0;1
3553;Karuselė;TIGRIUKAS;1576201225;Ne;6;3;0;9
3554;Karuselė;TIGRIUKAS;9344514262;Ne;20;0;0;20
3555;Karuselė;TIGRIUKAS;9065247151;Ne;8;0;0;8
3556;Karuselė;TIGRIUKAS;7131255599;Ne;14;2;0;16
3557;Karuselė;TIGRIUKAS;4180604225;Ne;14;2;0;16
3558;Karuselė;TIGRIUKAS;2397938004;Ne;0;1;0;1
3559;Karuselė;TIGRIUKAS;3605966015;Ne;4;0;0;4
3560;Karuselė;TIGRIUKAS;9633656827;Ne;0;1;0;1
3561;Karuselė;TIGRIUKAS;9252093125;Ne;12;0;0;12
3562;Karuselė;TIGRIUKAS;5176597751;Ne;7;1;0;8
3563;Karuselė;TIGRIUKAS;6656808100;Ne;0;1;0;1
3564;Karuselė;VAIVORYKŠTĖ;1289442716;Ne;7;0;2;9
3565;Karuselė;VAIVORYKŠTĖ;9855242602;Ne;7;1;0;8
3566;Karuselė;VAIVORYKŠTĖ;6546648346;Ne;0;10;0;10
3567;Karuselė;VAIVORYKŠTĖ;8063412271;Ne;11;0;0;11
3568;Karuselė;VAIVORYKŠTĖ;9408843254;Ne;7;0;0;7
3569;Karuselė;VAIVORYKŠTĖ;3514315636;Ne;0;0;4;4
3570;Karuselė;VAIVORYKŠTĖ;8085919723;Ne;0;0;4;4
3571;Karuselė;VAIVORYKŠTĖ;5444753290;Ne;2;3;0;5
3572;Karuselė;VAIVORYKŠTĖ;1581504806;Ne;6;0;1;7
3573;Karuselė;VAIVORYKŠTĖ;2215367063;Ne;13;0;0;13
3574;Karuselė;VAIVORYKŠTĖ;6424622497;Ne;0;1;2;3
3575;Karuselė;VAIVORYKŠTĖ;5855430678;Ne;0;2;0;2
3576;Karuselė;VAIVORYKŠTĖ;5128774216;Ne;1;0;0;1
3577;Karuselė;VAIVORYKŠTĖ;2757263085;Ne;2;1;0;3
3578;Karuselė;VAIVORYKŠTĖ;4110024673;Ne;0;6;0;6
3579;Karuselė;VAIVORYKŠTĖ;6444553698;Ne;12;0;1;13
3580;Karuselė;VAIVORYKŠTĖ;9400856559;Ne;0;7;0;7
3581;Karuselė;VAIVORYKŠTĖ;1083786182;Ne;0;7;0;7
3582;Karuselė;VAIVORYKŠTĖ;5998868204;Ne;0;1;0;1
3583;Karuselė;VAIVORYKŠTĖ;6734936247;Ne;0;9;0;9
3584;Karuselė;VAIVORYKŠTĖ;3082636224;Ne;0;1;2;3
3585;Karuselė;"AUKSINĖ ŽUVELĖ";2993499990;Ne;1;0;8;9
3586;Karuselė;"AUKSINĖ ŽUVELĖ";8671884362;Ne;5;1;0;6
3587;Karuselė;"AUKSINĖ ŽUVELĖ";6341570221;Ne;0;0;10;10
3588;Karuselė;"AUKSINĖ ŽUVELĖ";2135332292;Ne;2;9;0;11
3589;Karuselė;"AUKSINĖ ŽUVELĖ";8441520423;Ne;4;0;3;7
3590;Karuselė;"AUKSINĖ ŽUVELĖ";9463553056;Ne;0;10;0;10
3591;Karuselė;"AUKSINĖ ŽUVELĖ";4566201460;Ne;5;0;3;8
3592;Karuselė;"AUKSINĖ ŽUVELĖ";3551143062;Ne;5;0;1;6
3593;Karuselė;"AUKSINĖ ŽUVELĖ";8257771271;Ne;7;5;0;12
3594;Karuselė;"AUKSINĖ ŽUVELĖ";7749015193;Ne;0;5;0;5
3595;Karuselė;"AUKSINĖ ŽUVELĖ";1008205490;Ne;0;0;8;8
3596;Karuselė;"AUKSINĖ ŽUVELĖ";3075592618;Ne;5;0;0;5
3597;Karuselė;"AUKSINĖ ŽUVELĖ";2450390957;Ne;3;7;0;10
3598;Karuselė;"AUKSINĖ ŽUVELĖ";4871960780;Ne;6;0;2;8
3599;Karuselė;RAMUNĖ;8362740639;Ne;4;2;1;7
3600;Karuselė;RAMUNĖ;4302662341;Ne;0;15;0;15
3601;Karuselė;RAMUNĖ;9415377698;Ne;0;6;0;6
3602;Karuselė;RAMUNĖ;8474027736;Ne;0;7;0;7
3603;Karuselė;RAMUNĖ;9394220081;Ne;7;0;0;7
3604;Karuselė;RAMUNĖ;7535451590;Ne;0;12;0;12
3605;Karuselė;RAMUNĖ;4865727149;Ne;0;16;0;16
3606;Karuselė;RAMUNĖ;2842034472;Ne;7;0;0;7
3607;Karuselė;RAMUNĖ;8952114853;Ne;9;2;2;13
3608;Karuselė;RAMUNĖ;4757820179;Ne;0;2;5;7
3609;Karuselė;RAMUNĖ;9649615834;Ne;5;0;3;8
3610;Karuselė;RAMUNĖ;3885475525;Ne;31;0;0;31
3611;Karuselė;RAMUNĖ;6678283260;Ne;0;0;7;7
3612;Karuselė;RAMUNĖ;4196250786;Ne;6;2;0;8
3613;Karuselė;RAMUNĖ;2260731421;Ne;0;2;5;7
3614;Karuselė;VILKELIS;1412890120;Ne;0;9;0;9
3615;Karuselė;VILKELIS;4951249625;Ne;0;0;4;4
3616;Karuselė;VILKELIS;4130693235;Ne;7;1;7;15
3617;Karuselė;VILKELIS;8012963667;Ne;0;1;0;1
3618;Karuselė;VILKELIS;9340167973;Ne;3;6;3;12
3619;Karuselė;VILKELIS;9985033530;Ne;1;0;1;2
3620;Karuselė;VILKELIS;3661917922;Ne;0;0;1;1
3621;Karuselė;VILKELIS;4211688032;Ne;0;0;1;1
3622;Karuselė;VILKELIS;9304912028;Ne;0;2;2;4
3623;Karuselė;VILKELIS;5802996641;Taip;0;1;7;8
3624;Karuselė;VILKELIS;2306922755;Ne;0;2;1;3
3625;Karuselė;VILKELIS;4325959483;Ne;0;4;0;4
3626;Karuselė;VILKELIS;3271464159;Taip;10;1;0;11
3627;Karuselė;VILKELIS;7501323454;Ne;0;2;2;4
3628;Karuselė;VILKELIS;3968719760;Taip;0;1;1;2
3629;Karuselė;VILKELIS;6785226197;Ne;0;1;0;1
3630;Kaštonas;NYKŠTUKAI;7703842464;Ne;1;0;5;6
3631;Kaštonas;NYKŠTUKAI;1262404954;Ne;0;1;0;1
3632;Kaštonas;NYKŠTUKAI;6254250706;Ne;0;1;0;1
3633;Kaštonas;NYKŠTUKAI;8867446698;Ne;4;1;0;5
3634;Kaštonas;NYKŠTUKAI;8775608339;Ne;0;2;0;2
3635;Kaštonas;NYKŠTUKAI;6613837801;Ne;0;0;1;1
3636;Kaštonas;NYKŠTUKAI;6934262510;Ne;0;8;0;8
3637;Kaštonas;NYKŠTUKAI;6589898580;Ne;0;2;2;4
3638;Kaštonas;NYKŠTUKAI;4824511567;Ne;0;1;0;1
3639;Kaštonas;NYKŠTUKAI;4384907654;Ne;9;3;0;12
3640;Kaštonas;NYKŠTUKAI;3961661158;Ne;0;11;0;11
3641;Kaštonas;NYKŠTUKAI;8318869054;Ne;10;0;0;10
3642;Kaštonas;NYKŠTUKAI;2178971789;Ne;1;0;0;1
3643;Kaštonas;NYKŠTUKAI;4444087861;Ne;0;0;5;5
3644;Kaštonas;NYKŠTUKAI;9014726465;Taip;0;11;0;11
3645;Kaštonas;NYKŠTUKAI;2361839733;Ne;0;8;0;8
3646;Kaštonas;NYKŠTUKAI;3383390078;Ne;0;6;0;6
3647;Kaštonas;DRUGELIAI;8486955652;Ne;2;4;0;6
3648;Kaštonas;DRUGELIAI;2106924435;Ne;6;7;0;13
3649;Kaštonas;DRUGELIAI;8483888152;Ne;0;3;0;3
3650;Kaštonas;DRUGELIAI;3059036526;Ne;7;0;0;7
3651;Kaštonas;DRUGELIAI;2165890763;Ne;0;1;0;1
3652;Kaštonas;DRUGELIAI;7408901858;Ne;7;4;0;11
3653;Kaštonas;DRUGELIAI;2832688622;Ne;0;8;0;8
3654;Kaštonas;DRUGELIAI;9061158412;Ne;0;7;0;7
3655;Kaštonas;DRUGELIAI;5884427036;Ne;12;0;0;12
3656;Kaštonas;DRUGELIAI;1141693073;Ne;0;5;0;5
3657;Kaštonas;DRUGELIAI;6251564828;Ne;0;5;0;5
3658;Kaštonas;DRUGELIAI;5969052108;Ne;6;0;0;6
3659;Kaštonas;DRUGELIAI;8166925991;Ne;7;11;0;18
3660;Kaštonas;DRUGELIAI;4215759647;Ne;5;3;0;8
3661;Kaštonas;DRUGELIAI;5307755844;Ne;0;4;0;4
3662;Kaštonas;DRUGELIAI;9985164505;Ne;2;4;0;6
3663;Kaštonas;DRUGELIAI;2417951642;Ne;0;1;0;1
3664;Kaštonas;DRUGELIAI;8257643251;Ne;17;0;0;17
3665;Kaštonas;KIŠKUČIAI;2020612346;Ne;15;1;0;16
3666;Kaštonas;KIŠKUČIAI;6585977073;Ne;5;2;0;7
3667;Kaštonas;KIŠKUČIAI;9298372326;Ne;0;2;0;2
3668;Kaštonas;KIŠKUČIAI;9778140363;Ne;8;3;0;11
3669;Kaštonas;KIŠKUČIAI;8250964197;Ne;0;15;0;15
3670;Kaštonas;KIŠKUČIAI;7290414209;Ne;0;13;0;13
3671;Kaštonas;KIŠKUČIAI;9356018629;Ne;0;1;0;1
3672;Kaštonas;KIŠKUČIAI;1684641447;Ne;0;7;0;7
3673;Kaštonas;KIŠKUČIAI;1207372235;Ne;5;0;0;5
3674;Kaštonas;KIŠKUČIAI;4570064071;Ne;5;0;2;7
3675;Kaštonas;KIŠKUČIAI;4020980625;Ne;0;1;0;1
3676;Kaštonas;KIŠKUČIAI;2898327157;Ne;0;0;1;1
3677;Kaštonas;KIŠKUČIAI;9320223622;Ne;0;7;0;7
3678;Kaštonas;KIŠKUČIAI;3544696101;Ne;2;4;0;6
3679;Kaštonas;BITUTĖS;9285927858;Ne;1;5;0;6
3680;Kaštonas;BITUTĖS;5328263421;Taip;0;2;0;2
3681;Kaštonas;BITUTĖS;9903176616;Ne;0;1;0;1
3682;Kaštonas;BITUTĖS;4033866425;Taip;0;6;0;6
3683;Kaštonas;BITUTĖS;8275673303;Ne;17;0;0;17
3684;Kaštonas;BITUTĖS;1614180834;Ne;0;0;1;1
3685;Kaštonas;BITUTĖS;6711295699;Ne;0;7;0;7
3686;Kaštonas;BITUTĖS;2877124424;Ne;0;6;0;6
3687;Kaštonas;BITUTĖS;1031628633;Ne;0;3;0;3
3688;Kaštonas;BITUTĖS;4551111709;Ne;0;3;0;3
3689;Kaštonas;BITUTĖS;7508357392;Taip;2;0;0;2
3690;Kaštonas;BITUTĖS;8906976150;Ne;0;6;0;6
3691;Kaštonas;BITUTĖS;8151333699;Ne;20;1;0;21
3692;Kaštonas;BITUTĖS;3649329598;Taip;0;12;0;12
3693;Kaštonas;BITUTĖS;8214699601;Ne;0;10;0;10
3694;Kaštonas;BITUTĖS;8152577445;Ne;0;0;2;2
3695;Kaštonas;BITUTĖS;7291448857;Ne;4;5;0;9
3696;Kaštonas;BITUTĖS;4837002666;Taip;11;0;1;12
3697;Kaštonas;BITUTĖS;2701042709;Taip;20;0;0;20
3698;Kaštonas;BITUTĖS;6175014441;Ne;2;0;0;2
3699;Kaštonas;BITUTĖS;1748975865;Ne;2;1;0;3
3700;Kaštonas;MEŠKIUKAI;5350239917;Ne;0;0;2;2
3701;Kaštonas;MEŠKIUKAI;7956422880;Taip;0;4;0;4
3702;Kaštonas;MEŠKIUKAI;3554337770;Ne;7;0;0;7
3703;Kaštonas;MEŠKIUKAI;7911007041;Taip;0;6;0;6
3704;Kaštonas;MEŠKIUKAI;6289073634;Ne;0;7;0;7
3705;Kaštonas;MEŠKIUKAI;7553024183;Taip;0;6;0;6
3706;Kaštonas;MEŠKIUKAI;4616084852;Ne;0;2;0;2
3707;Kaštonas;MEŠKIUKAI;5157500600;Ne;5;1;0;6
3708;Kaštonas;MEŠKIUKAI;6606094891;Ne;0;6;0;6
3709;Kaštonas;MEŠKIUKAI;1364391105;Ne;0;4;0;4
3710;Kaštonas;MEŠKIUKAI;6967725663;Ne;0;8;0;8
3711;Kaštonas;MEŠKIUKAI;4308169582;Ne;0;1;2;3
3712;Kaštonas;MEŠKIUKAI;8797584508;Taip;4;0;0;4
3713;Kaštonas;MEŠKIUKAI;9965517774;Ne;0;5;0;5
3714;Kaštonas;MEŠKIUKAI;7138581709;Ne;0;5;0;5
3715;Kaštonas;MEŠKIUKAI;8446233414;Taip;0;5;0;5
3716;Kaštonas;MEŠKIUKAI;1196590128;Ne;2;0;0;2
3717;Kaštonas;BORUŽĖLĖS;1501441973;Ne;10;0;0;10
3718;Kaštonas;BORUŽĖLĖS;1612086010;Ne;0;5;0;5
3719;Kaštonas;BORUŽĖLĖS;1027896631;Ne;0;2;0;2
3720;Kaštonas;BORUŽĖLĖS;9034859988;Ne;5;1;0;6
3721;Kaštonas;BORUŽĖLĖS;9249007247;Ne;6;5;0;11
3722;Kaštonas;BORUŽĖLĖS;6896372095;Ne;3;0;0;3
3723;Kaštonas;BORUŽĖLĖS;1976138680;Ne;0;8;0;8
3724;Kaštonas;BORUŽĖLĖS;9807554365;Ne;14;0;0;14
3725;Kaštonas;BORUŽĖLĖS;4708114402;Ne;0;11;0;11
3726;Kaštonas;BORUŽĖLĖS;4641535612;Ne;0;15;0;15
3727;Kaštonas;BORUŽĖLĖS;7383219978;Ne;7;1;0;8
3728;Kaštonas;BORUŽĖLĖS;3251132542;Ne;9;1;0;10
3729;Kaštonas;BORUŽĖLĖS;6425908247;Ne;17;0;0;17
3730;Kaštonas;BORUŽĖLĖS;3860613494;Ne;14;0;0;14
3731;Kaštonas;BORUŽĖLĖS;9317649996;Taip;10;2;0;12
3732;Kaštonas;BORUŽĖLĖS;5948707303;Taip;10;0;1;11
3733;Kaštonas;BORUŽĖLĖS;7698074598;Ne;10;4;0;14
3734;Kaštonas;BORUŽĖLĖS;6749679348;Ne;2;0;0;2
3735;Kaštonas;BORUŽĖLĖS;5060824071;Ne;0;7;0;7
3736;"Krivūlė (Lydos g. 5)";SPINDULIUKAI;1937803301;Ne;0;0;10;10
3737;"Krivūlė (Lydos g. 5)";SPINDULIUKAI;9865192795;Ne;0;0;9;9
3738;"Krivūlė (Lydos g. 5)";SPINDULIUKAI;3913058095;Ne;0;0;4;4
3739;"Krivūlė (Lydos g. 5)";SPINDULIUKAI;1840809151;Ne;3;0;0;3
3740;"Krivūlė (Lydos g. 5)";SPINDULIUKAI;7335245963;Ne;0;0;1;1
3741;"Krivūlė (Lydos g. 5)";SPINDULIUKAI;5802739148;Ne;0;1;0;1
3742;"Krivūlė (Lydos g. 5)";SPINDULIUKAI;8348288864;Ne;0;0;2;2
3743;"Krivūlė (Lydos g. 5)";SPINDULIUKAI;7155162698;Ne;0;0;3;3
3744;"Krivūlė (Lydos g. 5)";SPINDULIUKAI;1151179495;Ne;0;0;2;2
3745;"Krivūlė (Lydos g. 5)";SPINDULIUKAI;9320613086;Ne;0;0;7;7
3746;"Krivūlė (Lydos g. 5)";SPINDULIUKAI;4750075323;Ne;5;0;0;5
3747;"Krivūlė (Lydos g. 5)";SPINDULIUKAI;3852793979;Ne;1;10;0;11
3748;"Krivūlė (Lydos g. 5)";SPINDULIUKAI;3184820008;Ne;12;0;0;12
3749;"Krivūlė (Lydos g. 5)";SPINDULIUKAI;7149268223;Ne;0;0;2;2
3750;"Krivūlė (Lydos g. 5)";BORUŽĖLĖS;3605506478;Ne;1;0;1;2
3751;"Krivūlė (Lydos g. 5)";BORUŽĖLĖS;4896656209;Ne;1;0;1;2
3752;"Krivūlė (Lydos g. 5)";BORUŽĖLĖS;4845515196;Ne;0;7;0;7
3753;"Krivūlė (Lydos g. 5)";BORUŽĖLĖS;5676562063;Ne;5;0;6;11
3754;"Krivūlė (Lydos g. 5)";BORUŽĖLĖS;6935969502;Ne;0;0;6;6
3755;"Krivūlė (Lydos g. 5)";BORUŽĖLĖS;4972360440;Ne;3;0;2;5
3756;"Krivūlė (Lydos g. 5)";BORUŽĖLĖS;7318064702;Ne;12;0;1;13
3757;"Krivūlė (Lydos g. 5)";BORUŽĖLĖS;3912620138;Ne;0;0;5;5
3758;"Krivūlė (Lydos g. 5)";BORUŽĖLĖS;3246787504;Ne;5;0;1;6
3759;"Krivūlė (Lydos g. 5)";BORUŽĖLĖS;2386053480;Ne;4;0;2;6
3760;"Krivūlė (Lydos g. 5)";BORUŽĖLĖS;8586287004;Ne;0;0;2;2
3761;"Krivūlė (Lydos g. 5)";BORUŽĖLĖS;4540069843;Ne;0;0;3;3
3762;"Krivūlė (Lydos g. 5)";BORUŽĖLĖS;4297876008;Ne;3;0;4;7
3763;"Krivūlė (Lydos g. 5)";BORUŽĖLĖS;4177660973;Ne;0;4;0;4
3764;"Krivūlė (Lydos g. 5)";BORUŽĖLĖS;2711010212;Ne;4;2;0;6
3765;"Krivūlė (Lydos g. 5)";BORUŽĖLĖS;4025821636;Ne;0;0;1;1
3766;"Krivūlė (Lydos g. 5)";BORUŽĖLĖS;7781918674;Ne;0;1;0;1
3767;"Krivūlė (Lydos g. 5)";DRUGELIŲ;5966543639;Ne;0;0;1;1
3768;"Krivūlė (Lydos g. 5)";DRUGELIŲ;5818988913;Ne;0;2;0;2
3769;"Krivūlė (Lydos g. 5)";DRUGELIŲ;7873123757;Ne;0;6;0;6
3770;"Krivūlė (Lydos g. 5)";DRUGELIŲ;2109315338;Ne;0;0;1;1
3771;"Krivūlė (Lydos g. 5)";DRUGELIŲ;6861483854;Ne;0;0;7;7
3772;"Krivūlė (Lydos g. 5)";DRUGELIŲ;1515185307;Ne;7;1;1;9
3773;"Krivūlė (Lydos g. 5)";DRUGELIŲ;9267414141;Ne;0;0;1;1
3774;"Krivūlė (Lydos g. 5)";DRUGELIŲ;6753080815;Ne;4;0;4;8
3775;"Krivūlė (Lydos g. 5)";DRUGELIŲ;6429160371;Ne;0;0;1;1
3776;"Krivūlė (Lydos g. 5)";DRUGELIŲ;3924127476;Ne;10;2;0;12
3777;"Krivūlė (Lydos g. 5)";"BITUTĖS (VALDOFRO)";18486357195;Ne;7;0;1;8
3778;"Krivūlė (Lydos g. 5)";"BITUTĖS (VALDOFRO)";3769812444;Ne;0;2;0;2
3779;"Krivūlė (Lydos g. 5)";"BITUTĖS (VALDOFRO)";5128760019;Ne;0;2;0;2
3780;"Krivūlė (Lydos g. 5)";"BITUTĖS (VALDOFRO)";7789248863;Ne;0;0;4;4
3781;"Krivūlė (Lydos g. 5)";"BITUTĖS (VALDOFRO)";2647149927;Ne;0;5;0;5
3782;"Krivūlė (Lydos g. 5)";"BITUTĖS (VALDOFRO)";5113297248;Ne;0;0;10;10
3783;"Krivūlė (Lydos g. 5)";"BITUTĖS (VALDOFRO)";9632352765;Ne;0;5;0;5
3784;"Krivūlė (Lydos g. 5)";"BITUTĖS (VALDOFRO)";5405660104;Ne;6;0;1;7
3785;"Krivūlė (Lydos g. 5)";"BITUTĖS (VALDOFRO)";8834855616;Ne;0;3;0;3
3786;"Krivūlė (Lydos g. 5)";"BITUTĖS (VALDOFRO)";3655576855;Ne;0;0;2;2
3787;"Krivūlė (Lydos g. 5)";"BITUTĖS (VALDOFRO)";1561180871;Ne;0;10;0;10
3788;"Krivūlė (Lydos g. 5)";"BITUTĖS (VALDOFRO)";9702372816;Ne;5;0;0;5
3789;"Krivūlė (Lydos g. 5)";"BITUTĖS (VALDOFRO)";4619224314;Ne;0;20;0;20
3790;"Krivūlė (Lydos g. 5)";"BITUTĖS (VALDOFRO)";8105688948;Ne;1;7;1;9
3791;"Krivūlė (Lydos g. 5)";"BITUTĖS (VALDOFRO)";1932209134;Ne;0;0;3;3
3792;"Krivūlė (Lydos g. 5)";"BITUTĖS (VALDOFRO)";7768827505;Ne;0;0;6;6
3793;"Krivūlė (Lydos g. 5)";"BITUTĖS (VALDOFRO)";7714519095;Ne;1;0;3;4
3794;"Krivūlė (Lydos g. 5)";"BITUTĖS (VALDOFRO)";9409899522;Ne;0;0;4;4
3795;"Krivūlė (Lydos g. 5)";"BITUTĖS (VALDOFRO)";6217494808;Ne;6;1;0;7
3796;"Krivūlė (Lydos g. 5)";EŽIUKAI;8042185027;Ne;0;0;1;1
3797;"Krivūlė (Lydos g. 5)";EŽIUKAI;5369083173;Ne;15;0;0;15
3798;"Krivūlė (Lydos g. 5)";EŽIUKAI;3144577262;Ne;7;0;1;8
3799;"Krivūlė (Lydos g. 5)";EŽIUKAI;1898389557;Ne;0;0;2;2
3800;"Krivūlė (Lydos g. 5)";EŽIUKAI;2607716072;Ne;0;0;2;2
3801;"Krivūlė (Lydos g. 5)";EŽIUKAI;6830712749;Ne;0;0;9;9
3802;"Krivūlė (Lydos g. 5)";EŽIUKAI;8873132189;Ne;7;0;1;8
3803;"Krivūlė (Lydos g. 5)";EŽIUKAI;2430372719;Ne;0;0;1;1
3804;"Krivūlė (Lydos g. 5)";EŽIUKAI;1893542120;Ne;0;20;0;20
3805;"Krivūlė (Lydos g. 5)";EŽIUKAI;1622229289;Ne;0;0;2;2
3806;"Krivūlė (Lydos g. 5)";EŽIUKAI;2157856704;Ne;0;0;2;2
3807;"Krivūlė (Lydos g. 5)";NYKŠTUKAI;9401810791;Ne;5;0;6;11
3808;"Krivūlė (Lydos g. 5)";NYKŠTUKAI;8713384668;Ne;11;0;9;20
3809;"Krivūlė (Lydos g. 5)";NYKŠTUKAI;9678890051;Ne;6;0;0;6
3810;"Krivūlė (Lydos g. 5)";NYKŠTUKAI;9553953446;Ne;0;16;0;16
3811;"Krivūlė (Lydos g. 5)";NYKŠTUKAI;5268832682;Ne;16;0;2;18
3812;"Krivūlė (Lydos g. 5)";NYKŠTUKAI;8767554721;Ne;0;1;0;1
3813;"Krivūlė (Lydos g. 5)";NYKŠTUKAI;9529242858;Ne;2;0;1;3
3814;"Krivūlė (Lydos g. 5)";NYKŠTUKAI;5768244312;Ne;0;1;0;1
3815;"Krivūlė (Lydos g. 5)";NYKŠTUKAI;7540940063;Ne;0;0;4;4
3816;"Krivūlė (Lydos g. 5)";NYKŠTUKAI;7262017017;Ne;0;1;0;1
3817;"Krivūlė (Lydos g. 5)";NYKŠTUKAI;9773092651;Ne;0;0;9;9
3818;"Krivūlė (Lydos g. 5)";NYKŠTUKAI;6548893885;Ne;0;6;14;20
3819;"Krivūlė (Lydos g. 5)";NYKŠTUKAI;8674468359;Ne;0;20;0;20
3820;"Krivūlė (Lydos g. 5)";NYKŠTUKAI;8047735389;Ne;10;0;2;12
3821;Kodėlčiukas;Saulutės;1725624698;Ne;5;0;1;6
3822;Kodėlčiukas;Saulutės;7509476161;Ne;3;1;2;6
3823;Kodėlčiukas;Saulutės;7327247516;Ne;6;0;1;7
3824;Kodėlčiukas;Saulutės;8992265000;Ne;1;0;0;1
3825;Kodėlčiukas;Saulutės;6285018663;Ne;4;1;0;5
3826;Kodėlčiukas;Saulutės;1033969800;Ne;0;1;0;1
3827;Kodėlčiukas;Saulutės;9042404309;Ne;0;0;4;4
3828;Kodėlčiukas;Saulutės;3276075664;Ne;0;0;1;1
3829;Kodėlčiukas;Saulutės;9476376350;Ne;0;0;1;1
3830;Kodėlčiukas;Saulutės;7561763602;Ne;9;0;0;9
3831;Kodėlčiukas;Saulutės;2289687766;Ne;0;0;2;2
3832;Kodėlčiukas;Saulutės;6476445296;Taip;3;0;0;3
3833;Kodėlčiukas;Saulutės;1992569595;Ne;13;0;2;15
3834;Kodėlčiukas;Saulutės;9527296531;Ne;0;0;14;14
3835;Kodėlčiukas;Saulutės;2542104903;Ne;2;4;6;12
3836;Kodėlčiukas;Nežiniukai;6045564826;Ne;14;0;0;14
3837;Kodėlčiukas;Nežiniukai;7136890681;Ne;0;0;2;2
3838;Kodėlčiukas;Nežiniukai;7971932716;Ne;7;0;0;7
3839;Kodėlčiukas;Nežiniukai;7282579315;Ne;6;0;1;7
3840;Kodėlčiukas;Nežiniukai;6905424567;Ne;3;14;1;18
3841;Kodėlčiukas;Nežiniukai;5443377251;Taip;4;1;0;5
3842;Kodėlčiukas;Nežiniukai;3150006441;Ne;5;0;4;9
3843;Kodėlčiukas;Nežiniukai;7626940433;Ne;0;6;0;6
3844;Kodėlčiukas;Nežiniukai;9803206596;Taip;0;0;8;8
3845;Kodėlčiukas;Nežiniukai;4917910801;Ne;9;0;0;9
3846;Kodėlčiukas;Nežiniukai;3473981974;Ne;9;0;2;11
3847;Kodėlčiukas;Nežiniukai;4038168647;Ne;3;0;3;6
3848;Kodėlčiukas;Nežiniukai;8378295683;Taip;11;0;1;12
3849;Kodėlčiukas;Nežiniukai;6000831611;Ne;5;0;2;7
3850;Kodėlčiukas;Nežiniukai;7286497455;Ne;6;0;3;9
3851;Kodėlčiukas;Nežiniukai;1603752483;Taip;10;0;1;11
3852;Kodėlčiukas;Nežiniukai;6074758814;Ne;0;7;0;7
3853;Kodėlčiukas;Nežiniukai;1699358514;Ne;0;1;0;1
3854;Kodėlčiukas;Nežiniukai;1302383608;Ne;14;0;0;14
3855;Kodėlčiukas;Nežiniukai;1160612316;Ne;11;3;0;14
3856;Kodėlčiukas;Nežiniukai;3470151604;Ne;0;0;2;2
3857;Kodėlčiukas;Nežiniukai;5729391456;Ne;3;3;1;7
3858;Kodėlčiukas;Gintarėliai;58406224468;Ne;0;0;3;3
3859;Kodėlčiukas;Gintarėliai;1485012710;Ne;5;0;1;6
3860;Kodėlčiukas;Gintarėliai;20084022099;Ne;0;0;5;5
3861;Kodėlčiukas;Gintarėliai;4884104023;Ne;0;0;2;2
3862;Kodėlčiukas;Gintarėliai;9332136116;Ne;4;0;1;5
3863;Kodėlčiukas;Gintarėliai;4944791330;Ne;1;0;1;2
3864;Kodėlčiukas;Gintarėliai;8219424737;Ne;0;1;5;6
3865;Kodėlčiukas;Gintarėliai;4849314647;Ne;5;0;1;6
3866;Kodėlčiukas;Gintarėliai;5202375085;Ne;0;2;0;2
3867;Kodėlčiukas;Gintarėliai;3758606327;Ne;0;0;5;5
3868;Kodėlčiukas;Gintarėliai;5093139270;Ne;0;0;4;4
3869;Kodėlčiukas;Gintarėliai;4738357524;Ne;0;0;10;10
3870;Kodėlčiukas;Gintarėliai;8873629130;Ne;11;0;0;11
3871;Kodėlčiukas;Gintarėliai;1190408818;Ne;0;0;14;14
3872;Kodėlčiukas;Gintarėliai;6764015170;Ne;0;6;0;6
3873;Kodėlčiukas;Gintarėliai;6248137523;Ne;9;0;0;9
3874;Kodėlčiukas;Gintarėliai;8606551477;Ne;10;0;1;11
3875;Kodėlčiukas;Šnekučiai;1844016431;Ne;1;0;0;1
3876;Kodėlčiukas;Šnekučiai;1550915654;Ne;6;3;0;9
3877;Kodėlčiukas;Šnekučiai;1935757837;Ne;1;8;0;9
3878;Kodėlčiukas;Šnekučiai;8114859362;Ne;0;12;0;12
3879;Kodėlčiukas;Šnekučiai;1666743304;Ne;7;0;0;7
3880;Kodėlčiukas;Šnekučiai;9178209049;Ne;0;0;2;2
3881;Kodėlčiukas;Šnekučiai;5988863934;Ne;11;0;0;11
3882;Kodėlčiukas;Šnekučiai;76164689333;Ne;6;0;0;6
3883;Kodėlčiukas;Šnekučiai;5386820408;Ne;10;0;0;10
3884;Kodėlčiukas;Šnekučiai;6194726931;Ne;0;3;0;3
3885;Kodėlčiukas;Šnekučiai;7074381835;Ne;6;1;0;7
3886;Kodėlčiukas;Šnekučiai;2988674717;Ne;0;5;4;9
3887;Kodėlčiukas;Šnekučiai;4273202718;Ne;5;0;0;5
3888;Kodėlčiukas;Šnekučiai;2244326972;Ne;0;0;3;3
3889;Kodėlčiukas;Šnekučiai;3778271049;Ne;16;0;0;16
3890;Kodėlčiukas;Šnekučiai;7647582987;Ne;0;0;3;3
3891;Kodėlčiukas;Šnekučiai;7510273691;Ne;6;1;0;7
3892;Kodėlčiukas;Pabiručiai;9278139998;Ne;12;0;0;12
3893;Kodėlčiukas;Pabiručiai;5894631257;Ne;0;0;2;2
3894;Kodėlčiukas;Pabiručiai;8586746296;Taip;4;0;0;4
3895;Kodėlčiukas;Pabiručiai;9480926599;Ne;9;1;1;11
3896;Kodėlčiukas;Pabiručiai;9511144369;Ne;12;0;9;21
3897;Kodėlčiukas;Pabiručiai;7246943802;Ne;0;0;6;6
3898;Kodėlčiukas;Pabiručiai;8189938439;Ne;3;5;4;12
3899;Kodėlčiukas;Pabiručiai;5587200800;Ne;5;0;1;6
3900;Kodėlčiukas;Pabiručiai;1433623973;Ne;7;0;0;7
3901;Kodėlčiukas;Pabiručiai;1087808091;Ne;0;1;0;1
3902;Kodėlčiukas;Pabiručiai;7570122834;Ne;0;0;3;3
3903;Kodėlčiukas;Pabiručiai;5359866071;Ne;0;1;1;2
3904;Kodėlčiukas;Pabiručiai;5801430256;Ne;0;8;0;8
3905;Kodėlčiukas;Pabiručiai;7455949617;Ne;5;1;0;6
3906;Kodėlčiukas;Pabiručiai;1039982141;Ne;8;0;0;8
3907;Kodėlčiukas;Pabiručiai;9830842598;Ne;0;0;3;3
3908;Kodėlčiukas;Pabiručiai;8291672306;Ne;0;0;1;1
3909;Kodėlčiukas;Pabiručiai;3882838712;Ne;7;0;1;8
3910;Kodėlčiukas;Pabiručiai;8635107742;Ne;0;0;3;3
3911;Kodėlčiukas;Smalsučiai;7630180473;Ne;6;1;1;8
3912;Kodėlčiukas;Smalsučiai;8140940288;Ne;0;0;4;4
3913;Kodėlčiukas;Smalsučiai;1600501494;Ne;0;4;1;5
3914;Kodėlčiukas;Smalsučiai;3880019350;Ne;10;0;0;10
3915;Kodėlčiukas;Smalsučiai;4818678923;Ne;0;4;1;5
3916;Kodėlčiukas;Smalsučiai;9589692031;Ne;13;0;0;13
3917;Kodėlčiukas;Smalsučiai;1906128091;Ne;0;0;4;4
3918;Kodėlčiukas;Smalsučiai;8302606312;Ne;0;3;0;3
3919;Kodėlčiukas;Smalsučiai;9460792167;Ne;14;0;0;14
3920;Kodėlčiukas;Smalsučiai;7324303899;Ne;0;0;1;1
3921;Kodėlčiukas;Smalsučiai;9794875862;Ne;10;0;2;12
3922;Kodėlčiukas;Smalsučiai;9528997865;Ne;15;1;0;16
3923;Kodėlčiukas;Smalsučiai;8879977943;Ne;6;0;0;6
3924;Kodėlčiukas;Smalsučiai;8647609373;Ne;5;6;0;11
3925;Kodėlčiukas;Smalsučiai;2062878300;Ne;6;0;3;9
3926;Kodėlčiukas;Smalsučiai;6950802941;Ne;10;0;1;11
3927;Kodėlčiukas;Smalsučiai;1233880820;Taip;10;1;0;11
3928;Kodėlčiukas;Giliukai;9754425363;Ne;0;1;0;1
3929;Kodėlčiukas;Giliukai;5587782917;Ne;16;0;0;16
3930;Kodėlčiukas;Giliukai;8100861190;Taip;5;4;0;9
3931;Kodėlčiukas;Giliukai;7639341503;Ne;0;7;0;7
3932;Kodėlčiukas;Giliukai;8017465692;Ne;6;0;0;6
3933;Kodėlčiukas;Giliukai;7937365710;Ne;28;0;0;28
3934;Kodėlčiukas;Giliukai;1937181137;Ne;8;0;0;8
3935;Kodėlčiukas;Giliukai;9733831323;Ne;17;0;0;17
3936;Kodėlčiukas;Giliukai;7007386353;Ne;11;1;0;12
3937;Kodėlčiukas;Giliukai;9721353724;Ne;10;0;0;10
3938;Kodėlčiukas;Giliukai;2943146610;Ne;8;0;1;9
3939;Kodėlčiukas;Giliukai;5573845415;Taip;10;0;1;11
3940;Kodėlčiukas;Giliukai;2122779530;Ne;17;0;0;17
3941;Kodėlčiukas;Giliukai;8785157050;Ne;11;9;0;20
3942;Kodėlčiukas;Giliukai;5770748359;Ne;17;0;0;17
3943;Kodėlčiukas;Giliukai;9992204262;Ne;11;0;0;11
3944;Kodėlčiukas;Giliukai;6643473339;Ne;0;10;0;10
3945;Kodėlčiukas;Giliukai;8107869258;Ne;0;0;3;3
3946;Kodėlčiukas;Giliukai;5909222351;Ne;21;0;0;21
3947;Kodėlčiukas;Giliukai;3130715310;Ne;0;4;0;4
3948;Kodėlčiukas;Giliukai;3686259290;Ne;0;0;2;2
3949;Kodėlčiukas;Gudručiai;6988515253;Ne;0;9;0;9
3950;Kodėlčiukas;Gudručiai;3385551650;Ne;11;1;0;12
3951;Kodėlčiukas;Gudručiai;7318908956;Ne;8;6;0;14
3952;Kodėlčiukas;Gudručiai;9865803714;Ne;18;0;0;18
3953;Kodėlčiukas;Gudručiai;8400610717;Ne;6;0;2;8
3954;Kodėlčiukas;Gudručiai;7116594055;Ne;0;0;3;3
3955;Kodėlčiukas;Gudručiai;7326475644;Ne;11;2;0;13
3956;Kodėlčiukas;Gudručiai;9483378853;Ne;0;2;0;2
3957;Kodėlčiukas;Gudručiai;8890987483;Ne;0;0;4;4
3958;Kodėlčiukas;Gudručiai;2987907651;Ne;1;0;0;1
3959;Kodėlčiukas;Gudručiai;9028856983;Ne;18;0;0;18
3960;Kodėlčiukas;Gudručiai;1588132166;Ne;14;0;0;14
3961;Kodėlčiukas;Gudručiai;6014084915;Ne;0;3;2;5
3962;Kodėlčiukas;Gudručiai;3068084704;Ne;3;1;1;5
3963;Kodėlčiukas;Gudručiai;6985788287;Ne;6;0;0;6
3964;Kodėlčiukas;Gudručiai;3427610168;Ne;17;0;0;17
3965;Kodėlčiukas;Žirniukai;2402290604;Ne;18;0;0;18
3966;Kodėlčiukas;Žirniukai;6522019070;Taip;11;0;0;11
3967;Kodėlčiukas;Žirniukai;1050905569;Ne;0;0;1;1
3968;Kodėlčiukas;Žirniukai;3053949510;Taip;28;0;0;28
3969;Kodėlčiukas;Žirniukai;5325660102;Ne;14;0;0;14
3970;Kodėlčiukas;Žirniukai;4321485862;Ne;17;0;0;17
3971;Kodėlčiukas;Žirniukai;1550287298;Ne;13;0;0;13
3972;Kodėlčiukas;Žirniukai;9045733092;Ne;10;0;1;11
3973;Kodėlčiukas;Žirniukai;4341694264;Ne;16;0;0;16
3974;Kodėlčiukas;Žirniukai;4597473929;Taip;16;0;0;16
3975;Kodėlčiukas;Žirniukai;9702236745;Ne;15;0;1;16
3976;Kodėlčiukas;Žirniukai;7189930025;Ne;0;0;1;1
3977;Kodėlčiukas;Žirniukai;2002468844;Ne;9;0;1;10
3978;Kodėlčiukas;Žirniukai;4187856743;Ne;3;0;0;3
3979;Kodėlčiukas;Katinėliai;4730433849;Ne;0;0;3;3
3980;Kodėlčiukas;Katinėliai;6474867237;Ne;1;0;2;3
3981;Kodėlčiukas;Katinėliai;4995538090;Taip;7;0;5;12
3982;Kodėlčiukas;Katinėliai;8045906704;Ne;6;1;2;9
3983;Kodėlčiukas;Katinėliai;6576466300;Ne;10;0;0;10
3984;Kodėlčiukas;Katinėliai;5650077893;Ne;0;0;2;2
3985;Kodėlčiukas;Katinėliai;3239314295;Ne;0;0;11;11
3986;Kodėlčiukas;Katinėliai;9221561862;Ne;3;1;0;4
3987;Kodėlčiukas;Katinėliai;6355536268;Ne;9;0;1;10
3988;Kodėlčiukas;Katinėliai;2147517344;Ne;12;0;0;12
3989;Kodėlčiukas;Katinėliai;2119041584;Ne;8;1;0;9
3990;Kodėlčiukas;Katinėliai;9826174805;Ne;0;0;3;3
3991;Kodėlčiukas;Katinėliai;2291665527;Ne;6;0;0;6
3992;Kodėlčiukas;Katinėliai;1570599010;Ne;5;1;0;6
3993;Kodėlčiukas;Katinėliai;9670055064;Ne;7;0;0;7
3994;Kodėlčiukas;Katinėliai;4727546035;Ne;18;0;0;18
3995;Kodėlčiukas;Nykštukai;6935233288;Ne;14;0;0;14
3996;Kodėlčiukas;Nykštukai;7686420784;Ne;0;0;2;2
3997;Kodėlčiukas;Nykštukai;8348024909;Taip;8;0;0;8
3998;Kodėlčiukas;Nykštukai;8759498015;Ne;0;0;13;13
3999;Kodėlčiukas;Nykštukai;8911944991;Taip;0;0;6;6
4000;Kodėlčiukas;Nykštukai;2465920649;Ne;6;0;0;6
4001;Kodėlčiukas;Nykštukai;4293763647;Ne;10;0;0;10
4002;Kodėlčiukas;Nykštukai;3878358193;Ne;0;7;1;8
4003;Kodėlčiukas;Nykštukai;1835522972;Ne;0;1;0;1
4004;Kodėlčiukas;Nykštukai;4986413731;Ne;5;0;0;5
4005;Kodėlčiukas;Nykštukai;2802895479;Ne;15;1;0;16
4006;Kodėlčiukas;Nykštukai;9914565606;Ne;11;0;2;13
4007;Kodėlčiukas;Nykštukai;2543628770;Ne;9;0;7;16
4008;Kodėlčiukas;ŽIOGELIAI;8769409404;Taip;19;0;0;19
4009;Kodėlčiukas;ŽIOGELIAI;5189091564;Ne;1;0;0;1
4010;Kodėlčiukas;ŽIOGELIAI;9055399463;Ne;0;1;3;4
4011;Kodėlčiukas;ŽIOGELIAI;4672108384;Ne;15;0;2;17
4012;Kodėlčiukas;ŽIOGELIAI;2081199093;Ne;0;0;19;19
4013;Kodėlčiukas;ŽIOGELIAI;4779994281;Taip;0;2;1;3
4014;Kodėlčiukas;ŽIOGELIAI;5115939251;Ne;2;0;1;3
4015;Kodėlčiukas;ŽIOGELIAI;3223461282;Ne;1;5;7;13
4016;Kodėlčiukas;ŽIOGELIAI;3603781385;Ne;9;3;0;12
4017;Kodėlčiukas;ŽIOGELIAI;6749972956;Ne;4;1;0;5
4018;Kodėlčiukas;ŽIOGELIAI;2189949450;Ne;8;0;0;8
4019;Kodėlčiukas;ŽIOGELIAI;7497358286;Ne;3;3;1;7
4020;Kodėlčiukas;ŽIOGELIAI;2990546939;Ne;10;0;0;10
4021;Kodėlčiukas;ŽIOGELIAI;4089558399;Ne;15;0;1;16
4022;Kodėlčiukas;ŽIOGELIAI;6843492891;Ne;7;0;0;7
4023;Kodėlčiukas;ŽIOGELIAI;2933909503;Ne;23;0;0;23
4024;Kodėlčiukas;BITUTĖS;2313607716;Ne;11;1;0;12
4025;Kodėlčiukas;BITUTĖS;2438891967;Ne;14;0;1;15
4026;Kodėlčiukas;BITUTĖS;8829986201;Ne;5;0;0;5
4027;Kodėlčiukas;BITUTĖS;3985455729;Ne;6;11;0;17
4028;Kodėlčiukas;BITUTĖS;8144034996;Ne;6;0;1;7
4029;Kodėlčiukas;BITUTĖS;3156788328;Ne;11;0;1;12
4030;Kodėlčiukas;BITUTĖS;7910205296;Ne;6;0;1;7
4031;Kodėlčiukas;BITUTĖS;9736751250;Ne;13;0;1;14
4032;Kodėlčiukas;BITUTĖS;8037386529;Ne;6;5;0;11
4033;Kodėlčiukas;BITUTĖS;1047209628;Ne;13;0;6;19
4034;Kodėlčiukas;BITUTĖS;5068611716;Taip;0;0;6;6
4035;Kodėlčiukas;BITUTĖS;8932472612;Ne;8;0;0;8
4036;Kodėlčiukas;BITUTĖS;7186835214;Ne;8;0;0;8
4037;Kodėlčiukas;BITUTĖS;4529565626;Ne;8;0;0;8
4038;Kodėlčiukas;BITUTĖS;7227149646;Ne;8;0;0;8
4039;Kodėlčiukas;BITUTĖS;1568628843;Ne;10;2;0;12
4040;Kodėlčiukas;BITUTĖS;9209671311;Ne;20;0;0;20
4041;Kodėlčiukas;BITUTĖS;6726383331;Ne;5;3;0;8
4042;Kodėlčiukas;BITUTĖS;1197049907;Ne;7;0;2;9
4043;Kodėlčiukas;VYŠNIUKAI;7705057116;Ne;6;0;1;7
4044;Kodėlčiukas;VYŠNIUKAI;7643398934;Ne;10;0;1;11
4045;Kodėlčiukas;VYŠNIUKAI;8799798070;Ne;1;0;2;3
4046;Kodėlčiukas;VYŠNIUKAI;7119815662;Ne;16;0;1;17
4047;Kodėlčiukas;VYŠNIUKAI;9398732476;Ne;11;0;3;14
4048;Kodėlčiukas;VYŠNIUKAI;2720748563;Ne;13;0;0;13
4049;Kodėlčiukas;VYŠNIUKAI;2871111867;Ne;9;1;0;10
4050;Kodėlčiukas;VYŠNIUKAI;9914322177;Ne;4;0;0;4
4051;Kodėlčiukas;VYŠNIUKAI;7242653444;Ne;0;4;0;4
4052;Kodėlčiukas;VYŠNIUKAI;2298734536;Ne;0;2;0;2
4053;Kodėlčiukas;VYŠNIUKAI;2549153581;Ne;16;0;3;19
4054;Kodėlčiukas;VYŠNIUKAI;1808211253;Ne;6;1;0;7
4055;Kodėlčiukas;VYŠNIUKAI;5178305435;Taip;16;0;0;16
4056;Kodėlčiukas;VYŠNIUKAI;5061852590;Ne;1;0;0;1
4057;Kodėlčiukas;VYŠNIUKAI;4782931414;Ne;0;4;0;4
4058;Kodėlčiukas;VYŠNIUKAI;3938536446;Ne;0;0;3;3
4059;Kodėlčiukas;VYŠNIUKAI;5752818911;Ne;0;13;0;13
4060;Kodėlčiukas;BORUŽĖLĖS;9109362006;Ne;0;1;1;2
4061;Kodėlčiukas;BORUŽĖLĖS;9169500252;Ne;0;4;0;4
4062;Kodėlčiukas;BORUŽĖLĖS;9724373368;Ne;0;5;0;5
4063;Kodėlčiukas;BORUŽĖLĖS;5075801618;Ne;0;0;2;2
4064;Kodėlčiukas;BORUŽĖLĖS;2819860331;Ne;9;0;1;10
4065;Kodėlčiukas;BORUŽĖLĖS;4941186694;Ne;6;1;0;7
4066;Kodėlčiukas;BORUŽĖLĖS;5952121209;Ne;0;7;0;7
4067;Kodėlčiukas;BORUŽĖLĖS;4230906452;Ne;4;6;0;10
4068;Kodėlčiukas;BORUŽĖLĖS;8779350309;Ne;0;0;1;1
4069;Kodėlčiukas;BORUŽĖLĖS;9208137169;Ne;10;1;1;12
4070;Kodėlčiukas;BORUŽĖLĖS;5876187643;Ne;0;3;1;4
4071;Kodėlčiukas;BORUŽĖLĖS;1827752731;Taip;0;0;2;2
4072;Kodėlčiukas;BORUŽĖLĖS;1005178052;Taip;22;0;0;22
4073;Kodėlčiukas;BORUŽĖLĖS;9252478832;Ne;8;1;0;9
4074;Kodėlčiukas;BORUŽĖLĖS;1889809198;Ne;0;0;1;1
4075;Kodėlčiukas;BORUŽĖLĖS;4490196764;Ne;10;5;0;15
4076;Kodėlčiukas;BORUŽĖLĖS;1074477043;Ne;0;0;1;1
4077;Kodėlčiukas;BORUŽĖLĖS;2351468626;Ne;0;1;0;1
4078;Kodėlčiukas;BORUŽĖLĖS;3403889915;Ne;0;9;0;9
4079;Kodėlčiukas;VYTURĖLIAI;6714818379;Ne;6;3;0;9
4080;Kodėlčiukas;VYTURĖLIAI;4218096561;Ne;0;4;0;4
4081;Kodėlčiukas;VYTURĖLIAI;2169307879;Ne;10;0;0;10
4082;Kodėlčiukas;VYTURĖLIAI;4585226357;Ne;9;0;4;13
4083;Kodėlčiukas;VYTURĖLIAI;4884233329;Ne;5;0;0;5
4084;Kodėlčiukas;VYTURĖLIAI;8263945732;Ne;0;0;6;6
4085;Kodėlčiukas;VYTURĖLIAI;2904858964;Ne;10;0;1;11
4086;Kodėlčiukas;VYTURĖLIAI;3413659259;Ne;0;0;3;3
4087;Kodėlčiukas;VYTURĖLIAI;9673271313;Ne;0;0;5;5
4088;Kodėlčiukas;VYTURĖLIAI;5710301153;Ne;2;0;5;7
4089;Kodėlčiukas;VYTURĖLIAI;5474125905;Ne;11;0;0;11
4090;Kodėlčiukas;VYTURĖLIAI;2298099102;Ne;6;1;0;7
4091;Kodėlčiukas;VYTURĖLIAI;5181211722;Ne;6;0;0;6
4092;Kodėlčiukas;VYTURĖLIAI;3472862544;Ne;10;0;0;10
4093;Kodėlčiukas;VYTURĖLIAI;5921714669;Ne;14;1;0;15
4094;Kodėlčiukas;VYTURĖLIAI;7778188733;Ne;0;0;1;1
4095;Kodėlčiukas;DRUGELIAI;4165123345;Ne;13;0;1;14
4096;Kodėlčiukas;DRUGELIAI;5772071707;Ne;4;0;0;4
4097;Kodėlčiukas;DRUGELIAI;7587203481;Ne;0;0;4;4
4098;Kodėlčiukas;DRUGELIAI;2353960861;Ne;0;11;0;11
4099;Kodėlčiukas;DRUGELIAI;6103959702;Ne;0;0;1;1
4100;Kodėlčiukas;DRUGELIAI;3267687337;Ne;0;0;5;5
4101;Kodėlčiukas;DRUGELIAI;5505788210;Ne;0;0;1;1
4102;Kodėlčiukas;DRUGELIAI;5577154148;Ne;0;2;0;2
4103;Kodėlčiukas;DRUGELIAI;8547039654;Ne;11;0;0;11
4104;Kodėlčiukas;DRUGELIAI;4202423480;Ne;0;0;1;1
4105;Kodėlčiukas;DRUGELIAI;9979034031;Ne;0;7;0;7
4106;Kodėlčiukas;DRUGELIAI;3240221130;Ne;0;1;0;1
4107;Kodėlčiukas;DRUGELIAI;7714816675;Taip;11;4;0;15
4108;Kodėlčiukas;DRUGELIAI;9664432781;Ne;3;0;0;3
4109;Kodėlčiukas;DRUGELIAI;5197946954;Ne;5;0;3;8
4110;Kodėlčiukas;DRUGELIAI;8315176054;Ne;10;1;1;12
4111;Kodėlčiukas;DRUGELIAI;3854719881;Ne;0;0;1;1
4112;Kodėlčiukas;DRUGELIAI;7908217415;Ne;8;0;4;12
4113;Kodėlčiukas;"NAUJA (LOPŠELIS)";1705030069;Ne;5;0;0;5
4114;Kodėlčiukas;OBUOLIUKAI;1289342844;Ne;0;3;0;3
4115;Kodėlčiukas;OBUOLIUKAI;7318196860;Ne;0;6;0;6
4116;Kodėlčiukas;OBUOLIUKAI;8208448849;Ne;5;0;0;5
4117;Kodėlčiukas;OBUOLIUKAI;1683506414;Ne;10;0;1;11
4118;Kodėlčiukas;OBUOLIUKAI;3315862631;Ne;0;15;0;15
4119;Kodėlčiukas;OBUOLIUKAI;5896726125;Ne;8;0;0;8
4120;Kodėlčiukas;OBUOLIUKAI;3168418461;Ne;0;5;0;5
4121;Kodėlčiukas;OBUOLIUKAI;9645987751;Ne;18;2;0;20
4122;Kodėlčiukas;OBUOLIUKAI;5860975805;Ne;6;0;0;6
4123;Kodėlčiukas;OBUOLIUKAI;8782155591;Ne;0;0;1;1
4124;Kodėlčiukas;OBUOLIUKAI;8104220950;Ne;10;5;0;15
4125;Kodėlčiukas;OBUOLIUKAI;2005453189;Ne;18;1;0;19
4126;Kodėlčiukas;OBUOLIUKAI;1180399735;Ne;1;0;0;1
4127;Kodėlčiukas;OBUOLIUKAI;5173730926;Ne;13;0;0;13
4128;Kodėlčiukas;OBUOLIUKAI;3442449482;Ne;14;0;0;14
4129;Kodėlčiukas;OBUOLIUKAI;7946010973;Taip;0;14;0;14
4130;Kodėlčiukas;OBUOLIUKAI;5342852235;Ne;8;0;1;9
4131;Kodėlčiukas;OBUOLIUKAI;8563412043;Ne;7;1;0;8
4132;Kodėlčiukas;OBUOLIUKAI;4026784012;Ne;0;1;5;6
4133;Kodėlčiukas;OBUOLIUKAI;2114176689;Ne;0;20;0;20
4134;Kodėlčiukas;OBUOLIUKAI;3033687110;Taip;0;2;1;3
4135;Kurpaitė;Viščiukų;4657523142;Ne;0;1;0;1
4136;Kurpaitė;Viščiukų;2157581956;Ne;0;13;0;13
4137;Kurpaitė;Viščiukų;3481813493;Ne;1;0;0;1
4138;Kurpaitė;Viščiukų;8402747029;Ne;0;2;0;2
4139;Kurpaitė;Viščiukų;2373582223;Ne;0;20;0;20
4140;Kurpaitė;Viščiukų;7194351335;Ne;18;0;0;18
4141;Kurpaitė;Viščiukų;5923694769;Ne;10;0;0;10
4142;Kurpaitė;Viščiukų;5447826458;Ne;0;9;0;9
4143;Kurpaitė;Viščiukų;6859316204;Ne;11;0;0;11
4144;Kurpaitė;Gėlyčių;9922582884;Ne;2;1;0;3
4145;Kurpaitė;Gėlyčių;6466518987;Taip;0;3;0;3
4146;Kurpaitė;Gėlyčių;9769835612;Taip;0;5;0;5
4147;Kurpaitė;Gėlyčių;5745448950;Ne;16;0;4;20
4148;Kurpaitė;Gėlyčių;3989274600;Ne;0;2;0;2
4149;Kurpaitė;Gėlyčių;3139272175;Ne;0;3;0;3
4150;Kurpaitė;Gėlyčių;4769611100;Ne;8;0;0;8
4151;Kurpaitė;Gėlyčių;4426311033;Ne;0;5;0;5
4152;Kurpaitė;Gėlyčių;1927773278;Ne;0;11;0;11
4153;Kurpaitė;Gėlyčių;9221882007;Ne;0;5;0;5
4154;Kurpaitė;Gėlyčių;3456815576;Ne;1;13;0;14
4155;Kurpaitė;Gėlyčių;8361612709;Ne;0;4;0;4
4156;Kurpaitė;Gėlyčių;1964193512;Ne;0;5;0;5
4157;Kurpaitė;Drugelių;9915241987;Ne;0;10;0;10
4158;Kurpaitė;Drugelių;9200404698;Ne;0;6;0;6
4159;Kurpaitė;Drugelių;5064875626;Ne;0;0;2;2
4160;Kurpaitė;Drugelių;4592795281;Ne;0;18;0;18
4161;Kurpaitė;Drugelių;2290343066;Taip;0;12;0;12
4162;Kurpaitė;Drugelių;4188925256;Ne;10;2;0;12
4163;Kurpaitė;Drugelių;1273426668;Ne;0;6;0;6
4164;Kurpaitė;Drugelių;5220314051;Ne;1;0;0;1
4165;Kurpaitė;Drugelių;1413326858;Ne;0;0;1;1
4166;Kurpaitė;Drugelių;3634641300;Ne;3;0;0;3
4167;Kurpaitė;Drugelių;4602268315;Ne;0;0;2;2
4168;Kurpaitė;Drugelių;8592478282;Ne;4;0;0;4
4169;Kurpaitė;Drugelių;6568580994;Ne;0;15;0;15
4170;Kurpaitė;Drugelių;5396599834;Ne;4;0;0;4
4171;Kurpaitė;Pelyčių;7546409044;Ne;0;11;0;11
4172;Kurpaitė;Pelyčių;7249931704;Ne;0;1;0;1
4173;Kurpaitė;Pelyčių;1218040871;Ne;12;4;0;16
4174;Kurpaitė;Pelyčių;1505783589;Ne;0;1;0;1
4175;Kurpaitė;Pelyčių;2359555461;Ne;0;1;0;1
4176;Kurpaitė;Pelyčių;65434834152;Ne;10;0;0;10
4177;Kurpaitė;Pelyčių;9063294667;Ne;0;3;0;3
4178;Kurpaitė;Pelyčių;4312062240;Taip;0;1;0;1
4179;Kurpaitė;Pelyčių;2827617670;Ne;0;3;0;3
4180;Kurpaitė;Pelyčių;1457318954;Ne;0;1;0;1
4181;Kurpaitė;Pelyčių;7897713994;Ne;0;5;0;5
4182;Kurpaitė;Pelyčių;4168882748;Ne;0;15;0;15
4183;Kurpaitė;Pelyčių;58127430940;Ne;0;6;0;6
4184;Kurpaitė;Pelyčių;2116580903;Ne;0;9;0;9
4185;Kurpaitė;Pelyčių;24410351286;Ne;0;13;0;13
4186;"Kūlverstukas (Suvalkų g. 6)";Saulutės;7449993309;Ne;7;1;2;10
4187;"Kūlverstukas (Suvalkų g. 6)";Saulutės;2450625415;Ne;4;0;2;6
4188;"Kūlverstukas (Suvalkų g. 6)";Saulutės;2101490038;Ne;4;0;2;6
4189;"Kūlverstukas (Suvalkų g. 6)";Saulutės;7118949795;Ne;0;0;1;1
4190;"Kūlverstukas (Suvalkų g. 6)";Saulutės;2762230590;Ne;4;6;0;10
4191;"Kūlverstukas (Suvalkų g. 6)";Saulutės;5103259175;Ne;0;0;6;6
4192;"Kūlverstukas (Suvalkų g. 6)";Saulutės;9167460438;Taip;0;5;8;13
4193;"Kūlverstukas (Suvalkų g. 6)";Saulutės;8319255735;Ne;0;0;5;5
4194;"Kūlverstukas (Suvalkų g. 6)";Saulutės;4846324136;Ne;2;0;0;2
4195;"Kūlverstukas (Suvalkų g. 6)";Saulutės;7505926208;Ne;4;4;0;8
4196;"Kūlverstukas (Suvalkų g. 6)";Saulutės;1014630718;Ne;4;4;0;8
4197;"Kūlverstukas (Suvalkų g. 6)";Saulutės;1795306946;Ne;0;0;2;2
4198;"Kūlverstukas (Suvalkų g. 6)";Saulutės;1898905623;Ne;6;1;0;7
4199;"Kūlverstukas (Suvalkų g. 6)";Saulutės;5340239466;Ne;4;0;0;4
4200;"Kūlverstukas (Suvalkų g. 6)";Saulutės;3448880105;Ne;0;0;4;4
4201;"Kūlverstukas (Suvalkų g. 6)";Saulutės;8294873714;Ne;9;0;0;9
4202;"Kūlverstukas (Suvalkų g. 6)";Saulutės;7970898546;Ne;2;0;0;2
4203;"Kūlverstukas (Suvalkų g. 6)";Saulutės;4532151103;Ne;6;0;1;7
4204;"Kūlverstukas (Suvalkų g. 6)";Saulutės;8353856412;Taip;9;0;0;9
4205;"Kūlverstukas (Suvalkų g. 6)";Saulutės;4173514390;Ne;0;0;2;2
4206;"Kūlverstukas (Suvalkų g. 6)";Peledžiukai;5488011852;Ne;0;0;4;4
4207;"Kūlverstukas (Suvalkų g. 6)";Peledžiukai;3937419139;Ne;5;0;1;6
4208;"Kūlverstukas (Suvalkų g. 6)";Peledžiukai;6975324309;Ne;0;0;5;5
4209;"Kūlverstukas (Suvalkų g. 6)";Peledžiukai;1452422691;Ne;6;1;1;8
4210;"Kūlverstukas (Suvalkų g. 6)";Peledžiukai;5372936730;Ne;0;0;1;1
4211;"Kūlverstukas (Suvalkų g. 6)";Peledžiukai;4396230034;Ne;0;10;0;10
4212;"Kūlverstukas (Suvalkų g. 6)";Peledžiukai;4073233921;Ne;0;0;1;1
4213;"Kūlverstukas (Suvalkų g. 6)";Peledžiukai;8092104136;Ne;0;0;6;6
4214;"Kūlverstukas (Suvalkų g. 6)";Peledžiukai;3238807604;Ne;4;1;0;5
4215;"Kūlverstukas (Suvalkų g. 6)";Peledžiukai;1932066021;Ne;3;0;0;3
4216;"Kūlverstukas (Suvalkų g. 6)";Peledžiukai;9655585527;Ne;0;0;3;3
4217;"Kūlverstukas (Suvalkų g. 6)";Peledžiukai;5488852698;Ne;0;0;1;1
4218;"Kūlverstukas (Suvalkų g. 6)";Peledžiukai;5345423038;Ne;0;6;0;6
4219;"Kūlverstukas (Suvalkų g. 6)";Peledžiukai;3270176280;Ne;0;5;0;5
4220;"Kūlverstukas (Suvalkų g. 6)";Peledžiukai;4285624305;Ne;6;0;1;7
4221;"Kūlverstukas (Suvalkų g. 6)";Peledžiukai;6894291912;Ne;1;0;0;1
4222;"Kūlverstukas (Suvalkų g. 6)";Gelytės;3811616695;Ne;20;0;0;20
4223;"Kūlverstukas (Suvalkų g. 6)";Gelytės;3162808486;Taip;7;0;0;7
4224;"Kūlverstukas (Suvalkų g. 6)";Gelytės;1939668692;Ne;0;0;6;6
4225;"Kūlverstukas (Suvalkų g. 6)";Gelytės;3196099819;Ne;0;14;0;14
4226;"Kūlverstukas (Suvalkų g. 6)";Gelytės;4651091340;Ne;0;20;0;20
4227;"Kūlverstukas (Suvalkų g. 6)";Gelytės;7112217569;Taip;0;0;10;10
4228;"Kūlverstukas (Suvalkų g. 6)";Gelytės;8701405518;Ne;0;10;0;10
4229;"Kūlverstukas (Suvalkų g. 6)";Gelytės;4111966910;Ne;7;0;4;11
4230;"Kūlverstukas (Suvalkų g. 6)";Gelytės;8964753108;Ne;1;0;0;1
4231;"Kūlverstukas (Suvalkų g. 6)";Gelytės;2389231051;Ne;4;0;0;4
4232;"Kūlverstukas (Suvalkų g. 6)";Gelytės;1067182820;Ne;0;0;4;4
4233;"Kūlverstukas (Suvalkų g. 6)";Gelytės;2316978273;Ne;0;0;6;6
4234;"Kūlverstukas (Suvalkų g. 6)";Gelytės;8333084277;Ne;0;0;7;7
4235;"Kūlverstukas (Suvalkų g. 6)";Gelytės;6710735721;Ne;0;1;2;3
4236;"Kūlverstukas (Suvalkų g. 6)";Gelytės;8618967238;Ne;6;0;1;7
4237;"Kūlverstukas (Suvalkų g. 6)";Gelytės;3790418633;Ne;0;1;0;1
4238;"Kūlverstukas (Suvalkų g. 6)";Gelytės;1679412281;Ne;0;1;0;1
4239;"Kūlverstukas (Suvalkų g. 6)";Bitutės;8599785196;Ne;0;4;0;4
4240;"Kūlverstukas (Suvalkų g. 6)";Bitutės;2082087440;Ne;6;0;1;7
4241;"Kūlverstukas (Suvalkų g. 6)";Bitutės;6319075079;Ne;4;0;0;4
4242;"Kūlverstukas (Suvalkų g. 6)";Bitutės;1062604474;Ne;0;0;2;2
4243;"Kūlverstukas (Suvalkų g. 6)";Bitutės;1985177751;Ne;0;0;4;4
4244;"Kūlverstukas (Suvalkų g. 6)";Bitutės;2924333435;Ne;4;0;5;9
4245;"Kūlverstukas (Suvalkų g. 6)";Bitutės;9787833724;Ne;0;0;2;2
4246;"Kūlverstukas (Suvalkų g. 6)";Bitutės;6916013898;Ne;0;0;6;6
4247;"Kūlverstukas (Suvalkų g. 6)";Bitutės;4694784301;Ne;11;0;0;11
4248;Lakštingala;Saulutės;2156571482;Ne;7;2;0;9
4249;Lakštingala;Saulutės;4651600682;Ne;10;0;0;10
4250;Lakštingala;Saulutės;2084960114;Ne;0;0;5;5
4251;Lakštingala;Saulutės;3911509979;Ne;0;1;3;4
4252;Lakštingala;Saulutės;1598639284;Ne;6;2;0;8
4253;Lakštingala;Saulutės;3723986383;Ne;7;0;3;10
4254;Lakštingala;Saulutės;1243254166;Ne;0;9;0;9
4255;Lakštingala;Saulutės;9628476764;Ne;0;1;0;1
4256;Lakštingala;Saulutės;4344553248;Ne;3;0;6;9
4257;Lakštingala;Saulutės;9457533516;Ne;0;0;1;1
4258;Lakštingala;Saulutės;6567480562;Ne;0;1;0;1
4259;Lakštingala;Saulutės;9495341480;Ne;0;4;0;4
4260;Lakštingala;Saulutės;2543779273;Ne;8;2;2;12
4261;Lakštingala;Saulutės;2093953744;Ne;0;1;0;1
4262;Lakštingala;Saulutės;1074616528;Ne;0;0;2;2
4263;Lakštingala;Saulutės;2626498928;Ne;5;0;0;5
4264;Lakštingala;Saulutės;9441296489;Ne;5;2;1;8
4265;Lakštingala;Saulutės;6369696598;Ne;0;2;0;2
4266;Lakštingala;Saulutės;3618452008;Ne;0;1;0;1
4267;Lakštingala;Saulutės;9297542026;Ne;0;1;0;1
4268;Lakštingala;Saulutės;9899997020;Ne;1;0;9;10
4269;Lakštingala;Saulutės;8130468345;Ne;2;1;0;3
4270;Lakštingala;Nykštukai;9725851433;Ne;0;0;10;10
4271;Lakštingala;Nykštukai;8217315818;Ne;6;0;0;6
4272;Lakštingala;Nykštukai;2769474812;Ne;0;0;2;2
4273;Lakštingala;Nykštukai;9879064676;Ne;9;0;0;9
4274;Lakštingala;Nykštukai;2941128360;Ne;2;0;0;2
4275;Lakštingala;Nykštukai;9912622093;Ne;0;0;1;1
4276;Lakštingala;Nykštukai;3509165175;Ne;4;1;0;5
4277;Lakštingala;Nykštukai;3993759015;Ne;13;6;0;19
4278;Lakštingala;Nykštukai;5445945319;Ne;4;10;0;14
4279;Lakštingala;Nykštukai;6332498461;Ne;0;0;2;2
4280;Lakštingala;Nykštukai;1655202909;Ne;0;2;0;2
4281;Lakštingala;Nykštukai;5162605666;Ne;4;2;2;8
4282;Lakštingala;Nykštukai;2073818724;Ne;0;0;2;2
4283;Lakštingala;Nykštukai;1863034132;Ne;0;0;5;5
4284;Lakštingala;Nykštukai;4032030375;Ne;5;6;0;11
4285;Lakštingala;Nykštukai;2652305131;Ne;5;0;2;7
4286;Lakštingala;Nykštukai;7963839249;Ne;5;0;3;8
4287;Lakštingala;Nykštukai;9375002191;Ne;0;10;0;10
4288;Lakštingala;Nykštukai;4179366572;Ne;1;0;11;12
4289;Lakštingala;Nykštukai;4857448665;Ne;0;6;2;8
4290;Lakštingala;Bitutės;8890852891;Ne;0;1;1;2
4291;Lakštingala;Bitutės;5851957031;Ne;4;1;0;5
4292;Lakštingala;Bitutės;7918688955;Ne;0;1;0;1
4293;Lakštingala;Bitutės;9395512638;Ne;0;1;0;1
4294;Lakštingala;Bitutės;1832608585;Ne;3;1;0;4
4295;Lakštingala;Bitutės;7900597697;Ne;0;1;3;4
4296;Lakštingala;Bitutės;8470575927;Ne;0;2;5;7
4297;Lakštingala;Bitutės;9497327995;Ne;14;0;0;14
4298;Lakštingala;Bitutės;1411121466;Ne;0;1;3;4
4299;Lakštingala;Bitutės;8944088082;Ne;0;3;8;11
4300;Lakštingala;Bitutės;9897713625;Ne;0;1;1;2
4301;Lakštingala;Bitutės;70798601578;Ne;0;7;0;7
4302;Lakštingala;Bitutės;5672932116;Ne;0;0;17;17
4303;Lakštingala;Bitutės;5598711072;Ne;0;0;1;1
4304;Lakštingala;Bitutės;9346986726;Ne;0;1;1;2
4305;Lakštingala;Bitutės;3872205876;Ne;15;0;0;15
4306;Lakštingala;Bitutės;5920907667;Ne;0;2;7;9
4307;Lakštingala;Bitutės;8679582358;Ne;20;0;0;20
4308;Lakštingala;Bitutės;2266870318;Ne;0;1;10;11
4309;Lakštingala;Pūkeliai;9774836470;Ne;5;1;0;6
4310;Lakštingala;Pūkeliai;1958696382;Ne;0;0;1;1
4311;Lakštingala;Pūkeliai;4542992319;Ne;6;4;0;10
4312;Lakštingala;Pūkeliai;2593030897;Ne;0;1;2;3
4313;Lakštingala;Pūkeliai;7929034243;Ne;0;7;0;7
4314;Lakštingala;Pūkeliai;8165998647;Ne;13;0;1;14
4315;Lakštingala;Pūkeliai;1458348357;Ne;19;0;0;19
4316;Lakštingala;Pūkeliai;4465752871;Ne;1;0;2;3
4317;Lakštingala;Pūkeliai;5379344261;Ne;8;0;1;9
4318;Lakštingala;Pūkeliai;4722328994;Ne;3;0;0;3
4319;Lakštingala;Pūkeliai;7272454093;Ne;1;0;6;7
4320;Lakštingala;Pūkeliai;1587899391;Ne;5;0;0;5
4321;Lakštingala;Pūkeliai;6234559044;Ne;0;0;7;7
4322;Lakštingala;Pūkeliai;5727308039;Ne;0;1;0;1
4323;Lakštingala;Pūkeliai;5051773825;Ne;5;0;0;5
4324;Lakštingala;Pūkeliai;9390342572;Ne;14;1;0;15
4325;Lakštingala;Pūkeliai;9694524137;Ne;4;2;0;6
4326;Lakštingala;Pūkeliai;5949665703;Ne;9;0;1;10
4327;Lakštingala;Pūkeliai;6565318145;Ne;1;0;0;1
4328;Lakštingala;Pūkeliai;4384468922;Ne;5;0;4;9
4329;Lakštingala;Pūkeliai;2423761155;Ne;3;7;2;12
4330;Lakštingala;Pūkeliai;8171357606;Ne;0;3;0;3
4331;Lakštingala;Aitvariukai;1474796466;Ne;0;8;0;8
4332;Lakštingala;Aitvariukai;9629855134;Ne;0;2;0;2
4333;Lakštingala;Aitvariukai;4546036762;Ne;0;0;1;1
4334;Lakštingala;Aitvariukai;7876311404;Ne;11;0;0;11
4335;Lakštingala;Aitvariukai;1248909711;Ne;4;1;0;5
4336;Lakštingala;Aitvariukai;9676872125;Ne;4;0;0;4
4337;Lakštingala;Aitvariukai;9083753159;Ne;0;0;2;2
4338;Lakštingala;Aitvariukai;7879280198;Ne;0;4;0;4
4339;Lakštingala;Aitvariukai;4403673558;Taip;6;3;0;9
4340;Lakštingala;Aitvariukai;5693413287;Ne;8;0;1;9
4341;Lakštingala;Aitvariukai;7240426529;Ne;0;2;3;5
4342;Lakštingala;Aitvariukai;5244646855;Ne;5;0;1;6
4343;Lakštingala;Aitvariukai;5602079341;Ne;13;0;0;13
4344;Lakštingala;Aitvariukai;3166474163;Ne;0;9;0;9
4345;Lakštingala;Aitvariukai;8609822839;Ne;0;2;1;3
4346;Lakštingala;Aitvariukai;6180443056;Ne;0;2;5;7
4347;Lakštingala;Aitvariukai;3113050690;Ne;0;2;0;2
4348;Lakštingala;Boružiukai;9795993812;Ne;0;6;0;6
4349;Lakštingala;Boružiukai;9004336424;Ne;0;13;0;13
4350;Lakštingala;Boružiukai;87470014156;Ne;0;0;1;1
4351;Lakštingala;Boružiukai;8820053026;Ne;0;1;0;1
4352;Lakštingala;Boružiukai;4811759034;Ne;6;1;0;7
4353;Lakštingala;Boružiukai;1898853302;Ne;0;3;0;3
4354;Lakštingala;Boružiukai;7443563000;Ne;3;0;4;7
4355;Lakštingala;Boružiukai;55720630870;Ne;0;5;1;6
4356;Lakštingala;Boružiukai;4818524423;Ne;10;5;2;17
4357;Lakštingala;Boružiukai;9724531753;Ne;0;4;0;4
4358;Lakštingala;Boružiukai;1783776913;Ne;0;1;0;1
4359;Lakštingala;Boružiukai;1106475925;Ne;4;0;2;6
4360;Lakštingala;Boružiukai;1667277983;Ne;0;2;1;3
4361;Lakštingala;Boružiukai;6947565845;Ne;0;5;0;5
4362;Lakštingala;Boružiukai;3009692491;Ne;0;5;0;5
4363;Lakštingala;Boružiukai;1800927281;Ne;6;3;0;9
4364;Lakštingala;Boružiukai;9998322501;Ne;0;2;1;3
4365;Lakštingala;Boružiukai;2304340938;Ne;0;2;0;2
4366;Lakštingala;Boružiukai;8284565948;Ne;14;0;0;14
4367;Lakštingala;Boružiukai;9445476887;Ne;10;1;4;15
4368;Lakštingala;Boružiukai;8899572475;Ne;5;2;0;7
4369;Lakštingala;Boružiukai;9492056071;Ne;0;1;0;1
4370;Lakštingala;Žiogeliai;8404025659;Ne;9;0;7;16
4371;Lakštingala;Žiogeliai;4113993067;Ne;0;4;0;4
4372;Lakštingala;Žiogeliai;6981178960;Ne;0;0;8;8
4373;Lakštingala;Žiogeliai;3908175786;Ne;4;0;16;20
4374;Lakštingala;Žiogeliai;4935753482;Ne;4;0;4;8
4375;Lakštingala;Žiogeliai;3439681068;Ne;10;0;2;12
4376;Lakštingala;Žiogeliai;3766986041;Ne;6;0;5;11
4377;Lakštingala;Žiogeliai;1974950823;Ne;3;0;0;3
4378;Lakštingala;Žiogeliai;6561743084;Ne;6;0;0;6
4379;Lakštingala;Žiogeliai;1226908540;Ne;0;0;6;6
4380;Lakštingala;Žiogeliai;3951057865;Ne;9;0;1;10
4381;Lakštingala;Žiogeliai;1494530289;Ne;0;0;4;4
4382;Lakštingala;Žiogeliai;7661973162;Ne;5;0;0;5
4383;Lakštingala;Žiogeliai;7104398627;Ne;4;7;2;13
4384;Lakštingala;Žiogeliai;7361353346;Ne;0;1;1;2
4385;Lakštingala;Žiogeliai;8351970017;Ne;0;1;4;5
4386;Lakštingala;Žiogeliai;8333832673;Ne;0;4;0;4
4387;Lakštingala;Žiogeliai;6872095965;Ne;1;0;2;3
4388;Lakštingala;SPINDULIUKAI;4365413054;Ne;0;0;2;2
4389;Lakštingala;SPINDULIUKAI;9762500668;Ne;0;2;0;2
4390;Lakštingala;SPINDULIUKAI;7640007392;Ne;0;14;0;14
4391;Lakštingala;SPINDULIUKAI;4784677514;Ne;6;0;0;6
4392;Lakštingala;SPINDULIUKAI;2022621678;Ne;0;0;1;1
4393;Lakštingala;SPINDULIUKAI;8429523368;Ne;0;2;0;2
4394;Lakštingala;SPINDULIUKAI;6668075753;Ne;5;0;3;8
4395;Lakštingala;SPINDULIUKAI;9081653166;Ne;0;2;0;2
4396;Lakštingala;SPINDULIUKAI;6780591792;Ne;4;1;0;5
4397;Lakštingala;SPINDULIUKAI;4698879435;Ne;6;0;0;6
4398;Lakštingala;SPINDULIUKAI;8722490845;Ne;0;0;1;1
4399;Lakštingala;SPINDULIUKAI;1220858944;Ne;7;1;0;8
4400;Lakštingala;SPINDULIUKAI;3823860988;Ne;0;0;4;4
4401;Lakštingala;SPINDULIUKAI;7141840160;Ne;0;1;0;1
4402;Lakštingala;SPINDULIUKAI;3282771613;Ne;0;1;0;1
4403;Lakštingala;SPINDULIUKAI;2795341401;Ne;0;1;0;1
4404;Lakštingala;Pėledžiukai;3520592784;Ne;0;0;1;1
4405;Lakštingala;Pėledžiukai;5258588961;Ne;0;7;3;10
4406;Lakštingala;Pėledžiukai;4774354751;Ne;8;0;0;8
4407;Lakštingala;Pėledžiukai;3369263112;Ne;5;0;2;7
4408;Lakštingala;Pėledžiukai;8375506323;Ne;0;1;0;1
4409;Lakštingala;Pėledžiukai;2738882466;Ne;3;0;0;3
4410;Lakštingala;Pėledžiukai;8717764626;Ne;13;0;0;13
4411;Lakštingala;Pėledžiukai;8075192528;Ne;0;2;6;8
4412;Lakštingala;Pėledžiukai;4270513515;Ne;0;1;0;1
4413;Lakštingala;Pėledžiukai;2514377385;Ne;0;1;0;1
4414;Lakštingala;Pėledžiukai;6161860331;Ne;0;2;1;3
4415;Lakštingala;Pėledžiukai;6866935290;Ne;0;0;15;15
4416;Lakštingala;Pėledžiukai;8787118512;Ne;0;4;0;4
4417;Lakštingala;Pėledžiukai;6805882038;Ne;4;1;0;5
4418;Lakštingala;Pėledžiukai;7139669240;Ne;0;2;4;6
4419;Lakštingala;Pėledžiukai;9502994399;Ne;0;0;1;1
4420;Lakštingala;Pėledžiukai;9431022632;Ne;0;0;2;2
4421;Lakštingala;Pėledžiukai;9856189053;Ne;3;2;0;5
4422;Lakštingala;Pėledžiukai;4608719006;Ne;0;0;3;3
4423;Lakštingala;Katinėliai;2346497467;Ne;5;0;2;7
4424;Lakštingala;Katinėliai;9894103692;Ne;0;2;3;5
4425;Lakštingala;Katinėliai;8800538473;Ne;6;1;0;7
4426;Lakštingala;Katinėliai;9093654437;Ne;6;0;1;7
4427;Lakštingala;Katinėliai;6011421835;Ne;9;0;8;17
4428;Lakštingala;Katinėliai;2673030043;Ne;0;0;2;2
4429;Lakštingala;Katinėliai;2010478542;Ne;11;0;1;12
4430;Lakštingala;Katinėliai;6285766353;Ne;6;0;1;7
4431;Lakštingala;Katinėliai;3877448215;Ne;6;0;0;6
4432;Lakštingala;Katinėliai;6148942052;Ne;0;0;1;1
4433;Lakštingala;Katinėliai;7623917384;Ne;1;0;1;2
4434;Lakštingala;Katinėliai;1903292595;Ne;11;0;0;11
4435;Lakštingala;Katinėliai;6764453371;Ne;4;1;0;5
4436;Lakštingala;Katinėliai;4184814075;Ne;7;0;0;7
4437;Lakštingala;Deimantėliai;8310446552;Ne;14;0;0;14
4438;Lakštingala;Deimantėliai;8063735934;Ne;0;2;0;2
4439;Lakštingala;Deimantėliai;7396235662;Ne;2;1;0;3
4440;Lakštingala;Deimantėliai;3863174791;Ne;0;0;1;1
4441;Lakštingala;Deimantėliai;4725848201;Ne;1;0;0;1
4442;Lakštingala;Deimantėliai;6930466455;Taip;2;1;2;5
4443;Lakštingala;Deimantėliai;2165808562;Ne;0;0;17;17
4444;Lakštingala;Deimantėliai;3352073562;Ne;0;0;17;17
4445;Lakštingala;Deimantėliai;5539054769;Ne;4;0;0;4
4446;Lakštingala;Deimantėliai;8421786788;Ne;0;0;1;1
4447;Lakštingala;Deimantėliai;6974936332;Ne;20;0;0;20
4448;Lakštingala;Deimantėliai;8764728846;Ne;0;1;0;1
4449;Lakštingala;Deimantėliai;8663938939;Taip;18;0;0;18
4450;Lakštingala;Deimantėliai;6231045485;Ne;5;0;0;5
4451;Lakštingala;Deimantėliai;5165517709;Ne;7;0;0;7
4452;Lakštingala;Deimantėliai;5965026791;Ne;2;4;0;6
4453;Lakštingala;KIŠKUČIAI;6520436055;Ne;14;0;0;14
4454;Lakštingala;KIŠKUČIAI;3208321841;Ne;13;2;0;15
4455;Lakštingala;KIŠKUČIAI;5464460112;Ne;0;2;1;3
4456;Lakštingala;KIŠKUČIAI;6970022417;Ne;0;0;3;3
4457;Lakštingala;KIŠKUČIAI;5730122965;Ne;16;0;0;16
4458;Lakštingala;KIŠKUČIAI;4140403601;Ne;0;2;1;3
4459;Lakštingala;KIŠKUČIAI;5119365443;Ne;2;0;0;2
4460;Lakštingala;KIŠKUČIAI;6689018476;Ne;6;0;0;6
4461;Lakštingala;KIŠKUČIAI;7017047366;Ne;9;0;1;10
4462;Lakštingala;KIŠKUČIAI;9539081376;Ne;0;0;9;9
4463;Lakštingala;KIŠKUČIAI;4854843534;Ne;0;0;10;10
4464;Lakštingala;KIŠKUČIAI;9162902701;Ne;0;0;15;15
4465;Lakštingala;KIŠKUČIAI;5455119187;Ne;5;0;0;5
4466;Lakštingala;KIŠKUČIAI;1113674539;Ne;8;0;0;8
4467;Lakštingala;KIŠKUČIAI;4370431439;Ne;0;2;4;6
4468;Lakštingala;KIŠKUČIAI;1898108870;Ne;0;0;18;18
4469;Lakštingala;KIŠKUČIAI;6652822827;Ne;0;0;1;1
4470;Lakštingala;KIŠKUČIAI;2998581623;Ne;0;2;3;5
4471;Lakštingala;KIŠKUČIAI;8414220381;Ne;0;0;8;8
4472;Lakštingala;KIŠKUČIAI;7817830649;Ne;3;11;0;14
4473;Lašelis;VIŠČIUKAI;6477439886;Ne;0;6;0;6
4474;Lašelis;VIŠČIUKAI;6912802425;Ne;14;0;0;14
4475;Lašelis;VIŠČIUKAI;6857428142;Ne;0;5;0;5
4476;Lašelis;VIŠČIUKAI;5759317067;Ne;12;0;0;12
4477;Lašelis;VIŠČIUKAI;9884946783;Taip;4;16;0;20
4478;Lašelis;VIŠČIUKAI;1367955273;Ne;0;9;1;10
4479;Lašelis;VIŠČIUKAI;2702582486;Ne;7;3;0;10
4480;Lašelis;VIŠČIUKAI;2824852871;Ne;0;13;1;14
4481;Lašelis;VIŠČIUKAI;1517104634;Taip;5;4;0;9
4482;Lašelis;VIŠČIUKAI;1294930990;Ne;0;1;0;1
4483;Lašelis;VIŠČIUKAI;9440665009;Ne;4;0;0;4
4484;Lašelis;VIŠČIUKAI;2121080776;Taip;4;0;1;5
4485;Lašelis;VIŠČIUKAI;3003679103;Ne;5;0;1;6
4486;Lašelis;VIŠČIUKAI;4427263877;Ne;0;0;4;4
4487;Lašelis;VIŠČIUKAI;4748156580;Ne;4;0;5;9
4488;Lašelis;VIŠČIUKAI;4860925464;Ne;0;0;5;5
4489;Lašelis;VIŠČIUKAI;8287867336;Ne;0;0;1;1
4490;Lašelis;ŠYPSENA;7137348151;Ne;6;0;1;7
4491;Lašelis;ŠYPSENA;1808067249;Ne;6;0;0;6
4492;Lašelis;ŠYPSENA;4933598046;Ne;0;3;0;3
4493;Lašelis;ŠYPSENA;2509469243;Ne;4;0;6;10
4494;Lašelis;ŠYPSENA;4832223461;Ne;20;0;0;20
4495;Lašelis;ŠYPSENA;5416590600;Ne;12;1;0;13
4496;Lašelis;ŠYPSENA;1490179832;Ne;0;10;0;10
4497;Lašelis;ŠYPSENA;6836452490;Ne;10;0;0;10
4498;Lašelis;ŠYPSENA;1983312896;Ne;0;5;0;5
4499;Lašelis;ŠYPSENA;1279052767;Ne;0;0;4;4
4500;Lašelis;ŠYPSENA;8906479495;Ne;2;0;7;9
4501;Lašelis;ŠYPSENA;2593126568;Ne;8;0;4;12
4502;Lašelis;ŠYPSENA;3995905195;Ne;0;20;0;20
4503;Lašelis;ŠYPSENA;6137626795;Ne;6;4;0;10
4504;Lašelis;ŠYPSENA;9664015801;Ne;3;3;0;6
4505;Lašelis;ŠYPSENA;2606193652;Ne;0;0;1;1
4506;Lašelis;ŠYPSENA;9434932943;Ne;6;6;0;12
4507;Lašelis;NYKŠTUKAI;4508779926;Ne;10;0;0;10
4508;Lašelis;NYKŠTUKAI;5931015581;Ne;0;0;3;3
4509;Lašelis;NYKŠTUKAI;8132517365;Ne;0;1;0;1
4510;Lašelis;NYKŠTUKAI;1244168190;Ne;0;0;1;1
4511;Lašelis;NYKŠTUKAI;4566547120;Ne;0;1;0;1
4512;Lašelis;NYKŠTUKAI;1035888733;Ne;0;3;0;3
4513;Lašelis;NYKŠTUKAI;1926439959;Ne;0;0;1;1
4514;Lašelis;NYKŠTUKAI;8318512396;Ne;3;0;0;3
4515;Lašelis;NYKŠTUKAI;2886967297;Ne;7;1;0;8
4516;Lašelis;NYKŠTUKAI;3805049682;Ne;11;0;0;11
4517;Lašelis;NYKŠTUKAI;2401058384;Ne;1;0;7;8
4518;Lašelis;NYKŠTUKAI;1042560186;Taip;0;1;0;1
4519;Lašelis;NYKŠTUKAI;8814796010;Ne;2;0;1;3
4520;Lašelis;NYKŠTUKAI;2223293390;Taip;8;0;3;11
4521;Lašelis;NYKŠTUKAI;3675606390;Ne;0;20;0;20
4522;Lašelis;NYKŠTUKAI;9647340725;Ne;10;0;1;11
4523;Lašelis;NYKŠTUKAI;3297005183;Ne;0;0;3;3
4524;Lašelis;NYKŠTUKAI;9313796973;Ne;11;0;0;11
4525;Lašelis;SAULUTĖ;1460027521;Ne;0;2;0;2
4526;Lašelis;SAULUTĖ;3144718477;Ne;9;0;1;10
4527;Lašelis;SAULUTĖ;7998812497;Taip;1;5;0;6
4528;Lašelis;SAULUTĖ;7351939034;Taip;0;4;0;4
4529;Lašelis;SAULUTĖ;3239288878;Taip;4;0;0;4
4530;Lašelis;SAULUTĖ;6829438486;Taip;7;0;1;8
4531;Lašelis;SAULUTĖ;6080664872;Ne;8;0;1;9
4532;Lašelis;SAULUTĖ;2204859014;Ne;6;0;0;6
4533;Lašelis;SAULUTĖ;1515920896;Taip;6;0;0;6
4534;Lašelis;SAULUTĖ;1085400709;Taip;0;0;5;5
4535;Lašelis;SAULUTĖ;1646912457;Taip;0;8;0;8
4536;Lašelis;SAULUTĖ;1816377082;Taip;0;5;0;5
4537;Lašelis;SAULUTĖ;3495676199;Ne;0;2;0;2
4538;Lašelis;SAULUTĖ;5731394231;Ne;4;0;0;4
4539;Lašelis;SAULUTĖ;1085950130;Taip;2;1;0;3
4540;Lašelis;BORUŽĖLĖS;1343964112;Ne;0;0;2;2
4541;Lašelis;BORUŽĖLĖS;7502668870;Ne;0;7;0;7
4542;Lašelis;BORUŽĖLĖS;7418586100;Ne;16;0;0;16
4543;Lašelis;BORUŽĖLĖS;8394290574;Ne;0;5;0;5
4544;Lašelis;BORUŽĖLĖS;7811809908;Ne;4;8;0;12
4545;Lašelis;BORUŽĖLĖS;4893073148;Ne;10;0;0;10
4546;Lašelis;BORUŽĖLĖS;4113842551;Ne;10;1;0;11
4547;Lašelis;BORUŽĖLĖS;1882188961;Taip;4;0;2;6
4548;Lašelis;BORUŽĖLĖS;6317716501;Ne;0;0;2;2
4549;Lašelis;BORUŽĖLĖS;8905080707;Ne;0;1;0;1
4550;Lašelis;BORUŽĖLĖS;2991487552;Ne;0;0;5;5
4551;Lašelis;BORUŽĖLĖS;2210081848;Ne;6;1;0;7
4552;Lašelis;BORUŽĖLĖS;1131591230;Ne;20;0;0;20
4553;Lašelis;BORUŽĖLĖS;4051058266;Ne;6;5;0;11
4554;Lašelis;BORUŽĖLĖS;7784416134;Ne;6;5;0;11
4555;Lašelis;SKRUZDELIUKAI;8212250478;Ne;10;4;0;14
4556;Lašelis;SKRUZDELIUKAI;5000188106;Ne;6;4;0;10
4557;Lašelis;SKRUZDELIUKAI;6203027620;Ne;2;0;1;3
4558;Lašelis;SKRUZDELIUKAI;9954809499;Taip;9;0;0;9
4559;Lašelis;SKRUZDELIUKAI;6158377421;Ne;9;3;0;12
4560;Lašelis;SKRUZDELIUKAI;3130271837;Ne;11;0;0;11
4561;Lašelis;SKRUZDELIUKAI;2871149756;Ne;17;0;0;17
4562;Lašelis;SKRUZDELIUKAI;7920615797;Ne;9;0;2;11
4563;Lašelis;SKRUZDELIUKAI;3146611814;Taip;0;4;0;4
4564;Lašelis;SKRUZDELIUKAI;7619426839;Ne;15;3;0;18
4565;Lašelis;SKRUZDELIUKAI;8718481664;Ne;10;4;0;14
4566;Lazdynėlis;BITUTĖS;1748260780;Ne;0;9;0;9
4567;Lazdynėlis;BITUTĖS;4462819848;Ne;5;0;1;6
4568;Lazdynėlis;BITUTĖS;5030400578;Taip;0;5;0;5
4569;Lazdynėlis;BITUTĖS;8159928299;Ne;2;0;0;2
4570;Lazdynėlis;BITUTĖS;9761942869;Ne;0;0;2;2
4571;Lazdynėlis;BITUTĖS;7911328294;Ne;4;0;0;4
4572;Lazdynėlis;BITUTĖS;1450181711;Ne;10;0;0;10
4573;Lazdynėlis;BITUTĖS;2044188250;Ne;0;4;4;8
4574;Lazdynėlis;BITUTĖS;4142277927;Ne;0;0;2;2
4575;Lazdynėlis;BITUTĖS;2032759165;Taip;2;0;0;2
4576;Lazdynėlis;BITUTĖS;4826167852;Ne;0;0;1;1
4577;Lazdynėlis;BITUTĖS;2586187455;Ne;14;1;0;15
4578;Lazdynėlis;BITUTĖS;2013752858;Ne;0;0;2;2
4579;Lazdynėlis;BITUTĖS;5562900372;Ne;0;20;0;20
4580;Lazdynėlis;BITUTĖS;6963058612;Ne;4;0;1;5
4581;Lazdynėlis;BITUTĖS;6920441303;Ne;0;0;1;1
4582;Lazdynėlis;BITUTĖS;4153294595;Ne;6;3;0;9
4583;Lazdynėlis;BITUTĖS;7910561870;Ne;0;20;0;20
4584;Lazdynėlis;EŽIUKAI;9362249595;Ne;0;0;2;2
4585;Lazdynėlis;EŽIUKAI;7135087818;Ne;0;0;2;2
4586;Lazdynėlis;EŽIUKAI;6814362584;Ne;4;0;4;8
4587;Lazdynėlis;EŽIUKAI;9219327706;Ne;0;2;0;2
4588;Lazdynėlis;EŽIUKAI;8229454863;Ne;0;0;2;2
4589;Lazdynėlis;EŽIUKAI;4747688220;Ne;0;0;3;3
4590;Lazdynėlis;EŽIUKAI;3097254722;Ne;0;0;2;2
4591;Lazdynėlis;EŽIUKAI;3040417651;Ne;3;0;0;3
4592;Lazdynėlis;EŽIUKAI;5407785006;Ne;0;0;1;1
4593;Lazdynėlis;EŽIUKAI;7208223612;Ne;0;0;1;1
4594;Lazdynėlis;EŽIUKAI;4293473176;Ne;6;0;0;6
4595;Lazdynėlis;EŽIUKAI;2723284353;Ne;0;2;1;3
4596;Lazdynėlis;EŽIUKAI;9548653584;Ne;0;1;0;1
4597;Lazdynėlis;EŽIUKAI;6008610525;Ne;10;0;0;10
4598;Lazdynėlis;EŽIUKAI;3879017767;Ne;4;0;0;4
4599;Lazdynėlis;EŽIUKAI;4031719765;Ne;0;1;0;1
4600;Lazdynėlis;BORUŽIUKAI;8337458289;Ne;0;20;0;20
4601;Lazdynėlis;BORUŽIUKAI;2592852361;Ne;11;9;0;20
4602;Lazdynėlis;BORUŽIUKAI;7692056055;Ne;12;0;0;12
4603;Lazdynėlis;BORUŽIUKAI;6394994841;Ne;2;0;0;2
4604;Lazdynėlis;BORUŽIUKAI;2009941344;Ne;6;0;1;7
4605;Lazdynėlis;BORUŽIUKAI;1653216959;Ne;6;0;0;6
4606;Lazdynėlis;BORUŽIUKAI;4190852647;Ne;9;0;0;9
4607;Lazdynėlis;BORUŽIUKAI;2058909635;Ne;0;10;0;10
4608;Lazdynėlis;BORUŽIUKAI;3105363578;Ne;5;15;0;20
4609;Lazdynėlis;BORUŽIUKAI;5622254334;Ne;6;0;1;7
4610;Lazdynėlis;BORUŽIUKAI;7587041613;Ne;5;0;0;5
4611;Lazdynėlis;BORUŽIUKAI;2380881303;Taip;5;0;0;5
4612;Lazdynėlis;BORUŽIUKAI;2632078843;Ne;20;0;0;20
4613;Lazdynėlis;BORUŽIUKAI;5756228709;Ne;0;0;1;1
4614;Lazdynėlis;BORUŽIUKAI;6824473598;Ne;0;0;3;3
4615;Lazdynėlis;BORUŽIUKAI;1707231039;Ne;0;20;0;20
4616;Lazdynėlis;BORUŽIUKAI;6413861274;Ne;4;0;0;4
4617;Lazdynėlis;BORUŽIUKAI;8030743153;Ne;6;0;0;6
4618;Lazdynėlis;BORUŽIUKAI;4642875037;Ne;5;4;0;9
4619;Lazdynėlis;BORUŽIUKAI;1722503577;Ne;9;0;0;9
4620;Lazdynėlis;BORUŽIUKAI;4595080695;Ne;0;20;0;20
4621;Lazdynėlis;BORUŽIUKAI;4958640516;Ne;0;20;0;20
4622;Lazdynėlis;BORUŽIUKAI;3351966091;Ne;0;20;0;20
4623;Lazdynėlis;BORUŽIUKAI;9548866880;Ne;9;0;0;9
4624;Lazdynėlis;KAČIUKAI;5888646355;Ne;2;1;4;7
4625;Lazdynėlis;KAČIUKAI;3678422730;Ne;0;0;1;1
4626;Lazdynėlis;KAČIUKAI;5708643953;Ne;0;0;3;3
4627;Lazdynėlis;KAČIUKAI;8295967906;Ne;5;0;0;5
4628;Lazdynėlis;KAČIUKAI;7864896721;Ne;0;1;1;2
4629;Lazdynėlis;KAČIUKAI;1424382629;Ne;6;0;0;6
4630;Lazdynėlis;KAČIUKAI;6787228086;Ne;0;0;9;9
4631;Lazdynėlis;KAČIUKAI;7313399153;Ne;15;0;0;15
4632;Lazdynėlis;KAČIUKAI;4842228703;Ne;4;0;1;5
4633;Lazdynėlis;KAČIUKAI;6542840562;Ne;0;6;0;6
4634;Lazdynėlis;KAČIUKAI;1265404063;Ne;3;1;0;4
4635;Lazdynėlis;KAČIUKAI;6086766393;Ne;0;0;11;11
4636;Lazdynėlis;KAČIUKAI;2958520599;Ne;5;7;0;12
4637;Lazdynėlis;KAČIUKAI;73057057862;Ne;16;0;0;16
4638;Lazdynėlis;KAČIUKAI;7455989945;Ne;6;1;1;8
4639;Lazdynėlis;KAČIUKAI;2164717183;Ne;0;0;5;5
4640;Lazdynėlis;KAČIUKAI;6657174602;Ne;0;0;9;9
4641;Lazdynėlis;VOVERIUKAI;6994408527;Ne;0;0;2;2
4642;Lazdynėlis;VOVERIUKAI;8159724466;Ne;9;0;1;10
4643;Lazdynėlis;VOVERIUKAI;5051632567;Ne;0;4;0;4
4644;Lazdynėlis;VOVERIUKAI;6276697479;Ne;11;1;0;12
4645;Lazdynėlis;VOVERIUKAI;1335000592;Ne;4;0;0;4
4646;Lazdynėlis;VOVERIUKAI;2514035189;Ne;8;0;2;10
4647;Lazdynėlis;VOVERIUKAI;9477491360;Ne;5;2;0;7
4648;Lazdynėlis;VOVERIUKAI;5256157552;Taip;9;0;0;9
4649;Lazdynėlis;VOVERIUKAI;5889772626;Ne;5;2;2;9
4650;Lazdynėlis;VOVERIUKAI;6559543013;Ne;0;1;0;1
4651;Lazdynėlis;VOVERIUKAI;9231049001;Ne;0;2;4;6
4652;Lazdynėlis;VOVERIUKAI;9886856760;Ne;8;2;0;10
4653;Lazdynėlis;VOVERIUKAI;2998606948;Ne;13;0;0;13
4654;Lazdynėlis;VOVERIUKAI;6164180360;Ne;0;2;0;2
4655;Lazdynėlis;VOVERIUKAI;6415858184;Ne;2;0;2;4
4656;Lazdynėlis;VOVERIUKAI;5796381191;Ne;5;2;3;10
4657;Lazdynėlis;VOVERIUKAI;3062408541;Ne;6;2;1;9
4658;Lazdynėlis;VOVERIUKAI;3779983775;Ne;5;6;0;11
4659;Lazdynėlis;VOVERIUKAI;4550819172;Ne;5;2;0;7
4660;Lazdynėlis;VOVERIUKAI;4771173060;Ne;0;0;3;3
4661;Lazdynėlis;VOVERIUKAI;3365726271;Ne;8;0;0;8
4662;Lazdynėlis;VOVERIUKAI;1355954767;Ne;8;1;0;9
4663;Lazdynėlis;VOVERIUKAI;7941793866;Ne;9;1;0;10
4664;Lazdynėlis;RIEŠUTĖLIAI;3086059608;Ne;9;0;0;9
4665;Lazdynėlis;RIEŠUTĖLIAI;9693153118;Ne;5;1;0;6
4666;Lazdynėlis;RIEŠUTĖLIAI;6056618348;Ne;0;20;0;20
4667;Lazdynėlis;RIEŠUTĖLIAI;5987500024;Ne;0;0;3;3
4668;Lazdynėlis;RIEŠUTĖLIAI;2453740823;Ne;4;0;0;4
4669;Lazdynėlis;RIEŠUTĖLIAI;4552505857;Ne;2;1;0;3
4670;Lazdynėlis;RIEŠUTĖLIAI;7545621720;Ne;4;1;2;7
4671;Lazdynėlis;RIEŠUTĖLIAI;9810842975;Ne;5;0;0;5
4672;Lazdynėlis;RIEŠUTĖLIAI;8179584161;Ne;0;1;1;2
4673;Lazdynėlis;RIEŠUTĖLIAI;3239107488;Ne;0;4;0;4
4674;Lazdynėlis;RIEŠUTĖLIAI;4055450300;Ne;7;0;0;7
4675;Lazdynėlis;RIEŠUTĖLIAI;8942906327;Ne;10;1;0;11
4676;Lazdynėlis;RIEŠUTĖLIAI;3362193379;Ne;5;1;0;6
4677;Lazdynėlis;RIEŠUTĖLIAI;9582702244;Taip;3;1;0;4
4678;Lazdynėlis;RIEŠUTĖLIAI;3062924645;Ne;0;1;0;1
4679;Lazdynėlis;RIEŠUTĖLIAI;3667994076;Ne;3;1;0;4
4680;Lazdynėlis;RIEŠUTĖLIAI;1668899344;Ne;6;1;2;9
4681;Lazdynėlis;RIEŠUTĖLIAI;4092363029;Ne;10;4;0;14
4682;Lazdynėlis;RIEŠUTĖLIAI;3250913116;Ne;12;0;0;12
4683;Lazdynėlis;RIEŠUTĖLIAI;8529192130;Ne;15;0;0;15
4684;Lazdynėlis;RIEŠUTĖLIAI;7719697394;Ne;5;4;0;9
4685;Lazdynėlis;ANČIUKAI;9519409694;Ne;5;0;0;5
4686;Lazdynėlis;ANČIUKAI;2526260625;Ne;5;0;0;5
4687;Lazdynėlis;ANČIUKAI;8340712398;Ne;3;0;0;3
4688;Lazdynėlis;ANČIUKAI;6031442797;Ne;0;10;0;10
4689;Lazdynėlis;ANČIUKAI;7552873109;Ne;7;0;0;7
4690;Lazdynėlis;ANČIUKAI;7655218276;Ne;0;1;0;1
4691;Lazdynėlis;ANČIUKAI;7561833526;Ne;7;0;0;7
4692;Lazdynėlis;ANČIUKAI;6817162699;Ne;6;4;0;10
4693;Lazdynėlis;ANČIUKAI;2294873565;Ne;12;0;0;12
4694;Lazdynėlis;ANČIUKAI;1499729462;Ne;6;1;0;7
4695;Lazdynėlis;ANČIUKAI;4745610579;Ne;4;1;0;5
4696;Lazdynėlis;ANČIUKAI;8530159773;Ne;3;0;0;3
4697;Lazdynėlis;ANČIUKAI;3036055537;Ne;3;0;0;3
4698;Lazdynėlis;ANČIUKAI;2911152510;Ne;7;0;1;8
4699;Lazdynėlis;ANČIUKAI;2933025284;Ne;10;0;0;10
4700;Lazdynėlis;ANČIUKAI;5832624944;Ne;0;0;4;4
4701;Lazdynėlis;ANČIUKAI;1168433014;Ne;4;4;1;9
4702;Lazdynėlis;ANČIUKAI;3764854654;Ne;6;0;0;6
4703;Lazdynėlis;ANČIUKAI;1961540377;Ne;5;0;0;5
4704;Lazdynėlis;GUDRUČIAI;4425724586;Ne;4;0;0;4
4705;Lazdynėlis;GUDRUČIAI;6684940385;Ne;6;0;1;7
4706;Lazdynėlis;GUDRUČIAI;9187681789;Ne;0;0;4;4
4707;Lazdynėlis;GUDRUČIAI;18498032472;Ne;5;0;0;5
4708;Lazdynėlis;GUDRUČIAI;1852865534;Ne;9;0;0;9
4709;Lazdynėlis;GUDRUČIAI;7789345652;Ne;4;0;1;5
4710;Lazdynėlis;GUDRUČIAI;3902772678;Ne;0;6;0;6
4711;Lazdynėlis;GUDRUČIAI;8822378464;Ne;9;0;0;9
4712;Lazdynėlis;GUDRUČIAI;2441835588;Ne;0;4;1;5
4713;Lazdynėlis;GUDRUČIAI;2603427970;Ne;0;20;0;20
4714;Lazdynėlis;GUDRUČIAI;6762216509;Ne;0;1;1;2
4715;Lazdynėlis;GUDRUČIAI;6863715428;Ne;0;1;0;1
4716;Lazdynėlis;GUDRUČIAI;4779025603;Ne;12;0;1;13
4717;Lazdynėlis;GUDRUČIAI;44510351979;Ne;0;0;2;2
4718;Lazdynėlis;GUDRUČIAI;3043350186;Ne;0;1;0;1
4719;Lazdynėlis;GUDRUČIAI;5182241318;Ne;5;0;0;5
4720;Lazdynėlis;MEŠKIUKAI;4094713096;Ne;7;0;5;12
4721;Lazdynėlis;MEŠKIUKAI;4267469349;Ne;5;1;0;6
4722;Lazdynėlis;MEŠKIUKAI;5354852979;Ne;0;20;0;20
4723;Lazdynėlis;MEŠKIUKAI;3427972329;Ne;8;0;0;8
4724;Lazdynėlis;MEŠKIUKAI;6941986839;Ne;10;0;1;11
4725;Lazdynėlis;MEŠKIUKAI;3697808826;Ne;6;0;0;6
4726;Lazdynėlis;MEŠKIUKAI;2812633983;Ne;0;4;0;4
4727;Lazdynėlis;MEŠKIUKAI;9590507486;Ne;13;0;0;13
4728;Lazdynėlis;MEŠKIUKAI;1488371861;Ne;0;0;2;2
4729;Lazdynėlis;MEŠKIUKAI;5982766841;Ne;0;20;0;20
4730;Lazdynėlis;MEŠKIUKAI;1984546310;Ne;2;0;0;2
4731;Lazdynėlis;MEŠKIUKAI;4408660083;Ne;0;20;0;20
4732;Lazdynėlis;MEŠKIUKAI;9930553716;Ne;5;0;0;5
4733;Lazdynėlis;MEŠKIUKAI;6831456807;Ne;10;0;0;10
4734;Lazdynėlis;MEŠKIUKAI;4795464133;Ne;4;0;0;4
4735;Lazdynėlis;MEŠKIUKAI;8567304224;Ne;9;0;0;9
4736;Lazdynėlis;MEŠKIUKAI;7754329238;Ne;10;1;0;11
4737;Lazdynėlis;MEŠKIUKAI;4366502064;Ne;15;0;0;15
4738;Lazdynėlis;MEŠKIUKAI;1331380925;Ne;0;20;0;20
4739;Liepsnelė;Ramunėlės;2251803207;Ne;10;0;0;10
4740;Liepsnelė;Ramunėlės;6566895135;Ne;11;0;0;11
4741;Liepsnelė;Ramunėlės;2522846125;Ne;6;0;0;6
4742;Liepsnelė;Ramunėlės;3467086136;Ne;5;0;0;5
4743;Liepsnelė;Ramunėlės;1214516126;Ne;20;0;0;20
4744;Liepsnelė;Ramunėlės;3982153133;Ne;10;0;0;10
4745;Liepsnelė;Zuikučiai;3708286263;Taip;5;0;0;5
4746;Liepsnelė;Zuikučiai;4321786654;Ne;3;0;0;3
4747;Liepsnelė;Zuikučiai;2968672487;Ne;6;0;0;6
4748;Liepsnelė;Zuikučiai;1125190558;Ne;5;0;0;5
4749;Liepsnelė;Zuikučiai;8082265078;Ne;4;0;0;4
4750;Liepsnelė;Zuikučiai;8112275531;Taip;15;0;0;15
4751;Liepsnelė;Nykštukai;1445328501;Ne;9;0;0;9
4752;Liepsnelė;Nykštukai;9993335478;Taip;5;0;0;5
4753;Liepsnelė;Nykštukai;8189699392;Taip;20;0;0;20
4754;Liepsnelė;Nykštukai;5909672361;Ne;5;0;0;5
4755;Liepsnelė;Žvirbliukai;7385890984;Taip;1;0;0;1
4756;Liepsnelė;Žvirbliukai;8080492986;Taip;15;0;0;15
4757;Liepsnelė;Žvirbliukai;7735063486;Taip;7;0;0;7
4758;Liepsnelė;Žvirbliukai;6860696706;Taip;10;0;0;10
4759;Liepsnelė;Žvirbliukai;1625321820;Taip;1;0;0;1
4760;Liepsnelė;Žvirbliukai;3382354753;Taip;6;0;0;6
4761;Liepsnelė;Žvirbliukai;9099285081;Taip;7;0;0;7
4762;Liepsnelė;Žvirbliukai;8592314279;Taip;15;0;0;15
4763;Liepsnelė;Žvirbliukai;2080374597;Ne;1;0;0;1
4764;Liepsnelė;Meškiukai;4922746328;Ne;6;0;0;6
4765;Liepsnelė;Meškiukai;4171233039;Ne;8;0;0;8
4766;Liepsnelė;Meškiukai;5138923652;Ne;17;0;0;17
4767;Liepsnelė;Meškiukai;2914113341;Ne;7;0;0;7
4768;Liepsnelė;Meškiukai;4850013650;Ne;5;0;0;5
4769;Liepsnelė;SAULUTĖ;9688635563;Ne;5;0;0;5
4770;Liepsnelė;SAULUTĖ;7853574888;Ne;1;0;0;1
4771;Liepsnelė;SAULUTĖ;4228034241;Ne;1;0;0;1
4772;Liepsnelė;SAULUTĖ;9864646484;Ne;4;0;0;4
4773;Liepsnelė;SAULUTĖ;9086156869;Ne;2;0;0;2
4774;Liepsnelė;SAULUTĖ;8598242099;Ne;2;0;0;2
4775;Liepsnelė;SAULUTĖ;7450403294;Ne;6;0;0;6
4776;Liepsnelė;Varpeliai;7001651895;Ne;1;0;0;1
4777;Liepsnelė;Varpeliai;1487219062;Ne;4;0;0;4
4778;Liepsnelė;Varpeliai;5692463151;Ne;10;0;0;10
4779;Liepsnelė;Varpeliai;7241069517;Ne;20;0;0;20
4780;Liepsnelė;"NAUJA NYKŠTUKAI";2020364455;Ne;7;0;0;7
4781;"Lokiuko giraitė";Bitutės;8470202629;Ne;7;0;0;7
4782;"Lokiuko giraitė";Bitutės;6973763551;Ne;9;0;0;9
4783;"Lokiuko giraitė";Bitutės;5347988495;Ne;4;0;0;4
4784;"Lokiuko giraitė";Bitutės;6738559650;Ne;1;0;0;1
4785;"Lokiuko giraitė";Bitutės;6915295500;Taip;6;0;0;6
4786;"Lokiuko giraitė";Bitutės;9831740217;Ne;5;0;0;5
4787;"Lokiuko giraitė";Bitutės;7623355797;Taip;5;0;0;5
4788;"Lokiuko giraitė";Bitutės;4804487551;Ne;20;0;0;20
4789;"Lokiuko giraitė";Bitutės;5548132297;Ne;1;0;0;1
4790;"Lokiuko giraitė";Geniukų;6095929896;Ne;5;0;0;5
4791;"Lokiuko giraitė";Geniukų;3295296911;Ne;7;0;0;7
4792;"Lokiuko giraitė";Geniukų;9035040416;Ne;2;0;0;2
4793;"Lokiuko giraitė";Geniukų;6125389516;Ne;13;0;0;13
4794;"Lokiuko giraitė";Drugelių;5675352600;Ne;6;0;0;6
4795;"Lokiuko giraitė";Drugelių;9228196983;Ne;13;0;0;13
4796;"Lokiuko giraitė";Drugelių;5965646232;Ne;5;0;0;5
4797;"Lokiuko giraitė";Drugelių;3398823531;Ne;5;0;0;5
4798;"Lokiuko giraitė";Drugelių;9298900399;Ne;6;0;0;6
4799;"Lokiuko giraitė";Drugelių;5529404234;Ne;4;0;0;4
4800;"Lokiuko giraitė";Drugelių;5162843908;Ne;9;0;0;9
4801;"Lokiuko giraitė";Gandriukų;4564299628;Ne;14;0;0;14
4802;"Lokiuko giraitė";Gandriukų;4290362680;Ne;8;0;0;8
4803;"Lokiuko giraitė";Gandriukų;3913627049;Ne;5;0;0;5
4804;"Lokiuko giraitė";Gandriukų;5287134614;Ne;18;0;0;18
4805;"Lokiuko giraitė";Gandriukų;3862009155;Ne;9;0;0;9
4806;"Lokiuko giraitė";Gandriukų;5828857219;Ne;17;0;0;17
4807;"Lokiuko giraitė";Gandriukų;8014344765;Ne;4;0;0;4
4808;"Lokiuko giraitė";Gandriukų;9589770383;Ne;5;0;0;5
4809;"Lokiuko giraitė";Gandriukų;3773650976;Ne;15;0;0;15
4810;"Lokiuko giraitė";Gandriukų;9951647177;Ne;5;0;0;5
4811;"Lokiuko giraitė";Gandriukų;5237221972;Ne;7;0;0;7
4812;"Lokiuko giraitė";Gandriukų;3485431151;Ne;6;0;0;6
4813;"Lokiuko giraitė";Gandriukų;5672634750;Ne;9;0;0;9
4814;"Lokiuko giraitė";Gandriukų;2027726779;Ne;5;0;0;5
4815;"Lokiuko giraitė";Gandriukų;1465289787;Ne;4;0;0;4
4816;"Lokiuko giraitė";Gandriukų;6544942054;Ne;20;0;0;20
4817;"Lokiuko giraitė";Žiogelių;9368545424;Ne;10;0;0;10
4818;"Lokiuko giraitė";Žiogelių;3661726552;Ne;1;0;0;1
4819;"Lokiuko giraitė";Žiogelių;4616888903;Ne;5;0;0;5
4820;"Lokiuko giraitė";Žiogelių;6230596088;Ne;4;0;0;4
4821;"Lokiuko giraitė";Žiogelių;7055713774;Ne;2;0;0;2
4822;"Lokiuko giraitė";Žiogelių;3436606327;Ne;5;0;0;5
4823;"Lokiuko giraitė";Žiogelių;7895015565;Ne;10;0;0;10
4824;"Lokiuko giraitė";Žiogelių;2577866452;Ne;9;0;0;9
4825;"Lokiuko giraitė";Žiogelių;1281994869;Ne;10;0;0;10
4826;"Lokiuko giraitė";Peliukų;8171877159;Ne;5;0;0;5
4827;"Lokiuko giraitė";Peliukų;2029494514;Ne;5;0;0;5
4828;"Lokiuko giraitė";Peliukų;5323186441;Ne;9;0;0;9
4829;"Lokiuko giraitė";Peliukų;8141761199;Ne;3;0;0;3
4830;"Lokiuko giraitė";Peliukų;8727861387;Ne;3;0;0;3
4831;"Lokiuko giraitė";Žvirbliukai;2794581101;Ne;1;0;0;1
4832;"Lokiuko giraitė";Žvirbliukai;6900530447;Ne;1;0;0;1
4833;"Lokiuko giraitė";Žvirbliukai;2279059666;Ne;6;0;0;6
4834;"Lokiuko giraitė";Žvirbliukai;1687118276;Ne;13;0;0;13
4835;"Lokiuko giraitė";Žvirbliukai;5973080803;Ne;6;0;0;6
4836;"Lokiuko giraitė";Žvirbliukai;7219983501;Ne;15;0;0;15
4837;"Lokiuko giraitė";Žvirbliukai;6054963934;Ne;3;0;0;3
4838;"Lokiuko giraitė";Žvirbliukai;9684079669;Ne;7;0;0;7
4839;"Lokiuko giraitė";Žvirbliukai;1993739216;Ne;10;0;0;10
4840;"Lokiuko giraitė";Žvirbliukai;7060764817;Ne;9;0;0;9
4841;"Lokiuko giraitė";Voveriukų;9729694481;Ne;5;0;0;5
4842;"Lokiuko giraitė";Voveriukų;8074894811;Ne;5;0;0;5
4843;"Lokiuko giraitė";Voveriukų;7052741895;Ne;4;0;0;4
4844;"Lokiuko giraitė";Voveriukų;9054344922;Ne;20;0;0;20
4845;"Lokiuko giraitė";Voveriukų;2107381850;Ne;3;0;0;3
4846;"Lokiuko giraitė";Voveriukų;22798205715;Ne;4;0;0;4
4847;"Lokiuko giraitė";PELĖDŽIUKŲ;7565904637;Ne;15;0;0;15
4848;"Lokiuko giraitė";PELĖDŽIUKŲ;7831508050;Ne;8;0;0;8
4849;"Lokiuko giraitė";PELĖDŽIUKŲ;8987725075;Ne;9;0;0;9
4850;"Lokiuko giraitė";PELĖDŽIUKŲ;8145004410;Ne;1;0;0;1
4851;"Lokiuko giraitė";PELĖDŽIUKŲ;2122113308;Ne;6;0;0;6
4852;"Lokiuko giraitė";PELĖDŽIUKŲ;5470393268;Ne;10;0;0;10
4853;"Lokiuko giraitė";PELĖDŽIUKŲ;8657413379;Ne;17;0;0;17
4854;"Lokiuko giraitė";PELĖDŽIUKŲ;9573469793;Ne;10;0;0;10
4855;"Lokiuko giraitė";PELĖDŽIUKŲ;7771717033;Ne;6;0;0;6
4856;"Lokiuko giraitė";PELĖDŽIUKŲ;2206053922;Ne;13;0;0;13
4857;"Lokiuko giraitė";KIŠKUČIŲ;6290161180;Ne;5;0;0;5
4858;"Lokiuko giraitė";KIŠKUČIŲ;4866185792;Ne;1;0;0;1
4859;"Lokiuko giraitė";KIŠKUČIŲ;3639606607;Ne;5;0;0;5
4860;"Lokiuko giraitė";KIŠKUČIŲ;3369075194;Ne;11;0;0;11
4861;"Lokiuko giraitė";KIŠKUČIŲ;9258315961;Ne;9;0;0;9
4862;"Lokiuko giraitė";KIŠKUČIŲ;3030459495;Ne;15;0;0;15
4863;"Lokiuko giraitė";KIŠKUČIŲ;5831978563;Ne;11;0;0;11
4864;"Lokiuko giraitė";KIŠKUČIŲ;1524540555;Ne;11;0;0;11
4865;"Lokiuko giraitė";KIŠKUČIŲ;9147204346;Ne;2;0;0;2
4866;"Lokiuko giraitė";BORUŽĖLIŲ;1143490905;Ne;2;0;0;2
4867;"Lokiuko giraitė";BORUŽĖLIŲ;5637511762;Ne;10;0;0;10
4868;"Lokiuko giraitė";BORUŽĖLIŲ;9130870709;Ne;6;0;0;6
4869;"Lokiuko giraitė";BORUŽĖLIŲ;3704421499;Ne;8;0;0;8
4870;"Lokiuko giraitė";BORUŽĖLIŲ;2089603988;Ne;4;0;0;4
4871;"Lokiuko giraitė";BORUŽĖLIŲ;5789004218;Ne;13;0;0;13
4872;"Lokiuko giraitė";BORUŽĖLIŲ;6154474857;Ne;1;0;0;1
4873;"Lokiuko giraitė";BORUŽĖLIŲ;5859480264;Ne;7;0;0;7
4874;"Lokiuko giraitė";BORUŽĖLIŲ;5496859463;Ne;8;0;0;8
4875;"Lokiuko giraitė";BORUŽĖLIŲ;4546969048;Ne;1;0;0;1
4876;"Lokiuko giraitė";BORUŽĖLIŲ;2908267390;Ne;5;0;0;5
4877;"Lokiuko giraitė";BORUŽĖLIŲ;9825715354;Ne;2;0;0;2
4878;"Lokiuko giraitė";BORUŽĖLIŲ;7102572343;Ne;4;0;0;4
4879;"Lokiuko giraitė";BORUŽĖLIŲ;6688280083;Ne;9;0;0;9
4880;"Lokiuko giraitė";EŽIUKŲ;3050293683;Ne;9;0;0;9
4881;"Lokiuko giraitė";EŽIUKŲ;3197512550;Ne;9;0;0;9
4882;"Lokiuko giraitė";EŽIUKŲ;8075543297;Ne;2;0;0;2
4883;"Lokiuko giraitė";EŽIUKŲ;7039944214;Ne;7;0;0;7
4884;"Lokiuko giraitė";EŽIUKŲ;2120529003;Ne;6;0;0;6
4885;"Lokiuko giraitė";EŽIUKŲ;2937626709;Ne;12;0;0;12
4886;"Lokiuko giraitė";EŽIUKŲ;8340163564;Ne;7;0;0;7
4887;"Lokiuko giraitė";EŽIUKŲ;5101863426;Ne;7;0;0;7
4888;"Lokiuko giraitė";EŽIUKŲ;1461506496;Ne;9;0;0;9
4889;"Lokiuko giraitė";EŽIUKŲ;3948450076;Ne;10;0;0;10
4890;"Lokiuko giraitė";EŽIUKŲ;3621289572;Ne;8;0;0;8
4891;"Lokiuko giraitė";EŽIUKŲ;5528253378;Ne;13;0;0;13
4892;"Lokiuko giraitė";EŽIUKŲ;6809921415;Ne;5;0;0;5
4893;"Lokiuko giraitė";EŽIUKŲ;4719679127;Ne;16;0;0;16
4894;Markučiai;Žirniukų;3525681034;Ne;7;3;0;10
4895;Markučiai;Žirniukų;7312533881;Ne;8;3;0;11
4896;Markučiai;Žirniukų;5250815223;Ne;0;0;1;1
4897;Markučiai;Žirniukų;8934965409;Ne;0;3;0;3
4898;Markučiai;Žirniukų;8360526946;Ne;25;4;0;29
4899;Markučiai;Žirniukų;2096169972;Ne;12;1;0;13
4900;Markučiai;Žirniukų;3073404128;Ne;0;4;0;4
4901;Markučiai;Žirniukų;6674351628;Ne;9;0;2;11
4902;Markučiai;Žirniukų;5614488534;Ne;5;0;0;5
4903;Markučiai;Žirniukų;2367999201;Ne;4;0;4;8
4904;Markučiai;Žirniukų;4242575616;Ne;5;3;0;8
4905;Markučiai;Žirniukų;4223653505;Ne;17;0;0;17
4906;Markučiai;Žirniukų;2099285475;Ne;13;0;17;30
4907;Markučiai;Žirniukų;2344252204;Ne;6;0;19;25
4908;Markučiai;Žirniukų;9576412366;Ne;5;0;0;5
4909;Markučiai;Žirniukų;1395241501;Ne;0;0;5;5
4910;Markučiai;Žirniukų;2526619144;Ne;5;1;0;6
4911;Markučiai;Nykštukų;7507551844;Ne;0;1;0;1
4912;Markučiai;Nykštukų;9545967631;Ne;3;0;0;3
4913;Markučiai;Nykštukų;6121911851;Ne;6;0;0;6
4914;Markučiai;Nykštukų;6898055631;Ne;10;1;0;11
4915;Markučiai;Nykštukų;3378749042;Ne;0;8;0;8
4916;Markučiai;Nykštukų;1884388847;Ne;0;3;0;3
4917;Markučiai;Nykštukų;5183244346;Ne;2;0;0;2
4918;Markučiai;Nykštukų;7624913025;Ne;5;4;0;9
4919;Markučiai;Nykštukų;4679710493;Ne;3;0;0;3
4920;Markučiai;Nykštukų;2994895532;Ne;5;0;0;5
4921;Markučiai;Nykštukų;4846899377;Ne;0;0;1;1
4922;Markučiai;Nykštukų;4150956779;Ne;1;1;0;2
4923;Markučiai;Nykštukų;4920107818;Ne;1;0;1;2
4924;Markučiai;Nykštukų;4222017733;Ne;1;0;0;1
4925;Markučiai;Nykštukų;3414015064;Ne;8;0;0;8
4926;Markučiai;Nykštukų;7642401516;Ne;0;0;1;1
4927;Markučiai;Nykštukų;8055783293;Ne;6;0;0;6
4928;Markučiai;Pelėdžiukų;9180404247;Ne;11;1;1;13
4929;Markučiai;Pelėdžiukų;3386071459;Ne;0;0;9;9
4930;Markučiai;Pelėdžiukų;4653663237;Ne;0;0;4;4
4931;Markučiai;Pelėdžiukų;5727655114;Ne;0;2;0;2
4932;Markučiai;Pelėdžiukų;6707310242;Ne;3;0;3;6
4933;Markučiai;Pelėdžiukų;7947287013;Ne;1;0;0;1
4934;Markučiai;Pelėdžiukų;4418580273;Ne;0;0;3;3
4935;Markučiai;Pelėdžiukų;5522654429;Ne;9;2;0;11
4936;Markučiai;Pelėdžiukų;7539605426;Ne;0;0;3;3
4937;Markučiai;Pelėdžiukų;8888538915;Ne;6;0;0;6
4938;Markučiai;Pelėdžiukų;1799946177;Ne;5;0;0;5
4939;Markučiai;Pelėdžiukų;7809719827;Taip;0;0;1;1
4940;Markučiai;Pelėdžiukų;4860961508;Ne;1;4;0;5
4941;Markučiai;Pelėdžiukų;6260010822;Ne;1;1;1;3
4942;Markučiai;Pelėdžiukų;6569807889;Ne;0;4;0;4
4943;Markučiai;Pelėdžiukų;5269411010;Ne;0;0;3;3
4944;Markučiai;Boružėlių;1171899107;Ne;0;0;4;4
4945;Markučiai;Boružėlių;8078777204;Ne;0;0;1;1
4946;Markučiai;Boružėlių;5902165968;Ne;0;0;3;3
4947;Markučiai;Boružėlių;5981692282;Ne;0;2;0;2
4948;Markučiai;Boružėlių;3739566642;Ne;5;4;2;11
4949;Markučiai;Boružėlių;6868394315;Ne;0;3;0;3
4950;Markučiai;Boružėlių;5663147778;Ne;0;0;6;6
4951;Markučiai;Boružėlių;8271830626;Ne;5;0;0;5
4952;Markučiai;Boružėlių;8046320044;Ne;8;0;0;8
4953;Markučiai;Boružėlių;3315824027;Ne;0;11;1;12
4954;Markučiai;Boružėlių;2060024771;Ne;7;0;0;7
4955;Markučiai;Boružėlių;2539486337;Ne;0;2;0;2
4956;Markučiai;Boružėlių;5562960498;Ne;0;1;5;6
4957;Markučiai;Boružėlių;3296423510;Ne;0;2;1;3
4958;Markučiai;Boružėlių;2543313198;Ne;0;0;3;3
4959;Markučiai;Bitučių;8792524832;Ne;0;2;0;2
4960;Markučiai;Bitučių;1717624510;Ne;0;5;0;5
4961;Markučiai;Bitučių;9518247571;Ne;6;0;0;6
4962;Markučiai;Bitučių;4836298058;Ne;0;0;4;4
4963;Markučiai;Bitučių;9027071539;Ne;0;1;0;1
4964;Markučiai;Bitučių;8748794886;Ne;0;0;1;1
4965;Markučiai;Bitučių;8950442843;Ne;7;0;1;8
4966;Markučiai;Bitučių;2840564082;Ne;0;1;0;1
4967;Markučiai;Bitučių;3926993383;Ne;5;0;3;8
4968;Markučiai;Bitučių;6530101961;Ne;0;0;6;6
4969;Markučiai;Bitučių;1908302738;Ne;0;0;4;4
4970;Markučiai;Bitučių;7056367646;Ne;5;0;2;7
4971;Markučiai;Bitučių;8195584468;Ne;0;0;3;3
4972;Markučiai;Bitučių;2049497686;Ne;0;6;1;7
4973;Markučiai;Bitučių;8541042547;Ne;5;0;0;5
4974;Markučiai;Bitučių;1447116821;Ne;5;0;0;5
4975;Markučiai;Drugelių;2288910885;Ne;0;0;9;9
4976;Markučiai;Drugelių;3544565354;Ne;0;0;3;3
4977;Markučiai;Drugelių;6992161129;Ne;4;0;1;5
4978;Markučiai;Drugelių;5024860112;Ne;1;1;0;2
4979;Markučiai;Drugelių;9412129807;Ne;0;2;0;2
4980;Markučiai;Drugelių;6979218594;Ne;14;0;0;14
4981;Markučiai;Drugelių;3491734422;Ne;0;0;6;6
4982;Markučiai;Drugelių;3491734422;Ne;0;0;6;6
4983;Markučiai;Drugelių;3491734422;Ne;0;0;6;6
4984;Markučiai;Drugelių;3832641521;Ne;0;0;4;4
4985;Markučiai;Drugelių;4520724770;Ne;2;0;7;9
4986;Markučiai;Drugelių;9391866085;Ne;0;0;4;4
4987;Markučiai;Drugelių;4918717178;Ne;5;0;12;17
4988;Markučiai;Drugelių;2967726802;Ne;9;0;2;11
4989;Markučiai;Drugelių;6684544229;Ne;0;0;2;2
4990;Markučiai;Drugelių;8230148662;Ne;6;0;9;15
4991;Markučiai;Drugelių;3487571241;Ne;1;0;1;2
4992;Markučiai;Skruzdėliukų;8105747904;Ne;11;0;4;15
4993;Markučiai;Skruzdėliukų;6617799980;Ne;6;5;0;11
4994;Markučiai;Skruzdėliukų;7580249913;Ne;12;0;0;12
4995;Markučiai;Skruzdėliukų;2246646548;Ne;9;4;0;13
4996;Markučiai;Skruzdėliukų;9921530582;Ne;0;0;1;1
4997;Markučiai;Skruzdėliukų;6759427415;Ne;0;19;0;19
4998;Markučiai;Skruzdėliukų;4820576711;Ne;6;0;0;6
4999;Markučiai;Skruzdėliukų;1527620947;Ne;12;6;0;18
5000;Markučiai;Skruzdėliukų;8774323234;Ne;0;0;1;1
5001;Markučiai;Skruzdėliukų;7881183912;Ne;6;0;0;6
5002;Markučiai;Skruzdėliukų;9338996275;Ne;11;0;0;11
5003;Markučiai;Skruzdėliukų;5180034556;Ne;6;0;0;6
5004;Markučiai;Skruzdėliukų;4383128686;Ne;6;0;0;6
5005;Markučiai;Skruzdėliukų;1929417022;Ne;8;0;3;11
5006;Markučiai;ZUIKUČIŲ;82320812575;Ne;0;3;0;3
5007;Markučiai;ZUIKUČIŲ;4861535057;Ne;0;1;0;1
5008;Markučiai;ZUIKUČIŲ;11751635395;Ne;0;1;0;1
5009;Markučiai;ZUIKUČIŲ;8061880631;Ne;0;0;1;1
5010;Markučiai;ZUIKUČIŲ;1392582514;Ne;0;3;0;3
5011;Markučiai;ZUIKUČIŲ;7691410556;Ne;6;0;0;6
5012;Markučiai;ZUIKUČIŲ;6808291628;Ne;6;7;0;13
5013;Markučiai;ZUIKUČIŲ;5387571295;Ne;0;0;2;2
5014;Markučiai;ZUIKUČIŲ;3794643964;Ne;0;1;0;1
5015;Markučiai;ZUIKUČIŲ;91228262895;Ne;0;0;3;3
5016;Markučiai;ZUIKUČIŲ;8605357678;Ne;0;1;0;1
5017;Markučiai;ZUIKUČIŲ;6055058096;Ne;0;1;0;1
5018;Markučiai;ŽIOGELIŲ;3163226803;Ne;0;1;3;4
5019;Markučiai;ŽIOGELIŲ;1244026489;Ne;9;0;0;9
5020;Markučiai;ŽIOGELIŲ;54892037118;Ne;0;1;5;6
5021;Markučiai;ŽIOGELIŲ;1054802708;Ne;0;0;1;1
5022;Markučiai;ŽIOGELIŲ;1007919702;Ne;0;8;0;8
5023;Markučiai;ŽIOGELIŲ;1923521405;Ne;0;10;0;10
5024;Markučiai;ŽIOGELIŲ;1164386108;Ne;0;11;0;11
5025;Markučiai;ŽIOGELIŲ;3340385503;Taip;2;0;1;3
5026;Markučiai;ŽIOGELIŲ;23267867195;Ne;0;0;5;5
5027;Markučiai;Ežiukių;1827829954;Ne;0;3;0;3
5028;Markučiai;Ežiukių;4925856706;Ne;0;5;0;5
5029;Markučiai;Ežiukių;6570638672;Ne;0;6;0;6
5030;Markučiai;Ežiukių;5975331223;Ne;6;0;2;8
5031;Markučiai;Ežiukių;2687320408;Ne;0;1;0;1
5032;Markučiai;Ežiukių;8990923872;Ne;3;8;0;11
5033;Markučiai;Ežiukių;5246980173;Ne;4;0;0;4
5034;Markučiai;Ežiukių;6308368050;Ne;1;4;0;5
5035;Markučiai;Ežiukių;4249158803;Ne;6;0;0;6
5036;Markučiai;Ežiukių;5958705106;Ne;1;1;0;2
5037;Markučiai;Ežiukių;9059302464;Ne;0;0;2;2
5038;Markučiai;Ežiukių;2962530721;Ne;0;1;0;1
5039;Markučiai;Ežiukių;6574037877;Ne;19;0;0;19
5040;Markučiai;Ežiukių;5752762229;Ne;0;2;1;3
5041;Markučiai;Ežiukių;9789274040;Ne;0;6;0;6
5042;Mažylis;"4 PRIEŠMOKYKLINĖ GR.";9411559447;Ne;10;0;3;13
5043;Mažylis;"4 PRIEŠMOKYKLINĖ GR.";4503734408;Ne;0;0;13;13
5044;Mažylis;"4 PRIEŠMOKYKLINĖ GR.";38277640135;Ne;0;0;1;1
5045;Mažylis;"4 PRIEŠMOKYKLINĖ GR.";1663347167;Ne;10;0;2;12
5046;Mažylis;"4 PRIEŠMOKYKLINĖ GR.";6854350717;Ne;0;0;4;4
5047;Mažylis;"4 PRIEŠMOKYKLINĖ GR.";6920129837;Ne;0;0;1;1
5048;Mažylis;"4 PRIEŠMOKYKLINĖ GR.";4104052524;Ne;0;4;1;5
5049;Mažylis;"4 PRIEŠMOKYKLINĖ GR.";3860760654;Ne;0;0;2;2
5050;Mažylis;"4 PRIEŠMOKYKLINĖ GR.";3344476309;Ne;0;0;6;6
5051;Mažylis;"4 PRIEŠMOKYKLINĖ GR.";6851169340;Ne;5;0;0;5
5052;Mažylis;"4 PRIEŠMOKYKLINĖ GR.";3217527771;Ne;0;0;3;3
5053;Mažylis;"4 PRIEŠMOKYKLINĖ GR.";7416381505;Ne;4;0;2;6
5054;Mažylis;"4 PRIEŠMOKYKLINĖ GR.";1514640197;Ne;0;0;1;1
5055;Mažylis;"4 PRIEŠMOKYKLINĖ GR.";1002832487;Ne;0;0;3;3
5056;Mažylis;"4 PRIEŠMOKYKLINĖ GR.";9608529135;Ne;0;0;2;2
5057;Mažylis;"4 PRIEŠMOKYKLINĖ GR.";4645411379;Ne;5;0;0;5
5058;Mažylis;"3 DARŽELIO GR.";3081814579;Ne;0;0;6;6
5059;Mažylis;"3 DARŽELIO GR.";9401388775;Ne;0;0;8;8
5060;Mažylis;"3 DARŽELIO GR.";4817146074;Ne;11;0;0;11
5061;Mažylis;"3 DARŽELIO GR.";7106648054;Ne;0;0;1;1
5062;Mažylis;"3 DARŽELIO GR.";7652390515;Ne;0;0;2;2
5063;Mažylis;"3 DARŽELIO GR.";8639480781;Ne;0;0;3;3
5064;Mažylis;"3 DARŽELIO GR.";9341935211;Ne;14;0;1;15
5065;Mažylis;"3 DARŽELIO GR.";2989562406;Ne;9;0;1;10
5066;Mažylis;"3 DARŽELIO GR.";1151737098;Ne;14;0;1;15
5067;Mažylis;"3 DARŽELIO GR.";7642914458;Ne;5;1;0;6
5068;Mažylis;"3 DARŽELIO GR.";5938312001;Ne;0;0;2;2
5069;Mažylis;"3 DARŽELIO GR.";2119733659;Ne;0;0;1;1
5070;Mažylis;"3 DARŽELIO GR.";3126627913;Taip;4;4;5;13
5071;Mažylis;"3 DARŽELIO GR.";2319506343;Ne;4;0;3;7
5072;Mažylis;"3 DARŽELIO GR.";9416161833;Ne;7;0;3;10
5073;Mažylis;"6 DARŽELIO GR.";5388105083;Ne;0;0;2;2
5074;Mažylis;"6 DARŽELIO GR.";8589124394;Ne;0;0;11;11
5075;Mažylis;"6 DARŽELIO GR.";9479398581;Ne;5;0;1;6
5076;Mažylis;"6 DARŽELIO GR.";1381828313;Ne;6;0;1;7
5077;Mažylis;"6 DARŽELIO GR.";7725286603;Ne;10;0;3;13
5078;Mažylis;"6 DARŽELIO GR.";7754956214;Ne;0;0;1;1
5079;Mažylis;"6 DARŽELIO GR.";3615636349;Ne;5;0;1;6
5080;Mažylis;"6 DARŽELIO GR.";9894955253;Ne;0;0;2;2
5081;Mažylis;"6 DARŽELIO GR.";6270840529;Ne;5;0;4;9
5082;Mažylis;"6 DARŽELIO GR.";4100492642;Ne;6;0;7;13
5083;Mažylis;"6 DARŽELIO GR.";5569913242;Ne;6;0;0;6
5084;Mažylis;"6 DARŽELIO GR.";6492768766;Ne;9;0;1;10
5085;Mažylis;"6 DARŽELIO GR.";6423910850;Ne;6;0;0;6
5086;Mažylis;"6 DARŽELIO GR.";1555305826;Ne;0;0;1;1
5087;Mažylis;"6 DARŽELIO GR.";5977423702;Ne;11;0;1;12
5088;Mažylis;"6 DARŽELIO GR.";9562863405;Ne;0;0;4;4
5089;Mažylis;"6 DARŽELIO GR.";5990843024;Ne;5;0;2;7
5090;Mažylis;"6 DARŽELIO GR.";9981751097;Ne;0;0;4;4
5091;Mažylis;"1 NAUJA (LOPŠELIS)";7037435201;Ne;0;0;1;1
5092;Mažylis;"1 NAUJA (LOPŠELIS)";4985161657;Ne;7;0;0;7
5093;Mažylis;"1 NAUJA (LOPŠELIS)";5297935198;Ne;12;1;1;14
5094;Mažylis;"1 NAUJA (LOPŠELIS)";1993916098;Ne;6;0;1;7
5095;Mažylis;"1 NAUJA (LOPŠELIS)";5727207294;Ne;7;0;0;7
5096;Mažylis;"1 NAUJA (LOPŠELIS)";3064367996;Ne;0;4;0;4
5097;Mažylis;"1 NAUJA (LOPŠELIS)";7810360699;Ne;0;20;0;20
5098;Mažylis;"1 NAUJA (LOPŠELIS)";3911343193;Ne;0;0;4;4
5099;Mažylis;"1 NAUJA (LOPŠELIS)";8259994523;Ne;12;0;0;12
5100;Mažylis;"1 NAUJA (LOPŠELIS)";6500577246;Ne;5;0;3;8
5101;Mažylis;"1 NAUJA (LOPŠELIS)";4201114033;Ne;6;0;1;7
5102;Mažylis;"1 NAUJA (LOPŠELIS)";8871998701;Ne;0;0;11;11
5103;Mažylis;"1 NAUJA (LOPŠELIS)";4347489809;Ne;4;0;6;10
5104;Mažylis;"1 NAUJA (LOPŠELIS)";4557902728;Ne;5;0;0;5
5105;Mažylis;"5 DARŽELIO GR.";2935175014;Ne;1;0;7;8
5106;Mažylis;"5 DARŽELIO GR.";6162880220;Ne;0;0;5;5
5107;Mažylis;"5 DARŽELIO GR.";1762105763;Ne;0;0;6;6
5108;Mažylis;"5 DARŽELIO GR.";2672500259;Ne;0;0;5;5
5109;Mažylis;"5 DARŽELIO GR.";8135596731;Ne;0;0;5;5
5110;Mažylis;"5 DARŽELIO GR.";8866980930;Ne;4;1;1;6
5111;Mažylis;"5 DARŽELIO GR.";2704741847;Ne;0;0;2;2
5112;Mažylis;"5 DARŽELIO GR.";9447747294;Taip;0;0;9;9
5113;Mažylis;"5 DARŽELIO GR.";4542742002;Ne;0;0;6;6
5114;Mažylis;"5 DARŽELIO GR.";4553092508;Ne;0;0;1;1
5115;Mažylis;"5 DARŽELIO GR.";8297427176;Ne;0;1;2;3
5116;Mažylis;"5 DARŽELIO GR.";6009637985;Ne;5;0;1;6
5117;Mažylis;"5 DARŽELIO GR.";5870983755;Ne;0;0;2;2
5118;Mažylis;"5 DARŽELIO GR.";8999239172;Ne;0;0;10;10
5119;Mažylis;"5 DARŽELIO GR.";3365026025;Ne;0;0;1;1
5120;Mažylis;"DARŽELIS 2 GR.";2795618410;Ne;0;0;4;4
5121;Mažylis;"DARŽELIS 2 GR.";9727982334;Ne;0;0;1;1
5122;Mažylis;"DARŽELIS 2 GR.";8655053217;Ne;9;0;0;9
5123;Mažylis;"DARŽELIS 2 GR.";7414398772;Taip;0;0;9;9
5124;Mažylis;"DARŽELIS 2 GR.";1058725505;Ne;9;0;0;9
5125;Mažylis;"DARŽELIS 2 GR.";1219174313;Ne;16;0;0;16
5126;Mažylis;"DARŽELIS 2 GR.";9111101357;Ne;3;0;7;10
5127;Mažylis;"DARŽELIS 2 GR.";1533948576;Ne;0;0;5;5
5128;Mažylis;"DARŽELIS 2 GR.";6272047137;Ne;0;1;1;2
5129;Mažylis;"DARŽELIS 2 GR.";7255856938;Ne;0;0;13;13
5130;Mažylis;"DARŽELIS 2 GR.";4987487972;Ne;14;0;0;14
5131;Mažylis;"DARŽELIS 2 GR.";9555408203;Ne;4;0;1;5
5132;Mažylis;"DARŽELIS 2 GR.";5165268747;Ne;4;0;3;7
5133;Mažylis;"DARŽELIS 2 GR.";2425437724;Ne;0;0;13;13
5134;Mažylis;"DARŽELIS 2 GR.";2723677422;Ne;2;0;2;4
5135;Mažylis;"DARŽELIS 2 GR.";9875575387;Ne;4;0;2;6
5136;Mažylis;"DARŽELIS 2 GR.";5658868407;Ne;0;0;1;1
5137;Mažylis;"DARŽELIS 2 GR.";9025867358;Ne;0;0;6;6
5138;Medynėlis;BITUTĖS;6238256156;Ne;0;3;0;3
5139;Medynėlis;BITUTĖS;8711567312;Ne;3;0;1;4
5140;Medynėlis;BITUTĖS;2993705115;Ne;0;2;3;5
5141;Medynėlis;BITUTĖS;1504612730;Ne;3;1;2;6
5142;Medynėlis;BITUTĖS;5522261530;Ne;0;6;0;6
5143;Medynėlis;BITUTĖS;6576401514;Ne;0;0;1;1
5144;Medynėlis;BITUTĖS;4107846958;Taip;4;1;0;5
5145;Medynėlis;BITUTĖS;7296044569;Ne;6;1;1;8
5146;Medynėlis;BITUTĖS;4418330478;Ne;6;0;1;7
5147;Medynėlis;BITUTĖS;6074296305;Ne;0;1;0;1
5148;Medynėlis;BITUTĖS;6815521895;Ne;0;0;3;3
5149;Medynėlis;BITUTĖS;4374464298;Ne;15;0;0;15
5150;Medynėlis;BITUTĖS;8107171123;Ne;2;2;0;4
5151;Medynėlis;BITUTĖS;4545707752;Ne;3;0;1;4
5152;Medynėlis;BITUTĖS;4419503239;Ne;5;0;0;5
5153;Medynėlis;BITUTĖS;7870261906;Ne;2;1;4;7
5154;Medynėlis;BITUTĖS;6466874318;Taip;0;3;0;3
5155;Medynėlis;BITUTĖS;2798305000;Ne;6;2;0;8
5156;Medynėlis;BITUTĖS;5440233814;Ne;4;0;0;4
5157;Medynėlis;BITUTĖS;4598267411;Ne;13;0;0;13
5158;Medynėlis;BITUTĖS;4243521511;Ne;0;0;1;1
5159;Medynėlis;DRUGELIAI;33981260502;Ne;0;0;4;4
5160;Medynėlis;DRUGELIAI;4581683292;Ne;0;4;0;4
5161;Medynėlis;DRUGELIAI;6343851636;Ne;0;6;0;6
5162;Medynėlis;DRUGELIAI;8948133343;Ne;0;1;0;1
5163;Medynėlis;DRUGELIAI;9413309043;Ne;0;2;0;2
5164;Medynėlis;DRUGELIAI;3773215372;Ne;6;2;0;8
5165;Medynėlis;DRUGELIAI;1795479738;Ne;1;6;0;7
5166;Medynėlis;DRUGELIAI;4024866819;Ne;1;0;0;1
5167;Medynėlis;DRUGELIAI;8775219704;Ne;0;1;0;1
5168;Medynėlis;DRUGELIAI;5269927048;Ne;0;3;0;3
5169;Medynėlis;DRUGELIAI;2540325264;Ne;6;1;0;7
5170;Medynėlis;DRUGELIAI;3870665108;Ne;0;6;0;6
5171;Medynėlis;DRUGELIAI;2794274146;Ne;1;0;0;1
5172;Medynėlis;SKRUZDĖLIUKAI;4783894465;Ne;5;1;1;7
5173;Medynėlis;SKRUZDĖLIUKAI;1142044361;Ne;4;0;0;4
5174;Medynėlis;SKRUZDĖLIUKAI;8719860414;Ne;10;0;1;11
5175;Medynėlis;SKRUZDĖLIUKAI;6802308420;Ne;2;1;0;3
5176;Medynėlis;SKRUZDĖLIUKAI;4645171858;Ne;1;0;2;3
5177;Medynėlis;SKRUZDĖLIUKAI;3947494044;Ne;0;2;1;3
5178;Medynėlis;SKRUZDĖLIUKAI;3295727210;Ne;5;3;0;8
5179;Medynėlis;SKRUZDĖLIUKAI;3761140697;Taip;16;0;0;16
5180;Medynėlis;SKRUZDĖLIUKAI;5330900656;Ne;18;0;0;18
5181;Medynėlis;SKRUZDĖLIUKAI;4897227188;Ne;10;0;4;14
5182;Medynėlis;SKRUZDĖLIUKAI;2339692406;Ne;5;0;0;5
5183;Medynėlis;SKRUZDĖLIUKAI;2433997383;Ne;3;1;0;4
5184;Medynėlis;SKRUZDĖLIUKAI;9705185906;Taip;1;0;0;1
5185;Medynėlis;SKRUZDĖLIUKAI;9873696787;Taip;13;0;0;13
5186;Medynėlis;SKRUZDĖLIUKAI;2218838971;Ne;0;0;11;11
5187;Medynėlis;SKRUZDĖLIUKAI;1206480760;Ne;12;0;0;12
5188;Medynėlis;VOVERIUKAI;6107849795;Taip;0;0;4;4
5189;Medynėlis;VOVERIUKAI;2627655353;Ne;1;0;3;4
5190;Medynėlis;VOVERIUKAI;5267128750;Ne;0;0;3;3
5191;Medynėlis;VOVERIUKAI;7638618099;Ne;2;1;3;6
5192;Medynėlis;VOVERIUKAI;4488439037;Ne;14;1;0;15
5193;Medynėlis;VOVERIUKAI;6101613567;Ne;0;0;2;2
5194;Medynėlis;VOVERIUKAI;1056744101;Ne;0;0;10;10
5195;Medynėlis;VOVERIUKAI;6485314750;Ne;5;0;4;9
5196;Medynėlis;VOVERIUKAI;7455041214;Ne;0;0;2;2
5197;Medynėlis;VOVERIUKAI;2234994999;Ne;0;4;0;4
5198;Medynėlis;VOVERIUKAI;3761845905;Taip;0;0;7;7
5199;Medynėlis;VOVERIUKAI;9825580191;Ne;0;0;1;1
5200;Medynėlis;VOVERIUKAI;7272017225;Taip;0;2;0;2
5201;Medynėlis;VOVERIUKAI;4092824377;Ne;4;7;0;11
5202;Medynėlis;VOVERIUKAI;1475701065;Ne;5;1;3;9
5203;Medynėlis;VOVERIUKAI;3674134340;Taip;6;0;0;6
5204;Medynėlis;VOVERIUKAI;5028189785;Taip;11;0;0;11
5205;Medynėlis;VOVERIUKAI;3235523199;Taip;1;0;5;6
5206;Medynėlis;VOVERIUKAI;2784942324;Taip;12;0;0;12
5207;Medynėlis;MEŠKIUKAI;7740591575;Ne;0;6;0;6
5208;Medynėlis;MEŠKIUKAI;9304002459;Ne;5;0;1;6
5209;Medynėlis;MEŠKIUKAI;5586407412;Ne;10;0;0;10
5210;Medynėlis;MEŠKIUKAI;90556319090;Ne;0;1;2;3
5211;Medynėlis;MEŠKIUKAI;9800678364;Ne;1;0;5;6
5212;Medynėlis;MEŠKIUKAI;2057309788;Ne;0;0;5;5
5213;Medynėlis;MEŠKIUKAI;5982453884;Ne;0;0;2;2
5214;Medynėlis;MEŠKIUKAI;2310200034;Ne;0;2;0;2
5215;Medynėlis;MEŠKIUKAI;1750775033;Taip;5;1;0;6
5216;Medynėlis;MEŠKIUKAI;9123873119;Ne;0;0;1;1
5217;Medynėlis;MEŠKIUKAI;2335108073;Ne;0;2;1;3
5218;Medynėlis;MEŠKIUKAI;1237589979;Ne;0;0;2;2
5219;Medynėlis;MEŠKIUKAI;1820113382;Ne;1;2;0;3
5220;Medynėlis;MEŠKIUKAI;6406459222;Ne;10;0;0;10
5221;Medynėlis;MEŠKIUKAI;4985243068;Taip;8;0;2;10
5222;Medynėlis;MEŠKIUKAI;7108619017;Ne;0;0;3;3
5223;Medynėlis;MEŠKIUKAI;6999562417;Ne;4;1;0;5
5224;Medynėlis;MEŠKIUKAI;7140184593;Ne;0;1;1;2
5225;Medynėlis;MEŠKIUKAI;3141225891;Taip;0;0;4;4
5226;Medynėlis;PELĖDŽIUKAI;2932544910;Ne;0;1;0;1
5227;Medynėlis;PELĖDŽIUKAI;9079900803;Ne;4;1;5;10
5228;Medynėlis;PELĖDŽIUKAI;5571641847;Ne;4;0;0;4
5229;Medynėlis;PELĖDŽIUKAI;9184868565;Ne;9;0;0;9
5230;Medynėlis;PELĖDŽIUKAI;6706028300;Ne;0;1;0;1
5231;Medynėlis;PELĖDŽIUKAI;6955467123;Ne;1;0;0;1
5232;Medynėlis;PELĖDŽIUKAI;6073797962;Taip;10;3;0;13
5233;Medynėlis;PELĖDŽIUKAI;5785463517;Ne;5;0;0;5
5234;Medynėlis;PELĖDŽIUKAI;4222917765;Ne;0;1;0;1
5235;Medynėlis;PELĖDŽIUKAI;9438854582;Ne;2;0;7;9
5236;Medynėlis;PELĖDŽIUKAI;3856908872;Ne;5;0;0;5
5237;Medynėlis;PELĖDŽIUKAI;2702814930;Ne;0;0;2;2
5238;Medynėlis;BORUŽIUKAI;3787172254;Ne;0;2;0;2
5239;Medynėlis;BORUŽIUKAI;7232396755;Ne;4;0;0;4
5240;Medynėlis;BORUŽIUKAI;7651663404;Ne;16;0;0;16
5241;Medynėlis;BORUŽIUKAI;1463263793;Ne;1;3;0;4
5242;Medynėlis;BORUŽIUKAI;9764215406;Ne;0;0;2;2
5243;Medynėlis;BORUŽIUKAI;5532880670;Ne;0;14;3;17
5244;Medynėlis;BORUŽIUKAI;1333848517;Ne;0;0;4;4
5245;Medynėlis;BORUŽIUKAI;9919108302;Ne;14;2;0;16
5246;Medynėlis;BORUŽIUKAI;1162859552;Ne;4;5;0;9
5247;Medynėlis;BORUŽIUKAI;6032067904;Ne;7;0;0;7
5248;Medynėlis;BORUŽIUKAI;4315717555;Ne;0;5;0;5
5249;Medynėlis;BORUŽIUKAI;8276864168;Taip;9;0;1;10
5250;Medynėlis;BORUŽIUKAI;5544663829;Ne;0;1;0;1
5251;Medynėlis;BORUŽIUKAI;2701448160;Ne;11;0;0;11
5252;Medynėlis;BORUŽIUKAI;1658457155;Ne;0;0;2;2
5253;Medynėlis;BORUŽIUKAI;8074251036;Ne;14;2;0;16
5254;Medynėlis;BORUŽIUKAI;5158507933;Ne;2;0;0;2
5255;Medynėlis;BORUŽIUKAI;2097758483;Ne;0;7;0;7
5256;Medynėlis;BORUŽIUKAI;4267654911;Taip;3;0;2;5
5257;Medynėlis;EŽIUKAI;9729505759;Ne;0;12;0;12
5258;Medynėlis;EŽIUKAI;8125271445;Ne;9;3;0;12
5259;Medynėlis;EŽIUKAI;9847006679;Ne;10;0;1;11
5260;Medynėlis;EŽIUKAI;7317307957;Ne;13;0;3;16
5261;Medynėlis;EŽIUKAI;7860869675;Ne;10;0;0;10
5262;Medynėlis;EŽIUKAI;4471168173;Ne;0;0;6;6
5263;Medynėlis;EŽIUKAI;1062269215;Ne;9;3;0;12
5264;Medynėlis;EŽIUKAI;5197757730;Taip;5;0;0;5
5265;Medynėlis;EŽIUKAI;5333502849;Ne;0;0;8;8
5266;Medynėlis;EŽIUKAI;6536626390;Ne;10;0;1;11
5267;Medynėlis;EŽIUKAI;8953622684;Ne;6;4;0;10
5268;Medynėlis;EŽIUKAI;3230747109;Ne;7;0;0;7
5269;Medynėlis;EŽIUKAI;8609650186;Ne;13;0;0;13
5270;Medynėlis;EŽIUKAI;6826409129;Ne;15;0;0;15
5271;Medynėlis;EŽIUKAI;2929100410;Ne;9;0;1;10
5272;Medynėlis;EŽIUKAI;6359536923;Ne;5;0;0;5
5273;Medynėlis;EŽIUKAI;2676262920;Ne;0;0;2;2
5274;Medynėlis;EŽIUKAI;5339084041;Taip;6;0;1;7
5275;Medynėlis;EŽIUKAI;5766492584;Ne;0;0;7;7
5276;Medynėlis;EŽIUKAI;8838774666;Ne;20;0;0;20
5277;Medynėlis;EŽIUKAI;6349817783;Ne;15;0;0;15
5278;Medynėlis;ZUIKUČIAI;6614028601;Ne;2;0;0;2
5279;Medynėlis;ZUIKUČIAI;8439619837;Ne;11;0;3;14
5280;Medynėlis;ZUIKUČIAI;5389909872;Ne;0;2;0;2
5281;Medynėlis;ZUIKUČIAI;9352391583;Ne;0;0;1;1
5282;Medynėlis;ZUIKUČIAI;4941353702;Ne;1;0;1;2
5283;Medynėlis;ZUIKUČIAI;4040542730;Ne;0;10;0;10
5284;Medynėlis;ZUIKUČIAI;6989524053;Ne;3;0;5;8
5285;Medynėlis;ZUIKUČIAI;9774213537;Ne;0;0;3;3
5286;Medynėlis;ZUIKUČIAI;9977590259;Ne;0;2;9;11
5287;Medynėlis;ZUIKUČIAI;7170801214;Ne;0;0;3;3
5288;Medynėlis;ZUIKUČIAI;9373849916;Ne;9;0;0;9
5289;Medynėlis;ZUIKUČIAI;6462589513;Ne;0;1;0;1
5290;Medynėlis;ZUIKUČIAI;4204366008;Ne;0;1;0;1
5291;Medynėlis;ZUIKUČIAI;6569938649;Ne;10;0;2;12
5292;Medynėlis;ZUIKUČIAI;3480190692;Taip;12;0;0;12
5293;Medynėlis;ZUIKUČIAI;5581973770;Ne;0;0;5;5
5294;Medynėlis;KAČIUKAI;5302122600;Ne;0;0;5;5
5295;Medynėlis;KAČIUKAI;6609111216;Ne;0;0;2;2
5296;Medynėlis;KAČIUKAI;6624835214;Ne;0;0;1;1
5297;Medynėlis;KAČIUKAI;2160081492;Ne;0;5;0;5
5298;Medynėlis;KAČIUKAI;4035587227;Ne;0;1;0;1
5299;Medynėlis;KAČIUKAI;8162771849;Ne;0;0;9;9
5300;Medynėlis;KAČIUKAI;9725019515;Ne;6;0;1;7
5301;Medynėlis;KAČIUKAI;3185760752;Ne;1;0;0;1
5302;Medynėlis;KAČIUKAI;6282113738;Ne;0;0;5;5
5303;Medynėlis;KAČIUKAI;4153545500;Ne;0;10;0;10
5304;Medynėlis;KAČIUKAI;8299034970;Ne;8;0;0;8
5305;Medynėlis;KAČIUKAI;1668143166;Ne;0;0;6;6
5306;Medynėlis;KAČIUKAI;4010058673;Ne;6;0;0;6
5307;Medynėlis;KAČIUKAI;9076139419;Ne;7;0;2;9
5308;Medynėlis;KAČIUKAI;1608019909;Ne;0;2;0;2
5309;Medynėlis;KAČIUKAI;1404831377;Ne;5;0;1;6
5310;Medynėlis;KAČIUKAI;2523474347;Ne;0;11;0;11
5311;Medynėlis;KAČIUKAI;7814008588;Ne;9;0;3;12
5312;Medynėlis;PELIUKAI;9290099536;Taip;0;0;3;3
5313;Medynėlis;PELIUKAI;1500986498;Ne;0;0;4;4
5314;Medynėlis;PELIUKAI;6924524346;Ne;1;1;0;2
5315;Medynėlis;PELIUKAI;6926408544;Ne;0;0;4;4
5316;Medynėlis;PELIUKAI;5391199861;Ne;5;0;0;5
5317;Medynėlis;PELIUKAI;6095795724;Ne;6;0;0;6
5318;Medynėlis;PELIUKAI;7914358405;Ne;4;1;0;5
5319;Medynėlis;PELIUKAI;3538656650;Ne;0;17;0;17
5320;Medynėlis;PELIUKAI;6993176904;Ne;5;0;0;5
5321;Medynėlis;PELIUKAI;2877881247;Ne;19;0;0;19
5322;Medynėlis;PELIUKAI;4145591997;Ne;9;1;0;10
5323;Medynėlis;PELIUKAI;8382537735;Ne;7;0;0;7
5324;Medynėlis;PELIUKAI;2816510180;Ne;7;0;0;7
5325;Medynėlis;PELIUKAI;3709984586;Ne;5;0;0;5
5326;Medynėlis;ANČIUKAI;9857514451;Ne;19;0;0;19
5327;Medynėlis;ANČIUKAI;6730475188;Ne;12;2;0;14
5328;Medynėlis;ANČIUKAI;6824842361;Ne;0;0;3;3
5329;Medynėlis;ANČIUKAI;5677747582;Ne;2;0;1;3
5330;Medynėlis;ANČIUKAI;4498233742;Ne;4;0;0;4
5331;Medynėlis;ANČIUKAI;5269794415;Ne;5;0;0;5
5332;Medynėlis;ANČIUKAI;5049081242;Ne;11;0;2;13
5333;Medynėlis;ANČIUKAI;4910857912;Ne;0;1;0;1
5334;Medynėlis;ANČIUKAI;4817353132;Ne;0;0;5;5
5335;Medynėlis;ANČIUKAI;7613699868;Taip;5;0;1;6
5336;Medynėlis;ANČIUKAI;9336656351;Ne;4;0;1;5
5337;Medynėlis;ANČIUKAI;7085226543;Ne;7;0;2;9
5338;Medynėlis;ANČIUKAI;1283602655;Ne;2;1;5;8
5339;Medynėlis;ANČIUKAI;3556203620;Ne;12;0;0;12
5340;Medynėlis;ANČIUKAI;2896713695;Ne;2;0;1;3
5341;Medynėlis;ANČIUKAI;4626655069;Ne;14;0;0;14
5342;Medynėlis;ANČIUKAI;5456045449;Ne;0;2;0;2
5343;Medynėlis;ANČIUKAI;8667441678;Ne;0;2;0;2
5344;Medynėlis;ANČIUKAI;6896823412;Ne;3;0;2;5
5345;Medynėlis;ANČIUKAI;6641009653;Ne;13;0;0;13
5346;Medynėlis;ANČIUKAI;8887092965;Ne;9;2;1;12
5347;Medynėlis;STIRNIUKAI;7488521058;Ne;5;0;0;5
5348;Medynėlis;LAPIUKAI;4328794578;Ne;2;0;0;2
5349;Molinukas;NYKŠTUKAI;6353165459;Ne;0;5;0;5
5350;Molinukas;NYKŠTUKAI;5876669121;Ne;8;0;0;8
5351;Molinukas;NYKŠTUKAI;6087698882;Ne;2;0;0;2
5352;Molinukas;NYKŠTUKAI;2211909678;Ne;10;3;0;13
5353;Molinukas;NYKŠTUKAI;2348120316;Ne;3;0;0;3
5354;Molinukas;NYKŠTUKAI;8053608348;Ne;0;0;1;1
5355;Molinukas;NYKŠTUKAI;6014990150;Ne;0;1;0;1
5356;Molinukas;NYKŠTUKAI;7623051674;Ne;5;1;0;6
5357;Molinukas;NYKŠTUKAI;9448910819;Ne;0;0;1;1
5358;Molinukas;NYKŠTUKAI;5580968328;Ne;9;0;0;9
5359;Molinukas;NYKŠTUKAI;4171978721;Ne;0;1;3;4
5360;Molinukas;NYKŠTUKAI;7134802574;Ne;0;0;1;1
5361;Molinukas;NYKŠTUKAI;8260101075;Ne;4;0;2;6
5362;Molinukas;NYKŠTUKAI;9244598883;Ne;4;0;0;4
5363;Molinukas;NYKŠTUKAI;5525772579;Ne;5;3;0;8
5364;Molinukas;NYKŠTUKAI;4475594896;Ne;10;3;0;13
5365;Molinukas;NYKŠTUKAI;7248705010;Ne;0;5;0;5
5366;Molinukas;NYKŠTUKAI;4101644021;Ne;0;5;0;5
5367;Molinukas;NYKŠTUKAI;6681397435;Ne;9;0;7;16
5368;Molinukas;ZUIKUČIŲ;9203375647;Ne;4;1;0;5
5369;Molinukas;ZUIKUČIŲ;2982968605;Ne;5;0;0;5
5370;Molinukas;ZUIKUČIŲ;8479427729;Ne;3;0;0;3
5371;Molinukas;ZUIKUČIŲ;4225457772;Ne;11;0;0;11
5372;Molinukas;ZUIKUČIŲ;8114735116;Ne;0;0;1;1
5373;Molinukas;ZUIKUČIŲ;5597119459;Ne;9;0;0;9
5374;Molinukas;ZUIKUČIŲ;8582985479;Ne;7;0;0;7
5375;Molinukas;ZUIKUČIŲ;8490020853;Ne;7;0;0;7
5376;Molinukas;ZUIKUČIŲ;2651732418;Ne;10;0;0;10
5377;Molinukas;ZUIKUČIŲ;1059002689;Ne;0;16;4;20
5378;Molinukas;ZUIKUČIŲ;5302191209;Ne;10;0;5;15
5379;Molinukas;ZUIKUČIŲ;1605039166;Ne;6;1;0;7
5380;Molinukas;ZUIKUČIŲ;6804127471;Ne;6;1;0;7
5381;Molinukas;ZUIKUČIŲ;4733315902;Ne;0;0;3;3
5382;Molinukas;ZUIKUČIŲ;2595941277;Ne;0;0;2;2
5383;Molinukas;ZUIKUČIŲ;2706981559;Ne;8;0;0;8
5384;Molinukas;ZUIKUČIŲ;6638634402;Ne;4;0;0;4
5385;Molinukas;ZUIKUČIŲ;4718396549;Ne;0;1;3;4
5386;Molinukas;ZUIKUČIŲ;3577613732;Ne;0;0;4;4
5387;Molinukas;ZUIKUČIŲ;9972204424;Ne;1;0;0;1
5388;Molinukas;ZUIKUČIŲ;3419958136;Ne;1;0;1;2
5389;Molinukas;SRAIGIUKŲ;1686122652;Ne;0;1;0;1
5390;Molinukas;SRAIGIUKŲ;9948685221;Ne;0;1;1;2
5391;Molinukas;SRAIGIUKŲ;6326031969;Ne;0;0;2;2
5392;Molinukas;SRAIGIUKŲ;6636118069;Ne;0;4;0;4
5393;Molinukas;SRAIGIUKŲ;7377137582;Ne;0;0;2;2
5394;Molinukas;SRAIGIUKŲ;6084682084;Ne;0;2;0;2
5395;Molinukas;SRAIGIUKŲ;8913137310;Ne;0;2;1;3
5396;Molinukas;SRAIGIUKŲ;5387818175;Ne;0;1;0;1
5397;Molinukas;SRAIGIUKŲ;1138255845;Ne;0;0;2;2
5398;Molinukas;SRAIGIUKŲ;8604288346;Ne;0;0;4;4
5399;Molinukas;SRAIGIUKŲ;4806350914;Ne;7;0;0;7
5400;Molinukas;SRAIGIUKŲ;8617979245;Ne;5;0;2;7
5401;Molinukas;SRAIGIUKŲ;2757744826;Ne;0;0;5;5
5402;Molinukas;SRAIGIUKŲ;4534279257;Ne;0;1;0;1
5403;Molinukas;SRAIGIUKŲ;4918181437;Ne;3;0;6;9
5404;Molinukas;SRAIGIUKŲ;7451224160;Ne;0;3;0;3
5405;Molinukas;SRAIGIUKŲ;8688180482;Ne;1;0;0;1
5406;Molinukas;SRAIGIUKŲ;1927843089;Ne;13;0;0;13
5407;Molinukas;VOVERIUKAI;3469196411;Ne;5;6;0;11
5408;Molinukas;VOVERIUKAI;8541456847;Ne;0;0;6;6
5409;Molinukas;VOVERIUKAI;2286586693;Ne;4;1;3;8
5410;Molinukas;VOVERIUKAI;6898958282;Ne;0;0;3;3
5411;Molinukas;VOVERIUKAI;5685582215;Ne;0;2;1;3
5412;Molinukas;VOVERIUKAI;2356814145;Ne;0;0;2;2
5413;Molinukas;VOVERIUKAI;7446607510;Ne;12;2;0;14
5414;Molinukas;VOVERIUKAI;9667704959;Ne;4;1;13;18
5415;Molinukas;VOVERIUKAI;3030169626;Ne;0;1;0;1
5416;Molinukas;VOVERIUKAI;3207373459;Ne;0;0;3;3
5417;Molinukas;VOVERIUKAI;4209143136;Ne;0;1;0;1
5418;Molinukas;VOVERIUKAI;5648861702;Ne;0;1;0;1
5419;Molinukas;VOVERIUKAI;4957226547;Ne;7;0;0;7
5420;Molinukas;VOVERIUKAI;8865966572;Ne;0;0;10;10
5421;Molinukas;VOVERIUKAI;4950808381;Ne;0;6;8;14
5422;Molinukas;VOVERIUKAI;7378643086;Ne;10;0;0;10
5423;Molinukas;VOVERIUKAI;2779700726;Ne;10;0;10;20
5424;Molinukas;VOVERIUKAI;6832647220;Ne;5;0;7;12
5425;Molinukas;VOVERIUKAI;9318837973;Ne;6;0;0;6
5426;Molinukas;VOVERIUKAI;8247270556;Ne;0;1;0;1
5427;Molinukas;ŽVIRBLIUKŲ;2935945686;Ne;0;1;0;1
5428;Molinukas;ŽVIRBLIUKŲ;7825545164;Ne;0;0;1;1
5429;Molinukas;ŽVIRBLIUKŲ;6190443233;Ne;0;1;2;3
5430;Molinukas;ŽVIRBLIUKŲ;1831078544;Taip;9;0;0;9
5431;Molinukas;ŽVIRBLIUKŲ;6531106368;Ne;9;0;0;9
5432;Molinukas;ŽVIRBLIUKŲ;4122429163;Ne;1;0;1;2
5433;Molinukas;ŽVIRBLIUKŲ;2862680065;Ne;0;1;0;1
5434;Molinukas;ŽVIRBLIUKŲ;3382913312;Ne;0;0;6;6
5435;Molinukas;ŽVIRBLIUKŲ;2448588784;Ne;16;0;4;20
5436;Molinukas;ŽVIRBLIUKŲ;2842168450;Ne;0;0;1;1
5437;Molinukas;KAČIUKŲ;1907287249;Ne;0;1;1;2
5438;Molinukas;KAČIUKŲ;1292778118;Ne;3;0;2;5
5439;Molinukas;KAČIUKŲ;8769667823;Ne;0;0;1;1
5440;Molinukas;KAČIUKŲ;8313486714;Ne;6;2;0;8
5441;Molinukas;KAČIUKŲ;3043679624;Ne;9;1;0;10
5442;Molinukas;KAČIUKŲ;2030429825;Taip;11;0;1;12
5443;Molinukas;KAČIUKŲ;4974513900;Ne;0;2;0;2
5444;Molinukas;KAČIUKŲ;6947938890;Ne;0;0;2;2
5445;Molinukas;KAČIUKŲ;1970929144;Ne;10;0;2;12
5446;Molinukas;KAČIUKŲ;3510936830;Ne;0;0;8;8
5447;Molinukas;KAČIUKŲ;8608465121;Ne;6;0;6;12
5448;Molinukas;KAČIUKŲ;1651103318;Ne;0;6;1;7
5449;"Naminukas (Smėlio g. 13)";Drugeliai;2395070574;Ne;5;1;0;6
5450;"Naminukas (Smėlio g. 13)";Drugeliai;5534073614;Ne;0;1;0;1
5451;"Naminukas (Smėlio g. 13)";Drugeliai;2132345627;Ne;0;1;0;1
5452;"Naminukas (Smėlio g. 13)";Drugeliai;1302119260;Ne;0;1;0;1
5453;"Naminukas (Smėlio g. 13)";Drugeliai;2864905392;Ne;0;9;0;9
5454;"Naminukas (Smėlio g. 13)";Drugeliai;7406775925;Ne;3;0;0;3
5455;"Naminukas (Smėlio g. 13)";Drugeliai;1333462200;Ne;9;0;0;9
5456;"Naminukas (Smėlio g. 13)";Drugeliai;5713661641;Ne;1;0;0;1
5457;"Naminukas (Smėlio g. 13)";Drugeliai;6581925461;Ne;0;3;0;3
5458;"Naminukas (Smėlio g. 13)";Drugeliai;3320805432;Ne;0;2;0;2
5459;"Naminukas (Smėlio g. 13)";Drugeliai;8141324449;Ne;11;0;0;11
5460;"Naminukas (Smėlio g. 13)";Drugeliai;8564586014;Ne;0;2;0;2
5461;"Naminukas (Smėlio g. 13)";Drugeliai;3236525642;Ne;0;1;0;1
5462;"Naminukas (Smėlio g. 13)";Drugeliai;7347998152;Ne;0;3;0;3
5463;"Naminukas (Smėlio g. 13)";Drugeliai;7272465847;Ne;8;0;2;10
5464;"Naminukas (Smėlio g. 13)";Drugeliai;7450368045;Ne;0;0;2;2
5465;"Naminukas (Smėlio g. 13)";Bitutės;4419568254;Ne;0;0;1;1
5466;"Naminukas (Smėlio g. 13)";Bitutės;1956749138;Ne;5;3;1;9
5467;"Naminukas (Smėlio g. 13)";Bitutės;6503569633;Ne;0;0;5;5
5468;"Naminukas (Smėlio g. 13)";Bitutės;3192885665;Ne;6;0;1;7
5469;"Naminukas (Smėlio g. 13)";Bitutės;9530232649;Ne;0;0;2;2
5470;"Naminukas (Smėlio g. 13)";Bitutės;8131328042;Ne;0;0;5;5
5471;"Naminukas (Smėlio g. 13)";Bitutės;1710002948;Ne;0;2;0;2
5472;"Naminukas (Smėlio g. 13)";Bitutės;3994190066;Ne;0;1;0;1
5473;"Naminukas (Smėlio g. 13)";Bitutės;5195078101;Ne;0;2;0;2
5474;"Naminukas (Smėlio g. 13)";Bitutės;9541388086;Ne;0;3;5;8
5475;"Naminukas (Smėlio g. 13)";Bitutės;2424412518;Ne;10;4;0;14
5476;"Naminukas (Smėlio g. 13)";Bitutės;5493709688;Ne;0;0;12;12
5477;"Naminukas (Smėlio g. 13)";Bitutės;2769848640;Ne;0;1;0;1
5478;"Naminukas (Smėlio g. 13)";Bitutės;9821244713;Ne;6;0;2;8
5479;"Naminukas (Smėlio g. 13)";Bitutės;7847923107;Ne;1;0;0;1
5480;"Naminukas (Smėlio g. 13)";Bitutės;4331408714;Ne;1;0;0;1
5481;"Naminukas (Smėlio g. 13)";Paukšteliai;3501921619;Ne;0;2;0;2
5482;"Naminukas (Smėlio g. 13)";Paukšteliai;5056487802;Ne;6;0;0;6
5483;"Naminukas (Smėlio g. 13)";Paukšteliai;3438010199;Ne;0;0;8;8
5484;"Naminukas (Smėlio g. 13)";Paukšteliai;4998565160;Ne;0;12;0;12
5485;"Naminukas (Smėlio g. 13)";Paukšteliai;9405784626;Ne;0;0;10;10
5486;"Naminukas (Smėlio g. 13)";Paukšteliai;2583886896;Ne;8;2;0;10
5487;"Naminukas (Smėlio g. 13)";Paukšteliai;4778385421;Ne;0;14;0;14
5488;"Naminukas (Smėlio g. 13)";Paukšteliai;1406418130;Ne;9;0;0;9
5489;"Naminukas (Smėlio g. 13)";Paukšteliai;9891722891;Ne;0;5;0;5
5490;"Naminukas (Smėlio g. 13)";Paukšteliai;2012656186;Ne;0;0;5;5
5491;"Naminukas (Smėlio g. 13)";Paukšteliai;8470716196;Ne;1;0;0;1
5492;"Naminukas (Smėlio g. 13)";Paukšteliai;3727828033;Ne;0;10;0;10
5493;"Naminukas (Smėlio g. 13)";Paukšteliai;9657786543;Ne;0;0;1;1
5494;"Naminukas (Smėlio g. 13)";Paukšteliai;2652538212;Ne;7;0;2;9
5495;"Naminukas (Smėlio g. 13)";"NYKŠTUKAI ";5849662446;Taip;0;1;0;1
5496;"Naminukas (Smėlio g. 13)";"NYKŠTUKAI ";5519447152;Ne;0;4;0;4
5497;"Naminukas (Smėlio g. 13)";"NYKŠTUKAI ";5741698937;Ne;9;0;0;9
5498;"Naminukas (Smėlio g. 13)";"NYKŠTUKAI ";1286329245;Ne;11;5;0;16
5499;"Naminukas (Smėlio g. 13)";"NYKŠTUKAI ";7717132979;Ne;0;12;0;12
5500;"Naminukas (Smėlio g. 13)";"NYKŠTUKAI ";3355811632;Ne;1;0;0;1
5501;"Naminukas (Smėlio g. 13)";"NYKŠTUKAI ";1618802271;Ne;0;0;7;7
5502;"Naminukas (Smėlio g. 13)";"NYKŠTUKAI ";1591540165;Ne;0;0;4;4
5503;"Naminukas (Smėlio g. 13)";"NYKŠTUKAI ";9537360943;Ne;5;0;0;5
5504;"Naminukas (Smėlio g. 13)";"NYKŠTUKAI ";1118193598;Ne;0;0;1;1
5505;"Naminukas (Smėlio g. 13)";"NYKŠTUKAI ";8102805098;Ne;7;0;4;11
5506;"Naminukas (Smėlio g. 13)";"NYKŠTUKAI ";9357758815;Ne;0;0;2;2
5507;"Naminukas (Smėlio g. 13)";"NYKŠTUKAI ";4422173848;Ne;0;0;1;1
5508;"Naminukas (Smėlio g. 13)";"NYKŠTUKAI ";1095955939;Ne;0;2;0;2
5509;Nykštukas;SMAGURIAI;8120626738;Taip;4;6;0;10
5510;Nykštukas;SMAGURIAI;9842748132;Ne;14;1;0;15
5511;Nykštukas;SMAGURIAI;4830484167;Taip;4;2;0;6
5512;Nykštukas;SMAGURIAI;1902253981;Taip;0;2;0;2
5513;Nykštukas;SMAGURIAI;4949895196;Taip;0;7;2;9
5514;Nykštukas;SMAGURIAI;9713859038;Taip;1;5;0;6
5515;Nykštukas;SMAGURIAI;7954996421;Taip;0;12;0;12
5516;Nykštukas;SMAGURIAI;4771072061;Taip;7;0;0;7
5517;Nykštukas;SMAGURIAI;5190754451;Taip;0;1;0;1
5518;Nykštukas;SMAGURIAI;8310484267;Ne;0;1;1;2
5519;Nykštukas;SMAGURIAI;1707956308;Taip;0;1;0;1
5520;Nykštukas;SMAGURIAI;8635571067;Taip;9;1;0;10
5521;Nykštukas;SMAGURIAI;9326131725;Taip;8;2;0;10
5522;Nykštukas;SMAGURIAI;2000207070;Taip;9;0;0;9
5523;Nykštukas;SMAGURIAI;2826079911;Taip;0;2;0;2
5524;Nykštukas;SMAGURIAI;7911842707;Taip;15;2;0;17
5525;Nykštukas;SMAGURIAI;6102907953;Taip;3;3;0;6
5526;Nykštukas;SMAGURIAI;7529677915;Taip;0;9;0;9
5527;Nykštukas;SMAGURIAI;4994727422;Taip;1;2;0;3
5528;Nykštukas;SMAGURIAI;3007541327;Taip;7;2;0;9
5529;Nykštukas;SMAGURIAI;9312935803;Taip;0;2;2;4
5530;Nykštukas;SMAGURIAI;3370000872;Taip;8;1;0;9
5531;Nykštukas;SMALSIUKAI;5121027981;Taip;8;0;0;8
5532;Nykštukas;SMALSIUKAI;6958596223;Ne;0;1;0;1
5533;Nykštukas;SMALSIUKAI;3002966681;Taip;9;2;0;11
5534;Nykštukas;SMALSIUKAI;4612171029;Taip;5;0;0;5
5535;Nykštukas;SMALSIUKAI;3120577264;Taip;5;2;0;7
5536;Nykštukas;SMALSIUKAI;1386798219;Taip;0;6;0;6
5537;Nykštukas;SMALSIUKAI;3852057722;Taip;0;1;0;1
5538;Nykštukas;SMALSIUKAI;2696384135;Taip;5;0;0;5
5539;Nykštukas;SMALSIUKAI;9532956150;Taip;5;0;0;5
5540;Nykštukas;SMALSIUKAI;3273579005;Taip;0;1;0;1
5541;Nykštukas;SMALSIUKAI;3985610575;Taip;0;6;0;6
5542;Nykštukas;SMALSIUKAI;8948554271;Taip;7;0;0;7
5543;Nykštukas;SMALSIUKAI;1102555964;Taip;0;1;0;1
5544;Nykštukas;SMALSIUKAI;4331906712;Taip;9;1;0;10
5545;Nykštukas;SMALSIUKAI;6112448299;Taip;0;10;0;10
5546;Nykštukas;SMALSIUKAI;9100510105;Taip;7;0;0;7
5547;Nykštukas;SMALSIUKAI;2143857296;Taip;9;1;0;10
5548;Nykštukas;SMALSIUKAI;9303832542;Ne;9;1;0;10
5549;Nykštukas;SMALSIUKAI;2571249434;Taip;0;9;0;9
5550;Nykštukas;SMALSIUKAI;3694497590;Taip;8;0;0;8
5551;Nykštukas;AITVARIUKAI;6923345088;Ne;1;1;0;2
5552;Nykštukas;AITVARIUKAI;9216544103;Ne;17;2;0;19
5553;Nykštukas;AITVARIUKAI;9319066179;Ne;9;2;0;11
5554;Nykštukas;AITVARIUKAI;2177539882;Ne;0;0;1;1
5555;Nykštukas;AITVARIUKAI;2232317366;Ne;4;0;1;5
5556;Nykštukas;AITVARIUKAI;7332769878;Taip;11;0;0;11
5557;Nykštukas;AITVARIUKAI;7896338372;Ne;15;0;0;15
5558;Nykštukas;AITVARIUKAI;2208319289;Ne;0;6;0;6
5559;Nykštukas;AITVARIUKAI;8548820023;Ne;8;0;0;8
5560;Nykštukas;AITVARIUKAI;9545178064;Ne;9;0;0;9
5561;Nykštukas;AITVARIUKAI;3561627809;Ne;0;2;0;2
5562;Nykštukas;AITVARIUKAI;5538446312;Ne;0;0;5;5
5563;Nykštukas;AITVARIUKAI;4822304386;Ne;7;0;1;8
5564;Nykštukas;AITVARIUKAI;4177690371;Ne;6;0;2;8
5565;Nykštukas;AITVARIUKAI;5292127770;Ne;4;0;4;8
5566;Nykštukas;DAINORĖLIAI;7730918105;Ne;19;0;0;19
5567;Nykštukas;DAINORĖLIAI;8475127245;Ne;12;0;0;12
5568;Nykštukas;DAINORĖLIAI;5434220008;Ne;0;4;0;4
5569;Nykštukas;DAINORĖLIAI;1122600949;Ne;12;0;0;12
5570;Nykštukas;DAINORĖLIAI;9776630115;Ne;9;0;0;9
5571;Nykštukas;DAINORĖLIAI;9524639831;Ne;16;0;0;16
5572;Nykštukas;DAINORĖLIAI;3367348573;Ne;5;9;0;14
5573;Nykštukas;DAINORĖLIAI;5961945345;Ne;20;0;0;20
5574;Nykštukas;DAINORĖLIAI;6561696818;Ne;6;0;1;7
5575;Nykštukas;DAINORĖLIAI;1283453188;Ne;16;5;0;21
5576;Nykštukas;DAINORĖLIAI;1167614164;Ne;0;1;0;1
5577;Nykštukas;DAINORĖLIAI;1174618721;Ne;0;1;0;1
5578;Nykštukas;DAINORĖLIAI;8681884252;Ne;0;4;0;4
5579;Nykštukas;DAINORĖLIAI;5255726742;Ne;3;1;0;4
5580;Nykštukas;DAINORĖLIAI;9027355399;Ne;7;6;0;13
5581;Nykštukas;DAINORĖLIAI;4893494144;Ne;0;3;0;3
5582;Nykštukas;DAINORĖLIAI;8318089070;Ne;10;0;0;10
5583;Nykštukas;DAINORĖLIAI;2727074729;Ne;8;1;0;9
5584;Nykštukas;DAINORĖLIAI;9437700329;Ne;9;0;0;9
5585;Nykštukas;POKŠTUKAI;7382271765;Ne;9;2;0;11
5586;Nykštukas;POKŠTUKAI;1655428422;Ne;0;1;0;1
5587;Nykštukas;POKŠTUKAI;2649916049;Ne;14;1;0;15
5588;Nykštukas;POKŠTUKAI;1796016501;Ne;20;0;0;20
5589;Nykštukas;POKŠTUKAI;5958711585;Ne;9;0;0;9
5590;Nykštukas;POKŠTUKAI;3999004312;Ne;0;6;0;6
5591;Nykštukas;POKŠTUKAI;6719999304;Ne;14;2;0;16
5592;Nykštukas;POKŠTUKAI;8148163137;Ne;0;1;0;1
5593;Nykštukas;POKŠTUKAI;8708184278;Ne;6;1;0;7
5594;Nykštukas;POKŠTUKAI;5699671696;Ne;7;0;0;7
5595;Nykštukas;POKŠTUKAI;3843163586;Ne;3;3;0;6
5596;Nykštukas;POKŠTUKAI;3507649457;Ne;5;0;0;5
5597;Nykštukas;POKŠTUKAI;3428031037;Ne;3;3;0;6
5598;Nykštukas;POKŠTUKAI;4508625009;Ne;5;0;0;5
5599;Nykštukas;POKŠTUKAI;2982662650;Ne;0;4;0;4
5600;Nykštukas;POKŠTUKAI;2627736026;Ne;9;5;0;14
5601;Nykštukas;POKŠTUKAI;4401103119;Ne;10;4;0;14
5602;Nykštukas;KODĖLČIUKAI;8168579152;Ne;14;0;0;14
5603;Nykštukas;KODĖLČIUKAI;9285820767;Ne;0;9;0;9
5604;Nykštukas;KODĖLČIUKAI;2685400939;Ne;14;2;0;16
5605;Nykštukas;KODĖLČIUKAI;3278960733;Ne;0;0;3;3
5606;Nykštukas;KODĖLČIUKAI;3760617860;Ne;0;2;0;2
5607;Nykštukas;KODĖLČIUKAI;6927545099;Taip;0;0;1;1
5608;Nykštukas;KODĖLČIUKAI;8042479133;Ne;0;0;5;5
5609;Nykštukas;KODĖLČIUKAI;6794885966;Ne;6;11;0;17
5610;Nykštukas;KODĖLČIUKAI;7616459970;Ne;0;11;0;11
5611;Nykštukas;KODĖLČIUKAI;2623254163;Ne;20;0;0;20
5612;Nykštukas;KODĖLČIUKAI;9296449928;Ne;10;0;3;13
5613;Nykštukas;KODĖLČIUKAI;2992219360;Ne;0;20;0;20
5614;Nykštukas;KODĖLČIUKAI;8804969886;Ne;0;0;1;1
5615;Nykštukas;KODĖLČIUKAI;3552386621;Ne;15;0;0;15
5616;Nykštukas;KODĖLČIUKAI;2692551262;Ne;0;1;0;1
5617;Nykštukas;PASAKORIAI;2661110617;Ne;10;0;0;10
5618;Nykštukas;PASAKORIAI;3040001373;Ne;8;2;0;10
5619;Nykštukas;PASAKORIAI;1855278809;Ne;0;0;2;2
5620;Nykštukas;PASAKORIAI;8640715657;Ne;10;3;0;13
5621;Nykštukas;PASAKORIAI;5504584349;Ne;8;7;0;15
5622;Nykštukas;PASAKORIAI;7990462246;Ne;5;1;1;7
5623;Nykštukas;PASAKORIAI;1379378120;Ne;0;6;0;6
5624;Nykštukas;PASAKORIAI;9413198245;Ne;4;0;1;5
5625;Nykštukas;PASAKORIAI;2518342041;Ne;5;0;0;5
5626;Nykštukas;PASAKORIAI;7828733135;Ne;9;2;1;12
5627;Nykštukas;PASAKORIAI;4480184458;Ne;3;0;6;9
5628;Nykštukas;PASAKORIAI;4090494707;Ne;6;0;0;6
5629;Nykštukas;PASAKORIAI;3026598985;Ne;7;1;0;8
5630;Nykštukas;PASAKORIAI;9714310539;Ne;7;3;0;10
5631;Nykštukas;PASAKORIAI;4795301170;Ne;12;0;0;12
5632;Nykštukas;PASAKORIAI;1579064341;Ne;7;0;1;8
5633;Nykštukas;PASAKORIAI;4992654449;Ne;4;0;1;5
5634;Nykštukas;PASAKORIAI;5337728911;Ne;19;1;0;20
5635;Nykštukas;PASAKORIAI;9509051946;Ne;0;10;0;10
5636;Nykštukas;PASAKORIAI;2231375994;Ne;20;0;0;20
5637;Nykštukas;PASAKORIAI;8371081106;Ne;0;11;0;11
5638;Nykštukas;GUDRUČIAI;9871410323;Ne;7;0;0;7
5639;Nykštukas;GUDRUČIAI;4559818614;Ne;7;0;0;7
5640;Nykštukas;GUDRUČIAI;9250827058;Ne;6;0;0;6
5641;Nykštukas;GUDRUČIAI;7447202642;Ne;6;9;0;15
5642;Nykštukas;GUDRUČIAI;1714708754;Ne;13;0;0;13
5643;Nykštukas;GUDRUČIAI;5157799354;Ne;20;0;0;20
5644;Nykštukas;GUDRUČIAI;4325369395;Taip;15;0;0;15
5645;Nykštukas;GUDRUČIAI;6630804505;Ne;13;0;0;13
5646;Nykštukas;GUDRUČIAI;8363202198;Ne;6;1;0;7
5647;Nykštukas;GUDRUČIAI;7326535810;Ne;10;1;0;11
5648;Nykštukas;GUDRUČIAI;9712596180;Taip;8;0;0;8
5649;Nykštukas;GUDRUČIAI;9941937734;Ne;0;1;0;1
5650;Nykštukas;GUDRUČIAI;2494482185;Ne;6;0;0;6
5651;Nykštukas;GUDRUČIAI;3619459404;Ne;7;0;0;7
5652;Nykštukas;GUDRUČIAI;1934596739;Ne;9;0;0;9
5653;Nykštukas;GUDRUČIAI;7604740418;Ne;11;0;0;11
5654;Nykštukas;GUDRUČIAI;2970293467;Ne;14;1;0;15
5655;Nykštukas;GUDRUČIAI;2881323571;Ne;0;2;0;2
5656;Nykštukas;GUDRUČIAI;2872277381;Ne;12;0;0;12
5657;Nykštukas;GUDRUČIAI;9940519259;Ne;0;0;4;4
5658;Nykštukas;NAMINUKAI;7456007276;Ne;0;3;0;3
5659;Nykštukas;NAMINUKAI;7176519994;Ne;0;4;0;4
5660;Nykštukas;NAMINUKAI;2440574056;Ne;0;8;0;8
5661;Nykštukas;NAMINUKAI;4064016871;Ne;0;2;0;2
5662;Nykštukas;NAMINUKAI;9054070492;Ne;0;0;5;5
5663;Nykštukas;NAMINUKAI;6106373554;Ne;7;0;0;7
5664;Nykštukas;NAMINUKAI;4925214655;Ne;0;2;0;2
5665;Nykštukas;NAMINUKAI;5032283848;Ne;0;0;3;3
5666;Nykštukas;NAMINUKAI;7494444468;Ne;0;1;1;2
5667;Nykštukas;NAMINUKAI;3925958632;Ne;0;1;1;2
5668;Nykštukas;NAMINUKAI;6338717583;Ne;0;1;0;1
5669;Nykštukas;NAMINUKAI;7976689381;Ne;0;1;0;1
5670;Nykštukas;NAMINUKAI;9686815141;Ne;7;5;0;12
5671;Nykštukas;NAMINUKAI;9575291096;Ne;10;0;0;10
5672;Nykštukas;NAMINUKAI;4503830456;Ne;0;1;0;1
5673;Nykštukas;NAMINUKAI;4040123876;Ne;0;8;0;8
5674;Nykštukas;NAMINUKAI;1088633575;Ne;8;0;0;8
5675;Nykštukas;NAMINUKAI;5088668786;Ne;14;5;0;19
5676;Nykštukas;NAMINUKAI;8874850019;Ne;11;1;0;12
5677;Nykštukas;NAMINUKAI;1510338621;Ne;9;5;0;14
5678;Nykštukas;NAMINUKAI;9067774103;Ne;20;0;0;20
5679;Nykštukas;NAMINUKAI;3405633312;Taip;7;0;0;7
5680;Nykštukas;KŪLVERSTUKAI;8827094160;Ne;6;2;0;8
5681;Nykštukas;KŪLVERSTUKAI;7320458031;Ne;0;3;0;3
5682;Nykštukas;KŪLVERSTUKAI;1148800623;Taip;1;1;0;2
5683;Nykštukas;KŪLVERSTUKAI;6786896381;Ne;0;5;0;5
5684;Nykštukas;KŪLVERSTUKAI;7432373335;Ne;0;2;0;2
5685;Nykštukas;KŪLVERSTUKAI;3660330885;Ne;0;7;0;7
5686;Nykštukas;KŪLVERSTUKAI;6883272732;Ne;9;0;0;9
5687;Nykštukas;KŪLVERSTUKAI;8919778025;Ne;4;0;0;4
5688;Nykštukas;KŪLVERSTUKAI;6337924089;Ne;9;0;0;9
5689;Nykštukas;KŪLVERSTUKAI;4323166473;Ne;12;0;0;12
5690;Nykštukas;KŪLVERSTUKAI;2748970206;Ne;20;0;0;20
5691;Nykštukas;KŪLVERSTUKAI;4490310109;Ne;0;4;0;4
5692;Nykštukas;KŪLVERSTUKAI;2947976429;Taip;12;0;0;12
5693;Nykštukas;KŪLVERSTUKAI;2763268154;Ne;0;6;1;7
5694;Nykštukas;KŪLVERSTUKAI;9887096503;Ne;0;2;1;3
5695;Nykštukas;TREPSIUKAI;2052451745;Ne;0;0;1;1
5696;Nykštukas;TREPSIUKAI;8701731017;Ne;15;1;0;16
5697;Nykštukas;TREPSIUKAI;4955003100;Ne;5;7;0;12
5698;Nykštukas;TREPSIUKAI;5103512898;Ne;0;5;0;5
5699;Nykštukas;TREPSIUKAI;7266550834;Ne;13;0;0;13
5700;Nykštukas;TREPSIUKAI;6563871327;Ne;3;2;0;5
5701;Nykštukas;TREPSIUKAI;5085577592;Ne;0;1;0;1
5702;Nykštukas;TREPSIUKAI;8819485547;Ne;11;0;0;11
5703;Nykštukas;TREPSIUKAI;5281616311;Ne;9;0;0;9
5704;Nykštukas;TREPSIUKAI;8372380734;Ne;19;0;0;19
5705;Nykštukas;TREPSIUKAI;4499337321;Ne;12;0;0;12
5706;Nykštukas;TREPSIUKAI;4622095064;Taip;4;1;0;5
5707;Nykštukas;TREPSIUKAI;8667489439;Ne;5;1;1;7
5708;Nykštukas;TREPSIUKAI;5010715255;Ne;0;4;0;4
5709;Nykštukas;TREPSIUKAI;8047072198;Ne;0;2;0;2
5710;Nykštukas;TREPSIUKAI;9790322329;Ne;10;0;0;10
5711;Nykštukas;TREPSIUKAI;8695794490;Ne;0;5;0;5
5712;Nykštukas;ŽIRNIUKAI;9661862689;Ne;17;0;0;17
5713;Nykštukas;ŽIRNIUKAI;1671340074;Taip;2;0;1;3
5714;Nykštukas;ŽIRNIUKAI;3339707558;Ne;6;2;0;8
5715;Nykštukas;ŽIRNIUKAI;7908029688;Ne;0;1;1;2
5716;Nykštukas;ŽIRNIUKAI;7299329150;Ne;0;0;1;1
5717;Nykštukas;ŽIRNIUKAI;9174636607;Ne;5;0;0;5
5718;Nykštukas;ŽIRNIUKAI;1218443707;Taip;3;0;0;3
5719;Nykštukas;ŽIRNIUKAI;7535385367;Taip;6;0;0;6
5720;Nykštukas;ŽIRNIUKAI;6709760898;Taip;1;14;0;15
5721;Nykštukas;ŽIRNIUKAI;2670682135;Ne;0;1;0;1
5722;Nykštukas;ŽIRNIUKAI;2800783215;Ne;0;20;0;20
5723;Nykštukas;ŽIRNIUKAI;2620150024;Ne;0;0;20;20
5724;Nykštukas;ŽIRNIUKAI;3032028847;Taip;17;0;0;17
5725;Nykštukas;ŽIRNIUKAI;6884714823;Ne;0;2;0;2
5726;Nykštukas;ŽIRNIUKAI;1616644404;Ne;13;5;1;19
5727;Nykštukas;ŽIRNIUKAI;9270615518;Taip;7;2;0;9
5728;Nykštukas;ŽIRNIUKAI;2078586374;Ne;0;9;0;9
5729;Ozas;Smalsučiai;2641398988;Ne;0;6;0;6
5730;Ozas;Smalsučiai;9227939420;Ne;0;1;0;1
5731;Ozas;Smalsučiai;87218067796;Ne;0;1;3;4
5732;Ozas;Smalsučiai;4397034031;Ne;0;8;1;9
5733;Ozas;Smalsučiai;1974320330;Ne;0;1;0;1
5734;Ozas;Smalsučiai;67987032400;Ne;0;0;1;1
5735;Ozas;Smalsučiai;71695973592;Ne;0;1;0;1
5736;Ozas;Smalsučiai;57069047630;Ne;0;9;0;9
5737;Ozas;Smalsučiai;3326395879;Ne;0;5;0;5
5738;Ozas;Smalsučiai;5150746885;Ne;0;5;0;5
5739;Ozas;Smalsučiai;1893257809;Ne;0;0;1;1
5740;Ozas;Smalsučiai;8072802467;Ne;1;0;0;1
5741;Ozas;Smalsučiai;1248092034;Ne;0;1;0;1
5742;Ozas;Smalsučiai;43381497677;Ne;0;7;0;7
5743;Ozas;Smalsučiai;7351651916;Ne;0;2;1;3
5744;Ozas;Smalsučiai;3286170280;Ne;1;0;0;1
5745;Ozas;Smalsučiai;9521048381;Ne;5;0;1;6
5746;Ozas;Smalsučiai;9905575489;Ne;0;2;2;4
5747;Ozas;Smalsučiai;5342394742;Ne;0;2;0;2
5748;Ozas;Drugeliai;6668470892;Ne;5;0;0;5
5749;Ozas;Drugeliai;2302999759;Ne;1;0;0;1
5750;Ozas;Drugeliai;8088330187;Ne;0;6;0;6
5751;Ozas;Drugeliai;9322806566;Ne;0;7;0;7
5752;Ozas;Drugeliai;2676747542;Ne;0;0;20;20
5753;Ozas;Drugeliai;8289643065;Ne;9;0;0;9
5754;Ozas;Drugeliai;9987863302;Ne;0;2;0;2
5755;Ozas;Drugeliai;2980799420;Ne;20;0;0;20
5756;Ozas;Drugeliai;8318380547;Ne;0;5;0;5
5757;Ozas;Drugeliai;43660054250;Ne;0;15;0;15
5758;Ozas;Drugeliai;15262583232;Ne;0;10;0;10
5759;Ozas;Drugeliai;1103685699;Ne;0;1;0;1
5760;Ozas;Drugeliai;4207160323;Ne;1;0;0;1
5761;Ozas;Drugeliai;1837947633;Ne;3;0;0;3
5762;Ozas;Boružėlės;1348960421;Ne;0;0;9;9
5763;Ozas;Boružėlės;1375643969;Ne;0;0;3;3
5764;Ozas;Boružėlės;63852147122;Ne;0;0;3;3
5765;Ozas;Boružėlės;8190314087;Ne;12;0;0;12
5766;Ozas;Boružėlės;3803998816;Ne;3;2;0;5
5767;Ozas;Boružėlės;1212358423;Ne;10;1;0;11
5768;Ozas;Boružėlės;7615907271;Ne;5;0;0;5
5769;Ozas;Boružėlės;1560342499;Ne;1;0;0;1
5770;Ozas;Boružėlės;8529654920;Ne;0;1;0;1
5771;Ozas;Boružėlės;2527574646;Ne;0;3;0;3
5772;Ozas;Boružėlės;36523514229;Ne;0;1;0;1
5773;Ozas;Boružėlės;1367050160;Ne;9;0;0;9
5774;Ozas;Boružėlės;6432357144;Ne;5;0;1;6
5775;Ozas;Boružėlės;1498656201;Ne;0;6;0;6
5776;Ozas;Boružėlės;9130645878;Ne;5;0;0;5
5777;Ozas;Boružėlės;60194872867;Ne;1;3;0;4
5778;Ozas;Boružėlės;7172573921;Ne;0;0;3;3
5779;Ozas;Boružėlės;68364031736;Ne;0;2;1;3
5780;Ozas;Žiogeliai;7461521320;Ne;0;3;0;3
5781;Ozas;Žiogeliai;6257625501;Ne;2;0;0;2
5782;Ozas;Žiogeliai;7402290524;Taip;16;0;0;16
5783;Ozas;Žiogeliai;1562277866;Ne;0;0;2;2
5784;Ozas;Žiogeliai;4571583671;Ne;0;0;3;3
5785;Ozas;Žiogeliai;5682027094;Ne;7;4;7;18
5786;Ozas;Žiogeliai;4966355020;Ne;0;1;0;1
5787;Ozas;Žiogeliai;9324647606;Ne;5;1;4;10
5788;Ozas;Žiogeliai;4942550213;Ne;15;0;1;16
5789;Ozas;Žiogeliai;8676986286;Ne;0;1;4;5
5790;Ozas;Žiogeliai;5420952391;Ne;11;4;0;15
5791;Ozas;Žiogeliai;2837228320;Ne;13;0;0;13
5792;Ozas;Žiogeliai;5156383727;Ne;0;5;0;5
5793;Ozas;Žiogeliai;2617258206;Ne;0;15;0;15
5794;Ozas;Žiogeliai;9768754737;Ne;0;4;0;4
5795;Ozas;Bitutės;4220780257;Ne;7;0;0;7
5796;Ozas;Bitutės;1161776624;Ne;0;0;3;3
5797;Ozas;Bitutės;4227555342;Taip;7;0;1;8
5798;Ozas;Bitutės;7499756171;Ne;0;18;0;18
5799;Ozas;Bitutės;2705294874;Ne;0;1;0;1
5800;Ozas;Bitutės;3329391600;Ne;5;0;0;5
5801;Ozas;Bitutės;4254601638;Ne;0;0;1;1
5802;Ozas;Bitutės;8304671844;Taip;5;0;0;5
5803;Ozas;Bitutės;5968428143;Ne;8;0;0;8
5804;Ozas;Bitutės;9772085405;Ne;0;1;2;3
5805;Ozas;Bitutės;7051699003;Ne;11;0;0;11
5806;Ozas;Bitutės;5383877034;Ne;0;0;3;3
5807;Ozas;Bitutės;1117208248;Ne;0;0;6;6
5808;Ozas;Bitutės;6811181735;Ne;13;0;0;13
5809;Ozas;Bitutės;8622621570;Ne;6;0;2;8
5810;Ozas;Bitutės;4260123123;Ne;7;0;0;7
5811;Ozas;Bitutės;7494307084;Taip;0;3;0;3
5812;Ozas;Bitutės;1475005204;Ne;0;2;0;2
5813;Ozas;Aitvarėliai;1144679735;Ne;11;0;0;11
5814;Ozas;Aitvarėliai;2773182934;Ne;0;4;3;7
5815;Ozas;Aitvarėliai;4357737538;Ne;6;0;2;8
5816;Ozas;Aitvarėliai;5642468671;Ne;8;0;0;8
5817;Ozas;Aitvarėliai;7686706482;Ne;0;1;5;6
5818;Ozas;Aitvarėliai;2922370952;Ne;0;0;5;5
5819;Ozas;Aitvarėliai;5383739203;Ne;12;0;0;12
5820;Ozas;Aitvarėliai;4583818638;Ne;3;0;0;3
5821;Ozas;Aitvarėliai;2165291778;Ne;5;5;0;10
5822;Ozas;Aitvarėliai;8754244281;Ne;17;0;0;17
5823;Ozas;Aitvarėliai;9443843603;Ne;15;0;0;15
5824;Ozas;Aitvarėliai;3238019756;Ne;11;0;0;11
5825;Ozas;Aitvarėliai;8987796218;Ne;10;8;0;18
5826;Ozas;Aitvarėliai;2544858937;Ne;3;0;0;3
5827;Ozas;Aitvarėliai;3783477511;Ne;4;13;0;17
5828;Ozas;Aitvarėliai;6778987483;Ne;0;6;3;9
5829;Ozas;Aitvarėliai;4891451748;Ne;0;5;0;5
5830;Ozas;Aitvarėliai;7009893338;Taip;4;0;0;4
5831;Ozas;Voveraitės;8178298861;Ne;4;0;0;4
5832;Ozas;Voveraitės;6263062055;Ne;10;2;0;12
5833;Ozas;Voveraitės;9195536968;Ne;0;2;2;4
5834;Ozas;Voveraitės;2991511872;Ne;0;2;0;2
5835;Ozas;Voveraitės;1564826076;Ne;14;0;0;14
5836;Ozas;Voveraitės;1240233169;Ne;7;0;1;8
5837;Ozas;Voveraitės;6088757991;Ne;9;1;0;10
5838;Ozas;Voveraitės;5822871838;Ne;6;10;0;16
5839;Ozas;Voveraitės;6499549095;Ne;0;2;2;4
5840;Ozas;Voveraitės;6666591428;Ne;6;2;0;8
5841;Ozas;Voveraitės;2297650260;Ne;5;3;0;8
5842;Ozas;Voveraitės;7908028909;Ne;0;7;0;7
5843;Ozas;Voveraitės;9762737217;Ne;5;0;0;5
5844;Ozas;Voveraitės;7421484648;Ne;12;0;8;20
5845;Ozas;Voveraitės;1997125531;Taip;0;3;0;3
5846;Ozas;Voveraitės;6053885086;Ne;5;0;1;6
5847;Ozas;Voveraitės;5751808248;Ne;8;0;0;8
5848;Ozas;Voveraitės;4556076744;Ne;8;0;3;11
5849;Ozas;Kodelčiukai;8743467101;Ne;4;0;0;4
5850;Ozas;Kodelčiukai;2964318343;Ne;11;0;1;12
5851;Ozas;Kodelčiukai;8696127374;Ne;0;3;0;3
5852;Ozas;Kodelčiukai;3704303636;Ne;0;4;0;4
5853;Ozas;Kodelčiukai;3412369198;Ne;9;0;0;9
5854;Ozas;Kodelčiukai;2951875705;Ne;2;0;0;2
5855;Ozas;Kodelčiukai;7305274617;Ne;6;0;0;6
5856;Ozas;Kodelčiukai;9306887706;Ne;10;0;1;11
5857;Ozas;Kodelčiukai;1348751454;Ne;15;0;2;17
5858;Ozas;Kodelčiukai;9322080266;Ne;0;2;0;2
5859;Ozas;Kodelčiukai;6809992664;Taip;10;0;2;12
5860;Ozas;Kodelčiukai;4516291572;Ne;7;1;0;8
5861;Ozas;Kodelčiukai;4287719751;Ne;5;3;0;8
5862;Ozas;Kodelčiukai;9620747099;Ne;0;8;0;8
5863;Ozas;Kodelčiukai;5216695220;Ne;0;1;5;6
5864;Ozas;Kodelčiukai;8779047802;Ne;11;0;0;11
5865;Ozas;Kodelčiukai;6783755555;Taip;0;3;0;3
5866;Ozas;Pelėdžiukai;4640897674;Ne;0;0;1;1
5867;Ozas;Pelėdžiukai;9277208213;Ne;0;0;1;1
5868;Ozas;Pelėdžiukai;2281337233;Taip;5;0;0;5
5869;Ozas;Pelėdžiukai;8040293681;Ne;0;0;4;4
5870;Ozas;Pelėdžiukai;1856258542;Ne;0;0;1;1
5871;Ozas;Pelėdžiukai;7640409923;Ne;0;7;0;7
5872;Ozas;Pelėdžiukai;4601869799;Ne;8;0;2;10
5873;Ozas;Pelėdžiukai;5958055645;Ne;8;0;2;10
5874;Ozas;Pelėdžiukai;7125754645;Ne;0;0;2;2
5875;Ozas;Pelėdžiukai;2824133388;Ne;10;1;0;11
5876;Ozas;Pelėdžiukai;2637531106;Ne;3;0;0;3
5877;Ozas;Pelėdžiukai;7287989663;Ne;5;0;0;5
5878;Ozas;Pelėdžiukai;6819000895;Ne;7;0;0;7
5879;Ozas;Pelėdžiukai;5950860889;Ne;9;0;2;11
5880;Ozas;Pelėdžiukai;4886045470;Ne;0;3;0;3
5881;Ozas;Pelėdžiukai;3212050416;Ne;0;3;0;3
5882;Ozas;Pelėdžiukai;3711403511;Ne;1;0;4;5
5883;Ozas;Pelėdžiukai;5392929222;Ne;20;0;0;20
5884;Ozas;Pelėdžiukai;7038928164;Taip;5;0;0;5
5885;Ozas;"Kačiukai ";4857216527;Ne;5;0;0;5
5886;Ozas;"Kačiukai ";7776754188;Ne;15;0;0;15
5887;Ozas;"Kačiukai ";5097380041;Taip;6;0;4;10
5888;Ozas;"Kačiukai ";2522810593;Ne;3;0;1;4
5889;Ozas;"Kačiukai ";3109261153;Ne;5;0;0;5
5890;Ozas;"Kačiukai ";9781398468;Ne;17;0;0;17
5891;Ozas;"Kačiukai ";8488500486;Ne;6;0;0;6
5892;Ozas;"Kačiukai ";2512535949;Taip;10;0;0;10
5893;Ozas;"Kačiukai ";4595986358;Ne;6;0;1;7
5894;Ozas;"Kačiukai ";5421245991;Ne;1;0;0;1
5895;Ozas;"Kačiukai ";9781527964;Ne;0;16;0;16
5896;Ozas;"Kačiukai ";4514798132;Ne;14;0;0;14
5897;Ozas;"Kačiukai ";9655492678;Ne;0;0;5;5
5898;Ozas;"Kačiukai ";2729524188;Ne;14;0;0;14
5899;Ozas;Ančiukų;3037323341;Ne;0;4;0;4
5900;Ozas;Ančiukų;2869987587;Ne;8;1;9;18
5901;Ozas;Ančiukų;5926100815;Ne;9;0;1;10
5902;Ozas;Ančiukų;9178967858;Ne;7;0;1;8
5903;Ozas;Ančiukų;2454569369;Ne;7;0;0;7
5904;Ozas;Ančiukų;3133776891;Ne;4;0;0;4
5905;Ozas;Ančiukų;2139224651;Ne;12;0;0;12
5906;Ozas;Ančiukų;8713970306;Ne;5;0;1;6
5907;Ozas;Ančiukų;2819545359;Ne;9;0;0;9
5908;Ozas;Ančiukų;1803782282;Taip;10;4;0;14
5909;Ozas;Ančiukų;5172367556;Ne;0;7;0;7
5910;Ozas;Ančiukų;8923372952;Ne;2;0;0;2
5911;Ozas;Ančiukų;7617839839;Ne;11;6;1;18
5912;Ozas;Ančiukų;9506090620;Ne;0;3;0;3
5913;Ozas;Ančiukų;6346123124;Taip;16;0;0;16
5914;Ozas;Nykškukų;3139289643;Ne;0;2;0;2
5915;Ozas;Nykškukų;3902722274;Ne;8;0;0;8
5916;Ozas;Nykškukų;7922667688;Ne;3;4;3;10
5917;Ozas;Nykškukų;8781771299;Ne;5;1;1;7
5918;Ozas;Nykškukų;3817138493;Ne;11;1;0;12
5919;Ozas;Nykškukų;8371368881;Ne;5;0;0;5
5920;Ozas;Nykškukų;4994121247;Ne;11;1;0;12
5921;Ozas;Nykškukų;6315443248;Ne;11;1;0;12
5922;Ozas;Nykškukų;6318419889;Ne;16;0;0;16
5923;Ozas;Nykškukų;6186850614;Ne;4;0;0;4
5924;Ozas;Nykškukų;5182160089;Ne;13;0;1;14
5925;Ozas;Nykškukų;1536889312;Ne;11;0;0;11
5926;Ozas;Nykškukų;8897904793;Ne;7;0;0;7
5927;Pabiručiai;Voveriukų;4539246865;Ne;0;4;0;4
5928;Pabiručiai;Voveriukų;1498738549;Ne;0;4;0;4
5929;Pabiručiai;Voveriukų;9564303781;Ne;0;0;6;6
5930;Pabiručiai;Voveriukų;4312364951;Ne;0;2;1;3
5931;Pabiručiai;Voveriukų;3756731363;Ne;0;0;9;9
5932;Pabiručiai;Voveriukų;7985360502;Ne;0;1;0;1
5933;Pabiručiai;Voveriukų;4069564285;Ne;0;5;0;5
5934;Pabiručiai;Voveriukų;7278334800;Ne;0;2;2;4
5935;Pabiručiai;Voveriukų;9468698553;Ne;4;0;1;5
5936;Pabiručiai;Voveriukų;5232678556;Taip;0;2;2;4
5937;Pabiručiai;Voveriukų;7066037017;Ne;0;2;0;2
5938;Pabiručiai;Voveriukų;5549851164;Ne;8;0;0;8
5939;Pabiručiai;Voveriukų;4040533883;Ne;0;4;0;4
5940;Pabiručiai;Voveriukų;2514312233;Ne;0;3;0;3
5941;Pabiručiai;Voveriukų;7606274875;Ne;0;3;0;3
5942;Pabiručiai;Voveriukų;4813206044;Ne;5;5;0;10
5943;Pabiručiai;Voveriukų;7846758352;Ne;0;1;0;1
5944;Pabiručiai;Boružiukų;1673473814;Ne;4;1;0;5
5945;Pabiručiai;Boružiukų;5686769648;Ne;7;4;0;11
5946;Pabiručiai;Boružiukų;7524993271;Ne;0;1;1;2
5947;Pabiručiai;Boružiukų;4006783343;Ne;0;4;0;4
5948;Pabiručiai;Boružiukų;7046122545;Ne;0;1;0;1
5949;Pabiručiai;Boružiukų;3096466200;Ne;5;1;0;6
5950;Pabiručiai;Boružiukų;4301904533;Ne;0;1;0;1
5951;Pabiručiai;Boružiukų;8175565139;Ne;0;1;0;1
5952;Pabiručiai;Boružiukų;8236964683;Ne;4;2;0;6
5953;Pabiručiai;Boružiukų;1240057541;Ne;0;5;0;5
5954;Pabiručiai;Boružiukų;1671027282;Ne;0;3;0;3
5955;Pabiručiai;Boružiukų;3759350345;Ne;0;1;0;1
5956;Pabiručiai;Boružiukų;3151360288;Ne;0;8;0;8
5957;Pabiručiai;Boružiukų;9299393363;Ne;5;5;0;10
5958;Pabiručiai;Boružiukų;1484291546;Ne;0;2;0;2
5959;Pabiručiai;Boružiukų;2771769336;Ne;9;4;0;13
5960;Pabiručiai;Boružiukų;2607840684;Ne;5;2;0;7
5961;Pabiručiai;Boružiukų;4681771534;Ne;0;1;0;1
5962;Pabiručiai;Boružiukų;7050339198;Ne;10;3;0;13
5963;Pabiručiai;Boružiukų;4798503931;Ne;6;1;0;7
5964;Pabiručiai;Katinėlių;8710389714;Ne;0;3;0;3
5965;Pabiručiai;Katinėlių;1670938208;Ne;1;6;0;7
5966;Pabiručiai;Katinėlių;6283372742;Ne;1;1;0;2
5967;Pabiručiai;Katinėlių;4205107384;Ne;1;0;1;2
5968;Pabiručiai;Katinėlių;4501176225;Ne;0;4;0;4
5969;Pabiručiai;Katinėlių;1749155319;Ne;5;2;2;9
5970;Pabiručiai;Katinėlių;2572570925;Ne;0;4;0;4
5971;Pabiručiai;Katinėlių;34883375155;Ne;0;2;0;2
5972;Pabiručiai;Katinėlių;8306688649;Ne;0;2;4;6
5973;Pabiručiai;Katinėlių;1705085006;Ne;15;0;0;15
5974;Pabiručiai;Katinėlių;58112415466;Ne;9;1;0;10
5975;Pabiručiai;Katinėlių;95695057362;Ne;0;8;0;8
5976;Pabiručiai;Katinėlių;42877891797;Ne;0;2;0;2
5977;Pabiručiai;Katinėlių;6285940478;Ne;0;2;0;2
5978;Pabiručiai;Katinėlių;1122183123;Ne;1;5;4;10
5979;Pabiručiai;Žiogelių;6548776238;Ne;0;0;5;5
5980;Pabiručiai;Žiogelių;3272576627;Ne;7;1;0;8
5981;Pabiručiai;Žiogelių;5522447437;Ne;0;0;2;2
5982;Pabiručiai;Žiogelių;3585198013;Ne;0;1;0;1
5983;Pabiručiai;Žiogelių;7974345478;Ne;4;0;0;4
5984;Pabiručiai;Žiogelių;3206962828;Ne;5;0;3;8
5985;Pabiručiai;Žiogelių;3355875364;Ne;0;3;0;3
5986;Pabiručiai;Žiogelių;5311762824;Ne;6;0;2;8
5987;Pabiručiai;Žiogelių;1587905929;Ne;8;3;0;11
5988;Pabiručiai;Žiogelių;4667769378;Ne;5;0;0;5
5989;Pabiručiai;Žiogelių;7085036701;Ne;0;4;0;4
5990;Pabiručiai;Žiogelių;8736658575;Ne;0;4;0;4
5991;Pabiručiai;Žiogelių;8106446562;Ne;12;0;0;12
5992;Pabiručiai;Žiogelių;8421025940;Ne;0;5;0;5
5993;Pabiručiai;Smalsiukai;2869383175;Ne;6;0;0;6
5994;Pabiručiai;Smalsiukai;7677235214;Ne;0;1;0;1
5995;Pabiručiai;Smalsiukai;9676561758;Ne;0;3;0;3
5996;Pabiručiai;Smalsiukai;7632969321;Ne;0;4;0;4
5997;Pabiručiai;Smalsiukai;7090116276;Ne;0;0;3;3
5998;Pabiručiai;Smalsiukai;4408666547;Ne;0;0;1;1
5999;Pabiručiai;Smalsiukai;9093137227;Ne;6;0;0;6
6000;Pabiručiai;Smalsiukai;6935913132;Ne;5;2;0;7
6001;Pabiručiai;Smalsiukai;1344711015;Ne;3;6;0;9
6002;Pabiručiai;Smalsiukai;7663581089;Ne;0;2;2;4
6003;Pabiručiai;Smalsiukai;9610623364;Ne;0;3;0;3
6004;Pabiručiai;Smalsiukai;8897462614;Ne;0;1;0;1
6005;Pabiručiai;Smalsiukai;2332338995;Ne;6;0;0;6
6006;Pabiručiai;Smalsiukai;4258226042;Ne;4;3;0;7
6007;Pabiručiai;Smalsiukai;3511851810;Ne;2;1;0;3
6008;Pabiručiai;Smalsiukai;6686039601;Ne;12;0;3;15
6009;Pabiručiai;Smalsiukai;5420231066;Ne;0;4;0;4
6010;Pabiručiai;Smalsiukai;8840885039;Ne;0;0;1;1
6011;Pabiručiai;Smalsiukai;9779260044;Ne;14;0;0;14
6012;Pabiručiai;Smalsiukai;2771891999;Ne;0;0;1;1
6013;Pabiručiai;Kiškučiai;9589005897;Ne;6;4;0;10
6014;Pabiručiai;Kiškučiai;9353062804;Ne;0;8;0;8
6015;Pabiručiai;Kiškučiai;1582754284;Ne;6;4;0;10
6016;Pabiručiai;Kiškučiai;4462744848;Ne;14;3;0;17
6017;Pabiručiai;Kiškučiai;5621183663;Ne;0;1;0;1
6018;Pabiručiai;Kiškučiai;9417138573;Ne;6;1;0;7
6019;Pabiručiai;Kiškučiai;1515270273;Ne;0;2;0;2
6020;Pabiručiai;Kiškučiai;2688728915;Ne;0;8;0;8
6021;Pabiručiai;Kiškučiai;5166525832;Ne;0;7;0;7
6022;Pabiručiai;Kiškučiai;8409455566;Ne;3;0;0;3
6023;Pabiručiai;Kiškučiai;1028312285;Ne;0;4;0;4
6024;Pabiručiai;Kiškučiai;5717534175;Ne;0;2;0;2
6025;Pabiručiai;Kiškučiai;3408518493;Ne;0;5;0;5
6026;Pabiručiai;Kiškučiai;7653129291;Ne;16;0;0;16
6027;Pabiručiai;Kiškučiai;7073230645;Taip;0;3;0;3
6028;Pabiručiai;Kiškučiai;7572077461;Ne;9;3;0;12
6029;Pabiručiai;"Pėledžiukai ";9834824219;Ne;10;7;0;17
6030;Pabiručiai;"Pėledžiukai ";6831569546;Ne;4;0;2;6
6031;Pabiručiai;"Pėledžiukai ";1683369842;Ne;0;4;1;5
6032;Pabiručiai;"Pėledžiukai ";7961879916;Ne;8;0;0;8
6033;Pabiručiai;"Pėledžiukai ";9050994322;Ne;10;1;0;11
6034;Pabiručiai;"Pėledžiukai ";1049154287;Ne;8;0;0;8
6035;Pabiručiai;"Pėledžiukai ";6697518151;Ne;0;3;0;3
6036;Pabiručiai;"Pėledžiukai ";2596301235;Ne;5;1;3;9
6037;Pabiručiai;"Pėledžiukai ";4333645528;Ne;0;1;0;1
6038;Pabiručiai;"Pėledžiukai ";6289025538;Ne;5;10;0;15
6039;Pabiručiai;"Pėledžiukai ";2343561322;Ne;0;2;0;2
6040;Pabiručiai;"Pėledžiukai ";3674583662;Ne;4;0;0;4
6041;Pabiručiai;"Pėledžiukai ";8268101318;Ne;0;8;0;8
6042;Pabiručiai;"Pėledžiukai ";2147165934;Ne;9;0;0;9
6043;Pabiručiai;"Pėledžiukai ";7385149524;Ne;2;0;0;2
6044;Pabiručiai;"Pėledžiukai ";7203091216;Ne;6;8;0;14
6045;Pabiručiai;"Pėledžiukai ";3224195892;Ne;15;0;1;16
6046;Pabiručiai;"Kodelčiūkai ";5950654594;Ne;6;2;0;8
6047;Pabiručiai;"Kodelčiūkai ";8775727677;Ne;0;4;0;4
6048;Pabiručiai;"Kodelčiūkai ";4317656984;Ne;1;0;1;2
6049;Pabiručiai;"Kodelčiūkai ";4785878572;Taip;0;12;0;12
6050;Pabiručiai;"Kodelčiūkai ";2295503584;Ne;0;8;0;8
6051;Pabiručiai;"Kodelčiūkai ";4595458527;Ne;5;0;0;5
6052;Pabiručiai;"Kodelčiūkai ";8716879106;Ne;4;0;0;4
6053;Pabiručiai;"Kodelčiūkai ";9067653417;Ne;0;0;4;4
6054;Pabiručiai;"Kodelčiūkai ";5247780866;Ne;3;0;0;3
6055;Pabiručiai;"Kodelčiūkai ";3433419710;Ne;0;0;2;2
6056;Pabiručiai;"Kodelčiūkai ";6386335808;Ne;15;0;3;18
6057;Pabiručiai;"Kodelčiūkai ";5010271037;Ne;0;2;2;4
6058;Pabiručiai;"Kodelčiūkai ";7289131864;Ne;5;2;0;7
6059;Pabiručiai;"Kodelčiūkai ";6209553290;Ne;20;0;0;20
6060;Pabiručiai;"Kodelčiūkai ";5913022147;Taip;7;0;1;8
6061;Pabiručiai;"Kodelčiūkai ";3748657353;Ne;0;0;2;2
6062;Pabiručiai;"Kodelčiūkai ";3497466298;Ne;0;2;0;2
6063;Pabiručiai;"Kodelčiūkai ";8179285338;Ne;0;11;0;11
6064;Pabiručiai;"Kodelčiūkai ";1234230729;Ne;5;0;5;10
6065;Pabiručiai;"Peliukų ";3702521810;Ne;6;0;0;6
6066;Pabiručiai;"Peliukų ";1947729077;Ne;16;0;0;16
6067;Pabiručiai;"Peliukų ";6678717039;Taip;3;1;0;4
6068;Pabiručiai;"Peliukų ";7182565608;Ne;12;2;0;14
6069;Pabiručiai;"Peliukų ";1776325000;Ne;12;0;1;13
6070;Pabiručiai;"Peliukų ";1099080685;Ne;0;10;0;10
6071;Pabiručiai;"Peliukų ";5990497129;Ne;3;3;0;6
6072;Pabiručiai;"Peliukų ";9890225918;Ne;14;0;1;15
6073;Pabiručiai;"Peliukų ";3826505104;Taip;6;0;0;6
6074;Pabiručiai;"Peliukų ";1971996148;Ne;0;2;0;2
6075;Pabiručiai;"Peliukų ";4852287574;Ne;6;0;0;6
6076;Pabiručiai;"Peliukų ";9790360371;Ne;3;0;0;3
6077;Pabiručiai;"Peliukų ";7980170279;Ne;1;0;0;1
6078;Pabiručiai;"Peliukų ";9806520732;Taip;5;0;0;5
6079;Pabiručiai;"Peliukų ";5923385276;Ne;0;0;1;1
6080;Pabiručiai;"Viščiukų ";8254676845;Ne;6;12;0;18
6081;Pabiručiai;"Viščiukų ";6742744014;Ne;0;1;0;1
6082;Pabiručiai;"Viščiukų ";7339565412;Ne;2;0;0;2
6083;Pabiručiai;"Viščiukų ";4880717493;Ne;17;0;1;18
6084;Pabiručiai;"Viščiukų ";1138743823;Ne;0;1;0;1
6085;Pabiručiai;"Viščiukų ";3011601512;Taip;12;0;1;13
6086;Pabiručiai;"Viščiukų ";7798837336;Ne;6;0;0;6
6087;Pabiručiai;"Viščiukų ";7914642744;Ne;10;0;0;10
6088;Pabiručiai;"Viščiukų ";5737214746;Ne;5;0;0;5
6089;Pabiručiai;"Viščiukų ";2141365015;Ne;1;0;0;1
6090;Pabiručiai;"Viščiukų ";8649685325;Ne;0;10;0;10
6091;Pabiručiai;"Viščiukų ";4929129093;Ne;4;5;0;9
6092;Pabiručiai;"Drugelių ";9890868992;Ne;15;0;1;16
6093;Pabiručiai;"Drugelių ";6601800828;Ne;8;0;0;8
6094;Pabiručiai;"Drugelių ";3491721002;Ne;0;0;4;4
6095;Pabiručiai;"Drugelių ";2556330147;Ne;0;14;0;14
6096;Pabiručiai;"Drugelių ";3004152898;Ne;0;16;0;16
6097;Pabiručiai;"Drugelių ";5050966784;Ne;9;0;0;9
6098;Pabiručiai;"Drugelių ";5019580409;Taip;6;0;0;6
6099;Pabiručiai;"Drugelių ";3531292373;Ne;0;7;0;7
6100;Pabiručiai;"Drugelių ";9878655387;Ne;0;1;0;1
6101;Pabiručiai;"Drugelių ";4876140467;Ne;15;1;0;16
6102;Pabiručiai;"Drugelių ";6481162347;Ne;3;0;0;3
6103;Pabiručiai;"Drugelių ";4012537474;Ne;0;0;4;4
6104;Pabiručiai;"Drugelių ";4701982784;Ne;12;0;0;12
6105;Pabiručiai;"Drugelių ";5147367745;Ne;14;0;1;15
6106;Pabiručiai;ŽIRNIUKŲ;5704073222;Ne;5;0;0;5
6107;Pabiručiai;ŽIRNIUKŲ;2924005478;Ne;4;0;1;5
6108;Pabiručiai;ŽIRNIUKŲ;1247522345;Ne;10;0;1;11
6109;Pabiručiai;ŽIRNIUKŲ;1852744763;Ne;8;0;3;11
6110;Pabiručiai;ŽIRNIUKŲ;4851108740;Ne;6;1;1;8
6111;Pabiručiai;ŽIRNIUKŲ;6513943228;Ne;10;0;1;11
6112;Pabiručiai;ŽIRNIUKŲ;2794484633;Ne;9;2;0;11
6113;Pabiručiai;ŽIRNIUKŲ;8870657682;Ne;10;0;0;10
6114;Pabiručiai;ŽIRNIUKŲ;4096412988;Ne;1;5;0;6
6115;Pabiručiai;ŽIRNIUKŲ;3262687187;Ne;0;1;0;1
6116;Pabiručiai;ŽIRNIUKŲ;8092886420;Ne;4;4;0;8
6117;Pabiručiai;ŽIRNIUKŲ;7873575929;Ne;14;3;0;17
6118;Pabiručiai;ŽIRNIUKŲ;5862643827;Ne;5;2;2;9
6119;Pabiručiai;ŽIRNIUKŲ;5184688482;Ne;6;0;0;6
6120;Pabiručiai;ŽIRNIUKŲ;9507212682;Ne;4;2;0;6
6121;Pabiručiai;ŽIRNIUKŲ;9651695086;Ne;17;0;0;17
6122;Pabiručiai;ŽIRNIUKŲ;5899880680;Ne;0;0;9;9
6123;Pagrandukas;Saulytės;7605508460;Ne;0;1;0;1
6124;Pagrandukas;Saulytės;6349387692;Ne;5;2;2;9
6125;Pagrandukas;Saulytės;8186092469;Ne;0;4;0;4
6126;Pagrandukas;Saulytės;2934300533;Ne;0;7;0;7
6127;Pagrandukas;Saulytės;1548697124;Ne;0;6;0;6
6128;Pagrandukas;Saulytės;6711830251;Ne;7;2;0;9
6129;Pagrandukas;Saulytės;7146697128;Ne;5;0;0;5
6130;Pagrandukas;Saulytės;3157676207;Ne;4;1;0;5
6131;Pagrandukas;Saulytės;7511097160;Ne;0;11;0;11
6132;Pagrandukas;Saulytės;5560372136;Ne;0;1;0;1
6133;Pagrandukas;Saulytės;1766912463;Ne;0;4;0;4
6134;Pagrandukas;Saulytės;9849054467;Ne;0;10;0;10
6135;Pagrandukas;Saulytės;8024910647;Ne;0;3;0;3
6136;Pagrandukas;Saulytės;8481502330;Ne;0;4;0;4
6137;Pagrandukas;Saulytės;7160305478;Ne;0;2;0;2
6138;Pagrandukas;Saulytės;3008997793;Ne;0;1;0;1
6139;Pagrandukas;Saulytės;6388805960;Ne;0;0;5;5
6140;Pagrandukas;Saulytės;3050207849;Ne;5;0;0;5
6141;Pagrandukas;Saulytės;8836178193;Ne;6;0;0;6
6142;Pagrandukas;Zuikučiai;7834436515;Ne;0;1;0;1
6143;Pagrandukas;Zuikučiai;7435609306;Ne;0;0;1;1
6144;Pagrandukas;Zuikučiai;5903416384;Ne;5;0;0;5
6145;Pagrandukas;Zuikučiai;2439891231;Ne;0;1;6;7
6146;Pagrandukas;Zuikučiai;6710887776;Ne;0;1;6;7
6147;Pagrandukas;Zuikučiai;7665811353;Taip;5;0;0;5
6148;Pagrandukas;Zuikučiai;2212787835;Ne;0;1;0;1
6149;Pagrandukas;Zuikučiai;2711590019;Ne;0;0;1;1
6150;Pagrandukas;Zuikučiai;6449029299;Ne;0;0;1;1
6151;Pagrandukas;Zuikučiai;1405820070;Ne;1;0;4;5
6152;Pagrandukas;Zuikučiai;1054107640;Ne;16;0;0;16
6153;Pagrandukas;Zuikučiai;1885539883;Ne;0;0;1;1
6154;Pagrandukas;Zuikučiai;2822538227;Ne;0;2;3;5
6155;Pagrandukas;Zuikučiai;1587839122;Ne;15;0;0;15
6156;Pagrandukas;Zuikučiai;2101505576;Ne;0;0;11;11
6157;Pagrandukas;Zuikučiai;5922595170;Ne;12;1;0;13
6158;Pagrandukas;Zuikučiai;9139212151;Ne;0;0;6;6
6159;Pagrandukas;Zuikučiai;8643993939;Ne;3;3;1;7
6160;Pagrandukas;Zuikučiai;5021106231;Ne;6;0;3;9
6161;Pagrandukas;Zuikučiai;3494047045;Ne;0;2;0;2
6162;Pagrandukas;Boružėlių;3888408459;Ne;3;0;0;3
6163;Pagrandukas;Boružėlių;3398225200;Taip;0;2;0;2
6164;Pagrandukas;Boružėlių;5752454925;Taip;0;3;0;3
6165;Pagrandukas;Boružėlių;3587941684;Ne;0;1;0;1
6166;Pagrandukas;Boružėlių;5946007985;Ne;0;1;0;1
6167;Pagrandukas;Boružėlių;7770852445;Ne;0;1;0;1
6168;Pagrandukas;Boružėlių;7271589727;Taip;0;3;0;3
6169;Pagrandukas;Boružėlių;7064391685;Ne;0;0;1;1
6170;Pagrandukas;Boružėlių;5640182548;Ne;0;5;0;5
6171;Pagrandukas;Boružėlių;1403569615;Taip;0;2;0;2
6172;Pagrandukas;Boružėlių;5511396314;Ne;3;4;0;7
6173;Pagrandukas;Boružėlių;9651789217;Taip;5;1;0;6
6174;Pagrandukas;Boružėlių;6911951786;Ne;0;3;0;3
6175;Pagrandukas;Boružėlių;2926077771;Ne;0;8;0;8
6176;Pagrandukas;Boružėlių;2361829423;Ne;0;7;0;7
6177;Pagrandukas;Boružėlių;8286183393;Ne;6;2;0;8
6178;Pagrandukas;Boružėlių;2549704540;Ne;0;2;0;2
6179;Pagrandukas;Boružėlių;9790803767;Ne;2;2;0;4
6180;Pagrandukas;Boružėlių;7043125057;Ne;16;0;0;16
6181;Pagrandukas;Bitutės;6044667668;Ne;0;1;2;3
6182;Pagrandukas;Bitutės;8529974367;Taip;0;2;7;9
6183;Pagrandukas;Bitutės;1938604743;Ne;0;1;0;1
6184;Pagrandukas;Bitutės;4079711515;Taip;0;3;0;3
6185;Pagrandukas;Bitutės;9188382746;Ne;0;3;10;13
6186;Pagrandukas;Bitutės;4603185679;Ne;0;1;0;1
6187;Pagrandukas;Bitutės;5613442667;Taip;10;0;4;14
6188;Pagrandukas;Bitutės;2923517578;Ne;0;14;0;14
6189;Pagrandukas;Bitutės;3875062228;Ne;0;5;2;7
6190;Pagrandukas;Bitutės;4405567649;Taip;9;1;0;10
6191;Pagrandukas;Bitutės;1583104760;Ne;6;0;0;6
6192;Pagrandukas;Bitutės;5649084353;Ne;10;0;0;10
6193;Pagrandukas;Bitutės;8719834064;Ne;5;1;2;8
6194;Pagrandukas;Bitutės;5821945401;Ne;9;0;0;9
6195;Pagrandukas;Bitutės;7675694987;Ne;3;1;0;4
6196;Pagrandukas;Bitutės;3709131197;Ne;14;0;0;14
6197;Pagrandukas;Bitutės;2098182423;Ne;0;1;0;1
6198;Pagrandukas;Bitutės;8280877177;Taip;0;1;0;1
6199;Pagrandukas;Bitutės;2764732768;Ne;4;0;0;4
6200;Pagrandukas;Pelėdžiukai;1714449109;Ne;0;2;0;2
6201;Pagrandukas;Pelėdžiukai;2877401332;Ne;10;1;0;11
6202;Pagrandukas;Pelėdžiukai;8167118045;Ne;10;0;0;10
6203;Pagrandukas;Pelėdžiukai;3390664086;Ne;0;2;0;2
6204;Pagrandukas;Pelėdžiukai;1733723373;Ne;7;0;0;7
6205;Pagrandukas;Pelėdžiukai;6011346969;Ne;7;0;0;7
6206;Pagrandukas;Pelėdžiukai;1077792535;Ne;0;3;0;3
6207;Pagrandukas;Pelėdžiukai;9583471280;Ne;0;3;0;3
6208;Pagrandukas;Pelėdžiukai;2481532396;Ne;16;0;0;16
6209;Pagrandukas;Pelėdžiukai;4398016119;Ne;0;2;0;2
6210;Pagrandukas;Pelėdžiukai;2640777376;Ne;0;0;7;7
6211;Pagrandukas;Pelėdžiukai;4910151924;Ne;5;1;0;6
6212;Pagrandukas;Pelėdžiukai;9431513632;Ne;0;1;0;1
6213;Pagrandukas;Pelėdžiukai;1977974235;Ne;0;2;4;6
6214;Pagrandukas;Pelėdžiukai;7238694532;Ne;3;4;3;10
6215;Pagrandukas;ŠYPSENĖLIŲ;4627387596;Ne;1;0;0;1
6216;Pagrandukas;ŠYPSENĖLIŲ;7173561328;Ne;10;0;1;11
6217;Pagrandukas;ŠYPSENĖLIŲ;5701479990;Ne;1;0;0;1
6218;Pagrandukas;ŠYPSENĖLIŲ;8027783692;Ne;2;0;2;4
6219;Pagrandukas;ŠYPSENĖLIŲ;6248684084;Ne;7;1;1;9
6220;Pagrandukas;ŠYPSENĖLIŲ;2904880156;Ne;3;0;0;3
6221;Pagrandukas;ŠYPSENĖLIŲ;5173633710;Ne;10;0;0;10
6222;Pagrandukas;ŠYPSENĖLIŲ;6057078416;Ne;14;0;0;14
6223;Pagrandukas;ŠYPSENĖLIŲ;1855833141;Ne;6;0;1;7
6224;Pagrandukas;ŠYPSENĖLIŲ;5272914210;Ne;1;0;0;1
6225;Pagrandukas;ŠYPSENĖLIŲ;6517393406;Ne;0;14;0;14
6226;Pagrandukas;ŠYPSENĖLIŲ;4094086585;Ne;7;1;2;10
6227;Pagrandukas;ŠYPSENĖLIŲ;6306635507;Ne;0;5;0;5
6228;Pakalnutė;Pagrandukai;9677810607;Ne;0;2;0;2
6229;Pakalnutė;Pagrandukai;5275833872;Ne;11;3;0;14
6230;Pakalnutė;Pagrandukai;5943686565;Ne;11;0;0;11
6231;Pakalnutė;Pagrandukai;2296079246;Ne;20;0;0;20
6232;Pakalnutė;Pagrandukai;9313588621;Ne;10;0;0;10
6233;Pakalnutė;Pagrandukai;5180015882;Ne;13;0;0;13
6234;Pakalnutė;Pagrandukai;3794283102;Ne;4;0;0;4
6235;Pakalnutė;Pagrandukai;3070652992;Ne;16;0;0;16
6236;Pakalnutė;Pagrandukai;7477188659;Ne;6;1;0;7
6237;Pakalnutė;Pagrandukai;4390444128;Ne;10;0;0;10
6238;Pakalnutė;Pagrandukai;2642359967;Ne;2;1;0;3
6239;Pakalnutė;Pagrandukai;1614993691;Taip;9;0;0;9
6240;Pakalnutė;Pagrandukai;6396963609;Ne;15;0;0;15
6241;Pakalnutė;Pagrandukai;6708041407;Ne;12;0;0;12
6242;Pakalnutė;Pagrandukai;1883500676;Ne;0;0;1;1
6243;Pakalnutė;"Pelėdžiukų ";8553182620;Ne;0;5;1;6
6244;Pakalnutė;"Pelėdžiukų ";3840499737;Ne;14;1;0;15
6245;Pakalnutė;"Pelėdžiukų ";4523766424;Ne;8;0;0;8
6246;Pakalnutė;"Pelėdžiukų ";6577255841;Ne;0;2;0;2
6247;Pakalnutė;"Pelėdžiukų ";7151877991;Ne;0;0;4;4
6248;Pakalnutė;"Pelėdžiukų ";2992768162;Ne;5;3;0;8
6249;Pakalnutė;"Pelėdžiukų ";9505524183;Ne;9;0;0;9
6250;Pakalnutė;"Pelėdžiukų ";8823232039;Ne;0;2;0;2
6251;Pakalnutė;"Pelėdžiukų ";2035060922;Ne;10;0;0;10
6252;Pakalnutė;"Pelėdžiukų ";7325137583;Taip;0;1;0;1
6253;Pakalnutė;"Pelėdžiukų ";4220368864;Ne;0;1;0;1
6254;Pakalnutė;"Pelėdžiukų ";1330092247;Ne;1;6;0;7
6255;Pakalnutė;"Pelėdžiukų ";3267680599;Ne;1;2;0;3
6256;Pakalnutė;Ežiukai;5058727058;Ne;3;0;0;3
6257;Pakalnutė;Ežiukai;4052166895;Ne;2;0;0;2
6258;Pakalnutė;Ežiukai;1070172991;Taip;0;1;2;3
6259;Pakalnutė;Ežiukai;9781993614;Ne;10;4;0;14
6260;Pakalnutė;Ežiukai;8081932074;Ne;6;0;0;6
6261;Pakalnutė;Ežiukai;9706455707;Ne;0;0;1;1
6262;Pakalnutė;Ežiukai;7881545979;Ne;3;4;0;7
6263;Pakalnutė;Ežiukai;8080989574;Ne;3;8;0;11
6264;Pakalnutė;Ežiukai;5911381706;Ne;0;1;0;1
6265;Pakalnutė;Ežiukai;2755412687;Ne;12;1;0;13
6266;Pakalnutė;Ežiukai;8236718590;Ne;4;0;0;4
6267;Pakalnutė;Ežiukai;3064391379;Ne;6;0;4;10
6268;Pakalnutė;Ežiukai;2015778005;Ne;6;0;0;6
6269;Pakalnutė;Skruzdėliukų;4033813807;Ne;1;0;0;1
6270;Pakalnutė;Skruzdėliukų;7503936754;Ne;6;0;0;6
6271;Pakalnutė;Skruzdėliukų;5409476517;Ne;5;9;0;14
6272;Pakalnutė;Skruzdėliukų;2670302354;Ne;8;0;0;8
6273;Pakalnutė;Skruzdėliukų;7105369111;Ne;5;0;0;5
6274;Pakalnutė;Skruzdėliukų;1195872320;Ne;2;1;0;3
6275;Pakalnutė;Skruzdėliukų;3211633472;Ne;0;1;0;1
6276;Pakalnutė;Skruzdėliukų;4423348418;Ne;0;2;0;2
6277;Pakalnutė;Skruzdėliukų;6055727963;Taip;0;4;0;4
6278;Pakalnutė;Skruzdėliukų;5619262190;Ne;5;0;0;5
6279;Pakalnutė;Skruzdėliukų;3215438452;Ne;5;1;0;6
6280;Pakalnutė;Skruzdėliukų;9681515221;Ne;0;4;0;4
6281;Pakalnutė;Skruzdėliukų;8496839980;Taip;2;0;0;2
6282;Pakalnutė;Skruzdėliukų;9336711927;Ne;0;0;15;15
6283;Pakalnutė;Skruzdėliukų;3288449407;Ne;8;0;0;8
6284;Pakalnutė;Skruzdėliukų;1540045675;Ne;0;3;0;3
6285;Pakalnutė;Bitučių;8461220770;Ne;0;0;1;1
6286;Pakalnutė;Bitučių;2765220889;Ne;9;2;3;14
6287;Pakalnutė;Bitučių;5532458706;Ne;5;3;0;8
6288;Pakalnutė;Bitučių;7526989580;Ne;12;0;0;12
6289;Pakalnutė;Bitučių;3306334576;Ne;7;0;5;12
6290;Pakalnutė;Bitučių;5342592825;Ne;6;0;0;6
6291;Pakalnutė;Bitučių;2932205226;Ne;5;2;0;7
6292;Pakalnutė;Bitučių;5464143742;Ne;9;0;2;11
6293;Pakalnutė;Bitučių;2070744110;Ne;0;0;3;3
6294;Pakalnutė;Bitučių;3965390135;Ne;0;0;2;2
6295;Pakalnutė;Bitučių;5355198213;Ne;2;0;0;2
6296;Pakalnutė;Bitučių;4533467194;Ne;6;0;2;8
6297;Pakalnutė;Boružiukų;6798939288;Ne;0;2;0;2
6298;Pakalnutė;Boružiukų;4934095931;Ne;0;5;0;5
6299;Pakalnutė;Boružiukų;5039000154;Ne;0;1;0;1
6300;Pakalnutė;Boružiukų;6575909478;Ne;1;2;3;6
6301;Pakalnutė;Boružiukų;2835611316;Ne;5;0;0;5
6302;Pakalnutė;Boružiukų;7672252382;Ne;2;4;0;6
6303;Pakalnutė;Boružiukų;4950195858;Ne;9;0;0;9
6304;Pakalnutė;Boružiukų;4927086034;Ne;12;0;0;12
6305;Pakalnutė;Boružiukų;6557165567;Ne;16;0;0;16
6306;Pakalnutė;Boružiukų;3677709759;Ne;5;0;3;8
6307;Pakalnutė;Boružiukų;2597900983;Ne;6;0;0;6
6308;Pakalnutė;Boružiukų;2062721289;Ne;2;2;2;6
6309;Pakalnutė;Boružiukų;1340022702;Ne;11;3;0;14
6310;Pakalnutė;Boružiukų;6228196996;Ne;16;0;0;16
6311;Pakalnutė;Boružiukų;7563201788;Ne;0;5;0;5
6312;Pakalnutė;Meškiukų;2666441234;Ne;3;0;0;3
6313;Pakalnutė;Meškiukų;4256222944;Taip;0;7;0;7
6314;Pakalnutė;Meškiukų;2101821362;Ne;6;3;0;9
6315;Pakalnutė;Meškiukų;4069910346;Ne;13;0;1;14
6316;Pakalnutė;Meškiukų;4313652059;Ne;0;3;1;4
6317;Pakalnutė;Meškiukų;7084798190;Ne;12;5;0;17
6318;Pakalnutė;Meškiukų;6133481935;Ne;0;1;0;1
6319;Pakalnutė;Meškiukų;3693337607;Ne;3;0;0;3
6320;Pakalnutė;Meškiukų;2923698853;Ne;9;7;0;16
6321;Pakalnutė;Meškiukų;1369906621;Ne;0;0;1;1
6322;Pakalnutė;Nykštukai;9918277117;Ne;7;0;0;7
6323;Pakalnutė;Nykštukai;6633585181;Ne;11;0;0;11
6324;Pakalnutė;Nykštukai;3870628774;Ne;1;0;3;4
6325;Pakalnutė;Nykštukai;8324219868;Ne;10;0;0;10
6326;Pakalnutė;Nykštukai;1864990681;Ne;8;0;0;8
6327;Pakalnutė;Nykštukai;2063766287;Ne;0;2;0;2
6328;Pakalnutė;Nykštukai;6528913736;Taip;0;1;0;1
6329;Pakalnutė;Nykštukai;8217779439;Ne;4;0;0;4
6330;Pakalnutė;Nykštukai;6206296685;Ne;0;20;0;20
6331;Pakalnutė;Nykštukai;8855237588;Taip;5;3;0;8
6332;Pakalnutė;Nykštukai;1561411767;Ne;6;14;0;20
6333;Pakalnutė;Nykštukai;9443826616;Ne;6;0;0;6
6334;Pakalnutė;Nykštukai;7024440142;Ne;6;0;0;6
6335;Pakalnutė;Nykštukai;2578170222;Ne;0;1;2;3
6336;Pakalnutė;Nykštukai;3967515235;Ne;6;0;0;6
6337;Pakalnutė;Nykštukai;5377715404;Ne;15;0;1;16
6338;Pakalnutė;Nykštukai;3938091521;Ne;14;0;0;14
6339;Pakalnutė;Nykštukai;4971065032;Ne;6;0;0;6
6340;Pakalnutė;"Zuikučių ";1198230323;Ne;0;0;1;1
6341;Pakalnutė;"Zuikučių ";3609982613;Ne;8;1;0;9
6342;Pakalnutė;"Zuikučių ";5958653847;Ne;3;0;0;3
6343;Pakalnutė;"Zuikučių ";1147843795;Ne;0;2;0;2
6344;Pakalnutė;"Zuikučių ";1583462733;Ne;6;0;0;6
6345;Pakalnutė;"Zuikučių ";6377564215;Ne;5;0;0;5
6346;Pakalnutė;"Zuikučių ";8813262660;Ne;5;1;0;6
6347;Pakalnutė;"Zuikučių ";7949588551;Ne;6;2;0;8
6348;Pakalnutė;"Zuikučių ";2002555659;Ne;6;0;2;8
6349;Pakalnutė;"Zuikučių ";4681267749;Ne;0;5;0;5
6350;Pakalnutė;"Zuikučių ";6884488772;Ne;2;0;1;3
6351;Pakalnutė;"Zuikučių ";5912904296;Ne;7;1;0;8
6352;Pakalnutė;"Drugelių ";5441477374;Ne;0;7;0;7
6353;Pakalnutė;"Drugelių ";7369661890;Ne;5;0;1;6
6354;Pakalnutė;"Drugelių ";7766653114;Ne;0;0;20;20
6355;Pakalnutė;"Drugelių ";7709684372;Ne;10;0;1;11
6356;Pakalnutė;"Drugelių ";9620000116;Ne;11;0;2;13
6357;Pakalnutė;"Drugelių ";5502444590;Ne;6;0;0;6
6358;Pakalnutė;"Drugelių ";1824418095;Ne;0;0;2;2
6359;Pakalnutė;"Drugelių ";9461133636;Ne;7;0;0;7
6360;Pakalnutė;"Drugelių ";4220406978;Ne;2;0;2;4
6361;Pakalnutė;"Drugelių ";5069038636;Ne;0;20;0;20
6362;Pakalnutė;"Drugelių ";7047587606;Ne;19;0;0;19
6363;Pakalnutė;"Drugelių ";2653667596;Ne;10;1;0;11
6364;Pakalnutė;"Drugelių ";2026242407;Ne;5;0;1;6
6365;Pakalnutė;"Drugelių ";2197533802;Ne;0;1;2;3
6366;Pakalnutė;"Drugelių ";4127500142;Ne;11;0;5;16
6367;Pakalnutė;"Drugelių ";9295709508;Taip;12;0;0;12
6368;Pakalnutė;"Drugelių ";6924023022;Ne;11;0;3;14
6369;Pakalnutė;Žvirbliukų;7421275778;Ne;6;0;1;7
6370;Pakalnutė;Žvirbliukų;8329725085;Ne;6;1;0;7
6371;Pakalnutė;Žvirbliukų;3190067149;Taip;0;2;0;2
6372;Pakalnutė;Žvirbliukų;7548659665;Ne;8;1;1;10
6373;Pakalnutė;Žvirbliukų;8010667913;Ne;16;0;3;19
6374;Pakalnutė;Žvirbliukų;1662773049;Ne;12;0;0;12
6375;Pakalnutė;Žvirbliukų;5531209454;Ne;25;0;0;25
6376;Pakalnutė;Žvirbliukų;3342793992;Ne;0;0;1;1
6377;Pakalnutė;Žvirbliukų;7258417347;Ne;12;0;1;13
6378;Pakalnutė;Žvirbliukų;4961361687;Ne;6;0;0;6
6379;Pakalnutė;Žvirbliukų;5878352514;Ne;6;0;2;8
6380;Pakalnutė;Žvirbliukų;5685361033;Ne;6;1;1;8
6381;Pakalnutė;Žvirbliukų;7782295402;Ne;6;0;1;7
6382;Pakalnutė;Žvirbliukų;7547661599;Taip;14;1;1;16
6383;Pakalnutė;Žvirbliukų;4469974699;Ne;0;1;0;1
6384;Pakalnutė;Žvirbliukų;6159955311;Ne;19;0;0;19
6385;Pakalnutė;Žvirbliukų;3903972025;Ne;1;6;0;7
6386;Pakalnutė;Žvirbliukų;8567965305;Ne;0;0;1;1
6387;Pakalnutė;Žvirbliukų;3458404368;Ne;9;1;2;12
6388;Panerių;Rūtelė;4689913361;Taip;0;0;4;4
6389;Panerių;Rūtelė;2195332401;Ne;0;0;1;1
6390;Panerių;Rūtelė;2571561865;Taip;0;3;0;3
6391;Panerių;Rūtelė;6908487075;Taip;0;0;7;7
6392;Panerių;Rūtelė;2643410976;Ne;0;0;5;5
6393;Panerių;Rūtelė;8771264170;Ne;0;0;5;5
6394;Panerių;Rūtelė;3346395516;Taip;1;0;0;1
6395;Panerių;Rūtelė;7805429137;Ne;0;0;15;15
6396;Panerių;Rūtelė;9268618414;Ne;0;0;4;4
6397;Panerių;Rūtelė;6411372006;Taip;14;0;4;18
6398;Panerių;Rūtelė;1419817211;Ne;1;0;0;1
6399;Panerių;Rūtelė;2333355325;Ne;0;0;1;1
6400;Panerių;Rūtelė;2235123048;Ne;5;0;1;6
6401;Panerių;Rūtelė;3190117304;Taip;0;10;0;10
6402;Panerių;Rūtelė;8693113275;Taip;1;0;6;7
6403;Panerių;Rūtelė;9630302749;Ne;2;0;0;2
6404;Panerių;Gėlytės;8514805919;Ne;5;0;2;7
6405;Panerių;Gėlytės;1339256258;Ne;5;0;0;5
6406;Panerių;Gėlytės;9729731866;Ne;1;0;0;1
6407;Panerių;Gėlytės;6583134855;Ne;4;0;2;6
6408;Panerių;Gėlytės;3948776877;Ne;4;0;2;6
6409;Panerių;Gėlytės;2751334281;Ne;0;0;2;2
6410;Panerių;Gėlytės;9432171719;Ne;5;0;0;5
6411;Panerių;Gėlytės;5452996791;Ne;12;0;0;12
6412;Panerių;Gėlytės;1717129076;Ne;20;0;0;20
6413;Panerių;Gėlytės;2035822976;Ne;9;0;1;10
6414;Panerių;Gėlytės;8447920373;Ne;0;0;1;1
6415;Panerių;Gėlytės;4161189870;Taip;0;8;7;15
6416;Panerių;Gėlytės;9004310393;Ne;19;0;0;19
6417;Panerių;Gėlytės;3112608087;Taip;3;0;1;4
6418;Panerių;Gėlytės;5100874548;Ne;10;0;0;10
6419;Panerių;Gėlytės;9955613696;Ne;4;0;0;4
6420;Panerių;Gėlytės;3882802840;Ne;0;2;0;2
6421;Panerių;Gėlytės;6304387432;Ne;0;0;10;10
6422;Panerių;Gėlytės;7166964095;Ne;1;0;2;3
6423;Panerių;Gėlytės;8109366029;Ne;0;0;1;1
6424;Panerių;Boružė;7657860513;Taip;9;1;0;10
6425;Panerių;Boružė;4369979548;Taip;11;4;0;15
6426;Panerių;Boružė;3273655606;Ne;15;0;0;15
6427;Panerių;Boružė;8067240250;Ne;6;0;2;8
6428;Panerių;Boružė;3526636673;Ne;5;0;0;5
6429;Panerių;Boružė;8407995549;Ne;0;7;0;7
6430;Panerių;Boružė;3502494751;Ne;0;0;6;6
6431;Panerių;Boružė;6574858142;Ne;8;0;0;8
6432;Panerių;Boružė;6653710644;Ne;0;1;0;1
6433;Panerių;Boružė;9288515724;Ne;20;0;0;20
6434;Panerių;Boružė;7976634590;Taip;0;0;1;1
6435;Panerių;Boružė;4716214117;Ne;4;5;0;9
6436;Panerių;Boružė;4957564440;Ne;0;0;3;3
6437;Panerių;Boružė;1985780685;Ne;12;0;0;12
6438;Panerių;BORUŽĖ;1519192757;Ne;14;0;0;14
6439;Papartis;ZUIKUČIAI;8874222586;Ne;0;0;6;6
6440;Papartis;ZUIKUČIAI;2446379598;Ne;0;0;2;2
6441;Papartis;ZUIKUČIAI;3054883426;Ne;1;0;2;3
6442;Papartis;ZUIKUČIAI;1191546794;Ne;3;0;2;5
6443;Papartis;ZUIKUČIAI;7619963429;Ne;0;1;0;1
6444;Papartis;ZUIKUČIAI;8958880558;Ne;6;4;0;10
6445;Papartis;ZUIKUČIAI;4380030213;Ne;4;0;0;4
6446;Papartis;ZUIKUČIAI;4906248064;Ne;0;1;3;4
6447;Papartis;ZUIKUČIAI;8447326505;Ne;5;1;1;7
6448;Papartis;ZUIKUČIAI;1919362027;Ne;3;1;0;4
6449;Papartis;ZUIKUČIAI;4640068595;Ne;0;1;0;1
6450;Papartis;ZUIKUČIAI;5796928317;Ne;0;2;0;2
6451;Papartis;ZUIKUČIAI;9375751990;Ne;6;7;0;13
6452;Papartis;ZUIKUČIAI;5776038830;Ne;11;0;0;11
6453;Papartis;ZUIKUČIAI;5579899922;Ne;10;0;2;12
6454;Papartis;ZUIKUČIAI;9358310527;Ne;3;3;0;6
6455;Papartis;ZUIKUČIAI;5363926529;Ne;0;4;0;4
6456;Papartis;ZUIKUČIAI;1722192450;Ne;8;1;0;9
6457;Papartis;DRUGELIAI;8005876431;Ne;18;0;0;18
6458;Papartis;DRUGELIAI;7384518191;Ne;0;0;6;6
6459;Papartis;DRUGELIAI;6664178454;Ne;0;1;1;2
6460;Papartis;DRUGELIAI;2432516496;Ne;5;2;0;7
6461;Papartis;DRUGELIAI;7742769931;Ne;9;0;1;10
6462;Papartis;DRUGELIAI;8305560946;Ne;0;0;4;4
6463;Papartis;DRUGELIAI;4778327620;Ne;12;0;0;12
6464;Papartis;DRUGELIAI;7486667034;Ne;0;0;1;1
6465;Papartis;DRUGELIAI;7331682622;Ne;14;0;1;15
6466;Papartis;DRUGELIAI;2824078830;Ne;10;0;0;10
6467;Papartis;DRUGELIAI;8782882575;Ne;0;6;0;6
6468;Papartis;DRUGELIAI;1405767603;Ne;0;2;2;4
6469;Papartis;DRUGELIAI;6435625940;Ne;5;1;3;9
6470;Papartis;DRUGELIAI;7187797639;Ne;1;0;10;11
6471;Papartis;DRUGELIAI;3411472740;Ne;12;0;3;15
6472;Papartis;DRUGELIAI;3209105694;Ne;10;0;0;10
6473;Papartis;DRUGELIAI;8277830926;Ne;3;0;0;3
6474;Papartis;DRUGELIAI;1759982543;Ne;0;1;2;3
6475;Papartis;DRUGELIAI;4689046394;Ne;7;1;0;8
6476;Papartis;DRUGELIAI;5430993785;Ne;4;0;0;4
6477;Papartis;ŽVIRBLIUKAI;7590170146;Ne;7;0;0;7
6478;Papartis;ŽVIRBLIUKAI;3408756311;Ne;5;0;0;5
6479;Papartis;ŽVIRBLIUKAI;4935694347;Ne;0;0;3;3
6480;Papartis;ŽVIRBLIUKAI;7067369268;Ne;8;0;0;8
6481;Papartis;ŽVIRBLIUKAI;1836914270;Ne;0;0;1;1
6482;Papartis;ŽVIRBLIUKAI;4508053349;Ne;3;1;0;4
6483;Papartis;ŽVIRBLIUKAI;2778629398;Ne;7;0;1;8
6484;Papartis;ŽVIRBLIUKAI;2535412635;Ne;12;0;0;12
6485;Papartis;ŽVIRBLIUKAI;7102350653;Ne;6;0;1;7
6486;Papartis;ŽVIRBLIUKAI;1205854439;Ne;0;0;2;2
6487;Papartis;ŽVIRBLIUKAI;8148483438;Ne;0;0;4;4
6488;Papartis;ŽVIRBLIUKAI;3295731801;Ne;0;1;0;1
6489;Papartis;ŽVIRBLIUKAI;6797687614;Ne;5;0;1;6
6490;Papartis;ŽVIRBLIUKAI;3475745012;Ne;14;0;1;15
6491;Papartis;ŽVIRBLIUKAI;4634683589;Ne;4;0;2;6
6492;Papartis;ŽVIRBLIUKAI;3243869451;Ne;2;0;0;2
6493;Papartis;ŽVIRBLIUKAI;5265293240;Ne;0;0;4;4
6494;Papartis;ŽVIRBLIUKAI;9134335737;Ne;0;0;6;6
6495;Papartis;ŽVIRBLIUKAI;7387281720;Ne;0;1;0;1
6496;Papartis;PELĖDŽIUKAI;7606939822;Ne;5;0;0;5
6497;Papartis;PELĖDŽIUKAI;2447926422;Ne;0;2;0;2
6498;Papartis;PELĖDŽIUKAI;1260151691;Ne;5;1;0;6
6499;Papartis;PELĖDŽIUKAI;4346817695;Ne;0;0;2;2
6500;Papartis;PELĖDŽIUKAI;1527263538;Ne;0;7;1;8
6501;Papartis;PELĖDŽIUKAI;1219140467;Ne;15;0;0;15
6502;Papartis;PELĖDŽIUKAI;5410369044;Ne;6;6;0;12
6503;Papartis;PELĖDŽIUKAI;1065128993;Ne;0;2;1;3
6504;Papartis;PELĖDŽIUKAI;6126912448;Ne;0;2;0;2
6505;Papartis;PELĖDŽIUKAI;8952917454;Ne;0;0;5;5
6506;Papartis;PELĖDŽIUKAI;3182457453;Ne;3;1;0;4
6507;Papartis;PELĖDŽIUKAI;5675537250;Ne;6;1;0;7
6508;Papartis;PELĖDŽIUKAI;72182866449;Ne;0;0;1;1
6509;Papartis;PELĖDŽIUKAI;7703070601;Ne;8;1;0;9
6510;Papartis;PELĖDŽIUKAI;7902130389;Ne;1;1;1;3
6511;Papartis;PELĖDŽIUKAI;4279580382;Taip;7;2;0;9
6512;Papartis;PELĖDŽIUKAI;1974159967;Ne;4;0;1;5
6513;Papartis;PELĖDŽIUKAI;5732853976;Ne;0;0;3;3
6514;Papartis;PELĖDŽIUKAI;1554777403;Ne;0;1;1;2
6515;Papartis;PELĖDŽIUKAI;7768672610;Ne;1;1;1;3
6516;Papartis;PELĖDŽIUKAI;3107106078;Ne;3;0;0;3
6517;Papartis;SAULUTĖS;5538433120;Taip;0;1;4;5
6518;Papartis;SAULUTĖS;6585372451;Ne;0;1;0;1
6519;Papartis;SAULUTĖS;6734567714;Ne;0;2;0;2
6520;Papartis;SAULUTĖS;4570512336;Taip;6;1;1;8
6521;Papartis;SAULUTĖS;1231594320;Ne;4;0;0;4
6522;Papartis;SAULUTĖS;3539507686;Ne;0;5;3;8
6523;Papartis;SAULUTĖS;6977513472;Ne;0;1;1;2
6524;Papartis;SAULUTĖS;9380951144;Ne;8;1;2;11
6525;Papartis;SAULUTĖS;4016297254;Ne;0;0;15;15
6526;Papartis;SAULUTĖS;5323875279;Ne;0;3;0;3
6527;Papartis;SAULUTĖS;5465955537;Ne;11;0;1;12
6528;Papartis;SAULUTĖS;2812347963;Ne;12;0;0;12
6529;Papartis;SAULUTĖS;4597039190;Ne;6;0;0;6
6530;Papartis;SAULUTĖS;8420752169;Taip;0;2;10;12
6531;Papartis;SAULUTĖS;6346776139;Ne;6;1;1;8
6532;Papartis;SAULUTĖS;1352401881;Ne;5;5;0;10
6533;Papartis;SAULUTĖS;6136213985;Ne;0;2;6;8
6534;Papartis;SAULUTĖS;7107692314;Ne;0;2;4;6
6535;Papartis;GANDRIUKAI;4878190663;Ne;0;0;1;1
6536;Papartis;GANDRIUKAI;9900023788;Ne;19;0;0;19
6537;Papartis;GANDRIUKAI;2783708905;Taip;14;0;1;15
6538;Papartis;GANDRIUKAI;6883101103;Ne;0;1;0;1
6539;Papartis;GANDRIUKAI;2868899342;Taip;0;1;2;3
6540;Papartis;GANDRIUKAI;9384670351;Ne;0;1;1;2
6541;Papartis;GANDRIUKAI;9968072478;Taip;15;0;0;15
6542;Papartis;GANDRIUKAI;2215846642;Taip;0;2;0;2
6543;Papartis;GANDRIUKAI;3320524073;Taip;0;0;2;2
6544;Papartis;GANDRIUKAI;9704930584;Ne;0;5;0;5
6545;Papartis;GANDRIUKAI;9804863902;Taip;9;0;0;9
6546;Papartis;GANDRIUKAI;9072635586;Ne;0;7;0;7
6547;Papartis;GANDRIUKAI;7859096984;Taip;0;2;0;2
6548;Papartis;GANDRIUKAI;1442806517;Ne;0;0;4;4
6549;Papartis;GANDRIUKAI;7252265838;Taip;9;0;1;10
6550;Papartis;GANDRIUKAI;9978625382;Taip;12;0;1;13
6551;Papartis;GANDRIUKAI;5883751305;Ne;0;1;0;1
6552;Papartis;GANDRIUKAI;4509843536;Taip;0;0;20;20
6553;Papartis;GANDRIUKAI;8768526171;Taip;16;0;0;16
6554;Papartis;AITVARELIAI;8891856856;Ne;6;1;0;7
6555;Papartis;AITVARELIAI;6889782462;Ne;0;2;4;6
6556;Papartis;AITVARELIAI;8532558577;Ne;0;2;2;4
6557;Papartis;AITVARELIAI;4918854899;Ne;0;2;0;2
6558;Papartis;AITVARELIAI;5252947502;Ne;0;1;0;1
6559;Papartis;AITVARELIAI;4261270064;Ne;0;2;0;2
6560;Papartis;AITVARELIAI;6416605464;Ne;7;0;0;7
6561;Papartis;AITVARELIAI;1266338760;Ne;5;0;0;5
6562;Papartis;AITVARELIAI;7504793827;Ne;1;0;1;2
6563;Papartis;AITVARELIAI;7156767639;Ne;11;0;0;11
6564;Papartis;AITVARELIAI;5268226380;Ne;0;5;0;5
6565;Papartis;AITVARELIAI;2116140075;Ne;0;3;0;3
6566;Papartis;AITVARELIAI;3896803048;Ne;0;2;1;3
6567;Papartis;AITVARELIAI;4138926711;Taip;0;0;1;1
6568;Papartis;AITVARELIAI;8989172483;Ne;0;0;10;10
6569;Papartis;AITVARELIAI;9384475270;Ne;0;3;0;3
6570;Papartis;SMALSUČIAI;5383936595;Ne;11;1;0;12
6571;Papartis;SMALSUČIAI;1698871014;Ne;7;1;0;8
6572;Papartis;SMALSUČIAI;6274608449;Ne;15;0;0;15
6573;Papartis;SMALSUČIAI;6664773988;Ne;0;2;0;2
6574;Papartis;SMALSUČIAI;8875490564;Ne;4;7;0;11
6575;Papartis;SMALSUČIAI;2921187615;Ne;9;0;0;9
6576;Papartis;SMALSUČIAI;5128663521;Ne;7;0;1;8
6577;Papartis;SMALSUČIAI;4500675679;Ne;0;5;0;5
6578;Papartis;SMALSUČIAI;7203919287;Ne;6;0;0;6
6579;Papartis;SMALSUČIAI;1486770896;Ne;7;0;0;7
6580;Papartis;SMALSUČIAI;5132031416;Ne;10;0;0;10
6581;Papartis;SMALSUČIAI;3395306653;Ne;1;3;0;4
6582;Papartis;SMALSUČIAI;5964232886;Ne;0;2;0;2
6583;Papartis;SMALSUČIAI;7149853209;Ne;0;0;1;1
6584;Papartis;SMALSUČIAI;4483401826;Ne;11;0;0;11
6585;Papartis;SMALSUČIAI;1616537800;Ne;0;5;0;5
6586;Papartis;"ŽIRNIUKAI ";3310893254;Ne;5;0;0;5
6587;Papartis;"ŽIRNIUKAI ";1073755384;Ne;0;6;3;9
6588;Papartis;"ŽIRNIUKAI ";7647225316;Ne;6;8;0;14
6589;Papartis;"ŽIRNIUKAI ";1210592579;Ne;0;0;2;2
6590;Papartis;"ŽIRNIUKAI ";1519815331;Ne;1;1;1;3
6591;Papartis;"ŽIRNIUKAI ";4158525314;Ne;4;0;0;4
6592;Papartis;"ŽIRNIUKAI ";4978398085;Ne;0;2;0;2
6593;Papartis;"ŽIRNIUKAI ";9746397380;Ne;9;0;0;9
6594;Papartis;"ŽIRNIUKAI ";4952279543;Ne;0;3;0;3
6595;Papartis;"ŽIRNIUKAI ";5276806556;Ne;5;0;2;7
6596;Papartis;"ŽIRNIUKAI ";2521609574;Ne;12;0;0;12
6597;Papartis;"ŽIRNIUKAI ";7617558492;Ne;0;0;7;7
6598;Papartis;"ŽIRNIUKAI ";1267981238;Ne;0;10;10;20
6599;Papartis;"ŽIRNIUKAI ";2772758899;Ne;15;0;2;17
6600;Papartis;"ŽIRNIUKAI ";1183123161;Ne;5;0;0;5
6601;Papartis;"ŽIRNIUKAI ";1150772988;Ne;0;1;0;1
6602;Papartis;"ŽIRNIUKAI ";6615368741;Ne;10;0;1;11
6603;Papartis;"ŽIRNIUKAI ";7108606229;Ne;5;0;0;5
6604;Papartis;"ŽIRNIUKAI ";1614261572;Ne;7;1;0;8
6605;Papartis;"ŽIRNIUKAI ";8834463589;Ne;11;0;0;11
6606;Papartis;BORUŽĖLĖS;3576856223;Ne;0;3;0;3
6607;Papartis;BORUŽĖLĖS;7492923318;Ne;10;0;0;10
6608;Papartis;BORUŽĖLĖS;1157298413;Ne;0;2;0;2
6609;Papartis;BORUŽĖLĖS;2079105902;Ne;0;4;0;4
6610;Papartis;BORUŽĖLĖS;1159418157;Ne;8;0;0;8
6611;Papartis;BORUŽĖLĖS;3490370261;Ne;20;0;0;20
6612;Papartis;BORUŽĖLĖS;3107245976;Ne;0;0;1;1
6613;Papartis;BORUŽĖLĖS;1566259150;Ne;20;0;0;20
6614;Papartis;BORUŽĖLĖS;1381195839;Ne;0;2;0;2
6615;Papartis;BORUŽĖLĖS;6107558090;Ne;0;1;0;1
6616;Papartis;BORUŽĖLĖS;6776383676;Ne;16;1;0;17
6617;Papartis;BORUŽĖLĖS;9838432144;Ne;0;4;0;4
6618;Papartis;BORUŽĖLĖS;9884399306;Ne;0;5;0;5
6619;Papartis;BORUŽĖLĖS;1511111597;Ne;15;0;0;15
6620;Papartis;BORUŽĖLĖS;8055310718;Ne;8;0;0;8
6621;Papartis;BORUŽĖLĖS;5259754395;Ne;0;6;0;6
6622;Papartis;BORUŽĖLĖS;5959006739;Ne;4;1;0;5
6623;Papartis;VARPELIAI;7260304487;Ne;13;0;0;13
6624;Papartis;VARPELIAI;9581159294;Ne;9;0;5;14
6625;Papartis;VARPELIAI;2956950308;Ne;11;0;1;12
6626;Papartis;VARPELIAI;6710049689;Ne;1;0;5;6
6627;Papartis;VARPELIAI;2777359899;Taip;6;0;0;6
6628;Papartis;VARPELIAI;1993893368;Ne;1;1;0;2
6629;Papartis;VARPELIAI;3345085436;Ne;0;1;5;6
6630;Papartis;VARPELIAI;7189999679;Ne;6;0;0;6
6631;Papartis;VARPELIAI;4256878733;Ne;9;0;0;9
6632;Papartis;VARPELIAI;8443731277;Ne;1;0;3;4
6633;Papartis;VARPELIAI;3419374226;Taip;0;0;20;20
6634;Papartis;VARPELIAI;2600724041;Ne;14;0;0;14
6635;Papartis;VARPELIAI;2053568874;Ne;13;8;0;21
6636;Papartis;VARPELIAI;4952700737;Ne;14;0;0;14
6637;Papartis;VARPELIAI;8642079824;Ne;6;0;1;7
6638;Papartis;VARPELIAI;2421158534;Ne;4;0;0;4
6639;Papartis;VARPELIAI;8872914372;Ne;6;1;1;8
6640;Papartis;NYKŠTUKAI;1566011843;Taip;2;0;3;5
6641;Papartis;NYKŠTUKAI;5652769035;Taip;3;0;0;3
6642;Papartis;NYKŠTUKAI;5942160584;Ne;11;0;0;11
6643;Papartis;NYKŠTUKAI;1680412204;Ne;10;0;1;11
6644;Papartis;NYKŠTUKAI;9285319899;Ne;7;0;2;9
6645;Papartis;NYKŠTUKAI;6949120693;Taip;0;4;0;4
6646;Papartis;NYKŠTUKAI;6794076631;Ne;9;1;0;10
6647;Papartis;NYKŠTUKAI;5608868738;Ne;0;4;0;4
6648;Papartis;NYKŠTUKAI;4203241118;Ne;0;1;0;1
6649;Papartis;NYKŠTUKAI;4806652727;Ne;0;1;0;1
6650;Papartis;NYKŠTUKAI;8932290803;Ne;0;0;2;2
6651;Papartis;NYKŠTUKAI;5652560002;Ne;6;1;1;8
6652;Papartis;NYKŠTUKAI;1559196767;Ne;0;0;7;7
6653;Papartis;NYKŠTUKAI;6360881137;Ne;1;1;0;2
6654;Papartis;NYKŠTUKAI;6941978169;Taip;0;1;0;1
6655;Papartis;NYKŠTUKAI;7080578299;Taip;0;0;1;1
6656;Pasaka;Drugelių;5665758011;Ne;0;2;3;5
6657;Pasaka;Drugelių;3092993659;Ne;0;2;1;3
6658;Pasaka;Drugelių;5027755073;Ne;0;2;1;3
6659;Pasaka;Drugelių;1300996831;Ne;0;3;0;3
6660;Pasaka;Drugelių;1313576071;Ne;0;2;2;4
6661;Pasaka;Drugelių;7455544922;Ne;3;0;0;3
6662;Pasaka;Drugelių;8963465320;Ne;6;0;0;6
6663;Pasaka;Drugelių;4743331873;Ne;0;9;0;9
6664;Pasaka;Drugelių;1583090840;Ne;0;2;0;2
6665;Pasaka;Drugelių;2774371800;Ne;6;0;3;9
6666;Pasaka;Drugelių;5547931812;Ne;0;2;0;2
6667;Pasaka;Drugelių;9060396476;Ne;0;2;2;4
6668;Pasaka;Drugelių;7078492847;Ne;5;2;2;9
6669;Pasaka;Nykštukų;7546205285;Ne;2;1;0;3
6670;Pasaka;Nykštukų;3151916774;Ne;0;2;1;3
6671;Pasaka;Nykštukų;4082752808;Ne;11;0;2;13
6672;Pasaka;Nykštukų;1813068555;Ne;0;2;1;3
6673;Pasaka;Nykštukų;8400549247;Ne;0;0;1;1
6674;Pasaka;Nykštukų;6326056771;Ne;9;2;0;11
6675;Pasaka;Nykštukų;4175157894;Ne;3;0;5;8
6676;Pasaka;Nykštukų;5768958388;Ne;0;0;3;3
6677;Pasaka;Montesori;16974081144;Ne;20;0;0;20
6678;Pasaka;Montesori;5812041166;Ne;0;0;2;2
6679;Pasaka;Montesori;4305485747;Ne;5;0;1;6
6680;Pasaka;Montesori;7837662446;Ne;9;0;3;12
6681;Pasaka;Montesori;3047931231;Ne;0;0;3;3
6682;Pasaka;Montesori;3195380938;Ne;0;0;1;1
6683;Pasaka;Montesori;6625690696;Ne;10;0;0;10
6684;Pasaka;Montesori;4548601585;Taip;9;2;0;11
6685;Pasaka;Montesori;7887326763;Ne;3;0;3;6
6686;Pasaka;Montesori;4366930715;Ne;0;0;2;2
6687;Pasaka;Montesori;9850592463;Ne;5;6;5;16
6688;Pasaka;Montesori;2995831258;Ne;0;13;0;13
6689;Pasaka;Montesori;6248810027;Ne;0;0;7;7
6690;Pasaka;Montesori;3620395122;Ne;6;0;0;6
6691;Pasaka;Montesori;5689164477;Ne;6;0;0;6
6692;Pasaka;Montesori;6484610418;Ne;10;0;2;12
6693;Pasaka;Žirniukų;9867183480;Ne;6;0;0;6
6694;Pasaka;Žirniukų;2815348652;Ne;0;0;3;3
6695;Pasaka;Žirniukų;5651025350;Ne;2;0;0;2
6696;Pasaka;Žirniukų;2422958320;Ne;0;0;8;8
6697;Pasaka;Žirniukų;9438006825;Ne;0;0;1;1
6698;Pasaka;Žirniukų;9136524816;Ne;4;0;4;8
6699;Pasaka;Žirniukų;9766432049;Ne;0;0;2;2
6700;Pasaka;Žirniukų;6387972576;Ne;9;0;1;10
6701;Pasaka;Žirniukų;4948174745;Ne;20;0;0;20
6702;Pasaka;Žirniukų;2144975281;Ne;6;0;0;6
6703;Pasaka;Žirniukų;8519108324;Ne;4;0;1;5
6704;Pasaka;Žirniukų;9950979894;Ne;9;0;0;9
6705;Pasaka;Žirniukų;9654507441;Ne;6;0;10;16
6706;Pasaka;Žirniukų;9654507441;Ne;6;0;10;16
6707;Pasaka;Žirniukų;9654507441;Ne;6;0;10;16
6708;Pasaka;Žirniukų;2569560383;Ne;0;0;4;4
6709;Pasaka;"Voveriukų ";3606141216;Ne;0;5;0;5
6710;Pasaka;"Voveriukų ";5217688848;Ne;0;5;0;5
6711;Pasaka;"Voveriukų ";4171004263;Ne;3;0;2;5
6712;Pasaka;"Voveriukų ";8504575043;Ne;0;0;5;5
6713;Pasaka;"Voveriukų ";2854919649;Ne;0;0;1;1
6714;Pasaka;"Voveriukų ";1950145441;Ne;10;0;1;11
6715;Pasaka;"Voveriukų ";4466963221;Ne;0;1;0;1
6716;Pasaka;"Voveriukų ";9588247759;Ne;0;0;2;2
6717;Pasaka;"Voveriukų ";3536862796;Ne;1;0;0;1
6718;Pasaka;"Voveriukų ";8899289832;Ne;3;0;0;3
6719;Pasaka;"Voveriukų ";4915357646;Ne;5;0;1;6
6720;Pasaka;"Voveriukų ";7176272684;Ne;4;4;0;8
6721;Pasaka;"Voveriukų ";9687385445;Ne;0;2;0;2
6722;Pasaka;"Voveriukų ";4799036184;Ne;0;0;8;8
6723;Pasaka;"Voveriukų ";6684234474;Ne;10;0;3;13
6724;Pasaka;"Voveriukų ";1745181416;Ne;7;0;2;9
6725;Pasaka;"Voveriukų ";9780490338;Ne;8;6;0;14
6726;Pasaka;"Voveriukų ";6315362421;Ne;12;0;0;12
6727;Pasaka;"Voveriukų ";6315362421;Ne;12;0;0;12
6728;Pasaka;"VALDOFRO 12";56766427323;Ne;4;0;0;4
6729;Pasaka;"VALDOFRO 12";2268625523;Ne;8;0;2;10
6730;Pasaka;"VALDOFRO 12";8976424908;Ne;4;0;0;4
6731;Pasaka;"VALDOFRO 12";8701112181;Ne;5;0;0;5
6732;Pasaka;"VALDOFRO 12";1305541319;Ne;0;1;2;3
6733;Pasaka;"VALDOFRO 12";7682903999;Ne;5;0;0;5
6734;Pasaka;"VALDOFRO 12";4325198579;Ne;0;0;7;7
6735;Pasaka;"VALDOFRO 12";6448940090;Ne;4;0;1;5
6736;Pasaka;"VALDOFRO 12";8411025450;Ne;7;1;1;9
6737;Pasaka;"VALDOFRO 12";1756831961;Ne;0;0;2;2
6738;Pasaka;"VALDOFRO 12";3840053722;Ne;0;16;1;17
6739;Pasaka;"VALDOFRO 12";8995205555;Ne;4;0;1;5
6740;Pasaka;"VALDOFRO 12";4548945364;Ne;0;0;3;3
6741;Pasaka;"VALDOFRO 12";8912822936;Ne;1;0;3;4
6742;Pasaka;"VALDOFRO 12";4301573328;Ne;1;0;4;5
6743;Pasaka;"VALDOFRO 12";5244582148;Ne;11;0;0;11
6744;Pasaka;"VALDOFRO 12";2650797982;Ne;0;0;2;2
6745;Pasaka;"VALDOFRO 12";9065016148;Ne;1;0;4;5
6746;Pasaka;"VALDOFRO 12";9809498406;Ne;0;0;2;2
6747;Pasaka;"VALDOFRO 12";5040348350;Ne;0;6;1;7
6748;Pasaka;"VALDORFO 2";77904202630;Ne;5;0;0;5
6749;Pasaka;"VALDORFO 2";4752117533;Ne;0;1;0;1
6750;Pasaka;"VALDORFO 2";8590385693;Ne;0;0;4;4
6751;Pasaka;"VALDORFO 2";4620573687;Ne;7;2;0;9
6752;Pasaka;"VALDORFO 2";9462745431;Ne;0;0;9;9
6753;Pasaka;"VALDORFO 2";5399148997;Ne;4;0;0;4
6754;Pasaka;"VALDORFO 2";1799326151;Ne;2;0;4;6
6755;Pasaka;"VALDORFO 2";2273629510;Ne;2;0;4;6
6756;Pasaka;"VALDORFO 2";5903270845;Ne;4;1;5;10
6757;Pasaka;"VALDORFO 2";3778182691;Ne;7;2;0;9
6758;Pasaka;"VALDORFO 2";5742479853;Ne;0;1;2;3
6759;Pasaka;"VALDORFO 2";3049361712;Ne;5;0;0;5
6760;Pasaka;"VALDORFO 2";6497042042;Ne;0;12;0;12
6761;Pasaka;"VALDORFO 2";9150761761;Ne;5;0;2;7
6762;Pasaka;"VALDORFO 2";9821858308;Ne;0;12;0;12
6763;Pasaka;"VALDORFO 2";1648043715;Ne;0;0;7;7
6764;Pasaka;"VALDORFO 2";8855436141;Ne;0;0;4;4
6765;Pasaka;Gudručiai;6253266504;Ne;5;0;0;5
6766;Pasaka;Gudručiai;4137222204;Ne;1;0;0;1
6767;Pasaka;Gudručiai;7103485358;Ne;2;0;1;3
6768;Pasaka;Gudručiai;7648503006;Ne;0;2;0;2
6769;Pasaka;Gudručiai;2400455036;Ne;10;0;0;10
6770;Pasaka;Gudručiai;9722435751;Ne;0;1;0;1
6771;Pasaka;Gudručiai;73703706115;Ne;5;0;1;6
6772;Pasaka;Gudručiai;79170702319;Ne;0;5;0;5
6773;Pasaka;Gudručiai;5965121999;Ne;8;0;0;8
6774;Pasaka;Gudručiai;7286419663;Ne;0;0;1;1
6775;Pasaka;Gudručiai;5973028582;Ne;0;6;1;7
6776;Pasaka;Gudručiai;2788679885;Ne;4;1;0;5
6777;Pasaka;Gudručiai;1565873178;Ne;9;0;0;9
6778;Pasaka;Gudručiai;5651452381;Ne;9;0;0;9
6779;Pasaka;Gudručiai;6441884677;Ne;9;0;0;9
6780;Pasaka;Gudručiai;2018620389;Ne;0;1;0;1
6781;Pasaka;Gudručiai;2671403814;Ne;0;0;2;2
6782;Pasaka;Gudručiai;42548487389;Ne;0;0;2;2
6783;Pasaka;Gudručiai;8448558788;Ne;4;0;2;6
6784;Pasaka;Bitelių;5351364328;Ne;0;0;12;12
6785;Pasaka;Bitelių;4635912654;Ne;0;0;12;12
6786;Pasaka;Bitelių;7248640367;Ne;5;2;0;7
6787;Pasaka;Bitelių;8277245475;Ne;0;0;5;5
6788;Pasaka;Bitelių;9136521759;Ne;0;2;1;3
6789;Pasaka;Bitelių;9737445077;Ne;6;0;0;6
6790;Pasaka;Bitelių;3367346582;Ne;9;0;0;9
6791;Pasaka;Bitelių;3351338617;Ne;5;0;0;5
6792;Pasaka;Bitelių;6139825302;Ne;0;3;0;3
6793;Pasaka;Bitelių;4970812899;Ne;0;0;5;5
6794;Pasaka;Bitelių;8873115041;Ne;2;0;1;3
6795;Pasaka;Bitelių;1720511696;Ne;3;0;0;3
6796;Pasaka;Bitelių;2963373430;Ne;9;3;0;12
6797;Pasaka;"Pabiručių ";4846146925;Ne;1;4;1;6
6798;Pasaka;"Pabiručių ";9770811826;Ne;9;4;0;13
6799;Pasaka;"Pabiručių ";5230621839;Ne;1;0;1;2
6800;Pasaka;"Pabiručių ";4770547514;Ne;3;0;0;3
6801;Pasaka;"Pabiručių ";9471447977;Ne;0;2;0;2
6802;Pasaka;"Pabiručių ";7751618911;Ne;0;1;0;1
6803;Pasaka;"Pabiručių ";7696383564;Ne;5;1;2;8
6804;Pasaka;"Pabiručių ";3796844193;Ne;15;0;0;15
6805;Pasaka;"Pabiručių ";4910817298;Ne;1;0;3;4
6806;Pasaka;"Pabiručių ";7127138831;Ne;0;1;0;1
6807;Pasaka;"Pabiručių ";9813397639;Ne;0;1;0;1
6808;Pasaka;"Pabiručių ";4222952044;Ne;0;6;11;17
6809;Pasaka;"Pabiručių ";5111195289;Ne;10;0;1;11
6810;Pasaka;"Pabiručių ";6182223896;Ne;10;0;1;11
6811;Pasaka;"Pabiručių ";8558563996;Ne;16;0;0;16
6812;Pasaka;"Pabiručių ";3557547656;Ne;0;0;20;20
6813;Pasaka;Šnekučių;1512874567;Ne;0;0;4;4
6814;Pasaka;Šnekučių;4296539838;Taip;0;4;3;7
6815;Pasaka;Šnekučių;1590306118;Ne;0;2;0;2
6816;Pasaka;Šnekučių;6795580569;Ne;2;0;0;2
6817;Pasaka;Šnekučių;3240292756;Ne;0;2;0;2
6818;Pasaka;Šnekučių;4215568107;Ne;7;0;0;7
6819;Pasaka;Šnekučių;4816441219;Ne;5;0;6;11
6820;Pasaka;Šnekučių;1795497567;Ne;13;0;0;13
6821;Pasaka;Šnekučių;8347051587;Ne;0;2;2;4
6822;Pasaka;Šnekučių;8841669113;Ne;0;0;2;2
6823;Pasaka;Šnekučių;4975045894;Ne;0;0;3;3
6824;Pasaka;Šnekučių;3588073618;Ne;6;0;0;6
6825;Pasaka;Šnekučių;1194745876;Ne;0;2;1;3
6826;Pasaka;Šnekučių;1749821746;Ne;0;2;0;2
6827;Pasaka;Šnekučių;1723076060;Ne;0;8;0;8
6828;Pasaka;Šnekučių;8475365713;Ne;0;2;9;11
6829;Pasaka;Šnekučių;5656511105;Ne;9;0;1;10
6830;Pasaka;"KIŠKUČIŲ (Žirmūnų g. 92)";7311929329;Ne;5;0;0;5
6831;Pasaka;"KIŠKUČIŲ (Žirmūnų g. 92)";2368681819;Ne;5;0;0;5
6832;Pasaka;"KIŠKUČIŲ (Žirmūnų g. 92)";5134067973;Taip;11;0;0;11
6833;Pasaka;"KIŠKUČIŲ (Žirmūnų g. 92)";2135527938;Ne;0;2;0;2
6834;Pasaka;"KIŠKUČIŲ (Žirmūnų g. 92)";5073970913;Ne;11;0;1;12
6835;Pasaka;"KIŠKUČIŲ (Žirmūnų g. 92)";6950137606;Ne;5;0;3;8
6836;Pasaka;"KIŠKUČIŲ (Žirmūnų g. 92)";2575986215;Ne;10;0;3;13
6837;Pasaka;"KIŠKUČIŲ (Žirmūnų g. 92)";4924664211;Ne;0;0;3;3
6838;Pasaka;"KIŠKUČIŲ (Žirmūnų g. 92)";9928518840;Taip;9;2;0;11
6839;Pasaka;"EŽIUKŲ (Žirmūnų g. 92)";9369336996;Ne;1;0;1;2
6840;Pasaka;"EŽIUKŲ (Žirmūnų g. 92)";8866484797;Ne;0;0;11;11
6841;Pasaka;"EŽIUKŲ (Žirmūnų g. 92)";3735117473;Ne;0;0;5;5
6842;Pasaka;"EŽIUKŲ (Žirmūnų g. 92)";6280303158;Ne;0;0;4;4
6843;Pasaka;"EŽIUKŲ (Žirmūnų g. 92)";9324220807;Ne;5;0;0;5
6844;Pasaka;"EŽIUKŲ (Žirmūnų g. 92)";5630598566;Ne;0;0;8;8
6845;Pasaka;"EŽIUKŲ (Žirmūnų g. 92)";3587648653;Ne;0;0;1;1
6846;Pasaka;"EŽIUKŲ (Žirmūnų g. 92)";6388657745;Ne;0;0;1;1
6847;Pasaka;"EŽIUKŲ (Žirmūnų g. 92)";8837340945;Ne;2;0;0;2
6848;Pasaka;"EŽIUKŲ (Žirmūnų g. 92)";8082395844;Ne;0;2;3;5
6849;Pasaka;"EŽIUKŲ (Žirmūnų g. 92)";9403892434;Ne;8;0;3;11
6850;Pasaka;"SAULUČIŲ (Žirmūnų g. 92)";1963481567;Ne;0;0;1;1
6851;Pasaka;"SAULUČIŲ (Žirmūnų g. 92)";8164697203;Ne;0;0;1;1
6852;Pasaka;"SAULUČIŲ (Žirmūnų g. 92)";1214817944;Ne;9;0;1;10
6853;Pasaka;"SAULUČIŲ (Žirmūnų g. 92)";2211744442;Ne;0;0;5;5
6854;Pasaka;"SAULUČIŲ (Žirmūnų g. 92)";5912306325;Ne;5;4;3;12
6855;Pasaka;"SAULUČIŲ (Žirmūnų g. 92)";6087447128;Ne;4;0;1;5
6856;Pasaka;"SAULUČIŲ (Žirmūnų g. 92)";3066438231;Ne;10;0;1;11
6857;Pasaka;"SAULUČIŲ (Žirmūnų g. 92)";3066438231;Ne;10;0;1;11
6858;Pasaka;"SAULUČIŲ (Žirmūnų g. 92)";3066438231;Ne;10;0;1;11
6859;Pasaka;"SAULUČIŲ (Žirmūnų g. 92)";6157459742;Ne;0;0;17;17
6860;Pasaka;"SAULUČIŲ (Žirmūnų g. 92)";3424189866;Ne;3;0;1;4
6861;Pasaka;"SAULUČIŲ (Žirmūnų g. 92)";7214402510;Ne;0;0;1;1
6862;Pasaka;"SAULUČIŲ (Žirmūnų g. 92)";6821289069;Ne;17;0;0;17
6863;Pasaka;"SAULUČIŲ (Žirmūnų g. 92)";5414186755;Ne;0;0;8;8
6864;Paslaptis;MONTIKI;4683384309;Ne;0;1;0;1
6865;Paslaptis;MONTIKI;9929877115;Taip;0;3;0;3
6866;Paslaptis;MONTIKI;6860366087;Taip;4;0;0;4
6867;Paslaptis;MONTIKI;3572102816;Ne;13;0;1;14
6868;Paslaptis;MONTIKI;2927014406;Ne;7;0;0;7
6869;Paslaptis;MONTIKI;3963816472;Ne;4;0;1;5
6870;Paslaptis;MONTIKI;6764142182;Ne;14;0;0;14
6871;Paslaptis;MONTIKI;9497654214;Ne;0;6;0;6
6872;Paslaptis;MONTIKI;1080710834;Ne;0;0;2;2
6873;Paslaptis;FRUTIKI;9100003209;Ne;14;1;0;15
6874;Paslaptis;FRUTIKI;3984799090;Taip;4;1;2;7
6875;Paslaptis;FRUTIKI;5886364670;Ne;0;1;0;1
6876;Paslaptis;FRUTIKI;9066462355;Ne;2;0;0;2
6877;Paslaptis;FRUTIKI;5406800599;Taip;7;0;0;7
6878;Paslaptis;FRUTIKI;1557783684;Ne;1;5;0;6
6879;Paslaptis;FRUTIKI;2105441745;Ne;9;2;0;11
6880;Paslaptis;FRUTIKI;6686352764;Ne;6;0;7;13
6881;Paslaptis;FRUTIKI;8717111488;Taip;5;2;0;7
6882;Paslaptis;FRUTIKI;5756338103;Ne;0;1;0;1
6883;Paslaptis;FRUTIKI;5646806136;Ne;6;1;1;8
6884;Paslaptis;FRUTIKI;6513238386;Ne;7;0;0;7
6885;Paslaptis;FRUTIKI;6098345982;Ne;5;0;0;5
6886;Paslaptis;FRUTIKI;4810686225;Ne;0;1;1;2
6887;Paslaptis;FRUTIKI;8296575784;Ne;14;0;0;14
6888;Paslaptis;FRUTIKI;1754621741;Ne;0;9;0;9
6889;Paslaptis;KALAMBURIKI;3093280943;Ne;5;0;0;5
6890;Paslaptis;KALAMBURIKI;2879752620;Ne;0;4;0;4
6891;Paslaptis;KALAMBURIKI;8280740387;Ne;0;1;1;2
6892;Paslaptis;KALAMBURIKI;5852939221;Ne;0;0;4;4
6893;Paslaptis;KALAMBURIKI;2693910134;Ne;6;1;0;7
6894;Paslaptis;KALAMBURIKI;3104525540;Ne;16;1;1;18
6895;Paslaptis;KALAMBURIKI;3415869190;Ne;1;5;0;6
6896;Paslaptis;KALAMBURIKI;3549998192;Ne;0;1;2;3
6897;Paslaptis;KALAMBURIKI;1782398974;Ne;0;2;0;2
6898;Paslaptis;KALAMBURIKI;8146824196;Ne;0;0;9;9
6899;Paslaptis;KALAMBURIKI;3398729758;Ne;0;0;2;2
6900;Paslaptis;KALAMBURIKI;8083478190;Ne;0;0;8;8
6901;Paslaptis;KALAMBURIKI;2089780119;Ne;5;0;6;11
6902;Pasakaitė;Vieversėlių;7685647972;Ne;0;0;3;3
6903;Pasakaitė;Vieversėlių;6459145539;Ne;0;9;0;9
6904;Pasakaitė;Vieversėlių;2194313054;Taip;0;1;0;1
6905;Pasakaitė;Vieversėlių;9587489514;Ne;0;0;2;2
6906;Pasakaitė;Vieversėlių;3444442287;Ne;9;0;4;13
6907;Pasakaitė;Vieversėlių;5485965486;Ne;0;7;0;7
6908;Pasakaitė;Vieversėlių;2849753418;Ne;0;5;0;5
6909;Pasakaitė;Vieversėlių;8043493934;Taip;0;0;1;1
6910;Pasakaitė;Vieversėlių;9543991684;Ne;0;5;0;5
6911;Pasakaitė;Vieversėlių;4882856664;Ne;0;3;1;4
6912;Pasakaitė;Vieversėlių;5953162958;Ne;0;0;3;3
6913;Pasakaitė;Vieversėlių;5948958906;Ne;8;0;1;9
6914;Pasakaitė;Vieversėlių;1060914693;Ne;3;1;1;5
6915;Pasakaitė;Vieversėlių;7761162338;Ne;1;5;0;6
6916;Pasakaitė;Vieversėlių;8463220257;Ne;0;2;0;2
6917;Pasakaitė;Vieversėlių;9018830962;Ne;18;4;0;22
6918;Pasakaitė;Vieversėlių;6736879757;Ne;28;0;0;28
6919;Pasakaitė;Vieversėlių;4191875802;Ne;0;0;3;3
6920;Pasakaitė;Vieversėlių;5020801150;Ne;5;0;1;6
6921;Pasakaitė;Spindulėlių;4758073190;Ne;1;0;0;1
6922;Pasakaitė;Spindulėlių;6714500298;Ne;0;7;0;7
6923;Pasakaitė;Spindulėlių;1697755753;Ne;0;4;0;4
6924;Pasakaitė;Spindulėlių;1056358241;Ne;0;8;0;8
6925;Pasakaitė;Spindulėlių;5791927811;Taip;5;25;0;30
6926;Pasakaitė;Spindulėlių;5094404397;Taip;5;25;0;30
6927;Pasakaitė;Spindulėlių;9870015737;Ne;1;2;0;3
6928;Pasakaitė;Spindulėlių;1449037968;Ne;13;2;0;15
6929;Pasakaitė;Spindulėlių;7474100735;Ne;10;2;0;12
6930;Pasakaitė;Spindulėlių;6015360076;Ne;0;24;0;24
6931;Pasakaitė;Spindulėlių;2733800758;Ne;0;3;0;3
6932;Pasakaitė;Spindulėlių;6256000265;Ne;6;0;0;6
6933;Pasakaitė;Spindulėlių;2891089579;Ne;6;0;0;6
6934;Pasakaitė;Spindulėlių;3381303531;Ne;0;5;0;5
6935;Pasakaitė;Spindulėlių;3652896053;Ne;15;2;0;17
6936;Pasakaitė;Spindulėlių;7265623955;Ne;5;3;0;8
6937;Pasakaitė;Spindulėlių;1564611671;Ne;9;0;0;9
6938;Pasakaitė;Spindulėlių;3283593388;Ne;10;0;0;10
6939;Pasakaitė;Spindulėlių;2652882309;Ne;0;10;2;12
6940;Pasakaitė;Spindulėlių;4268438476;Ne;20;0;0;20
6941;Pasakaitė;Pasagėlių;9895144528;Ne;2;0;4;6
6942;Pasakaitė;Pasagėlių;9409907631;Ne;6;0;5;11
6943;Pasakaitė;Pasagėlių;5589440439;Ne;8;0;2;10
6944;Pasakaitė;Pasagėlių;3355268509;Ne;15;0;0;15
6945;Pasakaitė;Pasagėlių;1959599606;Ne;0;7;0;7
6946;Pasakaitė;Pasagėlių;7440327561;Ne;0;5;0;5
6947;Pasakaitė;Pasagėlių;6325408070;Taip;3;0;0;3
6948;Pasakaitė;Pasagėlių;9238905834;Taip;0;9;0;9
6949;Pasakaitė;Pasagėlių;7666033916;Ne;6;0;0;6
6950;Pasakaitė;Pasagėlių;7219080600;Ne;0;14;0;14
6951;Pasakaitė;Pasagėlių;2341175137;Ne;7;0;1;8
6952;Pasakaitė;Pasagėlių;8905681529;Ne;1;0;0;1
6953;Pasakaitė;Pasagėlių;8165055476;Ne;0;0;3;3
6954;Pasakaitė;Pasagėlių;7360801624;Ne;10;0;0;10
6955;Pasakaitė;Pasagėlių;5034077389;Ne;0;0;3;3
6956;Pasakaitė;Švyturėlių;7702359586;Ne;0;4;0;4
6957;Pasakaitė;Švyturėlių;6847782430;Ne;0;1;0;1
6958;Pasakaitė;Švyturėlių;1533259056;Ne;0;1;0;1
6959;Pasakaitė;Švyturėlių;4728731352;Ne;6;0;0;6
6960;Pasakaitė;Švyturėlių;9821617981;Ne;9;0;1;10
6961;Pasakaitė;Švyturėlių;1619513932;Ne;0;6;1;7
6962;Pasakaitė;Švyturėlių;1184513606;Ne;0;0;4;4
6963;Pasakaitė;Švyturėlių;8223662339;Ne;9;0;1;10
6964;Pasakaitė;Švyturėlių;3710143250;Ne;0;0;1;1
6965;Pasakaitė;Švyturėlių;2329827275;Ne;4;0;2;6
6966;Pasakaitė;Švyturėlių;2933474317;Ne;5;0;1;6
6967;Pasakaitė;Švyturėlių;5498393070;Ne;0;2;18;20
6968;Pasakaitė;Švyturėlių;9012098645;Ne;0;2;18;20
6969;Pasakaitė;Švyturėlių;4604843442;Ne;0;8;0;8
6970;Pasakaitė;Švyturėlių;3417077517;Ne;4;0;0;4
6971;Pasakaitė;Švyturėlių;1793453325;Ne;5;0;1;6
6972;Pasakaitė;Švyturėlių;4694818333;Ne;0;1;0;1
6973;Pasakaitė;Kodėlčiukų;8662488739;Ne;7;0;2;9
6974;Pasakaitė;Kodėlčiukų;9972985920;Ne;0;0;2;2
6975;Pasakaitė;Kodėlčiukų;5699688792;Ne;20;0;0;20
6976;Pasakaitė;Kodėlčiukų;9441990175;Taip;7;0;5;12
6977;Pasakaitė;Kodėlčiukų;4485053261;Ne;10;0;0;10
6978;Pasakaitė;Kodėlčiukų;9351971114;Ne;8;0;3;11
6979;Pasakaitė;Kodėlčiukų;2303884875;Ne;16;0;0;16
6980;Pasakaitė;Kodėlčiukų;4878562841;Ne;12;0;2;14
6981;Pasakaitė;Kodėlčiukų;2994653871;Ne;13;0;1;14
6982;Pasakaitė;Kodėlčiukų;4328440534;Ne;9;0;0;9
6983;Pasakaitė;Kodėlčiukų;4881361200;Ne;11;0;2;13
6984;Pasakaitė;Kodėlčiukų;2389832646;Ne;0;6;0;6
6985;Pasakaitė;Kodėlčiukų;7138417196;Ne;16;0;0;16
6986;Pasakaitė;Kodėlčiukų;5581264184;Ne;14;0;0;14
6987;Pasakaitė;Kodėlčiukų;8037316673;Ne;11;0;0;11
6988;Pasakaitė;Kodėlčiukų;5732009054;Ne;0;2;0;2
6989;Pasakaitė;Kodėlčiukų;2407824666;Ne;0;0;1;1
6990;Pasakaitė;Kodėlčiukų;6755983130;Ne;10;0;2;12
6991;Pasakaitė;Kodėlčiukų;2476010561;Ne;18;0;0;18
6992;Pasakaitė;Kodėlčiukų;3925034196;Ne;18;0;0;18
6993;Pasakaitė;Gudručių;6568538767;Ne;0;15;0;15
6994;Pasakaitė;Gudručių;1523034176;Ne;0;0;10;10
6995;Pasakaitė;Gudručių;5369558652;Ne;14;0;0;14
6996;Pasakaitė;Gudručių;1019010454;Ne;0;6;2;8
6997;Pasakaitė;Gudručių;1707428977;Ne;0;0;13;13
6998;Pasakaitė;Gudručių;9680682204;Ne;0;0;1;1
6999;Pasakaitė;Gudručių;1791015854;Ne;3;0;1;4
7000;Pasakaitė;Gudručių;67374677045;Ne;10;0;1;11
7001;Pasakaitė;Gudručių;4959175420;Ne;0;4;0;4
7002;Pasakaitė;Gudručių;6839399035;Ne;15;0;0;15
7003;Pasakaitė;Gudručių;3778906698;Ne;0;0;1;1
7004;Pasakaitė;Gudručių;1940545723;Ne;0;5;0;5
7005;Pasakaitė;Gudručių;1809383469;Ne;5;0;0;5
7006;Pasakaitė;Gudručių;1592521766;Ne;0;0;2;2
7007;Pasakaitė;Gudručių;4008826950;Ne;6;0;3;9
7008;Pasakaitė;Gudručių;9031690002;Ne;7;0;0;7
7009;Pasakaitė;Gudručių;2742595829;Ne;4;0;1;5
7010;Pasakaitė;Gudručių;1513903341;Ne;9;0;0;9
7011;Pasakaitė;Gudručių;8390366303;Ne;0;0;3;3
7012;Pasakaitė;Gudručių;3231283338;Ne;10;0;0;10
7013;Pasakaitė;Čiulbonėlių;4680949976;Ne;0;7;0;7
7014;Pasakaitė;Čiulbonėlių;7152349570;Ne;0;11;0;11
7015;Pasakaitė;Čiulbonėlių;1458338379;Ne;8;5;0;13
7016;Pasakaitė;Čiulbonėlių;7526264241;Ne;0;10;2;12
7017;Pasakaitė;Čiulbonėlių;4974486850;Ne;0;0;1;1
7018;Pasakaitė;Čiulbonėlių;7607522887;Ne;5;6;0;11
7019;Pasakaitė;Čiulbonėlių;3606601644;Ne;0;2;0;2
7020;Pasakaitė;Čiulbonėlių;3579498202;Ne;4;5;0;9
7021;Pasakaitė;Čiulbonėlių;1220619991;Ne;0;0;1;1
7022;Pasakaitė;Čiulbonėlių;3400305768;Ne;4;0;0;4
7023;Pasakaitė;Čiulbonėlių;4013900094;Ne;0;0;1;1
7024;Pasakaitė;Čiulbonėlių;61230317080;Ne;8;0;0;8
7025;Pasakaitė;Čiulbonėlių;8466086339;Ne;0;6;0;6
7026;Pasakaitė;Čiulbonėlių;5467179333;Ne;0;0;3;3
7027;Pasakaitė;Čiulbonėlių;1740419218;Ne;0;7;0;7
7028;Pasakaitė;Čiulbonėlių;8469043564;Ne;0;0;4;4
7029;Pasakaitė;"Verpstelių ";7621306769;Ne;0;13;0;13
7030;Pasakaitė;"Verpstelių ";4946855684;Ne;0;12;0;12
7031;Pasakaitė;"Verpstelių ";5556362727;Ne;0;0;4;4
7032;Pasakaitė;"Verpstelių ";7759051761;Ne;5;4;0;9
7033;Pasakaitė;"Verpstelių ";1744216870;Ne;0;1;0;1
7034;Pasakaitė;"Verpstelių ";1425166722;Ne;5;0;2;7
7035;Pasakaitė;"Verpstelių ";7813221735;Ne;1;14;0;15
7036;Pasakaitė;"Verpstelių ";4246461594;Ne;0;0;4;4
7037;Pasakaitė;"Verpstelių ";1963102227;Ne;5;0;1;6
7038;Pasakaitė;"Verpstelių ";8267725352;Ne;0;0;3;3
7039;Pasakaitė;"Verpstelių ";8562284745;Ne;9;3;0;12
7040;Pasakaitė;"Verpstelių ";1041405418;Ne;0;11;0;11
7041;Pasakaitė;"Verpstelių ";7976921380;Ne;0;6;0;6
7042;Pasakaitė;"Verpstelių ";2505815026;Ne;16;0;8;24
7043;Pasakaitė;"Verpstelių ";5413457806;Ne;12;0;0;12
7044;Pasakaitė;"Verpstelių ";1115383380;Ne;3;0;0;3
7045;Pasakaitė;"Verpstelių ";2714905466;Ne;0;0;1;1
7046;Pasakaitė;"Verpstelių ";9226989209;Ne;0;5;0;5
7047;Pasakaitė;"Verpstelių ";8927014508;Ne;0;0;5;5
7048;Pasakaitė;Smalsučiai;7539851375;Ne;6;0;0;6
7049;Pasakaitė;Smalsučiai;2278658674;Ne;8;0;3;11
7050;Pasakaitė;Smalsučiai;6522727154;Ne;14;0;0;14
7051;Pasakaitė;Smalsučiai;1122248122;Ne;0;10;1;11
7052;Pasakaitė;Smalsučiai;9982451343;Ne;5;4;3;12
7053;Pasakaitė;Smalsučiai;4977052991;Ne;0;5;0;5
7054;Pasakaitė;Smalsučiai;7604996145;Ne;20;0;0;20
7055;Pasakaitė;Smalsučiai;4307883488;Ne;0;9;8;17
7056;Pasakaitė;Smalsučiai;2546550685;Ne;4;0;0;4
7057;Pasakaitė;Smalsučiai;5115067331;Ne;0;6;0;6
7058;Pasakaitė;Smalsučiai;7994712153;Ne;1;0;10;11
7059;Pasakaitė;"Čiauškučiai ";7399335037;Taip;1;0;0;1
7060;Pasakaitė;"Čiauškučiai ";4098119950;Ne;6;0;0;6
7061;Pasakaitė;"Čiauškučiai ";6229020982;Ne;6;3;0;9
7062;Pasakaitė;"Čiauškučiai ";5279719152;Ne;15;1;0;16
7063;Pasakaitė;"Čiauškučiai ";6160327808;Ne;1;0;3;4
7064;Pasakaitė;"Čiauškučiai ";1705913604;Ne;8;0;0;8
7065;Pasakaitė;"Čiauškučiai ";4898974534;Ne;9;2;0;11
7066;Pasakaitė;"Čiauškučiai ";7885958426;Ne;5;0;1;6
7067;Pasakaitė;"Čiauškučiai ";2902368705;Ne;0;16;0;16
7068;Pasakaitė;"Čiauškučiai ";2041179927;Ne;0;1;1;2
7069;Pasakaitė;"Čiauškučiai ";6745120294;Ne;1;0;0;1
7070;Pasakaitė;"Čiauškučiai ";4120765793;Ne;5;0;0;5
7071;Pasakaitė;Pabiručiai;5180059311;Ne;4;0;0;4
7072;Pasakaitė;Pabiručiai;5162170061;Ne;0;0;1;1
7073;Pasakaitė;Pabiručiai;8478538959;Ne;0;0;3;3
7074;Pasakaitė;Pabiručiai;6795204239;Ne;1;0;4;5
7075;Pasakaitė;Pabiručiai;5058070480;Ne;13;3;0;16
7076;Pasakaitė;Pabiručiai;1453976284;Ne;0;12;2;14
7077;Pasakaitė;Pabiručiai;8559244062;Ne;10;0;0;10
7078;Pasakaitė;Pabiručiai;9790988677;Ne;13;1;0;14
7079;Pasakaitė;Pabiručiai;5439936572;Ne;10;8;2;20
7080;Pasakaitė;Pabiručiai;4316883215;Ne;0;3;0;3
7081;Pasakaitė;Pabiručiai;6682010485;Ne;8;0;4;12
7082;Pasakaitė;Pabiručiai;3466308130;Ne;14;0;6;20
7083;Pasakaitė;Pabiručiai;9402238675;Ne;24;0;0;24
7084;Pasakaitė;Pabiručiai;9311649698;Ne;1;0;2;3
7085;Pasakaitė;Pabiručiai;5499373802;Ne;6;0;1;7
7086;Pasakaitė;Linksmučiai;7965916747;Ne;11;0;0;11
7087;Pasakaitė;Linksmučiai;1279728451;Ne;5;0;0;5
7088;Pasakaitė;Linksmučiai;2584717150;Ne;1;0;11;12
7089;Pasakaitė;Linksmučiai;4397797616;Ne;17;0;0;17
7090;Pasakaitė;Linksmučiai;4659277297;Ne;0;0;3;3
7091;Pasakaitė;Linksmučiai;8381083251;Ne;3;0;6;9
7092;Pasakaitė;Linksmučiai;8252123824;Ne;8;0;0;8
7093;Pasakaitė;Linksmučiai;4444725869;Taip;4;0;0;4
7094;Pasakaitė;Linksmučiai;2801785334;Ne;6;0;4;10
7095;Pasakaitė;Linksmučiai;9606533767;Ne;4;0;2;6
7096;Pasakaitė;Linksmučiai;2899659479;Ne;10;0;1;11
7097;Pasakaitė;Linksmučiai;8160163060;Ne;0;0;5;5
7098;Pasakaitė;Linksmučiai;8350808883;Ne;4;0;0;4
7099;Pelėda;KIŠKUČIAI;5022388487;Taip;7;0;0;7
7100;Pelėda;KIŠKUČIAI;3895256591;Taip;10;0;0;10
7101;Pelėda;KIŠKUČIAI;1094266559;Ne;9;0;0;9
7102;Pelėda;KIŠKUČIAI;2461987245;Ne;5;0;0;5
7103;Pelėda;KIŠKUČIAI;5592918852;Ne;5;0;0;5
7104;Pelėda;PELIUKAI;9517601102;Ne;6;0;0;6
7105;Pelėda;GUDRUČIAI;3635776343;Ne;4;0;0;4
7106;Pelėda;ŽIRNIUKAI;1066412786;Ne;7;0;0;7
7107;Pelėda;ŽIRNIUKAI;4561020945;Ne;10;0;0;10
7108;Pelėda;ŽIRNIUKAI;9150480625;Ne;11;0;0;11
7109;Pelėda;ŽIRNIUKAI;7202399026;Ne;5;0;0;5
7110;Pelėda;ŽIRNIUKAI;8279365345;Ne;1;0;0;1
7111;Pelėda;KODĖLČIUKAI;1249817734;Ne;9;0;0;9
7112;Pelėda;KODĖLČIUKAI;6142353763;Ne;7;0;0;7
7113;Pelėda;KODĖLČIUKAI;5942764642;Ne;4;0;0;4
7114;Pelėda;KODĖLČIUKAI;3466452994;Ne;16;0;0;16
7115;Pelėda;KODĖLČIUKAI;7383726391;Ne;7;0;0;7
7116;Pelėda;KODĖLČIUKAI;4273955889;Ne;8;0;0;8
7117;Pelėda;ĄŽUOLIUKAI;6192178337;Ne;4;0;0;4
7118;Pelėda;NYKŠTUKAI;9405028368;Ne;4;0;0;4
7119;Pelėda;BORUŽIUKŲ;7610873518;Ne;8;0;0;8
7120;Pelėda;BORUŽIUKŲ;8768572308;Ne;5;0;0;5
7121;Pelėda;BORUŽIUKŲ;5563116254;Ne;12;0;0;12
7122;Pelėda;DRUGELIAI;4392563768;Ne;4;0;0;4
7123;Pelėda;DRUGELIAI;4057233238;Ne;10;0;0;10
7124;Pelėda;DRUGELIAI;9470036802;Ne;5;0;0;5
7125;Pelėda;DRUGELIAI;9400640589;Ne;4;0;0;4
7126;Pelėda;DRUGELIAI;6445056693;Ne;7;0;0;7
7127;Pelėda;OBUOLIUKAI;5844613931;Ne;2;0;0;2
7128;Pelėda;OBUOLIUKAI;9836170452;Ne;6;0;0;6
7129;Pelėda;OBUOLIUKAI;7990033419;Ne;1;0;0;1
7130;Pelėda;OBUOLIUKAI;4380328321;Ne;10;0;0;10
7131;Pelėda;OBUOLIUKAI;7955805701;Ne;9;0;0;9
7132;Pelėda;OBUOLIUKAI;9175754279;Ne;11;0;0;11
7133;Pelėda;OBUOLIUKAI;2671545779;Ne;5;0;0;5
7134;Pelėda;BITUTĖS;4442670752;Ne;1;0;0;1
7135;Pelėda;BITUTĖS;2018682468;Ne;1;0;0;1
7136;Pelėda;BITUTĖS;9748236454;Ne;5;0;0;5
7137;Pelėda;SMALSUČIAI;9981001823;Ne;10;0;0;10
7138;Pelėda;SMALSUČIAI;5875616604;Taip;3;0;0;3
7139;Pelėda;SMALSUČIAI;5984789325;Ne;10;0;0;10
7140;Pelėda;SMALSUČIAI;1112632514;Ne;9;0;0;9
7141;Pelėda;SMALSUČIAI;8775397229;Ne;13;0;0;13
7142;Pelėda;SMALSUČIAI;3789797271;Ne;14;0;0;14
7143;Pelėda;SMALSUČIAI;7629444214;Ne;5;0;0;5
7144;Pelėda;SMALSUČIAI;3318347224;Ne;13;0;0;13
7145;Pelėda;SMALSUČIAI;1962928106;Ne;5;0;0;5
7146;Pelėda;SMALSUČIAI;4486503894;Ne;9;0;0;9
7147;Pelėda;"NAUJA DARŽELIS";3783477511;Ne;3;0;0;3
7148;Pelėda;"NAUJA DARŽELIS";9104022893;Ne;13;0;0;13
7149;Pelenė;Varpelis;2647876561;Ne;0;1;0;1
7150;Pelenė;Varpelis;8807342148;Ne;14;1;0;15
7151;Pelenė;Varpelis;5697826755;Ne;0;0;2;2
7152;Pelenė;Varpelis;4004975235;Ne;0;0;4;4
7153;Pelenė;Varpelis;8790613872;Ne;0;0;4;4
7154;Pelenė;Varpelis;2487632125;Ne;5;0;4;9
7155;Pelenė;Varpelis;5228983908;Ne;3;0;0;3
7156;Pelenė;Varpelis;3174009848;Ne;4;0;0;4
7157;Pelenė;Varpelis;6524101295;Ne;5;0;0;5
7158;Pelenė;Varpelis;4373886054;Ne;6;0;1;7
7159;Pelenė;Varpelis;8038559319;Ne;8;0;0;8
7160;Pelenė;Varpelis;7578318198;Ne;4;9;0;13
7161;Pelenė;Varpelis;7164790060;Ne;3;2;0;5
7162;Pelenė;Varpelis;1080017906;Ne;9;0;1;10
7163;Pelenė;Varpelis;9447223913;Ne;15;0;7;22
7164;Pelenė;Varpelis;6894978459;Ne;13;8;0;21
7165;Pelenė;Varpelis;6864263698;Ne;18;0;6;24
7166;Pelenė;Saulutės;7880284433;Ne;0;4;3;7
7167;Pelenė;Saulutės;1468658102;Ne;0;0;29;29
7168;Pelenė;Saulutės;2737277656;Taip;9;0;0;9
7169;Pelenė;Saulutės;1775717256;Taip;0;0;3;3
7170;Pelenė;Saulutės;4315677064;Taip;0;0;2;2
7171;Pelenė;Saulutės;5389865440;Ne;0;0;1;1
7172;Pelenė;Saulutės;8716395810;Taip;0;5;0;5
7173;Pelenė;Saulutės;6191899254;Taip;0;0;4;4
7174;Pelenė;Saulutės;6481466282;Ne;0;4;1;5
7175;Pelenė;Saulutės;8466974910;Taip;12;5;0;17
7176;Pelenė;Saulutės;2393964666;Taip;0;6;0;6
7177;Pelenė;Saulutės;5780697554;Ne;0;7;0;7
7178;Pelenė;Saulutės;4989239822;Ne;0;5;1;6
7179;Pelenė;Saulutės;6221703608;Ne;0;0;4;4
7180;Pelenė;Saulutės;2426412323;Ne;0;0;1;1
7181;Pelenė;Saulutės;6267178572;Ne;0;4;0;4
7182;Pelenė;Raktelis;9195113444;Ne;7;8;0;15
7183;Pelenė;Raktelis;4591637887;Ne;0;9;0;9
7184;Pelenė;Raktelis;7088493729;Ne;3;0;2;5
7185;Pelenė;Raktelis;4090532624;Ne;0;10;0;10
7186;Pelenė;Raktelis;8123162647;Ne;0;9;0;9
7187;Pelenė;Raktelis;3573543545;Ne;0;7;0;7
7188;Pelenė;Raktelis;7659625628;Ne;0;0;2;2
7189;Pelenė;Raktelis;6375060159;Ne;0;10;0;10
7190;Pelenė;Raktelis;2210314952;Ne;0;1;0;1
7191;Pelenė;Raktelis;6419661741;Ne;0;3;0;3
7192;Pelenė;Raktelis;4089199552;Ne;10;0;9;19
7193;Pelenė;Raktelis;6038229659;Ne;1;0;1;2
7194;Pelenė;Raktelis;1060619471;Ne;0;1;1;2
7195;Pelenė;Raktelis;5749399210;Ne;3;0;5;8
7196;Pelenė;Raktelis;4448592497;Ne;2;0;0;2
7197;Pelenė;Raktelis;5333802902;Ne;0;13;0;13
7198;Pelenė;Raktelis;1049199372;Ne;0;3;0;3
7199;Pelenė;Raktelis;2241816838;Ne;0;0;6;6
7200;Pelenė;Raktelis;5063098703;Ne;15;2;0;17
7201;Pelenė;Raktelis;6007163187;Ne;18;0;2;20
7202;Pelenė;Žvaigždutės;9473901831;Ne;5;0;0;5
7203;Pelenė;Žvaigždutės;2476080951;Ne;1;0;3;4
7204;Pelenė;Žvaigždutės;5548367924;Ne;0;0;9;9
7205;Pelenė;Žvaigždutės;5031778158;Ne;0;11;0;11
7206;Pelenė;Žvaigždutės;4056676361;Ne;0;0;7;7
7207;Pelenė;Žvaigždutės;4602503400;Ne;1;0;0;1
7208;Pelenė;Žvaigždutės;2555464779;Ne;0;8;0;8
7209;Pelenė;Žvaigždutės;9530531472;Ne;0;10;0;10
7210;Pelenė;Žvaigždutės;2040256240;Ne;4;0;0;4
7211;Pelenė;Žvaigždutės;4870187198;Ne;6;1;0;7
7212;Pelenė;Žvaigždutės;7640768043;Ne;28;0;0;28
7213;Pelenė;Žvaigždutės;7614130590;Ne;0;0;1;1
7214;Pelenė;Žvaigždutės;4856039707;Ne;10;1;0;11
7215;Pelenė;Žvaigždutės;5894429453;Ne;6;0;0;6
7216;Pelenė;Žvaigždutės;4109516555;Ne;0;13;0;13
7217;Pelenė;Žvaigždutės;5357701072;Ne;0;0;29;29
7218;Pelenė;Nykštukas;4541391191;Taip;13;0;2;15
7219;Pelenė;Nykštukas;9584503078;Ne;6;1;4;11
7220;Pelenė;Nykštukas;8770771520;Ne;0;1;3;4
7221;Pelenė;Nykštukas;10457480694;Ne;0;0;5;5
7222;Pelenė;Nykštukas;7254981715;Ne;0;5;0;5
7223;Pelenė;Nykštukas;6579504852;Ne;0;13;0;13
7224;Pelenė;Nykštukas;6021833025;Ne;4;0;0;4
7225;Pelenė;Nykštukas;1978481168;Ne;0;4;0;4
7226;Pelenė;Nykštukas;3596386480;Ne;0;10;0;10
7227;Pelenė;Nykštukas;3385568839;Ne;8;0;1;9
7228;Pelenė;Nykštukas;3189305906;Ne;0;3;0;3
7229;Pelenė;Nykštukas;1750366978;Ne;8;0;2;10
7230;Pelenė;Nykštukas;2092775878;Ne;0;6;0;6
7231;Pelenė;Nykštukas;8675348688;Ne;0;0;4;4
7232;Pelenė;Nykštukas;1142014148;Ne;2;0;0;2
7233;Pelenė;Nykštukas;1605794833;Ne;0;5;0;5
7234;Pelenė;Nykštukas;9063588699;Ne;2;5;0;7
7235;Pelenė;Nykštukas;9621197758;Ne;0;11;0;11
7236;Pelenė;Nykštukas;3296147024;Ne;0;13;0;13
7237;Pelenė;Žirniukai;8529178313;Ne;5;0;5;10
7238;Pelenė;Žirniukai;6046921077;Ne;7;0;0;7
7239;Pelenė;Žirniukai;9601582419;Ne;14;0;0;14
7240;Pelenė;Žirniukai;7057752202;Ne;2;0;2;4
7241;Pelenė;Žirniukai;7399112026;Ne;0;9;4;13
7242;Pelenė;Žirniukai;2443906444;Ne;3;0;0;3
7243;Pelenė;Žirniukai;5922348478;Ne;13;0;0;13
7244;Pelenė;Žirniukai;1313425695;Ne;6;0;0;6
7245;Pelenė;Žirniukai;5211115955;Ne;5;0;6;11
7246;Pelenė;Žirniukai;1595627222;Ne;0;15;0;15
7247;Pelenė;Žirniukai;2438266396;Ne;0;12;0;12
7248;Pelenė;Žirniukai;2590035984;Ne;7;1;0;8
7249;Pelenė;Žirniukai;3863839750;Ne;6;0;0;6
7250;Pelenė;Žirniukai;5686182866;Ne;0;0;6;6
7251;Pelenė;Žirniukai;7383544475;Ne;0;16;0;16
7252;Pelenė;Žirniukai;6661371876;Ne;4;0;0;4
7253;Pelenė;Žirniukai;2270989478;Ne;0;27;0;27
7254;Pelenė;Žirniukai;8617997163;Taip;18;6;3;27
7255;Pelenė;Žirniukai;7959433937;Ne;7;0;2;9
7256;Pelenė;Žirniukai;4703442187;Ne;5;0;0;5
7257;Pelenė;Lašeliai;7017031073;Ne;5;1;0;6
7258;Pelenė;Lašeliai;9313153383;Ne;0;10;0;10
7259;Pelenė;Lašeliai;5836118223;Ne;6;2;0;8
7260;Pelenė;Lašeliai;6316640679;Ne;0;0;6;6
7261;Pelenė;Lašeliai;1711603372;Ne;14;0;9;23
7262;Pelenė;Lašeliai;1944933777;Ne;0;20;0;20
7263;Pelenė;Lašeliai;2303618074;Ne;4;0;9;13
7264;Pelenė;Lašeliai;6167965418;Ne;7;0;0;7
7265;Pelenė;Lašeliai;8841183816;Ne;0;0;2;2
7266;Pelenė;Lašeliai;4431474395;Ne;0;3;0;3
7267;Pelenė;Lašeliai;9097123374;Ne;5;5;0;10
7268;Pelenė;Lašeliai;9162252512;Ne;0;0;24;24
7269;Pelenė;Lašeliai;4695104609;Ne;0;8;0;8
7270;Pelenė;Lašeliai;7148956863;Ne;0;11;0;11
7271;Pelenė;Lašeliai;4148108151;Ne;0;13;0;13
7272;Pelenė;Lašeliai;1303066945;Ne;14;0;0;14
7273;Pelenė;Lašeliai;3563882751;Ne;0;16;0;16
7274;Pelenė;Grūdelis;4624325473;Ne;0;9;0;9
7275;Pelenė;Grūdelis;1868951268;Ne;0;0;1;1
7276;Pelenė;Grūdelis;1140030742;Ne;0;2;0;2
7277;Pelenė;Grūdelis;69721118552;Ne;1;0;0;1
7278;Pelenė;Grūdelis;1336431888;Ne;2;0;1;3
7279;Pelenė;Grūdelis;6632188229;Ne;12;2;0;14
7280;Pelenė;Grūdelis;5356756237;Ne;0;0;3;3
7281;Pelenė;Grūdelis;39705461573;Ne;0;1;0;1
7282;Pelenė;Grūdelis;1781704945;Ne;1;0;0;1
7283;Pelenė;Grūdelis;2154553741;Ne;0;4;0;4
7284;Pelenė;Grūdelis;3497915398;Ne;0;5;0;5
7285;Pelenė;Grūdelis;8598498275;Ne;0;12;0;12
7286;Pelenė;Grūdelis;4307283949;Ne;0;0;10;10
7287;Pelenė;Grūdelis;1710249888;Ne;6;0;2;8
7288;Pelenė;Grūdelis;5325176433;Ne;0;8;0;8
7289;Pelenė;Grūdelis;1114786936;Ne;0;0;1;1
7290;Pelenė;Grūdelis;1245955282;Ne;0;8;0;8
7291;Pelenė;Grūdelis;6790396551;Ne;8;0;2;10
7292;Pelenė;Braškytė;7602432318;Ne;0;4;0;4
7293;Pelenė;Braškytė;2689903631;Ne;0;21;0;21
7294;Pelenė;Braškytė;4982869687;Ne;0;0;3;3
7295;Pelenė;Braškytė;8165766331;Ne;16;0;0;16
7296;Pelenė;Braškytė;1384382692;Ne;0;0;4;4
7297;Pelenė;Braškytė;4734502322;Ne;29;0;0;29
7298;Pelenė;Braškytė;8504675439;Ne;4;9;0;13
7299;Pelenė;Braškytė;2407328091;Ne;0;6;0;6
7300;Pelenė;Braškytė;8861981715;Ne;8;0;2;10
7301;Pelenė;Braškytė;6306403720;Ne;23;6;0;29
7302;Pelenė;Braškytė;9490816122;Ne;22;0;0;22
7303;Pelenė;Braškytė;2096373376;Ne;0;12;0;12
7304;Pelenė;Boružėlės;4961852594;Ne;4;0;0;4
7305;Pelenė;Boružėlės;1975574464;Ne;12;0;0;12
7306;Pelenė;Boružėlės;3549088727;Ne;5;0;3;8
7307;Pelenė;Boružėlės;5024793693;Ne;0;0;3;3
7308;Pelenė;Boružėlės;6567413229;Ne;15;0;1;16
7309;Pelenė;Boružėlės;6231387335;Ne;0;27;0;27
7310;Pelenė;Boružėlės;3700618977;Ne;6;0;4;10
7311;Pelenė;Boružėlės;5872711862;Ne;8;1;4;13
7312;Pelenė;Boružėlės;6081335781;Ne;4;1;0;5
7313;Pelenė;Boružėlės;3060502977;Ne;5;0;0;5
7314;Pelenė;Boružėlės;2083848693;Ne;14;0;0;14
7315;Pelenė;Boružėlės;1268615831;Taip;0;0;3;3
7316;Pelenė;Boružėlės;4396011355;Ne;5;0;0;5
7317;Pelenė;Boružėlės;6304818782;Ne;4;5;0;9
7318;Pelenė;Boružėlės;8718308575;Ne;0;27;0;27
7319;Pelenė;Boružėlės;5743530682;Ne;0;0;6;6
7320;Pelenė;Boružėlės;6867256280;Ne;0;0;5;5
7321;Pelenė;Boružėlės;7341814322;Taip;10;0;0;10
7322;Pelenė;Saldainiukai;5028095861;Ne;14;0;1;15
7323;Pelenė;Saldainiukai;9505945890;Ne;6;0;0;6
7324;Pelenė;Saldainiukai;8202196292;Ne;0;0;1;1
7325;Pelenė;Saldainiukai;5066227318;Ne;0;0;1;1
7326;Pelenė;Saldainiukai;7926586349;Ne;2;0;5;7
7327;Pelenė;Saldainiukai;4305733824;Ne;0;0;5;5
7328;Pelenė;Saldainiukai;2986690431;Ne;10;2;0;12
7329;Pelenė;Saldainiukai;4660385383;Ne;11;0;0;11
7330;Pelenė;Saldainiukai;8862429244;Ne;8;0;7;15
7331;Pelenė;Saldainiukai;9969975097;Ne;12;0;1;13
7332;Pelenė;Saldainiukai;5762403752;Ne;0;6;0;6
7333;Pelenė;Saldainiukai;5926700157;Ne;7;0;1;8
7334;Pelenė;Saldainiukai;8961082265;Ne;0;2;0;2
7335;Pelenė;Saldainiukai;2882716674;Ne;0;5;2;7
7336;Pelenė;Saldainiukai;4859437855;Ne;0;0;29;29
7337;Pelenė;Saldainiukai;4023923887;Ne;0;0;6;6
7338;Pelenė;Drugeliai;2540405047;Ne;1;0;6;7
7339;Pelenė;Drugeliai;3603352172;Ne;3;0;2;5
7340;Pelenė;Drugeliai;9218868317;Ne;0;0;2;2
7341;Pelenė;Drugeliai;2628676128;Ne;0;0;2;2
7342;Pelenė;Drugeliai;6834792589;Ne;0;0;3;3
7343;Pelenė;Drugeliai;9810123679;Ne;0;1;0;1
7344;Pelenė;Drugeliai;1048899958;Ne;0;0;1;1
7345;Pelenė;Drugeliai;3327213856;Ne;0;1;0;1
7346;Pelenė;Drugeliai;6252972353;Ne;1;0;6;7
7347;Pelenė;Drugeliai;1584256570;Ne;0;0;4;4
7348;Pelenė;Drugeliai;3205331614;Ne;0;0;4;4
7349;Pelenė;Drugeliai;5631629419;Ne;0;16;0;16
7350;Pelenė;Drugeliai;2163737781;Ne;0;16;0;16
7351;Pelenė;Drugeliai;9004080625;Ne;12;0;11;23
7352;Pelenė;Drugeliai;7565331966;Ne;0;16;0;16
7353;Pelenė;Drugeliai;8194354176;Ne;6;1;0;7
7354;Pelenė;Drugeliai;5579900958;Ne;0;0;4;4
7355;Pipiras;EŽIUKAI;1876870081;Ne;0;2;0;2
7356;Pipiras;EŽIUKAI;9275905384;Ne;1;4;0;5
7357;Pipiras;EŽIUKAI;41585818819;Ne;0;1;0;1
7358;Pipiras;EŽIUKAI;6153579332;Ne;3;0;0;3
7359;Pipiras;EŽIUKAI;1391958633;Ne;0;1;0;1
7360;Pipiras;EŽIUKAI;5637557921;Ne;0;3;0;3
7361;Pipiras;EŽIUKAI;7799786844;Ne;0;6;0;6
7362;Pipiras;EŽIUKAI;5014457985;Ne;14;0;0;14
7363;Pipiras;EŽIUKAI;1050430252;Ne;0;1;0;1
7364;Pipiras;EŽIUKAI;1904376366;Ne;0;3;0;3
7365;Pipiras;EŽIUKAI;3008358842;Ne;0;6;0;6
7366;Pipiras;EŽIUKAI;2024777430;Ne;0;1;0;1
7367;Pipiras;EŽIUKAI;2402351134;Ne;10;1;0;11
7368;Pipiras;EŽIUKAI;2255644686;Ne;0;0;10;10
7369;Pipiras;EŽIUKAI;7736031786;Ne;0;2;3;5
7370;Pipiras;EŽIUKAI;4959823035;Ne;4;7;0;11
7371;Pipiras;EŽIUKAI;1128674099;Ne;3;2;0;5
7372;Pipiras;EŽIUKAI;6339186940;Ne;0;0;4;4
7373;Pipiras;EŽIUKAI;3422170541;Ne;0;4;0;4
7374;Pipiras;EŽIUKAI;3314276870;Ne;3;2;0;5
7375;Pipiras;EŽIUKAI;7784343130;Ne;1;0;0;1
7376;Pipiras;BITUTĖS;3851239592;Ne;13;0;0;13
7377;Pipiras;BITUTĖS;7891664385;Ne;0;13;0;13
7378;Pipiras;BITUTĖS;9050423801;Ne;0;5;0;5
7379;Pipiras;BITUTĖS;3794537946;Ne;0;0;5;5
7380;Pipiras;BITUTĖS;5047070127;Ne;8;0;3;11
7381;Pipiras;BITUTĖS;2645772675;Ne;3;0;0;3
7382;Pipiras;BITUTĖS;9394456452;Ne;16;0;0;16
7383;Pipiras;BITUTĖS;9610070604;Ne;0;4;0;4
7384;Pipiras;BITUTĖS;7009194986;Ne;5;1;2;8
7385;Pipiras;BITUTĖS;6362968454;Ne;4;0;0;4
7386;Pipiras;BITUTĖS;6273958740;Ne;4;10;0;14
7387;Pipiras;BITUTĖS;2887703782;Taip;5;0;0;5
7388;Pipiras;BITUTĖS;9950318827;Ne;0;3;0;3
7389;Pipiras;BITUTĖS;9733577233;Ne;0;0;7;7
7390;Pipiras;NYKŠTUKAI;6696824728;Taip;4;2;1;7
7391;Pipiras;NYKŠTUKAI;2016718354;Ne;0;1;0;1
7392;Pipiras;NYKŠTUKAI;1169481984;Ne;10;2;1;13
7393;Pipiras;NYKŠTUKAI;4198534687;Ne;0;6;0;6
7394;Pipiras;NYKŠTUKAI;4458730479;Ne;9;0;0;9
7395;Pipiras;NYKŠTUKAI;4510888337;Taip;5;6;0;11
7396;Pipiras;NYKŠTUKAI;3980950261;Ne;14;0;0;14
7397;Pipiras;NYKŠTUKAI;7828638329;Ne;4;2;0;6
7398;Pipiras;NYKŠTUKAI;6775489564;Ne;6;0;6;12
7399;Pipiras;NYKŠTUKAI;8689174023;Ne;4;0;0;4
7400;Pipiras;NYKŠTUKAI;7747049622;Ne;9;0;0;9
7401;Pipiras;NYKŠTUKAI;9892201598;Ne;8;7;0;15
7402;Pipiras;NYKŠTUKAI;7371386368;Ne;3;1;0;4
7403;Pipiras;NYKŠTUKAI;1019753152;Ne;7;7;0;14
7404;Pipiras;NYKŠTUKAI;9877682150;Ne;0;1;0;1
7405;Pipiras;NYKŠTUKAI;9248925267;Ne;12;2;0;14
7406;Pipiras;NYKŠTUKAI;9711147855;Ne;0;1;0;1
7407;Pipiras;PELĖDŽIUKAI;6342044341;Ne;5;5;0;10
7408;Pipiras;PELĖDŽIUKAI;5725956659;Ne;5;0;0;5
7409;Pipiras;PELĖDŽIUKAI;3852848863;Ne;4;0;0;4
7410;Pipiras;PELĖDŽIUKAI;5235868332;Ne;2;4;0;6
7411;Pipiras;PELĖDŽIUKAI;1034182352;Ne;10;9;0;19
7412;Pipiras;PELĖDŽIUKAI;2075041950;Ne;1;0;0;1
7413;Pipiras;PELĖDŽIUKAI;6792777396;Ne;0;1;0;1
7414;Pipiras;PELĖDŽIUKAI;6780333972;Ne;7;8;0;15
7415;Pipiras;PELĖDŽIUKAI;5622119207;Ne;4;1;0;5
7416;Pipiras;PELĖDŽIUKAI;7934365114;Ne;10;2;0;12
7417;Pipiras;PELĖDŽIUKAI;6523189501;Taip;20;0;0;20
7418;Pipiras;PELĖDŽIUKAI;9770780973;Ne;12;0;0;12
7419;Pipiras;PELĖDŽIUKAI;5845498558;Ne;0;6;0;6
7420;Pipiras;PELĖDŽIUKAI;9840040112;Ne;2;5;0;7
7421;Pipiras;PELĖDŽIUKAI;1784839485;Ne;0;12;0;12
7422;Pipiras;PELĖDŽIUKAI;3775916247;Ne;0;1;0;1
7423;Pipiras;PELĖDŽIUKAI;7350131214;Ne;7;0;0;7
7424;Pipiras;DRUGELIAI;5856735452;Ne;7;1;0;8
7425;Pipiras;DRUGELIAI;2267192782;Ne;0;7;0;7
7426;Pipiras;DRUGELIAI;1045583136;Ne;13;2;0;15
7427;Pipiras;DRUGELIAI;1711168196;Ne;3;0;0;3
7428;Pipiras;DRUGELIAI;7425654504;Taip;0;11;0;11
7429;Pipiras;DRUGELIAI;4017042461;Ne;0;3;0;3
7430;Pipiras;DRUGELIAI;4725221169;Ne;5;0;0;5
7431;Pipiras;DRUGELIAI;5059203266;Ne;5;0;1;6
7432;Pipiras;DRUGELIAI;8140314304;Ne;0;0;2;2
7433;Pipiras;DRUGELIAI;8422419380;Ne;4;7;0;11
7434;Pipiras;DRUGELIAI;4811029230;Ne;0;13;0;13
7435;Pipiras;DRUGELIAI;6685567970;Taip;0;2;6;8
7436;Pipiras;DRUGELIAI;1353114929;Ne;0;2;0;2
7437;Pipiras;DRUGELIAI;4426479971;Taip;3;2;4;9
7438;Pipiras;DRUGELIAI;5512049762;Ne;5;3;0;8
7439;Pipiras;GĖLYTĖS;9670710691;Ne;0;0;6;6
7440;Pipiras;GĖLYTĖS;8965139441;Ne;0;2;2;4
7441;Pipiras;GĖLYTĖS;2095794125;Ne;0;0;2;2
7442;Pipiras;GĖLYTĖS;8675473349;Ne;0;0;1;1
7443;Pipiras;GĖLYTĖS;4945164161;Ne;10;2;0;12
7444;Pipiras;GĖLYTĖS;7362002646;Ne;0;1;0;1
7445;Pipiras;GĖLYTĖS;3755824911;Ne;0;2;0;2
7446;Pipiras;GĖLYTĖS;4559954910;Ne;5;10;0;15
7447;Pipiras;GĖLYTĖS;7157187063;Ne;11;1;0;12
7448;Pipiras;GĖLYTĖS;4021613243;Ne;0;6;0;6
7449;Pipiras;GĖLYTĖS;1611488078;Ne;5;2;2;9
7450;Pipiras;GĖLYTĖS;4236597883;Ne;0;0;10;10
7451;Pipiras;GĖLYTĖS;2474548836;Taip;0;1;0;1
7452;Pipiras;GĖLYTĖS;8553422709;Ne;0;0;1;1
7453;Pipiras;GĖLYTĖS;5738334591;Ne;0;7;0;7
7454;Pipiras;GĖLYTĖS;6428525902;Ne;1;0;0;1
7455;Pipiras;GĖLYTĖS;8354158722;Ne;1;0;1;2
7456;Pipiras;BORUŽĖLĖS;4707794599;Ne;0;0;1;1
7457;Pipiras;BORUŽĖLĖS;8673271201;Ne;0;5;0;5
7458;Pipiras;BORUŽĖLĖS;5968015502;Ne;0;2;0;2
7459;Pipiras;BORUŽĖLĖS;4086728233;Ne;0;4;3;7
7460;Pipiras;BORUŽĖLĖS;8508292428;Ne;0;1;0;1
7461;Pipiras;BORUŽĖLĖS;1210940213;Ne;0;2;2;4
7462;Pipiras;BORUŽĖLĖS;9097987789;Taip;0;5;0;5
7463;Pipiras;BORUŽĖLĖS;6310054093;Ne;0;1;0;1
7464;Pipiras;BORUŽĖLĖS;8959946514;Taip;0;0;2;2
7465;Pipiras;BORUŽĖLĖS;1146369304;Ne;5;1;0;6
7466;Pipiras;BORUŽĖLĖS;9970587185;Ne;0;7;0;7
7467;Pipiras;BORUŽĖLĖS;6034298583;Ne;6;1;0;7
7468;Pipiras;BORUŽĖLĖS;6344932171;Ne;3;2;0;5
7469;Pipiras;BORUŽĖLĖS;1550959705;Ne;0;0;3;3
7470;Pipiras;BORUŽĖLĖS;9645230615;Ne;0;5;0;5
7471;Pipiras;SKRUZDĖLIUKAI;7969837759;Ne;0;3;0;3
7472;Pipiras;SKRUZDĖLIUKAI;1315372873;Ne;0;6;0;6
7473;Pipiras;SKRUZDĖLIUKAI;9372109848;Ne;4;6;0;10
7474;Pipiras;SKRUZDĖLIUKAI;8296425777;Taip;0;1;0;1
7475;Pipiras;SKRUZDĖLIUKAI;9968182443;Ne;0;2;0;2
7476;Pipiras;SKRUZDĖLIUKAI;3768825314;Ne;5;0;2;7
7477;Pipiras;SKRUZDĖLIUKAI;5888429623;Taip;5;0;0;5
7478;Pipiras;SKRUZDĖLIUKAI;4309096743;Ne;4;0;2;6
7479;Pipiras;SKRUZDĖLIUKAI;8081343184;Ne;0;8;0;8
7480;Pipiras;SKRUZDĖLIUKAI;9852475056;Ne;17;0;0;17
7481;Pipiras;SKRUZDĖLIUKAI;6176818802;Ne;8;0;1;9
7482;Pipiras;SKRUZDĖLIUKAI;1215623527;Ne;0;1;0;1
7483;Pipiras;SKRUZDĖLIUKAI;1998249512;Ne;6;0;1;7
7484;Pipiras;SKRUZDĖLIUKAI;9625933545;Ne;0;1;0;1
7485;Pipiras;SKRUZDĖLIUKAI;7211189491;Ne;4;5;0;9
7486;Pipiras;ŽVIRBLIUKŲ;6340323302;Ne;5;0;0;5
7487;Pipiras;ŽVIRBLIUKŲ;5445858240;Ne;7;1;0;8
7488;Pipiras;ŽVIRBLIUKŲ;1242260242;Ne;0;1;0;1
7489;Pipiras;ŽVIRBLIUKŲ;4266424785;Taip;0;0;1;1
7490;Pipiras;ŽVIRBLIUKŲ;3421769229;Ne;1;1;0;2
7491;Pipiras;ŽVIRBLIUKŲ;8520454289;Ne;8;1;0;9
7492;Pipiras;ŽVIRBLIUKŲ;5422547144;Ne;8;0;0;8
7493;Pipiras;ŽVIRBLIUKŲ;6136423200;Ne;9;0;1;10
7494;Pipiras;ŽVIRBLIUKŲ;1144813356;Ne;0;0;2;2
7495;Pipiras;ŽVIRBLIUKŲ;6694920607;Ne;0;10;0;10
7496;Pipiras;ŽVIRBLIUKŲ;7912217889;Ne;5;0;0;5
7497;Pipiras;ŽVIRBLIUKŲ;3141822820;Ne;10;0;0;10
7498;Pipiras;ŽVIRBLIUKŲ;7870521230;Ne;0;0;2;2
7499;Pipiras;ŽVIRBLIUKŲ;4428216634;Ne;8;0;2;10
7500;Pipiras;ŽVIRBLIUKŲ;5502001191;Ne;0;1;0;1
7501;Pipiras;ŽVIRBLIUKŲ;3888552150;Ne;0;1;0;1
7502;Pipiras;ŽVIRBLIUKŲ;2240865490;Ne;0;6;0;6
7503;Pipiras;ŽVIRBLIUKŲ;2044498561;Ne;0;0;1;1
7504;Pipiras;ŽVIRBLIUKŲ;7026118693;Ne;0;2;0;2
7505;Pipiras;ŽVIRBLIUKŲ;87924002679;Ne;5;2;0;7
7506;Pipiras;ŽVIRBLIUKŲ;4496076326;Ne;0;0;2;2
7507;Pipiras;ZUIKUČIŲ;3641496225;Ne;6;2;0;8
7508;Pipiras;ZUIKUČIŲ;6925577945;Ne;0;2;0;2
7509;Pipiras;ZUIKUČIŲ;2159315426;Ne;20;0;0;20
7510;Pipiras;ZUIKUČIŲ;8404246568;Ne;0;6;0;6
7511;Pipiras;ZUIKUČIŲ;2599175140;Taip;2;0;0;2
7512;Pipiras;ZUIKUČIŲ;7200147039;Ne;4;0;0;4
7513;Pipiras;ZUIKUČIŲ;4743474665;Ne;5;2;0;7
7514;Pipiras;ZUIKUČIŲ;9422467047;Ne;0;0;4;4
7515;Pipiras;ZUIKUČIŲ;4991725638;Ne;0;8;4;12
7516;Pipiras;ZUIKUČIŲ;9552763906;Ne;3;0;2;5
7517;Pipiras;VARLIUKŲ;7446225835;Ne;15;0;0;15
7518;Pipiras;VARLIUKŲ;8800890503;Ne;3;0;0;3
7519;Pipiras;VARLIUKŲ;8028360748;Ne;6;0;0;6
7520;Pipiras;VARLIUKŲ;1238280105;Ne;2;2;1;5
7521;Pipiras;VARLIUKŲ;3299099535;Ne;0;3;0;3
7522;Pipiras;VARLIUKŲ;8364783015;Ne;0;0;20;20
7523;Pipiras;VARLIUKŲ;5502186385;Ne;4;0;0;4
7524;Pipiras;VARLIUKŲ;8707560610;Ne;0;0;1;1
7525;Pipiras;VARLIUKŲ;4940053409;Ne;2;0;0;2
7526;Pipiras;VARLIUKŲ;2588075386;Ne;1;0;0;1
7527;Pipiras;VARLIUKŲ;6666112357;Ne;0;1;0;1
7528;Pipiras;VARLIUKŲ;9473056714;Ne;5;14;0;19
7529;Pipiras;VARLIUKŲ;8040520887;Ne;0;2;5;7
7530;Pipiras;ŽIOGELIŲ;7510719254;Ne;0;0;9;9
7531;Pipiras;ŽIOGELIŲ;7802812858;Ne;1;0;10;11
7532;Pipiras;ŽIOGELIŲ;8697732892;Ne;16;0;0;16
7533;Pipiras;ŽIOGELIŲ;1466527534;Ne;0;0;3;3
7534;Pipiras;ŽIOGELIŲ;1172225661;Ne;0;3;2;5
7535;Pipiras;ŽIOGELIŲ;3825960148;Ne;7;2;1;10
7536;Pipiras;ŽIOGELIŲ;9747219629;Ne;1;10;0;11
7537;Pipiras;ŽIOGELIŲ;4229548366;Ne;0;0;6;6
7538;Pipiras;ŽIOGELIŲ;8666908143;Ne;1;2;0;3
7539;Pipiras;ŽIOGELIŲ;4083110785;Ne;20;0;0;20
7540;Pipiras;ŽIOGELIŲ;7011969610;Ne;7;0;0;7
7541;Pipiras;ŽIOGELIŲ;8055084637;Ne;0;5;0;5
7542;"Prie pasakų parko";ZUIKUČIAI;8493622886;Ne;0;0;1;1
7543;"Prie pasakų parko";ZUIKUČIAI;3998970024;Ne;0;4;0;4
7544;"Prie pasakų parko";ZUIKUČIAI;3907016976;Ne;1;0;3;4
7545;"Prie pasakų parko";ZUIKUČIAI;9770819792;Taip;3;0;0;3
7546;"Prie pasakų parko";ZUIKUČIAI;4904562817;Taip;5;0;0;5
7547;"Prie pasakų parko";ZUIKUČIAI;6662531456;Taip;8;0;0;8
7548;"Prie pasakų parko";ZUIKUČIAI;9659710840;Ne;0;1;0;1
7549;"Prie pasakų parko";ZUIKUČIAI;5394554484;Ne;4;0;0;4
7550;"Prie pasakų parko";ZUIKUČIAI;9707694441;Taip;4;0;0;4
7551;"Prie pasakų parko";ZUIKUČIAI;7220229641;Ne;5;7;0;12
7552;"Prie pasakų parko";ZUIKUČIAI;8616467675;Ne;0;0;1;1
7553;"Prie pasakų parko";ZUIKUČIAI;8215496569;Ne;0;0;1;1
7554;"Prie pasakų parko";ZUIKUČIAI;9742058853;Ne;5;0;0;5
7555;"Prie pasakų parko";PAUKŠČIUKŲ;4860316199;Ne;9;2;2;13
7556;"Prie pasakų parko";PAUKŠČIUKŲ;3907578461;Ne;12;0;1;13
7557;"Prie pasakų parko";PAUKŠČIUKŲ;7359935733;Ne;16;0;1;17
7558;"Prie pasakų parko";PAUKŠČIUKŲ;7330033315;Ne;0;0;1;1
7559;"Prie pasakų parko";PAUKŠČIUKŲ;9061639276;Ne;7;0;0;7
7560;"Prie pasakų parko";PAUKŠČIUKŲ;6601363351;Ne;4;0;0;4
7561;"Prie pasakų parko";PAUKŠČIUKŲ;9784398441;Ne;5;0;0;5
7562;"Prie pasakų parko";PAUKŠČIUKŲ;4891232161;Ne;0;0;1;1
7563;"Prie pasakų parko";PAUKŠČIUKŲ;9550985822;Ne;0;2;0;2
7564;"Prie pasakų parko";PAUKŠČIUKŲ;5737517940;Ne;4;0;4;8
7565;"Prie pasakų parko";PAUKŠČIUKŲ;7693728136;Taip;1;1;0;2
7566;"Prie pasakų parko";"LINKSMOJI ŠEIMYNĖLĖ (SPEC)";2820889357;Ne;6;2;1;9
7567;"Prie pasakų parko";"LINKSMOJI ŠEIMYNĖLĖ (SPEC)";29445903073;Ne;6;0;2;8
7568;"Prie pasakų parko";"LINKSMOJI ŠEIMYNĖLĖ (SPEC)";1549137154;Ne;0;0;2;2
7569;"Prie pasakų parko";"LINKSMOJI ŠEIMYNĖLĖ (SPEC)";9469871636;Ne;11;0;0;11
7570;"Prie pasakų parko";"LINKSMOJI ŠEIMYNĖLĖ (SPEC)";5641148690;Ne;0;7;0;7
7571;"Prie pasakų parko";"LINKSMOJI ŠEIMYNĖLĖ (SPEC)";9594976173;Ne;0;0;6;6
7572;"Prie pasakų parko";"LINKSMOJI ŠEIMYNĖLĖ (SPEC)";1828638638;Ne;4;0;1;5
7573;"Prie pasakų parko";"LINKSMOJI ŠEIMYNĖLĖ (SPEC)";9789977863;Ne;6;0;1;7
7574;"Prie pasakų parko";NYKŠTUKŲ;2287711014;Ne;3;0;1;4
7575;"Prie pasakų parko";NYKŠTUKŲ;6491435655;Ne;6;0;0;6
7576;"Prie pasakų parko";NYKŠTUKŲ;1743429440;Ne;0;2;0;2
7577;"Prie pasakų parko";NYKŠTUKŲ;1811994592;Taip;1;0;0;1
7578;"Prie pasakų parko";NYKŠTUKŲ;7739970115;Ne;1;0;0;1
7579;"Prie pasakų parko";NYKŠTUKŲ;6700916147;Ne;9;0;0;9
7580;"Prie pasakų parko";NYKŠTUKŲ;6733793491;Ne;9;0;4;13
7581;"Prie pasakų parko";NYKŠTUKŲ;2515928623;Ne;6;0;0;6
7582;"Prie pasakų parko";NYKŠTUKŲ;4726737519;Taip;8;0;3;11
7583;"Prie pasakų parko";NYKŠTUKŲ;1316127369;Ne;0;0;2;2
7584;"Prie pasakų parko";NYKŠTUKŲ;2654978735;Ne;12;0;7;19
7585;"Prie pasakų parko";NYKŠTUKŲ;3202292611;Ne;0;0;3;3
7586;"Prie pasakų parko";NYKŠTUKŲ;4457827262;Ne;14;0;0;14
7587;"Prie pasakų parko";LAŠELIŲ;6865751947;Ne;0;0;6;6
7588;"Prie pasakų parko";LAŠELIŲ;6992830082;Ne;0;0;1;1
7589;"Prie pasakų parko";LAŠELIŲ;1588062393;Ne;6;0;7;13
7590;"Prie pasakų parko";LAŠELIŲ;1278065349;Ne;9;0;0;9
7591;"Prie pasakų parko";LAŠELIŲ;4181676762;Ne;0;0;1;1
7592;"Prie pasakų parko";LAŠELIŲ;4548803933;Ne;6;0;1;7
7593;"Prie pasakų parko";LAŠELIŲ;6250610187;Ne;4;7;2;13
7594;"Prie pasakų parko";LAŠELIŲ;9190379838;Ne;5;0;3;8
7595;"Prie pasakų parko";LAŠELIŲ;8215830508;Ne;0;6;0;6
7596;"Prie pasakų parko";LAŠELIŲ;2216634402;Ne;1;0;1;2
7597;"Prie pasakų parko";LAŠELIŲ;8849417734;Ne;1;0;1;2
7598;"Prie pasakų parko";LAŠELIŲ;7545372781;Ne;0;0;1;1
7599;"Prie pasakų parko";LAŠELIŲ;2731544174;Ne;5;0;0;5
7600;"Prie pasakų parko";LAŠELIŲ;5494350183;Ne;0;3;0;3
7601;"Prie pasakų parko";LAŠELIŲ;5102718403;Taip;9;0;1;10
7602;"Prie pasakų parko";"KAČIUKAI (SPEC)";6772736175;Ne;3;0;2;5
7603;"Prie pasakų parko";"KAČIUKAI (SPEC)";5847625697;Ne;0;0;7;7
7604;"Prie pasakų parko";"KAČIUKAI (SPEC)";2590693851;Ne;6;0;0;6
7605;"Prie pasakų parko";"KAČIUKAI (SPEC)";3949671257;Ne;11;0;0;11
7606;"Prie pasakų parko";"KAČIUKAI (SPEC)";1370201372;Ne;0;4;0;4
7607;"Prie pasakų parko";"ŽVAIGŽDUTĖS  (SPEC)";7216751216;Ne;3;0;2;5
7608;"Prie pasakų parko";"ŽVAIGŽDUTĖS  (SPEC)";4037594669;Ne;0;0;1;1
7609;"Prie pasakų parko";"ŽVAIGŽDUTĖS  (SPEC)";9072312203;Ne;0;0;1;1
7610;"Prie pasakų parko";"ŽVAIGŽDUTĖS  (SPEC)";5006152810;Ne;2;0;0;2
7611;"Prie pasakų parko";"ŽVAIGŽDUTĖS  (SPEC)";6989235061;Ne;4;0;9;13
7612;"Prie pasakų parko";"ŽVAIGŽDUTĖS  (SPEC)";5009168398;Ne;0;0;2;2
7613;"Prie pasakų parko";"ŽVAIGŽDUTĖS  (SPEC)";6585504578;Ne;20;0;0;20
7614;"Prie pasakų parko";"ŽVAIGŽDUTĖS  (SPEC)";1621710265;Ne;5;0;1;6
7615;"Prie pasakų parko";"ŽVAIGŽDUTĖS  (SPEC)";8203595449;Ne;17;0;0;17
7616;"Prie pasakų parko";"ŽVAIGŽDUTĖS  (SPEC)";7476984763;Ne;8;0;0;8
7617;"Prie pasakų parko";"ANČIUKAI (SPEC)";8339335908;Ne;0;0;5;5
7618;"Prie pasakų parko";"ANČIUKAI (SPEC)";6802898184;Ne;0;0;1;1
7619;"Prie pasakų parko";"ANČIUKAI (SPEC)";9529949992;Ne;0;0;3;3
7620;"Prie pasakų parko";"ANČIUKAI (SPEC)";6431918357;Taip;7;0;0;7
7621;"Prie pasakų parko";"ANČIUKAI (SPEC)";1190509858;Taip;7;0;0;7
7622;"Prie pasakų parko";"ANČIUKAI (SPEC)";4309482351;Ne;5;0;0;5
7623;"Prie pasakų parko";"ANČIUKAI (SPEC)";7200571639;Ne;0;0;6;6
7624;"Prie pasakų parko";"ANČIUKAI (SPEC)";2047018335;Ne;5;0;0;5
7625;"Prie pasakų parko";"ANČIUKAI (SPEC)";2731902356;Ne;0;0;3;3
7626;"Prie pasakų parko";TIGRIUKAI;7858530013;Ne;5;5;0;10
7627;"Prie pasakų parko";TIGRIUKAI;3918269702;Taip;11;0;2;13
7628;"Prie pasakų parko";TIGRIUKAI;6446562388;Ne;1;3;0;4
7629;"Prie pasakų parko";TIGRIUKAI;2168919559;Ne;0;9;0;9
7630;"Prie pasakų parko";TIGRIUKAI;8899375521;Ne;20;0;0;20
7631;"Prie pasakų parko";TIGRIUKAI;2898016639;Taip;0;0;6;6
7632;"Prie pasakų parko";TIGRIUKAI;9476448601;Ne;0;0;3;3
7633;"Prie pasakų parko";TIGRIUKAI;8029428034;Ne;1;0;0;1
7634;"Prie pasakų parko";TIGRIUKAI;8715851643;Ne;0;0;2;2
7635;"Prie pasakų parko";TIGRIUKAI;3617673265;Ne;0;0;4;4
7636;"Prie pasakų parko";TIGRIUKAI;1704679306;Ne;3;0;0;3
7637;"Prie pasakų parko";TIGRIUKAI;7776961789;Ne;0;0;1;1
7638;"Prie pasakų parko";TIGRIUKAI;8285260113;Ne;0;0;8;8
7639;"Prie pasakų parko";TIGRIUKAI;3373275644;Ne;1;7;0;8
7640;"Prie pasakų parko";TIGRIUKAI;5518041213;Ne;0;0;3;3
7641;"Prie pasakų parko";TIGRIUKAI;8738488104;Ne;0;0;3;3
7642;"Prie pasakų parko";TIGRIUKAI;8406002339;Ne;0;0;6;6
7643;"Prie pasakų parko";"EŽIUKŲ (SPEC)";7115825217;Taip;8;0;7;15
7644;"Prie pasakų parko";"EŽIUKŲ (SPEC)";2952868428;Ne;6;0;1;7
7645;"Prie pasakų parko";"EŽIUKŲ (SPEC)";5159105661;Ne;0;0;4;4
7646;"Prie pasakų parko";"EŽIUKŲ (SPEC)";5944113879;Ne;1;0;2;3
7647;"Prie pasakų parko";"EŽIUKŲ (SPEC)";4950143153;Ne;1;0;5;6
7648;"Prie pasakų parko";"EŽIUKŲ (SPEC)";4799789212;Ne;3;0;6;9
7649;"Prie pasakų parko";"EŽIUKŲ (SPEC)";5834070970;Ne;13;0;1;14
7650;"Prie pasakų parko";"EŽIUKŲ (SPEC)";3579773269;Ne;5;0;0;5
7651;"Prie pasakų parko";"BORUŽIUKŲ (SPEC)";9715586563;Ne;0;1;8;9
7652;"Prie pasakų parko";"BORUŽIUKŲ (SPEC)";6215345468;Ne;0;0;2;2
7653;"Prie pasakų parko";"BORUŽIUKŲ (SPEC)";7000191099;Ne;5;0;1;6
7654;"Prie pasakų parko";"BORUŽIUKŲ (SPEC)";2104412442;Ne;9;0;0;9
7655;"Prie pasakų parko";SAULYTĖS;6762267582;Ne;4;0;1;5
7656;"Prie pasakų parko";SAULYTĖS;7459673719;Taip;1;0;3;4
7657;"Prie pasakų parko";SAULYTĖS;4351705573;Ne;0;0;7;7
7658;"Prie pasakų parko";SAULYTĖS;7390391804;Ne;0;6;0;6
7659;"Prie pasakų parko";SAULYTĖS;8685140364;Ne;10;3;0;13
7660;"Prie pasakų parko";SAULYTĖS;6606867989;Ne;0;0;2;2
7661;"Prie pasakų parko";SAULYTĖS;2206221105;Ne;5;0;1;6
7662;"Prie pasakų parko";SAULYTĖS;3038164555;Taip;6;0;0;6
7663;"Prie pasakų parko";SAULYTĖS;4183640714;Ne;20;0;0;20
7664;"Prie pasakų parko";SAULYTĖS;1738732866;Ne;7;1;0;8
7665;"Pumpurėlis (Kalvarijų g. 186)";RAMUNĖLIŲ;7610949816;Ne;0;6;0;6
7666;"Pumpurėlis (Kalvarijų g. 186)";RAMUNĖLIŲ;6165833101;Ne;4;0;0;4
7667;"Pumpurėlis (Kalvarijų g. 186)";RAMUNĖLIŲ;6977710645;Ne;0;0;1;1
7668;"Pumpurėlis (Kalvarijų g. 186)";RAMUNĖLIŲ;9431295796;Ne;2;0;10;12
7669;"Pumpurėlis (Kalvarijų g. 186)";RAMUNĖLIŲ;1395380236;Ne;3;0;4;7
7670;"Pumpurėlis (Kalvarijų g. 186)";RAMUNĖLIŲ;9424449290;Ne;5;3;0;8
7671;"Pumpurėlis (Kalvarijų g. 186)";RAMUNĖLIŲ;6955168163;Ne;4;0;1;5
7672;"Pumpurėlis (Kalvarijų g. 186)";RAMUNĖLIŲ;5171198109;Ne;15;0;0;15
7673;"Pumpurėlis (Kalvarijų g. 186)";RAMUNĖLIŲ;9726028397;Ne;8;0;0;8
7674;"Pumpurėlis (Kalvarijų g. 186)";RAMUNĖLIŲ;7229289985;Ne;5;0;3;8
7675;"Pumpurėlis (Kalvarijų g. 186)";RAMUNĖLIŲ;2969734731;Ne;0;0;1;1
7676;"Pumpurėlis (Kalvarijų g. 186)";RAMUNĖLIŲ;3953103488;Taip;0;4;0;4
7677;"Pumpurėlis (Kalvarijų g. 186)";RAMUNĖLIŲ;3838705973;Ne;6;0;3;9
7678;"Pumpurėlis (Kalvarijų g. 186)";RAMUNĖLIŲ;6726875853;Ne;0;0;4;4
7679;"Pumpurėlis (Kalvarijų g. 186)";RAMUNĖLIŲ;8667762689;Ne;0;2;0;2
7680;"Pumpurėlis (Kalvarijų g. 186)";RAMUNĖLIŲ;3874188848;Ne;8;0;12;20
7681;"Pumpurėlis (Kalvarijų g. 186)";RAMUNĖLIŲ;7619709360;Ne;10;0;0;10
7682;"Pumpurėlis (Kalvarijų g. 186)";VARPELIŲ;3101133244;Ne;2;1;0;3
7683;"Pumpurėlis (Kalvarijų g. 186)";VARPELIŲ;3893768713;Ne;0;8;0;8
7684;"Pumpurėlis (Kalvarijų g. 186)";VARPELIŲ;5023658988;Ne;0;0;1;1
7685;"Pumpurėlis (Kalvarijų g. 186)";VARPELIŲ;2668855786;Ne;3;8;0;11
7686;"Pumpurėlis (Kalvarijų g. 186)";VARPELIŲ;8258560345;Ne;4;4;0;8
7687;"Pumpurėlis (Kalvarijų g. 186)";VARPELIŲ;9612924972;Ne;0;1;0;1
7688;"Pumpurėlis (Kalvarijų g. 186)";VARPELIŲ;9884099545;Taip;9;0;0;9
7689;"Pumpurėlis (Kalvarijų g. 186)";VARPELIŲ;4508966729;Ne;6;0;0;6
7690;"Pumpurėlis (Kalvarijų g. 186)";VARPELIŲ;9552913910;Ne;4;0;0;4
7691;"Pumpurėlis (Kalvarijų g. 186)";VARPELIŲ;5196733185;Ne;1;0;0;1
7692;"Pumpurėlis (Kalvarijų g. 186)";VARPELIŲ;4928495108;Ne;0;1;2;3
7693;"Pumpurėlis (Kalvarijų g. 186)";VARPELIŲ;8886730333;Ne;0;8;0;8
7694;"Pumpurėlis (Kalvarijų g. 186)";VARPELIŲ;5564680653;Ne;0;0;2;2
7695;"Pumpurėlis (Kalvarijų g. 186)";VARPELIŲ;8525537588;Ne;7;0;1;8
7696;"Pumpurėlis (Kalvarijų g. 186)";VARPELIŲ;2103139845;Ne;15;0;0;15
7697;"Pumpurėlis (Kalvarijų g. 186)";VARPELIŲ;6780042929;Ne;0;20;0;20
7698;"Pumpurėlis (Kalvarijų g. 186)";VARPELIŲ;7182107790;Ne;8;0;0;8
7699;"Pumpurėlis (Kalvarijų g. 186)";VARPELIŲ;4629544683;Ne;6;1;0;7
7700;"Pumpurėlis (Kalvarijų g. 186)";VARPELIŲ;9224879966;Ne;0;0;4;4
7701;"Pumpurėlis (Kalvarijų g. 186)";DRUGELIŲ;5928552565;Ne;8;0;0;8
7702;"Pumpurėlis (Kalvarijų g. 186)";DRUGELIŲ;7055989095;Ne;0;11;0;11
7703;"Pumpurėlis (Kalvarijų g. 186)";DRUGELIŲ;7078621340;Ne;0;2;0;2
7704;"Pumpurėlis (Kalvarijų g. 186)";DRUGELIŲ;1538548768;Ne;7;0;0;7
7705;"Pumpurėlis (Kalvarijų g. 186)";DRUGELIŲ;2368226822;Ne;5;0;0;5
7706;"Pumpurėlis (Kalvarijų g. 186)";DRUGELIŲ;3088476130;Ne;0;0;1;1
7707;"Pumpurėlis (Kalvarijų g. 186)";DRUGELIŲ;9640790401;Taip;1;0;7;8
7708;"Pumpurėlis (Kalvarijų g. 186)";DRUGELIŲ;8320987208;Ne;9;0;0;9
7709;"Pumpurėlis (Kalvarijų g. 186)";DRUGELIŲ;7832408524;Ne;10;0;0;10
7710;"Pumpurėlis (Kalvarijų g. 186)";DRUGELIŲ;8644853849;Ne;0;7;0;7
7711;"Pumpurėlis (Kalvarijų g. 186)";DRUGELIŲ;9417688597;Ne;6;0;0;6
7712;"Pumpurėlis (Kalvarijų g. 186)";DRUGELIŲ;9032255874;Ne;11;0;3;14
7713;"Pumpurėlis (Kalvarijų g. 186)";DRUGELIŲ;9996789041;Ne;4;1;1;6
7714;"Pumpurėlis (Kalvarijų g. 186)";DRUGELIŲ;2684592319;Ne;6;0;0;6
7715;"Pumpurėlis (Kalvarijų g. 186)";DRUGELIŲ;5835115428;Ne;0;0;1;1
7716;"Pumpurėlis (Kalvarijų g. 186)";DRUGELIŲ;4506063812;Ne;4;3;0;7
7717;"Pumpurėlis (Kalvarijų g. 186)";DRUGELIŲ;2165141865;Ne;2;0;3;5
7718;"Pumpurėlis (Kalvarijų g. 186)";DRUGELIŲ;8671697745;Ne;0;0;5;5
7719;"Pumpurėlis (Kalvarijų g. 186)";DRUGELIŲ;3187815703;Ne;6;0;4;10
7720;"Pumpurėlis (Kalvarijų g. 186)";KODĖLČIUKŲ;8214602054;Ne;0;0;16;16
7721;"Pumpurėlis (Kalvarijų g. 186)";KODĖLČIUKŲ;5564844211;Ne;12;0;1;13
7722;"Pumpurėlis (Kalvarijų g. 186)";KODĖLČIUKŲ;1215117598;Ne;5;7;0;12
7723;"Pumpurėlis (Kalvarijų g. 186)";KODĖLČIUKŲ;6978091765;Ne;5;0;1;6
7724;"Pumpurėlis (Kalvarijų g. 186)";KODĖLČIUKŲ;6433757421;Ne;1;0;4;5
7725;"Pumpurėlis (Kalvarijų g. 186)";KODĖLČIUKŲ;3328647987;Ne;6;0;0;6
7726;"Pumpurėlis (Kalvarijų g. 186)";KODĖLČIUKŲ;3748601124;Ne;0;0;1;1
7727;"Pumpurėlis (Kalvarijų g. 186)";KODĖLČIUKŲ;4196409137;Ne;3;0;0;3
7728;"Pumpurėlis (Kalvarijų g. 186)";KODĖLČIUKŲ;8070486897;Ne;3;0;4;7
7729;"Pumpurėlis (Kalvarijų g. 186)";KODĖLČIUKŲ;2611141763;Ne;0;0;1;1
7730;"Pumpurėlis (Kalvarijų g. 186)";KODĖLČIUKŲ;2307819108;Ne;0;1;0;1
7731;"Pumpurėlis (Kalvarijų g. 186)";KODĖLČIUKŲ;9650395309;Ne;0;6;0;6
7732;"Pumpurėlis (Kalvarijų g. 186)";KODĖLČIUKŲ;3563609848;Ne;0;0;2;2
7733;"Pumpurėlis (Kalvarijų g. 186)";KODĖLČIUKŲ;6702744879;Ne;0;0;2;2
7734;"Pumpurėlis (Kalvarijų g. 186)";KODĖLČIUKŲ;2890596967;Ne;2;0;4;6
7735;"Pumpurėlis (Kalvarijų g. 186)";KODĖLČIUKŲ;9839285886;Taip;9;0;6;15
7736;"Pumpurėlis (Kalvarijų g. 186)";LINELIS;1017483419;Ne;0;1;0;1
7737;"Pumpurėlis (Kalvarijų g. 186)";LINELIS;6957047759;Ne;0;1;0;1
7738;"Pumpurėlis (Kalvarijų g. 186)";LINELIS;2468796972;Ne;0;11;0;11
7739;"Pumpurėlis (Kalvarijų g. 186)";LINELIS;1835168438;Ne;8;0;0;8
7740;"Pumpurėlis (Kalvarijų g. 186)";LINELIS;4344595328;Ne;6;3;0;9
7741;"Pumpurėlis (Kalvarijų g. 186)";LINELIS;9583257172;Ne;0;3;0;3
7742;"Pumpurėlis (Kalvarijų g. 186)";LINELIS;7533555059;Ne;0;1;0;1
7743;"Pumpurėlis (Kalvarijų g. 186)";LINELIS;8830261792;Ne;6;1;0;7
7744;"Pumpurėlis (Kalvarijų g. 186)";LINELIS;87061817106;Ne;0;1;0;1
7745;"Pumpurėlis (Kalvarijų g. 186)";LINELIS;8806961007;Ne;4;0;0;4
7746;"Pumpurėlis (Kalvarijų g. 186)";LINELIS;18928851032;Ne;0;1;0;1
7747;"Pumpurėlis (Kalvarijų g. 186)";LINELIS;8747439652;Ne;0;1;0;1
7748;"Pumpurėlis (Kalvarijų g. 186)";LINELIS;2629702959;Ne;0;3;0;3
7749;"Pumpurėlis (Kalvarijų g. 186)";LINELIS;5964953923;Ne;0;1;1;2
7750;"Pumpurėlis (Kalvarijų g. 186)";SAULUTĖS;5013491568;Ne;7;0;1;8
7751;"Pumpurėlis (Kalvarijų g. 186)";SAULUTĖS;6412442729;Ne;9;0;3;12
7752;"Pumpurėlis (Kalvarijų g. 186)";SAULUTĖS;2129779614;Ne;0;1;6;7
7753;"Pumpurėlis (Kalvarijų g. 186)";SAULUTĖS;1053338730;Ne;1;0;3;4
7754;"Pumpurėlis (Kalvarijų g. 186)";SAULUTĖS;7123915287;Ne;0;0;3;3
7755;"Pumpurėlis (Kalvarijų g. 186)";SAULUTĖS;1690424790;Ne;0;5;3;8
7756;"Pumpurėlis (Kalvarijų g. 186)";SAULUTĖS;1397924008;Ne;11;0;0;11
7757;"Pumpurėlis (Kalvarijų g. 186)";SAULUTĖS;6230500803;Ne;0;2;2;4
7758;"Pumpurėlis (Kalvarijų g. 186)";SAULUTĖS;1306102772;Ne;0;0;1;1
7759;"Pumpurėlis (Kalvarijų g. 186)";SAULUTĖS;1230058211;Ne;0;4;0;4
7760;"Pumpurėlis (Kalvarijų g. 186)";SAULUTĖS;25029630023;Ne;7;0;0;7
7761;"Pumpurėlis (Kalvarijų g. 186)";SAULUTĖS;6535398274;Ne;2;0;0;2
7762;"Pumpurėlis (Kalvarijų g. 186)";SAULUTĖS;9733380187;Ne;0;1;0;1
7763;"Pumpurėlis (Kalvarijų g. 186)";SAULUTĖS;2102427499;Ne;0;1;0;1
7764;"Pumpurėlis (Kalvarijų g. 186)";SAULUTĖS;1225377038;Ne;6;0;1;7
7765;"Pumpurėlis (Kalvarijų g. 186)";SAULUTĖS;9317495169;Ne;0;3;0;3
7766;"Pumpurėlis (Kalvarijų g. 186)";BITUTĖS;4419940231;Ne;8;0;0;8
7767;"Pumpurėlis (Kalvarijų g. 186)";BITUTĖS;4985045047;Taip;0;0;1;1
7768;"Pumpurėlis (Kalvarijų g. 186)";BITUTĖS;2651037375;Ne;8;0;0;8
7769;"Pumpurėlis (Kalvarijų g. 186)";BITUTĖS;1768239820;Ne;0;0;1;1
7770;"Pumpurėlis (Kalvarijų g. 186)";BITUTĖS;4426697956;Taip;3;0;2;5
7771;"Pumpurėlis (Kalvarijų g. 186)";BITUTĖS;7363814444;Ne;0;7;0;7
7772;"Pumpurėlis (Kalvarijų g. 186)";BITUTĖS;3405169131;Ne;2;0;1;3
7773;"Pumpurėlis (Kalvarijų g. 186)";BITUTĖS;3951445693;Ne;0;0;3;3
7774;"Pumpurėlis (Kalvarijų g. 186)";BITUTĖS;9612924316;Ne;0;9;0;9
7775;"Pumpurėlis (Kalvarijų g. 186)";BITUTĖS;5194285627;Taip;0;4;0;4
7776;"Pumpurėlis (Kalvarijų g. 186)";BITUTĖS;1714440337;Ne;0;0;1;1
7777;"Pumpurėlis (Kalvarijų g. 186)";BITUTĖS;8655389224;Ne;4;1;0;5
7778;"Pumpurėlis (Kalvarijų g. 186)";BITUTĖS;1674341906;Taip;0;0;1;1
7779;"Pumpurėlis (Kalvarijų g. 186)";BITUTĖS;1933502038;Ne;3;0;0;3
7780;"Pumpurėlis (Kalvarijų g. 186)";BITUTĖS;2230191718;Ne;3;0;0;3
7781;"Pumpurėlis (Kalvarijų g. 186)";BITUTĖS;7062090879;Ne;15;0;0;15
7782;"Pumpurėlis (Kalvarijų g. 186)";BITUTĖS;9245739052;Ne;0;0;2;2
7783;"Pumpurėlis (Kalvarijų g. 186)";BITUTĖS;8470433743;Ne;15;0;2;17
7784;"Pumpurėlis (Kalvarijų g. 186)";BITUTĖS;6474918016;Ne;9;0;1;10
7785;"Pumpurėlis (Kalvarijų g. 186)";DOBILIUKAI;9179780392;Ne;0;1;0;1
7786;"Pumpurėlis (Kalvarijų g. 186)";DOBILIUKAI;1839505206;Ne;0;9;0;9
7787;"Pumpurėlis (Kalvarijų g. 186)";DOBILIUKAI;3970253545;Ne;5;0;0;5
7788;"Pumpurėlis (Kalvarijų g. 186)";DOBILIUKAI;1808734330;Ne;0;1;0;1
7789;"Pumpurėlis (Kalvarijų g. 186)";DOBILIUKAI;6968264923;Ne;0;8;0;8
7790;"Pumpurėlis (Kalvarijų g. 186)";DOBILIUKAI;2700017433;Ne;0;5;1;6
7791;"Pumpurėlis (Kalvarijų g. 186)";DOBILIUKAI;7038597556;Ne;0;4;0;4
7792;"Pumpurėlis (Kalvarijų g. 186)";DOBILIUKAI;4130539703;Ne;0;1;0;1
7793;"Pumpurėlis (Kalvarijų g. 186)";DOBILIUKAI;3374174445;Ne;0;2;0;2
7794;"Pumpurėlis (Kalvarijų g. 186)";DOBILIUKAI;1961282282;Ne;0;0;3;3
7795;"Pumpurėlis (Kalvarijų g. 186)";DOBILIUKAI;7276322999;Ne;1;0;0;1
7796;"Pumpurėlis (Kalvarijų g. 186)";DOBILIUKAI;9058493247;Ne;2;1;0;3
7797;"Pumpurėlis (Kalvarijų g. 186)";DOBILIUKAI;3214652626;Ne;0;0;1;1
7798;"Pumpurėlis (Kalvarijų g. 186)";DOBILIUKAI;5444879430;Ne;2;1;2;5
7799;"Pumpurėlis (Kalvarijų g. 186)";DOBILIUKAI;7825190756;Ne;0;0;1;1
7800;"Pumpurėlis (Kalvarijų g. 186)";DOBILIUKAI;1438740562;Ne;1;0;0;1
7801;"Pumpurėlis (Kalvarijų g. 186)";DOBILIUKAI;9740660699;Ne;0;8;0;8
7802;"Pumpurėlis (Kalvarijų g. 186)";PUPYČIŲ;7652642088;Taip;0;0;1;1
7803;"Pumpurėlis (Kalvarijų g. 186)";PUPYČIŲ;9317274035;Ne;11;0;2;13
7804;"Pumpurėlis (Kalvarijų g. 186)";PUPYČIŲ;1555441484;Ne;11;0;2;13
7805;"Pumpurėlis (Kalvarijų g. 186)";PUPYČIŲ;9372725707;Ne;0;1;0;1
7806;"Pumpurėlis (Kalvarijų g. 186)";PUPYČIŲ;4249039048;Ne;0;2;2;4
7807;"Pumpurėlis (Kalvarijų g. 186)";PUPYČIŲ;1082775039;Ne;3;0;1;4
7808;"Pumpurėlis (Kalvarijų g. 186)";PUPYČIŲ;6982600785;Ne;8;0;2;10
7809;"Pumpurėlis (Kalvarijų g. 186)";PUPYČIŲ;1667602636;Ne;12;0;2;14
7810;"Pumpurėlis (Kalvarijų g. 186)";PUPYČIŲ;8212403350;Ne;0;2;0;2
7811;"Pumpurėlis (Kalvarijų g. 186)";PUPYČIŲ;1448399754;Ne;2;0;0;2
7812;"Pumpurėlis (Kalvarijų g. 186)";PUPYČIŲ;6795405194;Ne;8;0;0;8
7813;"Pumpurėlis (Kalvarijų g. 186)";PUPYČIŲ;7443152469;Ne;10;0;10;20
7814;"Pumpurėlis (Kalvarijų g. 186)";PUPYČIŲ;9306426978;Ne;0;0;5;5
7815;"Pumpurėlis (Kalvarijų g. 186)";PUPYČIŲ;3259416263;Ne;7;0;13;20
7816;"Pumpurėlis (Kalvarijų g. 186)";PUPYČIŲ;6939412463;Ne;4;0;0;4
7817;"Pumpurėlis (Kalvarijų g. 186)";PUPYČIŲ;2715059752;Ne;0;0;2;2
7818;"Pumpurėlis (Kalvarijų g. 186)";PUPYČIŲ;8458676611;Ne;0;9;11;20
7819;"Pumpurėlis (Kalvarijų g. 186)";ŽIRNIUKŲ;9903981454;Ne;8;0;0;8
7820;"Pumpurėlis (Kalvarijų g. 186)";ŽIRNIUKŲ;3537534154;Ne;0;4;0;4
7821;"Pumpurėlis (Kalvarijų g. 186)";ŽIRNIUKŲ;1782842327;Ne;16;0;0;16
7822;"Pumpurėlis (Kalvarijų g. 186)";ŽIRNIUKŲ;9478685443;Ne;0;1;1;2
7823;"Pumpurėlis (Kalvarijų g. 186)";ŽIRNIUKŲ;6647331393;Ne;0;0;6;6
7824;"Pumpurėlis (Kalvarijų g. 186)";ŽIRNIUKŲ;3001331278;Ne;16;0;0;16
7825;"Pumpurėlis (Kalvarijų g. 186)";ŽIRNIUKŲ;9735493140;Ne;11;0;3;14
7826;"Pumpurėlis (Kalvarijų g. 186)";ŽIRNIUKŲ;3964441086;Ne;14;0;0;14
7827;"Pumpurėlis (Kalvarijų g. 186)";ŽIRNIUKŲ;8550119831;Ne;17;0;0;17
7828;"Pumpurėlis (Kalvarijų g. 186)";ŽIRNIUKŲ;4245270154;Ne;11;0;0;11
7829;"Pumpurėlis (Kalvarijų g. 186)";ŽIRNIUKŲ;6860128064;Ne;13;1;0;14
7830;"Pumpurėlis (Kalvarijų g. 186)";ŽIRNIUKŲ;2282966743;Ne;0;0;1;1
7831;"Pumpurėlis (Kalvarijų g. 186)";ŽIRNIUKŲ;5968577443;Ne;5;0;1;6
7832;"Pumpurėlis (Kalvarijų g. 186)";ŽIRNIUKŲ;8083674991;Ne;5;1;2;8
7833;"Pumpurėlis (Kalvarijų g. 186)";ŽIRNIUKŲ;9750242149;Ne;7;0;1;8
7834;"Pumpurėlis (Kalvarijų g. 186)";ŽIRNIUKŲ;5420222684;Ne;0;1;0;1
7835;"Pumpurėlis (Kalvarijų g. 186)";ŽIRNIUKŲ;4198532140;Ne;4;1;1;6
7836;"Pumpurėlis (Kalvarijų g. 186)";ŽIRNIUKŲ;6422203618;Ne;11;0;0;11
7837;"Pumpurėlis (Kalvarijų g. 186)";BORUŽĖLIŲ;2269864490;Ne;9;0;0;9
7838;"Pumpurėlis (Kalvarijų g. 186)";BORUŽĖLIŲ;6223338814;Ne;10;0;0;10
7839;"Pumpurėlis (Kalvarijų g. 186)";BORUŽĖLIŲ;5659508302;Ne;3;0;3;6
7840;"Pumpurėlis (Kalvarijų g. 186)";BORUŽĖLIŲ;5998858670;Ne;11;0;0;11
7841;"Pumpurėlis (Kalvarijų g. 186)";BORUŽĖLIŲ;7398363498;Ne;10;0;0;10
7842;"Pumpurėlis (Kalvarijų g. 186)";BORUŽĖLIŲ;5835545051;Ne;6;6;0;12
7843;"Pumpurėlis (Kalvarijų g. 186)";BORUŽĖLIŲ;4188020534;Ne;0;0;1;1
7844;"Pumpurėlis (Kalvarijų g. 186)";BORUŽĖLIŲ;6256781298;Ne;4;2;1;7
7845;"Pumpurėlis (Kalvarijų g. 186)";BORUŽĖLIŲ;9136771401;Ne;7;0;1;8
7846;"Pumpurėlis (Kalvarijų g. 186)";BORUŽĖLIŲ;7045349032;Ne;13;0;1;14
7847;"Pumpurėlis (Kalvarijų g. 186)";BORUŽĖLIŲ;1017838338;Ne;14;0;0;14
7848;"Pumpurėlis (Kalvarijų g. 186)";BORUŽĖLIŲ;1648249689;Ne;5;0;1;6
7849;"Pumpurėlis (Kalvarijų g. 186)";BORUŽĖLIŲ;7535098093;Ne;0;0;3;3
7850;"Pumpurėlis (Kalvarijų g. 186)";BORUŽĖLIŲ;7843280418;Ne;15;0;0;15
7851;"Pumpurėlis (Kalvarijų g. 186)";BORUŽĖLIŲ;3531862496;Ne;12;0;0;12
7852;"Pumpurėlis (Kalvarijų g. 186)";BORUŽĖLIŲ;1441993078;Ne;11;0;1;12
7853;"Pumpurėlis (Kalvarijų g. 186)";BORUŽĖLIŲ;2768082342;Ne;5;0;0;5
7854;"Pumpurėlis (Kalvarijų g. 186)";BORUŽĖLIŲ;3407251558;Ne;5;0;1;6
7855;"Pumpurėlis (Kalvarijų g. 186)";BORUŽĖLIŲ;4355867863;Ne;0;0;2;2
7856;"Pumpurėlis (Kalvarijų g. 186)";SMALSUČIŲ;6212212516;Ne;0;1;0;1
7857;"Pumpurėlis (Kalvarijų g. 186)";SMALSUČIŲ;6604801631;Ne;0;0;3;3
7858;"Pumpurėlis (Kalvarijų g. 186)";SMALSUČIŲ;9363610488;Ne;1;0;0;1
7859;"Pumpurėlis (Kalvarijų g. 186)";SMALSUČIŲ;8380689261;Ne;0;0;1;1
7860;"Pumpurėlis (Kalvarijų g. 186)";SMALSUČIŲ;6483338028;Ne;11;0;0;11
7861;"Pumpurėlis (Kalvarijų g. 186)";SMALSUČIŲ;6959214331;Ne;6;2;1;9
7862;"Pumpurėlis (Kalvarijų g. 186)";SMALSUČIŲ;3085309902;Ne;0;0;3;3
7863;"Pumpurėlis (Kalvarijų g. 186)";SMALSUČIŲ;4964949574;Ne;3;0;1;4
7864;"Pumpurėlis (Kalvarijų g. 186)";SMALSUČIŲ;2905797053;Ne;4;5;0;9
7865;"Pumpurėlis (Kalvarijų g. 186)";SMALSUČIŲ;3871151401;Ne;14;0;0;14
7866;"Pumpurėlis (Kalvarijų g. 186)";SMALSUČIŲ;6557857672;Ne;9;0;0;9
7867;"Pumpurėlis (Kalvarijų g. 186)";SMALSUČIŲ;6614797909;Ne;0;0;2;2
7868;"Pumpurėlis (Kalvarijų g. 186)";SMALSUČIŲ;7813696919;Ne;0;0;2;2
7869;"Pumpurėlis (Kalvarijų g. 186)";SMALSUČIŲ;5278250113;Ne;0;0;3;3
7870;"Pumpurėlis (Kalvarijų g. 186)";SMALSUČIŲ;5236515914;Ne;5;0;1;6
7871;"Pumpurėlis (Kalvarijų g. 186)";SMALSUČIŲ;5456922203;Ne;1;0;2;3
7872;Puriena;Ančiukų;1658720269;Ne;8;0;0;8
7873;Puriena;Ančiukų;6158842119;Ne;0;10;0;10
7874;Puriena;Ančiukų;4100466337;Ne;6;0;1;7
7875;Puriena;Ančiukų;4060087185;Ne;0;9;6;15
7876;Puriena;Ančiukų;6280465748;Ne;5;1;0;6
7877;Puriena;Ančiukų;3033562627;Ne;0;11;0;11
7878;Puriena;Ančiukų;5777076971;Ne;0;10;0;10
7879;Puriena;Ančiukų;8310231540;Ne;0;3;2;5
7880;Puriena;Ančiukų;4460575818;Ne;0;5;0;5
7881;Puriena;Ančiukų;7967288875;Ne;6;0;1;7
7882;Puriena;Ančiukų;1907429094;Ne;4;0;0;4
7883;Puriena;Ančiukų;4605662701;Ne;0;3;0;3
7884;Puriena;Ančiukų;1819876614;Ne;9;0;2;11
7885;Puriena;Ančiukų;4776745276;Ne;0;1;0;1
7886;Puriena;Ančiukų;6496291933;Ne;0;6;1;7
7887;Puriena;Ančiukų;7769252165;Ne;0;2;0;2
7888;Puriena;Ančiukų;2170025682;Ne;1;0;0;1
7889;Puriena;Drugeliai;2966464432;Ne;1;1;0;2
7890;Puriena;Drugeliai;4760827000;Ne;0;0;1;1
7891;Puriena;Drugeliai;4812271011;Ne;0;20;0;20
7892;Puriena;Drugeliai;1521955898;Ne;0;4;1;5
7893;Puriena;Drugeliai;8881337164;Ne;0;4;0;4
7894;Puriena;Drugeliai;5478026060;Ne;0;0;1;1
7895;Puriena;Drugeliai;8159342676;Ne;3;0;2;5
7896;Puriena;Drugeliai;2321753665;Ne;10;0;0;10
7897;Puriena;Drugeliai;7021756459;Ne;14;2;2;18
7898;Puriena;Drugeliai;1564155036;Ne;0;1;3;4
7899;Puriena;Drugeliai;9098291788;Ne;0;3;0;3
7900;Puriena;Drugeliai;6613654824;Ne;0;3;1;4
7901;Puriena;Drugeliai;3738277048;Ne;1;5;0;6
7902;Puriena;Drugeliai;7562458336;Ne;0;0;1;1
7903;Puriena;Drugeliai;3579008577;Ne;9;0;3;12
7904;Puriena;Drugeliai;4248701232;Taip;28;0;1;29
7905;Puriena;Drugeliai;7477278612;Ne;0;5;0;5
7906;Puriena;Drugeliai;9847768390;Ne;0;9;4;13
7907;Puriena;Drugeliai;1455237224;Ne;0;1;0;1
7908;Puriena;Drugeliai;6212693015;Ne;20;0;0;20
7909;Puriena;Drugeliai;5593526943;Ne;0;1;0;1
7910;Puriena;Pelėdžiukai;8874823029;Ne;0;0;2;2
7911;Puriena;Pelėdžiukai;3149718901;Ne;0;2;3;5
7912;Puriena;Pelėdžiukai;3175917649;Ne;0;0;4;4
7913;Puriena;Pelėdžiukai;5619637663;Ne;0;2;2;4
7914;Puriena;Pelėdžiukai;8061605125;Ne;6;1;0;7
7915;Puriena;Pelėdžiukai;2579402981;Ne;5;0;1;6
7916;Puriena;Pelėdžiukai;2701942325;Ne;0;7;0;7
7917;Puriena;Pelėdžiukai;2267225709;Taip;0;6;0;6
7918;Puriena;Pelėdžiukai;6413337915;Ne;0;0;3;3
7919;Puriena;Pelėdžiukai;4858971990;Ne;8;0;0;8
7920;Puriena;Pelėdžiukai;1417566073;Ne;7;1;1;9
7921;Puriena;Pelėdžiukai;6463129806;Ne;1;0;0;1
7922;Puriena;Pelėdžiukai;5341228269;Ne;0;4;0;4
7923;Puriena;Pelėdžiukai;6352605894;Ne;0;0;1;1
7924;Puriena;Pelėdžiukai;6786694796;Ne;0;0;9;9
7925;Puriena;Pelėdžiukai;5080805225;Ne;11;0;1;12
7926;Puriena;Voveriukai;9911792407;Ne;19;0;0;19
7927;Puriena;Voveriukai;3826282438;Ne;6;0;0;6
7928;Puriena;Voveriukai;9453994213;Ne;7;0;0;7
7929;Puriena;Voveriukai;8497070167;Taip;11;2;1;14
7930;Puriena;Voveriukai;4517020977;Ne;1;0;1;2
7931;Puriena;Voveriukai;4283608124;Ne;0;1;0;1
7932;Puriena;Voveriukai;8144488922;Ne;15;0;0;15
7933;Puriena;Voveriukai;8476986855;Ne;0;4;0;4
7934;Puriena;Voveriukai;3627403517;Ne;9;0;3;12
7935;Puriena;Voveriukai;7120683581;Ne;0;1;0;1
7936;Puriena;Voveriukai;4653085762;Ne;0;10;0;10
7937;Puriena;Voveriukai;3542374463;Ne;1;1;2;4
7938;Puriena;Voveriukai;1933733714;Ne;0;2;0;2
7939;Puriena;Voveriukai;6150437624;Ne;0;2;0;2
7940;Puriena;Voveriukai;8772936125;Ne;0;0;9;9
7941;Puriena;Voveriukai;6428413592;Ne;14;0;0;14
7942;Puriena;Voveriukai;8242140541;Ne;6;0;2;8
7943;Puriena;Voveriukai;4498919764;Ne;7;0;2;9
7944;Puriena;Voveriukai;6140294839;Ne;7;0;1;8
7945;Puriena;Voveriukai;3455291312;Ne;0;5;0;5
7946;Puriena;Bitučių;1621772702;Ne;1;0;1;2
7947;Puriena;Bitučių;9413672989;Ne;0;0;8;8
7948;Puriena;Bitučių;5224135638;Ne;12;1;0;13
7949;Puriena;Bitučių;1175665781;Ne;3;0;4;7
7950;Puriena;Bitučių;6853706997;Ne;0;5;0;5
7951;Puriena;Bitučių;9962011647;Ne;0;0;13;13
7952;Puriena;Bitučių;1339162214;Ne;0;2;9;11
7953;Puriena;Bitučių;9543884311;Ne;0;9;0;9
7954;Puriena;Bitučių;8022809059;Ne;6;0;0;6
7955;Puriena;Bitučių;5395382717;Ne;0;2;0;2
7956;Puriena;Bitučių;8237149969;Ne;0;1;0;1
7957;Puriena;Bitučių;7481642656;Ne;0;20;0;20
7958;Puriena;Bitučių;8512814466;Ne;0;5;0;5
7959;Puriena;Bitučių;7622407056;Ne;4;0;0;4
7960;Puriena;Bitučių;4017644414;Ne;1;1;0;2
7961;Puriena;Bitučių;8416003733;Ne;0;6;3;9
7962;Puriena;Bitučių;8199607793;Ne;0;0;4;4
7963;Puriena;Bitučių;9854244405;Ne;0;7;0;7
7964;Puriena;Bitučių;6780164845;Ne;6;0;5;11
7965;Puriena;Zylutės;7337038503;Ne;0;5;0;5
7966;Puriena;Zylutės;5891404983;Ne;0;2;0;2
7967;Puriena;Zylutės;63196502622;Ne;0;5;0;5
7968;Puriena;Zylutės;9239618299;Ne;10;14;0;24
7969;Puriena;Zylutės;2083071198;Ne;0;7;0;7
7970;Puriena;Zylutės;20286870431;Ne;15;1;0;16
7971;Puriena;Zylutės;8618298134;Ne;17;0;0;17
7972;Puriena;Zylutės;1748337587;Ne;0;1;0;1
7973;Puriena;Zylutės;1820719083;Ne;9;0;0;9
7974;Puriena;Zylutės;11497629767;Ne;0;7;0;7
7975;Puriena;Zylutės;2146036332;Ne;8;0;0;8
7976;Puriena;Zylutės;2378865002;Ne;0;2;0;2
7977;Puriena;Zylutės;2131343339;Ne;6;0;0;6
7978;Puriena;Zylutės;8213725698;Ne;32;0;0;32
7979;Puriena;Zylutės;48468411549;Ne;0;4;0;4
7980;Puriena;Zylutės;1703078658;Ne;4;2;0;6
7981;Puriena;Zylutės;6416145396;Ne;10;0;0;10
7982;Puriena;Zylutės;3031725530;Ne;3;4;1;8
7983;Puriena;Zylutės;6813480086;Ne;15;1;0;16
7984;Puriena;Meškučių;6234132927;Ne;12;1;0;13
7985;Puriena;Meškučių;9500729561;Ne;0;2;2;4
7986;Puriena;Meškučių;9748726934;Ne;11;0;0;11
7987;Puriena;Meškučių;5323549829;Ne;0;2;0;2
7988;Puriena;Meškučių;2466609635;Ne;6;1;0;7
7989;Puriena;Meškučių;3309219271;Ne;0;1;0;1
7990;Puriena;Meškučių;5176663365;Ne;7;0;0;7
7991;Puriena;Meškučių;9961074983;Ne;0;1;0;1
7992;Puriena;Meškučių;3011629747;Ne;6;0;0;6
7993;Puriena;Meškučių;2029981617;Ne;0;1;0;1
7994;Puriena;Meškučių;6185080390;Ne;14;2;0;16
7995;Puriena;Meškučių;3526684967;Ne;0;2;0;2
7996;Puriena;Meškučių;1513909923;Ne;6;0;7;13
7997;Puriena;Meškučių;7556975480;Ne;9;1;5;15
7998;Puriena;Meškučių;2711642252;Taip;2;0;0;2
7999;Puriena;Meškučių;8093664167;Taip;5;0;0;5
8000;Puriena;Nykštukų;1053386081;Ne;0;0;3;3
8001;Puriena;Nykštukų;5469827031;Taip;16;0;0;16
8002;Puriena;Nykštukų;7649596096;Taip;14;0;6;20
8003;Puriena;Nykštukų;2762325241;Ne;11;1;4;16
8004;Puriena;Nykštukų;9907142348;Ne;8;0;6;14
8005;Puriena;Nykštukų;9369786639;Ne;7;0;0;7
8006;Puriena;Nykštukų;4728991133;Ne;0;0;2;2
8007;Puriena;Nykštukų;2344061847;Ne;9;1;0;10
8008;Puriena;Nykštukų;3630564604;Ne;8;1;0;9
8009;Puriena;Nykštukų;9438604106;Ne;0;0;1;1
8010;Puriena;Nykštukų;9379314578;Ne;20;0;0;20
8011;Puriena;Nykštukų;4211784186;Taip;9;0;0;9
8012;Puriena;Nykštukų;1610219365;Taip;17;0;0;17
8013;Puriena;Nykštukų;2146727759;Ne;0;2;3;5
8014;Puriena;Nykštukų;1988826809;Ne;0;0;2;2
8015;Puriena;Nykštukų;6271951373;Ne;4;0;0;4
8016;Puriena;Nykštukų;7869104640;Ne;3;5;0;8
8017;Puriena;Ežiukai;6612468095;Ne;4;1;0;5
8018;Puriena;Ežiukai;7913847170;Ne;0;1;1;2
8019;Puriena;Ežiukai;8089081251;Ne;19;0;0;19
8020;Puriena;Ežiukai;2830409862;Ne;0;7;0;7
8021;Puriena;Ežiukai;5550321808;Ne;32;0;0;32
8022;Puriena;Ežiukai;8038573068;Ne;0;2;0;2
8023;Puriena;Ežiukai;2624283930;Ne;0;5;0;5
8024;Puriena;Ežiukai;6001659356;Ne;9;0;0;9
8025;Puriena;Ežiukai;5539708916;Ne;17;1;0;18
8026;Puriena;Ežiukai;3204824116;Ne;5;0;0;5
8027;Puriena;Ežiukai;4954787474;Ne;0;2;3;5
8028;Puriena;Ežiukai;7720549981;Ne;11;9;0;20
8029;Puriena;Ežiukai;2312297583;Ne;8;0;1;9
8030;Puriena;Ežiukai;3232981406;Ne;14;0;0;14
8031;Puriena;Ežiukai;9228372078;Ne;16;0;0;16
8032;Puriena;Ežiukai;5374864513;Ne;5;0;0;5
8033;Puriena;"Boružiukų ";9600515308;Ne;20;0;0;20
8034;Puriena;"Boružiukų ";7985332838;Ne;0;20;0;20
8035;Puriena;"Boružiukų ";9671916745;Ne;1;0;0;1
8036;Puriena;"Boružiukų ";8195902319;Ne;0;1;2;3
8037;Puriena;"Boružiukų ";4587892949;Ne;12;0;4;16
8038;Puriena;"Boružiukų ";9497287421;Ne;0;20;0;20
8039;Puriena;"Boružiukų ";2818282875;Ne;0;1;1;2
8040;Puriena;"Boružiukų ";3215364967;Ne;0;5;4;9
8041;Puriena;"Boružiukų ";7016498639;Ne;0;0;1;1
8042;Puriena;"Boružiukų ";5797970231;Ne;0;4;0;4
8043;Puriena;"Boružiukų ";3382737176;Ne;7;0;0;7
8044;Puriena;"Boružiukų ";8110665629;Ne;0;2;0;2
8045;Puriena;"Boružiukų ";4006267650;Ne;8;8;0;16
8046;Puriena;"Boružiukų ";3440488785;Ne;2;0;4;6
8047;Puriena;"Boružiukų ";4016228982;Ne;9;0;0;9
8048;Puriena;"Boružiukų ";1796123753;Ne;7;0;0;7
8049;Puriena;"Boružiukų ";5277351784;Ne;9;0;0;9
8050;Puriena;"Boružiukų ";9931397038;Ne;27;0;0;27
8051;Puriena;"Zuikučių ";9907972536;Taip;0;1;0;1
8052;Puriena;"Zuikučių ";4165800035;Ne;6;0;2;8
8053;Puriena;"Zuikučių ";7634536770;Ne;0;5;3;8
8054;Puriena;"Zuikučių ";9423229931;Ne;0;4;0;4
8055;Puriena;"Zuikučių ";8284860687;Ne;0;2;0;2
8056;Puriena;"Zuikučių ";7334787183;Ne;0;1;2;3
8057;Puriena;"Zuikučių ";9176303276;Ne;14;6;5;25
8058;Puriena;"Zuikučių ";6941251095;Ne;19;0;0;19
8059;Puriena;"Zuikučių ";4193710604;Ne;0;6;0;6
8060;Puriena;"Zuikučių ";8474426340;Ne;0;0;3;3
8061;Puriena;"Zuikučių ";6227990580;Ne;10;0;0;10
8062;Puriena;"Zuikučių ";2172109284;Ne;7;0;0;7
8063;Puriena;"Zuikučių ";8239919265;Taip;1;0;1;2
8064;Puriena;"Zuikučių ";3094722037;Ne;0;2;0;2
8065;Puriena;"Zuikučių ";6308393533;Ne;0;2;4;6
8066;Puriena;"Zuikučių ";5927216569;Ne;0;0;3;3
8067;Puriena;Skruzdėliukai;2203259310;Ne;0;4;0;4
8068;Puriena;Skruzdėliukai;8478901457;Ne;0;1;0;1
8069;Puriena;Skruzdėliukai;4647433927;Ne;0;20;0;20
8070;Puriena;Skruzdėliukai;5257713434;Ne;0;20;0;20
8071;Puriena;Skruzdėliukai;11242620566;Ne;9;0;0;9
8072;Puriena;Skruzdėliukai;6285846517;Ne;0;1;0;1
8073;Puriena;Skruzdėliukai;9139110598;Ne;0;1;0;1
8074;Puriena;Skruzdėliukai;5501308683;Ne;4;3;0;7
8075;Puriena;Skruzdėliukai;2663832596;Ne;6;0;1;7
8076;Puriena;Skruzdėliukai;6057477307;Ne;1;0;7;8
8077;Puriena;Skruzdėliukai;1381379515;Ne;0;1;0;1
8078;Puriena;Skruzdėliukai;1290962809;Ne;0;2;0;2
8079;Puriena;Skruzdėliukai;1263637124;Ne;0;4;0;4
8080;Puriena;Skruzdėliukai;1290933817;Ne;0;0;1;1
8081;Pušaitė;Kodėlčiukai;3832434608;Ne;0;9;1;10
8082;Pušaitė;Kodėlčiukai;7068451014;Ne;0;1;0;1
8083;Pušaitė;Kodėlčiukai;6275090953;Ne;1;0;0;1
8084;Pušaitė;Kodėlčiukai;4198571222;Ne;3;0;2;5
8085;Pušaitė;Kodėlčiukai;4743105731;Ne;15;0;0;15
8086;Pušaitė;Kodėlčiukai;9391350218;Ne;0;5;0;5
8087;Pušaitė;Kodėlčiukai;2793941689;Ne;10;0;0;10
8088;Pušaitė;Kodėlčiukai;9364887123;Ne;0;1;0;1
8089;Pušaitė;Kodėlčiukai;4326967247;Ne;1;1;0;2
8090;Pušaitė;Kodėlčiukai;5922053969;Ne;1;0;0;1
8091;Pušaitė;Kodėlčiukai;4473930703;Ne;0;2;0;2
8092;Pušaitė;Kodėlčiukai;6775428321;Ne;0;7;0;7
8093;Pušaitė;Kodėlčiukai;4615270419;Ne;0;2;0;2
8094;Pušaitė;Kodėlčiukai;7117784038;Ne;6;2;0;8
8095;Pušaitė;Kodėlčiukai;2253477550;Ne;1;4;0;5
8096;Pušaitė;Kodėlčiukai;6186545163;Ne;0;3;2;5
8097;Pušaitė;Kodėlčiukai;6115556675;Ne;9;0;0;9
8098;Pušaitė;Saulutės;4511258460;Ne;12;0;1;13
8099;Pušaitė;Saulutės;5422616450;Ne;0;2;1;3
8100;Pušaitė;Saulutės;8931688329;Ne;14;0;0;14
8101;Pušaitė;Saulutės;5981944481;Ne;5;1;0;6
8102;Pušaitė;Saulutės;2254269292;Ne;0;0;13;13
8103;Pušaitė;Saulutės;5306237557;Ne;18;0;0;18
8104;Pušaitė;Saulutės;4234318548;Ne;0;0;5;5
8105;Pušaitė;Saulutės;4883211957;Ne;0;20;0;20
8106;Pušaitė;Saulutės;1384820994;Ne;1;1;7;9
8107;Pušaitė;Saulutės;8355083823;Ne;0;0;5;5
8108;Pušaitė;Saulutės;7291412329;Ne;8;0;0;8
8109;Pušaitė;Saulutės;2543188867;Ne;4;0;0;4
8110;Pušaitė;Saulutės;9577925438;Ne;1;0;0;1
8111;Pušaitė;Saulutės;8914668904;Ne;10;0;0;10
8112;Pušaitė;Zuikučiai;2115591523;Ne;2;0;4;6
8113;Pušaitė;Zuikučiai;8738827821;Ne;0;2;3;5
8114;Pušaitė;Zuikučiai;7477429922;Ne;0;4;0;4
8115;Pušaitė;Zuikučiai;2099169654;Ne;0;0;1;1
8116;Pušaitė;Zuikučiai;6355379926;Ne;1;1;0;2
8117;Pušaitė;Zuikučiai;80743691769;Ne;1;0;0;1
8118;Pušaitė;Zuikučiai;1296700534;Ne;0;1;0;1
8119;Pušaitė;Zuikučiai;51500717235;Ne;1;1;0;2
8120;Pušaitė;Zuikučiai;5398532705;Ne;0;0;4;4
8121;Pušaitė;Zuikučiai;1295203136;Ne;2;0;0;2
8122;Pušaitė;Zuikučiai;2944418714;Ne;19;0;0;19
8123;Pušaitė;Zuikučiai;3813761666;Ne;15;0;2;17
8124;Pušaitė;Zuikučiai;4762094720;Ne;2;2;1;5
8125;Pušaitė;Zuikučiai;6600314608;Ne;5;0;0;5
8126;Pušaitė;Zuikučiai;2130767942;Ne;1;5;0;6
8127;Pušaitė;Zuikučiai;9179757395;Ne;6;0;6;12
8128;Pušaitė;Zuikučiai;8592426606;Ne;0;5;0;5
8129;Pušaitė;Zuikučiai;7251064118;Ne;0;0;7;7
8130;Pušaitė;Vėžliukai;1326581025;Ne;0;11;0;11
8131;Pušaitė;Vėžliukai;8135552679;Ne;7;0;1;8
8132;Pušaitė;Vėžliukai;5161142520;Ne;6;0;1;7
8133;Pušaitė;Vėžliukai;3485234259;Ne;5;2;0;7
8134;Pušaitė;Vėžliukai;3014867515;Ne;7;0;0;7
8135;Pušaitė;Vėžliukai;9414554800;Ne;5;0;0;5
8136;Pušaitė;Vėžliukai;9470667227;Ne;0;3;0;3
8137;Pušaitė;Vėžliukai;7936991925;Taip;2;0;0;2
8138;Pušaitė;Vėžliukai;3014180020;Ne;0;0;4;4
8139;Pušaitė;Vėžliukai;7890577174;Ne;5;2;0;7
8140;Pušaitė;Vėžliukai;7652706756;Ne;3;2;0;5
8141;Pušaitė;Vėžliukai;5318602924;Ne;3;2;0;5
8142;Pušaitė;Vėžliukai;6794867560;Ne;4;0;0;4
8143;Pušaitė;Vėžliukai;5296435012;Ne;0;0;4;4
8144;Pušaitė;Vėžliukai;5512786073;Ne;9;2;0;11
8145;Pušaitė;Vėžliukai;8399589954;Ne;0;2;0;2
8146;Pušaitė;Vėžliukai;4281125486;Ne;7;2;0;9
8147;Pušaitė;Vėžliukai;2777222076;Ne;15;6;0;21
8148;Pušaitė;Vėžliukai;8459530338;Ne;0;9;0;9
8149;Pušaitė;"Linksmieji nykštukai";9265357004;Ne;0;3;0;3
8150;Pušaitė;"Linksmieji nykštukai";3150144924;Ne;6;2;0;8
8151;Pušaitė;"Linksmieji nykštukai";4517181474;Ne;3;2;0;5
8152;Pušaitė;"Linksmieji nykštukai";9033615485;Ne;0;2;0;2
8153;Pušaitė;"Linksmieji nykštukai";3130824742;Ne;0;1;0;1
8154;Pušaitė;"Linksmieji nykštukai";4605161267;Taip;10;1;8;19
8155;Pušaitė;"Linksmieji nykštukai";1024996364;Ne;2;0;0;2
8156;Pušaitė;"Linksmieji nykštukai";4662871524;Ne;4;1;0;5
8157;Pušaitė;"Linksmieji nykštukai";8438652029;Ne;6;0;2;8
8158;Pušaitė;"Linksmieji nykštukai";6578483902;Ne;10;0;0;10
8159;Pušaitė;"Linksmieji nykštukai";3350461304;Ne;4;0;0;4
8160;Pušaitė;"Linksmieji nykštukai";3788392895;Ne;0;1;0;1
8161;Pušaitė;"Linksmieji nykštukai";3195191374;Ne;5;0;0;5
8162;Pušaitė;"Linksmieji nykštukai";5422784898;Ne;0;4;0;4
8163;Pušaitė;"Linksmieji nykštukai";5104111840;Ne;0;4;1;5
8164;Pušaitė;"Linksmieji nykštukai";9866431097;Ne;1;2;0;3
8165;Pušaitė;"Linksmieji nykštukai";4564478833;Ne;7;0;0;7
8166;Pušaitė;"Linksmieji nykštukai";4374232593;Ne;1;2;0;3
8167;Pušaitė;"Linksmieji nykštukai";8378313810;Ne;3;1;0;4
8168;Pušaitė;"Kačiukų trobelė";3695016765;Ne;0;0;3;3
8169;Pušaitė;"Kačiukų trobelė";7983115812;Ne;0;2;0;2
8170;Pušaitė;"Kačiukų trobelė";1122112207;Ne;0;2;0;2
8171;Pušaitė;"Kačiukų trobelė";1635528919;Ne;0;0;7;7
8172;Pušaitė;"Kačiukų trobelė";2837439334;Ne;2;0;0;2
8173;Pušaitė;"Kačiukų trobelė";7014914682;Ne;0;4;0;4
8174;Pušaitė;"Kačiukų trobelė";8793102437;Ne;2;8;1;11
8175;Pušaitė;"Kačiukų trobelė";9056933586;Ne;14;0;0;14
8176;Pušaitė;"Kačiukų trobelė";6323180798;Ne;0;1;1;2
8177;Pušaitė;"Kačiukų trobelė";5191894075;Ne;0;1;0;1
8178;Pušaitė;"Kačiukų trobelė";1161519408;Ne;5;1;0;6
8179;Pušaitė;"Kačiukų trobelė";8822285103;Ne;0;1;0;1
8180;Pušaitė;"Kačiukų trobelė";9313564235;Ne;0;2;0;2
8181;Pušaitė;"Kačiukų trobelė";2865062081;Ne;0;0;3;3
8182;Pušaitė;"Kačiukų trobelė";1978339054;Ne;6;0;0;6
8183;Pušaitė;"Kačiukų trobelė";6189116357;Ne;14;0;2;16
8184;Pušaitė;Ežiukai;2951618391;Ne;7;2;0;9
8185;Pušaitė;Ežiukai;9524002395;Ne;0;2;1;3
8186;Pušaitė;Ežiukai;1111143593;Ne;9;0;3;12
8187;Pušaitė;Ežiukai;5394378197;Ne;0;0;1;1
8188;Pušaitė;Ežiukai;1143122778;Ne;0;9;0;9
8189;Pušaitė;Ežiukai;9461292576;Ne;0;4;0;4
8190;Pušaitė;Ežiukai;5185787803;Ne;0;0;1;1
8191;Pušaitė;Ežiukai;4671293211;Ne;5;0;0;5
8192;Pušaitė;Ežiukai;4101326122;Ne;3;0;0;3
8193;Pušaitė;Ežiukai;2983890410;Ne;2;0;0;2
8194;Pušaitė;Ežiukai;7808186865;Ne;0;9;0;9
8195;Pušaitė;Ežiukai;4842783897;Ne;0;0;3;3
8196;Pušaitė;Ežiukai;6472169278;Ne;0;2;0;2
8197;Pušaitė;Ežiukai;8021494509;Ne;6;0;0;6
8198;Pušaitė;Ežiukai;8309000712;Ne;0;4;2;6
8199;Pušaitė;"Gudručių šalis";2321256048;Ne;0;1;0;1
8200;Pušaitė;"Gudručių šalis";1305526154;Ne;13;1;0;14
8201;Pušaitė;"Gudručių šalis";6205900423;Ne;0;20;0;20
8202;Pušaitė;"Gudručių šalis";2078734161;Ne;0;0;4;4
8203;Pušaitė;"Gudručių šalis";8790959900;Ne;3;2;0;5
8204;Pušaitė;"Gudručių šalis";2397106198;Ne;0;1;0;1
8205;Pušaitė;"Gudručių šalis";3694667637;Ne;1;0;0;1
8206;Pušaitė;"Gudručių šalis";4101285889;Ne;0;0;7;7
8207;Pušaitė;"Gudručių šalis";3959838346;Ne;7;0;0;7
8208;Pušaitė;"Gudručių šalis";6356263503;Ne;2;0;2;4
8209;Pušaitė;"Gudručių šalis";2333176054;Ne;0;2;0;2
8210;Pušaitė;"Gudručių šalis";7066207306;Ne;6;0;0;6
8211;Pušaitė;"Gudručių šalis";4918124423;Ne;6;0;4;10
8212;Pušaitė;"Gudručių šalis";6734504906;Ne;10;0;0;10
8213;Pušaitė;"Gudručių šalis";7992567219;Ne;1;0;2;3
8214;Pušaitė;"Gudručių šalis";1807432967;Ne;0;0;2;2
8215;Pušaitė;"Lapučių mokyklėlė";9337726482;Ne;0;2;0;2
8216;Pušaitė;"Lapučių mokyklėlė";5139525557;Taip;0;4;1;5
8217;Pušaitė;"Lapučių mokyklėlė";2666541612;Ne;5;2;0;7
8218;Pušaitė;"Lapučių mokyklėlė";8343225451;Ne;4;3;0;7
8219;Pušaitė;"Lapučių mokyklėlė";1994898058;Ne;0;20;0;20
8220;Pušaitė;"Lapučių mokyklėlė";8551426938;Ne;5;2;0;7
8221;Pušaitė;"Lapučių mokyklėlė";4444972517;Ne;12;1;0;13
8222;Pušaitė;"Lapučių mokyklėlė";7615253880;Ne;14;0;0;14
8223;Pušaitė;"Lapučių mokyklėlė";4508356130;Ne;6;1;0;7
8224;Pušaitė;"Lapučių mokyklėlė";4138386134;Ne;4;0;0;4
8225;Pušaitė;"Lapučių mokyklėlė";4103149433;Ne;0;2;0;2
8226;Pušaitė;"Lapučių mokyklėlė";3387165403;Ne;9;0;0;9
8227;Pušaitė;"Lapučių mokyklėlė";5281161835;Ne;0;0;4;4
8228;Pušaitė;"Lapučių mokyklėlė";5339878948;Ne;6;2;0;8
8229;Pušaitė;"Lapučių mokyklėlė";3610256789;Ne;16;0;0;16
8230;Pušaitė;"Lapučių mokyklėlė";6576647982;Ne;0;0;4;4
8231;Pušaitė;"Lapučių mokyklėlė";1395577340;Ne;0;6;0;6
8232;Pušaitė;"Lapučių mokyklėlė";1534764228;Ne;0;1;0;1
8233;Pušaitė;"Lapučių mokyklėlė";5328083339;Ne;3;0;0;3
8234;Pušaitė;"Lapučių mokyklėlė";3200968850;Ne;0;11;0;11
8235;Pušaitė;"VOVERIUKAI ";6767281906;Ne;0;6;0;6
8236;Pušaitė;"VOVERIUKAI ";3732377309;Ne;2;0;0;2
8237;Pušaitė;"VOVERIUKAI ";5270528758;Ne;4;0;0;4
8238;Pušaitė;"VOVERIUKAI ";4344634837;Ne;0;20;0;20
8239;Pušaitė;"VOVERIUKAI ";1665030028;Taip;14;0;0;14
8240;Pušaitė;"VOVERIUKAI ";4769806128;Ne;7;0;0;7
8241;Pušaitė;"VOVERIUKAI ";6511940816;Ne;0;20;0;20
8242;Pušaitė;"VOVERIUKAI ";4818407739;Ne;13;0;0;13
8243;Pušaitė;"VOVERIUKAI ";8876092901;Ne;0;0;6;6
8244;Pušaitė;"VOVERIUKAI ";9546541248;Ne;4;0;0;4
8245;Pušaitė;"VOVERIUKAI ";4767321724;Ne;10;0;0;10
8246;Pušaitė;"VOVERIUKAI ";1542239525;Ne;3;0;0;3
8247;Pušaitė;"VOVERIUKAI ";4529006786;Ne;7;0;0;7
8248;Pušaitė;MEŠKUČIAI;5002710062;Taip;12;3;0;15
8249;Pušaitė;MEŠKUČIAI;9872317190;Ne;3;0;2;5
8250;Pušaitė;MEŠKUČIAI;3052743933;Ne;0;20;0;20
8251;Pušaitė;MEŠKUČIAI;3646346787;Taip;0;20;0;20
8252;Pušaitė;MEŠKUČIAI;6754402783;Taip;0;20;0;20
8253;Pušaitė;MEŠKUČIAI;9180309936;Ne;15;2;0;17
8254;Pušaitė;MEŠKUČIAI;4754791489;Ne;2;6;0;8
8255;Pušaitė;MEŠKUČIAI;2264047794;Ne;5;2;1;8
8256;Pušaitė;MEŠKUČIAI;4278699624;Ne;3;2;2;7
8257;Pušaitė;MEŠKUČIAI;8244793037;Ne;5;2;6;13
8258;Pušaitė;MEŠKUČIAI;3508664946;Ne;0;1;0;1
8259;Pušaitė;MEŠKUČIAI;3239486674;Ne;11;0;0;11
8260;Pušaitė;MEŠKUČIAI;2887576870;Ne;4;0;0;4
8261;Pušaitė;MEŠKUČIAI;7583243031;Ne;0;0;4;4
8262;Pušaitė;MEŠKUČIAI;9418440677;Ne;0;4;2;6
8263;Pušaitė;MEŠKUČIAI;4082173648;Ne;0;6;0;6
8264;Pušaitė;PELIUKAI;9177861202;Ne;8;1;6;15
8265;Pušaitė;PELIUKAI;9164927041;Ne;0;20;0;20
8266;Pušaitė;PELIUKAI;2454348536;Ne;0;0;6;6
8267;Pušaitė;PELIUKAI;6645711171;Ne;17;0;0;17
8268;Pušaitė;PELIUKAI;9867041220;Ne;4;0;0;4
8269;Pušaitė;PELIUKAI;9031289300;Ne;0;0;1;1
8270;Pušaitė;PELIUKAI;7210529114;Ne;0;2;0;2
8271;Pušaitė;PELIUKAI;2758026755;Ne;9;1;0;10
8272;Pušaitė;PELIUKAI;6851908671;Ne;1;0;3;4
8273;Pušaitė;PELIUKAI;7737524017;Ne;0;1;0;1
8274;Pušaitė;PELIUKAI;2618038364;Ne;5;10;0;15
8275;Pušaitė;PELIUKAI;1180343204;Ne;9;3;0;12
8276;Pušaitė;PELIUKAI;1069369636;Ne;3;1;0;4
8277;Pušaitė;PELIUKAI;5112517007;Ne;16;1;0;17
8278;Pušaitė;PELIUKAI;9261546370;Ne;13;1;0;14
8279;Pušaitė;PELIUKAI;6059415475;Ne;0;20;0;20
8280;"Pušynėlis (Miglos g. 53)";PUMPURĖLIAI;5725602894;Ne;20;0;0;20
8281;"Pušynėlis (Miglos g. 53)";PUMPURĖLIAI;2718421498;Ne;6;0;0;6
8282;"Pušynėlis (Miglos g. 53)";PUMPURĖLIAI;3882064516;Ne;4;0;6;10
8283;"Pušynėlis (Miglos g. 53)";PUMPURĖLIAI;9081582524;Ne;4;0;6;10
8284;"Pušynėlis (Miglos g. 53)";PUMPURĖLIAI;7787646910;Ne;0;0;1;1
8285;"Pušynėlis (Miglos g. 53)";PUMPURĖLIAI;8218331977;Ne;2;1;0;3
8286;"Pušynėlis (Miglos g. 53)";PUMPURĖLIAI;5568838550;Ne;5;0;7;12
8287;"Pušynėlis (Miglos g. 53)";PUMPURĖLIAI;2553444832;Ne;0;0;3;3
8288;"Pušynėlis (Miglos g. 53)";PUMPURĖLIAI;2744665477;Ne;10;0;0;10
8289;"Pušynėlis (Miglos g. 53)";PUMPURĖLIAI;2509111066;Ne;0;0;2;2
8290;"Pušynėlis (Miglos g. 53)";PUMPURĖLIAI;8902047615;Ne;0;9;0;9
8291;"Pušynėlis (Miglos g. 53)";PUMPURĖLIAI;3483639540;Ne;0;1;0;1
8292;"Pušynėlis (Miglos g. 53)";PUMPURĖLIAI;2861000826;Ne;0;6;0;6
8293;"Pušynėlis (Miglos g. 53)";PUMPURĖLIAI;5802582694;Ne;0;1;0;1
8294;"Pušynėlis (Miglos g. 53)";PUMPURĖLIAI;9465619945;Ne;0;0;5;5
8295;"Pušynėlis (Miglos g. 53)";PUMPURĖLIAI;9883505094;Ne;0;3;0;3
8296;"Pušynėlis (Miglos g. 53)";PUMPURĖLIAI;7438923710;Ne;12;0;0;12
8297;"Pušynėlis (Miglos g. 53)";PUMPURĖLIAI;8803766149;Ne;11;0;0;11
8298;"Pušynėlis (Miglos g. 53)";PUMPURĖLIAI;8462742834;Ne;0;4;10;14
8299;"Pušynėlis (Miglos g. 53)";PUMPURĖLIAI;6962705842;Ne;0;0;20;20
8300;"Pušynėlis (Miglos g. 53)";PUMPURĖLIAI;6110878898;Ne;6;1;0;7
8301;"Pušynėlis (Miglos g. 53)";SAULUTĖS;3483007385;Ne;16;0;0;16
8302;"Pušynėlis (Miglos g. 53)";SAULUTĖS;1891728904;Ne;0;1;0;1
8303;"Pušynėlis (Miglos g. 53)";SAULUTĖS;2508640229;Ne;2;0;0;2
8304;"Pušynėlis (Miglos g. 53)";SAULUTĖS;4052132379;Ne;6;0;0;6
8305;"Pušynėlis (Miglos g. 53)";SAULUTĖS;9483417104;Ne;4;0;1;5
8306;"Pušynėlis (Miglos g. 53)";SAULUTĖS;7401066252;Ne;3;0;0;3
8307;"Pušynėlis (Miglos g. 53)";SAULUTĖS;6036296660;Ne;0;2;0;2
8308;"Pušynėlis (Miglos g. 53)";SAULUTĖS;1251787066;Ne;0;0;2;2
8309;"Pušynėlis (Miglos g. 53)";SAULUTĖS;6709692748;Ne;0;1;0;1
8310;"Pušynėlis (Miglos g. 53)";SAULUTĖS;5318223378;Ne;5;0;4;9
8311;"Pušynėlis (Miglos g. 53)";SAULUTĖS;3100230874;Ne;0;19;0;19
8312;"Pušynėlis (Miglos g. 53)";SAULUTĖS;7896617995;Ne;0;0;4;4
8313;"Pušynėlis (Miglos g. 53)";SAULUTĖS;1034336110;Ne;0;1;0;1
8314;"Pušynėlis (Miglos g. 53)";SAULUTĖS;8799095053;Ne;12;1;0;13
8315;"Pušynėlis (Miglos g. 53)";SAULUTĖS;8451160808;Ne;7;0;0;7
8316;"Pušynėlis (Miglos g. 53)";SAULUTĖS;5501281051;Ne;0;0;9;9
8317;"Pušynėlis (Miglos g. 53)";PRIEŠMOKYKLINĖ;25261143142;Ne;0;4;0;4
8318;"Pušynėlis (Miglos g. 53)";PRIEŠMOKYKLINĖ;6549217377;Ne;7;0;0;7
8319;"Pušynėlis (Miglos g. 53)";PRIEŠMOKYKLINĖ;35538053975;Ne;0;2;1;3
8320;"Pušynėlis (Miglos g. 53)";PRIEŠMOKYKLINĖ;7729392498;Ne;6;0;0;6
8321;"Pušynėlis (Miglos g. 53)";PRIEŠMOKYKLINĖ;9192206804;Ne;0;1;0;1
8322;"Pušynėlis (Miglos g. 53)";PRIEŠMOKYKLINĖ;6077698697;Ne;0;0;1;1
8323;"Pušynėlis (Miglos g. 53)";PRIEŠMOKYKLINĖ;4668634909;Ne;0;2;0;2
8324;"Pušynėlis (Miglos g. 53)";PRIEŠMOKYKLINĖ;6560054869;Ne;0;8;0;8
8325;"Pušynėlis (Miglos g. 53)";PRIEŠMOKYKLINĖ;3037031809;Ne;4;1;0;5
8326;"Pušynėlis (Miglos g. 53)";PRIEŠMOKYKLINĖ;4030500100;Ne;0;0;2;2
8327;"Pušynėlis (Miglos g. 53)";PRIEŠMOKYKLINĖ;8172450090;Ne;0;0;1;1
8328;"Pušynėlis (Miglos g. 53)";PRIEŠMOKYKLINĖ;2019210609;Ne;0;2;0;2
8329;"Pušynėlis (Miglos g. 53)";PRIEŠMOKYKLINĖ;2793982816;Ne;4;0;1;5
8330;"Pušynėlis (Miglos g. 53)";PRIEŠMOKYKLINĖ;7046421581;Ne;1;0;0;1
8331;"Pušynėlis (Miglos g. 53)";PRIEŠMOKYKLINĖ;9466109315;Ne;0;3;0;3
8332;"Pušynėlis (Miglos g. 53)";PRIEŠMOKYKLINĖ;9154108688;Ne;0;0;5;5
8333;"Pušynėlis (Miglos g. 53)";PRIEŠMOKYKLINĖ;3510202379;Ne;0;0;13;13
8334;"Pušynėlis (Miglos g. 53)";PRIEŠMOKYKLINĖ;2765869141;Ne;7;0;0;7
8335;"Pušynėlis (Miglos g. 53)";PRIEŠMOKYKLINĖ;2141785580;Ne;1;1;0;2
8336;"Pušynėlis (Miglos g. 53)";"TREPSIUKAI (2018.09)";7732546085;Ne;7;0;0;7
8337;"Pušynėlis (Miglos g. 53)";"TREPSIUKAI (2018.09)";4449613959;Ne;0;0;20;20
8338;"Pušynėlis (Miglos g. 53)";"TREPSIUKAI (2018.09)";8933840402;Ne;12;0;0;12
8339;"Pušynėlis (Miglos g. 53)";"TREPSIUKAI (2018.09)";5488832089;Ne;10;0;0;10
8340;"Pušynėlis (Miglos g. 53)";"TREPSIUKAI (2018.09)";6414064067;Ne;0;2;0;2
8341;"Pušynėlis (Miglos g. 53)";"TREPSIUKAI (2018.09)";5670094788;Ne;0;0;13;13
8342;"Pušynėlis (Miglos g. 53)";"TREPSIUKAI (2018.09)";5264481173;Ne;11;0;0;11
8343;"Pušynėlis (Miglos g. 53)";"TREPSIUKAI (2018.09)";4468698630;Ne;4;0;3;7
8344;"Pušynėlis (Miglos g. 53)";"TREPSIUKAI (2018.09)";1240222214;Ne;5;0;0;5
8345;"Pušynėlis (Miglos g. 53)";"TREPSIUKAI (2018.09)";6318952845;Ne;4;0;0;4
8346;"Pušynėlis (Miglos g. 53)";"TREPSIUKAI (2018.09)";1508282873;Ne;3;0;1;4
8347;"Pušynėlis (Miglos g. 53)";"TREPSIUKAI (2018.09)";7745507151;Ne;4;0;1;5
8348;"Pušynėlis (Miglos g. 53)";"TREPSIUKAI (2018.09)";8372033449;Ne;6;2;0;8
8349;"Pušynėlis (Miglos g. 53)";"TREPSIUKAI (2018.09)";7964828070;Ne;0;1;3;4
8350;"Pušynėlis (Miglos g. 53)";"TREPSIUKAI (2018.09)";4603625624;Ne;0;5;2;7
8351;"Pušynėlis (Miglos g. 53)";"TREPSIUKAI (2018.09)";3682719098;Ne;5;0;0;5
8352;"Pušynėlis (Miglos g. 53)";"TREPSIUKAI (2018.09)";5038740377;Ne;5;3;0;8
8353;Raktelis;LAŠIUKAI;5031703240;Ne;0;1;0;1
8354;Raktelis;LAŠIUKAI;4671391106;Ne;0;1;0;1
8355;Raktelis;LAŠIUKAI;9313156299;Ne;0;1;0;1
8356;Raktelis;LAŠIUKAI;8117871963;Ne;0;9;0;9
8357;Raktelis;LAŠIUKAI;1192775994;Ne;0;3;0;3
8358;Raktelis;LAŠIUKAI;6854111162;Ne;0;2;0;2
8359;Raktelis;LAŠIUKAI;9230053040;Ne;8;5;0;13
8360;Raktelis;LAŠIUKAI;8410301417;Ne;0;1;0;1
8361;Raktelis;LAŠIUKAI;3713386556;Ne;0;2;4;6
8362;Raktelis;LAŠIUKAI;5818899732;Ne;0;0;1;1
8363;Raktelis;LAŠIUKAI;7487507324;Ne;0;2;1;3
8364;Raktelis;LAŠIUKAI;9584164290;Ne;0;1;0;1
8365;Raktelis;LAŠIUKAI;6049420030;Ne;3;0;2;5
8366;Raktelis;LAŠIUKAI;2303286473;Ne;0;0;1;1
8367;Raktelis;LAŠIUKAI;54221331553;Ne;0;0;3;3
8368;Raktelis;LAŠIUKAI;5802689482;Ne;0;12;0;12
8369;Raktelis;LAŠIUKAI;5000264125;Ne;0;2;0;2
8370;Raktelis;LAŠIUKAI;1457880868;Ne;7;1;0;8
8371;Raktelis;LAŠIUKAI;5711863758;Ne;0;1;3;4
8372;Raktelis;LAŠIUKAI;53034039807;Ne;7;4;0;11
8373;Raktelis;LAŠIUKAI;8559758812;Ne;0;10;1;11
8374;Raktelis;LAŠIUKAI;9210856228;Taip;0;0;2;2
8375;Raktelis;BITUTĖS;7265543701;Ne;0;2;0;2
8376;Raktelis;BITUTĖS;5405322552;Ne;18;0;0;18
8377;Raktelis;BITUTĖS;5492437864;Taip;0;1;0;1
8378;Raktelis;BITUTĖS;9139322116;Ne;0;1;0;1
8379;Raktelis;BITUTĖS;9965855682;Ne;0;1;0;1
8380;Raktelis;BITUTĖS;4319176525;Ne;0;13;0;13
8381;Raktelis;BITUTĖS;4317705126;Ne;0;0;2;2
8382;Raktelis;BITUTĖS;4187804340;Ne;0;0;2;2
8383;Raktelis;BITUTĖS;5820028619;Ne;0;4;0;4
8384;Raktelis;BITUTĖS;2652125338;Ne;0;0;1;1
8385;Raktelis;BITUTĖS;3821849812;Ne;0;1;0;1
8386;Raktelis;BITUTĖS;3308623522;Ne;0;2;1;3
8387;Raktelis;BITUTĖS;4059286631;Ne;0;5;0;5
8388;Raktelis;BITUTĖS;5913060415;Ne;0;1;0;1
8389;Raktelis;BITUTĖS;6974263764;Ne;0;2;0;2
8390;Raktelis;BITUTĖS;6932820066;Ne;3;0;0;3
8391;Raktelis;BITUTĖS;2410682193;Ne;6;0;2;8
8392;Raktelis;BITUTĖS;4615337759;Ne;0;2;1;3
8393;Raktelis;BITUTĖS;4962251215;Ne;0;7;0;7
8394;Raktelis;BITUTĖS;8282429202;Ne;3;0;0;3
8395;Raktelis;BORUŽĖLĖS;7068061170;Ne;20;0;0;20
8396;Raktelis;BORUŽĖLĖS;2361477092;Ne;7;3;0;10
8397;Raktelis;BORUŽĖLĖS;4226277600;Ne;0;6;0;6
8398;Raktelis;BORUŽĖLĖS;2599670832;Ne;4;2;1;7
8399;Raktelis;BORUŽĖLĖS;1757601091;Ne;15;0;0;15
8400;Raktelis;BORUŽĖLĖS;5865484633;Ne;7;0;0;7
8401;Raktelis;BORUŽĖLĖS;4529213150;Ne;6;0;0;6
8402;Raktelis;BORUŽĖLĖS;4936637343;Ne;0;1;0;1
8403;Raktelis;BORUŽĖLĖS;4333191842;Ne;11;0;0;11
8404;Raktelis;BORUŽĖLĖS;9529797517;Ne;5;0;0;5
8405;Raktelis;BORUŽĖLĖS;1618225282;Ne;0;0;1;1
8406;Raktelis;BORUŽĖLĖS;4442395100;Ne;16;1;0;17
8407;Raktelis;BORUŽĖLĖS;5150954686;Ne;20;0;0;20
8408;Raktelis;BORUŽĖLĖS;3490428062;Ne;3;7;0;10
8409;Raktelis;BORUŽĖLĖS;5404673733;Ne;1;1;0;2
8410;Raktelis;BORUŽĖLĖS;1314972335;Ne;0;6;0;6
8411;Raktelis;BORUŽĖLĖS;3343352568;Ne;0;2;2;4
8412;Raktelis;BORUŽĖLĖS;2698820718;Ne;0;2;0;2
8413;Raktelis;BORUŽĖLĖS;7990626447;Ne;6;1;0;7
8414;Raktelis;BORUŽĖLĖS;7459272209;Ne;0;0;1;1
8415;Raktelis;BORUŽĖLĖS;5046450478;Ne;4;5;0;9
8416;Raktelis;BORUŽĖLĖS;1141447274;Ne;4;4;0;8
8417;Raktelis;BORUŽĖLĖS;3456093273;Ne;20;0;0;20
8418;Raktelis;BORUŽĖLĖS;5576511314;Ne;5;1;0;6
8419;Raktelis;KAČIUKAI;5270430511;Ne;11;0;0;11
8420;Raktelis;KAČIUKAI;4622683599;Ne;0;3;0;3
8421;Raktelis;KAČIUKAI;8600632097;Ne;0;2;0;2
8422;Raktelis;KAČIUKAI;7630501672;Ne;2;1;0;3
8423;Raktelis;KAČIUKAI;8456082594;Ne;0;1;0;1
8424;Raktelis;KAČIUKAI;4676213966;Ne;1;0;0;1
8425;Raktelis;KAČIUKAI;4631375439;Ne;0;9;0;9
8426;Raktelis;KAČIUKAI;6265489540;Ne;9;0;0;9
8427;Raktelis;KAČIUKAI;4160091258;Ne;10;0;0;10
8428;Raktelis;KAČIUKAI;3775306030;Ne;4;5;0;9
8429;Raktelis;KAČIUKAI;4009105487;Ne;0;0;2;2
8430;Raktelis;KAČIUKAI;1843086151;Ne;0;1;4;5
8431;Raktelis;KAČIUKAI;2295251060;Ne;3;1;0;4
8432;Raktelis;KAČIUKAI;5042538956;Ne;3;0;0;3
8433;Raktelis;KAČIUKAI;7260767942;Ne;10;0;0;10
8434;Raktelis;KAČIUKAI;6323223256;Ne;8;1;0;9
8435;Raktelis;KAČIUKAI;1123693990;Ne;0;4;3;7
8436;Raktelis;KAČIUKAI;4979657165;Ne;0;12;0;12
8437;Raktelis;KIŠKUČIAI;9390692206;Ne;20;0;0;20
8438;Raktelis;KIŠKUČIAI;7847787737;Ne;4;0;1;5
8439;Raktelis;KIŠKUČIAI;7046291082;Ne;5;2;0;7
8440;Raktelis;KIŠKUČIAI;2278227649;Ne;10;1;1;12
8441;Raktelis;KIŠKUČIAI;8992797384;Ne;5;1;0;6
8442;Raktelis;KIŠKUČIAI;9803505110;Ne;5;1;2;8
8443;Raktelis;KIŠKUČIAI;6473692639;Ne;14;0;0;14
8444;Raktelis;KIŠKUČIAI;1668164327;Ne;14;0;0;14
8445;Raktelis;KIŠKUČIAI;6587878165;Ne;0;2;2;4
8446;Raktelis;KIŠKUČIAI;9169797346;Ne;6;1;2;9
8447;Raktelis;KIŠKUČIAI;2262854947;Ne;13;0;1;14
8448;Raktelis;KIŠKUČIAI;3493159224;Ne;3;0;0;3
8449;Raktelis;KIŠKUČIAI;1810732707;Ne;8;1;0;9
8450;Raktelis;KIŠKUČIAI;7605822626;Ne;14;0;1;15
8451;Raktelis;NYKŠTUKAI;7865593006;Ne;0;3;0;3
8452;Raktelis;NYKŠTUKAI;4252867688;Ne;5;0;0;5
8453;Raktelis;NYKŠTUKAI;7058612493;Ne;0;0;1;1
8454;Raktelis;NYKŠTUKAI;8817859592;Ne;10;0;0;10
8455;Raktelis;NYKŠTUKAI;4578445282;Ne;0;5;0;5
8456;Raktelis;NYKŠTUKAI;9164539135;Ne;9;2;1;12
8457;Raktelis;NYKŠTUKAI;4147382341;Ne;20;0;0;20
8458;Raktelis;NYKŠTUKAI;3968555691;Ne;0;11;0;11
8459;Raktelis;NYKŠTUKAI;4764915486;Ne;0;5;5;10
8460;Raktelis;NYKŠTUKAI;4765483387;Ne;0;0;3;3
8461;Raktelis;NYKŠTUKAI;9114203596;Ne;0;8;0;8
8462;Raktelis;NYKŠTUKAI;2803146830;Ne;18;0;0;18
8463;Raktelis;NYKŠTUKAI;7202523804;Ne;4;4;0;8
8464;Raktelis;NYKŠTUKAI;6718159439;Ne;3;8;0;11
8465;Raktelis;PELIUKAI;9599034285;Ne;4;0;0;4
8466;Raktelis;PELIUKAI;1604357851;Ne;20;0;0;20
8467;Raktelis;PELIUKAI;6393143566;Ne;9;1;0;10
8468;Raktelis;PELIUKAI;4014822452;Ne;0;4;0;4
8469;Raktelis;PELIUKAI;5758873229;Ne;15;0;0;15
8470;Raktelis;PELIUKAI;2141128125;Ne;10;0;0;10
8471;Raktelis;PELIUKAI;4502236264;Ne;15;0;0;15
8472;Raktelis;PELIUKAI;4834301832;Ne;4;0;0;4
8473;Raktelis;PELIUKAI;2754009962;Taip;5;0;1;6
8474;Raktelis;PELIUKAI;3311870918;Ne;14;2;0;16
8475;Raktelis;PELIUKAI;6826993779;Ne;14;2;0;16
8476;Raktelis;PELIUKAI;8698736569;Ne;4;1;0;5
8477;Raktelis;PELIUKAI;2044812301;Ne;5;3;0;8
8478;Raktelis;PELIUKAI;2301442262;Ne;8;0;0;8
8479;Raktelis;PELIUKAI;6853881405;Ne;0;2;1;3
8480;Raktelis;PELIUKAI;9983004779;Taip;1;2;0;3
8481;Raktelis;PELIUKAI;7389910330;Ne;9;1;0;10
8482;Raktelis;PELIUKAI;4513031164;Ne;11;0;0;11
8483;Raktelis;AGUONOS;6102196040;Ne;3;6;0;9
8484;Raktelis;AGUONOS;1622504968;Ne;10;0;0;10
8485;Raktelis;AGUONOS;6199212999;Ne;10;2;0;12
8486;Raktelis;AGUONOS;7334310944;Taip;0;3;0;3
8487;Raktelis;AGUONOS;1975411457;Taip;10;0;0;10
8488;Raktelis;AGUONOS;6367875352;Taip;0;0;7;7
8489;Raktelis;AGUONOS;7170546710;Ne;14;5;0;19
8490;Raktelis;AGUONOS;4905982507;Ne;0;5;0;5
8491;Raktelis;AGUONOS;9779789133;Ne;3;6;0;9
8492;Raktelis;AGUONOS;9593639791;Ne;9;1;0;10
8493;Raktelis;AGUONOS;1392036584;Taip;3;9;0;12
8494;Raktelis;AGUONOS;6608224825;Ne;5;5;0;10
8495;Raktelis;AGUONOS;4658530212;Taip;0;2;0;2
8496;Raktelis;AGUONOS;4335378625;Taip;6;0;0;6
8497;Raktelis;AGUONOS;8873203690;Ne;9;0;2;11
8498;Raktelis;AGUONOS;9357757604;Taip;1;7;0;8
8499;Raktelis;AGUONOS;8459980712;Taip;0;4;0;4
8500;Raktelis;AGUONOS;7973137015;Taip;4;2;0;6
8501;Raktelis;AGUONOS;8767785444;Ne;0;4;0;4
8502;Raktelis;LAPIUKŲ;6894769625;Ne;15;2;0;17
8503;Raktelis;LAPIUKŲ;7142823740;Ne;4;0;1;5
8504;Raktelis;LAPIUKŲ;3395720463;Ne;5;1;0;6
8505;Raktelis;LAPIUKŲ;4167194960;Ne;0;2;0;2
8506;Raktelis;LAPIUKŲ;2809458453;Ne;6;2;0;8
8507;Raktelis;LAPIUKŲ;2967941870;Ne;4;0;0;4
8508;Raktelis;LAPIUKŲ;6892006495;Ne;5;3;0;8
8509;Raktelis;LAPIUKŲ;3884068578;Ne;0;4;0;4
8510;Raktelis;LAPIUKŲ;4755892641;Ne;0;6;0;6
8511;Raktelis;LAPIUKŲ;7440866459;Ne;0;2;0;2
8512;Raktelis;LAPIUKŲ;3517484891;Ne;0;10;0;10
8513;Raktelis;LAPIUKŲ;5688795147;Ne;9;0;0;9
8514;Raktelis;LAPIUKŲ;8035618134;Ne;5;0;1;6
8515;Raktelis;LAPIUKŲ;6822021176;Ne;20;0;0;20
8516;Raktelis;LAPIUKŲ;8146076115;Ne;0;1;0;1
8517;Raktelis;LAPIUKŲ;2731096860;Ne;5;0;0;5
8518;Raktelis;LAPIUKŲ;4353473162;Ne;7;0;0;7
8519;Raktelis;LAPIUKŲ;8700012974;Ne;0;0;1;1
8520;Raktelis;LAPIUKŲ;1263150004;Ne;13;2;0;15
8521;Raktelis;LAPIUKŲ;1445359221;Ne;2;0;0;2
8522;Raktelis;LAPIUKŲ;9497620710;Ne;12;0;0;12
8523;Raktelis;LAPIUKŲ;1120263625;Ne;10;0;0;10
8524;Raktelis;PELĖDŽIUKAI;5275588088;Ne;11;2;0;13
8525;Raktelis;PELĖDŽIUKAI;54341630847;Ne;10;0;0;10
8526;Raktelis;PELĖDŽIUKAI;4583377785;Ne;1;3;0;4
8527;Raktelis;PELĖDŽIUKAI;8320696048;Ne;2;0;0;2
8528;Raktelis;PELĖDŽIUKAI;2753402906;Ne;9;0;0;9
8529;Raktelis;PELĖDŽIUKAI;9053427316;Ne;0;1;1;2
8530;Raktelis;PELĖDŽIUKAI;3423529085;Ne;0;1;0;1
8531;Raktelis;PELĖDŽIUKAI;9716191639;Ne;6;1;2;9
8532;Raktelis;PELĖDŽIUKAI;1322912585;Ne;0;2;0;2
8533;Raktelis;PELĖDŽIUKAI;6877934219;Taip;0;2;1;3
8534;Raktelis;PELĖDŽIUKAI;9130613710;Ne;10;2;0;12
8535;Raktelis;PELĖDŽIUKAI;2282754345;Ne;0;1;0;1
8536;Raktelis;PELĖDŽIUKAI;8207675881;Ne;0;4;0;4
8537;Raktelis;PELĖDŽIUKAI;6385127914;Taip;0;0;3;3
8538;Raktelis;PELĖDŽIUKAI;7869495911;Ne;4;1;0;5
8539;Raktelis;PELĖDŽIUKAI;5925441742;Ne;0;1;0;1
8540;Raktelis;PELĖDŽIUKAI;5082785025;Ne;0;0;10;10
8541;Raktelis;MEŠKIUKAI;6703168910;Ne;14;0;0;14
8542;Raktelis;MEŠKIUKAI;8851021346;Ne;4;0;1;5
8543;Raktelis;MEŠKIUKAI;4185763817;Ne;0;1;0;1
8544;Raktelis;MEŠKIUKAI;6685891017;Ne;0;0;2;2
8545;Raktelis;MEŠKIUKAI;3484991718;Ne;8;0;0;8
8546;Raktelis;MEŠKIUKAI;6855863189;Ne;12;0;0;12
8547;Raktelis;MEŠKIUKAI;1026592738;Ne;1;5;0;6
8548;Raktelis;MEŠKIUKAI;7900644404;Ne;20;0;0;20
8549;Raktelis;MEŠKIUKAI;5718804414;Ne;7;0;0;7
8550;Raktelis;MEŠKIUKAI;9718355271;Ne;6;1;2;9
8551;Raktelis;MEŠKIUKAI;2171952119;Ne;6;0;0;6
8552;Raktelis;MEŠKIUKAI;6358227532;Ne;0;6;0;6
8553;Raktelis;MEŠKIUKAI;8341026400;Ne;0;1;0;1
8554;Raktelis;MEŠKIUKAI;8608093349;Ne;0;3;2;5
8555;Rasa;Nykštukai;5176175108;Ne;0;2;6;8
8556;Rasa;Nykštukai;3979273111;Ne;0;5;0;5
8557;Rasa;Nykštukai;7004232909;Ne;0;2;0;2
8558;Rasa;Nykštukai;1223962374;Ne;0;0;6;6
8559;Rasa;Nykštukai;3200377629;Ne;9;1;0;10
8560;Rasa;Nykštukai;1336291828;Ne;0;5;0;5
8561;Rasa;Nykštukai;2540124793;Ne;0;1;0;1
8562;Rasa;Nykštukai;5363748728;Ne;0;2;0;2
8563;Rasa;Nykštukai;2977737634;Ne;1;0;0;1
8564;Rasa;Nykštukai;8310400946;Ne;0;2;0;2
8565;Rasa;Nykštukai;7520665472;Ne;4;2;0;6
8566;Rasa;Meškiukai;8378755600;Ne;0;14;0;14
8567;Rasa;Meškiukai;6691161322;Ne;4;0;0;4
8568;Rasa;Meškiukai;8740659600;Ne;0;20;0;20
8569;Rasa;Meškiukai;6874601830;Ne;6;10;0;16
8570;Rasa;Meškiukai;7357915584;Ne;0;9;0;9
8571;Rasa;Meškiukai;8314522373;Ne;0;5;0;5
8572;Rasa;Meškiukai;3548008659;Ne;0;20;0;20
8573;Rasa;Meškiukai;3773600344;Ne;9;0;3;12
8574;Rasa;Meškiukai;2371282781;Ne;9;0;3;12
8575;Rasa;Meškiukai;2555108465;Ne;0;0;4;4
8576;Rasa;Meškiukai;1992726664;Ne;0;1;0;1
8577;Rasa;Meškiukai;7637404588;Ne;0;2;0;2
8578;Rasa;Meškiukai;7502435359;Ne;4;2;0;6
8579;Rasa;Meškiukai;6853285570;Taip;7;0;3;10
8580;Rasa;Meškiukai;8674133653;Ne;0;20;0;20
8581;Rasa;Sauliukai;6879558965;Ne;2;0;0;2
8582;Rasa;Sauliukai;6356448094;Ne;10;0;0;10
8583;Rasa;Sauliukai;2683897055;Ne;0;5;0;5
8584;Rasa;Sauliukai;2982016133;Ne;0;2;1;3
8585;Rasa;Sauliukai;7534548604;Ne;0;2;0;2
8586;Rasa;Sauliukai;3567565920;Ne;0;2;0;2
8587;Rasa;Sauliukai;7565880116;Ne;0;2;0;2
8588;Rasa;Sauliukai;4790859112;Ne;0;0;1;1
8589;Rasa;Sauliukai;2110008545;Ne;1;0;0;1
8590;Rasa;Sauliukai;5932187584;Ne;5;3;0;8
8591;Rasa;Sauliukai;4837280374;Ne;4;1;0;5
8592;Rasa;Sauliukai;4260142706;Ne;0;2;0;2
8593;Rasa;Sauliukai;5145978804;Ne;17;2;0;19
8594;Rasa;Sauliukai;8818450386;Ne;3;1;0;4
8595;Rasa;Sauliukai;6734478649;Ne;0;0;2;2
8596;Rasa;Sauliukai;63673920646;Ne;1;0;0;1
8597;Rasa;Smalsučiai;9648034081;Ne;0;2;0;2
8598;Rasa;Smalsučiai;2626361958;Ne;1;4;0;5
8599;Rasa;Smalsučiai;7065597550;Ne;0;2;0;2
8600;Rasa;Smalsučiai;2132535297;Ne;0;2;1;3
8601;Rasa;Smalsučiai;8866896989;Ne;0;10;0;10
8602;Rasa;Smalsučiai;3023088027;Ne;0;2;0;2
8603;Rasa;Smalsučiai;4758605343;Ne;0;2;0;2
8604;Rasa;Smalsučiai;3091012313;Ne;0;2;0;2
8605;Rasa;Smalsučiai;7558966891;Ne;5;0;1;6
8606;Rasa;Smalsučiai;1823276800;Ne;9;1;0;10
8607;Rasa;Smalsučiai;6773004268;Ne;0;1;0;1
8608;Rasa;Smalsučiai;1457384318;Ne;0;1;0;1
8609;Rasa;Smalsučiai;5325275053;Ne;0;4;3;7
8610;Rasa;Smalsučiai;2121070882;Ne;0;3;0;3
8611;Rasa;Smalsučiai;4603188598;Ne;10;0;0;10
8612;Rasa;"Pelėdžiukai ";3387615841;Ne;0;1;0;1
8613;Rasa;"Pelėdžiukai ";8816116600;Ne;0;1;0;1
8614;Rasa;"Pelėdžiukai ";8455168346;Ne;0;0;1;1
8615;Rasa;"Pelėdžiukai ";5141906920;Ne;0;4;0;4
8616;Rasa;"Pelėdžiukai ";3381468321;Ne;0;2;0;2
8617;Rasa;"Pelėdžiukai ";1261868339;Ne;0;1;4;5
8618;Rasa;"Pelėdžiukai ";6553479199;Ne;7;2;1;10
8619;Rasa;"Pelėdžiukai ";4947382314;Ne;1;0;0;1
8620;Rasa;"Pelėdžiukai ";2968464121;Ne;0;2;0;2
8621;Rasa;"Pelėdžiukai ";5816940902;Taip;3;0;2;5
8622;Rasa;"Pelėdžiukai ";4389917247;Ne;0;20;0;20
8623;Rasa;"Pelėdžiukai ";2123838514;Ne;0;19;0;19
8624;Rasa;"Pelėdžiukai ";1288177637;Taip;0;19;0;19
8625;Rasa;"Pelėdžiukai ";8403268732;Ne;5;1;4;10
8626;Rasa;Katinėliai;5885520521;Ne;0;1;0;1
8627;Rasa;Katinėliai;3657956842;Ne;7;0;1;8
8628;Rasa;Katinėliai;6891623055;Ne;7;0;1;8
8629;Rasa;Katinėliai;9010812748;Ne;8;0;0;8
8630;Rasa;Katinėliai;7220007488;Ne;0;0;2;2
8631;Rasa;Katinėliai;8235869241;Ne;10;10;0;20
8632;Rasa;Katinėliai;2984661168;Ne;0;0;1;1
8633;Rasa;Katinėliai;4913483444;Ne;0;0;1;1
8634;Rasa;Katinėliai;4734775151;Ne;0;9;0;9
8635;Rasa;Katinėliai;4758138905;Ne;0;0;5;5
8636;Rasa;Katinėliai;9447346901;Ne;0;0;1;1
8637;Rasa;Katinėliai;3631124501;Ne;18;0;0;18
8638;Rasa;Katinėliai;9343039995;Ne;4;0;0;4
8639;Rasa;Katinėliai;4084236196;Ne;0;0;2;2
8640;Rasa;Katinėliai;3428261829;Ne;5;0;2;7
8641;Rasa;Katinėliai;2477057223;Ne;0;20;0;20
8642;Rasa;Katinėliai;5134342817;Ne;0;1;0;1
8643;Rasa;Katinėliai;9220749889;Ne;5;0;0;5
8644;Rasa;Ančiukai;1477018184;Ne;0;0;3;3
8645;Rasa;Ančiukai;4018241056;Ne;12;0;1;13
8646;Rasa;Ančiukai;1736903037;Ne;7;0;4;11
8647;Rasa;Ančiukai;4762348187;Ne;5;0;0;5
8648;Rasa;Ančiukai;8622210603;Ne;6;0;4;10
8649;Rasa;Ančiukai;1521328997;Ne;0;0;2;2
8650;Rasa;Ančiukai;3884782148;Ne;0;0;2;2
8651;Rasa;Ančiukai;9230334839;Taip;0;0;5;5
8652;Rasa;Ančiukai;8574946856;Taip;0;1;0;1
8653;Rasa;Ančiukai;6442933249;Ne;0;2;0;2
8654;Rasa;Ančiukai;4979105526;Ne;4;0;0;4
8655;Rasa;"Vyturiukai ";7028605422;Ne;0;10;0;10
8656;Rasa;"Vyturiukai ";2800420481;Taip;1;0;3;4
8657;Rasa;"Vyturiukai ";5869253167;Ne;7;0;0;7
8658;Rasa;"Vyturiukai ";7037958994;Ne;5;1;0;6
8659;Rasa;"Vyturiukai ";8236785255;Ne;9;1;0;10
8660;Rasa;"Vyturiukai ";6887471189;Ne;0;1;2;3
8661;Rasa;"Vyturiukai ";4694111253;Ne;1;1;0;2
8662;Rasa;"Vyturiukai ";2347639286;Ne;0;1;8;9
8663;Rasa;"Vyturiukai ";1206005039;Ne;3;1;0;4
8664;Rasa;"Vyturiukai ";9788282861;Ne;1;0;0;1
8665;Rasa;"Vyturiukai ";2769096357;Ne;20;0;0;20
8666;Rasa;"Vyturiukai ";6883073764;Ne;2;0;6;8
8667;Rasa;"Vyturiukai ";9706428782;Ne;0;5;0;5
8668;Rasa;"Vyturiukai ";7043271718;Ne;6;0;5;11
8669;Rasa;"Vyturiukai ";6575864256;Ne;19;0;0;19
8670;Rasa;Voveriukai;4111850024;Ne;0;0;1;1
8671;Rasa;Voveriukai;2190948879;Ne;1;11;0;12
8672;Rasa;Voveriukai;1978999728;Ne;0;0;1;1
8673;Rasa;Voveriukai;3546684695;Ne;4;0;1;5
8674;Rasa;Voveriukai;5977524939;Ne;0;0;4;4
8675;Rasa;Voveriukai;1592174114;Ne;0;0;3;3
8676;Rasa;Voveriukai;1564194649;Ne;3;0;4;7
8677;Rasa;Voveriukai;1764959761;Ne;0;0;5;5
8678;Rasa;Voveriukai;1765617605;Ne;4;1;2;7
8679;Rasa;Voveriukai;1733179752;Ne;0;3;0;3
8680;Rasa;Voveriukai;2895124729;Ne;10;1;0;11
8681;Rasa;Voveriukai;1679709767;Ne;0;0;7;7
8682;Rasa;Voveriukai;5622110823;Ne;0;2;1;3
8683;Rasa;Voveriukai;6221754830;Ne;0;2;0;2
8684;Rasa;Voveriukai;7218250981;Ne;0;11;1;12
8685;Rasa;"DRUGELIAI ";6621628020;Ne;15;0;1;16
8686;Rasa;"DRUGELIAI ";9959160342;Ne;15;0;1;16
8687;Rasa;"DRUGELIAI ";5761013588;Ne;9;2;6;17
8688;Rasa;"DRUGELIAI ";7220103314;Ne;0;0;1;1
8689;Rasa;"DRUGELIAI ";9506388242;Ne;0;12;0;12
8690;Rasa;"DRUGELIAI ";4188303400;Ne;12;0;0;12
8691;Rasa;"DRUGELIAI ";5483943978;Taip;0;3;1;4
8692;Rasa;"DRUGELIAI ";7251815682;Ne;12;0;0;12
8693;Rasa;"DRUGELIAI ";8702962863;Ne;0;6;0;6
8694;Rasa;"DRUGELIAI ";6291089659;Ne;0;0;6;6
8695;Rasa;"DRUGELIAI ";4183378344;Ne;0;0;1;1
8696;Rasa;"DRUGELIAI ";6314411900;Ne;0;0;1;1
8697;Rasa;"DRUGELIAI ";1575522555;Ne;10;0;6;16
8698;Rasa;Zuikučiai;7265752821;Ne;0;6;0;6
8699;Rasa;Zuikučiai;3470054190;Taip;0;0;2;2
8700;Rasa;Zuikučiai;7253736220;Ne;0;3;0;3
8701;Rasa;Zuikučiai;4940758709;Ne;0;2;0;2
8702;Rasa;Zuikučiai;6574998939;Ne;0;1;0;1
8703;Rasa;Zuikučiai;4212798846;Ne;1;4;0;5
8704;Rasa;Zuikučiai;7585566403;Taip;0;2;1;3
8705;Rasa;Zuikučiai;6505001743;Ne;6;1;0;7
8706;Rasa;Zuikučiai;6780996150;Taip;0;0;1;1
8707;Rasa;Zuikučiai;8159411349;Ne;16;0;0;16
8708;Rasa;Zuikučiai;8992548689;Ne;0;1;0;1
8709;Rasa;Širdelė;8424049317;Ne;5;0;0;5
8710;Rasa;Širdelė;8236464670;Ne;4;0;0;4
8711;Rasa;Širdelė;6976298054;Ne;0;1;0;1
8712;Rasa;Širdelė;3668598028;Ne;8;2;0;10
8713;Rasa;Širdelė;2333938367;Ne;0;4;0;4
8714;Rasa;Širdelė;9560289781;Ne;0;1;0;1
8715;Rasa;Širdelė;5719253028;Ne;5;0;0;5
8716;Rasa;Širdelė;9140875020;Ne;7;2;0;9
8717;Rasa;Širdelė;4694382836;Ne;0;1;1;2
8718;Rasa;Širdelė;1796573723;Ne;0;2;0;2
8719;Rasa;Širdelė;3535655117;Ne;4;0;0;4
8720;Rasa;Širdelė;4361959446;Ne;0;1;1;2
8721;Rasa;Širdelė;3215464914;Ne;1;2;0;3
8722;Rasa;Širdelė;6760723624;Ne;0;1;2;3
8723;Rasa;Širdelė;6606982242;Ne;0;2;0;2
8724;Rasa;Širdelė;1447258806;Ne;0;0;2;2
8725;Rasa;Širdelė;1627996663;Ne;2;14;0;16
8726;Rugelis;Kiškučiai;2548567224;Ne;10;0;0;10
8727;Rugelis;Kiškučiai;7578087466;Ne;1;0;0;1
8728;Rugelis;Kiškučiai;4873953024;Ne;7;0;0;7
8729;Rugelis;Kiškučiai;4861369279;Ne;7;0;0;7
8730;Rugelis;Kiškučiai;7896965911;Ne;8;0;0;8
8731;Rugelis;Kiškučiai;4927838136;Ne;8;0;0;8
8732;Rugelis;Nykštukai;9063793689;Ne;5;0;0;5
8733;Rugelis;Nykštukai;3321096223;Ne;11;0;0;11
8734;Rugelis;Nykštukai;8993542849;Ne;6;0;0;6
8735;Rugelis;Nykštukai;8299606275;Ne;11;0;0;11
8736;Rugelis;Saulutės;8895682644;Ne;8;0;0;8
8737;Rugelis;Saulutės;9040957933;Ne;1;0;0;1
8738;Rugelis;Saulutės;7129567323;Ne;7;0;0;7
8739;Rugelis;Saulutės;6287778607;Ne;7;0;0;7
8740;Rugelis;Saulutės;9106734166;Ne;14;0;0;14
8741;Rugelis;Saulutės;6747662090;Ne;5;0;0;5
8742;Rugelis;Saulutės;8425090839;Ne;7;0;0;7
8743;Rugelis;Saulutės;2499027107;Ne;5;0;0;5
8744;Rugelis;Drugeliai;9776104569;Ne;13;0;0;13
8745;Rugelis;Drugeliai;1394104417;Ne;7;0;0;7
8746;Rugelis;Drugeliai;1180960736;Ne;10;0;0;10
8747;Rugelis;Drugeliai;7690463984;Taip;1;0;0;1
8748;Rugelis;Drugeliai;8909156165;Ne;12;0;0;12
8749;Rugelis;Ežiukai;1513111738;Taip;3;0;0;3
8750;Rugelis;Ežiukai;9307230152;Ne;5;0;0;5
8751;Rugelis;Ežiukai;7414368090;Ne;4;0;0;4
8752;Rugelis;Ežiukai;5649014411;Ne;14;0;0;14
8753;Rugelis;Ežiukai;7505716323;Ne;10;0;0;10
8754;Rugelis;Bitutės;8529645041;Ne;9;0;0;9
8755;Rugelis;Bitutės;6305217730;Ne;11;0;0;11
8756;Rugelis;Bitutės;7385030387;Ne;11;0;0;11
8757;Rugelis;Bitutės;8411522319;Ne;10;0;0;10
8758;Rugelis;Bitutės;6750366833;Ne;4;0;0;4
8759;Rugelis;Žirniukai;4773153812;Ne;10;0;0;10
8760;Rugelis;Žirniukai;6490365923;Ne;4;0;0;4
8761;Rugelis;Žirniukai;9780302551;Ne;6;0;0;6
8762;Rugelis;Žirniukai;8183416965;Ne;9;0;0;9
8763;Rugelis;Žirniukai;3136867979;Ne;10;0;0;10
8764;Rugelis;Žirniukai;4074302113;Ne;2;0;0;2
8765;Rugelis;Žvirbliukai;6760192823;Ne;1;0;0;1
8766;Rugelis;Žvirbliukai;2459950313;Ne;8;0;0;8
8767;Rugelis;Žvirbliukai;4799504037;Ne;7;0;0;7
8768;Rugelis;Ramunėlės;4679095043;Ne;6;0;0;6
8769;Rugelis;Ramunėlės;5347341795;Ne;3;0;0;3
8770;Rugelis;Ramunėlės;6267162365;Ne;8;0;0;8
8771;Rugelis;Ramunėlės;7643579630;Ne;5;0;0;5
8772;Rugelis;Pipirai;7943300111;Ne;13;0;0;13
8773;Rugelis;Pipirai;6439077331;Ne;9;0;0;9
8774;Rugelis;Pipirai;8235025116;Ne;5;0;0;5
8775;Rugelis;Pipirai;1484215269;Ne;5;0;0;5
8776;Rugelis;Pipirai;8359970599;Ne;6;0;0;6
8777;Rugelis;Pipirai;3889281949;Ne;5;0;0;5
8778;Rugelis;Pipirai;1756394208;Ne;15;0;0;15
8779;Rugelis;Pipirai;1225959218;Ne;9;0;0;9
8780;Rugelis;Pipirai;3219628162;Ne;10;0;0;10
8781;Rugelis;Pipirai;6925066762;Ne;5;0;0;5
8782;Rugelis;Pipirai;6271802098;Ne;10;0;0;10
8783;Rugelis;Pipirai;1972178406;Ne;10;0;0;10
8784;Rugelis;Meškučiai;6548081733;Taip;4;0;0;4
8785;Rugelis;Meškučiai;4096255107;Ne;2;0;0;2
8786;Rugelis;Meškučiai;6109565432;Ne;7;0;0;7
8787;Rugelis;Meškučiai;9142052846;Taip;9;0;0;9
8788;Rugelis;Boružėlės;5964946032;Ne;1;0;0;1
8789;Rugelis;Boružėlės;1121258767;Ne;8;0;0;8
8790;Rugelis;Boružėlės;2498056977;Ne;1;0;0;1
8791;Riešutėlis;Viščiukų;7666200219;Ne;0;20;0;20
8792;Riešutėlis;Viščiukų;6626441225;Ne;12;0;0;12
8793;Riešutėlis;Viščiukų;6906373822;Ne;0;1;0;1
8794;Riešutėlis;Viščiukų;4636191548;Ne;8;0;0;8
8795;Riešutėlis;Viščiukų;2493171003;Ne;0;0;2;2
8796;Riešutėlis;Viščiukų;5133625078;Ne;8;1;0;9
8797;Riešutėlis;Viščiukų;2235912189;Ne;5;0;0;5
8798;Riešutėlis;Viščiukų;9864636983;Ne;14;0;0;14
8799;Riešutėlis;Viščiukų;4429903561;Ne;14;0;0;14
8800;Riešutėlis;Viščiukų;5317904812;Ne;0;0;2;2
8801;Riešutėlis;Viščiukų;8235524536;Ne;10;0;0;10
8802;Riešutėlis;Viščiukų;2832538856;Ne;0;20;0;20
8803;Riešutėlis;Viščiukų;4426750525;Ne;1;0;1;2
8804;Riešutėlis;Viščiukų;9341748384;Ne;0;2;0;2
8805;Riešutėlis;"Riešutėliai ";3800733442;Ne;5;0;0;5
8806;Riešutėlis;"Riešutėliai ";2117939721;Ne;0;0;2;2
8807;Riešutėlis;"Riešutėliai ";1343776985;Ne;0;0;4;4
8808;Riešutėlis;"Riešutėliai ";5915019363;Ne;8;2;0;10
8809;Riešutėlis;"Riešutėliai ";2207907790;Ne;0;2;0;2
8810;Riešutėlis;"Riešutėliai ";9699503472;Ne;7;0;3;10
8811;Riešutėlis;"Riešutėliai ";2098369052;Ne;5;0;0;5
8812;Riešutėlis;"Riešutėliai ";1426700414;Ne;1;1;0;2
8813;Riešutėlis;"Riešutėliai ";2301247729;Ne;0;4;0;4
8814;Riešutėlis;"Riešutėliai ";3602707130;Ne;0;2;0;2
8815;Riešutėlis;"Riešutėliai ";8991963843;Ne;1;0;0;1
8816;Riešutėlis;"Riešutėliai ";4293402095;Ne;0;3;0;3
8817;Riešutėlis;"Riešutėliai ";8917451081;Ne;0;5;0;5
8818;Riešutėlis;"Riešutėliai ";4698338374;Ne;0;2;0;2
8819;Riešutėlis;"Riešutėliai ";3345064565;Ne;0;2;0;2
8820;Riešutėlis;"Riešutėliai ";9078282526;Ne;0;1;0;1
8821;Riešutėlis;"Riešutėliai ";6762306583;Taip;0;5;0;5
8822;Riešutėlis;Ežiukai;7030346495;Ne;5;8;1;14
8823;Riešutėlis;Ežiukai;9750713954;Ne;0;2;0;2
8824;Riešutėlis;Ežiukai;7601776182;Ne;5;4;0;9
8825;Riešutėlis;Ežiukai;7381623086;Ne;0;2;1;3
8826;Riešutėlis;Ežiukai;9964688413;Ne;9;0;0;9
8827;Riešutėlis;Ežiukai;1548585448;Ne;4;0;0;4
8828;Riešutėlis;Ežiukai;8954127616;Ne;0;2;5;7
8829;Riešutėlis;Ežiukai;2092933906;Ne;15;2;0;17
8830;Riešutėlis;Ežiukai;6813024366;Ne;0;1;1;2
8831;Riešutėlis;Ežiukai;7913381005;Taip;3;5;0;8
8832;Riešutėlis;Ežiukai;8480059272;Ne;5;3;0;8
8833;Riešutėlis;Ežiukai;5728858361;Ne;0;2;0;2
8834;Riešutėlis;Ežiukai;5327627748;Ne;0;9;1;10
8835;Riešutėlis;Ežiukai;6194259707;Ne;2;3;0;5
8836;Riešutėlis;Ežiukai;2837471235;Ne;0;15;0;15
8837;Riešutėlis;Ežiukai;2699984170;Ne;0;1;0;1
8838;Riešutėlis;Ežiukai;7050440691;Ne;4;0;5;9
8839;Riešutėlis;Ežiukai;3577669231;Ne;5;4;0;9
8840;Riešutėlis;Ežiukai;1818130297;Ne;0;4;0;4
8841;Riešutėlis;Pelėdžiukai;3975540383;Taip;0;0;3;3
8842;Riešutėlis;Pelėdžiukai;1705599429;Ne;15;0;1;16
8843;Riešutėlis;Pelėdžiukai;4116506453;Ne;0;0;2;2
8844;Riešutėlis;Pelėdžiukai;2467739101;Ne;0;1;0;1
8845;Riešutėlis;Pelėdžiukai;2587460110;Ne;8;0;2;10
8846;Riešutėlis;Pelėdžiukai;6147780439;Ne;8;1;0;9
8847;Riešutėlis;Pelėdžiukai;3287685792;Ne;0;0;1;1
8848;Riešutėlis;Pelėdžiukai;1811701628;Ne;7;0;1;8
8849;Riešutėlis;Pelėdžiukai;5183264581;Ne;0;9;0;9
8850;Riešutėlis;Pelėdžiukai;4866613045;Ne;0;0;9;9
8851;Riešutėlis;Pelėdžiukai;6121386391;Ne;17;1;0;18
8852;Riešutėlis;Pelėdžiukai;4448024452;Ne;5;0;0;5
8853;Riešutėlis;Pelėdžiukai;3251066115;Ne;1;2;0;3
8854;Riešutėlis;Pelėdžiukai;4808684145;Ne;5;1;0;6
8855;Riešutėlis;Pelėdžiukai;4897581681;Ne;15;0;0;15
8856;Riešutėlis;Pelėdžiukai;7256075146;Ne;14;1;0;15
8857;Riešutėlis;Pelėdžiukai;5443448616;Ne;5;4;0;9
8858;Riešutėlis;Pelėdžiukai;8839482370;Ne;5;10;0;15
8859;Riešutėlis;Pelėdžiukai;4692384639;Ne;0;0;3;3
8860;Riešutėlis;Meškiukai;5537309549;Ne;0;2;0;2
8861;Riešutėlis;Meškiukai;8271632629;Ne;5;0;0;5
8862;Riešutėlis;Meškiukai;4898775561;Ne;0;1;0;1
8863;Riešutėlis;Meškiukai;8313605541;Ne;0;1;0;1
8864;Riešutėlis;Meškiukai;7987368969;Ne;0;7;0;7
8865;Riešutėlis;Meškiukai;65873300738;Ne;0;5;0;5
8866;Riešutėlis;Meškiukai;26781529460;Ne;0;0;3;3
8867;Riešutėlis;Meškiukai;1936519033;Ne;0;2;1;3
8868;Riešutėlis;Meškiukai;4131218911;Ne;0;8;0;8
8869;Riešutėlis;Meškiukai;4276034784;Ne;0;4;0;4
8870;Riešutėlis;Meškiukai;4344185375;Ne;0;1;0;1
8871;Riešutėlis;Meškiukai;6594928740;Ne;5;0;0;5
8872;Riešutėlis;Meškiukai;2566084613;Ne;9;0;0;9
8873;Riešutėlis;Meškiukai;1640383686;Ne;5;0;0;5
8874;Riešutėlis;Meškiukai;8087180983;Ne;6;0;0;6
8875;Riešutėlis;Meškiukai;16561622902;Ne;7;1;0;8
8876;Riešutėlis;Meškiukai;2611705234;Ne;0;1;0;1
8877;Riešutėlis;Meškiukai;4404544549;Ne;0;3;0;3
8878;Riešutėlis;Meškiukai;1455509576;Taip;4;1;0;5
8879;Riešutėlis;Meškiukai;1709857621;Ne;0;2;0;2
8880;Riešutėlis;Kiškučiai;9297835044;Ne;0;1;0;1
8881;Riešutėlis;Kiškučiai;9086474785;Ne;0;0;3;3
8882;Riešutėlis;Kiškučiai;3363757821;Ne;14;1;0;15
8883;Riešutėlis;Kiškučiai;2581250615;Ne;0;0;1;1
8884;Riešutėlis;Kiškučiai;8445984114;Ne;20;0;0;20
8885;Riešutėlis;Kiškučiai;5266946070;Ne;0;0;4;4
8886;Riešutėlis;Kiškučiai;9357375649;Ne;0;2;0;2
8887;Riešutėlis;Kiškučiai;4851336076;Ne;0;7;0;7
8888;Riešutėlis;Kiškučiai;6705754238;Ne;0;8;0;8
8889;Riešutėlis;Kiškučiai;1111543507;Ne;0;1;0;1
8890;Riešutėlis;Kiškučiai;9964105252;Ne;3;0;0;3
8891;Riešutėlis;Kiškučiai;5846061115;Ne;1;8;0;9
8892;Riešutėlis;Kiškučiai;2618556733;Ne;10;4;1;15
8893;Riešutėlis;Voveriukų;5995176001;Ne;0;6;0;6
8894;Riešutėlis;Voveriukų;2430518637;Ne;8;2;0;10
8895;Riešutėlis;Voveriukų;7225365172;Ne;0;2;0;2
8896;Riešutėlis;Voveriukų;5479780116;Ne;0;1;0;1
8897;Riešutėlis;Voveriukų;4451419273;Ne;0;12;0;12
8898;Riešutėlis;Voveriukų;9040123535;Ne;0;8;0;8
8899;Riešutėlis;Voveriukų;8012201566;Ne;0;3;0;3
8900;Riešutėlis;Voveriukų;4581184004;Ne;8;0;0;8
8901;Riešutėlis;Voveriukų;1941869661;Ne;0;1;0;1
8902;Riešutėlis;Saulutės;4004669930;Taip;0;2;2;4
8903;Riešutėlis;Saulutės;7177632315;Ne;5;0;0;5
8904;Riešutėlis;Saulutės;6721758785;Ne;0;5;0;5
8905;Riešutėlis;Saulutės;1748151109;Ne;0;4;0;4
8906;Riešutėlis;Saulutės;8504832383;Ne;0;1;0;1
8907;Riešutėlis;Saulutės;6292679662;Ne;5;0;0;5
8908;Riešutėlis;Saulutės;8738716660;Ne;0;2;2;4
8909;Riešutėlis;Saulutės;4828635362;Ne;5;1;0;6
8910;Riešutėlis;Saulutės;1196740726;Ne;0;2;0;2
8911;Riešutėlis;Saulutės;8415858895;Ne;0;1;3;4
8912;Riešutėlis;Saulutės;4498718519;Ne;1;10;0;11
8913;Riešutėlis;Saulutės;5753609922;Ne;8;2;0;10
8914;Riešutėlis;Saulutės;1860995033;Ne;0;9;11;20
8915;Riešutėlis;Saulutės;5013754772;Ne;1;0;0;1
8916;Riešutėlis;Saulutės;7154361660;Ne;14;3;0;17
8917;Riešutėlis;Saulutės;2395391926;Ne;0;0;1;1
8918;Riešutėlis;Saulutės;2572642260;Ne;0;0;1;1
8919;Riešutėlis;Saulutės;3544780386;Ne;4;0;1;5
8920;Riešutėlis;"Boruželės ";4118652467;Taip;0;20;0;20
8921;Riešutėlis;"Boruželės ";5662911204;Ne;0;20;0;20
8922;Riešutėlis;"Boruželės ";7663823906;Ne;10;4;0;14
8923;Riešutėlis;"Boruželės ";5336618381;Ne;7;0;0;7
8924;Riešutėlis;"Boruželės ";7327578507;Ne;6;2;0;8
8925;Riešutėlis;"Boruželės ";6368610810;Ne;7;0;0;7
8926;Riešutėlis;"Boruželės ";7313602281;Ne;3;0;0;3
8927;Riešutėlis;"Boruželės ";9815988800;Ne;0;3;0;3
8928;Riešutėlis;"Boruželės ";6681930005;Ne;5;0;0;5
8929;Riešutėlis;"Boruželės ";2352984379;Ne;0;12;2;14
8930;Riešutėlis;"Boruželės ";2238641969;Ne;8;0;0;8
8931;Riešutėlis;"Boruželės ";6217500325;Ne;0;20;0;20
8932;Riešutėlis;"Boruželės ";1058206787;Ne;6;0;1;7
8933;Riešutėlis;"Boruželės ";9198289423;Ne;3;0;0;3
8934;Riešutėlis;"Boruželės ";1282121190;Ne;5;2;0;7
8935;Riešutėlis;"Boruželės ";2875416610;Ne;0;4;0;4
8936;Riešutėlis;"Bitutės ";8498902448;Ne;0;2;0;2
8937;Riešutėlis;"Bitutės ";2498093110;Taip;5;0;0;5
8938;Riešutėlis;"Bitutės ";2459494071;Ne;0;0;1;1
8939;Riešutėlis;"Bitutės ";3931422170;Ne;0;1;9;10
8940;Riešutėlis;"Bitutės ";4591910912;Ne;3;0;0;3
8941;Riešutėlis;"Bitutės ";9285782325;Ne;0;2;0;2
8942;Riešutėlis;"Bitutės ";7473054556;Ne;1;1;0;2
8943;Riešutėlis;"Bitutės ";3592271009;Taip;0;0;4;4
8944;Riešutėlis;"Bitutės ";4358354602;Ne;4;0;0;4
8945;Riešutėlis;Drugelių;4776231497;Ne;0;1;0;1
8946;Riešutėlis;Drugelių;8578903763;Ne;0;1;0;1
8947;Riešutėlis;Drugelių;5811657782;Ne;0;0;2;2
8948;Riešutėlis;Drugelių;4221375847;Ne;0;4;0;4
8949;Riešutėlis;Drugelių;1075842434;Ne;0;0;1;1
8950;Riešutėlis;Drugelių;1942944625;Ne;0;2;0;2
8951;Riešutėlis;Drugelių;8845709386;Ne;0;10;0;10
8952;Riešutėlis;Drugelių;8128352818;Ne;1;0;0;1
8953;Riešutėlis;Drugelių;8180618419;Ne;0;2;0;2
8954;Riešutėlis;Drugelių;5412882446;Ne;0;0;5;5
8955;Riešutėlis;Drugelių;8020533200;Ne;0;2;0;2
8956;Riešutėlis;Drugelių;1164273595;Ne;4;0;0;4
8957;Riešutėlis;Drugelių;3975091711;Ne;3;2;0;5
8958;Riešutėlis;Drugelių;3151689985;Ne;2;0;0;2
8959;Riešutėlis;Drugelių;4845447863;Ne;0;0;4;4
8960;Riešutėlis;Nykštukų;1858791074;Ne;17;0;0;17
8961;Riešutėlis;Nykštukų;3759837057;Ne;0;18;2;20
8962;Riešutėlis;Nykštukų;4740516426;Taip;4;0;6;10
8963;Riešutėlis;Nykštukų;3150141050;Ne;3;0;0;3
8964;Riešutėlis;Nykštukų;6580050526;Ne;0;1;0;1
8965;Riešutėlis;Nykštukų;4810919435;Ne;0;0;6;6
8966;Riešutėlis;Nykštukų;2736824231;Ne;0;0;2;2
8967;Riešutėlis;Nykštukų;2378301886;Ne;7;0;1;8
8968;Riešutėlis;Nykštukų;5262881964;Ne;5;0;1;6
8969;Riešutėlis;Nykštukų;4328166135;Ne;0;2;0;2
8970;Riešutėlis;Nykštukų;9052991215;Ne;0;0;20;20
8971;Riešutėlis;Nykštukų;6582898708;Taip;4;0;0;4
8972;Riešutėlis;Nykštukų;6318150385;Ne;3;0;0;3
8973;Riešutėlis;Nykštukų;4042719626;Ne;0;0;2;2
8974;Rytas;Geniukų;9286509610;Ne;10;0;0;10
8975;Rytas;Geniukų;4435466932;Ne;12;0;0;12
8976;Rytas;Geniukų;6829373692;Taip;10;0;0;10
8977;Rytas;Geniukų;4715624133;Ne;11;0;0;11
8978;Rytas;Geniukų;1441892690;Taip;6;0;0;6
8979;Rytas;Svirpliukų;1667124077;Ne;7;0;0;7
8980;Rytas;Svirpliukų;1207078884;Ne;3;0;0;3
8981;Rytas;Svirpliukų;1481377422;Ne;7;0;0;7
8982;Rytas;Svirpliukų;8036117292;Ne;6;0;0;6
8983;Rytas;Svirpliukų;7088145969;Ne;2;0;0;2
8984;Rytas;Svirpliukų;5975704054;Ne;9;0;0;9
8985;Rytas;Svirpliukų;8000993383;Ne;15;0;0;15
8986;Rytas;Bitučių;8391277346;Taip;3;0;0;3
8987;Rytas;Boružėlių;9765188299;Ne;5;0;0;5
8988;Rytas;Boružėlių;9742476588;Taip;1;0;0;1
8989;Rytas;Drugelių;4385206977;Ne;20;0;0;20
8990;Rytas;Drugelių;12832347269;Ne;11;0;0;11
8991;Rytas;Drugelių;4971244488;Ne;2;0;0;2
8992;Rytas;Drugelių;8138247168;Ne;1;0;0;1
8993;Rytas;Ežiukų;9579385117;Ne;3;0;0;3
8994;Rytas;Ežiukų;5237693162;Ne;6;0;0;6
8995;Rytas;Ežiukų;9178162382;Ne;4;0;0;4
8996;Rytas;Ežiukų;1746144722;Ne;1;0;0;1
8997;Rytas;Ežiukų;7561808676;Ne;6;0;0;6
8998;Rytas;Ežiukų;4317475484;Ne;7;0;0;7
8999;Rytas;Ežiukų;5650761566;Ne;5;0;0;5
9000;Rytas;Žirniukų;7879688720;Ne;15;0;0;15
9001;Rytas;Žirniukų;4294498286;Ne;4;0;0;4
9002;Rytas;Žirniukų;1485585025;Taip;13;0;0;13
9003;Rytas;Skruzdeliukų;9877419148;Ne;10;0;0;10
9004;Rytas;Skruzdeliukų;8909345826;Taip;15;0;0;15
9005;Rytas;Skruzdeliukų;5646044889;Ne;6;0;0;6
9006;Rytas;Skruzdeliukų;3491483644;Ne;8;0;0;8
9007;Rytas;Skruzdeliukų;2856549971;Ne;3;0;0;3
9008;Rytas;Pelėdžiukų;4840168929;Ne;5;0;0;5
9009;Rytas;Pelėdžiukų;6545610327;Ne;10;0;0;10
9010;Rytas;Vyturėlių;6401326313;Ne;14;0;0;14
9011;Rytas;Vyturėlių;3361675377;Ne;12;0;0;12
9012;Rytas;Vyturėlių;3562352818;Ne;12;0;0;12
9013;Rytas;Vyturėlių;1803237458;Ne;5;0;0;5
9014;Rytas;Vyturėlių;5277075222;Ne;2;0;0;2
9015;Rytas;Aitvarų;6051461683;Taip;1;0;0;1
9016;Rytas;Aitvarų;7302333643;Taip;3;0;0;3
9017;Rytas;Aitvarų;3525186681;Taip;6;0;0;6
9018;Rytas;Aitvarų;3581614009;Taip;4;0;0;4
9019;Rytas;Voveriukų;7250807043;Ne;1;0;0;1
9020;Rytas;Voveriukų;3997587185;Ne;3;0;0;3
9021;Rytas;Voveriukų;2956282831;Ne;6;0;0;6
9022;Rytas;Voveriukų;9619045618;Ne;4;0;0;4
9023;Rytas;Voveriukų;3618566807;Ne;5;0;0;5
9024;Rytas;Voveriukų;5410353706;Ne;13;0;0;13
9025;Rytas;Voveriukų;8428669650;Ne;14;0;0;14
9026;Rytas;NAUJA;6822686126;Ne;5;0;0;5
9027;Ramunėlė;SAULUTĖS;3852734401;Ne;0;1;0;1
9028;Ramunėlė;SAULUTĖS;1192743154;Ne;0;2;0;2
9029;Ramunėlė;SAULUTĖS;5714771643;Ne;0;11;0;11
9030;Ramunėlė;SAULUTĖS;4209191105;Ne;0;1;0;1
9031;Ramunėlė;SAULUTĖS;9927068798;Ne;0;3;2;5
9032;Ramunėlė;SAULUTĖS;8929122197;Ne;0;1;0;1
9033;Ramunėlė;SAULUTĖS;7219400182;Ne;0;1;0;1
9034;Ramunėlė;SAULUTĖS;3779769727;Ne;0;1;0;1
9035;Ramunėlė;SAULUTĖS;8912978935;Ne;0;2;0;2
9036;Ramunėlė;SAULUTĖS;9533155706;Ne;4;2;0;6
9037;Ramunėlė;SAULUTĖS;3109623760;Ne;0;0;2;2
9038;Ramunėlė;SAULUTĖS;2697757513;Ne;20;0;0;20
9039;Ramunėlė;ŽIBUTĖ;5650659504;Ne;0;1;0;1
9040;Ramunėlė;ŽIBUTĖ;6627399830;Ne;0;4;4;8
9041;Ramunėlė;ŽIBUTĖ;8726443989;Ne;5;2;0;7
9042;Ramunėlė;ŽIBUTĖ;5801760033;Ne;1;0;0;1
9043;Ramunėlė;ŽIBUTĖ;9136437288;Ne;0;2;0;2
9044;Ramunėlė;ŽIBUTĖ;6040461460;Ne;0;2;0;2
9045;Ramunėlė;ŽIBUTĖ;3879563193;Ne;0;9;0;9
9046;Ramunėlė;ŽIBUTĖ;2591052434;Ne;0;2;0;2
9047;Ramunėlė;ŽIBUTĖ;2446375037;Ne;0;2;2;4
9048;Ramunėlė;ŽIBUTĖ;5304803880;Ne;0;1;0;1
9049;Ramunėlė;ŽIBUTĖ;8055844166;Ne;5;4;0;9
9050;Ramunėlė;ŽIRNIUKAI;7721421570;Ne;0;1;0;1
9051;Ramunėlė;ŽIRNIUKAI;8942483792;Ne;15;0;8;23
9052;Ramunėlė;ŽIRNIUKAI;6674467484;Ne;0;18;0;18
9053;Ramunėlė;ŽIRNIUKAI;7593855877;Ne;0;2;0;2
9054;Ramunėlė;ŽIRNIUKAI;2177200537;Ne;1;2;0;3
9055;Ramunėlė;ŽIRNIUKAI;4269170508;Ne;17;0;2;19
9056;Ramunėlė;ŽIRNIUKAI;4076525701;Ne;0;0;1;1
9057;Ramunėlė;ŽIRNIUKAI;4139935502;Ne;14;9;0;23
9058;Ramunėlė;ŽIRNIUKAI;1833069020;Ne;8;2;2;12
9059;Ramunėlė;ŽIRNIUKAI;4875011312;Ne;0;3;0;3
9060;Ramunėlė;ŽIRNIUKAI;4084046207;Ne;29;0;0;29
9061;Ramunėlė;ŽIRNIUKAI;5017020616;Ne;0;1;0;1
9062;Ramunėlė;ŽIRNIUKAI;6458458913;Ne;0;1;0;1
9063;Ramunėlė;ŽIRNIUKAI;6225605784;Ne;0;2;3;5
9064;Ramunėlė;ŽIRNIUKAI;4805808663;Ne;13;6;0;19
9065;Ramunėlė;BITUTĖS;8098492540;Ne;1;6;0;7
9066;Ramunėlė;BITUTĖS;6329943991;Ne;1;4;13;18
9067;Ramunėlė;BITUTĖS;7307307882;Taip;0;12;0;12
9068;Ramunėlė;BITUTĖS;2225787182;Taip;0;2;0;2
9069;Ramunėlė;BITUTĖS;6166192468;Taip;0;3;0;3
9070;Ramunėlė;BITUTĖS;5865482869;Ne;0;10;0;10
9071;Ramunėlė;BITUTĖS;8940763540;Taip;5;10;0;15
9072;Ramunėlė;BITUTĖS;6843262303;Taip;2;0;1;3
9073;Ramunėlė;BITUTĖS;7692958269;Ne;0;0;6;6
9074;Ramunėlė;BITUTĖS;8086994543;Taip;0;1;0;1
9075;Ramunėlė;BITUTĖS;5822045625;Taip;0;2;0;2
9076;Ramunėlė;BITUTĖS;9789690425;Ne;0;11;0;11
9077;Ramunėlė;BITUTĖS;1182350830;Ne;9;0;3;12
9078;Ramunėlė;BITUTĖS;6342801407;Ne;10;7;1;18
9079;Ramunėlė;BITUTĖS;4022818032;Ne;4;1;0;5
9080;Ramunėlė;BITUTĖS;7220407572;Ne;5;1;0;6
9081;Ramunėlė;BITUTĖS;1916520056;Ne;0;13;0;13
9082;Ramunėlė;BITUTĖS;6892481929;Ne;0;7;0;7
9083;Ramunėlė;BITUTĖS;2558296296;Ne;5;0;0;5
9084;Ramunėlė;BITUTĖS;6881228078;Ne;0;2;0;2
9085;Ramunėlė;DRUGELIAI;9584620339;Ne;0;0;16;16
9086;Ramunėlė;DRUGELIAI;6930505887;Ne;0;4;1;5
9087;Ramunėlė;DRUGELIAI;8402889872;Ne;4;1;0;5
9088;Ramunėlė;DRUGELIAI;7228065409;Ne;0;7;0;7
9089;Ramunėlė;DRUGELIAI;5170325023;Ne;0;0;1;1
9090;Ramunėlė;DRUGELIAI;8768539595;Ne;0;7;0;7
9091;Ramunėlė;DRUGELIAI;1078618047;Ne;13;7;0;20
9092;Ramunėlė;DRUGELIAI;9984243153;Ne;11;0;0;11
9093;Ramunėlė;DRUGELIAI;1199673371;Ne;0;0;1;1
9094;Ramunėlė;DRUGELIAI;4392309015;Ne;0;0;2;2
9095;Ramunėlė;DRUGELIAI;5049415445;Ne;7;0;1;8
9096;Ramunėlė;DRUGELIAI;8460527225;Ne;1;6;0;7
9097;Ramunėlė;DRUGELIAI;1800967823;Ne;2;0;0;2
9098;Ramunėlė;DRUGELIAI;8205893352;Ne;5;1;0;6
9099;Ramunėlė;DRUGELIAI;6809164145;Ne;4;4;0;8
9100;Ramunėlė;DRUGELIAI;6837877393;Ne;9;3;0;12
9101;Ramunėlė;NEUŽMIRŠTUOLĖS;1797997937;Ne;4;0;0;4
9102;Ramunėlė;NEUŽMIRŠTUOLĖS;9326288662;Ne;3;0;0;3
9103;Ramunėlė;NEUŽMIRŠTUOLĖS;9928703066;Ne;6;0;0;6
9104;Ramunėlė;NEUŽMIRŠTUOLĖS;4756689520;Ne;0;2;0;2
9105;Ramunėlė;NEUŽMIRŠTUOLĖS;2070729684;Ne;0;1;0;1
9106;Ramunėlė;NEUŽMIRŠTUOLĖS;4329292281;Ne;9;0;0;9
9107;Ramunėlė;NEUŽMIRŠTUOLĖS;6613469006;Ne;0;9;0;9
9108;Ramunėlė;NEUŽMIRŠTUOLĖS;3106987206;Ne;0;0;1;1
9109;Ramunėlė;NEUŽMIRŠTUOLĖS;2281370785;Ne;9;4;0;13
9110;Ramunėlė;NEUŽMIRŠTUOLĖS;8643188779;Ne;18;0;3;21
9111;Ramunėlė;NEUŽMIRŠTUOLĖS;9012749913;Ne;5;10;0;15
9112;Ramunėlė;NEUŽMIRŠTUOLĖS;1728034615;Ne;0;2;0;2
9113;Ramunėlė;NEUŽMIRŠTUOLĖS;1579527330;Ne;0;24;0;24
9114;Ramunėlė;NEUŽMIRŠTUOLĖS;7519551613;Ne;5;8;0;13
9115;Ramunėlė;NEUŽMIRŠTUOLĖS;2880352109;Ne;29;0;0;29
9116;Ramunėlė;NEUŽMIRŠTUOLĖS;3949246652;Ne;19;0;1;20
9117;Ramunėlė;NEUŽMIRŠTUOLĖS;3045477012;Ne;3;4;1;8
9118;Ramunėlė;NEUŽMIRŠTUOLĖS;5267145991;Ne;0;8;0;8
9119;Ramunėlė;NEUŽMIRŠTUOLĖS;1181787182;Ne;0;0;1;1
9120;Ramunėlė;NEUŽMIRŠTUOLĖS;7388319344;Ne;0;18;0;18
9121;Ramunėlė;OBUOLIUKAI;3683181174;Ne;0;3;1;4
9122;Ramunėlė;OBUOLIUKAI;7364976547;Ne;3;4;0;7
9123;Ramunėlė;OBUOLIUKAI;6156792400;Ne;0;1;0;1
9124;Ramunėlė;OBUOLIUKAI;4233978236;Ne;5;5;0;10
9125;Ramunėlė;OBUOLIUKAI;2983986428;Ne;0;25;0;25
9126;Ramunėlė;OBUOLIUKAI;5548358138;Ne;0;1;0;1
9127;Ramunėlė;OBUOLIUKAI;2427399083;Ne;0;2;2;4
9128;Ramunėlė;OBUOLIUKAI;2422656007;Ne;8;5;1;14
9129;Ramunėlė;OBUOLIUKAI;8623311748;Ne;0;4;0;4
9130;Ramunėlė;OBUOLIUKAI;6849205606;Ne;0;1;3;4
9131;Ramunėlė;OBUOLIUKAI;6604244856;Ne;0;1;0;1
9132;Ramunėlė;OBUOLIUKAI;8617271247;Ne;1;3;0;4
9133;Ramunėlė;OBUOLIUKAI;5610672420;Ne;14;0;0;14
9134;Ramunėlė;OBUOLIUKAI;4400154355;Ne;0;0;5;5
9135;Ramunėlė;OBUOLIUKAI;7250951221;Ne;0;2;1;3
9136;Ramunėlė;OBUOLIUKAI;3802924434;Ne;10;2;0;12
9137;Ramunėlė;OBUOLIUKAI;6981729247;Ne;11;2;0;13
9138;Ramunėlė;SAULĖGRĄŽA;2458101652;Ne;5;0;2;7
9139;Ramunėlė;SAULĖGRĄŽA;9663304288;Ne;19;0;2;21
9140;Ramunėlė;SAULĖGRĄŽA;5398069413;Ne;8;0;0;8
9141;Ramunėlė;SAULĖGRĄŽA;7873462803;Ne;12;0;4;16
9142;Ramunėlė;SAULĖGRĄŽA;3793779715;Ne;0;7;4;11
9143;Ramunėlė;SAULĖGRĄŽA;6775947111;Ne;0;0;26;26
9144;Ramunėlė;SAULĖGRĄŽA;1102946363;Ne;14;0;1;15
9145;Ramunėlė;SAULĖGRĄŽA;3603956795;Ne;10;1;0;11
9146;Ramunėlė;SAULĖGRĄŽA;4902056654;Ne;10;1;0;11
9147;Ramunėlė;SAULĖGRĄŽA;7563892184;Ne;12;1;0;13
9148;Ramunėlė;SAULĖGRĄŽA;3801952385;Ne;5;2;0;7
9149;Ramunėlė;SAULĖGRĄŽA;9120142666;Taip;6;0;1;7
9150;Ramunėlė;SAULĖGRĄŽA;6942789511;Ne;11;0;0;11
9151;Ramunėlė;SAULĖGRĄŽA;2415377154;Ne;7;3;5;15
9152;Ramunėlė;SAULĖGRĄŽA;9076692864;Ne;3;2;0;5
9153;Ramunėlė;BORUŽĖLĖS;7825538259;Ne;7;2;0;9
9154;Ramunėlė;BORUŽĖLĖS;8496322672;Ne;5;0;2;7
9155;Ramunėlė;BORUŽĖLĖS;6695672297;Ne;3;2;0;5
9156;Ramunėlė;BORUŽĖLĖS;7295041630;Ne;0;1;0;1
9157;Ramunėlė;BORUŽĖLĖS;58028743912;Ne;12;0;1;13
9158;Ramunėlė;BORUŽĖLĖS;1216101539;Ne;0;13;0;13
9159;Ramunėlė;BORUŽĖLĖS;4677819736;Ne;8;0;3;11
9160;Ramunėlė;BORUŽĖLĖS;3554787356;Ne;0;0;5;5
9161;Ramunėlė;BORUŽĖLĖS;6310921755;Ne;0;1;0;1
9162;Ramunėlė;BORUŽĖLĖS;3685786758;Ne;0;2;0;2
9163;Ramunėlė;BORUŽĖLĖS;6837072361;Ne;0;3;5;8
9164;Ramunėlė;BORUŽĖLĖS;1534723406;Ne;6;4;1;11
9165;Ramunėlė;BORUŽĖLĖS;8323020864;Ne;0;0;6;6
9166;Ramunėlė;BORUŽĖLĖS;9924675250;Ne;0;2;2;4
9167;Ramunėlė;BORUŽĖLĖS;6251432968;Ne;0;1;0;1
9168;Ramunėlė;NYKŠTUKAS;3166386231;Ne;4;1;0;5
9169;Ramunėlė;NYKŠTUKAS;8045080504;Ne;5;1;0;6
9170;Ramunėlė;NYKŠTUKAS;6983139076;Ne;10;0;0;10
9171;Ramunėlė;NYKŠTUKAS;7639613472;Ne;0;23;0;23
9172;Ramunėlė;NYKŠTUKAS;4642590173;Ne;3;3;0;6
9173;Ramunėlė;NYKŠTUKAS;9549605315;Ne;8;0;1;9
9174;Ramunėlė;NYKŠTUKAS;4491147309;Ne;5;0;9;14
9175;Ramunėlė;NYKŠTUKAS;4040520907;Ne;3;3;0;6
9176;Ramunėlė;NYKŠTUKAS;7542328641;Ne;9;0;0;9
9177;Ramunėlė;NYKŠTUKAS;1277413234;Ne;1;4;0;5
9178;Ramunėlė;NYKŠTUKAS;1215510902;Ne;5;6;0;11
9179;Ramunėlė;NYKŠTUKAS;8218201930;Ne;0;24;0;24
9180;Ramunėlė;NYKŠTUKAS;2760710235;Ne;4;0;0;4
9181;Ramunėlė;NYKŠTUKAS;5573083546;Ne;2;2;0;4
9182;Ramunėlė;NYKŠTUKAS;4376812983;Ne;16;0;1;17
9183;Ramunėlė;NYKŠTUKAS;1802650607;Ne;2;0;0;2
9184;Ramunėlė;UOGELĖ;6294697776;Ne;0;9;0;9
9185;Ramunėlė;UOGELĖ;7005354909;Ne;3;3;0;6
9186;Ramunėlė;UOGELĖ;5665429647;Ne;10;2;0;12
9187;Ramunėlė;UOGELĖ;9180197156;Ne;4;1;0;5
9188;Ramunėlė;UOGELĖ;5108864184;Ne;5;1;0;6
9189;Ramunėlė;UOGELĖ;4321527067;Ne;10;4;0;14
9190;Ramunėlė;UOGELĖ;7896711579;Ne;17;1;0;18
9191;Ramunėlė;UOGELĖ;5726947811;Ne;0;4;2;6
9192;Ramunėlė;UOGELĖ;1729152997;Ne;25;0;0;25
9193;Ramunėlė;UOGELĖ;7926168752;Taip;18;0;2;20
9194;Ramunėlė;UOGELĖ;5498856861;Ne;12;0;0;12
9195;Ramunėlė;UOGELĖ;3024065664;Ne;4;5;0;9
9196;Ramunėlė;UOGELĖ;1666033483;Ne;6;3;2;11
9197;Ramunėlė;UOGELĖ;9994601365;Ne;5;7;15;27
9198;Ramunėlė;UOGELĖ;2620747378;Ne;3;5;1;9
9199;Ramunėlė;VARPELIAI;1159457001;Ne;20;2;0;22
9200;Ramunėlė;VARPELIAI;6606966969;Ne;4;0;0;4
9201;Ramunėlė;VARPELIAI;9292235402;Taip;3;0;1;4
9202;Ramunėlė;VARPELIAI;1811931985;Ne;0;1;0;1
9203;Ramunėlė;VARPELIAI;1818513881;Ne;8;1;0;9
9204;Ramunėlė;VARPELIAI;4581826404;Ne;3;1;0;4
9205;Ramunėlė;VARPELIAI;8310875815;Ne;0;1;0;1
9206;Ramunėlė;VARPELIAI;1491688322;Ne;1;3;2;6
9207;Ramunėlė;VARPELIAI;5703289545;Ne;0;0;5;5
9208;Ramunėlė;VARPELIAI;9934852622;Ne;0;4;0;4
9209;Ramunėlė;VARPELIAI;4968998913;Ne;0;0;1;1
9210;Ramunėlė;VARPELIAI;3996453947;Ne;0;3;0;3
9211;Ramunėlė;VARPELIAI;3461269451;Ne;5;0;0;5
9212;Ramunėlė;VARPELIAI;3474578046;Ne;0;1;0;1
9213;Ramunėlė;VARPELIAI;7544671346;Ne;4;3;0;7
9214;Ramunėlė;VARPELIAI;5544992493;Ne;0;6;0;6
9215;Ramunėlė;VARPELIAI;6433856416;Ne;0;4;0;4
9216;Ramunėlė;VARPELIAI;3542912372;Ne;15;1;0;16
9217;Ramunėlė;VARPELIAI;3735308599;Ne;6;0;0;6
9218;Ramunėlė;VARPELIAI;3272747656;Ne;5;1;0;6
9219;Ramunėlė;VARPELIAI;6347893013;Ne;0;1;0;1
9220;Rūta;SMALSUČIAI;5899860543;Ne;0;9;0;9
9221;Rūta;SMALSUČIAI;1346124133;Ne;0;5;0;5
9222;Rūta;SMALSUČIAI;4728904136;Ne;0;2;0;2
9223;Rūta;SMALSUČIAI;9791861646;Ne;5;0;0;5
9224;Rūta;SMALSUČIAI;2928803089;Ne;0;1;0;1
9225;Rūta;SMALSUČIAI;8378318357;Ne;0;3;0;3
9226;Rūta;SMALSUČIAI;1951202550;Ne;4;0;3;7
9227;Rūta;SMALSUČIAI;3875136625;Ne;8;1;0;9
9228;Rūta;SMALSUČIAI;9911151238;Ne;0;0;2;2
9229;Rūta;SMALSUČIAI;7434152435;Ne;0;4;0;4
9230;Rūta;SMALSUČIAI;3843325181;Ne;0;0;2;2
9231;Rūta;SMALSUČIAI;6316768460;Ne;0;0;12;12
9232;Rūta;SMALSUČIAI;8182243701;Ne;8;1;0;9
9233;Rūta;SMALSUČIAI;7680605199;Taip;9;2;0;11
9234;Rūta;SMALSUČIAI;6075632046;Ne;0;10;0;10
9235;Rūta;SMALSUČIAI;1035527190;Ne;0;0;6;6
9236;Rūta;KŪLVERSTUKAI;4423305209;Ne;6;0;0;6
9237;Rūta;KŪLVERSTUKAI;9736567509;Ne;0;1;0;1
9238;Rūta;KŪLVERSTUKAI;7519931138;Ne;4;0;0;4
9239;Rūta;KŪLVERSTUKAI;4880804625;Ne;5;2;1;8
9240;Rūta;KŪLVERSTUKAI;3499727608;Ne;0;2;0;2
9241;Rūta;KŪLVERSTUKAI;9765301038;Ne;0;2;0;2
9242;Rūta;KŪLVERSTUKAI;9638495757;Taip;0;0;2;2
9243;Rūta;KŪLVERSTUKAI;8605070655;Ne;0;1;1;2
9244;Rūta;KŪLVERSTUKAI;7553844890;Ne;0;6;0;6
9245;Rūta;KŪLVERSTUKAI;3964922552;Ne;2;1;0;3
9246;Rūta;KŪLVERSTUKAI;8395765508;Ne;0;10;0;10
9247;Rūta;KŪLVERSTUKAI;9400586178;Ne;0;4;0;4
9248;Rūta;KŪLVERSTUKAI;3956912957;Ne;0;1;2;3
9249;Rūta;KŪLVERSTUKAI;2890569107;Ne;4;2;0;6
9250;Rūta;KŪLVERSTUKAI;2474991135;Ne;4;1;2;7
9251;Rūta;KŪLVERSTUKAI;1216786487;Ne;0;3;0;3
9252;Rūta;KŪLVERSTUKAI;9245618776;Ne;0;14;0;14
9253;Rūta;KŪLVERSTUKAI;5109138407;Taip;3;0;0;3
9254;Rūta;KŪLVERSTUKAI;6096664609;Ne;2;0;1;3
9255;Rūta;KODĖLČIUKAI;5962981130;Ne;5;0;1;6
9256;Rūta;KODĖLČIUKAI;4347678781;Ne;9;0;0;9
9257;Rūta;KODĖLČIUKAI;3736279705;Ne;6;0;3;9
9258;Rūta;KODĖLČIUKAI;8416455711;Ne;0;1;0;1
9259;Rūta;KODĖLČIUKAI;8668510009;Ne;15;0;0;15
9260;Rūta;KODĖLČIUKAI;2547849837;Ne;2;0;0;2
9261;Rūta;KODĖLČIUKAI;8883578144;Ne;4;0;6;10
9262;Rūta;KODĖLČIUKAI;4546082355;Ne;0;9;0;9
9263;Rūta;KODĖLČIUKAI;1000645885;Ne;0;3;0;3
9264;Rūta;KODĖLČIUKAI;5766392854;Ne;8;8;0;16
9265;Rūta;KODĖLČIUKAI;4944413811;Ne;1;0;0;1
9266;Rūta;KODĖLČIUKAI;9916296056;Ne;16;0;0;16
9267;Rūta;KODĖLČIUKAI;4656138649;Ne;0;0;1;1
9268;Rūta;KODĖLČIUKAI;1605412505;Ne;0;0;6;6
9269;Rūta;KODĖLČIUKAI;2492891254;Ne;0;12;0;12
9270;Rūta;BORUŽĖLĖS;7712500278;Ne;0;4;0;4
9271;Rūta;BORUŽĖLĖS;8945868791;Ne;0;0;8;8
9272;Rūta;BORUŽĖLĖS;8023404173;Ne;1;0;4;5
9273;Rūta;BORUŽĖLĖS;3348066709;Ne;0;0;2;2
9274;Rūta;BORUŽĖLĖS;4279367893;Taip;10;0;2;12
9275;Rūta;BORUŽĖLĖS;5141290453;Ne;6;0;0;6
9276;Rūta;BORUŽĖLĖS;6587625933;Ne;0;1;1;2
9277;Rūta;BORUŽĖLĖS;8303314520;Ne;10;0;0;10
9278;Rūta;BORUŽĖLĖS;3470052541;Ne;0;0;4;4
9279;Rūta;BORUŽĖLĖS;2625691851;Ne;0;8;0;8
9280;Rūta;BORUŽĖLĖS;1804222979;Ne;1;0;2;3
9281;Rūta;BORUŽĖLĖS;5624054621;Ne;0;0;1;1
9282;Rūta;VYTURĖLIAI;1967141665;Ne;0;0;4;4
9283;Rūta;VYTURĖLIAI;3873876608;Ne;5;0;0;5
9284;Rūta;VYTURĖLIAI;8851591109;Ne;0;0;3;3
9285;Rūta;VYTURĖLIAI;1276704331;Ne;0;0;3;3
9286;Rūta;VYTURĖLIAI;6207902435;Ne;0;3;0;3
9287;Rūta;VYTURĖLIAI;8889388348;Ne;0;0;1;1
9288;Rūta;VYTURĖLIAI;1346367896;Ne;4;0;0;4
9289;Rūta;VYTURĖLIAI;4363571135;Ne;0;2;0;2
9290;Rūta;VYTURĖLIAI;1521231573;Ne;0;1;0;1
9291;Rūta;VYTURĖLIAI;7552644990;Ne;0;0;4;4
9292;Rūta;VYTURĖLIAI;8673942478;Ne;0;6;0;6
9293;Rūta;VYTURĖLIAI;4754142240;Ne;0;1;0;1
9294;Rūta;VYTURĖLIAI;1565896222;Ne;0;1;0;1
9295;Rūta;VYTURĖLIAI;7631229177;Ne;12;1;0;13
9296;Rūta;"PABIRUČIAI (LOGOPEDINĖ)";8763382361;Ne;0;0;14;14
9297;Rūta;"PABIRUČIAI (LOGOPEDINĖ)";5871960113;Ne;1;0;0;1
9298;Rūta;"PABIRUČIAI (LOGOPEDINĖ)";5211104903;Ne;0;9;0;9
9299;Rūta;GUDRUČIAI;4044349935;Ne;10;0;0;10
9300;Rūta;GUDRUČIAI;3998791775;Ne;5;0;2;7
9301;Rūta;GUDRUČIAI;3462986405;Ne;3;2;3;8
9302;Rūta;GUDRUČIAI;8548089843;Taip;0;0;1;1
9303;Rūta;GUDRUČIAI;4293920701;Ne;0;0;1;1
9304;Rūta;GUDRUČIAI;9589117921;Ne;0;2;0;2
9305;Rūta;GUDRUČIAI;3044976169;Ne;0;0;1;1
9306;Rūta;GUDRUČIAI;2546023973;Ne;0;0;1;1
9307;Rūta;GUDRUČIAI;8273644943;Ne;0;1;0;1
9308;Rūta;GUDRUČIAI;8963959004;Ne;0;1;2;3
9309;Rūta;GUDRUČIAI;1811055786;Ne;0;1;0;1
9310;Rūta;GUDRUČIAI;1510268514;Ne;9;1;0;10
9311;Rūta;GUDRUČIAI;6814051598;Ne;0;2;0;2
9312;Rūta;GUDRUČIAI;2702537976;Ne;0;1;0;1
9313;Rūta;GUDRUČIAI;1623968580;Ne;0;0;5;5
9314;Rūta;GUDRUČIAI;8592528906;Ne;0;0;2;2
9315;Rūta;GUDRUČIAI;1182222976;Ne;0;5;0;5
9316;Rūta;SEKLYTĖLĖ;4823677957;Ne;0;3;0;3
9317;Rūta;SEKLYTĖLĖ;1301573542;Ne;0;1;0;1
9318;Rūta;SEKLYTĖLĖ;3567273206;Ne;10;2;0;12
9319;Rūta;SEKLYTĖLĖ;1671913833;Ne;0;1;0;1
9320;Rūta;SEKLYTĖLĖ;1186493111;Ne;0;4;0;4
9321;Rūta;SEKLYTĖLĖ;9675482322;Ne;0;3;0;3
9322;Rūta;SEKLYTĖLĖ;3820689725;Ne;0;1;0;1
9323;Rūta;SEKLYTĖLĖ;1415664888;Ne;0;13;0;13
9324;Rūta;SEKLYTĖLĖ;4282074540;Ne;4;4;0;8
9325;Rūta;SEKLYTĖLĖ;8607455403;Ne;0;5;0;5
9326;Rūta;SEKLYTĖLĖ;4168356825;Ne;4;0;0;4
9327;Rūta;SEKLYTĖLĖ;2677062861;Ne;2;2;0;4
9328;Rūta;SEKLYTĖLĖ;1390207547;Ne;0;1;0;1
9329;Rūta;SEKLYTĖLĖ;32004750783;Ne;0;1;0;1
9330;Rūta;SEKLYTĖLĖ;2912054049;Ne;8;0;0;8
9331;Rūta;"VARPELIAI (LOGOPEDINĖ)";3055294324;Ne;0;3;0;3
9332;Rūta;"VARPELIAI (LOGOPEDINĖ)";3810636967;Ne;0;1;0;1
9333;Rūta;"VARPELIAI (LOGOPEDINĖ)";2584812163;Ne;0;1;0;1
9334;Rūta;"VARPELIAI (LOGOPEDINĖ)";6032985748;Ne;0;7;0;7
9335;Rūta;"VARPELIAI (LOGOPEDINĖ)";4858914868;Ne;0;0;2;2
9336;Rūta;KIŠKUČIŲ;7837861265;Ne;0;0;1;1
9337;Rūta;KIŠKUČIŲ;2601011765;Taip;5;0;8;13
9338;Rūta;KIŠKUČIŲ;5579794648;Ne;0;6;0;6
9339;Rūta;KIŠKUČIŲ;4165080541;Ne;0;0;4;4
9340;Rūta;KIŠKUČIŲ;3877807687;Taip;5;0;1;6
9341;Rūta;KIŠKUČIŲ;9429856388;Ne;0;0;1;1
9342;Rūta;KIŠKUČIŲ;8483916287;Ne;10;0;0;10
9343;Rūta;KIŠKUČIŲ;7724451685;Ne;1;0;1;2
9344;Rūta;KIŠKUČIŲ;8138816581;Taip;0;0;20;20
9345;Rūta;KIŠKUČIŲ;2733932207;Taip;10;3;0;13
9346;Rūta;KIŠKUČIŲ;9471291067;Ne;0;4;0;4
9347;Rūta;KIŠKUČIŲ;8012225409;Ne;10;0;0;10
9348;Rūta;KIŠKUČIŲ;1290867375;Ne;0;7;0;7
9349;Rūta;KIŠKUČIŲ;2084935094;Ne;4;0;2;6
9350;Rūta;KIŠKUČIŲ;6088978998;Ne;0;0;11;11
9351;Rūta;KIŠKUČIŲ;8320791295;Ne;6;0;0;6
9352;Rūta;KIŠKUČIŲ;3109709043;Ne;9;0;6;15
9353;Rūta;KIŠKUČIŲ;2830990163;Ne;0;0;1;1
9354;Rūta;KIŠKUČIŲ;4780828296;Ne;0;0;2;2
9355;Rūta;ŽVIRBLIUKAI;3352007694;Ne;4;0;3;7
9356;Rūta;ŽVIRBLIUKAI;9243332756;Ne;0;2;0;2
9357;Rūta;ŽVIRBLIUKAI;1059126758;Ne;0;4;0;4
9358;Rūta;ŽVIRBLIUKAI;6417693659;Ne;0;1;10;11
9359;Rūta;ŽVIRBLIUKAI;4090915728;Ne;0;2;0;2
9360;Rūta;ŽVIRBLIUKAI;4466522924;Ne;5;7;3;15
9361;Rūta;ŽVIRBLIUKAI;7905893575;Ne;6;0;14;20
9362;Rūta;ŽVIRBLIUKAI;4436482805;Ne;0;1;0;1
9363;Rūta;ŽVIRBLIUKAI;1260386759;Ne;0;1;0;1
9364;Rūta;ŽVIRBLIUKAI;6044060646;Ne;5;2;3;10
9365;Rūta;ŽVIRBLIUKAI;9220661972;Ne;0;5;0;5
9366;Rūta;ŽVIRBLIUKAI;5109026000;Ne;0;6;0;6
9367;Rūta;ŽVIRBLIUKAI;4776631890;Ne;0;0;2;2
9368;Rūta;ŽVIRBLIUKAI;4440148328;Ne;10;0;0;10
9369;Rūta;ŽVIRBLIUKAI;1671179652;Ne;5;0;9;14
9370;Rūta;ŽVIRBLIUKAI;1152453609;Ne;0;3;0;3
9371;Rūta;ŽVIRBLIUKAI;9012256437;Ne;4;2;0;6
9372;Rūta;SAULUTĖS;6869693434;Ne;0;0;1;1
9373;Rūta;SAULUTĖS;6585842434;Ne;0;0;2;2
9374;Rūta;SAULUTĖS;6620957022;Taip;0;0;3;3
9375;Rūta;SAULUTĖS;8806743371;Ne;1;0;1;2
9376;Rūta;SAULUTĖS;2391120026;Ne;1;0;1;2
9377;Rūta;SAULUTĖS;3765741047;Ne;0;1;0;1
9378;Rūta;SAULUTĖS;2685515977;Ne;7;1;0;8
9379;Rūta;SAULUTĖS;9308127402;Taip;0;0;1;1
9380;Rūta;SAULUTĖS;7422059414;Taip;0;11;0;11
9381;Rūta;SAULUTĖS;8479424939;Ne;6;0;2;8
9382;Rūta;SAULUTĖS;9014433476;Ne;0;7;0;7
9383;Rūta;SAULUTĖS;1207463357;Ne;9;0;2;11
9384;Rūta;SAULUTĖS;1131910047;Ne;0;14;0;14
9385;Rūta;SAULUTĖS;8715921452;Ne;13;0;1;14
9386;Sadutė;Kiškučiai;6645848193;Ne;0;1;0;1
9387;Sadutė;Kiškučiai;1589424708;Ne;0;1;0;1
9388;Sadutė;Kiškučiai;5992865266;Ne;4;0;0;4
9389;Sadutė;Kiškučiai;3568132830;Ne;0;20;0;20
9390;Sadutė;Kiškučiai;6652070415;Ne;0;0;8;8
9391;Sadutė;Kiškučiai;6493110772;Ne;0;0;1;1
9392;Sadutė;Kiškučiai;4075714061;Ne;1;0;0;1
9393;Sadutė;Kiškučiai;3285448692;Ne;0;1;0;1
9394;Sadutė;Kiškučiai;2845125335;Ne;0;1;0;1
9395;Sadutė;Kiškučiai;4135398332;Ne;0;4;0;4
9396;Sadutė;Kiškučiai;3954151590;Ne;0;0;2;2
9397;Sadutė;Kiškučiai;1860645542;Ne;0;0;3;3
9398;Sadutė;Boružėlės;9115304973;Ne;0;0;2;2
9399;Sadutė;Boružėlės;8442967732;Ne;0;0;2;2
9400;Sadutė;Boružėlės;1273355194;Ne;8;0;0;8
9401;Sadutė;Boružėlės;3119547420;Ne;8;0;0;8
9402;Sadutė;Boružėlės;6994383907;Ne;5;0;0;5
9403;Sadutė;Boružėlės;8914509685;Ne;0;0;1;1
9404;Sadutė;Boružėlės;3875265137;Ne;0;0;2;2
9405;Sadutė;Boružėlės;5992119777;Ne;2;1;1;4
9406;Sadutė;Boružėlės;5682745869;Ne;0;0;1;1
9407;Sadutė;Boružėlės;7072437339;Ne;1;0;0;1
9408;Sadutė;Boružėlės;5579040052;Ne;2;5;0;7
9409;Sadutė;Boružėlės;3362830536;Ne;0;0;6;6
9410;Sadutė;Boružėlės;5395676303;Ne;0;0;1;1
9411;Sadutė;Boružėlės;5698462283;Ne;10;0;0;10
9412;Sadutė;Boružėlės;3845369333;Ne;13;0;0;13
9413;Sadutė;Boružėlės;8200891038;Ne;3;0;3;6
9414;Sadutė;Boružėlės;4696990344;Ne;8;0;1;9
9415;Sadutė;Bitutės;1759479328;Ne;3;1;2;6
9416;Sadutė;Bitutės;4245873513;Ne;0;1;1;2
9417;Sadutė;Bitutės;1873928395;Ne;3;1;0;4
9418;Sadutė;Bitutės;4883934480;Ne;5;1;0;6
9419;Sadutė;Bitutės;4479315578;Ne;0;1;2;3
9420;Sadutė;Bitutės;2020766695;Ne;0;20;0;20
9421;Sadutė;Bitutės;5011320850;Ne;4;0;3;7
9422;Sadutė;Bitutės;4161502667;Ne;2;1;2;5
9423;Sadutė;Bitutės;5973513916;Ne;0;4;0;4
9424;Sadutė;Bitutės;5169694660;Ne;1;0;0;1
9425;Sadutė;Bitutės;3361904803;Ne;2;0;3;5
9426;Sadutė;Bitutės;1231048342;Ne;6;1;3;10
9427;Sadutė;Bitutės;2355177889;Ne;0;0;1;1
9428;Sadutė;Bitutės;8556086501;Ne;2;1;0;3
9429;Sadutė;Bitutės;6066145909;Ne;15;0;0;15
9430;Sadutė;Bitutės;5142566738;Ne;12;1;1;14
9431;Sadutė;Bitutės;8662375739;Ne;6;1;3;10
9432;Sadutė;Bitutės;9692905987;Ne;0;0;5;5
9433;Sadutė;Bitutės;9107727583;Ne;0;0;3;3
9434;Sadutė;Bitutės;6138604955;Ne;0;1;0;1
9435;Sadutė;Drugeliai;9090754149;Ne;0;2;0;2
9436;Sadutė;Drugeliai;1552350084;Ne;0;3;0;3
9437;Sadutė;Drugeliai;7910380894;Ne;0;1;0;1
9438;Sadutė;Drugeliai;4402558234;Ne;0;2;0;2
9439;Sadutė;Drugeliai;5816844295;Ne;0;1;0;1
9440;Sadutė;Drugeliai;8803249656;Ne;2;2;0;4
9441;Sadutė;Drugeliai;6196282159;Ne;13;0;0;13
9442;Sadutė;Drugeliai;5139219626;Ne;0;4;1;5
9443;Sadutė;Drugeliai;1735450955;Ne;0;13;0;13
9444;Sadutė;Drugeliai;2064784580;Ne;0;12;0;12
9445;Sadutė;Drugeliai;6124376554;Ne;6;0;0;6
9446;Sadutė;Drugeliai;4623727349;Ne;0;2;0;2
9447;Sadutė;Drugeliai;7940706717;Ne;8;0;1;9
9448;Sadutė;Drugeliai;3457375001;Ne;0;0;3;3
9449;Sadutė;Pėledžiukai;9136727429;Ne;0;2;2;4
9450;Sadutė;Pėledžiukai;5616756293;Ne;0;20;0;20
9451;Sadutė;Pėledžiukai;2705458480;Ne;12;0;2;14
9452;Sadutė;Pėledžiukai;6314488650;Ne;0;0;2;2
9453;Sadutė;Pėledžiukai;6126235707;Ne;11;0;0;11
9454;Sadutė;Pėledžiukai;1537482438;Ne;0;0;3;3
9455;Sadutė;Pėledžiukai;7730645448;Taip;0;0;4;4
9456;Sadutė;Pėledžiukai;7551299839;Ne;5;0;0;5
9457;Sadutė;Pėledžiukai;8914706717;Ne;0;19;1;20
9458;Sadutė;Pėledžiukai;5385678913;Ne;6;0;0;6
9459;Sadutė;Pėledžiukai;2055127699;Ne;11;0;0;11
9460;Sadutė;Pėledžiukai;2747256989;Ne;11;2;0;13
9461;Sadutė;Kačiukų;1507052440;Ne;0;6;0;6
9462;Sadutė;Kačiukų;1903961488;Ne;0;1;0;1
9463;Sadutė;Kačiukų;2890916313;Ne;0;0;1;1
9464;Sadutė;Kačiukų;3993181500;Ne;0;10;2;12
9465;Sadutė;Kačiukų;8835627470;Ne;3;0;0;3
9466;Sadutė;Kačiukų;2426974464;Ne;10;0;0;10
9467;Sadutė;Kačiukų;8974374101;Ne;0;0;9;9
9468;Sadutė;Kačiukų;4401870028;Ne;0;1;0;1
9469;Sadutė;Kačiukų;8714168144;Ne;0;7;0;7
9470;Sadutė;Kačiukų;3927044011;Taip;2;5;0;7
9471;Sadutė;Kačiukų;8770727233;Ne;4;0;0;4
9472;Sadutė;Kačiukų;8556218971;Ne;8;0;0;8
9473;Sadutė;Kačiukų;5267093203;Ne;16;0;2;18
9474;Sadutė;Kačiukų;5614758320;Ne;0;15;0;15
9475;Sadutė;Kačiukų;2194387139;Ne;5;0;0;5
9476;Sakalėlis;GIRINUKŲ;9566176151;Ne;9;0;0;9
9477;Sakalėlis;GIRINUKŲ;5405669698;Ne;0;1;2;3
9478;Sakalėlis;GIRINUKŲ;2474164013;Ne;0;1;3;4
9479;Sakalėlis;GIRINUKŲ;9493905856;Ne;0;0;3;3
9480;Sakalėlis;GIRINUKŲ;5496044442;Ne;15;0;1;16
9481;Sakalėlis;GIRINUKŲ;3418702674;Ne;0;0;2;2
9482;Sakalėlis;GIRINUKŲ;3748865437;Ne;4;0;0;4
9483;Sakalėlis;GIRINUKŲ;6700169944;Ne;4;0;5;9
9484;Sakalėlis;GIRINUKŲ;3333037807;Ne;6;0;0;6
9485;Sakalėlis;GIRINUKŲ;8667155756;Taip;0;0;5;5
9486;Sakalėlis;GIRINUKŲ;4458071075;Ne;4;0;0;4
9487;Sakalėlis;GIRINUKŲ;2780141413;Taip;0;5;0;5
9488;Sakalėlis;GIRINUKŲ;1347171934;Ne;7;0;0;7
9489;Sakalėlis;VYTURIUKŲ;3927487265;Ne;0;0;1;1
9490;Sakalėlis;VYTURIUKŲ;2352118061;Ne;0;0;1;1
9491;Sakalėlis;VYTURIUKŲ;3680732318;Ne;0;9;0;9
9492;Sakalėlis;VYTURIUKŲ;4862004373;Ne;5;0;2;7
9493;Sakalėlis;VYTURIUKŲ;8422299669;Ne;0;0;1;1
9494;Sakalėlis;VYTURIUKŲ;8381310908;Ne;4;0;0;4
9495;Sakalėlis;VYTURIUKŲ;6840368824;Ne;11;0;0;11
9496;Sakalėlis;VYTURIUKŲ;1742362136;Ne;0;0;2;2
9497;Sakalėlis;VYTURIUKŲ;3351218789;Ne;0;0;2;2
9498;Sakalėlis;VYTURIUKŲ;9120873899;Ne;5;0;7;12
9499;Sakalėlis;VYTURIUKŲ;4136266629;Ne;2;0;0;2
9500;Sakalėlis;VYTURIUKŲ;5991029760;Taip;7;0;1;8
9501;Sakalėlis;VYTURIUKŲ;6378711142;Ne;5;0;0;5
9502;Sakalėlis;VYTURIUKŲ;1736303381;Taip;0;0;3;3
9503;Sakalėlis;VYTURIUKŲ;7280513854;Ne;6;0;0;6
9504;Sakalėlis;DRUGELIŲ;8095359035;Ne;0;0;6;6
9505;Sakalėlis;DRUGELIŲ;6515519140;Ne;0;0;1;1
9506;Sakalėlis;DRUGELIŲ;7706606275;Ne;1;0;0;1
9507;Sakalėlis;DRUGELIŲ;9272347788;Ne;8;0;6;14
9508;Sakalėlis;DRUGELIŲ;8331612396;Ne;0;0;2;2
9509;Sakalėlis;DRUGELIŲ;7542322748;Ne;4;0;0;4
9510;Sakalėlis;DRUGELIŲ;4918228191;Ne;0;0;2;2
9511;Sakalėlis;DRUGELIŲ;1201086815;Ne;0;0;3;3
9512;Sakalėlis;DRUGELIŲ;3934295338;Ne;3;0;0;3
9513;Sakalėlis;DRUGELIŲ;1117800518;Ne;6;0;0;6
9514;Sakalėlis;DRUGELIŲ;8160589611;Ne;0;3;0;3
9515;Sakalėlis;DRUGELIŲ;9836193857;Ne;0;1;0;1
9516;Sakalėlis;DRUGELIŲ;1833573491;Ne;0;0;7;7
9517;Sakalėlis;DRUGELIŲ;8713298648;Ne;0;7;0;7
9518;Sakalėlis;DRUGELIŲ;2889638745;Ne;0;0;2;2
9519;Sakalėlis;DRUGELIŲ;7540098033;Ne;0;0;2;2
9520;Sakalėlis;GENIUKŲ;4763858893;Ne;0;0;2;2
9521;Sakalėlis;GENIUKŲ;3337299648;Ne;3;0;0;3
9522;Sakalėlis;GENIUKŲ;43677485606;Ne;0;2;0;2
9523;Sakalėlis;GENIUKŲ;5717022080;Ne;4;0;0;4
9524;Sakalėlis;GENIUKŲ;4515180509;Ne;6;0;0;6
9525;Sakalėlis;GENIUKŲ;96053733139;Ne;5;0;0;5
9526;Sakalėlis;GENIUKŲ;4612388683;Ne;0;3;0;3
9527;Sakalėlis;GENIUKŲ;4775685174;Ne;1;0;0;1
9528;Sakalėlis;GENIUKŲ;8936933971;Ne;0;0;3;3
9529;Sakalėlis;GENIUKŲ;3371763993;Ne;10;0;0;10
9530;Sakalėlis;GENIUKŲ;7085108710;Ne;18;0;1;19
9531;Sakalėlis;GENIUKŲ;4364341933;Ne;2;0;5;7
9532;Sakalėlis;VOVERIUKŲ;5172421763;Ne;6;0;3;9
9533;Sakalėlis;VOVERIUKŲ;5233697077;Ne;1;0;0;1
9534;Sakalėlis;VOVERIUKŲ;6414564366;Taip;4;0;2;6
9535;Sakalėlis;VOVERIUKŲ;1953356983;Taip;3;0;1;4
9536;Sakalėlis;VOVERIUKŲ;4358313171;Ne;0;0;3;3
9537;Sakalėlis;VOVERIUKŲ;1873392718;Ne;5;0;0;5
9538;Sakalėlis;VOVERIUKŲ;6806170544;Ne;2;0;3;5
9539;Sakalėlis;VOVERIUKŲ;2557089391;Ne;3;5;0;8
9540;Sakalėlis;VOVERIUKŲ;3574956316;Ne;0;4;0;4
9541;Sakalėlis;VOVERIUKŲ;1403384561;Ne;3;0;0;3
9542;Sakalėlis;VOVERIUKŲ;3927363997;Ne;0;12;0;12
9543;Sakalėlis;VOVERIUKŲ;6293226507;Ne;13;0;2;15
9544;Sakalėlis;VOVERIUKŲ;2699844937;Ne;2;2;0;4
9545;Sakalėlis;VOVERIUKŲ;1273843302;Taip;0;4;3;7
9546;Sakalėlis;VOVERIUKŲ;6217643065;Ne;14;0;2;16
9547;Sakalėlis;VOVERIUKŲ;1669610397;Ne;0;0;8;8
9548;Sakalėlis;VOVERIUKŲ;4344537391;Ne;0;0;4;4
9549;Sakalėlis;VOVERIUKŲ;6016854405;Ne;0;13;0;13
9550;Sakalėlis;VOVERIUKŲ;2531146677;Ne;7;0;1;8
9551;Sakalėlis;VOVERIUKŲ;4968216193;Ne;0;0;4;4
9552;Sakalėlis;PĖLEDŽIUKŲ;1133377117;Ne;1;0;1;2
9553;Sakalėlis;PĖLEDŽIUKŲ;6190741162;Ne;1;0;0;1
9554;Sakalėlis;PĖLEDŽIUKŲ;4430763418;Ne;0;10;0;10
9555;Sakalėlis;PĖLEDŽIUKŲ;1104881142;Ne;0;0;1;1
9556;Sakalėlis;PĖLEDŽIUKŲ;6321575268;Ne;2;0;1;3
9557;Sakalėlis;PĖLEDŽIUKŲ;30987215315;Ne;0;5;0;5
9558;Sakalėlis;PĖLEDŽIUKŲ;3962436122;Ne;0;2;0;2
9559;Sakalėlis;PĖLEDŽIUKŲ;1141943082;Ne;0;4;0;4
9560;Sakalėlis;PĖLEDŽIUKŲ;46629941288;Ne;1;0;1;2
9561;Sakalėlis;PĖLEDŽIUKŲ;8852001037;Ne;0;0;4;4
9562;Sakalėlis;PĖLEDŽIUKŲ;6180987643;Ne;0;6;2;8
9563;Sakalėlis;PĖLEDŽIUKŲ;3678172501;Ne;8;1;0;9
9564;Sakalėlis;PĖLEDŽIUKŲ;7567476424;Ne;9;0;0;9
9565;Sakalėlis;PĖLEDŽIUKŲ;2055710873;Ne;0;0;1;1
9566;Sakalėlis;PĖLEDŽIUKŲ;1839096675;Ne;0;0;1;1
9567;Sakalėlis;PĖLEDŽIUKŲ;1339314644;Ne;0;0;1;1
9568;Sakalėlis;PĖLEDŽIUKŲ;5884781964;Ne;4;0;4;8
9569;Sakalėlis;PĖLEDŽIUKŲ;4495453007;Ne;0;0;1;1
9570;Sakalėlis;"BITUČIŲ (LOGOPEDINĖ)";7241416465;Ne;0;0;3;3
9571;Sakalėlis;"BITUČIŲ (LOGOPEDINĖ)";4857211754;Ne;1;0;0;1
9572;Sakalėlis;"BITUČIŲ (LOGOPEDINĖ)";8610668395;Ne;6;1;3;10
9573;Sakalėlis;"BITUČIŲ (LOGOPEDINĖ)";6259640492;Ne;2;0;0;2
9574;Sakalėlis;"BITUČIŲ (LOGOPEDINĖ)";1723436498;Ne;0;0;4;4
9575;Sakalėlis;"BITUČIŲ (LOGOPEDINĖ)";3938470708;Ne;1;0;0;1
9576;Sakalėlis;"BITUČIŲ (LOGOPEDINĖ)";4931253729;Ne;0;0;9;9
9577;Sakalėlis;"BITUČIŲ (LOGOPEDINĖ)";5376872141;Ne;4;0;0;4
9578;Sakalėlis;"BITUČIŲ (LOGOPEDINĖ)";4303490614;Taip;0;4;0;4
9579;Sakalėlis;"BORUŽIUKŲ (LOGOPEDINĖ)";4514546151;Ne;0;2;1;3
9580;Sakalėlis;"BORUŽIUKŲ (LOGOPEDINĖ)";3972897839;Ne;0;0;1;1
9581;Sakalėlis;"BORUŽIUKŲ (LOGOPEDINĖ)";2124857941;Ne;6;0;0;6
9582;Sakalėlis;"BORUŽIUKŲ (LOGOPEDINĖ)";1806698668;Ne;0;0;1;1
9583;Sakalėlis;"BORUŽIUKŲ (LOGOPEDINĖ)";6727251397;Ne;0;2;0;2
9584;Sakalėlis;"BORUŽIUKŲ (LOGOPEDINĖ)";6250400609;Ne;6;0;2;8
9585;Sakalėlis;"BORUŽIUKŲ (LOGOPEDINĖ)";6222204020;Ne;0;0;1;1
9586;Sakalėlis;"BORUŽIUKŲ (LOGOPEDINĖ)";8263169658;Ne;1;0;2;3
9587;Sakalėlis;MEŠKUČIŲ;9546779717;Ne;11;0;1;12
9588;Sakalėlis;MEŠKUČIŲ;8535457018;Ne;0;7;0;7
9589;Sakalėlis;MEŠKUČIŲ;4813561523;Ne;0;0;1;1
9590;Sakalėlis;MEŠKUČIŲ;7154383856;Ne;13;0;0;13
9591;Sakalėlis;MEŠKUČIŲ;5082756444;Taip;0;2;1;3
9592;Sakalėlis;MEŠKUČIŲ;7839893402;Ne;5;0;0;5
9593;Sakalėlis;MEŠKUČIŲ;3092760315;Ne;0;6;0;6
9594;Sakalėlis;MEŠKUČIŲ;3524545708;Ne;0;7;0;7
9595;Sakalėlis;MEŠKUČIŲ;5961207419;Ne;0;0;1;1
9596;Sakalėlis;MEŠKUČIŲ;5677280944;Taip;4;0;4;8
9597;Sakalėlis;MEŠKUČIŲ;2389541483;Taip;7;1;0;8
9598;Sakalėlis;MEŠKUČIŲ;4063074948;Ne;0;0;3;3
9599;Sakalėlis;MEŠKUČIŲ;8108456923;Ne;4;0;0;4
9600;Sakalėlis;MEŠKUČIŲ;7285230768;Ne;9;4;2;15
9601;Sakalėlis;MEŠKUČIŲ;2090313887;Ne;6;0;1;7
9602;Sakalėlis;MEŠKUČIŲ;9794245922;Ne;0;0;15;15
9603;Sakalėlis;MEŠKUČIŲ;8106231242;Ne;14;0;0;14
9604;Sakalėlis;MEŠKUČIŲ;4520212128;Ne;12;0;2;14
9605;Sakalėlis;MEŠKUČIŲ;7228559861;Ne;0;11;3;14
9606;Sakalėlis;MEŠKUČIŲ;1208798798;Ne;12;0;0;12
9607;Sakalėlis;KIŠKUČIŲ;5865993835;Ne;6;0;3;9
9608;Sakalėlis;KIŠKUČIŲ;8228039819;Ne;12;0;0;12
9609;Sakalėlis;KIŠKUČIŲ;6029443196;Ne;13;0;2;15
9610;Sakalėlis;KIŠKUČIŲ;4611384179;Ne;0;2;3;5
9611;Sakalėlis;KIŠKUČIŲ;4490632523;Ne;7;0;0;7
9612;Sakalėlis;KIŠKUČIŲ;8015985605;Ne;0;0;2;2
9613;Sakalėlis;KIŠKUČIŲ;5052638078;Ne;14;0;1;15
9614;Sakalėlis;KIŠKUČIŲ;5327382009;Ne;14;0;1;15
9615;Sakalėlis;KIŠKUČIŲ;6897550418;Ne;5;0;2;7
9616;Sakalėlis;KIŠKUČIŲ;9642519454;Ne;5;0;0;5
9617;Sakalėlis;KIŠKUČIŲ;5387119771;Taip;15;0;0;15
9618;Sakalėlis;KIŠKUČIŲ;6328924318;Ne;6;0;2;8
9619;Sakalėlis;KIŠKUČIŲ;8868588637;Taip;14;0;5;19
9620;Sakalėlis;SVIRPLIUKŲ;6597274376;Ne;1;0;0;1
9621;Sakalėlis;SVIRPLIUKŲ;5500248048;Ne;0;1;2;3
9622;Sakalėlis;SVIRPLIUKŲ;8562164673;Ne;0;1;3;4
9623;Sakalėlis;SVIRPLIUKŲ;2537030533;Ne;0;0;3;3
9624;Sakalėlis;SVIRPLIUKŲ;3719351129;Ne;5;1;0;6
9625;Sakalėlis;SVIRPLIUKŲ;3570413330;Ne;1;0;9;10
9626;Sakalėlis;SVIRPLIUKŲ;7852255204;Ne;7;0;1;8
9627;Sakalėlis;SVIRPLIUKŲ;7480286509;Ne;0;0;8;8
9628;Sakalėlis;SVIRPLIUKŲ;2250828607;Ne;11;1;1;13
9629;Sakalėlis;SVIRPLIUKŲ;2672429406;Ne;11;1;1;13
9630;Sakalėlis;SVIRPLIUKŲ;6851247779;Ne;6;0;1;7
9631;Sakalėlis;SVIRPLIUKŲ;9776767584;Ne;6;0;1;7
9632;Sakalėlis;SVIRPLIUKŲ;8501785305;Ne;6;0;0;6
9633;Sakalėlis;SVIRPLIUKŲ;1121818878;Ne;1;0;0;1
9634;Sakalėlis;SVIRPLIUKŲ;2233966176;Ne;0;0;13;13
9635;Sakalėlis;SVIRPLIUKŲ;7079300418;Ne;7;0;1;8
9636;Sakalėlis;SVIRPLIUKŲ;8659925528;Ne;0;0;4;4
9637;Sakalėlis;GANDRIUKŲ;8502289806;Ne;0;1;0;1
9638;Sakalėlis;GANDRIUKŲ;5292978341;Taip;0;4;2;6
9639;Sakalėlis;GANDRIUKŲ;9368758708;Ne;6;1;0;7
9640;Sakalėlis;GANDRIUKŲ;7384400795;Ne;0;8;0;8
9641;Sakalėlis;GANDRIUKŲ;3644413861;Ne;2;6;0;8
9642;Sakalėlis;GANDRIUKŲ;4230762388;Taip;8;0;1;9
9643;Sakalėlis;GANDRIUKŲ;3228617971;Ne;0;5;0;5
9644;Sakalėlis;GANDRIUKŲ;1545323439;Taip;4;0;3;7
9645;Sakalėlis;GANDRIUKŲ;5748438461;Taip;0;3;1;4
9646;Sakalėlis;GANDRIUKŲ;2734462553;Ne;0;1;0;1
9647;Sakalėlis;GANDRIUKŲ;2481285439;Ne;6;0;5;11
9648;Sakalėlis;GANDRIUKŲ;7345113972;Ne;6;1;1;8
9649;Sakalėlis;GANDRIUKŲ;6069544792;Ne;0;0;8;8
9650;Sakalėlis;GANDRIUKŲ;5460619168;Ne;0;0;1;1
9651;Sakalėlis;GANDRIUKŲ;1560077883;Ne;0;3;1;4
9652;Salininkų;BORUŽIUKAI;8329495685;Ne;0;1;0;1
9653;Salininkų;BORUŽIUKAI;1005025619;Ne;0;6;0;6
9654;Salininkų;BORUŽIUKAI;2146404021;Ne;0;2;1;3
9655;Salininkų;BORUŽIUKAI;8718514114;Ne;5;1;4;10
9656;Salininkų;BORUŽIUKAI;5447236646;Ne;9;1;5;15
9657;Salininkų;BORUŽIUKAI;2208793412;Ne;0;5;0;5
9658;Salininkų;BORUŽIUKAI;1647401700;Ne;14;0;1;15
9659;Salininkų;BORUŽIUKAI;9817285587;Ne;5;0;1;6
9660;Salininkų;BORUŽIUKAI;8823595510;Ne;0;2;0;2
9661;Salininkų;BORUŽIUKAI;9416926474;Ne;5;1;0;6
9662;Salininkų;BORUŽIUKAI;1254843449;Ne;10;2;0;12
9663;Salininkų;BORUŽIUKAI;3231379271;Ne;0;2;0;2
9664;Salininkų;BORUŽIUKAI;1346133493;Ne;8;2;1;11
9665;Salininkų;BORUŽIUKAI;2273407270;Ne;4;2;5;11
9666;Salininkų;BORUŽIUKAI;8911016037;Ne;4;0;0;4
9667;Salininkų;GĖLYTĖS;8602489420;Ne;0;8;0;8
9668;Salininkų;GĖLYTĖS;2895782373;Ne;5;5;0;10
9669;Salininkų;GĖLYTĖS;4971070998;Ne;0;2;0;2
9670;Salininkų;GĖLYTĖS;9893985732;Ne;1;4;0;5
9671;Salininkų;GĖLYTĖS;3686372180;Ne;0;0;2;2
9672;Salininkų;GĖLYTĖS;3703729963;Ne;1;0;0;1
9673;Salininkų;GĖLYTĖS;3338213592;Ne;0;1;0;1
9674;Salininkų;GĖLYTĖS;6506819265;Ne;0;1;0;1
9675;Salininkų;GĖLYTĖS;6510096414;Ne;0;7;0;7
9676;Salininkų;GĖLYTĖS;2491796874;Ne;0;0;2;2
9677;Salininkų;GĖLYTĖS;8141168894;Ne;7;0;0;7
9678;Salininkų;GĖLYTĖS;2440831687;Ne;5;0;0;5
9679;Salininkų;GĖLYTĖS;1284909139;Ne;0;3;0;3
9680;Salininkų;GĖLYTĖS;5164367382;Ne;0;2;5;7
9681;Salininkų;GĖLYTĖS;2798153926;Ne;0;1;0;1
9682;Salininkų;GĖLYTĖS;1453214735;Ne;0;1;0;1
9683;Salininkų;DRUGELIAI;2684868661;Ne;10;0;0;10
9684;Salininkų;DRUGELIAI;4333027447;Ne;12;0;0;12
9685;Salininkų;DRUGELIAI;3115232507;Ne;3;0;0;3
9686;Salininkų;DRUGELIAI;2009246885;Ne;8;0;2;10
9687;Salininkų;DRUGELIAI;3420217477;Ne;3;0;0;3
9688;Salininkų;DRUGELIAI;3890914603;Ne;15;1;0;16
9689;Salininkų;DRUGELIAI;3181932118;Ne;0;2;0;2
9690;Salininkų;DRUGELIAI;5017068344;Ne;5;0;0;5
9691;Salininkų;DRUGELIAI;3761217912;Ne;0;1;0;1
9692;Salininkų;DRUGELIAI;2208607684;Ne;0;1;0;1
9693;Salininkų;DRUGELIAI;5539560359;Ne;10;0;7;17
9694;Salininkų;DRUGELIAI;5587577036;Ne;1;0;0;1
9695;Salininkų;DRUGELIAI;5375668400;Ne;0;10;0;10
9696;Salininkų;DRUGELIAI;4529253958;Ne;8;0;0;8
9697;Salininkų;DRUGELIAI;5583804491;Ne;0;1;0;1
9698;Salininkų;DRUGELIAI;7063718023;Ne;1;0;0;1
9699;Salininkų;DRUGELIAI;9018366347;Ne;13;0;0;13
9700;Salininkų;ŽIRNIUKAI;7643665643;Ne;0;2;0;2
9701;Salininkų;ŽIRNIUKAI;9198411540;Ne;1;1;0;2
9702;Salininkų;ŽIRNIUKAI;6885580632;Ne;0;4;0;4
9703;Salininkų;ŽIRNIUKAI;7409604480;Ne;0;8;0;8
9704;Salininkų;ŽIRNIUKAI;3677558828;Ne;0;10;0;10
9705;Salininkų;ŽIRNIUKAI;6482437251;Ne;0;1;0;1
9706;Salininkų;ŽIRNIUKAI;1380797788;Ne;0;8;0;8
9707;Salininkų;ŽIRNIUKAI;2495782496;Ne;5;2;2;9
9708;Salininkų;ŽIRNIUKAI;9896357816;Ne;0;2;0;2
9709;Salininkų;ŽIRNIUKAI;4568462071;Ne;6;0;1;7
9710;Salininkų;ŽIRNIUKAI;9137783249;Ne;0;4;0;4
9711;Salininkų;ŽIRNIUKAI;8524400656;Ne;0;4;0;4
9712;Salininkų;ŽIRNIUKAI;7463713798;Ne;13;7;0;20
9713;Salininkų;ŽIRNIUKAI;9617873735;Ne;1;0;0;1
9714;Salininkų;ŽIRNIUKAI;6143967744;Ne;0;0;9;9
9715;Salininkų;ŽIRNIUKAI;8552427446;Ne;0;0;14;14
9716;Salininkų;ŽIRNIUKAI;6586988786;Ne;8;1;1;10
9717;Salininkų;ŽIRNIUKAI;1587485662;Ne;1;0;1;2
9718;Salininkų;PAUKŠČIUKAI;5427013789;Ne;0;4;0;4
9719;Salininkų;PAUKŠČIUKAI;3100499807;Ne;0;4;0;4
9720;Salininkų;PAUKŠČIUKAI;5867676844;Taip;0;0;3;3
9721;Salininkų;PAUKŠČIUKAI;3585435095;Taip;3;1;0;4
9722;Salininkų;PAUKŠČIUKAI;2760231414;Taip;6;1;0;7
9723;Salininkų;PAUKŠČIUKAI;7665409499;Taip;0;0;1;1
9724;Salininkų;PAUKŠČIUKAI;9724367035;Taip;0;1;0;1
9725;Salininkų;PAUKŠČIUKAI;1658695150;Taip;0;0;5;5
9726;Salininkų;PAUKŠČIUKAI;7383557807;Ne;0;7;0;7
9727;Salininkų;PAUKŠČIUKAI;2808778763;Taip;0;6;0;6
9728;Salininkų;PAUKŠČIUKAI;6656578271;Ne;5;2;0;7
9729;Salininkų;PAUKŠČIUKAI;7737045952;Taip;3;0;1;4
9730;Salininkų;PAUKŠČIUKAI;8995565864;Taip;14;0;0;14
9731;Salininkų;PAUKŠČIUKAI;7782972361;Taip;0;1;0;1
9732;Salininkų;PAUKŠČIUKAI;8394582546;Taip;0;9;0;9
9733;Salininkų;PAUKŠČIUKAI;6327046935;Taip;0;1;0;1
9734;Salininkų;PAUKŠČIUKAI;4425748908;Taip;0;5;0;5
9735;Salininkų;PAUKŠČIUKAI;4323257798;Taip;0;3;0;3
9736;Salininkų;PAUKŠČIUKAI;6266609965;Taip;0;10;0;10
9737;Salininkų;PAUKŠČIUKAI;3737834032;Taip;1;0;0;1
9738;Salininkų;PAUKŠČIUKAI;9813360176;Taip;0;2;0;2
9739;Salininkų;BITUTĖS;3252151974;Ne;7;0;2;9
9740;Salininkų;BITUTĖS;6845471044;Ne;0;0;3;3
9741;Salininkų;BITUTĖS;8774984357;Taip;0;0;2;2
9742;Salininkų;BITUTĖS;9902751686;Ne;18;0;0;18
9743;Salininkų;BITUTĖS;6125152143;Ne;1;0;0;1
9744;Salininkų;BITUTĖS;2095952937;Ne;1;0;0;1
9745;Salininkų;BITUTĖS;1928897962;Ne;3;0;0;3
9746;Salininkų;BITUTĖS;2073939432;Ne;1;0;0;1
9747;Salininkų;BITUTĖS;9996809930;Ne;7;0;3;10
9748;Salininkų;BITUTĖS;8992580214;Ne;3;0;0;3
9749;Salininkų;BITUTĖS;3915336062;Ne;10;0;0;10
9750;Salininkų;BITUTĖS;6577237672;Taip;0;0;1;1
9751;Salininkų;BITUTĖS;7115888747;Ne;2;0;3;5
9752;Salininkų;BITUTĖS;7639362434;Ne;3;0;3;6
9753;Salininkų;BITUTĖS;4480303856;Ne;0;0;2;2
9754;Salvija;Daigelis(šatil);4577248630;Ne;2;4;5;11
9755;Salvija;Daigelis(šatil);9978634888;Ne;0;0;4;4
9756;Salvija;Daigelis(šatil);1676795179;Ne;0;0;6;6
9757;Salvija;Daigelis(šatil);4665919836;Ne;3;0;0;3
9758;Salvija;Daigelis(šatil);3345231579;Ne;12;0;0;12
9759;Salvija;Daigelis(šatil);3640213912;Ne;0;0;1;1
9760;Salvija;Daigelis(šatil);1509182157;Ne;0;5;1;6
9761;Salvija;Daigelis(šatil);8337554678;Ne;0;0;1;1
9762;Salvija;Daigelis(šatil);5327735648;Ne;5;0;2;7
9763;Salvija;Daigelis(šatil);6323383244;Ne;2;4;5;11
9764;Salvija;Daigelis(šatil);3857916185;Ne;0;0;5;5
9765;Salvija;Daigelis(šatil);5554431690;Ne;0;0;18;18
9766;Salvija;Daigelis(šatil);1065575041;Ne;0;0;6;6
9767;Salvija;Daigelis(šatil);7410091250;Ne;0;0;4;4
9768;Salvija;"Pienė (savjon)";8023422294;Ne;3;0;0;3
9769;Salvija;"Pienė (savjon)";8981331532;Ne;0;0;4;4
9770;Salvija;"Pienė (savjon)";8306404275;Ne;0;0;4;4
9771;Salvija;"Pienė (savjon)";1261005294;Ne;0;0;2;2
9772;Salvija;"Pienė (savjon)";8013023311;Ne;0;0;1;1
9773;Salvija;"Pienė (savjon)";1653831148;Ne;5;0;1;6
9774;Salvija;"Pienė (savjon)";4325636377;Ne;0;0;2;2
9775;Salvija;"Pienė (savjon)";8892646200;Ne;0;0;3;3
9776;Salvija;"Pienė (savjon)";7477171133;Ne;10;0;0;10
9777;Salvija;"Pienė (savjon)";6706565915;Ne;9;0;2;11
9778;Salvija;"Pienė (savjon)";8853389268;Ne;4;1;0;5
9779;Salvija;"Pienė (savjon)";3856351749;Ne;6;0;0;6
9780;Salvija;"Pienė (savjon)";8158680641;Ne;5;0;0;5
9781;Salvija;"Pienė (savjon)";5816893736;Ne;6;5;0;11
9782;Salvija;"Pienė (savjon)";1975032693;Ne;0;0;2;2
9783;Saulėtekis;BERŽELIS;3493175211;Ne;0;4;0;4
9784;Saulėtekis;BERŽELIS;8086451893;Ne;0;0;1;1
9785;Saulėtekis;BERŽELIS;9351122147;Ne;4;0;1;5
9786;Saulėtekis;BERŽELIS;6667804855;Ne;5;0;1;6
9787;Saulėtekis;BERŽELIS;1852180633;Taip;0;0;2;2
9788;Saulėtekis;BERŽELIS;5468364505;Ne;5;0;0;5
9789;Saulėtekis;BERŽELIS;4704426104;Ne;3;0;1;4
9790;Saulėtekis;BERŽELIS;7407540257;Ne;0;0;2;2
9791;Saulėtekis;BERŽELIS;6920619390;Ne;0;0;2;2
9792;Saulėtekis;BERŽELIS;5194925689;Ne;0;1;0;1
9793;Saulėtekis;BERŽELIS;7494641077;Ne;0;3;0;3
9794;Saulėtekis;BERŽELIS;1577609727;Ne;0;1;0;1
9795;Saulėtekis;BERŽELIS;2672108464;Ne;2;0;0;2
9796;Saulėtekis;BERŽELIS;9579088485;Ne;0;1;0;1
9797;Saulėtekis;BERŽELIS;2568544418;Ne;4;0;0;4
9798;Saulėtekis;BERŽELIS;8927598999;Ne;13;0;0;13
9799;Saulėtekis;BERŽELIS;9734188792;Ne;10;0;5;15
9800;Saulėtekis;BERŽELIS;6983324115;Ne;0;0;2;2
9801;Saulėtekis;BERŽELIS;8061477303;Ne;0;4;1;5
9802;Saulėtekis;BERŽELIS;7436158953;Ne;0;0;1;1
9803;Saulėtekis;BERŽELIS;7165739418;Ne;4;0;1;5
9804;Saulėtekis;ŠYPSENA;9972687066;Ne;0;7;4;11
9805;Saulėtekis;ŠYPSENA;7346852524;Ne;2;0;0;2
9806;Saulėtekis;ŠYPSENA;7893982893;Ne;0;3;4;7
9807;Saulėtekis;ŠYPSENA;7505040675;Ne;0;1;0;1
9808;Saulėtekis;ŠYPSENA;9791926936;Ne;0;0;6;6
9809;Saulėtekis;ŠYPSENA;8143793642;Ne;9;2;0;11
9810;Saulėtekis;ŠYPSENA;7673965242;Ne;5;0;3;8
9811;Saulėtekis;ŠYPSENA;3166959569;Ne;5;0;1;6
9812;Saulėtekis;ŠYPSENA;9383567339;Taip;3;0;4;7
9813;Saulėtekis;ŠYPSENA;6608831217;Ne;4;2;0;6
9814;Saulėtekis;ŠYPSENA;7730889108;Ne;0;0;2;2
9815;Saulėtekis;ŠYPSENA;7435424899;Ne;6;0;1;7
9816;Saulėtekis;ŠYPSENA;9694119292;Ne;4;0;1;5
9817;Saulėtekis;ŠYPSENA;8881524909;Ne;0;0;4;4
9818;Saulėtekis;ŠYPSENA;5518726567;Ne;2;0;0;2
9819;Saulėtekis;ŠYPSENA;2177470008;Ne;0;0;3;3
9820;Saulėtekis;ŠYPSENA;4250589212;Ne;0;0;12;12
9821;Saulėtekis;ŠYPSENA;2686041419;Ne;0;4;3;7
9822;Saulėtekis;NYKŠTUKAI;7849181976;Ne;3;2;0;5
9823;Saulėtekis;NYKŠTUKAI;5748816813;Ne;13;0;0;13
9824;Saulėtekis;NYKŠTUKAI;1416983683;Ne;14;0;0;14
9825;Saulėtekis;NYKŠTUKAI;4758423356;Ne;0;2;0;2
9826;Saulėtekis;NYKŠTUKAI;9270109327;Ne;2;4;0;6
9827;Saulėtekis;NYKŠTUKAI;5183297420;Ne;10;0;0;10
9828;Saulėtekis;NYKŠTUKAI;8007704080;Ne;16;0;0;16
9829;Saulėtekis;NYKŠTUKAI;8683571534;Ne;3;0;0;3
9830;Saulėtekis;NYKŠTUKAI;9481578412;Ne;5;0;1;6
9831;Saulėtekis;NYKŠTUKAI;8167740525;Ne;20;0;0;20
9832;Saulėtekis;NYKŠTUKAI;9818660340;Ne;6;0;2;8
9833;Saulėtekis;NYKŠTUKAI;3729811521;Ne;0;1;0;1
9834;Saulėtekis;NYKŠTUKAI;8090571664;Ne;6;0;0;6
9835;Saulėtekis;NYKŠTUKAI;9104549419;Ne;0;1;0;1
9836;Saulėtekis;NYKŠTUKAI;3957655772;Ne;2;0;0;2
9837;Saulėtekis;NYKŠTUKAI;3270283626;Ne;20;0;0;20
9838;Saulėtekis;PAGRANDUKAS;4152255439;Ne;2;0;1;3
9839;Saulėtekis;PAGRANDUKAS;2209156661;Ne;0;0;4;4
9840;Saulėtekis;PAGRANDUKAS;5552614092;Ne;0;1;0;1
9841;Saulėtekis;PAGRANDUKAS;9497129509;Ne;0;0;1;1
9842;Saulėtekis;PAGRANDUKAS;7186085219;Ne;0;0;1;1
9843;Saulėtekis;PAGRANDUKAS;1020209414;Ne;2;0;1;3
9844;Saulėtekis;PAGRANDUKAS;2728836108;Ne;0;0;3;3
9845;Saulėtekis;PAGRANDUKAS;7164579375;Ne;8;0;2;10
9846;Saulėtekis;PAGRANDUKAS;8574702901;Taip;0;0;1;1
9847;Saulėtekis;PAGRANDUKAS;4038684284;Ne;8;0;3;11
9848;Saulėtekis;PAGRANDUKAS;2935641362;Ne;0;0;7;7
9849;Saulėtekis;PAGRANDUKAS;4676218435;Ne;15;0;0;15
9850;Saulėtekis;PAGRANDUKAS;7598254324;Ne;6;0;4;10
9851;Saulėtekis;PAGRANDUKAS;9737568538;Ne;0;1;1;2
9852;Saulėtekis;PAGRANDUKAS;8468491266;Ne;1;0;0;1
9853;Saulėtekis;PAGRANDUKAS;6181992249;Ne;0;0;1;1
9854;Saulėtekis;PAGRANDUKAS;8390615573;Ne;0;0;2;2
9855;Saulėtekis;PAGRANDUKAS;3366064429;Ne;0;0;2;2
9856;Saulėtekis;PAGRANDUKAS;5824537129;Ne;0;0;6;6
9857;Saulėtekis;RAMUNĖLIŲ;8739919774;Ne;0;9;0;9
9858;Saulėtekis;RAMUNĖLIŲ;4681031693;Ne;0;0;1;1
9859;Saulėtekis;RAMUNĖLIŲ;2316817605;Ne;0;0;11;11
9860;Saulėtekis;RAMUNĖLIŲ;3987535802;Ne;5;0;0;5
9861;Saulėtekis;RAMUNĖLIŲ;5297650157;Ne;7;0;0;7
9862;Saulėtekis;RAMUNĖLIŲ;6979741482;Ne;0;0;3;3
9863;Saulėtekis;RAMUNĖLIŲ;8348456528;Ne;5;0;0;5
9864;Saulėtekis;RAMUNĖLIŲ;3430209353;Ne;0;1;0;1
9865;Saulėtekis;RAMUNĖLIŲ;2786112846;Ne;0;8;0;8
9866;Saulėtekis;RAMUNĖLIŲ;8876580678;Ne;0;8;0;8
9867;Saulėtekis;RAMUNĖLIŲ;1427323748;Ne;10;0;3;13
9868;Saulėtekis;RAMUNĖLIŲ;3224110585;Ne;14;5;0;19
9869;Saulėtekis;RAMUNĖLIŲ;2002180753;Ne;8;0;3;11
9870;Saulėtekis;RAMUNĖLIŲ;5685176596;Ne;0;0;1;1
9871;Saulėtekis;RAMUNĖLIŲ;9668125862;Ne;0;0;1;1
9872;Saulėtekis;RAMUNĖLIŲ;4736430248;Ne;0;7;0;7
9873;Saulėtekis;RAMUNĖLIŲ;1108736588;Ne;8;0;0;8
9874;Saulėtekis;RAMUNĖLIŲ;3680199463;Ne;10;0;1;11
9875;Saulėtekis;RAMUNĖLIŲ;2383861394;Ne;0;13;0;13
9876;Saulėtekis;RAMUNĖLIŲ;2872732978;Ne;6;2;0;8
9877;Saulėtekis;RAMUNĖLIŲ;9732352141;Ne;6;0;1;7
9878;Saulėtekis;PASAKAITĖ;8033763960;Ne;12;0;0;12
9879;Saulėtekis;PASAKAITĖ;5086871001;Ne;0;1;0;1
9880;Saulėtekis;PASAKAITĖ;2446282019;Ne;9;2;0;11
9881;Saulėtekis;PASAKAITĖ;8572701238;Ne;10;0;0;10
9882;Saulėtekis;PASAKAITĖ;6063956790;Ne;0;3;0;3
9883;Saulėtekis;PASAKAITĖ;4437540996;Ne;10;0;0;10
9884;Saulėtekis;PASAKAITĖ;9226317303;Ne;10;1;0;11
9885;Saulėtekis;PASAKAITĖ;9267790598;Ne;6;1;0;7
9886;Saulėtekis;PASAKAITĖ;6670590135;Ne;9;2;0;11
9887;Saulėtekis;PASAKAITĖ;6720758829;Ne;0;2;0;2
9888;Saulėtekis;PASAKAITĖ;3224883243;Ne;9;0;0;9
9889;Saulėtekis;PASAKAITĖ;9382031144;Ne;5;6;0;11
9890;Saulėtekis;PASAKAITĖ;3371914339;Ne;4;0;0;4
9891;Saulėtekis;PASAKAITĖ;6214539956;Ne;9;0;0;9
9892;Saulėtekis;PASAKAITĖ;9584556476;Ne;2;1;3;6
9893;Saulėtekis;PASAKAITĖ;2469458604;Ne;6;1;0;7
9894;Saulėtekis;PASAKAITĖ;3499575148;Ne;0;1;0;1
9895;Saulėtekis;PASAKAITĖ;2206038658;Ne;5;2;5;12
9896;Saulėtekis;VARPELIAI;3303064486;Ne;4;0;1;5
9897;Saulėtekis;VARPELIAI;1355354514;Ne;6;0;0;6
9898;Saulėtekis;VARPELIAI;8195320453;Taip;4;0;0;4
9899;Saulėtekis;VARPELIAI;6534433593;Ne;20;0;0;20
9900;Saulėtekis;VARPELIAI;5997903066;Ne;16;0;0;16
9901;Saulėtekis;VARPELIAI;7338301696;Ne;0;2;1;3
9902;Saulėtekis;VARPELIAI;7171550857;Ne;4;0;2;6
9903;Saulėtekis;VARPELIAI;3157110037;Ne;10;1;9;20
9904;Saulėtekis;VARPELIAI;8331659142;Ne;0;7;13;20
9905;Saulėtekis;VARPELIAI;3832717108;Ne;9;0;0;9
9906;Saulėtekis;VARPELIAI;1198692142;Ne;6;0;0;6
9907;Saulėtekis;VARPELIAI;1240595768;Ne;7;0;0;7
9908;Saulėtekis;VARPELIAI;9246555859;Ne;1;0;6;7
9909;Saulėtekis;VARPELIAI;1479530265;Ne;9;0;0;9
9910;Saulėtekis;VARPELIAI;1164913351;Ne;8;0;0;8
9911;Saulėtekis;VARPELIAI;3499215193;Ne;9;0;0;9
9912;Saulėtekis;GRŪDELIS;1864236745;Ne;0;0;2;2
9913;Saulėtekis;GRŪDELIS;6535620172;Ne;0;0;8;8
9914;Saulėtekis;GRŪDELIS;8252953405;Taip;0;0;4;4
9915;Saulėtekis;GRŪDELIS;5161940030;Ne;0;0;2;2
9916;Saulėtekis;GRŪDELIS;5218345414;Ne;2;0;1;3
9917;Saulėtekis;GRŪDELIS;9646060606;Ne;4;3;0;7
9918;Saulėtekis;GRŪDELIS;1934900185;Ne;11;2;0;13
9919;Saulėtekis;GRŪDELIS;1331793286;Ne;10;0;8;18
9920;Saulėtekis;GRŪDELIS;9995919137;Ne;6;3;0;9
9921;Saulėtekis;GRŪDELIS;6928825133;Ne;0;3;0;3
9922;Saulėtekis;GRŪDELIS;8138047893;Ne;7;0;0;7
9923;Saulėtekis;GRŪDELIS;3953501167;Ne;9;0;2;11
9924;Saulėtekis;GRŪDELIS;2646213073;Ne;0;1;2;3
9925;Saulėtekis;GRŪDELIS;6482182524;Ne;0;4;0;4
9926;Saulėtekis;GRŪDELIS;6779891385;Ne;5;0;0;5
9927;Saulėtekis;GRŪDELIS;9743690247;Ne;0;0;1;1
9928;Saulėtekis;GRŪDELIS;7666624373;Ne;0;0;2;2
9929;Saulėtekis;JONVABALIS;1715634399;Ne;6;2;0;8
9930;Saulėtekis;JONVABALIS;7227802003;Ne;1;0;0;1
9931;Saulėtekis;JONVABALIS;4613040294;Ne;1;0;0;1
9932;Saulėtekis;JONVABALIS;1655720839;Ne;0;1;0;1
9933;Saulėtekis;JONVABALIS;3166181835;Ne;6;0;0;6
9934;Saulėtekis;JONVABALIS;6599452886;Ne;5;0;1;6
9935;Saulėtekis;JONVABALIS;8896065807;Ne;3;3;0;6
9936;Saulėtekis;JONVABALIS;3207128776;Ne;6;0;0;6
9937;Saulėtekis;JONVABALIS;2311184444;Ne;0;6;0;6
9938;Saulėtekis;JONVABALIS;9618342480;Ne;5;2;0;7
9939;Saulėtekis;JONVABALIS;1516164123;Ne;3;0;0;3
9940;Saulėtekis;JONVABALIS;60462712074;Ne;0;0;2;2
9941;Saulėtekis;JONVABALIS;1902333363;Ne;4;0;0;4
9942;Saulėtekis;JONVABALIS;4610536784;Ne;16;0;0;16
9943;Saulėtekis;JONVABALIS;8239855620;Ne;2;0;0;2
9944;Saulėtekis;JONVABALIS;6501250875;Ne;1;0;4;5
9945;Saulėtekis;JONVABALIS;8231869593;Ne;0;18;0;18
9946;Saulėtekis;JONVABALIS;8603952810;Ne;0;0;4;4
9947;Saulėtekis;JONVABALIS;9657195627;Ne;7;0;0;7
9948;Saulėtekis;JONVABALIS;3541535891;Ne;0;4;0;4
9949;Saulėtekis;JONVABALIS;4663268649;Ne;0;8;0;8
9950;Saulėtekis;JONVABALIS;9228189399;Ne;4;0;1;5
9951;Saulėtekis;SMALSUČIAI;7051608858;Ne;0;1;0;1
9952;Saulėtekis;SMALSUČIAI;2021901593;Ne;1;0;0;1
9953;Saulėtekis;SMALSUČIAI;5954194843;Ne;2;0;0;2
9954;Saulėtekis;SMALSUČIAI;2546789906;Ne;0;1;0;1
9955;Saulėtekis;SMALSUČIAI;8002806189;Ne;5;0;0;5
9956;Saulėtekis;SMALSUČIAI;2238947856;Ne;0;1;1;2
9957;Saulėtekis;SMALSUČIAI;5678858566;Ne;1;8;0;9
9958;Saulėtekis;SMALSUČIAI;9634949452;Ne;0;0;1;1
9959;Saulėtekis;SMALSUČIAI;3450907715;Ne;11;6;0;17
9960;Saulėtekis;SMALSUČIAI;81153273188;Ne;0;5;0;5
9961;Saulėtekis;SMALSUČIAI;7842280836;Ne;0;1;2;3
9962;Saulėtekis;SMALSUČIAI;9945647968;Ne;0;3;0;3
9963;Saulėtekis;SMALSUČIAI;9983577817;Ne;6;0;1;7
9964;Saulėtekis;SMALSUČIAI;84982517658;Ne;0;0;1;1
9965;Saulėtekis;SMALSUČIAI;5487547105;Ne;0;20;0;20
9966;Saulėtekis;SMALSUČIAI;1922979974;Ne;9;1;2;12
9967;Saulėtekis;BITUTĖS;7766084857;Ne;0;0;1;1
9968;Saulėtekis;BITUTĖS;4537254306;Ne;0;0;1;1
9969;Saulėtekis;BITUTĖS;1699576940;Ne;14;0;0;14
9970;Saulėtekis;BITUTĖS;1481503733;Ne;0;0;1;1
9971;Saulėtekis;BITUTĖS;8302260087;Ne;0;0;5;5
9972;Saulėtekis;BITUTĖS;2593106154;Ne;0;4;1;5
9973;Saulėtekis;BITUTĖS;2813949848;Ne;0;0;4;4
9974;Saulėtekis;BITUTĖS;3058991890;Ne;5;0;0;5
9975;Saulėtekis;BITUTĖS;7986712728;Ne;0;6;0;6
9976;Saulėtekis;BITUTĖS;6087170055;Ne;5;0;1;6
9977;Saulėtekis;BITUTĖS;7758268674;Ne;0;0;1;1
9978;Saulėtekis;BITUTĖS;2077976415;Ne;0;0;3;3
9979;Saulėtekis;BITUTĖS;7075757274;Ne;0;4;0;4
9980;Saulėtekis;BITUTĖS;9870595577;Ne;0;0;1;1
9981;Saulėtekis;BITUTĖS;2154590089;Ne;0;1;0;1
9982;Saulėtekis;BITUTĖS;3220993253;Ne;6;0;0;6
9983;Saulėtekis;BITUTĖS;9918219913;Ne;4;0;1;5
9984;Saulėtekis;BITUTĖS;2698535938;Ne;0;1;5;6
9985;Saulėtekis;BITUTĖS;8517049464;Ne;4;0;0;4
9986;Saulėtekis;BITUTĖS;2656659133;Ne;5;0;0;5
9987;Saulėtekis;BITUTĖS;7027103276;Ne;6;0;1;7
9988;Saulėtekis;BITUTĖS;9605052795;Ne;0;0;3;3
9989;Saulėtekis;RIEŠUTĖLIAI;8767786444;Ne;0;0;1;1
9990;Saulėtekis;RIEŠUTĖLIAI;2224626144;Ne;10;0;0;10
9991;Saulėtekis;RIEŠUTĖLIAI;5898051775;Ne;0;0;3;3
9992;Saulėtekis;RIEŠUTĖLIAI;3356705340;Ne;16;0;0;16
9993;Saulėtekis;RIEŠUTĖLIAI;7824492464;Ne;3;0;0;3
9994;Saulėtekis;RIEŠUTĖLIAI;3935935671;Ne;1;1;0;2
9995;Saulėtekis;RIEŠUTĖLIAI;7807096583;Ne;4;0;0;4
9996;Saulėtekis;RIEŠUTĖLIAI;2548612572;Ne;11;0;0;11
9997;Saulėtekis;RIEŠUTĖLIAI;2908714227;Ne;6;0;10;16
9998;Saulėtekis;RIEŠUTĖLIAI;7305619721;Ne;0;0;19;19
9999;Saulėtekis;RIEŠUTĖLIAI;9516841263;Ne;0;0;3;3
10000;Saulėtekis;RIEŠUTĖLIAI;6183384994;Taip;1;0;3;4
10001;Saulėtekis;RIEŠUTĖLIAI;1540848694;Ne;4;1;0;5
10002;Saulėtekis;RIEŠUTĖLIAI;3559882322;Ne;9;0;1;10
10003;Saulėtekis;RIEŠUTĖLIAI;4767842376;Taip;5;0;7;12
10004;Skroblinukas;SVIRPLIUKŲ;5433647187;Ne;8;3;0;11
10005;Skroblinukas;SVIRPLIUKŲ;2195112297;Ne;5;10;10;25
10006;Skroblinukas;SVIRPLIUKŲ;4198512202;Ne;18;1;1;20
10007;Skroblinukas;SVIRPLIUKŲ;7750501815;Ne;12;0;4;16
10008;Skroblinukas;SVIRPLIUKŲ;1544598440;Ne;20;0;0;20
10009;Skroblinukas;SVIRPLIUKŲ;6574558658;Ne;4;1;1;6
10010;Skroblinukas;SVIRPLIUKŲ;4861971439;Ne;18;0;0;18
10011;Skroblinukas;SVIRPLIUKŲ;7817632987;Ne;8;0;2;10
10012;Skroblinukas;SVIRPLIUKŲ;7675772872;Ne;0;0;7;7
10013;Skroblinukas;SVIRPLIUKŲ;4266945644;Taip;11;0;4;15
10014;Skroblinukas;SVIRPLIUKŲ;9003855190;Ne;0;21;0;21
10015;Skroblinukas;SVIRPLIUKŲ;7216760382;Ne;10;1;0;11
10016;Skroblinukas;SVIRPLIUKŲ;5154111867;Ne;5;8;0;13
10017;Skroblinukas;SVIRPLIUKŲ;8622930871;Ne;15;7;4;26
10018;Skroblinukas;SVIRPLIUKŲ;3260267388;Ne;10;0;3;13
10019;Skroblinukas;SVIRPLIUKŲ;7761972818;Ne;1;0;0;1
10020;Skroblinukas;SVIRPLIUKŲ;9629502585;Ne;0;5;0;5
10021;Skroblinukas;SVIRPLIUKŲ;6461678336;Ne;0;0;4;4
10022;Skroblinukas;SVIRPLIUKŲ;8283516422;Ne;9;0;0;9
10023;Skroblinukas;GANDRIUKŲ;2197158518;Ne;0;2;1;3
10024;Skroblinukas;GANDRIUKŲ;2406619611;Ne;6;1;0;7
10025;Skroblinukas;GANDRIUKŲ;9572912046;Ne;2;16;2;20
10026;Skroblinukas;GANDRIUKŲ;5646847921;Ne;15;1;0;16
10027;Skroblinukas;GANDRIUKŲ;1851920334;Ne;0;5;1;6
10028;Skroblinukas;GANDRIUKŲ;9377215921;Ne;0;16;0;16
10029;Skroblinukas;GANDRIUKŲ;6489976163;Ne;6;2;0;8
10030;Skroblinukas;GANDRIUKŲ;1159546580;Ne;3;1;0;4
10031;Skroblinukas;GANDRIUKŲ;2630699296;Ne;0;3;0;3
10032;Skroblinukas;GANDRIUKŲ;2310750833;Ne;0;4;4;8
10033;Skroblinukas;GANDRIUKŲ;9888115079;Ne;0;9;2;11
10034;Skroblinukas;GANDRIUKŲ;9475514959;Ne;0;5;0;5
10035;Skroblinukas;GANDRIUKŲ;9031598603;Ne;12;2;3;17
10036;Skroblinukas;GANDRIUKŲ;5251903769;Ne;0;18;0;18
10037;Skroblinukas;GANDRIUKŲ;7385271438;Ne;1;0;7;8
10038;Skroblinukas;VYTURIUKŲ;3954228349;Ne;5;0;0;5
10039;Skroblinukas;VYTURIUKŲ;6879979868;Ne;0;0;2;2
10040;Skroblinukas;VYTURIUKŲ;4560580022;Ne;1;5;0;6
10041;Skroblinukas;VYTURIUKŲ;2330232287;Ne;0;0;2;2
10042;Skroblinukas;VYTURIUKŲ;3065235192;Taip;0;1;2;3
10043;Skroblinukas;VYTURIUKŲ;5902713448;Ne;11;2;0;13
10044;Skroblinukas;VYTURIUKŲ;3594000419;Ne;0;9;0;9
10045;Skroblinukas;VYTURIUKŲ;3512297435;Ne;0;9;0;9
10046;Skroblinukas;VYTURIUKŲ;2481980627;Ne;3;0;3;6
10047;Skroblinukas;VYTURIUKŲ;2978284436;Ne;0;7;0;7
10048;Skroblinukas;VYTURIUKŲ;7068452970;Ne;0;0;2;2
10049;Skroblinukas;VYTURIUKŲ;3292517112;Ne;4;0;2;6
10050;Skroblinukas;VYTURIUKŲ;3461165182;Ne;0;0;20;20
10051;Skroblinukas;VYTURIUKŲ;4129726208;Ne;9;0;1;10
10052;Skroblinukas;VYTURIUKŲ;3351309750;Ne;10;0;0;10
10053;Skroblinukas;VYTURIUKŲ;5101136022;Ne;0;0;7;7
10054;Skroblinukas;GENIUKŲ;2323980730;Ne;4;0;0;4
10055;Skroblinukas;GENIUKŲ;1325903217;Ne;0;11;0;11
10056;Skroblinukas;GENIUKŲ;8380073853;Ne;0;10;2;12
10057;Skroblinukas;GENIUKŲ;4436698905;Ne;4;13;0;17
10058;Skroblinukas;GENIUKŲ;1905085978;Ne;0;0;14;14
10059;Skroblinukas;GENIUKŲ;1557733803;Ne;10;5;0;15
10060;Skroblinukas;GENIUKŲ;9433465007;Ne;3;0;3;6
10061;Skroblinukas;GENIUKŲ;1395950886;Ne;8;0;0;8
10062;Skroblinukas;GENIUKŲ;1696303051;Ne;0;2;0;2
10063;Skroblinukas;GENIUKŲ;9846569195;Ne;0;0;4;4
10064;Skroblinukas;GENIUKŲ;4773576465;Ne;0;0;1;1
10065;Skroblinukas;GENIUKŲ;2704157855;Ne;0;0;1;1
10066;Skroblinukas;GENIUKŲ;9564385215;Ne;4;0;4;8
10067;Skroblinukas;GENIUKŲ;6129591146;Ne;6;4;0;10
10068;Skroblinukas;GENIUKŲ;3128337104;Ne;1;1;0;2
10069;Skroblinukas;GENIUKŲ;4272941994;Ne;6;0;7;13
10070;Skroblinukas;GENIUKŲ;3864043251;Ne;0;1;0;1
10071;Skroblinukas;GENIUKŲ;1064449916;Ne;5;0;2;7
10072;Skroblinukas;GENIUKŲ;2071447940;Ne;0;2;1;3
10073;Skroblinukas;BITUČIŲ;1934804499;Ne;5;3;0;8
10074;Skroblinukas;BITUČIŲ;2134821488;Ne;7;0;0;7
10075;Skroblinukas;BITUČIŲ;6604496585;Ne;0;5;0;5
10076;Skroblinukas;BITUČIŲ;3736883850;Ne;5;1;0;6
10077;Skroblinukas;BITUČIŲ;7191689856;Ne;0;14;0;14
10078;Skroblinukas;BITUČIŲ;8778072326;Ne;0;0;1;1
10079;Skroblinukas;BITUČIŲ;2032621707;Ne;0;1;4;5
10080;Skroblinukas;BITUČIŲ;8374103872;Ne;0;2;0;2
10081;Skroblinukas;BITUČIŲ;4945107862;Ne;2;0;8;10
10082;Skroblinukas;BITUČIŲ;9594078223;Ne;0;2;0;2
10083;Skroblinukas;BITUČIŲ;1688990637;Ne;0;0;1;1
10084;Skroblinukas;BITUČIŲ;1000804920;Ne;0;1;0;1
10085;Skroblinukas;BITUČIŲ;1711568129;Ne;0;3;5;8
10086;Skroblinukas;BITUČIŲ;1293348150;Ne;4;0;0;4
10087;Skroblinukas;BITUČIŲ;9664357125;Ne;4;0;6;10
10088;Skroblinukas;BITUČIŲ;6227583229;Ne;5;0;0;5
10089;Skroblinukas;BORUŽĖLIŲ;8715188878;Ne;0;18;8;26
10090;Skroblinukas;BORUŽĖLIŲ;4688496560;Ne;0;0;3;3
10091;Skroblinukas;BORUŽĖLIŲ;7407601996;Ne;12;1;0;13
10092;Skroblinukas;BORUŽĖLIŲ;7255510731;Ne;8;0;1;9
10093;Skroblinukas;BORUŽĖLIŲ;5841866621;Ne;7;0;1;8
10094;Skroblinukas;BORUŽĖLIŲ;9341501143;Ne;19;0;1;20
10095;Skroblinukas;BORUŽĖLIŲ;2523742608;Ne;17;0;0;17
10096;Skroblinukas;BORUŽĖLIŲ;2311459579;Ne;20;0;0;20
10097;Skroblinukas;BORUŽĖLIŲ;3490684777;Ne;19;0;2;21
10098;Skroblinukas;BORUŽĖLIŲ;2717586232;Taip;1;7;0;8
10099;Skroblinukas;BORUŽĖLIŲ;4840767748;Ne;6;3;4;13
10100;Skroblinukas;BORUŽĖLIŲ;5694105568;Ne;12;0;0;12
10101;Skroblinukas;BORUŽĖLIŲ;7771969055;Ne;1;0;4;5
10102;Skroblinukas;BORUŽĖLIŲ;4631657273;Ne;1;0;14;15
10103;Skroblinukas;BORUŽĖLIŲ;8711201474;Ne;7;0;4;11
10104;Skroblinukas;BORUŽĖLIŲ;9513546028;Ne;23;0;4;27
10105;Skroblinukas;SKRUZDĖLIUKŲ;5688453546;Ne;0;2;1;3
10106;Skroblinukas;SKRUZDĖLIUKŲ;6890306112;Ne;0;6;0;6
10107;Skroblinukas;SKRUZDĖLIUKŲ;6445065388;Ne;2;8;0;10
10108;Skroblinukas;SKRUZDĖLIUKŲ;9448253468;Ne;0;0;3;3
10109;Skroblinukas;SKRUZDĖLIUKŲ;3771045336;Ne;0;7;0;7
10110;Skroblinukas;SKRUZDĖLIUKŲ;4424763028;Ne;6;7;0;13
10111;Skroblinukas;SKRUZDĖLIUKŲ;9353353289;Ne;10;2;0;12
10112;Skroblinukas;SKRUZDĖLIUKŲ;5252389111;Ne;5;4;0;9
10113;Skroblinukas;SKRUZDĖLIUKŲ;5157913924;Ne;0;13;0;13
10114;Skroblinukas;SKRUZDĖLIUKŲ;9368764758;Ne;0;2;0;2
10115;Skroblinukas;SKRUZDĖLIUKŲ;9958188318;Ne;7;3;0;10
10116;Skroblinukas;SKRUZDĖLIUKŲ;8576448571;Ne;0;14;0;14
10117;Skroblinukas;SKRUZDĖLIUKŲ;1002570367;Ne;0;1;0;1
10118;Skroblinukas;SKRUZDĖLIUKŲ;3290115134;Ne;0;0;6;6
10119;Skroblinukas;SKRUZDĖLIUKŲ;9813249677;Ne;0;6;0;6
10120;Skroblinukas;SKRUZDĖLIUKŲ;2101748012;Ne;1;0;2;3
10121;Skroblinukas;SKRUZDĖLIUKŲ;2706526326;Ne;0;0;2;2
10122;Skroblinukas;SKRUZDĖLIUKŲ;5915278745;Ne;0;3;0;3
10123;Skroblinukas;SKRUZDĖLIUKŲ;6640062847;Ne;10;5;1;16
10124;Skroblinukas;ŽVIRBLIUKŲ;9162582460;Ne;4;0;1;5
10125;Skroblinukas;ŽVIRBLIUKŲ;7955574061;Ne;1;2;0;3
10126;Skroblinukas;ŽVIRBLIUKŲ;1232121301;Ne;16;4;0;20
10127;Skroblinukas;ŽVIRBLIUKŲ;1014993354;Ne;1;13;0;14
10128;Skroblinukas;ŽVIRBLIUKŲ;1167332689;Ne;0;1;0;1
10129;Skroblinukas;ŽVIRBLIUKŲ;7527177120;Ne;2;1;0;3
10130;Skroblinukas;ŽVIRBLIUKŲ;4002729040;Ne;14;0;0;14
10131;Skroblinukas;ŽVIRBLIUKŲ;4197050176;Ne;7;10;0;17
10132;Skroblinukas;ŽVIRBLIUKŲ;4390614970;Ne;6;0;0;6
10133;Skroblinukas;ŽVIRBLIUKŲ;6070633607;Ne;9;0;0;9
10134;Skroblinukas;ŽVIRBLIUKŲ;6135412007;Ne;9;0;7;16
10135;Skroblinukas;ŽVIRBLIUKŲ;2312400921;Ne;9;0;7;16
10136;Skroblinukas;ŽVIRBLIUKŲ;4491947846;Ne;9;7;0;16
10137;Skroblinukas;ŽVIRBLIUKŲ;7804920443;Ne;18;0;0;18
10138;Skroblinukas;ŽIOGELIŲ;2885814517;Ne;7;1;0;8
10139;Skroblinukas;ŽIOGELIŲ;2363368201;Ne;4;0;3;7
10140;Skroblinukas;ŽIOGELIŲ;4639384934;Ne;11;0;0;11
10141;Skroblinukas;ŽIOGELIŲ;5206925237;Ne;9;0;9;18
10142;Skroblinukas;ŽIOGELIŲ;7581372511;Ne;9;1;1;11
10143;Skroblinukas;ŽIOGELIŲ;6279909049;Ne;15;0;0;15
10144;Skroblinukas;ŽIOGELIŲ;8998236911;Ne;16;1;0;17
10145;Skroblinukas;ŽIOGELIŲ;6791969485;Ne;10;4;1;15
10146;Skroblinukas;ŽIOGELIŲ;9737310101;Ne;6;0;5;11
10147;Skroblinukas;ŽIOGELIŲ;8680329175;Ne;14;0;4;18
10148;Skroblinukas;ŽIOGELIŲ;7028068342;Taip;20;3;2;25
10149;Skroblinukas;ŽIOGELIŲ;8118284793;Ne;13;0;1;14
10150;Skroblinukas;ŽIOGELIŲ;1844211217;Ne;15;0;0;15
10151;Skroblinukas;ŽIOGELIŲ;5354832150;Ne;10;0;0;10
10152;Skroblinukas;ŽIOGELIŲ;3689247672;Ne;9;1;0;10
10153;Skroblinukas;ŽIOGELIŲ;6717008836;Ne;0;10;0;10
10154;Skroblinukas;STRAZDELIŲ;1820748152;Ne;3;2;0;5
10155;Skroblinukas;STRAZDELIŲ;5946356374;Ne;27;0;1;28
10156;Skroblinukas;STRAZDELIŲ;5274898590;Ne;10;7;0;17
10157;Skroblinukas;STRAZDELIŲ;8629189405;Taip;8;1;0;9
10158;Skroblinukas;STRAZDELIŲ;4091852305;Ne;0;4;0;4
10159;Skroblinukas;STRAZDELIŲ;9809817630;Ne;29;0;0;29
10160;Skroblinukas;STRAZDELIŲ;6475609065;Ne;5;0;1;6
10161;Skroblinukas;STRAZDELIŲ;3705638869;Ne;7;0;1;8
10162;Skroblinukas;STRAZDELIŲ;2511496284;Ne;21;0;5;26
10163;Skroblinukas;STRAZDELIŲ;7045587415;Ne;6;0;1;7
10164;Skroblinukas;STRAZDELIŲ;8734405028;Ne;6;7;0;13
10165;Skroblinukas;STRAZDELIŲ;3885884265;Ne;0;0;5;5
10166;Skroblinukas;STRAZDELIŲ;8544069746;Ne;6;2;0;8
10167;Skroblinukas;STRAZDELIŲ;6011466024;Ne;4;0;1;5
10168;Skroblinukas;DRUGELIŲ;7400908711;Ne;0;11;1;12
10169;Skroblinukas;DRUGELIŲ;3889890374;Ne;0;7;0;7
10170;Skroblinukas;DRUGELIŲ;9481718833;Ne;7;0;0;7
10171;Skroblinukas;DRUGELIŲ;8864594520;Ne;0;0;1;1
10172;Skroblinukas;DRUGELIŲ;2772360168;Ne;0;7;2;9
10173;Skroblinukas;DRUGELIŲ;5957417413;Taip;1;6;1;8
10174;Skroblinukas;DRUGELIŲ;2887161771;Ne;2;0;0;2
10175;Skroblinukas;DRUGELIŲ;4737605061;Ne;0;11;6;17
10176;Skroblinukas;DRUGELIŲ;8390240445;Ne;3;0;0;3
10177;Skroblinukas;DRUGELIŲ;2948231687;Ne;0;0;2;2
10178;Skroblinukas;DRUGELIŲ;5912771080;Ne;0;3;0;3
10179;Skroblinukas;DRUGELIŲ;7528824951;Ne;11;0;0;11
10180;Skroblinukas;DRUGELIŲ;2987938909;Ne;0;7;5;12
10181;Skroblinukas;DRUGELIŲ;1453029732;Ne;3;2;0;5
10182;Skroblinukas;PELĖDŽIUKŲ;8953844650;Ne;6;0;1;7
10183;Skroblinukas;PELĖDŽIUKŲ;5813075721;Ne;15;0;0;15
10184;Skroblinukas;PELĖDŽIUKŲ;3646325903;Ne;2;1;0;3
10185;Skroblinukas;PELĖDŽIUKŲ;9292990596;Ne;5;0;1;6
10186;Skroblinukas;PELĖDŽIUKŲ;8202855376;Ne;14;1;4;19
10187;Skroblinukas;PELĖDŽIUKŲ;8312341293;Ne;0;6;4;10
10188;Skroblinukas;PELĖDŽIUKŲ;3658815079;Ne;1;1;0;2
10189;Skroblinukas;PELĖDŽIUKŲ;5418212729;Ne;8;0;0;8
10190;Skroblinukas;PELĖDŽIUKŲ;4168542339;Ne;1;0;6;7
10191;Skroblinukas;PELĖDŽIUKŲ;8958893525;Ne;6;7;0;13
10192;Skroblinukas;PELĖDŽIUKŲ;6675716937;Ne;6;0;2;8
10193;Skroblinukas;PELĖDŽIUKŲ;1009065470;Taip;11;3;0;14
10194;Skroblinukas;PELĖDŽIUKŲ;9699407871;Ne;7;0;1;8
10195;Skroblinukas;PELĖDŽIUKŲ;9553242594;Ne;0;6;0;6
10196;Skroblinukas;PELĖDŽIUKŲ;4802801867;Ne;0;2;0;2
10197;Skroblinukas;PELĖDŽIUKŲ;3532258904;Ne;5;1;1;7
10198;Skroblinukas;PELĖDŽIUKŲ;1758987652;Ne;5;0;2;7
10199;Skroblinukas;PELĖDŽIUKŲ;8465074037;Ne;8;0;2;10
10200;Skroblinukas;PELĖDŽIUKŲ;2071093890;Ne;6;0;2;8
10201;Skroblinukas;PELĖDŽIUKŲ;9523720873;Ne;5;0;17;22
10202;Skroblinukas;PELĖDŽIUKŲ;7920117036;Ne;14;1;0;15
10203;Skroblinukas;PELĖDŽIUKŲ;2215428081;Ne;6;0;0;6
10204;Smalsučiai;Žibuoklės;6535494814;Ne;0;0;2;2
10205;Smalsučiai;Žibuoklės;3309134310;Ne;4;2;0;6
10206;Smalsučiai;Žibuoklės;2326167599;Ne;5;0;0;5
10207;Smalsučiai;Žibuoklės;4094037708;Ne;0;0;1;1
10208;Smalsučiai;Žibuoklės;5893045664;Ne;6;0;0;6
10209;Smalsučiai;Žibuoklės;5482692473;Ne;0;2;1;3
10210;Smalsučiai;Žibuoklės;2742992400;Ne;0;0;5;5
10211;Smalsučiai;Žibuoklės;6299355505;Ne;0;5;0;5
10212;Smalsučiai;Žibuoklės;3877274360;Ne;1;2;0;3
10213;Smalsučiai;Žibuoklės;7726086066;Ne;0;8;0;8
10214;Smalsučiai;Žibuoklės;9988599126;Ne;5;0;0;5
10215;Smalsučiai;Žibuoklės;5489140006;Ne;0;0;1;1
10216;Smalsučiai;Žibuoklės;1380214235;Ne;1;0;0;1
10217;Smalsučiai;Žibuoklės;8644849194;Ne;8;1;5;14
10218;Smalsučiai;Žibuoklės;4506058735;Ne;5;0;1;6
10219;Smalsučiai;Žibuoklės;6931092874;Ne;10;0;1;11
10220;Smalsučiai;Žibuoklės;3071594259;Ne;0;2;1;3
10221;Smalsučiai;Žibuoklės;7107126092;Ne;8;0;0;8
10222;Smalsučiai;Aitvarų;3349726106;Ne;10;0;0;10
10223;Smalsučiai;Aitvarų;2219168902;Ne;0;0;3;3
10224;Smalsučiai;Aitvarų;9305837033;Ne;15;0;0;15
10225;Smalsučiai;Aitvarų;9305837033;Ne;15;0;0;15
10226;Smalsučiai;Aitvarų;9305837033;Ne;15;0;0;15
10227;Smalsučiai;Aitvarų;8877566394;Ne;0;10;2;12
10228;Smalsučiai;Aitvarų;3888093640;Ne;0;0;10;10
10229;Smalsučiai;Aitvarų;8284740122;Taip;10;0;5;15
10230;Smalsučiai;Aitvarų;1309254661;Ne;5;0;0;5
10231;Smalsučiai;Aitvarų;4154327720;Ne;0;0;3;3
10232;Smalsučiai;Aitvarų;8985656809;Ne;11;0;4;15
10233;Smalsučiai;Aitvarų;6032887449;Ne;0;2;0;2
10234;Smalsučiai;Aitvarų;9821259659;Ne;0;1;3;4
10235;Smalsučiai;Aitvarų;6232068532;Ne;0;10;1;11
10236;Smalsučiai;Aitvarų;3157534923;Ne;10;0;3;13
10237;Smalsučiai;Aitvarų;6825499095;Ne;10;0;0;10
10238;Smalsučiai;Aitvarų;2835117069;Ne;11;0;0;11
10239;Smalsučiai;Aitvarų;2610753472;Ne;4;0;0;4
10240;Smalsučiai;Aitvarų;6090244401;Ne;0;0;3;3
10241;Smalsučiai;Sraigiukų;1471941426;Ne;0;5;0;5
10242;Smalsučiai;Sraigiukų;5406430393;Ne;0;3;0;3
10243;Smalsučiai;Sraigiukų;9582225178;Ne;6;2;0;8
10244;Smalsučiai;Sraigiukų;9604182559;Taip;0;3;0;3
10245;Smalsučiai;Sraigiukų;6469604093;Ne;0;1;0;1
10246;Smalsučiai;Sraigiukų;4364810458;Ne;0;1;0;1
10247;Smalsučiai;Sraigiukų;4566816316;Ne;2;2;0;4
10248;Smalsučiai;Sraigiukų;7396172351;Ne;0;2;1;3
10249;Smalsučiai;Sraigiukų;6358800570;Ne;7;0;0;7
10250;Smalsučiai;Sraigiukų;2327930850;Ne;2;1;0;3
10251;Smalsučiai;Sraigiukų;3787937467;Ne;0;14;0;14
10252;Smalsučiai;Sraigiukų;4824786207;Ne;7;1;0;8
10253;Smalsučiai;Sraigiukų;3399798448;Ne;0;2;0;2
10254;Smalsučiai;Sraigiukų;1997966082;Ne;0;3;0;3
10255;Smalsučiai;Sraigiukų;4585930202;Ne;0;11;0;11
10256;Smalsučiai;Sraigiukų;8193410963;Ne;2;0;0;2
10257;Smalsučiai;Sraigiukų;9155011285;Ne;2;1;0;3
10258;Smalsučiai;Saulučių;2259361924;Ne;10;0;0;10
10259;Smalsučiai;Saulučių;1162964613;Taip;9;0;1;10
10260;Smalsučiai;Saulučių;9934952886;Ne;9;1;0;10
10261;Smalsučiai;Saulučių;9556433086;Ne;0;2;0;2
10262;Smalsučiai;Saulučių;3252901131;Ne;1;0;0;1
10263;Smalsučiai;Saulučių;9743116843;Ne;0;6;1;7
10264;Smalsučiai;Saulučių;2392217952;Ne;3;0;1;4
10265;Smalsučiai;Saulučių;1447512509;Ne;0;0;20;20
10266;Smalsučiai;Saulučių;2034284973;Ne;0;0;2;2
10267;Smalsučiai;Saulučių;7423419934;Ne;9;0;0;9
10268;Smalsučiai;Saulučių;7049101015;Ne;4;0;0;4
10269;Smalsučiai;Saulučių;9183519167;Ne;6;0;4;10
10270;Smalsučiai;Saulučių;5708986552;Ne;9;0;2;11
10271;Smalsučiai;Saulučių;8630411244;Ne;0;0;2;2
10272;Smalsučiai;Saulučių;5541908981;Ne;3;6;0;9
10273;Smalsučiai;Viščiukų;6006832443;Ne;9;0;0;9
10274;Smalsučiai;Viščiukų;9864518144;Ne;4;3;0;7
10275;Smalsučiai;Viščiukų;8128348060;Ne;0;0;14;14
10276;Smalsučiai;Viščiukų;4847584492;Ne;3;0;0;3
10277;Smalsučiai;Viščiukų;6415906523;Ne;11;0;0;11
10278;Smalsučiai;Viščiukų;4425714802;Ne;6;0;0;6
10279;Smalsučiai;Viščiukų;6090391818;Ne;13;0;0;13
10280;Smalsučiai;Viščiukų;7023531176;Ne;0;0;1;1
10281;Smalsučiai;Viščiukų;8259056296;Ne;2;0;1;3
10282;Smalsučiai;Viščiukų;9637877396;Ne;7;0;4;11
10283;Smalsučiai;Viščiukų;7137550663;Ne;1;0;0;1
10284;Smalsučiai;Viščiukų;3582805599;Ne;0;2;0;2
10285;Smalsučiai;Viščiukų;3757955200;Ne;5;2;0;7
10286;Smalsučiai;Viščiukų;4288788194;Ne;5;0;2;7
10287;Smalsučiai;Viščiukų;7874635165;Ne;0;2;7;9
10288;Smalsučiai;Viščiukų;5098291946;Ne;13;0;0;13
10289;Smalsučiai;Viščiukų;8578693978;Ne;0;9;0;9
10290;Smalsučiai;Viščiukų;4379645417;Ne;0;6;0;6
10291;Smalsučiai;Viščiukų;5536697307;Ne;0;0;20;20
10292;Smalsučiai;Boružėlių;1703679877;Ne;0;10;0;10
10293;Smalsučiai;Boružėlių;2208462326;Ne;0;2;0;2
10294;Smalsučiai;Boružėlių;6643253926;Ne;0;6;0;6
10295;Smalsučiai;Boružėlių;6085020049;Ne;0;2;2;4
10296;Smalsučiai;Boružėlių;69450514879;Ne;0;2;2;4
10297;Smalsučiai;Boružėlių;3063127699;Ne;0;1;0;1
10298;Smalsučiai;Boružėlių;2737886714;Ne;0;2;0;2
10299;Smalsučiai;Boružėlių;8523742213;Ne;14;0;1;15
10300;Smalsučiai;Boružėlių;5325706638;Ne;8;1;0;9
10301;Smalsučiai;Boružėlių;9314811354;Ne;0;6;0;6
10302;Smalsučiai;Boružėlių;9196634595;Ne;0;5;1;6
10303;Smalsučiai;Zuikių;96002139110;Ne;0;0;1;1
10304;Smalsučiai;Zuikių;2953239027;Ne;0;3;0;3
10305;Smalsučiai;Zuikių;5441966713;Ne;6;0;0;6
10306;Smalsučiai;Zuikių;9632022271;Ne;2;0;0;2
10307;Smalsučiai;Zuikių;8306946163;Ne;0;6;0;6
10308;Smalsučiai;Zuikių;6469044880;Ne;0;5;0;5
10309;Smalsučiai;Zuikių;99467576480;Ne;6;0;0;6
10310;Smalsučiai;Zuikių;2059832436;Ne;0;2;0;2
10311;Smalsučiai;Zuikių;1316590100;Ne;0;0;2;2
10312;Smalsučiai;Zuikių;1372591510;Ne;0;2;0;2
10313;Smalsučiai;Zuikių;8810690546;Ne;0;4;0;4
10314;Smalsučiai;Zuikių;9481692900;Ne;0;3;0;3
10315;Smalsučiai;Zuikių;4909226602;Ne;2;0;1;3
10316;Smalsučiai;Zuikių;6536165801;Ne;0;0;1;1
10317;Smalsučiai;Zuikių;3644256220;Ne;3;0;0;3
10318;Smalsučiai;Nykštukų;9181601713;Taip;0;1;0;1
10319;Smalsučiai;Nykštukų;2015172985;Taip;0;1;0;1
10320;Smalsučiai;Nykštukų;8893480054;Ne;0;1;0;1
10321;Smalsučiai;Nykštukų;6996192450;Ne;0;1;4;5
10322;Smalsučiai;Nykštukų;9378696084;Ne;10;0;2;12
10323;Smalsučiai;Nykštukų;7267389695;Ne;20;0;0;20
10324;Smalsučiai;Nykštukų;6996901033;Taip;0;0;1;1
10325;Smalsučiai;Nykštukų;4847212069;Ne;0;0;7;7
10326;Smalsučiai;Nykštukų;1344461213;Ne;0;0;1;1
10327;Smalsučiai;Nykštukų;1224857159;Ne;3;1;0;4
10328;Smalsučiai;Nykštukų;8690626891;Ne;5;0;0;5
10329;Smalsučiai;Nykštukų;5719056997;Ne;10;1;0;11
10330;Smalsučiai;Nykštukų;3646740184;Ne;10;1;2;13
10331;Smalsučiai;Nykštukų;6642882883;Ne;6;0;2;8
10332;Smalsučiai;Nykštukų;1023255628;Ne;0;0;10;10
10333;Smalsučiai;Katinėlių;2045283348;Ne;2;1;1;4
10334;Smalsučiai;Katinėlių;9710944054;Ne;5;0;0;5
10335;Smalsučiai;Katinėlių;5213319192;Ne;5;0;0;5
10336;Smalsučiai;Katinėlių;3782502443;Ne;0;1;0;1
10337;Smalsučiai;Katinėlių;6358968221;Ne;1;5;0;6
10338;Smalsučiai;Katinėlių;9984878984;Ne;2;5;0;7
10339;Smalsučiai;Katinėlių;2369569130;Ne;1;0;0;1
10340;Smalsučiai;Katinėlių;5535858303;Ne;1;0;1;2
10341;Smalsučiai;Katinėlių;2662588310;Ne;3;1;1;5
10342;Smalsučiai;Katinėlių;2668720481;Ne;0;4;0;4
10343;Smalsučiai;Katinėlių;4030955447;Ne;0;2;0;2
10344;Smalsučiai;Katinėlių;2926560092;Ne;7;0;0;7
10345;Smalsučiai;Katinėlių;8210141253;Ne;1;1;0;2
10346;Smalsučiai;Katinėlių;6131743288;Ne;10;0;5;15
10347;Smalsučiai;Katinėlių;7318218997;Ne;9;0;0;9
10348;Smalsučiai;Katinėlių;1331674807;Ne;1;1;1;3
10349;Smalsučiai;PELĖDŽIUKAI;1668692281;Ne;0;0;1;1
10350;Smalsučiai;PELĖDŽIUKAI;1181574676;Ne;12;1;0;13
10351;Smalsučiai;PELĖDŽIUKAI;1599488035;Ne;0;2;0;2
10352;Smalsučiai;PELĖDŽIUKAI;4727475042;Ne;14;0;0;14
10353;Smalsučiai;PELĖDŽIUKAI;8520753848;Ne;0;2;0;2
10354;Smalsučiai;PELĖDŽIUKAI;22791221635;Ne;0;1;0;1
10355;Smalsučiai;PELĖDŽIUKAI;3607226859;Ne;0;5;0;5
10356;Smalsučiai;PELĖDŽIUKAI;1467603676;Ne;0;8;0;8
10357;Smalsučiai;PELĖDŽIUKAI;5159799570;Ne;0;0;3;3
10358;Smalsučiai;PELĖDŽIUKAI;19592364606;Ne;0;2;0;2
10359;Smalsučiai;PELĖDŽIUKAI;1824321380;Ne;0;2;0;2
10360;Smalsučiai;PELĖDŽIUKAI;6207026048;Ne;0;7;0;7
10361;Smalsučiai;PELĖDŽIUKAI;4145769042;Ne;0;1;0;1
10362;Smalsučiai;PELĖDŽIUKAI;6529889121;Ne;0;2;0;2
10363;Smalsučiai;PELĖDŽIUKAI;1673246147;Ne;0;10;0;10
10364;Smalsučiai;PELĖDŽIUKAI;3627324317;Ne;0;1;0;1
10365;Smalsučiai;PELĖDŽIUKAI;5730866119;Ne;0;2;1;3
10366;Smalsučiai;PELĖDŽIUKAI;5611487967;Ne;5;1;0;6
10367;Smalsučiai;Pingvinukai;1305808180;Ne;0;3;0;3
10368;Smalsučiai;Pingvinukai;9222858199;Ne;10;0;0;10
10369;Smalsučiai;Pingvinukai;1909797307;Ne;3;0;4;7
10370;Smalsučiai;Pingvinukai;7400990599;Ne;0;0;5;5
10371;Smalsučiai;Pingvinukai;2673224420;Ne;5;0;1;6
10372;Smalsučiai;Pingvinukai;9771532192;Ne;0;17;0;17
10373;Smalsučiai;Pingvinukai;8402519872;Ne;0;1;0;1
10374;Smalsučiai;Pingvinukai;3746193901;Ne;5;4;0;9
10375;Smalsučiai;Pingvinukai;8499612926;Ne;11;0;0;11
10376;Smalsučiai;Pingvinukai;3625628040;Ne;9;1;0;10
10377;Smalsučiai;Pingvinukai;6128134712;Ne;4;0;0;4
10378;Smalsučiai;Pingvinukai;3045521655;Ne;7;0;0;7
10379;Smalsučiai;Pingvinukai;8615789381;Ne;7;0;2;9
10380;Smalsučiai;Voverikų;4973651632;Ne;0;0;7;7
10381;Smalsučiai;Voverikų;3509573985;Ne;9;1;0;10
10382;Smalsučiai;Voverikų;1485450504;Ne;4;0;0;4
10383;Smalsučiai;Voverikų;3042578767;Ne;8;1;0;9
10384;Smalsučiai;Voverikų;2070248478;Ne;3;0;2;5
10385;Smalsučiai;Voverikų;7205498813;Ne;2;1;1;4
10386;Smalsučiai;Voverikų;2612579099;Ne;0;19;0;19
10387;Smalsučiai;Voverikų;1162035522;Ne;6;0;2;8
10388;Smalsučiai;Voverikų;4105866680;Ne;1;1;0;2
10389;Spragtukas;NYKŠTUKAI;2943832694;Ne;0;0;1;1
10390;Spragtukas;NYKŠTUKAI;8297700739;Ne;0;2;0;2
10391;Spragtukas;NYKŠTUKAI;9595221494;Ne;6;0;0;6
10392;Spragtukas;NYKŠTUKAI;6185016824;Taip;4;8;0;12
10393;Spragtukas;NYKŠTUKAI;8715073512;Ne;10;0;0;10
10394;Spragtukas;NYKŠTUKAI;1710184531;Ne;3;0;0;3
10395;Spragtukas;NYKŠTUKAI;2076126173;Ne;0;3;0;3
10396;Spragtukas;NYKŠTUKAI;3012345413;Ne;6;0;0;6
10397;Spragtukas;NYKŠTUKAI;8698492694;Ne;0;8;0;8
10398;Spragtukas;NYKŠTUKAI;1150002524;Ne;0;3;0;3
10399;Spragtukas;NYKŠTUKAI;8288793522;Ne;2;6;0;8
10400;Spragtukas;NYKŠTUKAI;6986034864;Ne;0;3;0;3
10401;Spragtukas;NYKŠTUKAI;9665371858;Ne;8;0;0;8
10402;Spragtukas;SAULUTĖ;3337355440;Taip;1;1;0;2
10403;Spragtukas;SAULUTĖ;3692960591;Taip;1;2;0;3
10404;Spragtukas;SAULUTĖ;6192381779;Ne;1;0;0;1
10405;Spragtukas;SAULUTĖ;4586034709;Taip;5;0;0;5
10406;Spragtukas;SAULUTĖ;2305568596;Ne;0;1;0;1
10407;Spragtukas;SAULUTĖ;1150727381;Ne;2;14;0;16
10408;Spragtukas;SAULUTĖ;9191831532;Ne;0;1;0;1
10409;Spragtukas;SAULUTĖ;3948232692;Ne;9;2;2;13
10410;Spragtukas;SAULUTĖ;9149954373;Ne;4;3;0;7
10411;Spragtukas;SAULUTĖ;7511680722;Ne;5;0;0;5
10412;Spragtukas;SAULUTĖ;8235791891;Ne;10;0;1;11
10413;Spragtukas;SAULUTĖ;2987638580;Ne;6;0;6;12
10414;Spragtukas;SAULUTĖ;5687853390;Ne;9;1;0;10
10415;Spragtukas;SAULUTĖ;6679886985;Ne;1;0;1;2
10416;Spragtukas;SAULUTĖ;2879077913;Ne;2;4;0;6
10417;Spragtukas;SAULUTĖ;1998148708;Ne;0;2;1;3
10418;Spragtukas;SAULUTĖ;8227086854;Ne;0;7;0;7
10419;Spragtukas;SAULUTĖ;5697451914;Ne;1;2;0;3
10420;Spragtukas;SAULUTĖ;2879614195;Ne;0;11;0;11
10421;Spragtukas;SPINDULĖLIAI;4675031453;Ne;0;0;5;5
10422;Spragtukas;SPINDULĖLIAI;9781727236;Ne;0;0;3;3
10423;Spragtukas;SPINDULĖLIAI;1029392579;Ne;0;0;1;1
10424;Spragtukas;SPINDULĖLIAI;6417098461;Ne;0;1;0;1
10425;Spragtukas;SPINDULĖLIAI;4485715299;Ne;0;6;0;6
10426;Spragtukas;SPINDULĖLIAI;4224693184;Ne;0;0;4;4
10427;Spragtukas;SPINDULĖLIAI;2493749424;Ne;5;0;0;5
10428;Spragtukas;SPINDULĖLIAI;3411349574;Ne;3;0;1;4
10429;Spragtukas;SPINDULĖLIAI;1323065222;Ne;0;1;0;1
10430;Spragtukas;SPINDULĖLIAI;4764295850;Ne;10;0;0;10
10431;Spragtukas;SPINDULĖLIAI;6385589724;Ne;2;0;3;5
10432;Spragtukas;SPINDULĖLIAI;8912031554;Ne;0;16;0;16
10433;Spragtukas;SPINDULĖLIAI;6634972088;Ne;0;20;0;20
10434;Spragtukas;SPINDULĖLIAI;7326816081;Ne;0;20;0;20
10435;Spragtukas;SPINDULĖLIAI;5864894208;Ne;0;20;0;20
10436;Spragtukas;GINTARĖLIAI;8339926929;Ne;5;2;0;7
10437;Spragtukas;GINTARĖLIAI;1525489137;Ne;8;0;0;8
10438;Spragtukas;GINTARĖLIAI;5724874569;Ne;11;4;0;15
10439;Spragtukas;GINTARĖLIAI;1430632638;Ne;0;5;0;5
10440;Spragtukas;GINTARĖLIAI;8625143071;Ne;7;0;0;7
10441;Spragtukas;GINTARĖLIAI;2255007161;Ne;7;10;0;17
10442;Spragtukas;GINTARĖLIAI;9664130733;Ne;0;6;1;7
10443;Spragtukas;GINTARĖLIAI;2316071393;Ne;10;0;0;10
10444;Spragtukas;GINTARĖLIAI;8698469979;Ne;0;6;0;6
10445;Spragtukas;GINTARĖLIAI;1747417905;Ne;5;0;5;10
10446;Spragtukas;GINTARĖLIAI;6388163866;Ne;0;10;0;10
10447;Spragtukas;GINTARĖLIAI;8191270443;Ne;4;0;0;4
10448;Spragtukas;GINTARĖLIAI;3684183344;Taip;0;3;0;3
10449;Spragtukas;GINTARĖLIAI;7806145224;Ne;0;1;0;1
10450;Spragtukas;GINTARĖLIAI;2992201984;Ne;10;0;0;10
10451;Spragtukas;GINTARĖLIAI;2217627240;Ne;12;2;0;14
10452;Spragtukas;ČIPOLINO;2371848091;Ne;0;10;0;10
10453;Spragtukas;ČIPOLINO;6582680700;Ne;15;0;0;15
10454;Spragtukas;ČIPOLINO;1599958343;Ne;0;2;0;2
10455;Spragtukas;ČIPOLINO;1547670082;Ne;0;5;0;5
10456;Spragtukas;ČIPOLINO;7504632314;Ne;11;0;0;11
10457;Spragtukas;ČIPOLINO;6526633051;Ne;0;3;0;3
10458;Spragtukas;ČIPOLINO;7640805299;Ne;0;12;0;12
10459;Spragtukas;ČIPOLINO;1365907314;Ne;9;1;0;10
10460;Spragtukas;ČIPOLINO;4941531443;Ne;10;4;0;14
10461;Spragtukas;ČIPOLINO;3566797064;Ne;9;0;0;9
10462;Spragtukas;ČIPOLINO;69114720307;Ne;1;2;0;3
10463;Spragtukas;ČIPOLINO;1044112039;Ne;8;0;0;8
10464;Spragtukas;ČIPOLINO;5707084920;Ne;9;8;0;17
10465;Spragtukas;ČIPOLINO;1482803930;Ne;5;5;0;10
10466;Spragtukas;ČIPOLINO;3356307067;Ne;0;9;0;9
10467;Spragtukas;ČIPOLINO;2691004546;Ne;0;20;0;20
10468;Spragtukas;BORUŽĖLĖS;8614890958;Ne;0;3;0;3
10469;Spragtukas;BORUŽĖLĖS;6548270099;Ne;4;0;0;4
10470;Spragtukas;BORUŽĖLĖS;2356476212;Ne;6;0;4;10
10471;Spragtukas;BORUŽĖLĖS;8287102733;Ne;0;1;0;1
10472;Spragtukas;BORUŽĖLĖS;6584145176;Ne;4;6;0;10
10473;Spragtukas;BORUŽĖLĖS;9965087132;Ne;6;4;0;10
10474;Spragtukas;BORUŽĖLĖS;5150028968;Taip;0;6;0;6
10475;Spragtukas;BORUŽĖLĖS;6824861247;Ne;0;2;0;2
10476;Spragtukas;BORUŽĖLĖS;7264683147;Ne;10;0;0;10
10477;Spragtukas;BORUŽĖLĖS;5556920140;Ne;0;1;0;1
10478;Spragtukas;BORUŽĖLĖS;6547167325;Ne;5;0;0;5
10479;Spragtukas;BORUŽĖLĖS;4347275614;Taip;6;0;1;7
10480;Spragtukas;BORUŽĖLĖS;7073092344;Ne;16;8;0;24
10481;Spragtukas;BORUŽĖLĖS;1046613540;Ne;7;7;0;14
10482;Spragtukas;DRUGELIAI;1336973131;Ne;5;2;0;7
10483;Spragtukas;DRUGELIAI;1514277186;Ne;5;0;0;5
10484;Spragtukas;DRUGELIAI;1326603216;Ne;13;0;0;13
10485;Spragtukas;DRUGELIAI;5306883933;Ne;0;1;0;1
10486;Spragtukas;DRUGELIAI;72636559695;Ne;9;0;0;9
10487;Spragtukas;DRUGELIAI;1384812263;Ne;6;0;0;6
10488;Spragtukas;DRUGELIAI;1849644444;Ne;0;1;0;1
10489;Spragtukas;DRUGELIAI;4929866385;Ne;0;1;0;1
10490;Spragtukas;DRUGELIAI;8246512283;Ne;0;2;1;3
10491;Spragtukas;DRUGELIAI;9045185920;Ne;6;0;0;6
10492;Spragtukas;DRUGELIAI;1627243902;Ne;10;0;0;10
10493;Spragtukas;DRUGELIAI;8463747761;Ne;0;4;0;4
10494;Spragtukas;GAIDELIAI;2541126095;Ne;17;0;0;17
10495;Spragtukas;GAIDELIAI;4097458544;Ne;0;0;2;2
10496;Spragtukas;GAIDELIAI;8957903306;Ne;8;2;1;11
10497;Spragtukas;GAIDELIAI;1326714513;Taip;5;2;4;11
10498;Spragtukas;GAIDELIAI;4676052255;Taip;16;2;0;18
10499;Spragtukas;GAIDELIAI;7108640957;Ne;14;2;0;16
10500;Spragtukas;GAIDELIAI;6370760287;Ne;0;0;3;3
10501;Spragtukas;GAIDELIAI;7911124524;Ne;0;7;0;7
10502;Spragtukas;GAIDELIAI;9509296936;Ne;5;0;1;6
10503;Spragtukas;GAIDELIAI;3216796441;Ne;10;2;0;12
10504;Spragtukas;GAIDELIAI;8440836721;Ne;6;4;0;10
10505;Spragtukas;GAIDELIAI;4535021524;Ne;1;1;0;2
10506;Spragtukas;GAIDELIAI;2679834328;Ne;3;2;0;5
10507;Spragtukas;GAIDELIAI;7313963137;Ne;2;2;0;4
10508;Spragtukas;ŽUVELĖS;9078163633;Ne;3;1;0;4
10509;Spragtukas;ŽUVELĖS;8762832644;Ne;4;0;0;4
10510;Spragtukas;ŽUVELĖS;8652973900;Ne;5;0;0;5
10511;Spragtukas;ŽUVELĖS;3261213140;Ne;0;4;0;4
10512;Spragtukas;ŽUVELĖS;5689392663;Ne;2;0;0;2
10513;Spragtukas;ŽUVELĖS;9592271053;Taip;0;1;0;1
10514;Spragtukas;ŽUVELĖS;1272075883;Ne;5;0;0;5
10515;Spragtukas;ŽUVELĖS;6503842956;Ne;3;2;0;5
10516;Spragtukas;ŽUVELĖS;2578400770;Ne;2;1;0;3
10517;Spragtukas;ŽUVELĖS;3139748724;Ne;0;0;12;12
10518;Spragtukas;ŽUVELĖS;8640877497;Ne;13;0;0;13
10519;Spragtukas;ŽUVELĖS;2025314314;Ne;3;0;0;3
10520;Spragtukas;ŽUVELĖS;4848647219;Taip;0;1;0;1
10521;Spragtukas;ŽUVELĖS;3491418162;Ne;0;1;0;1
10522;Spragtukas;ŽUVELĖS;5836788916;Ne;0;1;0;1
10523;Spragtukas;ŽUVELĖS;5704941595;Ne;6;5;0;11
10524;Spragtukas;ŽUVELĖS;3286456855;Ne;0;7;0;7
10525;Spragtukas;ŽUVELĖS;9662188102;Ne;0;2;1;3
10526;Spragtukas;ŽUVELĖS;2539660577;Ne;8;2;0;10
10527;Spragtukas;ŽUVELĖS;6836232179;Ne;0;1;0;1
10528;Spragtukas;ŽUVELĖS;6757604305;Ne;9;0;0;9
10529;Spragtukas;RIEŠUTĖLIAI;8684246143;Ne;0;0;7;7
10530;Spragtukas;RIEŠUTĖLIAI;1407611561;Ne;5;0;0;5
10531;Spragtukas;RIEŠUTĖLIAI;8773952377;Ne;1;5;0;6
10532;Spragtukas;RIEŠUTĖLIAI;1977526177;Ne;5;1;0;6
10533;Spragtukas;RIEŠUTĖLIAI;7615522850;Taip;1;8;0;9
10534;Spragtukas;RIEŠUTĖLIAI;6797841737;Ne;5;1;0;6
10535;Spragtukas;RIEŠUTĖLIAI;8342098575;Ne;11;0;0;11
10536;Spragtukas;RIEŠUTĖLIAI;1992850470;Ne;3;0;0;3
10537;Spragtukas;RIEŠUTĖLIAI;6158327941;Ne;0;1;0;1
10538;Spragtukas;RIEŠUTĖLIAI;4134127256;Ne;12;0;0;12
10539;Spragtukas;RIEŠUTĖLIAI;3009567338;Ne;0;1;0;1
10540;Spragtukas;RIEŠUTĖLIAI;2648358901;Ne;11;1;0;12
10541;Spragtukas;RIEŠUTĖLIAI;3822599790;Ne;9;7;0;16
10542;Spragtukas;RIEŠUTĖLIAI;7767940027;Ne;4;2;1;7
10543;Spragtukas;RIEŠUTĖLIAI;4625065223;Ne;6;0;0;6
10544;Spragtukas;RIEŠUTĖLIAI;6963190259;Ne;4;0;0;4
10545;Spragtukas;RIEŠUTĖLIAI;8732886749;Ne;9;1;0;10
10546;Spragtukas;RIEŠUTĖLIAI;9975308171;Taip;8;1;0;9
10547;Spragtukas;VIŠČIUKAI;8473814776;Ne;2;7;0;9
10548;Spragtukas;VIŠČIUKAI;9951226210;Ne;7;2;0;9
10549;Spragtukas;VIŠČIUKAI;9294770557;Ne;7;0;0;7
10550;Spragtukas;VIŠČIUKAI;9443091032;Ne;15;2;0;17
10551;Spragtukas;VIŠČIUKAI;4461217748;Ne;0;2;2;4
10552;Spragtukas;VIŠČIUKAI;7412489884;Ne;0;20;0;20
10553;Spragtukas;VIŠČIUKAI;9579825533;Ne;20;0;0;20
10554;Spragtukas;VIŠČIUKAI;2087416420;Ne;6;0;0;6
10555;Spragtukas;VIŠČIUKAI;7933945356;Ne;4;0;0;4
10556;Spragtukas;VIŠČIUKAI;1545887575;Ne;3;0;0;3
10557;Spragtukas;VIŠČIUKAI;5948139350;Taip;2;0;0;2
10558;Spragtukas;VIŠČIUKAI;8110631015;Ne;0;1;0;1
10559;Spragtukas;VIŠČIUKAI;7522592685;Taip;15;0;2;17
10560;Spragtukas;VIŠČIUKAI;3110077272;Ne;11;0;0;11
10561;Spragtukas;MEŠKIUKAI;5440632023;Ne;8;0;0;8
10562;Spragtukas;MEŠKIUKAI;7271482702;Ne;12;2;0;14
10563;Spragtukas;MEŠKIUKAI;9099921999;Ne;2;0;0;2
10564;Spragtukas;MEŠKIUKAI;8307801987;Ne;13;2;0;15
10565;Spragtukas;MEŠKIUKAI;1493711333;Ne;0;1;0;1
10566;Spragtukas;MEŠKIUKAI;4742132709;Taip;0;12;0;12
10567;Spragtukas;MEŠKIUKAI;7256772984;Ne;6;0;0;6
10568;Spragtukas;MEŠKIUKAI;1487259291;Ne;1;2;8;11
10569;Spragtukas;MEŠKIUKAI;5225669850;Ne;9;0;0;9
10570;Spragtukas;MEŠKIUKAI;8109894184;Ne;0;2;1;3
10571;Spragtukas;MEŠKIUKAI;8396134652;Ne;19;0;1;20
10572;Spragtukas;MEŠKIUKAI;1784758799;Ne;8;0;0;8
10573;Spragtukas;MEŠKIUKAI;4441290823;Ne;1;2;0;3
10574;Spragtukas;MEŠKIUKAI;8486415968;Ne;8;0;0;8
10575;Spragtukas;MEŠKIUKAI;2026249018;Taip;5;4;0;9
10576;Spragtukas;MEŠKIUKAI;3423699840;Ne;0;0;1;1
10577;Strazdelis;Žiogelių;5346485534;Ne;0;1;0;1
10578;Strazdelis;Žiogelių;9933042249;Ne;0;10;0;10
10579;Strazdelis;Žiogelių;8581533423;Ne;2;0;0;2
10580;Strazdelis;Žiogelių;1141752802;Ne;0;0;2;2
10581;Strazdelis;Žiogelių;1228651165;Ne;5;1;1;7
10582;Strazdelis;Žiogelių;7768700192;Ne;8;0;1;9
10583;Strazdelis;Žiogelių;3596394112;Ne;14;2;0;16
10584;Strazdelis;Žiogelių;8493572399;Ne;0;6;0;6
10585;Strazdelis;Žiogelių;4563247013;Ne;20;0;0;20
10586;Strazdelis;Žiogelių;6437928004;Ne;0;1;4;5
10587;Strazdelis;Žiogelių;5600979545;Taip;0;11;0;11
10588;Strazdelis;Žiogelių;8971395173;Ne;1;1;0;2
10589;Strazdelis;Žiogelių;4955907851;Ne;10;0;0;10
10590;Strazdelis;Žiogelių;7425818775;Ne;4;2;0;6
10591;Strazdelis;Žiogelių;4516288199;Ne;0;3;0;3
10592;Strazdelis;Žiogelių;3028208428;Ne;5;0;0;5
10593;Strazdelis;Žiogelių;2753635198;Ne;0;1;8;9
10594;Strazdelis;Žiogelių;1194918926;Ne;0;0;5;5
10595;Strazdelis;Žiogelių;6651360492;Ne;10;3;0;13
10596;Strazdelis;Žiogelių;8686828982;Taip;4;3;1;8
10597;Strazdelis;Žiogelių;7913526787;Ne;2;0;2;4
10598;Strazdelis;Šeimynėlės;6570504154;Ne;0;5;0;5
10599;Strazdelis;Šeimynėlės;3848288765;Ne;0;2;0;2
10600;Strazdelis;Šeimynėlės;5033799225;Ne;0;2;0;2
10601;Strazdelis;Šeimynėlės;3897248010;Ne;0;1;0;1
10602;Strazdelis;Šeimynėlės;2990771887;Ne;0;10;0;10
10603;Strazdelis;Šeimynėlės;2185364583;Ne;0;1;1;2
10604;Strazdelis;Šeimynėlės;7905687363;Ne;0;2;0;2
10605;Strazdelis;Šeimynėlės;4501391298;Ne;0;4;0;4
10606;Strazdelis;Šeimynėlės;9057914477;Ne;2;0;1;3
10607;Strazdelis;Šeimynėlės;1277844969;Ne;0;2;0;2
10608;Strazdelis;Šeimynėlės;1012692326;Ne;9;0;0;9
10609;Strazdelis;Šeimynėlės;8899530711;Ne;9;0;0;9
10610;Strazdelis;Šeimynėlės;8336759173;Ne;14;1;0;15
10611;Strazdelis;Šeimynėlės;5784406335;Ne;0;4;0;4
10612;Strazdelis;Šeimynėlės;2068793184;Taip;4;3;0;7
10613;Strazdelis;Šeimynėlės;5296218650;Ne;12;0;1;13
10614;Strazdelis;Šeimynėlės;1754106518;Ne;0;2;0;2
10615;Strazdelis;Šeimynėlės;9806107189;Ne;5;2;0;7
10616;Strazdelis;Šeimynėlės;5924324241;Ne;10;0;5;15
10617;Strazdelis;Šeimynėlės;1553329770;Ne;0;1;0;1
10618;Strazdelis;Genelio;8277333786;Ne;0;0;2;2
10619;Strazdelis;Genelio;3084249678;Ne;1;4;0;5
10620;Strazdelis;Genelio;5499310072;Ne;0;0;2;2
10621;Strazdelis;Genelio;8333151969;Ne;0;5;0;5
10622;Strazdelis;Genelio;7083940713;Ne;5;0;0;5
10623;Strazdelis;Genelio;6271193831;Ne;3;0;0;3
10624;Strazdelis;Genelio;6480803618;Ne;5;2;5;12
10625;Strazdelis;Genelio;9490861272;Ne;1;4;0;5
10626;Strazdelis;Genelio;6071502600;Ne;1;1;0;2
10627;Strazdelis;Genelio;3713797440;Ne;1;1;0;2
10628;Strazdelis;Genelio;3456287323;Ne;0;7;0;7
10629;Strazdelis;Genelio;2459718449;Ne;0;9;0;9
10630;Strazdelis;Genelio;2483283363;Ne;0;1;0;1
10631;Strazdelis;Genelio;8956634754;Ne;9;0;0;9
10632;Strazdelis;Genelio;8762859576;Ne;0;1;2;3
10633;Strazdelis;Genelio;2306665561;Ne;0;5;0;5
10634;Strazdelis;Genelio;7680242840;Ne;0;6;0;6
10635;Strazdelis;Genelio;5742215922;Ne;1;1;2;4
10636;Strazdelis;Genelio;6954336739;Ne;0;2;0;2
10637;Strazdelis;Vikruolių;8182994112;Ne;6;0;0;6
10638;Strazdelis;Vikruolių;2871673641;Ne;0;1;0;1
10639;Strazdelis;Vikruolių;8754275576;Ne;1;1;0;2
10640;Strazdelis;Vikruolių;6147183190;Ne;5;1;0;6
10641;Strazdelis;Vikruolių;7216768880;Ne;0;1;0;1
10642;Strazdelis;Vikruolių;7823110477;Ne;0;1;0;1
10643;Strazdelis;Vikruolių;1187534672;Ne;0;1;0;1
10644;Strazdelis;Vikruolių;9904719582;Ne;0;1;0;1
10645;Strazdelis;Vikruolių;7308925265;Ne;5;4;0;9
10646;Strazdelis;Vikruolių;50350281905;Ne;9;1;0;10
10647;Strazdelis;Vikruolių;8038163444;Ne;0;1;0;1
10648;Strazdelis;Vikruolių;1540973269;Ne;0;1;0;1
10649;Strazdelis;Vikruolių;5580738386;Ne;6;2;0;8
10650;Strazdelis;Vikruolių;3955783379;Ne;8;0;0;8
10651;Strazdelis;Vikruolių;4430183106;Ne;8;0;2;10
10652;Strazdelis;Vikruolių;4076266466;Ne;9;1;0;10
10653;Strazdelis;Vyturėlių;4929828091;Ne;0;2;0;2
10654;Strazdelis;Vyturėlių;4454199703;Ne;5;2;0;7
10655;Strazdelis;Vyturėlių;3662217925;Ne;0;3;0;3
10656;Strazdelis;Vyturėlių;4698566091;Ne;0;5;0;5
10657;Strazdelis;Vyturėlių;8274897977;Ne;2;1;0;3
10658;Strazdelis;Vyturėlių;1665134387;Ne;1;0;0;1
10659;Strazdelis;Vyturėlių;5698472204;Ne;5;0;0;5
10660;Strazdelis;Vyturėlių;1481671624;Ne;0;0;2;2
10661;Strazdelis;Vyturėlių;4697537943;Ne;0;6;0;6
10662;Strazdelis;Vyturėlių;6014213362;Ne;0;3;0;3
10663;Strazdelis;Vyturėlių;9835716116;Ne;0;3;0;3
10664;Strazdelis;Vyturėlių;3943578036;Ne;0;1;0;1
10665;Strazdelis;Vyturėlių;2802486859;Ne;1;4;0;5
10666;Strazdelis;Vyturėlių;3482802557;Ne;0;1;0;1
10667;Strazdelis;Vyturėlių;5749300013;Ne;0;6;0;6
10668;Strazdelis;Vyturėlių;7215063033;Ne;0;1;0;1
10669;Strazdelis;Vyturėlių;7149827850;Ne;4;0;2;6
10670;Strazdelis;Vyturėlių;5834348507;Ne;1;7;0;8
10671;Strazdelis;Vyturėlių;2238875354;Ne;4;0;0;4
10672;Strazdelis;Varpelio;4159072583;Ne;0;13;0;13
10673;Strazdelis;Varpelio;9502341478;Ne;0;1;0;1
10674;Strazdelis;Varpelio;1955166372;Ne;8;0;0;8
10675;Strazdelis;Varpelio;4873707286;Ne;0;4;0;4
10676;Strazdelis;Varpelio;2824416350;Ne;0;1;0;1
10677;Strazdelis;Varpelio;3610250359;Ne;6;2;0;8
10678;Strazdelis;Varpelio;2766970956;Ne;0;3;0;3
10679;Strazdelis;Varpelio;1173067724;Ne;1;0;0;1
10680;Strazdelis;Varpelio;1021364759;Ne;0;2;0;2
10681;Strazdelis;Varpelio;7469848482;Ne;4;2;0;6
10682;Strazdelis;Varpelio;1841285441;Ne;0;1;0;1
10683;Strazdelis;Varpelio;7393083827;Ne;0;6;0;6
10684;Strazdelis;Varpelio;6555803164;Ne;0;5;0;5
10685;Strazdelis;Varpelio;1706026100;Ne;0;4;0;4
10686;Strazdelis;Varpelio;8035603341;Ne;0;3;0;3
10687;Strazdelis;Varpelio;2789987994;Ne;0;2;0;2
10688;Strazdelis;Varpelio;2251157025;Ne;1;0;0;1
10689;Strazdelis;Varpelio;5904388732;Ne;3;4;0;7
10690;Strazdelis;Varpelio;3460993302;Ne;0;5;0;5
10691;Strazdelis;Pelėdžiukų;5892430004;Taip;11;0;0;11
10692;Strazdelis;Pelėdžiukų;1704292727;Ne;0;2;0;2
10693;Strazdelis;Pelėdžiukų;8371999002;Ne;0;1;0;1
10694;Strazdelis;Pelėdžiukų;4448556404;Ne;0;1;0;1
10695;Strazdelis;Pelėdžiukų;8854150040;Ne;0;1;0;1
10696;Strazdelis;Pelėdžiukų;4004930488;Ne;4;0;0;4
10697;Strazdelis;Pelėdžiukų;5768674837;Ne;1;4;4;9
10698;Strazdelis;Pelėdžiukų;9761595867;Ne;0;2;1;3
10699;Strazdelis;Pelėdžiukų;7876385010;Ne;0;1;0;1
10700;Strazdelis;Pelėdžiukų;2848984531;Ne;8;0;0;8
10701;Strazdelis;Pelėdžiukų;1901641517;Ne;0;2;0;2
10702;Strazdelis;Pelėdžiukų;4617237063;Ne;0;7;0;7
10703;Strazdelis;Pelėdžiukų;3036380561;Ne;0;7;0;7
10704;Strazdelis;Pelėdžiukų;7349106795;Ne;0;1;0;1
10705;Strazdelis;Pelėdžiukų;8938997208;Ne;0;1;0;1
10706;Strazdelis;Pelėdžiukų;4562530311;Ne;0;0;12;12
10707;Strazdelis;Saulutės;27177757900;Ne;1;1;0;2
10708;Strazdelis;Saulutės;40932140069;Ne;9;1;0;10
10709;Strazdelis;Saulutės;1523471662;Ne;3;4;0;7
10710;Strazdelis;Saulutės;2854642875;Ne;5;0;0;5
10711;Strazdelis;Saulutės;7578229276;Ne;0;6;0;6
10712;Strazdelis;Saulutės;6614184499;Ne;0;1;0;1
10713;Strazdelis;Saulutės;3425430317;Ne;0;1;0;1
10714;Strazdelis;Saulutės;7081517417;Ne;0;1;0;1
10715;Strazdelis;Saulutės;67641340859;Ne;0;1;0;1
10716;Strazdelis;Saulutės;1802092125;Ne;0;1;0;1
10717;Strazdelis;Saulutės;1391009140;Ne;0;4;0;4
10718;Strazdelis;Saulutės;8808299050;Ne;3;0;0;3
10719;Strazdelis;Saulutės;3270413614;Ne;3;0;0;3
10720;Strazdelis;Saulutės;12713270671;Ne;0;4;0;4
10721;Strazdelis;Saulutės;3753612757;Ne;4;0;0;4
10722;Strazdelis;Saulutės;1474503932;Ne;0;0;2;2
10723;Strazdelis;Saulutės;9662566992;Taip;3;0;0;3
10724;Strazdelis;Bitutės;6508933324;Ne;4;0;0;4
10725;Strazdelis;Bitutės;4020547762;Ne;0;2;0;2
10726;Strazdelis;Bitutės;8753316532;Ne;6;1;0;7
10727;Strazdelis;Bitutės;5232064496;Ne;0;9;0;9
10728;Strazdelis;Bitutės;1539984888;Ne;0;1;0;1
10729;Strazdelis;Bitutės;4400849922;Ne;0;1;0;1
10730;Strazdelis;Bitutės;7890064837;Ne;0;7;0;7
10731;Strazdelis;Bitutės;1881071425;Taip;9;1;0;10
10732;Strazdelis;Bitutės;2908567982;Ne;0;5;0;5
10733;Strazdelis;Bitutės;9548465554;Ne;5;0;0;5
10734;Strazdelis;Bitutės;7466648222;Ne;0;1;0;1
10735;Strazdelis;Bitutės;8443837176;Ne;7;0;0;7
10736;Strazdelis;Bitutės;2963535523;Ne;4;1;0;5
10737;Strazdelis;Bitutės;4369569609;Ne;0;1;0;1
10738;Strazdelis;Bitutės;1005082012;Taip;0;2;1;3
10739;Strazdelis;Bitutės;2589303722;Ne;3;1;0;4
10740;Strazdelis;Bitutės;2081538505;Ne;5;7;0;12
10741;Strazdelis;Mažylių;9357195019;Ne;4;0;0;4
10742;Strazdelis;Mažylių;5256750516;Ne;12;2;0;14
10743;Strazdelis;Mažylių;4740153387;Ne;14;1;0;15
10744;Strazdelis;Mažylių;4965049621;Ne;5;0;0;5
10745;Strazdelis;Mažylių;2378910473;Ne;0;16;0;16
10746;Strazdelis;Mažylių;4699373769;Ne;0;1;0;1
10747;Strazdelis;Mažylių;3648883435;Ne;20;0;0;20
10748;Strazdelis;Mažylių;6788732053;Ne;0;2;0;2
10749;Strazdelis;Mažylių;2764495554;Ne;0;2;0;2
10750;Strazdelis;Mažylių;7039347901;Ne;0;0;2;2
10751;Strazdelis;Mažylių;4904388387;Ne;6;0;0;6
10752;Strazdelis;Mažylių;3082900425;Ne;5;0;0;5
10753;Strazdelis;Mažylių;1265557971;Ne;7;2;2;11
10754;Strazdelis;Mažylių;3900225484;Ne;15;0;0;15
10755;Strazdelis;Mažylių;8734458997;Ne;8;0;0;8
10756;Strazdelis;Mažylių;3561551193;Ne;0;5;0;5
10757;Strazdelis;Mažylių;1932428439;Ne;4;1;0;5
10758;Strazdelis;Mažylių;2871841427;Ne;4;0;0;4
10759;Strazdelis;Mažylių;3572665646;Ne;7;0;1;8
10760;Strazdelis;Mažylių;8699020650;Ne;8;0;0;8
10761;Strazdelis;Mažylių;3688573846;Ne;7;0;0;7
10762;Strazdelis;Pabiručių;7087235151;Ne;12;0;1;13
10763;Strazdelis;Pabiručių;6853311266;Ne;0;2;5;7
10764;Strazdelis;Pabiručių;3030445367;Ne;2;1;0;3
10765;Strazdelis;Pabiručių;4966668662;Ne;0;1;0;1
10766;Strazdelis;Pabiručių;8484672456;Ne;0;0;3;3
10767;Strazdelis;Pabiručių;8953577585;Ne;4;0;0;4
10768;Strazdelis;Pabiručių;1823053560;Ne;0;0;11;11
10769;Strazdelis;Pabiručių;8677659019;Ne;5;0;0;5
10770;Strazdelis;Pabiručių;4848650799;Ne;0;1;0;1
10771;Strazdelis;Pabiručių;7716476995;Ne;9;0;0;9
10772;Strazdelis;Pabiručių;4174940099;Ne;10;0;0;10
10773;Strazdelis;Pabiručių;7065489134;Ne;6;0;0;6
10774;Strazdelis;Pabiručių;8554043784;Ne;10;6;0;16
10775;Strazdelis;Pabiručių;1952086370;Taip;15;0;0;15
10776;Strazdelis;Pabiručių;7802337169;Ne;1;0;0;1
10777;Strazdelis;Pabiručių;8356680705;Ne;5;0;0;5
10778;Strazdelis;Pabiručių;6457478289;Ne;0;0;3;3
10779;Strazdelis;Pabiručių;3426039979;Ne;14;1;0;15
10780;Strazdelis;Pabiručių;4715198107;Ne;1;0;0;1
10781;Strazdelis;Pabiručių;4334385271;Ne;10;0;1;11
10782;Strazdelis;Pabiručių;1770338988;Ne;7;0;2;9
10783;Sveikuolis;Saulutė;2610917987;Ne;12;0;0;12
10784;Sveikuolis;Saulutė;3062543025;Ne;10;0;0;10
10785;Sveikuolis;Gintarėlis;7601362970;Ne;9;0;0;9
10786;Sveikuolis;Gintarėlis;1923905404;Ne;2;0;0;2
10787;Sveikuolis;Gintarėlis;4270680590;Ne;4;0;0;4
10788;Sveikuolis;Gintarėlis;9652670348;Ne;1;0;0;1
10789;Sveikuolis;Gintarėlis;4166776211;Ne;10;0;0;10
10790;Sveikuolis;EŽIUKAI;7277208374;Ne;4;0;0;4
10791;Sveikuolis;Boružėlė;8725179707;Ne;3;0;0;3
10792;Sveikuolis;Boružėlė;6221037630;Ne;5;0;0;5
10793;Sveikuolis;Boružėlė;6515123277;Ne;4;0;0;4
10794;Sveikuolis;Boružėlė;1226952966;Ne;1;0;0;1
10795;Sveikuolis;Boružėlė;5072424245;Ne;5;0;0;5
10796;Sveikuolis;LAIVELIS;8970206913;Ne;6;0;0;6
10797;Sveikuolis;BITUTĖ;6409695736;Ne;11;0;0;11
10798;Sveikuolis;BITUTĖ;4168236478;Ne;4;0;0;4
10799;Sveikuolis;BITUTĖ;4459702578;Ne;12;0;0;12
10800;Sveikuolis;BITUTĖ;8056339864;Ne;1;0;0;1
10801;Sveikuolis;BITUTĖ;8518868218;Ne;12;0;0;12
10802;Sveikuolis;VARPELIS;5936442120;Ne;5;0;0;5
10803;Sveikuolis;VARPELIS;5515614747;Ne;10;0;0;10
10804;Sveikuolis;VARPELIS;6269239492;Ne;18;0;0;18
10805;Sveikuolis;VARPELIS;8056684097;Ne;9;0;0;9
10806;Sveikuolis;VARPELIS;9873943920;Ne;5;0;0;5
10807;Sveikuolis;DRUGELIAI;1265118618;Ne;11;0;0;11
10808;Sveikuolis;DRUGELIAI;1737540337;Ne;5;0;0;5
10809;Sveikuolis;DRUGELIAI;5271282369;Ne;9;0;0;9
10810;Sveikuolis;DRUGELIAI;4062019702;Ne;7;0;0;7
10811;Sveikuolis;DRUGELIAI;8105953362;Ne;9;0;0;9
10812;Sveikuolis;DRUGELIAI;2737692810;Ne;4;0;0;4
10813;Sveikuolis;DRUGELIAI;4876267122;Taip;9;0;0;9
10814;Sveikuolis;ŽVAIGŽDUTĖ;8105068323;Ne;5;0;0;5
10815;Sveikuolis;ŽVAIGŽDUTĖ;1671494587;Ne;7;0;0;7
10816;Sveikuolis;ŽVAIGŽDUTĖ;6734362374;Ne;9;0;0;9
10817;Sveikuolis;ŽVAIGŽDUTĖ;6767728568;Ne;9;0;0;9
10818;Sveikuolis;ŽVAIGŽDUTĖ;9893764995;Ne;12;0;0;12
10819;Sveikuolis;MEŠKIUKAI;2978563798;Taip;19;0;0;19
10820;Sveikuolis;MEŠKIUKAI;2942450857;Ne;8;0;0;8
10821;Sveikuolis;MEŠKIUKAI;3347146751;Taip;5;0;0;5
10822;Sveikuolis;MEŠKIUKAI;7159776808;Ne;2;0;0;2
10823;Sveikuolis;MEŠKIUKAI;1398901995;Ne;6;0;0;6
10824;Sveikuolis;SAULĖGRĄŽA;7735606844;Ne;6;0;0;6
10825;Sveikuolis;SAULĖGRĄŽA;3601650280;Ne;1;0;0;1
10826;Sveikuolis;SAULĖGRĄŽA;3408609555;Ne;1;0;0;1
10827;Šermukšnėlė;MOLINUKAI;9746313951;Ne;7;0;0;7
10828;Šermukšnėlė;MOLINUKAI;9329824053;Ne;0;5;1;6
10829;Šermukšnėlė;MOLINUKAI;2714018690;Ne;6;0;2;8
10830;Šermukšnėlė;MOLINUKAI;5262882873;Ne;0;2;0;2
10831;Šermukšnėlė;MOLINUKAI;2985284699;Ne;0;2;2;4
10832;Šermukšnėlė;MOLINUKAI;4983510683;Ne;0;2;2;4
10833;Šermukšnėlė;MOLINUKAI;7385114026;Ne;0;0;2;2
10834;Šermukšnėlė;MOLINUKAI;2784732759;Ne;5;0;2;7
10835;Šermukšnėlė;MOLINUKAI;3342919832;Ne;0;1;0;1
10836;Šermukšnėlė;MOLINUKAI;9337047371;Ne;12;0;1;13
10837;Šermukšnėlė;MOLINUKAI;5835100042;Ne;0;0;1;1
10838;Šermukšnėlė;MOLINUKAI;4952285322;Ne;0;1;0;1
10839;Šermukšnėlė;MOLINUKAI;8104182167;Ne;9;0;1;10
10840;Šermukšnėlė;MOLINUKAI;6988120570;Ne;4;10;0;14
10841;Šermukšnėlė;MOLINUKAI;8728441474;Ne;7;0;0;7
10842;Šermukšnėlė;MOLINUKAI;4075151928;Ne;0;0;1;1
10843;Šermukšnėlė;MOLINUKAI;4968522498;Ne;12;2;0;14
10844;Šermukšnėlė;ŠIAUDINUKAI;3451361097;Ne;0;0;2;2
10845;Šermukšnėlė;ŠIAUDINUKAI;7002917737;Ne;5;0;0;5
10846;Šermukšnėlė;ŠIAUDINUKAI;7785671936;Ne;5;0;0;5
10847;Šermukšnėlė;ŠIAUDINUKAI;3637882900;Ne;0;10;0;10
10848;Šermukšnėlė;ŠIAUDINUKAI;1159472154;Ne;4;0;2;6
10849;Šermukšnėlė;ŠIAUDINUKAI;4956414941;Ne;6;0;0;6
10850;Šermukšnėlė;ŠIAUDINUKAI;3499394539;Ne;2;5;0;7
10851;Šermukšnėlė;ŠIAUDINUKAI;1157979179;Ne;0;5;0;5
10852;Šermukšnėlė;ŠIAUDINUKAI;3701053997;Taip;10;0;0;10
10853;Šermukšnėlė;ŠIAUDINUKAI;3082272196;Ne;0;0;2;2
10854;Šermukšnėlė;ŠIAUDINUKAI;9903310024;Ne;7;0;0;7
10855;Šermukšnėlė;ŠIAUDINUKAI;5627334876;Ne;4;0;1;5
10856;Šermukšnėlė;ŠIAUDINUKAI;3550736579;Ne;15;0;1;16
10857;Šermukšnėlė;ŠIAUDINUKAI;5993599994;Ne;9;10;0;19
10858;Šermukšnėlė;ŠIAUDINUKAI;6077798297;Ne;5;0;0;5
10859;Šermukšnėlė;ŠIAUDINUKAI;2351386211;Ne;10;0;1;11
10860;Šermukšnėlė;TOŠINUKAI;2160616078;Ne;0;0;1;1
10861;Šermukšnėlė;TOŠINUKAI;1661977128;Ne;6;0;3;9
10862;Šermukšnėlė;TOŠINUKAI;3994316729;Ne;0;0;1;1
10863;Šermukšnėlė;TOŠINUKAI;5140264695;Taip;6;0;0;6
10864;Šermukšnėlė;TOŠINUKAI;78341448188;Ne;5;0;1;6
10865;Šermukšnėlė;TOŠINUKAI;8279692394;Ne;12;0;0;12
10866;Šermukšnėlė;TOŠINUKAI;5096946133;Ne;0;0;5;5
10867;Šermukšnėlė;TOŠINUKAI;4981204674;Ne;0;1;0;1
10868;Šermukšnėlė;TOŠINUKAI;7229632099;Ne;10;0;0;10
10869;Šermukšnėlė;TOŠINUKAI;6413821285;Ne;0;6;0;6
10870;Šermukšnėlė;TOŠINUKAI;9035625467;Ne;3;0;0;3
10871;Šermukšnėlė;TOŠINUKAI;5832072195;Ne;0;11;0;11
10872;Šermukšnėlė;TOŠINUKAI;3222466449;Ne;0;0;3;3
10873;Šermukšnėlė;TOŠINUKAI;1569084597;Taip;0;0;5;5
10874;Šermukšnėlė;ODINUKAI;4422415026;Ne;0;1;1;2
10875;Šermukšnėlė;ODINUKAI;5575518612;Ne;0;3;2;5
10876;Šermukšnėlė;ODINUKAI;5733540837;Ne;0;0;7;7
10877;Šermukšnėlė;ODINUKAI;7262199284;Ne;0;1;0;1
10878;Šermukšnėlė;ODINUKAI;5159461963;Ne;0;2;0;2
10879;Šermukšnėlė;ODINUKAI;5354978646;Ne;9;0;0;9
10880;Šermukšnėlė;ODINUKAI;1882432812;Ne;9;0;0;9
10881;Šermukšnėlė;ODINUKAI;3949629658;Ne;4;1;0;5
10882;Šermukšnėlė;ODINUKAI;4201283154;Ne;5;0;0;5
10883;Šermukšnėlė;ODINUKAI;7667114310;Ne;10;0;0;10
10884;Šermukšnėlė;ODINUKAI;7245206247;Ne;0;0;3;3
10885;Šermukšnėlė;ODINUKAI;5397385093;Ne;0;0;3;3
10886;Šermukšnėlė;ODINUKAI;4331948700;Ne;0;0;1;1
10887;Šermukšnėlė;ODINUKAI;6718242890;Ne;0;0;3;3
10888;Šermukšnėlė;ODINUKAI;9664249364;Taip;1;1;0;2
10889;Šermukšnėlė;ODINUKAI;1064222922;Ne;10;0;2;12
10890;Šermukšnėlė;ODINUKAI;7770630580;Ne;0;0;2;2
10891;Šermukšnėlė;ODINUKAI;6194188831;Ne;0;0;1;1
10892;Šermukšnėlė;KRIAUKLELĖS;3613456202;Ne;0;0;3;3
10893;Šermukšnėlė;KRIAUKLELĖS;8541743148;Ne;2;0;0;2
10894;Šermukšnėlė;KRIAUKLELĖS;8709426669;Ne;9;4;0;13
10895;Šermukšnėlė;KRIAUKLELĖS;6599779539;Ne;4;4;0;8
10896;Šermukšnėlė;KRIAUKLELĖS;9876533442;Ne;8;0;1;9
10897;Šermukšnėlė;KRIAUKLELĖS;3653792683;Ne;0;0;5;5
10898;Šermukšnėlė;KRIAUKLELĖS;7266947985;Ne;0;0;1;1
10899;Šermukšnėlė;KRIAUKLELĖS;4256630681;Ne;5;0;0;5
10900;Šermukšnėlė;KRIAUKLELĖS;8117261716;Ne;0;0;1;1
10901;Šermukšnėlė;KRIAUKLELĖS;3245643086;Ne;0;7;0;7
10902;Šermukšnėlė;KRIAUKLELĖS;9074111563;Ne;7;0;1;8
10903;Šermukšnėlė;KRIAUKLELĖS;9908568127;Ne;6;1;0;7
10904;Šermukšnėlė;KRIAUKLELĖS;3002999054;Ne;0;0;1;1
10905;Šermukšnėlė;KRIAUKLELĖS;8748166398;Taip;2;0;0;2
10906;Šermukšnėlė;KRIAUKLELĖS;5408843906;Ne;0;1;0;1
10907;Šermukšnėlė;VYTINUKAI;1523361932;Ne;0;0;3;3
10908;Šermukšnėlė;VYTINUKAI;25189813939;Ne;5;0;1;6
10909;Šermukšnėlė;VYTINUKAI;83123267733;Ne;0;0;6;6
10910;Šermukšnėlė;VYTINUKAI;20028832329;Ne;3;1;0;4
10911;Šermukšnėlė;VYTINUKAI;3959795064;Ne;0;1;0;1
10912;Šermukšnėlė;VYTINUKAI;1244964311;Ne;5;0;1;6
10913;Šermukšnėlė;VYTINUKAI;83882579952;Ne;0;4;0;4
10914;Šermukšnėlė;VYTINUKAI;60840526220;Ne;0;5;0;5
10915;Šermukšnėlė;VYTINUKAI;1025787925;Ne;0;0;2;2
10916;Šermukšnėlė;VYTINUKAI;1519623099;Ne;0;0;2;2
10917;Šermukšnėlė;VYTINUKAI;9654198217;Ne;9;0;1;10
10918;Šermukšnėlė;VYTINUKAI;1670047548;Ne;4;0;2;6
10919;Šermukšnėlė;VYTINUKAI;5281637612;Ne;0;5;1;6
10920;Šermukšnėlė;VYTINUKAI;1685592290;Ne;0;0;1;1
10921;Šermukšnėlė;VYTINUKAI;8123096990;Ne;7;0;0;7
10922;Šermukšnėlė;VYTINUKAI;8511421692;Ne;0;0;4;4
10923;Šermukšnėlė;VYTINUKAI;3883861823;Ne;4;3;0;7
10924;Šermukšnėlė;VYTINUKAI;2163955454;Ne;1;0;3;4
10925;Šermukšnėlė;GINTARĖLIAI;2989011150;Ne;0;1;0;1
10926;Šermukšnėlė;GINTARĖLIAI;1996859146;Ne;3;0;1;4
10927;Šermukšnėlė;GINTARĖLIAI;4176986876;Ne;0;2;0;2
10928;Šermukšnėlė;GINTARĖLIAI;7036078780;Ne;10;0;0;10
10929;Šermukšnėlė;GINTARĖLIAI;1994737857;Ne;0;4;0;4
10930;Šermukšnėlė;GINTARĖLIAI;4619811264;Ne;0;5;0;5
10931;Šermukšnėlė;GINTARĖLIAI;5886893562;Ne;10;4;0;14
10932;Šermukšnėlė;GINTARĖLIAI;4783726095;Ne;0;3;0;3
10933;Šermukšnėlė;GINTARĖLIAI;9714566919;Ne;0;1;2;3
10934;Šermukšnėlė;GINTARĖLIAI;5172187141;Ne;0;2;0;2
10935;Šermukšnėlė;GINTARĖLIAI;3688946505;Ne;4;0;0;4
10936;Šermukšnėlė;GINTARĖLIAI;5905330617;Ne;0;0;1;1
10937;Šermukšnėlė;GINTARĖLIAI;1636944853;Ne;0;7;0;7
10938;Šermukšnėlė;GINTARĖLIAI;7053319091;Ne;6;0;0;6
10939;Šermukšnėlė;GINTARĖLIAI;7305013368;Ne;0;3;0;3
10940;Šermukšnėlė;GINTARĖLIAI;6698650179;Ne;9;1;0;10
10941;Šermukšnėlė;GINTARĖLIAI;7106405983;Ne;0;0;2;2
10942;Šermukšnėlė;AKMENUKAI;3543061360;Ne;4;1;0;5
10943;Šermukšnėlė;AKMENUKAI;7564745299;Ne;11;2;0;13
10944;Šermukšnėlė;AKMENUKAI;9617044855;Ne;10;3;0;13
10945;Šermukšnėlė;AKMENUKAI;1856012121;Ne;9;0;0;9
10946;Šermukšnėlė;AKMENUKAI;8407947566;Ne;14;0;0;14
10947;Šermukšnėlė;AKMENUKAI;8859731179;Ne;7;0;2;9
10948;Šermukšnėlė;AKMENUKAI;1902848560;Ne;11;2;0;13
10949;Šermukšnėlė;AKMENUKAI;3513568460;Ne;11;0;2;13
10950;Šermukšnėlė;AKMENUKAI;6896990721;Ne;7;0;0;7
10951;Šermukšnėlė;AKMENUKAI;4230698872;Ne;0;0;1;1
10952;Šermukšnėlė;AKMENUKAI;8669676262;Ne;0;4;0;4
10953;Šermukšnėlė;AKMENUKAI;3148857617;Ne;15;1;0;16
10954;Šermukšnėlė;AKMENUKAI;4965640386;Ne;5;0;0;5
10955;Šermukšnėlė;AKMENUKAI;3639954786;Ne;0;0;6;6
10956;Šermukšnėlė;AKMENUKAI;7843128263;Ne;1;1;0;2
10957;Šermukšnėlė;AKMENUKAI;9805841777;Ne;3;7;0;10
10958;Šermukšnėlė;AKMENUKAI;3945291560;Ne;5;0;1;6
10959;Šermukšnėlė;AKMENUKAI;5660238634;Ne;4;0;1;5
10960;Šermukšnėlė;AKMENUKAI;6067298318;Ne;8;0;0;8
10961;Šermukšnėlė;AKMENUKAI;5678559268;Ne;19;0;0;19
10962;Šermukšnėlė;AKMENUKAI;8479230675;Ne;10;4;0;14
10963;Šermukšnėlė;AKMENUKAI;6162830167;Ne;8;0;3;11
10964;Šermukšnėlė;SIŪLINUKAI;4619600451;Ne;0;0;1;1
10965;Šermukšnėlė;SIŪLINUKAI;2967000352;Ne;9;0;1;10
10966;Šermukšnėlė;SIŪLINUKAI;2740644605;Ne;10;0;0;10
10967;Šermukšnėlė;SIŪLINUKAI;6429038861;Ne;7;0;0;7
10968;Šermukšnėlė;SIŪLINUKAI;6429038861;Ne;7;0;0;7
10969;Šermukšnėlė;SIŪLINUKAI;6429038861;Ne;7;0;0;7
10970;Šermukšnėlė;SIŪLINUKAI;6429038861;Ne;7;0;0;7
10971;Šermukšnėlė;SIŪLINUKAI;1819553019;Ne;0;0;2;2
10972;Šermukšnėlė;SIŪLINUKAI;7568969509;Ne;11;0;2;13
10973;Šermukšnėlė;SIŪLINUKAI;7758886713;Ne;5;3;0;8
10974;Šermukšnėlė;SIŪLINUKAI;4390650081;Ne;0;0;2;2
10975;Šermukšnėlė;SIŪLINUKAI;5072021867;Ne;9;0;0;9
10976;Šermukšnėlė;SIŪLINUKAI;7934772640;Ne;10;2;0;12
10977;Šermukšnėlė;SIŪLINUKAI;3994075596;Ne;0;0;4;4
10978;Šermukšnėlė;SIŪLINUKAI;6231057889;Ne;4;0;0;4
10979;Šermukšnėlė;SIŪLINUKAI;3979766151;Ne;0;0;2;2
10980;Šermukšnėlė;SIŪLINUKAI;9534316724;Ne;16;0;0;16
10981;Šermukšnėlė;SIŪLINUKAI;2705569653;Ne;4;0;0;4
10982;Šermukšnėlė;MEDINUKAi;8558117857;Ne;0;20;0;20
10983;Šermukšnėlė;MEDINUKAi;1318170904;Ne;0;3;0;3
10984;Šermukšnėlė;MEDINUKAi;6149973884;Taip;0;0;3;3
10985;Šermukšnėlė;MEDINUKAi;5874725607;Ne;5;0;5;10
10986;Šermukšnėlė;MEDINUKAi;7532979465;Ne;10;0;0;10
10987;Šermukšnėlė;MEDINUKAi;7211488009;Ne;7;0;0;7
10988;Šermukšnėlė;MEDINUKAi;6928863055;Ne;0;3;1;4
10989;Šermukšnėlė;MEDINUKAi;6531113007;Ne;0;2;0;2
10990;Šermukšnėlė;MEDINUKAi;8437052600;Ne;3;3;2;8
10991;Šermukšnėlė;MEDINUKAi;8200175951;Ne;8;1;0;9
10992;Šermukšnėlė;MEDINUKAi;7546040491;Ne;8;1;0;9
10993;Šermukšnėlė;MEDINUKAi;9872479998;Ne;1;0;3;4
10994;Šermukšnėlė;MEDINUKAi;8587108797;Taip;20;0;0;20
10995;Šermukšnėlė;MEDINUKAi;5605191023;Ne;6;0;3;9
10996;Šermukšnėlė;MEDINUKAi;2698741674;Ne;0;2;0;2
10997;Šermukšnėlė;SKUDURINUKAI;2235123503;Ne;0;0;5;5
10998;Šermukšnėlė;SKUDURINUKAI;9535836301;Ne;16;0;0;16
10999;Šermukšnėlė;SKUDURINUKAI;3138507073;Ne;20;0;0;20
11000;Šermukšnėlė;SKUDURINUKAI;5162694179;Ne;15;0;0;15
11001;Šermukšnėlė;SKUDURINUKAI;9247356229;Ne;14;0;0;14
11002;Šermukšnėlė;SKUDURINUKAI;3206222470;Ne;19;0;0;19
11003;Šermukšnėlė;SKUDURINUKAI;5751303170;Ne;5;0;0;5
11004;Šermukšnėlė;SKUDURINUKAI;2810624440;Ne;0;2;0;2
11005;Šermukšnėlė;SKUDURINUKAI;3955219247;Ne;1;2;0;3
11006;Šermukšnėlė;SKUDURINUKAI;5564759354;Ne;8;0;0;8
11007;Šermukšnėlė;SKUDURINUKAI;1931894084;Ne;10;0;0;10
11008;Šermukšnėlė;SKUDURINUKAI;6778901855;Ne;9;0;0;9
11009;Šermukšnėlė;SKUDURINUKAI;1502704170;Ne;5;0;0;5
11010;Šermukšnėlė;PAGRANDUKAI;6797936390;Ne;0;5;0;5
11011;Šermukšnėlė;PAGRANDUKAI;1312471779;Taip;0;0;1;1
11012;Šermukšnėlė;PAGRANDUKAI;6286235756;Ne;6;0;0;6
11013;Šermukšnėlė;PAGRANDUKAI;4219655802;Ne;10;0;0;10
11014;Šermukšnėlė;PAGRANDUKAI;4337084152;Ne;0;14;2;16
11015;Šermukšnėlė;PAGRANDUKAI;8710910167;Ne;1;0;0;1
11016;Šermukšnėlė;PAGRANDUKAI;8092422909;Ne;12;0;3;15
11017;Šermukšnėlė;PAGRANDUKAI;9246072554;Ne;4;1;0;5
11018;Šermukšnėlė;PAGRANDUKAI;6185588116;Taip;0;0;1;1
11019;Šermukšnėlė;PAGRANDUKAI;1209135668;Ne;13;0;1;14
11020;Šermukšnėlė;PAGRANDUKAI;9080074486;Ne;6;0;3;9
11021;Šermukšnėlė;PAGRANDUKAI;7098953763;Ne;4;0;0;4
11022;Šermukšnėlė;PAGRANDUKAI;5081685546;Taip;5;0;4;9
11023;Šermukšnėlė;PAGRANDUKAI;5456669766;Ne;2;1;0;3
11024;Šermukšnėlė;PAGRANDUKAI;8641098720;Ne;14;0;2;16
11025;Šermukšnėlė;PAGRANDUKAI;4810571143;Ne;0;3;0;3
11026;Šermukšnėlė;PAGRANDUKAI;8130815072;Ne;8;2;0;10
11027;Šypsena;NYKŠTUKAI;8913058656;Ne;6;0;11;17
11028;Šypsena;NYKŠTUKAI;8508569167;Ne;6;1;0;7
11029;Šypsena;NYKŠTUKAI;5818211923;Ne;2;0;2;4
11030;Šypsena;NYKŠTUKAI;8665786789;Ne;14;5;0;19
11031;Šypsena;NYKŠTUKAI;1716274053;Ne;8;0;1;9
11032;Šypsena;NYKŠTUKAI;6724776618;Ne;9;0;0;9
11033;Šypsena;NYKŠTUKAI;2790906806;Ne;11;7;0;18
11034;Šypsena;NYKŠTUKAI;9363618080;Ne;6;1;0;7
11035;Šypsena;NYKŠTUKAI;9702364620;Ne;9;6;0;15
11036;Šypsena;NYKŠTUKAI;3733757483;Ne;11;0;0;11
11037;Šypsena;NYKŠTUKAI;2179657619;Ne;9;1;0;10
11038;Šypsena;NYKŠTUKAI;2900195046;Ne;18;0;0;18
11039;Šypsena;NYKŠTUKAI;3724645162;Ne;10;0;0;10
11040;Šypsena;NYKŠTUKAI;3003901966;Ne;7;2;0;9
11041;Šypsena;NYKŠTUKAI;2182189246;Ne;7;0;1;8
11042;Šypsena;NYKŠTUKAI;5142969776;Ne;5;0;5;10
11043;Šypsena;NYKŠTUKAI;8439694239;Ne;0;1;0;1
11044;Šypsena;NYKŠTUKAI;6377979434;Ne;14;0;0;14
11045;Šypsena;NYKŠTUKAI;7332307199;Ne;9;0;0;9
11046;Šypsena;NYKŠTUKAI;7074211876;Ne;8;0;0;8
11047;Šypsena;SPINDULIUKAI;7898387398;Ne;11;0;5;16
11048;Šypsena;SPINDULIUKAI;1324902555;Ne;0;1;0;1
11049;Šypsena;SPINDULIUKAI;5222603743;Ne;4;0;0;4
11050;Šypsena;SPINDULIUKAI;7120597034;Ne;4;0;2;6
11051;Šypsena;SPINDULIUKAI;5879506651;Ne;0;0;1;1
11052;Šypsena;SPINDULIUKAI;4695547847;Ne;10;0;0;10
11053;Šypsena;SPINDULIUKAI;6713182218;Ne;10;1;0;11
11054;Šypsena;SPINDULIUKAI;1287205292;Taip;1;0;2;3
11055;Šypsena;SPINDULIUKAI;8215278033;Ne;0;0;1;1
11056;Šypsena;SPINDULIUKAI;7537442618;Ne;6;5;0;11
11057;Šypsena;SPINDULIUKAI;2584574423;Ne;11;0;0;11
11058;Šypsena;SPINDULIUKAI;9704350208;Ne;0;2;3;5
11059;Šypsena;SPINDULIUKAI;5906001927;Ne;0;0;1;1
11060;Šypsena;SPINDULIUKAI;6951845385;Ne;0;0;2;2
11061;Šypsena;SPINDULIUKAI;7877396588;Ne;0;2;0;2
11062;Šypsena;SPINDULIUKAI;4520148322;Ne;0;3;0;3
11063;Šypsena;SPINDULIUKAI;3901424559;Ne;0;2;0;2
11064;Šypsena;SPINDULIUKAI;8765509994;Ne;8;2;0;10
11065;Šypsena;SPINDULIUKAI;3429836513;Ne;0;0;20;20
11066;Šypsena;SPINDULIUKAI;8566236342;Ne;10;0;0;10
11067;Šypsena;SKRUZDELIUKAI;5611440056;Ne;5;1;0;6
11068;Šypsena;SKRUZDELIUKAI;1558614852;Ne;0;0;1;1
11069;Šypsena;SKRUZDELIUKAI;1897176871;Ne;11;0;0;11
11070;Šypsena;SKRUZDELIUKAI;1181590127;Ne;14;0;0;14
11071;Šypsena;SKRUZDELIUKAI;4038279267;Ne;9;0;0;9
11072;Šypsena;SKRUZDELIUKAI;5834057370;Ne;0;3;0;3
11073;Šypsena;SKRUZDELIUKAI;1515803985;Taip;0;7;0;7
11074;Šypsena;SKRUZDELIUKAI;3809171499;Ne;0;0;1;1
11075;Šypsena;SKRUZDELIUKAI;4344780723;Taip;6;0;5;11
11076;Šypsena;SKRUZDELIUKAI;5928432220;Ne;0;0;3;3
11077;Šypsena;SKRUZDELIUKAI;5504570516;Ne;6;0;4;10
11078;Šypsena;SKRUZDELIUKAI;5369445077;Ne;0;0;1;1
11079;Šypsena;SKRUZDELIUKAI;2798819321;Ne;10;0;0;10
11080;Šypsena;SKRUZDELIUKAI;3506046076;Ne;7;0;0;7
11081;Šypsena;SKRUZDELIUKAI;4450146424;Ne;8;0;0;8
11082;Šypsena;SKRUZDELIUKAI;7519967594;Taip;14;0;0;14
11083;Šypsena;Bitutės;6158973964;Ne;4;0;0;4
11084;Šypsena;Bitutės;4766170132;Ne;3;0;1;4
11085;Šypsena;Bitutės;1422418997;Ne;9;0;0;9
11086;Šypsena;Bitutės;7569495879;Ne;11;0;0;11
11087;Šypsena;Bitutės;2312828770;Ne;0;1;0;1
11088;Šypsena;Bitutės;2248628927;Ne;0;8;0;8
11089;Šypsena;Bitutės;2706678026;Ne;10;0;0;10
11090;Šypsena;Bitutės;7413098580;Ne;9;2;0;11
11091;Šypsena;Bitutės;5985974927;Ne;0;5;0;5
11092;Šypsena;Bitutės;3387625466;Ne;5;0;0;5
11093;Šypsena;Bitutės;1669768648;Ne;0;1;0;1
11094;Šypsena;Bitutės;1575413188;Ne;4;3;0;7
11095;Šypsena;Bitutės;2005543016;Ne;0;0;1;1
11096;Šypsena;Bitutės;5568502083;Ne;0;2;0;2
11097;Šypsena;MEŠKIUKAI;9696633725;Ne;1;0;2;3
11098;Šypsena;MEŠKIUKAI;7876871684;Ne;0;0;2;2
11099;Šypsena;MEŠKIUKAI;6055482561;Ne;3;0;0;3
11100;Šypsena;MEŠKIUKAI;6028006499;Ne;1;0;2;3
11101;Šypsena;MEŠKIUKAI;3724483762;Ne;6;0;0;6
11102;Šypsena;MEŠKIUKAI;7817486488;Ne;11;0;1;12
11103;Šypsena;MEŠKIUKAI;9862387726;Ne;1;0;7;8
11104;Šypsena;MEŠKIUKAI;8001187137;Ne;12;0;0;12
11105;Šypsena;MEŠKIUKAI;3663446767;Taip;5;4;0;9
11106;Šypsena;MEŠKIUKAI;8094166916;Ne;0;0;1;1
11107;Šypsena;MEŠKIUKAI;5094556499;Ne;3;0;2;5
11108;Šypsena;MEŠKIUKAI;4496704989;Ne;6;6;0;12
11109;Šypsena;BORUŽĖLĖS;6738149077;Ne;12;2;2;16
11110;Šypsena;BORUŽĖLĖS;7905089772;Ne;2;0;0;2
11111;Šypsena;BORUŽĖLĖS;4011596895;Ne;10;0;0;10
11112;Šypsena;BORUŽĖLĖS;7234904026;Ne;14;0;0;14
11113;Šypsena;BORUŽĖLĖS;3951000812;Ne;0;15;0;15
11114;Šypsena;BORUŽĖLĖS;2177181171;Ne;14;0;2;16
11115;Šypsena;BORUŽĖLĖS;7960872132;Ne;0;1;2;3
11116;Šypsena;BORUŽĖLĖS;4260693029;Ne;14;4;0;18
11117;Šypsena;BORUŽĖLĖS;1657019248;Ne;0;0;1;1
11118;Šypsena;BORUŽĖLĖS;8756079118;Ne;0;1;0;1
11119;Šypsena;BORUŽĖLĖS;6859531936;Ne;0;0;1;1
11120;Šnekutis;DRUGELIŲ;1504945841;Ne;16;1;0;17
11121;Šnekutis;DRUGELIŲ;6305168453;Ne;5;0;0;5
11122;Šnekutis;DRUGELIŲ;9543014297;Ne;6;10;0;16
11123;Šnekutis;DRUGELIŲ;3096125224;Ne;0;20;0;20
11124;Šnekutis;DRUGELIŲ;3386995244;Taip;5;0;0;5
11125;Šnekutis;DRUGELIŲ;8984597121;Ne;3;0;0;3
11126;Šnekutis;DRUGELIŲ;8810371475;Ne;0;0;6;6
11127;Šnekutis;DRUGELIŲ;7680962037;Ne;10;4;0;14
11128;Šnekutis;DRUGELIŲ;7089148766;Taip;9;1;0;10
11129;Šnekutis;DRUGELIŲ;3611064172;Ne;4;2;0;6
11130;Šnekutis;DRUGELIŲ;3079202929;Ne;0;0;2;2
11131;Šnekutis;DRUGELIŲ;8036600501;Ne;4;1;0;5
11132;Šnekutis;DRUGELIŲ;6071004512;Ne;0;2;3;5
11133;Šnekutis;DRUGELIŲ;1556960616;Ne;10;0;0;10
11134;Šnekutis;DRUGELIŲ;3177449195;Ne;0;8;0;8
11135;Šnekutis;DRUGELIŲ;7954240439;Ne;5;0;0;5
11136;Šnekutis;DRUGELIŲ;6330033887;Ne;0;3;0;3
11137;Šnekutis;Kačiukų;3281475303;Taip;10;0;0;10
11138;Šnekutis;Kačiukų;9670205249;Taip;0;1;3;4
11139;Šnekutis;Kačiukų;7615716438;Taip;0;4;0;4
11140;Šnekutis;Kačiukų;9780684867;Ne;0;18;0;18
11141;Šnekutis;Kačiukų;3271262071;Taip;9;0;1;10
11142;Šnekutis;Kačiukų;3166309530;Ne;0;1;2;3
11143;Šnekutis;Kačiukų;4143844589;Taip;3;0;0;3
11144;Šnekutis;Kačiukų;7236658561;Taip;1;0;0;1
11145;Šnekutis;Kačiukų;7638626055;Taip;0;0;3;3
11146;Šnekutis;Kačiukų;9157136735;Taip;0;4;0;4
11147;Šnekutis;Kačiukų;4920263429;Ne;3;0;0;3
11148;Šnekutis;Kačiukų;2914145045;Ne;20;0;0;20
11149;Šnekutis;Kačiukų;8340697546;Taip;1;0;0;1
11150;Šnekutis;Kačiukų;9896249776;Taip;0;0;11;11
11151;Šnekutis;Kačiukų;2656152037;Ne;1;4;0;5
11152;Šnekutis;Kačiukų;9051956302;Ne;0;0;18;18
11153;Šnekutis;Kačiukų;5521822696;Ne;0;3;0;3
11154;Šnekutis;Kačiukų;9942669058;Ne;0;0;1;1
11155;Šnekutis;Kačiukų;2144568225;Ne;3;0;0;3
11156;Šnekutis;Kačiukų;4624075875;Ne;3;0;5;8
11157;Šnekutis;Pėlėdžiukų;3068754741;Ne;0;1;2;3
11158;Šnekutis;Pėlėdžiukų;4334155280;Ne;4;0;0;4
11159;Šnekutis;Pėlėdžiukų;77534335117;Ne;0;0;2;2
11160;Šnekutis;Pėlėdžiukų;3312928478;Ne;0;1;0;1
11161;Šnekutis;Pėlėdžiukų;8866360301;Ne;5;1;0;6
11162;Šnekutis;Pėlėdžiukų;8745465796;Ne;0;0;19;19
11163;Šnekutis;Pėlėdžiukų;3578045341;Ne;0;1;4;5
11164;Šnekutis;Pėlėdžiukų;5117544317;Ne;0;0;2;2
11165;Šnekutis;Pėlėdžiukų;5615869149;Ne;0;7;0;7
11166;Šnekutis;Pėlėdžiukų;1329958641;Ne;0;1;1;2
11167;Šnekutis;Pėlėdžiukų;9511116249;Ne;0;1;0;1
11168;Šnekutis;Pėlėdžiukų;1369660223;Ne;0;1;0;1
11169;Šnekutis;Pėlėdžiukų;1682748852;Ne;0;0;3;3
11170;Šnekutis;Pėlėdžiukų;2525115674;Ne;4;0;0;4
11171;Šnekutis;Pėlėdžiukų;9601932777;Ne;0;1;11;12
11172;Šnekutis;Pėlėdžiukų;4302555600;Ne;0;1;11;12
11173;Šnekutis;Pėlėdžiukų;7507857415;Ne;8;1;1;10
11174;Šnekutis;Pėlėdžiukų;7514753023;Ne;0;0;13;13
11175;Šnekutis;Pėlėdžiukų;54532738133;Ne;3;0;0;3
11176;Šnekutis;Boružėlių;4835202527;Ne;5;1;0;6
11177;Šnekutis;Boružėlių;9054899440;Ne;5;0;0;5
11178;Šnekutis;Boružėlių;9862362744;Ne;4;0;3;7
11179;Šnekutis;Boružėlių;5597629090;Ne;0;1;0;1
11180;Šnekutis;Boružėlių;7089000987;Ne;0;0;2;2
11181;Šnekutis;Boružėlių;2843483435;Ne;10;0;0;10
11182;Šnekutis;Boružėlių;5906320006;Ne;0;0;6;6
11183;Šnekutis;Boružėlių;6405894763;Ne;0;12;0;12
11184;Šnekutis;Boružėlių;3889176018;Ne;5;0;0;5
11185;Šnekutis;Boružėlių;6749848086;Ne;0;0;6;6
11186;Šnekutis;Boružėlių;6544973632;Ne;0;0;10;10
11187;Šnekutis;Boružėlių;6146988521;Taip;0;1;0;1
11188;Šnekutis;Boružėlių;7344776758;Ne;0;0;1;1
11189;Šnekutis;Boružėlių;3344425033;Ne;0;0;6;6
11190;Šnekutis;Boružėlių;3937465849;Ne;1;18;0;19
11191;Šnekutis;Boružėlių;8219465079;Ne;0;6;0;6
11192;Šnekutis;Boružėlių;6015384795;Ne;0;0;2;2
11193;Šnekutis;Boružėlių;7307895397;Ne;0;0;3;3
11194;Šnekutis;Boružėlių;3371393656;Ne;18;0;0;18
11195;Šnekutis;Boružėlių;2779793970;Ne;1;2;0;3
11196;Šnekutis;Meškučių;2852111627;Ne;3;0;0;3
11197;Šnekutis;Meškučių;3214549246;Ne;15;0;0;15
11198;Šnekutis;Meškučių;2626247219;Ne;9;0;0;9
11199;Šnekutis;Meškučių;2042842873;Ne;10;2;0;12
11200;Šnekutis;Meškučių;9709701441;Ne;1;0;1;2
11201;Šnekutis;Meškučių;7980166125;Ne;5;4;0;9
11202;Šnekutis;Meškučių;3572114463;Taip;10;0;0;10
11203;Šnekutis;Meškučių;8417485561;Ne;0;2;0;2
11204;Šnekutis;Meškučių;2312968654;Ne;4;0;0;4
11205;Šnekutis;Viščiukų;9790241725;Ne;0;0;2;2
11206;Šnekutis;Viščiukų;9322106995;Ne;0;0;1;1
11207;Šnekutis;Viščiukų;3842436406;Ne;10;0;0;10
11208;Šnekutis;Viščiukų;3115675798;Ne;3;0;0;3
11209;Šnekutis;Viščiukų;9385583890;Ne;19;1;0;20
11210;Šnekutis;Viščiukų;5934631354;Ne;0;0;2;2
11211;Šnekutis;Viščiukų;4848437026;Ne;0;0;8;8
11212;Šnekutis;Viščiukų;9772257715;Taip;1;0;0;1
11213;Šnekutis;Viščiukų;3593766968;Ne;6;0;2;8
11214;Šnekutis;Viščiukų;1805259980;Ne;13;0;0;13
11215;Šnekutis;Viščiukų;3588737003;Ne;0;0;18;18
11216;Šnekutis;Viščiukų;7200356364;Ne;10;0;0;10
11217;Šnekutis;Viščiukų;1248466603;Ne;14;0;1;15
11218;Šnekutis;Viščiukų;7006343288;Ne;20;0;0;20
11219;Šnekutis;Viščiukų;5919317274;Ne;11;0;3;14
11220;Užupiukas;VYTURĖLIŲ;5116564840;Ne;0;0;11;11
11221;Užupiukas;VYTURĖLIŲ;3656400244;Ne;0;8;0;8
11222;Užupiukas;VYTURĖLIŲ;3829013911;Ne;0;0;2;2
11223;Užupiukas;VYTURĖLIŲ;9212428150;Ne;2;0;1;3
11224;Užupiukas;VYTURĖLIŲ;8001099421;Ne;11;0;0;11
11225;Užupiukas;VYTURĖLIŲ;4401569800;Ne;5;0;6;11
11226;Užupiukas;VYTURĖLIŲ;1391826582;Ne;12;0;0;12
11227;Užupiukas;VYTURĖLIŲ;5021163099;Taip;0;0;3;3
11228;Užupiukas;VYTURĖLIŲ;8960813016;Ne;3;0;0;3
11229;Užupiukas;VYTURĖLIŲ;9132605734;Ne;7;0;2;9
11230;Užupiukas;VYTURĖLIŲ;8245876832;Ne;0;1;3;4
11231;Užupiukas;VYTURĖLIŲ;5168946019;Ne;0;0;2;2
11232;Užupiukas;VYTURĖLIŲ;5718382826;Ne;0;4;3;7
11233;Užupiukas;VYTURĖLIŲ;9209209113;Ne;7;0;1;8
11234;Užupiukas;VYTURĖLIŲ;9070732925;Taip;0;1;0;1
11235;Užupiukas;VYTURĖLIŲ;1647271985;Ne;0;5;0;5
11236;Užupiukas;VYTURĖLIŲ;8347350503;Ne;0;0;8;8
11237;Užupiukas;KAČIUKŲ;9991552624;Ne;0;0;1;1
11238;Užupiukas;KAČIUKŲ;3048959458;Ne;8;0;1;9
11239;Užupiukas;KAČIUKŲ;3080668107;Taip;3;4;0;7
11240;Užupiukas;KAČIUKŲ;1809036046;Ne;0;9;0;9
11241;Užupiukas;KAČIUKŲ;1102468034;Ne;0;0;1;1
11242;Užupiukas;KAČIUKŲ;1464016943;Ne;7;0;2;9
11243;Užupiukas;KAČIUKŲ;4485435274;Ne;0;0;2;2
11244;Užupiukas;KAČIUKŲ;1102293237;Ne;0;7;0;7
11245;Užupiukas;KAČIUKŲ;9386211193;Ne;0;6;4;10
11246;Užupiukas;KAČIUKŲ;7048114101;Ne;9;0;2;11
11247;Užupiukas;KAČIUKŲ;9333587467;Ne;0;0;1;1
11248;Užupiukas;KAČIUKŲ;7092857844;Ne;0;0;3;3
11249;Užupiukas;KAČIUKŲ;2606742144;Ne;0;5;0;5
11250;Užupiukas;KAČIUKŲ;5233447872;Ne;0;0;20;20
11251;Užupiukas;KAČIUKŲ;9719845726;Ne;0;0;5;5
11252;Užupiukas;KAČIUKŲ;3543913063;Ne;0;7;2;9
11253;Užupiukas;KAČIUKŲ;4920190785;Ne;8;0;11;19
11254;Užupiukas;DRUGELIŲ;8876174256;Ne;6;0;0;6
11255;Užupiukas;DRUGELIŲ;5239006321;Ne;0;1;9;10
11256;Užupiukas;DRUGELIŲ;7581152903;Ne;0;2;7;9
11257;Užupiukas;DRUGELIŲ;4680027403;Ne;0;0;2;2
11258;Užupiukas;DRUGELIŲ;6698907535;Ne;0;6;4;10
11259;Užupiukas;DRUGELIŲ;9577167600;Ne;1;1;1;3
11260;Užupiukas;DRUGELIŲ;3419182422;Ne;0;0;1;1
11261;Užupiukas;DRUGELIŲ;4854016957;Ne;7;0;6;13
11262;Užupiukas;DRUGELIŲ;8692826414;Ne;0;1;0;1
11263;Užupiukas;DRUGELIŲ;7169272175;Ne;4;0;10;14
11264;Užupiukas;DRUGELIŲ;1156471313;Ne;0;0;1;1
11265;Užupiukas;DRUGELIŲ;4595291532;Ne;0;0;7;7
11266;Užupiukas;DRUGELIŲ;3383643388;Ne;9;0;5;14
11267;Užupiukas;DRUGELIŲ;3961733676;Ne;12;0;6;18
11268;Užupiukas;DRUGELIŲ;5006880916;Ne;8;0;2;10
11269;Užupiukas;DRUGELIŲ;9715624372;Taip;6;0;3;9
11270;Užupiukas;DRUGELIŲ;1108429907;Ne;0;1;5;6
11271;Užupiukas;DRUGELIŲ;9295230331;Ne;0;0;9;9
11272;Užupiukas;DRUGELIŲ;3940029893;Ne;0;0;1;1
11273;Užupiukas;DRUGELIŲ;3575209839;Ne;3;1;0;4
11274;Užupiukas;EŽIUKŲ;1526296386;Ne;7;0;1;8
11275;Užupiukas;EŽIUKŲ;9774124589;Ne;15;0;1;16
11276;Užupiukas;EŽIUKŲ;2724216446;Ne;17;2;0;19
11277;Užupiukas;EŽIUKŲ;9446562736;Ne;0;4;0;4
11278;Užupiukas;EŽIUKŲ;5072363435;Ne;0;4;0;4
11279;Užupiukas;EŽIUKŲ;1100574872;Ne;12;0;1;13
11280;Užupiukas;EŽIUKŲ;5204808398;Ne;5;0;1;6
11281;Užupiukas;EŽIUKŲ;3171528288;Ne;11;0;0;11
11282;Užupiukas;EŽIUKŲ;7860601571;Ne;6;0;0;6
11283;Užupiukas;EŽIUKŲ;8020138690;Ne;3;0;1;4
11284;Užupiukas;EŽIUKŲ;6823724962;Ne;20;0;0;20
11285;Užupiukas;EŽIUKŲ;5538327364;Ne;3;1;0;4
11286;Užupiukas;EŽIUKŲ;6370918943;Ne;0;0;1;1
11287;Užupiukas;EŽIUKŲ;6512355340;Ne;3;4;1;8
11288;Užupiukas;EŽIUKŲ;4356736070;Ne;0;20;0;20
11289;Užupiukas;EŽIUKŲ;9906475253;Ne;5;0;1;6
11290;Užupiukas;EŽIUKŲ;8127218866;Ne;14;0;1;15
11291;Užupiukas;EŽIUKŲ;8720638097;Ne;0;0;2;2
11292;Užupiukas;BORUŽĖLIŲ;4781598862;Ne;0;0;4;4
11293;Užupiukas;BORUŽĖLIŲ;7861121290;Ne;0;0;2;2
11294;Užupiukas;BORUŽĖLIŲ;6526550727;Ne;5;0;0;5
11295;Užupiukas;BORUŽĖLIŲ;9735462228;Ne;0;0;2;2
11296;Užupiukas;BORUŽĖLIŲ;1582921323;Ne;0;0;1;1
11297;Užupiukas;BORUŽĖLIŲ;9791681813;Ne;0;0;4;4
11298;Užupiukas;BORUŽĖLIŲ;1503714343;Ne;0;0;2;2
11299;Užupiukas;BORUŽĖLIŲ;8313812681;Ne;0;0;3;3
11300;Užupiukas;BORUŽĖLIŲ;9677572224;Ne;3;0;0;3
11301;Užupiukas;BORUŽĖLIŲ;2445335267;Ne;3;0;0;3
11302;Užupiukas;BORUŽĖLIŲ;7555702944;Ne;0;1;0;1
11303;Užupiukas;BORUŽĖLIŲ;2307600884;Ne;0;0;12;12
11304;Užupiukas;BORUŽĖLIŲ;6073039842;Ne;0;4;0;4
11305;Užupiukas;BORUŽĖLIŲ;3038973312;Ne;0;0;2;2
11306;Užupiukas;BORUŽĖLIŲ;6601099182;Ne;7;5;0;12
11307;Užupiukas;BORUŽĖLIŲ;3940264504;Ne;3;0;2;5
11308;Užupiukas;BORUŽĖLIŲ;5517458323;Ne;7;0;0;7
11309;Užupiukas;BORUŽĖLIŲ;7427702848;Ne;0;8;0;8
11310;Užupiukas;SPINDULIUKŲ;5889162375;Ne;3;0;0;3
11311;Užupiukas;SPINDULIUKŲ;1718518621;Ne;2;0;2;4
11312;Užupiukas;SPINDULIUKŲ;1679324943;Ne;3;0;0;3
11313;Užupiukas;SPINDULIUKŲ;7298322865;Ne;3;0;0;3
11314;Užupiukas;SPINDULIUKŲ;8734960045;Ne;0;20;0;20
11315;Užupiukas;SPINDULIUKŲ;9863097416;Ne;0;0;3;3
11316;Užupiukas;SPINDULIUKŲ;3579499796;Ne;0;0;3;3
11317;Užupiukas;SPINDULIUKŲ;1772019951;Ne;0;0;2;2
11318;Užupiukas;SPINDULIUKŲ;3298267311;Ne;0;1;0;1
11319;Užupiukas;SPINDULIUKŲ;8915159672;Ne;0;1;0;1
11320;Užupiukas;SPINDULIUKŲ;1554333137;Ne;0;9;11;20
11321;Užupiukas;SPINDULIUKŲ;9723966502;Ne;0;0;5;5
11322;Užupiukas;SPINDULIUKŲ;9655636851;Ne;0;0;1;1
11323;Užupiukas;SPINDULIUKŲ;8724566014;Ne;6;0;5;11
11324;Užupiukas;SPINDULIUKŲ;8870229834;Ne;5;0;6;11
11325;Užupiukas;SPINDULIUKŲ;9096157655;Ne;10;0;0;10
11326;Užupiukas;SPINDULIUKŲ;9782972949;Ne;0;0;1;1
11327;Užupiukas;SPINDULIUKŲ;3958071677;Ne;0;0;3;3
11328;Užupiukas;ŽVIRBLIUKŲ;8519118225;Ne;0;3;4;7
11329;Užupiukas;ŽVIRBLIUKŲ;7549628277;Ne;0;3;4;7
11330;Užupiukas;ŽVIRBLIUKŲ;5085660507;Ne;0;1;0;1
11331;Užupiukas;ŽVIRBLIUKŲ;7530856195;Ne;0;3;0;3
11332;Užupiukas;ŽVIRBLIUKŲ;7345579721;Ne;5;0;1;6
11333;Užupiukas;ŽVIRBLIUKŲ;4710910251;Ne;0;0;8;8
11334;Užupiukas;ŽVIRBLIUKŲ;9428884149;Ne;0;0;1;1
11335;Užupiukas;ŽVIRBLIUKŲ;4054724625;Ne;9;0;1;10
11336;Užupiukas;ŽVIRBLIUKŲ;2210437775;Ne;7;1;1;9
11337;Užupiukas;ŽVIRBLIUKŲ;1995228207;Ne;0;0;1;1
11338;Užupiukas;ŽVIRBLIUKŲ;1496541880;Ne;0;0;16;16
11339;Užupiukas;ŽVIRBLIUKŲ;1684901495;Ne;0;2;0;2
11340;Užupiukas;ŽVIRBLIUKŲ;2390955083;Ne;0;1;0;1
11341;Užupiukas;ŽVIRBLIUKŲ;1843171673;Ne;5;0;0;5
11342;Užupiukas;ŽVIRBLIUKŲ;4785494419;Ne;0;2;7;9
11343;Užupiukas;ŽVIRBLIUKŲ;8119142600;Ne;0;0;3;3
11344;Užupiukas;ŽVIRBLIUKŲ;2362568676;Ne;0;0;6;6
11345;Užupiukas;PELĖDŽIUKŲ;40704768956;Ne;0;0;1;1
11346;Užupiukas;PELĖDŽIUKŲ;5665323444;Ne;0;0;5;5
11347;Užupiukas;PELĖDŽIUKŲ;4880828482;Ne;0;0;9;9
11348;Užupiukas;PELĖDŽIUKŲ;6478702476;Ne;0;0;7;7
11349;Užupiukas;PELĖDŽIUKŲ;6110869303;Ne;0;0;4;4
11350;Užupiukas;PELĖDŽIUKŲ;4247280316;Ne;0;0;1;1
11351;Užupiukas;PELĖDŽIUKŲ;4608233152;Ne;0;0;2;2
11352;Užupiukas;PELĖDŽIUKŲ;5498369850;Ne;10;0;0;10
11353;Užupiukas;PELĖDŽIUKŲ;2821350355;Ne;5;0;1;6
11354;Užupiukas;PELĖDŽIUKŲ;3309195572;Ne;0;0;2;2
11355;Užupiukas;PELĖDŽIUKŲ;4132760111;Ne;0;2;0;2
11356;Užupiukas;PELĖDŽIUKŲ;22401995674;Ne;6;0;0;6
11357;Užupiukas;PELĖDŽIUKŲ;3774364829;Ne;0;0;1;1
11358;Užupiukas;PELĖDŽIUKŲ;9197242545;Ne;0;0;1;1
11359;Užupiukas;PELĖDŽIUKŲ;1091861376;Ne;3;0;2;5
11360;Užupiukas;VARPELIŲ;7107441792;Ne;0;0;2;2
11361;Užupiukas;VARPELIŲ;8881187663;Ne;3;0;0;3
11362;Užupiukas;VARPELIŲ;8518137669;Ne;1;0;0;1
11363;Užupiukas;VARPELIŲ;9310238442;Ne;0;0;1;1
11364;Užupiukas;VARPELIŲ;2769924857;Ne;0;0;2;2
11365;Užupiukas;VARPELIŲ;5941280824;Ne;0;20;0;20
11366;Užupiukas;VARPELIŲ;7105857162;Ne;4;0;5;9
11367;Užupiukas;VARPELIŲ;2485426055;Ne;11;0;0;11
11368;Užupiukas;VARPELIŲ;7314085267;Ne;0;0;6;6
11369;Užupiukas;VARPELIŲ;4106614478;Ne;5;1;0;6
11370;Užupiukas;VARPELIŲ;9523512906;Ne;9;0;0;9
11371;Užupiukas;VARPELIŲ;3745080560;Ne;3;0;1;4
11372;Užupiukas;VARPELIŲ;5148672602;Ne;0;0;3;3
11373;Užupiukas;SAULUČIŲ;5704945892;Ne;0;0;9;9
11374;Užupiukas;SAULUČIŲ;2681679016;Ne;0;0;4;4
11375;Užupiukas;SAULUČIŲ;3684774901;Ne;0;0;1;1
11376;Užupiukas;SAULUČIŲ;8163092636;Ne;0;0;13;13
11377;Užupiukas;SAULUČIŲ;1976775494;Ne;1;3;0;4
11378;Užupiukas;SAULUČIŲ;5874450724;Ne;5;0;0;5
11379;Užupiukas;SAULUČIŲ;3341292382;Ne;0;1;5;6
11380;Užupiukas;SAULUČIŲ;5570569874;Ne;5;0;0;5
11381;Užupiukas;SAULUČIŲ;7643286183;Ne;0;0;1;1
11382;Užupiukas;SAULUČIŲ;2814556305;Ne;5;0;0;5
11383;Užupiukas;SAULUČIŲ;7209853233;Ne;0;0;4;4
11384;Užupiukas;SAULUČIŲ;9953994943;Ne;1;6;0;7
11385;Užupiukas;SAULUČIŲ;7956550754;Ne;0;0;7;7
11386;Užupiukas;SAULUČIŲ;5469735455;Ne;0;8;2;10
11387;Užupiukas;SAULUČIŲ;8489545569;Ne;0;0;1;1
11388;Užupiukas;SAULUČIŲ;7990479988;Ne;0;0;3;3
11389;Užupiukas;SAULUČIŲ;4691413468;Ne;0;0;3;3
11390;Užupiukas;SAULUČIŲ;7423292334;Ne;0;2;1;3
11391;Užupiukas;LAPIUKŲ;9833934299;Ne;5;2;0;7
11392;Užupiukas;LAPIUKŲ;4963679583;Ne;5;0;0;5
11393;Užupiukas;LAPIUKŲ;2679915982;Ne;0;2;0;2
11394;Užupiukas;LAPIUKŲ;6004467875;Ne;0;1;1;2
11395;Užupiukas;LAPIUKŲ;1718048938;Ne;5;0;0;5
11396;Užupiukas;LAPIUKŲ;7986962850;Ne;0;1;1;2
11397;Užupiukas;LAPIUKŲ;2517606394;Ne;0;0;2;2
11398;Užupiukas;LAPIUKŲ;7487174943;Ne;0;1;0;1
11399;Užupiukas;LAPIUKŲ;7161001771;Ne;0;1;0;1
11400;Užupiukas;LAPIUKŲ;6967184410;Ne;0;7;0;7
11401;Užupiukas;LAPIUKŲ;4900699267;Ne;0;1;0;1
11402;Užupiukas;LAPIUKŲ;1178152392;Ne;0;1;0;1
11403;Užupiukas;LAPIUKŲ;3311694266;Ne;0;2;0;2
11404;Užupiukas;LAPIUKŲ;8252575784;Ne;5;0;0;5
11405;Užupiukas;LAPIUKŲ;3333547785;Ne;0;3;0;3
11406;Užupiukas;LAPIUKŲ;8529259340;Ne;0;1;1;2
11407;Užupiukas;NYKŠTUKŲ;4895744524;Ne;16;0;0;16
11408;Užupiukas;NYKŠTUKŲ;3811750547;Ne;0;0;2;2
11409;Užupiukas;NYKŠTUKŲ;2158976125;Ne;0;0;2;2
11410;Užupiukas;NYKŠTUKŲ;6857321547;Ne;6;0;14;20
11411;Užupiukas;NYKŠTUKŲ;5381329362;Ne;4;0;0;4
11412;Užupiukas;NYKŠTUKŲ;1399112659;Ne;8;0;15;23
11413;Užupiukas;NYKŠTUKŲ;4379182756;Ne;0;0;7;7
11414;Užupiukas;NYKŠTUKŲ;9785674147;Ne;0;0;8;8
11415;Užupiukas;NYKŠTUKŲ;3094320206;Ne;0;0;6;6
11416;Užupiukas;NYKŠTUKŲ;9714322911;Ne;3;0;2;5
11417;Užupiukas;NYKŠTUKŲ;3014087333;Ne;0;0;1;1
11418;Užupiukas;NYKŠTUKŲ;7589905741;Ne;0;0;8;8
11419;Užupiukas;NYKŠTUKŲ;1891855020;Ne;2;0;0;2
11420;Užupiukas;NYKŠTUKŲ;1473606331;Ne;6;4;1;11
11421;Užupiukas;NYKŠTUKŲ;4570457987;Ne;0;1;7;8
11422;Užupiukas;NYKŠTUKŲ;9312234251;Ne;0;0;1;1
11423;Vaidilutė;Žiogelis;45949026707;Ne;0;1;3;4
11424;Vaidilutė;Žiogelis;5620009051;Ne;0;1;0;1
11425;Vaidilutė;Žiogelis;5203062837;Ne;9;0;0;9
11426;Vaidilutė;Žiogelis;3112025222;Ne;7;0;2;9
11427;Vaidilutė;Žiogelis;4334934114;Ne;0;0;3;3
11428;Vaidilutė;Žiogelis;7843388119;Ne;0;0;2;2
11429;Vaidilutė;Žiogelis;2041126370;Ne;0;0;4;4
11430;Vaidilutė;Žiogelis;5991149222;Ne;6;2;0;8
11431;Vaidilutė;Žiogelis;1266927367;Ne;0;0;4;4
11432;Vaidilutė;Žiogelis;9556632708;Ne;0;0;2;2
11433;Vaidilutė;Žiogelis;1769926207;Ne;0;0;2;2
11434;Vaidilutė;Rūtelė;7319037375;Ne;0;0;1;1
11435;Vaidilutė;Rūtelė;4838951446;Ne;3;1;0;4
11436;Vaidilutė;Rūtelė;7494818866;Ne;0;9;1;10
11437;Vaidilutė;Rūtelė;5500950179;Ne;3;6;0;9
11438;Vaidilutė;Rūtelė;1140011879;Ne;0;0;7;7
11439;Vaidilutė;Rūtelė;9563257771;Ne;0;3;0;3
11440;Vaidilutė;Rūtelė;9652684068;Ne;1;5;1;7
11441;Vaidilutė;Rūtelė;2024078532;Ne;0;0;6;6
11442;Vaidilutė;Rūtelė;5482030284;Ne;0;0;2;2
11443;Vaidilutė;Rūtelė;8505156287;Ne;1;0;0;1
11444;Vaidilutė;Rūtelė;9568450630;Ne;1;0;0;1
11445;Vaidilutė;Rūtelė;7306768961;Ne;3;0;3;6
11446;Vaidilutė;Rūtelė;7532115462;Ne;9;0;5;14
11447;Vaidilutė;Rūtelė;6896047075;Ne;0;0;1;1
11448;Vaidilutė;Rūtelė;3059654988;Ne;10;1;0;11
11449;Vaidilutė;Rūtelė;1341696594;Ne;2;6;0;8
11450;Vaidilutė;Rūtelė;1141947715;Ne;13;0;3;16
11451;Vaidilutė;Rūtelė;2014160468;Ne;10;1;0;11
11452;Vaidilutė;Voveraitė;3248203941;Ne;8;0;0;8
11453;Vaidilutė;Voveraitė;1608646909;Ne;9;0;0;9
11454;Vaidilutė;Voveraitė;9429544108;Taip;10;0;0;10
11455;Vaidilutė;Voveraitė;5652381296;Ne;5;0;0;5
11456;Vaidilutė;Voveraitė;8377824920;Ne;0;7;0;7
11457;Vaidilutė;Voveraitė;3299081380;Ne;5;0;0;5
11458;Vaidilutė;Voveraitė;3634285869;Ne;0;0;15;15
11459;Vaidilutė;Voveraitė;7703578508;Ne;0;0;10;10
11460;Vaidilutė;Voveraitė;3150642420;Ne;11;0;0;11
11461;Vaidilutė;Voveraitė;5855762068;Ne;3;0;0;3
11462;Vaidilutė;Voveraitė;7327131165;Ne;5;6;2;13
11463;Vaidilutė;Voveraitė;2318578603;Ne;3;0;6;9
11464;Vaidilutė;Voveraitė;9372280434;Ne;0;5;0;5
11465;Vaidilutė;Voveraitė;1372767364;Ne;0;0;1;1
11466;Vaidilutė;Voveraitė;7478943531;Ne;17;0;0;17
11467;Vaidilutė;Voveraitė;4738318120;Ne;10;7;0;17
11468;Vaidilutė;Voveraitė;3319615121;Ne;0;5;4;9
11469;Vaidilutė;Voveraitė;6299324271;Ne;0;1;2;3
11470;Vaidilutė;Voveraitė;4186708502;Ne;0;0;20;20
11471;Vaidilutė;Voveraitė;2855672500;Taip;0;18;0;18
11472;Vaidilutė;Voveraitė;8053548602;Ne;3;0;4;7
11473;Vaidilutė;Saulutė;8492055287;Ne;0;0;7;7
11474;Vaidilutė;Saulutė;6844372910;Ne;6;0;3;9
11475;Vaidilutė;Saulutė;4972645715;Ne;0;0;7;7
11476;Vaidilutė;Saulutė;1355005114;Ne;0;0;5;5
11477;Vaidilutė;Saulutė;4680645841;Ne;0;0;1;1
11478;Vaidilutė;Saulutė;2662468804;Ne;12;0;1;13
11479;Vaidilutė;Saulutė;5217609332;Ne;0;0;2;2
11480;Vaidilutė;Saulutė;2864731541;Ne;9;0;0;9
11481;Vaidilutė;Saulutė;1998872078;Ne;6;0;1;7
11482;Vaidilutė;Saulutė;2468220275;Ne;4;0;1;5
11483;Vaidilutė;Saulutė;1610262589;Ne;0;0;3;3
11484;Vaidilutė;Saulutė;2356037175;Ne;0;2;0;2
11485;Vaidilutė;Saulutė;5054640268;Ne;5;0;1;6
11486;Vaidilutė;Saulutė;6885473308;Ne;7;14;2;23
11487;Vaidilutė;Saulutė;7826111890;Ne;13;0;0;13
11488;Vaidilutė;Saulutė;9870763434;Ne;0;0;1;1
11489;Vaidilutė;Saulutė;5945744595;Taip;10;5;0;15
11490;Vaidilutė;Saulutė;6674238265;Ne;5;0;2;7
11491;Vaidilutė;Saulutė;2294802783;Ne;9;3;0;12
11492;Vaidilutė;Žibutė;5668493994;Ne;4;0;1;5
11493;Vaidilutė;Žibutė;4085959509;Ne;4;0;0;4
11494;Vaidilutė;Žibutė;3051006765;Ne;0;0;2;2
11495;Vaidilutė;Žibutė;9189713003;Ne;9;0;0;9
11496;Vaidilutė;Žibutė;7903242996;Ne;0;0;13;13
11497;Vaidilutė;Žibutė;7400197367;Ne;0;1;0;1
11498;Vaidilutė;Žibutė;3980894528;Ne;0;0;6;6
11499;Vaidilutė;Žibutė;1362256314;Ne;9;5;0;14
11500;Vaidilutė;Žibutė;2767482145;Ne;0;0;1;1
11501;Vaidilutė;Žibutė;8769601956;Ne;0;0;5;5
11502;Vaidilutė;Žibutė;1726638921;Ne;10;1;0;11
11503;Vaidilutė;Žibutė;5415279154;Ne;0;1;0;1
11504;Vaidilutė;Žibutė;1377015807;Ne;4;0;0;4
11505;Vaidilutė;Žibutė;4124217264;Ne;0;0;6;6
11506;Vaidilutė;Žibutė;7429825620;Ne;8;0;0;8
11507;Vaidilutė;Žibutė;7690470762;Ne;0;5;0;5
11508;Vaidilutė;"Ąžuoliukas ";3463112472;Ne;0;0;1;1
11509;Vaidilutė;"Ąžuoliukas ";3730573432;Ne;0;0;2;2
11510;Vaidilutė;"Ąžuoliukas ";5988376676;Ne;5;0;2;7
11511;Vaidilutė;"Ąžuoliukas ";4761992071;Ne;2;0;2;4
11512;Vaidilutė;"Ąžuoliukas ";5307486959;Ne;0;1;0;1
11513;Vaidilutė;"Ąžuoliukas ";1653497170;Ne;0;3;0;3
11514;Vaidilutė;"Ąžuoliukas ";1440819171;Ne;0;3;0;3
11515;Vaidilutė;"Ąžuoliukas ";2668758195;Ne;0;2;0;2
11516;Vaidilutė;"Ąžuoliukas ";4901387311;Ne;7;0;0;7
11517;Vaidilutė;"Ąžuoliukas ";2997948252;Ne;0;0;1;1
11518;Vaidilutė;"Ąžuoliukas ";9723156071;Ne;0;0;2;2
11519;Vaidilutė;"Ąžuoliukas ";3782651091;Ne;0;0;2;2
11520;Vaidilutė;"Ąžuoliukas ";6067801976;Ne;4;0;1;5
11521;Vaidilutė;"Žemuogėlė ";1993403692;Ne;3;0;1;4
11522;Vaidilutė;"Žemuogėlė ";9869134464;Ne;1;2;0;3
11523;Vaidilutė;"Žemuogėlė ";29153363263;Ne;12;0;2;14
11524;Vaidilutė;"Žemuogėlė ";5177060346;Ne;0;0;2;2
11525;Vaidilutė;"Žemuogėlė ";4671287016;Ne;0;0;5;5
11526;Vaidilutė;"Žemuogėlė ";7419525100;Ne;0;9;0;9
11527;Vaidilutė;"Žemuogėlė ";1363913645;Ne;0;1;0;1
11528;Vaidilutė;"Žemuogėlė ";5252637701;Ne;0;0;1;1
11529;Vaidilutė;"Žemuogėlė ";3202508790;Ne;0;0;7;7
11530;Vaidilutė;"Žemuogėlė ";9769645272;Ne;1;0;0;1
11531;Vaidilutė;"Žemuogėlė ";1691407801;Ne;1;0;1;2
11532;Vaidilutė;"Žemuogėlė ";1704155743;Ne;3;3;0;6
11533;Vaidilutė;"Žemuogėlė ";1139332221;Ne;0;0;2;2
11534;Vaidilutė;"Vyturėlis ";3121914268;Ne;5;0;0;5
11535;Vaidilutė;"Vyturėlis ";5050251048;Ne;5;0;3;8
11536;Vaidilutė;"Vyturėlis ";7106410219;Ne;0;0;2;2
11537;Vaidilutė;"Vyturėlis ";5326935037;Ne;8;0;0;8
11538;Vaidilutė;"Vyturėlis ";2189753894;Ne;0;3;0;3
11539;Vaidilutė;"Vyturėlis ";9689388330;Ne;1;2;0;3
11540;Vaidilutė;"Vyturėlis ";9584702487;Ne;0;1;1;2
11541;Vaidilutė;"Vyturėlis ";2081959307;Ne;2;0;1;3
11542;Vaidilutė;"Vyturėlis ";8882402632;Ne;0;0;1;1
11543;Vaidilutė;"Vyturėlis ";4230076320;Ne;0;1;0;1
11544;Vaidilutė;"Vyturėlis ";2058071219;Ne;5;0;2;7
11545;Vaidilutė;"Vyturėlis ";1401180999;Ne;0;2;2;4
11546;Vaidilutė;"Vyturėlis ";2251608691;Ne;3;0;4;7
11547;Vaidilutė;"Vyturėlis ";7914006128;Ne;4;0;0;4
11548;Vaidilutė;"Vyturėlis ";2194984060;Ne;0;0;9;9
11549;Vaidilutė;"Vyturėlis ";3351968717;Ne;5;1;0;6
11550;Vaidilutė;"Varpelis ";6250831269;Ne;0;4;0;4
11551;Vaidilutė;"Varpelis ";2763266518;Ne;0;0;1;1
11552;Vaidilutė;"Varpelis ";6037349527;Ne;5;0;2;7
11553;Vaidilutė;"Varpelis ";3832349858;Ne;0;0;5;5
11554;Vaidilutė;"Varpelis ";5448014291;Ne;0;1;0;1
11555;Vaidilutė;"Varpelis ";3497795848;Ne;2;0;1;3
11556;Vaidilutė;"Varpelis ";4280822951;Ne;0;0;3;3
11557;Vaidilutė;"Varpelis ";3453045619;Ne;0;0;1;1
11558;Vaidilutė;"Varpelis ";6022130248;Ne;0;0;5;5
11559;Vaidilutė;"Varpelis ";1882829340;Ne;0;0;8;8
11560;Vaidilutė;"Varpelis ";6097229427;Ne;4;0;0;4
11561;Vaidilutė;"Varpelis ";3353827105;Ne;8;0;1;9
11562;Vaidilutė;"Varpelis ";4362797606;Ne;10;0;0;10
11563;Vaidilutė;"Varpelis ";6322986820;Ne;0;0;1;1
11564;Vaidilutė;"Varpelis ";2941550026;Ne;0;0;3;3
11565;Vaidilutė;"Boružėlių ";6928815317;Ne;18;0;0;18
11566;Vaidilutė;"Boružėlių ";2164241264;Ne;0;0;1;1
11567;Vaidilutė;"Boružėlių ";4348206726;Taip;14;0;0;14
11568;Vaidilutė;"Boružėlių ";5008411199;Ne;3;0;0;3
11569;Vaidilutė;"Boružėlių ";5405461987;Ne;0;0;4;4
11570;Vaidilutė;"Boružėlių ";1283676263;Ne;0;0;7;7
11571;Vaidilutė;"Boružėlių ";8629789128;Ne;5;0;0;5
11572;Vaidilutė;"Boružėlių ";8413764934;Ne;0;2;0;2
11573;Vaidilutė;"Boružėlių ";2315322608;Ne;13;0;0;13
11574;Vaidilutė;"Boružėlių ";4760330697;Ne;0;0;1;1
11575;Vaidilutė;"Boružėlių ";5205356977;Ne;3;0;0;3
11576;Vaidilutė;"Boružėlių ";5095161432;Ne;18;0;0;18
11577;Vaidilutė;"Malūnelis ";4887753072;Ne;0;3;1;4
11578;Vaidilutė;"Malūnelis ";2876157676;Ne;3;0;0;3
11579;Vaidilutė;"Malūnelis ";3557654689;Ne;1;0;0;1
11580;Vaidilutė;"Malūnelis ";8257746012;Ne;1;0;0;1
11581;Vaidilutė;"Malūnelis ";8444010416;Ne;9;0;4;13
11582;Vaidilutė;"Malūnelis ";1998966302;Ne;1;3;1;5
11583;Vaidilutė;"Malūnelis ";5026620305;Ne;0;0;2;2
11584;Vaidilutė;"Malūnelis ";3826303389;Ne;5;0;1;6
11585;Vaidilutė;"Malūnelis ";4469754560;Ne;0;0;5;5
11586;Vaidilutė;"Malūnelis ";8433116520;Ne;5;0;6;11
11587;Vaidilutė;"Malūnelis ";5918039529;Ne;17;0;0;17
11588;Vaidilutė;"Malūnelis ";7660273021;Ne;0;1;2;3
11589;Vaidilutė;"Riešutėlis ";3605988018;Ne;0;2;0;2
11590;Vaidilutė;"Riešutėlis ";1161455376;Ne;12;0;1;13
11591;Vaidilutė;"Riešutėlis ";4518002596;Ne;0;0;3;3
11592;Vaidilutė;"Riešutėlis ";4657952465;Ne;5;0;1;6
11593;Vaidilutė;"Riešutėlis ";8756807918;Ne;3;0;6;9
11594;Vaidilutė;"Riešutėlis ";1206696843;Ne;0;0;7;7
11595;Vaidilutė;"Riešutėlis ";9872915544;Ne;0;3;1;4
11596;Vaidilutė;"Riešutėlis ";2976615414;Ne;8;0;6;14
11597;Vaidilutė;"Riešutėlis ";4709977896;Ne;0;0;2;2
11598;Vaidilutė;"Riešutėlis ";2409760986;Ne;0;0;3;3
11599;Vaidilutė;"Riešutėlis ";4051575845;Ne;6;0;0;6
11600;Vaidilutė;"Riešutėlis ";9025469107;Ne;0;0;2;2
11601;Vaidilutė;"Riešutėlis ";9567786222;Ne;8;0;9;17
11602;Vaidilutė;"Riešutėlis ";3064988592;Ne;9;0;3;12
11603;Vaidilutė;"Riešutėlis ";7043895152;Ne;3;0;0;3
11604;Vaidilutė;"Riešutėlis ";7871629009;Ne;0;0;2;2
11605;Vandenis;ŽUVĖDRŲ;5362078687;Ne;0;4;0;4
11606;Vandenis;ŽUVĖDRŲ;6784010746;Ne;5;1;0;6
11607;Vandenis;ŽUVĖDRŲ;9334958945;Ne;0;1;0;1
11608;Vandenis;ŽUVĖDRŲ;7447487403;Ne;8;0;0;8
11609;Vandenis;ŽUVĖDRŲ;7646133208;Ne;5;1;0;6
11610;Vandenis;ŽUVĖDRŲ;4303303483;Ne;5;0;0;5
11611;Vandenis;ŽUVĖDRŲ;2325465812;Ne;0;4;0;4
11612;Vandenis;ŽUVĖDRŲ;2649542586;Ne;0;11;0;11
11613;Vandenis;ŽUVĖDRŲ;1144490168;Ne;11;0;0;11
11614;Vandenis;ŽUVĖDRŲ;7391206543;Ne;0;1;0;1
11615;Vandenis;ŽUVĖDRŲ;9335319713;Ne;4;1;0;5
11616;Vandenis;ŽUVĖDRŲ;6068154206;Ne;3;0;0;3
11617;Vandenis;ŽUVĖDRŲ;7296608892;Ne;5;0;0;5
11618;Vandenis;ŽUVĖDRŲ;4117091634;Ne;9;1;0;10
11619;Vandenis;ŽUVĖDRŲ;6063181697;Ne;0;1;0;1
11620;Vandenis;ŽUVĖDRŲ;6661117114;Ne;6;5;0;11
11621;Vandenis;ŽUVĖDRŲ;6456557095;Ne;9;0;0;9
11622;Vandenis;ŽUVĖDRŲ;3342147138;Ne;20;0;0;20
11623;Vandenis;ŽUVĖDRŲ;5112768778;Ne;0;2;0;2
11624;Vandenis;RUONIUKŲ;2422642232;Ne;0;7;0;7
11625;Vandenis;RUONIUKŲ;1051281257;Ne;0;7;0;7
11626;Vandenis;RUONIUKŲ;1120907086;Ne;0;9;0;9
11627;Vandenis;RUONIUKŲ;1563710105;Ne;6;0;1;7
11628;Vandenis;RUONIUKŲ;7702272913;Ne;0;0;2;2
11629;Vandenis;RUONIUKŲ;6476051751;Ne;0;11;0;11
11630;Vandenis;RUONIUKŲ;9162936403;Ne;9;1;0;10
11631;Vandenis;RUONIUKŲ;4713395766;Ne;0;1;0;1
11632;Vandenis;RUONIUKŲ;6986724058;Ne;0;2;0;2
11633;Vandenis;RUONIUKŲ;7754158588;Ne;4;0;1;5
11634;Vandenis;RUONIUKŲ;9731729915;Ne;6;0;0;6
11635;Vandenis;RUONIUKŲ;8971291182;Ne;1;0;2;3
11636;Vandenis;RUONIUKŲ;6330187732;Ne;0;11;0;11
11637;Vandenis;RUONIUKŲ;9688954631;Ne;4;0;0;4
11638;Vandenis;RUONIUKŲ;8729351613;Ne;4;0;0;4
11639;Vandenis;RUONIUKŲ;4971165639;Ne;7;0;0;7
11640;Vandenis;RUONIUKŲ;6158299885;Ne;6;0;1;7
11641;Vandenis;RUONIUKŲ;3664560833;Ne;0;3;0;3
11642;Vandenis;RUONIUKŲ;5535901447;Ne;0;2;0;2
11643;Vandenis;ŽUVYČIŲ;55421695186;Ne;0;2;0;2
11644;Vandenis;ŽUVYČIŲ;43933878402;Ne;0;2;0;2
11645;Vandenis;ŽUVYČIŲ;8430706407;Ne;0;1;0;1
11646;Vandenis;ŽUVYČIŲ;8689134931;Ne;5;0;0;5
11647;Vandenis;ŽUVYČIŲ;4085256182;Ne;5;0;0;5
11648;Vandenis;ŽUVYČIŲ;1598122777;Ne;0;1;0;1
11649;Vandenis;ŽUVYČIŲ;5549292096;Ne;5;3;0;8
11650;Vandenis;ŽUVYČIŲ;24217366528;Ne;0;1;0;1
11651;Vandenis;ŽUVYČIŲ;3544717790;Ne;0;2;1;3
11652;Vandenis;ŽUVYČIŲ;4643267945;Ne;0;2;1;3
11653;Vandenis;ŽUVYČIŲ;27409922803;Ne;6;0;2;8
11654;Vandenis;ŽUVYČIŲ;9518434896;Ne;0;10;0;10
11655;Vandenis;ŽUVYČIŲ;2638433939;Ne;0;2;0;2
11656;Vandenis;PERLIUKŲ;8678508812;Ne;0;1;0;1
11657;Vandenis;PERLIUKŲ;2645775090;Ne;0;1;0;1
11658;Vandenis;PERLIUKŲ;7598257845;Ne;4;5;0;9
11659;Vandenis;PERLIUKŲ;7473692892;Ne;8;0;0;8
11660;Vandenis;PERLIUKŲ;5323428164;Ne;17;0;0;17
11661;Vandenis;PERLIUKŲ;6073002418;Ne;0;11;0;11
11662;Vandenis;PERLIUKŲ;2576575249;Ne;10;0;0;10
11663;Vandenis;PERLIUKŲ;1975385430;Ne;0;3;0;3
11664;Vandenis;PERLIUKŲ;3061606138;Ne;6;0;0;6
11665;Vandenis;PERLIUKŲ;8117385209;Ne;0;0;1;1
11666;Vandenis;PERLIUKŲ;5613067534;Ne;0;2;2;4
11667;Vandenis;PERLIUKŲ;2321919298;Ne;2;1;0;3
11668;Vandenis;PERLIUKŲ;5963181638;Ne;8;0;0;8
11669;Vandenis;PERLIUKŲ;5609737826;Ne;0;0;10;10
11670;Vandenis;PERLIUKŲ;3239754791;Ne;0;5;0;5
11671;Vandenis;PERLIUKŲ;5129492284;Ne;0;1;0;1
11672;Vandenis;ANČIUKŲ;4607196473;Ne;4;0;2;6
11673;Vandenis;ANČIUKŲ;6189862061;Ne;5;2;0;7
11674;Vandenis;ANČIUKŲ;4345021061;Ne;5;2;0;7
11675;Vandenis;ANČIUKŲ;9763300020;Ne;5;3;0;8
11676;Vandenis;ANČIUKŲ;9968877035;Ne;2;2;0;4
11677;Vandenis;ANČIUKŲ;3639160500;Ne;8;0;0;8
11678;Vandenis;ANČIUKŲ;9458613523;Ne;0;4;0;4
11679;Vandenis;ANČIUKŲ;4715198793;Ne;6;0;0;6
11680;Vandenis;ANČIUKŲ;1213743099;Ne;0;6;0;6
11681;Vandenis;ANČIUKŲ;4954121871;Ne;6;1;0;7
11682;Vandenis;ANČIUKŲ;4978712442;Ne;0;6;0;6
11683;Vandenis;ANČIUKŲ;7631982912;Ne;0;1;0;1
11684;Vandenis;ANČIUKŲ;7581114286;Ne;3;4;0;7
11685;Vandenis;ANČIUKŲ;9679010239;Ne;12;1;0;13
11686;Vandenis;ANČIUKŲ;9314410776;Ne;15;1;0;16
11687;Vandenis;ANČIUKŲ;1132534461;Taip;9;1;0;10
11688;Vandenis;ANČIUKŲ;2647966131;Ne;15;0;0;15
11689;Vandenis;ANČIUKŲ;3544764716;Ne;0;2;8;10
11690;Vandenis;ANČIUKŲ;4530824157;Ne;15;0;0;15
11691;Vandenis;VĖŽLIUKŲ;2309166304;Ne;9;1;0;10
11692;Vandenis;VĖŽLIUKŲ;2872343656;Taip;2;0;0;2
11693;Vandenis;VĖŽLIUKŲ;5454049563;Ne;0;2;0;2
11694;Vandenis;VĖŽLIUKŲ;9805578141;Ne;0;2;0;2
11695;Vandenis;VĖŽLIUKŲ;8921666108;Ne;7;2;0;9
11696;Vandenis;VĖŽLIUKŲ;7069369080;Ne;0;5;0;5
11697;Vandenis;VĖŽLIUKŲ;7924399684;Ne;0;3;0;3
11698;Vandenis;VĖŽLIUKŲ;1187395353;Ne;0;9;0;9
11699;Vandenis;VĖŽLIUKŲ;7091356848;Ne;0;9;0;9
11700;Vandenis;VĖŽLIUKŲ;5126732658;Ne;0;1;0;1
11701;Vandenis;VĖŽLIUKŲ;7059385610;Ne;0;7;0;7
11702;Vandenis;VĖŽLIUKŲ;9158541919;Ne;1;0;0;1
11703;Vandenis;VĖŽLIUKŲ;5959181898;Ne;1;0;0;1
11704;Vandenis;VĖŽLIUKŲ;1707354287;Ne;0;3;0;3
11705;Vandenis;VĖŽLIUKŲ;4413648496;Ne;0;0;1;1
11706;Vandenis;VĖŽLIUKŲ;4177166475;Ne;0;7;0;7
11707;Vandenis;VĖŽLIUKŲ;5218101579;Ne;0;2;0;2
11708;Vandenis;VĖŽLIUKŲ;2936885357;Ne;9;0;2;11
11709;Vandenis;VĖŽLIUKŲ;8879608849;Ne;0;13;0;13
11710;Vandenis;AŠTUNKOJŲ;2077783219;Ne;0;1;0;1
11711;Vandenis;AŠTUNKOJŲ;8511948282;Ne;7;1;0;8
11712;Vandenis;AŠTUNKOJŲ;2096950367;Ne;0;2;0;2
11713;Vandenis;AŠTUNKOJŲ;71786730314;Ne;2;0;0;2
11714;Vandenis;AŠTUNKOJŲ;6181866272;Ne;0;6;0;6
11715;Vandenis;AŠTUNKOJŲ;33317650043;Ne;0;3;0;3
11716;Vandenis;AŠTUNKOJŲ;7522472652;Ne;0;6;0;6
11717;Vandenis;AŠTUNKOJŲ;1222539247;Ne;0;1;0;1
11718;Vandenis;AŠTUNKOJŲ;4750141780;Ne;0;2;3;5
11719;Vandenis;AŠTUNKOJŲ;1621481561;Ne;0;1;0;1
11720;Vandenis;AŠTUNKOJŲ;1314724267;Ne;4;0;3;7
11721;Vandenis;AŠTUNKOJŲ;1282499654;Ne;0;4;0;4
11722;Vandenis;AŠTUNKOJŲ;1739780612;Ne;0;5;0;5
11723;Vandenis;AŠTUNKOJŲ;8233407105;Ne;0;1;0;1
11724;Vandenis;AŠTUNKOJŲ;2489776665;Ne;8;0;1;9
11725;Vandenis;AŠTUNKOJŲ;1633589144;Ne;5;4;1;10
11726;Vandenis;GANDRIUKŲ;4753416316;Ne;3;0;0;3
11727;Vandenis;GANDRIUKŲ;8264797886;Ne;6;0;2;8
11728;Vandenis;GANDRIUKŲ;9936940067;Ne;6;0;0;6
11729;Vandenis;GANDRIUKŲ;6153669587;Ne;6;0;0;6
11730;Vandenis;GANDRIUKŲ;6260893699;Ne;1;5;0;6
11731;Vandenis;GANDRIUKŲ;1919577714;Ne;12;0;0;12
11732;Vandenis;GANDRIUKŲ;7019646962;Ne;0;9;0;9
11733;Vandenis;GANDRIUKŲ;2078767085;Ne;6;0;3;9
11734;Vandenis;GANDRIUKŲ;2976505868;Ne;0;19;0;19
11735;Vandenis;GANDRIUKŲ;6558155968;Ne;6;0;0;6
11736;Vandenis;GANDRIUKŲ;6691874473;Ne;6;0;0;6
11737;Vandenis;GANDRIUKŲ;6483030616;Ne;1;1;0;2
11738;Vandenis;GANDRIUKŲ;8144830789;Ne;5;0;1;6
11739;Vandenis;GANDRIUKŲ;2381566229;Ne;2;0;1;3
11740;Vandenis;GANDRIUKŲ;5899846599;Ne;2;1;1;4
11741;Vandenis;GANDRIUKŲ;8127873607;Ne;4;0;0;4
11742;Vandenis;GANDRIUKŲ;1606103904;Ne;0;10;0;10
11743;Vandenis;GANDRIUKŲ;1753180703;Ne;0;0;2;2
11744;Vandenis;GANDRIUKŲ;7303512055;Ne;8;1;0;9
11745;Vandenis;GANDRIUKŲ;3231434944;Ne;0;0;18;18
11746;Vandenis;GANDRIUKŲ;6327478049;Ne;10;0;10;20
11747;Vandenis;GANDRIUKŲ;7311677107;Ne;0;0;1;1
11748;Vandenis;GANDRIUKŲ;6586215199;Ne;0;5;0;5
11749;Vandenis;GANDRIUKŲ;5985915835;Ne;0;0;1;1
11750;Vandenis;ŽĄSIUKAI;8034690071;Ne;4;2;0;6
11751;Vandenis;ŽĄSIUKAI;2004158593;Ne;2;1;0;3
11752;Vandenis;ŽĄSIUKAI;4984723792;Ne;0;2;0;2
11753;Vandenis;ŽĄSIUKAI;8014569725;Ne;3;0;0;3
11754;Vandenis;ŽĄSIUKAI;7071349847;Ne;2;4;0;6
11755;Vandenis;ŽĄSIUKAI;7070234429;Ne;0;2;0;2
11756;Vandenis;ŽĄSIUKAI;4072405890;Ne;7;0;0;7
11757;Vandenis;ŽĄSIUKAI;4349464804;Ne;6;2;0;8
11758;Vandenis;ŽĄSIUKAI;7596199296;Ne;0;7;0;7
11759;Vandenis;ŽĄSIUKAI;6876019354;Ne;0;5;0;5
11760;Vandenis;ŽĄSIUKAI;5607412408;Ne;15;1;0;16
11761;Vandenis;ŽĄSIUKAI;5641929490;Ne;1;5;0;6
11762;Vandenis;ŽĄSIUKAI;2454959791;Ne;3;0;0;3
11763;Vandenis;ŽĄSIUKAI;4565893472;Ne;1;0;0;1
11764;Vandenis;ŽĄSIUKAI;9801593009;Ne;10;0;0;10
11765;Vandenis;PURIENŲ;6851178154;Ne;9;0;0;9
11766;Vandenis;PURIENŲ;5440027798;Ne;5;2;1;8
11767;Vandenis;PURIENŲ;4455886780;Ne;17;0;0;17
11768;Vandenis;PURIENŲ;1031451445;Ne;5;0;0;5
11769;Vandenis;PURIENŲ;4815210197;Ne;6;0;0;6
11770;Vandenis;PURIENŲ;3337286021;Ne;14;0;0;14
11771;Vandenis;PURIENŲ;7020534318;Ne;7;0;0;7
11772;Vandenis;PURIENŲ;6027680514;Ne;8;2;1;11
11773;Vandenis;PURIENŲ;2960005490;Ne;10;0;0;10
11774;Vandenis;PURIENŲ;1180322026;Ne;10;0;0;10
11775;Vandenis;PURIENŲ;7959438279;Ne;9;0;0;9
11776;Vandenis;PURIENŲ;1788652447;Ne;7;0;0;7
11777;Vandenis;PURIENŲ;6332179750;Ne;0;2;3;5
11778;Vandenis;PURIENŲ;2719678617;Ne;4;0;0;4
11779;Vandenis;PURIENŲ;7171302906;Ne;13;0;0;13
11780;Vandenis;PURIENŲ;8085633453;Ne;13;0;0;13
11781;Vandenis;VARLIUKAI;6907717590;Ne;10;0;0;10
11782;Vandenis;VARLIUKAI;2661339448;Ne;18;0;0;18
11783;Vandenis;VARLIUKAI;2451901210;Ne;13;6;0;19
11784;Vandenis;VARLIUKAI;1786146371;Ne;7;2;0;9
11785;Vandenis;VARLIUKAI;3393306645;Ne;4;0;0;4
11786;Vandenis;VARLIUKAI;2506411643;Ne;9;2;0;11
11787;Vandenis;VARLIUKAI;8841954633;Ne;21;1;0;22
11788;Vandenis;VARLIUKAI;7001613448;Ne;21;1;0;22
11789;Vandenis;VARLIUKAI;1983972864;Ne;14;4;0;18
11790;Vandenis;VARLIUKAI;6067408982;Ne;13;0;0;13
11791;Vandenis;VARLIUKAI;8239664149;Ne;20;4;0;24
11792;Vandenis;VARLIUKAI;9380306986;Ne;5;1;0;6
11793;Vandenis;VARLIUKAI;1953052452;Ne;0;2;0;2
11794;Vandenis;VARLIUKAI;1799139825;Ne;1;0;0;1
11795;Vandenis;VARLIUKAI;3038533882;Ne;19;1;0;20
11796;Vandenis;VARLIUKAI;3173213991;Ne;5;6;0;11
11797;Vandenis;VARLIUKAI;5675840354;Ne;4;1;0;5
11798;Vandenis;VARLIUKAI;6570331247;Ne;27;1;0;28
11799;Vandenis;VARLIUKAI;2883058280;Ne;9;0;0;9
11800;Vandenis;VARLIUKAI;7233484054;Ne;15;0;0;15
11801;Vandenis;PINGVINAI;9856199548;Taip;10;1;0;11
11802;Vandenis;PINGVINAI;2209513000;Ne;0;3;0;3
11803;Vandenis;PINGVINAI;2665865704;Ne;3;1;0;4
11804;Vandenis;PINGVINAI;8755050997;Ne;14;0;0;14
11805;Vandenis;PINGVINAI;1780124964;Ne;0;1;0;1
11806;Vandenis;PINGVINAI;9609168578;Ne;3;1;0;4
11807;Vandenis;PINGVINAI;3360623444;Ne;6;2;0;8
11808;Vandenis;PINGVINAI;5191604973;Ne;4;1;0;5
11809;Vandenis;PINGVINAI;2757376962;Ne;0;5;0;5
11810;Vandenis;PINGVINAI;6992750701;Ne;1;3;0;4
11811;Vandenis;PINGVINAI;6731336385;Ne;10;0;0;10
11812;Vandenis;PINGVINAI;3933306911;Ne;20;0;0;20
11813;Vandenis;PINGVINAI;2534991705;Ne;6;0;0;6
11814;Vandenis;PINGVINAI;7267965471;Ne;0;2;1;3
11815;Vandenis;PINGVINAI;5632082019;Ne;13;3;0;16
11816;Vandenis;PINGVINAI;9717294497;Ne;0;3;0;3
11817;Vandenis;PINGVINAI;7770227772;Ne;0;20;0;20
11818;Vandenis;PINGVINAI;8560123112;Ne;9;3;0;12
11819;Vandenis;PINGVINAI;4091633411;Ne;5;0;0;5
11820;Varpelis;NYKŠTUKAI;3840270467;Ne;4;0;0;4
11821;Varpelis;NYKŠTUKAI;5322766823;Taip;2;0;0;2
11822;Varpelis;NYKŠTUKAI;1081800670;Ne;8;0;0;8
11823;Varpelis;NYKŠTUKAI;6455435982;Ne;6;0;0;6
11824;Varpelis;NYKŠTUKAI;5155733224;Ne;5;0;0;5
11825;Varpelis;NYKŠTUKAI;8269062925;Ne;2;0;0;2
11826;Varpelis;SMALSUČIŲ;7165290883;Ne;6;0;0;6
11827;Varpelis;SMALSUČIŲ;2439963805;Ne;14;0;0;14
11828;Varpelis;SMALSUČIŲ;5963798674;Ne;6;0;0;6
11829;Varpelis;SMALSUČIŲ;6873406894;Ne;1;0;0;1
11830;Varpelis;GINTARĖLIAI;3935604801;Ne;2;0;0;2
11831;Varpelis;GINTARĖLIAI;4315014085;Ne;3;0;0;3
11832;Varpelis;GINTARĖLIAI;2739291648;Ne;3;0;0;3
11833;Varpelis;GINTARĖLIAI;2585736095;Ne;10;0;0;10
11834;Varpelis;AITVARIUKŲ;1427668217;Ne;4;0;0;4
11835;Varpelis;BORUŽĖLIŲ;9459203013;Ne;4;0;0;4
11836;Varpelis;BORUŽĖLIŲ;1627348136;Ne;5;0;0;5
11837;Varpelis;ZUIKUČIŲ;2275090267;Ne;4;0;0;4
11838;Varpelis;ZUIKUČIŲ;1336468541;Ne;2;0;0;2
11839;Varpelis;ZUIKUČIŲ;4440350144;Ne;2;0;0;2
11840;Varpelis;ZUIKUČIŲ;2958988954;Ne;5;0;0;5
11841;Varpelis;ZUIKUČIŲ;1029481623;Ne;5;0;0;5
11842;Varpelis;BITUTĖS;7497169351;Ne;5;0;0;5
11843;Varpelis;DRUGELIAI;9846434157;Ne;2;0;0;2
11844;Varpelis;DRUGELIAI;6397377742;Ne;5;0;0;5
11845;Varpelis;DRUGELIAI;2087032775;Taip;6;0;0;6
11846;Varpelis;LAŠIUKŲ;4054668754;Ne;4;0;0;4
11847;Varpelis;LAŠIUKŲ;8203343084;Ne;8;0;0;8
11848;Varpelis;LAŠIUKŲ;5818568067;Ne;9;0;0;9
11849;Varpelis;LAŠIUKŲ;7029102540;Ne;10;0;0;10
11850;Varpelis;ŽIRNIUKŲ;3767484917;Taip;1;0;0;1
11851;Varpelis;ŽIRNIUKŲ;1251914675;Ne;8;0;0;8
11852;Varpelis;ŽIRNIUKŲ;6478769033;Ne;10;0;0;10
11853;Varpelis;ŽIRNIUKŲ;8997987781;Ne;15;0;0;15
11854;Vėjelis;Pumpurėliai;2541077369;Ne;7;1;0;8
11855;Vėjelis;Pumpurėliai;5516672613;Ne;0;2;0;2
11856;Vėjelis;Pumpurėliai;1084415930;Taip;0;2;3;5
11857;Vėjelis;Pumpurėliai;9071878406;Taip;0;2;3;5
11858;Vėjelis;Pumpurėliai;3206025676;Ne;5;0;0;5
11859;Vėjelis;Pumpurėliai;5611813359;Ne;0;4;0;4
11860;Vėjelis;Pumpurėliai;1057586168;Ne;6;0;0;6
11861;Vėjelis;Pumpurėliai;7539681314;Ne;0;3;0;3
11862;Vėjelis;Pumpurėliai;3081923183;Ne;1;0;0;1
11863;Vėjelis;Pumpurėliai;9003601108;Ne;1;0;0;1
11864;Vėjelis;Pumpurėliai;6168648640;Ne;0;2;0;2
11865;Vėjelis;Pumpurėliai;1876663813;Ne;2;1;0;3
11866;Vėjelis;Pumpurėliai;9824130744;Ne;0;2;2;4
11867;Vėjelis;Pumpurėliai;1842552329;Ne;8;0;0;8
11868;Vėjelis;Pumpurėliai;9986867356;Ne;0;1;0;1
11869;Vėjelis;Pumpurėliai;8467887788;Ne;0;9;0;9
11870;Vėjelis;Pumpurėliai;8994680698;Ne;3;1;0;4
11871;Vėjelis;Pumpurėliai;2656895893;Ne;4;2;0;6
11872;Vėjelis;Drugeliai;1978952781;Ne;0;0;1;1
11873;Vėjelis;Drugeliai;2734024890;Ne;10;6;0;16
11874;Vėjelis;Drugeliai;7981032872;Ne;0;20;0;20
11875;Vėjelis;Drugeliai;7594586198;Ne;0;6;0;6
11876;Vėjelis;Drugeliai;7697394469;Ne;1;0;4;5
11877;Vėjelis;Drugeliai;4066956765;Ne;0;2;2;4
11878;Vėjelis;Drugeliai;2788205363;Ne;6;2;2;10
11879;Vėjelis;Drugeliai;1331334220;Ne;1;2;3;6
11880;Vėjelis;Drugeliai;2151737048;Ne;0;2;0;2
11881;Vėjelis;Drugeliai;3982318250;Ne;1;0;0;1
11882;Vėjelis;Drugeliai;4473677352;Ne;0;2;0;2
11883;Vėjelis;Drugeliai;3524350131;Ne;0;0;1;1
11884;Vėjelis;Drugeliai;6061966626;Ne;6;0;0;6
11885;Vėjelis;Drugeliai;6891260701;Ne;0;4;0;4
11886;Vėjelis;Malūnėlis;1994035417;Ne;2;0;0;2
11887;Vėjelis;Malūnėlis;7097474285;Ne;1;0;0;1
11888;Vėjelis;Malūnėlis;1448699738;Ne;2;2;4;8
11889;Vėjelis;Malūnėlis;3275186042;Ne;0;1;0;1
11890;Vėjelis;Malūnėlis;1882750621;Ne;13;0;0;13
11891;Vėjelis;Malūnėlis;5109441799;Ne;0;0;3;3
11892;Vėjelis;Malūnėlis;4171024976;Ne;2;0;3;5
11893;Vėjelis;Malūnėlis;1871467392;Ne;5;0;0;5
11894;Vėjelis;Malūnėlis;8221349174;Ne;0;2;2;4
11895;Vėjelis;Malūnėlis;6600504736;Ne;5;0;0;5
11896;Vėjelis;Malūnėlis;8063276082;Ne;0;2;7;9
11897;Vėjelis;Malūnėlis;6244227830;Ne;1;6;0;7
11898;Vėjelis;Malūnėlis;1417987860;Ne;16;0;1;17
11899;Vėjelis;Malūnėlis;9636946669;Ne;12;0;0;12
11900;Vėjelis;Malūnėlis;8822873586;Ne;5;0;1;6
11901;Vėjelis;Žvaigždutės;9492690970;Ne;4;0;2;6
11902;Vėjelis;Žvaigždutės;1436893015;Ne;5;0;0;5
11903;Vėjelis;Žvaigždutės;2117924725;Ne;11;0;0;11
11904;Vėjelis;Žvaigždutės;1549518622;Ne;11;4;0;15
11905;Vėjelis;Žvaigždutės;6386092350;Ne;0;11;0;11
11906;Vėjelis;Žvaigždutės;6844704326;Ne;0;0;1;1
11907;Vėjelis;Žvaigždutės;3315240387;Taip;0;12;0;12
11908;Vėjelis;Žvaigždutės;2132551615;Ne;0;0;14;14
11909;Vėjelis;Žvaigždutės;2522750651;Ne;5;0;0;5
11910;Vėjelis;Žvaigždutės;6777528441;Ne;8;0;0;8
11911;Vėjelis;Žvaigždutės;4868574574;Ne;7;0;0;7
11912;Vėjelis;Žvaigždutės;9135807341;Ne;9;0;0;9
11913;Vėjelis;Žvaigždutės;4101161670;Ne;5;1;0;6
11914;Vėjelis;Žvaigždutės;7247057946;Ne;0;0;7;7
11915;Vėjelis;Žvaigždutės;7046938604;Ne;8;1;0;9
11916;Vėjelis;Žvaigždutės;3495322620;Ne;3;0;0;3
11917;Vėjelis;Žvaigždutės;1956418258;Ne;0;2;0;2
11918;Vėjelis;Žvaigždutės;7203026860;Ne;5;0;0;5
11919;Vėjelis;Žvaigždutės;8300497094;Ne;1;2;0;3
11920;Vėjelis;Varpeliai;7274745807;Ne;0;2;6;8
11921;Vėjelis;Varpeliai;5931553549;Ne;0;2;0;2
11922;Vėjelis;Varpeliai;9926991259;Ne;0;2;11;13
11923;Vėjelis;Varpeliai;6608657740;Ne;0;2;5;7
11924;Vėjelis;Varpeliai;2794205377;Ne;3;1;0;4
11925;Vėjelis;Varpeliai;7507448059;Ne;0;6;0;6
11926;Vėjelis;Varpeliai;2363974247;Ne;0;2;2;4
11927;Vėjelis;Varpeliai;8379298947;Ne;0;2;2;4
11928;Vėjelis;Varpeliai;1205392813;Ne;0;6;0;6
11929;Vėjelis;Varpeliai;5031781196;Ne;5;0;0;5
11930;Vėjelis;Varpeliai;4219672982;Ne;9;1;0;10
11931;Vėjelis;Varpeliai;50124109589;Ne;0;5;0;5
11932;Vėjelis;Varpeliai;4853650350;Ne;0;2;0;2
11933;Vėjelis;Varpeliai;4521161684;Ne;0;6;0;6
11934;Vėjelis;Varpeliai;60890519853;Ne;0;2;3;5
11935;Vėjelis;Varpeliai;8684461171;Ne;0;3;0;3
11936;Vėjelis;Varpeliai;7133454882;Ne;0;7;0;7
11937;Vėjelis;Varpeliai;1863210064;Ne;0;1;0;1
11938;Vėjelis;Varpeliai;1534169381;Ne;0;3;0;3
11939;Vėjelis;Varpeliai;2957105835;Ne;0;0;3;3
11940;Vėjelis;Pelėdžiukų;7211756910;Ne;0;2;0;2
11941;Vėjelis;Pelėdžiukų;2302652824;Ne;7;2;4;13
11942;Vėjelis;Pelėdžiukų;4852532740;Ne;0;20;0;20
11943;Vėjelis;Pelėdžiukų;4450739919;Ne;0;1;0;1
11944;Vėjelis;Pelėdžiukų;9202471939;Ne;4;3;0;7
11945;Vėjelis;Pelėdžiukų;1615837863;Ne;4;3;0;7
11946;Vėjelis;Pelėdžiukų;9852892338;Ne;0;2;0;2
11947;Vėjelis;Pelėdžiukų;8433853523;Ne;0;0;1;1
11948;Vėjelis;Pelėdžiukų;4746355716;Ne;8;0;0;8
11949;Vėjelis;Pelėdžiukų;5507017221;Ne;0;1;0;1
11950;Vėjelis;Pelėdžiukų;1259743374;Ne;0;2;2;4
11951;Vėjelis;Pelėdžiukų;6226234271;Ne;0;20;0;20
11952;Vėjelis;Pelėdžiukų;8153021028;Ne;0;2;3;5
11953;Vėjelis;Pelėdžiukų;8067153728;Ne;1;11;0;12
11954;Vėjelis;Pelėdžiukų;2283628712;Ne;6;1;0;7
11955;Vėjelis;Pelėdžiukų;2729246397;Ne;20;0;0;20
11956;Vėjelis;Pelėdžiukų;9769871497;Ne;0;0;8;8
11957;Vėjelis;Pelėdžiukų;4318295503;Ne;1;0;3;4
11958;Vėjelis;Pelėdžiukų;9867392835;Ne;2;4;0;6
11959;Vėjelis;Pelėdžiukų;5662728912;Ne;0;0;4;4
11960;Vėjelis;Skruzdeliukų;8470977526;Ne;0;11;0;11
11961;Vėjelis;Skruzdeliukų;9434737088;Ne;0;1;0;1
11962;Vėjelis;Skruzdeliukų;1952141664;Ne;4;0;2;6
11963;Vėjelis;Skruzdeliukų;4992783345;Ne;5;6;0;11
11964;Vėjelis;Skruzdeliukų;4997987762;Ne;0;0;2;2
11965;Vėjelis;Skruzdeliukų;4412135676;Ne;0;5;0;5
11966;Vėjelis;Skruzdeliukų;8356715925;Ne;0;0;3;3
11967;Vėjelis;Skruzdeliukų;4946988585;Ne;0;0;3;3
11968;Vėjelis;Skruzdeliukų;6408918277;Ne;0;0;8;8
11969;Vėjelis;Skruzdeliukų;7240155487;Ne;5;0;1;6
11970;Vėjelis;Skruzdeliukų;7695719991;Ne;0;2;1;3
11971;Vėjelis;Skruzdeliukų;6618114389;Ne;0;2;4;6
11972;Vėjelis;Skruzdeliukų;1381923971;Ne;0;2;0;2
11973;Vėjelis;Skruzdeliukų;8630131152;Ne;5;0;1;6
11974;Vėjelis;Skruzdeliukų;6431589805;Ne;0;2;2;4
11975;Vėjelis;Skruzdeliukų;4906958328;Ne;0;2;0;2
11976;Vėjelis;Skruzdeliukų;4080198912;Ne;0;0;5;5
11977;Vėjelis;Skruzdeliukų;1555270425;Ne;0;0;2;2
11978;Vėjelis;Skruzdeliukų;1467023330;Ne;5;0;0;5
11979;Vėjelis;Pieštukų;7860576967;Ne;6;0;0;6
11980;Vėjelis;Pieštukų;9546928491;Ne;3;0;0;3
11981;Vėjelis;Pieštukų;9675488924;Ne;3;0;0;3
11982;Vėjelis;Pieštukų;4884057836;Ne;0;0;5;5
11983;Vėjelis;Pieštukų;3898751303;Ne;17;3;0;20
11984;Vėjelis;Pieštukų;8281508498;Ne;0;0;4;4
11985;Vėjelis;Pieštukų;6909799367;Ne;6;0;0;6
11986;Vėjelis;Pieštukų;1075188861;Ne;15;0;0;15
11987;Vėjelis;Pieštukų;6823103188;Ne;0;10;0;10
11988;Vėjelis;Pieštukų;7854614677;Ne;1;1;0;2
11989;Vėjelis;Pieštukų;9451358807;Ne;13;0;0;13
11990;Vėjelis;Pieštukų;6453605110;Ne;0;20;0;20
11991;Vėjelis;Pieštukų;2734891342;Taip;4;7;0;11
11992;Vėjelis;Ramunėlių;5987294293;Taip;8;7;0;15
11993;Vėjelis;Ramunėlių;8047799576;Taip;0;4;0;4
11994;Vėjelis;Ramunėlių;7178844364;Taip;0;4;0;4
11995;Vėjelis;Ramunėlių;6996900411;Taip;1;2;0;3
11996;Vėjelis;Ramunėlių;4733227215;Taip;5;0;1;6
11997;Vėjelis;Ramunėlių;5909697341;Taip;0;2;0;2
11998;Vėjelis;Ramunėlių;6451722893;Taip;0;5;0;5
11999;Vėjelis;Ramunėlių;3584347608;Taip;0;1;0;1
12000;Vėjelis;Ramunėlių;1381191703;Taip;0;2;0;2
12001;Vėjelis;Ramunėlių;9042329808;Taip;6;1;0;7
12002;Vėjelis;Ramunėlių;6660799519;Ne;0;3;0;3
12003;Vėjelis;Ramunėlių;6889825160;Ne;7;0;1;8
12004;Vėjelis;Ramunėlių;4433799070;Taip;0;2;0;2
12005;Vėjelis;Ramunėlių;4745262277;Ne;0;3;0;3
12006;Vėjelis;Ramunėlių;7790713917;Ne;7;0;0;7
12007;Vėjelis;Ramunėlių;8054114720;Taip;0;9;0;9
12008;Vėjelis;Ramunėlių;8986581196;Ne;14;0;0;14
12009;Vėjelis;Nykštukai;6741600874;Ne;7;0;0;7
12010;Vėjelis;Nykštukai;9957614551;Ne;0;3;0;3
12011;Vėjelis;Nykštukai;7233448544;Ne;14;2;0;16
12012;Vėjelis;Nykštukai;5339200991;Ne;10;0;0;10
12013;Vėjelis;Nykštukai;6602964509;Ne;0;2;0;2
12014;Vėjelis;Nykštukai;2573683778;Ne;0;8;0;8
12015;Vėjelis;Nykštukai;3843601190;Ne;4;0;6;10
12016;Vėjelis;Nykštukai;3574432129;Ne;10;0;0;10
12017;Vėjelis;Nykštukai;4713754452;Ne;1;1;0;2
12018;Vėjelis;Nykštukai;7889625599;Ne;0;0;2;2
12019;Vėjelis;Nykštukai;7763996061;Ne;0;6;0;6
12020;Vėjelis;Nykštukai;8755889077;Taip;9;0;0;9
12021;Vėjelis;Nykštukai;2763569936;Taip;1;1;0;2
12022;Vėjelis;Nykštukai;9979979480;Ne;10;0;2;12
12023;Vėjelis;Nykštukai;4063795811;Ne;10;0;0;10
12024;Vėjelis;BITUTĖS;6824919005;Ne;0;2;1;3
12025;Vėjelis;BITUTĖS;4276237884;Ne;0;12;0;12
12026;Vėjelis;BITUTĖS;3772706363;Ne;0;4;0;4
12027;Vėjelis;BITUTĖS;1834203833;Ne;6;2;0;8
12028;Vėjelis;BITUTĖS;8452132066;Ne;0;20;0;20
12029;Vėjelis;BITUTĖS;6283428333;Ne;5;0;3;8
12030;Vėjelis;BITUTĖS;3767625080;Ne;4;0;0;4
12031;Vėjelis;BITUTĖS;6569848405;Ne;0;2;0;2
12032;Vėjelis;BITUTĖS;1457373815;Ne;20;0;0;20
12033;Vėjelis;BITUTĖS;8571757635;Ne;0;1;0;1
12034;Vėjelis;BITUTĖS;1022888418;Ne;0;2;0;2
12035;Vėjelis;BITUTĖS;9625857378;Taip;3;2;0;5
12036;Vėjelis;BITUTĖS;1116238331;Ne;6;1;0;7
12037;Vėjelis;BITUTĖS;1674810054;Ne;4;0;3;7
12038;Vėjelis;BITUTĖS;6581265682;Ne;9;0;0;9
12039;Vėjelis;BITUTĖS;1070853175;Ne;5;0;0;5
12040;Vėjelis;BITUTĖS;4348246825;Ne;8;0;3;11
12041;Vėjelis;BITUTĖS;8273890475;Ne;7;2;0;9
12042;Vėjelis;Boruželės;5381588565;Ne;0;2;0;2
12043;Vėjelis;Boruželės;9037622738;Ne;0;2;1;3
12044;Vėjelis;Boruželės;1588345134;Ne;0;0;20;20
12045;Vėjelis;Boruželės;1429496839;Ne;4;2;1;7
12046;Vėjelis;Boruželės;1931659200;Ne;4;0;0;4
12047;Vėjelis;Boruželės;8666759391;Ne;0;1;0;1
12048;Vėjelis;Boruželės;3844131154;Ne;0;4;2;6
12049;Vėjelis;Boruželės;4747466651;Ne;6;2;0;8
12050;Vėjelis;Boruželės;3473416323;Ne;0;1;0;1
12051;Vėjelis;Boruželės;8141198449;Ne;0;2;3;5
12052;Vėjelis;Boruželės;8121537795;Ne;0;2;0;2
12053;Vėjelis;Boruželės;5517128872;Ne;3;1;0;4
12054;Vėjelis;Boruželės;8938491367;Ne;4;0;0;4
12055;Vėjelis;Boruželės;6108049183;Taip;0;2;0;2
12056;Vėjelis;Boruželės;1115802837;Ne;0;4;0;4
12057;Vėjelis;Boruželės;3276062426;Ne;5;0;2;7
12058;Vėjelis;Boruželės;4132824111;Ne;10;0;0;10
12059;Vėjelis;Boruželės;2000277444;Ne;0;0;1;1
12060;Vėjelis;Boruželės;7752923796;Ne;6;0;1;7
12061;Vėtrungė;Debesėlių;3655025938;Ne;0;0;4;4
12062;Vėtrungė;Debesėlių;7863176604;Ne;8;0;0;8
12063;Vėtrungė;Debesėlių;3179715496;Ne;8;0;0;8
12064;Vėtrungė;Debesėlių;6439014588;Ne;6;0;7;13
12065;Vėtrungė;Debesėlių;9423361592;Ne;0;2;0;2
12066;Vėtrungė;Debesėlių;1191007983;Ne;0;6;0;6
12067;Vėtrungė;Debesėlių;3745680607;Ne;9;0;1;10
12068;Vėtrungė;Debesėlių;9359012317;Ne;0;0;1;1
12069;Vėtrungė;Debesėlių;1807742144;Taip;5;0;11;16
12070;Vėtrungė;Debesėlių;9893842192;Ne;6;0;1;7
12071;Vėtrungė;Debesėlių;3433811829;Ne;0;0;4;4
12072;Vėtrungė;Debesėlių;2447851565;Ne;0;1;0;1
12073;Vėtrungė;Debesėlių;2136966687;Ne;0;12;0;12
12074;Vėtrungė;Debesėlių;5246813735;Ne;0;1;2;3
12075;Vėtrungė;Debesėlių;5836190044;Ne;0;0;1;1
12076;Vėtrungė;Debesėlių;7185104341;Ne;0;3;6;9
12077;Vėtrungė;Debesėlių;6374739740;Taip;0;1;3;4
12078;Vėtrungė;Debesėlių;5939537473;Taip;0;8;0;8
12079;Vėtrungė;Debesėlių;1871358961;Ne;0;0;6;6
12080;Vėtrungė;Zuikių;9407558097;Ne;0;9;0;9
12081;Vėtrungė;Zuikių;7573021445;Ne;0;2;0;2
12082;Vėtrungė;Zuikių;3335047815;Ne;0;2;0;2
12083;Vėtrungė;Zuikių;8157356569;Ne;0;2;0;2
12084;Vėtrungė;Zuikių;9742099165;Ne;0;7;3;10
12085;Vėtrungė;Zuikių;1215953192;Ne;4;0;0;4
12086;Vėtrungė;Zuikių;3908259010;Ne;13;0;0;13
12087;Vėtrungė;Zuikių;1729819557;Ne;11;0;4;15
12088;Vėtrungė;Zuikių;4916692634;Ne;0;6;0;6
12089;Vėtrungė;Zuikių;6416245099;Ne;0;7;0;7
12090;Vėtrungė;Zuikių;4197321604;Ne;4;2;0;6
12091;Vėtrungė;Zuikių;8742161467;Ne;6;1;0;7
12092;Vėtrungė;Zuikių;2537221101;Ne;18;0;0;18
12093;Vėtrungė;Zuikių;7342250921;Ne;6;3;0;9
12094;Vėtrungė;Zuikių;7435005821;Ne;0;2;4;6
12095;Vėtrungė;Zuikių;1280823326;Ne;7;2;0;9
12096;Vėtrungė;Drugelių;5622109033;Ne;5;1;0;6
12097;Vėtrungė;Drugelių;2124476787;Ne;1;1;1;3
12098;Vėtrungė;Drugelių;2970067995;Ne;9;0;0;9
12099;Vėtrungė;Drugelių;5251308945;Taip;1;1;0;2
12100;Vėtrungė;Drugelių;9812496068;Ne;0;1;0;1
12101;Vėtrungė;Drugelių;3634995652;Ne;0;4;0;4
12102;Vėtrungė;Drugelių;3744377479;Ne;0;0;1;1
12103;Vėtrungė;Drugelių;2933312366;Ne;3;8;0;11
12104;Vėtrungė;Drugelių;2508501223;Ne;8;2;0;10
12105;Vėtrungė;Do-re-mi;9324733839;Ne;0;1;0;1
12106;Vėtrungė;Do-re-mi;2287044278;Ne;0;1;0;1
12107;Vėtrungė;Do-re-mi;2928868412;Ne;0;11;1;12
12108;Vėtrungė;Do-re-mi;2883254822;Ne;0;0;10;10
12109;Vėtrungė;Do-re-mi;9518734260;Ne;0;1;1;2
12110;Vėtrungė;Do-re-mi;7496582551;Ne;0;0;2;2
12111;Vėtrungė;Do-re-mi;5430818470;Ne;7;2;0;9
12112;Vėtrungė;Do-re-mi;5832298824;Ne;0;2;0;2
12113;Vėtrungė;Do-re-mi;7895027909;Ne;0;1;1;2
12114;Vėtrungė;Do-re-mi;7807708310;Ne;0;0;7;7
12115;Vėtrungė;Do-re-mi;3200251047;Ne;0;0;2;2
12116;Vėtrungė;Do-re-mi;3369970611;Ne;0;7;0;7
12117;Vėtrungė;Do-re-mi;1808699695;Ne;0;0;8;8
12118;Vėtrungė;Do-re-mi;9079483362;Ne;10;0;4;14
12119;Vėtrungė;Do-re-mi;9271869305;Ne;0;0;1;1
12120;Vėtrungė;Do-re-mi;5452337780;Ne;0;0;11;11
12121;Vėtrungė;Do-re-mi;8956375453;Ne;14;0;0;14
12122;Vėtrungė;Do-re-mi;9865628172;Ne;1;0;2;3
12123;Vėtrungė;Smalsučių;7803736567;Ne;0;7;0;7
12124;Vėtrungė;Smalsučių;6599281163;Ne;6;0;0;6
12125;Vėtrungė;Smalsučių;3249689008;Ne;7;5;0;12
12126;Vėtrungė;Smalsučių;7295216791;Ne;0;1;0;1
12127;Vėtrungė;Smalsučių;9795630131;Ne;0;3;0;3
12128;Vėtrungė;Smalsučių;2440001662;Ne;0;5;0;5
12129;Vėtrungė;Smalsučių;4000379945;Ne;0;3;0;3
12130;Vėtrungė;Smalsučių;5367369908;Ne;0;6;0;6
12131;Vėtrungė;Smalsučių;4154712272;Ne;0;2;1;3
12132;Vėtrungė;Smalsučių;7483624989;Taip;0;5;0;5
12133;Vėtrungė;Smalsučių;4394100006;Ne;7;2;1;10
12134;Vėtrungė;Smalsučių;7730716483;Ne;3;2;0;5
12135;Vėtrungė;Smalsučių;5786557195;Ne;0;0;1;1
12136;Vėtrungė;Gudručių;6732632515;Taip;1;1;0;2
12137;Vėtrungė;Gudručių;8721035192;Ne;6;7;0;13
12138;Vėtrungė;Gudručių;8897558066;Ne;0;2;0;2
12139;Vėtrungė;Gudručių;7921863675;Ne;0;3;0;3
12140;Vėtrungė;Gudručių;8154023892;Ne;7;2;0;9
12141;Vėtrungė;Gudručių;1522141057;Ne;0;8;0;8
12142;Vėtrungė;Gudručių;9962435598;Ne;18;0;0;18
12143;Vėtrungė;Gudručių;2482436192;Ne;0;2;0;2
12144;Vėtrungė;Gudručių;4092242233;Ne;0;1;0;1
12145;Vėtrungė;Gudručių;1551989977;Ne;0;1;0;1
12146;Vėtrungė;Gudručių;4091719904;Ne;0;6;0;6
12147;Vėtrungė;Gudručių;5994465833;Ne;2;6;0;8
12148;Vėtrungė;Gudručių;4347810256;Ne;0;2;6;8
12149;Vėtrungė;Gudručių;7704497739;Ne;0;1;0;1
12150;Vėtrungė;Gudručių;8643181832;Ne;0;0;1;1
12151;Vėtrungė;Gudručių;1520846063;Ne;0;2;1;3
12152;Vėtrungė;Kodėlčių;9172488122;Ne;0;1;2;3
12153;Vėtrungė;Kodėlčių;2739382736;Ne;5;1;10;16
12154;Vėtrungė;Kodėlčių;3903604247;Ne;9;0;0;9
12155;Vėtrungė;Kodėlčių;7872043253;Ne;0;2;2;4
12156;Vėtrungė;Kodėlčių;8465132902;Ne;0;1;0;1
12157;Vėtrungė;Kodėlčių;8859592174;Ne;6;1;0;7
12158;Vėtrungė;Kodėlčių;9211406129;Ne;4;5;0;9
12159;Vėtrungė;Kodėlčių;1032730549;Ne;0;1;0;1
12160;Vėtrungė;Kodėlčių;7511121411;Ne;0;1;0;1
12161;Vėtrungė;Kodėlčių;4756863295;Ne;6;3;1;10
12162;Vėtrungė;Kodėlčių;8985054558;Ne;0;1;0;1
12163;Vėtrungė;Kodėlčių;3922749661;Ne;0;0;12;12
12164;Vėtrungė;Kodėlčių;3887230224;Ne;6;0;0;6
12165;Vėtrungė;Kodėlčių;7740260264;Ne;0;0;1;1
12166;Vėtrungė;Paukštelių;3957148270;Ne;8;3;0;11
12167;Vėtrungė;Paukštelių;3466149991;Ne;6;1;0;7
12168;Vėtrungė;Paukštelių;5338424871;Ne;15;5;0;20
12169;Vėtrungė;Paukštelių;6812588777;Ne;9;0;0;9
12170;Vėtrungė;Paukštelių;2798915063;Ne;0;0;8;8
12171;Vėtrungė;Paukštelių;2981610749;Ne;8;0;1;9
12172;Vėtrungė;Paukštelių;6146327857;Ne;4;0;0;4
12173;Vėtrungė;Paukštelių;8149563485;Ne;3;2;0;5
12174;Vėtrungė;Viščiukų;5021830780;Ne;10;0;2;12
12175;Vėtrungė;Viščiukų;6190900822;Ne;0;0;2;2
12176;Vėtrungė;Viščiukų;3834510410;Ne;0;0;6;6
12177;Vėtrungė;Viščiukų;4597361099;Ne;11;0;6;17
12178;Vėtrungė;Viščiukų;2490075899;Ne;0;1;0;1
12179;Vėtrungė;Viščiukų;4712052283;Ne;0;4;0;4
12180;Vėtrungė;Viščiukų;8761701511;Ne;5;12;0;17
12181;Vėtrungė;Viščiukų;3527585648;Ne;5;0;0;5
12182;Vėtrungė;Viščiukų;9684184905;Ne;0;0;10;10
12183;Vėtrungė;Viščiukų;4145172377;Ne;11;0;2;13
12184;Vėtrungė;Viščiukų;8577668542;Ne;4;0;3;7
12185;Vėtrungė;Nykštukų;9696984346;Ne;0;4;0;4
12186;Vėtrungė;Nykštukų;7819147751;Ne;10;0;0;10
12187;Vėtrungė;Nykštukų;2348557463;Ne;11;0;0;11
12188;Vėtrungė;Nykštukų;7733472482;Ne;3;0;0;3
12189;Vėtrungė;Nykštukų;2309821873;Ne;0;1;0;1
12190;Vėtrungė;Nykštukų;2364156362;Ne;2;1;0;3
12191;Vėtrungė;Nykštukų;8059553343;Ne;2;1;0;3
12192;Vėtrungė;Nykštukų;4020987532;Ne;5;1;0;6
12193;Vėtrungė;Nykštukų;7699392279;Ne;0;11;0;11
12194;Vėtrungė;Nykštukų;9773838651;Ne;3;0;0;3
12195;Vėtrungė;Nykštukų;6783756347;Ne;5;0;0;5
12196;Vėtrungė;Nykštukų;4289435509;Ne;9;2;0;11
12197;Vėtrungė;Meškiukų;2226654309;Ne;0;2;0;2
12198;Vėtrungė;Meškiukų;9207846866;Ne;5;0;0;5
12199;Vėtrungė;Meškiukų;9065848425;Taip;0;10;0;10
12200;Vėtrungė;Meškiukų;9685389270;Ne;2;5;0;7
12201;Vėtrungė;Meškiukų;9313438768;Ne;0;6;0;6
12202;Vėtrungė;Meškiukų;2520926439;Ne;0;3;0;3
12203;Vėtrungė;Meškiukų;7143997258;Ne;4;1;0;5
12204;Vėtrungė;Meškiukų;8961791293;Ne;6;3;0;9
12205;Vėtrungė;Meškiukų;2809555356;Ne;0;5;0;5
12206;Vėtrungė;Meškiukų;1766599777;Ne;14;0;1;15
12207;Vėtrungė;Meškiukų;9642541034;Ne;0;1;1;2
12208;Vėtrungė;Meškiukų;1480035015;Ne;4;0;0;4
12209;Vėtrungė;Meškiukų;5887929703;Ne;0;0;1;1
12210;Vėtrungė;Ąžuoliukų;8775969909;Ne;0;0;1;1
12211;Vėtrungė;Ąžuoliukų;1034537691;Ne;3;0;1;4
12212;Vėtrungė;Ąžuoliukų;6363761237;Ne;2;0;0;2
12213;Vėtrungė;Ąžuoliukų;3073965379;Ne;6;1;0;7
12214;Vėtrungė;Ąžuoliukų;3938684888;Ne;0;3;1;4
12215;Vėtrungė;Ąžuoliukų;6073563461;Ne;5;0;0;5
12216;Vėtrungė;Ąžuoliukų;2977116563;Ne;5;0;0;5
12217;Vėtrungė;Ąžuoliukų;4925843510;Ne;5;0;0;5
12218;Vėtrungė;Ąžuoliukų;8867794275;Ne;2;0;0;2
12219;Vėtrungė;Ąžuoliukų;7096106273;Ne;5;0;15;20
12220;Vėtrungė;Ąžuoliukų;8026065367;Ne;0;0;1;1
12221;Vėtrungė;Ąžuoliukų;6476717645;Ne;0;0;4;4
12222;Vėtrungė;Ąžuoliukų;5167580818;Taip;20;0;0;20
12223;Vėtrungė;Ąžuoliukų;1169648551;Ne;5;0;1;6
12224;Vilnelė;Lakštutė;8843094480;Ne;4;1;0;5
12225;Vilnelė;Lakštutė;5786086401;Ne;0;2;0;2
12226;Vilnelė;Lakštutė;6249731759;Ne;0;15;0;15
12227;Vilnelė;Lakštutė;5554451335;Ne;0;2;1;3
12228;Vilnelė;Lakštutė;1762024490;Ne;4;1;0;5
12229;Vilnelė;Lakštutė;4427383755;Ne;0;2;0;2
12230;Vilnelė;Lakštutė;1547117566;Ne;0;2;0;2
12231;Vilnelė;Lakštutė;3231387543;Ne;0;1;0;1
12232;Vilnelė;Lakštutė;8837662451;Ne;0;17;0;17
12233;Vilnelė;Lakštutė;3900484348;Ne;0;2;3;5
12234;Vilnelė;Lakštutė;5498574366;Ne;0;9;0;9
12235;Vilnelė;Lakštutė;6686896190;Ne;0;2;1;3
12236;Vilnelė;Lakštutė;3032273912;Ne;0;2;0;2
12237;Vilnelė;Lakštutė;4017436910;Ne;7;0;1;8
12238;Vilnelė;Lakštutė;6156838553;Ne;0;9;3;12
12239;Vilnelė;Lakštutė;9843449060;Ne;14;0;1;15
12240;Vilnelė;Lakštutė;2803880424;Ne;0;2;0;2
12241;Vilnelė;Lakštutė;2418216191;Ne;4;0;1;5
12242;Vilnelė;Lakštutė;5913967803;Ne;4;0;1;5
12243;Vilnelė;Vyturėlis;5091272908;Ne;0;2;1;3
12244;Vilnelė;Vyturėlis;2131599015;Ne;6;3;0;9
12245;Vilnelė;Vyturėlis;18740103706;Ne;0;2;0;2
12246;Vilnelė;Vyturėlis;7057183482;Ne;20;0;0;20
12247;Vilnelė;Vyturėlis;8725191514;Ne;0;2;0;2
12248;Vilnelė;Vyturėlis;7963783957;Ne;0;2;0;2
12249;Vilnelė;Vyturėlis;1545570307;Ne;0;0;3;3
12250;Vilnelė;Vyturėlis;5540359276;Ne;0;2;1;3
12251;Vilnelė;Vyturėlis;1966090625;Ne;0;1;0;1
12252;Vilnelė;Vyturėlis;8740717061;Ne;0;1;0;1
12253;Vilnelė;Vyturėlis;3772263873;Ne;0;0;1;1
12254;Vilnelė;Vyturėlis;9183391434;Ne;0;9;0;9
12255;Vilnelė;Vyturėlis;9369955153;Ne;0;2;1;3
12256;Vilnelė;Vyturėlis;1151879281;Ne;0;2;3;5
12257;Vilnelė;Vyturėlis;8820091584;Ne;0;0;1;1
12258;Vilnelė;Vyturėlis;8270866998;Ne;0;14;5;19
12259;Vilnelė;Vyturėlis;1462397783;Ne;9;4;0;13
12260;Vilnelė;Pagrandukas;5508759323;Ne;4;1;1;6
12261;Vilnelė;Pagrandukas;2144925171;Ne;0;2;0;2
12262;Vilnelė;Pagrandukas;4295816753;Ne;0;1;0;1
12263;Vilnelė;Pagrandukas;3844066232;Ne;0;12;0;12
12264;Vilnelė;Pagrandukas;6659537454;Ne;0;4;0;4
12265;Vilnelė;Pagrandukas;5953205533;Ne;0;14;0;14
12266;Vilnelė;Pagrandukas;6830433856;Ne;0;1;0;1
12267;Vilnelė;Pagrandukas;4664946923;Ne;1;0;0;1
12268;Vilnelė;Pagrandukas;6982847450;Ne;0;2;1;3
12269;Vilnelė;Pagrandukas;7560124407;Ne;6;0;3;9
12270;Vilnelė;Pagrandukas;3685294539;Taip;1;1;0;2
12271;Vilnelė;Pagrandukas;4931943297;Ne;0;2;0;2
12272;Vilnelė;Pagrandukas;7882756938;Ne;0;2;0;2
12273;Vilnelė;Pagrandukas;7348404699;Ne;0;3;0;3
12274;Vilnelė;Pagrandukas;3323738649;Ne;0;1;0;1
12275;Vilnelė;Pagrandukas;8116613831;Ne;0;3;0;3
12276;Vilnelė;Pagrandukas;6466321228;Ne;0;12;0;12
12277;Vilnelė;Pagrandukas;4478847902;Ne;0;9;0;9
12278;Vilnelė;Pagrandukas;9635159885;Ne;0;1;1;2
12279;Vilnelė;Pagrandukas;2165389724;Ne;1;0;0;1
12280;Vilnelė;Bitutė;2121071276;Ne;0;0;1;1
12281;Vilnelė;Bitutė;7387394504;Ne;0;10;0;10
12282;Vilnelė;Bitutė;8593060923;Ne;4;1;0;5
12283;Vilnelė;Bitutė;1882520335;Ne;0;1;0;1
12284;Vilnelė;Bitutė;2990112955;Ne;0;1;0;1
12285;Vilnelė;Bitutė;6318246517;Ne;2;5;1;8
12286;Vilnelė;Bitutė;9058632601;Ne;0;3;0;3
12287;Vilnelė;Bitutė;98028664140;Ne;0;1;0;1
12288;Vilnelė;Bitutė;1507865281;Ne;0;5;0;5
12289;Vilnelė;Bitutė;2130482375;Ne;0;1;0;1
12290;Vilnelė;Bitutė;7292043157;Ne;0;2;2;4
12291;Vilnelė;Bitutė;4480175299;Ne;0;2;0;2
12292;Vilnelė;Bitutė;39494954188;Ne;0;6;0;6
12293;Vilnelė;Bitutė;6327531229;Ne;0;0;5;5
12294;Vilnelė;Bitutė;42835212158;Ne;11;5;0;16
12295;Vilnelė;Bitutė;6146514112;Ne;1;2;0;3
12296;Vilnelė;Bitutė;9016832316;Ne;3;0;1;4
12297;Vilnelė;Bitutė;6155522893;Ne;5;0;0;5
12298;Vilnelė;Šaltinėlis;7752502124;Taip;2;0;1;3
12299;Vilnelė;Šaltinėlis;3064118212;Ne;14;0;0;14
12300;Vilnelė;Šaltinėlis;5813090771;Ne;16;0;0;16
12301;Vilnelė;Šaltinėlis;9317041585;Ne;13;0;0;13
12302;Vilnelė;Šaltinėlis;4670933970;Ne;10;0;0;10
12303;Vilnelė;Šaltinėlis;4817502971;Ne;7;0;2;9
12304;Vilnelė;Šaltinėlis;3712463891;Ne;2;5;0;7
12305;Vilnelė;Šaltinėlis;2343750614;Ne;3;0;2;5
12306;Vilnelė;Šaltinėlis;2700153185;Ne;0;0;4;4
12307;Vilnelė;Šaltinėlis;7698638698;Ne;0;0;1;1
12308;Vilnelė;Šaltinėlis;7231998656;Ne;19;0;0;19
12309;Vilnelė;Šaltinėlis;1108529953;Ne;5;0;0;5
12310;Vilnelė;Riešutėllis;1027463000;Ne;0;1;0;1
12311;Vilnelė;Riešutėllis;7020707723;Ne;13;2;0;15
12312;Vilnelė;Riešutėllis;4203549404;Ne;0;0;2;2
12313;Vilnelė;Riešutėllis;3290952017;Ne;0;1;0;1
12314;Vilnelė;Riešutėllis;8588430578;Ne;0;4;0;4
12315;Vilnelė;Riešutėllis;7957695470;Ne;0;0;1;1
12316;Vilnelė;Riešutėllis;4780827432;Ne;5;2;0;7
12317;Vilnelė;Riešutėllis;3670613082;Ne;8;2;3;13
12318;Vilnelė;Riešutėllis;6417545510;Ne;0;1;0;1
12319;Vilnelė;Riešutėllis;7085972543;Ne;4;1;0;5
12320;Vilnelė;Riešutėllis;3211657057;Ne;0;2;1;3
12321;Vilnelė;Riešutėllis;9016866597;Ne;10;4;0;14
12322;Vilnelė;Riešutėllis;7087798406;Ne;0;2;2;4
12323;Vilnelė;Riešutėllis;4254744025;Ne;0;11;0;11
12324;Vilnelė;Riešutėllis;3730997665;Ne;6;0;3;9
12325;Vilnelė;Riešutėllis;2706699572;Ne;0;5;0;5
12326;Vilnelė;Riešutėllis;8774842903;Ne;0;0;1;1
12327;Vilnelė;Nykštukas;2891787022;Ne;0;2;0;2
12328;Vilnelė;Nykštukas;4734511521;Ne;0;6;1;7
12329;Vilnelė;Nykštukas;4295630317;Ne;0;20;0;20
12330;Vilnelė;Nykštukas;1554473199;Ne;1;2;0;3
12331;Vilnelė;Nykštukas;1819154122;Ne;0;2;0;2
12332;Vilnelė;Nykštukas;4060927733;Ne;6;1;0;7
12333;Vilnelė;Nykštukas;2299381653;Ne;0;3;0;3
12334;Vilnelė;Nykštukas;5041031750;Ne;0;2;0;2
12335;Vilnelė;Nykštukas;2157793186;Ne;0;0;2;2
12336;Vilnelė;Nykštukas;4516818999;Ne;0;13;0;13
12337;Vilnelė;Nykštukas;8579294202;Ne;0;10;0;10
12338;Vilnelė;Nykštukas;7161529969;Ne;0;1;0;1
12339;Vilnelė;Nykštukas;8493390146;Ne;1;1;0;2
12340;Vilnelė;Nykštukas;6048991617;Taip;6;0;0;6
12341;Vilnelė;Nykštukas;6054488692;Ne;6;0;0;6
12342;Vilnelė;Nykštukas;8630048961;Ne;0;6;0;6
12343;Vilnelė;Nykštukas;7592040226;Ne;0;8;0;8
12344;Vilnelė;Nykštukas;1515873552;Ne;0;1;0;1
12345;Vilnelė;Nykštukas;5629086127;Ne;1;0;0;1
12346;Vilnelė;Pieštukas;9879688569;Ne;6;1;0;7
12347;Vilnelė;Pieštukas;5473379559;Ne;10;0;0;10
12348;Vilnelė;Pieštukas;3781595939;Ne;0;4;0;4
12349;Vilnelė;Pieštukas;9884955712;Ne;0;2;0;2
12350;Vilnelė;Pieštukas;2479090686;Ne;0;2;0;2
12351;Vilnelė;Pieštukas;3945921490;Ne;0;15;0;15
12352;Vilnelė;Pieštukas;1975954784;Ne;0;5;0;5
12353;Vilnelė;Pieštukas;1730149127;Ne;0;1;0;1
12354;Vilnelė;Pieštukas;5778176840;Ne;0;2;0;2
12355;Vilnelė;Pieštukas;6355912551;Ne;0;6;0;6
12356;Vilnelė;Pieštukas;3811289758;Ne;0;7;0;7
12357;Vilnelė;Pieštukas;3529718234;Ne;0;3;0;3
12358;Vilnelė;Pieštukas;1880318663;Ne;0;9;0;9
12359;Vilnelė;Pieštukas;9589410276;Ne;0;9;0;9
12360;Vilnelė;Pieštukas;4718994967;Ne;0;13;0;13
12361;Vilnelė;Pieštukas;3856917286;Ne;0;11;0;11
12362;Vilnelė;Pieštukas;6132739519;Ne;0;6;0;6
12363;Vilnelė;Pieštukas;3791258264;Ne;0;1;0;1
12364;Vilnelė;Voverytė;7536603663;Ne;0;1;0;1
12365;Vilnelė;Voverytė;7388336851;Ne;0;1;0;1
12366;Vilnelė;Voverytė;8667403338;Ne;0;5;0;5
12367;Vilnelė;Voverytė;7883724600;Ne;0;5;0;5
12368;Vilnelė;Voverytė;4166351390;Ne;0;0;1;1
12369;Vilnelė;Voverytė;1351798589;Ne;0;5;0;5
12370;Vilnelė;Voverytė;9162681538;Ne;0;2;0;2
12371;Vilnelė;Voverytė;3075681823;Ne;0;2;0;2
12372;Vilnelė;Voverytė;2923012145;Ne;9;1;0;10
12373;Vilnelė;Voverytė;2841315531;Ne;0;0;4;4
12374;Vilnelė;Voverytė;9804772168;Ne;0;0;2;2
12375;Vilnelė;Voverytė;1596625263;Ne;0;0;2;2
12376;Vilnelė;Voverytė;7338573817;Ne;0;0;6;6
12377;Vilnelė;Voverytė;8121075430;Ne;0;3;0;3
12378;Vilnelė;Voverytė;1574809879;Ne;0;2;1;3
12379;Vilnelė;Voverytė;6083082959;Ne;0;2;0;2
12380;Vilnelė;Voverytė;2788449626;Ne;4;1;0;5
12381;Vilnelė;Kodėlčiukas;4642378600;Ne;11;0;0;11
12382;Vilnelė;Kodėlčiukas;6618109352;Ne;0;11;0;11
12383;Vilnelė;Kodėlčiukas;6715997340;Ne;3;3;0;6
12384;Vilnelė;Kodėlčiukas;9482133396;Ne;0;0;1;1
12385;Vilnelė;Kodėlčiukas;1580287517;Ne;7;0;0;7
12386;Vilnelė;Kodėlčiukas;5558378376;Taip;0;2;0;2
12387;Vilnelė;Kodėlčiukas;4328263940;Ne;0;4;0;4
12388;Vilnelė;Kodėlčiukas;3056845279;Ne;0;2;0;2
12389;Vilnelė;Kodėlčiukas;9640330864;Ne;2;1;0;3
12390;Vilnelė;Kodėlčiukas;3848720970;Ne;0;0;5;5
12391;Vilnelė;Kodėlčiukas;7833531435;Ne;0;3;0;3
12392;Vilnelė;Kodėlčiukas;5961910077;Ne;5;0;0;5
12393;Vilnelė;Kodėlčiukas;3115242919;Ne;0;1;0;1
12394;Vilnelė;Kodėlčiukas;8543995029;Taip;3;2;0;5
12395;Vilnelė;Kodėlčiukas;9418661965;Ne;0;1;0;1
12396;Vilnelė;Kodėlčiukas;5180951251;Ne;7;2;0;9
12397;Vilnelė;Žirniukas;5612501291;Ne;9;0;1;10
12398;Vilnelė;Žirniukas;2576381995;Ne;6;0;0;6
12399;Vilnelė;Žirniukas;3654833067;Ne;9;1;0;10
12400;Vilnelė;Žirniukas;4322462166;Ne;4;2;3;9
12401;Vilnelė;Žirniukas;9817054571;Ne;1;1;0;2
12402;Vilnelė;Žirniukas;9316933315;Ne;13;0;0;13
12403;Vilnelė;Žirniukas;5960725916;Ne;0;11;0;11
12404;Vilnelė;Žirniukas;8329253118;Ne;0;0;20;20
12405;Vilnelė;Žirniukas;9476510950;Ne;5;2;1;8
12406;Vilnelė;Žirniukas;3234028667;Ne;5;1;0;6
12407;Vilnelė;Žirniukas;6569980514;Ne;8;4;0;12
12408;Vilnelė;Žirniukas;6634526716;Ne;3;6;0;9
12409;Vilnelė;Žirniukas;8848138564;Taip;0;7;0;7
12410;Vilnelė;Žirniukas;5649725693;Ne;0;2;4;6
12411;Vilnelė;Žirniukas;7568755715;Ne;11;2;0;13
12412;Vilnelė;Žirniukas;1371066506;Ne;6;0;0;6
12413;Vilnelė;Žirniukas;4758117005;Taip;6;0;0;6
12414;Vilnelė;Pipiras;9660305163;Ne;0;6;0;6
12415;Vilnelė;Pipiras;2964672357;Ne;7;0;0;7
12416;Vilnelė;Pipiras;1566734465;Ne;0;2;1;3
12417;Vilnelė;Pipiras;9882766915;Ne;0;11;0;11
12418;Vilnelė;Pipiras;9016135318;Ne;0;1;0;1
12419;Vilnelė;Pipiras;8015908754;Ne;0;9;0;9
12420;Vilnelė;Pipiras;7968029402;Ne;0;1;0;1
12421;Vilnelė;Pipiras;7293735126;Ne;5;0;0;5
12422;Vilnelė;Pipiras;9950598582;Taip;10;0;0;10
12423;Vilnelė;Pipiras;5444967820;Ne;3;1;0;4
12424;Vilnelė;Pipiras;3828623778;Ne;2;0;0;2
12425;Vilnelė;Pipiras;5273665901;Ne;0;1;0;1
12426;Vilnelė;Pipiras;5173602064;Ne;0;2;0;2
12427;Vėrinėlis;GAIDELIAI;7069247393;Ne;2;0;0;2
12428;Vėrinėlis;GAIDELIAI;6162461750;Ne;0;0;5;5
12429;Vėrinėlis;GAIDELIAI;3500287869;Ne;7;1;2;10
12430;Vėrinėlis;GAIDELIAI;9370715798;Taip;14;3;0;17
12431;Vėrinėlis;GAIDELIAI;6500266853;Ne;11;0;2;13
12432;Vėrinėlis;GAIDELIAI;5891690000;Ne;15;0;4;19
12433;Vėrinėlis;GAIDELIAI;4401001009;Ne;8;9;0;17
12434;Vėrinėlis;GAIDELIAI;1685329004;Ne;6;10;0;16
12435;Vėrinėlis;GAIDELIAI;4498096701;Ne;10;0;1;11
12436;Vėrinėlis;GAIDELIAI;6055921178;Ne;5;4;0;9
12437;Vėrinėlis;GAIDELIAI;9144004655;Ne;9;0;0;9
12438;Vėrinėlis;GAIDELIAI;8272531606;Ne;9;0;0;9
12439;Vėrinėlis;GAIDELIAI;2114637828;Ne;6;0;2;8
12440;Vėrinėlis;GAIDELIAI;6159725406;Ne;0;0;2;2
12441;Vėrinėlis;GAIDELIAI;1844862699;Ne;0;0;1;1
12442;Vėrinėlis;GAIDELIAI;7455948332;Ne;17;4;0;21
12443;Vėrinėlis;GAIDELIAI;4965735537;Ne;10;0;0;10
12444;Vėrinėlis;SAULUTĖ;7224418233;Ne;16;0;0;16
12445;Vėrinėlis;SAULUTĖ;9612956692;Ne;0;7;0;7
12446;Vėrinėlis;SAULUTĖ;8238013636;Ne;10;0;1;11
12447;Vėrinėlis;SAULUTĖ;7273090217;Ne;0;0;1;1
12448;Vėrinėlis;SAULUTĖ;2337883071;Ne;0;0;6;6
12449;Vėrinėlis;SAULUTĖ;3882915774;Ne;0;6;0;6
12450;Vėrinėlis;SAULUTĖ;7440020169;Ne;0;9;0;9
12451;Vėrinėlis;SAULUTĖ;7913975075;Ne;0;8;0;8
12452;Vėrinėlis;SAULUTĖ;9967737864;Ne;16;0;0;16
12453;Vėrinėlis;SAULUTĖ;7364698713;Ne;0;0;4;4
12454;Vėrinėlis;SAULUTĖ;9009344779;Ne;7;0;0;7
12455;Vėrinėlis;SAULUTĖ;4059906525;Ne;0;0;1;1
12456;Vėrinėlis;SAULUTĖ;3832662507;Ne;5;1;0;6
12457;Vėrinėlis;SAULUTĖ;3291922401;Ne;0;4;0;4
12458;Vėrinėlis;SAULUTĖ;1007705906;Ne;13;0;0;13
12459;Vėrinėlis;SAULUTĖ;9289003583;Ne;0;1;0;1
12460;Vėrinėlis;SAULUTĖ;1684203955;Ne;0;1;0;1
12461;Vėrinėlis;SAULUTĖ;5942475043;Ne;0;4;0;4
12462;Vėrinėlis;SAULUTĖ;9310629340;Ne;7;0;4;11
12463;Vėrinėlis;NYKŠTUKAI;8755231814;Ne;0;0;4;4
12464;Vėrinėlis;NYKŠTUKAI;9604483237;Ne;0;0;12;12
12465;Vėrinėlis;NYKŠTUKAI;6220653152;Ne;8;3;0;11
12466;Vėrinėlis;NYKŠTUKAI;6644892686;Ne;0;4;0;4
12467;Vėrinėlis;NYKŠTUKAI;7981261038;Ne;10;1;0;11
12468;Vėrinėlis;NYKŠTUKAI;1395590011;Ne;0;2;2;4
12469;Vėrinėlis;NYKŠTUKAI;19865450007;Ne;0;3;0;3
12470;Vėrinėlis;NYKŠTUKAI;3975934329;Ne;0;0;2;2
12471;Vėrinėlis;NYKŠTUKAI;5511584499;Ne;0;0;2;2
12472;Vėrinėlis;NYKŠTUKAI;4958359640;Ne;11;0;0;11
12473;Vėrinėlis;NYKŠTUKAI;9751037428;Ne;0;3;0;3
12474;Vėrinėlis;NYKŠTUKAI;4089567420;Ne;5;0;1;6
12475;Vėrinėlis;NYKŠTUKAI;8579819581;Ne;14;2;0;16
12476;Vėrinėlis;NYKŠTUKAI;5209398043;Ne;5;3;0;8
12477;Vėrinėlis;NYKŠTUKAI;8824435889;Ne;0;0;2;2
12478;Vėrinėlis;BURATINAS;7093959212;Ne;0;1;0;1
12479;Vėrinėlis;BURATINAS;7078114492;Ne;0;0;3;3
12480;Vėrinėlis;BURATINAS;6280508974;Ne;0;0;3;3
12481;Vėrinėlis;BURATINAS;4666918175;Ne;0;1;0;1
12482;Vėrinėlis;BURATINAS;2774618380;Ne;0;6;0;6
12483;Vėrinėlis;BURATINAS;2857591912;Taip;0;1;0;1
12484;Vėrinėlis;BURATINAS;5429955166;Ne;0;3;0;3
12485;Vėrinėlis;BURATINAS;5429372946;Ne;6;1;0;7
12486;Vėrinėlis;BURATINAS;4183077476;Ne;15;4;0;19
12487;Vėrinėlis;BURATINAS;2529641529;Taip;0;11;0;11
12488;Vėrinėlis;BURATINAS;2467700639;Ne;15;1;0;16
12489;Vėrinėlis;BURATINAS;6136232912;Ne;19;5;0;24
12490;Vėrinėlis;BURATINAS;7092421890;Ne;1;0;0;1
12491;Vėrinėlis;BURATINAS;6058712578;Ne;0;1;0;1
12492;Vėrinėlis;BURATINAS;1164396960;Ne;6;6;0;12
12493;Vėrinėlis;BURATINAS;6413701823;Ne;7;3;0;10
12494;Vėrinėlis;BURATINAS;2364117224;Ne;0;5;0;5
12495;Vėrinėlis;BURATINAS;5206206080;Taip;0;12;0;12
12496;Vėrinėlis;BURATINAS;3947650381;Ne;1;7;0;8
12497;Vėrinėlis;GINTARĖLIAI;5987029334;Taip;0;0;28;28
12498;Vėrinėlis;GINTARĖLIAI;8372084728;Ne;20;0;0;20
12499;Vėrinėlis;GINTARĖLIAI;7432965615;Ne;7;2;0;9
12500;Vėrinėlis;GINTARĖLIAI;3457199716;Ne;0;1;0;1
12501;Vėrinėlis;GINTARĖLIAI;7743951577;Taip;11;0;0;11
12502;Vėrinėlis;GINTARĖLIAI;2006432327;Ne;20;0;0;20
12503;Vėrinėlis;GINTARĖLIAI;6785519869;Taip;20;0;0;20
12504;Vėrinėlis;GINTARĖLIAI;3363388500;Ne;13;2;0;15
12505;Vėrinėlis;GINTARĖLIAI;1872534206;Taip;0;2;5;7
12506;Vėrinėlis;GINTARĖLIAI;9171173116;Ne;6;0;0;6
12507;Vėrinėlis;GINTARĖLIAI;3192625484;Ne;14;0;0;14
12508;Vėrinėlis;GINTARĖLIAI;8343196405;Ne;10;2;5;17
12509;Vėrinėlis;GINTARĖLIAI;2284527544;Ne;4;0;0;4
12510;Vėrinėlis;GINTARĖLIAI;5644772729;Ne;0;1;0;1
12511;Vėrinėlis;GINTARĖLIAI;4034106321;Ne;6;1;0;7
12512;Vėrinėlis;RAMUNĖLĖS;4415030161;Taip;3;7;0;10
12513;Vėrinėlis;RAMUNĖLĖS;8620836106;Ne;0;1;3;4
12514;Vėrinėlis;RAMUNĖLĖS;5003344894;Ne;0;1;1;2
12515;Vėrinėlis;RAMUNĖLĖS;8922728881;Ne;0;1;0;1
12516;Vėrinėlis;RAMUNĖLĖS;5434506594;Ne;0;1;0;1
12517;Vėrinėlis;RAMUNĖLĖS;5041189990;Taip;0;7;0;7
12518;Vėrinėlis;RAMUNĖLĖS;3130841241;Ne;0;1;0;1
12519;Vėrinėlis;RAMUNĖLĖS;9798993200;Ne;0;1;0;1
12520;Vėrinėlis;RAMUNĖLĖS;6435612222;Taip;0;3;0;3
12521;Vėrinėlis;RAMUNĖLĖS;3316897176;Taip;0;11;0;11
12522;Vėrinėlis;RAMUNĖLĖS;1386916991;Taip;0;6;0;6
12523;Vėrinėlis;RAMUNĖLĖS;2090334618;Taip;15;5;0;20
12524;Vėrinėlis;RAMUNĖLĖS;1894717954;Taip;0;1;0;1
12525;Vėrinėlis;RAMUNĖLĖS;3810261864;Taip;0;6;0;6
12526;Vėrinėlis;RAMUNĖLĖS;4191386053;Taip;6;2;0;8
12527;Vėrinėlis;KODELČIUKŲ;7070058961;Ne;0;7;0;7
12528;Vėrinėlis;KODELČIUKŲ;3308843618;Ne;0;7;0;7
12529;Vėrinėlis;KODELČIUKŲ;1535567719;Ne;9;5;0;14
12530;Vėrinėlis;KODELČIUKŲ;8755941866;Ne;1;1;0;2
12531;Vėrinėlis;KODELČIUKŲ;42298331453;Ne;0;2;0;2
12532;Vėrinėlis;KODELČIUKŲ;8709714647;Ne;0;0;8;8
12533;Vėrinėlis;KODELČIUKŲ;6108187043;Ne;0;4;0;4
12534;Vėrinėlis;KODELČIUKŲ;9119967823;Ne;1;0;0;1
12535;Vėrinėlis;KODELČIUKŲ;4067153819;Ne;0;0;3;3
12536;Vėrinėlis;KODELČIUKŲ;8885866108;Ne;0;0;3;3
12537;Vėrinėlis;KODELČIUKŲ;7634939364;Ne;0;3;0;3
12538;Vėrinėlis;KODELČIUKŲ;3049346950;Ne;6;0;11;17
12539;Vėrinėlis;KODELČIUKŲ;8652292752;Ne;3;0;2;5
12540;Vėrinėlis;KODELČIUKŲ;3729926575;Ne;12;0;0;12
12541;Vėrinėlis;KODELČIUKŲ;7167034587;Ne;0;3;0;3
12542;Vėrinėlis;KODELČIUKŲ;9511678036;Ne;0;0;1;1
12543;Vėrinėlis;KODELČIUKŲ;3369668445;Ne;0;1;0;1
12544;Vėrinėlis;KODELČIUKŲ;8728166391;Ne;5;0;1;6
12545;Vėrinėlis;KODELČIUKŲ;5720076968;Ne;6;6;0;12
12546;Vėrinėlis;KODELČIUKŲ;8195455092;Ne;0;0;3;3
12547;Vėrinėlis;ŽIRNIUKAI;1769852084;Ne;2;6;0;8
12548;Vėrinėlis;ŽIRNIUKAI;4981127515;Ne;0;0;3;3
12549;Vėrinėlis;ŽIRNIUKAI;8329989952;Ne;0;0;1;1
12550;Vėrinėlis;ŽIRNIUKAI;3202518504;Ne;0;0;1;1
12551;Vėrinėlis;ŽIRNIUKAI;4752902173;Ne;5;0;2;7
12552;Vėrinėlis;ŽIRNIUKAI;7237945125;Ne;3;1;1;5
12553;Vėrinėlis;ŽIRNIUKAI;1736733257;Ne;9;0;0;9
12554;Vėrinėlis;ŽIRNIUKAI;2687583764;Ne;10;0;1;11
12555;Vėrinėlis;ŽIRNIUKAI;2633143128;Ne;0;0;1;1
12556;Vėrinėlis;ŽIRNIUKAI;9419245081;Ne;9;1;0;10
12557;Vėrinėlis;ŽIRNIUKAI;6377447141;Ne;14;0;1;15
12558;Vėrinėlis;ŽIRNIUKAI;7371908331;Ne;4;0;3;7
12559;Vėrinėlis;ŽIRNIUKAI;6392625405;Ne;0;14;0;14
12560;Vėrinėlis;ŽIRNIUKAI;2732572235;Ne;5;0;0;5
12561;Vėrinėlis;ŽIRNIUKAI;8483525051;Ne;8;0;2;10
12562;Vėrinėlis;ŽIRNIUKAI;8397025332;Ne;0;4;0;4
12563;Vėrinėlis;ŽIRNIUKAI;6576726481;Ne;0;4;0;4
12564;Vėrinėlis;VARPELIAI;7416041207;Ne;0;2;0;2
12565;Vėrinėlis;VARPELIAI;8655158155;Ne;0;4;0;4
12566;Vėrinėlis;VARPELIAI;6177784856;Ne;0;1;0;1
12567;Vėrinėlis;VARPELIAI;9388153932;Ne;0;0;16;16
12568;Vėrinėlis;VARPELIAI;6362125404;Ne;10;4;0;14
12569;Vėrinėlis;VARPELIAI;7216867683;Ne;0;1;0;1
12570;Vėrinėlis;VARPELIAI;8336694468;Ne;4;0;0;4
12571;Vėrinėlis;VARPELIAI;2731207996;Ne;0;0;4;4
12572;Vėrinėlis;VARPELIAI;9522506115;Ne;0;6;0;6
12573;Vėrinėlis;VARPELIAI;2561255096;Ne;20;0;0;20
12574;Vėrinėlis;VARPELIAI;5821107898;Ne;12;0;0;12
12575;Vėrinėlis;VARPELIAI;9351658311;Taip;0;10;0;10
12576;Vėrinėlis;VARPELIAI;3392458614;Ne;5;2;0;7
12577;Vėrinėlis;VARPELIAI;5447760434;Ne;0;1;0;1
12578;Vėrinėlis;BORUŽĖLĖS;8759487574;Ne;0;3;0;3
12579;Vėrinėlis;BORUŽĖLĖS;1910385020;Ne;0;1;0;1
12580;Vėrinėlis;BORUŽĖLĖS;2078857084;Ne;9;0;1;10
12581;Vėrinėlis;BORUŽĖLĖS;3934652683;Ne;1;0;2;3
12582;Vėrinėlis;BORUŽĖLĖS;6904733283;Ne;5;0;2;7
12583;Vėrinėlis;BORUŽĖLĖS;4446546335;Ne;0;0;4;4
12584;Vėrinėlis;BORUŽĖLĖS;3718510933;Ne;0;11;0;11
12585;Vėrinėlis;BORUŽĖLĖS;8904833339;Ne;15;0;0;15
12586;Vėrinėlis;BORUŽĖLĖS;3312501759;Ne;15;0;0;15
12587;Vėrinėlis;BORUŽĖLĖS;9217188911;Ne;0;20;0;20
12588;Vėrinėlis;BORUŽĖLĖS;7414937335;Ne;10;2;0;12
12589;Vėrinėlis;BORUŽĖLĖS;2574507205;Ne;8;0;0;8
12590;Vėrinėlis;BORUŽĖLĖS;6671382987;Ne;10;0;0;10
12591;Vėrinėlis;BORUŽĖLĖS;4852563692;Ne;0;0;1;1
12592;Vėrinėlis;BORUŽĖLĖS;5865529907;Ne;18;0;1;19
12593;Vėrinėlis;BORUŽĖLĖS;9613642664;Ne;0;12;0;12
12594;Vėrinėlis;BORUŽĖLĖS;2467242845;Ne;0;6;0;6
12595;Vėrinėlis;SVEIKUOLIAI;1909742394;Ne;5;0;0;5
12596;Vėrinėlis;SVEIKUOLIAI;3070965434;Ne;0;1;1;2
12597;Vėrinėlis;SVEIKUOLIAI;3563114419;Ne;0;1;0;1
12598;Vėrinėlis;SVEIKUOLIAI;3973272659;Ne;6;0;0;6
12599;Vėrinėlis;SVEIKUOLIAI;8716965452;Ne;10;1;0;11
12600;Vėrinėlis;SVEIKUOLIAI;7584124339;Ne;2;1;0;3
12601;Vėrinėlis;SVEIKUOLIAI;9352630743;Ne;0;1;2;3
12602;Vėrinėlis;SVEIKUOLIAI;4859330774;Ne;10;0;0;10
12603;Vėrinėlis;SVEIKUOLIAI;8543081245;Ne;0;6;0;6
12604;Vėrinėlis;SVEIKUOLIAI;1800434426;Ne;1;0;0;1
12605;Vėrinėlis;SVEIKUOLIAI;5614185158;Ne;6;0;0;6
12606;Vėrinėlis;SVEIKUOLIAI;5539714292;Taip;0;5;0;5
12607;Vėrinėlis;SVEIKUOLIAI;2516474825;Ne;0;0;1;1
12608;Vėrinėlis;SVEIKUOLIAI;9058127692;Ne;0;1;0;1
12609;Vėrinėlis;SVEIKUOLIAI;1278914183;Ne;9;0;3;12
12610;Vėrinėlis;SVEIKUOLIAI;7573209012;Ne;5;0;0;5
12611;Vėrinėlis;SVEIKUOLIAI;2015928440;Ne;11;0;0;11
12612;Vėrinėlis;ŠIRDELĖS;7734163541;Ne;0;0;3;3
12613;Vėrinėlis;ŠIRDELĖS;7811024382;Taip;4;0;0;4
12614;Vėrinėlis;ŠIRDELĖS;4378592116;Ne;9;0;2;11
12615;Vėrinėlis;ŠIRDELĖS;1841277321;Ne;5;1;0;6
12616;Vėrinėlis;ŠIRDELĖS;5588658517;Ne;0;1;0;1
12617;Vėrinėlis;ŠIRDELĖS;5653635907;Ne;0;5;0;5
12618;Vėrinėlis;ŠIRDELĖS;1152010178;Ne;12;0;0;12
12619;Vėrinėlis;ŠIRDELĖS;2038169885;Ne;1;8;0;9
12620;Vėrinėlis;ŠIRDELĖS;9375922889;Taip;5;5;0;10
12621;Vėrinėlis;ŠIRDELĖS;5813009126;Ne;13;0;0;13
12622;Vėrinėlis;ŠIRDELĖS;3511809411;Ne;6;0;0;6
12623;Vėrinėlis;ŠIRDELĖS;3535652648;Ne;4;0;2;6
12624;Vėrinėlis;ŠIRDELĖS;9217815657;Ne;13;0;0;13
12625;Vėrinėlis;ŠIRDELĖS;4403875733;Ne;0;0;1;1
12626;Vėrinėlis;ŠIRDELĖS;4700093328;Ne;10;5;1;16
12627;Vėrinėlis;ŠIRDELĖS;1939318286;Ne;0;2;0;2
12628;Vėrinėlis;ŠIRDELĖS;7361319518;Ne;8;0;1;9
12629;Vėrinėlis;ŠIRDELĖS;2847839917;Taip;14;2;0;16
12630;Vėrinėlis;ŠIRDELĖS;6905591549;Ne;5;1;0;6
12631;Viltenė;Drugeliai;3625763429;Ne;7;0;0;7
12632;Viltenė;Drugeliai;2392304909;Ne;9;0;0;9
12633;Viltenė;Drugeliai;5781655552;Ne;15;8;0;23
12634;Viltenė;Drugeliai;2410868015;Ne;0;12;0;12
12635;Viltenė;Drugeliai;8679787688;Ne;6;0;0;6
12636;Viltenė;Drugeliai;4616047113;Ne;7;1;0;8
12637;Viltenė;Drugeliai;6810811656;Ne;0;2;0;2
12638;Viltenė;Drugeliai;3905014810;Ne;0;8;0;8
12639;Viltenė;Drugeliai;4121448859;Ne;6;0;0;6
12640;Viltenė;Drugeliai;9157616307;Ne;19;0;0;19
12641;Viltenė;Drugeliai;9476132305;Ne;14;0;0;14
12642;Viltenė;Drugeliai;3052677157;Ne;0;1;0;1
12643;Viltenė;Drugeliai;5522245968;Ne;6;2;0;8
12644;Viltenė;Drugeliai;5552217000;Ne;0;6;0;6
12645;Viltenė;Drugeliai;9756519374;Ne;0;7;0;7
12646;Viltenė;Drugeliai;8527270437;Ne;10;0;0;10
12647;Viltenė;Drugeliai;4195708756;Ne;9;0;0;9
12648;Viltenė;Drugeliai;1081603034;Ne;19;0;0;19
12649;Viltenė;Drugeliai;7500965165;Ne;0;2;0;2
12650;Viltenė;Bitučių;2846574130;Ne;6;7;0;13
12651;Viltenė;Bitučių;8336855920;Taip;0;9;0;9
12652;Viltenė;Bitučių;2656363650;Ne;3;0;0;3
12653;Viltenė;Bitučių;2841144656;Ne;5;0;0;5
12654;Viltenė;Bitučių;7810374329;Ne;5;4;0;9
12655;Viltenė;Bitučių;4724382069;Ne;14;1;0;15
12656;Viltenė;Bitučių;4001205912;Ne;7;1;0;8
12657;Viltenė;Bitučių;7266522399;Ne;0;3;0;3
12658;Viltenė;Bitučių;9095458948;Ne;15;0;0;15
12659;Viltenė;Bitučių;4661430937;Ne;0;4;0;4
12660;Viltenė;Bitučių;5241075224;Taip;10;2;0;12
12661;Viltenė;Boružėlių;6642790962;Ne;16;0;0;16
12662;Viltenė;Boružėlių;9572407405;Ne;0;13;0;13
12663;Viltenė;Boružėlių;8473588098;Ne;8;5;0;13
12664;Viltenė;Boružėlių;3995418079;Ne;5;0;0;5
12665;Viltenė;Boružėlių;1399653129;Ne;0;4;0;4
12666;Viltenė;Boružėlių;7526555727;Ne;8;0;0;8
12667;Viltenė;Boružėlių;5379804362;Ne;0;5;0;5
12668;Viltenė;Boružėlių;1936628249;Ne;0;2;0;2
12669;Viltenė;Boružėlių;4003018966;Ne;0;2;0;2
12670;Viltenė;Boružėlių;7912396297;Ne;0;2;0;2
12671;Viltenė;Boružėlių;4036109404;Ne;2;0;0;2
12672;Viltenė;Boružėlių;4604298036;Ne;6;3;0;9
12673;Viltenė;Boružėlių;6621273812;Ne;0;1;0;1
12674;Viltenė;Boružėlių;2383607612;Taip;13;3;0;16
12675;Viltenė;Gandriukų;6481491422;Ne;11;0;0;11
12676;Viltenė;Gandriukų;2452782594;Ne;0;11;0;11
12677;Viltenė;Gandriukų;1126409020;Ne;0;1;0;1
12678;Viltenė;Gandriukų;2884698447;Ne;0;4;0;4
12679;Viltenė;Gandriukų;6060648988;Ne;6;0;0;6
12680;Viltenė;Gandriukų;1840626621;Ne;0;3;0;3
12681;Viltenė;Gandriukų;8549631247;Ne;9;0;0;9
12682;Viltenė;Gandriukų;7796422726;Ne;0;1;0;1
12683;Viltenė;Gandriukų;2815105107;Ne;0;1;0;1
12684;Viltenė;Gandriukų;6511850468;Ne;8;0;0;8
12685;Viltenė;Gandriukų;5850652322;Ne;0;1;0;1
12686;Viltenė;Gandriukų;3073228245;Ne;20;0;0;20
12687;Viltenė;Gandriukų;4468743044;Ne;10;0;0;10
12688;Viltenė;Gandriukų;6355857716;Ne;0;0;4;4
12689;Viltenė;Gandriukų;5929135840;Ne;4;1;0;5
12690;Viltenė;Gandriukų;6473925760;Ne;7;0;0;7
12691;Viltenė;Gandriukų;8458769051;Ne;0;0;3;3
12692;Viltenė;Aitvariukai;5083515613;Ne;0;1;0;1
12693;Viltenė;Aitvariukai;2137929911;Ne;8;0;0;8
12694;Viltenė;Aitvariukai;9185054066;Ne;6;1;0;7
12695;Viltenė;Aitvariukai;2036902795;Ne;3;2;0;5
12696;Viltenė;Aitvariukai;5599943846;Ne;0;6;0;6
12697;Viltenė;Aitvariukai;6721689684;Ne;9;0;0;9
12698;Viltenė;Aitvariukai;6296509460;Ne;0;2;0;2
12699;Viltenė;Aitvariukai;9101795131;Ne;0;2;0;2
12700;Viltenė;Aitvariukai;2976705872;Ne;11;3;0;14
12701;Viltenė;Aitvariukai;2192086488;Ne;3;4;0;7
12702;Viltenė;Aitvariukai;2026654467;Ne;0;4;0;4
12703;Viltenė;Aitvariukai;4641365031;Ne;5;4;0;9
12704;Viltenė;Aitvariukai;7277455268;Ne;0;17;0;17
12705;Viltenė;Aitvariukai;3245284852;Ne;2;0;0;2
12706;Viltenė;Aitvariukai;2786572522;Ne;0;6;0;6
12707;Viltenė;Aitvariukai;6171399579;Ne;5;1;0;6
12708;Viltenė;Geniukų;1822220265;Ne;0;1;0;1
12709;Viltenė;Geniukų;1423254631;Ne;0;4;0;4
12710;Viltenė;Geniukų;3002690526;Ne;0;2;0;2
12711;Viltenė;Geniukų;6276349499;Ne;0;1;0;1
12712;Viltenė;Geniukų;1672091332;Ne;0;1;0;1
12713;Viltenė;Geniukų;3018271511;Ne;14;2;0;16
12714;Viltenė;Geniukų;49998813869;Ne;0;4;0;4
12715;Viltenė;Geniukų;3389110405;Ne;0;4;0;4
12716;Viltenė;Geniukų;4319685140;Ne;7;0;0;7
12717;Viltenė;Geniukų;8125023386;Ne;0;1;0;1
12718;Viltenė;Geniukų;9035687504;Ne;0;1;0;1
12719;Viltenė;Geniukų;3746923185;Ne;6;1;0;7
12720;Viltenė;Geniukų;1557503831;Ne;0;5;0;5
12721;Viltenė;Saulutės;2044754943;Ne;0;2;0;2
12722;Viltenė;Saulutės;1615415742;Ne;0;1;0;1
12723;Viltenė;Saulutės;6664059418;Ne;0;6;0;6
12724;Viltenė;Saulutės;2141002432;Ne;0;6;0;6
12725;Viltenė;Saulutės;1362308882;Ne;1;2;0;3
12726;Viltenė;Saulutės;8920533673;Ne;0;1;0;1
12727;Viltenė;Saulutės;5024192785;Ne;0;7;0;7
12728;Viltenė;Saulutės;1918867591;Ne;6;4;0;10
12729;Viltenė;Saulutės;7559243300;Ne;10;2;0;12
12730;Viltenė;Saulutės;8512665706;Ne;3;0;0;3
12731;Viltenė;Saulutės;3560474943;Ne;0;6;0;6
12732;Viltenė;Saulutės;1252657362;Ne;13;2;0;15
12733;Viltenė;Saulutės;2559945034;Ne;0;1;0;1
12734;Viltenė;Saulutės;9055821628;Ne;0;1;0;1
12735;Viltenė;Saulutės;9858998005;Ne;0;4;0;4
12736;Viltenė;Saulutės;7726650894;Ne;0;3;0;3
12737;Viltenė;Saulutės;3709362712;Ne;0;1;0;1
12738;Viltenė;Lapiukų;2034259692;Ne;6;2;0;8
12739;Viltenė;Lapiukų;3473533533;Ne;6;5;0;11
12740;Viltenė;Lapiukų;8696698257;Ne;2;0;0;2
12741;Viltenė;Lapiukų;8248514570;Ne;0;6;0;6
12742;Viltenė;Lapiukų;2878124826;Taip;7;0;0;7
12743;Viltenė;Lapiukų;2660622296;Ne;0;1;0;1
12744;Viltenė;Lapiukų;4550915388;Ne;0;7;0;7
12745;Viltenė;Lapiukų;8122878153;Ne;0;0;1;1
12746;Viltenė;Lapiukų;9573891616;Ne;0;8;0;8
12747;Viltenė;Lapiukų;4243501722;Ne;0;5;0;5
12748;Viltenė;Lapiukų;6429905246;Ne;4;3;0;7
12749;Viltenė;Lapiukų;6070264006;Ne;0;5;0;5
12750;Viltenė;Lapiukų;8187712849;Ne;10;0;0;10
12751;Viltenė;Lapiukų;3679704404;Ne;6;2;0;8
12752;Viltenė;Lapiukų;1507287948;Ne;0;0;1;1
12753;Viltenė;Lapiukų;9846205631;Ne;10;0;1;11
12754;Viltenė;Voveriukai;6888346135;Ne;8;8;0;16
12755;Viltenė;Voveriukai;5816623708;Ne;0;20;0;20
12756;Viltenė;Voveriukai;5611839058;Ne;0;1;0;1
12757;Viltenė;Voveriukai;4414192600;Ne;0;1;12;13
12758;Viltenė;Voveriukai;2483760198;Ne;6;0;0;6
12759;Viltenė;Voveriukai;8341211836;Ne;20;0;0;20
12760;Viltenė;Voveriukai;6954065006;Ne;20;0;0;20
12761;Viltenė;Voveriukai;6741521720;Ne;9;2;0;11
12762;Viltenė;Voveriukai;2642080849;Ne;0;1;1;2
12763;Viltenė;Voveriukai;7322841332;Ne;6;1;5;12
12764;Viltenė;Voveriukai;1888167096;Ne;0;1;4;5
12765;Viltenė;Voveriukai;3291926243;Ne;8;4;0;12
12766;Viltenė;Voveriukai;2013415571;Ne;0;1;2;3
12767;Viltenė;Voveriukai;2894570917;Taip;0;1;0;1
12768;Viltenė;Voveriukai;7158824421;Ne;0;6;0;6
12769;Viltenė;Kiškučiai;6595715908;Ne;0;2;0;2
12770;Viltenė;Kiškučiai;3347380524;Ne;7;2;0;9
12771;Viltenė;Kiškučiai;1641406030;Taip;9;0;0;9
12772;Viltenė;Kiškučiai;2192673126;Ne;0;2;0;2
12773;Viltenė;Kiškučiai;3157417614;Ne;10;1;0;11
12774;Viltenė;Kiškučiai;5974408492;Ne;9;0;0;9
12775;Viltenė;Kiškučiai;9578037239;Ne;5;3;0;8
12776;Viltenė;Kiškučiai;4615393852;Ne;0;2;0;2
12777;Viltenė;Kiškučiai;2903596382;Ne;8;0;0;8
12778;Viltenė;Kiškučiai;8091905944;Ne;13;0;0;13
12779;Viltenė;Kiškučiai;7314937470;Ne;12;1;0;13
12780;Viltenė;Kiškučiai;8150583354;Ne;14;0;0;14
12781;Viltenė;Kiškučiai;9760364123;Ne;4;0;0;4
12782;Viltenė;Kiškučiai;6021086235;Ne;21;0;0;21
12783;Viltenė;Kiškučiai;1760899500;Ne;4;3;0;7
12784;Viltenė;Kiškučiai;9862698928;Ne;6;0;0;6
12785;Viltenė;Kiškučiai;3501209955;Ne;9;1;0;10
12786;Viltenė;Nykštukų;7993258845;Ne;9;0;0;9
12787;Viltenė;Nykštukų;4981225829;Ne;10;2;0;12
12788;Viltenė;Nykštukų;9424773418;Ne;10;0;0;10
12789;Viltenė;Nykštukų;3343045604;Ne;16;0;0;16
12790;Viltenė;Nykštukų;4537287677;Ne;11;0;0;11
12791;Viltenė;Nykštukų;3306285115;Ne;6;1;0;7
12792;Viltenė;Nykštukų;6992120038;Ne;5;1;0;6
12793;Viltenė;Nykštukų;7331321780;Ne;9;1;0;10
12794;Viltenė;Nykštukų;5707049797;Ne;0;0;2;2
12795;Viltenė;Nykštukų;2036857372;Ne;8;0;0;8
12796;Viltenė;Nykštukų;3853518656;Ne;10;0;0;10
12797;Viltenė;Nykštukų;9288406881;Ne;6;2;0;8
12798;Viltenė;Nykštukų;9263941853;Ne;13;1;0;14
12799;Viltenė;Nykštukų;9582577013;Ne;10;1;0;11
12800;Viltenė;Triušiukai;8278572246;Ne;8;0;0;8
12801;Viltenė;Triušiukai;1587868835;Ne;8;1;0;9
12802;Viltenė;Triušiukai;9819729046;Taip;5;7;0;12
12803;Viltenė;Triušiukai;8258247750;Ne;14;0;0;14
12804;Viltenė;Triušiukai;6635474168;Ne;9;2;0;11
12805;Viltenė;Triušiukai;7754951374;Ne;10;0;1;11
12806;Viltenė;Triušiukai;7145240197;Ne;8;0;0;8
12807;Viltenė;Triušiukai;7058586628;Ne;8;1;0;9
12808;Viltenė;Triušiukai;7005219570;Taip;9;1;0;10
12809;Viltenė;Triušiukai;4552355700;Ne;0;1;0;1
12810;Viltenė;Triušiukai;2850146424;Ne;2;3;0;5
12811;Viltenė;Triušiukai;1318750938;Ne;0;2;0;2
12812;Viltenė;Triušiukai;1788524515;Ne;5;4;0;9
12813;Voveraitė;ŽVIRBLIUKŲ;6684234832;Ne;0;8;10;18
12814;Voveraitė;ŽVIRBLIUKŲ;8119493388;Ne;0;2;0;2
12815;Voveraitė;ŽVIRBLIUKŲ;9715405072;Ne;0;1;0;1
12816;Voveraitė;ŽVIRBLIUKŲ;6959751328;Ne;3;0;4;7
12817;Voveraitė;ŽVIRBLIUKŲ;8803052781;Ne;0;0;6;6
12818;Voveraitė;ŽVIRBLIUKŲ;8257748589;Ne;0;1;0;1
12819;Voveraitė;ŽVIRBLIUKŲ;1522307865;Ne;0;0;2;2
12820;Voveraitė;ŽVIRBLIUKŲ;3811230983;Ne;0;0;13;13
12821;Voveraitė;ŽVIRBLIUKŲ;2142507659;Ne;4;0;1;5
12822;Voveraitė;ŽVIRBLIUKŲ;3247101840;Ne;0;0;4;4
12823;Voveraitė;ŽVIRBLIUKŲ;6643600680;Ne;5;0;5;10
12824;Voveraitė;ŽVIRBLIUKŲ;3877673172;Ne;1;1;0;2
12825;Voveraitė;ŽVIRBLIUKŲ;7008576999;Ne;5;1;0;6
12826;Voveraitė;ŽVIRBLIUKŲ;2716400502;Ne;5;0;0;5
12827;Voveraitė;ŽVIRBLIUKŲ;9117809080;Taip;0;1;2;3
12828;Voveraitė;ŽVIRBLIUKŲ;7861722125;Ne;9;0;2;11
12829;Voveraitė;VOVERIUKŲ;9195700962;Ne;8;4;0;12
12830;Voveraitė;VOVERIUKŲ;5138855000;Ne;4;0;0;4
12831;Voveraitė;VOVERIUKŲ;1340379090;Ne;0;1;0;1
12832;Voveraitė;VOVERIUKŲ;9912862474;Ne;0;3;0;3
12833;Voveraitė;VOVERIUKŲ;1960385335;Taip;9;0;0;9
12834;Voveraitė;VOVERIUKŲ;2594535017;Ne;8;2;0;10
12835;Voveraitė;VOVERIUKŲ;4563198733;Ne;0;3;0;3
12836;Voveraitė;VOVERIUKŲ;8373093305;Ne;6;1;0;7
12837;Voveraitė;VOVERIUKŲ;9514425475;Ne;0;2;0;2
12838;Voveraitė;VOVERIUKŲ;6891841301;Ne;0;9;0;9
12839;Voveraitė;VOVERIUKŲ;5935777154;Ne;1;1;0;2
12840;Voveraitė;VOVERIUKŲ;6007396459;Ne;8;0;0;8
12841;Voveraitė;VOVERIUKŲ;4054841724;Ne;5;7;0;12
12842;Voveraitė;VOVERIUKŲ;5956830012;Ne;1;5;0;6
12843;Voveraitė;VOVERIUKŲ;8344323109;Ne;0;1;0;1
12844;Voveraitė;VOVERIUKŲ;1141304286;Taip;1;0;0;1
12845;Voveraitė;VOVERIUKŲ;1663784931;Ne;5;0;0;5
12846;Voveraitė;VOVERIUKŲ;3276295199;Ne;1;2;0;3
12847;Voveraitė;VOVERIUKŲ;6113913885;Ne;1;1;0;2
12848;Voveraitė;KIŠKUČIŲ;4478984171;Ne;0;5;0;5
12849;Voveraitė;KIŠKUČIŲ;3736638759;Ne;4;1;0;5
12850;Voveraitė;KIŠKUČIŲ;9011096222;Ne;5;0;15;20
12851;Voveraitė;KIŠKUČIŲ;6261152304;Ne;0;2;0;2
12852;Voveraitė;KIŠKUČIŲ;8220437514;Ne;5;2;0;7
12853;Voveraitė;KIŠKUČIŲ;4060906360;Ne;0;1;0;1
12854;Voveraitė;KIŠKUČIŲ;5069929376;Ne;3;2;0;5
12855;Voveraitė;KIŠKUČIŲ;7379045686;Ne;0;5;0;5
12856;Voveraitė;KIŠKUČIŲ;1961699588;Ne;10;0;0;10
12857;Voveraitė;KIŠKUČIŲ;1979839656;Ne;0;1;0;1
12858;Voveraitė;KIŠKUČIŲ;9599137158;Ne;5;0;15;20
12859;Voveraitė;KIŠKUČIŲ;8121423914;Ne;4;0;0;4
12860;Voveraitė;KIŠKUČIŲ;4379372200;Ne;0;2;0;2
12861;Voveraitė;KIŠKUČIŲ;8528435385;Ne;10;0;0;10
12862;Voveraitė;KIŠKUČIŲ;8937070276;Ne;3;0;0;3
12863;Voveraitė;KIŠKUČIŲ;3859125174;Taip;8;1;0;9
12864;Voveraitė;KODĖLČIUKŲ;7868415893;Ne;1;0;0;1
12865;Voveraitė;KODĖLČIUKŲ;3274422598;Ne;5;1;1;7
12866;Voveraitė;KODĖLČIUKŲ;8438808999;Ne;0;2;0;2
12867;Voveraitė;KODĖLČIUKŲ;8818603905;Ne;5;0;3;8
12868;Voveraitė;KODĖLČIUKŲ;9397887760;Ne;0;2;2;4
12869;Voveraitė;KODĖLČIUKŲ;4151144278;Ne;0;0;2;2
12870;Voveraitė;KODĖLČIUKŲ;5598685365;Ne;0;7;0;7
12871;Voveraitė;KODĖLČIUKŲ;1482908802;Ne;3;0;2;5
12872;Voveraitė;KODĖLČIUKŲ;9887747925;Ne;0;0;1;1
12873;Voveraitė;KODĖLČIUKŲ;7605427741;Ne;4;3;0;7
12874;Voveraitė;KODĖLČIUKŲ;1046297151;Ne;0;3;0;3
12875;Voveraitė;KODĖLČIUKŲ;4996778855;Ne;0;3;0;3
12876;Voveraitė;KODĖLČIUKŲ;3432886020;Ne;0;1;0;1
12877;Voveraitė;KODĖLČIUKŲ;8154347030;Ne;0;2;0;2
12878;Voveraitė;KODĖLČIUKŲ;2482908027;Ne;7;4;0;11
12879;Voveraitė;KODĖLČIUKŲ;8692155848;Ne;0;15;2;17
12880;Voveraitė;KODĖLČIUKŲ;1040007977;Ne;0;5;0;5
12881;Voveraitė;KODĖLČIUKŲ;3881039538;Ne;9;1;2;12
12882;Voveraitė;KODĖLČIUKŲ;7281753415;Ne;0;1;11;12
12883;Voveraitė;KODĖLČIUKŲ;8021563060;Ne;1;2;3;6
12884;Voveraitė;KODĖLČIUKŲ;9816971493;Ne;0;1;1;2
12885;Voveraitė;MEŠKIUKŲ;7253112849;Ne;0;1;0;1
12886;Voveraitė;MEŠKIUKŲ;3217609712;Ne;0;4;0;4
12887;Voveraitė;MEŠKIUKŲ;4207949414;Ne;0;3;0;3
12888;Voveraitė;MEŠKIUKŲ;4547087565;Taip;0;3;0;3
12889;Voveraitė;MEŠKIUKŲ;7474214701;Ne;2;0;0;2
12890;Voveraitė;MEŠKIUKŲ;9729735431;Ne;3;1;0;4
12891;Voveraitė;MEŠKIUKŲ;6853358062;Ne;1;0;0;1
12892;Voveraitė;MEŠKIUKŲ;3539069705;Ne;0;1;0;1
12893;Voveraitė;MEŠKIUKŲ;9544043839;Taip;4;0;0;4
12894;Voveraitė;MEŠKIUKŲ;6609235703;Taip;0;9;0;9
12895;Voveraitė;MEŠKIUKŲ;1528968162;Taip;7;1;0;8
12896;Voveraitė;MEŠKIUKŲ;3159659638;Ne;0;1;0;1
12897;Voveraitė;MEŠKIUKŲ;3532178114;Ne;0;1;0;1
12898;Voveraitė;MEŠKIUKŲ;5196036817;Ne;0;1;0;1
12899;Voveraitė;MEŠKIUKŲ;1813440087;Ne;0;11;0;11
12900;Voveraitė;MEŠKIUKŲ;8534405352;Ne;15;1;0;16
12901;Voveraitė;MEŠKIUKŲ;5018335921;Ne;20;0;0;20
12902;Voveraitė;BORUŽĖLIŲ;3381417855;Ne;0;7;0;7
12903;Voveraitė;BORUŽĖLIŲ;5437283673;Ne;0;1;0;1
12904;Voveraitė;BORUŽĖLIŲ;3029983180;Ne;0;9;0;9
12905;Voveraitė;BORUŽĖLIŲ;7797966139;Ne;4;0;4;8
12906;Voveraitė;BORUŽĖLIŲ;4079618555;Ne;0;0;1;1
12907;Voveraitė;BORUŽĖLIŲ;6886337758;Ne;0;12;0;12
12908;Voveraitė;BORUŽĖLIŲ;1592633500;Ne;0;9;0;9
12909;Voveraitė;BORUŽĖLIŲ;1629942114;Ne;0;4;0;4
12910;Voveraitė;BORUŽĖLIŲ;1058273156;Ne;0;0;1;1
12911;Voveraitė;BORUŽĖLIŲ;9933037872;Ne;0;2;2;4
12912;Voveraitė;BORUŽĖLIŲ;3615729576;Ne;1;0;1;2
12913;Voveraitė;BORUŽĖLIŲ;6277010268;Ne;1;0;0;1
12914;Voveraitė;BORUŽĖLIŲ;2831224400;Ne;7;0;2;9
12915;Voveraitė;BORUŽĖLIŲ;2763656717;Ne;0;0;10;10
12916;Voveraitė;PELĖDŽIUKŲ;9491132884;Ne;5;0;0;5
12917;Voveraitė;PELĖDŽIUKŲ;1775800865;Ne;3;1;0;4
12918;Voveraitė;PELĖDŽIUKŲ;1959958256;Ne;7;0;3;10
12919;Voveraitė;PELĖDŽIUKŲ;6649068571;Ne;0;7;1;8
12920;Voveraitė;PELĖDŽIUKŲ;9231751171;Ne;0;1;0;1
12921;Voveraitė;PELĖDŽIUKŲ;54408671673;Ne;0;1;0;1
12922;Voveraitė;PELĖDŽIUKŲ;72154318379;Ne;0;1;0;1
12923;Voveraitė;PELĖDŽIUKŲ;9007031372;Ne;2;1;0;3
12924;Voveraitė;PELĖDŽIUKŲ;6369860178;Ne;1;0;0;1
12925;Voveraitė;PELĖDŽIUKŲ;6433760749;Ne;4;1;0;5
12926;Voveraitė;PELĖDŽIUKŲ;6460834118;Ne;10;0;0;10
12927;Voveraitė;PELĖDŽIUKŲ;7314148938;Ne;0;1;0;1
12928;Voveraitė;PELĖDŽIUKŲ;4511771924;Ne;0;1;0;1
12929;Voveraitė;PELĖDŽIUKŲ;602726070;Ne;0;2;0;2
12930;Voveraitė;PELĖDŽIUKŲ;4163635632;Ne;0;2;8;10
12931;Voveraitė;PELĖDŽIUKŲ;1397274691;Ne;0;6;0;6
12932;Voveraitė;DRUGELIŲ;7531020548;Ne;0;4;0;4
12933;Voveraitė;DRUGELIŲ;4300235743;Ne;0;0;3;3
12934;Voveraitė;DRUGELIŲ;1510853268;Ne;0;1;0;1
12935;Voveraitė;DRUGELIŲ;3388547792;Ne;0;7;0;7
12936;Voveraitė;DRUGELIŲ;8719547570;Ne;0;2;0;2
12937;Voveraitė;DRUGELIŲ;3475601049;Ne;1;0;0;1
12938;Voveraitė;DRUGELIŲ;4017408873;Ne;0;0;2;2
12939;Voveraitė;DRUGELIŲ;7533728486;Ne;1;1;0;2
12940;Voveraitė;DRUGELIŲ;5114768009;Ne;3;1;0;4
12941;Voveraitė;DRUGELIŲ;1045204378;Ne;0;1;0;1
12942;Voveraitė;DRUGELIŲ;4605007814;Ne;0;2;0;2
12943;Voveraitė;DRUGELIŲ;4911291891;Ne;5;2;8;15
12944;Voveraitė;DRUGELIŲ;6415024059;Taip;0;2;0;2
12945;Voveraitė;DRUGELIŲ;4350450125;Ne;0;1;0;1
12946;Voveraitė;DRUGELIŲ;8913940646;Ne;0;1;0;1
12947;Voveraitė;DRUGELIŲ;1201270622;Ne;0;2;3;5
12948;Voveraitė;DRUGELIŲ;7238482039;Ne;15;0;0;15
12949;Voveraitė;NYKŠTUKŲ;6579193196;Taip;4;0;1;5
12950;Voveraitė;NYKŠTUKŲ;8940421826;Ne;6;0;0;6
12951;Voveraitė;NYKŠTUKŲ;9332936763;Ne;6;1;0;7
12952;Voveraitė;NYKŠTUKŲ;6206817227;Ne;6;0;2;8
12953;Voveraitė;NYKŠTUKŲ;8206634977;Ne;3;0;0;3
12954;Voveraitė;NYKŠTUKŲ;3068683904;Ne;0;2;15;17
12955;Voveraitė;NYKŠTUKŲ;3600230896;Ne;3;0;0;3
12956;Voveraitė;NYKŠTUKŲ;1294012085;Ne;10;1;0;11
12957;Voveraitė;NYKŠTUKŲ;9363490578;Ne;1;7;0;8
12958;Voveraitė;NYKŠTUKŲ;8217771158;Ne;0;5;0;5
12959;Voveraitė;NYKŠTUKŲ;3409709168;Ne;2;7;0;9
12960;Voveraitė;NYKŠTUKŲ;1045121363;Ne;5;2;3;10
12961;Voveraitė;NYKŠTUKŲ;4319786615;Ne;0;1;0;1
12962;Voveraitė;NYKŠTUKŲ;4430631207;Ne;0;2;6;8
12963;Voveraitė;NYKŠTUKŲ;6092848276;Taip;12;0;1;13
12964;Voveraitė;NYKŠTUKŲ;4533816630;Ne;5;1;0;6
12965;Voveraitė;NYKŠTUKŲ;1237440400;Ne;4;2;2;8
12966;Voveraitė;NYKŠTUKŲ;8664568879;Taip;4;1;0;5
12967;Voveraitė;NYKŠTUKŲ;3261542931;Ne;14;1;5;20
12968;Voveraitė;GENIUKŲ;5296850349;Ne;0;0;2;2
12969;Voveraitė;GENIUKŲ;51213803814;Ne;0;3;0;3
12970;Voveraitė;GENIUKŲ;46205148458;Ne;0;1;0;1
12971;Voveraitė;GENIUKŲ;4468214107;Ne;5;0;0;5
12972;Voveraitė;GENIUKŲ;4045121781;Ne;5;1;0;6
12973;Voveraitė;GENIUKŲ;7786378018;Ne;3;1;0;4
12974;Voveraitė;GENIUKŲ;5449490074;Ne;5;2;4;11
12975;Voveraitė;GENIUKŲ;6690309946;Ne;0;1;0;1
12976;Voveraitė;GENIUKŲ;1772758517;Ne;9;2;4;15
12977;Voveraitė;LAPIUKŲ;5104290434;Ne;10;0;10;20
12978;Voveraitė;LAPIUKŲ;6648733729;Ne;0;20;0;20
12979;Voveraitė;LAPIUKŲ;8405238812;Ne;1;0;1;2
12980;Voveraitė;LAPIUKŲ;8152541593;Ne;12;0;0;12
12981;Voveraitė;LAPIUKŲ;4891757467;Ne;0;0;15;15
12982;Voveraitė;LAPIUKŲ;9218074631;Ne;4;0;4;8
12983;Voveraitė;LAPIUKŲ;1921260351;Ne;10;0;3;13
12984;Voveraitė;LAPIUKŲ;3452040361;Ne;10;1;0;11
12985;Voveraitė;LAPIUKŲ;8382950248;Ne;0;0;5;5
12986;Voveraitė;LAPIUKŲ;8695525951;Ne;9;0;0;9
12987;Voveraitė;LAPIUKŲ;6443288864;Ne;5;1;3;9
12988;Voveraitė;LAPIUKŲ;6650343917;Ne;3;4;0;7
12989;Voveraitė;LAPIUKŲ;8451803815;Ne;0;0;2;2
12990;Voveraitė;LAPIUKŲ;9327593792;Ne;14;0;0;14
12991;Voveraitė;LAPIUKŲ;4139239328;Ne;14;0;0;14
12992;Voveraitė;EŽIUKŲ;5420123208;Ne;0;3;0;3
12993;Voveraitė;EŽIUKŲ;7969862374;Ne;10;0;0;10
12994;Voveraitė;EŽIUKŲ;1692829228;Ne;5;2;1;8
12995;Voveraitė;EŽIUKŲ;4233627593;Ne;9;0;0;9
12996;Voveraitė;EŽIUKŲ;2446269570;Ne;0;4;4;8
12997;Voveraitė;EŽIUKŲ;2761041681;Ne;4;0;0;4
12998;Voveraitė;EŽIUKŲ;8074808131;Ne;12;0;0;12
12999;Voveraitė;EŽIUKŲ;8675606844;Ne;0;4;0;4
13000;Voveraitė;EŽIUKŲ;8229145014;Ne;8;0;0;8
13001;Voveraitė;EŽIUKŲ;3168493145;Ne;3;0;1;4
13002;Voveraitė;EŽIUKŲ;2118244290;Ne;0;2;0;2
13003;Voveraitė;EŽIUKŲ;3971484538;Ne;7;1;0;8
13004;Voveraitė;EŽIUKŲ;1542869765;Ne;3;0;1;4
13005;Voveraitė;EŽIUKŲ;2755043670;Ne;0;8;0;8
13006;Voveraitė;EŽIUKŲ;3408126903;Ne;6;0;0;6
13007;Voveraitė;EŽIUKŲ;8627692360;Ne;5;2;1;8
13008;Voveraitė;EŽIUKŲ;7776716092;Ne;0;3;0;3
13009;"Trakų Vokė";Voveriukų;1252962923;Ne;8;0;0;8
13010;"Trakų Vokė";Voveriukų;6076083379;Ne;6;0;4;10
13011;"Trakų Vokė";Voveriukų;7656305410;Ne;5;0;3;8
13012;"Trakų Vokė";Voveriukų;5626732539;Ne;0;2;0;2
13013;"Trakų Vokė";Voveriukų;2163756512;Ne;5;0;3;8
13014;"Trakų Vokė";Voveriukų;7346128036;Ne;2;0;1;3
13015;"Trakų Vokė";Voveriukų;2318712376;Ne;8;0;0;8
13016;"Trakų Vokė";Voveriukų;2812442474;Ne;5;0;0;5
13017;"Trakų Vokė";Voveriukų;7671121106;Ne;8;0;2;10
13018;"Trakų Vokė";Voveriukų;9140597911;Ne;2;0;5;7
13019;"Trakų Vokė";Voveriukų;5741852704;Ne;9;0;2;11
13020;"Trakų Vokė";Voveriukų;8636196544;Ne;8;0;0;8
13021;"Trakų Vokė";Voveriukų;4516714702;Ne;16;0;0;16
13022;"Trakų Vokė";Voveriukų;3445611475;Ne;9;0;0;9
13023;"Trakų Vokė";Boružėlių;2516219363;Taip;0;0;1;1
13024;"Trakų Vokė";Boružėlių;7858812338;Taip;10;0;0;10
13025;"Trakų Vokė";Boružėlių;1088928094;Ne;1;0;0;1
13026;"Trakų Vokė";Boružėlių;6908913934;Taip;7;0;0;7
13027;"Trakų Vokė";Boružėlių;6751625456;Taip;6;0;1;7
13028;"Trakų Vokė";Boružėlių;7752786907;Taip;17;0;0;17
13029;"Trakų Vokė";Boružėlių;4601374629;Ne;6;0;1;7
13030;"Trakų Vokė";Boružėlių;4438127190;Ne;5;0;4;9
13031;"Trakų Vokė";Boružėlių;2388817616;Taip;6;0;0;6
13032;"Trakų Vokė";Boružėlių;6732422645;Taip;0;0;4;4
13033;"Trakų Vokė";Boružėlių;5338798362;Taip;6;0;0;6
13034;"Trakų Vokė";Boružėlių;4014027030;Taip;6;0;3;9
13035;"Trakų Vokė";Boružėlių;7660240598;Taip;0;10;0;10
13036;"Trakų Vokė";KIŠKUČIŲ;9483709021;Ne;3;0;0;3
13037;"Trakų Vokė";KIŠKUČIŲ;2503382218;Ne;14;0;0;14
13038;"Trakų Vokė";KIŠKUČIŲ;8605461082;Ne;10;0;2;12
13039;"Trakų Vokė";KIŠKUČIŲ;6369848950;Taip;0;0;1;1
13040;"Trakų Vokė";KIŠKUČIŲ;4854440884;Taip;0;1;5;6
13041;"Trakų Vokė";KIŠKUČIŲ;2761614687;Taip;7;1;1;9
13042;"Trakų Vokė";KIŠKUČIŲ;9233090228;Ne;19;0;0;19
13043;"Trakų Vokė";KIŠKUČIŲ;1360046096;Ne;4;2;0;6
13044;"Trakų Vokė";KIŠKUČIŲ;3611639112;Ne;7;0;0;7
13045;"Trakų Vokė";KIŠKUČIŲ;5206616285;Ne;5;0;0;5
13046;"Trakų Vokė";KIŠKUČIŲ;2869217654;Ne;0;2;0;2
13047;"Trakų Vokė";KIŠKUČIŲ;4535167417;Ne;0;18;0;18
13048;"Trakų Vokė";KIŠKUČIŲ;2539647111;Ne;0;1;0;1
13049;"Trakų Vokė";KIŠKUČIŲ;8874384610;Ne;6;0;3;9
13050;"Trakų Vokė";KIŠKUČIŲ;2453791555;Ne;1;0;2;3
13051;"Trakų Vokė";KIŠKUČIŲ;9506008651;Ne;5;0;1;6
13052;"Trakų Vokė";BITUČIŲ;3686108421;Ne;5;0;1;6
13053;"Trakų Vokė";BITUČIŲ;3333979364;Ne;8;1;0;9
13054;"Trakų Vokė";BITUČIŲ;5810595458;Ne;6;0;0;6
13055;"Trakų Vokė";BITUČIŲ;8783922678;Ne;0;1;0;1
13056;"Trakų Vokė";BITUČIŲ;5031669549;Ne;13;0;0;13
13057;"Trakų Vokė";BITUČIŲ;8703806519;Ne;17;0;0;17
13058;"Trakų Vokė";BITUČIŲ;4531294784;Ne;10;0;0;10
13059;"Trakų Vokė";BITUČIŲ;2133793458;Ne;6;0;1;7
13060;"Trakų Vokė";BITUČIŲ;5720994041;Ne;10;0;0;10
13061;"Trakų Vokė";BITUČIŲ;6428645462;Ne;0;1;0;1
13062;"Trakų Vokė";BITUČIŲ;7459132887;Ne;6;0;0;6
13063;"Trakų Vokė";BITUČIŲ;1808420447;Ne;0;4;0;4
13064;"Trakų Vokė";BITUČIŲ;6402002961;Ne;1;2;0;3
13065;"Trakų Vokė";BITUČIŲ;3536227018;Ne;3;0;0;3
13066;"Trakų Vokė";BITUČIŲ;6787506848;Ne;8;0;0;8
13067;"Trakų Vokė";BITUČIŲ;3372734352;Ne;3;0;0;3
13068;"Trakų Vokė";BITUČIŲ;1000323267;Ne;6;0;0;6
13069;"Trakų Vokė";BITUČIŲ;1359519176;Ne;2;2;0;4
13070;"Trakų Vokė";BITUČIŲ;1039317931;Ne;18;0;0;18
13071;"Trakų Vokė";BITUČIŲ;4212617288;Ne;6;0;1;7
13072;Zylutė;Katerok;8749296671;Ne;9;0;0;9
13073;Zylutė;Katerok;4592825972;Ne;0;1;0;1
13074;Zylutė;Katerok;8747721198;Ne;12;0;0;12
13075;Zylutė;Katerok;8212030518;Ne;0;8;0;8
13076;Zylutė;Katerok;7706833089;Ne;17;3;0;20
13077;Zylutė;Katerok;3115223229;Ne;0;0;1;1
13078;Zylutė;Katerok;1897871944;Ne;0;2;0;2
13079;Zylutė;Katerok;5687201052;Taip;0;3;0;3
13080;Zylutė;Katerok;3055559237;Ne;0;0;1;1
13081;Zylutė;Katerok;2792217953;Ne;0;0;4;4
13082;Zylutė;Katerok;5948147748;Ne;2;0;1;3
13083;Zylutė;Katerok;7851423851;Ne;6;2;0;8
13084;Zylutė;Katerok;2945894661;Taip;7;0;1;8
13085;Zylutė;Katerok;9986289837;Ne;10;0;1;11
13086;Zylutė;Katerok;1164530815;Ne;0;0;1;1
13087;Zylutė;Katerok;1423890598;Taip;5;5;2;12
13088;Zylutė;Katerok;2558354198;Ne;5;0;0;5
13089;Zylutė;Katerok;8618778936;Ne;0;1;0;1
13090;Zylutė;"Vesole misiaki";3332865242;Taip;7;0;0;7
13091;Zylutė;"Vesole misiaki";9162232979;Ne;8;1;0;9
13092;Zylutė;"Vesole misiaki";9457457032;Taip;0;1;0;1
13093;Zylutė;"Vesole misiaki";4543822765;Taip;2;0;0;2
13094;Zylutė;"Vesole misiaki";4566817285;Taip;0;1;0;1
13095;Zylutė;"Vesole misiaki";9737308076;Ne;1;4;0;5
13096;Zylutė;"Vesole misiaki";2999425729;Taip;1;0;0;1
13097;Zylutė;"Vesole misiaki";5027134228;Taip;0;4;0;4
13098;Zylutė;"Vesole misiaki";5589330186;Ne;10;0;0;10
13099;Zylutė;"Vesole misiaki";3848401615;Ne;12;0;0;12
13100;Zylutė;"Vesole misiaki";2913504349;Ne;0;5;0;5
13101;Zylutė;"Vesole misiaki";6601967273;Ne;9;0;0;9
13102;Zylutė;"Vesole misiaki";2501761963;Ne;3;1;0;4
13103;Zylutė;"Vesole misiaki";6833822248;Taip;9;3;0;12
13104;Zylutė;"Vesole misiaki";3976277394;Ne;5;0;0;5
13105;Zylutė;"Vesole misiaki";2489898107;Ne;0;5;0;5
13106;Zylutė;"Vesole misiaki";2313423907;Ne;8;7;0;15
13107;Zylutė;NYKŠTUKAI;3371202491;Taip;0;0;1;1
13108;Zylutė;NYKŠTUKAI;4611555689;Ne;0;5;0;5
13109;Zylutė;NYKŠTUKAI;1169490002;Ne;0;18;0;18
13110;Zylutė;NYKŠTUKAI;3994691080;Ne;0;4;0;4
13111;Zylutė;NYKŠTUKAI;4894611078;Ne;0;4;0;4
13112;Zylutė;NYKŠTUKAI;7648922403;Ne;0;1;0;1
13113;Zylutė;NYKŠTUKAI;2113594059;Ne;0;7;0;7
13114;Zylutė;NYKŠTUKAI;9615779237;Ne;0;1;0;1
13115;Zylutė;NYKŠTUKAI;2604844156;Ne;5;1;0;6
13116;Zylutė;NYKŠTUKAI;2511658462;Ne;2;1;0;3
13117;Zylutė;NYKŠTUKAI;3035745273;Ne;6;0;1;7
13118;Zylutė;NYKŠTUKAI;2620903587;Ne;0;16;0;16
13119;Zylutė;NYKŠTUKAI;2001428305;Ne;13;0;0;13
13120;Zylutė;NYKŠTUKAI;4706933533;Ne;13;0;0;13
13121;Zylutė;NYKŠTUKAI;9951774752;Ne;9;0;0;9
13122;Zylutė;Ručijok;5096881585;Ne;7;0;4;11
13123;Zylutė;Ručijok;3201966434;Taip;3;0;1;4
13124;Zylutė;Ručijok;9904758615;Ne;19;0;0;19
13125;Zylutė;Ručijok;4874246039;Ne;6;1;0;7
13126;Zylutė;Ručijok;6607670962;Ne;15;0;2;17
13127;Zylutė;Ručijok;1145229045;Ne;0;0;2;2
13128;Zylutė;Ručijok;3058040516;Ne;17;0;0;17
13129;Zylutė;Ručijok;2916622808;Ne;4;0;0;4
13130;Zylutė;Ručijok;5038936878;Ne;1;0;13;14
13131;Zylutė;Ručijok;2491905840;Taip;10;0;0;10
13132;Zylutė;Ručijok;7742044835;Taip;0;5;0;5
13133;Zylutė;Ručijok;5956114459;Ne;0;8;0;8
13134;Zylutė;Ručijok;6276017610;Ne;1;0;0;1
13135;Zylutė;Ručijok;3128535871;Ne;2;7;0;9
13136;Zylutė;Raduga;9325387975;Taip;4;0;4;8
13137;Zylutė;Raduga;6569135467;Taip;0;0;4;4
13138;Zylutė;Raduga;3117948118;Taip;0;0;7;7
13139;Zylutė;Raduga;3943002728;Taip;12;0;1;13
13140;Zylutė;Raduga;4043810535;Taip;12;0;0;12
13141;Zylutė;Raduga;2107123106;Ne;27;0;0;27
13142;Zylutė;Raduga;7482740111;Taip;0;0;5;5
13143;Zylutė;Raduga;7824348276;Taip;4;0;0;4
13144;Zylutė;Raduga;4811667497;Ne;5;0;0;5
13145;Zylutė;Raduga;2681013154;Taip;0;0;14;14
13146;Zylutė;Raduga;6391999153;Taip;0;0;2;2
13147;Zylutė;Raduga;4493469560;Taip;0;0;2;2
13148;Zylutė;Raduga;3608920051;Taip;0;1;0;1
13149;Zylutė;Raduga;5408157164;Ne;0;0;9;9
13150;Zylutė;Raduga;3780475392;Taip;0;0;4;4
13151;Zylutė;"Miki Maus";9159342804;Ne;1;0;0;1
13152;Zylutė;"Miki Maus";8023418946;Ne;1;3;0;4
13153;Zylutė;"Miki Maus";5369354390;Taip;0;16;0;16
13154;Zylutė;"Miki Maus";8101232865;Ne;9;0;0;9
13155;Zylutė;"Miki Maus";7762245887;Ne;10;0;0;10
13156;Zylutė;"Miki Maus";9213491152;Ne;8;1;0;9
13157;Zylutė;"Miki Maus";3928932787;Ne;2;5;0;7
13158;Zylutė;"Miki Maus";4057419108;Ne;9;3;0;12
13159;Zylutė;"Miki Maus";3668160578;Ne;2;1;0;3
13160;Zylutė;"Miki Maus";9093777086;Ne;3;1;0;4
13161;Zylutė;"Miki Maus";7123399601;Ne;0;4;0;4
13162;Zylutė;"Miki Maus";5975875502;Ne;0;3;0;3
13163;Zylutė;Solnyško;8379932761;Ne;11;0;0;11
13164;Zylutė;Solnyško;5556769710;Ne;0;1;1;2
13165;Zylutė;Solnyško;2088316489;Ne;0;6;0;6
13166;Zylutė;Solnyško;1076803315;Ne;9;1;0;10
13167;Zylutė;Solnyško;7616444695;Ne;3;0;0;3
13168;Zylutė;Solnyško;5939522435;Ne;0;1;0;1
13169;Zylutė;Solnyško;5826813410;Ne;0;5;0;5
13170;Zylutė;Solnyško;8033573972;Ne;0;0;2;2
13171;Zylutė;Solnyško;7447067072;Ne;0;0;3;3
13172;Zylutė;Solnyško;4478652694;Ne;0;16;0;16
13173;Zylutė;Solnyško;1969578486;Ne;0;6;0;6
13174;Zylutė;Solnyško;6573541087;Ne;5;0;0;5
13175;Zylutė;Solnyško;2520744071;Ne;0;0;2;2
13176;Zylutė;Solnyško;3894885445;Ne;0;0;5;5
13177;Zylutė;Motyliok;7241045507;Ne;16;0;2;18
13178;Zylutė;Motyliok;9913001904;Ne;1;0;0;1
13179;Zylutė;Motyliok;5891900062;Ne;0;5;0;5
13180;Zylutė;Motyliok;6112586092;Ne;0;0;2;2
13181;Zylutė;Motyliok;8178488164;Ne;4;0;1;5
13182;Zylutė;Motyliok;5045652581;Ne;0;11;0;11
13183;Zylutė;Motyliok;9586800176;Ne;4;0;0;4
13184;Zylutė;Motyliok;4497904128;Ne;0;8;0;8
13185;Zylutė;Motyliok;3355159275;Ne;6;4;0;10
13186;Zylutė;Motyliok;9995791665;Ne;0;3;0;3
13187;Zylutė;Motyliok;1455822427;Ne;14;0;0;14
13188;Zylutė;Motyliok;2654373943;Taip;5;2;0;7
13189;Zylutė;Motyliok;3455374127;Ne;0;7;0;7
13190;Zylutė;Motyliok;1632490481;Ne;9;0;0;9
13191;Zylutė;Motyliok;1726060015;Ne;0;0;1;1
13192;Zylutė;Motyliok;6051657134;Ne;12;0;2;14
13193;Zylutė;Motyliok;3271366684;Ne;5;0;0;5
13194;Zylutė;Motyliok;3633983359;Ne;8;0;0;8
13195;Zylutė;Motyliok;9155513221;Ne;6;0;0;6
13196;Zylutė;ŽVIRBLIUKAI;6282501549;Ne;0;0;5;5
13197;Zylutė;ŽVIRBLIUKAI;1319040747;Ne;0;0;8;8
13198;Zylutė;ŽVIRBLIUKAI;4394023057;Ne;10;0;0;10
13199;Zylutė;ŽVIRBLIUKAI;8326987895;Ne;0;11;0;11
13200;Zylutė;ŽVIRBLIUKAI;9330583784;Ne;15;0;0;15
13201;Zylutė;ŽVIRBLIUKAI;9150157724;Ne;5;0;1;6
13202;Zylutė;ŽVIRBLIUKAI;8268700439;Taip;0;0;20;20
13203;Zylutė;ŽVIRBLIUKAI;1220439948;Ne;4;5;0;9
13204;Zylutė;ŽVIRBLIUKAI;4646273830;Ne;2;0;0;2
13205;Zylutė;ŽVIRBLIUKAI;1797701777;Ne;0;1;0;1
13206;Zylutė;ŽVIRBLIUKAI;2966482773;Taip;4;4;0;8
13207;Zylutė;ŽVIRBLIUKAI;8262929231;Ne;2;2;0;4
13208;Zylutė;ŽVIRBLIUKAI;8152140523;Ne;5;0;0;5
13209;Zylutė;ŽVIRBLIUKAI;8346794629;Ne;0;0;1;1
13210;Zylutė;ŽVIRBLIUKAI;2061747513;Taip;7;0;0;7
13211;Zylutė;"DRUŽNYJE REBIATA";5332039406;Ne;20;0;0;20
13212;Zylutė;"DRUŽNYJE REBIATA";6075614020;Ne;1;5;0;6
13213;Zylutė;"DRUŽNYJE REBIATA";9518714240;Ne;0;1;0;1
13214;Zylutė;"DRUŽNYJE REBIATA";2693961315;Ne;1;0;2;3
13215;Zylutė;"DRUŽNYJE REBIATA";4916625058;Ne;9;0;0;9
13216;Zylutė;"DRUŽNYJE REBIATA";3447644735;Ne;0;1;0;1
13217;Zylutė;"DRUŽNYJE REBIATA";6848387941;Ne;5;2;4;11
13218;Zylutė;"DRUŽNYJE REBIATA";1404949829;Ne;0;1;0;1
13219;Zylutė;"DRUŽNYJE REBIATA";4548205666;Ne;0;1;0;1
13220;Zylutė;"DRUŽNYJE REBIATA";6962852787;Ne;0;1;0;1
13221;Zylutė;"DRUŽNYJE REBIATA";9220918504;Ne;0;1;0;1
13222;Zylutė;"DRUŽNYJE REBIATA";9193349264;Ne;20;1;0;21
13223;Zylutė;"DRUŽNYJE REBIATA";8204885376;Ne;2;0;0;2
13224;Zylutė;"DRUŽNYJE REBIATA";6281989117;Ne;2;3;0;5
13225;Zylutė;"DRUŽNYJE REBIATA";9769201088;Ne;15;1;0;16
13226;Zylutė;"DRUŽNYJE REBIATA";6784471792;Ne;8;1;0;9
13227;Zylutė;VIEVERSĖLIAI;4505081448;Ne;3;1;0;4
13228;Zylutė;VIEVERSĖLIAI;72716975865;Ne;4;0;0;4
13229;Zylutė;VIEVERSĖLIAI;6275164528;Ne;6;0;0;6
13230;Zylutė;VIEVERSĖLIAI;5172154642;Ne;0;10;0;10
13231;Zylutė;VIEVERSĖLIAI;2943888466;Ne;0;4;0;4
13232;Zylutė;VIEVERSĖLIAI;6907378757;Ne;2;0;0;2
13233;Zylutė;VIEVERSĖLIAI;4016518230;Ne;0;4;0;4
13234;Zylutė;VIEVERSĖLIAI;9660898505;Ne;0;9;0;9
13235;Zylutė;VIEVERSĖLIAI;5544338521;Ne;0;1;0;1
13236;Zylutė;VIEVERSĖLIAI;3246229837;Ne;2;0;0;2
13237;Zylutė;VIEVERSĖLIAI;27488840113;Ne;8;1;0;9
13238;Zylutė;VIEVERSĖLIAI;1939618217;Ne;8;1;0;9
13239;Zylutė;VIEVERSĖLIAI;20569748356;Ne;16;1;0;17
13240;Zylutė;VIEVERSĖLIAI;1048279422;Ne;0;8;0;8
13241;Zylutė;VIEVERSĖLIAI;3919565034;Ne;0;3;0;3
13242;Zylutė;VIEVERSĖLIAI;6548786007;Ne;0;3;0;3
13243;Zylutė;VIEVERSĖLIAI;4154010905;Ne;6;0;0;6
13244;Zylutė;VIEVERSĖLIAI;3074954453;Ne;0;1;0;1
13245;Želmenėliai;Bitučių;4681686872;Taip;0;1;0;1
13246;Želmenėliai;Bitučių;3268310531;Ne;14;0;0;14
13247;Želmenėliai;Bitučių;2122665619;Taip;3;2;0;5
13248;Želmenėliai;Bitučių;2563117992;Ne;0;1;0;1
13249;Želmenėliai;Bitučių;6799702725;Ne;0;2;0;2
13250;Želmenėliai;Bitučių;8358780570;Ne;0;2;2;4
13251;Želmenėliai;Bitučių;9006406225;Ne;1;0;0;1
13252;Želmenėliai;Bitučių;2102401372;Ne;0;2;0;2
13253;Želmenėliai;Bitučių;6481952132;Ne;0;1;0;1
13254;Želmenėliai;Bitučių;9611741258;Ne;6;0;1;7
13255;Želmenėliai;Bitučių;1619143702;Ne;1;0;4;5
13256;Želmenėliai;Bitučių;5314438217;Ne;1;3;0;4
13257;Želmenėliai;Bitučių;4927030144;Ne;5;1;0;6
13258;Želmenėliai;Bitučių;3739751121;Taip;0;0;4;4
13259;Želmenėliai;Bitučių;2853659708;Ne;4;3;0;7
13260;Želmenėliai;Bitučių;9207984505;Ne;0;20;0;20
13261;Želmenėliai;Kačiukų;1292462938;Ne;4;0;0;4
13262;Želmenėliai;Kačiukų;2350936740;Ne;23;1;0;24
13263;Želmenėliai;Kačiukų;3063417708;Ne;0;12;15;27
13264;Želmenėliai;Kačiukų;2570248893;Ne;0;2;0;2
13265;Želmenėliai;Kačiukų;2577850672;Ne;0;4;0;4
13266;Želmenėliai;Kačiukų;7197717698;Ne;2;0;3;5
13267;Želmenėliai;Kačiukų;7849682820;Ne;8;3;0;11
13268;Želmenėliai;Kačiukų;2111008869;Ne;10;0;1;11
13269;Želmenėliai;Kačiukų;4589396143;Ne;10;0;0;10
13270;Želmenėliai;Kačiukų;4198085732;Ne;0;1;0;1
13271;Želmenėliai;Kačiukų;6509783586;Ne;7;0;0;7
13272;Želmenėliai;Kačiukų;4126499046;Ne;0;4;0;4
13273;Želmenėliai;Kačiukų;4758240577;Ne;0;1;0;1
13274;Želmenėliai;Kačiukų;7094853897;Taip;12;1;0;13
13275;Želmenėliai;Kačiukų;9493581034;Ne;0;3;3;6
13276;Želmenėliai;Kačiukų;4931664953;Ne;2;4;0;6
13277;Želmenėliai;Kačiukų;4376978921;Ne;0;16;0;16
13278;Želmenėliai;Kačiukų;9313666706;Ne;0;2;2;4
13279;Želmenėliai;Kačiukų;8590129703;Ne;0;0;4;4
13280;Želmenėliai;Kačiukų;3959066963;Ne;0;0;7;7
13281;Želmenėliai;Kačiukų;6761848439;Ne;0;0;16;16
13282;Želmenėliai;Voveriukų;6343814445;Ne;10;2;0;12
13283;Želmenėliai;Voveriukų;7833143421;Ne;0;2;1;3
13284;Želmenėliai;Voveriukų;8418427863;Ne;0;0;1;1
13285;Želmenėliai;Voveriukų;5360157217;Ne;15;4;0;19
13286;Želmenėliai;Voveriukų;2545133678;Ne;12;0;0;12
13287;Želmenėliai;Voveriukų;7423900312;Ne;9;3;0;12
13288;Želmenėliai;Voveriukų;4968328834;Ne;14;0;0;14
13289;Želmenėliai;Voveriukų;2025424742;Ne;0;0;1;1
13290;Želmenėliai;Voveriukų;2924134152;Ne;16;0;0;16
13291;Želmenėliai;Voveriukų;5975166975;Ne;0;0;10;10
13292;Želmenėliai;Voveriukų;6857922902;Ne;6;4;0;10
13293;Želmenėliai;Voveriukų;9811131936;Ne;15;0;1;16
13294;Želmenėliai;Voveriukų;8968533318;Ne;0;3;0;3
13295;Želmenėliai;Voveriukų;6264955603;Ne;5;1;0;6
13296;Želmenėliai;Voveriukų;8952421941;Ne;10;0;0;10
13297;Želmenėliai;Voveriukų;7345540758;Ne;10;0;1;11
13298;Želmenėliai;Voveriukų;4248374729;Ne;0;6;0;6
13299;Želmenėliai;Ežiukų;5795735579;Ne;5;2;0;7
13300;Želmenėliai;Ežiukų;2311169187;Ne;0;5;0;5
13301;Želmenėliai;Ežiukų;3572462731;Ne;1;5;0;6
13302;Želmenėliai;Ežiukų;3353793939;Ne;0;0;2;2
13303;Želmenėliai;Ežiukų;7495157523;Ne;0;3;0;3
13304;Želmenėliai;Ežiukų;3972980949;Ne;0;4;0;4
13305;Želmenėliai;Ežiukų;6779746783;Ne;10;0;0;10
13306;Želmenėliai;Ežiukų;6876147546;Ne;0;14;0;14
13307;Želmenėliai;Ežiukų;9126715074;Ne;0;1;0;1
13308;Želmenėliai;Ežiukų;1260607572;Ne;0;2;1;3
13309;Želmenėliai;Ežiukų;5638248652;Ne;2;0;0;2
13310;Želmenėliai;Ežiukų;8154713582;Ne;7;0;0;7
13311;Želmenėliai;Ežiukų;2296870749;Ne;9;8;0;17
13312;Želmenėliai;Ežiukų;6180553648;Ne;0;4;0;4
13313;Želmenėliai;Ežiukų;5171736943;Ne;0;3;0;3
13314;Želmenėliai;Ežiukų;7294722095;Ne;7;11;1;19
13315;Želmenėliai;Ežiukų;4120125150;Ne;12;0;0;12
13316;Želmenėliai;Ežiukų;5281861477;Ne;0;5;0;5
13317;Želmenėliai;Ežiukų;8987377791;Ne;0;5;0;5
13318;Želmenėliai;Ežiukų;7373892344;Ne;9;0;0;9
13319;Želmenėliai;Peledžiukų;8491797555;Ne;10;10;0;20
13320;Želmenėliai;Peledžiukų;4485249321;Ne;0;2;0;2
13321;Želmenėliai;Peledžiukų;3869372021;Ne;4;1;0;5
13322;Želmenėliai;Peledžiukų;4374898642;Ne;2;0;0;2
13323;Želmenėliai;Peledžiukų;7751609462;Ne;11;0;0;11
13324;Želmenėliai;Peledžiukų;5205425589;Ne;0;4;0;4
13325;Želmenėliai;Peledžiukų;5362390260;Ne;0;2;0;2
13326;Želmenėliai;Peledžiukų;1580370689;Ne;0;1;0;1
13327;Želmenėliai;Peledžiukų;1983575576;Ne;0;1;0;1
13328;Želmenėliai;Peledžiukų;7672980212;Ne;0;13;0;13
13329;Želmenėliai;Peledžiukų;6260153299;Ne;5;0;0;5
13330;Želmenėliai;Peledžiukų;6187661667;Ne;3;1;0;4
13331;Želmenėliai;Peledžiukų;6109546917;Ne;14;2;0;16
13332;Želmenėliai;Peledžiukų;8118696261;Ne;6;0;0;6
13333;Želmenėliai;Peledžiukų;4746898209;Ne;4;3;0;7
13334;Želmenėliai;Peledžiukų;9929149682;Taip;8;7;0;15
13335;Želmenėliai;Peledžiukų;3723155757;Ne;0;12;0;12
13336;Želmenėliai;Peledžiukų;5401466574;Ne;15;0;0;15
13337;Želmenėliai;Peledžiukų;6662439747;Ne;7;3;0;10
13338;Želmenėliai;Drugelių;7664430346;Ne;0;2;0;2
13339;Želmenėliai;Drugelių;3417538909;Ne;0;1;0;1
13340;Želmenėliai;Drugelių;3295852546;Ne;11;0;0;11
13341;Želmenėliai;Drugelių;3379266015;Ne;0;6;0;6
13342;Želmenėliai;Drugelių;1984105453;Ne;21;0;0;21
13343;Želmenėliai;Drugelių;4652412483;Ne;0;1;0;1
13344;Želmenėliai;Drugelių;1652949383;Ne;0;3;0;3
13345;Želmenėliai;Drugelių;5046836398;Ne;1;0;0;1
13346;Želmenėliai;Drugelių;9237611484;Ne;0;0;4;4
13347;Želmenėliai;Drugelių;5143554665;Ne;6;2;0;8
13348;Želmenėliai;Drugelių;7585159351;Ne;0;6;0;6
13349;Želmenėliai;Drugelių;4634346755;Ne;3;2;0;5
13350;Želmenėliai;Drugelių;4916436238;Ne;0;1;0;1
13351;Želmenėliai;Drugelių;5558795651;Ne;0;3;0;3
13352;Želmenėliai;Drugelių;7572597061;Ne;5;0;6;11
13353;Želmenėliai;Voriukų;4264751761;Ne;0;8;0;8
13354;Želmenėliai;Voriukų;1203343580;Ne;4;4;0;8
13355;Želmenėliai;Voriukų;6916426436;Ne;0;6;1;7
13356;Želmenėliai;Voriukų;7563461821;Ne;1;1;0;2
13357;Želmenėliai;Voriukų;4534946646;Ne;4;0;0;4
13358;Želmenėliai;Voriukų;4545012342;Ne;0;2;0;2
13359;Želmenėliai;Voriukų;7505996978;Ne;1;5;0;6
13360;Želmenėliai;Voriukų;2722619508;Ne;0;1;0;1
13361;Želmenėliai;Voriukų;5025345647;Ne;0;1;0;1
13362;Želmenėliai;Voriukų;8892137326;Ne;0;10;0;10
13363;Želmenėliai;Voriukų;5794346039;Ne;1;0;0;1
13364;Želmenėliai;Voriukų;8273301992;Ne;8;0;4;12
13365;Želmenėliai;Voriukų;8206979332;Taip;0;3;0;3
13366;Želmenėliai;Boružėlių;7792850272;Ne;7;0;0;7
13367;Želmenėliai;Boružėlių;1764468979;Ne;0;2;0;2
13368;Želmenėliai;Boružėlių;5161934903;Ne;0;10;0;10
13369;Želmenėliai;Boružėlių;8722573513;Ne;0;2;0;2
13370;Želmenėliai;Boružėlių;3516695805;Ne;4;8;0;12
13371;Želmenėliai;Boružėlių;5949535657;Ne;6;0;0;6
13372;Želmenėliai;Boružėlių;7077832687;Ne;0;4;0;4
13373;Želmenėliai;Boružėlių;3896171121;Ne;0;1;0;1
13374;Želmenėliai;Boružėlių;2951719129;Ne;12;5;0;17
13375;Želmenėliai;Boružėlių;2066439950;Ne;0;1;0;1
13376;Želmenėliai;Boružėlių;5207899503;Ne;9;5;0;14
13377;Želmenėliai;Boružėlių;2111705047;Ne;0;9;0;9
13378;Želmenėliai;Boružėlių;5514167627;Ne;16;1;0;17
13379;Želmenėliai;Boružėlių;8474210476;Taip;3;0;0;3
13380;Želmenėliai;Boružėlių;2179165096;Ne;16;1;0;17
13381;Želmenėliai;Pūkuotukų;3258904017;Ne;0;2;0;2
13382;Želmenėliai;Pūkuotukų;8667865301;Ne;8;1;0;9
13383;Želmenėliai;Pūkuotukų;5787772212;Ne;0;1;0;1
13384;Želmenėliai;Pūkuotukų;2727113833;Ne;4;2;0;6
13385;Želmenėliai;Pūkuotukų;9359070885;Ne;0;1;0;1
13386;Želmenėliai;Pūkuotukų;37152467004;Ne;5;3;0;8
13387;Želmenėliai;Pūkuotukų;5842563754;Ne;10;2;0;12
13388;Želmenėliai;Pūkuotukų;1941723687;Ne;0;2;0;2
13389;Želmenėliai;Pūkuotukų;1239398642;Ne;0;1;0;1
13390;Želmenėliai;Pūkuotukų;5616709457;Ne;0;4;0;4
13391;Želmenėliai;Pūkuotukų;4206128805;Ne;0;10;0;10
13392;Želmenėliai;Pūkuotukų;1248541555;Ne;1;8;0;9
13393;Želmenėliai;Pūkuotukų;8300887366;Ne;4;4;0;8
13394;Želmenėliai;Pūkuotukų;7099039424;Ne;0;2;1;3
13395;Želmenėliai;Pūkuotukų;1582618217;Ne;10;3;0;13
13396;Želmenėliai;Ančiukų;4979494010;Ne;5;2;0;7
13397;Želmenėliai;Ančiukų;7925266303;Ne;5;1;0;6
13398;Želmenėliai;Ančiukų;9377359390;Ne;0;0;2;2
13399;Želmenėliai;Ančiukų;2578675950;Ne;16;0;0;16
13400;Želmenėliai;Ančiukų;8060048377;Ne;23;0;0;23
13401;Želmenėliai;Ančiukų;1606079948;Ne;10;1;0;11
13402;Želmenėliai;Ančiukų;9250666159;Ne;22;0;0;22
13403;Želmenėliai;Ančiukų;5569699398;Ne;22;0;0;22
13404;Želmenėliai;Ančiukų;3926238501;Ne;21;1;0;22
13405;Želmenėliai;Ančiukų;4207070475;Ne;8;1;0;9
13406;Želmenėliai;Ančiukų;8409831053;Ne;17;0;0;17
13407;Želmenėliai;Ančiukų;3608041516;Ne;2;1;0;3
13408;Želmenėliai;Ančiukų;5454656514;Ne;0;1;0;1
13409;Želmenėliai;Ančiukų;8165683014;Ne;11;2;0;13
13410;Želmenėliai;Ančiukų;3172645969;Ne;24;1;0;25
13411;Želmenėliai;Ančiukų;7128213908;Ne;13;5;0;18
13412;Želmenėliai;Nykštukų;6230010537;Ne;0;6;0;6
13413;Želmenėliai;Nykštukų;4722890143;Ne;5;1;0;6
13414;Želmenėliai;Nykštukų;5052052744;Ne;20;0;0;20
13415;Želmenėliai;Nykštukų;6764567873;Ne;3;17;0;20
13416;Želmenėliai;Nykštukų;1025894534;Ne;4;11;0;15
13417;Želmenėliai;Nykštukų;9901320882;Ne;22;0;0;22
13418;Želmenėliai;Nykštukų;4526936339;Ne;5;0;4;9
13419;Želmenėliai;Nykštukų;8276857357;Ne;7;0;0;7
13420;Želmenėliai;Nykštukų;3232996198;Ne;8;0;1;9
13421;Želmenėliai;Nykštukų;2878494111;Ne;11;6;0;17
13422;Želmenėliai;Nykštukų;5169813205;Ne;1;0;0;1
13423;Želmenėliai;Nykštukų;7341132501;Ne;12;0;0;12
13424;Želmenėliai;Nykštukų;9661692350;Ne;11;6;0;17
13425;Želmenėliai;Nykštukų;3003922213;Ne;10;10;0;20
13426;Želmenėliai;Nykštukų;7123290599;Ne;29;0;0;29
13427;Želmenėliai;Lašelių;4451798870;Ne;1;0;0;1
13428;Želmenėliai;Lašelių;4485851428;Ne;0;1;0;1
13429;Želmenėliai;Lašelių;3558547171;Ne;0;5;0;5
13430;Želmenėliai;Lašelių;4930868989;Ne;0;1;0;1
13431;Želmenėliai;Lašelių;9076874685;Ne;7;0;0;7
13432;Želmenėliai;Lašelių;3346680108;Ne;10;6;0;16
13433;Želmenėliai;Lašelių;4679930998;Ne;15;0;0;15
13434;Želmenėliai;Lašelių;3344426717;Ne;11;0;0;11
13435;Želmenėliai;Lašelių;9483665065;Ne;17;0;0;17
13436;Želmenėliai;Lašelių;1426080041;Ne;1;0;0;1
13437;Želmenėliai;Lašelių;9182208354;Ne;0;3;0;3
13438;Želmenėliai;Lašelių;8104790589;Ne;10;2;0;12
13439;Želmenėliai;Lašelių;9544233589;Ne;5;1;0;6
13440;Želmenėliai;Lašelių;3979635800;Ne;5;0;0;5
13441;Žemyna;Čiauškučiai;9985529041;Ne;5;0;3;8
13442;Žemyna;Čiauškučiai;9570187081;Ne;5;0;2;7
13443;Žemyna;Čiauškučiai;2547436771;Ne;0;9;1;10
13444;Žemyna;Čiauškučiai;6051208732;Ne;5;0;0;5
13445;Žemyna;Čiauškučiai;6346173832;Ne;0;1;11;12
13446;Žemyna;Čiauškučiai;8694608716;Ne;8;0;0;8
13447;Žemyna;Čiauškučiai;3074391266;Ne;6;0;0;6
13448;Žemyna;Čiauškučiai;4693414703;Ne;3;0;0;3
13449;Žemyna;Čiauškučiai;1365045512;Ne;6;0;0;6
13450;Žemyna;Čiauškučiai;7620179886;Ne;5;0;5;10
13451;Žemyna;Čiauškučiai;2792702536;Ne;0;0;1;1
13452;Žemyna;Čiauškučiai;7376806308;Ne;1;0;0;1
13453;Žemyna;Čiauškučiai;7277970673;Ne;7;0;0;7
13454;Žemyna;Čiauškučiai;5069437469;Ne;11;0;0;11
13455;Žemyna;Čiauškučiai;7427119736;Ne;0;0;2;2
13456;Žemyna;Čiauškučiai;4642600915;Ne;0;0;9;9
13457;Žemyna;Čiauškučiai;2354265632;Ne;3;0;3;6
13458;Žemyna;Čiauškučiai;2887459684;Ne;6;0;2;8
13459;Žemyna;Čiauškučiai;1654157342;Ne;1;1;0;2
13460;Žemyna;Čiauškučiai;4652384557;Ne;8;0;0;8
13461;Žemyna;Čiauškučiai;7352868453;Ne;0;2;0;2
13462;Žemyna;Čiauškučiai;4501408683;Ne;0;0;2;2
13463;Žemyna;Čiauškučiai;4613946229;Ne;0;2;0;2
13464;Žemyna;Čiauškučiai;7675699775;Ne;5;0;0;5
13465;Žemyna;Nykštukai;5114094924;Ne;5;1;0;6
13466;Žemyna;Nykštukai;3874855308;Ne;3;0;0;3
13467;Žemyna;Nykštukai;2461700030;Ne;1;6;0;7
13468;Žemyna;Nykštukai;1725771976;Ne;0;0;8;8
13469;Žemyna;Nykštukai;3643594001;Ne;0;0;5;5
13470;Žemyna;Nykštukai;9182709647;Ne;0;1;0;1
13471;Žemyna;Nykštukai;7121742098;Ne;9;0;0;9
13472;Žemyna;Nykštukai;3519840747;Ne;0;0;1;1
13473;Žemyna;Nykštukai;1468040559;Ne;1;0;0;1
13474;Žemyna;Nykštukai;4444870782;Ne;0;1;0;1
13475;Žemyna;Nykštukai;7781924111;Ne;0;0;3;3
13476;Žemyna;Nykštukai;4257096808;Ne;0;6;0;6
13477;Žemyna;Nykštukai;2860210906;Ne;0;0;20;20
13478;Žemyna;Nykštukai;7832066079;Ne;0;4;0;4
13479;Žemyna;Nykštukai;9653530823;Ne;0;3;0;3
13480;Žemyna;Nykštukai;4524929331;Ne;7;0;0;7
13481;Žemyna;Nykštukai;4759403487;Ne;0;3;0;3
13482;Žemyna;Voveriukai;8525229514;Ne;20;0;0;20
13483;Žemyna;Voveriukai;8775518984;Ne;0;1;0;1
13484;Žemyna;Voveriukai;8926045231;Ne;0;1;6;7
13485;Žemyna;Voveriukai;3860791215;Ne;0;7;0;7
13486;Žemyna;Voveriukai;8185243991;Ne;0;1;9;10
13487;Žemyna;Voveriukai;9471382383;Ne;0;1;3;4
13488;Žemyna;Voveriukai;4549562657;Ne;0;0;1;1
13489;Žemyna;Voveriukai;8882641275;Ne;0;10;0;10
13490;Žemyna;Voveriukai;7121061078;Ne;0;0;1;1
13491;Žemyna;Voveriukai;4900914346;Ne;5;1;0;6
13492;Žemyna;Voveriukai;8241038433;Ne;0;1;0;1
13493;Žemyna;Voveriukai;3500358886;Ne;2;1;0;3
13494;Žemyna;Voveriukai;6592356004;Ne;12;0;0;12
13495;Žemyna;Kiškučiai;8622780639;Ne;5;0;3;8
13496;Žemyna;Kiškučiai;1575505075;Ne;9;0;2;11
13497;Žemyna;Kiškučiai;7917100888;Ne;1;3;0;4
13498;Žemyna;Kiškučiai;39916867354;Ne;3;1;1;5
13499;Žemyna;Kiškučiai;4317779866;Ne;1;0;0;1
13500;Žemyna;Kiškučiai;5258444578;Ne;1;0;4;5
13501;Žemyna;Kiškučiai;7785889259;Ne;0;0;3;3
13502;Žemyna;Kiškučiai;7676796264;Ne;8;0;0;8
13503;Žemyna;Kiškučiai;6536698798;Ne;7;0;0;7
13504;Žemyna;Kiškučiai;8139714064;Taip;0;0;4;4
13505;Žemyna;Kiškučiai;2090395417;Ne;6;1;0;7
13506;Žemyna;Kiškučiai;3895238312;Ne;0;0;8;8
13507;Žemyna;Kiškučiai;5056205809;Ne;0;0;4;4
13508;Žemyna;Kiškučiai;4519502372;Ne;0;0;3;3
13509;Žemyna;Kiškučiai;2137718635;Ne;10;0;0;10
13510;Žemyna;Kiškučiai;8018865138;Ne;0;2;0;2
13511;Žemyna;Kiškučiai;1717797530;Ne;4;0;1;5
13512;Žemyna;Kiškučiai;1058705875;Ne;0;4;0;4
13513;Žemyna;Kiškučiai;5233574060;Ne;0;3;0;3
13514;Žemyna;Kiškučiai;15110117571;Ne;5;1;0;6
13515;Žemyna;Kiškučiai;9219519029;Ne;0;4;0;4
13516;Žemyna;Kiškučiai;3875204515;Ne;6;0;0;6
13517;Žemyna;Kiškučiai;7638038269;Ne;0;1;0;1
13518;Žemyna;Kiškučiai;4821941126;Ne;0;0;2;2
13519;Žemyna;Vyturiukai;2526949655;Ne;10;0;0;10
13520;Žemyna;Vyturiukai;1417007895;Ne;0;0;5;5
13521;Žemyna;Vyturiukai;5355845891;Ne;0;0;1;1
13522;Žemyna;Vyturiukai;1481273689;Ne;6;0;1;7
13523;Žemyna;Vyturiukai;7781332622;Ne;10;3;0;13
13524;Žemyna;Vyturiukai;9366133892;Ne;0;5;0;5
13525;Žemyna;Vyturiukai;1031171460;Ne;4;0;1;5
13526;Žemyna;Vyturiukai;5204349188;Ne;5;0;0;5
13527;Žemyna;Vyturiukai;1345704379;Ne;6;0;1;7
13528;Žemyna;Vyturiukai;6097681172;Ne;0;1;0;1
13529;Žemyna;Vyturiukai;3446774478;Ne;10;1;0;11
13530;Žemyna;Vyturiukai;6271057561;Ne;6;0;0;6
13531;Žemyna;Vyturiukai;2304633263;Ne;0;0;7;7
13532;Žemyna;Vyturiukai;7300819771;Ne;1;0;0;1
13533;Žemyna;Vyturiukai;3679990879;Ne;1;0;2;3
13534;Žemyna;Vyturiukai;8461326396;Ne;0;20;0;20
13535;Žemyna;Vyturiukai;8681308720;Ne;0;1;0;1
13536;Žemyna;Vyturiukai;8577299116;Ne;12;0;2;14
13537;Žemyna;Vyturiukai;9646494715;Ne;0;2;0;2
13538;Žemyna;Vyturiukai;4863350801;Ne;13;0;0;13
13539;Žemyna;Vyturiukai;5655302107;Ne;0;2;0;2
13540;Žemyna;Pelėdžiukai;8040359407;Ne;10;0;2;12
13541;Žemyna;Pelėdžiukai;37570629861;Ne;5;9;0;14
13542;Žemyna;Pelėdžiukai;55161890341;Ne;5;0;0;5
13543;Žemyna;Pelėdžiukai;59506345859;Ne;0;4;0;4
13544;Žemyna;Pelėdžiukai;85135645557;Ne;3;0;0;3
13545;Žemyna;Pelėdžiukai;38769607968;Ne;5;0;0;5
13546;Žemyna;Pelėdžiukai;4235160760;Ne;0;0;1;1
13547;Žemyna;Pelėdžiukai;3622634119;Ne;4;0;3;7
13548;Žemyna;Pelėdžiukai;5306392307;Ne;9;0;0;9
13549;Žemyna;Pelėdžiukai;9018138289;Ne;4;0;2;6
13550;Žemyna;Pelėdžiukai;8096035110;Ne;4;0;0;4
13551;Žemyna;Pelėdžiukai;1687206394;Ne;0;0;2;2
13552;Žemyna;Pelėdžiukai;93423088394;Ne;0;7;0;7
13553;Žemyna;Pelėdžiukai;5933910526;Ne;1;0;1;2
13554;Žemyna;Pelėdžiukai;5506889213;Ne;0;0;3;3
13555;Žemyna;Pelėdžiukai;5815116293;Ne;9;0;1;10
13556;Žemyna;Pelėdžiukai;13242930752;Ne;3;0;0;3
13557;Žemyna;Pelėdžiukai;9224203811;Ne;4;0;3;7
13558;Žemyna;Pelėdžiukai;2527337934;Ne;2;0;1;3
13559;Žemyna;Vijurkai;8500642069;Ne;0;0;1;1
13560;Žemyna;Vijurkai;9148594407;Ne;3;0;3;6
13561;Žemyna;Vijurkai;6812823390;Ne;0;0;1;1
13562;Žemyna;Vijurkai;3938938667;Ne;5;0;0;5
13563;Žemyna;Vijurkai;7125026803;Ne;1;0;0;1
13564;Žemyna;Vijurkai;7693278353;Ne;0;5;0;5
13565;Žemyna;Vijurkai;6430348135;Ne;0;1;0;1
13566;Žemyna;Vijurkai;2976467316;Ne;0;0;2;2
13567;Žemyna;Vijurkai;3357339710;Ne;12;0;0;12
13568;Žemyna;Vijurkai;7925774308;Ne;6;0;0;6
13569;Žemyna;Vijurkai;1531980297;Ne;0;0;1;1
13570;Žemyna;Vijurkai;9866110744;Ne;3;0;1;4
13571;Žemyna;Vijurkai;2412956023;Ne;0;5;0;5
13572;Žemyna;Vijurkai;1114714466;Ne;6;0;0;6
13573;Žemyna;Vijurkai;5318574856;Ne;0;0;4;4
13574;Žemyna;Vijurkai;1264659113;Ne;0;12;0;12
13575;Žemyna;Vijurkai;4410293832;Ne;0;0;2;2
13576;Žemyna;Vijurkai;1652681820;Ne;3;0;1;4
13577;Žemyna;Šnekučiai;9501126807;Ne;3;0;0;3
13578;Žemyna;Šnekučiai;6735720135;Ne;7;0;3;10
13579;Žemyna;Šnekučiai;9912869400;Ne;1;4;1;6
13580;Žemyna;Šnekučiai;2006173745;Ne;0;1;1;2
13581;Žemyna;Šnekučiai;6116581655;Ne;0;0;1;1
13582;Žemyna;Šnekučiai;7280740926;Ne;0;2;0;2
13583;Žemyna;Šnekučiai;6419974691;Ne;0;0;11;11
13584;Žemyna;Šnekučiai;9818711030;Ne;5;0;0;5
13585;Žemyna;Šnekučiai;7764615445;Ne;0;1;1;2
13586;Žemyna;Šnekučiai;5868208651;Ne;1;1;0;2
13587;Žemyna;Šnekučiai;3992383447;Ne;3;0;1;4
13588;Žemyna;Šnekučiai;6856737270;Ne;1;0;1;2
13589;Žemyna;Šnekučiai;4872348199;Ne;2;1;0;3
13590;Žemyna;Šnekučiai;4502958166;Ne;0;1;2;3
13591;Žemyna;Šnekučiai;6728229865;Ne;4;2;0;6
13592;Žemyna;Šnekučiai;4612112289;Ne;1;0;0;1
13593;Žemyna;Šnekučiai;9568886284;Ne;10;0;0;10
13594;Žemyna;Šnekučiai;3982766622;Ne;0;1;2;3
13595;Žemyna;Pabiručiai;9827401825;Ne;0;5;0;5
13596;Žemyna;Pabiručiai;5743535463;Ne;6;2;0;8
13597;Žemyna;Pabiručiai;6958537154;Ne;0;1;0;1
13598;Žemyna;Pabiručiai;1745197274;Ne;0;8;0;8
13599;Žemyna;Pabiručiai;6041223291;Ne;8;0;1;9
13600;Žemyna;Pabiručiai;8248443265;Ne;1;0;3;4
13601;Žemyna;Pabiručiai;7122276019;Ne;0;2;0;2
13602;Žemyna;Pabiručiai;9094718595;Ne;0;11;0;11
13603;Žemyna;Pabiručiai;6208953341;Ne;0;0;7;7
13604;Žemyna;Pabiručiai;1656335765;Ne;0;2;0;2
13605;Žemyna;Pabiručiai;5127174926;Ne;9;0;0;9
13606;Žemyna;Pabiručiai;8559870965;Ne;0;0;3;3
13607;Žemyna;Pabiručiai;1850100203;Ne;6;0;1;7
13608;Žemyna;Pabiručiai;6450681255;Ne;6;0;0;6
13609;Žemyna;Pabiručiai;2860232791;Ne;1;0;1;2
13610;Žemyna;Pabiručiai;4237778022;Ne;6;0;0;6
13611;Žemyna;Pabiručiai;2414400761;Ne;0;4;0;4
13612;Žemyna;Pabiručiai;9511935264;Ne;0;6;0;6
13613;Žemyna;Pabiručiai;4176386795;Ne;2;1;0;3
13614;Žemyna;Pabiručiai;3393414493;Ne;10;0;1;11
13615;Žemyna;Pabiručiai;4960936366;Ne;10;0;6;16
13616;Žemyna;Pabiručiai;2495616844;Ne;0;6;0;6
13617;Žemyna;Drugeliai;7564693757;Ne;10;0;0;10
13618;Žemyna;Drugeliai;8302345911;Ne;0;1;0;1
13619;Žemyna;Drugeliai;3505551915;Ne;2;0;6;8
13620;Žemyna;Drugeliai;2231967652;Ne;15;0;0;15
13621;Žemyna;Drugeliai;3755964840;Ne;8;0;0;8
13622;Žemyna;Drugeliai;9171823612;Ne;0;0;19;19
13623;Žemyna;Drugeliai;5518125715;Ne;0;0;2;2
13624;Žemyna;Drugeliai;9589582451;Ne;0;0;9;9
13625;Žemyna;Drugeliai;1279981170;Ne;6;0;1;7
13626;Žemyna;Drugeliai;2102920661;Ne;13;0;1;14
13627;Žemyna;Drugeliai;6575272457;Ne;2;0;1;3
13628;Žemyna;Drugeliai;6164541167;Ne;15;0;0;15
13629;Žemyna;Drugeliai;7461187735;Ne;0;0;2;2
13630;Žemyna;Drugeliai;3390442637;Ne;5;0;0;5
13631;Žemyna;Drugeliai;2139103576;Ne;9;0;1;10
13632;Žemyna;Drugeliai;7920398415;Ne;0;4;0;4
13633;Žemyna;Drugeliai;1695063377;Ne;4;0;3;7
13634;Žemyna;Drugeliai;7745383607;Ne;9;1;0;10
13635;Žemyna;Drugeliai;7661182825;Ne;5;0;1;6
13636;Žemyna;Drugeliai;4861799571;Ne;9;0;2;11
13637;Žemyna;Drugeliai;8709792653;Ne;4;0;0;4
13638;Žemyna;"ŽIRNIUKAI ";4540472310;Ne;11;6;0;17
13639;Žemyna;"ŽIRNIUKAI ";9647706055;Ne;5;0;5;10
13640;Žemyna;"ŽIRNIUKAI ";8638419172;Ne;8;0;1;9
13641;Žemyna;"ŽIRNIUKAI ";7537145330;Ne;17;0;0;17
13642;Žemyna;"ŽIRNIUKAI ";7683443675;Ne;17;0;0;17
13643;Žemyna;"ŽIRNIUKAI ";5262196604;Ne;5;0;1;6
13644;Žemyna;"ŽIRNIUKAI ";9796331127;Ne;0;2;0;2
13645;Žemyna;"ŽIRNIUKAI ";3996577758;Ne;18;0;1;19
13646;Žemyna;"ŽIRNIUKAI ";6783675344;Ne;6;0;0;6
13647;Žemyna;"ŽIRNIUKAI ";9082375371;Ne;6;0;0;6
13648;Žemyna;"ŽIRNIUKAI ";1795919515;Ne;6;0;1;7
13649;Žemyna;"ŽIRNIUKAI ";3899901920;Ne;0;14;0;14
13650;Žemyna;"ŽIRNIUKAI ";7831778620;Ne;0;1;2;3
13651;Žemyna;"ŽIRNIUKAI ";8319442149;Ne;7;0;2;9
13652;Žemyna;"ŽIOGELIAI ";2039344248;Ne;5;0;0;5
13653;Žemyna;"ŽIOGELIAI ";5193466394;Ne;1;3;0;4
13654;Žemyna;"ŽIOGELIAI ";5968816137;Ne;1;0;1;2
13655;Žemyna;"ŽIOGELIAI ";4238528111;Ne;13;0;0;13
13656;Žemyna;"ŽIOGELIAI ";3741459808;Ne;12;0;0;12
13657;Žemyna;"ŽIOGELIAI ";3164469202;Ne;5;2;0;7
13658;Žemyna;"ŽIOGELIAI ";3870917221;Ne;6;0;2;8
13659;Žemyna;"ŽIOGELIAI ";6571952468;Taip;0;0;1;1
13660;Žemyna;"ŽIOGELIAI ";6632827240;Ne;10;0;0;10
13661;Žemyna;"ŽIOGELIAI ";3935318882;Ne;0;1;0;1
13662;Žemyna;"ŽIOGELIAI ";2010676445;Ne;0;1;0;1
13663;Žemyna;"ŽIOGELIAI ";1581399038;Ne;4;0;0;4
13664;Žemyna;"ŽIOGELIAI ";8611258788;Ne;1;0;14;15
13665;Žemyna;"ŽIOGELIAI ";9788890112;Ne;0;0;20;20
13666;Žemyna;"ŽIOGELIAI ";3324631994;Ne;0;9;1;10
13667;Žemuogėlė;Boružiukai;1350671777;Ne;0;3;1;4
13668;Žemuogėlė;Boružiukai;2158359435;Ne;15;0;0;15
13669;Žemuogėlė;Boružiukai;1639634300;Taip;10;2;0;12
13670;Žemuogėlė;Boružiukai;5521993938;Ne;0;0;2;2
13671;Žemuogėlė;Boružiukai;1267222057;Ne;6;5;0;11
13672;Žemuogėlė;Boružiukai;9562512849;Ne;11;3;0;14
13673;Žemuogėlė;Boružiukai;1150466286;Ne;2;0;2;4
13674;Žemuogėlė;Boružiukai;8040255583;Ne;0;4;0;4
13675;Žemuogėlė;Boružiukai;2190458676;Ne;1;1;0;2
13676;Žemuogėlė;Boružiukai;7328566035;Taip;0;0;10;10
13677;Žemuogėlė;Boružiukai;8557325116;Ne;10;2;0;12
13678;Žemuogėlė;Boružiukai;1350383125;Ne;0;0;2;2
13679;Žemuogėlė;Boružiukai;7050896262;Ne;6;2;0;8
13680;Žemuogėlė;Boružiukai;3413805578;Ne;0;0;1;1
13681;Žemuogėlė;Boružiukai;1187953952;Ne;0;0;1;1
13682;Žemuogėlė;Boružiukai;3677459716;Ne;1;5;2;8
13683;Žemuogėlė;Boružiukai;8426601160;Ne;2;0;2;4
13684;Žemuogėlė;Boružiukai;5911215640;Ne;3;2;3;8
13685;Žemuogėlė;Šviesuliukai;3837424301;Ne;0;1;0;1
13686;Žemuogėlė;Šviesuliukai;5499401648;Ne;0;3;0;3
13687;Žemuogėlė;Šviesuliukai;9599829363;Ne;1;3;0;4
13688;Žemuogėlė;Šviesuliukai;3746045950;Ne;0;9;0;9
13689;Žemuogėlė;Šviesuliukai;4663181188;Ne;17;0;0;17
13690;Žemuogėlė;Šviesuliukai;8492878852;Taip;1;0;1;2
13691;Žemuogėlė;Šviesuliukai;7603740057;Ne;11;6;0;17
13692;Žemuogėlė;Šviesuliukai;4506847669;Ne;0;3;0;3
13693;Žemuogėlė;Šviesuliukai;7189855370;Ne;0;8;0;8
13694;Žemuogėlė;Šviesuliukai;3801534195;Ne;9;1;1;11
13695;Žemuogėlė;Šviesuliukai;1341637008;Ne;10;0;1;11
13696;Žemuogėlė;Šviesuliukai;7288060676;Ne;27;0;0;27
13697;Žemuogėlė;Šviesuliukai;6086270618;Taip;0;4;0;4
13698;Žemuogėlė;Šviesuliukai;7551522580;Ne;0;0;1;1
13699;Žemuogėlė;Lašiukai;3190523750;Ne;14;0;1;15
13700;Žemuogėlė;Lašiukai;3706531223;Ne;4;1;0;5
13701;Žemuogėlė;Lašiukai;8029484123;Ne;5;0;1;6
13702;Žemuogėlė;Lašiukai;5992802843;Ne;0;4;0;4
13703;Žemuogėlė;Lašiukai;3753156044;Ne;2;1;0;3
13704;Žemuogėlė;Lašiukai;7592566602;Ne;0;0;4;4
13705;Žemuogėlė;Lašiukai;1555899448;Ne;0;1;0;1
13706;Žemuogėlė;Lašiukai;1953538445;Taip;3;0;1;4
13707;Žemuogėlė;Lašiukai;3546429231;Ne;0;14;0;14
13708;Žemuogėlė;Lašiukai;9579921777;Ne;0;10;0;10
13709;Žemuogėlė;Lašiukai;3073956225;Taip;0;1;0;1
13710;Žemuogėlė;Lašiukai;9693814425;Ne;0;0;1;1
13711;Žemuogėlė;Lašiukai;3825509486;Ne;0;1;0;1
13712;Žemuogėlė;Lašiukai;2115883173;Ne;5;0;20;25
13713;Žemuogėlė;Skambaliukai;54663750186;Ne;0;2;2;4
13714;Žemuogėlė;Skambaliukai;4231767115;Ne;0;1;0;1
13715;Žemuogėlė;Skambaliukai;3977351017;Ne;0;1;0;1
13716;Žemuogėlė;Skambaliukai;5147617128;Ne;6;11;0;17
13717;Žemuogėlė;Skambaliukai;1058207935;Ne;6;3;0;9
13718;Žemuogėlė;Skambaliukai;6962103028;Ne;0;2;0;2
13719;Žemuogėlė;Skambaliukai;7714826773;Ne;0;4;0;4
13720;Žemuogėlė;Skambaliukai;3134493860;Ne;0;4;0;4
13721;Žemuogėlė;Skambaliukai;1907004376;Ne;0;9;0;9
13722;Žemuogėlė;Skambaliukai;38870047353;Ne;5;1;0;6
13723;Žemuogėlė;Skambaliukai;7403172794;Ne;0;4;4;8
13724;Žemuogėlė;Skambaliukai;9315711142;Ne;0;2;2;4
13725;Žemuogėlė;Skambaliukai;2102057496;Ne;0;6;0;6
13726;Žemuogėlė;Skambaliukai;4421397490;Ne;4;0;0;4
13727;Žemuogėlė;Skambaliukai;94792383091;Ne;0;13;0;13
13728;Žemuogėlė;Spinduliukai;3411390558;Taip;5;2;0;7
13729;Žemuogėlė;Spinduliukai;5971652934;Ne;0;9;0;9
13730;Žemuogėlė;Spinduliukai;5127370193;Taip;2;0;0;2
13731;Žemuogėlė;Spinduliukai;1049009199;Taip;0;6;0;6
13732;Žemuogėlė;Spinduliukai;4578291476;Ne;0;14;0;14
13733;Žemuogėlė;Spinduliukai;5126348190;Taip;4;10;0;14
13734;Žemuogėlė;Spinduliukai;9534937419;Ne;0;2;0;2
13735;Žemuogėlė;Spinduliukai;2481547868;Taip;1;0;0;1
13736;Žemuogėlė;Spinduliukai;3612833383;Taip;11;0;0;11
13737;Žemuogėlė;Spinduliukai;9689082202;Taip;2;3;0;5
13738;Žemuogėlė;Spinduliukai;6707522989;Ne;0;5;0;5
13739;Žemuogėlė;Spinduliukai;6059069293;Ne;13;6;0;19
13740;Žemuogėlė;Spinduliukai;5770044886;Taip;15;4;0;19
13741;Žemuogėlė;Spinduliukai;7669457695;Ne;0;1;0;1
13742;Žemuogėlė;Spinduliukai;8675089149;Ne;0;2;0;2
13743;Žemuogėlė;Spinduliukai;4933948491;Ne;7;2;0;9
13744;Žemuogėlė;Perliukai;4629107942;Ne;0;7;4;11
13745;Žemuogėlė;Perliukai;1306065826;Ne;0;1;0;1
13746;Žemuogėlė;Perliukai;8106709288;Ne;0;1;0;1
13747;Žemuogėlė;Perliukai;1060986850;Ne;8;1;0;9
13748;Žemuogėlė;Perliukai;7794377881;Ne;0;3;2;5
13749;Žemuogėlė;Perliukai;1658954821;Ne;0;12;0;12
13750;Žemuogėlė;Perliukai;4698671798;Ne;2;1;0;3
13751;Žemuogėlė;Perliukai;2922827304;Ne;0;1;1;2
13752;Žemuogėlė;Perliukai;7415364637;Ne;1;15;0;16
13753;Žemuogėlė;Perliukai;3710681463;Ne;3;0;0;3
13754;Žemuogėlė;Perliukai;1796489729;Ne;3;1;0;4
13755;Žemuogėlė;Perliukai;8215763877;Ne;0;1;0;1
13756;Žemuogėlė;Perliukai;2934225120;Ne;4;0;0;4
13757;Žemuogėlė;Perliukai;3426685084;Ne;14;1;0;15
13758;Žemuogėlė;Perliukai;9150335499;Ne;6;2;0;8
13759;Žemuogėlė;Perliukai;1079114347;Ne;2;2;0;4
13760;Žemuogėlė;Perliukai;5902241163;Ne;0;2;0;2
13761;Žemuogėlė;Perliukai;7879519193;Taip;5;2;0;7
13762;Žemuogėlė;Perliukai;2109195565;Ne;3;1;0;4
13763;Žemuogėlė;Drugeliai;2745609317;Ne;0;5;0;5
13764;Žemuogėlė;Drugeliai;9694133286;Ne;0;1;0;1
13765;Žemuogėlė;Drugeliai;5557409350;Ne;1;0;0;1
13766;Žemuogėlė;Drugeliai;7668200447;Ne;1;1;0;2
13767;Žemuogėlė;Drugeliai;7148244029;Ne;0;2;0;2
13768;Žemuogėlė;Drugeliai;1901423257;Ne;0;1;0;1
13769;Žemuogėlė;Drugeliai;4862145385;Ne;3;2;0;5
13770;Žemuogėlė;Drugeliai;4368183799;Taip;0;2;0;2
13771;Žemuogėlė;Drugeliai;9902953729;Ne;9;5;0;14
13772;Žemuogėlė;Drugeliai;9537297860;Ne;9;1;0;10
13773;Žemuogėlė;Drugeliai;5170205929;Ne;16;4;0;20
13774;Žemuogėlė;Drugeliai;2428043195;Ne;9;7;0;16
13775;Žemuogėlė;Drugeliai;1716114524;Taip;13;1;0;14
13776;Žemuogėlė;Drugeliai;8137567729;Ne;0;6;0;6
13777;Žemuogėlė;Drugeliai;8348185761;Ne;3;8;0;11
13778;Žemuogėlė;Drugeliai;7974688217;Ne;6;0;1;7
13779;Žemuogėlė;Drugeliai;9273896998;Ne;16;0;0;16
13780;Žemuogėlė;"VIEVERSIUKAI ";6520776378;Ne;6;0;0;6
13781;Žemuogėlė;"VIEVERSIUKAI ";8048818368;Ne;8;0;2;10
13782;Žemuogėlė;"VIEVERSIUKAI ";6577040746;Ne;16;0;1;17
13783;Žemuogėlė;"VIEVERSIUKAI ";9872387354;Ne;5;0;4;9
13784;Žemuogėlė;"VIEVERSIUKAI ";2674188340;Ne;15;5;0;20
13785;Žemuogėlė;"VIEVERSIUKAI ";5300388726;Ne;13;2;0;15
13786;Žemuogėlė;"VIEVERSIUKAI ";7823828526;Ne;0;0;2;2
13787;Žemuogėlė;"VIEVERSIUKAI ";4172356209;Taip;30;0;0;30
13788;Žemuogėlė;"VIEVERSIUKAI ";6379837644;Ne;0;2;0;2
13789;Žemuogėlė;"VIEVERSIUKAI ";3104276726;Ne;11;6;0;17
13790;Žemuogėlė;"VIEVERSIUKAI ";3419907292;Ne;6;0;0;6
13791;Žemuogėlė;"VIEVERSIUKAI ";7323868051;Ne;2;2;0;4
13792;Žemuogėlė;"VIEVERSIUKAI ";2800160529;Ne;21;0;0;21
13793;Žemuogėlė;"VIEVERSIUKAI ";8934779062;Ne;16;0;0;16
13794;Žemuogėlė;"VIEVERSIUKAI ";3090630899;Ne;15;2;2;19
13795;Žemuogėlė;"VIEVERSIUKAI ";8091000121;Ne;12;1;0;13
13796;Žemuogėlė;"VIEVERSIUKAI ";2110963483;Ne;26;1;0;27
13797;Žemuogėlė;"VIEVERSIUKAI ";2574719380;Ne;19;5;0;24
13798;Žemuogėlė;"NYKŠTUKAI ";3505090532;Ne;11;0;1;12
13799;Žemuogėlė;"NYKŠTUKAI ";5208043522;Ne;13;0;0;13
13800;Žemuogėlė;"NYKŠTUKAI ";3740127955;Ne;6;0;0;6
13801;Žemuogėlė;"NYKŠTUKAI ";5614510812;Ne;7;2;1;10
13802;Žemuogėlė;"NYKŠTUKAI ";9584172565;Ne;6;2;0;8
13803;Žemuogėlė;"NYKŠTUKAI ";8706379207;Ne;16;0;0;16
13804;Žemuogėlė;"NYKŠTUKAI ";1790341419;Taip;10;0;0;10
13805;Žemuogėlė;"NYKŠTUKAI ";4998981337;Ne;0;4;0;4
13806;Žemuogėlė;"NYKŠTUKAI ";6045257180;Ne;11;0;0;11
13807;Žemuogėlė;"NYKŠTUKAI ";8301927361;Ne;8;0;0;8
13808;Žemuogėlė;"NYKŠTUKAI ";2496321184;Ne;13;0;0;13
13809;Žemuogėlė;"NYKŠTUKAI ";8490643028;Ne;11;0;0;11
13810;Žemuogėlė;"NYKŠTUKAI ";2139102266;Ne;26;0;0;26
13811;Žemuogėlė;"NYKŠTUKAI ";9735379466;Ne;10;3;0;13
13812;Žemuogėlė;KIŠKUČIAI;4654060157;Taip;0;0;4;4
13813;Žemuogėlė;KIŠKUČIAI;2652630375;Ne;9;10;2;21
13814;Žemuogėlė;KIŠKUČIAI;1250186598;Ne;3;1;1;5
13815;Žemuogėlė;KIŠKUČIAI;3287415964;Ne;0;9;0;9
13816;Žemuogėlė;KIŠKUČIAI;5094867109;Ne;7;1;1;9
13817;Žemuogėlė;KIŠKUČIAI;5186248897;Ne;25;0;0;25
13818;Žemuogėlė;KIŠKUČIAI;5125826172;Taip;6;4;0;10
13819;Žemuogėlė;KIŠKUČIAI;8262862183;Ne;19;0;0;19
13820;Žemuogėlė;KIŠKUČIAI;1280794094;Ne;2;0;0;2
13821;Žemuogėlė;KIŠKUČIAI;2251142510;Ne;5;0;0;5
13822;Žemuogėlė;KIŠKUČIAI;1417355297;Ne;13;0;0;13
13823;Žemuogėlė;KIŠKUČIAI;4974793430;Ne;16;0;2;18
13824;Žemuogėlė;KIŠKUČIAI;6659616731;Ne;5;0;0;5
13825;Žemuogėlė;KIŠKUČIAI;3459960812;Ne;15;0;0;15
13826;Žemuogėlė;Žiniukai;7804015060;Ne;0;1;0;1
13827;Žemuogėlė;Žiniukai;3765022476;Ne;0;1;0;1
13828;Žemuogėlė;Žiniukai;2001471529;Ne;0;2;0;2
13829;Žemuogėlė;Žiniukai;5266493632;Ne;7;1;0;8
13830;Žemuogėlė;Žiniukai;2841634296;Ne;6;0;0;6
13831;Žemuogėlė;Žiniukai;3237083654;Ne;9;1;0;10
13832;Žemuogėlė;Žiniukai;2259779058;Ne;0;1;0;1
13833;Žemuogėlė;Žiniukai;9693894254;Ne;0;4;1;5
13834;Žemuogėlė;Žiniukai;9378432383;Ne;0;1;0;1
13835;Žemuogėlė;Žiniukai;6073971598;Ne;7;3;0;10
13836;Žemuogėlė;Žiniukai;6913038845;Ne;0;10;0;10
13837;Žemuogėlė;Žiniukai;6581889641;Ne;1;0;0;1
13838;Žemuogėlė;Žiniukai;2555902309;Ne;5;5;0;10
13839;Žemuogėlė;Žiniukai;8757701456;Taip;0;8;0;8
13840;Žemuogėlė;Žiniukai;2132549536;Ne;10;8;0;18
13841;Žemuogėlė;Žiniukai;5532053268;Ne;3;0;0;3
13842;Žemuogėlė;Žiniukai;8496353410;Ne;5;2;0;7
13843;Žemuogėlė;Žiniukai;1733808230;Ne;0;15;0;15
13844;Žemuogėlė;Žiniukai;4660479216;Taip;7;1;0;8
13845;Žibutė;PELĖDŽIUKAI;3496675605;Ne;0;1;0;1
13846;Žibutė;PELĖDŽIUKAI;59824395612;Ne;0;0;1;1
13847;Žibutė;PELĖDŽIUKAI;1259481487;Ne;0;1;0;1
13848;Žibutė;PELĖDŽIUKAI;3826875107;Ne;0;2;0;2
13849;Žibutė;PELĖDŽIUKAI;3186792146;Ne;0;0;10;10
13850;Žibutė;PELĖDŽIUKAI;7344095020;Ne;0;0;3;3
13851;Žibutė;PELĖDŽIUKAI;1078105287;Ne;0;1;0;1
13852;Žibutė;PELĖDŽIUKAI;1394895695;Ne;2;0;0;2
13853;Žibutė;PELĖDŽIUKAI;2236930916;Ne;9;0;0;9
13854;Žibutė;PELĖDŽIUKAI;2840754631;Ne;1;5;0;6
13855;Žibutė;PELĖDŽIUKAI;6089325755;Ne;2;4;0;6
13856;Žibutė;PELĖDŽIUKAI;1274409680;Ne;11;0;0;11
13857;Žibutė;PELĖDŽIUKAI;8278928396;Ne;6;0;1;7
13858;Žibutė;PELĖDŽIUKAI;2957525481;Ne;5;3;2;10
13859;Žibutė;PELĖDŽIUKAI;3191351976;Ne;0;0;4;4
13860;Žibutė;PELĖDŽIUKAI;6495108202;Ne;0;4;2;6
13861;Žibutė;KREGŽDUTĖS;7036454359;Ne;0;0;3;3
13862;Žibutė;KREGŽDUTĖS;2406005105;Ne;13;0;0;13
13863;Žibutė;KREGŽDUTĖS;3555071718;Ne;8;0;0;8
13864;Žibutė;KREGŽDUTĖS;5412917352;Ne;5;0;0;5
13865;Žibutė;KREGŽDUTĖS;5187777741;Ne;5;0;1;6
13866;Žibutė;KREGŽDUTĖS;5190377896;Taip;1;3;0;4
13867;Žibutė;KREGŽDUTĖS;6013340521;Ne;1;0;0;1
13868;Žibutė;KREGŽDUTĖS;3574946816;Ne;7;0;0;7
13869;Žibutė;KREGŽDUTĖS;6194464236;Ne;0;0;10;10
13870;Žibutė;KREGŽDUTĖS;3777544301;Ne;0;4;0;4
13871;Žibutė;KREGŽDUTĖS;9923687090;Ne;10;0;7;17
13872;Žibutė;KREGŽDUTĖS;4847295068;Ne;7;0;0;7
13873;Žibutė;KREGŽDUTĖS;9700866512;Ne;0;3;0;3
13874;Žibutė;KREGŽDUTĖS;7774532200;Ne;0;7;0;7
13875;Žibutė;KREGŽDUTĖS;2607509585;Ne;0;0;1;1
13876;Žibutė;KREGŽDUTĖS;8944042589;Ne;0;7;0;7
13877;Žibutė;KREGŽDUTĖS;2438980348;Ne;7;0;1;8
13878;Žibutė;KREGŽDUTĖS;9918283923;Ne;14;0;0;14
13879;Žibutė;KREGŽDUTĖS;5126232169;Ne;11;0;0;11
13880;Žibutė;KREGŽDUTĖS;8792292819;Ne;6;0;14;20
13881;Žibutė;KREGŽDUTĖS;7668484415;Ne;7;1;0;8
13882;Žibutė;KREGŽDUTĖS;2516448580;Ne;5;0;9;14
13883;Žibutė;BORUŽĖLĖS;4278832423;Ne;0;0;5;5
13884;Žibutė;BORUŽĖLĖS;3066580779;Ne;0;1;9;10
13885;Žibutė;BORUŽĖLĖS;2910188022;Ne;0;0;7;7
13886;Žibutė;BORUŽĖLĖS;8879347884;Ne;6;0;8;14
13887;Žibutė;BORUŽĖLĖS;7764376193;Ne;2;0;2;4
13888;Žibutė;BORUŽĖLĖS;3618347199;Ne;0;1;0;1
13889;Žibutė;BORUŽĖLĖS;2374119662;Ne;0;3;8;11
13890;Žibutė;BORUŽĖLĖS;1381488132;Ne;0;0;6;6
13891;Žibutė;BORUŽĖLĖS;5591970907;Ne;0;0;3;3
13892;Žibutė;BORUŽĖLĖS;6672033757;Ne;0;1;0;1
13893;Žibutė;BORUŽĖLĖS;7481695788;Ne;1;0;0;1
13894;Žibutė;BORUŽĖLĖS;1112295932;Ne;0;3;4;7
13895;Žibutė;BORUŽĖLĖS;5632520305;Ne;0;0;7;7
13896;Žibutė;BORUŽĖLĖS;4622674814;Ne;0;3;0;3
13897;Žibutė;BORUŽĖLĖS;7805758264;Ne;0;1;0;1
13898;Žibutė;BORUŽĖLĖS;8640664660;Ne;0;0;4;4
13899;Žibutė;BITUTĖS;7023683517;Ne;0;1;0;1
13900;Žibutė;BITUTĖS;7853531467;Ne;0;1;1;2
13901;Žibutė;BITUTĖS;3687123871;Ne;0;0;1;1
13902;Žibutė;BITUTĖS;2312717334;Ne;0;3;0;3
13903;Žibutė;BITUTĖS;6361543454;Ne;9;1;0;10
13904;Žibutė;BITUTĖS;6934760468;Ne;0;8;1;9
13905;Žibutė;BITUTĖS;4455757640;Ne;4;1;1;6
13906;Žibutė;BITUTĖS;8797870379;Ne;0;5;0;5
13907;Žibutė;BITUTĖS;7792267540;Ne;12;0;0;12
13908;Žibutė;BITUTĖS;9221523836;Ne;0;6;0;6
13909;Žibutė;BITUTĖS;3632745935;Ne;4;0;0;4
13910;Žibutė;BITUTĖS;7611641692;Ne;0;3;1;4
13911;Žibutė;BITUTĖS;5112512917;Ne;11;0;4;15
13912;Žibutė;BITUTĖS;4685356158;Ne;0;0;1;1
13913;Žibutė;BITUTĖS;1515636796;Ne;0;2;0;2
13914;Žibutė;BITUTĖS;7872636200;Ne;0;1;0;1
13915;Žibutė;BITUTĖS;6833179680;Ne;4;10;1;15
13916;Žibutė;BITUTĖS;1614551884;Ne;0;0;2;2
13917;Žibutė;KAČIUKAI;9868621666;Ne;2;0;2;4
13918;Žibutė;KAČIUKAI;1366469428;Ne;0;1;0;1
13919;Žibutė;KAČIUKAI;4825064521;Ne;5;0;12;17
13920;Žibutė;KAČIUKAI;5826523148;Ne;0;1;0;1
13921;Žibutė;KAČIUKAI;3957898269;Ne;0;1;0;1
13922;Žibutė;KAČIUKAI;4382812297;Ne;3;0;0;3
13923;Žibutė;KAČIUKAI;5591698130;Ne;5;0;0;5
13924;Žibutė;KAČIUKAI;7479437931;Ne;12;1;0;13
13925;Žibutė;KAČIUKAI;1362419302;Ne;0;1;0;1
13926;Žibutė;KAČIUKAI;7531027545;Ne;2;0;5;7
13927;Žibutė;KAČIUKAI;3645481894;Ne;3;0;3;6
13928;Žibutė;KAČIUKAI;8880329060;Ne;0;1;0;1
13929;Žibutė;KAČIUKAI;5009495840;Ne;5;1;0;6
13930;Žibutė;KAČIUKAI;7136145033;Ne;10;0;0;10
13931;Žibutė;KAČIUKAI;9498011134;Ne;0;0;1;1
13932;Žibutė;KAČIUKAI;5677389434;Ne;0;1;0;1
13933;Žibutė;KAČIUKAI;5416015554;Ne;6;0;1;7
13934;Žibutė;KAČIUKAI;6074488747;Ne;1;0;0;1
13935;Žibutė;ZUIKIAI;4741505387;Ne;20;0;0;20
13936;Žibutė;ZUIKIAI;6209156111;Ne;6;2;0;8
13937;Žibutė;ZUIKIAI;2787326978;Ne;5;1;6;12
13938;Žibutė;ZUIKIAI;9856822557;Ne;10;0;0;10
13939;Žibutė;ZUIKIAI;4787010953;Ne;0;4;0;4
13940;Žibutė;ZUIKIAI;9645026432;Ne;9;0;0;9
13941;Žibutė;ZUIKIAI;3875455223;Ne;3;3;1;7
13942;Žibutė;ZUIKIAI;3449188614;Ne;5;0;0;5
13943;Žibutė;ZUIKIAI;4434623264;Ne;0;10;0;10
13944;Žibutė;ZUIKIAI;9769180056;Ne;20;0;0;20
13945;Žibutė;ZUIKIAI;2013724729;Ne;3;0;0;3
13946;Žibutė;ZUIKIAI;3786933891;Ne;6;1;0;7
13947;Žibutė;ZUIKIAI;9439026609;Ne;19;1;0;20
13948;Žibutė;ZUIKIAI;6234135622;Ne;5;0;0;5
13949;Žibutė;ZUIKIAI;8585964720;Ne;9;0;0;9
13950;Žibutė;ZUIKIAI;6618315401;Ne;13;0;0;13
13951;Žiedas;Bitutės;1484464986;Ne;0;0;1;1
13952;Žiedas;Bitutės;4807479784;Ne;2;2;0;4
13953;Žiedas;Bitutės;5513311280;Ne;1;0;0;1
13954;Žiedas;Bitutės;1529988412;Ne;0;0;1;1
13955;Žiedas;Bitutės;1007894628;Ne;10;0;4;14
13956;Žiedas;Bitutės;1625009666;Ne;0;0;1;1
13957;Žiedas;Bitutės;1550350520;Ne;5;0;0;5
13958;Žiedas;Bitutės;9058688663;Ne;1;5;0;6
13959;Žiedas;Bitutės;3414702993;Ne;0;0;3;3
13960;Žiedas;Bitutės;1824692620;Ne;0;1;0;1
13961;Žiedas;Bitutės;2507543124;Ne;20;0;0;20
13962;Žiedas;Bitutės;88471315730;Ne;0;1;1;2
13963;Žiedas;Bitutės;34193530;Ne;0;1;0;1
13964;Žiedas;Bitutės;86877563124;Ne;2;0;4;6
13965;Žiedas;Bitutės;5108263139;Ne;7;0;1;8
13966;Žiedas;Bitutės;5885209631;Ne;0;0;6;6
13967;Žiedas;Bitutės;5007348884;Ne;4;0;0;4
13968;Žiedas;Varpeliai;7097790025;Taip;0;1;0;1
13969;Žiedas;Varpeliai;3230107921;Ne;0;11;0;11
13970;Žiedas;Varpeliai;3178778438;Ne;0;0;9;9
13971;Žiedas;Varpeliai;9602083568;Ne;5;0;2;7
13972;Žiedas;Varpeliai;5628720422;Ne;0;4;0;4
13973;Žiedas;Varpeliai;1582961378;Ne;3;2;1;6
13974;Žiedas;Varpeliai;6882614465;Ne;9;1;0;10
13975;Žiedas;Varpeliai;6515510381;Ne;0;1;0;1
13976;Žiedas;Varpeliai;3842589827;Ne;22;6;0;28
13977;Žiedas;Varpeliai;5835309107;Ne;3;0;0;3
13978;Žiedas;Varpeliai;3387263016;Ne;6;0;0;6
13979;Žiedas;Varpeliai;3178580610;Ne;0;3;0;3
13980;Žiedas;Varpeliai;1043230748;Ne;0;0;2;2
13981;Žiedas;Varpeliai;5061575884;Ne;10;0;0;10
13982;Žiedas;Varpeliai;1333233100;Ne;10;2;0;12
13983;Žiedas;Varpeliai;9020540780;Ne;4;0;0;4
13984;Žiedas;Varpeliai;8148831014;Ne;0;0;9;9
13985;Žiedas;Ramunėlės;1333555044;Ne;8;0;0;8
13986;Žiedas;Ramunėlės;2092319455;Taip;4;4;0;8
13987;Žiedas;Ramunėlės;5789261620;Taip;3;0;0;3
13988;Žiedas;Ramunėlės;3900091129;Ne;8;0;0;8
13989;Žiedas;Ramunėlės;2515028280;Taip;9;2;0;11
13990;Žiedas;Ramunėlės;1583038469;Taip;10;0;0;10
13991;Žiedas;Ramunėlės;8208331527;Ne;5;3;0;8
13992;Žiedas;Ramunėlės;9037835899;Ne;0;2;0;2
13993;Žiedas;Ramunėlės;5577339739;Taip;2;7;0;9
13994;Žiedas;Ramunėlės;6884933845;Ne;12;0;0;12
13995;Žiedas;Ramunėlės;7548653053;Taip;5;0;0;5
13996;Žiedas;Ramunėlės;2843328732;Taip;0;0;4;4
13997;Žiedas;Ramunėlės;1243169901;Ne;8;1;0;9
13998;Žiedas;Ramunėlės;1580781723;Ne;0;4;0;4
13999;Žiedas;Ramunėlės;4933650089;Ne;0;4;0;4
14000;Žiedas;Ramunėlės;4044156905;Taip;5;0;3;8
14001;Žiedas;Ramunėlės;4844442247;Ne;0;2;0;2
14002;Žiedas;Ramunėlės;7294671324;Ne;1;0;0;1
14003;Žiedas;Ramunėlės;8812316692;Taip;0;1;0;1
14004;Žiedas;Pakalnutės;7798930533;Ne;5;6;0;11
14005;Žiedas;Pakalnutės;1094506858;Ne;10;2;0;12
14006;Žiedas;Pakalnutės;9375048835;Ne;8;3;0;11
14007;Žiedas;Pakalnutės;5266048033;Ne;14;2;0;16
14008;Žiedas;Pakalnutės;5804334198;Ne;3;0;0;3
14009;Žiedas;Pakalnutės;1721956438;Ne;8;1;0;9
14010;Žiedas;Pakalnutės;4808020243;Ne;2;0;0;2
14011;Žiedas;Pakalnutės;3742949697;Ne;11;0;0;11
14012;Žiedas;Pakalnutės;6343634478;Taip;0;3;0;3
14013;Žiedas;Pakalnutės;8015880569;Ne;0;1;0;1
14014;Žiedas;Pakalnutės;8857150598;Ne;8;2;0;10
14015;Žiedas;Pakalnutės;2416234016;Ne;3;1;0;4
14016;Žiedas;Pakalnutės;9054709268;Ne;6;2;0;8
14017;Žiedas;Pakalnutės;9964883646;Ne;0;2;0;2
14018;Žiedas;Pakalnutės;4021189767;Ne;4;2;1;7
14019;Žiedas;Pakalnutės;1346658299;Ne;9;4;0;13
14020;Žiedas;Pakalnutės;4697477761;Ne;2;0;0;2
14021;Žiedas;Pakalnutės;7678333395;Ne;3;0;0;3
14022;Žiedas;Pakalnutės;9207945616;Ne;4;2;0;6
14023;Žiedas;Pakalnutės;7221702677;Ne;3;1;0;4
14024;Žiedas;Pakalnutės;2393112381;Ne;0;2;0;2
14025;Žiedas;Rožytės;8846443535;Ne;0;2;0;2
14026;Žiedas;Rožytės;8645771800;Ne;0;0;4;4
14027;Žiedas;Rožytės;7942276632;Taip;0;2;0;2
14028;Žiedas;Rožytės;7799489700;Ne;0;16;0;16
14029;Žiedas;Rožytės;2182381160;Ne;5;0;0;5
14030;Žiedas;Rožytės;9021286246;Ne;0;7;0;7
14031;Žiedas;Rožytės;6261847845;Ne;0;1;0;1
14032;Žiedas;Rožytės;5020148822;Ne;1;0;1;2
14033;Žiedas;Rožytės;1777501190;Ne;0;1;0;1
14034;Žiedas;Rožytės;6459679214;Ne;0;10;0;10
14035;Žiedas;Rožytės;3984607857;Taip;1;2;1;4
14036;Žiedas;Rožytės;6041919197;Ne;0;1;2;3
14037;Žiedas;Pumpurėliai;5830738378;Ne;10;5;1;16
14038;Žiedas;Pumpurėliai;4360175072;Ne;3;0;1;4
14039;Žiedas;Pumpurėliai;7780469974;Ne;7;0;0;7
14040;Žiedas;Pumpurėliai;9337317396;Ne;4;2;0;6
14041;Žiedas;Pumpurėliai;1086714229;Ne;9;3;0;12
14042;Žiedas;Pumpurėliai;2320411618;Ne;0;1;0;1
14043;Žiedas;Pumpurėliai;8861734370;Taip;0;5;0;5
14044;Žiedas;Pumpurėliai;5635958124;Ne;0;3;0;3
14045;Žiedas;Pumpurėliai;7677595571;Ne;0;7;0;7
14046;Žiedas;Pumpurėliai;4699833757;Ne;14;3;0;17
14047;Žiedas;Pumpurėliai;8797245208;Ne;12;0;0;12
14048;Žiedas;DOBILIUKAI;9750690920;Ne;7;0;0;7
14049;Žiedas;"Dobiliukai ";9413654318;Ne;6;0;0;6
14050;Žiedas;"Dobiliukai ";6066566242;Ne;15;0;0;15
14051;Žiedas;"Dobiliukai ";8436592169;Ne;7;1;0;8
14052;Žiedas;"Dobiliukai ";3654878543;Ne;1;0;1;2
14053;Žiedas;"Dobiliukai ";8794003030;Ne;5;0;0;5
14054;Žiedas;"Dobiliukai ";8444690698;Ne;0;0;8;8
14055;Žiedas;"Dobiliukai ";2715554681;Taip;9;0;1;10
14056;Žiedas;"Dobiliukai ";2132564079;Ne;9;0;6;15
14057;Žiedas;"Dobiliukai ";9586578606;Taip;1;2;0;3
14058;Žiedas;"Dobiliukai ";3940002957;Taip;0;1;0;1
14059;Žiedas;"Dobiliukai ";5353507617;Ne;11;0;1;12
14060;Žiedas;"Dobiliukai ";4087903129;Ne;4;0;0;4
14061;Žiedas;"Dobiliukai ";8185042446;Ne;1;0;0;1
14062;Žiedas;"Dobiliukai ";7049399327;Ne;10;0;0;10
14063;Žiedas;"Dobiliukai ";5788152675;Ne;16;0;0;16
14064;Žiedas;"Dobiliukai ";8388297947;Ne;4;0;0;4
14065;Žiedas;"Dobiliukai ";3011163947;Ne;20;0;0;20
14066;Žiedas;"Dobiliukai ";6748378606;Ne;5;0;0;5
14067;Žiedas;"Dobiliukai ";7558307454;Ne;11;0;0;11
14068;Žiedas;"Dobiliukai ";6795173519;Ne;9;0;0;9
14069;Žiedas;RŪTELĖS;6822887260;Ne;0;7;0;7
14070;Žiedas;RŪTELĖS;5914428064;Ne;0;3;0;3
14071;Žiedas;RŪTELĖS;3857121753;Taip;0;6;0;6
14072;Žiedas;RŪTELĖS;6443633568;Ne;0;2;0;2
14073;Žiedas;RŪTELĖS;5959899914;Ne;0;10;0;10
14074;Žiedas;RŪTELĖS;7333813704;Ne;0;2;0;2
14075;Žiedas;RŪTELĖS;5126173608;Ne;2;2;2;6
14076;Žiedas;RŪTELĖS;1738121071;Ne;0;1;0;1
14077;Žiedas;RŪTELĖS;5420327672;Ne;0;1;0;1
14078;Žiedas;RŪTELĖS;4497634040;Ne;0;3;0;3
14079;Žiedas;RŪTELĖS;9218388800;Ne;5;2;0;7
14080;Žiedas;RŪTELĖS;7072578987;Ne;10;2;4;16
14081;Žiedas;RŪTELĖS;3715928992;Ne;0;1;0;1
14082;Žiedas;RŪTELĖS;9352485926;Ne;0;2;0;2
14083;Žiedas;RŪTELĖS;7578964555;Ne;0;3;0;3
14084;Žiedas;RŪTELĖS;5928377774;Ne;0;2;1;3
14085;Žiedas;SAULĖGRĄŽOS;8887021328;Ne;6;0;0;6
14086;Žiedas;SAULĖGRĄŽOS;2932857132;Ne;1;1;0;2
14087;Žiedas;SAULĖGRĄŽOS;5552786845;Ne;10;2;1;13
14088;Žiedas;SAULĖGRĄŽOS;8833895006;Ne;5;7;0;12
14089;Žiedas;SAULĖGRĄŽOS;5658235821;Ne;15;0;0;15
14090;Žiedas;SAULĖGRĄŽOS;4992446383;Ne;8;1;0;9
14091;Žiedas;SAULĖGRĄŽOS;1645402434;Ne;7;0;0;7
14092;Žiedas;SAULĖGRĄŽOS;2026540724;Ne;0;6;0;6
14093;Žiedas;SAULĖGRĄŽOS;4564268323;Ne;0;4;0;4
14094;Žiedas;SAULĖGRĄŽOS;1609487830;Ne;6;1;0;7
14095;Žiedas;SAULĖGRĄŽOS;3437651010;Ne;6;0;11;17
14096;Žiedas;SAULĖGRĄŽOS;3422053505;Ne;5;2;0;7
14097;Žiedas;SAULĖGRĄŽOS;5274845525;Ne;0;1;0;1
14098;Žiedas;SAULĖGRĄŽOS;9685152753;Ne;10;0;0;10
14099;Žiedas;SAULĖGRĄŽOS;8819018248;Ne;0;5;0;5
14100;Žiedas;SAULĖGRĄŽOS;3303581707;Ne;6;1;0;7
14101;Žiedas;RUGIAGĖLĖS;1035854293;Ne;0;0;1;1
14102;Žiedas;RUGIAGĖLĖS;1917085385;Ne;4;1;0;5
14103;Žiedas;RUGIAGĖLĖS;5987689515;Ne;1;0;5;6
14104;Žiedas;RUGIAGĖLĖS;1826599535;Ne;7;0;0;7
14105;Žiedas;RUGIAGĖLĖS;3477341028;Ne;0;7;0;7
14106;Žiedas;RUGIAGĖLĖS;2124086277;Ne;0;0;1;1
14107;Žiedas;RUGIAGĖLĖS;2642760082;Ne;11;0;0;11
14108;Žiedas;RUGIAGĖLĖS;1093479755;Ne;6;0;2;8
14109;Žiedas;RUGIAGĖLĖS;7381658912;Ne;9;1;0;10
14110;Žiedas;RUGIAGĖLĖS;7228139235;Ne;7;0;0;7
14111;Žiedas;RUGIAGĖLĖS;2312361963;Ne;10;1;1;12
14112;Žiedas;RUGIAGĖLĖS;6859410675;Ne;5;7;0;12
14113;Žiedas;RUGIAGĖLĖS;2148027253;Taip;8;0;2;10
14114;Žiedas;RUGIAGĖLĖS;1758868055;Ne;3;0;1;4
14115;Žiedas;RUGIAGĖLĖS;2182340305;Taip;0;1;0;1
14116;Žiedas;RUGIAGĖLĖS;1958481432;Ne;2;0;0;2
14117;Žiedas;RUGIAGĖLĖS;3099608553;Ne;8;1;0;9
14118;Žiedas;RUGIAGĖLĖS;9393499257;Ne;1;2;0;3
14119;Žiedas;RUGIAGĖLĖS;2170318597;Ne;1;0;0;1
14120;Žiedas;RUGIAGĖLĖS;8276022676;Ne;5;0;0;5
14121;Žiedas;Boružėlės;2095655987;Ne;0;1;0;1
14122;Žiedas;Boružėlės;7814504623;Ne;5;0;1;6
14123;Žiedas;Boružėlės;9648580306;Ne;0;7;0;7
14124;Žiedas;Boružėlės;9699668892;Ne;0;1;0;1
14125;Žiedas;Boružėlės;5653785844;Ne;7;0;0;7
14126;Žiedas;Boružėlės;9247088735;Ne;0;0;3;3
14127;Žiedas;Boružėlės;7396006218;Ne;0;1;0;1
14128;Žiedas;Boružėlės;5588136738;Ne;0;3;0;3
14129;Žiedas;Boružėlės;6786526552;Ne;3;1;0;4
14130;Žiedas;Boružėlės;6432090199;Ne;6;5;0;11
14131;Žiedas;Boružėlės;5626494892;Ne;0;2;0;2
14132;Žiedas;Boružėlės;3702078720;Ne;3;0;0;3
14133;Žiedas;Boružėlės;2849254119;Ne;19;2;2;23
14134;Žiedas;Boružėlės;9736967156;Ne;0;2;1;3
14135;Žiedas;Boružėlės;3586376571;Ne;0;3;0;3
14136;Žiedas;Boružėlės;1139186052;Ne;0;0;2;2
14137;Žiedas;Boružėlės;3704491209;Ne;4;0;0;4
14138;Žiedas;AGUONĖLĖS;1885623466;Ne;16;0;0;16
14139;Žiedas;AGUONĖLĖS;9464217926;Ne;0;2;0;2
14140;Žiedas;AGUONĖLĖS;9543860953;Ne;10;0;0;10
14141;Žiedas;AGUONĖLĖS;3247328978;Ne;10;0;0;10
14142;Žiedas;AGUONĖLĖS;4250009129;Ne;17;0;0;17
14143;Žiedas;AGUONĖLĖS;7399937598;Ne;6;5;0;11
14144;Žiedas;AGUONĖLĖS;1325715061;Ne;5;0;0;5
14145;Žiedas;AGUONĖLĖS;9111149805;Ne;13;0;0;13
14146;Žiedas;AGUONĖLĖS;4695900874;Ne;13;0;0;13
14147;Žiedas;AGUONĖLĖS;3258241663;Ne;9;0;0;9
14148;Žiedas;AGUONĖLĖS;6700593422;Ne;19;0;0;19
14149;Žiedas;AGUONĖLĖS;7535993061;Ne;0;1;0;1
14150;Žiedas;AGUONĖLĖS;1956219718;Ne;2;1;0;3
14151;Žiedas;AGUONĖLĖS;4809093267;Ne;0;2;0;2
14152;Žiedas;AGUONĖLĖS;1874460511;Ne;10;0;0;10
14153;Žiedas;AGUONĖLĖS;6856477482;Ne;17;0;0;17
14154;Žiedas;ŽIBUTĖS;8638720939;Ne;5;0;0;5
14155;Žiedas;ŽIBUTĖS;3654749109;Ne;0;4;0;4
14156;Žiedas;ŽIBUTĖS;4039958043;Ne;5;0;0;5
14157;Žiedas;ŽIBUTĖS;1835893385;Ne;20;0;0;20
14158;Žiedas;ŽIBUTĖS;2913328259;Ne;10;0;0;10
14159;Žiedas;ŽIBUTĖS;7418985667;Ne;6;0;0;6
14160;Žiedas;ŽIBUTĖS;2097392327;Ne;0;0;1;1
14161;Žiedas;ŽIBUTĖS;9269909624;Ne;12;0;0;12
14162;Žiedas;ŽIBUTĖS;7114207461;Ne;10;0;2;12
14163;Žiedas;ŽIBUTĖS;5106427067;Taip;0;2;0;2
14164;Žiedas;ŽIBUTĖS;3407247493;Ne;6;0;0;6
14165;Žiedas;ŽIBUTĖS;8084555994;Taip;8;0;1;9
14166;Žiedas;ŽIBUTĖS;7613786936;Taip;20;0;0;20
14167;Žiedas;ŽIBUTĖS;1669599543;Taip;19;0;0;19
14168;Žiedas;ŽIBUTĖS;1509140770;Ne;0;1;0;1
14169;Žiedas;ŽIBUTĖS;7498211984;Ne;6;0;0;6
14170;Žiedas;DRUGELIAI;8517250094;Ne;0;5;0;5
14171;Žiedas;DRUGELIAI;2763469583;Ne;0;2;0;2
14172;Žiedas;DRUGELIAI;9757771445;Ne;6;5;0;11
14173;Žiedas;DRUGELIAI;4222689492;Ne;0;1;0;1
14174;Žiedas;DRUGELIAI;2763996098;Ne;9;0;0;9
14175;Žiedas;DRUGELIAI;4983852075;Ne;0;1;0;1
14176;Žiedas;DRUGELIAI;9129315784;Ne;0;8;0;8
14177;Žiedas;DRUGELIAI;7952899220;Taip;4;2;0;6
14178;Žiedas;DRUGELIAI;2679205188;Ne;4;0;2;6
14179;Žiedas;DRUGELIAI;2026462074;Ne;4;1;0;5
14180;Žiedas;DRUGELIAI;4749655084;Ne;0;0;1;1
14181;Žilvitis;ŽIOGELIAI;8776206514;Ne;15;0;0;15
14182;Žilvitis;ŽIOGELIAI;6686719056;Ne;5;0;0;5
14183;Žilvitis;ŽIOGELIAI;1494531594;Ne;6;0;0;6
14184;Žilvitis;ŽIOGELIAI;3753646163;Ne;1;0;0;1
14185;Žilvitis;KREGŽDUTĖS;4074309193;Ne;5;0;0;5
14186;Žilvitis;KREGŽDUTĖS;9192673832;Ne;6;0;0;6
14187;Žilvitis;BORUŽĖLĖS;6048530704;Ne;3;0;0;3
14188;Žilvitis;BORUŽĖLĖS;9983043090;Taip;6;0;0;6
14189;Žilvitis;BORUŽĖLĖS;7829207612;Ne;3;0;0;3
14190;Žilvitis;BITUČIŲ;4158933782;Ne;9;0;0;9
14191;Žilvitis;BITUČIŲ;9780232059;Ne;4;0;0;4
14192;Žilvitis;KATINĖLIŲ;7157932299;Ne;4;0;0;4
14193;Žilvitis;MEŠKIUKŲ;8176348935;Ne;11;0;0;11
14194;Žilvitis;MEŠKIUKŲ;3216967815;Ne;5;0;0;5
14195;Žilvitis;MEŠKIUKŲ;5652006567;Ne;13;0;0;13
14196;Žilvitis;MEŠKIUKŲ;5882987937;Ne;5;0;0;5
14197;Žilvitis;VOVERIUKAI;8966682808;Ne;7;0;0;7
14198;Žilvitis;VOVERIUKAI;8931585095;Ne;9;0;0;9
14199;Žilvitis;VOVERIUKAI;1310073061;Ne;9;0;0;9
14200;Žilvitis;VOVERIUKAI;6695034600;Ne;5;0;0;5
14201;Žilvitis;SVAJOKLIAI;2678540206;Ne;14;0;0;14
14202;Žilvitis;SVAJOKLIAI;7926884684;Ne;7;0;0;7
14203;Žilvitis;SVAJOKLIAI;3474007327;Ne;12;0;0;12
14204;Žilvitis;SVAJOKLIAI;9177441278;Ne;12;0;0;12
14205;Žilvitis;SVAJOKLIAI;9495417427;Ne;6;0;0;6
14206;Žilvitis;SVAJOKLIAI;1139159071;Ne;6;0;0;6
14207;Žilvitis;PELĖDŽIUKAI;1248507608;Ne;13;0;0;13
14208;Žilvitis;PELĖDŽIUKAI;5233588745;Ne;7;0;0;7
14209;Žilvitis;PELĖDŽIUKAI;2908294931;Ne;15;0;0;15
14210;Žilvitis;LAŠELIAI;8324405560;Ne;5;0;0;5
14211;Žilvitis;LAŠELIAI;6029182096;Ne;9;0;0;9
14212;Žilvitis;LAŠELIAI;5372458087;Ne;11;0;0;11
14213;Žilvitis;LAŠELIAI;3122232547;Ne;4;0;0;4
14214;Žilvitis;LAŠELIAI;3994140420;Ne;12;0;0;12
14215;Žilvitis;SKRUZDĖLIUKAI;9319247575;Ne;4;0;0;4
14216;Žilvitis;SKRUZDĖLIUKAI;5719080805;Ne;6;0;0;6
14217;Žilvitis;SKRUZDĖLIUKAI;7042232320;Ne;4;0;0;4
14218;Žilvitis;SKRUZDĖLIUKAI;6054222822;Ne;12;0;0;12
14219;Žilvinėlio;SAULUTĖS;93987159767;Ne;6;0;0;6
14220;Žilvinėlio;SAULUTĖS;9323760111;Ne;7;0;0;7
14221;Žilvinėlio;UOSIUKAI;4189079983;Ne;5;0;0;5
14222;Žilvinėlio;UOSIUKAI;6629672531;Ne;4;0;0;4
14223;Žilvinėlio;BANGELĖS;1443433546;Ne;8;0;0;8
14224;Žilvinėlio;BANGELĖS;4321916674;Ne;10;0;0;10
14225;Žilvinėlio;RAMUNIUKAI;3225180564;Ne;9;0;0;9
14226;Žilvinėlio;ŽUVYČIŲ;4232223600;Ne;1;0;0;1
14227;Žilvinėlio;EGLUTĖS;7919935370;Ne;9;0;0;9
14228;Žilvinėlio;EGLUTĖS;6273559641;Ne;14;0;0;14
14229;Žilvinėlio;EGLUTĖS;7624190955;Ne;7;0;0;7
14230;Žilvinėlio;EGLUTĖS;1748279425;Ne;11;0;0;11
14231;Žilvinėlio;GINTARĖLIAI;6902924243;Ne;5;0;0;5
14232;Žilvinėlio;GINTARĖLIAI;5901272288;Ne;10;0;0;10
14233;Žilvinėlio;PAUKŠTELIAI;3889484251;Ne;7;0;0;7
14234;Žilvinėlio;DREBULIUKAI;7816896487;Ne;1;0;0;1
14235;Žilvinėlio;DREBULIUKAI;5444902879;Ne;3;0;0;3
14236;Žilvinėlio;DREBULIUKAI;2749622870;Ne;8;0;0;8
14237;Žilvinėlio;DREBULIUKAI;4621511107;Ne;6;0;0;6
14238;Žilvinėlio;ĄŽUOLIUKAI;8326996805;Ne;2;0;0;2
14239;Žilvinėlio;ĄŽUOLIUKAI;9472207355;Ne;7;0;0;7
14240;Žilvinėlio;DRUGELIAI;6861762242;Ne;7;0;0;7
14241;Žiogelis;SKRUZDELYTĖS;2959983278;Ne;14;0;0;14
14242;Žiogelis;SKRUZDELYTĖS;6165380986;Ne;1;0;0;1
14243;Žiogelis;SKRUZDELYTĖS;8410428124;Ne;9;0;0;9
14244;Žiogelis;SKRUZDELYTĖS;3214640817;Ne;0;12;0;12
14245;Žiogelis;SKRUZDELYTĖS;1937740173;Ne;7;2;0;9
14246;Žiogelis;SKRUZDELYTĖS;5737326104;Ne;15;0;0;15
14247;Žiogelis;SKRUZDELYTĖS;7107814348;Ne;0;6;0;6
14248;Žiogelis;SKRUZDELYTĖS;9243862028;Ne;0;3;0;3
14249;Žiogelis;SKRUZDELYTĖS;7395901559;Ne;0;5;0;5
14250;Žiogelis;SKRUZDELYTĖS;9819352425;Ne;2;2;0;4
14251;Žiogelis;SKRUZDELYTĖS;8780773039;Ne;0;14;0;14
14252;Žiogelis;SKRUZDELYTĖS;7881734492;Ne;1;0;0;1
14253;Žiogelis;SKRUZDELYTĖS;2701091043;Ne;0;5;0;5
14254;Žiogelis;SKRUZDELYTĖS;9120836406;Ne;0;0;1;1
14255;Žiogelis;SKRUZDELYTĖS;6742462116;Ne;0;16;0;16
14256;Žiogelis;SKRUZDELYTĖS;8763533677;Ne;7;1;0;8
14257;Žiogelis;SKRUZDELYTĖS;6608146625;Ne;0;3;0;3
14258;Žiogelis;SKRUZDELYTĖS;9035254979;Ne;15;0;1;16
14259;Žiogelis;ŽIRNIUKAI;2348525913;Ne;10;0;4;14
14260;Žiogelis;ŽIRNIUKAI;2771911603;Ne;7;0;0;7
14261;Žiogelis;ŽIRNIUKAI;6617995346;Ne;4;0;1;5
14262;Žiogelis;ŽIRNIUKAI;7936785905;Taip;0;5;0;5
14263;Žiogelis;ŽIRNIUKAI;9142952548;Ne;0;0;8;8
14264;Žiogelis;ŽIRNIUKAI;4450344120;Ne;0;0;5;5
14265;Žiogelis;ŽIRNIUKAI;8998694866;Ne;6;0;3;9
14266;Žiogelis;ŽIRNIUKAI;3472310047;Ne;4;0;0;4
14267;Žiogelis;ŽIRNIUKAI;8018943297;Ne;0;1;0;1
14268;Žiogelis;ŽIRNIUKAI;2463360858;Ne;5;0;0;5
14269;Žiogelis;ŽIRNIUKAI;1067136657;Ne;12;1;0;13
14270;Žiogelis;ŽIRNIUKAI;9672307977;Ne;0;0;5;5
14271;Žiogelis;ŽIRNIUKAI;5337641310;Ne;0;0;1;1
14272;Žiogelis;ŽIRNIUKAI;4755709634;Ne;5;0;0;5
14273;Žiogelis;ŽIRNIUKAI;2833768296;Ne;5;0;0;5
14274;Žiogelis;ŽIRNIUKAI;6857937795;Ne;1;0;3;4
14275;Žiogelis;ŽIRNIUKAI;9918493914;Ne;4;0;0;4
14276;Žiogelis;ŽIRNIUKAI;3516143432;Ne;5;0;0;5
14277;Žiogelis;ŽIRNIUKAI;5223426277;Ne;10;0;0;10
14278;Žiogelis;ŽIRNIUKAI;3628571567;Ne;0;5;0;5
14279;Žiogelis;DOBILĖLIAI;8683148826;Ne;0;9;0;9
14280;Žiogelis;DOBILĖLIAI;2117192553;Ne;1;0;1;2
14281;Žiogelis;DOBILĖLIAI;1465027680;Ne;8;0;2;10
14282;Žiogelis;DOBILĖLIAI;6495456608;Ne;0;1;0;1
14283;Žiogelis;DOBILĖLIAI;5364996984;Ne;4;0;2;6
14284;Žiogelis;DOBILĖLIAI;9568208184;Ne;4;0;2;6
14285;Žiogelis;DOBILĖLIAI;6340620973;Ne;0;0;4;4
14286;Žiogelis;DOBILĖLIAI;5961630249;Ne;11;0;0;11
14287;Žiogelis;DOBILĖLIAI;6532218580;Ne;2;0;1;3
14288;Žiogelis;DOBILĖLIAI;1763070523;Ne;0;5;0;5
14289;Žiogelis;DOBILĖLIAI;9610249055;Ne;0;2;0;2
14290;Žiogelis;DOBILĖLIAI;6115834138;Ne;4;0;4;8
14291;Žiogelis;DOBILĖLIAI;3887222613;Ne;11;1;0;12
14292;Žiogelis;DOBILĖLIAI;7065052244;Ne;0;0;5;5
14293;Žiogelis;DOBILĖLIAI;3427704550;Ne;0;0;1;1
14294;Žiogelis;DOBILĖLIAI;4103035195;Ne;5;1;0;6
14295;Žiogelis;BORUŽĖLĖS;24941867247;Ne;0;1;0;1
14296;Žiogelis;BORUŽĖLĖS;8819549855;Ne;0;8;2;10
14297;Žiogelis;BORUŽĖLĖS;3503872654;Ne;0;1;0;1
14298;Žiogelis;BORUŽĖLĖS;4445888917;Ne;0;1;0;1
14299;Žiogelis;BORUŽĖLĖS;8702710674;Ne;0;2;0;2
14300;Žiogelis;BORUŽĖLĖS;4671356872;Ne;5;0;0;5
14301;Žiogelis;BORUŽĖLĖS;18018505301;Ne;0;2;0;2
14302;Žiogelis;BORUŽĖLĖS;3750023611;Ne;0;4;2;6
14303;Žiogelis;BORUŽĖLĖS;4343510173;Ne;0;7;0;7
14304;Žiogelis;BORUŽĖLĖS;6659086172;Ne;0;2;0;2
14305;Žiogelis;BORUŽĖLĖS;3203359908;Ne;0;7;0;7
14306;Žiogelis;BORUŽĖLĖS;3320077143;Ne;0;1;0;1
14307;Žiogelis;BORUŽĖLĖS;1160064257;Ne;6;0;0;6
14308;Žiogelis;BORUŽĖLĖS;60959051938;Ne;0;1;0;1
14309;Žiogelis;BORUŽĖLĖS;1609336147;Ne;0;1;0;1
14310;Žiogelis;BORUŽĖLĖS;6346503991;Ne;0;0;10;10
14311;Žiogelis;BORUŽĖLĖS;3560637865;Ne;0;9;0;9
14312;Žiogelis;BORUŽĖLĖS;3420228264;Ne;0;1;0;1
14313;Žiogelis;BORUŽĖLĖS;1996517542;Ne;0;7;0;7
14314;Žiogelis;BORUŽĖLĖS;6760074113;Ne;0;0;4;4
14315;Žiogelis;DRUGELIAI;2797078863;Ne;16;0;0;16
14316;Žiogelis;DRUGELIAI;3813592739;Ne;4;1;1;6
14317;Žiogelis;DRUGELIAI;3820406417;Ne;20;0;0;20
14318;Žiogelis;DRUGELIAI;9533670829;Ne;7;1;0;8
14319;Žiogelis;DRUGELIAI;1673279182;Ne;11;0;0;11
14320;Žiogelis;DRUGELIAI;9964121573;Ne;1;5;0;6
14321;Žiogelis;DRUGELIAI;9717527407;Ne;5;0;1;6
14322;Žiogelis;DRUGELIAI;2622354022;Ne;0;6;0;6
14323;Žiogelis;DRUGELIAI;2243541285;Ne;16;1;0;17
14324;Žiogelis;DRUGELIAI;3810309354;Ne;0;1;0;1
14325;Žiogelis;DRUGELIAI;2326799191;Ne;12;0;0;12
14326;Žiogelis;DRUGELIAI;7974212517;Ne;9;5;0;14
14327;Žiogelis;DRUGELIAI;9423979719;Ne;9;5;0;14
14328;Žiogelis;DRUGELIAI;1833992163;Ne;17;0;0;17
14329;Žiogelis;DRUGELIAI;2529171444;Ne;0;1;0;1
14330;Žiogelis;DRUGELIAI;4946802677;Ne;9;0;0;9
14331;Žiogelis;PELĖDŽIUKAI;7502572217;Ne;0;2;1;3
14332;Žiogelis;PELĖDŽIUKAI;5876904663;Ne;0;0;1;1
14333;Žiogelis;PELĖDŽIUKAI;8217782981;Ne;14;1;0;15
14334;Žiogelis;PELĖDŽIUKAI;7120126547;Ne;0;2;1;3
14335;Žiogelis;PELĖDŽIUKAI;9387048672;Ne;7;8;0;15
14336;Žiogelis;PELĖDŽIUKAI;4378941619;Ne;0;1;0;1
14337;Žiogelis;PELĖDŽIUKAI;3937261260;Ne;0;2;0;2
14338;Žiogelis;PELĖDŽIUKAI;8873231715;Ne;0;0;3;3
14339;Žiogelis;PELĖDŽIUKAI;8894068297;Ne;0;3;0;3
14340;Žiogelis;PELĖDŽIUKAI;2759766559;Ne;1;14;0;15
14341;Žiogelis;PELĖDŽIUKAI;2160862681;Ne;7;0;0;7
14342;Žiogelis;PELĖDŽIUKAI;7725494899;Ne;0;2;0;2
14343;Žiogelis;PELĖDŽIUKAI;1223396469;Ne;0;2;0;2
14344;Žiogelis;PELĖDŽIUKAI;3500076229;Ne;0;3;0;3
14345;Žiogelis;PELĖDŽIUKAI;8715501524;Ne;0;2;7;9
14346;Žiogelis;VARPELIAI;7888873296;Ne;0;6;0;6
14347;Žiogelis;VARPELIAI;3520393042;Ne;0;8;0;8
14348;Žiogelis;VARPELIAI;8983731310;Ne;3;5;0;8
14349;Žiogelis;VARPELIAI;1954544417;Ne;4;3;0;7
14350;Žiogelis;VARPELIAI;6716558946;Ne;3;0;0;3
14351;Žiogelis;VARPELIAI;1035890284;Ne;10;1;0;11
14352;Žiogelis;VARPELIAI;9385596579;Ne;7;2;0;9
14353;Žiogelis;VARPELIAI;1447349850;Ne;0;3;0;3
14354;Žiogelis;VARPELIAI;3752358694;Ne;11;1;0;12
14355;Žiogelis;VARPELIAI;6402784913;Ne;12;1;0;13
14356;Žiogelis;VARPELIAI;3502278745;Ne;0;1;0;1
14357;Žiogelis;VARPELIAI;4462189852;Ne;0;6;0;6
14358;Žiogelis;VARPELIAI;9470241656;Ne;18;0;0;18
14359;Žiogelis;VARPELIAI;8133583992;Ne;4;5;0;9
14360;Žiogelis;VARPELIAI;2346231162;Ne;12;0;0;12
14361;Žiogelis;VARPELIAI;6658457517;Ne;7;0;0;7
14362;Žiogelis;VARPELIAI;6650891980;Ne;25;1;0;26
14363;Žiogelis;VARPELIAI;5076511003;Ne;8;0;0;8
14364;Žiogelis;VARPELIAI;1139259000;Ne;17;0;0;17
14365;Žiogelis;VARPELIAI;7992701275;Ne;0;2;0;2
14366;Žiogelis;KREGŽDUTĖS;1309122110;Ne;6;0;0;6
14367;Žiogelis;KREGŽDUTĖS;7704256764;Ne;0;1;0;1
14368;Žiogelis;KREGŽDUTĖS;6697117406;Ne;5;0;1;6
14369;Žiogelis;KREGŽDUTĖS;2028383677;Ne;0;3;0;3
14370;Žiogelis;KREGŽDUTĖS;3910954904;Ne;0;5;0;5
14371;Žiogelis;KREGŽDUTĖS;2233244282;Ne;1;0;0;1
14372;Žiogelis;KREGŽDUTĖS;9862582346;Ne;0;2;2;4
14373;Žiogelis;KREGŽDUTĖS;1320651707;Ne;0;6;0;6
14374;Žiogelis;KREGŽDUTĖS;85437321236;Ne;3;0;0;3
14375;Žiogelis;KREGŽDUTĖS;1320126836;Ne;0;1;0;1
14376;Žiogelis;KREGŽDUTĖS;3310492752;Ne;0;5;0;5
14377;Žiogelis;KREGŽDUTĖS;2366095661;Ne;4;0;2;6
14378;Žiogelis;KREGŽDUTĖS;8675451323;Ne;4;4;0;8
14379;Žiogelis;KREGŽDUTĖS;7087781379;Ne;0;2;0;2
14380;Žiogelis;KREGŽDUTĖS;4015109974;Ne;0;2;0;2
14381;Žiogelis;KREGŽDUTĖS;14932261911;Ne;3;2;2;7
14382;Žiogelis;KREGŽDUTĖS;4713696984;Ne;0;4;0;4
14383;Žiogelis;KREGŽDUTĖS;1442866468;Ne;5;0;0;5
14384;Žiogelis;KREGŽDUTĖS;1660784232;Ne;2;0;2;4
14385;Žiogelis;KREGŽDUTĖS;5579709130;Ne;0;2;0;2
14386;Žiogelis;KREGŽDUTĖS;5340501392;Ne;0;7;0;7
14387;Žiogelis;KREGŽDUTĖS;8979747150;Ne;8;2;0;10
14388;Žiogelis;ŽVIRBLIUKAI;9769735869;Ne;15;0;0;15
14389;Žiogelis;ŽVIRBLIUKAI;1106149118;Ne;0;2;0;2
14390;Žiogelis;ŽVIRBLIUKAI;9842311161;Ne;11;0;0;11
14391;Žiogelis;ŽVIRBLIUKAI;5475797764;Ne;10;0;0;10
14392;Žiogelis;ŽVIRBLIUKAI;2036243422;Ne;6;2;0;8
14393;Žiogelis;ŽVIRBLIUKAI;9634291623;Ne;10;1;0;11
14394;Žiogelis;ŽVIRBLIUKAI;7802165127;Taip;0;3;0;3
14395;Žiogelis;ŽVIRBLIUKAI;9378236361;Ne;13;1;0;14
14396;Žiogelis;ŽVIRBLIUKAI;5445409452;Ne;13;0;0;13
14397;Žiogelis;ŽVIRBLIUKAI;4155916507;Ne;5;0;0;5
14398;Žiogelis;ŽVIRBLIUKAI;4623532521;Ne;0;2;0;2
14399;Žiogelis;ŽVIRBLIUKAI;6988180082;Ne;5;1;0;6
14400;Žiogelis;ŽVIRBLIUKAI;4677227753;Ne;5;1;0;6
14401;Žiogelis;BITUTĖS;3752355139;Ne;9;0;2;11
14402;Žiogelis;BITUTĖS;2173494736;Ne;9;0;1;10
14403;Žiogelis;BITUTĖS;5042341085;Ne;13;0;0;13
14404;Žiogelis;BITUTĖS;6347738933;Ne;10;0;0;10
14405;Žiogelis;BITUTĖS;9627583831;Ne;4;0;0;4
14406;Žiogelis;BITUTĖS;3296450902;Ne;4;0;0;4
14407;Žiogelis;BITUTĖS;9981130790;Ne;7;3;0;10
14408;Žiogelis;BITUTĖS;9790463889;Ne;11;3;0;14
14409;Žiogelis;BITUTĖS;6024752960;Ne;0;6;0;6
14410;Žiogelis;BITUTĖS;8853905367;Ne;3;6;0;9
14411;Žiogelis;BITUTĖS;1397686161;Ne;0;6;0;6
14412;Žiogelis;BITUTĖS;2171351454;Ne;7;2;1;10
14413;Žiogelis;BITUTĖS;8835394030;Ne;0;9;0;9
14414;Žiogelis;BITUTĖS;4645245689;Ne;0;1;0;1
14415;Žiogelis;BITUTĖS;9874412804;Ne;0;4;0;4
14416;Žiogelis;BITUTĖS;5139645108;Ne;0;5;0;5
14417;Žiogelis;BITUTĖS;9766966628;Ne;9;1;0;10
14418;Žiogelis;RIEŠUTĖLIAI;8303283893;Ne;3;2;0;5
14419;Žiogelis;RIEŠUTĖLIAI;9863503924;Ne;0;5;0;5
14420;Žiogelis;RIEŠUTĖLIAI;6718866954;Ne;5;0;2;7
14421;Žiogelis;RIEŠUTĖLIAI;9144282935;Ne;0;0;4;4
14422;Žiogelis;RIEŠUTĖLIAI;5741157573;Ne;0;1;0;1
14423;Žiogelis;RIEŠUTĖLIAI;8485973974;Ne;4;0;0;4
14424;Žiogelis;RIEŠUTĖLIAI;6039409252;Ne;14;0;0;14
14425;Žiogelis;RIEŠUTĖLIAI;2275123126;Ne;10;0;0;10
14426;Žiogelis;RIEŠUTĖLIAI;4994053705;Ne;15;2;0;17
14427;Žiogelis;RIEŠUTĖLIAI;6048534817;Ne;0;0;4;4
14428;Žiogelis;RIEŠUTĖLIAI;5133034709;Ne;5;3;0;8
14429;Žiogelis;RIEŠUTĖLIAI;2724389716;Ne;18;0;1;19
14430;Žiogelis;RIEŠUTĖLIAI;7763941077;Ne;0;0;14;14
14431;Žiogelis;RIEŠUTĖLIAI;7008807839;Ne;0;1;3;4
14432;Žiogelis;RIEŠUTĖLIAI;5984496369;Ne;0;4;0;4
14433;Žiogelis;RIEŠUTĖLIAI;4587838884;Ne;0;11;0;11
14434;Žiogelis;PAKALNUTĖS;1618384759;Ne;1;0;0;1
14435;Žiogelis;PAKALNUTĖS;5054228916;Ne;0;0;2;2
14436;Žiogelis;PAKALNUTĖS;8712788346;Ne;11;0;0;11
14437;Žiogelis;PAKALNUTĖS;7535167450;Ne;0;0;1;1
14438;Žiogelis;PAKALNUTĖS;3361421852;Ne;4;0;0;4
14439;Žiogelis;PAKALNUTĖS;1268908081;Ne;5;0;0;5
14440;Žiogelis;PAKALNUTĖS;3856321373;Ne;12;0;0;12
14441;Žiogelis;PAKALNUTĖS;6378295945;Ne;18;0;0;18
14442;Žiogelis;PAKALNUTĖS;8959934210;Ne;0;1;1;2
14443;Žiogelis;PAKALNUTĖS;8591680136;Ne;5;1;0;6
14444;Žiogelis;PAKALNUTĖS;6980853713;Ne;6;0;0;6
14445;Žiogelis;PAKALNUTĖS;7340918175;Ne;0;7;0;7
14446;Žiogelis;PAKALNUTĖS;6866685213;Ne;12;0;0;12
14447;Žiogelis;PAKALNUTĖS;8058231095;Ne;11;0;2;13
14448;Žiogelis;PAKALNUTĖS;6593794147;Ne;0;0;1;1
14449;Žiogelis;PAKALNUTĖS;1650284820;Ne;4;0;0;4
14450;Žiogelis;PAKALNUTĖS;6515890056;Ne;13;0;0;13
14451;Žiogelis;PAKALNUTĖS;7310459638;Ne;8;1;0;9
14452;Žiogelis;PAKALNUTĖS;1763603533;Ne;8;3;0;11
14453;Žiogelis;PAKALNUTĖS;9813150014;Ne;0;1;0;1
14454;Žiogelis;PAKALNUTĖS;5454676924;Ne;8;0;0;8
14455;Žiogelis;PAKALNUTĖS;7702173581;Ne;3;0;0;3
14456;Žolynėlis;Spanguolėlė;8810441600;Ne;0;2;0;2
14457;Žolynėlis;Spanguolėlė;6440991320;Ne;14;0;0;14
14458;Žolynėlis;Spanguolėlė;3631138915;Ne;0;0;4;4
14459;Žolynėlis;Spanguolėlė;5218448120;Ne;0;3;0;3
14460;Žolynėlis;Spanguolėlė;4076450179;Ne;0;8;0;8
14461;Žolynėlis;Spanguolėlė;4494255525;Ne;0;2;2;4
14462;Žolynėlis;Spanguolėlė;2493633505;Ne;0;0;3;3
14463;Žolynėlis;Spanguolėlė;5438607463;Ne;2;2;0;4
14464;Žolynėlis;Spanguolėlė;5208585298;Ne;0;3;0;3
14465;Žolynėlis;Spanguolėlė;7451189254;Ne;9;3;0;12
14466;Žolynėlis;Spanguolėlė;3498596516;Ne;0;2;0;2
14467;Žolynėlis;Spanguolėlė;9498369210;Ne;16;0;0;16
14468;Žolynėlis;Spanguolėlė;7260397656;Ne;0;2;4;6
14469;Žolynėlis;Spanguolėlė;2315947380;Ne;10;1;0;11
14470;Žolynėlis;Spanguolėlė;5074658392;Ne;5;2;4;11
14471;Žolynėlis;Spanguolėlė;6288526291;Ne;5;1;0;6
14472;Žolynėlis;Spanguolėlė;7234022613;Ne;0;2;0;2
14473;Žolynėlis;"RŪTELĖ (spec)";1540454207;Ne;0;1;0;1
14474;Žolynėlis;"RŪTELĖ (spec)";4000928238;Ne;0;2;0;2
14475;Žolynėlis;"RŪTELĖ (spec)";5610113641;Ne;0;4;0;4
14476;Žolynėlis;"RŪTELĖ (spec)";9507509872;Ne;0;7;0;7
14477;Žolynėlis;"RŪTELĖ (spec)";2256262371;Ne;7;4;0;11
14478;Žolynėlis;"RŪTELĖ (spec)";8588753136;Ne;10;10;0;20
14479;Žolynėlis;"SAULUTĖ (spec)";9675783636;Ne;7;0;0;7
14480;Žolynėlis;"SAULUTĖ (spec)";7962304738;Ne;0;2;0;2
14481;Žolynėlis;"SAULUTĖ (spec)";6678697536;Ne;18;0;0;18
14482;Žolynėlis;"SAULUTĖ (spec)";6559029399;Ne;8;1;0;9
14483;Žolynėlis;"SAULUTĖ (spec)";3043560150;Ne;5;6;0;11
14484;Žolynėlis;"SAULUTĖ (spec)";3934182673;Ne;0;2;0;2
14485;Žolynėlis;"LINELIS (spec)";2665355759;Ne;8;2;0;10
14486;Žolynėlis;"LINELIS (spec)";2346018814;Ne;11;0;6;17
14487;Žolynėlis;"LINELIS (spec)";1916465295;Ne;4;0;0;4
14488;Žolynėlis;"LINELIS (spec)";3337602618;Ne;14;2;1;17
14489;Žolynėlis;"LINELIS (spec)";8930536051;Ne;4;0;0;4
14490;Žolynėlis;"LINELIS (spec)";2740906284;Ne;3;0;0;3
14491;Žolynėlis;"RASAKILA (spec)";4971887781;Ne;6;0;0;6
14492;Žolynėlis;"RASAKILA (spec)";6510930436;Ne;6;0;0;6
14493;Žolynėlis;"RASAKILA (spec)";6619551947;Ne;20;0;0;20
14494;Žolynėlis;"RASAKILA (spec)";4337084252;Ne;0;10;0;10
14495;Žolynėlis;"RASAKILA (spec)";4481343085;Ne;10;0;0;10
14496;Žolynėlis;"RAMUNĖLĖS (spec)";8552635547;Ne;0;2;5;7
14497;Žolynėlis;"RAMUNĖLĖS (spec)";4559404699;Ne;10;0;1;11
14498;Žolynėlis;"RAMUNĖLĖS (spec)";1703785525;Ne;3;2;2;7
14499;Žolynėlis;"RAMUNĖLĖS (spec)";2072569949;Ne;2;0;0;2
14500;Žolynėlis;"RAMUNĖLĖS (spec)";1090944316;Ne;0;1;2;3
14501;Žolynėlis;"RAMUNĖLĖS (spec)";5729519418;Ne;12;0;0;12
14502;Žolynėlis;Dobiliukai;2820649587;Ne;3;1;4;8
14503;Žolynėlis;Dobiliukai;7581436340;Ne;17;0;0;17
14504;Žolynėlis;Dobiliukai;3385748516;Ne;0;8;0;8
14505;Žolynėlis;Dobiliukai;4151633786;Ne;0;1;2;3
14506;Žolynėlis;Dobiliukai;2957426163;Ne;0;0;3;3
14507;Žolynėlis;Dobiliukai;3350246193;Ne;0;1;2;3
14508;Žolynėlis;Dobiliukai;5269388947;Ne;0;1;1;2
14509;Žolynėlis;Dobiliukai;1206144208;Ne;5;1;0;6
14510;Žolynėlis;Dobiliukai;1213384150;Ne;0;2;3;5
14511;Žolynėlis;Aguonėlė;3071570864;Ne;0;12;3;15
14512;Žolynėlis;Aguonėlė;1365534272;Ne;0;1;0;1
14513;Žolynėlis;Aguonėlė;2628636018;Ne;20;0;0;20
14514;Žolynėlis;Aguonėlė;6740105842;Ne;0;8;0;8
14515;Žolynėlis;Aguonėlė;3952731134;Ne;0;1;0;1
14516;Žolynėlis;Aguonėlė;6554864184;Ne;0;20;0;20
14517;Žolynėlis;Aguonėlė;9904373687;Ne;0;0;1;1
14518;Žolynėlis;Aguonėlė;9285539649;Ne;5;1;0;6
14519;Žolynėlis;Aguonėlė;5243624422;Ne;0;2;12;14
14520;Žolynėlis;Aguonėlė;6354832415;Ne;0;3;0;3
14521;Žolynėlis;Aguonėlė;1748987196;Ne;5;6;0;11
14522;Žolynėlis;Aguonėlė;4427274462;Taip;1;0;0;1
14523;Žolynėlis;Pienė;3520272555;Ne;10;3;0;13
14524;Žolynėlis;Pienė;2934361190;Ne;3;2;0;5
14525;Žolynėlis;Pienė;6763515483;Ne;0;1;0;1
14526;Žolynėlis;Pienė;1163753820;Ne;3;0;0;3
14527;Žolynėlis;Pienė;9106152447;Taip;7;2;3;12
14528;Žolynėlis;Pienė;1879046798;Ne;0;1;0;1
14529;Žolynėlis;Pienė;9238832484;Ne;0;2;0;2
14530;Žolynėlis;Pienė;3877168024;Ne;0;4;0;4
14531;Žolynėlis;Pienė;6416217971;Ne;4;2;0;6
14532;Žolynėlis;Pienė;4618251201;Ne;0;4;5;9
14533;Žolynėlis;Pienė;5432464074;Ne;0;4;1;5
14534;Žolynėlis;Pienė;8510764089;Ne;0;2;0;2
14535;Žolynėlis;Pienė;1264022895;Ne;5;1;2;8
14536;Žolynėlis;Pienė;8713225753;Ne;0;1;0;1
14537;Žolynėlis;Pienė;5332349177;Ne;0;8;0;8
14538;Žolynėlis;Pienė;5787331165;Ne;0;1;0;1
14539;Žolynėlis;Pienė;5474876914;Ne;0;0;1;1
14540;Žolynėlis;Pienė;2263679711;Ne;4;0;0;4
14541;Žolynėlis;Pienė;5973298389;Ne;0;4;0;4
14542;Žolynėlis;Čiobreliai;5564338170;Ne;3;0;0;3
14543;Žolynėlis;Čiobreliai;6543503409;Ne;1;1;0;2
14544;Žolynėlis;Čiobreliai;8215427354;Ne;0;15;0;15
14545;Žolynėlis;Čiobreliai;2565770471;Ne;20;0;0;20
14546;Žolynėlis;Čiobreliai;6829144389;Ne;9;0;0;9
14547;Žolynėlis;Čiobreliai;4545601535;Ne;0;2;0;2
14548;Žolynėlis;Čiobreliai;7256502393;Ne;4;1;0;5
14549;Žolynėlis;Čiobreliai;1901979061;Ne;0;6;0;6
14550;Žolynėlis;Čiobreliai;8027151284;Ne;7;1;0;8
14551;Žolynėlis;Čiobreliai;5717038791;Ne;15;0;0;15
14552;Žolynėlis;Čiobreliai;1933377698;Ne;0;7;0;7
14553;Žolynėlis;Čiobreliai;2108221942;Ne;10;0;0;10
14554;Žolynėlis;Čiobreliai;2881461471;Ne;0;2;0;2
14555;Žolynėlis;Čiobreliai;7339110559;Ne;1;1;0;2
14556;Žolynėlis;Čiobreliai;2460982987;Ne;1;5;0;6
14557;Žolynėlis;Čiobreliai;7980206574;Ne;2;0;0;2
14558;Žolynėlis;Čiobreliai;3088932720;Ne;1;0;0;1
14559;Žolynėlis;Čiobreliai;4758738231;Ne;0;6;0;6
14560;Žolynėlis;Čiobreliai;1485195267;Ne;0;1;0;1
14561;Žolynėlis;Avietėlė;4277871671;Ne;4;0;0;4
14562;Žolynėlis;Avietėlė;9404844632;Ne;4;0;0;4
14563;Žolynėlis;Avietėlė;5873931225;Ne;10;0;0;10
14564;Žolynėlis;Avietėlė;6124252688;Ne;7;0;0;7
14565;Žolynėlis;Avietėlė;3293250169;Ne;0;1;0;1
14566;Žolynėlis;Avietėlė;1266614631;Ne;9;0;0;9
14567;Žolynėlis;Avietėlė;9993230229;Ne;0;3;0;3
14568;Žolynėlis;Avietėlė;7855260478;Ne;10;1;0;11
14569;Žolynėlis;Avietėlė;2727273826;Ne;10;0;0;10
14570;Žolynėlis;Avietėlė;2718255075;Ne;3;4;0;7
14571;Žolynėlis;Avietėlė;7201413203;Ne;4;0;0;4
14572;Žolynėlis;Avietėlė;6417150398;Taip;5;0;0;5
14573;Žolynėlis;Avietėlė;7517815798;Ne;5;0;0;5
14574;Žolynėlis;Avietėlė;4094173207;Ne;0;0;2;2
14575;Žolynėlis;Avietėlė;4229530366;Ne;5;4;0;9
14576;Žolynėlis;Avietėlė;5771745015;Ne;4;0;0;4
14577;Žolynėlis;Avietėlė;9163883190;Ne;0;5;0;5
14578;Žuvėdra;"JŪROS ŽVAIGŽDUTĖS";7272717439;Ne;0;3;0;3
14579;Žuvėdra;"JŪROS ŽVAIGŽDUTĖS";9230342970;Ne;5;0;0;5
14580;Žuvėdra;"JŪROS ŽVAIGŽDUTĖS";1938808693;Ne;0;6;0;6
14581;Žuvėdra;"JŪROS ŽVAIGŽDUTĖS";2092890028;Ne;0;0;2;2
14582;Žuvėdra;"JŪROS ŽVAIGŽDUTĖS";2334342995;Ne;6;4;0;10
14583;Žuvėdra;"JŪROS ŽVAIGŽDUTĖS";5049101816;Ne;5;2;0;7
14584;Žuvėdra;"JŪROS ŽVAIGŽDUTĖS";1164464390;Ne;0;1;0;1
14585;Žuvėdra;"JŪROS ŽVAIGŽDUTĖS";1200084485;Ne;2;12;0;14
14586;Žuvėdra;"JŪROS ŽVAIGŽDUTĖS";4177319374;Taip;6;3;0;9
14587;Žuvėdra;"JŪROS ŽVAIGŽDUTĖS";7121154799;Ne;14;3;0;17
14588;Žuvėdra;"JŪROS ŽVAIGŽDUTĖS";8162649794;Ne;0;1;0;1
14589;Žuvėdra;"JŪROS ŽVAIGŽDUTĖS";7710853637;Ne;0;4;2;6
14590;Žuvėdra;"JŪROS ŽVAIGŽDUTĖS";2858729034;Ne;9;2;0;11
14591;Žuvėdra;"JŪROS ŽVAIGŽDUTĖS";9733979816;Ne;19;0;0;19
14592;Žuvėdra;"JŪROS ŽVAIGŽDUTĖS";5571732399;Ne;0;0;4;4
14593;Žuvėdra;"JŪROS ŽVAIGŽDUTĖS";3620753237;Ne;12;1;0;13
14594;Žuvėdra;DELFINUKAI;5436158437;Ne;5;4;0;9
14595;Žuvėdra;DELFINUKAI;2582404760;Ne;1;0;0;1
14596;Žuvėdra;DELFINUKAI;5818639448;Ne;6;0;0;6
14597;Žuvėdra;DELFINUKAI;1171751803;Ne;6;0;0;6
14598;Žuvėdra;DELFINUKAI;7235005234;Ne;5;0;2;7
14599;Žuvėdra;DELFINUKAI;5876618912;Ne;10;0;0;10
14600;Žuvėdra;DELFINUKAI;6989906913;Ne;0;1;0;1
14601;Žuvėdra;DELFINUKAI;4702627979;Ne;6;1;0;7
14602;Žuvėdra;DELFINUKAI;5002760763;Ne;0;5;0;5
14603;Žuvėdra;DELFINUKAI;7803397430;Ne;1;0;0;1
14604;Žuvėdra;DELFINUKAI;7705946236;Taip;9;6;0;15
14605;Žuvėdra;DELFINUKAI;1974766090;Ne;0;19;0;19
14606;Žuvėdra;DELFINUKAI;8869169590;Taip;14;0;0;14
14607;Žuvėdra;DELFINUKAI;3069506904;Ne;11;4;0;15
14608;Žuvėdra;DELFINUKAI;4146310547;Ne;6;2;0;8
14609;Žuvėdra;DELFINUKAI;5913580058;Ne;5;0;0;5
14610;Žuvėdra;DELFINUKAI;9651268462;Ne;2;0;6;8
14611;Žuvėdra;DELFINUKAI;2082128566;Ne;0;7;0;7
14612;Žuvėdra;OSMINOŽKI;5021263583;Ne;12;0;0;12
14613;Žuvėdra;OSMINOŽKI;63053155507;Ne;0;2;0;2
14614;Žuvėdra;OSMINOŽKI;6007871092;Ne;0;1;0;1
14615;Žuvėdra;OSMINOŽKI;2731016281;Ne;5;4;0;9
14616;Žuvėdra;OSMINOŽKI;6612880861;Ne;3;0;0;3
14617;Žuvėdra;OSMINOŽKI;14760907606;Ne;15;0;0;15
14618;Žuvėdra;OSMINOŽKI;5684848140;Ne;0;11;0;11
14619;Žuvėdra;OSMINOŽKI;5489757084;Ne;9;0;0;9
14620;Žuvėdra;OSMINOŽKI;8408371550;Ne;0;0;2;2
14621;Žuvėdra;OSMINOŽKI;5496071972;Ne;9;2;0;11
14622;Žuvėdra;OSMINOŽKI;6537464526;Ne;0;8;0;8
14623;Žuvėdra;OSMINOŽKI;3853045274;Ne;0;5;0;5
14624;Žuvėdra;OSMINOŽKI;3185158741;Taip;4;0;0;4
14625;Žuvėdra;OSMINOŽKI;8822952385;Ne;10;0;0;10
14626;Žuvėdra;OSMINOŽKI;5198825127;Taip;15;0;0;15
14627;Žuvėdra;RUSALAČKA;8700802853;Ne;0;3;0;3
14628;Žuvėdra;RUSALAČKA;1509519996;Ne;6;1;0;7
14629;Žuvėdra;RUSALAČKA;7467154866;Ne;19;1;0;20
14630;Žuvėdra;RUSALAČKA;5151984122;Ne;0;2;0;2
14631;Žuvėdra;RUSALAČKA;6715416675;Ne;4;0;3;7
14632;Žuvėdra;RUSALAČKA;3349158713;Ne;16;2;0;18
14633;Žuvėdra;RUSALAČKA;8942228415;Ne;11;0;0;11
14634;Žuvėdra;RUSALAČKA;8670342549;Ne;0;2;3;5
14635;Žuvėdra;RUSALAČKA;1707519901;Ne;2;0;0;2
14636;Žuvėdra;RUSALAČKA;1810114962;Taip;0;7;0;7
14637;Žuvėdra;RUSALAČKA;1960306957;Ne;3;4;0;7
14638;Žuvėdra;RUSALAČKA;2640238143;Ne;5;2;0;7
14639;Žuvėdra;RUSALAČKA;2577280901;Ne;0;1;0;1
14640;Žuvėdra;RUSALAČKA;5481785360;Ne;12;0;0;12
14641;Žuvėdra;RUSALAČKA;6862766787;Ne;11;0;0;11
14642;Žuvėdra;RUSALAČKA;9011276878;Ne;11;0;0;11
14643;Žuvėdra;RUSALAČKA;7387863175;Ne;0;3;0;3
14644;Žuvėdra;JANTARIKI;1219808187;Ne;7;2;0;9
14645;Žuvėdra;JANTARIKI;9200342856;Taip;0;4;0;4
14646;Žuvėdra;JANTARIKI;2197976174;Ne;6;0;1;7
14647;Žuvėdra;JANTARIKI;4881712317;Ne;7;9;0;16
14648;Žuvėdra;JANTARIKI;1929548863;Ne;3;1;6;10
14649;Žuvėdra;JANTARIKI;7464494386;Ne;0;1;0;1
14650;Žuvėdra;JANTARIKI;1072201019;Ne;3;0;0;3
14651;Žuvėdra;JANTARIKI;1993897043;Ne;0;6;0;6
14652;Žuvėdra;JANTARIKI;3058300342;Ne;0;2;3;5
14653;Žuvėdra;JANTARIKI;7227722516;Ne;2;0;0;2
14654;Žuvėdra;JANTARIKI;9256424331;Ne;8;3;0;11
14655;Žuvėdra;JANTARIKI;7908898376;Ne;9;6;0;15
14656;Žuvėdra;JANTARIKI;2789379055;Ne;0;6;0;6
14657;Žuvėdra;JANTARIKI;9838754800;Ne;2;0;0;2
14658;Žuvėdra;JANTARIKI;1604010000;Ne;6;5;0;11
14659;Žuvėdra;"AUKSINĖ ŽUVELĖ";9914814198;Ne;3;0;0;3
14660;Žuvėdra;"AUKSINĖ ŽUVELĖ";6287034023;Ne;5;6;0;11
14661;Žuvėdra;"AUKSINĖ ŽUVELĖ";2844920302;Ne;0;5;0;5
14662;Žuvėdra;"AUKSINĖ ŽUVELĖ";9460887312;Ne;8;0;5;13
14663;Žuvėdra;"AUKSINĖ ŽUVELĖ";9382616403;Taip;1;0;0;1
14664;Žuvėdra;"AUKSINĖ ŽUVELĖ";2323431685;Ne;6;0;0;6
14665;Žuvėdra;"AUKSINĖ ŽUVELĖ";4888533074;Taip;10;0;0;10
14666;Žuvėdra;"AUKSINĖ ŽUVELĖ";5009153711;Taip;15;0;0;15
14667;Žuvėdra;"AUKSINĖ ŽUVELĖ";7258677907;Taip;6;2;0;8
14668;Žuvėdra;"AUKSINĖ ŽUVELĖ";4739865462;Ne;6;0;1;7
14669;Žuvėdra;"AUKSINĖ ŽUVELĖ";7135848009;Ne;2;1;0;3
14670;Žuvėdra;"AUKSINĖ ŽUVELĖ";3781157324;Ne;5;0;2;7
14671;Žuvėdra;"AUKSINĖ ŽUVELĖ";7164457313;Ne;9;6;0;15
14672;Žuvėdra;"AUKSINĖ ŽUVELĖ";9215777054;Ne;6;0;4;10
14673;Žvangutis;PELIUKŲ;7616874368;Ne;0;0;3;3
14674;Žvangutis;PELIUKŲ;3906808900;Ne;2;0;2;4
14675;Žvangutis;PELIUKŲ;7722153982;Ne;0;2;0;2
14676;Žvangutis;PELIUKŲ;4295016449;Ne;13;2;0;15
14677;Žvangutis;PELIUKŲ;9958554027;Ne;4;0;0;4
14678;Žvangutis;PELIUKŲ;8592522675;Ne;5;1;0;6
14679;Žvangutis;PELIUKŲ;3957064486;Ne;2;1;0;3
14680;Žvangutis;PELIUKŲ;5112520119;Ne;3;2;1;6
14681;Žvangutis;PELIUKŲ;5817402847;Ne;1;12;0;13
14682;Žvangutis;PELIUKŲ;4407484687;Ne;0;1;0;1
14683;Žvangutis;PELIUKŲ;4337928288;Ne;7;0;3;10
14684;Žvangutis;PELIUKŲ;6788355315;Ne;6;0;0;6
14685;Žvangutis;PELIUKŲ;8062689240;Ne;0;1;0;1
14686;Žvangutis;PELIUKŲ;3875906173;Ne;4;2;0;6
14687;Žvangutis;PELIUKŲ;1328464199;Ne;0;3;5;8
14688;Žvangutis;PELIUKŲ;3546672690;Ne;0;2;1;3
14689;Žvangutis;PELIUKŲ;4992231141;Ne;0;1;0;1
14690;Žvangutis;PELIUKŲ;8481666202;Ne;0;4;0;4
14691;Žvangutis;PELIUKŲ;4705131089;Ne;1;0;0;1
14692;Žvangutis;ANČIUKŲ;1420510354;Ne;2;2;0;4
14693;Žvangutis;ANČIUKŲ;6579934222;Ne;0;0;1;1
14694;Žvangutis;ANČIUKŲ;9134683276;Ne;0;2;0;2
14695;Žvangutis;ANČIUKŲ;9145365865;Ne;0;2;0;2
14696;Žvangutis;ANČIUKŲ;6701947168;Ne;0;2;0;2
14697;Žvangutis;ANČIUKŲ;3315858185;Ne;10;0;0;10
14698;Žvangutis;ANČIUKŲ;7320625500;Ne;5;0;0;5
14699;Žvangutis;ANČIUKŲ;6110958520;Ne;6;0;10;16
14700;Žvangutis;ANČIUKŲ;6989839997;Ne;0;1;0;1
14701;Žvangutis;ANČIUKŲ;7202747419;Ne;10;1;0;11
14702;Žvangutis;ANČIUKŲ;3817258555;Ne;0;2;0;2
14703;Žvangutis;ANČIUKŲ;3775960571;Ne;5;10;0;15
14704;Žvangutis;ANČIUKŲ;7267340112;Ne;0;3;0;3
14705;Žvangutis;ANČIUKŲ;50889154641;Ne;10;0;0;10
14706;Žvangutis;ANČIUKŲ;1310113034;Ne;0;6;0;6
14707;Žvangutis;ANČIUKŲ;3513746926;Ne;8;2;0;10
14708;Žvangutis;ANČIUKŲ;4053450010;Ne;0;1;0;1
14709;Žvangutis;ANČIUKŲ;8511103595;Ne;3;1;4;8
14710;Žvangutis;ANČIUKŲ;6815104137;Ne;0;3;0;3
14711;Žvangutis;ANČIUKŲ;6844824726;Ne;0;2;0;2
14712;Žvangutis;ANČIUKŲ;9408369641;Taip;0;2;0;2
14713;Žvangutis;ANČIUKŲ;2600596320;Ne;11;0;0;11
14714;Žvangutis;PELĖDŽIUKŲ;1322688456;Ne;3;2;1;6
14715;Žvangutis;PELĖDŽIUKŲ;9036869235;Ne;0;3;0;3
14716;Žvangutis;PELĖDŽIUKŲ;2570379643;Ne;1;5;0;6
14717;Žvangutis;PELĖDŽIUKŲ;2623107843;Ne;0;2;2;4
14718;Žvangutis;PELĖDŽIUKŲ;1185135525;Ne;0;3;0;3
14719;Žvangutis;PELĖDŽIUKŲ;9468660351;Ne;0;1;0;1
14720;Žvangutis;PELĖDŽIUKŲ;1324948757;Taip;8;0;0;8
14721;Žvangutis;PELĖDŽIUKŲ;2922083476;Ne;0;11;0;11
14722;Žvangutis;PELĖDŽIUKŲ;1282567366;Taip;3;0;0;3
14723;Žvangutis;PELĖDŽIUKŲ;6068428687;Ne;6;2;0;8
14724;Žvangutis;PELĖDŽIUKŲ;9149037184;Ne;8;1;0;9
14725;Žvangutis;PELĖDŽIUKŲ;3665275100;Ne;5;0;0;5
14726;Žvangutis;PELĖDŽIUKŲ;5012996199;Ne;0;2;3;5
14727;Žvangutis;PELĖDŽIUKŲ;8295525284;Ne;0;2;0;2
14728;Žvangutis;PELĖDŽIUKŲ;3276065009;Ne;7;8;0;15
14729;Žvangutis;PELĖDŽIUKŲ;6040986672;Ne;4;3;0;7
14730;Žvangutis;PELĖDŽIUKŲ;2716216474;Ne;0;2;0;2
14731;Žvangutis;PELĖDŽIUKŲ;5723728310;Ne;6;5;0;11
14732;Žvangutis;PELĖDŽIUKŲ;1404378308;Taip;0;4;0;4
14733;Žvangutis;PELĖDŽIUKŲ;6207989105;Ne;0;2;0;2
14734;Žvangutis;PELĖDŽIUKŲ;5539992579;Ne;4;5;0;9
14735;Žvangutis;KAČIUKŲ;7213349517;Ne;0;1;0;1
14736;Žvangutis;KAČIUKŲ;7581320158;Ne;0;1;0;1
14737;Žvangutis;KAČIUKŲ;2296360416;Ne;0;7;0;7
14738;Žvangutis;KAČIUKŲ;7721746116;Ne;0;7;0;7
14739;Žvangutis;KAČIUKŲ;1142315595;Ne;14;1;0;15
14740;Žvangutis;KAČIUKŲ;9239279639;Ne;0;2;0;2
14741;Žvangutis;KAČIUKŲ;4696437804;Ne;5;1;0;6
14742;Žvangutis;KAČIUKŲ;8492637734;Ne;5;2;0;7
14743;Žvangutis;KAČIUKŲ;2503355659;Ne;7;0;0;7
14744;Žvangutis;KAČIUKŲ;9235884407;Ne;10;4;0;14
14745;Žvangutis;KAČIUKŲ;8863909185;Ne;7;3;0;10
14746;Žvangutis;KAČIUKŲ;3498584864;Taip;0;2;0;2
14747;Žvangutis;KAČIUKŲ;4408086513;Ne;10;7;0;17
14748;Žvangutis;KAČIUKŲ;1256264382;Ne;0;12;0;12
14749;Žvangutis;KAČIUKŲ;8030520477;Ne;4;2;2;8
14750;Žvangutis;KAČIUKŲ;8810739982;Ne;4;0;0;4
14751;Žvangutis;KAČIUKŲ;2740875969;Ne;8;0;0;8
14752;Žvangutis;KAČIUKŲ;8269992031;Ne;0;7;4;11
14753;Žvangutis;KAČIUKŲ;1224292338;Ne;0;0;3;3
14754;Žvangutis;KAČIUKŲ;1634651749;Ne;0;0;1;1
14755;Žvangutis;MEŠKUČIŲ;8753815074;Ne;4;0;0;4
14756;Žvangutis;MEŠKUČIŲ;3781959962;Ne;6;0;8;14
14757;Žvangutis;MEŠKUČIŲ;8506809320;Ne;0;3;0;3
14758;Žvangutis;MEŠKUČIŲ;8376022173;Ne;3;1;0;4
14759;Žvangutis;MEŠKUČIŲ;6825952779;Ne;0;1;2;3
14760;Žvangutis;MEŠKUČIŲ;4920234186;Ne;9;0;0;9
14761;Žvangutis;MEŠKUČIŲ;1590704985;Ne;0;0;1;1
14762;Žvangutis;MEŠKUČIŲ;9306755042;Ne;0;0;1;1
14763;Žvangutis;MEŠKUČIŲ;5328547183;Ne;0;1;0;1
14764;Žvangutis;MEŠKUČIŲ;9523189658;Ne;4;0;0;4
14765;Žvangutis;MEŠKUČIŲ;8598396569;Ne;0;1;0;1
14766;Žvangutis;MEŠKUČIŲ;1706200292;Ne;4;0;0;4
14767;Žvangutis;KIŠKUČIŲ;8906823569;Ne;16;0;2;18
14768;Žvangutis;KIŠKUČIŲ;6094686500;Taip;0;8;0;8
14769;Žvangutis;KIŠKUČIŲ;2049990751;Ne;8;0;0;8
14770;Žvangutis;KIŠKUČIŲ;2308726385;Ne;4;0;0;4
14771;Žvangutis;KIŠKUČIŲ;9711017196;Ne;6;0;1;7
14772;Žvangutis;KIŠKUČIŲ;3940893168;Ne;7;0;0;7
14773;Žvangutis;KIŠKUČIŲ;1592158260;Ne;15;0;0;15
14774;Žvangutis;KIŠKUČIŲ;5022657156;Ne;4;0;0;4
14775;Žvangutis;KIŠKUČIŲ;7645908955;Ne;5;0;5;10
14776;Žvangutis;KIŠKUČIŲ;6741623841;Ne;2;0;1;3
14777;Žvangutis;KIŠKUČIŲ;3029382724;Ne;13;0;0;13
14778;Žvangutis;KIŠKUČIŲ;4514606021;Ne;0;9;0;9
14779;Žvangutis;KIŠKUČIŲ;7844987649;Ne;4;0;3;7
14780;Žvangutis;KIŠKUČIŲ;7599491698;Ne;10;0;0;10
14781;Žvangutis;KIŠKUČIŲ;4128856598;Ne;11;0;0;11
14782;Žvangutis;KIŠKUČIŲ;4968365511;Taip;16;0;0;16
14783;Žirniukas;Boružiukų;5311746004;Ne;0;0;9;9
14784;Žirniukas;Boružiukų;6466220057;Ne;4;0;0;4
14785;Žirniukas;Boružiukų;2476906136;Ne;0;5;0;5
14786;Žirniukas;Boružiukų;2785102131;Ne;0;2;1;3
14787;Žirniukas;Boružiukų;6624263476;Ne;0;1;0;1
14788;Žirniukas;Boružiukų;8213507698;Ne;1;2;0;3
14789;Žirniukas;Boružiukų;6268788036;Ne;0;2;1;3
14790;Žirniukas;Boružiukų;2636634198;Ne;0;2;0;2
14791;Žirniukas;Boružiukų;8148254025;Ne;8;0;0;8
14792;Žirniukas;Boružiukų;6531175340;Ne;8;1;0;9
14793;Žirniukas;Boružiukų;6641200341;Ne;1;1;0;2
14794;Žirniukas;Boružiukų;3022672028;Ne;10;2;0;12
14795;Žirniukas;Boružiukų;8180092480;Ne;0;0;1;1
14796;Žirniukas;Boružiukų;9896989995;Ne;0;1;0;1
14797;Žirniukas;Boružiukų;5420360864;Ne;0;2;3;5
14798;Žirniukas;Boružiukų;1873446232;Ne;0;0;1;1
14799;Žirniukas;Boružiukų;8294569569;Ne;0;12;0;12
14800;Žirniukas;Boružiukų;7397202752;Ne;0;2;0;2
14801;Žirniukas;Boružiukų;7190628011;Ne;1;0;2;3
14802;Žirniukas;Smalsučiai;2132625724;Ne;2;0;0;2
14803;Žirniukas;Smalsučiai;2557138057;Ne;0;9;0;9
14804;Žirniukas;Smalsučiai;8644938346;Ne;0;3;0;3
14805;Žirniukas;Smalsučiai;5761169841;Ne;4;0;0;4
14806;Žirniukas;Smalsučiai;2151329751;Ne;0;2;0;2
14807;Žirniukas;Smalsučiai;5939918015;Ne;0;2;1;3
14808;Žirniukas;Smalsučiai;2049123663;Ne;11;6;0;17
14809;Žirniukas;Smalsučiai;3010062747;Ne;0;5;0;5
14810;Žirniukas;Smalsučiai;2162238771;Ne;0;1;0;1
14811;Žirniukas;Smalsučiai;1064894307;Ne;0;2;0;2
14812;Žirniukas;Smalsučiai;4378877068;Ne;0;2;0;2
14813;Žirniukas;Smalsučiai;2029018108;Ne;0;3;0;3
14814;Žirniukas;Smalsučiai;2309995947;Ne;0;2;0;2
14815;Žirniukas;Smalsučiai;1162904969;Ne;1;5;0;6
14816;Žirniukas;Smalsučiai;1514504241;Ne;0;2;1;3
14817;Žirniukas;Smalsučiai;6180439078;Ne;0;2;1;3
14818;Žirniukas;Smalsučiai;5987510202;Ne;0;2;0;2
14819;Žirniukas;Smalsučiai;1944169398;Ne;0;1;0;1
14820;Žirniukas;Smalsučiai;7975957714;Ne;0;1;0;1
14821;Žirniukas;Smalsučiai;3808838764;Ne;0;2;0;2
14822;Žirniukas;Smalsučiai;9374080010;Ne;5;0;0;5
14823;Žirniukas;Smalsučiai;1678041002;Ne;0;7;2;9
14824;Žirniukas;Gėlyčių;6121388208;Ne;2;0;1;3
14825;Žirniukas;Gėlyčių;6201949014;Ne;11;0;0;11
14826;Žirniukas;Gėlyčių;5103440019;Ne;5;0;1;6
14827;Žirniukas;Gėlyčių;3370588608;Ne;6;0;0;6
14828;Žirniukas;Gėlyčių;7872611724;Ne;0;0;1;1
14829;Žirniukas;Gėlyčių;9497414375;Ne;0;0;5;5
14830;Žirniukas;Gėlyčių;5422282267;Ne;0;1;0;1
14831;Žirniukas;Gėlyčių;5427116799;Ne;5;0;2;7
14832;Žirniukas;Gėlyčių;3214136760;Ne;0;6;0;6
14833;Žirniukas;Gėlyčių;9021495553;Ne;6;0;0;6
14834;Žirniukas;Gėlyčių;6147030672;Ne;6;0;0;6
14835;Žirniukas;Nykštukų;2746074694;Ne;0;2;0;2
14836;Žirniukas;Nykštukų;4282344625;Ne;0;1;0;1
14837;Žirniukas;Nykštukų;3874713264;Ne;0;1;1;2
14838;Žirniukas;Nykštukų;1532129054;Ne;3;0;1;4
14839;Žirniukas;Nykštukų;7368124402;Ne;0;4;0;4
14840;Žirniukas;Nykštukų;2526769571;Ne;0;0;1;1
14841;Žirniukas;Nykštukų;2027344763;Ne;0;1;1;2
14842;Žirniukas;Nykštukų;9730269905;Ne;0;3;0;3
14843;Žirniukas;Nykštukų;9478756666;Ne;0;0;4;4
14844;Žirniukas;Nykštukų;9425682286;Ne;0;0;1;1
14845;Žirniukas;Nykštukų;4704879073;Ne;0;0;4;4
14846;Žirniukas;Nykštukų;4732089209;Ne;0;5;0;5
14847;Žirniukas;Nykštukų;9988669252;Ne;10;1;0;11
14848;Žirniukas;Nykštukų;8242086461;Ne;2;5;0;7
14849;Žirniukas;Nykštukų;8242086461;Ne;2;5;0;7
14850;Žirniukas;Nykštukų;8242086461;Ne;2;5;0;7
14851;Žirniukas;Nykštukų;6511802399;Ne;2;5;0;7
14852;Žirniukas;Nykštukų;6511802399;Ne;2;5;0;7
14853;Žirniukas;Nykštukų;6511802399;Ne;2;5;0;7
14854;Žirniukas;Saulytės;9649896460;Ne;0;1;7;8
14855;Žirniukas;Saulytės;9707776533;Ne;1;1;0;2
14856;Žirniukas;Saulytės;7278153529;Ne;1;0;0;1
14857;Žirniukas;Saulytės;7927815250;Ne;0;1;0;1
14858;Žirniukas;Saulytės;2325139043;Ne;4;1;0;5
14859;Žirniukas;Saulytės;9961947583;Ne;0;1;0;1
14860;Žirniukas;Saulytės;9656768968;Ne;0;1;1;2
14861;Žirniukas;Saulytės;4045432303;Ne;0;2;0;2
14862;Žirniukas;Saulytės;1074945082;Ne;14;0;1;15
14863;Žirniukas;Saulytės;1594735501;Ne;0;1;0;1
14864;Žirniukas;Saulytės;4433579937;Ne;0;1;1;2
14865;Žirniukas;Saulytės;4229687519;Ne;0;2;0;2
14866;Žirniukas;Saulytės;8151071354;Ne;0;1;1;2
14867;Žirniukas;Saulytės;8599313527;Ne;0;2;1;3
14868;Žirniukas;Saulytės;4320686646;Ne;0;2;0;2
14869;Žirniukas;Drugelių;6271194358;Ne;0;11;0;11
14870;Žirniukas;Drugelių;5269074776;Ne;0;0;11;11
14871;Žirniukas;Drugelių;3509857181;Ne;2;0;0;2
14872;Žirniukas;Drugelių;2517524802;Ne;20;0;0;20
14873;Žirniukas;Drugelių;9901196251;Ne;4;0;2;6
14874;Žirniukas;Drugelių;5046469974;Ne;10;0;0;10
14875;Žirniukas;Drugelių;1826203483;Ne;0;1;1;2
14876;Žirniukas;Drugelių;4536071547;Ne;0;1;3;4
14877;Žirniukas;Drugelių;3996393849;Ne;18;0;0;18
14878;Žirniukas;Drugelių;7240364379;Ne;0;0;7;7
14879;Žirniukas;Drugelių;6300372863;Ne;6;1;0;7
14880;Žirniukas;Drugelių;5670489807;Ne;0;1;0;1
14881;Žirniukas;Drugelių;9794535841;Ne;13;0;0;13
14882;Žirniukas;Drugelių;1018506580;Ne;0;12;1;13
14883;Žirniukas;Drugelių;9384464752;Ne;0;2;3;5
14884;Žirniukas;Pelėdžiukai;7889803840;Ne;0;1;0;1
14885;Žirniukas;Pelėdžiukai;2895924102;Ne;0;0;1;1
14886;Žirniukas;Pelėdžiukai;4347695841;Ne;0;0;6;6
14887;Žirniukas;Pelėdžiukai;7356213150;Ne;15;3;0;18
14888;Žirniukas;Pelėdžiukai;7545458622;Ne;7;2;1;10
14889;Žirniukas;Pelėdžiukai;5376080603;Ne;0;0;3;3
14890;Žirniukas;Pelėdžiukai;7755938379;Ne;0;1;0;1
14891;Žirniukas;Pelėdžiukai;5470692657;Ne;10;2;0;12
14892;Žirniukas;Pelėdžiukai;8690042163;Ne;0;1;0;1
14893;Žirniukas;Pelėdžiukai;2332260494;Ne;5;0;0;5
14894;Žirniukas;Pelėdžiukai;6941160450;Ne;1;4;0;5
14895;Žirniukas;Pelėdžiukai;4464151713;Ne;0;0;1;1
14896;Žirniukas;Pelėdžiukai;3907578167;Ne;0;1;0;1
14897;Žirniukas;Pelėdžiukai;4069128550;Ne;4;0;0;4
14898;Žirniukas;ZUIKUČIAI;5613818351;Ne;0;1;0;1
14899;Žirniukas;ZUIKUČIAI;1345594362;Ne;0;2;1;3
14900;Žirniukas;ZUIKUČIAI;9847840127;Taip;0;1;0;1
14901;Žirniukas;ZUIKUČIAI;1005139737;Ne;10;0;0;10
14902;Žirniukas;ZUIKUČIAI;7968189099;Ne;16;1;0;17
14903;Žirniukas;ZUIKUČIAI;7081683726;Ne;6;1;0;7
14904;Žirniukas;ZUIKUČIAI;7021496832;Ne;0;0;2;2
14905;Žirniukas;ZUIKUČIAI;4860680720;Ne;9;1;0;10
14906;Žirniukas;ZUIKUČIAI;7269948694;Ne;0;1;0;1
14907;Žirniukas;ZUIKUČIAI;1679864330;Ne;6;0;1;7
14908;Žirniukas;ZUIKUČIAI;9569187800;Ne;12;2;1;15
14909;Žirniukas;ZUIKUČIAI;2302878611;Ne;0;14;0;14
14910;Aušra;Kodėlčiukai;2611563172;Ne;10;0;0;10
14911;Aušra;Kodėlčiukai;4720749995;Ne;0;2;0;2
14912;Aušra;Kodėlčiukai;6139706771;Ne;11;0;1;12
14913;Aušra;Kodėlčiukai;7314273812;Ne;8;2;0;10
14914;Aušra;Kodėlčiukai;5046439805;Ne;6;0;0;6
14915;Aušra;Kodėlčiukai;4540040693;Ne;9;0;0;9
14916;Aušra;Kodėlčiukai;1423840991;Ne;20;0;0;20
14917;Aušra;Kodėlčiukai;5013135853;Ne;10;1;0;11
14918;Aušra;Kodėlčiukai;9728140172;Ne;7;0;0;7
14919;Aušra;Kodėlčiukai;7765504789;Ne;0;5;0;5
14920;Aušra;Kodėlčiukai;8108663467;Ne;0;1;0;1
14921;Aušra;Kodėlčiukai;4824773027;Ne;4;0;0;4
14922;Aušra;Kodėlčiukai;1897365632;Ne;7;0;0;7
14923;Aušra;Kodėlčiukai;7469266085;Ne;0;16;0;16
14924;Aušra;Kodėlčiukai;1883185016;Ne;0;4;0;4
14925;Aušra;Kodėlčiukai;1773343262;Ne;9;0;0;9
14926;Aušra;Kodėlčiukai;9437530221;Taip;0;2;6;8
14927;Aušra;"4B klasė";92119607174;Ne;13;0;0;13
14928;Aušra;"4B klasė";22923377435;Ne;4;0;0;4
14929;Aušra;"4B klasė";41852924528;Ne;0;20;0;20
14930;Aušra;"4B klasė";58526614808;Ne;0;20;0;20
14931;Aušra;"4B klasė";37339481276;Ne;0;20;0;20
14932;Aušra;"4B klasė";45165946624;Ne;0;20;0;20
14933;Aušra;"4B klasė";48349819906;Ne;6;0;0;6
14934;Aušra;"4B klasė";6201728036;Ne;0;20;0;20
14935;Aušra;"4B klasė";36889923728;Ne;0;20;0;20
14936;Aušra;"4B klasė";8901585006;Ne;0;20;0;20
14937;Aušra;"4B klasė";64562667133;Ne;0;20;0;20
14938;Aušra;"4B klasė";57520886724;Ne;1;0;0;1
14939;Aušra;"4B klasė";75433637766;Ne;0;20;0;20
14940;Aušra;"4B klasė";83119050626;Ne;0;20;0;20
14941;Aušra;"4B klasė";83119050626;Ne;0;20;0;20
14942;Aušra;Smalsučiai;1450251779;Ne;0;5;0;5
14943;Aušra;Smalsučiai;5409157554;Ne;0;1;5;6
14944;Aušra;Smalsučiai;8176840834;Ne;0;6;0;6
14945;Aušra;Smalsučiai;3680329197;Ne;5;0;2;7
14946;Aušra;Smalsučiai;3898178166;Ne;0;6;0;6
14947;Aušra;Smalsučiai;29499576216;Ne;6;0;0;6
14948;Aušra;Smalsučiai;4404047456;Ne;3;0;4;7
14949;Aušra;Smalsučiai;9702136789;Ne;0;0;6;6
14950;Aušra;Smalsučiai;8709340592;Ne;0;0;5;5
14951;Aušra;Smalsučiai;5673568541;Ne;0;0;1;1
14952;Aušra;Smalsučiai;5524681006;Taip;0;2;2;4
14953;Aušra;Smalsučiai;6384243597;Ne;0;5;0;5
14954;Aušra;Smalsučiai;19402768340;Ne;0;4;0;4
14955;Aušra;Smalsučiai;1343532870;Ne;3;0;1;4
14956;Aušra;Smalsučiai;7043021721;Ne;0;2;0;2
14957;Aušra;Smalsučiai;1612662076;Ne;0;7;0;7
14958;Aušra;Smalsučiai;1387254053;Ne;0;1;1;2
14959;Aušra;Smalsučiai;1575761029;Ne;0;0;7;7
14960;Aušra;Smalsučiai;5777939563;Ne;0;1;0;1
14961;Aušra;Smalsučiai;7814902928;Ne;0;1;0;1
14962;Aušra;"1A klasė";3001784066;Ne;8;0;0;8
14963;Aušra;"1A klasė";84116863778;Ne;8;0;0;8
14964;Aušra;"1A klasė";21544489661;Ne;1;0;0;1
14965;Aušra;"1A klasė";24625925423;Ne;2;0;0;2
14966;Aušra;"1A klasė";1893586984;Ne;0;20;0;20
14967;Aušra;"1A klasė";15657824495;Ne;3;0;0;3
14968;Aušra;"1A klasė";79051821501;Ne;8;0;0;8
14969;Aušra;"1A klasė";58254707316;Ne;2;0;0;2
14970;Aušra;"1A klasė";1219257874;Ne;0;20;0;20
14971;Aušra;"1A klasė";4325224130;Ne;2;0;0;2
14972;Aušra;"1A klasė";1623803107;Ne;3;0;0;3
14973;Aušra;"1B klasė";1988459596;Ne;3;0;0;3
14974;Aušra;"1B klasė";4930807661;Ne;2;0;0;2
14975;Aušra;"1B klasė";50687988382;Ne;3;0;0;3
14976;Aušra;"1B klasė";41268510292;Ne;2;0;0;2
14977;Aušra;"1B klasė";8428069167;Ne;10;0;0;10
14978;Aušra;"1B klasė";3910688753;Ne;3;0;0;3
14979;Aušra;"1B klasė";4024898537;Ne;5;0;0;5
14980;Aušra;"1B klasė";4103951942;Ne;7;0;0;7
14981;Aušra;"1B klasė";46481555688;Ne;2;0;0;2
14982;Aušra;"1B klasė";70844824182;Ne;3;0;0;3
14983;Aušra;"1B klasė";17098859260;Ne;11;0;0;11
14984;Aušra;"1B klasė";2841526614;Ne;7;0;0;7
14985;Aušra;"1B klasė";8813044848;Ne;7;0;0;7
14986;Aušra;"1B klasė";58741201573;Ne;4;0;0;4
14987;Aušra;"1B klasė";2003368811;Taip;1;0;0;1
14988;Aušra;"1B klasė";65840410497;Ne;2;0;0;2
14989;Aušra;"1B klasė";90604001837;Ne;2;0;0;2
14990;Aušra;"1B klasė";7794899167;Ne;2;0;0;2
14991;Aušra;"2A klasė";5468993286;Ne;1;0;0;1
14992;Aušra;"2A klasė";1167565535;Ne;5;0;0;5
14993;Aušra;"2A klasė";1145863002;Ne;0;20;0;20
14994;Aušra;"2A klasė";77966124767;Ne;1;0;0;1
14995;Aušra;"2A klasė";1427235223;Ne;2;0;0;2
14996;Aušra;"2A klasė";97312326369;Ne;1;0;0;1
14997;Aušra;"2A klasė";35779814505;Ne;2;0;0;2
14998;Aušra;"2A klasė";1393006122;Ne;4;0;0;4
14999;Aušra;"2A klasė";7998332115;Ne;2;0;0;2
15000;Aušra;"2A klasė";1315930711;Ne;2;0;0;2
15001;Aušra;"2A klasė";42344686036;Ne;2;0;0;2
15002;Aušra;"2A klasė";2647629246;Ne;1;0;0;1
15003;Aušra;"3A klasė";8510995681;Ne;1;0;0;1
15004;Aušra;"3A klasė";9605206310;Ne;3;0;0;3
15005;Aušra;"3A klasė";14157070764;Ne;2;0;0;2
15006;Aušra;"3A klasė";99073448709;Ne;0;20;0;20
15007;Aušra;"3A klasė";68160889669;Ne;4;0;0;4
15008;Aušra;"3A klasė";1437126272;Ne;3;0;0;3
15009;Aušra;"3A klasė";2062775070;Ne;0;20;0;20
15010;Aušra;"3A klasė";88655846176;Ne;1;0;0;1
15011;Aušra;"3A klasė";73509864636;Ne;2;0;0;2
15012;Aušra;"3A klasė";27958163601;Ne;4;0;0;4
15013;Aušra;"3A klasė";68031503463;Ne;6;0;0;6
15014;Aušra;"3A klasė";81633973264;Ne;0;20;0;20
15015;Aušra;"3A klasė";70233681803;Ne;0;20;0;20
15016;Aušra;"3A klasė";1437385365;Ne;0;20;0;20
15017;Aušra;"3A klasė";51185323645;Ne;0;20;0;20
15018;Aušra;"3A klasė";52985512945;Ne;0;20;0;20
15019;Aušra;"3A klasė";97781409787;Ne;0;20;0;20
15020;Aušra;"3A klasė";40714551025;Ne;9;0;0;9
15021;Aušra;"4A klasė";68481706412;Ne;0;20;0;20
15022;Aušra;"4A klasė";99886964420;Ne;0;20;0;20
15023;Aušra;"4A klasė";95948867937;Ne;0;20;0;20
15024;Aušra;"4A klasė";78030425432;Ne;1;0;0;1
15025;Aušra;"4A klasė";97596344387;Ne;0;20;0;20
15026;Aušra;"4A klasė";97596344387;Ne;0;20;0;20
15027;Aušra;"4A klasė";34795588283;Ne;0;20;0;20
15028;Aušra;"4A klasė";29636399665;Ne;0;20;0;20
15029;Aušra;"4A klasė";81428848455;Ne;0;20;0;20
15030;Aušra;"4A klasė";47725613978;Ne;0;20;0;20
15031;Aušra;"4A klasė";93365393803;Ne;0;20;0;20
15032;Aušra;"4A klasė";52864653926;Ne;2;0;0;2
15033;Aušra;"4A klasė";10272136932;Ne;3;0;0;3
15034;Aušra;"4A klasė";77425098448;Ne;0;20;0;20
15035;Aušra;"4A klasė";20550256232;Ne;0;20;0;20
15036;Aušra;"4A klasė";2113586354;Ne;2;0;0;2
15037;Aušra;"4A klasė";19718806057;Ne;0;20;0;20
15038;Aušra;"4A klasė";21856009403;Ne;0;20;0;20
15039;Aušra;"4A klasė";5166358753;Ne;5;0;0;5
15040;Aušra;Pabiručiai;7476662446;Ne;0;0;1;1
15041;Aušra;Pabiručiai;9466807067;Ne;3;0;1;4
15042;Aušra;Pabiručiai;6508435821;Ne;0;2;0;2
15043;Aušra;Pabiručiai;7926621700;Ne;0;4;0;4
15044;Aušra;Pabiručiai;8665364744;Ne;20;0;0;20
15045;Aušra;Pabiručiai;6555345047;Ne;0;4;0;4
15046;Aušra;Pabiručiai;8769357172;Ne;0;2;2;4
15047;Aušra;Pabiručiai;1306616759;Taip;0;3;2;5
15048;Aušra;Pabiručiai;3275288747;Ne;0;0;2;2
15049;Aušra;Pabiručiai;5797692122;Ne;5;3;2;10
15050;Aušra;Pabiručiai;4646215025;Ne;0;0;5;5
15051;Aušra;Pabiručiai;7199483890;Ne;0;2;2;4
15052;Aušra;Pabiručiai;7944904281;Ne;0;1;0;1
15053;Aušra;Pabiručiai;3553620602;Ne;5;2;0;7
15054;Aušra;Pabiručiai;2904303784;Ne;5;2;0;7
15055;Aušra;Pabiručiai;6056923592;Ne;0;1;0;1
15056;Aušra;Pabiručiai;3953653896;Ne;0;2;0;2
15057;Aušra;Pabiručiai;2273160688;Ne;11;1;0;12
15058;Aušra;Pabiručiai;8462418277;Ne;0;1;0;1
15059;Aušra;Gudručiai;2271582954;Ne;0;0;2;2
15060;Aušra;Gudručiai;4564561993;Ne;0;1;0;1
15061;Aušra;Gudručiai;5854637278;Ne;0;4;0;4
15062;Aušra;Gudručiai;8715912139;Ne;9;1;0;10
15063;Aušra;Gudručiai;9614562473;Ne;0;1;0;1
15064;Aušra;Gudručiai;7921251819;Ne;4;2;0;6
15065;Aušra;Gudručiai;9628651723;Ne;6;5;0;11
15066;Aušra;Gudručiai;3343235857;Ne;4;0;0;4
15067;Aušra;Gudručiai;1429548355;Ne;0;4;0;4
15068;Aušra;Gudručiai;1933801749;Ne;0;3;0;3
15069;Aušra;Gudručiai;5955385407;Ne;5;1;0;6
15070;Aušra;Gudručiai;2243689816;Ne;0;19;0;19
15071;Aušra;Gudručiai;1693711284;Ne;6;0;0;6
15072;Aušra;Gudručiai;6935310711;Ne;3;0;0;3
15073;Aušra;Gudručiai;3698868934;Ne;0;10;0;10
15074;Aušra;Gudručiai;9079804366;Ne;0;2;2;4
15075;Aušra;Gudručiai;3498143162;Ne;0;2;2;4
15076;Aušra;Naminukai;8884580599;Ne;6;0;0;6
15077;Aušra;Naminukai;6614027605;Ne;5;0;0;5
15078;Aušra;Naminukai;2039920706;Ne;0;5;0;5
15079;Aušra;Naminukai;6965081051;Ne;2;3;0;5
15080;Aušra;Naminukai;2768220823;Ne;0;0;4;4
15081;Aušra;Naminukai;5925213006;Ne;4;1;0;5
15082;Aušra;Naminukai;1630814772;Ne;8;0;0;8
15083;Aušra;Naminukai;9333701196;Ne;0;2;0;2
15084;Aušra;Naminukai;4010347313;Ne;4;5;0;9
15085;Aušra;Naminukai;3860755808;Ne;0;0;3;3
15086;Aušra;Naminukai;4339450816;Ne;0;2;3;5
15087;Aušra;Naminukai;4000881716;Ne;8;4;1;13
15088;Aušra;Naminukai;5268479689;Ne;2;0;0;2
15089;Aušra;Naminukai;4163605313;Ne;0;5;3;8
15090;Aušra;Naminukai;3468946868;Ne;16;0;0;16
15091;Aušra;Naminukai;7710131755;Ne;10;1;0;11
15092;Aušra;Naminukai;8584355573;Ne;0;2;0;2
15093;Aušra;Naminukai;2495610772;Ne;0;19;0;19
15094;Aušra;Naminukai;8489362814;Ne;0;0;2;2
15095;Aušra;Naminukai;3675175233;Ne;0;4;0;4
15096;Aušra;" 1C klasė";1426802917;Ne;1;0;0;1
15097;Aušra;" 1C klasė";3133031845;Ne;3;0;0;3
15098;Aušra;" 1C klasė";43737170074;Ne;3;0;0;3
15099;Aušra;" 1C klasė";1370336984;Ne;3;0;0;3
15100;Aušra;" 1C klasė";6483078840;Ne;1;0;0;1
15101;Aušra;" 1C klasė";1684481833;Ne;7;0;0;7
15102;Aušra;" 1C klasė";5704281727;Ne;5;0;0;5
15103;Aušra;" 1C klasė";1479311429;Ne;4;0;0;4
15104;Aušra;" 1C klasė";90520726029;Ne;1;0;0;1
15105;Aušra;" 1C klasė";1844632980;Ne;2;0;0;2
15106;Aušra;" 1C klasė";94478599707;Ne;1;0;0;1
15107;Aušra;" 1C klasė";78489473446;Ne;7;0;0;7
15108;Aušra;" 1C klasė";29328876924;Ne;9;0;0;9
15109;Aušra;" 1C klasė";7649832094;Ne;2;0;0;2
15110;Aušra;" 1C klasė";8225188274;Ne;11;0;0;11
15111;Aušra;" 1C klasė";1371282149;Ne;2;0;0;2
15112;Berželis;PČIOLKI;6113571093;Ne;7;0;1;8
15113;Berželis;PČIOLKI;9024992452;Ne;0;0;1;1
15114;Berželis;PČIOLKI;1521982237;Ne;0;0;4;4
15115;Berželis;PČIOLKI;3437712794;Ne;5;0;0;5
15116;Berželis;PČIOLKI;3298044639;Ne;5;0;0;5
15117;Berželis;PČIOLKI;2615440913;Ne;0;0;1;1
15118;Berželis;PČIOLKI;3772780161;Ne;16;0;0;16
15119;Berželis;PČIOLKI;4563582416;Ne;16;0;0;16
15120;Berželis;PČIOLKI;9894751274;Ne;0;0;2;2
15121;Berželis;PČIOLKI;7526006253;Ne;5;0;0;5
15122;Berželis;PČIOLKI;1036370516;Ne;10;0;0;10
15123;Berželis;PČIOLKI;2214171136;Ne;11;0;0;11
15124;Berželis;PČIOLKI;6473498471;Ne;2;8;6;16
15125;Berželis;PČIOLKI;97218091736;Ne;9;0;0;9
15126;Berželis;PČIOLKI;5798989689;Ne;4;0;0;4
15127;Berželis;PČIOLKI;2007064959;Ne;8;0;0;8
15128;Berželis;PČIOLKI;5084171353;Ne;7;0;1;8
15129;Berželis;PČIOLKI;4521372127;Ne;0;2;0;2
15130;Berželis;PČIOLKI;1067618571;Ne;9;0;0;9
15131;Berželis;PČIOLKI;7287552286;Ne;0;0;4;4
15132;Berželis;"BOŽJI KOROVKI";3162044236;Ne;5;1;0;6
15133;Berželis;"BOŽJI KOROVKI";9132058594;Taip;9;0;1;10
15134;Berželis;"BOŽJI KOROVKI";7421059780;Ne;8;0;3;11
15135;Berželis;"BOŽJI KOROVKI";5739847580;Ne;0;2;0;2
15136;Berželis;"BOŽJI KOROVKI";4100740863;Ne;0;16;0;16
15137;Berželis;"BOŽJI KOROVKI";1750209600;Taip;3;1;0;4
15138;Berželis;"BOŽJI KOROVKI";5953387226;Ne;7;6;3;16
15139;Berželis;"BOŽJI KOROVKI";3070917065;Ne;0;11;0;11
15140;Berželis;"BOŽJI KOROVKI";8118040960;Ne;5;2;0;7
15141;Berželis;"BOŽJI KOROVKI";2005082089;Ne;4;1;0;5
15142;Berželis;"BOŽJI KOROVKI";5692603837;Taip;13;1;1;15
15143;Berželis;"BOŽJI KOROVKI";5194480946;Ne;5;1;0;6
15144;Berželis;"BOŽJI KOROVKI";9848723402;Ne;0;2;1;3
15145;Berželis;"BOŽJI KOROVKI";5551459997;Ne;10;1;0;11
15146;Berželis;"BOŽJI KOROVKI";6651007152;Ne;16;0;0;16
15147;Berželis;"BOŽJI KOROVKI";8451877584;Ne;11;0;0;11
15148;Berželis;"BOŽJI KOROVKI";7080168105;Ne;10;2;2;14
15149;Berželis;"BOŽJI KOROVKI";9438498834;Ne;0;1;0;1
15150;Berželis;"BOŽJI KOROVKI";1132252592;Ne;5;0;1;6
15151;Berželis;"BOŽJI KOROVKI";5550598069;Ne;6;2;0;8
15152;Berželis;"BOŽJI KOROVKI";1852964349;Ne;2;0;0;2
15153;Berželis;"BOŽJI KOROVKI";8871199713;Ne;10;0;3;13
15154;Berželis;"BOŽJI KOROVKI";1722262813;Ne;0;4;0;4
15155;Berželis;"BOŽJI KOROVKI";9466461910;Ne;10;0;0;10
15156;Berželis;SOLNYŠKO;2182268389;Ne;0;0;1;1
15157;Berželis;SOLNYŠKO;1498165322;Ne;0;0;3;3
15158;Berželis;SOLNYŠKO;8737788279;Ne;9;0;0;9
15159;Berželis;SOLNYŠKO;2901168499;Ne;4;0;4;8
15160;Berželis;SOLNYŠKO;7411282628;Ne;0;20;0;20
15161;Berželis;SOLNYŠKO;8957312159;Ne;0;20;0;20
15162;Berželis;SOLNYŠKO;1167103292;Ne;0;0;1;1
15163;Berželis;SOLNYŠKO;5408368340;Ne;0;0;7;7
15164;Berželis;SOLNYŠKO;1070751052;Ne;10;0;1;11
15165;Berželis;SOLNYŠKO;1424868444;Ne;0;4;0;4
15166;Berželis;SOLNYŠKO;1146976812;Ne;0;1;0;1
15167;Berželis;SOLNYŠKO;6774460279;Ne;20;0;0;20
15168;Berželis;SOLNYŠKO;5866092980;Ne;0;0;5;5
15169;Berželis;BABOČKI;2016194182;Ne;0;0;1;1
15170;Berželis;BABOČKI;2030770943;Ne;3;0;1;4
15171;Berželis;BABOČKI;2667957070;Ne;4;0;0;4
15172;Berželis;BABOČKI;7781031211;Ne;8;0;0;8
15173;Berželis;BABOČKI;2493612905;Taip;1;0;1;2
15174;Berželis;BABOČKI;5688897783;Ne;0;10;0;10
15175;Berželis;BABOČKI;9245706377;Ne;3;4;0;7
15176;Berželis;BABOČKI;6352635742;Ne;0;6;1;7
15177;Berželis;BABOČKI;8448872491;Ne;0;3;0;3
15178;Berželis;BABOČKI;5069322062;Ne;6;0;1;7
15179;Berželis;BABOČKI;2954451168;Ne;10;0;0;10
15180;Berželis;BABOČKI;9585609150;Ne;0;4;0;4
15181;Berželis;BABOČKI;9091691636;Ne;4;0;2;6
15182;Berželis;BABOČKI;7940591009;Ne;0;0;1;1
15183;Berželis;BABOČKI;4546285993;Ne;0;20;0;20
15184;Berželis;BABOČKI;5876182759;Ne;0;4;0;4
15185;Berželis;BABOČKI;6577232093;Ne;4;5;0;9
15186;Berželis;BABOČKI;6387242787;Ne;0;20;0;20
15187;Berželis;SOVUŠKI;8185887403;Ne;6;0;0;6
15188;Berželis;SOVUŠKI;1289333809;Ne;14;0;0;14
15189;Berželis;SOVUŠKI;8086074279;Ne;0;2;0;2
15190;Berželis;SOVUŠKI;9273819928;Ne;5;3;0;8
15191;Berželis;SOVUŠKI;3885474466;Ne;3;1;0;4
15192;Berželis;SOVUŠKI;1825910306;Ne;3;1;0;4
15193;Berželis;SOVUŠKI;1464998584;Ne;10;0;0;10
15194;Berželis;SOVUŠKI;3835273594;Ne;0;10;0;10
15195;Berželis;SOVUŠKI;2632535013;Ne;8;0;0;8
15196;Berželis;SOVUŠKI;6698849108;Ne;2;0;2;4
15197;Berželis;SOVUŠKI;1583268041;Ne;7;0;0;7
15198;Berželis;PODSOLNUŠKI;1044720859;Ne;0;0;1;1
15199;Berželis;PODSOLNUŠKI;3157906472;Ne;13;0;0;13
15200;Berželis;PODSOLNUŠKI;9945124824;Ne;13;0;0;13
15201;Berželis;PODSOLNUŠKI;5925726854;Ne;0;0;3;3
15202;Berželis;PODSOLNUŠKI;8168498937;Ne;8;0;0;8
15203;Berželis;PODSOLNUŠKI;9072126286;Ne;6;0;0;6
15204;Berželis;PODSOLNUŠKI;8633724383;Ne;12;0;0;12
15205;Berželis;PODSOLNUŠKI;2259367998;Ne;8;0;2;10
15206;Berželis;PODSOLNUŠKI;3033042487;Ne;9;0;2;11
15207;Berželis;PODSOLNUŠKI;2136455625;Ne;13;0;5;18
15208;Berželis;PODSOLNUŠKI;1964320071;Ne;14;0;0;14
15209;Berželis;PODSOLNUŠKI;2615832804;Ne;10;7;0;17
15210;Berželis;PODSOLNUŠKI;9133988149;Ne;12;0;1;13
15211;Berželis;PODSOLNUŠKI;5795151632;Ne;8;0;2;10
15212;Berželis;PODSOLNUŠKI;6686248053;Ne;12;0;0;12
15213;Berželis;PODSOLNUŠKI;1081582842;Taip;11;3;0;14
15214;Berželis;PODSOLNUŠKI;5963915092;Ne;15;0;0;15
15215;Berželis;PODSOLNUŠKI;3378237475;Ne;15;0;2;17
15216;Berželis;LAPIUKAI;2539824027;Taip;0;0;1;1
15217;Berželis;LAPIUKAI;9658062645;Ne;0;0;1;1
15218;Berželis;LAPIUKAI;7947225506;Ne;0;0;1;1
15219;Berželis;LAPIUKAI;2144796691;Ne;22;0;0;22
15220;Berželis;LAPIUKAI;1834920753;Taip;4;0;1;5
15221;Berželis;LAPIUKAI;2794074071;Taip;3;0;0;3
15222;Berželis;LAPIUKAI;9681310544;Taip;0;7;0;7
15223;Berželis;LAPIUKAI;9543499205;Ne;0;1;0;1
15224;Berželis;LAPIUKAI;2947072348;Ne;0;1;0;1
15225;Berželis;LAPIUKAI;4243086262;Ne;4;0;0;4
15226;Berželis;LAPIUKAI;8994102218;Taip;0;11;0;11
15227;Berželis;LAPIUKAI;4854931959;Taip;0;0;5;5
15228;Berželis;MEŠKIUKAI;7902774064;Taip;11;0;1;12
15229;Berželis;MEŠKIUKAI;9459031158;Ne;10;0;0;10
15230;Berželis;MEŠKIUKAI;1235617054;Ne;17;2;0;19
15231;Berželis;MEŠKIUKAI;1178588907;Ne;10;0;0;10
15232;Berželis;MEŠKIUKAI;5100214127;Ne;5;1;0;6
15233;Berželis;MEŠKIUKAI;3535856504;Taip;1;0;0;1
15234;Berželis;MEŠKIUKAI;1673524685;Ne;4;0;0;4
15235;Berželis;MEŠKIUKAI;8560266611;Ne;11;0;1;12
15236;Berželis;MEŠKIUKAI;3936106342;Taip;4;0;0;4
15237;Berželis;MEŠKIUKAI;6689893827;Ne;6;0;0;6
15238;Berželis;MEŠKIUKAI;8251510865;Ne;0;0;3;3
15239;Berželis;MEŠKIUKAI;9182053246;Ne;11;0;0;11
15240;Berželis;MEŠKIUKAI;7535016799;Taip;20;0;0;20
15241;Berželis;ŽIEDELIAI;9805181733;Ne;6;0;2;8
15242;Berželis;ŽIEDELIAI;1165300871;Ne;5;0;1;6
15243;Berželis;ŽIEDELIAI;2016827207;Ne;5;0;2;7
15244;Berželis;ŽIEDELIAI;9979442772;Ne;0;0;7;7
15245;Berželis;ŽIEDELIAI;7042967329;Ne;17;0;0;17
15246;Berželis;ŽIEDELIAI;9925865228;Ne;0;0;6;6
15247;Berželis;ŽIEDELIAI;1402975280;Ne;0;5;0;5
15248;Berželis;ŽIEDELIAI;1535940949;Taip;0;9;0;9
15249;Berželis;ŽIEDELIAI;2030492491;Ne;0;0;1;1
15250;Berželis;ŽIEDELIAI;3351114197;Ne;0;0;8;8
15251;Berželis;ŽIEDELIAI;5248880873;Ne;5;0;4;9
15252;Berželis;ŽIEDELIAI;2262911854;Ne;3;0;0;3
15253;Berželis;ŽIEDELIAI;2508532190;Ne;6;0;0;6
15254;Berželis;ŽIEDELIAI;7807553847;Ne;1;0;0;1
15255;Berželis;NYKŠTUKAI;8148104183;Ne;0;0;7;7
15256;Berželis;NYKŠTUKAI;7935684899;Ne;14;0;3;17
15257;Berželis;NYKŠTUKAI;1403664386;Ne;5;4;1;10
15258;Berželis;NYKŠTUKAI;5637168259;Ne;13;0;0;13
15259;Berželis;NYKŠTUKAI;9666648116;Ne;5;0;0;5
15260;Berželis;NYKŠTUKAI;3559065542;Ne;8;0;1;9
15261;Berželis;NYKŠTUKAI;3556594755;Ne;2;0;4;6
15262;Berželis;NYKŠTUKAI;2933069798;Ne;5;0;4;9
15263;Berželis;NYKŠTUKAI;8430372047;Ne;7;0;2;9
15264;Berželis;NYKŠTUKAI;5099275362;Taip;10;0;0;10
15265;Berželis;NYKŠTUKAI;5101382213;Ne;0;0;7;7
15266;Berželis;NYKŠTUKAI;2425621326;Ne;12;0;1;13
15267;Berželis;NYKŠTUKAI;7676141462;Ne;0;6;0;6
15268;Berželis;NYKŠTUKAI;3852021563;Ne;5;0;3;8
15269;Berželis;NYKŠTUKAI;3379227410;Ne;0;0;4;4
15270;Berželis;NYKŠTUKAI;5839964720;Ne;3;1;0;4
15271;Berželis;UOGELĖS;8735934456;Ne;5;0;0;5
15272;Berželis;UOGELĖS;5304917030;Taip;0;0;3;3
15273;Berželis;UOGELĖS;6136155301;Ne;15;0;1;16
15274;Berželis;UOGELĖS;9950641759;Ne;1;0;3;4
15275;Berželis;UOGELĖS;5851732944;Ne;7;0;1;8
15276;Berželis;UOGELĖS;2321608974;Ne;0;0;7;7
15277;Berželis;UOGELĖS;3229996417;Ne;0;0;4;4
15278;Berželis;UOGELĖS;6773760208;Taip;20;0;0;20
15279;Berželis;UOGELĖS;7750905743;Taip;5;0;0;5
15280;Berželis;UOGELĖS;4607486516;Ne;4;0;1;5
15281;Berželis;UOGELĖS;8814953641;Ne;5;0;2;7
15282;Berželis;UOGELĖS;5197350105;Ne;0;0;2;2
15283;Berželis;KODĖLČIUKAI;5786052354;Ne;7;0;1;8
15284;Berželis;KODĖLČIUKAI;5134372871;Ne;6;1;0;7
15285;Berželis;KODĖLČIUKAI;5751995154;Ne;0;0;3;3
15286;Berželis;KODĖLČIUKAI;3589890886;Ne;0;1;0;1
15287;Berželis;KODĖLČIUKAI;7986744784;Ne;4;0;0;4
15288;Berželis;KODĖLČIUKAI;1127524998;Ne;5;0;1;6
15289;Berželis;KODĖLČIUKAI;3951962738;Taip;2;0;0;2
15290;Berželis;KODĖLČIUKAI;2193392844;Taip;11;0;1;12
15291;Berželis;KODĖLČIUKAI;9696962207;Ne;5;0;3;8
15292;Berželis;KODĖLČIUKAI;8286301258;Ne;9;8;0;17
15293;Berželis;KODĖLČIUKAI;8875116641;Ne;0;0;2;2
15294;Berželis;KODĖLČIUKAI;6500588668;Ne;2;0;1;3
15295;Berželis;KODĖLČIUKAI;3327751482;Ne;0;0;4;4
15296;Berželis;KODĖLČIUKAI;6060490387;Ne;5;0;0;5
15297;Berželis;KODĖLČIUKAI;4254592648;Ne;0;0;5;5
15298;"Vilniaus savivaldybės Grigiškių lopšelis-darželis „Pelėdžiukas“";Boružiukai;4717485711;Ne;2;0;0;2
15299;"Vilniaus savivaldybės Grigiškių lopšelis-darželis „Pelėdžiukas“";Boružiukai;4416321501;Ne;11;0;0;11
15300;"Vilniaus savivaldybės Grigiškių lopšelis-darželis „Pelėdžiukas“";Boružiukai;8186650663;Ne;2;0;0;2
15301;"Vilniaus savivaldybės Grigiškių lopšelis-darželis „Pelėdžiukas“";Boružiukai;8167858668;Ne;5;0;0;5
15302;"Vilniaus savivaldybės Grigiškių lopšelis-darželis „Pelėdžiukas“";Bitutės;5577887760;Ne;7;0;0;7
15303;"Vilniaus savivaldybės Grigiškių lopšelis-darželis „Pelėdžiukas“";Bitutės;8809390531;Ne;20;0;0;20
15304;"Vilniaus savivaldybės Grigiškių lopšelis-darželis „Pelėdžiukas“";Šimtakojai;9873016236;Ne;4;0;0;4
15305;"Vilniaus savivaldybės Grigiškių lopšelis-darželis „Pelėdžiukas“";Šimtakojai;2636303097;Ne;7;0;0;7
15306;"Vilniaus savivaldybės Grigiškių lopšelis-darželis „Pelėdžiukas“";Šimtakojai;3665649945;Ne;13;0;0;13
15307;"Vilniaus savivaldybės Grigiškių lopšelis-darželis „Pelėdžiukas“";Šimtakojai;4952438410;Ne;9;0;0;9
15308;"Vilniaus savivaldybės Grigiškių lopšelis-darželis „Pelėdžiukas“";Šimtakojai;8981652451;Ne;16;0;0;16
15309;"Vilniaus savivaldybės Grigiškių lopšelis-darželis „Pelėdžiukas“";Šimtakojai;7552237759;Ne;10;0;0;10
15310;"Vilniaus savivaldybės Grigiškių lopšelis-darželis „Pelėdžiukas“";Šimtakojai;9540483835;Ne;12;0;0;12
15311;"Vilniaus savivaldybės Grigiškių lopšelis-darželis „Pelėdžiukas“";Šimtakojai;1414374293;Ne;5;0;0;5
15312;"Vilniaus savivaldybės Grigiškių lopšelis-darželis „Pelėdžiukas“";Šimtakojai;8509392550;Ne;11;0;0;11
15313;"Vilniaus savivaldybės Grigiškių lopšelis-darželis „Pelėdžiukas“";Voriukai;8749407065;Ne;10;0;0;10
15314;"Vilniaus savivaldybės Grigiškių lopšelis-darželis „Pelėdžiukas“";Voriukai;9091186589;Ne;2;0;0;2
15315;"Vilniaus savivaldybės Grigiškių lopšelis-darželis „Pelėdžiukas“";Voriukai;4531333251;Ne;7;0;0;7
15316;"Vilniaus savivaldybės Grigiškių lopšelis-darželis „Pelėdžiukas“";Voriukai;4201194457;Ne;4;0;0;4
15317;"Vilniaus savivaldybės Grigiškių lopšelis-darželis „Pelėdžiukas“";Voriukai;7905678693;Ne;4;0;0;4
15318;"Vilniaus savivaldybės Grigiškių lopšelis-darželis „Pelėdžiukas“";Žiogeliai;3551021368;Ne;4;0;0;4
15319;"Vilniaus savivaldybės Grigiškių lopšelis-darželis „Pelėdžiukas“";Žiogeliai;5586528502;Ne;5;0;0;5
15320;"Vilniaus savivaldybės Grigiškių lopšelis-darželis „Pelėdžiukas“";Žiogeliai;5382214547;Ne;11;0;0;11
15321;"Vilniaus savivaldybės Grigiškių lopšelis-darželis „Pelėdžiukas“";Žiogeliai;6943790883;Ne;8;0;0;8
15322;"Vilniaus savivaldybės Grigiškių lopšelis-darželis „Pelėdžiukas“";Žiogeliai;7611551430;Ne;8;0;0;8
15323;"Vilniaus savivaldybės Grigiškių lopšelis-darželis „Pelėdžiukas“";Žiogeliai;5383099966;Ne;1;0;0;1
15324;"Vilniaus savivaldybės Grigiškių lopšelis-darželis „Pelėdžiukas“";SKRUZDELIUKAI;3494244855;Ne;11;0;0;11
15325;"Vilniaus savivaldybės Grigiškių lopšelis-darželis „Pelėdžiukas“";SKRUZDELIUKAI;2039158517;Ne;10;0;0;10
15326;"Vilniaus savivaldybės Grigiškių lopšelis-darželis „Pelėdžiukas“";SKRUZDELIUKAI;7154840871;Ne;20;0;0;20
15327;"Vilniaus savivaldybės Grigiškių lopšelis-darželis „Pelėdžiukas“";SKRUZDELIUKAI;7389134464;Ne;13;0;0;13
15328;"Vilniaus savivaldybės Grigiškių lopšelis-darželis „Pelėdžiukas“";SKRUZDELIUKAI;8473409188;Ne;11;0;0;11
15329;"Vilniaus savivaldybės Grigiškių lopšelis-darželis „Pelėdžiukas“";SKRUZDELIUKAI;4880175524;Ne;3;0;0;3
15330;"Vilniaus savivaldybės Grigiškių lopšelis-darželis „Pelėdžiukas“";DRUGELIAI;3252144357;Ne;10;0;0;10
15331;"Vilniaus savivaldybės Grigiškių lopšelis-darželis „Pelėdžiukas“";DRUGELIAI;6940865564;Ne;15;0;0;15
15332;"Vilniaus savivaldybės Grigiškių lopšelis-darželis „Pelėdžiukas“";DRUGELIAI;7919921890;Ne;4;0;0;4
15333;"Vilniaus savivaldybės Grigiškių lopšelis-darželis „Pelėdžiukas“";DRUGELIAI;5708062625;Ne;3;0;0;3
15334;"Vilniaus savivaldybės Grigiškių lopšelis-darželis „Pelėdžiukas“";DRUGELIAI;8732447498;Ne;14;0;0;14
15335;"Vilniaus savivaldybės Grigiškių lopšelis-darželis „Pelėdžiukas“";DRUGELIAI;7670521802;Ne;5;0;0;5
15336;"Vilniaus savivaldybės Grigiškių lopšelis-darželis „Pelėdžiukas“";LAUMŽIRGIAI;3989005936;Ne;9;0;0;9
15337;"Vilniaus savivaldybės Grigiškių lopšelis-darželis „Pelėdžiukas“";LAUMŽIRGIAI;9958849499;Ne;3;0;0;3
15338;"Vilniaus savivaldybės Grigiškių lopšelis-darželis „Pelėdžiukas“";LAUMŽIRGIAI;6709604166;Ne;14;0;0;14
15339;"Vilniaus savivaldybės Grigiškių lopšelis-darželis „Pelėdžiukas“";LAUMŽIRGIAI;2345722745;Ne;11;0;0;11
15340;Saulutė;Drugeliai;5987478379;Taip;8;0;1;9
15341;Saulutė;Drugeliai;5943795519;Ne;9;0;1;10
15342;Saulutė;Drugeliai;4453610732;Ne;0;14;0;14
15343;Saulutė;Drugeliai;4067009709;Ne;0;1;2;3
15344;Saulutė;Drugeliai;3991128892;Ne;9;0;0;9
15345;Saulutė;Drugeliai;4781756849;Ne;0;20;0;20
15346;Saulutė;Drugeliai;7689842018;Ne;0;0;2;2
15347;Saulutė;Drugeliai;4288298305;Ne;0;10;0;10
15348;Saulutė;Drugeliai;9133269796;Ne;0;1;4;5
15349;Saulutė;Drugeliai;6057938367;Ne;16;1;0;17
15350;Saulutė;Drugeliai;1268204445;Ne;0;1;1;2
15351;Saulutė;Drugeliai;1585403702;Ne;8;0;0;8
15352;Saulutė;Drugeliai;4915192103;Ne;8;0;4;12
15353;Saulutė;Drugeliai;8003855875;Ne;8;0;1;9
15354;Saulutė;Drugeliai;2301903550;Ne;20;0;0;20
15355;Saulutė;Drugeliai;3265401334;Ne;11;0;0;11
15356;Saulutė;Drugeliai;2337702344;Ne;7;0;0;7
15357;Saulutė;Drugeliai;3662919521;Ne;3;1;0;4
15358;Saulutė;Drugeliai;6455593653;Ne;4;0;0;4
15359;Saulutė;Drugeliai;9410517602;Ne;9;0;0;9
15360;Saulutė;Drugeliai;1088813143;Ne;8;0;2;10
15361;Saulutė;Drugeliai;8409958782;Ne;2;7;0;9
15362;Saulutė;Drugeliai;6304028361;Ne;2;1;0;3
15363;Saulutė;"Saulės zuikučiai";5148542811;Ne;15;0;0;15
15364;Saulutė;"Saulės zuikučiai";2259917151;Ne;9;1;0;10
15365;Saulutė;"Saulės zuikučiai";3749374270;Ne;0;2;1;3
15366;Saulutė;"Saulės zuikučiai";8242602551;Ne;10;4;0;14
15367;Saulutė;"Saulės zuikučiai";5247769309;Ne;7;4;0;11
15368;Saulutė;"Saulės zuikučiai";7888435573;Ne;0;1;0;1
15369;Saulutė;"Saulės zuikučiai";3089541630;Ne;5;0;0;5
15370;Saulutė;"Saulės zuikučiai";5326279083;Ne;0;0;1;1
15371;Saulutė;"Saulės zuikučiai";1562393383;Ne;0;0;2;2
15372;Saulutė;"Saulės zuikučiai";3272296969;Taip;0;0;2;2
15373;Saulutė;"Saulės zuikučiai";6924891265;Ne;10;0;0;10
15374;Saulutė;"Saulės zuikučiai";4663795223;Ne;20;0;2;22
15375;Saulutė;"Saulės zuikučiai";5931269521;Ne;5;4;0;9
15376;Saulutė;"Saulės zuikučiai";7839168221;Ne;11;0;0;11
15377;Saulutė;"Saulės zuikučiai";4945943570;Ne;4;0;2;6
15378;Saulutė;"Saulės zuikučiai";3730442890;Ne;13;0;0;13
15379;Saulutė;"Saulės zuikučiai";3620722907;Ne;0;0;1;1
15380;Saulutė;Boružėlės;3295289082;Ne;0;1;0;1
15381;Saulutė;Boružėlės;8390767549;Ne;7;0;1;8
15382;Saulutė;Boružėlės;7576532632;Ne;0;9;1;10
15383;Saulutė;Boružėlės;2725491887;Ne;2;0;2;4
15384;Saulutė;Boružėlės;7764493159;Ne;0;0;1;1
15385;Saulutė;Boružėlės;5565832676;Ne;0;0;2;2
15386;Saulutė;Boružėlės;5811810714;Ne;0;0;7;7
15387;Saulutė;Boružėlės;7081700501;Ne;0;3;0;3
15388;Saulutė;Boružėlės;7474989619;Ne;5;4;0;9
15389;Saulutė;Boružėlės;8619163154;Ne;0;0;2;2
15390;Saulutė;Boružėlės;1803710557;Ne;10;0;2;12
15391;Saulutė;Boružėlės;9098663596;Ne;0;0;2;2
15392;Saulutė;Boružėlės;7425789805;Ne;0;12;0;12
15393;Saulutė;Boružėlės;1265174091;Ne;5;0;1;6
15394;Saulutė;Boružėlės;2527027536;Ne;0;0;4;4
15395;Saulutė;Boružėlės;3852862834;Ne;0;10;0;10
15396;Saulutė;Boružėlės;1275552038;Ne;0;0;3;3
15397;Saulutė;Nykštukai;2601822200;Ne;0;0;4;4
15398;Saulutė;Nykštukai;9497439410;Ne;0;11;0;11
15399;Saulutė;Nykštukai;5607937410;Ne;0;4;0;4
15400;Saulutė;Nykštukai;3571751974;Ne;6;0;1;7
15401;Saulutė;Nykštukai;3221612665;Ne;5;0;1;6
15402;Saulutė;Nykštukai;2140277182;Ne;13;2;0;15
15403;Saulutė;Nykštukai;4510990261;Ne;0;0;1;1
15404;Saulutė;Nykštukai;4800144085;Ne;7;0;0;7
15405;Saulutė;Nykštukai;8257363228;Ne;4;0;1;5
15406;Saulutė;Nykštukai;8984040932;Ne;0;1;0;1
15407;Saulutė;Nykštukai;3463428772;Ne;0;1;0;1
15408;Saulutė;Nykštukai;4390098560;Ne;5;0;0;5
15409;Saulutė;Nykštukai;3363212754;Ne;0;2;0;2
15410;Saulutė;Nykštukai;5442075474;Ne;12;0;0;12
15411;Saulutė;Nykštukai;8722717930;Ne;0;0;20;20
15412;Saulutė;Nykštukai;2669711574;Taip;7;0;1;8
15413;Saulutė;Meškiukai;8952893819;Ne;0;15;0;15
15414;Saulutė;Meškiukai;4222649372;Ne;5;0;1;6
15415;Saulutė;Meškiukai;1229624643;Ne;17;0;0;17
15416;Saulutė;Meškiukai;9572394489;Ne;10;0;10;20
15417;Saulutė;Meškiukai;9567511354;Ne;6;0;2;8
15418;Saulutė;Meškiukai;6579874077;Ne;0;17;0;17
15419;Saulutė;Meškiukai;6178908581;Ne;0;9;1;10
15420;Saulutė;Meškiukai;8472510151;Ne;6;0;3;9
15421;Saulutė;Meškiukai;6955061957;Ne;7;5;0;12
15422;Saulutė;Meškiukai;7478215328;Ne;12;0;0;12
15423;Saulutė;Meškiukai;9727366891;Ne;6;0;7;13
15424;Saulutė;Meškiukai;5219429911;Ne;0;7;0;7
15425;Saulutė;Meškiukai;3125186472;Ne;10;0;4;14
15426;Saulutė;Meškiukai;5509365461;Ne;6;0;0;6
15427;Saulutė;Meškiukai;8787977881;Ne;8;0;1;9
15428;Saulutė;Meškiukai;8147755754;Ne;4;0;8;12
15429;Saulutė;Ežiukai;2813274509;Ne;12;0;0;12
15430;Saulutė;Ežiukai;3410606033;Taip;6;6;0;12
15431;Saulutė;Ežiukai;2315812734;Ne;0;0;3;3
15432;Saulutė;Ežiukai;2059342403;Ne;6;0;0;6
15433;Saulutė;Ežiukai;8736917541;Ne;0;0;1;1
15434;Saulutė;Ežiukai;4363210987;Ne;0;0;1;1
15435;Saulutė;Ežiukai;5972503001;Ne;15;0;1;16
15436;Saulutė;Ežiukai;6884472677;Ne;10;0;4;14
15437;Saulutė;Ežiukai;6219942114;Ne;11;0;0;11
15438;Saulutė;Ežiukai;4194586403;Ne;0;0;1;1
15439;Saulutė;Ežiukai;1853984777;Ne;7;0;1;8
15440;Saulutė;Ežiukai;1666301750;Ne;7;0;4;11
15441;Saulutė;Ežiukai;3133714991;Ne;0;0;5;5
15442;Saulutė;Ežiukai;4039065925;Ne;0;0;5;5
15443;Saulutė;Ežiukai;7967532537;Ne;1;0;0;1
15444;Saulutė;Ežiukai;5335820652;Ne;0;0;1;1
15445;Saulutė;Ežiukai;2728669975;Ne;17;0;0;17
15446;Saulutė;Ežiukai;9398356470;Ne;5;0;6;11
15447;Saulutė;Ežiukai;6126870829;Ne;0;0;4;4
15448;Saulutė;Ežiukai;3565818383;Ne;9;0;0;9
15449;Saulutė;Bitutės;5200638523;Ne;8;0;0;8
15450;Saulutė;Bitutės;5448950324;Ne;7;0;20;27
15451;Saulutė;Bitutės;3948540247;Ne;4;0;0;4
15452;Saulutė;Bitutės;4130972647;Ne;11;0;3;14
15453;Saulutė;Bitutės;3242810449;Ne;0;7;0;7
15454;Saulutė;Bitutės;7032417938;Taip;10;0;2;12
15455;Saulutė;Bitutės;5897526863;Ne;14;0;0;14
15456;Saulutė;Bitutės;9110162513;Ne;0;0;3;3
15457;Saulutė;Bitutės;1648978545;Ne;0;12;0;12
15458;Saulutė;Bitutės;6927834443;Taip;0;15;0;15
15459;Saulutė;Bitutės;8714520840;Ne;0;16;0;16
15460;Saulutė;Bitutės;9726675673;Ne;11;6;0;17
15461;Saulutė;Bitutės;8520474896;Ne;11;6;0;17
15462;Saulutė;Bitutės;6189637986;Ne;9;0;0;9
15463;Saulutė;Bitutės;7132125341;Ne;0;0;3;3
15464;Saulutė;Bitutės;3215349379;Ne;0;0;12;12
15465;Saulutė;Bitutės;3259790911;Ne;11;0;0;11
15466;Saulutė;Bitutės;7311594119;Ne;12;8;0;20
15467;Saulutė;Pelėdžiukai;8512137633;Ne;12;2;0;14
15468;Saulutė;Pelėdžiukai;7139492238;Ne;5;0;0;5
15469;Saulutė;Pelėdžiukai;4211866191;Ne;0;0;1;1
15470;Saulutė;Pelėdžiukai;2373409300;Ne;6;0;0;6
15471;Saulutė;Pelėdžiukai;8405262902;Ne;17;0;1;18
15472;Saulutė;Pelėdžiukai;1745754752;Ne;5;0;0;5
15473;Saulutė;Pelėdžiukai;4123500930;Ne;0;0;4;4
15474;Saulutė;Pelėdžiukai;1056158093;Ne;2;0;0;2
15475;Saulutė;Pelėdžiukai;8371366346;Ne;0;4;0;4
15476;Saulutė;Pelėdžiukai;6842585310;Ne;12;0;0;12
15477;Saulutė;Pelėdžiukai;1776164273;Ne;15;0;1;16
15478;Saulutė;Pelėdžiukai;5850783789;Ne;0;2;0;2
15479;Saulutė;Pelėdžiukai;6608003946;Ne;0;20;0;20
15480;Saulutė;Pelėdžiukai;7243072252;Ne;0;0;1;1
15481;Saulutė;Pelėdžiukai;9903380188;Ne;0;0;1;1
15482;Saulutė;Pelėdžiukai;7620841597;Ne;0;0;1;1
15483;Saulutė;Pelėdžiukai;6046611248;Taip;6;1;0;7
15484;Saulutė;Pelėdžiukai;4301516165;Ne;0;14;2;16
15485;Saulutė;Pelėdžiukai;7258180835;Ne;5;0;1;6
15486;Saulutė;Pelėdžiukai;2566263680;Ne;7;0;2;9
15487;Saulutė;Pelėdžiukai;9106119465;Ne;6;0;2;8
15488;Saulutė;Zylutės;3228226715;Ne;9;0;1;10
15489;Saulutė;Zylutės;8040751073;Ne;0;0;3;3
15490;Saulutė;Zylutės;2074473832;Ne;6;0;1;7
15491;Saulutė;Zylutės;8041118115;Ne;0;20;0;20
15492;Saulutė;Zylutės;5198558993;Ne;20;0;0;20
15493;Saulutė;Zylutės;6109527712;Ne;0;0;2;2
15494;Saulutė;Zylutės;7446423510;Ne;0;1;0;1
15495;Saulutė;Zylutės;8717210130;Ne;0;6;0;6
15496;Saulutė;Zylutės;5264813819;Ne;3;0;0;3
15497;Saulutė;Zylutės;9146298505;Ne;0;4;0;4
15498;Saulutė;Zylutės;1324799653;Ne;0;4;0;4
15499;Saulutė;Zylutės;3691381351;Ne;0;1;0;1
15500;Saulutė;Zylutės;2010774109;Ne;3;0;0;3
15501;Saulutė;Zylutės;1546200973;Ne;14;0;0;14
15502;Saulutė;Zylutės;8379304869;Ne;4;0;0;4
15503;Saulutė;Zylutės;66108847230;Ne;8;7;0;15
15504;Saulutė;Zylutės;9947607411;Ne;9;0;0;9
15505;Saulutė;Zylutės;3408369823;Ne;0;0;6;6
15506;Saulutė;"1 klasė";1717909005;Ne;4;0;0;4
15507;Saulutė;"1 klasė";87814849917;Ne;1;0;0;1
15508;Saulutė;"1 klasė";1320018338;Ne;1;0;0;1
15509;Saulutė;"1 klasė";8599199376;Ne;1;0;0;1
15510;Saulutė;"1 klasė";8944601874;Ne;1;0;0;1
15511;Saulutė;"1 klasė";3064199909;Ne;3;0;0;3
15512;Saulutė;"1 klasė";1556270046;Ne;3;0;0;3
15513;Saulutė;"1 klasė";1291318940;Ne;2;0;0;2
15514;Saulutė;"1 klasė";6096297366;Ne;7;0;0;7
15515;Saulutė;"1 klasė";1609952589;Ne;1;0;0;1
15516;Saulutė;"1 klasė";1513449225;Ne;4;0;0;4
15517;Saulutė;"1 klasė";7281873166;Ne;6;0;0;6
15518;Saulutė;"1 klasė";28772515317;Ne;3;0;0;3
15519;Saulutė;"1 klasė";1786491396;Ne;1;0;0;1
15520;Saulutė;"1 klasė";61073095949;Ne;1;0;0;1
15521;Saulutė;"1 klasė";3505492809;Ne;11;0;0;11
15522;Saulutė;"1 klasė";9235972927;Ne;6;0;0;6
15523;Saulutė;"1 klasė";2677995903;Ne;5;0;0;5
15524;Saulutė;"1 klasė";1386800520;Ne;7;0;0;7
15525;Saulutė;"2 klasė";45306237230;Ne;2;0;0;2
15526;Saulutė;"2 klasė";79438946697;Ne;4;0;0;4
15527;Saulutė;"2 klasė";79919438191;Ne;4;0;0;4
15528;Saulutė;"2 klasė";2622662153;Ne;11;0;0;11
15529;Saulutė;"2 klasė";9612975694;Ne;6;0;0;6
15530;Saulutė;"2 klasė";37315117916;Ne;2;0;0;2
15531;Saulutė;"2 klasė";14195215027;Ne;4;0;0;4
15532;Saulutė;"2 klasė";2098990667;Ne;5;0;0;5
15533;Saulutė;"2 klasė";27386434894;Ne;1;0;0;1
15534;Saulutė;"2 klasė";46280382280;Ne;1;0;0;1
15535;Saulutė;"2 klasė";1935503629;Ne;1;0;0;1
15536;Saulutė;"2 klasė";75405796772;Ne;1;0;0;1
15537;Saulutė;"2 klasė";1277263391;Ne;2;0;0;2
15538;Saulutė;"2 klasė";97145959022;Ne;2;0;0;2
15539;Saulutė;"2 klasė";4640909915;Ne;1;0;0;1
15540;Saulutė;"2 klasė";1534183935;Ne;2;0;0;2
15541;Saulutė;"2 klasė";5574049005;Ne;11;0;0;11
15542;Saulutė;"3 klasė";1005459768;Ne;1;0;0;1
15543;Saulutė;"3 klasė";76108591835;Ne;1;0;0;1
15544;Saulutė;"3 klasė";1475031090;Ne;4;0;0;4
15545;Saulutė;"3 klasė";3156830821;Ne;2;0;0;2
15546;Saulutė;"3 klasė";3246485288;Ne;4;0;0;4
15547;Saulutė;"3 klasė";78967475616;Ne;1;0;0;1
15548;Saulutė;"3 klasė";89710141573;Ne;5;0;0;5
15549;Saulutė;"3 klasė";25124975646;Ne;2;0;0;2
15550;Saulutė;"3 klasė";3450668814;Ne;9;0;0;9
15551;Saulutė;"3 klasė";8168961080;Ne;3;0;0;3
15552;Saulutė;"3 klasė";57283533169;Ne;1;0;0;1
15553;Saulutė;"3 klasė";76744652185;Ne;2;0;0;2
15554;Saulutė;"3 klasė";97296161595;Ne;5;0;0;5
15555;Saulutė;"3 klasė";1205642335;Ne;6;0;0;6
15556;Saulutė;"3 klasė";2426509692;Ne;5;0;0;5
15557;Saulutė;"3 klasė";99841176399;Ne;1;0;0;1
15558;Saulutė;"3 klasė";21703177024;Ne;2;0;0;2
15559;Saulutė;"3 klasė";1337654926;Ne;4;0;0;4
15560;Saulutė;"3 klasė";54950572289;Ne;1;0;0;1
15561;Saulutė;"3 klasė";13147367113;Ne;5;0;0;5
15562;Saulutė;"3 klasė";2216383015;Ne;1;0;0;1
15563;Saulutė;"3 klasė";1644704074;Ne;5;0;0;5
15564;Saulutė;"3 klasė";96497471950;Ne;9;0;0;9
15565;Saulutė;"3 klasė";6557918941;Ne;5;0;0;5
15566;Saulutė;"3 klasė";2787531476;Ne;6;0;0;6
15567;Saulutė;"4 klasė";5822529731;Ne;3;0;0;3
15568;Saulutė;"4 klasė";67739063665;Ne;1;0;0;1
15569;Saulutė;"4 klasė";81191097069;Ne;1;0;0;1
15570;Saulutė;"4 klasė";92198716772;Ne;9;0;0;9
15571;Saulutė;"4 klasė";2262536579;Ne;1;0;0;1
15572;Saulutė;"4 klasė";2095347468;Ne;4;0;0;4
15573;Saulutė;"4 klasė";2819521168;Ne;4;0;0;4
15574;Saulutė;"4 klasė";8308288099;Ne;1;0;0;1
15575;Saulutė;"4 klasė";30863736694;Ne;3;0;0;3
15576;Saulutė;"4 klasė";12964000357;Ne;9;0;0;9
15577;Saulutė;"4 klasė";54726632101;Ne;2;0;0;2
15578;Saulutė;"4 klasė";25720655179;Ne;2;0;0;2
15579;Saulutė;"4 klasė";61113930769;Ne;1;0;0;1
15580;Saulutė;"4 klasė";5213320470;Ne;7;0;0;7
15581;Saulutė;"4 klasė";50110262859;Ne;2;0;0;2
15582;Saulutė;"4 klasė";42204884890;Ne;3;0;0;3
15583;Svaja;SAULĖGRĄŽA;4189290919;Ne;0;20;0;20
15584;Svaja;SAULĖGRĄŽA;4333001830;Ne;0;0;1;1
15585;Svaja;SAULĖGRĄŽA;9680766688;Ne;7;0;1;8
15586;Svaja;SAULĖGRĄŽA;3809817617;Ne;6;0;0;6
15587;Svaja;SAULĖGRĄŽA;3792660330;Ne;13;0;0;13
15588;Svaja;SAULĖGRĄŽA;3563842321;Ne;2;0;0;2
15589;Svaja;SAULĖGRĄŽA;4253831334;Ne;0;0;3;3
15590;Svaja;SAULĖGRĄŽA;3461282516;Ne;6;0;1;7
15591;Svaja;SAULĖGRĄŽA;9240037050;Ne;0;5;0;5
15592;Svaja;SAULĖGRĄŽA;7089640807;Ne;4;1;0;5
15593;Svaja;SAULĖGRĄŽA;4510147045;Ne;4;6;0;10
15594;Svaja;SAULĖGRĄŽA;6928763381;Ne;4;0;0;4
15595;Svaja;SAULĖGRĄŽA;3501620040;Ne;6;1;0;7
15596;Svaja;SAULĖGRĄŽA;7575922215;Ne;0;0;1;1
15597;Svaja;SAULĖGRĄŽA;7408966637;Ne;5;2;0;7
15598;Svaja;SAULĖGRĄŽA;7747251736;Ne;6;0;1;7
15599;Svaja;"STEBUKLINGAS ŽIBINTAS";9814969596;Ne;7;2;0;9
15600;Svaja;"STEBUKLINGAS ŽIBINTAS";2200408537;Ne;7;0;0;7
15601;Svaja;"STEBUKLINGAS ŽIBINTAS";9086270220;Ne;13;0;0;13
15602;Svaja;"STEBUKLINGAS ŽIBINTAS";3940123543;Ne;0;7;1;8
15603;Svaja;"STEBUKLINGAS ŽIBINTAS";8353427144;Ne;6;0;0;6
15604;Svaja;"STEBUKLINGAS ŽIBINTAS";9843726794;Ne;6;0;0;6
15605;Svaja;"STEBUKLINGAS ŽIBINTAS";4237592104;Ne;11;0;0;11
15606;Svaja;"STEBUKLINGAS ŽIBINTAS";2658828200;Ne;1;0;0;1
15607;Svaja;"STEBUKLINGAS ŽIBINTAS";4290716676;Ne;3;11;3;17
15608;Svaja;"STEBUKLINGAS ŽIBINTAS";1558093905;Ne;1;0;1;2
15609;Svaja;"STEBUKLINGAS ŽIBINTAS";9102872020;Ne;5;0;0;5
15610;Svaja;"STEBUKLINGAS ŽIBINTAS";7277217069;Ne;8;0;1;9
15611;Svaja;"STEBUKLINGAS ŽIBINTAS";9259478140;Ne;10;0;3;13
15612;Svaja;"STEBUKLINGAS ŽIBINTAS";1050291871;Taip;0;0;1;1
15613;Svaja;"STEBUKLINGAS ŽIBINTAS";2188430052;Ne;0;0;1;1
15614;Svaja;"STEBUKLINGAS ŽIBINTAS";1860076171;Ne;4;0;0;4
15615;Svaja;"STEBUKLINGAS ŽIBINTAS";8363418532;Ne;8;0;1;9
15616;Svaja;"STEBUKLINGAS ŽIBINTAS";8172396846;Ne;11;2;0;13
15617;Svaja;"STEBUKLINGAS ŽIBINTAS";9545690301;Ne;9;0;2;11
15618;Svaja;"STEBUKLINGAS ŽIBINTAS";4004383843;Ne;7;1;0;8
15619;Svaja;"STEBUKLINGAS ŽIBINTAS";6128350581;Ne;5;0;0;5
15620;Svaja;"STEBUKLINGAS ŽIBINTAS";1150040935;Ne;5;0;2;7
15621;Svaja;SAULUTĖ;50207734108;Ne;6;0;0;6
15622;Svaja;SAULUTĖ;20473739993;Ne;5;0;1;6
15623;Svaja;SAULUTĖ;30719991872;Ne;17;0;1;18
15624;Svaja;SAULUTĖ;6665752307;Ne;2;0;0;2
15625;Svaja;SAULUTĖ;4968201186;Ne;7;0;0;7
15626;Svaja;SAULUTĖ;8689706130;Ne;1;0;0;1
15627;Svaja;SAULUTĖ;6807834176;Ne;0;0;1;1
15628;Svaja;SAULUTĖ;7020342969;Ne;4;0;0;4
15629;Svaja;SAULUTĖ;3633996231;Ne;9;0;3;12
15630;Svaja;SAULUTĖ;2750615517;Ne;2;0;1;3
15631;Svaja;SAULUTĖ;3049808328;Ne;2;0;5;7
15632;Svaja;SAULUTĖ;1045300185;Ne;6;0;0;6
15633;Svaja;SAULUTĖ;4341042027;Ne;7;0;0;7
15634;Svaja;SAULUTĖ;3802996573;Ne;7;0;2;9
15635;Svaja;SAULUTĖ;7936765752;Ne;3;0;0;3
15636;Svaja;SAULUTĖ;4293339784;Ne;0;3;0;3
15637;Svaja;SAULUTĖ;5479482244;Ne;5;0;1;6
15638;Svaja;SAULUTĖ;7473493846;Ne;7;0;0;7
15639;Svaja;SAULUTĖ;5443682744;Ne;2;1;0;3
15640;Svaja;SAULUTĖ;9112198914;Ne;1;0;0;1
15641;Svaja;SAULUTĖ;8656417794;Ne;0;0;3;3
15642;Svaja;SAULUTĖ;3630922360;Ne;2;0;1;3
15643;Svaja;SAULUTĖ;1377813636;Ne;11;0;0;11
15644;Svaja;"AUKSINĖ ŽUVELĖ";4565097904;Ne;0;0;2;2
15645;Svaja;"AUKSINĖ ŽUVELĖ";9091970902;Ne;5;0;1;6
15646;Svaja;"AUKSINĖ ŽUVELĖ";9826552657;Ne;1;0;0;1
15647;Svaja;"AUKSINĖ ŽUVELĖ";6028471687;Ne;15;0;0;15
15648;Svaja;"AUKSINĖ ŽUVELĖ";1877749103;Ne;10;0;0;10
15649;Svaja;"AUKSINĖ ŽUVELĖ";5033214011;Ne;6;0;2;8
15650;Svaja;"AUKSINĖ ŽUVELĖ";5224855138;Ne;0;0;1;1
15651;Svaja;"AUKSINĖ ŽUVELĖ";5013548619;Ne;0;1;0;1
15652;Svaja;"AUKSINĖ ŽUVELĖ";5908440171;Ne;0;0;1;1
15653;Svaja;"AUKSINĖ ŽUVELĖ";1914129062;Ne;5;0;5;10
15654;Svaja;"AUKSINĖ ŽUVELĖ";3567924341;Ne;2;0;8;10
15655;Svaja;"AUKSINĖ ŽUVELĖ";2427918378;Ne;7;0;0;7
15656;Svaja;"AUKSINĖ ŽUVELĖ";7605002899;Ne;0;0;3;3
15657;Svaja;"AUKSINĖ ŽUVELĖ";5198482539;Ne;0;1;0;1
15658;Svaja;"AUKSINĖ ŽUVELĖ";7562678317;Ne;5;0;5;10
15659;Svaja;"AUKSINĖ ŽUVELĖ";2641473764;Ne;9;0;0;9
15660;Svaja;"AUKSINĖ ŽUVELĖ";7434898745;Ne;0;4;0;4
15661;Svaja;"PRIE ĮLANKOS";5595087767;Ne;0;0;1;1
15662;Svaja;"PRIE ĮLANKOS";8503177793;Taip;0;0;1;1
15663;Svaja;"PRIE ĮLANKOS";1633236289;Ne;0;11;2;13
15664;Svaja;"PRIE ĮLANKOS";9414846817;Ne;14;0;0;14
15665;Svaja;"PRIE ĮLANKOS";9311520300;Taip;0;0;1;1
15666;Svaja;"PRIE ĮLANKOS";9864664937;Ne;0;0;1;1
15667;Svaja;"PRIE ĮLANKOS";4014493868;Ne;0;3;0;3
15668;Svaja;"PRIE ĮLANKOS";6388514464;Ne;0;3;0;3
15669;Svaja;"PRIE ĮLANKOS";5862570666;Ne;1;0;0;1
15670;Svaja;"PRIE ĮLANKOS";2018689468;Ne;4;0;1;5
15671;Svaja;"PRIE ĮLANKOS";3459060550;Ne;18;0;0;18
15672;Svaja;"PRIE ĮLANKOS";1617844709;Ne;5;0;8;13
15673;Svaja;"PRIE ĮLANKOS";3458374439;Ne;0;0;1;1
15674;Svaja;"PRIE ĮLANKOS";4393041946;Ne;0;0;1;1
15675;Svaja;"PRIE ĮLANKOS";6676145522;Ne;5;0;3;8
15676;Svaja;"PRIE ĮLANKOS";1671495181;Ne;0;0;1;1
15677;Svaja;"PRIE ĮLANKOS";9950569499;Ne;0;0;2;2
15678;Svaja;"PRIE ĮLANKOS";4284157599;Ne;0;0;2;2
15679;Svaja;"PRIE ĮLANKOS";6361228838;Ne;0;0;3;3
15680;Svaja;"PRIE ĮLANKOS";7514587933;Ne;0;6;0;6
15681;Svaja;"1 B klasė";24863928147;Ne;0;2;0;2
15682;Svaja;"1 B klasė";1865658456;Ne;0;3;0;3
15683;Svaja;"1 B klasė";8279605005;Ne;0;20;0;20
15684;Svaja;"1 B klasė";55925058866;Ne;0;20;0;20
15685;Svaja;"1 B klasė";1437557657;Ne;12;0;0;12
15686;Svaja;"1 B klasė";25194696146;Ne;0;4;0;4
15687;Svaja;"1 B klasė";8875237023;Ne;0;5;0;5
15688;Svaja;"1 B klasė";64196174690;Ne;7;13;0;20
15689;Svaja;"1 B klasė";8491275729;Ne;0;2;0;2
15690;Svaja;"1 B klasė";21871530266;Ne;0;1;0;1
15691;Svaja;"1 B klasė";36505115395;Ne;0;20;0;20
15692;Svaja;"1 B klasė";7911488445;Ne;0;1;0;1
15693;Svaja;"1 B klasė";6593047776;Ne;1;0;0;1
15694;Svaja;"1 B klasė";15159708127;Ne;0;5;0;5
15695;Svaja;"1 B klasė";2985196852;Ne;0;3;0;3
15696;Svaja;"1 B klasė";9110985103;Ne;0;1;0;1
15697;Svaja;"1 B klasė";3562817807;Ne;6;3;0;9
15698;Svaja;"1 B klasė";11671380984;Ne;0;6;0;6
15699;Svaja;"1 B klasė";1369637618;Ne;0;1;0;1
15700;Svaja;"1 A klasė";5337604370;Ne;0;5;0;5
15701;Svaja;"1 A klasė";1046879533;Ne;0;1;0;1
15702;Svaja;"1 A klasė";2147266053;Ne;0;2;0;2
15703;Svaja;"1 A klasė";65917456866;Ne;4;0;0;4
15704;Svaja;"1 A klasė";73679997517;Ne;0;20;0;20
15705;Svaja;"1 A klasė";7669562010;Ne;0;5;0;5
15706;Svaja;"1 A klasė";5335776957;Ne;0;20;0;20
15707;Svaja;"1 A klasė";56117509354;Ne;0;1;0;1
15708;Svaja;"1 A klasė";27445299450;Ne;0;1;0;1
15709;Svaja;"1 A klasė";1576498450;Ne;0;4;0;4
15710;Svaja;"1 A klasė";43307670660;Ne;5;15;0;20
15711;Svaja;"1 A klasė";22702341083;Ne;9;0;0;9
15712;Svaja;"1 A klasė";70641067006;Ne;0;20;0;20
15713;Svaja;"1 A klasė";4900757614;Ne;0;1;0;1
15714;Svaja;"1 A klasė";1061894314;Ne;0;8;0;8
15715;Svaja;"1 A klasė";8697355813;Ne;0;2;0;2
15716;Svaja;"1 A klasė";193181908;Ne;0;1;0;1
15717;Svaja;"1 A klasė";193181908;Ne;0;1;0;1
15718;Svaja;"2 A klasė";9628146488;Ne;0;6;0;6
15719;Svaja;"2 A klasė";1562041360;Ne;0;5;0;5
15720;Svaja;"2 A klasė";43223177664;Ne;0;2;0;2
15721;Svaja;"2 A klasė";1017471747;Ne;0;1;0;1
15722;Svaja;"2 A klasė";26500981786;Ne;0;8;0;8
15723;Svaja;"2 A klasė";1400892707;Ne;9;0;0;9
15724;Svaja;"2 A klasė";30027404222;Ne;6;0;0;6
15725;Svaja;"2 A klasė";15246943974;Ne;0;1;0;1
15726;Svaja;"2 A klasė";8198614500;Ne;0;6;0;6
15727;Svaja;"2 A klasė";67462299886;Ne;0;5;0;5
15728;Svaja;"2 A klasė";40856210635;Ne;0;1;0;1
15729;Svaja;"2 A klasė";18733824395;Ne;0;1;0;1
15730;Svaja;"2 A klasė";84508228457;Ne;0;2;0;2
15731;Svaja;"2 A klasė";2058827699;Ne;0;3;0;3
15732;Svaja;"2 A klasė";1943166503;Ne;0;10;0;10
15733;Svaja;"2 A klasė";1048576329;Ne;0;5;0;5
15734;Svaja;"2 B klasė";4804779327;Ne;0;20;0;20
15735;Svaja;"2 B klasė";7719185632;Ne;0;1;0;1
15736;Svaja;"2 B klasė";69028070656;Ne;4;0;0;4
15737;Svaja;"2 B klasė";54745410330;Ne;0;2;0;2
15738;Svaja;"2 B klasė";1601648171;Ne;0;3;0;3
15739;Svaja;"2 B klasė";89316574266;Ne;0;2;0;2
15740;Svaja;"2 B klasė";78293798850;Ne;0;4;0;4
15741;Svaja;"2 B klasė";40814723278;Ne;0;2;0;2
15742;Svaja;"2 B klasė";87432529423;Ne;0;3;0;3
15743;Svaja;"2 B klasė";19887874988;Ne;0;1;0;1
15744;Svaja;"2 B klasė";69413101571;Ne;0;3;0;3
15745;Svaja;"2 B klasė";1655551042;Ne;0;3;0;3
15746;Svaja;"2 B klasė";21608020858;Ne;0;1;0;1
15747;Svaja;"2 B klasė";44989143252;Ne;4;0;0;4
15748;Svaja;"2 B klasė";6056157113;Ne;0;3;0;3
15749;Svaja;"2 B klasė";30360097999;Ne;0;20;0;20
15750;Svaja;"3 A klasė";72752022712;Ne;0;4;0;4
15751;Svaja;"3 A klasė";8828911320;Ne;0;1;0;1
15752;Svaja;"3 A klasė";60448774566;Ne;0;4;0;4
15753;Svaja;"3 A klasė";64487515384;Ne;0;20;0;20
15754;Svaja;"3 A klasė";3474439050;Ne;0;1;0;1
15755;Svaja;"3 A klasė";6057524892;Ne;0;20;0;20
15756;Svaja;"3 A klasė";3604946305;Ne;0;20;0;20
15757;Svaja;"3 A klasė";1168637823;Ne;0;3;0;3
15758;Svaja;"3 A klasė";4906784415;Ne;0;4;0;4
15759;Svaja;"3 B klasė";6905550313;Ne;0;1;0;1
15760;Svaja;"3 B klasė";62971657427;Ne;0;5;0;5
15761;Svaja;"3 B klasė";4416877973;Ne;0;1;0;1
15762;Svaja;"3 B klasė";1847775266;Ne;0;20;0;20
15763;Svaja;"3 B klasė";17947580061;Ne;0;1;0;1
15764;Svaja;"3 B klasė";73391331150;Ne;5;3;0;8
15765;Svaja;"3 B klasė";70507326327;Ne;0;20;0;20
15766;Svaja;"3 B klasė";80772711351;Ne;0;1;0;1
15767;Svaja;"3 B klasė";54328462992;Ne;0;20;0;20
15768;Svaja;"3 B klasė";8011137572;Ne;3;0;0;3
15769;Svaja;"3 B klasė";56506642672;Ne;0;1;0;1
15770;Svaja;"3 B klasė";3526873547;Ne;3;17;0;20
15771;Svaja;"3 B klasė";70506691027;Ne;0;20;0;20
15772;Svaja;"3 B klasė";4282243865;Ne;0;20;0;20
15773;Svaja;"4 A klasė";96680395594;Ne;0;2;0;2
15774;Svaja;"4 A klasė";31604152893;Ne;0;2;0;2
15775;Svaja;"4 A klasė";72655912805;Ne;0;20;0;20
15776;Svaja;"4 A klasė";69928474471;Ne;0;20;0;20
15777;Svaja;"4 A klasė";49184638535;Ne;0;20;0;20
15778;Svaja;"4 A klasė";99157757025;Ne;0;3;0;3
15779;Svaja;"4 A klasė";16955510836;Taip;0;3;0;3
15780;Svaja;"4 A klasė";24812635291;Ne;3;0;0;3
15781;Svaja;"4 A klasė";21534170175;Ne;0;2;0;2
15782;Svaja;"4 A klasė";28311552445;Ne;0;1;0;1
15783;Svaja;"4 A klasė";38781141060;Ne;0;1;0;1
15784;Svaja;"4 A klasė";88447528808;Ne;0;3;0;3
15785;Svaja;"4 A klasė";66507774550;Ne;0;4;0;4
15786;Svaja;"4 A klasė";76101749947;Ne;0;20;0;20
15787;Svaja;"4 A klasė";18432518932;Ne;0;2;0;2
15788;Svaja;"4 B klasė";61996055386;Ne;0;20;0;20
15789;Svaja;"4 B klasė";57983452414;Ne;0;20;0;20
15790;Svaja;"4 B klasė";30200636424;Ne;0;20;0;20
15791;Svaja;"4 B klasė";8802243719;Ne;0;20;0;20
15792;Svaja;"4 B klasė";7747921362;Ne;0;20;0;20
15793;Svaja;"4 B klasė";9401605132;Ne;0;3;0;3
15794;Svaja;"4 B klasė";27313057222;Ne;0;20;0;20
15795;Svaja;"4 B klasė";68894832324;Ne;0;20;0;20
15796;Svaja;"4 B klasė";29972474690;Ne;0;20;0;20
15797;Svaja;"4 B klasė";47441661801;Ne;0;3;0;3
15798;Svaja;"4 B klasė";62579722313;Ne;0;2;0;2
15799;Svaja;"4 B klasė";21035820496;Ne;0;20;0;20
15800;Svaja;"4 B klasė";71840791098;Ne;0;3;0;3
15801;Svaja;"4 B klasė";59707838958;Ne;0;20;0;20
15802;Svaja;"4 B klasė";71086654007;Ne;0;20;0;20
15803;Svaja;"4 B klasė";15871540340;Ne;0;20;0;20
15804;Svaja;"4 B klasė";77796846388;Ne;0;20;0;20
15805;Svaja;"4 C klasė";79260508923;Ne;9;0;0;9
15806;Svaja;"4 C klasė";94437606762;Ne;0;20;0;20
15807;Svaja;"4 C klasė";73440582394;Ne;0;20;0;20
15808;Svaja;"4 C klasė";60982723867;Ne;0;20;0;20
15809;Svaja;"4 C klasė";70157518595;Ne;0;20;0;20
15810;Svaja;"4 C klasė";5975083034;Ne;0;20;0;20
15811;Svaja;"4 C klasė";76871144487;Ne;5;15;0;20
15812;Svaja;"4 C klasė";12226488343;Ne;0;20;0;20
15813;Svaja;"4 C klasė";3909240894;Ne;0;1;0;1
15814;Svaja;"4 C klasė";73691352138;Ne;0;5;0;5
15815;Svaja;"4 C klasė";66967032561;Ne;7;0;0;7
15816;Svaja;"4 C klasė";82358174131;Ne;0;5;0;5
15817;Svaja;"4 C klasė";25585032766;Ne;0;20;0;20
15818;Svaja;"4 C klasė";79572045341;Ne;0;20;0;20
15819;Svaja;"3 C klasė";1848422504;Ne;0;4;0;4
15820;Svaja;"3 C klasė";3743948734;Ne;0;4;0;4
15821;Svaja;"3 C klasė";25934507261;Ne;0;3;0;3
15822;Svaja;"3 C klasė";89047123808;Ne;0;12;0;12
15823;Svaja;"3 C klasė";74904581010;Ne;0;20;0;20
15824;Svaja;"3 C klasė";41183537732;Ne;0;9;0;9
15825;Svaja;"3 C klasė";70714898590;Ne;0;1;0;1
15826;Svaja;"3 C klasė";54852358913;Ne;0;20;0;20
15827;Svaja;"3 C klasė";57253216255;Ne;0;8;0;8
15828;Svaja;"3 C klasė";34995551069;Ne;0;20;0;20
15829;Svaja;"3 C klasė";1795682827;Ne;0;2;0;2
15830;Svaja;"3 C klasė";93651139102;Ne;0;2;0;2
15831;Svaja;"3 C klasė";1742951527;Ne;0;2;0;2
15832;Svaja;"3 C klasė";91855230473;Ne;0;4;0;4
15833;Svaja;"3 C klasė";1855559693;Ne;0;20;0;20
15834;Svaja;"3 C klasė";2165716699;Ne;14;1;0;15
15835;Svaja;"3 C klasė";31216445971;Ne;0;20;0;20
15836;Svaja;"3 C klasė";36001411632;Ne;0;3;0;3
15837;Svaja;"3 C klasė";94449039022;Ne;0;20;0;20
15838;Svaja;"3 C klasė";85150525696;Ne;0;2;0;2
15839;Svaja;"3 C klasė";91088224294;Ne;0;2;0;2
15840;Šilelis;PAUKŠTELIAI;6128379060;Ne;19;0;0;19
15841;Šilelis;PAUKŠTELIAI;9653439873;Ne;6;0;0;6
15842;Šilelis;PAUKŠTELIAI;2823486581;Ne;1;5;2;8
15843;Šilelis;PAUKŠTELIAI;6369443270;Ne;5;12;0;17
15844;Šilelis;PAUKŠTELIAI;7595774842;Ne;5;0;0;5
15845;Šilelis;PAUKŠTELIAI;6614686867;Ne;6;14;0;20
15846;Šilelis;PAUKŠTELIAI;3053443777;Ne;9;0;0;9
15847;Šilelis;PAUKŠTELIAI;7072057348;Ne;0;1;0;1
15848;Šilelis;PAUKŠTELIAI;5974537364;Ne;0;10;8;18
15849;Šilelis;PAUKŠTELIAI;8166061969;Ne;10;0;0;10
15850;Šilelis;PAUKŠTELIAI;2051644210;Taip;0;1;0;1
15851;Šilelis;PAUKŠTELIAI;1124854378;Ne;6;0;0;6
15852;Šilelis;PAUKŠTELIAI;8184170908;Ne;6;0;0;6
15853;Šilelis;PAUKŠTELIAI;7197420388;Ne;6;4;0;10
15854;Šilelis;PAUKŠTELIAI;9107920165;Ne;6;4;0;10
15855;Šilelis;PAUKŠTELIAI;4432542988;Ne;5;0;0;5
15856;Šilelis;PAUKŠTELIAI;6852463814;Ne;2;12;0;14
15857;Šilelis;PAUKŠTELIAI;9799198904;Ne;7;0;0;7
15858;Šilelis;PAUKŠTELIAI;5493811298;Ne;0;0;4;4
15859;Šilelis;SKRUZDELIUKAI;7502057552;Taip;1;0;0;1
15860;Šilelis;SKRUZDELIUKAI;6099940488;Taip;8;0;0;8
15861;Šilelis;SKRUZDELIUKAI;6139976105;Taip;0;4;0;4
15862;Šilelis;SKRUZDELIUKAI;3823958567;Ne;0;7;0;7
15863;Šilelis;SKRUZDELIUKAI;1887013803;Taip;4;0;2;6
15864;Šilelis;SKRUZDELIUKAI;6359318134;Ne;6;0;0;6
15865;Šilelis;SKRUZDELIUKAI;5598152793;Taip;15;0;0;15
15866;Šilelis;SKRUZDELIUKAI;8090773379;Ne;19;1;0;20
15867;Šilelis;SKRUZDELIUKAI;1200024379;Ne;11;0;0;11
15868;Šilelis;SKRUZDELIUKAI;7299084520;Ne;0;4;0;4
15869;Šilelis;SKRUZDELIUKAI;8578620603;Ne;7;0;0;7
15870;Šilelis;SKRUZDELIUKAI;9589138527;Ne;16;1;0;17
15871;Šilelis;SKRUZDELIUKAI;3967932407;Ne;0;3;0;3
15872;Šilelis;SKRUZDELIUKAI;2972202874;Taip;9;7;0;16
15873;Šilelis;SKRUZDELIUKAI;9461117894;Ne;20;0;0;20
15874;Šilelis;SKRUZDELIUKAI;5817818596;Ne;6;7;1;14
15875;Šilelis;SKRUZDELIUKAI;6827855685;Ne;12;0;0;12
15876;Šilelis;SKRUZDELIUKAI;5091571136;Ne;6;0;0;6
15877;Šilelis;SKRUZDELIUKAI;8297975308;Ne;6;6;0;12
15878;Šilelis;SKRUZDELIUKAI;3381053227;Ne;10;7;0;17
15879;Šilelis;SKRUZDELIUKAI;9276607554;Taip;10;1;0;11
15880;Šilelis;SMERFY;3247333567;Ne;5;5;0;10
15881;Šilelis;SMERFY;6999088222;Ne;9;0;0;9
15882;Šilelis;SMERFY;5665331529;Ne;0;3;0;3
15883;Šilelis;SMERFY;3089270468;Ne;0;3;0;3
15884;Šilelis;SMERFY;7824279279;Ne;6;4;0;10
15885;Šilelis;SMERFY;4504627601;Ne;0;0;3;3
15886;Šilelis;SMERFY;7534468539;Ne;10;0;0;10
15887;Šilelis;SMERFY;6390855924;Ne;10;4;0;14
15888;Šilelis;SMERFY;1821827154;Ne;4;0;1;5
15889;Šilelis;SMERFY;4196893379;Ne;9;0;0;9
15890;Šilelis;SMERFY;5025956218;Ne;12;0;0;12
15891;Šilelis;EŽIUKAI;9266061396;Taip;0;0;1;1
15892;Šilelis;EŽIUKAI;7074963804;Ne;0;5;0;5
15893;Šilelis;EŽIUKAI;1165219272;Taip;0;4;0;4
15894;Šilelis;EŽIUKAI;4702068672;Ne;0;4;0;4
15895;Šilelis;EŽIUKAI;5020209473;Ne;5;1;0;6
15896;Šilelis;EŽIUKAI;2295849333;Ne;0;2;0;2
15897;Šilelis;EŽIUKAI;5131051261;Taip;1;0;0;1
15898;Šilelis;EŽIUKAI;1883483049;Ne;0;2;0;2
15899;Šilelis;EŽIUKAI;6854997486;Ne;3;0;0;3
15900;Šilelis;EŽIUKAI;6386996498;Ne;0;0;3;3
15901;Šilelis;EŽIUKAI;4822495270;Ne;13;0;0;13
15902;Šilelis;EŽIUKAI;2681063256;Ne;6;0;0;6
15903;Šilelis;EŽIUKAI;7208757038;Taip;11;0;1;12
15904;Šilelis;NYKŠTUKAI;3046954717;Ne;1;10;0;11
15905;Šilelis;NYKŠTUKAI;2862894359;Ne;0;0;1;1
15906;Šilelis;NYKŠTUKAI;3158708835;Ne;4;2;0;6
15907;Šilelis;NYKŠTUKAI;6195580698;Ne;0;0;2;2
15908;Šilelis;NYKŠTUKAI;4323998445;Ne;0;0;11;11
15909;Šilelis;NYKŠTUKAI;2095572561;Taip;10;0;2;12
15910;Šilelis;NYKŠTUKAI;2161973782;Ne;0;3;0;3
15911;Šilelis;NYKŠTUKAI;4459114205;Ne;11;0;0;11
15912;Šilelis;NYKŠTUKAI;3728633100;Ne;0;0;3;3
15913;Šilelis;NYKŠTUKAI;3999426414;Ne;0;1;0;1
15914;Šilelis;NYKŠTUKAI;5745874033;Ne;0;0;1;1
15915;Šilelis;NYKŠTUKAI;9769483899;Ne;0;1;0;1
15916;Šilelis;NYKŠTUKAI;3120671593;Ne;0;0;2;2
15917;Šilelis;NYKŠTUKAI;6980045156;Ne;1;0;0;1
15918;Šilelis;NYKŠTUKAI;9685227636;Ne;12;0;0;12
15919;Šilelis;NYKŠTUKAI;4868465692;Ne;6;8;0;14
15920;Šilelis;NYKŠTUKAI;4754544277;Ne;0;4;0;4
15921;Šilelis;NYKŠTUKAI;1222028604;Ne;0;20;0;20
15922;Šilelis;NYKŠTUKAI;7480611069;Ne;6;0;0;6
15923;Šilelis;ANČIUKAI;1726944289;Ne;18;0;0;18
15924;Šilelis;ANČIUKAI;4336942500;Ne;3;0;0;3
15925;Šilelis;ANČIUKAI;9661578871;Ne;0;0;8;8
15926;Šilelis;ANČIUKAI;6616262730;Ne;7;2;1;10
15927;Šilelis;ANČIUKAI;4323750313;Ne;14;0;5;19
15928;Šilelis;ANČIUKAI;3221398692;Ne;11;0;0;11
15929;Šilelis;ANČIUKAI;6364741317;Ne;14;0;0;14
15930;Šilelis;ANČIUKAI;1325857464;Taip;0;0;6;6
15931;Šilelis;ANČIUKAI;9407916190;Ne;2;5;0;7
15932;Šilelis;ANČIUKAI;8188160849;Ne;0;1;0;1
15933;Šilelis;ANČIUKAI;7128670936;Ne;9;0;0;9
15934;Šilelis;ANČIUKAI;8613748314;Ne;9;1;0;10
15935;Šilelis;ANČIUKAI;5381213051;Taip;15;0;0;15
15936;Šilelis;ANČIUKAI;2976607303;Ne;5;0;0;5
15937;Šilelis;ANČIUKAI;8807755852;Ne;0;6;0;6
15938;Šilelis;ANČIUKAI;4135383684;Ne;2;1;0;3
15939;Šilelis;ANČIUKAI;5926624138;Taip;5;0;0;5
15940;Šilelis;ANČIUKAI;8603589758;Ne;0;0;3;3
15941;Šilelis;KAČIUKAI;9899047136;Ne;4;0;0;4
15942;Šilelis;KAČIUKAI;3216168797;Ne;10;0;0;10
15943;Šilelis;KAČIUKAI;9848760151;Ne;0;4;0;4
15944;Šilelis;KAČIUKAI;4743459915;Ne;5;1;0;6
15945;Šilelis;KAČIUKAI;8387022157;Ne;0;7;0;7
15946;Šilelis;KAČIUKAI;3393466953;Ne;14;0;0;14
15947;Šilelis;KAČIUKAI;2111979474;Ne;5;0;1;6
15948;Šilelis;KAČIUKAI;8064905796;Ne;4;3;0;7
15949;Šilelis;KAČIUKAI;5176259940;Ne;0;0;15;15
15950;Šilelis;KAČIUKAI;5589764935;Taip;7;0;4;11
15951;Šilelis;KAČIUKAI;7123048946;Ne;10;0;0;10
15952;Šilelis;KAČIUKAI;2906501601;Ne;4;2;0;6
15953;Šilelis;KAČIUKAI;6510813364;Ne;0;3;0;3
15954;Šilelis;KAČIUKAI;8504187981;Ne;10;0;0;10
15955;Šilelis;KAČIUKAI;6470073008;Ne;5;0;0;5
15956;Šilelis;KAČIUKAI;3419284228;Ne;0;7;0;7
15957;Šilelis;KAČIUKAI;3712001932;Ne;0;3;0;3
15958;Šilelis;KAČIUKAI;9106999969;Ne;0;4;0;4
15959;Šilelis;KAČIUKAI;5030871828;Taip;0;0;1;1
15960;Šilelis;KAČIUKAI;6894466509;Ne;2;0;5;7
15961;Šilelis;KAČIUKAI;5026203678;Ne;10;4;0;14
15962;Šilelis;KIŠKUČIAI;8632645047;Ne;7;0;6;13
15963;Šilelis;KIŠKUČIAI;8759694551;Ne;10;0;2;12
15964;Šilelis;KIŠKUČIAI;2209552706;Ne;6;0;2;8
15965;Šilelis;KIŠKUČIAI;3296197220;Ne;0;2;0;2
15966;Šilelis;KIŠKUČIAI;4386065478;Ne;0;1;0;1
15967;Šilelis;KIŠKUČIAI;7043644521;Ne;10;0;0;10
15968;Šilelis;KIŠKUČIAI;8096868221;Ne;0;0;1;1
15969;Šilelis;KIŠKUČIAI;3395084186;Ne;5;0;0;5
15970;Šilelis;KIŠKUČIAI;2551747888;Ne;2;0;0;2
15971;Šilelis;KIŠKUČIAI;8598321310;Ne;4;0;3;7
15972;Šilelis;KREGŽDUTĖS;1025643459;Ne;10;0;0;10
15973;Šilelis;KREGŽDUTĖS;8453070684;Ne;0;12;1;13
15974;Šilelis;KREGŽDUTĖS;1286082219;Ne;1;0;3;4
15975;Šilelis;KREGŽDUTĖS;3068950702;Ne;9;0;0;9
15976;Šilelis;KREGŽDUTĖS;8665357907;Ne;1;3;0;4
15977;Šilelis;KREGŽDUTĖS;1152159735;Taip;6;0;0;6
15978;Šilelis;KREGŽDUTĖS;6630114847;Taip;0;0;4;4
15979;Šilelis;KREGŽDUTĖS;3953114161;Taip;0;0;4;4
15980;Šilelis;KREGŽDUTĖS;2499322761;Ne;15;0;0;15
15981;Šilelis;KREGŽDUTĖS;8659845107;Ne;12;0;2;14
15982;Šilelis;KREGŽDUTĖS;5868594049;Ne;10;0;0;10
15983;Šilelis;KREGŽDUTĖS;8855625488;Ne;5;0;1;6
15984;Šilelis;KREGŽDUTĖS;5223262925;Ne;1;0;0;1
15985;Šilelis;KREGŽDUTĖS;1279361795;Taip;7;1;0;8
15986;Šilelis;KREGŽDUTĖS;9292761872;Ne;16;0;1;17
15987;Šilelis;PAGRANDUKAI;9922962130;Ne;18;0;0;18
15988;Šilelis;PAGRANDUKAI;4814863979;Ne;19;1;0;20
15989;Šilelis;PAGRANDUKAI;9670243727;Ne;0;3;0;3
15990;Šilelis;PAGRANDUKAI;8357287467;Ne;6;1;0;7
15991;Šilelis;PAGRANDUKAI;20525573092;Ne;0;3;0;3
15992;Šilelis;PAGRANDUKAI;2897196188;Ne;0;0;2;2
15993;Šilelis;PAGRANDUKAI;3583955729;Ne;0;1;0;1
15994;Šilelis;PAGRANDUKAI;9113098594;Ne;0;0;1;1
15995;Šilelis;PAGRANDUKAI;7623203279;Ne;7;0;0;7
15996;Šilelis;PAGRANDUKAI;4340856490;Ne;0;2;0;2
15997;Šilelis;PAGRANDUKAI;6276408187;Ne;1;0;1;2
15998;Šilelis;PAGRANDUKAI;8416126751;Ne;3;0;1;4
15999;Šilelis;PAGRANDUKAI;2397366916;Taip;1;0;0;1
16000;Šilelis;PAGRANDUKAI;7936978436;Ne;6;4;0;10
16001;Šilelis;PAGRANDUKAI;1747920772;Ne;0;3;0;3
16002;Šilelis;PAGRANDUKAI;3843999609;Ne;6;5;1;12
16003;Šilelis;PAGRANDUKAI;1898004894;Ne;6;1;0;7
16004;Šilelis;BITUTĖS;2948291866;Taip;0;1;0;1
16005;Šilelis;BITUTĖS;5835209357;Taip;0;0;2;2
16006;Šilelis;BITUTĖS;7512731255;Ne;3;1;1;5
16007;Šilelis;BITUTĖS;9035595952;Ne;3;0;0;3
16008;Šilelis;BITUTĖS;7814807923;Ne;7;1;0;8
16009;Šilelis;BITUTĖS;9071963194;Taip;14;0;1;15
16010;Šilelis;BITUTĖS;5843337891;Ne;3;0;0;3
16011;Šilelis;BITUTĖS;1960952604;Ne;5;1;1;7
16012;Šilelis;BITUTĖS;3954379433;Ne;0;13;0;13
16013;Šilelis;BITUTĖS;7350013139;Ne;6;1;0;7
16014;Šilelis;BITUTĖS;3062557053;Ne;0;0;2;2
16015;Šilelis;BITUTĖS;1390916076;Ne;0;0;2;2
16016;Šilelis;BITUTĖS;6143099736;Ne;0;0;3;3
16017;Šilelis;BITUTĖS;2667785768;Ne;17;0;0;17
16018;Šilelis;BITUTĖS;2023309512;Ne;2;0;0;2
16019;Šilelis;BITUTĖS;5210301367;Taip;6;0;2;8
16020;Šilelis;BITUTĖS;5375413045;Ne;0;8;0;8
16021;Šilelis;BITUTĖS;6297546907;Ne;7;0;1;8
16022;Šilelis;BITUTĖS;6830200578;Ne;8;0;0;8
16023;Šilelis;DRUGELIAI;3598370884;Taip;13;0;1;14
16024;Šilelis;DRUGELIAI;1347150938;Ne;8;0;0;8
16025;Šilelis;DRUGELIAI;7636725161;Ne;10;0;0;10
16026;Šilelis;DRUGELIAI;9256656029;Ne;0;0;1;1
16027;Šilelis;DRUGELIAI;1891388542;Ne;0;2;0;2
16028;Šilelis;DRUGELIAI;5759824196;Ne;0;3;0;3
16029;Šilelis;DRUGELIAI;31906089315;Ne;2;5;0;7
16030;Šilelis;DRUGELIAI;4115738520;Ne;0;0;2;2
16031;Šilelis;DRUGELIAI;3824174896;Ne;0;0;2;2
16032;Šilelis;DRUGELIAI;8090765017;Ne;12;1;0;13
16033;Šilelis;DRUGELIAI;54633547799;Ne;0;10;0;10
16034;Šilelis;DRUGELIAI;9100047520;Ne;0;0;1;1
16035;Šilelis;DRUGELIAI;1019874215;Ne;7;0;2;9
16036;Šilelis;DRUGELIAI;1638362625;Ne;10;0;0;10
16037;Šilelis;DRUGELIAI;9482667810;Ne;3;0;2;5
16038;Šilelis;DRUGELIAI;6230566495;Ne;5;1;0;6
16039;Šilelis;DRUGELIAI;6523676718;Ne;0;4;0;4
16040;Šilelis;DRUGELIAI;5766702969;Ne;8;2;0;10
16041;Šilelis;DRUGELIAI;8915228012;Ne;4;0;1;5
16042;Šilelis;DRUGELIAI;1984731000;Ne;6;0;0;6
16043;Šilelis;DRUGELIAI;7542121945;Ne;0;4;0;4
16044;Vaivorykštė;Vasilki;1182787416;Ne;2;0;0;2
16045;Vaivorykštė;Vasilki;7584984095;Ne;2;0;0;2
16046;Vaivorykštė;Černički;2939777444;Ne;6;0;0;6
16047;Vaivorykštė;Černički;1280289591;Ne;6;0;0;6
16048;Vaivorykštė;Černički;2921117681;Ne;7;0;0;7
16049;Vaivorykštė;Černički;2697757513;Ne;11;0;0;11
16050;Vaivorykštė;Smorodinki;6660558274;Ne;4;0;0;4
16051;Vaivorykštė;Klubnički;6038851172;Ne;8;0;0;8
16052;Vaivorykštė;Maki;5770527396;Ne;17;0;0;17
16053;Vaivorykštė;Maki;3574911889;Ne;9;0;0;9
16054;Vaivorykštė;Maki;8028989061;Ne;1;0;0;1
16055;Vaivorykštė;Maki;9658149652;Ne;1;0;0;1
16056;Vaivorykštė;"VIŠENKI (LOGOP.)";8269241567;Ne;3;0;0;3
16057;Vaivorykštė;"ANIUTINY GLAZKI (LOGOPED.)";1568023021;Ne;5;0;0;5
16058;Vaivorykštė;"Kolokolčiki ";9689972596;Ne;6;0;0;6
16059;Vaivorykštė;"Vinogradiki ";4452029427;Ne;5;0;0;5
16060;Vaivorykštė;Malinki;2252828301;Ne;7;0;0;7
16061;Vaivorykštė;1B;16829822711;Ne;6;0;0;6
16062;Vaivorykštė;1B;67140125134;Ne;4;0;0;4
16063;Vaivorykštė;1B;49976650682;Ne;1;0;0;1
16064;Vaivorykštė;1B;1743621609;Ne;5;0;0;5
16065;Vaivorykštė;1B;39050794307;Ne;1;0;0;1
16066;Vaivorykštė;1C;5392153410;Ne;4;0;0;4
16067;Vaivorykštė;GOROŠKI;1990249057;Ne;2;0;0;2
16068;Vaivorykštė;GOROŠKI;7706526762;Ne;3;0;0;3
16069;Vaivorykštė;GOROŠKI;6815286823;Ne;5;0;0;5
16070;Vaduvos;PAGRANDUKAI;1431863758;Ne;1;0;0;1
16071;Vaduvos;PAGRANDUKAI;8408017356;Ne;0;10;1;11
16072;Vaduvos;PAGRANDUKAI;72724196791;Ne;4;9;0;13
16073;Vaduvos;PAGRANDUKAI;9371067563;Ne;0;3;0;3
16074;Vaduvos;PAGRANDUKAI;6425640531;Ne;4;0;0;4
16075;Vaduvos;PAGRANDUKAI;4029586203;Ne;0;1;0;1
16076;Vaduvos;PAGRANDUKAI;73800920781;Ne;0;0;7;7
16077;Vaduvos;PAGRANDUKAI;18035723255;Ne;0;0;1;1
16078;Vaduvos;PAGRANDUKAI;5954492368;Ne;14;1;0;15
16079;Vaduvos;PAGRANDUKAI;7397068779;Ne;0;5;0;5
16080;Vaduvos;PAGRANDUKAI;8875709110;Ne;0;3;0;3
16081;Vaduvos;PAGRANDUKAI;2897226343;Ne;8;0;0;8
16082;Vaduvos;PAGRANDUKAI;68848152670;Ne;19;0;0;19
16083;Vaduvos;PAGRANDUKAI;4105978403;Ne;0;2;0;2
16084;Vaduvos;PAGRANDUKAI;5428067167;Ne;5;0;7;12
16085;Vaduvos;PAGRANDUKAI;3699578284;Ne;7;2;0;9
16086;Vaduvos;PAGRANDUKAI;8299189235;Ne;20;0;0;20
16087;Vaduvos;PAGRANDUKAI;9540008495;Ne;0;2;0;2
16088;Vaduvos;KODĖLČIUKAI;3010510262;Ne;0;8;0;8
16089;Vaduvos;KODĖLČIUKAI;9429028460;Ne;0;1;0;1
16090;Vaduvos;KODĖLČIUKAI;6210729584;Ne;0;4;0;4
16091;Vaduvos;KODĖLČIUKAI;9606193112;Ne;0;2;0;2
16092;Vaduvos;KODĖLČIUKAI;4177935331;Ne;0;3;0;3
16093;Vaduvos;KODĖLČIUKAI;9072097216;Ne;0;0;4;4
16094;Vaduvos;KODĖLČIUKAI;6810198013;Ne;0;3;0;3
16095;Vaduvos;KODĖLČIUKAI;3641822841;Taip;14;0;5;19
16096;Vaduvos;KODĖLČIUKAI;5262165284;Ne;15;0;0;15
16097;Vaduvos;KODĖLČIUKAI;8603418399;Ne;5;6;0;11
16098;Vaduvos;KODĖLČIUKAI;3096104197;Ne;10;0;1;11
16099;Vaduvos;KODĖLČIUKAI;5761137540;Ne;1;0;0;1
16100;Vaduvos;KODĖLČIUKAI;1054097622;Ne;11;0;0;11
16101;Vaduvos;KODĖLČIUKAI;6013737546;Ne;0;0;13;13
16102;Vaduvos;KODĖLČIUKAI;6991960029;Ne;5;1;0;6
16103;Vaduvos;KODĖLČIUKAI;4789480822;Ne;0;2;0;2
16104;Vaduvos;SMALSUČIAI;3555513755;Taip;4;10;0;14
16105;Vaduvos;SMALSUČIAI;2184711783;Ne;0;2;0;2
16106;Vaduvos;SMALSUČIAI;7537754249;Ne;0;0;4;4
16107;Vaduvos;SMALSUČIAI;5573145836;Ne;0;0;4;4
16108;Vaduvos;SMALSUČIAI;7337663549;Ne;0;10;0;10
16109;Vaduvos;SMALSUČIAI;5055972872;Ne;15;1;0;16
16110;Vaduvos;SMALSUČIAI;1423148023;Ne;0;4;0;4
16111;Vaduvos;SMALSUČIAI;3091707832;Ne;0;4;0;4
16112;Vaduvos;SMALSUČIAI;87008942241;Ne;0;0;2;2
16113;Vaduvos;SMALSUČIAI;7181151562;Ne;0;0;1;1
16114;Vaduvos;SMALSUČIAI;7431411663;Ne;0;3;0;3
16115;Vaduvos;SMALSUČIAI;2257135127;Taip;8;0;1;9
16116;Vaduvos;SMALSUČIAI;6462126837;Ne;0;1;0;1
16117;Vaduvos;SMALSUČIAI;1265287458;Ne;9;0;2;11
16118;Vaduvos;SMALSUČIAI;1434871968;Ne;2;0;2;4
16119;Vaduvos;SMALSUČIAI;3948025914;Ne;6;0;5;11
16120;Vaduvos;SMALSUČIAI;7508333714;Ne;0;4;0;4
16121;Vaduvos;SMALSUČIAI;3925021238;Taip;20;0;0;20
16122;Vaduvos;SMALSUČIAI;9384395948;Ne;0;2;0;2
16123;Vaduvos;GILIUKAI;1277811729;Ne;5;1;0;6
16124;Vaduvos;GILIUKAI;1969325922;Taip;0;4;0;4
16125;Vaduvos;GILIUKAI;5376707663;Ne;9;0;0;9
16126;Vaduvos;GILIUKAI;6409466338;Ne;0;2;0;2
16127;Vaduvos;GILIUKAI;2835635250;Ne;4;0;0;4
16128;Vaduvos;GILIUKAI;2939561403;Ne;9;0;1;10
16129;Vaduvos;GILIUKAI;8188374113;Ne;15;3;0;18
16130;Vaduvos;GILIUKAI;6514406042;Ne;8;0;0;8
16131;Vaduvos;GILIUKAI;3057729267;Ne;17;0;0;17
16132;Vaduvos;GILIUKAI;6346625714;Ne;0;0;1;1
16133;Vaduvos;GILIUKAI;8580834401;Ne;8;0;3;11
16134;Vaduvos;GILIUKAI;9167796462;Ne;4;0;3;7
16135;Vaduvos;GILIUKAI;6276149710;Ne;0;0;14;14
16136;Vaduvos;GILIUKAI;6572776966;Ne;6;0;1;7
16137;Vaduvos;GILIUKAI;6676167440;Ne;0;1;0;1
16138;Vaduvos;GILIUKAI;2957685586;Ne;5;1;11;17
16139;Vaduvos;GILIUKAI;3540548094;Ne;8;0;0;8
16140;Vaduvos;GILIUKAI;8964194121;Ne;14;0;1;15
16141;Vaduvos;GILIUKAI;5297217576;Ne;5;1;0;6
16142;Vaduvos;GILIUKAI;5010914832;Ne;8;1;0;9
16143;Vaduvos;GILIUKAI;4030891958;Ne;0;0;10;10
16144;Vaduvos;GILIUKAI;7730737705;Ne;6;0;5;11
16145;Vaduvos;GILIUKAI;2011976336;Ne;14;0;0;14
16146;Vaduvos;BORUŽĖLĖS;2277525837;Ne;12;0;0;12
16147;Vaduvos;BORUŽĖLĖS;6439773886;Ne;1;13;0;14
16148;Vaduvos;BORUŽĖLĖS;5634252033;Ne;0;2;0;2
16149;Vaduvos;BORUŽĖLĖS;6593754016;Ne;20;0;0;20
16150;Vaduvos;BORUŽĖLĖS;7521846747;Ne;0;6;0;6
16151;Vaduvos;BORUŽĖLĖS;1422507884;Ne;9;0;0;9
16152;Vaduvos;BORUŽĖLĖS;3461756429;Ne;0;0;2;2
16153;Vaduvos;BORUŽĖLĖS;8324927031;Ne;0;6;0;6
16154;Vaduvos;BORUŽĖLĖS;4465504676;Ne;17;0;0;17
16155;Vaduvos;BORUŽĖLĖS;7904713344;Ne;9;0;0;9
16156;Vaduvos;BORUŽĖLĖS;2417613291;Ne;0;4;0;4
16157;Vaduvos;BORUŽĖLĖS;8064111922;Ne;1;0;4;5
16158;Vaduvos;BORUŽĖLĖS;2923920649;Ne;0;0;2;2
16159;Vaduvos;BORUŽĖLĖS;6552763746;Ne;13;2;0;15
16160;Vaduvos;BORUŽĖLĖS;3255011809;Ne;0;6;0;6
16161;Vaduvos;BORUŽĖLĖS;8946940285;Taip;9;1;0;10
16162;Vaduvos;BORUŽĖLĖS;9188471756;Ne;14;0;0;14
16163;Vaduvos;BORUŽĖLĖS;7169054113;Ne;0;5;0;5
16164;Vaduvos;BORUŽĖLĖS;1924714755;Ne;0;0;11;11
16165;Vaduvos;DRUGELIAI;4936598927;Ne;10;0;0;10
16166;Vaduvos;DRUGELIAI;2341467486;Ne;9;0;0;9
16167;Vaduvos;DRUGELIAI;5510687497;Ne;12;1;0;13
16168;Vaduvos;DRUGELIAI;9824469881;Ne;14;0;0;14
16169;Vaduvos;DRUGELIAI;5915272436;Ne;14;0;1;15
16170;Vaduvos;DRUGELIAI;4238942070;Ne;6;0;0;6
16171;Vaduvos;DRUGELIAI;1539465611;Ne;0;1;0;1
16172;Vaduvos;DRUGELIAI;8384302877;Ne;5;0;0;5
16173;Vaduvos;DRUGELIAI;6770559352;Ne;21;1;0;22
16174;Vaduvos;DRUGELIAI;4856601924;Ne;5;4;0;9
16175;Vaduvos;DRUGELIAI;2452309232;Taip;0;6;0;6
16176;Vaduvos;DRUGELIAI;6776150749;Ne;0;2;0;2
16177;Vaduvos;DRUGELIAI;4587836073;Ne;10;3;0;13
16178;Vaduvos;DRUGELIAI;9333495119;Ne;0;8;0;8
16179;Vaduvos;DRUGELIAI;7597268115;Ne;14;0;3;17
16180;Vaduvos;DRUGELIAI;8400344609;Ne;20;0;0;20
16181;Vaduvos;DRUGELIAI;1987969267;Ne;17;0;0;17
16182;Vaduvos;DRUGELIAI;8990472878;Ne;11;1;0;12
16183;Vaduvos;DRUGELIAI;2717887489;Ne;12;0;0;12
16184;Vaduvos;DRUGELIAI;5881009426;Ne;6;2;0;8
16185;Vaduvos;RIEŠUTĖLIAI;6611531526;Ne;6;0;3;9
16186;Vaduvos;RIEŠUTĖLIAI;1466282653;Ne;15;0;0;15
16187;Vaduvos;RIEŠUTĖLIAI;3206096414;Ne;10;0;7;17
16188;Vaduvos;RIEŠUTĖLIAI;8055108164;Ne;3;0;3;6
16189;Vaduvos;RIEŠUTĖLIAI;5509202519;Ne;0;2;4;6
16190;Vaduvos;RIEŠUTĖLIAI;3855900628;Ne;11;0;0;11
16191;Vaduvos;RIEŠUTĖLIAI;4576510280;Ne;15;0;0;15
16192;Vaduvos;RIEŠUTĖLIAI;5775152939;Ne;16;0;1;17
16193;Vaduvos;RIEŠUTĖLIAI;3060409258;Ne;0;2;0;2
16194;Vaduvos;RIEŠUTĖLIAI;8070494719;Ne;3;0;1;4
16195;Vaduvos;RIEŠUTĖLIAI;9232960362;Ne;20;0;0;20
16196;Vaduvos;RIEŠUTĖLIAI;7425991335;Ne;7;0;4;11
16197;Vaduvos;RIEŠUTĖLIAI;7592658267;Ne;4;0;11;15
16198;Vaduvos;RIEŠUTĖLIAI;8533315132;Ne;0;6;0;6
16199;Vaduvos;RIEŠUTĖLIAI;2508650990;Ne;14;0;0;14
16200;Vaduvos;RIEŠUTĖLIAI;6943057114;Ne;10;0;0;10
16201;Vaduvos;RIEŠUTĖLIAI;8669267296;Ne;10;0;0;10
16202;Vaduvos;RIEŠUTĖLIAI;1736248725;Ne;7;7;0;14
16203;Vaduvos;"1 klasė";3174998523;Ne;0;15;0;15
16204;Vaduvos;"1 klasė";1825188497;Ne;0;3;0;3
16205;Vaduvos;"1 klasė";3722349868;Ne;0;6;0;6
16206;Vaduvos;"1 klasė";13888236429;Ne;4;4;0;8
16207;Vaduvos;"1 klasė";5307128703;Ne;0;1;0;1
16208;Vaduvos;"1 klasė";6128582180;Ne;0;10;0;10
16209;Vaduvos;"1 klasė";62183976729;Ne;0;8;0;8
16210;Vaduvos;"1 klasė";93702732546;Ne;0;1;0;1
16211;Vaduvos;"1 klasė";15757662594;Ne;0;6;0;6
16212;Vaduvos;"1 klasė";41870343319;Ne;0;1;0;1
16213;Vaduvos;"1 klasė";4513707989;Ne;0;10;0;10
16214;Vaduvos;"1 klasė";68937983441;Ne;0;1;0;1
16215;Vaduvos;"1 klasė";59616893535;Ne;0;12;0;12
16216;Vaduvos;"1 klasė";22641388717;Ne;5;0;0;5
16217;Vaduvos;"1 klasė";21499108813;Ne;5;1;0;6
16218;Vaduvos;"1 klasė";79437154441;Ne;0;1;0;1
16219;Vaduvos;"1 klasė";46608435244;Ne;10;1;0;11
16220;Vaduvos;"1 klasė";61046090149;Ne;0;4;0;4
16221;Vaduvos;"1 klasė";56280470781;Ne;3;1;0;4
16222;Vaduvos;"1 klasė";11202010413;Ne;0;1;0;1
16223;Vaduvos;"1 klasė";1370696345;Ne;0;2;0;2
16224;Vaduvos;"1 klasė";4342471835;Ne;0;1;0;1
16225;Vaduvos;"1 klasė";9112649520;Ne;0;1;0;1
16226;Vaduvos;"1 klasė";1599595256;Ne;7;1;0;8
16227;Vaduvos;"1 klasė";5435336235;Ne;0;8;0;8
16228;Vaduvos;"1 klasė";1681367373;Ne;0;11;0;11
16229;Vaduvos;"3 klasė";97423576166;Ne;0;1;0;1
16230;Vaduvos;"3 klasė";38504924027;Ne;0;1;0;1
16231;Vaduvos;"3 klasė";96148085691;Ne;0;1;0;1
16232;Vaduvos;"3 klasė";12330772986;Ne;0;4;0;4
16233;Vaduvos;"3 klasė";33277362439;Ne;1;3;0;4
16234;Vaduvos;"3 klasė";32138087379;Ne;0;20;0;20
16235;Vaduvos;"3 klasė";67324784528;Ne;0;1;0;1
16236;Vaduvos;"3 klasė";4807104855;Ne;0;1;0;1
16237;Vaduvos;"3 klasė";2181614424;Ne;0;1;0;1
16238;Vaduvos;"3 klasė";2019573643;Ne;1;5;0;6
16239;Vaduvos;"3 klasė";27419094487;Ne;0;1;0;1
16240;Vaduvos;"3 klasė";89793734700;Ne;0;1;0;1
16241;Vaduvos;"3 klasė";17473821556;Ne;0;20;0;20
16242;Vaduvos;"3 klasė";53866301875;Ne;0;20;0;20
16243;Vaduvos;"3 klasė";7786986697;Ne;0;1;0;1
16244;Vaduvos;"3 klasė";9147332638;Ne;0;1;0;1
16245;Vaduvos;"3 klasė";1532675814;Ne;0;3;0;3
16246;Vaduvos;"3 klasė";98259624669;Ne;0;1;0;1
16247;Vaduvos;"3 klasė";36931517006;Ne;0;1;0;1
16248;Vaduvos;"3 klasė";61243424057;Ne;0;10;0;10
16249;Vaduvos;"3 klasė";30979103892;Ne;0;1;0;1
16250;Vaduvos;"3 klasė";78245732319;Ne;0;1;0;1
16251;Vaduvos;"3 klasė";48433447683;Ne;0;2;0;2
16252;Vaduvos;"3 klasė";85090873161;Ne;0;20;0;20
16253;Vaduvos;"3 klasė";41272273463;Ne;0;1;0;1
16254;Vaduvos;"4 klasė";96473212525;Ne;0;9;0;9
16255;Vaduvos;"4 klasė";75428164558;Ne;0;1;0;1
16256;Vaduvos;"4 klasė";63286903462;Ne;0;2;0;2
16257;Vaduvos;"4 klasė";13721939854;Ne;0;4;0;4
16258;Vaduvos;"4 klasė";1171210935;Ne;0;2;0;2
16259;Vaduvos;"4 klasė";7172286009;Ne;0;8;0;8
16260;Vaduvos;"4 klasė";6049882391;Ne;0;20;0;20
16261;Vaduvos;"4 klasė";38013859931;Ne;0;1;0;1
16262;Vaduvos;"4 klasė";4591744662;Ne;0;1;0;1
16263;Vaduvos;"4 klasė";9149523910;Ne;0;1;0;1
16264;Vaduvos;"4 klasė";76662161382;Ne;0;1;0;1
16265;Vaduvos;"4 klasė";26934740147;Ne;0;2;0;2
16266;Vaduvos;"4 klasė";18300713872;Ne;0;20;0;20
16267;Vaduvos;"4 klasė";768455288;Ne;0;2;0;2
16268;Vaduvos;"4 klasė";1768173501;Ne;0;1;0;1
16269;Vaduvos;"4 klasė";60531886576;Ne;0;1;0;1
16270;Vaduvos;"4 klasė";38462664426;Ne;0;2;0;2
16271;Vaduvos;"4 klasė";1821644443;Ne;0;5;0;5
16272;Vaduvos;"2 B klasė";95104294893;Ne;6;1;0;7
16273;Vaduvos;"2 B klasė";1241148402;Ne;0;2;0;2
16274;Vaduvos;"2 B klasė";66359913774;Ne;0;2;0;2
16275;Vaduvos;"2 B klasė";39687066893;Ne;0;4;0;4
16276;Vaduvos;"2 B klasė";64074141491;Ne;6;0;0;6
16277;Vaduvos;"2 B klasė";47465933557;Ne;0;1;0;1
16278;Vaduvos;"2 B klasė";62521006557;Ne;0;1;0;1
16279;Vaduvos;"2 B klasė";87671358423;Ne;0;20;0;20
16280;Vaduvos;"2 B klasė";3310156076;Ne;0;20;0;20
16281;Vaduvos;"2 A klasė";6279678482;Ne;0;2;0;2
16282;Vaduvos;"2 A klasė";96892752634;Ne;0;2;0;2
16283;Vaduvos;"2 A klasė";61243200177;Ne;0;1;0;1
16284;Vaduvos;"2 A klasė";62703428759;Ne;0;1;0;1
16285;Vaduvos;"2 A klasė";68420568339;Ne;0;3;0;3
16286;Vaduvos;"2 A klasė";49738318631;Ne;0;1;0;1
16287;Vaduvos;"2 A klasė";65647119496;Ne;0;1;0;1
16288;Vaduvos;"2 A klasė";19390879176;Ne;0;1;0;1
16289;Vaduvos;"2 A klasė";6155494370;Ne;0;3;0;3
16290;Vaduvos;"2 A klasė";1139509471;Ne;0;20;0;20
16291;Vaduvos;"2 A klasė";70693742936;Ne;0;4;0;4
16292;Vaduvos;"2 A klasė";1010061503;Ne;0;1;0;1
16293;Vaduvos;"2 A klasė";1107557891;Ne;0;20;0;20
16294;Vaduvos;"2 A klasė";8802765960;Ne;0;1;0;1
16295;Vaduvos;"2 A klasė";3172047211;Ne;0;2;0;2
16296;Vilkpėdės;BORUŽĖLĖS;8002436634;Ne;0;0;1;1
16297;Vilkpėdės;BORUŽĖLĖS;1249504082;Ne;1;0;5;6
16298;Vilkpėdės;BORUŽĖLĖS;4052026470;Ne;5;0;2;7
16299;Vilkpėdės;BORUŽĖLĖS;4726171678;Ne;9;0;0;9
16300;Vilkpėdės;BORUŽĖLĖS;7519472444;Ne;10;0;0;10
16301;Vilkpėdės;BORUŽĖLĖS;3991785883;Ne;7;0;2;9
16302;Vilkpėdės;BORUŽĖLĖS;9334610111;Ne;10;0;0;10
16303;Vilkpėdės;BORUŽĖLĖS;5050493757;Ne;8;0;3;11
16304;Vilkpėdės;BORUŽĖLĖS;8217972925;Ne;12;1;0;13
16305;Vilkpėdės;BORUŽĖLĖS;2232913117;Taip;16;0;3;19
16306;Vilkpėdės;BORUŽĖLĖS;7805866055;Ne;7;0;0;7
16307;Vilkpėdės;BORUŽĖLĖS;3994451071;Ne;6;0;8;14
16308;Vilkpėdės;BORUŽĖLĖS;2529188623;Ne;8;0;2;10
16309;Vilkpėdės;BORUŽĖLĖS;5569182344;Ne;6;0;0;6
16310;Vilkpėdės;BORUŽĖLĖS;5677284428;Ne;15;0;0;15
16311;Vilkpėdės;SKRUZDĖLIUKAI;7661268641;Ne;0;4;0;4
16312;Vilkpėdės;SKRUZDĖLIUKAI;4018140154;Ne;15;0;1;16
16313;Vilkpėdės;SKRUZDĖLIUKAI;2419661008;Ne;15;0;0;15
16314;Vilkpėdės;SKRUZDĖLIUKAI;8804335248;Ne;13;0;0;13
16315;Vilkpėdės;SKRUZDĖLIUKAI;2525399410;Ne;6;0;3;9
16316;Vilkpėdės;SKRUZDĖLIUKAI;4031175523;Ne;0;0;1;1
16317;Vilkpėdės;SKRUZDĖLIUKAI;6198736925;Ne;6;0;2;8
16318;Vilkpėdės;SKRUZDĖLIUKAI;5812430367;Ne;3;3;0;6
16319;Vilkpėdės;SKRUZDĖLIUKAI;1478022307;Ne;8;5;0;13
16320;Vilkpėdės;SKRUZDĖLIUKAI;2205143759;Ne;0;1;3;4
16321;Vilkpėdės;SKRUZDĖLIUKAI;6598572049;Ne;0;0;1;1
16322;Vilkpėdės;SKRUZDĖLIUKAI;7931496783;Ne;5;0;0;5
16323;Vilkpėdės;SKRUZDĖLIUKAI;2418313731;Ne;0;0;7;7
16324;Vilkpėdės;SKRUZDĖLIUKAI;1342167313;Ne;26;3;0;29
16325;Vilkpėdės;SKRUZDĖLIUKAI;1838974989;Ne;6;0;4;10
16326;Vilkpėdės;SKRUZDĖLIUKAI;5334238235;Ne;10;0;1;11
16327;Vilkpėdės;SKRUZDĖLIUKAI;2703704892;Ne;0;0;2;2
16328;Vilkpėdės;SKRUZDĖLIUKAI;8385974099;Ne;6;0;0;6
16329;Vilkpėdės;SKRUZDĖLIUKAI;1985540746;Ne;5;0;5;10
16330;Vilkpėdės;DRUGELIAI;1040357501;Ne;5;2;0;7
16331;Vilkpėdės;DRUGELIAI;6876470245;Ne;5;2;0;7
16332;Vilkpėdės;DRUGELIAI;8431620518;Ne;4;0;2;6
16333;Vilkpėdės;DRUGELIAI;1655396296;Ne;5;0;2;7
16334;Vilkpėdės;DRUGELIAI;5076206526;Ne;0;4;0;4
16335;Vilkpėdės;DRUGELIAI;3611416887;Ne;0;4;0;4
16336;Vilkpėdės;DRUGELIAI;7008659662;Ne;2;0;0;2
16337;Vilkpėdės;DRUGELIAI;9501254301;Ne;9;0;0;9
16338;Vilkpėdės;DRUGELIAI;4998396593;Ne;3;0;0;3
16339;Vilkpėdės;DRUGELIAI;6819447340;Ne;6;1;0;7
16340;Vilkpėdės;DRUGELIAI;1278300322;Ne;0;1;0;1
16341;Vilkpėdės;DRUGELIAI;9797550851;Ne;18;0;0;18
16342;Vilkpėdės;DRUGELIAI;2379571797;Ne;5;0;0;5
16343;Vilkpėdės;DRUGELIAI;2358685682;Ne;8;0;0;8
16344;Vilkpėdės;DRUGELIAI;7489143683;Ne;0;4;0;4
16345;Vilkpėdės;ŽIOGELIAI;1396827668;Ne;3;0;0;3
16346;Vilkpėdės;ŽIOGELIAI;5551822633;Ne;17;0;0;17
16347;Vilkpėdės;ŽIOGELIAI;9544418642;Ne;0;5;0;5
16348;Vilkpėdės;ŽIOGELIAI;1063740772;Ne;6;1;0;7
16349;Vilkpėdės;ŽIOGELIAI;3666145718;Ne;4;2;0;6
16350;Vilkpėdės;ŽIOGELIAI;5633014328;Ne;6;0;0;6
16351;Vilkpėdės;ŽIOGELIAI;5422061533;Ne;9;0;0;9
16352;Vilkpėdės;ŽIOGELIAI;4311938034;Ne;5;0;0;5
16353;Vilkpėdės;ŽIOGELIAI;5346798201;Ne;0;5;0;5
16354;Vilkpėdės;ŽIOGELIAI;3720639726;Ne;6;0;0;6
16355;Vilkpėdės;ŽIOGELIAI;1609823694;Ne;8;0;0;8
16356;Vilkpėdės;ŽIOGELIAI;7634076203;Ne;6;0;0;6
16357;Vilkpėdės;ŽIOGELIAI;6690742997;Ne;2;2;0;4
16358;Vilkpėdės;ŽIOGELIAI;3350784810;Ne;9;1;0;10
16359;Vilkpėdės;ŽIOGELIAI;1655985778;Ne;13;2;0;15
16360;Vilkpėdės;ŽIOGELIAI;3664125930;Ne;8;0;0;8
16361;Vilkpėdės;ŽIOGELIAI;3737265597;Ne;14;0;0;14
16362;Vilkpėdės;ŽIOGELIAI;2241104719;Ne;6;2;0;8
16363;Vilkpėdės;ŽIOGELIAI;8423972962;Ne;3;2;0;5
16364;Vilkpėdės;ŽIOGELIAI;1537270256;Ne;8;2;0;10
16365;Vilkpėdės;ŽIOGELIAI;3229559339;Ne;8;2;0;10
16366;Vilkpėdės;ŽIOGELIAI;8783790519;Ne;7;2;0;9
16367;Vilkpėdės;BITUTĖS;6418829930;Ne;0;7;0;7
16368;Vilkpėdės;BITUTĖS;1633942236;Ne;5;4;0;9
16369;Vilkpėdės;BITUTĖS;2503128176;Ne;6;0;0;6
16370;Vilkpėdės;BITUTĖS;9570469277;Taip;0;4;3;7
16371;Vilkpėdės;BITUTĖS;5420512675;Ne;0;0;3;3
16372;Vilkpėdės;BITUTĖS;8613778606;Ne;10;4;0;14
16373;Vilkpėdės;BITUTĖS;7991758361;Ne;1;0;0;1
16374;Vilkpėdės;BITUTĖS;6064336759;Ne;4;0;0;4
16375;Vilkpėdės;BITUTĖS;5577199802;Ne;9;0;0;9
16376;Vilkpėdės;BITUTĖS;8930504912;Ne;4;0;2;6
16377;Vilkpėdės;BITUTĖS;3303872633;Ne;10;5;0;15
16378;Vilkpėdės;BITUTĖS;5972405023;Ne;0;1;0;1
16379;Vilkpėdės;BITUTĖS;4485811377;Ne;14;0;0;14
16380;Vilkpėdės;BITUTĖS;5274855225;Ne;13;0;0;13
16381;Vilkpėdės;BITUTĖS;8860791478;Ne;5;0;0;5
16382;Vilkpėdės;BITUTĖS;7829343719;Ne;16;0;1;17
16383;Vilkpėdės;"4 klasė";51286525404;Ne;2;0;0;2
16384;Vilkpėdės;"4 klasė";49513181091;Ne;0;8;0;8
16385;Vilkpėdės;"4 klasė";37450374921;Ne;3;0;0;3
16386;Vilkpėdės;"4 klasė";1024429836;Ne;2;0;0;2
16387;Vilkpėdės;"4 klasė";66356984763;Ne;5;5;0;10
16388;Vilkpėdės;"4 klasė";88279045901;Ne;3;2;0;5
16389;Vilkpėdės;"4 klasė";66451097025;Ne;9;0;0;9
16390;Vilkpėdės;"4 klasė";2806307083;Ne;0;6;0;6
16391;Vilkpėdės;"4 klasė";79269485254;Ne;1;1;0;2
16392;Vilkpėdės;GUDRUČIAI;1451102218;Ne;0;7;0;7
16393;Vilkpėdės;GUDRUČIAI;2065010940;Ne;3;2;0;5
16394;Vilkpėdės;GUDRUČIAI;2181146968;Ne;0;2;0;2
16395;Vilkpėdės;GUDRUČIAI;4392760215;Ne;0;5;0;5
16396;Vilkpėdės;GUDRUČIAI;4515945951;Ne;5;0;2;7
16397;Vilkpėdės;GUDRUČIAI;2736368118;Ne;6;0;0;6
16398;Vilkpėdės;GUDRUČIAI;7527929277;Taip;0;2;0;2
16399;Vilkpėdės;GUDRUČIAI;46561435465;Ne;0;7;0;7
16400;Vilkpėdės;GUDRUČIAI;48059844727;Ne;1;1;0;2
16401;Vilkpėdės;GUDRUČIAI;4735164204;Ne;9;0;0;9
16402;Vilkpėdės;GUDRUČIAI;7889480219;Ne;0;2;0;2
16403;Vilkpėdės;GUDRUČIAI;9867411687;Ne;0;3;0;3
16404;Vilkpėdės;GUDRUČIAI;2900581406;Ne;0;1;0;1
16405;Vilkpėdės;GUDRUČIAI;7875898177;Ne;0;9;0;9
16406;Vilkpėdės;GUDRUČIAI;1195392132;Ne;0;1;0;1
16407;Vilkpėdės;GUDRUČIAI;7634355147;Ne;0;1;0;1
16408;Vilkpėdės;GUDRUČIAI;4276158771;Ne;5;2;0;7
16409;Vilkpėdės;GUDRUČIAI;2604179994;Ne;6;2;0;8
16410;Vilkpėdės;GUDRUČIAI;3696611509;Ne;2;2;0;4
16411;Vilkpėdės;SMALSUČIAI;4095366279;Ne;0;1;0;1
16412;Vilkpėdės;SMALSUČIAI;5048931309;Ne;10;0;0;10
16413;Vilkpėdės;SMALSUČIAI;7698759895;Ne;3;5;0;8
16414;Vilkpėdės;SMALSUČIAI;1217929358;Ne;5;1;0;6
16415;Vilkpėdės;SMALSUČIAI;1807884737;Ne;6;5;0;11
16416;Vilkpėdės;SMALSUČIAI;2251274741;Ne;9;4;0;13
16417;Vilkpėdės;SMALSUČIAI;6816745585;Ne;6;0;0;6
16418;Vilkpėdės;SMALSUČIAI;9460356725;Ne;3;0;0;3
16419;Vilkpėdės;SMALSUČIAI;8128254701;Ne;0;6;0;6
16420;Vilkpėdės;SMALSUČIAI;2320350937;Ne;9;0;0;9
16421;Vilkpėdės;SMALSUČIAI;7747013579;Ne;0;2;0;2
16422;Vilkpėdės;SMALSUČIAI;7894766629;Ne;0;2;0;2
16423;Vilkpėdės;SMALSUČIAI;3987021185;Ne;11;0;0;11
16424;Vilkpėdės;SMALSUČIAI;7010024061;Ne;0;9;0;9
16425;Vilkpėdės;SMALSUČIAI;7908813288;Ne;0;2;0;2
16426;Vilkpėdės;SMALSUČIAI;6522707709;Ne;0;5;1;6
16427;Vilkpėdės;SMALSUČIAI;9795696242;Ne;0;1;0;1
16428;Vilkpėdės;SMALSUČIAI;8581661608;Ne;0;1;0;1
16429;Vilkpėdės;SMALSUČIAI;6261547304;Ne;1;0;0;1
16430;Vilkpėdės;SMALSUČIAI;2420271759;Ne;12;0;0;12
16431;Vilkpėdės;KODĖLČIUKŲ;6283767445;Ne;0;5;0;5
16432;Vilkpėdės;KODĖLČIUKŲ;9605430333;Ne;4;1;0;5
16433;Vilkpėdės;KODĖLČIUKŲ;7745776486;Taip;4;0;0;4
16434;Vilkpėdės;KODĖLČIUKŲ;8969001990;Ne;10;1;0;11
16435;Vilkpėdės;KODĖLČIUKŲ;7158737372;Ne;9;2;0;11
16436;Vilkpėdės;KODĖLČIUKŲ;3785308006;Ne;5;0;0;5
16437;Vilkpėdės;KODĖLČIUKŲ;6744834487;Ne;1;4;0;5
16438;Vilkpėdės;KODĖLČIUKŲ;4166416292;Ne;4;5;0;9
16439;Vilkpėdės;KODĖLČIUKŲ;3888880306;Ne;0;6;0;6
16440;Vilkpėdės;KODĖLČIUKŲ;9601934563;Ne;0;1;0;1
16441;Vilkpėdės;KODĖLČIUKŲ;7401886306;Ne;10;1;0;11
16442;Vilkpėdės;KODĖLČIUKŲ;1528619779;Ne;12;0;0;12
16443;Vilkpėdės;KODĖLČIUKŲ;2359315281;Ne;12;0;0;12
16444;Vilkpėdės;KODĖLČIUKŲ;1571869318;Ne;0;2;0;2
16445;Vilkpėdės;KODĖLČIUKŲ;6820236577;Ne;0;1;0;1
16446;Vilkpėdės;KODĖLČIUKŲ;4255757333;Ne;1;2;0;3
16447;Vilkpėdės;KODĖLČIUKŲ;1063561954;Ne;1;0;0;1
16448;Vilkpėdės;KODĖLČIUKŲ;6778288398;Ne;4;2;0;6
16449;Vilkpėdės;KODĖLČIUKŲ;7284081203;Ne;9;0;0;9
16450;Žiburėlis;Nykštukai;7163594513;Ne;0;1;1;2
16451;Žiburėlis;Nykštukai;5174211773;Ne;0;2;2;4
16452;Žiburėlis;Nykštukai;5408766721;Ne;0;0;2;2
16453;Žiburėlis;Nykštukai;7211961512;Ne;3;2;0;5
16454;Žiburėlis;Nykštukai;7465939429;Taip;2;2;0;4
16455;Žiburėlis;Nykštukai;7307386173;Taip;5;6;0;11
16456;Žiburėlis;Nykštukai;8215816053;Ne;0;1;0;1
16457;Žiburėlis;Nykštukai;7633450988;Taip;10;0;1;11
16458;Žiburėlis;Nykštukai;2292895729;Ne;6;5;0;11
16459;Žiburėlis;Nykštukai;9806454408;Ne;0;14;0;14
16460;Žiburėlis;Nykštukai;3938379566;Ne;0;10;0;10
16461;Žiburėlis;Nykštukai;8480167191;Ne;4;6;0;10
16462;Žiburėlis;Nykštukai;1559091567;Ne;0;4;0;4
16463;Žiburėlis;Nykštukai;3750024153;Ne;0;4;1;5
16464;Žiburėlis;"Žiniukai ";5816890413;Ne;19;0;0;19
16465;Žiburėlis;"Žiniukai ";2928528630;Ne;0;4;0;4
16466;Žiburėlis;"Žiniukai ";2624326930;Ne;0;12;0;12
16467;Žiburėlis;"Žiniukai ";6300247811;Ne;4;0;0;4
16468;Žiburėlis;"Žiniukai ";3033049328;Ne;0;2;0;2
16469;Žiburėlis;"Žiniukai ";3262856058;Ne;6;1;0;7
16470;Žiburėlis;"Žiniukai ";1720078356;Ne;9;0;0;9
16471;Žiburėlis;"Žiniukai ";7424129974;Ne;0;3;0;3
16472;Žiburėlis;"Žiniukai ";4187381976;Ne;12;1;0;13
16473;Žiburėlis;"Žiniukai ";5006361324;Ne;5;0;0;5
16474;Žiburėlis;"Žiniukai ";2956339420;Ne;1;1;0;2
16475;Žiburėlis;"Žiniukai ";2999365435;Ne;0;1;0;1
16476;Žiburėlis;"Žiniukai ";7070952018;Ne;0;8;0;8
16477;Žiburėlis;"Žiniukai ";3687703187;Ne;0;4;0;4
16478;Žiburėlis;"Žiniukai ";8535429783;Ne;16;0;0;16
16479;Žiburėlis;"Žiniukai ";1543314096;Ne;5;1;0;6
16480;Žiburėlis;"Žiniukai ";1061646244;Ne;6;0;0;6
16481;Žiburėlis;"Žiniukai ";2741301903;Ne;12;1;0;13
16482;Žiburėlis;"Smalsiukai ";5438697081;Taip;6;0;0;6
16483;Žiburėlis;"Smalsiukai ";1126972447;Ne;9;0;0;9
16484;Žiburėlis;"Smalsiukai ";5114554577;Ne;0;2;0;2
16485;Žiburėlis;"Smalsiukai ";2072972990;Ne;10;0;0;10
16486;Žiburėlis;"Smalsiukai ";3835820013;Ne;2;2;0;4
16487;Žiburėlis;"Smalsiukai ";4355778076;Ne;1;1;0;2
16488;Žiburėlis;"Smalsiukai ";92490398630;Ne;3;0;0;3
16489;Žiburėlis;"Smalsiukai ";7578655857;Ne;0;1;0;1
16490;Žiburėlis;"Smalsiukai ";9253393819;Ne;0;4;0;4
16491;Žiburėlis;"Smalsiukai ";1599112927;Ne;0;8;0;8
16492;Žiburėlis;"Smalsiukai ";24639355056;Ne;0;1;0;1
16493;Žiburėlis;"Smalsiukai ";6519139977;Ne;0;20;0;20
16494;Žiburėlis;"Smalsiukai ";7861704875;Ne;0;1;0;1
16495;Žiburėlis;"Smalsiukai ";34873231652;Ne;0;3;0;3
16496;Žiburėlis;"Smalsiukai ";1125662904;Ne;0;11;0;11
16497;Žiburėlis;"Smalsiukai ";2175751377;Ne;1;3;0;4
16498;Žiburėlis;"Smalsiukai ";28985997205;Ne;5;5;0;10
16499;Žiburėlis;"Giliukai ";7310274376;Ne;4;0;0;4
16500;Žiburėlis;"Giliukai ";1090883494;Taip;5;0;0;5
16501;Žiburėlis;"Giliukai ";9215654134;Ne;5;1;0;6
16502;Žiburėlis;"Giliukai ";2866098551;Taip;6;0;0;6
16503;Žiburėlis;"Giliukai ";6918525245;Taip;3;1;0;4
16504;Žiburėlis;"Giliukai ";6946621147;Ne;0;4;0;4
16505;Žiburėlis;"Giliukai ";5148264064;Taip;11;0;0;11
16506;Žiburėlis;"Giliukai ";6733333096;Ne;5;0;0;5
16507;Žiburėlis;"Giliukai ";1943162133;Ne;1;0;0;1
16508;Žiburėlis;"Giliukai ";6232492947;Ne;6;0;0;6
16509;Žiburėlis;"Giliukai ";3807588865;Ne;5;0;0;5
16510;Žiburėlis;"Giliukai ";4091901597;Ne;3;0;0;3
16511;Žiburėlis;"Giliukai ";4016969144;Ne;14;0;0;14
16512;Žiburėlis;"Giliukai ";3776569251;Ne;13;0;0;13
16513;Žiburėlis;"Giliukai ";9494271740;Ne;0;1;0;1
16514;Žiburėlis;"Giliukai ";3992503848;Ne;8;1;0;9
16515;Žiburėlis;"Giliukai ";8440073413;Ne;15;0;0;15
16516;Žiburėlis;"Giliukai ";6121237159;Ne;15;0;0;15
16517;Žiburėlis;"Giliukai ";6289338466;Ne;8;0;0;8
16518;Žiburėlis;"Giliukai ";7977098545;Ne;0;1;0;1
16519;Žiburėlis;"Giliukai ";2990465012;Ne;8;0;0;8
16520;Žiburėlis;"Giliukai ";8697451319;Ne;5;1;0;6
16521;Žiburėlis;"1 klasė";93584914250;Ne;5;0;0;5
16522;Žiburėlis;Meškiukai;3593851196;Ne;8;0;0;8
16523;Žiburėlis;Meškiukai;9470154520;Ne;1;2;0;3
16524;Žiburėlis;Meškiukai;2285666668;Ne;7;0;0;7
16525;Žiburėlis;Meškiukai;9731661697;Taip;9;0;0;9
16526;Žiburėlis;Meškiukai;2186032732;Ne;6;0;0;6
16527;Žiburėlis;Meškiukai;9321467329;Taip;0;4;0;4
16528;Žiburėlis;Meškiukai;2254407798;Ne;5;0;0;5
16529;Žiburėlis;Meškiukai;1651713696;Ne;0;0;1;1
16530;Žiburėlis;Meškiukai;8415647388;Ne;1;0;0;1
16531;Žiburėlis;Meškiukai;2371990135;Ne;0;0;2;2
16532;Žiburėlis;Meškiukai;6218255066;Ne;9;0;0;9
16533;Žiburėlis;Meškiukai;3522480911;Taip;5;0;2;7
16534;Žiburėlis;Meškiukai;5683969627;Ne;5;0;0;5
16535;Žiburėlis;Meškiukai;4667559315;Ne;0;1;0;1
16536;Žiburėlis;Viščiukai;5115160061;Taip;20;0;0;20
16537;Žiburėlis;Viščiukai;7485768254;Ne;15;0;0;15
16538;Žiburėlis;Viščiukai;7364102991;Ne;14;0;0;14
16539;Žiburėlis;Viščiukai;8179414341;Ne;16;0;0;16
16540;Žiburėlis;Viščiukai;7140031765;Taip;0;0;3;3
16541;Žiburėlis;Viščiukai;1758251348;Ne;0;1;0;1
16542;Žiburėlis;Viščiukai;3323538690;Ne;10;8;0;18
16543;Žiburėlis;Viščiukai;1121755119;Ne;0;1;0;1
16544;Žiburėlis;Viščiukai;3738184802;Ne;7;1;0;8
16545;Žiburėlis;Viščiukai;8603154782;Ne;14;1;0;15
16546;Žiburėlis;Viščiukai;5213049603;Ne;1;2;0;3
16547;Žiburėlis;Viščiukai;4727673956;Ne;1;0;0;1
16548;Žiburėlis;Viščiukai;1606332622;Ne;5;0;0;5
16549;Žiburėlis;Viščiukai;8284913889;Ne;18;0;0;18
16550;Žiburėlis;Viščiukai;2851350451;Ne;10;0;0;10
16551;Žiburėlis;Viščiukai;6206770019;Ne;0;8;0;8
16552;Žiburėlis;Viščiukai;5314676261;Ne;7;0;0;7
16553;Žiburėlis;"Drambliukai ";5724506894;Ne;5;3;0;8
16554;Žiburėlis;"Drambliukai ";2102574423;Ne;4;0;0;4
16555;Žiburėlis;"Drambliukai ";4937518207;Ne;4;1;0;5
16556;Žiburėlis;"Drambliukai ";9041469393;Taip;19;0;0;19
16557;Žiburėlis;"Drambliukai ";8285987095;Ne;23;0;0;23
16558;Žiburėlis;"Drambliukai ";2805244671;Taip;2;3;0;5
16559;Žiburėlis;"Drambliukai ";5025452484;Taip;5;4;0;9
16560;Žiburėlis;"Drambliukai ";9344950711;Ne;20;4;0;24
16561;Žiburėlis;"Drambliukai ";8082088504;Taip;6;11;0;17
16562;Žiburėlis;"Drambliukai ";4656467260;Ne;5;1;0;6
16563;Žiburėlis;"Drambliukai ";9771442035;Ne;11;4;0;15
16564;Žiburėlis;"Drambliukai ";6274583813;Ne;2;0;0;2
16565;Žiburėlis;"Drambliukai ";5194593598;Ne;32;0;0;32
16566;Žiburėlis;"Drambliukai ";8752098051;Ne;0;6;0;6
16567;Žiburėlis;"Drambliukai ";8207315673;Ne;9;1;0;10
16568;Žiburėlis;"Drambliukai ";6751043071;Ne;17;0;0;17
16569;Žiburėlis;"Drambliukai ";1449541244;Taip;15;5;0;20
16570;Žiburėlis;"2 klasė";75779767358;Ne;5;0;0;5
16571;Žiburėlis;"2 klasė";19924188057;Ne;4;0;0;4
16572;Žiburėlis;BORUŽIUKAI;3723613593;Ne;1;2;0;3
16573;Žiburėlis;BORUŽIUKAI;7895148630;Ne;0;20;0;20
16574;Žiburėlis;BORUŽIUKAI;8936912406;Ne;0;5;0;5
16575;Žiburėlis;BORUŽIUKAI;4631232618;Ne;15;0;0;15
16576;Žiburėlis;BORUŽIUKAI;5793531526;Ne;0;3;0;3
16577;Žiburėlis;BORUŽIUKAI;4578828135;Ne;0;0;1;1
16578;Žiburėlis;BORUŽIUKAI;6128571259;Ne;1;2;0;3
16579;Žiburėlis;BORUŽIUKAI;3760039280;Ne;0;1;0;1
16580;Žiburėlis;BORUŽIUKAI;5799439634;Ne;6;1;0;7
16581;Žiburėlis;BORUŽIUKAI;4229040996;Ne;4;5;0;9
16582;Žiburėlis;BORUŽIUKAI;8373944614;Ne;20;0;0;20
16583;Žiburėlis;BORUŽIUKAI;9256751455;Ne;5;0;0;5
16584;Žiburėlis;BORUŽIUKAI;9357376188;Ne;0;5;0;5
16585;Žiburėlis;BORUŽIUKAI;4233222771;Ne;0;0;3;3
16586;Žiburėlis;BORUŽIUKAI;9029039015;Ne;0;0;2;2
16587;Žiburėlis;BORUŽIUKAI;7017574924;Ne;20;0;0;20
16588;Žiburėlis;BORUŽIUKAI;1661456806;Ne;0;5;0;5
16589;Žiburėlis;BORUŽIUKAI;2527837980;Ne;14;0;0;14
16590;Žiburėlis;BORUŽIUKAI;5828514911;Ne;0;0;1;1
16591;Žiburėlis;SPINDULIUKAI;5002691930;Ne;3;1;0;4
16592;Žiburėlis;SPINDULIUKAI;2995697464;Ne;4;0;0;4
16593;Žiburėlis;SPINDULIUKAI;7856708616;Ne;8;4;2;14
16594;Žiburėlis;SPINDULIUKAI;5205959106;Ne;4;0;1;5
16595;Žiburėlis;SPINDULIUKAI;2491972986;Ne;9;5;0;14
16596;Žiburėlis;SPINDULIUKAI;1190058462;Ne;0;1;0;1
16597;Žiburėlis;SPINDULIUKAI;7402647048;Ne;7;0;0;7
16598;Žiburėlis;SPINDULIUKAI;9352485231;Ne;0;1;0;1
16599;Žiburėlis;SPINDULIUKAI;5951659866;Ne;6;0;0;6
16600;Žiburėlis;SPINDULIUKAI;1775465307;Ne;0;1;0;1
16601;Žiburėlis;SPINDULIUKAI;8346571253;Ne;5;0;0;5
16602;Žiburėlis;SPINDULIUKAI;8973307069;Ne;3;1;0;4
16603;Žiburėlis;SPINDULIUKAI;5098955523;Ne;0;13;0;13
16604;Žiburėlis;SPINDULIUKAI;6647598068;Ne;2;0;0;2
16605;Žiburėlis;SPINDULIUKAI;8686565770;Taip;3;1;0;4
16606;Žiburėlis;SPINDULIUKAI;7825665451;Ne;0;2;0;2
16607;Žiburėlis;SPINDULIUKAI;5556807335;Ne;5;0;0;5
16608;Žiburėlis;SPINDULIUKAI;2808361570;Ne;5;0;0;5
16609;Žiburėlis;KIŠKUČIAI;6492467281;Ne;5;0;2;7
16610;Žiburėlis;KIŠKUČIAI;3352845095;Ne;0;3;0;3
16611;Žiburėlis;KIŠKUČIAI;1004953300;Ne;12;0;0;12
16612;Žiburėlis;KIŠKUČIAI;3296994981;Ne;0;8;0;8
16613;Žiburėlis;KIŠKUČIAI;1887550130;Ne;9;2;2;13
16614;Žiburėlis;KIŠKUČIAI;6019278045;Ne;4;0;1;5
16615;Žiburėlis;KIŠKUČIAI;4079793067;Ne;8;0;0;8
16616;Žiburėlis;KIŠKUČIAI;5418413225;Ne;3;1;0;4
16617;Žiburėlis;KIŠKUČIAI;6044837042;Taip;9;0;1;10
16618;Žiburėlis;KIŠKUČIAI;1334695206;Ne;0;0;13;13
16619;Žiburėlis;KIŠKUČIAI;7597762608;Ne;7;7;0;14
16620;Žiburėlis;KIŠKUČIAI;6562748977;Ne;12;0;0;12
16621;Žiburėlis;KIŠKUČIAI;5145195661;Ne;10;6;0;16
16622;Žiburėlis;KIŠKUČIAI;4477396434;Ne;0;0;5;5
16623;Žiburėlis;KIŠKUČIAI;2712358146;Ne;15;0;0;15
16624;Žiburėlis;KIŠKUČIAI;5410394172;Ne;0;1;0;1
16625;Žiburėlis;KIŠKUČIAI;2117995780;Taip;10;0;0;10
16626;Žiburėlis;KIŠKUČIAI;4003368130;Ne;19;0;0;19
16627;Žiburėlis;KIŠKUČIAI;2456703958;Ne;7;0;0;7
16628;Žiburėlis;KIŠKUČIAI;1868558773;Taip;9;2;0;11
16629;Žiburėlis;KIŠKUČIAI;2083500905;Ne;0;2;1;3
16630;Žiburėlis;KIŠKUČIAI;6577061306;Ne;8;1;0;9
16631;Žiburėlis;DRUGELIAI;9783567484;Taip;0;7;0;7
16632;Žiburėlis;DRUGELIAI;4109288891;Taip;20;0;0;20
16633;Žiburėlis;DRUGELIAI;1015624216;Ne;0;2;0;2
16634;Žiburėlis;DRUGELIAI;9526477121;Taip;11;0;0;11
16635;Žiburėlis;DRUGELIAI;4387021429;Ne;0;3;0;3
16636;Žiburėlis;DRUGELIAI;4910787530;Ne;0;7;0;7
16637;Žiburėlis;DRUGELIAI;5324852807;Ne;2;1;0;3
16638;Žiburėlis;DRUGELIAI;4916545915;Ne;0;3;0;3
16639;Žiburėlis;DRUGELIAI;8133371774;Ne;0;7;0;7
16640;Žiburėlis;DRUGELIAI;7278242428;Taip;6;0;0;6
16641;Žiburėlis;DRUGELIAI;1833704617;Ne;0;1;0;1
16642;Žiburėlis;DRUGELIAI;1228806324;Ne;0;2;0;2
16643;Žiburėlis;DRUGELIAI;2163018032;Ne;0;4;0;4
16644;Žiburėlis;DRUGELIAI;4581800760;Ne;0;0;3;3
16645;Žiburėlis;DRUGELIAI;4168864882;Ne;9;1;0;10
16646;Justinukas;VARLIUKAI;6878000636;Ne;15;0;0;15
16647;Justinukas;VARLIUKAI;3402600460;Ne;9;0;0;9
16648;Justinukas;VARLIUKAI;6108136100;Ne;17;0;0;17
16649;Justinukas;ŽIOGELIAI;2684933301;Ne;6;0;0;6
16650;Justinukas;PELEDŽIUKŲ;2009689031;Ne;19;0;0;19
16651;Justinukas;BORUŽIUKŲ;7295085620;Ne;3;0;0;3
16652;Justinukas;BORUŽIUKŲ;8357607160;Ne;10;0;0;10
16653;Justinukas;SKRUZDĖLIUKAI;4779968906;Ne;10;0;0;10
16654;Justinukas;SKRUZDĖLIUKAI;7521830021;Ne;10;0;0;10
16655;Justinukas;SKRUZDĖLIUKAI;9460529256;Ne;12;0;0;12
16656;Justinukas;SKRUZDĖLIUKAI;7724869086;Ne;4;0;0;4
16657;Justinukas;ŽVIRBLIUKAI;3510272433;Ne;14;0;0;14
16658;Justinukas;ŽVIRBLIUKAI;7273678532;Ne;6;0;0;6
16659;Justinukas;ŽVIRBLIUKAI;9466140880;Ne;12;0;0;12
16660;Justinukas;ŽVIRBLIUKAI;3921870527;Ne;15;0;0;15
16661;Justinukas;ŽVIRBLIUKAI;5377568044;Ne;16;0;0;16
16662;Justinukas;ŽVIRBLIUKAI;7956699360;Ne;13;0;0;13
16663;Justinukas;EŽIUKAI;6184892609;Ne;5;0;0;5
16664;Justinukas;EŽIUKAI;3947021827;Ne;1;0;0;1
16665;Justinukas;EŽIUKAI;4425373579;Ne;11;0;0;11
16666;Justinukas;EŽIUKAI;9140896667;Ne;5;0;0;5
16667;Justinukas;DRUGELIAI;3013789713;Taip;3;0;0;3
16668;Justinukas;DRUGELIAI;3611504027;Taip;7;0;0;7
16669;Justinukas;BITUTĖS;9721186766;Ne;13;0;0;13
16670;Justinukas;BITUTĖS;8450280075;Ne;7;0;0;7
16671;Justinukas;BITUTĖS;9883094147;Ne;5;0;0;5
16672;Justinukas;BITUTĖS;7440371868;Ne;16;0;0;16
16673;Justinukas;VOVERIUKAI;6482808707;Ne;9;0;0;9
16674;Justinukas;VOVERIUKAI;4194429972;Ne;7;0;0;7
16675;Justinukas;VOVERIUKAI;4698732792;Ne;6;0;0;6
16676;Justinukas;KAČIUKAI;8011242863;Ne;8;0;0;8
16677;Justinukas;KAČIUKAI;2933666727;Ne;6;0;0;6
16678;Justinukas;KAČIUKAI;8592318869;Ne;5;0;0;5
16679;Justinukas;KAČIUKAI;9680924796;Ne;8;0;0;8
16680;Justinukas;ZUIKUČIAI;34905919221;Ne;3;0;0;3
16681;Bangelė;Aštuonkojai;6026399355;Ne;0;0;3;3
16682;Bangelė;Aštuonkojai;5504180016;Ne;16;0;0;16
16683;Bangelė;Aštuonkojai;5476753511;Ne;19;0;0;19
16684;Bangelė;Aštuonkojai;9168310196;Ne;4;1;0;5
16685;Bangelė;Aštuonkojai;1351714626;Ne;0;1;1;2
16686;Bangelė;Aštuonkojai;8875703109;Taip;0;1;0;1
16687;Bangelė;Aštuonkojai;3063439996;Ne;0;6;0;6
16688;Bangelė;Aštuonkojai;2156837975;Ne;0;2;0;2
16689;Bangelė;Aštuonkojai;9143945953;Ne;0;1;0;1
16690;Bangelė;Aštuonkojai;3022508446;Ne;0;0;1;1
16691;Bangelė;Aštuonkojai;5546256869;Ne;5;0;0;5
16692;Bangelė;Aštuonkojai;6980232224;Ne;3;0;0;3
16693;Bangelė;Aštuonkojai;6145050734;Ne;0;4;0;4
16694;Bangelė;Aštuonkojai;1390623903;Ne;0;5;0;5
16695;Bangelė;Aštuonkojai;9788923823;Ne;9;3;5;17
16696;Bangelė;Aštuonkojai;7136625230;Ne;0;1;0;1
16697;Bangelė;Aštuonkojai;2491928697;Ne;6;0;0;6
16698;Bangelė;Delfinukai,;3471355267;Ne;5;0;0;5
16699;Bangelė;Delfinukai,;7107685761;Ne;0;1;0;1
16700;Bangelė;Delfinukai,;6978215876;Ne;0;0;6;6
16701;Bangelė;Delfinukai,;7434358474;Ne;0;14;0;14
16702;Bangelė;Delfinukai,;2575806242;Ne;0;0;3;3
16703;Bangelė;Delfinukai,;5994720767;Ne;0;3;0;3
16704;Bangelė;Delfinukai,;4532810332;Ne;0;5;0;5
16705;Bangelė;Delfinukai,;4036461205;Ne;0;1;0;1
16706;Bangelė;Delfinukai,;3344441441;Ne;18;0;1;19
16707;Bangelė;Delfinukai,;2858929915;Ne;0;0;1;1
16708;Bangelė;Delfinukai,;7068305612;Ne;0;0;9;9
16709;Bangelė;Delfinukai,;4412780063;Taip;13;1;0;14
16710;Bangelė;Delfinukai,;9608900293;Ne;0;0;2;2
16711;Bangelė;Delfinukai,;4080993439;Ne;16;0;0;16
16712;Bangelė;Delfinukai,;6819322060;Ne;15;0;0;15
16713;Bangelė;"Saulės spindulėliai";55668308050;Ne;0;7;0;7
16714;Bangelė;"Saulės spindulėliai";9150185864;Ne;0;9;0;9
16715;Bangelė;"Saulės spindulėliai";2863118434;Ne;0;6;0;6
16716;Bangelė;"Saulės spindulėliai";9167286651;Ne;0;0;7;7
16717;Bangelė;"Saulės spindulėliai";43740476077;Ne;0;12;0;12
16718;Bangelė;"Saulės spindulėliai";9846780259;Ne;0;6;0;6
16719;Bangelė;"Saulės spindulėliai";1377734102;Ne;0;0;3;3
16720;Bangelė;"Saulės spindulėliai";5950451237;Ne;0;0;1;1
16721;Bangelė;"Saulės spindulėliai";1032881464;Ne;5;0;0;5
16722;Bangelė;"Saulės spindulėliai";9488932192;Ne;0;2;0;2
16723;Bangelė;"Saulės spindulėliai";1728085772;Ne;14;0;1;15
16724;Bangelė;"Saulės spindulėliai";1447396084;Ne;0;1;1;2
16725;Bangelė;"Saulės spindulėliai";6173470021;Ne;9;1;0;10
16726;Bangelė;"Saulės spindulėliai";6927540308;Ne;0;0;2;2
16727;Bangelė;"Saulės spindulėliai";9464115339;Ne;5;1;0;6
16728;Bangelė;"Saulės spindulėliai";3338203753;Ne;0;2;0;2
16729;Bangelė;"Saulės spindulėliai";3206495858;Ne;15;0;0;15
16730;Bangelė;"Saulės spindulėliai";7861208185;Ne;15;0;0;15
16731;Bangelė;"Saulės spindulėliai";2027892816;Ne;0;1;0;1
16732;Bangelė;"Saulės spindulėliai";2503946448;Ne;0;1;0;1
16733;Bangelė;"Saulės spindulėliai";2872188915;Ne;0;0;4;4
16734;Bangelė;"Pingvinukai ";4317054990;Ne;0;1;0;1
16735;Bangelė;"Pingvinukai ";8943721679;Ne;0;2;0;2
16736;Bangelė;"Pingvinukai ";6566277472;Ne;0;10;2;12
16737;Bangelė;"Pingvinukai ";7362196984;Ne;0;13;0;13
16738;Bangelė;"Pingvinukai ";4940247006;Ne;22;0;0;22
16739;Bangelė;"Pingvinukai ";8335931279;Ne;0;3;1;4
16740;Bangelė;"Pingvinukai ";9955097720;Ne;0;1;0;1
16741;Bangelė;"Pingvinukai ";7016039389;Ne;0;3;0;3
16742;Bangelė;"Pingvinukai ";5237434283;Ne;10;0;0;10
16743;Bangelė;"Pingvinukai ";4651237403;Ne;16;0;0;16
16744;Bangelė;"Jūros žvaigždutės ";5673493708;Ne;0;6;0;6
16745;Bangelė;"Jūros žvaigždutės ";9447145378;Ne;0;1;1;2
16746;Bangelė;"Jūros žvaigždutės ";4086446380;Ne;0;1;0;1
16747;Bangelė;"Jūros žvaigždutės ";8745595583;Ne;9;0;2;11
16748;Bangelė;"Jūros žvaigždutės ";5229147553;Ne;0;0;6;6
16749;Bangelė;"Jūros žvaigždutės ";9267349375;Taip;0;16;0;16
16750;Bangelė;"Jūros žvaigždutės ";3069288815;Ne;17;0;0;17
16751;Bangelė;"Jūros žvaigždutės ";8563674709;Ne;11;0;0;11
16752;Bangelė;"Jūros žvaigždutės ";3946690047;Ne;1;0;0;1
16753;Bangelė;"Jūros žvaigždutės ";6705583340;Ne;0;0;6;6
16754;Bangelė;"Jūros žvaigždutės ";2662758502;Taip;13;1;0;14
16755;Bangelė;"Jūros žvaigždutės ";6174617493;Ne;0;3;0;3
16756;Bangelė;"Jūros žvaigždutės ";9633372201;Ne;0;6;0;6
16757;Bangelė;"Jūros žvaigždutės ";8075810032;Ne;0;2;0;2
16758;Bangelė;"Jūros žvaigždutės ";3500097405;Taip;20;0;0;20
16759;Bangelė;"Jūros žvaigždutės ";2624013880;Ne;8;0;2;10
16760;Bangelė;Žuvytės;9009809585;Ne;0;3;0;3
16761;Bangelė;Žuvytės;6496580354;Ne;11;0;3;14
16762;Bangelė;Žuvytės;6480681705;Ne;0;2;0;2
16763;Bangelė;Žuvytės;7142694888;Ne;0;0;1;1
16764;Bangelė;Žuvytės;8734511431;Ne;0;1;0;1
16765;Bangelė;Žuvytės;1895213200;Ne;0;0;2;2
16766;Bangelė;Žuvytės;9765268154;Ne;6;8;0;14
16767;Bangelė;Žuvytės;8495423628;Ne;10;0;2;12
16768;Bangelė;Žuvytės;7419016784;Ne;0;1;5;6
16769;Bangelė;Žuvytės;3991021350;Ne;5;0;2;7
16770;Bangelė;Žuvytės;9954762483;Ne;6;3;0;9
16771;Bangelė;Žuvytės;9493465898;Ne;0;6;0;6
16772;Bangelė;Žuvytės;5597329949;Ne;7;4;0;11
16773;Bangelė;Žuvytės;2134225414;Ne;6;0;0;6
16774;Bangelė;Žuvytės;4494049529;Ne;5;2;1;8
16775;Bangelė;Žuvytės;3334029244;Ne;3;3;0;6
16776;Bangelė;Žuvytės;6165322599;Ne;0;3;0;3
16777;Bangelė;Žuvytės;3016778137;Ne;0;0;1;1
16778;Bangelė;Žuvytės;1898671487;Ne;0;0;1;1
16779;Bangelė;Žuvytės;7174742281;Ne;24;0;0;24
16780;Bangelė;Žuvytės;6806911810;Ne;1;0;5;6
16781;Bangelė;Ruoniai;8149880453;Ne;9;1;0;10
16782;Bangelė;Ruoniai;4571869439;Ne;4;3;0;7
16783;Bangelė;Ruoniai;9672505885;Ne;0;0;5;5
16784;Bangelė;Ruoniai;2017886238;Ne;0;1;0;1
16785;Bangelė;Ruoniai;8990701154;Ne;7;0;0;7
16786;Bangelė;Ruoniai;6861123988;Taip;0;2;0;2
16787;Bangelė;Ruoniai;7233139048;Taip;0;1;0;1
16788;Bangelė;Ruoniai;6044653707;Taip;0;1;0;1
16789;Bangelė;Ruoniai;1915827035;Taip;0;1;0;1
16790;Bangelė;Ruoniai;7685394517;Ne;7;0;0;7
16791;Bangelė;Ruoniai;9041585534;Taip;7;0;0;7
16792;Bangelė;Ruoniai;9706351115;Ne;0;4;0;4
16793;Bangelė;Ruoniai;2764009011;Taip;9;0;0;9
16794;Bangelė;Ruoniai;4338067260;Taip;8;0;4;12
16795;Bangelė;Ruoniai;8758933649;Ne;9;0;1;10
16796;Bangelė;Ruoniai;7230987338;Taip;0;2;1;3
16797;Bangelė;Ruoniai;1528387105;Ne;0;9;0;9
16798;Bangelė;Ruoniai;6712145066;Ne;0;0;7;7
16799;Bangelė;"Pagrandukai ";9561221619;Ne;0;8;0;8
16800;Bangelė;"Pagrandukai ";9128326823;Ne;6;0;2;8
16801;Bangelė;"Pagrandukai ";5625257865;Ne;1;0;1;2
16802;Bangelė;"Pagrandukai ";6415607960;Ne;3;0;5;8
16803;Bangelė;"Pagrandukai ";1182624046;Ne;0;7;0;7
16804;Bangelė;"Pagrandukai ";9355348960;Ne;8;0;1;9
16805;Bangelė;"Pagrandukai ";1467390411;Ne;10;0;2;12
16806;Bangelė;"Pagrandukai ";2730545639;Ne;13;0;1;14
16807;Bangelė;"Pagrandukai ";4041276015;Ne;6;0;1;7
16808;Bangelė;"Pagrandukai ";7503518328;Ne;9;0;0;9
16809;Bangelė;"Pagrandukai ";9010238689;Taip;6;0;2;8
16810;Bangelė;"Pagrandukai ";5829865386;Ne;2;0;0;2
16811;Bangelė;"Zuikučiai ";7364368699;Ne;11;0;0;11
16812;Bangelė;"Zuikučiai ";3806267811;Ne;11;0;0;11
16813;Bangelė;"Zuikučiai ";5961647252;Ne;3;2;0;5
16814;Bangelė;"Zuikučiai ";8493650050;Ne;5;4;0;9
16815;Bangelė;"Zuikučiai ";3851738513;Ne;9;0;0;9
16816;Bangelė;"Zuikučiai ";3452984649;Ne;2;15;0;17
16817;Bangelė;"Zuikučiai ";2362345363;Ne;5;0;0;5
16818;Bangelė;"Zuikučiai ";4891131242;Ne;8;0;0;8
16819;Bangelė;"Zuikučiai ";7445583512;Ne;5;2;0;7
16820;Bangelė;"Zuikučiai ";8931569423;Ne;4;0;0;4
16821;Bangelė;"Zuikučiai ";2382714949;Ne;0;0;1;1
16822;Bangelė;"Zuikučiai ";7755966282;Ne;0;0;5;5
16823;Bangelė;"Zuikučiai ";4480762963;Ne;0;0;1;1
16824;Bangelė;"Zuikučiai ";8765892966;Ne;0;2;0;2
16825;Bangelė;Vėžliukai;9142460659;Ne;0;4;0;4
16826;Bangelė;Vėžliukai;7862345122;Ne;0;0;4;4
16827;Bangelė;Vėžliukai;1869389013;Ne;20;0;0;20
16828;Bangelė;Vėžliukai;2630571748;Ne;0;6;0;6
16829;Bangelė;Vėžliukai;6003859569;Ne;0;1;0;1
16830;Bangelė;Vėžliukai;5779198855;Ne;1;0;0;1
16831;Bangelė;Vėžliukai;5746189515;Ne;0;1;0;1
16832;Bangelė;Vėžliukai;6312356331;Ne;0;0;3;3
16833;Bangelė;Vėžliukai;8454369872;Taip;0;0;1;1
16834;Gėlynas;PAKALNUTĖ;4557380282;Ne;7;4;0;11
16835;Gėlynas;PAKALNUTĖ;1548317086;Ne;14;0;0;14
16836;Gėlynas;PAKALNUTĖ;3470963396;Ne;0;1;0;1
16837;Gėlynas;PAKALNUTĖ;6053841081;Ne;0;4;0;4
16838;Gėlynas;PAKALNUTĖ;2171064300;Ne;2;0;1;3
16839;Gėlynas;PAKALNUTĖ;2404562144;Ne;0;4;0;4
16840;Gėlynas;PAKALNUTĖ;7504469409;Ne;0;3;0;3
16841;Gėlynas;PAKALNUTĖ;8693415786;Ne;0;1;0;1
16842;Gėlynas;PAKALNUTĖ;4366442459;Ne;10;0;0;10
16843;Gėlynas;PAKALNUTĖ;1463783538;Ne;0;0;2;2
16844;Gėlynas;PAKALNUTĖ;7064068912;Ne;0;10;0;10
16845;Gėlynas;PAKALNUTĖ;8555408466;Ne;5;7;0;12
16846;Gėlynas;PAKALNUTĖ;2377323648;Ne;5;0;0;5
16847;Gėlynas;PAKALNUTĖ;5382148888;Ne;7;0;0;7
16848;Gėlynas;PAKALNUTĖ;6296728638;Ne;0;2;0;2
16849;Gėlynas;PAKALNUTĖ;5826067446;Ne;7;0;0;7
16850;Gėlynas;PAKALNUTĖ;2273705177;Taip;5;0;0;5
16851;Gėlynas;PAKALNUTĖ;5350834071;Ne;0;0;8;8
16852;Gėlynas;PAKALNUTĖ;2520140743;Taip;4;0;0;4
16853;Gėlynas;VARPELIS;2769668641;Ne;0;4;0;4
16854;Gėlynas;VARPELIS;1004866224;Ne;0;3;0;3
16855;Gėlynas;VARPELIS;2417880374;Ne;0;0;2;2
16856;Gėlynas;VARPELIS;4382465307;Ne;0;9;0;9
16857;Gėlynas;VARPELIS;5135747448;Ne;0;0;5;5
16858;Gėlynas;VARPELIS;2132298690;Ne;16;0;0;16
16859;Gėlynas;VARPELIS;8464074679;Ne;3;0;4;7
16860;Gėlynas;VARPELIS;9911225363;Ne;5;0;1;6
16861;Gėlynas;VARPELIS;5395474698;Ne;0;4;0;4
16862;Gėlynas;VARPELIS;6898127005;Ne;10;0;0;10
16863;Gėlynas;VARPELIS;3365442661;Ne;0;0;7;7
16864;Gėlynas;VARPELIS;5145396320;Ne;0;8;0;8
16865;Gėlynas;VARPELIS;90046802421;Ne;0;5;0;5
16866;Gėlynas;VARPELIS;7814357385;Ne;0;2;2;4
16867;Gėlynas;VARPELIS;1674569569;Ne;0;1;0;1
16868;Gėlynas;VARPELIS;1036951275;Ne;5;0;0;5
16869;Gėlynas;VARPELIS;7808971151;Ne;0;0;5;5
16870;Gėlynas;VARPELIS;4916885450;Ne;11;0;3;14
16871;Gėlynas;RAKTAŽOLĖ;5634213306;Ne;0;0;1;1
16872;Gėlynas;RAKTAŽOLĖ;3491517766;Ne;0;2;0;2
16873;Gėlynas;RAKTAŽOLĖ;4505012978;Ne;0;3;0;3
16874;Gėlynas;RAKTAŽOLĖ;5541707540;Ne;0;0;1;1
16875;Gėlynas;RAKTAŽOLĖ;5124029118;Ne;5;1;0;6
16876;Gėlynas;RAKTAŽOLĖ;8999346908;Ne;0;3;0;3
16877;Gėlynas;RAKTAŽOLĖ;8458276300;Ne;0;1;0;1
16878;Gėlynas;RAKTAŽOLĖ;7730322729;Ne;0;4;0;4
16879;Gėlynas;RAKTAŽOLĖ;2348787949;Ne;6;0;1;7
16880;Gėlynas;RAKTAŽOLĖ;6528464599;Ne;10;6;0;16
16881;Gėlynas;RAKTAŽOLĖ;8615943743;Ne;10;1;0;11
16882;Gėlynas;RAKTAŽOLĖ;7389502638;Ne;10;2;0;12
16883;Gėlynas;RAKTAŽOLĖ;1590299264;Ne;0;1;0;1
16884;Gėlynas;RAKTAŽOLĖ;5751256561;Ne;11;0;1;12
16885;Gėlynas;RAKTAŽOLĖ;8080660097;Ne;0;5;0;5
16886;Gėlynas;RAKTAŽOLĖ;1015554617;Ne;4;0;0;4
16887;Gėlynas;RAKTAŽOLĖ;8444505017;Ne;5;1;0;6
16888;Gėlynas;SAULĖGRĄŽA;1505666690;Ne;0;0;2;2
16889;Gėlynas;SAULĖGRĄŽA;6451922757;Ne;0;0;1;1
16890;Gėlynas;SAULĖGRĄŽA;2141722631;Ne;0;5;0;5
16891;Gėlynas;SAULĖGRĄŽA;2742456983;Ne;0;0;1;1
16892;Gėlynas;SAULĖGRĄŽA;3549079170;Ne;0;12;0;12
16893;Gėlynas;SAULĖGRĄŽA;9305282699;Ne;0;1;0;1
16894;Gėlynas;SAULĖGRĄŽA;6815740588;Ne;0;0;8;8
16895;Gėlynas;SAULĖGRĄŽA;3606076029;Ne;0;7;0;7
16896;Gėlynas;SAULĖGRĄŽA;5964419627;Ne;6;0;0;6
16897;Gėlynas;SAULĖGRĄŽA;4824667762;Ne;0;2;0;2
16898;Gėlynas;SAULĖGRĄŽA;9330385153;Ne;0;4;0;4
16899;Gėlynas;SAULĖGRĄŽA;9724668402;Ne;9;1;0;10
16900;Gėlynas;SAULĖGRĄŽA;9462822190;Ne;1;0;0;1
16901;Gėlynas;SAULĖGRĄŽA;2784709117;Ne;0;0;1;1
16902;Gėlynas;SAULĖGRĄŽA;6114995335;Ne;0;0;1;1
16903;Gėlynas;SAULĖGRĄŽA;5320531856;Ne;9;1;0;10
16904;Gėlynas;SAULĖGRĄŽA;7998013477;Ne;1;0;1;2
16905;Gėlynas;SAULĖGRĄŽA;6244314445;Ne;14;2;0;16
16906;Gėlynas;RAMUNĖLĖ;1665668966;Ne;0;0;2;2
16907;Gėlynas;RAMUNĖLĖ;5813156578;Ne;4;0;0;4
16908;Gėlynas;RAMUNĖLĖ;6221721945;Ne;0;6;0;6
16909;Gėlynas;RAMUNĖLĖ;6790040590;Ne;5;0;1;6
16910;Gėlynas;RAMUNĖLĖ;4854709904;Ne;0;1;0;1
16911;Gėlynas;RAMUNĖLĖ;2434552926;Taip;11;0;3;14
16912;Gėlynas;RAMUNĖLĖ;1570975863;Ne;0;0;2;2
16913;Gėlynas;RAMUNĖLĖ;9302757372;Ne;0;16;0;16
16914;Gėlynas;RAMUNĖLĖ;8550986498;Ne;14;0;1;15
16915;Gėlynas;RAMUNĖLĖ;9973824348;Taip;0;0;7;7
16916;Gėlynas;RAMUNĖLĖ;1681208354;Ne;0;0;3;3
16917;Gėlynas;RAMUNĖLĖ;1003739544;Ne;13;0;7;20
16918;Gėlynas;ŽIBUTĖ;4192292896;Ne;0;6;0;6
16919;Gėlynas;ŽIBUTĖ;6826311903;Ne;0;1;0;1
16920;Gėlynas;ŽIBUTĖ;8447789767;Ne;9;1;0;10
16921;Gėlynas;ŽIBUTĖ;1862266440;Ne;6;0;0;6
16922;Gėlynas;ŽIBUTĖ;3746597878;Ne;0;3;0;3
16923;Gėlynas;ŽIBUTĖ;9182072776;Ne;5;0;0;5
16924;Gėlynas;ŽIBUTĖ;4292724541;Ne;6;0;0;6
16925;Gėlynas;ŽIBUTĖ;8681345327;Ne;0;1;0;1
16926;Gėlynas;ŽIBUTĖ;7988094745;Ne;0;1;0;1
16927;Gėlynas;ŽIBUTĖ;9552677108;Ne;6;1;0;7
16928;Gėlynas;ŽIBUTĖ;2608369575;Ne;6;1;0;7
16929;Gėlynas;ŽIBUTĖ;1949260962;Ne;5;0;0;5
16930;Gėlynas;ŽIBUTĖ;6635004996;Ne;10;0;0;10
16931;Gėlynas;ŽIBUTĖ;1556683639;Ne;0;3;0;3
16932;Gėlynas;ŽIBUTĖ;5942466822;Ne;11;0;2;13
16933;Gėlynas;ŽIBUTĖ;2193861056;Ne;0;0;4;4
16934;Gėlynas;ŽIBUTĖ;2790269385;Ne;9;0;0;9
16935;Obelėlė;Gudručiai;2014314139;Ne;6;0;2;8
16936;Obelėlė;Gudručiai;9900484892;Ne;7;0;0;7
16937;Obelėlė;Gudručiai;9586720282;Ne;6;0;3;9
16938;Obelėlė;Gudručiai;4015702815;Ne;0;9;0;9
16939;Obelėlė;Gudručiai;5141585309;Ne;3;0;0;3
16940;Obelėlė;Gudručiai;9736557012;Ne;5;0;1;6
16941;Obelėlė;Gudručiai;6720058972;Ne;0;0;1;1
16942;Obelėlė;Gudručiai;2053807216;Taip;11;0;0;11
16943;Obelėlė;Gudručiai;1184082097;Ne;10;0;0;10
16944;Obelėlė;Gudručiai;2533715287;Ne;0;0;1;1
16945;Obelėlė;Gudručiai;1312484983;Ne;17;0;0;17
16946;Obelėlė;Gudručiai;1565630870;Ne;0;6;0;6
16947;Obelėlė;Gudručiai;1598785483;Ne;0;1;0;1
16948;Obelėlė;Pasakaitė;1695933896;Ne;6;0;3;9
16949;Obelėlė;Pasakaitė;1555780072;Ne;10;0;0;10
16950;Obelėlė;Pasakaitė;1543298097;Ne;0;0;1;1
16951;Obelėlė;Pasakaitė;79601449969;Ne;0;0;2;2
16952;Obelėlė;Pasakaitė;4257479486;Ne;0;0;3;3
16953;Obelėlė;Pasakaitė;8394566707;Ne;9;0;0;9
16954;Obelėlė;Pasakaitė;9527363918;Ne;0;0;2;2
16955;Obelėlė;Pasakaitė;10939948244;Ne;0;1;0;1
16956;Obelėlė;Pasakaitė;6789881144;Ne;0;0;1;1
16957;Obelėlė;Pasakaitė;6036130112;Ne;0;0;3;3
16958;Obelėlė;Pasakaitė;1893470952;Ne;0;0;2;2
16959;Obelėlė;Pasakaitė;7754276632;Ne;0;20;0;20
16960;Obelėlė;Pasakaitė;69055416041;Ne;0;0;2;2
16961;Obelėlė;Pasakaitė;3517342646;Ne;0;0;4;4
16962;Obelėlė;Pasakaitė;4220808775;Ne;5;0;1;6
16963;Obelėlė;Pasakaitė;1507072248;Ne;0;0;2;2
16964;Obelėlė;Pasakaitė;7934760271;Ne;15;0;0;15
16965;Obelėlė;Svajokliai;9981446556;Ne;0;0;1;1
16966;Obelėlė;Svajokliai;4849499826;Ne;0;2;0;2
16967;Obelėlė;Svajokliai;1469593267;Ne;5;0;0;5
16968;Obelėlė;Svajokliai;9819048265;Taip;12;0;0;12
16969;Obelėlė;Svajokliai;1010954005;Ne;0;0;10;10
16970;Obelėlė;Svajokliai;4489212434;Ne;4;0;1;5
16971;Obelėlė;Svajokliai;5620250331;Ne;0;0;3;3
16972;Obelėlė;Svajokliai;5588467580;Ne;17;0;2;19
16973;Obelėlė;Svajokliai;7094715237;Ne;0;0;9;9
16974;Obelėlė;Svajokliai;7003947655;Ne;0;1;0;1
16975;Obelėlė;Svajokliai;8918176312;Ne;0;0;5;5
16976;Obelėlė;Svajokliai;7794072582;Ne;6;0;0;6
16977;Obelėlė;Svajokliai;6785654280;Ne;0;0;3;3
16978;Obelėlė;Svajokliai;2813927086;Ne;3;0;0;3
16979;Obelėlė;Smalsučiai;6497584911;Ne;11;0;2;13
16980;Obelėlė;Smalsučiai;7687093936;Ne;1;0;0;1
16981;Obelėlė;Smalsučiai;1469375976;Ne;2;0;0;2
16982;Obelėlė;Smalsučiai;7108517080;Ne;11;0;1;12
16983;Obelėlė;Smalsučiai;6008839269;Taip;1;0;0;1
16984;Obelėlė;Smalsučiai;4987747783;Ne;1;0;0;1
16985;Obelėlė;Smalsučiai;5085970254;Ne;6;0;0;6
16986;Obelėlė;Smalsučiai;8709758561;Ne;0;0;1;1
16987;Obelėlė;Smalsučiai;4318546408;Ne;4;0;0;4
16988;Obelėlė;Smalsučiai;2631405243;Ne;2;0;3;5
16989;Obelėlė;Smalsučiai;8173307704;Ne;20;0;0;20
16990;Obelėlė;Smalsučiai;9796759067;Ne;0;11;0;11
16991;Obelėlė;Smalsučiai;6720808705;Ne;3;0;0;3
16992;Obelėlė;Smalsučiai;7850656031;Ne;5;0;1;6
16993;Obelėlė;Smalsučiai;9084969712;Taip;6;0;0;6
16994;Obelėlė;Smalsučiai;6364101139;Ne;2;0;0;2
16995;Obelėlė;Smalsučiai;6064646690;Ne;0;0;4;4
16996;Obelėlė;Smalsučiai;8183287212;Ne;0;1;4;5
16997;Obelėlė;Smalsučiai;2574840626;Ne;14;0;0;14
16998;Obelėlė;Smalsučiai;8981403984;Ne;0;20;0;20
16999;Obelėlė;Pabiručiai;5763713052;Taip;0;20;0;20
17000;Obelėlė;Pabiručiai;1819480590;Ne;0;0;1;1
17001;Obelėlė;Pabiručiai;8579887226;Ne;5;0;0;5
17002;Obelėlė;Pabiručiai;6946457363;Ne;6;0;0;6
17003;Obelėlė;Pabiručiai;8948297718;Ne;0;0;1;1
17004;Obelėlė;Pabiručiai;3951816174;Ne;9;0;2;11
17005;Obelėlė;Pabiručiai;5599466885;Taip;15;0;1;16
17006;Obelėlė;Pabiručiai;9634414572;Ne;6;0;1;7
17007;Obelėlė;Pabiručiai;2262107831;Ne;0;0;5;5
17008;Obelėlė;Pabiručiai;3526079444;Ne;14;0;0;14
17009;Obelėlė;Pabiručiai;9731565368;Ne;9;0;0;9
17010;Obelėlė;Pabiručiai;8827515572;Ne;7;0;0;7
17011;Obelėlė;Pabiručiai;2399173200;Ne;4;0;0;4
17012;Obelėlė;Pabiručiai;9627134967;Ne;0;1;2;3
17013;Obelėlė;Pabiručiai;5368376431;Ne;10;0;2;12
17014;Obelėlė;Strakaliukai;1706102918;Ne;0;0;1;1
17015;Obelėlė;Strakaliukai;2770477678;Taip;10;4;0;14
17016;Obelėlė;Strakaliukai;8682794598;Ne;0;0;1;1
17017;Obelėlė;Strakaliukai;8754552660;Ne;14;0;0;14
17018;Obelėlė;Strakaliukai;9716500560;Ne;12;0;0;12
17019;Obelėlė;Strakaliukai;4251418414;Ne;2;0;0;2
17020;Obelėlė;Strakaliukai;3116100694;Ne;6;0;0;6
17021;Obelėlė;Strakaliukai;8050551266;Ne;0;14;0;14
17022;Obelėlė;Strakaliukai;7468335279;Ne;8;3;1;12
17023;Obelėlė;Strakaliukai;1180508643;Ne;0;5;0;5
17024;Obelėlė;Strakaliukai;7124393375;Ne;0;0;7;7
17025;Obelėlė;Strakaliukai;5001844064;Ne;3;0;3;6
17026;Obelėlė;Strakaliukai;9976694313;Ne;0;0;4;4
17027;Obelėlė;Saulutė;2772753891;Taip;13;0;0;13
17028;Obelėlė;Saulutė;8486560892;Ne;0;4;0;4
17029;Obelėlė;Saulutė;1858251094;Ne;5;0;4;9
17030;Obelėlė;Saulutė;2893378990;Ne;6;0;1;7
17031;Obelėlė;Saulutė;6874039388;Ne;6;0;3;9
17032;Obelėlė;Saulutė;7491934262;Ne;0;0;5;5
17033;Obelėlė;Saulutė;9043542844;Ne;0;0;2;2
17034;Obelėlė;Saulutė;4321210604;Ne;0;0;7;7
17035;Obelėlė;Saulutė;4209489251;Ne;0;0;3;3
17036;Obelėlė;Saulutė;4309622934;Ne;14;0;0;14
17037;Obelėlė;Saulutė;3590915973;Ne;0;0;2;2
17038;Obelėlė;Saulutė;6470533765;Ne;4;0;4;8
17039;Obelėlė;Saulutė;8223715886;Ne;4;0;4;8
17040;Obelėlė;Saulutė;8461505586;Ne;0;0;5;5
17041;Obelėlė;Saulutė;2730569223;Ne;1;0;0;1
17042;Obelėlė;Saulutė;4218895290;Ne;15;0;5;20
17043;Obelėlė;Rieduliukai;9008900055;Ne;16;0;0;16
17044;Obelėlė;Rieduliukai;9332534001;Ne;16;0;0;16
17045;Obelėlė;Rieduliukai;2465101384;Ne;3;0;0;3
17046;Obelėlė;Rieduliukai;7403160073;Ne;0;6;6;12
17047;Obelėlė;Rieduliukai;2663004768;Ne;9;0;3;12
17048;Obelėlė;Rieduliukai;8060994250;Ne;8;0;3;11
17049;Obelėlė;Rieduliukai;1788880520;Ne;7;0;7;14
17050;Obelėlė;Rieduliukai;3452970142;Taip;1;0;0;1
17051;Obelėlė;Rieduliukai;4505857257;Ne;0;0;2;2
17052;Obelėlė;Rieduliukai;9995891955;Ne;5;0;1;6
17053;Obelėlė;Rieduliukai;4707488292;Ne;0;20;0;20
17054;Obelėlė;Rieduliukai;5617103957;Ne;11;0;3;14
17055;Obelėlė;Rieduliukai;3646359565;Ne;12;0;5;17
17056;Obelėlė;Rieduliukai;5366112771;Ne;6;0;0;6
17057;Obelėlė;Rieduliukai;6945301927;Ne;3;0;0;3
17058;Obelėlė;Rieduliukai;2031637374;Ne;14;0;0;14
17059;Obelėlė;Žirniukai;5209482838;Ne;0;20;0;20
17060;Obelėlė;Žirniukai;5503843905;Ne;14;0;1;15
17061;Obelėlė;Žirniukai;6133596410;Ne;6;0;3;9
17062;Obelėlė;Žirniukai;2702773541;Ne;12;0;0;12
17063;Obelėlė;Žirniukai;2769784741;Ne;3;0;2;5
17064;Obelėlė;Žirniukai;8982197866;Ne;13;0;0;13
17065;Obelėlė;Žirniukai;7813350634;Ne;6;0;2;8
17066;Obelėlė;Žirniukai;3568124213;Ne;0;12;2;14
17067;Obelėlė;Žirniukai;5478392319;Ne;2;0;0;2
17068;Obelėlė;Žirniukai;4223995429;Ne;0;0;1;1
17069;Obelėlė;Žirniukai;5073364608;Ne;16;0;0;16
17070;Obelėlė;Žirniukai;3287262204;Ne;5;0;0;5
17071;Obelėlė;Žirniukai;9005520809;Ne;2;0;0;2
17072;Obelėlė;Žirniukai;5192989376;Ne;13;0;0;13
17073;Obelėlė;Žirniukai;1799603610;Ne;0;20;0;20
17074;Obelėlė;Bičiuliai;3425736276;Ne;4;0;0;4
17075;Obelėlė;Bičiuliai;5776116844;Ne;0;5;1;6
17076;Obelėlė;Bičiuliai;8487088625;Ne;0;1;0;1
17077;Obelėlė;Bičiuliai;1630067014;Ne;12;0;0;12
17078;Obelėlė;Bičiuliai;1537769810;Ne;0;0;5;5
17079;Obelėlė;Bičiuliai;8371648703;Ne;3;0;0;3
17080;Obelėlė;Bičiuliai;2329734472;Ne;0;0;1;1
17081;Obelėlė;Bičiuliai;1419189517;Ne;5;0;1;6
17082;Obelėlė;Bičiuliai;8155712451;Ne;5;0;1;6
17083;Obelėlė;Bičiuliai;4849175527;Ne;4;0;1;5
17084;Obelėlė;Bičiuliai;1362135757;Ne;5;0;1;6
17085;Obelėlė;Bičiuliai;3769993089;Ne;4;0;1;5
17086;Obelėlė;Bičiuliai;5374979248;Ne;7;0;0;7
17087;Obelėlė;Bičiuliai;1909459236;Ne;0;0;1;1
17088;Obelėlė;Bičiuliai;8757731600;Taip;0;0;8;8
17089;Obelėlė;Kodėlčiukai;9960526051;Ne;0;0;1;1
17090;Obelėlė;Kodėlčiukai;1050919659;Ne;4;0;1;5
17091;Obelėlė;Kodėlčiukai;7014872044;Ne;0;0;1;1
17092;Obelėlė;Kodėlčiukai;3028107343;Ne;8;0;1;9
17093;Obelėlė;Kodėlčiukai;4840134079;Ne;2;0;1;3
17094;Obelėlė;Kodėlčiukai;3320493372;Ne;0;0;2;2
17095;Obelėlė;Kodėlčiukai;8366162313;Ne;1;0;0;1
17096;Obelėlė;Kodėlčiukai;2227383487;Ne;6;4;0;10
17097;Obelėlė;Kodėlčiukai;8818153952;Ne;2;0;0;2
17098;Obelėlė;Kodėlčiukai;4887103549;Ne;0;0;1;1
17099;Obelėlė;Kodėlčiukai;5221918341;Taip;0;0;6;6
17100;Obelėlė;Kodėlčiukai;3748406335;Ne;5;0;0;5
17101;Obelėlė;Kodėlčiukai;7422668691;Ne;7;0;1;8
17102;Obelėlė;Kodėlčiukai;5233321854;Ne;0;0;4;4
17103;Obelėlė;Kodėlčiukai;1472630240;Ne;0;0;2;2
17104;Obelėlė;Pagrandukai;7934967787;Ne;5;0;0;5
17105;Obelėlė;Pagrandukai;4673426170;Ne;17;0;0;17
17106;Obelėlė;Pagrandukai;6436061438;Taip;6;0;2;8
17107;Obelėlė;Pagrandukai;8711370875;Ne;6;0;0;6
17108;Obelėlė;Pagrandukai;6938326798;Ne;10;0;1;11
17109;Obelėlė;Pagrandukai;9258651395;Taip;14;0;0;14
17110;Obelėlė;Pagrandukai;4974008654;Ne;0;20;0;20
17111;Obelėlė;Pagrandukai;3563701047;Ne;16;0;0;16
17112;Obelėlė;Pagrandukai;8664564820;Taip;3;0;2;5
17113;Obelėlė;Pagrandukai;9170515841;Ne;6;0;2;8
17114;Obelėlė;Pagrandukai;4930485327;Ne;1;0;0;1
17115;Obelėlė;Pagrandukai;9514739912;Ne;3;1;1;5
17116;Obelėlė;Pagrandukai;8534759650;Ne;8;0;1;9
17117;Obelėlė;Pagrandukai;7368698046;Ne;15;0;0;15
17118;Obelėlė;Pagrandukai;3738932600;Ne;8;0;2;10
17119;Spygliukas;Bitutės;8404929784;Ne;0;6;0;6
17120;Spygliukas;Bitutės;4835818382;Ne;5;1;0;6
17121;Spygliukas;Bitutės;9413950200;Ne;18;0;0;18
17122;Spygliukas;Bitutės;1664878188;Ne;10;0;0;10
17123;Spygliukas;Bitutės;5134327772;Ne;0;1;1;2
17124;Spygliukas;Bitutės;8869320003;Ne;0;1;1;2
17125;Spygliukas;Bitutės;8476882854;Ne;5;0;0;5
17126;Spygliukas;Bitutės;1333556956;Ne;0;0;2;2
17127;Spygliukas;Bitutės;3761715811;Ne;4;2;0;6
17128;Spygliukas;Bitutės;8270525839;Ne;0;1;0;1
17129;Spygliukas;Bitutės;3697691132;Ne;11;2;3;16
17130;Spygliukas;Bitutės;1550737449;Ne;5;0;2;7
17131;Spygliukas;Bitutės;2395961015;Ne;14;1;0;15
17132;Spygliukas;Bitutės;9431217584;Ne;5;5;0;10
17133;Spygliukas;Bitutės;8289288541;Ne;0;1;1;2
17134;Spygliukas;Kiškučiai;6195903792;Ne;0;0;5;5
17135;Spygliukas;Kiškučiai;1927028026;Ne;0;2;0;2
17136;Spygliukas;Kiškučiai;8981549891;Ne;3;0;3;6
17137;Spygliukas;Kiškučiai;9813995933;Taip;0;7;0;7
17138;Spygliukas;Kiškučiai;4013601534;Ne;6;0;0;6
17139;Spygliukas;Kiškučiai;3959136555;Ne;6;0;1;7
17140;Spygliukas;Kiškučiai;6383264068;Ne;5;0;0;5
17141;Spygliukas;Kiškučiai;5369930705;Ne;4;0;0;4
17142;Spygliukas;Kiškučiai;6246925536;Taip;10;1;0;11
17143;Spygliukas;Kiškučiai;1037321774;Taip;0;1;2;3
17144;Spygliukas;Kiškučiai;5615854225;Ne;0;7;0;7
17145;Spygliukas;Kiškučiai;7261580644;Ne;0;5;0;5
17146;Spygliukas;Kiškučiai;1436452804;Ne;3;1;8;12
17147;Spygliukas;Kiškučiai;1330384915;Ne;19;0;0;19
17148;Spygliukas;Kiškučiai;8299276429;Ne;5;1;0;6
17149;Spygliukas;Boružėlės;3569857813;Ne;0;0;3;3
17150;Spygliukas;Boružėlės;5493599614;Ne;2;0;1;3
17151;Spygliukas;Boružėlės;6931145017;Ne;9;0;0;9
17152;Spygliukas;Boružėlės;8802722601;Taip;0;0;1;1
17153;Spygliukas;Boružėlės;9285259322;Ne;0;4;0;4
17154;Spygliukas;Boružėlės;1341333016;Ne;0;0;20;20
17155;Spygliukas;Boružėlės;5561426508;Ne;0;9;0;9
17156;Spygliukas;Boružėlės;8806126755;Taip;0;2;0;2
17157;Spygliukas;Boružėlės;4477402331;Ne;9;0;0;9
17158;Spygliukas;Boružėlės;2772801133;Ne;2;1;1;4
17159;Spygliukas;Boružėlės;5765106914;Ne;0;0;5;5
17160;Spygliukas;Boružėlės;3416275094;Ne;0;1;7;8
17161;Spygliukas;Boružėlės;6248409896;Ne;0;1;0;1
17162;Spygliukas;Boružėlės;8708083787;Ne;5;7;0;12
17163;Spygliukas;Boružėlės;8825264090;Taip;0;0;5;5
17164;Spygliukas;Boružėlės;4577592862;Ne;0;8;0;8
17165;Spygliukas;Boružėlės;7900652746;Ne;0;4;0;4
17166;Spygliukas;Ežiukai;4340767624;Ne;0;1;2;3
17167;Spygliukas;Ežiukai;1983112873;Taip;0;1;0;1
17168;Spygliukas;Ežiukai;4615217628;Ne;6;5;0;11
17169;Spygliukas;Ežiukai;5612894706;Ne;0;1;0;1
17170;Spygliukas;Ežiukai;6552944183;Ne;10;0;1;11
17171;Spygliukas;Ežiukai;7749937772;Ne;0;10;10;20
17172;Spygliukas;Ežiukai;2719100414;Ne;1;1;0;2
17173;Spygliukas;Ežiukai;1429613380;Ne;7;0;3;10
17174;Spygliukas;Ežiukai;4026252608;Ne;5;1;4;10
17175;Spygliukas;Ežiukai;4098112375;Ne;0;0;1;1
17176;Spygliukas;Ežiukai;9321493897;Ne;0;5;1;6
17177;Spygliukas;Ežiukai;7908419787;Taip;4;0;2;6
17178;Spygliukas;Ežiukai;3088387895;Ne;0;0;1;1
17179;Spygliukas;Ežiukai;7287543571;Ne;2;0;3;5
17180;Spygliukas;Geniukai;8821434815;Ne;4;0;0;4
17181;Spygliukas;Geniukai;2713999021;Ne;11;0;0;11
17182;Spygliukas;Geniukai;5782501698;Ne;5;0;1;6
17183;Spygliukas;Geniukai;6700076900;Ne;0;0;11;11
17184;Spygliukas;Geniukai;8338260940;Ne;0;1;0;1
17185;Spygliukas;Geniukai;1863442354;Ne;0;0;3;3
17186;Spygliukas;Geniukai;1291429206;Ne;0;3;0;3
17187;Spygliukas;Geniukai;7477731865;Ne;5;0;1;6
17188;Spygliukas;Geniukai;7561072315;Ne;1;0;0;1
17189;Spygliukas;Geniukai;8093949301;Ne;6;0;0;6
17190;Spygliukas;Geniukai;9141146733;Ne;9;0;0;9
17191;Spygliukas;Geniukai;6363991196;Ne;0;6;0;6
17192;Spygliukas;Geniukai;1127941700;Ne;0;2;0;2
17193;Spygliukas;Geniukai;8581453160;Ne;0;0;2;2
17194;Spygliukas;Geniukai;7573756485;Ne;5;0;1;6
17195;Spygliukas;Geniukai;9770852356;Ne;5;0;4;9
17196;Spygliukas;Geniukai;1283097421;Ne;6;0;20;26
17197;Spygliukas;Riešutėliai;29449834997;Ne;3;0;2;5
17198;Spygliukas;Riešutėliai;47977103711;Ne;7;0;0;7
17199;Spygliukas;Riešutėliai;1855897974;Ne;6;0;0;6
17200;Spygliukas;Riešutėliai;1940209166;Ne;0;3;0;3
17201;Spygliukas;Riešutėliai;1238940921;Ne;0;2;0;2
17202;Spygliukas;Riešutėliai;9797138740;Ne;0;0;7;7
17203;Spygliukas;Riešutėliai;9001243644;Ne;20;0;0;20
17204;Spygliukas;Riešutėliai;1679263120;Ne;0;6;0;6
17205;Spygliukas;Riešutėliai;7250958367;Ne;6;0;2;8
17206;Spygliukas;Riešutėliai;9975117461;Ne;5;0;0;5
17207;Spygliukas;Riešutėliai;5022615426;Ne;0;5;3;8
17208;Spygliukas;Riešutėliai;8103481313;Ne;5;0;0;5
17209;Spygliukas;Riešutėliai;7421000718;Ne;0;0;4;4
17210;Spygliukas;Riešutėliai;2980459339;Ne;4;0;0;4
17211;Spygliukas;Pelėdžiukai;1260920726;Ne;11;0;0;11
17212;Spygliukas;Pelėdžiukai;8686118262;Ne;0;1;1;2
17213;Spygliukas;Pelėdžiukai;6242194100;Ne;2;0;0;2
17214;Spygliukas;Pelėdžiukai;8048474808;Ne;0;0;5;5
17215;Spygliukas;Pelėdžiukai;5778081118;Ne;6;0;1;7
17216;Spygliukas;Pelėdžiukai;4721066953;Ne;0;0;1;1
17217;Spygliukas;Pelėdžiukai;8331205164;Ne;5;0;1;6
17218;Spygliukas;Pelėdžiukai;4949371837;Ne;15;0;0;15
17219;Spygliukas;Pelėdžiukai;4650693672;Ne;0;0;2;2
17220;Spygliukas;Pelėdžiukai;1662885055;Ne;0;0;2;2
17221;Spygliukas;Pelėdžiukai;50047868918;Ne;6;0;0;6
17222;Spygliukas;Pelėdžiukai;6457632191;Ne;0;1;0;1
17223;Spygliukas;Pelėdžiukai;9178184431;Ne;0;0;4;4
17224;Spygliukas;Pelėdžiukai;5962360012;Ne;0;0;1;1
17225;Spygliukas;Pelėdžiukai;2739564216;Ne;8;0;0;8
17226;Spygliukas;Pelėdžiukai;4610504338;Ne;0;0;1;1
17227;Spygliukas;Pelėdžiukai;89044575245;Ne;5;5;0;10
17228;Spygliukas;Zylutės;9465470810;Ne;10;0;0;10
17229;Spygliukas;Zylutės;8366571422;Ne;0;0;1;1
17230;Spygliukas;Zylutės;4417471958;Taip;20;0;0;20
17231;Spygliukas;Zylutės;4177369871;Ne;5;0;0;5
17232;Spygliukas;Zylutės;9601530981;Ne;9;0;0;9
17233;Spygliukas;Zylutės;3066293772;Ne;10;0;1;11
17234;Spygliukas;Zylutės;3268222954;Ne;3;0;0;3
17235;Spygliukas;Zylutės;5006372835;Ne;8;0;0;8
17236;Spygliukas;Zylutės;1729199382;Taip;5;0;1;6
17237;Spygliukas;Zylutės;8408234202;Ne;0;0;1;1
17238;Spygliukas;Zylutės;3317395260;Ne;5;2;0;7
17239;Spygliukas;Zylutės;6343141973;Ne;3;1;0;4
17240;Spygliukas;Zylutės;2632672131;Ne;5;1;0;6
17241;Spygliukas;Zylutės;5638595939;Ne;13;1;0;14
17242;Spygliukas;Skruzdėliukai;8509447147;Ne;0;1;1;2
17243;Spygliukas;Skruzdėliukai;5739075961;Ne;13;0;0;13
17244;Spygliukas;Skruzdėliukai;7324915516;Ne;11;2;3;16
17245;Spygliukas;Skruzdėliukai;6414439254;Ne;11;2;3;16
17246;Spygliukas;Skruzdėliukai;7663839690;Ne;2;0;0;2
17247;Spygliukas;Skruzdėliukai;8426426785;Ne;0;1;0;1
17248;Spygliukas;Skruzdėliukai;6680699873;Ne;0;6;2;8
17249;Spygliukas;Skruzdėliukai;2955219028;Ne;0;2;2;4
17250;Spygliukas;Skruzdėliukai;1823720183;Ne;9;1;0;10
17251;Spygliukas;Skruzdėliukai;8565217488;Ne;9;0;6;15
17252;Spygliukas;Skruzdėliukai;2367685286;Ne;0;20;0;20
17253;Spygliukas;Skruzdėliukai;3065727701;Ne;6;1;0;7
17254;Spygliukas;Skruzdėliukai;1775612723;Ne;20;0;0;20
17255;Spygliukas;Skruzdėliukai;5043843336;Ne;11;0;0;11
17256;Spygliukas;Voveraitės;9112172144;Ne;2;2;1;5
17257;Spygliukas;Voveraitės;7897603878;Ne;0;2;0;2
17258;Spygliukas;Voveraitės;7741841634;Ne;0;7;0;7
17259;Spygliukas;Voveraitės;3077468722;Ne;9;0;0;9
17260;Spygliukas;Voveraitės;4948147941;Ne;2;0;0;2
17261;Spygliukas;Voveraitės;2272141731;Ne;0;0;2;2
17262;Spygliukas;Voveraitės;6587957213;Ne;0;1;1;2
17263;Spygliukas;Voveraitės;1426267001;Ne;1;0;0;1
17264;Spygliukas;Voveraitės;8189748611;Ne;0;0;2;2
17265;Spygliukas;Voveraitės;8877911083;Ne;3;0;0;3
17266;Spygliukas;Voveraitės;6405496193;Ne;0;1;6;7
17267;Spygliukas;Voveraitės;7113913750;Ne;5;0;0;5
17268;Spygliukas;Voveraitės;9231097598;Ne;0;0;4;4
17269;Spygliukas;Voveraitės;4681061579;Ne;5;0;1;6
17270;Spygliukas;Voveraitės;7313828707;Ne;1;0;0;1
17271;Spygliukas;Voveraitės;1234195733;Ne;0;2;0;2
17272;Spygliukas;Giliukų;6015646417;Taip;21;0;4;25
17273;Spygliukas;Giliukų;1761340174;Ne;5;2;0;7
17274;Spygliukas;Giliukų;4854168938;Taip;11;0;1;12
17275;Spygliukas;Giliukų;7522567241;Ne;0;1;1;2
17276;Spygliukas;Giliukų;7460280684;Ne;5;0;0;5
17277;Spygliukas;Giliukų;4429961491;Ne;3;0;1;4
17278;Spygliukas;Giliukų;8821028259;Ne;5;0;0;5
17279;Spygliukas;Giliukų;6485350404;Ne;20;0;0;20
17280;Spygliukas;Giliukų;3237501537;Ne;5;0;4;9
17281;Spygliukas;Giliukų;8722863277;Ne;5;0;2;7
17282;Spygliukas;Giliukų;9025238241;Ne;8;1;0;9
17283;Spygliukas;Giliukų;3603606800;Ne;5;2;2;9
17284;Spygliukas;Giliukų;6290439938;Ne;5;1;0;6
17285;Spygliukas;Giliukų;7776811391;Ne;5;0;0;5
17286;Spygliukas;Giliukų;3777763305;Ne;6;0;0;6
17287;Spygliukas;Giliukų;4626877679;Ne;10;1;1;12
17288;Spygliukas;Giliukų;5255993275;Taip;5;0;6;11
17289;Spygliukas;Drugeliai;7271659513;Ne;0;7;0;7
17290;Spygliukas;Drugeliai;4634660174;Ne;0;2;4;6
17291;Spygliukas;Drugeliai;4368224847;Ne;5;2;3;10
17292;Spygliukas;Drugeliai;9316731983;Ne;6;0;0;6
17293;Spygliukas;Drugeliai;6630979640;Ne;3;0;0;3
17294;Spygliukas;Drugeliai;2315421636;Ne;0;1;0;1
17295;Spygliukas;Drugeliai;7928675053;Taip;0;1;0;1
17296;Spygliukas;Drugeliai;9052337501;Ne;0;0;6;6
17297;Spygliukas;Drugeliai;4505044604;Ne;0;3;0;3
17298;Spygliukas;Drugeliai;2989701249;Ne;4;1;1;6
17299;Spygliukas;Drugeliai;9086986643;Taip;5;1;0;6
17300;Spygliukas;Drugeliai;9392554576;Ne;5;0;0;5
17301;Spygliukas;Drugeliai;8646122773;Ne;0;1;1;2
17302;Vieversys;Žirniukai;5365334453;Ne;0;0;5;5
17303;Vieversys;Žirniukai;7029322013;Ne;1;1;0;2
17304;Vieversys;Žirniukai;2266222087;Ne;11;0;0;11
17305;Vieversys;Žirniukai;2869545222;Ne;15;0;0;15
17306;Vieversys;Žirniukai;2024837493;Ne;2;0;0;2
17307;Vieversys;Žirniukai;8129566710;Ne;0;0;3;3
17308;Vieversys;Žirniukai;5576923685;Ne;4;0;0;4
17309;Vieversys;Žirniukai;3295424711;Ne;4;0;3;7
17310;Vieversys;Žirniukai;3575906273;Ne;4;0;0;4
17311;Vieversys;Žirniukai;3533711179;Taip;4;1;0;5
17312;Vieversys;Varpelių;5150986489;Ne;3;1;0;4
17313;Vieversys;Varpelių;9463693741;Ne;5;0;1;6
17314;Vieversys;Varpelių;1924774817;Taip;7;2;0;9
17315;Vieversys;Varpelių;3595005599;Ne;0;1;5;6
17316;Vieversys;Varpelių;9155896981;Ne;0;2;1;3
17317;Vieversys;Varpelių;9580031042;Ne;0;1;0;1
17318;Vieversys;Varpelių;2635722489;Ne;0;2;8;10
17319;Vieversys;Varpelių;8350070741;Ne;9;0;0;9
17320;Vieversys;Varpelių;2805682329;Ne;4;1;0;5
17321;Vieversys;Varpelių;9453100342;Ne;9;0;1;10
17322;Vieversys;Varpelių;2956566201;Ne;10;1;0;11
17323;Vieversys;Varpelių;1727558984;Ne;0;0;13;13
17324;Vieversys;Varpelių;3780226431;Ne;9;0;3;12
17325;Vieversys;Varpelių;3572628491;Ne;0;0;3;3
17326;Vieversys;Varpelių;1128991679;Taip;6;0;0;6
17327;Vieversys;Varpelių;7611047781;Ne;6;0;0;6
17328;Vieversys;Varpelių;8079885165;Ne;5;5;0;10
17329;Vieversys;Kiškučių;5922485482;Ne;0;5;0;5
17330;Vieversys;Kiškučių;3917758713;Ne;0;1;3;4
17331;Vieversys;Kiškučių;9387421639;Ne;0;0;3;3
17332;Vieversys;Kiškučių;2383765752;Ne;3;0;0;3
17333;Vieversys;Kiškučių;1247565595;Ne;5;0;0;5
17334;Vieversys;Kiškučių;53977164888;Ne;0;6;0;6
17335;Vieversys;Kiškučių;5810605263;Ne;4;0;1;5
17336;Vieversys;Kiškučių;3205204176;Ne;0;0;1;1
17337;Vieversys;Kiškučių;82594887399;Ne;3;0;3;6
17338;Vieversys;Kiškučių;6787960120;Ne;0;0;3;3
17339;Vieversys;Kiškučių;9612415733;Ne;0;1;2;3
17340;Vieversys;Kiškučių;5286521728;Ne;3;0;0;3
17341;Vieversys;Kiškučių;1149316471;Ne;0;3;0;3
17342;Vieversys;Kiškučių;7500147648;Ne;9;0;0;9
17343;Vieversys;Kiškučių;95891054066;Ne;0;1;1;2
17344;Vieversys;Kiškučių;4313822180;Ne;2;0;0;2
17345;Vieversys;Kiškučių;8038341998;Ne;0;0;1;1
17346;Vieversys;Kiškučių;6720355390;Ne;0;0;10;10
17347;Vieversys;Kiškučių;1933907389;Ne;0;0;5;5
17348;Vieversys;Pelėdžiukų;77272293257;Ne;5;0;2;7
17349;Vieversys;Pelėdžiukų;94463134058;Ne;0;3;0;3
17350;Vieversys;Pelėdžiukų;2193074123;Ne;0;0;4;4
17351;Vieversys;Pelėdžiukų;9499315463;Ne;4;0;0;4
17352;Vieversys;Pelėdžiukų;9774365819;Ne;0;0;1;1
17353;Vieversys;Pelėdžiukų;2521488728;Ne;0;4;6;10
17354;Vieversys;Pelėdžiukų;6473759470;Ne;0;1;0;1
17355;Vieversys;Pelėdžiukų;50181034746;Ne;0;0;1;1
17356;Vieversys;Pelėdžiukų;5871715452;Ne;0;0;2;2
17357;Vieversys;Pelėdžiukų;9659337657;Ne;2;1;0;3
17358;Vieversys;Pelėdžiukų;3458399180;Ne;4;0;0;4
17359;Vieversys;Pelėdžiukų;1361156816;Ne;13;0;0;13
17360;Vieversys;Pelėdžiukų;3755410640;Ne;0;3;0;3
17361;Vieversys;Saulučių;3164280186;Ne;5;0;3;8
17362;Vieversys;Saulučių;6127272124;Ne;0;0;2;2
17363;Vieversys;Saulučių;4892622551;Ne;0;0;1;1
17364;Vieversys;Saulučių;5654533451;Ne;0;0;2;2
17365;Vieversys;Saulučių;9972526744;Ne;4;0;1;5
17366;Vieversys;Saulučių;9985374057;Ne;7;0;1;8
17367;Vieversys;Saulučių;9308040716;Ne;9;0;0;9
17368;Vieversys;Saulučių;4741252829;Ne;9;0;0;9
17369;Vieversys;Saulučių;2140887757;Ne;4;0;3;7
17370;Vieversys;Saulučių;1748006118;Ne;7;0;0;7
17371;Vieversys;Saulučių;7048475906;Ne;2;0;2;4
17372;Vieversys;Saulučių;2663322242;Ne;4;0;2;6
17373;Vieversys;Saulučių;7596355010;Ne;0;0;2;2
17374;Vieversys;Saulučių;3360981720;Ne;5;0;1;6
17375;Vieversys;Saulučių;9322322737;Ne;8;0;3;11
17376;Vieversys;Kregždučių;5645852451;Ne;4;0;0;4
17377;Vieversys;Kregždučių;9088171869;Ne;1;0;9;10
17378;Vieversys;Kregždučių;7998100115;Ne;4;0;3;7
17379;Vieversys;Kregždučių;9093088054;Ne;0;1;0;1
17380;Vieversys;Kregždučių;4870401841;Ne;0;0;1;1
17381;Vieversys;Kregždučių;6808541662;Ne;5;1;0;6
17382;Vieversys;Kregždučių;7568415178;Ne;9;0;0;9
17383;Vieversys;Kregždučių;8141710663;Ne;0;0;2;2
17384;Vieversys;Kregždučių;6157594693;Ne;0;3;0;3
17385;Vieversys;Kregždučių;9090281352;Ne;5;4;0;9
17386;Vieversys;Kregždučių;4308330177;Ne;0;0;8;8
17387;Vieversys;Kregždučių;4347494053;Ne;0;5;0;5
17388;Vieversys;Kregždučių;3122763958;Ne;9;0;1;10
17389;Vieversys;Kregždučių;2938302462;Ne;0;0;3;3
17390;Vieversys;Kregždučių;9577869269;Ne;0;0;4;4
17391;Vieversys;Boružėlių;8587368497;Ne;0;0;7;7
17392;Vieversys;Boružėlių;5683183310;Ne;0;2;0;2
17393;Vieversys;Boružėlių;9884517851;Ne;4;1;0;5
17394;Vieversys;Boružėlių;7399326463;Ne;4;0;0;4
17395;Vieversys;Boružėlių;4088189914;Ne;0;0;3;3
17396;Vieversys;Boružėlių;7364582681;Ne;3;3;0;6
17397;Vieversys;Boružėlių;9826657384;Ne;6;2;2;10
17398;Vieversys;Boružėlių;3731412573;Ne;2;3;0;5
17399;Vieversys;Boružėlių;9255292099;Taip;0;2;0;2
17400;Vieversys;Boružėlių;7429565381;Ne;9;0;6;15
17401;Vieversys;Boružėlių;4297477514;Taip;7;0;1;8
17402;Vieversys;Boružėlių;8816714193;Ne;0;0;3;3
17403;Vieversys;Boružėlių;6148482625;Ne;0;11;0;11
17404;Vieversys;Boružėlių;2701284187;Ne;0;3;0;3
17405;Vieversys;Boružėlių;6234199996;Ne;19;0;0;19
17406;Vieversys;Bitučių;9268459013;Ne;0;3;3;6
17407;Vieversys;Bitučių;8706336322;Ne;0;0;1;1
17408;Vieversys;Bitučių;5966170543;Ne;0;0;1;1
17409;Vieversys;Bitučių;5210732072;Ne;9;0;1;10
17410;Vieversys;Bitučių;9188208330;Ne;0;0;3;3
17411;Vieversys;Bitučių;2072413459;Ne;4;0;6;10
17412;Vieversys;Bitučių;9454017990;Taip;0;0;20;20
17413;Vieversys;Bitučių;9476611261;Ne;20;0;0;20
17414;Vieversys;Bitučių;6083402842;Ne;0;0;1;1
17415;Vieversys;Bitučių;4428101863;Ne;2;5;0;7
17416;Vieversys;Bitučių;4335653911;Ne;0;0;1;1
17417;Vieversys;Bitučių;9978867863;Ne;0;0;5;5
17418;Vieversys;Bitučių;9092693925;Ne;1;0;1;2
17419;Vieversys;Bitučių;2661027772;Ne;1;4;0;5
17420;Vieversys;Bitučių;3601928285;Ne;0;0;2;2
17421;Vieversys;Bitučių;5479620291;Taip;5;0;11;16
17422;Vieversys;Bitučių;2931875387;Ne;6;0;0;6
17423;Vieversys;Bitučių;5417413393;Ne;0;1;3;4
17424;Vieversys;Smalsučių;3681120339;Ne;0;20;0;20
17425;Vieversys;Smalsučių;9164615794;Ne;0;3;0;3
17426;Vieversys;Smalsučių;3684937630;Ne;4;0;0;4
17427;Vieversys;Smalsučių;6563139211;Ne;0;2;1;3
17428;Vieversys;Smalsučių;4294676988;Ne;0;9;2;11
17429;Vieversys;Smalsučių;4835022593;Ne;10;0;2;12
17430;Vieversys;Smalsučių;3249717073;Ne;0;2;0;2
17431;Vieversys;Smalsučių;7120329258;Ne;0;1;0;1
17432;Vieversys;Smalsučių;8174124875;Taip;0;2;0;2
17433;Vieversys;Smalsučių;5769453869;Ne;0;3;0;3
17434;Vieversys;Smalsučių;5907903394;Ne;0;0;15;15
17435;Vieversys;Smalsučių;3946609345;Ne;0;6;6;12
17436;Vieversys;Smalsučių;8129139979;Ne;3;0;0;3
17437;Vieversys;Smalsučių;9835682858;Ne;0;15;2;17
17438;Vieversys;Smalsučių;7007620994;Ne;0;0;8;8
17439;Vieversys;Smalsučių;1757028935;Ne;0;1;2;3
17440;Vieversys;Smalsučių;4488027554;Ne;0;1;2;3
17441;Vieversys;Kodėlčiukų;9217208794;Ne;0;20;0;20
17442;Vieversys;Kodėlčiukų;5037806018;Ne;1;0;0;1
17443;Vieversys;Kodėlčiukų;1752359969;Taip;0;3;0;3
17444;Vieversys;Kodėlčiukų;6791121542;Ne;12;0;0;12
17445;Vieversys;Kodėlčiukų;5898422871;Ne;0;6;1;7
17446;Vieversys;Kodėlčiukų;7453156612;Ne;5;0;0;5
17447;Vieversys;Kodėlčiukų;6926960486;Ne;6;0;0;6
17448;Vieversys;Kodėlčiukų;3180687885;Ne;9;0;4;13
17449;Vieversys;Kodėlčiukų;1881076551;Ne;3;0;0;3
17450;Vieversys;Kodėlčiukų;1384388802;Ne;9;4;0;13
17451;Vieversys;Kodėlčiukų;2562413607;Ne;0;0;4;4
17452;Vieversys;Kodėlčiukų;9965162863;Ne;0;1;0;1
17453;Vieversys;Kodėlčiukų;4702339508;Taip;9;5;2;16
17454;Vieversys;Kodėlčiukų;4631238425;Ne;1;10;0;11
17455;Vieversys;Kodėlčiukų;8512643926;Ne;6;3;1;10
17456;Vieversys;Kodėlčiukų;7967372524;Ne;1;0;12;13
17457;Vieversys;Kodėlčiukų;4703696958;Ne;1;0;0;1
17458;Vieversys;NYKŠTUKAI;3332069842;Ne;1;0;0;1
17459;Vieversys;NYKŠTUKAI;2107000312;Ne;0;17;3;20
17460;Vieversys;NYKŠTUKAI;7539934804;Ne;5;0;0;5
17461;Vieversys;NYKŠTUKAI;1714096583;Ne;16;0;0;16
17462;Vieversys;NYKŠTUKAI;8371839883;Ne;12;0;0;12
17463;Vieversys;NYKŠTUKAI;6474334564;Ne;5;8;0;13
17464;Vieversys;NYKŠTUKAI;6631296204;Ne;11;0;0;11
17465;Vieversys;NYKŠTUKAI;2092872414;Ne;0;0;4;4
17466;Vieversys;NYKŠTUKAI;5394635510;Ne;6;0;2;8
17467;Vieversys;NYKŠTUKAI;1160455554;Ne;7;0;0;7
17468;Vieversys;NYKŠTUKAI;8200432952;Ne;5;0;5;10
17469;Vieversys;NYKŠTUKAI;2535992834;Ne;8;0;0;8
17470;Vieversys;NYKŠTUKAI;4087823915;Ne;7;0;0;7
17471;Vieversys;NYKŠTUKAI;7111551694;Ne;9;0;0;9
17472;Vieversys;NYKŠTUKAI;7778432049;Ne;0;11;0;11
17473;Vieversys;NYKŠTUKAI;4952182897;Ne;0;5;0;5
17474;Vieversys;DRUGELIAI;2638813853;Ne;0;20;0;20
17475;Vieversys;DRUGELIAI;9412299328;Ne;14;0;1;15
17476;Vieversys;DRUGELIAI;1552959751;Ne;7;0;0;7
17477;Vieversys;DRUGELIAI;6669012722;Ne;11;0;0;11
17478;Vieversys;DRUGELIAI;5384977888;Ne;0;11;0;11
17479;Vieversys;DRUGELIAI;9813883328;Ne;0;0;1;1
17480;Vieversys;DRUGELIAI;7708807923;Ne;0;1;3;4
17481;Vieversys;DRUGELIAI;5580265718;Taip;5;0;15;20
17482;Vieversys;DRUGELIAI;4129333932;Ne;0;20;0;20
17483;Vieversys;DRUGELIAI;8199984460;Ne;0;20;0;20
17484;Vieversys;DRUGELIAI;6581002790;Ne;4;0;1;5
17485;Vieversys;DRUGELIAI;9666764935;Ne;0;0;20;20
17486;Vieversys;DRUGELIAI;8966020793;Ne;19;0;1;20
17487;Vieversys;DRUGELIAI;1720061988;Taip;1;5;0;6
17488;Vieversys;DRUGELIAI;6014448044;Ne;4;7;0;11
17489;Žirmūnėliai;SAULUTĖS;5560694124;Ne;7;4;0;11
17490;Žirmūnėliai;SAULUTĖS;6116321928;Ne;14;0;0;14
17491;Žirmūnėliai;SAULUTĖS;2310523676;Ne;0;2;0;2
17492;Žirmūnėliai;SAULUTĖS;4922028935;Ne;7;0;0;7
17493;Žirmūnėliai;SAULUTĖS;1948299433;Ne;6;0;1;7
17494;Žirmūnėliai;SAULUTĖS;4763350308;Ne;7;0;0;7
17495;Žirmūnėliai;SAULUTĖS;5626711530;Ne;4;0;0;4
17496;Žirmūnėliai;SAULUTĖS;3902161368;Ne;3;2;2;7
17497;Žirmūnėliai;SAULUTĖS;4793967980;Ne;5;0;0;5
17498;Žirmūnėliai;SAULUTĖS;6177408775;Ne;5;0;0;5
17499;Žirmūnėliai;SAULUTĖS;8242112212;Ne;9;2;1;12
17500;Žirmūnėliai;SAULUTĖS;2392106040;Ne;0;6;0;6
17501;Žirmūnėliai;SAULUTĖS;4343419766;Ne;3;1;0;4
17502;Žirmūnėliai;SAULUTĖS;9145626116;Ne;15;1;9;25
17503;Žirmūnėliai;SAULUTĖS;8345632807;Ne;0;4;0;4
17504;Žirmūnėliai;SAULUTĖS;8592714547;Ne;7;2;1;10
17505;Žirmūnėliai;GILIUKAI;6430944858;Ne;0;0;2;2
17506;Žirmūnėliai;GILIUKAI;5929166560;Ne;0;1;0;1
17507;Žirmūnėliai;GILIUKAI;3767421827;Ne;0;2;0;2
17508;Žirmūnėliai;GILIUKAI;5104310002;Ne;0;2;6;8
17509;Žirmūnėliai;GILIUKAI;6899109664;Ne;0;2;1;3
17510;Žirmūnėliai;GILIUKAI;7410921362;Ne;0;3;0;3
17511;Žirmūnėliai;GILIUKAI;5089884149;Ne;4;0;1;5
17512;Žirmūnėliai;GILIUKAI;1791977446;Ne;5;1;0;6
17513;Žirmūnėliai;GILIUKAI;6875484657;Ne;0;0;5;5
17514;Žirmūnėliai;GILIUKAI;8459217612;Ne;0;0;4;4
17515;Žirmūnėliai;GILIUKAI;5486475468;Ne;0;0;1;1
17516;Žirmūnėliai;GILIUKAI;8618410295;Ne;7;1;0;8
17517;Žirmūnėliai;GILIUKAI;1941509002;Ne;0;0;11;11
17518;Žirmūnėliai;DRUGELIAI;4218266688;Ne;7;0;0;7
17519;Žirmūnėliai;DRUGELIAI;7020486370;Ne;4;0;0;4
17520;Žirmūnėliai;DRUGELIAI;5736502380;Ne;0;1;0;1
17521;Žirmūnėliai;DRUGELIAI;9378860669;Ne;5;0;0;5
17522;Žirmūnėliai;DRUGELIAI;8607934394;Ne;0;2;2;4
17523;Žirmūnėliai;DRUGELIAI;5723289396;Ne;6;0;0;6
17524;Žirmūnėliai;DRUGELIAI;7892626521;Ne;0;5;0;5
17525;Žirmūnėliai;DRUGELIAI;8999160836;Ne;1;0;0;1
17526;Žirmūnėliai;DRUGELIAI;8209309240;Ne;0;5;0;5
17527;Žirmūnėliai;DRUGELIAI;2837129621;Ne;0;2;2;4
17528;Žirmūnėliai;DRUGELIAI;1273684243;Ne;1;19;0;20
17529;Žirmūnėliai;DRUGELIAI;2971175236;Ne;14;0;0;14
17530;Žirmūnėliai;DRUGELIAI;6594728970;Ne;0;2;1;3
17531;Žirmūnėliai;DRUGELIAI;7422544482;Ne;1;1;0;2
17532;Žirmūnėliai;DRUGELIAI;4336415033;Ne;16;0;0;16
17533;Žirmūnėliai;DRUGELIAI;9241738140;Ne;4;2;0;6
17534;Žirmūnėliai;DRUGELIAI;4778339658;Ne;0;1;0;1
17535;Žirmūnėliai;BORUŽIUKAI;4796654075;Ne;0;0;3;3
17536;Žirmūnėliai;BORUŽIUKAI;1234956674;Ne;1;1;4;6
17537;Žirmūnėliai;BORUŽIUKAI;9926432375;Ne;0;3;0;3
17538;Žirmūnėliai;BORUŽIUKAI;2739395691;Ne;5;0;0;5
17539;Žirmūnėliai;BORUŽIUKAI;3351861764;Ne;0;7;0;7
17540;Žirmūnėliai;BORUŽIUKAI;5611315994;Ne;0;1;0;1
17541;Žirmūnėliai;BORUŽIUKAI;7528704460;Ne;0;1;0;1
17542;Žirmūnėliai;BORUŽIUKAI;1618573494;Ne;1;0;0;1
17543;Žirmūnėliai;BORUŽIUKAI;31403739893;Ne;2;6;0;8
17544;Žirmūnėliai;BORUŽIUKAI;6647641423;Ne;0;0;1;1
17545;Žirmūnėliai;BORUŽIUKAI;8623037038;Ne;0;0;1;1
17546;Žirmūnėliai;BORUŽIUKAI;3540307559;Ne;3;0;0;3
17547;Žirmūnėliai;BORUŽIUKAI;1885292520;Ne;0;1;0;1
17548;Žirmūnėliai;BORUŽIUKAI;1865240339;Ne;0;2;8;10
17549;Žirmūnėliai;BORUŽIUKAI;3274576752;Ne;6;0;0;6
17550;Žirmūnėliai;BORUŽIUKAI;5209700153;Ne;3;0;0;3
17551;Žirmūnėliai;BORUŽIUKAI;8339819296;Ne;0;0;1;1
17552;Žirmūnėliai;BORUŽIUKAI;2033271165;Ne;0;1;5;6
17553;Žirmūnėliai;EŽIUKAI;7011701994;Ne;0;1;0;1
17554;Žirmūnėliai;EŽIUKAI;2661052835;Ne;0;8;0;8
17555;Žirmūnėliai;EŽIUKAI;1655437833;Ne;0;0;8;8
17556;Žirmūnėliai;EŽIUKAI;3640979388;Ne;6;0;0;6
17557;Žirmūnėliai;EŽIUKAI;6878528100;Ne;0;0;10;10
17558;Žirmūnėliai;EŽIUKAI;8440187348;Ne;5;1;0;6
17559;Žirmūnėliai;EŽIUKAI;4968278870;Ne;8;0;3;11
17560;Žirmūnėliai;EŽIUKAI;2693415717;Ne;0;2;2;4
17561;Žirmūnėliai;EŽIUKAI;7953019230;Ne;0;17;0;17
17562;Žirmūnėliai;EŽIUKAI;1832367936;Ne;0;0;1;1
17563;Žirmūnėliai;EŽIUKAI;3180116136;Ne;0;2;1;3
17564;Žirmūnėliai;EŽIUKAI;9759491055;Ne;0;0;1;1
17565;Žirmūnėliai;EŽIUKAI;1127214387;Ne;0;1;2;3
17566;Žirmūnėliai;EŽIUKAI;4101748829;Ne;0;3;0;3
17567;Žirmūnėliai;EŽIUKAI;6448582622;Ne;11;5;0;16
17568;Žirmūnėliai;EŽIUKAI;4710829908;Ne;0;2;0;2
17569;Žirmūnėliai;EŽIUKAI;7996709950;Ne;3;0;0;3
17570;Žirmūnėliai;EŽIUKAI;7580002502;Ne;6;0;3;9
17571;Žirmūnėliai;EŽIUKAI;4638575301;Ne;0;0;1;1
17572;Žirmūnėliai;EŽIUKAI;3310847619;Ne;0;0;7;7
17573;Žirmūnėliai;EŽIUKAI;1977798059;Ne;0;0;21;21
17574;Žirmūnėliai;ŽVIRBLIUKAI;6896145409;Ne;2;2;3;7
17575;Žirmūnėliai;ŽVIRBLIUKAI;1255857051;Ne;0;0;3;3
17576;Žirmūnėliai;ŽVIRBLIUKAI;1347664230;Ne;0;15;3;18
17577;Žirmūnėliai;ŽVIRBLIUKAI;8030469722;Ne;6;0;0;6
17578;Žirmūnėliai;ŽVIRBLIUKAI;4517290068;Ne;0;0;1;1
17579;Žirmūnėliai;ŽVIRBLIUKAI;1582563837;Ne;0;2;2;4
17580;Žirmūnėliai;ŽVIRBLIUKAI;1381923106;Ne;0;2;0;2
17581;Žirmūnėliai;ŽVIRBLIUKAI;1725143117;Ne;0;2;5;7
17582;Žirmūnėliai;ŽVIRBLIUKAI;1478039469;Ne;5;0;1;6
17583;Žirmūnėliai;ŽVIRBLIUKAI;5037669167;Ne;6;2;1;9
17584;Žirmūnėliai;ŽVIRBLIUKAI;1073135587;Ne;0;3;0;3
17585;Žirmūnėliai;ŽVIRBLIUKAI;8308074932;Ne;1;2;0;3
17586;Žirmūnėliai;ŽVIRBLIUKAI;1761284228;Ne;0;2;1;3
17587;Žirmūnėliai;ŽVIRBLIUKAI;41018224936;Ne;0;2;1;3
17588;Žirmūnėliai;ŽVIRBLIUKAI;1894070647;Ne;0;2;2;4
17589;Žirmūnėliai;ŽVIRBLIUKAI;9482910388;Ne;0;4;0;4
17590;Žirmūnėliai;SPALVELĖS;4815427530;Ne;3;0;0;3
17591;Žirmūnėliai;SPALVELĖS;6641667315;Ne;14;1;0;15
17592;Žirmūnėliai;SPALVELĖS;2985092368;Ne;0;2;3;5
17593;Žirmūnėliai;SPALVELĖS;1401001989;Ne;0;3;9;12
17594;Žirmūnėliai;SPALVELĖS;2841958534;Ne;3;0;0;3
17595;Žirmūnėliai;SPALVELĖS;6259368139;Ne;5;0;0;5
17596;Žirmūnėliai;SPALVELĖS;1356219744;Ne;0;14;0;14
17597;Žirmūnėliai;SPALVELĖS;8538773532;Ne;6;0;0;6
17598;Žirmūnėliai;SPALVELĖS;6934204209;Ne;10;0;0;10
17599;Žirmūnėliai;SPALVELĖS;3458810185;Ne;6;3;0;9
17600;Žirmūnėliai;SPALVELĖS;9306935083;Ne;6;0;0;6
17601;Žirmūnėliai;SPALVELĖS;5316869112;Ne;0;20;0;20
17602;Žirmūnėliai;SPALVELĖS;4807331877;Ne;0;0;4;4
17603;Žirmūnėliai;SPALVELĖS;8742911909;Ne;7;4;0;11
17604;Žirmūnėliai;SPALVELĖS;6817236579;Ne;2;0;0;2
17605;Žirmūnėliai;SPALVELĖS;9042509512;Ne;19;3;0;22
17606;Žirmūnėliai;SPALVELĖS;5076712824;Ne;1;0;0;1
17607;Žirmūnėliai;SPALVELĖS;8444883234;Ne;6;0;0;6
17608;Žirmūnėliai;DEBESĖLIAI;6908512961;Ne;0;15;0;15
17609;Žirmūnėliai;DEBESĖLIAI;2866010286;Ne;0;2;1;3
17610;Žirmūnėliai;DEBESĖLIAI;3431320961;Ne;0;1;0;1
17611;Žirmūnėliai;DEBESĖLIAI;7087770068;Ne;4;1;0;5
17612;Žirmūnėliai;DEBESĖLIAI;4347548125;Ne;21;0;1;22
17613;Žirmūnėliai;DEBESĖLIAI;3330603362;Ne;14;0;4;18
17614;Žirmūnėliai;DEBESĖLIAI;5440814849;Ne;0;1;0;1
17615;Žirmūnėliai;DEBESĖLIAI;7680479258;Ne;7;0;1;8
17616;Žirmūnėliai;DEBESĖLIAI;8136265008;Ne;5;20;0;25
17617;Žirmūnėliai;DEBESĖLIAI;7568228423;Ne;6;0;2;8
17618;Žirmūnėliai;DEBESĖLIAI;9813507899;Ne;14;0;3;17
17619;Žirmūnėliai;DEBESĖLIAI;8687642039;Ne;3;0;2;5
17620;Žirmūnėliai;DEBESĖLIAI;5982848146;Ne;15;3;0;18
17621;Žirmūnėliai;DEBESĖLIAI;5676730437;Ne;7;0;1;8
17622;Žirmūnėliai;DEBESĖLIAI;4653124134;Taip;5;0;0;5
17623;Žirmūnėliai;DEBESĖLIAI;4501490189;Ne;19;0;0;19
17624;Žirmūnėliai;DEBESĖLIAI;8239982682;Taip;0;0;3;3
17625;Žirmūnėliai;VIŠČIUKAI;2270868598;Ne;4;2;0;6
17626;Žirmūnėliai;VIŠČIUKAI;2802717644;Ne;4;0;0;4
17627;Žirmūnėliai;VIŠČIUKAI;3029428022;Ne;5;0;0;5
17628;Žirmūnėliai;VIŠČIUKAI;9759504463;Ne;10;0;0;10
17629;Žirmūnėliai;VIŠČIUKAI;4134541560;Ne;13;0;0;13
17630;Žirmūnėliai;VIŠČIUKAI;8481357052;Ne;3;0;1;4
17631;Žirmūnėliai;VIŠČIUKAI;6892941066;Ne;0;2;1;3
17632;Žirmūnėliai;VIŠČIUKAI;9858198555;Ne;10;0;0;10
17633;Žirmūnėliai;VIŠČIUKAI;3641319043;Ne;15;2;0;17
17634;Žirmūnėliai;VIŠČIUKAI;6523502376;Ne;4;0;2;6
17635;Žirmūnėliai;VIŠČIUKAI;9280663182;Ne;3;6;0;9
17636;Žirmūnėliai;VIŠČIUKAI;5281338626;Ne;5;1;0;6
17637;Žirmūnėliai;VIŠČIUKAI;9688006040;Ne;20;0;0;20
17638;Žirmūnėliai;VIŠČIUKAI;5622319185;Ne;9;0;2;11
17639;Žirmūnėliai;VIŠČIUKAI;7053321410;Ne;11;0;0;11
17640;Žirmūnėliai;VIŠČIUKAI;4512970900;Ne;0;0;1;1
17641;Žirmūnėliai;ZUIKUČIŲ;4291114238;Ne;5;2;0;7
17642;Žirmūnėliai;ZUIKUČIŲ;4836165731;Ne;0;0;3;3
17643;Žirmūnėliai;ZUIKUČIŲ;3762889366;Ne;4;4;0;8
17644;Žirmūnėliai;ZUIKUČIŲ;3977279181;Ne;17;0;0;17
17645;Žirmūnėliai;ZUIKUČIŲ;8002655555;Ne;0;11;0;11
17646;Žirmūnėliai;ZUIKUČIŲ;6427861912;Ne;0;0;2;2
17647;Žirmūnėliai;ZUIKUČIŲ;2736632324;Ne;0;1;0;1
17648;Žirmūnėliai;ZUIKUČIŲ;5892153807;Taip;14;1;3;18
17649;Žirmūnėliai;ZUIKUČIŲ;2870069039;Ne;0;2;1;3
17650;Žirmūnėliai;ZUIKUČIŲ;6543834058;Ne;9;0;0;9
17651;Žirmūnėliai;ZUIKUČIŲ;8271996884;Ne;5;1;2;8
17652;Žirmūnėliai;ZUIKUČIŲ;3012945005;Ne;6;2;0;8
17653;Žirmūnėliai;ZUIKUČIŲ;8782085662;Ne;15;1;0;16
17654;Žirmūnėliai;ZUIKUČIŲ;3174613910;Ne;0;2;1;3
17655;Žirmūnėliai;ZUIKUČIŲ;5668266601;Ne;15;0;0;15
17656;Žirmūnėliai;ZUIKUČIŲ;9472372819;Ne;5;0;0;5
17657;Žirmūnėliai;ZUIKUČIŲ;6812682361;Ne;0;0;9;9
17658;Žirmūnėliai;OBUOLIUKAI;4575123456;Ne;3;2;0;5
17659;Žirmūnėliai;OBUOLIUKAI;3795476732;Ne;7;0;0;7
17660;Žirmūnėliai;OBUOLIUKAI;1917500190;Taip;4;3;0;7
17661;Žirmūnėliai;OBUOLIUKAI;9002868728;Ne;0;5;6;11
17662;Žirmūnėliai;OBUOLIUKAI;2073922023;Taip;10;0;0;10
17663;Žirmūnėliai;OBUOLIUKAI;4999561481;Ne;6;3;0;9
17664;Žirmūnėliai;OBUOLIUKAI;6358006462;Ne;7;2;0;9
17665;Žirmūnėliai;OBUOLIUKAI;2497258407;Ne;9;0;0;9
17666;Žirmūnėliai;OBUOLIUKAI;3949374730;Ne;0;4;0;4
17667;Žirmūnėliai;OBUOLIUKAI;6869102228;Ne;6;2;0;8
17668;Žirmūnėliai;OBUOLIUKAI;9367849317;Ne;3;0;0;3
17669;Žirmūnėliai;OBUOLIUKAI;9892620134;Ne;0;0;1;1
17670;Žirmūnėliai;OBUOLIUKAI;6450412481;Ne;0;6;0;6
17671;Žirmūnėliai;OBUOLIUKAI;1523231731;Ne;6;2;0;8
17672;Žirmūnėliai;OBUOLIUKAI;9225654910;Ne;0;5;0;5
17673;Žirmūnėliai;OBUOLIUKAI;5483418311;Ne;7;2;0;9
17674;Žirmūnėliai;OBUOLIUKAI;7945713337;Ne;0;1;0;1
17675;Žirmūnėliai;OBUOLIUKAI;8823426998;Ne;0;1;0;1
17676;Žirmūnėliai;OBUOLIUKAI;2263820829;Ne;9;0;0;9
17677;Žirmūnėliai;OBUOLIUKAI;9732291476;Ne;0;0;1;1
17678;Žirmūnėliai;DAINORĖLIAI;1255294064;Ne;6;2;1;9
17679;Žirmūnėliai;DAINORĖLIAI;5616289290;Ne;7;1;0;8
17680;Žirmūnėliai;DAINORĖLIAI;3520677404;Ne;0;7;0;7
17681;Žirmūnėliai;DAINORĖLIAI;9978718231;Ne;0;2;3;5
17682;Žirmūnėliai;DAINORĖLIAI;4641264260;Ne;7;2;0;9
17683;Žirmūnėliai;DAINORĖLIAI;8794707243;Ne;0;2;0;2
17684;Žirmūnėliai;DAINORĖLIAI;5646794795;Ne;0;0;2;2
17685;Žirmūnėliai;DAINORĖLIAI;5901940160;Ne;1;0;0;1
17686;Žirmūnėliai;DAINORĖLIAI;9908958250;Taip;0;0;18;18
17687;Žirmūnėliai;DAINORĖLIAI;1116572386;Ne;5;1;0;6
17688;Žirmūnėliai;DAINORĖLIAI;8615363279;Ne;0;1;0;1
17689;"Dainorėliai (Ankštoji g. 11)";VARPELIAI;87242570532;Ne;1;0;0;1
17690;"Dainorėliai (Ankštoji g. 11)";VARPELIAI;18233813290;Ne;0;1;0;1
17691;"Dainorėliai (Ankštoji g. 11)";VARPELIAI;6176171443;Ne;0;1;0;1
17692;"Dainorėliai (Ankštoji g. 11)";VARPELIAI;88781762328;Ne;0;1;0;1
17693;"Dainorėliai (Ankštoji g. 11)";VARPELIAI;5693385617;Ne;0;3;0;3
17694;"Dainorėliai (Ankštoji g. 11)";VARPELIAI;8267213392;Ne;0;1;0;1
17695;"Dainorėliai (Ankštoji g. 11)";VARPELIAI;5959380807;Ne;0;1;0;1
17696;"Dainorėliai (Ankštoji g. 11)";VARPELIAI;2938732886;Ne;0;3;0;3
17697;"Dainorėliai (Ankštoji g. 11)";VARPELIAI;3183793211;Ne;0;1;0;1
17698;"Dainorėliai (Ankštoji g. 11)";VARPELIAI;1928369859;Ne;8;0;0;8
17699;"Dainorėliai (Ankštoji g. 11)";VARPELIAI;4269946363;Ne;0;14;0;14
17700;"Dainorėliai (Ankštoji g. 11)";VARPELIAI;1088248393;Ne;0;2;4;6
17701;"Dainorėliai (Ankštoji g. 11)";VARPELIAI;2070086316;Ne;0;1;0;1
17702;"Dainorėliai (Ankštoji g. 11)";VARPELIAI;2074070030;Ne;0;5;0;5
17703;"Dainorėliai (Ankštoji g. 11)";VARPELIAI;6898685834;Ne;0;5;0;5
17704;"Dainorėliai (Ankštoji g. 11)";VARPELIAI;6909583023;Ne;0;2;1;3
17705;"Dainorėliai (Ankštoji g. 11)";VARPELIAI;9319771186;Ne;1;1;0;2
17706;"Dainorėliai (Ankštoji g. 11)";VARPELIAI;68134437706;Ne;2;0;0;2
17707;"Dainorėliai (Ankštoji g. 11)";ŽIOGELIAI;5591598390;Ne;9;0;0;9
17708;"Dainorėliai (Ankštoji g. 11)";ŽIOGELIAI;6481621329;Taip;8;1;0;9
17709;"Dainorėliai (Ankštoji g. 11)";ŽIOGELIAI;5715129088;Ne;5;0;0;5
17710;"Dainorėliai (Ankštoji g. 11)";ŽIOGELIAI;9132532505;Ne;7;0;0;7
17711;"Dainorėliai (Ankštoji g. 11)";ŽIOGELIAI;2450726148;Ne;0;10;0;10
17712;"Dainorėliai (Ankštoji g. 11)";ŽIOGELIAI;7591953671;Ne;5;0;10;15
17713;"Dainorėliai (Ankštoji g. 11)";ŽIOGELIAI;6169434322;Ne;0;2;1;3
17714;"Dainorėliai (Ankštoji g. 11)";ŽIOGELIAI;2094849111;Ne;0;3;0;3
17715;"Dainorėliai (Ankštoji g. 11)";ŽIOGELIAI;6659114730;Ne;6;0;3;9
17716;"Dainorėliai (Ankštoji g. 11)";ŽIOGELIAI;3887433142;Ne;1;1;0;2
17717;"Dainorėliai (Ankštoji g. 11)";ŽIOGELIAI;2541781620;Ne;0;8;2;10
17718;"Dainorėliai (Ankštoji g. 11)";ŽIOGELIAI;8239000041;Ne;0;6;0;6
17719;"Dainorėliai (Ankštoji g. 11)";ŽIOGELIAI;7984447187;Ne;2;0;2;4
17720;"Dainorėliai (Ankštoji g. 11)";ŽIOGELIAI;3897725337;Ne;7;0;0;7
17721;"Dainorėliai (Ankštoji g. 11)";ŽIOGELIAI;4307634491;Ne;0;2;0;2
17722;"Dainorėliai (Ankštoji g. 11)";ŽIOGELIAI;4973241539;Ne;0;0;14;14
17723;"Dainorėliai (Ankštoji g. 11)";DRUGELIAI;9592384914;Ne;0;0;1;1
17724;"Dainorėliai (Ankštoji g. 11)";DRUGELIAI;4900234806;Ne;8;0;0;8
17725;"Dainorėliai (Ankštoji g. 11)";DRUGELIAI;8962657389;Ne;0;2;0;2
17726;"Dainorėliai (Ankštoji g. 11)";DRUGELIAI;2703267758;Ne;0;1;0;1
17727;"Dainorėliai (Ankštoji g. 11)";DRUGELIAI;6899629612;Ne;0;2;0;2
17728;"Dainorėliai (Ankštoji g. 11)";DRUGELIAI;2605119306;Ne;5;2;1;8
17729;"Dainorėliai (Ankštoji g. 11)";DRUGELIAI;9976869100;Ne;0;1;0;1
17730;"Dainorėliai (Ankštoji g. 11)";DRUGELIAI;3063825996;Ne;0;2;5;7
17731;"Dainorėliai (Ankštoji g. 11)";DRUGELIAI;5854379630;Ne;0;2;3;5
17732;"Dainorėliai (Ankštoji g. 11)";DRUGELIAI;3711954197;Ne;0;1;0;1
17733;"Dainorėliai (Ankštoji g. 11)";DRUGELIAI;3741337791;Ne;6;0;0;6
17734;"Dainorėliai (Ankštoji g. 11)";DRUGELIAI;1718576253;Ne;0;1;0;1
17735;"Dainorėliai (Ankštoji g. 11)";DRUGELIAI;2803571247;Ne;0;2;4;6
17736;"Dainorėliai (Ankštoji g. 11)";DRUGELIAI;1332165159;Ne;13;2;0;15
17737;"Dainorėliai (Ankštoji g. 11)";DRUGELIAI;8684975630;Ne;5;0;4;9
17738;"Dainorėliai (Ankštoji g. 11)";DRUGELIAI;6460217912;Ne;0;2;0;2
17739;"Dainorėliai (Ankštoji g. 11)";"1 klasė";2520667095;Ne;1;0;0;1
17740;"Dainorėliai (Ankštoji g. 11)";"1 klasė";1333499160;Ne;5;0;0;5
17741;"Dainorėliai (Ankštoji g. 11)";"1 klasė";19286303769;Ne;5;0;0;5
17742;"Dainorėliai (Ankštoji g. 11)";"1 klasė";73386013083;Ne;3;0;0;3
17743;"Dainorėliai (Ankštoji g. 11)";"1 klasė";27521381629;Ne;2;0;0;2
17744;"Dainorėliai (Ankštoji g. 11)";"1 klasė";6411939690;Ne;1;0;0;1
17745;"Dainorėliai (Ankštoji g. 11)";"1 klasė";2287353933;Ne;4;0;0;4
17746;"Dainorėliai (Ankštoji g. 11)";"1 klasė";5479496104;Ne;8;0;0;8
17747;"Dainorėliai (Ankštoji g. 11)";"1 klasė";1084400276;Ne;4;0;0;4
17748;"Dainorėliai (Ankštoji g. 11)";"1 klasė";1531362555;Ne;3;0;0;3
17749;"Dainorėliai (Ankštoji g. 11)";"1 klasė";6195426672;Ne;8;0;0;8
17750;"Dainorėliai (Ankštoji g. 11)";"1 klasė";1120848949;Ne;1;0;0;1
17751;"Dainorėliai (Ankštoji g. 11)";"2 klasė";67124516230;Ne;6;0;0;6
17752;"Dainorėliai (Ankštoji g. 11)";"2 klasė";7506194777;Ne;11;0;0;11
17753;"Dainorėliai (Ankštoji g. 11)";"2 klasė";1829858221;Ne;3;0;0;3
17754;"Dainorėliai (Ankštoji g. 11)";"2 klasė";58071607976;Ne;6;0;0;6
17755;"Dainorėliai (Ankštoji g. 11)";"2 klasė";87717571411;Ne;10;0;0;10
17756;"Dainorėliai (Ankštoji g. 11)";"2 klasė";2531690903;Ne;7;0;0;7
17757;"Dainorėliai (Ankštoji g. 11)";"2 klasė";35134511946;Ne;2;0;0;2
17758;"Dainorėliai (Ankštoji g. 11)";"3 klasė";2045625141;Ne;3;0;0;3
17759;"Dainorėliai (Ankštoji g. 11)";"3 klasė";84084897419;Ne;3;0;0;3
17760;"Dainorėliai (Ankštoji g. 11)";"3 klasė";34219208558;Ne;2;0;0;2
17761;"Dainorėliai (Ankštoji g. 11)";"3 klasė";13138644060;Ne;1;0;0;1
17762;"Dainorėliai (Ankštoji g. 11)";"3 klasė";42402953271;Ne;3;0;0;3
17763;"Dainorėliai (Ankštoji g. 11)";"3 klasė";2142553899;Ne;1;0;0;1
17764;"Dainorėliai (Ankštoji g. 11)";"3 klasė";37660372564;Ne;1;0;0;1
17765;"Dainorėliai (Ankštoji g. 11)";"3 klasė";47323045857;Ne;4;0;0;4
17766;"Dainorėliai (Ankštoji g. 11)";"3 klasė";10679627657;Ne;1;0;0;1
17767;"Dainorėliai (Ankštoji g. 11)";"3 klasė";84999972369;Ne;2;0;0;2
17768;"Dainorėliai (Ankštoji g. 11)";"4 klasė";29726515194;Ne;8;0;0;8
17769;"Dainorėliai (Ankštoji g. 11)";"4 klasė";93738984644;Ne;2;0;0;2
17770;"Dainorėliai (Ankštoji g. 11)";"4 klasė";57179351170;Ne;1;0;0;1
17771;"Dainorėliai (Ankštoji g. 11)";"4 klasė";77907054102;Ne;1;0;0;1
17772;"Dainorėliai (Ankštoji g. 11)";"4 klasė";24048489264;Ne;6;0;0;6
17773;"Dainorėliai (Ankštoji g. 11)";"4 klasė";6203511535;Ne;1;0;0;1
17774;"Dainorėliai (Ankštoji g. 11)";"4 klasė";81956978417;Ne;2;0;0;2
17775;"Dainorėliai (Ankštoji g. 11)";"4 klasė";3018657993;Ne;1;0;0;1
17776;"Dainorėliai (Ankštoji g. 11)";"4 klasė";48245075123;Ne;2;0;0;2
17777;"Dainorėliai (Ankštoji g. 11)";"4 klasė";57618865048;Ne;6;0;0;6
17778;"Dainorėliai (Ankštoji g. 11)";SAULUTĖS;8857018998;Ne;6;1;0;7
17779;"Dainorėliai (Ankštoji g. 11)";SAULUTĖS;5632663846;Ne;0;15;0;15
17780;"Dainorėliai (Ankštoji g. 11)";SAULUTĖS;4307591123;Ne;0;5;0;5
17781;"Dainorėliai (Ankštoji g. 11)";SAULUTĖS;5410183494;Ne;5;0;0;5
17782;"Dainorėliai (Ankštoji g. 11)";SAULUTĖS;5587907483;Ne;9;2;2;13
17783;"Dainorėliai (Ankštoji g. 11)";SAULUTĖS;2064843848;Ne;3;2;0;5
17784;"Dainorėliai (Ankštoji g. 11)";SAULUTĖS;5687390372;Ne;0;1;0;1
17785;"Dainorėliai (Ankštoji g. 11)";SAULUTĖS;7804441689;Taip;5;0;1;6
17786;"Dainorėliai (Ankštoji g. 11)";SAULUTĖS;6090746954;Ne;10;2;0;12
17787;"Dainorėliai (Ankštoji g. 11)";SAULUTĖS;7118473669;Ne;6;1;0;7
17788;"Dainorėliai (Ankštoji g. 11)";SAULUTĖS;4431804759;Ne;0;2;0;2
17789;"Dainorėliai (Ankštoji g. 11)";SAULUTĖS;6697149560;Ne;0;2;1;3
17790;"Dainorėliai (Ankštoji g. 11)";SAULUTĖS;3762178533;Taip;0;6;0;6
17791;Lokiukas;BITUTĖS;3329205450;Ne;8;5;3;16
17792;Lokiukas;BITUTĖS;7920238202;Ne;0;9;0;9
17793;Lokiukas;BITUTĖS;1376124245;Ne;0;20;0;20
17794;Lokiukas;BITUTĖS;2181315008;Ne;0;0;2;2
17795;Lokiukas;BITUTĖS;3896883842;Ne;20;0;0;20
17796;Lokiukas;BITUTĖS;8656751314;Ne;18;0;1;19
17797;Lokiukas;BITUTĖS;4551069961;Ne;0;0;5;5
17798;Lokiukas;BITUTĖS;5794303981;Ne;1;0;7;8
17799;Lokiukas;BITUTĖS;2671053309;Taip;0;6;0;6
17800;Lokiukas;BITUTĖS;5217458476;Ne;0;0;4;4
17801;Lokiukas;BITUTĖS;6883994020;Ne;7;0;1;8
17802;Lokiukas;BITUTĖS;8209165996;Ne;0;0;2;2
17803;Lokiukas;BITUTĖS;9834746275;Ne;0;0;2;2
17804;Lokiukas;BITUTĖS;1647778939;Ne;0;0;1;1
17805;Lokiukas;BITUTĖS;6260486656;Ne;0;6;0;6
17806;Lokiukas;BITUTĖS;1987485885;Ne;0;0;1;1
17807;Lokiukas;BITUTĖS;8378138411;Taip;0;0;1;1
17808;Lokiukas;BITUTĖS;3397999534;Ne;0;19;0;19
17809;Lokiukas;BITUTĖS;8994257898;Ne;5;0;1;6
17810;Lokiukas;"1 B klasė";14605095801;Ne;6;0;0;6
17811;Lokiukas;"1 B klasė";8036643654;Ne;7;0;0;7
17812;Lokiukas;"1 B klasė";5879386524;Ne;1;0;0;1
17813;Lokiukas;"1 B klasė";9625041533;Ne;1;0;0;1
17814;Lokiukas;"1 B klasė";2476231041;Ne;1;0;0;1
17815;Lokiukas;"1 B klasė";2548712970;Ne;3;0;0;3
17816;Lokiukas;"1 B klasė";1570438208;Ne;20;0;0;20
17817;Lokiukas;"1 B klasė";2673522432;Ne;20;0;0;20
17818;Lokiukas;"1 B klasė";47399326083;Ne;11;0;0;11
17819;Lokiukas;"1 B klasė";7591418969;Ne;5;0;0;5
17820;Lokiukas;"1 B klasė";4569798381;Ne;20;0;0;20
17821;Lokiukas;"1 B klasė";8399364170;Ne;2;0;0;2
17822;Lokiukas;"1 B klasė";97284171512;Ne;4;0;0;4
17823;Lokiukas;"1 B klasė";5943583254;Ne;1;0;0;1
17824;Lokiukas;"1 B klasė";3070998871;Ne;6;0;0;6
17825;Lokiukas;"1 B klasė";5453470660;Ne;2;0;0;2
17826;Lokiukas;"1 B klasė";4427448272;Ne;20;0;0;20
17827;Lokiukas;"1 B klasė";20659573470;Ne;20;0;0;20
17828;Lokiukas;"1 B klasė";5437008837;Ne;2;0;0;2
17829;Lokiukas;"1 B klasė";4580716838;Ne;1;0;0;1
17830;Lokiukas;"1 B klasė";39975872119;Ne;1;0;0;1
17831;Lokiukas;"1 B klasė";8568285232;Ne;6;0;0;6
17832;Lokiukas;"1 B klasė";9501202273;Ne;1;0;0;1
17833;Lokiukas;"1 B klasė";8943496964;Ne;20;0;0;20
17834;Lokiukas;"1 A klasė";56069293343;Ne;4;0;0;4
17835;Lokiukas;"1 A klasė";1230490562;Ne;2;0;0;2
17836;Lokiukas;"1 A klasė";39222094073;Ne;2;0;0;2
17837;Lokiukas;"1 A klasė";1626698185;Ne;9;0;0;9
17838;Lokiukas;"1 A klasė";8270572748;Ne;1;0;0;1
17839;Lokiukas;"1 A klasė";34800098950;Ne;3;0;0;3
17840;Lokiukas;"1 A klasė";3825101647;Ne;20;0;0;20
17841;Lokiukas;"1 A klasė";8618280811;Ne;20;0;0;20
17842;Lokiukas;"1 A klasė";8323172347;Ne;3;0;0;3
17843;Lokiukas;"1 A klasė";7844351275;Ne;1;0;0;1
17844;Lokiukas;"1 A klasė";2045735700;Ne;2;0;0;2
17845;Lokiukas;"1 A klasė";43500434912;Ne;2;0;0;2
17846;Lokiukas;"1 A klasė";25141529581;Ne;1;0;0;1
17847;Lokiukas;"1 A klasė";3369746590;Ne;2;0;0;2
17848;Lokiukas;"1 A klasė";3004895246;Ne;20;0;0;20
17849;Lokiukas;GUDRUČIAI;1604886863;Ne;0;0;1;1
17850;Lokiukas;GUDRUČIAI;5446430319;Ne;0;0;2;2
17851;Lokiukas;GUDRUČIAI;5995034919;Ne;0;0;2;2
17852;Lokiukas;GUDRUČIAI;2354942164;Ne;9;2;2;13
17853;Lokiukas;GUDRUČIAI;5076773045;Ne;4;2;0;6
17854;Lokiukas;GUDRUČIAI;1620856143;Ne;0;0;1;1
17855;Lokiukas;GUDRUČIAI;1733486244;Ne;0;0;1;1
17856;Lokiukas;GUDRUČIAI;4633366779;Ne;0;0;1;1
17857;Lokiukas;GUDRUČIAI;3485639108;Ne;6;0;0;6
17858;Lokiukas;GUDRUČIAI;3991821717;Ne;5;0;0;5
17859;Lokiukas;GUDRUČIAI;1606617694;Ne;0;5;0;5
17860;Lokiukas;GUDRUČIAI;1210407640;Ne;0;0;3;3
17861;Lokiukas;BORUŽĖLĖS;2625981190;Ne;2;0;0;2
17862;Lokiukas;BORUŽĖLĖS;8576418875;Ne;5;7;0;12
17863;Lokiukas;BORUŽĖLĖS;4617372387;Ne;5;0;0;5
17864;Lokiukas;BORUŽĖLĖS;6869785650;Ne;1;2;0;3
17865;Lokiukas;BORUŽĖLĖS;8630112458;Ne;5;2;0;7
17866;Lokiukas;BORUŽĖLĖS;3930463578;Ne;0;1;2;3
17867;Lokiukas;BORUŽĖLĖS;2660616022;Ne;3;0;0;3
17868;Lokiukas;BORUŽĖLĖS;9798351980;Ne;0;0;3;3
17869;Lokiukas;BORUŽĖLĖS;5401463671;Ne;6;1;0;7
17870;Lokiukas;BORUŽĖLĖS;9996442005;Ne;10;1;0;11
17871;Lokiukas;BORUŽĖLĖS;4840187188;Ne;17;0;0;17
17872;Lokiukas;BORUŽĖLĖS;1724976098;Ne;12;5;0;17
17873;Lokiukas;BORUŽĖLĖS;7426579018;Ne;0;2;2;4
17874;Lokiukas;BORUŽĖLĖS;1974049743;Ne;6;1;1;8
17875;Lokiukas;BORUŽĖLĖS;3733581089;Ne;0;0;1;1
17876;Lokiukas;BORUŽĖLĖS;3876368364;Ne;5;1;0;6
17877;Lokiukas;BORUŽĖLĖS;9354491312;Ne;20;0;0;20
17878;Lokiukas;BORUŽĖLĖS;6091878190;Ne;6;0;0;6
17879;Lokiukas;BORUŽĖLĖS;1076719080;Ne;11;1;0;12
17880;Lokiukas;ANČIUKAI;5670185948;Ne;0;10;0;10
17881;Lokiukas;ANČIUKAI;5843699073;Ne;0;0;2;2
17882;Lokiukas;ANČIUKAI;4788062781;Ne;0;1;0;1
17883;Lokiukas;ANČIUKAI;8758248334;Ne;0;0;5;5
17884;Lokiukas;ANČIUKAI;2466354050;Taip;0;0;1;1
17885;Lokiukas;ANČIUKAI;3849212461;Ne;8;0;2;10
17886;Lokiukas;ANČIUKAI;3668903653;Ne;1;0;0;1
17887;Lokiukas;ANČIUKAI;7509043689;Ne;0;0;4;4
17888;Lokiukas;ANČIUKAI;9673257342;Ne;0;0;2;2
17889;Lokiukas;ANČIUKAI;2266747745;Ne;16;0;0;16
17890;Lokiukas;ANČIUKAI;4417116107;Ne;2;0;3;5
17891;Lokiukas;ANČIUKAI;5893844708;Ne;20;0;0;20
17892;Lokiukas;ANČIUKAI;1712365476;Ne;2;17;0;19
17893;Lokiukas;ANČIUKAI;6827710384;Ne;2;16;0;18
17894;Lokiukas;KODĖLČIUKAI;2642065594;Ne;1;2;0;3
17895;Lokiukas;KODĖLČIUKAI;6758550653;Ne;0;0;6;6
17896;Lokiukas;KODĖLČIUKAI;6336140882;Ne;13;0;2;15
17897;Lokiukas;KODĖLČIUKAI;8796640190;Ne;0;0;2;2
17898;Lokiukas;KODĖLČIUKAI;8915504279;Ne;0;5;0;5
17899;Lokiukas;KODĖLČIUKAI;4379238557;Ne;3;2;0;5
17900;Lokiukas;KODĖLČIUKAI;3694653020;Ne;2;2;1;5
17901;Lokiukas;KODĖLČIUKAI;4060641736;Ne;0;2;0;2
17902;Lokiukas;KODĖLČIUKAI;1040288021;Ne;0;0;1;1
17903;Lokiukas;KODĖLČIUKAI;34546519642;Ne;7;2;0;9
17904;Lokiukas;KODĖLČIUKAI;7943213321;Ne;0;1;0;1
17905;Lokiukas;KODĖLČIUKAI;6069516217;Ne;0;8;0;8
17906;Lokiukas;KODĖLČIUKAI;1752784666;Ne;5;0;0;5
17907;Lokiukas;KODĖLČIUKAI;5467387832;Ne;10;0;0;10
17908;Lokiukas;KODĖLČIUKAI;9307491947;Ne;13;0;0;13
17909;Lokiukas;KODĖLČIUKAI;8286358519;Ne;7;0;1;8
17910;Lokiukas;KODĖLČIUKAI;8902619265;Ne;0;0;3;3
17911;Lokiukas;DRUGELIAI;1170293017;Ne;0;8;0;8
17912;Lokiukas;DRUGELIAI;4442073527;Ne;0;1;0;1
17913;Lokiukas;DRUGELIAI;2021477393;Ne;7;0;0;7
17914;Lokiukas;DRUGELIAI;7006828256;Ne;6;0;0;6
17915;Lokiukas;DRUGELIAI;7532603655;Ne;0;5;0;5
17916;Lokiukas;DRUGELIAI;4858829710;Ne;6;3;0;9
17917;Lokiukas;DRUGELIAI;4197547631;Ne;8;2;0;10
17918;Lokiukas;DRUGELIAI;8596706753;Ne;0;2;0;2
17919;Lokiukas;DRUGELIAI;2374601283;Ne;0;0;1;1
17920;Lokiukas;DRUGELIAI;7195184433;Ne;0;2;0;2
17921;Lokiukas;DRUGELIAI;4919744559;Ne;14;4;0;18
17922;Lokiukas;DRUGELIAI;6226281752;Ne;0;2;0;2
17923;Lokiukas;DRUGELIAI;1390586527;Ne;12;0;0;12
17924;Lokiukas;DRUGELIAI;2093224908;Ne;0;3;0;3
17925;Lokiukas;DRUGELIAI;1341265560;Ne;0;5;0;5
17926;Lokiukas;DRUGELIAI;5131662172;Ne;15;2;0;17
17927;Lokiukas;DRUGELIAI;1913742619;Ne;0;1;0;1
17928;Lokiukas;DRUGELIAI;4284574166;Ne;16;1;0;17
17929;Lokiukas;"2 A klasė";67133709394;Ne;1;0;0;1
17930;Lokiukas;"2 A klasė";73696992182;Ne;8;0;0;8
17931;Lokiukas;"2 A klasė";82025637099;Ne;6;0;0;6
17932;Lokiukas;"2 A klasė";73515179103;Ne;2;0;0;2
17933;Lokiukas;"2 A klasė";36677665098;Ne;2;0;0;2
17934;Lokiukas;"2 A klasė";131300206;Ne;3;0;0;3
17935;Lokiukas;"2 A klasė";86120193313;Ne;1;0;0;1
17936;Lokiukas;"2 A klasė";83528495608;Ne;1;0;0;1
17937;Lokiukas;"2 A klasė";51237034253;Ne;1;0;0;1
17938;Lokiukas;"2 A klasė";52940830874;Ne;2;0;0;2
17939;Lokiukas;"2 A klasė";8240261104;Ne;6;0;0;6
17940;Lokiukas;"2 A klasė";83086633109;Ne;1;0;0;1
17941;Lokiukas;"2 B klasė";7235277422;Ne;2;0;0;2
17942;Lokiukas;"2 B klasė";1072148409;Ne;2;0;0;2
17943;Lokiukas;"2 B klasė";2054450461;Ne;8;0;0;8
17944;Lokiukas;"2 B klasė";3255141230;Ne;20;0;0;20
17945;Lokiukas;"2 B klasė";3255141230;Ne;20;0;0;20
17946;Lokiukas;"2 B klasė";51059574159;Ne;20;0;0;20
17947;Lokiukas;"2 B klasė";2959877846;Ne;20;0;0;20
17948;Lokiukas;"2 B klasė";6414861823;Ne;20;0;0;20
17949;Lokiukas;"2 B klasė";7130407913;Ne;20;0;0;20
17950;Lokiukas;"2 B klasė";68390568000;Ne;3;0;0;3
17951;Lokiukas;"2 B klasė";8980902068;Ne;1;0;0;1
17952;Lokiukas;"2 B klasė";4164426360;Ne;1;0;0;1
17953;Lokiukas;"2 B klasė";2078673522;Ne;1;0;0;1
17954;Lokiukas;"2 B klasė";40006848965;Ne;1;0;0;1
17955;Lokiukas;"3 A klasė";25170045140;Ne;20;0;0;20
17956;Lokiukas;"3 A klasė";15685936471;Ne;2;0;0;2
17957;Lokiukas;"3 A klasė";10948160841;Ne;20;0;0;20
17958;Lokiukas;"3 A klasė";21802863853;Ne;2;0;0;2
17959;Lokiukas;"3 A klasė";29577495646;Ne;2;0;0;2
17960;Lokiukas;"3 A klasė";22979689191;Ne;1;0;0;1
17961;Lokiukas;"3 A klasė";80754592972;Ne;1;0;0;1
17962;Lokiukas;"3 A klasė";14903100496;Ne;1;0;0;1
17963;Lokiukas;"3 A klasė";97609897018;Ne;2;0;0;2
17964;Lokiukas;"3 A klasė";4608275224;Ne;3;0;0;3
17965;Lokiukas;"3 A klasė";99706061553;Ne;5;0;0;5
17966;Lokiukas;"3 A klasė";7785940412;Ne;1;0;0;1
17967;Lokiukas;"3 A klasė";24099693663;Ne;20;0;0;20
17968;Lokiukas;"3 A klasė";35769782473;Ne;5;0;0;5
17969;Lokiukas;"3 A klasė";43070670534;Ne;4;0;0;4
17970;Lokiukas;"3 A klasė";15574258138;Ne;1;0;0;1
17971;Lokiukas;"3 A klasė";59840033826;Ne;3;0;0;3
17972;Lokiukas;"3 A klasė";24523198513;Ne;20;0;0;20
17973;Lokiukas;"3 A klasė";84273668685;Ne;1;0;0;1
17974;Lokiukas;"3 A klasė";9077016953;Ne;5;0;0;5
17975;Lokiukas;"3 A klasė";9747265775;Ne;20;0;0;20
17976;Lokiukas;"3 A klasė";5198408183;Ne;4;0;0;4
17977;Lokiukas;"3 A klasė";80793623068;Ne;2;0;0;2
17978;Lokiukas;"3 A klasė";93374754851;Ne;20;0;0;20
17979;Lokiukas;"3 B klasė";5311341721;Ne;20;0;0;20
17980;Lokiukas;"3 B klasė";61890775725;Ne;10;0;0;10
17981;Lokiukas;"3 B klasė";24221829774;Ne;6;0;0;6
17982;Lokiukas;"3 B klasė";96046361641;Ne;3;0;0;3
17983;Lokiukas;"3 B klasė";7324496782;Ne;11;0;0;11
17984;Lokiukas;"3 B klasė";95910336503;Ne;17;0;0;17
17985;Lokiukas;"3 B klasė";58513885211;Ne;5;0;0;5
17986;Lokiukas;"3 B klasė";57958699478;Ne;1;0;0;1
17987;Lokiukas;"3 B klasė";10811780420;Ne;4;0;0;4
17988;Lokiukas;"3 B klasė";18646642032;Ne;1;0;0;1
17989;Lokiukas;"3 B klasė";79109699217;Ne;2;0;0;2
17990;Lokiukas;"3 B klasė";50713289266;Ne;20;0;0;20
17991;Lokiukas;"3 B klasė";20231469825;Ne;11;0;0;11
17992;Lokiukas;"3 B klasė";18336619115;Ne;1;0;0;1
17993;Lokiukas;"3 B klasė";2105377652;Ne;4;0;0;4
17994;Lokiukas;"3 B klasė";39867459515;Ne;9;0;0;9
17995;Lokiukas;"3 B klasė";1146878499;Ne;5;0;0;5
17996;Lokiukas;"3 B klasė";62268017779;Ne;7;0;0;7
17997;Lokiukas;"3 B klasė";28796727185;Ne;20;0;0;20
17998;Lokiukas;"3 B klasė";88415635113;Ne;13;0;0;13
17999;Lokiukas;"3 B klasė";9141446821;Ne;6;0;0;6
18000;Lokiukas;"3 B klasė";7497324442;Ne;20;0;0;20
18001;Lokiukas;"3 B klasė";7903535850;Ne;4;0;0;4
18002;Lokiukas;"3 B klasė";75507005694;Ne;9;0;0;9
18003;Lokiukas;"3 B klasė";73426072972;Ne;6;0;0;6
18004;Lokiukas;"3 B klasė";59913848400;Ne;6;0;0;6
18005;Lokiukas;"3 B klasė";9516336072;Ne;7;0;0;7
18006;Lokiukas;"4 A klasė";45280536946;Ne;20;0;0;20
18007;Lokiukas;"4 A klasė";53087036306;Ne;1;0;0;1
18008;Lokiukas;"4 A klasė";79223457439;Ne;1;0;0;1
18009;Lokiukas;"4 A klasė";75613665040;Ne;8;0;0;8
18010;Lokiukas;"4 A klasė";10240586503;Ne;20;0;0;20
18011;Lokiukas;"4 A klasė";86623153797;Ne;1;0;0;1
18012;Lokiukas;"4 A klasė";43389930516;Ne;18;0;0;18
18013;Lokiukas;"4 A klasė";52296454506;Ne;1;0;0;1
18014;Lokiukas;"4 A klasė";66999644935;Ne;20;0;0;20
18015;Lokiukas;"4 A klasė";72167964645;Ne;1;0;0;1
18016;Lokiukas;"4 A klasė";2143040924;Ne;20;0;0;20
18017;Lokiukas;"4 A klasė";3206276637;Ne;20;0;0;20
18018;Lokiukas;"4 A klasė";5775631777;Ne;2;0;0;2
18019;Lokiukas;"4 A klasė";3703002168;Ne;2;0;0;2
18020;Lokiukas;"4 A klasė";38636200254;Ne;3;0;0;3
18021;Lokiukas;"4 A klasė";53544600623;Ne;1;0;0;1
18022;Lokiukas;"4 A klasė";6702448475;Ne;1;0;0;1
18023;Lokiukas;"4 A klasė";42292408557;Ne;20;0;0;20
18024;Lokiukas;"4 B klasė";35018370441;Ne;4;0;0;4
18025;Lokiukas;"4 B klasė";98289469398;Ne;3;0;0;3
18026;Lokiukas;"4 B klasė";15445053855;Ne;4;0;0;4
18027;Lokiukas;"4 B klasė";3262579895;Ne;3;0;0;3
18028;Lokiukas;"4 B klasė";51554951703;Ne;20;0;0;20
18029;Lokiukas;"4 B klasė";88947878548;Ne;1;0;0;1
18030;Lokiukas;"4 B klasė";29198900240;Ne;1;0;0;1
18031;Lokiukas;"4 B klasė";77441549037;Ne;2;0;0;2
18032;Lokiukas;"4 B klasė";79301547085;Ne;4;0;0;4
18033;Lokiukas;"4 B klasė";10897713744;Ne;1;0;0;1
18034;Lokiukas;"4 B klasė";16889795010;Ne;20;0;0;20
18035;Lokiukas;"4 B klasė";5067673212;Ne;7;0;0;7
18036;Lokiukas;"4 B klasė";1424195731;Ne;20;0;0;20
18037;Lokiukas;"4 B klasė";1104333637;Ne;10;0;0;10
18038;Lokiukas;"4 B klasė";45735190114;Ne;20;0;0;20
18039;Lokiukas;"4 B klasė";1245850082;Ne;20;0;0;20
18040;Šaltinėlis;Ančiukų;3901200729;Ne;5;0;0;5
18041;Šaltinėlis;Ančiukų;1312785137;Ne;9;3;0;12
18042;Šaltinėlis;Ančiukų;9209105445;Ne;16;1;0;17
18043;Šaltinėlis;Ančiukų;9112527921;Ne;5;0;0;5
18044;Šaltinėlis;Ančiukų;9398488555;Ne;2;0;0;2
18045;Šaltinėlis;Ančiukų;2027779524;Ne;0;5;0;5
18046;Šaltinėlis;Ančiukų;5498764523;Ne;9;0;0;9
18047;Šaltinėlis;Ančiukų;4226929875;Ne;13;4;0;17
18048;Šaltinėlis;Ančiukų;1489377928;Ne;14;4;0;18
18049;Šaltinėlis;Ančiukų;5005394548;Ne;12;4;0;16
18050;Šaltinėlis;Ančiukų;1102861619;Taip;0;2;0;2
18051;Šaltinėlis;Ančiukų;1928794692;Ne;7;2;0;9
18052;Šaltinėlis;Ančiukų;1742421427;Ne;3;4;0;7
18053;Šaltinėlis;Ančiukų;9581384663;Ne;12;0;0;12
18054;Šaltinėlis;Ančiukų;9465174636;Ne;0;8;0;8
18055;Šaltinėlis;Ančiukų;8034195267;Ne;4;2;0;6
18056;Šaltinėlis;Ančiukų;5455997139;Ne;0;6;0;6
18057;Šaltinėlis;Ančiukų;9588260206;Ne;13;2;0;15
18058;Šaltinėlis;Ančiukų;8116985061;Ne;10;0;0;10
18059;Šaltinėlis;Bitučių;9983153464;Ne;9;0;0;9
18060;Šaltinėlis;Bitučių;6487378225;Ne;0;1;0;1
18061;Šaltinėlis;Bitučių;56396772538;Ne;1;1;0;2
18062;Šaltinėlis;Bitučių;5251390843;Ne;17;0;0;17
18063;Šaltinėlis;Bitučių;8500790262;Ne;6;0;0;6
18064;Šaltinėlis;Bitučių;4332884673;Ne;0;2;0;2
18065;Šaltinėlis;Bitučių;9362495172;Ne;11;0;3;14
18066;Šaltinėlis;Bitučių;6462738640;Ne;7;0;0;7
18067;Šaltinėlis;Bitučių;7133143923;Ne;0;10;0;10
18068;Šaltinėlis;Bitučių;6887838949;Ne;23;0;0;23
18069;Šaltinėlis;Bitučių;2630875135;Ne;10;0;0;10
18070;Šaltinėlis;Bitučių;9218883174;Ne;12;0;0;12
18071;Šaltinėlis;Bitučių;2973820849;Ne;22;0;0;22
18072;Šaltinėlis;Bitučių;9820788524;Ne;0;12;0;12
18073;Šaltinėlis;Bitučių;9769491789;Ne;3;1;0;4
18074;Šaltinėlis;Bitučių;9274165569;Ne;0;5;0;5
18075;Šaltinėlis;Bitučių;3691635011;Ne;0;1;0;1
18076;Šaltinėlis;Bitučių;2084451705;Ne;2;0;0;2
18077;Šaltinėlis;Bitučių;8555517284;Ne;5;0;0;5
18078;Šaltinėlis;Bitučių;7483928256;Ne;17;0;0;17
18079;Šaltinėlis;Bitučių;2646901307;Ne;1;1;0;2
18080;Šaltinėlis;Bitučių;7737797979;Ne;2;0;0;2
18081;Šaltinėlis;Bitučių;3017437426;Ne;5;0;0;5
18082;Šaltinėlis;Saulutės;7311831014;Ne;5;4;0;9
18083;Šaltinėlis;Saulutės;5854723120;Ne;5;7;0;12
18084;Šaltinėlis;Saulutės;5833136956;Ne;0;1;0;1
18085;Šaltinėlis;Saulutės;3483756240;Ne;14;0;0;14
18086;Šaltinėlis;Saulutės;5799032398;Ne;0;5;0;5
18087;Šaltinėlis;Saulutės;5525740049;Ne;0;1;0;1
18088;Šaltinėlis;Saulutės;1978469605;Ne;0;1;0;1
18089;Šaltinėlis;Saulutės;4743907195;Ne;7;2;0;9
18090;Šaltinėlis;Saulutės;5343279219;Ne;4;1;0;5
18091;Šaltinėlis;Saulutės;7118672118;Taip;5;0;0;5
18092;Šaltinėlis;Saulutės;2465009553;Ne;5;0;0;5
18093;Šaltinėlis;Saulutės;5345738219;Ne;5;1;0;6
18094;Šaltinėlis;Saulutės;7650840990;Ne;7;2;0;9
18095;Šaltinėlis;Saulutės;3507180650;Ne;10;0;0;10
18096;Šaltinėlis;Saulutės;1678450741;Ne;5;0;0;5
18097;Šaltinėlis;Saulutės;5774391181;Ne;3;0;0;3
18098;Šaltinėlis;Saulutės;4681460322;Ne;0;9;0;9
18099;Šaltinėlis;Saulutės;3968514430;Ne;0;2;0;2
18100;Šaltinėlis;Saulutės;8950694484;Ne;0;4;0;4
18101;Šaltinėlis;Saulutės;2499890317;Ne;13;0;0;13
18102;Šaltinėlis;Saulutės;3579974049;Ne;4;3;0;7
18103;Šaltinėlis;Meškiukų;6915625306;Ne;0;2;0;2
18104;Šaltinėlis;Meškiukų;6645807642;Ne;6;2;0;8
18105;Šaltinėlis;Meškiukų;4664741207;Ne;7;2;0;9
18106;Šaltinėlis;Meškiukų;1400918201;Ne;14;0;0;14
18107;Šaltinėlis;Meškiukų;5420067622;Ne;6;2;0;8
18108;Šaltinėlis;Meškiukų;1656674673;Ne;6;6;0;12
18109;Šaltinėlis;Meškiukų;4248763165;Ne;5;3;0;8
18110;Šaltinėlis;Meškiukų;9922223978;Ne;11;0;0;11
18111;Šaltinėlis;Meškiukų;8995077908;Ne;1;5;0;6
18112;Šaltinėlis;Meškiukų;5982188743;Ne;0;2;0;2
18113;Šaltinėlis;Meškiukų;6586783795;Ne;0;2;0;2
18114;Šaltinėlis;Meškiukų;7468640592;Ne;0;3;0;3
18115;Šaltinėlis;Meškiukų;4064231806;Ne;6;1;0;7
18116;Šaltinėlis;Meškiukų;4159654434;Ne;1;0;0;1
18117;Šaltinėlis;Meškiukų;6688536661;Ne;0;2;0;2
18118;Šaltinėlis;Meškiukų;8880659539;Ne;6;5;0;11
18119;Šaltinėlis;Meškiukų;3228788999;Ne;1;1;0;2
18120;Šaltinėlis;Meškiukų;5905345563;Ne;1;1;0;2
18121;Šaltinėlis;Meškiukų;2332065937;Ne;2;2;0;4
18122;Šaltinėlis;Nykštukai;9766640995;Ne;23;0;0;23
18123;Šaltinėlis;Nykštukai;3356138058;Ne;8;0;0;8
18124;Šaltinėlis;Nykštukai;5434349511;Ne;20;0;0;20
18125;Šaltinėlis;Nykštukai;4226068669;Ne;0;2;0;2
18126;Šaltinėlis;Nykštukai;2976773344;Ne;9;0;0;9
18127;Šaltinėlis;Nykštukai;3687243030;Ne;4;3;0;7
18128;Šaltinėlis;Nykštukai;4364256563;Ne;14;0;0;14
18129;Šaltinėlis;Nykštukai;9333013048;Ne;13;0;0;13
18130;Šaltinėlis;Nykštukai;4029616063;Ne;8;1;0;9
18131;Šaltinėlis;Nykštukai;7534585887;Ne;4;0;0;4
18132;Šaltinėlis;Nykštukai;7120592596;Ne;4;0;0;4
18133;Šaltinėlis;Nykštukai;6244924079;Ne;9;3;0;12
18134;Šaltinėlis;Nykštukai;3806267811;Ne;16;0;0;16
18135;Šaltinėlis;Nykštukai;3497881408;Ne;6;4;0;10
18136;Šaltinėlis;Nykštukai;6383844995;Ne;9;0;0;9
18137;Šaltinėlis;Perliukų;2825412170;Ne;5;0;0;5
18138;Šaltinėlis;Perliukų;1686009371;Ne;11;0;1;12
18139;Šaltinėlis;Perliukų;9522524163;Taip;0;2;6;8
18140;Šaltinėlis;Perliukų;9075507649;Ne;5;9;0;14
18141;Šaltinėlis;Perliukų;7068058767;Ne;15;0;0;15
18142;Šaltinėlis;Perliukų;2189112609;Ne;17;0;0;17
18143;Šaltinėlis;Perliukų;8914777163;Ne;8;6;0;14
18144;Šaltinėlis;Perliukų;9674923143;Ne;4;3;0;7
18145;Šaltinėlis;Perliukų;1823048790;Ne;3;0;2;5
18146;Šaltinėlis;Perliukų;3073692882;Ne;0;11;0;11
18147;Šaltinėlis;Perliukų;5325974488;Ne;6;0;2;8
18148;Šaltinėlis;Perliukų;2022956307;Ne;0;4;0;4
18149;Šaltinėlis;Perliukų;2126751248;Ne;20;0;0;20
18150;Šaltinėlis;Perliukų;3271931810;Ne;11;0;1;12
18151;Šaltinėlis;Perliukų;7955094634;Ne;0;0;2;2
18152;Šaltinėlis;Perliukų;7133044918;Ne;12;0;0;12
18153;Šaltinėlis;Perliukų;2806453623;Ne;6;4;0;10
18154;Šaltinėlis;Perliukų;9691993251;Ne;0;1;0;1
18155;Šaltinėlis;Perliukų;4430546695;Ne;15;0;0;15
18156;Šaltinėlis;Perliukų;8506287076;Ne;3;0;0;3
18157;Šaltinėlis;BORUŽĖLĖS;3505001330;Ne;16;0;0;16
18158;Šaltinėlis;BORUŽĖLĖS;8973369897;Ne;10;0;0;10
18159;Šaltinėlis;BORUŽĖLĖS;3780870805;Ne;2;4;0;6
18160;Šaltinėlis;BORUŽĖLĖS;2157520281;Ne;7;2;0;9
18161;Šaltinėlis;BORUŽĖLĖS;8995954572;Ne;16;0;0;16
18162;Šaltinėlis;BORUŽĖLĖS;4742849747;Ne;9;0;0;9
18163;Šaltinėlis;BORUŽĖLĖS;5996579651;Ne;11;1;0;12
18164;Šaltinėlis;BORUŽĖLĖS;5331397179;Ne;5;2;0;7
18165;Šaltinėlis;BORUŽĖLĖS;9218436977;Ne;13;0;0;13
18166;Šaltinėlis;BORUŽĖLĖS;5593692486;Ne;6;0;0;6
18167;Šaltinėlis;BORUŽĖLĖS;1496105338;Ne;0;0;2;2
18168;Šaltinėlis;1A;3582666579;Ne;0;8;0;8
18169;Šaltinėlis;1A;46569341613;Ne;0;7;0;7
18170;Šaltinėlis;1A;52142182972;Ne;0;20;0;20
18171;Šaltinėlis;1A;6880337593;Ne;0;1;0;1
18172;Šaltinėlis;1A;9595350871;Ne;0;2;0;2
18173;Šaltinėlis;1A;8902634958;Ne;0;2;0;2
18174;Šaltinėlis;1A;9757246434;Ne;0;10;0;10
18175;Šaltinėlis;1A;1004445904;Ne;0;1;0;1
18176;Šaltinėlis;"2A klasė";32264290873;Ne;0;2;0;2
18177;Šaltinėlis;"2A klasė";1767635282;Ne;0;7;0;7
18178;Šaltinėlis;"2A klasė";1390316465;Ne;20;0;0;20
18179;Šaltinėlis;"2A klasė";3455754351;Ne;0;20;0;20
18180;Šaltinėlis;"2A klasė";66575684640;Ne;2;0;0;2
18181;Šaltinėlis;"2A klasė";86592374576;Ne;0;20;0;20
18182;Šaltinėlis;"2A klasė";1614411921;Ne;0;2;0;2
18183;Šaltinėlis;"2A klasė";79406746980;Ne;0;6;0;6
18184;Šaltinėlis;"2A klasė";3577137327;Ne;5;0;0;5
18185;Šaltinėlis;"2A klasė";48525545812;Ne;0;2;0;2
18186;Šaltinėlis;"2A klasė";1190394855;Ne;11;0;0;11
18187;Šaltinėlis;"2A klasė";40186714037;Ne;0;4;0;4
18188;Šaltinėlis;"2A klasė";1456486363;Ne;0;2;0;2
18189;Šaltinėlis;"2A klasė";32949623652;Ne;0;7;0;7
18190;Šaltinėlis;"3A klasė";80649337160;Ne;0;2;0;2
18191;Šaltinėlis;"3A klasė";92958012146;Ne;0;1;0;1
18192;Šaltinėlis;"3A klasė";84656960510;Ne;0;20;0;20
18193;Šaltinėlis;"3A klasė";83621946293;Ne;0;20;0;20
18194;Šaltinėlis;"3A klasė";67808618878;Ne;0;20;0;20
18195;Šaltinėlis;"3A klasė";9647785988;Ne;0;20;0;20
18196;Šaltinėlis;"3A klasė";54025577281;Ne;0;1;0;1
18197;Šaltinėlis;"3A klasė";29482180151;Ne;0;4;0;4
18198;Šaltinėlis;"3A klasė";54753218491;Ne;0;20;0;20
18199;Šaltinėlis;"3A klasė";86029472773;Ne;0;20;0;20
18200;Šaltinėlis;"3A klasė";64821172553;Ne;7;4;0;11
18201;Šaltinėlis;"3A klasė";5744976843;Ne;0;2;0;2
18202;Šaltinėlis;"3A klasė";25459069972;Ne;0;2;0;2
18203;Šaltinėlis;"3A klasė";6669392157;Ne;0;2;0;2
18204;Šaltinėlis;"3A klasė";89358384113;Ne;0;1;0;1
18205;Šaltinėlis;"3A klasė";28956971978;Ne;0;5;0;5
18206;Šaltinėlis;"3A klasė";4050444191;Ne;0;2;0;2
18207;Šaltinėlis;"3A klasė";89093437170;Ne;0;2;0;2
18208;Šaltinėlis;"3A klasė";51872331010;Ne;0;5;0;5
18209;Šaltinėlis;"4A klasė";83657465071;Ne;1;9;0;10
18210;Šaltinėlis;"4A klasė";9705941341;Ne;0;20;0;20
18211;Šaltinėlis;"4A klasė";38496350161;Ne;0;20;0;20
18212;Šaltinėlis;"4A klasė";62612067151;Ne;0;1;0;1
18213;Šaltinėlis;"4A klasė";96133834896;Ne;0;20;0;20
18214;Šaltinėlis;"4A klasė";73466313766;Ne;0;5;0;5
18215;Šaltinėlis;"4A klasė";2323456393;Ne;0;20;0;20
18216;Šaltinėlis;"4A klasė";47045578599;Ne;0;1;0;1
18217;Šaltinėlis;"4A klasė";36718328105;Ne;0;1;0;1
18218;Šaltinėlis;"4A klasė";86995081866;Ne;5;0;0;5
18219;Šaltinėlis;"4A klasė";29683761586;Ne;0;1;0;1
18220;Šaltinėlis;"4A klasė";9842958341;Ne;0;2;0;2
18221;Šaltinėlis;"4A klasė";40769315138;Ne;0;9;0;9
18222;Šaltinėlis;"4A klasė";66754907606;Ne;0;20;0;20
18223;Šaltinėlis;"4A klasė";6056572441;Ne;0;1;0;1
18224;Šaltinėlis;"4A klasė";9927833966;Ne;0;1;0;1
18225;Šaltinėlis;3B;83173349544;Ne;0;1;0;1
18226;Šaltinėlis;3B;39088869084;Ne;0;2;0;2
18227;Šaltinėlis;3B;1422035829;Ne;0;1;0;1
18228;Šaltinėlis;3B;7711903999;Ne;0;4;0;4
18229;Šaltinėlis;3B;3072314714;Ne;0;6;0;6
18230;Šaltinėlis;3B;1220687492;Ne;0;1;0;1
18231;Šaltinėlis;3B;74337710550;Ne;0;1;0;1
18232;Šaltinėlis;3B;35401075864;Ne;0;1;0;1
18233;Šaltinėlis;3B;19630605543;Ne;0;3;0;3
18234;Šaltinėlis;3B;3626545396;Ne;0;6;0;6
18235;Šaltinėlis;3B;6317111400;Ne;0;4;0;4
18236;Šaltinėlis;3B;4762756751;Ne;0;6;0;6
18237;Šaltinėlis;3B;72372808270;Ne;0;1;0;1
18238;Šaltinėlis;3B;1924418657;Ne;0;14;0;14
18239;Šaltinėlis;3B;81082410620;Ne;0;8;0;8
18240;Šaltinėlis;1B;84494627465;Ne;0;2;0;2
18241;Šaltinėlis;1B;2146141461;Ne;0;1;0;1
18242;Šaltinėlis;1B;6068980312;Ne;0;1;0;1
18243;Šaltinėlis;1B;9425353041;Ne;0;2;0;2
18244;Šaltinėlis;1B;17147527171;Ne;0;20;0;20
18245;Šaltinėlis;1B;1935762293;Ne;0;1;0;1
18246;Šaltinėlis;1B;1716801722;Ne;0;4;0;4
18247;Šaltinėlis;1B;2333071711;Ne;0;5;0;5
18248;Šaltinėlis;1B;52507085619;Ne;0;1;0;1
18249;Šaltinėlis;1B;526307704;Ne;0;1;0;1
18250;Šaltinėlis;1B;1958647188;Ne;0;2;0;2
18251;Šaltinėlis;1B;1583520894;Ne;0;20;0;20
18252;Šaltinėlis;1B;11083638216;Ne;0;1;0;1
18253;Šaltinėlis;PELĖDŽIUKAI;8973208195;Ne;5;0;0;5
18254;Šaltinėlis;PELĖDŽIUKAI;1367082230;Ne;0;0;1;1
18255;Šaltinėlis;PELĖDŽIUKAI;4387568448;Ne;0;1;5;6
18256;Šaltinėlis;PELĖDŽIUKAI;7723290276;Ne;0;3;0;3
18257;Šaltinėlis;PELĖDŽIUKAI;1348724947;Ne;0;20;0;20
18258;Šaltinėlis;PELĖDŽIUKAI;2658414287;Ne;5;0;0;5
18259;Šaltinėlis;PELĖDŽIUKAI;3638565578;Ne;0;1;0;1
18260;Šaltinėlis;PELĖDŽIUKAI;8721116918;Ne;3;0;0;3
18261;Šaltinėlis;PELĖDŽIUKAI;7211267255;Ne;0;0;2;2
18262;Šaltinėlis;PELĖDŽIUKAI;3660687688;Ne;0;6;0;6
18263;Šaltinėlis;PELĖDŽIUKAI;5869977541;Ne;8;0;3;11
18264;Šaltinėlis;PELĖDŽIUKAI;3609939325;Ne;2;0;0;2
18265;Šaltinėlis;PELĖDŽIUKAI;9108653045;Ne;0;6;0;6
18266;Šaltinėlis;PELĖDŽIUKAI;7918995181;Ne;4;0;1;5
18267;Šaltinėlis;PELĖDŽIUKAI;9673105905;Ne;7;0;1;8
18268;Šaltinėlis;PELĖDŽIUKAI;5099997904;Ne;0;0;1;1
18269;Gabijėlė;GANDRIUKŲ;4498088417;Ne;0;0;1;1
18270;Gabijėlė;GANDRIUKŲ;2277489032;Ne;0;0;3;3
18271;Gabijėlė;GANDRIUKŲ;8994076883;Ne;0;0;5;5
18272;Gabijėlė;GANDRIUKŲ;7087892822;Ne;11;2;0;13
18273;Gabijėlė;GANDRIUKŲ;5057272847;Ne;0;0;9;9
18274;Gabijėlė;GANDRIUKŲ;3548399391;Ne;0;0;1;1
18275;Gabijėlė;GANDRIUKŲ;3532989398;Ne;5;0;0;5
18276;Gabijėlė;GANDRIUKŲ;2215880644;Ne;9;0;2;11
18277;Gabijėlė;GANDRIUKŲ;3799003783;Ne;5;0;0;5
18278;Gabijėlė;GANDRIUKŲ;5513530983;Ne;0;1;0;1
18279;Gabijėlė;GANDRIUKŲ;9581539166;Ne;11;0;2;13
18280;Gabijėlė;GANDRIUKŲ;6004026516;Ne;0;3;0;3
18281;Gabijėlė;GANDRIUKŲ;4328252445;Ne;9;0;0;9
18282;Gabijėlė;GANDRIUKŲ;9706026832;Ne;2;3;0;5
18283;Gabijėlė;GANDRIUKŲ;2491503656;Ne;0;9;0;9
18284;Gabijėlė;GANDRIUKŲ;8904768332;Ne;8;0;0;8
18285;Gabijėlė;GANDRIUKŲ;5715645968;Ne;0;0;1;1
18286;Gabijėlė;GANDRIUKŲ;8572833698;Ne;4;0;0;4
18287;Gabijėlė;GANDRIUKŲ;8646572151;Ne;10;0;0;10
18288;Gabijėlė;GANDRIUKŲ;5054419205;Ne;0;10;0;10
18289;Gabijėlė;GANDRIUKŲ;7530976246;Ne;6;0;0;6
18290;Gabijėlė;GANDRIUKŲ;2682112101;Ne;9;0;0;9
18291;Gabijėlė;LAKŠTINGALIUKŲ;7019425859;Ne;0;0;2;2
18292;Gabijėlė;LAKŠTINGALIUKŲ;1611004144;Ne;0;0;1;1
18293;Gabijėlė;LAKŠTINGALIUKŲ;5862882027;Ne;0;0;1;1
18294;Gabijėlė;LAKŠTINGALIUKŲ;8798786098;Ne;9;0;1;10
18295;Gabijėlė;LAKŠTINGALIUKŲ;8035360208;Ne;8;8;0;16
18296;Gabijėlė;LAKŠTINGALIUKŲ;2384469423;Ne;9;0;0;9
18297;Gabijėlė;LAKŠTINGALIUKŲ;8167646385;Ne;9;0;1;10
18298;Gabijėlė;LAKŠTINGALIUKŲ;8926268619;Ne;20;0;0;20
18299;Gabijėlė;LAKŠTINGALIUKŲ;9480021589;Ne;0;2;0;2
18300;Gabijėlė;LAKŠTINGALIUKŲ;3215569531;Ne;0;3;0;3
18301;Gabijėlė;LAKŠTINGALIUKŲ;5992403900;Ne;5;0;1;6
18302;Gabijėlė;LAKŠTINGALIUKŲ;9116943443;Ne;0;0;6;6
18303;Gabijėlė;LAKŠTINGALIUKŲ;6927730664;Ne;18;0;0;18
18304;Gabijėlė;LAKŠTINGALIUKŲ;7444385669;Ne;0;0;1;1
18305;Gabijėlė;LAKŠTINGALIUKŲ;9398722388;Ne;8;1;0;9
18306;Gabijėlė;LAKŠTINGALIUKŲ;9491327802;Ne;0;0;1;1
18307;Gabijėlė;LAKŠTINGALIUKŲ;9324498850;Ne;0;1;4;5
18308;Gabijėlė;LAKŠTINGALIUKŲ;8314088016;Ne;4;1;0;5
18309;Gabijėlė;LAKŠTINGALIUKŲ;6295299651;Ne;4;1;0;5
18310;Gabijėlė;LAKŠTINGALIUKŲ;9694544564;Ne;0;0;4;4
18311;Gabijėlė;LAKŠTINGALIUKŲ;6931780900;Ne;6;3;0;9
18312;Gabijėlė;LAKŠTINGALIUKŲ;2030555139;Ne;10;2;0;12
18313;Gabijėlė;ŽVIRBLIUKŲ;7043775905;Ne;0;2;3;5
18314;Gabijėlė;ŽVIRBLIUKŲ;4475530177;Ne;4;0;0;4
18315;Gabijėlė;ŽVIRBLIUKŲ;5743861607;Ne;0;0;9;9
18316;Gabijėlė;ŽVIRBLIUKŲ;7410541320;Ne;0;5;0;5
18317;Gabijėlė;ŽVIRBLIUKŲ;4493192224;Ne;6;0;1;7
18318;Gabijėlė;ŽVIRBLIUKŲ;3268231136;Ne;0;7;0;7
18319;Gabijėlė;ŽVIRBLIUKŲ;5332825339;Ne;0;0;1;1
18320;Gabijėlė;ŽVIRBLIUKŲ;2264669298;Ne;0;1;0;1
18321;Gabijėlė;ŽVIRBLIUKŲ;5942625633;Ne;6;0;1;7
18322;Gabijėlė;ŽVIRBLIUKŲ;3155403180;Ne;0;0;3;3
18323;Gabijėlė;ŽVIRBLIUKŲ;1158461185;Ne;0;0;3;3
18324;Gabijėlė;ŽVIRBLIUKŲ;3218415151;Ne;1;0;2;3
18325;Gabijėlė;ŽVIRBLIUKŲ;8823299212;Ne;0;0;1;1
18326;Gabijėlė;ŽVIRBLIUKŲ;8879972953;Ne;4;5;0;9
18327;Gabijėlė;ŽVIRBLIUKŲ;9627906252;Ne;4;0;4;8
18328;Gabijėlė;ŽVIRBLIUKŲ;1725665169;Ne;4;0;0;4
18329;Gabijėlė;ŽVIRBLIUKŲ;6674038058;Ne;5;0;0;5
18330;Gabijėlė;ŽVIRBLIUKŲ;4146051969;Ne;0;0;2;2
18331;Gabijėlė;ŽVIRBLIUKŲ;6604681536;Ne;0;0;2;2
18332;Gabijėlė;ŽVIRBLIUKŲ;1273722177;Ne;9;0;1;10
18333;Gabijėlė;ŽVIRBLIUKŲ;6310234092;Ne;8;0;0;8
18334;Gabijėlė;ŽVIRBLIUKŲ;8384795164;Ne;2;0;5;7
18335;Gabijėlė;ŽVIRBLIUKŲ;3209491491;Ne;6;3;0;9
18336;Gabijėlė;GENIUKŲ;3445433386;Ne;0;8;0;8
18337;Gabijėlė;GENIUKŲ;7312628876;Ne;0;7;0;7
18338;Gabijėlė;GENIUKŲ;1581688238;Ne;0;0;1;1
18339;Gabijėlė;GENIUKŲ;3176075887;Ne;0;8;0;8
18340;Gabijėlė;GENIUKŲ;9972967198;Ne;0;1;0;1
18341;Gabijėlė;GENIUKŲ;1589534853;Ne;0;1;0;1
18342;Gabijėlė;GENIUKŲ;6482824000;Ne;0;12;0;12
18343;Gabijėlė;GENIUKŲ;5962852108;Ne;5;0;2;7
18344;Gabijėlė;GENIUKŲ;7178676049;Ne;0;6;0;6
18345;Gabijėlė;GENIUKŲ;1974388885;Ne;0;4;0;4
18346;Gabijėlė;GENIUKŲ;2407507314;Ne;9;0;2;11
18347;Gabijėlė;GENIUKŲ;3827747057;Ne;0;10;0;10
18348;Gabijėlė;GENIUKŲ;4234733280;Ne;0;2;0;2
18349;Gabijėlė;GENIUKŲ;6375754699;Ne;0;0;1;1
18350;Gabijėlė;GENIUKŲ;6869951613;Ne;0;2;0;2
18351;Gabijėlė;GENIUKŲ;7173852168;Ne;0;11;0;11
18352;Gabijėlė;GENIUKŲ;8036572198;Ne;0;5;0;5
18353;Gabijėlė;DAGILIUKŲ;9348393550;Ne;0;2;0;2
18354;Gabijėlė;DAGILIUKŲ;4264925447;Ne;0;2;0;2
18355;Gabijėlė;DAGILIUKŲ;9120107749;Ne;5;0;0;5
18356;Gabijėlė;DAGILIUKŲ;9494313873;Ne;2;0;1;3
18357;Gabijėlė;DAGILIUKŲ;9783343968;Ne;4;0;0;4
18358;Gabijėlė;DAGILIUKŲ;4462129182;Ne;15;0;0;15
18359;Gabijėlė;DAGILIUKŲ;9503639471;Ne;7;0;0;7
18360;Gabijėlė;DAGILIUKŲ;1988597157;Ne;11;0;0;11
18361;Gabijėlė;DAGILIUKŲ;9895518740;Ne;10;0;10;20
18362;Gabijėlė;DAGILIUKŲ;9449023766;Ne;0;1;0;1
18363;Gabijėlė;DAGILIUKŲ;1286688629;Ne;8;0;4;12
18364;Gabijėlė;DAGILIUKŲ;1455856766;Ne;10;0;0;10
18365;Gabijėlė;DAGILIUKŲ;6438144206;Ne;0;0;6;6
18366;Gabijėlė;DAGILIUKŲ;8662914262;Ne;0;1;0;1
18367;Gabijėlė;DAGILIUKŲ;9280283478;Ne;0;1;1;2
18368;Gabijėlė;DAGILIUKŲ;2254104149;Ne;0;1;0;1
18369;Gabijėlė;DAGILIUKŲ;4490619514;Ne;10;0;1;11
18370;Gabijėlė;DAGILIUKŲ;2386980295;Ne;0;0;7;7
18371;Gabijėlė;DAGILIUKŲ;4664011011;Ne;14;0;0;14
18372;Gabijėlė;PELEDŽIUKŲ;4170105224;Ne;2;2;2;6
18373;Gabijėlė;PELEDŽIUKŲ;5675574534;Ne;6;0;1;7
18374;Gabijėlė;PELEDŽIUKŲ;5163460269;Ne;0;0;2;2
18375;Gabijėlė;PELEDŽIUKŲ;1356830225;Ne;0;0;2;2
18376;Gabijėlė;PELEDŽIUKŲ;9265103627;Ne;4;0;0;4
18377;Gabijėlė;PELEDŽIUKŲ;9451897367;Ne;0;0;1;1
18378;Gabijėlė;PELEDŽIUKŲ;1583034900;Ne;0;5;5;10
18379;Gabijėlė;PELEDŽIUKŲ;2128428173;Ne;0;0;4;4
18380;Gabijėlė;PELEDŽIUKŲ;7028670164;Ne;0;0;4;4
18381;Gabijėlė;PELEDŽIUKŲ;2885913045;Ne;0;6;0;6
18382;Gabijėlė;PELEDŽIUKŲ;5869580147;Ne;0;0;4;4
18383;Gabijėlė;PELEDŽIUKŲ;7096789623;Ne;0;0;3;3
18384;Gabijėlė;PELEDŽIUKŲ;4724322463;Ne;0;8;0;8
18385;Gabijėlė;PELEDŽIUKŲ;1810898809;Taip;7;0;0;7
18386;Gabijėlė;PELEDŽIUKŲ;5801792404;Ne;6;0;1;7
18387;Gabijėlė;PELEDŽIUKŲ;8550877260;Taip;11;6;0;17
18388;Gabijėlė;PELEDŽIUKŲ;5579070948;Ne;0;0;1;1
18389;Gabijėlė;PELEDŽIUKŲ;8549800358;Ne;11;0;1;12
18390;Gabijėlė;PELEDŽIUKŲ;8133131896;Ne;0;0;1;1
18391;Gabijėlė;PELEDŽIUKŲ;2048046055;Ne;0;0;2;2
18392;Gabijėlė;PELEDŽIUKŲ;7261932151;Ne;4;0;0;4
18393;Gabijėlė;PELEDŽIUKŲ;8088806507;Ne;0;1;0;1
18394;Gabijėlė;PELEDŽIUKŲ;6728495961;Ne;20;0;0;20
18395;Gabijėlė;KREGZDŽIUKŲ;1759118326;Ne;0;4;0;4
18396;Gabijėlė;KREGZDŽIUKŲ;9533325351;Ne;0;6;0;6
18397;Gabijėlė;KREGZDŽIUKŲ;5407565441;Ne;1;0;2;3
18398;Gabijėlė;KREGZDŽIUKŲ;2357515455;Ne;0;0;1;1
18399;Gabijėlė;KREGZDŽIUKŲ;1574272380;Ne;10;0;0;10
18400;Gabijėlė;KREGZDŽIUKŲ;9675186834;Taip;0;6;2;8
18401;Gabijėlė;KREGZDŽIUKŲ;4317708029;Ne;0;7;0;7
18402;Gabijėlė;KREGZDŽIUKŲ;8555272917;Ne;0;4;0;4
18403;Gabijėlė;KREGZDŽIUKŲ;3584692524;Ne;0;1;0;1
18404;Gabijėlė;KREGZDŽIUKŲ;8613821848;Ne;0;2;4;6
18405;Gabijėlė;KREGZDŽIUKŲ;7038167942;Ne;0;11;0;11
18406;Gabijėlė;KREGZDŽIUKŲ;6570702235;Ne;2;0;0;2
18407;Gabijėlė;KREGZDŽIUKŲ;9528783892;Ne;0;6;0;6
18408;Gabijėlė;KREGZDŽIUKŲ;9358478209;Ne;0;0;3;3
18409;Gabijėlė;KREGZDŽIUKŲ;9030890792;Ne;0;0;2;2
18410;Gabijėlė;KREGZDŽIUKŲ;3031333199;Ne;0;0;2;2
18411;Gabijėlė;KREGZDŽIUKŲ;9116153981;Ne;0;0;1;1
18412;Gabijėlė;KREGZDŽIUKŲ;7447079902;Ne;14;4;2;20
18413;Gabijėlė;KREGZDŽIUKŲ;2289016022;Ne;13;0;1;14
18414;Gabijėlė;KREGZDŽIUKŲ;1230236612;Ne;0;0;4;4
18415;Gabijėlė;KREGZDŽIUKŲ;4575230225;Ne;6;0;0;6
18416;Gabijėlė;KREGZDŽIUKŲ;7224216275;Ne;0;0;2;2
18417;Gabijėlė;ZYLIUKŲ;6154378055;Ne;6;0;4;10
18418;Gabijėlė;ZYLIUKŲ;7700700293;Ne;10;0;4;14
18419;Gabijėlė;ZYLIUKŲ;6759447513;Ne;0;5;0;5
18420;Gabijėlė;ZYLIUKŲ;1090635644;Ne;6;0;0;6
18421;Gabijėlė;ZYLIUKŲ;9893869150;Ne;0;0;8;8
18422;Gabijėlė;ZYLIUKŲ;7921467223;Ne;0;0;3;3
18423;Gabijėlė;ZYLIUKŲ;6446842432;Ne;1;0;1;2
18424;Gabijėlė;ZYLIUKŲ;6562965816;Ne;4;0;0;4
18425;Gabijėlė;ZYLIUKŲ;7047606048;Ne;1;0;0;1
18426;Gabijėlė;ZYLIUKŲ;6983092888;Ne;5;0;2;7
18427;Gabijėlė;ZYLIUKŲ;4267803371;Ne;1;0;5;6
18428;Gabijėlė;ZYLIUKŲ;9259673720;Ne;2;0;0;2
18429;Gabijėlė;ZYLIUKŲ;8362509831;Ne;1;0;2;3
18430;Gabijėlė;ZYLIUKŲ;4907669556;Ne;0;4;0;4
18431;Gabijėlė;ZYLIUKŲ;1947898190;Ne;5;2;2;9
18432;Gabijėlė;ZYLIUKŲ;2384174631;Ne;5;0;7;12
18433;Gabijėlė;ZYLIUKŲ;6393256426;Ne;0;0;7;7
18434;Gabijėlė;ZYLIUKŲ;5736012194;Ne;15;0;0;15
18435;Gabijėlė;ZYLIUKŲ;4712780337;Ne;5;0;0;5
18436;Gabijėlė;ZYLIUKŲ;1004297369;Ne;1;0;3;4
18437;Gabijėlė;ZYLIUKŲ;7180444215;Ne;2;0;7;9
18438;Gabijėlė;ZYLIUKŲ;8965185578;Ne;1;0;1;2
18439;Gabijėlė;VOLUNGĖLIŲ;4000838897;Ne;12;0;0;12
18440;Gabijėlė;VOLUNGĖLIŲ;2099510027;Ne;8;0;0;8
18441;Gabijėlė;VOLUNGĖLIŲ;2227816651;Ne;0;1;0;1
18442;Gabijėlė;VOLUNGĖLIŲ;6956030813;Ne;15;1;0;16
18443;Gabijėlė;VOLUNGĖLIŲ;8733551230;Ne;9;1;0;10
18444;Gabijėlė;VOLUNGĖLIŲ;3763595874;Ne;10;0;0;10
18445;Gabijėlė;VOLUNGĖLIŲ;5360985745;Ne;4;0;0;4
18446;Gabijėlė;VOLUNGĖLIŲ;4580305437;Ne;0;10;0;10
18447;Gabijėlė;VOLUNGĖLIŲ;5737066080;Ne;4;1;0;5
18448;Gabijėlė;VOLUNGĖLIŲ;3972933727;Ne;6;1;1;8
18449;Gabijėlė;VOLUNGĖLIŲ;6643563560;Ne;0;1;0;1
18450;Gabijėlė;VOLUNGĖLIŲ;8312753333;Ne;0;2;0;2
18451;Gabijėlė;VOLUNGĖLIŲ;8569742033;Ne;5;0;0;5
18452;Gabijėlė;VOLUNGĖLIŲ;8327903800;Ne;8;1;0;9
18453;Gabijėlė;VOLUNGĖLIŲ;4160646449;Ne;0;5;0;5
18454;Gabijėlė;VOLUNGĖLIŲ;5060265729;Ne;6;0;0;6
18455;Gabijėlė;VOLUNGĖLIŲ;6960725029;Ne;4;1;3;8
18456;Gabijėlė;VOLUNGĖLIŲ;3995459990;Ne;0;1;0;1
18457;Gabijėlė;VOLUNGĖLIŲ;8320449381;Taip;8;2;0;10
18458;Gabijėlė;VOLUNGĖLIŲ;3267339129;Ne;6;0;1;7
18459;Gabijėlė;VOLUNGĖLIŲ;4304012457;Ne;4;0;0;4
18460;Gabijėlė;ANČIUKŲ;2036978425;Ne;0;5;0;5
18461;Gabijėlė;ANČIUKŲ;5219706067;Ne;0;10;0;10
18462;Gabijėlė;ANČIUKŲ;9822093084;Ne;9;0;0;9
18463;Gabijėlė;ANČIUKŲ;1415184607;Ne;0;0;3;3
18464;Gabijėlė;ANČIUKŲ;85836097485;Ne;0;0;6;6
18465;Gabijėlė;ANČIUKŲ;28017865889;Ne;0;5;0;5
18466;Gabijėlė;ANČIUKŲ;1917587420;Ne;0;11;0;11
18467;Gabijėlė;ANČIUKŲ;1465584524;Ne;3;0;2;5
18468;Gabijėlė;ANČIUKŲ;6198439092;Ne;0;2;0;2
18469;Gabijėlė;ANČIUKŲ;7948343328;Ne;0;1;0;1
18470;Gabijėlė;ANČIUKŲ;8111239476;Ne;0;10;0;10
18471;Gabijėlė;ANČIUKŲ;4085049535;Ne;0;2;0;2
18472;Gabijėlė;ANČIUKŲ;8893637755;Ne;0;17;0;17
18473;Gabijėlė;ANČIUKŲ;8874692591;Ne;6;0;0;6
18474;Gabijėlė;ANČIUKŲ;4752631976;Ne;0;0;1;1
18475;Gabijėlė;ANČIUKŲ;5783373671;Ne;0;1;0;1
18476;Gabijėlė;ANČIUKŲ;6766770793;Ne;0;0;1;1
18477;Gabijėlė;ANČIUKŲ;10796114623;Ne;0;3;0;3
18478;Gabijėlė;ANČIUKŲ;43123279348;Ne;0;7;0;7
18479;Gabijėlė;BALANDŽIUKŲ;6719097956;Ne;0;0;4;4
18480;Gabijėlė;BALANDŽIUKŲ;9157819780;Ne;0;3;0;3
18481;Gabijėlė;BALANDŽIUKŲ;8131229306;Ne;0;0;2;2
18482;Gabijėlė;BALANDŽIUKŲ;8525869648;Ne;14;0;0;14
18483;Gabijėlė;BALANDŽIUKŲ;2070050969;Ne;0;1;0;1
18484;Gabijėlė;BALANDŽIUKŲ;2776579713;Ne;1;2;0;3
18485;Gabijėlė;BALANDŽIUKŲ;9197020006;Ne;0;2;0;2
18486;Gabijėlė;BALANDŽIUKŲ;1615940996;Ne;0;0;1;1
18487;Gabijėlė;BALANDŽIUKŲ;2921208571;Ne;0;0;2;2
18488;Gabijėlė;BALANDŽIUKŲ;9501202207;Ne;0;5;0;5
18489;Gabijėlė;BALANDŽIUKŲ;6145720452;Ne;10;1;0;11
18490;Gabijėlė;BALANDŽIUKŲ;7563741123;Ne;0;5;0;5
18491;Gabijėlė;BALANDŽIUKŲ;3694447705;Ne;0;0;4;4
18492;Gabijėlė;BALANDŽIUKŲ;2189532651;Ne;1;0;0;1
18493;Gabijėlė;VYTURIUKŲ;6131649116;Ne;5;0;2;7
18494;Gabijėlė;VYTURIUKŲ;8461048184;Ne;4;0;0;4
18495;Gabijėlė;VYTURIUKŲ;7894667201;Ne;11;1;0;12
18496;Gabijėlė;VYTURIUKŲ;3960795412;Ne;8;0;0;8
18497;Gabijėlė;VYTURIUKŲ;3454061135;Ne;0;9;0;9
18498;Gabijėlė;VYTURIUKŲ;5652244967;Ne;10;0;2;12
18499;Gabijėlė;VYTURIUKŲ;6013482554;Ne;3;0;1;4
18500;Gabijėlė;VYTURIUKŲ;1523190444;Ne;6;0;0;6
18501;Gabijėlė;VYTURIUKŲ;7295985579;Ne;1;0;0;1
18502;Gabijėlė;VYTURIUKŲ;6834871835;Ne;4;0;0;4
18503;Gabijėlė;VYTURIUKŲ;8749080961;Ne;0;0;5;5
18504;Gabijėlė;VYTURIUKŲ;1185216449;Ne;0;1;0;1
18505;Gabijėlė;VYTURIUKŲ;6107630313;Ne;1;0;0;1
18506;Gabijėlė;VYTURIUKŲ;5297866989;Ne;2;0;2;4
18507;Gabijėlė;VYTURIUKŲ;7509112343;Ne;13;0;1;14
18508;Gabijėlė;VYTURIUKŲ;4248856615;Ne;8;0;0;8
18509;Gabijėlė;VYTURIUKŲ;6539078572;Ne;0;10;0;10
18510;Gabijėlė;VYTURIUKŲ;9657713903;Ne;13;0;0;13
18511;Gabijėlė;VYTURIUKŲ;5310270057;Ne;0;0;4;4
18512;Gabijėlė;LIEPSNELIŲ;1835893385;Ne;20;0;0;20
18513;Saulėgrąža;Bitutės;8660677159;Ne;0;3;4;7
18514;Saulėgrąža;Bitutės;9437387272;Ne;0;0;1;1
18515;Saulėgrąža;Bitutės;5940167166;Ne;0;0;5;5
18516;Saulėgrąža;Bitutės;6641588877;Ne;0;0;7;7
18517;Saulėgrąža;Bitutės;8505655534;Ne;4;2;1;7
18518;Saulėgrąža;Bitutės;2809788049;Ne;0;1;1;2
18519;Saulėgrąža;Bitutės;1381240000;Ne;0;2;6;8
18520;Saulėgrąža;Bitutės;8766433391;Ne;0;2;0;2
18521;Saulėgrąža;Bitutės;7283302671;Ne;0;0;6;6
18522;Saulėgrąža;Bitutės;4265356484;Ne;0;0;2;2
18523;Saulėgrąža;Bitutės;2042826101;Ne;0;2;2;4
18524;Saulėgrąža;Bitutės;1345079291;Ne;0;3;5;8
18525;Saulėgrąža;Bitutės;3319538368;Taip;9;0;0;9
18526;Saulėgrąža;Bitutės;8597567633;Ne;0;4;0;4
18527;Saulėgrąža;Bitutės;5221286194;Ne;0;0;4;4
18528;Saulėgrąža;Bitutės;8531862400;Ne;0;0;1;1
18529;Saulėgrąža;Šnekučiai;5752240936;Ne;1;0;6;7
18530;Saulėgrąža;Šnekučiai;1194417698;Ne;15;0;0;15
18531;Saulėgrąža;Šnekučiai;7605120979;Ne;7;0;0;7
18532;Saulėgrąža;Šnekučiai;7094602327;Ne;5;0;0;5
18533;Saulėgrąža;Šnekučiai;2092031362;Ne;0;0;2;2
18534;Saulėgrąža;Šnekučiai;5321867228;Ne;1;0;1;2
18535;Saulėgrąža;Šnekučiai;4943974662;Ne;0;5;1;6
18536;Saulėgrąža;Šnekučiai;2606475854;Ne;0;0;1;1
18537;Saulėgrąža;Šnekučiai;8489738069;Ne;0;0;5;5
18538;Saulėgrąža;Šnekučiai;6582418868;Ne;0;0;4;4
18539;Saulėgrąža;Šnekučiai;7822120516;Ne;0;3;1;4
18540;Saulėgrąža;Šnekučiai;9467190029;Ne;5;0;1;6
18541;Saulėgrąža;Šnekučiai;1128467783;Ne;16;0;1;17
18542;Saulėgrąža;Šnekučiai;1946531018;Ne;0;0;4;4
18543;Saulėgrąža;Šnekučiai;3360745408;Ne;4;0;0;4
18544;Saulėgrąža;Skruzdėliukai;7211562324;Ne;0;0;2;2
18545;Saulėgrąža;Skruzdėliukai;7636592904;Ne;4;0;0;4
18546;Saulėgrąža;Skruzdėliukai;87694187780;Ne;6;0;0;6
18547;Saulėgrąža;Skruzdėliukai;6036373745;Ne;0;0;1;1
18548;Saulėgrąža;Skruzdėliukai;4023911154;Ne;0;0;2;2
18549;Saulėgrąža;Skruzdėliukai;2029367287;Ne;7;1;0;8
18550;Saulėgrąža;Skruzdėliukai;4904157108;Ne;12;0;0;12
18551;Saulėgrąža;Skruzdėliukai;2453261741;Ne;0;0;4;4
18552;Saulėgrąža;Skruzdėliukai;6867062357;Ne;0;3;0;3
18553;Saulėgrąža;Skruzdėliukai;9701242161;Ne;5;0;0;5
18554;Saulėgrąža;Skruzdėliukai;2123441401;Ne;1;0;2;3
18555;Saulėgrąža;Skruzdėliukai;6373141401;Ne;0;2;0;2
18556;Saulėgrąža;Skruzdėliukai;5674402704;Ne;0;11;0;11
18557;Saulėgrąža;Skruzdėliukai;8140258691;Ne;2;4;0;6
18558;Saulėgrąža;Skruzdėliukai;5336463701;Ne;8;0;0;8
18559;Saulėgrąža;Skruzdėliukai;3839880985;Ne;0;0;1;1
18560;Saulėgrąža;Skruzdėliukai;1397888834;Ne;7;0;6;13
18561;Saulėgrąža;Skruzdėliukai;4902990966;Ne;0;0;2;2
18562;Saulėgrąža;Gudručiai;1557512232;Ne;0;0;4;4
18563;Saulėgrąža;Gudručiai;3334830210;Ne;19;0;0;19
18564;Saulėgrąža;Gudručiai;3460944414;Ne;0;6;0;6
18565;Saulėgrąža;Gudručiai;8066720746;Ne;7;0;0;7
18566;Saulėgrąža;Gudručiai;6087243776;Ne;8;0;0;8
18567;Saulėgrąža;Gudručiai;4656827505;Ne;5;0;4;9
18568;Saulėgrąža;Gudručiai;2142393859;Ne;20;0;0;20
18569;Saulėgrąža;Gudručiai;2811204521;Ne;3;0;0;3
18570;Saulėgrąža;Gudručiai;9703861091;Ne;0;0;1;1
18571;Saulėgrąža;Gudručiai;6925730672;Ne;0;0;1;1
18572;Saulėgrąža;Gudručiai;9537997340;Ne;0;4;0;4
18573;Saulėgrąža;Gudručiai;6188169984;Ne;10;0;0;10
18574;Saulėgrąža;Gudručiai;4593109666;Ne;0;2;0;2
18575;Saulėgrąža;Gudručiai;3455052574;Ne;0;0;1;1
18576;Saulėgrąža;Gudručiai;6803731510;Ne;5;0;1;6
18577;Saulėgrąža;Gudručiai;7499997676;Ne;0;0;5;5
18578;Saulėgrąža;Gudručiai;2934189012;Ne;10;0;0;10
18579;Saulėgrąža;Smalsučiai;6415042057;Ne;5;0;0;5
18580;Saulėgrąža;Smalsučiai;7236623241;Ne;15;0;0;15
18581;Saulėgrąža;Smalsučiai;4204112706;Ne;0;3;0;3
18582;Saulėgrąža;Smalsučiai;3574399274;Ne;0;11;0;11
18583;Saulėgrąža;Smalsučiai;12350048317;Ne;0;4;0;4
18584;Saulėgrąža;Smalsučiai;3214026239;Ne;10;0;0;10
18585;Saulėgrąža;Smalsučiai;1314754650;Ne;0;8;0;8
18586;Saulėgrąža;Smalsučiai;4252425680;Ne;0;0;3;3
18587;Saulėgrąža;Smalsučiai;1563002207;Ne;0;9;0;9
18588;Saulėgrąža;"Boruželės ";3889868838;Ne;10;0;0;10
18589;Saulėgrąža;"Boruželės ";1613110580;Ne;0;0;1;1
18590;Saulėgrąža;"Boruželės ";6802366478;Ne;5;0;0;5
18591;Saulėgrąža;"Boruželės ";9604238128;Ne;5;0;7;12
18592;Saulėgrąža;"Boruželės ";4587532777;Ne;6;0;1;7
18593;Saulėgrąža;"Boruželės ";1008547550;Ne;0;0;2;2
18594;Saulėgrąža;"Boruželės ";4930162914;Ne;1;0;2;3
18595;Saulėgrąža;"Boruželės ";3080026762;Ne;9;0;0;9
18596;Saulėgrąža;"Boruželės ";9328524382;Taip;6;0;5;11
18597;Saulėgrąža;"Boruželės ";2598768766;Ne;10;0;1;11
18598;Saulėgrąža;"Boruželės ";5734857301;Ne;0;0;6;6
18599;Saulėgrąža;"Boruželės ";9658060059;Ne;0;0;2;2
18600;Saulėgrąža;"Boruželės ";3594593787;Ne;0;3;0;3
18601;Saulėgrąža;Žiogeliai;7400016718;Ne;15;0;0;15
18602;Saulėgrąža;Žiogeliai;8518372931;Ne;0;0;1;1
18603;Saulėgrąža;Žiogeliai;3540590993;Ne;4;0;5;9
18604;Saulėgrąža;Žiogeliai;6297303519;Ne;0;0;2;2
18605;Saulėgrąža;Žiogeliai;7399313501;Ne;5;0;1;6
18606;Saulėgrąža;Žiogeliai;2551242973;Ne;0;0;8;8
18607;Saulėgrąža;Žiogeliai;7881751334;Ne;0;1;0;1
18608;Saulėgrąža;Žiogeliai;4332729441;Ne;0;9;0;9
18609;Saulėgrąža;Žiogeliai;6818436741;Ne;5;2;0;7
18610;Saulėgrąža;Žiogeliai;3290592235;Ne;0;0;1;1
18611;Saulėgrąža;Žiogeliai;3690611746;Ne;7;0;0;7
18612;Saulėgrąža;Žiogeliai;7807068772;Ne;1;0;4;5
18613;Saulėgrąža;Žiogeliai;5360973768;Ne;0;0;4;4
18614;Saulėgrąža;Žiogeliai;8769720021;Ne;0;0;1;1
18615;Saulėgrąža;Žiogeliai;5328915059;Ne;0;2;0;2
18616;Saulėgrąža;Žiogeliai;1533696548;Ne;0;0;1;1
18617;Saulėgrąža;Drugeliai;1955944355;Ne;0;1;0;1
18618;Saulėgrąža;Drugeliai;8337203952;Ne;8;0;1;9
18619;Saulėgrąža;Drugeliai;6127496900;Taip;14;0;0;14
18620;Saulėgrąža;Drugeliai;8841882983;Ne;7;0;3;10
18621;Saulėgrąža;Drugeliai;6608001857;Ne;0;3;0;3
18622;Saulėgrąža;Drugeliai;4663169787;Ne;0;0;5;5
18623;Saulėgrąža;Drugeliai;7281353368;Ne;0;0;3;3
18624;Saulėgrąža;Drugeliai;8138991066;Ne;2;0;0;2
18625;Saulėgrąža;Drugeliai;1379283244;Ne;0;0;4;4
18626;Saulėgrąža;Drugeliai;4767744537;Ne;2;0;3;5
18627;Saulėgrąža;Drugeliai;1564385864;Ne;0;0;2;2
18628;Saulėgrąža;Drugeliai;4361365993;Ne;7;0;6;13
18629;Saulėgrąža;Drugeliai;8882080945;Ne;4;0;6;10
18630;Saulėgrąža;Drugeliai;1386348080;Ne;0;0;6;6
18631;Saulėgrąža;Drugeliai;3318222372;Ne;0;1;0;1
18632;Saulėgrąža;Drugeliai;8148900529;Ne;0;0;1;1
18633;Saulėgrąža;Drugeliai;3988854847;Ne;0;0;2;2
18634;Saulėgrąža;Pabiručiai;1193968905;Ne;0;0;3;3
18635;Saulėgrąža;Pabiručiai;9812784697;Ne;9;1;0;10
18636;Saulėgrąža;Pabiručiai;1732823416;Ne;3;0;0;3
18637;Saulėgrąža;Pabiručiai;2063366170;Ne;0;0;1;1
18638;Saulėgrąža;Pabiručiai;5417303387;Ne;0;0;1;1
18639;Saulėgrąža;Pabiručiai;4113866451;Ne;0;0;2;2
18640;Saulėgrąža;Pabiručiai;5759064166;Ne;0;0;1;1
18641;Saulėgrąža;Pabiručiai;3014850439;Ne;11;0;2;13
18642;Saulėgrąža;Pabiručiai;7563907981;Ne;0;0;10;10
18643;Saulėgrąža;Pabiručiai;7110805205;Ne;1;0;0;1
18644;Saulėgrąža;Pabiručiai;6489291407;Ne;0;0;1;1
18645;Saulėgrąža;Pabiručiai;5302001715;Ne;0;0;2;2
18646;Saulėgrąža;Pabiručiai;6846627257;Ne;0;0;1;1
18647;Saulėgrąža;Pabiručiai;7492804255;Ne;0;0;2;2
18648;Saulėgrąža;Žvirbliukai;4642639501;Ne;11;0;0;11
18649;Saulėgrąža;Žvirbliukai;2655671127;Ne;10;0;0;10
18650;Saulėgrąža;Žvirbliukai;6521035871;Ne;14;0;0;14
18651;Saulėgrąža;Žvirbliukai;4022011749;Ne;0;1;0;1
18652;Saulėgrąža;Žvirbliukai;7341460478;Ne;1;0;1;2
18653;Saulėgrąža;Žvirbliukai;3611547634;Ne;3;0;0;3
18654;Saulėgrąža;Žvirbliukai;4804554877;Ne;10;0;0;10
18655;Saulėgrąža;Žvirbliukai;7772718729;Ne;4;3;0;7
18656;Saulėgrąža;Žvirbliukai;4154566152;Ne;0;0;4;4
18657;Saulėgrąža;Žvirbliukai;5546123929;Ne;0;0;2;2
18658;Saulėgrąža;Pagrandukai;9226189126;Taip;0;0;1;1
18659;Saulėgrąža;Pagrandukai;7283179482;Ne;0;3;0;3
18660;Saulėgrąža;Pagrandukai;3060727219;Ne;0;12;4;16
18661;Saulėgrąža;Pagrandukai;4405035646;Ne;8;0;1;9
18662;Saulėgrąža;Pagrandukai;4017783391;Ne;1;0;2;3
18663;Saulėgrąža;Pagrandukai;5584937620;Ne;0;0;7;7
18664;Saulėgrąža;Pagrandukai;3745791935;Ne;0;0;1;1
18665;Saulėgrąža;Pagrandukai;3785206644;Ne;3;2;5;10
18666;Saulėgrąža;Pagrandukai;2395186861;Ne;18;0;0;18
18667;Saulėgrąža;Pagrandukai;6130342214;Ne;0;2;6;8
18668;Saulėgrąža;Pagrandukai;3860139612;Ne;0;0;11;11
18669;Saulėgrąža;Pagrandukai;7545277683;Ne;0;1;0;1
18670;Saulėgrąža;Pagrandukai;5633604322;Ne;0;0;13;13
18671;Saulėgrąža;Pagrandukai;2882565651;Ne;6;0;2;8
18672;Saulėgrąža;Pagrandukai;3270627153;Ne;0;0;1;1
18673;Saulėgrąža;ŽIRNIUKAI;1865329102;Ne;4;0;1;5
18674;Saulėgrąža;ŽIRNIUKAI;1348059394;Ne;17;0;3;20
18675;Saulėgrąža;ŽIRNIUKAI;9048103711;Ne;0;0;8;8
18676;Saulėgrąža;ŽIRNIUKAI;7006151469;Ne;12;0;3;15
18677;Saulėgrąža;ŽIRNIUKAI;2639340053;Ne;0;0;1;1
18678;Saulėgrąža;ŽIRNIUKAI;8759207627;Ne;0;6;9;15
18679;Saulėgrąža;ŽIRNIUKAI;7224392042;Ne;3;0;0;3
18680;Saulėgrąža;ŽIRNIUKAI;7394519503;Ne;4;3;1;8
18681;Saulėgrąža;ŽIRNIUKAI;7639669608;Ne;2;0;0;2
18682;Saulėgrąža;ŽIRNIUKAI;3406939096;Ne;11;0;0;11
18683;Saulėgrąža;ŽIRNIUKAI;1486025741;Taip;6;0;5;11
18684;Saulėgrąža;ŽIRNIUKAI;7556672566;Taip;6;0;0;6
18685;Saulėgrąža;ŽIRNIUKAI;8100161189;Ne;3;0;0;3
18686;Saulėgrąža;ŽIRNIUKAI;2320995262;Ne;3;0;0;3
18687;Saulėgrąža;ŽIRNIUKAI;5168679344;Ne;0;0;5;5
18688;Saulėgrąža;ŽIRNIUKAI;3467805481;Ne;7;0;3;10
18689;Saulėgrąža;ŽIRNIUKAI;3124081874;Ne;17;0;0;17
18690;Saulėgrąža;ŽIRNIUKAI;3898229402;Ne;0;5;1;6
18691;Saulėgrąža;ŽIRNIUKAI;1217899072;Ne;8;0;0;8
18692;Saulėgrąža;ŽIRNIUKAI;5263977515;Ne;5;0;1;6
18693;Saulėgrąža;ŽIRNIUKAI;5054190103;Ne;0;0;3;3
18694;"Pilaitukas (I. Kanto al. 7A)";BITUTĖS;8169484415;Ne;5;5;0;10
18695;"Pilaitukas (I. Kanto al. 7A)";BITUTĖS;1253300093;Ne;0;0;2;2
18696;"Pilaitukas (I. Kanto al. 7A)";BITUTĖS;2242454299;Ne;0;2;2;4
18697;"Pilaitukas (I. Kanto al. 7A)";BITUTĖS;4082490488;Ne;5;10;0;15
18698;"Pilaitukas (I. Kanto al. 7A)";BITUTĖS;3345387791;Ne;0;0;1;1
18699;"Pilaitukas (I. Kanto al. 7A)";BITUTĖS;3541354283;Ne;2;1;0;3
18700;"Pilaitukas (I. Kanto al. 7A)";BITUTĖS;5740951665;Ne;12;0;3;15
18701;"Pilaitukas (I. Kanto al. 7A)";BITUTĖS;4591799893;Ne;9;3;0;12
18702;"Pilaitukas (I. Kanto al. 7A)";BITUTĖS;6308557885;Ne;9;1;0;10
18703;"Pilaitukas (I. Kanto al. 7A)";BITUTĖS;6514731102;Ne;9;1;0;10
18704;"Pilaitukas (I. Kanto al. 7A)";BITUTĖS;5988165204;Ne;0;0;2;2
18705;"Pilaitukas (I. Kanto al. 7A)";BITUTĖS;3037850837;Ne;0;1;0;1
18706;"Pilaitukas (I. Kanto al. 7A)";BITUTĖS;9126553732;Taip;0;2;3;5
18707;"Pilaitukas (I. Kanto al. 7A)";BITUTĖS;7438112270;Ne;6;0;1;7
18708;"Pilaitukas (I. Kanto al. 7A)";BITUTĖS;5331915157;Ne;0;0;2;2
18709;"Pilaitukas (I. Kanto al. 7A)";BITUTĖS;3159733673;Ne;2;2;1;5
18710;"Pilaitukas (I. Kanto al. 7A)";BITUTĖS;2122392982;Taip;0;7;0;7
18711;"Pilaitukas (I. Kanto al. 7A)";BITUTĖS;7082099968;Ne;0;4;0;4
18712;"Pilaitukas (I. Kanto al. 7A)";ZUIKUČIAI;8993885764;Ne;0;1;0;1
18713;"Pilaitukas (I. Kanto al. 7A)";ZUIKUČIAI;5206637809;Ne;7;0;4;11
18714;"Pilaitukas (I. Kanto al. 7A)";ZUIKUČIAI;5288784331;Ne;0;0;1;1
18715;"Pilaitukas (I. Kanto al. 7A)";ZUIKUČIAI;8255398803;Ne;0;6;0;6
18716;"Pilaitukas (I. Kanto al. 7A)";ZUIKUČIAI;2862447956;Ne;0;4;0;4
18717;"Pilaitukas (I. Kanto al. 7A)";ZUIKUČIAI;8727175656;Ne;0;4;0;4
18718;"Pilaitukas (I. Kanto al. 7A)";ZUIKUČIAI;8207194955;Ne;0;0;5;5
18719;"Pilaitukas (I. Kanto al. 7A)";ZUIKUČIAI;5640802570;Ne;8;1;0;9
18720;"Pilaitukas (I. Kanto al. 7A)";ZUIKUČIAI;4623818227;Ne;0;0;2;2
18721;"Pilaitukas (I. Kanto al. 7A)";ZUIKUČIAI;9260893320;Ne;0;3;0;3
18722;"Pilaitukas (I. Kanto al. 7A)";ZUIKUČIAI;9988041515;Ne;4;0;0;4
18723;"Pilaitukas (I. Kanto al. 7A)";ZUIKUČIAI;9108428738;Ne;4;0;0;4
18724;"Pilaitukas (I. Kanto al. 7A)";ZUIKUČIAI;1607454890;Ne;0;0;5;5
18725;"Pilaitukas (I. Kanto al. 7A)";ZUIKUČIAI;5710747769;Ne;5;2;0;7
18726;"Pilaitukas (I. Kanto al. 7A)";ZUIKUČIAI;7568744500;Ne;6;0;2;8
18727;"Pilaitukas (I. Kanto al. 7A)";ZUIKUČIAI;5407354218;Ne;4;3;0;7
18728;"Pilaitukas (I. Kanto al. 7A)";ZUIKUČIAI;1704055907;Ne;0;0;10;10
18729;"Pilaitukas (I. Kanto al. 7A)";ZUIKUČIAI;7853910193;Ne;1;0;6;7
18730;"Pilaitukas (I. Kanto al. 7A)";ZUIKUČIAI;2705235576;Ne;0;14;1;15
18731;"Pilaitukas (I. Kanto al. 7A)";ANČIUKAI;3357097410;Ne;0;3;0;3
18732;"Pilaitukas (I. Kanto al. 7A)";ANČIUKAI;7773318230;Ne;1;6;0;7
18733;"Pilaitukas (I. Kanto al. 7A)";ANČIUKAI;4097742120;Ne;0;1;0;1
18734;"Pilaitukas (I. Kanto al. 7A)";ANČIUKAI;2923272767;Ne;0;2;0;2
18735;"Pilaitukas (I. Kanto al. 7A)";ANČIUKAI;8620858011;Ne;0;1;0;1
18736;"Pilaitukas (I. Kanto al. 7A)";ANČIUKAI;4286388920;Ne;0;0;1;1
18737;"Pilaitukas (I. Kanto al. 7A)";ANČIUKAI;3761827714;Ne;1;1;0;2
18738;"Pilaitukas (I. Kanto al. 7A)";ANČIUKAI;6888607864;Ne;0;3;0;3
18739;"Pilaitukas (I. Kanto al. 7A)";ANČIUKAI;5490465905;Ne;1;1;0;2
18740;"Pilaitukas (I. Kanto al. 7A)";ANČIUKAI;7876850509;Ne;4;1;0;5
18741;"Pilaitukas (I. Kanto al. 7A)";ANČIUKAI;3035456834;Ne;1;0;0;1
18742;"Pilaitukas (I. Kanto al. 7A)";ANČIUKAI;2476942319;Ne;1;0;0;1
18743;"Pilaitukas (I. Kanto al. 7A)";ANČIUKAI;8033540052;Ne;8;1;0;9
18744;"Pilaitukas (I. Kanto al. 7A)";ANČIUKAI;8787181006;Ne;6;2;0;8
18745;"Pilaitukas (I. Kanto al. 7A)";ANČIUKAI;7189824054;Ne;7;0;0;7
18746;"Pilaitukas (I. Kanto al. 7A)";ANČIUKAI;9332831979;Ne;10;0;1;11
18747;"Pilaitukas (I. Kanto al. 7A)";ANČIUKAI;5706918634;Ne;10;0;0;10
18748;"Pilaitukas (I. Kanto al. 7A)";ANČIUKAI;8954370321;Ne;6;0;6;12
18749;"Pilaitukas (I. Kanto al. 7A)";ANČIUKAI;1660462256;Ne;6;8;0;14
18750;"Pilaitukas (I. Kanto al. 7A)";MEŠKIUKAI;8577357264;Ne;4;1;0;5
18751;"Pilaitukas (I. Kanto al. 7A)";MEŠKIUKAI;5297214263;Ne;7;4;0;11
18752;"Pilaitukas (I. Kanto al. 7A)";MEŠKIUKAI;8268790017;Ne;5;0;0;5
18753;"Pilaitukas (I. Kanto al. 7A)";MEŠKIUKAI;2054626415;Ne;0;20;0;20
18754;"Pilaitukas (I. Kanto al. 7A)";MEŠKIUKAI;8322980583;Ne;18;0;0;18
18755;"Pilaitukas (I. Kanto al. 7A)";MEŠKIUKAI;1610122884;Ne;3;0;2;5
18756;"Pilaitukas (I. Kanto al. 7A)";MEŠKIUKAI;2365387089;Ne;0;5;0;5
18757;"Pilaitukas (I. Kanto al. 7A)";MEŠKIUKAI;9670329628;Ne;0;4;0;4
18758;"Pilaitukas (I. Kanto al. 7A)";MEŠKIUKAI;7750575554;Ne;15;0;0;15
18759;"Pilaitukas (I. Kanto al. 7A)";MEŠKIUKAI;4171896175;Ne;5;7;0;12
18760;"Pilaitukas (I. Kanto al. 7A)";MEŠKIUKAI;1362132769;Ne;7;0;0;7
18761;"Pilaitukas (I. Kanto al. 7A)";MEŠKIUKAI;6807166920;Ne;4;2;0;6
18762;"Pilaitukas (I. Kanto al. 7A)";MEŠKIUKAI;1591276987;Ne;0;0;2;2
18763;"Pilaitukas (I. Kanto al. 7A)";MEŠKIUKAI;8279288250;Ne;0;1;0;1
18764;"Pilaitukas (I. Kanto al. 7A)";ŽUVYTĖS;48011638560;Ne;1;0;0;1
18765;"Pilaitukas (I. Kanto al. 7A)";ŽUVYTĖS;36338976218;Ne;10;0;0;10
18766;"Pilaitukas (I. Kanto al. 7A)";ŽUVYTĖS;9224653856;Ne;9;0;0;9
18767;"Pilaitukas (I. Kanto al. 7A)";ŽUVYTĖS;4694691187;Ne;3;0;0;3
18768;"Pilaitukas (I. Kanto al. 7A)";ŽUVYTĖS;2110458181;Ne;0;6;0;6
18769;"Pilaitukas (I. Kanto al. 7A)";ŽUVYTĖS;5252233127;Ne;6;4;0;10
18770;"Pilaitukas (I. Kanto al. 7A)";ŽUVYTĖS;5206439753;Ne;0;3;0;3
18771;"Pilaitukas (I. Kanto al. 7A)";ŽUVYTĖS;6222888898;Ne;3;0;0;3
18772;"Pilaitukas (I. Kanto al. 7A)";ŽUVYTĖS;1512181401;Ne;1;1;0;2
18773;"Pilaitukas (I. Kanto al. 7A)";ŽUVYTĖS;5949185075;Ne;5;0;0;5
18774;"Pilaitukas (I. Kanto al. 7A)";ŽUVYTĖS;2117570444;Ne;0;1;0;1
18775;"Pilaitukas (I. Kanto al. 7A)";ŽUVYTĖS;79485847381;Ne;0;1;0;1
18776;"Pilaitukas (I. Kanto al. 7A)";ŽUVYTĖS;7909465673;Ne;2;0;0;2
18777;"Pilaitukas (I. Kanto al. 7A)";ŽUVYTĖS;4505384039;Ne;0;1;0;1
18778;"Pilaitukas (I. Kanto al. 7A)";ŽUVYTĖS;1618432877;Ne;1;0;0;1
18779;"Pilaitukas (I. Kanto al. 7A)";ŽUVYTĖS;9724892897;Ne;16;0;0;16
18780;"Pilaitukas (I. Kanto al. 7A)";ŽUVYTĖS;3821748678;Ne;6;0;0;6
18781;"Pilaitukas (I. Kanto al. 7A)";ŽUVYTĖS;1114477688;Ne;0;10;0;10
18782;"Pilaitukas (I. Kanto al. 7A)";PAUKŠTELIAI;3325511140;Ne;0;3;0;3
18783;"Pilaitukas (I. Kanto al. 7A)";PAUKŠTELIAI;6514784647;Ne;0;1;0;1
18784;"Pilaitukas (I. Kanto al. 7A)";PAUKŠTELIAI;1135880899;Ne;0;1;0;1
18785;"Pilaitukas (I. Kanto al. 7A)";PAUKŠTELIAI;18466900688;Ne;0;2;0;2
18786;"Pilaitukas (I. Kanto al. 7A)";PAUKŠTELIAI;4038320896;Ne;8;7;0;15
18787;"Pilaitukas (I. Kanto al. 7A)";PAUKŠTELIAI;3794882532;Ne;0;1;1;2
18788;"Pilaitukas (I. Kanto al. 7A)";PAUKŠTELIAI;5689385925;Ne;4;1;0;5
18789;"Pilaitukas (I. Kanto al. 7A)";PAUKŠTELIAI;39600380611;Ne;0;1;1;2
18790;"Pilaitukas (I. Kanto al. 7A)";PAUKŠTELIAI;3214740183;Ne;0;1;0;1
18791;"Pilaitukas (I. Kanto al. 7A)";PAUKŠTELIAI;9924612250;Ne;0;0;8;8
18792;"Pilaitukas (I. Kanto al. 7A)";PAUKŠTELIAI;9618329726;Ne;0;2;0;2
18793;"Pilaitukas (I. Kanto al. 7A)";PAUKŠTELIAI;1003278169;Ne;1;1;0;2
18794;"Pilaitukas (I. Kanto al. 7A)";PAUKŠTELIAI;9450834035;Ne;0;3;0;3
18795;"Pilaitukas (I. Kanto al. 7A)";PAUKŠTELIAI;5604992163;Ne;0;3;0;3
18796;"Pilaitukas (I. Kanto al. 7A)";PAUKŠTELIAI;14554050141;Ne;0;1;0;1
18797;"Pilaitukas (I. Kanto al. 7A)";PAUKŠTELIAI;1693309238;Ne;0;6;0;6
18798;"Pilaitukas (I. Kanto al. 7A)";BORUŽĖLĖS;8364902911;Taip;1;2;0;3
18799;"Pilaitukas (I. Kanto al. 7A)";BORUŽĖLĖS;5063602139;Ne;7;0;0;7
18800;"Pilaitukas (I. Kanto al. 7A)";BORUŽĖLĖS;5984878126;Ne;5;4;0;9
18801;"Pilaitukas (I. Kanto al. 7A)";BORUŽĖLĖS;9898379569;Ne;0;0;3;3
18802;"Pilaitukas (I. Kanto al. 7A)";BORUŽĖLĖS;5324806808;Ne;0;0;9;9
18803;"Pilaitukas (I. Kanto al. 7A)";BORUŽĖLĖS;5185051301;Ne;7;0;0;7
18804;"Pilaitukas (I. Kanto al. 7A)";BORUŽĖLĖS;1731106179;Ne;7;5;1;13
18805;"Pilaitukas (I. Kanto al. 7A)";BORUŽĖLĖS;3784944532;Ne;10;0;1;11
18806;"Pilaitukas (I. Kanto al. 7A)";BORUŽĖLĖS;5186675623;Ne;0;0;3;3
18807;"Pilaitukas (I. Kanto al. 7A)";BORUŽĖLĖS;4317406707;Ne;8;0;0;8
18808;"Pilaitukas (I. Kanto al. 7A)";BORUŽĖLĖS;8380819975;Ne;4;4;1;9
18809;"Pilaitukas (I. Kanto al. 7A)";BORUŽĖLĖS;1944443723;Ne;15;0;1;16
18810;"Pilaitukas (I. Kanto al. 7A)";DRUGELIAI;1677962644;Ne;9;2;0;11
18811;"Pilaitukas (I. Kanto al. 7A)";DRUGELIAI;4745358362;Ne;9;2;0;11
18812;"Pilaitukas (I. Kanto al. 7A)";DRUGELIAI;2917197418;Ne;6;0;0;6
18813;"Pilaitukas (I. Kanto al. 7A)";DRUGELIAI;6712878938;Taip;19;0;0;19
18814;"Pilaitukas (I. Kanto al. 7A)";DRUGELIAI;3298272815;Taip;20;0;0;20
18815;"Pilaitukas (I. Kanto al. 7A)";DRUGELIAI;3772830210;Ne;4;0;5;9
18816;"Pilaitukas (I. Kanto al. 7A)";DRUGELIAI;4719223490;Ne;15;0;1;16
18817;"Pilaitukas (I. Kanto al. 7A)";DRUGELIAI;9414051187;Taip;0;0;8;8
18818;"Pilaitukas (I. Kanto al. 7A)";DRUGELIAI;6280870972;Ne;12;0;3;15
18819;"Pilaitukas (I. Kanto al. 7A)";DRUGELIAI;9741985709;Ne;14;0;0;14
18820;"Pilaitukas (I. Kanto al. 7A)";DRUGELIAI;7807341574;Ne;6;0;0;6
18821;"Pilaitukas (I. Kanto al. 7A)";DRUGELIAI;5215800828;Ne;3;4;0;7
18822;"Pilaitukas (I. Kanto al. 7A)";DRUGELIAI;2414941263;Ne;9;0;2;11
18823;"Pilaitukas (I. Kanto al. 7A)";DRUGELIAI;2210253038;Taip;14;4;0;18
18824;"Pilaitukas (I. Kanto al. 7A)";DRUGELIAI;8710069256;Ne;7;0;0;7
18825;"Pilaitukas (I. Kanto al. 7A)";DRUGELIAI;7830059468;Ne;19;0;0;19
18826;"Pilaitukas (I. Kanto al. 7A)";DRUGELIAI;7479542200;Ne;7;1;2;10
18827;"Pilaitukas (I. Kanto al. 7A)";DRUGELIAI;5901884512;Ne;14;0;0;14
18828;"Pilaitukas (I. Kanto al. 7A)";DRUGELIAI;1747834520;Ne;0;3;0;3
18829;"Pilaitukas (I. Kanto al. 7A)";PELIUKAI;9246925227;Ne;6;0;3;9
18830;"Pilaitukas (I. Kanto al. 7A)";PELIUKAI;7808204054;Ne;0;3;0;3
18831;"Pilaitukas (I. Kanto al. 7A)";PELIUKAI;4810825253;Ne;10;0;0;10
18832;"Pilaitukas (I. Kanto al. 7A)";PELIUKAI;8769116377;Ne;0;0;5;5
18833;"Pilaitukas (I. Kanto al. 7A)";PELIUKAI;8501376663;Ne;0;1;0;1
18834;"Pilaitukas (I. Kanto al. 7A)";PELIUKAI;3395656390;Ne;0;0;1;1
18835;"Pilaitukas (I. Kanto al. 7A)";PELIUKAI;5421602723;Ne;0;2;0;2
18836;"Pilaitukas (I. Kanto al. 7A)";PELIUKAI;8168228529;Ne;8;1;0;9
18837;"Pilaitukas (I. Kanto al. 7A)";PELIUKAI;4014329370;Ne;4;0;1;5
18838;"Pilaitukas (I. Kanto al. 7A)";PELIUKAI;6833933586;Ne;0;2;0;2
18839;"Pilaitukas (I. Kanto al. 7A)";PELIUKAI;2416277190;Ne;9;0;0;9
18840;"Pilaitukas (I. Kanto al. 7A)";PELIUKAI;9774222130;Ne;3;1;0;4
18841;"Pilaitukas (I. Kanto al. 7A)";PELIUKAI;1270365948;Ne;1;0;0;1
18842;"Pilaitukas (I. Kanto al. 7A)";PELIUKAI;7604004800;Ne;0;1;0;1
18843;"Pilaitukas (I. Kanto al. 7A)";PELIUKAI;9556421129;Ne;1;0;0;1
18844;"Pilaitukas (I. Kanto al. 7A)";PELIUKAI;3954210452;Ne;11;0;0;11
18845;"Pilaitukas (I. Kanto al. 7A)";PELIUKAI;5223336496;Ne;10;0;1;11
18846;"Pilaitukas (I. Kanto al. 7A)";PELIUKAI;3651140874;Ne;15;0;1;16
18847;"Pilaitukas (I. Kanto al. 7A)";PELIUKAI;2823859128;Ne;7;0;0;7
18848;"Pilaitukas (I. Kanto al. 7A)";PELIUKAI;7750936973;Ne;6;0;0;6
18849;"Pilaitukas (I. Kanto al. 7A)";KAČIUKAI;2406183145;Ne;0;6;0;6
18850;"Pilaitukas (I. Kanto al. 7A)";KAČIUKAI;2379660463;Ne;0;6;0;6
18851;"Pilaitukas (I. Kanto al. 7A)";KAČIUKAI;1585341963;Ne;0;1;0;1
18852;"Pilaitukas (I. Kanto al. 7A)";KAČIUKAI;9038324313;Ne;7;0;0;7
18853;"Pilaitukas (I. Kanto al. 7A)";KAČIUKAI;2463482642;Ne;2;0;0;2
18854;"Pilaitukas (I. Kanto al. 7A)";KAČIUKAI;3080014745;Ne;0;6;0;6
18855;"Pilaitukas (I. Kanto al. 7A)";KAČIUKAI;5353687011;Taip;10;3;0;13
18856;"Pilaitukas (I. Kanto al. 7A)";KAČIUKAI;6525191057;Ne;2;0;0;2
18857;"Pilaitukas (I. Kanto al. 7A)";KAČIUKAI;8009040109;Ne;2;0;1;3
18858;"Pilaitukas (I. Kanto al. 7A)";KAČIUKAI;2105380328;Ne;0;0;3;3
18859;"Pilaitukas (I. Kanto al. 7A)";KAČIUKAI;5326689274;Ne;12;0;1;13
18860;"Pilaitukas (I. Kanto al. 7A)";KAČIUKAI;9653647227;Ne;12;0;1;13
18861;"Pilaitukas (I. Kanto al. 7A)";KAČIUKAI;4022543517;Ne;0;2;0;2
18862;"Pilaitukas (I. Kanto al. 7A)";KAČIUKAI;3825942473;Ne;0;13;0;13
18863;"Pilaitukas (I. Kanto al. 7A)";KAČIUKAI;1611371690;Ne;20;0;0;20
18864;"Pilaitukas (I. Kanto al. 7A)";KAČIUKAI;9247501721;Ne;0;0;1;1
18865;"Pilaitukas (I. Kanto al. 7A)";KAČIUKAI;6436694057;Ne;0;0;1;1
18866;"Pilaitukas (I. Kanto al. 7A)";KAČIUKAI;9974310580;Ne;11;0;0;11
18867;"Pilaitukas (I. Kanto al. 7A)";KAČIUKAI;6235375235;Ne;9;0;1;10
18868;"Pilaitukas (I. Kanto al. 7A)";KAČIUKAI;9914575692;Ne;1;0;0;1
18869;"Pilaitukas (I. Kanto al. 7A)";SAULUTĖS;8047683859;Ne;11;0;0;11
18870;"Pilaitukas (I. Kanto al. 7A)";SAULUTĖS;8694369154;Ne;11;0;0;11
18871;"Pilaitukas (I. Kanto al. 7A)";SAULUTĖS;1052452915;Ne;16;0;1;17
18872;"Pilaitukas (I. Kanto al. 7A)";SAULUTĖS;2336933998;Ne;20;0;0;20
18873;"Pilaitukas (I. Kanto al. 7A)";SAULUTĖS;1134083816;Ne;12;0;0;12
18874;"Pilaitukas (I. Kanto al. 7A)";SAULUTĖS;2110996493;Ne;11;0;0;11
18875;"Pilaitukas (I. Kanto al. 7A)";SAULUTĖS;1452645899;Ne;9;0;0;9
18876;"Pilaitukas (I. Kanto al. 7A)";SAULUTĖS;9587140991;Ne;0;20;0;20
18877;"Pilaitukas (I. Kanto al. 7A)";SAULUTĖS;8306015313;Ne;0;8;0;8
18878;"Pilaitukas (I. Kanto al. 7A)";MENULIUKAI;6337917448;Ne;0;4;0;4
18879;"Pilaitukas (I. Kanto al. 7A)";MENULIUKAI;3636976107;Ne;0;4;0;4
18880;"Pilaitukas (I. Kanto al. 7A)";MENULIUKAI;5026344198;Ne;5;0;0;5
18881;"Pilaitukas (I. Kanto al. 7A)";MENULIUKAI;5564784922;Ne;6;0;0;6
18882;"Pilaitukas (I. Kanto al. 7A)";MENULIUKAI;1290017967;Ne;0;7;0;7
18883;"Pilaitukas (I. Kanto al. 7A)";MENULIUKAI;1841240800;Ne;6;0;0;6
18884;"Pilaitukas (I. Kanto al. 7A)";MENULIUKAI;4710865219;Ne;6;0;0;6
18885;"Pilaitukas (I. Kanto al. 7A)";MENULIUKAI;5691854235;Ne;5;0;0;5
18886;"Pilaitukas (I. Kanto al. 7A)";MENULIUKAI;6054821801;Ne;0;4;0;4
18887;"Pilaitukas (I. Kanto al. 7A)";MENULIUKAI;1620231835;Ne;3;2;0;5
18888;"Pilaitukas (I. Kanto al. 7A)";MENULIUKAI;8873155277;Ne;0;20;0;20
18889;"Pilaitukas (I. Kanto al. 7A)";MENULIUKAI;1532252453;Ne;20;0;0;20
18890;"Pilaitukas (I. Kanto al. 7A)";MENULIUKAI;8225571149;Ne;6;0;0;6
18891;"Pilaitukas (I. Kanto al. 7A)";MENULIUKAI;8207648026;Ne;9;0;0;9
18892;"Pilaitukas (I. Kanto al. 7A)";MENULIUKAI;3921932673;Ne;9;0;0;9
18893;"Pilaitukas (I. Kanto al. 7A)";MENULIUKAI;7855892595;Ne;5;0;0;5
18894;"Pilaitukas (I. Kanto al. 7A)";MENULIUKAI;8058057477;Ne;8;0;0;8
18895;"Pilaitukas (I. Kanto al. 7A)";MENULIUKAI;5682244165;Ne;1;0;0;1
18896;"Pilaitukas (I. Kanto al. 7A)";MENULIUKAI;3952708917;Ne;11;0;0;11
18897;"Pilaitukas (I. Kanto al. 7A)";ĖŽIUKAI;1568651642;Ne;0;0;6;6
18898;"Pilaitukas (I. Kanto al. 7A)";ĖŽIUKAI;2892275540;Ne;4;0;0;4
18899;"Pilaitukas (I. Kanto al. 7A)";ĖŽIUKAI;1746050808;Ne;8;2;0;10
18900;"Pilaitukas (I. Kanto al. 7A)";ĖŽIUKAI;2633256935;Ne;17;0;0;17
18901;"Pilaitukas (I. Kanto al. 7A)";ĖŽIUKAI;8747053041;Ne;17;0;0;17
18902;"Pilaitukas (I. Kanto al. 7A)";ĖŽIUKAI;7555601497;Ne;5;0;0;5
18903;"Pilaitukas (I. Kanto al. 7A)";ĖŽIUKAI;6019760696;Ne;4;0;1;5
18904;"Pilaitukas (I. Kanto al. 7A)";ĖŽIUKAI;5979852431;Ne;20;0;0;20
18905;"Pilaitukas (I. Kanto al. 7A)";ĖŽIUKAI;9950619644;Ne;3;0;2;5
18906;"Pilaitukas (I. Kanto al. 7A)";ĖŽIUKAI;8682279246;Taip;0;20;0;20
18907;"Pilaitukas (I. Kanto al. 7A)";ĖŽIUKAI;6271751691;Ne;9;0;0;9
18908;"Pilaitukas (I. Kanto al. 7A)";ĖŽIUKAI;9306169443;Ne;0;1;0;1
18909;"Pilaitukas (I. Kanto al. 7A)";ĖŽIUKAI;5155899628;Ne;16;0;0;16
18910;"Pilaitukas (I. Kanto al. 7A)";ĖŽIUKAI;5340877261;Ne;17;0;0;17
18911;"Pilaitukas (I. Kanto al. 7A)";ĖŽIUKAI;2342453729;Ne;6;1;0;7
18912;"Pilaitukas (I. Kanto al. 7A)";ĖŽIUKAI;6064545501;Ne;11;0;0;11
18913;"Pilaitukas (I. Kanto al. 7A)";ĖŽIUKAI;5904710385;Ne;10;0;0;10
18914;"Pilaitukas (I. Kanto al. 7A)";ĖŽIUKAI;1486895496;Ne;15;0;0;15
18915;"Pilaitukas (I. Kanto al. 7A)";ĖŽIUKAI;9441608677;Ne;4;0;0;4
18916;Vilija;BORUŽĖLĖS;6611278346;Ne;5;5;0;10
18917;Vilija;BORUŽĖLĖS;5979446899;Ne;3;0;1;4
18918;Vilija;BORUŽĖLĖS;3386809866;Ne;4;9;1;14
18919;Vilija;BORUŽĖLĖS;7980759563;Ne;0;0;5;5
18920;Vilija;BORUŽĖLĖS;6115055683;Ne;0;5;0;5
18921;Vilija;BORUŽĖLĖS;8995800590;Ne;0;0;9;9
18922;Vilija;BORUŽĖLĖS;4577389098;Ne;5;0;2;7
18923;Vilija;BORUŽĖLĖS;9806725516;Ne;0;0;3;3
18924;Vilija;BORUŽĖLĖS;4791053946;Ne;0;0;2;2
18925;Vilija;BORUŽĖLĖS;4755512150;Ne;0;3;0;3
18926;Vilija;BORUŽĖLĖS;7464020972;Ne;9;0;0;9
18927;Vilija;NYKŠTUKAI;8364033602;Ne;0;1;0;1
18928;Vilija;NYKŠTUKAI;6136579994;Ne;1;0;0;1
18929;Vilija;NYKŠTUKAI;1116822936;Ne;9;0;0;9
18930;Vilija;ANČIUKAI;5643311237;Ne;0;3;0;3
18931;Vilija;ANČIUKAI;9176710135;Ne;4;0;1;5
18932;Vilija;ANČIUKAI;8073341597;Ne;0;4;0;4
18933;Vilija;ANČIUKAI;8493278100;Ne;0;12;0;12
18934;Vilija;ANČIUKAI;3857271014;Ne;5;0;0;5
18935;Vilija;ANČIUKAI;3552472323;Ne;0;6;0;6
18936;Vilija;ANČIUKAI;5683016588;Ne;0;0;1;1
18937;Vilija;ANČIUKAI;7012683174;Ne;6;0;0;6
18938;Vilija;ANČIUKAI;6385918522;Taip;3;7;0;10
18939;Vilija;ANČIUKAI;4400813531;Ne;0;1;0;1
18940;Vilija;ANČIUKAI;5454031929;Ne;13;2;0;15
18941;Vilija;ANČIUKAI;4858617162;Ne;8;5;0;13
18942;Vilija;ANČIUKAI;8318388772;Ne;0;6;0;6
18943;Vilija;ANČIUKAI;3677313088;Ne;0;1;0;1
18944;Vilija;ANČIUKAI;6815408748;Ne;0;0;1;1
18945;Vilija;DRUGELIAI;2205400512;Taip;0;0;1;1
18946;Vilija;DRUGELIAI;2309358870;Ne;0;0;1;1
18947;Vilija;DRUGELIAI;5530078264;Ne;19;0;0;19
18948;Vilija;DRUGELIAI;3131712783;Ne;0;10;0;10
18949;Vilija;DRUGELIAI;2807100092;Ne;0;7;0;7
18950;Vilija;DRUGELIAI;5340772605;Ne;6;0;4;10
18951;Vilija;DRUGELIAI;8429923120;Ne;0;0;10;10
18952;Vilija;DRUGELIAI;7418104659;Ne;0;0;2;2
18953;Vilija;DRUGELIAI;3667953591;Ne;0;0;6;6
18954;Vilija;DRUGELIAI;9740915508;Ne;3;0;0;3
18955;Vilija;DRUGELIAI;7482818685;Ne;0;0;2;2
18956;Vilija;DRUGELIAI;5455278072;Ne;6;0;0;6
18957;Vilija;DRUGELIAI;3349199472;Taip;11;1;0;12
18958;Vilija;DRUGELIAI;6057668143;Ne;0;0;1;1
18959;Vilija;DRUGELIAI;8420744276;Ne;0;5;0;5
18960;Vilija;SMERFAI;7927617851;Ne;9;0;0;9
18961;Vilija;SMERFAI;2164009051;Ne;0;1;0;1
18962;Vilija;SMERFAI;3021504467;Ne;5;0;0;5
18963;Vilija;SMERFAI;3058713381;Ne;5;0;0;5
18964;Vilija;SMERFAI;5976988338;Ne;4;0;0;4
18965;Vilija;SMERFAI;5825920843;Ne;7;0;0;7
18966;Vilija;SAULUTĖS;1442878380;Ne;10;0;0;10
18967;Vilija;SAULUTĖS;5561043797;Ne;7;0;0;7
18968;Vilija;SAULUTĖS;7673248841;Ne;0;2;0;2
18969;Vilija;SAULUTĖS;4481147539;Ne;1;7;0;8
18970;Vilija;SAULUTĖS;7915451529;Ne;4;0;0;4
18971;Vilija;SAULUTĖS;7880863171;Ne;3;0;0;3
18972;Vilija;SAULUTĖS;7603226092;Ne;5;0;0;5
18973;Vilija;SAULUTĖS;2551070326;Ne;1;0;0;1
18974;Vilija;ZUIKUČIAI;5128863532;Ne;2;0;0;2
18975;Vilija;ZUIKUČIAI;9726826566;Ne;0;4;0;4
18976;Vilija;ZUIKUČIAI;8586835095;Ne;9;0;0;9
18977;Vilija;ZUIKUČIAI;4985952177;Ne;11;0;2;13
18978;Vilija;ZUIKUČIAI;4774836050;Ne;6;0;4;10
18979;Vilija;ZUIKUČIAI;9414667437;Ne;0;5;0;5
18980;Vilija;ZUIKUČIAI;9264550987;Ne;0;0;1;1
18981;Vilija;ZUIKUČIAI;5381198018;Ne;0;1;0;1
18982;Vilija;ZUIKUČIAI;4355138593;Ne;10;1;0;11
18983;Vilija;ZUIKUČIAI;5735417577;Ne;8;0;0;8
18984;Vilija;ZUIKUČIAI;9370046849;Ne;5;0;0;5
18985;Vilija;ZUIKUČIAI;7109895494;Ne;17;0;0;17
18986;Vilija;ZUIKUČIAI;4444129040;Ne;0;1;0;1
18987;Vilija;ZUIKUČIAI;3168061557;Ne;9;0;4;13
18988;Vilija;ZUIKUČIAI;5492194393;Ne;8;2;0;10
18989;Vilija;ZUIKUČIAI;4818901769;Ne;3;0;4;7
18990;Vilija;ZUIKUČIAI;6759928420;Ne;9;0;0;9
18991;Vilija;ZUIKUČIAI;4839841253;Ne;0;0;2;2
18992;Vilija;BITUTĖS;9419794080;Ne;5;5;0;10
18993;Vilija;BITUTĖS;1019420340;Ne;7;0;0;7
18994;Vilija;BITUTĖS;5132828941;Ne;9;0;0;9
18995;Vilija;BITUTĖS;9218278301;Ne;0;2;0;2
18996;Vilija;BITUTĖS;9174484523;Ne;9;0;0;9
18997;Vilija;BITUTĖS;5102754179;Ne;3;0;0;3
18998;Vilija;BITUTĖS;4743123463;Ne;6;0;0;6
18999;Vilija;BITUTĖS;8499318976;Ne;0;3;0;3
19000;Vilija;BITUTĖS;8426011190;Ne;6;0;0;6
19001;Vilija;BITUTĖS;8173954240;Ne;11;0;0;11
19002;Vilija;BITUTĖS;1804898751;Ne;11;0;0;11
19003;Vilija;BITUTĖS;5651708105;Ne;9;0;0;9
19004;Vilija;BITUTĖS;9250902486;Ne;9;0;0;9
19005;Vilija;BITUTĖS;4137025486;Ne;0;1;0;1
19006;Vilija;BITUTĖS;7004389875;Ne;0;1;0;1
19007;Vilija;"Pingviniukai (Laisvės pr. 57)";2731415182;Ne;0;0;5;5
19008;Vilija;"Pingviniukai (Laisvės pr. 57)";4639407305;Ne;7;0;0;7
19009;Vilija;"Pingviniukai (Laisvės pr. 57)";2859663283;Ne;0;0;1;1
19010;Vilija;"Pingviniukai (Laisvės pr. 57)";7815069972;Ne;0;0;1;1
19011;Vilija;"Pingviniukai (Laisvės pr. 57)";6625339545;Ne;9;0;6;15
19012;Vilija;"Pingviniukai (Laisvės pr. 57)";1840182282;Ne;0;0;7;7
19013;Vilija;"Pingviniukai (Laisvės pr. 57)";2442272908;Ne;11;0;0;11
19014;Vilija;"Pingviniukai (Laisvės pr. 57)";2872066559;Ne;12;0;0;12
19015;Vilija;"Pingviniukai (Laisvės pr. 57)";7219010961;Ne;0;0;3;3
19016;Vilija;"Pingviniukai (Laisvės pr. 57)";2012412360;Ne;16;0;0;16
19017;Vilija;"Pingviniukai (Laisvės pr. 57)";6855296751;Ne;6;0;0;6
19018;Vilija;"Pingviniukai (Laisvės pr. 57)";2506766222;Ne;0;2;0;2
19019;Vilija;"Pingviniukai (Laisvės pr. 57)";2076388581;Ne;12;0;0;12
19020;Vilija;"Meškiukai (Laisvės pr. 57)";1337656706;Ne;19;0;0;19
19021;Vilija;"Meškiukai (Laisvės pr. 57)";7518841522;Ne;17;0;0;17
19022;Vilija;"Meškiukai (Laisvės pr. 57)";3225442553;Ne;0;0;4;4
19023;Vilija;"Meškiukai (Laisvės pr. 57)";3700333490;Ne;14;0;0;14
19024;Vilija;"Meškiukai (Laisvės pr. 57)";2725051611;Ne;12;0;0;12
19025;Vilija;"Meškiukai (Laisvės pr. 57)";1233653513;Ne;6;0;0;6
19026;Vilija;"Meškiukai (Laisvės pr. 57)";7735728034;Ne;0;3;0;3
19027;Vilija;"Meškiukai (Laisvės pr. 57)";7947071463;Ne;0;0;1;1
19028;Vilija;"Meškiukai (Laisvės pr. 57)";4921409780;Ne;12;0;0;12
19029;Vilija;"Meškiukai (Laisvės pr. 57)";5698897949;Ne;16;0;0;16
19030;Vilija;"Meškiukai (Laisvės pr. 57)";8165784270;Ne;0;0;3;3
19031;Vilija;"Meškiukai (Laisvės pr. 57)";9163803569;Ne;1;0;2;3
19032;Vilija;"Meškiukai (Laisvės pr. 57)";2501118611;Ne;0;0;4;4
19033;Vilija;"Meškiukai (Laisvės pr. 57)";7001209450;Ne;5;5;1;11
19034;Vilija;"Meškiukai (Laisvės pr. 57)";5166455649;Ne;1;0;0;1
19035;Vilija;"Ramunėlės (Laisvės pr. 57)";7707208780;Ne;0;5;0;5
19036;Vilija;"Ramunėlės (Laisvės pr. 57)";7226615203;Ne;6;0;6;12
19037;Vilija;"Ramunėlės (Laisvės pr. 57)";9261213181;Ne;0;0;2;2
19038;Vilija;"Ramunėlės (Laisvės pr. 57)";5034597412;Ne;8;4;0;12
19039;Vilija;"Ramunėlės (Laisvės pr. 57)";5999958057;Ne;9;1;0;10
19040;Vilija;"Ramunėlės (Laisvės pr. 57)";6142340523;Ne;0;0;3;3
19041;Vilija;"Ramunėlės (Laisvės pr. 57)";4798370162;Ne;20;0;0;20
19042;Vilija;"Ramunėlės (Laisvės pr. 57)";2036033312;Ne;3;0;0;3
19043;Vilija;"Ramunėlės (Laisvės pr. 57)";1902217772;Ne;3;0;0;3
19044;Vilija;"Ramunėlės (Laisvės pr. 57)";9377088075;Ne;0;0;2;2
19045;Vilija;"Ramunėlės (Laisvės pr. 57)";6177733291;Ne;1;0;0;1
19046;Vilija;"Ramunėlės (Laisvės pr. 57)";2455384784;Ne;10;0;0;10
19047;Vilija;"Ramunėlės (Laisvės pr. 57)";9278725667;Ne;7;0;0;7
19048;Vilija;"Ramunėlės (Laisvės pr. 57)";7288035130;Ne;7;0;0;7
19049;Vilija;"Varpeliai (Laisvės pr. 57)";6742119549;Taip;7;6;1;14
19050;Vilija;"Varpeliai (Laisvės pr. 57)";2948716989;Taip;0;1;0;1
19051;Vilija;"Varpeliai (Laisvės pr. 57)";6525761466;Taip;5;0;0;5
19052;Vilija;"Varpeliai (Laisvės pr. 57)";5277217733;Ne;0;0;2;2
19053;Vilija;"Varpeliai (Laisvės pr. 57)";3346154143;Taip;5;2;0;7
19054;Vilija;"Varpeliai (Laisvės pr. 57)";1502013942;Taip;14;0;1;15
19055;Vilija;"Varpeliai (Laisvės pr. 57)";2190583964;Taip;0;0;1;1
19056;Vilija;"Varpeliai (Laisvės pr. 57)";3920229653;Taip;0;0;1;1
19057;Vilija;"Varpeliai (Laisvės pr. 57)";4969561425;Ne;9;0;2;11
19058;Vilija;"Varpeliai (Laisvės pr. 57)";8092890260;Taip;8;2;0;10
19059;Vilija;"Varpeliai (Laisvės pr. 57)";3998988004;Taip;0;0;8;8
19060;Vilija;"Varpeliai (Laisvės pr. 57)";6756184787;Taip;0;0;5;5
19061;Vilija;"Varpeliai (Laisvės pr. 57)";4288487063;Taip;1;0;1;2
19062;Vilija;"Varpeliai (Laisvės pr. 57)";5768470608;Taip;6;0;0;6
19063;Vilija;"Varpeliai (Laisvės pr. 57)";3589001032;Ne;0;0;5;5
19064;Vilija;"Varpeliai (Laisvės pr. 57)";4692443164;Ne;20;0;0;20
19065;Vilija;"Varpeliai (Laisvės pr. 57)";7426713153;Ne;0;0;3;3
19066;Vilija;"Varpeliai (Laisvės pr. 57)";5734602455;Taip;0;0;1;1
19067;Vilija;"Varpeliai (Laisvės pr. 57)";4562536818;Taip;0;0;2;2
19068;Vilija;"Varpeliai (Laisvės pr. 57)";6226967695;Ne;0;0;2;2
19069;Vilija;"Varpeliai (Laisvės pr. 57)";3062594197;Ne;14;0;0;14
19070;Vilija;"Voveraitės (Laisvės pr. 57)";7522129675;Ne;10;0;3;13
19071;Vilija;"Voveraitės (Laisvės pr. 57)";1807028630;Ne;7;0;0;7
19072;Vilija;"Voveraitės (Laisvės pr. 57)";4868770355;Taip;17;0;2;19
19073;Vilija;"Voveraitės (Laisvės pr. 57)";8923074604;Ne;6;2;0;8
19074;Vilija;"Voveraitės (Laisvės pr. 57)";9809985578;Ne;0;0;4;4
19075;Vilija;"Voveraitės (Laisvės pr. 57)";3464990457;Ne;5;3;0;8
19076;Vilija;"Voveraitės (Laisvės pr. 57)";5229557734;Ne;10;0;0;10
19077;Vilija;"Voveraitės (Laisvės pr. 57)";8758253294;Ne;0;1;2;3
19078;Vilija;"Voveraitės (Laisvės pr. 57)";6496861835;Ne;11;0;0;11
19079;Vilija;"Voveraitės (Laisvės pr. 57)";6782229835;Ne;6;4;0;10
19080;Vilija;"Voveraitės (Laisvės pr. 57)";2910501252;Ne;6;0;2;8
19081;Vilija;"Voveraitės (Laisvės pr. 57)";3899016982;Ne;1;0;0;1
19082;Vilija;"Voveraitės (Laisvės pr. 57)";4873345183;Ne;1;0;4;5
19083;Vilija;"Voveraitės (Laisvės pr. 57)";9638268554;Ne;6;0;0;6
19084;Vilija;"Voveraitės (Laisvės pr. 57)";3654655172;Ne;8;1;0;9
19085;Vilija;"Voveraitės (Laisvės pr. 57)";7184118489;Ne;0;0;1;1
19086;Vilija;"Voveraitės (Laisvės pr. 57)";3095065890;Ne;9;0;0;9
19087;Vilija;"Pelėdžiukai (Laisvės pr. 57)";3269357241;Taip;17;0;0;17
19088;Vilija;"Pelėdžiukai (Laisvės pr. 57)";2055282010;Ne;1;0;0;1
19089;Vilija;"Pelėdžiukai (Laisvės pr. 57)";7358925256;Ne;1;0;0;1
19090;Vilija;"Pelėdžiukai (Laisvės pr. 57)";2778931038;Ne;7;0;10;17
19091;Vilija;"Pelėdžiukai (Laisvės pr. 57)";8465864375;Ne;7;0;0;7
19092;Vilija;"Pelėdžiukai (Laisvės pr. 57)";7784329873;Ne;12;0;0;12
19093;Vilija;"Pelėdžiukai (Laisvės pr. 57)";4437786689;Ne;15;0;0;15
19094;Vilija;"Pelėdžiukai (Laisvės pr. 57)";7089883250;Ne;6;0;2;8
19095;Vilija;"Pelėdžiukai (Laisvės pr. 57)";5043122065;Taip;1;0;0;1
19096;Vilija;"Pelėdžiukai (Laisvės pr. 57)";3581180895;Ne;0;0;2;2
19097;Vilija;"Pelėdžiukai (Laisvės pr. 57)";1306244736;Ne;11;4;0;15
19098;Vilija;"Pelėdžiukai (Laisvės pr. 57)";8608907350;Ne;3;0;1;4
19099;Vilija;"Pelėdžiukai (Laisvės pr. 57)";9117896572;Ne;0;9;0;9
19100;Vilija;"Pelėdžiukai (Laisvės pr. 57)";5821077318;Ne;0;11;5;16
19101;Vilija;"Pelėdžiukai (Laisvės pr. 57)";8186421282;Ne;9;0;1;10
19102;Vilija;"Pelėdžiukai (Laisvės pr. 57)";8815055819;Ne;0;8;0;8
19103;Vilija;"Pelėdžiukai (Laisvės pr. 57)";9750688419;Ne;0;8;0;8
19104;Vilija;"Pelėdžiukai (Laisvės pr. 57)";1778722493;Ne;7;0;0;7
19105;Vilija;"Pelėdžiukai (Laisvės pr. 57)";9915113607;Ne;15;0;0;15
19106;Vilija;"Pelėdžiukai (Laisvės pr. 57)";6581404954;Ne;0;0;1;1
19107;Vilija;"Pelėdžiukai (Laisvės pr. 57)";7869675895;Ne;12;0;0;12
19108;Vilija;"Pelėdžiukai (Laisvės pr. 57)";7697727530;Ne;0;0;5;5
19109;Vilija;"1 A klasė";93217431744;Ne;6;0;0;6
19110;Vilija;"1 B klasė";46757944454;Ne;7;0;0;7
19111;Vilija;"1 B klasė";1163483318;Ne;6;0;0;6
19112;Vilija;"1 B klasė";8793138240;Ne;3;0;0;3
19113;Vilija;"2 A klasė";13479943342;Ne;2;0;0;2
19114;Vilija;"2 A klasė";13479943342;Ne;2;0;0;2
19115;Vilija;"3 A klasė";2040557798;Ne;1;0;0;1
19116;Vilija;"3 A klasė";2040557798;Ne;1;0;0;1
19117;Vilija;"3 B klasė";44674068414;Ne;5;0;0;5
19118;Vilija;"3 B klasė";44674068414;Ne;5;0;0;5
19119;Vilija;"3 B klasė";44674068414;Ne;5;0;0;5
19120;Vilija;"4 A klasė";3184088380;Ne;6;0;0;6
19121;Vilija;"4 A klasė";3184088380;Ne;6;0;0;6
19122;Vilija;"4 A klasė";1546363831;Ne;2;0;0;2
19123;Vilija;"4 B klasė";35111018435;Ne;6;0;0;6
19124;Vilija;"4 B klasė";85447158165;Ne;1;0;0;1
19125;Švelnukas;Pelėdžiukai;8016531082;Ne;0;12;8;20
19126;Švelnukas;Pelėdžiukai;8219071968;Ne;2;1;6;9
19127;Švelnukas;Pelėdžiukai;3235768013;Ne;2;0;0;2
19128;Švelnukas;Pelėdžiukai;9008722163;Ne;0;3;0;3
19129;Švelnukas;Pelėdžiukai;5699300764;Ne;4;0;0;4
19130;Švelnukas;Pelėdžiukai;1116279011;Ne;8;0;0;8
19131;Švelnukas;Pelėdžiukai;3892058023;Ne;8;0;0;8
19132;Švelnukas;Pelėdžiukai;5681611554;Ne;0;1;0;1
19133;Švelnukas;Pelėdžiukai;8589226595;Ne;18;0;0;18
19134;Švelnukas;Pelėdžiukai;5041138716;Ne;0;3;0;3
19135;Švelnukas;Pelėdžiukai;3804532959;Ne;7;0;0;7
19136;Švelnukas;Pelėdžiukai;8650902343;Ne;1;0;1;2
19137;Švelnukas;Pelėdžiukai;1409803554;Ne;0;6;0;6
19138;Švelnukas;Pelėdžiukai;1991507109;Ne;0;5;0;5
19139;Švelnukas;Pelėdžiukai;9808833734;Ne;0;0;1;1
19140;Švelnukas;Pelėdžiukai;6069027553;Ne;0;1;0;1
19141;Švelnukas;Pelėdžiukai;9814032171;Ne;9;0;1;10
19142;Švelnukas;Ežiukai;64192510147;Ne;9;1;0;10
19143;Švelnukas;Ežiukai;25374873288;Ne;0;1;0;1
19144;Švelnukas;Ežiukai;23795609183;Ne;3;0;1;4
19145;Švelnukas;Ežiukai;8399963483;Ne;0;4;4;8
19146;Švelnukas;Ežiukai;4711482287;Ne;0;1;0;1
19147;Švelnukas;Ežiukai;8681264696;Ne;0;1;0;1
19148;Švelnukas;Ežiukai;2521009631;Ne;0;0;2;2
19149;Švelnukas;Ežiukai;1165172787;Ne;6;0;0;6
19150;Švelnukas;Ežiukai;2892176166;Ne;4;0;0;4
19151;Švelnukas;Ežiukai;7308701231;Ne;0;0;1;1
19152;Švelnukas;Ežiukai;6209334207;Ne;12;0;0;12
19153;Švelnukas;Ežiukai;1201550386;Ne;0;0;1;1
19154;Švelnukas;Ežiukai;7266255326;Ne;0;2;0;2
19155;Švelnukas;Ežiukai;2348752207;Ne;0;20;0;20
19156;Švelnukas;Ežiukai;1143579276;Ne;5;0;1;6
19157;Švelnukas;Ežiukai;9402567487;Ne;1;0;3;4
19158;Švelnukas;Ežiukai;8569985034;Ne;0;8;0;8
19159;Švelnukas;Švelnukai;4681584014;Ne;0;0;8;8
19160;Švelnukas;Švelnukai;6607578153;Ne;10;0;0;10
19161;Švelnukas;Švelnukai;8847738918;Ne;0;1;0;1
19162;Švelnukas;Švelnukai;1982267458;Ne;0;0;2;2
19163;Švelnukas;Švelnukai;9766734938;Ne;0;3;2;5
19164;Švelnukas;Švelnukai;3020524039;Ne;7;2;0;9
19165;Švelnukas;Švelnukai;9829912750;Ne;0;4;3;7
19166;Švelnukas;Švelnukai;2464467471;Ne;5;0;0;5
19167;Švelnukas;Švelnukai;5213589179;Ne;5;4;0;9
19168;Švelnukas;Švelnukai;1963518457;Ne;0;0;1;1
19169;Švelnukas;Švelnukai;5936821902;Ne;0;0;2;2
19170;Švelnukas;Švelnukai;3228293160;Ne;0;5;0;5
19171;Švelnukas;Švelnukai;7607215137;Ne;3;0;0;3
19172;Švelnukas;Švelnukai;4629757899;Ne;0;2;0;2
19173;Švelnukas;Švelnukai;6964997767;Ne;0;0;4;4
19174;Švelnukas;Švelnukai;8951810066;Ne;10;0;0;10
19175;Švelnukas;Švelnukai;2663990082;Ne;5;0;3;8
19176;Švelnukas;Švelnukai;6204286255;Ne;0;1;2;3
19177;Švelnukas;Švelnukai;5960966542;Ne;5;1;4;10
19178;Švelnukas;Boružiukai;1951447127;Ne;4;0;0;4
19179;Švelnukas;Boružiukai;3849957906;Ne;0;0;17;17
19180;Švelnukas;Boružiukai;5550841477;Ne;6;0;4;10
19181;Švelnukas;Boružiukai;9722532034;Ne;0;1;0;1
19182;Švelnukas;Boružiukai;1264256177;Ne;0;1;2;3
19183;Švelnukas;Boružiukai;1332533332;Ne;0;0;6;6
19184;Švelnukas;Boružiukai;7967996032;Ne;5;0;0;5
19185;Švelnukas;Boružiukai;8951980999;Ne;0;0;1;1
19186;Švelnukas;Boružiukai;4990399144;Ne;0;4;0;4
19187;Švelnukas;Boružiukai;9575767514;Ne;5;0;8;13
19188;Švelnukas;Boružiukai;6282137936;Ne;0;5;0;5
19189;Švelnukas;Boružiukai;2077614498;Ne;6;0;0;6
19190;Švelnukas;Boružiukai;4404904322;Ne;0;0;6;6
19191;Švelnukas;Boružiukai;8895028305;Ne;10;0;2;12
19192;Švelnukas;Boružiukai;4961854528;Ne;9;0;0;9
19193;Švelnukas;Smalsučiai;9558811523;Ne;0;0;2;2
19194;Švelnukas;Smalsučiai;1661019352;Ne;0;2;0;2
19195;Švelnukas;Smalsučiai;5554625346;Ne;0;1;0;1
19196;Švelnukas;Smalsučiai;3282020958;Ne;0;1;0;1
19197;Švelnukas;Smalsučiai;5805289419;Ne;0;0;1;1
19198;Švelnukas;Smalsučiai;1415899173;Ne;0;0;1;1
19199;Švelnukas;Smalsučiai;7987715134;Ne;4;0;0;4
19200;Švelnukas;Smalsučiai;3455801077;Ne;0;20;0;20
19201;Švelnukas;Smalsučiai;8193690277;Ne;5;1;4;10
19202;Švelnukas;Smalsučiai;9371102717;Ne;0;20;0;20
19203;Švelnukas;Smalsučiai;3472774028;Ne;4;0;0;4
19204;Švelnukas;Smalsučiai;5845744917;Ne;0;0;4;4
19205;Švelnukas;Smalsučiai;6764222588;Ne;0;0;13;13
19206;Švelnukas;Smalsučiai;1840752560;Ne;0;11;2;13
19207;Švelnukas;Smalsučiai;8268391509;Ne;6;0;1;7
19208;Švelnukas;Smalsučiai;4467095100;Ne;0;0;3;3
19209;Švelnukas;Nykštukai;5518267134;Ne;0;0;1;1
19210;Švelnukas;Nykštukai;2141519946;Ne;0;1;0;1
19211;Švelnukas;Nykštukai;8771953161;Ne;0;0;4;4
19212;Švelnukas;Nykštukai;5327209876;Ne;0;2;0;2
19213;Švelnukas;Nykštukai;2282356211;Ne;5;1;0;6
19214;Švelnukas;Nykštukai;4697253853;Ne;0;0;1;1
19215;Švelnukas;Nykštukai;7387060610;Ne;0;1;0;1
19216;Švelnukas;Nykštukai;1762528313;Ne;0;0;1;1
19217;Švelnukas;Nykštukai;6633233824;Ne;0;0;5;5
19218;Švelnukas;Nykštukai;2106591525;Ne;0;1;0;1
19219;Švelnukas;Nykštukai;93497358197;Ne;0;2;0;2
19220;Švelnukas;Nykštukai;4302735157;Ne;0;0;2;2
19221;Švelnukas;Nykštukai;2785396019;Ne;0;0;9;9
19222;Švelnukas;Nykštukai;6195335543;Ne;0;4;0;4
19223;Boružėlė;"Nykštukai gudručiai";3340082011;Ne;9;1;0;10
19224;Boružėlė;"Nykštukai gudručiai";7736917485;Ne;5;2;2;9
19225;Boružėlė;"Nykštukai gudručiai";9520696660;Ne;0;0;2;2
19226;Boružėlė;"Nykštukai gudručiai";5691884576;Ne;1;5;0;6
19227;Boružėlė;"Nykštukai gudručiai";9193273478;Ne;0;0;3;3
19228;Boružėlė;"Nykštukai gudručiai";3237771499;Ne;4;0;0;4
19229;Boružėlė;"Nykštukai gudručiai";8359957290;Ne;0;2;9;11
19230;Boružėlė;"Nykštukai gudručiai";8141240094;Ne;0;0;20;20
19231;Boružėlė;"Nykštukai gudručiai";2349571778;Ne;1;4;0;5
19232;Boružėlė;"Nykštukai gudručiai";1894170218;Ne;0;1;0;1
19233;Boružėlė;"Nykštukai gudručiai";3509512899;Ne;3;2;0;5
19234;Boružėlė;"Nykštukai gudručiai";8888151470;Ne;3;2;1;6
19235;Boružėlė;"Nykštukai gudručiai";3430953692;Ne;7;5;0;12
19236;Boružėlė;"Nykštukai gudručiai";8365962523;Ne;3;0;5;8
19237;Boružėlė;"Nykštukai gudručiai";3592853535;Ne;6;1;0;7
19238;Boružėlė;"Nykštukai gudručiai";6876323023;Ne;0;2;0;2
19239;Boružėlė;"Nykštukai gudručiai";2744894565;Ne;0;2;0;2
19240;Boružėlė;"Nykštukai gudručiai";6590829182;Ne;1;2;0;3
19241;Boružėlė;"Nykštukai gudručiai";3129825206;Ne;0;7;0;7
19242;Boružėlė;"Nykštukai gudručiai";9771767352;Ne;5;1;0;6
19243;Boružėlė;"Nykštukai gudručiai";8789209196;Ne;6;0;1;7
19244;Boružėlė;"Nykštukai gudručiai";2571360077;Ne;4;2;0;6
19245;Boružėlė;"Nykštukai gudručiai";9078805020;Ne;0;4;0;4
19246;Boružėlė;"Saulės zuikučiai";4554260776;Ne;9;3;0;12
19247;Boružėlė;"Saulės zuikučiai";5298170118;Ne;0;4;2;6
19248;Boružėlė;"Saulės zuikučiai";2133849514;Ne;0;3;0;3
19249;Boružėlė;"Saulės zuikučiai";1116012068;Ne;5;2;1;8
19250;Boružėlė;"Saulės zuikučiai";1292298259;Ne;6;0;1;7
19251;Boružėlė;"Saulės zuikučiai";3130977416;Ne;0;6;1;7
19252;Boružėlė;"Saulės zuikučiai";4323998138;Ne;18;0;0;18
19253;Boružėlė;"Saulės zuikučiai";2087238951;Ne;1;2;0;3
19254;Boružėlė;"Saulės zuikučiai";3952645542;Ne;0;4;0;4
19255;Boružėlė;"Saulės zuikučiai";5516103398;Ne;0;0;3;3
19256;Boružėlė;"Saulės zuikučiai";8259586236;Ne;0;2;0;2
19257;Boružėlė;"Saulės zuikučiai";3955841578;Ne;0;2;0;2
19258;Boružėlė;"Saulės zuikučiai";1583223569;Ne;0;2;0;2
19259;Boružėlė;"Saulės zuikučiai";4433248526;Ne;9;0;0;9
19260;Boružėlė;"Saulės zuikučiai";1547802140;Ne;4;0;1;5
19261;Boružėlė;"Saulės zuikučiai";4020348640;Ne;2;0;0;2
19262;Boružėlė;"Saulės zuikučiai";2561969142;Ne;1;0;14;15
19263;Boružėlė;"Saulės zuikučiai";7262515868;Ne;14;0;0;14
19264;Boružėlė;"Saulės zuikučiai";6527254253;Ne;18;1;0;19
19265;Boružėlė;"Saulės zuikučiai";7942043844;Ne;0;6;0;6
19266;Boružėlė;Gėlytės;3288141024;Ne;0;5;0;5
19267;Boružėlė;Gėlytės;1166207929;Ne;1;2;1;4
19268;Boružėlė;Gėlytės;7956982615;Ne;0;2;1;3
19269;Boružėlė;Gėlytės;4637656311;Ne;0;0;4;4
19270;Boružėlė;Gėlytės;6070356395;Ne;3;0;0;3
19271;Boružėlė;Gėlytės;4180537253;Ne;0;4;1;5
19272;Boružėlė;Gėlytės;6722353853;Ne;0;1;4;5
19273;Boružėlė;Gėlytės;8376436755;Ne;0;2;1;3
19274;Boružėlė;Gėlytės;7763958937;Ne;0;5;0;5
19275;Boružėlė;Gėlytės;9855354210;Ne;4;0;0;4
19276;Boružėlė;Gėlytės;2515608520;Ne;19;1;0;20
19277;Boružėlė;Gėlytės;3354291446;Ne;0;0;4;4
19278;Boružėlė;Gėlytės;8520403894;Ne;0;0;1;1
19279;Boružėlė;Gėlytės;4268486154;Ne;3;0;0;3
19280;Boružėlė;Gėlytės;7614216150;Ne;0;2;0;2
19281;Boružėlė;Gėlytės;4448964310;Ne;0;0;1;1
19282;Boružėlė;Gėlytės;8205706322;Ne;0;1;4;5
19283;Boružėlė;Gėlytės;8834231529;Ne;2;2;2;6
19284;Boružėlė;Gėlytės;3604658753;Ne;3;0;0;3
19285;Boružėlė;Smalsutis;2086485441;Ne;0;5;0;5
19286;Boružėlė;Smalsutis;5129244830;Ne;0;1;0;1
19287;Boružėlė;Smalsutis;6927100979;Ne;0;2;1;3
19288;Boružėlė;Smalsutis;4947670606;Ne;10;0;1;11
19289;Boružėlė;Smalsutis;7263730692;Ne;0;0;1;1
19290;Boružėlė;Smalsutis;5708558321;Ne;0;1;0;1
19291;Boružėlė;Smalsutis;6484173786;Ne;0;1;0;1
19292;Boružėlė;Smalsutis;39553430808;Ne;0;0;3;3
19293;Boružėlė;Smalsutis;4958704459;Ne;0;5;0;5
19294;Boružėlė;Smalsutis;5618586722;Ne;0;1;0;1
19295;Boružėlė;Smalsutis;8493908653;Ne;0;1;0;1
19296;Boružėlė;Smalsutis;4283064680;Ne;0;10;3;13
19297;Boružėlė;Smalsutis;2447148171;Taip;3;1;0;4
19298;Boružėlė;Drugeliai;8357946299;Ne;7;1;0;8
19299;Boružėlė;Drugeliai;1130980139;Ne;3;1;0;4
19300;Boružėlė;Drugeliai;6463583187;Ne;0;2;2;4
19301;Boružėlė;Drugeliai;3136028536;Ne;14;1;0;15
19302;Boružėlė;Drugeliai;2211576663;Ne;0;5;0;5
19303;Boružėlė;Drugeliai;1559001916;Ne;6;1;0;7
19304;Boružėlė;Drugeliai;4233602822;Ne;7;0;0;7
19305;Boružėlė;Drugeliai;9463322491;Ne;7;2;3;12
19306;Boružėlė;Drugeliai;3108758436;Ne;5;0;0;5
19307;Boružėlė;Drugeliai;8482813204;Ne;10;6;0;16
19308;Boružėlė;Drugeliai;6369070055;Ne;1;0;0;1
19309;Boružėlė;Drugeliai;6902130914;Ne;1;1;1;3
19310;Boružėlė;Drugeliai;3459207879;Ne;11;0;0;11
19311;Boružėlė;Drugeliai;6980022864;Ne;12;1;0;13
19312;Boružėlė;Drugeliai;7756929745;Ne;5;0;0;5
19313;Boružėlė;Drugeliai;5726187445;Ne;7;1;0;8
19314;Boružėlė;Drugeliai;2308405580;Ne;0;0;2;2
19315;Boružėlė;Drugeliai;3405184929;Ne;7;5;0;12
19316;Boružėlė;Drugeliai;8213060214;Ne;10;0;0;10
19317;Boružėlė;Drugeliai;3331238309;Ne;6;0;0;6
19318;Boružėlė;Drugeliai;2783338563;Ne;0;2;0;2
19319;Boružėlė;Vyturėliai;1913540317;Ne;2;0;0;2
19320;Boružėlė;Vyturėliai;1591582954;Ne;0;2;0;2
19321;Boružėlė;Vyturėliai;3322567969;Ne;0;1;0;1
19322;Boružėlė;Vyturėliai;8311383437;Ne;0;2;0;2
19323;Boružėlė;Vyturėliai;7534482245;Ne;19;0;0;19
19324;Boružėlė;Vyturėliai;3310676316;Ne;3;1;0;4
19325;Boružėlė;Vyturėliai;87834777247;Ne;4;2;0;6
19326;Boružėlė;Vyturėliai;50071056728;Ne;0;9;0;9
19327;Boružėlė;Vyturėliai;2098408445;Ne;0;1;0;1
19328;Boružėlė;Vyturėliai;8706461730;Ne;9;0;0;9
19329;Boružėlė;Vyturėliai;8146684259;Ne;0;2;0;2
19330;Boružėlė;Vyturėliai;8225622711;Ne;1;0;0;1
19331;Boružėlė;Vyturėliai;67504667512;Ne;7;0;0;7
19332;Boružėlė;Vyturėliai;9150703371;Ne;5;2;0;7
19333;Boružėlė;Vyturėliai;5811751925;Ne;0;8;0;8
19334;Boružėlė;Vyturėliai;6978158667;Ne;0;5;0;5
19335;Boružėlė;Vyturėliai;9640681773;Ne;0;0;20;20
19336;Boružėlė;Vyturėliai;5576016171;Ne;18;0;0;18
19337;Boružėlė;Žvaigždutės;4990831292;Ne;6;0;0;6
19338;Boružėlė;Žvaigždutės;9838823214;Ne;6;0;0;6
19339;Boružėlė;Žvaigždutės;6242220139;Ne;0;6;0;6
19340;Boružėlė;Žvaigždutės;3489498503;Ne;0;4;1;5
19341;Boružėlė;Žvaigždutės;9720535449;Ne;2;1;0;3
19342;Boružėlė;Žvaigždutės;6435556131;Ne;2;1;0;3
19343;Boružėlė;Žvaigždutės;5307997577;Ne;6;0;1;7
19344;Boružėlė;Žvaigždutės;6972646373;Ne;1;0;0;1
19345;Boružėlė;Žvaigždutės;8820827882;Ne;0;2;0;2
19346;Boružėlė;Žvaigždutės;2857645329;Ne;1;2;0;3
19347;Boružėlė;Žvaigždutės;1799882790;Ne;0;4;4;8
19348;Boružėlė;Ąžuoliukai;5774358876;Ne;0;3;0;3
19349;Boružėlė;Ąžuoliukai;4519645340;Ne;0;2;0;2
19350;Boružėlė;Ąžuoliukai;24315678618;Ne;4;0;1;5
19351;Boružėlė;Ąžuoliukai;4994696176;Ne;0;2;0;2
19352;Boružėlė;Ąžuoliukai;5138737297;Ne;0;1;0;1
19353;Boružėlė;Ąžuoliukai;3040376382;Ne;0;2;3;5
19354;Boružėlė;Ąžuoliukai;3840860155;Ne;0;0;1;1
19355;Boružėlė;Ąžuoliukai;7722277859;Ne;5;0;0;5
19356;Boružėlė;Ąžuoliukai;6954794465;Ne;0;0;1;1
19357;Boružėlė;Ąžuoliukai;5832223872;Ne;0;2;3;5
19358;Boružėlė;Ąžuoliukai;5148410392;Ne;0;0;1;1
19359;Boružėlė;Ąžuoliukai;76222777017;Ne;0;2;0;2
19360;Boružėlė;Ąžuoliukai;45181369655;Ne;0;0;1;1
19361;Boružėlė;Ąžuoliukai;2077228543;Ne;0;0;19;19
19362;Boružėlė;Ąžuoliukai;6022191251;Ne;0;2;2;4
19363;Boružėlė;Ąžuoliukai;3869817904;Ne;0;2;2;4
19364;Boružėlė;Ąžuoliukai;8029389952;Ne;8;1;0;9
19365;Boružėlė;Ąžuoliukai;8683282162;Ne;8;0;0;8
19366;Boružėlė;Saulutės;9492548829;Ne;0;2;0;2
19367;Boružėlė;Saulutės;5437943626;Ne;0;4;0;4
19368;Boružėlė;Saulutės;3503931241;Ne;6;2;0;8
19369;Boružėlė;Saulutės;8882070834;Ne;15;0;0;15
19370;Boružėlė;Saulutės;7882386455;Taip;0;6;0;6
19371;Boružėlė;Saulutės;6265279517;Ne;12;2;0;14
19372;Boružėlė;Saulutės;6275425512;Ne;8;0;0;8
19373;Boružėlė;Saulutės;8804878419;Ne;0;4;5;9
19374;Boružėlė;Saulutės;3871593172;Ne;5;4;1;10
19375;Boružėlė;Saulutės;3953507461;Ne;5;2;1;8
19376;Boružėlė;Saulutės;1492091211;Ne;7;2;0;9
19377;Boružėlė;Saulutės;1830043506;Ne;7;2;0;9
19378;Boružėlė;Saulutės;5680510186;Ne;0;1;0;1
19379;Boružėlė;Saulutės;1152697871;Ne;0;3;0;3
19380;Boružėlė;Saulutės;1779839709;Ne;0;4;0;4
19381;Boružėlė;Saulutės;7652740249;Ne;4;0;0;4
19382;Boružėlė;Saulutės;5508064424;Taip;17;2;0;19
19383;Boružėlė;Saulutės;7260471712;Ne;0;3;0;3
19384;Boružėlė;Saulutės;5064892417;Ne;0;2;2;4
19385;Boružėlė;Ežiukai;9342498392;Ne;0;1;0;1
19386;Boružėlė;Ežiukai;8195442951;Ne;0;8;0;8
19387;Boružėlė;Ežiukai;6448688592;Ne;6;0;0;6
19388;Boružėlė;Ežiukai;2429696310;Ne;0;4;0;4
19389;Boružėlė;Ežiukai;9893643199;Ne;0;4;0;4
19390;Boružėlė;Ežiukai;3112016309;Ne;6;0;0;6
19391;Boružėlė;Ežiukai;5394149649;Ne;6;0;0;6
19392;Boružėlė;Ežiukai;9391811395;Ne;0;2;0;2
19393;Boružėlė;Ežiukai;8167376712;Ne;5;2;0;7
19394;Boružėlė;Ežiukai;9423458813;Ne;2;0;0;2
19395;Boružėlė;Ežiukai;5825164520;Ne;0;0;5;5
19396;Boružėlė;Ežiukai;7190980006;Ne;0;1;0;1
19397;Boružėlė;Ežiukai;7459531236;Ne;0;1;0;1
19398;Boružėlė;Ežiukai;8818358360;Ne;0;1;0;1
19399;Boružėlė;Ežiukai;2926620929;Ne;0;2;0;2
19400;Boružėlė;Ežiukai;6609156790;Ne;0;4;1;5
19401;Boružėlė;Ežiukai;5768415821;Ne;0;2;0;2
19402;Boružėlė;Ežiukai;8291389794;Ne;0;2;0;2
19403;Boružėlė;Ežiukai;5492228053;Ne;0;2;0;2
19404;Boružėlė;Ežiukai;6087811262;Ne;3;2;2;7
19405;Boružėlė;Boružiukai;7068409148;Ne;10;6;0;16
19406;Boružėlė;Boružiukai;8434178580;Ne;0;2;2;4
19407;Boružėlė;Boružiukai;8752343077;Ne;5;0;0;5
19408;Boružėlė;Boružiukai;8944790932;Ne;6;1;3;10
19409;Boružėlė;Boružiukai;7149439740;Ne;0;2;2;4
19410;Boružėlė;Boružiukai;3005601935;Ne;0;4;0;4
19411;Boružėlė;Boružiukai;4497753570;Ne;14;0;0;14
19412;Boružėlė;Boružiukai;1865891989;Ne;2;2;0;4
19413;Boružėlė;Boružiukai;2298750617;Ne;9;0;0;9
19414;Boružėlė;Boružiukai;8739264310;Taip;11;0;1;12
19415;Boružėlė;Boružiukai;3097874340;Ne;3;1;1;5
19416;Boružėlė;Boružiukai;1551933321;Ne;12;0;0;12
19417;Boružėlė;Boružiukai;3097217902;Ne;4;1;0;5
19418;Boružėlė;Boružiukai;4727351240;Ne;9;0;0;9
19419;Boružėlė;Nykštukai;3331139963;Ne;0;1;0;1
19420;Boružėlė;Nykštukai;1047419932;Ne;1;2;0;3
19421;Boružėlė;Nykštukai;2304719318;Ne;5;0;0;5
19422;Boružėlė;Nykštukai;2104101406;Ne;0;7;4;11
19423;Boružėlė;Nykštukai;8377410278;Ne;10;1;3;14
19424;Boružėlė;Nykštukai;4928818565;Ne;5;0;0;5
19425;Boružėlė;Nykštukai;5619719965;Ne;0;3;0;3
19426;Boružėlė;Nykštukai;1966066642;Ne;8;1;0;9
19427;Boružėlė;Nykštukai;6267999965;Ne;0;4;10;14
19428;Boružėlė;Nykštukai;1929202434;Ne;13;0;0;13
19429;Boružėlė;Nykštukai;4217116059;Ne;0;1;0;1
19430;Boružėlė;Nykštukai;8165748779;Ne;0;1;7;8
19431;Žaliakalnio;Drugeliai;6379145626;Ne;3;2;2;7
19432;Žaliakalnio;Drugeliai;7094914749;Ne;5;6;0;11
19433;Žaliakalnio;Drugeliai;7449949339;Ne;4;0;0;4
19434;Žaliakalnio;Drugeliai;2607433844;Ne;0;2;0;2
19435;Žaliakalnio;Drugeliai;1413563085;Ne;8;1;0;9
19436;Žaliakalnio;Drugeliai;9032003195;Ne;0;6;0;6
19437;Žaliakalnio;Drugeliai;7566429633;Ne;0;7;0;7
19438;Žaliakalnio;Drugeliai;3835667120;Ne;0;4;0;4
19439;Žaliakalnio;Drugeliai;6341640909;Ne;0;1;0;1
19440;Žaliakalnio;Drugeliai;4059753894;Ne;2;2;1;5
19441;Žaliakalnio;Drugeliai;2305496316;Ne;9;0;0;9
19442;Žaliakalnio;Drugeliai;9984857605;Ne;4;0;0;4
19443;Žaliakalnio;Drugeliai;5764128482;Ne;4;0;0;4
19444;Žaliakalnio;Drugeliai;4497938258;Ne;1;0;0;1
19445;Žaliakalnio;Drugeliai;1673321992;Ne;0;2;0;2
19446;Žaliakalnio;Boružėlių;5843020412;Ne;0;2;0;2
19447;Žaliakalnio;Boružėlių;9625531462;Ne;0;12;0;12
19448;Žaliakalnio;Boružėlių;6699373334;Ne;0;12;0;12
19449;Žaliakalnio;Boružėlių;1528111839;Ne;0;1;0;1
19450;Žaliakalnio;Boružėlių;2284465378;Ne;0;4;0;4
19451;Žaliakalnio;Boružėlių;7977009681;Ne;0;1;0;1
19452;Žaliakalnio;Boružėlių;2808776865;Ne;3;0;0;3
19453;Žaliakalnio;Boružėlių;2278681435;Ne;3;0;5;8
19454;Žaliakalnio;Boružėlių;3445649442;Taip;0;5;0;5
19455;Žaliakalnio;Boružėlių;3105500733;Ne;3;0;1;4
19456;Žaliakalnio;Boružėlių;1200844791;Ne;0;3;0;3
19457;Žaliakalnio;Boružėlių;8052539476;Ne;15;10;0;25
19458;Žaliakalnio;Boružėlių;6590016097;Ne;3;7;0;10
19459;Žaliakalnio;Boružėlių;8304431519;Ne;0;0;9;9
19460;Žaliakalnio;Boružėlių;5488964606;Ne;8;0;0;8
19461;Žaliakalnio;Boružėlių;8429135626;Ne;0;8;0;8
19462;Žaliakalnio;Boružėlių;8073554707;Ne;17;0;0;17
19463;Žaliakalnio;Boružėlių;8534973941;Ne;4;11;0;15
19464;Žaliakalnio;Boružėlių;2987217910;Ne;16;0;0;16
19465;Žaliakalnio;Boružėlių;5157814568;Ne;7;0;0;7
19466;Žaliakalnio;Zuikučiai;6088333997;Ne;6;1;0;7
19467;Žaliakalnio;Zuikučiai;2673619031;Ne;0;1;0;1
19468;Žaliakalnio;Zuikučiai;5843314345;Ne;0;4;0;4
19469;Žaliakalnio;Zuikučiai;6823528666;Ne;5;3;0;8
19470;Žaliakalnio;Zuikučiai;3509064089;Ne;0;2;0;2
19471;Žaliakalnio;Zuikučiai;7000429934;Ne;0;2;0;2
19472;Žaliakalnio;Zuikučiai;5730610895;Ne;1;4;0;5
19473;Žaliakalnio;Zuikučiai;6881070397;Ne;0;8;0;8
19474;Žaliakalnio;Zuikučiai;8209559343;Ne;6;0;0;6
19475;Žaliakalnio;Zuikučiai;1321592040;Ne;0;1;0;1
19476;Žaliakalnio;Zuikučiai;8298313285;Ne;0;1;0;1
19477;Žaliakalnio;Zuikučiai;9331287916;Ne;6;3;0;9
19478;Žaliakalnio;Zuikučiai;4607456527;Ne;9;0;0;9
19479;Žaliakalnio;Zuikučiai;9363615751;Ne;7;3;0;10
19480;Žaliakalnio;Zuikučiai;6727442688;Ne;10;2;0;12
19481;Žaliakalnio;Bitutė;5744370516;Ne;5;1;0;6
19482;Žaliakalnio;Bitutė;3619817569;Ne;5;1;0;6
19483;Žaliakalnio;Bitutė;3905448562;Ne;4;1;0;5
19484;Žaliakalnio;Bitutė;8481665290;Ne;0;2;0;2
19485;Žaliakalnio;Bitutė;8950583202;Ne;0;4;0;4
19486;Žaliakalnio;Bitutė;6324315523;Ne;5;3;2;10
19487;Žaliakalnio;Bitutė;6877235095;Ne;0;1;0;1
19488;Žaliakalnio;Bitutė;2280683252;Ne;5;0;0;5
19489;Žaliakalnio;Bitutė;7711347723;Ne;4;7;0;11
19490;Žaliakalnio;Bitutė;4561672875;Ne;4;1;0;5
19491;Žaliakalnio;Bitutė;8185190219;Ne;5;0;0;5
19492;Žaliakalnio;Bitutė;7830692152;Ne;0;5;0;5
19493;Žaliakalnio;Bitutė;1423481154;Ne;5;1;0;6
19494;Žaliakalnio;Bitutė;4928400872;Ne;0;7;0;7
19495;Žaliakalnio;Bitutė;2613771302;Ne;3;0;0;3
19496;Žaliakalnio;Bitutė;3976548663;Ne;0;3;0;3
19497;Žaliakalnio;Bitutė;8599646291;Ne;0;0;3;3
19498;Žaliakalnio;Bitutė;3721878250;Ne;11;0;0;11
19499;Žaliakalnio;Bitutė;6291287113;Ne;4;0;0;4
19500;Žaliakalnio;Bitutė;4412760433;Ne;5;0;2;7
19501;Žaliakalnio;Bitutė;7989372873;Ne;5;1;0;6
19502;Žaliakalnio;Bitutė;1173977434;Ne;5;2;0;7
19503;Žaliakalnio;Nykštukų;9069518153;Taip;0;16;0;16
19504;Žaliakalnio;Nykštukų;8142435757;Ne;1;2;1;4
19505;Žaliakalnio;Nykštukų;3446593135;Ne;2;0;1;3
19506;Žaliakalnio;Nykštukų;1064854294;Taip;0;15;0;15
19507;Žaliakalnio;Nykštukų;1632465983;Ne;10;3;0;13
19508;Žaliakalnio;Nykštukų;9521104462;Ne;6;0;0;6
19509;Žaliakalnio;Nykštukų;5565027085;Ne;4;2;0;6
19510;Žaliakalnio;Nykštukų;2242604156;Ne;0;7;0;7
19511;Žaliakalnio;Nykštukų;8852165484;Ne;7;0;0;7
19512;Žaliakalnio;Nykštukų;9801618806;Ne;10;0;0;10
19513;Žaliakalnio;Nykštukų;4255734788;Ne;12;0;0;12
19514;Žaliakalnio;Nykštukų;7793937917;Ne;0;5;0;5
19515;Žaliakalnio;Nykštukų;8117013474;Ne;13;2;0;15
19516;Žaliakalnio;Nykštukų;7205368281;Ne;3;4;0;7
19517;Žaliakalnio;Nykštukų;7495990953;Ne;19;1;0;20
19518;Žaliakalnio;Nykštukų;4036239701;Ne;3;2;0;5
19519;Žaliakalnio;Nykštukų;5258266970;Ne;8;0;0;8
19520;Žaliakalnio;Nykštukų;6166482260;Ne;17;8;0;25
19521;Žaliakalnio;ŽIOGELIAI;2426844621;Ne;0;1;0;1
19522;Žaliakalnio;ŽIOGELIAI;5752912101;Ne;0;1;0;1
19523;Žaliakalnio;ŽIOGELIAI;9967098834;Ne;5;1;0;6
19524;Žaliakalnio;ŽIOGELIAI;1133557422;Ne;0;3;0;3
19525;Žaliakalnio;ŽIOGELIAI;3464935314;Ne;0;4;0;4
19526;Žaliakalnio;ŽIOGELIAI;4702470511;Ne;0;4;0;4
19527;Žaliakalnio;ŽIOGELIAI;2272043654;Ne;0;1;0;1
19528;Žaliakalnio;ŽIOGELIAI;8518422934;Ne;0;2;0;2
19529;Žaliakalnio;ŽIOGELIAI;6674631040;Ne;0;0;1;1
19530;Žaliakalnio;ŽIOGELIAI;8245784590;Ne;6;0;0;6
19531;Žaliakalnio;ŽIOGELIAI;9485995178;Ne;0;3;0;3
19532;Žaliakalnio;ŽIOGELIAI;8383425712;Ne;0;0;3;3
19533;Žaliakalnio;ŽIOGELIAI;1309236035;Ne;9;0;2;11
19534;Žaliakalnio;ŽIOGELIAI;7025195076;Ne;4;0;0;4
19535;Žaliakalnio;ŽIOGELIAI;2514763739;Ne;0;0;2;2
19536;Žaliakalnio;ŽIOGELIAI;6294045755;Ne;0;4;0;4
19537;Žaliakalnio;ŽIOGELIAI;8232697563;Ne;0;1;0;1
19538;Žaliakalnio;ŽIOGELIAI;2694424532;Ne;5;5;0;10
19539;Žaliakalnio;ŽIOGELIAI;6136717862;Ne;2;0;0;2
19540;Žaliakalnio;SAULUTĖS;5602734465;Ne;0;12;0;12
19541;Žaliakalnio;SAULUTĖS;4154737541;Ne;4;7;0;11
19542;Žaliakalnio;SAULUTĖS;7913029369;Ne;0;4;0;4
19543;Žaliakalnio;SAULUTĖS;7793917852;Ne;0;2;0;2
19544;Žaliakalnio;SAULUTĖS;3018398546;Ne;1;9;0;10
19545;Žaliakalnio;SAULUTĖS;8765159796;Ne;1;1;1;3
19546;Žaliakalnio;SAULUTĖS;3028921540;Ne;0;1;0;1
19547;Žaliakalnio;SAULUTĖS;7636933790;Ne;11;6;0;17
19548;Žaliakalnio;SAULUTĖS;4355433666;Ne;7;1;0;8
19549;Žaliakalnio;SAULUTĖS;1975313368;Ne;15;5;0;20
19550;Žaliakalnio;SAULUTĖS;9016032548;Ne;0;1;0;1
19551;Žaliakalnio;SAULUTĖS;1715385224;Ne;3;5;0;8
19552;Žaliakalnio;SAULUTĖS;3304186400;Ne;9;5;0;14
19553;Žaliakalnio;SAULUTĖS;3434815790;Ne;0;1;0;1
19554;Žaliakalnio;SAULUTĖS;7071209465;Ne;11;0;0;11
19555;Žaliakalnio;SAULUTĖS;7543073516;Ne;0;3;0;3
19556;Žaliakalnio;SAULUTĖS;9379373983;Ne;2;1;0;3
19557;Žaliakalnio;SAULUTĖS;2806386840;Ne;4;0;0;4
19558;Volungė;Bitutės;6661730121;Ne;1;0;1;2
19559;Volungė;Bitutės;5791161943;Ne;0;0;1;1
19560;Volungė;Bitutės;3307326410;Ne;0;0;3;3
19561;Volungė;Bitutės;5300334761;Ne;5;0;0;5
19562;Volungė;Bitutės;6755366051;Ne;10;0;0;10
19563;Volungė;Bitutės;4013639324;Ne;0;0;6;6
19564;Volungė;Bitutės;2599441104;Ne;0;9;0;9
19565;Volungė;Bitutės;5892600735;Ne;0;12;8;20
19566;Volungė;Bitutės;1902122510;Ne;4;0;1;5
19567;Volungė;Bitutės;1752817125;Ne;0;0;20;20
19568;Volungė;Bitutės;3515725398;Ne;4;0;3;7
19569;Volungė;Bitutės;3666364101;Ne;0;0;3;3
19570;Volungė;Bitutės;7151952679;Ne;4;0;2;6
19571;Volungė;Bitutės;5960027749;Ne;6;0;9;15
19572;Volungė;Bitutės;3106135598;Ne;0;0;2;2
19573;Volungė;Bitutės;9842009354;Ne;3;0;4;7
19574;Volungė;Bitutės;4437625791;Ne;1;0;0;1
19575;Volungė;Bitutės;9933980783;Ne;0;20;0;20
19576;Volungė;Bitutės;4685227759;Ne;0;20;0;20
19577;Volungė;Boružiukai;6431477042;Ne;0;0;2;2
19578;Volungė;Boružiukai;1137713075;Ne;5;2;0;7
19579;Volungė;Boružiukai;2322594823;Ne;3;10;0;13
19580;Volungė;Boružiukai;7965601199;Ne;0;0;1;1
19581;Volungė;Boružiukai;3746978206;Ne;0;0;4;4
19582;Volungė;Boružiukai;9188994935;Ne;0;5;0;5
19583;Volungė;Boružiukai;8285309230;Ne;10;0;1;11
19584;Volungė;Boružiukai;7149986415;Ne;0;0;1;1
19585;Volungė;Boružiukai;4598763851;Ne;0;0;1;1
19586;Volungė;Boružiukai;7867741556;Ne;10;0;1;11
19587;Volungė;Boružiukai;8459167833;Ne;0;2;1;3
19588;Volungė;Boružiukai;6028582927;Ne;6;0;0;6
19589;Volungė;Boružiukai;3832613221;Ne;5;6;0;11
19590;Volungė;Boružiukai;1757041481;Ne;0;0;11;11
19591;Volungė;Boružiukai;7971287899;Ne;16;1;0;17
19592;Volungė;Boružiukai;2627555750;Ne;0;0;7;7
19593;Volungė;Boružiukai;1974650443;Ne;0;0;1;1
19594;Volungė;Boružiukai;2603335248;Ne;4;0;0;4
19595;Volungė;Boružiukai;2068447339;Ne;0;20;0;20
19596;Volungė;Boružiukai;3528581949;Ne;4;0;4;8
19597;Volungė;Žvirbliukai;2360026330;Ne;0;0;1;1
19598;Volungė;Žvirbliukai;8414351815;Ne;7;0;1;8
19599;Volungė;Žvirbliukai;2051410463;Ne;6;0;3;9
19600;Volungė;Žvirbliukai;5074093178;Ne;3;0;0;3
19601;Volungė;Žvirbliukai;5750385275;Taip;2;0;3;5
19602;Volungė;Žvirbliukai;9575894080;Ne;0;0;2;2
19603;Volungė;Žvirbliukai;8927595898;Ne;8;0;6;14
19604;Volungė;Žvirbliukai;9384821249;Ne;8;0;1;9
19605;Volungė;Žvirbliukai;5361410157;Ne;15;0;0;15
19606;Volungė;Žvirbliukai;3499045731;Ne;0;0;20;20
19607;Volungė;Žvirbliukai;4235842588;Ne;0;0;1;1
19608;Volungė;Žvirbliukai;3028611395;Ne;9;0;3;12
19609;Volungė;Žvirbliukai;2949033093;Ne;0;0;6;6
19610;Volungė;Žvirbliukai;2159667991;Ne;0;0;1;1
19611;Volungė;Žvirbliukai;5470252589;Ne;0;0;15;15
19612;Volungė;Žvirbliukai;7923029388;Ne;0;0;6;6
19613;Volungė;Žiogeliai;6360834021;Ne;3;0;0;3
19614;Volungė;Žiogeliai;4856240879;Ne;4;0;6;10
19615;Volungė;Žiogeliai;4694016281;Ne;0;0;1;1
19616;Volungė;Žiogeliai;9816038480;Ne;0;0;1;1
19617;Volungė;Žiogeliai;8640511964;Ne;0;0;4;4
19618;Volungė;Žiogeliai;5170536566;Ne;4;0;1;5
19619;Volungė;Žiogeliai;8421730419;Ne;0;12;8;20
19620;Volungė;Žiogeliai;6532202782;Ne;0;0;3;3
19621;Volungė;Žiogeliai;2712034356;Ne;6;0;1;7
19622;Volungė;Žiogeliai;2246291631;Ne;5;0;1;6
19623;Volungė;Žiogeliai;6920821813;Ne;0;0;1;1
19624;Volungė;Žiogeliai;8299305464;Ne;12;0;4;16
19625;Volungė;Žiogeliai;1781838937;Ne;0;0;6;6
19626;Volungė;Žiogeliai;7859381467;Ne;0;6;0;6
19627;Volungė;Žiogeliai;3091641738;Ne;0;0;2;2
19628;Volungė;Žiogeliai;8578521969;Ne;0;0;2;2
19629;Volungė;Žiogeliai;5174427959;Ne;0;0;1;1
19630;Volungė;Žiogeliai;4726043862;Ne;0;0;2;2
19631;Volungė;Pelėdžiukai;2890377876;Ne;0;0;4;4
19632;Volungė;Pelėdžiukai;1099216923;Ne;0;0;9;9
19633;Volungė;Pelėdžiukai;3430719834;Ne;0;0;2;2
19634;Volungė;Pelėdžiukai;2566901599;Ne;0;0;1;1
19635;Volungė;Pelėdžiukai;2420242319;Ne;0;0;7;7
19636;Volungė;Pelėdžiukai;3356901662;Ne;5;0;4;9
19637;Volungė;Pelėdžiukai;1225378067;Ne;0;3;0;3
19638;Volungė;Pelėdžiukai;7281448136;Ne;0;0;4;4
19639;Volungė;Pelėdžiukai;3215314804;Ne;0;0;3;3
19640;Volungė;Pelėdžiukai;9629567682;Ne;5;0;4;9
19641;Volungė;Pelėdžiukai;1120682487;Ne;0;0;2;2
19642;Volungė;Pelėdžiukai;9082860913;Ne;0;11;0;11
19643;Volungė;Pelėdžiukai;8174587725;Ne;0;0;4;4
19644;Volungė;Pelėdžiukai;17534618616;Ne;0;0;3;3
19645;Volungė;Pelėdžiukai;7521910384;Ne;5;0;1;6
19646;Volungė;Pelėdžiukai;6565522808;Ne;0;0;1;1
19647;Volungė;Pelėdžiukai;9068889427;Ne;4;2;0;6
19648;Volungė;Pelėdžiukai;4123080241;Ne;4;0;2;6
19649;Volungė;Pelėdžiukai;8268202101;Ne;0;0;4;4
19650;Volungė;Pelėdžiukai;1366066359;Ne;0;2;1;3
19651;Volungė;Drugeliai;6280208510;Ne;0;4;0;4
19652;Volungė;Drugeliai;4032261812;Ne;4;0;6;10
19653;Volungė;Drugeliai;8045459660;Ne;6;0;6;12
19654;Volungė;Drugeliai;1402200673;Ne;6;0;6;12
19655;Volungė;Drugeliai;7574856429;Ne;15;0;0;15
19656;Volungė;Drugeliai;9729285419;Ne;0;0;15;15
19657;Volungė;Drugeliai;2686827560;Ne;0;0;5;5
19658;Volungė;Drugeliai;9973604148;Ne;0;0;1;1
19659;Volungė;Drugeliai;8905401944;Ne;4;0;3;7
19660;Volungė;Drugeliai;2923810441;Ne;0;0;1;1
19661;Volungė;Drugeliai;6782622442;Taip;5;0;1;6
19662;Volungė;Drugeliai;4252713086;Ne;4;0;0;4
19663;Volungė;Drugeliai;2530804242;Ne;0;0;2;2
19664;Volungė;Drugeliai;3150532451;Ne;4;0;0;4
19665;Volungė;Drugeliai;4745609424;Taip;9;0;0;9
19666;Volungė;Drugeliai;7584598377;Ne;0;0;1;1
19667;Volungė;"SKRUZDĖLIUKAI ";3394646139;Ne;20;0;0;20
19668;Volungė;"SKRUZDĖLIUKAI ";6464890465;Ne;0;6;2;8
19669;Volungė;"SKRUZDĖLIUKAI ";2493541457;Ne;6;0;2;8
19670;Volungė;"SKRUZDĖLIUKAI ";1101228927;Ne;1;0;0;1
19671;Volungė;"SKRUZDĖLIUKAI ";5332306628;Ne;0;0;7;7
19672;Volungė;"SKRUZDĖLIUKAI ";9319825151;Taip;0;4;1;5
19673;Volungė;"SKRUZDĖLIUKAI ";6370584522;Ne;3;10;0;13
19674;Volungė;"SKRUZDĖLIUKAI ";8168630107;Ne;3;0;1;4
19675;Volungė;"SKRUZDĖLIUKAI ";8992514683;Ne;8;2;0;10
19676;Volungė;"SKRUZDĖLIUKAI ";5833091791;Ne;0;0;1;1
19677;Volungė;"SKRUZDĖLIUKAI ";5994884455;Ne;1;1;0;2
19678;Volungė;"SKRUZDĖLIUKAI ";3818924175;Ne;5;0;0;5
19679;Volungė;"SKRUZDĖLIUKAI ";8244731771;Ne;0;0;3;3
19680;Volungė;"SKRUZDĖLIUKAI ";6110117105;Ne;1;0;8;9
19681;Volungė;"SKRUZDĖLIUKAI ";4944556574;Ne;7;2;0;9
19682;Volungė;"SKRUZDĖLIUKAI ";2212423676;Ne;4;0;5;9
19683;Volungė;"SKRUZDĖLIUKAI ";5942497397;Ne;0;0;20;20
19684;Volungė;"SKRUZDĖLIUKAI ";4991465781;Ne;0;0;1;1
19685;Volungė;"SKRUZDĖLIUKAI ";8613580206;Ne;0;0;2;2
19686;Volungė;Zylutės;6127398531;Ne;0;0;1;1
19687;Volungė;Zylutės;4664635246;Taip;9;0;5;14
19688;Volungė;Zylutės;1125730734;Ne;4;0;0;4
19689;Volungė;Zylutės;5650558154;Ne;14;0;0;14
19690;Volungė;Zylutės;1592634034;Ne;9;0;2;11
19691;Volungė;Zylutės;5588544003;Ne;2;0;2;4
19692;Volungė;Zylutės;3758750922;Ne;10;0;8;18
19693;Volungė;Zylutės;9562426487;Ne;4;0;3;7
19694;Volungė;Zylutės;4136178027;Ne;0;2;3;5
19695;Volungė;Zylutės;5882826586;Taip;0;11;0;11
19696;Volungė;Zylutės;6969633765;Ne;5;0;1;6
19697;Volungė;Zylutės;6445614647;Ne;9;0;0;9
19698;Volungė;Zylutės;5561683986;Ne;6;0;1;7
19699;Volungė;Zylutės;5338942678;Ne;11;0;3;14
19700;Volungė;Zylutės;8987748481;Ne;2;0;1;3
19701;Volungė;"2 klasė";7246064765;Ne;5;0;0;5
19702;Volungė;"3 klasė";98173443441;Ne;6;0;0;6
19703;Volungė;"3 klasė";21905512433;Ne;3;0;0;3
19704;Volungė;"3 klasė";249422166;Ne;13;0;0;13
19705;Giliukas;SMALSUČIAI;1710286878;Ne;6;0;13;19
19706;Giliukas;SMALSUČIAI;9134734376;Ne;0;0;1;1
19707;Giliukas;SMALSUČIAI;3728323646;Ne;30;0;0;30
19708;Giliukas;SMALSUČIAI;6742406486;Ne;10;0;0;10
19709;Giliukas;SMALSUČIAI;9556962586;Ne;3;0;0;3
19710;Giliukas;SMALSUČIAI;2840410579;Ne;11;0;0;11
19711;Giliukas;SMALSUČIAI;2378721717;Ne;4;0;2;6
19712;Giliukas;SMALSUČIAI;7316126011;Ne;0;0;7;7
19713;Giliukas;SMALSUČIAI;6489845832;Ne;32;0;0;32
19714;Giliukas;SMALSUČIAI;6203352124;Ne;4;2;1;7
19715;Giliukas;SMALSUČIAI;9704885611;Ne;1;0;0;1
19716;Giliukas;SMALSUČIAI;7993049824;Taip;10;3;1;14
19717;Giliukas;SMALSUČIAI;2700296404;Ne;0;0;3;3
19718;Giliukas;SMALSUČIAI;7412960823;Taip;0;0;2;2
19719;Giliukas;SMALSUČIAI;9160815037;Ne;20;0;11;31
19720;Giliukas;SMALSUČIAI;8701216181;Ne;6;2;0;8
19721;Giliukas;GUDRUČIAI;3847358328;Ne;15;2;2;19
19722;Giliukas;GUDRUČIAI;6165618131;Ne;15;4;0;19
19723;Giliukas;GUDRUČIAI;9608331265;Ne;0;3;0;3
19724;Giliukas;GUDRUČIAI;3691791222;Ne;9;0;0;9
19725;Giliukas;GUDRUČIAI;1870173947;Ne;0;23;0;23
19726;Giliukas;GUDRUČIAI;3983555939;Ne;10;2;0;12
19727;Giliukas;GUDRUČIAI;2951628295;Ne;0;4;0;4
19728;Giliukas;GUDRUČIAI;9408948207;Taip;0;5;3;8
19729;Giliukas;GUDRUČIAI;2003990493;Ne;0;4;0;4
19730;Giliukas;GUDRUČIAI;4960232685;Ne;3;2;1;6
19731;Giliukas;GUDRUČIAI;4916844983;Ne;6;0;0;6
19732;Giliukas;GUDRUČIAI;5787041097;Ne;6;3;0;9
19733;Giliukas;GUDRUČIAI;7159681896;Ne;10;0;1;11
19734;Giliukas;PABIRUČIAI;4183026763;Ne;0;0;2;2
19735;Giliukas;PABIRUČIAI;1221640023;Ne;6;2;0;8
19736;Giliukas;PABIRUČIAI;2362785562;Ne;10;2;1;13
19737;Giliukas;PABIRUČIAI;4247090684;Ne;3;0;13;16
19738;Giliukas;PABIRUČIAI;2379370477;Ne;0;2;0;2
19739;Giliukas;PABIRUČIAI;3054591644;Ne;5;0;0;5
19740;Giliukas;PABIRUČIAI;3870143024;Ne;10;1;0;11
19741;Giliukas;PABIRUČIAI;6914013230;Ne;20;0;0;20
19742;Giliukas;PABIRUČIAI;2512831288;Ne;20;0;2;22
19743;Giliukas;PABIRUČIAI;7013767174;Ne;6;0;0;6
19744;Giliukas;PABIRUČIAI;4810236703;Taip;9;0;0;9
19745;Giliukas;PABIRUČIAI;4105974682;Ne;5;0;1;6
19746;Giliukas;PABIRUČIAI;8874804636;Ne;8;1;0;9
19747;Giliukas;ŠVELNUKAI;9360994563;Ne;6;0;0;6
19748;Giliukas;ŠVELNUKAI;7402797271;Ne;20;0;0;20
19749;Giliukas;ŠVELNUKAI;3839624551;Ne;0;0;1;1
19750;Giliukas;ŠVELNUKAI;2012365132;Ne;4;0;0;4
19751;Giliukas;ŠVELNUKAI;9270743786;Ne;4;0;1;5
19752;Giliukas;ŠVELNUKAI;4565216956;Ne;12;0;0;12
19753;Giliukas;ŠVELNUKAI;5834233526;Ne;7;0;0;7
19754;Giliukas;ŠVELNUKAI;8973584424;Ne;5;0;1;6
19755;Giliukas;ŠVELNUKAI;9679421414;Ne;9;0;0;9
19756;Giliukas;ŠVELNUKAI;2881704755;Ne;6;0;0;6
19757;Giliukas;ŠVELNUKAI;3238820351;Ne;14;0;0;14
19758;Giliukas;ŠVELNUKAI;4340602792;Ne;0;0;7;7
19759;Giliukas;ŠVELNUKAI;2229737837;Ne;0;10;10;20
19760;Giliukas;ŽINIUKAI;6422178450;Ne;2;2;0;4
19761;Giliukas;ŽINIUKAI;2502801547;Ne;16;2;1;19
19762;Giliukas;ŽINIUKAI;9617542456;Ne;0;4;0;4
19763;Giliukas;ŽINIUKAI;2562809633;Ne;0;8;1;9
19764;Giliukas;ŽINIUKAI;5326178821;Ne;15;4;0;19
19765;Giliukas;ŽINIUKAI;2692141913;Ne;20;0;0;20
19766;Giliukas;ŽINIUKAI;9152432124;Ne;20;0;0;20
19767;Giliukas;ŽINIUKAI;4854370266;Ne;5;0;0;5
19768;Giliukas;ŽINIUKAI;6703080106;Ne;19;2;0;21
19769;Giliukas;ŽINIUKAI;6942029629;Taip;0;5;1;6
19770;Giliukas;ŽINIUKAI;9274289812;Ne;10;0;0;10
19771;Giliukas;ŽINIUKAI;6956862865;Taip;0;3;2;5
19772;Giliukas;ŽINIUKAI;3150981084;Ne;3;5;0;8
19773;Giliukas;ŽINIUKAI;6134554678;Ne;17;4;1;22
19774;Giliukas;ŽINIUKAI;6338583515;Ne;0;2;0;2
19775;Giliukas;ŽINIUKAI;2064182165;Ne;9;0;0;9
19776;Giliukas;ŽINIUKAI;5201020765;Ne;32;0;0;32
19777;Giliukas;ŽINIUKAI;3137768675;Ne;13;0;0;13
19778;Giliukas;ŽINIUKAI;3718774263;Ne;5;27;0;32
19779;Giliukas;MYLIMUKAI;7205807049;Ne;0;2;3;5
19780;Giliukas;MYLIMUKAI;1165810193;Ne;0;2;4;6
19781;Giliukas;MYLIMUKAI;3055598917;Ne;0;2;0;2
19782;Giliukas;MYLIMUKAI;6953123617;Ne;0;10;0;10
19783;Giliukas;MYLIMUKAI;4207939009;Ne;8;0;0;8
19784;Giliukas;MYLIMUKAI;2742106493;Ne;1;4;5;10
19785;Giliukas;MYLIMUKAI;7053406257;Ne;8;0;0;8
19786;Giliukas;MYLIMUKAI;5222092567;Ne;0;0;1;1
19787;Giliukas;MYLIMUKAI;4581414740;Ne;8;0;0;8
19788;Giliukas;MYLIMUKAI;2226855971;Ne;0;6;7;13
19789;Giliukas;MYLIMUKAI;7431116067;Ne;4;0;4;8
19790;Giliukas;MYLIMUKAI;6748766233;Ne;5;0;0;5
19791;Giliukas;MYLIMUKAI;3726149759;Ne;6;2;0;8
19792;Giliukas;MYLIMUKAI;5300517567;Ne;0;2;0;2
19793;Giliukas;MYLIMUKAI;5625404051;Ne;0;0;7;7
19794;Giliukas;ČIAUŠKUČIAI;1762536884;Ne;4;2;1;7
19795;Giliukas;ČIAUŠKUČIAI;7646966187;Ne;4;0;0;4
19796;Giliukas;ČIAUŠKUČIAI;2801731379;Ne;9;2;0;11
19797;Giliukas;ČIAUŠKUČIAI;8499893356;Ne;7;9;0;16
19798;Giliukas;ČIAUŠKUČIAI;9205911152;Ne;4;0;0;4
19799;Giliukas;ČIAUŠKUČIAI;3720032249;Ne;4;0;0;4
19800;Giliukas;ČIAUŠKUČIAI;4940718205;Ne;1;2;0;3
19801;Giliukas;ČIAUŠKUČIAI;8491008130;Taip;9;2;0;11
19802;Giliukas;ČIAUŠKUČIAI;2612551188;Ne;9;0;0;9
19803;Giliukas;ČIAUŠKUČIAI;9366734581;Ne;16;0;0;16
19804;Giliukas;ČIAUŠKUČIAI;9462634699;Ne;8;0;0;8
19805;Giliukas;ČIAUŠKUČIAI;8106782330;Ne;11;2;0;13
19806;Giliukas;ČIAUŠKUČIAI;1332725572;Ne;15;1;0;16
19807;Giliukas;ČIAUŠKUČIAI;2787116787;Ne;0;3;0;3
19808;Giliukas;ŠNEKUČIAI;9229086918;Ne;3;2;1;6
19809;Giliukas;ŠNEKUČIAI;3274313536;Ne;0;3;0;3
19810;Giliukas;ŠNEKUČIAI;9287193955;Ne;5;4;1;10
19811;Giliukas;ŠNEKUČIAI;9499591494;Ne;0;0;3;3
19812;Giliukas;ŠNEKUČIAI;7195772641;Ne;3;0;0;3
19813;Giliukas;ŠNEKUČIAI;1439350058;Ne;5;0;0;5
19814;Giliukas;ŠNEKUČIAI;4843920452;Ne;7;0;0;7
19815;Giliukas;ŠNEKUČIAI;2004782696;Ne;13;0;2;15
19816;Giliukas;ŠNEKUČIAI;8147492951;Ne;1;0;1;2
19817;Giliukas;ŠNEKUČIAI;2349166172;Ne;6;0;0;6
19818;Giliukas;ŠNEKUČIAI;8241215831;Ne;7;0;7;14
19819;Giliukas;ŠNEKUČIAI;9475918013;Ne;0;0;3;3
19820;Giliukas;ŠNEKUČIAI;7944198886;Ne;11;0;0;11
19821;"Lazdynų mokykla (Žėručio g. 4)";RUPG;6038907328;Ne;5;0;0;5
19822;"Lazdynų mokykla (Žėručio g. 4)";RUPG;4086774324;Ne;0;20;0;20
19823;"Lazdynų mokykla (Žėručio g. 4)";RUPG;6070629454;Ne;0;20;0;20
19824;"Lazdynų mokykla (Žėručio g. 4)";RUPG;1118653070;Ne;0;2;0;2
19825;"Lazdynų mokykla (Žėručio g. 4)";RUPG;3367804873;Ne;0;1;0;1
19826;"Lazdynų mokykla (Žėručio g. 4)";RUPG;5806696915;Ne;0;0;4;4
19827;"Lazdynų mokykla (Žėručio g. 4)";RUPG;2209697834;Ne;0;20;0;20
19828;"Lazdynų mokykla (Žėručio g. 4)";RUPG;6638804854;Ne;0;20;0;20
19829;"Lazdynų mokykla (Žėručio g. 4)";RUPG;3634678954;Ne;0;3;0;3
19830;"Lazdynų mokykla (Žėručio g. 4)";RUPG;1025406111;Ne;0;3;0;3
19831;"Lazdynų mokykla (Žėručio g. 4)";RUPG;5095782784;Ne;7;0;0;7
19832;"Lazdynų mokykla (Žėručio g. 4)";LEPG;6822686126;Ne;5;0;0;5
19833;"Lazdynų mokykla (Žėručio g. 4)";LEPG;2070196225;Ne;0;0;1;1
19834;"Lazdynų mokykla (Žėručio g. 4)";LEPG;2613078582;Ne;0;12;0;12
19835;"Lazdynų mokykla (Žėručio g. 4)";LEPG;7059075747;Ne;1;0;1;2
19836;"Lazdynų mokykla (Žėručio g. 4)";LEPG;5438716880;Ne;2;0;1;3
19837;"Lazdynų mokykla (Žėručio g. 4)";LEPG;7487278074;Ne;0;0;3;3
19838;"Lazdynų mokykla (Žėručio g. 4)";LEPG;7320049068;Ne;0;0;3;3
19839;"Lazdynų mokykla (Žėručio g. 4)";LEPG;1396367371;Ne;0;0;5;5
19840;"Lazdynų mokykla (Žėručio g. 4)";LEPG;7324846434;Ne;0;0;2;2
19841;"Lazdynų mokykla (Žėručio g. 4)";LEPG;6794153377;Ne;0;0;6;6
19842;"Lazdynų mokykla (Žėručio g. 4)";LEPG;2825614921;Ne;9;0;1;10
19843;"Lazdynų mokykla (Žėručio g. 4)";LEPG;9592456683;Ne;2;0;0;2
19844;"Lazdynų mokykla (Žėručio g. 4)";LEPG;4149212470;Ne;2;0;2;4
19845;"Lazdynų mokykla (Žėručio g. 4)";LEPG;8324750958;Ne;6;0;1;7
19846;"Lazdynų mokykla (Žėručio g. 4)";LEPG;7659209862;Ne;0;20;0;20
19847;"Lazdynų mokykla (Žėručio g. 4)";RUPG;5015519090;Ne;0;0;4;4
19848;"Lazdynų mokykla (Žėručio g. 4)";RUPG;1745679183;Ne;9;1;0;10
19849;"Lazdynų mokykla (Žėručio g. 4)";RUPG;9255723192;Taip;3;0;1;4
19850;"Lazdynų mokykla (Žėručio g. 4)";RUPG;9639587601;Ne;0;0;3;3
19851;"Lazdynų mokykla (Žėručio g. 4)";RUPG;4087148273;Ne;0;0;1;1
19852;"Lazdynų mokykla (Žėručio g. 4)";RUPG;2740942924;Ne;6;0;1;7
19853;"Lazdynų mokykla (Žėručio g. 4)";RUPG;4023257875;Ne;0;0;1;1
19854;"Lazdynų mokykla (Žėručio g. 4)";RUPG;2308739823;Ne;0;0;2;2
19855;"Lazdynų mokykla (Žėručio g. 4)";RUPG;9123178095;Ne;0;8;0;8
19856;"Lazdynų mokykla (Žėručio g. 4)";RUPG;3000676765;Ne;9;0;0;9
19857;"Lazdynų mokykla (Žėručio g. 4)";RUPG;9968637187;Ne;12;0;1;13
19858;"Lazdynų mokykla (Žėručio g. 4)";RUPG;8886654664;Ne;4;0;0;4
19859;"Lazdynų mokykla (Žėručio g. 4)";RUPG;1910570858;Ne;0;2;0;2
19860;"VĮ Mažasis Trinapolis mok. 160 Eur";Nykštukų;615692580;Ne;6;0;0;6
19861;"VĮ Mažasis Trinapolis mok. 160 Eur";Kėkštukų;2883122532;Ne;9;0;0;9
19862;"VĮ Mažasis Trinapolis mok. 160 Eur";Kėkštukų;2883122532;Ne;9;0;0;9
19863;"VĮ Mažasis Trinapolis mok. 160 Eur";Kėkštukų;2883122532;Ne;9;0;0;9
19864;"VĮ Mažasis Trinapolis mok. 160 Eur";Kėkštukų;6315362421;Ne;7;0;0;7
19865;"VĮ Mažasis Trinapolis mok. 160 Eur";Kėkštukų;6315362421;Ne;7;0;0;7
19866;Santariškių;Serbentukai;2334347228;Ne;5;0;0;5
19867;Santariškių;Serbentukai;7908316429;Ne;4;0;0;4
19868;Santariškių;Serbentukai;9976014841;Ne;5;0;0;5
19869;Santariškių;Serbentukai;6954955786;Ne;5;0;0;5
19870;Santariškių;Obuoliukai;4946587661;Ne;10;0;0;10
19871;Santariškių;Obuoliukai;7657046362;Ne;5;0;0;5
19872;Santariškių;Obuoliukai;2922481794;Ne;5;0;0;5
19873;Santariškių;Žirginėliai;9409374327;Ne;9;0;0;9
19874;Santariškių;Žirginėliai;8069534610;Ne;4;0;0;4
19875;Santariškių;Kankorėžiukai;2762372259;Ne;11;0;0;11
19876;Santariškių;Slyviukai;1851631810;Ne;12;0;0;12
19877;Santariškių;Kriaušiukai;7264402009;Ne;4;0;0;4
19878;Santariškių;Giliukai;1376757822;Ne;10;0;0;10
19879;Santariškių;Giliukai;8969667023;Ne;13;1;0;14
19880;Santariškių;Giliukai;85809010374;Ne;13;0;0;13
19881;Santariškių;Šermukšniukai;7887354416;Ne;5;0;0;5
19882;Santariškių;Šermukšniukai;5750546881;Ne;9;0;0;9
19883;Santariškių;Šermukšniukai;9547725183;Ne;6;0;0;6
19884;Santariškių;Riešutukai;4747657309;Ne;5;0;0;5
19885;Santariškių;Riešutukai;1621601910;Ne;5;0;0;5
19886;Santariškių;Avietėlės;4468637202;Ne;6;0;0;6
19887;Santariškių;Vyšniukai;9819079431;Ne;5;0;0;5
19888;Santariškių;Vyšniukai;8749265990;Ne;5;0;0;5
19889;Santariškių;Agrastukai;5952329323;Ne;10;0;0;10
19890;"Vilnios pagrindinė mokykla";EŽIUKAI;8365999750;Ne;9;0;0;9
19891;"Vilnios pagrindinė mokykla";EŽIUKAI;7264446456;Ne;4;0;0;4
19892;"Vilnios pagrindinė mokykla";EŽIUKAI;6631342796;Taip;1;0;0;1
19893;"„Atžalyno” mokykla-darželis";Giliukai;1209960122;Ne;8;0;3;11
19894;"„Atžalyno” mokykla-darželis";Giliukai;1579954367;Ne;0;5;2;7
19895;"„Atžalyno” mokykla-darželis";Giliukai;2773253032;Ne;6;0;0;6
19896;"„Atžalyno” mokykla-darželis";Giliukai;3170216428;Ne;0;0;3;3
19897;"„Atžalyno” mokykla-darželis";Giliukai;2772290605;Ne;6;0;0;6
19898;"„Atžalyno” mokykla-darželis";Giliukai;5596753512;Ne;2;0;0;2
19899;"„Atžalyno” mokykla-darželis";Giliukai;1958519966;Ne;0;0;6;6
19900;"„Atžalyno” mokykla-darželis";Giliukai;9806203065;Ne;5;0;0;5
19901;"„Atžalyno” mokykla-darželis";Giliukai;8688627865;Ne;1;0;0;1
19902;"„Atžalyno” mokykla-darželis";Giliukai;2601122166;Ne;16;0;0;16
19903;"„Atžalyno” mokykla-darželis";Giliukai;3529875728;Ne;0;0;1;1
19904;"„Atžalyno” mokykla-darželis";Giliukai;1311162040;Ne;7;0;3;10
19905;"„Atžalyno” mokykla-darželis";Giliukai;4427232735;Ne;4;0;6;10
19906;"„Atžalyno” mokykla-darželis";Giliukai;9013323901;Ne;17;0;0;17
19907;"„Atžalyno” mokykla-darželis";Giliukai;8254801574;Ne;0;0;1;1
19908;"„Atžalyno” mokykla-darželis";Giliukai;9215658103;Ne;0;0;1;1
19909;"„Atžalyno” mokykla-darželis";Giliukai;5030879885;Ne;0;0;6;6
19910;"„Atžalyno” mokykla-darželis";Giliukai;3484401937;Ne;0;0;1;1
19911;"„Atžalyno” mokykla-darželis";Riešutėliai;4360099345;Ne;10;2;0;12
19912;"„Atžalyno” mokykla-darželis";Riešutėliai;5947938371;Ne;8;0;10;18
19913;"„Atžalyno” mokykla-darželis";Riešutėliai;5384245347;Ne;0;4;0;4
19914;"„Atžalyno” mokykla-darželis";Riešutėliai;4246430352;Ne;10;0;1;11
19915;"„Atžalyno” mokykla-darželis";Riešutėliai;8574494664;Ne;4;5;0;9
19916;"„Atžalyno” mokykla-darželis";Riešutėliai;5815412814;Ne;0;1;0;1
19917;"„Atžalyno” mokykla-darželis";Riešutėliai;4161658496;Ne;0;0;2;2
19918;"„Atžalyno” mokykla-darželis";Riešutėliai;8942132574;Ne;8;2;0;10
19919;"„Atžalyno” mokykla-darželis";Riešutėliai;7109850241;Taip;0;10;0;10
19920;"„Atžalyno” mokykla-darželis";Riešutėliai;7368616441;Ne;6;0;3;9
19921;"„Atžalyno” mokykla-darželis";Riešutėliai;5242752663;Ne;4;2;0;6
19922;"„Atžalyno” mokykla-darželis";Riešutėliai;5709028342;Ne;8;0;0;8
19923;"„Atžalyno” mokykla-darželis";Riešutėliai;8803555426;Ne;8;0;0;8
19924;"„Atžalyno” mokykla-darželis";Riešutėliai;5994983369;Ne;5;3;1;9
19925;"„Atžalyno” mokykla-darželis";Riešutėliai;1041363325;Ne;0;0;15;15
19926;"„Atžalyno” mokykla-darželis";Riešutėliai;7676614240;Ne;0;10;3;13
19927;"„Atžalyno” mokykla-darželis";Riešutėliai;3751729666;Ne;1;0;4;5
19928;"„Atžalyno” mokykla-darželis";Riešutėliai;3441950153;Ne;0;0;6;6
19929;"„Atžalyno” mokykla-darželis";Riešutėliai;4223591454;Ne;5;0;1;6
19930;"„Atžalyno” mokykla-darželis";Žirniukai;6903825217;Ne;0;10;0;10
19931;"„Atžalyno” mokykla-darželis";Žirniukai;9101301819;Ne;0;0;6;6
19932;"„Atžalyno” mokykla-darželis";Žirniukai;6602037942;Taip;0;1;0;1
19933;"„Atžalyno” mokykla-darželis";Žirniukai;7579781779;Ne;5;3;1;9
19934;"„Atžalyno” mokykla-darželis";Žirniukai;1915676392;Ne;0;0;4;4
19935;"„Atžalyno” mokykla-darželis";Žirniukai;7669725276;Ne;5;11;0;16
19936;"„Atžalyno” mokykla-darželis";Žirniukai;5986664970;Ne;0;9;2;11
19937;"„Atžalyno” mokykla-darželis";Žirniukai;9913048992;Ne;0;8;0;8
19938;"„Atžalyno” mokykla-darželis";Žirniukai;4616870552;Ne;0;0;2;2
19939;"„Atžalyno” mokykla-darželis";Žirniukai;4107946143;Ne;0;0;2;2
19940;"„Atžalyno” mokykla-darželis";Žirniukai;7883570492;Ne;5;8;0;13
19941;"„Atžalyno” mokykla-darželis";Žirniukai;8320161812;Ne;17;3;0;20
19942;"„Atžalyno” mokykla-darželis";Žirniukai;5335059675;Ne;0;11;0;11
19943;"„Atžalyno” mokykla-darželis";Žirniukai;6922776405;Ne;0;1;16;17
19944;"„Atžalyno” mokykla-darželis";Žirniukai;9690554753;Ne;28;0;3;31
19945;"„Atžalyno” mokykla-darželis";Žirniukai;1961428224;Ne;3;0;14;17
19946;"„Atžalyno” mokykla-darželis";Žirniukai;8070499557;Ne;0;7;1;8
19947;"„Atžalyno” mokykla-darželis";Žirniukai;2446697763;Ne;0;0;4;4
19948;"„Atžalyno” mokykla-darželis";Žirniukai;4784990018;Ne;10;1;0;11
19949;"„Atžalyno” mokykla-darželis";VYŠNIUKAI;6120955217;Ne;8;1;0;9
19950;"„Atžalyno” mokykla-darželis";VYŠNIUKAI;1787256844;Ne;24;2;0;26
19951;"„Atžalyno” mokykla-darželis";VYŠNIUKAI;2547003287;Ne;24;2;0;26
19952;"„Atžalyno” mokykla-darželis";VYŠNIUKAI;4503448206;Ne;5;0;0;5
19953;"„Atžalyno” mokykla-darželis";VYŠNIUKAI;3664056583;Ne;10;0;0;10
19954;"„Atžalyno” mokykla-darželis";VYŠNIUKAI;5456248305;Ne;21;0;0;21
19955;"„Atžalyno” mokykla-darželis";VYŠNIUKAI;3719072139;Ne;10;0;1;11
19956;"„Atžalyno” mokykla-darželis";VYŠNIUKAI;9245994735;Ne;20;6;0;26
19957;"„Atžalyno” mokykla-darželis";VYŠNIUKAI;3770167696;Ne;6;0;4;10
19958;"„Atžalyno” mokykla-darželis";VYŠNIUKAI;2000352986;Ne;17;0;0;17
19959;"„Atžalyno” mokykla-darželis";VYŠNIUKAI;2177213062;Ne;8;0;0;8
19960;"„Atžalyno” mokykla-darželis";VYŠNIUKAI;4635394632;Ne;16;0;0;16
19961;"„Atžalyno” mokykla-darželis";VYŠNIUKAI;3524131672;Ne;9;0;0;9
19962;"„Atžalyno” mokykla-darželis";VYŠNIUKAI;4840490901;Ne;22;0;0;22
19963;"„Atžalyno” mokykla-darželis";VYŠNIUKAI;4796052680;Ne;8;0;0;8
19964;"„Atžalyno” mokykla-darželis";VYŠNIUKAI;3181675972;Ne;5;0;2;7
19965;"„Atžalyno” mokykla-darželis";VYŠNIUKAI;8163063211;Ne;4;0;1;5
19966;"„Atžalyno” mokykla-darželis";VYŠNIUKAI;4431437971;Ne;13;2;4;19
19967;"„Atžalyno” mokykla-darželis";PIPIRIUKAI;8357021249;Ne;13;4;0;17
19968;"„Atžalyno” mokykla-darželis";PIPIRIUKAI;4582284727;Ne;10;0;0;10
19969;"„Atžalyno” mokykla-darželis";PIPIRIUKAI;4785607785;Ne;0;0;2;2
19970;"„Atžalyno” mokykla-darželis";PIPIRIUKAI;5615246040;Ne;0;0;3;3
19971;"„Atžalyno” mokykla-darželis";PIPIRIUKAI;1988657552;Ne;14;0;2;16
19972;"„Atžalyno” mokykla-darželis";PIPIRIUKAI;6721771665;Ne;3;0;0;3
19973;"„Atžalyno” mokykla-darželis";PIPIRIUKAI;7946139474;Taip;3;5;0;8
19974;"„Atžalyno” mokykla-darželis";PIPIRIUKAI;2921181385;Ne;8;0;0;8
19975;"„Atžalyno” mokykla-darželis";PIPIRIUKAI;2108706876;Ne;13;0;3;16
19976;"„Atžalyno” mokykla-darželis";PIPIRIUKAI;1228919159;Ne;5;10;0;15
19977;"„Atžalyno” mokykla-darželis";PIPIRIUKAI;3919301151;Ne;10;0;1;11
19978;"„Atžalyno” mokykla-darželis";PIPIRIUKAI;3624299098;Ne;0;4;0;4
19979;"„Atžalyno” mokykla-darželis";PIPIRIUKAI;2537063401;Ne;0;0;4;4
19980;"„Atžalyno” mokykla-darželis";PIPIRIUKAI;4166521512;Ne;11;1;0;12
19981;"„Atžalyno” mokykla-darželis";PIPIRIUKAI;8372179128;Ne;1;0;7;8
19982;"„Atžalyno” mokykla-darželis";PIPIRIUKAI;3204191459;Ne;3;13;0;16
19983;"„Atžalyno” mokykla-darželis";PIPIRIUKAI;3015863723;Ne;13;5;0;18
19984;"„Atžalyno” mokykla-darželis";PIPIRIUKAI;3323233525;Ne;13;5;0;18
19985;"„Atžalyno” mokykla-darželis";PIPIRIUKAI;4596770586;Ne;0;1;0;1
19986;"„Atžalyno” mokykla-darželis";PIPIRIUKAI;7652421432;Ne;1;0;2;3
19987;"Vilniaus Naujininkų mokykla";"SAULĖS ZUIKUČIAI";1096474672;Ne;5;0;1;6
19988;"Vilniaus Naujininkų mokykla";"SAULĖS ZUIKUČIAI";9856315057;Taip;13;0;0;13
19989;"Vilniaus Naujininkų mokykla";"SAULĖS ZUIKUČIAI";1901250406;Ne;0;5;0;5
19990;"Vilniaus Naujininkų mokykla";"SAULĖS ZUIKUČIAI";9427388681;Ne;7;2;0;9
19991;"Vilniaus Naujininkų mokykla";"SAULĖS ZUIKUČIAI";9411054207;Ne;0;4;0;4
19992;"Vilniaus Naujininkų mokykla";"SAULĖS ZUIKUČIAI";3810550099;Ne;0;12;0;12
19993;"Vilniaus Naujininkų mokykla";"SAULĖS ZUIKUČIAI";7692387379;Ne;0;0;1;1
19994;"Vilniaus Naujininkų mokykla";"SAULĖS ZUIKUČIAI";8935072613;Ne;16;0;0;16
19995;"Vilniaus Naujininkų mokykla";"SAULĖS ZUIKUČIAI";9544088525;Ne;8;0;0;8
19996;"Vilniaus Naujininkų mokykla";"SAULĖS ZUIKUČIAI";9488762308;Ne;17;0;1;18
19997;"Vilniaus Naujininkų mokykla";"SAULĖS ZUIKUČIAI";5148002236;Taip;0;1;3;4
19998;"Vilniaus Naujininkų mokykla";"SAULĖS ZUIKUČIAI";8352550813;Ne;9;0;1;10
19999;"Vilniaus Naujininkų mokykla";SMALSUČIAI;1224054771;Ne;0;0;1;1
20000;"Vilniaus Naujininkų mokykla";SMALSUČIAI;79174984189;Ne;0;0;1;1
20001;"Vilniaus Naujininkų mokykla";SMALSUČIAI;1662993666;Ne;0;0;1;1
20002;"Vilniaus Naujininkų mokykla";SMALSUČIAI;7144596269;Ne;0;5;0;5
20003;"Vilniaus Naujininkų mokykla";SMALSUČIAI;6362889550;Ne;10;0;3;13
20004;"Vilniaus Naujininkų mokykla";SMALSUČIAI;1980755137;Ne;4;4;0;8
20005;"Vilniaus Naujininkų mokykla";SMALSUČIAI;1920917916;Ne;5;4;0;9
20006;"Vilniaus Naujininkų mokykla";SMALSUČIAI;8828658544;Ne;0;0;1;1
20007;"Vilniaus Naujininkų mokykla";SMALSUČIAI;5633127620;Ne;0;0;11;11
20008;"Vilniaus Naujininkų mokykla";SMALSUČIAI;3867799187;Ne;12;0;1;13
20009;"Vilniaus Naujininkų mokykla";SMALSUČIAI;1350744949;Ne;0;0;3;3
20010;"Vilniaus Naujininkų mokykla";SMALSUČIAI;63557632023;Ne;0;1;0;1
20011;"Vilniaus Naujininkų mokykla";SMALSUČIAI;8280826634;Ne;0;0;2;2
20012;"Vilniaus Naujininkų mokykla";SMALSUČIAI;5302103644;Ne;0;8;0;8
20013;"Vilniaus Naujininkų mokykla";SMALSUČIAI;5638817349;Ne;0;0;1;1
20014;"Vilniaus Naujininkų mokykla";SMALSUČIAI;1880254518;Ne;1;0;0;1
20015;"Vilniaus Naujininkų mokykla";SMALSUČIAI;2113295854;Ne;0;0;1;1
20016;"Vilniaus Taikos progimnazija";ŽINIUKŲ;4256675710;Ne;8;0;0;8
20017;"Vilniaus Taikos progimnazija";ŽINIUKŲ;1876645582;Ne;5;0;0;5
20018;"Vilniaus Taikos progimnazija";ŽINIUKŲ;2002197530;Ne;10;0;0;10
20019;"Vilniaus Taikos progimnazija";KODĖLČIUKŲ;63633096713;Ne;10;0;0;10
20020;"Vilniaus karaliaus Mindaugo mokykla";"PUG 2";8957131694;Ne;5;0;5;10
20021;"Vilniaus karaliaus Mindaugo mokykla";"PUG 2";1146561649;Ne;0;0;4;4
20022;"Vilniaus karaliaus Mindaugo mokykla";"PUG 2";1159232792;Ne;6;0;3;9
20023;"Vilniaus karaliaus Mindaugo mokykla";"PUG 2";2248658930;Ne;10;0;2;12
20024;"Vilniaus karaliaus Mindaugo mokykla";"PUG 2";2092637040;Ne;11;0;0;11
20025;"Vilniaus karaliaus Mindaugo mokykla";"PUG 2";5029631107;Ne;0;0;5;5
20026;"Vilniaus karaliaus Mindaugo mokykla";"PUG 2";6196554287;Ne;8;0;1;9
20027;"Vilniaus karaliaus Mindaugo mokykla";"PUG 2";4661051023;Ne;0;0;5;5
20028;"Vilniaus karaliaus Mindaugo mokykla";"PUG 2";1507200600;Ne;0;0;6;6
20029;"Vilniaus karaliaus Mindaugo mokykla";"PUG 2";7440474403;Ne;0;0;5;5
20030;"Vilniaus karaliaus Mindaugo mokykla";"PUG 2";8860314164;Ne;0;15;0;15
20031;"Vilniaus karaliaus Mindaugo mokykla";"PUG 2";4684525618;Ne;6;0;0;6
20032;"Vilniaus karaliaus Mindaugo mokykla";"PUG 2";2876837284;Ne;8;0;0;8
20033;"Vilniaus karaliaus Mindaugo mokykla";"PUG 1";8879549409;Ne;0;0;7;7
20034;"Vilniaus karaliaus Mindaugo mokykla";"PUG 1";1781442182;Ne;6;0;1;7
20035;"Vilniaus karaliaus Mindaugo mokykla";"PUG 1";6299298199;Ne;0;0;1;1
20036;"Vilniaus karaliaus Mindaugo mokykla";"PUG 1";35830862363;Ne;0;1;0;1
20037;"Vilniaus karaliaus Mindaugo mokykla";"PUG 1";4143153535;Ne;0;0;2;2
20038;"Vilniaus karaliaus Mindaugo mokykla";"PUG 1";1505918280;Ne;6;0;0;6
20039;"Vilniaus karaliaus Mindaugo mokykla";"PUG 1";1445657342;Ne;0;0;3;3
20040;"Vilniaus karaliaus Mindaugo mokykla";"PUG 1";9313380552;Ne;8;0;0;8
20041;"Vilniaus karaliaus Mindaugo mokykla";"PUG 1";7782678159;Ne;0;1;0;1
20042;"Vilniaus karaliaus Mindaugo mokykla";"PUG 1";14043704729;Ne;0;0;2;2
20043;"Vilniaus karaliaus Mindaugo mokykla";"PUG 1";4724383814;Ne;14;0;0;14
20044;"Vilniaus karaliaus Mindaugo mokykla";"PUG 1";1376514473;Ne;11;0;1;12
20045;"Vilniaus karaliaus Mindaugo mokykla";"PUG 1";7543795007;Ne;5;0;0;5
20046;"Vilniaus karaliaus Mindaugo mokykla";"PUG 1";9522269582;Ne;6;0;6;12
20047;"Vilniaus karaliaus Mindaugo mokykla";"PUG 3";3490705425;Ne;5;0;0;5
20048;"Vilniaus karaliaus Mindaugo mokykla";"PUG 3";2836206893;Ne;2;0;0;2
20049;"Vilniaus karaliaus Mindaugo mokykla";"PUG 3";38426234048;Ne;0;5;0;5
20050;"Vilniaus karaliaus Mindaugo mokykla";"PUG 3";1502213914;Ne;0;0;2;2
20051;"Vilniaus karaliaus Mindaugo mokykla";"PUG 3";1929838733;Ne;10;0;3;13
20052;"Vilniaus karaliaus Mindaugo mokykla";"PUG 3";3344717003;Ne;0;1;0;1
20053;"Vilniaus karaliaus Mindaugo mokykla";"PUG 3";4677405885;Ne;0;0;2;2
20054;"Vilniaus karaliaus Mindaugo mokykla";"PUG 3";6406285034;Ne;0;0;5;5
20055;"Vilniaus karaliaus Mindaugo mokykla";"PUG 3";2043786151;Ne;9;0;0;9
20056;Ąžuolas;Nykštukų;2444496734;Ne;3;0;0;3
20057;Ąžuolas;Nykštukų;3500326530;Ne;12;0;0;12
20058;Ąžuolas;Nykštukų;7514774129;Ne;12;0;0;12
20059;Ąžuolas;Nykštukų;6774621338;Ne;4;0;0;4
20060;Ąžuolas;Nykštukų;8527673917;Ne;9;0;0;9
20061;Ąžuolas;Boružiukų;3776024233;Ne;1;0;0;1
20062;Ąžuolas;Boružiukų;8910442426;Ne;10;0;0;10
20063;Ąžuolas;Boružiukų;5981498599;Ne;5;0;0;5
20064;Ąžuolas;Boružiukų;5473340721;Ne;6;0;0;6
20065;Ąžuolas;Boružiukų;1039931951;Ne;10;0;0;10
20066;Ąžuolas;Boružiukų;8526109093;Ne;5;0;0;5
20067;Ąžuolas;Boružiukų;2204716407;Ne;5;0;0;5
20068;Ąžuolas;Boružiukų;9746921429;Ne;8;0;0;8
20069;Ąžuolas;Boružiukų;7324049199;Ne;4;0;0;4
20070;Ąžuolas;Spinduliukų;1513053027;Ne;3;0;0;3
20071;Ąžuolas;Spinduliukų;8252275926;Ne;5;0;0;5
20072;Ąžuolas;Zuikučių;8615752261;Ne;2;0;0;2
20073;Ąžuolas;Zuikučių;3809638495;Ne;6;0;0;6
20074;Ąžuolas;Zuikučių;8763973830;Ne;14;0;0;14
20075;Ąžuolas;Zuikučių;6822523548;Ne;8;0;0;8
20076;Ąžuolas;Zuikučių;9640621123;Ne;19;0;0;19
20077;Ąžuolas;Zuikučių;9058138845;Ne;3;0;0;3
20078;Ąžuolas;Zuikučių;1874874608;Ne;14;0;0;14
20079;Ąžuolas;Lašiukų;1986875375;Ne;1;0;0;1
20080;Ąžuolas;Lašiukų;6757503530;Ne;1;0;0;1
20081;Ąžuolas;Drugelių;9269381450;Ne;5;0;0;5
20082;Ąžuolas;Drugelių;2929166765;Ne;6;0;0;6
20083;Ąžuolas;Žemuogėlių;9193606783;Ne;9;0;0;9
20084;Ąžuolas;Žemuogėlių;4566184004;Ne;7;0;0;7
20085;Ąžuolas;Žvaigždučių;1952851263;Ne;4;0;0;4
20086;Ąžuolas;Žvaigždučių;2617592224;Ne;5;0;0;5
20087;Ąžuolas;Žvaigždučių;4766617696;Ne;8;0;0;8
20088;Ąžuolas;Žvaigždučių;8159667094;Ne;2;0;0;2
20089;Ąžuolas;Paukštelių;8601254064;Ne;5;0;0;5
20090;Ąžuolas;Bitučių;3590540514;Ne;6;0;0;6
20091;Ąžuolas;Bitučių;5842415245;Ne;4;0;0;4
20092;Ąžuolas;Bitučių;5472436999;Ne;5;0;0;5
20093;Ąžuolas;Bitučių;1087056237;Ne;2;0;0;2
20094;Ąžuolas;Bitučių;3318621681;Ne;4;0;0;4
20095;Ąžuolas;Bitučių;8703116268;Taip;1;0;0;1
20096;Ąžuolas;Bitučių;1369962422;Taip;5;0;0;5
20097;Ąžuolas;Giliukų;3707386873;Ne;7;0;0;7
20098;"Vilniaus Levo Karsavino vidurinė mokykla";PELEDŽIUKAI;2149830021;Ne;1;0;1;2
20099;"Vilniaus Levo Karsavino vidurinė mokykla";PELEDŽIUKAI;2718046390;Ne;6;0;1;7
20100;"Vilniaus Levo Karsavino vidurinė mokykla";PELEDŽIUKAI;9094287056;Ne;11;0;0;11
20101;"Vilniaus Levo Karsavino vidurinė mokykla";PELEDŽIUKAI;6917007871;Ne;4;0;6;10
20102;"Vilniaus Levo Karsavino vidurinė mokykla";PELEDŽIUKAI;3452236805;Ne;0;20;0;20
20103;"Vilniaus Levo Karsavino vidurinė mokykla";PELEDŽIUKAI;4066969586;Ne;0;0;10;10
20104;"Vilniaus Levo Karsavino vidurinė mokykla";PELEDŽIUKAI;8564433463;Ne;3;0;3;6
20105;"Vilniaus Levo Karsavino vidurinė mokykla";PELEDŽIUKAI;1067737206;Ne;0;8;0;8
20106;"Vilniaus Levo Karsavino vidurinė mokykla";PELEDŽIUKAI;1288690113;Ne;0;2;0;2
20107;"Vilniaus Levo Karsavino vidurinė mokykla";PELEDŽIUKAI;55396452032;Ne;2;0;0;2
20108;"Vilniaus Levo Karsavino vidurinė mokykla";PELEDŽIUKAI;2276463136;Ne;4;0;0;4
20109;"Vilniaus Levo Karsavino vidurinė mokykla";PELEDŽIUKAI;43259107285;Ne;0;5;0;5
20110;"Vilniaus Levo Karsavino vidurinė mokykla";PELEDŽIUKAI;9947263640;Ne;0;6;4;10
20111;"Vilniaus Levo Karsavino vidurinė mokykla";PELEDŽIUKAI;3641595127;Ne;4;0;1;5
20112;"Vilniaus Levo Karsavino vidurinė mokykla";PELEDŽIUKAI;3254847545;Ne;0;20;0;20
20113;"Vilniaus Levo Karsavino vidurinė mokykla";PELEDŽIUKAI;3381954095;Ne;0;0;2;2
20114;"Vilniaus Levo Karsavino vidurinė mokykla";PELEDŽIUKAI;7227603702;Ne;5;0;0;5
20115;"Vilniaus Levo Karsavino vidurinė mokykla";PELEDŽIUKAI;57138305703;Ne;3;0;7;10
20116;"Vilniaus Levo Karsavino vidurinė mokykla";PELEDŽIUKAI;5768653399;Ne;7;0;2;9
20117;"Vilniaus Levo Karsavino vidurinė mokykla";Žiniukai;5452659798;Ne;0;1;0;1
20118;"Vilniaus Levo Karsavino vidurinė mokykla";Žiniukai;5803032683;Ne;13;0;0;13
20119;"Vilniaus Levo Karsavino vidurinė mokykla";Žiniukai;2306517891;Ne;0;20;0;20
20120;"Vilniaus Levo Karsavino vidurinė mokykla";Žiniukai;1428614163;Ne;7;0;1;8
20121;"Vilniaus Levo Karsavino vidurinė mokykla";Žiniukai;9801214344;Ne;0;20;0;20
20122;"Vilniaus Levo Karsavino vidurinė mokykla";Žiniukai;8180889070;Ne;8;0;1;9
20123;"Vilniaus Levo Karsavino vidurinė mokykla";Žiniukai;7023565057;Ne;1;0;1;2
20124;"Vilniaus Levo Karsavino vidurinė mokykla";Žiniukai;3379725202;Ne;14;0;1;15
20125;"Vilniaus Levo Karsavino vidurinė mokykla";Žiniukai;7298260831;Ne;0;0;2;2
20126;"Vilniaus Levo Karsavino vidurinė mokykla";Žiniukai;4302751308;Ne;4;0;0;4
20127;"Vilniaus Levo Karsavino vidurinė mokykla";Žiniukai;7920182730;Ne;9;0;0;9
20128;"Vilniaus Levo Karsavino vidurinė mokykla";Žiniukai;12377363480;Ne;5;0;0;5
20129;"Vilniaus Levo Karsavino vidurinė mokykla";Žiniukai;8199573104;Ne;2;0;2;4
20130;"Vilniaus Levo Karsavino vidurinė mokykla";Žiniukai;9589810356;Ne;0;0;1;1
20131;"Vilniaus Levo Karsavino vidurinė mokykla";Žiniukai;64214150955;Ne;1;0;0;1
20132;"Vilniaus Levo Karsavino vidurinė mokykla";Žiniukai;6340289012;Ne;0;0;1;1
20133;"Vilniaus Liepkalnio Pagrindinė Mokykla";Bitutės;5597152556;Ne;0;0;1;1
20134;"Vilniaus Liepkalnio Pagrindinė Mokykla";Bitutės;4115995882;Ne;0;0;9;9
20135;"Vilniaus Liepkalnio Pagrindinė Mokykla";Bitutės;6136792125;Ne;1;0;3;4
20136;"Vilniaus Liepkalnio Pagrindinė Mokykla";Bitutės;9293634828;Ne;9;0;0;9
20137;"Vilniaus Liepkalnio Pagrindinė Mokykla";Bitutės;8324581018;Ne;0;0;7;7
20138;"Vilniaus Liepkalnio Pagrindinė Mokykla";Bitutės;1599633295;Ne;13;0;0;13
20139;"Vilniaus Liepkalnio Pagrindinė Mokykla";Bitutės;9589525954;Ne;0;0;3;3
20140;"Vilniaus Liepkalnio Pagrindinė Mokykla";Bitutės;7052487356;Ne;0;0;3;3
20141;"Vilniaus Liepkalnio Pagrindinė Mokykla";Bitutės;2080390421;Ne;0;0;3;3
20142;"Vilniaus Liepkalnio Pagrindinė Mokykla";Bitutės;5323726165;Ne;9;0;1;10
20143;"Vilniaus Liepkalnio Pagrindinė Mokykla";Bitutės;7922755136;Ne;15;0;1;16
20144;"Vilniaus Liepkalnio Pagrindinė Mokykla";Bitutės;1795366502;Ne;0;0;12;12
20145;"Vilniaus Liepkalnio Pagrindinė Mokykla";Bitutės;9211966929;Ne;0;0;6;6
20146;"Vilniaus Liepkalnio Pagrindinė Mokykla";Bitutės;4112888719;Ne;0;0;2;2
20147;"Vilniaus Liepkalnio Pagrindinė Mokykla";Bitutės;8809471063;Ne;5;0;2;7
20148;"Vilniaus Liepkalnio Pagrindinė Mokykla";Bitutės;9771780358;Ne;0;0;11;11
20149;"Vilniaus Liepkalnio Pagrindinė Mokykla";Bitutės;4973569038;Ne;0;0;1;1
20150;"Vilniaus Pranciškaus Skorinos gimnazija";Saulytė;5194059497;Ne;18;0;1;19
20151;"Vilniaus Pranciškaus Skorinos gimnazija";Saulytė;5034268767;Ne;3;4;2;9
20152;"Vilniaus Pranciškaus Skorinos gimnazija";Saulytė;3036582121;Ne;5;0;0;5
20153;"Vilniaus Pranciškaus Skorinos gimnazija";Saulytė;5304082676;Ne;31;0;0;31
20154;"Vilniaus Pranciškaus Skorinos gimnazija";Saulytė;7055894770;Ne;0;1;0;1
20155;"Vilniaus Pranciškaus Skorinos gimnazija";Saulytė;6995285377;Ne;3;1;0;4
20156;"Vilniaus Pranciškaus Skorinos gimnazija";Saulytė;3984446381;Ne;7;2;0;9
20157;"Vilniaus Pranciškaus Skorinos gimnazija";Saulytė;8641919789;Ne;0;0;2;2
20158;"Vilniaus Pranciškaus Skorinos gimnazija";Saulytė;5733610359;Ne;14;0;1;15
20159;"Vilniaus Pranciškaus Skorinos gimnazija";Saulytė;4501408366;Ne;7;0;0;7
20160;"Vilniaus Pranciškaus Skorinos gimnazija";Saulytė;4705514590;Ne;6;1;0;7
20161;"Vilniaus Pranciškaus Skorinos gimnazija";Saulytė;4165354124;Ne;15;1;0;16
20162;"Vilniaus Pranciškaus Skorinos gimnazija";Saulytė;6940231858;Ne;6;7;0;13
20163;"Vilniaus Pranciškaus Skorinos gimnazija";Saulytė;8572069816;Ne;15;0;0;15
20164;"Vilniaus Pranciškaus Skorinos gimnazija";Saulytė;3354419392;Ne;0;31;0;31
20165;"Vilniaus Pranciškaus Skorinos gimnazija";Saulytė;9176198859;Ne;0;0;2;2
20166;"Vilniaus Pranciškaus Skorinos gimnazija";Saulytė;3234612149;Ne;12;5;0;17
20167;"Vilniaus Simono Konarskio mokykla";"1 GR.";1464992631;Ne;1;0;0;1
20168;"Vilniaus Simono Konarskio mokykla";"1 GR.";4463822099;Ne;4;0;0;4
20169;"Vilniaus Simono Konarskio mokykla";"1 GR.";9079781265;Ne;7;0;0;7
20170;"Vilniaus Simono Konarskio mokykla";"1 GR.";5073378325;Ne;7;0;0;7
20171;"Vilniaus Simono Konarskio mokykla";"1 GR.";9093492513;Ne;11;0;0;11
20172;"Vilniaus Simono Konarskio mokykla";"1 GR.";7701956270;Ne;6;0;0;6
20173;"Vilniaus Trakų Vokės gimnazija";Priešmokyklinė;5299428924;Ne;3;0;0;3
20174;"Vilniaus Trakų Vokės gimnazija";Priešmokyklinė;9386629495;Ne;1;0;0;1
20175;"Vilniaus Trakų Vokės gimnazija";Priešmokyklinė;6209271043;Ne;0;0;2;2
20176;"Vilniaus Trakų Vokės gimnazija";Priešmokyklinė;3406479364;Ne;4;1;0;5
20177;"Vilniaus Trakų Vokės gimnazija";Priešmokyklinė;5526830430;Ne;3;1;0;4
20178;"Vilniaus Trakų Vokės gimnazija";Priešmokyklinė;4849992906;Ne;0;9;0;9
20179;"Vilniaus Trakų Vokės gimnazija";Priešmokyklinė;8542147751;Ne;3;0;0;3
20180;"Vilniaus Trakų Vokės gimnazija";Priešmokyklinė;2672165297;Ne;0;0;1;1
20181;"Vilniaus Trakų Vokės gimnazija";Priešmokyklinė;2955411131;Ne;0;1;1;2
20182;"Vilniaus Trakų Vokės gimnazija";Priešmokyklinė;1433982328;Ne;0;0;1;1
20183;"Vilniaus Trakų Vokės gimnazija";Priešmokyklinė;8658085249;Ne;0;0;3;3
20184;"Vilniaus Trakų Vokės gimnazija";Priešmokyklinė;39255784762;Ne;2;0;0;2
20185;"Vilniaus Trakų Vokės gimnazija";Priešmokyklinė;4599632235;Ne;3;2;0;5
20186;"Vilniaus Trakų Vokės gimnazija";Priešmokyklinė;2839396687;Ne;1;2;3;6
20187;"Vilniaus Trakų Vokės gimnazija";Priešmokyklinė;8857529726;Ne;7;0;0;7
20188;"Vilniaus Trakų Vokės gimnazija";Priešmokyklinė;7566567901;Ne;0;0;6;6
20189;"Vilniaus Trakų Vokės gimnazija";"Priešmokyklinė 2";4362066941;Ne;0;8;5;13
20190;"Vilniaus Trakų Vokės gimnazija";"Priešmokyklinė 2";1074730366;Ne;2;0;0;2
20191;"Vilniaus Trakų Vokės gimnazija";"Priešmokyklinė 2";6593654477;Ne;7;0;1;8
20192;"Vilniaus Trakų Vokės gimnazija";"Priešmokyklinė 2";9582511053;Ne;8;6;0;14
20193;"Vilniaus Trakų Vokės gimnazija";"Priešmokyklinė 2";3775081619;Ne;0;1;1;2
20194;"Vilniaus Trakų Vokės gimnazija";"Priešmokyklinė 2";4615315809;Ne;0;1;1;2
20195;"Vilniaus Trakų Vokės gimnazija";"Priešmokyklinė 2";25106446270;Ne;0;3;0;3
20196;"Vilniaus Trakų Vokės gimnazija";"Priešmokyklinė 2";18963190527;Ne;0;1;0;1
20197;"Vilniaus Trakų Vokės gimnazija";"Priešmokyklinė 2";4914675622;Ne;0;1;1;2
20198;"Vilniaus Trakų Vokės gimnazija";"Priešmokyklinė 2";5251929660;Ne;0;21;0;21
20199;"Vilniaus Trakų Vokės gimnazija";"Priešmokyklinė 2";3690179876;Ne;0;0;10;10
20200;"Vilniaus Trakų Vokės gimnazija";"Priešmokyklinė 2";8218370873;Ne;0;1;0;1
20201;"Vilniaus Trakų Vokės gimnazija";"Priešmokyklinė 2";4720226790;Ne;5;0;0;5
20202;"Vilniaus Trakų Vokės gimnazija";"Priešmokyklinė 2";1057189769;Ne;0;0;2;2
20203;"Vilniaus Trakų Vokės gimnazija";"Priešmokyklinė 2";2149804129;Ne;0;1;0;1
20204;"Vilniaus Trakų Vokės gimnazija";"Priešmokyklinė 2";1590598232;Ne;0;0;4;4
20205;"Vilniaus Trakų Vokės gimnazija";"Priešmokyklinė 2";8168960897;Ne;0;3;0;3
20206;"Vilniaus Trakų Vokės gimnazija";"Priešmokyklinė 2";9039274775;Ne;6;0;6;12
20207;"Vilniaus Trakų Vokės gimnazija";"Priešmokyklinė 3";7547303829;Ne;6;0;5;11
20208;"Vilniaus Trakų Vokės gimnazija";"Priešmokyklinė 3";2301758912;Ne;0;3;3;6
20209;"Vilniaus Trakų Vokės gimnazija";"Priešmokyklinė 3";7792654474;Ne;2;1;0;3
20210;"Vilniaus Trakų Vokės gimnazija";"Priešmokyklinė 3";3449317958;Ne;5;0;2;7
20211;"Vilniaus Trakų Vokės gimnazija";"Priešmokyklinė 3";9268558715;Ne;3;0;2;5
20212;"Vilniaus Trakų Vokės gimnazija";"Priešmokyklinė 3";9668538340;Ne;0;0;2;2
20213;"Vilniaus Trakų Vokės gimnazija";"Priešmokyklinė 3";2469486746;Ne;0;0;9;9
20214;"Vilniaus Trakų Vokės gimnazija";"Priešmokyklinė 3";95320712086;Ne;0;0;1;1
20215;"Vilniaus Trakų Vokės gimnazija";"Priešmokyklinė 3";1053286928;Ne;0;0;3;3
20216;"Vilniaus Trakų Vokės gimnazija";"Priešmokyklinė 3";5115117246;Ne;6;0;14;20
20217;"Vilniaus Trakų Vokės gimnazija";"Priešmokyklinė 3";6765094662;Taip;6;3;0;9
20218;"Vilniaus Trakų Vokės gimnazija";"Priešmokyklinė 3";6835150864;Ne;0;6;0;6
20219;"Vilniaus Trakų Vokės gimnazija";"Priešmokyklinė 3";1940148622;Ne;0;0;13;13
20220;"Vilniaus Trakų Vokės gimnazija";"Priešmokyklinė 3";8929514493;Ne;8;0;0;8
20221;"Vilniaus Trakų Vokės gimnazija";"Priešmokyklinė 3";9051697544;Ne;7;0;3;10
20222;"Vilniaus Trakų Vokės gimnazija";"Priešmokyklinė 3";1398572100;Ne;5;0;2;7
20223;"Vilniaus Salininkų gimnazija";"Priešmokyklinė A";10335028421;Ne;0;1;0;1
20224;"Vilniaus Salininkų gimnazija";"Priešmokyklinė A";1180792335;Ne;1;0;0;1
20225;"Vilniaus Salininkų gimnazija";"Priešmokyklinė A";5063792784;Ne;7;0;0;7
20226;"Vilniaus Salininkų gimnazija";"Priešmokyklinė A";1704033440;Ne;9;0;0;9
20227;"Vilniaus Salininkų gimnazija";"Priešmokyklinė A";46867660097;Ne;0;3;0;3
20228;"Vilniaus Salininkų gimnazija";"Priešmokyklinė A";3692008687;Ne;9;3;0;12
20229;"Vilniaus Salininkų gimnazija";"Priešmokyklinė A";2292919406;Ne;0;5;0;5
20230;"Vilniaus Salininkų gimnazija";"Priešmokyklinė A";4269202761;Ne;8;2;0;10
20231;"Vilniaus Salininkų gimnazija";"Priešmokyklinė A";9375550172;Ne;0;2;0;2
20232;"Vilniaus Salininkų gimnazija";"Priešmokyklinė A";7160091629;Ne;0;5;0;5
20233;"Vilniaus Salininkų gimnazija";"Priešmokyklinė A";41023354439;Ne;7;0;0;7
20234;"Vilniaus Salininkų gimnazija";"Priešmokyklinė A";3848448401;Ne;9;1;0;10
20235;"Vilniaus Salininkų gimnazija";"Priešmokyklinė A";3737786832;Ne;0;2;0;2
20236;"Vilniaus Salininkų gimnazija";"Priešmokyklinė A";8025611655;Ne;1;0;0;1
20237;"Vilniaus Salininkų gimnazija";"Priešmokyklinė A";4939261324;Ne;7;0;0;7
20238;"Vilniaus Salininkų gimnazija";"Priešmokyklinė A";6738902611;Ne;0;20;0;20
20239;"Vilniaus Salininkų gimnazija";"Priešmokyklinė A";2989580886;Ne;2;0;0;2
20240;"Vilniaus Salininkų gimnazija";"Priešmokyklinė A";3661928980;Ne;7;0;0;7
20241;"Vilniaus Salininkų gimnazija";"PRIEŠMOKYKLINĖ B";98941037508;Ne;0;20;0;20
20242;"Vilniaus Salininkų gimnazija";"PRIEŠMOKYKLINĖ B";8018093186;Ne;3;0;0;3
20243;"Vilniaus Salininkų gimnazija";"PRIEŠMOKYKLINĖ B";9216372353;Ne;2;0;0;2
20244;"Vilniaus Salininkų gimnazija";"PRIEŠMOKYKLINĖ B";3015424614;Ne;9;0;0;9
20245;"Vilniaus Salininkų gimnazija";"PRIEŠMOKYKLINĖ B";8488127476;Ne;2;0;0;2
20246;"Vilniaus Salininkų gimnazija";"PRIEŠMOKYKLINĖ B";8410624264;Ne;10;2;0;12
20247;"Vilniaus Salininkų gimnazija";"PRIEŠMOKYKLINĖ B";1544346282;Ne;1;0;0;1
20248;"Vilniaus Salininkų gimnazija";"PRIEŠMOKYKLINĖ B";1723241116;Ne;10;0;0;10
20249;"Vilniaus Salininkų gimnazija";"PRIEŠMOKYKLINĖ B";1460694577;Ne;1;1;0;2
20250;"Vilniaus Salininkų gimnazija";"PRIEŠMOKYKLINĖ B";5689344488;Ne;1;0;0;1
20251;"Vilniaus Salininkų gimnazija";"PRIEŠMOKYKLINĖ B";91859774311;Ne;1;0;0;1
20252;"Vilniaus Salininkų gimnazija";"PRIEŠMOKYKLINĖ B";9026612929;Ne;0;20;0;20
20253;"Vilniaus Salininkų gimnazija";"PRIEŠMOKYKLINĖ B";4271670413;Ne;3;0;0;3
20254;"Vilniaus „Spindulio“ progimnazija";PM2;3093606855;Ne;5;0;1;6
20255;"Vilniaus „Spindulio“ progimnazija";PM2;6304295422;Ne;0;0;1;1
20256;"Vilniaus „Spindulio“ progimnazija";PM2;9099945815;Ne;4;1;0;5
20257;"Vilniaus „Spindulio“ progimnazija";PM2;75538036055;Ne;0;1;0;1
20258;"Vilniaus „Spindulio“ progimnazija";PM2;15583558585;Ne;7;2;0;9
20259;"Vilniaus „Spindulio“ progimnazija";PM2;2427349194;Ne;9;0;0;9
20260;"Vilniaus „Spindulio“ progimnazija";PM2;7445566160;Ne;4;1;0;5
20261;"Vilniaus „Spindulio“ progimnazija";PM2;6561536457;Ne;0;2;0;2
20262;"Vilniaus „Spindulio“ progimnazija";PM2;8023936861;Ne;3;1;0;4
20263;"Vilniaus „Spindulio“ progimnazija";PM2;7277680544;Ne;0;1;0;1
20264;"Vilniaus „Spindulio“ progimnazija";PM2;6479094819;Ne;2;0;0;2
20265;"Vilniaus „Spindulio“ progimnazija";PM2;2356833740;Ne;0;0;2;2
20266;"Vilniaus „Spindulio“ progimnazija";PM2;9516852657;Ne;0;0;1;1
20267;"Vilniaus „Spindulio“ progimnazija";PM2;7120717682;Ne;0;2;0;2
20268;"Vilniaus „Spindulio“ progimnazija";PM2;1183272346;Ne;2;0;0;2
20269;"Vilniaus „Spindulio“ progimnazija";PM2;6201567680;Ne;0;0;3;3
20270;"Vilniaus „Spindulio“ progimnazija";PM2;8012626513;Ne;5;1;0;6
20271;"Vilniaus „Spindulio“ progimnazija";PM2;52216192635;Ne;0;0;1;1
20272;"Vilniaus „Spindulio“ progimnazija";PM1;1948438336;Ne;0;2;1;3
20273;"Vilniaus „Spindulio“ progimnazija";PM1;43859975789;Ne;0;0;1;1
20274;"Vilniaus „Spindulio“ progimnazija";PM1;60320557464;Ne;0;1;0;1
20275;"Vilniaus „Spindulio“ progimnazija";PM1;2531571615;Ne;0;2;0;2
20276;"Vilniaus „Spindulio“ progimnazija";PM1;1194444282;Ne;0;1;0;1
20277;"Vilniaus „Spindulio“ progimnazija";PM1;56885383122;Ne;0;3;0;3
20278;"Vilniaus „Spindulio“ progimnazija";PM1;1338476746;Ne;2;0;0;2
20279;"Vilniaus „Spindulio“ progimnazija";PM1;2402204674;Ne;0;1;0;1
20280;"Vilniaus „Spindulio“ progimnazija";PM1;6700068320;Taip;0;2;2;4
20281;"Vilniaus „Spindulio“ progimnazija";PM1;9347513042;Ne;0;1;0;1
20282;"Vilniaus „Spindulio“ progimnazija";PM1;1153333591;Ne;0;1;0;1
20283;"Vilniaus „Spindulio“ progimnazija";PM1;9573336239;Ne;0;1;0;1
20284;"Vilniaus „Spindulio“ progimnazija";PM1;1454101129;Ne;5;0;0;5
20285;"Vilniaus „Spindulio“ progimnazija";PM1;1325054642;Ne;0;1;0;1
20286;"Vilniaus „Spindulio“ progimnazija";PM1;91028452879;Ne;20;0;0;20
20287;"Vilniaus „Spindulio“ progimnazija";PM1;1789047913;Ne;0;2;0;2
20288;"Vilniaus Vladislavo Sirokomlės gimnazija";Nykštukai;6031408197;Ne;3;0;1;4
20289;"Vilniaus Vladislavo Sirokomlės gimnazija";Nykštukai;1499061139;Ne;26;5;0;31
20290;"Vilniaus Vladislavo Sirokomlės gimnazija";Nykštukai;2219712757;Ne;5;0;0;5
20291;"Vilniaus Vladislavo Sirokomlės gimnazija";Nykštukai;5544613599;Ne;2;4;0;6
20292;"Vilniaus Vladislavo Sirokomlės gimnazija";Nykštukai;25415760747;Ne;0;2;0;2
20293;"Vilniaus Vladislavo Sirokomlės gimnazija";Nykštukai;17201639406;Ne;6;0;0;6
20294;"Vilniaus Vladislavo Sirokomlės gimnazija";Nykštukai;8302624354;Ne;11;1;0;12
20295;"Vilniaus Vladislavo Sirokomlės gimnazija";Nykštukai;1492328724;Ne;0;0;1;1
20296;"Vilniaus Vladislavo Sirokomlės gimnazija";Nykštukai;4436165764;Ne;0;7;0;7
20297;"Vilniaus Vladislavo Sirokomlės gimnazija";Nykštukai;1837566431;Ne;0;2;0;2
20298;"Vilniaus Vladislavo Sirokomlės gimnazija";Nykštukai;4534828670;Ne;4;27;0;31
20299;"Vilniaus Vladislavo Sirokomlės gimnazija";Nykštukai;9391697537;Ne;0;1;0;1
20300;"Vilniaus Vladislavo Sirokomlės gimnazija";Nykštukai;5422289286;Ne;0;3;2;5
20301;"Vilniaus Vladislavo Sirokomlės gimnazija";Nykštukai;5625943720;Ne;5;7;0;12
20302;"Vilniaus Vladislavo Sirokomlės gimnazija";Nykštukai;2946297529;Ne;0;1;0;1
20303;"Vilniaus Vladislavo Sirokomlės gimnazija";Smurfai;9751494612;Ne;0;2;0;2
20304;"Vilniaus Vladislavo Sirokomlės gimnazija";Smurfai;4727265555;Ne;15;2;0;17
20305;"Vilniaus Vladislavo Sirokomlės gimnazija";Smurfai;1493604303;Ne;0;1;0;1
20306;"Vilniaus Vladislavo Sirokomlės gimnazija";Smurfai;4830374546;Ne;6;4;0;10
20307;"Vilniaus Vladislavo Sirokomlės gimnazija";Smurfai;4506651162;Ne;0;1;0;1
20308;"Vilniaus Vladislavo Sirokomlės gimnazija";Smurfai;1817869518;Ne;9;4;0;13
20309;"Vilniaus Vladislavo Sirokomlės gimnazija";Smurfai;7904983228;Ne;1;3;0;4
20310;"Vilniaus Vladislavo Sirokomlės gimnazija";Smurfai;1570206034;Ne;5;4;0;9
20311;"Vilniaus Vladislavo Sirokomlės gimnazija";Smurfai;2386927970;Ne;4;1;0;5
20312;"Vilniaus Vladislavo Sirokomlės gimnazija";Smurfai;4990982790;Ne;3;3;0;6
20313;"Vilniaus Vladislavo Sirokomlės gimnazija";Smurfai;3880578523;Ne;0;1;0;1
20314;"Vilniaus Vladislavo Sirokomlės gimnazija";Smurfai;9868386182;Ne;6;3;0;9
20315;"Vilniaus Vladislavo Sirokomlės gimnazija";Smurfai;1090204906;Ne;3;0;0;3
20316;"Vilniaus „Pelėdos” pradinė mokykla";Bitutės;3131930907;Ne;20;0;0;20
20317;"Vilniaus „Pelėdos” pradinė mokykla";Bitutės;2023718424;Ne;0;0;1;1
20318;"Vilniaus „Pelėdos” pradinė mokykla";Bitutės;13170636069;Ne;0;0;3;3
20319;"Vilniaus „Pelėdos” pradinė mokykla";Bitutės;49343952061;Ne;0;0;4;4
20320;"Vilniaus „Pelėdos” pradinė mokykla";Bitutės;8281005516;Ne;0;0;1;1
20321;"Vilniaus „Pelėdos” pradinė mokykla";Bitutės;7678062264;Ne;5;0;3;8
20322;"Vilniaus „Pelėdos” pradinė mokykla";Bitutės;6610166355;Ne;0;0;1;1
20323;"Vilniaus „Pelėdos” pradinė mokykla";Bitutės;4427123314;Ne;0;0;4;4
20324;"Vilniaus „Pelėdos” pradinė mokykla";Bitutės;5610993611;Ne;8;0;0;8
20325;"Vilniaus „Pelėdos” pradinė mokykla";Bitutės;1121936989;Ne;0;0;6;6
20326;"Vilniaus „Pelėdos” pradinė mokykla";Bitutės;4268531240;Ne;5;0;4;9
20327;"Vilniaus „Pelėdos” pradinė mokykla";Bitutės;7907026349;Ne;0;0;3;3
20328;"Vilniaus „Pelėdos” pradinė mokykla";Bitutės;9343761295;Ne;1;0;1;2
20329;"Vilniaus „Pelėdos” pradinė mokykla";Bitutės;7006338378;Ne;6;5;3;14
20330;"Vilniaus „Pelėdos” pradinė mokykla";Bitutės;3030820917;Ne;4;0;2;6
20331;"Vilniaus „Pelėdos” pradinė mokykla";Bitutės;3768735503;Ne;3;0;3;6
20332;"Vilniaus „Pelėdos” pradinė mokykla";Bitutės;6597383913;Ne;0;8;1;9
20333;"Vilniaus „Pelėdos” pradinė mokykla";Boružėlės;3284613284;Ne;4;0;0;4
20334;"Vilniaus „Pelėdos” pradinė mokykla";Boružėlės;1830060403;Ne;0;1;0;1
20335;"Vilniaus „Pelėdos” pradinė mokykla";Boružėlės;1153781469;Ne;0;0;6;6
20336;"Vilniaus „Pelėdos” pradinė mokykla";Boružėlės;93600065957;Ne;8;0;0;8
20337;"Vilniaus „Pelėdos” pradinė mokykla";Boružėlės;1616324236;Ne;10;0;0;10
20338;"Vilniaus „Pelėdos” pradinė mokykla";Boružėlės;8370864547;Ne;9;1;0;10
20339;"Vilniaus „Pelėdos” pradinė mokykla";Boružėlės;5140876051;Ne;4;0;0;4
20340;"Vilniaus „Pelėdos” pradinė mokykla";Boružėlės;8086378912;Ne;0;5;0;5
20341;"Vilniaus „Pelėdos” pradinė mokykla";1a;1206482166;Ne;5;0;0;5
20342;"Vilniaus Joachimo Lelevelio inžinerijos mokykla";0A;1546251543;Ne;0;20;0;20
20343;"Vilniaus Joachimo Lelevelio inžinerijos mokykla";0A;9130637883;Ne;0;1;0;1
20344;"Vilniaus Joachimo Lelevelio inžinerijos mokykla";0A;1954888655;Ne;3;0;0;3
20345;"Vilniaus Joachimo Lelevelio inžinerijos mokykla";0A;7776071299;Ne;5;0;0;5
20346;"Vilniaus Joachimo Lelevelio inžinerijos mokykla";0A;9215070593;Ne;4;0;0;4
20347;"Vilniaus Joachimo Lelevelio inžinerijos mokykla";0A;3039980710;Ne;0;2;0;2
20348;"Vilniaus Joachimo Lelevelio inžinerijos mokykla";0A;1826015013;Ne;0;3;0;3
20349;"Vilniaus Joachimo Lelevelio inžinerijos mokykla";0A;5630659056;Ne;0;2;6;8
20350;"Vilniaus Joachimo Lelevelio inžinerijos mokykla";0A;2797443202;Ne;1;0;0;1
20351;"Vilniaus Joachimo Lelevelio inžinerijos mokykla";0B;2324578741;Ne;0;3;0;3
20352;"Vilniaus Joachimo Lelevelio inžinerijos mokykla";0B;6132569107;Taip;0;0;1;1
20353;"Vilniaus Joachimo Lelevelio inžinerijos mokykla";0B;64247830728;Ne;0;20;0;20
20354;"Vilniaus Joachimo Lelevelio inžinerijos mokykla";0B;2601103834;Ne;9;0;1;10
20355;"Vilniaus Joachimo Lelevelio inžinerijos mokykla";0B;65960895249;Ne;0;3;0;3
20356;"Vilniaus Joachimo Lelevelio inžinerijos mokykla";0B;5722934228;Ne;0;2;0;2
20357;"Vilniaus Joachimo Lelevelio inžinerijos mokykla";0B;1385352925;Ne;4;1;0;5
20358;"Vilniaus Joachimo Lelevelio inžinerijos mokykla";0B;4209118353;Ne;0;3;1;4
20359;"Vilniaus Joachimo Lelevelio inžinerijos mokykla";0B;6883982889;Ne;0;0;1;1
20360;"Vilniaus Joachimo Lelevelio inžinerijos mokykla";0B;2842587194;Ne;0;1;0;1
20361;"Vilniaus Joachimo Lelevelio inžinerijos mokykla";0B;8042807487;Ne;0;4;0;4
20362;"Vilniaus Joachimo Lelevelio inžinerijos mokykla";0B;6501930436;Ne;3;0;2;5
20363;"Vilniaus Joachimo Lelevelio inžinerijos mokykla";0B;71081903240;Ne;1;1;0;2
20364;"Vilniaus Juzefo Ignacijaus Kraševskio gimnazija";Priešmokyklinė;2201538495;Taip;8;0;0;8
20365;"Vilniaus Juzefo Ignacijaus Kraševskio gimnazija";Priešmokyklinė;9114472645;Ne;4;4;0;8
20366;"Vilniaus Juzefo Ignacijaus Kraševskio gimnazija";Priešmokyklinė;5261769707;Ne;15;0;0;15
20367;"Vilniaus Juzefo Ignacijaus Kraševskio gimnazija";Priešmokyklinė;5255617339;Ne;14;0;1;15
20368;"Vilniaus Juzefo Ignacijaus Kraševskio gimnazija";Priešmokyklinė;1600495468;Ne;0;2;0;2
20369;"Vilniaus Juzefo Ignacijaus Kraševskio gimnazija";Priešmokyklinė;3733665122;Ne;8;2;0;10
20370;"Vilniaus Juzefo Ignacijaus Kraševskio gimnazija";Priešmokyklinė;4499924331;Ne;5;3;0;8
20371;"Vilniaus Juzefo Ignacijaus Kraševskio gimnazija";Priešmokyklinė;6048337545;Ne;7;0;0;7
20372;"Vilniaus Juzefo Ignacijaus Kraševskio gimnazija";Priešmokyklinė;9948555227;Ne;3;0;4;7
20373;"Vilniaus Juzefo Ignacijaus Kraševskio gimnazija";Priešmokyklinė;7993975989;Ne;4;4;0;8
20374;"Vilniaus Juzefo Ignacijaus Kraševskio gimnazija";Priešmokyklinė;2684151591;Ne;8;1;0;9
20375;"Vilniaus Juzefo Ignacijaus Kraševskio gimnazija";Priešmokyklinė;7670166244;Ne;0;0;6;6
20376;"Vilniaus Juzefo Ignacijaus Kraševskio gimnazija";Priešmokyklinė;4864834075;Ne;0;1;0;1
20377;"Vilniaus Juzefo Ignacijaus Kraševskio gimnazija";Priešmokyklinė;1837140329;Ne;8;0;0;8
20378;"Vilniaus Juzefo Ignacijaus Kraševskio gimnazija";Priešmokyklinė;9333766622;Ne;9;4;0;13
20379;"Vilniaus Juzefo Ignacijaus Kraševskio gimnazija";Priešmokyklinė;3507672150;Ne;0;4;0;4
20380;"Vilniaus Juzefo Ignacijaus Kraševskio gimnazija";Priešmokyklinė;7305350540;Ne;4;1;0;5
20381;"Vilniaus Juzefo Ignacijaus Kraševskio gimnazija";Priešmokyklinė;3698808100;Ne;0;4;0;4
20382;"Vilniaus Juzefo Ignacijaus Kraševskio gimnazija";Priešmokyklinė;9754373141;Ne;0;0;4;4
20383;"Vilniaus Jono Pauliaus II progimnazija";Nykštukai;2055530718;Ne;0;0;1;1
20384;"Vilniaus Jono Pauliaus II progimnazija";Nykštukai;4831426440;Ne;0;0;1;1
20385;"Vilniaus Jono Pauliaus II progimnazija";Nykštukai;3762141936;Ne;0;1;0;1
20386;"Vilniaus Jono Pauliaus II progimnazija";Nykštukai;8703046661;Ne;0;1;0;1
20387;"Vilniaus Jono Pauliaus II progimnazija";Nykštukai;6724813553;Ne;2;3;0;5
20388;"Vilniaus Jono Pauliaus II progimnazija";Nykštukai;51629266891;Ne;3;0;0;3
20389;"Vilniaus Jono Pauliaus II progimnazija";Nykštukai;8998452731;Ne;3;0;0;3
20390;"Vilniaus Jono Pauliaus II progimnazija";Nykštukai;4071338645;Ne;6;3;0;9
20391;"Vilniaus Jono Pauliaus II progimnazija";Nykštukai;3637409607;Ne;5;1;0;6
20392;"Vilniaus Jono Pauliaus II progimnazija";Nykštukai;6988819614;Ne;3;0;0;3
20393;"Vilniaus Jono Pauliaus II progimnazija";Nykštukai;9672929606;Ne;6;0;1;7
20394;"Vilniaus Jono Pauliaus II progimnazija";Nykštukai;1624125024;Ne;0;0;3;3
20395;"Vilniaus Jono Pauliaus II progimnazija";Nykštukai;8796557675;Ne;5;3;0;8
20396;"Vilniaus Jono Pauliaus II progimnazija";Nykštukai;5902455219;Ne;0;3;0;3
20397;"Vilniaus Jono Pauliaus II progimnazija";Žiniukai;36350993825;Ne;0;2;1;3
20398;"Vilniaus Jono Pauliaus II progimnazija";Žiniukai;8607110629;Ne;6;0;2;8
20399;"Vilniaus Jono Pauliaus II progimnazija";Žiniukai;6779413882;Ne;13;1;0;14
20400;"Vilniaus Jono Pauliaus II progimnazija";Žiniukai;1897451825;Ne;0;5;0;5
20401;"Vilniaus Jono Pauliaus II progimnazija";Žiniukai;49110267692;Ne;0;0;2;2
20402;"Vilniaus Jono Pauliaus II progimnazija";Žiniukai;7947148051;Ne;8;0;0;8
20403;"Vilniaus Jono Pauliaus II progimnazija";Žiniukai;35673258175;Ne;4;0;0;4
20404;"Vilniaus Jono Pauliaus II progimnazija";Žiniukai;69245659818;Ne;11;7;0;18
20405;"Vilniaus Jono Pauliaus II progimnazija";Žiniukai;9664467134;Ne;4;1;0;5
20406;"Vilniaus Jono Pauliaus II progimnazija";Žiniukai;7838787153;Ne;12;0;0;12
20407;"Vilniaus Jono Pauliaus II progimnazija";Žiniukai;1429139157;Ne;10;0;0;10
20408;"Vilniaus Jono Pauliaus II progimnazija";Žiniukai;3042409414;Ne;5;3;0;8
20409;"Vilniaus Jono Pauliaus II progimnazija";Žiniukai;8245310502;Ne;0;6;0;6
20410;"Vilniaus Jono Pauliaus II progimnazija";Žiniukai;1460444785;Ne;5;2;0;7
20411;"Vilniaus Jono Pauliaus II progimnazija";Žiniukai;9262869284;Ne;9;1;0;10
20412;"Vilniaus Jono Pauliaus II progimnazija";Žiniukai;38456484551;Ne;0;5;0;5
20413;"Vilniaus Jono Pauliaus II progimnazija";Žiniukai;6646474196;Ne;3;0;1;4
20414;"Vilniaus Jono Pauliaus II progimnazija";Spindulėlis;1950514819;Ne;0;31;0;31
20415;"Vilniaus Jono Pauliaus II progimnazija";Spindulėlis;1298127839;Ne;0;1;0;1
20416;"Vilniaus Jono Pauliaus II progimnazija";Spindulėlis;1009453682;Ne;1;2;0;3
20417;"Vilniaus Jono Pauliaus II progimnazija";Spindulėlis;2244921301;Ne;3;0;0;3
20418;"Vilniaus Jono Pauliaus II progimnazija";Spindulėlis;1133359254;Ne;0;1;0;1
20419;"Vilniaus Jono Pauliaus II progimnazija";Spindulėlis;8336138549;Ne;0;0;1;1
20420;"Vilniaus Jono Pauliaus II progimnazija";Spindulėlis;1831094707;Ne;0;0;1;1
20421;"Vilniaus Jono Pauliaus II progimnazija";Spindulėlis;5036549574;Ne;5;0;0;5
20422;"Vilniaus Jono Pauliaus II progimnazija";Spindulėlis;5451923881;Ne;12;0;0;12
20423;"Vilniaus Jono Pauliaus II progimnazija";Spindulėlis;8100789958;Ne;1;0;1;2
20424;"Vilniaus Jono Pauliaus II progimnazija";Spindulėlis;5079107907;Ne;5;0;0;5
20425;"Vilniaus Jono Pauliaus II progimnazija";Spindulėlis;9908198854;Ne;4;3;0;7
20426;"Vilniaus Jono Pauliaus II progimnazija";Spindulėlis;6595165722;Ne;12;1;0;13
20427;"Vilniaus Verkių mokykla-daugiafunkcis centras";"1S, 3S, 3L, 4SK, 4LK klasė";42873989145;Ne;0;4;0;4
20428;"Vilniaus Verkių mokykla-daugiafunkcis centras";"1S, 3S, 3L, 4SK, 4LK klasė";5346078886;Ne;0;1;0;1
20429;"Vilniaus Verkių mokykla-daugiafunkcis centras";"1S, 3S, 3L, 4SK, 4LK klasė";1732370199;Ne;0;1;0;1
20430;"Vilniaus Verkių mokykla-daugiafunkcis centras";"1S, 3S, 3L, 4SK, 4LK klasė";4773060159;Ne;0;18;0;18
20431;"Vilniaus Verkių mokykla-daugiafunkcis centras";"1S, 3S, 3L, 4SK, 4LK klasė";3669076308;Ne;0;3;0;3
20432;"Vilniaus Verkių mokykla-daugiafunkcis centras";"1S, 3S, 3L, 4SK, 4LK klasė";67103811533;Ne;0;1;0;1
20433;"Vilniaus Verkių mokykla-daugiafunkcis centras";"1S, 3S, 3L, 4SK, 4LK klasė";62513475987;Ne;0;5;0;5
20434;"Vilniaus Verkių mokykla-daugiafunkcis centras";"1S, 3S, 3L, 4SK, 4LK klasė";1350580842;Ne;0;5;0;5
20435;"Vilniaus Verkių mokykla-daugiafunkcis centras";"1S, 2S, 2L, 3S, 4S, 4SK, 5L klasė ";6951842417;Ne;0;4;0;4
20436;"Vilniaus Verkių mokykla-daugiafunkcis centras";"1S, 2S, 2L, 3S, 4S, 4SK, 5L klasė ";4011623622;Ne;0;20;0;20
20437;"Vilniaus Verkių mokykla-daugiafunkcis centras";"1S, 2S, 2L, 3S, 4S, 4SK, 5L klasė ";8342540661;Ne;0;4;0;4
20438;"Vilniaus Verkių mokykla-daugiafunkcis centras";"1S, 2S, 2L, 3S, 4S, 4SK, 5L klasė ";37848550744;Ne;0;20;0;20
20439;"Vilniaus Verkių mokykla-daugiafunkcis centras";"1S, 2S, 2L, 3S, 4S, 4SK, 5L klasė ";2396841187;Ne;10;0;0;10
20440;"Vilniaus Verkių mokykla-daugiafunkcis centras";"1L, 4S, 4L, 6S, 6L, 6LK klasė";6813357731;Ne;0;5;0;5
20441;"Vilniaus Verkių mokykla-daugiafunkcis centras";"1L, 4S, 4L, 6S, 6L, 6LK klasė";7591511377;Ne;0;1;0;1
20442;"Vilniaus Verkių mokykla-daugiafunkcis centras";"1L, 4S, 4L, 6S, 6L, 6LK klasė";9355917461;Ne;0;2;0;2
20443;"Vilniaus Verkių mokykla-daugiafunkcis centras";"1L, 4S, 4L, 6S, 6L, 6LK klasė";4187084284;Ne;0;9;0;9
20444;"Vilniaus Verkių mokykla-daugiafunkcis centras";"1L, 4S, 4L, 6S, 6L, 6LK klasė";1989565075;Ne;0;20;0;20
20445;"Vilniaus Verkių mokykla-daugiafunkcis centras";"1L, 4S, 4L, 6S, 6L, 6LK klasė";9259642351;Ne;0;20;0;20
20446;"Vilniaus Verkių mokykla-daugiafunkcis centras";"5L, 6L, 6LK, 7L, 7LK klasė ";1503792026;Ne;5;8;0;13
20447;"Vilniaus Verkių mokykla-daugiafunkcis centras";"5L, 6L, 6LK, 7L, 7LK klasė ";4066377955;Ne;0;14;0;14
20448;"Vilniaus Verkių mokykla-daugiafunkcis centras";"5L, 6L, 6LK, 7L, 7LK klasė ";44372408680;Ne;0;1;0;1
20449;"Vilniaus Verkių mokykla-daugiafunkcis centras";"6LK, 7S, 7SK klasė";8779088808;Ne;0;3;0;3
20450;"Vilniaus Verkių mokykla-daugiafunkcis centras";"6LK, 7S, 7SK klasė";3444507772;Ne;0;2;0;2
20451;"Vilniaus Verkių mokykla-daugiafunkcis centras";"6LK, 7S, 7SK klasė";1514869108;Ne;0;1;0;1
20452;"Vilniaus Verkių mokykla-daugiafunkcis centras";"6LK, 7S, 7SK klasė";3870610295;Ne;0;20;0;20
20453;"Vilniaus Verkių mokykla-daugiafunkcis centras";"6LK, 7S, 7SK klasė";2360897023;Ne;0;1;0;1
20454;"Vilniaus Verkių mokykla-daugiafunkcis centras";"5S, 5SK, 5L, 6S klasė";8272359516;Ne;4;2;0;6
20455;"Vilniaus Verkių mokykla-daugiafunkcis centras";"5S, 5SK, 5L, 6S klasė";4914336091;Ne;0;20;0;20
20456;"Vilniaus Verkių mokykla-daugiafunkcis centras";"5S, 5SK, 5L, 6S klasė";4914336091;Ne;0;20;0;20
20457;"Vilniaus Verkių mokykla-daugiafunkcis centras";"5S, 5SK, 5L, 6S klasė";11657021053;Ne;0;1;0;1
20458;"Vilniaus Verkių mokykla-daugiafunkcis centras";"6L, 7L, 7LK klasė";5865808613;Ne;0;4;0;4
20459;"Vilniaus Verkių mokykla-daugiafunkcis centras";"6L, 7L, 7LK klasė";2261393560;Ne;0;6;0;6
20460;"Vilniaus Verkių mokykla-daugiafunkcis centras";"6L, 7L, 7LK klasė";9362938835;Ne;0;1;0;1
20461;"Vilniaus Verkių mokykla-daugiafunkcis centras";"6L, 7L, 7LK klasė";44425437058;Ne;0;1;0;1
20462;"Vilniaus Verkių mokykla-daugiafunkcis centras";"8LK, 9L, 10L, 10LK klasė";1480378589;Ne;0;20;0;20
20463;"Vilniaus Verkių mokykla-daugiafunkcis centras";"8LK, 9L, 10L, 10LK klasė";3519068093;Ne;5;0;0;5
20464;"Vilniaus Verkių mokykla-daugiafunkcis centras";"8LK, 9L, 10L, 10LK klasė";2054806833;Ne;0;20;0;20
20465;"Vilniaus Verkių mokykla-daugiafunkcis centras";"8LK, 9L, 10L, 10LK klasė";7616694308;Ne;0;5;0;5
20466;"Vilniaus Verkių mokykla-daugiafunkcis centras";"8LK, 9L, 10L, 10LK klasė";2457359072;Ne;0;2;0;2
20467;"Vilniaus Verkių mokykla-daugiafunkcis centras";"8LK, 9L, 10L, 10LK klasė";1853931111;Ne;0;10;0;10
20468;"Vilniaus Verkių mokykla-daugiafunkcis centras";"8LK, 9L, 10L, 10LK klasė";7886245604;Ne;5;2;0;7
20469;"Vilniaus Verkių mokykla-daugiafunkcis centras";"8LK, 9L, 10L, 10LK klasė";9613466086;Ne;0;8;0;8
20470;"Vilniaus Verkių mokykla-daugiafunkcis centras";"8LK, 9L, 10L, 10LK klasė";9613466086;Ne;0;8;0;8
20471;"Vilniaus Verkių mokykla-daugiafunkcis centras";"10S, 10L klasė";6352988790;Ne;0;16;0;16
20472;"Vilniaus Verkių mokykla-daugiafunkcis centras";"10S, 10L klasė";3218545382;Ne;0;20;0;20
20473;"Vilniaus Verkių mokykla-daugiafunkcis centras";"10S, 10L klasė";3529185406;Ne;0;16;0;16
20474;"Vilniaus Verkių mokykla-daugiafunkcis centras";"10S, 10L klasė";3529185406;Ne;0;16;0;16
20475;"Vilniaus Verkių mokykla-daugiafunkcis centras";"10S, 10L klasė";3529185406;Ne;0;16;0;16
20476;"Vilniaus Verkių mokykla-daugiafunkcis centras";"10S, 10L klasė";9330275690;Ne;0;13;0;13
20477;"Vilniaus Verkių mokykla-daugiafunkcis centras";"10S, 10L klasė";2708620759;Ne;0;2;0;2
20478;"Vilniaus Verkių mokykla-daugiafunkcis centras";"6S, 8S, 9S, 9L, 10L klasė";1334357441;Ne;0;1;0;1
20479;"Vilniaus Verkių mokykla-daugiafunkcis centras";"6S, 8S, 9S, 9L, 10L klasė";5030855634;Ne;10;6;0;16
20480;"Vilniaus Verkių mokykla-daugiafunkcis centras";"6S, 8S, 9S, 9L, 10L klasė";7278736731;Ne;0;7;0;7
20481;"Vilniaus Verkių mokykla-daugiafunkcis centras";"6S, 8S, 9S, 9L, 10L klasė";2810286239;Ne;0;9;0;9
20482;"Vilniaus Verkių mokykla-daugiafunkcis centras";"10S, 10L, SĮUP I m.m. klasė ";3155197214;Ne;0;20;0;20
20483;"Vilniaus Verkių mokykla-daugiafunkcis centras";"10S, 10L, SĮUP I m.m. klasė ";1062601239;Ne;0;7;0;7
20484;"Vilniaus Verkių mokykla-daugiafunkcis centras";"10S, 10L, SĮUP I m.m. klasė ";6958157444;Ne;0;1;0;1
20485;"Vilniaus Verkių mokykla-daugiafunkcis centras";"10S, 10L, SĮUP I m.m. klasė ";6937513931;Ne;0;20;0;20
20486;"Vilniaus Verkių mokykla-daugiafunkcis centras";"10S, 10L, SĮUP I m.m. klasė ";2076640938;Ne;0;6;0;6
20487;"Vilniaus Verkių mokykla-daugiafunkcis centras";"10S, 10L, SĮUP I m.m. klasė ";2305478898;Ne;0;7;0;7
20488;"Vilniaus Verkių mokykla-daugiafunkcis centras";"10S, 10L, SĮUP I m.m. klasė ";2518928115;Ne;0;6;0;6
20489;"Vilniaus Verkių mokykla-daugiafunkcis centras";"10S, 10L, SĮUP I m.m. klasė ";7000432264;Ne;0;3;0;3
20490;"Vilniaus Verkių mokykla-daugiafunkcis centras";"10S, 10L, SĮUP I m.m. klasė ";1454746961;Ne;0;9;0;9
20491;"Vilniaus Verkių mokykla-daugiafunkcis centras";"SĮUP I m.m., SĮUP III m.m. klasė ";6301505187;Ne;0;7;0;7
20492;"Vilniaus Verkių mokykla-daugiafunkcis centras";"SĮUP I m.m., SĮUP III m.m. klasė ";8732243137;Ne;0;1;0;1
20493;"Vilniaus Verkių mokykla-daugiafunkcis centras";"SĮUP I m.m., SĮUP III m.m. klasė ";9975744237;Ne;0;20;0;20
20494;"Vilniaus Verkių mokykla-daugiafunkcis centras";"SĮUP I m.m., SĮUP III m.m. klasė ";1548000907;Ne;0;3;0;3
20495;"Vilniaus Verkių mokykla-daugiafunkcis centras";"SĮUP I m.m., SĮUP III m.m. klasė ";9500247903;Ne;0;10;0;10
20496;"Vilniaus Verkių mokykla-daugiafunkcis centras";"SĮUP I m.m., SĮUP III m.m. klasė ";6966632177;Ne;0;10;0;10
20497;"Vilniaus Verkių mokykla-daugiafunkcis centras";"SĮUP I m.m., SĮUP III m.m. klasė ";9513501805;Ne;0;12;0;12
20498;"Vilniaus Verkių mokykla-daugiafunkcis centras";"SĮUP I m.m., SĮUP II m.m. klasė";4054448861;Ne;0;2;0;2
20499;"Vilniaus Verkių mokykla-daugiafunkcis centras";"SĮUP I m.m., SĮUP II m.m. klasė";4518835802;Ne;0;6;0;6
20500;"Vilniaus Verkių mokykla-daugiafunkcis centras";"SĮUP I m.m., SĮUP II m.m. klasė";8495267789;Ne;0;7;0;7
20501;"Vilniaus Verkių mokykla-daugiafunkcis centras";"SĮUP I m.m., SĮUP II m.m., SĮUP III m.m. klasė ";9963369886;Ne;0;1;0;1
20502;"Vilniaus Verkių mokykla-daugiafunkcis centras";"SĮUP I m.m., SĮUP II m.m., SĮUP III m.m. klasė ";4901307502;Ne;0;7;0;7
20503;"Vilniaus Verkių mokykla-daugiafunkcis centras";"SĮUP I m.m., SĮUP II m.m., SĮUP III m.m. klasė ";7821183996;Ne;0;1;0;1
20504;"Vilniaus Verkių mokykla-daugiafunkcis centras";"8S, 8SK, 9S, 9SK klasė";7819002176;Ne;8;1;0;9
20505;"Vilniaus Verkių mokykla-daugiafunkcis centras";"8S, 8SK, 9S, 9SK klasė";6396691531;Ne;0;20;0;20
20506;"Vilniaus Verkių mokykla-daugiafunkcis centras";"8S, 8SK, 9S, 9SK klasė";9420292538;Ne;0;1;0;1
20507;"Vilniaus Verkių mokykla-daugiafunkcis centras";"8S, 8SK, 9S, 9SK klasė";7689301739;Ne;0;4;0;4
20508;"Vilniaus Verkių mokykla-daugiafunkcis centras";"8S, 8SK, 9S, 9SK klasė";8199430682;Ne;0;1;0;1
20509;"Vilniaus Sausio 13-osios mokykla";GUDRUČIAI;2153133102;Ne;2;0;0;2
20510;"Vilniaus Sausio 13-osios mokykla";GUDRUČIAI;3725632707;Ne;8;0;0;8
20511;Gluosnis;KIŠKUČIAI;2984134115;Ne;5;0;6;11
20512;Gluosnis;KIŠKUČIAI;6955695422;Ne;9;5;1;15
20513;Gluosnis;KIŠKUČIAI;1305651237;Ne;12;0;0;12
20514;Gluosnis;KIŠKUČIAI;4285562600;Ne;5;2;1;8
20515;Gluosnis;KIŠKUČIAI;5432102004;Ne;4;0;1;5
20516;Gluosnis;KIŠKUČIAI;8009719622;Ne;0;0;2;2
20517;Gluosnis;KIŠKUČIAI;9833971809;Ne;1;0;0;1
20518;Gluosnis;KIŠKUČIAI;6883663577;Ne;7;2;0;9
20519;Gluosnis;KIŠKUČIAI;1512855055;Ne;8;2;2;12
20520;Gluosnis;KIŠKUČIAI;8337313448;Ne;4;0;1;5
20521;Gluosnis;KIŠKUČIAI;4632419177;Ne;0;0;2;2
20522;Gluosnis;KIŠKUČIAI;6113153127;Ne;12;0;0;12
20523;Gluosnis;KIŠKUČIAI;7769522093;Ne;13;0;1;14
20524;Gluosnis;KIŠKUČIAI;9993638596;Ne;0;0;1;1
20525;Gluosnis;KIŠKUČIAI;6994005000;Ne;0;1;0;1
20526;Gluosnis;KIŠKUČIAI;9221983318;Ne;7;0;2;9
20527;Gluosnis;KIŠKUČIAI;5664156894;Ne;6;0;0;6
20528;Gluosnis;KIŠKUČIAI;7073637619;Ne;4;0;1;5
20529;Gluosnis;KIŠKUČIAI;1391404073;Ne;2;0;3;5
20530;Gluosnis;KIŠKUČIAI;4591550636;Ne;7;6;0;13
20531;Gluosnis;EŽIUKAI;4153713911;Ne;6;1;2;9
20532;Gluosnis;EŽIUKAI;4493877427;Ne;10;0;1;11
20533;Gluosnis;EŽIUKAI;1301904113;Ne;3;0;0;3
20534;Gluosnis;EŽIUKAI;5350702449;Ne;14;0;0;14
20535;Gluosnis;EŽIUKAI;8577271806;Ne;0;0;6;6
20536;Gluosnis;EŽIUKAI;6622415563;Ne;5;1;0;6
20537;Gluosnis;EŽIUKAI;3988305400;Ne;0;1;0;1
20538;Gluosnis;EŽIUKAI;9788278155;Ne;13;5;0;18
20539;Gluosnis;EŽIUKAI;7526020668;Ne;7;0;0;7
20540;Gluosnis;EŽIUKAI;5522411084;Ne;0;0;5;5
20541;Gluosnis;EŽIUKAI;5392759654;Taip;3;0;0;3
20542;Gluosnis;EŽIUKAI;6681653921;Ne;0;8;0;8
20543;Gluosnis;EŽIUKAI;4902627153;Taip;12;0;3;15
20544;Gluosnis;EŽIUKAI;2525780494;Ne;1;3;0;4
20545;Gluosnis;EŽIUKAI;9389736360;Ne;11;3;3;17
20546;Gluosnis;EŽIUKAI;2707855273;Ne;10;1;1;12
20547;Gluosnis;EŽIUKAI;7523459118;Ne;12;0;0;12
20548;Gluosnis;EŽIUKAI;2794163383;Ne;1;0;1;2
20549;Gluosnis;EŽIUKAI;7264550578;Ne;0;0;7;7
20550;Gluosnis;EŽIUKAI;5368171142;Ne;15;3;2;20
20551;Gluosnis;EŽIUKAI;9888037899;Ne;13;0;3;16
20552;Gluosnis;MEŠKIUKAI;8998776286;Ne;6;0;0;6
20553;Gluosnis;MEŠKIUKAI;1846499141;Ne;15;0;0;15
20554;Gluosnis;MEŠKIUKAI;7935750427;Ne;1;0;0;1
20555;Gluosnis;MEŠKIUKAI;4905002832;Ne;0;4;0;4
20556;Gluosnis;MEŠKIUKAI;9102081648;Ne;3;0;4;7
20557;Gluosnis;MEŠKIUKAI;4498429439;Ne;0;0;1;1
20558;Gluosnis;MEŠKIUKAI;8259160584;Ne;0;2;1;3
20559;Gluosnis;MEŠKIUKAI;1235091885;Ne;5;5;0;10
20560;Gluosnis;MEŠKIUKAI;1165636758;Ne;0;0;1;1
20561;Gluosnis;MEŠKIUKAI;8499748544;Ne;4;0;0;4
20562;Gluosnis;MEŠKIUKAI;9699577397;Ne;14;0;1;15
20563;Gluosnis;MEŠKIUKAI;7995558671;Ne;10;2;0;12
20564;Gluosnis;MEŠKIUKAI;1602556462;Ne;6;0;0;6
20565;Gluosnis;MEŠKIUKAI;8842139496;Ne;0;2;5;7
20566;Gluosnis;MEŠKIUKAI;4060859156;Ne;5;1;0;6
20567;Gluosnis;MEŠKIUKAI;6428753580;Ne;9;0;1;10
20568;Gluosnis;MEŠKIUKAI;3323237449;Ne;0;2;0;2
20569;Gluosnis;MEŠKIUKAI;6246512101;Ne;4;0;0;4
20570;Gluosnis;MEŠKIUKAI;3038732180;Ne;5;10;1;16
20571;Gluosnis;MEŠKIUKAI;1712795835;Ne;9;0;0;9
20572;Gluosnis;BORUŽĖLĖS;8840658383;Taip;7;1;0;8
20573;Gluosnis;BORUŽĖLĖS;1102935178;Ne;0;0;9;9
20574;Gluosnis;BORUŽĖLĖS;2167312808;Ne;4;0;0;4
20575;Gluosnis;BORUŽĖLĖS;4204797742;Ne;0;9;0;9
20576;Gluosnis;BORUŽĖLĖS;6302765948;Ne;6;0;1;7
20577;Gluosnis;BORUŽĖLĖS;2173191971;Ne;9;0;0;9
20578;Gluosnis;BORUŽĖLĖS;4237053702;Ne;12;5;0;17
20579;Gluosnis;BORUŽĖLĖS;8502947568;Ne;6;0;0;6
20580;Gluosnis;BORUŽĖLĖS;9664090375;Ne;1;0;1;2
20581;Gluosnis;BORUŽĖLĖS;1335152703;Ne;0;11;0;11
20582;Gluosnis;BORUŽĖLĖS;1314992969;Ne;16;0;2;18
20583;Gluosnis;BORUŽĖLĖS;7833136455;Ne;9;0;0;9
20584;Gluosnis;BORUŽĖLĖS;5556821953;Ne;3;0;0;3
20585;Gluosnis;BORUŽĖLĖS;2515646510;Ne;9;0;2;11
20586;Gluosnis;BORUŽĖLĖS;3212658311;Ne;0;0;1;1
20587;Gluosnis;BORUŽĖLĖS;2603201633;Ne;11;3;3;17
20588;Gluosnis;BORUŽĖLĖS;6086258054;Ne;20;0;0;20
20589;Gluosnis;BORUŽĖLĖS;1351519995;Ne;14;0;0;14
20590;Gluosnis;BORUŽĖLĖS;6960673767;Taip;12;0;1;13
20591;Gluosnis;LAPIUKAI;7025815772;Ne;5;0;0;5
20592;Gluosnis;LAPIUKAI;5266206726;Ne;15;0;0;15
20593;Gluosnis;LAPIUKAI;2968946946;Ne;6;1;0;7
20594;Gluosnis;LAPIUKAI;8976032500;Ne;11;0;1;12
20595;Gluosnis;LAPIUKAI;3190331209;Ne;20;0;0;20
20596;Gluosnis;LAPIUKAI;5376108804;Ne;7;0;1;8
20597;Gluosnis;LAPIUKAI;9386396460;Ne;9;1;0;10
20598;Gluosnis;LAPIUKAI;1664508998;Ne;14;4;0;18
20599;Gluosnis;LAPIUKAI;1296975213;Ne;10;0;4;14
20600;Gluosnis;LAPIUKAI;8227732558;Ne;14;0;0;14
20601;Gluosnis;LAPIUKAI;5633386146;Ne;12;0;0;12
20602;Gluosnis;LAPIUKAI;4146877525;Ne;0;14;2;16
20603;Gluosnis;LAPIUKAI;4616132460;Ne;6;0;0;6
20604;Gluosnis;LAPIUKAI;4280829038;Ne;0;0;1;1
20605;Gluosnis;LAPIUKAI;7090336454;Ne;10;1;0;11
20606;Gluosnis;LAPIUKAI;2889837198;Ne;13;0;3;16
20607;Gluosnis;PELĖDŽIUKAI;8259035822;Ne;7;3;0;10
20608;Gluosnis;PELĖDŽIUKAI;2181550091;Ne;0;0;2;2
20609;Gluosnis;PELĖDŽIUKAI;6163009686;Ne;0;3;0;3
20610;Gluosnis;PELĖDŽIUKAI;1671693932;Ne;0;0;1;1
20611;Gluosnis;PELĖDŽIUKAI;4005023841;Ne;9;0;3;12
20612;Gluosnis;PELĖDŽIUKAI;9497547057;Ne;9;2;0;11
20613;Gluosnis;PELĖDŽIUKAI;6865973084;Ne;0;2;0;2
20614;Gluosnis;PELĖDŽIUKAI;1185903576;Ne;0;0;3;3
20615;Gluosnis;PELĖDŽIUKAI;7537587118;Taip;0;0;5;5
20616;Gluosnis;PELĖDŽIUKAI;7075070566;Ne;6;0;0;6
20617;Gluosnis;PELĖDŽIUKAI;7761376910;Ne;0;0;1;1
20618;Gluosnis;PELĖDŽIUKAI;3434902234;Ne;0;0;2;2
20619;Gluosnis;PELĖDŽIUKAI;6944918504;Ne;6;4;0;10
20620;Gluosnis;PELĖDŽIUKAI;7842723958;Ne;5;3;0;8
20621;Gluosnis;PELĖDŽIUKAI;94487630173;Ne;6;2;0;8
20622;Gluosnis;PELĖDŽIUKAI;1076538028;Ne;3;1;0;4
20623;Gluosnis;VOVERIUKAI;6747244713;Ne;12;0;0;12
20624;Gluosnis;VOVERIUKAI;3900322680;Ne;13;0;0;13
20625;Gluosnis;VOVERIUKAI;2423433989;Ne;11;0;4;15
20626;Gluosnis;VOVERIUKAI;1263019496;Ne;0;1;19;20
20627;Gluosnis;VOVERIUKAI;4564193030;Ne;15;0;0;15
20628;Gluosnis;VOVERIUKAI;4224637208;Ne;1;1;3;5
20629;Gluosnis;VOVERIUKAI;1144177849;Ne;8;1;0;9
20630;Gluosnis;VOVERIUKAI;6729016081;Ne;12;1;0;13
20631;Gluosnis;VOVERIUKAI;4069584911;Ne;9;0;4;13
20632;Gluosnis;VOVERIUKAI;6119618742;Ne;11;0;0;11
20633;Gluosnis;VOVERIUKAI;2794080237;Ne;15;0;0;15
20634;Gluosnis;VOVERIUKAI;5623135790;Ne;9;0;1;10
20635;Gluosnis;VOVERIUKAI;2310874591;Ne;10;1;0;11
20636;Gluosnis;VOVERIUKAI;5210930032;Ne;6;0;0;6
20637;Gluosnis;VOVERIUKAI;5008836118;Ne;5;0;1;6
20638;Gluosnis;VOVERIUKAI;4361177196;Ne;16;0;1;17
20639;Gluosnis;VOVERIUKAI;9484423786;Ne;10;0;3;13
20640;Gluosnis;VOVERIUKAI;8109714321;Ne;16;0;0;16
20641;Gluosnis;DRUGELIAI;5949954525;Taip;6;0;0;6
20642;Gluosnis;DRUGELIAI;1716235604;Taip;0;4;0;4
20643;Gluosnis;DRUGELIAI;4125830926;Taip;0;12;0;12
20644;Gluosnis;DRUGELIAI;6358187113;Ne;1;0;4;5
20645;Gluosnis;DRUGELIAI;9084785666;Ne;0;1;0;1
20646;Gluosnis;DRUGELIAI;4940563623;Ne;12;0;0;12
20647;Gluosnis;DRUGELIAI;1113731535;Ne;5;2;0;7
20648;Gluosnis;DRUGELIAI;4653963373;Ne;13;5;0;18
20649;Gluosnis;DRUGELIAI;8314366921;Ne;0;0;2;2
20650;Gluosnis;DRUGELIAI;4220504133;Ne;12;0;0;12
20651;Gluosnis;DRUGELIAI;9931766935;Ne;3;0;6;9
20652;Gluosnis;DRUGELIAI;3527418865;Ne;9;0;0;9
20653;Gluosnis;DRUGELIAI;6914171069;Ne;0;7;0;7
20654;Gluosnis;DRUGELIAI;1848647593;Ne;10;5;0;15
20655;Gluosnis;DRUGELIAI;7756397778;Ne;6;0;2;8
20656;Gluosnis;DRUGELIAI;5943955268;Ne;11;0;2;13
20657;Gluosnis;DRUGELIAI;8690911930;Ne;10;0;1;11
20658;Gluosnis;DRUGELIAI;1543842220;Ne;0;0;2;2
20659;Gluosnis;DRUGELIAI;1787206205;Ne;11;1;0;12
20660;Gluosnis;DRUGELIAI;5264930854;Ne;0;1;0;1
20661;Gluosnis;BITUTĖS;4176300773;Ne;13;0;0;13
20662;Gluosnis;BITUTĖS;2554790908;Ne;6;1;0;7
20663;Gluosnis;BITUTĖS;8281499182;Ne;16;0;0;16
20664;Gluosnis;BITUTĖS;2403029153;Ne;7;0;0;7
20665;Gluosnis;BITUTĖS;6432475763;Ne;5;0;0;5
20666;Gluosnis;BITUTĖS;1966484574;Ne;0;2;1;3
20667;Gluosnis;BITUTĖS;4353195155;Taip;5;3;1;9
20668;Gluosnis;BITUTĖS;5889360726;Ne;12;0;0;12
20669;Gluosnis;BITUTĖS;8035097045;Ne;5;0;1;6
20670;Gluosnis;BITUTĖS;3362089746;Ne;0;0;9;9
20671;Gluosnis;BITUTĖS;7390361159;Ne;10;0;0;10
20672;Gluosnis;BITUTĖS;8380310240;Ne;12;0;0;12
20673;Gluosnis;BITUTĖS;3673702157;Ne;1;0;2;3
20674;Gluosnis;BITUTĖS;9098141563;Ne;10;0;6;16
20675;Gluosnis;BITUTĖS;9201769624;Ne;0;0;4;4
20676;Gluosnis;BITUTĖS;1306381382;Ne;3;0;0;3
20677;Gluosnis;BITUTĖS;6767500085;Ne;7;0;0;7
20678;Gluosnis;BITUTĖS;6001358241;Ne;0;0;2;2
20679;Gluosnis;BITUTĖS;5380755693;Ne;9;0;3;12
20680;Gluosnis;BITUTĖS;6197840105;Ne;15;0;0;15
20681;Gluosnis;BITUTĖS;5204445760;Ne;9;0;0;9
20682;"Vilniaus Ateities mokykla";PRIEŠMOKYKLINĖ;7032738936;Ne;6;0;0;6
20683;"Vilniaus Simono Stanevičiaus progimnazija";BITUTĖS;7091697930;Ne;8;0;0;8
20684;"Vilniaus Saulėtekio mokykla-daugiafunkcinis centras";Priešmokyklinė;1029813471;Ne;0;0;1;1
20685;"Vilniaus Saulėtekio mokykla-daugiafunkcinis centras";Priešmokyklinė;8760467524;Ne;6;0;1;7
20686;"Vilniaus Saulėtekio mokykla-daugiafunkcinis centras";Priešmokyklinė;6738279023;Ne;8;6;0;14
20687;"Vilniaus Saulėtekio mokykla-daugiafunkcinis centras";Priešmokyklinė;2159833613;Ne;4;3;0;7
20688;"Vilniaus Saulėtekio mokykla-daugiafunkcinis centras";Priešmokyklinė;1193336600;Ne;5;7;0;12
20689;"Vilniaus Saulėtekio mokykla-daugiafunkcinis centras";Priešmokyklinė;5914721966;Ne;0;0;5;5
20690;"Vilniaus Saulėtekio mokykla-daugiafunkcinis centras";Priešmokyklinė;8852228006;Ne;0;0;18;18
20691;"Vilniaus Saulėtekio mokykla-daugiafunkcinis centras";Priešmokyklinė;4159716896;Ne;0;0;2;2
20692;"Vilniaus Saulėtekio mokykla-daugiafunkcinis centras";Priešmokyklinė;1667714484;Ne;5;0;9;14
20693;"Vilniaus Saulėtekio mokykla-daugiafunkcinis centras";Priešmokyklinė;6589058061;Ne;0;0;1;1
20694;"Vilniaus Saulėtekio mokykla-daugiafunkcinis centras";Priešmokyklinė;3048310276;Ne;3;6;1;10
20695;"Vilniaus Saulėtekio mokykla-daugiafunkcinis centras";Priešmokyklinė;6991187086;Ne;5;0;1;6
20696;"Vilniaus Saulėtekio mokykla-daugiafunkcinis centras";Priešmokyklinė;1698381959;Ne;0;6;0;6
20697;"Vilniaus Saulėtekio mokykla-daugiafunkcinis centras";Priešmokyklinė;2500332755;Ne;9;0;0;9
20698;"Vilniaus Saulėtekio mokykla-daugiafunkcinis centras";Priešmokyklinė;2074102166;Ne;6;0;1;7
20699;"Vilniaus Saulėtekio mokykla-daugiafunkcinis centras";Priešmokyklinė;2906786855;Ne;0;0;2;2
20700;"Vilniaus Saulėtekio mokykla-daugiafunkcinis centras";Priešmokyklinė;3108520221;Ne;0;9;0;9
20701;"Vilniaus Saulėtekio mokykla-daugiafunkcinis centras";Priešmokyklinė;8815534200;Ne;5;0;1;6
20702;"Vilniaus Saulėtekio mokykla-daugiafunkcinis centras";Priešmokyklinė;4751570183;Ne;0;0;1;1
20703;"Vilniaus Saulėtekio mokykla-daugiafunkcinis centras";Priešmokyklinė;9164075226;Ne;10;0;0;10
20704;"Vilniaus Saulėtekio mokykla-daugiafunkcinis centras";Priešmokyklinė;2020364455;Ne;6;0;0;6
20705;"Vilniaus Saulėtekio mokykla-daugiafunkcinis centras";Priešmokyklinė;4787974814;Ne;10;0;2;12
20706;"Vilniaus Saulėtekio mokykla-daugiafunkcinis centras";Priešmokyklinė;6553762186;Ne;3;8;0;11
20707;"Vilniaus Saulėtekio mokykla-daugiafunkcinis centras";Priešmokyklinė;9057726203;Ne;0;1;0;1
20708;"Vilniaus Saulėtekio mokykla-daugiafunkcinis centras";Priešmokyklinė;6492909546;Ne;3;2;0;5
20709;"Vilniaus Saulėtekio mokykla-daugiafunkcinis centras";Priešmokyklinė;4937714337;Ne;0;0;3;3
20710;"Vilniaus Saulėtekio mokykla-daugiafunkcinis centras";Priešmokyklinė;3745251439;Ne;0;0;3;3
20711;"Vilniaus Saulėtekio mokykla-daugiafunkcinis centras";"PRIEŠMOKYKLINĖ 2";9963290362;Ne;0;0;7;7
20712;"Vilniaus Saulėtekio mokykla-daugiafunkcinis centras";"PRIEŠMOKYKLINĖ 2";1342094235;Ne;0;0;1;1
20713;"Vilniaus Saulėtekio mokykla-daugiafunkcinis centras";"PRIEŠMOKYKLINĖ 2";2628936055;Ne;9;1;0;10
20714;"Vilniaus Saulėtekio mokykla-daugiafunkcinis centras";"PRIEŠMOKYKLINĖ 2";4542122478;Ne;6;0;2;8
20715;"Vilniaus Saulėtekio mokykla-daugiafunkcinis centras";"PRIEŠMOKYKLINĖ 2";5927071864;Ne;0;0;1;1
20716;"Vilniaus Saulėtekio mokykla-daugiafunkcinis centras";"PRIEŠMOKYKLINĖ 2";4970499391;Ne;0;0;7;7
20717;"Vilniaus Saulėtekio mokykla-daugiafunkcinis centras";"PRIEŠMOKYKLINĖ 2";6593824471;Ne;19;0;1;20
20718;"Vilniaus Saulėtekio mokykla-daugiafunkcinis centras";"PRIEŠMOKYKLINĖ 2";8669346247;Ne;4;0;3;7
20719;"Vilniaus Saulėtekio mokykla-daugiafunkcinis centras";"PRIEŠMOKYKLINĖ 2";1924079984;Ne;0;0;1;1
20720;"Vilniaus Saulėtekio mokykla-daugiafunkcinis centras";"PRIEŠMOKYKLINĖ 2";5590376570;Ne;4;0;3;7
20721;"Vilniaus Saulėtekio mokykla-daugiafunkcinis centras";"PRIEŠMOKYKLINĖ 2";8766410254;Ne;0;0;1;1
20722;"Vilniaus Saulėtekio mokykla-daugiafunkcinis centras";"PRIEŠMOKYKLINĖ 2";4151582358;Ne;0;2;0;2
20723;"Vilniaus Saulėtekio mokykla-daugiafunkcinis centras";"PRIEŠMOKYKLINĖ 2";1376656872;Ne;3;0;4;7
20724;"Vilniaus Saulėtekio mokykla-daugiafunkcinis centras";"PRIEŠMOKYKLINĖ 2";3639632543;Ne;0;4;0;4
20725;"Vilniaus Saulėtekio mokykla-daugiafunkcinis centras";"PRIEŠMOKYKLINĖ 2";6865962441;Ne;0;4;0;4
20726;"Vilniaus Saulėtekio mokykla-daugiafunkcinis centras";"PRIEŠMOKYKLINĖ 2";3982877012;Ne;11;0;1;12
20727;"Vilniaus Saulėtekio mokykla-daugiafunkcinis centras";"PRIEŠMOKYKLINĖ 2";1660650556;Ne;12;9;0;21
20728;"Vilniaus Saulėtekio mokykla-daugiafunkcinis centras";"PRIEŠMOKYKLINĖ 2";4890393582;Ne;0;0;1;1
20729;"Vilniaus Saulėtekio mokykla-daugiafunkcinis centras";"PRIEŠMOKYKLINĖ 2";5304096806;Ne;4;0;1;5
20730;"Vilniaus Saulėtekio mokykla-daugiafunkcinis centras";"PRIEŠMOKYKLINĖ 2";1648983304;Ne;20;0;2;22
20731;"Vilniaus Saulėtekio mokykla-daugiafunkcinis centras";"PRIEŠMOKYKLINĖ 2";1543123485;Ne;0;0;1;1
20732;"Vilniaus Saulėtekio mokykla-daugiafunkcinis centras";"PRIEŠMOKYKLINĖ 2";4176208765;Ne;0;14;1;15
20733;"Vilniaus Saulėtekio mokykla-daugiafunkcinis centras";"PRIEŠMOKYKLINĖ 2";8458361084;Ne;10;0;4;14
20734;Žolynas;Dobiliukai;4619873224;Ne;8;0;0;8
20735;Žolynas;Dobiliukai;5645688735;Ne;6;0;0;6
20736;Žolynas;Dobiliukai;3225183876;Ne;4;0;0;4
20737;Žolynas;Varpeliai;8625512899;Ne;4;0;0;4
20738;Žolynas;Varpeliai;1820257436;Ne;5;1;0;6
20739;Žolynas;Varpeliai;6857062144;Ne;3;0;0;3
20740;Žolynas;Varpeliai;7910548315;Ne;5;0;0;5
20741;Žolynas;Žemuogėlės;7307869483;Ne;5;0;0;5
20742;Žolynas;Žemuogėlės;4574369709;Ne;5;0;0;5
20743;Žolynas;Žemuogėlės;3670416668;Ne;1;0;0;1
20744;Žolynas;Žemuogėlės;2816866449;Ne;4;0;0;4
20745;Žolynas;Ramunėlės;4048788625;Taip;4;0;0;4
20746;Žolynas;Ramunėlės;9287690553;Ne;5;0;0;5
20747;Žolynas;Ramunėlės;7497676060;Taip;10;0;0;10
20748;Žolynas;Ramunėlės;3703497175;Ne;2;0;0;2
20749;Žolynas;Ramunėlės;6225625746;Ne;10;0;0;10
20750;Žolynas;Šlamučiai;9291306449;Ne;4;0;0;4
20751;Žolynas;Šlamučiai;8153606853;Taip;4;0;0;4
20752;Žolynas;Aguonėles;5231161105;Ne;1;0;0;1
20753;Žolynas;Aguonėles;7723064420;Ne;4;0;0;4
20754;Žolynas;Rugiagėlės;6390802189;Taip;14;0;0;14
20755;Žolynas;Rugiagėlės;3981871213;Ne;8;0;0;8
20756;Žolynas;Rugiagėlės;4628728628;Ne;2;0;0;2
20757;Žolynas;Rugiagėlės;2283289955;Ne;4;0;0;4
20758;Žolynas;Rugiagėlės;4938171997;Ne;2;0;0;2
20759;Žolynas;Rugiagėlės;8326676534;Ne;9;0;0;9
20760;Žolynas;Rugiagėlės;3249208907;Ne;4;0;0;4
20761;Žolynas;Rugiagėlės;4432780615;Ne;4;0;0;4
20762;Žolynas;Rugiagėlės;2660197697;Ne;5;0;0;5
20763;Žolynas;Čiobreliai;6722603438;Ne;4;0;0;4
20764;Žolynas;Čiobreliai;7870236961;Ne;4;0;0;4
20765;"Vilniaus „Genio“ progimnazija";NYKŠTUKAI;6545116373;Ne;0;2;0;2
20766;"Vilniaus „Genio“ progimnazija";NYKŠTUKAI;1666616466;Ne;1;2;0;3
20767;"Vilniaus „Genio“ progimnazija";NYKŠTUKAI;3008272979;Ne;0;2;0;2
20768;"Vilniaus „Genio“ progimnazija";NYKŠTUKAI;1807466584;Ne;0;2;0;2
20769;"Vilniaus „Genio“ progimnazija";NYKŠTUKAI;4680264973;Ne;4;0;0;4
20770;"Vilniaus „Genio“ progimnazija";NYKŠTUKAI;5850506831;Ne;0;2;0;2
20771;"Vilniaus „Genio“ progimnazija";NYKŠTUKAI;2176438968;Ne;3;0;0;3
20772;"Vilniaus „Genio“ progimnazija";NYKŠTUKAI;6154837614;Ne;3;0;0;3
20773;"Vilniaus „Genio“ progimnazija";NYKŠTUKAI;2865995680;Ne;4;0;0;4
20774;"Gintarėlis (Popieriaus g. 46A)";SKRUZDĖLIUKAI;6162836315;Ne;5;1;0;6
20775;"Gintarėlis (Popieriaus g. 46A)";SKRUZDĖLIUKAI;5738933125;Ne;0;9;0;9
20776;"Gintarėlis (Popieriaus g. 46A)";SKRUZDĖLIUKAI;1994856959;Ne;2;1;0;3
20777;"Gintarėlis (Popieriaus g. 46A)";SKRUZDĖLIUKAI;8223747534;Ne;8;0;1;9
20778;"Gintarėlis (Popieriaus g. 46A)";SKRUZDĖLIUKAI;1045355492;Ne;9;0;5;14
20779;"Gintarėlis (Popieriaus g. 46A)";SKRUZDĖLIUKAI;6193540660;Ne;15;1;0;16
20780;"Gintarėlis (Popieriaus g. 46A)";SKRUZDĖLIUKAI;7916257692;Ne;0;0;1;1
20781;"Gintarėlis (Popieriaus g. 46A)";SKRUZDĖLIUKAI;7510541192;Ne;0;7;0;7
20782;"Gintarėlis (Popieriaus g. 46A)";SKRUZDĖLIUKAI;9045108717;Ne;10;7;0;17
20783;"Gintarėlis (Popieriaus g. 46A)";SKRUZDĖLIUKAI;1955719034;Ne;0;2;3;5
20784;"Gintarėlis (Popieriaus g. 46A)";SKRUZDĖLIUKAI;1215549844;Ne;0;1;0;1
20785;"Gintarėlis (Popieriaus g. 46A)";SKRUZDĖLIUKAI;5379858630;Ne;0;0;11;11
20786;"Gintarėlis (Popieriaus g. 46A)";SKRUZDĖLIUKAI;5961603860;Ne;0;8;0;8
20787;"Gintarėlis (Popieriaus g. 46A)";SKRUZDĖLIUKAI;8068499156;Ne;0;4;0;4
20788;"Gintarėlis (Popieriaus g. 46A)";SKRUZDĖLIUKAI;5190355636;Ne;8;0;0;8
20789;"Gintarėlis (Popieriaus g. 46A)";SKRUZDĖLIUKAI;4290033336;Ne;5;0;0;5
20790;"Gintarėlis (Popieriaus g. 46A)";PELĖDŽIUKAI;6506180216;Ne;0;5;0;5
20791;"Gintarėlis (Popieriaus g. 46A)";PELĖDŽIUKAI;9200073539;Ne;10;2;0;12
20792;"Gintarėlis (Popieriaus g. 46A)";PELĖDŽIUKAI;8019543081;Ne;0;3;0;3
20793;"Gintarėlis (Popieriaus g. 46A)";PELĖDŽIUKAI;8792175474;Ne;6;2;0;8
20794;"Gintarėlis (Popieriaus g. 46A)";PELĖDŽIUKAI;3304191482;Ne;9;0;0;9
20795;"Gintarėlis (Popieriaus g. 46A)";PELĖDŽIUKAI;4181430769;Ne;0;9;0;9
20796;"Gintarėlis (Popieriaus g. 46A)";PELĖDŽIUKAI;3202819190;Ne;0;0;1;1
20797;"Gintarėlis (Popieriaus g. 46A)";PELĖDŽIUKAI;9807784148;Ne;12;2;0;14
20798;"Gintarėlis (Popieriaus g. 46A)";PELĖDŽIUKAI;6883573289;Ne;6;2;3;11
20799;"Gintarėlis (Popieriaus g. 46A)";PELĖDŽIUKAI;3127881266;Ne;0;3;0;3
20800;"Gintarėlis (Popieriaus g. 46A)";PELĖDŽIUKAI;2052962147;Ne;10;0;2;12
20801;"Gintarėlis (Popieriaus g. 46A)";PELĖDŽIUKAI;8677500463;Taip;0;0;1;1
20802;"Gintarėlis (Popieriaus g. 46A)";PELĖDŽIUKAI;7031945895;Ne;0;10;0;10
20803;"Gintarėlis (Popieriaus g. 46A)";"LINKSMASIS AVILYS";7872515649;Ne;10;2;0;12
20804;"Gintarėlis (Popieriaus g. 46A)";"LINKSMASIS AVILYS";7256557310;Ne;0;2;0;2
20805;"Gintarėlis (Popieriaus g. 46A)";"LINKSMASIS AVILYS";6425840559;Ne;0;0;6;6
20806;"Gintarėlis (Popieriaus g. 46A)";"LINKSMASIS AVILYS";3572188688;Ne;6;2;1;9
20807;"Gintarėlis (Popieriaus g. 46A)";"LINKSMASIS AVILYS";7010430969;Ne;0;2;1;3
20808;"Gintarėlis (Popieriaus g. 46A)";"LINKSMASIS AVILYS";7734802846;Ne;0;1;0;1
20809;"Gintarėlis (Popieriaus g. 46A)";"LINKSMASIS AVILYS";1070119148;Ne;0;7;0;7
20810;"Gintarėlis (Popieriaus g. 46A)";"LINKSMASIS AVILYS";9182625265;Ne;6;2;1;9
20811;"Gintarėlis (Popieriaus g. 46A)";"LINKSMASIS AVILYS";3738678648;Ne;7;3;0;10
20812;"Gintarėlis (Popieriaus g. 46A)";"LINKSMASIS AVILYS";2737144359;Ne;11;0;0;11
20813;"Gintarėlis (Popieriaus g. 46A)";"LINKSMASIS AVILYS";8680339493;Ne;5;5;0;10
20814;"Gintarėlis (Popieriaus g. 46A)";"LINKSMASIS AVILYS";5223116373;Ne;5;0;0;5
20815;"Gintarėlis (Popieriaus g. 46A)";Varliukai;6821929306;Ne;0;5;0;5
20816;"Gintarėlis (Popieriaus g. 46A)";Varliukai;7274616480;Ne;5;0;4;9
20817;"Gintarėlis (Popieriaus g. 46A)";Varliukai;1362980885;Ne;14;4;0;18
20818;"Gintarėlis (Popieriaus g. 46A)";Varliukai;9762364250;Ne;3;3;0;6
20819;"Gintarėlis (Popieriaus g. 46A)";Varliukai;6849227110;Taip;0;1;0;1
20820;"Gintarėlis (Popieriaus g. 46A)";Varliukai;4263315669;Ne;20;0;0;20
20821;"Gintarėlis (Popieriaus g. 46A)";Varliukai;7206593645;Ne;10;0;3;13
20822;"Gintarėlis (Popieriaus g. 46A)";Varliukai;7400455090;Ne;0;13;0;13
20823;"Gintarėlis (Popieriaus g. 46A)";Varliukai;3702588434;Ne;0;0;12;12
20824;"Gintarėlis (Popieriaus g. 46A)";Varliukai;6514247750;Ne;9;0;0;9
20825;"Gintarėlis (Popieriaus g. 46A)";Varliukai;1166720069;Ne;0;2;0;2
20826;"Gintarėlis (Popieriaus g. 46A)";Varliukai;4556644354;Ne;9;0;0;9
20827;"Gintarėlis (Popieriaus g. 46A)";Varliukai;7510641510;Ne;10;0;0;10
20828;"Gintarėlis (Popieriaus g. 46A)";Varliukai;6534072038;Ne;6;1;5;12
20829;"Gintarėlis (Popieriaus g. 46A)";Varliukai;5478441530;Ne;5;2;2;9
20830;"Gintarėlis (Popieriaus g. 46A)";Varliukai;5771196440;Ne;10;1;1;12
20831;"Pušynėlis (A. Mickevičiaus g. 21)";DAIGIUKAI;5317547220;Ne;5;0;0;5
20832;"Pušynėlis (A. Mickevičiaus g. 21)";DAIGIUKAI;9025539389;Ne;18;0;0;18
20833;"Pušynėlis (A. Mickevičiaus g. 21)";DAIGIUKAI;5512586591;Ne;18;0;0;18
20834;"Pušynėlis (A. Mickevičiaus g. 21)";DAIGIUKAI;6594473055;Ne;4;0;0;4
20835;"Pušynėlis (A. Mickevičiaus g. 21)";DAIGIUKAI;8211464695;Ne;3;1;0;4
20836;"Pušynėlis (A. Mickevičiaus g. 21)";DAIGIUKAI;6321178561;Taip;0;0;5;5
20837;"Pušynėlis (A. Mickevičiaus g. 21)";DAIGIUKAI;6606436348;Ne;2;1;0;3
20838;"Pušynėlis (A. Mickevičiaus g. 21)";DAIGIUKAI;8457384507;Ne;8;0;2;10
20839;"Pušynėlis (A. Mickevičiaus g. 21)";DAIGIUKAI;1085678424;Ne;12;0;0;12
20840;"Pušynėlis (A. Mickevičiaus g. 21)";DAIGIUKAI;9710499937;Ne;0;16;0;16
20841;"Pušynėlis (A. Mickevičiaus g. 21)";DAIGIUKAI;4685125111;Ne;6;0;0;6
20842;"Pušynėlis (A. Mickevičiaus g. 21)";DAIGIUKAI;9717473430;Ne;2;2;0;4
20843;"Pušynėlis (A. Mickevičiaus g. 21)";DAIGIUKAI;2763762463;Ne;1;4;1;6
20844;"Pušynėlis (A. Mickevičiaus g. 21)";DAIGIUKAI;9835049161;Ne;0;4;6;10
20845;"Pušynėlis (A. Mickevičiaus g. 21)";NYKŠTUKAI;1050710006;Ne;0;2;1;3
20846;"Pušynėlis (A. Mickevičiaus g. 21)";NYKŠTUKAI;1758632291;Ne;2;5;0;7
20847;"Pušynėlis (A. Mickevičiaus g. 21)";NYKŠTUKAI;8699085292;Ne;10;0;0;10
20848;"Pušynėlis (A. Mickevičiaus g. 21)";NYKŠTUKAI;8327830781;Ne;5;1;0;6
20849;"Pušynėlis (A. Mickevičiaus g. 21)";NYKŠTUKAI;8820865805;Ne;0;17;0;17
20850;"Pušynėlis (A. Mickevičiaus g. 21)";NYKŠTUKAI;9520423020;Ne;10;3;6;19
20851;"Pušynėlis (A. Mickevičiaus g. 21)";NYKŠTUKAI;1177938753;Ne;5;1;0;6
20852;"Pušynėlis (A. Mickevičiaus g. 21)";NYKŠTUKAI;9450347140;Ne;0;3;0;3
20853;"Pušynėlis (A. Mickevičiaus g. 21)";NYKŠTUKAI;2222790161;Ne;0;1;0;1
20854;"Pušynėlis (A. Mickevičiaus g. 21)";NYKŠTUKAI;7596876368;Taip;3;2;3;8
20855;"Pušynėlis (A. Mickevičiaus g. 21)";NYKŠTUKAI;7429853563;Taip;5;3;0;8
20856;"Pušynėlis (A. Mickevičiaus g. 21)";NYKŠTUKAI;8464672994;Ne;3;4;0;7
20857;"Pušynėlis (A. Mickevičiaus g. 21)";NYKŠTUKAI;1904434730;Ne;0;0;4;4
20858;"Pušynėlis (A. Mickevičiaus g. 21)";NYKŠTUKAI;3574446664;Taip;0;2;3;5
20859;"Pušynėlis (A. Mickevičiaus g. 21)";NYKŠTUKAI;5364537212;Ne;10;0;0;10
20860;"Pušynėlis (A. Mickevičiaus g. 21)";NYKŠTUKAI;7172604103;Ne;0;1;1;2
20861;"Pušynėlis (A. Mickevičiaus g. 21)";NYKŠTUKAI;8839614928;Ne;0;4;0;4
20862;"Pušynėlis (A. Mickevičiaus g. 21)";NYKŠTUKAI;8512699165;Ne;0;3;0;3
20863;"Pušynėlis (A. Mickevičiaus g. 21)";GILIUKAI;9401101407;Ne;0;3;0;3
20864;"Pušynėlis (A. Mickevičiaus g. 21)";GILIUKAI;4997004998;Ne;6;0;0;6
20865;"Pušynėlis (A. Mickevičiaus g. 21)";GILIUKAI;9517319856;Ne;10;3;2;15
20866;"Pušynėlis (A. Mickevičiaus g. 21)";GILIUKAI;9028515427;Ne;7;3;0;10
20867;"Pušynėlis (A. Mickevičiaus g. 21)";GILIUKAI;2825756894;Ne;10;2;0;12
20868;"Pušynėlis (A. Mickevičiaus g. 21)";GILIUKAI;1134325833;Ne;0;5;0;5
20869;"Pušynėlis (A. Mickevičiaus g. 21)";GILIUKAI;5668765825;Ne;5;2;3;10
20870;"Pušynėlis (A. Mickevičiaus g. 21)";GILIUKAI;3954867816;Ne;0;2;0;2
20871;"Pušynėlis (A. Mickevičiaus g. 21)";GILIUKAI;7685809238;Ne;9;1;0;10
20872;"Pušynėlis (A. Mickevičiaus g. 21)";GILIUKAI;2712755125;Ne;0;1;0;1
20873;"Pušynėlis (A. Mickevičiaus g. 21)";GILIUKAI;7011836009;Ne;4;2;1;7
20874;"Pušynėlis (A. Mickevičiaus g. 21)";GILIUKAI;3301741162;Ne;0;3;1;4
20875;"Pušynėlis (A. Mickevičiaus g. 21)";GILIUKAI;6735037523;Ne;17;1;0;18
20876;"Pušynėlis (A. Mickevičiaus g. 21)";GILIUKAI;7881263225;Ne;0;4;0;4
20877;"Pušynėlis (A. Mickevičiaus g. 21)";GILIUKAI;1612049897;Ne;0;2;0;2
20878;"Pušynėlis (A. Mickevičiaus g. 21)";GILIUKAI;9920959446;Taip;0;4;0;4
20879;"Pušynėlis (A. Mickevičiaus g. 21)";GILIUKAI;4898147530;Ne;0;1;0;1
20880;"Pušynėlis (A. Mickevičiaus g. 21)";GILIUKAI;2228682366;Ne;10;2;0;12
20881;"Pušynėlis (A. Mickevičiaus g. 21)";GILIUKAI;4464615995;Ne;0;1;0;1
20882;"Naminukas (Klinikų g. 5)";VARPELIAI;2089455192;Ne;1;1;0;2
20883;"Naminukas (Klinikų g. 5)";VARPELIAI;3281707263;Ne;0;0;2;2
20884;"Naminukas (Klinikų g. 5)";VARPELIAI;3683089217;Ne;1;0;1;2
20885;"Naminukas (Klinikų g. 5)";VARPELIAI;7328682222;Ne;0;0;6;6
20886;"Naminukas (Klinikų g. 5)";VARPELIAI;7772300667;Ne;8;0;5;13
20887;"Naminukas (Klinikų g. 5)";VARPELIAI;1086919259;Ne;0;0;4;4
20888;"Naminukas (Klinikų g. 5)";VARPELIAI;3497829075;Ne;0;0;1;1
20889;"Naminukas (Klinikų g. 5)";VARPELIAI;3938225198;Ne;7;0;0;7
20890;"Naminukas (Klinikų g. 5)";VARPELIAI;5991261279;Ne;0;0;1;1
20891;"Naminukas (Klinikų g. 5)";VARPELIAI;2576516583;Ne;5;0;3;8
20892;"Naminukas (Klinikų g. 5)";VARPELIAI;8694425584;Ne;0;0;5;5
20893;"Naminukas (Klinikų g. 5)";VARPELIAI;8782832803;Ne;3;3;0;6
20894;"Naminukas (Klinikų g. 5)";VARPELIAI;5172385044;Taip;15;0;0;15
20895;"Naminukas (Klinikų g. 5)";VARPELIAI;5465843371;Ne;3;1;0;4
20896;"Naminukas (Klinikų g. 5)";VARPELIAI;6515021073;Ne;0;13;7;20
20897;"Naminukas (Klinikų g. 5)";VARPELIAI;9894306360;Ne;19;0;0;19
20898;"Naminukas (Klinikų g. 5)";SAULUTĖS;9212800864;Ne;9;0;0;9
20899;"Naminukas (Klinikų g. 5)";SAULUTĖS;9215327479;Ne;11;0;0;11
20900;"Naminukas (Klinikų g. 5)";SAULUTĖS;8595804874;Ne;0;0;2;2
20901;"Naminukas (Klinikų g. 5)";SAULUTĖS;7947598191;Ne;4;0;1;5
20902;"Naminukas (Klinikų g. 5)";SAULUTĖS;3911352454;Ne;0;0;6;6
20903;"Naminukas (Klinikų g. 5)";SAULUTĖS;7107337857;Ne;20;0;0;20
20904;"Naminukas (Klinikų g. 5)";SAULUTĖS;3079900548;Ne;0;0;20;20
20905;"Naminukas (Klinikų g. 5)";SAULUTĖS;7301768930;Ne;6;0;1;7
20906;"Naminukas (Klinikų g. 5)";SAULUTĖS;2336627398;Ne;2;13;1;16
20907;"Naminukas (Klinikų g. 5)";SAULUTĖS;1879925655;Ne;11;0;0;11
20908;"Naminukas (Klinikų g. 5)";SAULUTĖS;2881576194;Ne;4;0;5;9
20909;"Naminukas (Klinikų g. 5)";SAULUTĖS;4836599508;Ne;0;0;8;8
20910;"Naminukas (Klinikų g. 5)";SAULUTĖS;1932169696;Ne;11;0;0;11
20911;"Naminukas (Klinikų g. 5)";DRUGELIAI;2339599448;Ne;15;1;0;16
20912;"Naminukas (Klinikų g. 5)";DRUGELIAI;4077985773;Ne;6;1;0;7
20913;"Naminukas (Klinikų g. 5)";DRUGELIAI;3276656641;Ne;0;0;5;5
20914;"Naminukas (Klinikų g. 5)";DRUGELIAI;6633031473;Ne;0;0;1;1
20915;"Naminukas (Klinikų g. 5)";DRUGELIAI;4116151797;Taip;0;0;3;3
20916;"Naminukas (Klinikų g. 5)";DRUGELIAI;7033053271;Ne;0;0;1;1
20917;"Naminukas (Klinikų g. 5)";DRUGELIAI;1454039572;Ne;0;0;1;1
20918;"Naminukas (Klinikų g. 5)";DRUGELIAI;7184471307;Ne;6;0;0;6
20919;"Naminukas (Klinikų g. 5)";DRUGELIAI;6949857110;Ne;3;0;0;3
20920;"Naminukas (Klinikų g. 5)";DRUGELIAI;8039086094;Ne;1;0;1;2
20921;"Naminukas (Klinikų g. 5)";DRUGELIAI;8432194383;Ne;5;0;0;5
20922;"Naminukas (Klinikų g. 5)";DRUGELIAI;7463647806;Ne;5;0;0;5
20923;"Naminukas (Klinikų g. 5)";DRUGELIAI;4171789569;Ne;0;7;0;7
20924;"Naminukas (Klinikų g. 5)";DRUGELIAI;6880075874;Ne;12;1;0;13
20925;"Naminukas (Klinikų g. 5)";DRUGELIAI;8793327541;Ne;0;0;3;3
20926;"Naminukas (Klinikų g. 5)";DRUGELIAI;2004615252;Ne;0;1;0;1
20927;"Naminukas (Klinikų g. 5)";BITUTĖS;21152690883;Ne;0;1;2;3
20928;"Naminukas (Klinikų g. 5)";BITUTĖS;1528496272;Ne;0;0;1;1
20929;"Naminukas (Klinikų g. 5)";BITUTĖS;92417802345;Ne;6;0;0;6
20930;"Naminukas (Klinikų g. 5)";BITUTĖS;1424288192;Ne;0;0;6;6
20931;"Naminukas (Klinikų g. 5)";BITUTĖS;1180176295;Ne;0;1;0;1
20932;"Naminukas (Klinikų g. 5)";BITUTĖS;6592057292;Ne;15;0;0;15
20933;"Naminukas (Klinikų g. 5)";BITUTĖS;5578151523;Ne;0;0;2;2
20934;"Naminukas (Klinikų g. 5)";BITUTĖS;4353031174;Ne;6;9;1;16
20935;"Naminukas (Klinikų g. 5)";BITUTĖS;9244494109;Ne;3;0;0;3
20936;"Naminukas (Klinikų g. 5)";BITUTĖS;8923393066;Ne;6;0;0;6
20937;"Naminukas (Klinikų g. 5)";BITUTĖS;9178907705;Ne;11;0;0;11
20938;"Naminukas (Klinikų g. 5)";BITUTĖS;5288557629;Ne;4;2;0;6
20939;"Naminukas (Klinikų g. 5)";BITUTĖS;5233044803;Ne;0;0;1;1
20940;"Naminukas (Klinikų g. 5)";BITUTĖS;1346035733;Taip;0;6;0;6
20941;"Naminukas (Klinikų g. 5)";BITUTĖS;3791118736;Ne;5;0;6;11
20942;"Naminukas (Klinikų g. 5)";BITUTĖS;7099787230;Ne;16;0;0;16
20943;"Naminukas (Klinikų g. 5)";BITUTĖS;3088386659;Ne;5;0;0;5
20944;"Gervelė (Stadiono g. 5)";BORUŽĖLĖS;6427072260;Ne;3;0;0;3
20945;"Gervelė (Stadiono g. 5)";BORUŽĖLĖS;9777308731;Ne;7;0;0;7
20946;"Gervelė (Stadiono g. 5)";BORUŽĖLĖS;2712133300;Ne;4;0;0;4
20947;"Gervelė (Stadiono g. 5)";BORUŽĖLĖS;2622183564;Ne;12;0;0;12
20948;"Gervelė (Stadiono g. 5)";BORUŽĖLĖS;1006720360;Ne;4;0;0;4
20949;"Gervelė (Stadiono g. 5)";BORUŽĖLĖS;8190190100;Ne;10;2;0;12
20950;"Gervelė (Stadiono g. 5)";BORUŽĖLĖS;6338612770;Taip;0;0;2;2
20951;"Gervelė (Stadiono g. 5)";BORUŽĖLĖS;6004269553;Ne;0;0;20;20
20952;"Gervelė (Stadiono g. 5)";BORUŽĖLĖS;8797608822;Ne;5;0;3;8
20953;"Gervelė (Stadiono g. 5)";PAUKŠTELIAI;2031118410;Ne;0;6;1;7
20954;"Gervelė (Stadiono g. 5)";PAUKŠTELIAI;5966215998;Ne;16;0;0;16
20955;"Gervelė (Stadiono g. 5)";PAUKŠTELIAI;7463376031;Ne;0;15;0;15
20956;"Gervelė (Stadiono g. 5)";PAUKŠTELIAI;3567687304;Ne;3;0;0;3
20957;"Gervelė (Stadiono g. 5)";PAUKŠTELIAI;6372245141;Ne;0;0;2;2
20958;"Gervelė (Stadiono g. 5)";PAUKŠTELIAI;2892214705;Ne;9;0;0;9
20959;"Gervelė (Stadiono g. 5)";PAUKŠTELIAI;7952102572;Ne;0;0;2;2
20960;"Gervelė (Stadiono g. 5)";PAUKŠTELIAI;9154032804;Ne;5;3;2;10
20961;"Gervelė (Stadiono g. 5)";PAUKŠTELIAI;3676856569;Ne;5;0;0;5
20962;"Gervelė (Stadiono g. 5)";PAUKŠTELIAI;4588890423;Ne;5;5;2;12
20963;"Gervelė (Stadiono g. 5)";PAUKŠTELIAI;6822089289;Ne;1;0;0;1
20964;"Gervelė (Stadiono g. 5)";SPINDULĖLIAI;4508176017;Taip;3;0;2;5
20965;"Gervelė (Stadiono g. 5)";SPINDULĖLIAI;4051246539;Ne;6;0;0;6
20966;"Gervelė (Stadiono g. 5)";SPINDULĖLIAI;1020095914;Ne;0;0;3;3
20967;"Gervelė (Stadiono g. 5)";SPINDULĖLIAI;2207041148;Taip;5;4;0;9
20968;"Gervelė (Stadiono g. 5)";SPINDULĖLIAI;7419432731;Ne;6;0;0;6
20969;"Gervelė (Stadiono g. 5)";SPINDULĖLIAI;1611114179;Taip;7;0;0;7
20970;"Gervelė (Stadiono g. 5)";SPINDULĖLIAI;8710469480;Ne;6;2;0;8
20971;"Gervelė (Stadiono g. 5)";GĖLYTĖS;6172016747;Ne;0;1;0;1
20972;"Gervelė (Stadiono g. 5)";GĖLYTĖS;3873345138;Ne;0;4;0;4
20973;"Gervelė (Stadiono g. 5)";GĖLYTĖS;5518309115;Ne;0;3;0;3
20974;"Gervelė (Stadiono g. 5)";GĖLYTĖS;4930308435;Ne;0;5;0;5
20975;"Gervelė (Stadiono g. 5)";GĖLYTĖS;7115198351;Ne;7;0;0;7
20976;"Gervelė (Stadiono g. 5)";GĖLYTĖS;9291855374;Ne;0;3;0;3
20977;"Gervelė (Stadiono g. 5)";GĖLYTĖS;1749117711;Ne;1;0;0;1
20978;"Gervelė (Stadiono g. 5)";GĖLYTĖS;7855598075;Ne;4;3;0;7
20979;"Gervelė (Stadiono g. 5)";GĖLYTĖS;6488139414;Ne;7;0;0;7
20980;"Gervelė (Stadiono g. 5)";GĖLYTĖS;3216423543;Ne;5;0;0;5
20981;"Gervelė (Stadiono g. 5)";GĖLYTĖS;3490370918;Ne;0;4;0;4
20982;"Gervelė (Stadiono g. 5)";GĖLYTĖS;9183582003;Ne;0;4;0;4
20983;"Kūlverstukas (Mindaugo g. 7)";GNOMIKI;1720671485;Ne;0;9;0;9
20984;"Kūlverstukas (Mindaugo g. 7)";GNOMIKI;4894478262;Ne;0;0;2;2
20985;"Kūlverstukas (Mindaugo g. 7)";GNOMIKI;2501327054;Ne;0;1;0;1
20986;"Kūlverstukas (Mindaugo g. 7)";GNOMIKI;8348978878;Ne;0;3;0;3
20987;"Kūlverstukas (Mindaugo g. 7)";GNOMIKI;2709547427;Taip;0;4;0;4
20988;"Kūlverstukas (Mindaugo g. 7)";GNOMIKI;5532063862;Ne;3;0;0;3
20989;"Kūlverstukas (Mindaugo g. 7)";GNOMIKI;5747277587;Ne;0;0;5;5
20990;"Kūlverstukas (Mindaugo g. 7)";GNOMIKI;1166429762;Ne;1;1;0;2
20991;"Kūlverstukas (Mindaugo g. 7)";GNOMIKI;6514730230;Ne;1;2;0;3
20992;"Kūlverstukas (Mindaugo g. 7)";GNOMIKI;5298776235;Ne;0;1;0;1
20993;"Kūlverstukas (Mindaugo g. 7)";GNOMIKI;4116831802;Ne;0;1;0;1
20994;"Kūlverstukas (Mindaugo g. 7)";GNOMIKI;1916522637;Ne;0;0;20;20
20995;"Kūlverstukas (Mindaugo g. 7)";GNOMIKI;3239566139;Ne;0;5;0;5
20996;"Kūlverstukas (Mindaugo g. 7)";GNOMIKI;5260820316;Ne;0;5;0;5
20997;"Kūlverstukas (Mindaugo g. 7)";ZAIČIATA;8994705290;Ne;0;12;0;12
20998;"Kūlverstukas (Mindaugo g. 7)";ZAIČIATA;8496678513;Ne;8;0;1;9
20999;"Kūlverstukas (Mindaugo g. 7)";ZAIČIATA;7933156766;Ne;5;0;2;7
21000;"Kūlverstukas (Mindaugo g. 7)";ZAIČIATA;2494202134;Ne;0;3;0;3
21001;"Kūlverstukas (Mindaugo g. 7)";ZAIČIATA;2714297182;Ne;6;0;0;6
21002;"Kūlverstukas (Mindaugo g. 7)";ZAIČIATA;4998847820;Ne;5;0;2;7
21003;"Kūlverstukas (Mindaugo g. 7)";ZAIČIATA;4271185150;Ne;0;0;1;1
21004;"Kūlverstukas (Mindaugo g. 7)";ZAIČIATA;6497373567;Ne;0;3;0;3
21005;"Kūlverstukas (Mindaugo g. 7)";ZAIČIATA;3660002342;Ne;20;0;0;20
21006;"Kūlverstukas (Mindaugo g. 7)";ZAIČIATA;5079635330;Ne;0;2;0;2
21007;"Kūlverstukas (Mindaugo g. 7)";ZAIČIATA;5879283662;Ne;0;5;1;6
21008;"Kūlverstukas (Mindaugo g. 7)";ZAIČIATA;3067918179;Ne;5;0;0;5
21009;"Kūlverstukas (Mindaugo g. 7)";ZAIČIATA;1776176097;Taip;11;0;0;11
21010;"Kūlverstukas (Mindaugo g. 7)";ZAIČIATA;6685524805;Taip;0;8;0;8
21011;"Kūlverstukas (Mindaugo g. 7)";SVETLIAČKI;6219872984;Ne;0;0;6;6
21012;"Kūlverstukas (Mindaugo g. 7)";SVETLIAČKI;9098427210;Ne;0;0;10;10
21013;"Kūlverstukas (Mindaugo g. 7)";SVETLIAČKI;70033583066;Ne;0;2;0;2
21014;"Kūlverstukas (Mindaugo g. 7)";SVETLIAČKI;2154916232;Ne;0;3;0;3
21015;"Kūlverstukas (Mindaugo g. 7)";SVETLIAČKI;5794471794;Ne;0;0;3;3
21016;"Kūlverstukas (Mindaugo g. 7)";SVETLIAČKI;8577197481;Ne;14;2;0;16
21017;"Kūlverstukas (Mindaugo g. 7)";SVETLIAČKI;3449300504;Ne;0;6;0;6
21018;"Kūlverstukas (Mindaugo g. 7)";SVETLIAČKI;1102996499;Ne;0;1;0;1
21019;"Kūlverstukas (Mindaugo g. 7)";SVETLIAČKI;6311116034;Ne;0;1;0;1
21020;"Kūlverstukas (Mindaugo g. 7)";SVETLIAČKI;1635418112;Ne;0;11;0;11
21021;"Kūlverstukas (Mindaugo g. 7)";SVETLIAČKI;4352034102;Ne;4;0;2;6
21022;"Kūlverstukas (Mindaugo g. 7)";ZVONOČKI;1486878343;Ne;0;0;1;1
21023;"Kūlverstukas (Mindaugo g. 7)";ZVONOČKI;8835111916;Ne;0;2;4;6
21024;"Kūlverstukas (Mindaugo g. 7)";ZVONOČKI;5724787637;Ne;0;3;0;3
21025;"Kūlverstukas (Mindaugo g. 7)";ZVONOČKI;7898746258;Ne;0;0;3;3
21026;"Kūlverstukas (Mindaugo g. 7)";ZVONOČKI;9835391223;Ne;0;2;0;2
21027;"Kūlverstukas (Mindaugo g. 7)";ZVONOČKI;2429527586;Ne;0;0;9;9
21028;"Kūlverstukas (Mindaugo g. 7)";ZVONOČKI;5217751936;Ne;0;16;0;16
21029;"Kūlverstukas (Mindaugo g. 7)";ZVONOČKI;1566191212;Ne;0;2;0;2
21030;"Kūlverstukas (Mindaugo g. 7)";ZVONOČKI;9569296370;Ne;10;2;0;12
21031;"Kūlverstukas (Mindaugo g. 7)";ZVONOČKI;9156801640;Ne;0;20;0;20
21032;"Kūlverstukas (Mindaugo g. 7)";ZVONOČKI;1125206576;Ne;10;2;0;12
21033;"Kūlverstukas (Mindaugo g. 7)";ZVONOČKI;5938022496;Ne;0;1;0;1
21034;"Vilniaus Pavilnio pagrindinė mokykla";"PRIEŠMOKYKLINĖ PL";2738553283;Ne;12;2;1;15
21035;"Vilniaus Pavilnio pagrindinė mokykla";"PRIEŠMOKYKLINĖ PL";2101902207;Ne;1;0;1;2
21036;"Vilniaus Pavilnio pagrindinė mokykla";"PRIEŠMOKYKLINĖ PL";1957926887;Ne;15;0;0;15
21037;"Vilniaus Pavilnio pagrindinė mokykla";"PRIEŠMOKYKLINĖ PL";1046606022;Ne;0;0;1;1
21038;"Vilniaus Pavilnio pagrindinė mokykla";"PRIEŠMOKYKLINĖ RU";4339607826;Ne;1;0;0;1
21039;"Vilniaus Pavilnio pagrindinė mokykla";"PRIEŠMOKYKLINĖ RU";3609961581;Ne;9;0;0;9
21040;"Vilniaus Pavilnio pagrindinė mokykla";"PRIEŠMOKYKLINĖ RU";5619763557;Ne;0;20;0;20
21041;"Vilniaus Pavilnio pagrindinė mokykla";"PRIEŠMOKYKLINĖ RU";9759761725;Ne;0;20;0;20
21042;"Vilniaus Pavilnio pagrindinė mokykla";"PRIEŠMOKYKLINĖ RU";3058369504;Ne;0;0;1;1
21043;"Vilniaus Pavilnio pagrindinė mokykla";"PRIEŠMOKYKLINĖ RU";9142513631;Ne;1;0;3;4
21044;"Vilniaus Pavilnio pagrindinė mokykla";"PRIEŠMOKYKLINĖ RU";5972567526;Ne;5;0;3;8
21045;"Vilniaus Pavilnio pagrindinė mokykla";"PRIEŠMOKYKLINĖ RU";2846917348;Ne;9;0;4;13
21046;"Vilniaus Pavilnio pagrindinė mokykla";"PRIEŠMOKYKLINĖ RU";3243226933;Ne;3;0;3;6
21047;"Vilniaus Pavilnio pagrindinė mokykla";"PRIEŠMOKYKLINĖ RU";7544963724;Ne;0;0;3;3
21048;"Lazdynų mokykla (Liudvinavo g.128)";DRUGELIAI;4684618253;Ne;0;0;2;2
21049;"Lazdynų mokykla (Liudvinavo g.128)";DRUGELIAI;7524849851;Ne;18;0;0;18
21050;"Lazdynų mokykla (Liudvinavo g.128)";DRUGELIAI;8650496265;Ne;5;0;2;7
21051;"Lazdynų mokykla (Liudvinavo g.128)";DRUGELIAI;1365362641;Taip;4;2;0;6
21052;"Lazdynų mokykla (Liudvinavo g.128)";DRUGELIAI;9196184984;Ne;7;2;0;9
21053;"Lazdynų mokykla (Liudvinavo g.128)";DRUGELIAI;2767732459;Ne;0;8;0;8
21054;"Lazdynų mokykla (Liudvinavo g.128)";DRUGELIAI;6394098306;Ne;10;0;4;14
21055;"Lazdynų mokykla (Liudvinavo g.128)";DRUGELIAI;6627809171;Ne;0;20;0;20
21056;"Lazdynų mokykla (Liudvinavo g.128)";DRUGELIAI;7074859809;Taip;3;2;8;13
21057;"Lazdynų mokykla (Liudvinavo g.128)";DRUGELIAI;4097980299;Ne;0;1;0;1
21058;"Lazdynų mokykla (Liudvinavo g.128)";DRUGELIAI;8001610972;Ne;0;1;0;1
21059;"Lazdynų mokykla (Liudvinavo g.128)";DRUGELIAI;5902104981;Ne;9;0;0;9
21060;"Lazdynų mokykla (Liudvinavo g.128)";DRUGELIAI;7590111138;Ne;12;0;0;12
21061;"Lazdynų mokykla (Liudvinavo g.128)";DRUGELIAI;8472834181;Taip;11;0;0;11
21062;"Lazdynų mokykla (Liudvinavo g.128)";DRUGELIAI;2027751624;Ne;0;4;0;4
21063;"Lazdynų mokykla (Liudvinavo g.128)";ZUIKUČIAI;7232402011;Ne;6;2;0;8
21064;"Lazdynų mokykla (Liudvinavo g.128)";ZUIKUČIAI;4166599533;Ne;15;0;0;15
21065;"Lazdynų mokykla (Liudvinavo g.128)";ZUIKUČIAI;3435025978;Ne;0;0;6;6
21066;"Lazdynų mokykla (Liudvinavo g.128)";ZUIKUČIAI;3715070791;Ne;2;0;7;9
21067;"Lazdynų mokykla (Liudvinavo g.128)";ZUIKUČIAI;3265099747;Ne;0;0;2;2
21068;"Lazdynų mokykla (Liudvinavo g.128)";ZUIKUČIAI;8669630986;Taip;10;1;0;11
21069;"Lazdynų mokykla (Liudvinavo g.128)";ZUIKUČIAI;1336503878;Taip;4;1;2;7
21070;"Lazdynų mokykla (Liudvinavo g.128)";ZUIKUČIAI;3302443490;Ne;0;0;2;2
21071;"Lazdynų mokykla (Liudvinavo g.128)";ZUIKUČIAI;3268305561;Ne;0;0;2;2
21072;"Lazdynų mokykla (Liudvinavo g.128)";ZUIKUČIAI;7000921682;Ne;0;0;2;2
21073;"Lazdynų mokykla (Liudvinavo g.128)";ZUIKUČIAI;3535244441;Ne;3;0;3;6
21074;"Lazdynų mokykla (Liudvinavo g.128)";ZUIKUČIAI;7594978836;Ne;3;2;0;5
21075;"Lazdynų mokykla (Liudvinavo g.128)";ZUIKUČIAI;5465094647;Ne;0;5;1;6
21076;"Lazdynų mokykla (Liudvinavo g.128)";ZUIKUČIAI;1044630813;Ne;0;2;0;2
21077;"Lazdynų mokykla (Liudvinavo g.128)";ZUIKUČIAI;7229926614;Ne;4;0;0;4
21078;"Lazdynų mokykla (Liudvinavo g.128)";ZUIKUČIAI;8899186547;Ne;16;0;0;16
21079;"Lazdynų mokykla (Liudvinavo g.128)";ZUIKUČIAI;5181200460;Ne;7;0;3;10
21080;"Vilniaus Šilo mokykla";Boružėlės;7122041826;Ne;20;0;0;20
21081;"Vilniaus Šilo mokykla";Boružėlės;5962551687;Ne;3;0;0;3
21082;"Vilniaus Šilo mokykla";Boružėlės;1538635985;Ne;14;0;0;14
21083;"Vilniaus Šilo mokykla";Boružėlės;6136087920;Ne;0;20;0;20
21084;"Vilniaus Šilo mokykla";Boružėlės;4544126354;Ne;11;0;0;11
21085;"Vilniaus Šilo mokykla";"1 spec.";1153167430;Ne;12;0;0;12
21086;"Vilniaus Šilo mokykla";"1 spec.";8863021708;Ne;1;0;0;1
21087;"Vilniaus Šilo mokykla";"1 spec.";4438939800;Ne;3;0;0;3
21088;"Vilniaus Šilo mokykla";"1 spec.";1971717759;Ne;1;0;0;1
21089;"Vilniaus Šilo mokykla";"1 spec.";1180183091;Ne;0;20;0;20
21090;"Vilniaus Šilo mokykla";"3-4 kl. RUS";34463714051;Ne;2;0;0;2
21091;"Vilniaus Šilo mokykla";"3-4 kl. RUS";9789373884;Ne;0;20;0;20
21092;"Vilniaus Šilo mokykla";"3-4 kl. RUS";3419495275;Ne;1;19;0;20
21093;"Vilniaus Šilo mokykla";"6 lav.";67989956617;Ne;0;20;0;20
21094;"Vilniaus Šilo mokykla";"6 lav.";2862598950;Ne;2;0;0;2
21095;"Vilniaus Šilo mokykla";"7-10 spec.";9944901942;Ne;1;0;0;1
21096;"Vilniaus Šilo mokykla";"7-10 spec.";5083856935;Ne;1;0;0;1
21097;"Vilniaus Šilo mokykla";"7-10 spec.";3333634089;Ne;3;20;0;23
21098;"Vilniaus Šilo mokykla";"7-10 spec.";8548722736;Ne;2;0;0;2
21099;"Vilniaus Šilo mokykla";"7-10 spec.";1726056983;Ne;3;0;0;3
21100;"Vilniaus Šilo mokykla";"7-10 spec.";5255365063;Ne;2;0;0;2
21101;"Vilniaus Šilo mokykla";"7-10 spec.";6452740859;Ne;4;0;0;4
21102;"Vilniaus Šilo mokykla";"SĮ A";6954467869;Ne;0;20;0;20
21103;"Vilniaus Šilo mokykla";"SĮ A";5649950011;Ne;1;0;0;1
21104;"Vilniaus Šilo mokykla";"SĮ A";2755910347;Ne;5;0;0;5
21105;"Vilniaus Šilo mokykla";"SĮ A";9354191217;Ne;1;0;0;1
21106;"Vilniaus Šilo mokykla";"SĮ A";9471629029;Ne;1;0;0;1
21107;"Vilniaus Šilo mokykla";"SĮ A";6088433049;Ne;2;0;0;2
21108;"Vilniaus Šilo mokykla";"SĮ A";1819519275;Ne;1;0;0;1
21109;"Vilniaus Šilo mokykla";"SĮ A";9050305661;Ne;0;20;0;20
21110;"Vilniaus Šilo mokykla";"SĮ A";8625084837;Ne;0;20;0;20
21111;"Vilniaus Šilo mokykla";"SĮ A";9845575989;Ne;1;0;0;1
21112;"Vilniaus Šilo mokykla";"SĮ A";3308772529;Ne;1;0;0;1
21113;"Vilniaus Šilo mokykla";"SĮ C";5309862220;Ne;0;20;0;20
21114;"Vilniaus Šilo mokykla";"SĮ C";5138513395;Ne;10;0;0;10
21115;"Vilniaus Šilo mokykla";"SĮ C";1969540884;Ne;0;20;0;20
21116;"Vilniaus Šilo mokykla";"Priešmokyklinė grupė";5311183877;Ne;8;0;0;8
21117;"Vilniaus Šilo mokykla";"Priešmokyklinė grupė";1675384533;Ne;15;0;0;15
21118;"Vilniaus Šilo mokykla";"Priešmokyklinė grupė";3237698420;Ne;5;0;0;5
21119;"Vilniaus Šilo mokykla";"Priešmokyklinė grupė";2070454339;Ne;0;20;0;20
21120;"Vilniaus Šilo mokykla";"Priešmokyklinė grupė";8915901727;Ne;6;0;0;6
21121;"Vilniaus Šilo mokykla";"Priešmokyklinė grupė";9906750269;Ne;0;20;0;20
21122;"Vilniaus Šilo mokykla";"Priešmokyklinė grupė";8897729962;Ne;2;0;0;2
21123;Malūnėlis;BITUTĖS;1001575740;Ne;0;0;4;4
21124;Malūnėlis;BITUTĖS;8618778205;Ne;3;1;0;4
21125;Malūnėlis;BITUTĖS;2545930114;Ne;2;0;0;2
21126;Malūnėlis;BITUTĖS;3329510128;Ne;4;0;2;6
21127;Malūnėlis;BITUTĖS;5402027714;Ne;0;2;0;2
21128;Malūnėlis;BITUTĖS;6863437022;Ne;0;16;0;16
21129;Malūnėlis;BITUTĖS;5244586185;Ne;5;2;0;7
21130;Malūnėlis;BITUTĖS;7144098762;Ne;6;0;0;6
21131;Malūnėlis;BITUTĖS;1146723570;Ne;19;0;0;19
21132;Malūnėlis;BITUTĖS;9891418762;Ne;4;12;0;16
21133;Malūnėlis;BITUTĖS;8642960989;Ne;5;0;0;5
21134;Malūnėlis;BITUTĖS;5959610426;Taip;1;2;0;3
21135;Malūnėlis;BITUTĖS;4367009696;Taip;7;3;0;10
21136;Malūnėlis;BITUTĖS;5770511204;Ne;3;2;0;5
21137;Malūnėlis;BITUTĖS;9936144392;Ne;8;0;1;9
21138;Malūnėlis;BITUTĖS;1944670796;Ne;14;0;0;14
21139;Malūnėlis;BITUTĖS;5421090978;Ne;8;1;0;9
21140;Malūnėlis;BITUTĖS;8643210289;Taip;3;2;0;5
21141;Malūnėlis;BITUTĖS;1528972517;Ne;0;11;0;11
21142;Malūnėlis;BITUTĖS;4202723476;Ne;1;1;0;2
21143;Malūnėlis;BITUTĖS;9257812097;Ne;0;1;0;1
21144;Malūnėlis;BITUTĖS;3402561453;Ne;0;9;0;9
21145;Malūnėlis;VOVERIUKAI;3293082023;Ne;2;5;0;7
21146;Malūnėlis;VOVERIUKAI;6575258889;Taip;10;5;0;15
21147;Malūnėlis;VOVERIUKAI;1003043129;Ne;0;0;2;2
21148;Malūnėlis;VOVERIUKAI;3779723692;Ne;0;2;0;2
21149;Malūnėlis;VOVERIUKAI;7983537913;Ne;0;0;5;5
21150;Malūnėlis;VOVERIUKAI;9592117637;Ne;2;1;0;3
21151;Malūnėlis;VOVERIUKAI;9894452403;Ne;5;4;0;9
21152;Malūnėlis;VOVERIUKAI;9342720464;Ne;0;7;0;7
21153;Malūnėlis;VOVERIUKAI;2246526281;Ne;2;0;0;2
21154;Malūnėlis;VOVERIUKAI;2192305527;Ne;11;2;0;13
21155;Malūnėlis;VOVERIUKAI;6805587761;Ne;11;2;0;13
21156;Malūnėlis;VOVERIUKAI;3371260811;Ne;3;0;0;3
21157;Malūnėlis;VOVERIUKAI;5061720786;Ne;4;0;4;8
21158;Malūnėlis;VOVERIUKAI;3898518306;Ne;0;0;14;14
21159;Malūnėlis;VOVERIUKAI;1770049356;Ne;8;1;0;9
21160;Malūnėlis;VOVERIUKAI;5909022614;Taip;4;1;0;5
21161;Malūnėlis;VOVERIUKAI;6081634102;Ne;10;1;0;11
21162;Malūnėlis;BORUŽĖLĖS;7556990784;Ne;1;0;1;2
21163;Malūnėlis;BORUŽĖLĖS;1100719254;Taip;5;0;0;5
21164;Malūnėlis;BORUŽĖLĖS;2525923211;Ne;10;0;0;10
21165;Malūnėlis;BORUŽĖLĖS;9304119075;Ne;8;0;0;8
21166;Malūnėlis;BORUŽĖLĖS;6928976717;Taip;9;0;2;11
21167;Malūnėlis;BORUŽĖLĖS;6531364407;Ne;6;0;0;6
21168;Malūnėlis;BORUŽĖLĖS;2637299307;Ne;10;0;0;10
21169;Malūnėlis;BORUŽĖLĖS;8551271848;Ne;5;0;1;6
21170;Malūnėlis;BORUŽĖLĖS;8277245773;Taip;11;3;0;14
21171;Malūnėlis;BORUŽĖLĖS;5686301875;Ne;12;0;0;12
21172;Malūnėlis;BORUŽĖLĖS;1407908511;Ne;5;0;0;5
21173;Malūnėlis;BORUŽĖLĖS;4787212056;Taip;14;2;0;16
21174;Malūnėlis;BORUŽĖLĖS;7740957549;Ne;5;0;0;5
21175;Malūnėlis;BORUŽĖLĖS;9185138453;Ne;18;2;0;20
21176;Malūnėlis;BORUŽĖLĖS;5727725132;Ne;18;1;0;19
21177;Malūnėlis;BORUŽĖLĖS;9559372808;Ne;13;0;0;13
21178;Malūnėlis;Skruzdėliukų;2093908776;Ne;0;4;0;4
21179;Malūnėlis;Skruzdėliukų;9798968369;Ne;6;0;0;6
21180;Malūnėlis;Skruzdėliukų;4859886340;Ne;10;0;1;11
21181;Malūnėlis;Skruzdėliukų;1213476648;Ne;6;0;0;6
21182;Malūnėlis;Skruzdėliukų;9300944734;Ne;3;4;0;7
21183;Malūnėlis;Skruzdėliukų;5877882690;Ne;0;3;0;3
21184;Malūnėlis;Skruzdėliukų;9153589128;Ne;10;0;2;12
21185;Malūnėlis;Skruzdėliukų;1549241453;Ne;0;0;1;1
21186;Malūnėlis;Skruzdėliukų;5478561852;Ne;5;1;0;6
21187;Malūnėlis;Skruzdėliukų;9207327884;Ne;11;0;2;13
21188;Malūnėlis;Skruzdėliukų;6609446450;Ne;2;1;0;3
21189;Malūnėlis;Skruzdėliukų;5687585794;Ne;9;0;0;9
21190;Malūnėlis;Skruzdėliukų;8076487157;Ne;0;0;2;2
21191;Malūnėlis;Skruzdėliukų;2495112045;Ne;15;0;0;15
21192;Malūnėlis;Skruzdėliukų;3935474148;Ne;0;1;1;2
21193;Malūnėlis;Skruzdėliukų;8751365673;Ne;5;0;1;6
21194;Malūnėlis;Žirniukų;3791873303;Ne;0;4;0;4
21195;Malūnėlis;Žirniukų;3031849277;Ne;0;1;0;1
21196;Malūnėlis;Žirniukų;6747286787;Ne;0;1;0;1
21197;Malūnėlis;Žirniukų;4539998453;Ne;9;0;0;9
21198;Malūnėlis;Žirniukų;6943968536;Ne;4;2;0;6
21199;Malūnėlis;Žirniukų;4841028952;Ne;16;0;0;16
21200;Malūnėlis;Žirniukų;7097858329;Ne;6;0;0;6
21201;Malūnėlis;Žirniukų;5893575540;Ne;12;0;0;12
21202;Malūnėlis;Žirniukų;1398391534;Ne;4;1;1;6
21203;Malūnėlis;Žirniukų;2961972215;Ne;10;0;1;11
21204;Malūnėlis;Žirniukų;3315571256;Ne;0;13;1;14
21205;Malūnėlis;Žirniukų;3315571256;Ne;0;13;1;14
21206;Malūnėlis;Žirniukų;3315571256;Ne;0;13;1;14
21207;Malūnėlis;Žirniukų;9941335615;Ne;6;5;0;11
21208;Malūnėlis;Žirniukų;3464224841;Ne;5;1;0;6
21209;Malūnėlis;Žirniukų;6047042736;Ne;2;0;0;2
21210;Malūnėlis;Žirniukų;4875859413;Ne;15;0;0;15
21211;Malūnėlis;Žirniukų;6647872886;Taip;0;1;4;5
21212;"Dainorėliai (Goštauto g. 4)";PUMPURĖLIAI;4560328911;Ne;10;2;9;21
21213;"Dainorėliai (Goštauto g. 4)";PUMPURĖLIAI;4435310580;Ne;0;1;22;23
21214;"Dainorėliai (Goštauto g. 4)";PUMPURĖLIAI;7197089520;Ne;0;1;1;2
21215;"Dainorėliai (Goštauto g. 4)";PUMPURĖLIAI;3999214263;Ne;1;0;0;1
21216;"Dainorėliai (Goštauto g. 4)";PUMPURĖLIAI;6362265057;Ne;0;0;5;5
21217;"Dainorėliai (Goštauto g. 4)";PUMPURĖLIAI;1233029451;Ne;6;14;0;20
21218;"Dainorėliai (Goštauto g. 4)";PUMPURĖLIAI;5534783929;Ne;6;0;2;8
21219;"Dainorėliai (Goštauto g. 4)";PUMPURĖLIAI;3705286231;Ne;5;0;0;5
21220;"Dainorėliai (Goštauto g. 4)";PUMPURĖLIAI;4826994208;Ne;5;0;0;5
21221;"Dainorėliai (Goštauto g. 4)";PUMPURĖLIAI;4848146301;Ne;1;1;5;7
21222;"Dainorėliai (Goštauto g. 4)";DEBESĖLIŲ;6513417505;Ne;7;1;0;8
21223;"Dainorėliai (Goštauto g. 4)";DEBESĖLIŲ;3908458280;Ne;20;0;0;20
21224;"Dainorėliai (Goštauto g. 4)";DEBESĖLIŲ;1873415679;Ne;0;5;0;5
21225;"Dainorėliai (Goštauto g. 4)";DEBESĖLIŲ;4286864865;Ne;10;0;0;10
21226;"Dainorėliai (Goštauto g. 4)";DEBESĖLIŲ;1554081754;Ne;0;0;2;2
21227;"Dainorėliai (Goštauto g. 4)";DEBESĖLIŲ;6832582194;Taip;0;2;3;5
21228;"Dainorėliai (Goštauto g. 4)";DEBESĖLIŲ;2095914442;Ne;0;1;0;1
21229;"Dainorėliai (Goštauto g. 4)";DEBESĖLIŲ;3271090533;Ne;0;19;0;19
21230;"Dainorėliai (Goštauto g. 4)";DEBESĖLIŲ;4033317616;Ne;14;0;0;14
21231;"Dainorėliai (Goštauto g. 4)";DEBESĖLIŲ;6449332338;Ne;0;2;0;2
21232;"Dainorėliai (Goštauto g. 4)";DEBESĖLIŲ;9285865812;Ne;13;1;0;14
21233;"Dainorėliai (Goštauto g. 4)";DEBESĖLIŲ;6284140548;Taip;0;21;0;21
21234;"Dainorėliai (Goštauto g. 4)";DEBESĖLIŲ;2534758615;Ne;8;4;0;12
21235;"Dainorėliai (Goštauto g. 4)";DEBESĖLIŲ;5283566263;Ne;7;2;0;9
21236;"Krivūlė (Vokiečių g. 1)";PABIRUČIAI;9011102232;Ne;0;0;1;1
21237;"Krivūlė (Vokiečių g. 1)";PABIRUČIAI;5535822704;Ne;0;20;0;20
21238;"Krivūlė (Vokiečių g. 1)";PABIRUČIAI;1944288576;Ne;0;0;1;1
21239;"Krivūlė (Vokiečių g. 1)";PABIRUČIAI;3696403149;Taip;0;20;0;20
21240;"Krivūlė (Vokiečių g. 1)";PABIRUČIAI;5721252419;Ne;0;20;0;20
21241;"Krivūlė (Vokiečių g. 1)";PABIRUČIAI;4600688626;Ne;0;0;3;3
21242;"Krivūlė (Vokiečių g. 1)";PABIRUČIAI;7308968772;Ne;3;0;0;3
21243;"Krivūlė (Vokiečių g. 1)";PABIRUČIAI;4884789671;Ne;8;0;2;10
21244;"Krivūlė (Vokiečių g. 1)";PABIRUČIAI;8352493729;Ne;0;20;0;20
21245;"Krivūlė (Vokiečių g. 1)";PABIRUČIAI;8678565710;Ne;0;6;1;7
21246;"Krivūlė (Vokiečių g. 1)";PABIRUČIAI;9401191578;Ne;0;0;1;1
21247;"Krivūlė (Vokiečių g. 1)";PABIRUČIAI;2259139771;Ne;10;0;1;11
21248;"Krivūlė (Vokiečių g. 1)";PABIRUČIAI;3138555448;Ne;7;7;1;15
21249;"Krivūlė (Vokiečių g. 1)";PABIRUČIAI;2784118970;Ne;0;0;3;3
21250;"Krivūlė (Vokiečių g. 1)";PABIRUČIAI;3227555647;Ne;0;0;6;6
21251;"Krivūlė (Vokiečių g. 1)";PABIRUČIAI;4261770381;Ne;13;0;2;15
21252;"Krivūlė (Vokiečių g. 1)";SMALSUČIAI;5304221329;Ne;1;0;3;4
21253;"Krivūlė (Vokiečių g. 1)";SMALSUČIAI;7508079584;Ne;0;0;1;1
21254;"Krivūlė (Vokiečių g. 1)";SMALSUČIAI;3076382863;Ne;0;0;2;2
21255;"Krivūlė (Vokiečių g. 1)";SMALSUČIAI;7997564406;Ne;0;5;0;5
21256;"Krivūlė (Vokiečių g. 1)";SMALSUČIAI;8710938907;Ne;6;0;2;8
21257;"Krivūlė (Vokiečių g. 1)";SMALSUČIAI;4491462086;Taip;1;0;3;4
21258;"Krivūlė (Vokiečių g. 1)";SMALSUČIAI;4773564048;Ne;0;9;0;9
21259;"Krivūlė (Vokiečių g. 1)";SMALSUČIAI;3324090723;Ne;0;0;5;5
21260;"Krivūlė (Vokiečių g. 1)";SMALSUČIAI;4094383258;Ne;8;0;1;9
21261;"Krivūlė (Vokiečių g. 1)";SMALSUČIAI;9229817861;Ne;0;0;6;6
21262;"Krivūlė (Vokiečių g. 1)";SMALSUČIAI;8042469720;Ne;6;6;0;12
21263;"Krivūlė (Vokiečių g. 1)";SMALSUČIAI;4845066055;Ne;0;0;20;20
21264;"Krivūlė (Vokiečių g. 1)";SMALSUČIAI;9328365491;Ne;4;0;1;5
21265;"Krivūlė (Vokiečių g. 1)";SMALSUČIAI;1815336153;Ne;0;1;0;1
21266;"Krivūlė (Vokiečių g. 1)";SMALSUČIAI;6521798502;Ne;5;0;6;11
21267;"Krivūlė (Vokiečių g. 1)";SMALSUČIAI;1851097789;Ne;4;6;0;10
21268;"Krivūlė (Vokiečių g. 1)";GUDRUČIAI;4681543921;Ne;0;0;3;3
21269;"Krivūlė (Vokiečių g. 1)";GUDRUČIAI;8520470321;Ne;0;0;1;1
21270;"Krivūlė (Vokiečių g. 1)";GUDRUČIAI;5753204752;Ne;3;0;2;5
21271;"Krivūlė (Vokiečių g. 1)";GUDRUČIAI;2659604299;Ne;0;0;3;3
21272;"Krivūlė (Vokiečių g. 1)";GUDRUČIAI;1622495013;Ne;5;0;2;7
21273;"Krivūlė (Vokiečių g. 1)";GUDRUČIAI;7727246187;Ne;0;1;0;1
21274;"Krivūlė (Vokiečių g. 1)";GUDRUČIAI;5652936425;Ne;2;0;0;2
21275;"Krivūlė (Vokiečių g. 1)";GUDRUČIAI;6072261879;Ne;1;0;3;4
21276;"Krivūlė (Vokiečių g. 1)";GUDRUČIAI;5149419581;Ne;0;0;1;1
21277;"Krivūlė (Vokiečių g. 1)";GUDRUČIAI;7789605738;Ne;6;0;0;6
21278;"Krivūlė (Vokiečių g. 1)";GUDRUČIAI;9693693101;Ne;1;0;7;8
21279;"Krivūlė (Vokiečių g. 1)";GUDRUČIAI;5462491857;Ne;0;5;0;5
21280;"Krivūlė (Vokiečių g. 1)";GUDRUČIAI;8871794542;Ne;6;0;1;7
21281;"Krivūlė (Vokiečių g. 1)";GUDRUČIAI;5182563483;Ne;1;0;0;1
21282;"Pumpurėlis (Trinapolio g. 11)";GUDRUČIAI;7002569226;Ne;11;0;0;11
21283;"Pumpurėlis (Trinapolio g. 11)";GUDRUČIAI;9353403057;Ne;3;0;0;3
21284;"Pumpurėlis (Trinapolio g. 11)";GUDRUČIAI;9353403057;Ne;3;0;0;3
21285;"Pumpurėlis (Trinapolio g. 11)";GUDRUČIAI;6920353753;Ne;14;0;1;15
21286;"Pumpurėlis (Trinapolio g. 11)";GUDRUČIAI;6920353753;Ne;14;0;1;15
21287;"Pumpurėlis (Trinapolio g. 11)";GUDRUČIAI;1189960583;Ne;0;0;7;7
21288;"Pumpurėlis (Trinapolio g. 11)";GUDRUČIAI;3841134563;Ne;1;0;2;3
21289;"Pumpurėlis (Trinapolio g. 11)";GUDRUČIAI;3841134563;Ne;1;0;2;3
21290;"Pumpurėlis (Trinapolio g. 11)";GUDRUČIAI;3841134563;Ne;1;0;2;3
21291;"Pumpurėlis (Trinapolio g. 11)";GUDRUČIAI;5187890514;Ne;0;0;3;3
21292;"Pumpurėlis (Trinapolio g. 11)";GUDRUČIAI;9126312869;Ne;2;0;0;2
21293;"Pumpurėlis (Trinapolio g. 11)";GUDRUČIAI;3387386473;Ne;5;0;2;7
21294;"Pumpurėlis (Trinapolio g. 11)";GUDRUČIAI;7177681927;Ne;6;0;2;8
21295;"Pumpurėlis (Trinapolio g. 11)";GUDRUČIAI;2130008026;Ne;10;0;3;13
21296;"Pumpurėlis (Trinapolio g. 11)";GUDRUČIAI;3333547914;Taip;10;0;10;20
21297;"Pumpurėlis (Trinapolio g. 11)";GUDRUČIAI;9550967420;Ne;7;0;13;20
21298;"Pumpurėlis (Trinapolio g. 11)";GUDRUČIAI;8534897580;Taip;0;0;2;2
21299;"Pumpurėlis (Trinapolio g. 11)";GUDRUČIAI;1750311606;Ne;0;5;0;5
21300;"Pumpurėlis (Trinapolio g. 11)";PABIRUČIAI;9824315755;Ne;0;7;0;7
21301;"Pumpurėlis (Trinapolio g. 11)";PABIRUČIAI;4565317498;Ne;0;0;2;2
21302;"Pumpurėlis (Trinapolio g. 11)";PABIRUČIAI;7910361194;Ne;8;0;8;16
21303;"Pumpurėlis (Trinapolio g. 11)";PABIRUČIAI;5249717804;Ne;10;0;0;10
21304;"Pumpurėlis (Trinapolio g. 11)";PABIRUČIAI;5403012236;Ne;1;9;5;15
21305;"Pumpurėlis (Trinapolio g. 11)";PABIRUČIAI;7998027741;Ne;2;0;1;3
21306;"Pumpurėlis (Trinapolio g. 11)";PABIRUČIAI;4955734206;Ne;4;0;1;5
21307;"Pumpurėlis (Trinapolio g. 11)";PABIRUČIAI;8704865319;Ne;9;0;1;10
21308;"Pumpurėlis (Trinapolio g. 11)";PABIRUČIAI;8207951541;Ne;0;0;1;1
21309;"Pumpurėlis (Trinapolio g. 11)";PABIRUČIAI;4696006714;Taip;5;0;0;5
21310;"Pumpurėlis (Trinapolio g. 11)";PABIRUČIAI;9597889927;Ne;0;0;3;3
21311;"Pumpurėlis (Trinapolio g. 11)";PABIRUČIAI;2187090934;Ne;8;0;0;8
21312;"Pumpurėlis (Trinapolio g. 11)";PABIRUČIAI;1222204689;Ne;6;0;0;6
21313;"Pumpurėlis (Trinapolio g. 11)";PABIRUČIAI;9395698760;Ne;13;0;0;13
21314;"Gilužis (Įsruties g. 30)";"MEDYNĖLIO 1 GR.";8237963602;Ne;10;0;1;11
21315;"Gilužis (Įsruties g. 30)";"MEDYNĖLIO 1 GR.";9753512366;Ne;16;0;0;16
21316;"Gilužis (Įsruties g. 30)";"MEDYNĖLIO 1 GR.";6914566889;Ne;1;0;0;1
21317;"Gilužis (Įsruties g. 30)";"MEDYNĖLIO 1 GR.";5306278297;Ne;10;0;7;17
21318;"Gilužis (Įsruties g. 30)";"MEDYNĖLIO 1 GR.";1054809163;Ne;9;0;3;12
21319;"Gilužis (Įsruties g. 30)";"MEDYNĖLIO 1 GR.";7887970476;Ne;6;0;1;7
21320;"Gilužis (Įsruties g. 30)";"MEDYNĖLIO 1 GR.";6507021182;Ne;0;14;3;17
21321;"Gilužis (Įsruties g. 30)";"MEDYNĖLIO 1 GR.";2364391112;Ne;3;0;0;3
21322;"Gilužis (Įsruties g. 30)";"MEDYNĖLIO 1 GR.";7068801003;Ne;0;0;1;1
21323;"Gilužis (Įsruties g. 30)";"MEDYNĖLIO 1 GR.";3081351563;Ne;9;0;0;9
21324;"Gilužis (Įsruties g. 30)";"MEDYNĖLIO 1 GR.";1015379578;Ne;0;2;1;3
21325;"Gilužis (Įsruties g. 30)";"MEDYNĖLIO 2 GR.";7247606321;Ne;0;0;10;10
21326;"Gilužis (Įsruties g. 30)";"MEDYNĖLIO 2 GR.";5664892047;Ne;10;0;0;10
21327;"Gilužis (Įsruties g. 30)";"MEDYNĖLIO 2 GR.";3379889899;Ne;8;0;0;8
21328;"Gilužis (Įsruties g. 30)";"MEDYNĖLIO 2 GR.";2567788346;Ne;5;0;0;5
21329;"Gilužis (Įsruties g. 30)";"MEDYNĖLIO 2 GR.";8717811266;Ne;8;0;3;11
21330;"Gilužis (Įsruties g. 30)";"MEDYNĖLIO 2 GR.";5769955074;Taip;2;0;0;2
21331;"Gilužis (Įsruties g. 30)";"MEDYNĖLIO 2 GR.";7487731015;Ne;8;0;4;12
21332;"Gilužis (Įsruties g. 30)";"MEDYNĖLIO 2 GR.";5079154238;Ne;6;0;4;10
21333;"Gilužis (Įsruties g. 30)";"MEDYNĖLIO 2 GR.";5490128851;Ne;0;0;5;5
21334;"Gilužis (Įsruties g. 30)";"MEDYNĖLIO 2 GR.";5784201106;Ne;9;0;1;10
21335;"Gilužis (Įsruties g. 30)";"MEDYNĖLIO 2 GR.";8904873416;Ne;1;0;0;1
21336;"Gilužis (Įsruties g. 30)";"MEDYNĖLIO 2 GR.";2851682356;Ne;7;0;0;7
21337;"Gilužis (Įsruties g. 30)";"STRAZDELIO GR.";6485579727;Ne;2;0;0;2
21338;"Gilužis (Įsruties g. 30)";"STRAZDELIO GR.";8477445384;Ne;0;0;3;3
21339;"Gilužis (Įsruties g. 30)";"STRAZDELIO GR.";6766559505;Taip;4;0;0;4
21340;"Gilužis (Įsruties g. 30)";"STRAZDELIO GR.";3194397689;Ne;7;4;1;12
21341;"Gilužis (Įsruties g. 30)";"STRAZDELIO GR.";5737505086;Ne;0;20;0;20
21342;"Gilužis (Įsruties g. 30)";"STRAZDELIO GR.";3414489196;Ne;20;0;0;20
21343;"Gilužis (Įsruties g. 30)";"STRAZDELIO GR.";6586605929;Ne;0;13;0;13
21344;"Gilužis (Įsruties g. 30)";"STRAZDELIO GR.";3331616067;Ne;7;0;6;13
21345;"Gilužis (Įsruties g. 30)";"STRAZDELIO GR.";3729538163;Ne;5;0;1;6
21346;"Gilužis (Įsruties g. 30)";"STRAZDELIO GR.";4325300253;Ne;4;0;3;7
21347;"Gilužis (Įsruties g. 30)";"STRAZDELIO GR.";5921538837;Ne;8;0;1;9
21348;"Gilužis (Įsruties g. 30)";"STRAZDELIO GR.";7053810996;Taip;0;0;1;1
21349;"Gilužis (Įsruties g. 30)";"STRAZDELIO GR.";9846916206;Ne;0;0;1;1
21350;"Gilužis (Įsruties g. 30)";"STRAZDELIO GR.";2398220397;Ne;15;0;2;17
21351;"Gilužis (Įsruties g. 30)";"STRAZDELIO GR.";3187000487;Ne;4;0;2;6
21352;"Gilužis (Įsruties g. 30)";"STRAZDELIO GR.";1826248450;Ne;6;0;1;7
21353;"Gilužis (Įsruties g. 30)";"STRAZDELIO GR.";9325927745;Ne;5;0;9;14
21354;"Pilaitukas (Įsruties g. 27)";ŠNEKUČIAI;9940643503;Ne;1;0;0;1
21355;"Pilaitukas (Įsruties g. 27)";ŠNEKUČIAI;9731380502;Ne;0;2;0;2
21356;"Pilaitukas (Įsruties g. 27)";ŠNEKUČIAI;7224121082;Ne;20;0;0;20
21357;"Pilaitukas (Įsruties g. 27)";ŠNEKUČIAI;9115588495;Ne;16;0;1;17
21358;"Pilaitukas (Įsruties g. 27)";ŠNEKUČIAI;1082342063;Ne;0;1;0;1
21359;"Pilaitukas (Įsruties g. 27)";ŠNEKUČIAI;8801482035;Ne;0;11;7;18
21360;"Pilaitukas (Įsruties g. 27)";ŠNEKUČIAI;2894028512;Ne;3;0;0;3
21361;"Pilaitukas (Įsruties g. 27)";ŠNEKUČIAI;9622989196;Ne;6;0;5;11
21362;"Pilaitukas (Įsruties g. 27)";ŠNEKUČIAI;1356473379;Ne;0;20;0;20
21363;"Pilaitukas (Įsruties g. 27)";ŠNEKUČIAI;2883122532;Ne;7;1;0;8
21364;"Pilaitukas (Įsruties g. 27)";ŠNEKUČIAI;2883122532;Ne;7;1;0;8
21365;"Pilaitukas (Įsruties g. 27)";ŠNEKUČIAI;2883122532;Ne;7;1;0;8
21366;"Pilaitukas (Įsruties g. 27)";ŠNEKUČIAI;1309209771;Ne;6;0;1;7
21367;"Pilaitukas (Įsruties g. 27)";SMALSUČIAI;3215689222;Ne;0;0;1;1
21368;"Pilaitukas (Įsruties g. 27)";SMALSUČIAI;1974429718;Ne;9;0;0;9
21369;"Pilaitukas (Įsruties g. 27)";SMALSUČIAI;4544849086;Ne;15;0;0;15
21370;"Pilaitukas (Įsruties g. 27)";SMALSUČIAI;6934677745;Ne;0;0;1;1
21371;"Pilaitukas (Įsruties g. 27)";SMALSUČIAI;6496708020;Ne;0;0;1;1
21372;"Pilaitukas (Įsruties g. 27)";SMALSUČIAI;4608105047;Ne;10;0;1;11
21373;"Pilaitukas (Įsruties g. 27)";SMALSUČIAI;8698639192;Ne;0;0;1;1
21374;"Pilaitukas (Įsruties g. 27)";SMALSUČIAI;3273127718;Ne;5;0;1;6
21375;"Pilaitukas (Įsruties g. 27)";SMALSUČIAI;3501783231;Ne;17;0;0;17
21376;"Pilaitukas (Įsruties g. 27)";SMALSUČIAI;4898803794;Ne;12;0;0;12
21377;"Pilaitukas (Įsruties g. 27)";SMALSUČIAI;7034013577;Ne;4;0;0;4
21378;"Pilaitukas (Įsruties g. 27)";SMALSUČIAI;1793393776;Ne;0;4;6;10
21379;"Pilaitukas (Įsruties g. 27)";SMALSUČIAI;6906821879;Ne;11;0;0;11
21380;"Pilaitukas (Įsruties g. 27)";" GUDRUČIAI";9921730735;Ne;0;0;1;1
21381;"Pilaitukas (Įsruties g. 27)";" GUDRUČIAI";3068325053;Ne;0;0;4;4
21382;"Pilaitukas (Įsruties g. 27)";" GUDRUČIAI";1571691020;Ne;0;0;4;4
21383;"Pilaitukas (Įsruties g. 27)";" GUDRUČIAI";7904142328;Ne;0;0;4;4
21384;"Pilaitukas (Įsruties g. 27)";" GUDRUČIAI";8584321345;Ne;0;3;0;3
21385;"Pilaitukas (Įsruties g. 27)";" GUDRUČIAI";3483758882;Taip;2;0;0;2
21386;"Pilaitukas (Įsruties g. 27)";" GUDRUČIAI";3674481373;Ne;0;0;1;1
21387;"Pilaitukas (Įsruties g. 27)";" GUDRUČIAI";5059528135;Ne;5;0;0;5
21388;"Pilaitukas (Įsruties g. 27)";" GUDRUČIAI";87760608710;Ne;3;0;0;3
21389;"Pilaitukas (Įsruties g. 27)";" GUDRUČIAI";93271260871;Ne;12;2;0;14
21390;"Pilaitukas (Įsruties g. 27)";" GUDRUČIAI";8928237970;Ne;11;0;0;11
21391;"Pilaitukas (Įsruties g. 27)";" GUDRUČIAI";2819283284;Ne;11;0;1;12
21392;"Pilaitukas (Įsruties g. 27)";" GUDRUČIAI";5574732283;Ne;0;0;1;1
21393;"Pilaitukas (Įsruties g. 27)";" GUDRUČIAI";7380303098;Ne;4;5;0;9
21394;"Pilaitukas (Įsruties g. 27)";" GUDRUČIAI";1430155044;Ne;0;0;3;3
21395;"Pilaitukas (Įsruties g. 27)";" GUDRUČIAI";3621245783;Ne;0;0;4;4
21396;"Pilaitukas (Įsruties g. 27)";" GUDRUČIAI";2682252810;Ne;0;0;1;1
21397;"Pilaitukas (Įsruties g. 27)";" GUDRUČIAI";7290732562;Ne;7;0;4;11
21398;"Pilaitukas (Įsruties g. 27)";" GUDRUČIAI";3927118900;Ne;6;6;1;13
21399;"Pilaitukas (Įsruties g. 27)";" GUDRUČIAI";5464065587;Ne;5;1;0;6
