Nr.;"Darželio pavadinimas";"Grupės pavadinimas";"Vaiko Identifikacinis Nr.";"Deklaruotas mieste";"Pateisintos dėl ligos";"Pateisintos dėl kitų priežasčių";"Nepateisintos dienos";"Praleistos dienos Viso"
1;Aitvaras;"VIJURKAI (ALERG.)";2566375128;Ne;0;12;0;12
2;Aitvaras;"VIJURKAI (ALERG.)";1879540041;Ne;5;2;0;7
3;Aitvaras;"VIJURKAI (ALERG.)";1532588441;Ne;0;1;0;1
4;Aitvaras;"VIJURKAI (ALERG.)";9157794193;Ne;12;0;0;12
5;Aitvaras;"VIJURKAI (ALERG.)";9562494357;Ne;16;0;0;16
6;Aitvaras;"VIJURKAI (ALERG.)";6021342178;Ne;21;0;0;21
7;Aitvaras;"VIJURKAI (ALERG.)";2650483861;Ne;3;1;0;4
8;Aitvaras;"VIJURKAI (ALERG.)";2601983670;Ne;0;1;0;1
9;Aitvaras;"VIJURKAI (ALERG.)";3570820823;Ne;0;0;1;1
10;Aitvaras;"VIJURKAI (ALERG.)";6444377924;Ne;0;2;0;2
11;Aitvaras;"VIJURKAI (ALERG.)";4702400490;Ne;7;0;0;7
12;Aitvaras;"VIJURKAI (ALERG.)";9807784148;Ne;0;1;0;1
13;Aitvaras;"VIJURKAI (ALERG.)";8641433486;Ne;7;1;0;8
14;Aitvaras;"VIJURKAI (ALERG.)";5619137905;Ne;2;1;0;3
15;Aitvaras;"SMALSUČIAI (ALERG.)";7109001184;Ne;0;0;1;1
16;Aitvaras;"SMALSUČIAI (ALERG.)";4114397590;Ne;3;1;0;4
17;Aitvaras;"SMALSUČIAI (ALERG.)";2357399981;Ne;4;2;0;6
18;Aitvaras;"SMALSUČIAI (ALERG.)";2760970218;Ne;4;2;0;6
19;Aitvaras;"SMALSUČIAI (ALERG.)";8666824607;Ne;0;1;0;1
20;Aitvaras;"SMALSUČIAI (ALERG.)";4564723798;Ne;0;6;0;6
21;Aitvaras;"SMALSUČIAI (ALERG.)";4176681907;Ne;5;1;0;6
22;Aitvaras;"SMALSUČIAI (ALERG.)";5612991255;Ne;0;1;0;1
23;Aitvaras;"SMALSUČIAI (ALERG.)";5572538840;Ne;0;3;0;3
24;Aitvaras;"SMALSUČIAI (ALERG.)";4120515569;Ne;1;0;0;1
25;Aitvaras;"SMALSUČIAI (ALERG.)";4612994715;Ne;2;0;1;3
26;Aitvaras;"SMALSUČIAI (ALERG.)";9885781306;Ne;0;1;0;1
27;Aitvaras;"SMALSUČIAI (ALERG.)";1091372798;Ne;0;1;0;1
28;Aitvaras;PADAUŽIUKAI;8065540507;Ne;0;1;0;1
29;Aitvaras;PADAUŽIUKAI;2328771385;Ne;5;6;0;11
30;Aitvaras;PADAUŽIUKAI;1288810999;Ne;3;0;1;4
31;Aitvaras;PADAUŽIUKAI;5922357091;Ne;10;0;0;10
32;Aitvaras;PADAUŽIUKAI;6501943902;Ne;6;1;0;7
33;Aitvaras;PADAUŽIUKAI;4350590529;Ne;0;2;0;2
34;Aitvaras;PADAUŽIUKAI;7777235021;Ne;0;2;0;2
35;Aitvaras;PADAUŽIUKAI;5641224483;Ne;0;1;0;1
36;Aitvaras;PADAUŽIUKAI;6214572150;Ne;11;0;0;11
37;Aitvaras;PADAUŽIUKAI;1830134108;Taip;0;0;7;7
38;Aitvaras;PADAUŽIUKAI;3178965623;Ne;0;1;0;1
39;Aitvaras;PADAUŽIUKAI;5905456814;Ne;0;1;0;1
40;Aitvaras;PADAUŽIUKAI;6739827530;Ne;0;6;0;6
41;Aitvaras;PADAUŽIUKAI;3323458595;Ne;4;0;0;4
42;Aitvaras;PADAUŽIUKAI;2807595769;Ne;0;6;0;6
43;Aitvaras;PADAUŽIUKAI;8360380303;Ne;3;0;0;3
44;Aitvaras;PADAUŽIUKAI;1252145346;Ne;0;0;3;3
45;Aitvaras;PADAUŽIUKAI;7455895024;Ne;0;3;1;4
46;Aitvaras;PADAUŽIUKAI;8439586875;Ne;4;2;0;6
47;Aitvaras;PADAUŽIUKAI;1594675221;Ne;8;1;0;9
48;Aitvaras;"AITVARIUKAI (ALERG.)";3639102842;Ne;0;1;0;1
49;Aitvaras;"AITVARIUKAI (ALERG.)";7243387750;Ne;4;4;0;8
50;Aitvaras;"AITVARIUKAI (ALERG.)";6587437949;Ne;0;3;0;3
51;Aitvaras;"AITVARIUKAI (ALERG.)";7461284958;Ne;0;1;0;1
52;Aitvaras;"AITVARIUKAI (ALERG.)";3394251305;Ne;0;2;0;2
53;Aitvaras;"AITVARIUKAI (ALERG.)";6459307767;Ne;1;0;0;1
54;Aitvaras;"AITVARIUKAI (ALERG.)";5635576679;Taip;5;1;0;6
55;Aitvaras;"AITVARIUKAI (ALERG.)";7988247429;Ne;2;2;0;4
56;Aitvaras;"AITVARIUKAI (ALERG.)";8770777328;Ne;0;2;0;2
57;Aitvaras;"AITVARIUKAI (ALERG.)";9721273154;Ne;8;0;0;8
58;Aitvaras;"AITVARIUKAI (ALERG.)";8543644000;Ne;4;0;0;4
59;Aitvaras;"AITVARIUKAI (ALERG.)";1859647003;Ne;11;0;0;11
60;Aitvaras;"AITVARIUKAI (ALERG.)";4204923580;Ne;6;1;0;7
61;Aitvaras;"AITVARIUKAI (ALERG.)";4777266938;Ne;6;0;0;6
62;Aitvaras;"AITVARIUKAI (ALERG.)";7568388141;Ne;5;2;0;7
63;Aitvaras;"AITVARIUKAI (ALERG.)";3954840915;Ne;0;7;0;7
64;Aitvaras;"AITVARIUKAI (ALERG.)";2146963673;Ne;1;0;0;1
65;Aitvaras;"AITVARIUKAI (ALERG.)";9763502346;Ne;0;4;0;4
66;Aitvaras;"AITVARIUKAI (ALERG.)";9228736015;Ne;2;7;0;9
67;Aitvaras;"AITVARIUKAI (ALERG.)";2615576367;Ne;11;5;0;16
68;Aitvaras;"SAULĖS ZUIKUČIAI  (ALERG.)";5711324951;Ne;0;1;0;1
69;Aitvaras;"SAULĖS ZUIKUČIAI  (ALERG.)";9659883026;Ne;6;0;0;6
70;Aitvaras;"SAULĖS ZUIKUČIAI  (ALERG.)";2184231202;Ne;0;2;0;2
71;Aitvaras;"SAULĖS ZUIKUČIAI  (ALERG.)";2478737835;Ne;10;0;0;10
72;Aitvaras;"SAULĖS ZUIKUČIAI  (ALERG.)";1136438927;Ne;0;1;0;1
73;Aitvaras;"SAULĖS ZUIKUČIAI  (ALERG.)";8137900398;Ne;0;2;0;2
74;Aitvaras;"SAULĖS ZUIKUČIAI  (ALERG.)";9147954612;Ne;0;0;1;1
75;Aitvaras;"SAULĖS ZUIKUČIAI  (ALERG.)";2511844613;Ne;8;0;0;8
76;Aitvaras;"SAULĖS ZUIKUČIAI  (ALERG.)";9534206000;Ne;2;0;0;2
77;Aitvaras;"SAULĖS ZUIKUČIAI  (ALERG.)";3737054758;Taip;9;1;0;10
78;Aitvaras;"SAULĖS ZUIKUČIAI  (ALERG.)";4646876966;Ne;7;1;0;8
79;Aitvaras;"SAULĖS ZUIKUČIAI  (ALERG.)";9271534775;Ne;3;5;0;8
80;Aitvaras;"SAULĖS ZUIKUČIAI  (ALERG.)";5252728205;Ne;0;0;2;2
81;Aitvaras;"SAULĖS ZUIKUČIAI  (ALERG.)";2373509019;Ne;16;0;0;16
82;Aitvaras;"SAULĖS ZUIKUČIAI  (ALERG.)";3677551059;Ne;2;0;1;3
83;Aitvaras;"SAULĖS ZUIKUČIAI  (ALERG.)";2547934790;Ne;0;6;0;6
84;Aitvaras;"ŽEMYNUKAI (ALERG.)";6218019092;Ne;0;4;4;8
85;Aitvaras;"ŽEMYNUKAI (ALERG.)";7560642918;Ne;0;2;0;2
86;Aitvaras;"ŽEMYNUKAI (ALERG.)";3820930777;Ne;28;1;0;29
87;Aitvaras;"ŽEMYNUKAI (ALERG.)";6624986090;Ne;13;0;2;15
88;Aitvaras;"ŽEMYNUKAI (ALERG.)";4733627644;Ne;8;2;0;10
89;Aitvaras;"ŽEMYNUKAI (ALERG.)";3104109370;Ne;1;10;3;14
90;Aitvaras;"ŽEMYNUKAI (ALERG.)";7853714142;Taip;12;1;0;13
91;Aitvaras;"ŽEMYNUKAI (ALERG.)";1949144346;Ne;0;2;1;3
92;Aitvaras;"ŽEMYNUKAI (ALERG.)";3961423273;Ne;0;1;0;1
93;Aitvaras;"ŽEMYNUKAI (ALERG.)";7113016866;Ne;8;0;0;8
94;Aitvaras;"ŽEMYNUKAI (ALERG.)";4377666052;Taip;4;4;6;14
95;Aitvaras;"ŽEMYNUKAI (ALERG.)";8333823078;Ne;0;2;0;2
96;Aitvaras;"ŽEMYNUKAI (ALERG.)";5623106419;Ne;0;2;0;2
97;Aitvaras;"ŽEMYNUKAI (ALERG.)";5351333397;Ne;0;7;0;7
98;Aitvaras;"ŽEMYNUKAI (ALERG.)";2065988478;Ne;16;0;0;16
99;Aitvaras;"ŽEMYNUKAI (ALERG.)";3635354769;Ne;15;2;0;17
100;Aitvaras;"ŽEMYNUKAI (ALERG.)";3851322849;Ne;0;13;0;13
101;Aitvaras;"ŽEMYNUKAI (ALERG.)";7889947603;Ne;10;10;0;20
102;Aitvaras;"ŽEMYNUKAI (ALERG.)";1662289664;Ne;0;10;0;10
103;Aitvaras;"LINKSMUČIAI (ALERG.)";4721229601;Ne;6;0;0;6
104;Aitvaras;"LINKSMUČIAI (ALERG.)";7598319477;Ne;3;0;3;6
105;Aitvaras;"LINKSMUČIAI (ALERG.)";2231465856;Ne;6;0;1;7
106;Aitvaras;"LINKSMUČIAI (ALERG.)";4394700961;Ne;2;0;2;4
107;Aitvaras;"LINKSMUČIAI (ALERG.)";8161320750;Ne;0;1;0;1
108;Aitvaras;"LINKSMUČIAI (ALERG.)";9006105693;Taip;10;0;0;10
109;Aitvaras;"LINKSMUČIAI (ALERG.)";7886218360;Ne;16;0;0;16
110;Aitvaras;"LINKSMUČIAI (ALERG.)";2209078997;Ne;6;0;0;6
111;Aitvaras;"LINKSMUČIAI (ALERG.)";7463592589;Ne;3;0;0;3
112;Aitvaras;"LINKSMUČIAI (ALERG.)";9810208704;Ne;8;0;0;8
113;Aitvaras;"LINKSMUČIAI (ALERG.)";5308153768;Ne;9;0;0;9
114;Aitvaras;"LINKSMUČIAI (ALERG.)";4954780185;Ne;1;0;1;2
115;Aitvaras;NAMINUKAI;3053557807;Ne;0;1;0;1
116;Aitvaras;NAMINUKAI;6126913961;Ne;2;0;0;2
117;Aitvaras;NAMINUKAI;3347213578;Ne;0;2;0;2
118;Aitvaras;NAMINUKAI;9024245490;Taip;0;1;0;1
119;Aitvaras;NAMINUKAI;8512502118;Ne;0;3;0;3
120;Aitvaras;NAMINUKAI;9039303562;Ne;0;6;2;8
121;Aitvaras;NAMINUKAI;6080549524;Ne;0;6;2;8
122;Aitvaras;NAMINUKAI;6048701733;Ne;0;5;0;5
123;Aitvaras;NAMINUKAI;8043062737;Taip;0;3;0;3
124;Aitvaras;NAMINUKAI;3005447572;Ne;1;2;0;3
125;Aitvaras;NAMINUKAI;1549552392;Ne;0;4;0;4
126;Aitvaras;NAMINUKAI;9490714865;Ne;0;5;0;5
127;Aitvaras;NAMINUKAI;1498630458;Ne;4;0;0;4
128;Aitvaras;NAMINUKAI;5967188507;Ne;0;12;0;12
129;Aitvaras;NAMINUKAI;5161069611;Ne;0;6;0;6
130;Aitvaras;NAMINUKAI;7934344218;Ne;1;1;0;2
131;Aitvaras;NAMINUKAI;6279152796;Ne;0;1;0;1
132;Aitvaras;ŠELMIAI;4984058405;Taip;0;4;0;4
133;Aitvaras;ŠELMIAI;9725401255;Ne;15;0;0;15
134;Aitvaras;ŠELMIAI;4547342872;Ne;3;2;1;6
135;Aitvaras;ŠELMIAI;5684526288;Taip;0;1;0;1
136;Aitvaras;ŠELMIAI;5601517340;Ne;0;11;0;11
137;Aitvaras;ŠELMIAI;8756012613;Ne;0;0;1;1
138;Aitvaras;ŠELMIAI;1203732956;Ne;3;0;0;3
139;Aitvaras;ŠELMIAI;5782609781;Ne;11;1;0;12
140;Aitvaras;ŠELMIAI;7805819121;Ne;17;0;0;17
141;Aitvaras;ŠELMIAI;8558414510;Ne;2;1;0;3
142;Aitvaras;ŠELMIAI;4551774368;Ne;2;1;0;3
143;Aitvaras;ŠELMIAI;7352233454;Ne;0;0;4;4
144;Aitvaras;ŠELMIAI;1901118931;Ne;0;1;0;1
145;Aitvaras;ŠELMIAI;4812423010;Ne;17;2;0;19
146;Aitvaras;ŠELMIAI;8644983502;Ne;5;1;0;6
147;Aitvaras;ŠELMIAI;9295561516;Ne;0;2;1;3
148;Aitvaras;ŠELMIAI;6188186413;Ne;8;1;0;9
149;Aitvaras;KODĖLČIUKAI;4613021421;Ne;5;2;0;7
150;Aitvaras;KODĖLČIUKAI;2887681961;Ne;9;1;0;10
151;Aitvaras;KODĖLČIUKAI;4760801928;Ne;15;0;0;15
152;Aitvaras;KODĖLČIUKAI;7136674662;Ne;0;2;0;2
153;Aitvaras;KODĖLČIUKAI;7922937851;Ne;0;6;0;6
154;Aitvaras;KODĖLČIUKAI;4163871634;Ne;5;1;0;6
155;Aitvaras;KODĖLČIUKAI;3988226974;Ne;5;1;0;6
156;Aitvaras;KODĖLČIUKAI;1070324386;Ne;0;1;0;1
157;Aitvaras;KODĖLČIUKAI;1599296739;Taip;5;10;5;20
158;Aitvaras;KODĖLČIUKAI;4987412561;Ne;4;0;1;5
159;Aitvaras;KODĖLČIUKAI;2239387580;Ne;0;1;0;1
160;Aitvaras;KODĖLČIUKAI;9949206639;Ne;0;1;0;1
161;Aitvaras;KODĖLČIUKAI;2892898328;Taip;0;1;1;2
162;Aitvaras;KODĖLČIUKAI;3749008647;Ne;0;0;7;7
163;Aitvaras;KODĖLČIUKAI;2871973045;Ne;5;0;0;5
164;Aitvaras;KODĖLČIUKAI;9218287162;Taip;4;1;0;5
165;Aitvaras;KODĖLČIUKAI;5093291829;Ne;11;0;0;11
166;Aitvaras;KODĖLČIUKAI;6119148164;Ne;7;2;0;9
167;Aitvaras;PABIRUČIAI;7971913889;Ne;7;2;1;10
168;Aitvaras;PABIRUČIAI;5563725441;Ne;1;0;0;1
169;Aitvaras;PABIRUČIAI;1961795617;Ne;0;0;1;1
170;Aitvaras;PABIRUČIAI;9081528512;Ne;4;0;0;4
171;Aitvaras;PABIRUČIAI;9494510876;Ne;4;12;0;16
172;Aitvaras;PABIRUČIAI;6689082073;Ne;0;2;6;8
173;Aitvaras;PABIRUČIAI;4816698202;Ne;0;1;1;2
174;Aitvaras;PABIRUČIAI;2817620246;Ne;1;0;0;1
175;Aitvaras;PABIRUČIAI;4560348711;Ne;1;0;0;1
176;Aitvaras;PABIRUČIAI;4251238917;Ne;8;0;0;8
177;Aitvaras;PABIRUČIAI;8003130815;Ne;5;0;3;8
178;Aitvaras;PABIRUČIAI;2045368104;Ne;0;1;3;4
179;Aitvaras;PABIRUČIAI;6660146833;Ne;0;1;1;2
180;Aitvaras;PABIRUČIAI;1026413538;Ne;15;0;2;17
181;Aitvaras;PABIRUČIAI;1020056632;Ne;0;0;3;3
182;Aitvaras;"SVAJOKLIAI  (ALERG.)";5659897032;Ne;10;0;0;10
183;Aitvaras;"SVAJOKLIAI  (ALERG.)";4618560397;Ne;11;2;0;13
184;Aitvaras;"SVAJOKLIAI  (ALERG.)";9209862610;Ne;0;3;0;3
185;Aitvaras;"SVAJOKLIAI  (ALERG.)";6191938291;Ne;2;0;0;2
186;Aitvaras;"SVAJOKLIAI  (ALERG.)";7006713502;Ne;3;2;0;5
187;Aitvaras;"SVAJOKLIAI  (ALERG.)";3923601422;Ne;6;1;0;7
188;Aitvaras;"SVAJOKLIAI  (ALERG.)";5790551266;Ne;1;0;0;1
189;Aitvaras;"SVAJOKLIAI  (ALERG.)";2975696317;Ne;2;11;0;13
190;Aitvaras;"SVAJOKLIAI  (ALERG.)";3891067128;Ne;1;10;0;11
191;Aitvaras;"SVAJOKLIAI  (ALERG.)";8352951885;Ne;5;0;0;5
192;Aitvaras;"SVAJOKLIAI  (ALERG.)";5255843693;Ne;6;0;0;6
193;Aitvaras;"SVAJOKLIAI  (ALERG.)";1448307414;Ne;13;0;0;13
194;Aitvaras;"SVAJOKLIAI  (ALERG.)";5593105541;Taip;10;0;0;10
195;Aitvaras;"SVAJOKLIAI  (ALERG.)";8963214183;Ne;0;12;0;12
196;Aitvaras;"SVAJOKLIAI  (ALERG.)";1131690624;Ne;0;1;0;1
197;Aitvaras;"SVAJOKLIAI  (ALERG.)";4801034095;Ne;0;6;0;6
198;Aitvaras;"SVAJOKLIAI  (ALERG.)";6916032116;Ne;4;1;0;5
199;Aitvaras;"SVAJOKLIAI  (ALERG.)";8300788433;Ne;0;13;0;13
200;Atžalėlės;Gėlytės;4284673729;Ne;11;3;0;14
201;Atžalėlės;Gėlytės;2385614957;Ne;1;6;1;8
202;Atžalėlės;Gėlytės;5432433423;Taip;0;4;0;4
203;Atžalėlės;Gėlytės;9715625283;Ne;17;0;0;17
204;Atžalėlės;Gėlytės;2131592139;Ne;5;2;0;7
205;Atžalėlės;Gėlytės;1722233272;Ne;0;8;0;8
206;Atžalėlės;Gėlytės;9189223222;Ne;0;4;0;4
207;Atžalėlės;Gėlytės;3283415814;Ne;0;4;0;4
208;Atžalėlės;Gėlytės;1146492807;Ne;0;0;2;2
209;Atžalėlės;Gėlytės;3870758086;Ne;0;1;1;2
210;Atžalėlės;Gėlytės;6202250600;Ne;3;0;0;3
211;Atžalėlės;Gėlytės;4098210138;Ne;1;0;0;1
212;Atžalėlės;Gėlytės;6177038838;Ne;0;1;1;2
213;Atžalėlės;Gėlytės;5742471497;Ne;0;0;5;5
214;Atžalėlės;Gėlytės;1036410428;Ne;0;0;1;1
215;Atžalėlės;Gėlytės;6597540627;Ne;3;0;0;3
216;Atžalėlės;Drugeliai;9481268935;Ne;7;0;2;9
217;Atžalėlės;Drugeliai;1423254771;Ne;9;0;1;10
218;Atžalėlės;Drugeliai;1505286928;Ne;4;1;0;5
219;Atžalėlės;Drugeliai;7483616061;Ne;9;0;3;12
220;Atžalėlės;Drugeliai;4227804985;Ne;0;0;1;1
221;Atžalėlės;Drugeliai;9053620501;Ne;0;0;1;1
222;Atžalėlės;Drugeliai;5174826594;Ne;0;0;1;1
223;Atžalėlės;Drugeliai;4148412941;Ne;0;8;0;8
224;Atžalėlės;Drugeliai;9054589111;Ne;0;0;2;2
225;Atžalėlės;Drugeliai;7501772398;Ne;0;0;3;3
226;Atžalėlės;Drugeliai;1710646812;Ne;0;0;5;5
227;Atžalėlės;Drugeliai;6447615639;Ne;5;0;0;5
228;Atžalėlės;Drugeliai;5972419628;Ne;0;3;0;3
229;Atžalėlės;Gandriukai;2083260403;Ne;0;16;0;16
230;Atžalėlės;Gandriukai;3692090073;Ne;0;1;0;1
231;Atžalėlės;Gandriukai;5119260525;Taip;3;0;4;7
232;Atžalėlės;Gandriukai;4293557144;Ne;0;12;0;12
233;Atžalėlės;Gandriukai;9201449702;Ne;2;0;0;2
234;Atžalėlės;Gandriukai;2078549599;Ne;6;0;3;9
235;Atžalėlės;Gandriukai;1305611902;Ne;6;0;2;8
236;Atžalėlės;Voveriukai;3795729265;Ne;1;0;2;3
237;Atžalėlės;Voveriukai;8201582382;Ne;9;0;1;10
238;Atžalėlės;Voveriukai;4362058013;Ne;9;0;1;10
239;Atžalėlės;Voveriukai;3069192413;Ne;0;0;2;2
240;Atžalėlės;Voveriukai;5705303891;Taip;0;0;1;1
241;Atžalėlės;Voveriukai;2374624441;Ne;0;3;0;3
242;Atžalėlės;Voveriukai;1212074068;Ne;8;0;1;9
243;Atžalėlės;Voveriukai;9967641617;Ne;0;2;0;2
244;Atžalėlės;Voveriukai;6723689098;Ne;5;6;0;11
245;Atžalėlės;Voveriukai;4661388894;Ne;0;6;0;6
246;Atžalėlės;Voveriukai;1538643591;Ne;1;0;0;1
247;Atžalėlės;Voveriukai;5319794176;Taip;0;0;3;3
248;Atžalėlės;Voveriukai;9085453655;Ne;3;0;4;7
249;Atžalėlės;Voveriukai;7196464328;Taip;1;0;0;1
250;Atžalėlės;Voveriukai;7018297883;Ne;1;0;11;12
251;Atžalėlės;Voveriukai;9508110719;Ne;1;0;0;1
252;Atžalėlės;Voveriukai;7522643082;Taip;4;0;0;4
253;Atžalėlės;Voveriukai;7613931447;Taip;5;1;0;6
254;Atžalėlės;Voveriukai;7510951079;Ne;0;3;0;3
255;Atžalėlės;Voveriukai;8547622670;Ne;4;0;2;6
256;Atžalėlės;Voveriukai;3143856911;Taip;0;14;0;14
257;Atžalėlės;Paukšteliai;7807313362;Ne;0;0;2;2
258;Atžalėlės;Paukšteliai;6537864486;Ne;2;0;3;5
259;Atžalėlės;Paukšteliai;8524244526;Taip;4;0;2;6
260;Atžalėlės;Paukšteliai;6873507667;Ne;3;0;1;4
261;Atžalėlės;Paukšteliai;7321516783;Taip;0;0;2;2
262;Atžalėlės;Paukšteliai;6265777690;Ne;0;0;2;2
263;Atžalėlės;Paukšteliai;1844980319;Ne;2;5;1;8
264;Atžalėlės;Paukšteliai;5997958773;Ne;0;5;2;7
265;Atžalėlės;Paukšteliai;8512283024;Ne;2;0;0;2
266;Atžalėlės;Paukšteliai;2078781673;Ne;0;5;0;5
267;Atžalėlės;Paukšteliai;1520206753;Ne;12;0;6;18
268;Atžalėlės;Paukšteliai;4081717007;Ne;0;0;4;4
269;Atžalėlės;Paukšteliai;1089221288;Ne;3;0;0;3
270;Atžalėlės;Paukšteliai;4392352210;Ne;11;0;0;11
271;Atžalėlės;Paukšteliai;1774212280;Ne;21;0;0;21
272;Atžalėlės;Meškiukai;8586739429;Ne;0;7;0;7
273;Atžalėlės;Meškiukai;2617568019;Taip;0;1;0;1
274;Atžalėlės;Meškiukai;3281114596;Ne;0;9;0;9
275;Atžalėlės;Meškiukai;5466374223;Ne;0;0;5;5
276;Atžalėlės;Meškiukai;2433029299;Ne;2;0;2;4
277;Atžalėlės;Meškiukai;9631336340;Ne;0;1;0;1
278;Atžalėlės;Meškiukai;2930612059;Ne;5;1;2;8
279;Atžalėlės;Meškiukai;6385777303;Ne;5;0;1;6
280;Atžalėlės;Meškiukai;2569491645;Ne;3;0;0;3
281;Atžalėlės;Meškiukai;1431197358;Ne;0;5;0;5
282;Atžalėlės;Meškiukai;4177753994;Ne;0;0;1;1
283;Atžalėlės;Meškiukai;3743308789;Ne;0;1;0;1
284;Atžalėlės;Meškiukai;7936991925;Taip;11;0;1;12
285;Atžalėlės;Meškiukai;8976815736;Ne;3;1;0;4
286;Atžalėlės;Saulutės;8460997063;Ne;0;0;4;4
287;Atžalėlės;Saulutės;6048763811;Taip;0;0;9;9
288;Atžalėlės;Saulutės;2291204010;Ne;0;1;2;3
289;Atžalėlės;Saulutės;2306086573;Ne;0;0;2;2
290;Atžalėlės;Saulutės;8208908249;Ne;0;10;1;11
291;Atžalėlės;Bitutės;8060332402;Ne;11;0;2;13
292;Atžalėlės;Bitutės;8396693160;Ne;0;0;2;2
293;Atžalėlės;Bitutės;6253257539;Ne;0;0;2;2
294;Atžalėlės;Bitutės;6211002805;Ne;0;10;0;10
295;Atžalėlės;Bitutės;1939076303;Ne;0;2;2;4
296;Atžalėlės;Bitutės;7052938312;Ne;0;1;0;1
297;Atžalėlės;Bitutės;8707875125;Ne;13;0;3;16
298;Atžalėlės;Bitutės;3559977339;Ne;5;0;0;5
299;Atžalėlės;Bitutės;5148142239;Ne;0;0;4;4
300;Atžalėlės;Bitutės;5593774275;Ne;12;0;0;12
301;Atžalėlės;Bitutės;5511148178;Ne;15;0;1;16
302;Atžalėlės;Boružiukai;7104671423;Ne;14;0;1;15
303;Atžalėlės;Boružiukai;3119998745;Taip;5;0;0;5
304;Atžalėlės;Boružiukai;3198845538;Ne;0;5;0;5
305;Atžalėlės;Boružiukai;3998483465;Ne;6;0;2;8
306;Atžalėlės;Boružiukai;5582697993;Ne;0;1;0;1
307;Atžalėlės;Boružiukai;7980775632;Taip;10;10;0;20
308;Atžalėlės;Boružiukai;8681809797;Ne;0;0;1;1
309;Atžalėlės;Boružiukai;3590987364;Ne;7;0;0;7
310;Atžalėlės;Boružiukai;6237597328;Ne;6;2;0;8
311;Atžalėlės;Boružiukai;1383944713;Ne;5;0;0;5
312;Atžalėlės;Boružiukai;7091939299;Ne;3;0;0;3
313;Atžalėlės;Šypsenėlės;9736390705;Ne;6;0;0;6
314;Atžalėlės;Šypsenėlės;4071402757;Ne;0;0;1;1
315;Atžalėlės;Šypsenėlės;2032772143;Ne;0;0;6;6
316;Atžalėlės;Šypsenėlės;9487375092;Taip;7;0;3;10
317;Atžalėlės;Šypsenėlės;1943349835;Ne;0;0;2;2
318;Atžalėlės;Šypsenėlės;6828140775;Ne;6;0;2;8
319;Atžalėlės;Šypsenėlės;8564143904;Ne;12;0;0;12
320;Atžalėlės;Šypsenėlės;3299724612;Ne;0;4;0;4
321;Atžalėlės;Šypsenėlės;2271887521;Taip;8;0;1;9
322;Atžalėlės;Šypsenėlės;9707462467;Ne;0;5;0;5
323;Atžalėlės;Šypsenėlės;2298114905;Ne;2;0;0;2
324;Atžalėlės;Šypsenėlės;7159628246;Ne;7;0;0;7
325;Aušrelė;PASAKIUKAI;1754138341;Ne;7;1;1;9
326;Aušrelė;PASAKIUKAI;6913824678;Ne;1;0;1;2
327;Aušrelė;PASAKIUKAI;8542012622;Ne;0;0;2;2
328;Aušrelė;PASAKIUKAI;3713528812;Ne;5;0;0;5
329;Aušrelė;PASAKIUKAI;1949809977;Ne;0;0;2;2
330;Aušrelė;PASAKIUKAI;1798478023;Ne;1;0;0;1
331;Aušrelė;PASAKIUKAI;1607338052;Ne;3;0;1;4
332;Aušrelė;PASAKIUKAI;1544869163;Ne;0;0;2;2
333;Aušrelė;PASAKIUKAI;6577540623;Ne;19;0;0;19
334;Aušrelė;PASAKIUKAI;5460833944;Ne;18;0;0;18
335;Aušrelė;PASAKIUKAI;6372004855;Ne;0;0;5;5
336;Aušrelė;PASAKIUKAI;2311552230;Ne;0;0;1;1
337;Aušrelė;PASAKIUKAI;7130040621;Ne;7;0;0;7
338;Aušrelė;PASAKIUKAI;7208341200;Ne;0;1;2;3
339;Aušrelė;BORUŽĖLĖS;5733298006;Ne;0;5;0;5
340;Aušrelė;BORUŽĖLĖS;4565813136;Ne;0;13;0;13
341;Aušrelė;BORUŽĖLĖS;9877307844;Ne;9;1;1;11
342;Aušrelė;BORUŽĖLĖS;2873845920;Ne;0;0;3;3
343;Aušrelė;BORUŽĖLĖS;5904797250;Ne;3;0;1;4
344;Aušrelė;BORUŽĖLĖS;1871799626;Ne;4;0;5;9
345;Aušrelė;BORUŽĖLĖS;4924950592;Ne;0;2;1;3
346;Aušrelė;BORUŽĖLĖS;6672975558;Ne;6;0;5;11
347;Aušrelė;BORUŽĖLĖS;8799928392;Ne;6;0;0;6
348;Aušrelė;BORUŽĖLĖS;5801943729;Taip;0;2;0;2
349;Aušrelė;BORUŽĖLĖS;5866673884;Taip;0;10;0;10
350;Aušrelė;BORUŽĖLĖS;8835689988;Ne;6;2;0;8
351;Aušrelė;BORUŽĖLĖS;8689174023;Ne;0;0;2;2
352;Aušrelė;BORUŽĖLĖS;7966060521;Ne;0;0;2;2
353;Aušrelė;SMALSUČIAI;6761263775;Ne;5;0;0;5
354;Aušrelė;SMALSUČIAI;3015028879;Ne;0;1;0;1
355;Aušrelė;SMALSUČIAI;5935579452;Ne;1;2;1;4
356;Aušrelė;SMALSUČIAI;2863655361;Ne;7;0;0;7
357;Aušrelė;SMALSUČIAI;2390128933;Ne;0;2;0;2
358;Aušrelė;SMALSUČIAI;8503309819;Ne;2;0;0;2
359;Aušrelė;SMALSUČIAI;2827216981;Ne;0;3;0;3
360;Aušrelė;SMALSUČIAI;9443641849;Ne;1;0;0;1
361;Aušrelė;SMALSUČIAI;7930717076;Ne;5;1;0;6
362;Aušrelė;SMALSUČIAI;7609339123;Ne;10;0;1;11
363;Aušrelė;SMALSUČIAI;1556010005;Taip;2;0;0;2
364;Aušrelė;SMALSUČIAI;5478028396;Ne;0;2;0;2
365;Aušrelė;SMALSUČIAI;7070013052;Ne;0;0;2;2
366;Aušrelė;SMALSUČIAI;3581155949;Ne;3;2;0;5
367;Aušrelė;SMALSUČIAI;6507218940;Ne;0;1;0;1
368;Aušrelė;SMALSUČIAI;2266390402;Ne;0;10;0;10
369;Aušrelė;SMALSUČIAI;8032661062;Ne;0;10;0;10
370;Aušrelė;SMALSUČIAI;4262596104;Ne;8;3;0;11
371;Aušrelė;SMALSUČIAI;1976613166;Ne;0;1;1;2
372;Aušrelė;SMALSUČIAI;3288449407;Ne;0;8;0;8
373;Aušrelė;KODĖLČIUKAI;7723159748;Ne;7;1;0;8
374;Aušrelė;KODĖLČIUKAI;7367268748;Ne;0;2;0;2
375;Aušrelė;KODĖLČIUKAI;3623813061;Ne;0;8;0;8
376;Aušrelė;KODĖLČIUKAI;4288695809;Ne;3;0;0;3
377;Aušrelė;KODĖLČIUKAI;9566144610;Ne;0;10;0;10
378;Aušrelė;KODĖLČIUKAI;6186758486;Ne;2;0;1;3
379;Aušrelė;KODĖLČIUKAI;3320399046;Ne;10;0;0;10
380;Aušrelė;KODĖLČIUKAI;6911735462;Ne;3;7;0;10
381;Aušrelė;KODĖLČIUKAI;4248808572;Ne;0;10;0;10
382;Aušrelė;KODĖLČIUKAI;5046027475;Ne;0;1;0;1
383;Aušrelė;KODĖLČIUKAI;8338569001;Ne;3;0;0;3
384;Aušrelė;KODĖLČIUKAI;2766357229;Taip;5;0;0;5
385;Aušrelė;KODĖLČIUKAI;7515666888;Ne;0;0;1;1
386;Aušrelė;KODĖLČIUKAI;8862488358;Ne;1;1;0;2
387;Aušrelė;KODĖLČIUKAI;4882556718;Ne;0;1;1;2
388;Aušrelė;KODĖLČIUKAI;6321332888;Ne;4;0;0;4
389;Aušrelė;PELĖDŽIUKAI;4725588671;Ne;0;1;0;1
390;Aušrelė;PELĖDŽIUKAI;3223092149;Ne;0;11;0;11
391;Aušrelė;PELĖDŽIUKAI;8580241126;Ne;0;0;3;3
392;Aušrelė;PELĖDŽIUKAI;4227228548;Ne;5;1;0;6
393;Aušrelė;PELĖDŽIUKAI;8996445434;Ne;5;1;0;6
394;Aušrelė;PELĖDŽIUKAI;8411336992;Ne;0;0;2;2
395;Aušrelė;PELĖDŽIUKAI;8917907028;Ne;0;0;1;1
396;Aušrelė;PELĖDŽIUKAI;1642358593;Ne;0;0;1;1
397;Aušrelė;PELĖDŽIUKAI;1276792874;Ne;0;0;4;4
398;Aušrelė;PELĖDŽIUKAI;8210698019;Ne;0;0;5;5
399;Aušrelė;PELĖDŽIUKAI;9004934832;Ne;0;0;1;1
400;Aušrelė;AITVARIUKAI;6833654667;Ne;0;1;0;1
401;Aušrelė;AITVARIUKAI;8102749675;Taip;0;3;0;3
402;Aušrelė;AITVARIUKAI;4595435635;Ne;14;0;0;14
403;Aušrelė;AITVARIUKAI;6434548772;Ne;5;0;0;5
404;Aušrelė;AITVARIUKAI;7978186455;Ne;0;5;0;5
405;Aušrelė;AITVARIUKAI;5708459561;Ne;0;7;0;7
406;Aušrelė;AITVARIUKAI;1039180129;Ne;15;0;0;15
407;Aušrelė;AITVARIUKAI;5125295651;Ne;0;1;0;1
408;Aušrelė;AITVARIUKAI;6081100604;Ne;5;0;0;5
409;Aušrelė;AITVARIUKAI;5727081833;Ne;0;1;0;1
410;Aušrelė;AITVARIUKAI;4942168388;Taip;10;0;0;10
411;Aušrelė;AITVARIUKAI;7788139791;Ne;1;3;0;4
412;Aušrelė;BITUTĖS;1741716341;Taip;7;2;0;9
413;Aušrelė;BITUTĖS;2071674661;Ne;0;12;0;12
414;Aušrelė;BITUTĖS;5598494461;Ne;0;0;2;2
415;Aušrelė;BITUTĖS;4935192851;Ne;0;3;0;3
416;Aušrelė;BITUTĖS;5614774250;Ne;3;0;0;3
417;Aušrelė;BITUTĖS;6591538425;Taip;0;2;0;2
418;Aušrelė;BITUTĖS;8203256528;Ne;0;15;0;15
419;Aušrelė;BITUTĖS;5741252819;Ne;0;15;0;15
420;Aušrelė;BITUTĖS;1243825974;Ne;0;2;0;2
421;Aušrelė;BITUTĖS;2468245186;Ne;0;8;0;8
422;Aušrelė;BITUTĖS;5266959731;Ne;0;6;0;6
423;Aušrelė;BITUTĖS;2545065554;Ne;0;1;0;1
424;Aušrelė;BITUTĖS;2543313198;Ne;5;0;0;5
425;Aušrelė;ŽIRNIUKAI;8833081700;Ne;0;3;0;3
426;Aušrelė;ŽIRNIUKAI;7028068342;Ne;6;0;0;6
427;Aušrelė;ŽIRNIUKAI;9274178180;Ne;6;0;0;6
428;Aušrelė;ŽIRNIUKAI;2553689977;Ne;5;0;0;5
429;Aušrelė;ŽIRNIUKAI;9859520649;Ne;10;0;0;10
430;Aušrelė;ŽIRNIUKAI;1915023166;Ne;5;0;0;5
431;Aušrelė;ŽIRNIUKAI;2543352192;Ne;3;0;0;3
432;Aušrelė;ŽIRNIUKAI;1528883001;Ne;2;0;0;2
433;Aušrelė;ŽIRNIUKAI;3023414781;Ne;3;1;0;4
434;Aušrelė;ŽIRNIUKAI;2582979005;Taip;3;0;0;3
435;Aušrelė;ŽIRNIUKAI;9884818480;Ne;4;2;0;6
436;Aušrelė;ŽIRNIUKAI;9075395810;Ne;0;0;8;8
437;Aušrelė;ŽIRNIUKAI;5429867368;Ne;0;3;0;3
438;Aušrelė;ŽIRNIUKAI;4004600465;Ne;0;2;0;2
439;Aušrelė;ŽIRNIUKAI;1138257807;Ne;0;1;0;1
440;Aušrelė;GRYBUKAI;2466858636;Taip;13;8;0;21
441;Aušrelė;GRYBUKAI;4213141410;Ne;7;8;0;15
442;Aušrelė;GRYBUKAI;6287520834;Ne;5;0;0;5
443;Aušrelė;GRYBUKAI;4260768468;Ne;6;0;0;6
444;Aušrelė;GRYBUKAI;2236345596;Ne;4;0;1;5
445;Aušrelė;GRYBUKAI;6902592468;Ne;0;0;2;2
446;Aušrelė;GRYBUKAI;2845543931;Ne;6;0;0;6
447;Aušrelė;GRYBUKAI;4063895292;Ne;0;11;0;11
448;Aušrelė;GRYBUKAI;9093567659;Ne;7;0;0;7
449;Aušrelė;GRYBUKAI;7058664271;Taip;8;0;0;8
450;Aušrelė;GRYBUKAI;7670935967;Ne;5;3;0;8
451;Aušrelė;GRYBUKAI;9007129980;Taip;0;0;1;1
452;Aušrelė;GRYBUKAI;5709799539;Ne;8;1;0;9
453;Aušrelė;GRYBUKAI;8724802289;Ne;0;1;0;1
454;Aušrelė;DRUGELIAI;1209824814;Ne;0;10;0;10
455;Aušrelė;DRUGELIAI;3831695455;Ne;0;3;0;3
456;Aušrelė;DRUGELIAI;2737402297;Ne;0;1;7;8
457;Aušrelė;DRUGELIAI;3813270658;Ne;0;2;0;2
458;Aušrelė;DRUGELIAI;4254737302;Ne;7;0;0;7
459;Aušrelė;DRUGELIAI;4464947621;Taip;0;8;0;8
460;Aušrelė;DRUGELIAI;7286960315;Ne;6;2;0;8
461;Aušrelė;DRUGELIAI;8102293098;Taip;2;2;1;5
462;Aušrelė;DRUGELIAI;2266835623;Ne;6;4;0;10
463;Aušrelė;DRUGELIAI;1094141305;Ne;0;1;0;1
464;Aušrelė;DRUGELIAI;9514049590;Ne;0;9;0;9
465;Aušrelė;DRUGELIAI;5815844340;Ne;0;1;0;1
466;Aušrelė;DRUGELIAI;5668908532;Ne;0;4;0;4
467;Aušrelė;DRUGELIAI;4840787696;Ne;3;1;1;5
468;Aušrelė;NYKŠTUKAI;9914518299;Ne;2;1;0;3
469;Aušrelė;NYKŠTUKAI;4297417711;Ne;10;0;0;10
470;Aušrelė;NYKŠTUKAI;7964156691;Taip;0;7;0;7
471;Aušrelė;NYKŠTUKAI;7937067384;Ne;3;1;0;4
472;Aušrelė;NYKŠTUKAI;8099338305;Ne;7;1;0;8
473;Aušrelė;NYKŠTUKAI;4282189556;Ne;0;6;0;6
474;Aušrelė;NYKŠTUKAI;5689460984;Ne;0;1;0;1
475;Aušrelė;NYKŠTUKAI;1950091527;Taip;4;0;0;4
476;Aušrelė;NYKŠTUKAI;8378225406;Ne;0;2;0;2
477;Aušrelė;NYKŠTUKAI;3259828075;Ne;5;1;0;6
478;Aušrelė;NYKŠTUKAI;4952876188;Ne;3;1;0;4
479;Aušrelė;NYKŠTUKAI;5358736178;Ne;0;3;0;3
480;Aušrelė;NYKŠTUKAI;6474867237;Ne;0;1;0;1
481;Aušrelė;NYKŠTUKAI;2645772675;Ne;0;2;1;3
482;Aušrelė;SPINDULIUKAI;8848358559;Ne;0;1;0;1
483;Aušrelė;SPINDULIUKAI;3194122285;Ne;0;1;0;1
484;Aušrelė;SPINDULIUKAI;8801906679;Ne;0;3;2;5
485;Aušrelė;SPINDULIUKAI;1446194971;Ne;0;3;0;3
486;Aušrelė;SPINDULIUKAI;8997650487;Ne;0;0;13;13
487;Aušrelė;SPINDULIUKAI;5274919078;Ne;0;0;1;1
488;Aušrelė;SPINDULIUKAI;2981314491;Ne;1;0;4;5
489;Aušrelė;SPINDULIUKAI;2441221298;Ne;0;0;1;1
490;Aušrelė;SPINDULIUKAI;5018495543;Ne;9;0;0;9
491;Aušrelė;SPINDULIUKAI;8797157671;Ne;0;0;3;3
492;Aušrelė;SPINDULIUKAI;3646395136;Ne;1;0;3;4
493;Aušrelė;SPINDULIUKAI;9973824348;Ne;14;0;1;15
494;Aušrelė;SPINDULIUKAI;3072503569;Ne;6;0;0;6
495;Birutės;SKRUZDELIUKŲ;4968068043;Ne;0;10;0;10
496;Birutės;SKRUZDELIUKŲ;1761065941;Ne;2;1;0;3
497;Birutės;SKRUZDELIUKŲ;9610268046;Ne;2;0;0;2
498;Birutės;SKRUZDELIUKŲ;4027700332;Ne;4;0;0;4
499;Birutės;SKRUZDELIUKŲ;8636113039;Ne;0;9;0;9
500;Birutės;SKRUZDELIUKŲ;9411016611;Ne;4;0;0;4
501;Birutės;SKRUZDELIUKŲ;7119951690;Ne;11;1;0;12
502;Birutės;SKRUZDELIUKŲ;1945532852;Ne;1;1;0;2
503;Birutės;SKRUZDELIUKŲ;5154903444;Ne;5;2;0;7
504;Birutės;SKRUZDELIUKŲ;9541516589;Ne;10;0;1;11
505;Birutės;SKRUZDELIUKŲ;6815916679;Ne;3;0;0;3
506;Birutės;SKRUZDELIUKŲ;9187671201;Ne;5;0;0;5
507;Birutės;SKRUZDELIUKŲ;2140552221;Ne;5;0;0;5
508;Birutės;SKRUZDELIUKŲ;7940403585;Ne;2;1;0;3
509;Birutės;SKRUZDELIUKŲ;4375683234;Taip;6;0;0;6
510;Birutės;SKRUZDELIUKŲ;8432173636;Ne;5;0;0;5
511;Birutės;SKRUZDELIUKŲ;9904827482;Ne;3;2;0;5
512;Birutės;SKRUZDELIUKŲ;2859160609;Ne;3;0;0;3
513;Birutės;SKRUZDELIUKŲ;2329522074;Ne;0;1;0;1
514;Birutės;SKRUZDELIUKŲ;1072357835;Ne;2;0;0;2
515;Birutės;BITUČIŲ;2866807046;Ne;5;0;1;6
516;Birutės;BITUČIŲ;7477555732;Ne;6;0;2;8
517;Birutės;BITUČIŲ;3991168916;Ne;5;0;1;6
518;Birutės;BITUČIŲ;7859284810;Taip;8;0;0;8
519;Birutės;BITUČIŲ;9147604398;Ne;2;0;0;2
520;Birutės;BITUČIŲ;3562960250;Taip;0;7;0;7
521;Birutės;BITUČIŲ;4647941243;Ne;7;0;0;7
522;Birutės;BITUČIŲ;8145970519;Ne;4;0;0;4
523;Birutės;BITUČIŲ;8736343179;Ne;7;0;2;9
524;Birutės;BITUČIŲ;9627882026;Ne;0;0;1;1
525;Birutės;BITUČIŲ;2046634392;Ne;5;0;0;5
526;Birutės;BITUČIŲ;3993249933;Ne;2;0;0;2
527;Birutės;BITUČIŲ;4102490815;Ne;1;0;1;2
528;Birutės;BITUČIŲ;3584029960;Ne;7;0;0;7
529;Birutės;BITUČIŲ;7875884277;Ne;9;0;0;9
530;Birutės;BORUŽIUKAI;5893851353;Ne;2;1;0;3
531;Birutės;BORUŽIUKAI;5457357625;Ne;2;1;0;3
532;Birutės;BORUŽIUKAI;5869137292;Ne;0;3;0;3
533;Birutės;BORUŽIUKAI;5026442722;Ne;6;0;0;6
534;Birutės;BORUŽIUKAI;6977276295;Ne;2;0;0;2
535;Birutės;BORUŽIUKAI;9289922622;Ne;4;0;0;4
536;Birutės;BORUŽIUKAI;8011210158;Ne;4;0;0;4
537;Birutės;BORUŽIUKAI;9263238557;Ne;0;3;0;3
538;Birutės;BORUŽIUKAI;4488481136;Ne;2;0;0;2
539;Birutės;BORUŽIUKAI;6460415179;Ne;6;1;0;7
540;Birutės;BORUŽIUKAI;6973898557;Ne;5;1;0;6
541;Birutės;BORUŽIUKAI;7033907787;Ne;1;0;1;2
542;Birutės;BORUŽIUKAI;5745377474;Ne;0;1;2;3
543;Birutės;BORUŽIUKAI;5897671273;Ne;2;0;5;7
544;Birutės;BORUŽIUKAI;2016711225;Ne;1;1;0;2
545;Birutės;BORUŽIUKAI;7494879160;Taip;12;0;2;14
546;Birutės;BORUŽIUKAI;7712882120;Ne;6;0;0;6
547;Birutės;BORUŽIUKAI;7741922416;Ne;0;5;0;5
548;Birutės;BORUŽIUKAI;1400510886;Ne;8;0;0;8
549;Birutės;BORUŽIUKAI;1776142202;Ne;5;0;0;5
550;Birutės;BORUŽIUKAI;4906874758;Ne;5;1;0;6
551;Birutės;BORUŽIUKAI;5875585426;Ne;1;0;0;1
552;Birutės;BORUŽIUKAI;7398022393;Taip;4;0;2;6
553;Birutės;DRUGELIAI;8854957814;Ne;2;0;2;4
554;Birutės;DRUGELIAI;5957267018;Ne;0;0;4;4
555;Birutės;DRUGELIAI;1442496209;Ne;0;3;0;3
556;Birutės;DRUGELIAI;2318034045;Taip;8;0;2;10
557;Birutės;DRUGELIAI;3516719248;Ne;3;0;0;3
558;Birutės;DRUGELIAI;5688633357;Ne;8;0;2;10
559;Birutės;DRUGELIAI;8559820030;Ne;9;0;3;12
560;Birutės;DRUGELIAI;9863681147;Ne;0;0;3;3
561;Birutės;DRUGELIAI;9307655828;Ne;11;0;1;12
562;Birutės;DRUGELIAI;3115571205;Ne;0;0;1;1
563;Birutės;DRUGELIAI;5177528200;Ne;0;0;9;9
564;Birutės;DRUGELIAI;3391101786;Ne;2;0;1;3
565;Birutės;DRUGELIAI;7336936451;Ne;0;4;0;4
566;Birutės;DRUGELIAI;4995437657;Ne;0;0;2;2
567;Bitutė;Aitvariukų;4474600934;Ne;4;0;1;5
568;Bitutė;Aitvariukų;5606049201;Taip;18;0;2;20
569;Bitutė;Aitvariukų;6035394425;Ne;4;11;0;15
570;Bitutė;Aitvariukų;7132616264;Ne;12;3;1;16
571;Bitutė;Aitvariukų;6030674568;Ne;8;0;1;9
572;Bitutė;Aitvariukų;9747786638;Ne;9;15;0;24
573;Bitutė;Aitvariukų;8259512455;Ne;4;0;4;8
574;Bitutė;Aitvariukų;2899217019;Ne;14;0;0;14
575;Bitutė;Aitvariukų;8670124052;Ne;6;0;1;7
576;Bitutė;Aitvariukų;1340530611;Taip;0;4;0;4
577;Bitutė;Aitvariukų;4164058783;Ne;21;0;0;21
578;Bitutė;Aitvariukų;8908052679;Ne;5;0;0;5
579;Bitutė;Aitvariukų;4924483609;Ne;2;10;0;12
580;Bitutė;Aitvariukų;7447624247;Taip;0;8;0;8
581;Bitutė;Aitvariukų;5880651175;Ne;0;0;4;4
582;Bitutė;Aitvariukų;7433169909;Ne;6;14;0;20
583;Bitutė;Ežiukų;5126303823;Ne;0;1;0;1
584;Bitutė;Ežiukų;4764586168;Ne;11;0;0;11
585;Bitutė;Ežiukų;8905075899;Ne;11;0;1;12
586;Bitutė;Ežiukų;3600670185;Taip;2;0;5;7
587;Bitutė;Ežiukų;6341806464;Ne;2;0;2;4
588;Bitutė;Ežiukų;2812580726;Ne;0;1;7;8
589;Bitutė;Ežiukų;8186706520;Ne;0;33;0;33
590;Bitutė;Ežiukų;5378885117;Ne;3;2;1;6
591;Bitutė;Ežiukų;2122052883;Ne;18;0;2;20
592;Bitutė;Ežiukų;4444523140;Taip;0;2;2;4
593;Bitutė;Ežiukų;4468366941;Ne;1;0;1;2
594;Bitutė;Ežiukų;5188828679;Ne;0;2;0;2
595;Bitutė;Ežiukų;8109028957;Ne;0;3;0;3
596;Bitutė;Ežiukų;3156654672;Ne;3;0;1;4
597;Bitutė;Ežiukų;9106644834;Taip;0;3;3;6
598;Bitutė;Ežiukų;5146691157;Ne;3;0;0;3
599;Bitutė;Žvirbliukų;1290146001;Taip;0;5;0;5
600;Bitutė;Žvirbliukų;6226996242;Ne;10;3;0;13
601;Bitutė;Žvirbliukų;1460746240;Ne;5;2;0;7
602;Bitutė;Žvirbliukų;3359918177;Ne;2;0;1;3
603;Bitutė;Žvirbliukų;9352292654;Ne;7;4;0;11
604;Bitutė;Žvirbliukų;2819417600;Ne;0;2;0;2
605;Bitutė;Žvirbliukų;5421744666;Ne;11;5;0;16
606;Bitutė;Žvirbliukų;9780599803;Ne;0;4;0;4
607;Bitutė;Žvirbliukų;7741454857;Ne;7;2;0;9
608;Bitutė;Žvirbliukų;6091108131;Ne;19;1;0;20
609;Bitutė;Žvirbliukų;4617493676;Taip;13;1;2;16
610;Bitutė;Žvirbliukų;3860047703;Taip;2;2;0;4
611;Bitutė;Žvirbliukų;5375847129;Ne;0;3;0;3
612;Bitutė;Žvirbliukų;3806852067;Taip;4;21;0;25
613;Bitutė;Žvirbliukų;3528436838;Ne;3;0;0;3
614;Bitutė;Žvirbliukų;2583001947;Taip;14;1;0;15
615;Bitutė;Žvirbliukų;2129484313;Ne;5;1;0;6
616;Bitutė;Žvirbliukų;2144809294;Ne;10;3;1;14
617;Bitutė;Žvirbliukų;7013249141;Ne;18;0;2;20
618;Bitutė;Žvirbliukų;5081300818;Ne;5;0;0;5
619;Bitutė;Žvirbliukų;4524571780;Ne;12;0;1;13
620;Bitutė;Gandriukų;8373296210;Ne;9;0;0;9
621;Bitutė;Gandriukų;8789574593;Ne;12;0;2;14
622;Bitutė;Gandriukų;1985958540;Ne;0;6;0;6
623;Bitutė;Gandriukų;8743960488;Ne;0;4;0;4
624;Bitutė;Gandriukų;9451529077;Ne;15;1;0;16
625;Bitutė;Gandriukų;9337144831;Taip;16;3;0;19
626;Bitutė;Gandriukų;4639968278;Ne;0;1;0;1
627;Bitutė;Gandriukų;1907876695;Ne;0;1;0;1
628;Bitutė;Gandriukų;7720798466;Ne;0;1;0;1
629;Bitutė;Gandriukų;1662815358;Taip;0;1;0;1
630;Bitutė;Gandriukų;1733189730;Ne;0;3;0;3
631;Bitutė;Gandriukų;4566919587;Ne;0;6;0;6
632;Bitutė;Gandriukų;9966437881;Ne;3;3;0;6
633;Bitutė;Gandriukų;2806899030;Ne;4;0;0;4
634;Bitutė;Gandriukų;1241863345;Ne;2;1;0;3
635;Bitutė;Gandriukų;9465186207;Ne;6;9;0;15
636;Bitutė;Pelėdžiukai;2444289145;Ne;4;7;3;14
637;Bitutė;Pelėdžiukai;3517750478;Ne;0;4;0;4
638;Bitutė;Pelėdžiukai;3804171750;Ne;1;1;0;2
639;Bitutė;Pelėdžiukai;5406667195;Ne;5;2;0;7
640;Bitutė;Pelėdžiukai;4458990772;Ne;7;0;1;8
641;Bitutė;Pelėdžiukai;3723040682;Ne;0;1;0;1
642;Bitutė;Pelėdžiukai;6014726741;Ne;0;2;0;2
643;Bitutė;Pelėdžiukai;4527880105;Ne;5;0;1;6
644;Bitutė;Pelėdžiukai;2190439190;Ne;4;2;0;6
645;Bitutė;Pelėdžiukai;9834697190;Ne;3;0;0;3
646;Bitutė;Pelėdžiukai;7113693496;Ne;1;3;1;5
647;Bitutė;Pelėdžiukai;9523588597;Ne;2;0;0;2
648;Bitutė;Pelėdžiukai;7047262367;Ne;10;0;0;10
649;Bitutė;Pelėdžiukai;4177331531;Ne;0;0;2;2
650;Bitutė;Pelėdžiukai;2483462846;Ne;0;1;0;1
651;Bitutė;Pelėdžiukai;7678106084;Ne;6;0;0;6
652;Bitutė;Pelėdžiukai;9166624750;Ne;1;1;0;2
653;Bitutė;Pelėdžiukai;8373105196;Ne;10;1;0;11
654;Bitutė;Pelėdžiukai;6044969600;Ne;0;1;0;1
655;Bitutė;Pelėdžiukai;3654065124;Ne;9;0;0;9
656;Bitutė;Boružėlių;8276590981;Ne;14;0;8;22
657;Bitutė;Boružėlių;3026526421;Ne;5;5;0;10
658;Bitutė;Boružėlių;7503203424;Taip;3;0;12;15
659;Bitutė;Boružėlių;1711888057;Ne;2;0;6;8
660;Bitutė;Boružėlių;8355346371;Ne;0;0;3;3
661;Bitutė;Boružėlių;9545405359;Ne;2;0;7;9
662;Bitutė;Boružėlių;9691450767;Ne;4;0;3;7
663;Bitutė;Boružėlių;3170266155;Ne;0;0;12;12
664;Bitutė;Boružėlių;6455582149;Ne;0;0;5;5
665;Bitutė;Boružėlių;8011051470;Ne;5;7;5;17
666;Bitutė;Boružėlių;9521938997;Ne;10;0;1;11
667;Bitutė;Boružėlių;9668365838;Ne;0;11;0;11
668;Bitutė;Boružėlių;3870675531;Ne;3;0;2;5
669;Bitutė;Boružėlių;7095475821;Taip;0;0;1;1
670;Bitutė;Boružėlių;6255439813;Ne;11;0;2;13
671;Bitutė;Boružėlių;2623999429;Ne;0;6;1;7
672;Bitutė;Boružėlių;6840722112;Ne;9;1;1;11
673;Bitutė;Boružėlių;4884898917;Ne;0;4;0;4
674;Bitutė;Boružėlių;4869423833;Ne;5;0;0;5
675;Bitutė;Boružėlių;5071978105;Ne;1;0;5;6
676;Bitutė;Šokliukų;8211710975;Ne;6;3;0;9
677;Bitutė;Šokliukų;8872286273;Ne;15;2;0;17
678;Bitutė;Šokliukų;5169768042;Ne;4;8;0;12
679;Bitutė;Šokliukų;1348548294;Ne;10;2;0;12
680;Bitutė;Šokliukų;7318555933;Ne;5;1;0;6
681;Bitutė;Šokliukų;1012702386;Ne;5;0;0;5
682;Bitutė;Šokliukų;9924340801;Ne;5;3;0;8
683;Bitutė;Šokliukų;7165511381;Ne;2;6;0;8
684;Bitutė;Šokliukų;2853616585;Ne;3;1;0;4
685;Bitutė;Šokliukų;5109258680;Ne;6;2;0;8
686;Bitutė;Šokliukų;3417576747;Ne;9;2;0;11
687;Bitutė;Šokliukų;8422448947;Ne;4;1;0;5
688;Bitutė;Šokliukų;7926482326;Ne;2;8;0;10
689;Bitutė;Šokliukų;5876700984;Ne;4;8;0;12
690;Bitutė;Šokliukų;2177537591;Ne;6;1;0;7
691;Bitutė;Šokliukų;5759407291;Ne;4;2;0;6
692;Bitutė;Šokliukų;4471813998;Ne;0;2;0;2
693;Bitutė;Šokliukų;9234090775;Taip;5;5;0;10
694;Bitutė;Drugelių;9094567866;Ne;0;0;5;5
695;Bitutė;Drugelių;5759595005;Ne;20;0;4;24
696;Bitutė;Drugelių;2085899696;Ne;18;0;1;19
697;Bitutė;Drugelių;2029309955;Ne;0;7;0;7
698;Bitutė;Drugelių;7376746010;Ne;2;0;1;3
699;Bitutė;Drugelių;5845408472;Ne;6;1;0;7
700;Bitutė;Drugelių;3611348253;Ne;8;0;1;9
701;Bitutė;Drugelių;8727525320;Ne;8;0;1;9
702;Bitutė;Drugelių;1558826102;Ne;7;0;0;7
703;Bitutė;Drugelių;6325890676;Ne;16;0;3;19
704;Bitutė;Drugelių;2748400429;Ne;15;11;0;26
705;Bitutė;Drugelių;2848732083;Taip;0;0;1;1
706;Bitutė;Drugelių;5278510767;Ne;0;10;0;10
707;Bitutė;Drugelių;8962725357;Ne;3;1;1;5
708;Bitutė;Drugelių;5471241132;Ne;9;1;1;11
709;Bitutė;Drugelių;1218462939;Ne;7;0;0;7
710;Bitutė;Drugelių;8008237092;Ne;18;0;2;20
711;Bitutė;Drugelių;4545188971;Ne;17;5;0;22
712;Bitutė;Kiškučių;3603716923;Ne;20;4;0;24
713;Bitutė;Kiškučių;5181958187;Ne;6;3;0;9
714;Bitutė;Kiškučių;1715987321;Ne;3;0;4;7
715;Bitutė;Kiškučių;4480187618;Ne;8;0;1;9
716;Bitutė;Kiškučių;4926289620;Ne;9;0;1;10
717;Bitutė;Kiškučių;7694916340;Ne;10;0;1;11
718;Bitutė;Kiškučių;5061164237;Ne;12;0;0;12
719;Bitutė;Kiškučių;8130382253;Ne;11;0;0;11
720;Bitutė;Kiškučių;5869737425;Ne;14;0;0;14
721;Bitutė;Kiškučių;5220694242;Ne;1;0;0;1
722;Bitutė;Kiškučių;8303932330;Ne;9;0;0;9
723;Bitutė;Kiškučių;8642411661;Ne;3;9;0;12
724;Bitutė;Kiškučių;1198024852;Ne;6;3;0;9
725;Bitutė;Kiškučių;9909017070;Ne;6;3;0;9
726;Bitutė;Kiškučių;3811028304;Ne;4;11;0;15
727;Bitutė;Kiškučių;9592567172;Ne;5;4;0;9
728;Bitutė;Kiškučių;7535583229;Ne;2;2;2;6
729;Bitutė;Kiškučių;7619112317;Ne;8;5;0;13
730;Bitutė;Kiškučių;8896842164;Ne;6;0;0;6
731;Bitutė;Kiškučių;8561037889;Ne;3;1;1;5
732;Bitutė;"Viščiukų ";2707925569;Ne;0;0;3;3
733;Bitutė;"Viščiukų ";7566001042;Taip;6;0;0;6
734;Bitutė;"Viščiukų ";9872069356;Ne;1;0;2;3
735;Bitutė;"Viščiukų ";2368846393;Ne;5;0;1;6
736;Bitutė;"Viščiukų ";7341046095;Ne;6;0;1;7
737;Bitutė;"Viščiukų ";9325422338;Ne;10;14;0;24
738;Bitutė;"Viščiukų ";1147029462;Ne;4;0;1;5
739;Bitutė;"Viščiukų ";9653424274;Ne;5;0;1;6
740;Bitutė;"Viščiukų ";3318389039;Ne;2;0;0;2
741;Bitutė;"Viščiukų ";7301966217;Ne;10;0;0;10
742;Bitutė;"Viščiukų ";4864590214;Ne;0;28;0;28
743;Bitutė;"Viščiukų ";5111232226;Ne;10;2;0;12
744;Bitutė;"Viščiukų ";7384402285;Ne;4;0;1;5
745;Bitutė;"Viščiukų ";6045476884;Ne;3;0;1;4
746;Bitutė;"Skruzdėliukai ";5686278261;Ne;6;0;0;6
747;Bitutė;"Skruzdėliukai ";1423694056;Ne;1;0;1;2
748;Bitutė;"Skruzdėliukai ";6311396261;Ne;11;2;0;13
749;Bitutė;"Skruzdėliukai ";7145036085;Ne;0;0;1;1
750;Bitutė;"Skruzdėliukai ";2252157473;Ne;17;0;0;17
751;Bitutė;"Skruzdėliukai ";6169426273;Ne;12;0;0;12
752;Bitutė;"Skruzdėliukai ";4513783927;Ne;14;0;0;14
753;Bitutė;"Skruzdėliukai ";8667259778;Ne;18;0;1;19
754;Bitutė;"Skruzdėliukai ";4413880918;Ne;7;0;0;7
755;Bitutė;"Skruzdėliukai ";9436414962;Ne;15;1;0;16
756;Bitutė;"Skruzdėliukai ";9864771568;Ne;30;0;0;30
757;Bitutė;"Skruzdėliukai ";6353690252;Ne;12;0;0;12
758;Bitutė;"Skruzdėliukai ";2160735504;Ne;7;0;0;7
759;Bitutė;"Skruzdėliukai ";1387310054;Ne;3;0;0;3
760;Bitutė;"Skruzdėliukai ";7245807233;Ne;8;6;1;15
761;Bitutė;"Skruzdėliukai ";4467090141;Taip;0;2;0;2
762;Bitutė;"Skruzdėliukai ";5433617195;Ne;0;6;0;6
763;Bitutė;"Skruzdėliukai ";2391170362;Ne;7;0;5;12
764;Bitutė;"Skruzdėliukai ";5490753578;Ne;0;0;2;2
765;Bitutė;"Nykštukų ";1677780832;Ne;5;0;0;5
766;Bitutė;"Nykštukų ";7093067437;Ne;12;0;2;14
767;Bitutė;"Nykštukų ";9392119453;Ne;0;7;0;7
768;Bitutė;"Nykštukų ";7618391238;Ne;0;6;0;6
769;Bitutė;"Nykštukų ";7201520408;Ne;0;10;0;10
770;Bitutė;"Nykštukų ";3564872382;Ne;8;1;0;9
771;Bitutė;"Nykštukų ";2779363539;Ne;23;0;0;23
772;Bitutė;"Nykštukų ";8344844253;Ne;5;0;0;5
773;Bitutė;"Nykštukų ";4341037730;Ne;11;0;0;11
774;Bitutė;"Nykštukų ";6591026369;Ne;0;4;0;4
775;Bitutė;"Nykštukų ";3430153178;Ne;0;3;0;3
776;Bitutė;"Nykštukų ";3938392405;Ne;0;0;1;1
777;Bitutė;"Nykštukų ";5974397461;Ne;0;8;1;9
778;Coliukė;"Bitutės (A.Kojelavičiaus g. 298)";6725408547;Ne;0;10;1;11
779;Coliukė;"Bitutės (A.Kojelavičiaus g. 298)";2167230398;Ne;0;3;0;3
780;Coliukė;"Bitutės (A.Kojelavičiaus g. 298)";1968467455;Taip;0;2;0;2
781;Coliukė;"Bitutės (A.Kojelavičiaus g. 298)";9462610674;Ne;0;0;1;1
782;Coliukė;"Bitutės (A.Kojelavičiaus g. 298)";4188233426;Ne;0;0;2;2
783;Coliukė;"Bitutės (A.Kojelavičiaus g. 298)";9331485675;Ne;7;0;0;7
784;Coliukė;"Bitutės (A.Kojelavičiaus g. 298)";2275327607;Ne;0;0;1;1
785;Coliukė;"Bitutės (A.Kojelavičiaus g. 298)";9879369365;Ne;0;3;0;3
786;Coliukė;"Bitutės (A.Kojelavičiaus g. 298)";4845247006;Ne;0;0;1;1
787;Coliukė;"Bitutės (A.Kojelavičiaus g. 298)";9885547263;Ne;0;0;3;3
788;Coliukė;"Bitutės (A.Kojelavičiaus g. 298)";8149118599;Ne;0;11;0;11
789;Coliukė;"Bitutės (A.Kojelavičiaus g. 298)";7358018315;Ne;6;1;1;8
790;Coliukė;"Bitutės (A.Kojelavičiaus g. 298)";9688432169;Ne;0;1;2;3
791;Coliukė;"Bitutės (A.Kojelavičiaus g. 298)";8478006305;Ne;0;0;6;6
792;Coliukė;"Bitutės (A.Kojelavičiaus g. 298)";9352547729;Ne;0;0;1;1
793;Coliukė;"Bitutės (A.Kojelavičiaus g. 298)";9750447455;Ne;6;0;2;8
794;Coliukė;"Bitutės (A.Kojelavičiaus g. 298)";7621095517;Ne;0;0;3;3
795;Coliukė;"Bitutės (A.Kojelavičiaus g. 298)";2385917598;Ne;6;0;2;8
796;Coliukė;"Bitutės (A.Kojelavičiaus g. 298)";4881447596;Ne;10;0;1;11
797;Coliukė;"Bitutės (A.Kojelavičiaus g. 298)";2151108735;Ne;9;2;0;11
798;Coliukė;"Boružėlės.spec. (Karklėnų g. 15)";5756690199;Ne;7;0;2;9
799;Coliukė;"Boružėlės.spec. (Karklėnų g. 15)";4422823135;Ne;3;0;5;8
800;Coliukė;"Boružėlės.spec. (Karklėnų g. 15)";2947495861;Ne;3;0;5;8
801;Coliukė;"Boružėlės.spec. (Karklėnų g. 15)";5008183731;Ne;1;2;0;3
802;Coliukė;"Boružėlės.spec. (Karklėnų g. 15)";1134875499;Ne;0;1;0;1
803;Coliukė;"Boružėlės.spec. (Karklėnų g. 15)";1326014786;Ne;12;0;5;17
804;Coliukė;"Boružėlės.spec. (Karklėnų g. 15)";7513522378;Ne;1;0;0;1
805;Coliukė;"Boružėlės.spec. (Karklėnų g. 15)";3905904092;Ne;0;0;1;1
806;Coliukė;"Nykštukai (A.Kojelavičiaus g. 298)";4149083597;Ne;10;0;0;10
807;Coliukė;"Nykštukai (A.Kojelavičiaus g. 298)";2171894105;Taip;5;0;0;5
808;Coliukė;"Nykštukai (A.Kojelavičiaus g. 298)";5481656345;Ne;0;3;0;3
809;Coliukė;"Nykštukai (A.Kojelavičiaus g. 298)";2379680426;Taip;10;0;0;10
810;Coliukė;"Nykštukai (A.Kojelavičiaus g. 298)";6483218499;Ne;5;0;0;5
811;Coliukė;"Nykštukai (A.Kojelavičiaus g. 298)";1590896552;Ne;5;2;0;7
812;Coliukė;"Nykštukai (A.Kojelavičiaus g. 298)";1465212393;Ne;6;8;0;14
813;Coliukė;"Nykštukai (A.Kojelavičiaus g. 298)";1516038730;Ne;9;0;0;9
814;Coliukė;"Nykštukai (A.Kojelavičiaus g. 298)";6441253648;Ne;5;0;0;5
815;Coliukė;"Nykštukai (A.Kojelavičiaus g. 298)";4537756081;Ne;0;12;0;12
816;Coliukė;"Nykštukai (A.Kojelavičiaus g. 298)";3719547522;Ne;2;1;0;3
817;Coliukė;"Nykštukai (A.Kojelavičiaus g. 298)";5450167562;Ne;5;0;0;5
818;Coliukė;"Nykštukai (A.Kojelavičiaus g. 298)";3384332079;Taip;6;1;0;7
819;Coliukė;"Nykštukai (A.Kojelavičiaus g. 298)";1198781036;Ne;5;2;0;7
820;Coliukė;"Nykštukai (A.Kojelavičiaus g. 298)";5283583324;Ne;0;1;0;1
821;Coliukė;"Nykštukai (A.Kojelavičiaus g. 298)";9334564869;Ne;15;1;0;16
822;Coliukė;"Nykštukai (A.Kojelavičiaus g. 298)";3140659021;Ne;0;0;13;13
823;Coliukė;"Nykštukai (A.Kojelavičiaus g. 298)";2321127662;Ne;10;0;0;10
824;Coliukė;"Nykštukai (A.Kojelavičiaus g. 298)";1575061659;Taip;4;2;0;6
825;Coliukė;"Nykštukai (A.Kojelavičiaus g. 298)";3678496820;Ne;10;0;0;10
826;Coliukė;"Nykštukai (A.Kojelavičiaus g. 298)";8715608220;Ne;0;7;0;7
827;Coliukė;"Nykštukai (A.Kojelavičiaus g. 298)";3908791146;Ne;4;2;0;6
828;Coliukė;"Nykštukai (A.Kojelavičiaus g. 298)";4635299740;Ne;9;5;0;14
829;Coliukė;"Gėlytės (A.Kojelavičiaus g. 304) ";6226741104;Ne;13;0;0;13
830;Coliukė;"Gėlytės (A.Kojelavičiaus g. 304) ";1415007991;Ne;5;0;1;6
831;Coliukė;"Gėlytės (A.Kojelavičiaus g. 304) ";3712638808;Taip;0;1;1;2
832;Coliukė;"Gėlytės (A.Kojelavičiaus g. 304) ";7500857860;Ne;0;0;14;14
833;Coliukė;"Gėlytės (A.Kojelavičiaus g. 304) ";2952029073;Taip;8;0;0;8
834;Coliukė;"Gėlytės (A.Kojelavičiaus g. 304) ";4048883287;Ne;0;0;13;13
835;Coliukė;"Gėlytės (A.Kojelavičiaus g. 304) ";4757165137;Ne;14;0;0;14
836;Coliukė;"Gėlytės (A.Kojelavičiaus g. 304) ";3693899535;Ne;6;0;0;6
837;Coliukė;"Gėlytės (A.Kojelavičiaus g. 304) ";7259282073;Ne;1;0;0;1
838;Coliukė;"Gėlytės (A.Kojelavičiaus g. 304) ";4327259627;Ne;0;1;0;1
839;Coliukė;"Drugeliai  (A.Kojelavičiaus g. 304)  ";6675290003;Ne;11;0;0;11
840;Coliukė;"Drugeliai  (A.Kojelavičiaus g. 304)  ";8849541084;Ne;8;1;0;9
841;Coliukė;"Drugeliai  (A.Kojelavičiaus g. 304)  ";7763035106;Ne;0;6;0;6
842;Coliukė;"Drugeliai  (A.Kojelavičiaus g. 304)  ";8756465257;Ne;0;4;0;4
843;Coliukė;"Drugeliai  (A.Kojelavičiaus g. 304)  ";6224089401;Ne;0;1;0;1
844;Coliukė;"Drugeliai  (A.Kojelavičiaus g. 304)  ";6102405328;Ne;6;0;0;6
845;Coliukė;"Drugeliai  (A.Kojelavičiaus g. 304)  ";1220834062;Taip;0;1;0;1
846;Coliukė;"Drugeliai  (A.Kojelavičiaus g. 304)  ";3392367716;Ne;0;7;0;7
847;Coliukė;"Drugeliai  (A.Kojelavičiaus g. 304)  ";8698370746;Ne;5;0;0;5
848;Coliukė;"Drugeliai  (A.Kojelavičiaus g. 304)  ";6611713551;Ne;12;0;0;12
849;Coliukė;"Drugeliai  (A.Kojelavičiaus g. 304)  ";6755886435;Ne;7;0;0;7
850;Coliukė;"Drugeliai  (A.Kojelavičiaus g. 304)  ";6816085304;Ne;0;7;0;7
851;Coliukė;"Drugeliai  (A.Kojelavičiaus g. 304)  ";8606195508;Taip;8;0;0;8
852;Coliukė;"Drugeliai  (A.Kojelavičiaus g. 304)  ";2247086548;Ne;0;1;0;1
853;Čiauškutis;BITUTĖS;7976738303;Ne;0;0;1;1
854;Čiauškutis;BITUTĖS;4026881335;Taip;16;0;0;16
855;Čiauškutis;BITUTĖS;4852837431;Ne;0;0;1;1
856;Čiauškutis;BITUTĖS;4652951382;Ne;0;0;4;4
857;Čiauškutis;BITUTĖS;3837360101;Ne;1;0;0;1
858;Čiauškutis;BITUTĖS;2319237497;Ne;15;0;3;18
859;Čiauškutis;BITUTĖS;1765857419;Ne;0;1;0;1
860;Čiauškutis;BITUTĖS;7282041196;Ne;1;19;1;21
861;Čiauškutis;ŽVIRBLIUKAI;5125518366;Ne;0;0;6;6
862;Čiauškutis;ŽVIRBLIUKAI;4962200863;Ne;9;0;2;11
863;Čiauškutis;ŽVIRBLIUKAI;7324659239;Ne;0;0;1;1
864;Čiauškutis;ŽVIRBLIUKAI;9759888353;Ne;0;0;6;6
865;Čiauškutis;ŽVIRBLIUKAI;1032711865;Ne;10;0;1;11
866;Čiauškutis;ŽVIRBLIUKAI;4599018314;Ne;0;0;7;7
867;Čiauškutis;ŽVIRBLIUKAI;6103657328;Ne;0;0;6;6
868;Čiauškutis;ŽVIRBLIUKAI;5368435217;Taip;0;0;1;1
869;Čiauškutis;SAULUTĖS;1158816422;Ne;0;21;0;21
870;Čiauškutis;SAULUTĖS;7489733038;Ne;0;0;3;3
871;Čiauškutis;SAULUTĖS;3724324861;Ne;0;21;0;21
872;Čiauškutis;SAULUTĖS;8580034134;Taip;9;0;0;9
873;Čiauškutis;SAULUTĖS;2445742257;Ne;5;12;4;21
874;Čiauškutis;SAULUTĖS;2686038029;Ne;0;0;5;5
875;Čiauškutis;EŽIUKAI;9565722619;Ne;0;0;3;3
876;Čiauškutis;EŽIUKAI;7654242839;Ne;0;0;21;21
877;Čiauškutis;EŽIUKAI;9294208012;Ne;0;0;5;5
878;Čiauškutis;EŽIUKAI;4216443034;Ne;0;0;6;6
879;Čiauškutis;EŽIUKAI;8297774828;Ne;0;6;0;6
880;Čiauškutis;EŽIUKAI;6303770262;Ne;6;0;0;6
881;Čiauškutis;EŽIUKAI;2380881303;Ne;3;0;1;4
882;Čiauškutis;EŽIUKAI;2829031299;Ne;3;0;0;3
883;Čiauškutis;DRUGELIAI;4681902267;Ne;13;0;1;14
884;Čiauškutis;DRUGELIAI;1928404791;Ne;0;0;1;1
885;Čiauškutis;DRUGELIAI;7746580858;Ne;2;0;0;2
886;Čiauškutis;DRUGELIAI;1234494170;Ne;6;0;0;6
887;Čiauškutis;DRUGELIAI;9897499968;Ne;0;18;3;21
888;Čiauškutis;DRUGELIAI;7135435979;Ne;4;0;2;6
889;Čiauškutis;GENELIAI;5957587644;Ne;0;0;2;2
890;Čiauškutis;GENELIAI;5052137859;Taip;0;21;0;21
891;Čiauškutis;GENELIAI;8876608072;Ne;0;0;6;6
892;Čiauškutis;GENELIAI;6785604459;Ne;6;6;9;21
893;Čiauškutis;GENELIAI;8679018030;Ne;11;0;4;15
894;Čiauškutis;GENELIAI;7851357992;Ne;11;0;4;15
895;Čiauškutis;GENELIAI;7928675053;Ne;1;0;0;1
896;Čiauškutis;LINKSMUČIAI;8689127061;Ne;12;0;1;13
897;Čiauškutis;LINKSMUČIAI;1306672095;Ne;0;0;1;1
898;Čiauškutis;LINKSMUČIAI;5910818962;Ne;6;0;1;7
899;Čiauškutis;LINKSMUČIAI;4881821738;Ne;0;0;1;1
900;Čiauškutis;LINKSMUČIAI;4881821738;Ne;0;0;1;1
901;Čiauškutis;LINKSMUČIAI;7526975680;Ne;0;0;1;1
902;Čiauškutis;LINKSMUČIAI;6146321785;Ne;0;0;1;1
903;Čiauškutis;LINKSMUČIAI;6434727608;Ne;14;0;1;15
904;Čiauškutis;LINKSMUČIAI;1733251156;Ne;5;0;1;6
905;Čiauškutis;KIŠKUČIAI;1900086424;Ne;0;1;0;1
906;Čiauškutis;KIŠKUČIAI;3465024013;Ne;5;16;0;21
907;Čiauškutis;KIŠKUČIAI;2271458332;Ne;1;0;1;2
908;Čiauškutis;KIŠKUČIAI;9754417066;Ne;21;0;0;21
909;Čiauškutis;KIŠKUČIAI;5589764935;Ne;10;0;0;10
910;Čiauškutis;KIŠKUČIAI;3126627913;Ne;1;0;1;2
911;Čiauškutis;LAPIUKAI;6810906239;Ne;5;16;0;21
912;Čiauškutis;LAPIUKAI;9460608737;Ne;5;0;6;11
913;Čiauškutis;LAPIUKAI;9928767253;Ne;0;0;1;1
914;Čiauškutis;LAPIUKAI;9702568740;Ne;0;4;0;4
915;Čiauškutis;LAPIUKAI;5842585542;Ne;9;10;1;20
916;Čiauškutis;MEŠKUČIAI;2172687454;Ne;10;0;0;10
917;Čiauškutis;MEŠKUČIAI;3660195990;Ne;3;0;0;3
918;Čiauškutis;MEŠKUČIAI;8910832777;Ne;16;0;0;16
919;Čiauškutis;MEŠKUČIAI;4213259879;Ne;0;3;0;3
920;Čiauškutis;MEŠKUČIAI;1515680948;Ne;0;0;1;1
921;Čiauškutis;MEŠKUČIAI;7714816675;Ne;0;0;1;1
922;Čiauškutis;MEŠKUČIAI;9684750515;Ne;4;0;0;4
923;Čiauškutis;PELĖDŽIUKAI;4971788697;Ne;0;0;2;2
924;Čiauškutis;PELĖDŽIUKAI;9228568063;Ne;19;0;0;19
925;Čiauškutis;PELĖDŽIUKAI;1561833758;Ne;17;0;0;17
926;Čiauškutis;PELĖDŽIUKAI;7931998640;Ne;11;0;0;11
927;Čiauškutis;PELĖDŽIUKAI;6615319751;Ne;13;0;8;21
928;Čiauškutis;PELĖDŽIUKAI;2377986721;Ne;0;0;5;5
929;Čiauškutis;PELĖDŽIUKAI;5446546214;Taip;0;0;5;5
930;Čiauškutis;PELĖDŽIUKAI;3298272815;Ne;4;0;6;10
931;Čiauškutis;NYKŠTUKAI;8948893335;Ne;11;0;0;11
932;Čiauškutis;NYKŠTUKAI;2633243682;Ne;2;1;0;3
933;Čiauškutis;NYKŠTUKAI;5575614158;Ne;0;0;21;21
934;Čiauškutis;NYKŠTUKAI;2044220236;Ne;1;10;0;11
935;Čiauškutis;NYKŠTUKAI;7335655769;Ne;0;0;1;1
936;Čiauškutis;NYKŠTUKAI;5686690700;Ne;10;0;0;10
937;Čiauškutis;NYKŠTUKAI;6051208732;Ne;3;0;1;4
938;Delfinukas;Boružėlių;5963440967;Ne;5;0;3;8
939;Delfinukas;Boružėlių;8444134791;Ne;4;0;0;4
940;Delfinukas;Boružėlių;6878446154;Ne;4;1;0;5
941;Delfinukas;Boružėlių;1970318187;Ne;14;0;0;14
942;Delfinukas;Boružėlių;7752786752;Ne;14;0;0;14
943;Delfinukas;Boružėlių;2459046463;Ne;5;2;1;8
944;Delfinukas;Boružėlių;6133972529;Ne;2;5;0;7
945;Delfinukas;Boružėlių;2323767897;Ne;14;0;1;15
946;Delfinukas;Boružėlių;2830904360;Ne;4;0;2;6
947;Delfinukas;Boružėlių;2371901540;Ne;5;6;3;14
948;Delfinukas;Boružėlių;9127076507;Ne;0;5;0;5
949;Delfinukas;Boružėlių;3015726598;Taip;1;0;2;3
950;Delfinukas;Boružėlių;1843845065;Ne;12;0;3;15
951;Delfinukas;Boružėlių;8554498555;Ne;0;1;1;2
952;Delfinukas;Boružėlių;2716595364;Ne;13;0;5;18
953;Delfinukas;Boružėlių;2450560824;Taip;10;10;0;20
954;Delfinukas;Saulytės;8315269427;Ne;1;0;0;1
955;Delfinukas;Saulytės;4215887291;Ne;0;2;0;2
956;Delfinukas;Saulytės;3631520143;Ne;1;0;0;1
957;Delfinukas;Saulytės;9424966984;Taip;6;0;0;6
958;Delfinukas;Saulytės;6069600728;Ne;2;0;1;3
959;Delfinukas;Saulytės;9729550922;Taip;0;10;0;10
960;Delfinukas;Saulytės;1404270345;Ne;1;1;0;2
961;Delfinukas;Saulytės;3842160990;Ne;0;5;0;5
962;Delfinukas;Saulytės;8402529296;Taip;3;2;0;5
963;Delfinukas;Saulytės;5642328792;Ne;0;4;0;4
964;Delfinukas;Saulytės;8176576958;Ne;5;0;0;5
965;Delfinukas;Saulytės;8275943176;Ne;2;2;0;4
966;Delfinukas;Saulytės;8085530134;Taip;0;3;0;3
967;Delfinukas;Saulytės;8148610460;Ne;1;2;0;3
968;Delfinukas;Saulytės;8186312409;Ne;0;1;0;1
969;Delfinukas;Saulytės;1873630966;Ne;0;8;0;8
970;Delfinukas;Saulytės;1953356983;Ne;2;0;2;4
971;Delfinukas;Pelėdžiukų;8774145277;Ne;0;4;0;4
972;Delfinukas;Pelėdžiukų;6113662246;Ne;3;10;0;13
973;Delfinukas;Pelėdžiukų;1526129772;Taip;0;11;2;13
974;Delfinukas;Pelėdžiukų;8659309242;Ne;0;4;0;4
975;Delfinukas;Pelėdžiukų;8267992425;Ne;0;9;0;9
976;Delfinukas;Pelėdžiukų;9319874239;Taip;0;1;0;1
977;Delfinukas;Pelėdžiukų;4096274346;Taip;0;2;3;5
978;Delfinukas;Pelėdžiukų;5246300518;Taip;10;0;1;11
979;Delfinukas;Pelėdžiukų;2420308954;Ne;0;13;0;13
980;Delfinukas;Pelėdžiukų;6286748047;Ne;3;10;0;13
981;Delfinukas;Pelėdžiukų;4465504676;Taip;2;2;0;4
982;Delfinukas;Pelėdžiukų;6282501549;Ne;0;2;1;3
983;Delfinukas;Pelėdžiukų;6025384346;Ne;0;0;16;16
984;Delfinukas;Varliukų;4949220786;Ne;1;0;1;2
985;Delfinukas;Varliukų;2792051636;Taip;0;1;1;2
986;Delfinukas;Varliukų;3577180085;Ne;4;0;0;4
987;Delfinukas;Varliukų;7976681530;Ne;0;10;0;10
988;Delfinukas;Varliukų;4338259551;Ne;1;0;1;2
989;Delfinukas;Varliukų;5095713834;Taip;9;1;1;11
990;Delfinukas;Varliukų;5964021733;Ne;11;1;0;12
991;Delfinukas;Varliukų;5821591959;Ne;0;11;0;11
992;Delfinukas;Varliukų;9095895182;Ne;0;0;2;2
993;Delfinukas;Varliukų;5138840297;Ne;0;0;2;2
994;Delfinukas;Varliukų;7072060541;Ne;0;0;2;2
995;Delfinukas;Varliukų;3797355501;Ne;11;0;0;11
996;Delfinukas;Varliukų;4751611934;Taip;0;5;0;5
997;Delfinukas;Varliukų;4254414928;Taip;3;2;1;6
998;Delfinukas;Varliukų;7359531377;Ne;5;0;1;6
999;Delfinukas;Varpelių;8913681176;Ne;0;1;0;1
1000;Delfinukas;Varpelių;9514189769;Ne;0;1;0;1
1001;Delfinukas;Varpelių;1484123788;Ne;5;1;0;6
1002;Delfinukas;Varpelių;8950528288;Ne;5;0;0;5
1003;Delfinukas;Varpelių;9898427089;Ne;0;5;0;5
1004;Delfinukas;Varpelių;2730512600;Ne;4;2;0;6
1005;Delfinukas;Varpelių;8911433659;Ne;1;5;1;7
1006;Delfinukas;Varpelių;6952314149;Ne;0;18;1;19
1007;Delfinukas;Varpelių;3795705735;Ne;0;1;0;1
1008;Delfinukas;Varpelių;4101463768;Ne;3;0;0;3
1009;Delfinukas;Varpelių;5467211088;Ne;0;4;0;4
1010;Delfinukas;Varpelių;7780893730;Taip;4;1;0;5
1011;Delfinukas;Varpelių;6071660741;Ne;0;1;0;1
1012;Delfinukas;Drugeliai;7615519932;Taip;0;2;1;3
1013;Delfinukas;Drugeliai;6604115681;Ne;5;6;0;11
1014;Delfinukas;Drugeliai;5990192934;Ne;16;1;0;17
1015;Delfinukas;Drugeliai;9635669748;Ne;0;10;0;10
1016;Delfinukas;Drugeliai;8526813977;Ne;0;10;0;10
1017;Delfinukas;Drugeliai;6873181103;Ne;2;1;0;3
1018;Delfinukas;Drugeliai;4484804360;Ne;0;1;0;1
1019;Delfinukas;Drugeliai;8328481987;Ne;0;7;0;7
1020;Delfinukas;Drugeliai;6992505341;Ne;4;2;0;6
1021;Delfinukas;Drugeliai;8129592398;Ne;0;1;0;1
1022;Delfinukas;Drugeliai;2756574162;Ne;4;0;0;4
1023;Delfinukas;Drugeliai;2985669766;Ne;11;1;0;12
1024;Delfinukas;Drugeliai;6457042338;Taip;3;8;0;11
1025;Delfinukas;Drugeliai;3134897964;Taip;0;2;0;2
1026;Delfinukas;Drugeliai;8411289299;Ne;0;1;0;1
1027;Delfinukas;Drugeliai;2683746435;Ne;1;0;0;1
1028;Delfinukas;Žuvytės;4384995354;Ne;0;1;0;1
1029;Delfinukas;Žuvytės;1918878505;Ne;0;1;0;1
1030;Delfinukas;Žuvytės;1575125658;Taip;5;0;0;5
1031;Delfinukas;Žuvytės;7354837777;Ne;11;0;1;12
1032;Delfinukas;Žuvytės;8884939114;Ne;0;0;1;1
1033;Delfinukas;Žuvytės;6522639028;Ne;10;0;0;10
1034;Delfinukas;Žuvytės;1296440609;Ne;3;0;0;3
1035;Delfinukas;Žuvytės;5665463557;Ne;5;0;0;5
1036;Delfinukas;Žuvytės;9686085316;Ne;0;0;1;1
1037;Delfinukas;Žuvytės;5281161835;Ne;5;0;2;7
1038;Delfinukas;Žuvytės;2425621326;Ne;3;0;0;3
1039;Delfinukas;Žuvytės;4782384361;Ne;13;0;1;14
1040;Delfinukas;Žuvytės;6865463448;Taip;9;0;3;12
1041;Delfinukas;Žuvytės;9773069890;Ne;0;0;2;2
1042;Delfinukas;Žuvytės;5397241026;Ne;0;6;0;6
1043;Delfinukas;Delfinai;8038737019;Ne;0;1;0;1
1044;Delfinukas;Delfinai;5797308373;Ne;0;4;0;4
1045;Delfinukas;Delfinai;5241426445;Ne;3;0;0;3
1046;Delfinukas;Delfinai;8099120371;Ne;0;0;1;1
1047;Delfinukas;Delfinai;7663934825;Ne;0;1;0;1
1048;Delfinukas;Delfinai;2382077576;Ne;0;2;0;2
1049;Delfinukas;Delfinai;7629622746;Ne;0;1;0;1
1050;Delfinukas;Delfinai;1922513830;Taip;0;1;0;1
1051;Delfinukas;Delfinai;6270012707;Taip;0;8;0;8
1052;Delfinukas;Delfinai;8085481968;Ne;0;1;0;1
1053;Delfinukas;Delfinai;9605756229;Ne;0;5;0;5
1054;Delfinukas;Delfinai;3407321091;Ne;0;1;0;1
1055;Delfinukas;Delfinai;8415516743;Ne;0;0;2;2
1056;Delfinukas;Delfinai;4855210424;Ne;9;0;0;9
1057;Delfinukas;Delfinai;3465399369;Ne;0;1;0;1
1058;Delfinukas;Delfinai;2890469172;Ne;4;0;2;6
1059;Delfinukas;Paukšteliai;7366145460;Ne;9;2;0;11
1060;Delfinukas;Paukšteliai;1164720538;Ne;0;5;0;5
1061;Delfinukas;Paukšteliai;9351906710;Ne;0;1;0;1
1062;Delfinukas;Paukšteliai;9332794060;Ne;5;0;0;5
1063;Delfinukas;Paukšteliai;6650725760;Ne;15;1;1;17
1064;Delfinukas;Paukšteliai;9776618488;Taip;9;1;0;10
1065;Delfinukas;Paukšteliai;4561911078;Ne;13;0;0;13
1066;Delfinukas;Paukšteliai;9289866851;Ne;18;0;2;20
1067;Delfinukas;Paukšteliai;1746566943;Taip;3;0;0;3
1068;Delfinukas;Paukšteliai;9073634575;Ne;7;0;0;7
1069;Delfinukas;Paukšteliai;2186801708;Ne;12;5;0;17
1070;Delfinukas;Paukšteliai;6055420223;Ne;10;0;0;10
1071;Delfinukas;Kiškučiai;5585334518;Taip;4;0;0;4
1072;Delfinukas;Kiškučiai;4196156707;Ne;0;1;0;1
1073;Delfinukas;Kiškučiai;5443027988;Taip;0;10;0;10
1074;Delfinukas;Kiškučiai;6301767635;Ne;0;5;0;5
1075;Delfinukas;Kiškučiai;9184207705;Ne;0;1;0;1
1076;Delfinukas;Kiškučiai;2163238846;Ne;5;1;0;6
1077;Delfinukas;Kiškučiai;4327924499;Ne;12;0;0;12
1078;Delfinukas;Kiškučiai;7312438969;Taip;2;0;0;2
1079;Delfinukas;Kiškučiai;6693756145;Ne;0;6;0;6
1080;Delfinukas;Kiškučiai;3205671100;Taip;0;1;0;1
1081;Delfinukas;Kiškučiai;4755699845;Ne;1;2;0;3
1082;Delfinukas;Kiškučiai;5164599763;Taip;6;0;0;6
1083;Delfinukas;Kiškučiai;9586646352;Taip;3;0;0;3
1084;Delfinukas;Kiškučiai;3487670354;Ne;1;0;0;1
1085;Delfinukas;BITUTĖS;9719348837;Ne;5;7;0;12
1086;Delfinukas;BITUTĖS;6601922746;Ne;0;5;0;5
1087;Delfinukas;BITUTĖS;8896957908;Taip;2;0;2;4
1088;Delfinukas;BITUTĖS;3239635507;Ne;0;1;0;1
1089;Delfinukas;BITUTĖS;5339993544;Taip;0;1;0;1
1090;Delfinukas;BITUTĖS;6929926768;Ne;5;0;0;5
1091;Delfinukas;BITUTĖS;8937594052;Ne;1;0;0;1
1092;Delfinukas;BITUTĖS;5179080544;Taip;0;11;0;11
1093;Delfinukas;BITUTĖS;7727263761;Ne;0;7;0;7
1094;Delfinukas;BITUTĖS;9941631164;Ne;0;7;0;7
1095;Delfinukas;BITUTĖS;8081895401;Ne;5;0;0;5
1096;Delfinukas;BITUTĖS;5600320855;Ne;5;7;0;12
1097;Delfinukas;BITUTĖS;9195828884;Ne;0;0;1;1
1098;Delfinukas;BITUTĖS;8552371520;Ne;0;5;0;5
1099;Delfinukas;BITUTĖS;2377204734;Ne;0;2;0;2
1100;Delfinukas;BITUTĖS;6243471374;Ne;5;5;0;10
1101;Delfinukas;BITUTĖS;4303234827;Ne;5;2;0;7
1102;Delfinukas;BITUTĖS;6325092903;Ne;4;1;0;5
1103;Drevinukas;ZUIKUČIAI;9817317105;Ne;0;0;5;5
1104;Drevinukas;ZUIKUČIAI;1595081335;Ne;6;0;5;11
1105;Drevinukas;ZUIKUČIAI;2646799484;Ne;0;3;6;9
1106;Drevinukas;ZUIKUČIAI;2772424629;Ne;6;0;3;9
1107;Drevinukas;ZUIKUČIAI;5928234487;Ne;0;0;3;3
1108;Drevinukas;ZUIKUČIAI;8873060121;Ne;0;0;2;2
1109;Drevinukas;ZUIKUČIAI;1567790084;Ne;0;0;1;1
1110;Drevinukas;ZUIKUČIAI;3293457412;Ne;0;0;2;2
1111;Drevinukas;ZUIKUČIAI;6243097297;Ne;5;0;6;11
1112;Drevinukas;ZUIKUČIAI;5704489483;Ne;0;7;3;10
1113;Drevinukas;ZUIKUČIAI;7054681115;Ne;0;0;1;1
1114;Drevinukas;ZUIKUČIAI;3381363132;Ne;16;0;1;17
1115;Drevinukas;ZUIKUČIAI;6462582301;Ne;5;5;0;10
1116;Drevinukas;ZUIKUČIAI;3070518153;Ne;0;0;11;11
1117;Drevinukas;ZUIKUČIAI;9174977150;Ne;7;0;0;7
1118;Drevinukas;ZUIKUČIAI;4243045398;Ne;0;0;17;17
1119;Drevinukas;ZUIKUČIAI;4309475233;Ne;0;0;17;17
1120;Drevinukas;ZUIKUČIAI;6393960467;Ne;0;5;0;5
1121;Drevinukas;ZUIKUČIAI;5578749226;Ne;11;0;3;14
1122;Drevinukas;AŽUOLIUKŲ;1644656704;Ne;0;0;1;1
1123;Drevinukas;AŽUOLIUKŲ;5721031754;Ne;0;0;6;6
1124;Drevinukas;AŽUOLIUKŲ;4714478955;Ne;0;0;1;1
1125;Drevinukas;AŽUOLIUKŲ;8701250912;Ne;0;0;1;1
1126;Drevinukas;AŽUOLIUKŲ;8143614891;Ne;5;2;0;7
1127;Drevinukas;AŽUOLIUKŲ;5673244101;Ne;4;1;1;6
1128;Drevinukas;AŽUOLIUKŲ;3643007998;Ne;3;0;3;6
1129;Drevinukas;AŽUOLIUKŲ;4262951360;Ne;6;10;0;16
1130;Drevinukas;AŽUOLIUKŲ;7689145214;Ne;0;1;5;6
1131;Drevinukas;AŽUOLIUKŲ;4572837478;Ne;15;5;0;20
1132;Drevinukas;AŽUOLIUKŲ;1564065835;Ne;0;0;7;7
1133;Drevinukas;AŽUOLIUKŲ;9289471118;Ne;0;0;3;3
1134;Drevinukas;AŽUOLIUKŲ;9915130747;Ne;5;0;2;7
1135;Drevinukas;AŽUOLIUKŲ;1058927778;Ne;0;1;0;1
1136;Drevinukas;AŽUOLIUKŲ;9534007163;Ne;11;0;4;15
1137;Drevinukas;AŽUOLIUKŲ;2300338724;Ne;0;2;2;4
1138;Drevinukas;AŽUOLIUKŲ;3725760478;Ne;2;0;1;3
1139;Drevinukas;AŽUOLIUKŲ;6165662595;Ne;0;0;8;8
1140;Drevinukas;AŽUOLIUKŲ;2740093399;Ne;2;1;0;3
1141;Drevinukas;PELĖDŽIUKAI;3032536983;Ne;3;0;0;3
1142;Drevinukas;PELĖDŽIUKAI;3392249574;Ne;2;0;2;4
1143;Drevinukas;PELĖDŽIUKAI;5524567803;Ne;5;0;2;7
1144;Drevinukas;PELĖDŽIUKAI;9016985238;Ne;3;0;1;4
1145;Drevinukas;PELĖDŽIUKAI;2929598743;Ne;8;1;0;9
1146;Drevinukas;PELĖDŽIUKAI;4076576850;Ne;8;0;0;8
1147;Drevinukas;PELĖDŽIUKAI;6373230526;Ne;2;2;0;4
1148;Drevinukas;PELĖDŽIUKAI;7642022439;Ne;0;1;0;1
1149;Drevinukas;PELĖDŽIUKAI;6316000019;Taip;2;0;0;2
1150;Drevinukas;PELĖDŽIUKAI;4404254932;Ne;0;0;1;1
1151;Drevinukas;PELĖDŽIUKAI;2378493422;Ne;1;0;1;2
1152;Drevinukas;PELĖDŽIUKAI;1859208322;Ne;10;0;2;12
1153;Drevinukas;PELĖDŽIUKAI;8984653958;Ne;0;1;0;1
1154;Drevinukas;PELĖDŽIUKAI;5620887702;Ne;2;0;1;3
1155;Drevinukas;PELĖDŽIUKAI;2281463885;Ne;0;0;1;1
1156;Drevinukas;PELĖDŽIUKAI;5875459639;Ne;0;6;0;6
1157;Drevinukas;PELĖDŽIUKAI;6582186497;Ne;5;0;2;7
1158;Drevinukas;PELĖDŽIUKAI;7218201733;Ne;0;1;0;1
1159;Drevinukas;BORUŽĖLĖS;4242944055;Ne;4;1;0;5
1160;Drevinukas;BORUŽĖLĖS;6492987985;Ne;2;0;0;2
1161;Drevinukas;BORUŽĖLĖS;6645506336;Ne;12;3;0;15
1162;Drevinukas;BORUŽĖLĖS;9845207619;Ne;3;0;3;6
1163;Drevinukas;BORUŽĖLĖS;9517560132;Ne;15;0;0;15
1164;Drevinukas;BORUŽĖLĖS;6895472558;Ne;3;0;1;4
1165;Drevinukas;BORUŽĖLĖS;4147987057;Ne;7;1;0;8
1166;Drevinukas;BORUŽĖLĖS;9695419813;Ne;1;2;1;4
1167;Drevinukas;BORUŽĖLĖS;8694887879;Ne;0;7;0;7
1168;Drevinukas;BORUŽĖLĖS;3192583690;Ne;5;0;0;5
1169;Drevinukas;BORUŽĖLĖS;6659263391;Ne;5;0;0;5
1170;Drevinukas;BORUŽĖLĖS;8719022482;Taip;0;0;1;1
1171;Drevinukas;BORUŽĖLĖS;5860361695;Ne;5;0;1;6
1172;Drevinukas;BORUŽĖLĖS;5999370094;Ne;0;11;0;11
1173;Drevinukas;BORUŽĖLĖS;4588368596;Ne;3;10;3;16
1174;Drevinukas;BORUŽĖLĖS;2571295179;Taip;2;2;3;7
1175;Drevinukas;BORUŽĖLĖS;2820241608;Ne;2;2;0;4
1176;Drevinukas;BORUŽĖLĖS;8940838262;Ne;0;1;1;2
1177;Drevinukas;BORUŽĖLĖS;3240313747;Ne;0;5;0;5
1178;Drevinukas;BORUŽĖLĖS;2179736991;Ne;7;0;0;7
1179;Drevinukas;BITUTĖS;5348609358;Ne;0;0;1;1
1180;Drevinukas;BITUTĖS;1098647410;Ne;1;0;1;2
1181;Drevinukas;BITUTĖS;2312241894;Ne;6;0;1;7
1182;Drevinukas;BITUTĖS;5394143000;Ne;0;0;1;1
1183;Drevinukas;BITUTĖS;3871506691;Ne;5;0;1;6
1184;Drevinukas;BITUTĖS;6914111231;Ne;5;0;1;6
1185;Drevinukas;BITUTĖS;3377957769;Ne;2;0;0;2
1186;Drevinukas;BITUTĖS;2423143170;Ne;3;0;1;4
1187;Drevinukas;BITUTĖS;1343431478;Ne;0;0;4;4
1188;Drevinukas;BITUTĖS;1829421385;Ne;2;0;2;4
1189;Drevinukas;BITUTĖS;8262224710;Ne;0;1;1;2
1190;Drevinukas;BITUTĖS;4203106313;Ne;2;0;0;2
1191;Drevinukas;BITUTĖS;9513405583;Ne;2;0;1;3
1192;Drevinukas;BITUTĖS;5959004452;Ne;3;0;0;3
1193;Drevinukas;BITUTĖS;8896207423;Ne;0;0;1;1
1194;Drevinukas;BITUTĖS;4662426451;Ne;0;0;3;3
1195;Drevinukas;BITUTĖS;5236292764;Ne;0;0;1;1
1196;Drevinukas;BITUTĖS;3617533357;Ne;3;0;0;3
1197;Drevinukas;BITUTĖS;4134729710;Ne;11;0;0;11
1198;Drevinukas;NYKŠTUKAI;9105675010;Ne;3;0;0;3
1199;Drevinukas;NYKŠTUKAI;8578579808;Ne;9;0;1;10
1200;Drevinukas;NYKŠTUKAI;3611870655;Ne;2;0;0;2
1201;Drevinukas;NYKŠTUKAI;1094428951;Ne;2;0;1;3
1202;Drevinukas;NYKŠTUKAI;9283862598;Ne;10;0;0;10
1203;Drevinukas;NYKŠTUKAI;2201342382;Taip;5;0;1;6
1204;Drevinukas;NYKŠTUKAI;4759293403;Ne;12;0;1;13
1205;Drevinukas;NYKŠTUKAI;9004568476;Ne;9;0;0;9
1206;Drevinukas;NYKŠTUKAI;9715586195;Ne;0;0;1;1
1207;Drevinukas;NYKŠTUKAI;1368495173;Ne;5;5;1;11
1208;Drevinukas;NYKŠTUKAI;8284025903;Ne;0;7;0;7
1209;Drevinukas;NYKŠTUKAI;8654858364;Ne;5;0;1;6
1210;Drevinukas;NYKŠTUKAI;7801920518;Ne;15;0;2;17
1211;Drevinukas;NYKŠTUKAI;1570356979;Ne;7;0;1;8
1212;Drevinukas;NYKŠTUKAI;9123131368;Ne;0;5;0;5
1213;Drevinukas;NYKŠTUKAI;8877080179;Ne;6;0;0;6
1214;Drevinukas;NYKŠTUKAI;6492711565;Taip;3;0;0;3
1215;Drevinukas;NYKŠTUKAI;7316996793;Ne;1;7;0;8
1216;Drevinukas;NYKŠTUKAI;3408981880;Ne;0;0;3;3
1217;Drevinukas;NYKŠTUKAI;8953871512;Ne;10;0;3;13
1218;Drevinukas;NYKŠTUKAI;3983656958;Ne;5;0;1;6
1219;Drevinukas;SMALSUČIAI;7241671439;Ne;8;0;0;8
1220;Drevinukas;SMALSUČIAI;2246885419;Ne;10;1;0;11
1221;Drevinukas;SMALSUČIAI;4089351543;Taip;3;0;0;3
1222;Drevinukas;SMALSUČIAI;7863529560;Ne;3;0;0;3
1223;Drevinukas;SMALSUČIAI;8107900397;Ne;3;0;0;3
1224;Drevinukas;SMALSUČIAI;1757626792;Ne;3;0;0;3
1225;Drevinukas;SMALSUČIAI;5666172450;Ne;5;0;0;5
1226;Drevinukas;SMALSUČIAI;2926566478;Ne;1;0;0;1
1227;Drevinukas;SMALSUČIAI;1478224813;Ne;6;0;0;6
1228;Drevinukas;SMALSUČIAI;9707576704;Ne;3;0;0;3
1229;Drevinukas;SMALSUČIAI;2971775004;Ne;2;0;0;2
1230;Drevinukas;SMALSUČIAI;7466516412;Ne;5;0;0;5
1231;Drevinukas;SMALSUČIAI;2888797405;Ne;4;0;0;4
1232;Drevinukas;SMALSUČIAI;5614413092;Ne;6;0;0;6
1233;Drevinukas;ŽVIRBLIUKAI;5702650036;Ne;0;5;0;5
1234;Drevinukas;ŽVIRBLIUKAI;5928679046;Ne;0;5;1;6
1235;Drevinukas;ŽVIRBLIUKAI;5785185025;Ne;6;0;1;7
1236;Drevinukas;ŽVIRBLIUKAI;8482376948;Ne;5;0;0;5
1237;Drevinukas;ŽVIRBLIUKAI;7970286765;Ne;6;0;0;6
1238;Drevinukas;ŽVIRBLIUKAI;3598394850;Ne;7;0;0;7
1239;Drevinukas;ŽVIRBLIUKAI;5536448847;Ne;6;0;2;8
1240;Drevinukas;ŽVIRBLIUKAI;1471647820;Ne;5;0;0;5
1241;Drevinukas;ŽVIRBLIUKAI;7600838895;Ne;5;0;0;5
1242;Drevinukas;ŽVIRBLIUKAI;4371848878;Ne;0;0;2;2
1243;Drugelis;NYKŠTUKŲ;9316073597;Ne;0;2;0;2
1244;Drugelis;NYKŠTUKŲ;3551095669;Ne;0;1;0;1
1245;Drugelis;NYKŠTUKŲ;1785724340;Ne;0;4;0;4
1246;Drugelis;NYKŠTUKŲ;7447519502;Ne;0;1;0;1
1247;Drugelis;NYKŠTUKŲ;4523513611;Ne;3;0;0;3
1248;Drugelis;NYKŠTUKŲ;6594452094;Ne;5;0;0;5
1249;Drugelis;NYKŠTUKŲ;4825232236;Ne;0;1;0;1
1250;Drugelis;NYKŠTUKŲ;8717445483;Ne;3;2;0;5
1251;Drugelis;NYKŠTUKŲ;4471405682;Ne;4;6;0;10
1252;Drugelis;NYKŠTUKŲ;4867387611;Ne;0;4;0;4
1253;Drugelis;NYKŠTUKŲ;7609530453;Ne;0;1;0;1
1254;Drugelis;NYKŠTUKŲ;8070030439;Ne;0;1;0;1
1255;Drugelis;NYKŠTUKŲ;3061896520;Ne;0;1;0;1
1256;Drugelis;NYKŠTUKŲ;5692743298;Ne;0;5;0;5
1257;Drugelis;NYKŠTUKŲ;6452921695;Taip;0;11;0;11
1258;Drugelis;NYKŠTUKŲ;6390802189;Taip;6;0;0;6
1259;Drugelis;NYKŠTUKŲ;4321420201;Ne;6;0;0;6
1260;Drugelis;SMALSUČIŲ;5121351234;Ne;13;1;0;14
1261;Drugelis;SMALSUČIŲ;6626437352;Taip;0;5;0;5
1262;Drugelis;SMALSUČIŲ;5000965458;Ne;3;14;0;17
1263;Drugelis;SMALSUČIŲ;9683350741;Ne;6;4;0;10
1264;Drugelis;SMALSUČIŲ;4058293462;Ne;0;10;0;10
1265;Drugelis;SMALSUČIŲ;4805858183;Ne;1;2;0;3
1266;Drugelis;SMALSUČIŲ;9650052415;Ne;1;0;0;1
1267;Drugelis;SMALSUČIŲ;5533529267;Ne;0;7;0;7
1268;Drugelis;SMALSUČIŲ;3733097479;Ne;4;0;0;4
1269;Drugelis;SMALSUČIŲ;9066572677;Ne;8;0;0;8
1270;Drugelis;SMALSUČIŲ;2196445523;Ne;6;1;0;7
1271;Drugelis;SMALSUČIŲ;3645668411;Ne;6;0;0;6
1272;Drugelis;SMALSUČIŲ;3261462674;Ne;6;0;0;6
1273;Drugelis;SMALSUČIŲ;2644563881;Ne;9;0;0;9
1274;Drugelis;SMALSUČIŲ;6890441262;Ne;8;1;0;9
1275;Drugelis;SMALSUČIŲ;1417298801;Ne;5;0;1;6
1276;Drugelis;MUMINUKŲ;7390061272;Ne;4;0;1;5
1277;Drugelis;MUMINUKŲ;3311620018;Ne;0;0;1;1
1278;Drugelis;MUMINUKŲ;8812550811;Ne;0;1;0;1
1279;Drugelis;MUMINUKŲ;5661335344;Ne;0;12;0;12
1280;Drugelis;MUMINUKŲ;1816845006;Ne;3;7;0;10
1281;Drugelis;MUMINUKŲ;1666992752;Ne;0;0;1;1
1282;Drugelis;MUMINUKŲ;9510744779;Ne;0;1;0;1
1283;Drugelis;MUMINUKŲ;9907121223;Ne;0;9;0;9
1284;Drugelis;MUMINUKŲ;1858504360;Ne;0;1;0;1
1285;Drugelis;MUMINUKŲ;5515894973;Ne;0;1;0;1
1286;Drugelis;MUMINUKŲ;8282807535;Ne;2;0;1;3
1287;Drugelis;MUMINUKŲ;3293212749;Ne;0;1;0;1
1288;Drugelis;MUMINUKŲ;9588931333;Ne;7;0;0;7
1289;Drugelis;MUMINUKŲ;3176174057;Taip;0;2;0;2
1290;Drugelis;MUMINUKŲ;1761596625;Ne;5;2;0;7
1291;Drugelis;PŪKUOTUKAI;3560294703;Ne;0;0;1;1
1292;Drugelis;PŪKUOTUKAI;1215586620;Ne;5;0;1;6
1293;Drugelis;PŪKUOTUKAI;9005448398;Ne;3;1;0;4
1294;Drugelis;PŪKUOTUKAI;2926662708;Taip;0;5;0;5
1295;Drugelis;PŪKUOTUKAI;6504082488;Ne;0;3;0;3
1296;Drugelis;PŪKUOTUKAI;7321544601;Ne;9;7;0;16
1297;Drugelis;PŪKUOTUKAI;9296067137;Ne;0;10;0;10
1298;Drugelis;PŪKUOTUKAI;9855121078;Ne;6;2;0;8
1299;Drugelis;PŪKUOTUKAI;6068102133;Ne;9;3;0;12
1300;Drugelis;PŪKUOTUKAI;7825151440;Ne;4;0;0;4
1301;Drugelis;PŪKUOTUKAI;4812322553;Ne;5;2;0;7
1302;Drugelis;PŪKUOTUKAI;3081918342;Ne;7;0;0;7
1303;Drugelis;PŪKUOTUKAI;6032568621;Ne;3;1;0;4
1304;Drugelis;PŪKUOTUKAI;4580456500;Ne;10;8;0;18
1305;Drugelis;PŪKUOTUKAI;8259051898;Ne;0;2;2;4
1306;Drugelis;PŪKUOTUKAI;2573357635;Ne;0;0;1;1
1307;Drugelis;PŪKUOTUKAI;3567930528;Ne;2;2;0;4
1308;Drugelis;SPINDULIUKAI;7775085427;Ne;1;10;0;11
1309;Drugelis;SPINDULIUKAI;2456724368;Ne;1;1;1;3
1310;Drugelis;SPINDULIUKAI;5538435916;Ne;4;0;1;5
1311;Drugelis;SPINDULIUKAI;3473680112;Ne;5;0;2;7
1312;Drugelis;SPINDULIUKAI;8438128438;Ne;0;1;3;4
1313;Drugelis;SPINDULIUKAI;9226673535;Ne;6;0;0;6
1314;Drugelis;SPINDULIUKAI;5773336517;Ne;17;1;0;18
1315;Drugelis;SPINDULIUKAI;5276647563;Ne;1;0;1;2
1316;Drugelis;SPINDULIUKAI;3883341684;Ne;0;0;7;7
1317;Drugelis;SPINDULIUKAI;9908380623;Taip;6;0;3;9
1318;Drugelis;KIŠKUČIAI;3603051567;Ne;0;0;1;1
1319;Drugelis;KIŠKUČIAI;4628926113;Ne;5;2;0;7
1320;Drugelis;KIŠKUČIAI;7307032077;Ne;0;1;0;1
1321;Drugelis;KIŠKUČIAI;4871624566;Ne;0;11;0;11
1322;Drugelis;KIŠKUČIAI;1213610973;Taip;8;1;0;9
1323;Drugelis;KIŠKUČIAI;9211760307;Ne;0;4;0;4
1324;Drugelis;KIŠKUČIAI;6071997970;Ne;7;3;0;10
1325;Drugelis;KIŠKUČIAI;8819853863;Ne;5;0;0;5
1326;Drugelis;KIŠKUČIAI;9900296726;Ne;6;3;0;9
1327;Drugelis;KIŠKUČIAI;6997707085;Ne;0;2;1;3
1328;Drugelis;KIŠKUČIAI;1375535260;Ne;0;0;2;2
1329;Drugelis;KIŠKUČIAI;5857726963;Ne;6;0;0;6
1330;Drugelis;KIŠKUČIAI;1817932444;Ne;0;16;0;16
1331;Drugelis;KIŠKUČIAI;8891228382;Ne;2;0;0;2
1332;Drugelis;KIŠKUČIAI;1074913909;Ne;6;0;1;7
1333;Drugelis;KIŠKUČIAI;2729246397;Taip;17;0;1;18
1334;Drugelis;PŪKUOTUKAI;1808917187;Ne;1;0;2;3
1335;Drugelis;PŪKUOTUKAI;5995208093;Ne;10;0;0;10
1336;Drugelis;PŪKUOTUKAI;6965297550;Ne;3;1;1;5
1337;Drugelis;PŪKUOTUKAI;3800496237;Ne;15;0;0;15
1338;Drugelis;PŪKUOTUKAI;5557284298;Taip;0;9;1;10
1339;"Du gaideliai";Uodelių;8624394105;Ne;5;5;0;10
1340;"Du gaideliai";Uodelių;9506572113;Taip;0;8;0;8
1341;"Du gaideliai";Uodelių;6224116229;Ne;0;1;3;4
1342;"Du gaideliai";Uodelių;5514521078;Ne;0;3;0;3
1343;"Du gaideliai";Uodelių;6630053388;Taip;5;0;0;5
1344;"Du gaideliai";Uodelių;3654057453;Taip;2;1;1;4
1345;"Du gaideliai";Uodelių;8921985681;Ne;16;0;3;19
1346;"Du gaideliai";Uodelių;5225949099;Ne;0;1;0;1
1347;"Du gaideliai";Uodelių;2122841302;Taip;10;0;1;11
1348;"Du gaideliai";Uodelių;3206388799;Taip;0;0;1;1
1349;"Du gaideliai";Uodelių;2084660815;Ne;0;2;0;2
1350;"Du gaideliai";Uodelių;7153424410;Ne;0;2;0;2
1351;"Du gaideliai";Uodelių;4799107717;Ne;0;1;1;2
1352;"Du gaideliai";Uodelių;1940981083;Taip;21;0;0;21
1353;"Du gaideliai";Uodelių;5113352673;Ne;0;1;0;1
1354;"Du gaideliai";Uodelių;6054058539;Taip;0;4;0;4
1355;"Du gaideliai";Uodelių;5016914497;Ne;5;0;5;10
1356;"Du gaideliai";Uodelių;4759244471;Ne;1;0;1;2
1357;"Du gaideliai";OŽIUKŲ;6942798420;Ne;0;5;0;5
1358;"Du gaideliai";OŽIUKŲ;8174023197;Ne;0;1;3;4
1359;"Du gaideliai";OŽIUKŲ;8420400705;Ne;0;10;2;12
1360;"Du gaideliai";OŽIUKŲ;7372149799;Ne;0;6;0;6
1361;"Du gaideliai";OŽIUKŲ;2826490663;Ne;0;0;3;3
1362;"Du gaideliai";OŽIUKŲ;4157021754;Ne;3;0;4;7
1363;"Du gaideliai";OŽIUKŲ;1968978650;Ne;2;0;2;4
1364;"Du gaideliai";OŽIUKŲ;5291934919;Ne;7;3;0;10
1365;"Du gaideliai";OŽIUKŲ;2564259600;Ne;4;0;1;5
1366;"Du gaideliai";OŽIUKŲ;6132405512;Ne;0;0;15;15
1367;"Du gaideliai";OŽIUKŲ;2756525592;Ne;0;1;0;1
1368;"Du gaideliai";OŽIUKŲ;7563789811;Ne;3;1;2;6
1369;"Du gaideliai";OŽIUKŲ;6704167983;Ne;10;8;1;19
1370;"Du gaideliai";OŽIUKŲ;9126780620;Ne;0;1;3;4
1371;"Du gaideliai";OŽIUKŲ;9374869616;Ne;1;1;0;2
1372;"Du gaideliai";OŽIUKŲ;5726096980;Ne;0;3;2;5
1373;"Du gaideliai";OŽIUKŲ;4408537397;Ne;0;4;0;4
1374;"Du gaideliai";OŽIUKŲ;1527839162;Ne;0;1;4;5
1375;"Du gaideliai";OŽIUKŲ;5809089345;Ne;0;0;5;5
1376;"Du gaideliai";OŽIUKŲ;5867716168;Ne;0;0;11;11
1377;"Du gaideliai";OŽIUKŲ;1882241729;Taip;3;0;0;3
1378;"Du gaideliai";OŽIUKŲ;2616106413;Ne;10;5;4;19
1379;"Du gaideliai";OŽIUKŲ;9934568135;Ne;0;18;0;18
1380;"Du gaideliai";Vištyčių;2100449108;Ne;0;0;1;1
1381;"Du gaideliai";Vištyčių;7033276798;Ne;0;0;2;2
1382;"Du gaideliai";Vištyčių;8744467866;Ne;0;0;1;1
1383;"Du gaideliai";Vištyčių;3019797369;Ne;0;0;1;1
1384;"Du gaideliai";Vištyčių;6204233540;Ne;3;0;0;3
1385;"Du gaideliai";Vištyčių;2845145754;Ne;0;0;3;3
1386;"Du gaideliai";Vištyčių;7726490359;Ne;15;0;1;16
1387;"Du gaideliai";Vištyčių;5788923258;Ne;0;9;0;9
1388;"Du gaideliai";Vištyčių;5611102395;Ne;0;8;0;8
1389;"Du gaideliai";Vištyčių;8410547195;Ne;0;2;0;2
1390;"Du gaideliai";Vištyčių;6120647567;Ne;4;4;0;8
1391;"Du gaideliai";Vištyčių;2905083899;Taip;0;5;1;6
1392;"Du gaideliai";Vištyčių;9585785202;Taip;0;0;1;1
1393;"Du gaideliai";Vištyčių;2151825222;Ne;0;4;0;4
1394;"Du gaideliai";Vištyčių;8043896286;Ne;10;1;0;11
1395;"Du gaideliai";GAIDŽIUKŲ;2635903222;Ne;9;0;2;11
1396;"Du gaideliai";GAIDŽIUKŲ;7537924142;Ne;0;0;1;1
1397;"Du gaideliai";GAIDŽIUKŲ;2240947701;Ne;6;0;0;6
1398;"Du gaideliai";GAIDŽIUKŲ;3507387826;Ne;0;7;0;7
1399;"Du gaideliai";GAIDŽIUKŲ;4144269068;Ne;9;1;0;10
1400;"Du gaideliai";GAIDŽIUKŲ;8047413507;Ne;7;1;0;8
1401;"Du gaideliai";GAIDŽIUKŲ;9568647033;Ne;7;0;0;7
1402;"Du gaideliai";GAIDŽIUKŲ;5894974508;Ne;0;1;0;1
1403;"Du gaideliai";GAIDŽIUKŲ;6247706405;Ne;12;0;1;13
1404;"Du gaideliai";GAIDŽIUKŲ;1135098595;Ne;0;5;0;5
1405;"Du gaideliai";GAIDŽIUKŲ;3370029981;Ne;0;2;0;2
1406;"Du gaideliai";GAIDŽIUKŲ;1751328192;Ne;0;1;0;1
1407;"Du gaideliai";GAIDŽIUKŲ;6870356241;Ne;5;1;0;6
1408;"Du gaideliai";GAIDŽIUKŲ;5103483956;Ne;0;1;0;1
1409;"Du gaideliai";GAIDŽIUKŲ;3854355215;Ne;6;0;3;9
1410;"Du gaideliai";GAIDŽIUKŲ;3849899284;Ne;10;1;0;11
1411;"Du gaideliai";Musyčių;8819197022;Ne;7;1;0;8
1412;"Du gaideliai";Musyčių;6826558709;Ne;10;1;0;11
1413;"Du gaideliai";Musyčių;7556954721;Ne;1;0;1;2
1414;"Du gaideliai";Musyčių;3601150560;Ne;0;1;0;1
1415;"Du gaideliai";Musyčių;9561040908;Ne;0;1;0;1
1416;"Du gaideliai";Musyčių;9477645505;Ne;3;7;1;11
1417;"Du gaideliai";Musyčių;7855653537;Ne;0;1;0;1
1418;"Du gaideliai";Musyčių;9619723983;Ne;0;1;0;1
1419;"Du gaideliai";Musyčių;1048130675;Taip;5;5;0;10
1420;"Du gaideliai";MALŪNO;3457511180;Ne;0;3;1;4
1421;"Du gaideliai";MALŪNO;1706627632;Ne;6;9;0;15
1422;"Du gaideliai";MALŪNO;4995471264;Ne;14;0;0;14
1423;"Du gaideliai";MALŪNO;2135080469;Ne;1;0;1;2
1424;"Du gaideliai";MALŪNO;9289309829;Ne;0;1;1;2
1425;"Du gaideliai";MALŪNO;1025181286;Ne;0;1;1;2
1426;"Du gaideliai";MALŪNO;5028947424;Ne;0;0;3;3
1427;"Du gaideliai";MALŪNO;2613120460;Ne;3;0;0;3
1428;"Du gaideliai";MALŪNO;3469559577;Ne;6;0;1;7
1429;"Du gaideliai";MALŪNO;8197231934;Ne;6;0;0;6
1430;"Du gaideliai";MALŪNO;2261152926;Ne;7;0;1;8
1431;"Du gaideliai";MALŪNO;4792733524;Ne;5;0;0;5
1432;Eglutė;RAMUNĖ;6009794480;Ne;0;8;0;8
1433;Eglutė;RAMUNĖ;4252256130;Ne;0;0;1;1
1434;Eglutė;RAMUNĖ;7234851379;Ne;5;0;1;6
1435;Eglutė;RAMUNĖ;5636437290;Ne;0;0;1;1
1436;Eglutė;RAMUNĖ;5190045146;Ne;0;1;0;1
1437;Eglutė;RAMUNĖ;3985929379;Ne;0;4;0;4
1438;Eglutė;RAMUNĖ;1842517164;Ne;0;10;0;10
1439;Eglutė;RAMUNĖ;7703290039;Ne;0;3;0;3
1440;Eglutė;RAMUNĖ;7530638623;Ne;0;12;0;12
1441;Eglutė;RAMUNĖ;2357276888;Ne;0;0;3;3
1442;Eglutė;RAMUNĖ;2816913563;Taip;0;0;1;1
1443;Eglutė;RAMUNĖ;7811667336;Ne;2;0;0;2
1444;Eglutė;RAMUNĖ;6146679388;Ne;0;12;0;12
1445;Eglutė;RAMUNĖ;5166183300;Ne;0;6;0;6
1446;Eglutė;PELĖDŽIUKAI;3883122650;Ne;8;0;0;8
1447;Eglutė;PELĖDŽIUKAI;7859815752;Ne;0;7;2;9
1448;Eglutė;PELĖDŽIUKAI;4176597208;Ne;0;2;1;3
1449;Eglutė;PELĖDŽIUKAI;7758643349;Ne;0;1;0;1
1450;Eglutė;PELĖDŽIUKAI;6483580751;Ne;0;1;0;1
1451;Eglutė;PELĖDŽIUKAI;4490295754;Ne;0;4;0;4
1452;Eglutė;PELĖDŽIUKAI;5924994736;Ne;0;4;0;4
1453;Eglutė;PELĖDŽIUKAI;1759383841;Taip;0;1;0;1
1454;Eglutė;PELĖDŽIUKAI;6597261061;Ne;0;1;0;1
1455;Eglutė;PELĖDŽIUKAI;9046652370;Ne;3;5;0;8
1456;Eglutė;PELĖDŽIUKAI;9356785605;Ne;0;1;0;1
1457;Eglutė;PELĖDŽIUKAI;8943684351;Ne;5;0;0;5
1458;Eglutė;PELĖDŽIUKAI;1932785408;Ne;0;0;4;4
1459;Eglutė;PELĖDŽIUKAI;8165126017;Ne;0;5;0;5
1460;Eglutė;PELĖDŽIUKAI;3584247594;Ne;1;2;0;3
1461;Eglutė;PELĖDŽIUKAI;5678727198;Ne;0;0;6;6
1462;Eglutė;PELĖDŽIUKAI;1835565594;Ne;0;5;0;5
1463;Eglutė;KODĖLČIUKAI;7831541089;Ne;11;1;0;12
1464;Eglutė;KODĖLČIUKAI;7735192219;Ne;0;8;0;8
1465;Eglutė;KODĖLČIUKAI;3430016771;Ne;19;0;0;19
1466;Eglutė;KODĖLČIUKAI;6382927775;Ne;1;9;0;10
1467;Eglutė;KODĖLČIUKAI;7919553451;Ne;0;2;0;2
1468;Eglutė;KODĖLČIUKAI;7658345479;Ne;5;0;0;5
1469;Eglutė;KODĖLČIUKAI;7229612001;Ne;1;0;2;3
1470;Eglutė;KODĖLČIUKAI;5779671024;Taip;0;0;4;4
1471;Eglutė;KODĖLČIUKAI;5783776734;Ne;0;6;0;6
1472;Eglutė;KODĖLČIUKAI;4932945207;Ne;21;0;0;21
1473;Eglutė;KODĖLČIUKAI;4490541539;Ne;4;0;0;4
1474;Eglutė;KODĖLČIUKAI;5407757245;Ne;5;0;2;7
1475;Eglutė;KODĖLČIUKAI;3237476593;Ne;1;1;0;2
1476;Eglutė;KODĖLČIUKAI;9542103745;Ne;6;0;0;6
1477;Eglutė;KODĖLČIUKAI;6653111225;Ne;10;0;0;10
1478;Eglutė;KODĖLČIUKAI;1122907387;Ne;5;2;0;7
1479;Eglutė;KODĖLČIUKAI;9686836846;Ne;4;2;0;6
1480;Eglutė;KODĖLČIUKAI;3650609128;Taip;2;0;0;2
1481;Eglutė;KODĖLČIUKAI;8847930854;Ne;2;1;0;3
1482;Eglutė;KODĖLČIUKAI;5592515139;Ne;5;0;0;5
1483;Eglutė;OBUOLIUKAI;5704418881;Ne;0;0;1;1
1484;Eglutė;OBUOLIUKAI;3488060437;Ne;1;1;0;2
1485;Eglutė;OBUOLIUKAI;8698242107;Ne;6;0;0;6
1486;Eglutė;OBUOLIUKAI;1630732306;Ne;0;4;0;4
1487;Eglutė;OBUOLIUKAI;9381529574;Ne;4;1;0;5
1488;Eglutė;OBUOLIUKAI;9150254806;Ne;0;8;0;8
1489;Eglutė;OBUOLIUKAI;4539946535;Ne;10;0;0;10
1490;Eglutė;OBUOLIUKAI;8749425471;Taip;6;2;0;8
1491;Eglutė;OBUOLIUKAI;5103022009;Ne;6;1;0;7
1492;Eglutė;OBUOLIUKAI;1460628870;Taip;0;5;5;10
1493;Eglutė;OBUOLIUKAI;8542684582;Ne;15;1;0;16
1494;Eglutė;OBUOLIUKAI;7313013331;Ne;0;0;2;2
1495;Eglutė;OBUOLIUKAI;3091697091;Ne;5;1;0;6
1496;Eglutė;OBUOLIUKAI;8037564034;Ne;0;2;0;2
1497;Eglutė;OBUOLIUKAI;3051637136;Ne;9;0;0;9
1498;Eglutė;OBUOLIUKAI;2669400743;Ne;4;0;0;4
1499;Eglutė;OBUOLIUKAI;3011330968;Ne;6;1;4;11
1500;Eglutė;OBUOLIUKAI;4823811890;Ne;0;12;0;12
1501;Eglutė;OBUOLIUKAI;4151258155;Ne;9;0;0;9
1502;Eglutė;OBUOLIUKAI;9292940501;Ne;9;2;0;11
1503;Eglutė;KAŠTONAS;3107823269;Ne;0;3;0;3
1504;Eglutė;KAŠTONAS;3799824061;Taip;3;0;2;5
1505;Eglutė;KAŠTONAS;1380219881;Ne;1;6;0;7
1506;Eglutė;KAŠTONAS;7027121333;Ne;0;1;0;1
1507;Eglutė;KAŠTONAS;1744942011;Ne;3;0;0;3
1508;Eglutė;KAŠTONAS;8384141923;Ne;0;2;4;6
1509;Eglutė;KAŠTONAS;3112281182;Ne;9;2;1;12
1510;Eglutė;KAŠTONAS;4876032787;Ne;0;5;0;5
1511;Eglutė;KAŠTONAS;9542684993;Ne;0;3;0;3
1512;Eglutė;KAŠTONAS;6967074765;Ne;2;0;2;4
1513;Eglutė;KAŠTONAS;6679186715;Ne;0;0;4;4
1514;Eglutė;KAŠTONAS;9054104040;Ne;0;12;0;12
1515;Eglutė;KAŠTONAS;9193920390;Ne;0;6;0;6
1516;Eglutė;KAŠTONAS;8721209423;Ne;9;1;0;10
1517;Eglutė;KAŠTONAS;7789753835;Ne;0;2;0;2
1518;Eglutė;KAŠTONAS;1774538642;Ne;0;0;1;1
1519;Eglutė;KAŠTONAS;7114040071;Ne;0;1;2;3
1520;Eglutė;EŽIUKAI;1422631723;Ne;19;0;0;19
1521;Eglutė;EŽIUKAI;6709551046;Taip;0;1;0;1
1522;Eglutė;EŽIUKAI;6093932811;Ne;0;3;0;3
1523;Eglutė;EŽIUKAI;2651867769;Ne;2;0;0;2
1524;Eglutė;EŽIUKAI;3473388722;Ne;0;8;0;8
1525;Eglutė;EŽIUKAI;9402686801;Ne;0;5;0;5
1526;Eglutė;EŽIUKAI;2597978713;Ne;0;4;0;4
1527;Eglutė;EŽIUKAI;4451772812;Ne;6;1;0;7
1528;Eglutė;EŽIUKAI;8493750509;Ne;2;5;0;7
1529;Eglutė;EŽIUKAI;9929681000;Ne;0;7;0;7
1530;Eglutė;EŽIUKAI;6105927493;Ne;2;0;0;2
1531;Eglutė;EŽIUKAI;4560670047;Ne;1;0;0;1
1532;Eglutė;EŽIUKAI;1048451048;Ne;0;1;0;1
1533;Eglutė;EŽIUKAI;6279703448;Ne;0;2;0;2
1534;Eglutė;EŽIUKAI;6142326330;Ne;0;2;0;2
1535;Eglutė;EŽIUKAI;9728550000;Ne;3;0;0;3
1536;Eglutė;EŽIUKAI;7598993411;Taip;17;0;1;18
1537;Eglutė;EŽIUKAI;4047404616;Taip;13;0;0;13
1538;Eglutė;EŽIUKAI;4230594049;Taip;0;5;0;5
1539;Eglutė;EŽIUKAI;3006381069;Ne;0;1;0;1
1540;Eglutė;GILĖ;1550045866;Ne;0;1;0;1
1541;Eglutė;GILĖ;6550999480;Ne;0;1;0;1
1542;Eglutė;GILĖ;2857760751;Ne;1;0;0;1
1543;Eglutė;GILĖ;5650957826;Ne;0;5;0;5
1544;Eglutė;GILĖ;1393626624;Ne;2;1;0;3
1545;Eglutė;GILĖ;2917925763;Ne;0;0;1;1
1546;Eglutė;GILĖ;9746021019;Ne;0;2;5;7
1547;Eglutė;GILĖ;2276311106;Ne;0;5;0;5
1548;Eglutė;GILĖ;6924344686;Ne;0;1;2;3
1549;Eglutė;GILĖ;5645197324;Ne;0;0;2;2
1550;Eglutė;GILĖ;2615824395;Ne;5;1;0;6
1551;Eglutė;GILĖ;1899379269;Ne;0;0;5;5
1552;Eglutė;GILĖ;3605053253;Ne;6;1;0;7
1553;Eglutė;GILĖ;1531942494;Taip;0;4;4;8
1554;Eglutė;GILĖ;5840014240;Ne;6;5;0;11
1555;Eglutė;GILĖ;9758104910;Ne;0;0;3;3
1556;Eglutė;GILĖ;9515238936;Ne;5;0;0;5
1557;Eglutė;GILĖ;6309529738;Ne;0;1;0;1
1558;Eglutė;SAULUTĖ;9741776217;Taip;0;4;0;4
1559;Eglutė;SAULUTĖ;5285593057;Ne;0;0;1;1
1560;Eglutė;SAULUTĖ;3091324735;Ne;0;1;1;2
1561;Eglutė;SAULUTĖ;5518570006;Ne;0;0;2;2
1562;Eglutė;SAULUTĖ;5805450838;Ne;0;0;3;3
1563;Eglutė;SAULUTĖ;9084576953;Ne;0;1;7;8
1564;Eglutė;SAULUTĖ;4489150480;Ne;5;9;0;14
1565;Eglutė;SAULUTĖ;2425927050;Ne;0;8;0;8
1566;Eglutė;SAULUTĖ;5918429438;Ne;0;3;0;3
1567;Eglutė;SAULUTĖ;5006042568;Ne;0;2;0;2
1568;Eglutė;SAULUTĖ;5275306818;Ne;15;0;0;15
1569;Eglutė;SAULUTĖ;2621445549;Ne;0;1;1;2
1570;Eglutė;SAULUTĖ;6328900251;Ne;0;1;0;1
1571;Eglutė;SAULUTĖ;9661883776;Ne;0;1;0;1
1572;Eglutė;SAULUTĖ;8799063905;Ne;0;5;0;5
1573;Eglutė;SAULUTĖ;5108928996;Ne;5;0;0;5
1574;Eglutė;SAULUTĖ;3690266358;Ne;0;1;0;1
1575;Eglutė;ŠARKELĖ;8410302338;Ne;5;0;0;5
1576;Eglutė;ŠARKELĖ;1715411901;Ne;0;0;1;1
1577;Eglutė;ŠARKELĖ;9875724921;Ne;0;1;0;1
1578;Eglutė;ŠARKELĖ;7564179845;Taip;0;1;2;3
1579;Eglutė;ŠARKELĖ;9178835404;Ne;21;0;0;21
1580;Eglutė;ŠARKELĖ;6773894090;Ne;5;0;0;5
1581;Eglutė;ŠARKELĖ;5146804510;Ne;10;0;0;10
1582;Eglutė;ŠARKELĖ;7231828805;Ne;2;4;0;6
1583;Eglutė;ŠARKELĖ;7618937988;Ne;4;0;0;4
1584;Eglutė;ŠARKELĖ;6805213753;Ne;4;8;0;12
1585;Eglutė;ŠARKELĖ;4427853197;Ne;0;0;1;1
1586;Eglutė;ŠARKELĖ;3368734808;Ne;21;0;0;21
1587;Eglutė;ŠARKELĖ;4465995209;Ne;9;0;1;10
1588;Eglutė;ŠARKELĖ;2666894761;Ne;2;4;0;6
1589;Eglutė;ŠARKELĖ;4697026463;Ne;0;0;2;2
1590;Eglutė;ŠARKELĖ;9795027066;Ne;12;0;0;12
1591;Eglutė;ŠARKELĖ;3974970972;Taip;0;1;0;1
1592;Eglutė;ŠARKELĖ;2950414583;Ne;21;0;0;21
1593;Eglutė;NYKŠTUKAI;3210398495;Ne;0;0;2;2
1594;Eglutė;NYKŠTUKAI;2546506486;Taip;8;0;4;12
1595;Eglutė;NYKŠTUKAI;2073980883;Ne;0;4;0;4
1596;Eglutė;NYKŠTUKAI;2643648862;Ne;0;0;2;2
1597;Eglutė;NYKŠTUKAI;2824749988;Ne;9;0;0;9
1598;Eglutė;NYKŠTUKAI;4508182019;Ne;0;0;1;1
1599;Eglutė;NYKŠTUKAI;5840899666;Ne;4;0;3;7
1600;Eglutė;ŽIRNIUKAI;3706904006;Ne;5;0;5;10
1601;Eglutė;ŽIRNIUKAI;6898851909;Ne;0;0;1;1
1602;Eglutė;ŽIRNIUKAI;1645141463;Ne;0;0;2;2
1603;Eglutė;ŽIRNIUKAI;8640230418;Taip;0;0;3;3
1604;Eglutė;ŽIRNIUKAI;6469399675;Ne;2;0;2;4
1605;Eglutė;ŽIRNIUKAI;5991097138;Ne;0;0;1;1
1606;Eglutė;BORUŽIUKAI;5982037450;Ne;0;1;1;2
1607;Eglutė;BORUŽIUKAI;7994301287;Ne;6;1;0;7
1608;Eglutė;BORUŽIUKAI;9300315869;Ne;4;0;1;5
1609;Eglutė;BORUŽIUKAI;4476918512;Taip;3;0;1;4
1610;Eglutė;BORUŽIUKAI;8751687849;Ne;6;0;0;6
1611;Eglutė;BORUŽIUKAI;3228447710;Ne;4;0;0;4
1612;Eglutė;BORUŽIUKAI;7288367894;Ne;0;0;1;1
1613;Eglutė;BORUŽIUKAI;1446642492;Ne;5;1;0;6
1614;Eglutė;BORUŽIUKAI;1699040995;Ne;2;0;2;4
1615;Eglutė;BORUŽIUKAI;6966897830;Ne;2;0;0;2
1616;"Geniukų kalvė";SAULUTĖS;9557055841;Ne;6;0;1;7
1617;"Geniukų kalvė";SAULUTĖS;4329782598;Ne;0;1;0;1
1618;"Geniukų kalvė";SAULUTĖS;8932671578;Ne;12;0;0;12
1619;"Geniukų kalvė";SAULUTĖS;9522911738;Ne;0;0;1;1
1620;"Geniukų kalvė";SAULUTĖS;7886553419;Ne;2;0;2;4
1621;"Geniukų kalvė";SAULUTĖS;4745451344;Ne;0;5;0;5
1622;"Geniukų kalvė";SAULUTĖS;3889643236;Ne;0;7;0;7
1623;"Geniukų kalvė";SAULUTĖS;6102906310;Ne;0;0;2;2
1624;"Geniukų kalvė";SAULUTĖS;9976423099;Ne;10;0;0;10
1625;"Geniukų kalvė";SAULUTĖS;5180240547;Ne;3;0;1;4
1626;"Geniukų kalvė";SAULUTĖS;7140298387;Taip;0;0;2;2
1627;"Geniukų kalvė";SAULUTĖS;7006566384;Ne;1;0;1;2
1628;"Geniukų kalvė";SAULUTĖS;1571869318;Ne;3;0;2;5
1629;"Geniukų kalvė";BITUTĖS;9323779212;Ne;0;0;1;1
1630;"Geniukų kalvė";BITUTĖS;8577323715;Ne;0;0;1;1
1631;"Geniukų kalvė";BITUTĖS;7453065865;Ne;2;0;0;2
1632;"Geniukų kalvė";BITUTĖS;8570015975;Ne;0;7;0;7
1633;"Geniukų kalvė";BITUTĖS;9455124402;Ne;1;0;0;1
1634;"Geniukų kalvė";BITUTĖS;4633553106;Ne;1;0;0;1
1635;"Geniukų kalvė";BITUTĖS;5102325807;Ne;0;7;0;7
1636;"Geniukų kalvė";BITUTĖS;1492140432;Taip;0;12;9;21
1637;"Geniukų kalvė";BITUTĖS;1426555835;Taip;0;1;0;1
1638;"Geniukų kalvė";BITUTĖS;4691978116;Taip;8;0;0;8
1639;"Geniukų kalvė";BITUTĖS;6111168227;Ne;2;1;1;4
1640;"Geniukų kalvė";BITUTĖS;7744441981;Taip;0;0;8;8
1641;"Geniukų kalvė";BITUTĖS;1209268848;Taip;0;0;8;8
1642;"Geniukų kalvė";BITUTĖS;6214681079;Ne;16;1;0;17
1643;"Geniukų kalvė";BITUTĖS;3221034847;Ne;0;0;1;1
1644;"Geniukų kalvė";BITUTĖS;2813336498;Ne;5;0;0;5
1645;"Geniukų kalvė";KIŠKUČIAI;5253380852;Ne;6;0;7;13
1646;"Geniukų kalvė";KIŠKUČIAI;2684344984;Taip;4;0;0;4
1647;"Geniukų kalvė";KIŠKUČIAI;5078771341;Ne;5;1;1;7
1648;"Geniukų kalvė";KIŠKUČIAI;4849740486;Ne;0;0;1;1
1649;"Geniukų kalvė";KIŠKUČIAI;9730758999;Ne;3;0;1;4
1650;"Geniukų kalvė";KIŠKUČIAI;9579750299;Ne;5;0;0;5
1651;"Geniukų kalvė";KIŠKUČIAI;9543553237;Ne;0;0;1;1
1652;"Geniukų kalvė";KIŠKUČIAI;2032408983;Ne;0;0;1;1
1653;"Geniukų kalvė";KIŠKUČIAI;9386761753;Ne;0;7;0;7
1654;"Geniukų kalvė";KIŠKUČIAI;6188518268;Taip;7;0;2;9
1655;"Geniukų kalvė";KIŠKUČIAI;1945456486;Ne;2;0;1;3
1656;"Geniukų kalvė";KIŠKUČIAI;3887137828;Ne;8;0;2;10
1657;"Geniukų kalvė";KIŠKUČIAI;2396085192;Ne;0;5;1;6
1658;"Geniukų kalvė";KIŠKUČIAI;8760512032;Ne;6;0;0;6
1659;"Geniukų kalvė";KIŠKUČIAI;4249054993;Ne;0;0;3;3
1660;"Geniukų kalvė";KIŠKUČIAI;1642514752;Ne;4;0;2;6
1661;"Geniukų kalvė";KIŠKUČIAI;9199949456;Ne;6;0;0;6
1662;"Geniukų kalvė";KIŠKUČIAI;9368537477;Ne;0;0;3;3
1663;"Geniukų kalvė";KIŠKUČIAI;8340662627;Ne;7;0;0;7
1664;"Geniukų kalvė";VYTURĖLIAI;4958738745;Ne;0;2;4;6
1665;"Geniukų kalvė";VYTURĖLIAI;9069256760;Ne;4;0;0;4
1666;"Geniukų kalvė";VYTURĖLIAI;5161535756;Ne;0;4;0;4
1667;"Geniukų kalvė";VYTURĖLIAI;3493492581;Ne;0;1;0;1
1668;"Geniukų kalvė";VYTURĖLIAI;6828079735;Ne;0;2;0;2
1669;"Geniukų kalvė";VYTURĖLIAI;8769761434;Ne;0;7;0;7
1670;"Geniukų kalvė";VYTURĖLIAI;1891205998;Taip;0;0;1;1
1671;"Geniukų kalvė";VYTURĖLIAI;3085228868;Ne;0;1;0;1
1672;"Geniukų kalvė";VYTURĖLIAI;2710207578;Ne;0;21;0;21
1673;"Geniukų kalvė";VYTURĖLIAI;3297360222;Ne;5;2;0;7
1674;"Geniukų kalvė";VYTURĖLIAI;6794151223;Ne;0;1;0;1
1675;"Geniukų kalvė";VYTURĖLIAI;4777155321;Ne;0;2;0;2
1676;"Geniukų kalvė";VYTURĖLIAI;9643242164;Ne;0;3;0;3
1677;"Geniukų kalvė";VYTURĖLIAI;5684792148;Ne;9;0;0;9
1678;"Geniukų kalvė";DRUGELIAI;2217221922;Taip;0;5;1;6
1679;"Geniukų kalvė";DRUGELIAI;8271041553;Ne;0;1;0;1
1680;"Geniukų kalvė";DRUGELIAI;1237228692;Ne;0;1;0;1
1681;"Geniukų kalvė";DRUGELIAI;3055777730;Ne;0;2;1;3
1682;"Geniukų kalvė";DRUGELIAI;8770345339;Ne;12;0;3;15
1683;"Geniukų kalvė";DRUGELIAI;6070945557;Taip;0;1;0;1
1684;"Geniukų kalvė";DRUGELIAI;1051563985;Ne;0;3;0;3
1685;"Geniukų kalvė";DRUGELIAI;5146141771;Ne;0;0;2;2
1686;"Geniukų kalvė";DRUGELIAI;6174114461;Ne;0;2;1;3
1687;"Geniukų kalvė";DRUGELIAI;6237208661;Ne;0;0;1;1
1688;"Geniukų kalvė";DRUGELIAI;2659298240;Ne;0;2;0;2
1689;"Geniukų kalvė";DRUGELIAI;9677583445;Taip;3;3;0;6
1690;"Geniukų kalvė";DRUGELIAI;6737863183;Ne;4;1;0;5
1691;"Geniukų kalvė";DRUGELIAI;5704223824;Ne;8;2;0;10
1692;"Geniukų kalvė";DRUGELIAI;3166309530;Ne;2;1;0;3
1693;"Geniukų kalvė";"SAULĖS ZUIKUČIAI";2313382307;Ne;0;0;1;1
1694;"Geniukų kalvė";"SAULĖS ZUIKUČIAI";7500079028;Taip;0;0;1;1
1695;"Geniukų kalvė";"SAULĖS ZUIKUČIAI";8071493871;Ne;7;0;2;9
1696;"Geniukų kalvė";"SAULĖS ZUIKUČIAI";1718428600;Ne;0;0;1;1
1697;"Geniukų kalvė";"SAULĖS ZUIKUČIAI";6016585056;Ne;5;0;0;5
1698;"Geniukų kalvė";"SAULĖS ZUIKUČIAI";2816691996;Ne;0;0;4;4
1699;"Geniukų kalvė";"SAULĖS ZUIKUČIAI";5512172533;Ne;0;6;0;6
1700;"Geniukų kalvė";"SAULĖS ZUIKUČIAI";4722801116;Ne;0;11;0;11
1701;"Geniukų kalvė";"SAULĖS ZUIKUČIAI";5763009912;Ne;2;0;0;2
1702;"Geniukų kalvė";"SAULĖS ZUIKUČIAI";5725034297;Ne;2;0;0;2
1703;"Geniukų kalvė";"SAULĖS ZUIKUČIAI";1499735818;Ne;5;0;0;5
1704;"Geniukų kalvė";"SAULĖS ZUIKUČIAI";5161600326;Taip;7;0;0;7
1705;"Geniukų kalvė";"SAULĖS ZUIKUČIAI";4975437036;Ne;1;0;0;1
1706;"Geniukų kalvė";"SAULĖS ZUIKUČIAI";1277485419;Ne;13;0;0;13
1707;"Geniukų kalvė";SMALSUČIAI;5974481787;Ne;7;2;0;9
1708;"Geniukų kalvė";SMALSUČIAI;7915720190;Ne;2;0;0;2
1709;"Geniukų kalvė";SMALSUČIAI;8985466295;Ne;0;1;0;1
1710;"Geniukų kalvė";SMALSUČIAI;4231659246;Ne;8;0;0;8
1711;"Geniukų kalvė";SMALSUČIAI;2300947427;Ne;1;1;0;2
1712;"Geniukų kalvė";SMALSUČIAI;1028242614;Ne;0;8;0;8
1713;"Geniukų kalvė";SMALSUČIAI;2596680448;Ne;0;2;0;2
1714;"Geniukų kalvė";SMALSUČIAI;4405381922;Ne;0;1;0;1
1715;"Geniukų kalvė";SMALSUČIAI;6473724074;Ne;5;0;0;5
1716;"Geniukų kalvė";SMALSUČIAI;3627418555;Ne;0;6;0;6
1717;"Geniukų kalvė";SMALSUČIAI;9155681194;Taip;9;2;0;11
1718;"Geniukų kalvė";SMALSUČIAI;7440029486;Taip;5;4;0;9
1719;"Geniukų kalvė";SMALSUČIAI;6168422514;Ne;11;1;0;12
1720;"Geniukų kalvė";SMALSUČIAI;6757580298;Ne;1;0;0;1
1721;"Geniukų kalvė";SMALSUČIAI;1573612317;Ne;0;5;0;5
1722;"Geniukų kalvė";SMALSUČIAI;6138451393;Ne;0;1;0;1
1723;"Geniukų kalvė";RUDNOSIUKAI;7079072084;Ne;5;0;0;5
1724;"Geniukų kalvė";RUDNOSIUKAI;6060825704;Ne;0;0;3;3
1725;"Geniukų kalvė";RUDNOSIUKAI;6149037133;Ne;0;5;0;5
1726;"Geniukų kalvė";RUDNOSIUKAI;5883913787;Ne;0;0;2;2
1727;"Geniukų kalvė";RUDNOSIUKAI;9696452101;Ne;8;0;0;8
1728;"Geniukų kalvė";RUDNOSIUKAI;5205178173;Ne;0;0;1;1
1729;"Geniukų kalvė";RUDNOSIUKAI;9847003556;Ne;3;0;0;3
1730;"Geniukų kalvė";RUDNOSIUKAI;7300853810;Ne;2;0;0;2
1731;"Geniukų kalvė";RUDNOSIUKAI;2839299179;Ne;1;5;0;6
1732;"Geniukų kalvė";RUDNOSIUKAI;4664026888;Ne;5;0;0;5
1733;"Geniukų kalvė";RUDNOSIUKAI;2165793561;Ne;0;2;0;2
1734;"Geniukų kalvė";RUDNOSIUKAI;8973285553;Ne;0;10;0;10
1735;"Geniukų kalvė";RUDNOSIUKAI;4985606198;Ne;9;0;3;12
1736;"Geniukų kalvė";RUDNOSIUKAI;2798750158;Ne;0;1;0;1
1737;"Geniukų kalvė";RUDNOSIUKAI;6373989816;Ne;0;8;0;8
1738;"Geniukų kalvė";PELĖDŽIUKAI;6783296167;Ne;0;8;0;8
1739;"Geniukų kalvė";PELĖDŽIUKAI;1844495906;Ne;1;1;0;2
1740;"Geniukų kalvė";PELĖDŽIUKAI;7234620406;Ne;1;0;0;1
1741;"Geniukų kalvė";PELĖDŽIUKAI;5847488152;Taip;0;1;3;4
1742;"Geniukų kalvė";PELĖDŽIUKAI;3676717541;Ne;0;8;0;8
1743;"Geniukų kalvė";PELĖDŽIUKAI;7310171451;Ne;6;2;0;8
1744;"Geniukų kalvė";PELĖDŽIUKAI;9820642056;Ne;1;0;1;2
1745;"Geniukų kalvė";PELĖDŽIUKAI;5115570519;Taip;3;0;0;3
1746;"Geniukų kalvė";PELĖDŽIUKAI;1179440839;Ne;1;0;0;1
1747;"Geniukų kalvė";PELĖDŽIUKAI;8277880528;Ne;5;0;0;5
1748;"Geniukų kalvė";PELĖDŽIUKAI;2448906549;Taip;6;0;5;11
1749;"Geniukų kalvė";PELĖDŽIUKAI;2884835744;Ne;3;0;0;3
1750;"Geniukų kalvė";BORUŽĖLĖS;7561521903;Ne;2;0;0;2
1751;"Geniukų kalvė";BORUŽĖLĖS;2312298671;Taip;3;0;0;3
1752;"Geniukų kalvė";BORUŽĖLĖS;8217855034;Ne;4;0;0;4
1753;"Geniukų kalvė";BORUŽĖLĖS;1068112116;Ne;2;0;0;2
1754;"Geniukų kalvė";BORUŽĖLĖS;1421857914;Ne;8;0;0;8
1755;"Geniukų kalvė";BORUŽĖLĖS;7736527608;Ne;0;11;0;11
1756;"Geniukų kalvė";BORUŽĖLĖS;4805806745;Ne;6;0;0;6
1757;"Geniukų kalvė";BORUŽĖLĖS;1383717352;Ne;6;0;0;6
1758;"Geniukų kalvė";BORUŽĖLĖS;3071724778;Ne;1;1;0;2
1759;"Geniukų kalvė";BORUŽĖLĖS;2302465593;Ne;6;0;0;6
1760;"Geniukų kalvė";BORUŽĖLĖS;3024701779;Ne;3;0;0;3
1761;"Geniukų kalvė";BORUŽĖLĖS;1822730314;Ne;3;6;0;9
1762;"Geniukų kalvė";BORUŽĖLĖS;3015544833;Ne;5;1;0;6
1763;"Geniukų kalvė";BORUŽĖLĖS;9264121921;Ne;3;0;0;3
1764;"Geniukų kalvė";BORUŽĖLĖS;3071147714;Ne;3;4;0;7
1765;"Geniukų kalvė";BORUŽĖLĖS;7776771879;Ne;1;0;0;1
1766;"Geniukų kalvė";BORUŽĖLĖS;9446649021;Ne;4;0;0;4
1767;"Geniukų kalvė";BORUŽĖLĖS;1733621845;Ne;8;0;0;8
1768;"Geniukų kalvė";PAGRANDUKAI;8525540366;Ne;1;0;0;1
1769;"Geniukų kalvė";PAGRANDUKAI;8214399001;Ne;1;0;0;1
1770;"Geniukų kalvė";PAGRANDUKAI;2584997232;Ne;5;0;0;5
1771;"Geniukų kalvė";PAGRANDUKAI;1330046867;Ne;2;0;0;2
1772;"Geniukų kalvė";PAGRANDUKAI;9483545114;Ne;2;0;0;2
1773;"Geniukų kalvė";PAGRANDUKAI;1060081499;Ne;9;0;0;9
1774;"Geniukų kalvė";NYKŠTUKAI;9322790214;Ne;0;0;1;1
1775;"Geniukų kalvė";NYKŠTUKAI;6680434763;Ne;0;0;3;3
1776;"Geniukų kalvė";NYKŠTUKAI;7161460256;Ne;2;0;7;9
1777;"Geniukų kalvė";NYKŠTUKAI;3484288126;Ne;0;0;9;9
1778;"Geniukų kalvė";NYKŠTUKAI;7093135374;Ne;0;0;1;1
1779;"Geniukų kalvė";NYKŠTUKAI;3227799882;Ne;7;0;0;7
1780;"Geniukų kalvė";NYKŠTUKAI;4251353237;Ne;1;0;0;1
1781;"Geniukų kalvė";NYKŠTUKAI;6262489669;Ne;0;0;2;2
1782;"Geniukų kalvė";NYKŠTUKAI;3942415928;Ne;0;0;6;6
1783;"Geniukų kalvė";NYKŠTUKAI;1842445148;Taip;0;0;2;2
1784;Gelvonėlis;ĄŽUOLIUKAI;2329699993;Taip;0;1;0;1
1785;Gelvonėlis;ĄŽUOLIUKAI;9058956012;Ne;0;7;0;7
1786;Gelvonėlis;ĄŽUOLIUKAI;4111774915;Ne;0;3;0;3
1787;Gelvonėlis;ĄŽUOLIUKAI;3677100165;Ne;5;0;6;11
1788;Gelvonėlis;ĄŽUOLIUKAI;7449710008;Ne;0;1;0;1
1789;Gelvonėlis;ĄŽUOLIUKAI;8163855482;Taip;6;0;0;6
1790;Gelvonėlis;ĄŽUOLIUKAI;3942630720;Taip;10;2;0;12
1791;Gelvonėlis;ĄŽUOLIUKAI;1453271708;Taip;0;2;1;3
1792;Gelvonėlis;ĄŽUOLIUKAI;9756155028;Ne;6;7;0;13
1793;Gelvonėlis;ĄŽUOLIUKAI;8206816148;Taip;6;1;0;7
1794;Gelvonėlis;ĄŽUOLIUKAI;1274119900;Taip;0;3;0;3
1795;Gelvonėlis;ĄŽUOLIUKAI;5901499708;Ne;3;0;0;3
1796;Gelvonėlis;ĄŽUOLIUKAI;1403890893;Taip;0;0;3;3
1797;Gelvonėlis;ĄŽUOLIUKAI;2519955694;Taip;0;1;0;1
1798;Gelvonėlis;ĄŽUOLIUKAI;4190673346;Ne;3;0;9;12
1799;Gelvonėlis;ŽVIRBLIUKAI;5024860112;Ne;0;4;0;4
1800;Gelvonėlis;ŽVIRBLIUKAI;8987012601;Ne;8;0;1;9
1801;Gelvonėlis;ŽVIRBLIUKAI;7632523330;Ne;0;0;1;1
1802;Gelvonėlis;ŽVIRBLIUKAI;1112841066;Ne;0;12;1;13
1803;Gelvonėlis;ŽVIRBLIUKAI;2553846157;Ne;0;6;0;6
1804;Gelvonėlis;ŽVIRBLIUKAI;8003522011;Taip;0;0;1;1
1805;Gelvonėlis;ŽVIRBLIUKAI;9900244859;Ne;0;0;9;9
1806;Gelvonėlis;ŽVIRBLIUKAI;4027647695;Ne;0;0;11;11
1807;Gelvonėlis;ŽVIRBLIUKAI;5713586282;Ne;0;3;3;6
1808;Gelvonėlis;ŽVIRBLIUKAI;8560940316;Ne;0;0;1;1
1809;Gelvonėlis;ŽVIRBLIUKAI;5874473596;Ne;0;1;1;2
1810;Gelvonėlis;ŽVIRBLIUKAI;5305480599;Ne;10;0;0;10
1811;Gelvonėlis;ŽVIRBLIUKAI;5124211917;Ne;0;0;2;2
1812;Gelvonėlis;ŽVIRBLIUKAI;8540204705;Ne;0;0;1;1
1813;Gelvonėlis;ŽVIRBLIUKAI;8124516993;Ne;2;0;4;6
1814;Gelvonėlis;RASELĖS;5996128423;Ne;20;0;0;20
1815;Gelvonėlis;RASELĖS;9149117970;Ne;0;11;1;12
1816;Gelvonėlis;RASELĖS;6451557430;Ne;0;7;0;7
1817;Gelvonėlis;RASELĖS;1802520150;Ne;0;0;1;1
1818;Gelvonėlis;RASELĖS;3192542909;Ne;2;10;0;12
1819;Gelvonėlis;RASELĖS;9622818893;Ne;0;0;1;1
1820;Gelvonėlis;RASELĖS;2638430817;Ne;0;0;4;4
1821;Gelvonėlis;RASELĖS;1462716950;Ne;4;11;1;16
1822;Gelvonėlis;RASELĖS;9600526942;Ne;0;7;0;7
1823;Gelvonėlis;RASELĖS;1387948936;Ne;0;1;0;1
1824;Gelvonėlis;RASELĖS;1587584701;Ne;0;0;1;1
1825;Gelvonėlis;SAULUTĖ;7392743619;Ne;0;0;1;1
1826;Gelvonėlis;SAULUTĖ;1734685590;Ne;0;0;7;7
1827;Gelvonėlis;SAULUTĖ;7936622964;Ne;0;5;0;5
1828;Gelvonėlis;SAULUTĖ;3719670896;Ne;0;0;3;3
1829;Gelvonėlis;SAULUTĖ;1672409070;Ne;0;0;3;3
1830;Gelvonėlis;SAULUTĖ;3771796903;Ne;0;0;2;2
1831;Gelvonėlis;SAULUTĖ;4268590631;Ne;0;0;1;1
1832;Gelvonėlis;SAULUTĖ;5598186460;Ne;5;0;1;6
1833;Gelvonėlis;SAULUTĖ;9767254134;Ne;1;0;2;3
1834;Gelvonėlis;SAULUTĖ;2452711535;Ne;10;0;1;11
1835;Gelvonėlis;SAULUTĖ;3371560338;Ne;11;0;5;16
1836;Gelvonėlis;SAULUTĖ;2800795052;Ne;1;0;4;5
1837;Gelvonėlis;SAULUTĖ;9980127170;Ne;1;0;3;4
1838;Gelvonėlis;SAULUTĖ;6206837435;Ne;0;3;0;3
1839;Gelvonėlis;SAULUTĖ;6840560863;Ne;0;0;1;1
1840;Gelvonėlis;PELĖDŽIUKAI;6604992169;Ne;1;0;1;2
1841;Gelvonėlis;PELĖDŽIUKAI;8508450500;Ne;0;1;5;6
1842;Gelvonėlis;PELĖDŽIUKAI;8704971956;Ne;0;0;1;1
1843;Gelvonėlis;PELĖDŽIUKAI;6556472766;Ne;5;0;5;10
1844;Gelvonėlis;PELĖDŽIUKAI;7182180008;Ne;0;0;1;1
1845;Gelvonėlis;PELĖDŽIUKAI;8976258838;Ne;0;0;2;2
1846;Gelvonėlis;PELĖDŽIUKAI;6598178467;Ne;0;0;3;3
1847;Gelvonėlis;PELĖDŽIUKAI;8885088900;Ne;0;1;3;4
1848;Gelvonėlis;PELĖDŽIUKAI;2400289466;Ne;0;0;7;7
1849;Gelvonėlis;PELĖDŽIUKAI;1987204544;Ne;0;1;0;1
1850;Gelvonėlis;PELĖDŽIUKAI;2515471132;Ne;1;0;3;4
1851;Gelvonėlis;PELĖDŽIUKAI;4281431471;Ne;0;0;1;1
1852;Gelvonėlis;PELĖDŽIUKAI;1085845218;Ne;0;0;1;1
1853;Gelvonėlis;PELĖDŽIUKAI;6319058542;Ne;0;0;1;1
1854;Gelvonėlis;PELĖDŽIUKAI;9538571448;Ne;0;0;1;1
1855;Gelvonėlis;PELĖDŽIUKAI;9147186080;Ne;0;1;1;2
1856;Gelvonėlis;PELĖDŽIUKAI;7195164378;Taip;0;0;1;1
1857;Gelvonėlis;PELĖDŽIUKAI;7620280474;Ne;5;0;0;5
1858;Gelvonėlis;PELĖDŽIUKAI;4913415466;Ne;0;0;3;3
1859;Gelvonėlis;DRUGELIAI;2407650243;Ne;6;0;0;6
1860;Gelvonėlis;DRUGELIAI;2407650243;Ne;6;0;0;6
1861;Gelvonėlis;DRUGELIAI;7262185834;Ne;5;0;0;5
1862;Gelvonėlis;DRUGELIAI;7733244178;Ne;1;0;0;1
1863;Gelvonėlis;DRUGELIAI;1252450619;Ne;11;0;0;11
1864;Gelvonėlis;DRUGELIAI;7811394993;Ne;14;0;0;14
1865;Gelvonėlis;DRUGELIAI;6197211003;Ne;1;0;0;1
1866;Gelvonėlis;DRUGELIAI;1723279380;Ne;13;0;0;13
1867;Gelvonėlis;DRUGELIAI;4125444433;Ne;12;0;0;12
1868;Gelvonėlis;DRUGELIAI;5104092000;Ne;0;3;0;3
1869;Gelvonėlis;DRUGELIAI;7408801401;Ne;3;0;0;3
1870;Gelvonėlis;DRUGELIAI;2045223350;Ne;0;2;0;2
1871;Gelvonėlis;DRUGELIAI;5850515555;Ne;3;0;0;3
1872;Gelvonėlis;VARPELIAI;6131268672;Ne;12;0;0;12
1873;Gelvonėlis;VARPELIAI;4088437014;Ne;3;0;4;7
1874;Gelvonėlis;VARPELIAI;3150970953;Ne;0;0;6;6
1875;Gelvonėlis;VARPELIAI;2896360160;Ne;0;0;5;5
1876;Gelvonėlis;VARPELIAI;4162701876;Ne;6;1;0;7
1877;Gelvonėlis;VARPELIAI;8365647638;Ne;0;10;1;11
1878;Gelvonėlis;VARPELIAI;3618681535;Ne;0;0;1;1
1879;Gelvonėlis;VARPELIAI;2114734415;Ne;14;0;2;16
1880;Gelvonėlis;VARPELIAI;5882430535;Ne;0;0;1;1
1881;Gelvonėlis;VARPELIAI;2645337382;Taip;0;0;7;7
1882;Gelvonėlis;VARPELIAI;3813000890;Taip;3;9;1;13
1883;Gelvonėlis;VARPELIAI;5379820728;Ne;0;0;5;5
1884;Gelvonėlis;VARPELIAI;1984082487;Ne;0;0;3;3
1885;Gelvonėlis;BORUŽĖLĖS;8209225630;Ne;10;0;0;10
1886;Gelvonėlis;BORUŽĖLĖS;6554989142;Ne;0;0;1;1
1887;Gelvonėlis;BORUŽĖLĖS;4112607183;Ne;0;0;1;1
1888;Gelvonėlis;BORUŽĖLĖS;6243360625;Ne;12;2;0;14
1889;Gelvonėlis;BORUŽĖLĖS;1712926391;Ne;4;5;2;11
1890;Gelvonėlis;BORUŽĖLĖS;6647585785;Ne;4;0;1;5
1891;Gelvonėlis;BORUŽĖLĖS;8973272332;Ne;5;3;0;8
1892;Gelvonėlis;BORUŽĖLĖS;9849765037;Ne;0;0;1;1
1893;Gelvonėlis;BORUŽĖLĖS;4749071286;Ne;5;2;0;7
1894;Gelvonėlis;BORUŽĖLĖS;3926733474;Ne;0;0;4;4
1895;Gelvonėlis;BORUŽĖLĖS;4620517551;Ne;0;0;3;3
1896;Gelvonėlis;BORUŽĖLĖS;6598688551;Ne;0;2;0;2
1897;Gelvonėlis;NYKŠTUKAI;5311057148;Ne;1;0;0;1
1898;Gelvonėlis;NYKŠTUKAI;9266138595;Ne;6;0;0;6
1899;Gelvonėlis;NYKŠTUKAI;6740297512;Ne;2;0;1;3
1900;Gelvonėlis;NYKŠTUKAI;2302268767;Taip;6;0;1;7
1901;Gelvonėlis;NYKŠTUKAI;4723497260;Ne;6;0;0;6
1902;Gelvonėlis;NYKŠTUKAI;8962769076;Ne;12;0;0;12
1903;Gelvonėlis;NYKŠTUKAI;3173327297;Ne;0;1;1;2
1904;Gelvonėlis;NYKŠTUKAI;9529938060;Taip;7;0;0;7
1905;Gelvonėlis;NYKŠTUKAI;6072327798;Taip;0;3;0;3
1906;Gelvonėlis;NYKŠTUKAI;2195887907;Taip;8;0;0;8
1907;Gelvonėlis;NYKŠTUKAI;4244879840;Ne;7;0;0;7
1908;Gelvonėlis;NYKŠTUKAI;8863386276;Ne;8;0;0;8
1909;Gelvonėlis;BITUTĖS;6534527571;Ne;0;5;0;5
1910;Gelvonėlis;BITUTĖS;1105838340;Ne;3;0;1;4
1911;Gelvonėlis;BITUTĖS;5865866507;Ne;2;10;0;12
1912;Gelvonėlis;BITUTĖS;5444127599;Ne;6;6;0;12
1913;Gelvonėlis;BITUTĖS;5633162524;Ne;0;7;0;7
1914;Gelvonėlis;BITUTĖS;6330751030;Ne;4;0;1;5
1915;Gelvonėlis;BITUTĖS;6710189985;Ne;0;6;0;6
1916;Gelvonėlis;BITUTĖS;5281400074;Ne;5;0;1;6
1917;Gelvonėlis;BITUTĖS;3514762919;Ne;6;0;1;7
1918;Gelvonėlis;BITUTĖS;7850553299;Ne;0;5;0;5
1919;Gelvonėlis;BITUTĖS;1730718430;Ne;0;0;2;2
1920;Gelvonėlis;BITUTĖS;8480138654;Ne;8;2;0;10
1921;Gelvonėlis;BITUTĖS;7725313260;Ne;9;0;0;9
1922;Gelvonėlis;BITUTĖS;5816373550;Ne;0;0;3;3
1923;Gelvonėlis;BITUTĖS;4380468764;Ne;0;6;0;6
1924;Gelvonėlis;RAMUNĖLĖS;2774170680;Ne;0;8;0;8
1925;Gelvonėlis;RAMUNĖLĖS;9403505858;Taip;5;6;0;11
1926;Gelvonėlis;RAMUNĖLĖS;4450990418;Ne;0;7;0;7
1927;Gelvonėlis;RAMUNĖLĖS;6883156109;Ne;1;1;2;4
1928;Gelvonėlis;RAMUNĖLĖS;1562829157;Ne;1;1;0;2
1929;Gelvonėlis;RAMUNĖLĖS;2821485779;Ne;11;0;0;11
1930;Gelvonėlis;RAMUNĖLĖS;2818319130;Ne;7;0;0;7
1931;Gelvonėlis;RAMUNĖLĖS;7301596834;Ne;6;0;2;8
1932;Gelvonėlis;RAMUNĖLĖS;9046297659;Taip;9;8;0;17
1933;Gelvonėlis;RAMUNĖLĖS;9492898584;Taip;0;11;0;11
1934;Gelvonėlis;RAMUNĖLĖS;7654781219;Ne;0;0;1;1
1935;Gelvonėlis;RIEŠUTĖLIAI;3368423382;Ne;0;5;0;5
1936;Gelvonėlis;RIEŠUTĖLIAI;5461812139;Ne;0;6;0;6
1937;Gelvonėlis;RIEŠUTĖLIAI;5986018609;Ne;0;0;1;1
1938;Gelvonėlis;RIEŠUTĖLIAI;8532801167;Ne;0;0;5;5
1939;Gelvonėlis;RIEŠUTĖLIAI;4208103106;Ne;0;8;0;8
1940;Gelvonėlis;RIEŠUTĖLIAI;8766702456;Ne;0;0;1;1
1941;Gelvonėlis;RIEŠUTĖLIAI;6305084811;Ne;7;0;1;8
1942;Gelvonėlis;RIEŠUTĖLIAI;2005647155;Ne;0;1;3;4
1943;Gelvonėlis;RIEŠUTĖLIAI;1266479895;Ne;0;1;0;1
1944;Gelvonėlis;RIEŠUTĖLIAI;5934077931;Ne;0;3;0;3
1945;Gelvonėlis;RIEŠUTĖLIAI;4280463938;Ne;0;1;0;1
1946;Gelvonėlis;RIEŠUTĖLIAI;6471921512;Ne;5;0;0;5
1947;Gelvonėlis;RIEŠUTĖLIAI;3448444552;Ne;0;1;0;1
1948;Gelvonėlis;RIEŠUTĖLIAI;4832167372;Ne;8;6;0;14
1949;Gelvonėlis;RIEŠUTĖLIAI;2015807805;Ne;4;10;0;14
1950;Gelvonėlis;RIEŠUTĖLIAI;9323228591;Ne;0;0;1;1
1951;Gelvonėlis;RIEŠUTĖLIAI;2360728722;Ne;3;0;4;7
1952;Gelvonėlis;RIEŠUTĖLIAI;9132529216;Ne;0;4;1;5
1953;"Gervelė (Dzūkų g. 32)";ŽIRNIUKAI;7140356352;Ne;0;0;1;1
1954;"Gervelė (Dzūkų g. 32)";ŽIRNIUKAI;3170062234;Taip;2;0;0;2
1955;"Gervelė (Dzūkų g. 32)";ŽIRNIUKAI;8598429197;Taip;0;0;3;3
1956;"Gervelė (Dzūkų g. 32)";ŽIRNIUKAI;9294388176;Taip;0;8;0;8
1957;"Gervelė (Dzūkų g. 32)";ŽIRNIUKAI;8098158634;Taip;2;0;1;3
1958;"Gervelė (Dzūkų g. 32)";ŽIRNIUKAI;7205673717;Ne;4;0;1;5
1959;"Gervelė (Dzūkų g. 32)";ŽIRNIUKAI;3554640994;Ne;0;0;2;2
1960;"Gervelė (Dzūkų g. 32)";ŽIRNIUKAI;1226130732;Taip;6;0;1;7
1961;"Gervelė (Dzūkų g. 32)";ŽIRNIUKAI;4552290778;Ne;0;0;1;1
1962;"Gervelė (Dzūkų g. 32)";ŽIRNIUKAI;9884946783;Ne;17;0;0;17
1963;"Gervelė (Dzūkų g. 32)";ŽIRNIUKAI;4174471780;Ne;12;0;2;14
1964;"Gervelė (Dzūkų g. 32)";ŽIRNIUKAI;6424240375;Ne;14;0;5;19
1965;"Gervelė (Dzūkų g. 32)";ŽIRNIUKAI;2210605017;Ne;13;0;2;15
1966;"Gervelė (Dzūkų g. 32)";ŽIRNIUKAI;1777909973;Taip;3;0;1;4
1967;"Gervelė (Dzūkų g. 32)";ŽIRNIUKAI;1400829693;Ne;0;0;1;1
1968;"Gervelė (Dzūkų g. 32)";ŽIRNIUKAI;4661861470;Ne;7;0;3;10
1969;"Gervelė (Dzūkų g. 32)";LAŠIUKAI;2523056808;Taip;0;0;1;1
1970;"Gervelė (Dzūkų g. 32)";LAŠIUKAI;6844406500;Ne;0;1;0;1
1971;"Gervelė (Dzūkų g. 32)";LAŠIUKAI;2359854614;Ne;0;10;0;10
1972;"Gervelė (Dzūkų g. 32)";LAŠIUKAI;8811086908;Ne;0;4;0;4
1973;"Gervelė (Dzūkų g. 32)";LAŠIUKAI;2046282471;Ne;11;0;0;11
1974;"Gervelė (Dzūkų g. 32)";LAŠIUKAI;1573560581;Ne;1;0;0;1
1975;"Gervelė (Dzūkų g. 32)";LAŠIUKAI;9133101055;Ne;13;0;0;13
1976;"Gervelė (Dzūkų g. 32)";LAŠIUKAI;7192663882;Ne;2;0;0;2
1977;"Gervelė (Dzūkų g. 32)";LAŠIUKAI;1024397071;Ne;10;0;0;10
1978;"Gervelė (Dzūkų g. 32)";LAŠIUKAI;1783612448;Ne;5;0;4;9
1979;"Gervelė (Dzūkų g. 32)";LAŠIUKAI;4075328330;Ne;0;11;0;11
1980;"Gervelė (Dzūkų g. 32)";LAŠIUKAI;7394199974;Ne;6;0;0;6
1981;"Gervelė (Dzūkų g. 32)";LAŠIUKAI;5497737178;Taip;4;0;0;4
1982;"Gervelė (Dzūkų g. 32)";LAŠIUKAI;5480025851;Ne;2;0;0;2
1983;"Gervelė (Dzūkų g. 32)";LAŠIUKAI;7363767471;Ne;17;0;0;17
1984;"Gervelė (Dzūkų g. 32)";PABIRUČIAI;1637204236;Ne;1;0;0;1
1985;"Gervelė (Dzūkų g. 32)";PABIRUČIAI;8157865822;Ne;0;0;1;1
1986;"Gervelė (Dzūkų g. 32)";PABIRUČIAI;7924884022;Ne;0;12;0;12
1987;"Gervelė (Dzūkų g. 32)";PABIRUČIAI;3702908570;Ne;3;0;0;3
1988;"Gervelė (Dzūkų g. 32)";PABIRUČIAI;1323074335;Ne;5;0;1;6
1989;"Gervelė (Dzūkų g. 32)";PABIRUČIAI;4899690598;Ne;0;0;12;12
1990;"Gervelė (Dzūkų g. 32)";PABIRUČIAI;5799823801;Ne;1;2;0;3
1991;"Gervelė (Dzūkų g. 32)";PABIRUČIAI;6058944385;Ne;0;7;0;7
1992;"Gervelė (Dzūkų g. 32)";PABIRUČIAI;6431701403;Ne;0;0;3;3
1993;"Gervelė (Dzūkų g. 32)";PABIRUČIAI;2446758975;Taip;0;4;0;4
1994;"Gervelė (Dzūkų g. 32)";PABIRUČIAI;2413995770;Ne;0;1;0;1
1995;"Gervelė (Dzūkų g. 32)";PABIRUČIAI;1353920541;Ne;10;1;0;11
1996;"Gervelė (Dzūkų g. 32)";PABIRUČIAI;8533480337;Ne;6;2;0;8
1997;"Gervelė (Dzūkų g. 32)";PABIRUČIAI;8287867336;Ne;0;10;0;10
1998;"Gervelė (Dzūkų g. 32)";PABIRUČIAI;2186818108;Ne;7;0;0;7
1999;"Gervelė (Dzūkų g. 32)";BITUTĖS;5360362280;Ne;0;0;1;1
2000;"Gervelė (Dzūkų g. 32)";BITUTĖS;5360362280;Ne;0;0;1;1
2001;"Gervelė (Dzūkų g. 32)";BITUTĖS;7317091881;Ne;0;1;0;1
2002;"Gervelė (Dzūkų g. 32)";BITUTĖS;6228025635;Ne;0;0;1;1
2003;"Gervelė (Dzūkų g. 32)";BITUTĖS;9977349707;Ne;0;3;0;3
2004;"Gervelė (Dzūkų g. 32)";BITUTĖS;4295743997;Ne;0;1;0;1
2005;"Gervelė (Dzūkų g. 32)";BITUTĖS;1112844296;Ne;0;0;3;3
2006;"Gervelė (Dzūkų g. 32)";BITUTĖS;7935059565;Ne;4;0;0;4
2007;"Gervelė (Dzūkų g. 32)";BITUTĖS;5267617723;Ne;0;0;1;1
2008;"Gervelė (Dzūkų g. 32)";BITUTĖS;5953552777;Ne;0;5;1;6
2009;"Gervelė (Dzūkų g. 32)";BITUTĖS;4038179503;Ne;0;0;1;1
2010;"Gervelė (Dzūkų g. 32)";BITUTĖS;1160084928;Ne;9;0;0;9
2011;"Gervelė (Dzūkų g. 32)";BITUTĖS;6287806975;Taip;0;3;0;3
2012;"Gervelė (Dzūkų g. 32)";BITUTĖS;5167248493;Ne;1;0;0;1
2013;"Gervelė (Dzūkų g. 32)";BITUTĖS;9291855374;Taip;0;0;1;1
2014;"Gervelė (Dzūkų g. 32)";BURATINO;9239897472;Ne;10;1;0;11
2015;"Gervelė (Dzūkų g. 32)";BURATINO;9982951468;Ne;0;0;2;2
2016;"Gervelė (Dzūkų g. 32)";BURATINO;4775822341;Ne;7;2;0;9
2017;"Gervelė (Dzūkų g. 32)";BURATINO;4434618210;Ne;0;0;7;7
2018;"Gervelė (Dzūkų g. 32)";BURATINO;6166476760;Ne;3;0;0;3
2019;"Gervelė (Dzūkų g. 32)";BURATINO;4516538272;Ne;9;0;0;9
2020;"Gervelė (Dzūkų g. 32)";BURATINO;3723783633;Ne;7;0;0;7
2021;"Gervelė (Dzūkų g. 32)";BURATINO;8472436632;Taip;9;0;0;9
2022;"Gervelė (Dzūkų g. 32)";BURATINO;1655678792;Ne;5;0;1;6
2023;"Gervelė (Dzūkų g. 32)";BURATINO;9697299387;Taip;1;0;0;1
2024;"Gervelė (Dzūkų g. 32)";BURATINO;7300458249;Ne;9;0;0;9
2025;"Gervelė (Dzūkų g. 32)";BURATINO;5737517940;Ne;4;0;0;4
2026;"Gervelė (Dzūkų g. 32)";BURATINO;6595410865;Ne;4;0;0;4
2027;"Gervelė (Dzūkų g. 32)";BURATINO;1328359434;Ne;10;0;0;10
2028;"Gervelė (Dzūkų g. 32)";BURATINO;2080374597;Ne;3;0;2;5
2029;"Gervelė (Dzūkų g. 32)";BURATINO;1270020781;Taip;9;0;0;9
2030;"Gervelė (Dzūkų g. 32)";BURATINO;9768014964;Ne;6;0;0;6
2031;"Gervelė (Dzūkų g. 32)";VIŠČIUKŲ;3928187363;Ne;0;0;4;4
2032;"Gervelė (Dzūkų g. 32)";VIŠČIUKŲ;8193126684;Ne;5;0;0;5
2033;"Gervelė (Dzūkų g. 32)";VIŠČIUKŲ;7152159380;Ne;3;0;0;3
2034;"Gervelė (Dzūkų g. 32)";VIŠČIUKŲ;6503715631;Ne;1;0;0;1
2035;"Gervelė (Dzūkų g. 32)";VIŠČIUKŲ;6071962550;Ne;5;0;1;6
2036;"Gervelė (Dzūkų g. 32)";VIŠČIUKŲ;8456221074;Ne;9;0;0;9
2037;"Gervelė (Dzūkų g. 32)";VIŠČIUKŲ;9738262953;Ne;6;0;0;6
2038;"Gervelė (Dzūkų g. 32)";VIŠČIUKŲ;8792240321;Ne;0;0;1;1
2039;"Gervelė (Dzūkų g. 32)";VIŠČIUKŲ;8392147716;Ne;3;0;0;3
2040;"Gervelė (Dzūkų g. 32)";VIŠČIUKŲ;6254125398;Ne;10;0;5;15
2041;"Gilužis (Vydūno g. 11A)";Skruzdėliukų;9707968228;Taip;5;1;0;6
2042;"Gilužis (Vydūno g. 11A)";Skruzdėliukų;8628253655;Ne;5;3;0;8
2043;"Gilužis (Vydūno g. 11A)";Skruzdėliukų;9783700319;Ne;15;0;0;15
2044;"Gilužis (Vydūno g. 11A)";Skruzdėliukų;4509741536;Ne;0;4;0;4
2045;"Gilužis (Vydūno g. 11A)";Skruzdėliukų;2221786284;Ne;4;0;0;4
2046;"Gilužis (Vydūno g. 11A)";Skruzdėliukų;3002266577;Ne;1;2;0;3
2047;"Gilužis (Vydūno g. 11A)";Skruzdėliukų;5190752112;Ne;7;3;0;10
2048;"Gilužis (Vydūno g. 11A)";Skruzdėliukų;2440762487;Ne;7;3;0;10
2049;"Gilužis (Vydūno g. 11A)";Skruzdėliukų;9104005195;Ne;5;1;0;6
2050;"Gilužis (Vydūno g. 11A)";Skruzdėliukų;5394693502;Ne;6;0;0;6
2051;"Gilužis (Vydūno g. 11A)";Skruzdėliukų;4106792355;Ne;1;0;0;1
2052;"Gilužis (Vydūno g. 11A)";Skruzdėliukų;4876074981;Ne;4;1;0;5
2053;"Gilužis (Vydūno g. 11A)";Skruzdėliukų;2633680406;Ne;0;8;0;8
2054;"Gilužis (Vydūno g. 11A)";Skruzdėliukų;4455977087;Ne;5;0;0;5
2055;"Gilužis (Vydūno g. 11A)";Skruzdėliukų;1085130813;Ne;0;3;0;3
2056;"Gilužis (Vydūno g. 11A)";Skruzdėliukų;2615087717;Ne;6;0;0;6
2057;"Gilužis (Vydūno g. 11A)";Skruzdėliukų;2516315604;Ne;8;1;0;9
2058;"Gilužis (Vydūno g. 11A)";Skruzdėliukų;2706629834;Ne;0;5;0;5
2059;"Gilužis (Vydūno g. 11A)";Skruzdėliukų;5556674867;Ne;1;0;0;1
2060;"Gilužis (Vydūno g. 11A)";Skruzdėliukų;6831107153;Ne;3;0;0;3
2061;"Gilužis (Vydūno g. 11A)";Skruzdėliukų;8852862161;Ne;2;0;0;2
2062;"Gilužis (Vydūno g. 11A)";Skruzdėliukų;2955779117;Ne;4;0;0;4
2063;"Gilužis (Vydūno g. 11A)";Nykštukų;3132445117;Ne;0;3;0;3
2064;"Gilužis (Vydūno g. 11A)";Nykštukų;7937643339;Ne;7;0;0;7
2065;"Gilužis (Vydūno g. 11A)";Nykštukų;3473889426;Ne;0;2;0;2
2066;"Gilužis (Vydūno g. 11A)";Nykštukų;9362581908;Ne;0;2;0;2
2067;"Gilužis (Vydūno g. 11A)";Nykštukų;8899557365;Ne;0;0;1;1
2068;"Gilužis (Vydūno g. 11A)";Nykštukų;2661894041;Ne;7;2;0;9
2069;"Gilužis (Vydūno g. 11A)";Nykštukų;5109935385;Ne;0;2;0;2
2070;"Gilužis (Vydūno g. 11A)";Nykštukų;7228498662;Ne;0;1;0;1
2071;"Gilužis (Vydūno g. 11A)";Nykštukų;1459273692;Ne;0;2;0;2
2072;"Gilužis (Vydūno g. 11A)";Nykštukų;4156613717;Ne;0;4;0;4
2073;"Gilužis (Vydūno g. 11A)";Nykštukų;5713786735;Ne;0;1;0;1
2074;"Gilužis (Vydūno g. 11A)";Nykštukų;6315155554;Ne;0;1;0;1
2075;"Gilužis (Vydūno g. 11A)";Nykštukų;8522552650;Ne;6;1;0;7
2076;"Gilužis (Vydūno g. 11A)";Nykštukų;3176305306;Ne;1;2;0;3
2077;"Gilužis (Vydūno g. 11A)";Nykštukų;4094486541;Ne;0;1;0;1
2078;"Gilužis (Vydūno g. 11A)";Nykštukų;6493142538;Ne;1;1;0;2
2079;"Gilužis (Vydūno g. 11A)";Bitučių;4841014668;Ne;2;2;0;4
2080;"Gilužis (Vydūno g. 11A)";Bitučių;1634295583;Ne;0;5;0;5
2081;"Gilužis (Vydūno g. 11A)";Bitučių;4360261750;Ne;0;5;0;5
2082;"Gilužis (Vydūno g. 11A)";Bitučių;5728341732;Taip;4;7;0;11
2083;"Gilužis (Vydūno g. 11A)";Bitučių;2780710383;Taip;4;0;0;4
2084;"Gilužis (Vydūno g. 11A)";Bitučių;6931726275;Ne;0;1;0;1
2085;"Gilužis (Vydūno g. 11A)";Bitučių;1867185320;Ne;2;10;0;12
2086;"Gilužis (Vydūno g. 11A)";Bitučių;3429435736;Ne;6;0;0;6
2087;"Gilužis (Vydūno g. 11A)";Bitučių;8539946703;Taip;0;21;0;21
2088;"Gilužis (Vydūno g. 11A)";Bitučių;9000351000;Ne;4;4;0;8
2089;"Gilužis (Vydūno g. 11A)";Bitučių;5366174839;Ne;1;2;0;3
2090;"Gilužis (Vydūno g. 11A)";Bitučių;5162397237;Ne;0;21;0;21
2091;"Gilužis (Vydūno g. 11A)";Bitučių;7250617867;Ne;0;2;0;2
2092;"Gilužis (Vydūno g. 11A)";Bitučių;9053608903;Ne;0;10;0;10
2093;"Gilužis (Vydūno g. 11A)";Bitučių;6115776872;Ne;0;0;6;6
2094;"Gilužis (Vydūno g. 11A)";Bitučių;5651799121;Ne;0;0;4;4
2095;"Gilužis (Vydūno g. 11A)";Bitučių;2950813185;Ne;0;4;0;4
2096;"Gilužis (Vydūno g. 11A)";Bitučių;6515525848;Ne;0;4;0;4
2097;"Gilužis (Vydūno g. 11A)";Bitučių;2345403784;Ne;0;0;1;1
2098;"Gilužis (Vydūno g. 11A)";Kačiukų;1273655212;Ne;3;1;0;4
2099;"Gilužis (Vydūno g. 11A)";Kačiukų;4978922821;Ne;8;0;0;8
2100;"Gilužis (Vydūno g. 11A)";Kačiukų;2945406185;Ne;8;0;0;8
2101;"Gilužis (Vydūno g. 11A)";Kačiukų;1582241363;Ne;9;0;1;10
2102;"Gilužis (Vydūno g. 11A)";Kačiukų;7330938312;Ne;14;0;0;14
2103;"Gilužis (Vydūno g. 11A)";Kačiukų;6571132974;Ne;0;21;0;21
2104;"Gilužis (Vydūno g. 11A)";Kačiukų;7001112696;Ne;0;0;1;1
2105;"Gilužis (Vydūno g. 11A)";Kačiukų;9034842169;Ne;5;0;0;5
2106;"Gilužis (Vydūno g. 11A)";Kačiukų;6966795180;Ne;0;8;0;8
2107;"Gilužis (Vydūno g. 11A)";Kačiukų;5128383851;Ne;8;0;0;8
2108;"Gilužis (Vydūno g. 11A)";Kačiukų;8318405114;Ne;11;0;0;11
2109;"Gilužis (Vydūno g. 11A)";Kačiukų;7826015897;Ne;10;0;0;10
2110;"Gilužis (Vydūno g. 11A)";Kačiukų;4403218878;Ne;1;9;0;10
2111;"Gilužis (Vydūno g. 11A)";Kačiukų;3419281756;Ne;6;0;0;6
2112;"Gilužis (Vydūno g. 11A)";Kačiukų;1862524255;Ne;0;0;1;1
2113;"Gilužis (Vydūno g. 11A)";Kačiukų;9421351780;Ne;10;0;0;10
2114;"Gilužis (Vydūno g. 11A)";Kačiukų;6404411477;Ne;0;1;0;1
2115;"Gilužis (Vydūno g. 11A)";Kačiukų;4128387076;Ne;7;0;0;7
2116;"Gilužis (Vydūno g. 11A)";Kačiukų;7042664923;Ne;8;0;1;9
2117;"Gilužis (Vydūno g. 11A)";Kačiukų;9097165155;Ne;10;0;0;10
2118;"Gilužis (Vydūno g. 11A)";Kačiukų;8762534617;Ne;10;7;0;17
2119;"Gilužis (Vydūno g. 11A)";Kačiukų;5641406427;Ne;5;0;1;6
2120;"Gilužis (Vydūno g. 11A)";Pelėdžiukų;5217748032;Ne;0;15;0;15
2121;"Gilužis (Vydūno g. 11A)";Pelėdžiukų;7998695149;Ne;10;0;0;10
2122;"Gilužis (Vydūno g. 11A)";Pelėdžiukų;7742783427;Ne;9;0;0;9
2123;"Gilužis (Vydūno g. 11A)";Pelėdžiukų;7358572344;Ne;9;1;0;10
2124;"Gilužis (Vydūno g. 11A)";Pelėdžiukų;4617259961;Ne;6;0;0;6
2125;"Gilužis (Vydūno g. 11A)";Pelėdžiukų;1222370750;Ne;5;2;0;7
2126;"Gilužis (Vydūno g. 11A)";Pelėdžiukų;9503516686;Ne;3;2;0;5
2127;"Gilužis (Vydūno g. 11A)";Pelėdžiukų;6270071724;Ne;0;10;0;10
2128;"Gilužis (Vydūno g. 11A)";Pelėdžiukų;4051726208;Ne;0;1;0;1
2129;"Gilužis (Vydūno g. 11A)";Pelėdžiukų;7092060789;Ne;5;0;0;5
2130;"Gilužis (Vydūno g. 11A)";Pelėdžiukų;4435227217;Ne;3;0;0;3
2131;"Gilužis (Vydūno g. 11A)";Pelėdžiukų;1804218972;Ne;0;2;0;2
2132;"Gilužis (Vydūno g. 11A)";Pelėdžiukų;3166161973;Ne;0;1;0;1
2133;"Gilužis (Vydūno g. 11A)";Pelėdžiukų;5070988982;Ne;6;0;0;6
2134;"Gilužis (Vydūno g. 11A)";Pelėdžiukų;7899274495;Ne;10;0;0;10
2135;"Gilužis (Vydūno g. 11A)";Pelėdžiukų;6093514885;Ne;4;1;0;5
2136;"Gilužis (Vydūno g. 11A)";Pelėdžiukų;2869506388;Ne;4;1;0;5
2137;"Gilužis (Vydūno g. 11A)";Pelėdžiukų;9520409342;Ne;7;0;0;7
2138;"Gilužis (Vydūno g. 11A)";Pelėdžiukų;9186274541;Ne;10;0;0;10
2139;"Gilužis (Vydūno g. 11A)";Drugelių;6121625070;Taip;5;1;0;6
2140;"Gilužis (Vydūno g. 11A)";Drugelių;1770064694;Taip;0;4;0;4
2141;"Gilužis (Vydūno g. 11A)";Drugelių;9591229878;Ne;0;12;0;12
2142;"Gilužis (Vydūno g. 11A)";Drugelių;9092013248;Ne;5;2;0;7
2143;"Gilužis (Vydūno g. 11A)";Drugelių;9109883577;Ne;10;0;0;10
2144;"Gilužis (Vydūno g. 11A)";Drugelių;8006465211;Ne;4;0;0;4
2145;"Gilužis (Vydūno g. 11A)";Drugelių;5118401707;Ne;1;0;0;1
2146;"Gilužis (Vydūno g. 11A)";Drugelių;3190597262;Ne;2;0;0;2
2147;"Gilužis (Vydūno g. 11A)";Drugelių;2988856911;Ne;1;0;0;1
2148;"Gilužis (Vydūno g. 11A)";Drugelių;3532863024;Ne;0;21;0;21
2149;"Gilužis (Vydūno g. 11A)";Drugelių;1376645277;Ne;11;0;0;11
2150;"Gilužis (Vydūno g. 11A)";Drugelių;1410870589;Ne;5;2;0;7
2151;"Gilužis (Vydūno g. 11A)";Drugelių;6786334223;Taip;8;0;0;8
2152;"Gilužis (Vydūno g. 11A)";Drugelių;9112993465;Ne;10;0;1;11
2153;"Gilužis (Vydūno g. 11A)";Drugelių;4909329417;Ne;1;2;1;4
2154;"Gilužis (Vydūno g. 11A)";Drugelių;8244385001;Ne;1;2;0;3
2155;"Gilužis (Vydūno g. 11A)";Drugelių;6429142049;Ne;3;0;0;3
2156;"Gilužis (Vydūno g. 11A)";Drugelių;7731169885;Taip;6;1;0;7
2157;"Gilužis (Vydūno g. 11A)";Drugelių;1093643746;Ne;0;1;0;1
2158;"Gilužis (Vydūno g. 11A)";Drugelių;3902713866;Ne;1;0;0;1
2159;"Gilužis (Vydūno g. 11A)";Drugelių;6950139609;Ne;4;0;2;6
2160;"Gilužis (Vydūno g. 11A)";Drugelių;2397231165;Taip;0;1;1;2
2161;"Gilužis (Vydūno g. 11A)";Saulučių;5705945483;Ne;0;5;0;5
2162;"Gilužis (Vydūno g. 11A)";Saulučių;8237963602;Taip;6;0;0;6
2163;"Gilužis (Vydūno g. 11A)";Saulučių;6914566889;Ne;0;0;1;1
2164;"Gilužis (Vydūno g. 11A)";Saulučių;5306278297;Taip;11;10;0;21
2165;"Gilužis (Vydūno g. 11A)";Saulučių;1054809163;Ne;2;6;3;11
2166;"Gilužis (Vydūno g. 11A)";Saulučių;7887970476;Ne;0;0;1;1
2167;"Gilužis (Vydūno g. 11A)";Saulučių;6507021182;Ne;4;0;1;5
2168;"Gilužis (Vydūno g. 11A)";Saulučių;4652281185;Ne;6;0;1;7
2169;"Gilužis (Vydūno g. 11A)";Saulučių;4122073923;Ne;2;0;0;2
2170;"Gilužis (Vydūno g. 11A)";Saulučių;2364391112;Ne;0;0;2;2
2171;"Gilužis (Vydūno g. 11A)";Saulučių;7068801003;Taip;0;0;1;1
2172;"Gilužis (Vydūno g. 11A)";Saulučių;3081351563;Ne;1;0;0;1
2173;"Gilužis (Vydūno g. 11A)";Saulučių;1015379578;Ne;1;0;0;1
2174;"Gilužis (Vydūno g. 11A)";Saulučių;7247606321;Ne;0;0;2;2
2175;"Gilužis (Vydūno g. 11A)";Saulučių;2915024298;Ne;0;0;3;3
2176;"Gilužis (Vydūno g. 11A)";Saulučių;8717811266;Ne;1;0;0;1
2177;"Gilužis (Vydūno g. 11A)";Saulučių;5769955074;Taip;0;7;0;7
2178;"Gilužis (Vydūno g. 11A)";Saulučių;7487731015;Taip;0;0;1;1
2179;"Gilužis (Vydūno g. 11A)";Saulučių;5079154238;Ne;0;0;1;1
2180;"Gilužis (Vydūno g. 11A)";Saulučių;5490128851;Ne;6;8;1;15
2181;"Gilužis (Vydūno g. 11A)";Saulučių;5784201106;Ne;5;0;0;5
2182;"Gilužis (Vydūno g. 11A)";Saulučių;8904873416;Ne;1;1;1;3
2183;"Gilužis (Vydūno g. 11A)";Saulučių;2851682356;Ne;1;0;0;1
2184;"Gilužis (Vydūno g. 11A)";Paukštelių;8662424856;Ne;0;1;0;1
2185;"Gilužis (Vydūno g. 11A)";Paukštelių;8110869130;Ne;0;5;0;5
2186;"Gilužis (Vydūno g. 11A)";Paukštelių;2883959240;Ne;0;2;5;7
2187;"Gilužis (Vydūno g. 11A)";Paukštelių;6322255194;Taip;11;0;0;11
2188;"Gilužis (Vydūno g. 11A)";Paukštelių;6572690788;Ne;0;0;1;1
2189;"Gilužis (Vydūno g. 11A)";Paukštelių;3646988912;Ne;2;0;0;2
2190;"Gilužis (Vydūno g. 11A)";Paukštelių;5030871828;Ne;0;0;7;7
2191;"Gilužis (Vydūno g. 11A)";Paukštelių;3954379433;Ne;0;2;0;2
2192;"Gilužis (Vydūno g. 11A)";Paukštelių;7307386173;Taip;0;1;0;1
2193;"Gilužis (Vydūno g. 11A)";Paukštelių;6478152041;Ne;0;1;0;1
2194;"Gilužis (Vydūno g. 11A)";Paukštelių;1005178052;Taip;6;0;1;7
2195;"Gilužis (Vydūno g. 11A)";Obuoliukų;8201769917;Ne;0;14;0;14
2196;"Gilužis (Vydūno g. 11A)";Obuoliukų;9892608223;Taip;0;5;0;5
2197;"Gilužis (Vydūno g. 11A)";Obuoliukų;4058698645;Ne;0;13;0;13
2198;"Gilužis (Vydūno g. 11A)";Obuoliukų;1540018160;Ne;11;0;0;11
2199;"Gilužis (Vydūno g. 11A)";Obuoliukų;7716908903;Ne;6;0;0;6
2200;"Gilužis (Vydūno g. 11A)";Obuoliukų;3131597174;Ne;5;0;0;5
2201;"Gilužis (Vydūno g. 11A)";Obuoliukų;6239369861;Ne;6;0;1;7
2202;"Gilužis (Vydūno g. 11A)";Obuoliukų;6172360933;Ne;1;1;0;2
2203;"Gilužis (Vydūno g. 11A)";Obuoliukų;7398446674;Ne;1;0;0;1
2204;"Gilužis (Vydūno g. 11A)";Obuoliukų;4592380105;Ne;6;0;0;6
2205;"Gilužis (Vydūno g. 11A)";Obuoliukų;4242362889;Ne;5;0;0;5
2206;"Gilužis (Vydūno g. 11A)";Obuoliukų;7560732216;Ne;5;0;0;5
2207;"Gilužis (Vydūno g. 11A)";Obuoliukų;5476140202;Ne;5;0;0;5
2208;"Gilužis (Vydūno g. 11A)";Obuoliukų;8194444043;Ne;2;0;0;2
2209;"Gilužis (Vydūno g. 11A)";Obuoliukų;6737884137;Ne;0;6;0;6
2210;"Gilužis (Vydūno g. 11A)";Obuoliukų;6825745985;Ne;11;2;0;13
2211;"Gilužis (Vydūno g. 11A)";Obuoliukų;3458957423;Ne;2;3;0;5
2212;"Gilužis (Vydūno g. 11A)";Obuoliukų;8900414658;Ne;0;3;0;3
2213;"Gilužis (Vydūno g. 11A)";Obuoliukų;3219101391;Taip;1;2;0;3
2214;"Gilužis (Vydūno g. 11A)";Obuoliukų;4528131001;Ne;1;7;0;8
2215;"Gilužis (Vydūno g. 11A)";Obuoliukų;5895659747;Ne;13;7;0;20
2216;"Gilužis (Vydūno g. 11A)";Obuoliukų;3331616067;Taip;3;0;0;3
2217;"Gilužis (Vydūno g. 11A)";KIŠKUČIŲ;5744027226;Ne;10;0;1;11
2218;"Gilužis (Vydūno g. 11A)";KIŠKUČIŲ;8639633038;Ne;0;0;2;2
2219;"Gilužis (Vydūno g. 11A)";KIŠKUČIŲ;5721924532;Ne;6;0;0;6
2220;"Gilužis (Vydūno g. 11A)";KIŠKUČIŲ;9484221435;Ne;5;1;0;6
2221;"Gilužis (Vydūno g. 11A)";KIŠKUČIŲ;6323747855;Ne;0;4;0;4
2222;"Gilužis (Vydūno g. 11A)";KIŠKUČIŲ;2680643896;Ne;7;0;0;7
2223;"Gilužis (Vydūno g. 11A)";KIŠKUČIŲ;5685074731;Ne;0;5;0;5
2224;"Gilužis (Vydūno g. 11A)";KIŠKUČIŲ;7632771776;Taip;6;0;1;7
2225;"Gilužis (Vydūno g. 11A)";KIŠKUČIŲ;9061835019;Ne;0;0;2;2
2226;"Gilužis (Vydūno g. 11A)";KIŠKUČIŲ;7560574633;Taip;7;0;0;7
2227;"Gilužis (Vydūno g. 11A)";KIŠKUČIŲ;4199633620;Ne;6;2;2;10
2228;"Gilužis (Vydūno g. 11A)";KIŠKUČIŲ;9851612698;Ne;6;0;1;7
2229;"Gilužis (Vydūno g. 11A)";KIŠKUČIŲ;1391410955;Taip;15;0;0;15
2230;"Gilužis (Vydūno g. 11A)";KIŠKUČIŲ;6383469680;Ne;0;10;0;10
2231;"Gilužis (Vydūno g. 11A)";KIŠKUČIŲ;8341597766;Taip;0;0;4;4
2232;"Gilužis (Vydūno g. 11A)";KIŠKUČIŲ;3171560628;Ne;2;0;0;2
2233;"Gilužis (Vydūno g. 11A)";KIŠKUČIŲ;4347319425;Ne;0;0;4;4
2234;"Gilužis (Vydūno g. 11A)";KIŠKUČIŲ;8591741716;Taip;6;1;0;7
2235;"Gilužis (Vydūno g. 11A)";KIŠKUČIŲ;8877445672;Ne;5;0;2;7
2236;"Gilužis (Vydūno g. 11A)";KIŠKUČIŲ;9489594782;Ne;6;0;0;6
2237;"Gilužis (Vydūno g. 11A)";Meškučių;7263432152;Taip;0;2;0;2
2238;"Gilužis (Vydūno g. 11A)";Meškučių;4655266106;Ne;0;1;0;1
2239;"Gilužis (Vydūno g. 11A)";Meškučių;3800593189;Ne;0;11;0;11
2240;"Gilužis (Vydūno g. 11A)";Meškučių;8393554697;Ne;10;2;0;12
2241;"Gilužis (Vydūno g. 11A)";Meškučių;8301535013;Ne;0;4;0;4
2242;"Gilužis (Vydūno g. 11A)";Meškučių;2939982311;Ne;0;8;0;8
2243;"Gilužis (Vydūno g. 11A)";Meškučių;3365778697;Ne;8;1;1;10
2244;"Gilužis (Vydūno g. 11A)";Meškučių;7912093880;Taip;11;1;0;12
2245;"Gilužis (Vydūno g. 11A)";Meškučių;2389277783;Ne;0;2;0;2
2246;"Gilužis (Vydūno g. 11A)";Meškučių;2500949029;Ne;0;8;0;8
2247;"Gilužis (Vydūno g. 11A)";Meškučių;4741129495;Ne;0;2;0;2
2248;"Gilužis (Vydūno g. 11A)";Meškučių;7992750316;Ne;0;21;0;21
2249;"Gilužis (Vydūno g. 11A)";Meškučių;5505153657;Ne;2;5;0;7
2250;"Gilužis (Vydūno g. 11A)";Meškučių;2577554894;Ne;7;0;0;7
2251;"Gilužis (Vydūno g. 11A)";Meškučių;3148477315;Ne;7;0;0;7
2252;"Gilužis (Vydūno g. 11A)";Meškučių;1068375927;Ne;8;0;2;10
2253;"Gilužis (Vydūno g. 11A)";Meškučių;8476240141;Ne;0;0;2;2
2254;"Gilužis (Vydūno g. 11A)";Meškučių;6185280967;Ne;6;1;0;7
2255;"Gilužis (Vydūno g. 11A)";Meškučių;5177805719;Taip;1;0;0;1
2256;"Gilužis (Vydūno g. 11A)";Meškučių;7045940267;Ne;10;0;0;10
2257;"Gilužis (Vydūno g. 11A)";Meškučių;5654754316;Ne;6;1;0;7
2258;"Gilužis (Vydūno g. 11A)";Pagrandukai;6884146146;Ne;8;3;0;11
2259;"Gilužis (Vydūno g. 11A)";Pagrandukai;6920910054;Ne;11;1;0;12
2260;"Gilužis (Vydūno g. 11A)";Pagrandukai;6501973647;Ne;1;2;0;3
2261;"Gilužis (Vydūno g. 11A)";Pagrandukai;5397975739;Ne;0;2;0;2
2262;"Gilužis (Vydūno g. 11A)";Pagrandukai;6109205159;Ne;7;0;0;7
2263;"Gilužis (Vydūno g. 11A)";Pagrandukai;2328338059;Ne;6;0;0;6
2264;"Gilužis (Vydūno g. 11A)";Pagrandukai;5376639182;Ne;0;11;0;11
2265;"Gilužis (Vydūno g. 11A)";Pagrandukai;5378701300;Ne;0;1;0;1
2266;"Gilužis (Vydūno g. 11A)";Pagrandukai;3366788027;Ne;0;1;0;1
2267;"Gilužis (Vydūno g. 11A)";Pagrandukai;5184511012;Ne;5;2;0;7
2268;"Gilužis (Vydūno g. 11A)";Pagrandukai;9587502317;Ne;5;2;0;7
2269;"Gilužis (Vydūno g. 11A)";Pagrandukai;5334441484;Ne;0;1;0;1
2270;"Gilužis (Vydūno g. 11A)";Pagrandukai;8477445384;Ne;4;2;0;6
2271;"Gilužis (Vydūno g. 11A)";Pagrandukai;1758670627;Ne;2;0;0;2
2272;"Gilužis (Vydūno g. 11A)";Pagrandukai;6766559505;Taip;0;1;0;1
2273;"Gilužis (Vydūno g. 11A)";Pagrandukai;5737505086;Ne;0;10;0;10
2274;"Gilužis (Vydūno g. 11A)";Pagrandukai;3729538163;Ne;0;1;0;1
2275;"Gilužis (Vydūno g. 11A)";Pagrandukai;6207304860;Ne;0;2;0;2
2276;"Gilužis (Vydūno g. 11A)";Pagrandukai;5921538837;Ne;4;2;0;6
2277;"Gilužis (Vydūno g. 11A)";Pagrandukai;9846916206;Taip;0;3;0;3
2278;"Gilužis (Vydūno g. 11A)";Pagrandukai;9325927745;Ne;2;9;0;11
2279;"Gilužis (Vydūno g. 11A)";Boružėlių;5581417252;Ne;8;1;2;11
2280;"Gilužis (Vydūno g. 11A)";Boružėlių;2819680099;Ne;0;1;0;1
2281;"Gilužis (Vydūno g. 11A)";Boružėlių;1209632075;Ne;2;0;0;2
2282;"Gilužis (Vydūno g. 11A)";Boružėlių;9753512366;Taip;5;6;0;11
2283;"Gilužis (Vydūno g. 11A)";Boružėlių;1541283216;Ne;5;0;1;6
2284;"Gilužis (Vydūno g. 11A)";Boružėlių;6514483362;Taip;2;1;1;4
2285;"Gilužis (Vydūno g. 11A)";Boružėlių;5664892047;Ne;4;0;1;5
2286;"Gilužis (Vydūno g. 11A)";Boružėlių;3379889899;Ne;5;1;0;6
2287;"Gilužis (Vydūno g. 11A)";Boružėlių;3917385813;Taip;2;0;0;2
2288;"Gilužis (Vydūno g. 11A)";Boružėlių;3194397689;Ne;0;8;0;8
2289;"Gilužis (Vydūno g. 11A)";Boružėlių;6586605929;Ne;6;1;1;8
2290;"Gilužis (Vydūno g. 11A)";Boružėlių;1826248450;Ne;2;0;0;2
2291;"Gilužis (Vydūno g. 11A)";Boružėlių;3279830266;Ne;12;0;0;12
2292;"Gilužis (Vydūno g. 11A)";Boružėlių;9676661005;Ne;12;2;0;14
2293;"Gilužis (Vydūno g. 11A)";Boružėlių;1306757860;Ne;12;2;0;14
2294;"Gilužis (Vydūno g. 11A)";Boružėlių;1604096952;Ne;1;0;0;1
2295;"Gilužis (Vydūno g. 11A)";Boružėlių;4266998302;Ne;6;1;0;7
2296;Giraitė;Aviliukas;4292730355;Ne;0;1;0;1
2297;Giraitė;Aviliukas;7001163828;Ne;0;0;1;1
2298;Giraitė;Aviliukas;6159650070;Ne;1;0;2;3
2299;Giraitė;Aviliukas;5275912609;Ne;0;1;0;1
2300;Giraitė;Aviliukas;2219854347;Ne;5;0;0;5
2301;Giraitė;Aviliukas;6315990604;Taip;17;0;4;21
2302;Giraitė;Aviliukas;2338867192;Ne;0;0;1;1
2303;Giraitė;Aviliukas;3719285343;Ne;0;2;3;5
2304;Giraitė;Aviliukas;3757900478;Ne;0;0;2;2
2305;Giraitė;Aviliukas;6121586335;Ne;0;0;6;6
2306;Giraitė;Aviliukas;4440444700;Ne;0;0;1;1
2307;Giraitė;Aviliukas;5356944812;Ne;2;0;6;8
2308;Giraitė;Aviliukas;4554565631;Ne;5;0;3;8
2309;Giraitė;LapiukaI;6141730004;Ne;2;0;0;2
2310;Giraitė;LapiukaI;6325909670;Ne;1;0;1;2
2311;Giraitė;LapiukaI;2740656695;Ne;11;0;0;11
2312;Giraitė;LapiukaI;5030697729;Ne;0;1;2;3
2313;Giraitė;LapiukaI;1921430434;Ne;0;1;0;1
2314;Giraitė;LapiukaI;4296449093;Taip;0;2;0;2
2315;Giraitė;LapiukaI;1974159110;Ne;4;0;2;6
2316;Giraitė;LapiukaI;5532639133;Ne;7;0;0;7
2317;Giraitė;LapiukaI;5902161665;Ne;5;0;0;5
2318;Giraitė;LapiukaI;4260343903;Taip;0;0;1;1
2319;Giraitė;LapiukaI;9088123796;Ne;1;0;2;3
2320;Giraitė;LapiukaI;7772177095;Ne;0;1;0;1
2321;Giraitė;LapiukaI;8492822889;Ne;6;1;0;7
2322;Giraitė;LapiukaI;9503157590;Ne;0;0;1;1
2323;Giraitė;LapiukaI;5471577047;Ne;0;0;1;1
2324;Giraitė;Voveriukai;8612554184;Ne;2;1;0;3
2325;Giraitė;Voveriukai;2064019596;Ne;3;0;0;3
2326;Giraitė;Voveriukai;8050306951;Ne;11;0;0;11
2327;Giraitė;Voveriukai;1262854023;Ne;2;0;0;2
2328;Giraitė;Voveriukai;7260229442;Ne;1;0;0;1
2329;Giraitė;Voveriukai;1126576745;Ne;6;0;0;6
2330;Giraitė;Voveriukai;4719547384;Ne;4;2;0;6
2331;Giraitė;Voveriukai;1772997796;Ne;10;0;1;11
2332;Giraitė;Voveriukai;4008393576;Ne;2;1;0;3
2333;Giraitė;Voveriukai;9281071794;Taip;5;0;1;6
2334;Giraitė;Voveriukai;9766107773;Ne;16;0;0;16
2335;Giraitė;Voveriukai;9386943162;Ne;3;0;0;3
2336;Giraitė;Voveriukai;3613828494;Ne;4;3;0;7
2337;Giraitė;Voveriukai;2686885139;Taip;1;0;0;1
2338;Giraitė;Voveriukai;9764802294;Ne;0;0;1;1
2339;Giraitė;Voveriukai;2726766768;Taip;6;0;1;7
2340;Giraitė;Voveriukai;6565165993;Ne;1;0;1;2
2341;Giraitė;Voveriukai;7392324344;Taip;4;10;0;14
2342;Giraitė;Grybukai;7354834895;Ne;0;0;1;1
2343;Giraitė;Grybukai;8799195526;Ne;0;4;0;4
2344;Giraitė;Grybukai;2177856916;Ne;0;1;0;1
2345;Giraitė;Grybukai;4137699629;Ne;3;0;0;3
2346;Giraitė;Grybukai;7919088987;Ne;0;0;1;1
2347;Giraitė;Grybukai;4773517160;Ne;1;0;0;1
2348;Giraitė;Grybukai;5616242311;Ne;0;0;2;2
2349;Giraitė;Grybukai;2074303013;Ne;0;0;1;1
2350;Giraitė;Grybukai;4932174149;Ne;0;1;0;1
2351;Giraitė;Grybukai;3875214088;Ne;0;9;0;9
2352;Giraitė;Grybukai;5202562049;Ne;0;4;1;5
2353;Giraitė;Grybukai;3607198556;Ne;0;0;3;3
2354;Giraitė;Grybukai;1583733838;Ne;0;1;0;1
2355;Giraitė;Riešutėliai;5365264259;Taip;0;0;1;1
2356;Giraitė;Riešutėliai;7179656901;Ne;6;1;0;7
2357;Giraitė;Riešutėliai;3158451613;Ne;7;0;0;7
2358;Giraitė;Riešutėliai;7910736839;Ne;0;0;6;6
2359;Giraitė;Riešutėliai;3308792461;Ne;0;0;6;6
2360;Giraitė;Riešutėliai;3116241918;Ne;0;7;0;7
2361;Giraitė;Riešutėliai;6838184704;Ne;10;2;0;12
2362;Giraitė;Riešutėliai;7566944002;Ne;6;0;0;6
2363;Giraitė;Riešutėliai;3839432744;Ne;1;0;0;1
2364;Giraitė;Riešutėliai;7803047658;Ne;0;3;0;3
2365;Giraitė;Riešutėliai;9144465313;Ne;0;0;1;1
2366;Giraitė;Riešutėliai;6288016799;Ne;2;0;0;2
2367;Giraitė;Riešutėliai;3278871662;Ne;0;2;1;3
2368;Giraitė;Riešutėliai;4168934880;Ne;0;1;2;3
2369;Giraitė;Riešutėliai;6337090583;Ne;0;0;4;4
2370;Giraitė;Riešutėliai;3843211767;Ne;0;0;7;7
2371;Giraitė;Meškiukai;5870376620;Ne;0;1;0;1
2372;Giraitė;Meškiukai;5447466102;Ne;0;6;0;6
2373;Giraitė;Meškiukai;5574589536;Ne;0;0;1;1
2374;Giraitė;Meškiukai;5876711899;Ne;4;0;0;4
2375;Giraitė;Meškiukai;9589760939;Ne;5;0;0;5
2376;Giraitė;Meškiukai;4500393769;Ne;4;0;0;4
2377;Giraitė;Meškiukai;3144724475;Taip;0;5;2;7
2378;Giraitė;Meškiukai;5525538498;Ne;0;17;0;17
2379;Giraitė;Meškiukai;2867735227;Ne;5;0;0;5
2380;Giraitė;Meškiukai;4681342624;Ne;6;7;0;13
2381;Giraitė;Meškiukai;6799728348;Taip;0;1;1;2
2382;Giraitė;Meškiukai;4431964254;Taip;3;1;2;6
2383;Giraitė;Meškiukai;9669849051;Ne;0;0;3;3
2384;Giraitė;Meškiukai;4946664007;Ne;5;0;1;6
2385;Giraitė;Meškiukai;1170698327;Ne;4;10;0;14
2386;Giraitė;Meškiukai;6865072274;Ne;15;0;1;16
2387;Giraitė;Meškiukai;3108521607;Ne;0;11;0;11
2388;Giraitė;Meškiukai;3612494313;Ne;4;4;0;8
2389;Giraitė;Meškiukai;2076989836;Ne;5;0;0;5
2390;Giraitė;Meškiukai;8139743188;Taip;8;1;0;9
2391;Giraitė;Uogelės;9927102264;Ne;6;0;0;6
2392;Giraitė;Uogelės;4121361794;Ne;0;0;1;1
2393;Giraitė;Uogelės;4843415587;Ne;0;1;0;1
2394;Giraitė;Uogelės;2732715332;Ne;0;0;1;1
2395;Giraitė;Uogelės;2307307454;Ne;1;0;0;1
2396;Giraitė;Uogelės;2102237550;Ne;0;2;3;5
2397;Giraitė;Uogelės;6065010363;Ne;0;0;1;1
2398;Giraitė;Uogelės;7094750784;Taip;0;11;0;11
2399;Giraitė;Uogelės;4009092043;Ne;2;0;0;2
2400;Giraitė;Uogelės;1356340471;Ne;6;0;1;7
2401;Giraitė;Uogelės;7377939409;Ne;5;0;1;6
2402;Giraitė;Uogelės;4288937528;Ne;4;0;0;4
2403;Giraitė;Uogelės;3643426944;Ne;0;0;3;3
2404;Giraitė;Šaltinėlis;3334974747;Ne;4;0;2;6
2405;Giraitė;Šaltinėlis;1125576830;Ne;0;0;5;5
2406;Giraitė;Šaltinėlis;2223501723;Ne;3;0;0;3
2407;Giraitė;Šaltinėlis;3262098794;Ne;5;0;1;6
2408;Giraitė;Šaltinėlis;8938565070;Ne;0;1;0;1
2409;Giraitė;Šaltinėlis;4094300540;Ne;2;1;4;7
2410;Giraitė;Šaltinėlis;3978249830;Ne;0;0;1;1
2411;Giraitė;Šaltinėlis;7831610906;Taip;8;0;1;9
2412;Giraitė;Šaltinėlis;9566341270;Ne;6;0;0;6
2413;Giraitė;Šaltinėlis;8928574407;Ne;0;0;1;1
2414;Giraitė;Šaltinėlis;6897620778;Ne;6;0;0;6
2415;Giraitė;Šaltinėlis;2652478107;Ne;1;1;2;4
2416;Giraitė;Šaltinėlis;3498087339;Ne;0;0;2;2
2417;Giraitė;Boružėlės;8552588816;Ne;5;0;0;5
2418;Giraitė;Boružėlės;2782467129;Ne;4;0;0;4
2419;Giraitė;Boružėlės;7149126803;Ne;7;0;0;7
2420;Giraitė;Boružėlės;6989400181;Ne;10;0;0;10
2421;Giraitė;Boružėlės;8163272129;Ne;3;0;0;3
2422;Giraitė;Boružėlės;2463291913;Ne;10;0;0;10
2423;Giraitė;Boružėlės;9611196852;Ne;0;2;0;2
2424;Giraitė;Boružėlės;2483204684;Ne;9;0;0;9
2425;Giraitė;Boružėlės;4876614491;Ne;0;2;0;2
2426;Giraitė;Boružėlės;2344506210;Ne;7;0;0;7
2427;Giraitė;Gandriukai;8525380061;Ne;1;2;1;4
2428;Giraitė;Gandriukai;7008670489;Ne;0;1;0;1
2429;Giraitė;Gandriukai;6277788515;Ne;0;0;1;1
2430;Giraitė;Gandriukai;7767820565;Ne;12;0;0;12
2431;Giraitė;Gandriukai;8819218663;Ne;1;0;0;1
2432;Giraitė;Gandriukai;7269074498;Ne;1;0;0;1
2433;Giraitė;Gandriukai;1490748887;Taip;1;0;0;1
2434;Giraitė;Gandriukai;7789414361;Ne;6;1;0;7
2435;Giraitė;Gandriukai;9850432917;Ne;5;0;0;5
2436;Giraitė;Gandriukai;8101302584;Taip;9;0;0;9
2437;Giraitė;Gandriukai;3027761044;Ne;2;0;0;2
2438;Giraitė;Gandriukai;4371263826;Ne;0;0;1;1
2439;Giraitė;Gandriukai;1227555563;Ne;3;0;0;3
2440;Giraitė;ŽVIRBLIUKAI;7395332578;Ne;11;0;0;11
2441;Giraitė;ŽVIRBLIUKAI;5086296808;Ne;0;7;0;7
2442;Giraitė;ŽVIRBLIUKAI;9669916418;Ne;0;2;3;5
2443;Giraitė;ŽVIRBLIUKAI;3481695682;Ne;0;20;0;20
2444;Giraitė;ŽVIRBLIUKAI;7551981095;Ne;8;0;1;9
2445;Giraitė;ŽVIRBLIUKAI;7678134658;Ne;0;0;2;2
2446;Giraitė;ŽVIRBLIUKAI;9471560738;Ne;0;1;0;1
2447;Giraitė;ŽVIRBLIUKAI;7230351549;Ne;6;0;1;7
2448;Giraitė;ŽVIRBLIUKAI;2416162886;Ne;2;0;2;4
2449;Giraitė;ŽVIRBLIUKAI;7543605905;Ne;1;11;0;12
2450;Giraitė;ŽVIRBLIUKAI;8128401630;Ne;5;0;0;5
2451;Giraitė;ŽVIRBLIUKAI;4233170371;Ne;0;0;2;2
2452;Giraitė;ŽVIRBLIUKAI;8871979627;Ne;0;5;2;7
2453;Giraitė;ŽVIRBLIUKAI;3214528809;Ne;0;0;3;3
2454;Giraitė;ŽVIRBLIUKAI;5548434439;Ne;0;9;0;9
2455;Giraitė;ŽVIRBLIUKAI;4450822125;Ne;0;0;1;1
2456;Giraitė;Kiškeliai;8259691835;Ne;11;0;1;12
2457;Giraitė;Kiškeliai;8782435144;Ne;0;0;4;4
2458;Giraitė;Kiškeliai;3457058930;Ne;0;0;3;3
2459;Giraitė;Kiškeliai;8787203512;Ne;0;0;2;2
2460;Giraitė;Kiškeliai;5364415038;Ne;0;0;1;1
2461;Giraitė;Kiškeliai;9503522932;Ne;0;0;3;3
2462;Giraitė;Kiškeliai;8869418518;Ne;2;0;2;4
2463;Giraitė;Kiškeliai;4964803735;Ne;6;0;2;8
2464;Giraitė;Kiškeliai;4858846263;Ne;0;0;3;3
2465;Giraitė;Kiškeliai;8148626841;Ne;1;0;4;5
2466;Giraitė;Kiškeliai;6346936964;Ne;0;0;2;2
2467;Gudrutis;Gandriukų;3264829331;Ne;3;0;0;3
2468;Gudrutis;Gandriukų;7143849852;Ne;7;0;1;8
2469;Gudrutis;Gandriukų;4600814480;Ne;5;0;0;5
2470;Gudrutis;Gandriukų;5931281687;Ne;3;0;0;3
2471;Gudrutis;Gandriukų;5498218329;Ne;0;3;0;3
2472;Gudrutis;Gandriukų;9454206104;Ne;2;1;1;4
2473;Gudrutis;Gandriukų;5911423362;Ne;1;1;1;3
2474;Gudrutis;Gandriukų;3316297441;Ne;0;5;0;5
2475;Gudrutis;Gandriukų;1170008457;Ne;5;0;0;5
2476;Gudrutis;Gandriukų;7930414623;Ne;4;0;0;4
2477;Gudrutis;Gandriukų;7531077386;Ne;0;11;0;11
2478;Gudrutis;Gandriukų;2278368966;Ne;5;0;1;6
2479;Gudrutis;Gandriukų;3000289515;Ne;4;0;0;4
2480;Gudrutis;Gandriukų;2256458624;Ne;3;0;0;3
2481;Gudrutis;Gandriukų;2784392885;Ne;12;0;0;12
2482;Gudrutis;Gandriukų;1588396018;Ne;0;0;1;1
2483;Gudrutis;Gandriukų;5257913623;Ne;5;0;0;5
2484;Gudrutis;"Saulės zuikučių";7934673005;Ne;4;0;0;4
2485;Gudrutis;"Saulės zuikučių";1670550212;Taip;7;1;0;8
2486;Gudrutis;"Saulės zuikučių";5241856014;Taip;0;0;1;1
2487;Gudrutis;"Saulės zuikučių";1225698076;Ne;0;1;1;2
2488;Gudrutis;"Saulės zuikučių";8500911420;Ne;10;0;0;10
2489;Gudrutis;"Saulės zuikučių";5408444872;Ne;5;0;2;7
2490;Gudrutis;"Saulės zuikučių";9041133527;Ne;8;0;0;8
2491;Gudrutis;"Saulės zuikučių";8621229735;Ne;5;10;0;15
2492;Gudrutis;"Saulės zuikučių";9697445037;Ne;0;0;1;1
2493;Gudrutis;"Saulės zuikučių";3281890659;Ne;0;2;0;2
2494;Gudrutis;"Saulės zuikučių";2291393238;Ne;1;0;0;1
2495;Gudrutis;"Saulės zuikučių";5585248878;Ne;6;0;0;6
2496;Gudrutis;"Saulės zuikučių";1384696362;Ne;5;0;1;6
2497;Gudrutis;"Saulės zuikučių";2666772437;Ne;8;0;0;8
2498;Gudrutis;"Saulės zuikučių";9044566825;Taip;6;0;1;7
2499;Gudrutis;"Saulės zuikučių";9683107780;Ne;2;0;0;2
2500;Gudrutis;"Saulės zuikučių";1197649093;Ne;0;0;4;4
2501;Gudrutis;Pelėdžiukų;7955353991;Ne;0;1;0;1
2502;Gudrutis;Pelėdžiukų;2197278086;Ne;0;3;0;3
2503;Gudrutis;Pelėdžiukų;6358318238;Ne;0;2;5;7
2504;Gudrutis;Pelėdžiukų;8774935740;Taip;0;3;3;6
2505;Gudrutis;Pelėdžiukų;4844838728;Ne;0;2;1;3
2506;Gudrutis;Pelėdžiukų;1685531183;Ne;0;0;2;2
2507;Gudrutis;Pelėdžiukų;9253468183;Ne;0;6;0;6
2508;Gudrutis;Pelėdžiukų;7755882832;Ne;0;1;0;1
2509;Gudrutis;Pelėdžiukų;9297898193;Taip;0;12;1;13
2510;Gudrutis;Pelėdžiukų;7663746093;Ne;4;2;1;7
2511;Gudrutis;Pelėdžiukų;9784116399;Taip;11;0;1;12
2512;Gudrutis;Pelėdžiukų;8512130106;Ne;0;2;1;3
2513;Gudrutis;Pelėdžiukų;3919786807;Taip;17;0;0;17
2514;Gudrutis;Pelėdžiukų;1485530468;Ne;0;0;1;1
2515;Gudrutis;Pelėdžiukų;8598450150;Ne;18;0;0;18
2516;Gudrutis;Pelėdžiukų;2484715724;Ne;18;0;0;18
2517;Gudrutis;Pelėdžiukų;2118820249;Ne;0;0;1;1
2518;Gudrutis;Pelėdžiukų;5508723821;Ne;7;2;0;9
2519;Gudrutis;BITUČIŲ;6700254479;Ne;7;0;4;11
2520;Gudrutis;BITUČIŲ;2293472716;Ne;0;0;7;7
2521;Gudrutis;BITUČIŲ;6835038962;Ne;0;0;5;5
2522;Gudrutis;BITUČIŲ;2118727861;Ne;0;0;2;2
2523;Gudrutis;BITUČIŲ;9701111916;Ne;2;0;3;5
2524;Gudrutis;BITUČIŲ;1725920873;Ne;1;0;2;3
2525;Gudrutis;BITUČIŲ;1901358996;Ne;1;0;0;1
2526;Gudrutis;BITUČIŲ;9847597133;Ne;0;11;0;11
2527;Gudrutis;BITUČIŲ;3646335609;Ne;0;0;5;5
2528;Gudrutis;BITUČIŲ;7871991275;Ne;0;0;1;1
2529;Gudrutis;BITUČIŲ;5580618896;Ne;0;0;1;1
2530;Gudrutis;BITUČIŲ;2468434676;Ne;0;0;1;1
2531;Gudrutis;BITUČIŲ;3625838131;Ne;0;1;0;1
2532;Gudrutis;BITUČIŲ;2337493193;Ne;0;5;0;5
2533;Gudrutis;BITUČIŲ;2408038213;Ne;3;0;1;4
2534;Gudrutis;BITUČIŲ;2764843216;Ne;1;1;0;2
2535;Gudrutis;BITUČIŲ;1012579870;Ne;0;0;7;7
2536;Gudrutis;Boružėlių;4623428212;Ne;10;0;1;11
2537;Gudrutis;Boružėlių;9893732913;Ne;7;0;1;8
2538;Gudrutis;Boružėlių;2807547699;Ne;13;0;0;13
2539;Gudrutis;Boružėlių;6326258371;Ne;4;0;0;4
2540;Gudrutis;Boružėlių;7033634744;Ne;8;1;0;9
2541;Gudrutis;Boružėlių;5748775407;Ne;5;0;0;5
2542;Gudrutis;Boružėlių;8296416202;Ne;5;0;0;5
2543;Gudrutis;Boružėlių;3959030593;Ne;5;0;0;5
2544;Gudrutis;Boružėlių;4672748361;Ne;11;0;0;11
2545;Gudrutis;Boružėlių;8081931247;Ne;11;0;0;11
2546;Gudrutis;Boružėlių;5382755416;Ne;6;0;0;6
2547;Gudrutis;Boružėlių;4546694746;Ne;10;0;0;10
2548;Gudrutis;Boružėlių;9948022627;Ne;15;0;1;16
2549;Gudrutis;Boružėlių;4540855641;Ne;0;0;1;1
2550;Gudrutis;Boružėlių;4691454736;Ne;10;0;2;12
2551;Gudrutis;Drugeliai;2497248749;Ne;7;0;0;7
2552;Gudrutis;Drugeliai;3797656483;Ne;0;0;1;1
2553;Gudrutis;Drugeliai;9200644104;Ne;0;0;1;1
2554;Gudrutis;Drugeliai;9096764346;Ne;0;2;0;2
2555;Gudrutis;Drugeliai;5306281458;Ne;3;0;2;5
2556;Gudrutis;Drugeliai;8783180638;Ne;3;0;2;5
2557;Gudrutis;Drugeliai;1737001982;Ne;5;0;0;5
2558;Gudrutis;Drugeliai;8525851058;Ne;3;0;0;3
2559;Gudrutis;Drugeliai;8080976400;Ne;0;0;2;2
2560;Gudrutis;Drugeliai;6101410750;Ne;0;2;0;2
2561;Gudrutis;Drugeliai;5710348070;Ne;0;0;11;11
2562;Gudrutis;Drugeliai;8843761360;Ne;0;0;11;11
2563;Gudrutis;Drugeliai;5590297232;Ne;7;0;3;10
2564;Gudrutis;Drugeliai;2827279258;Ne;0;10;0;10
2565;Gudrutis;Drugeliai;5093267385;Ne;3;0;4;7
2566;Gudrutis;Drugeliai;1364145110;Ne;6;0;2;8
2567;Gudrutis;Drugeliai;8803747496;Ne;0;0;3;3
2568;Gudrutis;Drugeliai;9714712791;Ne;0;0;2;2
2569;Gudrutis;Drugeliai;6268669142;Taip;5;0;1;6
2570;Jurginėlis;Ąžuoliukai;7309052653;Ne;21;0;0;21
2571;Jurginėlis;Ąžuoliukai;8571054905;Ne;0;10;0;10
2572;Jurginėlis;Ąžuoliukai;6168508647;Ne;13;0;1;14
2573;Jurginėlis;Ąžuoliukai;5861832676;Ne;0;7;0;7
2574;Jurginėlis;Ąžuoliukai;3933113321;Ne;0;10;0;10
2575;Jurginėlis;Ąžuoliukai;5861418459;Ne;0;11;0;11
2576;Jurginėlis;Ąžuoliukai;5869170503;Ne;0;0;1;1
2577;Jurginėlis;Ąžuoliukai;6202225321;Ne;0;1;0;1
2578;Jurginėlis;Ąžuoliukai;7081618073;Ne;0;1;0;1
2579;Jurginėlis;Ąžuoliukai;6851855147;Ne;0;0;1;1
2580;Jurginėlis;Ąžuoliukai;6153432639;Ne;3;0;0;3
2581;Jurginėlis;Ąžuoliukai;8174251359;Ne;2;0;3;5
2582;Jurginėlis;Ąžuoliukai;2447025385;Ne;1;8;2;11
2583;Jurginėlis;Ąžuoliukai;5313627252;Ne;4;3;1;8
2584;Jurginėlis;Žiogeliai;8159210242;Ne;6;12;0;18
2585;Jurginėlis;Žiogeliai;7251598691;Ne;0;6;0;6
2586;Jurginėlis;Žiogeliai;6906225772;Ne;9;2;0;11
2587;Jurginėlis;Žiogeliai;7010130915;Ne;0;5;0;5
2588;Jurginėlis;Žiogeliai;7907096012;Ne;0;10;0;10
2589;Jurginėlis;Žiogeliai;7250246853;Ne;0;5;0;5
2590;Jurginėlis;Žiogeliai;7300018733;Ne;6;0;0;6
2591;Jurginėlis;Žiogeliai;4674128568;Ne;0;5;0;5
2592;Jurginėlis;Žiogeliai;9305884152;Ne;1;4;0;5
2593;Jurginėlis;Žiogeliai;9716328349;Ne;16;3;0;19
2594;Jurginėlis;Žiogeliai;4441183185;Ne;1;1;0;2
2595;Jurginėlis;Žiogeliai;9563102730;Taip;5;1;0;6
2596;Jurginėlis;Žiogeliai;4502564783;Ne;3;4;0;7
2597;Jurginėlis;Žiogeliai;1937927553;Ne;2;1;0;3
2598;Jurginėlis;Žiogeliai;7527178332;Ne;4;1;0;5
2599;Jurginėlis;Žiogeliai;4682125116;Ne;6;3;0;9
2600;Jurginėlis;Žiogeliai;3920971621;Ne;7;2;0;9
2601;Jurginėlis;Pelėdžiukų;1303323955;Ne;0;10;0;10
2602;Jurginėlis;Pelėdžiukų;4466955830;Ne;0;21;0;21
2603;Jurginėlis;Pelėdžiukų;6285599044;Ne;12;0;0;12
2604;Jurginėlis;Pelėdžiukų;5043815909;Ne;0;6;0;6
2605;Jurginėlis;Pelėdžiukų;9901171406;Ne;1;0;0;1
2606;Jurginėlis;Pelėdžiukų;4233910766;Ne;5;0;0;5
2607;Jurginėlis;Pelėdžiukų;6594025023;Ne;0;2;0;2
2608;Jurginėlis;Pelėdžiukų;6124147401;Ne;4;0;0;4
2609;Jurginėlis;Pelėdžiukų;9139025010;Ne;1;0;0;1
2610;Jurginėlis;Pelėdžiukų;7554346190;Taip;8;0;0;8
2611;Jurginėlis;Pelėdžiukų;4555257132;Taip;2;0;0;2
2612;Jurginėlis;Boružėlių;6806704355;Ne;1;0;0;1
2613;Jurginėlis;Boružėlių;3091019969;Taip;8;0;0;8
2614;Jurginėlis;Boružėlių;9288380246;Ne;6;0;0;6
2615;Jurginėlis;Boružėlių;2548920722;Ne;8;0;0;8
2616;Jurginėlis;Boružėlių;7288921301;Ne;5;0;0;5
2617;Jurginėlis;Boružėlių;2263818210;Ne;3;0;0;3
2618;Jurginėlis;Boružėlių;4827340942;Ne;2;0;0;2
2619;Jurginėlis;Boružėlių;4463258777;Ne;0;4;0;4
2620;Jurginėlis;Boružėlių;2225892248;Ne;5;1;0;6
2621;Jurginėlis;Boružėlių;6579565337;Ne;2;0;0;2
2622;Jurginėlis;Boružėlių;3462969423;Ne;0;5;0;5
2623;Jurginėlis;Boružėlių;7990015623;Ne;0;1;0;1
2624;Jurginėlis;Boružėlių;4158502752;Ne;0;1;0;1
2625;Jurginėlis;Boružėlių;5242359650;Taip;0;7;0;7
2626;Jurginėlis;Boružėlių;3284464951;Ne;0;5;0;5
2627;Jurginėlis;Bitučių;5984893389;Ne;0;4;0;4
2628;Jurginėlis;Bitučių;3079495897;Ne;1;2;2;5
2629;Jurginėlis;Bitučių;8727844649;Ne;0;0;7;7
2630;Jurginėlis;Bitučių;1455749921;Ne;0;6;0;6
2631;Jurginėlis;Bitučių;7809274980;Ne;0;6;0;6
2632;Jurginėlis;Bitučių;2417314519;Ne;7;0;0;7
2633;Jurginėlis;Bitučių;6968528293;Ne;0;2;0;2
2634;Jurginėlis;Bitučių;8779807396;Ne;0;1;1;2
2635;Jurginėlis;Bitučių;9760394658;Taip;2;0;1;3
2636;Jurginėlis;Bitučių;4967548277;Ne;9;0;0;9
2637;Jurginėlis;Bitučių;2925253653;Ne;0;10;0;10
2638;Jurginėlis;Bitučių;1340689348;Ne;0;0;1;1
2639;Jurginėlis;Bitučių;2221708420;Ne;0;1;1;2
2640;Jurginėlis;Bitučių;6181547354;Ne;12;1;0;13
2641;Jurginėlis;Bitučių;2490875633;Ne;3;12;1;16
2642;Jurginėlis;Bitučių;4689913361;Ne;0;0;2;2
2643;Jurginėlis;Skruzdeliukų;1351306981;Ne;2;5;0;7
2644;Jurginėlis;Skruzdeliukų;9146039217;Ne;0;1;0;1
2645;Jurginėlis;Skruzdeliukų;3558752347;Ne;0;5;0;5
2646;Jurginėlis;Skruzdeliukų;5734506036;Ne;8;0;0;8
2647;Jurginėlis;Skruzdeliukų;3699180485;Ne;5;0;0;5
2648;Jurginėlis;Skruzdeliukų;1634502874;Taip;14;0;0;14
2649;Jurginėlis;Skruzdeliukų;4981043400;Ne;4;0;0;4
2650;Jurginėlis;Skruzdeliukų;1763849354;Ne;0;1;0;1
2651;Jurginėlis;Skruzdeliukų;4944292549;Ne;3;2;0;5
2652;Jurginėlis;Skruzdeliukų;9506129699;Ne;7;1;0;8
2653;Jurginėlis;Skruzdeliukų;9550110246;Ne;2;0;0;2
2654;Jurginėlis;Skruzdeliukų;3822916547;Ne;21;0;0;21
2655;Jurginėlis;Skruzdeliukų;3541542063;Ne;0;0;2;2
2656;Jurginėlis;Skruzdeliukų;1204999684;Ne;7;1;0;8
2657;Jurginėlis;Skruzdeliukų;9937405742;Ne;4;0;0;4
2658;Jurginėlis;Skruzdeliukų;1726968598;Ne;0;16;0;16
2659;Jurginėlis;Skruzdeliukų;2332714713;Ne;5;10;0;15
2660;Jurginėlis;Skruzdeliukų;9961083854;Ne;0;1;0;1
2661;Jurginėlis;Skruzdeliukų;6542567172;Taip;6;3;0;9
2662;Jurginėlis;Drugelių;2025403481;Ne;4;1;1;6
2663;Jurginėlis;Drugelių;9065349248;Ne;6;8;0;14
2664;Jurginėlis;Drugelių;8341951659;Ne;7;4;0;11
2665;Jurginėlis;Drugelių;7795042485;Taip;6;0;2;8
2666;Jurginėlis;Drugelių;5138832895;Ne;6;0;0;6
2667;Jurginėlis;Drugelių;5751977493;Taip;7;0;0;7
2668;Jurginėlis;Drugelių;3466562781;Ne;2;0;1;3
2669;Jurginėlis;Drugelių;6068645621;Taip;0;8;0;8
2670;Jurginėlis;Drugelių;4276237094;Taip;14;1;0;15
2671;Jurginėlis;Drugelių;3527520303;Ne;2;0;0;2
2672;Jurginėlis;Drugelių;1208882528;Ne;0;0;2;2
2673;Jurginėlis;Drugelių;5874949368;Taip;15;0;0;15
2674;Jurginėlis;Drugelių;7349309693;Ne;0;4;0;4
2675;Jurginėlis;Drugelių;3063084253;Ne;9;0;0;9
2676;Jurginėlis;Drugelių;7409019574;Ne;6;2;0;8
2677;Jurginėlis;Drugelių;5928303681;Ne;3;0;1;4
2678;Jurginėlis;Drugelių;5476486516;Ne;6;0;0;6
2679;Jurginėlis;Drugelių;8536084383;Ne;2;0;0;2
2680;Jurginėlis;Žibučių;4979618298;Ne;2;0;0;2
2681;Jurginėlis;Žibučių;6636147085;Ne;0;1;2;3
2682;Jurginėlis;Žibučių;1438159631;Ne;0;1;0;1
2683;Jurginėlis;Žibučių;1336429135;Ne;6;0;0;6
2684;Jurginėlis;Žibučių;6948834218;Ne;16;0;4;20
2685;Jurginėlis;Žibučių;7721612113;Ne;2;0;3;5
2686;Jurginėlis;Žibučių;8111158692;Ne;1;0;0;1
2687;Jurginėlis;Žibučių;5936508522;Taip;15;6;0;21
2688;Jurginėlis;Žibučių;6717892969;Ne;3;2;0;5
2689;Jurginėlis;Žibučių;7977676733;Ne;2;0;0;2
2690;Jurginėlis;Žibučių;7530846375;Ne;2;0;0;2
2691;Jurginėlis;Žibučių;3861311860;Ne;6;1;0;7
2692;Jurginėlis;Žibučių;1263601087;Ne;4;1;1;6
2693;Jurginėlis;Žibučių;5549766339;Ne;0;11;0;11
2694;Jurginėlis;Žibučių;4429780802;Ne;0;1;0;1
2695;Jurginėlis;Žibučių;8968718021;Ne;9;3;0;12
2696;Jurginėlis;Žibučių;2782553941;Ne;12;0;1;13
2697;Jurginėlis;Žibučių;6259461257;Ne;2;0;0;2
2698;Jurginėlis;Žibučių;7252041334;Ne;4;0;4;8
2699;Jurginėlis;Zuikučių;4432849717;Ne;0;5;0;5
2700;Jurginėlis;Zuikučių;6587382160;Ne;0;2;1;3
2701;Jurginėlis;Zuikučių;8097652962;Ne;0;0;1;1
2702;Jurginėlis;Zuikučių;6671759364;Ne;0;6;0;6
2703;Jurginėlis;Zuikučių;8937404520;Ne;0;0;1;1
2704;Jurginėlis;Zuikučių;8161347781;Ne;0;9;0;9
2705;Jurginėlis;Zuikučių;4113264904;Taip;2;0;1;3
2706;Jurginėlis;Zuikučių;8117563141;Ne;0;10;0;10
2707;Jurginėlis;Zuikučių;5652597514;Taip;0;0;1;1
2708;Jurginėlis;Zuikučių;6341896288;Ne;0;0;1;1
2709;Jurginėlis;Zuikučių;4180071775;Ne;2;0;1;3
2710;Jurginėlis;Zuikučių;8017976529;Ne;15;0;0;15
2711;Jurginėlis;Zuikučių;3530906368;Ne;7;0;0;7
2712;Jurginėlis;Zuikučių;1582948463;Ne;0;0;1;1
2713;Jurginėlis;Viščiukų;1405338657;Ne;18;0;0;18
2714;Jurginėlis;Viščiukų;9366610698;Taip;13;0;0;13
2715;Jurginėlis;Viščiukų;8050408300;Ne;0;0;2;2
2716;Jurginėlis;Viščiukų;2378007686;Ne;17;0;0;17
2717;Jurginėlis;Viščiukų;3254001601;Ne;4;0;0;4
2718;Jurginėlis;Viščiukų;8050843105;Taip;2;0;1;3
2719;Jurginėlis;Viščiukų;6550401531;Taip;3;0;0;3
2720;Jurginėlis;Viščiukų;7684663210;Taip;3;0;0;3
2721;Jurginėlis;Viščiukų;6135184014;Ne;0;3;0;3
2722;Jurginėlis;Meškiukų;6584048242;Ne;4;0;0;4
2723;Jurginėlis;Meškiukų;8348637578;Ne;6;0;0;6
2724;Jurginėlis;Meškiukų;6266328957;Taip;9;0;0;9
2725;Jurginėlis;Meškiukų;7424513586;Ne;1;0;0;1
2726;Jurginėlis;Meškiukų;5945075337;Ne;3;0;0;3
2727;Jurginėlis;Meškiukų;5472986119;Ne;5;0;0;5
2728;Jurginėlis;Meškiukų;5105758563;Ne;6;0;0;6
2729;Jurginėlis;Meškiukų;7892411156;Ne;4;0;0;4
2730;Jurginėlis;Meškiukų;2967314352;Ne;4;0;0;4
2731;Jurginėlis;Meškiukų;7053226448;Ne;6;0;0;6
2732;Jurginėlis;Gandriukų;6306274502;Taip;13;0;0;13
2733;Jurginėlis;Gandriukų;9603380131;Ne;8;0;0;8
2734;Jurginėlis;Gandriukų;7193314762;Ne;0;5;2;7
2735;Jurginėlis;Gandriukų;4506484183;Ne;0;1;0;1
2736;Jurginėlis;Gandriukų;5474358669;Ne;20;0;1;21
2737;Jurginėlis;Gandriukų;3741447134;Ne;3;0;0;3
2738;Jurginėlis;Gandriukų;2595002682;Ne;9;0;1;10
2739;Jurginėlis;Gandriukų;5866358319;Taip;3;0;1;4
2740;Jurginėlis;Gandriukų;1598578487;Ne;0;0;1;1
2741;Jurginėlis;Gandriukų;4644476606;Taip;6;0;1;7
2742;Jurginėlis;Gandriukų;3230200231;Ne;10;2;0;12
2743;Jurginėlis;Gandriukų;7636442845;Ne;9;0;0;9
2744;Jurginėlis;Gandriukų;1286603999;Ne;0;0;2;2
2745;Jurginėlis;Gandriukų;4617952912;Ne;12;0;0;12
2746;Jurginėlis;Gandriukų;3672557409;Ne;0;0;1;1
2747;Jurginėlis;Gandriukų;1043529560;Ne;18;0;0;18
2748;Jurginėlis;Gandriukų;5688209539;Ne;5;0;0;5
2749;Jurginėlis;Gandriukų;2084877917;Ne;14;0;0;14
2750;Karuselė;PAGRANDUKAS;1621482372;Ne;7;3;0;10
2751;Karuselė;PAGRANDUKAS;3330374479;Ne;11;1;0;12
2752;Karuselė;PAGRANDUKAS;3984262482;Ne;3;0;0;3
2753;Karuselė;PAGRANDUKAS;9130534156;Ne;8;1;0;9
2754;Karuselė;PAGRANDUKAS;3660843696;Ne;0;3;0;3
2755;Karuselė;PAGRANDUKAS;5132581245;Ne;6;1;0;7
2756;Karuselė;PAGRANDUKAS;2412418335;Ne;5;1;0;6
2757;Karuselė;PAGRANDUKAS;7393434659;Ne;0;8;0;8
2758;Karuselė;PAGRANDUKAS;6252613489;Ne;0;13;0;13
2759;Karuselė;PAGRANDUKAS;6004882312;Ne;0;5;0;5
2760;Karuselė;PAGRANDUKAS;6856800484;Ne;2;10;0;12
2761;Karuselė;PAGRANDUKAS;3972815393;Taip;3;2;0;5
2762;Karuselė;PAGRANDUKAS;8157193503;Taip;0;3;0;3
2763;Karuselė;PAGRANDUKAS;9651192437;Taip;1;1;0;2
2764;Karuselė;PAGRANDUKAS;7916589127;Ne;0;1;0;1
2765;Karuselė;PAGRANDUKAS;7564618678;Ne;6;0;0;6
2766;Karuselė;PAGRANDUKAS;6546648346;Ne;0;4;0;4
2767;Karuselė;PAGRANDUKAS;8182071103;Ne;0;2;0;2
2768;Karuselė;NYKŠTUKAS;4966362343;Ne;6;2;0;8
2769;Karuselė;NYKŠTUKAS;9997776739;Ne;8;0;0;8
2770;Karuselė;NYKŠTUKAS;4445214427;Ne;0;8;0;8
2771;Karuselė;NYKŠTUKAS;9354431582;Ne;0;1;0;1
2772;Karuselė;NYKŠTUKAS;5216815933;Ne;0;2;0;2
2773;Karuselė;NYKŠTUKAS;7817417459;Ne;8;2;2;12
2774;Karuselė;NYKŠTUKAS;9654804545;Ne;0;11;0;11
2775;Karuselė;NYKŠTUKAS;1486577955;Ne;8;2;0;10
2776;Karuselė;NYKŠTUKAS;5697305819;Taip;3;2;2;7
2777;Karuselė;NYKŠTUKAS;8007341411;Ne;15;0;0;15
2778;Karuselė;NYKŠTUKAS;4363388969;Ne;0;21;0;21
2779;Karuselė;NYKŠTUKAS;4296509304;Ne;0;1;0;1
2780;Karuselė;NYKŠTUKAS;9243932017;Ne;0;2;1;3
2781;Karuselė;NYKŠTUKAS;5986973796;Ne;8;2;1;11
2782;Karuselė;NYKŠTUKAS;4856589410;Ne;0;6;0;6
2783;Karuselė;NYKŠTUKAS;9999461542;Ne;4;2;0;6
2784;Karuselė;NYKŠTUKAS;9385698812;Ne;0;1;0;1
2785;Karuselė;NYKŠTUKAS;9071878406;Ne;5;0;0;5
2786;Karuselė;BITUTĖ;8175498192;Ne;0;3;0;3
2787;Karuselė;BITUTĖ;7977133699;Taip;3;1;0;4
2788;Karuselė;BITUTĖ;6165548450;Taip;2;7;0;9
2789;Karuselė;BITUTĖ;4435125556;Ne;2;0;0;2
2790;Karuselė;BITUTĖ;3049506194;Ne;0;1;0;1
2791;Karuselė;BITUTĖ;7733032142;Ne;0;4;0;4
2792;Karuselė;BITUTĖ;1412890120;Ne;0;9;0;9
2793;Karuselė;BITUTĖ;4130693235;Ne;0;1;0;1
2794;Karuselė;BITUTĖ;9340167973;Ne;5;0;0;5
2795;Karuselė;BITUTĖ;6826455161;Ne;0;9;0;9
2796;Karuselė;BITUTĖ;2727440190;Ne;0;1;0;1
2797;Karuselė;BITUTĖ;2306922755;Ne;0;2;0;2
2798;Karuselė;BITUTĖ;6062361348;Ne;0;4;0;4
2799;Karuselė;BITUTĖ;2529641529;Ne;0;9;0;9
2800;Karuselė;BITUTĖ;4262640017;Ne;0;1;0;1
2801;Karuselė;BITUTĖ;6495631086;Ne;0;1;0;1
2802;Karuselė;BITUTĖ;2247913568;Ne;0;2;0;2
2803;Karuselė;BORUŽĖLĖ;7030946179;Ne;6;0;0;6
2804;Karuselė;BORUŽĖLĖ;2409274793;Ne;0;0;18;18
2805;Karuselė;BORUŽĖLĖ;9303194274;Ne;6;0;0;6
2806;Karuselė;BORUŽĖLĖ;7986277964;Ne;0;0;1;1
2807;Karuselė;BORUŽĖLĖ;5397256562;Ne;8;0;0;8
2808;Karuselė;BORUŽĖLĖ;8004953571;Ne;9;0;0;9
2809;Karuselė;BORUŽĖLĖ;8357973162;Ne;9;0;0;9
2810;Karuselė;BORUŽĖLĖ;8689140295;Taip;1;0;2;3
2811;Karuselė;BORUŽĖLĖ;7430518094;Ne;8;0;0;8
2812;Karuselė;BORUŽĖLĖ;9995800164;Ne;11;0;0;11
2813;Karuselė;BORUŽĖLĖ;8664628232;Ne;8;0;7;15
2814;Karuselė;BORUŽĖLĖ;8234778310;Ne;14;0;4;18
2815;Karuselė;BORUŽĖLĖ;7869324652;Ne;1;0;0;1
2816;Karuselė;BORUŽĖLĖ;5519366758;Ne;7;0;0;7
2817;Karuselė;BORUŽĖLĖ;6669293437;Ne;8;0;0;8
2818;Karuselė;UOGELĖ;1119373532;Taip;7;1;1;9
2819;Karuselė;UOGELĖ;2135332292;Ne;0;12;0;12
2820;Karuselė;UOGELĖ;8441520423;Ne;6;0;3;9
2821;Karuselė;UOGELĖ;9463553056;Ne;0;7;0;7
2822;Karuselė;UOGELĖ;8671884362;Ne;9;0;0;9
2823;Karuselė;UOGELĖ;4871960780;Ne;15;1;0;16
2824;Karuselė;UOGELĖ;3551143062;Ne;7;0;0;7
2825;Karuselė;UOGELĖ;8257771271;Ne;0;10;0;10
2826;Karuselė;UOGELĖ;7749015193;Ne;0;12;0;12
2827;Karuselė;UOGELĖ;2993499990;Ne;7;10;0;17
2828;Karuselė;UOGELĖ;3075592618;Ne;5;5;0;10
2829;Karuselė;UOGELĖ;2450390957;Ne;0;12;0;12
2830;Karuselė;UOGELĖ;7535451590;Ne;0;8;0;8
2831;Karuselė;UOGELĖ;4302662341;Ne;5;10;0;15
2832;Karuselė;UOGELĖ;4865727149;Ne;6;6;0;12
2833;Karuselė;UOGELĖ;8952114853;Ne;6;1;3;10
2834;Karuselė;UOGELĖ;9649615834;Ne;3;0;0;3
2835;Karuselė;UOGELĖ;3885475525;Ne;0;12;0;12
2836;Karuselė;UOGELĖ;4799230363;Ne;1;0;0;1
2837;Karuselė;GINTARĖLIS;3904453423;Ne;0;2;1;3
2838;Karuselė;GINTARĖLIS;7489136297;Ne;0;0;1;1
2839;Karuselė;GINTARĖLIS;3534074990;Ne;10;9;1;20
2840;Karuselė;GINTARĖLIS;1019322763;Ne;0;0;1;1
2841;Karuselė;GINTARĖLIS;8481143199;Ne;4;5;0;9
2842;Karuselė;GINTARĖLIS;3157893936;Ne;3;0;0;3
2843;Karuselė;GINTARĖLIS;8409412605;Ne;6;1;2;9
2844;Karuselė;GINTARĖLIS;2688863117;Ne;6;2;0;8
2845;Karuselė;GINTARĖLIS;7439791054;Ne;21;0;0;21
2846;Karuselė;GINTARĖLIS;3696384277;Ne;0;2;0;2
2847;Karuselė;GINTARĖLIS;2945027875;Ne;12;0;1;13
2848;Karuselė;GINTARĖLIS;8855096080;Ne;0;1;0;1
2849;Karuselė;GINTARĖLIS;9116238924;Ne;4;1;1;6
2850;Karuselė;GINTARĖLIS;6433987745;Ne;0;0;7;7
2851;Karuselė;GINTARĖLIS;9479962436;Taip;0;0;1;1
2852;Karuselė;GINTARĖLIS;3460470459;Ne;0;6;0;6
2853;Karuselė;GINTARĖLIS;3471091687;Ne;7;0;0;7
2854;Karuselė;GINTARĖLIS;4325959483;Ne;0;0;6;6
2855;Karuselė;GINTARĖLIS;6785226197;Ne;0;2;2;4
2856;Karuselė;SAULUTĖ;5627583683;Ne;12;1;0;13
2857;Karuselė;SAULUTĖ;2242659064;Ne;11;3;0;14
2858;Karuselė;SAULUTĖ;5704218177;Ne;11;1;1;13
2859;Karuselė;SAULUTĖ;5146709341;Ne;2;1;0;3
2860;Karuselė;SAULUTĖ;7814525717;Ne;3;2;0;5
2861;Karuselė;SAULUTĖ;8331985564;Ne;4;0;0;4
2862;Karuselė;SAULUTĖ;9400171357;Ne;5;2;0;7
2863;Karuselė;SAULUTĖ;9656723409;Ne;0;3;0;3
2864;Karuselė;SAULUTĖ;5766390337;Ne;9;1;0;10
2865;Karuselė;SAULUTĖ;5803808409;Ne;0;2;0;2
2866;Karuselė;SAULUTĖ;2269840705;Ne;2;1;0;3
2867;Karuselė;SAULUTĖ;3149575456;Ne;9;2;1;12
2868;Karuselė;SAULUTĖ;5640656442;Ne;6;1;0;7
2869;Karuselė;SAULUTĖ;9451789237;Ne;2;2;0;4
2870;Karuselė;SAULUTĖ;9450841251;Ne;13;0;0;13
2871;Karuselė;SAULUTĖ;6338379641;Ne;2;0;0;2
2872;Karuselė;SAULUTĖ;8830559511;Ne;4;0;1;5
2873;Karuselė;SAULUTĖ;3228100488;Ne;11;0;0;11
2874;Karuselė;SAULUTĖ;5830080035;Ne;4;0;1;5
2875;Karuselė;SAULUTĖ;9985033530;Ne;0;0;1;1
2876;Karuselė;SAULUTĖ;4211688032;Ne;0;0;1;1
2877;Karuselė;SAULUTĖ;5802996641;Taip;3;6;0;9
2878;Karuselė;SAULUTĖ;3271464159;Taip;0;14;0;14
2879;Karuselė;SAULUTĖ;7501323454;Ne;3;1;0;4
2880;Karuselė;TIGRIUKAS;9561892809;Ne;2;2;0;4
2881;Karuselė;TIGRIUKAS;9726299722;Ne;0;4;0;4
2882;Karuselė;TIGRIUKAS;1576201225;Ne;3;0;0;3
2883;Karuselė;TIGRIUKAS;9344514262;Ne;17;0;0;17
2884;Karuselė;TIGRIUKAS;7131255599;Ne;5;2;0;7
2885;Karuselė;TIGRIUKAS;4180604225;Ne;5;2;0;7
2886;Karuselė;TIGRIUKAS;2397938004;Ne;0;1;0;1
2887;Karuselė;TIGRIUKAS;3605966015;Ne;9;0;0;9
2888;Karuselė;TIGRIUKAS;9252093125;Ne;12;0;0;12
2889;Karuselė;TIGRIUKAS;6656808100;Ne;0;1;0;1
2890;Karuselė;TIGRIUKAS;8474027736;Ne;4;4;0;8
2891;Karuselė;TIGRIUKAS;2549599594;Ne;12;0;0;12
2892;Karuselė;TIGRIUKAS;9394220081;Ne;0;2;1;3
2893;Karuselė;TIGRIUKAS;7618984957;Ne;3;0;0;3
2894;Karuselė;TIGRIUKAS;6678283260;Ne;0;2;0;2
2895;Karuselė;TIGRIUKAS;5964942317;Ne;0;7;0;7
2896;Karuselė;VAIVORYKŠTĖ;1289442716;Ne;0;0;3;3
2897;Karuselė;VAIVORYKŠTĖ;9855242602;Ne;0;0;4;4
2898;Karuselė;VAIVORYKŠTĖ;8063412271;Ne;11;1;0;12
2899;Karuselė;VAIVORYKŠTĖ;9408843254;Ne;5;0;0;5
2900;Karuselė;VAIVORYKŠTĖ;3514315636;Ne;0;2;1;3
2901;Karuselė;VAIVORYKŠTĖ;8085919723;Ne;0;2;1;3
2902;Karuselė;VAIVORYKŠTĖ;1581504806;Ne;0;12;0;12
2903;Karuselė;VAIVORYKŠTĖ;2215367063;Ne;6;6;0;12
2904;Karuselė;VAIVORYKŠTĖ;6424622497;Ne;1;2;0;3
2905;Karuselė;VAIVORYKŠTĖ;2757263085;Ne;0;6;0;6
2906;Karuselė;VAIVORYKŠTĖ;4110024673;Ne;0;0;2;2
2907;Karuselė;VAIVORYKŠTĖ;9400856559;Ne;7;1;0;8
2908;Karuselė;VAIVORYKŠTĖ;1083786182;Ne;7;1;0;8
2909;Karuselė;VAIVORYKŠTĖ;6734936247;Ne;0;8;0;8
2910;Karuselė;VAIVORYKŠTĖ;3082636224;Ne;0;2;1;3
2911;Karuselė;VAIVORYKŠTĖ;4749086136;Ne;14;6;0;20
2912;Karuselė;"AUKSINĖ ŽUVELĖ";1344025242;Ne;6;0;0;6
2913;Karuselė;"AUKSINĖ ŽUVELĖ";5313839511;Ne;5;1;0;6
2914;Karuselė;"AUKSINĖ ŽUVELĖ";8074453862;Ne;4;0;0;4
2915;Karuselė;"AUKSINĖ ŽUVELĖ";5912561598;Ne;1;4;0;5
2916;Karuselė;"AUKSINĖ ŽUVELĖ";3728662112;Ne;11;0;1;12
2917;Karuselė;"AUKSINĖ ŽUVELĖ";9170947196;Ne;9;0;0;9
2918;Karuselė;"AUKSINĖ ŽUVELĖ";1004895817;Taip;0;2;0;2
2919;Karuselė;"AUKSINĖ ŽUVELĖ";4982029137;Ne;1;0;0;1
2920;Karuselė;"AUKSINĖ ŽUVELĖ";3408146969;Ne;6;0;0;6
2921;Karuselė;"AUKSINĖ ŽUVELĖ";3464711958;Ne;3;11;0;14
2922;Karuselė;"AUKSINĖ ŽUVELĖ";9001727438;Ne;0;0;2;2
2923;Karuselė;RAMUNĖ;6319361312;Ne;0;2;1;3
2924;Karuselė;RAMUNĖ;6370060620;Ne;3;0;0;3
2925;Karuselė;RAMUNĖ;6844148347;Ne;0;0;3;3
2926;Karuselė;RAMUNĖ;3890681011;Ne;0;2;1;3
2927;Karuselė;RAMUNĖ;6469579272;Ne;0;2;0;2
2928;Karuselė;RAMUNĖ;4707292159;Ne;9;1;0;10
2929;Karuselė;RAMUNĖ;5926712250;Ne;0;0;1;1
2930;Karuselė;RAMUNĖ;1427836663;Taip;0;0;2;2
2931;Karuselė;RAMUNĖ;9789687336;Ne;3;2;0;5
2932;Karuselė;RAMUNĖ;2843226066;Ne;5;0;6;11
2933;Karuselė;RAMUNĖ;3276397300;Ne;0;0;1;1
2934;Karuselė;VILKELIS;6300348828;Ne;0;2;0;2
2935;Karuselė;VILKELIS;3485160781;Ne;5;2;0;7
2936;Karuselė;VILKELIS;2500977616;Ne;3;6;0;9
2937;Karuselė;VILKELIS;8238334389;Ne;0;11;0;11
2938;Karuselė;VILKELIS;5036757881;Ne;3;0;0;3
2939;Karuselė;VILKELIS;7794320463;Ne;7;0;0;7
2940;Karuselė;VILKELIS;7052993128;Ne;7;0;0;7
2941;Karuselė;VILKELIS;7480485777;Ne;0;2;0;2
2942;Karuselė;VILKELIS;6341570221;Ne;5;1;0;6
2943;Karuselė;VILKELIS;3622914118;Ne;0;2;0;2
2944;Karuselė;VILKELIS;4566201460;Ne;0;4;0;4
2945;Karuselė;VILKELIS;8848085495;Ne;0;12;0;12
2946;Karuselė;VILKELIS;8362740639;Ne;5;1;0;6
2947;Karuselė;VILKELIS;2842034472;Ne;7;0;0;7
2948;Karuselė;VILKELIS;8531556390;Ne;0;2;0;2
2949;Karuselė;VILKELIS;4757820179;Ne;2;2;2;6
2950;Karuselė;VILKELIS;9415377698;Ne;0;6;0;6
2951;Karuselė;VILKELIS;2260731421;Ne;4;0;0;4
2952;Karuselė;VILKELIS;4196250786;Ne;1;2;0;3
2953;Kaštonas;NYKŠTUKAI;7703842464;Taip;0;15;0;15
2954;Kaštonas;NYKŠTUKAI;2178971789;Ne;0;2;0;2
2955;Kaštonas;NYKŠTUKAI;2361839733;Ne;0;5;0;5
2956;Kaštonas;NYKŠTUKAI;3383390078;Ne;0;21;0;21
2957;Kaštonas;NYKŠTUKAI;4782280933;Ne;0;3;0;3
2958;Kaštonas;NYKŠTUKAI;1258105498;Ne;9;0;0;9
2959;Kaštonas;NYKŠTUKAI;8766848385;Ne;0;3;0;3
2960;Kaštonas;NYKŠTUKAI;3251132542;Ne;7;2;0;9
2961;Kaštonas;NYKŠTUKAI;1501441973;Ne;0;17;0;17
2962;Kaštonas;NYKŠTUKAI;5948707303;Taip;11;3;0;14
2963;Kaštonas;DRUGELIAI;8486955652;Ne;9;1;0;10
2964;Kaštonas;DRUGELIAI;7408901858;Ne;7;5;0;12
2965;Kaštonas;DRUGELIAI;8582453109;Ne;0;1;0;1
2966;Kaštonas;DRUGELIAI;2832688622;Ne;4;5;0;9
2967;Kaštonas;DRUGELIAI;9061158412;Ne;3;5;0;8
2968;Kaštonas;DRUGELIAI;5884427036;Ne;4;1;0;5
2969;Kaštonas;DRUGELIAI;1141693073;Ne;5;1;0;6
2970;Kaštonas;DRUGELIAI;6251564828;Ne;3;0;0;3
2971;Kaštonas;DRUGELIAI;5969052108;Ne;0;3;0;3
2972;Kaštonas;DRUGELIAI;8166925991;Ne;0;2;0;2
2973;Kaštonas;DRUGELIAI;4215759647;Ne;6;0;0;6
2974;Kaštonas;DRUGELIAI;5307755844;Ne;0;2;0;2
2975;Kaštonas;DRUGELIAI;8257643251;Ne;6;1;0;7
2976;Kaštonas;DRUGELIAI;4384907654;Ne;4;2;0;6
2977;Kaštonas;DRUGELIAI;1976138680;Ne;7;1;0;8
2978;Kaštonas;DRUGELIAI;7992154554;Ne;1;1;0;2
2979;Kaštonas;DRUGELIAI;7698074598;Ne;10;4;0;14
2980;Kaštonas;KIŠKUČIAI;9807554365;Taip;11;0;0;11
2981;Kaštonas;KIŠKUČIAI;4552007726;Ne;10;0;0;10
2982;Kaštonas;KIŠKUČIAI;2020612346;Ne;0;5;0;5
2983;Kaštonas;KIŠKUČIAI;6585977073;Ne;5;1;0;6
2984;Kaštonas;KIŠKUČIAI;7383219978;Ne;11;7;0;18
2985;Kaštonas;KIŠKUČIAI;4641535612;Ne;0;18;0;18
2986;Kaštonas;KIŠKUČIAI;4708114402;Ne;6;4;0;10
2987;Kaštonas;KIŠKUČIAI;2057499534;Ne;20;0;0;20
2988;Kaštonas;KIŠKUČIAI;6749679348;Ne;2;1;0;3
2989;Kaštonas;KIŠKUČIAI;3860613494;Ne;0;11;0;11
2990;Kaštonas;KIŠKUČIAI;9778140363;Ne;6;3;0;9
2991;Kaštonas;KIŠKUČIAI;7290414209;Ne;0;15;0;15
2992;Kaštonas;KIŠKUČIAI;9356018629;Ne;0;1;0;1
2993;Kaštonas;KIŠKUČIAI;9320223622;Ne;0;8;0;8
2994;Kaštonas;KIŠKUČIAI;3544696101;Ne;0;2;0;2
2995;Kaštonas;KIŠKUČIAI;6425908247;Ne;5;3;0;8
2996;Kaštonas;KIŠKUČIAI;1612086010;Ne;0;6;0;6
2997;Kaštonas;KIŠKUČIAI;2874873326;Ne;8;2;0;10
2998;Kaštonas;KIŠKUČIAI;6934262510;Ne;0;8;0;8
2999;Kaštonas;KIŠKUČIAI;9034859988;Ne;0;3;0;3
3000;Kaštonas;KIŠKUČIAI;9249007247;Ne;6;10;0;16
3001;Kaštonas;BITUTĖS;2898327157;Ne;5;0;0;5
3002;Kaštonas;BITUTĖS;1207372235;Ne;0;1;0;1
3003;Kaštonas;BITUTĖS;9298372326;Ne;0;3;0;3
3004;Kaštonas;BITUTĖS;4115242811;Ne;0;13;0;13
3005;Kaštonas;BITUTĖS;6896372095;Ne;2;2;0;4
3006;Kaštonas;BITUTĖS;1684641447;Ne;3;8;0;11
3007;Kaštonas;BITUTĖS;1761520786;Ne;3;0;0;3
3008;Kaštonas;BITUTĖS;8250964197;Ne;0;6;0;6
3009;Kaštonas;BITUTĖS;4095137806;Ne;1;0;0;1
3010;Kaštonas;BITUTĖS;9285927858;Ne;7;4;0;11
3011;Kaštonas;BITUTĖS;9903176616;Ne;0;1;0;1
3012;Kaštonas;BITUTĖS;8275673303;Ne;0;2;1;3
3013;Kaštonas;BITUTĖS;1614180834;Ne;2;0;5;7
3014;Kaštonas;BITUTĖS;2877124424;Ne;9;1;0;10
3015;Kaštonas;BITUTĖS;1031628633;Ne;0;3;0;3
3016;Kaštonas;BITUTĖS;4551111709;Ne;0;3;0;3
3017;Kaštonas;BITUTĖS;7291448857;Ne;0;6;0;6
3018;Kaštonas;BITUTĖS;4837002666;Taip;13;0;0;13
3019;Kaštonas;BITUTĖS;6175014441;Ne;5;6;0;11
3020;Kaštonas;BITUTĖS;1748975865;Ne;0;5;0;5
3021;Kaštonas;MEŠKIUKAI;2228759708;Ne;11;0;0;11
3022;Kaštonas;MEŠKIUKAI;5350239917;Ne;0;6;1;7
3023;Kaštonas;MEŠKIUKAI;7088197668;Ne;5;1;0;6
3024;Kaštonas;MEŠKIUKAI;6515739350;Ne;0;1;0;1
3025;Kaštonas;MEŠKIUKAI;4854158033;Ne;0;0;1;1
3026;Kaštonas;MEŠKIUKAI;6613837801;Ne;0;5;0;5
3027;Kaštonas;MEŠKIUKAI;6263544162;Ne;0;7;0;7
3028;Kaštonas;MEŠKIUKAI;2281935638;Ne;0;1;0;1
3029;Kaštonas;MEŠKIUKAI;4353473162;Ne;0;1;0;1
3030;Kaštonas;MEŠKIUKAI;1862173525;Ne;0;1;0;1
3031;Kaštonas;MEŠKIUKAI;8775608339;Ne;0;11;0;11
3032;Kaštonas;MEŠKIUKAI;3456815576;Ne;0;2;0;2
3033;Kaštonas;MEŠKIUKAI;2356291627;Ne;0;1;0;1
3034;Kaštonas;MEŠKIUKAI;6289073634;Ne;0;21;0;21
3035;Kaštonas;MEŠKIUKAI;4616084852;Ne;0;1;0;1
3036;Kaštonas;MEŠKIUKAI;5157500600;Ne;7;1;0;8
3037;Kaštonas;MEŠKIUKAI;4308169582;Ne;0;6;0;6
3038;Kaštonas;MEŠKIUKAI;6589898580;Ne;6;8;0;14
3039;Kaštonas;MEŠKIUKAI;4824511567;Ne;0;1;0;1
3040;Kaštonas;MEŠKIUKAI;3961661158;Ne;0;7;0;7
3041;Kaštonas;MEŠKIUKAI;8318869054;Ne;14;1;0;15
3042;Kaštonas;MEŠKIUKAI;2434765663;Ne;0;1;0;1
3043;Kaštonas;MEŠKIUKAI;4444087861;Ne;0;1;1;2
3044;Kaštonas;MEŠKIUKAI;9379171183;Ne;7;1;1;9
3045;Kaštonas;MEŠKIUKAI;6254250706;Ne;10;0;0;10
3046;Kaštonas;MEŠKIUKAI;1262404954;Ne;10;0;0;10
3047;Kaštonas;MEŠKIUKAI;9014726465;Ne;0;1;3;4
3048;Kaštonas;BORUŽĖLĖS;6859729814;Ne;2;3;0;5
3049;Kaštonas;BORUŽĖLĖS;1027896631;Ne;0;11;0;11
3050;Kaštonas;BORUŽĖLĖS;6891429484;Ne;2;2;0;4
3051;Kaštonas;BORUŽĖLĖS;6442448667;Ne;5;7;0;12
3052;Kaštonas;BORUŽĖLĖS;2345742465;Ne;1;0;0;1
3053;Kaštonas;BORUŽĖLĖS;5060824071;Taip;0;4;0;4
3054;Kaštonas;BORUŽĖLĖS;3279850526;Ne;3;0;0;3
3055;Kaštonas;BORUŽĖLĖS;8151333699;Ne;15;0;0;15
3056;Kaštonas;BORUŽĖLĖS;4285107537;Ne;7;0;0;7
3057;Kaštonas;BORUŽĖLĖS;3153834010;Ne;7;0;0;7
3058;Kaštonas;BORUŽĖLĖS;3839816548;Ne;0;6;0;6
3059;"Krivūlė (Lydos g. 5)";SPINDULIUKAI;1937803301;Ne;0;0;6;6
3060;"Krivūlė (Lydos g. 5)";SPINDULIUKAI;9865192795;Ne;0;0;6;6
3061;"Krivūlė (Lydos g. 5)";SPINDULIUKAI;1840809151;Ne;0;0;1;1
3062;"Krivūlė (Lydos g. 5)";SPINDULIUKAI;7335245963;Ne;0;0;1;1
3063;"Krivūlė (Lydos g. 5)";SPINDULIUKAI;5802739148;Ne;0;9;4;13
3064;"Krivūlė (Lydos g. 5)";SPINDULIUKAI;5667934115;Ne;0;0;1;1
3065;"Krivūlė (Lydos g. 5)";SPINDULIUKAI;7155162698;Ne;0;0;2;2
3066;"Krivūlė (Lydos g. 5)";SPINDULIUKAI;1151179495;Ne;0;0;6;6
3067;"Krivūlė (Lydos g. 5)";SPINDULIUKAI;9320613086;Ne;15;0;0;15
3068;"Krivūlė (Lydos g. 5)";SPINDULIUKAI;3852793979;Ne;20;0;0;20
3069;"Krivūlė (Lydos g. 5)";SPINDULIUKAI;3184820008;Ne;0;0;7;7
3070;"Krivūlė (Lydos g. 5)";SPINDULIUKAI;7149268223;Ne;0;0;4;4
3071;"Krivūlė (Lydos g. 5)";SPINDULIUKAI;7025398689;Ne;10;0;0;10
3072;"Krivūlė (Lydos g. 5)";SPINDULIUKAI;4943482123;Ne;0;0;1;1
3073;"Krivūlė (Lydos g. 5)";SPINDULIUKAI;4619224314;Ne;2;0;4;6
3074;"Krivūlė (Lydos g. 5)";BORUŽĖLĖS;8711082048;Ne;0;0;2;2
3075;"Krivūlė (Lydos g. 5)";BORUŽĖLĖS;2915437387;Ne;0;0;3;3
3076;"Krivūlė (Lydos g. 5)";BORUŽĖLĖS;8304613793;Ne;8;0;0;8
3077;"Krivūlė (Lydos g. 5)";BORUŽĖLĖS;9030517214;Ne;0;0;2;2
3078;"Krivūlė (Lydos g. 5)";BORUŽĖLĖS;9553952862;Ne;8;0;2;10
3079;"Krivūlė (Lydos g. 5)";BORUŽĖLĖS;9732635621;Ne;0;0;3;3
3080;"Krivūlė (Lydos g. 5)";BORUŽĖLĖS;3368847042;Ne;4;0;0;4
3081;"Krivūlė (Lydos g. 5)";BORUŽĖLĖS;6283777399;Ne;0;0;2;2
3082;"Krivūlė (Lydos g. 5)";BORUŽĖLĖS;4454327278;Ne;0;0;4;4
3083;"Krivūlė (Lydos g. 5)";DRUGELIŲ;2654066358;Ne;0;0;5;5
3084;"Krivūlė (Lydos g. 5)";DRUGELIŲ;5113297248;Ne;0;0;11;11
3085;"Krivūlė (Lydos g. 5)";DRUGELIŲ;5596874303;Ne;0;0;3;3
3086;"Krivūlė (Lydos g. 5)";DRUGELIŲ;4297876008;Ne;5;0;0;5
3087;"Krivūlė (Lydos g. 5)";DRUGELIŲ;7781918674;Ne;1;3;0;4
3088;"Krivūlė (Lydos g. 5)";DRUGELIŲ;3246787504;Ne;0;0;1;1
3089;"Krivūlė (Lydos g. 5)";DRUGELIŲ;3605506478;Ne;0;0;3;3
3090;"Krivūlė (Lydos g. 5)";DRUGELIŲ;4896656209;Ne;0;0;3;3
3091;"Krivūlė (Lydos g. 5)";DRUGELIŲ;5531566792;Ne;0;10;0;10
3092;"Krivūlė (Lydos g. 5)";DRUGELIŲ;1171226193;Ne;0;0;6;6
3093;"Krivūlė (Lydos g. 5)";DRUGELIŲ;1815336153;Ne;5;2;1;8
3094;"Krivūlė (Lydos g. 5)";"BITUTĖS (VALDOFRO)";7848471009;Ne;0;0;2;2
3095;"Krivūlė (Lydos g. 5)";"BITUTĖS (VALDOFRO)";8834855616;Ne;0;4;0;4
3096;"Krivūlė (Lydos g. 5)";"BITUTĖS (VALDOFRO)";1561180871;Ne;0;19;0;19
3097;"Krivūlė (Lydos g. 5)";"BITUTĖS (VALDOFRO)";9702372816;Ne;0;0;1;1
3098;"Krivūlė (Lydos g. 5)";"BITUTĖS (VALDOFRO)";8105688948;Ne;0;11;0;11
3099;"Krivūlė (Lydos g. 5)";"BITUTĖS (VALDOFRO)";1932209134;Ne;0;0;1;1
3100;"Krivūlė (Lydos g. 5)";"BITUTĖS (VALDOFRO)";7768827505;Ne;4;0;6;10
3101;"Krivūlė (Lydos g. 5)";"BITUTĖS (VALDOFRO)";7199431924;Ne;0;0;3;3
3102;"Krivūlė (Lydos g. 5)";"BITUTĖS (VALDOFRO)";7714519095;Ne;0;0;1;1
3103;"Krivūlė (Lydos g. 5)";"BITUTĖS (VALDOFRO)";9409899522;Ne;0;0;8;8
3104;"Krivūlė (Lydos g. 5)";"BITUTĖS (VALDOFRO)";6365743037;Ne;0;0;1;1
3105;"Krivūlė (Lydos g. 5)";"BITUTĖS (VALDOFRO)";6830712749;Taip;0;0;3;3
3106;"Krivūlė (Lydos g. 5)";"BITUTĖS (VALDOFRO)";5600651110;Ne;0;1;0;1
3107;"Krivūlė (Lydos g. 5)";"BITUTĖS (VALDOFRO)";8352493729;Taip;16;0;0;16
3108;"Krivūlė (Lydos g. 5)";"BITUTĖS (VALDOFRO)";9229817861;Taip;0;0;2;2
3109;"Krivūlė (Lydos g. 5)";EŽIUKAI;8042185027;Ne;16;0;1;17
3110;"Krivūlė (Lydos g. 5)";EŽIUKAI;7242596817;Taip;0;0;3;3
3111;"Krivūlė (Lydos g. 5)";EŽIUKAI;5369083173;Ne;6;0;2;8
3112;"Krivūlė (Lydos g. 5)";EŽIUKAI;9051038248;Ne;0;0;15;15
3113;"Krivūlė (Lydos g. 5)";EŽIUKAI;3144577262;Ne;0;0;1;1
3114;"Krivūlė (Lydos g. 5)";EŽIUKAI;1898389557;Ne;0;0;1;1
3115;"Krivūlė (Lydos g. 5)";EŽIUKAI;2607716072;Ne;0;0;2;2
3116;"Krivūlė (Lydos g. 5)";EŽIUKAI;3836712448;Ne;0;0;1;1
3117;"Krivūlė (Lydos g. 5)";EŽIUKAI;8873132189;Ne;7;0;1;8
3118;"Krivūlė (Lydos g. 5)";EŽIUKAI;1893542120;Ne;11;0;1;12
3119;"Krivūlė (Lydos g. 5)";EŽIUKAI;1622229289;Ne;0;0;1;1
3120;"Krivūlė (Lydos g. 5)";EŽIUKAI;2157856704;Ne;8;0;3;11
3121;"Krivūlė (Lydos g. 5)";EŽIUKAI;7316772543;Ne;0;0;1;1
3122;"Krivūlė (Lydos g. 5)";EŽIUKAI;6506806826;Ne;0;0;3;3
3123;"Krivūlė (Lydos g. 5)";EŽIUKAI;1189206089;Ne;0;0;6;6
3124;"Krivūlė (Lydos g. 5)";EŽIUKAI;1251966163;Ne;0;0;12;12
3125;"Krivūlė (Lydos g. 5)";EŽIUKAI;1125863541;Ne;0;0;5;5
3126;"Krivūlė (Lydos g. 5)";NYKŠTUKAI;9820383193;Ne;0;0;2;2
3127;"Krivūlė (Lydos g. 5)";NYKŠTUKAI;8713384668;Ne;10;0;0;10
3128;"Krivūlė (Lydos g. 5)";NYKŠTUKAI;5268832682;Ne;0;21;0;21
3129;"Krivūlė (Lydos g. 5)";NYKŠTUKAI;8767554721;Ne;0;1;2;3
3130;"Krivūlė (Lydos g. 5)";NYKŠTUKAI;9529242858;Ne;3;0;0;3
3131;"Krivūlė (Lydos g. 5)";NYKŠTUKAI;8898023612;Ne;0;0;1;1
3132;"Krivūlė (Lydos g. 5)";NYKŠTUKAI;5768244312;Ne;0;2;0;2
3133;"Krivūlė (Lydos g. 5)";NYKŠTUKAI;7540940063;Taip;0;0;2;2
3134;"Krivūlė (Lydos g. 5)";NYKŠTUKAI;7262017017;Ne;0;0;1;1
3135;"Krivūlė (Lydos g. 5)";NYKŠTUKAI;6548893885;Ne;5;0;1;6
3136;"Krivūlė (Lydos g. 5)";NYKŠTUKAI;8674468359;Ne;5;0;4;9
3137;"Krivūlė (Lydos g. 5)";NYKŠTUKAI;1374452129;Ne;0;0;1;1
3138;"Krivūlė (Lydos g. 5)";NYKŠTUKAI;6466188552;Ne;6;0;0;6
3139;Kodėlčiukas;Saulutės;6517880481;Ne;0;5;0;5
3140;Kodėlčiukas;Saulutės;1725624698;Ne;3;0;0;3
3141;Kodėlčiukas;Saulutės;7327247516;Ne;1;0;0;1
3142;Kodėlčiukas;Saulutės;8992265000;Ne;5;0;3;8
3143;Kodėlčiukas;Saulutės;6285018663;Ne;0;2;0;2
3144;Kodėlčiukas;Saulutės;1033969800;Ne;4;1;0;5
3145;Kodėlčiukas;Saulutės;7611485881;Ne;0;0;3;3
3146;Kodėlčiukas;Saulutės;7561763602;Ne;0;0;1;1
3147;Kodėlčiukas;Saulutės;2289687766;Ne;5;0;0;5
3148;Kodėlčiukas;Saulutės;1992569595;Ne;0;0;5;5
3149;Kodėlčiukas;Saulutės;9527296531;Ne;0;0;6;6
3150;Kodėlčiukas;Saulutės;8070400563;Ne;0;0;2;2
3151;Kodėlčiukas;Saulutės;8447045958;Ne;0;7;1;8
3152;Kodėlčiukas;Saulutės;2542104903;Ne;10;3;0;13
3153;Kodėlčiukas;Saulutės;2162480212;Ne;0;6;1;7
3154;Kodėlčiukas;Saulutės;5064171874;Ne;5;0;0;5
3155;Kodėlčiukas;Nežiniukai;4896921433;Ne;11;0;0;11
3156;Kodėlčiukas;Nežiniukai;2301454083;Ne;6;0;1;7
3157;Kodėlčiukas;Nežiniukai;6041087039;Ne;6;0;0;6
3158;Kodėlčiukas;Nežiniukai;7283028602;Ne;2;0;0;2
3159;Kodėlčiukas;Nežiniukai;1682040192;Ne;8;0;0;8
3160;Kodėlčiukas;Nežiniukai;3060543464;Ne;7;0;2;9
3161;Kodėlčiukas;Nežiniukai;8475052982;Ne;5;2;1;8
3162;Kodėlčiukas;Nežiniukai;6631435446;Ne;12;0;0;12
3163;Kodėlčiukas;Nežiniukai;7167508091;Ne;10;0;0;10
3164;Kodėlčiukas;Nežiniukai;2350656752;Ne;11;0;0;11
3165;Kodėlčiukas;Nežiniukai;8644416746;Ne;8;0;0;8
3166;Kodėlčiukas;Nežiniukai;6164851553;Ne;7;0;1;8
3167;Kodėlčiukas;Nežiniukai;8435298904;Ne;12;0;0;12
3168;Kodėlčiukas;Gintarėliai;5891546827;Ne;0;0;5;5
3169;Kodėlčiukas;Gintarėliai;9085395350;Ne;0;0;2;2
3170;Kodėlčiukas;Gintarėliai;6409157827;Ne;0;0;2;2
3171;Kodėlčiukas;Gintarėliai;8101197864;Ne;0;0;1;1
3172;Kodėlčiukas;Gintarėliai;2543628770;Ne;0;0;6;6
3173;Kodėlčiukas;Gintarėliai;8911944991;Taip;0;0;7;7
3174;Kodėlčiukas;Gintarėliai;6670171992;Taip;2;0;0;2
3175;Kodėlčiukas;Gintarėliai;2465920649;Ne;3;10;0;13
3176;Kodėlčiukas;Gintarėliai;8348024909;Ne;1;0;1;2
3177;Kodėlčiukas;Gintarėliai;3878358193;Ne;5;0;0;5
3178;Kodėlčiukas;Gintarėliai;6935233288;Ne;18;0;0;18
3179;Kodėlčiukas;Gintarėliai;1835522972;Ne;2;1;0;3
3180;Kodėlčiukas;Gintarėliai;9418778626;Ne;6;0;0;6
3181;Kodėlčiukas;Gintarėliai;5541555127;Ne;10;1;0;11
3182;Kodėlčiukas;Gintarėliai;8759498015;Taip;5;0;1;6
3183;Kodėlčiukas;Gintarėliai;2802895479;Ne;0;6;0;6
3184;Kodėlčiukas;Gintarėliai;9914565606;Ne;0;3;0;3
3185;Kodėlčiukas;Gintarėliai;7686420784;Ne;6;2;0;8
3186;Kodėlčiukas;Gintarėliai;3037267215;Taip;0;0;1;1
3187;Kodėlčiukas;Šnekučiai;3778271049;Ne;5;0;1;6
3188;Kodėlčiukas;Šnekučiai;7510273691;Ne;0;3;0;3
3189;Kodėlčiukas;Šnekučiai;5075801618;Ne;0;0;1;1
3190;Kodėlčiukas;Šnekučiai;4490196764;Ne;0;0;2;2
3191;Kodėlčiukas;Šnekučiai;5952121209;Ne;0;3;0;3
3192;Kodėlčiukas;Šnekučiai;9208137169;Ne;0;0;2;2
3193;Kodėlčiukas;Šnekučiai;5876187643;Ne;5;0;0;5
3194;Kodėlčiukas;Šnekučiai;4866089623;Ne;0;1;0;1
3195;Kodėlčiukas;Šnekučiai;1206798597;Ne;0;0;3;3
3196;Kodėlčiukas;Šnekučiai;9169500252;Ne;0;7;0;7
3197;Kodėlčiukas;Šnekučiai;4941186694;Ne;0;1;0;1
3198;Kodėlčiukas;Šnekučiai;6587593805;Ne;7;0;0;7
3199;Kodėlčiukas;Šnekučiai;1074477043;Ne;0;1;1;2
3200;Kodėlčiukas;Šnekučiai;9109362006;Ne;0;0;1;1
3201;Kodėlčiukas;Šnekučiai;9724373368;Ne;0;4;0;4
3202;Kodėlčiukas;Šnekučiai;2819860331;Ne;0;0;1;1
3203;Kodėlčiukas;Šnekučiai;4230906452;Ne;0;0;1;1
3204;Kodėlčiukas;Pabiručiai;9278139998;Ne;0;0;1;1
3205;Kodėlčiukas;Pabiručiai;6008027505;Ne;3;0;1;4
3206;Kodėlčiukas;Pabiručiai;6065858518;Ne;0;0;1;1
3207;Kodėlčiukas;Pabiručiai;9480926599;Taip;0;0;1;1
3208;Kodėlčiukas;Pabiručiai;7246943802;Ne;0;0;2;2
3209;Kodėlčiukas;Pabiručiai;8189938439;Ne;0;6;0;6
3210;Kodėlčiukas;Pabiručiai;5587200800;Ne;2;0;2;4
3211;Kodėlčiukas;Pabiručiai;1433623973;Ne;9;0;1;10
3212;Kodėlčiukas;Pabiručiai;7570122834;Ne;0;0;1;1
3213;Kodėlčiukas;Pabiručiai;5359866071;Ne;0;0;2;2
3214;Kodėlčiukas;Pabiručiai;5801430256;Ne;1;6;0;7
3215;Kodėlčiukas;Pabiručiai;7455949617;Ne;0;0;1;1
3216;Kodėlčiukas;Pabiručiai;1039982141;Ne;0;0;4;4
3217;Kodėlčiukas;Pabiručiai;9830842598;Ne;5;0;4;9
3218;Kodėlčiukas;Pabiručiai;3882838712;Ne;0;0;1;1
3219;Kodėlčiukas;Pabiručiai;8635107742;Ne;0;7;1;8
3220;Kodėlčiukas;Pabiručiai;5064526349;Ne;11;1;0;12
3221;Kodėlčiukas;Smalsučiai;6950802941;Ne;6;0;1;7
3222;Kodėlčiukas;Smalsučiai;6045564826;Ne;1;1;0;2
3223;Kodėlčiukas;Smalsučiai;7136890681;Ne;0;10;1;11
3224;Kodėlčiukas;Smalsučiai;7971932716;Ne;0;10;1;11
3225;Kodėlčiukas;Smalsučiai;7282579315;Taip;0;0;3;3
3226;Kodėlčiukas;Smalsučiai;6905424567;Ne;3;0;0;3
3227;Kodėlčiukas;Smalsučiai;6074758814;Ne;0;7;0;7
3228;Kodėlčiukas;Smalsučiai;1302383608;Ne;7;0;0;7
3229;Kodėlčiukas;Smalsučiai;7626940433;Ne;0;5;0;5
3230;Kodėlčiukas;Smalsučiai;5729391456;Ne;0;0;4;4
3231;Kodėlčiukas;Smalsučiai;7286497455;Ne;19;0;0;19
3232;Kodėlčiukas;Smalsučiai;4038168647;Ne;0;5;0;5
3233;Kodėlčiukas;Smalsučiai;6000831611;Ne;0;0;1;1
3234;Kodėlčiukas;Smalsučiai;1160612316;Ne;1;3;0;4
3235;Kodėlčiukas;Smalsučiai;3470151604;Ne;0;11;0;11
3236;Kodėlčiukas;Smalsučiai;5921714669;Ne;0;3;0;3
3237;Kodėlčiukas;Smalsučiai;6764015170;Ne;6;4;0;10
3238;Kodėlčiukas;Giliukai;9754425363;Ne;4;1;0;5
3239;Kodėlčiukas;Giliukai;5587782917;Ne;1;1;0;2
3240;Kodėlčiukas;Giliukai;8100861190;Taip;4;4;0;8
3241;Kodėlčiukas;Giliukai;7639341503;Ne;0;2;0;2
3242;Kodėlčiukas;Giliukai;8017465692;Ne;0;4;0;4
3243;Kodėlčiukas;Giliukai;7937365710;Ne;13;0;0;13
3244;Kodėlčiukas;Giliukai;1937181137;Ne;1;0;0;1
3245;Kodėlčiukas;Giliukai;7007386353;Ne;5;2;0;7
3246;Kodėlčiukas;Giliukai;9721353724;Ne;4;0;1;5
3247;Kodėlčiukas;Giliukai;5573845415;Taip;15;0;0;15
3248;Kodėlčiukas;Giliukai;2122779530;Ne;0;0;2;2
3249;Kodėlčiukas;Giliukai;8785157050;Ne;0;18;0;18
3250;Kodėlčiukas;Giliukai;5770748359;Ne;0;2;0;2
3251;Kodėlčiukas;Giliukai;9992204262;Ne;4;0;2;6
3252;Kodėlčiukas;Giliukai;6643473339;Ne;0;2;0;2
3253;Kodėlčiukas;Giliukai;8107869258;Ne;0;3;3;6
3254;Kodėlčiukas;Giliukai;3130715310;Ne;6;4;0;10
3255;Kodėlčiukas;Giliukai;3686259290;Ne;7;0;0;7
3256;Kodėlčiukas;Giliukai;2928885561;Ne;12;0;0;12
3257;Kodėlčiukas;Giliukai;5909222351;Ne;6;0;0;6
3258;Kodėlčiukas;Gudručiai;6988515253;Ne;1;0;0;1
3259;Kodėlčiukas;Gudručiai;3385551650;Ne;4;0;0;4
3260;Kodėlčiukas;Gudručiai;7318908956;Ne;0;0;2;2
3261;Kodėlčiukas;Gudručiai;7430239198;Ne;9;0;0;9
3262;Kodėlčiukas;Gudručiai;8400610717;Taip;9;0;1;10
3263;Kodėlčiukas;Gudručiai;7116594055;Ne;5;0;1;6
3264;Kodėlčiukas;Gudručiai;9483378853;Ne;0;1;0;1
3265;Kodėlčiukas;Gudručiai;8890987483;Ne;0;0;1;1
3266;Kodėlčiukas;Gudručiai;2216791610;Ne;0;0;1;1
3267;Kodėlčiukas;Gudručiai;2987907651;Ne;0;0;2;2
3268;Kodėlčiukas;Gudručiai;9028856983;Ne;1;0;0;1
3269;Kodėlčiukas;Gudručiai;1588132166;Ne;5;0;0;5
3270;Kodėlčiukas;Gudručiai;6014084915;Ne;0;1;1;2
3271;Kodėlčiukas;Gudručiai;3068084704;Ne;0;1;1;2
3272;Kodėlčiukas;Gudručiai;6985788287;Ne;11;0;0;11
3273;Kodėlčiukas;Gudručiai;3427610168;Ne;2;0;0;2
3274;Kodėlčiukas;Žirniukai;6522019070;Ne;5;0;1;6
3275;Kodėlčiukas;Žirniukai;1050905569;Ne;0;5;2;7
3276;Kodėlčiukas;Žirniukai;3053949510;Taip;12;0;0;12
3277;Kodėlčiukas;Žirniukai;8429572505;Ne;0;0;4;4
3278;Kodėlčiukas;Žirniukai;4321485862;Ne;0;0;2;2
3279;Kodėlčiukas;Žirniukai;1550287298;Ne;0;0;1;1
3280;Kodėlčiukas;Žirniukai;9045733092;Ne;7;0;0;7
3281;Kodėlčiukas;Žirniukai;4341694264;Ne;0;0;1;1
3282;Kodėlčiukas;Žirniukai;4597473929;Taip;1;0;1;2
3283;Kodėlčiukas;Žirniukai;9702236745;Ne;0;0;3;3
3284;Kodėlčiukas;Žirniukai;7189930025;Ne;1;0;1;2
3285;Kodėlčiukas;Žirniukai;4530733149;Ne;6;0;0;6
3286;Kodėlčiukas;Katinėliai;4730433849;Ne;0;0;7;7
3287;Kodėlčiukas;Katinėliai;4995538090;Ne;5;0;0;5
3288;Kodėlčiukas;Katinėliai;8045906704;Ne;3;0;1;4
3289;Kodėlčiukas;Katinėliai;7306085848;Ne;10;0;0;10
3290;Kodėlčiukas;Katinėliai;6576466300;Ne;0;1;0;1
3291;Kodėlčiukas;Katinėliai;5650077893;Ne;15;1;1;17
3292;Kodėlčiukas;Katinėliai;3239314295;Ne;0;5;0;5
3293;Kodėlčiukas;Katinėliai;9221561862;Ne;0;2;0;2
3294;Kodėlčiukas;Katinėliai;2147517344;Ne;7;0;6;13
3295;Kodėlčiukas;Katinėliai;2119041584;Ne;9;0;1;10
3296;Kodėlčiukas;Katinėliai;1570599010;Ne;7;0;1;8
3297;Kodėlčiukas;Katinėliai;4727546035;Ne;6;0;4;10
3298;Kodėlčiukas;Katinėliai;6011097577;Taip;0;0;14;14
3299;Kodėlčiukas;Katinėliai;6334889816;Ne;11;0;0;11
3300;Kodėlčiukas;Katinėliai;6135628975;Ne;11;0;0;11
3301;Kodėlčiukas;Katinėliai;4028114251;Ne;0;0;2;2
3302;Kodėlčiukas;Nykštukai;5719244938;Ne;9;0;1;10
3303;Kodėlčiukas;Nykštukai;4643616472;Ne;1;0;0;1
3304;Kodėlčiukas;Nykštukai;6498584861;Ne;3;0;0;3
3305;Kodėlčiukas;Nykštukai;1776582488;Ne;0;0;1;1
3306;Kodėlčiukas;Nykštukai;2394070354;Ne;2;0;2;4
3307;Kodėlčiukas;Nykštukai;3018381817;Ne;12;0;0;12
3308;Kodėlčiukas;Nykštukai;9330345860;Ne;5;2;0;7
3309;Kodėlčiukas;Nykštukai;9645711345;Ne;2;0;0;2
3310;Kodėlčiukas;Nykštukai;3509994698;Ne;3;0;1;4
3311;Kodėlčiukas;Nykštukai;3737512833;Taip;6;0;0;6
3312;Kodėlčiukas;Nykštukai;8399334364;Ne;14;0;0;14
3313;Kodėlčiukas;Nykštukai;1498607108;Ne;9;0;0;9
3314;Kodėlčiukas;Nykštukai;7963235116;Ne;7;0;0;7
3315;Kodėlčiukas;ŽIOGELIAI;5189091564;Ne;0;0;1;1
3316;Kodėlčiukas;ŽIOGELIAI;6745245907;Ne;3;0;0;3
3317;Kodėlčiukas;ŽIOGELIAI;9055399463;Ne;0;0;4;4
3318;Kodėlčiukas;ŽIOGELIAI;2081199093;Ne;21;0;0;21
3319;Kodėlčiukas;ŽIOGELIAI;3223461282;Taip;0;11;0;11
3320;Kodėlčiukas;ŽIOGELIAI;3603781385;Taip;0;8;0;8
3321;Kodėlčiukas;ŽIOGELIAI;7497358286;Ne;0;0;4;4
3322;Kodėlčiukas;ŽIOGELIAI;2990546939;Ne;0;0;1;1
3323;Kodėlčiukas;ŽIOGELIAI;4089558399;Ne;3;0;1;4
3324;Kodėlčiukas;ŽIOGELIAI;6843492891;Ne;0;0;1;1
3325;Kodėlčiukas;ŽIOGELIAI;2933909503;Ne;6;0;0;6
3326;Kodėlčiukas;BITUTĖS;8144034996;Ne;0;0;3;3
3327;Kodėlčiukas;BITUTĖS;9844479346;Ne;12;0;0;12
3328;Kodėlčiukas;BITUTĖS;5222125070;Ne;1;2;0;3
3329;Kodėlčiukas;BITUTĖS;6580462777;Ne;0;0;4;4
3330;Kodėlčiukas;BITUTĖS;5023273477;Ne;8;0;0;8
3331;Kodėlčiukas;BITUTĖS;3970337050;Ne;1;0;0;1
3332;Kodėlčiukas;BITUTĖS;7539430546;Ne;1;0;0;1
3333;Kodėlčiukas;BITUTĖS;6436603293;Ne;7;0;0;7
3334;Kodėlčiukas;BITUTĖS;2272657477;Ne;6;0;0;6
3335;Kodėlčiukas;VYŠNIUKAI;7705057116;Ne;0;0;1;1
3336;Kodėlčiukas;VYŠNIUKAI;7643398934;Ne;0;0;10;10
3337;Kodėlčiukas;VYŠNIUKAI;8799798070;Ne;2;0;3;5
3338;Kodėlčiukas;VYŠNIUKAI;7119815662;Ne;1;0;3;4
3339;Kodėlčiukas;VYŠNIUKAI;9398732476;Taip;9;0;7;16
3340;Kodėlčiukas;VYŠNIUKAI;2720748563;Ne;0;2;0;2
3341;Kodėlčiukas;VYŠNIUKAI;9914322177;Ne;1;0;0;1
3342;Kodėlčiukas;VYŠNIUKAI;2298734536;Ne;0;1;0;1
3343;Kodėlčiukas;VYŠNIUKAI;2549153581;Ne;12;0;3;15
3344;Kodėlčiukas;VYŠNIUKAI;1808211253;Ne;0;3;0;3
3345;Kodėlčiukas;VYŠNIUKAI;5178305435;Taip;6;0;0;6
3346;Kodėlčiukas;VYŠNIUKAI;5061852590;Ne;0;1;1;2
3347;Kodėlčiukas;VYŠNIUKAI;4782931414;Ne;0;7;0;7
3348;Kodėlčiukas;VYŠNIUKAI;1803320085;Taip;0;0;3;3
3349;Kodėlčiukas;VYŠNIUKAI;3938536446;Ne;0;0;5;5
3350;Kodėlčiukas;VYŠNIUKAI;5752818911;Ne;0;3;1;4
3351;Kodėlčiukas;VYŠNIUKAI;6656558797;Ne;1;0;1;2
3352;Kodėlčiukas;BORUŽĖLĖS;2340866110;Taip;6;2;1;9
3353;Kodėlčiukas;BORUŽĖLĖS;6726383331;Ne;9;0;0;9
3354;Kodėlčiukas;BORUŽĖLĖS;1568628843;Ne;0;8;0;8
3355;Kodėlčiukas;BORUŽĖLĖS;3156788328;Ne;3;0;1;4
3356;Kodėlčiukas;BORUŽĖLĖS;7186835214;Ne;4;0;1;5
3357;Kodėlčiukas;BORUŽĖLĖS;8829986201;Ne;2;0;2;4
3358;Kodėlčiukas;BORUŽĖLĖS;4529565626;Ne;9;0;0;9
3359;Kodėlčiukas;BORUŽĖLĖS;9020265248;Ne;0;0;1;1
3360;Kodėlčiukas;BORUŽĖLĖS;2313607716;Taip;0;9;0;9
3361;Kodėlčiukas;BORUŽĖLĖS;9209671311;Ne;2;0;1;3
3362;Kodėlčiukas;BORUŽĖLĖS;7227149646;Ne;0;10;0;10
3363;Kodėlčiukas;BORUŽĖLĖS;3985455729;Ne;0;6;1;7
3364;Kodėlčiukas;BORUŽĖLĖS;5068611716;Taip;0;0;1;1
3365;Kodėlčiukas;BORUŽĖLĖS;7910205296;Ne;1;0;1;2
3366;Kodėlčiukas;BORUŽĖLĖS;1047209628;Ne;5;0;5;10
3367;Kodėlčiukas;BORUŽĖLĖS;8932472612;Ne;4;0;1;5
3368;Kodėlčiukas;VYTURĖLIAI;6714818379;Ne;0;8;0;8
3369;Kodėlčiukas;VYTURĖLIAI;4218096561;Ne;3;8;0;11
3370;Kodėlčiukas;VYTURĖLIAI;2169307879;Ne;5;0;0;5
3371;Kodėlčiukas;VYTURĖLIAI;2448536092;Ne;10;0;0;10
3372;Kodėlčiukas;VYTURĖLIAI;4585226357;Ne;5;0;0;5
3373;Kodėlčiukas;VYTURĖLIAI;4884233329;Ne;4;0;0;4
3374;Kodėlčiukas;VYTURĖLIAI;8263945732;Ne;8;0;0;8
3375;Kodėlčiukas;VYTURĖLIAI;2904858964;Ne;20;0;0;20
3376;Kodėlčiukas;VYTURĖLIAI;3413659259;Ne;1;7;0;8
3377;Kodėlčiukas;VYTURĖLIAI;9673271313;Ne;6;0;0;6
3378;Kodėlčiukas;VYTURĖLIAI;5710301153;Ne;9;0;0;9
3379;Kodėlčiukas;VYTURĖLIAI;1746835627;Ne;1;0;0;1
3380;Kodėlčiukas;VYTURĖLIAI;5474125905;Ne;6;2;0;8
3381;Kodėlčiukas;VYTURĖLIAI;2298099102;Ne;0;10;0;10
3382;Kodėlčiukas;VYTURĖLIAI;3472862544;Ne;3;0;0;3
3383;Kodėlčiukas;VYTURĖLIAI;6476445296;Ne;4;2;0;6
3384;Kodėlčiukas;DRUGELIAI;4165123345;Taip;1;6;0;7
3385;Kodėlčiukas;DRUGELIAI;5772071707;Ne;0;7;0;7
3386;Kodėlčiukas;DRUGELIAI;1149682376;Ne;0;4;0;4
3387;Kodėlčiukas;DRUGELIAI;7587203481;Ne;5;0;0;5
3388;Kodėlčiukas;DRUGELIAI;2353960861;Ne;0;5;0;5
3389;Kodėlčiukas;DRUGELIAI;6103959702;Ne;4;0;1;5
3390;Kodėlčiukas;DRUGELIAI;5577154148;Ne;0;2;1;3
3391;Kodėlčiukas;DRUGELIAI;4202423480;Ne;5;0;0;5
3392;Kodėlčiukas;DRUGELIAI;9979034031;Ne;0;2;0;2
3393;Kodėlčiukas;DRUGELIAI;3240221130;Ne;0;0;1;1
3394;Kodėlčiukas;DRUGELIAI;9139424911;Ne;0;0;1;1
3395;Kodėlčiukas;DRUGELIAI;9664432781;Ne;0;0;1;1
3396;Kodėlčiukas;DRUGELIAI;5197946954;Ne;0;6;6;12
3397;Kodėlčiukas;DRUGELIAI;3651073383;Ne;0;0;5;5
3398;Kodėlčiukas;DRUGELIAI;3854719881;Ne;0;3;1;4
3399;Kodėlčiukas;DRUGELIAI;1889809198;Ne;0;0;1;1
3400;Kodėlčiukas;DRUGELIAI;8315176054;Ne;0;1;1;2
3401;Kodėlčiukas;DRUGELIAI;7908217415;Ne;5;0;2;7
3402;Kodėlčiukas;OBUOLIUKAI;8784531004;Ne;3;0;0;3
3403;Kodėlčiukas;OBUOLIUKAI;1289342844;Ne;2;0;2;4
3404;Kodėlčiukas;OBUOLIUKAI;1683506414;Ne;0;0;4;4
3405;Kodėlčiukas;OBUOLIUKAI;3315862631;Taip;0;3;0;3
3406;Kodėlčiukas;OBUOLIUKAI;3168418461;Ne;0;10;0;10
3407;Kodėlčiukas;OBUOLIUKAI;9645987751;Ne;6;3;0;9
3408;Kodėlčiukas;OBUOLIUKAI;5860975805;Ne;0;0;1;1
3409;Kodėlčiukas;OBUOLIUKAI;8782155591;Taip;0;0;4;4
3410;Kodėlčiukas;OBUOLIUKAI;8104220950;Ne;0;13;0;13
3411;Kodėlčiukas;OBUOLIUKAI;2005453189;Ne;0;8;0;8
3412;Kodėlčiukas;OBUOLIUKAI;1180399735;Ne;0;2;0;2
3413;Kodėlčiukas;OBUOLIUKAI;5173730926;Ne;13;1;1;15
3414;Kodėlčiukas;OBUOLIUKAI;3442449482;Ne;4;0;1;5
3415;Kodėlčiukas;OBUOLIUKAI;7946010973;Taip;6;4;0;10
3416;Kodėlčiukas;OBUOLIUKAI;5342852235;Ne;0;3;0;3
3417;Kodėlčiukas;OBUOLIUKAI;8563412043;Ne;0;0;1;1
3418;Kodėlčiukas;OBUOLIUKAI;4026784012;Ne;0;0;5;5
3419;Kodėlčiukas;OBUOLIUKAI;2114176689;Ne;8;0;6;14
3420;Kodėlčiukas;OBUOLIUKAI;3033687110;Taip;0;3;1;4
3421;Kodėlčiukas;OBUOLIUKAI;5252261660;Ne;6;4;0;10
3422;Kodėlčiukas;AITVARIUKAI;9573073973;Ne;0;0;3;3
3423;Kodėlčiukas;AITVARIUKAI;2892318767;Taip;0;0;3;3
3424;Kodėlčiukas;AITVARIUKAI;2892318767;Taip;0;0;3;3
3425;Kodėlčiukas;AITVARIUKAI;6809202793;Taip;2;0;0;2
3426;Kodėlčiukas;AITVARIUKAI;6809202793;Taip;2;0;0;2
3427;Kodėlčiukas;AITVARIUKAI;9389125350;Taip;7;0;5;12
3428;Kodėlčiukas;AITVARIUKAI;9389125350;Taip;7;0;5;12
3429;Kodėlčiukas;AITVARIUKAI;2429997257;Taip;0;0;3;3
3430;Kodėlčiukas;AITVARIUKAI;2429997257;Taip;0;0;3;3
3431;Kodėlčiukas;AITVARIUKAI;1775864846;Taip;0;0;1;1
3432;Kodėlčiukas;AITVARIUKAI;1775864846;Taip;0;0;1;1
3433;Kodėlčiukas;AITVARIUKAI;8707777661;Taip;10;0;4;14
3434;Kodėlčiukas;AITVARIUKAI;8707777661;Taip;10;0;4;14
3435;Kodėlčiukas;AITVARIUKAI;4366942357;Taip;1;0;1;2
3436;Kodėlčiukas;AITVARIUKAI;4366942357;Taip;1;0;1;2
3437;Kodėlčiukas;AITVARIUKAI;2601561338;Taip;6;0;5;11
3438;Kodėlčiukas;AITVARIUKAI;3735299373;Ne;1;0;0;1
3439;Kodėlčiukas;AITVARIUKAI;3071951746;Ne;5;0;7;12
3440;Kodėlčiukas;DEBESĖLIAI;2048119857;Ne;2;0;0;2
3441;Kodėlčiukas;DEBESĖLIAI;7141979862;Taip;5;0;1;6
3442;Kodėlčiukas;DEBESĖLIAI;7141979862;Taip;5;0;1;6
3443;Kodėlčiukas;DEBESĖLIAI;2914410829;Ne;13;0;0;13
3444;Kodėlčiukas;DEBESĖLIAI;3662576624;Ne;7;0;2;9
3445;Kodėlčiukas;DEBESĖLIAI;6567146331;Taip;1;0;2;3
3446;Kodėlčiukas;DEBESĖLIAI;6567146331;Taip;1;0;2;3
3447;Kodėlčiukas;DEBESĖLIAI;5786431452;Ne;8;0;3;11
3448;Kodėlčiukas;DEBESĖLIAI;1056383365;Ne;8;0;1;9
3449;Kodėlčiukas;DEBESĖLIAI;5286211766;Taip;5;0;0;5
3450;Kodėlčiukas;DEBESĖLIAI;5286211766;Taip;5;0;0;5
3451;Kodėlčiukas;EŽIUKAI;1906930504;Ne;3;0;0;3
3452;Kodėlčiukas;EŽIUKAI;5925818434;Taip;10;0;0;10
3453;Kodėlčiukas;EŽIUKAI;5925818434;Taip;10;0;0;10
3454;Kodėlčiukas;EŽIUKAI;7107700885;Ne;6;1;0;7
3455;Kodėlčiukas;EŽIUKAI;7107700885;Ne;6;1;0;7
3456;Kodėlčiukas;EŽIUKAI;4842829705;Ne;5;1;0;6
3457;Kodėlčiukas;EŽIUKAI;4842829705;Ne;5;1;0;6
3458;Kodėlčiukas;EŽIUKAI;2728038596;Ne;5;0;0;5
3459;Kodėlčiukas;EŽIUKAI;6373705667;Ne;3;0;0;3
3460;Kodėlčiukas;EŽIUKAI;6373705667;Ne;3;0;0;3
3461;Kodėlčiukas;EŽIUKAI;2999381333;Taip;1;0;0;1
3462;Kodėlčiukas;EŽIUKAI;2999381333;Taip;1;0;0;1
3463;Kodėlčiukas;EŽIUKAI;5540660080;Ne;1;0;0;1
3464;Kodėlčiukas;EŽIUKAI;4795230461;Ne;0;6;0;6
3465;Kodėlčiukas;EŽIUKAI;9092413482;Taip;12;2;0;14
3466;Kodėlčiukas;EŽIUKAI;9424975662;Taip;0;4;0;4
3467;Kodėlčiukas;EŽIUKAI;9424975662;Taip;0;4;0;4
3468;Kodėlčiukas;EŽIUKAI;3598405258;Taip;6;0;0;6
3469;Kodėlčiukas;EŽIUKAI;3598405258;Taip;6;0;0;6
3470;Kodėlčiukas;EŽIUKAI;5025581128;Ne;7;11;0;18
3471;Kodėlčiukas;EŽIUKAI;5025581128;Ne;7;11;0;18
3472;Kodėlčiukas;EŽIUKAI;1761109453;Ne;2;0;0;2
3473;Kurpaitė;Viščiukų;9825971721;Ne;0;1;0;1
3474;Kurpaitė;Viščiukų;4572559234;Ne;1;0;0;1
3475;Kurpaitė;Viščiukų;9299294437;Ne;7;0;0;7
3476;Kurpaitė;Viščiukų;9761100202;Ne;9;0;0;9
3477;Kurpaitė;Viščiukų;7973054986;Ne;0;4;0;4
3478;Kurpaitė;Viščiukų;2233142424;Ne;2;0;0;2
3479;Kurpaitė;Viščiukų;5629017875;Ne;2;0;0;2
3480;Kurpaitė;Viščiukų;5234784564;Taip;0;17;0;17
3481;Kurpaitė;Gėlyčių;5952306163;Ne;0;3;0;3
3482;Kurpaitė;Gėlyčių;3139272175;Ne;0;1;0;1
3483;Kurpaitė;Gėlyčių;4769611100;Ne;3;0;0;3
3484;Kurpaitė;Gėlyčių;4687182527;Ne;0;6;0;6
3485;Kurpaitė;Gėlyčių;2373582223;Ne;0;21;0;21
3486;Kurpaitė;Gėlyčių;2157581956;Ne;0;13;0;13
3487;Kurpaitė;Gėlyčių;5175919323;Ne;0;13;0;13
3488;Kurpaitė;Gėlyčių;7194351335;Ne;0;14;0;14
3489;Kurpaitė;Gėlyčių;2744439309;Ne;0;1;0;1
3490;Kurpaitė;Gėlyčių;5923694769;Ne;0;1;0;1
3491;Kurpaitė;Gėlyčių;8402747029;Ne;0;2;0;2
3492;Kurpaitė;Gėlyčių;5557028481;Ne;0;4;0;4
3493;Kurpaitė;Gėlyčių;5447826458;Ne;0;11;0;11
3494;Kurpaitė;Gėlyčių;2867842844;Ne;9;1;0;10
3495;Kurpaitė;Gėlyčių;6859316204;Ne;7;0;0;7
3496;Kurpaitė;Drugelių;8868415451;Ne;0;4;0;4
3497;Kurpaitė;Drugelių;1273426668;Ne;0;6;0;6
3498;Kurpaitė;Drugelių;1413326858;Ne;8;0;0;8
3499;Kurpaitė;Drugelių;6568580994;Ne;0;11;0;11
3500;Kurpaitė;Drugelių;5396599834;Ne;5;0;0;5
3501;Kurpaitė;Drugelių;1752006477;Ne;4;0;0;4
3502;Kurpaitė;Drugelių;9922582884;Ne;2;0;0;2
3503;Kurpaitė;Drugelių;3989274600;Ne;4;1;0;5
3504;Kurpaitė;Drugelių;4426311033;Ne;0;5;0;5
3505;Kurpaitė;Drugelių;1927773278;Ne;0;10;0;10
3506;Kurpaitė;Drugelių;8361612709;Ne;3;0;0;3
3507;Kurpaitė;Pelyčių;7546409044;Ne;0;12;0;12
3508;Kurpaitė;Pelyčių;4519369081;Ne;1;0;0;1
3509;Kurpaitė;Pelyčių;7897713994;Ne;2;0;0;2
3510;Kurpaitė;Pelyčių;5609161523;Ne;1;12;0;13
3511;Kurpaitė;Pelyčių;8592478282;Taip;0;0;1;1
3512;Kurpaitė;Pelyčių;4188925256;Ne;0;3;0;3
3513;Kurpaitė;Pelyčių;3634641300;Ne;0;3;0;3
3514;Kurpaitė;Pelyčių;9915241987;Ne;3;0;0;3
3515;Kurpaitė;Pelyčių;5844470373;Ne;9;0;0;9
3516;Kurpaitė;Pelyčių;1864484931;Ne;7;0;0;7
3517;Kurpaitė;Pelyčių;8069116180;Ne;5;0;0;5
3518;Kurpaitė;Pelyčių;9384218589;Ne;3;12;0;15
3519;Kurpaitė;Pelyčių;6309468728;Ne;12;0;0;12
3520;Kurpaitė;Pelyčių;4168882748;Ne;0;9;0;9
3521;Lakštingala;Saulutės;2156571482;Ne;0;0;3;3
3522;Lakštingala;Saulutės;2084960114;Ne;0;0;4;4
3523;Lakštingala;Saulutės;3911509979;Ne;2;0;0;2
3524;Lakštingala;Saulutės;1598639284;Ne;0;0;1;1
3525;Lakštingala;Saulutės;3723986383;Ne;10;1;0;11
3526;Lakštingala;Saulutės;1243254166;Taip;0;8;0;8
3527;Lakštingala;Saulutės;6567480562;Ne;0;0;1;1
3528;Lakštingala;Saulutės;9495341480;Ne;0;5;0;5
3529;Lakštingala;Saulutės;2543779273;Taip;6;2;1;9
3530;Lakštingala;Saulutės;2093953744;Ne;0;0;2;2
3531;Lakštingala;Saulutės;5432816139;Ne;0;0;2;2
3532;Lakštingala;Saulutės;8679582358;Ne;21;0;0;21
3533;Lakštingala;Saulutės;3520592784;Ne;0;9;0;9
3534;Lakštingala;Saulutės;3369263112;Ne;13;0;0;13
3535;Lakštingala;Saulutės;8717764626;Ne;7;0;1;8
3536;Lakštingala;Saulutės;6780591792;Ne;0;2;1;3
3537;Lakštingala;Saulutės;1220858944;Ne;5;0;0;5
3538;Lakštingala;Saulutės;4032030375;Ne;0;1;0;1
3539;Lakštingala;Saulutės;3839016986;Taip;0;0;2;2
3540;Lakštingala;Saulutės;9628476764;Ne;7;0;2;9
3541;Lakštingala;Saulutės;4344553248;Ne;5;0;1;6
3542;Lakštingala;Nykštukai;5943711793;Ne;20;0;0;20
3543;Lakštingala;Nykštukai;1561903802;Ne;0;0;6;6
3544;Lakštingala;Nykštukai;9420187643;Ne;7;0;1;8
3545;Lakštingala;Nykštukai;9339816191;Ne;0;6;0;6
3546;Lakštingala;Nykštukai;8310446552;Ne;8;0;2;10
3547;Lakštingala;Nykštukai;8063735934;Ne;0;0;1;1
3548;Lakštingala;Nykštukai;7396235662;Ne;1;0;1;2
3549;Lakštingala;Nykštukai;3863174791;Taip;1;0;1;2
3550;Lakštingala;Nykštukai;4725848201;Taip;4;0;1;5
3551;Lakštingala;Nykštukai;2165808562;Ne;8;0;5;13
3552;Lakštingala;Nykštukai;5539054769;Ne;0;0;1;1
3553;Lakštingala;Nykštukai;8421786788;Taip;1;0;2;3
3554;Lakštingala;Nykštukai;6974936332;Ne;18;0;0;18
3555;Lakštingala;Nykštukai;8764728846;Ne;1;0;1;2
3556;Lakštingala;Nykštukai;8663938939;Taip;9;0;1;10
3557;Lakštingala;Nykštukai;6231045485;Ne;0;0;1;1
3558;Lakštingala;Nykštukai;5165517709;Ne;3;0;1;4
3559;Lakštingala;Nykštukai;5965026791;Ne;2;0;0;2
3560;Lakštingala;Bitutės;6234559044;Ne;16;0;0;16
3561;Lakštingala;Bitutės;5727308039;Ne;4;0;0;4
3562;Lakštingala;Bitutės;8171357606;Ne;0;5;0;5
3563;Lakštingala;Bitutės;8165998647;Taip;3;0;0;3
3564;Lakštingala;Bitutės;9774836470;Ne;0;2;0;2
3565;Lakštingala;Bitutės;1958696382;Ne;2;1;0;3
3566;Lakštingala;Bitutės;1587899391;Ne;0;2;0;2
3567;Lakštingala;Bitutės;9694524137;Ne;4;7;0;11
3568;Lakštingala;Bitutės;1458348357;Ne;0;5;0;5
3569;Lakštingala;Bitutės;4542992319;Ne;11;0;0;11
3570;Lakštingala;Bitutės;7272454093;Ne;5;2;0;7
3571;Lakštingala;Bitutės;5949665703;Ne;5;0;0;5
3572;Lakštingala;Bitutės;4722328994;Ne;0;2;0;2
3573;Lakštingala;Bitutės;4465752871;Taip;0;1;0;1
3574;Lakštingala;Bitutės;2593030897;Ne;0;2;0;2
3575;Lakštingala;Bitutės;6565318145;Ne;0;1;0;1
3576;Lakštingala;Bitutės;4384468922;Ne;0;6;0;6
3577;Lakštingala;Bitutės;6908873466;Ne;3;0;0;3
3578;Lakštingala;Bitutės;5379344261;Ne;2;2;0;4
3579;Lakštingala;Bitutės;7929034243;Ne;10;0;0;10
3580;Lakštingala;Bitutės;5854794141;Ne;2;0;0;2
3581;Lakštingala;Bitutės;2423761155;Ne;5;0;0;5
3582;Lakštingala;Bitutės;5920907667;Ne;0;11;0;11
3583;Lakštingala;Pūkeliai;9093654437;Taip;0;0;1;1
3584;Lakštingala;Pūkeliai;3877448215;Ne;5;1;0;6
3585;Lakštingala;Pūkeliai;6148942052;Ne;10;0;0;10
3586;Lakštingala;Pūkeliai;7623917384;Ne;9;0;0;9
3587;Lakštingala;Pūkeliai;6011421835;Ne;6;0;0;6
3588;Lakštingala;Pūkeliai;8861428074;Ne;8;0;1;9
3589;Lakštingala;Pūkeliai;2673030043;Ne;0;6;1;7
3590;Lakštingala;Pūkeliai;2346497467;Ne;16;0;1;17
3591;Lakštingala;Pūkeliai;2010478542;Ne;14;0;0;14
3592;Lakštingala;Pūkeliai;1903292595;Ne;6;0;1;7
3593;Lakštingala;Pūkeliai;6764453371;Ne;0;1;0;1
3594;Lakštingala;Pūkeliai;9894103692;Ne;1;5;0;6
3595;Lakštingala;Pūkeliai;1371422364;Ne;0;8;0;8
3596;Lakštingala;Pūkeliai;8800538473;Ne;0;12;1;13
3597;Lakštingala;Pūkeliai;6285766353;Ne;5;0;0;5
3598;Lakštingala;Pūkeliai;3752408599;Ne;0;0;1;1
3599;Lakštingala;Pūkeliai;9183206191;Ne;3;0;1;4
3600;Lakštingala;Pūkeliai;2611117446;Ne;16;0;0;16
3601;Lakštingala;Pūkeliai;5524522038;Ne;16;0;0;16
3602;Lakštingala;Pūkeliai;5890760362;Ne;7;1;1;9
3603;Lakštingala;Pūkeliai;5583075385;Ne;7;0;0;7
3604;Lakštingala;Pūkeliai;4234177812;Ne;4;0;1;5
3605;Lakštingala;Pūkeliai;5903339111;Ne;6;0;2;8
3606;Lakštingala;Aitvariukai;1474796466;Ne;5;0;1;6
3607;Lakštingala;Aitvariukai;9629855134;Ne;0;0;1;1
3608;Lakštingala;Aitvariukai;4546036762;Ne;1;0;1;2
3609;Lakštingala;Aitvariukai;6219896499;Ne;4;0;1;5
3610;Lakštingala;Aitvariukai;7876311404;Ne;4;0;0;4
3611;Lakštingala;Aitvariukai;1248909711;Ne;1;0;1;2
3612;Lakštingala;Aitvariukai;9676872125;Ne;8;0;0;8
3613;Lakštingala;Aitvariukai;9083753159;Ne;2;0;1;3
3614;Lakštingala;Aitvariukai;7879280198;Ne;3;0;0;3
3615;Lakštingala;Aitvariukai;4403673558;Taip;21;0;0;21
3616;Lakštingala;Aitvariukai;5693413287;Taip;11;0;1;12
3617;Lakštingala;Aitvariukai;7240426529;Taip;4;0;1;5
3618;Lakštingala;Aitvariukai;8558000223;Ne;4;0;2;6
3619;Lakštingala;Aitvariukai;5244646855;Ne;2;0;1;3
3620;Lakštingala;Aitvariukai;5602079341;Ne;6;1;1;8
3621;Lakštingala;Aitvariukai;3166474163;Ne;5;0;1;6
3622;Lakštingala;Aitvariukai;8609822839;Ne;0;0;1;1
3623;Lakštingala;Aitvariukai;6180443056;Ne;0;5;0;5
3624;Lakštingala;Aitvariukai;3113050690;Ne;0;0;1;1
3625;Lakštingala;Aitvariukai;6389721877;Ne;9;0;6;15
3626;Lakštingala;Aitvariukai;4211861355;Ne;9;0;1;10
3627;Lakštingala;Aitvariukai;6872095965;Taip;1;0;1;2
3628;Lakštingala;Boružiukai;1898853302;Ne;0;1;0;1
3629;Lakštingala;Boružiukai;8284565948;Ne;12;1;0;13
3630;Lakštingala;Boružiukai;4857448665;Ne;0;2;1;3
3631;Lakštingala;Boružiukai;1863034132;Taip;0;1;0;1
3632;Lakštingala;Boružiukai;8217315818;Ne;10;0;0;10
3633;Lakštingala;Boružiukai;9912622093;Taip;0;9;0;9
3634;Lakštingala;Boružiukai;6292331193;Ne;5;0;0;5
3635;Lakštingala;Boružiukai;3509165175;Ne;3;0;0;3
3636;Lakštingala;Boružiukai;4179366572;Ne;2;2;0;4
3637;Lakštingala;Boružiukai;9489982241;Ne;0;1;0;1
3638;Lakštingala;Boružiukai;3993759015;Ne;2;7;0;9
3639;Lakštingala;Boružiukai;5445945319;Ne;1;0;0;1
3640;Lakštingala;Boružiukai;2652305131;Ne;0;1;0;1
3641;Lakštingala;Boružiukai;9725851433;Ne;0;9;0;9
3642;Lakštingala;Boružiukai;1655202909;Ne;6;2;0;8
3643;Lakštingala;Boružiukai;6009631424;Ne;3;0;0;3
3644;Lakštingala;Boružiukai;9375002191;Ne;0;1;0;1
3645;Lakštingala;Boružiukai;7963839249;Ne;2;2;0;4
3646;Lakštingala;Boružiukai;2073818724;Ne;5;0;1;6
3647;Lakštingala;Boružiukai;7994475429;Ne;0;2;0;2
3648;Lakštingala;Boružiukai;2266870318;Ne;0;1;0;1
3649;Lakštingala;Boružiukai;9346986726;Ne;5;0;0;5
3650;Lakštingala;Žiogeliai;5048686136;Ne;0;0;7;7
3651;Lakštingala;Žiogeliai;8404025659;Taip;10;0;3;13
3652;Lakštingala;Žiogeliai;4113993067;Taip;0;3;0;3
3653;Lakštingala;Žiogeliai;6981178960;Ne;0;0;1;1
3654;Lakštingala;Žiogeliai;3908175786;Ne;9;0;1;10
3655;Lakštingala;Žiogeliai;9860169528;Ne;8;0;7;15
3656;Lakštingala;Žiogeliai;4935753482;Ne;0;0;9;9
3657;Lakštingala;Žiogeliai;3439681068;Ne;0;0;11;11
3658;Lakštingala;Žiogeliai;3766986041;Ne;7;0;11;18
3659;Lakštingala;Žiogeliai;1974950823;Ne;0;5;0;5
3660;Lakštingala;Žiogeliai;6561743084;Ne;0;0;1;1
3661;Lakštingala;Žiogeliai;1226908540;Ne;6;0;3;9
3662;Lakštingala;Žiogeliai;3951057865;Ne;0;13;0;13
3663;Lakštingala;Žiogeliai;1494530289;Ne;2;0;5;7
3664;Lakštingala;Žiogeliai;7661973162;Ne;0;0;1;1
3665;Lakštingala;Žiogeliai;7104398627;Ne;5;0;0;5
3666;Lakštingala;Žiogeliai;7361353346;Ne;6;0;0;6
3667;Lakštingala;Žiogeliai;4790291839;Ne;5;1;0;6
3668;Lakštingala;Žiogeliai;8351970017;Taip;0;1;2;3
3669;Lakštingala;Žiogeliai;8333832673;Ne;0;2;0;2
3670;Lakštingala;Žiogeliai;5849662446;Ne;0;4;0;4
3671;Lakštingala;SPINDULIUKAI;4365413054;Taip;0;0;9;9
3672;Lakštingala;SPINDULIUKAI;9762500668;Ne;5;0;0;5
3673;Lakštingala;SPINDULIUKAI;7640007392;Ne;0;14;0;14
3674;Lakštingala;SPINDULIUKAI;4784677514;Ne;0;9;0;9
3675;Lakštingala;SPINDULIUKAI;2022621678;Ne;0;0;7;7
3676;Lakštingala;SPINDULIUKAI;8429523368;Ne;0;2;0;2
3677;Lakštingala;SPINDULIUKAI;6668075753;Ne;4;0;2;6
3678;Lakštingala;SPINDULIUKAI;9081653166;Ne;0;1;0;1
3679;Lakštingala;SPINDULIUKAI;8722490845;Ne;4;0;0;4
3680;Lakštingala;SPINDULIUKAI;3823860988;Ne;0;0;6;6
3681;Lakštingala;SPINDULIUKAI;7141840160;Ne;0;2;1;3
3682;Lakštingala;SPINDULIUKAI;2795341401;Ne;0;6;3;9
3683;Lakštingala;SPINDULIUKAI;9052256710;Ne;0;1;0;1
3684;Lakštingala;SPINDULIUKAI;8130468345;Ne;0;1;1;2
3685;Lakštingala;SPINDULIUKAI;2626498928;Ne;5;1;0;6
3686;Lakštingala;SPINDULIUKAI;9441296489;Ne;0;1;0;1
3687;Lakštingala;Pėledžiukai;6135103377;Ne;4;0;1;5
3688;Lakštingala;Pėledžiukai;4774354751;Taip;5;2;6;13
3689;Lakštingala;Pėledžiukai;8375506323;Ne;0;7;1;8
3690;Lakštingala;Pėledžiukai;2738882466;Ne;0;0;3;3
3691;Lakštingala;Pėledžiukai;8075192528;Ne;0;2;5;7
3692;Lakštingala;Pėledžiukai;4270513515;Ne;0;1;0;1
3693;Lakštingala;Pėledžiukai;6866935290;Ne;11;0;0;11
3694;Lakštingala;Pėledžiukai;8787118512;Taip;5;2;1;8
3695;Lakštingala;Pėledžiukai;6805882038;Ne;4;1;0;5
3696;Lakštingala;Pėledžiukai;7139669240;Ne;5;2;5;12
3697;Lakštingala;Pėledžiukai;9502994399;Ne;0;0;6;6
3698;Lakštingala;Pėledžiukai;9431022632;Ne;8;2;0;10
3699;Lakštingala;Pėledžiukai;9856189053;Ne;0;3;0;3
3700;Lakštingala;Pėledžiukai;5391954600;Ne;0;1;0;1
3701;Lakštingala;Pėledžiukai;4608719006;Ne;0;6;0;6
3702;Lakštingala;Pėledžiukai;5812491783;Ne;6;0;1;7
3703;Lakštingala;Pėledžiukai;9899997020;Ne;5;0;0;5
3704;Lakštingala;Pėledžiukai;6369696598;Ne;0;1;1;2
3705;Lakštingala;Pėledžiukai;9297542026;Ne;0;0;3;3
3706;Lakštingala;Pėledžiukai;3618452008;Ne;0;2;0;2
3707;Lakštingala;Katinėliai;7351891043;Ne;3;0;2;5
3708;Lakštingala;Katinėliai;2610113024;Ne;0;0;3;3
3709;Lakštingala;Katinėliai;7987187638;Ne;10;0;1;11
3710;Lakštingala;Katinėliai;8900191763;Ne;10;0;1;11
3711;Lakštingala;Katinėliai;2029350217;Ne;0;0;6;6
3712;Lakštingala;Katinėliai;3899425918;Ne;8;0;0;8
3713;Lakštingala;Katinėliai;4165688458;Ne;5;0;1;6
3714;Lakštingala;Katinėliai;2841048627;Ne;5;0;2;7
3715;Lakštingala;Katinėliai;1279172936;Ne;3;0;8;11
3716;Lakštingala;Katinėliai;2333102026;Ne;0;0;4;4
3717;Lakštingala;Katinėliai;2662167519;Ne;3;0;2;5
3718;Lakštingala;Katinėliai;3227628813;Ne;7;0;2;9
3719;Lakštingala;Katinėliai;2770661353;Ne;0;0;8;8
3720;Lakštingala;Deimantėliai;2114708431;Ne;0;1;4;5
3721;Lakštingala;Deimantėliai;8074211850;Ne;3;0;1;4
3722;Lakštingala;Deimantėliai;6749980386;Ne;3;0;1;4
3723;Lakštingala;Deimantėliai;9072843429;Ne;5;0;4;9
3724;Lakštingala;Deimantėliai;8938720617;Ne;10;0;0;10
3725;Lakštingala;Deimantėliai;7853382073;Ne;0;0;3;3
3726;Lakštingala;Deimantėliai;1276857151;Ne;11;1;0;12
3727;Lakštingala;Deimantėliai;6971655647;Ne;5;0;4;9
3728;Lakštingala;Deimantėliai;7043519686;Ne;1;2;1;4
3729;Lakštingala;Deimantėliai;4976683143;Taip;2;0;3;5
3730;Lakštingala;Deimantėliai;7078051438;Ne;5;0;0;5
3731;Lakštingala;Deimantėliai;8571415914;Ne;0;5;0;5
3732;Lakštingala;Deimantėliai;8711116860;Ne;0;0;2;2
3733;Lakštingala;Deimantėliai;2886415541;Ne;0;2;0;2
3734;Lakštingala;Deimantėliai;1661358666;Ne;0;0;2;2
3735;Lakštingala;Deimantėliai;9312563560;Ne;2;0;0;2
3736;Lakštingala;Deimantėliai;4199371972;Ne;4;1;0;5
3737;Lakštingala;KIŠKUČIAI;6520436055;Taip;7;1;0;8
3738;Lakštingala;KIŠKUČIAI;3208321841;Taip;14;1;0;15
3739;Lakštingala;KIŠKUČIAI;6970022417;Ne;0;1;2;3
3740;Lakštingala;KIŠKUČIAI;5730122965;Ne;0;2;0;2
3741;Lakštingala;KIŠKUČIAI;4140403601;Taip;0;5;0;5
3742;Lakštingala;KIŠKUČIAI;6689018476;Ne;1;1;0;2
3743;Lakštingala;KIŠKUČIAI;9539081376;Ne;0;0;4;4
3744;Lakštingala;KIŠKUČIAI;4854843534;Ne;5;0;0;5
3745;Lakštingala;KIŠKUČIAI;9162902701;Ne;0;0;19;19
3746;Lakštingala;KIŠKUČIAI;5455119187;Ne;1;0;1;2
3747;Lakštingala;KIŠKUČIAI;1113674539;Ne;8;1;1;10
3748;Lakštingala;KIŠKUČIAI;4370431439;Ne;8;1;0;9
3749;Lakštingala;KIŠKUČIAI;1898108870;Ne;8;2;0;10
3750;Lakštingala;KIŠKUČIAI;6652822827;Ne;0;0;6;6
3751;Lakštingala;KIŠKUČIAI;2998581623;Ne;0;5;0;5
3752;Lakštingala;KIŠKUČIAI;8414220381;Ne;5;0;1;6
3753;Lakštingala;KIŠKUČIAI;7817830649;Ne;0;6;0;6
3754;Lakštingala;KIŠKUČIAI;4653006161;Ne;0;2;0;2
3755;Lakštingala;KIŠKUČIAI;1831078544;Ne;12;0;2;14
3756;Lakštingala;KIŠKUČIAI;4184814075;Ne;0;2;1;3
3757;Lašelis;VIŠČIUKAI;6477439886;Ne;0;4;0;4
3758;Lašelis;VIŠČIUKAI;6912802425;Ne;2;0;0;2
3759;Lašelis;VIŠČIUKAI;6857428142;Ne;5;1;0;6
3760;Lašelis;VIŠČIUKAI;5759317067;Ne;3;3;0;6
3761;Lašelis;VIŠČIUKAI;1367955273;Ne;0;8;0;8
3762;Lašelis;VIŠČIUKAI;2702582486;Ne;3;0;0;3
3763;Lašelis;VIŠČIUKAI;2824852871;Ne;0;13;0;13
3764;Lašelis;VIŠČIUKAI;1294930990;Ne;0;2;0;2
3765;Lašelis;VIŠČIUKAI;3003679103;Ne;0;0;1;1
3766;Lašelis;VIŠČIUKAI;4427263877;Ne;0;13;0;13
3767;Lašelis;VIŠČIUKAI;1168408482;Ne;2;0;0;2
3768;Lašelis;VIŠČIUKAI;4748156580;Ne;0;0;1;1
3769;Lašelis;VIŠČIUKAI;4860925464;Ne;0;0;2;2
3770;Lašelis;VIŠČIUKAI;2915806799;Ne;6;0;1;7
3771;Lašelis;VIŠČIUKAI;2900106941;Ne;4;0;0;4
3772;Lašelis;VIŠČIUKAI;2748888134;Ne;2;0;0;2
3773;Lašelis;ŠYPSENA;6317716501;Ne;5;0;0;5
3774;Lašelis;ŠYPSENA;7502668870;Ne;0;3;0;3
3775;Lašelis;ŠYPSENA;7784416134;Ne;0;2;0;2
3776;Lašelis;ŠYPSENA;4051058266;Ne;0;2;0;2
3777;Lašelis;ŠYPSENA;2991487552;Ne;15;0;0;15
3778;Lašelis;ŠYPSENA;7418586100;Ne;12;0;0;12
3779;Lašelis;ŠYPSENA;1429188137;Ne;5;0;0;5
3780;Lašelis;ŠYPSENA;1131591230;Ne;4;6;0;10
3781;Lašelis;ŠYPSENA;1343964112;Ne;6;0;0;6
3782;Lašelis;ŠYPSENA;7811809908;Ne;5;0;0;5
3783;Lašelis;ŠYPSENA;1882188961;Taip;4;0;0;4
3784;Lašelis;ŠYPSENA;4893073148;Ne;0;3;0;3
3785;Lašelis;ŠYPSENA;2210081848;Ne;2;0;0;2
3786;Lašelis;ŠYPSENA;8834899622;Ne;6;0;0;6
3787;Lašelis;ŠYPSENA;1070067484;Ne;8;0;0;8
3788;Lašelis;ŠYPSENA;4805028666;Ne;11;0;0;11
3789;Lašelis;NYKŠTUKAI;1426555166;Ne;8;0;1;9
3790;Lašelis;NYKŠTUKAI;2509469243;Ne;10;8;3;21
3791;Lašelis;NYKŠTUKAI;4832223461;Ne;5;0;1;6
3792;Lašelis;NYKŠTUKAI;5416590600;Ne;10;8;3;21
3793;Lašelis;NYKŠTUKAI;1490179832;Ne;5;8;1;14
3794;Lašelis;NYKŠTUKAI;3995905195;Ne;0;21;0;21
3795;Lašelis;NYKŠTUKAI;1808067249;Ne;11;1;0;12
3796;Lašelis;NYKŠTUKAI;1060784180;Taip;0;14;0;14
3797;Lašelis;NYKŠTUKAI;6137626795;Ne;4;0;1;5
3798;Lašelis;NYKŠTUKAI;1635921119;Ne;8;1;0;9
3799;Lašelis;NYKŠTUKAI;6836452490;Ne;0;0;1;1
3800;Lašelis;NYKŠTUKAI;9664015801;Ne;0;2;0;2
3801;Lašelis;NYKŠTUKAI;1983312896;Ne;0;8;0;8
3802;Lašelis;NYKŠTUKAI;1279052767;Ne;0;20;0;20
3803;Lašelis;NYKŠTUKAI;8906479495;Ne;6;0;1;7
3804;Lašelis;NYKŠTUKAI;9434932943;Ne;10;2;0;12
3805;Lašelis;NYKŠTUKAI;2593126568;Ne;0;0;6;6
3806;Lašelis;SAULUTĖ;3495676199;Ne;0;1;0;1
3807;Lašelis;SAULUTĖ;1085950130;Taip;1;0;0;1
3808;Lašelis;SAULUTĖ;1175045927;Ne;1;1;0;2
3809;Lašelis;SAULUTĖ;5931015581;Ne;5;0;0;5
3810;Lašelis;SAULUTĖ;8132517365;Ne;7;0;0;7
3811;Lašelis;SAULUTĖ;9647340725;Ne;21;0;0;21
3812;Lašelis;SAULUTĖ;1042560186;Taip;0;5;0;5
3813;Lašelis;SAULUTĖ;1035888733;Ne;0;5;0;5
3814;Lašelis;SAULUTĖ;1926439959;Ne;2;1;0;3
3815;Lašelis;SAULUTĖ;4508779926;Ne;6;0;0;6
3816;Lašelis;SAULUTĖ;1415345442;Ne;8;0;0;8
3817;Lašelis;SAULUTĖ;8318512396;Ne;0;19;0;19
3818;Lašelis;SAULUTĖ;8814796010;Ne;0;4;0;4
3819;Lašelis;SAULUTĖ;2886967297;Ne;1;0;0;1
3820;Lašelis;SAULUTĖ;3805049682;Ne;8;10;0;18
3821;Lašelis;SAULUTĖ;2401058384;Ne;11;1;0;12
3822;Lašelis;SAULUTĖ;3675606390;Ne;0;2;0;2
3823;Lašelis;BORUŽĖLĖS;5000188106;Ne;12;0;0;12
3824;Lašelis;BORUŽĖLĖS;6203027620;Ne;8;0;0;8
3825;Lašelis;BORUŽĖLĖS;7619426839;Ne;12;4;0;16
3826;Lašelis;BORUŽĖLĖS;8718481664;Ne;12;0;0;12
3827;Lašelis;BORUŽĖLĖS;3130271837;Ne;0;3;0;3
3828;Lašelis;BORUŽĖLĖS;2871149756;Ne;6;0;0;6
3829;Lašelis;BORUŽĖLĖS;7920615797;Ne;1;0;0;1
3830;Lašelis;BORUŽĖLĖS;8212250478;Ne;0;5;0;5
3831;Lašelis;BORUŽĖLĖS;1675784376;Ne;9;0;0;9
3832;Lašelis;BORUŽĖLĖS;6275226824;Ne;1;0;0;1
3833;Lašelis;BORUŽĖLĖS;6751223169;Ne;5;0;0;5
3834;Lašelis;BORUŽĖLĖS;7432843976;Ne;6;0;0;6
3835;Lašelis;BORUŽĖLĖS;3567172061;Ne;7;0;0;7
3836;Lašelis;BORUŽĖLĖS;3183193902;Ne;2;0;0;2
3837;Lašelis;BORUŽĖLĖS;9879208797;Ne;7;0;0;7
3838;Lašelis;SKRUZDELIUKAI;5535348173;Ne;2;0;0;2
3839;Lašelis;SKRUZDELIUKAI;4571213887;Ne;1;0;0;1
3840;Lašelis;SKRUZDELIUKAI;7367252046;Ne;3;0;0;3
3841;Lašelis;SKRUZDELIUKAI;9364834089;Ne;10;0;0;10
3842;Lašelis;SKRUZDELIUKAI;2200081600;Taip;4;0;0;4
3843;Lašelis;SKRUZDELIUKAI;6130824517;Ne;4;0;0;4
3844;Lašelis;SKRUZDELIUKAI;9905868465;Ne;4;0;0;4
3845;Lašelis;SKRUZDELIUKAI;9394906598;Ne;3;0;0;3
3846;Lašelis;SKRUZDELIUKAI;9976394850;Ne;13;0;0;13
3847;Lašelis;SKRUZDELIUKAI;7610658433;Ne;7;0;0;7
3848;Lašelis;SKRUZDELIUKAI;4802629905;Ne;7;0;0;7
3849;Lašelis;SKRUZDELIUKAI;4487717519;Ne;4;3;0;7
3850;Lazdynėlis;BITUTĖS;1748260780;Ne;0;5;0;5
3851;Lazdynėlis;BITUTĖS;2044188250;Ne;0;0;1;1
3852;Lazdynėlis;BITUTĖS;4545757725;Ne;3;0;0;3
3853;Lazdynėlis;BITUTĖS;4153294595;Taip;5;0;0;5
3854;Lazdynėlis;BITUTĖS;7910561870;Ne;2;0;0;2
3855;Lazdynėlis;BITUTĖS;6276697479;Ne;0;0;2;2
3856;Lazdynėlis;BITUTĖS;9886856760;Ne;0;3;0;3
3857;Lazdynėlis;BITUTĖS;2998606948;Ne;0;3;0;3
3858;Lazdynėlis;BITUTĖS;5796381191;Ne;11;10;0;21
3859;Lazdynėlis;BITUTĖS;4771173060;Ne;10;0;1;11
3860;Lazdynėlis;BITUTĖS;1355954767;Ne;0;1;0;1
3861;Lazdynėlis;BITUTĖS;1070172991;Ne;2;0;0;2
3862;Lazdynėlis;EŽIUKAI;3040417651;Ne;2;1;1;4
3863;Lazdynėlis;EŽIUKAI;6021387236;Ne;0;3;7;10
3864;Lazdynėlis;EŽIUKAI;7945472048;Ne;5;0;1;6
3865;Lazdynėlis;EŽIUKAI;1168433014;Taip;0;10;0;10
3866;Lazdynėlis;EŽIUKAI;7655218276;Ne;0;1;0;1
3867;Lazdynėlis;EŽIUKAI;6031442797;Ne;0;1;2;3
3868;Lazdynėlis;EŽIUKAI;3764854654;Taip;0;1;1;2
3869;Lazdynėlis;EŽIUKAI;5832624944;Ne;6;1;1;8
3870;Lazdynėlis;EŽIUKAI;1499729462;Ne;2;1;0;3
3871;Lazdynėlis;EŽIUKAI;2294873565;Ne;2;1;0;3
3872;Lazdynėlis;EŽIUKAI;2911152510;Ne;1;1;2;4
3873;Lazdynėlis;EŽIUKAI;3036055537;Ne;0;1;0;1
3874;Lazdynėlis;EŽIUKAI;6817162699;Ne;0;10;0;10
3875;Lazdynėlis;EŽIUKAI;8530159773;Ne;0;1;0;1
3876;Lazdynėlis;EŽIUKAI;7552873109;Ne;7;1;0;8
3877;Lazdynėlis;EŽIUKAI;9519409694;Ne;10;0;0;10
3878;Lazdynėlis;EŽIUKAI;2526260625;Ne;0;0;1;1
3879;Lazdynėlis;EŽIUKAI;2933025284;Ne;0;3;0;3
3880;Lazdynėlis;BORUŽIUKAI;8337458289;Ne;0;21;0;21
3881;Lazdynėlis;BORUŽIUKAI;7692056055;Ne;0;1;0;1
3882;Lazdynėlis;BORUŽIUKAI;6394994841;Ne;0;7;0;7
3883;Lazdynėlis;BORUŽIUKAI;2009941344;Taip;2;6;0;8
3884;Lazdynėlis;BORUŽIUKAI;1653216959;Ne;11;0;1;12
3885;Lazdynėlis;BORUŽIUKAI;4190852647;Taip;13;0;0;13
3886;Lazdynėlis;BORUŽIUKAI;2058909635;Ne;0;22;0;22
3887;Lazdynėlis;BORUŽIUKAI;3105363578;Ne;0;22;0;22
3888;Lazdynėlis;BORUŽIUKAI;5622254334;Ne;11;0;0;11
3889;Lazdynėlis;BORUŽIUKAI;7587041613;Ne;7;0;1;8
3890;Lazdynėlis;BORUŽIUKAI;2632078843;Ne;22;0;0;22
3891;Lazdynėlis;BORUŽIUKAI;5756228709;Ne;0;2;0;2
3892;Lazdynėlis;BORUŽIUKAI;6824473598;Ne;2;1;0;3
3893;Lazdynėlis;BORUŽIUKAI;1707231039;Ne;0;22;0;22
3894;Lazdynėlis;BORUŽIUKAI;4642875037;Ne;0;6;0;6
3895;Lazdynėlis;BORUŽIUKAI;1722503577;Ne;7;0;1;8
3896;Lazdynėlis;BORUŽIUKAI;4595080695;Ne;0;22;0;22
3897;Lazdynėlis;BORUŽIUKAI;4958640516;Ne;6;0;1;7
3898;Lazdynėlis;BORUŽIUKAI;3351966091;Ne;0;14;2;16
3899;Lazdynėlis;BORUŽIUKAI;9548866880;Ne;7;0;1;8
3900;Lazdynėlis;BORUŽIUKAI;6633585181;Taip;0;0;1;1
3901;Lazdynėlis;KAČIUKAI;2958520599;Ne;0;0;3;3
3902;Lazdynėlis;KAČIUKAI;6657174602;Ne;0;0;2;2
3903;Lazdynėlis;KAČIUKAI;2013752858;Ne;0;0;1;1
3904;Lazdynėlis;KAČIUKAI;2586187455;Ne;0;0;1;1
3905;Lazdynėlis;KAČIUKAI;7911328294;Ne;0;0;1;1
3906;Lazdynėlis;KAČIUKAI;4881322530;Ne;0;0;1;1
3907;Lazdynėlis;KAČIUKAI;8159928299;Ne;0;0;2;2
3908;Lazdynėlis;KAČIUKAI;1574847460;Ne;0;0;2;2
3909;Lazdynėlis;KAČIUKAI;4462819848;Ne;0;0;1;1
3910;Lazdynėlis;KAČIUKAI;9693153118;Ne;0;0;2;2
3911;Lazdynėlis;KAČIUKAI;7719697394;Ne;2;1;1;4
3912;Lazdynėlis;KAČIUKAI;4055450300;Ne;3;0;2;5
3913;Lazdynėlis;KAČIUKAI;6056618348;Ne;0;0;1;1
3914;Lazdynėlis;KAČIUKAI;3667994076;Ne;0;0;4;4
3915;Lazdynėlis;VOVERIUKAI;1312649234;Ne;0;0;2;2
3916;Lazdynėlis;VOVERIUKAI;7135087818;Ne;0;0;3;3
3917;Lazdynėlis;VOVERIUKAI;3097254722;Ne;0;1;2;3
3918;Lazdynėlis;VOVERIUKAI;6352480127;Ne;0;0;2;2
3919;Lazdynėlis;VOVERIUKAI;6814362584;Ne;0;0;3;3
3920;Lazdynėlis;VOVERIUKAI;4293473176;Ne;5;0;0;5
3921;Lazdynėlis;VOVERIUKAI;2723284353;Ne;0;1;1;2
3922;Lazdynėlis;VOVERIUKAI;6008610525;Ne;0;2;0;2
3923;Lazdynėlis;VOVERIUKAI;4031719765;Ne;0;7;0;7
3924;Lazdynėlis;RIEŠUTĖLIAI;3086059608;Ne;2;0;0;2
3925;Lazdynėlis;RIEŠUTĖLIAI;5987500024;Ne;4;0;0;4
3926;Lazdynėlis;RIEŠUTĖLIAI;2453740823;Ne;0;1;0;1
3927;Lazdynėlis;RIEŠUTĖLIAI;7545621720;Ne;0;1;0;1
3928;Lazdynėlis;RIEŠUTĖLIAI;8179584161;Ne;5;0;0;5
3929;Lazdynėlis;RIEŠUTĖLIAI;8942906327;Ne;15;0;0;15
3930;Lazdynėlis;RIEŠUTĖLIAI;9582702244;Ne;5;2;0;7
3931;Lazdynėlis;RIEŠUTĖLIAI;7523052754;Ne;0;4;0;4
3932;Lazdynėlis;RIEŠUTĖLIAI;4092363029;Ne;6;3;0;9
3933;Lazdynėlis;RIEŠUTĖLIAI;3250913116;Taip;0;1;1;2
3934;Lazdynėlis;RIEŠUTĖLIAI;8529192130;Ne;0;1;1;2
3935;Lazdynėlis;RIEŠUTĖLIAI;5354852979;Ne;4;2;0;6
3936;Lazdynėlis;RIEŠUTĖLIAI;6831456807;Ne;5;1;0;6
3937;Lazdynėlis;RIEŠUTĖLIAI;4795464133;Ne;0;1;0;1
3938;Lazdynėlis;RIEŠUTĖLIAI;7754329238;Ne;6;1;0;7
3939;Lazdynėlis;RIEŠUTĖLIAI;1488371861;Ne;3;0;0;3
3940;Lazdynėlis;ANČIUKAI;4189563297;Ne;2;0;0;2
3941;Lazdynėlis;ANČIUKAI;6575706614;Ne;2;0;0;2
3942;Lazdynėlis;ANČIUKAI;6284781209;Ne;6;1;0;7
3943;Lazdynėlis;ANČIUKAI;7261983723;Ne;4;0;0;4
3944;Lazdynėlis;ANČIUKAI;7386794107;Ne;5;0;0;5
3945;Lazdynėlis;ANČIUKAI;9724741469;Ne;7;0;0;7
3946;Lazdynėlis;ANČIUKAI;3060705012;Ne;2;0;0;2
3947;Lazdynėlis;GUDRUČIAI;3357092509;Ne;8;0;1;9
3948;Lazdynėlis;GUDRUČIAI;6994408527;Ne;1;0;1;2
3949;Lazdynėlis;GUDRUČIAI;2514035189;Ne;6;1;2;9
3950;Lazdynėlis;GUDRUČIAI;5889772626;Ne;0;0;1;1
3951;Lazdynėlis;GUDRUČIAI;6559543013;Ne;0;6;1;7
3952;Lazdynėlis;GUDRUČIAI;9231049001;Taip;0;0;1;1
3953;Lazdynėlis;GUDRUČIAI;5051632567;Ne;6;0;0;6
3954;Lazdynėlis;GUDRUČIAI;4550819172;Ne;0;1;2;3
3955;Lazdynėlis;GUDRUČIAI;8314002741;Ne;0;0;1;1
3956;Lazdynėlis;GUDRUČIAI;3365726271;Ne;0;1;1;2
3957;Lazdynėlis;GUDRUČIAI;7941793866;Ne;2;0;1;3
3958;Lazdynėlis;GUDRUČIAI;2802505435;Ne;0;0;1;1
3959;Lazdynėlis;MEŠKIUKAI;4094713096;Ne;3;1;1;5
3960;Lazdynėlis;MEŠKIUKAI;3427972329;Ne;0;9;0;9
3961;Lazdynėlis;MEŠKIUKAI;6941986839;Ne;9;0;0;9
3962;Lazdynėlis;MEŠKIUKAI;9590507486;Ne;0;1;0;1
3963;Lazdynėlis;MEŠKIUKAI;5982766841;Ne;0;21;0;21
3964;Lazdynėlis;MEŠKIUKAI;4408660083;Ne;2;0;2;4
3965;Lazdynėlis;MEŠKIUKAI;8567304224;Ne;5;0;0;5
3966;Lazdynėlis;MEŠKIUKAI;4366502064;Taip;4;0;0;4
3967;Lazdynėlis;MEŠKIUKAI;1331380925;Ne;0;8;0;8
3968;Lazdynėlis;MEŠKIUKAI;5301881620;Ne;3;5;0;8
3969;Lazdynėlis;MEŠKIUKAI;8473007295;Ne;0;0;1;1
3970;Liepsnelė;Varpeliai;7992655946;Ne;6;0;0;6
3971;Liepsnelė;"NAUJA NYKŠTUKAI";1924079984;Ne;5;0;0;5
3972;Markučiai;Žirniukų;3525681034;Ne;5;5;0;10
3973;Markučiai;Žirniukų;7312533881;Ne;5;5;0;10
3974;Markučiai;Žirniukų;8934965409;Ne;1;0;0;1
3975;Markučiai;Žirniukų;8360526946;Ne;12;4;0;16
3976;Markučiai;Žirniukų;7244815252;Ne;1;0;0;1
3977;Markučiai;Žirniukų;2096169972;Ne;7;0;0;7
3978;Markučiai;Žirniukų;3073404128;Ne;7;0;0;7
3979;Markučiai;Žirniukų;5614488534;Ne;11;0;0;11
3980;Markučiai;Žirniukų;2367999201;Taip;14;0;0;14
3981;Markučiai;Žirniukų;2099285475;Taip;18;0;0;18
3982;Markučiai;Žirniukų;2344252204;Ne;8;0;0;8
3983;Markučiai;Žirniukų;9576412366;Ne;2;0;0;2
3984;Markučiai;Žirniukų;1395241501;Ne;12;0;0;12
3985;Markučiai;Žirniukų;8046320044;Ne;2;0;0;2
3986;Markučiai;Žirniukų;2060024771;Ne;10;0;0;10
3987;Markučiai;Žirniukų;6815286823;Ne;11;0;0;11
3988;Markučiai;Nykštukų;7507551844;Ne;1;0;0;1
3989;Markučiai;Nykštukų;9545967631;Ne;4;0;0;4
3990;Markučiai;Nykštukų;6121911851;Ne;2;0;0;2
3991;Markučiai;Nykštukų;6898055631;Taip;3;1;0;4
3992;Markučiai;Nykštukų;3378749042;Ne;0;9;0;9
3993;Markučiai;Nykštukų;4485929800;Ne;1;0;0;1
3994;Markučiai;Nykštukų;7624913025;Ne;0;8;0;8
3995;Markučiai;Nykštukų;4679710493;Ne;0;5;0;5
3996;Markučiai;Nykštukų;2994895532;Ne;5;0;0;5
3997;Markučiai;Nykštukų;4846899377;Ne;1;0;0;1
3998;Markučiai;Nykštukų;4920107818;Ne;1;5;0;6
3999;Markučiai;Nykštukų;7680126946;Ne;16;0;0;16
4000;Markučiai;Nykštukų;4222017733;Ne;2;0;0;2
4001;Markučiai;Nykštukų;3414015064;Ne;4;0;0;4
4002;Markučiai;Nykštukų;7642401516;Ne;9;0;0;9
4003;Markučiai;Nykštukų;8055783293;Taip;0;6;0;6
4004;Markučiai;Pelėdžiukų;9180404247;Ne;3;7;2;12
4005;Markučiai;Pelėdžiukų;4653663237;Ne;13;0;1;14
4006;Markučiai;Pelėdžiukų;4418580273;Ne;1;0;0;1
4007;Markučiai;Pelėdžiukų;5522654429;Ne;4;1;0;5
4008;Markučiai;Pelėdžiukų;7539605426;Ne;0;0;1;1
4009;Markučiai;Pelėdžiukų;8888538915;Ne;4;0;1;5
4010;Markučiai;Pelėdžiukų;1799946177;Ne;0;0;1;1
4011;Markučiai;Pelėdžiukų;7809719827;Taip;2;1;2;5
4012;Markučiai;Pelėdžiukų;4860961508;Ne;0;0;1;1
4013;Markučiai;Pelėdžiukų;6569807889;Ne;9;0;2;11
4014;Markučiai;Pelėdžiukų;5269411010;Ne;10;0;3;13
4015;Markučiai;Pelėdžiukų;1524727903;Taip;1;0;0;1
4016;Markučiai;Pelėdžiukų;8839679529;Ne;4;0;1;5
4017;Markučiai;Boružėlių;8078777204;Ne;0;8;1;9
4018;Markučiai;Boružėlių;8244065962;Ne;4;1;0;5
4019;Markučiai;Boružėlių;5981692282;Ne;2;0;0;2
4020;Markučiai;Boružėlių;3739566642;Ne;5;4;0;9
4021;Markučiai;Boružėlių;6868394315;Ne;0;0;1;1
4022;Markučiai;Boružėlių;7634475536;Ne;0;0;1;1
4023;Markučiai;Boružėlių;5663147778;Ne;2;0;2;4
4024;Markučiai;Boružėlių;8271830626;Ne;7;0;0;7
4025;Markučiai;Boružėlių;3315824027;Ne;7;7;0;14
4026;Markučiai;Boružėlių;5562960498;Ne;2;1;0;3
4027;Markučiai;Boružėlių;6260010822;Ne;4;0;0;4
4028;Markučiai;Boružėlių;6707310242;Ne;1;5;2;8
4029;Markučiai;Boružėlių;9631684972;Ne;2;0;1;3
4030;Markučiai;Boružėlių;4911787595;Ne;3;0;0;3
4031;Markučiai;Boružėlių;1587323435;Ne;0;33;0;33
4032;Markučiai;Bitučių;8792524832;Ne;0;0;1;1
4033;Markučiai;Bitučių;9518247571;Ne;4;0;1;5
4034;Markučiai;Bitučių;4836298058;Ne;0;10;0;10
4035;Markučiai;Bitučių;9027071539;Ne;5;1;0;6
4036;Markučiai;Bitučių;8748794886;Ne;0;0;9;9
4037;Markučiai;Bitučių;7387460586;Ne;3;0;3;6
4038;Markučiai;Bitučių;8950442843;Ne;4;0;0;4
4039;Markučiai;Bitučių;2840564082;Ne;1;1;1;3
4040;Markučiai;Bitučių;3926993383;Ne;13;0;3;16
4041;Markučiai;Bitučių;6530101961;Ne;6;0;5;11
4042;Markučiai;Bitučių;1908302738;Ne;0;0;5;5
4043;Markučiai;Bitučių;7056367646;Ne;6;6;6;18
4044;Markučiai;Bitučių;8195584468;Ne;4;0;0;4
4045;Markučiai;Bitučių;2049497686;Ne;5;0;3;8
4046;Markučiai;Bitučių;8541042547;Ne;0;0;4;4
4047;Markučiai;Bitučių;1447116821;Ne;5;0;0;5
4048;Markučiai;Bitučių;2931958829;Ne;6;0;0;6
4049;Markučiai;Bitučių;9303448709;Ne;0;0;2;2
4050;Markučiai;Drugelių;2537459830;Ne;0;0;1;1
4051;Markučiai;Drugelių;2288910885;Ne;4;0;1;5
4052;Markučiai;Drugelių;3544565354;Ne;5;0;4;9
4053;Markučiai;Drugelių;9412129807;Ne;5;7;0;12
4054;Markučiai;Drugelių;6979218594;Ne;5;0;2;7
4055;Markučiai;Drugelių;3491734422;Ne;0;0;19;19
4056;Markučiai;Drugelių;3491734422;Ne;0;0;19;19
4057;Markučiai;Drugelių;3491734422;Ne;0;0;19;19
4058;Markučiai;Drugelių;3832641521;Ne;10;0;2;12
4059;Markučiai;Drugelių;4520724770;Ne;13;0;5;18
4060;Markučiai;Drugelių;9391866085;Ne;8;0;3;11
4061;Markučiai;Drugelių;2967726802;Ne;7;0;4;11
4062;Markučiai;Drugelių;6684544229;Taip;7;0;6;13
4063;Markučiai;Drugelių;3487571241;Ne;5;0;1;6
4064;Markučiai;Drugelių;6338612770;Ne;0;0;1;1
4065;Markučiai;Drugelių;1433469476;Ne;2;0;0;2
4066;Markučiai;Drugelių;7110705287;Ne;11;0;9;20
4067;Markučiai;Skruzdėliukų;8105747904;Taip;8;1;5;14
4068;Markučiai;Skruzdėliukų;6617799980;Ne;0;10;0;10
4069;Markučiai;Skruzdėliukų;7580249913;Ne;5;0;2;7
4070;Markučiai;Skruzdėliukų;2246646548;Ne;3;0;0;3
4071;Markučiai;Skruzdėliukų;9921530582;Ne;0;0;3;3
4072;Markučiai;Skruzdėliukų;6759427415;Ne;20;0;0;20
4073;Markučiai;Skruzdėliukų;4820576711;Ne;6;0;0;6
4074;Markučiai;Skruzdėliukų;1527620947;Ne;14;0;1;15
4075;Markučiai;Skruzdėliukų;8774323234;Ne;3;0;0;3
4076;Markučiai;Skruzdėliukų;7881183912;Ne;3;0;0;3
4077;Markučiai;Skruzdėliukų;5180034556;Ne;0;0;1;1
4078;Markučiai;Skruzdėliukų;4383128686;Ne;1;0;1;2
4079;Markučiai;Skruzdėliukų;8679791696;Ne;0;0;1;1
4080;Markučiai;Skruzdėliukų;2647189399;Taip;3;0;0;3
4081;Markučiai;Skruzdėliukų;3077125574;Ne;5;0;3;8
4082;Markučiai;Skruzdėliukų;1711102751;Ne;13;0;0;13
4083;Markučiai;ZUIKUČIŲ;8649978914;Ne;7;0;1;8
4084;Markučiai;ŽIOGELIŲ;3859363657;Ne;6;0;0;6
4085;Markučiai;ŽIOGELIŲ;3306931221;Taip;2;1;0;3
4086;Markučiai;ŽIOGELIŲ;9249362647;Ne;0;0;3;3
4087;Markučiai;ŽIOGELIŲ;7425442727;Ne;2;0;0;2
4088;Markučiai;ŽIOGELIŲ;3918398890;Ne;7;0;1;8
4089;Markučiai;ŽIOGELIŲ;6293219533;Ne;4;0;0;4
4090;Markučiai;ŽIOGELIŲ;9395009057;Ne;11;0;0;11
4091;Markučiai;ŽIOGELIŲ;4306059458;Ne;0;0;1;1
4092;Markučiai;ŽIOGELIŲ;5934853242;Ne;8;0;0;8
4093;Markučiai;ŽIOGELIŲ;1989450429;Ne;0;0;14;14
4094;Markučiai;ŽIOGELIŲ;7299207983;Taip;11;0;0;11
4095;Markučiai;ŽIOGELIŲ;5429666204;Taip;11;0;1;12
4096;Markučiai;Ežiukių;5474990334;Ne;19;0;0;19
4097;Markučiai;Ežiukių;4829322890;Ne;18;0;2;20
4098;Markučiai;Ežiukių;8045995558;Ne;0;0;7;7
4099;Markučiai;Ežiukių;3864391517;Ne;10;0;1;11
4100;Markučiai;Ežiukių;9448972984;Ne;10;0;3;13
4101;Markučiai;Ežiukių;9462937261;Ne;15;0;0;15
4102;Markučiai;Ežiukių;8085781929;Ne;0;0;2;2
4103;Markučiai;Ežiukių;2222934026;Ne;0;0;15;15
4104;Markučiai;Ežiukių;5096397215;Ne;13;0;0;13
4105;Markučiai;Ežiukių;7266459848;Ne;12;0;2;14
4106;Markučiai;Ežiukių;9707955312;Ne;1;0;0;1
4107;Markučiai;Ežiukių;3942674807;Ne;9;0;3;12
4108;Markučiai;Ežiukių;8338320308;Taip;4;0;2;6
4109;Markučiai;Ežiukių;1376430548;Ne;10;0;2;12
4110;Mažylis;"2 DARŽELIO GR.";4639389587;Ne;0;5;0;5
4111;Mažylis;"2 DARŽELIO GR.";1500475643;Ne;0;6;5;11
4112;Mažylis;"2 DARŽELIO GR.";8259994523;Ne;0;0;1;1
4113;Mažylis;"2 DARŽELIO GR.";4347489809;Ne;3;0;1;4
4114;Mažylis;"2 DARŽELIO GR.";5297935198;Ne;2;8;1;11
4115;Mažylis;"2 DARŽELIO GR.";1993916098;Taip;4;0;0;4
4116;Mažylis;"2 DARŽELIO GR.";4309902086;Ne;0;0;2;2
4117;Mažylis;"2 DARŽELIO GR.";5727207294;Ne;0;0;1;1
4118;Mažylis;"2 DARŽELIO GR.";3064367996;Ne;0;3;0;3
4119;Mažylis;"2 DARŽELIO GR.";4557902728;Ne;9;0;1;10
4120;Mažylis;"2 DARŽELIO GR.";4201114033;Ne;0;0;2;2
4121;Mažylis;"2 DARŽELIO GR.";7810360699;Ne;0;17;1;18
4122;Mažylis;"2 DARŽELIO GR.";3911343193;Ne;0;0;4;4
4123;Mažylis;"4 PRIEŠMOKYKLINĖ GR.";2979849055;Ne;0;0;5;5
4124;Mažylis;"4 PRIEŠMOKYKLINĖ GR.";6162880220;Ne;0;0;1;1
4125;Mažylis;"4 PRIEŠMOKYKLINĖ GR.";6009637985;Ne;4;0;1;5
4126;Mažylis;"4 PRIEŠMOKYKLINĖ GR.";1762105763;Ne;0;0;2;2
4127;Mažylis;"4 PRIEŠMOKYKLINĖ GR.";2672500259;Ne;0;0;4;4
4128;Mažylis;"4 PRIEŠMOKYKLINĖ GR.";2935175014;Ne;6;0;2;8
4129;Mažylis;"4 PRIEŠMOKYKLINĖ GR.";8866980930;Ne;5;8;1;14
4130;Mažylis;"4 PRIEŠMOKYKLINĖ GR.";2704741847;Ne;0;0;2;2
4131;Mažylis;"4 PRIEŠMOKYKLINĖ GR.";8297427176;Ne;0;0;1;1
4132;Mažylis;"4 PRIEŠMOKYKLINĖ GR.";5870983755;Ne;4;0;0;4
4133;Mažylis;"4 PRIEŠMOKYKLINĖ GR.";4280547746;Ne;15;0;0;15
4134;Mažylis;"4 PRIEŠMOKYKLINĖ GR.";9447747294;Taip;0;0;1;1
4135;Mažylis;"4 PRIEŠMOKYKLINĖ GR.";4542742002;Ne;0;0;2;2
4136;Mažylis;"4 PRIEŠMOKYKLINĖ GR.";2031457519;Ne;2;0;1;3
4137;Mažylis;"4 PRIEŠMOKYKLINĖ GR.";5102030168;Ne;0;0;1;1
4138;Mažylis;"4 PRIEŠMOKYKLINĖ GR.";3308427647;Ne;0;0;1;1
4139;Mažylis;"4 PRIEŠMOKYKLINĖ GR.";7923522942;Ne;0;0;1;1
4140;Mažylis;"3 DARŽELIO GR.";6100650710;Taip;0;0;4;4
4141;Mažylis;"3 DARŽELIO GR.";9401388775;Ne;0;0;3;3
4142;Mažylis;"3 DARŽELIO GR.";7106648054;Ne;0;7;0;7
4143;Mažylis;"3 DARŽELIO GR.";6809320247;Ne;0;0;2;2
4144;Mažylis;"3 DARŽELIO GR.";2006289999;Ne;5;0;0;5
4145;Mažylis;"3 DARŽELIO GR.";7652390515;Ne;0;0;2;2
4146;Mažylis;"3 DARŽELIO GR.";8639480781;Ne;0;0;2;2
4147;Mažylis;"3 DARŽELIO GR.";9341935211;Taip;15;0;0;15
4148;Mažylis;"3 DARŽELIO GR.";2989562406;Ne;10;0;0;10
4149;Mažylis;"3 DARŽELIO GR.";1151737098;Ne;0;0;2;2
4150;Mažylis;"3 DARŽELIO GR.";7642914458;Ne;0;0;1;1
4151;Mažylis;"3 DARŽELIO GR.";5938312001;Ne;0;6;4;10
4152;Mažylis;"3 DARŽELIO GR.";2119733659;Ne;0;0;2;2
4153;Mažylis;"3 DARŽELIO GR.";6904083734;Ne;0;0;2;2
4154;Mažylis;"3 DARŽELIO GR.";2319506343;Taip;4;0;5;9
4155;Mažylis;"3 DARŽELIO GR.";9416161833;Ne;4;0;0;4
4156;Mažylis;"3 DARŽELIO GR.";9807376076;Ne;6;0;0;6
4157;Mažylis;"3 DARŽELIO GR.";4592795281;Ne;0;0;3;3
4158;Mažylis;"6 DARŽELIO GR.";5388105083;Ne;0;5;0;5
4159;Mažylis;"6 DARŽELIO GR.";8589124394;Ne;0;0;1;1
4160;Mažylis;"6 DARŽELIO GR.";1381828313;Ne;0;0;3;3
4161;Mažylis;"6 DARŽELIO GR.";7725286603;Ne;0;0;11;11
4162;Mažylis;"6 DARŽELIO GR.";7754956214;Ne;0;0;1;1
4163;Mažylis;"6 DARŽELIO GR.";3615636349;Ne;2;0;0;2
4164;Mažylis;"6 DARŽELIO GR.";9894955253;Ne;0;0;6;6
4165;Mažylis;"6 DARŽELIO GR.";6270840529;Taip;0;0;15;15
4166;Mažylis;"6 DARŽELIO GR.";4100492642;Ne;0;0;7;7
4167;Mažylis;"6 DARŽELIO GR.";5569913242;Ne;7;0;1;8
4168;Mažylis;"6 DARŽELIO GR.";6492768766;Ne;3;0;0;3
4169;Mažylis;"6 DARŽELIO GR.";6423910850;Ne;0;8;2;10
4170;Mažylis;"6 DARŽELIO GR.";1555305826;Ne;0;0;1;1
4171;Mažylis;"6 DARŽELIO GR.";5977423702;Taip;0;11;5;16
4172;Mažylis;"6 DARŽELIO GR.";5990843024;Ne;0;0;7;7
4173;Mažylis;"6 DARŽELIO GR.";5137132420;Ne;0;4;2;6
4174;Mažylis;"1 NAUJA (LOPŠELIS)";7037435201;Ne;0;0;30;30
4175;Mažylis;"1 NAUJA (LOPŠELIS)";1233510409;Ne;5;0;0;5
4176;Mažylis;"1 NAUJA (LOPŠELIS)";5683455589;Taip;0;0;18;18
4177;Mažylis;"1 NAUJA (LOPŠELIS)";6441787213;Ne;0;0;2;2
4178;Mažylis;"1 NAUJA (LOPŠELIS)";9416048380;Ne;7;0;0;7
4179;Mažylis;"1 NAUJA (LOPŠELIS)";2159387617;Ne;0;0;3;3
4180;Mažylis;"1 NAUJA (LOPŠELIS)";1174743283;Ne;5;0;0;5
4181;Mažylis;"1 NAUJA (LOPŠELIS)";3898781037;Ne;0;0;2;2
4182;Mažylis;"1 NAUJA (LOPŠELIS)";7940550309;Ne;0;0;7;7
4183;Mažylis;"1 NAUJA (LOPŠELIS)";2331014727;Ne;3;0;1;4
4184;Mažylis;"1 NAUJA (LOPŠELIS)";4373022569;Ne;0;0;1;1
4185;Mažylis;"5 DARŽELIO GR.";8655053217;Ne;0;0;6;6
4186;Mažylis;"5 DARŽELIO GR.";1058725505;Ne;0;0;1;1
4187;Mažylis;"5 DARŽELIO GR.";4880415881;Ne;0;0;30;30
4188;Mažylis;"5 DARŽELIO GR.";9111101357;Ne;8;0;2;10
4189;Mažylis;"5 DARŽELIO GR.";6728351360;Ne;0;0;1;1
4190;Mažylis;"5 DARŽELIO GR.";6272047137;Ne;0;0;1;1
4191;Mažylis;"5 DARŽELIO GR.";7255856938;Taip;0;0;10;10
4192;Mažylis;"5 DARŽELIO GR.";2795618410;Ne;3;0;5;8
4193;Mažylis;"5 DARŽELIO GR.";4987487972;Ne;0;0;12;12
4194;Mažylis;"5 DARŽELIO GR.";9727982334;Ne;6;0;0;6
4195;Mažylis;"5 DARŽELIO GR.";2723677422;Ne;0;0;5;5
4196;Mažylis;"5 DARŽELIO GR.";7252955092;Taip;0;0;3;3
4197;Mažylis;"5 DARŽELIO GR.";3072841295;Ne;0;0;11;11
4198;Mažylis;"5 DARŽELIO GR.";4796712246;Ne;0;0;4;4
4199;Mažylis;"5 DARŽELIO GR.";3079202929;Ne;0;0;6;6
4200;Mažylis;"5 DARŽELIO GR.";4968383899;Ne;0;0;9;9
4201;Medynėlis;BITUTĖS;6238256156;Ne;10;0;0;10
4202;Medynėlis;BITUTĖS;2993705115;Ne;10;1;0;11
4203;Medynėlis;BITUTĖS;1504612730;Ne;8;0;0;8
4204;Medynėlis;BITUTĖS;5522261530;Ne;0;1;0;1
4205;Medynėlis;BITUTĖS;4107846958;Taip;0;1;5;6
4206;Medynėlis;BITUTĖS;7296044569;Ne;0;3;0;3
4207;Medynėlis;BITUTĖS;4418330478;Ne;5;0;3;8
4208;Medynėlis;BITUTĖS;6074296305;Ne;7;0;0;7
4209;Medynėlis;BITUTĖS;6815521895;Taip;0;0;1;1
4210;Medynėlis;BITUTĖS;4374464298;Ne;8;0;1;9
4211;Medynėlis;BITUTĖS;8107171123;Ne;4;2;2;8
4212;Medynėlis;BITUTĖS;4545707752;Ne;0;0;2;2
4213;Medynėlis;BITUTĖS;4419503239;Ne;7;0;2;9
4214;Medynėlis;BITUTĖS;7870261906;Ne;4;1;0;5
4215;Medynėlis;BITUTĖS;6466874318;Taip;15;1;0;16
4216;Medynėlis;BITUTĖS;2798305000;Ne;0;1;0;1
4217;Medynėlis;BITUTĖS;5440233814;Ne;0;1;1;2
4218;Medynėlis;BITUTĖS;4598267411;Ne;6;0;0;6
4219;Medynėlis;BITUTĖS;5194220650;Ne;9;0;0;9
4220;Medynėlis;BITUTĖS;4243521511;Ne;0;0;3;3
4221;Medynėlis;DRUGELIAI;9670396828;Ne;0;8;0;8
4222;Medynėlis;DRUGELIAI;5551121950;Taip;0;1;0;1
4223;Medynėlis;DRUGELIAI;2627421550;Ne;1;0;0;1
4224;Medynėlis;DRUGELIAI;9079900803;Taip;7;0;0;7
4225;Medynėlis;DRUGELIAI;5571641847;Ne;1;0;0;1
4226;Medynėlis;DRUGELIAI;9355165862;Ne;13;0;0;13
4227;Medynėlis;DRUGELIAI;6955467123;Ne;1;0;0;1
4228;Medynėlis;DRUGELIAI;9438854582;Ne;0;11;0;11
4229;Medynėlis;DRUGELIAI;1901805808;Ne;0;7;0;7
4230;Medynėlis;DRUGELIAI;5784691118;Ne;0;7;0;7
4231;Medynėlis;DRUGELIAI;7501831333;Ne;0;1;0;1
4232;Medynėlis;DRUGELIAI;4267654911;Ne;1;0;0;1
4233;Medynėlis;SKRUZDĖLIUKAI;2218838971;Ne;5;0;5;10
4234;Medynėlis;SKRUZDĖLIUKAI;1206480760;Ne;5;0;0;5
4235;Medynėlis;SKRUZDĖLIUKAI;3790099536;Ne;0;0;5;5
4236;Medynėlis;SKRUZDĖLIUKAI;9336656351;Ne;20;0;0;20
4237;Medynėlis;SKRUZDĖLIUKAI;7085226543;Ne;10;0;0;10
4238;Medynėlis;SKRUZDĖLIUKAI;5049081242;Ne;0;0;3;3
4239;Medynėlis;SKRUZDĖLIUKAI;6824842361;Ne;3;0;0;3
4240;Medynėlis;SKRUZDĖLIUKAI;1283602655;Ne;0;1;6;7
4241;Medynėlis;SKRUZDĖLIUKAI;3556203620;Ne;12;0;0;12
4242;Medynėlis;SKRUZDĖLIUKAI;5269794415;Ne;0;0;2;2
4243;Medynėlis;SKRUZDĖLIUKAI;4626655069;Ne;5;1;0;6
4244;Medynėlis;SKRUZDĖLIUKAI;5677747582;Ne;0;7;0;7
4245;Medynėlis;SKRUZDĖLIUKAI;3480190692;Taip;1;0;0;1
4246;Medynėlis;VOVERIUKAI;8275097931;Ne;0;7;0;7
4247;Medynėlis;VOVERIUKAI;1026253778;Taip;0;0;1;1
4248;Medynėlis;VOVERIUKAI;2523474347;Ne;3;5;0;8
4249;Medynėlis;VOVERIUKAI;5302122600;Ne;0;0;4;4
4250;Medynėlis;VOVERIUKAI;6609111216;Ne;0;0;1;1
4251;Medynėlis;VOVERIUKAI;6624835214;Ne;0;10;1;11
4252;Medynėlis;VOVERIUKAI;2160081492;Ne;0;3;0;3
4253;Medynėlis;VOVERIUKAI;4035587227;Ne;4;0;0;4
4254;Medynėlis;VOVERIUKAI;8162771849;Ne;7;0;1;8
4255;Medynėlis;VOVERIUKAI;9725019515;Ne;0;0;1;1
4256;Medynėlis;VOVERIUKAI;3185760752;Ne;0;0;2;2
4257;Medynėlis;VOVERIUKAI;1404831377;Ne;3;0;0;3
4258;Medynėlis;VOVERIUKAI;7814008588;Ne;14;0;0;14
4259;Medynėlis;VOVERIUKAI;5610660982;Ne;0;0;2;2
4260;Medynėlis;VOVERIUKAI;6282113738;Ne;5;0;0;5
4261;Medynėlis;VOVERIUKAI;4153545500;Ne;0;7;0;7
4262;Medynėlis;VOVERIUKAI;8299034970;Ne;0;2;0;2
4263;Medynėlis;VOVERIUKAI;1668143166;Ne;7;0;1;8
4264;Medynėlis;VOVERIUKAI;1608019909;Ne;10;1;0;11
4265;Medynėlis;VOVERIUKAI;4010058673;Ne;0;4;0;4
4266;Medynėlis;VOVERIUKAI;6502531749;Taip;0;0;5;5
4267;Medynėlis;VOVERIUKAI;9076139419;Ne;0;1;3;4
4268;Medynėlis;MEŠKIUKAI;7140184593;Ne;4;0;2;6
4269;Medynėlis;MEŠKIUKAI;5114554577;Ne;0;2;0;2
4270;Medynėlis;MEŠKIUKAI;3365026025;Ne;0;1;1;2
4271;Medynėlis;MEŠKIUKAI;6107849795;Ne;0;0;3;3
4272;Medynėlis;MEŠKIUKAI;4488439037;Ne;0;0;4;4
4273;Medynėlis;MEŠKIUKAI;4100792567;Ne;0;0;1;1
4274;Medynėlis;MEŠKIUKAI;6101613567;Ne;0;0;1;1
4275;Medynėlis;MEŠKIUKAI;1056744101;Ne;0;1;0;1
4276;Medynėlis;MEŠKIUKAI;6485314750;Ne;1;0;1;2
4277;Medynėlis;MEŠKIUKAI;7455041214;Ne;4;0;1;5
4278;Medynėlis;MEŠKIUKAI;5028189785;Ne;15;0;1;16
4279;Medynėlis;MEŠKIUKAI;3761845905;Taip;0;0;1;1
4280;Medynėlis;MEŠKIUKAI;9825580191;Ne;0;0;1;1
4281;Medynėlis;MEŠKIUKAI;7272017225;Ne;0;5;0;5
4282;Medynėlis;MEŠKIUKAI;4092824377;Ne;0;1;1;2
4283;Medynėlis;MEŠKIUKAI;1475701065;Ne;0;0;1;1
4284;Medynėlis;MEŠKIUKAI;3674134340;Ne;0;0;6;6
4285;Medynėlis;MEŠKIUKAI;4645171858;Taip;4;0;1;5
4286;Medynėlis;PELĖDŽIUKAI;6073797962;Ne;0;3;0;3
4287;Medynėlis;PELĖDŽIUKAI;4222917765;Ne;1;1;1;3
4288;Medynėlis;PELĖDŽIUKAI;1621499650;Ne;3;1;1;5
4289;Medynėlis;PELĖDŽIUKAI;6681155625;Ne;0;5;1;6
4290;Medynėlis;PELĖDŽIUKAI;2702814930;Taip;0;10;1;11
4291;Medynėlis;PELĖDŽIUKAI;6211076154;Ne;7;0;0;7
4292;Medynėlis;PELĖDŽIUKAI;5658868407;Ne;1;0;0;1
4293;Medynėlis;PELĖDŽIUKAI;6975191449;Ne;13;1;1;15
4294;Medynėlis;PELĖDŽIUKAI;8441629302;Ne;2;0;1;3
4295;Medynėlis;PELĖDŽIUKAI;4783894465;Ne;9;1;1;11
4296;Medynėlis;PELĖDŽIUKAI;3761140697;Ne;9;0;1;10
4297;Medynėlis;PELĖDŽIUKAI;5330900656;Ne;4;0;2;6
4298;Medynėlis;PELĖDŽIUKAI;1142044361;Ne;0;0;1;1
4299;Medynėlis;PELĖDŽIUKAI;8719860414;Ne;6;0;1;7
4300;Medynėlis;PELĖDŽIUKAI;4897227188;Ne;7;0;4;11
4301;Medynėlis;PELĖDŽIUKAI;9873696787;Taip;0;5;0;5
4302;Medynėlis;PELĖDŽIUKAI;6802308420;Ne;5;0;2;7
4303;Medynėlis;PELĖDŽIUKAI;2339692406;Ne;8;0;0;8
4304;Medynėlis;PELĖDŽIUKAI;3947494044;Ne;2;0;2;4
4305;Medynėlis;PELĖDŽIUKAI;3295727210;Ne;7;0;2;9
4306;Medynėlis;PELĖDŽIUKAI;2234994999;Ne;0;1;0;1
4307;Medynėlis;BORUŽIUKAI;6622963662;Ne;7;0;2;9
4308;Medynėlis;BORUŽIUKAI;9290099536;Taip;0;0;1;1
4309;Medynėlis;BORUŽIUKAI;6924524346;Ne;5;5;0;10
4310;Medynėlis;BORUŽIUKAI;2877881247;Ne;5;9;0;14
4311;Medynėlis;BORUŽIUKAI;3709984586;Ne;4;0;0;4
4312;Medynėlis;BORUŽIUKAI;6470879334;Ne;0;0;1;1
4313;Medynėlis;BORUŽIUKAI;2379829985;Ne;0;0;1;1
4314;Medynėlis;BORUŽIUKAI;4145591997;Ne;4;1;0;5
4315;Medynėlis;BORUŽIUKAI;5391199861;Ne;4;0;1;5
4316;Medynėlis;BORUŽIUKAI;6095795724;Ne;0;0;1;1
4317;Medynėlis;BORUŽIUKAI;7914358405;Ne;0;0;1;1
4318;Medynėlis;BORUŽIUKAI;7695626630;Ne;0;0;1;1
4319;Medynėlis;BORUŽIUKAI;3538656650;Ne;0;4;0;4
4320;Medynėlis;BORUŽIUKAI;5389909872;Ne;1;2;0;3
4321;Medynėlis;EŽIUKAI;9729505759;Ne;6;8;0;14
4322;Medynėlis;EŽIUKAI;8125271445;Ne;6;12;0;18
4323;Medynėlis;EŽIUKAI;9847006679;Ne;5;0;1;6
4324;Medynėlis;EŽIUKAI;7317307957;Ne;7;0;2;9
4325;Medynėlis;EŽIUKAI;7860869675;Ne;1;0;3;4
4326;Medynėlis;EŽIUKAI;4471168173;Ne;1;0;0;1
4327;Medynėlis;EŽIUKAI;1062269215;Ne;7;0;2;9
4328;Medynėlis;EŽIUKAI;5197757730;Taip;0;0;1;1
4329;Medynėlis;EŽIUKAI;6536626390;Ne;10;0;2;12
4330;Medynėlis;EŽIUKAI;8953622684;Ne;0;6;0;6
4331;Medynėlis;EŽIUKAI;3230747109;Ne;7;0;0;7
4332;Medynėlis;EŽIUKAI;9175884049;Ne;2;1;1;4
4333;Medynėlis;EŽIUKAI;8609650186;Ne;6;0;0;6
4334;Medynėlis;EŽIUKAI;6826409129;Ne;0;10;1;11
4335;Medynėlis;EŽIUKAI;2929100410;Ne;5;1;0;6
4336;Medynėlis;EŽIUKAI;6359536923;Ne;4;0;0;4
4337;Medynėlis;EŽIUKAI;2676262920;Ne;11;0;0;11
4338;Medynėlis;EŽIUKAI;5339084041;Taip;3;0;5;8
4339;Medynėlis;EŽIUKAI;5766492584;Ne;1;0;2;3
4340;Medynėlis;EŽIUKAI;6561927001;Ne;0;0;1;1
4341;Medynėlis;EŽIUKAI;8838774666;Ne;6;0;1;7
4342;Medynėlis;EŽIUKAI;6349817783;Ne;1;0;1;2
4343;Medynėlis;ZUIKUČIAI;4498233742;Ne;0;0;5;5
4344;Medynėlis;ZUIKUČIAI;6641009653;Ne;0;2;0;2
4345;Medynėlis;ZUIKUČIAI;6730475188;Ne;0;1;0;1
4346;Medynėlis;ZUIKUČIAI;2896713695;Ne;0;0;7;7
4347;Medynėlis;ZUIKUČIAI;2512917914;Ne;0;0;1;1
4348;Medynėlis;ZUIKUČIAI;1864754712;Ne;5;0;0;5
4349;Medynėlis;ZUIKUČIAI;1260839046;Ne;4;0;0;4
4350;Medynėlis;ZUIKUČIAI;6847727830;Ne;2;0;0;2
4351;Medynėlis;KAČIUKAI;2735961000;Ne;11;0;3;14
4352;Medynėlis;KAČIUKAI;3187000487;Ne;5;0;1;6
4353;Medynėlis;KAČIUKAI;3079549158;Ne;10;0;0;10
4354;Medynėlis;KAČIUKAI;1616551970;Taip;0;0;1;1
4355;Medynėlis;KAČIUKAI;7737665102;Ne;0;1;0;1
4356;Medynėlis;KAČIUKAI;1840127319;Ne;10;0;1;11
4357;Medynėlis;KAČIUKAI;2259408744;Taip;5;0;0;5
4358;Medynėlis;KAČIUKAI;5096386323;Ne;5;1;0;6
4359;Medynėlis;KAČIUKAI;2322666023;Ne;5;0;1;6
4360;Medynėlis;KAČIUKAI;4328794578;Ne;0;0;2;2
4361;Medynėlis;KAČIUKAI;9389418983;Ne;13;0;1;14
4362;Medynėlis;KAČIUKAI;2032064340;Ne;0;0;1;1
4363;Medynėlis;KAČIUKAI;2507106460;Taip;3;0;0;3
4364;Medynėlis;KAČIUKAI;8879923257;Ne;3;0;0;3
4365;Medynėlis;KAČIUKAI;7488521058;Ne;15;0;0;15
4366;Medynėlis;KAČIUKAI;2028112718;Taip;11;0;0;11
4367;Medynėlis;PELIUKAI;6614028601;Ne;16;0;1;17
4368;Medynėlis;PELIUKAI;8439619837;Ne;4;0;3;7
4369;Medynėlis;PELIUKAI;9352391583;Ne;7;0;1;8
4370;Medynėlis;PELIUKAI;4040542730;Ne;0;6;0;6
4371;Medynėlis;PELIUKAI;6989524053;Ne;3;0;1;4
4372;Medynėlis;PELIUKAI;9774213537;Ne;0;1;0;1
4373;Medynėlis;PELIUKAI;7129951535;Ne;0;0;6;6
4374;Medynėlis;PELIUKAI;9977590259;Ne;6;2;6;14
4375;Medynėlis;PELIUKAI;7170801214;Ne;5;1;0;6
4376;Medynėlis;PELIUKAI;9373849916;Ne;3;0;1;4
4377;Medynėlis;PELIUKAI;8678054784;Ne;0;0;2;2
4378;Medynėlis;PELIUKAI;6569938649;Ne;0;0;6;6
4379;Medynėlis;PELIUKAI;6462589513;Ne;5;0;1;6
4380;Medynėlis;PELIUKAI;4204366008;Ne;0;0;2;2
4381;Medynėlis;PELIUKAI;3348520838;Ne;0;0;1;1
4382;Medynėlis;PELIUKAI;2231990831;Ne;0;0;1;1
4383;Medynėlis;PELIUKAI;8887092965;Ne;6;2;6;14
4384;Medynėlis;PELIUKAI;3299495310;Ne;5;0;3;8
4385;Medynėlis;ANČIUKAI;9536473088;Ne;0;0;1;1
4386;Medynėlis;ANČIUKAI;4006434252;Ne;2;0;1;3
4387;Medynėlis;ANČIUKAI;8994120910;Ne;6;0;1;7
4388;Medynėlis;ANČIUKAI;6948059114;Ne;6;0;1;7
4389;Medynėlis;ANČIUKAI;9288258906;Ne;5;0;0;5
4390;Medynėlis;ANČIUKAI;4869007055;Ne;0;0;1;1
4391;Medynėlis;ANČIUKAI;9025913427;Ne;0;0;1;1
4392;Medynėlis;ANČIUKAI;3739441317;Taip;11;0;0;11
4393;Medynėlis;ANČIUKAI;6208391418;Ne;0;0;1;1
4394;Medynėlis;ANČIUKAI;1936512553;Ne;4;0;0;4
4395;Medynėlis;ANČIUKAI;1864754712;Ne;6;0;0;6
4396;Molinukas;NYKŠTUKAI;4974513900;Ne;2;0;0;2
4397;Molinukas;NYKŠTUKAI;8313486714;Ne;0;1;0;1
4398;Molinukas;NYKŠTUKAI;8608465121;Ne;9;8;0;17
4399;Molinukas;NYKŠTUKAI;1826463800;Ne;1;0;0;1
4400;Molinukas;NYKŠTUKAI;3043679624;Ne;7;1;0;8
4401;Molinukas;NYKŠTUKAI;4992887072;Ne;0;1;0;1
4402;Molinukas;NYKŠTUKAI;8769667823;Ne;4;0;0;4
4403;Molinukas;NYKŠTUKAI;1651103318;Ne;0;1;2;3
4404;Molinukas;NYKŠTUKAI;6947938890;Ne;1;0;0;1
4405;Molinukas;NYKŠTUKAI;1970929144;Ne;5;0;0;5
4406;Molinukas;NYKŠTUKAI;3510936830;Ne;0;0;1;1
4407;Molinukas;NYKŠTUKAI;1907287249;Ne;2;0;0;2
4408;Molinukas;NYKŠTUKAI;5172948843;Ne;1;0;0;1
4409;Molinukas;NYKŠTUKAI;7825545164;Ne;7;0;1;8
4410;Molinukas;NYKŠTUKAI;6190443233;Ne;12;0;1;13
4411;Molinukas;NYKŠTUKAI;6531106368;Ne;14;0;0;14
4412;Molinukas;NYKŠTUKAI;4122429163;Ne;10;0;0;10
4413;Molinukas;NYKŠTUKAI;8660958288;Ne;3;5;0;8
4414;Molinukas;NYKŠTUKAI;2862680065;Ne;7;1;0;8
4415;Molinukas;NYKŠTUKAI;3382913312;Ne;3;0;0;3
4416;Molinukas;NYKŠTUKAI;2842168450;Ne;7;0;0;7
4417;Molinukas;NYKŠTUKAI;4044289280;Ne;7;0;0;7
4418;Molinukas;ZUIKUČIŲ;9203375647;Ne;8;0;0;8
4419;Molinukas;ZUIKUČIŲ;2982968605;Ne;6;1;0;7
4420;Molinukas;ZUIKUČIŲ;8479427729;Ne;0;1;0;1
4421;Molinukas;ZUIKUČIŲ;8114735116;Ne;1;11;0;12
4422;Molinukas;ZUIKUČIŲ;5597119459;Ne;0;11;0;11
4423;Molinukas;ZUIKUČIŲ;8582985479;Ne;10;0;1;11
4424;Molinukas;ZUIKUČIŲ;8490020853;Ne;10;0;1;11
4425;Molinukas;ZUIKUČIŲ;2651732418;Ne;5;0;0;5
4426;Molinukas;ZUIKUČIŲ;1059002689;Ne;0;2;4;6
4427;Molinukas;ZUIKUČIŲ;5302191209;Ne;8;0;0;8
4428;Molinukas;ZUIKUČIŲ;1605039166;Ne;17;0;0;17
4429;Molinukas;ZUIKUČIŲ;6804127471;Ne;17;0;0;17
4430;Molinukas;ZUIKUČIŲ;2878262979;Ne;1;0;0;1
4431;Molinukas;ZUIKUČIŲ;7441251480;Ne;0;0;1;1
4432;Molinukas;ZUIKUČIŲ;4733315902;Ne;0;0;2;2
4433;Molinukas;ZUIKUČIŲ;2595941277;Ne;0;0;1;1
4434;Molinukas;ZUIKUČIŲ;2706981559;Ne;4;1;0;5
4435;Molinukas;ZUIKUČIŲ;6638634402;Ne;3;0;0;3
4436;Molinukas;ZUIKUČIŲ;3577613732;Ne;0;0;1;1
4437;Molinukas;ZUIKUČIŲ;9972204424;Ne;8;0;0;8
4438;Molinukas;ZUIKUČIŲ;2789279432;Ne;15;0;0;15
4439;Molinukas;SRAIGIUKŲ;4806350914;Ne;4;0;0;4
4440;Molinukas;SRAIGIUKŲ;7451224160;Ne;0;0;3;3
4441;Molinukas;SRAIGIUKŲ;4475594896;Ne;0;5;0;5
4442;Molinukas;SRAIGIUKŲ;9244598883;Ne;5;0;0;5
4443;Molinukas;SRAIGIUKŲ;7623051674;Ne;0;3;0;3
4444;Molinukas;SRAIGIUKŲ;9448910819;Ne;0;1;1;2
4445;Molinukas;SRAIGIUKŲ;1651650182;Ne;0;0;1;1
4446;Molinukas;SRAIGIUKŲ;7248705010;Taip;16;0;0;16
4447;Molinukas;SRAIGIUKŲ;5580968328;Ne;2;0;0;2
4448;Molinukas;SRAIGIUKŲ;6353165459;Ne;12;0;0;12
4449;Molinukas;SRAIGIUKŲ;9293819449;Ne;0;0;1;1
4450;Molinukas;SRAIGIUKŲ;8536615996;Ne;1;0;0;1
4451;Molinukas;SRAIGIUKŲ;6087698882;Ne;0;0;1;1
4452;Molinukas;SRAIGIUKŲ;7602239077;Ne;0;7;0;7
4453;Molinukas;SRAIGIUKŲ;1849018608;Ne;0;1;1;2
4454;Molinukas;SRAIGIUKŲ;4171978721;Ne;1;0;0;1
4455;Molinukas;SRAIGIUKŲ;6681397435;Ne;10;0;0;10
4456;Molinukas;SRAIGIUKŲ;7134802574;Ne;5;0;2;7
4457;Molinukas;SRAIGIUKŲ;8260101075;Ne;5;0;2;7
4458;Molinukas;SRAIGIUKŲ;5525772579;Ne;0;4;1;5
4459;Molinukas;SRAIGIUKŲ;5876669121;Ne;0;0;1;1
4460;Molinukas;VOVERIUKAI;3469196411;Ne;0;0;1;1
4461;Molinukas;VOVERIUKAI;4583155940;Ne;0;5;1;6
4462;Molinukas;VOVERIUKAI;8541456847;Ne;0;5;3;8
4463;Molinukas;VOVERIUKAI;2286586693;Ne;6;0;2;8
4464;Molinukas;VOVERIUKAI;9413396859;Ne;2;7;0;9
4465;Molinukas;VOVERIUKAI;6898958282;Ne;5;13;0;18
4466;Molinukas;VOVERIUKAI;4000190261;Ne;5;0;0;5
4467;Molinukas;VOVERIUKAI;5685582215;Ne;1;2;0;3
4468;Molinukas;VOVERIUKAI;2356814145;Ne;5;0;3;8
4469;Molinukas;VOVERIUKAI;7446607510;Ne;0;9;0;9
4470;Molinukas;VOVERIUKAI;9667704959;Ne;9;5;3;17
4471;Molinukas;VOVERIUKAI;8516451290;Ne;10;0;1;11
4472;Molinukas;VOVERIUKAI;3207373459;Taip;0;0;12;12
4473;Molinukas;VOVERIUKAI;1865748733;Ne;0;1;0;1
4474;Molinukas;VOVERIUKAI;4209143136;Ne;6;0;6;12
4475;Molinukas;VOVERIUKAI;5648861702;Ne;6;0;6;12
4476;Molinukas;VOVERIUKAI;8865966572;Ne;0;0;1;1
4477;Molinukas;VOVERIUKAI;4950808381;Ne;0;5;0;5
4478;Molinukas;VOVERIUKAI;7378643086;Ne;3;0;0;3
4479;Molinukas;VOVERIUKAI;2779700726;Ne;6;0;0;6
4480;Molinukas;VOVERIUKAI;6832647220;Ne;0;15;0;15
4481;Molinukas;VOVERIUKAI;9318837973;Ne;0;0;2;2
4482;Molinukas;VOVERIUKAI;8247270556;Ne;0;0;1;1
4483;Molinukas;ŽVIRBLIUKŲ;2935945686;Ne;1;0;0;1
4484;Molinukas;ŽVIRBLIUKŲ;9850656596;Ne;7;0;0;7
4485;Molinukas;ŽVIRBLIUKŲ;7052683028;Ne;1;0;0;1
4486;Molinukas;ŽVIRBLIUKŲ;6324308817;Ne;1;0;0;1
4487;Molinukas;ŽVIRBLIUKŲ;8578781383;Taip;1;0;0;1
4488;Molinukas;ŽVIRBLIUKŲ;1768984445;Ne;7;0;0;7
4489;Molinukas;ŽVIRBLIUKŲ;9936048965;Ne;8;0;0;8
4490;Molinukas;KAČIUKŲ;8973341322;Ne;6;0;2;8
4491;Molinukas;KAČIUKŲ;4356610282;Ne;0;0;3;3
4492;Molinukas;KAČIUKŲ;5166540248;Ne;2;0;3;5
4493;Molinukas;KAČIUKŲ;5834614345;Ne;2;0;3;5
4494;Molinukas;KAČIUKŲ;5665993086;Ne;0;1;0;1
4495;Molinukas;KAČIUKŲ;7349691727;Ne;0;5;0;5
4496;Molinukas;KAČIUKŲ;7192221243;Ne;1;0;0;1
4497;Molinukas;KAČIUKŲ;2866461509;Ne;7;0;1;8
4498;"Naminukas (Smėlio g. 13)";Drugeliai;6776805494;Ne;0;0;1;1
4499;"Naminukas (Smėlio g. 13)";Drugeliai;2395070574;Ne;0;0;1;1
4500;"Naminukas (Smėlio g. 13)";Drugeliai;5534073614;Ne;2;1;0;3
4501;"Naminukas (Smėlio g. 13)";Drugeliai;2132345627;Ne;0;1;0;1
4502;"Naminukas (Smėlio g. 13)";Drugeliai;1302119260;Ne;0;2;0;2
4503;"Naminukas (Smėlio g. 13)";Drugeliai;2864905392;Ne;0;12;0;12
4504;"Naminukas (Smėlio g. 13)";Drugeliai;7406775925;Ne;7;0;1;8
4505;"Naminukas (Smėlio g. 13)";Drugeliai;1333462200;Ne;10;0;2;12
4506;"Naminukas (Smėlio g. 13)";Drugeliai;5713661641;Ne;0;10;0;10
4507;"Naminukas (Smėlio g. 13)";Drugeliai;6581925461;Ne;2;0;0;2
4508;"Naminukas (Smėlio g. 13)";Drugeliai;2198493034;Ne;0;3;0;3
4509;"Naminukas (Smėlio g. 13)";Drugeliai;8141324449;Ne;5;0;5;10
4510;"Naminukas (Smėlio g. 13)";Drugeliai;8564586014;Ne;0;11;1;12
4511;"Naminukas (Smėlio g. 13)";Drugeliai;3236525642;Ne;0;0;2;2
4512;"Naminukas (Smėlio g. 13)";Drugeliai;7347998152;Ne;0;1;4;5
4513;"Naminukas (Smėlio g. 13)";Drugeliai;7272465847;Ne;6;0;5;11
4514;"Naminukas (Smėlio g. 13)";Drugeliai;8760638670;Ne;0;0;2;2
4515;"Naminukas (Smėlio g. 13)";Bitutės;6057391542;Ne;1;0;0;1
4516;"Naminukas (Smėlio g. 13)";Bitutės;4624191456;Ne;4;0;0;4
4517;"Naminukas (Smėlio g. 13)";Bitutės;4671626416;Ne;0;1;0;1
4518;"Naminukas (Smėlio g. 13)";Bitutės;4941814027;Ne;0;1;0;1
4519;"Naminukas (Smėlio g. 13)";Bitutės;2179061425;Taip;0;1;0;1
4520;"Naminukas (Smėlio g. 13)";Bitutės;1095955939;Ne;0;2;0;2
4521;"Naminukas (Smėlio g. 13)";Bitutės;4422173848;Taip;13;5;0;18
4522;"Naminukas (Smėlio g. 13)";Bitutės;5741698937;Ne;5;0;0;5
4523;"Naminukas (Smėlio g. 13)";Bitutės;7717132979;Ne;0;17;1;18
4524;"Naminukas (Smėlio g. 13)";Bitutės;9357758815;Ne;0;3;1;4
4525;"Naminukas (Smėlio g. 13)";Paukšteliai;3501921619;Ne;0;2;0;2
4526;"Naminukas (Smėlio g. 13)";Paukšteliai;7297661383;Ne;3;3;0;6
4527;"Naminukas (Smėlio g. 13)";Paukšteliai;5056487802;Ne;0;10;0;10
4528;"Naminukas (Smėlio g. 13)";Paukšteliai;3438010199;Ne;7;0;0;7
4529;"Naminukas (Smėlio g. 13)";Paukšteliai;4998565160;Ne;0;18;0;18
4530;"Naminukas (Smėlio g. 13)";Paukšteliai;9405784626;Ne;12;0;3;15
4531;"Naminukas (Smėlio g. 13)";Paukšteliai;2583886896;Ne;6;2;0;8
4532;"Naminukas (Smėlio g. 13)";Paukšteliai;4778385421;Ne;0;15;1;16
4533;"Naminukas (Smėlio g. 13)";Paukšteliai;6178500478;Ne;2;0;1;3
4534;"Naminukas (Smėlio g. 13)";Paukšteliai;9440685520;Ne;7;0;0;7
4535;"Naminukas (Smėlio g. 13)";Paukšteliai;1406418130;Ne;0;0;2;2
4536;"Naminukas (Smėlio g. 13)";Paukšteliai;2012656186;Ne;3;0;2;5
4537;"Naminukas (Smėlio g. 13)";Paukšteliai;8470716196;Ne;0;0;1;1
4538;"Naminukas (Smėlio g. 13)";Paukšteliai;3727828033;Ne;0;4;0;4
4539;"Naminukas (Smėlio g. 13)";Paukšteliai;2652538212;Ne;0;6;0;6
4540;"Naminukas (Smėlio g. 13)";Paukšteliai;5280419144;Ne;6;3;0;9
4541;"Naminukas (Smėlio g. 13)";Paukšteliai;3018465520;Ne;2;2;0;4
4542;"Naminukas (Smėlio g. 13)";Paukšteliai;2551242973;Ne;0;0;1;1
4543;"Naminukas (Smėlio g. 13)";Paukšteliai;2113378945;Ne;6;4;0;10
4544;"Naminukas (Smėlio g. 13)";Paukšteliai;7450368045;Ne;0;4;0;4
4545;"Naminukas (Smėlio g. 13)";"NYKŠTUKAI ";7646186458;Ne;2;1;0;3
4546;"Naminukas (Smėlio g. 13)";"NYKŠTUKAI ";5519447152;Ne;0;2;0;2
4547;"Naminukas (Smėlio g. 13)";"NYKŠTUKAI ";1286329245;Ne;0;6;0;6
4548;"Naminukas (Smėlio g. 13)";"NYKŠTUKAI ";1618802271;Ne;5;0;0;5
4549;"Naminukas (Smėlio g. 13)";"NYKŠTUKAI ";1591540165;Ne;0;2;3;5
4550;"Naminukas (Smėlio g. 13)";"NYKŠTUKAI ";1118193598;Ne;0;0;4;4
4551;"Naminukas (Smėlio g. 13)";"NYKŠTUKAI ";8102805098;Ne;6;0;0;6
4552;"Naminukas (Smėlio g. 13)";"NYKŠTUKAI ";3324849843;Ne;2;0;0;2
4553;"Naminukas (Smėlio g. 13)";"NYKŠTUKAI ";5498798560;Ne;0;2;0;2
4554;"Naminukas (Smėlio g. 13)";"NYKŠTUKAI ";3120516850;Ne;4;0;14;18
4555;"Naminukas (Smėlio g. 13)";"NYKŠTUKAI ";9891722891;Ne;4;0;0;4
4556;Nykštukas;SMAGURIAI;7320458031;Ne;0;3;0;3
4557;Nykštukas;SMAGURIAI;7432373335;Ne;0;0;1;1
4558;Nykštukas;SMAGURIAI;6337924089;Ne;0;2;0;2
4559;Nykštukas;SMAGURIAI;2748970206;Ne;7;0;0;7
4560;Nykštukas;SMAGURIAI;3441133631;Ne;0;2;0;2
4561;Nykštukas;SMAGURIAI;7562216310;Ne;0;5;0;5
4562;Nykštukas;SMAGURIAI;6594118834;Ne;16;0;0;16
4563;Nykštukas;SMAGURIAI;2455221957;Ne;0;9;1;10
4564;Nykštukas;SMAGURIAI;4071479304;Ne;10;2;0;12
4565;Nykštukas;SMAGURIAI;2910587300;Ne;5;0;0;5
4566;Nykštukas;SMAGURIAI;2770385957;Ne;2;1;1;4
4567;Nykštukas;SMAGURIAI;8695794490;Ne;1;1;0;2
4568;Nykštukas;SMAGURIAI;8372380734;Ne;8;0;0;8
4569;Nykštukas;SMAGURIAI;6672148719;Ne;6;0;3;9
4570;Nykštukas;SMAGURIAI;9790322329;Ne;0;1;0;1
4571;Nykštukas;SMALSIUKAI;6285425127;Ne;10;0;0;10
4572;Nykštukas;SMALSIUKAI;6786896381;Ne;0;6;0;6
4573;Nykštukas;SMALSIUKAI;4490310109;Ne;5;0;0;5
4574;Nykštukas;SMALSIUKAI;2947976429;Taip;12;0;0;12
4575;Nykštukas;SMALSIUKAI;8919778025;Ne;0;4;0;4
4576;Nykštukas;SMALSIUKAI;8827094160;Ne;3;0;1;4
4577;Nykštukas;SMALSIUKAI;9887096503;Ne;18;0;0;18
4578;Nykštukas;SMALSIUKAI;4323166473;Ne;0;0;1;1
4579;Nykštukas;SMALSIUKAI;4622095064;Taip;9;0;0;9
4580;Nykštukas;SMALSIUKAI;4955003100;Ne;7;0;0;7
4581;Nykštukas;SMALSIUKAI;8667489439;Ne;2;1;0;3
4582;Nykštukas;SMALSIUKAI;7603500691;Ne;0;0;1;1
4583;Nykštukas;SMALSIUKAI;7266550834;Ne;0;5;0;5
4584;Nykštukas;SMALSIUKAI;6563871327;Ne;0;1;2;3
4585;Nykštukas;SMALSIUKAI;8819485547;Ne;9;0;0;9
4586;Nykštukas;SMALSIUKAI;5010715255;Ne;0;1;0;1
4587;Nykštukas;SMALSIUKAI;8047072198;Taip;0;6;0;6
4588;Nykštukas;SMALSIUKAI;4499337321;Ne;6;0;0;6
4589;Nykštukas;SMALSIUKAI;4445045176;Ne;6;1;0;7
4590;Nykštukas;AITVARIUKAI;6923345088;Taip;0;1;0;1
4591;Nykštukas;AITVARIUKAI;8580777381;Ne;0;5;0;5
4592;Nykštukas;AITVARIUKAI;9319066179;Ne;5;2;0;7
4593;Nykštukas;AITVARIUKAI;2177539882;Ne;2;1;0;3
4594;Nykštukas;AITVARIUKAI;6351178752;Ne;5;0;0;5
4595;Nykštukas;AITVARIUKAI;2232317366;Ne;6;0;0;6
4596;Nykštukas;AITVARIUKAI;7332769878;Taip;5;0;0;5
4597;Nykštukas;AITVARIUKAI;7896338372;Ne;10;0;0;10
4598;Nykštukas;AITVARIUKAI;2208319289;Ne;0;5;0;5
4599;Nykštukas;AITVARIUKAI;5285669371;Ne;0;1;0;1
4600;Nykštukas;AITVARIUKAI;8548820023;Ne;9;3;0;12
4601;Nykštukas;AITVARIUKAI;9545178064;Ne;11;0;0;11
4602;Nykštukas;AITVARIUKAI;3561627809;Ne;0;1;0;1
4603;Nykštukas;AITVARIUKAI;5538446312;Ne;10;0;0;10
4604;Nykštukas;AITVARIUKAI;4822304386;Ne;6;0;0;6
4605;Nykštukas;AITVARIUKAI;4177690371;Ne;1;0;0;1
4606;Nykštukas;AITVARIUKAI;5292127770;Ne;2;0;0;2
4607;Nykštukas;DAINORĖLIAI;7730918105;Ne;11;0;0;11
4608;Nykštukas;DAINORĖLIAI;8475127245;Ne;0;0;1;1
4609;Nykštukas;DAINORĖLIAI;1122600949;Ne;3;0;0;3
4610;Nykštukas;DAINORĖLIAI;3853935568;Ne;0;1;0;1
4611;Nykštukas;DAINORĖLIAI;9776630115;Ne;2;5;0;7
4612;Nykštukas;DAINORĖLIAI;5291104224;Ne;0;1;0;1
4613;Nykštukas;DAINORĖLIAI;9524639831;Ne;4;0;0;4
4614;Nykštukas;DAINORĖLIAI;3367348573;Ne;7;2;0;9
4615;Nykštukas;DAINORĖLIAI;5961945345;Ne;17;1;0;18
4616;Nykštukas;DAINORĖLIAI;6561696818;Ne;7;0;1;8
4617;Nykštukas;DAINORĖLIAI;1283453188;Ne;5;1;0;6
4618;Nykštukas;DAINORĖLIAI;1167614164;Ne;0;1;2;3
4619;Nykštukas;DAINORĖLIAI;7473124310;Taip;1;0;0;1
4620;Nykštukas;DAINORĖLIAI;8681884252;Ne;0;4;0;4
4621;Nykštukas;DAINORĖLIAI;5255726742;Ne;0;1;0;1
4622;Nykštukas;DAINORĖLIAI;9027355399;Ne;0;6;0;6
4623;Nykštukas;DAINORĖLIAI;4893494144;Ne;0;7;0;7
4624;Nykštukas;DAINORĖLIAI;8318089070;Taip;0;1;4;5
4625;Nykštukas;DAINORĖLIAI;2727074729;Ne;0;17;0;17
4626;Nykštukas;DAINORĖLIAI;9437700329;Ne;0;1;0;1
4627;Nykštukas;POKŠTUKAI;7382271765;Ne;0;1;0;1
4628;Nykštukas;POKŠTUKAI;1655428422;Ne;8;1;0;9
4629;Nykštukas;POKŠTUKAI;2649916049;Ne;6;0;0;6
4630;Nykštukas;POKŠTUKAI;1796016501;Ne;0;17;0;17
4631;Nykštukas;POKŠTUKAI;5958711585;Ne;3;7;0;10
4632;Nykštukas;POKŠTUKAI;3999004312;Ne;0;1;0;1
4633;Nykštukas;POKŠTUKAI;6719999304;Ne;0;6;0;6
4634;Nykštukas;POKŠTUKAI;8148163137;Ne;4;4;0;8
4635;Nykštukas;POKŠTUKAI;8708184278;Ne;0;1;0;1
4636;Nykštukas;POKŠTUKAI;5699671696;Ne;0;1;0;1
4637;Nykštukas;POKŠTUKAI;3843163586;Ne;0;2;0;2
4638;Nykštukas;POKŠTUKAI;1316018865;Ne;0;4;0;4
4639;Nykštukas;POKŠTUKAI;3507649457;Ne;0;1;0;1
4640;Nykštukas;POKŠTUKAI;3428031037;Ne;0;2;0;2
4641;Nykštukas;POKŠTUKAI;4508625009;Ne;0;2;0;2
4642;Nykštukas;POKŠTUKAI;6698622575;Ne;0;2;0;2
4643;Nykštukas;POKŠTUKAI;2982662650;Ne;0;3;0;3
4644;Nykštukas;POKŠTUKAI;2627736026;Ne;0;11;0;11
4645;Nykštukas;POKŠTUKAI;4401103119;Taip;0;4;0;4
4646;Nykštukas;POKŠTUKAI;9703895923;Ne;15;1;0;16
4647;Nykštukas;KODĖLČIUKAI;8168579152;Ne;7;0;0;7
4648;Nykštukas;KODĖLČIUKAI;2685400939;Ne;0;0;6;6
4649;Nykštukas;KODĖLČIUKAI;3278960733;Ne;0;0;2;2
4650;Nykštukas;KODĖLČIUKAI;5934979528;Ne;0;0;1;1
4651;Nykštukas;KODĖLČIUKAI;3760617860;Ne;5;0;2;7
4652;Nykštukas;KODĖLČIUKAI;6927545099;Ne;0;0;2;2
4653;Nykštukas;KODĖLČIUKAI;8042479133;Ne;4;0;3;7
4654;Nykštukas;KODĖLČIUKAI;6345791450;Ne;3;0;4;7
4655;Nykštukas;KODĖLČIUKAI;6794885966;Ne;0;0;8;8
4656;Nykštukas;KODĖLČIUKAI;7616459970;Ne;0;0;4;4
4657;Nykštukas;KODĖLČIUKAI;2623254163;Ne;3;2;0;5
4658;Nykštukas;KODĖLČIUKAI;9296449928;Ne;0;0;10;10
4659;Nykštukas;KODĖLČIUKAI;2992219360;Ne;21;0;0;21
4660;Nykštukas;KODĖLČIUKAI;4667303597;Ne;0;0;1;1
4661;Nykštukas;KODĖLČIUKAI;8804969886;Ne;2;0;0;2
4662;Nykštukas;KODĖLČIUKAI;3552386621;Ne;17;0;0;17
4663;Nykštukas;KODĖLČIUKAI;2692551262;Ne;5;2;0;7
4664;Nykštukas;KODĖLČIUKAI;6607025451;Ne;0;0;10;10
4665;Nykštukas;PASAKORIAI;2661110617;Ne;10;5;0;15
4666;Nykštukas;PASAKORIAI;3040001373;Ne;0;1;0;1
4667;Nykštukas;PASAKORIAI;1855278809;Ne;0;6;0;6
4668;Nykštukas;PASAKORIAI;8640715657;Ne;0;5;0;5
4669;Nykštukas;PASAKORIAI;7990462246;Ne;5;0;1;6
4670;Nykštukas;PASAKORIAI;9413198245;Ne;8;0;1;9
4671;Nykštukas;PASAKORIAI;2518342041;Ne;0;5;0;5
4672;Nykštukas;PASAKORIAI;7828733135;Ne;5;1;1;7
4673;Nykštukas;PASAKORIAI;4480184458;Ne;0;2;0;2
4674;Nykštukas;PASAKORIAI;4090494707;Ne;0;5;0;5
4675;Nykštukas;PASAKORIAI;3026598985;Ne;0;0;1;1
4676;Nykštukas;PASAKORIAI;9714310539;Ne;0;1;0;1
4677;Nykštukas;PASAKORIAI;4795301170;Ne;0;2;0;2
4678;Nykštukas;PASAKORIAI;1579064341;Ne;3;1;3;7
4679;Nykštukas;PASAKORIAI;4992654449;Ne;13;0;0;13
4680;Nykštukas;PASAKORIAI;5337728911;Ne;0;0;1;1
4681;Nykštukas;PASAKORIAI;8371081106;Taip;0;9;0;9
4682;Nykštukas;PASAKORIAI;3496434361;Ne;3;4;0;7
4683;Nykštukas;GUDRUČIAI;4559818614;Ne;0;12;0;12
4684;Nykštukas;GUDRUČIAI;9250827058;Taip;0;4;0;4
4685;Nykštukas;GUDRUČIAI;7447202642;Ne;0;7;0;7
4686;Nykštukas;GUDRUČIAI;4325369395;Ne;5;1;0;6
4687;Nykštukas;GUDRUČIAI;6630804505;Ne;0;1;0;1
4688;Nykštukas;GUDRUČIAI;7326535810;Ne;0;10;0;10
4689;Nykštukas;GUDRUČIAI;9712596180;Taip;7;0;0;7
4690;Nykštukas;GUDRUČIAI;9941937734;Ne;0;2;0;2
4691;Nykštukas;GUDRUČIAI;2494482185;Ne;2;0;0;2
4692;Nykštukas;GUDRUČIAI;3619459404;Ne;0;7;0;7
4693;Nykštukas;GUDRUČIAI;1934596739;Ne;1;0;0;1
4694;Nykštukas;GUDRUČIAI;7604740418;Ne;2;10;0;12
4695;Nykštukas;GUDRUČIAI;2970293467;Ne;0;15;0;15
4696;Nykštukas;GUDRUČIAI;2881323571;Ne;10;1;0;11
4697;Nykštukas;GUDRUČIAI;2872277381;Ne;0;1;0;1
4698;Nykštukas;GUDRUČIAI;9940519259;Taip;0;2;0;2
4699;Nykštukas;GUDRUČIAI;9023823445;Ne;0;8;0;8
4700;Nykštukas;GUDRUČIAI;8361758895;Ne;0;4;0;4
4701;Nykštukas;NAMINUKAI;7456007276;Ne;0;3;0;3
4702;Nykštukas;NAMINUKAI;7176519994;Ne;5;6;0;11
4703;Nykštukas;NAMINUKAI;4064016871;Ne;0;1;0;1
4704;Nykštukas;NAMINUKAI;9054070492;Ne;0;2;0;2
4705;Nykštukas;NAMINUKAI;6106373554;Ne;5;1;0;6
4706;Nykštukas;NAMINUKAI;4925214655;Ne;0;1;0;1
4707;Nykštukas;NAMINUKAI;5032283848;Taip;0;2;0;2
4708;Nykštukas;NAMINUKAI;7494444468;Ne;0;1;0;1
4709;Nykštukas;NAMINUKAI;3925958632;Ne;0;1;0;1
4710;Nykštukas;NAMINUKAI;6338717583;Ne;1;0;0;1
4711;Nykštukas;NAMINUKAI;9686815141;Ne;0;3;0;3
4712;Nykštukas;NAMINUKAI;9575291096;Ne;0;5;0;5
4713;Nykštukas;NAMINUKAI;4503830456;Ne;0;2;0;2
4714;Nykštukas;NAMINUKAI;4040123876;Ne;0;9;0;9
4715;Nykštukas;NAMINUKAI;8874850019;Ne;0;9;0;9
4716;Nykštukas;NAMINUKAI;1510338621;Ne;5;1;0;6
4717;Nykštukas;NAMINUKAI;9067774103;Ne;8;9;0;17
4718;Nykštukas;NAMINUKAI;3405633312;Taip;0;6;0;6
4719;Nykštukas;KŪLVERSTUKAI;7078264994;Ne;2;0;0;2
4720;Nykštukas;KŪLVERSTUKAI;3660330885;Ne;1;0;0;1
4721;Nykštukas;KŪLVERSTUKAI;4897443402;Ne;0;1;0;1
4722;Nykštukas;KŪLVERSTUKAI;6778384400;Ne;8;0;0;8
4723;Nykštukas;KŪLVERSTUKAI;6888025109;Ne;2;0;0;2
4724;Nykštukas;KŪLVERSTUKAI;6071938183;Taip;1;0;0;1
4725;Nykštukas;KŪLVERSTUKAI;7310647095;Ne;8;0;3;11
4726;Nykštukas;KŪLVERSTUKAI;5297046545;Ne;8;0;0;8
4727;Nykštukas;KŪLVERSTUKAI;8414521116;Ne;3;0;0;3
4728;Nykštukas;KŪLVERSTUKAI;1666098441;Ne;0;1;0;1
4729;Nykštukas;KŪLVERSTUKAI;9177683618;Ne;7;0;0;7
4730;Nykštukas;KŪLVERSTUKAI;1077620433;Ne;8;2;0;10
4731;Nykštukas;TREPSIUKAI;8701731017;Ne;0;1;0;1
4732;Nykštukas;TREPSIUKAI;8820983001;Ne;1;0;0;1
4733;Nykštukas;TREPSIUKAI;1355881784;Ne;11;0;0;11
4734;Nykštukas;TREPSIUKAI;2974110726;Ne;4;0;0;4
4735;Nykštukas;TREPSIUKAI;7311244803;Ne;0;1;0;1
4736;Nykštukas;ŽIRNIUKAI;9661862689;Ne;2;0;0;2
4737;Nykštukas;ŽIRNIUKAI;1594734231;Ne;1;0;0;1
4738;Nykštukas;ŽIRNIUKAI;7908029688;Ne;5;5;0;10
4739;Nykštukas;ŽIRNIUKAI;7299329150;Ne;2;0;0;2
4740;Nykštukas;ŽIRNIUKAI;7535385367;Taip;3;0;0;3
4741;Nykštukas;ŽIRNIUKAI;2670682135;Ne;0;1;0;1
4742;Nykštukas;ŽIRNIUKAI;1202614927;Ne;1;0;0;1
4743;Nykštukas;ŽIRNIUKAI;2800783215;Ne;21;0;0;21
4744;Nykštukas;ŽIRNIUKAI;2620150024;Taip;10;0;0;10
4745;Nykštukas;ŽIRNIUKAI;3032028847;Taip;12;1;0;13
4746;Nykštukas;ŽIRNIUKAI;4144437365;Ne;5;0;0;5
4747;Nykštukas;ŽIRNIUKAI;6884714823;Ne;0;4;0;4
4748;Nykštukas;ŽIRNIUKAI;1616644404;Ne;5;0;0;5
4749;Nykštukas;ŽIRNIUKAI;9270615518;Taip;13;1;0;14
4750;Nykštukas;ŽIRNIUKAI;2078586374;Ne;0;6;0;6
4751;Nykštukas;ŽIRNIUKAI;1102203704;Ne;1;0;0;1
4752;Ozas;Smalsučiai;4066900299;Ne;5;0;0;5
4753;Ozas;Smalsučiai;4694561135;Taip;3;0;0;3
4754;Ozas;Smalsučiai;4792735767;Ne;17;2;0;19
4755;Ozas;Smalsučiai;5651665799;Ne;1;0;2;3
4756;Ozas;Smalsučiai;7756424421;Ne;10;0;0;10
4757;Ozas;Smalsučiai;4334162942;Ne;13;0;0;13
4758;Ozas;Smalsučiai;1507372220;Ne;8;0;0;8
4759;Ozas;Smalsučiai;7884934528;Ne;12;0;1;13
4760;Ozas;Smalsučiai;7298628220;Ne;7;1;1;9
4761;Ozas;Smalsučiai;1112829748;Ne;11;0;0;11
4762;Ozas;Smalsučiai;1699412266;Ne;2;0;0;2
4763;Ozas;Smalsučiai;8833452950;Ne;4;0;1;5
4764;Ozas;Smalsučiai;2189280675;Ne;16;1;0;17
4765;Ozas;Smalsučiai;6922447926;Ne;4;0;1;5
4766;Ozas;Smalsučiai;8860029000;Ne;10;0;0;10
4767;Ozas;Smalsučiai;4022390983;Taip;2;0;1;3
4768;Ozas;Smalsučiai;7786745329;Ne;11;0;0;11
4769;Ozas;Smalsučiai;1398871402;Ne;7;0;0;7
4770;Ozas;Drugeliai;6419221599;Taip;0;0;1;1
4771;Ozas;Drugeliai;1866535603;Taip;0;0;1;1
4772;Ozas;Drugeliai;4673128698;Ne;0;0;1;1
4773;Ozas;Drugeliai;7870419810;Ne;13;0;1;14
4774;Ozas;Drugeliai;2869987587;Ne;1;6;3;10
4775;Ozas;Drugeliai;9178967858;Ne;9;0;2;11
4776;Ozas;Drugeliai;5677543279;Ne;0;0;1;1
4777;Ozas;Drugeliai;2454569369;Ne;12;0;1;13
4778;Ozas;Drugeliai;8713970306;Ne;0;0;1;1
4779;Ozas;Drugeliai;1803782282;Taip;0;4;0;4
4780;Ozas;Drugeliai;2819545359;Taip;9;0;2;11
4781;Ozas;Drugeliai;3994760698;Ne;16;0;1;17
4782;Ozas;Drugeliai;7922667688;Ne;3;0;0;3
4783;Ozas;Drugeliai;1536889312;Ne;0;0;9;9
4784;Ozas;Drugeliai;8897904793;Ne;2;0;0;2
4785;Ozas;Drugeliai;3723247420;Ne;6;0;1;7
4786;Ozas;Drugeliai;1489355274;Ne;6;0;2;8
4787;Ozas;Drugeliai;9655492678;Ne;0;0;5;5
4788;Ozas;Drugeliai;1062591107;Taip;0;1;1;2
4789;Ozas;Drugeliai;3967307153;Ne;9;0;0;9
4790;Ozas;Boružėlės;3037323341;Ne;0;1;0;1
4791;Ozas;Boružėlės;6346123124;Ne;14;0;0;14
4792;Ozas;Boružėlės;3133776891;Ne;1;0;0;1
4793;Ozas;Boružėlės;2139224651;Ne;11;1;0;12
4794;Ozas;Boružėlės;9506090620;Ne;5;0;0;5
4795;Ozas;Boružėlės;5172367556;Ne;0;5;0;5
4796;Ozas;Boružėlės;7617839839;Ne;10;4;0;14
4797;Ozas;Boružėlės;6392066805;Taip;5;1;0;6
4798;Ozas;Boružėlės;8781771299;Ne;0;1;2;3
4799;Ozas;Boružėlės;3817138493;Ne;4;2;0;6
4800;Ozas;Boružėlės;8371368881;Ne;1;1;1;3
4801;Ozas;Boružėlės;4994121247;Ne;12;1;0;13
4802;Ozas;Boružėlės;3902722274;Ne;6;0;0;6
4803;Ozas;Boružėlės;7585213159;Ne;0;3;0;3
4804;Ozas;Boružėlės;6315443248;Ne;10;6;0;16
4805;Ozas;Boružėlės;3139289643;Ne;0;1;0;1
4806;Ozas;Boružėlės;6186850614;Ne;11;1;0;12
4807;Ozas;Boružėlės;6318419889;Taip;7;1;0;8
4808;Ozas;Boružėlės;5182160089;Ne;6;1;2;9
4809;Ozas;Boružėlės;7787473586;Ne;10;0;0;10
4810;Ozas;Žiogeliai;7461521320;Ne;0;4;0;4
4811;Ozas;Žiogeliai;6257625501;Ne;1;0;1;2
4812;Ozas;Žiogeliai;7402290524;Taip;5;0;3;8
4813;Ozas;Žiogeliai;1562277866;Ne;0;0;1;1
4814;Ozas;Žiogeliai;4571583671;Ne;7;0;3;10
4815;Ozas;Žiogeliai;5682027094;Ne;9;7;5;21
4816;Ozas;Žiogeliai;9324647606;Taip;3;0;1;4
4817;Ozas;Žiogeliai;9392526836;Ne;0;1;1;2
4818;Ozas;Žiogeliai;4942550213;Ne;9;0;1;10
4819;Ozas;Žiogeliai;8676986286;Ne;0;0;7;7
4820;Ozas;Žiogeliai;2345112767;Ne;7;0;0;7
4821;Ozas;Žiogeliai;5420952391;Ne;0;0;6;6
4822;Ozas;Žiogeliai;9929822317;Ne;0;0;1;1
4823;Ozas;Žiogeliai;2837228320;Ne;0;5;1;6
4824;Ozas;Žiogeliai;2617258206;Ne;0;5;0;5
4825;Ozas;Žiogeliai;4030056504;Ne;0;0;1;1
4826;Ozas;Žiogeliai;5156383727;Ne;0;0;4;4
4827;Ozas;Žiogeliai;3770045761;Ne;3;0;2;5
4828;Ozas;Žiogeliai;9768754737;Ne;0;0;1;1
4829;Ozas;Žiogeliai;7264789334;Ne;0;1;1;2
4830;Ozas;Žiogeliai;7165299220;Ne;0;0;3;3
4831;Ozas;Bitutės;4220780257;Ne;2;0;0;2
4832;Ozas;Bitutės;1161776624;Ne;1;0;1;2
4833;Ozas;Bitutės;4227555342;Taip;0;0;1;1
4834;Ozas;Bitutės;7499756171;Ne;9;5;0;14
4835;Ozas;Bitutės;2705294874;Ne;0;1;1;2
4836;Ozas;Bitutės;2369544599;Ne;0;0;1;1
4837;Ozas;Bitutės;8304671844;Taip;8;0;0;8
4838;Ozas;Bitutės;9772085405;Ne;1;0;1;2
4839;Ozas;Bitutės;7051699003;Ne;1;0;0;1
4840;Ozas;Bitutės;5383877034;Ne;0;0;4;4
4841;Ozas;Bitutės;1117208248;Ne;1;0;1;2
4842;Ozas;Bitutės;6811181735;Ne;2;2;0;4
4843;Ozas;Bitutės;8622621570;Ne;15;0;0;15
4844;Ozas;Bitutės;4260123123;Ne;1;0;0;1
4845;Ozas;Bitutės;7494307084;Taip;1;0;2;3
4846;Ozas;Bitutės;1895519949;Ne;0;0;1;1
4847;Ozas;Bitutės;1475005204;Ne;0;4;0;4
4848;Ozas;Bitutės;5968428143;Ne;1;0;1;2
4849;Ozas;Bitutės;2138633237;Taip;4;0;0;4
4850;Ozas;Bitutės;4286058360;Ne;11;0;1;12
4851;Ozas;Aitvarėliai;1144679735;Ne;15;0;0;15
4852;Ozas;Aitvarėliai;2773182934;Ne;4;0;2;6
4853;Ozas;Aitvarėliai;4357737538;Ne;0;0;3;3
4854;Ozas;Aitvarėliai;5642468671;Ne;3;0;0;3
4855;Ozas;Aitvarėliai;1045890394;Ne;0;0;1;1
4856;Ozas;Aitvarėliai;7686706482;Ne;0;1;1;2
4857;Ozas;Aitvarėliai;2395567376;Ne;1;0;1;2
4858;Ozas;Aitvarėliai;5383739203;Ne;2;1;0;3
4859;Ozas;Aitvarėliai;4583818638;Ne;0;0;2;2
4860;Ozas;Aitvarėliai;1543683077;Ne;0;0;2;2
4861;Ozas;Aitvarėliai;2165291778;Ne;0;9;0;9
4862;Ozas;Aitvarėliai;8754244281;Ne;11;2;0;13
4863;Ozas;Aitvarėliai;6646671212;Ne;1;0;1;2
4864;Ozas;Aitvarėliai;9443843603;Ne;12;0;0;12
4865;Ozas;Aitvarėliai;3238019756;Ne;21;0;0;21
4866;Ozas;Aitvarėliai;8987796218;Ne;4;0;3;7
4867;Ozas;Aitvarėliai;3783477511;Ne;2;0;0;2
4868;Ozas;Aitvarėliai;6778987483;Ne;3;0;0;3
4869;Ozas;Aitvarėliai;7009893338;Taip;5;0;0;5
4870;Ozas;Aitvarėliai;4891451748;Ne;0;7;0;7
4871;Ozas;Aitvarėliai;9813020279;Ne;0;0;1;1
4872;Ozas;Aitvarėliai;2922370952;Ne;4;0;0;4
4873;Ozas;Aitvarėliai;2544858937;Ne;1;0;1;2
4874;Ozas;Voveraitės;6263062055;Ne;3;1;0;4
4875;Ozas;Voveraitės;9195536968;Ne;0;2;0;2
4876;Ozas;Voveraitės;2991511872;Ne;4;2;0;6
4877;Ozas;Voveraitės;5016547315;Ne;0;4;0;4
4878;Ozas;Voveraitės;2511477658;Ne;9;2;0;11
4879;Ozas;Voveraitės;1240233169;Ne;6;0;4;10
4880;Ozas;Voveraitės;6088757991;Ne;0;1;0;1
4881;Ozas;Voveraitės;5822871838;Ne;0;1;0;1
4882;Ozas;Voveraitės;6499549095;Ne;0;2;0;2
4883;Ozas;Voveraitės;2297650260;Ne;6;0;0;6
4884;Ozas;Voveraitės;7908028909;Ne;5;1;0;6
4885;Ozas;Voveraitės;9762737217;Ne;4;1;0;5
4886;Ozas;Voveraitės;7421484648;Ne;16;1;0;17
4887;Ozas;Voveraitės;1997125531;Taip;0;2;0;2
4888;Ozas;Voveraitės;5751808248;Taip;5;1;0;6
4889;Ozas;Voveraitės;4556076744;Ne;2;1;0;3
4890;Ozas;Voveraitės;8503041003;Ne;3;0;0;3
4891;Ozas;Voveraitės;7978092840;Ne;0;1;0;1
4892;Ozas;Kodelčiukai;8743467101;Ne;0;3;0;3
4893;Ozas;Kodelčiukai;2964318343;Ne;4;0;0;4
4894;Ozas;Kodelčiukai;8696127374;Ne;0;0;1;1
4895;Ozas;Kodelčiukai;3704303636;Ne;0;2;0;2
4896;Ozas;Kodelčiukai;2573702751;Ne;2;0;0;2
4897;Ozas;Kodelčiukai;3412369198;Ne;11;0;0;11
4898;Ozas;Kodelčiukai;2951875705;Ne;1;0;0;1
4899;Ozas;Kodelčiukai;7305274617;Ne;0;1;0;1
4900;Ozas;Kodelčiukai;9306887706;Ne;2;0;0;2
4901;Ozas;Kodelčiukai;1348751454;Ne;9;1;0;10
4902;Ozas;Kodelčiukai;9322080266;Ne;3;3;0;6
4903;Ozas;Kodelčiukai;6809992664;Taip;4;2;0;6
4904;Ozas;Kodelčiukai;4516291572;Taip;2;0;0;2
4905;Ozas;Kodelčiukai;4287719751;Ne;0;6;0;6
4906;Ozas;Kodelčiukai;9620747099;Ne;7;0;0;7
4907;Ozas;Kodelčiukai;8779047802;Ne;0;6;0;6
4908;Ozas;Kodelčiukai;6783755555;Taip;0;8;0;8
4909;Ozas;Kodelčiukai;8222112564;Ne;2;7;0;9
4910;Ozas;Kodelčiukai;8797919230;Ne;0;1;0;1
4911;Ozas;Kodelčiukai;4573329075;Ne;14;0;0;14
4912;Ozas;Pelėdžiukai;4640897674;Ne;0;1;0;1
4913;Ozas;Pelėdžiukai;9277208213;Ne;0;1;0;1
4914;Ozas;Pelėdžiukai;8040293681;Ne;7;0;1;8
4915;Ozas;Pelėdžiukai;1856258542;Ne;1;0;2;3
4916;Ozas;Pelėdžiukai;5922569280;Ne;0;6;0;6
4917;Ozas;Pelėdžiukai;7640409923;Ne;0;1;0;1
4918;Ozas;Pelėdžiukai;4601869799;Ne;3;1;0;4
4919;Ozas;Pelėdžiukai;5958055645;Ne;0;5;0;5
4920;Ozas;Pelėdžiukai;7125754645;Ne;1;0;0;1
4921;Ozas;Pelėdžiukai;2824133388;Ne;2;11;0;13
4922;Ozas;Pelėdžiukai;2637531106;Ne;5;1;0;6
4923;Ozas;Pelėdžiukai;7287989663;Ne;3;0;0;3
4924;Ozas;Pelėdžiukai;6819000895;Ne;4;0;0;4
4925;Ozas;Pelėdžiukai;5950860889;Ne;2;1;0;3
4926;Ozas;Pelėdžiukai;4886045470;Ne;1;1;0;2
4927;Ozas;Pelėdžiukai;3212050416;Ne;5;0;0;5
4928;Ozas;Pelėdžiukai;3725141591;Ne;2;0;0;2
4929;Ozas;Pelėdžiukai;3711403511;Ne;1;1;5;7
4930;Ozas;Pelėdžiukai;5392929222;Ne;21;0;0;21
4931;Ozas;Pelėdžiukai;7038928164;Taip;0;1;1;2
4932;Ozas;Pelėdžiukai;2281337233;Taip;1;0;3;4
4933;Ozas;Pelėdžiukai;9334268998;Ne;3;0;0;3
4934;Ozas;"Kačiukai ";4857216527;Ne;0;0;1;1
4935;Ozas;"Kačiukai ";7776754188;Ne;11;0;1;12
4936;Ozas;"Kačiukai ";5097380041;Taip;0;0;4;4
4937;Ozas;"Kačiukai ";3109261153;Ne;5;0;0;5
4938;Ozas;"Kačiukai ";9781398468;Taip;12;0;2;14
4939;Ozas;"Kačiukai ";8488500486;Ne;0;0;1;1
4940;Ozas;"Kačiukai ";2512535949;Taip;6;0;0;6
4941;Ozas;"Kačiukai ";4595986358;Ne;0;0;1;1
4942;Ozas;"Kačiukai ";9781527964;Ne;4;3;0;7
4943;Ozas;"Kačiukai ";4514798132;Ne;20;0;0;20
4944;Ozas;"Kačiukai ";2729524188;Ne;0;0;3;3
4945;Ozas;"Kačiukai ";3269417874;Ne;0;1;0;1
4946;Ozas;"Kačiukai ";5866709636;Ne;15;0;0;15
4947;Ozas;"Kačiukai ";6632795981;Ne;6;0;0;6
4948;Ozas;"Kačiukai ";9543492718;Ne;7;0;0;7
4949;Ozas;"Kačiukai ";2599175140;Ne;2;0;0;2
4950;Ozas;"Kačiukai ";2030429825;Taip;11;0;0;11
4951;Ozas;Ančiukų;3472468379;Ne;2;0;0;2
4952;Ozas;Ančiukų;6512655578;Ne;8;0;0;8
4953;Ozas;Ančiukų;1092988354;Ne;6;0;0;6
4954;Ozas;Ančiukų;5811261087;Ne;4;0;0;4
4955;Ozas;Ančiukų;6894358457;Ne;10;0;0;10
4956;Ozas;Ančiukų;1671756798;Ne;6;0;0;6
4957;Ozas;Ančiukų;5163358861;Ne;2;0;0;2
4958;Ozas;Ančiukų;7611417346;Ne;8;0;0;8
4959;Ozas;Ančiukų;4941588023;Ne;4;0;0;4
4960;Ozas;Ančiukų;8772165816;Ne;9;0;0;9
4961;Ozas;Ančiukų;4910534724;Ne;5;0;0;5
4962;Ozas;Nykškukų;9319720476;Ne;9;0;0;9
4963;Ozas;Nykškukų;2794839285;Ne;10;0;0;10
4964;Ozas;Nykškukų;2326431805;Ne;10;1;0;11
4965;Ozas;Nykškukų;1760627703;Ne;7;1;0;8
4966;Ozas;Nykškukų;5126356120;Ne;10;0;0;10
4967;Ozas;Nykškukų;2490578190;Ne;2;5;0;7
4968;Ozas;Nykškukų;7789232957;Ne;7;0;0;7
4969;Ozas;Nykškukų;2531635671;Ne;5;1;0;6
4970;Ozas;Nykškukų;9685593404;Ne;6;0;0;6
4971;Pabiručiai;Voveriukų;4539246865;Ne;0;2;0;2
4972;Pabiručiai;Voveriukų;2349337471;Ne;0;2;1;3
4973;Pabiručiai;Voveriukų;9564303781;Ne;6;0;4;10
4974;Pabiručiai;Voveriukų;3756731363;Ne;0;4;4;8
4975;Pabiručiai;Voveriukų;7985360502;Ne;0;1;0;1
4976;Pabiručiai;Voveriukų;3936426174;Ne;5;5;0;10
4977;Pabiručiai;Voveriukų;4069564285;Ne;0;1;0;1
4978;Pabiručiai;Voveriukų;7278334800;Ne;5;2;0;7
4979;Pabiručiai;Voveriukų;9468698553;Ne;4;1;0;5
4980;Pabiručiai;Voveriukų;5232678556;Taip;0;1;0;1
4981;Pabiručiai;Voveriukų;7066037017;Ne;0;0;1;1
4982;Pabiručiai;Voveriukų;4040533883;Ne;0;7;0;7
4983;Pabiručiai;Voveriukų;2514312233;Ne;0;2;0;2
4984;Pabiručiai;Voveriukų;7606274875;Ne;0;2;0;2
4985;Pabiručiai;Voveriukų;4813206044;Ne;0;4;0;4
4986;Pabiručiai;Boružiukų;1673473814;Taip;0;1;0;1
4987;Pabiručiai;Boružiukų;5686769648;Taip;8;2;1;11
4988;Pabiručiai;Boružiukų;7524993271;Taip;0;1;2;3
4989;Pabiručiai;Boružiukų;5708597471;Ne;3;1;0;4
4990;Pabiručiai;Boružiukų;7046122545;Ne;0;2;0;2
4991;Pabiručiai;Boružiukų;3096466200;Ne;0;2;0;2
4992;Pabiručiai;Boružiukų;4301904533;Ne;0;12;0;12
4993;Pabiručiai;Boružiukų;8236964683;Ne;0;1;0;1
4994;Pabiručiai;Boružiukų;1240057541;Ne;6;0;3;9
4995;Pabiručiai;Boružiukų;1671027282;Ne;0;7;0;7
4996;Pabiručiai;Boružiukų;3759350345;Ne;0;4;0;4
4997;Pabiručiai;Boružiukų;3151360288;Ne;10;1;0;11
4998;Pabiručiai;Boružiukų;9299393363;Ne;0;2;0;2
4999;Pabiručiai;Boružiukų;1484291546;Ne;0;2;0;2
5000;Pabiručiai;Boružiukų;2771769336;Ne;0;2;0;2
5001;Pabiručiai;Boružiukų;2607840684;Taip;0;1;0;1
5002;Pabiručiai;Boružiukų;4681771534;Ne;0;1;0;1
5003;Pabiručiai;Boružiukų;7050339198;Ne;2;1;0;3
5004;Pabiručiai;Boružiukų;4798503931;Ne;3;0;0;3
5005;Pabiručiai;Boružiukų;1429061018;Ne;0;5;0;5
5006;Pabiručiai;Katinėlių;8649685325;Ne;7;0;0;7
5007;Pabiručiai;Katinėlių;5737214746;Ne;15;0;1;16
5008;Pabiručiai;Katinėlių;4929129093;Ne;0;7;0;7
5009;Pabiručiai;Katinėlių;2141365015;Ne;0;11;0;11
5010;Pabiručiai;Katinėlių;7914642744;Ne;1;0;1;2
5011;Pabiručiai;Katinėlių;1099080685;Ne;5;3;0;8
5012;Pabiručiai;Katinėlių;3011601512;Taip;10;0;0;10
5013;Pabiručiai;Katinėlių;4852287574;Ne;0;6;0;6
5014;Pabiručiai;Katinėlių;3826505104;Taip;0;4;2;6
5015;Pabiručiai;Katinėlių;6678717039;Taip;0;1;0;1
5016;Pabiručiai;Katinėlių;7798837336;Ne;0;2;1;3
5017;Pabiručiai;Katinėlių;7339565412;Taip;0;0;1;1
5018;Pabiručiai;Katinėlių;6742744014;Ne;0;3;0;3
5019;Pabiručiai;Katinėlių;1206012259;Ne;0;2;0;2
5020;Pabiručiai;Katinėlių;9790360371;Ne;0;0;1;1
5021;Pabiručiai;Katinėlių;9890225918;Ne;13;0;1;14
5022;Pabiručiai;Katinėlių;7980170279;Ne;0;0;1;1
5023;Pabiručiai;Katinėlių;1138743823;Ne;3;1;0;4
5024;Pabiručiai;Katinėlių;6508093808;Ne;3;0;1;4
5025;Pabiručiai;Žiogelių;3531292373;Ne;0;2;0;2
5026;Pabiručiai;Žiogelių;1247522345;Ne;10;11;0;21
5027;Pabiručiai;Žiogelių;9878655387;Ne;2;0;0;2
5028;Pabiručiai;Žiogelių;8092886420;Ne;0;7;0;7
5029;Pabiručiai;Žiogelių;4012537474;Ne;3;0;0;3
5030;Pabiručiai;Žiogelių;7561916887;Ne;6;0;0;6
5031;Pabiručiai;Žiogelių;9651695086;Ne;0;8;0;8
5032;Pabiručiai;Žiogelių;5050966784;Ne;0;1;0;1
5033;Pabiručiai;Žiogelių;3262687187;Ne;1;0;0;1
5034;Pabiručiai;Žiogelių;4096412988;Ne;2;0;0;2
5035;Pabiručiai;Žiogelių;4876140467;Ne;12;0;0;12
5036;Pabiručiai;Žiogelių;5862643827;Ne;3;0;0;3
5037;Pabiručiai;Žiogelių;6014791534;Ne;1;0;0;1
5038;Pabiručiai;Žiogelių;5704073222;Ne;1;0;0;1
5039;Pabiručiai;Žiogelių;8870657682;Ne;5;0;0;5
5040;Pabiručiai;Žiogelių;2924005478;Ne;7;0;0;7
5041;Pabiručiai;Žiogelių;8668524776;Ne;0;1;0;1
5042;Pabiručiai;Žiogelių;6513943228;Ne;1;0;0;1
5043;Pabiručiai;Žiogelių;4755427277;Ne;6;0;0;6
5044;Pabiručiai;Žiogelių;5184688482;Ne;3;0;0;3
5045;Pabiručiai;Žiogelių;7873575929;Ne;20;0;0;20
5046;Pabiručiai;Smalsiukai;2869383175;Ne;0;9;0;9
5047;Pabiručiai;Smalsiukai;7677235214;Ne;1;0;1;2
5048;Pabiručiai;Smalsiukai;9676561758;Taip;0;7;0;7
5049;Pabiručiai;Smalsiukai;7090116276;Ne;3;0;3;6
5050;Pabiručiai;Smalsiukai;4408666547;Ne;0;0;1;1
5051;Pabiručiai;Smalsiukai;6935913132;Ne;5;4;0;9
5052;Pabiručiai;Smalsiukai;1344711015;Ne;0;4;0;4
5053;Pabiručiai;Smalsiukai;7663581089;Ne;5;0;0;5
5054;Pabiručiai;Smalsiukai;8897462614;Ne;0;2;1;3
5055;Pabiručiai;Smalsiukai;2332338995;Ne;13;0;2;15
5056;Pabiručiai;Smalsiukai;4258226042;Ne;0;6;0;6
5057;Pabiručiai;Smalsiukai;3511851810;Ne;11;1;0;12
5058;Pabiručiai;Smalsiukai;6686039601;Ne;11;1;1;13
5059;Pabiručiai;Smalsiukai;8840885039;Ne;5;0;3;8
5060;Pabiručiai;Smalsiukai;2771891999;Ne;12;0;0;12
5061;Pabiručiai;Smalsiukai;7295052694;Ne;0;1;0;1
5062;Pabiručiai;Smalsiukai;6834663627;Ne;0;8;0;8
5063;Pabiručiai;Kiškučiai;3368607302;Ne;0;8;0;8
5064;Pabiručiai;Kiškučiai;9589005897;Ne;8;3;0;11
5065;Pabiručiai;Kiškučiai;9353062804;Ne;0;1;0;1
5066;Pabiručiai;Kiškučiai;1582754284;Ne;21;0;0;21
5067;Pabiručiai;Kiškučiai;4462744848;Ne;7;7;0;14
5068;Pabiručiai;Kiškučiai;5621183663;Ne;0;5;0;5
5069;Pabiručiai;Kiškučiai;9417138573;Ne;0;2;0;2
5070;Pabiručiai;Kiškučiai;1515270273;Ne;1;2;0;3
5071;Pabiručiai;Kiškučiai;2688728915;Ne;0;9;0;9
5072;Pabiručiai;Kiškučiai;5166525832;Ne;3;2;0;5
5073;Pabiručiai;Kiškučiai;8409455566;Ne;2;15;0;17
5074;Pabiručiai;Kiškučiai;1028312285;Ne;0;7;0;7
5075;Pabiručiai;Kiškučiai;5346249456;Taip;5;6;0;11
5076;Pabiručiai;Kiškučiai;5717534175;Ne;0;1;0;1
5077;Pabiručiai;Kiškučiai;3408518493;Ne;7;7;0;14
5078;Pabiručiai;Kiškučiai;7653129291;Ne;14;3;0;17
5079;Pabiručiai;Kiškučiai;7073230645;Taip;4;3;0;7
5080;Pabiručiai;Kiškučiai;8820585407;Ne;0;2;0;2
5081;Pabiručiai;Kiškučiai;7572077461;Ne;0;1;0;1
5082;Pabiručiai;Kiškučiai;6073797962;Ne;2;0;0;2
5083;Pabiručiai;"Pėledžiukai ";9834824219;Taip;4;9;0;13
5084;Pabiručiai;"Pėledžiukai ";1683369842;Ne;0;0;2;2
5085;Pabiručiai;"Pėledžiukai ";9050994322;Ne;4;0;0;4
5086;Pabiručiai;"Pėledžiukai ";1049154287;Ne;0;0;1;1
5087;Pabiručiai;"Pėledžiukai ";6697518151;Ne;0;1;0;1
5088;Pabiručiai;"Pėledžiukai ";2596301235;Ne;2;1;0;3
5089;Pabiručiai;"Pėledžiukai ";4333645528;Ne;0;1;0;1
5090;Pabiručiai;"Pėledžiukai ";6289025538;Ne;0;16;0;16
5091;Pabiručiai;"Pėledžiukai ";2812291058;Ne;0;6;0;6
5092;Pabiručiai;"Pėledžiukai ";2343561322;Ne;0;2;0;2
5093;Pabiručiai;"Pėledžiukai ";3674583662;Ne;0;10;0;10
5094;Pabiručiai;"Pėledžiukai ";8268101318;Ne;0;5;0;5
5095;Pabiručiai;"Pėledžiukai ";2147165934;Ne;10;0;0;10
5096;Pabiručiai;"Pėledžiukai ";7385149524;Ne;0;5;0;5
5097;Pabiručiai;"Pėledžiukai ";3224195892;Taip;0;1;0;1
5098;Pabiručiai;"Pėledžiukai ";1852744763;Ne;0;0;4;4
5099;Pabiručiai;"Pėledžiukai ";5899880680;Ne;6;0;3;9
5100;Pabiručiai;"Pėledžiukai ";5165268747;Ne;0;4;0;4
5101;Pabiručiai;"Kodelčiūkai ";8775727677;Ne;0;2;0;2
5102;Pabiručiai;"Kodelčiūkai ";2295503584;Ne;0;9;0;9
5103;Pabiručiai;"Kodelčiūkai ";4595458527;Ne;6;1;1;8
5104;Pabiručiai;"Kodelčiūkai ";8716879106;Ne;0;1;0;1
5105;Pabiručiai;"Kodelčiūkai ";9067653417;Ne;5;15;0;20
5106;Pabiručiai;"Kodelčiūkai ";5247780866;Ne;1;1;0;2
5107;Pabiručiai;"Kodelčiūkai ";3433419710;Ne;1;1;0;2
5108;Pabiručiai;"Kodelčiūkai ";6386335808;Taip;14;0;1;15
5109;Pabiručiai;"Kodelčiūkai ";5010271037;Ne;6;1;0;7
5110;Pabiručiai;"Kodelčiūkai ";9538339883;Ne;0;1;0;1
5111;Pabiručiai;"Kodelčiūkai ";7289131864;Ne;0;4;0;4
5112;Pabiručiai;"Kodelčiūkai ";8179285338;Ne;0;3;0;3
5113;Pabiručiai;"Kodelčiūkai ";1234230729;Ne;6;0;1;7
5114;Pabiručiai;"Kodelčiūkai ";3006640255;Ne;10;0;0;10
5115;Pabiručiai;"Kodelčiūkai ";2519371211;Ne;4;0;1;5
5116;Pabiručiai;"Kodelčiūkai ";5211115955;Ne;2;0;0;2
5117;Pabiručiai;"Kodelčiūkai ";2433997383;Ne;1;1;0;2
5118;Pabiručiai;"Peliukų ";3702521810;Ne;9;0;0;9
5119;Pabiručiai;"Peliukų ";4894380231;Ne;3;0;0;3
5120;Pabiručiai;"Peliukų ";1947729077;Ne;2;0;0;2
5121;Pabiručiai;"Peliukų ";7182565608;Taip;0;4;0;4
5122;Pabiručiai;"Peliukų ";1776325000;Ne;4;0;0;4
5123;Pabiručiai;"Peliukų ";5990497129;Ne;5;5;0;10
5124;Pabiručiai;"Peliukų ";7644854044;Ne;0;5;0;5
5125;Pabiručiai;"Peliukų ";9806520732;Taip;3;0;0;3
5126;Pabiručiai;"Peliukų ";2765716248;Ne;7;0;0;7
5127;Pabiručiai;"Peliukų ";8551913254;Ne;13;0;0;13
5128;Pabiručiai;"Peliukų ";1414752034;Ne;8;0;0;8
5129;Pabiručiai;"Peliukų ";2860703696;Ne;0;7;0;7
5130;Pabiručiai;"Peliukų ";1707526401;Ne;5;0;0;5
5131;Pabiručiai;"Peliukų ";5980457097;Taip;6;0;0;6
5132;Pabiručiai;"Viščiukų ";8048012241;Ne;8;0;0;8
5133;Pabiručiai;"Viščiukų ";2757879842;Ne;3;0;0;3
5134;Pabiručiai;"Viščiukų ";7101741906;Ne;8;0;0;8
5135;Pabiručiai;"Viščiukų ";3372218487;Ne;8;0;0;8
5136;Pabiručiai;"Viščiukų ";7537470611;Ne;0;4;0;4
5137;Pabiručiai;"Viščiukų ";6581286069;Ne;3;10;0;13
5138;Pabiručiai;"Viščiukų ";3400423825;Ne;7;0;0;7
5139;Pabiručiai;"Viščiukų ";4078487035;Ne;6;0;0;6
5140;Pabiručiai;"Viščiukų ";7183696280;Ne;0;1;0;1
5141;Pabiručiai;"Viščiukų ";6547174468;Ne;2;0;0;2
5142;Pabiručiai;"Viščiukų ";4554910957;Ne;5;0;0;5
5143;Pabiručiai;"Viščiukų ";8571325340;Ne;0;1;0;1
5144;Pabiručiai;"Drugelių ";9890868992;Ne;6;0;5;11
5145;Pabiručiai;"Drugelių ";2556330147;Ne;0;8;0;8
5146;Pabiručiai;"Drugelių ";3004152898;Ne;0;1;0;1
5147;Pabiručiai;"Drugelių ";5147367745;Ne;4;0;0;4
5148;Pabiručiai;"Drugelių ";7469111351;Ne;1;0;1;2
5149;Pabiručiai;"Drugelių ";3189763918;Ne;0;1;0;1
5150;Pabiručiai;"Drugelių ";8268444485;Ne;1;0;0;1
5151;Pabiručiai;"Drugelių ";8066935182;Ne;1;0;0;1
5152;Pabiručiai;"Drugelių ";6491275202;Taip;5;0;1;6
5153;Pabiručiai;ŽIRNIUKŲ;9507212682;Ne;0;1;0;1
5154;Pabiručiai;ŽIRNIUKŲ;8756826405;Ne;1;0;0;1
5155;Pabiručiai;ŽIRNIUKŲ;4600476221;Ne;5;0;0;5
5156;Pabiručiai;ŽIRNIUKŲ;9042431134;Ne;2;0;0;2
5157;Pabiručiai;ŽIRNIUKŲ;1537534207;Ne;4;0;0;4
5158;Pabiručiai;ŽIRNIUKŲ;2142523078;Ne;0;1;0;1
5159;Pabiručiai;ŽIRNIUKŲ;3370660254;Taip;7;0;1;8
5160;Pabiručiai;ŽIRNIUKŲ;4229089612;Ne;6;0;0;6
5161;Pabiručiai;ŽIRNIUKŲ;8834001928;Ne;6;0;0;6
5162;Pabiručiai;ŽIRNIUKŲ;9185016818;Ne;11;0;0;11
5163;Pabiručiai;ŽIRNIUKŲ;2141466782;Ne;9;0;0;9
5164;Pabiručiai;ŽIRNIUKŲ;9748002526;Ne;0;0;1;1
5165;Pabiručiai;ŽIRNIUKŲ;5436055219;Ne;3;0;0;3
5166;Pabiručiai;ŽIRNIUKŲ;6601800828;Ne;14;0;0;14
5167;Pabiručiai;ŽIRNIUKŲ;8074555646;Ne;2;0;0;2
5168;Pagrandukas;Saulytės;6349387692;Ne;5;1;0;6
5169;Pagrandukas;Saulytės;8186092469;Ne;0;4;0;4
5170;Pagrandukas;Saulytės;2934300533;Ne;0;17;0;17
5171;Pagrandukas;Saulytės;1548697124;Ne;0;1;0;1
5172;Pagrandukas;Saulytės;6711830251;Ne;0;8;0;8
5173;Pagrandukas;Saulytės;7146697128;Taip;4;2;0;6
5174;Pagrandukas;Saulytės;3157676207;Ne;0;1;0;1
5175;Pagrandukas;Saulytės;7511097160;Ne;1;6;0;7
5176;Pagrandukas;Saulytės;3783160018;Ne;4;0;0;4
5177;Pagrandukas;Saulytės;7454863899;Ne;6;1;0;7
5178;Pagrandukas;Saulytės;5560372136;Ne;0;2;0;2
5179;Pagrandukas;Saulytės;1766912463;Taip;0;6;0;6
5180;Pagrandukas;Saulytės;9849054467;Ne;3;8;0;11
5181;Pagrandukas;Saulytės;8024910647;Ne;0;1;0;1
5182;Pagrandukas;Saulytės;8481502330;Ne;0;1;0;1
5183;Pagrandukas;Saulytės;7160305478;Ne;0;2;0;2
5184;Pagrandukas;Saulytės;3008997793;Ne;1;3;0;4
5185;Pagrandukas;Saulytės;6388805960;Ne;6;18;0;24
5186;Pagrandukas;Saulytės;3050207849;Ne;0;1;0;1
5187;Pagrandukas;Saulytės;8836178193;Ne;8;8;0;16
5188;Pagrandukas;Saulytės;7157549179;Ne;0;4;0;4
5189;Pagrandukas;Zuikučiai;7834436515;Ne;0;2;0;2
5190;Pagrandukas;Zuikučiai;5903416384;Ne;2;0;0;2
5191;Pagrandukas;Zuikučiai;2439891231;Ne;0;7;0;7
5192;Pagrandukas;Zuikučiai;6710887776;Ne;0;7;0;7
5193;Pagrandukas;Zuikučiai;2212787835;Ne;0;2;0;2
5194;Pagrandukas;Zuikučiai;1405820070;Ne;0;1;0;1
5195;Pagrandukas;Zuikučiai;1054107640;Ne;0;9;0;9
5196;Pagrandukas;Zuikučiai;1795582354;Ne;0;1;0;1
5197;Pagrandukas;Zuikučiai;1587839122;Ne;4;0;0;4
5198;Pagrandukas;Zuikučiai;2101505576;Ne;0;0;3;3
5199;Pagrandukas;Zuikučiai;5922595170;Ne;6;0;0;6
5200;Pagrandukas;Zuikučiai;9139212151;Ne;0;0;1;1
5201;Pagrandukas;Zuikučiai;8643993939;Ne;0;5;0;5
5202;Pagrandukas;Boružėlių;5330598431;Ne;11;0;0;11
5203;Pagrandukas;Boružėlių;9141829963;Ne;1;2;0;3
5204;Pagrandukas;Boružėlių;3643271023;Ne;2;2;0;4
5205;Pagrandukas;Boružėlių;7897742424;Ne;1;0;0;1
5206;Pagrandukas;Boružėlių;3313757952;Ne;1;0;0;1
5207;Pagrandukas;Boružėlių;4013188468;Ne;0;2;0;2
5208;Pagrandukas;Boružėlių;8812047984;Ne;10;0;0;10
5209;Pagrandukas;Boružėlių;7219415600;Ne;0;1;0;1
5210;Pagrandukas;Boružėlių;1552515788;Ne;0;3;0;3
5211;Pagrandukas;Boružėlių;6506518248;Ne;0;9;0;9
5212;Pagrandukas;Boružėlių;2244308184;Ne;4;0;0;4
5213;Pagrandukas;Boružėlių;4730178155;Ne;6;0;0;6
5214;Pagrandukas;Boružėlių;8869609106;Ne;11;0;0;11
5215;Pagrandukas;Boružėlių;8948739929;Ne;0;1;0;1
5216;Pagrandukas;Boružėlių;9390682686;Ne;4;0;0;4
5217;Pagrandukas;Bitutės;9188382746;Ne;3;0;0;3
5218;Pagrandukas;Bitutės;1583104760;Ne;0;1;0;1
5219;Pagrandukas;Bitutės;5649084353;Ne;0;2;0;2
5220;Pagrandukas;Bitutės;5821945401;Ne;0;14;0;14
5221;Pagrandukas;Bitutės;7675694987;Ne;6;0;0;6
5222;Pagrandukas;Bitutės;2764732768;Ne;4;0;2;6
5223;Pagrandukas;Bitutės;9987717045;Ne;7;0;0;7
5224;Pagrandukas;Bitutės;4771506131;Ne;4;0;4;8
5225;Pagrandukas;Bitutės;9798727946;Ne;4;0;0;4
5226;Pagrandukas;Bitutės;5464426019;Ne;3;0;4;7
5227;Pagrandukas;Bitutės;6845210200;Ne;3;5;0;8
5228;Pagrandukas;Bitutės;6090721838;Ne;9;0;0;9
5229;Pagrandukas;Bitutės;6129335910;Ne;3;0;0;3
5230;Pagrandukas;Bitutės;1780452241;Ne;2;0;3;5
5231;Pagrandukas;Bitutės;3795172018;Taip;4;2;0;6
5232;Pagrandukas;Bitutės;5604315555;Ne;4;6;0;10
5233;Pagrandukas;Bitutės;7784155503;Ne;5;6;0;11
5234;Pagrandukas;Bitutės;5511396314;Ne;0;9;0;9
5235;Pagrandukas;Pelėdžiukai;1714449109;Ne;5;1;0;6
5236;Pagrandukas;Pelėdžiukai;3160109801;Ne;5;3;0;8
5237;Pagrandukas;Pelėdžiukai;2877401332;Ne;0;2;0;2
5238;Pagrandukas;Pelėdžiukai;8167118045;Ne;4;0;0;4
5239;Pagrandukas;Pelėdžiukai;3390664086;Ne;0;8;0;8
5240;Pagrandukas;Pelėdžiukai;1733723373;Ne;12;0;0;12
5241;Pagrandukas;Pelėdžiukai;6011346969;Ne;2;1;0;3
5242;Pagrandukas;Pelėdžiukai;1077792535;Ne;5;0;0;5
5243;Pagrandukas;Pelėdžiukai;9583471280;Ne;4;0;0;4
5244;Pagrandukas;Pelėdžiukai;2481532396;Ne;0;2;0;2
5245;Pagrandukas;Pelėdžiukai;4398016119;Ne;1;1;0;2
5246;Pagrandukas;Pelėdžiukai;2640777376;Ne;5;0;0;5
5247;Pagrandukas;Pelėdžiukai;4910151924;Ne;8;1;0;9
5248;Pagrandukas;Pelėdžiukai;9431513632;Ne;0;1;0;1
5249;Pagrandukas;Pelėdžiukai;1977974235;Ne;4;1;0;5
5250;Pagrandukas;Pelėdžiukai;7238694532;Ne;8;1;0;9
5251;Pagrandukas;Pelėdžiukai;4014238120;Ne;7;0;0;7
5252;Pagrandukas;Pelėdžiukai;8789320226;Ne;4;3;0;7
5253;Pagrandukas;Pelėdžiukai;1308066299;Ne;1;0;1;2
5254;Pagrandukas;Pelėdžiukai;3569618725;Ne;13;0;0;13
5255;Pagrandukas;ŠYPSENĖLIŲ;4627387596;Ne;3;0;0;3
5256;Pagrandukas;ŠYPSENĖLIŲ;7173561328;Ne;5;0;0;5
5257;Pagrandukas;ŠYPSENĖLIŲ;1101989969;Ne;1;0;0;1
5258;Pagrandukas;ŠYPSENĖLIŲ;5701479990;Ne;6;0;0;6
5259;Pagrandukas;ŠYPSENĖLIŲ;8027783692;Taip;5;0;0;5
5260;Pagrandukas;ŠYPSENĖLIŲ;6248684084;Taip;14;0;0;14
5261;Pagrandukas;ŠYPSENĖLIŲ;2904880156;Ne;6;0;0;6
5262;Pagrandukas;ŠYPSENĖLIŲ;5173633710;Ne;2;0;0;2
5263;Pagrandukas;ŠYPSENĖLIŲ;6057078416;Ne;6;0;0;6
5264;Pagrandukas;ŠYPSENĖLIŲ;1855833141;Ne;2;0;0;2
5265;Pagrandukas;ŠYPSENĖLIŲ;1475375452;Ne;7;0;0;7
5266;Pagrandukas;ŠYPSENĖLIŲ;8475724797;Ne;1;0;0;1
5267;Pagrandukas;ŠYPSENĖLIŲ;6517393406;Ne;18;0;0;18
5268;Pagrandukas;ŠYPSENĖLIŲ;4094086585;Ne;6;0;0;6
5269;Pagrandukas;ŠYPSENĖLIŲ;6306635507;Ne;0;4;0;4
5270;Pagrandukas;ŠYPSENĖLIŲ;1728795744;Ne;10;0;0;10
5271;Pagrandukas;ŠYPSENĖLIŲ;8728782427;Ne;13;0;0;13
5272;Pagrandukas;ŠYPSENĖLIŲ;8638429638;Ne;2;0;0;2
5273;Pagrandukas;ŠYPSENĖLIŲ;7498372078;Ne;7;0;0;7
5274;Pakalnutė;Pagrandukai;7475119623;Ne;0;2;0;2
5275;Pakalnutė;Pagrandukai;9677810607;Ne;1;0;1;2
5276;Pakalnutė;Pagrandukai;5275833872;Ne;0;1;1;2
5277;Pakalnutė;Pagrandukai;2296079246;Ne;0;0;1;1
5278;Pakalnutė;Pagrandukai;9313588621;Ne;1;0;0;1
5279;Pakalnutė;Pagrandukai;7962849592;Ne;2;0;2;4
5280;Pakalnutė;Pagrandukai;5180015882;Ne;0;0;1;1
5281;Pakalnutė;Pagrandukai;3070652992;Ne;0;1;0;1
5282;Pakalnutė;Pagrandukai;7477188659;Ne;0;1;0;1
5283;Pakalnutė;Pagrandukai;4390444128;Ne;2;0;1;3
5284;Pakalnutė;Pagrandukai;2642359967;Ne;5;0;0;5
5285;Pakalnutė;Pagrandukai;7417131378;Taip;2;6;1;9
5286;Pakalnutė;Pagrandukai;6396963609;Ne;6;0;1;7
5287;Pakalnutė;Pagrandukai;6708041407;Ne;4;0;0;4
5288;Pakalnutė;Pagrandukai;1883500676;Ne;5;0;1;6
5289;Pakalnutė;Pagrandukai;9537826109;Ne;4;0;0;4
5290;Pakalnutė;"Pelėdžiukų ";8730363504;Ne;0;0;2;2
5291;Pakalnutė;"Pelėdžiukų ";6002425101;Ne;7;0;0;7
5292;Pakalnutė;"Pelėdžiukų ";6592271501;Ne;0;1;5;6
5293;Pakalnutė;"Pelėdžiukų ";6981958616;Ne;1;0;1;2
5294;Pakalnutė;"Pelėdžiukų ";3139358443;Ne;0;0;5;5
5295;Pakalnutė;"Pelėdžiukų ";1999933222;Taip;0;0;2;2
5296;Pakalnutė;"Pelėdžiukų ";1783674258;Ne;0;0;3;3
5297;Pakalnutė;"Pelėdžiukų ";9624523658;Ne;3;0;0;3
5298;Pakalnutė;"Pelėdžiukų ";9517878047;Ne;0;0;2;2
5299;Pakalnutė;"Pelėdžiukų ";6555749105;Ne;0;0;3;3
5300;Pakalnutė;"Pelėdžiukų ";9253328160;Ne;5;0;1;6
5301;Pakalnutė;"Pelėdžiukų ";6866535420;Ne;0;0;1;1
5302;Pakalnutė;"Pelėdžiukų ";8996675127;Ne;0;0;3;3
5303;Pakalnutė;Ežiukai;4052166895;Ne;7;0;0;7
5304;Pakalnutė;Ežiukai;9323200833;Ne;3;1;0;4
5305;Pakalnutė;Ežiukai;9781993614;Ne;5;0;0;5
5306;Pakalnutė;Ežiukai;4317305712;Ne;2;0;0;2
5307;Pakalnutė;Ežiukai;7734657452;Ne;8;0;0;8
5308;Pakalnutė;Ežiukai;8081932074;Ne;1;0;0;1
5309;Pakalnutė;Ežiukai;9706455707;Ne;12;0;0;12
5310;Pakalnutė;Ežiukai;7881545979;Ne;5;0;1;6
5311;Pakalnutė;Ežiukai;8080989574;Ne;1;0;2;3
5312;Pakalnutė;Ežiukai;5911381706;Ne;0;1;0;1
5313;Pakalnutė;Ežiukai;2755412687;Ne;1;0;0;1
5314;Pakalnutė;Ežiukai;8236718590;Ne;0;1;0;1
5315;Pakalnutė;Ežiukai;3064391379;Ne;3;0;0;3
5316;Pakalnutė;Ežiukai;8329725085;Taip;4;0;0;4
5317;Pakalnutė;Ežiukai;1662773049;Ne;3;0;0;3
5318;Pakalnutė;Ežiukai;4961361687;Ne;1;0;0;1
5319;Pakalnutė;Ežiukai;5685361033;Ne;13;0;0;13
5320;Pakalnutė;Skruzdėliukų;4033813807;Ne;5;0;0;5
5321;Pakalnutė;Skruzdėliukų;5409476517;Ne;0;19;0;19
5322;Pakalnutė;Skruzdėliukų;7105369111;Ne;0;0;2;2
5323;Pakalnutė;Skruzdėliukų;6944726166;Ne;0;0;1;1
5324;Pakalnutė;Skruzdėliukų;1195872320;Ne;0;1;1;2
5325;Pakalnutė;Skruzdėliukų;3211633472;Ne;0;0;1;1
5326;Pakalnutė;Skruzdėliukų;4423348418;Ne;8;0;0;8
5327;Pakalnutė;Skruzdėliukų;6055727963;Taip;2;6;0;8
5328;Pakalnutė;Skruzdėliukų;3215438452;Ne;1;0;0;1
5329;Pakalnutė;Skruzdėliukų;9681515221;Ne;5;0;1;6
5330;Pakalnutė;Skruzdėliukų;8496839980;Ne;0;0;1;1
5331;Pakalnutė;Skruzdėliukų;9336711927;Taip;16;0;0;16
5332;Pakalnutė;Skruzdėliukų;5356902834;Ne;5;0;0;5
5333;Pakalnutė;Skruzdėliukų;1540045675;Ne;0;10;0;10
5334;Pakalnutė;Skruzdėliukų;8768704484;Ne;4;0;1;5
5335;Pakalnutė;Skruzdėliukų;6675588261;Ne;4;0;1;5
5336;Pakalnutė;Bitučių;2367683002;Ne;0;0;1;1
5337;Pakalnutė;Bitučių;2765220889;Ne;0;2;0;2
5338;Pakalnutė;Bitučių;9445909071;Ne;3;1;0;4
5339;Pakalnutė;Bitučių;5532458706;Ne;0;1;0;1
5340;Pakalnutė;Bitučių;7526989580;Ne;2;0;1;3
5341;Pakalnutė;Bitučių;3306334576;Ne;4;3;0;7
5342;Pakalnutė;Bitučių;5342592825;Ne;2;2;0;4
5343;Pakalnutė;Bitučių;5464143742;Ne;8;0;0;8
5344;Pakalnutė;Bitučių;6351193702;Ne;0;1;0;1
5345;Pakalnutė;Bitučių;2070744110;Ne;2;0;0;2
5346;Pakalnutė;Bitučių;3965390135;Ne;0;0;2;2
5347;Pakalnutė;Bitučių;5355198213;Ne;6;0;1;7
5348;Pakalnutė;Bitučių;4533467194;Ne;6;0;1;7
5349;Pakalnutė;Bitučių;4523766424;Ne;8;1;0;9
5350;Pakalnutė;Bitučių;4452372238;Taip;3;0;0;3
5351;Pakalnutė;Bitučių;2992768162;Ne;4;0;1;5
5352;Pakalnutė;Bitučių;9505524183;Ne;6;0;1;7
5353;Pakalnutė;Bitučių;8900756351;Ne;0;0;2;2
5354;Pakalnutė;Bitučių;1330092247;Ne;1;0;1;2
5355;Pakalnutė;Bitučių;3267680599;Ne;0;3;0;3
5356;Pakalnutė;Boružiukų;6798939288;Ne;6;0;1;7
5357;Pakalnutė;Boružiukų;7357431226;Ne;0;0;1;1
5358;Pakalnutė;Boružiukų;4934095931;Ne;1;5;0;6
5359;Pakalnutė;Boružiukų;5039000154;Ne;0;1;0;1
5360;Pakalnutė;Boružiukų;2835611316;Ne;2;0;0;2
5361;Pakalnutė;Boružiukų;7672252382;Ne;0;0;1;1
5362;Pakalnutė;Boružiukų;4950195858;Ne;15;0;1;16
5363;Pakalnutė;Boružiukų;6557165567;Ne;1;0;1;2
5364;Pakalnutė;Boružiukų;3677709759;Taip;0;0;1;1
5365;Pakalnutė;Boružiukų;2597900983;Ne;1;5;0;6
5366;Pakalnutė;Boružiukų;2062721289;Ne;1;0;1;2
5367;Pakalnutė;Boružiukų;1340022702;Ne;0;0;1;1
5368;Pakalnutė;Boružiukų;6228196996;Ne;9;0;0;9
5369;Pakalnutė;Boružiukų;5619262190;Ne;2;1;1;4
5370;Pakalnutė;Boružiukų;8553182620;Ne;10;0;1;11
5371;Pakalnutė;Boružiukų;3840499737;Ne;0;3;1;4
5372;Pakalnutė;Boružiukų;4220368864;Ne;4;1;0;5
5373;Pakalnutė;Boružiukų;7151877991;Taip;1;1;0;2
5374;Pakalnutė;Boružiukų;4353883274;Ne;2;0;0;2
5375;Pakalnutė;Boružiukų;8823232039;Ne;0;0;1;1
5376;Pakalnutė;Meškiukų;2101821362;Ne;9;2;0;11
5377;Pakalnutė;Meškiukų;4069910346;Ne;0;4;0;4
5378;Pakalnutė;Meškiukų;4313652059;Ne;0;1;0;1
5379;Pakalnutė;Meškiukų;7084798190;Ne;8;0;0;8
5380;Pakalnutė;Meškiukų;6133481935;Ne;8;0;0;8
5381;Pakalnutė;Meškiukų;3693337607;Ne;2;0;0;2
5382;Pakalnutė;Meškiukų;8576580816;Taip;1;0;0;1
5383;Pakalnutė;Meškiukų;1303121160;Ne;2;0;0;2
5384;Pakalnutė;Meškiukų;6082998947;Ne;5;0;0;5
5385;Pakalnutė;Meškiukų;7696196458;Ne;6;0;0;6
5386;Pakalnutė;Meškiukų;9724506812;Taip;2;0;0;2
5387;Pakalnutė;Meškiukų;9327477300;Ne;0;1;0;1
5388;Pakalnutė;Nykštukai;9918277117;Taip;5;0;0;5
5389;Pakalnutė;Nykštukai;6633585181;Taip;4;1;0;5
5390;Pakalnutė;Nykštukai;3870628774;Ne;1;0;0;1
5391;Pakalnutė;Nykštukai;8324219868;Ne;1;1;0;2
5392;Pakalnutė;Nykštukai;1864990681;Ne;3;0;0;3
5393;Pakalnutė;Nykštukai;2063766287;Ne;2;4;0;6
5394;Pakalnutė;Nykštukai;6528913736;Taip;2;0;0;2
5395;Pakalnutė;Nykštukai;8217779439;Ne;7;1;0;8
5396;Pakalnutė;Nykštukai;6206296685;Ne;3;1;0;4
5397;Pakalnutė;Nykštukai;8855237588;Taip;5;0;0;5
5398;Pakalnutė;Nykštukai;1561411767;Ne;4;1;0;5
5399;Pakalnutė;Nykštukai;9443826616;Ne;8;1;0;9
5400;Pakalnutė;Nykštukai;7024440142;Ne;0;1;0;1
5401;Pakalnutė;Nykštukai;2578170222;Ne;16;0;0;16
5402;Pakalnutė;Nykštukai;3967515235;Ne;5;0;0;5
5403;Pakalnutė;Nykštukai;5377715404;Ne;14;0;0;14
5404;Pakalnutė;Nykštukai;3938091521;Ne;9;0;0;9
5405;Pakalnutė;"Zuikučių ";3992958274;Taip;6;0;0;6
5406;Pakalnutė;"Zuikučių ";7665013940;Ne;0;0;2;2
5407;Pakalnutė;"Zuikučių ";5366218312;Ne;8;0;1;9
5408;Pakalnutė;"Zuikučių ";9093281442;Ne;0;0;6;6
5409;Pakalnutė;"Zuikučių ";8678783379;Ne;3;0;0;3
5410;Pakalnutė;"Zuikučių ";7200174700;Ne;0;1;3;4
5411;Pakalnutė;"Zuikučių ";2364777781;Ne;4;0;1;5
5412;Pakalnutė;"Zuikučių ";6817504559;Ne;5;0;0;5
5413;Pakalnutė;"Zuikučių ";1044084070;Ne;14;0;0;14
5414;Pakalnutė;"Zuikučių ";4587376166;Ne;6;0;0;6
5415;Pakalnutė;"Zuikučių ";7696333378;Ne;2;7;0;9
5416;Pakalnutė;"Drugelių ";5441477374;Ne;0;7;0;7
5417;Pakalnutė;"Drugelių ";7369661890;Ne;5;0;0;5
5418;Pakalnutė;"Drugelių ";7766653114;Ne;13;0;0;13
5419;Pakalnutė;"Drugelių ";7709684372;Ne;3;0;0;3
5420;Pakalnutė;"Drugelių ";9620000116;Taip;13;0;0;13
5421;Pakalnutė;"Drugelių ";5502444590;Ne;5;0;0;5
5422;Pakalnutė;"Drugelių ";3730712580;Ne;3;0;0;3
5423;Pakalnutė;"Drugelių ";4220406978;Ne;2;0;0;2
5424;Pakalnutė;"Drugelių ";7047587606;Ne;0;10;0;10
5425;Pakalnutė;"Drugelių ";2653667596;Ne;1;0;0;1
5426;Pakalnutė;"Drugelių ";2026242407;Ne;2;0;0;2
5427;Pakalnutė;"Drugelių ";2197533802;Ne;1;0;0;1
5428;Pakalnutė;"Drugelių ";1791607977;Taip;0;1;0;1
5429;Pakalnutė;"Drugelių ";4127500142;Ne;0;2;0;2
5430;Pakalnutė;"Drugelių ";9295709508;Taip;6;0;0;6
5431;Pakalnutė;"Drugelių ";6924023022;Ne;14;0;0;14
5432;Pakalnutė;"Drugelių ";8105507156;Ne;1;0;0;1
5433;Pakalnutė;Žvirbliukų;7421275778;Ne;0;0;1;1
5434;Pakalnutė;Žvirbliukų;3190067149;Taip;0;21;0;21
5435;Pakalnutė;Žvirbliukų;7548659665;Taip;2;0;0;2
5436;Pakalnutė;Žvirbliukų;8010667913;Ne;15;0;1;16
5437;Pakalnutė;Žvirbliukų;5531209454;Ne;7;0;1;8
5438;Pakalnutė;Žvirbliukų;7258417347;Taip;17;0;0;17
5439;Pakalnutė;Žvirbliukų;5878352514;Ne;0;0;1;1
5440;Pakalnutė;Žvirbliukų;7782295402;Ne;0;0;2;2
5441;Pakalnutė;Žvirbliukų;7547661599;Taip;0;1;0;1
5442;Pakalnutė;Žvirbliukų;4469974699;Ne;5;0;0;5
5443;Pakalnutė;Žvirbliukų;6159955311;Ne;6;1;0;7
5444;Pakalnutė;Žvirbliukų;3903972025;Ne;2;2;0;4
5445;Pakalnutė;Žvirbliukų;8394290574;Ne;0;1;0;1
5446;Pakalnutė;Žvirbliukų;1368254053;Ne;0;0;1;1
5447;Pakalnutė;Žvirbliukų;6361966325;Ne;0;6;0;6
5448;Panerių;Rūtelė;2333355325;Taip;0;0;1;1
5449;Panerių;Rūtelė;4867297993;Ne;0;0;2;2
5450;Panerių;Rūtelė;2235123048;Ne;5;0;0;5
5451;Panerių;Rūtelė;3190117304;Taip;0;11;0;11
5452;Panerių;Rūtelė;8693113275;Taip;12;0;1;13
5453;Panerių;Rūtelė;6468190149;Ne;0;5;0;5
5454;Panerių;Rūtelė;9630302749;Ne;0;0;1;1
5455;Panerių;Rūtelė;3057714143;Ne;5;0;0;5
5456;Panerių;Rūtelė;9432171719;Ne;0;1;0;1
5457;Panerių;Rūtelė;1717129076;Ne;0;0;5;5
5458;Panerių;Rūtelė;2035822976;Ne;6;0;0;6
5459;Panerių;Rūtelė;3550194241;Ne;0;0;1;1
5460;Panerių;Rūtelė;9729731866;Ne;4;0;0;4
5461;Panerių;Rūtelė;8447920373;Ne;0;0;2;2
5462;Panerių;Rūtelė;6583134855;Ne;0;0;4;4
5463;Panerių;Rūtelė;4161189870;Taip;15;0;1;16
5464;Panerių;Rūtelė;9004310393;Ne;10;0;0;10
5465;Panerių;Rūtelė;3948776877;Ne;0;0;1;1
5466;Panerių;Rūtelė;8514805919;Ne;0;0;1;1
5467;Panerių;Rūtelė;2751334281;Ne;0;0;2;2
5468;Panerių;Rūtelė;1339256258;Ne;6;5;0;11
5469;Panerių;Rūtelė;3882802840;Ne;0;2;1;3
5470;Panerių;Gėlytės;3112608087;Taip;0;0;1;1
5471;Panerių;Gėlytės;5100874548;Ne;11;0;0;11
5472;Panerių;Gėlytės;7166964095;Ne;8;0;1;9
5473;Panerių;Gėlytės;7657860513;Taip;0;4;0;4
5474;Panerių;Gėlytės;4716214117;Ne;8;5;0;13
5475;Panerių;Gėlytės;9014387764;Ne;0;1;0;1
5476;Panerių;Gėlytės;3273655606;Ne;5;5;1;11
5477;Panerių;Gėlytės;8067240250;Ne;5;0;1;6
5478;Panerių;Gėlytės;8407995549;Taip;2;0;0;2
5479;Panerių;Gėlytės;3502494751;Ne;2;0;3;5
5480;Panerių;Gėlytės;6574858142;Ne;2;0;3;5
5481;Panerių;Gėlytės;7976634590;Taip;5;0;0;5
5482;Panerių;Gėlytės;1985780685;Ne;10;0;1;11
5483;Panerių;Boružė;6067429637;Ne;0;0;2;2
5484;Panerių;Boružė;8204542330;Ne;0;0;1;1
5485;Panerių;Boružė;9834947195;Ne;3;0;0;3
5486;Panerių;Boružė;2411155582;Ne;0;0;1;1
5487;Panerių;Boružė;5243109212;Ne;6;0;0;6
5488;Panerių;Boružė;7516118069;Taip;2;0;0;2
5489;Panerių;Boružė;9157312277;Ne;3;0;1;4
5490;Panerių;Boružė;6903412424;Ne;5;0;0;5
5491;Panerių;Boružė;4459492055;Ne;0;0;2;2
5492;Papartis;ZUIKUČIAI;8874222586;Ne;11;0;0;11
5493;Papartis;ZUIKUČIAI;2446379598;Ne;4;0;0;4
5494;Papartis;ZUIKUČIAI;3054883426;Ne;6;0;0;6
5495;Papartis;ZUIKUČIAI;1191546794;Ne;0;6;0;6
5496;Papartis;ZUIKUČIAI;7619963429;Ne;0;2;0;2
5497;Papartis;ZUIKUČIAI;8958880558;Ne;3;5;0;8
5498;Papartis;ZUIKUČIAI;4380030213;Ne;6;1;0;7
5499;Papartis;ZUIKUČIAI;4906248064;Ne;4;0;0;4
5500;Papartis;ZUIKUČIAI;8447326505;Ne;0;1;0;1
5501;Papartis;ZUIKUČIAI;1919362027;Ne;1;1;0;2
5502;Papartis;ZUIKUČIAI;4640068595;Ne;0;1;0;1
5503;Papartis;ZUIKUČIAI;5796928317;Ne;1;1;0;2
5504;Papartis;ZUIKUČIAI;9375751990;Ne;0;2;0;2
5505;Papartis;ZUIKUČIAI;5786648402;Ne;2;0;0;2
5506;Papartis;ZUIKUČIAI;5776038830;Ne;0;8;0;8
5507;Papartis;ZUIKUČIAI;5579899922;Ne;1;0;0;1
5508;Papartis;ZUIKUČIAI;9358310527;Ne;0;13;0;13
5509;Papartis;ZUIKUČIAI;5363926529;Taip;3;0;0;3
5510;Papartis;ZUIKUČIAI;1722192450;Ne;7;0;0;7
5511;Papartis;ZUIKUČIAI;8897061283;Ne;9;0;0;9
5512;Papartis;DRUGELIAI;8005876431;Ne;1;0;0;1
5513;Papartis;DRUGELIAI;2432516496;Ne;12;0;1;13
5514;Papartis;DRUGELIAI;7742769931;Ne;8;0;1;9
5515;Papartis;DRUGELIAI;8305560946;Ne;2;0;3;5
5516;Papartis;DRUGELIAI;4778327620;Ne;0;5;0;5
5517;Papartis;DRUGELIAI;7331682622;Ne;0;1;0;1
5518;Papartis;DRUGELIAI;2824078830;Ne;0;2;0;2
5519;Papartis;DRUGELIAI;1405767603;Ne;0;1;0;1
5520;Papartis;DRUGELIAI;6435625940;Ne;0;4;0;4
5521;Papartis;DRUGELIAI;7187797639;Ne;1;1;0;2
5522;Papartis;DRUGELIAI;3411472740;Ne;8;1;0;9
5523;Papartis;DRUGELIAI;3209105694;Ne;1;0;0;1
5524;Papartis;DRUGELIAI;8277830926;Ne;0;2;0;2
5525;Papartis;DRUGELIAI;1759982543;Ne;0;2;0;2
5526;Papartis;DRUGELIAI;4689046394;Ne;0;1;0;1
5527;Papartis;DRUGELIAI;5430993785;Ne;10;1;0;11
5528;Papartis;ŽVIRBLIUKAI;5538433120;Taip;0;1;0;1
5529;Papartis;ŽVIRBLIUKAI;9380951144;Ne;0;4;8;12
5530;Papartis;ŽVIRBLIUKAI;2812347963;Ne;16;0;2;18
5531;Papartis;ŽVIRBLIUKAI;3685642787;Ne;16;0;0;16
5532;Papartis;ŽVIRBLIUKAI;8420752169;Taip;5;1;2;8
5533;Papartis;ŽVIRBLIUKAI;4016297254;Ne;10;0;2;12
5534;Papartis;ŽVIRBLIUKAI;6585372451;Ne;0;0;1;1
5535;Papartis;ŽVIRBLIUKAI;6734567714;Ne;0;0;1;1
5536;Papartis;ŽVIRBLIUKAI;4597039190;Ne;8;0;0;8
5537;Papartis;ŽVIRBLIUKAI;1352401881;Ne;7;0;1;8
5538;Papartis;ŽVIRBLIUKAI;1231594320;Ne;0;0;1;1
5539;Papartis;ŽVIRBLIUKAI;3539507686;Ne;10;0;0;10
5540;Papartis;ŽVIRBLIUKAI;5465955537;Ne;9;0;2;11
5541;Papartis;ŽVIRBLIUKAI;6346776139;Ne;20;0;5;25
5542;Papartis;ŽVIRBLIUKAI;3595627659;Ne;4;0;0;4
5543;Papartis;ŽVIRBLIUKAI;6977513472;Ne;0;1;0;1
5544;Papartis;ŽVIRBLIUKAI;5323875279;Ne;23;1;2;26
5545;Papartis;ŽVIRBLIUKAI;6136213985;Ne;2;1;0;3
5546;Papartis;ŽVIRBLIUKAI;7107692314;Ne;1;1;0;2
5547;Papartis;ŽVIRBLIUKAI;5070767260;Ne;5;0;1;6
5548;Papartis;PELĖDŽIUKAI;9502229005;Ne;0;0;1;1
5549;Papartis;PELĖDŽIUKAI;5652560002;Ne;0;0;2;2
5550;Papartis;PELĖDŽIUKAI;6360881137;Ne;2;0;0;2
5551;Papartis;PELĖDŽIUKAI;6794076631;Ne;0;1;1;2
5552;Papartis;PELĖDŽIUKAI;6941978169;Ne;7;0;1;8
5553;Papartis;PELĖDŽIUKAI;4203241118;Ne;0;0;1;1
5554;Papartis;PELĖDŽIUKAI;9285319899;Ne;0;1;2;3
5555;Papartis;PELĖDŽIUKAI;5942160584;Ne;0;10;0;10
5556;Papartis;PELĖDŽIUKAI;9922091482;Ne;0;1;0;1
5557;Papartis;PELĖDŽIUKAI;1680412204;Taip;4;0;0;4
5558;Papartis;PELĖDŽIUKAI;6423401656;Ne;0;0;1;1
5559;Papartis;PELĖDŽIUKAI;9384670351;Ne;2;0;0;2
5560;Papartis;PELĖDŽIUKAI;4509843536;Ne;10;0;1;11
5561;Papartis;PELĖDŽIUKAI;4878190663;Ne;0;0;1;1
5562;Papartis;PELĖDŽIUKAI;9900023788;Ne;0;0;1;1
5563;Papartis;SAULUTĖS;8187136860;Ne;1;0;0;1
5564;Papartis;SAULUTĖS;1428163291;Ne;6;0;0;6
5565;Papartis;SAULUTĖS;6436061438;Ne;6;0;0;6
5566;Papartis;SAULUTĖS;8423259604;Ne;0;4;0;4
5567;Papartis;SAULUTĖS;4887468138;Ne;1;0;0;1
5568;Papartis;SAULUTĖS;8866437550;Ne;3;0;0;3
5569;Papartis;SAULUTĖS;3948323728;Ne;8;1;0;9
5570;Papartis;SAULUTĖS;2004327439;Ne;1;0;0;1
5571;Papartis;SAULUTĖS;6199807321;Ne;7;0;0;7
5572;Papartis;GANDRIUKAI;4969807705;Ne;20;0;0;20
5573;Papartis;GANDRIUKAI;5383936595;Ne;15;0;1;16
5574;Papartis;GANDRIUKAI;6274608449;Ne;5;0;0;5
5575;Papartis;GANDRIUKAI;6664773988;Ne;3;1;0;4
5576;Papartis;GANDRIUKAI;8875490564;Ne;3;0;1;4
5577;Papartis;GANDRIUKAI;7149853209;Ne;6;0;0;6
5578;Papartis;GANDRIUKAI;2921187615;Ne;12;0;1;13
5579;Papartis;GANDRIUKAI;4500675679;Ne;0;1;0;1
5580;Papartis;GANDRIUKAI;7203919287;Ne;0;11;0;11
5581;Papartis;GANDRIUKAI;5132031416;Ne;17;0;0;17
5582;Papartis;GANDRIUKAI;3395306653;Ne;13;3;0;16
5583;Papartis;GANDRIUKAI;1616537800;Ne;0;6;0;6
5584;Papartis;GANDRIUKAI;8303599213;Ne;2;0;1;3
5585;Papartis;GANDRIUKAI;9326439257;Ne;13;0;0;13
5586;Papartis;GANDRIUKAI;8410744610;Ne;2;6;0;8
5587;Papartis;AITVARELIAI;8891856856;Ne;0;1;0;1
5588;Papartis;AITVARELIAI;6889782462;Taip;0;2;5;7
5589;Papartis;AITVARELIAI;5736456872;Ne;0;2;0;2
5590;Papartis;AITVARELIAI;3040269026;Ne;0;2;0;2
5591;Papartis;AITVARELIAI;8532558577;Ne;0;2;1;3
5592;Papartis;AITVARELIAI;4918854899;Ne;0;1;0;1
5593;Papartis;AITVARELIAI;5252947502;Ne;0;2;0;2
5594;Papartis;AITVARELIAI;7803854703;Ne;0;2;0;2
5595;Papartis;AITVARELIAI;4261270064;Ne;0;4;0;4
5596;Papartis;AITVARELIAI;6416605464;Ne;0;1;0;1
5597;Papartis;AITVARELIAI;1266338760;Ne;0;3;0;3
5598;Papartis;AITVARELIAI;7504793827;Ne;0;2;0;2
5599;Papartis;AITVARELIAI;7156767639;Ne;5;2;0;7
5600;Papartis;AITVARELIAI;2116140075;Ne;0;3;0;3
5601;Papartis;AITVARELIAI;3896803048;Ne;0;1;0;1
5602;Papartis;AITVARELIAI;8989172483;Ne;0;0;18;18
5603;Papartis;AITVARELIAI;9384475270;Ne;0;4;0;4
5604;Papartis;SMALSUČIAI;5660932637;Ne;8;2;0;10
5605;Papartis;SMALSUČIAI;3576856223;Ne;0;6;0;6
5606;Papartis;SMALSUČIAI;5259754395;Ne;9;2;0;11
5607;Papartis;SMALSUČIAI;1157298413;Ne;3;0;0;3
5608;Papartis;SMALSUČIAI;3107245976;Ne;5;0;0;5
5609;Papartis;SMALSUČIAI;1381195839;Ne;2;1;0;3
5610;Papartis;SMALSUČIAI;6107558090;Ne;0;4;0;4
5611;Papartis;SMALSUČIAI;5959006739;Ne;4;2;0;6
5612;Papartis;SMALSUČIAI;6776383676;Ne;7;2;0;9
5613;Papartis;SMALSUČIAI;2079105902;Ne;0;1;0;1
5614;Papartis;SMALSUČIAI;9838432144;Ne;12;5;0;17
5615;Papartis;SMALSUČIAI;9884399306;Ne;5;5;0;10
5616;Papartis;SMALSUČIAI;1511111597;Ne;6;0;0;6
5617;Papartis;SMALSUČIAI;8055310718;Ne;7;1;0;8
5618;Papartis;SMALSUČIAI;7492923318;Ne;11;0;0;11
5619;Papartis;SMALSUČIAI;3490370261;Ne;9;5;0;14
5620;Papartis;SMALSUČIAI;1566259150;Ne;8;0;0;8
5621;Papartis;SMALSUČIAI;1159418157;Ne;1;6;0;7
5622;Papartis;SMALSUČIAI;4087823915;Ne;5;0;0;5
5623;Papartis;"ŽIRNIUKAI ";3310893254;Ne;3;0;1;4
5624;Papartis;"ŽIRNIUKAI ";1073755384;Ne;0;0;5;5
5625;Papartis;"ŽIRNIUKAI ";7647225316;Ne;13;2;0;15
5626;Papartis;"ŽIRNIUKAI ";1210592579;Ne;0;0;6;6
5627;Papartis;"ŽIRNIUKAI ";4158525314;Ne;3;0;1;4
5628;Papartis;"ŽIRNIUKAI ";4978398085;Ne;0;10;1;11
5629;Papartis;"ŽIRNIUKAI ";9746397380;Ne;2;0;1;3
5630;Papartis;"ŽIRNIUKAI ";4952279543;Ne;0;2;0;2
5631;Papartis;"ŽIRNIUKAI ";5276806556;Ne;0;0;1;1
5632;Papartis;"ŽIRNIUKAI ";2521609574;Taip;7;0;6;13
5633;Papartis;"ŽIRNIUKAI ";7617558492;Ne;0;5;1;6
5634;Papartis;"ŽIRNIUKAI ";2772758899;Ne;2;0;4;6
5635;Papartis;"ŽIRNIUKAI ";1183123161;Taip;0;0;2;2
5636;Papartis;"ŽIRNIUKAI ";9518392031;Ne;0;0;1;1
5637;Papartis;"ŽIRNIUKAI ";6615368741;Ne;10;0;2;12
5638;Papartis;"ŽIRNIUKAI ";1614261572;Ne;0;3;0;3
5639;Papartis;BORUŽĖLĖS;4156776066;Ne;6;0;1;7
5640;Papartis;BORUŽĖLĖS;1713966292;Taip;6;0;1;7
5641;Papartis;BORUŽĖLĖS;1229841021;Ne;0;0;1;1
5642;Papartis;BORUŽĖLĖS;6971029839;Ne;0;0;2;2
5643;Papartis;BORUŽĖLĖS;3671248088;Ne;2;1;1;4
5644;Papartis;BORUŽĖLĖS;3033128518;Ne;5;0;0;5
5645;Papartis;BORUŽĖLĖS;3138701373;Ne;9;0;2;11
5646;Papartis;BORUŽĖLĖS;4800482635;Ne;9;0;1;10
5647;Papartis;BORUŽĖLĖS;2833918272;Ne;10;0;1;11
5648;Papartis;BORUŽĖLĖS;5459468987;Ne;9;0;2;11
5649;Papartis;VARPELIAI;5796633935;Ne;5;1;0;6
5650;Papartis;VARPELIAI;5073439000;Ne;0;1;0;1
5651;Papartis;VARPELIAI;1390187546;Ne;6;0;0;6
5652;Papartis;VARPELIAI;6559847250;Ne;0;3;1;4
5653;Papartis;VARPELIAI;6053981340;Ne;0;3;1;4
5654;Papartis;VARPELIAI;5038105723;Taip;0;0;1;1
5655;Papartis;VARPELIAI;3327404107;Ne;1;0;0;1
5656;Papartis;VARPELIAI;4839033346;Ne;9;2;0;11
5657;Papartis;VARPELIAI;5063367652;Ne;2;0;0;2
5658;Papartis;VARPELIAI;4620041887;Ne;1;0;1;2
5659;Papartis;VARPELIAI;1032653411;Ne;0;0;1;1
5660;Papartis;NYKŠTUKAI;7260304487;Ne;0;2;0;2
5661;Papartis;NYKŠTUKAI;9581159294;Taip;3;0;0;3
5662;Papartis;NYKŠTUKAI;2956950308;Taip;1;0;0;1
5663;Papartis;NYKŠTUKAI;6710049689;Ne;9;1;0;10
5664;Papartis;NYKŠTUKAI;2777359899;Taip;0;0;1;1
5665;Papartis;NYKŠTUKAI;1993893368;Ne;0;1;0;1
5666;Papartis;NYKŠTUKAI;3345085436;Ne;0;1;0;1
5667;Papartis;NYKŠTUKAI;7189999679;Ne;3;1;0;4
5668;Papartis;NYKŠTUKAI;8443731277;Ne;0;1;1;2
5669;Papartis;NYKŠTUKAI;3419374226;Taip;8;0;11;19
5670;Papartis;NYKŠTUKAI;8642079824;Ne;7;0;1;8
5671;Papartis;NYKŠTUKAI;2421158534;Ne;0;0;2;2
5672;Papartis;NYKŠTUKAI;2600724041;Ne;0;1;0;1
5673;Papartis;NYKŠTUKAI;8872914372;Ne;4;0;0;4
5674;Papartis;NYKŠTUKAI;2053568874;Ne;0;5;0;5
5675;Papartis;NYKŠTUKAI;4952700737;Ne;10;0;0;10
5676;Papartis;NYKŠTUKAI;9881509036;Taip;3;0;0;3
5677;Pasaka;Drugelių;2308992563;Ne;6;0;2;8
5678;Pasaka;Drugelių;9249389876;Ne;7;1;0;8
5679;Pasaka;Drugelių;2961210575;Taip;6;0;0;6
5680;Pasaka;Drugelių;2383607612;Taip;0;1;0;1
5681;Pasaka;Drugelių;5351364328;Ne;0;2;2;4
5682;Pasaka;Drugelių;4635912654;Ne;0;2;2;4
5683;Pasaka;Drugelių;9737445077;Ne;7;0;0;7
5684;Pasaka;Drugelių;9136521759;Ne;0;1;0;1
5685;Pasaka;Drugelių;8400549247;Ne;0;0;1;1
5686;Pasaka;Drugelių;4175157894;Ne;0;0;1;1
5687;Pasaka;Drugelių;7252498738;Ne;3;11;2;16
5688;Pasaka;Nykštukų;9567521319;Ne;0;7;0;7
5689;Pasaka;Nykštukų;5768958388;Ne;0;10;0;10
5690;Pasaka;Nykštukų;2211744442;Ne;1;0;1;2
5691;Pasaka;Nykštukų;5912306325;Ne;5;4;0;9
5692;Pasaka;Nykštukų;2217868951;Ne;1;1;1;3
5693;Pasaka;Nykštukų;2217868951;Ne;1;1;1;3
5694;Pasaka;Nykštukų;2217868951;Ne;1;1;1;3
5695;Pasaka;Nykštukų;3066438231;Ne;0;15;0;15
5696;Pasaka;Nykštukų;3066438231;Ne;0;15;0;15
5697;Pasaka;Nykštukų;3066438231;Ne;0;15;0;15
5698;Pasaka;Nykštukų;3424189866;Ne;0;0;1;1
5699;Pasaka;Nykštukų;7214402510;Ne;0;0;2;2
5700;Pasaka;Nykštukų;6821289069;Ne;0;0;3;3
5701;Pasaka;Nykštukų;3557547656;Ne;0;2;0;2
5702;Pasaka;Nykštukų;2086919906;Ne;10;0;2;12
5703;Pasaka;Nykštukų;4614626554;Ne;0;0;1;1
5704;Pasaka;Nykštukų;2121277188;Ne;0;0;1;1
5705;Pasaka;Nykštukų;8391715624;Ne;2;0;0;2
5706;Pasaka;Montesori;4548601585;Taip;0;6;0;6
5707;Pasaka;Montesori;7887326763;Ne;0;0;1;1
5708;Pasaka;Montesori;9850592463;Ne;0;0;2;2
5709;Pasaka;Montesori;2995831258;Ne;5;0;1;6
5710;Pasaka;Montesori;6248810027;Taip;3;0;0;3
5711;Pasaka;Montesori;7751618911;Ne;7;0;0;7
5712;Pasaka;Montesori;5230621839;Ne;0;0;1;1
5713;Pasaka;Montesori;9471447977;Taip;0;2;2;4
5714;Pasaka;Montesori;4222952044;Ne;3;0;0;3
5715;Pasaka;Montesori;5969883817;Taip;2;1;1;4
5716;Pasaka;Montesori;2558448927;Taip;0;0;4;4
5717;Pasaka;Žirniukų;2422958320;Ne;5;0;3;8
5718;Pasaka;Žirniukų;9438006825;Ne;0;0;1;1
5719;Pasaka;Žirniukų;9136524816;Ne;0;0;1;1
5720;Pasaka;Žirniukų;9766432049;Ne;0;0;1;1
5721;Pasaka;Žirniukų;6387972576;Ne;3;0;0;3
5722;Pasaka;Žirniukų;4948174745;Ne;5;0;6;11
5723;Pasaka;Žirniukų;2144975281;Ne;0;5;0;5
5724;Pasaka;Žirniukų;8519108324;Ne;3;0;2;5
5725;Pasaka;Žirniukų;9950979894;Ne;2;0;0;2
5726;Pasaka;Žirniukų;9654507441;Ne;0;8;0;8
5727;Pasaka;Žirniukų;9654507441;Ne;0;8;0;8
5728;Pasaka;Žirniukų;9654507441;Ne;0;8;0;8
5729;Pasaka;Žirniukų;2569560383;Ne;0;0;5;5
5730;Pasaka;Žirniukų;9780490338;Ne;0;0;7;7
5731;Pasaka;"Voveriukų ";3606141216;Ne;0;10;0;10
5732;Pasaka;"Voveriukų ";5217688848;Ne;0;10;0;10
5733;Pasaka;"Voveriukų ";4171004263;Ne;0;1;3;4
5734;Pasaka;"Voveriukų ";8504575043;Ne;0;1;0;1
5735;Pasaka;"Voveriukų ";9588247759;Taip;0;4;0;4
5736;Pasaka;"Voveriukų ";8899289832;Ne;0;0;3;3
5737;Pasaka;"Voveriukų ";7176272684;Ne;0;2;0;2
5738;Pasaka;"Voveriukų ";4799036184;Ne;0;5;0;5
5739;Pasaka;"Voveriukų ";6684234474;Taip;0;0;6;6
5740;Pasaka;"Voveriukų ";6925961600;Ne;0;7;0;7
5741;Pasaka;"Voveriukų ";8421404290;Taip;0;1;0;1
5742;Pasaka;"Voveriukų ";1745181416;Ne;0;0;14;14
5743;Pasaka;"Voveriukų ";6315362421;Ne;0;3;0;3
5744;Pasaka;"Voveriukų ";6315362421;Ne;0;3;0;3
5745;Pasaka;"VALDOFRO 12";8976424908;Ne;0;0;1;1
5746;Pasaka;"VALDOFRO 12";7682903999;Ne;0;0;1;1
5747;Pasaka;"VALDOFRO 12";8411025450;Ne;5;0;0;5
5748;Pasaka;"VALDOFRO 12";1756831961;Ne;0;1;0;1
5749;Pasaka;"VALDOFRO 12";3840053722;Ne;0;3;0;3
5750;Pasaka;"VALDOFRO 12";4548945364;Ne;0;0;1;1
5751;Pasaka;"VALDOFRO 12";5244582148;Ne;0;0;10;10
5752;Pasaka;"VALDOFRO 12";9065016148;Ne;0;0;1;1
5753;Pasaka;"VALDOFRO 12";6920718870;Ne;3;0;2;5
5754;Pasaka;"VALDORFO 2";4620573687;Ne;1;1;0;2
5755;Pasaka;"VALDORFO 2";4825373152;Ne;5;0;0;5
5756;Pasaka;"VALDORFO 2";9462745431;Ne;0;0;1;1
5757;Pasaka;"VALDORFO 2";5399148997;Ne;0;1;0;1
5758;Pasaka;"VALDORFO 2";1799326151;Ne;5;0;1;6
5759;Pasaka;"VALDORFO 2";2273629510;Ne;5;0;1;6
5760;Pasaka;"VALDORFO 2";3778182691;Ne;2;1;0;3
5761;Pasaka;"VALDORFO 2";5742479853;Ne;0;0;1;1
5762;Pasaka;"VALDORFO 2";3049361712;Ne;0;0;1;1
5763;Pasaka;"VALDORFO 2";1648043715;Ne;0;0;3;3
5764;Pasaka;"VALDORFO 2";8855436141;Ne;6;10;2;18
5765;Pasaka;"VALDORFO 2";3796844193;Ne;3;0;0;3
5766;Pasaka;"VALDORFO 2";1940341287;Ne;2;0;0;2
5767;Pasaka;Gudručiai;5687494160;Ne;0;1;0;1
5768;Pasaka;Gudručiai;3151916774;Ne;0;1;0;1
5769;Pasaka;Gudručiai;4773893970;Ne;4;1;0;5
5770;Pasaka;Gudručiai;1813068555;Ne;0;0;1;1
5771;Pasaka;Gudručiai;7546205285;Ne;0;15;0;15
5772;Pasaka;Gudručiai;4082752808;Taip;5;0;0;5
5773;Pasaka;Gudručiai;6139825302;Ne;0;3;0;3
5774;Pasaka;Gudručiai;1720511696;Ne;0;0;2;2
5775;Pasaka;Gudručiai;4970812899;Ne;5;0;2;7
5776;Pasaka;Gudručiai;5723970763;Ne;0;1;0;1
5777;Pasaka;Bitelių;7696383564;Ne;0;0;2;2
5778;Pasaka;Bitelių;4910817298;Ne;0;0;1;1
5779;Pasaka;Bitelių;7960739321;Ne;0;0;2;2
5780;Pasaka;"Pabiručių ";5111195289;Ne;0;6;0;6
5781;Pasaka;"Pabiručių ";6182223896;Ne;0;6;1;7
5782;Pasaka;"Pabiručių ";4982900413;Ne;0;9;0;9
5783;Pasaka;"Pabiručių ";8276520594;Ne;5;0;3;8
5784;Pasaka;"Pabiručių ";4572517095;Ne;0;0;3;3
5785;Pasaka;"Pabiručių ";5297950763;Ne;7;0;0;7
5786;Pasaka;"Pabiručių ";8662703330;Ne;2;0;0;2
5787;Pasaka;"Pabiručių ";6189170713;Ne;0;0;1;1
5788;Pasaka;"Pabiručių ";2963191890;Ne;0;0;1;1
5789;Pasaka;Šnekučių;1793176485;Ne;1;2;0;3
5790;Pasaka;Šnekučių;4296539838;Taip;0;0;6;6
5791;Pasaka;Šnekučių;1590306118;Ne;3;1;0;4
5792;Pasaka;Šnekučių;6795580569;Ne;1;1;0;2
5793;Pasaka;Šnekučių;4215568107;Ne;4;0;0;4
5794;Pasaka;Šnekučių;8365256755;Ne;3;1;0;4
5795;Pasaka;Šnekučių;4816441219;Ne;3;0;2;5
5796;Pasaka;Šnekučių;1795497567;Ne;0;0;1;1
5797;Pasaka;Šnekučių;8347051587;Ne;16;0;0;16
5798;Pasaka;Šnekučių;4975045894;Ne;3;0;0;3
5799;Pasaka;Šnekučių;3588073618;Ne;3;0;1;4
5800;Pasaka;Šnekučių;1194745876;Ne;0;0;2;2
5801;Pasaka;Šnekučių;1749821746;Ne;5;0;1;6
5802;Pasaka;Šnekučių;1723076060;Ne;6;4;0;10
5803;Pasaka;Šnekučių;8475365713;Taip;0;2;0;2
5804;Pasaka;Šnekučių;5656511105;Ne;7;9;0;16
5805;Pasaka;"KIŠKUČIŲ (Žirmūnų g. 92)";7311929329;Ne;0;0;1;1
5806;Pasaka;"KIŠKUČIŲ (Žirmūnų g. 92)";2368681819;Ne;0;7;0;7
5807;Pasaka;"KIŠKUČIŲ (Žirmūnų g. 92)";5134067973;Taip;0;13;0;13
5808;Pasaka;"KIŠKUČIŲ (Žirmūnų g. 92)";2135527938;Ne;0;3;0;3
5809;Pasaka;"KIŠKUČIŲ (Žirmūnų g. 92)";5073970913;Ne;5;0;0;5
5810;Pasaka;"KIŠKUČIŲ (Žirmūnų g. 92)";5255764606;Taip;0;0;17;17
5811;Pasaka;"KIŠKUČIŲ (Žirmūnų g. 92)";6950137606;Ne;0;0;1;1
5812;Pasaka;"KIŠKUČIŲ (Žirmūnų g. 92)";2575986215;Ne;0;0;9;9
5813;Pasaka;"KIŠKUČIŲ (Žirmūnų g. 92)";4924664211;Ne;0;0;1;1
5814;Pasaka;"KIŠKUČIŲ (Žirmūnų g. 92)";5632714212;Ne;17;0;0;17
5815;Pasaka;"KIŠKUČIŲ (Žirmūnų g. 92)";9928518840;Ne;0;0;3;3
5816;Pasaka;"EŽIUKŲ (Žirmūnų g. 92)";4389337333;Taip;5;0;0;5
5817;Pasaka;"EŽIUKŲ (Žirmūnų g. 92)";9266921444;Ne;0;0;3;3
5818;Pasaka;"EŽIUKŲ (Žirmūnų g. 92)";9922357232;Ne;0;0;3;3
5819;Pasaka;"EŽIUKŲ (Žirmūnų g. 92)";7811540398;Ne;1;0;3;4
5820;Pasaka;"EŽIUKŲ (Žirmūnų g. 92)";7964569326;Ne;1;0;3;4
5821;Pasaka;"EŽIUKŲ (Žirmūnų g. 92)";3567879839;Ne;4;0;0;4
5822;Pasaka;"EŽIUKŲ (Žirmūnų g. 92)";4458246330;Ne;0;0;4;4
5823;Pasaka;"EŽIUKŲ (Žirmūnų g. 92)";5450477466;Ne;0;0;7;7
5824;Pasaka;"EŽIUKŲ (Žirmūnų g. 92)";9409030208;Ne;5;0;2;7
5825;Pasaka;"EŽIUKŲ (Žirmūnų g. 92)";9717417413;Ne;0;0;6;6
5826;Pasaka;"EŽIUKŲ (Žirmūnų g. 92)";6780585061;Ne;10;0;0;10
5827;Pasaka;"EŽIUKŲ (Žirmūnų g. 92)";2313200719;Ne;9;0;1;10
5828;Pasaka;"SAULUČIŲ (Žirmūnų g. 92)";1963481567;Ne;3;0;3;6
5829;Pasaka;"SAULUČIŲ (Žirmūnų g. 92)";8164697203;Ne;0;0;1;1
5830;Pasaka;"SAULUČIŲ (Žirmūnų g. 92)";6991062262;Ne;5;0;0;5
5831;Pasaka;"SAULUČIŲ (Žirmūnų g. 92)";1214817944;Ne;3;0;0;3
5832;Pasaka;"SAULUČIŲ (Žirmūnų g. 92)";6087447128;Ne;3;0;0;3
5833;Pasaka;"SAULUČIŲ (Žirmūnų g. 92)";9369336996;Ne;0;0;1;1
5834;Pasaka;"SAULUČIŲ (Žirmūnų g. 92)";8866484797;Taip;15;0;0;15
5835;Pasaka;"SAULUČIŲ (Žirmūnų g. 92)";3587648653;Ne;15;0;0;15
5836;Pasaka;"SAULUČIŲ (Žirmūnų g. 92)";6388657745;Ne;15;0;0;15
5837;Pasaka;"SAULUČIŲ (Žirmūnų g. 92)";6280303158;Ne;0;0;1;1
5838;Pasaka;"SAULUČIŲ (Žirmūnų g. 92)";9403892434;Ne;1;0;9;10
5839;Pasaka;"SAULUČIŲ (Žirmūnų g. 92)";6498432810;Ne;4;0;1;5
5840;Pasaka;"SAULUČIŲ (Žirmūnų g. 92)";8837340945;Ne;5;0;2;7
5841;Pasaka;"SAULUČIŲ (Žirmūnų g. 92)";1083785206;Taip;0;0;1;1
5842;Paslaptis;MONTIKI;4683384309;Taip;5;1;0;6
5843;Paslaptis;MONTIKI;4350594725;Taip;2;1;0;3
5844;Paslaptis;MONTIKI;1780728941;Ne;9;0;0;9
5845;Paslaptis;MONTIKI;4962917136;Ne;1;0;0;1
5846;Paslaptis;MONTIKI;5908641161;Ne;11;0;0;11
5847;Paslaptis;MONTIKI;1869254264;Ne;0;0;6;6
5848;Paslaptis;MONTIKI;3463582845;Ne;4;0;0;4
5849;Paslaptis;MONTIKI;7867852953;Ne;4;0;0;4
5850;Paslaptis;MONTIKI;4038980805;Ne;7;0;0;7
5851;Paslaptis;FRUTIKI;2105441745;Ne;6;1;0;7
5852;Paslaptis;FRUTIKI;6686352764;Ne;5;0;2;7
5853;Paslaptis;FRUTIKI;6513238386;Ne;7;0;0;7
5854;Paslaptis;FRUTIKI;8457752288;Ne;10;1;1;12
5855;Paslaptis;FRUTIKI;4159590988;Ne;10;0;1;11
5856;Paslaptis;FRUTIKI;9929877115;Taip;16;0;0;16
5857;Paslaptis;FRUTIKI;6860366087;Taip;6;8;0;14
5858;Paslaptis;FRUTIKI;3572102816;Ne;10;0;0;10
5859;Paslaptis;FRUTIKI;2927014406;Taip;10;0;0;10
5860;Paslaptis;FRUTIKI;7053452493;Ne;0;1;0;1
5861;Paslaptis;FRUTIKI;8909545951;Ne;6;0;0;6
5862;Paslaptis;FRUTIKI;3963816472;Ne;12;0;0;12
5863;Paslaptis;FRUTIKI;5809630456;Ne;4;1;0;5
5864;Paslaptis;FRUTIKI;6764142182;Ne;0;1;3;4
5865;Paslaptis;FRUTIKI;9299390190;Ne;7;6;0;13
5866;Paslaptis;FRUTIKI;9497654214;Ne;7;0;1;8
5867;Paslaptis;FRUTIKI;1080710834;Ne;5;0;0;5
5868;Paslaptis;FRUTIKI;5480407965;Ne;0;15;0;15
5869;Paslaptis;KALAMBURIKI;1029321312;Taip;0;1;0;1
5870;Paslaptis;KALAMBURIKI;5852939221;Ne;0;1;0;1
5871;Paslaptis;KALAMBURIKI;3104525540;Taip;8;0;0;8
5872;Paslaptis;KALAMBURIKI;3398729758;Ne;9;0;0;9
5873;Paslaptis;KALAMBURIKI;7672102974;Ne;11;1;0;12
5874;Paslaptis;KALAMBURIKI;9100003209;Ne;10;1;0;11
5875;Paslaptis;KALAMBURIKI;3984799090;Taip;5;1;0;6
5876;Paslaptis;KALAMBURIKI;5886364670;Ne;8;0;0;8
5877;Paslaptis;KALAMBURIKI;2675089401;Ne;0;1;0;1
5878;Paslaptis;KALAMBURIKI;1557783684;Ne;0;19;0;19
5879;Paslaptis;KALAMBURIKI;8895770223;Ne;0;1;0;1
5880;Paslaptis;KALAMBURIKI;5206529350;Ne;10;1;1;12
5881;Paslaptis;KALAMBURIKI;5456011928;Ne;0;1;0;1
5882;Paslaptis;KALAMBURIKI;8717111488;Taip;0;0;3;3
5883;Paslaptis;KALAMBURIKI;5646806136;Ne;11;0;0;11
5884;Paslaptis;KALAMBURIKI;6098345982;Ne;5;1;0;6
5885;Paslaptis;KALAMBURIKI;8296575784;Ne;4;1;0;5
5886;Paslaptis;KALAMBURIKI;7638521198;Ne;9;1;0;10
5887;Pasakaitė;Vieversėlių;5162170061;Ne;10;0;0;10
5888;Pasakaitė;Vieversėlių;6795204239;Ne;0;0;1;1
5889;Pasakaitė;Vieversėlių;8559244062;Taip;0;0;1;1
5890;Pasakaitė;Vieversėlių;4316883215;Ne;0;2;0;2
5891;Pasakaitė;Vieversėlių;8478538959;Ne;0;21;0;21
5892;Pasakaitė;Vieversėlių;5279719152;Ne;5;2;0;7
5893;Pasakaitė;Vieversėlių;4098119950;Ne;0;3;0;3
5894;Pasakaitė;Vieversėlių;6160327808;Ne;0;0;1;1
5895;Pasakaitė;Vieversėlių;1705913604;Ne;5;0;0;5
5896;Pasakaitė;Vieversėlių;4898974534;Ne;0;0;1;1
5897;Pasakaitė;Vieversėlių;7399335037;Taip;1;0;0;1
5898;Pasakaitė;Vieversėlių;7965916747;Ne;0;0;1;1
5899;Pasakaitė;Vieversėlių;2584717150;Ne;0;10;5;15
5900;Pasakaitė;Vieversėlių;4397797616;Ne;0;19;0;19
5901;Pasakaitė;Vieversėlių;4659277297;Ne;5;0;1;6
5902;Pasakaitė;Vieversėlių;8160163060;Ne;0;12;2;14
5903;Pasakaitė;Vieversėlių;8350808883;Ne;2;0;0;2
5904;Pasakaitė;Vieversėlių;1122248122;Ne;0;7;0;7
5905;Pasakaitė;Vieversėlių;2801785334;Taip;0;1;0;1
5906;Pasakaitė;Spindulėlių;1697755753;Ne;11;3;0;14
5907;Pasakaitė;Spindulėlių;8105641645;Ne;0;0;4;4
5908;Pasakaitė;Spindulėlių;5791927811;Taip;0;20;0;20
5909;Pasakaitė;Spindulėlių;5094404397;Taip;0;20;0;20
5910;Pasakaitė;Spindulėlių;9870015737;Ne;7;0;0;7
5911;Pasakaitė;Spindulėlių;2733800758;Ne;3;0;2;5
5912;Pasakaitė;Spindulėlių;6256000265;Ne;10;0;0;10
5913;Pasakaitė;Spindulėlių;2891089579;Ne;10;0;0;10
5914;Pasakaitė;Spindulėlių;3381303531;Ne;0;7;0;7
5915;Pasakaitė;Spindulėlių;7265623955;Ne;16;0;1;17
5916;Pasakaitė;Spindulėlių;1564611671;Ne;3;0;0;3
5917;Pasakaitė;Spindulėlių;4268438476;Ne;12;0;0;12
5918;Pasakaitė;Spindulėlių;2340908210;Ne;6;1;0;7
5919;Pasakaitė;Spindulėlių;6229020982;Ne;7;5;1;13
5920;Pasakaitė;Spindulėlių;2278658674;Ne;9;0;0;9
5921;Pasakaitė;Spindulėlių;9982451343;Ne;7;11;0;18
5922;Pasakaitė;Spindulėlių;5745073940;Ne;8;0;1;9
5923;Pasakaitė;Spindulėlių;6745120294;Ne;0;7;0;7
5924;Pasakaitė;Spindulėlių;9508156795;Ne;0;2;0;2
5925;Pasakaitė;Pasagėlių;2810892060;Taip;0;0;1;1
5926;Pasakaitė;Pasagėlių;9895144528;Ne;0;7;0;7
5927;Pasakaitė;Pasagėlių;9409907631;Ne;6;0;5;11
5928;Pasakaitė;Pasagėlių;5589440439;Ne;0;2;2;4
5929;Pasakaitė;Pasagėlių;5959875562;Ne;1;0;2;3
5930;Pasakaitė;Pasagėlių;3355268509;Ne;5;0;0;5
5931;Pasakaitė;Pasagėlių;1959599606;Ne;3;0;1;4
5932;Pasakaitė;Pasagėlių;7440327561;Ne;0;3;0;3
5933;Pasakaitė;Pasagėlių;6325408070;Taip;3;14;0;17
5934;Pasakaitė;Pasagėlių;9238905834;Taip;10;4;0;14
5935;Pasakaitė;Pasagėlių;4826492004;Ne;5;1;0;6
5936;Pasakaitė;Pasagėlių;5540251866;Ne;5;0;0;5
5937;Pasakaitė;Pasagėlių;7219080600;Ne;5;2;0;7
5938;Pasakaitė;Pasagėlių;2341175137;Ne;5;0;4;9
5939;Pasakaitė;Pasagėlių;8905681529;Ne;0;0;4;4
5940;Pasakaitė;Pasagėlių;8165055476;Ne;0;0;1;1
5941;Pasakaitė;Pasagėlių;5034077389;Ne;0;0;1;1
5942;Pasakaitė;Pasagėlių;9645230615;Ne;3;1;0;4
5943;Pasakaitė;Švyturėlių;7702359586;Ne;0;0;4;4
5944;Pasakaitė;Švyturėlių;6847782430;Ne;0;5;0;5
5945;Pasakaitė;Švyturėlių;4728731352;Taip;0;5;0;5
5946;Pasakaitė;Švyturėlių;9821617981;Ne;0;6;1;7
5947;Pasakaitė;Švyturėlių;5498393070;Ne;0;0;4;4
5948;Pasakaitė;Švyturėlių;9012098645;Ne;0;0;4;4
5949;Pasakaitė;Švyturėlių;1384552110;Taip;0;0;1;1
5950;Pasakaitė;Švyturėlių;4694818333;Ne;0;14;1;15
5951;Pasakaitė;Švyturėlių;5115067331;Ne;0;7;0;7
5952;Pasakaitė;Švyturėlių;6522727154;Ne;0;0;3;3
5953;Pasakaitė;Švyturėlių;4977052991;Ne;0;2;0;2
5954;Pasakaitė;Švyturėlių;7604996145;Ne;21;0;0;21
5955;Pasakaitė;Švyturėlių;4144569088;Ne;0;6;0;6
5956;Pasakaitė;Švyturėlių;8381083251;Ne;0;8;1;9
5957;Pasakaitė;Švyturėlių;9606533767;Ne;6;0;0;6
5958;Pasakaitė;Švyturėlių;2902368705;Ne;6;9;0;15
5959;Pasakaitė;Kodėlčiukų;8662488739;Ne;5;0;1;6
5960;Pasakaitė;Kodėlčiukų;9972985920;Taip;0;3;2;5
5961;Pasakaitė;Kodėlčiukų;5699688792;Ne;1;0;2;3
5962;Pasakaitė;Kodėlčiukų;9441990175;Taip;0;0;6;6
5963;Pasakaitė;Kodėlčiukų;1588525307;Ne;0;2;0;2
5964;Pasakaitė;Kodėlčiukų;4485053261;Ne;5;0;2;7
5965;Pasakaitė;Kodėlčiukų;9351971114;Ne;1;0;2;3
5966;Pasakaitė;Kodėlčiukų;2303884875;Ne;3;0;0;3
5967;Pasakaitė;Kodėlčiukų;9543262464;Ne;6;0;1;7
5968;Pasakaitė;Kodėlčiukų;4878562841;Ne;0;0;4;4
5969;Pasakaitė;Kodėlčiukų;2994653871;Ne;0;0;1;1
5970;Pasakaitė;Kodėlčiukų;4328440534;Ne;0;0;2;2
5971;Pasakaitė;Kodėlčiukų;4881361200;Ne;0;0;2;2
5972;Pasakaitė;Kodėlčiukų;2389832646;Ne;0;5;0;5
5973;Pasakaitė;Kodėlčiukų;7138417196;Ne;0;0;1;1
5974;Pasakaitė;Kodėlčiukų;5581264184;Ne;0;2;0;2
5975;Pasakaitė;Kodėlčiukų;8037316673;Ne;4;0;1;5
5976;Pasakaitė;Kodėlčiukų;5732009054;Ne;0;0;1;1
5977;Pasakaitė;Kodėlčiukų;2407824666;Ne;4;0;1;5
5978;Pasakaitė;Kodėlčiukų;2476010561;Ne;7;0;1;8
5979;Pasakaitė;Kodėlčiukų;3925034196;Ne;7;0;1;8
5980;Pasakaitė;Kodėlčiukų;9512782063;Ne;0;0;2;2
5981;Pasakaitė;Gudručių;1513903341;Ne;0;3;0;3
5982;Pasakaitė;Gudručių;3231283338;Ne;0;2;0;2
5983;Pasakaitė;Gudručių;6736879757;Ne;14;0;0;14
5984;Pasakaitė;Gudručių;2194313054;Taip;1;0;0;1
5985;Pasakaitė;Gudručių;9587489514;Ne;0;0;1;1
5986;Pasakaitė;Gudručių;3444442287;Ne;1;0;2;3
5987;Pasakaitė;Gudručių;3680596008;Ne;0;0;1;1
5988;Pasakaitė;Gudručių;5485965486;Ne;0;6;0;6
5989;Pasakaitė;Gudručių;7685647972;Ne;0;0;1;1
5990;Pasakaitė;Gudručių;5953162958;Ne;0;14;0;14
5991;Pasakaitė;Gudručių;9018830962;Ne;5;3;0;8
5992;Pasakaitė;Gudručių;5948958906;Ne;0;0;1;1
5993;Pasakaitė;Gudručių;1060914693;Ne;6;0;0;6
5994;Pasakaitė;Gudručių;5020801150;Ne;0;0;2;2
5995;Pasakaitė;Gudručių;4864779439;Taip;0;4;1;5
5996;Pasakaitė;Gudručių;1533259056;Ne;0;0;1;1
5997;Pasakaitė;Čiulbonėlių;7526264241;Ne;0;0;8;8
5998;Pasakaitė;Čiulbonėlių;3541877287;Ne;4;0;2;6
5999;Pasakaitė;Čiulbonėlių;4974486850;Ne;0;0;3;3
6000;Pasakaitė;Čiulbonėlių;7607522887;Ne;14;0;0;14
6001;Pasakaitė;Čiulbonėlių;3606601644;Ne;0;2;0;2
6002;Pasakaitė;Čiulbonėlių;3579498202;Ne;8;1;1;10
6003;Pasakaitė;Čiulbonėlių;1220619991;Ne;0;9;1;10
6004;Pasakaitė;Čiulbonėlių;7790937149;Ne;4;0;5;9
6005;Pasakaitė;Čiulbonėlių;3400305768;Ne;4;0;5;9
6006;Pasakaitė;Čiulbonėlių;1619513932;Taip;0;0;2;2
6007;Pasakaitė;Čiulbonėlių;4604843442;Ne;6;3;0;9
6008;Pasakaitė;Čiulbonėlių;1962693480;Ne;0;0;2;2
6009;Pasakaitė;Čiulbonėlių;4758073190;Ne;6;0;1;7
6010;Pasakaitė;Čiulbonėlių;5628746801;Ne;6;0;0;6
6011;Pasakaitė;Čiulbonėlių;6015360076;Ne;0;7;0;7
6012;Pasakaitė;Čiulbonėlių;1056358241;Ne;10;1;0;11
6013;Pasakaitė;Čiulbonėlių;2652882309;Ne;0;0;2;2
6014;Pasakaitė;Čiulbonėlių;1449037968;Ne;5;1;0;6
6015;Pasakaitė;Čiulbonėlių;8463220257;Ne;0;10;0;10
6016;Pasakaitė;Čiulbonėlių;2563725297;Ne;0;0;1;1
6017;Pasakaitė;Čiulbonėlių;3659371923;Ne;0;0;3;3
6018;Pasakaitė;"Verpstelių ";7621306769;Ne;0;7;0;7
6019;Pasakaitė;"Verpstelių ";4946855684;Ne;5;4;0;9
6020;Pasakaitė;"Verpstelių ";5556362727;Ne;0;0;1;1
6021;Pasakaitė;"Verpstelių ";7451624229;Ne;0;0;1;1
6022;Pasakaitė;"Verpstelių ";7759051761;Ne;0;5;0;5
6023;Pasakaitė;"Verpstelių ";1425166722;Ne;6;0;0;6
6024;Pasakaitė;"Verpstelių ";4246461594;Ne;0;0;7;7
6025;Pasakaitė;"Verpstelių ";1963102227;Ne;5;0;2;7
6026;Pasakaitė;"Verpstelių ";8267725352;Ne;0;0;1;1
6027;Pasakaitė;"Verpstelių ";8562284745;Ne;0;3;0;3
6028;Pasakaitė;"Verpstelių ";1041405418;Ne;0;4;0;4
6029;Pasakaitė;"Verpstelių ";7976921380;Ne;3;0;0;3
6030;Pasakaitė;"Verpstelių ";2505815026;Ne;0;0;2;2
6031;Pasakaitė;"Verpstelių ";5413457806;Ne;0;1;0;1
6032;Pasakaitė;"Verpstelių ";1115383380;Ne;5;0;0;5
6033;Pasakaitė;"Verpstelių ";9226989209;Ne;0;3;0;3
6034;Pasakaitė;"Verpstelių ";8927014508;Ne;0;0;4;4
6035;Pasakaitė;Smalsučiai;7994712153;Ne;1;13;3;17
6036;Pasakaitė;Smalsučiai;1271645870;Ne;16;0;0;16
6037;Pasakaitė;Smalsučiai;6266150515;Taip;7;0;1;8
6038;Pasakaitė;Smalsučiai;7193659817;Ne;0;7;0;7
6039;Pasakaitė;Smalsučiai;3359676586;Ne;0;0;2;2
6040;Pasakaitė;Smalsučiai;3041099329;Ne;6;0;0;6
6041;Pasakaitė;Smalsučiai;6446178994;Ne;6;0;0;6
6042;Pasakaitė;Smalsučiai;2301346026;Ne;0;0;1;1
6043;Pasakaitė;Smalsučiai;4413770207;Ne;6;0;0;6
6044;Pasakaitė;Smalsučiai;8181710494;Ne;5;0;3;8
6045;Pasakaitė;"Čiauškučiai ";7585900157;Ne;0;0;3;3
6046;Pasakaitė;"Čiauškučiai ";9335770325;Ne;3;0;0;3
6047;Pasakaitė;"Čiauškučiai ";2780813752;Ne;1;0;0;1
6048;Pasakaitė;"Čiauškučiai ";5202153993;Taip;0;4;0;4
6049;Pasakaitė;"Čiauškučiai ";3329580710;Ne;1;0;0;1
6050;Pasakaitė;"Čiauškučiai ";4189572117;Ne;5;0;0;5
6051;Pasakaitė;"Čiauškučiai ";3931651662;Ne;4;0;0;4
6052;Pasakaitė;"Čiauškučiai ";1400956305;Ne;4;0;0;4
6053;Pasakaitė;"Čiauškučiai ";6756484192;Ne;5;5;0;10
6054;Pasakaitė;"Čiauškučiai ";6033454938;Ne;3;0;0;3
6055;Pasakaitė;"Čiauškučiai ";7118164408;Ne;6;5;0;11
6056;Pasakaitė;"Čiauškučiai ";9823031346;Ne;6;5;0;11
6057;Pasakaitė;"Čiauškučiai ";4852610052;Ne;6;0;0;6
6058;Pasakaitė;Pabiručiai;1453976284;Taip;0;0;7;7
6059;Pasakaitė;Pabiručiai;9790988677;Ne;6;0;0;6
6060;Pasakaitė;Pabiručiai;5439936572;Ne;0;9;2;11
6061;Pasakaitė;Pabiručiai;3466308130;Ne;16;0;1;17
6062;Pasakaitė;Pabiručiai;9402238675;Ne;0;4;0;4
6063;Pasakaitė;Pabiručiai;9285254916;Ne;6;0;2;8
6064;Pasakaitė;Pabiručiai;6025275102;Ne;0;0;3;3
6065;Pasakaitė;Pabiručiai;7902661691;Ne;4;0;0;4
6066;Pasakaitė;Pabiručiai;2398839782;Ne;0;0;3;3
6067;Pasakaitė;Pabiručiai;3552340609;Ne;10;0;0;10
6068;Pasakaitė;Pabiručiai;2332609415;Taip;7;0;0;7
6069;Pasakaitė;Pabiručiai;4081701824;Ne;0;0;11;11
6070;Pasakaitė;Pabiručiai;8340813023;Ne;0;0;3;3
6071;Pasakaitė;Pabiručiai;3070478547;Ne;0;16;0;16
6072;Pasakaitė;Linksmučiai;8252123824;Ne;0;0;5;5
6073;Pasakaitė;Linksmučiai;4444725869;Taip;4;0;0;4
6074;Pasakaitė;Linksmučiai;3049219840;Ne;5;0;0;5
6075;Pasakaitė;Linksmučiai;9190078546;Ne;0;0;4;4
6076;Pasakaitė;Linksmučiai;5274145775;Ne;16;0;0;16
6077;Pasakaitė;Linksmučiai;8399160991;Ne;5;2;0;7
6078;Pasakaitė;Linksmučiai;9690867215;Ne;7;0;3;10
6079;Pasakaitė;Linksmučiai;1117035233;Ne;1;0;1;2
6080;Pasakaitė;Linksmučiai;8055084637;Ne;4;0;2;6
6081;Pasakaitė;Linksmučiai;5058070480;Taip;0;4;0;4
6082;Pasakaitė;Linksmučiai;9311649698;Ne;6;0;0;6
6083;Pasakaitė;Linksmučiai;5499373802;Ne;0;7;0;7
6084;Pasakaitė;Linksmučiai;4307883488;Ne;4;3;0;7
6085;Pasakaitė;Linksmučiai;4120765793;Ne;0;0;2;2
6086;Pasakaitė;Linksmučiai;3691817711;Ne;5;0;0;5
6087;Pelenė;Varpelis;2647876561;Ne;0;4;0;4
6088;Pelenė;Varpelis;8807342148;Ne;10;0;0;10
6089;Pelenė;Varpelis;8239650471;Ne;5;0;0;5
6090;Pelenė;Varpelis;4004975235;Ne;0;1;0;1
6091;Pelenė;Varpelis;8790613872;Ne;0;1;0;1
6092;Pelenė;Varpelis;2487632125;Ne;15;0;0;15
6093;Pelenė;Varpelis;5228983908;Ne;4;0;0;4
6094;Pelenė;Varpelis;3174009848;Ne;5;0;0;5
6095;Pelenė;Varpelis;4373886054;Ne;10;0;0;10
6096;Pelenė;Varpelis;8038559319;Ne;4;0;0;4
6097;Pelenė;Varpelis;7578318198;Ne;0;7;0;7
6098;Pelenė;Varpelis;7164790060;Ne;6;5;0;11
6099;Pelenė;Varpelis;9447223913;Ne;10;0;0;10
6100;Pelenė;Varpelis;6894978459;Ne;11;0;0;11
6101;Pelenė;Varpelis;6864263698;Taip;9;0;0;9
6102;Pelenė;Saulutės;4961852594;Ne;5;0;0;5
6103;Pelenė;Saulutės;8718308575;Ne;0;21;0;21
6104;Pelenė;Saulutės;6867256280;Ne;6;0;0;6
6105;Pelenė;Saulutės;4396011355;Ne;18;0;0;18
6106;Pelenė;Saulutės;9639135363;Ne;0;11;0;11
6107;Pelenė;Saulutės;5743530682;Ne;3;0;0;3
6108;Pelenė;Saulutės;6304818782;Ne;2;1;0;3
6109;Pelenė;Saulutės;1975574464;Ne;4;0;0;4
6110;Pelenė;Saulutės;3549088727;Ne;13;0;0;13
6111;Pelenė;Saulutės;5024793693;Ne;0;1;0;1
6112;Pelenė;Saulutės;2952739501;Ne;7;0;0;7
6113;Pelenė;Saulutės;6567413229;Ne;7;0;0;7
6114;Pelenė;Saulutės;6231387335;Ne;0;17;0;17
6115;Pelenė;Saulutės;4068236246;Ne;1;0;0;1
6116;Pelenė;Saulutės;3700618977;Ne;6;0;0;6
6117;Pelenė;Saulutės;5872711862;Ne;5;0;0;5
6118;Pelenė;Saulutės;6081335781;Ne;0;2;0;2
6119;Pelenė;Saulutės;3060502977;Ne;3;0;0;3
6120;Pelenė;Saulutės;2083848693;Ne;14;0;0;14
6121;Pelenė;Raktelis;4859437855;Ne;0;5;0;5
6122;Pelenė;Raktelis;5028095861;Ne;5;2;0;7
6123;Pelenė;Raktelis;8202196292;Ne;0;1;0;1
6124;Pelenė;Raktelis;5762403752;Ne;0;2;0;2
6125;Pelenė;Raktelis;7926586349;Ne;7;0;0;7
6126;Pelenė;Raktelis;2986690431;Ne;2;0;0;2
6127;Pelenė;Raktelis;4660385383;Ne;8;0;0;8
6128;Pelenė;Raktelis;4305733824;Ne;0;6;0;6
6129;Pelenė;Raktelis;5066227318;Ne;10;0;0;10
6130;Pelenė;Raktelis;8862429244;Taip;7;0;0;7
6131;Pelenė;Raktelis;9505945890;Ne;4;2;0;6
6132;Pelenė;Raktelis;8961082265;Ne;0;1;0;1
6133;Pelenė;Raktelis;2882716674;Ne;1;0;0;1
6134;Pelenė;Raktelis;5970146724;Ne;2;0;0;2
6135;Pelenė;Raktelis;1424479862;Ne;8;0;0;8
6136;Pelenė;Raktelis;1197137607;Ne;6;0;0;6
6137;Pelenė;Žvaigždutės;9473901831;Ne;4;0;0;4
6138;Pelenė;Žvaigždutės;2476080951;Ne;6;0;0;6
6139;Pelenė;Žvaigždutės;5587759166;Ne;1;0;0;1
6140;Pelenė;Žvaigždutės;5548367924;Ne;12;0;0;12
6141;Pelenė;Žvaigždutės;5031778158;Ne;0;5;0;5
6142;Pelenė;Žvaigždutės;4056676361;Ne;5;0;0;5
6143;Pelenė;Žvaigždutės;4602503400;Ne;3;0;0;3
6144;Pelenė;Žvaigždutės;2555464779;Ne;5;0;0;5
6145;Pelenė;Žvaigždutės;9530531472;Ne;5;4;0;9
6146;Pelenė;Žvaigždutės;2040256240;Ne;4;0;0;4
6147;Pelenė;Žvaigždutės;4870187198;Ne;0;5;0;5
6148;Pelenė;Žvaigždutės;7640768043;Ne;4;0;0;4
6149;Pelenė;Žvaigždutės;7614130590;Ne;7;0;0;7
6150;Pelenė;Žvaigždutės;4856039707;Ne;6;1;0;7
6151;Pelenė;Žvaigždutės;5894429453;Ne;6;0;0;6
6152;Pelenė;Žvaigždutės;4109516555;Ne;0;10;0;10
6153;Pelenė;Žvaigždutės;5357701072;Ne;18;0;0;18
6154;Pelenė;Žvaigždutės;7426299485;Ne;8;0;0;8
6155;Pelenė;Žvaigždutės;1136986980;Ne;7;0;0;7
6156;Pelenė;Nykštukas;9195113444;Ne;13;0;0;13
6157;Pelenė;Nykštukas;5749399210;Ne;5;0;0;5
6158;Pelenė;Nykštukas;4448592497;Ne;1;0;0;1
6159;Pelenė;Nykštukas;5333802902;Ne;0;5;0;5
6160;Pelenė;Nykštukas;4591637887;Ne;5;0;0;5
6161;Pelenė;Nykštukas;7088493729;Ne;9;0;0;9
6162;Pelenė;Nykštukas;4090532624;Ne;6;2;0;8
6163;Pelenė;Nykštukas;8123162647;Ne;7;0;0;7
6164;Pelenė;Nykštukas;3573543545;Taip;0;5;0;5
6165;Pelenė;Nykštukas;7659625628;Ne;2;0;0;2
6166;Pelenė;Nykštukas;6375060159;Ne;8;8;0;16
6167;Pelenė;Nykštukas;2210314952;Ne;0;2;0;2
6168;Pelenė;Nykštukas;1049199372;Ne;0;1;0;1
6169;Pelenė;Nykštukas;6007163187;Ne;8;0;0;8
6170;Pelenė;Nykštukas;5063098703;Taip;2;0;0;2
6171;Pelenė;Nykštukas;4089199552;Ne;2;0;0;2
6172;Pelenė;Nykštukas;6038229659;Ne;18;0;0;18
6173;Pelenė;Nykštukas;2241816838;Ne;7;0;0;7
6174;Pelenė;Nykštukas;5389865440;Ne;2;0;0;2
6175;Pelenė;Žirniukai;6699892147;Ne;14;0;0;14
6176;Pelenė;Žirniukai;2270989478;Ne;0;21;0;21
6177;Pelenė;Žirniukai;2590035984;Ne;0;1;0;1
6178;Pelenė;Žirniukai;6046921077;Ne;0;2;0;2
6179;Pelenė;Žirniukai;9601582419;Ne;0;5;0;5
6180;Pelenė;Žirniukai;4703442187;Ne;6;0;0;6
6181;Pelenė;Žirniukai;7959433937;Taip;7;0;0;7
6182;Pelenė;Žirniukai;7057752202;Ne;1;0;0;1
6183;Pelenė;Žirniukai;7399112026;Ne;3;11;0;14
6184;Pelenė;Žirniukai;5686182866;Ne;4;0;0;4
6185;Pelenė;Žirniukai;2443906444;Ne;4;0;0;4
6186;Pelenė;Žirniukai;3863839750;Taip;8;2;0;10
6187;Pelenė;Žirniukai;5922348478;Ne;3;0;0;3
6188;Pelenė;Žirniukai;1313425695;Ne;6;6;0;12
6189;Pelenė;Žirniukai;2068793184;Ne;0;9;0;9
6190;Pelenė;Žirniukai;7383544475;Ne;0;19;0;19
6191;Pelenė;Žirniukai;1595627222;Ne;0;11;0;11
6192;Pelenė;Žirniukai;2438266396;Ne;0;3;0;3
6193;Pelenė;Lašeliai;9018211726;Ne;1;0;0;1
6194;Pelenė;Lašeliai;9313153383;Ne;0;10;0;10
6195;Pelenė;Lašeliai;6316640679;Ne;6;0;0;6
6196;Pelenė;Lašeliai;1711603372;Ne;0;13;0;13
6197;Pelenė;Lašeliai;1944933777;Ne;0;16;0;16
6198;Pelenė;Lašeliai;2303618074;Ne;8;0;0;8
6199;Pelenė;Lašeliai;6167965418;Ne;8;0;0;8
6200;Pelenė;Lašeliai;8841183816;Ne;7;0;0;7
6201;Pelenė;Lašeliai;4431474395;Ne;3;0;0;3
6202;Pelenė;Lašeliai;9097123374;Ne;0;7;0;7
6203;Pelenė;Lašeliai;9162252512;Ne;10;0;0;10
6204;Pelenė;Lašeliai;4695104609;Ne;0;6;0;6
6205;Pelenė;Lašeliai;7148956863;Ne;0;7;0;7
6206;Pelenė;Lašeliai;4148108151;Ne;5;0;0;5
6207;Pelenė;Lašeliai;1303066945;Ne;0;13;0;13
6208;Pelenė;Lašeliai;3563882751;Taip;0;9;0;9
6209;Pelenė;Grūdelis;6221703608;Ne;1;1;0;2
6210;Pelenė;Grūdelis;1278011268;Ne;1;0;0;1
6211;Pelenė;Grūdelis;7880284433;Ne;1;0;0;1
6212;Pelenė;Grūdelis;4989239822;Ne;1;0;0;1
6213;Pelenė;Grūdelis;6481466282;Ne;8;0;0;8
6214;Pelenė;Grūdelis;6267178572;Ne;0;6;0;6
6215;Pelenė;Grūdelis;1468658102;Ne;5;0;0;5
6216;Pelenė;Grūdelis;1573848786;Ne;5;0;0;5
6217;Pelenė;Grūdelis;7985634731;Ne;4;0;0;4
6218;Pelenė;Grūdelis;1555782878;Ne;2;0;0;2
6219;Pelenė;Grūdelis;7858530013;Taip;0;12;0;12
6220;Pelenė;Grūdelis;7702502252;Ne;0;3;0;3
6221;Pelenė;Grūdelis;6678273450;Ne;4;0;0;4
6222;Pelenė;Grūdelis;2544725334;Ne;3;0;0;3
6223;Pelenė;Braškytė;8504675439;Ne;6;0;0;6
6224;Pelenė;Braškytė;6306403720;Ne;0;8;0;8
6225;Pelenė;Braškytė;5243889672;Ne;7;0;0;7
6226;Pelenė;Braškytė;9123459933;Ne;5;2;0;7
6227;Pelenė;Braškytė;2425992275;Ne;2;0;0;2
6228;Pelenė;Braškytė;5215324103;Ne;2;0;0;2
6229;Pelenė;Braškytė;1783529770;Ne;0;2;0;2
6230;Pelenė;Braškytė;6181640181;Ne;9;0;0;9
6231;Pelenė;Braškytė;8977625247;Ne;3;0;0;3
6232;Pelenė;Braškytė;6025404134;Ne;0;6;0;6
6233;Pelenė;Boružėlės;3200796745;Ne;3;0;0;3
6234;Pelenė;Boružėlės;6427008429;Ne;2;0;0;2
6235;Pelenė;Boružėlės;4290709227;Ne;2;0;0;2
6236;Pelenė;Boružėlės;1075220572;Ne;5;0;0;5
6237;Pelenė;Boružėlės;3677861360;Ne;1;0;0;1
6238;Pelenė;Boružėlės;5845118981;Taip;11;0;0;11
6239;Pelenė;Boružėlės;8942422475;Ne;2;0;0;2
6240;Pelenė;Boružėlės;3004297722;Ne;10;0;0;10
6241;Pelenė;Boružėlės;7794147237;Ne;1;0;0;1
6242;Pelenė;Saldainiukai;2689903631;Ne;0;17;0;17
6243;Pelenė;Saldainiukai;4982869687;Ne;1;0;0;1
6244;Pelenė;Saldainiukai;3499827987;Ne;6;0;0;6
6245;Pelenė;Saldainiukai;8165766331;Ne;0;1;0;1
6246;Pelenė;Saldainiukai;2096373376;Ne;15;0;0;15
6247;Pelenė;Saldainiukai;1384382692;Ne;2;17;0;19
6248;Pelenė;Saldainiukai;9490816122;Taip;16;0;0;16
6249;Pelenė;Saldainiukai;4734502322;Ne;12;0;0;12
6250;Pelenė;Saldainiukai;7602432318;Ne;6;0;0;6
6251;Pelenė;Saldainiukai;2407328091;Taip;6;5;0;11
6252;Pelenė;Saldainiukai;8861981715;Ne;7;0;0;7
6253;Pelenė;Saldainiukai;2416490133;Ne;9;0;0;9
6254;Pelenė;Saldainiukai;7599381657;Taip;7;0;0;7
6255;Pelenė;Saldainiukai;7445137950;Ne;2;0;0;2
6256;Pelenė;Saldainiukai;2123466599;Ne;6;0;0;6
6257;Pelenė;Saldainiukai;9290443563;Ne;5;0;0;5
6258;Pelenė;Saldainiukai;2661260892;Ne;17;0;0;17
6259;Pelenė;Drugeliai;2540405047;Ne;10;0;0;10
6260;Pelenė;Drugeliai;3603352172;Ne;9;0;0;9
6261;Pelenė;Drugeliai;5084452088;Ne;0;1;0;1
6262;Pelenė;Drugeliai;9218868317;Ne;5;0;0;5
6263;Pelenė;Drugeliai;2628676128;Ne;0;7;0;7
6264;Pelenė;Drugeliai;6834792589;Ne;0;1;0;1
6265;Pelenė;Drugeliai;9810123679;Ne;0;8;0;8
6266;Pelenė;Drugeliai;1048899958;Ne;1;0;0;1
6267;Pelenė;Drugeliai;3327213856;Ne;0;1;0;1
6268;Pelenė;Drugeliai;6252972353;Ne;6;0;0;6
6269;Pelenė;Drugeliai;1584256570;Ne;2;0;0;2
6270;Pelenė;Drugeliai;3205331614;Ne;7;0;0;7
6271;Pelenė;Drugeliai;2163737781;Ne;0;12;0;12
6272;Pelenė;Drugeliai;9004080625;Ne;4;8;0;12
6273;Pelenė;Drugeliai;7565331966;Taip;4;0;0;4
6274;Pelenė;Drugeliai;5579900958;Ne;8;0;0;8
6275;Pipiras;EŽIUKAI;8520454289;Ne;0;3;0;3
6276;Pipiras;EŽIUKAI;5512049762;Ne;0;2;1;3
6277;Pipiras;EŽIUKAI;5856735452;Taip;2;0;0;2
6278;Pipiras;EŽIUKAI;2267192782;Ne;0;1;0;1
6279;Pipiras;EŽIUKAI;1711168196;Ne;0;1;0;1
6280;Pipiras;EŽIUKAI;5908707752;Ne;6;0;1;7
6281;Pipiras;EŽIUKAI;4017042461;Ne;0;7;0;7
6282;Pipiras;EŽIUKAI;4725221169;Ne;0;4;0;4
6283;Pipiras;EŽIUKAI;8140314304;Ne;0;0;5;5
6284;Pipiras;EŽIUKAI;8422419380;Ne;0;1;0;1
6285;Pipiras;EŽIUKAI;6791495556;Taip;0;3;0;3
6286;Pipiras;EŽIUKAI;4811029230;Taip;3;3;3;9
6287;Pipiras;EŽIUKAI;6363349541;Taip;0;2;0;2
6288;Pipiras;EŽIUKAI;1353114929;Ne;0;3;2;5
6289;Pipiras;BITUTĖS;3851239592;Ne;5;2;0;7
6290;Pipiras;BITUTĖS;1645482584;Ne;5;1;0;6
6291;Pipiras;BITUTĖS;7891664385;Ne;6;0;0;6
6292;Pipiras;BITUTĖS;9050423801;Ne;0;3;0;3
6293;Pipiras;BITUTĖS;3794537946;Ne;1;10;0;11
6294;Pipiras;BITUTĖS;5047070127;Ne;2;0;0;2
6295;Pipiras;BITUTĖS;9394456452;Ne;21;0;0;21
6296;Pipiras;BITUTĖS;7009194986;Ne;8;1;0;9
6297;Pipiras;BITUTĖS;9950318827;Ne;0;1;0;1
6298;Pipiras;BITUTĖS;9733577233;Ne;8;0;0;8
6299;Pipiras;BITUTĖS;2337751973;Ne;0;3;0;3
6300;Pipiras;BITUTĖS;5735018704;Ne;2;0;0;2
6301;Pipiras;BITUTĖS;6306414173;Ne;1;0;0;1
6302;Pipiras;NYKŠTUKAI;6696824728;Taip;7;1;0;8
6303;Pipiras;NYKŠTUKAI;2016718354;Ne;0;3;0;3
6304;Pipiras;NYKŠTUKAI;1169481984;Ne;0;1;6;7
6305;Pipiras;NYKŠTUKAI;4198534687;Ne;0;4;0;4
6306;Pipiras;NYKŠTUKAI;4458730479;Ne;8;3;0;11
6307;Pipiras;NYKŠTUKAI;3980950261;Ne;0;1;0;1
6308;Pipiras;NYKŠTUKAI;7828638329;Ne;0;1;2;3
6309;Pipiras;NYKŠTUKAI;6775489564;Ne;0;0;11;11
6310;Pipiras;NYKŠTUKAI;9892201598;Ne;9;6;0;15
6311;Pipiras;NYKŠTUKAI;7371386368;Ne;0;1;0;1
6312;Pipiras;NYKŠTUKAI;1019753152;Ne;0;7;0;7
6313;Pipiras;NYKŠTUKAI;5141447649;Ne;15;1;0;16
6314;Pipiras;NYKŠTUKAI;9877682150;Ne;0;1;0;1
6315;Pipiras;NYKŠTUKAI;9248925267;Ne;0;7;0;7
6316;Pipiras;NYKŠTUKAI;9711147855;Ne;0;6;0;6
6317;Pipiras;PELĖDŽIUKAI;8985065850;Ne;8;0;3;11
6318;Pipiras;PELĖDŽIUKAI;3647356600;Ne;0;7;0;7
6319;Pipiras;PELĖDŽIUKAI;6465109403;Taip;7;0;0;7
6320;Pipiras;PELĖDŽIUKAI;6905506774;Ne;6;9;0;15
6321;Pipiras;PELĖDŽIUKAI;8040520887;Ne;0;1;0;1
6322;Pipiras;PELĖDŽIUKAI;7446225835;Ne;0;2;0;2
6323;Pipiras;PELĖDŽIUKAI;8800890503;Ne;0;1;0;1
6324;Pipiras;PELĖDŽIUKAI;6184943213;Ne;0;1;0;1
6325;Pipiras;PELĖDŽIUKAI;8028360748;Ne;5;1;0;6
6326;Pipiras;PELĖDŽIUKAI;1238280105;Ne;0;1;0;1
6327;Pipiras;PELĖDŽIUKAI;3299099535;Ne;0;2;0;2
6328;Pipiras;PELĖDŽIUKAI;5502186385;Ne;1;0;1;2
6329;Pipiras;PELĖDŽIUKAI;8707560610;Ne;2;0;0;2
6330;Pipiras;PELĖDŽIUKAI;4940053409;Ne;1;0;1;2
6331;Pipiras;PELĖDŽIUKAI;2588075386;Ne;0;4;0;4
6332;Pipiras;PELĖDŽIUKAI;6666112357;Ne;0;1;0;1
6333;Pipiras;PELĖDŽIUKAI;9473056714;Ne;0;18;0;18
6334;Pipiras;DRUGELIAI;6018174577;Ne;2;0;0;2
6335;Pipiras;DRUGELIAI;1393570307;Ne;12;0;0;12
6336;Pipiras;DRUGELIAI;3216664984;Ne;0;1;0;1
6337;Pipiras;DRUGELIAI;9307622469;Ne;0;5;0;5
6338;Pipiras;DRUGELIAI;6925577945;Ne;0;11;0;11
6339;Pipiras;DRUGELIAI;9639609431;Ne;6;1;0;7
6340;Pipiras;DRUGELIAI;9422467047;Ne;2;5;1;8
6341;Pipiras;DRUGELIAI;4743474665;Ne;16;0;0;16
6342;Pipiras;DRUGELIAI;9552763906;Ne;0;1;0;1
6343;Pipiras;DRUGELIAI;2159315426;Ne;6;1;0;7
6344;Pipiras;DRUGELIAI;8404246568;Ne;5;1;0;6
6345;Pipiras;DRUGELIAI;3641496225;Ne;0;9;1;10
6346;Pipiras;DRUGELIAI;4991725638;Ne;5;0;3;8
6347;Pipiras;DRUGELIAI;7200147039;Ne;10;1;0;11
6348;Pipiras;DRUGELIAI;5035593032;Ne;0;2;0;2
6349;Pipiras;DRUGELIAI;1079088070;Ne;0;2;0;2
6350;Pipiras;GĖLYTĖS;9670710691;Ne;9;0;0;9
6351;Pipiras;GĖLYTĖS;8965139441;Ne;2;1;0;3
6352;Pipiras;GĖLYTĖS;2095794125;Ne;5;0;2;7
6353;Pipiras;GĖLYTĖS;8675473349;Ne;1;0;1;2
6354;Pipiras;GĖLYTĖS;4945164161;Ne;9;4;0;13
6355;Pipiras;GĖLYTĖS;7362002646;Ne;6;0;0;6
6356;Pipiras;GĖLYTĖS;3755824911;Ne;3;1;0;4
6357;Pipiras;GĖLYTĖS;6453274205;Ne;3;1;0;4
6358;Pipiras;GĖLYTĖS;4559954910;Ne;0;14;0;14
6359;Pipiras;GĖLYTĖS;7157187063;Ne;0;12;0;12
6360;Pipiras;GĖLYTĖS;4021613243;Ne;0;2;0;2
6361;Pipiras;GĖLYTĖS;1611488078;Ne;0;1;0;1
6362;Pipiras;GĖLYTĖS;4236597883;Ne;14;0;1;15
6363;Pipiras;GĖLYTĖS;4289497197;Ne;3;0;0;3
6364;Pipiras;GĖLYTĖS;2474548836;Taip;2;1;0;3
6365;Pipiras;GĖLYTĖS;8553422709;Ne;14;0;0;14
6366;Pipiras;GĖLYTĖS;5738334591;Ne;0;7;0;7
6367;Pipiras;GĖLYTĖS;6428525902;Ne;0;2;0;2
6368;Pipiras;GĖLYTĖS;8354158722;Ne;3;0;0;3
6369;Pipiras;BORUŽĖLĖS;9127154444;Taip;0;1;0;1
6370;Pipiras;BORUŽĖLĖS;4707794599;Ne;2;0;0;2
6371;Pipiras;BORUŽĖLĖS;8673271201;Ne;2;0;0;2
6372;Pipiras;BORUŽĖLĖS;5968015502;Ne;0;1;0;1
6373;Pipiras;BORUŽĖLĖS;4086728233;Ne;0;6;0;6
6374;Pipiras;BORUŽĖLĖS;8508292428;Ne;1;2;0;3
6375;Pipiras;BORUŽĖLĖS;1210940213;Ne;0;1;0;1
6376;Pipiras;BORUŽĖLĖS;8260680662;Ne;0;1;0;1
6377;Pipiras;BORUŽĖLĖS;1548928533;Ne;1;0;0;1
6378;Pipiras;BORUŽĖLĖS;9097987789;Taip;0;4;0;4
6379;Pipiras;BORUŽĖLĖS;6310054093;Ne;0;1;0;1
6380;Pipiras;BORUŽĖLĖS;8959946514;Taip;0;4;0;4
6381;Pipiras;BORUŽĖLĖS;8443786510;Ne;0;2;0;2
6382;Pipiras;BORUŽĖLĖS;1146369304;Ne;0;1;0;1
6383;Pipiras;BORUŽĖLĖS;9970587185;Ne;2;0;0;2
6384;Pipiras;BORUŽĖLĖS;6344932171;Ne;0;6;0;6
6385;Pipiras;BORUŽĖLĖS;1550959705;Ne;0;3;0;3
6386;Pipiras;SKRUZDĖLIUKAI;7969837759;Ne;0;1;0;1
6387;Pipiras;SKRUZDĖLIUKAI;1315372873;Ne;0;3;0;3
6388;Pipiras;SKRUZDĖLIUKAI;9372109848;Ne;0;0;6;6
6389;Pipiras;SKRUZDĖLIUKAI;2296702730;Ne;8;0;0;8
6390;Pipiras;SKRUZDĖLIUKAI;3768825314;Ne;7;0;1;8
6391;Pipiras;SKRUZDĖLIUKAI;4309096743;Ne;0;0;2;2
6392;Pipiras;SKRUZDĖLIUKAI;8081343184;Ne;10;0;1;11
6393;Pipiras;SKRUZDĖLIUKAI;9852475056;Ne;2;2;1;5
6394;Pipiras;SKRUZDĖLIUKAI;6176818802;Ne;0;0;2;2
6395;Pipiras;SKRUZDĖLIUKAI;1215623527;Ne;0;1;0;1
6396;Pipiras;SKRUZDĖLIUKAI;9625933545;Ne;0;2;0;2
6397;Pipiras;SKRUZDĖLIUKAI;7211189491;Ne;5;2;1;8
6398;Pipiras;SKRUZDĖLIUKAI;6092576917;Ne;0;0;1;1
6399;Pipiras;ŽVIRBLIUKŲ;6342044341;Ne;0;2;0;2
6400;Pipiras;ŽVIRBLIUKŲ;5725956659;Ne;5;1;0;6
6401;Pipiras;ŽVIRBLIUKŲ;3852848863;Taip;0;1;0;1
6402;Pipiras;ŽVIRBLIUKŲ;9157870634;Ne;0;1;0;1
6403;Pipiras;ŽVIRBLIUKŲ;5235868332;Ne;0;2;0;2
6404;Pipiras;ŽVIRBLIUKŲ;1034182352;Ne;0;9;0;9
6405;Pipiras;ŽVIRBLIUKŲ;2075041950;Ne;0;7;0;7
6406;Pipiras;ŽVIRBLIUKŲ;6792777396;Ne;0;1;0;1
6407;Pipiras;ŽVIRBLIUKŲ;6780333972;Ne;0;3;0;3
6408;Pipiras;ŽVIRBLIUKŲ;5622119207;Ne;0;1;0;1
6409;Pipiras;ŽVIRBLIUKŲ;7934365114;Ne;3;1;0;4
6410;Pipiras;ŽVIRBLIUKŲ;9770780973;Ne;7;1;0;8
6411;Pipiras;ŽVIRBLIUKŲ;5845498558;Ne;0;2;0;2
6412;Pipiras;ŽVIRBLIUKŲ;9840040112;Ne;0;5;0;5
6413;Pipiras;ŽVIRBLIUKŲ;1784839485;Ne;0;7;0;7
6414;Pipiras;ŽVIRBLIUKŲ;7350131214;Ne;2;2;0;4
6415;Pipiras;ZUIKUČIŲ;7202983046;Taip;5;1;0;6
6416;Pipiras;ZUIKUČIŲ;6392620549;Taip;0;1;0;1
6417;Pipiras;ZUIKUČIŲ;5273904507;Ne;10;1;1;12
6418;Pipiras;ZUIKUČIŲ;3779938901;Taip;6;0;0;6
6419;Pipiras;ZUIKUČIŲ;9206586291;Ne;5;0;0;5
6420;Pipiras;ZUIKUČIŲ;1326532597;Ne;1;0;0;1
6421;Pipiras;ZUIKUČIŲ;3759775049;Taip;4;1;0;5
6422;Pipiras;ZUIKUČIŲ;8716061709;Ne;0;1;0;1
6423;Pipiras;ZUIKUČIŲ;6700688846;Ne;0;10;0;10
6424;Pipiras;VARLIUKŲ;8952109131;Ne;0;19;0;19
6425;Pipiras;VARLIUKŲ;1419011066;Ne;3;0;1;4
6426;Pipiras;VARLIUKŲ;3553431200;Taip;6;0;0;6
6427;Pipiras;VARLIUKŲ;3219349754;Ne;1;1;0;2
6428;Pipiras;VARLIUKŲ;1254069142;Taip;0;3;0;3
6429;Pipiras;VARLIUKŲ;5735835403;Ne;0;0;1;1
6430;Pipiras;VARLIUKŲ;1995619760;Ne;2;0;0;2
6431;Pipiras;VARLIUKŲ;8128573827;Ne;5;0;1;6
6432;Pipiras;VARLIUKŲ;6349032299;Ne;6;0;1;7
6433;Pipiras;VARLIUKŲ;7209844964;Ne;0;0;3;3
6434;Pipiras;VARLIUKŲ;7689406983;Ne;5;0;0;5
6435;Pipiras;ŽIOGELIŲ;7510719254;Ne;16;0;0;16
6436;Pipiras;ŽIOGELIŲ;7802812858;Ne;8;0;0;8
6437;Pipiras;ŽIOGELIŲ;8697732892;Ne;9;0;0;9
6438;Pipiras;ŽIOGELIŲ;1466527534;Ne;17;0;0;17
6439;Pipiras;ŽIOGELIŲ;1172225661;Ne;10;1;0;11
6440;Pipiras;ŽIOGELIŲ;3825960148;Ne;11;2;0;13
6441;Pipiras;ŽIOGELIŲ;9747219629;Ne;0;6;0;6
6442;Pipiras;ŽIOGELIŲ;8445608419;Taip;8;0;0;8
6443;Pipiras;ŽIOGELIŲ;6602780166;Ne;8;1;0;9
6444;Pipiras;ŽIOGELIŲ;4229548366;Ne;9;0;1;10
6445;Pipiras;ŽIOGELIŲ;8666908143;Ne;9;0;0;9
6446;Pipiras;ŽIOGELIŲ;4083110785;Ne;0;2;0;2
6447;Pipiras;ŽIOGELIŲ;7011969610;Ne;6;0;0;6
6448;Pipiras;ŽIOGELIŲ;2784222529;Ne;11;0;0;11
6449;Pipiras;ŽIOGELIŲ;3701585967;Ne;10;1;0;11
6450;Pipiras;ŽIOGELIŲ;8852386906;Ne;2;0;0;2
6451;Pipiras;ŽIOGELIŲ;1417118390;Ne;10;1;0;11
6452;Pipiras;ŽIOGELIŲ;8364783015;Ne;7;5;0;12
6453;Pipiras;ŽIOGELIŲ;8351469544;Ne;0;1;0;1
6454;"Prie pasakų parko";ZUIKUČIAI;8493622886;Ne;3;0;0;3
6455;"Prie pasakų parko";ZUIKUČIAI;3998970024;Ne;1;0;0;1
6456;"Prie pasakų parko";ZUIKUČIAI;3907016976;Ne;1;0;0;1
6457;"Prie pasakų parko";ZUIKUČIAI;4904562817;Ne;6;0;0;6
6458;"Prie pasakų parko";ZUIKUČIAI;5394554484;Ne;1;0;0;1
6459;"Prie pasakų parko";ZUIKUČIAI;9707694441;Taip;6;0;0;6
6460;"Prie pasakų parko";ZUIKUČIAI;7220229641;Ne;10;6;0;16
6461;"Prie pasakų parko";ZUIKUČIAI;8616467675;Ne;3;0;0;3
6462;"Prie pasakų parko";ZUIKUČIAI;4183640714;Ne;4;0;0;4
6463;"Prie pasakų parko";ZUIKUČIAI;5326765354;Taip;2;0;0;2
6464;"Prie pasakų parko";PAUKŠČIUKŲ;7330033315;Ne;9;0;0;9
6465;"Prie pasakų parko";PAUKŠČIUKŲ;9061639276;Ne;6;0;0;6
6466;"Prie pasakų parko";PAUKŠČIUKŲ;6601363351;Ne;2;0;1;3
6467;"Prie pasakų parko";PAUKŠČIUKŲ;7693728136;Taip;0;3;0;3
6468;"Prie pasakų parko";PAUKŠČIUKŲ;8627379659;Ne;6;0;0;6
6469;"Prie pasakų parko";PAUKŠČIUKŲ;1644560882;Ne;12;0;0;12
6470;"Prie pasakų parko";PAUKŠČIUKŲ;4643624588;Ne;11;0;0;11
6471;"Prie pasakų parko";PAUKŠČIUKŲ;7349726598;Ne;0;0;2;2
6472;"Prie pasakų parko";PAUKŠČIUKŲ;9571177184;Taip;15;0;0;15
6473;"Prie pasakų parko";PAUKŠČIUKŲ;1435069282;Ne;0;0;5;5
6474;"Prie pasakų parko";"LINKSMOJI ŠEIMYNĖLĖ (SPEC)";7955197522;Ne;0;0;1;1
6475;"Prie pasakų parko";"LINKSMOJI ŠEIMYNĖLĖ (SPEC)";2077861244;Ne;0;0;7;7
6476;"Prie pasakų parko";"LINKSMOJI ŠEIMYNĖLĖ (SPEC)";1427487116;Ne;0;0;1;1
6477;"Prie pasakų parko";"LINKSMOJI ŠEIMYNĖLĖ (SPEC)";4895744524;Ne;0;0;6;6
6478;"Prie pasakų parko";NYKŠTUKŲ;2287711014;Ne;0;0;1;1
6479;"Prie pasakų parko";NYKŠTUKŲ;6491435655;Ne;6;5;0;11
6480;"Prie pasakų parko";NYKŠTUKŲ;1743429440;Ne;0;3;0;3
6481;"Prie pasakų parko";NYKŠTUKŲ;7739970115;Ne;7;0;2;9
6482;"Prie pasakų parko";NYKŠTUKŲ;6700916147;Ne;5;0;2;7
6483;"Prie pasakų parko";NYKŠTUKŲ;6733793491;Taip;7;6;0;13
6484;"Prie pasakų parko";NYKŠTUKŲ;2515928623;Ne;2;0;0;2
6485;"Prie pasakų parko";NYKŠTUKŲ;4726737519;Taip;3;0;1;4
6486;"Prie pasakų parko";NYKŠTUKŲ;2661900328;Ne;0;0;2;2
6487;"Prie pasakų parko";NYKŠTUKŲ;3202292611;Ne;0;0;1;1
6488;"Prie pasakų parko";NYKŠTUKŲ;4457827262;Ne;4;0;1;5
6489;"Prie pasakų parko";NYKŠTUKŲ;6171021539;Ne;0;0;1;1
6490;"Prie pasakų parko";NYKŠTUKŲ;4860316199;Ne;8;0;0;8
6491;"Prie pasakų parko";NYKŠTUKŲ;3907578461;Ne;4;0;0;4
6492;"Prie pasakų parko";NYKŠTUKŲ;9784398441;Ne;8;0;1;9
6493;"Prie pasakų parko";NYKŠTUKŲ;9550985822;Ne;0;1;0;1
6494;"Prie pasakų parko";LAŠELIŲ;8574432191;Ne;0;0;1;1
6495;"Prie pasakų parko";LAŠELIŲ;4181676762;Ne;0;5;0;5
6496;"Prie pasakų parko";LAŠELIŲ;4548803933;Ne;1;0;0;1
6497;"Prie pasakų parko";LAŠELIŲ;6250610187;Ne;3;1;0;4
6498;"Prie pasakų parko";LAŠELIŲ;2216634402;Ne;8;0;0;8
6499;"Prie pasakų parko";LAŠELIŲ;2731544174;Ne;6;0;0;6
6500;"Prie pasakų parko";LAŠELIŲ;8339335908;Ne;2;0;0;2
6501;"Prie pasakų parko";LAŠELIŲ;2350325153;Ne;0;0;1;1
6502;"Prie pasakų parko";LAŠELIŲ;7390391804;Ne;0;0;1;1
6503;"Prie pasakų parko";LAŠELIŲ;6762267582;Ne;4;0;2;6
6504;"Prie pasakų parko";LAŠELIŲ;9072312203;Ne;5;0;0;5
6505;"Prie pasakų parko";LAŠELIŲ;2952868428;Ne;6;11;0;17
6506;"Prie pasakų parko";LAŠELIŲ;5159105661;Ne;11;0;0;11
6507;"Prie pasakų parko";LAŠELIŲ;3436003531;Ne;0;1;0;1
6508;"Prie pasakų parko";LAŠELIŲ;6074218082;Ne;1;0;0;1
6509;"Prie pasakų parko";"KAČIUKAI (SPEC)";6772736175;Ne;7;0;1;8
6510;"Prie pasakų parko";"KAČIUKAI (SPEC)";5847625697;Ne;2;0;7;9
6511;"Prie pasakų parko";"KAČIUKAI (SPEC)";2590693851;Ne;0;0;1;1
6512;"Prie pasakų parko";"KAČIUKAI (SPEC)";3949671257;Taip;0;0;1;1
6513;"Prie pasakų parko";"KAČIUKAI (SPEC)";2583331243;Ne;0;0;1;1
6514;"Prie pasakų parko";"KAČIUKAI (SPEC)";1370201372;Ne;0;6;1;7
6515;"Prie pasakų parko";"KAČIUKAI (SPEC)";8056265378;Ne;0;2;3;5
6516;"Prie pasakų parko";"KAČIUKAI (SPEC)";5594531224;Ne;0;0;2;2
6517;"Prie pasakų parko";"KAČIUKAI (SPEC)";1618225282;Ne;0;0;2;2
6518;"Prie pasakų parko";"ŽVAIGŽDUTĖS  (SPEC)";7216751216;Ne;13;0;2;15
6519;"Prie pasakų parko";"ŽVAIGŽDUTĖS  (SPEC)";5006152810;Ne;6;0;0;6
6520;"Prie pasakų parko";"ŽVAIGŽDUTĖS  (SPEC)";6989235061;Ne;5;0;4;9
6521;"Prie pasakų parko";"ŽVAIGŽDUTĖS  (SPEC)";5009168398;Ne;1;0;1;2
6522;"Prie pasakų parko";"ŽVAIGŽDUTĖS  (SPEC)";6585504578;Taip;8;0;2;10
6523;"Prie pasakų parko";"ŽVAIGŽDUTĖS  (SPEC)";1621710265;Ne;3;0;0;3
6524;"Prie pasakų parko";"ŽVAIGŽDUTĖS  (SPEC)";8203595449;Ne;7;0;9;16
6525;"Prie pasakų parko";"ŽVAIGŽDUTĖS  (SPEC)";7476984763;Ne;7;0;2;9
6526;"Prie pasakų parko";"ŽVAIGŽDUTĖS  (SPEC)";7449993309;Ne;9;0;3;12
6527;"Prie pasakų parko";"ANČIUKAI (SPEC)";6802898184;Ne;5;10;0;15
6528;"Prie pasakų parko";"ANČIUKAI (SPEC)";9529949992;Ne;4;0;1;5
6529;"Prie pasakų parko";"ANČIUKAI (SPEC)";4309482351;Ne;12;0;3;15
6530;"Prie pasakų parko";"ANČIUKAI (SPEC)";7200571639;Ne;0;0;2;2
6531;"Prie pasakų parko";"ANČIUKAI (SPEC)";2047018335;Ne;2;0;3;5
6532;"Prie pasakų parko";"ANČIUKAI (SPEC)";2731902356;Ne;0;0;4;4
6533;"Prie pasakų parko";"ANČIUKAI (SPEC)";5627477370;Ne;6;0;3;9
6534;"Prie pasakų parko";"ANČIUKAI (SPEC)";9999109437;Ne;7;0;0;7
6535;"Prie pasakų parko";TIGRIUKAI;3918269702;Taip;0;0;7;7
6536;"Prie pasakų parko";TIGRIUKAI;6446562388;Ne;5;2;0;7
6537;"Prie pasakų parko";TIGRIUKAI;2168919559;Ne;0;9;0;9
6538;"Prie pasakų parko";TIGRIUKAI;9476448601;Ne;0;11;0;11
6539;"Prie pasakų parko";TIGRIUKAI;8029428034;Ne;0;1;0;1
6540;"Prie pasakų parko";TIGRIUKAI;8715851643;Ne;4;6;1;11
6541;"Prie pasakų parko";TIGRIUKAI;1704679306;Ne;0;0;1;1
6542;"Prie pasakų parko";TIGRIUKAI;7776961789;Ne;0;0;3;3
6543;"Prie pasakų parko";TIGRIUKAI;3373275644;Ne;0;4;0;4
6544;"Prie pasakų parko";TIGRIUKAI;5518041213;Taip;0;2;1;3
6545;"Prie pasakų parko";TIGRIUKAI;8738488104;Taip;0;2;1;3
6546;"Prie pasakų parko";TIGRIUKAI;8406002339;Ne;0;0;1;1
6547;"Prie pasakų parko";TIGRIUKAI;8685140364;Taip;0;14;7;21
6548;"Prie pasakų parko";TIGRIUKAI;6606867989;Ne;0;0;1;1
6549;"Prie pasakų parko";TIGRIUKAI;6784471792;Ne;0;2;0;2
6550;"Prie pasakų parko";TIGRIUKAI;8338549157;Ne;0;0;1;1
6551;"Prie pasakų parko";"EŽIUKŲ (SPEC)";5944113879;Ne;11;0;0;11
6552;"Prie pasakų parko";"EŽIUKŲ (SPEC)";4950143153;Ne;0;0;2;2
6553;"Prie pasakų parko";"EŽIUKŲ (SPEC)";4799789212;Taip;0;0;1;1
6554;"Prie pasakų parko";"EŽIUKŲ (SPEC)";5834070970;Ne;15;0;1;16
6555;"Prie pasakų parko";"EŽIUKŲ (SPEC)";3579773269;Ne;1;0;1;2
6556;"Prie pasakų parko";"EŽIUKŲ (SPEC)";7313963137;Ne;3;0;0;3
6557;"Prie pasakų parko";"EŽIUKŲ (SPEC)";6627809171;Ne;0;0;1;1
6558;"Prie pasakų parko";"BORUŽIUKŲ (SPEC)";9715586563;Ne;0;0;10;10
6559;"Prie pasakų parko";"BORUŽIUKŲ (SPEC)";2104412442;Ne;0;0;6;6
6560;"Prie pasakų parko";"BORUŽIUKŲ (SPEC)";6051760219;Ne;0;0;2;2
6561;"Prie pasakų parko";"BORUŽIUKŲ (SPEC)";5821107898;Ne;0;0;2;2
6562;"Prie pasakų parko";SAULYTĖS;4351705573;Ne;6;0;0;6
6563;"Prie pasakų parko";SAULYTĖS;4827245401;Ne;3;0;0;3
6564;"Prie pasakų parko";SAULYTĖS;5039094555;Ne;4;0;1;5
6565;"Prie pasakų parko";SAULYTĖS;4580377882;Ne;4;0;1;5
6566;"Prie pasakų parko";SAULYTĖS;9464727980;Ne;3;0;0;3
6567;"Prie pasakų parko";SAULYTĖS;8621403184;Ne;1;0;3;4
6568;"Prie pasakų parko";SAULYTĖS;6955061957;Ne;1;0;2;3
6569;"Prie pasakų parko";SAULYTĖS;1096237210;Ne;15;0;2;17
6570;"Prie pasakų parko";SAULYTĖS;2088585478;Ne;0;0;5;5
6571;"Pumpurėlis (Kalvarijų g. 186)";RAMUNĖLIŲ;9052267552;Ne;0;1;0;1
6572;"Pumpurėlis (Kalvarijų g. 186)";RAMUNĖLIŲ;9372725707;Ne;0;1;0;1
6573;"Pumpurėlis (Kalvarijų g. 186)";RAMUNĖLIŲ;2715059752;Ne;1;0;1;2
6574;"Pumpurėlis (Kalvarijų g. 186)";RAMUNĖLIŲ;4249039048;Ne;11;6;1;18
6575;"Pumpurėlis (Kalvarijų g. 186)";RAMUNĖLIŲ;1082775039;Ne;7;0;0;7
6576;"Pumpurėlis (Kalvarijų g. 186)";RAMUNĖLIŲ;6982600785;Ne;0;0;3;3
6577;"Pumpurėlis (Kalvarijų g. 186)";RAMUNĖLIŲ;1667602636;Ne;12;0;0;12
6578;"Pumpurėlis (Kalvarijų g. 186)";RAMUNĖLIŲ;8212403350;Ne;0;0;3;3
6579;"Pumpurėlis (Kalvarijų g. 186)";RAMUNĖLIŲ;6795405194;Ne;0;0;3;3
6580;"Pumpurėlis (Kalvarijų g. 186)";RAMUNĖLIŲ;7443152469;Ne;0;0;21;21
6581;"Pumpurėlis (Kalvarijų g. 186)";RAMUNĖLIŲ;9306426978;Ne;0;0;2;2
6582;"Pumpurėlis (Kalvarijų g. 186)";RAMUNĖLIŲ;8458676611;Taip;11;0;1;12
6583;"Pumpurėlis (Kalvarijų g. 186)";RAMUNĖLIŲ;1856558407;Ne;0;0;2;2
6584;"Pumpurėlis (Kalvarijų g. 186)";RAMUNĖLIŲ;7002569226;Ne;0;0;2;2
6585;"Pumpurėlis (Kalvarijų g. 186)";RAMUNĖLIŲ;1189960583;Ne;5;1;3;9
6586;"Pumpurėlis (Kalvarijų g. 186)";VARPELIŲ;5326000400;Ne;14;6;0;20
6587;"Pumpurėlis (Kalvarijų g. 186)";VARPELIŲ;7998027741;Taip;3;0;1;4
6588;"Pumpurėlis (Kalvarijų g. 186)";VARPELIŲ;9395698760;Taip;0;1;6;7
6589;"Pumpurėlis (Kalvarijų g. 186)";VARPELIŲ;9478685443;Ne;3;0;0;3
6590;"Pumpurėlis (Kalvarijų g. 186)";VARPELIŲ;9903981454;Ne;3;0;2;5
6591;"Pumpurėlis (Kalvarijų g. 186)";VARPELIŲ;6647331393;Ne;5;0;3;8
6592;"Pumpurėlis (Kalvarijų g. 186)";VARPELIŲ;3537534154;Ne;0;1;0;1
6593;"Pumpurėlis (Kalvarijų g. 186)";VARPELIŲ;3001331278;Ne;6;0;0;6
6594;"Pumpurėlis (Kalvarijų g. 186)";VARPELIŲ;9735493140;Ne;10;0;0;10
6595;"Pumpurėlis (Kalvarijų g. 186)";VARPELIŲ;3964441086;Ne;11;1;0;12
6596;"Pumpurėlis (Kalvarijų g. 186)";VARPELIŲ;8550119831;Taip;21;0;0;21
6597;"Pumpurėlis (Kalvarijų g. 186)";VARPELIŲ;4245270154;Ne;0;0;1;1
6598;"Pumpurėlis (Kalvarijų g. 186)";VARPELIŲ;6860128064;Ne;0;0;2;2
6599;"Pumpurėlis (Kalvarijų g. 186)";VARPELIŲ;2282966743;Ne;0;1;0;1
6600;"Pumpurėlis (Kalvarijų g. 186)";VARPELIŲ;5968577443;Ne;6;0;1;7
6601;"Pumpurėlis (Kalvarijų g. 186)";VARPELIŲ;8083674991;Ne;12;0;0;12
6602;"Pumpurėlis (Kalvarijų g. 186)";VARPELIŲ;6422203618;Ne;0;1;0;1
6603;"Pumpurėlis (Kalvarijų g. 186)";VARPELIŲ;1782842327;Ne;13;0;0;13
6604;"Pumpurėlis (Kalvarijų g. 186)";VARPELIŲ;9750242149;Taip;12;0;0;12
6605;"Pumpurėlis (Kalvarijų g. 186)";VARPELIŲ;5420222684;Ne;0;1;0;1
6606;"Pumpurėlis (Kalvarijų g. 186)";DRUGELIŲ;5928552565;Taip;0;0;2;2
6607;"Pumpurėlis (Kalvarijų g. 186)";DRUGELIŲ;7055989095;Ne;0;16;0;16
6608;"Pumpurėlis (Kalvarijų g. 186)";DRUGELIŲ;7078621340;Ne;0;2;0;2
6609;"Pumpurėlis (Kalvarijų g. 186)";DRUGELIŲ;2368226822;Ne;0;0;3;3
6610;"Pumpurėlis (Kalvarijų g. 186)";DRUGELIŲ;3088476130;Ne;5;0;3;8
6611;"Pumpurėlis (Kalvarijų g. 186)";DRUGELIŲ;9640790401;Taip;0;0;7;7
6612;"Pumpurėlis (Kalvarijų g. 186)";DRUGELIŲ;7832408524;Ne;6;0;1;7
6613;"Pumpurėlis (Kalvarijų g. 186)";DRUGELIŲ;8644853849;Ne;8;0;2;10
6614;"Pumpurėlis (Kalvarijų g. 186)";DRUGELIŲ;9417688597;Ne;2;0;2;4
6615;"Pumpurėlis (Kalvarijų g. 186)";DRUGELIŲ;9032255874;Ne;0;0;5;5
6616;"Pumpurėlis (Kalvarijų g. 186)";DRUGELIŲ;9996789041;Ne;0;0;3;3
6617;"Pumpurėlis (Kalvarijų g. 186)";DRUGELIŲ;2684592319;Ne;2;0;0;2
6618;"Pumpurėlis (Kalvarijų g. 186)";DRUGELIŲ;5835115428;Ne;1;0;1;2
6619;"Pumpurėlis (Kalvarijų g. 186)";DRUGELIŲ;2132563531;Ne;1;0;0;1
6620;"Pumpurėlis (Kalvarijų g. 186)";DRUGELIŲ;4506063812;Ne;5;4;1;10
6621;"Pumpurėlis (Kalvarijų g. 186)";DRUGELIŲ;2165141865;Ne;12;0;0;12
6622;"Pumpurėlis (Kalvarijų g. 186)";DRUGELIŲ;8671697745;Ne;0;0;1;1
6623;"Pumpurėlis (Kalvarijų g. 186)";DRUGELIŲ;3187815703;Ne;5;0;7;12
6624;"Pumpurėlis (Kalvarijų g. 186)";KODĖLČIUKŲ;8214602054;Taip;8;0;1;9
6625;"Pumpurėlis (Kalvarijų g. 186)";KODĖLČIUKŲ;9654958302;Ne;0;1;0;1
6626;"Pumpurėlis (Kalvarijų g. 186)";KODĖLČIUKŲ;5564844211;Ne;12;0;1;13
6627;"Pumpurėlis (Kalvarijų g. 186)";KODĖLČIUKŲ;1215117598;Ne;8;0;0;8
6628;"Pumpurėlis (Kalvarijų g. 186)";KODĖLČIUKŲ;6978091765;Ne;12;0;2;14
6629;"Pumpurėlis (Kalvarijų g. 186)";KODĖLČIUKŲ;6433757421;Ne;3;5;0;8
6630;"Pumpurėlis (Kalvarijų g. 186)";KODĖLČIUKŲ;3328647987;Ne;1;0;0;1
6631;"Pumpurėlis (Kalvarijų g. 186)";KODĖLČIUKŲ;3748601124;Ne;6;1;0;7
6632;"Pumpurėlis (Kalvarijų g. 186)";KODĖLČIUKŲ;6004234378;Ne;0;0;1;1
6633;"Pumpurėlis (Kalvarijų g. 186)";KODĖLČIUKŲ;4196409137;Ne;1;0;0;1
6634;"Pumpurėlis (Kalvarijų g. 186)";KODĖLČIUKŲ;6117720533;Ne;2;0;0;2
6635;"Pumpurėlis (Kalvarijų g. 186)";KODĖLČIUKŲ;8070486897;Ne;8;0;1;9
6636;"Pumpurėlis (Kalvarijų g. 186)";KODĖLČIUKŲ;3534133061;Ne;3;2;0;5
6637;"Pumpurėlis (Kalvarijų g. 186)";KODĖLČIUKŲ;2611141763;Ne;2;0;0;2
6638;"Pumpurėlis (Kalvarijų g. 186)";KODĖLČIUKŲ;2307819108;Ne;0;0;1;1
6639;"Pumpurėlis (Kalvarijų g. 186)";KODĖLČIUKŲ;9650395309;Ne;6;5;0;11
6640;"Pumpurėlis (Kalvarijų g. 186)";KODĖLČIUKŲ;6702744879;Ne;2;0;0;2
6641;"Pumpurėlis (Kalvarijų g. 186)";KODĖLČIUKŲ;9839285886;Taip;11;0;0;11
6642;"Pumpurėlis (Kalvarijų g. 186)";LINELIS;6780042929;Ne;6;5;0;11
6643;"Pumpurėlis (Kalvarijų g. 186)";LINELIS;7610949816;Ne;0;2;0;2
6644;"Pumpurėlis (Kalvarijų g. 186)";LINELIS;8667762689;Ne;0;3;0;3
6645;"Pumpurėlis (Kalvarijų g. 186)";LINELIS;3953103488;Taip;0;1;0;1
6646;"Pumpurėlis (Kalvarijų g. 186)";LINELIS;9431295796;Ne;0;2;0;2
6647;"Pumpurėlis (Kalvarijų g. 186)";LINELIS;3838705973;Ne;1;4;0;5
6648;"Pumpurėlis (Kalvarijų g. 186)";LINELIS;1395380236;Ne;2;1;0;3
6649;"Pumpurėlis (Kalvarijų g. 186)";LINELIS;9424449290;Ne;11;0;0;11
6650;"Pumpurėlis (Kalvarijų g. 186)";LINELIS;6955168163;Ne;6;0;0;6
6651;"Pumpurėlis (Kalvarijų g. 186)";LINELIS;5171198109;Ne;10;0;0;10
6652;"Pumpurėlis (Kalvarijų g. 186)";LINELIS;7229289985;Ne;6;0;0;6
6653;"Pumpurėlis (Kalvarijų g. 186)";LINELIS;7619709360;Ne;0;1;0;1
6654;"Pumpurėlis (Kalvarijų g. 186)";LINELIS;6726875853;Ne;8;3;0;11
6655;"Pumpurėlis (Kalvarijų g. 186)";LINELIS;7559071945;Ne;0;1;0;1
6656;"Pumpurėlis (Kalvarijų g. 186)";SAULUTĖS;7182107790;Taip;0;0;3;3
6657;"Pumpurėlis (Kalvarijų g. 186)";SAULUTĖS;3101133244;Ne;6;1;0;7
6658;"Pumpurėlis (Kalvarijų g. 186)";SAULUTĖS;5023658988;Ne;0;1;3;4
6659;"Pumpurėlis (Kalvarijų g. 186)";SAULUTĖS;2668855786;Ne;2;1;3;6
6660;"Pumpurėlis (Kalvarijų g. 186)";SAULUTĖS;9612924972;Ne;2;0;1;3
6661;"Pumpurėlis (Kalvarijų g. 186)";SAULUTĖS;9884099545;Taip;10;0;0;10
6662;"Pumpurėlis (Kalvarijų g. 186)";SAULUTĖS;3733509497;Ne;0;0;1;1
6663;"Pumpurėlis (Kalvarijų g. 186)";SAULUTĖS;9224879966;Ne;0;1;3;4
6664;"Pumpurėlis (Kalvarijų g. 186)";SAULUTĖS;5564680653;Ne;0;0;2;2
6665;"Pumpurėlis (Kalvarijų g. 186)";SAULUTĖS;1411232443;Ne;1;4;2;7
6666;"Pumpurėlis (Kalvarijų g. 186)";SAULUTĖS;5196733185;Ne;0;0;1;1
6667;"Pumpurėlis (Kalvarijų g. 186)";SAULUTĖS;4629544683;Ne;0;9;0;9
6668;"Pumpurėlis (Kalvarijų g. 186)";BITUTĖS;4419940231;Ne;11;4;0;15
6669;"Pumpurėlis (Kalvarijų g. 186)";BITUTĖS;4985045047;Taip;1;0;1;2
6670;"Pumpurėlis (Kalvarijų g. 186)";BITUTĖS;2651037375;Ne;2;0;0;2
6671;"Pumpurėlis (Kalvarijų g. 186)";BITUTĖS;1768239820;Ne;4;0;3;7
6672;"Pumpurėlis (Kalvarijų g. 186)";BITUTĖS;2566557351;Taip;0;3;7;10
6673;"Pumpurėlis (Kalvarijų g. 186)";BITUTĖS;4426697956;Taip;2;0;0;2
6674;"Pumpurėlis (Kalvarijų g. 186)";BITUTĖS;7363814444;Ne;4;7;4;15
6675;"Pumpurėlis (Kalvarijų g. 186)";BITUTĖS;3405169131;Ne;0;0;3;3
6676;"Pumpurėlis (Kalvarijų g. 186)";BITUTĖS;3951445693;Ne;5;0;4;9
6677;"Pumpurėlis (Kalvarijų g. 186)";BITUTĖS;9612924316;Ne;0;2;0;2
6678;"Pumpurėlis (Kalvarijų g. 186)";BITUTĖS;1714440337;Ne;0;0;3;3
6679;"Pumpurėlis (Kalvarijų g. 186)";BITUTĖS;8655389224;Ne;0;0;1;1
6680;"Pumpurėlis (Kalvarijų g. 186)";BITUTĖS;1674341906;Taip;0;1;0;1
6681;"Pumpurėlis (Kalvarijų g. 186)";BITUTĖS;3842632260;Ne;0;5;2;7
6682;"Pumpurėlis (Kalvarijų g. 186)";BITUTĖS;2230191718;Ne;2;0;1;3
6683;"Pumpurėlis (Kalvarijų g. 186)";BITUTĖS;7062090879;Ne;4;0;1;5
6684;"Pumpurėlis (Kalvarijų g. 186)";BITUTĖS;9245739052;Ne;5;0;2;7
6685;"Pumpurėlis (Kalvarijų g. 186)";BITUTĖS;8470433743;Ne;12;0;2;14
6686;"Pumpurėlis (Kalvarijų g. 186)";BITUTĖS;6474918016;Ne;0;7;0;7
6687;"Pumpurėlis (Kalvarijų g. 186)";DOBILIUKAI;9179780392;Ne;0;3;0;3
6688;"Pumpurėlis (Kalvarijų g. 186)";DOBILIUKAI;1839505206;Ne;0;2;0;2
6689;"Pumpurėlis (Kalvarijų g. 186)";DOBILIUKAI;3970253545;Ne;0;0;1;1
6690;"Pumpurėlis (Kalvarijų g. 186)";DOBILIUKAI;1808734330;Ne;0;1;0;1
6691;"Pumpurėlis (Kalvarijų g. 186)";DOBILIUKAI;6968264923;Ne;0;6;0;6
6692;"Pumpurėlis (Kalvarijų g. 186)";DOBILIUKAI;2700017433;Ne;4;0;0;4
6693;"Pumpurėlis (Kalvarijų g. 186)";DOBILIUKAI;7038597556;Ne;0;12;0;12
6694;"Pumpurėlis (Kalvarijų g. 186)";DOBILIUKAI;4130539703;Ne;0;4;0;4
6695;"Pumpurėlis (Kalvarijų g. 186)";DOBILIUKAI;6307988067;Ne;0;11;0;11
6696;"Pumpurėlis (Kalvarijų g. 186)";DOBILIUKAI;3374174445;Ne;0;3;0;3
6697;"Pumpurėlis (Kalvarijų g. 186)";DOBILIUKAI;3398517047;Ne;4;0;0;4
6698;"Pumpurėlis (Kalvarijų g. 186)";DOBILIUKAI;1961282282;Ne;0;0;3;3
6699;"Pumpurėlis (Kalvarijų g. 186)";DOBILIUKAI;7276322999;Ne;5;0;0;5
6700;"Pumpurėlis (Kalvarijų g. 186)";DOBILIUKAI;3214652626;Ne;1;0;1;2
6701;"Pumpurėlis (Kalvarijų g. 186)";DOBILIUKAI;5444879430;Taip;5;1;0;6
6702;"Pumpurėlis (Kalvarijų g. 186)";DOBILIUKAI;7825190756;Ne;5;0;0;5
6703;"Pumpurėlis (Kalvarijų g. 186)";DOBILIUKAI;1438740562;Ne;5;0;0;5
6704;"Pumpurėlis (Kalvarijų g. 186)";DOBILIUKAI;9740660699;Ne;10;2;0;12
6705;"Pumpurėlis (Kalvarijų g. 186)";PUPYČIŲ;9317274035;Ne;9;0;0;9
6706;"Pumpurėlis (Kalvarijų g. 186)";PUPYČIŲ;1555441484;Ne;9;0;0;9
6707;"Pumpurėlis (Kalvarijų g. 186)";PUPYČIŲ;5238756058;Ne;5;0;6;11
6708;"Pumpurėlis (Kalvarijų g. 186)";PUPYČIŲ;1945615416;Ne;0;0;4;4
6709;"Pumpurėlis (Kalvarijų g. 186)";PUPYČIŲ;3131907007;Ne;0;0;2;2
6710;"Pumpurėlis (Kalvarijų g. 186)";PUPYČIŲ;5384176825;Ne;0;0;3;3
6711;"Pumpurėlis (Kalvarijų g. 186)";PUPYČIŲ;5228548329;Ne;0;0;1;1
6712;"Pumpurėlis (Kalvarijų g. 186)";PUPYČIŲ;9789187163;Ne;0;0;1;1
6713;"Pumpurėlis (Kalvarijų g. 186)";PUPYČIŲ;7114896633;Ne;0;0;5;5
6714;"Pumpurėlis (Kalvarijų g. 186)";PUPYČIŲ;4133819653;Ne;0;0;9;9
6715;"Pumpurėlis (Kalvarijų g. 186)";PUPYČIŲ;8215233820;Ne;0;6;14;20
6716;"Pumpurėlis (Kalvarijų g. 186)";PUPYČIŲ;1413673339;Ne;6;0;2;8
6717;"Pumpurėlis (Kalvarijų g. 186)";PUPYČIŲ;9164586359;Ne;2;0;3;5
6718;"Pumpurėlis (Kalvarijų g. 186)";PUPYČIŲ;9316908064;Ne;2;0;3;5
6719;"Pumpurėlis (Kalvarijų g. 186)";PUPYČIŲ;1082943651;Ne;3;0;1;4
6720;"Pumpurėlis (Kalvarijų g. 186)";ŽIRNIUKŲ;4198532140;Ne;1;0;0;1
6721;"Pumpurėlis (Kalvarijų g. 186)";ŽIRNIUKŲ;6162279957;Ne;11;0;0;11
6722;"Pumpurėlis (Kalvarijų g. 186)";ŽIRNIUKŲ;6602860291;Ne;2;0;3;5
6723;"Pumpurėlis (Kalvarijų g. 186)";ŽIRNIUKŲ;6535225429;Ne;10;0;10;20
6724;"Pumpurėlis (Kalvarijų g. 186)";ŽIRNIUKŲ;6606861732;Ne;4;0;0;4
6725;"Pumpurėlis (Kalvarijų g. 186)";ŽIRNIUKŲ;8057222613;Ne;6;0;0;6
6726;"Pumpurėlis (Kalvarijų g. 186)";ŽIRNIUKŲ;9704396561;Ne;0;0;20;20
6727;"Pumpurėlis (Kalvarijų g. 186)";ŽIRNIUKŲ;9033360796;Ne;0;0;20;20
6728;"Pumpurėlis (Kalvarijų g. 186)";ŽIRNIUKŲ;3438212768;Ne;5;0;0;5
6729;"Pumpurėlis (Kalvarijų g. 186)";ŽIRNIUKŲ;4686840292;Ne;0;0;2;2
6730;"Pumpurėlis (Kalvarijų g. 186)";ŽIRNIUKŲ;4195060928;Ne;6;0;0;6
6731;"Pumpurėlis (Kalvarijų g. 186)";ŽIRNIUKŲ;3966128737;Ne;6;10;0;16
6732;"Pumpurėlis (Kalvarijų g. 186)";ŽIRNIUKŲ;4446088965;Ne;9;0;0;9
6733;"Pumpurėlis (Kalvarijų g. 186)";ŽIRNIUKŲ;5765942106;Ne;8;0;0;8
6734;"Pumpurėlis (Kalvarijų g. 186)";ŽIRNIUKŲ;8978637291;Taip;7;0;0;7
6735;"Pumpurėlis (Kalvarijų g. 186)";BORUŽĖLIŲ;2269864490;Ne;15;0;1;16
6736;"Pumpurėlis (Kalvarijų g. 186)";BORUŽĖLIŲ;6223338814;Ne;0;0;2;2
6737;"Pumpurėlis (Kalvarijų g. 186)";BORUŽĖLIŲ;5998858670;Ne;7;0;1;8
6738;"Pumpurėlis (Kalvarijų g. 186)";BORUŽĖLIŲ;7398363498;Ne;0;0;2;2
6739;"Pumpurėlis (Kalvarijų g. 186)";BORUŽĖLIŲ;5835545051;Ne;0;3;0;3
6740;"Pumpurėlis (Kalvarijų g. 186)";BORUŽĖLIŲ;4188020534;Ne;2;0;0;2
6741;"Pumpurėlis (Kalvarijų g. 186)";BORUŽĖLIŲ;6256781298;Ne;0;7;0;7
6742;"Pumpurėlis (Kalvarijų g. 186)";BORUŽĖLIŲ;9136771401;Ne;13;0;1;14
6743;"Pumpurėlis (Kalvarijų g. 186)";BORUŽĖLIŲ;7045349032;Ne;0;8;10;18
6744;"Pumpurėlis (Kalvarijų g. 186)";BORUŽĖLIŲ;1017838338;Ne;7;0;0;7
6745;"Pumpurėlis (Kalvarijų g. 186)";BORUŽĖLIŲ;1648249689;Ne;5;0;1;6
6746;"Pumpurėlis (Kalvarijų g. 186)";BORUŽĖLIŲ;7843280418;Ne;0;0;3;3
6747;"Pumpurėlis (Kalvarijų g. 186)";BORUŽĖLIŲ;1441993078;Ne;6;0;3;9
6748;"Pumpurėlis (Kalvarijų g. 186)";BORUŽĖLIŲ;2768082342;Ne;1;0;1;2
6749;"Pumpurėlis (Kalvarijų g. 186)";BORUŽĖLIŲ;3407251558;Ne;0;0;2;2
6750;"Pumpurėlis (Kalvarijų g. 186)";SMALSUČIŲ;6212212516;Taip;6;0;0;6
6751;"Pumpurėlis (Kalvarijų g. 186)";SMALSUČIŲ;6604801631;Ne;0;0;1;1
6752;"Pumpurėlis (Kalvarijų g. 186)";SMALSUČIŲ;9363610488;Ne;1;0;0;1
6753;"Pumpurėlis (Kalvarijų g. 186)";SMALSUČIŲ;8380689261;Taip;5;0;0;5
6754;"Pumpurėlis (Kalvarijų g. 186)";SMALSUČIŲ;6483338028;Ne;1;0;0;1
6755;"Pumpurėlis (Kalvarijų g. 186)";SMALSUČIŲ;6959214331;Ne;7;4;0;11
6756;"Pumpurėlis (Kalvarijų g. 186)";SMALSUČIŲ;3085309902;Ne;0;0;1;1
6757;"Pumpurėlis (Kalvarijų g. 186)";SMALSUČIŲ;4964949574;Ne;6;0;0;6
6758;"Pumpurėlis (Kalvarijų g. 186)";SMALSUČIŲ;2905797053;Ne;4;0;0;4
6759;"Pumpurėlis (Kalvarijų g. 186)";SMALSUČIŲ;2026021360;Ne;4;0;0;4
6760;"Pumpurėlis (Kalvarijų g. 186)";SMALSUČIŲ;3871151401;Taip;0;1;0;1
6761;"Pumpurėlis (Kalvarijų g. 186)";SMALSUČIŲ;6557857672;Ne;10;0;0;10
6762;"Pumpurėlis (Kalvarijų g. 186)";SMALSUČIŲ;7813696919;Ne;0;9;0;9
6763;"Pumpurėlis (Kalvarijų g. 186)";SMALSUČIŲ;5236515914;Taip;1;0;0;1
6764;"Pumpurėlis (Kalvarijų g. 186)";SMALSUČIŲ;5456922203;Ne;4;0;0;4
6765;"Pumpurėlis (Kalvarijų g. 186)";SMALSUČIŲ;8886730333;Ne;0;4;0;4
6766;Puriena;Ančiukų;6158842119;Ne;0;20;0;20
6767;Puriena;Ančiukų;3557013127;Ne;0;1;0;1
6768;Puriena;Ančiukų;4100466337;Ne;0;12;11;23
6769;Puriena;Ančiukų;9251058353;Ne;3;1;0;4
6770;Puriena;Ančiukų;3681811493;Ne;0;6;0;6
6771;Puriena;Ančiukų;4060087185;Taip;0;0;3;3
6772;Puriena;Ančiukų;6280465748;Ne;15;1;0;16
6773;Puriena;Ančiukų;3033562627;Ne;5;4;0;9
6774;Puriena;Ančiukų;5777076971;Ne;5;4;0;9
6775;Puriena;Ančiukų;8310231540;Ne;0;1;1;2
6776;Puriena;Ančiukų;4460575818;Ne;0;1;0;1
6777;Puriena;Ančiukų;8120597514;Ne;0;4;0;4
6778;Puriena;Ančiukų;7967288875;Ne;1;0;1;2
6779;Puriena;Ančiukų;1907429094;Taip;0;0;1;1
6780;Puriena;Ančiukų;4605662701;Ne;0;3;0;3
6781;Puriena;Ančiukų;1819876614;Ne;0;0;3;3
6782;Puriena;Ančiukų;4776745276;Ne;0;1;1;2
6783;Puriena;Ančiukų;7769252165;Ne;1;1;1;3
6784;Puriena;Ančiukų;3772941726;Ne;0;1;0;1
6785;Puriena;Ančiukų;1428098802;Ne;0;1;0;1
6786;Puriena;Ančiukų;6416145396;Ne;0;3;2;5
6787;Puriena;Drugeliai;7016498639;Ne;0;0;2;2
6788;Puriena;Drugeliai;9671916745;Ne;0;5;2;7
6789;Puriena;Drugeliai;8195902319;Ne;4;6;1;11
6790;Puriena;Drugeliai;5797970231;Ne;10;0;1;11
6791;Puriena;Drugeliai;3382737176;Ne;6;0;0;6
6792;Puriena;Drugeliai;4587892949;Ne;9;0;2;11
6793;Puriena;Drugeliai;3440488785;Ne;0;0;4;4
6794;Puriena;Drugeliai;8284860687;Ne;0;10;0;10
6795;Puriena;Drugeliai;6941251095;Ne;21;12;0;33
6796;Puriena;Drugeliai;3252190329;Ne;0;0;1;1
6797;Puriena;Drugeliai;5927216569;Ne;5;0;1;6
6798;Puriena;Drugeliai;8474426340;Ne;0;0;1;1
6799;Puriena;Drugeliai;6308393533;Ne;8;0;6;14
6800;Puriena;Drugeliai;9907972536;Taip;5;0;0;5
6801;Puriena;Drugeliai;8239919265;Taip;3;0;4;7
6802;Puriena;Drugeliai;7634536770;Ne;6;0;0;6
6803;Puriena;Drugeliai;9176303276;Ne;7;10;1;18
6804;Puriena;Drugeliai;3604094165;Ne;7;0;0;7
6805;Puriena;Drugeliai;8110665629;Ne;0;9;1;10
6806;Puriena;Pelėdžiukai;2013783668;Ne;2;1;0;3
6807;Puriena;Pelėdžiukai;8874823029;Ne;1;0;1;2
6808;Puriena;Pelėdžiukai;3149718901;Ne;12;2;0;14
6809;Puriena;Pelėdžiukai;9041388275;Ne;0;0;1;1
6810;Puriena;Pelėdžiukai;3175917649;Ne;3;0;1;4
6811;Puriena;Pelėdžiukai;2579402981;Ne;5;0;1;6
6812;Puriena;Pelėdžiukai;3671297035;Ne;0;0;1;1
6813;Puriena;Pelėdžiukai;2701942325;Ne;0;9;0;9
6814;Puriena;Pelėdžiukai;2267225709;Taip;9;0;0;9
6815;Puriena;Pelėdžiukai;4858971990;Ne;0;10;0;10
6816;Puriena;Pelėdžiukai;1417566073;Ne;0;1;3;4
6817;Puriena;Pelėdžiukai;6463129806;Ne;0;5;1;6
6818;Puriena;Pelėdžiukai;4501239330;Ne;0;0;2;2
6819;Puriena;Pelėdžiukai;5341228269;Ne;0;10;0;10
6820;Puriena;Pelėdžiukai;6786694796;Ne;5;0;2;7
6821;Puriena;Pelėdžiukai;8952508230;Taip;8;0;2;10
6822;Puriena;Pelėdžiukai;5080805225;Taip;5;1;3;9
6823;Puriena;Pelėdžiukai;1158768017;Ne;0;1;0;1
6824;Puriena;Pelėdžiukai;1658720269;Ne;0;7;0;7
6825;Puriena;Voveriukai;8772936125;Ne;3;0;3;6
6826;Puriena;Voveriukai;6428413592;Ne;12;0;2;14
6827;Puriena;Voveriukai;8242140541;Taip;14;0;0;14
6828;Puriena;Voveriukai;7066959314;Ne;8;7;0;15
6829;Puriena;Voveriukai;1455237224;Taip;0;1;1;2
6830;Puriena;Voveriukai;3094722037;Ne;1;0;1;2
6831;Puriena;Voveriukai;4165800035;Ne;6;0;0;6
6832;Puriena;Voveriukai;7334787183;Ne;5;1;1;7
6833;Puriena;Voveriukai;3312235148;Ne;0;0;1;1
6834;Puriena;Voveriukai;8412041946;Ne;8;0;1;9
6835;Puriena;Voveriukai;3287725982;Ne;14;0;1;15
6836;Puriena;Voveriukai;6496077328;Ne;12;0;1;13
6837;Puriena;Voveriukai;8845361962;Ne;3;12;0;15
6838;Puriena;Voveriukai;9965834233;Ne;3;0;1;4
6839;Puriena;Voveriukai;5841409384;Taip;17;0;0;17
6840;Puriena;Voveriukai;9934831745;Ne;0;0;1;1
6841;Puriena;Voveriukai;8310464710;Ne;0;12;0;12
6842;Puriena;Voveriukai;1614993691;Taip;0;1;1;2
6843;Puriena;Voveriukai;2172109284;Ne;4;3;0;7
6844;Puriena;Bitučių;1621772702;Ne;0;0;3;3
6845;Puriena;Bitučių;9413672989;Ne;4;1;0;5
6846;Puriena;Bitučių;1175665781;Taip;0;0;1;1
6847;Puriena;Bitučių;6853706997;Ne;2;6;0;8
6848;Puriena;Bitučių;1339162214;Ne;0;1;0;1
6849;Puriena;Bitučių;9543884311;Ne;0;0;2;2
6850;Puriena;Bitučių;5395382717;Ne;1;2;1;4
6851;Puriena;Bitučių;8237149969;Ne;0;1;0;1
6852;Puriena;Bitučių;7481642656;Ne;0;33;0;33
6853;Puriena;Bitučių;8512814466;Ne;0;5;0;5
6854;Puriena;Bitučių;7622407056;Ne;0;10;0;10
6855;Puriena;Bitučių;4017644414;Ne;0;0;5;5
6856;Puriena;Bitučių;8416003733;Ne;0;0;3;3
6857;Puriena;Bitučių;8199607793;Ne;0;0;6;6
6858;Puriena;Bitučių;9854244405;Ne;0;0;2;2
6859;Puriena;Bitučių;6780164845;Ne;0;0;5;5
6860;Puriena;Bitučių;6413337915;Ne;5;0;1;6
6861;Puriena;Zylutės;7891369140;Ne;0;0;1;1
6862;Puriena;Zylutės;2966464432;Ne;2;0;0;2
6863;Puriena;Zylutės;1521955898;Ne;10;0;0;10
6864;Puriena;Zylutės;8881337164;Ne;5;3;0;8
6865;Puriena;Zylutės;5478026060;Ne;0;0;1;1
6866;Puriena;Zylutės;6914613438;Ne;0;0;1;1
6867;Puriena;Zylutės;8159342676;Ne;0;1;0;1
6868;Puriena;Zylutės;1121312813;Ne;0;1;0;1
6869;Puriena;Zylutės;7021756459;Ne;8;1;0;9
6870;Puriena;Zylutės;1564155036;Taip;5;2;0;7
6871;Puriena;Zylutės;9098291788;Ne;0;9;0;9
6872;Puriena;Zylutės;6613654824;Ne;0;0;1;1
6873;Puriena;Zylutės;3738277048;Ne;0;6;0;6
6874;Puriena;Zylutės;3579008577;Ne;6;2;0;8
6875;Puriena;Zylutės;7477278612;Ne;3;0;1;4
6876;Puriena;Zylutės;9847768390;Ne;0;5;1;6
6877;Puriena;Zylutės;9150157724;Ne;8;0;1;9
6878;Puriena;Meškučių;6234132927;Ne;12;2;0;14
6879;Puriena;Meškučių;4563681164;Ne;0;2;2;4
6880;Puriena;Meškučių;3153330970;Ne;0;7;1;8
6881;Puriena;Meškučių;9500729561;Ne;0;1;0;1
6882;Puriena;Meškučių;1238475246;Ne;5;1;0;6
6883;Puriena;Meškučių;5591189546;Ne;0;6;1;7
6884;Puriena;Meškučių;9748726934;Ne;0;1;0;1
6885;Puriena;Meškučių;7466163131;Ne;6;0;0;6
6886;Puriena;Meškučių;2466609635;Ne;0;2;0;2
6887;Puriena;Meškučių;3309219271;Ne;0;4;0;4
6888;Puriena;Meškučių;9509041179;Ne;0;0;4;4
6889;Puriena;Meškučių;5176663365;Ne;0;2;0;2
6890;Puriena;Meškučių;9961074983;Ne;6;1;0;7
6891;Puriena;Meškučių;3011629747;Ne;14;0;0;14
6892;Puriena;Meškučių;2029981617;Ne;0;1;0;1
6893;Puriena;Meškučių;6185080390;Ne;5;1;0;6
6894;Puriena;Meškučių;3526684967;Ne;0;2;2;4
6895;Puriena;Meškučių;1513909923;Ne;5;6;3;14
6896;Puriena;Meškučių;7556975480;Ne;6;0;6;12
6897;Puriena;Meškučių;2711642252;Taip;0;2;0;2
6898;Puriena;Meškučių;8093664167;Taip;0;2;0;2
6899;Puriena;Meškučių;8359978283;Ne;0;2;3;5
6900;Puriena;Nykštukų;1053386081;Taip;0;1;1;2
6901;Puriena;Nykštukų;5469827031;Taip;0;0;2;2
6902;Puriena;Nykštukų;7649596096;Taip;6;0;3;9
6903;Puriena;Nykštukų;2762325241;Taip;5;1;15;21
6904;Puriena;Nykštukų;9907142348;Ne;1;0;6;7
6905;Puriena;Nykštukų;9369786639;Ne;3;0;1;4
6906;Puriena;Nykštukų;4728991133;Ne;0;0;1;1
6907;Puriena;Nykštukų;2344061847;Taip;0;1;0;1
6908;Puriena;Nykštukų;3630564604;Ne;5;0;4;9
6909;Puriena;Nykštukų;9438604106;Ne;0;0;3;3
6910;Puriena;Nykštukų;9379314578;Ne;20;0;1;21
6911;Puriena;Nykštukų;4211784186;Ne;1;0;1;2
6912;Puriena;Nykštukų;2146727759;Ne;0;2;5;7
6913;Puriena;Nykštukų;1988826809;Ne;0;0;1;1
6914;Puriena;Nykštukų;6605817147;Ne;5;0;2;7
6915;Puriena;Nykštukų;6271951373;Ne;3;0;0;3
6916;Puriena;Nykštukų;7869104640;Ne;4;1;0;5
6917;Puriena;Nykštukų;9931397038;Taip;3;0;1;4
6918;Puriena;Nykštukų;9497287421;Ne;0;1;0;1
6919;Puriena;Nykštukų;4006267650;Taip;0;8;0;8
6920;Puriena;Nykštukų;5277351784;Ne;4;0;1;5
6921;Puriena;Nykštukų;3215364967;Ne;0;1;2;3
6922;Puriena;Ežiukai;6612468095;Taip;15;0;0;15
6923;Puriena;Ežiukai;7913847170;Ne;9;0;1;10
6924;Puriena;Ežiukai;8089081251;Ne;0;6;0;6
6925;Puriena;Ežiukai;2830409862;Ne;6;4;0;10
6926;Puriena;Ežiukai;5550321808;Ne;0;0;1;1
6927;Puriena;Ežiukai;8038573068;Ne;0;2;3;5
6928;Puriena;Ežiukai;2624283930;Ne;0;5;0;5
6929;Puriena;Ežiukai;6001659356;Ne;0;0;1;1
6930;Puriena;Ežiukai;5539708916;Ne;0;5;0;5
6931;Puriena;Ežiukai;7335537384;Ne;0;5;2;7
6932;Puriena;Ežiukai;3204824116;Ne;3;0;1;4
6933;Puriena;Ežiukai;7720549981;Taip;12;0;1;13
6934;Puriena;Ežiukai;5555076926;Ne;0;0;1;1
6935;Puriena;Ežiukai;2312297583;Ne;0;0;3;3
6936;Puriena;Ežiukai;3232981406;Ne;10;0;0;10
6937;Puriena;Ežiukai;9228372078;Ne;1;0;3;4
6938;Puriena;Ežiukai;5374864513;Ne;21;0;0;21
6939;Puriena;Ežiukai;1737249860;Ne;0;6;0;6
6940;Puriena;Ežiukai;4608801156;Taip;0;1;0;1
6941;Puriena;Ežiukai;6991740430;Ne;0;0;1;1
6942;Puriena;"Boružiukų ";9600515308;Taip;13;1;0;14
6943;Puriena;"Boružiukų ";7985332838;Ne;0;21;0;21
6944;Puriena;"Boružiukų ";2818282875;Ne;3;1;2;6
6945;Puriena;"Boružiukų ";1796123753;Ne;4;9;2;15
6946;Puriena;"Boružiukų ";9489913940;Ne;6;0;0;6
6947;Puriena;"Boružiukų ";7350776605;Ne;10;0;0;10
6948;Puriena;"Boružiukų ";3521550682;Ne;1;0;2;3
6949;Puriena;"Boružiukų ";7554505121;Taip;1;1;0;2
6950;Puriena;"Boružiukų ";9728603155;Ne;5;0;0;5
6951;Puriena;"Boružiukų ";1453976004;Ne;10;0;0;10
6952;Puriena;"Boružiukų ";9402161115;Ne;10;0;0;10
6953;Puriena;"Boružiukų ";6966564224;Ne;7;0;0;7
6954;Puriena;"Boružiukų ";3888242345;Ne;10;0;0;10
6955;Puriena;"Boružiukų ";9085439508;Ne;11;0;0;11
6956;Puriena;"Zuikučių ";6549867740;Ne;0;4;1;5
6957;Puriena;"Zuikučių ";9102891844;Ne;9;0;0;9
6958;Puriena;"Zuikučių ";4946887007;Ne;0;12;0;12
6959;Puriena;"Zuikučių ";4139839679;Ne;3;0;0;3
6960;Puriena;"Zuikučių ";8607005504;Ne;7;0;1;8
6961;Puriena;"Zuikučių ";9553026735;Ne;10;0;0;10
6962;Puriena;"Zuikučių ";5257520238;Ne;1;0;6;7
6963;Puriena;"Zuikučių ";4549244705;Ne;13;0;0;13
6964;Puriena;"Zuikučių ";4257334383;Ne;0;0;1;1
6965;Puriena;"Zuikučių ";2736255661;Ne;0;0;4;4
6966;Puriena;"Zuikučių ";4363865643;Ne;2;0;1;3
6967;Puriena;"Zuikučių ";1877494111;Ne;3;1;2;6
6968;Puriena;"Zuikučių ";3510157302;Ne;0;12;0;12
6969;Puriena;Skruzdėliukai;9729644429;Ne;1;0;0;1
6970;Puriena;Skruzdėliukai;4283608124;Ne;3;1;0;4
6971;Puriena;Skruzdėliukai;8144488922;Ne;4;5;0;9
6972;Puriena;Skruzdėliukai;8476986855;Ne;0;6;0;6
6973;Puriena;Skruzdėliukai;3627403517;Ne;5;5;0;10
6974;Puriena;Skruzdėliukai;6140294839;Ne;13;0;0;13
6975;Puriena;Skruzdėliukai;2813562677;Ne;5;6;0;11
6976;Puriena;Skruzdėliukai;7120683581;Ne;0;3;0;3
6977;Puriena;Skruzdėliukai;4653085762;Ne;0;6;0;6
6978;Puriena;Skruzdėliukai;8497070167;Taip;4;0;0;4
6979;Puriena;Skruzdėliukai;4498919764;Ne;6;0;0;6
6980;Puriena;Skruzdėliukai;4517020977;Taip;3;0;0;3
6981;Puriena;Skruzdėliukai;6150437624;Ne;0;1;0;1
6982;Puriena;Skruzdėliukai;3455291312;Ne;2;10;0;12
6983;Puriena;Skruzdėliukai;9911792407;Ne;13;2;0;15
6984;Puriena;Skruzdėliukai;6352605894;Ne;2;5;0;7
6985;Pušaitė;Kodėlčiukai;8702361596;Ne;3;0;0;3
6986;Pušaitė;Kodėlčiukai;4838345510;Ne;2;0;0;2
6987;Pušaitė;Kodėlčiukai;6275090953;Ne;0;1;0;1
6988;Pušaitė;Kodėlčiukai;8750774616;Ne;0;1;0;1
6989;Pušaitė;Kodėlčiukai;9391350218;Ne;0;7;1;8
6990;Pušaitė;Kodėlčiukai;2793941689;Ne;0;5;0;5
6991;Pušaitė;Kodėlčiukai;9364887123;Ne;2;0;0;2
6992;Pušaitė;Kodėlčiukai;4326967247;Ne;0;2;0;2
6993;Pušaitė;Kodėlčiukai;5922053969;Ne;0;0;5;5
6994;Pušaitė;Kodėlčiukai;4473930703;Ne;0;1;0;1
6995;Pušaitė;Kodėlčiukai;6775428321;Ne;0;10;0;10
6996;Pušaitė;Kodėlčiukai;4615270419;Ne;0;3;0;3
6997;Pušaitė;Kodėlčiukai;7117784038;Ne;0;2;0;2
6998;Pušaitė;Kodėlčiukai;2253477550;Ne;0;1;0;1
6999;Pušaitė;Kodėlčiukai;8754286143;Ne;7;0;0;7
7000;Pušaitė;Kodėlčiukai;6186545163;Ne;0;1;0;1
7001;Pušaitė;Kodėlčiukai;3150144924;Ne;0;2;0;2
7002;Pušaitė;Kodėlčiukai;6189116357;Ne;0;4;9;13
7003;Pušaitė;Saulutės;2254269292;Ne;0;0;7;7
7004;Pušaitė;Saulutės;5306237557;Ne;10;0;2;12
7005;Pušaitė;Saulutės;7480846917;Taip;0;0;1;1
7006;Pušaitė;Saulutės;8355083823;Ne;0;5;0;5
7007;Pušaitė;Saulutės;2543188867;Ne;0;5;1;6
7008;Pušaitė;Saulutės;8914668904;Ne;0;0;2;2
7009;Pušaitė;Saulutės;2396217546;Ne;0;3;2;5
7010;Pušaitė;Saulutės;3126709123;Ne;2;0;1;3
7011;Pušaitė;Saulutės;5469990058;Ne;8;0;0;8
7012;Pušaitė;Saulutės;1044902638;Ne;4;0;3;7
7013;Pušaitė;Saulutės;6784729764;Ne;0;1;0;1
7014;Pušaitė;Saulutės;6215522656;Ne;0;0;7;7
7015;Pušaitė;Saulutės;2675136958;Ne;9;0;2;11
7016;Pušaitė;Saulutės;6261355186;Ne;1;0;9;10
7017;Pušaitė;Saulutės;7888103890;Ne;4;0;0;4
7018;Pušaitė;Saulutės;6848340140;Taip;3;0;2;5
7019;Pušaitė;Zuikučiai;7291412329;Ne;5;0;3;8
7020;Pušaitė;Zuikučiai;5981944481;Ne;2;0;0;2
7021;Pušaitė;Zuikučiai;4511258460;Taip;8;0;1;9
7022;Pušaitė;Zuikučiai;5422616450;Ne;0;0;7;7
7023;Pušaitė;Zuikučiai;5819186055;Ne;0;0;2;2
7024;Pušaitė;Zuikučiai;9577925438;Ne;5;0;0;5
7025;Pušaitė;Zuikučiai;4234318548;Ne;0;0;2;2
7026;Pušaitė;Zuikučiai;9180309936;Taip;10;1;0;11
7027;Pušaitė;Zuikučiai;4754791489;Ne;5;0;5;10
7028;Pušaitė;Zuikučiai;4082173648;Ne;10;0;0;10
7029;Pušaitė;Zuikučiai;2264047794;Ne;0;2;0;2
7030;Pušaitė;Zuikučiai;3052743933;Ne;0;21;0;21
7031;Pušaitė;Zuikučiai;4278699624;Ne;4;0;0;4
7032;Pušaitė;Zuikučiai;8244793037;Taip;0;0;4;4
7033;Pušaitė;Zuikučiai;5002710062;Taip;6;1;8;15
7034;Pušaitė;Zuikučiai;3508664946;Ne;0;0;1;1
7035;Pušaitė;Zuikučiai;2887576870;Ne;3;0;0;3
7036;Pušaitė;Zuikučiai;7583243031;Ne;0;0;3;3
7037;Pušaitė;Zuikučiai;1180343204;Ne;0;9;1;10
7038;Pušaitė;Vėžliukai;1326581025;Ne;0;10;0;10
7039;Pušaitė;Vėžliukai;3485234259;Ne;10;0;0;10
7040;Pušaitė;Vėžliukai;3014867515;Ne;0;0;6;6
7041;Pušaitė;Vėžliukai;9414554800;Ne;0;2;0;2
7042;Pušaitė;Vėžliukai;9470667227;Ne;0;2;0;2
7043;Pušaitė;Vėžliukai;6739253961;Ne;0;11;0;11
7044;Pušaitė;Vėžliukai;7652706756;Ne;0;1;0;1
7045;Pušaitė;Vėžliukai;5318602924;Ne;0;21;0;21
7046;Pušaitė;Vėžliukai;6794867560;Ne;0;0;1;1
7047;Pušaitė;Vėžliukai;5296435012;Ne;0;7;0;7
7048;Pušaitė;Vėžliukai;6833083982;Ne;5;0;2;7
7049;Pušaitė;Vėžliukai;5512786073;Ne;3;1;0;4
7050;Pušaitė;Vėžliukai;4281125486;Ne;3;0;0;3
7051;Pušaitė;Vėžliukai;2777222076;Ne;0;2;0;2
7052;Pušaitė;"Linksmieji nykštukai";9265357004;Ne;0;1;0;1
7053;Pušaitė;"Linksmieji nykštukai";7520393710;Ne;3;0;0;3
7054;Pušaitė;"Linksmieji nykštukai";4517181474;Ne;7;1;0;8
7055;Pušaitė;"Linksmieji nykštukai";9033615485;Taip;2;1;0;3
7056;Pušaitė;"Linksmieji nykštukai";3130824742;Ne;0;1;0;1
7057;Pušaitė;"Linksmieji nykštukai";1781601521;Ne;6;0;0;6
7058;Pušaitė;"Linksmieji nykštukai";1024996364;Ne;1;0;1;2
7059;Pušaitė;"Linksmieji nykštukai";4662871524;Ne;7;3;0;10
7060;Pušaitė;"Linksmieji nykštukai";3350461304;Ne;0;2;0;2
7061;Pušaitė;"Linksmieji nykštukai";9327636862;Ne;5;0;0;5
7062;Pušaitė;"Linksmieji nykštukai";4175909754;Ne;0;1;2;3
7063;Pušaitė;"Linksmieji nykštukai";3788392895;Ne;0;1;0;1
7064;Pušaitė;"Linksmieji nykštukai";9127444013;Ne;0;1;0;1
7065;Pušaitė;"Linksmieji nykštukai";5422784898;Ne;0;2;0;2
7066;Pušaitė;"Linksmieji nykštukai";5104111840;Ne;2;0;0;2
7067;Pušaitė;"Linksmieji nykštukai";9866431097;Ne;5;1;0;6
7068;Pušaitė;"Linksmieji nykštukai";4374232593;Ne;11;0;0;11
7069;Pušaitė;"Linksmieji nykštukai";8378313810;Ne;0;2;0;2
7070;Pušaitė;"Kačiukų trobelė";3695016765;Ne;13;0;0;13
7071;Pušaitė;"Kačiukų trobelė";5415680731;Ne;1;0;0;1
7072;Pušaitė;"Kačiukų trobelė";1122112207;Ne;0;6;0;6
7073;Pušaitė;"Kačiukų trobelė";1635528919;Ne;0;0;5;5
7074;Pušaitė;"Kačiukų trobelė";2837439334;Ne;3;0;1;4
7075;Pušaitė;"Kačiukų trobelė";8793102437;Ne;4;4;0;8
7076;Pušaitė;"Kačiukų trobelė";9056933586;Ne;6;2;1;9
7077;Pušaitė;"Kačiukų trobelė";6323180798;Ne;1;0;0;1
7078;Pušaitė;"Kačiukų trobelė";5191894075;Ne;2;2;0;4
7079;Pušaitė;"Kačiukų trobelė";8822285103;Ne;0;1;0;1
7080;Pušaitė;"Kačiukų trobelė";9313564235;Ne;6;1;0;7
7081;Pušaitė;"Kačiukų trobelė";2865062081;Ne;0;0;2;2
7082;Pušaitė;"Kačiukų trobelė";1978339054;Ne;0;2;0;2
7083;Pušaitė;"Kačiukų trobelė";5461822909;Taip;2;1;0;3
7084;Pušaitė;Ežiukai;5013833636;Ne;6;0;0;6
7085;Pušaitė;Ežiukai;6742576615;Ne;0;0;4;4
7086;Pušaitė;Ežiukai;6511940816;Ne;10;0;0;10
7087;Pušaitė;Ežiukai;9546541248;Ne;4;0;4;8
7088;Pušaitė;Ežiukai;4769806128;Ne;5;0;0;5
7089;Pušaitė;Ežiukai;4529006786;Ne;4;0;0;4
7090;Pušaitė;Ežiukai;6767281906;Taip;2;1;0;3
7091;Pušaitė;Ežiukai;7210529114;Ne;7;0;4;11
7092;Pušaitė;Ežiukai;9164927041;Ne;0;21;0;21
7093;Pušaitė;Ežiukai;9867041220;Ne;0;1;0;1
7094;Pušaitė;Ežiukai;9031289300;Ne;4;0;4;8
7095;Pušaitė;Ežiukai;2758026755;Ne;0;1;0;1
7096;Pušaitė;Ežiukai;6059415475;Ne;0;0;11;11
7097;Pušaitė;Ežiukai;7737524017;Taip;0;1;0;1
7098;Pušaitė;Ežiukai;1069369636;Ne;0;1;0;1
7099;Pušaitė;Ežiukai;2454348536;Taip;6;0;0;6
7100;Pušaitė;Ežiukai;3646346787;Ne;0;15;0;15
7101;Pušaitė;Ežiukai;4883211957;Ne;10;0;3;13
7102;Pušaitė;"Gudručių šalis";8763667682;Ne;0;0;1;1
7103;Pušaitė;"Gudručių šalis";5488507646;Taip;0;21;0;21
7104;Pušaitė;"Gudručių šalis";1305526154;Ne;3;10;0;13
7105;Pušaitė;"Gudručių šalis";6205900423;Taip;0;21;0;21
7106;Pušaitė;"Gudručių šalis";2078734161;Ne;1;0;3;4
7107;Pušaitė;"Gudručių šalis";8790959900;Ne;4;2;0;6
7108;Pušaitė;"Gudručių šalis";2397106198;Ne;0;1;1;2
7109;Pušaitė;"Gudručių šalis";3694667637;Ne;0;0;1;1
7110;Pušaitė;"Gudručių šalis";4101285889;Ne;0;0;7;7
7111;Pušaitė;"Gudručių šalis";5563772495;Ne;0;0;9;9
7112;Pušaitė;"Gudručių šalis";6356263503;Ne;4;0;9;13
7113;Pušaitė;"Gudručių šalis";4918124423;Ne;0;0;5;5
7114;Pušaitė;"Gudručių šalis";6734504906;Ne;0;0;2;2
7115;Pušaitė;"Gudručių šalis";7992567219;Ne;0;0;1;1
7116;Pušaitė;"Gudručių šalis";1807432967;Ne;1;0;0;1
7117;Pušaitė;"Gudručių šalis";3380836598;Ne;0;0;1;1
7118;Pušaitė;"Lapučių mokyklėlė";9337726482;Ne;0;1;0;1
7119;Pušaitė;"Lapučių mokyklėlė";2666541612;Ne;0;1;0;1
7120;Pušaitė;"Lapučių mokyklėlė";8218991320;Ne;0;1;3;4
7121;Pušaitė;"Lapučių mokyklėlė";1994898058;Ne;0;2;4;6
7122;Pušaitė;"Lapučių mokyklėlė";8551426938;Ne;6;8;0;14
7123;Pušaitė;"Lapučių mokyklėlė";4444972517;Ne;6;0;0;6
7124;Pušaitė;"Lapučių mokyklėlė";4857214952;Ne;0;1;0;1
7125;Pušaitė;"Lapučių mokyklėlė";4138386134;Ne;0;2;1;3
7126;Pušaitė;"Lapučių mokyklėlė";4747611989;Ne;0;2;2;4
7127;Pušaitė;"Lapučių mokyklėlė";3387165403;Ne;0;1;0;1
7128;Pušaitė;"Lapučių mokyklėlė";5339878948;Ne;0;3;0;3
7129;Pušaitė;"Lapučių mokyklėlė";3610256789;Ne;0;2;4;6
7130;Pušaitė;"Lapučių mokyklėlė";6576647982;Taip;0;7;3;10
7131;Pušaitė;"Lapučių mokyklėlė";1395577340;Ne;0;2;2;4
7132;Pušaitė;"Lapučių mokyklėlė";1534764228;Ne;0;3;0;3
7133;Pušaitė;"Lapučių mokyklėlė";5328083339;Taip;0;2;3;5
7134;Pušaitė;"Lapučių mokyklėlė";3200968850;Ne;0;10;0;10
7135;Pušaitė;"VOVERIUKAI ";1665030028;Taip;0;21;0;21
7136;Pušaitė;"VOVERIUKAI ";4818407739;Ne;3;0;0;3
7137;Pušaitė;"VOVERIUKAI ";8876092901;Taip;3;1;2;6
7138;Pušaitė;"VOVERIUKAI ";4767321724;Ne;0;0;2;2
7139;Pušaitė;"VOVERIUKAI ";1542239525;Ne;0;1;0;1
7140;Pušaitė;"VOVERIUKAI ";6643741885;Ne;0;0;2;2
7141;Pušaitė;"VOVERIUKAI ";1439721280;Ne;5;0;0;5
7142;Pušaitė;"VOVERIUKAI ";6891217457;Ne;2;0;0;2
7143;Pušaitė;"VOVERIUKAI ";6786313527;Ne;2;0;2;4
7144;Pušaitė;"VOVERIUKAI ";8967363762;Ne;3;0;0;3
7145;Pušaitė;"VOVERIUKAI ";2699657569;Ne;0;21;0;21
7146;Pušaitė;MEŠKUČIAI;6754402783;Taip;0;5;0;5
7147;Pušaitė;MEŠKUČIAI;3239486674;Taip;2;0;0;2
7148;Pušaitė;MEŠKUČIAI;9339706754;Taip;15;0;0;15
7149;Pušaitė;MEŠKUČIAI;9418440677;Ne;0;1;0;1
7150;Pušaitė;MEŠKUČIAI;9887693476;Ne;0;0;2;2
7151;Pušaitė;MEŠKUČIAI;1034005054;Ne;0;0;1;1
7152;Pušaitė;MEŠKUČIAI;3238080908;Ne;1;0;0;1
7153;Pušaitė;MEŠKUČIAI;7278950473;Ne;1;0;0;1
7154;Pušaitė;MEŠKUČIAI;3994799424;Ne;5;0;0;5
7155;Pušaitė;MEŠKUČIAI;5686927118;Ne;0;1;0;1
7156;Pušaitė;PELIUKAI;9177861202;Taip;0;2;4;6
7157;Pušaitė;PELIUKAI;6645711171;Ne;9;2;0;11
7158;Pušaitė;PELIUKAI;2618038364;Ne;5;0;0;5
7159;Pušaitė;PELIUKAI;5112517007;Ne;0;4;0;4
7160;Pušaitė;PELIUKAI;7285450755;Ne;0;16;0;16
7161;Pušaitė;PELIUKAI;7204853123;Ne;15;0;0;15
7162;Pušaitė;PELIUKAI;4802860079;Ne;0;6;0;6
7163;Pušaitė;PELIUKAI;2772351972;Ne;0;6;0;6
7164;Pušaitė;PELIUKAI;5305731047;Ne;0;6;0;6
7165;Pušaitė;PELIUKAI;1450204608;Ne;0;1;0;1
7166;Pušaitė;PELIUKAI;7553389781;Ne;1;0;0;1
7167;Pušaitė;PELIUKAI;4420904389;Ne;0;1;0;1
7168;Pušaitė;PELIUKAI;8273198870;Ne;0;1;2;3
7169;"Pušynėlis (Miglos g. 53)";PUMPURĖLIAI;2744665477;Ne;0;0;1;1
7170;"Pušynėlis (Miglos g. 53)";PUMPURĖLIAI;8845728723;Ne;0;1;0;1
7171;"Pušynėlis (Miglos g. 53)";PUMPURĖLIAI;4962270317;Ne;0;0;1;1
7172;"Pušynėlis (Miglos g. 53)";PUMPURĖLIAI;7689524787;Ne;4;0;2;6
7173;"Pušynėlis (Miglos g. 53)";PUMPURĖLIAI;1517104634;Ne;0;1;0;1
7174;"Pušynėlis (Miglos g. 53)";PUMPURĖLIAI;7732546085;Ne;2;0;0;2
7175;"Pušynėlis (Miglos g. 53)";PUMPURĖLIAI;6414064067;Ne;7;0;0;7
7176;"Pušynėlis (Miglos g. 53)";PUMPURĖLIAI;8933840402;Ne;2;0;2;4
7177;"Pušynėlis (Miglos g. 53)";PUMPURĖLIAI;1439408620;Ne;17;0;0;17
7178;"Pušynėlis (Miglos g. 53)";PUMPURĖLIAI;7964828070;Ne;12;0;0;12
7179;"Pušynėlis (Miglos g. 53)";PUMPURĖLIAI;4449613959;Ne;16;0;3;19
7180;"Pušynėlis (Miglos g. 53)";PUMPURĖLIAI;3125802067;Ne;0;0;14;14
7181;"Pušynėlis (Miglos g. 53)";PUMPURĖLIAI;1508282873;Taip;7;0;0;7
7182;"Pušynėlis (Miglos g. 53)";PUMPURĖLIAI;4603625624;Ne;5;0;2;7
7183;"Pušynėlis (Miglos g. 53)";PUMPURĖLIAI;5488832089;Taip;1;0;1;2
7184;"Pušynėlis (Miglos g. 53)";PUMPURĖLIAI;5670094788;Ne;5;0;1;6
7185;"Pušynėlis (Miglos g. 53)";PUMPURĖLIAI;5264481173;Ne;8;0;0;8
7186;"Pušynėlis (Miglos g. 53)";PUMPURĖLIAI;5038740377;Ne;0;1;0;1
7187;"Pušynėlis (Miglos g. 53)";SAULUTĖS;5501281051;Ne;6;0;0;6
7188;"Pušynėlis (Miglos g. 53)";SAULUTĖS;9454407638;Ne;16;0;0;16
7189;"Pušynėlis (Miglos g. 53)";SAULUTĖS;5508064424;Ne;6;0;0;6
7190;"Pušynėlis (Miglos g. 53)";SAULUTĖS;5568838550;Ne;0;1;0;1
7191;"Pušynėlis (Miglos g. 53)";SAULUTĖS;2718421498;Ne;0;1;0;1
7192;"Pušynėlis (Miglos g. 53)";SAULUTĖS;2509111066;Ne;1;1;0;2
7193;"Pušynėlis (Miglos g. 53)";SAULUTĖS;8902047615;Ne;2;0;0;2
7194;"Pušynėlis (Miglos g. 53)";SAULUTĖS;3483639540;Ne;0;1;0;1
7195;"Pušynėlis (Miglos g. 53)";SAULUTĖS;2861000826;Taip;0;1;1;2
7196;"Pušynėlis (Miglos g. 53)";SAULUTĖS;5802582694;Ne;2;0;0;2
7197;"Pušynėlis (Miglos g. 53)";SAULUTĖS;3882064516;Ne;5;0;0;5
7198;"Pušynėlis (Miglos g. 53)";SAULUTĖS;9081582524;Ne;5;0;0;5
7199;"Pušynėlis (Miglos g. 53)";SAULUTĖS;9883505094;Ne;8;0;0;8
7200;"Pušynėlis (Miglos g. 53)";SAULUTĖS;4526807309;Ne;3;0;0;3
7201;"Pušynėlis (Miglos g. 53)";SAULUTĖS;7438923710;Ne;9;0;0;9
7202;"Pušynėlis (Miglos g. 53)";SAULUTĖS;6110878898;Ne;6;0;0;6
7203;"Pušynėlis (Miglos g. 53)";SAULUTĖS;8218331977;Ne;1;0;0;1
7204;"Pušynėlis (Miglos g. 53)";SAULUTĖS;6962705842;Ne;7;0;0;7
7205;"Pušynėlis (Miglos g. 53)";PRIEŠMOKYKLINĖ;4668634909;Ne;0;1;0;1
7206;"Pušynėlis (Miglos g. 53)";PRIEŠMOKYKLINĖ;4030500100;Ne;5;0;0;5
7207;"Pušynėlis (Miglos g. 53)";PRIEŠMOKYKLINĖ;8172450090;Ne;6;0;0;6
7208;"Pušynėlis (Miglos g. 53)";PRIEŠMOKYKLINĖ;9483417104;Ne;0;10;0;10
7209;"Pušynėlis (Miglos g. 53)";PRIEŠMOKYKLINĖ;6036296660;Ne;0;5;0;5
7210;"Pušynėlis (Miglos g. 53)";PRIEŠMOKYKLINĖ;1164201286;Ne;0;1;0;1
7211;"Pušynėlis (Miglos g. 53)";PRIEŠMOKYKLINĖ;2508640229;Ne;1;0;0;1
7212;"Pušynėlis (Miglos g. 53)";PRIEŠMOKYKLINĖ;1251787066;Ne;10;0;0;10
7213;"Pušynėlis (Miglos g. 53)";PRIEŠMOKYKLINĖ;5236219294;Ne;6;1;0;7
7214;"Pušynėlis (Miglos g. 53)";PRIEŠMOKYKLINĖ;6709692748;Ne;0;2;0;2
7215;"Pušynėlis (Miglos g. 53)";PRIEŠMOKYKLINĖ;8799095053;Ne;0;1;0;1
7216;"Pušynėlis (Miglos g. 53)";PRIEŠMOKYKLINĖ;5318223378;Ne;1;0;0;1
7217;"Pušynėlis (Miglos g. 53)";PRIEŠMOKYKLINĖ;3100230874;Ne;5;2;0;7
7218;"Pušynėlis (Miglos g. 53)";PRIEŠMOKYKLINĖ;8451160808;Ne;6;0;0;6
7219;"Pušynėlis (Miglos g. 53)";PRIEŠMOKYKLINĖ;7896617995;Ne;2;0;0;2
7220;"Pušynėlis (Miglos g. 53)";PRIEŠMOKYKLINĖ;5897839636;Ne;0;1;0;1
7221;"Pušynėlis (Miglos g. 53)";PRIEŠMOKYKLINĖ;1034336110;Ne;5;0;0;5
7222;"Pušynėlis (Miglos g. 53)";PRIEŠMOKYKLINĖ;3483007385;Ne;1;0;0;1
7223;"Pušynėlis (Miglos g. 53)";"TREPSIUKAI (2018.09)";7745507151;Ne;0;0;1;1
7224;"Pušynėlis (Miglos g. 53)";"TREPSIUKAI (2018.09)";8911046719;Ne;5;0;0;5
7225;"Pušynėlis (Miglos g. 53)";"TREPSIUKAI (2018.09)";8668256321;Ne;5;0;0;5
7226;"Pušynėlis (Miglos g. 53)";"TREPSIUKAI (2018.09)";5748126562;Taip;11;0;0;11
7227;"Pušynėlis (Miglos g. 53)";"TREPSIUKAI (2018.09)";7752614074;Ne;1;0;0;1
7228;"Pušynėlis (Miglos g. 53)";"TREPSIUKAI (2018.09)";1318218735;Ne;5;0;1;6
7229;"Pušynėlis (Miglos g. 53)";"TREPSIUKAI (2018.09)";5723212271;Ne;12;0;0;12
7230;Raktelis;LAŠIUKAI;9230053040;Ne;0;9;0;9
7231;Raktelis;LAŠIUKAI;9139322116;Ne;4;0;0;4
7232;Raktelis;LAŠIUKAI;6929358401;Ne;0;2;0;2
7233;Raktelis;LAŠIUKAI;4317705126;Ne;5;0;0;5
7234;Raktelis;LAŠIUKAI;5627179884;Ne;0;0;2;2
7235;Raktelis;LAŠIUKAI;4187804340;Ne;0;0;1;1
7236;Raktelis;LAŠIUKAI;9965855682;Ne;2;1;0;3
7237;Raktelis;LAŠIUKAI;7265543701;Ne;0;2;1;3
7238;Raktelis;LAŠIUKAI;4319176525;Ne;2;2;0;4
7239;Raktelis;LAŠIUKAI;5218387088;Ne;0;1;0;1
7240;Raktelis;LAŠIUKAI;5820028619;Ne;9;0;0;9
7241;Raktelis;LAŠIUKAI;5405322552;Ne;0;0;1;1
7242;Raktelis;LAŠIUKAI;4905982507;Ne;10;0;0;10
7243;Raktelis;LAŠIUKAI;7170546710;Ne;7;10;0;17
7244;Raktelis;LAŠIUKAI;9593639791;Ne;0;0;1;1
7245;Raktelis;LAŠIUKAI;1975411457;Ne;6;0;0;6
7246;Raktelis;LAŠIUKAI;6608224825;Ne;0;6;0;6
7247;Raktelis;LAŠIUKAI;2289954824;Ne;9;0;0;9
7248;Raktelis;LAŠIUKAI;6199212999;Ne;5;2;0;7
7249;Raktelis;LAŠIUKAI;9591285702;Ne;4;1;0;5
7250;Raktelis;BITUTĖS;3308623522;Ne;6;0;0;6
7251;Raktelis;BITUTĖS;5913060415;Ne;7;0;0;7
7252;Raktelis;BITUTĖS;6974263764;Ne;0;2;0;2
7253;Raktelis;BITUTĖS;6932820066;Ne;0;10;0;10
7254;Raktelis;BITUTĖS;2410682193;Ne;5;0;1;6
7255;Raktelis;BITUTĖS;4615337759;Ne;3;2;1;6
7256;Raktelis;BITUTĖS;8282429202;Ne;8;0;0;8
7257;Raktelis;BITUTĖS;7222856683;Ne;0;2;0;2
7258;Raktelis;BITUTĖS;7479542200;Ne;17;0;0;17
7259;Raktelis;BITUTĖS;6703168910;Ne;5;0;0;5
7260;Raktelis;BITUTĖS;1026592738;Ne;5;0;0;5
7261;Raktelis;BITUTĖS;7900644404;Ne;0;2;19;21
7262;Raktelis;BITUTĖS;6685891017;Ne;0;0;2;2
7263;Raktelis;BITUTĖS;3484991718;Ne;10;1;0;11
7264;Raktelis;BITUTĖS;6358227532;Ne;0;2;3;5
7265;Raktelis;BITUTĖS;9718355271;Ne;5;1;3;9
7266;Raktelis;BITUTĖS;6855863189;Ne;6;0;1;7
7267;Raktelis;BITUTĖS;7605822626;Ne;7;3;0;10
7268;Raktelis;BITUTĖS;9169797346;Ne;0;11;0;11
7269;Raktelis;BITUTĖS;2383174152;Ne;0;13;0;13
7270;Raktelis;BITUTĖS;7046291082;Ne;10;0;0;10
7271;Raktelis;BORUŽĖLĖS;7068061170;Ne;11;3;0;14
7272;Raktelis;BORUŽĖLĖS;2361477092;Ne;15;0;0;15
7273;Raktelis;BORUŽĖLĖS;4226277600;Ne;7;0;0;7
7274;Raktelis;BORUŽĖLĖS;2599670832;Ne;5;16;0;21
7275;Raktelis;BORUŽĖLĖS;1757601091;Ne;1;0;0;1
7276;Raktelis;BORUŽĖLĖS;5865484633;Ne;0;2;2;4
7277;Raktelis;BORUŽĖLĖS;4529213150;Taip;0;1;0;1
7278;Raktelis;BORUŽĖLĖS;4936637343;Ne;8;1;0;9
7279;Raktelis;BORUŽĖLĖS;4333191842;Ne;11;0;3;14
7280;Raktelis;BORUŽĖLĖS;9529797517;Ne;0;5;0;5
7281;Raktelis;BORUŽĖLĖS;4442395100;Ne;9;0;0;9
7282;Raktelis;BORUŽĖLĖS;5150954686;Ne;9;0;1;10
7283;Raktelis;BORUŽĖLĖS;3490428062;Ne;0;4;0;4
7284;Raktelis;BORUŽĖLĖS;1314972335;Ne;0;8;0;8
7285;Raktelis;BORUŽĖLĖS;3343352568;Ne;0;2;3;5
7286;Raktelis;BORUŽĖLĖS;2698820718;Ne;0;2;0;2
7287;Raktelis;BORUŽĖLĖS;7459272209;Ne;0;0;2;2
7288;Raktelis;BORUŽĖLĖS;5046450478;Ne;5;2;1;8
7289;Raktelis;BORUŽĖLĖS;1141447274;Ne;0;4;0;4
7290;Raktelis;BORUŽĖLĖS;5576511314;Ne;0;1;0;1
7291;Raktelis;BORUŽĖLĖS;3456093273;Ne;0;2;0;2
7292;Raktelis;BORUŽĖLĖS;8647112887;Taip;0;2;0;2
7293;Raktelis;KAČIUKAI;5270430511;Ne;5;0;0;5
7294;Raktelis;KAČIUKAI;4622683599;Ne;5;0;0;5
7295;Raktelis;KAČIUKAI;8600632097;Ne;6;2;0;8
7296;Raktelis;KAČIUKAI;7630501672;Ne;3;0;0;3
7297;Raktelis;KAČIUKAI;6007823584;Ne;0;1;0;1
7298;Raktelis;KAČIUKAI;8456082594;Ne;0;1;0;1
7299;Raktelis;KAČIUKAI;4676213966;Ne;3;0;0;3
7300;Raktelis;KAČIUKAI;4631375439;Ne;0;4;0;4
7301;Raktelis;KAČIUKAI;6265489540;Ne;0;2;0;2
7302;Raktelis;KAČIUKAI;4160091258;Ne;6;0;0;6
7303;Raktelis;KAČIUKAI;3775306030;Ne;6;2;0;8
7304;Raktelis;KAČIUKAI;6550851582;Ne;2;1;0;3
7305;Raktelis;KAČIUKAI;4009105487;Ne;5;0;1;6
7306;Raktelis;KAČIUKAI;1843086151;Ne;0;1;0;1
7307;Raktelis;KAČIUKAI;2295251060;Ne;0;2;0;2
7308;Raktelis;KAČIUKAI;1983808547;Ne;6;0;0;6
7309;Raktelis;KAČIUKAI;5042538956;Ne;8;1;0;9
7310;Raktelis;KAČIUKAI;7260767942;Ne;6;2;0;8
7311;Raktelis;KAČIUKAI;1123693990;Ne;7;1;0;8
7312;Raktelis;KAČIUKAI;4979657165;Taip;0;1;0;1
7313;Raktelis;KAČIUKAI;2700148968;Ne;0;0;1;1
7314;Raktelis;KAČIUKAI;9264550987;Ne;11;1;0;12
7315;Raktelis;KAČIUKAI;8767785444;Ne;7;0;0;7
7316;Raktelis;KIŠKUČIAI;7847787737;Ne;0;2;1;3
7317;Raktelis;KIŠKUČIAI;1810732707;Ne;5;2;2;9
7318;Raktelis;KIŠKUČIAI;5293558630;Ne;3;0;2;5
7319;Raktelis;KIŠKUČIAI;6473692639;Ne;1;2;0;3
7320;Raktelis;KIŠKUČIAI;1668164327;Ne;1;2;0;3
7321;Raktelis;KIŠKUČIAI;1058482540;Ne;2;1;0;3
7322;Raktelis;KIŠKUČIAI;6451056434;Ne;5;0;0;5
7323;Raktelis;KIŠKUČIAI;1129962966;Ne;0;2;0;2
7324;Raktelis;KIŠKUČIAI;7931502610;Ne;4;0;0;4
7325;Raktelis;KIŠKUČIAI;9203811388;Ne;4;0;0;4
7326;Raktelis;KIŠKUČIAI;1511932941;Ne;12;0;0;12
7327;Raktelis;KIŠKUČIAI;5053933317;Ne;5;0;0;5
7328;Raktelis;KIŠKUČIAI;1664533959;Taip;7;0;0;7
7329;Raktelis;NYKŠTUKAI;7865593006;Ne;3;0;1;4
7330;Raktelis;NYKŠTUKAI;8817859592;Ne;3;1;0;4
7331;Raktelis;NYKŠTUKAI;4578445282;Ne;0;1;0;1
7332;Raktelis;NYKŠTUKAI;9164539135;Ne;5;2;0;7
7333;Raktelis;NYKŠTUKAI;4147382341;Ne;0;0;1;1
7334;Raktelis;NYKŠTUKAI;3968555691;Ne;2;0;0;2
7335;Raktelis;NYKŠTUKAI;8507551381;Ne;1;0;0;1
7336;Raktelis;NYKŠTUKAI;4764915486;Ne;1;0;5;6
7337;Raktelis;NYKŠTUKAI;4765483387;Ne;0;0;1;1
7338;Raktelis;NYKŠTUKAI;2803146830;Ne;11;10;0;21
7339;Raktelis;NYKŠTUKAI;7202523804;Ne;0;2;0;2
7340;Raktelis;NYKŠTUKAI;6718159439;Ne;4;1;0;5
7341;Raktelis;NYKŠTUKAI;7058612493;Ne;1;0;1;2
7342;Raktelis;NYKŠTUKAI;9390692206;Ne;0;21;0;21
7343;Raktelis;NYKŠTUKAI;9803505110;Ne;8;0;0;8
7344;Raktelis;NYKŠTUKAI;6587878165;Ne;0;2;0;2
7345;Raktelis;NYKŠTUKAI;2262854947;Ne;11;0;10;21
7346;Raktelis;NYKŠTUKAI;2278227649;Ne;6;2;0;8
7347;Raktelis;NYKŠTUKAI;3493159224;Ne;5;0;0;5
7348;Raktelis;PELIUKAI;2044812301;Ne;0;5;0;5
7349;Raktelis;PELIUKAI;7389910330;Ne;3;0;0;3
7350;Raktelis;PELIUKAI;8698736569;Taip;0;2;0;2
7351;Raktelis;PELIUKAI;9983004779;Taip;0;4;0;4
7352;Raktelis;PELIUKAI;6346741475;Ne;2;0;3;5
7353;Raktelis;PELIUKAI;7117319827;Ne;0;4;0;4
7354;Raktelis;PELIUKAI;4100807708;Ne;2;1;0;3
7355;Raktelis;PELIUKAI;9778807678;Ne;5;0;0;5
7356;Raktelis;PELIUKAI;2928040174;Ne;2;0;0;2
7357;Raktelis;PELIUKAI;5497606646;Ne;3;0;0;3
7358;Raktelis;PELIUKAI;4139932945;Ne;6;1;0;7
7359;Raktelis;PELIUKAI;8581379659;Ne;8;0;0;8
7360;Raktelis;AGUONOS;9039234219;Ne;8;0;0;8
7361;Raktelis;AGUONOS;3811586185;Ne;5;0;0;5
7362;Raktelis;AGUONOS;1714731965;Ne;7;0;0;7
7363;Raktelis;AGUONOS;9666909207;Ne;2;0;0;2
7364;Raktelis;AGUONOS;9992920721;Ne;1;0;0;1
7365;Raktelis;AGUONOS;3373893685;Ne;0;1;0;1
7366;Raktelis;AGUONOS;2949132578;Ne;5;0;0;5
7367;Raktelis;AGUONOS;4828942464;Ne;1;0;0;1
7368;Raktelis;AGUONOS;5686613002;Ne;4;0;0;4
7369;Raktelis;AGUONOS;5362472918;Ne;0;1;0;1
7370;Raktelis;AGUONOS;9205511475;Ne;10;0;0;10
7371;Raktelis;AGUONOS;1197236154;Ne;2;0;0;2
7372;Raktelis;AGUONOS;6019423312;Ne;3;0;0;3
7373;Raktelis;AGUONOS;2550528342;Ne;3;0;0;3
7374;Raktelis;LAPIUKŲ;3517484891;Ne;0;5;0;5
7375;Raktelis;LAPIUKŲ;1263150004;Taip;8;0;0;8
7376;Raktelis;LAPIUKŲ;1120263625;Ne;7;0;0;7
7377;Raktelis;LAPIUKŲ;5688795147;Ne;8;2;0;10
7378;Raktelis;LAPIUKŲ;8035618134;Ne;2;2;0;4
7379;Raktelis;LAPIUKŲ;8146076115;Ne;0;1;0;1
7380;Raktelis;LAPIUKŲ;1445359221;Ne;7;0;0;7
7381;Raktelis;LAPIUKŲ;1604357851;Ne;5;0;0;5
7382;Raktelis;LAPIUKŲ;9599034285;Ne;1;2;0;3
7383;Raktelis;LAPIUKŲ;3311870918;Ne;4;1;0;5
7384;Raktelis;LAPIUKŲ;6826993779;Ne;4;1;0;5
7385;Raktelis;LAPIUKŲ;2141128125;Ne;14;0;0;14
7386;Raktelis;LAPIUKŲ;4502236264;Ne;19;0;0;19
7387;Raktelis;LAPIUKŲ;2301442262;Ne;2;0;0;2
7388;Raktelis;LAPIUKŲ;6853881405;Ne;9;0;0;9
7389;Raktelis;LAPIUKŲ;4513031164;Ne;12;0;0;12
7390;Raktelis;PELĖDŽIUKAI;9716191639;Ne;2;2;0;4
7391;Raktelis;PELĖDŽIUKAI;1322912585;Ne;0;0;15;15
7392;Raktelis;PELĖDŽIUKAI;9130613710;Ne;0;3;0;3
7393;Raktelis;PELĖDŽIUKAI;9151796053;Ne;1;0;0;1
7394;Raktelis;PELĖDŽIUKAI;2282754345;Ne;0;4;0;4
7395;Raktelis;PELĖDŽIUKAI;8207675881;Ne;3;1;0;4
7396;Raktelis;PELĖDŽIUKAI;7869495911;Ne;0;2;0;2
7397;Raktelis;PELĖDŽIUKAI;5925441742;Ne;6;1;0;7
7398;Raktelis;PELĖDŽIUKAI;5082785025;Ne;5;0;0;5
7399;Raktelis;PELĖDŽIUKAI;3395720463;Ne;0;6;0;6
7400;Raktelis;PELĖDŽIUKAI;4167194960;Taip;0;2;0;2
7401;Raktelis;PELĖDŽIUKAI;2809458453;Ne;3;11;1;15
7402;Raktelis;PELĖDŽIUKAI;6894769625;Ne;5;0;0;5
7403;Raktelis;PELĖDŽIUKAI;2967941870;Taip;3;0;0;3
7404;Raktelis;PELĖDŽIUKAI;7440866459;Ne;3;1;0;4
7405;Raktelis;PELĖDŽIUKAI;4755892641;Taip;0;3;0;3
7406;Raktelis;MEŠKIUKAI;8851021346;Ne;10;0;0;10
7407;Raktelis;MEŠKIUKAI;4185763817;Ne;0;2;0;2
7408;Raktelis;MEŠKIUKAI;8341026400;Ne;0;1;0;1
7409;Raktelis;MEŠKIUKAI;2103900090;Ne;5;0;0;5
7410;Raktelis;MEŠKIUKAI;5718804414;Ne;8;0;0;8
7411;Raktelis;MEŠKIUKAI;2171952119;Ne;4;5;0;9
7412;Raktelis;MEŠKIUKAI;8515886073;Ne;2;0;0;2
7413;Raktelis;MEŠKIUKAI;1304479190;Ne;1;0;0;1
7414;Raktelis;MEŠKIUKAI;5358970156;Ne;3;0;0;3
7415;Rasa;Nykštukai;5176175108;Ne;2;0;0;2
7416;Rasa;Nykštukai;3979273111;Ne;0;1;0;1
7417;Rasa;Nykštukai;4847544355;Ne;0;1;0;1
7418;Rasa;Nykštukai;9723040721;Ne;0;1;0;1
7419;Rasa;Nykštukai;1223962374;Ne;1;0;0;1
7420;Rasa;Nykštukai;3200377629;Ne;8;0;0;8
7421;Rasa;Nykštukai;1336291828;Ne;0;3;0;3
7422;Rasa;Nykštukai;5861229664;Ne;0;1;0;1
7423;Rasa;Nykštukai;1386880644;Ne;0;1;0;1
7424;Rasa;Nykštukai;7228037580;Ne;4;0;0;4
7425;Rasa;Nykštukai;2540124793;Ne;0;1;0;1
7426;Rasa;Nykštukai;5363748728;Ne;0;1;0;1
7427;Rasa;Nykštukai;7520665472;Taip;5;1;0;6
7428;Rasa;Nykštukai;2190948879;Ne;5;2;0;7
7429;Rasa;Nykštukai;4010262461;Ne;0;0;1;1
7430;Rasa;Nykštukai;8236464670;Ne;5;0;0;5
7431;Rasa;Nykštukai;2333938367;Ne;1;1;0;2
7432;Rasa;Meškiukai;8378755600;Ne;0;20;0;20
7433;Rasa;Meškiukai;3073804713;Ne;0;0;5;5
7434;Rasa;Meškiukai;6691161322;Ne;0;0;1;1
7435;Rasa;Meškiukai;8740659600;Ne;0;21;0;21
7436;Rasa;Meškiukai;4127921417;Ne;3;0;1;4
7437;Rasa;Meškiukai;7357915584;Ne;0;7;0;7
7438;Rasa;Meškiukai;8314522373;Ne;0;4;0;4
7439;Rasa;Meškiukai;3548008659;Ne;7;3;0;10
7440;Rasa;Meškiukai;3773600344;Ne;0;0;2;2
7441;Rasa;Meškiukai;2371282781;Ne;0;0;2;2
7442;Rasa;Meškiukai;2555108465;Ne;0;15;0;15
7443;Rasa;Meškiukai;1992726664;Ne;0;10;0;10
7444;Rasa;Meškiukai;7843789214;Ne;0;5;0;5
7445;Rasa;Meškiukai;7637404588;Ne;5;0;4;9
7446;Rasa;Meškiukai;7502435359;Ne;0;3;0;3
7447;Rasa;Meškiukai;6853285570;Taip;0;5;0;5
7448;Rasa;Meškiukai;8674133653;Ne;13;0;1;14
7449;Rasa;Meškiukai;2840437821;Ne;3;1;0;4
7450;Rasa;Sauliukai;6891623055;Taip;1;2;0;3
7451;Rasa;Sauliukai;7220007488;Ne;0;0;1;1
7452;Rasa;Sauliukai;4498966097;Taip;0;0;1;1
7453;Rasa;Sauliukai;4734775151;Ne;10;3;0;13
7454;Rasa;Sauliukai;8235869241;Ne;6;2;0;8
7455;Rasa;Sauliukai;3428261829;Ne;0;1;0;1
7456;Rasa;Sauliukai;5426981046;Ne;3;2;1;6
7457;Rasa;Sauliukai;9220749889;Ne;0;1;0;1
7458;Rasa;Sauliukai;5885520521;Ne;0;1;0;1
7459;Rasa;Sauliukai;3631124501;Taip;8;2;0;10
7460;Rasa;Sauliukai;2477057223;Ne;0;5;0;5
7461;Rasa;Sauliukai;4913483444;Ne;4;1;0;5
7462;Rasa;Sauliukai;4084236196;Ne;0;2;0;2
7463;Rasa;Sauliukai;6411372006;Ne;12;0;1;13
7464;Rasa;Sauliukai;9157136735;Ne;0;0;3;3
7465;Rasa;Smalsučiai;9288967646;Ne;5;0;2;7
7466;Rasa;Smalsučiai;6307149426;Ne;3;0;3;6
7467;Rasa;Smalsučiai;8350239611;Ne;5;0;3;8
7468;Rasa;Smalsučiai;3867443155;Ne;5;0;2;7
7469;Rasa;Smalsučiai;2480847070;Ne;0;0;4;4
7470;Rasa;Smalsučiai;4828855802;Ne;7;0;3;10
7471;Rasa;Smalsučiai;7250512345;Ne;0;0;3;3
7472;Rasa;Smalsučiai;8204386619;Ne;0;0;2;2
7473;Rasa;Smalsučiai;1683652129;Taip;6;0;3;9
7474;Rasa;Smalsučiai;2368671762;Ne;6;0;1;7
7475;Rasa;Smalsučiai;7335907373;Ne;4;0;2;6
7476;Rasa;Smalsučiai;2647048529;Ne;9;0;4;13
7477;Rasa;Smalsučiai;8159424999;Ne;1;0;0;1
7478;Rasa;Smalsučiai;7901163117;Ne;9;0;3;12
7479;Rasa;"Pelėdžiukai ";8455168346;Ne;0;0;2;2
7480;Rasa;"Pelėdžiukai ";9056416308;Ne;0;2;0;2
7481;Rasa;"Pelėdžiukai ";5141906920;Ne;0;1;0;1
7482;Rasa;"Pelėdžiukai ";3381468321;Ne;0;2;0;2
7483;Rasa;"Pelėdžiukai ";1261868339;Ne;0;2;3;5
7484;Rasa;"Pelėdžiukai ";6553479199;Taip;4;2;0;6
7485;Rasa;"Pelėdžiukai ";4947382314;Ne;4;0;0;4
7486;Rasa;"Pelėdžiukai ";2968464121;Ne;2;2;0;4
7487;Rasa;"Pelėdžiukai ";5816940902;Taip;9;0;0;9
7488;Rasa;"Pelėdžiukai ";4389917247;Ne;0;11;0;11
7489;Rasa;"Pelėdžiukai ";8403268732;Ne;3;1;0;4
7490;Rasa;"Pelėdžiukai ";4855210006;Ne;0;2;0;2
7491;Rasa;"Pelėdžiukai ";4661651050;Ne;0;2;0;2
7492;Rasa;"Pelėdžiukai ";4453855861;Ne;3;1;0;4
7493;Rasa;"Pelėdžiukai ";4234198467;Taip;4;2;0;6
7494;Rasa;"Pelėdžiukai ";6874601830;Ne;7;4;0;11
7495;Rasa;Katinėliai;8622210603;Ne;0;5;0;5
7496;Rasa;Katinėliai;8574946856;Taip;0;8;0;8
7497;Rasa;Katinėliai;1477018184;Ne;0;0;3;3
7498;Rasa;Katinėliai;1521328997;Ne;0;2;1;3
7499;Rasa;Katinėliai;4018241056;Ne;0;1;0;1
7500;Rasa;Katinėliai;4762348187;Ne;0;1;0;1
7501;Rasa;Katinėliai;3884782148;Ne;3;0;1;4
7502;Rasa;Katinėliai;9230334839;Taip;0;0;1;1
7503;Rasa;Katinėliai;6755131948;Ne;0;7;0;7
7504;Rasa;Katinėliai;6442933249;Ne;0;5;0;5
7505;Rasa;Katinėliai;1736903037;Ne;0;2;5;7
7506;Rasa;Katinėliai;6656230158;Ne;5;0;0;5
7507;Rasa;Katinėliai;6640475278;Ne;4;0;1;5
7508;Rasa;Katinėliai;6856440701;Ne;0;0;15;15
7509;Rasa;Ančiukai;4427497247;Ne;6;0;2;8
7510;Rasa;Ančiukai;2683337738;Taip;0;0;4;4
7511;Rasa;Ančiukai;9938323938;Ne;4;1;0;5
7512;Rasa;Ančiukai;4872698495;Ne;1;0;0;1
7513;Rasa;"Vyturiukai ";7028605422;Taip;5;0;2;7
7514;Rasa;"Vyturiukai ";9599510902;Ne;0;0;1;1
7515;Rasa;"Vyturiukai ";5869253167;Ne;0;0;3;3
7516;Rasa;"Vyturiukai ";7037958994;Ne;2;0;0;2
7517;Rasa;"Vyturiukai ";8236785255;Ne;8;0;0;8
7518;Rasa;"Vyturiukai ";6887471189;Ne;0;0;9;9
7519;Rasa;"Vyturiukai ";2347639286;Ne;2;0;0;2
7520;Rasa;"Vyturiukai ";9788282861;Ne;7;0;1;8
7521;Rasa;"Vyturiukai ";2711923397;Ne;1;0;1;2
7522;Rasa;"Vyturiukai ";2769096357;Ne;7;0;2;9
7523;Rasa;"Vyturiukai ";6883073764;Ne;0;0;10;10
7524;Rasa;"Vyturiukai ";9706428782;Ne;3;6;0;9
7525;Rasa;"Vyturiukai ";6575864256;Taip;5;0;1;6
7526;Rasa;"Vyturiukai ";8296425777;Ne;3;0;2;5
7527;Rasa;"Vyturiukai ";7284349651;Ne;6;0;1;7
7528;Rasa;"Vyturiukai ";7265752821;Ne;3;0;1;4
7529;Rasa;"Vyturiukai ";2800420481;Ne;0;0;1;1
7530;Rasa;Voveriukai;4111850024;Ne;0;0;2;2
7531;Rasa;Voveriukai;1978999728;Ne;9;0;2;11
7532;Rasa;Voveriukai;3546684695;Ne;4;1;2;7
7533;Rasa;Voveriukai;5740754301;Ne;5;0;1;6
7534;Rasa;Voveriukai;5977524939;Ne;4;0;1;5
7535;Rasa;Voveriukai;1592174114;Ne;8;0;0;8
7536;Rasa;Voveriukai;1564194649;Ne;0;4;0;4
7537;Rasa;Voveriukai;1764959761;Ne;6;0;0;6
7538;Rasa;Voveriukai;1765617605;Ne;0;0;1;1
7539;Rasa;Voveriukai;1733179752;Ne;5;0;1;6
7540;Rasa;Voveriukai;2895124729;Taip;0;15;1;16
7541;Rasa;Voveriukai;8469342353;Ne;0;13;0;13
7542;Rasa;Voveriukai;5622110823;Ne;0;0;2;2
7543;Rasa;Voveriukai;6221754830;Ne;0;4;0;4
7544;Rasa;Voveriukai;7218250981;Ne;0;4;0;4
7545;Rasa;Voveriukai;7152769140;Taip;0;1;8;9
7546;Rasa;Voveriukai;1167373091;Taip;0;7;3;10
7547;Rasa;Voveriukai;2699865274;Taip;0;7;3;10
7548;Rasa;"DRUGELIAI ";6621628020;Ne;8;1;0;9
7549;Rasa;"DRUGELIAI ";9959160342;Ne;8;1;0;9
7550;Rasa;"DRUGELIAI ";5761013588;Ne;0;10;0;10
7551;Rasa;"DRUGELIAI ";7220103314;Ne;0;13;0;13
7552;Rasa;"DRUGELIAI ";9506388242;Ne;0;7;0;7
7553;Rasa;"DRUGELIAI ";4188303400;Ne;3;0;0;3
7554;Rasa;"DRUGELIAI ";5483943978;Taip;0;4;0;4
7555;Rasa;"DRUGELIAI ";7251815682;Taip;18;0;0;18
7556;Rasa;"DRUGELIAI ";8702962863;Ne;1;6;0;7
7557;Rasa;"DRUGELIAI ";6291089659;Taip;2;0;0;2
7558;Rasa;"DRUGELIAI ";1575522555;Ne;16;0;2;18
7559;Rasa;"DRUGELIAI ";2881055956;Ne;5;1;0;6
7560;Rasa;"DRUGELIAI ";3113010641;Ne;0;0;1;1
7561;Rasa;Zuikučiai;8027532547;Ne;7;4;0;11
7562;Rasa;Zuikučiai;3470054190;Taip;7;0;0;7
7563;Rasa;Zuikučiai;7253736220;Ne;9;0;0;9
7564;Rasa;Zuikučiai;4940758709;Ne;0;2;0;2
7565;Rasa;Zuikučiai;7091899236;Ne;12;1;0;13
7566;Rasa;Zuikučiai;6574998939;Ne;0;1;0;1
7567;Rasa;Zuikučiai;4212798846;Ne;0;2;0;2
7568;Rasa;Zuikučiai;6505001743;Ne;8;5;3;16
7569;Rasa;Zuikučiai;6780996150;Taip;4;10;0;14
7570;Rasa;Zuikučiai;8159411349;Ne;5;3;0;8
7571;Rasa;Zuikučiai;8992548689;Ne;9;3;0;12
7572;Rasa;Zuikučiai;1983112873;Ne;4;0;0;4
7573;Rasa;Zuikučiai;6650473677;Ne;2;0;0;2
7574;Rasa;Zuikučiai;4508356130;Ne;0;1;0;1
7575;Rasa;Zuikučiai;1843058886;Ne;0;7;0;7
7576;Rasa;Širdelė;3668598028;Ne;0;4;0;4
7577;Rasa;Širdelė;9560289781;Ne;0;1;0;1
7578;Rasa;Širdelė;5719253028;Ne;5;0;0;5
7579;Rasa;Širdelė;9140875020;Ne;0;12;0;12
7580;Rasa;Širdelė;5710220699;Ne;0;2;0;2
7581;Rasa;Širdelė;4694382836;Ne;0;6;0;6
7582;Rasa;Širdelė;1796573723;Ne;10;1;0;11
7583;Rasa;Širdelė;3535655117;Ne;0;6;0;6
7584;Rasa;Širdelė;4361959446;Ne;0;1;0;1
7585;Rasa;Širdelė;3215464914;Ne;5;2;0;7
7586;Rasa;Širdelė;6760723624;Ne;4;2;0;6
7587;Rasa;Širdelė;1447258806;Ne;4;10;0;14
7588;Rasa;Širdelė;1627996663;Ne;0;9;0;9
7589;Rasa;Širdelė;9884995175;Ne;1;0;0;1
7590;Rasa;Širdelė;3965976031;Ne;1;0;0;1
7591;Rasa;Širdelė;4982146852;Taip;0;6;0;6
7592;Rasa;Širdelė;4248042049;Taip;0;6;0;6
7593;Rasa;Širdelė;7604145882;Ne;0;1;0;1
7594;Rasa;Širdelė;9713743149;Ne;1;0;0;1
7595;Riešutėlis;Viščiukų;8413887888;Ne;4;0;0;4
7596;Riešutėlis;Viščiukų;7142412042;Ne;3;0;0;3
7597;Riešutėlis;Viščiukų;5659054276;Ne;4;4;0;8
7598;Riešutėlis;Viščiukų;7985174814;Ne;5;1;0;6
7599;Riešutėlis;Viščiukų;3508479107;Ne;10;4;0;14
7600;Riešutėlis;Viščiukų;6398881485;Ne;3;0;0;3
7601;Riešutėlis;Viščiukų;3040811647;Ne;1;2;0;3
7602;Riešutėlis;Viščiukų;4554875389;Ne;16;1;0;17
7603;Riešutėlis;Viščiukų;4533005769;Ne;4;1;10;15
7604;Riešutėlis;Viščiukų;3883149010;Taip;2;0;0;2
7605;Riešutėlis;Viščiukų;8049449033;Taip;3;1;0;4
7606;Riešutėlis;Viščiukų;1389302927;Ne;4;1;0;5
7607;Riešutėlis;Viščiukų;6105142818;Ne;0;2;0;2
7608;Riešutėlis;"Riešutėliai ";3800733442;Ne;5;0;0;5
7609;Riešutėlis;"Riešutėliai ";2117939721;Ne;3;0;0;3
7610;Riešutėlis;"Riešutėliai ";1343776985;Ne;11;0;0;11
7611;Riešutėlis;"Riešutėliai ";5915019363;Ne;0;8;0;8
7612;Riešutėlis;"Riešutėliai ";2207907790;Ne;5;0;0;5
7613;Riešutėlis;"Riešutėliai ";9699503472;Ne;12;0;0;12
7614;Riešutėlis;"Riešutėliai ";2098369052;Ne;2;0;0;2
7615;Riešutėlis;"Riešutėliai ";1426700414;Ne;9;1;0;10
7616;Riešutėlis;"Riešutėliai ";8539906445;Ne;10;0;0;10
7617;Riešutėlis;"Riešutėliai ";5873443383;Ne;8;0;0;8
7618;Riešutėlis;"Riešutėliai ";2301247729;Ne;4;4;0;8
7619;Riešutėlis;"Riešutėliai ";3602707130;Ne;3;2;0;5
7620;Riešutėlis;"Riešutėliai ";8991963843;Ne;18;0;0;18
7621;Riešutėlis;"Riešutėliai ";9318640304;Taip;3;1;0;4
7622;Riešutėlis;"Riešutėliai ";4293402095;Ne;5;1;0;6
7623;Riešutėlis;"Riešutėliai ";8917451081;Taip;6;2;0;8
7624;Riešutėlis;"Riešutėliai ";4698338374;Ne;5;0;0;5
7625;Riešutėlis;"Riešutėliai ";3345064565;Ne;2;0;0;2
7626;Riešutėlis;"Riešutėliai ";9078282526;Ne;5;2;0;7
7627;Riešutėlis;Ežiukai;5758442826;Taip;2;1;0;3
7628;Riešutėlis;Ežiukai;9888470246;Taip;2;1;0;3
7629;Riešutėlis;Ežiukai;6217500325;Ne;11;0;0;11
7630;Riešutėlis;Ežiukai;4042719626;Ne;2;0;0;2
7631;Riešutėlis;Ežiukai;1858791074;Ne;0;1;0;1
7632;Riešutėlis;Ežiukai;1006119133;Ne;0;1;0;1
7633;Riešutėlis;Ežiukai;3759837057;Ne;13;8;0;21
7634;Riešutėlis;Ežiukai;4740516426;Taip;6;6;0;12
7635;Riešutėlis;Ežiukai;5078051087;Ne;15;0;0;15
7636;Riešutėlis;Ežiukai;6580050526;Ne;1;1;0;2
7637;Riešutėlis;Ežiukai;4810919435;Ne;0;1;0;1
7638;Riešutėlis;Ežiukai;2736824231;Ne;5;0;0;5
7639;Riešutėlis;Ežiukai;2378301886;Ne;0;5;0;5
7640;Riešutėlis;Ežiukai;2483793992;Ne;0;2;0;2
7641;Riešutėlis;Ežiukai;5262881964;Ne;11;0;0;11
7642;Riešutėlis;Ežiukai;4328166135;Ne;3;2;0;5
7643;Riešutėlis;Ežiukai;9052991215;Ne;6;1;0;7
7644;Riešutėlis;Ežiukai;6318150385;Ne;0;7;0;7
7645;Riešutėlis;Pelėdžiukai;3975540383;Taip;2;0;0;2
7646;Riešutėlis;Pelėdžiukai;1705599429;Ne;1;0;0;1
7647;Riešutėlis;Pelėdžiukai;4116506453;Ne;1;0;0;1
7648;Riešutėlis;Pelėdžiukai;2467739101;Ne;7;0;0;7
7649;Riešutėlis;Pelėdžiukai;2587460110;Ne;13;0;0;13
7650;Riešutėlis;Pelėdžiukai;6147780439;Ne;7;0;0;7
7651;Riešutėlis;Pelėdžiukai;3287685792;Ne;6;0;0;6
7652;Riešutėlis;Pelėdžiukai;1811701628;Ne;4;0;0;4
7653;Riešutėlis;Pelėdžiukai;5183264581;Ne;3;2;0;5
7654;Riešutėlis;Pelėdžiukai;6121386391;Ne;12;0;0;12
7655;Riešutėlis;Pelėdžiukai;3251066115;Ne;8;1;0;9
7656;Riešutėlis;Pelėdžiukai;4808684145;Ne;0;1;0;1
7657;Riešutėlis;Pelėdžiukai;4897581681;Ne;17;0;0;17
7658;Riešutėlis;Pelėdžiukai;7256075146;Ne;16;1;0;17
7659;Riešutėlis;Pelėdžiukai;5443448616;Ne;0;5;0;5
7660;Riešutėlis;Pelėdžiukai;9598824163;Ne;0;1;0;1
7661;Riešutėlis;Pelėdžiukai;8839482370;Ne;10;0;0;10
7662;Riešutėlis;Pelėdžiukai;4692384639;Ne;10;0;0;10
7663;Riešutėlis;Meškiukai;7030346495;Ne;5;6;0;11
7664;Riešutėlis;Meškiukai;9750713954;Ne;6;0;0;6
7665;Riešutėlis;Meškiukai;3577669231;Ne;13;0;0;13
7666;Riešutėlis;Meškiukai;8066712255;Ne;2;0;0;2
7667;Riešutėlis;Meškiukai;2837471235;Ne;12;1;0;13
7668;Riešutėlis;Meškiukai;2699984170;Ne;1;1;0;2
7669;Riešutėlis;Meškiukai;7601776182;Ne;0;2;0;2
7670;Riešutėlis;Meškiukai;7050440691;Ne;0;2;0;2
7671;Riešutėlis;Meškiukai;6259158270;Ne;1;0;0;1
7672;Riešutėlis;Meškiukai;7381623086;Ne;3;2;1;6
7673;Riešutėlis;Meškiukai;6284614328;Ne;0;2;1;3
7674;Riešutėlis;Meškiukai;1548585448;Ne;10;0;0;10
7675;Riešutėlis;Meškiukai;5728858361;Ne;0;4;0;4
7676;Riešutėlis;Meškiukai;8954127616;Ne;0;2;3;5
7677;Riešutėlis;Meškiukai;2092933906;Ne;0;6;0;6
7678;Riešutėlis;Meškiukai;6813024366;Ne;0;2;0;2
7679;Riešutėlis;Meškiukai;3460145784;Ne;0;1;0;1
7680;Riešutėlis;Meškiukai;8480059272;Ne;0;4;0;4
7681;Riešutėlis;Meškiukai;8751571852;Ne;1;0;0;1
7682;Riešutėlis;Kiškučiai;9297835044;Taip;1;0;0;1
7683;Riešutėlis;Kiškučiai;9086474785;Ne;5;0;0;5
7684;Riešutėlis;Kiškučiai;3363757821;Ne;6;0;0;6
7685;Riešutėlis;Kiškučiai;2581250615;Ne;1;0;0;1
7686;Riešutėlis;Kiškučiai;8445984114;Taip;15;0;0;15
7687;Riešutėlis;Kiškučiai;5266946070;Ne;2;0;0;2
7688;Riešutėlis;Kiškučiai;9357375649;Ne;11;1;0;12
7689;Riešutėlis;Kiškučiai;9548551553;Ne;5;0;0;5
7690;Riešutėlis;Kiškučiai;9500744921;Ne;13;0;0;13
7691;Riešutėlis;Kiškučiai;4851336076;Ne;1;0;0;1
7692;Riešutėlis;Kiškučiai;6705754238;Ne;11;0;0;11
7693;Riešutėlis;Kiškučiai;1111543507;Ne;0;1;0;1
7694;Riešutėlis;Kiškučiai;9964105252;Ne;8;0;0;8
7695;Riešutėlis;Kiškučiai;6693197006;Ne;13;0;0;13
7696;Riešutėlis;Kiškučiai;5846061115;Ne;5;0;0;5
7697;Riešutėlis;Kiškučiai;9995814717;Ne;0;8;0;8
7698;Riešutėlis;Kiškučiai;3165015754;Ne;0;3;0;3
7699;Riešutėlis;Kiškučiai;5738764214;Ne;5;0;0;5
7700;Riešutėlis;Kiškučiai;1494363200;Ne;16;0;0;16
7701;Riešutėlis;Voveriukų;9864636983;Ne;6;0;0;6
7702;Riešutėlis;Voveriukų;5662911204;Ne;8;0;0;8
7703;Riešutėlis;Voveriukų;7663823906;Ne;8;3;0;11
7704;Riešutėlis;Voveriukų;1282121190;Ne;5;2;2;9
7705;Riešutėlis;Voveriukų;5336618381;Ne;0;2;0;2
7706;Riešutėlis;Voveriukų;7327578507;Ne;20;0;0;20
7707;Riešutėlis;Voveriukų;6368610810;Ne;11;0;0;11
7708;Riešutėlis;Voveriukų;2875416610;Ne;5;9;0;14
7709;Riešutėlis;Voveriukų;7313602281;Ne;5;0;1;6
7710;Riešutėlis;Voveriukų;9296178632;Ne;5;6;0;11
7711;Riešutėlis;Voveriukų;6681930005;Ne;11;0;1;12
7712;Riešutėlis;Voveriukų;7259198785;Ne;0;10;0;10
7713;Riešutėlis;Voveriukų;2352984379;Ne;8;0;0;8
7714;Riešutėlis;Voveriukų;2238641969;Ne;6;2;0;8
7715;Riešutėlis;Voveriukų;1058206787;Taip;0;0;2;2
7716;Riešutėlis;Voveriukų;9198289423;Ne;9;1;0;10
7717;Riešutėlis;Voveriukų;3340831522;Ne;17;0;1;18
7718;Riešutėlis;Saulutės;4004669930;Taip;4;0;0;4
7719;Riešutėlis;Saulutės;6721758785;Ne;0;2;1;3
7720;Riešutėlis;Saulutės;1748151109;Ne;0;6;0;6
7721;Riešutėlis;Saulutės;8738716660;Ne;1;2;0;3
7722;Riešutėlis;Saulutės;1196740726;Ne;3;2;0;5
7723;Riešutėlis;Saulutės;8415858895;Ne;7;1;3;11
7724;Riešutėlis;Saulutės;4498718519;Taip;6;1;1;8
7725;Riešutėlis;Saulutės;5753609922;Ne;10;1;0;11
7726;Riešutėlis;Saulutės;5013754772;Taip;1;1;1;3
7727;Riešutėlis;Saulutės;6468871352;Ne;3;4;0;7
7728;Riešutėlis;Saulutės;7154361660;Ne;13;0;0;13
7729;Riešutėlis;Saulutės;2395391926;Ne;1;5;0;6
7730;Riešutėlis;Saulutės;2572642260;Ne;7;0;1;8
7731;Riešutėlis;Saulutės;3544780386;Ne;2;0;1;3
7732;Riešutėlis;"Boruželės ";7666200219;Ne;10;1;0;11
7733;Riešutėlis;"Boruželės ";7071757771;Ne;8;0;0;8
7734;Riešutėlis;"Boruželės ";6626441225;Ne;9;0;0;9
7735;Riešutėlis;"Boruželės ";4426750525;Ne;5;0;0;5
7736;Riešutėlis;"Boruželės ";6906373822;Ne;13;0;0;13
7737;Riešutėlis;"Boruželės ";4636191548;Ne;0;10;1;11
7738;Riešutėlis;"Boruželės ";2734001106;Ne;13;0;0;13
7739;Riešutėlis;"Boruželės ";2493171003;Ne;16;0;2;18
7740;Riešutėlis;"Boruželės ";5133625078;Ne;0;3;0;3
7741;Riešutėlis;"Boruželės ";9341748384;Ne;14;0;0;14
7742;Riešutėlis;"Boruželės ";2235912189;Ne;9;0;0;9
7743;Riešutėlis;"Boruželės ";4429903561;Ne;0;0;1;1
7744;Riešutėlis;"Boruželės ";5317904812;Ne;10;0;0;10
7745;Riešutėlis;"Boruželės ";8235524536;Ne;11;0;0;11
7746;Riešutėlis;"Boruželės ";7795124495;Ne;8;0;0;8
7747;Riešutėlis;"Boruželės ";2832538856;Ne;5;2;2;9
7748;Riešutėlis;"Boruželės ";3730909181;Ne;10;0;0;10
7749;Riešutėlis;"Bitutės ";8498902448;Ne;9;1;0;10
7750;Riešutėlis;"Bitutės ";2498093110;Taip;4;0;0;4
7751;Riešutėlis;"Bitutės ";2459494071;Ne;2;1;0;3
7752;Riešutėlis;"Bitutės ";3931422170;Ne;0;2;0;2
7753;Riešutėlis;"Bitutės ";4591910912;Ne;5;0;0;5
7754;Riešutėlis;"Bitutės ";9285782325;Ne;13;1;0;14
7755;Riešutėlis;"Bitutės ";7473054556;Ne;0;4;0;4
7756;Riešutėlis;"Bitutės ";3475897400;Ne;10;0;0;10
7757;Riešutėlis;"Bitutės ";3592271009;Taip;0;2;0;2
7758;Riešutėlis;"Bitutės ";6815804556;Ne;0;1;0;1
7759;Riešutėlis;"Bitutės ";1626888090;Ne;0;1;0;1
7760;Riešutėlis;"Bitutės ";4358354602;Ne;2;6;0;8
7761;Riešutėlis;"Bitutės ";9903170301;Ne;0;1;0;1
7762;Riešutėlis;"Bitutės ";1842107341;Ne;14;0;0;14
7763;Riešutėlis;"Bitutės ";1033490929;Ne;7;0;0;7
7764;Riešutėlis;Drugelių;8266735624;Ne;0;1;0;1
7765;Riešutėlis;Drugelių;4776231497;Ne;0;1;0;1
7766;Riešutėlis;Drugelių;5811657782;Ne;2;0;0;2
7767;Riešutėlis;Drugelių;4221375847;Ne;0;7;0;7
7768;Riešutėlis;Drugelių;8845709386;Ne;0;4;0;4
7769;Riešutėlis;Drugelių;8180618419;Ne;0;1;0;1
7770;Riešutėlis;Drugelių;5412882446;Ne;2;0;0;2
7771;Riešutėlis;Drugelių;8020533200;Ne;4;2;0;6
7772;Riešutėlis;Drugelių;1164273595;Ne;0;6;0;6
7773;Riešutėlis;Drugelių;8918753084;Ne;0;2;1;3
7774;Riešutėlis;Drugelių;3836374000;Ne;0;1;0;1
7775;Riešutėlis;Drugelių;3151689985;Ne;0;6;0;6
7776;Riešutėlis;Drugelių;7225365172;Ne;8;0;0;8
7777;Riešutėlis;Nykštukų;3208422211;Ne;5;1;0;6
7778;Riešutėlis;Nykštukų;2133207806;Ne;0;16;0;16
7779;Riešutėlis;Nykštukų;2380936705;Ne;2;0;0;2
7780;Riešutėlis;Nykštukų;1227857842;Ne;8;2;0;10
7781;Riešutėlis;Nykštukų;8857997445;Ne;0;1;0;1
7782;Riešutėlis;Nykštukų;5296617022;Ne;4;0;0;4
7783;Riešutėlis;Nykštukų;9445150366;Ne;0;3;0;3
7784;Riešutėlis;Nykštukų;9977733313;Ne;9;2;0;11
7785;Riešutėlis;Nykštukų;4746769566;Ne;11;0;0;11
7786;Riešutėlis;Nykštukų;9415334673;Ne;8;0;0;8
7787;Rytas;Svirpliukų;8000993383;Ne;1;0;0;1
7788;Ramunėlė;SAULUTĖS;3852734401;Ne;1;2;0;3
7789;Ramunėlė;SAULUTĖS;1192743154;Ne;0;4;0;4
7790;Ramunėlė;SAULUTĖS;5714771643;Ne;0;2;0;2
7791;Ramunėlė;SAULUTĖS;1483391590;Ne;4;2;1;7
7792;Ramunėlė;SAULUTĖS;4209191105;Ne;0;2;0;2
7793;Ramunėlė;SAULUTĖS;9927068798;Ne;6;2;1;9
7794;Ramunėlė;SAULUTĖS;7219400182;Ne;9;2;0;11
7795;Ramunėlė;SAULUTĖS;3779769727;Ne;0;2;0;2
7796;Ramunėlė;SAULUTĖS;8912978935;Ne;0;1;0;1
7797;Ramunėlė;SAULUTĖS;1618282165;Ne;0;0;14;14
7798;Ramunėlė;SAULUTĖS;9533155706;Ne;3;2;0;5
7799;Ramunėlė;SAULUTĖS;6329943991;Ne;7;2;2;11
7800;Ramunėlė;SAULUTĖS;4677819736;Ne;0;2;1;3
7801;Ramunėlė;SAULUTĖS;6310921755;Ne;0;1;0;1
7802;Ramunėlė;SAULUTĖS;1568531299;Taip;0;2;0;2
7803;Ramunėlė;SAULUTĖS;4605161267;Ne;0;3;0;3
7804;Ramunėlė;ŽIBUTĖ;4715809064;Ne;0;1;0;1
7805;Ramunėlė;ŽIBUTĖ;5315953299;Ne;0;1;0;1
7806;Ramunėlė;ŽIBUTĖ;2173425836;Ne;5;2;0;7
7807;Ramunėlė;ŽIBUTĖ;2686455030;Ne;5;2;0;7
7808;Ramunėlė;ŽIBUTĖ;5650659504;Ne;0;1;0;1
7809;Ramunėlė;ŽIBUTĖ;6627399830;Ne;0;1;0;1
7810;Ramunėlė;ŽIBUTĖ;8726443989;Ne;0;2;0;2
7811;Ramunėlė;ŽIBUTĖ;6389008823;Ne;4;0;0;4
7812;Ramunėlė;ŽIBUTĖ;9136437288;Ne;0;2;0;2
7813;Ramunėlė;ŽIBUTĖ;6040461460;Ne;2;1;0;3
7814;Ramunėlė;ŽIBUTĖ;2605941371;Ne;0;2;0;2
7815;Ramunėlė;ŽIBUTĖ;7010828978;Ne;0;4;0;4
7816;Ramunėlė;ŽIBUTĖ;3879563193;Ne;0;4;0;4
7817;Ramunėlė;ŽIBUTĖ;2446375037;Ne;0;3;0;3
7818;Ramunėlė;ŽIBUTĖ;1671759939;Ne;0;1;0;1
7819;Ramunėlė;ŽIBUTĖ;3525444906;Ne;0;2;0;2
7820;Ramunėlė;ŽIRNIUKAI;7721421570;Ne;2;10;0;12
7821;Ramunėlė;ŽIRNIUKAI;8942483792;Ne;3;0;0;3
7822;Ramunėlė;ŽIRNIUKAI;6674467484;Ne;0;16;0;16
7823;Ramunėlė;ŽIRNIUKAI;7593855877;Ne;3;3;0;6
7824;Ramunėlė;ŽIRNIUKAI;2177200537;Ne;4;0;0;4
7825;Ramunėlė;ŽIRNIUKAI;7026935746;Ne;2;4;0;6
7826;Ramunėlė;ŽIRNIUKAI;5581693652;Ne;9;1;0;10
7827;Ramunėlė;ŽIRNIUKAI;4269170508;Ne;7;0;0;7
7828;Ramunėlė;ŽIRNIUKAI;7263195574;Ne;9;0;0;9
7829;Ramunėlė;ŽIRNIUKAI;4076525701;Ne;9;0;0;9
7830;Ramunėlė;ŽIRNIUKAI;4139935502;Ne;15;0;0;15
7831;Ramunėlė;ŽIRNIUKAI;1833069020;Ne;4;2;0;6
7832;Ramunėlė;ŽIRNIUKAI;4875011312;Ne;0;5;0;5
7833;Ramunėlė;ŽIRNIUKAI;4084046207;Ne;5;22;0;27
7834;Ramunėlė;ŽIRNIUKAI;2276657044;Ne;0;0;4;4
7835;Ramunėlė;ŽIRNIUKAI;5017020616;Ne;0;1;0;1
7836;Ramunėlė;ŽIRNIUKAI;6458458913;Ne;6;2;0;8
7837;Ramunėlė;ŽIRNIUKAI;6225605784;Taip;10;0;0;10
7838;Ramunėlė;ŽIRNIUKAI;4805808663;Ne;4;3;0;7
7839;Ramunėlė;ŽIRNIUKAI;7250951221;Ne;2;2;0;4
7840;Ramunėlė;BITUTĖS;5865482869;Taip;0;12;0;12
7841;Ramunėlė;BITUTĖS;7692958269;Ne;1;11;0;12
7842;Ramunėlė;BITUTĖS;9789690425;Ne;0;2;0;2
7843;Ramunėlė;BITUTĖS;1182350830;Ne;9;0;0;9
7844;Ramunėlė;BITUTĖS;6342801407;Ne;3;4;0;7
7845;Ramunėlė;BITUTĖS;4022818032;Ne;0;2;0;2
7846;Ramunėlė;BITUTĖS;1916520056;Ne;0;11;0;11
7847;Ramunėlė;BITUTĖS;2245564567;Ne;0;1;0;1
7848;Ramunėlė;BITUTĖS;6870110390;Ne;0;1;0;1
7849;Ramunėlė;BITUTĖS;6892481929;Ne;1;1;0;2
7850;Ramunėlė;BITUTĖS;6881228078;Ne;3;5;0;8
7851;Ramunėlė;BITUTĖS;9326288662;Ne;0;1;0;1
7852;Ramunėlė;BITUTĖS;3045477012;Ne;0;4;0;4
7853;Ramunėlė;BITUTĖS;8643188779;Ne;7;0;0;7
7854;Ramunėlė;BITUTĖS;3106987206;Ne;3;0;0;3
7855;Ramunėlė;BITUTĖS;4329292281;Ne;15;0;0;15
7856;Ramunėlė;BITUTĖS;9928703066;Ne;0;1;0;1
7857;Ramunėlė;BITUTĖS;4756689520;Ne;0;2;0;2
7858;Ramunėlė;DRUGELIAI;9984243153;Ne;9;5;0;14
7859;Ramunėlė;DRUGELIAI;4392309015;Ne;9;0;5;14
7860;Ramunėlė;DRUGELIAI;5049415445;Ne;12;5;4;21
7861;Ramunėlė;DRUGELIAI;8460527225;Ne;0;3;0;3
7862;Ramunėlė;DRUGELIAI;6809164145;Ne;10;1;0;11
7863;Ramunėlė;DRUGELIAI;6981729247;Ne;7;0;0;7
7864;Ramunėlė;DRUGELIAI;3683181174;Ne;10;7;0;17
7865;Ramunėlė;DRUGELIAI;6156792400;Ne;0;7;0;7
7866;Ramunėlė;DRUGELIAI;2983986428;Ne;13;0;0;13
7867;Ramunėlė;DRUGELIAI;5548358138;Ne;1;0;0;1
7868;Ramunėlė;DRUGELIAI;2427399083;Ne;0;1;0;1
7869;Ramunėlė;DRUGELIAI;2422656007;Ne;0;4;3;7
7870;Ramunėlė;DRUGELIAI;5153948802;Ne;1;0;0;1
7871;Ramunėlė;DRUGELIAI;4233978236;Ne;0;16;0;16
7872;Ramunėlė;DRUGELIAI;2558296296;Ne;11;0;0;11
7873;Ramunėlė;NEUŽMIRŠTUOLĖS;2070729684;Ne;0;3;0;3
7874;Ramunėlė;NEUŽMIRŠTUOLĖS;6613469006;Ne;5;8;0;13
7875;Ramunėlė;NEUŽMIRŠTUOLĖS;3742982547;Ne;0;1;0;1
7876;Ramunėlė;NEUŽMIRŠTUOLĖS;9012749913;Ne;0;14;0;14
7877;Ramunėlė;NEUŽMIRŠTUOLĖS;1728034615;Ne;2;1;0;3
7878;Ramunėlė;NEUŽMIRŠTUOLĖS;1579527330;Ne;0;3;0;3
7879;Ramunėlė;NEUŽMIRŠTUOLĖS;7519551613;Ne;0;5;0;5
7880;Ramunėlė;NEUŽMIRŠTUOLĖS;2880352109;Ne;5;1;0;6
7881;Ramunėlė;NEUŽMIRŠTUOLĖS;3949246652;Ne;13;0;0;13
7882;Ramunėlė;NEUŽMIRŠTUOLĖS;5267145991;Ne;0;12;0;12
7883;Ramunėlė;NEUŽMIRŠTUOLĖS;1181787182;Taip;0;9;0;9
7884;Ramunėlė;NEUŽMIRŠTUOLĖS;9374972014;Ne;2;2;0;4
7885;Ramunėlė;NEUŽMIRŠTUOLĖS;6849227110;Ne;5;3;0;8
7886;Ramunėlė;NEUŽMIRŠTUOLĖS;3792795591;Ne;0;2;0;2
7887;Ramunėlė;NEUŽMIRŠTUOLĖS;4862989594;Ne;0;1;0;1
7888;Ramunėlė;NEUŽMIRŠTUOLĖS;9758688249;Ne;7;0;0;7
7889;Ramunėlė;NEUŽMIRŠTUOLĖS;9945561827;Ne;9;0;0;9
7890;Ramunėlė;OBUOLIUKAI;6604244856;Ne;5;1;0;6
7891;Ramunėlė;OBUOLIUKAI;8617271247;Ne;0;8;0;8
7892;Ramunėlė;OBUOLIUKAI;6413888803;Ne;2;0;0;2
7893;Ramunėlė;OBUOLIUKAI;5610672420;Taip;13;1;0;14
7894;Ramunėlė;OBUOLIUKAI;4400154355;Ne;6;0;0;6
7895;Ramunėlė;OBUOLIUKAI;9861069932;Ne;2;1;0;3
7896;Ramunėlė;OBUOLIUKAI;4806844761;Taip;4;0;0;4
7897;Ramunėlė;OBUOLIUKAI;7639613472;Ne;15;0;0;15
7898;Ramunėlė;OBUOLIUKAI;4040520907;Ne;0;5;0;5
7899;Ramunėlė;OBUOLIUKAI;5573083546;Ne;2;2;0;4
7900;Ramunėlė;OBUOLIUKAI;1215510902;Ne;0;6;0;6
7901;Ramunėlė;OBUOLIUKAI;8218201930;Taip;9;21;0;30
7902;Ramunėlė;OBUOLIUKAI;4788062781;Ne;0;7;0;7
7903;Ramunėlė;OBUOLIUKAI;3166386231;Ne;6;2;0;8
7904;Ramunėlė;OBUOLIUKAI;4491147309;Ne;18;0;0;18
7905;Ramunėlė;SAULĖGRĄŽA;7836959157;Ne;0;0;1;1
7906;Ramunėlė;SAULĖGRĄŽA;2458101652;Ne;0;10;0;10
7907;Ramunėlė;SAULĖGRĄŽA;9663304288;Ne;0;0;2;2
7908;Ramunėlė;SAULĖGRĄŽA;5398069413;Ne;3;0;0;3
7909;Ramunėlė;SAULĖGRĄŽA;7873462803;Ne;9;0;0;9
7910;Ramunėlė;SAULĖGRĄŽA;3793779715;Ne;0;2;3;5
7911;Ramunėlė;SAULĖGRĄŽA;6775947111;Ne;6;0;24;30
7912;Ramunėlė;SAULĖGRĄŽA;1102946363;Ne;2;0;2;4
7913;Ramunėlė;SAULĖGRĄŽA;3801952385;Ne;0;1;0;1
7914;Ramunėlė;SAULĖGRĄŽA;9120142666;Taip;6;11;0;17
7915;Ramunėlė;SAULĖGRĄŽA;6942789511;Ne;0;0;1;1
7916;Ramunėlė;SAULĖGRĄŽA;2415377154;Ne;0;8;2;10
7917;Ramunėlė;SAULĖGRĄŽA;9076692864;Ne;3;4;0;7
7918;Ramunėlė;SAULĖGRĄŽA;3744140961;Ne;1;3;0;4
7919;Ramunėlė;SAULĖGRĄŽA;4177116924;Ne;3;0;0;3
7920;Ramunėlė;SAULĖGRĄŽA;1071166494;Ne;0;4;0;4
7921;Ramunėlė;SAULĖGRĄŽA;9656732273;Ne;0;0;2;2
7922;Ramunėlė;SAULĖGRĄŽA;6983139076;Taip;0;0;2;2
7923;Ramunėlė;SAULĖGRĄŽA;8045080504;Ne;9;2;0;11
7924;Ramunėlė;BORUŽĖLĖS;1818513881;Ne;9;0;4;13
7925;Ramunėlė;BORUŽĖLĖS;4581826404;Ne;5;0;0;5
7926;Ramunėlė;BORUŽĖLĖS;8310875815;Ne;0;1;0;1
7927;Ramunėlė;BORUŽĖLĖS;1491688322;Ne;5;3;0;8
7928;Ramunėlė;BORUŽĖLĖS;6606966969;Taip;0;10;0;10
7929;Ramunėlė;BORUŽĖLĖS;9934852622;Ne;0;6;0;6
7930;Ramunėlė;BORUŽĖLĖS;9292235402;Taip;4;0;0;4
7931;Ramunėlė;BORUŽĖLĖS;3996453947;Ne;0;4;0;4
7932;Ramunėlė;BORUŽĖLĖS;3461269451;Ne;0;3;0;3
7933;Ramunėlė;BORUŽĖLĖS;3474578046;Ne;5;1;0;6
7934;Ramunėlė;BORUŽĖLĖS;7544671346;Ne;0;8;0;8
7935;Ramunėlė;BORUŽĖLĖS;5544992493;Ne;0;1;0;1
7936;Ramunėlė;BORUŽĖLĖS;6433856416;Ne;0;12;0;12
7937;Ramunėlė;BORUŽĖLĖS;3542912372;Ne;17;2;0;19
7938;Ramunėlė;BORUŽĖLĖS;1159457001;Ne;9;1;0;10
7939;Ramunėlė;BORUŽĖLĖS;3735308599;Ne;4;0;0;4
7940;Ramunėlė;BORUŽĖLĖS;3272747656;Ne;4;1;0;5
7941;Ramunėlė;BORUŽĖLĖS;6347893013;Taip;0;1;0;1
7942;Ramunėlė;BORUŽĖLĖS;1811931985;Ne;0;4;0;4
7943;Ramunėlė;NYKŠTUKAS;9549605315;Ne;2;9;0;11
7944;Ramunėlė;NYKŠTUKAS;7542328641;Ne;3;0;0;3
7945;Ramunėlė;NYKŠTUKAS;1277413234;Ne;0;1;0;1
7946;Ramunėlė;NYKŠTUKAS;7715458376;Ne;3;0;0;3
7947;Ramunėlė;NYKŠTUKAS;2874729290;Ne;5;0;0;5
7948;Ramunėlė;NYKŠTUKAS;5011852981;Ne;3;0;0;3
7949;Ramunėlė;NYKŠTUKAS;7049941095;Ne;1;0;0;1
7950;Ramunėlė;NYKŠTUKAS;7958270513;Ne;5;0;0;5
7951;Ramunėlė;NYKŠTUKAS;9005050527;Ne;5;0;0;5
7952;Ramunėlė;NYKŠTUKAS;2521516332;Ne;11;0;0;11
7953;Ramunėlė;UOGELĖ;9765904825;Ne;14;0;0;14
7954;Ramunėlė;UOGELĖ;5934414699;Ne;10;0;0;10
7955;Ramunėlė;UOGELĖ;3097478921;Ne;15;0;5;20
7956;Ramunėlė;UOGELĖ;1962502699;Ne;4;0;9;13
7957;Ramunėlė;UOGELĖ;2652236809;Ne;0;0;1;1
7958;Ramunėlė;UOGELĖ;9603368652;Ne;10;0;1;11
7959;Ramunėlė;UOGELĖ;3838004754;Ne;0;0;3;3
7960;Ramunėlė;UOGELĖ;3037286125;Ne;11;0;0;11
7961;Ramunėlė;UOGELĖ;5196627958;Taip;0;0;1;1
7962;Ramunėlė;UOGELĖ;1346734609;Ne;2;10;0;12
7963;Ramunėlė;UOGELĖ;8538153845;Ne;1;0;7;8
7964;Ramunėlė;VARPELIAI;8023404173;Taip;0;1;0;1
7965;Ramunėlė;VARPELIAI;7005354909;Ne;0;3;0;3
7966;Ramunėlė;VARPELIAI;5665429647;Ne;5;0;0;5
7967;Ramunėlė;VARPELIAI;4946797276;Ne;0;5;0;5
7968;Ramunėlė;VARPELIAI;9180197156;Ne;3;0;0;3
7969;Ramunėlė;VARPELIAI;5108864184;Ne;3;0;0;3
7970;Ramunėlė;VARPELIAI;4321527067;Taip;7;4;0;11
7971;Ramunėlė;VARPELIAI;2202879286;Ne;2;2;0;4
7972;Ramunėlė;VARPELIAI;1666033483;Ne;7;2;0;9
7973;Ramunėlė;VARPELIAI;7896711579;Ne;3;3;0;6
7974;Ramunėlė;VARPELIAI;9994601365;Taip;12;3;0;15
7975;Ramunėlė;VARPELIAI;2620747378;Ne;3;0;0;3
7976;Ramunėlė;VARPELIAI;5726947811;Ne;0;2;0;2
7977;Ramunėlė;VARPELIAI;4171905362;Ne;0;4;0;4
7978;Ramunėlė;VARPELIAI;8764042799;Ne;3;5;0;8
7979;Ramunėlė;VARPELIAI;7926168752;Taip;11;0;1;12
7980;Ramunėlė;VARPELIAI;5498856861;Ne;6;0;0;6
7981;Ramunėlė;VARPELIAI;3024065664;Ne;0;4;0;4
7982;Ramunėlė;VARPELIAI;4397072823;Ne;2;0;3;5
7983;Rūta;SMALSUČIAI;2601011765;Taip;14;0;1;15
7984;Rūta;SMALSUČIAI;5902965224;Ne;0;0;2;2
7985;Rūta;SMALSUČIAI;5579794648;Ne;6;4;0;10
7986;Rūta;SMALSUČIAI;7837861265;Taip;7;0;1;8
7987;Rūta;SMALSUČIAI;9471291067;Ne;8;1;0;9
7988;Rūta;SMALSUČIAI;4165080541;Ne;11;0;0;11
7989;Rūta;SMALSUČIAI;8012225409;Ne;6;0;0;6
7990;Rūta;SMALSUČIAI;3877807687;Taip;14;0;0;14
7991;Rūta;SMALSUČIAI;9429856388;Ne;5;0;0;5
7992;Rūta;SMALSUČIAI;8483916287;Ne;11;0;1;12
7993;Rūta;SMALSUČIAI;1290867375;Ne;5;2;0;7
7994;Rūta;SMALSUČIAI;4780828296;Ne;0;0;4;4
7995;Rūta;SMALSUČIAI;2830990163;Ne;2;0;0;2
7996;Rūta;SMALSUČIAI;7724451685;Ne;0;4;0;4
7997;Rūta;SMALSUČIAI;8320791295;Ne;5;0;0;5
7998;Rūta;SMALSUČIAI;3109709043;Ne;12;0;1;13
7999;Rūta;SMALSUČIAI;2733932207;Taip;5;1;0;6
8000;Rūta;KŪLVERSTUKAI;5002760763;Ne;3;0;0;3
8001;Rūta;KŪLVERSTUKAI;4440148328;Ne;10;1;0;11
8002;Rūta;KŪLVERSTUKAI;1059126758;Ne;0;9;0;9
8003;Rūta;KŪLVERSTUKAI;6417693659;Ne;4;1;2;7
8004;Rūta;KŪLVERSTUKAI;3352007694;Ne;0;3;0;3
8005;Rūta;KŪLVERSTUKAI;4090915728;Ne;0;2;0;2
8006;Rūta;KŪLVERSTUKAI;4466522924;Ne;10;0;0;10
8007;Rūta;KŪLVERSTUKAI;7905893575;Ne;13;1;0;14
8008;Rūta;KŪLVERSTUKAI;4776631890;Ne;6;0;0;6
8009;Rūta;KŪLVERSTUKAI;1260386759;Ne;0;2;0;2
8010;Rūta;KŪLVERSTUKAI;4208678278;Ne;11;1;0;12
8011;Rūta;KŪLVERSTUKAI;6044060646;Ne;6;3;0;9
8012;Rūta;KŪLVERSTUKAI;1671179652;Ne;5;1;0;6
8013;Rūta;KŪLVERSTUKAI;5109026000;Ne;0;1;0;1
8014;Rūta;KŪLVERSTUKAI;9012256437;Ne;3;1;0;4
8015;Rūta;KODĖLČIUKAI;5962981130;Ne;9;0;0;9
8016;Rūta;KODĖLČIUKAI;3736279705;Ne;9;0;0;9
8017;Rūta;KODĖLČIUKAI;8416455711;Ne;0;4;0;4
8018;Rūta;KODĖLČIUKAI;8668510009;Ne;2;0;0;2
8019;Rūta;KODĖLČIUKAI;2547849837;Ne;5;1;1;7
8020;Rūta;KODĖLČIUKAI;9501101073;Ne;7;0;4;11
8021;Rūta;KODĖLČIUKAI;8883578144;Ne;0;10;1;11
8022;Rūta;KODĖLČIUKAI;4546082355;Ne;0;1;0;1
8023;Rūta;KODĖLČIUKAI;1000645885;Ne;0;0;1;1
8024;Rūta;KODĖLČIUKAI;5766392854;Ne;0;9;0;9
8025;Rūta;KODĖLČIUKAI;9916296056;Ne;0;0;3;3
8026;Rūta;KODĖLČIUKAI;4656138649;Taip;0;0;2;2
8027;Rūta;KODĖLČIUKAI;1605412505;Taip;6;0;0;6
8028;Rūta;KODĖLČIUKAI;4533816630;Ne;5;0;0;5
8029;Rūta;KODĖLČIUKAI;8455941633;Ne;4;0;5;9
8030;Rūta;KODĖLČIUKAI;8120157087;Ne;5;0;0;5
8031;Rūta;BORUŽĖLĖS;7712500278;Ne;5;0;3;8
8032;Rūta;BORUŽĖLĖS;3898579878;Ne;0;1;0;1
8033;Rūta;BORUŽĖLĖS;8945868791;Taip;15;0;1;16
8034;Rūta;BORUŽĖLĖS;3348066709;Ne;3;0;1;4
8035;Rūta;BORUŽĖLĖS;4279367893;Taip;0;0;2;2
8036;Rūta;BORUŽĖLĖS;5141290453;Taip;10;4;0;14
8037;Rūta;BORUŽĖLĖS;8303314520;Ne;9;0;0;9
8038;Rūta;BORUŽĖLĖS;3470052541;Ne;13;1;0;14
8039;Rūta;BORUŽĖLĖS;2625691851;Ne;0;0;1;1
8040;Rūta;BORUŽĖLĖS;1804222979;Taip;6;0;0;6
8041;Rūta;BORUŽĖLĖS;5624054621;Ne;1;0;0;1
8042;Rūta;BORUŽĖLĖS;2373746441;Ne;1;0;0;1
8043;Rūta;BORUŽĖLĖS;2724625200;Ne;5;0;0;5
8044;Rūta;BORUŽĖLĖS;2118244290;Ne;2;0;2;4
8045;Rūta;BORUŽĖLĖS;2492891254;Ne;15;0;0;15
8046;Rūta;BORUŽĖLĖS;4204930257;Ne;9;0;0;9
8047;Rūta;VYTURĖLIAI;7680605199;Taip;11;0;1;12
8048;Rūta;VYTURĖLIAI;9386595365;Ne;0;0;4;4
8049;Rūta;VYTURĖLIAI;5899860543;Ne;0;2;0;2
8050;Rūta;VYTURĖLIAI;4728904136;Ne;0;6;0;6
8051;Rūta;VYTURĖLIAI;9791861646;Ne;0;0;4;4
8052;Rūta;VYTURĖLIAI;2928803089;Ne;0;2;0;2
8053;Rūta;VYTURĖLIAI;1951202550;Taip;0;0;2;2
8054;Rūta;VYTURĖLIAI;9911151238;Ne;0;3;0;3
8055;Rūta;VYTURĖLIAI;7434152435;Ne;3;0;0;3
8056;Rūta;VYTURĖLIAI;1035527190;Ne;2;0;0;2
8057;Rūta;VYTURĖLIAI;3843325181;Ne;0;4;0;4
8058;Rūta;VYTURĖLIAI;8182243701;Ne;0;0;2;2
8059;Rūta;VYTURĖLIAI;8763382361;Ne;0;7;0;7
8060;Rūta;VYTURĖLIAI;8277677952;Taip;3;0;0;3
8061;Rūta;"PABIRUČIAI (LOGOPEDINĖ)";5211104903;Ne;0;5;0;5
8062;Rūta;"PABIRUČIAI (LOGOPEDINĖ)";1734479058;Ne;0;0;1;1
8063;Rūta;"PABIRUČIAI (LOGOPEDINĖ)";4271185150;Ne;9;0;1;10
8064;Rūta;GUDRUČIAI;4044349935;Ne;6;0;0;6
8065;Rūta;GUDRUČIAI;3998791775;Ne;10;0;1;11
8066;Rūta;GUDRUČIAI;3043164521;Ne;3;2;0;5
8067;Rūta;GUDRUČIAI;3462986405;Ne;0;1;0;1
8068;Rūta;GUDRUČIAI;4473591998;Ne;0;2;0;2
8069;Rūta;GUDRUČIAI;3044976169;Ne;0;0;1;1
8070;Rūta;GUDRUČIAI;2546023973;Ne;0;0;1;1
8071;Rūta;GUDRUČIAI;8273644943;Ne;0;2;0;2
8072;Rūta;GUDRUČIAI;3454881685;Ne;0;0;2;2
8073;Rūta;GUDRUČIAI;1510268514;Ne;0;1;0;1
8074;Rūta;GUDRUČIAI;6814051598;Taip;0;1;0;1
8075;Rūta;GUDRUČIAI;2702537976;Ne;0;1;0;1
8076;Rūta;GUDRUČIAI;2772130413;Ne;0;4;0;4
8077;Rūta;GUDRUČIAI;8592528906;Ne;0;0;1;1
8078;Rūta;GUDRUČIAI;1182222976;Ne;0;0;1;1
8079;Rūta;SEKLYTĖLĖ;4423305209;Ne;0;1;0;1
8080;Rūta;SEKLYTĖLĖ;9245618776;Ne;5;0;0;5
8081;Rūta;SEKLYTĖLĖ;1216786487;Ne;0;2;0;2
8082;Rūta;SEKLYTĖLĖ;9736567509;Ne;0;3;0;3
8083;Rūta;SEKLYTĖLĖ;7519931138;Ne;0;1;0;1
8084;Rūta;SEKLYTĖLĖ;4880804625;Ne;0;3;0;3
8085;Rūta;SEKLYTĖLĖ;3055345528;Ne;0;1;0;1
8086;Rūta;SEKLYTĖLĖ;3499727608;Ne;0;2;0;2
8087;Rūta;SEKLYTĖLĖ;9765301038;Ne;0;2;0;2
8088;Rūta;SEKLYTĖLĖ;9638495757;Taip;0;3;0;3
8089;Rūta;SEKLYTĖLĖ;1962172243;Ne;0;1;0;1
8090;Rūta;SEKLYTĖLĖ;8605070655;Ne;0;7;0;7
8091;Rūta;SEKLYTĖLĖ;7553844890;Ne;0;8;0;8
8092;Rūta;SEKLYTĖLĖ;3964922552;Ne;3;0;0;3
8093;Rūta;SEKLYTĖLĖ;8395765508;Ne;1;0;0;1
8094;Rūta;SEKLYTĖLĖ;5109138407;Taip;6;0;0;6
8095;Rūta;SEKLYTĖLĖ;9400586178;Ne;0;3;0;3
8096;Rūta;SEKLYTĖLĖ;3956912957;Ne;6;0;0;6
8097;Rūta;SEKLYTĖLĖ;2474991135;Ne;4;2;0;6
8098;Rūta;"VARPELIAI (LOGOPEDINĖ)";4911219947;Ne;7;0;0;7
8099;Rūta;"VARPELIAI (LOGOPEDINĖ)";9171781646;Ne;0;0;1;1
8100;Rūta;"VARPELIAI (LOGOPEDINĖ)";6221528830;Ne;7;0;0;7
8101;Rūta;"VARPELIAI (LOGOPEDINĖ)";5871960113;Ne;1;0;1;2
8102;Rūta;"VARPELIAI (LOGOPEDINĖ)";3814794448;Ne;0;0;2;2
8103;Rūta;"VARPELIAI (LOGOPEDINĖ)";1029871210;Ne;0;0;1;1
8104;Rūta;"VARPELIAI (LOGOPEDINĖ)";6572172779;Ne;5;0;1;6
8105;Rūta;"VARPELIAI (LOGOPEDINĖ)";7946139474;Ne;0;4;0;4
8106;Rūta;"VARPELIAI (LOGOPEDINĖ)";4931253729;Ne;0;0;3;3
8107;Rūta;KIŠKUČIŲ;6587625933;Ne;5;1;0;6
8108;Rūta;KIŠKUČIŲ;9526121339;Ne;6;0;0;6
8109;Rūta;KIŠKUČIŲ;3805738277;Ne;7;0;1;8
8110;Rūta;KIŠKUČIŲ;8038977034;Ne;4;0;0;4
8111;Rūta;KIŠKUČIŲ;6019344201;Taip;10;0;0;10
8112;Rūta;KIŠKUČIŲ;4712457100;Ne;5;0;2;7
8113;Rūta;KIŠKUČIŲ;8370305271;Ne;6;0;0;6
8114;Rūta;KIŠKUČIŲ;4244665683;Ne;5;0;1;6
8115;Rūta;KIŠKUČIŲ;1504057906;Ne;0;0;2;2
8116;Rūta;KIŠKUČIŲ;9842173401;Ne;0;0;4;4
8117;Rūta;KIŠKUČIŲ;2895194578;Taip;6;0;0;6
8118;Rūta;KIŠKUČIŲ;1893871283;Ne;3;0;1;4
8119;Rūta;KIŠKUČIŲ;8711505500;Ne;0;0;1;1
8120;Rūta;KIŠKUČIŲ;7694633171;Ne;5;0;0;5
8121;Rūta;KIŠKUČIŲ;2534754132;Ne;0;0;1;1
8122;Rūta;ŽVIRBLIUKAI;6778088225;Ne;2;1;4;7
8123;Rūta;ŽVIRBLIUKAI;1397028236;Ne;0;0;2;2
8124;Rūta;ŽVIRBLIUKAI;6567603848;Ne;0;0;2;2
8125;Rūta;ŽVIRBLIUKAI;7913626224;Ne;5;0;0;5
8126;Rūta;ŽVIRBLIUKAI;9803391980;Ne;4;0;0;4
8127;Rūta;ŽVIRBLIUKAI;4512761439;Ne;0;0;3;3
8128;Rūta;ŽVIRBLIUKAI;9695283747;Ne;14;0;0;14
8129;Rūta;ŽVIRBLIUKAI;1184265720;Ne;0;0;3;3
8130;Rūta;ŽVIRBLIUKAI;8423092171;Ne;0;0;2;2
8131;Rūta;ŽVIRBLIUKAI;5375565821;Ne;0;0;1;1
8132;Rūta;SAULUTĖS;6585842434;Ne;6;0;2;8
8133;Rūta;SAULUTĖS;8806743371;Ne;0;0;1;1
8134;Rūta;SAULUTĖS;2391120026;Ne;0;0;1;1
8135;Rūta;SAULUTĖS;7762509383;Ne;0;2;1;3
8136;Rūta;SAULUTĖS;2685515977;Ne;14;0;0;14
8137;Rūta;SAULUTĖS;5512946296;Ne;0;13;0;13
8138;Rūta;SAULUTĖS;9308127402;Ne;0;0;6;6
8139;Rūta;SAULUTĖS;7422059414;Taip;0;10;0;10
8140;Rūta;SAULUTĖS;8571905994;Ne;0;2;4;6
8141;Rūta;SAULUTĖS;8479424939;Ne;10;0;1;11
8142;Rūta;SAULUTĖS;9014433476;Ne;0;1;0;1
8143;Rūta;SAULUTĖS;1207463357;Ne;3;0;2;5
8144;Rūta;SAULUTĖS;1131910047;Ne;0;0;21;21
8145;Rūta;SAULUTĖS;8715921452;Ne;0;0;2;2
8146;Rūta;SAULUTĖS;9243332756;Ne;0;2;0;2
8147;Sadutė;Kiškučiai;1589424708;Ne;0;1;0;1
8148;Sadutė;Kiškučiai;5992865266;Ne;5;1;0;6
8149;Sadutė;Kiškučiai;3568132830;Ne;17;0;0;17
8150;Sadutė;Kiškučiai;2087489114;Ne;3;0;0;3
8151;Sadutė;Kiškučiai;4360361866;Taip;5;1;0;6
8152;Sadutė;Kiškučiai;2139177648;Ne;5;0;0;5
8153;Sadutė;Kiškučiai;6493110772;Ne;3;1;0;4
8154;Sadutė;Kiškučiai;8397295024;Ne;5;0;0;5
8155;Sadutė;Kiškučiai;3285448692;Ne;1;1;0;2
8156;Sadutė;Kiškučiai;2845125335;Ne;1;1;0;2
8157;Sadutė;Kiškučiai;4135398332;Ne;6;1;0;7
8158;Sadutė;Kiškučiai;1860645542;Taip;2;1;0;3
8159;Sadutė;Kiškučiai;8841564884;Ne;0;2;0;2
8160;Sadutė;Kiškučiai;8350900604;Ne;10;0;0;10
8161;Sadutė;Kiškučiai;2807949826;Ne;2;2;0;4
8162;Sadutė;Boružėlės;9115304973;Ne;0;2;0;2
8163;Sadutė;Boružėlės;1273355194;Ne;0;6;0;6
8164;Sadutė;Boružėlės;3119547420;Ne;0;6;0;6
8165;Sadutė;Boružėlės;8987528237;Ne;0;0;2;2
8166;Sadutė;Boružėlės;6994383907;Ne;0;0;3;3
8167;Sadutė;Boružėlės;8914509685;Ne;0;0;1;1
8168;Sadutė;Boružėlės;3875265137;Ne;0;0;4;4
8169;Sadutė;Boružėlės;5992119777;Ne;0;3;0;3
8170;Sadutė;Boružėlės;5682745869;Ne;0;0;3;3
8171;Sadutė;Boružėlės;7072437339;Ne;4;0;0;4
8172;Sadutė;Boružėlės;3362830536;Ne;2;3;0;5
8173;Sadutė;Boružėlės;5395676303;Ne;0;0;2;2
8174;Sadutė;Boružėlės;5698462283;Taip;0;0;2;2
8175;Sadutė;Boružėlės;3845369333;Ne;8;0;2;10
8176;Sadutė;Boružėlės;4696990344;Ne;2;0;1;3
8177;Sadutė;Boružėlės;1753849762;Taip;0;0;4;4
8178;Sadutė;Boružėlės;7580736252;Taip;0;0;3;3
8179;Sadutė;Bitutės;1759479328;Ne;0;0;7;7
8180;Sadutė;Bitutės;1873928395;Ne;5;0;1;6
8181;Sadutė;Bitutės;5866461096;Ne;0;5;1;6
8182;Sadutė;Bitutės;4883934480;Ne;0;0;3;3
8183;Sadutė;Bitutės;7097653016;Ne;6;0;0;6
8184;Sadutė;Bitutės;4479315578;Ne;0;0;1;1
8185;Sadutė;Bitutės;2020766695;Ne;0;21;0;21
8186;Sadutė;Bitutės;5011320850;Ne;0;0;2;2
8187;Sadutė;Bitutės;5973513916;Ne;5;0;2;7
8188;Sadutė;Bitutės;3361904803;Ne;12;0;0;12
8189;Sadutė;Bitutės;1231048342;Ne;0;1;0;1
8190;Sadutė;Bitutės;8556086501;Ne;3;0;0;3
8191;Sadutė;Bitutės;6066145909;Ne;8;0;2;10
8192;Sadutė;Bitutės;5142566738;Ne;0;0;5;5
8193;Sadutė;Bitutės;8662375739;Taip;15;0;1;16
8194;Sadutė;Bitutės;9692905987;Ne;0;21;0;21
8195;Sadutė;Bitutės;9107727583;Ne;3;0;0;3
8196;Sadutė;Bitutės;6138604955;Taip;4;0;1;5
8197;Sadutė;Bitutės;3339522259;Ne;2;0;0;2
8198;Sadutė;Drugeliai;2965270548;Ne;2;0;0;2
8199;Sadutė;Drugeliai;6039555589;Ne;7;0;1;8
8200;Sadutė;Drugeliai;3450873020;Ne;2;0;0;2
8201;Sadutė;Drugeliai;5133144667;Ne;0;0;1;1
8202;Sadutė;Drugeliai;1907291315;Ne;0;0;1;1
8203;Sadutė;Drugeliai;3540727678;Ne;5;0;0;5
8204;Sadutė;Pėledžiukai;2705458480;Ne;3;0;2;5
8205;Sadutė;Pėledžiukai;6314488650;Taip;4;0;0;4
8206;Sadutė;Pėledžiukai;6126235707;Ne;9;0;1;10
8207;Sadutė;Pėledžiukai;1537482438;Ne;0;6;0;6
8208;Sadutė;Pėledžiukai;6716550703;Ne;0;0;1;1
8209;Sadutė;Pėledžiukai;7551299839;Ne;5;6;0;11
8210;Sadutė;Pėledžiukai;8914706717;Ne;0;0;1;1
8211;Sadutė;Pėledžiukai;6379705269;Ne;0;0;1;1
8212;Sadutė;Pėledžiukai;5385678913;Taip;3;1;1;5
8213;Sadutė;Pėledžiukai;2747256989;Ne;0;0;1;1
8214;Sadutė;Pėledžiukai;3277826759;Ne;0;0;1;1
8215;Sadutė;Pėledžiukai;2003300961;Ne;0;0;1;1
8216;Sadutė;Pėledžiukai;6430493524;Ne;2;0;0;2
8217;Sadutė;Pėledžiukai;1510498753;Ne;2;0;0;2
8218;Sadutė;Kačiukų;1903961488;Ne;0;0;1;1
8219;Sadutė;Kačiukų;2890916313;Ne;3;1;0;4
8220;Sadutė;Kačiukų;6253351299;Ne;0;0;2;2
8221;Sadutė;Kačiukų;5438448926;Ne;2;0;0;2
8222;Sadutė;Kačiukų;8974374101;Ne;0;0;1;1
8223;Sadutė;Kačiukų;4401870028;Ne;0;0;2;2
8224;Sadutė;Kačiukų;8770727233;Ne;0;0;2;2
8225;Sadutė;Kačiukų;5267093203;Ne;10;0;7;17
8226;Sadutė;Kačiukų;5614758320;Ne;0;14;0;14
8227;Sadutė;Kačiukų;2194387139;Ne;3;0;0;3
8228;Sakalėlis;GIRINUKŲ;6597274376;Ne;6;0;1;7
8229;Sakalėlis;GIRINUKŲ;5500248048;Ne;0;0;1;1
8230;Sakalėlis;GIRINUKŲ;8562164673;Ne;1;1;2;4
8231;Sakalėlis;GIRINUKŲ;1121818878;Ne;6;2;1;9
8232;Sakalėlis;GIRINUKŲ;3570413330;Ne;6;0;4;10
8233;Sakalėlis;GIRINUKŲ;6889888573;Ne;0;0;2;2
8234;Sakalėlis;GIRINUKŲ;5465596207;Taip;0;0;1;1
8235;Sakalėlis;GIRINUKŲ;7852255204;Ne;8;0;0;8
8236;Sakalėlis;GIRINUKŲ;9926328835;Ne;0;11;0;11
8237;Sakalėlis;GIRINUKŲ;1253452975;Ne;0;0;1;1
8238;Sakalėlis;GIRINUKŲ;8328069876;Ne;0;0;1;1
8239;Sakalėlis;GIRINUKŲ;7480286509;Ne;0;1;0;1
8240;Sakalėlis;GIRINUKŲ;2250828607;Ne;0;1;5;6
8241;Sakalėlis;GIRINUKŲ;2672429406;Ne;0;1;5;6
8242;Sakalėlis;GIRINUKŲ;2233966176;Ne;1;0;6;7
8243;Sakalėlis;GIRINUKŲ;7079300418;Ne;6;0;1;7
8244;Sakalėlis;GIRINUKŲ;6851247779;Ne;4;0;0;4
8245;Sakalėlis;GIRINUKŲ;8501785305;Ne;0;0;3;3
8246;Sakalėlis;GIRINUKŲ;2649804066;Ne;2;0;2;4
8247;Sakalėlis;VYTURIUKŲ;3927487265;Ne;0;0;1;1
8248;Sakalėlis;VYTURIUKŲ;3680732318;Ne;0;0;2;2
8249;Sakalėlis;VYTURIUKŲ;4862004373;Ne;0;1;1;2
8250;Sakalėlis;VYTURIUKŲ;6840368824;Ne;6;0;1;7
8251;Sakalėlis;VYTURIUKŲ;2985239904;Ne;3;0;2;5
8252;Sakalėlis;VYTURIUKŲ;3351218789;Ne;0;0;2;2
8253;Sakalėlis;VYTURIUKŲ;9120873899;Ne;21;0;0;21
8254;Sakalėlis;VYTURIUKŲ;5991029760;Taip;3;1;2;6
8255;Sakalėlis;VYTURIUKŲ;6378711142;Ne;0;0;6;6
8256;Sakalėlis;VYTURIUKŲ;7280513854;Ne;0;1;0;1
8257;Sakalėlis;VYTURIUKŲ;1806698668;Ne;1;0;0;1
8258;Sakalėlis;DRUGELIŲ;8095359035;Ne;7;0;1;8
8259;Sakalėlis;DRUGELIŲ;6515519140;Ne;3;0;0;3
8260;Sakalėlis;DRUGELIŲ;7706606275;Ne;3;0;0;3
8261;Sakalėlis;DRUGELIŲ;9272347788;Ne;2;3;0;5
8262;Sakalėlis;DRUGELIŲ;9416737436;Ne;8;0;0;8
8263;Sakalėlis;DRUGELIŲ;8331612396;Ne;0;0;1;1
8264;Sakalėlis;DRUGELIŲ;2898006208;Ne;5;0;1;6
8265;Sakalėlis;DRUGELIŲ;7542322748;Ne;2;0;2;4
8266;Sakalėlis;DRUGELIŲ;4918228191;Ne;5;0;0;5
8267;Sakalėlis;DRUGELIŲ;1201086815;Ne;7;0;3;10
8268;Sakalėlis;DRUGELIŲ;3934295338;Ne;11;0;1;12
8269;Sakalėlis;DRUGELIŲ;1117800518;Ne;14;0;0;14
8270;Sakalėlis;DRUGELIŲ;2515169899;Ne;0;0;3;3
8271;Sakalėlis;DRUGELIŲ;8160589611;Ne;0;1;0;1
8272;Sakalėlis;DRUGELIŲ;9836193857;Ne;6;0;0;6
8273;Sakalėlis;DRUGELIŲ;4004006771;Ne;0;0;1;1
8274;Sakalėlis;DRUGELIŲ;1833573491;Ne;12;0;1;13
8275;Sakalėlis;DRUGELIŲ;8713298648;Ne;5;0;1;6
8276;Sakalėlis;DRUGELIŲ;2889638745;Ne;7;0;1;8
8277;Sakalėlis;DRUGELIŲ;3329244758;Ne;0;0;6;6
8278;Sakalėlis;DRUGELIŲ;7540098033;Taip;0;0;5;5
8279;Sakalėlis;GENIUKŲ;2505477059;Ne;1;0;1;2
8280;Sakalėlis;GENIUKŲ;5865993835;Ne;0;0;3;3
8281;Sakalėlis;GENIUKŲ;6328924318;Ne;5;0;1;6
8282;Sakalėlis;GENIUKŲ;2003090775;Ne;0;0;2;2
8283;Sakalėlis;GENIUKŲ;8228039819;Ne;21;0;0;21
8284;Sakalėlis;GENIUKŲ;7006304327;Ne;0;0;1;1
8285;Sakalėlis;GENIUKŲ;4611384179;Taip;0;2;4;6
8286;Sakalėlis;GENIUKŲ;4490632523;Ne;6;0;1;7
8287;Sakalėlis;GENIUKŲ;8868588637;Taip;7;0;1;8
8288;Sakalėlis;GENIUKŲ;8015985605;Ne;0;1;1;2
8289;Sakalėlis;GENIUKŲ;5052638078;Ne;11;10;0;21
8290;Sakalėlis;GENIUKŲ;5327382009;Ne;11;10;0;21
8291;Sakalėlis;GENIUKŲ;6897550418;Ne;6;0;1;7
8292;Sakalėlis;GENIUKŲ;9642519454;Ne;3;0;1;4
8293;Sakalėlis;GENIUKŲ;6300266321;Ne;0;0;1;1
8294;Sakalėlis;GENIUKŲ;8796728627;Ne;0;5;0;5
8295;Sakalėlis;GENIUKŲ;8659925528;Ne;6;0;2;8
8296;Sakalėlis;VOVERIUKŲ;5172421763;Ne;0;0;3;3
8297;Sakalėlis;VOVERIUKŲ;5233697077;Ne;8;0;4;12
8298;Sakalėlis;VOVERIUKŲ;6414564366;Taip;2;0;2;4
8299;Sakalėlis;VOVERIUKŲ;4358313171;Ne;0;0;6;6
8300;Sakalėlis;VOVERIUKŲ;1873392718;Ne;0;0;1;1
8301;Sakalėlis;VOVERIUKŲ;6806170544;Ne;0;10;11;21
8302;Sakalėlis;VOVERIUKŲ;2557089391;Ne;14;0;1;15
8303;Sakalėlis;VOVERIUKŲ;8133985842;Ne;0;0;7;7
8304;Sakalėlis;VOVERIUKŲ;3574956316;Ne;0;3;0;3
8305;Sakalėlis;VOVERIUKŲ;1403384561;Ne;0;0;8;8
8306;Sakalėlis;VOVERIUKŲ;3927363997;Ne;9;0;1;10
8307;Sakalėlis;VOVERIUKŲ;6293226507;Ne;14;0;1;15
8308;Sakalėlis;VOVERIUKŲ;2699844937;Taip;0;12;3;15
8309;Sakalėlis;VOVERIUKŲ;1273843302;Taip;0;0;4;4
8310;Sakalėlis;VOVERIUKŲ;1669610397;Taip;0;0;8;8
8311;Sakalėlis;VOVERIUKŲ;6016854405;Ne;7;1;0;8
8312;Sakalėlis;VOVERIUKŲ;2531146677;Ne;5;0;0;5
8313;Sakalėlis;VOVERIUKŲ;4968216193;Ne;0;0;1;1
8314;Sakalėlis;VOVERIUKŲ;3217646353;Ne;0;0;1;1
8315;Sakalėlis;PĖLEDŽIUKŲ;5405669698;Ne;0;0;1;1
8316;Sakalėlis;PĖLEDŽIUKŲ;2474164013;Ne;2;1;1;4
8317;Sakalėlis;PĖLEDŽIUKŲ;5496044442;Ne;0;0;4;4
8318;Sakalėlis;PĖLEDŽIUKŲ;3418702674;Ne;0;0;1;1
8319;Sakalėlis;PĖLEDŽIUKŲ;3748865437;Ne;0;0;1;1
8320;Sakalėlis;PĖLEDŽIUKŲ;3333037807;Ne;9;0;0;9
8321;Sakalėlis;PĖLEDŽIUKŲ;4596727938;Ne;3;0;1;4
8322;Sakalėlis;PĖLEDŽIUKŲ;1347171934;Ne;0;1;0;1
8323;Sakalėlis;PĖLEDŽIUKŲ;8790189865;Ne;0;0;2;2
8324;Sakalėlis;PĖLEDŽIUKŲ;4458071075;Ne;5;0;0;5
8325;Sakalėlis;PĖLEDŽIUKŲ;4209146744;Ne;0;0;1;1
8326;Sakalėlis;PĖLEDŽIUKŲ;6217643065;Ne;0;0;3;3
8327;Sakalėlis;PĖLEDŽIUKŲ;9368758708;Ne;12;0;0;12
8328;Sakalėlis;PĖLEDŽIUKŲ;8326977226;Ne;0;11;0;11
8329;Sakalėlis;PĖLEDŽIUKŲ;4576495786;Taip;0;2;4;6
8330;Sakalėlis;"BITUČIŲ (LOGOPEDINĖ)";5376872141;Taip;3;0;0;3
8331;Sakalėlis;"BITUČIŲ (LOGOPEDINĖ)";3079900548;Ne;2;0;0;2
8332;Sakalėlis;"BITUČIŲ (LOGOPEDINĖ)";2669711574;Ne;7;0;0;7
8333;Sakalėlis;"BITUČIŲ (LOGOPEDINĖ)";8638720071;Ne;5;0;0;5
8334;Sakalėlis;"BITUČIŲ (LOGOPEDINĖ)";4442027941;Ne;6;0;0;6
8335;Sakalėlis;"BORUŽIUKŲ (LOGOPEDINĖ)";6222204020;Ne;0;7;1;8
8336;Sakalėlis;"BORUŽIUKŲ (LOGOPEDINĖ)";7602249339;Ne;0;0;1;1
8337;Sakalėlis;"BORUŽIUKŲ (LOGOPEDINĖ)";8263169658;Ne;0;0;1;1
8338;Sakalėlis;"BORUŽIUKŲ (LOGOPEDINĖ)";9776767584;Ne;6;0;3;9
8339;Sakalėlis;"BORUŽIUKŲ (LOGOPEDINĖ)";7620944079;Ne;1;0;1;2
8340;Sakalėlis;"BORUŽIUKŲ (LOGOPEDINĖ)";2732572235;Ne;0;0;1;1
8341;Sakalėlis;"BORUŽIUKŲ (LOGOPEDINĖ)";5677280944;Taip;0;0;4;4
8342;Sakalėlis;MEŠKUČIŲ;9546779717;Ne;4;1;0;5
8343;Sakalėlis;MEŠKUČIŲ;8535457018;Ne;0;1;0;1
8344;Sakalėlis;MEŠKUČIŲ;7154383856;Ne;5;0;0;5
8345;Sakalėlis;MEŠKUČIŲ;5082756444;Taip;3;0;1;4
8346;Sakalėlis;MEŠKUČIŲ;3092760315;Ne;0;5;0;5
8347;Sakalėlis;MEŠKUČIŲ;3524545708;Ne;0;6;0;6
8348;Sakalėlis;MEŠKUČIŲ;5961207419;Ne;1;0;0;1
8349;Sakalėlis;MEŠKUČIŲ;5961861760;Ne;3;0;0;3
8350;Sakalėlis;MEŠKUČIŲ;2389541483;Taip;0;7;0;7
8351;Sakalėlis;MEŠKUČIŲ;8108456923;Ne;4;0;0;4
8352;Sakalėlis;MEŠKUČIŲ;7285230768;Ne;0;7;0;7
8353;Sakalėlis;MEŠKUČIŲ;2090313887;Ne;0;9;0;9
8354;Sakalėlis;MEŠKUČIŲ;9794245922;Ne;0;0;3;3
8355;Sakalėlis;MEŠKUČIŲ;8106231242;Ne;5;0;0;5
8356;Sakalėlis;MEŠKUČIŲ;4520212128;Ne;0;12;0;12
8357;Sakalėlis;MEŠKUČIŲ;7228559861;Ne;0;11;4;15
8358;Sakalėlis;KIŠKUČIŲ;6029443196;Ne;12;0;2;14
8359;Sakalėlis;KIŠKUČIŲ;8036737782;Ne;0;1;0;1
8360;Sakalėlis;KIŠKUČIŲ;9621137382;Ne;7;0;1;8
8361;Sakalėlis;KIŠKUČIŲ;3941949117;Ne;2;0;0;2
8362;Sakalėlis;KIŠKUČIŲ;7796882816;Ne;7;0;0;7
8363;Sakalėlis;KIŠKUČIŲ;1270977572;Taip;4;0;0;4
8364;Sakalėlis;KIŠKUČIŲ;1213702668;Ne;1;0;0;1
8365;Sakalėlis;KIŠKUČIŲ;6682017840;Ne;20;0;0;20
8366;Sakalėlis;KIŠKUČIŲ;1913818905;Ne;6;0;1;7
8367;Sakalėlis;KIŠKUČIŲ;1969584481;Ne;10;0;3;13
8368;Sakalėlis;KIŠKUČIŲ;7764732694;Ne;7;0;1;8
8369;Sakalėlis;KIŠKUČIŲ;9172210601;Ne;6;0;0;6
8370;Sakalėlis;SVIRPLIUKŲ;1981444595;Ne;0;0;3;3
8371;Sakalėlis;SVIRPLIUKŲ;8562206323;Ne;0;0;2;2
8372;Sakalėlis;SVIRPLIUKŲ;5494452779;Ne;0;0;2;2
8373;Sakalėlis;SVIRPLIUKŲ;3294479203;Ne;11;0;0;11
8374;Sakalėlis;SVIRPLIUKŲ;9423279756;Taip;8;0;0;8
8375;Sakalėlis;SVIRPLIUKŲ;3205403024;Ne;10;0;0;10
8376;Sakalėlis;SVIRPLIUKŲ;3963251786;Ne;0;0;5;5
8377;Sakalėlis;SVIRPLIUKŲ;8386308690;Ne;0;0;3;3
8378;Sakalėlis;SVIRPLIUKŲ;9410185441;Ne;0;0;3;3
8379;Sakalėlis;SVIRPLIUKŲ;8959937912;Ne;0;0;1;1
8380;Sakalėlis;SVIRPLIUKŲ;5649630720;Ne;2;0;0;2
8381;Sakalėlis;SVIRPLIUKŲ;5740175023;Ne;7;0;1;8
8382;Sakalėlis;SVIRPLIUKŲ;6476563646;Ne;0;0;6;6
8383;Sakalėlis;SVIRPLIUKŲ;8162876482;Ne;0;1;0;1
8384;Sakalėlis;SVIRPLIUKŲ;1766430091;Ne;2;0;0;2
8385;Sakalėlis;GANDRIUKŲ;8502289806;Ne;0;4;0;4
8386;Sakalėlis;GANDRIUKŲ;7384400795;Ne;10;2;0;12
8387;Sakalėlis;GANDRIUKŲ;3644413861;Ne;0;1;0;1
8388;Sakalėlis;GANDRIUKŲ;4230762388;Taip;4;0;1;5
8389;Sakalėlis;GANDRIUKŲ;3228617971;Ne;0;0;3;3
8390;Sakalėlis;GANDRIUKŲ;5748438461;Taip;0;0;1;1
8391;Sakalėlis;GANDRIUKŲ;2734462553;Ne;0;0;3;3
8392;Sakalėlis;GANDRIUKŲ;2481285439;Ne;0;0;1;1
8393;Sakalėlis;GANDRIUKŲ;7345113972;Ne;3;3;0;6
8394;Sakalėlis;GANDRIUKŲ;6069544792;Taip;0;0;5;5
8395;Sakalėlis;GANDRIUKŲ;8869621812;Ne;3;0;1;4
8396;Sakalėlis;GANDRIUKŲ;5460619168;Ne;5;0;6;11
8397;Sakalėlis;GANDRIUKŲ;1560077883;Taip;0;0;1;1
8398;Sakalėlis;GANDRIUKŲ;5387119771;Taip;6;0;0;6
8399;Sakalėlis;GANDRIUKŲ;9599801230;Ne;0;9;1;10
8400;Sakalėlis;GANDRIUKŲ;3611884072;Ne;0;0;7;7
8401;Sakalėlis;GANDRIUKŲ;7321913487;Ne;0;0;3;3
8402;Sakalėlis;GANDRIUKŲ;1820886350;Ne;8;0;0;8
8403;Sakalėlis;GANDRIUKŲ;4307106905;Ne;0;0;1;1
8404;Sakalėlis;GANDRIUKŲ;2889517278;Ne;6;0;0;6
8405;Salininkų;BORUŽIUKAI;4251420816;Ne;5;10;0;15
8406;Salininkų;BORUŽIUKAI;5023856698;Ne;0;0;1;1
8407;Salininkų;BORUŽIUKAI;9802972916;Ne;0;0;4;4
8408;Salininkų;BORUŽIUKAI;1198469626;Ne;11;0;2;13
8409;Salininkų;BORUŽIUKAI;3168392325;Ne;0;5;0;5
8410;Salininkų;BORUŽIUKAI;6477136976;Ne;11;0;0;11
8411;Salininkų;BORUŽIUKAI;6903692351;Ne;5;0;0;5
8412;Salininkų;BORUŽIUKAI;8049341629;Ne;6;0;0;6
8413;Salininkų;BORUŽIUKAI;4726550395;Ne;0;11;0;11
8414;Salininkų;BORUŽIUKAI;4742529598;Ne;0;11;0;11
8415;Salininkų;BORUŽIUKAI;4866786238;Ne;4;0;1;5
8416;Salininkų;BORUŽIUKAI;3710734769;Taip;0;1;0;1
8417;Salininkų;GĖLYTĖS;8718514114;Ne;0;2;1;3
8418;Salininkų;GĖLYTĖS;8930622266;Ne;0;3;0;3
8419;Salininkų;GĖLYTĖS;5447236646;Ne;12;1;1;14
8420;Salininkų;GĖLYTĖS;8911016037;Ne;0;8;0;8
8421;Salininkų;GĖLYTĖS;5045064069;Ne;0;0;2;2
8422;Salininkų;GĖLYTĖS;1647401700;Ne;4;0;2;6
8423;Salininkų;GĖLYTĖS;9817285587;Ne;5;10;0;15
8424;Salininkų;GĖLYTĖS;2146404021;Ne;0;3;0;3
8425;Salininkų;GĖLYTĖS;8823595510;Ne;0;11;0;11
8426;Salininkų;GĖLYTĖS;9416926474;Ne;11;1;0;12
8427;Salininkų;GĖLYTĖS;1005025619;Taip;0;7;0;7
8428;Salininkų;GĖLYTĖS;9855014750;Ne;2;0;0;2
8429;Salininkų;GĖLYTĖS;1254843449;Ne;16;0;0;16
8430;Salininkų;GĖLYTĖS;6315595048;Ne;0;2;0;2
8431;Salininkų;GĖLYTĖS;3231379271;Ne;13;0;0;13
8432;Salininkų;GĖLYTĖS;2056560837;Ne;8;0;0;8
8433;Salininkų;DRUGELIAI;2684868661;Ne;11;0;0;11
8434;Salininkų;DRUGELIAI;8063397588;Ne;10;0;2;12
8435;Salininkų;DRUGELIAI;4333027447;Ne;0;4;0;4
8436;Salininkų;DRUGELIAI;3115232507;Ne;2;0;2;4
8437;Salininkų;DRUGELIAI;2009246885;Ne;5;1;2;8
8438;Salininkų;DRUGELIAI;3420217477;Ne;11;0;0;11
8439;Salininkų;DRUGELIAI;3890914603;Ne;3;3;0;6
8440;Salininkų;DRUGELIAI;3181932118;Ne;0;5;0;5
8441;Salininkų;DRUGELIAI;5017068344;Ne;5;0;0;5
8442;Salininkų;DRUGELIAI;3761217912;Ne;0;3;0;3
8443;Salininkų;DRUGELIAI;2208607684;Ne;10;1;0;11
8444;Salininkų;DRUGELIAI;3963410827;Ne;0;4;2;6
8445;Salininkų;DRUGELIAI;5539560359;Taip;3;1;3;7
8446;Salininkų;DRUGELIAI;5587577036;Ne;0;0;2;2
8447;Salininkų;DRUGELIAI;5375668400;Ne;0;7;0;7
8448;Salininkų;DRUGELIAI;4529253958;Ne;5;0;0;5
8449;Salininkų;DRUGELIAI;5583804491;Ne;5;0;1;6
8450;Salininkų;DRUGELIAI;7063718023;Ne;5;0;0;5
8451;Salininkų;DRUGELIAI;9018366347;Ne;0;8;0;8
8452;Salininkų;ŽIRNIUKAI;7643665643;Ne;0;8;0;8
8453;Salininkų;ŽIRNIUKAI;6885580632;Ne;0;5;0;5
8454;Salininkų;ŽIRNIUKAI;7409604480;Taip;0;3;0;3
8455;Salininkų;ŽIRNIUKAI;3677558828;Ne;0;0;1;1
8456;Salininkų;ŽIRNIUKAI;8095820690;Ne;2;0;1;3
8457;Salininkų;ŽIRNIUKAI;6482437251;Ne;0;2;1;3
8458;Salininkų;ŽIRNIUKAI;2495782496;Ne;0;2;2;4
8459;Salininkų;ŽIRNIUKAI;9896357816;Ne;0;0;1;1
8460;Salininkų;ŽIRNIUKAI;4568462071;Ne;0;0;4;4
8461;Salininkų;ŽIRNIUKAI;9137783249;Ne;4;2;0;6
8462;Salininkų;ŽIRNIUKAI;8524400656;Ne;9;0;0;9
8463;Salininkų;ŽIRNIUKAI;7463713798;Ne;0;6;0;6
8464;Salininkų;ŽIRNIUKAI;9617873735;Ne;0;2;3;5
8465;Salininkų;ŽIRNIUKAI;6143967744;Ne;0;0;3;3
8466;Salininkų;ŽIRNIUKAI;8552427446;Ne;0;3;0;3
8467;Salininkų;ŽIRNIUKAI;6586988786;Ne;6;0;1;7
8468;Salininkų;ŽIRNIUKAI;1587485662;Ne;5;0;0;5
8469;Salininkų;ŽIRNIUKAI;9611858211;Ne;0;5;0;5
8470;Salininkų;PAUKŠČIUKAI;2895782373;Ne;0;1;2;3
8471;Salininkų;PAUKŠČIUKAI;4971070998;Ne;0;0;1;1
8472;Salininkų;PAUKŠČIUKAI;9893985732;Ne;1;3;0;4
8473;Salininkų;PAUKŠČIUKAI;1284909139;Ne;0;1;0;1
8474;Salininkų;PAUKŠČIUKAI;3686372180;Ne;0;0;1;1
8475;Salininkų;PAUKŠČIUKAI;9892443649;Ne;0;1;0;1
8476;Salininkų;PAUKŠČIUKAI;5164367382;Ne;1;2;0;3
8477;Salininkų;PAUKŠČIUKAI;3703729963;Ne;5;1;0;6
8478;Salininkų;PAUKŠČIUKAI;3338213592;Ne;3;1;0;4
8479;Salininkų;PAUKŠČIUKAI;6510096414;Ne;0;12;0;12
8480;Salininkų;PAUKŠČIUKAI;9482632726;Ne;0;2;0;2
8481;Salininkų;PAUKŠČIUKAI;3464228778;Ne;0;0;1;1
8482;Salininkų;PAUKŠČIUKAI;2440831687;Ne;0;4;0;4
8483;Salininkų;PAUKŠČIUKAI;2726813574;Ne;1;0;1;2
8484;Salininkų;PAUKŠČIUKAI;8141168894;Ne;8;0;1;9
8485;Salininkų;PAUKŠČIUKAI;2798153926;Taip;0;2;0;2
8486;Salininkų;PAUKŠČIUKAI;8602489420;Ne;0;4;0;4
8487;Salininkų;PAUKŠČIUKAI;1453214735;Ne;5;0;0;5
8488;Salininkų;BITUTĖS;3252151974;Ne;0;6;2;8
8489;Salininkų;BITUTĖS;6845471044;Ne;1;0;8;9
8490;Salininkų;BITUTĖS;9902751686;Ne;3;0;0;3
8491;Salininkų;BITUTĖS;1928897962;Ne;0;0;3;3
8492;Salininkų;BITUTĖS;3527495230;Ne;0;0;1;1
8493;Salininkų;BITUTĖS;2073939432;Ne;9;0;0;9
8494;Salininkų;BITUTĖS;9996809930;Ne;4;0;8;12
8495;Salininkų;BITUTĖS;3915336062;Ne;6;0;3;9
8496;Salininkų;BITUTĖS;7115888747;Ne;6;0;1;7
8497;Salininkų;BITUTĖS;7639362434;Ne;0;7;1;8
8498;Salininkų;BITUTĖS;2370778977;Ne;0;1;0;1
8499;Salininkų;BITUTĖS;1020073382;Ne;0;1;0;1
8500;Salininkų;BITUTĖS;4480303856;Ne;6;0;0;6
8501;Salininkų;BITUTĖS;7383557807;Ne;0;8;0;8
8502;Salvija;Daigelis(šatil);8337554678;Ne;0;0;2;2
8503;Salvija;Daigelis(šatil);6323383244;Ne;0;8;0;8
8504;Salvija;Daigelis(šatil);1043297837;Ne;17;0;0;17
8505;Salvija;Daigelis(šatil);3857916185;Ne;0;0;9;9
8506;Salvija;Daigelis(šatil);4719344565;Ne;0;0;1;1
8507;Salvija;Daigelis(šatil);1168900211;Ne;6;0;1;7
8508;Salvija;Daigelis(šatil);7410091250;Ne;0;0;3;3
8509;Salvija;Daigelis(šatil);5761622263;Ne;9;0;0;9
8510;Salvija;Daigelis(šatil);1850688392;Ne;2;0;0;2
8511;Salvija;Daigelis(šatil);2959140033;Ne;1;0;1;2
8512;Salvija;Daigelis(šatil);3856024521;Ne;0;3;0;3
8513;Salvija;Daigelis(šatil);1959861292;Ne;10;0;0;10
8514;Salvija;Daigelis(šatil);1585988377;Ne;2;0;0;2
8515;Salvija;"Pienė (savjon)";8981331532;Ne;0;0;10;10
8516;Salvija;"Pienė (savjon)";8013023311;Ne;0;0;1;1
8517;Salvija;"Pienė (savjon)";4325636377;Ne;0;0;2;2
8518;Salvija;"Pienė (savjon)";7477171133;Ne;12;0;0;12
8519;Salvija;"Pienė (savjon)";6706565915;Ne;1;0;0;1
8520;Salvija;"Pienė (savjon)";8853389268;Ne;0;0;2;2
8521;Salvija;"Pienė (savjon)";3856351749;Taip;0;3;0;3
8522;Salvija;"Pienė (savjon)";7862619996;Ne;0;0;1;1
8523;Salvija;"Pienė (savjon)";3487446998;Ne;0;0;2;2
8524;Salvija;"Pienė (savjon)";5816893736;Ne;0;0;1;1
8525;Salvija;"Pienė (savjon)";1975032693;Ne;0;2;0;2
8526;Salvija;"Pienė (savjon)";5327735648;Ne;0;16;0;16
8527;Salvija;"Pienė (savjon)";4665919836;Ne;0;5;0;5
8528;Salvija;"Pienė (savjon)";4577248630;Ne;0;8;0;8
8529;Salvija;"Pienė (savjon)";1509182157;Ne;0;7;0;7
8530;Salvija;"Pienė (savjon)";6509829735;Ne;0;0;2;2
8531;Salvija;"Pienė (savjon)";1062662192;Ne;2;0;0;2
8532;Salvija;"Pienė (savjon)";9978634888;Ne;0;5;0;5
8533;Salvija;"Pienė (savjon)";3640213912;Ne;0;0;2;2
8534;Salvija;"Pienė (savjon)";1676795179;Ne;0;0;2;2
8535;Saulėtekis;BERŽELIS;3493175211;Ne;0;2;0;2
8536;Saulėtekis;BERŽELIS;8023603198;Ne;5;0;0;5
8537;Saulėtekis;BERŽELIS;8086451893;Ne;1;0;0;1
8538;Saulėtekis;BERŽELIS;5468364505;Ne;0;8;0;8
8539;Saulėtekis;BERŽELIS;4704426104;Ne;11;0;0;11
8540;Saulėtekis;BERŽELIS;7407540257;Ne;5;0;0;5
8541;Saulėtekis;BERŽELIS;6920619390;Ne;5;0;0;5
8542;Saulėtekis;BERŽELIS;5194925689;Ne;0;9;0;9
8543;Saulėtekis;BERŽELIS;9579088485;Ne;8;0;0;8
8544;Saulėtekis;BERŽELIS;7436158953;Ne;0;7;0;7
8545;Saulėtekis;BERŽELIS;7165739418;Ne;1;0;0;1
8546;Saulėtekis;BERŽELIS;1917500190;Ne;0;3;0;3
8547;Saulėtekis;BERŽELIS;2935641362;Ne;9;0;0;9
8548;Saulėtekis;BERŽELIS;4676218435;Ne;0;0;1;1
8549;Saulėtekis;BERŽELIS;7598254324;Ne;1;0;0;1
8550;Saulėtekis;BERŽELIS;8468491266;Ne;5;1;0;6
8551;Saulėtekis;BERŽELIS;6181992249;Taip;5;0;0;5
8552;Saulėtekis;BERŽELIS;5824537129;Ne;21;0;0;21
8553;Saulėtekis;ŠYPSENA;8331205443;Ne;12;0;0;12
8554;Saulėtekis;ŠYPSENA;4975294724;Ne;11;0;3;14
8555;Saulėtekis;ŠYPSENA;7780877703;Ne;2;0;0;2
8556;Saulėtekis;ŠYPSENA;2282128335;Ne;14;0;1;15
8557;Saulėtekis;ŠYPSENA;7759917109;Ne;11;0;0;11
8558;Saulėtekis;ŠYPSENA;3306250980;Ne;5;0;2;7
8559;Saulėtekis;ŠYPSENA;4391887095;Ne;1;0;1;2
8560;Saulėtekis;ŠYPSENA;1278985938;Ne;3;0;2;5
8561;Saulėtekis;ŠYPSENA;4765756650;Taip;14;0;0;14
8562;Saulėtekis;ŠYPSENA;8173628625;Ne;0;0;3;3
8563;Saulėtekis;ŠYPSENA;1237869114;Ne;9;0;0;9
8564;Saulėtekis;ŠYPSENA;1515580716;Ne;8;0;0;8
8565;Saulėtekis;ŠYPSENA;6831161042;Ne;8;0;0;8
8566;Saulėtekis;ŠYPSENA;4433821698;Ne;8;0;1;9
8567;Saulėtekis;NYKŠTUKAI;7849181976;Ne;9;2;0;11
8568;Saulėtekis;NYKŠTUKAI;5748816813;Taip;1;4;0;5
8569;Saulėtekis;NYKŠTUKAI;7555273745;Ne;0;12;0;12
8570;Saulėtekis;NYKŠTUKAI;1416983683;Ne;0;1;0;1
8571;Saulėtekis;NYKŠTUKAI;4758423356;Ne;3;1;0;4
8572;Saulėtekis;NYKŠTUKAI;9270109327;Ne;6;1;0;7
8573;Saulėtekis;NYKŠTUKAI;5183297420;Ne;0;10;0;10
8574;Saulėtekis;NYKŠTUKAI;8007704080;Ne;11;0;0;11
8575;Saulėtekis;NYKŠTUKAI;8683571534;Ne;0;3;0;3
8576;Saulėtekis;NYKŠTUKAI;9481578412;Taip;1;1;1;3
8577;Saulėtekis;NYKŠTUKAI;8167740525;Ne;13;0;1;14
8578;Saulėtekis;NYKŠTUKAI;7273354670;Ne;6;0;0;6
8579;Saulėtekis;NYKŠTUKAI;3371045145;Ne;0;1;0;1
8580;Saulėtekis;NYKŠTUKAI;9818660340;Ne;12;1;0;13
8581;Saulėtekis;NYKŠTUKAI;3729811521;Ne;6;1;0;7
8582;Saulėtekis;NYKŠTUKAI;5888979911;Ne;0;6;0;6
8583;Saulėtekis;NYKŠTUKAI;8090571664;Ne;0;1;0;1
8584;Saulėtekis;NYKŠTUKAI;9104549419;Ne;0;2;0;2
8585;Saulėtekis;NYKŠTUKAI;3957655772;Ne;6;2;0;8
8586;Saulėtekis;NYKŠTUKAI;1511922965;Taip;2;0;0;2
8587;Saulėtekis;NYKŠTUKAI;1331793286;Ne;8;5;0;13
8588;Saulėtekis;NYKŠTUKAI;8927598999;Ne;11;0;0;11
8589;Saulėtekis;PAGRANDUKAS;8098047919;Ne;0;1;0;1
8590;Saulėtekis;PAGRANDUKAS;8240764949;Ne;0;0;1;1
8591;Saulėtekis;PAGRANDUKAS;5970957754;Ne;8;0;1;9
8592;Saulėtekis;PAGRANDUKAS;5252265065;Taip;6;0;0;6
8593;Saulėtekis;PAGRANDUKAS;3903728416;Ne;16;0;0;16
8594;Saulėtekis;PAGRANDUKAS;3096623181;Ne;6;0;0;6
8595;Saulėtekis;PAGRANDUKAS;6029401583;Ne;16;0;0;16
8596;Saulėtekis;PAGRANDUKAS;5321135231;Ne;10;0;2;12
8597;Saulėtekis;PAGRANDUKAS;6008705995;Ne;7;0;1;8
8598;Saulėtekis;PAGRANDUKAS;5173602064;Ne;0;0;1;1
8599;Saulėtekis;PAGRANDUKAS;3142594542;Ne;0;0;1;1
8600;Saulėtekis;PAGRANDUKAS;1734813803;Ne;0;2;0;2
8601;Saulėtekis;PAGRANDUKAS;6966791665;Ne;1;0;0;1
8602;Saulėtekis;PAGRANDUKAS;7293735126;Ne;1;0;0;1
8603;Saulėtekis;PAGRANDUKAS;4066394876;Ne;6;1;0;7
8604;Saulėtekis;PAGRANDUKAS;9575338070;Ne;0;0;1;1
8605;Saulėtekis;RAMUNĖLIŲ;8739919774;Ne;10;2;0;12
8606;Saulėtekis;RAMUNĖLIŲ;4681031693;Ne;2;0;2;4
8607;Saulėtekis;RAMUNĖLIŲ;2316817605;Ne;5;0;1;6
8608;Saulėtekis;RAMUNĖLIŲ;3987535802;Ne;1;1;0;2
8609;Saulėtekis;RAMUNĖLIŲ;6979741482;Ne;0;5;0;5
8610;Saulėtekis;RAMUNĖLIŲ;3430209353;Ne;5;10;0;15
8611;Saulėtekis;RAMUNĖLIŲ;5980690239;Ne;5;0;0;5
8612;Saulėtekis;RAMUNĖLIŲ;2786112846;Ne;0;3;0;3
8613;Saulėtekis;RAMUNĖLIŲ;8876580678;Ne;0;3;0;3
8614;Saulėtekis;RAMUNĖLIŲ;1427323748;Ne;8;12;0;20
8615;Saulėtekis;RAMUNĖLIŲ;3224110585;Ne;10;3;0;13
8616;Saulėtekis;RAMUNĖLIŲ;2002180753;Ne;8;0;3;11
8617;Saulėtekis;RAMUNĖLIŲ;9668125862;Ne;3;0;0;3
8618;Saulėtekis;RAMUNĖLIŲ;4736430248;Ne;0;8;0;8
8619;Saulėtekis;RAMUNĖLIŲ;1108736588;Taip;0;0;1;1
8620;Saulėtekis;RAMUNĖLIŲ;3680199463;Ne;4;0;2;6
8621;Saulėtekis;RAMUNĖLIŲ;2383861394;Ne;3;0;0;3
8622;Saulėtekis;RAMUNĖLIŲ;2872732978;Ne;0;6;0;6
8623;Saulėtekis;RAMUNĖLIŲ;7494641077;Ne;0;2;0;2
8624;Saulėtekis;RAMUNĖLIŲ;1577609727;Ne;0;2;0;2
8625;Saulėtekis;PASAKAITĖ;8033763960;Ne;1;2;0;3
8626;Saulėtekis;PASAKAITĖ;4437540996;Ne;12;0;0;12
8627;Saulėtekis;PASAKAITĖ;7407451018;Ne;0;1;0;1
8628;Saulėtekis;PASAKAITĖ;9267790598;Ne;1;0;0;1
8629;Saulėtekis;PASAKAITĖ;6670590135;Ne;0;9;0;9
8630;Saulėtekis;PASAKAITĖ;6720758829;Ne;1;1;0;2
8631;Saulėtekis;PASAKAITĖ;3224883243;Ne;0;10;0;10
8632;Saulėtekis;PASAKAITĖ;9382031144;Ne;0;6;0;6
8633;Saulėtekis;PASAKAITĖ;3371914339;Ne;0;2;0;2
8634;Saulėtekis;PASAKAITĖ;6214539956;Ne;6;1;0;7
8635;Saulėtekis;PASAKAITĖ;9584556476;Ne;0;7;0;7
8636;Saulėtekis;PASAKAITĖ;9799880235;Ne;0;1;0;1
8637;Saulėtekis;PASAKAITĖ;3499575148;Ne;0;5;0;5
8638;Saulėtekis;PASAKAITĖ;2206038658;Ne;7;0;0;7
8639;Saulėtekis;PASAKAITĖ;7826554599;Ne;2;0;0;2
8640;Saulėtekis;VARPELIAI;3303064486;Ne;4;0;0;4
8641;Saulėtekis;VARPELIAI;8195320453;Taip;1;0;0;1
8642;Saulėtekis;VARPELIAI;5997903066;Ne;0;10;1;11
8643;Saulėtekis;VARPELIAI;7338301696;Taip;0;6;0;6
8644;Saulėtekis;VARPELIAI;9383203972;Ne;0;8;0;8
8645;Saulėtekis;VARPELIAI;7171550857;Ne;1;0;0;1
8646;Saulėtekis;VARPELIAI;3157110037;Ne;13;0;0;13
8647;Saulėtekis;VARPELIAI;8331659142;Taip;10;0;0;10
8648;Saulėtekis;VARPELIAI;1479530265;Ne;4;0;0;4
8649;Saulėtekis;VARPELIAI;1164913351;Taip;9;0;0;9
8650;Saulėtekis;VARPELIAI;3499215193;Ne;5;0;0;5
8651;Saulėtekis;VARPELIAI;5165684803;Ne;0;0;2;2
8652;Saulėtekis;VARPELIAI;3780019474;Ne;5;0;0;5
8653;Saulėtekis;VARPELIAI;9615110873;Ne;2;0;0;2
8654;Saulėtekis;VARPELIAI;3206247299;Ne;5;0;0;5
8655;Saulėtekis;VARPELIAI;7423380888;Ne;11;0;1;12
8656;Saulėtekis;VARPELIAI;2621773226;Ne;8;0;0;8
8657;Saulėtekis;VARPELIAI;4592401190;Ne;11;0;0;11
8658;Saulėtekis;GRŪDELIS;1864236745;Ne;3;0;0;3
8659;Saulėtekis;GRŪDELIS;7171048750;Ne;0;0;1;1
8660;Saulėtekis;GRŪDELIS;6535620172;Ne;0;0;2;2
8661;Saulėtekis;GRŪDELIS;8219644557;Ne;0;0;2;2
8662;Saulėtekis;GRŪDELIS;5161940030;Ne;0;9;0;9
8663;Saulėtekis;GRŪDELIS;9646060606;Ne;0;6;0;6
8664;Saulėtekis;GRŪDELIS;1934900185;Ne;6;0;2;8
8665;Saulėtekis;GRŪDELIS;9995919137;Ne;0;7;0;7
8666;Saulėtekis;GRŪDELIS;6928825133;Ne;0;1;0;1
8667;Saulėtekis;GRŪDELIS;8138047893;Ne;5;0;2;7
8668;Saulėtekis;GRŪDELIS;3953501167;Ne;7;0;1;8
8669;Saulėtekis;GRŪDELIS;2646213073;Ne;0;9;3;12
8670;Saulėtekis;GRŪDELIS;6482182524;Ne;0;6;0;6
8671;Saulėtekis;GRŪDELIS;6779891385;Ne;0;0;1;1
8672;Saulėtekis;GRŪDELIS;9743690247;Ne;8;0;1;9
8673;Saulėtekis;GRŪDELIS;7666624373;Ne;0;0;5;5
8674;Saulėtekis;GRŪDELIS;8061477303;Ne;0;0;3;3
8675;Saulėtekis;GRŪDELIS;2568544418;Taip;0;0;8;8
8676;Saulėtekis;GRŪDELIS;9734188792;Ne;16;0;0;16
8677;Saulėtekis;GRŪDELIS;9787534807;Ne;0;0;3;3
8678;Saulėtekis;JONVABALIS;8239855620;Taip;7;0;0;7
8679;Saulėtekis;JONVABALIS;8603952810;Ne;7;0;0;7
8680;Saulėtekis;JONVABALIS;8881524909;Ne;3;0;0;3
8681;Saulėtekis;JONVABALIS;7673965242;Ne;9;0;0;9
8682;Saulėtekis;JONVABALIS;7730889108;Ne;5;0;0;5
8683;Saulėtekis;JONVABALIS;2686041419;Ne;10;0;3;13
8684;Saulėtekis;JONVABALIS;3166959569;Ne;0;3;0;3
8685;Saulėtekis;JONVABALIS;7346852524;Ne;4;0;0;4
8686;Saulėtekis;JONVABALIS;5518726567;Ne;4;0;0;4
8687;Saulėtekis;JONVABALIS;7435424899;Ne;10;0;2;12
8688;Saulėtekis;JONVABALIS;2177470008;Ne;7;0;0;7
8689;Saulėtekis;JONVABALIS;7893982893;Ne;2;0;0;2
8690;Saulėtekis;JONVABALIS;7803735686;Ne;1;0;0;1
8691;Saulėtekis;JONVABALIS;7505040675;Ne;0;2;0;2
8692;Saulėtekis;JONVABALIS;9694119292;Taip;3;0;0;3
8693;Saulėtekis;JONVABALIS;8427457478;Ne;8;0;0;8
8694;Saulėtekis;JONVABALIS;9791926936;Ne;8;0;0;8
8695;Saulėtekis;JONVABALIS;6608831217;Ne;0;3;0;3
8696;Saulėtekis;SMALSUČIAI;9941731250;Ne;5;0;0;5
8697;Saulėtekis;SMALSUČIAI;8102360466;Ne;12;0;0;12
8698;Saulėtekis;SMALSUČIAI;2371396923;Ne;2;0;0;2
8699;Saulėtekis;SMALSUČIAI;8745921541;Ne;10;0;0;10
8700;Saulėtekis;SMALSUČIAI;2728836108;Ne;2;0;0;2
8701;Saulėtekis;SMALSUČIAI;7164579375;Ne;1;0;0;1
8702;Saulėtekis;SMALSUČIAI;4038684284;Taip;1;0;0;1
8703;Saulėtekis;SMALSUČIAI;8390615573;Ne;0;5;0;5
8704;Saulėtekis;SMALSUČIAI;4152255439;Ne;1;0;0;1
8705;Saulėtekis;SMALSUČIAI;8574702901;Taip;2;0;0;2
8706;Saulėtekis;SMALSUČIAI;7186085219;Ne;1;0;0;1
8707;Saulėtekis;SMALSUČIAI;2209156661;Ne;3;0;0;3
8708;Saulėtekis;SMALSUČIAI;9497129509;Ne;1;0;0;1
8709;Saulėtekis;SMALSUČIAI;3366064429;Ne;0;1;0;1
8710;Saulėtekis;SMALSUČIAI;9870595577;Ne;3;0;0;3
8711;Saulėtekis;SMALSUČIAI;7766084857;Ne;1;0;0;1
8712;Saulėtekis;SMALSUČIAI;2154590089;Ne;1;0;0;1
8713;Saulėtekis;SMALSUČIAI;3220993253;Ne;10;0;0;10
8714;Saulėtekis;SMALSUČIAI;2698535938;Ne;5;0;0;5
8715;Saulėtekis;BITUTĖS;4252302344;Ne;8;0;0;8
8716;Saulėtekis;BITUTĖS;9382796391;Ne;8;0;0;8
8717;Saulėtekis;BITUTĖS;2095103400;Ne;8;0;0;8
8718;Saulėtekis;BITUTĖS;7614555277;Ne;5;0;0;5
8719;Saulėtekis;BITUTĖS;7308749675;Ne;0;4;0;4
8720;Saulėtekis;BITUTĖS;3898675190;Ne;10;0;1;11
8721;Saulėtekis;BITUTĖS;4135680619;Ne;5;0;0;5
8722;Saulėtekis;BITUTĖS;3768954974;Ne;0;0;1;1
8723;Saulėtekis;BITUTĖS;2939151459;Ne;0;0;2;2
8724;Saulėtekis;BITUTĖS;2790163936;Ne;10;0;0;10
8725;Saulėtekis;BITUTĖS;9649078106;Taip;0;0;6;6
8726;Saulėtekis;BITUTĖS;9892315045;Taip;0;0;1;1
8727;Saulėtekis;BITUTĖS;8890060293;Ne;5;0;0;5
8728;Saulėtekis;BITUTĖS;3954368962;Ne;0;0;5;5
8729;Saulėtekis;BITUTĖS;3349025533;Ne;1;0;9;10
8730;Saulėtekis;BITUTĖS;6945891800;Ne;4;0;0;4
8731;Saulėtekis;RIEŠUTĖLIAI;8767786444;Ne;0;0;3;3
8732;Saulėtekis;RIEŠUTĖLIAI;2224626144;Ne;13;0;0;13
8733;Saulėtekis;RIEŠUTĖLIAI;9270231819;Ne;3;0;0;3
8734;Saulėtekis;RIEŠUTĖLIAI;5898051775;Ne;0;0;1;1
8735;Saulėtekis;RIEŠUTĖLIAI;7898928446;Ne;3;0;0;3
8736;Saulėtekis;RIEŠUTĖLIAI;3356705340;Ne;5;0;2;7
8737;Saulėtekis;RIEŠUTĖLIAI;7807096583;Ne;0;0;3;3
8738;Saulėtekis;RIEŠUTĖLIAI;2548612572;Ne;6;0;0;6
8739;Saulėtekis;RIEŠUTĖLIAI;2908714227;Ne;15;0;2;17
8740;Saulėtekis;RIEŠUTĖLIAI;7305619721;Ne;0;0;10;10
8741;Saulėtekis;RIEŠUTĖLIAI;9516841263;Ne;0;0;2;2
8742;Saulėtekis;RIEŠUTĖLIAI;6183384994;Taip;5;0;1;6
8743;Saulėtekis;RIEŠUTĖLIAI;3559882322;Ne;6;0;1;7
8744;Saulėtekis;RIEŠUTĖLIAI;4767842376;Taip;0;0;5;5
8745;Saulėtekis;RIEŠUTĖLIAI;4413014466;Ne;8;0;0;8
8746;Saulėtekis;RIEŠUTĖLIAI;3832717108;Ne;0;1;0;1
8747;Saulėtekis;RIEŠUTĖLIAI;1240595768;Ne;9;0;0;9
8748;Saulėtekis;RIEŠUTĖLIAI;9246555859;Ne;11;0;0;11
8749;Skroblinukas;SVIRPLIUKŲ;2195112297;Ne;3;0;5;8
8750;Skroblinukas;SVIRPLIUKŲ;4198512202;Ne;0;0;6;6
8751;Skroblinukas;SVIRPLIUKŲ;7750501815;Ne;11;0;9;20
8752;Skroblinukas;SVIRPLIUKŲ;4960825597;Ne;0;10;1;11
8753;Skroblinukas;SVIRPLIUKŲ;6574558658;Ne;0;11;1;12
8754;Skroblinukas;SVIRPLIUKŲ;4861971439;Ne;0;1;3;4
8755;Skroblinukas;SVIRPLIUKŲ;7817632987;Ne;0;1;0;1
8756;Skroblinukas;SVIRPLIUKŲ;7675772872;Ne;0;0;2;2
8757;Skroblinukas;SVIRPLIUKŲ;4266945644;Taip;1;10;0;11
8758;Skroblinukas;SVIRPLIUKŲ;5154111867;Ne;0;4;0;4
8759;Skroblinukas;SVIRPLIUKŲ;8622930871;Ne;6;12;2;20
8760;Skroblinukas;SVIRPLIUKŲ;3260267388;Ne;0;13;0;13
8761;Skroblinukas;SVIRPLIUKŲ;7761972818;Ne;0;2;0;2
8762;Skroblinukas;SVIRPLIUKŲ;9629502585;Ne;7;11;0;18
8763;Skroblinukas;SVIRPLIUKŲ;6461678336;Ne;0;0;5;5
8764;Skroblinukas;SVIRPLIUKŲ;8283516422;Ne;5;5;0;10
8765;Skroblinukas;GANDRIUKŲ;2406619611;Ne;10;1;0;11
8766;Skroblinukas;GANDRIUKŲ;5646847921;Ne;6;5;0;11
8767;Skroblinukas;GANDRIUKŲ;1851920334;Ne;0;0;2;2
8768;Skroblinukas;GANDRIUKŲ;9377215921;Ne;0;13;0;13
8769;Skroblinukas;GANDRIUKŲ;6489976163;Ne;13;0;0;13
8770;Skroblinukas;GANDRIUKŲ;1159546580;Ne;0;3;1;4
8771;Skroblinukas;GANDRIUKŲ;2310750833;Ne;2;4;0;6
8772;Skroblinukas;GANDRIUKŲ;9888115079;Ne;0;7;0;7
8773;Skroblinukas;GANDRIUKŲ;9475514959;Ne;0;3;0;3
8774;Skroblinukas;GANDRIUKŲ;9031598603;Ne;2;0;1;3
8775;Skroblinukas;GANDRIUKŲ;5251903769;Ne;5;8;0;13
8776;Skroblinukas;GANDRIUKŲ;7385271438;Ne;1;0;2;3
8777;Skroblinukas;GANDRIUKŲ;7274368180;Ne;2;0;0;2
8778;Skroblinukas;GANDRIUKŲ;9541682085;Ne;7;0;0;7
8779;Skroblinukas;GANDRIUKŲ;7753392781;Ne;3;0;0;3
8780;Skroblinukas;GANDRIUKŲ;1369962422;Ne;5;0;6;11
8781;Skroblinukas;VYTURIUKŲ;3954228349;Ne;6;0;4;10
8782;Skroblinukas;VYTURIUKŲ;4560580022;Ne;0;0;2;2
8783;Skroblinukas;VYTURIUKŲ;2330232287;Ne;1;0;0;1
8784;Skroblinukas;VYTURIUKŲ;3065235192;Taip;0;1;1;2
8785;Skroblinukas;VYTURIUKŲ;5902713448;Ne;3;5;0;8
8786;Skroblinukas;VYTURIUKŲ;3594000419;Ne;0;6;0;6
8787;Skroblinukas;VYTURIUKŲ;3512297435;Ne;0;6;0;6
8788;Skroblinukas;VYTURIUKŲ;2481980627;Ne;0;0;1;1
8789;Skroblinukas;VYTURIUKŲ;2978284436;Ne;1;0;0;1
8790;Skroblinukas;VYTURIUKŲ;7068452970;Ne;0;0;1;1
8791;Skroblinukas;VYTURIUKŲ;3292517112;Ne;3;2;0;5
8792;Skroblinukas;VYTURIUKŲ;4129726208;Ne;3;0;0;3
8793;Skroblinukas;VYTURIUKŲ;3351309750;Ne;2;0;1;3
8794;Skroblinukas;VYTURIUKŲ;5101136022;Ne;0;0;2;2
8795;Skroblinukas;VYTURIUKŲ;9828486832;Ne;0;0;1;1
8796;Skroblinukas;VYTURIUKŲ;2263955772;Ne;0;0;1;1
8797;Skroblinukas;GENIUKŲ;6011466024;Ne;9;0;0;9
8798;Skroblinukas;GENIUKŲ;8629189405;Taip;8;0;2;10
8799;Skroblinukas;GENIUKŲ;8544069746;Ne;0;2;0;2
8800;Skroblinukas;GENIUKŲ;6475609065;Ne;0;0;19;19
8801;Skroblinukas;GENIUKŲ;4091852305;Ne;0;15;1;16
8802;Skroblinukas;GENIUKŲ;1820748152;Ne;2;0;0;2
8803;Skroblinukas;GENIUKŲ;3705638869;Ne;0;5;1;6
8804;Skroblinukas;GENIUKŲ;2511496284;Ne;10;0;1;11
8805;Skroblinukas;GENIUKŲ;7153774246;Ne;0;1;0;1
8806;Skroblinukas;GENIUKŲ;7045587415;Ne;0;5;4;9
8807;Skroblinukas;GENIUKŲ;5946356374;Ne;11;0;0;11
8808;Skroblinukas;GENIUKŲ;5274898590;Ne;4;6;0;10
8809;Skroblinukas;GENIUKŲ;1167332689;Taip;0;1;1;2
8810;Skroblinukas;GENIUKŲ;4491947846;Ne;10;2;1;13
8811;Skroblinukas;GENIUKŲ;7955574061;Ne;0;4;0;4
8812;Skroblinukas;GENIUKŲ;4002729040;Ne;4;0;0;4
8813;Skroblinukas;GENIUKŲ;9162582460;Ne;5;0;1;6
8814;Skroblinukas;GENIUKŲ;1014993354;Ne;3;1;2;6
8815;Skroblinukas;GENIUKŲ;1232121301;Ne;0;3;0;3
8816;Skroblinukas;GENIUKŲ;8680329175;Ne;13;0;1;14
8817;Skroblinukas;BITUČIŲ;4639384934;Ne;0;0;2;2
8818;Skroblinukas;BITUČIŲ;5206925237;Ne;5;0;0;5
8819;Skroblinukas;BITUČIŲ;6717008836;Ne;0;3;0;3
8820;Skroblinukas;BITUČIŲ;6791969485;Ne;0;0;4;4
8821;Skroblinukas;BITUČIŲ;2363368201;Ne;6;0;4;10
8822;Skroblinukas;BITUČIŲ;2885814517;Ne;0;0;2;2
8823;Skroblinukas;BITUČIŲ;5354832150;Ne;0;0;1;1
8824;Skroblinukas;BITUČIŲ;5841866621;Ne;6;0;2;8
8825;Skroblinukas;BITUČIŲ;3490684777;Ne;4;0;4;8
8826;Skroblinukas;BITUČIŲ;2717586232;Taip;0;4;0;4
8827;Skroblinukas;BITUČIŲ;9513546028;Ne;0;0;5;5
8828;Skroblinukas;BITUČIŲ;8715188878;Ne;0;9;6;15
8829;Skroblinukas;BITUČIŲ;7407601996;Ne;1;0;0;1
8830;Skroblinukas;BITUČIŲ;4631657273;Ne;0;0;2;2
8831;Skroblinukas;BITUČIŲ;7255510731;Ne;6;0;2;8
8832;Skroblinukas;BITUČIŲ;5694105568;Ne;10;0;0;10
8833;Skroblinukas;BORUŽĖLIŲ;7771969055;Ne;3;0;0;3
8834;Skroblinukas;BORUŽĖLIŲ;8711201474;Ne;0;0;2;2
8835;Skroblinukas;BORUŽĖLIŲ;2166244766;Ne;7;0;0;7
8836;Skroblinukas;BORUŽĖLIŲ;7729612420;Ne;7;1;0;8
8837;Skroblinukas;BORUŽĖLIŲ;1357700154;Ne;8;0;0;8
8838;Skroblinukas;BORUŽĖLIŲ;7446262781;Ne;6;0;0;6
8839;Skroblinukas;BORUŽĖLIŲ;6005897181;Ne;0;0;1;1
8840;Skroblinukas;SKRUZDĖLIUKŲ;5688453546;Ne;4;2;0;6
8841;Skroblinukas;SKRUZDĖLIUKŲ;6890306112;Ne;0;6;0;6
8842;Skroblinukas;SKRUZDĖLIUKŲ;6445065388;Ne;5;1;0;6
8843;Skroblinukas;SKRUZDĖLIUKŲ;3771045336;Ne;0;3;0;3
8844;Skroblinukas;SKRUZDĖLIUKŲ;4424763028;Ne;0;4;0;4
8845;Skroblinukas;SKRUZDĖLIUKŲ;5157913924;Ne;7;0;1;8
8846;Skroblinukas;SKRUZDĖLIUKŲ;9368764758;Ne;0;3;0;3
8847;Skroblinukas;SKRUZDĖLIUKŲ;8576448571;Ne;3;0;1;4
8848;Skroblinukas;SKRUZDĖLIUKŲ;3290115134;Ne;5;7;0;12
8849;Skroblinukas;SKRUZDĖLIUKŲ;9813249677;Ne;0;3;0;3
8850;Skroblinukas;SKRUZDĖLIUKŲ;5915278745;Ne;0;2;0;2
8851;Skroblinukas;SKRUZDĖLIUKŲ;5433647187;Ne;0;1;0;1
8852;Skroblinukas;ŽVIRBLIUKŲ;3041669079;Ne;0;5;0;5
8853;Skroblinukas;ŽVIRBLIUKŲ;6068248705;Ne;5;0;0;5
8854;Skroblinukas;ŽVIRBLIUKŲ;3117532423;Ne;3;0;0;3
8855;Skroblinukas;ŽVIRBLIUKŲ;8124086303;Ne;6;0;0;6
8856;Skroblinukas;ŽVIRBLIUKŲ;7640540309;Ne;0;1;0;1
8857;Skroblinukas;ŽVIRBLIUKŲ;7527177120;Ne;0;8;0;8
8858;Skroblinukas;ŽVIRBLIUKŲ;6135412007;Taip;4;0;2;6
8859;Skroblinukas;ŽVIRBLIUKŲ;2312400921;Taip;4;0;2;6
8860;Skroblinukas;ŽVIRBLIUKŲ;7804920443;Ne;4;0;0;4
8861;Skroblinukas;ŽVIRBLIUKŲ;4197050176;Ne;0;8;0;8
8862;Skroblinukas;ŽVIRBLIUKŲ;4390614970;Taip;20;0;0;20
8863;Skroblinukas;ŽIOGELIŲ;6279909049;Ne;6;0;4;10
8864;Skroblinukas;ŽIOGELIŲ;9737310101;Ne;0;0;1;1
8865;Skroblinukas;ŽIOGELIŲ;8118284793;Ne;0;0;1;1
8866;Skroblinukas;ŽIOGELIŲ;4266029484;Ne;0;1;0;1
8867;Skroblinukas;ŽIOGELIŲ;7650915045;Ne;3;0;2;5
8868;Skroblinukas;ŽIOGELIŲ;6444788760;Ne;0;0;1;1
8869;Skroblinukas;ŽIOGELIŲ;6070633607;Ne;0;0;1;1
8870;Skroblinukas;STRAZDELIŲ;4799600999;Ne;0;2;0;2
8871;Skroblinukas;STRAZDELIŲ;8898971191;Ne;4;1;0;5
8872;Skroblinukas;STRAZDELIŲ;5804217824;Ne;4;0;2;6
8873;Skroblinukas;STRAZDELIŲ;1762416639;Ne;3;0;1;4
8874;Skroblinukas;STRAZDELIŲ;7483556761;Ne;7;0;0;7
8875;Skroblinukas;STRAZDELIŲ;1846830752;Ne;2;0;1;3
8876;Skroblinukas;STRAZDELIŲ;8734405028;Ne;7;2;0;9
8877;Skroblinukas;STRAZDELIŲ;2132271995;Ne;12;0;3;15
8878;Skroblinukas;STRAZDELIŲ;9753194124;Ne;0;0;1;1
8879;Skroblinukas;DRUGELIŲ;7400908711;Ne;5;6;0;11
8880;Skroblinukas;DRUGELIŲ;3889890374;Ne;0;3;0;3
8881;Skroblinukas;DRUGELIŲ;8864594520;Ne;1;0;3;4
8882;Skroblinukas;DRUGELIŲ;3624518310;Ne;3;0;0;3
8883;Skroblinukas;DRUGELIŲ;4831370981;Ne;0;1;0;1
8884;Skroblinukas;DRUGELIŲ;5957417413;Ne;0;10;0;10
8885;Skroblinukas;DRUGELIŲ;3226115050;Ne;0;1;0;1
8886;Skroblinukas;DRUGELIŲ;2887161771;Ne;0;1;0;1
8887;Skroblinukas;DRUGELIŲ;4737605061;Ne;0;3;0;3
8888;Skroblinukas;DRUGELIŲ;2948231687;Ne;0;0;1;1
8889;Skroblinukas;DRUGELIŲ;5912771080;Ne;7;4;0;11
8890;Skroblinukas;DRUGELIŲ;7528824951;Taip;0;0;3;3
8891;Skroblinukas;DRUGELIŲ;2987938909;Ne;0;9;1;10
8892;Skroblinukas;DRUGELIŲ;1453029732;Ne;5;0;0;5
8893;Skroblinukas;PELĖDŽIUKŲ;8953844650;Ne;0;1;0;1
8894;Skroblinukas;PELĖDŽIUKŲ;5813075721;Ne;0;5;3;8
8895;Skroblinukas;PELĖDŽIUKŲ;3646325903;Ne;0;9;0;9
8896;Skroblinukas;PELĖDŽIUKŲ;9292990596;Taip;8;1;2;11
8897;Skroblinukas;PELĖDŽIUKŲ;8202855376;Ne;1;0;18;19
8898;Skroblinukas;PELĖDŽIUKŲ;8312341293;Taip;0;1;0;1
8899;Skroblinukas;PELĖDŽIUKŲ;3658815079;Ne;4;0;2;6
8900;Skroblinukas;PELĖDŽIUKŲ;5418212729;Ne;0;0;1;1
8901;Skroblinukas;PELĖDŽIUKŲ;4168542339;Ne;0;7;2;9
8902;Skroblinukas;PELĖDŽIUKŲ;8958893525;Ne;0;10;2;12
8903;Skroblinukas;PELĖDŽIUKŲ;1009065470;Taip;9;6;1;16
8904;Skroblinukas;PELĖDŽIUKŲ;9553242594;Ne;0;9;1;10
8905;Skroblinukas;PELĖDŽIUKŲ;4802801867;Ne;2;2;0;4
8906;Skroblinukas;PELĖDŽIUKŲ;3532258904;Ne;0;0;9;9
8907;Skroblinukas;PELĖDŽIUKŲ;1758987652;Ne;4;5;1;10
8908;Skroblinukas;PELĖDŽIUKŲ;8465074037;Ne;0;10;5;15
8909;Skroblinukas;PELĖDŽIUKŲ;2071093890;Ne;6;0;2;8
8910;Skroblinukas;PELĖDŽIUKŲ;9523720873;Ne;6;0;11;17
8911;Skroblinukas;PELĖDŽIUKŲ;7920117036;Ne;3;1;4;8
8912;Skroblinukas;PELĖDŽIUKŲ;2215428081;Ne;0;1;1;2
8913;Smalsučiai;Žibuoklės;6535494814;Ne;2;0;0;2
8914;Smalsučiai;Žibuoklės;3309134310;Ne;0;2;3;5
8915;Smalsučiai;Žibuoklės;4094037708;Ne;0;6;8;14
8916;Smalsučiai;Žibuoklės;5893045664;Ne;0;2;0;2
8917;Smalsučiai;Žibuoklės;2742992400;Ne;4;0;3;7
8918;Smalsučiai;Žibuoklės;3877274360;Ne;10;2;5;17
8919;Smalsučiai;Žibuoklės;7726086066;Ne;1;0;0;1
8920;Smalsučiai;Žibuoklės;5489140006;Ne;0;6;0;6
8921;Smalsučiai;Žibuoklės;6931092874;Ne;0;0;21;21
8922;Smalsučiai;Žibuoklės;8259056296;Ne;9;0;7;16
8923;Smalsučiai;Žibuoklės;9637877396;Ne;0;6;4;10
8924;Smalsučiai;Aitvarų;3349726106;Ne;9;0;0;9
8925;Smalsučiai;Aitvarų;2219168902;Ne;9;0;0;9
8926;Smalsučiai;Aitvarų;9305837033;Ne;8;0;0;8
8927;Smalsučiai;Aitvarų;9305837033;Ne;8;0;0;8
8928;Smalsučiai;Aitvarų;9305837033;Ne;8;0;0;8
8929;Smalsučiai;Aitvarų;8877566394;Ne;4;0;0;4
8930;Smalsučiai;Aitvarų;3888093640;Taip;4;1;0;5
8931;Smalsučiai;Aitvarų;8284740122;Taip;10;0;0;10
8932;Smalsučiai;Aitvarų;1309254661;Ne;5;0;0;5
8933;Smalsučiai;Aitvarų;8985656809;Ne;8;0;0;8
8934;Smalsučiai;Aitvarų;6032887449;Ne;2;1;0;3
8935;Smalsučiai;Aitvarų;9821259659;Taip;7;1;0;8
8936;Smalsučiai;Aitvarų;4054278651;Ne;9;0;0;9
8937;Smalsučiai;Aitvarų;6232068532;Ne;7;0;0;7
8938;Smalsučiai;Aitvarų;3157534923;Ne;3;1;0;4
8939;Smalsučiai;Aitvarų;6825499095;Ne;8;0;0;8
8940;Smalsučiai;Aitvarų;4832292565;Ne;6;0;0;6
8941;Smalsučiai;Aitvarų;2835117069;Ne;5;0;0;5
8942;Smalsučiai;Aitvarų;2610753472;Ne;3;0;0;3
8943;Smalsučiai;Aitvarų;6090244401;Ne;6;0;0;6
8944;Smalsučiai;Aitvarų;2350539797;Ne;5;0;0;5
8945;Smalsučiai;Aitvarų;1126565862;Taip;11;0;0;11
8946;Smalsučiai;Sraigiukų;7933302912;Ne;0;2;0;2
8947;Smalsučiai;Sraigiukų;1471941426;Ne;0;0;3;3
8948;Smalsučiai;Sraigiukų;1458544456;Taip;0;2;0;2
8949;Smalsučiai;Sraigiukų;5406430393;Ne;5;3;0;8
8950;Smalsučiai;Sraigiukų;9604182559;Taip;0;10;0;10
8951;Smalsučiai;Sraigiukų;6469604093;Ne;5;2;0;7
8952;Smalsučiai;Sraigiukų;4566816316;Ne;0;2;1;3
8953;Smalsučiai;Sraigiukų;5184903287;Ne;5;0;0;5
8954;Smalsučiai;Sraigiukų;4629526320;Ne;0;0;2;2
8955;Smalsučiai;Sraigiukų;4134975456;Ne;5;0;0;5
8956;Smalsučiai;Sraigiukų;7396172351;Ne;0;1;0;1
8957;Smalsučiai;Sraigiukų;6358800570;Ne;0;2;0;2
8958;Smalsučiai;Sraigiukų;2327930850;Ne;0;1;0;1
8959;Smalsučiai;Sraigiukų;3787937467;Ne;0;2;0;2
8960;Smalsučiai;Sraigiukų;1997966082;Ne;0;1;0;1
8961;Smalsučiai;Sraigiukų;4585930202;Ne;0;2;0;2
8962;Smalsučiai;Sraigiukų;8193410963;Ne;0;1;0;1
8963;Smalsučiai;Saulučių;1776385691;Ne;0;8;0;8
8964;Smalsučiai;Saulučių;2259361924;Ne;5;0;2;7
8965;Smalsučiai;Saulučių;1162964613;Taip;11;0;2;13
8966;Smalsučiai;Saulučių;9934952886;Ne;3;0;0;3
8967;Smalsučiai;Saulučių;9556433086;Ne;4;10;0;14
8968;Smalsučiai;Saulučių;1904973393;Ne;0;0;5;5
8969;Smalsučiai;Saulučių;3252901131;Taip;0;3;2;5
8970;Smalsučiai;Saulučių;2392217952;Taip;0;0;6;6
8971;Smalsučiai;Saulučių;1447512509;Ne;11;0;5;16
8972;Smalsučiai;Saulučių;2034284973;Ne;0;0;1;1
8973;Smalsučiai;Saulučių;7049101015;Ne;0;0;1;1
8974;Smalsučiai;Saulučių;9183519167;Ne;5;0;2;7
8975;Smalsučiai;Saulučių;5708986552;Ne;0;0;1;1
8976;Smalsučiai;Saulučių;4889923629;Ne;0;1;1;2
8977;Smalsučiai;Saulučių;6927421427;Ne;0;0;1;1
8978;Smalsučiai;Saulučių;7874635165;Taip;0;0;10;10
8979;Smalsučiai;Saulučių;5536697307;Ne;0;0;21;21
8980;Smalsučiai;Viščiukų;6827441564;Ne;1;0;0;1
8981;Smalsučiai;Viščiukų;4760366724;Ne;3;1;0;4
8982;Smalsučiai;Viščiukų;2045283348;Ne;8;1;0;9
8983;Smalsučiai;Viščiukų;9710944054;Ne;0;1;0;1
8984;Smalsučiai;Viščiukų;5213319192;Ne;13;0;2;15
8985;Smalsučiai;Viščiukų;8210141253;Ne;5;0;0;5
8986;Smalsučiai;Viščiukų;3782502443;Ne;4;1;0;5
8987;Smalsučiai;Viščiukų;6358968221;Ne;2;1;0;3
8988;Smalsučiai;Viščiukų;2926560092;Ne;0;1;0;1
8989;Smalsučiai;Viščiukų;4030955447;Ne;0;6;0;6
8990;Smalsučiai;Viščiukų;6131743288;Ne;10;0;0;10
8991;Smalsučiai;Viščiukų;1331674807;Ne;0;0;6;6
8992;Smalsučiai;Viščiukų;9984878984;Ne;3;1;0;4
8993;Smalsučiai;Viščiukų;5535858303;Ne;5;1;0;6
8994;Smalsučiai;Viščiukų;8724759192;Ne;1;0;0;1
8995;Smalsučiai;Viščiukų;2662588310;Ne;12;0;0;12
8996;Smalsučiai;Viščiukų;7318218997;Taip;5;1;0;6
8997;Smalsučiai;Viščiukų;2668720481;Ne;0;1;0;1
8998;Smalsučiai;Boružėlių;8606216911;Ne;0;0;2;2
8999;Smalsučiai;Boružėlių;9181601713;Taip;0;3;0;3
9000;Smalsučiai;Boružėlių;6642882883;Ne;2;9;0;11
9001;Smalsučiai;Boružėlių;7637630200;Ne;0;4;0;4
9002;Smalsučiai;Boružėlių;2375360937;Ne;1;0;0;1
9003;Smalsučiai;Boružėlių;1224857159;Ne;0;1;0;1
9004;Smalsučiai;Boružėlių;2015172985;Ne;5;0;0;5
9005;Smalsučiai;Boružėlių;4457317471;Taip;0;0;2;2
9006;Smalsučiai;Boružėlių;8893480054;Taip;10;0;1;11
9007;Smalsučiai;Boružėlių;3646740184;Ne;0;5;0;5
9008;Smalsučiai;Boružėlių;6996192450;Ne;0;1;2;3
9009;Smalsučiai;Boružėlių;9378696084;Ne;0;1;2;3
9010;Smalsučiai;Boružėlių;7267389695;Ne;10;0;1;11
9011;Smalsučiai;Boružėlių;4847212069;Ne;0;0;7;7
9012;Smalsučiai;Boružėlių;8690626891;Ne;0;5;0;5
9013;Smalsučiai;Zuikių;8128348060;Ne;12;0;0;12
9014;Smalsučiai;Zuikių;3757955200;Ne;3;0;2;5
9015;Smalsučiai;Zuikių;4847584492;Ne;8;0;0;8
9016;Smalsučiai;Zuikių;6415906523;Ne;2;1;0;3
9017;Smalsučiai;Zuikių;4379645417;Ne;0;9;0;9
9018;Smalsučiai;Zuikių;9732075162;Ne;0;5;0;5
9019;Smalsučiai;Zuikių;6090391818;Ne;1;2;0;3
9020;Smalsučiai;Zuikių;7023531176;Ne;1;0;0;1
9021;Smalsučiai;Zuikių;5098291946;Ne;0;0;21;21
9022;Smalsučiai;Zuikių;3582805599;Ne;0;1;0;1
9023;Smalsučiai;Zuikių;7137550663;Ne;0;3;0;3
9024;Smalsučiai;Zuikių;8578693978;Ne;0;3;0;3
9025;Smalsučiai;Zuikių;4506058735;Ne;0;20;0;20
9026;Smalsučiai;Nykštukų;6279850475;Ne;9;0;0;9
9027;Smalsučiai;Nykštukų;8461139523;Ne;1;2;0;3
9028;Smalsučiai;Nykštukų;3162567266;Ne;1;2;0;3
9029;Smalsučiai;Nykštukų;8405943289;Ne;10;0;0;10
9030;Smalsučiai;Nykštukų;7231947961;Ne;10;0;0;10
9031;Smalsučiai;Nykštukų;5205336476;Ne;9;0;0;9
9032;Smalsučiai;Nykštukų;5537437823;Ne;3;0;0;3
9033;Smalsučiai;Nykštukų;4110887316;Ne;3;0;0;3
9034;Smalsučiai;Nykštukų;2271751532;Ne;11;0;0;11
9035;Smalsučiai;Nykštukų;7257857454;Taip;12;0;0;12
9036;Smalsučiai;Nykštukų;9299524862;Ne;7;0;0;7
9037;Smalsučiai;Katinėlių;2369569130;Ne;0;1;0;1
9038;Smalsučiai;Katinėlių;3636314894;Ne;13;0;0;13
9039;Smalsučiai;Katinėlių;4306056807;Ne;6;0;0;6
9040;Smalsučiai;Katinėlių;7094624971;Ne;3;0;0;3
9041;Smalsučiai;Katinėlių;1956492436;Ne;1;0;0;1
9042;Smalsučiai;Katinėlių;5710530457;Ne;0;1;3;4
9043;Smalsučiai;Katinėlių;4517950062;Taip;4;1;0;5
9044;Smalsučiai;Katinėlių;7567134320;Ne;4;0;0;4
9045;Smalsučiai;Katinėlių;5390381543;Ne;17;0;0;17
9046;Smalsučiai;Katinėlių;9373529880;Ne;16;0;0;16
9047;Smalsučiai;Katinėlių;3104627678;Ne;8;0;0;8
9048;Smalsučiai;Katinėlių;4989144093;Ne;2;0;1;3
9049;Smalsučiai;Katinėlių;4275309820;Ne;0;5;3;8
9050;Smalsučiai;PELĖDŽIUKAI;9222858199;Ne;7;0;2;9
9051;Smalsučiai;PELĖDŽIUKAI;1909797307;Taip;0;0;4;4
9052;Smalsučiai;PELĖDŽIUKAI;7400990599;Ne;0;0;4;4
9053;Smalsučiai;PELĖDŽIUKAI;2673224420;Ne;0;0;1;1
9054;Smalsučiai;PELĖDŽIUKAI;9771532192;Ne;0;10;0;10
9055;Smalsučiai;PELĖDŽIUKAI;8402519872;Ne;0;0;1;1
9056;Smalsučiai;PELĖDŽIUKAI;1305808180;Ne;0;1;0;1
9057;Smalsučiai;PELĖDŽIUKAI;6393203986;Ne;0;3;0;3
9058;Smalsučiai;PELĖDŽIUKAI;3746193901;Taip;0;5;0;5
9059;Smalsučiai;PELĖDŽIUKAI;8499612926;Ne;0;0;4;4
9060;Smalsučiai;PELĖDŽIUKAI;3625628040;Taip;1;0;0;1
9061;Smalsučiai;PELĖDŽIUKAI;6128134712;Ne;7;0;0;7
9062;Smalsučiai;PELĖDŽIUKAI;8615789381;Ne;4;1;0;5
9063;Smalsučiai;PELĖDŽIUKAI;3045521655;Ne;11;0;3;14
9064;Smalsučiai;PELĖDŽIUKAI;5789420793;Ne;4;0;0;4
9065;Smalsučiai;PELĖDŽIUKAI;7973827402;Ne;4;0;0;4
9066;Smalsučiai;PELĖDŽIUKAI;5104153092;Ne;0;0;7;7
9067;Smalsučiai;Pingvinukai;3064333387;Ne;5;0;0;5
9068;Smalsučiai;Pingvinukai;4557510634;Ne;4;0;1;5
9069;Smalsučiai;Pingvinukai;7065180174;Taip;0;1;0;1
9070;Smalsučiai;Pingvinukai;8493312040;Ne;0;0;1;1
9071;Smalsučiai;Pingvinukai;5081708388;Ne;9;0;0;9
9072;Smalsučiai;Pingvinukai;6430983316;Ne;3;0;0;3
9073;Smalsučiai;Voverikų;4811022648;Ne;0;8;1;9
9074;Smalsučiai;Voverikų;4973651632;Ne;0;8;1;9
9075;Smalsučiai;Voverikų;3509573985;Ne;3;0;0;3
9076;Smalsučiai;Voverikų;3042578767;Ne;0;8;0;8
9077;Smalsučiai;Voverikų;2070248478;Ne;2;0;0;2
9078;Smalsučiai;Voverikų;7205498813;Taip;0;1;5;6
9079;Smalsučiai;Voverikų;2612579099;Ne;0;20;0;20
9080;Smalsučiai;Voverikų;1559069582;Ne;0;0;1;1
9081;Smalsučiai;Voverikų;2885279828;Ne;0;6;0;6
9082;Smalsučiai;Voverikų;1162035522;Ne;0;0;4;4
9083;Smalsučiai;Voverikų;5964344820;Ne;0;5;1;6
9084;Smalsučiai;Voverikų;4611852575;Ne;0;8;0;8
9085;Smalsučiai;Voverikų;7988779202;Taip;0;4;0;4
9086;Smalsučiai;Voverikų;2583712404;Ne;0;0;3;3
9087;Smalsučiai;Voverikų;6984861531;Ne;0;0;3;3
9088;Smalsučiai;Voverikų;6399363046;Ne;5;0;0;5
9089;Smalsučiai;Voverikų;4233687544;Ne;7;0;0;7
9090;Spragtukas;NYKŠTUKAI;4527798635;Ne;6;0;0;6
9091;Spragtukas;NYKŠTUKAI;8551195766;Ne;1;7;1;9
9092;Spragtukas;NYKŠTUKAI;8297700739;Ne;10;0;0;10
9093;Spragtukas;NYKŠTUKAI;9595221494;Ne;8;0;1;9
9094;Spragtukas;NYKŠTUKAI;8715073512;Ne;8;0;0;8
9095;Spragtukas;NYKŠTUKAI;1710184531;Ne;7;10;0;17
9096;Spragtukas;NYKŠTUKAI;2076126173;Ne;10;3;0;13
9097;Spragtukas;NYKŠTUKAI;3012345413;Ne;20;0;0;20
9098;Spragtukas;NYKŠTUKAI;8698492694;Ne;4;0;3;7
9099;Spragtukas;NYKŠTUKAI;1150002524;Ne;8;1;0;9
9100;Spragtukas;NYKŠTUKAI;4493810276;Ne;16;0;1;17
9101;Spragtukas;NYKŠTUKAI;8288793522;Ne;9;1;0;10
9102;Spragtukas;NYKŠTUKAI;6986034864;Ne;10;0;0;10
9103;Spragtukas;NYKŠTUKAI;9308064461;Ne;4;0;1;5
9104;Spragtukas;SAULUTĖ;3337355440;Taip;5;0;0;5
9105;Spragtukas;SAULUTĖ;4669257062;Ne;5;3;0;8
9106;Spragtukas;SAULUTĖ;3692960591;Ne;8;0;0;8
9107;Spragtukas;SAULUTĖ;4586034709;Taip;5;0;0;5
9108;Spragtukas;SAULUTĖ;3948232692;Ne;2;2;2;6
9109;Spragtukas;SAULUTĖ;9149954373;Ne;0;8;0;8
9110;Spragtukas;SAULUTĖ;8235791891;Ne;5;0;0;5
9111;Spragtukas;SAULUTĖ;2987638580;Ne;0;2;3;5
9112;Spragtukas;SAULUTĖ;5687853390;Taip;0;2;0;2
9113;Spragtukas;SAULUTĖ;6679886985;Ne;5;11;0;16
9114;Spragtukas;SAULUTĖ;2879077913;Ne;0;4;0;4
9115;Spragtukas;SAULUTĖ;1998148708;Taip;5;2;0;7
9116;Spragtukas;SAULUTĖ;8227086854;Ne;0;7;0;7
9117;Spragtukas;SAULUTĖ;3086399458;Ne;0;2;0;2
9118;Spragtukas;SAULUTĖ;2879614195;Taip;0;11;0;11
9119;Spragtukas;SAULUTĖ;8912031554;Taip;12;0;0;12
9120;Spragtukas;SPINDULĖLIAI;8083960192;Ne;0;0;2;2
9121;Spragtukas;SPINDULĖLIAI;6228634157;Ne;5;0;2;7
9122;Spragtukas;SPINDULĖLIAI;5902286196;Ne;0;0;2;2
9123;Spragtukas;SPINDULĖLIAI;4194552077;Ne;2;0;0;2
9124;Spragtukas;SPINDULĖLIAI;9074266444;Ne;0;0;2;2
9125;Spragtukas;SPINDULĖLIAI;6313941560;Ne;0;0;1;1
9126;Spragtukas;SPINDULĖLIAI;3323280861;Ne;0;0;2;2
9127;Spragtukas;SPINDULĖLIAI;8856554286;Ne;5;0;0;5
9128;Spragtukas;SPINDULĖLIAI;3367731738;Ne;5;2;0;7
9129;Spragtukas;GINTARĖLIAI;5724874569;Ne;0;2;0;2
9130;Spragtukas;GINTARĖLIAI;1430632638;Ne;0;3;0;3
9131;Spragtukas;GINTARĖLIAI;8625143071;Ne;0;10;0;10
9132;Spragtukas;GINTARĖLIAI;2255007161;Ne;0;2;0;2
9133;Spragtukas;GINTARĖLIAI;6493380877;Ne;0;2;0;2
9134;Spragtukas;GINTARĖLIAI;9664130733;Ne;0;10;0;10
9135;Spragtukas;GINTARĖLIAI;2316071393;Ne;0;1;0;1
9136;Spragtukas;GINTARĖLIAI;8698469979;Ne;0;11;0;11
9137;Spragtukas;GINTARĖLIAI;1747417905;Ne;0;7;0;7
9138;Spragtukas;GINTARĖLIAI;6388163866;Ne;0;4;0;4
9139;Spragtukas;GINTARĖLIAI;8191270443;Ne;2;2;0;4
9140;Spragtukas;GINTARĖLIAI;3684183344;Ne;0;3;0;3
9141;Spragtukas;GINTARĖLIAI;7806145224;Ne;7;1;0;8
9142;Spragtukas;GINTARĖLIAI;2992201984;Ne;0;4;0;4
9143;Spragtukas;GINTARĖLIAI;2217627240;Taip;0;4;0;4
9144;Spragtukas;GINTARĖLIAI;1150727381;Ne;4;4;0;8
9145;Spragtukas;GINTARĖLIAI;2706473182;Ne;4;1;0;5
9146;Spragtukas;ČIPOLINO;9951226210;Ne;0;2;0;2
9147;Spragtukas;ČIPOLINO;7933945356;Ne;0;5;0;5
9148;Spragtukas;ČIPOLINO;8473814776;Ne;0;1;0;1
9149;Spragtukas;ČIPOLINO;4461217748;Ne;0;3;0;3
9150;Spragtukas;ČIPOLINO;9579825533;Ne;5;1;0;6
9151;Spragtukas;ČIPOLINO;9443091032;Ne;0;13;0;13
9152;Spragtukas;ČIPOLINO;7412489884;Ne;6;0;0;6
9153;Spragtukas;ČIPOLINO;1545887575;Ne;2;6;0;8
9154;Spragtukas;ČIPOLINO;9294770557;Ne;9;0;0;9
9155;Spragtukas;ČIPOLINO;8110631015;Ne;0;1;0;1
9156;Spragtukas;ČIPOLINO;2963449719;Ne;3;0;0;3
9157;Spragtukas;ČIPOLINO;8136108310;Ne;0;8;0;8
9158;Spragtukas;ČIPOLINO;8710910167;Ne;0;6;0;6
9159;Spragtukas;ČIPOLINO;7692148513;Ne;4;0;0;4
9160;Spragtukas;ČIPOLINO;2599579491;Ne;7;1;0;8
9161;Spragtukas;BORUŽĖLĖS;8614890958;Ne;0;6;0;6
9162;Spragtukas;BORUŽĖLĖS;2356476212;Ne;0;0;1;1
9163;Spragtukas;BORUŽĖLĖS;8287102733;Taip;0;10;0;10
9164;Spragtukas;BORUŽĖLĖS;6584145176;Ne;0;9;0;9
9165;Spragtukas;BORUŽĖLĖS;6824861247;Ne;13;1;0;14
9166;Spragtukas;BORUŽĖLĖS;7264683147;Ne;10;1;0;11
9167;Spragtukas;BORUŽĖLĖS;5556920140;Ne;9;1;0;10
9168;Spragtukas;BORUŽĖLĖS;7073092344;Ne;0;18;0;18
9169;Spragtukas;BORUŽĖLĖS;1046613540;Ne;0;7;0;7
9170;Spragtukas;BORUŽĖLĖS;1180285187;Taip;0;0;2;2
9171;Spragtukas;BORUŽĖLĖS;2268649859;Ne;0;0;2;2
9172;Spragtukas;BORUŽĖLĖS;3225684296;Ne;6;0;2;8
9173;Spragtukas;BORUŽĖLĖS;5940679759;Ne;3;5;0;8
9174;Spragtukas;DRUGELIAI;7058848570;Ne;3;0;0;3
9175;Spragtukas;DRUGELIAI;7271482702;Ne;5;1;0;6
9176;Spragtukas;DRUGELIAI;9099921999;Ne;3;0;0;3
9177;Spragtukas;DRUGELIAI;4441290823;Taip;11;0;0;11
9178;Spragtukas;DRUGELIAI;5440632023;Ne;0;3;0;3
9179;Spragtukas;DRUGELIAI;8307801987;Taip;0;7;0;7
9180;Spragtukas;DRUGELIAI;9310818975;Ne;0;0;2;2
9181;Spragtukas;DRUGELIAI;8486415968;Ne;5;6;0;11
9182;Spragtukas;DRUGELIAI;4742132709;Taip;9;0;1;10
9183;Spragtukas;DRUGELIAI;3423699840;Ne;0;0;4;4
9184;Spragtukas;DRUGELIAI;7256772984;Ne;0;0;1;1
9185;Spragtukas;DRUGELIAI;2026249018;Taip;6;3;1;10
9186;Spragtukas;DRUGELIAI;1487259291;Ne;6;0;13;19
9187;Spragtukas;DRUGELIAI;8396134652;Ne;8;0;2;10
9188;Spragtukas;GAIDELIAI;2541126095;Ne;4;10;0;14
9189;Spragtukas;GAIDELIAI;4097458544;Ne;11;0;0;11
9190;Spragtukas;GAIDELIAI;8957903306;Ne;0;1;0;1
9191;Spragtukas;GAIDELIAI;1326714513;Ne;4;1;0;5
9192;Spragtukas;GAIDELIAI;7108640957;Ne;0;1;2;3
9193;Spragtukas;GAIDELIAI;6370760287;Ne;0;0;1;1
9194;Spragtukas;GAIDELIAI;7911124524;Ne;5;1;0;6
9195;Spragtukas;GAIDELIAI;9509296936;Ne;0;0;1;1
9196;Spragtukas;GAIDELIAI;3216796441;Ne;5;0;0;5
9197;Spragtukas;GAIDELIAI;8440836721;Taip;21;0;0;21
9198;Spragtukas;GAIDELIAI;4535021524;Ne;0;1;0;1
9199;Spragtukas;GAIDELIAI;2679834328;Ne;1;1;0;2
9200;Spragtukas;GAIDELIAI;7912840514;Ne;3;1;0;4
9201;Spragtukas;ŽUVELĖS;9078163633;Ne;3;0;0;3
9202;Spragtukas;ŽUVELĖS;8762832644;Ne;0;1;0;1
9203;Spragtukas;ŽUVELĖS;8652973900;Ne;0;1;0;1
9204;Spragtukas;ŽUVELĖS;3261213140;Ne;0;3;0;3
9205;Spragtukas;ŽUVELĖS;5689392663;Ne;5;1;0;6
9206;Spragtukas;ŽUVELĖS;9592271053;Taip;0;1;0;1
9207;Spragtukas;ŽUVELĖS;1272075883;Ne;0;6;0;6
9208;Spragtukas;ŽUVELĖS;6503842956;Ne;2;2;0;4
9209;Spragtukas;ŽUVELĖS;2578400770;Ne;0;1;0;1
9210;Spragtukas;ŽUVELĖS;3139748724;Ne;2;3;0;5
9211;Spragtukas;ŽUVELĖS;8640877497;Ne;0;1;0;1
9212;Spragtukas;ŽUVELĖS;2025314314;Ne;0;0;1;1
9213;Spragtukas;ŽUVELĖS;4848647219;Taip;6;1;0;7
9214;Spragtukas;ŽUVELĖS;5704941595;Ne;0;7;0;7
9215;Spragtukas;ŽUVELĖS;9662188102;Ne;0;2;0;2
9216;Spragtukas;ŽUVELĖS;2539660577;Ne;4;1;0;5
9217;Spragtukas;ŽUVELĖS;6836232179;Ne;0;6;0;6
9218;Spragtukas;RIEŠUTĖLIAI;1407611561;Ne;7;0;1;8
9219;Spragtukas;RIEŠUTĖLIAI;8773952377;Ne;0;3;0;3
9220;Spragtukas;RIEŠUTĖLIAI;1977526177;Ne;0;5;0;5
9221;Spragtukas;RIEŠUTĖLIAI;7615522850;Taip;0;7;0;7
9222;Spragtukas;RIEŠUTĖLIAI;6797841737;Ne;3;0;0;3
9223;Spragtukas;RIEŠUTĖLIAI;9204569123;Ne;5;0;0;5
9224;Spragtukas;RIEŠUTĖLIAI;8342098575;Ne;4;1;0;5
9225;Spragtukas;RIEŠUTĖLIAI;1992850470;Ne;3;0;0;3
9226;Spragtukas;RIEŠUTĖLIAI;6158327941;Ne;5;1;0;6
9227;Spragtukas;RIEŠUTĖLIAI;3009567338;Ne;3;0;0;3
9228;Spragtukas;RIEŠUTĖLIAI;2648358901;Ne;5;4;0;9
9229;Spragtukas;RIEŠUTĖLIAI;3822599790;Ne;0;14;0;14
9230;Spragtukas;RIEŠUTĖLIAI;7767940027;Ne;7;0;0;7
9231;Spragtukas;RIEŠUTĖLIAI;4625065223;Ne;6;8;0;14
9232;Spragtukas;RIEŠUTĖLIAI;6963190259;Ne;21;0;0;21
9233;Spragtukas;RIEŠUTĖLIAI;9975308171;Taip;9;0;0;9
9234;Spragtukas;VIŠČIUKAI;6219915771;Ne;5;0;1;6
9235;Spragtukas;VIŠČIUKAI;5497023448;Ne;5;0;0;5
9236;Spragtukas;VIŠČIUKAI;2359209112;Ne;2;0;0;2
9237;Spragtukas;VIŠČIUKAI;4489637427;Ne;1;0;0;1
9238;Spragtukas;VIŠČIUKAI;6804843816;Taip;4;0;0;4
9239;Spragtukas;VIŠČIUKAI;8560471564;Ne;9;0;1;10
9240;Spragtukas;VIŠČIUKAI;1878079499;Ne;1;0;0;1
9241;Spragtukas;MEŠKIUKAI;7730786172;Ne;2;0;1;3
9242;Spragtukas;MEŠKIUKAI;2422384041;Ne;1;0;0;1
9243;Spragtukas;MEŠKIUKAI;1411972930;Ne;1;0;1;2
9244;Spragtukas;MEŠKIUKAI;4654665538;Ne;3;0;0;3
9245;Spragtukas;MEŠKIUKAI;1869458751;Ne;1;4;0;5
9246;Spragtukas;MEŠKIUKAI;4332445650;Ne;2;0;0;2
9247;Spragtukas;MEŠKIUKAI;2172787507;Ne;3;0;0;3
9248;Spragtukas;MEŠKIUKAI;6073139322;Ne;6;0;0;6
9249;Strazdelis;Žiogelių;5346485534;Ne;1;0;0;1
9250;Strazdelis;Žiogelių;9933042249;Ne;0;9;0;9
9251;Strazdelis;Žiogelių;8581533423;Ne;4;0;0;4
9252;Strazdelis;Žiogelių;8209625399;Ne;0;2;0;2
9253;Strazdelis;Žiogelių;1141752802;Ne;4;1;0;5
9254;Strazdelis;Žiogelių;3596394112;Taip;10;2;0;12
9255;Strazdelis;Žiogelių;4563247013;Ne;18;0;1;19
9256;Strazdelis;Žiogelių;6437928004;Ne;0;1;0;1
9257;Strazdelis;Žiogelių;8971395173;Ne;1;1;0;2
9258;Strazdelis;Žiogelių;4955907851;Ne;6;0;1;7
9259;Strazdelis;Žiogelių;7425818775;Ne;1;0;0;1
9260;Strazdelis;Žiogelių;9567476872;Ne;5;0;0;5
9261;Strazdelis;Žiogelių;3028208428;Ne;0;0;2;2
9262;Strazdelis;Žiogelių;2753635198;Taip;0;2;3;5
9263;Strazdelis;Žiogelių;1194918926;Ne;0;0;2;2
9264;Strazdelis;Žiogelių;6651360492;Ne;0;12;0;12
9265;Strazdelis;Žiogelių;7913526787;Ne;15;6;0;21
9266;Strazdelis;Žiogelių;5742215922;Ne;0;1;0;1
9267;Strazdelis;Žiogelių;8035603341;Ne;5;1;0;6
9268;Strazdelis;Šeimynėlės;3848288765;Ne;0;2;3;5
9269;Strazdelis;Šeimynėlės;5033799225;Ne;0;2;3;5
9270;Strazdelis;Šeimynėlės;1683900907;Ne;0;2;0;2
9271;Strazdelis;Šeimynėlės;3897248010;Ne;4;2;0;6
9272;Strazdelis;Šeimynėlės;2990771887;Ne;0;12;0;12
9273;Strazdelis;Šeimynėlės;2185364583;Ne;0;8;0;8
9274;Strazdelis;Šeimynėlės;7905687363;Ne;0;2;0;2
9275;Strazdelis;Šeimynėlės;4501391298;Ne;0;11;0;11
9276;Strazdelis;Šeimynėlės;9057914477;Ne;0;0;1;1
9277;Strazdelis;Šeimynėlės;1277844969;Ne;0;1;0;1
9278;Strazdelis;Šeimynėlės;1012692326;Ne;0;2;3;5
9279;Strazdelis;Šeimynėlės;8899530711;Ne;0;2;3;5
9280;Strazdelis;Šeimynėlės;5784406335;Ne;0;2;0;2
9281;Strazdelis;Šeimynėlės;5296218650;Ne;3;0;0;3
9282;Strazdelis;Šeimynėlės;9209201954;Ne;0;1;0;1
9283;Strazdelis;Šeimynėlės;8295035233;Ne;0;1;0;1
9284;Strazdelis;Šeimynėlės;1553329770;Ne;1;1;0;2
9285;Strazdelis;Genelio;9586256979;Ne;0;1;0;1
9286;Strazdelis;Genelio;3084249678;Ne;0;5;0;5
9287;Strazdelis;Genelio;5499310072;Ne;0;1;0;1
9288;Strazdelis;Genelio;8333151969;Ne;0;2;0;2
9289;Strazdelis;Genelio;6271193831;Ne;2;1;0;3
9290;Strazdelis;Genelio;6480803618;Ne;0;4;0;4
9291;Strazdelis;Genelio;9490861272;Ne;0;13;0;13
9292;Strazdelis;Genelio;6071502600;Ne;0;1;0;1
9293;Strazdelis;Genelio;3713797440;Ne;0;1;0;1
9294;Strazdelis;Genelio;1034497200;Ne;1;2;0;3
9295;Strazdelis;Genelio;2459718449;Ne;0;1;0;1
9296;Strazdelis;Genelio;2483283363;Ne;3;2;0;5
9297;Strazdelis;Genelio;5714581201;Ne;0;2;0;2
9298;Strazdelis;Genelio;8956634754;Ne;7;2;0;9
9299;Strazdelis;Genelio;8762859576;Ne;4;0;0;4
9300;Strazdelis;Genelio;2306665561;Ne;0;8;0;8
9301;Strazdelis;Genelio;7680242840;Ne;0;2;0;2
9302;Strazdelis;Vikruolių;8287554571;Ne;0;1;0;1
9303;Strazdelis;Vikruolių;1901641517;Ne;0;2;0;2
9304;Strazdelis;Vikruolių;8637386316;Ne;0;1;0;1
9305;Strazdelis;Vikruolių;1704292727;Ne;3;2;0;5
9306;Strazdelis;Vikruolių;5892430004;Taip;0;6;0;6
9307;Strazdelis;Vikruolių;4617237063;Ne;3;2;0;5
9308;Strazdelis;Vikruolių;3036380561;Ne;3;2;0;5
9309;Strazdelis;Vikruolių;8371999002;Ne;0;7;0;7
9310;Strazdelis;Vikruolių;4562530311;Ne;0;0;2;2
9311;Strazdelis;Vikruolių;4004930488;Ne;5;5;0;10
9312;Strazdelis;Vikruolių;5768674837;Ne;5;0;3;8
9313;Strazdelis;Vikruolių;7349106795;Ne;2;0;1;3
9314;Strazdelis;Vikruolių;9761595867;Ne;14;0;0;14
9315;Strazdelis;Vikruolių;4448556404;Ne;10;0;0;10
9316;Strazdelis;Vikruolių;7876385010;Ne;0;0;2;2
9317;Strazdelis;Vyturėlių;7471890377;Ne;0;0;2;2
9318;Strazdelis;Vyturėlių;2848984531;Ne;0;1;0;1
9319;Strazdelis;Vyturėlių;4159072583;Ne;0;2;1;3
9320;Strazdelis;Vyturėlių;2662549392;Ne;0;0;1;1
9321;Strazdelis;Vyturėlių;7469848482;Ne;0;0;1;1
9322;Strazdelis;Vyturėlių;1841285441;Taip;0;1;2;3
9323;Strazdelis;Vyturėlių;5904388732;Ne;0;8;0;8
9324;Strazdelis;Vyturėlių;3460993302;Ne;0;0;3;3
9325;Strazdelis;Vyturėlių;7393083827;Ne;0;5;2;7
9326;Strazdelis;Vyturėlių;6555803164;Ne;0;1;0;1
9327;Strazdelis;Vyturėlių;1955166372;Ne;2;0;0;2
9328;Strazdelis;Vyturėlių;1706026100;Ne;5;1;0;6
9329;Strazdelis;Vyturėlių;4873707286;Ne;2;6;0;8
9330;Strazdelis;Vyturėlių;3610250359;Ne;0;0;1;1
9331;Strazdelis;Vyturėlių;2789987994;Ne;0;1;0;1
9332;Strazdelis;Vyturėlių;1173067724;Ne;2;15;0;17
9333;Strazdelis;Varpelio;9502341478;Ne;1;8;0;9
9334;Strazdelis;Varpelio;5924324241;Ne;13;0;2;15
9335;Strazdelis;Varpelio;6954336739;Ne;5;0;1;6
9336;Strazdelis;Varpelio;3456287323;Taip;0;5;0;5
9337;Strazdelis;Varpelio;2990465012;Ne;1;1;0;2
9338;Strazdelis;Varpelio;5425585036;Ne;0;1;0;1
9339;Strazdelis;Varpelio;1018598897;Ne;0;0;1;1
9340;Strazdelis;Varpelio;5314676261;Ne;0;1;0;1
9341;Strazdelis;Varpelio;5683969627;Ne;5;0;0;5
9342;Strazdelis;Varpelio;2398220397;Ne;0;1;6;7
9343;Strazdelis;Varpelio;1455467186;Ne;0;3;0;3
9344;Strazdelis;Pelėdžiukų;7087235151;Ne;0;5;0;5
9345;Strazdelis;Pelėdžiukų;4461728361;Ne;0;17;0;17
9346;Strazdelis;Pelėdžiukų;1770338988;Ne;1;1;0;2
9347;Strazdelis;Pelėdžiukų;3030445367;Ne;0;0;1;1
9348;Strazdelis;Pelėdžiukų;8484672456;Ne;2;1;0;3
9349;Strazdelis;Pelėdžiukų;6457478289;Ne;2;1;0;3
9350;Strazdelis;Pelėdžiukų;8953577585;Ne;0;1;0;1
9351;Strazdelis;Pelėdžiukų;3426039979;Ne;4;8;0;12
9352;Strazdelis;Pelėdžiukų;4334385271;Ne;1;11;0;12
9353;Strazdelis;Pelėdžiukų;8677659019;Ne;0;2;1;3
9354;Strazdelis;Pelėdžiukų;4848650799;Ne;0;1;0;1
9355;Strazdelis;Pelėdžiukų;4174940099;Ne;1;1;0;2
9356;Strazdelis;Pelėdžiukų;8554043784;Taip;0;8;0;8
9357;Strazdelis;Pelėdžiukų;1952086370;Taip;0;2;0;2
9358;Strazdelis;Saulutės;8686828982;Taip;0;8;0;8
9359;Strazdelis;Saulutės;1228651165;Ne;0;1;0;1
9360;Strazdelis;Saulutės;7768700192;Ne;0;1;0;1
9361;Strazdelis;Saulutės;2852253325;Ne;2;0;0;2
9362;Strazdelis;Saulutės;3943914976;Ne;2;0;0;2
9363;Strazdelis;Saulutės;8938997208;Ne;0;1;0;1
9364;Strazdelis;Saulutės;2589303722;Ne;0;1;0;1
9365;Strazdelis;Saulutės;5232064496;Ne;0;1;0;1
9366;Strazdelis;Saulutės;2081538505;Ne;1;14;0;15
9367;Strazdelis;Saulutės;9776075027;Ne;1;0;1;2
9368;Strazdelis;Saulutės;6311710825;Ne;0;1;0;1
9369;Strazdelis;Saulutės;1021364759;Ne;0;1;0;1
9370;Strazdelis;Bitutės;8485509145;Ne;0;1;0;1
9371;Strazdelis;Bitutės;6508933324;Ne;0;1;0;1
9372;Strazdelis;Bitutės;4020547762;Ne;0;2;0;2
9373;Strazdelis;Bitutės;8753316532;Ne;5;2;0;7
9374;Strazdelis;Bitutės;9555240419;Ne;0;1;0;1
9375;Strazdelis;Bitutės;3043580835;Ne;0;3;0;3
9376;Strazdelis;Bitutės;1539984888;Ne;0;1;0;1
9377;Strazdelis;Bitutės;4400849922;Ne;2;2;0;4
9378;Strazdelis;Bitutės;7890064837;Ne;10;2;0;12
9379;Strazdelis;Bitutės;1881071425;Taip;7;0;0;7
9380;Strazdelis;Bitutės;2908567982;Ne;5;3;0;8
9381;Strazdelis;Bitutės;9548465554;Ne;0;6;0;6
9382;Strazdelis;Bitutės;2963535523;Ne;0;5;0;5
9383;Strazdelis;Bitutės;4369569609;Ne;0;2;1;3
9384;Strazdelis;Mažylių;9357195019;Ne;0;2;0;2
9385;Strazdelis;Mažylių;5256750516;Ne;0;5;0;5
9386;Strazdelis;Mažylių;2378910473;Ne;9;3;0;12
9387;Strazdelis;Mažylių;3648883435;Ne;14;2;0;16
9388;Strazdelis;Mažylių;6788732053;Ne;0;2;0;2
9389;Strazdelis;Mažylių;7039347901;Ne;3;0;0;3
9390;Strazdelis;Mažylių;4904388387;Ne;3;1;0;4
9391;Strazdelis;Mažylių;3082900425;Ne;0;2;0;2
9392;Strazdelis;Mažylių;3900225484;Ne;5;0;0;5
9393;Strazdelis;Mažylių;8734458997;Ne;6;0;0;6
9394;Strazdelis;Mažylių;3561551193;Ne;0;3;0;3
9395;Strazdelis;Mažylių;1932428439;Ne;0;1;0;1
9396;Strazdelis;Mažylių;2871841427;Ne;5;4;0;9
9397;Strazdelis;Mažylių;3572665646;Ne;3;0;0;3
9398;Strazdelis;Mažylių;8699020650;Ne;2;2;0;4
9399;Strazdelis;Pabiručių;6853311266;Ne;0;2;0;2
9400;Strazdelis;Pabiručių;1823053560;Ne;7;10;0;17
9401;Strazdelis;Pabiručių;7065489134;Ne;0;4;0;4
9402;Strazdelis;Pabiručių;9931075329;Ne;0;5;0;5
9403;Strazdelis;Pabiručių;4335313098;Taip;0;2;0;2
9404;Strazdelis;Pabiručių;6199087019;Ne;0;8;0;8
9405;Strazdelis;Pabiručių;2230287744;Ne;0;2;0;2
9406;Strazdelis;Pabiručių;1361102201;Ne;0;0;1;1
9407;Strazdelis;Pabiručių;4740153387;Ne;0;1;0;1
9408;Sveikuolis;EŽIUKAI;8230064533;Ne;3;0;0;3
9409;Šermukšnėlė;MOLINUKAI;9746313951;Ne;0;10;0;10
9410;Šermukšnėlė;MOLINUKAI;4638109666;Taip;0;6;1;7
9411;Šermukšnėlė;MOLINUKAI;9329824053;Ne;0;0;1;1
9412;Šermukšnėlė;MOLINUKAI;2714018690;Ne;16;0;0;16
9413;Šermukšnėlė;MOLINUKAI;5262882873;Ne;5;1;0;6
9414;Šermukšnėlė;MOLINUKAI;7385114026;Ne;0;0;2;2
9415;Šermukšnėlė;MOLINUKAI;2784732759;Ne;0;0;3;3
9416;Šermukšnėlė;MOLINUKAI;3342919832;Ne;5;0;0;5
9417;Šermukšnėlė;MOLINUKAI;9337047371;Ne;0;0;1;1
9418;Šermukšnėlė;MOLINUKAI;2098090763;Ne;0;0;2;2
9419;Šermukšnėlė;MOLINUKAI;5835100042;Taip;0;0;4;4
9420;Šermukšnėlė;MOLINUKAI;8000479161;Ne;0;0;2;2
9421;Šermukšnėlė;MOLINUKAI;4952285322;Ne;0;6;0;6
9422;Šermukšnėlė;MOLINUKAI;5733048755;Ne;12;0;1;13
9423;Šermukšnėlė;MOLINUKAI;6608458145;Ne;5;0;0;5
9424;Šermukšnėlė;MOLINUKAI;8104182167;Ne;0;0;4;4
9425;Šermukšnėlė;MOLINUKAI;6988120570;Ne;0;18;0;18
9426;Šermukšnėlė;MOLINUKAI;8728441474;Ne;15;0;0;15
9427;Šermukšnėlė;MOLINUKAI;4075151928;Ne;0;0;1;1
9428;Šermukšnėlė;MOLINUKAI;9527382390;Ne;0;0;1;1
9429;Šermukšnėlė;MOLINUKAI;4968522498;Ne;15;9;0;24
9430;Šermukšnėlė;ŠIAUDINUKAI;7249568196;Ne;0;7;0;7
9431;Šermukšnėlė;ŠIAUDINUKAI;3451361097;Ne;0;0;1;1
9432;Šermukšnėlė;ŠIAUDINUKAI;7002917737;Ne;6;1;0;7
9433;Šermukšnėlė;ŠIAUDINUKAI;7785671936;Ne;8;0;1;9
9434;Šermukšnėlė;ŠIAUDINUKAI;3637882900;Ne;0;9;0;9
9435;Šermukšnėlė;ŠIAUDINUKAI;1159472154;Ne;0;0;2;2
9436;Šermukšnėlė;ŠIAUDINUKAI;4956414941;Ne;10;0;0;10
9437;Šermukšnėlė;ŠIAUDINUKAI;3499394539;Ne;0;10;2;12
9438;Šermukšnėlė;ŠIAUDINUKAI;1157979179;Ne;0;10;0;10
9439;Šermukšnėlė;ŠIAUDINUKAI;7917101921;Ne;3;0;0;3
9440;Šermukšnėlė;ŠIAUDINUKAI;3082272196;Taip;0;0;3;3
9441;Šermukšnėlė;ŠIAUDINUKAI;9903310024;Ne;0;2;1;3
9442;Šermukšnėlė;ŠIAUDINUKAI;9012757607;Ne;0;0;1;1
9443;Šermukšnėlė;ŠIAUDINUKAI;5627334876;Ne;0;0;2;2
9444;Šermukšnėlė;ŠIAUDINUKAI;3550736579;Ne;12;6;0;18
9445;Šermukšnėlė;ŠIAUDINUKAI;5993599994;Taip;9;8;3;20
9446;Šermukšnėlė;ŠIAUDINUKAI;6077798297;Ne;0;0;4;4
9447;Šermukšnėlė;ŠIAUDINUKAI;2351386211;Ne;6;0;5;11
9448;Šermukšnėlė;TOŠINUKAI;3994316729;Ne;0;1;0;1
9449;Šermukšnėlė;TOŠINUKAI;5096946133;Ne;0;0;3;3
9450;Šermukšnėlė;TOŠINUKAI;7229632099;Ne;6;0;0;6
9451;Šermukšnėlė;TOŠINUKAI;7038705221;Ne;0;0;7;7
9452;Šermukšnėlė;TOŠINUKAI;9035625467;Taip;10;0;0;10
9453;Šermukšnėlė;TOŠINUKAI;3081548524;Ne;0;0;2;2
9454;Šermukšnėlė;TOŠINUKAI;9442514813;Ne;0;0;1;1
9455;Šermukšnėlė;TOŠINUKAI;9585435700;Taip;5;0;2;7
9456;Šermukšnėlė;TOŠINUKAI;1131780941;Taip;0;0;1;1
9457;Šermukšnėlė;TOŠINUKAI;6286039101;Ne;10;0;0;10
9458;Šermukšnėlė;TOŠINUKAI;9584702487;Ne;4;0;0;4
9459;Šermukšnėlė;TOŠINUKAI;8691777167;Ne;1;0;1;2
9460;Šermukšnėlė;TOŠINUKAI;2534758615;Ne;5;0;1;6
9461;Šermukšnėlė;TOŠINUKAI;1622834854;Ne;4;0;0;4
9462;Šermukšnėlė;TOŠINUKAI;4945395564;Ne;9;0;2;11
9463;Šermukšnėlė;TOŠINUKAI;2163955454;Ne;0;0;1;1
9464;Šermukšnėlė;TOŠINUKAI;7106405983;Ne;3;0;3;6
9465;Šermukšnėlė;ODINUKAI;4422415026;Taip;7;6;0;13
9466;Šermukšnėlė;ODINUKAI;5545018656;Ne;0;0;1;1
9467;Šermukšnėlė;ODINUKAI;2176788727;Taip;0;5;1;6
9468;Šermukšnėlė;ODINUKAI;5575518612;Ne;0;0;1;1
9469;Šermukšnėlė;ODINUKAI;5733540837;Ne;0;0;2;2
9470;Šermukšnėlė;ODINUKAI;5159461963;Ne;0;0;1;1
9471;Šermukšnėlė;ODINUKAI;5354978646;Ne;1;11;0;12
9472;Šermukšnėlė;ODINUKAI;1882432812;Ne;0;11;1;12
9473;Šermukšnėlė;ODINUKAI;4201283154;Ne;0;0;1;1
9474;Šermukšnėlė;ODINUKAI;6105915822;Ne;0;0;1;1
9475;Šermukšnėlė;ODINUKAI;7667114310;Ne;0;0;1;1
9476;Šermukšnėlė;ODINUKAI;7245206247;Ne;0;0;2;2
9477;Šermukšnėlė;ODINUKAI;4331948700;Ne;0;0;1;1
9478;Šermukšnėlė;ODINUKAI;6718242890;Ne;0;0;1;1
9479;Šermukšnėlė;ODINUKAI;1064222922;Ne;0;0;3;3
9480;Šermukšnėlė;ODINUKAI;7770630580;Ne;0;6;1;7
9481;Šermukšnėlė;KRIAUKLELĖS;4256630681;Ne;0;0;6;6
9482;Šermukšnėlė;KRIAUKLELĖS;8117261716;Ne;5;0;2;7
9483;Šermukšnėlė;KRIAUKLELĖS;6946711443;Ne;1;0;1;2
9484;Šermukšnėlė;KRIAUKLELĖS;9908568127;Ne;5;0;1;6
9485;Šermukšnėlė;KRIAUKLELĖS;9783673534;Ne;0;7;0;7
9486;Šermukšnėlė;KRIAUKLELĖS;5408843906;Ne;0;1;0;1
9487;Šermukšnėlė;KRIAUKLELĖS;4810571143;Taip;0;2;0;2
9488;Šermukšnėlė;KRIAUKLELĖS;4219655802;Ne;5;0;0;5
9489;Šermukšnėlė;KRIAUKLELĖS;6797936390;Ne;0;0;3;3
9490;Šermukšnėlė;KRIAUKLELĖS;8092422909;Ne;10;0;5;15
9491;Šermukšnėlė;KRIAUKLELĖS;6286235756;Ne;5;0;0;5
9492;Šermukšnėlė;KRIAUKLELĖS;9080074486;Ne;3;0;1;4
9493;Šermukšnėlė;KRIAUKLELĖS;5456669766;Ne;0;3;0;3
9494;Šermukšnėlė;KRIAUKLELĖS;7098953763;Ne;0;0;3;3
9495;Šermukšnėlė;VYTINUKAI;2235123503;Ne;1;0;1;2
9496;Šermukšnėlė;VYTINUKAI;5605191023;Taip;5;0;0;5
9497;Šermukšnėlė;VYTINUKAI;6928863055;Ne;0;0;1;1
9498;Šermukšnėlė;VYTINUKAI;8558117857;Taip;0;1;3;4
9499;Šermukšnėlė;VYTINUKAI;6531113007;Ne;0;5;0;5
9500;Šermukšnėlė;VYTINUKAI;8437052600;Ne;0;0;1;1
9501;Šermukšnėlė;VYTINUKAI;1318170904;Taip;5;0;0;5
9502;Šermukšnėlė;VYTINUKAI;8200175951;Ne;5;1;0;6
9503;Šermukšnėlė;VYTINUKAI;6149973884;Taip;14;0;0;14
9504;Šermukšnėlė;VYTINUKAI;5874725607;Ne;0;0;2;2
9505;Šermukšnėlė;VYTINUKAI;7532979465;Taip;0;5;0;5
9506;Šermukšnėlė;VYTINUKAI;7546040491;Ne;12;0;0;12
9507;Šermukšnėlė;VYTINUKAI;2698741674;Ne;0;1;0;1
9508;Šermukšnėlė;VYTINUKAI;3359398381;Ne;0;0;1;1
9509;Šermukšnėlė;VYTINUKAI;9872479998;Ne;15;0;1;16
9510;Šermukšnėlė;GINTARĖLIAI;8249749948;Ne;0;0;1;1
9511;Šermukšnėlė;GINTARĖLIAI;2989011150;Ne;0;2;1;3
9512;Šermukšnėlė;GINTARĖLIAI;3747531232;Ne;2;0;1;3
9513;Šermukšnėlė;GINTARĖLIAI;1996859146;Ne;2;0;0;2
9514;Šermukšnėlė;GINTARĖLIAI;4176986876;Ne;0;5;0;5
9515;Šermukšnėlė;GINTARĖLIAI;7036078780;Ne;16;1;0;17
9516;Šermukšnėlė;GINTARĖLIAI;1994737857;Ne;0;1;1;2
9517;Šermukšnėlė;GINTARĖLIAI;4619811264;Ne;0;1;1;2
9518;Šermukšnėlė;GINTARĖLIAI;5886893562;Ne;10;5;0;15
9519;Šermukšnėlė;GINTARĖLIAI;4783726095;Ne;8;0;1;9
9520;Šermukšnėlė;GINTARĖLIAI;9714566919;Taip;0;0;1;1
9521;Šermukšnėlė;GINTARĖLIAI;5172187141;Ne;0;7;0;7
9522;Šermukšnėlė;GINTARĖLIAI;3688946505;Ne;6;0;3;9
9523;Šermukšnėlė;GINTARĖLIAI;5905330617;Ne;0;10;1;11
9524;Šermukšnėlė;GINTARĖLIAI;1636944853;Ne;0;11;0;11
9525;Šermukšnėlė;GINTARĖLIAI;7053319091;Taip;0;0;2;2
9526;Šermukšnėlė;GINTARĖLIAI;6351841889;Taip;13;0;0;13
9527;Šermukšnėlė;GINTARĖLIAI;6698650179;Ne;0;3;0;3
9528;Šermukšnėlė;GINTARĖLIAI;8639470631;Ne;2;9;0;11
9529;Šermukšnėlė;GINTARĖLIAI;8541743148;Ne;4;0;0;4
9530;Šermukšnėlė;AKMENUKAI;8407947566;Ne;3;0;3;6
9531;Šermukšnėlė;AKMENUKAI;8669676262;Ne;0;5;0;5
9532;Šermukšnėlė;AKMENUKAI;3148857617;Ne;0;6;0;6
9533;Šermukšnėlė;AKMENUKAI;4965640386;Ne;1;0;0;1
9534;Šermukšnėlė;AKMENUKAI;3639954786;Ne;0;0;14;14
9535;Šermukšnėlė;AKMENUKAI;7843128263;Ne;0;1;0;1
9536;Šermukšnėlė;AKMENUKAI;9805841777;Ne;4;0;0;4
9537;Šermukšnėlė;AKMENUKAI;5660238634;Ne;2;6;0;8
9538;Šermukšnėlė;AKMENUKAI;6067298318;Ne;11;0;0;11
9539;Šermukšnėlė;AKMENUKAI;5678559268;Ne;1;0;0;1
9540;Šermukšnėlė;AKMENUKAI;8479230675;Ne;0;4;0;4
9541;Šermukšnėlė;AKMENUKAI;6162830167;Ne;4;0;0;4
9542;Šermukšnėlė;AKMENUKAI;2913363351;Taip;11;0;1;12
9543;Šermukšnėlė;AKMENUKAI;2506945279;Ne;9;0;0;9
9544;Šermukšnėlė;AKMENUKAI;8709426669;Ne;0;7;0;7
9545;Šermukšnėlė;AKMENUKAI;6599779539;Ne;0;5;0;5
9546;Šermukšnėlė;AKMENUKAI;9876533442;Ne;1;5;0;6
9547;Šermukšnėlė;AKMENUKAI;3653792683;Ne;2;0;1;3
9548;Šermukšnėlė;SIŪLINUKAI;2967000352;Ne;5;0;2;7
9549;Šermukšnėlė;SIŪLINUKAI;4528448735;Ne;0;0;3;3
9550;Šermukšnėlė;SIŪLINUKAI;2740644605;Ne;7;0;1;8
9551;Šermukšnėlė;SIŪLINUKAI;8454298610;Ne;0;0;3;3
9552;Šermukšnėlė;SIŪLINUKAI;1819553019;Ne;19;0;0;19
9553;Šermukšnėlė;SIŪLINUKAI;7568969509;Ne;0;0;1;1
9554;Šermukšnėlė;SIŪLINUKAI;7758886713;Ne;0;0;1;1
9555;Šermukšnėlė;SIŪLINUKAI;4390650081;Taip;0;0;1;1
9556;Šermukšnėlė;SIŪLINUKAI;5072021867;Ne;0;0;1;1
9557;Šermukšnėlė;SIŪLINUKAI;7934772640;Ne;0;4;0;4
9558;Šermukšnėlė;SIŪLINUKAI;3994075596;Ne;5;0;0;5
9559;Šermukšnėlė;SIŪLINUKAI;3979766151;Taip;17;0;0;17
9560;Šermukšnėlė;SIŪLINUKAI;9534316724;Ne;11;0;1;12
9561;Šermukšnėlė;SIŪLINUKAI;9703804879;Ne;0;3;0;3
9562;Šermukšnėlė;SIŪLINUKAI;1754181467;Ne;0;7;0;7
9563;Šermukšnėlė;SIŪLINUKAI;6030012939;Ne;0;0;1;1
9564;Šermukšnėlė;MEDINUKAi;2568480087;Ne;16;0;1;17
9565;Šermukšnėlė;MEDINUKAi;3819765572;Taip;1;0;1;2
9566;Šermukšnėlė;MEDINUKAi;2868258867;Ne;0;10;0;10
9567;Šermukšnėlė;MEDINUKAi;5483843510;Ne;0;0;2;2
9568;Šermukšnėlė;MEDINUKAi;7832178585;Ne;5;4;0;9
9569;Šermukšnėlė;MEDINUKAi;7523588943;Ne;0;1;0;1
9570;Šermukšnėlė;MEDINUKAi;1931894084;Ne;0;1;0;1
9571;Šermukšnėlė;MEDINUKAi;9535836301;Ne;0;0;2;2
9572;Šermukšnėlė;MEDINUKAi;3138507073;Ne;18;3;0;21
9573;Šermukšnėlė;MEDINUKAi;6778901855;Ne;0;2;0;2
9574;Šermukšnėlė;MEDINUKAi;1502704170;Ne;6;0;2;8
9575;Šermukšnėlė;MEDINUKAi;9247356229;Ne;10;1;0;11
9576;Šermukšnėlė;MEDINUKAi;3206222470;Ne;8;0;0;8
9577;Šermukšnėlė;MEDINUKAi;5751303170;Ne;2;0;3;5
9578;Šermukšnėlė;MEDINUKAi;2810624440;Ne;9;9;0;18
9579;Šermukšnėlė;MEDINUKAi;3955219247;Ne;0;1;0;1
9580;Šermukšnėlė;MEDINUKAi;5564759354;Taip;6;0;2;8
9581;Šermukšnėlė;MEDINUKAi;5081685546;Taip;1;12;8;21
9582;Šermukšnėlė;SKUDURINUKAI;5162694179;Ne;12;0;0;12
9583;Šermukšnėlė;SKUDURINUKAI;9005316719;Ne;5;8;0;13
9584;Šermukšnėlė;SKUDURINUKAI;8898016958;Ne;1;0;0;1
9585;Šermukšnėlė;SKUDURINUKAI;6618875999;Ne;1;0;0;1
9586;Šermukšnėlė;SKUDURINUKAI;9258544213;Taip;3;0;0;3
9587;Šermukšnėlė;SKUDURINUKAI;4839548718;Ne;10;0;0;10
9588;Šermukšnėlė;SKUDURINUKAI;2154197839;Ne;3;0;0;3
9589;Šermukšnėlė;SKUDURINUKAI;2156273039;Ne;3;0;0;3
9590;Šermukšnėlė;SKUDURINUKAI;3024192802;Ne;1;0;0;1
9591;Šermukšnėlė;SKUDURINUKAI;1208356789;Ne;0;0;1;1
9592;Šermukšnėlė;SKUDURINUKAI;6437380493;Ne;1;0;2;3
9593;Šermukšnėlė;SKUDURINUKAI;8726532739;Ne;3;0;0;3
9594;Šermukšnėlė;PAGRANDUKAI;6185588116;Taip;0;0;2;2
9595;Šermukšnėlė;PAGRANDUKAI;1209135668;Ne;12;0;0;12
9596;Šermukšnėlė;PAGRANDUKAI;8641098720;Taip;5;0;0;5
9597;Šermukšnėlė;PAGRANDUKAI;8130815072;Ne;0;4;0;4
9598;Šermukšnėlė;PAGRANDUKAI;9246403711;Taip;1;0;0;1
9599;Šermukšnėlė;PAGRANDUKAI;3105388312;Ne;0;3;1;4
9600;Šermukšnėlė;PAGRANDUKAI;2300950399;Taip;5;3;0;8
9601;Šermukšnėlė;PAGRANDUKAI;7570038521;Ne;8;7;0;15
9602;Šermukšnėlė;PAGRANDUKAI;4627034424;Ne;9;0;0;9
9603;Šermukšnėlė;PAGRANDUKAI;5397987456;Ne;6;0;2;8
9604;Šermukšnėlė;PAGRANDUKAI;3705620362;Ne;0;0;1;1
9605;Šypsena;NYKŠTUKAI;3806651280;Ne;5;8;0;13
9606;Šypsena;NYKŠTUKAI;4330797734;Ne;4;0;9;13
9607;Šypsena;NYKŠTUKAI;7876871684;Ne;0;0;7;7
9608;Šypsena;NYKŠTUKAI;6055482561;Ne;9;0;0;9
9609;Šypsena;NYKŠTUKAI;6028006499;Ne;4;0;1;5
9610;Šypsena;NYKŠTUKAI;3724483762;Ne;3;0;0;3
9611;Šypsena;NYKŠTUKAI;7817486488;Ne;18;0;1;19
9612;Šypsena;NYKŠTUKAI;9862387726;Ne;7;0;0;7
9613;Šypsena;NYKŠTUKAI;8094166916;Ne;0;0;7;7
9614;Šypsena;NYKŠTUKAI;5446516798;Ne;0;0;5;5
9615;Šypsena;NYKŠTUKAI;5094556499;Taip;0;0;4;4
9616;Šypsena;NYKŠTUKAI;4496704989;Ne;0;0;10;10
9617;Šypsena;NYKŠTUKAI;7471913547;Ne;7;0;2;9
9618;Šypsena;NYKŠTUKAI;7174068697;Ne;2;0;6;8
9619;Šypsena;NYKŠTUKAI;6738149077;Ne;9;2;13;24
9620;Šypsena;NYKŠTUKAI;7905089772;Ne;0;5;7;12
9621;Šypsena;NYKŠTUKAI;7960872132;Ne;0;0;4;4
9622;Šypsena;NYKŠTUKAI;4260693029;Ne;6;9;0;15
9623;Šypsena;SPINDULIUKAI;8627994583;Ne;6;0;1;7
9624;Šypsena;SPINDULIUKAI;9702364620;Ne;5;2;0;7
9625;Šypsena;SPINDULIUKAI;3733757483;Ne;4;0;0;4
9626;Šypsena;SPINDULIUKAI;2179657619;Ne;0;1;0;1
9627;Šypsena;SPINDULIUKAI;2900195046;Ne;3;6;0;9
9628;Šypsena;SPINDULIUKAI;5818211923;Ne;2;0;0;2
9629;Šypsena;SPINDULIUKAI;8665786789;Ne;8;5;0;13
9630;Šypsena;SPINDULIUKAI;3003901966;Ne;0;1;0;1
9631;Šypsena;SPINDULIUKAI;2182189246;Ne;2;0;0;2
9632;Šypsena;SPINDULIUKAI;1431850136;Ne;0;1;0;1
9633;Šypsena;SPINDULIUKAI;1716274053;Ne;0;0;13;13
9634;Šypsena;SPINDULIUKAI;8439694239;Ne;0;6;1;7
9635;Šypsena;SPINDULIUKAI;6377979434;Ne;0;7;0;7
9636;Šypsena;SKRUZDELIUKAI;7898387398;Ne;0;0;8;8
9637;Šypsena;SKRUZDELIUKAI;1324902555;Ne;1;1;5;7
9638;Šypsena;SKRUZDELIUKAI;5222603743;Ne;2;0;0;2
9639;Šypsena;SKRUZDELIUKAI;7120597034;Ne;0;0;1;1
9640;Šypsena;SKRUZDELIUKAI;5879506651;Ne;0;0;9;9
9641;Šypsena;SKRUZDELIUKAI;3823623458;Ne;3;0;2;5
9642;Šypsena;SKRUZDELIUKAI;3429836513;Ne;0;0;11;11
9643;Šypsena;SKRUZDELIUKAI;4695547847;Ne;0;0;1;1
9644;Šypsena;SKRUZDELIUKAI;3901424559;Ne;6;6;0;12
9645;Šypsena;SKRUZDELIUKAI;6713182218;Ne;0;6;0;6
9646;Šypsena;SKRUZDELIUKAI;8215278033;Ne;1;0;5;6
9647;Šypsena;SKRUZDELIUKAI;7537442618;Ne;0;5;0;5
9648;Šypsena;SKRUZDELIUKAI;8566236342;Ne;17;0;7;24
9649;Šypsena;SKRUZDELIUKAI;9704350208;Ne;0;0;9;9
9650;Šypsena;SKRUZDELIUKAI;5906001927;Ne;1;0;4;5
9651;Šypsena;SKRUZDELIUKAI;7877396588;Ne;0;8;0;8
9652;Šypsena;SKRUZDELIUKAI;8765509994;Ne;12;0;0;12
9653;Šypsena;SKRUZDELIUKAI;4520148322;Ne;0;6;0;6
9654;Šypsena;Bitutės;1422418997;Ne;0;1;0;1
9655;Šypsena;Bitutės;3810433774;Ne;9;0;6;15
9656;Šypsena;Bitutės;9623451754;Ne;8;0;1;9
9657;Šypsena;Bitutės;5611440056;Ne;1;0;2;3
9658;Šypsena;Bitutės;1558614852;Ne;5;1;1;7
9659;Šypsena;Bitutės;1897176871;Ne;7;6;0;13
9660;Šypsena;Bitutės;1181590127;Ne;0;4;0;4
9661;Šypsena;Bitutės;4808041625;Ne;0;0;1;1
9662;Šypsena;Bitutės;5834057370;Ne;0;2;0;2
9663;Šypsena;Bitutės;3809171499;Ne;0;0;4;4
9664;Šypsena;Bitutės;5928432220;Ne;0;0;1;1
9665;Šypsena;Bitutės;5504570516;Ne;0;0;3;3
9666;Šypsena;Bitutės;5369445077;Ne;0;0;4;4
9667;Šypsena;Bitutės;2798819321;Ne;0;1;0;1
9668;Šypsena;MEŠKIUKAI;9696633725;Taip;4;0;0;4
9669;Šypsena;MEŠKIUKAI;4011596895;Ne;6;0;0;6
9670;Šypsena;MEŠKIUKAI;7234904026;Ne;6;0;0;6
9671;Šypsena;MEŠKIUKAI;3951000812;Ne;0;12;0;12
9672;Šypsena;MEŠKIUKAI;2177181171;Ne;10;0;0;10
9673;Šypsena;MEŠKIUKAI;1657019248;Ne;5;0;0;5
9674;Šypsena;MEŠKIUKAI;6224937025;Ne;5;0;0;5
9675;Šypsena;MEŠKIUKAI;1934857313;Ne;0;2;0;2
9676;Šypsena;MEŠKIUKAI;8109877136;Ne;6;0;0;6
9677;Šypsena;MEŠKIUKAI;3643736553;Ne;12;0;0;12
9678;Šypsena;MEŠKIUKAI;9841955736;Ne;10;0;0;10
9679;Šypsena;MEŠKIUKAI;2692869989;Ne;4;0;0;4
9680;Šypsena;BORUŽĖLĖS;3563748951;Ne;4;0;0;4
9681;Šypsena;BORUŽĖLĖS;8456684826;Ne;1;0;0;1
9682;Šypsena;BORUŽĖLĖS;2250346637;Ne;10;0;0;10
9683;Šypsena;BORUŽĖLĖS;1307377636;Ne;13;0;0;13
9684;Šypsena;BORUŽĖLĖS;3550145484;Ne;0;0;1;1
9685;Šypsena;BORUŽĖLĖS;1153036896;Ne;13;0;0;13
9686;Šypsena;BORUŽĖLĖS;3624678823;Ne;2;0;0;2
9687;Šypsena;BORUŽĖLĖS;9232229854;Ne;5;0;0;5
9688;Šypsena;BORUŽĖLĖS;3285293143;Ne;10;0;0;10
9689;Šypsena;BORUŽĖLĖS;6905376170;Ne;1;0;0;1
9690;Šypsena;BORUŽĖLĖS;3205854107;Taip;6;0;0;6
9691;Šnekutis;DRUGELIŲ;9543014297;Ne;4;1;0;5
9692;Šnekutis;DRUGELIŲ;3096125224;Ne;0;4;0;4
9693;Šnekutis;DRUGELIŲ;3386995244;Taip;0;3;1;4
9694;Šnekutis;DRUGELIŲ;8984597121;Ne;1;0;0;1
9695;Šnekutis;DRUGELIŲ;8810371475;Ne;0;1;1;2
9696;Šnekutis;DRUGELIŲ;7680962037;Ne;13;1;2;16
9697;Šnekutis;DRUGELIŲ;3611064172;Taip;2;1;0;3
9698;Šnekutis;DRUGELIŲ;8209686459;Ne;2;1;0;3
9699;Šnekutis;DRUGELIŲ;8036600501;Ne;0;1;0;1
9700;Šnekutis;DRUGELIŲ;1556960616;Ne;16;1;0;17
9701;Šnekutis;DRUGELIŲ;4380966487;Ne;0;0;1;1
9702;Šnekutis;DRUGELIŲ;7954240439;Ne;8;8;0;16
9703;Šnekutis;DRUGELIŲ;6330033887;Ne;0;3;0;3
9704;Šnekutis;DRUGELIŲ;1504945841;Ne;18;3;0;21
9705;Šnekutis;DRUGELIŲ;3177449195;Ne;0;6;0;6
9706;Šnekutis;Kačiukų;2914145045;Ne;11;0;0;11
9707;Šnekutis;Kačiukų;2656152037;Ne;0;2;0;2
9708;Šnekutis;Kačiukų;5521822696;Ne;0;0;2;2
9709;Šnekutis;Kačiukų;2144568225;Ne;4;0;0;4
9710;Šnekutis;Kačiukų;4624075875;Ne;0;0;2;2
9711;Šnekutis;Kačiukų;3635781445;Ne;5;0;4;9
9712;Šnekutis;Kačiukų;7109850241;Ne;0;5;0;5
9713;Šnekutis;Kačiukų;6072420827;Ne;3;0;0;3
9714;Šnekutis;Kačiukų;2626247219;Ne;5;0;1;6
9715;Šnekutis;Kačiukų;7707897830;Ne;0;0;2;2
9716;Šnekutis;Kačiukų;2312968654;Ne;2;0;0;2
9717;Šnekutis;Kačiukų;3214549246;Ne;0;6;1;7
9718;Šnekutis;Kačiukų;8417485561;Ne;2;0;0;2
9719;Šnekutis;Kačiukų;2140099519;Ne;21;0;0;21
9720;Šnekutis;Kačiukų;2042842873;Ne;0;4;0;4
9721;Šnekutis;Pėlėdžiukų;4835202527;Ne;0;0;1;1
9722;Šnekutis;Pėlėdžiukų;7089000987;Ne;1;0;0;1
9723;Šnekutis;Pėlėdžiukų;9326455786;Ne;0;0;2;2
9724;Šnekutis;Pėlėdžiukų;2843483435;Ne;1;0;0;1
9725;Šnekutis;Pėlėdžiukų;5906320006;Ne;0;10;0;10
9726;Šnekutis;Pėlėdžiukų;6405894763;Ne;0;9;0;9
9727;Šnekutis;Pėlėdžiukų;3889176018;Ne;0;0;7;7
9728;Šnekutis;Pėlėdžiukų;9054899440;Ne;0;0;1;1
9729;Šnekutis;Pėlėdžiukų;9862362744;Taip;1;0;0;1
9730;Šnekutis;Pėlėdžiukų;6015384795;Ne;0;0;5;5
9731;Šnekutis;Pėlėdžiukų;7307895397;Ne;0;0;1;1
9732;Šnekutis;Pėlėdžiukų;3371393656;Ne;16;0;0;16
9733;Šnekutis;Pėlėdžiukų;5597629090;Ne;10;0;0;10
9734;Šnekutis;Pėlėdžiukų;6544973632;Ne;0;2;1;3
9735;Šnekutis;Pėlėdžiukų;8219465079;Ne;8;1;0;9
9736;Šnekutis;Pėlėdžiukų;2779793970;Ne;5;1;0;6
9737;Šnekutis;Pėlėdžiukų;5519015388;Ne;0;0;5;5
9738;Šnekutis;Pėlėdžiukų;7344776758;Taip;0;0;2;2
9739;Šnekutis;Pėlėdžiukų;5970951526;Ne;0;1;0;1
9740;Šnekutis;Boružėlių;9887692849;Ne;0;0;8;8
9741;Šnekutis;Boružėlių;1833392181;Ne;0;0;3;3
9742;Šnekutis;Boružėlių;3115675798;Ne;2;0;0;2
9743;Šnekutis;Boružėlių;1805259980;Ne;1;0;0;1
9744;Šnekutis;Boružėlių;9385583890;Ne;5;13;3;21
9745;Šnekutis;Boružėlių;9790241725;Ne;0;5;5;10
9746;Šnekutis;Boružėlių;5934631354;Ne;1;0;0;1
9747;Šnekutis;Boružėlių;7006343288;Ne;16;0;0;16
9748;Šnekutis;Boružėlių;9322106995;Ne;0;0;2;2
9749;Šnekutis;Boružėlių;1248466603;Ne;17;0;0;17
9750;Šnekutis;Boružėlių;3842436406;Ne;7;0;1;8
9751;Šnekutis;Boružėlių;9772257715;Taip;1;0;0;1
9752;Šnekutis;Boružėlių;3593766968;Ne;17;0;0;17
9753;Šnekutis;Boružėlių;7200356364;Ne;5;0;2;7
9754;Šnekutis;Boružėlių;3572114463;Taip;0;0;1;1
9755;Šnekutis;Meškučių;1219175855;Ne;1;0;0;1
9756;Šnekutis;Meškučių;7980166125;Ne;10;1;0;11
9757;Šnekutis;Meškučių;6041045276;Ne;8;0;0;8
9758;Šnekutis;Meškučių;2134556666;Ne;6;0;0;6
9759;Šnekutis;Meškučių;5727476284;Ne;1;0;0;1
9760;Šnekutis;Meškučių;7775818807;Ne;6;2;0;8
9761;Šnekutis;Meškučių;9752334636;Ne;6;0;0;6
9762;Šnekutis;Meškučių;8612528998;Ne;0;5;0;5
9763;Šnekutis;Meškučių;6915324469;Ne;0;3;0;3
9764;Šnekutis;Meškučių;5506037153;Ne;5;0;0;5
9765;Šnekutis;Meškučių;1772197145;Ne;0;6;0;6
9766;Šnekutis;Meškučių;4452941417;Ne;4;1;0;5
9767;Šnekutis;Meškučių;8332860563;Ne;5;0;0;5
9768;Šnekutis;Viščiukų;3588737003;Ne;5;5;0;10
9769;Šnekutis;Viščiukų;4848437026;Ne;5;0;0;5
9770;Šnekutis;Viščiukų;5059417996;Ne;2;0;0;2
9771;Šnekutis;Viščiukų;7914683654;Taip;3;0;0;3
9772;Šnekutis;Viščiukų;6849168221;Ne;4;0;0;4
9773;Šnekutis;Viščiukų;8061450452;Ne;2;0;0;2
9774;Šnekutis;Viščiukų;9238064074;Ne;2;0;0;2
9775;Šnekutis;Viščiukų;2258811969;Ne;6;0;0;6
9776;Šnekutis;Viščiukų;3869428583;Taip;6;0;0;6
9777;Šnekutis;Viščiukų;9433668798;Ne;9;0;0;9
9778;Šnekutis;Viščiukų;8241953257;Ne;4;0;0;4
9779;Šnekutis;Viščiukų;1811580823;Ne;0;1;0;1
9780;Užupiukas;VYTURĖLIŲ;9807212956;Ne;1;0;4;5
9781;Užupiukas;VYTURĖLIŲ;3096315534;Taip;4;0;1;5
9782;Užupiukas;VYTURĖLIŲ;5182110542;Ne;2;0;0;2
9783;Užupiukas;VYTURĖLIŲ;3690562985;Ne;0;0;2;2
9784;Užupiukas;VYTURĖLIŲ;7034777770;Ne;5;0;6;11
9785;Užupiukas;VYTURĖLIŲ;4449466321;Ne;0;0;1;1
9786;Užupiukas;VYTURĖLIŲ;9872846882;Ne;10;0;0;10
9787;Užupiukas;VYTURĖLIŲ;5694960072;Ne;0;0;1;1
9788;Užupiukas;VYTURĖLIŲ;3879735445;Taip;0;0;1;1
9789;Užupiukas;VYTURĖLIŲ;2377079878;Ne;2;2;0;4
9790;Užupiukas;VYTURĖLIŲ;3474990673;Ne;4;0;0;4
9791;Užupiukas;VYTURĖLIŲ;1434083187;Ne;5;0;0;5
9792;Užupiukas;VYTURĖLIŲ;5851602817;Ne;0;0;8;8
9793;Užupiukas;VYTURĖLIŲ;8601594247;Ne;0;0;3;3
9794;Užupiukas;VYTURĖLIŲ;9556937880;Taip;8;0;0;8
9795;Užupiukas;VYTURĖLIŲ;4055044580;Taip;5;0;1;6
9796;Užupiukas;VYTURĖLIŲ;3654349639;Ne;0;0;1;1
9797;Užupiukas;VYTURĖLIŲ;3275112189;Ne;7;0;1;8
9798;Užupiukas;VYTURĖLIŲ;5280778870;Ne;3;0;2;5
9799;Užupiukas;VYTURĖLIŲ;7735497084;Ne;3;0;2;5
9800;Užupiukas;VYTURĖLIŲ;9278445367;Ne;13;0;0;13
9801;Užupiukas;KAČIUKŲ;3567963511;Ne;0;0;1;1
9802;Užupiukas;KAČIUKŲ;9991552624;Ne;0;0;2;2
9803;Užupiukas;KAČIUKŲ;1809036046;Ne;0;0;2;2
9804;Užupiukas;KAČIUKŲ;1102468034;Ne;0;0;13;13
9805;Užupiukas;KAČIUKŲ;1464016943;Ne;12;0;0;12
9806;Užupiukas;KAČIUKŲ;9386211193;Ne;0;0;3;3
9807;Užupiukas;KAČIUKŲ;1388346927;Ne;0;0;1;1
9808;Užupiukas;KAČIUKŲ;9333587467;Ne;0;0;1;1
9809;Užupiukas;KAČIUKŲ;7092857844;Ne;0;0;2;2
9810;Užupiukas;KAČIUKŲ;2606742144;Ne;0;0;6;6
9811;Užupiukas;KAČIUKŲ;3543913063;Ne;5;4;3;12
9812;Užupiukas;KAČIUKŲ;4920190785;Ne;0;0;9;9
9813;Užupiukas;KAČIUKŲ;8519118225;Ne;0;0;1;1
9814;Užupiukas;KAČIUKŲ;7549628277;Ne;0;0;1;1
9815;Užupiukas;KAČIUKŲ;1414888906;Ne;0;0;1;1
9816;Užupiukas;DRUGELIŲ;8876174256;Ne;4;0;1;5
9817;Užupiukas;DRUGELIŲ;5239006321;Ne;0;1;1;2
9818;Užupiukas;DRUGELIŲ;7581152903;Ne;5;4;3;12
9819;Užupiukas;DRUGELIŲ;6698907535;Taip;0;0;2;2
9820;Užupiukas;DRUGELIŲ;4854016957;Ne;0;0;9;9
9821;Užupiukas;DRUGELIŲ;4595291532;Ne;8;0;2;10
9822;Užupiukas;DRUGELIŲ;3383643388;Ne;0;0;9;9
9823;Užupiukas;DRUGELIŲ;3961733676;Ne;0;0;4;4
9824;Užupiukas;DRUGELIŲ;5006880916;Ne;0;0;6;6
9825;Užupiukas;DRUGELIŲ;9715624372;Taip;0;0;3;3
9826;Užupiukas;DRUGELIŲ;1108429907;Taip;0;0;9;9
9827;Užupiukas;DRUGELIŲ;9295230331;Ne;0;0;1;1
9828;Užupiukas;DRUGELIŲ;3575209839;Ne;0;1;1;2
9829;Užupiukas;DRUGELIŲ;5361599156;Ne;1;1;1;3
9830;Užupiukas;DRUGELIŲ;9577167600;Taip;10;0;0;10
9831;Užupiukas;DRUGELIŲ;4680027403;Ne;0;0;5;5
9832;Užupiukas;DRUGELIŲ;5289730914;Ne;0;0;13;13
9833;Užupiukas;EŽIUKŲ;8936209423;Taip;4;0;1;5
9834;Užupiukas;EŽIUKŲ;2522356285;Ne;0;3;0;3
9835;Užupiukas;EŽIUKŲ;5055376157;Ne;0;0;1;1
9836;Užupiukas;EŽIUKŲ;3235855849;Ne;0;0;1;1
9837;Užupiukas;EŽIUKŲ;9116065216;Ne;2;0;0;2
9838;Užupiukas;EŽIUKŲ;4788900708;Ne;5;0;1;6
9839;Užupiukas;EŽIUKŲ;4670096314;Ne;4;0;2;6
9840;Užupiukas;EŽIUKŲ;7914295007;Ne;0;0;1;1
9841;Užupiukas;EŽIUKŲ;6016947840;Ne;0;0;5;5
9842;Užupiukas;EŽIUKŲ;8443732431;Ne;6;0;1;7
9843;Užupiukas;EŽIUKŲ;4583779329;Ne;10;0;0;10
9844;Užupiukas;EŽIUKŲ;1757695746;Ne;10;0;0;10
9845;Užupiukas;EŽIUKŲ;7299810108;Ne;3;0;1;4
9846;Užupiukas;EŽIUKŲ;1989125835;Ne;10;0;3;13
9847;Užupiukas;EŽIUKŲ;6857321547;Ne;7;0;4;11
9848;Užupiukas;EŽIUKŲ;5866437622;Taip;8;0;1;9
9849;Užupiukas;EŽIUKŲ;5784908270;Ne;10;0;1;11
9850;Užupiukas;EŽIUKŲ;9163947073;Ne;0;0;2;2
9851;Užupiukas;BORUŽĖLIŲ;8467502933;Ne;0;0;11;11
9852;Užupiukas;BORUŽĖLIŲ;2804115700;Taip;0;0;1;1
9853;Užupiukas;BORUŽĖLIŲ;4151757682;Ne;0;0;13;13
9854;Užupiukas;BORUŽĖLIŲ;3811750547;Ne;0;0;5;5
9855;Užupiukas;BORUŽĖLIŲ;2158976125;Ne;0;0;5;5
9856;Užupiukas;BORUŽĖLIŲ;7589905741;Ne;0;0;1;1
9857;Užupiukas;BORUŽĖLIŲ;1473606331;Ne;0;10;6;16
9858;Užupiukas;BORUŽĖLIŲ;9312234251;Ne;0;0;2;2
9859;Užupiukas;BORUŽĖLIŲ;5381329362;Taip;0;0;1;1
9860;Užupiukas;BORUŽĖLIŲ;4570457987;Ne;0;0;5;5
9861;Užupiukas;BORUŽĖLIŲ;4841475687;Ne;0;7;0;7
9862;Užupiukas;BORUŽĖLIŲ;9714322911;Ne;0;0;2;2
9863;Užupiukas;BORUŽĖLIŲ;7107441792;Ne;0;0;3;3
9864;Užupiukas;BORUŽĖLIŲ;7105857162;Ne;4;0;0;4
9865;Užupiukas;BORUŽĖLIŲ;8518137669;Ne;0;0;1;1
9866;Užupiukas;BORUŽĖLIŲ;7716893423;Ne;0;0;7;7
9867;Užupiukas;SPINDULIUKŲ;7443013255;Ne;0;2;2;4
9868;Užupiukas;SPINDULIUKŲ;3656400244;Ne;0;5;0;5
9869;Užupiukas;SPINDULIUKŲ;5718382826;Ne;0;0;5;5
9870;Užupiukas;SPINDULIUKŲ;2580733127;Ne;0;0;1;1
9871;Užupiukas;SPINDULIUKŲ;1146968021;Ne;0;0;6;6
9872;Užupiukas;SPINDULIUKŲ;3829013911;Ne;3;0;2;5
9873;Užupiukas;SPINDULIUKŲ;9212428150;Ne;0;0;1;1
9874;Užupiukas;SPINDULIUKŲ;8001099421;Ne;6;0;0;6
9875;Užupiukas;SPINDULIUKŲ;1391826582;Ne;0;0;2;2
9876;Užupiukas;SPINDULIUKŲ;8960813016;Ne;0;0;1;1
9877;Užupiukas;SPINDULIUKŲ;9132605734;Taip;0;0;2;2
9878;Užupiukas;SPINDULIUKŲ;8347350503;Ne;11;0;0;11
9879;Užupiukas;SPINDULIUKŲ;7532497390;Ne;0;0;1;1
9880;Užupiukas;SPINDULIUKŲ;9209209113;Taip;5;0;1;6
9881;Užupiukas;SPINDULIUKŲ;5168946019;Ne;0;0;1;1
9882;Užupiukas;SPINDULIUKŲ;5116564840;Ne;3;0;3;6
9883;Užupiukas;SPINDULIUKŲ;1930961813;Ne;0;3;0;3
9884;Užupiukas;SPINDULIUKŲ;3794021404;Ne;0;0;3;3
9885;Užupiukas;ŽVIRBLIUKŲ;5085660507;Ne;0;5;0;5
9886;Užupiukas;ŽVIRBLIUKŲ;9925592494;Ne;0;1;0;1
9887;Užupiukas;ŽVIRBLIUKŲ;7345579721;Ne;0;9;0;9
9888;Užupiukas;ŽVIRBLIUKŲ;4710910251;Ne;0;6;0;6
9889;Užupiukas;ŽVIRBLIUKŲ;9428884149;Ne;0;0;7;7
9890;Užupiukas;ŽVIRBLIUKŲ;2210437775;Ne;0;3;0;3
9891;Užupiukas;ŽVIRBLIUKŲ;1995228207;Ne;0;2;0;2
9892;Užupiukas;ŽVIRBLIUKŲ;1496541880;Taip;0;0;4;4
9893;Užupiukas;ŽVIRBLIUKŲ;1684901495;Ne;0;1;0;1
9894;Užupiukas;ŽVIRBLIUKŲ;3224193396;Ne;0;1;0;1
9895;Užupiukas;ŽVIRBLIUKŲ;4785494419;Ne;6;2;0;8
9896;Užupiukas;ŽVIRBLIUKŲ;8119142600;Ne;8;7;1;16
9897;Užupiukas;ŽVIRBLIUKŲ;2362568676;Ne;7;0;0;7
9898;Užupiukas;ŽVIRBLIUKŲ;7530856195;Ne;0;1;0;1
9899;Užupiukas;ŽVIRBLIUKŲ;4054724625;Ne;4;0;0;4
9900;Užupiukas;ŽVIRBLIUKŲ;1843171673;Ne;21;0;0;21
9901;Užupiukas;ŽVIRBLIUKŲ;9719845726;Ne;7;1;0;8
9902;Užupiukas;ŽVIRBLIUKŲ;5233447872;Ne;0;0;21;21
9903;Užupiukas;ŽVIRBLIUKŲ;1647271985;Ne;0;0;1;1
9904;Užupiukas;PELĖDŽIUKŲ;6699322898;Ne;11;6;0;17
9905;Užupiukas;PELĖDŽIUKŲ;5204808398;Ne;0;0;6;6
9906;Užupiukas;PELĖDŽIUKŲ;6512355340;Ne;0;0;1;1
9907;Užupiukas;PELĖDŽIUKŲ;9906475253;Ne;0;0;1;1
9908;Užupiukas;PELĖDŽIUKŲ;3171528288;Ne;0;0;2;2
9909;Užupiukas;PELĖDŽIUKŲ;7860601571;Ne;4;0;3;7
9910;Užupiukas;PELĖDŽIUKŲ;9774124589;Ne;3;0;7;10
9911;Užupiukas;PELĖDŽIUKŲ;2724216446;Taip;0;11;0;11
9912;Užupiukas;PELĖDŽIUKŲ;6823724962;Ne;0;0;3;3
9913;Užupiukas;PELĖDŽIUKŲ;9446562736;Ne;0;0;1;1
9914;Užupiukas;PELĖDŽIUKŲ;5072363435;Ne;0;0;1;1
9915;Užupiukas;PELĖDŽIUKŲ;1651249962;Ne;3;0;0;3
9916;Užupiukas;PELĖDŽIUKŲ;1526296386;Ne;0;1;2;3
9917;Užupiukas;PELĖDŽIUKŲ;8720638097;Ne;0;0;2;2
9918;Užupiukas;PELĖDŽIUKŲ;3057147440;Ne;0;1;0;1
9919;Užupiukas;PELĖDŽIUKŲ;6370918943;Ne;0;0;3;3
9920;Užupiukas;PELĖDŽIUKŲ;1100574872;Ne;0;0;1;1
9921;Užupiukas;VARPELIŲ;7919242126;Ne;0;2;2;4
9922;Užupiukas;VARPELIŲ;5941280824;Ne;0;0;3;3
9923;Užupiukas;VARPELIŲ;2485426055;Ne;0;0;3;3
9924;Užupiukas;VARPELIŲ;7314085267;Ne;0;0;1;1
9925;Užupiukas;VARPELIŲ;1407429980;Ne;0;0;3;3
9926;Užupiukas;VARPELIŲ;4811619739;Ne;0;1;0;1
9927;Užupiukas;VARPELIŲ;9523512906;Ne;10;0;1;11
9928;Užupiukas;VARPELIŲ;3745080560;Ne;0;0;1;1
9929;Užupiukas;VARPELIŲ;5148672602;Ne;11;0;1;12
9930;Užupiukas;VARPELIŲ;2769924857;Ne;0;0;2;2
9931;Užupiukas;VARPELIŲ;7837545732;Ne;0;0;1;1
9932;Užupiukas;VARPELIŲ;4112143599;Ne;0;0;1;1
9933;Užupiukas;VARPELIŲ;7628420639;Ne;0;0;2;2
9934;Užupiukas;VARPELIŲ;6879206867;Ne;5;0;0;5
9935;Užupiukas;VARPELIŲ;6736111909;Ne;0;0;19;19
9936;Užupiukas;VARPELIŲ;4206519159;Ne;0;0;2;2
9937;Užupiukas;VARPELIŲ;9514298829;Ne;0;0;1;1
9938;Užupiukas;VARPELIŲ;3394103404;Ne;0;0;1;1
9939;Užupiukas;SAULUČIŲ;5704945892;Ne;0;0;5;5
9940;Užupiukas;SAULUČIŲ;2681679016;Ne;0;0;2;2
9941;Užupiukas;SAULUČIŲ;3684774901;Ne;4;0;0;4
9942;Užupiukas;SAULUČIŲ;1976775494;Taip;0;5;0;5
9943;Užupiukas;SAULUČIŲ;5874450724;Ne;0;0;1;1
9944;Užupiukas;SAULUČIŲ;3341292382;Ne;0;0;3;3
9945;Užupiukas;SAULUČIŲ;2211595125;Ne;8;0;1;9
9946;Užupiukas;SAULUČIŲ;5570569874;Ne;0;0;2;2
9947;Užupiukas;SAULUČIŲ;7643286183;Ne;0;0;6;6
9948;Užupiukas;SAULUČIŲ;7209853233;Ne;0;0;3;3
9949;Užupiukas;SAULUČIŲ;9953994943;Ne;5;4;0;9
9950;Užupiukas;SAULUČIŲ;7956550754;Ne;0;0;1;1
9951;Užupiukas;SAULUČIŲ;5469735455;Ne;0;0;2;2
9952;Užupiukas;SAULUČIŲ;8489545569;Ne;10;0;0;10
9953;Užupiukas;SAULUČIŲ;7423292334;Ne;3;1;0;4
9954;Užupiukas;SAULUČIŲ;9216626936;Ne;0;1;0;1
9955;Užupiukas;SAULUČIŲ;9962455415;Ne;0;0;3;3
9956;Užupiukas;SAULUČIŲ;9709440406;Ne;1;0;0;1
9957;Užupiukas;SAULUČIŲ;9434907771;Ne;2;0;4;6
9958;Užupiukas;LAPIUKŲ;9833934299;Ne;0;3;1;4
9959;Užupiukas;LAPIUKŲ;4963679583;Ne;0;0;4;4
9960;Užupiukas;LAPIUKŲ;2679915982;Ne;0;1;0;1
9961;Užupiukas;LAPIUKŲ;7986962850;Ne;0;1;1;2
9962;Užupiukas;LAPIUKŲ;2517606394;Ne;3;0;4;7
9963;Užupiukas;LAPIUKŲ;5965564175;Ne;0;1;0;1
9964;Užupiukas;LAPIUKŲ;7161001771;Ne;3;1;0;4
9965;Užupiukas;LAPIUKŲ;6967184410;Ne;0;8;0;8
9966;Užupiukas;LAPIUKŲ;1178152392;Ne;7;1;1;9
9967;Užupiukas;LAPIUKŲ;7029091978;Ne;4;0;0;4
9968;Užupiukas;LAPIUKŲ;3311694266;Ne;0;1;0;1
9969;Užupiukas;LAPIUKŲ;1041972540;Ne;0;1;0;1
9970;Užupiukas;LAPIUKŲ;4467470795;Ne;0;1;0;1
9971;Užupiukas;LAPIUKŲ;3333547785;Ne;0;4;0;4
9972;Užupiukas;LAPIUKŲ;8529259340;Ne;3;1;2;6
9973;Užupiukas;LAPIUKŲ;8252575784;Ne;0;1;0;1
9974;Užupiukas;LAPIUKŲ;7559183263;Ne;0;8;0;8
9975;Užupiukas;LAPIUKŲ;4900699267;Ne;0;1;1;2
9976;Užupiukas;NYKŠTUKŲ;1399112659;Ne;1;5;0;6
9977;Užupiukas;NYKŠTUKŲ;6628511386;Ne;0;0;6;6
9978;Užupiukas;NYKŠTUKŲ;5343951688;Ne;0;0;2;2
9979;Užupiukas;NYKŠTUKŲ;9110921035;Ne;0;0;2;2
9980;Užupiukas;NYKŠTUKŲ;6716173079;Ne;0;4;0;4
9981;Užupiukas;NYKŠTUKŲ;4441941216;Ne;7;0;1;8
9982;Užupiukas;NYKŠTUKŲ;4489962171;Ne;10;0;1;11
9983;Užupiukas;NYKŠTUKŲ;1139748215;Ne;7;0;0;7
9984;Vaidilutė;Žiogelis;8789527552;Ne;0;0;1;1
9985;Vaidilutė;Žiogelis;7319037375;Ne;2;0;0;2
9986;Vaidilutė;Žiogelis;4838951446;Ne;0;1;0;1
9987;Vaidilutė;Žiogelis;7494818866;Ne;0;0;1;1
9988;Vaidilutė;Žiogelis;5500950179;Ne;9;0;0;9
9989;Vaidilutė;Žiogelis;7306768961;Ne;0;0;2;2
9990;Vaidilutė;Žiogelis;7532115462;Ne;3;0;1;4
9991;Vaidilutė;Žiogelis;9437865610;Ne;1;0;0;1
9992;Vaidilutė;Žiogelis;1140011879;Ne;0;0;2;2
9993;Vaidilutė;Žiogelis;9563257771;Ne;0;4;2;6
9994;Vaidilutė;Žiogelis;6896047075;Ne;0;0;3;3
9995;Vaidilutė;Žiogelis;3059654988;Ne;4;3;1;8
9996;Vaidilutė;Žiogelis;1341696594;Ne;2;0;1;3
9997;Vaidilutė;Žiogelis;1141947715;Ne;2;0;6;8
9998;Vaidilutė;Žiogelis;5482030284;Ne;0;0;1;1
9999;Vaidilutė;Žiogelis;8505156287;Ne;0;0;1;1
10000;Vaidilutė;Žiogelis;2189753894;Ne;0;0;3;3
10001;Vaidilutė;Rūtelė;6449710777;Ne;3;0;0;3
10002;Vaidilutė;Rūtelė;2444426554;Ne;3;0;0;3
10003;Vaidilutė;Rūtelė;4887753072;Ne;0;0;1;1
10004;Vaidilutė;Rūtelė;2876157676;Ne;0;0;2;2
10005;Vaidilutė;Rūtelė;3557654689;Ne;5;0;0;5
10006;Vaidilutė;Rūtelė;8257746012;Ne;0;0;1;1
10007;Vaidilutė;Rūtelė;8444010416;Ne;0;0;3;3
10008;Vaidilutė;Rūtelė;4568108299;Ne;0;3;1;4
10009;Vaidilutė;Rūtelė;1998966302;Ne;0;0;2;2
10010;Vaidilutė;Rūtelė;5026620305;Ne;0;0;1;1
10011;Vaidilutė;Rūtelė;3826303389;Ne;3;0;1;4
10012;Vaidilutė;Rūtelė;5918039529;Ne;9;0;0;9
10013;Vaidilutė;Rūtelė;7660273021;Ne;5;0;3;8
10014;Vaidilutė;Rūtelė;6795083491;Ne;7;0;3;10
10015;Vaidilutė;Rūtelė;6604575848;Ne;7;0;3;10
10016;Vaidilutė;Rūtelė;7649954695;Ne;3;0;4;7
10017;Vaidilutė;Voveraitė;3248203941;Ne;0;0;5;5
10018;Vaidilutė;Voveraitė;1608646909;Ne;6;0;2;8
10019;Vaidilutė;Voveraitė;9429544108;Taip;0;0;3;3
10020;Vaidilutė;Voveraitė;8377824920;Ne;15;0;0;15
10021;Vaidilutė;Voveraitė;3299081380;Taip;0;0;6;6
10022;Vaidilutė;Voveraitė;3634285869;Taip;8;0;6;14
10023;Vaidilutė;Voveraitė;7703578508;Ne;0;0;16;16
10024;Vaidilutė;Voveraitė;3150642420;Ne;0;0;6;6
10025;Vaidilutė;Voveraitė;5855762068;Ne;0;0;2;2
10026;Vaidilutė;Voveraitė;8177787790;Ne;2;1;0;3
10027;Vaidilutė;Voveraitė;7327131165;Ne;14;0;2;16
10028;Vaidilutė;Voveraitė;2318578603;Ne;10;0;0;10
10029;Vaidilutė;Voveraitė;9372280434;Ne;0;0;2;2
10030;Vaidilutė;Voveraitė;1372767364;Ne;0;0;2;2
10031;Vaidilutė;Voveraitė;4738318120;Ne;0;6;0;6
10032;Vaidilutė;Voveraitė;3319615121;Ne;0;0;2;2
10033;Vaidilutė;Voveraitė;6299324271;Ne;0;4;1;5
10034;Vaidilutė;Voveraitė;4186708502;Taip;0;0;3;3
10035;Vaidilutė;Voveraitė;2855672500;Taip;0;6;0;6
10036;Vaidilutė;Voveraitė;8053548602;Ne;0;0;1;1
10037;Vaidilutė;Saulutė;2164241264;Ne;2;0;0;2
10038;Vaidilutė;Saulutė;4648985217;Ne;0;1;1;2
10039;Vaidilutė;Saulutė;4805621473;Ne;3;0;1;4
10040;Vaidilutė;Saulutė;4348206726;Taip;9;0;3;12
10041;Vaidilutė;Saulutė;5405461987;Ne;0;0;6;6
10042;Vaidilutė;Saulutė;6928815317;Ne;0;0;12;12
10043;Vaidilutė;Saulutė;1283676263;Ne;0;0;5;5
10044;Vaidilutė;Saulutė;6239494382;Ne;0;1;0;1
10045;Vaidilutė;Saulutė;8629789128;Ne;9;0;2;11
10046;Vaidilutė;Saulutė;8413764934;Ne;0;1;1;2
10047;Vaidilutė;Saulutė;2315322608;Ne;0;0;6;6
10048;Vaidilutė;Saulutė;7019245743;Ne;0;1;1;2
10049;Vaidilutė;Saulutė;7075509397;Ne;3;0;2;5
10050;Vaidilutė;Saulutė;8012451263;Ne;0;0;1;1
10051;Vaidilutė;Saulutė;4760330697;Taip;8;0;0;8
10052;Vaidilutė;Saulutė;5205356977;Ne;0;0;4;4
10053;Vaidilutė;Saulutė;5095161432;Ne;0;0;7;7
10054;Vaidilutė;Saulutė;7572407329;Ne;0;0;4;4
10055;Vaidilutė;Saulutė;4963577351;Ne;0;0;2;2
10056;Vaidilutė;Saulutė;6527155865;Ne;0;1;8;9
10057;Vaidilutė;Žibutė;4085959509;Ne;5;0;2;7
10058;Vaidilutė;Žibutė;1001320466;Ne;0;0;2;2
10059;Vaidilutė;Žibutė;3051006765;Ne;0;10;2;12
10060;Vaidilutė;Žibutė;9189713003;Ne;0;3;0;3
10061;Vaidilutė;Žibutė;7903242996;Ne;5;0;2;7
10062;Vaidilutė;Žibutė;7400197367;Ne;1;1;0;2
10063;Vaidilutė;Žibutė;5236154349;Ne;0;0;1;1
10064;Vaidilutė;Žibutė;3980894528;Ne;4;0;5;9
10065;Vaidilutė;Žibutė;1362256314;Ne;0;0;5;5
10066;Vaidilutė;Žibutė;7940581813;Ne;7;0;1;8
10067;Vaidilutė;Žibutė;7765298370;Ne;0;0;3;3
10068;Vaidilutė;Žibutė;8769601956;Ne;0;3;3;6
10069;Vaidilutė;Žibutė;1726638921;Ne;6;2;0;8
10070;Vaidilutė;Žibutė;5415279154;Ne;0;0;4;4
10071;Vaidilutė;Žibutė;4124217264;Ne;0;0;6;6
10072;Vaidilutė;Žibutė;7429825620;Ne;5;0;1;6
10073;Vaidilutė;Žibutė;3087959868;Ne;5;0;0;5
10074;Vaidilutė;Žibutė;7690470762;Ne;5;1;0;6
10075;Vaidilutė;Žibutė;1606864068;Ne;2;0;1;3
10076;Vaidilutė;"Ąžuoliukas ";3730573432;Ne;0;12;0;12
10077;Vaidilutė;"Ąžuoliukas ";1305478052;Ne;0;0;1;1
10078;Vaidilutė;"Ąžuoliukas ";4954285515;Ne;0;0;2;2
10079;Vaidilutė;"Ąžuoliukas ";4761992071;Ne;0;0;1;1
10080;Vaidilutė;"Ąžuoliukas ";3381544575;Ne;0;0;1;1
10081;Vaidilutė;"Ąžuoliukas ";5307486959;Ne;0;0;1;1
10082;Vaidilutė;"Ąžuoliukas ";1653497170;Ne;0;0;1;1
10083;Vaidilutė;"Ąžuoliukas ";1440819171;Ne;0;8;1;9
10084;Vaidilutė;"Ąžuoliukas ";2668758195;Ne;0;0;1;1
10085;Vaidilutė;"Ąžuoliukas ";2997948252;Ne;5;1;2;8
10086;Vaidilutė;"Ąžuoliukas ";9723156071;Ne;0;1;2;3
10087;Vaidilutė;"Ąžuoliukas ";4193108560;Ne;0;0;1;1
10088;Vaidilutė;"Ąžuoliukas ";3782651091;Ne;10;0;0;10
10089;Vaidilutė;"Žemuogėlė ";2131127298;Ne;0;0;1;1
10090;Vaidilutė;"Žemuogėlė ";2014160468;Ne;0;0;2;2
10091;Vaidilutė;"Žemuogėlė ";4680645841;Ne;0;1;2;3
10092;Vaidilutė;"Žemuogėlė ";2662468804;Ne;0;0;2;2
10093;Vaidilutė;"Žemuogėlė ";5217609332;Ne;0;0;1;1
10094;Vaidilutė;"Žemuogėlė ";8492055287;Ne;0;0;2;2
10095;Vaidilutė;"Žemuogėlė ";5945744595;Taip;0;5;4;9
10096;Vaidilutė;"Žemuogėlė ";2864731541;Ne;6;0;1;7
10097;Vaidilutė;"Žemuogėlė ";2468220275;Ne;0;0;3;3
10098;Vaidilutė;"Žemuogėlė ";6844372910;Ne;0;0;8;8
10099;Vaidilutė;"Žemuogėlė ";4972645715;Ne;4;0;4;8
10100;Vaidilutė;"Žemuogėlė ";1610262589;Ne;5;0;4;9
10101;Vaidilutė;"Žemuogėlė ";2356037175;Ne;0;0;1;1
10102;Vaidilutė;"Žemuogėlė ";5054640268;Ne;0;0;4;4
10103;Vaidilutė;"Žemuogėlė ";1092821241;Ne;0;0;4;4
10104;Vaidilutė;"Žemuogėlė ";1355005114;Ne;8;0;1;9
10105;Vaidilutė;"Žemuogėlė ";2294802783;Ne;0;10;0;10
10106;Vaidilutė;"Žemuogėlė ";2419903023;Ne;8;0;2;10
10107;Vaidilutė;"Vyturėlis ";3121914268;Ne;0;0;1;1
10108;Vaidilutė;"Vyturėlis ";5050251048;Ne;0;8;4;12
10109;Vaidilutė;"Vyturėlis ";7106410219;Ne;5;0;3;8
10110;Vaidilutė;"Vyturėlis ";9558983004;Ne;0;10;0;10
10111;Vaidilutė;"Vyturėlis ";5326935037;Ne;3;0;0;3
10112;Vaidilutė;"Vyturėlis ";9689388330;Ne;0;1;1;2
10113;Vaidilutė;"Vyturėlis ";8882402632;Ne;0;0;3;3
10114;Vaidilutė;"Vyturėlis ";1539700521;Ne;0;10;1;11
10115;Vaidilutė;"Vyturėlis ";4230076320;Ne;3;0;0;3
10116;Vaidilutė;"Vyturėlis ";4388069915;Ne;13;0;0;13
10117;Vaidilutė;"Vyturėlis ";1401180999;Ne;0;0;1;1
10118;Vaidilutė;"Vyturėlis ";1417828163;Ne;1;0;0;1
10119;Vaidilutė;"Vyturėlis ";5651628204;Ne;0;0;1;1
10120;Vaidilutė;"Vyturėlis ";2251608691;Ne;3;0;0;3
10121;Vaidilutė;"Vyturėlis ";7914006128;Ne;0;10;2;12
10122;Vaidilutė;"Vyturėlis ";7131561558;Ne;6;0;3;9
10123;Vaidilutė;"Vyturėlis ";2194984060;Ne;0;0;9;9
10124;Vaidilutė;"Vyturėlis ";3351968717;Taip;0;0;2;2
10125;Vaidilutė;"Vyturėlis ";1732848786;Ne;8;0;2;10
10126;Vaidilutė;"Varpelis ";6037349527;Ne;0;0;7;7
10127;Vaidilutė;"Varpelis ";5867501558;Ne;0;1;0;1
10128;Vaidilutė;"Varpelis ";9317774960;Ne;0;1;1;2
10129;Vaidilutė;"Varpelis ";5448014291;Ne;3;1;0;4
10130;Vaidilutė;"Varpelis ";3497795848;Ne;3;0;0;3
10131;Vaidilutė;"Varpelis ";4280822951;Ne;0;1;0;1
10132;Vaidilutė;"Varpelis ";6107554047;Ne;6;0;0;6
10133;Vaidilutė;"Varpelis ";6022130248;Ne;0;0;6;6
10134;Vaidilutė;"Varpelis ";5101104226;Ne;9;1;2;12
10135;Vaidilutė;"Varpelis ";5594121340;Ne;0;0;1;1
10136;Vaidilutė;"Varpelis ";1882829340;Ne;15;0;1;16
10137;Vaidilutė;"Varpelis ";3353827105;Ne;0;0;3;3
10138;Vaidilutė;"Varpelis ";4362797606;Ne;0;1;0;1
10139;Vaidilutė;"Varpelis ";2058071219;Ne;0;0;7;7
10140;Vaidilutė;"Boružėlių ";2401619665;Ne;4;0;0;4
10141;Vaidilutė;"Boružėlių ";7992756674;Taip;0;0;1;1
10142;Vaidilutė;"Boružėlių ";7082436875;Ne;0;0;1;1
10143;Vaidilutė;"Malūnelis ";3509892176;Ne;5;0;0;5
10144;Vaidilutė;"Malūnelis ";9183056003;Ne;0;0;1;1
10145;Vaidilutė;"Malūnelis ";2194687285;Ne;5;0;1;6
10146;Vaidilutė;"Malūnelis ";7109743847;Ne;0;0;7;7
10147;Vaidilutė;"Malūnelis ";8042617129;Ne;0;0;1;1
10148;Vaidilutė;"Malūnelis ";6541442524;Ne;0;0;1;1
10149;Vaidilutė;"Riešutėlis ";1161455376;Ne;5;0;1;6
10150;Vaidilutė;"Riešutėlis ";4518002596;Ne;0;0;3;3
10151;Vaidilutė;"Riešutėlis ";4657952465;Ne;0;0;9;9
10152;Vaidilutė;"Riešutėlis ";8756807918;Ne;15;0;3;18
10153;Vaidilutė;"Riešutėlis ";9782176726;Ne;0;15;0;15
10154;Vaidilutė;"Riešutėlis ";1206696843;Ne;0;1;2;3
10155;Vaidilutė;"Riešutėlis ";2976615414;Ne;0;0;2;2
10156;Vaidilutė;"Riešutėlis ";4709977896;Ne;6;0;0;6
10157;Vaidilutė;"Riešutėlis ";2409760986;Ne;0;0;2;2
10158;Vaidilutė;"Riešutėlis ";4051575845;Ne;5;0;4;9
10159;Vaidilutė;"Riešutėlis ";9025469107;Ne;14;0;2;16
10160;Vaidilutė;"Riešutėlis ";3862444839;Ne;5;0;0;5
10161;Vaidilutė;"Riešutėlis ";9567786222;Ne;0;0;3;3
10162;Vaidilutė;"Riešutėlis ";3321127541;Ne;0;0;1;1
10163;Vaidilutė;"Riešutėlis ";3064988592;Taip;0;0;4;4
10164;Vaidilutė;"Riešutėlis ";7043895152;Ne;0;0;2;2
10165;Vaidilutė;"Riešutėlis ";8296567629;Ne;0;0;2;2
10166;Vaidilutė;"Riešutėlis ";7871629009;Ne;0;0;2;2
10167;Vaidilutė;"Riešutėlis ";9398922369;Ne;0;10;6;16
10168;Vandenis;ŽUVĖDRŲ;5362078687;Ne;3;1;0;4
10169;Vandenis;ŽUVĖDRŲ;6784010746;Taip;6;2;3;11
10170;Vandenis;ŽUVĖDRŲ;2238926097;Ne;0;2;0;2
10171;Vandenis;ŽUVĖDRŲ;9334958945;Ne;4;0;0;4
10172;Vandenis;ŽUVĖDRŲ;7646133208;Ne;0;1;0;1
10173;Vandenis;ŽUVĖDRŲ;4303303483;Ne;0;1;0;1
10174;Vandenis;ŽUVĖDRŲ;2325465812;Ne;0;3;0;3
10175;Vandenis;ŽUVĖDRŲ;2649542586;Ne;0;3;0;3
10176;Vandenis;ŽUVĖDRŲ;7948161881;Ne;5;0;1;6
10177;Vandenis;ŽUVĖDRŲ;7391206543;Ne;0;2;0;2
10178;Vandenis;ŽUVĖDRŲ;9335319713;Ne;0;2;0;2
10179;Vandenis;ŽUVĖDRŲ;7296608892;Ne;5;3;0;8
10180;Vandenis;ŽUVĖDRŲ;4117091634;Ne;3;1;0;4
10181;Vandenis;ŽUVĖDRŲ;6063181697;Ne;0;4;0;4
10182;Vandenis;ŽUVĖDRŲ;6661117114;Ne;14;2;0;16
10183;Vandenis;ŽUVĖDRŲ;5112768778;Ne;0;6;0;6
10184;Vandenis;ŽUVĖDRŲ;6456557095;Ne;6;0;0;6
10185;Vandenis;RUONIUKŲ;9756270419;Ne;7;0;0;7
10186;Vandenis;RUONIUKŲ;5438770600;Ne;1;0;0;1
10187;Vandenis;RUONIUKŲ;6851036864;Ne;8;0;0;8
10188;Vandenis;RUONIUKŲ;2144282854;Ne;6;3;0;9
10189;Vandenis;RUONIUKŲ;1969144957;Ne;0;3;0;3
10190;Vandenis;RUONIUKŲ;4319584977;Ne;4;0;0;4
10191;Vandenis;RUONIUKŲ;7950837626;Ne;8;0;0;8
10192;Vandenis;RUONIUKŲ;8001157954;Ne;13;0;0;13
10193;Vandenis;RUONIUKŲ;6882874044;Taip;5;4;0;9
10194;Vandenis;RUONIUKŲ;9178978753;Ne;2;5;0;7
10195;Vandenis;RUONIUKŲ;9095152994;Ne;8;1;0;9
10196;Vandenis;RUONIUKŲ;9756750533;Ne;6;0;0;6
10197;Vandenis;RUONIUKŲ;4525906178;Ne;0;2;0;2
10198;Vandenis;RUONIUKŲ;9316297713;Ne;9;0;0;9
10199;Vandenis;RUONIUKŲ;3101289470;Ne;3;0;0;3
10200;Vandenis;RUONIUKŲ;9542360827;Ne;5;0;0;5
10201;Vandenis;RUONIUKŲ;5516720117;Ne;5;0;0;5
10202;Vandenis;ŽUVYČIŲ;7565308536;Ne;0;9;0;9
10203;Vandenis;ŽUVYČIŲ;1120907086;Ne;0;4;0;4
10204;Vandenis;ŽUVYČIŲ;1563710105;Ne;0;1;0;1
10205;Vandenis;ŽUVYČIŲ;6330187732;Ne;0;2;0;2
10206;Vandenis;ŽUVYČIŲ;9527253920;Ne;4;2;0;6
10207;Vandenis;ŽUVYČIŲ;6158299885;Ne;5;0;0;5
10208;Vandenis;ŽUVYČIŲ;5535901447;Ne;0;1;0;1
10209;Vandenis;ŽUVYČIŲ;6476051751;Ne;0;3;0;3
10210;Vandenis;ŽUVYČIŲ;1051281257;Ne;0;6;0;6
10211;Vandenis;ŽUVYČIŲ;2422642232;Ne;0;4;0;4
10212;Vandenis;ŽUVYČIŲ;8729351613;Ne;0;1;0;1
10213;Vandenis;ŽUVYČIŲ;4971165639;Ne;0;3;0;3
10214;Vandenis;ŽUVYČIŲ;7754158588;Ne;1;0;0;1
10215;Vandenis;PERLIUKŲ;8239664149;Ne;1;0;0;1
10216;Vandenis;PERLIUKŲ;2451901210;Ne;5;1;0;6
10217;Vandenis;PERLIUKŲ;1953052452;Ne;0;1;0;1
10218;Vandenis;PERLIUKŲ;6724626527;Ne;0;2;3;5
10219;Vandenis;PERLIUKŲ;1799139825;Ne;0;3;0;3
10220;Vandenis;PERLIUKŲ;1786146371;Ne;5;0;0;5
10221;Vandenis;PERLIUKŲ;3038533882;Ne;9;0;0;9
10222;Vandenis;PERLIUKŲ;3393306645;Ne;2;1;0;3
10223;Vandenis;PERLIUKŲ;2506411643;Ne;2;1;0;3
10224;Vandenis;PERLIUKŲ;8841954633;Ne;10;3;0;13
10225;Vandenis;PERLIUKŲ;7001613448;Ne;10;3;0;13
10226;Vandenis;PERLIUKŲ;2661339448;Ne;9;0;0;9
10227;Vandenis;PERLIUKŲ;5675840354;Ne;5;0;0;5
10228;Vandenis;PERLIUKŲ;3173213991;Ne;0;4;0;4
10229;Vandenis;ANČIUKŲ;4607196473;Ne;7;0;0;7
10230;Vandenis;ANČIUKŲ;9763300020;Ne;2;4;0;6
10231;Vandenis;ANČIUKŲ;3639160500;Ne;0;2;0;2
10232;Vandenis;ANČIUKŲ;9458613523;Ne;0;1;0;1
10233;Vandenis;ANČIUKŲ;1213743099;Ne;0;1;0;1
10234;Vandenis;ANČIUKŲ;4954121871;Ne;0;1;0;1
10235;Vandenis;ANČIUKŲ;7631982912;Ne;0;1;0;1
10236;Vandenis;ANČIUKŲ;9679010239;Ne;2;4;3;9
10237;Vandenis;ANČIUKŲ;1132534461;Ne;0;1;0;1
10238;Vandenis;ANČIUKŲ;3544764716;Ne;6;2;0;8
10239;Vandenis;ANČIUKŲ;4530824157;Ne;10;0;1;11
10240;Vandenis;ANČIUKŲ;4954787474;Ne;8;1;0;9
10241;Vandenis;VĖŽLIUKŲ;2309166304;Ne;4;0;2;6
10242;Vandenis;VĖŽLIUKŲ;2872343656;Ne;0;0;3;3
10243;Vandenis;VĖŽLIUKŲ;5454049563;Ne;0;1;0;1
10244;Vandenis;VĖŽLIUKŲ;9805578141;Ne;0;1;0;1
10245;Vandenis;VĖŽLIUKŲ;8921666108;Taip;0;2;0;2
10246;Vandenis;VĖŽLIUKŲ;7069369080;Ne;0;1;2;3
10247;Vandenis;VĖŽLIUKŲ;7924399684;Ne;0;0;4;4
10248;Vandenis;VĖŽLIUKŲ;1187395353;Ne;0;5;0;5
10249;Vandenis;VĖŽLIUKŲ;7091356848;Ne;0;0;1;1
10250;Vandenis;VĖŽLIUKŲ;5126732658;Ne;0;1;4;5
10251;Vandenis;VĖŽLIUKŲ;1707354287;Taip;0;0;1;1
10252;Vandenis;VĖŽLIUKŲ;4413648496;Ne;0;0;3;3
10253;Vandenis;VĖŽLIUKŲ;4177166475;Ne;0;0;2;2
10254;Vandenis;VĖŽLIUKŲ;2936885357;Ne;0;0;7;7
10255;Vandenis;VĖŽLIUKŲ;8879608849;Ne;0;4;1;5
10256;Vandenis;AŠTUNKOJŲ;6896047075;Ne;3;0;0;3
10257;Vandenis;AŠTUNKOJŲ;6295009202;Ne;0;3;0;3
10258;Vandenis;AŠTUNKOJŲ;3239754791;Ne;0;2;0;2
10259;Vandenis;AŠTUNKOJŲ;7598257845;Ne;0;8;0;8
10260;Vandenis;AŠTUNKOJŲ;5323428164;Ne;3;0;0;3
10261;Vandenis;AŠTUNKOJŲ;6073002418;Ne;3;0;0;3
10262;Vandenis;AŠTUNKOJŲ;2576575249;Ne;3;0;0;3
10263;Vandenis;AŠTUNKOJŲ;1975385430;Ne;0;3;0;3
10264;Vandenis;AŠTUNKOJŲ;3061606138;Ne;5;0;0;5
10265;Vandenis;AŠTUNKOJŲ;5613067534;Ne;0;1;0;1
10266;Vandenis;AŠTUNKOJŲ;2321919298;Taip;0;1;0;1
10267;Vandenis;GANDRIUKŲ;4753416316;Ne;1;0;0;1
10268;Vandenis;GANDRIUKŲ;8264797886;Ne;3;0;0;3
10269;Vandenis;GANDRIUKŲ;6260893699;Ne;5;0;0;5
10270;Vandenis;GANDRIUKŲ;1919577714;Taip;7;1;0;8
10271;Vandenis;GANDRIUKŲ;7019646962;Ne;0;5;0;5
10272;Vandenis;GANDRIUKŲ;2078767085;Ne;2;0;0;2
10273;Vandenis;GANDRIUKŲ;2976505868;Ne;10;0;0;10
10274;Vandenis;GANDRIUKŲ;6691874473;Ne;3;10;0;13
10275;Vandenis;GANDRIUKŲ;6483030616;Ne;15;0;0;15
10276;Vandenis;GANDRIUKŲ;2381566229;Ne;9;0;0;9
10277;Vandenis;GANDRIUKŲ;5899846599;Ne;5;0;0;5
10278;Vandenis;GANDRIUKŲ;8127873607;Ne;2;0;0;2
10279;Vandenis;GANDRIUKŲ;1606103904;Ne;0;1;0;1
10280;Vandenis;GANDRIUKŲ;1753180703;Ne;10;0;0;10
10281;Vandenis;GANDRIUKŲ;7303512055;Ne;1;0;0;1
10282;Vandenis;GANDRIUKŲ;7311677107;Ne;8;0;0;8
10283;Vandenis;GANDRIUKŲ;6586215199;Ne;0;4;0;4
10284;Vandenis;ŽĄSIUKAI;8034690071;Ne;1;0;0;1
10285;Vandenis;ŽĄSIUKAI;2004158593;Ne;0;2;0;2
10286;Vandenis;ŽĄSIUKAI;4984723792;Ne;5;2;0;7
10287;Vandenis;ŽĄSIUKAI;8014569725;Ne;0;1;0;1
10288;Vandenis;ŽĄSIUKAI;7071349847;Ne;0;1;0;1
10289;Vandenis;ŽĄSIUKAI;7070234429;Ne;0;2;0;2
10290;Vandenis;ŽĄSIUKAI;4072405890;Ne;0;12;0;12
10291;Vandenis;ŽĄSIUKAI;4349464804;Ne;0;1;0;1
10292;Vandenis;ŽĄSIUKAI;7596199296;Ne;0;8;0;8
10293;Vandenis;ŽĄSIUKAI;6876019354;Taip;5;0;0;5
10294;Vandenis;ŽĄSIUKAI;5607412408;Ne;4;6;0;10
10295;Vandenis;ŽĄSIUKAI;1925178245;Ne;0;1;0;1
10296;Vandenis;ŽĄSIUKAI;7058441500;Ne;0;6;0;6
10297;Vandenis;ŽĄSIUKAI;2454959791;Ne;3;0;0;3
10298;Vandenis;ŽĄSIUKAI;9801593009;Ne;8;0;0;8
10299;Vandenis;ŽĄSIUKAI;9093048795;Ne;1;0;0;1
10300;Vandenis;PURIENŲ;6851178154;Ne;0;1;0;1
10301;Vandenis;PURIENŲ;5440027798;Ne;13;0;0;13
10302;Vandenis;PURIENŲ;4455886780;Ne;0;1;0;1
10303;Vandenis;PURIENŲ;4815210197;Ne;0;5;0;5
10304;Vandenis;PURIENŲ;3337286021;Ne;1;2;0;3
10305;Vandenis;PURIENŲ;7020534318;Ne;0;5;0;5
10306;Vandenis;PURIENŲ;6027680514;Ne;0;2;0;2
10307;Vandenis;PURIENŲ;2960005490;Ne;5;0;0;5
10308;Vandenis;PURIENŲ;1180322026;Ne;5;0;0;5
10309;Vandenis;PURIENŲ;3633805607;Ne;0;1;0;1
10310;Vandenis;PURIENŲ;6332179750;Ne;0;2;0;2
10311;Vandenis;PURIENŲ;2719678617;Ne;0;2;0;2
10312;Vandenis;PURIENŲ;7171302906;Ne;0;3;0;3
10313;Vandenis;PURIENŲ;8085633453;Ne;0;3;0;3
10314;Vandenis;PURIENŲ;2614561762;Ne;0;1;0;1
10315;Vandenis;PURIENŲ;5764809162;Ne;0;5;0;5
10316;Vandenis;PURIENŲ;1244502945;Ne;0;1;0;1
10317;Vandenis;VARLIUKAI;3851301038;Ne;0;1;0;1
10318;Vandenis;VARLIUKAI;1557924470;Ne;6;0;0;6
10319;Vandenis;VARLIUKAI;4467604017;Ne;6;0;0;6
10320;Vandenis;VARLIUKAI;1586318209;Ne;8;0;0;8
10321;Vandenis;VARLIUKAI;1713088739;Ne;8;0;0;8
10322;Vandenis;VARLIUKAI;6348714341;Ne;3;2;1;6
10323;Vandenis;VARLIUKAI;1926484881;Ne;12;0;0;12
10324;Vandenis;VARLIUKAI;1587789226;Ne;0;2;1;3
10325;Vandenis;VARLIUKAI;6061476765;Ne;0;2;0;2
10326;Vandenis;VARLIUKAI;4220080362;Ne;9;0;0;9
10327;Vandenis;VARLIUKAI;8642524068;Ne;8;1;0;9
10328;Vandenis;VARLIUKAI;8184314532;Ne;5;0;0;5
10329;Vandenis;VARLIUKAI;6499309064;Ne;5;0;0;5
10330;Vandenis;VARLIUKAI;3048168468;Ne;3;0;0;3
10331;Vandenis;PINGVINAI;9856199548;Taip;7;1;0;8
10332;Vandenis;PINGVINAI;2209513000;Ne;2;6;0;8
10333;Vandenis;PINGVINAI;2665865704;Ne;3;0;0;3
10334;Vandenis;PINGVINAI;1780124964;Ne;0;2;1;3
10335;Vandenis;PINGVINAI;9609168578;Ne;0;3;0;3
10336;Vandenis;PINGVINAI;3360623444;Ne;0;2;0;2
10337;Vandenis;PINGVINAI;5191604973;Ne;4;0;0;4
10338;Vandenis;PINGVINAI;2757376962;Ne;0;4;0;4
10339;Vandenis;PINGVINAI;6731336385;Ne;8;0;0;8
10340;Vandenis;PINGVINAI;3933306911;Ne;5;1;0;6
10341;Vandenis;PINGVINAI;7267965471;Taip;5;0;0;5
10342;Vandenis;PINGVINAI;9717294497;Ne;0;1;0;1
10343;Vandenis;PINGVINAI;7770227772;Ne;9;7;0;16
10344;Vandenis;PINGVINAI;8560123112;Ne;5;0;0;5
10345;Vandenis;Debesėlių;3163423293;Ne;0;1;13;14
10346;Vandenis;Debesėlių;6555465114;Ne;8;0;0;8
10347;Vandenis;Debesėlių;4226028904;Taip;5;1;2;8
10348;Vandenis;Debesėlių;2844636823;Ne;4;0;1;5
10349;Vandenis;Debesėlių;8299531021;Taip;0;0;3;3
10350;Vandenis;Debesėlių;9521927635;Ne;1;0;3;4
10351;Vandenis;Debesėlių;6494266251;Ne;2;0;0;2
10352;Vandenis;Debesėlių;3835819023;Ne;4;0;2;6
10353;Vandenis;Debesėlių;2953842982;Taip;4;1;3;8
10354;Vandenis;Debesėlių;8678508812;Ne;0;6;0;6
10355;Vandenis;Debesėlių;5609737826;Ne;0;0;9;9
10356;Vandenis;Debesėlių;6327478049;Ne;0;0;20;20
10357;Vandenis;Debesėlių;3231434944;Taip;0;1;16;17
10358;Vandenis;Debesėlių;6003491409;Ne;0;0;3;3
10359;Vandenis;Debesėlių;5690075288;Ne;0;0;6;6
10360;Vandenis;Debesėlių;3701053997;Ne;9;0;0;9
10361;Vandenis;Gintarėlių;1542662577;Taip;0;0;14;14
10362;Vandenis;Gintarėlių;5683829836;Ne;0;0;4;4
10363;Vandenis;Gintarėlių;5560529824;Ne;0;0;3;3
10364;Vandenis;Gintarėlių;5874429309;Ne;0;0;1;1
10365;Vandenis;Gintarėlių;7318344804;Ne;0;0;1;1
10366;Vandenis;Gintarėlių;7884422309;Taip;0;0;20;20
10367;Vandenis;Gintarėlių;8420609325;Ne;0;0;7;7
10368;Vandenis;Gintarėlių;5071489844;Ne;0;0;1;1
10369;Vandenis;Gintarėlių;5081501601;Ne;0;0;9;9
10370;Vandenis;Gintarėlių;9498231306;Ne;0;0;2;2
10371;Vandenis;Gintarėlių;3342147138;Ne;0;0;12;12
10372;Vandenis;Lašelių;1233236350;Ne;11;0;0;11
10373;Vandenis;Lašelių;5459023317;Ne;3;0;0;3
10374;Vandenis;Lašelių;2475761158;Ne;4;0;0;4
10375;Vandenis;Lašelių;6869501724;Ne;2;0;0;2
10376;Vandenis;Lašelių;5434744285;Ne;11;0;0;11
10377;Vandenis;Lašelių;5207600083;Ne;4;0;0;4
10378;Vandenis;Lašelių;2440317162;Ne;5;0;0;5
10379;Vandenis;Lašelių;7544597355;Ne;10;0;0;10
10380;Vandenis;Lašelių;7095534371;Ne;2;19;0;21
10381;Vandenis;Lašelių;1636387018;Ne;12;0;0;12
10382;Vandenis;Lašelių;5440102024;Ne;6;10;0;16
10383;Vandenis;Burbuliukų;3750162497;Ne;12;0;0;12
10384;Vandenis;Burbuliukų;6068144373;Ne;6;0;0;6
10385;Vandenis;Burbuliukų;2783738727;Ne;0;1;0;1
10386;Vandenis;Burbuliukų;2998970043;Ne;0;1;0;1
10387;Vandenis;Burbuliukų;7080129095;Ne;0;2;0;2
10388;Vandenis;Burbuliukų;7856148436;Ne;8;0;0;8
10389;Vandenis;Burbuliukų;1035549424;Ne;3;0;0;3
10390;Vandenis;Burbuliukų;7492804255;Ne;5;0;0;5
10391;Vandenis;Burbuliukų;4483401826;Ne;4;0;0;4
10392;Vandenis;Burbuliukų;9314410776;Ne;9;2;0;11
10393;Vandenis;Burbuliukų;2647966131;Ne;0;1;0;1
10394;Vandenis;Burbuliukų;5545019790;Ne;4;2;0;6
10395;Vandenis;Burbuliukų;9128547685;Ne;4;2;0;6
10396;Vandenis;Kriauklyčių;9130870495;Taip;13;2;0;15
10397;Vandenis;Kriauklyčių;7736505435;Ne;6;0;0;6
10398;Vandenis;Kriauklyčių;5362018982;Ne;5;0;0;5
10399;Vandenis;Kriauklyčių;4219981694;Ne;0;0;4;4
10400;Vandenis;Kriauklyčių;8703465445;Ne;20;0;0;20
10401;Vandenis;Kriauklyčių;5983635986;Ne;2;0;3;5
10402;Vandenis;Kriauklyčių;8921398489;Ne;16;0;0;16
10403;Vandenis;Kriauklyčių;6112591131;Ne;0;0;1;1
10404;Vandenis;Kriauklyčių;2528214535;Ne;14;0;0;14
10405;Vandenis;Kriauklyčių;1836082819;Ne;5;0;0;5
10406;Vandenis;Kriauklyčių;2945086818;Ne;8;0;1;9
10407;Vandenis;Kriauklyčių;3262634002;Ne;2;0;1;3
10408;Vandenis;Kriauklyčių;3820448467;Taip;1;0;0;1
10409;Vandenis;Kriauklyčių;4168391832;Ne;9;0;0;9
10410;Vandenis;Kriauklyčių;2883058280;Ne;5;0;0;5
10411;Vandenis;Kriauklyčių;2997649372;Ne;12;0;0;12
10412;Vandenis;Kriauklyčių;9400150352;Ne;4;0;0;4
10413;Vėjelis;Pumpurėliai;2541077369;Ne;0;13;0;13
10414;Vėjelis;Pumpurėliai;3125815427;Ne;5;1;0;6
10415;Vėjelis;Pumpurėliai;5516672613;Ne;6;1;0;7
10416;Vėjelis;Pumpurėliai;2866394056;Ne;0;1;0;1
10417;Vėjelis;Pumpurėliai;3206025676;Ne;5;1;0;6
10418;Vėjelis;Pumpurėliai;1057586168;Ne;5;0;0;5
10419;Vėjelis;Pumpurėliai;7539681314;Ne;0;2;2;4
10420;Vėjelis;Pumpurėliai;3081923183;Ne;0;1;0;1
10421;Vėjelis;Pumpurėliai;9003601108;Ne;0;1;0;1
10422;Vėjelis;Pumpurėliai;6168648640;Ne;4;1;0;5
10423;Vėjelis;Pumpurėliai;6840643273;Ne;0;8;0;8
10424;Vėjelis;Pumpurėliai;9824130744;Ne;5;0;0;5
10425;Vėjelis;Pumpurėliai;1842552329;Ne;5;0;3;8
10426;Vėjelis;Pumpurėliai;8994680698;Ne;0;2;1;3
10427;Vėjelis;Pumpurėliai;2656895893;Ne;0;2;0;2
10428;Vėjelis;Pumpurėliai;3026520402;Ne;0;7;0;7
10429;Vėjelis;Pumpurėliai;2734891342;Taip;0;11;0;11
10430;Vėjelis;Pumpurėliai;7748975870;Taip;0;0;2;2
10431;Vėjelis;Drugeliai;1331334220;Ne;0;2;3;5
10432;Vėjelis;Drugeliai;2151737048;Ne;0;8;0;8
10433;Vėjelis;Drugeliai;4988352741;Ne;0;0;1;1
10434;Vėjelis;Drugeliai;4473677352;Ne;0;4;0;4
10435;Vėjelis;Drugeliai;4506243333;Ne;1;0;1;2
10436;Vėjelis;Drugeliai;3524350131;Ne;0;0;1;1
10437;Vėjelis;Drugeliai;6061966626;Ne;0;0;1;1
10438;Vėjelis;Drugeliai;6891260701;Ne;0;3;0;3
10439;Vėjelis;Drugeliai;9986867356;Ne;0;0;1;1
10440;Vėjelis;Drugeliai;1876663813;Ne;5;2;0;7
10441;Vėjelis;Drugeliai;8467887788;Ne;0;9;0;9
10442;Vėjelis;Drugeliai;1823215441;Ne;0;0;4;4
10443;Vėjelis;Drugeliai;5888429623;Ne;0;5;0;5
10444;Vėjelis;Drugeliai;9592852011;Ne;0;0;1;1
10445;Vėjelis;Drugeliai;7247057946;Ne;0;0;11;11
10446;Vėjelis;Drugeliai;8986581196;Ne;0;0;2;2
10447;Vėjelis;Malūnėlis;1994035417;Ne;0;6;0;6
10448;Vėjelis;Malūnėlis;7097474285;Ne;0;10;0;10
10449;Vėjelis;Malūnėlis;1448699738;Ne;8;1;0;9
10450;Vėjelis;Malūnėlis;3275186042;Ne;0;1;0;1
10451;Vėjelis;Malūnėlis;1882750621;Taip;1;1;0;2
10452;Vėjelis;Malūnėlis;5109441799;Ne;0;0;1;1
10453;Vėjelis;Malūnėlis;4171024976;Ne;0;1;0;1
10454;Vėjelis;Malūnėlis;1871467392;Ne;3;0;0;3
10455;Vėjelis;Malūnėlis;1342200813;Ne;0;0;2;2
10456;Vėjelis;Malūnėlis;8221349174;Ne;0;2;0;2
10457;Vėjelis;Malūnėlis;6600504736;Ne;0;1;0;1
10458;Vėjelis;Malūnėlis;8063276082;Ne;0;1;1;2
10459;Vėjelis;Malūnėlis;6244227830;Ne;6;0;5;11
10460;Vėjelis;Malūnėlis;1417987860;Ne;8;0;4;12
10461;Vėjelis;Malūnėlis;9636946669;Ne;0;0;3;3
10462;Vėjelis;Malūnėlis;5066748621;Ne;3;0;1;4
10463;Vėjelis;Malūnėlis;6823103188;Ne;1;2;0;3
10464;Vėjelis;Malūnėlis;2887703782;Ne;2;4;0;6
10465;Vėjelis;Malūnėlis;4063795811;Ne;5;0;0;5
10466;Vėjelis;Žvaigždutės;2522750651;Ne;0;2;0;2
10467;Vėjelis;Žvaigždutės;4868574574;Ne;0;1;0;1
10468;Vėjelis;Žvaigždutės;3495322620;Ne;0;12;0;12
10469;Vėjelis;Žvaigždutės;1956418258;Ne;0;0;2;2
10470;Vėjelis;Žvaigždutės;7860576967;Ne;5;0;2;7
10471;Vėjelis;Žvaigždutės;1075188861;Ne;0;0;3;3
10472;Vėjelis;Žvaigždutės;9451358807;Ne;11;0;5;16
10473;Vėjelis;Žvaigždutės;8995478684;Ne;0;0;4;4
10474;Vėjelis;Žvaigždutės;8281508498;Ne;0;0;2;2
10475;Vėjelis;Žvaigždutės;6909799367;Ne;0;0;6;6
10476;Vėjelis;Žvaigždutės;4884057836;Ne;0;0;3;3
10477;Vėjelis;Žvaigždutės;9546928491;Ne;1;0;3;4
10478;Vėjelis;Žvaigždutės;9675488924;Ne;5;0;1;6
10479;Vėjelis;Žvaigždutės;7101585528;Ne;0;0;1;1
10480;Vėjelis;Žvaigždutės;9202471939;Ne;0;3;0;3
10481;Vėjelis;Žvaigždutės;1615837863;Ne;0;3;0;3
10482;Vėjelis;Žvaigždutės;8273890475;Ne;0;0;2;2
10483;Vėjelis;Varpeliai;7507448059;Ne;0;12;0;12
10484;Vėjelis;Varpeliai;4853650350;Ne;0;1;0;1
10485;Vėjelis;Varpeliai;9492690970;Ne;0;1;0;1
10486;Vėjelis;Varpeliai;9557135813;Ne;0;0;1;1
10487;Vėjelis;Varpeliai;1436893015;Ne;0;2;0;2
10488;Vėjelis;Varpeliai;4353239658;Ne;0;2;3;5
10489;Vėjelis;Varpeliai;9135807341;Ne;0;3;0;3
10490;Vėjelis;Varpeliai;2117924725;Ne;21;0;0;21
10491;Vėjelis;Varpeliai;8866974952;Ne;0;1;0;1
10492;Vėjelis;Varpeliai;2132551615;Ne;15;0;3;18
10493;Vėjelis;Varpeliai;4101161670;Ne;0;0;1;1
10494;Vėjelis;Varpeliai;1549518622;Ne;0;2;0;2
10495;Vėjelis;Varpeliai;6386092350;Ne;0;15;0;15
10496;Vėjelis;Varpeliai;7046938604;Ne;0;2;0;2
10497;Vėjelis;Varpeliai;3315240387;Taip;8;3;0;11
10498;Vėjelis;Varpeliai;8300497094;Ne;4;1;0;5
10499;Vėjelis;Pelėdžiukų;3067215309;Ne;0;1;0;1
10500;Vėjelis;Pelėdžiukų;7211756910;Ne;0;5;0;5
10501;Vėjelis;Pelėdžiukų;2302652824;Ne;2;2;0;4
10502;Vėjelis;Pelėdžiukų;4852532740;Ne;6;7;3;16
10503;Vėjelis;Pelėdžiukų;9852892338;Ne;0;4;0;4
10504;Vėjelis;Pelėdžiukų;8433853523;Ne;3;0;0;3
10505;Vėjelis;Pelėdžiukų;4746355716;Ne;4;0;0;4
10506;Vėjelis;Pelėdžiukų;5507017221;Ne;5;2;0;7
10507;Vėjelis;Pelėdžiukų;1259743374;Ne;10;2;0;12
10508;Vėjelis;Pelėdžiukų;6226234271;Taip;0;2;14;16
10509;Vėjelis;Pelėdžiukų;7559733997;Ne;0;4;0;4
10510;Vėjelis;Pelėdžiukų;8153021028;Ne;5;1;0;6
10511;Vėjelis;Pelėdžiukų;8067153728;Ne;1;1;0;2
10512;Vėjelis;Pelėdžiukų;2283628712;Taip;0;2;5;7
10513;Vėjelis;Pelėdžiukų;9769871497;Ne;0;0;1;1
10514;Vėjelis;Pelėdžiukų;4318295503;Ne;11;0;2;13
10515;Vėjelis;Pelėdžiukų;9867392835;Ne;0;9;0;9
10516;Vėjelis;Pelėdžiukų;5662728912;Ne;11;2;0;13
10517;Vėjelis;Skruzdeliukų;3096861110;Taip;4;0;0;4
10518;Vėjelis;Skruzdeliukų;1938557472;Ne;2;0;0;2
10519;Vėjelis;Skruzdeliukų;9964641007;Ne;10;0;0;10
10520;Vėjelis;Skruzdeliukų;7577991381;Ne;10;0;0;10
10521;Vėjelis;Skruzdeliukų;5333058186;Ne;9;0;0;9
10522;Vėjelis;Skruzdeliukų;2238139120;Ne;4;0;0;4
10523;Vėjelis;Skruzdeliukų;4531125902;Ne;8;0;0;8
10524;Vėjelis;Skruzdeliukų;9528142262;Ne;8;0;0;8
10525;Vėjelis;Skruzdeliukų;4758209854;Ne;9;0;0;9
10526;Vėjelis;Skruzdeliukų;1793991609;Ne;6;0;0;6
10527;Vėjelis;Skruzdeliukų;2987292658;Ne;6;0;0;6
10528;Vėjelis;Skruzdeliukų;4605288262;Ne;5;0;0;5
10529;Vėjelis;Pieštukų;7854614677;Ne;6;0;1;7
10530;Vėjelis;Pieštukų;6453605110;Taip;0;21;0;21
10531;Vėjelis;Pieštukų;6520167840;Ne;0;0;1;1
10532;Vėjelis;Pieštukų;7613786936;Ne;0;0;2;2
10533;Vėjelis;Pieštukų;6839116451;Ne;7;0;0;7
10534;Vėjelis;Pieštukų;6938777118;Ne;1;0;0;1
10535;Vėjelis;Pieštukų;2553724469;Ne;12;0;0;12
10536;Vėjelis;Pieštukų;3012722334;Ne;3;0;0;3
10537;Vėjelis;Pieštukų;7889625599;Ne;0;1;0;1
10538;Vėjelis;Pieštukų;8310513436;Ne;2;0;2;4
10539;Vėjelis;Pieštukų;1291592424;Ne;2;0;0;2
10540;Vėjelis;Ramunėlių;5331895599;Ne;0;7;0;7
10541;Vėjelis;Ramunėlių;1506416880;Ne;4;0;0;4
10542;Vėjelis;Ramunėlių;3756116835;Ne;0;0;1;1
10543;Vėjelis;Ramunėlių;1452685229;Ne;0;1;0;1
10544;Vėjelis;Ramunėlių;6573481399;Ne;0;11;0;11
10545;Vėjelis;Ramunėlių;2534737343;Ne;9;0;0;9
10546;Vėjelis;Ramunėlių;8505186157;Ne;1;0;1;2
10547;Vėjelis;Ramunėlių;4717248684;Ne;3;2;0;5
10548;Vėjelis;Ramunėlių;5291321394;Ne;0;1;0;1
10549;Vėjelis;Nykštukai;6741600874;Ne;6;0;0;6
10550;Vėjelis;Nykštukai;9957614551;Ne;0;2;0;2
10551;Vėjelis;Nykštukai;7233448544;Ne;0;4;0;4
10552;Vėjelis;Nykštukai;5339200991;Ne;0;6;0;6
10553;Vėjelis;Nykštukai;6602964509;Ne;1;0;0;1
10554;Vėjelis;Nykštukai;2573683778;Ne;0;1;0;1
10555;Vėjelis;Nykštukai;3843601190;Ne;5;5;0;10
10556;Vėjelis;Nykštukai;4713754452;Ne;3;8;0;11
10557;Vėjelis;Nykštukai;8755889077;Taip;0;2;0;2
10558;Vėjelis;Nykštukai;9979979480;Ne;7;2;0;9
10559;Vėjelis;Nykštukai;6581265682;Ne;0;3;0;3
10560;Vėjelis;Nykštukai;8452132066;Ne;0;21;0;21
10561;Vėjelis;Nykštukai;7552365055;Ne;12;0;0;12
10562;Vėjelis;Nykštukai;9351658311;Ne;0;8;0;8
10563;Vėjelis;Nykštukai;1074246375;Ne;5;0;0;5
10564;Vėjelis;BITUTĖS;6824919005;Ne;8;1;0;9
10565;Vėjelis;BITUTĖS;4276237884;Taip;0;6;0;6
10566;Vėjelis;BITUTĖS;3772706363;Ne;6;1;0;7
10567;Vėjelis;BITUTĖS;1834203833;Ne;0;2;2;4
10568;Vėjelis;BITUTĖS;6283428333;Ne;11;0;0;11
10569;Vėjelis;BITUTĖS;1112394040;Ne;6;1;0;7
10570;Vėjelis;BITUTĖS;3767625080;Ne;5;1;0;6
10571;Vėjelis;BITUTĖS;6569848405;Ne;5;2;0;7
10572;Vėjelis;BITUTĖS;1457373815;Taip;10;1;2;13
10573;Vėjelis;BITUTĖS;8571757635;Ne;9;1;0;10
10574;Vėjelis;BITUTĖS;1022888418;Ne;5;1;0;6
10575;Vėjelis;BITUTĖS;1116238331;Ne;5;3;0;8
10576;Vėjelis;BITUTĖS;8286070405;Ne;6;2;0;8
10577;Vėjelis;BITUTĖS;1674810054;Ne;10;0;1;11
10578;Vėjelis;BITUTĖS;1070853175;Ne;5;0;1;6
10579;Vėjelis;BITUTĖS;4348246825;Ne;11;0;0;11
10580;Vėjelis;BITUTĖS;6660799519;Ne;5;0;0;5
10581;Vėjelis;BITUTĖS;1235788079;Ne;4;2;0;6
10582;Vėjelis;BITUTĖS;4745262277;Ne;6;0;0;6
10583;Vėjelis;BITUTĖS;7790713917;Taip;0;1;0;1
10584;Vėjelis;Boruželės;2199680661;Ne;0;0;1;1
10585;Vėjelis;Boruželės;1429496839;Ne;5;0;1;6
10586;Vėjelis;Boruželės;6108049183;Taip;0;7;0;7
10587;Vėjelis;Boruželės;3276062426;Ne;1;0;1;2
10588;Vėjelis;Boruželės;4132824111;Ne;0;8;1;9
10589;Vėjelis;Boruželės;7752923796;Ne;12;0;5;17
10590;Vėjelis;Boruželės;8957653216;Ne;1;5;3;9
10591;Vėjelis;Boruželės;4412135676;Ne;0;0;1;1
10592;Vėjelis;Boruželės;4746932126;Ne;0;1;1;2
10593;Vėjelis;Boruželės;1978952781;Ne;0;0;1;1
10594;Vėjelis;Boruželės;8353084814;Ne;0;5;1;6
10595;Vėjelis;Boruželės;2416832899;Ne;0;0;1;1
10596;Vėjelis;Boruželės;7594586198;Ne;1;0;1;2
10597;Vėjelis;Boruželės;7981032872;Ne;0;0;8;8
10598;Vėjelis;Boruželės;7697394469;Ne;3;0;1;4
10599;Vėjelis;Boruželės;4066956765;Ne;0;0;2;2
10600;Vėjelis;Boruželės;2788205363;Ne;0;2;3;5
10601;Vėtrungė;Debesėlių;3655025938;Taip;0;0;1;1
10602;Vėtrungė;Debesėlių;2825732654;Taip;0;0;4;4
10603;Vėtrungė;Debesėlių;7863176604;Ne;5;0;0;5
10604;Vėtrungė;Debesėlių;6439014588;Ne;0;0;4;4
10605;Vėtrungė;Debesėlių;1191007983;Ne;5;0;2;7
10606;Vėtrungė;Debesėlių;3745680607;Ne;6;0;2;8
10607;Vėtrungė;Debesėlių;9359012317;Ne;6;0;5;11
10608;Vėtrungė;Debesėlių;1807742144;Taip;0;0;10;10
10609;Vėtrungė;Debesėlių;3433811829;Ne;0;0;7;7
10610;Vėtrungė;Debesėlių;2447851565;Ne;0;0;6;6
10611;Vėtrungė;Debesėlių;5246813735;Ne;0;0;3;3
10612;Vėtrungė;Debesėlių;5545581078;Ne;0;0;1;1
10613;Vėtrungė;Debesėlių;7185104341;Ne;0;2;0;2
10614;Vėtrungė;Debesėlių;5939537473;Taip;0;0;16;16
10615;Vėtrungė;Debesėlių;1871358961;Ne;0;0;3;3
10616;Vėtrungė;Debesėlių;1480035015;Ne;0;0;2;2
10617;Vėtrungė;Debesėlių;7632969321;Ne;1;0;2;3
10618;Vėtrungė;Debesėlių;9642541034;Ne;0;0;3;3
10619;Vėtrungė;Debesėlių;6115556675;Ne;2;0;0;2
10620;Vėtrungė;Zuikių;9332362038;Taip;1;0;0;1
10621;Vėtrungė;Zuikių;9407558097;Ne;0;8;2;10
10622;Vėtrungė;Zuikių;4121886031;Ne;3;0;0;3
10623;Vėtrungė;Zuikių;7573021445;Ne;0;0;13;13
10624;Vėtrungė;Zuikių;3335047815;Ne;0;2;0;2
10625;Vėtrungė;Zuikių;8157356569;Ne;0;1;0;1
10626;Vėtrungė;Zuikių;1215953192;Ne;10;0;0;10
10627;Vėtrungė;Zuikių;3908259010;Ne;0;0;2;2
10628;Vėtrungė;Zuikių;1729819557;Ne;1;1;4;6
10629;Vėtrungė;Zuikių;4916692634;Ne;1;0;3;4
10630;Vėtrungė;Zuikių;4197321604;Ne;0;0;2;2
10631;Vėtrungė;Zuikių;1007578933;Ne;0;8;2;10
10632;Vėtrungė;Zuikių;7558548846;Ne;0;8;2;10
10633;Vėtrungė;Zuikių;8742161467;Ne;0;1;8;9
10634;Vėtrungė;Zuikių;2537221101;Ne;2;1;1;4
10635;Vėtrungė;Zuikių;7342250921;Ne;0;12;2;14
10636;Vėtrungė;Zuikių;9248113268;Ne;1;0;0;1
10637;Vėtrungė;Zuikių;7435005821;Ne;2;1;2;5
10638;Vėtrungė;Zuikių;1280823326;Ne;0;6;0;6
10639;Vėtrungė;Zuikių;4508176017;Taip;4;0;1;5
10640;Vėtrungė;Zuikių;8958748086;Ne;0;0;2;2
10641;Vėtrungė;Zuikių;5887929703;Ne;0;5;0;5
10642;Vėtrungė;Drugelių;5622109033;Ne;0;1;0;1
10643;Vėtrungė;Drugelių;7943682529;Ne;0;0;1;1
10644;Vėtrungė;Drugelių;9090873546;Ne;0;0;3;3
10645;Vėtrungė;Drugelių;2124476787;Ne;0;1;0;1
10646;Vėtrungė;Drugelių;2970067995;Ne;0;1;0;1
10647;Vėtrungė;Drugelių;5251308945;Taip;0;7;0;7
10648;Vėtrungė;Drugelių;9812496068;Ne;10;0;0;10
10649;Vėtrungė;Drugelių;8753387108;Ne;0;1;0;1
10650;Vėtrungė;Drugelių;3634995652;Ne;0;4;0;4
10651;Vėtrungė;Drugelių;3744377479;Ne;4;0;1;5
10652;Vėtrungė;Drugelių;7186353024;Ne;10;2;0;12
10653;Vėtrungė;Drugelių;2933312366;Taip;6;7;0;13
10654;Vėtrungė;Drugelių;2508501223;Ne;0;8;0;8
10655;Vėtrungė;Drugelių;5887245282;Ne;10;0;0;10
10656;Vėtrungė;Drugelių;7974212517;Ne;0;2;0;2
10657;Vėtrungė;Drugelių;9423979719;Ne;0;2;0;2
10658;Vėtrungė;Drugelių;1611114179;Ne;8;5;0;13
10659;Vėtrungė;Do-re-mi;7752842285;Ne;6;0;0;6
10660;Vėtrungė;Do-re-mi;1408629891;Ne;12;0;0;12
10661;Vėtrungė;Do-re-mi;7411180918;Ne;5;3;0;8
10662;Vėtrungė;Do-re-mi;2832753464;Ne;6;0;2;8
10663;Vėtrungė;Do-re-mi;2643851525;Ne;6;0;0;6
10664;Vėtrungė;Do-re-mi;6782673546;Ne;0;1;0;1
10665;Vėtrungė;Do-re-mi;3885409650;Taip;10;2;1;13
10666;Vėtrungė;Do-re-mi;4944115709;Taip;15;0;0;15
10667;Vėtrungė;Do-re-mi;7175547800;Ne;0;1;0;1
10668;Vėtrungė;Do-re-mi;1024958500;Ne;0;1;0;1
10669;Vėtrungė;Do-re-mi;5272077870;Ne;0;2;0;2
10670;Vėtrungė;Do-re-mi;1185643576;Ne;4;1;0;5
10671;Vėtrungė;Do-re-mi;9158760410;Ne;9;0;0;9
10672;Vėtrungė;Do-re-mi;3000030998;Ne;11;0;0;11
10673;Vėtrungė;Smalsučių;1020095914;Ne;7;0;0;7
10674;Vėtrungė;Smalsučių;7270370939;Ne;0;0;1;1
10675;Vėtrungė;Smalsučių;4713420194;Ne;5;0;0;5
10676;Vėtrungė;Smalsučių;9313438768;Ne;0;8;0;8
10677;Vėtrungė;Smalsučių;9685389270;Ne;0;1;0;1
10678;Vėtrungė;Smalsučių;9207846866;Ne;0;8;0;8
10679;Vėtrungė;Smalsučių;1766599777;Ne;3;4;0;7
10680;Vėtrungė;Smalsučių;5832298824;Ne;0;2;0;2
10681;Vėtrungė;Smalsučių;2136966687;Ne;0;21;0;21
10682;Vėtrungė;Smalsučių;2207041148;Ne;5;1;0;6
10683;Vėtrungė;Smalsučių;5836190044;Ne;7;0;2;9
10684;Vėtrungė;Smalsučių;6374739740;Taip;0;1;1;2
10685;Vėtrungė;Gudručių;7496582551;Ne;0;1;0;1
10686;Vėtrungė;Gudručių;6449124019;Ne;0;0;2;2
10687;Vėtrungė;Gudručių;8956375453;Ne;0;1;0;1
10688;Vėtrungė;Gudručių;7807708310;Ne;0;10;2;12
10689;Vėtrungė;Gudručių;9271869305;Ne;0;0;2;2
10690;Vėtrungė;Gudručių;2883254822;Ne;0;1;0;1
10691;Vėtrungė;Gudručių;3200251047;Ne;0;21;0;21
10692;Vėtrungė;Gudručių;5430818470;Ne;6;0;1;7
10693;Vėtrungė;Gudručių;4709068324;Ne;0;1;0;1
10694;Vėtrungė;Gudručių;9865628172;Ne;6;1;0;7
10695;Vėtrungė;Kodėlčių;9172488122;Ne;3;2;7;12
10696;Vėtrungė;Kodėlčių;2739382736;Ne;10;1;0;11
10697;Vėtrungė;Kodėlčių;3903604247;Ne;12;0;0;12
10698;Vėtrungė;Kodėlčių;3500551575;Ne;6;1;0;7
10699;Vėtrungė;Kodėlčių;7872043253;Taip;0;2;0;2
10700;Vėtrungė;Kodėlčių;9852609222;Ne;6;0;0;6
10701;Vėtrungė;Kodėlčių;8465132902;Ne;4;0;0;4
10702;Vėtrungė;Kodėlčių;8859592174;Ne;0;4;0;4
10703;Vėtrungė;Kodėlčių;7862615352;Ne;2;2;0;4
10704;Vėtrungė;Kodėlčių;5385880910;Ne;8;0;0;8
10705;Vėtrungė;Kodėlčių;9211406129;Ne;0;2;0;2
10706;Vėtrungė;Kodėlčių;1032730549;Ne;0;2;0;2
10707;Vėtrungė;Kodėlčių;9127735773;Ne;9;0;0;9
10708;Vėtrungė;Kodėlčių;5830221727;Ne;8;1;0;9
10709;Vėtrungė;Kodėlčių;4756863295;Ne;5;1;0;6
10710;Vėtrungė;Kodėlčių;8985054558;Ne;5;1;0;6
10711;Vėtrungė;Kodėlčių;3922749661;Ne;5;1;0;6
10712;Vėtrungė;Kodėlčių;8013249618;Taip;0;1;0;1
10713;Vėtrungė;Kodėlčių;3887230224;Ne;3;2;0;5
10714;Vėtrungė;Kodėlčių;7740260264;Ne;3;0;1;4
10715;Vėtrungė;Kodėlčių;6807838878;Ne;15;0;0;15
10716;Vėtrungė;Kodėlčių;3638303693;Ne;10;1;0;11
10717;Vėtrungė;Kodėlčių;1871157707;Ne;8;0;1;9
10718;Vėtrungė;Paukštelių;6983172988;Ne;2;0;0;2
10719;Vėtrungė;Paukštelių;3957148270;Ne;0;9;0;9
10720;Vėtrungė;Paukštelių;3466149991;Ne;7;5;0;12
10721;Vėtrungė;Paukštelių;7258995031;Ne;5;3;0;8
10722;Vėtrungė;Paukštelių;5338424871;Ne;1;7;0;8
10723;Vėtrungė;Paukštelių;6812588777;Ne;0;5;0;5
10724;Vėtrungė;Paukštelių;2798915063;Ne;0;4;0;4
10725;Vėtrungė;Paukštelių;2981610749;Ne;21;0;1;22
10726;Vėtrungė;Paukštelių;6146327857;Ne;5;0;0;5
10727;Vėtrungė;Paukštelių;8149563485;Ne;3;0;0;3
10728;Vėtrungė;Paukštelių;2786721399;Ne;7;0;0;7
10729;Vėtrungė;Paukštelių;9461365083;Ne;4;2;0;6
10730;Vėtrungė;Paukštelių;9822462988;Ne;16;0;0;16
10731;Vėtrungė;Paukštelių;2741119142;Ne;4;0;0;4
10732;Vėtrungė;Viščiukų;2725607774;Ne;0;6;0;6
10733;Vėtrungė;Viščiukų;5808423634;Ne;0;0;3;3
10734;Vėtrungė;Viščiukų;8761701511;Ne;0;6;0;6
10735;Vėtrungė;Viščiukų;3527585648;Ne;21;0;0;21
10736;Vėtrungė;Viščiukų;4145172377;Ne;9;0;4;13
10737;Vėtrungė;Viščiukų;3859501564;Ne;7;0;1;8
10738;Vėtrungė;Viščiukų;3917214308;Ne;6;0;0;6
10739;Vėtrungė;Viščiukų;9862408289;Ne;0;0;2;2
10740;Vėtrungė;Viščiukų;7065114742;Ne;2;0;0;2
10741;Vėtrungė;Viščiukų;2558088727;Ne;0;11;3;14
10742;Vėtrungė;Viščiukų;6495674830;Ne;2;0;0;2
10743;Vėtrungė;Viščiukų;3874839729;Taip;0;0;6;6
10744;Vėtrungė;Viščiukų;8276160906;Ne;0;0;1;1
10745;Vėtrungė;Viščiukų;4516633703;Ne;6;0;0;6
10746;Vėtrungė;Viščiukų;6279761125;Ne;5;0;0;5
10747;Vėtrungė;Nykštukų;9696984346;Ne;0;3;10;13
10748;Vėtrungė;Nykštukų;7819147751;Ne;9;1;0;10
10749;Vėtrungė;Nykštukų;6990506209;Ne;15;0;0;15
10750;Vėtrungė;Nykštukų;2348557463;Ne;0;0;6;6
10751;Vėtrungė;Nykštukų;7733472482;Ne;1;0;1;2
10752;Vėtrungė;Nykštukų;2309821873;Ne;0;7;0;7
10753;Vėtrungė;Nykštukų;8059553343;Ne;5;3;0;8
10754;Vėtrungė;Nykštukų;4020987532;Ne;0;2;0;2
10755;Vėtrungė;Nykštukų;9569555731;Ne;9;0;0;9
10756;Vėtrungė;Nykštukų;7699392279;Ne;2;0;0;2
10757;Vėtrungė;Nykštukų;9773838651;Ne;2;2;0;4
10758;Vėtrungė;Nykštukų;6866720274;Ne;0;1;0;1
10759;Vėtrungė;Nykštukų;3869546285;Ne;2;0;0;2
10760;Vėtrungė;Nykštukų;6783756347;Ne;0;1;2;3
10761;Vėtrungė;Nykštukų;4289435509;Ne;5;0;0;5
10762;Vėtrungė;Nykštukų;5132419026;Ne;6;0;3;9
10763;Vėtrungė;Nykštukų;7647363322;Ne;6;0;3;9
10764;Vėtrungė;Nykštukų;3046782145;Ne;13;0;2;15
10765;Vėtrungė;Nykštukų;7037942782;Ne;1;6;4;11
10766;Vėtrungė;Nykštukų;2205455847;Ne;22;0;0;22
10767;Vėtrungė;Nykštukų;8577668542;Ne;4;0;2;6
10768;Vėtrungė;Ąžuoliukų;8775969909;Ne;3;0;3;6
10769;Vėtrungė;Ąžuoliukų;1034537691;Ne;4;0;2;6
10770;Vėtrungė;Ąžuoliukų;6363761237;Ne;0;1;0;1
10771;Vėtrungė;Ąžuoliukų;8913748584;Taip;0;0;2;2
10772;Vėtrungė;Ąžuoliukų;3073965379;Ne;9;0;0;9
10773;Vėtrungė;Ąžuoliukų;3938684888;Ne;15;0;1;16
10774;Vėtrungė;Ąžuoliukų;6073563461;Ne;0;3;0;3
10775;Vėtrungė;Ąžuoliukų;4925843510;Ne;0;0;2;2
10776;Vėtrungė;Ąžuoliukų;7096106273;Taip;0;0;12;12
10777;Vėtrungė;Ąžuoliukų;6476717645;Ne;5;0;0;5
10778;Vėtrungė;Ąžuoliukų;1169648551;Ne;8;0;1;9
10779;Vėtrungė;Ąžuoliukų;4489937085;Ne;13;0;1;14
10780;Vėtrungė;Ąžuoliukų;4740985408;Ne;0;3;0;3
10781;Vėtrungė;Ąžuoliukų;9684184905;Ne;1;0;0;1
10782;Vėtrungė;Ąžuoliukų;5021830780;Taip;9;0;0;9
10783;Vėtrungė;Ąžuoliukų;1568598938;Ne;0;0;2;2
10784;Vėtrungė;Ąžuoliukų;9459062715;Ne;0;0;4;4
10785;Vėtrungė;"&quot;MEŠKIUKŲ&quot;";9667227707;Taip;0;0;4;4
10786;Vėtrungė;"&quot;MEŠKIUKŲ&quot;";4529215724;Taip;0;0;4;4
10787;Vėtrungė;"&quot;MEŠKIUKŲ&quot;";7900887923;Ne;8;0;0;8
10788;Vėtrungė;"&quot;MEŠKIUKŲ&quot;";2462720995;Ne;1;1;0;2
10789;Vėtrungė;"&quot;MEŠKIUKŲ&quot;";7323779310;Ne;2;0;0;2
10790;Vėtrungė;"&quot;MEŠKIUKŲ&quot;";4550285483;Ne;4;0;0;4
10791;Vėtrungė;"&quot;MEŠKIUKŲ&quot;";2711203550;Ne;11;1;0;12
10792;Vėtrungė;"&quot;MEŠKIUKŲ&quot;";8632209474;Ne;5;0;0;5
10793;Vilnelė;Lakštutė;8843094480;Ne;7;1;2;10
10794;Vilnelė;Lakštutė;5786086401;Ne;11;0;1;12
10795;Vilnelė;Lakštutė;6249731759;Ne;0;2;0;2
10796;Vilnelė;Lakštutė;6837850601;Ne;0;4;0;4
10797;Vilnelė;Lakštutė;5554451335;Ne;11;8;0;19
10798;Vilnelė;Lakštutė;1762024490;Taip;0;2;0;2
10799;Vilnelė;Lakštutė;8201829887;Ne;6;0;0;6
10800;Vilnelė;Lakštutė;7702217893;Ne;5;0;0;5
10801;Vilnelė;Lakštutė;4427383755;Ne;0;8;0;8
10802;Vilnelė;Lakštutė;1547117566;Ne;0;8;0;8
10803;Vilnelė;Lakštutė;3231387543;Ne;6;0;0;6
10804;Vilnelė;Lakštutė;1734277231;Taip;3;2;0;5
10805;Vilnelė;Lakštutė;3900484348;Ne;0;2;6;8
10806;Vilnelė;Lakštutė;5498574366;Taip;0;1;0;1
10807;Vilnelė;Lakštutė;6686896190;Ne;0;2;1;3
10808;Vilnelė;Lakštutė;3032273912;Ne;4;4;0;8
10809;Vilnelė;Lakštutė;4017436910;Ne;3;2;1;6
10810;Vilnelė;Lakštutė;6156838553;Ne;6;0;0;6
10811;Vilnelė;Lakštutė;9843449060;Taip;9;0;2;11
10812;Vilnelė;Lakštutė;2803880424;Ne;9;1;0;10
10813;Vilnelė;Lakštutė;2418216191;Ne;8;0;2;10
10814;Vilnelė;Lakštutė;5913967803;Ne;4;0;1;5
10815;Vilnelė;Vyturėlis;7536603663;Ne;5;4;0;9
10816;Vilnelė;Vyturėlis;3503461211;Ne;7;2;0;9
10817;Vilnelė;Vyturėlis;1574809879;Ne;11;7;0;18
10818;Vilnelė;Vyturėlis;3558073399;Ne;5;0;0;5
10819;Vilnelė;Vyturėlis;6083082959;Ne;0;2;0;2
10820;Vilnelė;Vyturėlis;3993826389;Ne;4;0;0;4
10821;Vilnelė;Vyturėlis;7388336851;Ne;4;0;0;4
10822;Vilnelė;Vyturėlis;8667403338;Ne;11;0;0;11
10823;Vilnelė;Vyturėlis;4166351390;Ne;10;0;0;10
10824;Vilnelė;Vyturėlis;1351798589;Ne;11;0;0;11
10825;Vilnelė;Vyturėlis;2841315531;Ne;0;1;0;1
10826;Vilnelė;Vyturėlis;9162681538;Ne;5;0;0;5
10827;Vilnelė;Vyturėlis;3075681823;Ne;3;0;0;3
10828;Vilnelė;Vyturėlis;9804772168;Ne;0;1;0;1
10829;Vilnelė;Vyturėlis;1596625263;Ne;10;0;0;10
10830;Vilnelė;Vyturėlis;7338573817;Ne;6;0;0;6
10831;Vilnelė;Vyturėlis;8121075430;Taip;0;5;0;5
10832;Vilnelė;Vyturėlis;6342242777;Ne;10;3;0;13
10833;Vilnelė;Vyturėlis;3843064564;Ne;0;2;0;2
10834;Vilnelė;Vyturėlis;9674145631;Ne;12;0;0;12
10835;Vilnelė;Pagrandukas;5508759323;Ne;0;2;0;2
10836;Vilnelė;Pagrandukas;4295816753;Ne;0;7;0;7
10837;Vilnelė;Pagrandukas;3844066232;Ne;0;2;0;2
10838;Vilnelė;Pagrandukas;6659537454;Ne;0;6;0;6
10839;Vilnelė;Pagrandukas;4448413194;Ne;9;2;0;11
10840;Vilnelė;Pagrandukas;6830433856;Ne;0;2;1;3
10841;Vilnelė;Pagrandukas;4664946923;Ne;8;0;0;8
10842;Vilnelė;Pagrandukas;6982847450;Ne;0;2;0;2
10843;Vilnelė;Pagrandukas;7560124407;Ne;8;0;0;8
10844;Vilnelė;Pagrandukas;3685294539;Taip;5;0;0;5
10845;Vilnelė;Pagrandukas;4931943297;Ne;0;0;3;3
10846;Vilnelė;Pagrandukas;7882756938;Ne;0;3;0;3
10847;Vilnelė;Pagrandukas;7348404699;Taip;0;5;0;5
10848;Vilnelė;Pagrandukas;3323738649;Ne;0;1;0;1
10849;Vilnelė;Pagrandukas;8116613831;Ne;0;6;0;6
10850;Vilnelė;Pagrandukas;9489760844;Ne;0;5;0;5
10851;Vilnelė;Pagrandukas;6466321228;Ne;0;16;0;16
10852;Vilnelė;Pagrandukas;4478847902;Ne;0;8;0;8
10853;Vilnelė;Pagrandukas;9635159885;Ne;0;2;2;4
10854;Vilnelė;Pagrandukas;2165389724;Ne;0;0;2;2
10855;Vilnelė;Bitutė;4718994967;Ne;0;6;0;6
10856;Vilnelė;Bitutė;3529718234;Ne;0;1;0;1
10857;Vilnelė;Bitutė;1880318663;Ne;0;1;0;1
10858;Vilnelė;Bitutė;9589410276;Ne;0;1;0;1
10859;Vilnelė;Bitutė;9879688569;Ne;0;7;0;7
10860;Vilnelė;Bitutė;5473379559;Ne;0;1;0;1
10861;Vilnelė;Bitutė;3781595939;Ne;0;17;0;17
10862;Vilnelė;Bitutė;3791258264;Taip;5;2;0;7
10863;Vilnelė;Bitutė;6132739519;Ne;0;4;0;4
10864;Vilnelė;Bitutė;1730149127;Ne;0;6;0;6
10865;Vilnelė;Bitutė;9884955712;Ne;0;1;0;1
10866;Vilnelė;Bitutė;6355912551;Ne;0;2;0;2
10867;Vilnelė;Bitutė;3945921490;Ne;0;13;0;13
10868;Vilnelė;Bitutė;7976798775;Ne;0;0;4;4
10869;Vilnelė;Bitutė;8092642447;Ne;0;2;2;4
10870;Vilnelė;Bitutė;3811289758;Ne;0;6;0;6
10871;Vilnelė;Bitutė;3856917286;Ne;0;3;0;3
10872;Vilnelė;Bitutė;7883724600;Ne;5;1;0;6
10873;Vilnelė;Šaltinėlis;5487729159;Taip;4;0;0;4
10874;Vilnelė;Šaltinėlis;1108529953;Ne;7;0;0;7
10875;Vilnelė;Šaltinėlis;8118746185;Ne;2;0;0;2
10876;Vilnelė;Šaltinėlis;7949990857;Ne;4;0;0;4
10877;Vilnelė;Šaltinėlis;8267286482;Ne;2;0;0;2
10878;Vilnelė;Šaltinėlis;3579253910;Ne;2;0;0;2
10879;Vilnelė;Šaltinėlis;4973214588;Ne;0;21;0;21
10880;Vilnelė;Šaltinėlis;4939435139;Ne;0;5;0;5
10881;Vilnelė;Šaltinėlis;6858955752;Ne;1;0;0;1
10882;Vilnelė;Šaltinėlis;9578062060;Taip;7;0;0;7
10883;Vilnelė;Šaltinėlis;5341996342;Ne;13;0;0;13
10884;Vilnelė;Šaltinėlis;2639194662;Ne;3;3;0;6
10885;Vilnelė;Šaltinėlis;5625236416;Ne;9;0;0;9
10886;Vilnelė;Šaltinėlis;9774791340;Ne;2;0;0;2
10887;Vilnelė;Šaltinėlis;1893356606;Taip;0;21;0;21
10888;Vilnelė;Šaltinėlis;2835124257;Ne;6;0;0;6
10889;Vilnelė;Šaltinėlis;7924367229;Ne;17;0;0;17
10890;Vilnelė;Riešutėllis;1027463000;Ne;0;11;0;11
10891;Vilnelė;Riešutėllis;7020707723;Ne;5;4;0;9
10892;Vilnelė;Riešutėllis;4203549404;Ne;7;0;1;8
10893;Vilnelė;Riešutėllis;3290952017;Taip;5;1;0;6
10894;Vilnelė;Riešutėllis;8588430578;Ne;0;7;0;7
10895;Vilnelė;Riešutėllis;7957695470;Ne;5;7;1;13
10896;Vilnelė;Riešutėllis;8750705826;Ne;2;0;1;3
10897;Vilnelė;Riešutėllis;4780827432;Ne;8;1;0;9
10898;Vilnelė;Riešutėllis;4455099179;Ne;7;0;0;7
10899;Vilnelė;Riešutėllis;2367127222;Ne;5;3;0;8
10900;Vilnelė;Riešutėllis;5306723959;Ne;13;0;0;13
10901;Vilnelė;Riešutėllis;3670613082;Taip;14;0;0;14
10902;Vilnelė;Riešutėllis;7085972543;Ne;10;0;0;10
10903;Vilnelė;Riešutėllis;3211657057;Ne;1;1;0;2
10904;Vilnelė;Riešutėllis;9016866597;Ne;7;7;0;14
10905;Vilnelė;Riešutėllis;7087798406;Ne;5;0;0;5
10906;Vilnelė;Riešutėllis;4254744025;Ne;8;4;0;12
10907;Vilnelė;Riešutėllis;3730997665;Taip;3;1;0;4
10908;Vilnelė;Riešutėllis;2706699572;Ne;0;1;0;1
10909;Vilnelė;Riešutėllis;8774842903;Ne;10;1;0;11
10910;Vilnelė;Riešutėllis;3031790547;Ne;5;0;0;5
10911;Vilnelė;Nykštukas;4210511566;Taip;5;1;0;6
10912;Vilnelė;Nykštukas;2891787022;Ne;10;1;0;11
10913;Vilnelė;Nykštukas;4734511521;Ne;0;1;0;1
10914;Vilnelė;Nykštukas;6344134620;Ne;5;0;0;5
10915;Vilnelė;Nykštukas;4295630317;Ne;29;0;0;29
10916;Vilnelė;Nykštukas;1554473199;Ne;9;16;0;25
10917;Vilnelė;Nykštukas;1819154122;Ne;0;3;0;3
10918;Vilnelė;Nykštukas;4060927733;Taip;13;0;0;13
10919;Vilnelė;Nykštukas;2299381653;Taip;0;13;0;13
10920;Vilnelė;Nykštukas;5041031750;Ne;0;1;0;1
10921;Vilnelė;Nykštukas;2157793186;Ne;15;0;0;15
10922;Vilnelė;Nykštukas;4516818999;Ne;0;18;0;18
10923;Vilnelė;Nykštukas;8579294202;Ne;0;15;0;15
10924;Vilnelė;Nykštukas;7161529969;Ne;4;0;0;4
10925;Vilnelė;Nykštukas;6054488692;Ne;13;0;0;13
10926;Vilnelė;Nykštukas;8630048961;Ne;0;19;0;19
10927;Vilnelė;Nykštukas;7592040226;Taip;7;16;0;23
10928;Vilnelė;Nykštukas;1515873552;Ne;12;0;0;12
10929;Vilnelė;Nykštukas;5629086127;Ne;7;2;0;9
10930;Vilnelė;Pieštukas;9882766915;Ne;11;0;0;11
10931;Vilnelė;Pieštukas;5444967820;Ne;10;0;0;10
10932;Vilnelė;Pieštukas;3828623778;Ne;10;0;0;10
10933;Vilnelė;Pieštukas;7698638698;Ne;2;0;0;2
10934;Vilnelė;Pieštukas;3064118212;Ne;11;0;0;11
10935;Vilnelė;Pieštukas;7231998656;Taip;4;0;0;4
10936;Vilnelė;Pieštukas;2343750614;Ne;7;0;0;7
10937;Vilnelė;Pieštukas;4670933970;Ne;5;0;0;5
10938;Vilnelė;Pieštukas;9317041585;Ne;7;0;0;7
10939;Vilnelė;Pieštukas;2683662906;Ne;4;0;0;4
10940;Vilnelė;Pieštukas;4982137749;Taip;10;1;0;11
10941;Vilnelė;Pieštukas;2700153185;Taip;2;0;0;2
10942;Vilnelė;Pieštukas;4817502971;Ne;5;0;0;5
10943;Vilnelė;Pieštukas;3712463891;Ne;5;0;0;5
10944;Vilnelė;Pieštukas;2576381995;Ne;6;0;0;6
10945;Vilnelė;Pieštukas;9476510950;Ne;4;0;0;4
10946;Vilnelė;Pieštukas;9316933315;Ne;2;0;0;2
10947;Vilnelė;Pieštukas;8848138564;Taip;7;2;0;9
10948;Vilnelė;Voverytė;2918624119;Ne;0;0;1;1
10949;Vilnelė;Voverytė;3432602015;Ne;3;2;0;5
10950;Vilnelė;Voverytė;9660305163;Ne;5;0;2;7
10951;Vilnelė;Voverytė;9950598582;Taip;25;2;0;27
10952;Vilnelė;Voverytė;7968029402;Ne;0;2;0;2
10953;Vilnelė;Voverytė;7221712624;Ne;0;2;0;2
10954;Vilnelė;Voverytė;2964672357;Ne;6;2;1;9
10955;Vilnelė;Voverytė;5273665901;Taip;2;3;0;5
10956;Vilnelė;Voverytė;1566734465;Ne;3;0;0;3
10957;Vilnelė;Voverytė;1371066506;Ne;0;11;0;11
10958;Vilnelė;Voverytė;3654833067;Ne;0;2;1;3
10959;Vilnelė;Voverytė;4322462166;Ne;0;2;1;3
10960;Vilnelė;Voverytė;5649725693;Ne;4;2;0;6
10961;Vilnelė;Voverytė;3234028667;Ne;0;3;0;3
10962;Vilnelė;Voverytė;7870509810;Taip;5;0;1;6
10963;Vilnelė;Voverytė;6569980514;Ne;12;6;0;18
10964;Vilnelė;Voverytė;4758117005;Taip;12;1;0;13
10965;Vilnelė;Voverytė;6634526716;Taip;4;10;0;14
10966;Vilnelė;Voverytė;1598555488;Ne;0;4;0;4
10967;Vilnelė;Voverytė;5960725916;Ne;12;11;0;23
10968;Vilnelė;Voverytė;7568755715;Ne;10;3;5;18
10969;Vilnelė;Kodėlčiukas;4642378600;Ne;0;1;0;1
10970;Vilnelė;Kodėlčiukas;6618109352;Ne;0;21;0;21
10971;Vilnelė;Kodėlčiukas;6715997340;Ne;1;2;0;3
10972;Vilnelė;Kodėlčiukas;9482133396;Ne;0;0;1;1
10973;Vilnelė;Kodėlčiukas;8620789304;Ne;7;0;0;7
10974;Vilnelė;Kodėlčiukas;8439505238;Ne;0;2;0;2
10975;Vilnelė;Kodėlčiukas;1580287517;Ne;4;5;0;9
10976;Vilnelė;Kodėlčiukas;5558378376;Taip;25;0;0;25
10977;Vilnelė;Kodėlčiukas;3056845279;Ne;0;9;0;9
10978;Vilnelė;Kodėlčiukas;9640330864;Ne;13;1;0;14
10979;Vilnelė;Kodėlčiukas;7833531435;Ne;0;3;0;3
10980;Vilnelė;Kodėlčiukas;5961910077;Ne;5;0;0;5
10981;Vilnelė;Kodėlčiukas;8543995029;Taip;0;13;0;13
10982;Vilnelė;Kodėlčiukas;1933660272;Ne;5;0;0;5
10983;Vilnelė;Kodėlčiukas;5398303580;Ne;1;0;1;2
10984;Vilnelė;Kodėlčiukas;5180951251;Ne;8;3;2;13
10985;Vilnelė;Žirniukas;9817054571;Ne;5;1;0;6
10986;Vilnelė;Žirniukas;8329253118;Ne;9;0;0;9
10987;Vilnelė;Žirniukas;9476348226;Ne;1;2;0;3
10988;Vilnelė;Žirniukas;9253975757;Ne;3;0;0;3
10989;Vilnelė;Žirniukas;9432188739;Ne;4;0;0;4
10990;Vilnelė;Žirniukas;8216383228;Ne;0;2;0;2
10991;Vilnelė;Žirniukas;2146981715;Ne;6;0;0;6
10992;Vilnelė;Žirniukas;1465849135;Taip;13;0;0;13
10993;Vilnelė;Žirniukas;9090894054;Ne;8;0;0;8
10994;Vilnelė;Žirniukas;2188575653;Ne;13;0;0;13
10995;Vilnelė;Žirniukas;2234709212;Ne;3;0;0;3
10996;Vilnelė;Žirniukas;1912897383;Ne;5;0;0;5
10997;Vilnelė;Žirniukas;4789175532;Ne;4;0;0;4
10998;Vilnelė;Pipiras;1977362135;Ne;11;0;0;11
10999;Vilnelė;Pipiras;6883775268;Ne;3;0;0;3
11000;Vilnelė;Pipiras;1336126156;Ne;4;0;0;4
11001;Vilnelė;Pipiras;8061099641;Ne;0;2;0;2
11002;Vilnelė;Pipiras;1631249610;Ne;5;0;0;5
11003;Vilnelė;Pipiras;9300237246;Ne;10;0;0;10
11004;Vilnelė;Pipiras;7090044022;Ne;3;0;0;3
11005;Vilnelė;Pipiras;6707024855;Ne;0;1;0;1
11006;Vilnelė;Pipiras;9016135318;Taip;1;2;0;3
11007;Vilnelė;Pipiras;8015908754;Ne;6;3;0;9
11008;Vėrinėlis;GAIDELIAI;6162461750;Ne;2;0;0;2
11009;Vėrinėlis;GAIDELIAI;1944358526;Ne;11;0;0;11
11010;Vėrinėlis;GAIDELIAI;3500287869;Ne;14;0;0;14
11011;Vėrinėlis;GAIDELIAI;6500266853;Ne;1;0;0;1
11012;Vėrinėlis;GAIDELIAI;5891690000;Ne;1;0;0;1
11013;Vėrinėlis;GAIDELIAI;4401001009;Ne;7;4;0;11
11014;Vėrinėlis;GAIDELIAI;1685329004;Ne;9;0;0;9
11015;Vėrinėlis;GAIDELIAI;4498096701;Ne;10;0;0;10
11016;Vėrinėlis;GAIDELIAI;9144004655;Ne;7;0;0;7
11017;Vėrinėlis;GAIDELIAI;8272531606;Ne;2;0;0;2
11018;Vėrinėlis;GAIDELIAI;2114637828;Ne;0;10;0;10
11019;Vėrinėlis;GAIDELIAI;7455948332;Ne;10;1;0;11
11020;Vėrinėlis;GAIDELIAI;4965735537;Ne;7;0;0;7
11021;Vėrinėlis;GAIDELIAI;1014076118;Taip;5;0;0;5
11022;Vėrinėlis;GAIDELIAI;2273903945;Ne;4;0;1;5
11023;Vėrinėlis;GAIDELIAI;8817186115;Ne;0;4;0;4
11024;Vėrinėlis;GAIDELIAI;8050158529;Ne;3;0;0;3
11025;Vėrinėlis;GAIDELIAI;6159725406;Ne;0;0;2;2
11026;Vėrinėlis;SAULUTĖ;7224418233;Ne;10;0;0;10
11027;Vėrinėlis;SAULUTĖ;7471147288;Ne;0;0;1;1
11028;Vėrinėlis;SAULUTĖ;8238013636;Ne;5;0;2;7
11029;Vėrinėlis;SAULUTĖ;2337883071;Ne;0;0;6;6
11030;Vėrinėlis;SAULUTĖ;6913001318;Ne;0;3;0;3
11031;Vėrinėlis;SAULUTĖ;7440020169;Ne;0;7;0;7
11032;Vėrinėlis;SAULUTĖ;7913975075;Ne;0;11;0;11
11033;Vėrinėlis;SAULUTĖ;9967737864;Ne;0;14;0;14
11034;Vėrinėlis;SAULUTĖ;9009344779;Ne;0;7;0;7
11035;Vėrinėlis;SAULUTĖ;4059906525;Ne;3;0;0;3
11036;Vėrinėlis;SAULUTĖ;3832662507;Ne;0;0;8;8
11037;Vėrinėlis;SAULUTĖ;1007705906;Ne;5;6;0;11
11038;Vėrinėlis;SAULUTĖ;5942475043;Ne;0;10;0;10
11039;Vėrinėlis;SAULUTĖ;9310629340;Ne;0;0;1;1
11040;Vėrinėlis;SAULUTĖ;2369434537;Ne;0;1;0;1
11041;Vėrinėlis;SAULUTĖ;3130841241;Ne;0;0;1;1
11042;Vėrinėlis;NYKŠTUKAI;5488087105;Ne;5;1;0;6
11043;Vėrinėlis;NYKŠTUKAI;5859566909;Ne;0;0;4;4
11044;Vėrinėlis;NYKŠTUKAI;4423562494;Ne;2;0;1;3
11045;Vėrinėlis;NYKŠTUKAI;5167825818;Ne;2;0;0;2
11046;Vėrinėlis;NYKŠTUKAI;2646575761;Ne;5;0;0;5
11047;Vėrinėlis;NYKŠTUKAI;9300891973;Ne;0;0;6;6
11048;Vėrinėlis;NYKŠTUKAI;8980451743;Ne;5;0;1;6
11049;Vėrinėlis;NYKŠTUKAI;8397635057;Taip;0;11;2;13
11050;Vėrinėlis;NYKŠTUKAI;8423611087;Ne;7;0;0;7
11051;Vėrinėlis;NYKŠTUKAI;8294753714;Ne;14;0;0;14
11052;Vėrinėlis;NYKŠTUKAI;4841000338;Ne;3;0;3;6
11053;Vėrinėlis;NYKŠTUKAI;2403376619;Ne;0;0;1;1
11054;Vėrinėlis;NYKŠTUKAI;2384172198;Ne;0;0;5;5
11055;Vėrinėlis;NYKŠTUKAI;7958241295;Ne;6;0;0;6
11056;Vėrinėlis;BURATINAS;7093959212;Ne;0;2;0;2
11057;Vėrinėlis;BURATINAS;8100283579;Ne;3;2;0;5
11058;Vėrinėlis;BURATINAS;2774618380;Taip;8;0;1;9
11059;Vėrinėlis;BURATINAS;5429955166;Ne;0;9;0;9
11060;Vėrinėlis;BURATINAS;5429372946;Ne;2;0;0;2
11061;Vėrinėlis;BURATINAS;2467700639;Ne;16;1;0;17
11062;Vėrinėlis;BURATINAS;6136232912;Ne;10;1;0;11
11063;Vėrinėlis;BURATINAS;7092421890;Ne;0;5;0;5
11064;Vėrinėlis;BURATINAS;6058712578;Ne;0;5;0;5
11065;Vėrinėlis;BURATINAS;6413701823;Ne;3;0;1;4
11066;Vėrinėlis;BURATINAS;2364117224;Ne;0;2;0;2
11067;Vėrinėlis;BURATINAS;7287634205;Ne;5;0;0;5
11068;Vėrinėlis;BURATINAS;3898060925;Ne;11;0;2;13
11069;Vėrinėlis;BURATINAS;4676052255;Ne;4;5;0;9
11070;Vėrinėlis;BURATINAS;3882915774;Taip;6;0;2;8
11071;Vėrinėlis;BURATINAS;7167034587;Ne;5;0;1;6
11072;Vėrinėlis;BURATINAS;1919350623;Ne;11;0;1;12
11073;Vėrinėlis;BURATINAS;9612956692;Ne;6;2;0;8
11074;Vėrinėlis;BURATINAS;6310807762;Ne;1;0;0;1
11075;Vėrinėlis;GINTARĖLIAI;8372084728;Ne;0;9;0;9
11076;Vėrinėlis;GINTARĖLIAI;6054398276;Ne;8;0;0;8
11077;Vėrinėlis;GINTARĖLIAI;7432965615;Ne;8;0;0;8
11078;Vėrinėlis;GINTARĖLIAI;3457199716;Ne;2;2;0;4
11079;Vėrinėlis;GINTARĖLIAI;7743951577;Taip;13;0;1;14
11080;Vėrinėlis;GINTARĖLIAI;2006432327;Ne;5;1;0;6
11081;Vėrinėlis;GINTARĖLIAI;6785519869;Taip;11;5;0;16
11082;Vėrinėlis;GINTARĖLIAI;3363388500;Ne;15;4;0;19
11083;Vėrinėlis;GINTARĖLIAI;8545392429;Ne;5;0;0;5
11084;Vėrinėlis;GINTARĖLIAI;9171173116;Ne;6;2;0;8
11085;Vėrinėlis;GINTARĖLIAI;3192625484;Ne;8;0;0;8
11086;Vėrinėlis;GINTARĖLIAI;8343196405;Ne;11;2;0;13
11087;Vėrinėlis;GINTARĖLIAI;2284527544;Ne;1;0;0;1
11088;Vėrinėlis;GINTARĖLIAI;5644772729;Taip;0;1;0;1
11089;Vėrinėlis;GINTARĖLIAI;4034106321;Ne;3;0;0;3
11090;Vėrinėlis;GINTARĖLIAI;5654269153;Ne;10;0;1;11
11091;Vėrinėlis;GINTARĖLIAI;6226329879;Ne;10;0;1;11
11092;Vėrinėlis;GINTARĖLIAI;9370715798;Taip;6;1;0;7
11093;Vėrinėlis;GINTARĖLIAI;6055921178;Ne;8;2;0;10
11094;Vėrinėlis;RAMUNĖLĖS;5447760434;Ne;0;14;0;14
11095;Vėrinėlis;RAMUNĖLĖS;4123553749;Ne;7;2;0;9
11096;Vėrinėlis;RAMUNĖLĖS;9234123596;Ne;0;0;3;3
11097;Vėrinėlis;RAMUNĖLĖS;9257045102;Ne;1;0;0;1
11098;Vėrinėlis;RAMUNĖLĖS;5501075800;Ne;0;1;0;1
11099;Vėrinėlis;RAMUNĖLĖS;1699912818;Ne;1;0;0;1
11100;Vėrinėlis;RAMUNĖLĖS;7294499755;Taip;0;3;0;3
11101;Vėrinėlis;RAMUNĖLĖS;7544881486;Ne;0;1;0;1
11102;Vėrinėlis;RAMUNĖLĖS;1403519604;Ne;7;0;2;9
11103;Vėrinėlis;RAMUNĖLĖS;6240649255;Ne;7;0;2;9
11104;Vėrinėlis;RAMUNĖLĖS;2763569936;Ne;0;3;0;3
11105;Vėrinėlis;RAMUNĖLĖS;7349463495;Ne;0;3;0;3
11106;Vėrinėlis;RAMUNĖLĖS;9935098198;Ne;5;0;0;5
11107;Vėrinėlis;KODELČIUKŲ;5342916562;Ne;1;0;0;1
11108;Vėrinėlis;KODELČIUKŲ;6316271212;Ne;2;0;0;2
11109;Vėrinėlis;KODELČIUKŲ;9650883071;Ne;4;0;0;4
11110;Vėrinėlis;KODELČIUKŲ;9349874701;Ne;5;0;0;5
11111;Vėrinėlis;KODELČIUKŲ;9179544549;Ne;1;0;0;1
11112;Vėrinėlis;KODELČIUKŲ;3830101723;Ne;3;0;0;3
11113;Vėrinėlis;KODELČIUKŲ;2908247336;Ne;7;0;1;8
11114;Vėrinėlis;KODELČIUKŲ;8389805682;Taip;6;0;0;6
11115;Vėrinėlis;KODELČIUKŲ;3563156582;Ne;6;0;0;6
11116;Vėrinėlis;KODELČIUKŲ;1119458722;Ne;5;0;0;5
11117;Vėrinėlis;KODELČIUKŲ;8029977991;Ne;5;0;1;6
11118;Vėrinėlis;KODELČIUKŲ;8977670959;Ne;6;4;0;10
11119;Vėrinėlis;KODELČIUKŲ;7382201231;Ne;5;0;3;8
11120;Vėrinėlis;ŽIRNIUKAI;1769852084;Ne;4;0;1;5
11121;Vėrinėlis;ŽIRNIUKAI;4981127515;Ne;0;0;1;1
11122;Vėrinėlis;ŽIRNIUKAI;8329989952;Ne;0;0;1;1
11123;Vėrinėlis;ŽIRNIUKAI;3202518504;Ne;0;0;4;4
11124;Vėrinėlis;ŽIRNIUKAI;4752902173;Ne;4;0;1;5
11125;Vėrinėlis;ŽIRNIUKAI;7237945125;Ne;0;0;1;1
11126;Vėrinėlis;ŽIRNIUKAI;5600815908;Ne;0;0;1;1
11127;Vėrinėlis;ŽIRNIUKAI;1736733257;Ne;10;0;0;10
11128;Vėrinėlis;ŽIRNIUKAI;2633143128;Ne;1;0;0;1
11129;Vėrinėlis;ŽIRNIUKAI;9419245081;Ne;0;0;1;1
11130;Vėrinėlis;ŽIRNIUKAI;7817387800;Ne;0;0;1;1
11131;Vėrinėlis;ŽIRNIUKAI;6377447141;Ne;5;0;3;8
11132;Vėrinėlis;ŽIRNIUKAI;7371908331;Ne;0;0;8;8
11133;Vėrinėlis;ŽIRNIUKAI;2087129236;Ne;0;0;1;1
11134;Vėrinėlis;ŽIRNIUKAI;6392625405;Ne;4;9;0;13
11135;Vėrinėlis;ŽIRNIUKAI;1896980533;Ne;0;1;2;3
11136;Vėrinėlis;ŽIRNIUKAI;2732572235;Ne;5;0;5;10
11137;Vėrinėlis;ŽIRNIUKAI;8483525051;Ne;0;0;1;1
11138;Vėrinėlis;ŽIRNIUKAI;8397025332;Ne;0;0;1;1
11139;Vėrinėlis;ŽIRNIUKAI;6576726481;Ne;0;0;1;1
11140;Vėrinėlis;ŽIRNIUKAI;6220653152;Ne;0;3;0;3
11141;Vėrinėlis;VARPELIAI;8655158155;Ne;3;1;0;4
11142;Vėrinėlis;VARPELIAI;3829146401;Ne;0;1;0;1
11143;Vėrinėlis;VARPELIAI;6177784856;Ne;0;7;0;7
11144;Vėrinėlis;VARPELIAI;6362125404;Ne;10;1;0;11
11145;Vėrinėlis;VARPELIAI;7216867683;Ne;0;1;0;1
11146;Vėrinėlis;VARPELIAI;2731207996;Ne;2;0;3;5
11147;Vėrinėlis;VARPELIAI;2625930005;Ne;0;0;1;1
11148;Vėrinėlis;VARPELIAI;1026312967;Ne;0;2;1;3
11149;Vėrinėlis;VARPELIAI;2561255096;Ne;5;0;1;6
11150;Vėrinėlis;VARPELIAI;3392458614;Ne;0;1;0;1
11151;Vėrinėlis;VARPELIAI;5837383907;Ne;5;0;0;5
11152;Vėrinėlis;VARPELIAI;3953496894;Ne;1;0;0;1
11153;Vėrinėlis;VARPELIAI;4086695239;Ne;5;0;0;5
11154;Vėrinėlis;BORUŽĖLĖS;8759487574;Ne;0;5;0;5
11155;Vėrinėlis;BORUŽĖLĖS;1910385020;Ne;5;0;0;5
11156;Vėrinėlis;BORUŽĖLĖS;2078857084;Ne;4;0;0;4
11157;Vėrinėlis;BORUŽĖLĖS;3934652683;Ne;0;1;0;1
11158;Vėrinėlis;BORUŽĖLĖS;6904733283;Ne;0;2;3;5
11159;Vėrinėlis;BORUŽĖLĖS;4446546335;Ne;0;0;3;3
11160;Vėrinėlis;BORUŽĖLĖS;3718510933;Ne;0;1;0;1
11161;Vėrinėlis;BORUŽĖLĖS;2501287529;Ne;0;4;0;4
11162;Vėrinėlis;BORUŽĖLĖS;8904833339;Ne;0;6;0;6
11163;Vėrinėlis;BORUŽĖLĖS;3312501759;Ne;0;6;0;6
11164;Vėrinėlis;BORUŽĖLĖS;9217188911;Ne;6;7;0;13
11165;Vėrinėlis;BORUŽĖLĖS;7414937335;Ne;0;8;0;8
11166;Vėrinėlis;BORUŽĖLĖS;2574507205;Ne;2;0;0;2
11167;Vėrinėlis;BORUŽĖLĖS;6671382987;Ne;3;5;0;8
11168;Vėrinėlis;BORUŽĖLĖS;3200007674;Ne;0;1;0;1
11169;Vėrinėlis;BORUŽĖLĖS;4852563692;Ne;0;2;1;3
11170;Vėrinėlis;BORUŽĖLĖS;5865529907;Ne;11;0;0;11
11171;Vėrinėlis;BORUŽĖLĖS;9613642664;Ne;0;13;0;13
11172;Vėrinėlis;BORUŽĖLĖS;2467242845;Ne;0;6;0;6
11173;Vėrinėlis;BORUŽĖLĖS;4037594669;Ne;3;11;0;14
11174;Vėrinėlis;SVEIKUOLIAI;1909742394;Ne;3;1;0;4
11175;Vėrinėlis;SVEIKUOLIAI;6176308531;Ne;6;0;0;6
11176;Vėrinėlis;SVEIKUOLIAI;3070965434;Ne;0;1;1;2
11177;Vėrinėlis;SVEIKUOLIAI;6154618103;Ne;2;1;0;3
11178;Vėrinėlis;SVEIKUOLIAI;3563114419;Ne;0;1;1;2
11179;Vėrinėlis;SVEIKUOLIAI;3973272659;Ne;0;1;0;1
11180;Vėrinėlis;SVEIKUOLIAI;8032396191;Ne;0;8;0;8
11181;Vėrinėlis;SVEIKUOLIAI;8716965452;Ne;5;1;0;6
11182;Vėrinėlis;SVEIKUOLIAI;7584124339;Ne;10;0;3;13
11183;Vėrinėlis;SVEIKUOLIAI;4859330774;Ne;0;1;0;1
11184;Vėrinėlis;SVEIKUOLIAI;8543081245;Ne;0;1;0;1
11185;Vėrinėlis;SVEIKUOLIAI;1800434426;Ne;0;1;0;1
11186;Vėrinėlis;SVEIKUOLIAI;3958551159;Ne;0;7;0;7
11187;Vėrinėlis;SVEIKUOLIAI;5539714292;Taip;0;1;0;1
11188;Vėrinėlis;SVEIKUOLIAI;2516474825;Ne;9;0;1;10
11189;Vėrinėlis;SVEIKUOLIAI;9058127692;Ne;0;0;4;4
11190;Vėrinėlis;SVEIKUOLIAI;1278914183;Ne;15;0;0;15
11191;Vėrinėlis;SVEIKUOLIAI;7573209012;Ne;3;0;1;4
11192;Vėrinėlis;SVEIKUOLIAI;2015928440;Taip;0;1;0;1
11193;Vėrinėlis;ŠIRDELĖS;4378592116;Ne;0;0;7;7
11194;Vėrinėlis;ŠIRDELĖS;1841277321;Ne;0;2;0;2
11195;Vėrinėlis;ŠIRDELĖS;5588658517;Ne;0;5;0;5
11196;Vėrinėlis;ŠIRDELĖS;5653635907;Ne;0;7;0;7
11197;Vėrinėlis;ŠIRDELĖS;1152010178;Ne;8;0;3;11
11198;Vėrinėlis;ŠIRDELĖS;2038169885;Ne;0;11;0;11
11199;Vėrinėlis;ŠIRDELĖS;9375922889;Taip;0;12;0;12
11200;Vėrinėlis;ŠIRDELĖS;5813009126;Ne;0;9;0;9
11201;Vėrinėlis;ŠIRDELĖS;3511809411;Ne;0;6;0;6
11202;Vėrinėlis;ŠIRDELĖS;9217815657;Ne;0;6;0;6
11203;Vėrinėlis;ŠIRDELĖS;4403875733;Ne;4;0;5;9
11204;Vėrinėlis;ŠIRDELĖS;4700093328;Ne;7;0;0;7
11205;Vėrinėlis;ŠIRDELĖS;3687250255;Ne;0;0;1;1
11206;Vėrinėlis;ŠIRDELĖS;7361319518;Ne;0;0;3;3
11207;Vėrinėlis;ŠIRDELĖS;2847839917;Taip;0;13;0;13
11208;Vėrinėlis;ŠIRDELĖS;7311740859;Ne;0;1;0;1
11209;Vėrinėlis;ŠIRDELĖS;6905591549;Ne;0;10;0;10
11210;Viltenė;Drugeliai;3625763429;Ne;0;11;0;11
11211;Viltenė;Drugeliai;2392304909;Ne;0;7;0;7
11212;Viltenė;Drugeliai;5781655552;Ne;0;8;0;8
11213;Viltenė;Drugeliai;2410868015;Ne;0;19;0;19
11214;Viltenė;Drugeliai;4616047113;Ne;0;5;0;5
11215;Viltenė;Drugeliai;6810811656;Ne;0;1;0;1
11216;Viltenė;Drugeliai;3905014810;Ne;0;6;0;6
11217;Viltenė;Drugeliai;9157616307;Ne;5;0;0;5
11218;Viltenė;Drugeliai;5522245968;Ne;1;1;0;2
11219;Viltenė;Drugeliai;7401460248;Ne;0;1;0;1
11220;Viltenė;Drugeliai;9820462941;Ne;0;1;0;1
11221;Viltenė;Drugeliai;5552217000;Taip;0;2;0;2
11222;Viltenė;Drugeliai;9756519374;Ne;0;1;0;1
11223;Viltenė;Drugeliai;7928894276;Ne;0;4;0;4
11224;Viltenė;Drugeliai;4195708756;Ne;6;2;0;8
11225;Viltenė;Drugeliai;1081603034;Ne;20;0;0;20
11226;Viltenė;Drugeliai;7500965165;Ne;0;2;0;2
11227;Viltenė;Bitučių;7717223673;Ne;5;0;0;5
11228;Viltenė;Bitučių;4001205912;Ne;7;2;0;9
11229;Viltenė;Bitučių;5077874991;Ne;6;3;0;9
11230;Viltenė;Bitučių;7266522399;Ne;11;0;0;11
11231;Viltenė;Bitučių;5241075224;Taip;1;1;0;2
11232;Viltenė;Bitučių;1765335359;Ne;2;1;0;3
11233;Viltenė;Bitučių;8681961430;Ne;11;0;0;11
11234;Viltenė;Bitučių;9805422851;Ne;0;1;0;1
11235;Viltenė;Boružėlių;9572407405;Ne;0;1;0;1
11236;Viltenė;Boružėlių;8473588098;Ne;5;5;0;10
11237;Viltenė;Boružėlių;3995418079;Ne;5;1;0;6
11238;Viltenė;Boružėlių;1936628249;Ne;0;3;0;3
11239;Viltenė;Boružėlių;7912396297;Ne;0;4;0;4
11240;Viltenė;Boružėlių;4036109404;Ne;3;6;0;9
11241;Viltenė;Boružėlių;4604298036;Ne;5;3;0;8
11242;Viltenė;Boružėlių;9242034622;Ne;0;5;0;5
11243;Viltenė;Boružėlių;6621273812;Ne;0;1;0;1
11244;Viltenė;Boružėlių;1496943250;Ne;0;6;0;6
11245;Viltenė;Boružėlių;8527270437;Ne;0;6;0;6
11246;Viltenė;Boružėlių;3052677157;Ne;0;2;0;2
11247;Viltenė;Gandriukų;6481491422;Ne;0;0;3;3
11248;Viltenė;Gandriukų;1126409020;Ne;0;0;1;1
11249;Viltenė;Gandriukų;2884698447;Ne;3;0;0;3
11250;Viltenė;Gandriukų;6060648988;Ne;0;1;0;1
11251;Viltenė;Gandriukų;1840626621;Ne;9;1;0;10
11252;Viltenė;Gandriukų;8549631247;Ne;2;0;0;2
11253;Viltenė;Gandriukų;2815105107;Ne;0;1;0;1
11254;Viltenė;Gandriukų;6511850468;Ne;0;1;0;1
11255;Viltenė;Gandriukų;4945108189;Ne;0;4;0;4
11256;Viltenė;Gandriukų;5850652322;Ne;0;1;0;1
11257;Viltenė;Gandriukų;8110413064;Ne;0;1;0;1
11258;Viltenė;Gandriukų;1243595112;Ne;0;1;0;1
11259;Viltenė;Gandriukų;3073228245;Ne;0;0;6;6
11260;Viltenė;Gandriukų;4468743044;Ne;9;0;0;9
11261;Viltenė;Gandriukų;6355857716;Ne;2;0;3;5
11262;Viltenė;Gandriukų;5929135840;Ne;1;0;1;2
11263;Viltenė;Gandriukų;6473925760;Ne;1;1;0;2
11264;Viltenė;Aitvariukai;5083515613;Ne;5;2;0;7
11265;Viltenė;Aitvariukai;2137929911;Ne;0;3;0;3
11266;Viltenė;Aitvariukai;9185054066;Ne;4;5;0;9
11267;Viltenė;Aitvariukai;2036902795;Ne;0;2;0;2
11268;Viltenė;Aitvariukai;5599943846;Ne;4;3;0;7
11269;Viltenė;Aitvariukai;6721689684;Ne;0;1;0;1
11270;Viltenė;Aitvariukai;6296509460;Ne;0;4;0;4
11271;Viltenė;Aitvariukai;9101795131;Ne;3;6;0;9
11272;Viltenė;Aitvariukai;3908574248;Ne;4;1;0;5
11273;Viltenė;Aitvariukai;8439859449;Ne;12;1;0;13
11274;Viltenė;Aitvariukai;2976705872;Ne;7;0;0;7
11275;Viltenė;Aitvariukai;2192086488;Ne;2;1;0;3
11276;Viltenė;Aitvariukai;2026654467;Ne;5;1;0;6
11277;Viltenė;Aitvariukai;4641365031;Taip;10;1;0;11
11278;Viltenė;Aitvariukai;7277455268;Ne;0;8;0;8
11279;Viltenė;Aitvariukai;3245284852;Ne;4;1;0;5
11280;Viltenė;Aitvariukai;2786572522;Ne;2;3;0;5
11281;Viltenė;Aitvariukai;6171399579;Ne;7;3;0;10
11282;Viltenė;Aitvariukai;3839680327;Taip;0;2;0;2
11283;Viltenė;Geniukų;3157417614;Ne;0;5;0;5
11284;Viltenė;Geniukų;2903596382;Ne;2;0;0;2
11285;Viltenė;Geniukų;9819729046;Ne;0;1;0;1
11286;Viltenė;Geniukų;1318750938;Ne;0;3;0;3
11287;Viltenė;Geniukų;6379567497;Ne;1;1;0;2
11288;Viltenė;Geniukų;7145240197;Ne;6;2;0;8
11289;Viltenė;Geniukų;7058586628;Ne;0;3;0;3
11290;Viltenė;Geniukų;4552355700;Ne;0;5;0;5
11291;Viltenė;Geniukų;1587868835;Ne;1;2;0;3
11292;Viltenė;Geniukų;2850146424;Ne;0;1;0;1
11293;Viltenė;Geniukų;3306285115;Ne;0;2;0;2
11294;Viltenė;Geniukų;9288406881;Ne;3;0;0;3
11295;Viltenė;Geniukų;6992120038;Ne;5;2;0;7
11296;Viltenė;Geniukų;4981225829;Ne;6;3;0;9
11297;Viltenė;Geniukų;3853518656;Ne;0;1;0;1
11298;Viltenė;Geniukų;9582577013;Ne;8;11;0;19
11299;Viltenė;Geniukų;2036857372;Ne;1;1;0;2
11300;Viltenė;Geniukų;3343045604;Ne;0;1;0;1
11301;Viltenė;Geniukų;9424773418;Ne;8;0;0;8
11302;Viltenė;Saulutės;8091905944;Ne;0;5;0;5
11303;Viltenė;Saulutės;5974408492;Ne;2;0;0;2
11304;Viltenė;Saulutės;2192673126;Ne;0;0;3;3
11305;Viltenė;Saulutės;1641406030;Taip;0;0;2;2
11306;Viltenė;Saulutės;4615393852;Ne;0;1;0;1
11307;Viltenė;Saulutės;9578037239;Ne;7;0;0;7
11308;Viltenė;Saulutės;1760899500;Ne;0;1;1;2
11309;Viltenė;Saulutės;3347380524;Ne;0;7;1;8
11310;Viltenė;Saulutės;2846574130;Ne;14;6;0;20
11311;Viltenė;Saulutės;2656363650;Ne;0;0;1;1
11312;Viltenė;Saulutės;4724382069;Ne;5;0;1;6
11313;Viltenė;Saulutės;2841144656;Ne;7;0;0;7
11314;Viltenė;Saulutės;4379784712;Ne;0;10;0;10
11315;Viltenė;Saulutės;7810374329;Taip;0;11;0;11
11316;Viltenė;Saulutės;9095458948;Ne;13;0;0;13
11317;Viltenė;Saulutės;4661430937;Ne;0;1;1;2
11318;Viltenė;Saulutės;8346933997;Ne;0;11;0;11
11319;Viltenė;Saulutės;8258247750;Ne;3;5;0;8
11320;Viltenė;Saulutės;6595715908;Ne;8;0;1;9
11321;Viltenė;Lapiukų;2034259692;Ne;5;6;0;11
11322;Viltenė;Lapiukų;3473533533;Ne;0;4;0;4
11323;Viltenė;Lapiukų;8248514570;Ne;1;1;0;2
11324;Viltenė;Lapiukų;2878124826;Taip;5;0;0;5
11325;Viltenė;Lapiukų;2660622296;Ne;1;2;0;3
11326;Viltenė;Lapiukų;8122878153;Ne;0;1;0;1
11327;Viltenė;Lapiukų;9573891616;Ne;0;19;0;19
11328;Viltenė;Lapiukų;6429905246;Ne;3;1;0;4
11329;Viltenė;Lapiukų;6070264006;Ne;0;5;0;5
11330;Viltenė;Lapiukų;8187712849;Ne;2;1;0;3
11331;Viltenė;Lapiukų;3679704404;Ne;0;7;0;7
11332;Viltenė;Lapiukų;1507287948;Taip;1;1;0;2
11333;Viltenė;Lapiukų;9846205631;Ne;9;0;0;9
11334;Viltenė;Lapiukų;9063994291;Ne;0;10;0;10
11335;Viltenė;Lapiukų;1964849653;Ne;17;1;0;18
11336;Viltenė;Voveriukai;6888346135;Ne;0;12;0;12
11337;Viltenė;Voveriukai;2936670828;Ne;1;1;0;2
11338;Viltenė;Voveriukai;5816623708;Ne;0;18;3;21
11339;Viltenė;Voveriukai;5611839058;Ne;8;0;0;8
11340;Viltenė;Voveriukai;4414192600;Ne;6;1;0;7
11341;Viltenė;Voveriukai;2483760198;Ne;6;0;0;6
11342;Viltenė;Voveriukai;8341211836;Ne;6;0;0;6
11343;Viltenė;Voveriukai;6954065006;Ne;6;0;0;6
11344;Viltenė;Voveriukai;6741521720;Ne;6;7;0;13
11345;Viltenė;Voveriukai;2642080849;Ne;10;0;0;10
11346;Viltenė;Voveriukai;6040634853;Ne;2;0;0;2
11347;Viltenė;Voveriukai;7322841332;Ne;7;9;0;16
11348;Viltenė;Voveriukai;1888167096;Ne;0;3;0;3
11349;Viltenė;Voveriukai;3291926243;Ne;0;8;0;8
11350;Viltenė;Voveriukai;2013415571;Ne;5;0;0;5
11351;Viltenė;Voveriukai;2894570917;Taip;5;0;0;5
11352;Viltenė;Voveriukai;1890096287;Ne;6;1;0;7
11353;Viltenė;Kiškučiai;7314937470;Ne;6;1;0;7
11354;Viltenė;Kiškučiai;8150583354;Ne;3;0;0;3
11355;Viltenė;Kiškučiai;9862698928;Ne;3;0;0;3
11356;Viltenė;Kiškučiai;7273826810;Ne;10;0;0;10
11357;Viltenė;Kiškučiai;4970273010;Ne;10;0;0;10
11358;Viltenė;Kiškučiai;6971198297;Ne;2;0;0;2
11359;Viltenė;Kiškučiai;3719039209;Ne;3;0;0;3
11360;Viltenė;Kiškučiai;2413392645;Ne;1;0;0;1
11361;Viltenė;Nykštukų;9263941853;Ne;6;1;0;7
11362;Viltenė;Nykštukų;9308502487;Ne;10;0;0;10
11363;Viltenė;Nykštukų;7957033437;Ne;0;6;0;6
11364;Viltenė;Nykštukų;4692894136;Ne;4;0;2;6
11365;Viltenė;Nykštukų;2675172000;Ne;0;4;0;4
11366;Viltenė;Nykštukų;7950534618;Ne;0;3;0;3
11367;Viltenė;Nykštukų;7281994705;Taip;1;0;0;1
11368;Viltenė;Nykštukų;9962055404;Ne;2;0;0;2
11369;Viltenė;Triušiukai;7754951374;Ne;5;2;0;7
11370;Viltenė;Triušiukai;2720563160;Ne;0;5;0;5
11371;Viltenė;Triušiukai;9211978362;Ne;3;2;0;5
11372;Viltenė;Triušiukai;3007260551;Ne;0;2;0;2
11373;Viltenė;Triušiukai;7809538482;Ne;7;0;0;7
11374;Viltenė;Triušiukai;1324341385;Taip;2;0;0;2
11375;Viltenė;Triušiukai;5083086443;Ne;0;1;0;1
11376;Viltenė;Triušiukai;9163535422;Ne;2;0;0;2
11377;Viltenė;Triušiukai;8517635316;Ne;2;3;0;5
11378;Voveraitė;ŽVIRBLIUKŲ;6684234832;Ne;0;0;9;9
11379;Voveraitė;ŽVIRBLIUKŲ;8119493388;Ne;0;0;4;4
11380;Voveraitė;ŽVIRBLIUKŲ;5510544648;Ne;7;0;0;7
11381;Voveraitė;ŽVIRBLIUKŲ;6959751328;Ne;0;0;3;3
11382;Voveraitė;ŽVIRBLIUKŲ;8803052781;Ne;0;0;1;1
11383;Voveraitė;ŽVIRBLIUKŲ;1522307865;Ne;0;0;2;2
11384;Voveraitė;ŽVIRBLIUKŲ;3811230983;Taip;4;0;11;15
11385;Voveraitė;ŽVIRBLIUKŲ;2142507659;Ne;0;0;13;13
11386;Voveraitė;ŽVIRBLIUKŲ;5395915359;Ne;0;0;1;1
11387;Voveraitė;ŽVIRBLIUKŲ;3247101840;Ne;0;0;4;4
11388;Voveraitė;ŽVIRBLIUKŲ;6643600680;Taip;0;0;15;15
11389;Voveraitė;ŽVIRBLIUKŲ;4460047281;Ne;0;0;1;1
11390;Voveraitė;KIŠKUČIŲ;9537862791;Ne;12;1;0;13
11391;Voveraitė;KIŠKUČIŲ;4478984171;Ne;0;1;0;1
11392;Voveraitė;KIŠKUČIŲ;9011096222;Ne;3;2;0;5
11393;Voveraitė;KIŠKUČIŲ;8746008166;Ne;0;1;0;1
11394;Voveraitė;KIŠKUČIŲ;8084986328;Ne;4;2;0;6
11395;Voveraitė;KIŠKUČIŲ;6261152304;Ne;0;3;0;3
11396;Voveraitė;KIŠKUČIŲ;8220437514;Ne;0;1;0;1
11397;Voveraitė;KIŠKUČIŲ;4060906360;Ne;0;1;0;1
11398;Voveraitė;KIŠKUČIŲ;5069929376;Ne;5;0;0;5
11399;Voveraitė;KIŠKUČIŲ;7379045686;Ne;0;2;0;2
11400;Voveraitė;KIŠKUČIŲ;1961699588;Ne;3;0;0;3
11401;Voveraitė;KIŠKUČIŲ;8121423914;Ne;0;1;0;1
11402;Voveraitė;KIŠKUČIŲ;8937070276;Ne;5;0;0;5
11403;Voveraitė;KIŠKUČIŲ;3859125174;Taip;15;2;0;17
11404;Voveraitė;KODĖLČIUKŲ;7868415893;Ne;0;1;0;1
11405;Voveraitė;KODĖLČIUKŲ;8438808999;Ne;0;1;1;2
11406;Voveraitė;KODĖLČIUKŲ;8818603905;Ne;6;10;0;16
11407;Voveraitė;KODĖLČIUKŲ;9397887760;Ne;0;6;4;10
11408;Voveraitė;KODĖLČIUKŲ;4151144278;Ne;4;1;0;5
11409;Voveraitė;KODĖLČIUKŲ;5598685365;Ne;0;1;0;1
11410;Voveraitė;KODĖLČIUKŲ;1482908802;Ne;0;5;0;5
11411;Voveraitė;KODĖLČIUKŲ;9887747925;Ne;0;6;0;6
11412;Voveraitė;KODĖLČIUKŲ;7605427741;Ne;0;3;0;3
11413;Voveraitė;KODĖLČIUKŲ;3432886020;Ne;11;2;0;13
11414;Voveraitė;KODĖLČIUKŲ;2482908027;Ne;0;9;0;9
11415;Voveraitė;KODĖLČIUKŲ;8692155848;Ne;0;1;4;5
11416;Voveraitė;KODĖLČIUKŲ;1040007977;Ne;0;6;0;6
11417;Voveraitė;KODĖLČIUKŲ;3881039538;Ne;0;2;0;2
11418;Voveraitė;KODĖLČIUKŲ;7281753415;Ne;0;2;0;2
11419;Voveraitė;KODĖLČIUKŲ;8021563060;Ne;0;1;2;3
11420;Voveraitė;KODĖLČIUKŲ;9816971493;Ne;0;1;1;2
11421;Voveraitė;MEŠKIUKŲ;8881070477;Ne;0;6;0;6
11422;Voveraitė;MEŠKIUKŲ;7253112849;Ne;0;7;0;7
11423;Voveraitė;MEŠKIUKŲ;3217609712;Ne;0;8;0;8
11424;Voveraitė;MEŠKIUKŲ;3088866739;Ne;0;1;0;1
11425;Voveraitė;MEŠKIUKŲ;7474214701;Ne;0;5;0;5
11426;Voveraitė;MEŠKIUKŲ;3539069705;Ne;0;3;0;3
11427;Voveraitė;MEŠKIUKŲ;9544043839;Ne;0;2;0;2
11428;Voveraitė;MEŠKIUKŲ;6609235703;Taip;0;1;0;1
11429;Voveraitė;MEŠKIUKŲ;1528968162;Taip;0;12;0;12
11430;Voveraitė;MEŠKIUKŲ;3159659638;Ne;6;0;0;6
11431;Voveraitė;MEŠKIUKŲ;3532178114;Ne;6;0;0;6
11432;Voveraitė;MEŠKIUKŲ;5196036817;Ne;0;1;0;1
11433;Voveraitė;MEŠKIUKŲ;8534405352;Ne;6;2;0;8
11434;Voveraitė;MEŠKIUKŲ;5018335921;Taip;8;6;0;14
11435;Voveraitė;DRUGELIŲ;7531020548;Ne;3;0;0;3
11436;Voveraitė;DRUGELIŲ;4300235743;Ne;1;0;0;1
11437;Voveraitė;DRUGELIŲ;3475601049;Ne;1;2;0;3
11438;Voveraitė;DRUGELIŲ;4017408873;Ne;6;0;0;6
11439;Voveraitė;DRUGELIŲ;7533728486;Ne;3;0;0;3
11440;Voveraitė;DRUGELIŲ;1550830434;Ne;5;0;0;5
11441;Voveraitė;DRUGELIŲ;5114768009;Ne;4;1;0;5
11442;Voveraitė;DRUGELIŲ;4605007814;Ne;1;0;0;1
11443;Voveraitė;DRUGELIŲ;4911291891;Ne;6;0;0;6
11444;Voveraitė;DRUGELIŲ;4782336282;Ne;0;2;0;2
11445;Voveraitė;DRUGELIŲ;4350450125;Ne;0;6;0;6
11446;Voveraitė;DRUGELIŲ;1201270622;Ne;4;0;0;4
11447;Voveraitė;DRUGELIŲ;7238482039;Taip;0;1;0;1
11448;Voveraitė;NYKŠTUKŲ;8206634977;Ne;0;2;0;2
11449;Voveraitė;NYKŠTUKŲ;3068683904;Taip;3;5;7;15
11450;Voveraitė;NYKŠTUKŲ;3600230896;Ne;1;0;0;1
11451;Voveraitė;NYKŠTUKŲ;1294012085;Ne;0;7;0;7
11452;Voveraitė;NYKŠTUKŲ;9363490578;Ne;0;3;0;3
11453;Voveraitė;NYKŠTUKŲ;8217771158;Ne;0;7;0;7
11454;Voveraitė;NYKŠTUKŲ;3409709168;Ne;0;2;1;3
11455;Voveraitė;NYKŠTUKŲ;1045121363;Taip;0;9;0;9
11456;Voveraitė;NYKŠTUKŲ;4319786615;Ne;0;2;0;2
11457;Voveraitė;NYKŠTUKŲ;1384430452;Ne;4;0;2;6
11458;Voveraitė;LAPIUKŲ;8405238812;Ne;5;0;0;5
11459;Voveraitė;LAPIUKŲ;8152541593;Ne;0;0;13;13
11460;Voveraitė;LAPIUKŲ;9327593792;Ne;4;0;12;16
11461;Voveraitė;LAPIUKŲ;4139239328;Ne;12;0;4;16
11462;Voveraitė;EŽIUKŲ;5420123208;Ne;0;1;0;1
11463;Voveraitė;EŽIUKŲ;1692829228;Ne;6;0;2;8
11464;Voveraitė;EŽIUKŲ;8074808131;Ne;0;10;0;10
11465;Voveraitė;EŽIUKŲ;8229145014;Ne;0;0;1;1
11466;Voveraitė;EŽIUKŲ;2755043670;Ne;11;1;0;12
11467;"Trakų Vokė";Voveriukų;1252962923;Ne;4;0;1;5
11468;"Trakų Vokė";Voveriukų;2163756512;Ne;4;0;0;4
11469;"Trakų Vokė";Voveriukų;2318712376;Ne;3;0;0;3
11470;"Trakų Vokė";Voveriukų;9140597911;Ne;13;0;0;13
11471;"Trakų Vokė";Voveriukų;5741852704;Ne;9;0;0;9
11472;"Trakų Vokė";Voveriukų;8636196544;Ne;2;0;0;2
11473;"Trakų Vokė";Voveriukų;4516714702;Ne;9;0;0;9
11474;"Trakų Vokė";Voveriukų;3445611475;Ne;3;0;0;3
11475;"Trakų Vokė";Voveriukų;3422308444;Ne;6;0;1;7
11476;"Trakų Vokė";Voveriukų;6076083379;Taip;0;2;0;2
11477;"Trakų Vokė";Voveriukų;5626732539;Ne;0;3;0;3
11478;"Trakų Vokė";Voveriukų;7706665420;Ne;5;0;1;6
11479;"Trakų Vokė";Voveriukų;7656305410;Ne;4;6;0;10
11480;"Trakų Vokė";Voveriukų;7346128036;Ne;6;0;0;6
11481;"Trakų Vokė";Voveriukų;2812442474;Ne;8;0;0;8
11482;"Trakų Vokė";Voveriukų;7671121106;Ne;7;0;3;10
11483;"Trakų Vokė";Voveriukų;7797516793;Ne;2;0;0;2
11484;"Trakų Vokė";Voveriukų;2077669020;Ne;4;8;0;12
11485;"Trakų Vokė";Voveriukų;8938061997;Ne;5;0;2;7
11486;"Trakų Vokė";Voveriukų;1946140073;Ne;9;0;1;10
11487;"Trakų Vokė";Voveriukų;6494156059;Ne;0;2;0;2
11488;"Trakų Vokė";Voveriukų;6247495021;Ne;7;1;0;8
11489;"Trakų Vokė";Voveriukų;3471649998;Ne;11;0;0;11
11490;"Trakų Vokė";Boružėlių;6550998156;Ne;12;0;0;12
11491;"Trakų Vokė";Boružėlių;7705116536;Ne;0;0;1;1
11492;"Trakų Vokė";Boružėlių;4621824988;Taip;5;0;0;5
11493;"Trakų Vokė";Boružėlių;7122970239;Ne;0;0;1;1
11494;"Trakų Vokė";Boružėlių;2287132096;Ne;0;0;1;1
11495;"Trakų Vokė";Boružėlių;3930137078;Ne;0;3;0;3
11496;"Trakų Vokė";Boružėlių;1515075178;Ne;0;3;0;3
11497;"Trakų Vokė";Boružėlių;7778039165;Ne;4;0;0;4
11498;"Trakų Vokė";Boružėlių;7042434004;Ne;5;0;0;5
11499;"Trakų Vokė";KIŠKUČIŲ;2348524235;Ne;9;0;0;9
11500;"Trakų Vokė";KIŠKUČIŲ;8148859043;Ne;6;0;0;6
11501;"Trakų Vokė";KIŠKUČIŲ;9375730686;Ne;5;0;0;5
11502;"Trakų Vokė";KIŠKUČIŲ;2327739950;Taip;2;0;0;2
11503;"Trakų Vokė";KIŠKUČIŲ;1436135794;Ne;4;0;0;4
11504;"Trakų Vokė";KIŠKUČIŲ;3233117814;Ne;1;0;0;1
11505;"Trakų Vokė";KIŠKUČIŲ;3146611814;Ne;2;0;0;2
11506;"Trakų Vokė";KIŠKUČIŲ;8601290001;Ne;7;0;0;7
11507;"Trakų Vokė";KIŠKUČIŲ;8861279937;Ne;3;0;0;3
11508;"Trakų Vokė";KIŠKUČIŲ;8747275362;Ne;1;0;0;1
11509;"Trakų Vokė";KIŠKUČIŲ;7799307934;Ne;3;0;0;3
11510;"Trakų Vokė";BITUČIŲ;7632198751;Ne;1;0;0;1
11511;"Trakų Vokė";BITUČIŲ;3686108421;Ne;10;0;0;10
11512;"Trakų Vokė";BITUČIŲ;5031669549;Ne;9;0;0;9
11513;"Trakų Vokė";BITUČIŲ;8703806519;Ne;16;0;0;16
11514;"Trakų Vokė";BITUČIŲ;4531294784;Taip;7;0;0;7
11515;"Trakų Vokė";BITUČIŲ;5720994041;Ne;13;0;0;13
11516;"Trakų Vokė";BITUČIŲ;7459132887;Taip;2;1;0;3
11517;"Trakų Vokė";BITUČIŲ;6402002961;Ne;9;0;0;9
11518;"Trakų Vokė";BITUČIŲ;3536227018;Taip;6;0;0;6
11519;"Trakų Vokė";BITUČIŲ;6787506848;Ne;10;3;0;13
11520;"Trakų Vokė";BITUČIŲ;1359519176;Ne;10;0;0;10
11521;"Trakų Vokė";BITUČIŲ;1039317931;Ne;8;10;0;18
11522;"Trakų Vokė";BITUČIŲ;3333979364;Ne;4;1;0;5
11523;"Trakų Vokė";BITUČIŲ;3023545645;Ne;1;0;0;1
11524;"Trakų Vokė";BITUČIŲ;8783922678;Ne;1;5;0;6
11525;"Trakų Vokė";BITUČIŲ;1389577176;Taip;0;18;0;18
11526;Zylutė;Katerok;8749296671;Ne;0;1;0;1
11527;Zylutė;Katerok;8747721198;Ne;0;6;0;6
11528;Zylutė;Katerok;8212030518;Ne;0;5;0;5
11529;Zylutė;Katerok;7706833089;Ne;0;8;0;8
11530;Zylutė;Katerok;2968625045;Ne;3;0;0;3
11531;Zylutė;Katerok;5687201052;Ne;1;1;0;2
11532;Zylutė;Katerok;3055559237;Ne;0;7;0;7
11533;Zylutė;Katerok;2792217953;Ne;0;1;0;1
11534;Zylutė;Katerok;5948147748;Ne;0;1;0;1
11535;Zylutė;Katerok;7851423851;Ne;0;0;1;1
11536;Zylutė;Katerok;1164530815;Ne;0;7;0;7
11537;Zylutė;Katerok;1423890598;Ne;14;0;0;14
11538;Zylutė;Katerok;8268700439;Taip;1;1;2;4
11539;Zylutė;Katerok;4494567155;Ne;3;1;2;6
11540;Zylutė;Katerok;8618778936;Ne;0;1;0;1
11541;Zylutė;"Vesole misiaki";9162232979;Ne;9;0;0;9
11542;Zylutė;"Vesole misiaki";9737308076;Ne;0;7;0;7
11543;Zylutė;"Vesole misiaki";5589330186;Taip;13;0;0;13
11544;Zylutė;"Vesole misiaki";3848401615;Ne;5;0;2;7
11545;Zylutė;"Vesole misiaki";2913504349;Ne;5;0;0;5
11546;Zylutė;"Vesole misiaki";2501761963;Ne;6;11;0;17
11547;Zylutė;"Vesole misiaki";3976277394;Ne;0;3;0;3
11548;Zylutė;"Vesole misiaki";2489898107;Ne;4;4;0;8
11549;Zylutė;"Vesole misiaki";2013182317;Ne;0;0;1;1
11550;Zylutė;"Vesole misiaki";2313423907;Ne;10;0;0;10
11551;Zylutė;"Vesole misiaki";8121814945;Ne;0;0;2;2
11552;Zylutė;"Vesole misiaki";9159342804;Taip;0;0;1;1
11553;Zylutė;"Vesole misiaki";2201317313;Ne;8;0;1;9
11554;Zylutė;"Vesole misiaki";9018673580;Ne;0;0;1;1
11555;Zylutė;"Vesole misiaki";5369354390;Ne;17;0;0;17
11556;Zylutė;"Vesole misiaki";9507157625;Ne;1;0;1;2
11557;Zylutė;"Vesole misiaki";8101232865;Ne;5;0;0;5
11558;Zylutė;NYKŠTUKAI;1169490002;Ne;0;10;0;10
11559;Zylutė;NYKŠTUKAI;4894611078;Ne;3;0;0;3
11560;Zylutė;NYKŠTUKAI;7648922403;Ne;6;2;0;8
11561;Zylutė;NYKŠTUKAI;2113594059;Ne;0;7;0;7
11562;Zylutė;NYKŠTUKAI;2604844156;Ne;10;5;0;15
11563;Zylutė;NYKŠTUKAI;2511658462;Ne;5;0;0;5
11564;Zylutė;NYKŠTUKAI;3035745273;Ne;0;0;2;2
11565;Zylutė;NYKŠTUKAI;2620903587;Ne;16;0;0;16
11566;Zylutė;NYKŠTUKAI;2745905798;Ne;0;0;4;4
11567;Zylutė;NYKŠTUKAI;5975875502;Ne;6;1;0;7
11568;Zylutė;NYKŠTUKAI;4840138765;Ne;6;0;1;7
11569;Zylutė;NYKŠTUKAI;9221414691;Taip;6;0;0;6
11570;Zylutė;NYKŠTUKAI;7433615959;Ne;4;0;0;4
11571;Zylutė;Ručijok;5096881585;Ne;17;0;1;18
11572;Zylutė;Ručijok;4874246039;Ne;0;1;0;1
11573;Zylutė;Ručijok;3274885318;Ne;0;0;18;18
11574;Zylutė;Ručijok;6607670962;Ne;15;0;0;15
11575;Zylutė;Ručijok;2769424439;Ne;4;7;0;11
11576;Zylutė;Ručijok;1145229045;Ne;3;0;0;3
11577;Zylutė;Ručijok;3058040516;Ne;16;0;0;16
11578;Zylutė;Ručijok;5038936878;Ne;17;0;0;17
11579;Zylutė;Ručijok;2491905840;Taip;11;0;0;11
11580;Zylutė;Ručijok;5956114459;Ne;13;0;0;13
11581;Zylutė;Ručijok;6276017610;Ne;0;1;1;2
11582;Zylutė;Ručijok;3128535871;Ne;8;0;0;8
11583;Zylutė;Ručijok;6281989117;Taip;0;2;0;2
11584;Zylutė;Ručijok;2505224609;Taip;0;0;2;2
11585;Zylutė;Ručijok;7519900933;Ne;6;0;0;6
11586;Zylutė;Ručijok;3573761619;Ne;6;0;3;9
11587;Zylutė;Raduga;2916622808;Ne;10;0;0;10
11588;Zylutė;Raduga;2527003662;Taip;11;0;0;11
11589;Zylutė;Raduga;7911418657;Ne;5;0;0;5
11590;Zylutė;Raduga;5650984730;Ne;0;0;2;2
11591;Zylutė;Raduga;2826889413;Ne;1;0;0;1
11592;Zylutė;Raduga;4801678066;Ne;0;12;0;12
11593;Zylutė;"Miki Maus";7762245887;Taip;5;0;0;5
11594;Zylutė;"Miki Maus";9213491152;Ne;0;0;2;2
11595;Zylutė;"Miki Maus";3928932787;Ne;0;7;0;7
11596;Zylutė;"Miki Maus";4057419108;Taip;5;0;0;5
11597;Zylutė;"Miki Maus";3668160578;Ne;0;13;0;13
11598;Zylutė;"Miki Maus";9093777086;Ne;0;11;0;11
11599;Zylutė;"Miki Maus";7123399601;Ne;0;5;0;5
11600;Zylutė;"Miki Maus";7625237309;Taip;7;0;0;7
11601;Zylutė;"Miki Maus";8291414891;Ne;6;0;0;6
11602;Zylutė;"Miki Maus";6876326785;Ne;6;0;0;6
11603;Zylutė;Solnyško;5556769710;Ne;0;7;0;7
11604;Zylutė;Solnyško;2088316489;Ne;4;3;0;7
11605;Zylutė;Solnyško;1076803315;Ne;0;2;0;2
11606;Zylutė;Solnyško;7616444695;Ne;5;0;0;5
11607;Zylutė;Solnyško;5234846079;Ne;0;1;0;1
11608;Zylutė;Solnyško;5939522435;Ne;0;1;0;1
11609;Zylutė;Solnyško;5826813410;Ne;0;2;0;2
11610;Zylutė;Solnyško;7447067072;Ne;0;10;0;10
11611;Zylutė;Solnyško;1386683435;Ne;1;0;0;1
11612;Zylutė;Solnyško;1969578486;Ne;0;17;0;17
11613;Zylutė;Solnyško;6573541087;Ne;0;10;0;10
11614;Zylutė;Solnyško;2520744071;Ne;1;1;3;5
11615;Zylutė;Solnyško;3201966434;Taip;5;0;0;5
11616;Zylutė;Motyliok;7241045507;Ne;5;0;0;5
11617;Zylutė;Motyliok;6112586092;Ne;0;13;0;13
11618;Zylutė;Motyliok;8178488164;Ne;6;0;0;6
11619;Zylutė;Motyliok;5045652581;Ne;7;3;0;10
11620;Zylutė;Motyliok;9586800176;Ne;0;0;2;2
11621;Zylutė;Motyliok;4497904128;Ne;10;3;0;13
11622;Zylutė;Motyliok;3355159275;Ne;0;1;0;1
11623;Zylutė;Motyliok;9995791665;Taip;9;0;0;9
11624;Zylutė;Motyliok;1455822427;Ne;0;0;2;2
11625;Zylutė;Motyliok;3455374127;Ne;0;7;0;7
11626;Zylutė;Motyliok;1632490481;Taip;0;13;0;13
11627;Zylutė;Motyliok;1726060015;Ne;7;0;2;9
11628;Zylutė;Motyliok;3084870481;Ne;6;0;0;6
11629;Zylutė;Motyliok;3271366684;Ne;4;10;0;14
11630;Zylutė;Motyliok;3633983359;Ne;7;0;0;7
11631;Zylutė;Motyliok;9155513221;Ne;5;0;0;5
11632;Zylutė;Motyliok;6601967273;Ne;6;0;0;6
11633;Zylutė;Motyliok;6778361006;Ne;6;0;0;6
11634;Zylutė;ŽVIRBLIUKAI;1319040747;Ne;0;0;4;4
11635;Zylutė;ŽVIRBLIUKAI;8326987895;Ne;7;1;0;8
11636;Zylutė;ŽVIRBLIUKAI;9330583784;Ne;0;2;0;2
11637;Zylutė;ŽVIRBLIUKAI;1220439948;Ne;6;6;0;12
11638;Zylutė;ŽVIRBLIUKAI;4646273830;Ne;0;2;0;2
11639;Zylutė;ŽVIRBLIUKAI;9580188426;Ne;0;0;1;1
11640;Zylutė;ŽVIRBLIUKAI;1797701777;Ne;0;1;0;1
11641;Zylutė;ŽVIRBLIUKAI;2966482773;Taip;0;10;0;10
11642;Zylutė;ŽVIRBLIUKAI;1452384017;Ne;0;10;0;10
11643;Zylutė;ŽVIRBLIUKAI;8152140523;Ne;6;0;0;6
11644;Zylutė;ŽVIRBLIUKAI;2061747513;Taip;5;0;0;5
11645;Zylutė;ŽVIRBLIUKAI;4611555689;Ne;5;6;0;11
11646;Zylutė;ŽVIRBLIUKAI;3894885445;Ne;0;5;0;5
11647;Zylutė;ŽVIRBLIUKAI;3371202491;Taip;0;0;21;21
11648;Zylutė;ŽVIRBLIUKAI;7137348151;Taip;2;0;0;2
11649;Zylutė;ŽVIRBLIUKAI;3556698363;Ne;5;0;0;5
11650;Zylutė;"DRUŽNYJE REBIATA";5332039406;Taip;11;5;5;21
11651;Zylutė;"DRUŽNYJE REBIATA";9039665233;Ne;5;0;0;5
11652;Zylutė;"DRUŽNYJE REBIATA";6075614020;Ne;15;2;0;17
11653;Zylutė;"DRUŽNYJE REBIATA";9518714240;Ne;1;2;0;3
11654;Zylutė;"DRUŽNYJE REBIATA";2693961315;Ne;12;1;0;13
11655;Zylutė;"DRUŽNYJE REBIATA";3372639449;Taip;11;1;0;12
11656;Zylutė;"DRUŽNYJE REBIATA";4916625058;Ne;1;1;0;2
11657;Zylutė;"DRUŽNYJE REBIATA";3447644735;Ne;0;2;0;2
11658;Zylutė;"DRUŽNYJE REBIATA";3174042441;Ne;0;7;0;7
11659;Zylutė;"DRUŽNYJE REBIATA";6848387941;Taip;7;1;0;8
11660;Zylutė;"DRUŽNYJE REBIATA";1404949829;Ne;8;1;0;9
11661;Zylutė;"DRUŽNYJE REBIATA";4548205666;Ne;4;2;0;6
11662;Zylutė;"DRUŽNYJE REBIATA";6962852787;Ne;4;2;0;6
11663;Zylutė;"DRUŽNYJE REBIATA";9220918504;Ne;4;2;0;6
11664;Zylutė;"DRUŽNYJE REBIATA";9193349264;Ne;1;1;0;2
11665;Zylutė;"DRUŽNYJE REBIATA";2444440430;Ne;1;1;0;2
11666;Zylutė;"DRUŽNYJE REBIATA";8204885376;Ne;3;1;0;4
11667;Zylutė;"DRUŽNYJE REBIATA";8130859512;Ne;1;0;0;1
11668;Zylutė;"DRUŽNYJE REBIATA";9769201088;Ne;12;1;0;13
11669;Zylutė;"DRUŽNYJE REBIATA";5233163416;Ne;0;1;0;1
11670;Zylutė;"DRUŽNYJE REBIATA";5126282685;Ne;8;1;0;9
11671;Zylutė;"DRUŽNYJE REBIATA";8820121776;Ne;4;0;0;4
11672;Zylutė;VIEVERSĖLIAI;9748604675;Taip;8;0;0;8
11673;Zylutė;VIEVERSĖLIAI;9372402025;Taip;4;0;0;4
11674;Zylutė;VIEVERSĖLIAI;6540140502;Ne;7;0;0;7
11675;Zylutė;VIEVERSĖLIAI;5058082347;Ne;2;1;0;3
11676;Zylutė;VIEVERSĖLIAI;7072947464;Ne;3;0;0;3
11677;Zylutė;VIEVERSĖLIAI;3449678598;Ne;3;0;0;3
11678;Zylutė;VIEVERSĖLIAI;1271913393;Ne;3;0;0;3
11679;Zylutė;VIEVERSĖLIAI;4135186333;Ne;0;0;1;1
11680;Zylutė;VIEVERSĖLIAI;7070131037;Ne;6;0;0;6
11681;Zylutė;VIEVERSĖLIAI;1501573278;Taip;13;0;0;13
11682;Zylutė;VIEVERSĖLIAI;5125900173;Ne;7;3;0;10
11683;Želmenėliai;Bitučių;3268310531;Ne;0;1;0;1
11684;Želmenėliai;Bitučių;2563117992;Ne;0;1;0;1
11685;Želmenėliai;Bitučių;6799702725;Ne;0;2;0;2
11686;Želmenėliai;Bitučių;9006406225;Ne;0;2;0;2
11687;Želmenėliai;Bitučių;2102401372;Ne;0;1;0;1
11688;Želmenėliai;Bitučių;4931835807;Ne;0;1;0;1
11689;Želmenėliai;Bitučių;9611741258;Ne;2;0;0;2
11690;Želmenėliai;Bitučių;1619143702;Ne;1;0;0;1
11691;Želmenėliai;Bitučių;9825545754;Ne;2;1;0;3
11692;Želmenėliai;Bitučių;5314438217;Ne;0;4;0;4
11693;Želmenėliai;Bitučių;4927030144;Ne;1;1;0;2
11694;Želmenėliai;Bitučių;8028761330;Ne;0;1;0;1
11695;Želmenėliai;Bitučių;2853659708;Ne;2;0;0;2
11696;Želmenėliai;Bitučių;9207984505;Ne;5;4;0;9
11697;Želmenėliai;Bitučių;7919738237;Ne;0;2;0;2
11698;Želmenėliai;Kačiukų;2350936740;Taip;6;2;0;8
11699;Želmenėliai;Kačiukų;3063417708;Ne;0;9;0;9
11700;Želmenėliai;Kačiukų;2570248893;Ne;5;0;0;5
11701;Želmenėliai;Kačiukų;7197717698;Ne;0;2;3;5
11702;Želmenėliai;Kačiukų;7849682820;Ne;7;9;0;16
11703;Želmenėliai;Kačiukų;2111008869;Ne;11;0;0;11
11704;Želmenėliai;Kačiukų;4589396143;Ne;3;1;0;4
11705;Želmenėliai;Kačiukų;4198085732;Ne;0;4;0;4
11706;Želmenėliai;Kačiukų;4126499046;Ne;0;5;0;5
11707;Želmenėliai;Kačiukų;4758240577;Ne;0;4;0;4
11708;Želmenėliai;Kačiukų;7094853897;Taip;2;1;0;3
11709;Želmenėliai;Kačiukų;9493581034;Ne;15;2;4;21
11710;Želmenėliai;Kačiukų;4931664953;Ne;0;1;0;1
11711;Želmenėliai;Kačiukų;4376978921;Ne;0;12;0;12
11712;Želmenėliai;Kačiukų;9313666706;Ne;4;2;0;6
11713;Želmenėliai;Kačiukų;8590129703;Ne;0;0;10;10
11714;Želmenėliai;Kačiukų;3959066963;Ne;0;1;3;4
11715;Želmenėliai;Kačiukų;6761848439;Ne;0;0;21;21
11716;Želmenėliai;Voveriukų;5360157217;Ne;17;0;0;17
11717;Želmenėliai;Voveriukų;2025424742;Ne;0;2;0;2
11718;Želmenėliai;Voveriukų;2924134152;Ne;0;6;5;11
11719;Želmenėliai;Voveriukų;5975166975;Ne;5;6;0;11
11720;Želmenėliai;Voveriukų;6857922902;Ne;6;1;0;7
11721;Želmenėliai;Voveriukų;9811131936;Ne;2;0;0;2
11722;Želmenėliai;Voveriukų;8968533318;Ne;6;0;0;6
11723;Želmenėliai;Voveriukų;8952421941;Ne;16;1;0;17
11724;Želmenėliai;Voveriukų;7345540758;Ne;8;0;0;8
11725;Želmenėliai;Voveriukų;9709599805;Ne;5;1;0;6
11726;Želmenėliai;Voveriukų;4248374729;Ne;0;2;0;2
11727;Želmenėliai;Voveriukų;7263162876;Ne;0;1;3;4
11728;Želmenėliai;Voveriukų;1199920167;Ne;0;0;2;2
11729;Želmenėliai;Voveriukų;5247889693;Taip;0;1;0;1
11730;Želmenėliai;Voveriukų;5767158743;Ne;0;0;11;11
11731;Želmenėliai;Ežiukų;2311169187;Ne;13;0;0;13
11732;Želmenėliai;Ežiukų;3572462731;Ne;1;1;0;2
11733;Želmenėliai;Ežiukų;3353793939;Ne;1;0;0;1
11734;Želmenėliai;Ežiukų;7495157523;Ne;0;1;0;1
11735;Želmenėliai;Ežiukų;3972980949;Ne;0;3;0;3
11736;Želmenėliai;Ežiukų;6779746783;Ne;5;2;0;7
11737;Želmenėliai;Ežiukų;6876147546;Taip;11;1;0;12
11738;Želmenėliai;Ežiukų;8154713582;Ne;1;0;0;1
11739;Želmenėliai;Ežiukų;2296870749;Ne;1;0;0;1
11740;Želmenėliai;Ežiukų;6180553648;Ne;0;2;0;2
11741;Želmenėliai;Ežiukų;7294722095;Ne;2;2;0;4
11742;Želmenėliai;Ežiukų;4120125150;Ne;2;2;0;4
11743;Želmenėliai;Ežiukų;5281861477;Ne;0;1;0;1
11744;Želmenėliai;Ežiukų;8987377791;Ne;0;1;0;1
11745;Želmenėliai;Ežiukų;7373892344;Taip;4;0;0;4
11746;Želmenėliai;Ežiukų;6481952132;Ne;7;1;0;8
11747;Želmenėliai;Peledžiukų;8491797555;Ne;20;1;0;21
11748;Želmenėliai;Peledžiukų;7058759730;Ne;0;1;0;1
11749;Želmenėliai;Peledžiukų;4485249321;Ne;0;1;0;1
11750;Želmenėliai;Peledžiukų;3869372021;Ne;0;1;0;1
11751;Želmenėliai;Peledžiukų;4374898642;Ne;0;1;0;1
11752;Želmenėliai;Peledžiukų;7751609462;Ne;11;2;0;13
11753;Želmenėliai;Peledžiukų;5929410363;Ne;0;1;0;1
11754;Želmenėliai;Peledžiukų;5205425589;Ne;0;2;0;2
11755;Želmenėliai;Peledžiukų;1580370689;Ne;0;5;0;5
11756;Želmenėliai;Peledžiukų;7672980212;Ne;7;2;1;10
11757;Želmenėliai;Peledžiukų;6260153299;Ne;5;1;0;6
11758;Želmenėliai;Peledžiukų;6187661667;Ne;0;1;0;1
11759;Želmenėliai;Peledžiukų;6109546917;Ne;14;1;0;15
11760;Želmenėliai;Peledžiukų;8118696261;Ne;2;2;0;4
11761;Želmenėliai;Peledžiukų;4746898209;Ne;0;0;10;10
11762;Želmenėliai;Peledžiukų;9929149682;Taip;4;0;1;5
11763;Želmenėliai;Peledžiukų;3723155757;Taip;7;0;4;11
11764;Želmenėliai;Peledžiukų;6662439747;Ne;5;1;0;6
11765;Želmenėliai;Drugelių;7123290599;Ne;5;0;0;5
11766;Želmenėliai;Drugelių;4526936339;Ne;7;0;0;7
11767;Želmenėliai;Drugelių;5052052744;Ne;16;0;0;16
11768;Želmenėliai;Drugelių;2878494111;Ne;0;1;0;1
11769;Želmenėliai;Drugelių;5169813205;Ne;10;0;1;11
11770;Želmenėliai;Drugelių;9661692350;Ne;5;5;0;10
11771;Želmenėliai;Drugelių;1025894534;Ne;0;12;0;12
11772;Želmenėliai;Drugelių;1606079948;Ne;0;2;0;2
11773;Želmenėliai;Drugelių;9250666159;Ne;16;0;0;16
11774;Želmenėliai;Drugelių;5569699398;Ne;16;0;0;16
11775;Želmenėliai;Drugelių;7925266303;Ne;4;0;0;4
11776;Želmenėliai;Drugelių;4979494010;Ne;4;0;0;4
11777;Želmenėliai;Drugelių;8409831053;Ne;3;1;0;4
11778;Želmenėliai;Drugelių;8060048377;Ne;15;1;0;16
11779;Želmenėliai;Drugelių;2578675950;Ne;0;0;3;3
11780;Želmenėliai;Drugelių;5454656514;Ne;0;0;1;1
11781;Želmenėliai;Drugelių;7792850272;Ne;4;0;0;4
11782;Želmenėliai;Voriukų;4264751761;Ne;0;2;0;2
11783;Želmenėliai;Voriukų;6916426436;Ne;0;1;0;1
11784;Želmenėliai;Voriukų;7563461821;Ne;0;1;0;1
11785;Želmenėliai;Voriukų;4534946646;Ne;0;4;0;4
11786;Želmenėliai;Voriukų;4075533071;Ne;0;5;0;5
11787;Želmenėliai;Voriukų;4545012342;Ne;0;10;0;10
11788;Želmenėliai;Voriukų;7505996978;Ne;14;1;0;15
11789;Želmenėliai;Voriukų;2722619508;Ne;3;2;0;5
11790;Želmenėliai;Voriukų;5025345647;Ne;0;1;0;1
11791;Želmenėliai;Voriukų;8892137326;Ne;0;2;0;2
11792;Želmenėliai;Voriukų;7700521261;Ne;0;3;0;3
11793;Želmenėliai;Voriukų;1649724696;Ne;0;1;0;1
11794;Želmenėliai;Voriukų;5794346039;Ne;5;2;0;7
11795;Želmenėliai;Voriukų;8273301992;Ne;0;4;0;4
11796;Želmenėliai;Voriukų;4784667239;Ne;8;0;3;11
11797;Želmenėliai;Voriukų;9427388681;Ne;0;3;0;3
11798;Želmenėliai;Voriukų;9977585033;Ne;0;1;0;1
11799;Želmenėliai;Voriukų;6343814445;Ne;0;1;0;1
11800;Želmenėliai;Voriukų;5171736943;Ne;4;0;0;4
11801;Želmenėliai;Boružėlių;1764468979;Ne;5;1;0;6
11802;Želmenėliai;Boružėlių;5161934903;Ne;0;2;0;2
11803;Želmenėliai;Boružėlių;8722573513;Ne;0;2;0;2
11804;Želmenėliai;Boružėlių;3516695805;Ne;0;9;0;9
11805;Želmenėliai;Boružėlių;5949535657;Ne;0;3;0;3
11806;Želmenėliai;Boružėlių;7077832687;Ne;0;2;0;2
11807;Želmenėliai;Boružėlių;3896171121;Ne;0;4;0;4
11808;Želmenėliai;Boružėlių;2951719129;Ne;0;9;0;9
11809;Želmenėliai;Boružėlių;5207899503;Ne;0;8;0;8
11810;Želmenėliai;Boružėlių;2111705047;Ne;0;12;0;12
11811;Želmenėliai;Boružėlių;8474210476;Taip;2;0;0;2
11812;Želmenėliai;Boružėlių;2179165096;Ne;13;1;0;14
11813;Želmenėliai;Boružėlių;6831569546;Ne;7;0;0;7
11814;Želmenėliai;Boružėlių;9042786857;Ne;2;0;0;2
11815;Želmenėliai;Boružėlių;5913022147;Ne;13;1;0;14
11816;Želmenėliai;Pūkuotukų;3979635800;Ne;3;0;0;3
11817;Želmenėliai;Pūkuotukų;4485851428;Ne;5;1;0;6
11818;Želmenėliai;Pūkuotukų;2501163903;Ne;7;0;0;7
11819;Želmenėliai;Pūkuotukų;1426080041;Taip;2;1;0;3
11820;Želmenėliai;Pūkuotukų;3346680108;Ne;13;0;0;13
11821;Želmenėliai;Pūkuotukų;8654298177;Ne;1;0;0;1
11822;Želmenėliai;Pūkuotukų;9182208354;Ne;1;2;0;3
11823;Želmenėliai;Pūkuotukų;4679930998;Ne;1;0;0;1
11824;Želmenėliai;Pūkuotukų;3344426717;Ne;6;0;0;6
11825;Želmenėliai;Pūkuotukų;4930868989;Ne;1;5;0;6
11826;Želmenėliai;Pūkuotukų;4451798870;Ne;1;0;0;1
11827;Želmenėliai;Pūkuotukų;8104790589;Ne;2;1;0;3
11828;Želmenėliai;Pūkuotukų;4722890143;Taip;1;1;0;2
11829;Želmenėliai;Pūkuotukų;9901320882;Ne;2;0;0;2
11830;Želmenėliai;Pūkuotukų;3232996198;Ne;1;0;0;1
11831;Želmenėliai;Pūkuotukų;6764567873;Ne;0;5;0;5
11832;Želmenėliai;Pūkuotukų;3926238501;Ne;0;10;0;10
11833;Želmenėliai;Pūkuotukų;2095477479;Ne;2;0;0;2
11834;Želmenėliai;Ančiukų;9377359390;Ne;13;0;0;13
11835;Želmenėliai;Ančiukų;8165683014;Ne;14;3;0;17
11836;Želmenėliai;Ančiukų;3172645969;Taip;15;0;0;15
11837;Želmenėliai;Ančiukų;7128213908;Ne;3;6;0;9
11838;Želmenėliai;Ančiukų;6723870371;Ne;11;0;0;11
11839;Želmenėliai;Ančiukų;5872145297;Ne;8;1;0;9
11840;Želmenėliai;Ančiukų;9558387704;Ne;0;1;0;1
11841;Želmenėliai;Ančiukų;4841250486;Ne;2;0;0;2
11842;Želmenėliai;Ančiukų;3057181122;Ne;2;0;0;2
11843;Želmenėliai;Ančiukų;1359184372;Ne;15;0;0;15
11844;Želmenėliai;Ančiukų;9945526672;Ne;21;0;0;21
11845;Želmenėliai;Nykštukų;3003922213;Ne;0;8;0;8
11846;Želmenėliai;Nykštukų;3539019330;Ne;0;0;2;2
11847;Želmenėliai;Nykštukų;3313780575;Ne;11;0;3;14
11848;Želmenėliai;Nykštukų;5560792581;Ne;0;1;0;1
11849;Želmenėliai;Nykštukų;8191484604;Ne;1;0;0;1
11850;Želmenėliai;Nykštukų;2028226797;Ne;0;3;0;3
11851;Želmenėliai;Nykštukų;2369379191;Taip;7;0;0;7
11852;Želmenėliai;Nykštukų;2678902898;Ne;7;0;0;7
11853;Želmenėliai;Nykštukų;7537198352;Ne;6;0;0;6
11854;Želmenėliai;Nykštukų;2896053108;Ne;8;1;0;9
11855;Želmenėliai;Nykštukų;1613626023;Ne;0;1;0;1
11856;Želmenėliai;Lašelių;9483665065;Ne;11;1;0;12
11857;Želmenėliai;Lašelių;9774587149;Ne;6;0;0;6
11858;Želmenėliai;Lašelių;9608259121;Ne;0;1;0;1
11859;Želmenėliai;Lašelių;7403060823;Ne;7;0;0;7
11860;Želmenėliai;Lašelių;9178657126;Ne;0;1;0;1
11861;Želmenėliai;Lašelių;6605391184;Ne;6;0;0;6
11862;Želmenėliai;Lašelių;7067545362;Ne;15;0;0;15
11863;Žemyna;Čiauškučiai;9985529041;Ne;13;0;2;15
11864;Žemyna;Čiauškučiai;9570187081;Taip;0;0;1;1
11865;Žemyna;Čiauškučiai;2547436771;Ne;10;0;2;12
11866;Žemyna;Čiauškučiai;6346173832;Ne;0;0;3;3
11867;Žemyna;Čiauškučiai;8694608716;Ne;0;0;2;2
11868;Žemyna;Čiauškučiai;3074391266;Taip;6;0;0;6
11869;Žemyna;Čiauškučiai;1365045512;Ne;0;0;1;1
11870;Žemyna;Čiauškučiai;7620179886;Ne;0;0;3;3
11871;Žemyna;Čiauškučiai;7277970673;Ne;0;0;3;3
11872;Žemyna;Čiauškučiai;4642600915;Ne;0;0;1;1
11873;Žemyna;Čiauškučiai;2354265632;Ne;5;0;0;5
11874;Žemyna;Čiauškučiai;1654157342;Ne;0;0;9;9
11875;Žemyna;Čiauškučiai;4613946229;Ne;0;0;1;1
11876;Žemyna;Čiauškučiai;7675699775;Ne;1;1;2;4
11877;Žemyna;Čiauškučiai;6254811026;Taip;5;1;0;6
11878;Žemyna;Nykštukai;5124024813;Ne;0;0;1;1
11879;Žemyna;Nykštukai;8965957442;Ne;11;0;1;12
11880;Žemyna;Nykštukai;6965700024;Ne;5;0;2;7
11881;Žemyna;Nykštukai;3413550977;Ne;19;0;0;19
11882;Žemyna;Nykštukai;1158238868;Ne;0;0;2;2
11883;Žemyna;Nykštukai;8234617396;Taip;4;0;2;6
11884;Žemyna;Nykštukai;2105658990;Ne;3;0;1;4
11885;Žemyna;Nykštukai;1241953155;Ne;6;0;2;8
11886;Žemyna;Nykštukai;5274759824;Ne;0;0;2;2
11887;Žemyna;Nykštukai;9457156368;Taip;18;0;0;18
11888;Žemyna;Nykštukai;5968816137;Ne;0;0;1;1
11889;Žemyna;Nykštukai;1581399038;Ne;0;0;1;1
11890;Žemyna;Nykštukai;4238528111;Taip;5;0;0;5
11891;Žemyna;Nykštukai;3741459808;Taip;5;0;0;5
11892;Žemyna;Nykštukai;3870917221;Ne;7;0;1;8
11893;Žemyna;Nykštukai;6632827240;Ne;0;0;1;1
11894;Žemyna;Nykštukai;3935318882;Ne;0;2;0;2
11895;Žemyna;Nykštukai;2010676445;Ne;0;2;0;2
11896;Žemyna;Nykštukai;9788890112;Ne;8;0;3;11
11897;Žemyna;Nykštukai;8157281885;Ne;0;0;1;1
11898;Žemyna;Voveriukai;6912605631;Ne;0;0;12;12
11899;Žemyna;Voveriukai;4549562657;Ne;0;0;1;1
11900;Žemyna;Voveriukai;8882641275;Ne;0;0;11;11
11901;Žemyna;Voveriukai;7121061078;Ne;0;0;3;3
11902;Žemyna;Voveriukai;4900914346;Ne;0;0;11;11
11903;Žemyna;Voveriukai;8241038433;Ne;0;0;3;3
11904;Žemyna;Voveriukai;5189603013;Ne;0;0;5;5
11905;Žemyna;Voveriukai;3500358886;Taip;1;0;4;5
11906;Žemyna;Voveriukai;6592356004;Ne;0;0;12;12
11907;Žemyna;Voveriukai;7705964355;Ne;0;0;6;6
11908;Žemyna;Voveriukai;5486645485;Taip;0;0;2;2
11909;Žemyna;Voveriukai;5828590779;Ne;0;5;6;11
11910;Žemyna;Voveriukai;6070560979;Ne;0;3;1;4
11911;Žemyna;Voveriukai;8601806926;Ne;0;0;18;18
11912;Žemyna;Voveriukai;1883775045;Ne;6;0;11;17
11913;Žemyna;Kiškučiai;9912869400;Ne;5;0;6;11
11914;Žemyna;Kiškučiai;2006173745;Ne;0;0;1;1
11915;Žemyna;Kiškučiai;6116581655;Ne;0;3;1;4
11916;Žemyna;Kiškučiai;6728229865;Ne;0;3;0;3
11917;Žemyna;Kiškučiai;4872348199;Taip;4;0;2;6
11918;Žemyna;Kiškučiai;2710551760;Ne;0;5;0;5
11919;Žemyna;Kiškučiai;6419974691;Ne;10;0;0;10
11920;Žemyna;Kiškučiai;9818711030;Ne;6;0;3;9
11921;Žemyna;Kiškučiai;6735720135;Ne;0;8;2;10
11922;Žemyna;Kiškučiai;7764615445;Ne;0;0;1;1
11923;Žemyna;Kiškučiai;5868208651;Ne;0;0;9;9
11924;Žemyna;Kiškučiai;3982766622;Ne;1;0;2;3
11925;Žemyna;Kiškučiai;3992383447;Ne;9;0;2;11
11926;Žemyna;Kiškučiai;9568886284;Ne;0;0;11;11
11927;Žemyna;Kiškučiai;9668975591;Ne;0;1;1;2
11928;Žemyna;Kiškučiai;6856737270;Ne;0;0;1;1
11929;Žemyna;Kiškučiai;4612112289;Ne;0;0;5;5
11930;Žemyna;Kiškučiai;5188496664;Ne;0;0;2;2
11931;Žemyna;Vyturiukai;2526949655;Ne;0;0;4;4
11932;Žemyna;Vyturiukai;1417007895;Ne;0;2;0;2
11933;Žemyna;Vyturiukai;7781332622;Taip;0;7;0;7
11934;Žemyna;Vyturiukai;9366133892;Ne;4;0;0;4
11935;Žemyna;Vyturiukai;1031171460;Ne;7;0;1;8
11936;Žemyna;Vyturiukai;5204349188;Ne;13;5;0;18
11937;Žemyna;Vyturiukai;1345704379;Ne;0;0;4;4
11938;Žemyna;Vyturiukai;6097681172;Ne;5;1;0;6
11939;Žemyna;Vyturiukai;5133115712;Ne;4;0;1;5
11940;Žemyna;Vyturiukai;5416338054;Ne;4;0;1;5
11941;Žemyna;Vyturiukai;3446774478;Ne;4;3;0;7
11942;Žemyna;Vyturiukai;2304633263;Ne;0;0;10;10
11943;Žemyna;Vyturiukai;3679990879;Ne;0;5;2;7
11944;Žemyna;Vyturiukai;8461326396;Ne;15;0;6;21
11945;Žemyna;Vyturiukai;8681308720;Ne;0;2;0;2
11946;Žemyna;Vyturiukai;9646494715;Ne;0;4;0;4
11947;Žemyna;Vyturiukai;4863350801;Ne;1;0;2;3
11948;Žemyna;Vyturiukai;5655302107;Ne;0;12;0;12
11949;Žemyna;Pelėdžiukai;8525229514;Ne;0;0;1;1
11950;Žemyna;Pelėdžiukai;1846287760;Ne;6;0;2;8
11951;Žemyna;Pelėdžiukai;8775518984;Ne;2;0;0;2
11952;Žemyna;Pelėdžiukai;8926045231;Taip;6;0;3;9
11953;Žemyna;Pelėdžiukai;3860791215;Ne;0;7;0;7
11954;Žemyna;Pelėdžiukai;9855080887;Ne;0;0;1;1
11955;Žemyna;Pelėdžiukai;8185243991;Ne;0;0;4;4
11956;Žemyna;Pelėdžiukai;7942276632;Ne;1;0;2;3
11957;Žemyna;Pelėdžiukai;2422672832;Ne;0;0;5;5
11958;Žemyna;Pelėdžiukai;8408275231;Ne;0;7;0;7
11959;Žemyna;Pelėdžiukai;9194899557;Ne;0;6;0;6
11960;Žemyna;Pelėdžiukai;6175213274;Taip;21;0;0;21
11961;Žemyna;Pelėdžiukai;7311046586;Ne;0;3;0;3
11962;Žemyna;Pelėdžiukai;5124507416;Ne;0;3;0;3
11963;Žemyna;Pelėdžiukai;7672879525;Ne;0;0;4;4
11964;Žemyna;Vijurkai;5114094924;Ne;0;0;3;3
11965;Žemyna;Vijurkai;3643594001;Ne;0;0;3;3
11966;Žemyna;Vijurkai;7121742098;Ne;0;0;1;1
11967;Žemyna;Vijurkai;2461700030;Ne;0;9;0;9
11968;Žemyna;Vijurkai;3519840747;Ne;0;0;1;1
11969;Žemyna;Vijurkai;7508491119;Ne;3;0;0;3
11970;Žemyna;Vijurkai;1725771976;Ne;0;0;8;8
11971;Žemyna;Vijurkai;9653530823;Ne;0;1;1;2
11972;Žemyna;Vijurkai;2860210906;Ne;8;0;1;9
11973;Žemyna;Vijurkai;7832066079;Ne;0;8;0;8
11974;Žemyna;Vijurkai;1468040559;Ne;0;0;2;2
11975;Žemyna;Vijurkai;4322192775;Ne;0;0;1;1
11976;Žemyna;Vijurkai;4444870782;Ne;0;1;0;1
11977;Žemyna;Vijurkai;7781924111;Ne;0;0;1;1
11978;Žemyna;Vijurkai;2928125522;Ne;1;1;1;3
11979;Žemyna;Vijurkai;4759403487;Ne;0;6;1;7
11980;Žemyna;Vijurkai;5222774764;Ne;0;17;1;18
11981;Žemyna;Šnekučiai;4540472310;Ne;0;8;0;8
11982;Žemyna;Šnekučiai;9647706055;Ne;0;0;4;4
11983;Žemyna;Šnekučiai;7537145330;Ne;3;0;2;5
11984;Žemyna;Šnekučiai;7683443675;Ne;3;0;2;5
11985;Žemyna;Šnekučiai;3899901920;Taip;5;1;0;6
11986;Žemyna;Šnekučiai;9692952139;Taip;0;2;1;3
11987;Žemyna;Šnekučiai;1999410395;Ne;8;0;0;8
11988;Žemyna;Šnekučiai;4373063041;Ne;5;1;0;6
11989;Žemyna;Šnekučiai;9813765590;Ne;12;0;1;13
11990;Žemyna;Šnekučiai;4779461598;Ne;6;0;1;7
11991;Žemyna;Šnekučiai;3976010927;Ne;15;0;2;17
11992;Žemyna;Šnekučiai;4963338410;Ne;11;0;1;12
11993;Žemyna;Šnekučiai;1078809628;Ne;7;0;0;7
11994;Žemyna;Šnekučiai;3729250035;Taip;6;6;1;13
11995;Žemyna;Šnekučiai;9535234845;Ne;0;6;2;8
11996;Žemyna;Šnekučiai;9796331127;Ne;0;1;1;2
11997;Žemyna;Šnekučiai;3996577758;Ne;5;5;0;10
11998;Žemyna;Pabiručiai;9827401825;Ne;0;0;2;2
11999;Žemyna;Pabiručiai;5743535463;Ne;0;0;7;7
12000;Žemyna;Pabiručiai;6958537154;Ne;0;0;2;2
12001;Žemyna;Pabiručiai;7005045961;Ne;0;1;0;1
12002;Žemyna;Pabiručiai;6041223291;Ne;3;0;1;4
12003;Žemyna;Pabiručiai;9094718595;Ne;0;0;5;5
12004;Žemyna;Pabiručiai;6208953341;Ne;0;8;0;8
12005;Žemyna;Pabiručiai;1656335765;Ne;0;0;1;1
12006;Žemyna;Pabiručiai;5127174926;Ne;0;0;5;5
12007;Žemyna;Pabiručiai;8559870965;Ne;0;0;1;1
12008;Žemyna;Pabiručiai;1850100203;Ne;0;0;1;1
12009;Žemyna;Pabiručiai;2860232791;Ne;0;0;4;4
12010;Žemyna;Pabiručiai;4237778022;Ne;0;1;0;1
12011;Žemyna;Pabiručiai;2414400761;Ne;0;0;7;7
12012;Žemyna;Pabiručiai;9511935264;Ne;0;3;0;3
12013;Žemyna;Pabiručiai;4176386795;Ne;0;0;1;1
12014;Žemyna;Pabiručiai;4960936366;Taip;5;0;1;6
12015;Žemyna;Pabiručiai;2495616844;Taip;0;0;1;1
12016;Žemyna;Drugeliai;7564693757;Taip;3;0;3;6
12017;Žemyna;Drugeliai;8302345911;Ne;0;1;0;1
12018;Žemyna;Drugeliai;3505551915;Ne;16;0;3;19
12019;Žemyna;Drugeliai;9171823612;Ne;0;0;15;15
12020;Žemyna;Drugeliai;5518125715;Ne;0;0;1;1
12021;Žemyna;Drugeliai;9589582451;Ne;0;0;1;1
12022;Žemyna;Drugeliai;1279981170;Taip;0;0;1;1
12023;Žemyna;Drugeliai;2102920661;Ne;5;6;0;11
12024;Žemyna;Drugeliai;6575272457;Ne;6;0;1;7
12025;Žemyna;Drugeliai;6164541167;Ne;9;0;0;9
12026;Žemyna;Drugeliai;7461187735;Ne;1;0;0;1
12027;Žemyna;Drugeliai;3390442637;Ne;0;0;1;1
12028;Žemyna;Drugeliai;2371069183;Ne;0;0;1;1
12029;Žemyna;Drugeliai;2139103576;Taip;7;0;0;7
12030;Žemyna;Drugeliai;7920398415;Ne;0;3;7;10
12031;Žemyna;Drugeliai;1695063377;Ne;5;0;1;6
12032;Žemyna;Drugeliai;7745383607;Ne;4;0;1;5
12033;Žemyna;Drugeliai;7661182825;Ne;0;0;1;1
12034;Žemyna;Drugeliai;4861799571;Ne;0;0;1;1
12035;Žemyna;Drugeliai;7969518430;Ne;4;0;1;5
12036;Žemyna;"ŽIRNIUKAI ";8638419172;Ne;3;0;0;3
12037;Žemyna;"ŽIRNIUKAI ";5262196604;Ne;6;0;1;7
12038;Žemyna;"ŽIRNIUKAI ";6783675344;Ne;6;0;0;6
12039;Žemyna;"ŽIRNIUKAI ";9082375371;Ne;6;0;0;6
12040;Žemyna;"ŽIRNIUKAI ";3172071074;Ne;17;0;2;19
12041;Žemyna;"ŽIRNIUKAI ";7684869135;Ne;0;0;2;2
12042;Žemyna;"ŽIRNIUKAI ";8574497593;Ne;0;0;10;10
12043;Žemyna;"ŽIRNIUKAI ";3951546627;Ne;10;0;0;10
12044;Žemyna;"ŽIRNIUKAI ";2333634521;Ne;0;0;5;5
12045;Žemyna;"ŽIRNIUKAI ";8915491841;Ne;0;0;8;8
12046;Žemyna;"ŽIRNIUKAI ";7567666690;Ne;0;0;3;3
12047;Žemyna;"ŽIRNIUKAI ";1667692063;Ne;0;0;16;16
12048;Žemyna;"ŽIRNIUKAI ";1898736492;Ne;1;0;1;2
12049;Žemyna;"ŽIRNIUKAI ";2302222659;Ne;5;0;0;5
12050;Žemyna;"ŽIRNIUKAI ";1014787654;Ne;6;0;3;9
12051;Žemyna;"ŽIOGELIAI ";2039344248;Ne;0;0;4;4
12052;Žemyna;"ŽIOGELIAI ";5193466394;Ne;6;2;0;8
12053;Žemyna;"ŽIOGELIAI ";8365200813;Taip;0;0;1;1
12054;Žemyna;"ŽIOGELIAI ";8939113856;Ne;0;4;0;4
12055;Žemyna;"ŽIOGELIAI ";8205404725;Ne;6;0;2;8
12056;Žemyna;"ŽIOGELIAI ";3768231563;Ne;9;0;2;11
12057;Žemyna;"ŽIOGELIAI ";7580529381;Ne;7;3;2;12
12058;Žemyna;"ŽIOGELIAI ";5593285877;Ne;7;3;2;12
12059;Žemyna;"ŽIOGELIAI ";3397833166;Ne;7;0;0;7
12060;Žemyna;"ŽIOGELIAI ";2255662379;Ne;10;0;1;11
12061;Žemyna;"ŽIOGELIAI ";8017209353;Ne;10;0;1;11
12062;Žemyna;"ŽIOGELIAI ";8036600474;Ne;5;0;0;5
12063;Žemyna;"ŽIOGELIAI ";6317657622;Ne;20;0;0;20
12064;Žemuogėlė;Boružiukai;1350671777;Ne;4;0;0;4
12065;Žemuogėlė;Boružiukai;2158359435;Ne;16;0;1;17
12066;Žemuogėlė;Boružiukai;1639634300;Taip;9;0;0;9
12067;Žemuogėlė;Boružiukai;5521993938;Ne;5;0;0;5
12068;Žemuogėlė;Boružiukai;1267222057;Ne;3;1;0;4
12069;Žemuogėlė;Boružiukai;9562512849;Ne;12;3;1;16
12070;Žemuogėlė;Boružiukai;8661864424;Ne;2;0;2;4
12071;Žemuogėlė;Boružiukai;1150466286;Ne;12;0;3;15
12072;Žemuogėlė;Boružiukai;8040255583;Ne;4;0;5;9
12073;Žemuogėlė;Boružiukai;2190458676;Ne;9;0;2;11
12074;Žemuogėlė;Boružiukai;7328566035;Taip;11;0;0;11
12075;Žemuogėlė;Boružiukai;8557325116;Ne;0;11;0;11
12076;Žemuogėlė;Boružiukai;1350383125;Ne;7;0;0;7
12077;Žemuogėlė;Boružiukai;7050896262;Ne;0;0;4;4
12078;Žemuogėlė;Boružiukai;1187953952;Ne;3;6;0;9
12079;Žemuogėlė;Boružiukai;3677459716;Taip;5;0;0;5
12080;Žemuogėlė;Boružiukai;8426601160;Ne;3;5;0;8
12081;Žemuogėlė;Boružiukai;5911215640;Ne;0;0;15;15
12082;Žemuogėlė;Šviesuliukai;9599829363;Ne;0;7;0;7
12083;Žemuogėlė;Šviesuliukai;4663181188;Ne;1;2;0;3
12084;Žemuogėlė;Šviesuliukai;1341637008;Ne;0;7;0;7
12085;Žemuogėlė;Šviesuliukai;7288060676;Ne;30;0;0;30
12086;Žemuogėlė;Šviesuliukai;5447960062;Ne;10;0;0;10
12087;Žemuogėlė;Šviesuliukai;4654060157;Taip;9;0;0;9
12088;Žemuogėlė;Šviesuliukai;2652630375;Ne;10;0;2;12
12089;Žemuogėlė;Šviesuliukai;1250186598;Ne;14;0;0;14
12090;Žemuogėlė;Šviesuliukai;3287415964;Ne;0;9;0;9
12091;Žemuogėlė;Šviesuliukai;5094867109;Ne;7;0;0;7
12092;Žemuogėlė;Šviesuliukai;4974793430;Ne;12;0;0;12
12093;Žemuogėlė;Šviesuliukai;5186248897;Ne;4;0;0;4
12094;Žemuogėlė;Šviesuliukai;5125826172;Ne;0;6;0;6
12095;Žemuogėlė;Šviesuliukai;8262862183;Taip;5;0;3;8
12096;Žemuogėlė;Šviesuliukai;8798113318;Taip;2;0;0;2
12097;Žemuogėlė;Šviesuliukai;1280794094;Taip;0;0;5;5
12098;Žemuogėlė;Šviesuliukai;2251142510;Taip;10;0;0;10
12099;Žemuogėlė;Šviesuliukai;1417355297;Ne;11;0;0;11
12100;Žemuogėlė;Šviesuliukai;6659616731;Ne;5;2;0;7
12101;Žemuogėlė;Lašiukai;3190523750;Ne;6;0;0;6
12102;Žemuogėlė;Lašiukai;1251497003;Ne;0;1;0;1
12103;Žemuogėlė;Lašiukai;3706531223;Ne;0;1;0;1
12104;Žemuogėlė;Lašiukai;8029484123;Ne;9;0;0;9
12105;Žemuogėlė;Lašiukai;5992802843;Ne;5;12;0;17
12106;Žemuogėlė;Lašiukai;3753156044;Ne;5;1;0;6
12107;Žemuogėlė;Lašiukai;7592566602;Ne;0;0;5;5
12108;Žemuogėlė;Lašiukai;1555899448;Ne;1;0;0;1
12109;Žemuogėlė;Lašiukai;8644564820;Ne;0;1;0;1
12110;Žemuogėlė;Lašiukai;3546429231;Ne;0;17;0;17
12111;Žemuogėlė;Lašiukai;7137182934;Ne;0;0;1;1
12112;Žemuogėlė;Lašiukai;3073956225;Taip;0;5;0;5
12113;Žemuogėlė;Lašiukai;9693814425;Ne;2;0;0;2
12114;Žemuogėlė;Lašiukai;3059525247;Ne;3;0;0;3
12115;Žemuogėlė;Lašiukai;6747566307;Ne;0;1;0;1
12116;Žemuogėlė;Lašiukai;2115883173;Ne;8;0;1;9
12117;Žemuogėlė;Lašiukai;9848385521;Ne;8;0;0;8
12118;Žemuogėlė;Skambaliukai;7804015060;Ne;2;1;0;3
12119;Žemuogėlė;Skambaliukai;3765022476;Ne;0;2;0;2
12120;Žemuogėlė;Skambaliukai;9476688736;Ne;4;0;0;4
12121;Žemuogėlė;Skambaliukai;2001471529;Ne;0;7;0;7
12122;Žemuogėlė;Skambaliukai;9519563708;Taip;5;0;0;5
12123;Žemuogėlė;Skambaliukai;5266493632;Ne;0;6;0;6
12124;Žemuogėlė;Skambaliukai;3237083654;Ne;0;12;0;12
12125;Žemuogėlė;Skambaliukai;2259779058;Ne;4;0;0;4
12126;Žemuogėlė;Skambaliukai;9693894254;Ne;0;1;0;1
12127;Žemuogėlė;Skambaliukai;9378432383;Ne;2;1;0;3
12128;Žemuogėlė;Skambaliukai;6913038845;Ne;0;10;0;10
12129;Žemuogėlė;Skambaliukai;6581889641;Ne;10;0;0;10
12130;Žemuogėlė;Skambaliukai;2555902309;Ne;8;12;0;20
12131;Žemuogėlė;Skambaliukai;2132549536;Ne;4;3;0;7
12132;Žemuogėlė;Skambaliukai;5532053268;Ne;0;10;0;10
12133;Žemuogėlė;Skambaliukai;1733808230;Ne;0;0;1;1
12134;Žemuogėlė;Skambaliukai;9579921777;Ne;4;10;0;14
12135;Žemuogėlė;Spinduliukai;5971652934;Ne;1;13;0;14
12136;Žemuogėlė;Spinduliukai;4578291476;Ne;22;0;0;22
12137;Žemuogėlė;Spinduliukai;6707522989;Ne;0;10;0;10
12138;Žemuogėlė;Spinduliukai;7669457695;Ne;3;0;0;3
12139;Žemuogėlė;Spinduliukai;4933948491;Ne;1;1;0;2
12140;Žemuogėlė;Spinduliukai;8492878852;Taip;5;0;1;6
12141;Žemuogėlė;Spinduliukai;7551522580;Ne;0;5;3;8
12142;Žemuogėlė;Spinduliukai;7603740057;Ne;0;0;3;3
12143;Žemuogėlė;Spinduliukai;6755278376;Ne;0;11;2;13
12144;Žemuogėlė;Spinduliukai;3746045950;Ne;0;6;0;6
12145;Žemuogėlė;Spinduliukai;4506847669;Ne;0;10;0;10
12146;Žemuogėlė;Spinduliukai;7837251012;Ne;0;1;0;1
12147;Žemuogėlė;Spinduliukai;7189855370;Ne;0;14;0;14
12148;Žemuogėlė;Spinduliukai;3801534195;Ne;12;15;0;27
12149;Žemuogėlė;Perliukai;6504659145;Ne;2;10;0;12
12150;Žemuogėlė;Perliukai;3505090532;Ne;6;2;0;8
12151;Žemuogėlė;Perliukai;1790341419;Taip;6;0;1;7
12152;Žemuogėlė;Perliukai;4998981337;Taip;5;12;0;17
12153;Žemuogėlė;Perliukai;6045257180;Ne;0;0;1;1
12154;Žemuogėlė;Perliukai;8301927361;Ne;13;5;0;18
12155;Žemuogėlė;Perliukai;2496321184;Ne;2;11;0;13
12156;Žemuogėlė;Perliukai;8490643028;Ne;0;1;0;1
12157;Žemuogėlė;Perliukai;5208043522;Ne;5;0;0;5
12158;Žemuogėlė;Perliukai;2139102266;Ne;13;1;0;14
12159;Žemuogėlė;Perliukai;3740127955;Taip;12;0;1;13
12160;Žemuogėlė;Perliukai;5614510812;Ne;1;1;0;2
12161;Žemuogėlė;Perliukai;9735379466;Ne;10;0;0;10
12162;Žemuogėlė;Perliukai;4089939292;Taip;0;5;0;5
12163;Žemuogėlė;Perliukai;9584172565;Ne;8;5;0;13
12164;Žemuogėlė;Perliukai;8706379207;Ne;13;0;0;13
12165;Žemuogėlė;Perliukai;1457860763;Ne;9;0;0;9
12166;Žemuogėlė;Drugeliai;2745609317;Ne;3;0;1;4
12167;Žemuogėlė;Drugeliai;9694133286;Ne;6;0;0;6
12168;Žemuogėlė;Drugeliai;5557409350;Taip;7;5;0;12
12169;Žemuogėlė;Drugeliai;7668200447;Ne;5;1;0;6
12170;Žemuogėlė;Drugeliai;7148244029;Ne;19;0;0;19
12171;Žemuogėlė;Drugeliai;1901423257;Ne;1;0;0;1
12172;Žemuogėlė;Drugeliai;4862145385;Ne;5;7;0;12
12173;Žemuogėlė;Drugeliai;4368183799;Taip;12;0;0;12
12174;Žemuogėlė;Drugeliai;9902953729;Ne;17;10;0;27
12175;Žemuogėlė;Drugeliai;9537297860;Ne;3;1;0;4
12176;Žemuogėlė;Drugeliai;5170205929;Ne;0;2;0;2
12177;Žemuogėlė;Drugeliai;2428043195;Ne;5;3;0;8
12178;Žemuogėlė;Drugeliai;1716114524;Taip;11;0;0;11
12179;Žemuogėlė;Drugeliai;8137567729;Ne;7;13;0;20
12180;Žemuogėlė;Drugeliai;7974688217;Ne;7;2;0;9
12181;Žemuogėlė;Drugeliai;9273896998;Ne;17;0;0;17
12182;Žemuogėlė;Drugeliai;9801151322;Ne;17;1;0;18
12183;Žemuogėlė;Drugeliai;5142411841;Taip;10;1;0;11
12184;Žemuogėlė;Drugeliai;9872387354;Ne;14;6;0;20
12185;Žemuogėlė;Drugeliai;5300388726;Ne;0;11;0;11
12186;Žemuogėlė;"VIEVERSIUKAI ";8048818368;Ne;0;16;5;21
12187;Žemuogėlė;"VIEVERSIUKAI ";6577040746;Ne;16;0;0;16
12188;Žemuogėlė;"VIEVERSIUKAI ";2674188340;Ne;9;0;0;9
12189;Žemuogėlė;"VIEVERSIUKAI ";7823828526;Ne;4;11;0;15
12190;Žemuogėlė;"VIEVERSIUKAI ";4172356209;Taip;0;6;0;6
12191;Žemuogėlė;"VIEVERSIUKAI ";6379837644;Ne;10;0;0;10
12192;Žemuogėlė;"VIEVERSIUKAI ";3104276726;Ne;0;13;2;15
12193;Žemuogėlė;"VIEVERSIUKAI ";2800160529;Taip;12;10;0;22
12194;Žemuogėlė;"VIEVERSIUKAI ";8934779062;Ne;6;0;0;6
12195;Žemuogėlė;"VIEVERSIUKAI ";3090630899;Ne;0;7;0;7
12196;Žemuogėlė;"VIEVERSIUKAI ";8091000121;Ne;11;0;0;11
12197;Žemuogėlė;"VIEVERSIUKAI ";2110963483;Ne;3;20;1;24
12198;Žemuogėlė;"VIEVERSIUKAI ";2574719380;Taip;8;2;0;10
12199;Žemuogėlė;"NYKŠTUKAI ";9205221446;Ne;10;0;0;10
12200;Žemuogėlė;"NYKŠTUKAI ";2655733505;Ne;15;0;0;15
12201;Žemuogėlė;"NYKŠTUKAI ";1911605637;Ne;13;0;0;13
12202;Žemuogėlė;"NYKŠTUKAI ";9798128294;Ne;18;0;0;18
12203;Žemuogėlė;"NYKŠTUKAI ";1916826391;Taip;12;0;0;12
12204;Žemuogėlė;"NYKŠTUKAI ";5948873766;Ne;4;0;0;4
12205;Žemuogėlė;"NYKŠTUKAI ";3010585170;Ne;5;10;0;15
12206;Žemuogėlė;"NYKŠTUKAI ";1769751604;Ne;20;0;0;20
12207;Žemuogėlė;"NYKŠTUKAI ";3462564692;Ne;7;0;0;7
12208;Žemuogėlė;"NYKŠTUKAI ";7565473877;Ne;6;0;0;6
12209;Žemuogėlė;"NYKŠTUKAI ";8211122634;Ne;5;0;1;6
12210;Žemuogėlė;"NYKŠTUKAI ";8706639942;Taip;0;0;1;1
12211;Žemuogėlė;"NYKŠTUKAI ";4180815331;Ne;5;0;0;5
12212;Žemuogėlė;"NYKŠTUKAI ";9290074229;Ne;7;0;0;7
12213;Žemuogėlė;"NYKŠTUKAI ";1601617523;Ne;9;0;0;9
12214;Žemuogėlė;KIŠKUČIAI;3467743802;Ne;9;0;0;9
12215;Žemuogėlė;KIŠKUČIAI;8584425313;Taip;7;1;0;8
12216;Žemuogėlė;KIŠKUČIAI;7423719480;Ne;8;0;0;8
12217;Žemuogėlė;KIŠKUČIAI;9889748260;Ne;4;0;0;4
12218;Žemuogėlė;KIŠKUČIAI;3842157786;Ne;3;0;0;3
12219;Žemuogėlė;KIŠKUČIAI;2091617436;Ne;17;0;0;17
12220;Žemuogėlė;KIŠKUČIAI;9501717210;Ne;17;0;0;17
12221;Žemuogėlė;KIŠKUČIAI;7263992351;Ne;0;5;0;5
12222;Žemuogėlė;KIŠKUČIAI;7508582586;Ne;1;0;0;1
12223;Žemuogėlė;Žiniukai;1306065826;Ne;5;0;0;5
12224;Žemuogėlė;Žiniukai;2664267604;Ne;10;7;0;17
12225;Žemuogėlė;Žiniukai;1060986850;Ne;0;7;0;7
12226;Žemuogėlė;Žiniukai;9150335499;Taip;12;0;0;12
12227;Žemuogėlė;Žiniukai;7794377881;Taip;1;1;0;2
12228;Žemuogėlė;Žiniukai;1658954821;Ne;0;2;0;2
12229;Žemuogėlė;Žiniukai;4698671798;Taip;9;0;0;9
12230;Žemuogėlė;Žiniukai;1079114347;Ne;1;1;0;2
12231;Žemuogėlė;Žiniukai;5902241163;Ne;3;1;0;4
12232;Žemuogėlė;Žiniukai;7879519193;Taip;0;5;0;5
12233;Žemuogėlė;Žiniukai;2922827304;Ne;7;0;0;7
12234;Žemuogėlė;Žiniukai;2109195565;Ne;3;0;0;3
12235;Žemuogėlė;Žiniukai;7415364637;Ne;11;0;0;11
12236;Žemuogėlė;Žiniukai;3710681463;Ne;4;0;0;4
12237;Žemuogėlė;Žiniukai;8215763877;Ne;10;0;0;10
12238;Žemuogėlė;Žiniukai;2934225120;Ne;13;0;0;13
12239;Žemuogėlė;Žiniukai;3426685084;Ne;18;0;0;18
12240;Žibutė;PELĖDŽIUKAI;3777544301;Taip;0;0;2;2
12241;Žibutė;PELĖDŽIUKAI;1362419302;Ne;5;0;0;5
12242;Žibutė;PELĖDŽIUKAI;9634311146;Ne;0;0;2;2
12243;Žibutė;PELĖDŽIUKAI;5677389434;Ne;4;1;2;7
12244;Žibutė;PELĖDŽIUKAI;5416015554;Ne;4;0;1;5
12245;Žibutė;PELĖDŽIUKAI;1366469428;Ne;0;5;1;6
12246;Žibutė;PELĖDŽIUKAI;4825064521;Ne;6;0;3;9
12247;Žibutė;PELĖDŽIUKAI;5826523148;Ne;0;0;2;2
12248;Žibutė;PELĖDŽIUKAI;7531027545;Ne;2;0;2;4
12249;Žibutė;PELĖDŽIUKAI;3957898269;Ne;2;0;0;2
12250;Žibutė;PELĖDŽIUKAI;8880329060;Taip;0;0;3;3
12251;Žibutė;PELĖDŽIUKAI;5591698130;Ne;2;0;0;2
12252;Žibutė;PELĖDŽIUKAI;9868621666;Ne;2;0;1;3
12253;Žibutė;PELĖDŽIUKAI;5009495840;Ne;5;0;0;5
12254;Žibutė;PELĖDŽIUKAI;7136145033;Ne;4;0;2;6
12255;Žibutė;PELĖDŽIUKAI;6978977383;Ne;0;0;1;1
12256;Žibutė;PELĖDŽIUKAI;2880593326;Ne;0;0;1;1
12257;Žibutė;PELĖDŽIUKAI;7479437931;Ne;2;1;1;4
12258;Žibutė;PELĖDŽIUKAI;9498011134;Ne;0;0;1;1
12259;Žibutė;KREGŽDUTĖS;7036454359;Ne;5;0;1;6
12260;Žibutė;KREGŽDUTĖS;3555071718;Ne;3;0;1;4
12261;Žibutė;KREGŽDUTĖS;5412917352;Ne;0;0;1;1
12262;Žibutė;KREGŽDUTĖS;5187777741;Ne;5;0;1;6
12263;Žibutė;KREGŽDUTĖS;5190377896;Ne;6;0;1;7
12264;Žibutė;KREGŽDUTĖS;6013340521;Ne;0;6;0;6
12265;Žibutė;KREGŽDUTĖS;3574946816;Ne;8;0;0;8
12266;Žibutė;KREGŽDUTĖS;9923687090;Ne;13;0;2;15
12267;Žibutė;KREGŽDUTĖS;4847295068;Ne;4;0;0;4
12268;Žibutė;KREGŽDUTĖS;9700866512;Ne;0;2;0;2
12269;Žibutė;KREGŽDUTĖS;7774532200;Ne;0;6;0;6
12270;Žibutė;KREGŽDUTĖS;2607509585;Ne;3;1;0;4
12271;Žibutė;KREGŽDUTĖS;8944042589;Ne;0;0;3;3
12272;Žibutė;KREGŽDUTĖS;2438980348;Ne;2;0;3;5
12273;Žibutė;KREGŽDUTĖS;9918283923;Ne;5;0;0;5
12274;Žibutė;KREGŽDUTĖS;5126232169;Ne;10;0;0;10
12275;Žibutė;KREGŽDUTĖS;8792292819;Ne;8;0;0;8
12276;Žibutė;KREGŽDUTĖS;7668484415;Ne;0;9;0;9
12277;Žibutė;KREGŽDUTĖS;2516448580;Ne;0;6;0;6
12278;Žibutė;BORUŽĖLĖS;5430856044;Ne;3;0;0;3
12279;Žibutė;BORUŽĖLĖS;8303166103;Ne;4;0;0;4
12280;Žibutė;BORUŽĖLĖS;4708691611;Ne;14;0;1;15
12281;Žibutė;BORUŽĖLĖS;9116859942;Ne;0;1;2;3
12282;Žibutė;BORUŽĖLĖS;1730975120;Ne;10;1;1;12
12283;Žibutė;BORUŽĖLĖS;9547812966;Ne;9;0;4;13
12284;Žibutė;BORUŽĖLĖS;7738606888;Ne;4;0;8;12
12285;Žibutė;BORUŽĖLĖS;6072605005;Ne;0;2;2;4
12286;Žibutė;BORUŽĖLĖS;8423264689;Ne;1;0;3;4
12287;Žibutė;BORUŽĖLĖS;3258258046;Ne;3;0;1;4
12288;Žibutė;BORUŽĖLĖS;9127784681;Ne;5;0;2;7
12289;Žibutė;BORUŽĖLĖS;6209156111;Ne;6;9;5;20
12290;Žibutė;BITUTĖS;7023683517;Ne;0;6;0;6
12291;Žibutė;BITUTĖS;7853531467;Taip;0;0;1;1
12292;Žibutė;BITUTĖS;3687123871;Ne;10;0;0;10
12293;Žibutė;BITUTĖS;2312717334;Ne;7;2;0;9
12294;Žibutė;BITUTĖS;6361543454;Ne;6;12;0;18
12295;Žibutė;BITUTĖS;1297347740;Ne;0;0;1;1
12296;Žibutė;BITUTĖS;6934760468;Ne;0;1;1;2
12297;Žibutė;BITUTĖS;4455757640;Ne;1;0;1;2
12298;Žibutė;BITUTĖS;8797870379;Ne;7;1;0;8
12299;Žibutė;BITUTĖS;7792267540;Ne;1;8;0;9
12300;Žibutė;BITUTĖS;9221523836;Ne;8;5;0;13
12301;Žibutė;BITUTĖS;3632745935;Ne;0;0;1;1
12302;Žibutė;BITUTĖS;7611641692;Ne;5;0;0;5
12303;Žibutė;BITUTĖS;5112512917;Ne;7;0;0;7
12304;Žibutė;BITUTĖS;8276724226;Ne;0;0;1;1
12305;Žibutė;BITUTĖS;1515636796;Ne;2;1;0;3
12306;Žibutė;BITUTĖS;7872636200;Ne;0;1;1;2
12307;Žibutė;BITUTĖS;6833179680;Ne;9;0;0;9
12308;Žibutė;BITUTĖS;1614551884;Ne;11;0;0;11
12309;Žibutė;KAČIUKAI;9611892163;Taip;7;0;0;7
12310;Žibutė;KAČIUKAI;1786332689;Ne;0;0;1;1
12311;Žibutė;KAČIUKAI;3618347199;Ne;1;0;1;2
12312;Žibutė;KAČIUKAI;5591970907;Ne;5;1;0;6
12313;Žibutė;KAČIUKAI;7764376193;Ne;0;0;7;7
12314;Žibutė;KAČIUKAI;8879347884;Ne;7;0;1;8
12315;Žibutė;KAČIUKAI;7608622330;Ne;16;0;0;16
12316;Žibutė;KAČIUKAI;5186839413;Ne;0;1;0;1
12317;Žibutė;KAČIUKAI;4278832423;Ne;5;0;0;5
12318;Žibutė;KAČIUKAI;1381488132;Ne;5;0;1;6
12319;Žibutė;KAČIUKAI;2910188022;Ne;4;0;0;4
12320;Žibutė;KAČIUKAI;4622674814;Ne;0;0;2;2
12321;Žibutė;KAČIUKAI;5632520305;Ne;0;0;2;2
12322;Žibutė;KAČIUKAI;7805758264;Ne;5;4;0;9
12323;Žibutė;KAČIUKAI;6672033757;Ne;1;0;0;1
12324;Žibutė;KAČIUKAI;3066580779;Ne;10;0;0;10
12325;Žibutė;KAČIUKAI;8640664660;Ne;0;10;0;10
12326;Žibutė;KAČIUKAI;2374119662;Ne;0;1;0;1
12327;Žibutė;ZUIKIAI;5326761360;Ne;13;12;0;25
12328;Žibutė;ZUIKIAI;4741505387;Ne;9;0;0;9
12329;Žibutė;ZUIKIAI;2787326978;Ne;4;1;0;5
12330;Žibutė;ZUIKIAI;4787010953;Ne;9;0;0;9
12331;Žibutė;ZUIKIAI;9645026432;Ne;16;3;0;19
12332;Žibutė;ZUIKIAI;3875455223;Ne;1;2;0;3
12333;Žibutė;ZUIKIAI;3449188614;Ne;15;0;0;15
12334;Žibutė;ZUIKIAI;4434623264;Ne;8;2;0;10
12335;Žibutė;ZUIKIAI;9769180056;Ne;11;3;0;14
12336;Žibutė;ZUIKIAI;3786933891;Ne;8;2;0;10
12337;Žibutė;ZUIKIAI;9379539151;Ne;2;5;0;7
12338;Žibutė;ZUIKIAI;6234135622;Ne;12;5;0;17
12339;Žibutė;ZUIKIAI;8585964720;Ne;13;2;0;15
12340;Žibutė;ZUIKIAI;9793570682;Ne;9;1;0;10
12341;Žibutė;ZUIKIAI;6618315401;Ne;18;0;0;18
12342;Žibutė;ZUIKIAI;6290821274;Ne;2;0;0;2
12343;Žibutė;ZUIKIAI;5045628452;Ne;6;0;0;6
12344;Žiedas;Bitutės;8208331527;Ne;3;0;0;3
12345;Žiedas;Bitutės;9140396365;Ne;1;0;0;1
12346;Žiedas;Bitutės;8148831014;Ne;1;0;0;1
12347;Žiedas;Bitutės;3230107921;Ne;1;0;0;1
12348;Žiedas;Bitutės;3178778438;Ne;0;5;0;5
12349;Žiedas;Bitutės;9602083568;Ne;11;0;0;11
12350;Žiedas;Bitutės;5061575884;Ne;4;1;0;5
12351;Žiedas;Bitutės;5628720422;Ne;1;2;0;3
12352;Žiedas;Bitutės;1582961378;Ne;3;1;0;4
12353;Žiedas;Bitutės;9020540780;Ne;2;0;0;2
12354;Žiedas;Bitutės;5578227349;Ne;0;7;0;7
12355;Žiedas;Bitutės;6914059680;Ne;3;1;0;4
12356;Žiedas;Bitutės;7771247056;Ne;1;0;0;1
12357;Žiedas;Bitutės;6515510381;Ne;1;1;0;2
12358;Žiedas;Bitutės;3842589827;Ne;6;0;0;6
12359;Žiedas;Bitutės;1043230748;Ne;1;0;0;1
12360;Žiedas;Bitutės;5835309107;Taip;0;1;0;1
12361;Žiedas;Bitutės;3387263016;Taip;6;0;0;6
12362;Žiedas;Bitutės;3178580610;Ne;0;3;0;3
12363;Žiedas;Varpeliai;2320543511;Ne;0;1;0;1
12364;Žiedas;Varpeliai;4699833757;Ne;3;1;0;4
12365;Žiedas;Varpeliai;8861734370;Taip;0;5;0;5
12366;Žiedas;Varpeliai;7780469974;Ne;0;0;1;1
12367;Žiedas;Varpeliai;4360175072;Ne;8;0;0;8
12368;Žiedas;Varpeliai;2149342412;Ne;0;0;1;1
12369;Žiedas;Varpeliai;1086714229;Ne;14;3;0;17
12370;Žiedas;Varpeliai;7445583512;Ne;5;0;0;5
12371;Žiedas;Varpeliai;2714272604;Ne;3;0;0;3
12372;Žiedas;Varpeliai;2321239854;Ne;11;0;1;12
12373;Žiedas;Varpeliai;2680021778;Ne;4;0;0;4
12374;Žiedas;Varpeliai;9012779767;Ne;1;0;0;1
12375;Žiedas;Varpeliai;9400503719;Ne;5;0;0;5
12376;Žiedas;Ramunėlės;3055218791;Ne;2;2;0;4
12377;Žiedas;Ramunėlės;1333555044;Ne;5;0;0;5
12378;Žiedas;Ramunėlės;5789261620;Ne;5;0;0;5
12379;Žiedas;Ramunėlės;5577339739;Taip;8;0;0;8
12380;Žiedas;Ramunėlės;1659873036;Ne;0;1;0;1
12381;Žiedas;Ramunėlės;1243169901;Ne;7;0;0;7
12382;Žiedas;Ramunėlės;1580781723;Ne;0;1;0;1
12383;Žiedas;Ramunėlės;5920211041;Ne;0;6;0;6
12384;Žiedas;Ramunėlės;4933650089;Ne;0;3;0;3
12385;Žiedas;Ramunėlės;4044156905;Ne;0;9;0;9
12386;Žiedas;Ramunėlės;4844442247;Ne;0;5;0;5
12387;Žiedas;Ramunėlės;7294671324;Ne;0;11;0;11
12388;Žiedas;Ramunėlės;8415686253;Taip;0;3;0;3
12389;Žiedas;Ramunėlės;7441475685;Ne;11;0;1;12
12390;Žiedas;Ramunėlės;1309242930;Taip;0;0;1;1
12391;Žiedas;Ramunėlės;8797245208;Ne;9;0;0;9
12392;Žiedas;Ramunėlės;5635958124;Ne;5;1;0;6
12393;Žiedas;Ramunėlės;9337317396;Ne;5;1;0;6
12394;Žiedas;Ramunėlės;2320411618;Ne;1;6;0;7
12395;Žiedas;Ramunėlės;2769598744;Ne;2;0;0;2
12396;Žiedas;Pakalnutės;7798930533;Taip;0;4;0;4
12397;Žiedas;Pakalnutės;1094506858;Taip;0;2;0;2
12398;Žiedas;Pakalnutės;9375048835;Ne;2;0;0;2
12399;Žiedas;Pakalnutės;5266048033;Ne;0;4;0;4
12400;Žiedas;Pakalnutės;5804334198;Ne;0;0;3;3
12401;Žiedas;Pakalnutės;1721956438;Ne;0;2;0;2
12402;Žiedas;Pakalnutės;3742949697;Ne;0;1;0;1
12403;Žiedas;Pakalnutės;6343634478;Taip;0;3;0;3
12404;Žiedas;Pakalnutės;8015880569;Ne;0;1;0;1
12405;Žiedas;Pakalnutės;8857150598;Ne;10;0;0;10
12406;Žiedas;Pakalnutės;2416234016;Ne;0;2;0;2
12407;Žiedas;Pakalnutės;9054709268;Ne;0;1;0;1
12408;Žiedas;Pakalnutės;9964883646;Ne;0;4;0;4
12409;Žiedas;Pakalnutės;4917324037;Ne;0;1;0;1
12410;Žiedas;Pakalnutės;4021189767;Ne;0;2;0;2
12411;Žiedas;Pakalnutės;4697477761;Ne;0;2;0;2
12412;Žiedas;Pakalnutės;7678333395;Ne;0;1;0;1
12413;Žiedas;Pakalnutės;9207945616;Ne;0;1;0;1
12414;Žiedas;Pakalnutės;7221702677;Taip;3;1;0;4
12415;Žiedas;Pakalnutės;2393112381;Ne;0;3;0;3
12416;Žiedas;Rožytės;8846443535;Taip;0;0;3;3
12417;Žiedas;Rožytės;7799489700;Ne;17;1;0;18
12418;Žiedas;Rožytės;8927034492;Ne;0;20;0;20
12419;Žiedas;Rožytės;1777501190;Ne;0;0;2;2
12420;Žiedas;Rožytės;1844621525;Ne;0;4;0;4
12421;Žiedas;Rožytės;6459679214;Ne;0;8;0;8
12422;Žiedas;Rožytės;5987689515;Ne;7;0;1;8
12423;Žiedas;Rožytės;1035854293;Ne;0;0;2;2
12424;Žiedas;Rožytės;7584712202;Ne;3;0;1;4
12425;Žiedas;Rožytės;2642760082;Ne;0;0;3;3
12426;Žiedas;Rožytės;1917085385;Ne;0;1;1;2
12427;Žiedas;Rožytės;3099608553;Ne;11;0;1;12
12428;Žiedas;Rožytės;7228139235;Ne;10;0;1;11
12429;Žiedas;Rožytės;1975718197;Ne;6;0;1;7
12430;Žiedas;Rožytės;2312361963;Ne;11;0;3;14
12431;Žiedas;Rožytės;6859410675;Ne;7;0;0;7
12432;Žiedas;Rožytės;1390431397;Ne;0;0;5;5
12433;Žiedas;Rožytės;3490370918;Ne;3;0;1;4
12434;Žiedas;Rožytės;9183582003;Ne;3;0;1;4
12435;Žiedas;Pumpurėliai;1631534238;Ne;7;0;1;8
12436;Žiedas;Pumpurėliai;3994387532;Ne;6;1;0;7
12437;Žiedas;Pumpurėliai;5862164657;Ne;2;0;0;2
12438;Žiedas;Pumpurėliai;9833875402;Ne;1;0;0;1
12439;Žiedas;Pumpurėliai;8336518449;Ne;6;0;0;6
12440;Žiedas;Pumpurėliai;8592046023;Ne;7;0;0;7
12441;Žiedas;Pumpurėliai;5814371567;Ne;13;0;0;13
12442;Žiedas;Pumpurėliai;4854055565;Ne;0;4;0;4
12443;Žiedas;Pumpurėliai;3075660919;Ne;9;0;0;9
12444;Žiedas;Pumpurėliai;7801566777;Ne;5;1;0;6
12445;Žiedas;Pumpurėliai;2013485224;Ne;1;0;0;1
12446;Žiedas;"Dobiliukai ";6066566242;Ne;5;1;0;6
12447;Žiedas;"Dobiliukai ";3654878543;Ne;9;0;0;9
12448;Žiedas;"Dobiliukai ";8444690698;Ne;16;0;1;17
12449;Žiedas;"Dobiliukai ";2715554681;Taip;12;1;0;13
12450;Žiedas;"Dobiliukai ";2132564079;Ne;5;0;3;8
12451;Žiedas;"Dobiliukai ";9586578606;Taip;5;10;1;16
12452;Žiedas;"Dobiliukai ";3940002957;Taip;0;2;0;2
12453;Žiedas;"Dobiliukai ";5353507617;Ne;15;1;0;16
12454;Žiedas;"Dobiliukai ";2794691006;Taip;8;0;0;8
12455;Žiedas;"Dobiliukai ";6665199013;Ne;9;0;0;9
12456;Žiedas;"Dobiliukai ";1852347789;Ne;0;0;2;2
12457;Žiedas;"Dobiliukai ";3284907486;Ne;4;0;0;4
12458;Žiedas;"Dobiliukai ";2633676360;Ne;0;0;7;7
12459;Žiedas;"Dobiliukai ";7677595571;Taip;10;1;3;14
12460;Žiedas;"Dobiliukai ";5106427067;Taip;5;0;0;5
12461;Žiedas;RŪTELĖS;1885623466;Ne;14;0;0;14
12462;Žiedas;RŪTELĖS;9464217926;Ne;6;1;0;7
12463;Žiedas;RŪTELĖS;9543860953;Ne;5;0;0;5
12464;Žiedas;RŪTELĖS;3247328978;Ne;4;0;0;4
12465;Žiedas;RŪTELĖS;4250009129;Ne;4;0;0;4
12466;Žiedas;RŪTELĖS;7399937598;Ne;0;6;0;6
12467;Žiedas;RŪTELĖS;1325715061;Ne;8;0;0;8
12468;Žiedas;RŪTELĖS;9111149805;Ne;0;2;0;2
12469;Žiedas;RŪTELĖS;4695900874;Ne;0;2;0;2
12470;Žiedas;RŪTELĖS;3258241663;Ne;2;1;0;3
12471;Žiedas;RŪTELĖS;6700593422;Ne;11;1;0;12
12472;Žiedas;RŪTELĖS;6245366671;Ne;0;7;0;7
12473;Žiedas;RŪTELĖS;3835714894;Ne;2;1;0;3
12474;Žiedas;RŪTELĖS;1956219718;Ne;0;2;0;2
12475;Žiedas;RŪTELĖS;4809093267;Ne;7;0;0;7
12476;Žiedas;RŪTELĖS;6856477482;Ne;5;0;0;5
12477;Žiedas;RŪTELĖS;1874460511;Ne;0;4;0;4
12478;Žiedas;RŪTELĖS;7150427502;Ne;5;1;0;6
12479;Žiedas;RŪTELĖS;1562699898;Taip;4;0;0;4
12480;Žiedas;RŪTELĖS;6312115234;Ne;3;0;0;3
12481;Žiedas;RŪTELĖS;3831917542;Ne;8;0;0;8
12482;Žiedas;RŪTELĖS;1669599543;Taip;13;0;2;15
12483;Žiedas;SAULĖGRĄŽOS;1011602827;Ne;0;2;1;3
12484;Žiedas;SAULĖGRĄŽOS;8887021328;Ne;5;0;0;5
12485;Žiedas;SAULĖGRĄŽOS;2932857132;Ne;0;0;1;1
12486;Žiedas;SAULĖGRĄŽOS;5552786845;Ne;1;2;1;4
12487;Žiedas;SAULĖGRĄŽOS;5658235821;Ne;1;1;0;2
12488;Žiedas;SAULĖGRĄŽOS;4992446383;Ne;1;0;0;1
12489;Žiedas;SAULĖGRĄŽOS;9057761408;Ne;0;1;0;1
12490;Žiedas;SAULĖGRĄŽOS;2026540724;Ne;0;1;0;1
12491;Žiedas;SAULĖGRĄŽOS;4564268323;Ne;0;5;1;6
12492;Žiedas;SAULĖGRĄŽOS;3437651010;Ne;0;1;0;1
12493;Žiedas;SAULĖGRĄŽOS;3422053505;Ne;7;8;0;15
12494;Žiedas;SAULĖGRĄŽOS;5274845525;Ne;0;2;1;3
12495;Žiedas;SAULĖGRĄŽOS;7057747531;Ne;0;2;0;2
12496;Žiedas;SAULĖGRĄŽOS;8819018248;Ne;0;5;0;5
12497;Žiedas;SAULĖGRĄŽOS;7604200899;Ne;0;1;0;1
12498;Žiedas;SAULĖGRĄŽOS;3303581707;Ne;0;1;0;1
12499;Žiedas;SAULĖGRĄŽOS;2134466899;Ne;0;2;1;3
12500;Žiedas;SAULĖGRĄŽOS;6822887260;Ne;0;1;0;1
12501;Žiedas;SAULĖGRĄŽOS;1253833615;Ne;0;2;0;2
12502;Žiedas;SAULĖGRĄŽOS;7172793351;Ne;0;2;1;3
12503;Žiedas;RUGIAGĖLĖS;1826599535;Ne;8;0;2;10
12504;Žiedas;RUGIAGĖLĖS;3477341028;Ne;0;10;0;10
12505;Žiedas;RUGIAGĖLĖS;2124086277;Ne;8;0;1;9
12506;Žiedas;RUGIAGĖLĖS;1093479755;Ne;0;0;2;2
12507;Žiedas;RUGIAGĖLĖS;7381658912;Ne;7;0;5;12
12508;Žiedas;RUGIAGĖLĖS;2148027253;Taip;6;0;1;7
12509;Žiedas;RUGIAGĖLĖS;1958481432;Ne;0;0;2;2
12510;Žiedas;RUGIAGĖLĖS;9393499257;Ne;7;1;0;8
12511;Žiedas;RUGIAGĖLĖS;8276022676;Taip;9;0;0;9
12512;Žiedas;RUGIAGĖLĖS;7418985667;Ne;3;0;0;3
12513;Žiedas;RUGIAGĖLĖS;6766710113;Ne;11;0;0;11
12514;Žiedas;RUGIAGĖLĖS;1835893385;Ne;16;0;0;16
12515;Žiedas;RUGIAGĖLĖS;2913328259;Ne;9;0;1;10
12516;Žiedas;RUGIAGĖLĖS;4568189195;Ne;1;1;0;2
12517;Žiedas;RUGIAGĖLĖS;7114207461;Taip;5;0;1;6
12518;Žiedas;RUGIAGĖLĖS;3407247493;Ne;5;0;1;6
12519;Žiedas;RUGIAGĖLĖS;6923562927;Taip;11;0;0;11
12520;Žiedas;RUGIAGĖLĖS;1509140770;Ne;0;0;1;1
12521;Žiedas;RUGIAGĖLĖS;7498211984;Ne;0;0;2;2
12522;Žiedas;RUGIAGĖLĖS;3948942801;Ne;0;4;0;4
12523;Žiedas;Boružėlės;9685152753;Ne;2;0;0;2
12524;Žiedas;Boružėlės;5914428064;Taip;0;7;0;7
12525;Žiedas;Boružėlės;3857121753;Taip;8;2;0;10
12526;Žiedas;Boružėlės;6443633568;Ne;0;2;0;2
12527;Žiedas;Boružėlės;5959899914;Ne;0;4;0;4
12528;Žiedas;Boružėlės;7333813704;Ne;2;1;0;3
12529;Žiedas;Boružėlės;3715928992;Ne;0;1;0;1
12530;Žiedas;Boružėlės;6658762922;Ne;0;7;0;7
12531;Žiedas;Boružėlės;7578964555;Ne;0;1;0;1
12532;Žiedas;Boružėlės;5928377774;Ne;0;0;1;1
12533;Žiedas;Boružėlės;5126173608;Ne;8;0;0;8
12534;Žiedas;Boružėlės;7072578987;Ne;6;0;3;9
12535;Žiedas;Boružėlės;5647232875;Ne;0;2;0;2
12536;Žiedas;Boružėlės;1738121071;Taip;3;4;0;7
12537;Žiedas;AGUONĖLĖS;5518670127;Ne;6;0;0;6
12538;Žiedas;AGUONĖLĖS;6162306565;Ne;0;0;1;1
12539;Žiedas;AGUONĖLĖS;5947851166;Ne;4;1;0;5
12540;Žiedas;AGUONĖLĖS;7159730702;Taip;1;0;0;1
12541;Žiedas;AGUONĖLĖS;8485801027;Ne;0;1;0;1
12542;Žiedas;AGUONĖLĖS;5789381608;Ne;4;0;0;4
12543;Žiedas;AGUONĖLĖS;1642330461;Ne;0;2;0;2
12544;Žiedas;AGUONĖLĖS;7161235417;Ne;3;0;0;3
12545;Žiedas;AGUONĖLĖS;5177625346;Ne;9;0;1;10
12546;Žiedas;ŽIBUTĖS;8638720939;Ne;10;0;1;11
12547;Žiedas;ŽIBUTĖS;2097392327;Ne;8;0;0;8
12548;Žiedas;ŽIBUTĖS;9269909624;Ne;7;6;0;13
12549;Žiedas;ŽIBUTĖS;2935037966;Ne;7;0;0;7
12550;Žiedas;ŽIBUTĖS;3271812706;Ne;2;0;0;2
12551;Žiedas;ŽIBUTĖS;6248399763;Ne;5;0;0;5
12552;Žiedas;ŽIBUTĖS;8163426046;Ne;1;1;0;2
12553;Žiedas;ŽIBUTĖS;4530564746;Ne;7;0;0;7
12554;Žiedas;ŽIBUTĖS;1546447912;Taip;2;1;0;3
12555;Žiedas;ŽIBUTĖS;3488618084;Ne;4;1;0;5
12556;Žiedas;ŽIBUTĖS;8651843785;Ne;3;0;0;3
12557;Žiedas;ŽIBUTĖS;9834096834;Ne;1;0;1;2
12558;Žiedas;DRUGELIAI;9763704573;Ne;5;0;0;5
12559;Žiedas;DRUGELIAI;5028265234;Ne;5;2;0;7
12560;Žiedas;DRUGELIAI;6852487760;Ne;12;3;0;15
12561;Žiedas;DRUGELIAI;8645771800;Ne;0;0;4;4
12562;Žiedas;DRUGELIAI;6041919197;Ne;0;8;0;8
12563;Žiedas;DRUGELIAI;8163645535;Ne;3;14;0;17
12564;Žiedas;DRUGELIAI;2182381160;Ne;6;1;0;7
12565;Žiedas;DRUGELIAI;8822472312;Ne;2;1;0;3
12566;Žiedas;DRUGELIAI;9021286246;Ne;11;2;0;13
12567;Žiedas;DRUGELIAI;6261847845;Ne;2;0;0;2
12568;Žiedas;DRUGELIAI;1219634640;Ne;0;2;0;2
12569;Žiedas;DRUGELIAI;2170318597;Ne;3;0;0;3
12570;Žiedas;DRUGELIAI;1333233100;Ne;3;2;0;5
12571;Žiogelis;SKRUZDELYTĖS;2959983278;Ne;0;2;0;2
12572;Žiogelis;SKRUZDELYTĖS;4677024422;Ne;4;0;0;4
12573;Žiogelis;SKRUZDELYTĖS;6165380986;Ne;2;0;0;2
12574;Žiogelis;SKRUZDELYTĖS;5281321968;Ne;1;0;0;1
12575;Žiogelis;SKRUZDELYTĖS;8410428124;Ne;3;0;0;3
12576;Žiogelis;SKRUZDELYTĖS;3214640817;Ne;6;1;0;7
12577;Žiogelis;SKRUZDELYTĖS;1937740173;Ne;0;1;0;1
12578;Žiogelis;SKRUZDELYTĖS;5737326104;Ne;2;0;0;2
12579;Žiogelis;SKRUZDELYTĖS;2614574694;Taip;0;1;0;1
12580;Žiogelis;SKRUZDELYTĖS;7107814348;Ne;4;5;0;9
12581;Žiogelis;SKRUZDELYTĖS;9243862028;Ne;3;0;0;3
12582;Žiogelis;SKRUZDELYTĖS;7395901559;Ne;0;2;0;2
12583;Žiogelis;SKRUZDELYTĖS;9819352425;Taip;0;12;0;12
12584;Žiogelis;SKRUZDELYTĖS;8780773039;Ne;0;14;0;14
12585;Žiogelis;SKRUZDELYTĖS;7881734492;Ne;5;0;0;5
12586;Žiogelis;SKRUZDELYTĖS;9120836406;Ne;3;0;0;3
12587;Žiogelis;SKRUZDELYTĖS;6742462116;Ne;0;1;0;1
12588;Žiogelis;SKRUZDELYTĖS;6608146625;Ne;3;0;0;3
12589;Žiogelis;SKRUZDELYTĖS;9035254979;Ne;6;0;0;6
12590;Žiogelis;ŽIRNIUKAI;9769735869;Ne;0;1;0;1
12591;Žiogelis;ŽIRNIUKAI;1106149118;Ne;0;1;0;1
12592;Žiogelis;ŽIRNIUKAI;9737574835;Ne;0;2;0;2
12593;Žiogelis;ŽIRNIUKAI;9842311161;Ne;0;1;0;1
12594;Žiogelis;ŽIRNIUKAI;2036243422;Ne;5;0;0;5
12595;Žiogelis;ŽIRNIUKAI;9634291623;Ne;3;1;0;4
12596;Žiogelis;ŽIRNIUKAI;6491130711;Ne;3;0;0;3
12597;Žiogelis;ŽIRNIUKAI;9378236361;Ne;12;0;0;12
12598;Žiogelis;ŽIRNIUKAI;5445409452;Ne;12;0;0;12
12599;Žiogelis;ŽIRNIUKAI;4155916507;Ne;0;2;0;2
12600;Žiogelis;ŽIRNIUKAI;4623532521;Ne;0;2;0;2
12601;Žiogelis;ŽIRNIUKAI;6988180082;Ne;5;5;0;10
12602;Žiogelis;ŽIRNIUKAI;4677227753;Ne;5;5;0;10
12603;Žiogelis;ŽIRNIUKAI;5996045442;Ne;6;0;0;6
12604;Žiogelis;ŽIRNIUKAI;5527793395;Ne;0;2;0;2
12605;Žiogelis;ŽIRNIUKAI;4974459437;Taip;8;0;0;8
12606;Žiogelis;ŽIRNIUKAI;8682279246;Taip;0;1;0;1
12607;Žiogelis;ŽIRNIUKAI;8664568879;Taip;0;1;0;1
12608;Žiogelis;ŽIRNIUKAI;9941105459;Ne;7;2;0;9
12609;Žiogelis;ŽIRNIUKAI;3199884855;Ne;12;0;0;12
12610;Žiogelis;ŽIRNIUKAI;5245672298;Ne;10;1;0;11
12611;Žiogelis;ŽIRNIUKAI;7804701635;Ne;7;0;0;7
12612;Žiogelis;DOBILĖLIAI;8485067381;Ne;5;0;0;5
12613;Žiogelis;DOBILĖLIAI;1618384759;Ne;0;1;0;1
12614;Žiogelis;DOBILĖLIAI;5054228916;Ne;0;0;1;1
12615;Žiogelis;DOBILĖLIAI;8712788346;Ne;3;1;0;4
12616;Žiogelis;DOBILĖLIAI;3428197871;Ne;0;1;0;1
12617;Žiogelis;DOBILĖLIAI;7535167450;Ne;0;0;4;4
12618;Žiogelis;DOBILĖLIAI;3361421852;Ne;0;1;0;1
12619;Žiogelis;DOBILĖLIAI;1268908081;Ne;0;3;0;3
12620;Žiogelis;DOBILĖLIAI;3856321373;Ne;3;5;0;8
12621;Žiogelis;DOBILĖLIAI;6378295945;Ne;4;2;2;8
12622;Žiogelis;DOBILĖLIAI;8959934210;Ne;0;3;0;3
12623;Žiogelis;DOBILĖLIAI;8591680136;Taip;0;3;0;3
12624;Žiogelis;DOBILĖLIAI;6980853713;Ne;0;4;2;6
12625;Žiogelis;DOBILĖLIAI;7340918175;Taip;0;7;0;7
12626;Žiogelis;DOBILĖLIAI;5454676924;Ne;2;1;0;3
12627;Žiogelis;DOBILĖLIAI;5487213418;Ne;9;1;0;10
12628;Žiogelis;DOBILĖLIAI;8058231095;Ne;9;2;0;11
12629;Žiogelis;DOBILĖLIAI;7702173581;Ne;1;2;0;3
12630;Žiogelis;DOBILĖLIAI;6593794147;Ne;1;10;0;11
12631;Žiogelis;DOBILĖLIAI;1650284820;Ne;0;1;0;1
12632;Žiogelis;DOBILĖLIAI;6515890056;Ne;8;2;2;12
12633;Žiogelis;DOBILĖLIAI;7310459638;Taip;1;2;0;3
12634;Žiogelis;DOBILĖLIAI;1763603533;Ne;13;0;3;16
12635;Žiogelis;BORUŽĖLĖS;8683148826;Ne;6;3;0;9
12636;Žiogelis;BORUŽĖLĖS;6532218580;Ne;2;0;1;3
12637;Žiogelis;BORUŽĖLĖS;1763070523;Taip;0;2;0;2
12638;Žiogelis;BORUŽĖLĖS;2117192553;Ne;1;0;0;1
12639;Žiogelis;BORUŽĖLĖS;3427704550;Ne;1;0;0;1
12640;Žiogelis;BORUŽĖLĖS;6115834138;Ne;0;21;0;21
12641;Žiogelis;BORUŽĖLĖS;1465027680;Ne;6;0;2;8
12642;Žiogelis;BORUŽĖLĖS;4103035195;Ne;0;0;1;1
12643;Žiogelis;BORUŽĖLĖS;3392582853;Ne;3;6;0;9
12644;Žiogelis;BORUŽĖLĖS;5557800297;Ne;3;6;0;9
12645;Žiogelis;BORUŽĖLĖS;6495456608;Ne;0;0;1;1
12646;Žiogelis;BORUŽĖLĖS;5364996984;Taip;2;10;0;12
12647;Žiogelis;BORUŽĖLĖS;9568208184;Taip;2;10;0;12
12648;Žiogelis;BORUŽĖLĖS;7065052244;Ne;2;0;0;2
12649;Žiogelis;BORUŽĖLĖS;6340620973;Ne;0;0;1;1
12650;Žiogelis;BORUŽĖLĖS;5961630249;Ne;5;0;1;6
12651;Žiogelis;BORUŽĖLĖS;3887222613;Ne;10;0;0;10
12652;Žiogelis;BORUŽĖLĖS;9610249055;Ne;0;0;1;1
12653;Žiogelis;BORUŽĖLĖS;3686409773;Taip;5;0;0;5
12654;Žiogelis;BORUŽĖLĖS;2122392982;Taip;0;0;2;2
12655;Žiogelis;DRUGELIAI;2797078863;Ne;11;0;0;11
12656;Žiogelis;DRUGELIAI;3813592739;Ne;1;0;0;1
12657;Žiogelis;DRUGELIAI;3820406417;Taip;0;10;0;10
12658;Žiogelis;DRUGELIAI;9533670829;Ne;6;0;1;7
12659;Žiogelis;DRUGELIAI;1673279182;Ne;9;7;0;16
12660;Žiogelis;DRUGELIAI;9964121573;Ne;2;0;6;8
12661;Žiogelis;DRUGELIAI;5104952346;Ne;3;0;2;5
12662;Žiogelis;DRUGELIAI;9717527407;Ne;0;8;0;8
12663;Žiogelis;DRUGELIAI;2622354022;Ne;0;1;0;1
12664;Žiogelis;DRUGELIAI;2243541285;Ne;0;1;0;1
12665;Žiogelis;DRUGELIAI;3810309354;Ne;21;0;0;21
12666;Žiogelis;DRUGELIAI;2326799191;Ne;0;0;10;10
12667;Žiogelis;DRUGELIAI;1833992163;Ne;11;0;0;11
12668;Žiogelis;DRUGELIAI;2529171444;Ne;5;0;0;5
12669;Žiogelis;DRUGELIAI;4946802677;Ne;0;0;5;5
12670;Žiogelis;DRUGELIAI;8763533677;Ne;0;6;1;7
12671;Žiogelis;DRUGELIAI;4994053705;Ne;0;1;0;1
12672;Žiogelis;DRUGELIAI;2655049586;Ne;9;0;1;10
12673;Žiogelis;DRUGELIAI;4120627587;Ne;0;1;2;3
12674;Žiogelis;PELĖDŽIUKAI;7128248940;Ne;0;4;0;4
12675;Žiogelis;PELĖDŽIUKAI;6709029770;Ne;0;4;0;4
12676;Žiogelis;PELĖDŽIUKAI;7502572217;Ne;6;1;0;7
12677;Žiogelis;PELĖDŽIUKAI;5876904663;Ne;0;2;1;3
12678;Žiogelis;PELĖDŽIUKAI;8217782981;Ne;0;11;0;11
12679;Žiogelis;PELĖDŽIUKAI;7120126547;Ne;0;1;0;1
12680;Žiogelis;PELĖDŽIUKAI;9387048672;Ne;0;6;0;6
12681;Žiogelis;PELĖDŽIUKAI;4378941619;Taip;4;1;0;5
12682;Žiogelis;PELĖDŽIUKAI;3937261260;Ne;0;3;0;3
12683;Žiogelis;PELĖDŽIUKAI;8873231715;Ne;0;0;2;2
12684;Žiogelis;PELĖDŽIUKAI;8894068297;Ne;0;2;0;2
12685;Žiogelis;PELĖDŽIUKAI;2160862681;Ne;0;1;0;1
12686;Žiogelis;PELĖDŽIUKAI;7725494899;Ne;0;1;0;1
12687;Žiogelis;PELĖDŽIUKAI;1939672072;Ne;4;0;1;5
12688;Žiogelis;PELĖDŽIUKAI;8689074067;Ne;0;5;0;5
12689;Žiogelis;PELĖDŽIUKAI;4565342104;Ne;9;1;0;10
12690;Žiogelis;PELĖDŽIUKAI;1223396469;Ne;4;0;0;4
12691;Žiogelis;PELĖDŽIUKAI;3500076229;Taip;0;12;0;12
12692;Žiogelis;PELĖDŽIUKAI;8715501524;Taip;0;2;14;16
12693;Žiogelis;PELĖDŽIUKAI;6347738933;Ne;10;1;0;11
12694;Žiogelis;PELĖDŽIUKAI;3520393042;Ne;1;2;0;3
12695;Žiogelis;VARPELIAI;8983731310;Ne;0;5;0;5
12696;Žiogelis;VARPELIAI;1954544417;Ne;0;1;0;1
12697;Žiogelis;VARPELIAI;9385596579;Ne;0;3;0;3
12698;Žiogelis;VARPELIAI;1447349850;Ne;10;1;0;11
12699;Žiogelis;VARPELIAI;3752358694;Ne;5;0;0;5
12700;Žiogelis;VARPELIAI;4462189852;Taip;0;7;0;7
12701;Žiogelis;VARPELIAI;8133583992;Ne;6;4;0;10
12702;Žiogelis;VARPELIAI;2346231162;Ne;0;4;0;4
12703;Žiogelis;VARPELIAI;6658457517;Ne;5;0;0;5
12704;Žiogelis;VARPELIAI;6650891980;Ne;10;0;0;10
12705;Žiogelis;VARPELIAI;5076511003;Ne;5;1;0;6
12706;Žiogelis;VARPELIAI;1139259000;Ne;11;0;0;11
12707;Žiogelis;VARPELIAI;7992701275;Ne;10;0;0;10
12708;Žiogelis;VARPELIAI;2238709964;Ne;7;2;0;9
12709;Žiogelis;VARPELIAI;5288197445;Ne;0;3;0;3
12710;Žiogelis;VARPELIAI;5336455992;Ne;8;1;0;9
12711;Žiogelis;VARPELIAI;9769801670;Taip;12;0;0;12
12712;Žiogelis;VARPELIAI;3606236367;Ne;0;5;0;5
12713;Žiogelis;VARPELIAI;5115094299;Ne;5;0;0;5
12714;Žiogelis;VARPELIAI;1647252870;Ne;6;5;0;11
12715;Žiogelis;KREGŽDUTĖS;5042341085;Ne;6;0;0;6
12716;Žiogelis;KREGŽDUTĖS;9766966628;Ne;1;2;0;3
12717;Žiogelis;KREGŽDUTĖS;8835394030;Ne;0;3;0;3
12718;Žiogelis;KREGŽDUTĖS;3752355139;Ne;0;1;0;1
12719;Žiogelis;KREGŽDUTĖS;9627583831;Ne;0;1;0;1
12720;Žiogelis;KREGŽDUTĖS;3296450902;Ne;0;2;0;2
12721;Žiogelis;KREGŽDUTĖS;4814936645;Ne;0;1;0;1
12722;Žiogelis;KREGŽDUTĖS;3792114246;Ne;0;1;0;1
12723;Žiogelis;KREGŽDUTĖS;9981130790;Ne;0;1;0;1
12724;Žiogelis;KREGŽDUTĖS;4605250897;Ne;2;0;0;2
12725;Žiogelis;KREGŽDUTĖS;3820534331;Ne;0;1;0;1
12726;Žiogelis;KREGŽDUTĖS;5139645108;Ne;0;3;0;3
12727;Žiogelis;KREGŽDUTĖS;9790463889;Ne;1;1;0;2
12728;Žiogelis;KREGŽDUTĖS;9874412804;Ne;2;2;0;4
12729;Žiogelis;KREGŽDUTĖS;6024752960;Ne;3;1;0;4
12730;Žiogelis;KREGŽDUTĖS;8853905367;Ne;3;1;0;4
12731;Žiogelis;KREGŽDUTĖS;1397686161;Ne;3;5;0;8
12732;Žiogelis;KREGŽDUTĖS;2171351454;Ne;0;2;0;2
12733;Žiogelis;KREGŽDUTĖS;2173494736;Ne;0;1;0;1
12734;Žiogelis;KREGŽDUTĖS;4156736676;Ne;0;1;0;1
12735;Žiogelis;KREGŽDUTĖS;1134384178;Ne;0;2;0;2
12736;Žiogelis;KREGŽDUTĖS;4609861306;Ne;0;1;0;1
12737;Žiogelis;KREGŽDUTĖS;2759766559;Ne;0;14;0;14
12738;Žiogelis;ŽVIRBLIUKAI;6718866954;Ne;1;0;0;1
12739;Žiogelis;ŽVIRBLIUKAI;4708377318;Ne;3;0;0;3
12740;Žiogelis;ŽVIRBLIUKAI;8601929848;Ne;3;0;0;3
12741;Žiogelis;ŽVIRBLIUKAI;2028344962;Ne;2;0;0;2
12742;Žiogelis;ŽVIRBLIUKAI;2925961701;Ne;8;0;0;8
12743;Žiogelis;ŽVIRBLIUKAI;3407223108;Ne;3;0;0;3
12744;Žiogelis;ŽVIRBLIUKAI;4924536259;Ne;3;0;0;3
12745;Žiogelis;ŽVIRBLIUKAI;1093662117;Ne;5;0;0;5
12746;Žiogelis;ŽVIRBLIUKAI;2540274386;Ne;5;0;0;5
12747;Žiogelis;ŽVIRBLIUKAI;4602474688;Ne;1;0;0;1
12748;Žiogelis;BITUTĖS;5337641310;Ne;11;0;0;11
12749;Žiogelis;BITUTĖS;2771911603;Ne;0;2;0;2
12750;Žiogelis;BITUTĖS;4561384361;Ne;3;0;0;3
12751;Žiogelis;BITUTĖS;6617995346;Ne;0;2;0;2
12752;Žiogelis;BITUTĖS;4755709634;Ne;2;0;0;2
12753;Žiogelis;BITUTĖS;7936785905;Taip;2;2;0;4
12754;Žiogelis;BITUTĖS;2348525913;Ne;11;0;0;11
12755;Žiogelis;BITUTĖS;3628571567;Ne;0;4;0;4
12756;Žiogelis;BITUTĖS;9142952548;Ne;0;8;0;8
12757;Žiogelis;BITUTĖS;4450344120;Ne;6;1;0;7
12758;Žiogelis;BITUTĖS;5223426277;Ne;6;0;0;6
12759;Žiogelis;BITUTĖS;8998694866;Ne;0;21;0;21
12760;Žiogelis;BITUTĖS;3472310047;Ne;0;2;0;2
12761;Žiogelis;BITUTĖS;8018943297;Ne;0;6;0;6
12762;Žiogelis;BITUTĖS;3516143432;Ne;8;0;0;8
12763;Žiogelis;BITUTĖS;2833768296;Ne;0;0;1;1
12764;Žiogelis;BITUTĖS;9918493914;Ne;5;0;0;5
12765;Žiogelis;BITUTĖS;2463360858;Ne;0;1;0;1
12766;Žiogelis;BITUTĖS;6857937795;Ne;15;0;0;15
12767;Žiogelis;BITUTĖS;1067136657;Ne;0;1;0;1
12768;Žiogelis;BITUTĖS;9672307977;Ne;0;1;0;1
12769;Žiogelis;BITUTĖS;2799966199;Ne;5;0;0;5
12770;Žiogelis;RIEŠUTĖLIAI;8634114085;Ne;1;0;0;1
12771;Žiogelis;RIEŠUTĖLIAI;6035707604;Ne;1;0;0;1
12772;Žiogelis;RIEŠUTĖLIAI;9869864499;Ne;4;0;0;4
12773;Žiogelis;RIEŠUTĖLIAI;8652050979;Ne;1;5;0;6
12774;Žiogelis;RIEŠUTĖLIAI;6470463492;Taip;0;4;0;4
12775;Žiogelis;RIEŠUTĖLIAI;2454569485;Ne;6;0;0;6
12776;Žiogelis;RIEŠUTĖLIAI;3242570582;Ne;6;0;0;6
12777;Žiogelis;PAKALNUTĖS;9144282935;Ne;0;15;0;15
12778;Žiogelis;PAKALNUTĖS;5741157573;Taip;0;0;1;1
12779;Žiogelis;PAKALNUTĖS;8485973974;Ne;0;0;3;3
12780;Žiogelis;PAKALNUTĖS;6039409252;Ne;2;1;1;4
12781;Žiogelis;PAKALNUTĖS;2275123126;Ne;1;0;1;2
12782;Žiogelis;PAKALNUTĖS;4587838884;Taip;2;11;0;13
12783;Žiogelis;PAKALNUTĖS;6048534817;Ne;2;0;0;2
12784;Žiogelis;PAKALNUTĖS;5133034709;Ne;0;2;0;2
12785;Žiogelis;PAKALNUTĖS;8303283893;Ne;1;2;0;3
12786;Žiogelis;PAKALNUTĖS;4147132498;Ne;0;3;0;3
12787;Žiogelis;PAKALNUTĖS;2724389716;Taip;1;0;0;1
12788;Žiogelis;PAKALNUTĖS;7763941077;Ne;8;0;0;8
12789;Žiogelis;PAKALNUTĖS;7008807839;Ne;2;0;1;3
12790;Žiogelis;PAKALNUTĖS;2518015116;Ne;0;0;1;1
12791;Žiogelis;PAKALNUTĖS;5984496369;Ne;0;5;0;5
12792;Žiogelis;PAKALNUTĖS;5475797764;Ne;1;0;0;1
12793;Žiogelis;PAKALNUTĖS;4376301940;Ne;0;0;2;2
12794;Žiogelis;PAKALNUTĖS;2177479618;Ne;0;0;2;2
12795;Žiogelis;PAKALNUTĖS;6213118462;Ne;0;0;4;4
12796;Žolynėlis;Spanguolėlė;8810441600;Taip;7;0;0;7
12797;Žolynėlis;Spanguolėlė;6440991320;Ne;11;1;0;12
12798;Žolynėlis;Spanguolėlė;3631138915;Ne;1;0;0;1
12799;Žolynėlis;Spanguolėlė;5218448120;Ne;2;1;0;3
12800;Žolynėlis;Spanguolėlė;4076450179;Ne;0;2;0;2
12801;Žolynėlis;Spanguolėlė;4494255525;Ne;0;7;0;7
12802;Žolynėlis;Spanguolėlė;2493633505;Ne;0;0;17;17
12803;Žolynėlis;Spanguolėlė;5438607463;Ne;0;1;0;1
12804;Žolynėlis;Spanguolėlė;5208585298;Ne;6;0;0;6
12805;Žolynėlis;Spanguolėlė;7451189254;Ne;3;0;0;3
12806;Žolynėlis;Spanguolėlė;9498369210;Ne;8;1;0;9
12807;Žolynėlis;Spanguolėlė;7260397656;Ne;0;1;0;1
12808;Žolynėlis;Spanguolėlė;2315947380;Ne;5;0;0;5
12809;Žolynėlis;Spanguolėlė;5074658392;Ne;5;0;0;5
12810;Žolynėlis;Spanguolėlė;3222329369;Ne;14;0;0;14
12811;Žolynėlis;"SAULUTĖ (spec)";9675783636;Ne;1;0;0;1
12812;Žolynėlis;"SAULUTĖ (spec)";7962304738;Ne;0;3;0;3
12813;Žolynėlis;"SAULUTĖ (spec)";3934182673;Ne;4;2;0;6
12814;Žolynėlis;"SAULUTĖ (spec)";8588753136;Ne;8;1;0;9
12815;Žolynėlis;"SAULUTĖ (spec)";9507509872;Ne;0;14;0;14
12816;Žolynėlis;"LINELIS (spec)";8930536051;Ne;0;2;0;2
12817;Žolynėlis;"LINELIS (spec)";6510930436;Ne;0;1;0;1
12818;Žolynėlis;"LINELIS (spec)";6619551947;Ne;21;0;0;21
12819;Žolynėlis;"LINELIS (spec)";5610113641;Ne;0;11;0;11
12820;Žolynėlis;"LINELIS (spec)";6678697536;Ne;21;0;0;21
12821;Žolynėlis;"LINELIS (spec)";3043560150;Ne;0;2;7;9
12822;Žolynėlis;"RASAKILA (spec)";4971887781;Ne;0;1;0;1
12823;Žolynėlis;"RASAKILA (spec)";4337084252;Ne;0;21;0;21
12824;Žolynėlis;"RASAKILA (spec)";4481343085;Ne;5;0;0;5
12825;Žolynėlis;"RASAKILA (spec)";8577197481;Ne;0;2;0;2
12826;Žolynėlis;"RASAKILA (spec)";2327996393;Ne;4;0;0;4
12827;Žolynėlis;"RAMUNĖLĖS (spec)";4559404699;Ne;10;1;0;11
12828;Žolynėlis;"RAMUNĖLĖS (spec)";1703785525;Ne;0;2;9;11
12829;Žolynėlis;"RAMUNĖLĖS (spec)";2072569949;Ne;0;1;0;1
12830;Žolynėlis;"RAMUNĖLĖS (spec)";1090944316;Ne;1;2;0;3
12831;Žolynėlis;"RAMUNĖLĖS (spec)";5729519418;Ne;8;2;0;10
12832;Žolynėlis;"RAMUNĖLĖS (spec)";7266224868;Ne;5;2;0;7
12833;Žolynėlis;"RAMUNĖLĖS (spec)";7085655808;Ne;5;1;0;6
12834;Žolynėlis;"RAMUNĖLĖS (spec)";3748657353;Ne;5;0;0;5
12835;Žolynėlis;Dobiliukai;2005661306;Ne;0;1;0;1
12836;Žolynėlis;Dobiliukai;2820649587;Ne;0;4;0;4
12837;Žolynėlis;Dobiliukai;7581436340;Ne;13;0;2;15
12838;Žolynėlis;Dobiliukai;3385748516;Taip;0;6;0;6
12839;Žolynėlis;Dobiliukai;2957426163;Ne;2;0;0;2
12840;Žolynėlis;Dobiliukai;5456771327;Ne;6;0;0;6
12841;Žolynėlis;Dobiliukai;8341730420;Taip;5;1;0;6
12842;Žolynėlis;Dobiliukai;5634886191;Ne;0;1;3;4
12843;Žolynėlis;Dobiliukai;3350246193;Ne;0;8;0;8
12844;Žolynėlis;Dobiliukai;5269388947;Ne;8;1;0;9
12845;Žolynėlis;Dobiliukai;1206144208;Ne;11;1;0;12
12846;Žolynėlis;Dobiliukai;1213384150;Ne;5;1;0;6
12847;Žolynėlis;Dobiliukai;7485033527;Ne;4;0;0;4
12848;Žolynėlis;Dobiliukai;7053810996;Taip;4;0;0;4
12849;Žolynėlis;Dobiliukai;4229530366;Ne;10;3;0;13
12850;Žolynėlis;Aguonėlė;3071570864;Ne;0;7;3;10
12851;Žolynėlis;Aguonėlė;1440666914;Ne;0;10;0;10
12852;Žolynėlis;Aguonėlė;1365534272;Ne;0;1;0;1
12853;Žolynėlis;Aguonėlė;2628636018;Ne;0;7;0;7
12854;Žolynėlis;Aguonėlė;6740105842;Ne;0;9;0;9
12855;Žolynėlis;Aguonėlė;3952731134;Ne;0;0;3;3
12856;Žolynėlis;Aguonėlė;6554864184;Ne;0;2;0;2
12857;Žolynėlis;Aguonėlė;9904373687;Ne;4;1;1;6
12858;Žolynėlis;Aguonėlė;9285539649;Ne;0;2;0;2
12859;Žolynėlis;Aguonėlė;5243624422;Taip;13;2;0;15
12860;Žolynėlis;Aguonėlė;4761054847;Ne;0;1;0;1
12861;Žolynėlis;Aguonėlė;6354832415;Ne;0;1;0;1
12862;Žolynėlis;Aguonėlė;1748987196;Ne;0;8;0;8
12863;Žolynėlis;Aguonėlė;3819863015;Ne;0;5;0;5
12864;Žolynėlis;Aguonėlė;4094173207;Ne;4;0;0;4
12865;Žolynėlis;Aguonėlė;6034854963;Ne;0;3;0;3
12866;Žolynėlis;Aguonėlė;1847470349;Ne;0;0;2;2
12867;Žolynėlis;Pienė;3520272555;Ne;0;5;0;5
12868;Žolynėlis;Pienė;1163753820;Ne;0;2;0;2
12869;Žolynėlis;Pienė;9238832484;Ne;0;2;0;2
12870;Žolynėlis;Pienė;3877168024;Ne;0;4;0;4
12871;Žolynėlis;Pienė;4618251201;Taip;0;5;0;5
12872;Žolynėlis;Pienė;1264022895;Ne;0;2;0;2
12873;Žolynėlis;Pienė;5332349177;Ne;0;4;3;7
12874;Žolynėlis;Pienė;5787331165;Ne;0;2;1;3
12875;Žolynėlis;Pienė;3091749692;Ne;5;1;0;6
12876;Žolynėlis;Pienė;2263679711;Taip;5;3;0;8
12877;Žolynėlis;Pienė;5149512625;Ne;0;1;0;1
12878;Žolynėlis;Pienė;5973298389;Ne;8;0;0;8
12879;Žolynėlis;Pienė;8552635547;Ne;4;3;0;7
12880;Žolynėlis;Pienė;2256262371;Ne;0;4;0;4
12881;Žolynėlis;Čiobreliai;8215427354;Ne;10;1;0;11
12882;Žolynėlis;Čiobreliai;7339496409;Ne;0;2;0;2
12883;Žolynėlis;Čiobreliai;2565770471;Ne;22;0;0;22
12884;Žolynėlis;Čiobreliai;6829144389;Ne;2;2;0;4
12885;Žolynėlis;Čiobreliai;2108221942;Ne;0;2;0;2
12886;Žolynėlis;Čiobreliai;2881461471;Ne;3;0;0;3
12887;Žolynėlis;Čiobreliai;7339110559;Ne;0;1;0;1
12888;Žolynėlis;Čiobreliai;2460982987;Ne;0;2;0;2
12889;Žolynėlis;Čiobreliai;3088932720;Ne;0;1;0;1
12890;Žolynėlis;Čiobreliai;6679254518;Ne;0;1;0;1
12891;Žolynėlis;Čiobreliai;6763515483;Taip;0;1;0;1
12892;Žolynėlis;Čiobreliai;5432464074;Ne;0;1;0;1
12893;Žolynėlis;Čiobreliai;6416217971;Ne;0;7;0;7
12894;Žolynėlis;Čiobreliai;1879046798;Ne;0;8;0;8
12895;Žolynėlis;Čiobreliai;2934361190;Ne;2;0;0;2
12896;Žolynėlis;Avietėlė;4277871671;Ne;5;1;0;6
12897;Žolynėlis;Avietėlė;9404844632;Ne;5;1;0;6
12898;Žolynėlis;Avietėlė;5873931225;Ne;9;3;0;12
12899;Žolynėlis;Avietėlė;1266614631;Ne;0;0;1;1
12900;Žolynėlis;Avietėlė;7855260478;Ne;0;1;1;2
12901;Žolynėlis;Avietėlė;2718255075;Ne;5;2;0;7
12902;Žolynėlis;Avietėlė;7517815798;Ne;10;0;0;10
12903;Žolynėlis;Avietėlė;5771745015;Ne;0;0;1;1
12904;Žolynėlis;Avietėlė;5581675294;Ne;1;0;10;11
12905;Žolynėlis;Avietėlė;1108820859;Ne;13;0;0;13
12906;Žolynėlis;Avietėlė;9905727117;Ne;5;0;1;6
12907;Žolynėlis;Avietėlė;4221470753;Ne;0;2;4;6
12908;Žolynėlis;Avietėlė;5234937076;Ne;5;0;5;10
12909;Žolynėlis;RŪTELĖ;3293250169;Ne;1;0;0;1
12910;Žolynėlis;RŪTELĖ;9993230229;Ne;5;8;0;13
12911;Žolynėlis;RŪTELĖ;7264446456;Ne;0;6;0;6
12912;Žolynėlis;RŪTELĖ;3857544079;Taip;6;0;1;7
12913;Žolynėlis;RŪTELĖ;3401352504;Ne;0;0;1;1
12914;Žolynėlis;RŪTELĖ;5175997689;Ne;6;1;0;7
12915;Žolynėlis;RŪTELĖ;4780520358;Ne;3;0;0;3
12916;Žolynėlis;RŪTELĖ;3804251134;Ne;6;0;0;6
12917;Žolynėlis;RŪTELĖ;5769654742;Ne;0;0;2;2
12918;Žuvėdra;"JŪROS ŽVAIGŽDUTĖS";1200084485;Ne;10;0;1;11
12919;Žuvėdra;"JŪROS ŽVAIGŽDUTĖS";4177319374;Taip;0;0;2;2
12920;Žuvėdra;"JŪROS ŽVAIGŽDUTĖS";7121154799;Ne;11;0;5;16
12921;Žuvėdra;"JŪROS ŽVAIGŽDUTĖS";8162649794;Taip;0;1;0;1
12922;Žuvėdra;"JŪROS ŽVAIGŽDUTĖS";7710853637;Taip;0;0;1;1
12923;Žuvėdra;"JŪROS ŽVAIGŽDUTĖS";2858729034;Taip;0;9;0;9
12924;Žuvėdra;"JŪROS ŽVAIGŽDUTĖS";7958768355;Ne;5;0;0;5
12925;Žuvėdra;"JŪROS ŽVAIGŽDUTĖS";5571732399;Ne;0;0;1;1
12926;Žuvėdra;"JŪROS ŽVAIGŽDUTĖS";3620753237;Ne;0;0;1;1
12927;Žuvėdra;"JŪROS ŽVAIGŽDUTĖS";1974766090;Ne;15;1;0;16
12928;Žuvėdra;"JŪROS ŽVAIGŽDUTĖS";8869169590;Taip;12;3;0;15
12929;Žuvėdra;"JŪROS ŽVAIGŽDUTĖS";2082128566;Ne;0;9;0;9
12930;Žuvėdra;"JŪROS ŽVAIGŽDUTĖS";6952843736;Ne;0;1;0;1
12931;Žuvėdra;DELFINUKAI;7235005234;Ne;5;0;0;5
12932;Žuvėdra;DELFINUKAI;5876618912;Ne;10;0;3;13
12933;Žuvėdra;DELFINUKAI;6989906913;Ne;0;1;0;1
12934;Žuvėdra;DELFINUKAI;4702627979;Ne;0;0;1;1
12935;Žuvėdra;DELFINUKAI;7803397430;Ne;5;0;0;5
12936;Žuvėdra;DELFINUKAI;7705946236;Taip;5;3;0;8
12937;Žuvėdra;DELFINUKAI;3069506904;Ne;0;7;0;7
12938;Žuvėdra;DELFINUKAI;5913580058;Ne;0;0;3;3
12939;Žuvėdra;DELFINUKAI;9651268462;Ne;0;0;4;4
12940;Žuvėdra;DELFINUKAI;3423051494;Ne;7;0;1;8
12941;Žuvėdra;DELFINUKAI;4881712317;Ne;5;2;0;7
12942;Žuvėdra;DELFINUKAI;1993897043;Ne;0;0;2;2
12943;Žuvėdra;DELFINUKAI;9200342856;Taip;12;0;3;15
12944;Žuvėdra;DELFINUKAI;1604010000;Ne;3;1;0;4
12945;Žuvėdra;DELFINUKAI;9914814198;Taip;0;0;1;1
12946;Žuvėdra;OSMINOŽKI;5273726957;Ne;9;0;0;9
12947;Žuvėdra;OSMINOŽKI;5674529681;Ne;0;16;0;16
12948;Žuvėdra;OSMINOŽKI;7368183516;Ne;0;11;0;11
12949;Žuvėdra;OSMINOŽKI;3853045274;Ne;0;13;0;13
12950;Žuvėdra;OSMINOŽKI;3185158741;Taip;1;0;0;1
12951;Žuvėdra;OSMINOŽKI;5198825127;Taip;12;7;0;19
12952;Žuvėdra;OSMINOŽKI;5561903903;Ne;1;0;0;1
12953;Žuvėdra;OSMINOŽKI;5818639448;Ne;1;0;0;1
12954;Žuvėdra;OSMINOŽKI;3613045982;Ne;6;14;0;20
12955;Žuvėdra;OSMINOŽKI;7467154866;Ne;0;10;0;10
12956;Žuvėdra;OSMINOŽKI;5151984122;Ne;0;1;0;1
12957;Žuvėdra;OSMINOŽKI;6862766787;Ne;14;0;0;14
12958;Žuvėdra;OSMINOŽKI;6715416675;Ne;5;0;0;5
12959;Žuvėdra;OSMINOŽKI;3349158713;Ne;2;0;0;2
12960;Žuvėdra;OSMINOŽKI;8942228415;Ne;2;0;0;2
12961;Žuvėdra;RUSALAČKA;4715123063;Ne;0;3;0;3
12962;Žuvėdra;RUSALAČKA;1707519901;Ne;0;7;1;8
12963;Žuvėdra;RUSALAČKA;1960306957;Ne;0;10;0;10
12964;Žuvėdra;RUSALAČKA;2577280901;Ne;11;0;2;13
12965;Žuvėdra;RUSALAČKA;5481785360;Ne;3;0;0;3
12966;Žuvėdra;RUSALAČKA;9011276878;Ne;6;6;0;12
12967;Žuvėdra;RUSALAČKA;7387863175;Ne;0;16;0;16
12968;Žuvėdra;RUSALAČKA;7464494386;Ne;0;1;0;1
12969;Žuvėdra;RUSALAČKA;3058300342;Ne;0;1;0;1
12970;Žuvėdra;RUSALAČKA;7227722516;Ne;12;0;0;12
12971;Žuvėdra;RUSALAČKA;4893062971;Ne;2;0;2;4
12972;Žuvėdra;RUSALAČKA;1219808187;Taip;6;1;0;7
12973;Žuvėdra;RUSALAČKA;7908898376;Ne;10;0;1;11
12974;Žuvėdra;RUSALAČKA;2197976174;Ne;0;0;1;1
12975;Žuvėdra;RUSALAČKA;9838754800;Ne;4;0;0;4
12976;Žuvėdra;RUSALAČKA;3781157324;Ne;0;10;0;10
12977;Žuvėdra;RUSALAČKA;1171751803;Ne;0;1;0;1
12978;Žuvėdra;RUSALAČKA;1039661177;Taip;7;5;0;12
12979;Žuvėdra;JANTARIKI;1929548863;Ne;8;0;0;8
12980;Žuvėdra;JANTARIKI;9256424331;Ne;16;1;0;17
12981;Žuvėdra;JANTARIKI;2789379055;Ne;11;0;0;11
12982;Žuvėdra;JANTARIKI;9610223932;Ne;8;0;0;8
12983;Žuvėdra;JANTARIKI;9410938471;Ne;3;1;0;4
12984;Žuvėdra;JANTARIKI;1526878181;Ne;17;0;0;17
12985;Žuvėdra;JANTARIKI;5272918949;Ne;0;7;0;7
12986;Žuvėdra;JANTARIKI;1352508839;Ne;0;2;0;2
12987;Žuvėdra;JANTARIKI;8224363978;Ne;11;0;0;11
12988;Žuvėdra;JANTARIKI;1224866951;Ne;5;0;0;5
12989;Žuvėdra;"AUKSINĖ ŽUVELĖ";6287034023;Ne;4;0;0;4
12990;Žuvėdra;"AUKSINĖ ŽUVELĖ";9460887312;Ne;0;1;4;5
12991;Žuvėdra;"AUKSINĖ ŽUVELĖ";5009153711;Taip;12;1;0;13
12992;Žuvėdra;"AUKSINĖ ŽUVELĖ";4739865462;Ne;0;5;0;5
12993;Žuvėdra;"AUKSINĖ ŽUVELĖ";7135848009;Ne;5;5;0;10
12994;Žuvėdra;"AUKSINĖ ŽUVELĖ";9215777054;Ne;0;0;1;1
12995;Žuvėdra;"AUKSINĖ ŽUVELĖ";6451721553;Ne;10;0;1;11
12996;Žuvėdra;"AUKSINĖ ŽUVELĖ";4447517071;Ne;5;0;0;5
12997;Žuvėdra;"AUKSINĖ ŽUVELĖ";2118573300;Ne;10;0;0;10
12998;Žvangutis;PELIUKŲ;7616874368;Ne;0;2;0;2
12999;Žvangutis;PELIUKŲ;3906808900;Ne;3;0;0;3
13000;Žvangutis;PELIUKŲ;7722153982;Ne;1;0;0;1
13001;Žvangutis;PELIUKŲ;4295016449;Ne;5;1;0;6
13002;Žvangutis;PELIUKŲ;9958554027;Ne;0;1;0;1
13003;Žvangutis;PELIUKŲ;8592522675;Ne;0;11;0;11
13004;Žvangutis;PELIUKŲ;3957064486;Ne;7;0;0;7
13005;Žvangutis;PELIUKŲ;5817402847;Ne;0;19;0;19
13006;Žvangutis;PELIUKŲ;4407484687;Ne;6;1;0;7
13007;Žvangutis;PELIUKŲ;5638068914;Ne;0;7;0;7
13008;Žvangutis;PELIUKŲ;4337928288;Ne;0;1;0;1
13009;Žvangutis;PELIUKŲ;3875906173;Ne;5;2;0;7
13010;Žvangutis;PELIUKŲ;1328464199;Ne;7;2;1;10
13011;Žvangutis;PELIUKŲ;3546672690;Ne;0;1;0;1
13012;Žvangutis;PELIUKŲ;4992231141;Ne;2;1;0;3
13013;Žvangutis;PELIUKŲ;3408933802;Ne;0;0;1;1
13014;Žvangutis;PELIUKŲ;8481666202;Ne;3;0;3;6
13015;Žvangutis;PELIUKŲ;4705131089;Ne;1;0;0;1
13016;Žvangutis;PELIUKŲ;7844987649;Ne;0;4;0;4
13017;Žvangutis;ANČIUKŲ;2308726385;Ne;9;0;0;9
13018;Žvangutis;ANČIUKŲ;5539992579;Ne;0;1;0;1
13019;Žvangutis;ANČIUKŲ;8295525284;Ne;1;1;0;2
13020;Žvangutis;ANČIUKŲ;1324948757;Taip;0;4;0;4
13021;Žvangutis;ANČIUKŲ;6068428687;Ne;0;2;0;2
13022;Žvangutis;ANČIUKŲ;1322688456;Ne;0;1;0;1
13023;Žvangutis;ANČIUKŲ;9149037184;Ne;0;2;0;2
13024;Žvangutis;ANČIUKŲ;1404378308;Ne;0;6;0;6
13025;Žvangutis;ANČIUKŲ;1185135525;Ne;0;2;0;2
13026;Žvangutis;ANČIUKŲ;5012996199;Ne;1;4;0;5
13027;Žvangutis;ANČIUKŲ;2623107843;Ne;0;1;0;1
13028;Žvangutis;ANČIUKŲ;3276065009;Ne;3;0;0;3
13029;Žvangutis;ANČIUKŲ;5723728310;Ne;0;1;0;1
13030;Žvangutis;ANČIUKŲ;2570379643;Ne;0;7;0;7
13031;Žvangutis;ANČIUKŲ;9036869235;Ne;0;1;0;1
13032;Žvangutis;ANČIUKŲ;2922083476;Ne;0;2;0;2
13033;Žvangutis;ANČIUKŲ;6040986672;Ne;8;2;0;10
13034;Žvangutis;ANČIUKŲ;2716216474;Ne;0;2;0;2
13035;Žvangutis;PELĖDŽIUKŲ;7599491698;Ne;0;8;0;8
13036;Žvangutis;PELĖDŽIUKŲ;6094686500;Taip;0;0;2;2
13037;Žvangutis;PELĖDŽIUKŲ;9711017196;Taip;0;0;1;1
13038;Žvangutis;PELĖDŽIUKŲ;7051007224;Ne;2;0;0;2
13039;Žvangutis;PELĖDŽIUKŲ;8906823569;Ne;0;15;0;15
13040;Žvangutis;PELĖDŽIUKŲ;8753815074;Taip;0;0;1;1
13041;Žvangutis;PELĖDŽIUKŲ;8506809320;Ne;0;2;0;2
13042;Žvangutis;PELĖDŽIUKŲ;8376022173;Ne;10;0;2;12
13043;Žvangutis;PELĖDŽIUKŲ;6825952779;Ne;8;0;1;9
13044;Žvangutis;PELĖDŽIUKŲ;4920234186;Ne;3;0;0;3
13045;Žvangutis;PELĖDŽIUKŲ;8598396569;Ne;7;1;0;8
13046;Žvangutis;PELĖDŽIUKŲ;9306755042;Ne;5;0;0;5
13047;Žvangutis;PELĖDŽIUKŲ;1352736819;Taip;0;0;1;1
13048;Žvangutis;PELĖDŽIUKŲ;2298103025;Ne;9;0;1;10
13049;Žvangutis;PELĖDŽIUKŲ;5126809299;Taip;6;0;1;7
13050;Žvangutis;PELĖDŽIUKŲ;9883337991;Taip;6;0;0;6
13051;Žvangutis;KAČIUKŲ;7213349517;Ne;0;1;0;1
13052;Žvangutis;KAČIUKŲ;7581320158;Ne;0;2;0;2
13053;Žvangutis;KAČIUKŲ;2296360416;Ne;0;5;0;5
13054;Žvangutis;KAČIUKŲ;7721746116;Taip;0;6;0;6
13055;Žvangutis;KAČIUKŲ;2598842770;Ne;0;1;0;1
13056;Žvangutis;KAČIUKŲ;1142315595;Ne;0;1;0;1
13057;Žvangutis;KAČIUKŲ;9239279639;Ne;0;1;0;1
13058;Žvangutis;KAČIUKŲ;4696437804;Ne;0;1;0;1
13059;Žvangutis;KAČIUKŲ;8492637734;Ne;9;1;0;10
13060;Žvangutis;KAČIUKŲ;2503355659;Ne;0;1;0;1
13061;Žvangutis;KAČIUKŲ;8360356476;Ne;0;3;0;3
13062;Žvangutis;KAČIUKŲ;8863909185;Ne;11;6;0;17
13063;Žvangutis;KAČIUKŲ;3498584864;Taip;3;1;0;4
13064;Žvangutis;KAČIUKŲ;4408086513;Ne;0;12;0;12
13065;Žvangutis;KAČIUKŲ;1256264382;Ne;0;9;0;9
13066;Žvangutis;KAČIUKŲ;8030520477;Ne;8;1;0;9
13067;Žvangutis;KAČIUKŲ;5166614226;Ne;1;10;0;11
13068;Žvangutis;KAČIUKŲ;2740875969;Ne;7;0;0;7
13069;Žvangutis;KAČIUKŲ;8269992031;Ne;7;0;0;7
13070;Žvangutis;KAČIUKŲ;1224292338;Ne;1;0;0;1
13071;Žvangutis;MEŠKUČIŲ;5162865213;Ne;3;0;0;3
13072;Žvangutis;MEŠKUČIŲ;8324813274;Ne;9;0;0;9
13073;Žvangutis;MEŠKUČIŲ;7098816023;Taip;0;0;2;2
13074;Žvangutis;MEŠKUČIŲ;3734153710;Ne;6;0;0;6
13075;Žvangutis;MEŠKUČIŲ;5780339899;Ne;7;0;0;7
13076;Žvangutis;MEŠKUČIŲ;6189100246;Ne;0;1;0;1
13077;Žvangutis;MEŠKUČIŲ;6329268519;Ne;2;0;0;2
13078;Žvangutis;MEŠKUČIŲ;5579521166;Ne;5;0;0;5
13079;Žvangutis;KIŠKUČIŲ;3940893168;Ne;0;0;1;1
13080;Žvangutis;KIŠKUČIŲ;1592158260;Ne;7;0;0;7
13081;Žvangutis;KIŠKUČIŲ;7645908955;Ne;5;0;0;5
13082;Žvangutis;KIŠKUČIŲ;6741623841;Ne;0;0;5;5
13083;Žvangutis;KIŠKUČIŲ;4128856598;Taip;0;0;1;1
13084;Žvangutis;KIŠKUČIŲ;4968365511;Taip;9;0;2;11
13085;Žvangutis;KIŠKUČIŲ;1706200292;Ne;5;0;0;5
13086;Žvangutis;KIŠKUČIŲ;5328547183;Ne;6;0;0;6
13087;Žvangutis;KIŠKUČIŲ;4471191112;Ne;1;0;2;3
13088;Žvangutis;KIŠKUČIŲ;6768957624;Ne;5;0;0;5
13089;Žvangutis;KIŠKUČIŲ;8233392333;Ne;12;0;1;13
13090;Žvangutis;KIŠKUČIŲ;2284700283;Ne;2;0;1;3
13091;Žvangutis;KIŠKUČIŲ;9292902597;Taip;0;0;7;7
13092;Žirniukas;Boružiukų;5311746004;Ne;0;0;13;13
13093;Žirniukas;Boružiukų;2476906136;Ne;0;1;0;1
13094;Žirniukas;Boružiukų;2528905738;Ne;0;11;0;11
13095;Žirniukas;Boružiukų;6268788036;Ne;7;1;0;8
13096;Žirniukas;Boružiukų;6363169823;Ne;0;3;0;3
13097;Žirniukas;Boružiukų;2636634198;Ne;1;6;0;7
13098;Žirniukas;Boružiukų;8148254025;Ne;2;2;0;4
13099;Žirniukas;Boružiukų;6531175340;Ne;0;1;0;1
13100;Žirniukas;Boružiukų;3022672028;Ne;7;6;0;13
13101;Žirniukas;Boružiukų;8180092480;Ne;5;0;0;5
13102;Žirniukas;Boružiukų;9896989995;Ne;0;2;0;2
13103;Žirniukas;Boružiukų;7397202752;Ne;0;2;1;3
13104;Žirniukas;Boružiukų;4233026576;Ne;0;0;2;2
13105;Žirniukas;Boružiukų;6598851580;Ne;6;2;4;12
13106;Žirniukas;Boružiukų;7965050711;Ne;0;0;9;9
13107;Žirniukas;Boružiukų;9986289837;Ne;2;0;1;3
13108;Žirniukas;Boružiukų;7872611724;Ne;0;2;4;6
13109;Žirniukas;Boružiukų;3189741449;Ne;0;1;0;1
13110;Žirniukas;Boružiukų;2140863010;Ne;0;2;10;12
13111;Žirniukas;Smalsučiai;5819443551;Ne;0;1;0;1
13112;Žirniukas;Smalsučiai;6096664609;Ne;2;2;0;4
13113;Žirniukas;Smalsučiai;1074945082;Ne;8;1;0;9
13114;Žirniukas;Smalsučiai;4433579937;Ne;0;1;0;1
13115;Žirniukas;Smalsučiai;1594735501;Ne;2;1;0;3
13116;Žirniukas;Smalsučiai;4229687519;Ne;0;2;0;2
13117;Žirniukas;Smalsučiai;2733313392;Ne;2;1;0;3
13118;Žirniukas;Smalsučiai;9707776533;Ne;6;0;0;6
13119;Žirniukas;Smalsučiai;7278153529;Ne;6;0;0;6
13120;Žirniukas;Smalsučiai;8151071354;Ne;9;0;0;9
13121;Žirniukas;Smalsučiai;7927815250;Ne;5;0;0;5
13122;Žirniukas;Smalsučiai;2325139043;Ne;0;2;0;2
13123;Žirniukas;Smalsučiai;4527367786;Ne;0;1;0;1
13124;Žirniukas;Smalsučiai;8599313527;Taip;8;2;0;10
13125;Žirniukas;Smalsučiai;4320686646;Ne;0;5;0;5
13126;Žirniukas;Smalsučiai;3610402086;Ne;0;1;0;1
13127;Žirniukas;Smalsučiai;6362626389;Ne;7;1;0;8
13128;Žirniukas;Smalsučiai;9961947583;Ne;4;0;0;4
13129;Žirniukas;Smalsučiai;4045432303;Ne;5;1;0;6
13130;Žirniukas;Gėlyčių;2982628594;Ne;2;0;0;2
13131;Žirniukas;Gėlyčių;6121388208;Taip;4;0;0;4
13132;Žirniukas;Gėlyčių;6201949014;Ne;3;0;4;7
13133;Žirniukas;Gėlyčių;5103440019;Ne;0;5;0;5
13134;Žirniukas;Gėlyčių;9497414375;Taip;0;0;2;2
13135;Žirniukas;Gėlyčių;5427116799;Ne;3;0;1;4
13136;Žirniukas;Gėlyčių;9021495553;Ne;0;9;0;9
13137;Žirniukas;Gėlyčių;6147030672;Ne;2;0;1;3
13138;Žirniukas;Gėlyčių;2423974973;Ne;3;0;0;3
13139;Žirniukas;Gėlyčių;2789026451;Ne;2;0;0;2
13140;Žirniukas;Gėlyčių;2221770310;Ne;2;0;0;2
13141;Žirniukas;Gėlyčių;6788087742;Ne;0;5;0;5
13142;Žirniukas;Nykštukų;5734197350;Ne;0;1;0;1
13143;Žirniukas;Nykštukų;2746074694;Ne;0;1;0;1
13144;Žirniukas;Nykštukų;4282344625;Ne;0;1;0;1
13145;Žirniukas;Nykštukų;3874713264;Ne;1;0;0;1
13146;Žirniukas;Nykštukų;7368124402;Ne;5;1;0;6
13147;Žirniukas;Nykštukų;1635353228;Ne;3;2;0;5
13148;Žirniukas;Nykštukų;2526769571;Ne;2;11;0;13
13149;Žirniukas;Nykštukų;2027344763;Ne;1;2;0;3
13150;Žirniukas;Nykštukų;9478756666;Ne;0;1;0;1
13151;Žirniukas;Nykštukų;4732089209;Ne;1;3;1;5
13152;Žirniukas;Nykštukų;9988669252;Ne;0;2;0;2
13153;Žirniukas;Nykštukų;8242086461;Ne;0;10;0;10
13154;Žirniukas;Nykštukų;8242086461;Ne;0;10;0;10
13155;Žirniukas;Nykštukų;8242086461;Ne;0;10;0;10
13156;Žirniukas;Nykštukų;6511802399;Ne;0;10;0;10
13157;Žirniukas;Nykštukų;6511802399;Ne;0;10;0;10
13158;Žirniukas;Nykštukų;6511802399;Ne;0;10;0;10
13159;Žirniukas;Nykštukų;8053289965;Ne;11;1;0;12
13160;Žirniukas;Nykštukų;2635969699;Ne;4;0;0;4
13161;Žirniukas;Nykštukų;5422282267;Ne;8;0;0;8
13162;Žirniukas;Saulytės;5613818351;Ne;4;1;0;5
13163;Žirniukas;Saulytės;1345594362;Ne;5;0;1;6
13164;Žirniukas;Saulytės;9847840127;Taip;0;10;3;13
13165;Žirniukas;Saulytės;1005139737;Ne;5;5;0;10
13166;Žirniukas;Saulytės;7968189099;Ne;5;1;3;9
13167;Žirniukas;Saulytės;7081683726;Ne;0;6;0;6
13168;Žirniukas;Saulytės;7021496832;Ne;2;0;0;2
13169;Žirniukas;Saulytės;1449763041;Ne;0;0;1;1
13170;Žirniukas;Saulytės;7269948694;Ne;4;0;0;4
13171;Žirniukas;Saulytės;1679864330;Ne;6;0;0;6
13172;Žirniukas;Saulytės;3438394768;Ne;0;0;4;4
13173;Žirniukas;Saulytės;9569187800;Ne;0;1;0;1
13174;Žirniukas;Saulytės;2302878611;Ne;0;5;0;5
13175;Žirniukas;Saulytės;2115471433;Taip;0;2;0;2
13176;Žirniukas;Saulytės;3603956795;Ne;5;0;0;5
13177;Žirniukas;Saulytės;4902056654;Ne;5;0;0;5
13178;Žirniukas;Saulytės;7563892184;Ne;5;0;0;5
13179;Žirniukas;Drugelių;6271194358;Ne;0;5;0;5
13180;Žirniukas;Drugelių;9232828844;Ne;0;2;0;2
13181;Žirniukas;Drugelių;5269074776;Ne;0;0;7;7
13182;Žirniukas;Drugelių;3509857181;Ne;0;1;1;2
13183;Žirniukas;Drugelių;2517524802;Ne;0;1;0;1
13184;Žirniukas;Drugelių;9901196251;Ne;0;7;1;8
13185;Žirniukas;Drugelių;4762596462;Ne;0;0;1;1
13186;Žirniukas;Drugelių;5046469974;Ne;5;1;0;6
13187;Žirniukas;Drugelių;1826203483;Ne;5;0;0;5
13188;Žirniukas;Drugelių;4536071547;Ne;0;1;1;2
13189;Žirniukas;Drugelių;3996393849;Ne;9;1;0;10
13190;Žirniukas;Drugelių;7240364379;Ne;0;1;2;3
13191;Žirniukas;Drugelių;6300372863;Ne;0;5;0;5
13192;Žirniukas;Drugelių;5670489807;Ne;0;5;0;5
13193;Žirniukas;Drugelių;9794535841;Ne;15;0;0;15
13194;Žirniukas;Drugelių;1031316325;Ne;5;0;0;5
13195;Žirniukas;Drugelių;1018506580;Ne;0;8;0;8
13196;Žirniukas;Drugelių;9384464752;Ne;0;2;0;2
13197;Žirniukas;Pelėdžiukai;7889803840;Ne;3;0;0;3
13198;Žirniukas;Pelėdžiukai;2895924102;Ne;5;10;0;15
13199;Žirniukas;Pelėdžiukai;4347695841;Ne;1;10;0;11
13200;Žirniukas;Pelėdžiukai;4847093256;Ne;1;0;0;1
13201;Žirniukas;Pelėdžiukai;7356213150;Ne;0;3;0;3
13202;Žirniukas;Pelėdžiukai;7545458622;Taip;0;2;0;2
13203;Žirniukas;Pelėdžiukai;8354728917;Ne;0;1;0;1
13204;Žirniukas;Pelėdžiukai;9511974432;Ne;0;1;0;1
13205;Žirniukas;Pelėdžiukai;7755938379;Ne;1;0;0;1
13206;Žirniukas;Pelėdžiukai;5470692657;Taip;4;2;0;6
13207;Žirniukas;Pelėdžiukai;8808445761;Taip;0;2;0;2
13208;Žirniukas;Pelėdžiukai;2332260494;Ne;1;1;0;2
13209;Žirniukas;Pelėdžiukai;6941160450;Ne;3;0;0;3
13210;Žirniukas;Pelėdžiukai;4464151713;Ne;1;5;0;6
13211;Žirniukas;Pelėdžiukai;3907578167;Taip;2;1;0;3
13212;Žirniukas;Pelėdžiukai;4069128550;Ne;2;0;0;2
13213;Žirniukas;Pelėdžiukai;7767762079;Ne;0;1;0;1
13214;Žirniukas;ZUIKUČIAI;4860680720;Ne;7;1;0;8
13215;Žirniukas;ZUIKUČIAI;9993119353;Ne;0;1;0;1
13216;Žirniukas;ZUIKUČIAI;4519996144;Ne;0;2;4;6
13217;Žirniukas;ZUIKUČIAI;7530076269;Ne;4;2;0;6
13218;Žirniukas;ZUIKUČIAI;6780809984;Ne;0;0;1;1
13219;Žirniukas;ZUIKUČIAI;5580500746;Ne;5;1;0;6
13220;Žirniukas;ZUIKUČIAI;6042654423;Taip;0;0;1;1
13221;Žirniukas;ZUIKUČIAI;6223594794;Ne;6;0;0;6
13222;Aušra;Kodėlčiukai;2199083085;Ne;0;2;0;2
13223;Aušra;Kodėlčiukai;4540040693;Ne;2;1;0;3
13224;Aušra;Kodėlčiukai;5013135853;Ne;0;0;1;1
13225;Aušra;Kodėlčiukai;7765504789;Taip;3;0;0;3
13226;Aušra;Kodėlčiukai;4824773027;Ne;6;0;0;6
13227;Aušra;Kodėlčiukai;6139706771;Ne;7;0;1;8
13228;Aušra;Kodėlčiukai;5929538617;Ne;0;4;0;4
13229;Aušra;Kodėlčiukai;4720749995;Ne;11;0;0;11
13230;Aušra;Kodėlčiukai;8108663467;Ne;2;0;0;2
13231;Aušra;Kodėlčiukai;5046439805;Ne;0;0;1;1
13232;Aušra;Kodėlčiukai;3420851059;Ne;0;1;0;1
13233;Aušra;Kodėlčiukai;7314273812;Taip;2;0;0;2
13234;Aušra;Kodėlčiukai;1423840991;Ne;9;1;0;10
13235;Aušra;Kodėlčiukai;7469266085;Ne;6;0;6;12
13236;Aušra;Kodėlčiukai;1010721404;Ne;4;5;0;9
13237;Aušra;Kodėlčiukai;2611563172;Taip;2;0;2;4
13238;Aušra;Kodėlčiukai;1883185016;Taip;0;2;0;2
13239;Aušra;Kodėlčiukai;9437530221;Taip;0;2;1;3
13240;Aušra;Kodėlčiukai;7367602247;Ne;0;7;0;7
13241;Aušra;Smalsučiai;4010347313;Ne;0;0;1;1
13242;Aušra;Smalsučiai;5993984086;Ne;0;1;0;1
13243;Aušra;Smalsučiai;1630814772;Ne;0;1;0;1
13244;Aušra;Smalsučiai;2768220823;Ne;0;0;3;3
13245;Aušra;Smalsučiai;4000881716;Ne;0;2;2;4
13246;Aušra;Smalsučiai;5268479689;Ne;0;1;0;1
13247;Aušra;Smalsučiai;7710131755;Taip;0;1;2;3
13248;Aušra;Smalsučiai;3468946868;Ne;2;1;0;3
13249;Aušra;Smalsučiai;8021547491;Taip;4;0;0;4
13250;Aušra;Smalsučiai;5925213006;Taip;0;2;2;4
13251;Aušra;Smalsučiai;2495610772;Ne;0;8;0;8
13252;Aušra;Smalsučiai;3526010606;Ne;0;1;0;1
13253;Aušra;Smalsučiai;4339450816;Ne;0;2;0;2
13254;Aušra;Smalsučiai;4163605313;Taip;0;9;0;9
13255;Aušra;Smalsučiai;6614027605;Taip;8;1;0;9
13256;Aušra;Smalsučiai;3860755808;Ne;0;9;0;9
13257;Aušra;Smalsučiai;2039920706;Ne;0;1;0;1
13258;Aušra;Smalsučiai;9333701196;Ne;2;0;2;4
13259;Aušra;Smalsučiai;8584355573;Taip;0;3;0;3
13260;Aušra;Smalsučiai;6965081051;Ne;0;1;0;1
13261;Aušra;Smalsučiai;8489362814;Ne;3;0;0;3
13262;Aušra;Smalsučiai;3675175233;Ne;0;1;0;1
13263;Aušra;"1A klasė";5524681006;Ne;1;0;0;1
13264;Aušra;"1A klasė";4404047456;Ne;1;0;0;1
13265;Aušra;"1A klasė";3680329197;Ne;7;0;0;7
13266;Aušra;"1A klasė";1575761029;Ne;1;0;0;1
13267;Aušra;"1A klasė";97102749430;Ne;1;0;0;1
13268;Aušra;"1A klasė";5777939563;Ne;1;0;0;1
13269;Aušra;"1A klasė";8740755922;Ne;0;0;1;1
13270;Aušra;"1A klasė";8500642069;Ne;1;0;0;1
13271;Aušra;"1A klasė";1450251779;Ne;1;0;0;1
13272;Aušra;"1A klasė";8176840834;Ne;1;0;0;1
13273;Aušra;"1A klasė";4922560649;Ne;1;0;0;1
13274;Aušra;"1A klasė";4946988585;Ne;1;0;0;1
13275;Aušra;"1A klasė";3767301684;Ne;1;0;0;1
13276;Aušra;"1A klasė";8755231814;Ne;1;0;0;1
13277;Aušra;"1A klasė";1625009666;Ne;1;0;0;1
13278;Aušra;"1A klasė";9058688663;Taip;5;0;0;5
13279;Aušra;"1A klasė";4468214107;Ne;1;0;0;1
13280;Aušra;"1A klasė";7708360056;Ne;1;0;0;1
13281;Aušra;"1A klasė";8096035110;Taip;3;0;0;3
13282;Aušra;"1A klasė";1687206394;Ne;3;0;0;3
13283;Aušra;"1A klasė";1557503831;Taip;1;0;0;1
13284;Aušra;"1A klasė";1636794584;Taip;1;0;0;1
13285;Aušra;"1A klasė";5258444578;Taip;5;0;0;5
13286;Aušra;"1A klasė";1612662076;Ne;2;0;0;2
13287;Aušra;"1B klasė";5409157554;Ne;1;0;0;1
13288;Aušra;"1B klasė";8709340592;Ne;1;0;0;1
13289;Aušra;"1B klasė";1940882109;Ne;3;0;0;3
13290;Aušra;"1B klasė";6384243597;Ne;4;0;0;4
13291;Aušra;"1B klasė";3898178166;Ne;2;0;0;2
13292;Aušra;"1B klasė";1343532870;Ne;3;0;0;3
13293;Aušra;"1B klasė";9614562473;Ne;1;0;0;1
13294;Aušra;"1B klasė";7921251819;Ne;18;0;0;18
13295;Aušra;"1B klasė";2523842161;Ne;6;0;0;6
13296;Aušra;"1B klasė";1465584524;Ne;1;0;0;1
13297;Aušra;"1B klasė";8036572198;Ne;1;0;0;1
13298;Aušra;"1B klasė";8525869648;Ne;1;0;0;1
13299;Aušra;"1B klasė";9589692031;Ne;1;0;0;1
13300;Aušra;"1B klasė";9972967198;Ne;1;0;0;1
13301;Aušra;"1B klasė";5522008237;Ne;2;0;0;2
13302;Aušra;"1B klasė";5269927048;Ne;1;0;0;1
13303;Aušra;"1B klasė";6084096300;Ne;1;0;0;1
13304;Aušra;"1B klasė";10796114623;Ne;2;0;0;2
13305;Aušra;"1B klasė";2052892422;Ne;1;0;0;1
13306;Aušra;"1B klasė";9197020006;Ne;1;0;0;1
13307;Aušra;"1B klasė";7178676049;Ne;1;0;0;1
13308;Aušra;"1B klasė";1298724775;Ne;1;0;0;1
13309;Aušra;"1B klasė";7918281270;Ne;6;0;0;6
13310;Aušra;"1B klasė";43123279348;Ne;1;0;0;1
13311;Aušra;"2A klasė";3001784066;Ne;1;0;0;1
13312;Aušra;"2A klasė";84116863778;Ne;2;0;0;2
13313;Aušra;"2A klasė";2227238810;Ne;1;0;0;1
13314;Aušra;"2A klasė";59837942520;Ne;1;0;0;1
13315;Aušra;"2A klasė";11053850075;Ne;1;0;0;1
13316;Aušra;"2A klasė";23609052737;Ne;1;0;0;1
13317;Aušra;"2A klasė";41017803426;Ne;8;0;0;8
13318;Aušra;"2A klasė";21544489661;Ne;3;0;0;3
13319;Aušra;"2A klasė";24625925423;Ne;1;0;0;1
13320;Aušra;"2A klasė";62186117615;Ne;1;0;0;1
13321;Aušra;"2A klasė";3526237179;Ne;3;0;0;3
13322;Aušra;"2A klasė";1893586984;Ne;0;21;0;21
13323;Aušra;"2A klasė";8686777160;Ne;5;0;0;5
13324;Aušra;"2A klasė";15657824495;Ne;1;0;0;1
13325;Aušra;"2A klasė";5988529284;Taip;1;0;0;1
13326;Aušra;"2A klasė";79051821501;Ne;8;0;0;8
13327;Aušra;"2A klasė";2062470430;Ne;1;0;0;1
13328;Aušra;"2A klasė";5815377310;Ne;2;0;0;2
13329;Aušra;"2A klasė";58254707316;Ne;1;0;0;1
13330;Aušra;"2A klasė";1385844067;Ne;1;0;0;1
13331;Aušra;"2A klasė";2121418946;Taip;1;0;0;1
13332;Aušra;"2A klasė";1219257874;Ne;0;21;0;21
13333;Aušra;"2A klasė";4325224130;Ne;1;0;0;1
13334;Aušra;"2A klasė";59267104215;Ne;1;0;0;1
13335;Aušra;"2A klasė";3732655408;Taip;2;0;0;2
13336;Aušra;"3A klasė";1049364899;Ne;1;0;0;1
13337;Aušra;"3A klasė";1473962346;Ne;1;0;0;1
13338;Aušra;"3A klasė";1427235223;Ne;2;0;0;2
13339;Aušra;"3A klasė";42344686036;Ne;1;0;0;1
13340;Aušra;"3A klasė";95586246863;Ne;1;0;0;1
13341;Aušra;"3A klasė";1167565535;Ne;1;0;0;1
13342;Aušra;"3A klasė";5468993286;Ne;1;0;0;1
13343;Aušra;"3A klasė";75047415039;Taip;1;0;0;1
13344;Aušra;"3A klasė";85826303673;Ne;5;0;0;5
13345;Aušra;"3A klasė";1145863002;Ne;1;0;0;1
13346;Aušra;"3A klasė";77966124767;Ne;1;0;0;1
13347;Aušra;"3A klasė";97312326369;Taip;2;0;0;2
13348;Aušra;"3A klasė";48817619537;Ne;1;0;0;1
13349;Aušra;"3A klasė";55937499558;Ne;3;0;0;3
13350;Aušra;"3A klasė";35779814505;Ne;1;0;0;1
13351;Aušra;"3A klasė";76280361479;Ne;1;0;0;1
13352;Aušra;"3A klasė";2131349938;Ne;1;0;0;1
13353;Aušra;"3A klasė";1455625997;Ne;1;0;0;1
13354;Aušra;"3A klasė";36447115547;Ne;1;0;0;1
13355;Aušra;"3A klasė";1393006122;Ne;5;0;0;5
13356;Aušra;"3A klasė";7998332115;Ne;1;0;0;1
13357;Aušra;"3A klasė";2647629246;Ne;1;0;0;1
13358;Aušra;"3A klasė";14611425618;Ne;0;21;0;21
13359;Aušra;"3A klasė";31458685084;Ne;17;0;0;17
13360;Aušra;"3A klasė";1315930711;Ne;1;0;0;1
13361;Aušra;"3A klasė";4110537888;Ne;1;0;0;1
13362;Aušra;"3A klasė";9603569117;Ne;1;0;0;1
13363;Aušra;"3A klasė";2019480768;Ne;1;0;0;1
13364;Aušra;"4A klasė";40499781883;Ne;1;0;0;1
13365;Aušra;"4A klasė";73509864636;Ne;1;0;0;1
13366;Aušra;"4A klasė";8510995681;Taip;1;0;0;1
13367;Aušra;"4A klasė";13157844661;Ne;1;0;0;1
13368;Aušra;"4A klasė";70233681803;Ne;0;21;0;21
13369;Aušra;"4A klasė";68160889669;Ne;1;0;0;1
13370;Aušra;"4A klasė";97781409787;Ne;1;0;0;1
13371;Aušra;"4A klasė";9605206310;Ne;1;0;0;1
13372;Aušra;"4A klasė";88655846176;Ne;4;0;0;4
13373;Aušra;"4A klasė";3284383302;Ne;1;0;0;1
13374;Aušra;"4A klasė";1437126272;Taip;1;0;0;1
13375;Aušra;"4A klasė";39537089288;Ne;4;0;0;4
13376;Aušra;"4A klasė";3965445196;Ne;1;0;0;1
13377;Aušra;"4A klasė";85578471272;Ne;1;0;0;1
13378;Aušra;"4A klasė";27958163601;Ne;1;0;0;1
13379;Aušra;"4A klasė";68031503463;Ne;0;21;0;21
13380;Aušra;"4A klasė";81633973264;Ne;4;0;0;4
13381;Aušra;"4A klasė";52985512945;Ne;0;21;0;21
13382;Aušra;"4A klasė";51185323645;Ne;0;21;0;21
13383;Aušra;"4A klasė";1437385365;Ne;0;21;0;21
13384;Aušra;"4A klasė";15330844181;Ne;1;0;0;1
13385;Aušra;"4A klasė";2062775070;Ne;0;21;0;21
13386;Aušra;"4A klasė";14157070764;Ne;2;0;0;2
13387;Aušra;"4A klasė";99073448709;Ne;6;0;0;6
13388;Aušra;"4A klasė";40714551025;Ne;1;0;0;1
13389;Aušra;"4A klasė";58699109274;Ne;1;0;0;1
13390;Aušra;"2B klasė";1988459596;Ne;1;0;0;1
13391;Aušra;"2B klasė";4930807661;Ne;1;0;0;1
13392;Aušra;"2B klasė";86128256406;Ne;1;0;0;1
13393;Aušra;"2B klasė";50687988382;Ne;1;0;0;1
13394;Aušra;"2B klasė";1021183555;Ne;1;0;0;1
13395;Aušra;"2B klasė";41268510292;Ne;2;0;0;2
13396;Aušra;"2B klasė";8428069167;Ne;2;0;0;2
13397;Aušra;"2B klasė";3910688753;Ne;1;0;0;1
13398;Aušra;"2B klasė";4024898537;Ne;1;0;0;1
13399;Aušra;"2B klasė";1238171728;Taip;2;0;0;2
13400;Aušra;"2B klasė";4103951942;Ne;1;0;0;1
13401;Aušra;"2B klasė";46481555688;Ne;5;0;0;5
13402;Aušra;"2B klasė";1063755068;Ne;1;0;0;1
13403;Aušra;"2B klasė";70844824182;Ne;2;0;0;2
13404;Aušra;"2B klasė";17098859260;Ne;1;0;0;1
13405;Aušra;"2B klasė";9940683245;Ne;1;0;0;1
13406;Aušra;"2B klasė";2841526614;Ne;3;0;0;3
13407;Aušra;"2B klasė";8813044848;Ne;2;0;0;2
13408;Aušra;"2B klasė";58741201573;Ne;2;0;0;2
13409;Aušra;"2B klasė";2003368811;Taip;1;0;0;1
13410;Aušra;"2B klasė";65840410497;Ne;2;0;0;2
13411;Aušra;"2B klasė";1640356242;Ne;1;0;0;1
13412;Aušra;"2B klasė";90604001837;Taip;10;0;0;10
13413;Aušra;"2B klasė";7794899167;Ne;5;0;0;5
13414;Aušra;Pabiručiai;8769357172;Ne;10;0;0;10
13415;Aušra;Pabiručiai;8462418277;Ne;4;1;0;5
13416;Aušra;Pabiručiai;6555345047;Ne;15;0;0;15
13417;Aušra;Pabiručiai;1306616759;Ne;0;2;0;2
13418;Aušra;Pabiručiai;3336605264;Ne;14;0;0;14
13419;Aušra;Pabiručiai;7476662446;Ne;11;0;0;11
13420;Aušra;Pabiručiai;7199483890;Ne;3;1;0;4
13421;Aušra;Pabiručiai;7926621700;Taip;10;0;0;10
13422;Aušra;Pabiručiai;2904303784;Ne;0;1;0;1
13423;Aušra;Pabiručiai;7888891808;Ne;5;0;2;7
13424;Aušra;Pabiručiai;7944904281;Ne;0;1;0;1
13425;Aušra;Pabiručiai;4646215025;Ne;11;0;0;11
13426;Aušra;Pabiručiai;6056923592;Taip;3;1;0;4
13427;Aušra;Pabiručiai;8665364744;Taip;12;1;0;13
13428;Aušra;Pabiručiai;3553620602;Ne;4;0;0;4
13429;Aušra;Pabiručiai;4071233786;Ne;1;0;1;2
13430;Aušra;Pabiručiai;3953653896;Ne;8;0;2;10
13431;Aušra;Pabiručiai;6508435821;Ne;9;0;0;9
13432;Aušra;Pabiručiai;5797692122;Ne;6;1;0;7
13433;Aušra;Pabiručiai;7542690501;Ne;0;21;0;21
13434;Aušra;Pabiručiai;3759593393;Ne;0;1;0;1
13435;Aušra;Gudručiai;1933801749;Ne;0;0;2;2
13436;Aušra;Gudručiai;6658178519;Ne;0;2;0;2
13437;Aušra;Gudručiai;4564561993;Ne;0;1;0;1
13438;Aušra;Gudručiai;2243689816;Ne;0;5;0;5
13439;Aušra;Gudručiai;5955385407;Ne;0;2;0;2
13440;Aušra;Gudručiai;2271582954;Ne;6;0;0;6
13441;Aušra;Gudručiai;9628651723;Ne;5;4;0;9
13442;Aušra;Gudručiai;1337138547;Ne;5;0;0;5
13443;Aušra;Gudručiai;3343235857;Ne;5;0;0;5
13444;Aušra;Gudručiai;8715912139;Ne;0;2;0;2
13445;Aušra;Gudručiai;7783006852;Ne;0;1;0;1
13446;Aušra;Gudručiai;1429548355;Taip;0;21;0;21
13447;Aušra;Gudručiai;1693711284;Ne;8;6;0;14
13448;Aušra;Gudručiai;6935310711;Ne;6;2;0;8
13449;Aušra;Gudručiai;3698868934;Ne;10;0;0;10
13450;Aušra;Gudručiai;9079804366;Ne;0;1;0;1
13451;Aušra;Gudručiai;3498143162;Ne;0;1;0;1
13452;Aušra;Gudručiai;5053808615;Ne;0;2;0;2
13453;Aušra;Naminukai;5596076175;Ne;13;1;2;16
13454;Aušra;Naminukai;5029468798;Ne;6;1;2;9
13455;Aušra;Naminukai;3889084120;Ne;1;0;1;2
13456;Aušra;Naminukai;9817943569;Ne;5;0;0;5
13457;Aušra;Naminukai;9783616691;Ne;0;1;0;1
13458;Aušra;Naminukai;8872977307;Taip;6;0;2;8
13459;Aušra;Naminukai;7833475076;Ne;1;0;1;2
13460;Aušra;Naminukai;1415288593;Taip;1;0;0;1
13461;Aušra;Naminukai;8317843419;Taip;10;0;0;10
13462;Aušra;Naminukai;5245988936;Ne;0;0;1;1
13463;Aušra;Naminukai;2109806524;Ne;6;0;0;6
13464;Aušra;Naminukai;4824331856;Ne;0;0;1;1
13465;Aušra;Naminukai;4779994281;Ne;0;0;1;1
13466;Aušra;"2 C klasė";1426802917;Ne;1;0;0;1
13467;Aušra;"2 C klasė";26010333641;Ne;2;0;0;2
13468;Aušra;"2 C klasė";3133031845;Ne;1;0;0;1
13469;Aušra;"2 C klasė";11130172902;Ne;1;0;0;1
13470;Aušra;"2 C klasė";43737170074;Ne;7;0;0;7
13471;Aušra;"2 C klasė";1370336984;Ne;1;0;0;1
13472;Aušra;"2 C klasė";6483078840;Ne;1;0;0;1
13473;Aušra;"2 C klasė";1684481833;Ne;2;0;0;2
13474;Aušra;"2 C klasė";1198248619;Ne;1;0;0;1
13475;Aušra;"2 C klasė";4765125810;Ne;1;0;0;1
13476;Aušra;"2 C klasė";5704281727;Ne;5;0;0;5
13477;Aušra;"2 C klasė";1479311429;Ne;1;0;0;1
13478;Aušra;"2 C klasė";1542575012;Taip;1;0;0;1
13479;Aušra;"2 C klasė";1291782232;Ne;1;0;0;1
13480;Aušra;"2 C klasė";90520726029;Ne;1;0;0;1
13481;Aušra;"2 C klasė";1844632980;Ne;1;0;0;1
13482;Aušra;"2 C klasė";94478599707;Ne;1;0;0;1
13483;Aušra;"2 C klasė";78489473446;Ne;3;0;0;3
13484;Aušra;"2 C klasė";29328876924;Ne;4;0;0;4
13485;Aušra;"2 C klasė";7649832094;Ne;1;0;0;1
13486;Aušra;"2 C klasė";8225188274;Ne;2;0;0;2
13487;Aušra;"2 C klasė";1371282149;Ne;1;0;0;1
13488;Aušra;"2 C klasė";57559227292;Ne;2;0;0;2
13489;Berželis;PČIOLKI;7781031211;Taip;6;0;2;8
13490;Berželis;PČIOLKI;4546285993;Ne;0;21;0;21
13491;Berželis;PČIOLKI;7940591009;Ne;0;0;7;7
13492;Berželis;PČIOLKI;5688897783;Ne;0;0;2;2
13493;Berželis;PČIOLKI;2016194182;Ne;0;9;0;9
13494;Berželis;PČIOLKI;5069322062;Ne;0;0;5;5
13495;Berželis;PČIOLKI;6577232093;Ne;0;0;5;5
13496;Berželis;PČIOLKI;9585609150;Ne;0;8;0;8
13497;Berželis;PČIOLKI;6387242787;Ne;0;21;0;21
13498;Berželis;SOVUŠKI;5350402890;Ne;3;0;0;3
13499;Berželis;SOVUŠKI;8185887403;Ne;2;0;0;2
13500;Berželis;SOVUŠKI;1289333809;Ne;8;1;0;9
13501;Berželis;SOVUŠKI;8086074279;Ne;4;0;0;4
13502;Berželis;SOVUŠKI;9273819928;Ne;0;3;0;3
13503;Berželis;SOVUŠKI;3885474466;Ne;8;1;0;9
13504;Berželis;SOVUŠKI;1825910306;Ne;1;0;0;1
13505;Berželis;SOVUŠKI;6706273205;Ne;1;0;0;1
13506;Berželis;SOVUŠKI;1464998584;Ne;12;0;0;12
13507;Berželis;SOVUŠKI;2844736188;Ne;1;0;0;1
13508;Berželis;SOVUŠKI;3835273594;Ne;0;2;0;2
13509;Berželis;SOVUŠKI;2632535013;Ne;1;2;0;3
13510;Berželis;SOVUŠKI;6698849108;Ne;6;0;0;6
13511;Berželis;SOVUŠKI;1583268041;Ne;1;0;0;1
13512;Berželis;SOVUŠKI;5925726854;Ne;13;0;0;13
13513;Berželis;SOVUŠKI;1044720859;Ne;0;5;0;5
13514;Berželis;SOVUŠKI;2615832804;Ne;7;8;0;15
13515;Berželis;PODSOLNUŠKI;3157906472;Ne;0;0;4;4
13516;Berželis;PODSOLNUŠKI;9945124824;Ne;17;0;0;17
13517;Berželis;PODSOLNUŠKI;8168498937;Taip;8;3;0;11
13518;Berželis;PODSOLNUŠKI;9072126286;Ne;5;0;0;5
13519;Berželis;PODSOLNUŠKI;8633724383;Ne;9;0;1;10
13520;Berželis;PODSOLNUŠKI;2259367998;Ne;8;0;0;8
13521;Berželis;PODSOLNUŠKI;3033042487;Ne;11;0;3;14
13522;Berželis;PODSOLNUŠKI;2136455625;Ne;5;0;5;10
13523;Berželis;PODSOLNUŠKI;1964320071;Ne;7;0;0;7
13524;Berželis;PODSOLNUŠKI;9133988149;Ne;5;0;1;6
13525;Berželis;PODSOLNUŠKI;5795151632;Ne;0;0;3;3
13526;Berželis;PODSOLNUŠKI;6686248053;Ne;6;0;0;6
13527;Berželis;PODSOLNUŠKI;1081582842;Taip;6;1;0;7
13528;Berželis;PODSOLNUŠKI;5963915092;Ne;8;0;0;8
13529;Berželis;PODSOLNUŠKI;3378237475;Ne;8;0;0;8
13530;Berželis;MEŠKIUKAI;9178527605;Taip;4;0;0;4
13531;Berželis;MEŠKIUKAI;1235617054;Ne;10;0;1;11
13532;Berželis;MEŠKIUKAI;5100214127;Ne;5;0;0;5
13533;Berželis;MEŠKIUKAI;3535856504;Taip;0;6;0;6
13534;Berželis;MEŠKIUKAI;8560266611;Ne;10;0;1;11
13535;Berželis;MEŠKIUKAI;3936106342;Taip;5;0;0;5
13536;Berželis;MEŠKIUKAI;6689893827;Ne;2;6;0;8
13537;Berželis;MEŠKIUKAI;8251510865;Ne;0;0;4;4
13538;Berželis;MEŠKIUKAI;9182053246;Ne;3;0;1;4
13539;Berželis;MEŠKIUKAI;6394357191;Ne;0;0;5;5
13540;Berželis;ŽIEDELIAI;3786609012;Taip;0;0;1;1
13541;Berželis;ŽIEDELIAI;9805181733;Ne;4;0;0;4
13542;Berželis;ŽIEDELIAI;2016827207;Ne;4;0;0;4
13543;Berželis;ŽIEDELIAI;9979442772;Ne;0;0;3;3
13544;Berželis;ŽIEDELIAI;9925865228;Ne;5;0;2;7
13545;Berželis;ŽIEDELIAI;1402975280;Taip;5;3;0;8
13546;Berželis;ŽIEDELIAI;2030492491;Ne;2;0;1;3
13547;Berželis;ŽIEDELIAI;3351114197;Ne;0;0;5;5
13548;Berželis;ŽIEDELIAI;5248880873;Ne;12;0;1;13
13549;Berželis;ŽIEDELIAI;2947072348;Ne;6;2;0;8
13550;Berželis;ŽIEDELIAI;1834920753;Taip;4;0;4;8
13551;Berželis;ŽIEDELIAI;6384939601;Ne;0;0;1;1
13552;Berželis;ŽIEDELIAI;2410514408;Ne;0;0;1;1
13553;Berželis;NYKŠTUKAI;7935684899;Ne;9;0;3;12
13554;Berželis;NYKŠTUKAI;1403664386;Ne;3;0;3;6
13555;Berželis;NYKŠTUKAI;9666648116;Ne;5;0;5;10
13556;Berželis;NYKŠTUKAI;3559065542;Ne;0;0;2;2
13557;Berželis;NYKŠTUKAI;3556594755;Ne;0;0;1;1
13558;Berželis;NYKŠTUKAI;2933069798;Taip;0;0;2;2
13559;Berželis;NYKŠTUKAI;3852021563;Ne;4;0;2;6
13560;Berželis;NYKŠTUKAI;3379227410;Taip;5;0;3;8
13561;Berželis;NYKŠTUKAI;5012540410;Ne;0;0;2;2
13562;Berželis;UOGELĖS;8735934456;Ne;0;8;2;10
13563;Berželis;UOGELĖS;6136155301;Ne;6;0;3;9
13564;Berželis;UOGELĖS;9950641759;Ne;15;0;0;15
13565;Berželis;UOGELĖS;9034464618;Ne;1;0;1;2
13566;Berželis;UOGELĖS;2321608974;Ne;0;0;4;4
13567;Berželis;UOGELĖS;3229996417;Ne;1;0;0;1
13568;Berželis;UOGELĖS;4607486516;Ne;5;0;4;9
13569;Berželis;KODĖLČIUKAI;4254592648;Ne;18;0;0;18
13570;Saulutė;Drugeliai;5987478379;Taip;5;0;0;5
13571;Saulutė;Drugeliai;5943795519;Taip;0;1;0;1
13572;Saulutė;Drugeliai;4067009709;Ne;2;1;0;3
13573;Saulutė;Drugeliai;3991128892;Ne;17;0;0;17
13574;Saulutė;Drugeliai;7689842018;Ne;5;0;0;5
13575;Saulutė;Drugeliai;4288298305;Ne;1;1;0;2
13576;Saulutė;Drugeliai;9133269796;Ne;8;0;0;8
13577;Saulutė;Drugeliai;6057938367;Ne;2;0;0;2
13578;Saulutė;Drugeliai;1268204445;Ne;0;1;0;1
13579;Saulutė;Drugeliai;8003855875;Ne;1;0;0;1
13580;Saulutė;Drugeliai;2301903550;Ne;3;0;0;3
13581;Saulutė;Drugeliai;2337702344;Ne;1;0;0;1
13582;Saulutė;Drugeliai;9410517602;Ne;7;0;0;7
13583;Saulutė;Drugeliai;1088813143;Ne;1;0;0;1
13584;Saulutė;Drugeliai;6304028361;Ne;2;0;0;2
13585;Saulutė;Drugeliai;2750955550;Ne;7;0;0;7
13586;Saulutė;Drugeliai;5931269521;Ne;9;0;0;9
13587;Saulutė;Drugeliai;3730442890;Ne;7;1;0;8
13588;Saulutė;Drugeliai;8409958782;Ne;20;0;0;20
13589;Saulutė;"Saulės zuikučiai";6924891265;Ne;10;0;0;10
13590;Saulutė;"Saulės zuikučiai";5448950324;Ne;7;10;0;17
13591;Saulutė;"Saulės zuikučiai";4130972647;Taip;7;2;0;9
13592;Saulutė;"Saulės zuikučiai";3242810449;Ne;0;14;0;14
13593;Saulutė;"Saulės zuikučiai";9110162513;Ne;0;1;0;1
13594;Saulutė;"Saulės zuikučiai";1648978545;Ne;0;3;0;3
13595;Saulutė;"Saulės zuikučiai";6927834443;Taip;0;16;0;16
13596;Saulutė;"Saulės zuikučiai";8714520840;Ne;6;5;0;11
13597;Saulutė;"Saulės zuikučiai";9726675673;Ne;19;0;0;19
13598;Saulutė;"Saulės zuikučiai";8520474896;Ne;19;0;0;19
13599;Saulutė;"Saulės zuikučiai";3215349379;Taip;0;14;0;14
13600;Saulutė;"Saulės zuikučiai";7311594119;Ne;2;14;0;16
13601;Saulutė;"Saulės zuikučiai";8952893819;Ne;0;19;0;19
13602;Saulutė;"Saulės zuikučiai";9567511354;Ne;5;10;0;15
13603;Saulutė;"Saulės zuikučiai";6579874077;Ne;0;9;0;9
13604;Saulutė;"Saulės zuikučiai";6178908581;Ne;2;1;0;3
13605;Saulutė;"Saulės zuikučiai";8472510151;Ne;0;19;0;19
13606;Saulutė;"Saulės zuikučiai";7478215328;Ne;6;0;0;6
13607;Saulutė;"Saulės zuikučiai";9727366891;Ne;13;0;0;13
13608;Saulutė;"Saulės zuikučiai";4222649372;Ne;0;20;0;20
13609;Saulutė;Boružėlės;1587328722;Ne;0;0;1;1
13610;Saulutė;Boružėlės;8390767549;Ne;16;0;0;16
13611;Saulutė;Boružėlės;7576532632;Ne;0;0;2;2
13612;Saulutė;Boružėlės;9314889468;Ne;0;0;4;4
13613;Saulutė;Boružėlės;7081700501;Ne;0;1;0;1
13614;Saulutė;Boružėlės;7474989619;Ne;0;5;0;5
13615;Saulutė;Boružėlės;1803710557;Ne;0;0;2;2
13616;Saulutė;Boružėlės;9173336078;Ne;0;0;1;1
13617;Saulutė;Boružėlės;9098663596;Ne;0;0;1;1
13618;Saulutė;Boružėlės;7425789805;Ne;9;20;0;29
13619;Saulutė;Boružėlės;2988010963;Ne;0;1;4;5
13620;Saulutė;Boružėlės;3852862834;Ne;0;6;3;9
13621;Saulutė;Boružėlės;1275552038;Ne;6;0;3;9
13622;Saulutė;Boružėlės;3363212754;Ne;0;0;3;3
13623;Saulutė;Boružėlės;8086759121;Ne;2;0;1;3
13624;Saulutė;Boružėlės;4840187188;Ne;0;0;4;4
13625;Saulutė;Nykštukai;2601822200;Ne;1;0;1;2
13626;Saulutė;Nykštukai;3244850673;Ne;0;11;0;11
13627;Saulutė;Nykštukai;5607937410;Ne;0;3;0;3
13628;Saulutė;Nykštukai;3571751974;Ne;0;0;1;1
13629;Saulutė;Nykštukai;3221612665;Ne;0;7;1;8
13630;Saulutė;Nykštukai;2140277182;Ne;0;0;1;1
13631;Saulutė;Nykštukai;4800144085;Ne;16;0;0;16
13632;Saulutė;Nykštukai;8257363228;Ne;9;0;0;9
13633;Saulutė;Nykštukai;9664809396;Taip;5;0;0;5
13634;Saulutė;Nykštukai;8984040932;Ne;1;6;0;7
13635;Saulutė;Nykštukai;3463428772;Ne;1;0;3;4
13636;Saulutė;Nykštukai;9930330487;Ne;0;0;1;1
13637;Saulutė;Nykštukai;7158455528;Ne;0;0;1;1
13638;Saulutė;Nykštukai;1229624643;Ne;0;3;0;3
13639;Saulutė;Nykštukai;9572394489;Ne;16;0;0;16
13640;Saulutė;Nykštukai;5509365461;Ne;6;0;1;7
13641;Saulutė;Nykštukai;3408369823;Ne;0;0;2;2
13642;Saulutė;Nykštukai;5264813819;Ne;0;0;2;2
13643;Saulutė;Nykštukai;3265401334;Ne;0;2;2;4
13644;Saulutė;Nykštukai;9497439410;Ne;0;8;0;8
13645;Saulutė;Nykštukai;5335820652;Taip;5;0;2;7
13646;Saulutė;Nykštukai;4510990261;Ne;15;0;0;15
13647;Saulutė;Nykštukai;7555183487;Ne;0;15;1;16
13648;Saulutė;Meškiukai;6955061957;Ne;8;0;0;8
13649;Saulutė;Meškiukai;5219429911;Ne;0;0;3;3
13650;Saulutė;Meškiukai;8787977881;Ne;5;0;0;5
13651;Saulutė;Meškiukai;8147755754;Ne;6;0;3;9
13652;Saulutė;Meškiukai;1562476697;Ne;20;0;0;20
13653;Saulutė;Meškiukai;1776176097;Ne;10;0;0;10
13654;Saulutė;Meškiukai;1408451926;Ne;13;8;0;21
13655;Saulutė;Meškiukai;9175541045;Ne;0;15;3;18
13656;Saulutė;Meškiukai;6978306762;Ne;10;11;0;21
13657;Saulutė;Meškiukai;7757420187;Taip;10;0;0;10
13658;Saulutė;Meškiukai;9919098322;Ne;14;0;2;16
13659;Saulutė;Meškiukai;3883395634;Ne;4;17;0;21
13660;Saulutė;Meškiukai;2929345460;Ne;0;21;0;21
13661;Saulutė;Ežiukai;2813274509;Ne;10;0;1;11
13662;Saulutė;Ežiukai;2315812734;Ne;5;0;0;5
13663;Saulutė;Ežiukai;8736917541;Taip;0;0;3;3
13664;Saulutė;Ežiukai;4363210987;Ne;0;0;4;4
13665;Saulutė;Ežiukai;5972503001;Ne;6;0;0;6
13666;Saulutė;Ežiukai;6884472677;Ne;0;0;1;1
13667;Saulutė;Ežiukai;4194586403;Ne;0;0;3;3
13668;Saulutė;Ežiukai;1853984777;Ne;0;0;1;1
13669;Saulutė;Ežiukai;1666301750;Ne;0;0;4;4
13670;Saulutė;Ežiukai;3133714991;Ne;0;0;5;5
13671;Saulutė;Ežiukai;4039065925;Ne;0;0;2;2
13672;Saulutė;Ežiukai;2728669975;Ne;7;0;1;8
13673;Saulutė;Ežiukai;9398356470;Ne;0;7;2;9
13674;Saulutė;Ežiukai;6126870829;Ne;5;0;1;6
13675;Saulutė;Ežiukai;3565818383;Ne;0;0;2;2
13676;Saulutė;Ežiukai;9101950978;Ne;0;0;3;3
13677;Saulutė;Ežiukai;6982979199;Ne;6;0;1;7
13678;Saulutė;Ežiukai;8919457259;Ne;6;0;1;7
13679;Saulutė;Ežiukai;3125186472;Ne;0;0;1;1
13680;Saulutė;Ežiukai;7941601480;Ne;5;0;1;6
13681;Saulutė;Ežiukai;8961335897;Ne;14;0;0;14
13682;Saulutė;Bitutės;5897526863;Ne;0;0;2;2
13683;Saulutė;Bitutės;6531388817;Ne;2;5;0;7
13684;Saulutė;Bitutės;1640977737;Ne;12;0;0;12
13685;Saulutė;Bitutės;2251663689;Ne;0;21;0;21
13686;Saulutė;Bitutės;8428335721;Ne;6;12;1;19
13687;Saulutė;Bitutės;5623547412;Ne;0;21;0;21
13688;Saulutė;Bitutės;1931298484;Ne;6;0;0;6
13689;Saulutė;Bitutės;5308928580;Ne;8;10;0;18
13690;Saulutė;Bitutės;9741004996;Ne;5;6;0;11
13691;Saulutė;Bitutės;3883903645;Taip;0;21;0;21
13692;Saulutė;Bitutės;2402895955;Ne;0;8;1;9
13693;Saulutė;Bitutės;4055603288;Taip;5;0;1;6
13694;Saulutė;Bitutės;8551251470;Ne;0;21;0;21
13695;Saulutė;Bitutės;2849357495;Ne;10;0;0;10
13696;Saulutė;Bitutės;1763631244;Ne;0;20;0;20
13697;Saulutė;Bitutės;7123687661;Ne;6;15;0;21
13698;Saulutė;Pelėdžiukai;8512137633;Taip;8;0;0;8
13699;Saulutė;Pelėdžiukai;4211866191;Ne;0;15;0;15
13700;Saulutė;Pelėdžiukai;2373409300;Ne;4;0;0;4
13701;Saulutė;Pelėdžiukai;8405262902;Taip;2;0;1;3
13702;Saulutė;Pelėdžiukai;1745754752;Ne;1;0;0;1
13703;Saulutė;Pelėdžiukai;4123500930;Ne;4;0;0;4
13704;Saulutė;Pelėdžiukai;1056158093;Ne;2;0;0;2
13705;Saulutė;Pelėdžiukai;8371366346;Ne;0;6;0;6
13706;Saulutė;Pelėdžiukai;6842585310;Ne;5;0;0;5
13707;Saulutė;Pelėdžiukai;1776164273;Ne;0;2;0;2
13708;Saulutė;Pelėdžiukai;5850783789;Ne;4;0;0;4
13709;Saulutė;Pelėdžiukai;6608003946;Ne;0;19;0;19
13710;Saulutė;Pelėdžiukai;7620841597;Ne;5;0;0;5
13711;Saulutė;Pelėdžiukai;7640441297;Ne;2;11;0;13
13712;Saulutė;Pelėdžiukai;6046611248;Taip;11;0;0;11
13713;Saulutė;Pelėdžiukai;4301516165;Ne;20;0;0;20
13714;Saulutė;Pelėdžiukai;7258180835;Ne;0;21;0;21
13715;Saulutė;Pelėdžiukai;2566263680;Ne;7;0;1;8
13716;Saulutė;Pelėdžiukai;4179271978;Ne;14;0;0;14
13717;Saulutė;Zylutės;3228226715;Ne;2;0;0;2
13718;Saulutė;Zylutės;8040751073;Ne;0;0;4;4
13719;Saulutė;Zylutės;2074473832;Ne;0;1;0;1
13720;Saulutė;Zylutės;8041118115;Ne;0;21;0;21
13721;Saulutė;Zylutės;5198558993;Ne;21;0;0;21
13722;Saulutė;Zylutės;8717210130;Ne;9;0;0;9
13723;Saulutė;Zylutės;8211523302;Ne;7;1;0;8
13724;Saulutė;Zylutės;3272296969;Taip;0;0;1;1
13725;Saulutė;Zylutės;7032417938;Taip;4;0;0;4
13726;Saulutė;Zylutės;1784093413;Ne;6;0;0;6
13727;Saulutė;Zylutės;8722717930;Ne;18;0;0;18
13728;Saulutė;Zylutės;5442075474;Ne;10;0;0;10
13729;Saulutė;Zylutės;4136425904;Ne;7;1;0;8
13730;Saulutė;Zylutės;4390098560;Ne;0;14;5;19
13731;Saulutė;Zylutės;4663795223;Ne;11;9;1;21
13732;Saulutė;Zylutės;7839168221;Ne;1;0;0;1
13733;Saulutė;Zylutės;2527027536;Ne;5;0;0;5
13734;Saulutė;Zylutės;2725491887;Ne;10;0;0;10
13735;Saulutė;Zylutės;1712365476;Ne;3;0;0;3
13736;Saulutė;"1 klasė";8379304869;Ne;4;0;0;4
13737;Saulutė;"1 klasė";2397257894;Ne;2;0;0;2
13738;Saulutė;"1 klasė";3620722907;Ne;4;0;0;4
13739;Saulutė;"1 klasė";3749374270;Ne;2;0;0;2
13740;Saulutė;"1 klasė";5148542811;Ne;4;0;0;4
13741;Saulutė;"1 klasė";1562393383;Ne;3;0;0;3
13742;Saulutė;"1 klasė";4818911910;Ne;11;0;0;11
13743;Saulutė;"1 klasė";8092104136;Ne;1;0;0;1
13744;Saulutė;"1 klasė";4971244488;Taip;1;0;0;1
13745;Saulutė;"2 klasė";1717909005;Ne;9;0;0;9
13746;Saulutė;"2 klasė";1513449225;Ne;1;0;0;1
13747;Saulutė;"2 klasė";87814849917;Ne;1;0;0;1
13748;Saulutė;"2 klasė";84919478493;Ne;1;0;0;1
13749;Saulutė;"2 klasė";1320018338;Ne;1;0;0;1
13750;Saulutė;"2 klasė";8599199376;Ne;4;0;0;4
13751;Saulutė;"2 klasė";8944601874;Ne;1;0;0;1
13752;Saulutė;"2 klasė";3064199909;Ne;1;0;0;1
13753;Saulutė;"2 klasė";1556270046;Ne;1;0;0;1
13754;Saulutė;"2 klasė";1291318940;Ne;3;0;0;3
13755;Saulutė;"2 klasė";2677995903;Ne;1;0;0;1
13756;Saulutė;"2 klasė";1910653135;Ne;7;0;0;7
13757;Saulutė;"2 klasė";1786491396;Ne;3;0;0;3
13758;Saulutė;"2 klasė";1386800520;Ne;3;0;0;3
13759;Saulutė;"2 klasė";89920419797;Ne;1;0;0;1
13760;Saulutė;"3 klasė";45306237230;Ne;15;0;0;15
13761;Saulutė;"3 klasė";79919438191;Ne;1;0;0;1
13762;Saulutė;"3 klasė";29074930927;Ne;6;0;0;6
13763;Saulutė;"3 klasė";31705050946;Ne;5;0;0;5
13764;Saulutė;"3 klasė";9612975694;Ne;21;0;0;21
13765;Saulutė;"3 klasė";77923802656;Ne;1;0;0;1
13766;Saulutė;"3 klasė";1935503629;Ne;1;0;0;1
13767;Saulutė;"3 klasė";75405796772;Ne;2;0;0;2
13768;Saulutė;"3 klasė";97145959022;Ne;1;0;0;1
13769;Saulutė;"3 klasė";1534183935;Ne;1;0;0;1
13770;Saulutė;"3 klasė";5574049005;Ne;4;0;0;4
13771;Saulutė;"3 klasė";1510434265;Ne;2;0;0;2
13772;Saulutė;"3 klasė";1422040758;Ne;5;0;0;5
13773;Saulutė;"4 klasė";1005459768;Ne;8;0;0;8
13774;Saulutė;"4 klasė";1804521229;Ne;4;0;0;4
13775;Saulutė;"4 klasė";76108591835;Ne;3;0;0;3
13776;Saulutė;"4 klasė";3156830821;Ne;2;0;0;2
13777;Saulutė;"4 klasė";3246485288;Ne;2;0;0;2
13778;Saulutė;"4 klasė";44452051978;Ne;1;0;0;1
13779;Saulutė;"4 klasė";25124975646;Ne;1;0;0;1
13780;Saulutė;"4 klasė";8168961080;Ne;4;0;0;4
13781;Saulutė;"4 klasė";76744652185;Ne;1;0;0;1
13782;Saulutė;"4 klasė";97296161595;Ne;5;0;0;5
13783;Saulutė;"4 klasė";87409240076;Ne;1;0;0;1
13784;Saulutė;"4 klasė";2426509692;Ne;1;0;0;1
13785;Saulutė;"4 klasė";21703177024;Ne;3;0;0;3
13786;Saulutė;"4 klasė";1337654926;Ne;3;0;0;3
13787;Saulutė;"4 klasė";2787531476;Ne;2;0;0;2
13788;Saulutė;"4 klasė";2216383015;Ne;4;0;0;4
13789;Saulutė;"4 klasė";96497471950;Ne;2;0;0;2
13790;Svaja;SAULĖGRĄŽA;3792660330;Ne;0;1;0;1
13791;Svaja;SAULĖGRĄŽA;4510147045;Ne;0;8;0;8
13792;Svaja;SAULĖGRĄŽA;9680766688;Ne;0;5;2;7
13793;Svaja;SAULĖGRĄŽA;3912426942;Ne;0;0;1;1
13794;Svaja;SAULĖGRĄŽA;3809817617;Ne;0;0;3;3
13795;Svaja;SAULĖGRĄŽA;3501620040;Ne;0;0;1;1
13796;Svaja;SAULĖGRĄŽA;6928763381;Ne;0;21;0;21
13797;Svaja;SAULĖGRĄŽA;7408966637;Ne;0;1;0;1
13798;Svaja;SAULĖGRĄŽA;7089640807;Ne;0;5;0;5
13799;Svaja;SAULĖGRĄŽA;3461282516;Ne;0;0;5;5
13800;Svaja;SAULĖGRĄŽA;4253831334;Ne;0;0;3;3
13801;Svaja;SAULĖGRĄŽA;6963684639;Ne;0;0;1;1
13802;Svaja;SAULĖGRĄŽA;4189290919;Ne;0;21;0;21
13803;Svaja;"STEBUKLINGAS ŽIBINTAS";1558093905;Ne;1;0;1;2
13804;Svaja;"STEBUKLINGAS ŽIBINTAS";1050291871;Taip;10;0;1;11
13805;Svaja;"STEBUKLINGAS ŽIBINTAS";2200408537;Ne;5;0;0;5
13806;Svaja;"STEBUKLINGAS ŽIBINTAS";9814969596;Ne;0;0;2;2
13807;Svaja;"STEBUKLINGAS ŽIBINTAS";4290716676;Ne;1;0;0;1
13808;Svaja;"STEBUKLINGAS ŽIBINTAS";9545690301;Ne;5;0;1;6
13809;Svaja;"STEBUKLINGAS ŽIBINTAS";9843726794;Ne;4;0;1;5
13810;Svaja;"STEBUKLINGAS ŽIBINTAS";2658828200;Ne;0;0;1;1
13811;Svaja;"STEBUKLINGAS ŽIBINTAS";3940123543;Ne;5;0;1;6
13812;Svaja;"STEBUKLINGAS ŽIBINTAS";9086270220;Ne;4;10;0;14
13813;Svaja;"STEBUKLINGAS ŽIBINTAS";4237592104;Ne;1;0;0;1
13814;Svaja;"STEBUKLINGAS ŽIBINTAS";7277217069;Ne;3;0;3;6
13815;Svaja;"STEBUKLINGAS ŽIBINTAS";8172396846;Ne;0;0;1;1
13816;Svaja;"STEBUKLINGAS ŽIBINTAS";2188430052;Ne;6;0;1;7
13817;Svaja;"STEBUKLINGAS ŽIBINTAS";4004383843;Ne;0;2;0;2
13818;Svaja;"STEBUKLINGAS ŽIBINTAS";8353427144;Ne;0;0;1;1
13819;Svaja;"STEBUKLINGAS ŽIBINTAS";1150040935;Ne;5;0;0;5
13820;Svaja;SAULUTĖ;8890454460;Ne;0;0;1;1
13821;Svaja;SAULUTĖ;5440231053;Ne;0;0;2;2
13822;Svaja;SAULUTĖ;3382252131;Ne;6;0;0;6
13823;Svaja;SAULUTĖ;4250501744;Ne;4;0;4;8
13824;Svaja;SAULUTĖ;3684781373;Ne;5;2;0;7
13825;Svaja;SAULUTĖ;1013124074;Ne;7;0;1;8
13826;Svaja;SAULUTĖ;8632400763;Ne;2;0;1;3
13827;Svaja;SAULUTĖ;1312040427;Ne;6;0;0;6
13828;Svaja;SAULUTĖ;5455078232;Ne;10;0;1;11
13829;Svaja;SAULUTĖ;7087302180;Ne;8;0;1;9
13830;Svaja;SAULUTĖ;6335409702;Ne;0;0;4;4
13831;Svaja;SAULUTĖ;6027456849;Ne;15;0;1;16
13832;Svaja;SAULUTĖ;8609098948;Ne;5;0;2;7
13833;Svaja;SAULUTĖ;7520701357;Ne;0;2;0;2
13834;Svaja;SAULUTĖ;6765463228;Ne;0;0;1;1
13835;Svaja;SAULUTĖ;4577061794;Ne;9;0;1;10
13836;Svaja;SAULUTĖ;2599692546;Ne;9;0;1;10
13837;Svaja;SAULUTĖ;4415517674;Ne;0;0;1;1
13838;Svaja;SAULUTĖ;6837946814;Ne;0;0;12;12
13839;Svaja;SAULUTĖ;6354364944;Ne;15;0;0;15
13840;Svaja;"AUKSINĖ ŽUVELĖ";1914129062;Ne;0;0;1;1
13841;Svaja;"AUKSINĖ ŽUVELĖ";9826552657;Ne;0;0;1;1
13842;Svaja;"AUKSINĖ ŽUVELĖ";2427918378;Ne;0;1;0;1
13843;Svaja;"AUKSINĖ ŽUVELĖ";3567924341;Ne;6;0;4;10
13844;Svaja;"AUKSINĖ ŽUVELĖ";5033214011;Ne;8;0;0;8
13845;Svaja;"AUKSINĖ ŽUVELĖ";5013548619;Ne;4;0;3;7
13846;Svaja;"AUKSINĖ ŽUVELĖ";9091970902;Ne;0;0;1;1
13847;Svaja;"AUKSINĖ ŽUVELĖ";6028471687;Ne;14;0;1;15
13848;Svaja;"AUKSINĖ ŽUVELĖ";1877749103;Ne;0;0;1;1
13849;Svaja;"AUKSINĖ ŽUVELĖ";7605002899;Ne;0;0;2;2
13850;Svaja;"AUKSINĖ ŽUVELĖ";5230444195;Ne;0;0;1;1
13851;Svaja;"AUKSINĖ ŽUVELĖ";7562678317;Ne;0;0;1;1
13852;Svaja;"AUKSINĖ ŽUVELĖ";5198482539;Ne;5;0;0;5
13853;Svaja;"AUKSINĖ ŽUVELĖ";7434898745;Ne;0;5;0;5
13854;Svaja;"AUKSINĖ ŽUVELĖ";6086270618;Ne;3;0;0;3
13855;Svaja;"AUKSINĖ ŽUVELĖ";1932506236;Ne;4;0;3;7
13856;Svaja;"PRIE ĮLANKOS";9240037050;Ne;0;0;2;2
13857;Svaja;"PRIE ĮLANKOS";3459060550;Ne;13;0;0;13
13858;Svaja;"PRIE ĮLANKOS";7853479591;Ne;0;0;1;1
13859;Svaja;"PRIE ĮLANKOS";5127370193;Ne;0;3;0;3
13860;Svaja;"PRIE ĮLANKOS";6102907953;Ne;0;0;1;1
13861;Svaja;"PRIE ĮLANKOS";2070084064;Ne;9;0;0;9
13862;Svaja;"PRIE ĮLANKOS";4256222944;Ne;0;0;1;1
13863;Svaja;"PRIE ĮLANKOS";4376033711;Taip;3;2;0;5
13864;Svaja;"PRIE ĮLANKOS";6139976105;Ne;4;0;0;4
13865;Svaja;"PRIE ĮLANKOS";3823958567;Ne;0;0;1;1
13866;Svaja;"PRIE ĮLANKOS";6059069293;Ne;0;0;1;1
13867;Svaja;"PRIE ĮLANKOS";8622800666;Ne;10;0;0;10
13868;Svaja;"1 B klasė";20473739993;Ne;0;21;0;21
13869;Svaja;"1 B klasė";50207734108;Ne;0;1;0;1
13870;Svaja;"1 B klasė";8689706130;Ne;0;1;0;1
13871;Svaja;"1 B klasė";1045300185;Ne;0;1;0;1
13872;Svaja;"1 B klasė";6665752307;Ne;0;1;0;1
13873;Svaja;"1 B klasė";5479482244;Ne;0;1;0;1
13874;Svaja;"1 B klasė";7020342969;Ne;0;3;0;3
13875;Svaja;"1 B klasė";2166382346;Ne;0;8;0;8
13876;Svaja;"1 B klasė";8503177793;Ne;0;1;0;1
13877;Svaja;"1 B klasė";1633236289;Ne;0;1;0;1
13878;Svaja;"1 B klasė";8656417794;Ne;0;1;0;1
13879;Svaja;"1 B klasė";4014493868;Ne;0;2;0;2
13880;Svaja;"1 B klasė";6388514464;Ne;0;7;0;7
13881;Svaja;"1 B klasė";1044733634;Ne;0;3;0;3
13882;Svaja;"1 B klasė";1392455608;Ne;0;1;0;1
13883;Svaja;"1 B klasė";9864664937;Ne;0;1;0;1
13884;Svaja;"1 B klasė";1617844709;Ne;0;4;0;4
13885;Svaja;"1 B klasė";5862570666;Ne;0;2;0;2
13886;Svaja;"1 B klasė";3102257512;Ne;0;1;0;1
13887;Svaja;"1 B klasė";4284157599;Ne;0;2;0;2
13888;Svaja;"1 B klasė";9950569499;Ne;0;1;0;1
13889;Svaja;"1 B klasė";3458374439;Ne;0;2;0;2
13890;Svaja;"1 B klasė";4541391191;Ne;0;2;0;2
13891;Svaja;"1 B klasė";7205437280;Ne;0;7;0;7
13892;Svaja;"1 B klasė";6638804854;Ne;0;1;0;1
13893;Svaja;"1 B klasė";67304194087;Ne;0;3;0;3
13894;Svaja;"1 B klasė";3000676765;Taip;0;1;0;1
13895;Svaja;"1 A klasė";9112198914;Ne;0;2;0;2
13896;Svaja;"1 A klasė";6807834176;Ne;0;1;0;1
13897;Svaja;"1 A klasė";7936765752;Ne;4;1;0;5
13898;Svaja;"1 A klasė";3049808328;Ne;0;3;0;3
13899;Svaja;"1 A klasė";3802996573;Taip;0;1;0;1
13900;Svaja;"1 A klasė";5443682744;Ne;0;1;0;1
13901;Svaja;"1 A klasė";9475971731;Ne;0;4;0;4
13902;Svaja;"1 A klasė";4968201186;Ne;0;1;0;1
13903;Svaja;"1 A klasė";7473493846;Taip;0;1;0;1
13904;Svaja;"1 A klasė";30719991872;Ne;0;1;0;1
13905;Svaja;"1 A klasė";3633996231;Ne;0;3;0;3
13906;Svaja;"1 A klasė";2750615517;Ne;0;1;0;1
13907;Svaja;"1 A klasė";9311520300;Ne;0;1;0;1
13908;Svaja;"1 A klasė";5595087767;Ne;0;1;0;1
13909;Svaja;"1 A klasė";6676145522;Taip;0;5;0;5
13910;Svaja;"1 A klasė";2018689468;Ne;0;1;0;1
13911;Svaja;"1 A klasė";1671495181;Ne;0;1;0;1
13912;Svaja;"1 A klasė";7514587933;Ne;0;10;0;10
13913;Svaja;"1 A klasė";4393041946;Ne;0;1;0;1
13914;Svaja;"1 A klasė";3868254757;Ne;0;1;0;1
13915;Svaja;"1 A klasė";1377813636;Ne;0;2;0;2
13916;Svaja;"1 A klasė";3630922360;Ne;0;1;0;1
13917;Svaja;"1 A klasė";6995285377;Ne;0;4;0;4
13918;Svaja;"1 A klasė";2436416327;Ne;0;2;0;2
13919;Svaja;"1 A klasė";8357287467;Taip;0;1;0;1
13920;Svaja;"1 A klasė";3636826798;Ne;0;1;0;1
13921;Svaja;"1 A klasė";1114477688;Ne;0;3;0;3
13922;Svaja;"1 A klasė";5356005675;Ne;0;3;0;3
13923;Svaja;"2 A klasė";43307670660;Ne;0;2;0;2
13924;Svaja;"2 A klasė";58102699652;Ne;0;2;0;2
13925;Svaja;"2 A klasė";5335776957;Ne;0;21;0;21
13926;Svaja;"2 A klasė";22702341083;Ne;0;3;0;3
13927;Svaja;"2 A klasė";2076060840;Ne;0;2;0;2
13928;Svaja;"2 A klasė";27445299450;Ne;0;2;0;2
13929;Svaja;"2 A klasė";1576498450;Ne;0;2;0;2
13930;Svaja;"2 A klasė";1714711904;Ne;0;11;0;11
13931;Svaja;"2 A klasė";1046879533;Ne;0;3;0;3
13932;Svaja;"2 A klasė";65917456866;Ne;0;2;0;2
13933;Svaja;"2 A klasė";4846025153;Ne;0;2;0;2
13934;Svaja;"2 A klasė";47457128214;Ne;0;4;0;4
13935;Svaja;"2 A klasė";2147266053;Ne;0;2;0;2
13936;Svaja;"2 A klasė";1197826066;Ne;0;2;0;2
13937;Svaja;"2 A klasė";5337604370;Ne;0;2;0;2
13938;Svaja;"2 A klasė";73679997517;Ne;0;3;0;3
13939;Svaja;"2 A klasė";56117509354;Ne;0;2;0;2
13940;Svaja;"2 A klasė";7669562010;Ne;0;4;0;4
13941;Svaja;"2 A klasė";4900757614;Ne;0;2;0;2
13942;Svaja;"2 A klasė";1061894314;Ne;0;3;0;3
13943;Svaja;"2 A klasė";8697355813;Ne;0;5;0;5
13944;Svaja;"2 A klasė";193181908;Ne;0;2;0;2
13945;Svaja;"2 A klasė";193181908;Ne;0;2;0;2
13946;Svaja;"2 B klasė";25194696146;Ne;0;6;0;6
13947;Svaja;"2 B klasė";55925058866;Ne;0;21;0;21
13948;Svaja;"2 B klasė";1704075006;Ne;0;2;0;2
13949;Svaja;"2 B klasė";8875237023;Ne;0;2;0;2
13950;Svaja;"2 B klasė";8279605005;Ne;0;21;0;21
13951;Svaja;"2 B klasė";1437557657;Ne;0;10;0;10
13952;Svaja;"2 B klasė";36505115395;Ne;0;21;0;21
13953;Svaja;"2 B klasė";6593047776;Ne;0;4;0;4
13954;Svaja;"2 B klasė";7911488445;Ne;0;2;0;2
13955;Svaja;"2 B klasė";64196174690;Ne;0;21;0;21
13956;Svaja;"2 B klasė";7753488216;Ne;0;2;0;2
13957;Svaja;"2 B klasė";21871530266;Ne;0;2;0;2
13958;Svaja;"2 B klasė";9110985103;Ne;0;2;0;2
13959;Svaja;"2 B klasė";2985196852;Ne;0;4;0;4
13960;Svaja;"2 B klasė";3562817807;Ne;0;21;0;21
13961;Svaja;"2 B klasė";2069150261;Taip;0;2;0;2
13962;Svaja;"2 B klasė";1191494598;Ne;0;4;0;4
13963;Svaja;"2 B klasė";24863928147;Ne;0;2;0;2
13964;Svaja;"2 B klasė";15159708127;Ne;0;2;0;2
13965;Svaja;"2 B klasė";8491275729;Ne;0;2;0;2
13966;Svaja;"2 B klasė";11671380984;Ne;0;2;0;2
13967;Svaja;"2 B klasė";99183628764;Ne;0;5;0;5
13968;Svaja;"2 B klasė";1369637618;Ne;0;2;0;2
13969;Svaja;"2 B klasė";3660152224;Ne;0;2;0;2
13970;Svaja;"2 B klasė";1865658456;Ne;0;3;0;3
13971;Svaja;"3 A klasė";9628146488;Ne;0;1;0;1
13972;Svaja;"3 A klasė";1017471747;Ne;0;1;0;1
13973;Svaja;"3 A klasė";1304775332;Ne;0;1;0;1
13974;Svaja;"3 A klasė";26902749194;Ne;0;1;0;1
13975;Svaja;"3 A klasė";1297727288;Ne;0;1;0;1
13976;Svaja;"3 A klasė";30027404222;Ne;0;1;0;1
13977;Svaja;"3 A klasė";1352488176;Taip;0;3;0;3
13978;Svaja;"3 A klasė";1943166503;Ne;0;5;0;5
13979;Svaja;"3 A klasė";8198614500;Ne;0;5;0;5
13980;Svaja;"3 A klasė";5522433229;Ne;0;1;0;1
13981;Svaja;"3 A klasė";40856210635;Ne;0;14;0;14
13982;Svaja;"3 A klasė";67462299886;Ne;0;3;0;3
13983;Svaja;"3 A klasė";18733824395;Ne;0;1;0;1
13984;Svaja;"3 A klasė";26500981786;Ne;0;1;0;1
13985;Svaja;"3 A klasė";89042677798;Ne;0;1;0;1
13986;Svaja;"3 A klasė";3022690832;Ne;0;2;0;2
13987;Svaja;"3 A klasė";23112873505;Ne;0;1;0;1
13988;Svaja;"3 A klasė";15246943974;Ne;0;1;0;1
13989;Svaja;"3 A klasė";1562041360;Ne;0;1;0;1
13990;Svaja;"3 A klasė";2058827699;Ne;0;2;0;2
13991;Svaja;"3 A klasė";84508228457;Ne;0;3;0;3
13992;Svaja;"3 A klasė";1048576329;Ne;0;1;0;1
13993;Svaja;"3 B klasė";69028070656;Ne;0;2;0;2
13994;Svaja;"3 B klasė";30360097999;Ne;0;21;0;21
13995;Svaja;"3 B klasė";19887874988;Ne;0;1;0;1
13996;Svaja;"3 B klasė";1967394949;Ne;0;1;0;1
13997;Svaja;"3 B klasė";7719185632;Ne;0;2;0;2
13998;Svaja;"3 B klasė";57216954289;Ne;0;1;0;1
13999;Svaja;"3 B klasė";44989143252;Ne;0;4;0;4
14000;Svaja;"3 B klasė";87432529423;Ne;0;1;0;1
14001;Svaja;"3 B klasė";3077814152;Ne;0;2;0;2
14002;Svaja;"3 B klasė";6056157113;Ne;0;1;0;1
14003;Svaja;"3 B klasė";21608020858;Ne;0;1;0;1
14004;Svaja;"3 B klasė";1655551042;Ne;0;1;0;1
14005;Svaja;"3 B klasė";1601648171;Taip;0;1;0;1
14006;Svaja;"3 B klasė";1509272327;Ne;0;6;0;6
14007;Svaja;"3 B klasė";4804779327;Ne;0;21;0;21
14008;Svaja;"3 B klasė";40814723278;Ne;0;1;0;1
14009;Svaja;"3 B klasė";69413101571;Ne;0;1;0;1
14010;Svaja;"3 B klasė";54745410330;Ne;0;1;0;1
14011;Svaja;"3 B klasė";4881476441;Ne;0;1;0;1
14012;Svaja;"3 B klasė";78293798850;Ne;0;1;0;1
14013;Svaja;"3 B klasė";30036722764;Ne;0;1;0;1
14014;Svaja;"3 B klasė";89316574266;Ne;0;21;0;21
14015;Svaja;"3 B klasė";809734624;Ne;0;1;0;1
14016;Svaja;"3 B klasė";76618850202;Ne;0;6;0;6
14017;Svaja;"3 B klasė";1378219785;Ne;0;1;0;1
14018;Svaja;"4 A klasė";6057524892;Ne;0;1;0;1
14019;Svaja;"4 A klasė";63346231562;Ne;0;10;0;10
14020;Svaja;"4 A klasė";25578518444;Ne;0;4;0;4
14021;Svaja;"4 A klasė";64487515384;Ne;0;21;0;21
14022;Svaja;"4 A klasė";89695643588;Ne;0;15;0;15
14023;Svaja;"4 A klasė";15252353189;Ne;0;2;0;2
14024;Svaja;"4 A klasė";4617061890;Taip;0;3;0;3
14025;Svaja;"4 A klasė";8828911320;Ne;0;1;0;1
14026;Svaja;"4 A klasė";75104768118;Ne;0;1;0;1
14027;Svaja;"4 A klasė";3604946305;Ne;0;21;0;21
14028;Svaja;"4 A klasė";34216516886;Ne;0;1;0;1
14029;Svaja;"4 A klasė";3474439050;Ne;0;4;0;4
14030;Svaja;"4 A klasė";72752022712;Ne;0;1;0;1
14031;Svaja;"4 A klasė";30754812113;Ne;0;1;0;1
14032;Svaja;"4 A klasė";75296600945;Ne;0;3;0;3
14033;Svaja;"4 A klasė";2321739150;Ne;0;7;0;7
14034;Svaja;"4 A klasė";1168637823;Ne;0;4;0;4
14035;Svaja;"4 A klasė";4906784415;Ne;0;2;0;2
14036;Svaja;"4 A klasė";60448774566;Ne;0;5;0;5
14037;Svaja;"4 A klasė";1649920341;Ne;0;1;0;1
14038;Svaja;"4 B klasė";70506691027;Ne;0;21;0;21
14039;Svaja;"4 B klasė";73391331150;Ne;0;21;0;21
14040;Svaja;"4 B klasė";70507326327;Ne;0;21;0;21
14041;Svaja;"4 B klasė";1470843400;Ne;0;1;0;1
14042;Svaja;"4 B klasė";8011137572;Ne;0;1;0;1
14043;Svaja;"4 B klasė";4416877973;Ne;0;5;0;5
14044;Svaja;"4 B klasė";54328462992;Ne;0;21;0;21
14045;Svaja;"4 B klasė";44418402260;Ne;0;1;0;1
14046;Svaja;"4 B klasė";1367687415;Ne;0;1;0;1
14047;Svaja;"4 B klasė";92044111261;Ne;0;1;0;1
14048;Svaja;"4 B klasė";1847775266;Ne;0;8;0;8
14049;Svaja;"4 B klasė";71708072632;Ne;0;1;0;1
14050;Svaja;"4 B klasė";56506642672;Ne;0;6;0;6
14051;Svaja;"4 B klasė";17947580061;Ne;0;4;0;4
14052;Svaja;"4 B klasė";3526873547;Ne;0;8;0;8
14053;Svaja;"4 B klasė";62971657427;Ne;0;1;0;1
14054;Svaja;"4 B klasė";50649509868;Ne;0;21;0;21
14055;Svaja;"4 B klasė";80772711351;Ne;0;2;0;2
14056;Svaja;"4 B klasė";11937575740;Ne;0;1;0;1
14057;Svaja;"4 B klasė";6969692916;Ne;0;21;0;21
14058;Svaja;"4 B klasė";4282243865;Ne;0;7;0;7
14059;Svaja;"4 B klasė";6905550313;Ne;0;2;0;2
14060;Svaja;"4 C klasė";93651139102;Ne;0;1;0;1
14061;Svaja;"4 C klasė";25934507261;Ne;0;2;0;2
14062;Svaja;"4 C klasė";89047123808;Ne;0;1;0;1
14063;Svaja;"4 C klasė";41183537732;Ne;0;2;0;2
14064;Svaja;"4 C klasė";50510924690;Ne;0;1;0;1
14065;Svaja;"4 C klasė";54462393937;Ne;0;10;0;10
14066;Svaja;"4 C klasė";74904581010;Ne;0;2;0;2
14067;Svaja;"4 C klasė";1795682827;Ne;0;4;0;4
14068;Svaja;"4 C klasė";2165716699;Ne;0;21;0;21
14069;Svaja;"4 C klasė";94449039022;Ne;0;21;0;21
14070;Svaja;"4 C klasė";85150525696;Ne;0;1;0;1
14071;Svaja;"4 C klasė";36001411632;Ne;0;1;0;1
14072;Svaja;"4 C klasė";34995551069;Ne;0;21;0;21
14073;Svaja;"4 C klasė";1742951527;Ne;0;1;0;1
14074;Svaja;"4 C klasė";1848422504;Ne;0;3;0;3
14075;Svaja;"4 C klasė";3743948734;Ne;0;3;0;3
14076;Svaja;"4 C klasė";70714898590;Ne;0;1;0;1
14077;Svaja;"4 C klasė";54852358913;Taip;0;9;0;9
14078;Svaja;"4 C klasė";57253216255;Ne;0;7;0;7
14079;Svaja;"4 C klasė";91855230473;Ne;0;3;0;3
14080;Svaja;"4 C klasė";1855559693;Ne;0;21;0;21
14081;Svaja;"4 C klasė";31216445971;Ne;0;21;0;21
14082;Svaja;"4 C klasė";20342193231;Ne;0;1;0;1
14083;Svaja;"4 C klasė";91088224294;Ne;0;21;0;21
14084;Šilelis;PAUKŠTELIAI;6128379060;Ne;0;16;5;21
14085;Šilelis;PAUKŠTELIAI;9653439873;Ne;4;1;0;5
14086;Šilelis;PAUKŠTELIAI;2823486581;Ne;0;1;0;1
14087;Šilelis;PAUKŠTELIAI;6369443270;Ne;0;2;0;2
14088;Šilelis;PAUKŠTELIAI;7595774842;Ne;0;0;1;1
14089;Šilelis;PAUKŠTELIAI;6614686867;Ne;6;8;0;14
14090;Šilelis;PAUKŠTELIAI;3053443777;Ne;0;10;0;10
14091;Šilelis;PAUKŠTELIAI;4960501068;Ne;0;4;0;4
14092;Šilelis;PAUKŠTELIAI;7072057348;Ne;0;7;0;7
14093;Šilelis;PAUKŠTELIAI;5974537364;Taip;0;5;3;8
14094;Šilelis;PAUKŠTELIAI;8166061969;Ne;6;0;0;6
14095;Šilelis;PAUKŠTELIAI;1124854378;Ne;0;7;0;7
14096;Šilelis;PAUKŠTELIAI;8184170908;Ne;6;0;0;6
14097;Šilelis;PAUKŠTELIAI;4432542988;Ne;1;0;0;1
14098;Šilelis;PAUKŠTELIAI;9799198904;Taip;0;0;1;1
14099;Šilelis;PAUKŠTELIAI;5493811298;Ne;2;0;0;2
14100;Šilelis;PAUKŠTELIAI;4032841142;Ne;1;0;0;1
14101;Šilelis;PAUKŠTELIAI;5951309572;Ne;0;0;4;4
14102;Šilelis;SKRUZDELIUKAI;6359318134;Ne;2;0;1;3
14103;Šilelis;SKRUZDELIUKAI;5598152793;Taip;1;0;4;5
14104;Šilelis;SKRUZDELIUKAI;8090773379;Ne;0;4;0;4
14105;Šilelis;SKRUZDELIUKAI;7299084520;Ne;0;1;0;1
14106;Šilelis;SKRUZDELIUKAI;9589138527;Ne;14;0;0;14
14107;Šilelis;SKRUZDELIUKAI;3967932407;Ne;0;5;0;5
14108;Šilelis;SKRUZDELIUKAI;2972202874;Taip;5;0;0;5
14109;Šilelis;SKRUZDELIUKAI;9461117894;Ne;0;16;3;19
14110;Šilelis;SKRUZDELIUKAI;5817818596;Ne;6;0;11;17
14111;Šilelis;SKRUZDELIUKAI;5091571136;Ne;0;0;3;3
14112;Šilelis;SKRUZDELIUKAI;8297975308;Ne;0;10;0;10
14113;Šilelis;SKRUZDELIUKAI;3381053227;Ne;0;14;0;14
14114;Šilelis;SKRUZDELIUKAI;9276607554;Taip;0;20;1;21
14115;Šilelis;SMERFY;3247333567;Ne;0;3;0;3
14116;Šilelis;SMERFY;3089270468;Ne;0;5;0;5
14117;Šilelis;SMERFY;7534468539;Ne;0;0;1;1
14118;Šilelis;SMERFY;6390855924;Ne;1;1;0;2
14119;Šilelis;SMERFY;4196893379;Ne;0;6;0;6
14120;Šilelis;SMERFY;5025956218;Ne;5;0;0;5
14121;Šilelis;SMERFY;8909345826;Ne;2;0;0;2
14122;Šilelis;SMERFY;9502563865;Ne;0;3;0;3
14123;Šilelis;SMERFY;3452984649;Ne;3;0;0;3
14124;Šilelis;SMERFY;8659845107;Ne;5;0;0;5
14125;Šilelis;SMERFY;1906712332;Ne;4;0;0;4
14126;Šilelis;EŽIUKAI;7074963804;Ne;0;1;0;1
14127;Šilelis;EŽIUKAI;4702068672;Ne;0;6;0;6
14128;Šilelis;EŽIUKAI;2295849333;Ne;6;1;0;7
14129;Šilelis;EŽIUKAI;1883483049;Ne;3;10;0;13
14130;Šilelis;EŽIUKAI;6854997486;Ne;3;0;0;3
14131;Šilelis;EŽIUKAI;6386996498;Ne;6;0;0;6
14132;Šilelis;EŽIUKAI;6233673622;Ne;8;0;0;8
14133;Šilelis;EŽIUKAI;5314433515;Ne;16;0;0;16
14134;Šilelis;EŽIUKAI;1980323777;Ne;16;0;0;16
14135;Šilelis;EŽIUKAI;9203888742;Ne;3;3;0;6
14136;Šilelis;EŽIUKAI;2289616655;Ne;4;0;0;4
14137;Šilelis;EŽIUKAI;5167084901;Ne;0;0;4;4
14138;Šilelis;EŽIUKAI;3669647107;Ne;0;1;0;1
14139;Šilelis;EŽIUKAI;2151250706;Ne;4;0;0;4
14140;Šilelis;NYKŠTUKAI;3046954717;Ne;2;0;1;3
14141;Šilelis;NYKŠTUKAI;3158708835;Ne;4;2;0;6
14142;Šilelis;NYKŠTUKAI;6195580698;Ne;5;0;4;9
14143;Šilelis;NYKŠTUKAI;4323998445;Taip;0;0;3;3
14144;Šilelis;NYKŠTUKAI;2095572561;Taip;4;0;9;13
14145;Šilelis;NYKŠTUKAI;2161973782;Ne;8;3;0;11
14146;Šilelis;NYKŠTUKAI;4459114205;Ne;0;2;0;2
14147;Šilelis;NYKŠTUKAI;3728633100;Ne;0;7;0;7
14148;Šilelis;NYKŠTUKAI;3999426414;Ne;0;5;0;5
14149;Šilelis;NYKŠTUKAI;9769483899;Ne;0;1;0;1
14150;Šilelis;NYKŠTUKAI;8944490184;Ne;0;0;2;2
14151;Šilelis;NYKŠTUKAI;2908840424;Ne;6;0;1;7
14152;Šilelis;NYKŠTUKAI;6980045156;Ne;0;10;0;10
14153;Šilelis;NYKŠTUKAI;4868465692;Ne;7;3;0;10
14154;Šilelis;NYKŠTUKAI;4754544277;Ne;0;4;0;4
14155;Šilelis;NYKŠTUKAI;1222028604;Ne;8;0;3;11
14156;Šilelis;NYKŠTUKAI;7480611069;Ne;0;0;1;1
14157;Šilelis;NYKŠTUKAI;9360553910;Ne;8;3;0;11
14158;Šilelis;NYKŠTUKAI;6852463814;Ne;0;12;0;12
14159;Šilelis;ANČIUKAI;4336942500;Ne;0;0;3;3
14160;Šilelis;ANČIUKAI;9661578871;Ne;0;0;4;4
14161;Šilelis;ANČIUKAI;6616262730;Ne;0;1;1;2
14162;Šilelis;ANČIUKAI;4323750313;Ne;0;7;1;8
14163;Šilelis;ANČIUKAI;3221398692;Ne;0;0;1;1
14164;Šilelis;ANČIUKAI;6364741317;Ne;6;0;3;9
14165;Šilelis;ANČIUKAI;1325857464;Taip;0;0;4;4
14166;Šilelis;ANČIUKAI;9407916190;Ne;0;7;0;7
14167;Šilelis;ANČIUKAI;8188160849;Ne;0;5;0;5
14168;Šilelis;ANČIUKAI;7128670936;Ne;12;0;2;14
14169;Šilelis;ANČIUKAI;8613748314;Ne;4;5;0;9
14170;Šilelis;ANČIUKAI;5381213051;Taip;10;0;0;10
14171;Šilelis;ANČIUKAI;8807755852;Ne;0;4;0;4
14172;Šilelis;ANČIUKAI;5926624138;Taip;0;0;2;2
14173;Šilelis;ANČIUKAI;8603589758;Ne;15;0;0;15
14174;Šilelis;ANČIUKAI;4996192593;Ne;6;0;5;11
14175;Šilelis;ANČIUKAI;6485433036;Ne;8;0;6;14
14176;Šilelis;ANČIUKAI;7968869585;Taip;11;0;0;11
14177;Šilelis;ANČIUKAI;3182336761;Taip;5;0;3;8
14178;Šilelis;ANČIUKAI;9767000842;Taip;0;0;3;3
14179;Šilelis;KAČIUKAI;3216168797;Ne;5;0;2;7
14180;Šilelis;KAČIUKAI;9848760151;Taip;4;1;0;5
14181;Šilelis;KAČIUKAI;4743459915;Ne;0;1;0;1
14182;Šilelis;KAČIUKAI;8387022157;Ne;0;10;0;10
14183;Šilelis;KAČIUKAI;3393466953;Taip;0;11;0;11
14184;Šilelis;KAČIUKAI;2111979474;Ne;0;5;0;5
14185;Šilelis;KAČIUKAI;8064905796;Ne;0;3;0;3
14186;Šilelis;KAČIUKAI;7123048946;Ne;0;1;3;4
14187;Šilelis;KAČIUKAI;2906501601;Ne;0;3;0;3
14188;Šilelis;KAČIUKAI;6510813364;Ne;0;4;0;4
14189;Šilelis;KAČIUKAI;8319185507;Ne;0;1;0;1
14190;Šilelis;KAČIUKAI;8504187981;Taip;4;0;0;4
14191;Šilelis;KAČIUKAI;6470073008;Ne;0;4;0;4
14192;Šilelis;KAČIUKAI;3419284228;Ne;0;1;1;2
14193;Šilelis;KAČIUKAI;3712001932;Ne;0;1;0;1
14194;Šilelis;KAČIUKAI;9106999969;Ne;6;10;0;16
14195;Šilelis;KAČIUKAI;6894466509;Ne;1;5;0;6
14196;Šilelis;KAČIUKAI;5026203678;Ne;8;2;0;10
14197;Šilelis;KAČIUKAI;4272205822;Taip;0;8;1;9
14198;Šilelis;KAČIUKAI;6561145380;Ne;0;3;0;3
14199;Šilelis;KAČIUKAI;5138192616;Ne;0;1;3;4
14200;Šilelis;KIŠKUČIAI;9480895465;Taip;0;6;2;8
14201;Šilelis;KIŠKUČIAI;8759694551;Ne;8;0;0;8
14202;Šilelis;KIŠKUČIAI;2209552706;Ne;15;0;0;15
14203;Šilelis;KIŠKUČIAI;4386065478;Ne;1;0;0;1
14204;Šilelis;KIŠKUČIAI;7043644521;Ne;11;0;0;11
14205;Šilelis;KIŠKUČIAI;3395084186;Ne;1;0;0;1
14206;Šilelis;KIŠKUČIAI;9746722034;Ne;2;0;1;3
14207;Šilelis;KIŠKUČIAI;2551747888;Ne;3;0;0;3
14208;Šilelis;KIŠKUČIAI;5815768693;Ne;4;0;0;4
14209;Šilelis;KIŠKUČIAI;8598321310;Ne;4;0;4;8
14210;Šilelis;KIŠKUČIAI;5431978292;Ne;0;0;1;1
14211;Šilelis;KIŠKUČIAI;6415777619;Ne;2;0;0;2
14212;Šilelis;KIŠKUČIAI;7630784355;Ne;0;2;0;2
14213;Šilelis;KIŠKUČIAI;4910899296;Taip;2;0;0;2
14214;Šilelis;KREGŽDUTĖS;1025643459;Ne;0;0;2;2
14215;Šilelis;KREGŽDUTĖS;8453070684;Ne;5;0;0;5
14216;Šilelis;KREGŽDUTĖS;3068950702;Ne;9;0;0;9
14217;Šilelis;KREGŽDUTĖS;8665357907;Ne;1;0;1;2
14218;Šilelis;KREGŽDUTĖS;1152159735;Taip;1;0;0;1
14219;Šilelis;KREGŽDUTĖS;6630114847;Taip;4;0;0;4
14220;Šilelis;KREGŽDUTĖS;3953114161;Taip;5;0;1;6
14221;Šilelis;KREGŽDUTĖS;2499322761;Ne;7;2;0;9
14222;Šilelis;KREGŽDUTĖS;5868594049;Ne;0;0;4;4
14223;Šilelis;KREGŽDUTĖS;1279361795;Taip;1;1;0;2
14224;Šilelis;KREGŽDUTĖS;9292761872;Ne;7;0;1;8
14225;Šilelis;KREGŽDUTĖS;9715544798;Ne;3;1;0;4
14226;Šilelis;KREGŽDUTĖS;6987557382;Ne;6;0;0;6
14227;Šilelis;KREGŽDUTĖS;4696129999;Ne;2;0;0;2
14228;Šilelis;KREGŽDUTĖS;5192604763;Ne;0;0;2;2
14229;Šilelis;KREGŽDUTĖS;6065839221;Ne;1;0;0;1
14230;Šilelis;PAGRANDUKAI;8632645047;Ne;3;0;0;3
14231;Šilelis;PAGRANDUKAI;8616798722;Ne;3;0;0;3
14232;Šilelis;PAGRANDUKAI;6598481106;Ne;4;0;0;4
14233;Šilelis;PAGRANDUKAI;7900611929;Ne;3;0;0;3
14234;Šilelis;PAGRANDUKAI;1325551883;Ne;4;0;1;5
14235;Šilelis;PAGRANDUKAI;6090493923;Ne;13;0;0;13
14236;Šilelis;PAGRANDUKAI;3730589571;Taip;1;0;1;2
14237;Šilelis;PAGRANDUKAI;5090120850;Ne;5;0;0;5
14238;Šilelis;PAGRANDUKAI;3147394614;Ne;2;0;0;2
14239;Šilelis;PAGRANDUKAI;4275363307;Ne;4;0;1;5
14240;Šilelis;PAGRANDUKAI;2702371841;Ne;6;0;0;6
14241;Šilelis;PAGRANDUKAI;2378919393;Ne;9;0;0;9
14242;Šilelis;PAGRANDUKAI;3727531756;Ne;0;0;2;2
14243;Šilelis;BITUTĖS;7512731255;Ne;8;1;1;10
14244;Šilelis;BITUTĖS;7814807923;Ne;0;3;0;3
14245;Šilelis;BITUTĖS;9071963194;Ne;3;0;0;3
14246;Šilelis;BITUTĖS;1960952604;Ne;0;7;0;7
14247;Šilelis;BITUTĖS;7350013139;Ne;5;0;0;5
14248;Šilelis;BITUTĖS;3879234745;Taip;0;1;0;1
14249;Šilelis;BITUTĖS;2023309512;Ne;10;0;0;10
14250;Šilelis;BITUTĖS;5375413045;Ne;0;15;0;15
14251;Šilelis;BITUTĖS;6830200578;Ne;0;4;0;4
14252;Šilelis;BITUTĖS;6479728064;Ne;0;5;0;5
14253;Šilelis;BITUTĖS;3686287802;Ne;0;0;1;1
14254;Šilelis;BITUTĖS;9602317911;Ne;0;1;0;1
14255;Šilelis;BITUTĖS;8304500877;Ne;0;0;1;1
14256;Šilelis;BITUTĖS;8741597642;Ne;0;0;1;1
14257;Šilelis;BITUTĖS;7061399035;Taip;0;0;3;3
14258;Šilelis;DRUGELIAI;6800679760;Ne;2;0;0;2
14259;Šilelis;DRUGELIAI;3100416582;Ne;7;0;3;10
14260;Šilelis;DRUGELIAI;8563843417;Ne;0;0;1;1
14261;Šilelis;DRUGELIAI;3134882364;Ne;0;0;2;2
14262;Šilelis;DRUGELIAI;5131513427;Ne;0;0;3;3
14263;Šilelis;DRUGELIAI;2575292661;Ne;0;5;0;5
14264;Šilelis;DRUGELIAI;4762848901;Ne;0;0;2;2
14265;Šilelis;DRUGELIAI;2073341570;Ne;5;0;2;7
14266;Šilelis;DRUGELIAI;3940956024;Ne;13;0;0;13
14267;Šilelis;DRUGELIAI;9047094780;Ne;0;9;0;9
14268;Šilelis;DRUGELIAI;1244496708;Ne;0;0;1;1
14269;Šilelis;DRUGELIAI;9593306122;Ne;0;0;4;4
14270;Šilelis;DRUGELIAI;5899112658;Ne;0;0;2;2
14271;Vaivorykštė;1A;18971508901;Taip;2;0;0;2
14272;Vaduvos;PAGRANDUKAI;6611531526;Ne;7;0;0;7
14273;Vaduvos;PAGRANDUKAI;4576510280;Ne;9;0;0;9
14274;Vaduvos;PAGRANDUKAI;3060409258;Ne;0;2;0;2
14275;Vaduvos;PAGRANDUKAI;8070494719;Ne;4;0;0;4
14276;Vaduvos;PAGRANDUKAI;3206096414;Ne;8;0;0;8
14277;Vaduvos;PAGRANDUKAI;9232960362;Ne;10;0;0;10
14278;Vaduvos;PAGRANDUKAI;7425991335;Ne;3;0;0;3
14279;Vaduvos;PAGRANDUKAI;8533315132;Ne;0;7;0;7
14280;Vaduvos;PAGRANDUKAI;2508650990;Ne;0;1;0;1
14281;Vaduvos;PAGRANDUKAI;1466282653;Ne;4;0;0;4
14282;Vaduvos;PAGRANDUKAI;8055108164;Ne;5;0;0;5
14283;Vaduvos;PAGRANDUKAI;6943057114;Ne;6;0;0;6
14284;Vaduvos;PAGRANDUKAI;8669267296;Ne;0;4;0;4
14285;Vaduvos;PAGRANDUKAI;1736248725;Taip;10;3;0;13
14286;Vaduvos;PAGRANDUKAI;2369774637;Ne;11;0;0;11
14287;Vaduvos;PAGRANDUKAI;9385879695;Taip;6;0;0;6
14288;Vaduvos;PAGRANDUKAI;1414575326;Ne;1;0;0;1
14289;Vaduvos;PAGRANDUKAI;7205880191;Ne;15;0;0;15
14290;Vaduvos;PAGRANDUKAI;3695552176;Ne;8;0;0;8
14291;Vaduvos;KODĖLČIUKAI;3010510262;Ne;6;0;0;6
14292;Vaduvos;KODĖLČIUKAI;6210729584;Ne;11;0;0;11
14293;Vaduvos;KODĖLČIUKAI;9606193112;Ne;3;0;0;3
14294;Vaduvos;KODĖLČIUKAI;4177935331;Ne;0;6;0;6
14295;Vaduvos;KODĖLČIUKAI;9983148737;Ne;1;1;0;2
14296;Vaduvos;KODĖLČIUKAI;6810198013;Ne;0;1;0;1
14297;Vaduvos;KODĖLČIUKAI;8603418399;Taip;7;0;0;7
14298;Vaduvos;KODĖLČIUKAI;3096104197;Ne;13;0;0;13
14299;Vaduvos;KODĖLČIUKAI;9597857664;Ne;5;1;0;6
14300;Vaduvos;KODĖLČIUKAI;1054097622;Ne;6;2;0;8
14301;Vaduvos;KODĖLČIUKAI;6013737546;Ne;5;1;0;6
14302;Vaduvos;KODĖLČIUKAI;4789480822;Ne;0;3;0;3
14303;Vaduvos;KODĖLČIUKAI;7904713344;Ne;0;6;0;6
14304;Vaduvos;SMALSUČIAI;2184711783;Ne;0;1;0;1
14305;Vaduvos;SMALSUČIAI;7181151562;Taip;0;1;0;1
14306;Vaduvos;SMALSUČIAI;6462126837;Ne;0;1;0;1
14307;Vaduvos;SMALSUČIAI;1265287458;Ne;4;1;0;5
14308;Vaduvos;SMALSUČIAI;3948025914;Ne;2;3;0;5
14309;Vaduvos;SMALSUČIAI;6253552951;Ne;6;2;0;8
14310;Vaduvos;SMALSUČIAI;7789888994;Ne;2;0;0;2
14311;Vaduvos;SMALSUČIAI;6593271671;Ne;0;1;0;1
14312;Vaduvos;SMALSUČIAI;6379952023;Ne;6;3;0;9
14313;Vaduvos;SMALSUČIAI;4550915388;Ne;6;1;0;7
14314;Vaduvos;SMALSUČIAI;8324927031;Ne;0;4;0;4
14315;Vaduvos;SMALSUČIAI;3680758366;Ne;2;0;0;2
14316;Vaduvos;GILIUKAI;1277811729;Ne;0;3;0;3
14317;Vaduvos;GILIUKAI;1969325922;Taip;0;1;0;1
14318;Vaduvos;GILIUKAI;5376707663;Taip;0;2;0;2
14319;Vaduvos;GILIUKAI;2835635250;Ne;5;0;0;5
14320;Vaduvos;GILIUKAI;2939561403;Ne;0;4;0;4
14321;Vaduvos;GILIUKAI;8188374113;Ne;5;1;0;6
14322;Vaduvos;GILIUKAI;3057729267;Ne;5;0;0;5
14323;Vaduvos;GILIUKAI;6276149710;Ne;5;3;0;8
14324;Vaduvos;GILIUKAI;6572776966;Ne;5;0;0;5
14325;Vaduvos;GILIUKAI;6676167440;Ne;6;0;0;6
14326;Vaduvos;GILIUKAI;2957685586;Taip;6;3;0;9
14327;Vaduvos;GILIUKAI;3540548094;Ne;0;1;0;1
14328;Vaduvos;GILIUKAI;8964194121;Ne;11;0;0;11
14329;Vaduvos;GILIUKAI;5297217576;Ne;0;2;0;2
14330;Vaduvos;GILIUKAI;5010914832;Ne;7;0;0;7
14331;Vaduvos;GILIUKAI;4030891958;Ne;0;3;0;3
14332;Vaduvos;GILIUKAI;7730737705;Ne;0;1;0;1
14333;Vaduvos;GILIUKAI;2011976336;Ne;6;3;0;9
14334;Vaduvos;GILIUKAI;5510687497;Ne;8;5;0;13
14335;Vaduvos;BORUŽĖLĖS;6439773886;Ne;0;1;0;1
14336;Vaduvos;BORUŽĖLĖS;5634252033;Ne;0;2;0;2
14337;Vaduvos;BORUŽĖLĖS;6593754016;Ne;8;2;0;10
14338;Vaduvos;BORUŽĖLĖS;7521846747;Ne;0;3;0;3
14339;Vaduvos;BORUŽĖLĖS;1422507884;Ne;16;1;0;17
14340;Vaduvos;BORUŽĖLĖS;3461756429;Ne;1;0;0;1
14341;Vaduvos;BORUŽĖLĖS;2417613291;Ne;2;0;0;2
14342;Vaduvos;BORUŽĖLĖS;5717064754;Ne;3;2;0;5
14343;Vaduvos;BORUŽĖLĖS;8064111922;Ne;4;1;0;5
14344;Vaduvos;BORUŽĖLĖS;3255011809;Ne;10;2;0;12
14345;Vaduvos;BORUŽĖLĖS;7169054113;Ne;5;0;0;5
14346;Vaduvos;BORUŽĖLĖS;2366843609;Ne;5;1;0;6
14347;Vaduvos;BORUŽĖLĖS;6991960029;Ne;0;3;0;3
14348;Vaduvos;DRUGELIAI;4936598927;Ne;6;1;0;7
14349;Vaduvos;DRUGELIAI;9824469881;Ne;6;0;0;6
14350;Vaduvos;DRUGELIAI;5915272436;Ne;7;0;0;7
14351;Vaduvos;DRUGELIAI;1539465611;Ne;0;1;0;1
14352;Vaduvos;DRUGELIAI;8384302877;Ne;2;1;0;3
14353;Vaduvos;DRUGELIAI;6770559352;Taip;5;4;0;9
14354;Vaduvos;DRUGELIAI;4856601924;Ne;4;0;0;4
14355;Vaduvos;DRUGELIAI;2452309232;Taip;0;2;0;2
14356;Vaduvos;DRUGELIAI;6776150749;Ne;0;5;0;5
14357;Vaduvos;DRUGELIAI;4587836073;Ne;0;3;0;3
14358;Vaduvos;DRUGELIAI;9333495119;Ne;0;8;0;8
14359;Vaduvos;DRUGELIAI;8400344609;Ne;3;3;0;6
14360;Vaduvos;DRUGELIAI;1987969267;Ne;4;0;0;4
14361;Vaduvos;DRUGELIAI;8990472878;Ne;0;1;0;1
14362;Vaduvos;DRUGELIAI;2717887489;Ne;18;0;0;18
14363;Vaduvos;DRUGELIAI;5881009426;Taip;0;3;0;3
14364;Vaduvos;DRUGELIAI;1434871968;Ne;1;3;0;4
14365;Vaduvos;RIEŠUTĖLIAI;3855900628;Ne;7;7;0;14
14366;Vaduvos;RIEŠUTĖLIAI;8709781176;Ne;6;2;0;8
14367;Vaduvos;RIEŠUTĖLIAI;5457850068;Taip;4;0;0;4
14368;Vaduvos;RIEŠUTĖLIAI;5217573680;Ne;3;1;0;4
14369;Vaduvos;RIEŠUTĖLIAI;3775261278;Ne;1;0;0;1
14370;Vaduvos;RIEŠUTĖLIAI;6228969089;Ne;6;0;0;6
14371;Vaduvos;RIEŠUTĖLIAI;9508198734;Ne;1;0;1;2
14372;Vaduvos;RIEŠUTĖLIAI;1247907161;Ne;1;0;0;1
14373;Vaduvos;RIEŠUTĖLIAI;5012931485;Ne;1;0;0;1
14374;Vaduvos;RIEŠUTĖLIAI;2767613126;Ne;1;0;0;1
14375;Vaduvos;"1 klasė";4805607216;Ne;0;2;0;2
14376;Vaduvos;"1 klasė";4805607216;Ne;0;2;0;2
14377;Vaduvos;"1 klasė";4805607216;Ne;0;2;0;2
14378;Vaduvos;"1 klasė";4805607216;Ne;0;2;0;2
14379;Vaduvos;"1 klasė";1696303051;Ne;0;1;0;1
14380;Vaduvos;"1 klasė";1431863758;Ne;0;1;0;1
14381;Vaduvos;"1 klasė";72724196791;Ne;0;1;0;1
14382;Vaduvos;"1 klasė";9371067563;Ne;0;3;0;3
14383;Vaduvos;"1 klasė";2897226343;Ne;0;1;0;1
14384;Vaduvos;"1 klasė";68848152670;Taip;0;1;0;1
14385;Vaduvos;"1 klasė";6425640531;Ne;0;1;0;1
14386;Vaduvos;"1 klasė";4029586203;Ne;0;1;0;1
14387;Vaduvos;"1 klasė";4105978403;Ne;0;1;0;1
14388;Vaduvos;"1 klasė";9540008495;Ne;0;4;0;4
14389;Vaduvos;"1 klasė";8299189235;Ne;0;2;0;2
14390;Vaduvos;"1 klasė";73800920781;Ne;0;1;0;1
14391;Vaduvos;"1 klasė";5428067167;Taip;0;1;0;1
14392;Vaduvos;"1 klasė";5954492368;Ne;0;2;0;2
14393;Vaduvos;"1 klasė";3699578284;Ne;0;2;0;2
14394;Vaduvos;"1 klasė";7397068779;Ne;0;2;0;2
14395;Vaduvos;"1 klasė";8875709110;Ne;0;1;0;1
14396;Vaduvos;"1 klasė";7305111076;Ne;0;1;0;1
14397;Vaduvos;"1 klasė";7163839896;Ne;0;1;0;1
14398;Vaduvos;"1 klasė";7493037613;Ne;0;1;0;1
14399;Vaduvos;"1 klasė";1423148023;Ne;0;1;0;1
14400;Vaduvos;"1 klasė";5573145836;Ne;0;1;0;1
14401;Vaduvos;"1 klasė";7337663549;Ne;0;1;0;1
14402;Vaduvos;"1 klasė";87008942241;Ne;0;1;0;1
14403;Vaduvos;"2 klasė";3174998523;Taip;0;1;0;1
14404;Vaduvos;"2 klasė";9112649520;Ne;0;3;0;3
14405;Vaduvos;"2 klasė";93702732546;Ne;0;1;0;1
14406;Vaduvos;"2 klasė";15757662594;Ne;0;1;0;1
14407;Vaduvos;"2 klasė";1599595256;Ne;0;1;0;1
14408;Vaduvos;"2 klasė";1825188497;Ne;0;4;0;4
14409;Vaduvos;"2 klasė";4513707989;Ne;0;3;0;3
14410;Vaduvos;"2 klasė";68937983441;Ne;0;1;0;1
14411;Vaduvos;"2 klasė";3722349868;Ne;0;2;0;2
14412;Vaduvos;"2 klasė";13888236429;Ne;0;5;0;5
14413;Vaduvos;"2 klasė";59616893535;Ne;0;2;0;2
14414;Vaduvos;"2 klasė";22641388717;Ne;0;1;0;1
14415;Vaduvos;"2 klasė";21499108813;Ne;0;1;0;1
14416;Vaduvos;"2 klasė";79437154441;Ne;0;1;0;1
14417;Vaduvos;"2 klasė";46608435244;Ne;0;1;0;1
14418;Vaduvos;"2 klasė";5307128703;Ne;0;1;0;1
14419;Vaduvos;"2 klasė";5435336235;Ne;0;1;0;1
14420;Vaduvos;"2 klasė";61046090149;Ne;0;1;0;1
14421;Vaduvos;"2 klasė";56280470781;Ne;0;1;0;1
14422;Vaduvos;"2 klasė";6128582180;Ne;0;3;0;3
14423;Vaduvos;"2 klasė";11202010413;Ne;0;1;0;1
14424;Vaduvos;"2 klasė";1681367373;Ne;0;5;0;5
14425;Vaduvos;"2 klasė";1370696345;Ne;0;2;0;2
14426;Vaduvos;"2 klasė";62183976729;Ne;0;4;0;4
14427;Vaduvos;"2 klasė";4342471835;Ne;0;1;0;1
14428;Vaduvos;"4 klasė";97423576166;Ne;0;3;0;3
14429;Vaduvos;"4 klasė";38504924027;Ne;0;1;0;1
14430;Vaduvos;"4 klasė";96148085691;Taip;0;21;0;21
14431;Vaduvos;"4 klasė";12330772986;Ne;0;4;0;4
14432;Vaduvos;"4 klasė";33277362439;Ne;0;1;0;1
14433;Vaduvos;"4 klasė";41272273463;Taip;0;3;0;3
14434;Vaduvos;"4 klasė";32138087379;Ne;0;7;0;7
14435;Vaduvos;"4 klasė";67324784528;Ne;0;2;0;2
14436;Vaduvos;"4 klasė";4807104855;Ne;0;2;0;2
14437;Vaduvos;"4 klasė";2181614424;Ne;0;1;0;1
14438;Vaduvos;"4 klasė";2019573643;Ne;0;1;0;1
14439;Vaduvos;"4 klasė";27419094487;Ne;0;1;0;1
14440;Vaduvos;"4 klasė";89793734700;Ne;0;2;0;2
14441;Vaduvos;"4 klasė";17473821556;Ne;0;4;0;4
14442;Vaduvos;"4 klasė";53866301875;Ne;0;6;0;6
14443;Vaduvos;"4 klasė";7786986697;Ne;0;1;0;1
14444;Vaduvos;"4 klasė";9147332638;Ne;0;2;0;2
14445;Vaduvos;"4 klasė";1532675814;Ne;0;1;0;1
14446;Vaduvos;"4 klasė";98259624669;Ne;0;1;0;1
14447;Vaduvos;"4 klasė";36931517006;Ne;0;4;0;4
14448;Vaduvos;"4 klasė";61243424057;Ne;0;3;0;3
14449;Vaduvos;"4 klasė";30979103892;Ne;0;2;0;2
14450;Vaduvos;"4 klasė";78245732319;Ne;0;1;0;1
14451;Vaduvos;"4 klasė";48433447683;Ne;0;1;0;1
14452;Vaduvos;"4 klasė";85090873161;Taip;0;21;0;21
14453;Vaduvos;3A;6279678482;Ne;0;21;0;21
14454;Vaduvos;3A;96892752634;Ne;0;1;0;1
14455;Vaduvos;3A;61243200177;Ne;0;1;0;1
14456;Vaduvos;3A;62703428759;Ne;0;1;0;1
14457;Vaduvos;3A;68420568339;Ne;0;5;0;5
14458;Vaduvos;3A;49738318631;Ne;0;1;0;1
14459;Vaduvos;3A;65647119496;Ne;0;1;0;1
14460;Vaduvos;3A;19390879176;Ne;0;2;0;2
14461;Vaduvos;3A;6155494370;Ne;0;1;0;1
14462;Vaduvos;3A;1139509471;Ne;0;21;0;21
14463;Vaduvos;3A;70693742936;Ne;0;1;0;1
14464;Vaduvos;3A;1010061503;Ne;0;9;0;9
14465;Vaduvos;3A;1107557891;Ne;0;21;0;21
14466;Vaduvos;3A;8802765960;Ne;0;2;0;2
14467;Vaduvos;3A;3172047211;Ne;0;1;0;1
14468;Vaduvos;3B;95104294893;Ne;0;3;0;3
14469;Vaduvos;3B;40872193458;Ne;0;21;0;21
14470;Vaduvos;3B;6500567162;Ne;0;7;0;7
14471;Vaduvos;3B;78931952732;Ne;0;3;0;3
14472;Vaduvos;3B;1241148402;Ne;0;3;0;3
14473;Vaduvos;3B;66359913774;Taip;0;2;0;2
14474;Vaduvos;3B;24887196729;Ne;0;1;0;1
14475;Vaduvos;3B;39687066893;Ne;0;2;0;2
14476;Vaduvos;3B;64074141491;Ne;0;2;0;2
14477;Vaduvos;3B;93924290247;Ne;0;5;0;5
14478;Vaduvos;3B;47465933557;Ne;0;1;0;1
14479;Vaduvos;3B;62521006557;Ne;0;1;0;1
14480;Vaduvos;3B;16882774330;Ne;0;2;0;2
14481;Vaduvos;3B;3259114583;Ne;0;1;0;1
14482;Vaduvos;3B;8782782031;Ne;0;1;0;1
14483;Vaduvos;3B;87671358423;Ne;0;21;0;21
14484;Vaduvos;3B;55138588393;Ne;0;1;0;1
14485;Vilkpėdės;PASAKORIŲ;1268568294;Ne;0;13;0;13
14486;Vilkpėdės;PASAKORIŲ;7918728030;Taip;4;0;0;4
14487;Vilkpėdės;PASAKORIŲ;8819707366;Ne;7;0;0;7
14488;Vilkpėdės;PASAKORIŲ;2102814426;Ne;1;2;0;3
14489;Vilkpėdės;PASAKORIŲ;6877083798;Ne;5;0;0;5
14490;Vilkpėdės;PASAKORIŲ;7780157972;Ne;0;4;0;4
14491;Vilkpėdės;PASAKORIŲ;7937515587;Ne;1;0;0;1
14492;Vilkpėdės;PASAKORIŲ;3646631186;Ne;11;0;0;11
14493;Vilkpėdės;MĮSLIUKŲ;7370710652;Ne;0;1;0;1
14494;Vilkpėdės;MĮSLIUKŲ;4314657343;Ne;1;0;0;1
14495;Vilkpėdės;MĮSLIUKŲ;3863312205;Ne;7;0;0;7
14496;Vilkpėdės;MĮSLIUKŲ;8907004805;Ne;1;0;0;1
14497;Vilkpėdės;MĮSLIUKŲ;7334892130;Ne;3;0;0;3
14498;Vilkpėdės;MĮSLIUKŲ;5110059560;Taip;1;0;0;1
14499;Vilkpėdės;ŽINIUKŲ;4270461575;Ne;7;0;1;8
14500;Vilkpėdės;ŽINIUKŲ;4998396593;Ne;5;0;0;5
14501;Vilkpėdės;ŽINIUKŲ;6819447340;Ne;5;2;0;7
14502;Vilkpėdės;ŽINIUKŲ;1278300322;Ne;3;3;0;6
14503;Vilkpėdės;ŽINIUKŲ;9797550851;Ne;0;0;9;9
14504;Vilkpėdės;ŽINIUKŲ;1040357501;Ne;0;0;1;1
14505;Vilkpėdės;ŽINIUKŲ;6876470245;Ne;0;0;1;1
14506;Vilkpėdės;ŽINIUKŲ;1655396296;Ne;0;0;3;3
14507;Vilkpėdės;ŽINIUKŲ;2358685682;Ne;7;0;1;8
14508;Vilkpėdės;ŽINIUKŲ;5076206526;Ne;0;5;0;5
14509;Vilkpėdės;ŽINIUKŲ;3611416887;Ne;0;5;0;5
14510;Vilkpėdės;IŠMINČIŲ;8002436634;Taip;4;0;1;5
14511;Vilkpėdės;IŠMINČIŲ;1249504082;Ne;0;0;1;1
14512;Vilkpėdės;IŠMINČIŲ;7992484314;Ne;0;0;1;1
14513;Vilkpėdės;IŠMINČIŲ;5050493757;Ne;0;6;0;6
14514;Vilkpėdės;IŠMINČIŲ;8217972925;Ne;0;1;0;1
14515;Vilkpėdės;IŠMINČIŲ;5677284428;Ne;0;0;1;1
14516;Vilkpėdės;IŠMINČIŲ;2232913117;Taip;6;0;3;9
14517;Vilkpėdės;IŠMINČIŲ;7805866055;Ne;0;4;0;4
14518;Vilkpėdės;IŠMINČIŲ;3994451071;Ne;0;0;1;1
14519;Vilkpėdės;IŠMINČIŲ;4726171678;Ne;0;0;1;1
14520;Vilkpėdės;IŠMINČIŲ;2529188623;Ne;3;0;1;4
14521;Vilkpėdės;IŠMINČIŲ;7519472444;Ne;5;5;0;10
14522;Vilkpėdės;IŠMINČIŲ;5569182344;Ne;5;10;0;15
14523;Vilkpėdės;IŠMINČIŲ;9334610111;Ne;6;0;2;8
14524;Vilkpėdės;IŠMINČIŲ;6268525635;Ne;13;0;1;14
14525;Vilkpėdės;IŠMINČIŲ;4277073629;Ne;13;0;0;13
14526;Vilkpėdės;IŠMINČIŲ;7489143683;Ne;0;0;4;4
14527;Vilkpėdės;TYRINĖTOJŲ;6418829930;Ne;0;5;0;5
14528;Vilkpėdės;TYRINĖTOJŲ;7829343719;Taip;0;0;7;7
14529;Vilkpėdės;TYRINĖTOJŲ;2503128176;Taip;9;0;0;9
14530;Vilkpėdės;TYRINĖTOJŲ;9570469277;Taip;0;1;3;4
14531;Vilkpėdės;TYRINĖTOJŲ;5274855225;Ne;16;0;0;16
14532;Vilkpėdės;TYRINĖTOJŲ;8860791478;Ne;0;1;0;1
14533;Vilkpėdės;TYRINĖTOJŲ;5420512675;Taip;21;0;2;23
14534;Vilkpėdės;TYRINĖTOJŲ;8613778606;Ne;9;1;0;10
14535;Vilkpėdės;TYRINĖTOJŲ;6064336759;Ne;0;2;0;2
14536;Vilkpėdės;TYRINĖTOJŲ;5577199802;Ne;2;0;0;2
14537;Vilkpėdės;TYRINĖTOJŲ;3303872633;Ne;9;1;0;10
14538;Vilkpėdės;TYRINĖTOJŲ;5972405023;Taip;0;6;0;6
14539;Vilkpėdės;TYRINĖTOJŲ;4485811377;Ne;0;2;0;2
14540;Vilkpėdės;TYRINĖTOJŲ;9841831811;Ne;7;0;1;8
14541;Vilkpėdės;SMALSUOLIŲ;1019057127;Ne;0;0;7;7
14542;Vilkpėdės;SMALSUOLIŲ;6522707709;Ne;1;10;0;11
14543;Vilkpėdės;SMALSUOLIŲ;1655985778;Ne;5;1;0;6
14544;Vilkpėdės;SMALSUOLIŲ;3664125930;Ne;0;1;0;1
14545;Vilkpėdės;SMALSUOLIŲ;8423972962;Ne;2;0;0;2
14546;Vilkpėdės;SMALSUOLIŲ;3350784810;Ne;0;11;0;11
14547;Vilkpėdės;SMALSUOLIŲ;5346798201;Ne;4;0;0;4
14548;Vilkpėdės;SMALSUOLIŲ;5551822633;Ne;3;11;0;14
14549;Vilkpėdės;SMALSUOLIŲ;9544418642;Ne;0;0;7;7
14550;Vilkpėdės;SMALSUOLIŲ;3666145718;Ne;4;3;0;7
14551;Vilkpėdės;SMALSUOLIŲ;5633014328;Ne;2;0;0;2
14552;Vilkpėdės;SMALSUOLIŲ;3737265597;Ne;0;2;0;2
14553;Vilkpėdės;SMALSUOLIŲ;7634076203;Ne;1;0;0;1
14554;Vilkpėdės;KODĖLČIŲ;6283767445;Ne;0;2;0;2
14555;Vilkpėdės;KODĖLČIŲ;9605430333;Ne;0;1;0;1
14556;Vilkpėdės;KODĖLČIŲ;7745776486;Taip;4;0;0;4
14557;Vilkpėdės;KODĖLČIŲ;8969001990;Taip;0;1;0;1
14558;Vilkpėdės;KODĖLČIŲ;7158737372;Ne;0;6;0;6
14559;Vilkpėdės;KODĖLČIŲ;3785308006;Ne;5;0;0;5
14560;Vilkpėdės;KODĖLČIŲ;6744834487;Ne;0;7;0;7
14561;Vilkpėdės;KODĖLČIŲ;4166416292;Ne;0;11;0;11
14562;Vilkpėdės;KODĖLČIŲ;7401886306;Ne;0;1;0;1
14563;Vilkpėdės;KODĖLČIŲ;7284081203;Ne;5;0;0;5
14564;Vilkpėdės;KODĖLČIŲ;1528619779;Ne;0;1;0;1
14565;Vilkpėdės;KODĖLČIŲ;2359315281;Ne;0;1;0;1
14566;Vilkpėdės;KODĖLČIŲ;1571869318;Ne;0;1;0;1
14567;Vilkpėdės;KODĖLČIŲ;6820236577;Ne;0;4;0;4
14568;Vilkpėdės;KODĖLČIŲ;4255757333;Ne;2;0;0;2
14569;Vilkpėdės;KODĖLČIŲ;6778288398;Ne;6;0;0;6
14570;Vilkpėdės;KODĖLČIŲ;1537270256;Ne;9;2;0;11
14571;Vilkpėdės;KODĖLČIŲ;3229559339;Ne;9;2;0;11
14572;Vilkpėdės;MOKSLINČIŲ;9294350205;Ne;0;1;0;1
14573;Vilkpėdės;MOKSLINČIŲ;5048931309;Ne;6;0;1;7
14574;Vilkpėdės;MOKSLINČIŲ;7698759895;Ne;1;5;0;6
14575;Vilkpėdės;MOKSLINČIŲ;2251274741;Ne;9;1;0;10
14576;Vilkpėdės;MOKSLINČIŲ;6816745585;Ne;1;5;0;6
14577;Vilkpėdės;MOKSLINČIŲ;9460356725;Ne;3;0;0;3
14578;Vilkpėdės;MOKSLINČIŲ;8128254701;Ne;5;2;0;7
14579;Vilkpėdės;MOKSLINČIŲ;8015392054;Ne;0;2;0;2
14580;Vilkpėdės;MOKSLINČIŲ;2320350937;Ne;5;1;0;6
14581;Vilkpėdės;MOKSLINČIŲ;7747013579;Ne;2;0;0;2
14582;Vilkpėdės;MOKSLINČIŲ;3987021185;Ne;0;12;0;12
14583;Vilkpėdės;MOKSLINČIŲ;7908813288;Ne;0;3;0;3
14584;Vilkpėdės;MOKSLINČIŲ;9795696242;Ne;1;1;0;2
14585;Vilkpėdės;MOKSLINČIŲ;8581661608;Ne;7;0;0;7
14586;Vilkpėdės;MOKSLINČIŲ;2420271759;Ne;4;6;3;13
14587;Vilkpėdės;MOKSLINČIŲ;3696611509;Ne;0;1;0;1
14588;Vilkpėdės;MOKSLINČIŲ;4735164204;Ne;2;0;0;2
14589;Vilkpėdės;MOKSLINČIŲ;3888880306;Ne;0;3;0;3
14590;Vilkpėdės;MOKSLINČIŲ;8783790519;Ne;1;2;0;3
14591;Žiburėlis;Nykštukai;4109288891;Taip;19;0;0;19
14592;Žiburėlis;Nykštukai;7522040537;Ne;0;3;0;3
14593;Žiburėlis;Nykštukai;1015624216;Ne;0;1;0;1
14594;Žiburėlis;Nykštukai;9526477121;Taip;2;4;0;6
14595;Žiburėlis;Nykštukai;4387021429;Ne;0;7;0;7
14596;Žiburėlis;Nykštukai;4910787530;Ne;0;11;0;11
14597;Žiburėlis;Nykštukai;9783567484;Ne;6;0;0;6
14598;Žiburėlis;Nykštukai;5324852807;Ne;9;0;0;9
14599;Žiburėlis;Nykštukai;4916545915;Ne;0;4;0;4
14600;Žiburėlis;Nykštukai;8133371774;Ne;0;5;0;5
14601;Žiburėlis;Nykštukai;7278242428;Ne;5;0;0;5
14602;Žiburėlis;Nykštukai;5732540560;Ne;0;5;0;5
14603;Žiburėlis;Nykštukai;1833704617;Ne;0;1;0;1
14604;Žiburėlis;Nykštukai;1228806324;Taip;0;2;0;2
14605;Žiburėlis;Nykštukai;2163018032;Ne;6;0;0;6
14606;Žiburėlis;Nykštukai;4581800760;Ne;7;6;0;13
14607;Žiburėlis;Nykštukai;5002691930;Ne;2;1;0;3
14608;Žiburėlis;Nykštukai;5098955523;Ne;0;9;0;9
14609;Žiburėlis;Nykštukai;5629404179;Ne;7;1;0;8
14610;Žiburėlis;Nykštukai;6647598068;Ne;10;0;0;10
14611;Žiburėlis;Nykštukai;1190058462;Ne;0;1;0;1
14612;Žiburėlis;"Žiniukai ";3687703187;Ne;0;5;0;5
14613;Žiburėlis;"Žiniukai ";8215816053;Ne;0;1;0;1
14614;Žiburėlis;"Žiniukai ";7465939429;Taip;0;4;0;4
14615;Žiburėlis;"Žiniukai ";4710995351;Ne;0;1;0;1
14616;Žiburėlis;"Žiniukai ";7211961512;Ne;2;1;0;3
14617;Žiburėlis;"Žiniukai ";1559091567;Ne;0;1;0;1
14618;Žiburėlis;"Žiniukai ";3750024153;Ne;0;2;0;2
14619;Žiburėlis;"Žiniukai ";7633450988;Taip;0;1;0;1
14620;Žiburėlis;"Žiniukai ";8480167191;Ne;6;8;0;14
14621;Žiburėlis;"Žiniukai ";2292895729;Ne;6;1;0;7
14622;Žiburėlis;"Žiniukai ";5408766721;Ne;0;2;0;2
14623;Žiburėlis;"Žiniukai ";1764592065;Ne;0;1;0;1
14624;Žiburėlis;"Žiniukai ";7862546963;Ne;0;1;0;1
14625;Žiburėlis;"Žiniukai ";8902837168;Ne;0;1;0;1
14626;Žiburėlis;"Žiniukai ";6696156248;Ne;1;0;0;1
14627;Žiburėlis;"Žiniukai ";3938379566;Ne;0;1;0;1
14628;Žiburėlis;"Žiniukai ";5174211773;Ne;2;5;0;7
14629;Žiburėlis;"Smalsiukai ";5438697081;Taip;7;1;0;8
14630;Žiburėlis;"Smalsiukai ";1126972447;Ne;1;0;0;1
14631;Žiburėlis;"Smalsiukai ";3936418539;Ne;0;1;0;1
14632;Žiburėlis;"Smalsiukai ";2072972990;Ne;0;3;0;3
14633;Žiburėlis;"Smalsiukai ";3835820013;Taip;1;3;0;4
14634;Žiburėlis;"Smalsiukai ";8875517201;Ne;4;0;0;4
14635;Žiburėlis;"Smalsiukai ";8065557477;Ne;3;1;0;4
14636;Žiburėlis;"Smalsiukai ";1843213137;Ne;1;1;0;2
14637;Žiburėlis;"Smalsiukai ";8953230752;Ne;6;1;0;7
14638;Žiburėlis;"Smalsiukai ";7402647048;Ne;2;1;0;3
14639;Žiburėlis;"Smalsiukai ";9352485231;Ne;0;1;0;1
14640;Žiburėlis;"Smalsiukai ";2491972986;Ne;2;1;0;3
14641;Žiburėlis;"Smalsiukai ";8973307069;Ne;2;1;0;3
14642;Žiburėlis;"Smalsiukai ";7825665451;Ne;3;1;0;4
14643;Žiburėlis;"Smalsiukai ";5556807335;Ne;0;1;0;1
14644;Žiburėlis;"Smalsiukai ";8970153523;Ne;1;0;0;1
14645;Žiburėlis;"Smalsiukai ";5145195661;Ne;0;8;0;8
14646;Žiburėlis;"Smalsiukai ";8018718405;Ne;4;1;0;5
14647;Žiburėlis;"Giliukai ";7310274376;Ne;0;10;0;10
14648;Žiburėlis;"Giliukai ";1090883494;Ne;0;9;0;9
14649;Žiburėlis;"Giliukai ";2866098551;Ne;6;0;0;6
14650;Žiburėlis;"Giliukai ";6918525245;Ne;1;2;0;3
14651;Žiburėlis;"Giliukai ";5148264064;Taip;0;14;0;14
14652;Žiburėlis;"Giliukai ";6733333096;Ne;1;8;0;9
14653;Žiburėlis;"Giliukai ";1943162133;Ne;0;1;0;1
14654;Žiburėlis;"Giliukai ";6232492947;Ne;0;6;0;6
14655;Žiburėlis;"Giliukai ";3807588865;Ne;0;10;0;10
14656;Žiburėlis;"Giliukai ";4016969144;Ne;0;1;0;1
14657;Žiburėlis;"Giliukai ";3776569251;Ne;1;0;0;1
14658;Žiburėlis;"Giliukai ";9494271740;Ne;0;1;0;1
14659;Žiburėlis;"Giliukai ";3992503848;Ne;3;1;0;4
14660;Žiburėlis;"Giliukai ";8440073413;Ne;5;1;0;6
14661;Žiburėlis;"Giliukai ";6121237159;Ne;5;1;0;6
14662;Žiburėlis;"Giliukai ";6289338466;Ne;4;0;0;4
14663;Žiburėlis;"Giliukai ";7977098545;Ne;0;13;0;13
14664;Žiburėlis;"Giliukai ";8697451319;Ne;0;10;0;10
14665;Žiburėlis;Meškiukai;3593851196;Ne;0;0;1;1
14666;Žiburėlis;Meškiukai;9470154520;Ne;0;0;3;3
14667;Žiburėlis;Meškiukai;2285666668;Ne;5;0;1;6
14668;Žiburėlis;Meškiukai;2836519241;Ne;0;0;8;8
14669;Žiburėlis;Meškiukai;2186032732;Ne;0;1;0;1
14670;Žiburėlis;Meškiukai;9321467329;Ne;7;0;0;7
14671;Žiburėlis;Meškiukai;2254407798;Ne;5;1;0;6
14672;Žiburėlis;Meškiukai;4887304311;Ne;0;0;1;1
14673;Žiburėlis;Meškiukai;1651713696;Ne;0;0;2;2
14674;Žiburėlis;Meškiukai;1105220246;Taip;3;2;0;5
14675;Žiburėlis;Meškiukai;8415647388;Ne;0;1;0;1
14676;Žiburėlis;Meškiukai;2371990135;Ne;0;0;2;2
14677;Žiburėlis;Meškiukai;6218255066;Ne;0;0;9;9
14678;Žiburėlis;Meškiukai;3522480911;Taip;0;2;5;7
14679;Žiburėlis;Meškiukai;4667559315;Ne;0;1;0;1
14680;Žiburėlis;Meškiukai;1606332622;Taip;9;2;0;11
14681;Žiburėlis;Meškiukai;1758251348;Ne;20;1;0;21
14682;Žiburėlis;Meškiukai;8284913889;Ne;7;0;4;11
14683;Žiburėlis;Meškiukai;1121755119;Ne;0;0;4;4
14684;Žiburėlis;Meškiukai;2851350451;Taip;6;2;0;8
14685;Žiburėlis;Meškiukai;6206770019;Ne;0;7;0;7
14686;Žiburėlis;Viščiukai;1507346142;Ne;4;0;0;4
14687;Žiburėlis;Viščiukai;9009869114;Ne;1;0;0;1
14688;Žiburėlis;Viščiukai;1839099729;Ne;9;0;0;9
14689;Žiburėlis;Viščiukai;1758228365;Ne;2;0;0;2
14690;Žiburėlis;Viščiukai;2382486049;Ne;5;0;0;5
14691;Žiburėlis;"Drambliukai ";5115160061;Taip;21;5;0;26
14692;Žiburėlis;"Drambliukai ";7364102991;Taip;17;2;0;19
14693;Žiburėlis;"Drambliukai ";8179414341;Ne;6;2;0;8
14694;Žiburėlis;"Drambliukai ";3323538690;Ne;4;1;0;5
14695;Žiburėlis;"Drambliukai ";3738184802;Taip;2;1;0;3
14696;Žiburėlis;"Drambliukai ";8603154782;Ne;2;0;0;2
14697;Žiburėlis;"Drambliukai ";5213049603;Ne;11;3;0;14
14698;Žiburėlis;"Drambliukai ";6750601280;Taip;5;0;0;5
14699;Žiburėlis;"Drambliukai ";6126086504;Ne;0;1;0;1
14700;Žiburėlis;"Drambliukai ";7687475882;Ne;9;1;0;10
14701;Žiburėlis;"Drambliukai ";5254196326;Ne;4;0;0;4
14702;Žiburėlis;"Drambliukai ";8444514098;Ne;14;0;0;14
14703;Žiburėlis;"Drambliukai ";4459356832;Ne;0;4;0;4
14704;Žiburėlis;"Drambliukai ";3787858744;Ne;16;0;0;16
14705;Žiburėlis;"Drambliukai ";1449541244;Taip;8;10;0;18
14706;Žiburėlis;"Drambliukai ";2472729022;Ne;0;3;0;3
14707;Žiburėlis;BORUŽIUKAI;3723613593;Ne;2;0;0;2
14708;Žiburėlis;BORUŽIUKAI;9964255985;Ne;0;7;0;7
14709;Žiburėlis;BORUŽIUKAI;7895148630;Taip;6;15;0;21
14710;Žiburėlis;BORUŽIUKAI;8936912406;Ne;0;1;0;1
14711;Žiburėlis;BORUŽIUKAI;4631232618;Ne;4;3;0;7
14712;Žiburėlis;BORUŽIUKAI;5793531526;Ne;10;2;0;12
14713;Žiburėlis;BORUŽIUKAI;6128571259;Taip;0;4;0;4
14714;Žiburėlis;BORUŽIUKAI;3760039280;Ne;0;4;0;4
14715;Žiburėlis;BORUŽIUKAI;5799439634;Ne;1;0;0;1
14716;Žiburėlis;BORUŽIUKAI;4229040996;Ne;8;0;0;8
14717;Žiburėlis;BORUŽIUKAI;8373944614;Ne;16;1;0;17
14718;Žiburėlis;BORUŽIUKAI;9256751455;Ne;5;3;0;8
14719;Žiburėlis;BORUŽIUKAI;2077823704;Ne;5;3;0;8
14720;Žiburėlis;BORUŽIUKAI;9357376188;Ne;2;2;0;4
14721;Žiburėlis;BORUŽIUKAI;4233222771;Ne;2;0;0;2
14722;Žiburėlis;BORUŽIUKAI;9029039015;Ne;1;1;0;2
14723;Žiburėlis;BORUŽIUKAI;7017574924;Ne;6;3;0;9
14724;Žiburėlis;BORUŽIUKAI;1661456806;Ne;0;1;0;1
14725;Žiburėlis;BORUŽIUKAI;2527837980;Ne;10;0;0;10
14726;Žiburėlis;BORUŽIUKAI;9771442035;Taip;3;0;0;3
14727;Žiburėlis;SPINDULIUKAI;2995697464;Ne;8;1;1;10
14728;Žiburėlis;SPINDULIUKAI;7856708616;Ne;4;5;0;9
14729;Žiburėlis;SPINDULIUKAI;5205959106;Ne;3;1;0;4
14730;Žiburėlis;SPINDULIUKAI;1775465307;Ne;2;1;0;3
14731;Žiburėlis;SPINDULIUKAI;4720567144;Ne;5;0;0;5
14732;Žiburėlis;SPINDULIUKAI;2808361570;Taip;1;3;0;4
14733;Žiburėlis;SPINDULIUKAI;3253759256;Taip;6;5;0;11
14734;Žiburėlis;SPINDULIUKAI;6969335298;Ne;8;1;2;11
14735;Žiburėlis;SPINDULIUKAI;5835919483;Ne;1;2;0;3
14736;Žiburėlis;SPINDULIUKAI;4738991020;Ne;4;0;2;6
14737;Žiburėlis;SPINDULIUKAI;6080914975;Ne;6;0;0;6
14738;Žiburėlis;SPINDULIUKAI;9325991773;Ne;3;0;0;3
14739;Žiburėlis;SPINDULIUKAI;6674351628;Taip;8;0;0;8
14740;Žiburėlis;SPINDULIUKAI;5075522632;Ne;1;1;0;2
14741;Žiburėlis;SPINDULIUKAI;1908345602;Ne;2;1;0;3
14742;Žiburėlis;SPINDULIUKAI;8140848665;Ne;1;0;7;8
14743;Žiburėlis;SPINDULIUKAI;7140031765;Taip;0;0;2;2
14744;Žiburėlis;KIŠKUČIAI;6492467281;Ne;0;1;5;6
14745;Žiburėlis;KIŠKUČIAI;3352845095;Ne;0;1;0;1
14746;Žiburėlis;KIŠKUČIAI;3296994981;Ne;6;2;0;8
14747;Žiburėlis;KIŠKUČIAI;6019278045;Ne;3;1;6;10
14748;Žiburėlis;KIŠKUČIAI;5418413225;Ne;0;3;0;3
14749;Žiburėlis;KIŠKUČIAI;6044837042;Taip;0;0;6;6
14750;Žiburėlis;KIŠKUČIAI;1334695206;Ne;6;1;9;16
14751;Žiburėlis;KIŠKUČIAI;7597762608;Ne;3;2;0;5
14752;Žiburėlis;KIŠKUČIAI;6562748977;Ne;11;0;0;11
14753;Žiburėlis;KIŠKUČIAI;4477396434;Ne;5;1;0;6
14754;Žiburėlis;KIŠKUČIAI;2712358146;Ne;0;1;11;12
14755;Žiburėlis;KIŠKUČIAI;5410394172;Ne;0;1;0;1
14756;Žiburėlis;KIŠKUČIAI;4003368130;Ne;13;0;0;13
14757;Žiburėlis;KIŠKUČIAI;2456703958;Ne;5;0;0;5
14758;Žiburėlis;KIŠKUČIAI;1868558773;Taip;0;10;0;10
14759;Žiburėlis;KIŠKUČIAI;2083500905;Taip;1;3;2;6
14760;Žiburėlis;KIŠKUČIAI;6577061306;Ne;0;1;0;1
14761;Žiburėlis;KIŠKUČIAI;9731661697;Taip;0;1;4;5
14762;Žiburėlis;DRUGELIAI;9551175579;Ne;5;1;0;6
14763;Žiburėlis;DRUGELIAI;2872122574;Ne;21;0;0;21
14764;Žiburėlis;DRUGELIAI;5422660783;Ne;21;0;0;21
14765;Žiburėlis;DRUGELIAI;3780842203;Taip;10;0;0;10
14766;Žiburėlis;DRUGELIAI;6751043071;Ne;9;1;0;10
14767;Žiburėlis;DRUGELIAI;2805244671;Ne;3;0;1;4
14768;Žiburėlis;DRUGELIAI;8082088504;Taip;0;3;0;3
14769;Žiburėlis;DRUGELIAI;5025452484;Taip;5;1;0;6
14770;Žiburėlis;DRUGELIAI;5724506894;Ne;7;0;0;7
14771;Žiburėlis;DRUGELIAI;8207315673;Taip;6;0;0;6
14772;Žiburėlis;DRUGELIAI;4656467260;Ne;0;1;0;1
14773;Žiburėlis;DRUGELIAI;9344950711;Taip;3;2;0;5
14774;Žiburėlis;DRUGELIAI;6274583813;Ne;0;2;0;2
14775;Žiburėlis;DRUGELIAI;5194593598;Taip;13;0;0;13
14776;Žiburėlis;DRUGELIAI;2383554216;Ne;8;0;0;8
14777;Žiburėlis;DRUGELIAI;9041469393;Taip;6;1;0;7
14778;Žiburėlis;DRUGELIAI;8285987095;Ne;0;7;0;7
14779;Žiburėlis;DRUGELIAI;8752098051;Ne;0;7;0;7
14780;Žiburėlis;DRUGELIAI;1511882237;Ne;0;1;0;1
14781;Bangelė;Aštuonkojai;6216334243;Ne;0;6;0;6
14782;Bangelė;Aštuonkojai;8406002339;Ne;0;0;2;2
14783;Bangelė;Aštuonkojai;8385661612;Ne;0;0;2;2
14784;Bangelė;Aštuonkojai;7434358474;Ne;0;14;7;21
14785;Bangelė;Aštuonkojai;3471355267;Ne;0;1;0;1
14786;Bangelė;Aštuonkojai;6978215876;Ne;3;0;6;9
14787;Bangelė;Aštuonkojai;9801978617;Ne;0;2;0;2
14788;Bangelė;Aštuonkojai;9608900293;Ne;0;0;4;4
14789;Bangelė;Aštuonkojai;7434879947;Ne;0;0;2;2
14790;Bangelė;Aštuonkojai;7107685761;Ne;0;0;1;1
14791;Bangelė;Aštuonkojai;5994720767;Ne;0;7;0;7
14792;Bangelė;Aštuonkojai;4532810332;Ne;0;11;0;11
14793;Bangelė;Aštuonkojai;8575020060;Ne;0;0;1;1
14794;Bangelė;Aštuonkojai;4036461205;Ne;0;0;1;1
14795;Bangelė;Aštuonkojai;3344441441;Ne;2;9;4;15
14796;Bangelė;Aštuonkojai;2858929915;Ne;1;0;1;2
14797;Bangelė;Aštuonkojai;7068305612;Ne;10;0;3;13
14798;Bangelė;Aštuonkojai;8943721679;Ne;5;3;0;8
14799;Bangelė;Delfinukai,;9142460659;Ne;21;0;0;21
14800;Bangelė;Delfinukai,;6566277472;Ne;6;0;0;6
14801;Bangelė;Delfinukai,;1541525635;Ne;0;1;0;1
14802;Bangelė;Delfinukai,;7362196984;Ne;6;6;0;12
14803;Bangelė;Delfinukai,;4317054990;Ne;0;4;0;4
14804;Bangelė;Delfinukai,;4651237403;Ne;15;0;0;15
14805;Bangelė;Delfinukai,;4712616315;Ne;1;1;0;2
14806;Bangelė;Delfinukai,;8335931279;Ne;0;2;0;2
14807;Bangelė;Delfinukai,;9311379746;Ne;9;0;0;9
14808;Bangelė;Delfinukai,;9955097720;Ne;0;1;0;1
14809;Bangelė;Delfinukai,;4851593235;Ne;9;0;0;9
14810;Bangelė;Delfinukai,;8998648968;Ne;0;3;0;3
14811;Bangelė;Delfinukai,;7016039389;Ne;0;1;2;3
14812;Bangelė;Delfinukai,;2127734178;Ne;0;0;3;3
14813;Bangelė;Delfinukai,;2107766301;Ne;5;10;0;15
14814;Bangelė;Delfinukai,;5237434283;Ne;6;0;0;6
14815;Bangelė;"Saulės spindulėliai";9488932192;Ne;10;1;0;11
14816;Bangelė;"Saulės spindulėliai";8238868856;Ne;0;4;0;4
14817;Bangelė;"Saulės spindulėliai";4843411757;Ne;0;3;0;3
14818;Bangelė;"Saulės spindulėliai";1754002501;Ne;3;3;0;6
14819;Bangelė;"Saulės spindulėliai";3063439996;Ne;0;2;0;2
14820;Bangelė;"Saulės spindulėliai";6026399355;Ne;4;0;1;5
14821;Bangelė;"Saulės spindulėliai";2156837975;Ne;0;4;0;4
14822;Bangelė;"Saulės spindulėliai";9143945953;Ne;0;4;0;4
14823;Bangelė;"Saulės spindulėliai";3022508446;Ne;0;0;1;1
14824;Bangelė;"Saulės spindulėliai";5476753511;Ne;0;0;1;1
14825;Bangelė;"Saulės spindulėliai";5546256869;Ne;0;0;1;1
14826;Bangelė;"Saulės spindulėliai";6980232224;Ne;0;1;0;1
14827;Bangelė;"Saulės spindulėliai";1390623903;Ne;0;3;0;3
14828;Bangelė;"Saulės spindulėliai";9788923823;Ne;11;8;2;21
14829;Bangelė;"Saulės spindulėliai";7136625230;Ne;0;6;0;6
14830;Bangelė;"Saulės spindulėliai";9168310196;Ne;0;7;0;7
14831;Bangelė;"Saulės spindulėliai";9790680407;Taip;3;0;2;5
14832;Bangelė;"Pingvinukai ";2405364948;Ne;9;0;2;11
14833;Bangelė;"Pingvinukai ";8959248662;Ne;1;0;0;1
14834;Bangelė;"Pingvinukai ";5054826517;Ne;2;0;3;5
14835;Bangelė;"Pingvinukai ";8943497040;Ne;0;2;0;2
14836;Bangelė;"Pingvinukai ";8297403610;Ne;4;0;0;4
14837;Bangelė;"Pingvinukai ";3351519357;Ne;1;0;0;1
14838;Bangelė;"Pingvinukai ";9740713810;Ne;7;0;0;7
14839;Bangelė;"Pingvinukai ";5829865386;Ne;3;0;10;13
14840;Bangelė;"Pingvinukai ";1591647267;Ne;2;0;1;3
14841;Bangelė;"Pingvinukai ";8981519368;Ne;0;0;1;1
14842;Bangelė;"Pingvinukai ";2362345363;Ne;6;0;0;6
14843;Bangelė;"Jūros žvaigždutės ";9447145378;Ne;0;0;2;2
14844;Bangelė;"Jūros žvaigždutės ";8745595583;Ne;16;0;1;17
14845;Bangelė;"Jūros žvaigždutės ";6174617493;Ne;5;7;0;12
14846;Bangelė;"Jūros žvaigždutės ";8075810032;Ne;0;0;1;1
14847;Bangelė;"Jūros žvaigždutės ";2624013880;Ne;0;0;7;7
14848;Bangelė;"Jūros žvaigždutės ";6397805392;Ne;0;5;0;5
14849;Bangelė;"Jūros žvaigždutės ";5961647252;Ne;9;0;1;10
14850;Bangelė;"Jūros žvaigždutės ";3851738513;Ne;0;0;1;1
14851;Bangelė;"Jūros žvaigždutės ";4891131242;Ne;5;0;0;5
14852;Bangelė;"Jūros žvaigždutės ";8931569423;Ne;0;1;0;1
14853;Bangelė;"Jūros žvaigždutės ";7364368699;Ne;0;8;1;9
14854;Bangelė;"Jūros žvaigždutės ";7755966282;Ne;0;0;4;4
14855;Bangelė;"Jūros žvaigždutės ";6400785821;Ne;5;0;0;5
14856;Bangelė;"Jūros žvaigždutės ";8765892966;Ne;0;3;0;3
14857;Bangelė;"Jūros žvaigždutės ";5370269001;Ne;0;5;0;5
14858;Bangelė;Žuvytės;7174742281;Ne;12;5;0;17
14859;Bangelė;Žuvytės;6806911810;Ne;0;0;5;5
14860;Bangelė;Žuvytės;6548270099;Ne;10;2;0;12
14861;Bangelė;Žuvytės;4086446380;Ne;0;2;0;2
14862;Bangelė;Žuvytės;9268294844;Ne;0;0;2;2
14863;Bangelė;Žuvytės;3069288815;Ne;6;0;2;8
14864;Bangelė;Žuvytės;9729929020;Ne;10;0;0;10
14865;Bangelė;Žuvytės;8563674709;Ne;0;0;1;1
14866;Bangelė;Žuvytės;5673493708;Ne;0;3;0;3
14867;Bangelė;Žuvytės;3500097405;Taip;16;0;1;17
14868;Bangelė;Žuvytės;1544311819;Ne;0;0;1;1
14869;Bangelė;Žuvytės;4080993439;Ne;0;2;0;2
14870;Bangelė;Žuvytės;3016778137;Taip;0;6;0;6
14871;Bangelė;Ruoniai;8758933649;Ne;2;0;2;4
14872;Bangelė;Ruoniai;6480681705;Ne;0;2;0;2
14873;Bangelė;Ruoniai;7142694888;Ne;5;6;0;11
14874;Bangelė;Ruoniai;8734511431;Ne;0;3;0;3
14875;Bangelė;Ruoniai;1895213200;Ne;0;3;0;3
14876;Bangelė;Ruoniai;9765268154;Ne;0;6;0;6
14877;Bangelė;Ruoniai;8495423628;Ne;4;1;0;5
14878;Bangelė;Ruoniai;7419016784;Ne;0;0;3;3
14879;Bangelė;Ruoniai;5190563034;Ne;11;0;0;11
14880;Bangelė;Ruoniai;9954762483;Ne;0;15;1;16
14881;Bangelė;Ruoniai;9493465898;Ne;0;1;0;1
14882;Bangelė;Ruoniai;5597329949;Ne;0;1;0;1
14883;Bangelė;Ruoniai;4494049529;Ne;5;0;0;5
14884;Bangelė;Ruoniai;3334029244;Ne;8;0;1;9
14885;Bangelė;Ruoniai;6496580354;Ne;7;0;9;16
14886;Bangelė;Ruoniai;6165322599;Ne;0;4;0;4
14887;Bangelė;"Pagrandukai ";9355348960;Ne;7;0;0;7
14888;Bangelė;"Pagrandukai ";7503518328;Ne;0;4;0;4
14889;Bangelė;"Pagrandukai ";4927362383;Ne;5;0;0;5
14890;Bangelė;"Pagrandukai ";7432980844;Ne;0;1;0;1
14891;Bangelė;"Pagrandukai ";7729373603;Ne;0;6;0;6
14892;Bangelė;"Pagrandukai ";9430653481;Ne;4;0;0;4
14893;Bangelė;"Pagrandukai ";4558724094;Ne;5;0;0;5
14894;Bangelė;"Pagrandukai ";3557202302;Ne;5;0;0;5
14895;Bangelė;"Zuikučiai ";3269021780;Ne;6;0;0;6
14896;Bangelė;"Zuikučiai ";4611715232;Ne;0;0;5;5
14897;Bangelė;"Zuikučiai ";6925192867;Ne;0;0;1;1
14898;Bangelė;"Zuikučiai ";6965660021;Ne;10;3;0;13
14899;Bangelė;"Zuikučiai ";3994276744;Ne;12;0;0;12
14900;Bangelė;"Zuikučiai ";3059847953;Ne;0;2;0;2
14901;Bangelė;"Zuikučiai ";5909385625;Ne;4;0;4;8
14902;Bangelė;"Zuikučiai ";4401415720;Ne;2;0;0;2
14903;Bangelė;"Zuikučiai ";9841829359;Ne;1;0;0;1
14904;Bangelė;"Zuikučiai ";6100558953;Ne;0;0;4;4
14905;Bangelė;"Zuikučiai ";5192643204;Ne;0;0;4;4
14906;Bangelė;Vėžliukai;7862345122;Ne;3;0;0;3
14907;Bangelė;Vėžliukai;1869389013;Ne;0;3;0;3
14908;Bangelė;Vėžliukai;2630571748;Ne;6;4;0;10
14909;Bangelė;Vėžliukai;3978683237;Ne;5;0;0;5
14910;Bangelė;Vėžliukai;5779198855;Ne;0;1;0;1
14911;Bangelė;Vėžliukai;5746189515;Ne;5;2;0;7
14912;Bangelė;Vėžliukai;8454369872;Taip;0;1;0;1
14913;Bangelė;Vėžliukai;9561221619;Ne;0;3;0;3
14914;Bangelė;Vėžliukai;1182624046;Ne;3;10;0;13
14915;Bangelė;Vėžliukai;5625257865;Ne;14;0;0;14
14916;Bangelė;Vėžliukai;9010238689;Taip;4;2;0;6
14917;Bangelė;Vėžliukai;9128326823;Ne;0;2;0;2
14918;Bangelė;Vėžliukai;6415607960;Taip;14;1;0;15
14919;Bangelė;Vėžliukai;2730545639;Ne;4;1;0;5
14920;Bangelė;Vėžliukai;2301343701;Ne;0;7;0;7
14921;Bangelė;Vėžliukai;6506241123;Taip;3;0;0;3
14922;Gėlynas;PAKALNUTĖ;4557380282;Ne;0;21;0;21
14923;Gėlynas;PAKALNUTĖ;3470963396;Ne;0;13;0;13
14924;Gėlynas;PAKALNUTĖ;2171064300;Ne;9;2;0;11
14925;Gėlynas;PAKALNUTĖ;2404562144;Ne;0;3;0;3
14926;Gėlynas;PAKALNUTĖ;7504469409;Ne;0;4;0;4
14927;Gėlynas;PAKALNUTĖ;4366442459;Ne;2;0;0;2
14928;Gėlynas;PAKALNUTĖ;1463783538;Taip;3;5;0;8
14929;Gėlynas;PAKALNUTĖ;7064068912;Ne;11;0;0;11
14930;Gėlynas;PAKALNUTĖ;1822933936;Ne;7;3;0;10
14931;Gėlynas;PAKALNUTĖ;4668195919;Ne;0;5;0;5
14932;Gėlynas;PAKALNUTĖ;8555408466;Ne;0;9;0;9
14933;Gėlynas;PAKALNUTĖ;2377323648;Taip;1;0;0;1
14934;Gėlynas;PAKALNUTĖ;5382148888;Ne;8;0;0;8
14935;Gėlynas;PAKALNUTĖ;6296728638;Ne;0;2;0;2
14936;Gėlynas;PAKALNUTĖ;5826067446;Ne;1;7;0;8
14937;Gėlynas;PAKALNUTĖ;2273705177;Taip;8;0;0;8
14938;Gėlynas;PAKALNUTĖ;5350834071;Ne;0;10;0;10
14939;Gėlynas;PAKALNUTĖ;6244314445;Ne;3;0;0;3
14940;Gėlynas;PAKALNUTĖ;9707677931;Ne;9;2;0;11
14941;Gėlynas;VARPELIS;9330385153;Ne;0;2;0;2
14942;Gėlynas;VARPELIS;9724668402;Ne;2;0;0;2
14943;Gėlynas;VARPELIS;2742456983;Ne;0;2;0;2
14944;Gėlynas;VARPELIS;6815740588;Ne;2;0;0;2
14945;Gėlynas;VARPELIS;3606076029;Ne;0;7;0;7
14946;Gėlynas;VARPELIS;5291444399;Ne;3;0;0;3
14947;Gėlynas;VARPELIS;5320531856;Ne;14;0;0;14
14948;Gėlynas;VARPELIS;7730322729;Ne;0;4;0;4
14949;Gėlynas;VARPELIS;4505012978;Ne;7;0;0;7
14950;Gėlynas;VARPELIS;9508507084;Ne;1;0;0;1
14951;Gėlynas;VARPELIS;6528464599;Ne;1;0;0;1
14952;Gėlynas;VARPELIS;8615943743;Taip;0;10;0;10
14953;Gėlynas;VARPELIS;8458276300;Ne;1;0;0;1
14954;Gėlynas;VARPELIS;8999346908;Ne;0;1;0;1
14955;Gėlynas;VARPELIS;3491517766;Ne;2;0;0;2
14956;Gėlynas;RAKTAŽOLĖ;7389502638;Ne;0;9;0;9
14957;Gėlynas;RAKTAŽOLĖ;1590299264;Ne;6;0;0;6
14958;Gėlynas;RAKTAŽOLĖ;5751256561;Ne;12;0;0;12
14959;Gėlynas;RAKTAŽOLĖ;6875794958;Ne;7;0;0;7
14960;Gėlynas;RAKTAŽOLĖ;3492361041;Ne;3;0;0;3
14961;Gėlynas;RAKTAŽOLĖ;6451922757;Ne;2;0;0;2
14962;Gėlynas;RAKTAŽOLĖ;7150367866;Ne;11;0;0;11
14963;Gėlynas;RAKTAŽOLĖ;4983822000;Ne;1;0;0;1
14964;Gėlynas;RAKTAŽOLĖ;9462822190;Ne;2;0;0;2
14965;Gėlynas;RAKTAŽOLĖ;3549079170;Ne;0;9;0;9
14966;Gėlynas;RAKTAŽOLĖ;5964419627;Taip;2;0;0;2
14967;Gėlynas;RAKTAŽOLĖ;7998013477;Ne;1;0;0;1
14968;Gėlynas;RAKTAŽOLĖ;8447789767;Ne;4;0;0;4
14969;Gėlynas;RAKTAŽOLĖ;1468588114;Ne;1;0;0;1
14970;Gėlynas;RAKTAŽOLĖ;9305282699;Ne;1;0;0;1
14971;Gėlynas;RAKTAŽOLĖ;1235384604;Ne;3;0;0;3
14972;Gėlynas;RAKTAŽOLĖ;8693415786;Ne;5;0;0;5
14973;Gėlynas;SAULĖGRĄŽA;3746597878;Ne;0;3;1;4
14974;Gėlynas;SAULĖGRĄŽA;9182072776;Ne;0;0;6;6
14975;Gėlynas;SAULĖGRĄŽA;1862266440;Ne;4;0;6;10
14976;Gėlynas;SAULĖGRĄŽA;4292724541;Ne;0;3;0;3
14977;Gėlynas;SAULĖGRĄŽA;2790269385;Ne;5;0;1;6
14978;Gėlynas;SAULĖGRĄŽA;4192292896;Ne;0;0;2;2
14979;Gėlynas;SAULĖGRĄŽA;9552677108;Ne;0;6;0;6
14980;Gėlynas;SAULĖGRĄŽA;2608369575;Ne;0;6;0;6
14981;Gėlynas;SAULĖGRĄŽA;6635004996;Ne;0;0;1;1
14982;Gėlynas;SAULĖGRĄŽA;5942466822;Ne;5;0;0;5
14983;Gėlynas;SAULĖGRĄŽA;2193861056;Taip;0;0;7;7
14984;Gėlynas;SAULĖGRĄŽA;6826311903;Ne;0;0;2;2
14985;Gėlynas;SAULĖGRĄŽA;6221721945;Ne;0;0;10;10
14986;Gėlynas;SAULĖGRĄŽA;7005278902;Ne;0;0;2;2
14987;Gėlynas;SAULĖGRĄŽA;6790040590;Taip;0;0;2;2
14988;Gėlynas;SAULĖGRĄŽA;4854709904;Ne;3;0;4;7
14989;Gėlynas;SAULĖGRĄŽA;1570975863;Ne;0;0;3;3
14990;Gėlynas;SAULĖGRĄŽA;9302757372;Ne;10;10;0;20
14991;Gėlynas;RAMUNĖLĖ;5813156578;Ne;0;2;0;2
14992;Gėlynas;RAMUNĖLĖ;8550986498;Ne;10;0;0;10
14993;Gėlynas;RAMUNĖLĖ;1003739544;Taip;15;0;0;15
14994;Gėlynas;RAMUNĖLĖ;5576414317;Ne;5;0;0;5
14995;Gėlynas;RAMUNĖLĖ;1625163282;Ne;2;0;0;2
14996;Gėlynas;RAMUNĖLĖ;1962457749;Ne;3;0;0;3
14997;Gėlynas;RAMUNĖLĖ;9063119595;Ne;8;0;0;8
14998;Gėlynas;RAMUNĖLĖ;1923691283;Taip;12;0;0;12
14999;Gėlynas;RAMUNĖLĖ;1360487284;Ne;3;0;0;3
15000;Gėlynas;RAMUNĖLĖ;2043763411;Ne;0;1;0;1
15001;Gėlynas;RAMUNĖLĖ;4666515153;Ne;1;0;0;1
15002;Gėlynas;RAMUNĖLĖ;1074695140;Taip;1;0;0;1
15003;Gėlynas;RAMUNĖLĖ;4574399336;Ne;1;0;0;1
15004;Gėlynas;RAMUNĖLĖ;6447818933;Ne;3;0;0;3
15005;Gėlynas;ŽIBUTĖ;1556683639;Ne;0;3;0;3
15006;Gėlynas;ŽIBUTĖ;2885148633;Ne;9;0;0;9
15007;Gėlynas;ŽIBUTĖ;6053762333;Ne;5;0;0;5
15008;Gėlynas;ŽIBUTĖ;1579053252;Ne;12;0;0;12
15009;Gėlynas;ŽIBUTĖ;9980617252;Ne;2;0;0;2
15010;Gėlynas;ŽIBUTĖ;9256960820;Ne;11;0;0;11
15011;Gėlynas;ŽIBUTĖ;9513419357;Ne;0;1;0;1
15012;Gėlynas;ŽIBUTĖ;3629326461;Ne;0;4;0;4
15013;Obelėlė;Gudručiai;9900484892;Ne;3;0;0;3
15014;Obelėlė;Gudručiai;9586720282;Ne;4;0;0;4
15015;Obelėlė;Gudručiai;5141585309;Ne;6;0;0;6
15016;Obelėlė;Gudručiai;9736557012;Ne;10;0;2;12
15017;Obelėlė;Gudručiai;6720058972;Ne;3;4;1;8
15018;Obelėlė;Gudručiai;2204293216;Ne;0;7;3;10
15019;Obelėlė;Gudručiai;1184082097;Ne;0;0;1;1
15020;Obelėlė;Gudručiai;2533715287;Ne;0;5;2;7
15021;Obelėlė;Gudručiai;1312484983;Ne;11;0;0;11
15022;Obelėlė;Gudručiai;1598785483;Ne;8;2;0;10
15023;Obelėlė;Gudručiai;2170134084;Ne;0;6;0;6
15024;Obelėlė;Gudručiai;8155712451;Ne;0;0;1;1
15025;Obelėlė;Gudručiai;1362135757;Ne;2;0;0;2
15026;Obelėlė;Gudručiai;3769993089;Ne;0;0;1;1
15027;Obelėlė;Gudručiai;1630067014;Ne;1;0;0;1
15028;Obelėlė;Pasakaitė;9008900055;Ne;1;0;0;1
15029;Obelėlė;Pasakaitė;9332534001;Ne;1;0;0;1
15030;Obelėlė;Pasakaitė;1788880520;Ne;6;0;4;10
15031;Obelėlė;Pasakaitė;2465101384;Ne;7;0;2;9
15032;Obelėlė;Pasakaitė;5366112771;Ne;0;2;0;2
15033;Obelėlė;Pasakaitė;5603904852;Ne;0;8;1;9
15034;Obelėlė;Pasakaitė;9995891955;Ne;0;0;1;1
15035;Obelėlė;Pasakaitė;3646359565;Ne;20;0;0;20
15036;Obelėlė;Pasakaitė;2663004768;Ne;3;0;2;5
15037;Obelėlė;Pasakaitė;4707488292;Ne;21;0;0;21
15038;Obelėlė;Pasakaitė;2031637374;Taip;0;0;4;4
15039;Obelėlė;Pasakaitė;4678269928;Taip;3;0;0;3
15040;Obelėlė;Pasakaitė;8060994250;Taip;7;0;3;10
15041;Obelėlė;Pasakaitė;5617103957;Ne;0;0;2;2
15042;Obelėlė;Pasakaitė;6321178561;Ne;4;0;1;5
15043;Obelėlė;Pasakaitė;9903010418;Ne;0;0;1;1
15044;Obelėlė;Pasakaitė;4673426170;Ne;3;0;1;4
15045;Obelėlė;Pasakaitė;7901070568;Ne;0;0;1;1
15046;Obelėlė;Svajokliai;9981446556;Taip;5;0;0;5
15047;Obelėlė;Svajokliai;4849499826;Ne;0;0;2;2
15048;Obelėlė;Svajokliai;1469593267;Ne;3;0;0;3
15049;Obelėlė;Svajokliai;9819048265;Taip;0;9;0;9
15050;Obelėlė;Svajokliai;1010954005;Ne;0;0;5;5
15051;Obelėlė;Svajokliai;4489212434;Ne;0;0;2;2
15052;Obelėlė;Svajokliai;6325027163;Ne;0;0;1;1
15053;Obelėlė;Svajokliai;5312394513;Ne;0;0;5;5
15054;Obelėlė;Svajokliai;1705232474;Ne;0;0;1;1
15055;Obelėlė;Svajokliai;5588467580;Ne;9;0;4;13
15056;Obelėlė;Svajokliai;7094715237;Ne;0;0;3;3
15057;Obelėlė;Svajokliai;8231489868;Ne;11;0;1;12
15058;Obelėlė;Svajokliai;7003947655;Ne;0;0;1;1
15059;Obelėlė;Svajokliai;9641297002;Ne;0;0;1;1
15060;Obelėlė;Svajokliai;8918176312;Ne;0;0;4;4
15061;Obelėlė;Svajokliai;8604451971;Ne;0;0;4;4
15062;Obelėlė;Svajokliai;6785654280;Ne;0;0;4;4
15063;Obelėlė;Svajokliai;6311322617;Ne;0;0;1;1
15064;Obelėlė;Smalsučiai;6497584911;Ne;3;0;0;3
15065;Obelėlė;Smalsučiai;7687093936;Ne;1;0;0;1
15066;Obelėlė;Smalsučiai;1469375976;Ne;3;0;0;3
15067;Obelėlė;Smalsučiai;4987747783;Ne;2;0;0;2
15068;Obelėlė;Smalsučiai;5085970254;Ne;1;7;0;8
15069;Obelėlė;Smalsučiai;8709758561;Ne;7;0;0;7
15070;Obelėlė;Smalsučiai;4318546408;Ne;1;0;0;1
15071;Obelėlė;Smalsučiai;2631405243;Ne;7;0;0;7
15072;Obelėlė;Smalsučiai;8173307704;Ne;11;0;0;11
15073;Obelėlė;Smalsučiai;6720808705;Ne;12;0;0;12
15074;Obelėlė;Smalsučiai;7850656031;Ne;1;0;0;1
15075;Obelėlė;Smalsučiai;9084969712;Taip;3;0;0;3
15076;Obelėlė;Smalsučiai;6364101139;Ne;7;0;0;7
15077;Obelėlė;Smalsučiai;6064646690;Ne;2;0;0;2
15078;Obelėlė;Smalsučiai;8183287212;Ne;1;0;0;1
15079;Obelėlė;Smalsučiai;2574840626;Ne;4;5;0;9
15080;Obelėlė;Smalsučiai;8981403984;Ne;0;21;0;21
15081;Obelėlė;Pabiručiai;5763713052;Taip;11;0;0;11
15082;Obelėlė;Pabiručiai;7667966704;Ne;3;5;0;8
15083;Obelėlė;Pabiručiai;1819480590;Ne;2;0;0;2
15084;Obelėlė;Pabiručiai;8579887226;Ne;5;0;0;5
15085;Obelėlė;Pabiručiai;3951816174;Ne;5;0;0;5
15086;Obelėlė;Pabiručiai;5599466885;Ne;0;0;5;5
15087;Obelėlė;Pabiručiai;9634414572;Ne;2;0;1;3
15088;Obelėlė;Pabiručiai;2262107831;Ne;5;0;0;5
15089;Obelėlė;Pabiručiai;4851824672;Ne;7;0;0;7
15090;Obelėlė;Pabiručiai;3526079444;Ne;3;0;1;4
15091;Obelėlė;Pabiručiai;9731565368;Ne;2;0;2;4
15092;Obelėlė;Pabiručiai;8827515572;Ne;3;0;0;3
15093;Obelėlė;Pabiručiai;2399173200;Ne;0;0;1;1
15094;Obelėlė;Pabiručiai;8443192155;Ne;0;0;2;2
15095;Obelėlė;Pabiručiai;9627134967;Ne;3;4;0;7
15096;Obelėlė;Pabiručiai;4575139158;Ne;9;1;0;10
15097;Obelėlė;Strakaliukai;1706102918;Taip;2;0;0;2
15098;Obelėlė;Strakaliukai;8682794598;Ne;2;6;0;8
15099;Obelėlė;Strakaliukai;8754552660;Ne;2;0;0;2
15100;Obelėlė;Strakaliukai;8092024850;Ne;1;0;0;1
15101;Obelėlė;Strakaliukai;9716500560;Ne;1;0;0;1
15102;Obelėlė;Strakaliukai;4251418414;Ne;1;0;0;1
15103;Obelėlė;Strakaliukai;5943314566;Ne;1;0;0;1
15104;Obelėlė;Strakaliukai;3116100694;Ne;2;0;0;2
15105;Obelėlė;Strakaliukai;8050551266;Ne;0;3;0;3
15106;Obelėlė;Strakaliukai;7468335279;Taip;6;0;0;6
15107;Obelėlė;Strakaliukai;1180508643;Ne;0;3;0;3
15108;Obelėlė;Strakaliukai;7124393375;Ne;2;11;0;13
15109;Obelėlė;Strakaliukai;5001844064;Ne;3;0;0;3
15110;Obelėlė;Strakaliukai;9976694313;Ne;2;0;0;2
15111;Obelėlė;Strakaliukai;1537769810;Ne;0;9;0;9
15112;Obelėlė;Strakaliukai;5776116844;Ne;3;0;0;3
15113;Obelėlė;Strakaliukai;1419189517;Ne;3;0;0;3
15114;Obelėlė;Strakaliukai;3425736276;Ne;1;0;0;1
15115;Obelėlė;Strakaliukai;8487088625;Ne;0;1;0;1
15116;Obelėlė;Strakaliukai;5374979248;Taip;4;0;0;4
15117;Obelėlė;Saulutė;2772753891;Taip;0;9;0;9
15118;Obelėlė;Saulutė;8486560892;Ne;0;1;0;1
15119;Obelėlė;Saulutė;1858251094;Ne;0;0;6;6
15120;Obelėlė;Saulutė;2893378990;Ne;5;0;5;10
15121;Obelėlė;Saulutė;6874039388;Ne;0;10;0;10
15122;Obelėlė;Saulutė;7491934262;Ne;0;0;1;1
15123;Obelėlė;Saulutė;9043542844;Ne;0;0;3;3
15124;Obelėlė;Saulutė;4321210604;Taip;0;0;2;2
15125;Obelėlė;Saulutė;4209489251;Ne;4;0;8;12
15126;Obelėlė;Saulutė;4309622934;Ne;12;0;0;12
15127;Obelėlė;Saulutė;6470533765;Ne;1;6;0;7
15128;Obelėlė;Saulutė;8223715886;Ne;1;6;0;7
15129;Obelėlė;Saulutė;8461505586;Ne;0;0;6;6
15130;Obelėlė;Saulutė;2730569223;Ne;0;0;8;8
15131;Obelėlė;Saulutė;4218895290;Ne;5;1;2;8
15132;Obelėlė;Saulutė;3460171136;Taip;0;0;3;3
15133;Obelėlė;Saulutė;4262041356;Ne;0;0;6;6
15134;Obelėlė;Rieduliukai;7358561581;Taip;1;0;0;1
15135;Obelėlė;Rieduliukai;6288343928;Ne;8;0;0;8
15136;Obelėlė;Rieduliukai;8672239434;Ne;10;0;0;10
15137;Obelėlė;Rieduliukai;9980499571;Ne;0;0;2;2
15138;Obelėlė;Rieduliukai;9329425457;Ne;4;7;1;12
15139;Obelėlė;Rieduliukai;1246354139;Ne;2;0;0;2
15140;Obelėlė;Rieduliukai;8963630504;Ne;1;0;0;1
15141;Obelėlė;Rieduliukai;3210789582;Ne;5;0;0;5
15142;Obelėlė;Rieduliukai;1039878043;Ne;5;0;0;5
15143;Obelėlė;Rieduliukai;7111855298;Ne;5;0;0;5
15144;Obelėlė;Rieduliukai;9359921446;Ne;6;0;0;6
15145;Obelėlė;Žirniukai;9542303128;Ne;1;0;0;1
15146;Obelėlė;Žirniukai;3886008149;Ne;9;0;0;9
15147;Obelėlė;Žirniukai;4676986978;Ne;1;0;0;1
15148;Obelėlė;Žirniukai;9222485883;Taip;9;0;0;9
15149;Obelėlė;Žirniukai;4708077301;Ne;6;0;0;6
15150;Obelėlė;Žirniukai;3199776998;Ne;2;0;0;2
15151;Obelėlė;Žirniukai;4979811410;Ne;1;10;0;11
15152;Obelėlė;Žirniukai;1369344706;Ne;8;0;0;8
15153;Obelėlė;Žirniukai;2561695305;Ne;7;0;0;7
15154;Obelėlė;Žirniukai;3347690540;Ne;10;0;0;10
15155;Obelėlė;Žirniukai;9502503757;Ne;9;0;0;9
15156;Obelėlė;Žirniukai;3474007758;Ne;10;0;0;10
15157;Obelėlė;Žirniukai;8777938603;Ne;5;0;0;5
15158;Obelėlė;Žirniukai;5213900934;Ne;8;0;0;8
15159;Obelėlė;Žirniukai;4862765923;Ne;21;0;0;21
15160;Obelėlė;Bičiuliai;5209482838;Ne;10;0;2;12
15161;Obelėlė;Bičiuliai;8422696011;Ne;0;0;1;1
15162;Obelėlė;Bičiuliai;1799603610;Ne;0;21;0;21
15163;Obelėlė;Bičiuliai;5192989376;Taip;13;0;1;14
15164;Obelėlė;Bičiuliai;5503843905;Ne;0;0;5;5
15165;Obelėlė;Bičiuliai;2769784741;Ne;0;21;0;21
15166;Obelėlė;Bičiuliai;1222183008;Ne;0;13;3;16
15167;Obelėlė;Bičiuliai;7813350634;Ne;0;0;1;1
15168;Obelėlė;Bičiuliai;6133596410;Ne;0;0;1;1
15169;Obelėlė;Bičiuliai;3568124213;Ne;0;3;1;4
15170;Obelėlė;Bičiuliai;2702773541;Ne;4;0;4;8
15171;Obelėlė;Bičiuliai;5478392319;Ne;0;0;1;1
15172;Obelėlė;Bičiuliai;4223995429;Ne;0;20;0;20
15173;Obelėlė;Bičiuliai;8982197866;Ne;10;0;3;13
15174;Obelėlė;Bičiuliai;3881456534;Taip;15;0;3;18
15175;Obelėlė;Kodėlčiukai;9960526051;Ne;7;0;0;7
15176;Obelėlė;Kodėlčiukai;1050919659;Ne;3;0;1;4
15177;Obelėlė;Kodėlčiukai;7014872044;Ne;7;0;0;7
15178;Obelėlė;Kodėlčiukai;3028107343;Ne;5;0;0;5
15179;Obelėlė;Kodėlčiukai;4717038536;Ne;2;0;0;2
15180;Obelėlė;Kodėlčiukai;4840134079;Taip;2;0;0;2
15181;Obelėlė;Kodėlčiukai;8762518354;Ne;0;0;1;1
15182;Obelėlė;Kodėlčiukai;3320493372;Ne;18;0;0;18
15183;Obelėlė;Kodėlčiukai;8366162313;Ne;0;0;1;1
15184;Obelėlė;Kodėlčiukai;6481365666;Ne;0;0;1;1
15185;Obelėlė;Kodėlčiukai;2227383487;Ne;3;0;1;4
15186;Obelėlė;Kodėlčiukai;8818153952;Ne;4;0;0;4
15187;Obelėlė;Kodėlčiukai;4887103549;Ne;15;0;0;15
15188;Obelėlė;Kodėlčiukai;5221918341;Taip;2;0;0;2
15189;Obelėlė;Kodėlčiukai;3748406335;Ne;1;0;0;1
15190;Obelėlė;Kodėlčiukai;5233321854;Ne;0;0;2;2
15191;Obelėlė;Kodėlčiukai;7531515854;Ne;0;21;0;21
15192;Obelėlė;Kodėlčiukai;7422668691;Ne;0;0;2;2
15193;Obelėlė;Pagrandukai;7934967787;Ne;5;0;0;5
15194;Obelėlė;Pagrandukai;6938326798;Ne;7;5;0;12
15195;Obelėlė;Pagrandukai;9258651395;Taip;2;0;0;2
15196;Obelėlė;Pagrandukai;3563701047;Ne;16;0;0;16
15197;Obelėlė;Pagrandukai;8664564820;Taip;5;0;0;5
15198;Obelėlė;Pagrandukai;9170515841;Ne;16;0;0;16
15199;Obelėlė;Pagrandukai;4930485327;Ne;5;0;0;5
15200;Obelėlė;Pagrandukai;7368698046;Ne;13;0;0;13
15201;Obelėlė;Pagrandukai;3738932600;Taip;3;0;0;3
15202;Obelėlė;Pagrandukai;2203568007;Ne;12;0;0;12
15203;Obelėlė;Pagrandukai;1423488655;Ne;1;0;0;1
15204;Obelėlė;Pagrandukai;6045739549;Taip;8;0;0;8
15205;Obelėlė;Pagrandukai;1100928253;Ne;12;0;0;12
15206;Spygliukas;Bitutės;9444569348;Ne;1;0;0;1
15207;Spygliukas;Bitutės;4835818382;Ne;0;2;0;2
15208;Spygliukas;Bitutės;9413950200;Ne;0;1;0;1
15209;Spygliukas;Bitutės;1664878188;Ne;0;4;0;4
15210;Spygliukas;Bitutės;5134327772;Ne;2;1;0;3
15211;Spygliukas;Bitutės;8869320003;Ne;0;6;0;6
15212;Spygliukas;Bitutės;8476882854;Ne;11;0;0;11
15213;Spygliukas;Bitutės;3761715811;Ne;0;2;0;2
15214;Spygliukas;Bitutės;8270525839;Ne;0;2;0;2
15215;Spygliukas;Bitutės;3697691132;Ne;10;2;0;12
15216;Spygliukas;Bitutės;1550737449;Taip;2;1;0;3
15217;Spygliukas;Bitutės;2395961015;Taip;0;1;0;1
15218;Spygliukas;Bitutės;9431217584;Ne;3;3;0;6
15219;Spygliukas;Bitutės;8289288541;Ne;4;1;0;5
15220;Spygliukas;Bitutės;8825264090;Taip;7;1;0;8
15221;Spygliukas;Kiškučiai;8246739374;Ne;0;1;0;1
15222;Spygliukas;Kiškučiai;8426426785;Taip;1;8;0;9
15223;Spygliukas;Kiškučiai;1243647769;Ne;5;0;0;5
15224;Spygliukas;Kiškučiai;6680699873;Ne;21;0;0;21
15225;Spygliukas;Kiškučiai;5043843336;Ne;5;0;0;5
15226;Spygliukas;Kiškučiai;8509447147;Ne;0;6;0;6
15227;Spygliukas;Kiškučiai;2955219028;Ne;10;0;0;10
15228;Spygliukas;Kiškučiai;5739075961;Ne;7;0;0;7
15229;Spygliukas;Kiškučiai;1823720183;Ne;16;1;0;17
15230;Spygliukas;Kiškučiai;1775612723;Ne;0;7;0;7
15231;Spygliukas;Kiškučiai;7324915516;Ne;11;1;0;12
15232;Spygliukas;Kiškučiai;6414439254;Ne;11;1;0;12
15233;Spygliukas;Kiškučiai;8565217488;Ne;20;0;0;20
15234;Spygliukas;Kiškučiai;3065727701;Ne;9;1;0;10
15235;Spygliukas;Kiškučiai;2367685286;Taip;0;21;0;21
15236;Spygliukas;Kiškučiai;7663839690;Ne;0;1;0;1
15237;Spygliukas;Kiškučiai;2738766977;Ne;1;0;0;1
15238;Spygliukas;Kiškučiai;4409209677;Ne;7;0;0;7
15239;Spygliukas;Boružėlės;5615854225;Ne;0;7;0;7
15240;Spygliukas;Boružėlės;6195903792;Ne;2;0;0;2
15241;Spygliukas;Boružėlės;1927028026;Ne;0;1;0;1
15242;Spygliukas;Boružėlės;7261580644;Ne;0;5;0;5
15243;Spygliukas;Boružėlės;6246925536;Taip;8;8;0;16
15244;Spygliukas;Boružėlės;8299276429;Taip;5;5;0;10
15245;Spygliukas;Boružėlės;7243104877;Ne;1;1;0;2
15246;Spygliukas;Boružėlės;9813995933;Taip;0;11;0;11
15247;Spygliukas;Boružėlės;4013601534;Ne;13;1;0;14
15248;Spygliukas;Boružėlės;1436452804;Ne;8;1;0;9
15249;Spygliukas;Boružėlės;3959136555;Ne;5;0;0;5
15250;Spygliukas;Boružėlės;6383264068;Ne;6;1;0;7
15251;Spygliukas;Boružėlės;1330384915;Taip;3;0;0;3
15252;Spygliukas;Boružėlės;1037321774;Ne;3;1;0;4
15253;Spygliukas;Boružėlės;9025238241;Ne;8;0;0;8
15254;Spygliukas;Boružėlės;5255993275;Taip;16;0;0;16
15255;Spygliukas;Ežiukai;2164549239;Ne;2;0;0;2
15256;Spygliukas;Ežiukai;4340767624;Taip;7;0;0;7
15257;Spygliukas;Ežiukai;4615217628;Taip;7;3;0;10
15258;Spygliukas;Ežiukai;5612894706;Ne;8;4;0;12
15259;Spygliukas;Ežiukai;6552944183;Ne;1;0;0;1
15260;Spygliukas;Ežiukai;6459076295;Ne;1;0;0;1
15261;Spygliukas;Ežiukai;7749937772;Ne;11;0;0;11
15262;Spygliukas;Ežiukai;5160835235;Ne;2;1;0;3
15263;Spygliukas;Ežiukai;2719100414;Ne;9;0;0;9
15264;Spygliukas;Ežiukai;4026252608;Ne;5;2;0;7
15265;Spygliukas;Ežiukai;4098112375;Ne;6;0;0;6
15266;Spygliukas;Ežiukai;9321493897;Ne;5;0;0;5
15267;Spygliukas;Ežiukai;7908419787;Taip;1;0;0;1
15268;Spygliukas;Ežiukai;3088387895;Ne;3;0;0;3
15269;Spygliukas;Ežiukai;7287543571;Ne;5;0;0;5
15270;Spygliukas;Ežiukai;3297728501;Ne;0;1;0;1
15271;Spygliukas;Ežiukai;3959227706;Ne;7;1;0;8
15272;Spygliukas;Geniukai;8821434815;Ne;3;0;0;3
15273;Spygliukas;Geniukai;2713999021;Ne;5;1;0;6
15274;Spygliukas;Geniukai;5782501698;Ne;4;0;0;4
15275;Spygliukas;Geniukai;6700076900;Ne;17;0;0;17
15276;Spygliukas;Geniukai;8338260940;Ne;4;1;0;5
15277;Spygliukas;Geniukai;1863442354;Ne;2;1;0;3
15278;Spygliukas;Geniukai;9945315122;Ne;0;1;0;1
15279;Spygliukas;Geniukai;1291429206;Ne;0;2;0;2
15280;Spygliukas;Geniukai;7477731865;Ne;0;1;0;1
15281;Spygliukas;Geniukai;2950722789;Taip;0;1;0;1
15282;Spygliukas;Geniukai;8093949301;Ne;3;1;0;4
15283;Spygliukas;Geniukai;9141146733;Ne;2;0;0;2
15284;Spygliukas;Geniukai;6363991196;Ne;0;8;0;8
15285;Spygliukas;Geniukai;8308394841;Ne;3;6;0;9
15286;Spygliukas;Geniukai;1127941700;Ne;0;1;0;1
15287;Spygliukas;Geniukai;9783154498;Ne;6;0;0;6
15288;Spygliukas;Geniukai;8581453160;Ne;13;0;0;13
15289;Spygliukas;Geniukai;7573756485;Ne;8;0;0;8
15290;Spygliukas;Geniukai;9770852356;Ne;6;0;0;6
15291;Spygliukas;Riešutėliai;1333556956;Ne;5;1;0;6
15292;Spygliukas;Riešutėliai;7271659513;Ne;13;1;0;14
15293;Spygliukas;Riešutėliai;8604767396;Ne;4;1;0;5
15294;Spygliukas;Riešutėliai;4634660174;Ne;6;0;0;6
15295;Spygliukas;Riešutėliai;8646122773;Ne;3;1;0;4
15296;Spygliukas;Riešutėliai;7924880159;Ne;0;5;0;5
15297;Spygliukas;Riešutėliai;4368224847;Ne;1;5;0;6
15298;Spygliukas;Riešutėliai;9316731983;Ne;0;11;0;11
15299;Spygliukas;Riešutėliai;5012876830;Ne;1;0;0;1
15300;Spygliukas;Riešutėliai;2315421636;Ne;0;1;0;1
15301;Spygliukas;Riešutėliai;7125425492;Ne;1;0;0;1
15302;Spygliukas;Riešutėliai;9052337501;Ne;1;0;0;1
15303;Spygliukas;Riešutėliai;1974541155;Ne;0;1;0;1
15304;Spygliukas;Riešutėliai;4505044604;Ne;0;7;0;7
15305;Spygliukas;Riešutėliai;9086986643;Taip;3;1;0;4
15306;Spygliukas;Pelėdžiukai;3569857813;Ne;4;0;0;4
15307;Spygliukas;Pelėdžiukai;5493599614;Ne;3;0;0;3
15308;Spygliukas;Pelėdžiukai;4577592862;Taip;0;3;0;3
15309;Spygliukas;Pelėdžiukai;6931145017;Ne;2;0;0;2
15310;Spygliukas;Pelėdžiukai;8802722601;Taip;0;6;0;6
15311;Spygliukas;Pelėdžiukai;9285259322;Ne;5;0;0;5
15312;Spygliukas;Pelėdžiukai;1341333016;Ne;19;0;0;19
15313;Spygliukas;Pelėdžiukai;8806126755;Taip;0;6;0;6
15314;Spygliukas;Pelėdžiukai;4477402331;Ne;5;0;0;5
15315;Spygliukas;Pelėdžiukai;2772801133;Ne;8;0;0;8
15316;Spygliukas;Pelėdžiukai;3706443395;Ne;4;0;0;4
15317;Spygliukas;Pelėdžiukai;5765106914;Ne;1;1;0;2
15318;Spygliukas;Pelėdžiukai;8708083787;Ne;10;0;0;10
15319;Spygliukas;Pelėdžiukai;3416275094;Ne;8;7;0;15
15320;Spygliukas;Pelėdžiukai;1401951658;Ne;0;6;0;6
15321;Spygliukas;Pelėdžiukai;7900652746;Taip;0;5;0;5
15322;Spygliukas;Zylutės;2135024989;Ne;15;0;0;15
15323;Spygliukas;Zylutės;7351963782;Ne;6;0;0;6
15324;Spygliukas;Zylutės;3804738695;Taip;11;1;0;12
15325;Spygliukas;Zylutės;3036959597;Ne;4;0;0;4
15326;Spygliukas;Zylutės;5565042215;Ne;11;0;0;11
15327;Spygliukas;Zylutės;4161787684;Ne;5;0;0;5
15328;Spygliukas;Zylutės;8536017163;Ne;9;0;0;9
15329;Spygliukas;Zylutės;4097562838;Ne;6;0;0;6
15330;Spygliukas;Zylutės;6021859437;Ne;2;0;0;2
15331;Spygliukas;Zylutės;5357257525;Ne;11;0;0;11
15332;Spygliukas;Zylutės;9382060963;Ne;12;0;0;12
15333;Spygliukas;Zylutės;8246963847;Ne;7;0;0;7
15334;Spygliukas;Skruzdėliukai;6828136677;Ne;10;0;0;10
15335;Spygliukas;Skruzdėliukai;7524773805;Ne;0;3;0;3
15336;Spygliukas;Skruzdėliukai;2921299830;Ne;7;2;0;9
15337;Spygliukas;Skruzdėliukai;3458761442;Ne;4;2;0;6
15338;Spygliukas;Skruzdėliukai;9211070397;Ne;4;1;0;5
15339;Spygliukas;Skruzdėliukai;1210648053;Ne;10;0;0;10
15340;Spygliukas;Skruzdėliukai;7163485844;Ne;5;0;0;5
15341;Spygliukas;Skruzdėliukai;4974008654;Ne;6;0;0;6
15342;Spygliukas;Skruzdėliukai;6749921681;Ne;1;0;0;1
15343;Spygliukas;Voveraitės;9112172144;Ne;13;0;0;13
15344;Spygliukas;Voveraitės;7897603878;Ne;2;0;0;2
15345;Spygliukas;Voveraitės;7741841634;Ne;0;7;0;7
15346;Spygliukas;Voveraitės;3077468722;Ne;2;0;0;2
15347;Spygliukas;Voveraitės;1177439438;Ne;0;1;0;1
15348;Spygliukas;Voveraitės;2272141731;Ne;1;0;0;1
15349;Spygliukas;Voveraitės;6587957213;Ne;0;11;0;11
15350;Spygliukas;Voveraitės;6758336405;Ne;7;0;0;7
15351;Spygliukas;Voveraitės;3668191959;Ne;2;0;0;2
15352;Spygliukas;Voveraitės;1426267001;Ne;4;0;0;4
15353;Spygliukas;Voveraitės;8189748611;Ne;3;0;0;3
15354;Spygliukas;Voveraitės;8877911083;Ne;3;0;0;3
15355;Spygliukas;Voveraitės;6405496193;Ne;1;1;0;2
15356;Spygliukas;Voveraitės;9231097598;Ne;2;0;0;2
15357;Spygliukas;Voveraitės;4681061579;Ne;3;0;0;3
15358;Spygliukas;Voveraitės;1234195733;Ne;2;0;0;2
15359;Spygliukas;Giliukų;1761340174;Ne;4;2;0;6
15360;Spygliukas;Giliukų;4854168938;Taip;3;0;0;3
15361;Spygliukas;Giliukų;7522567241;Ne;2;1;0;3
15362;Spygliukas;Giliukų;7460280684;Taip;7;0;0;7
15363;Spygliukas;Giliukų;4429961491;Ne;0;6;1;7
15364;Spygliukas;Giliukų;8821028259;Ne;0;0;1;1
15365;Spygliukas;Giliukų;6485350404;Ne;18;0;0;18
15366;Spygliukas;Giliukų;3237501537;Ne;5;0;0;5
15367;Spygliukas;Giliukų;8722863277;Ne;4;0;0;4
15368;Spygliukas;Giliukų;3603606800;Ne;8;1;0;9
15369;Spygliukas;Giliukų;6290439938;Ne;0;3;0;3
15370;Spygliukas;Giliukų;7776811391;Ne;3;1;0;4
15371;Spygliukas;Giliukų;3777763305;Ne;4;0;0;4
15372;Spygliukas;Giliukų;4626877679;Ne;0;2;0;2
15373;Spygliukas;Giliukų;4494339318;Ne;10;0;0;10
15374;Spygliukas;Drugeliai;5164567779;Ne;0;2;0;2
15375;Spygliukas;Drugeliai;9465470810;Ne;9;0;0;9
15376;Spygliukas;Drugeliai;9601530981;Ne;4;0;0;4
15377;Spygliukas;Drugeliai;4417471958;Taip;5;0;0;5
15378;Spygliukas;Drugeliai;3317395260;Ne;6;1;0;7
15379;Spygliukas;Drugeliai;6858338620;Ne;5;0;0;5
15380;Spygliukas;Drugeliai;5638595939;Ne;6;1;0;7
15381;Spygliukas;Drugeliai;8408234202;Taip;1;1;0;2
15382;Spygliukas;Drugeliai;1729199382;Taip;2;0;0;2
15383;Spygliukas;Drugeliai;5006372835;Ne;7;0;0;7
15384;Spygliukas;Drugeliai;3268222954;Ne;0;1;0;1
15385;Spygliukas;Drugeliai;3066293772;Ne;8;0;0;8
15386;Spygliukas;Drugeliai;2632672131;Taip;0;1;0;1
15387;Vieversys;Žirniukai;7029322013;Taip;2;2;0;4
15388;Vieversys;Žirniukai;2869545222;Taip;1;1;0;2
15389;Vieversys;Žirniukai;7601876587;Ne;0;5;0;5
15390;Vieversys;Žirniukai;2024837493;Ne;0;10;0;10
15391;Vieversys;Žirniukai;8129566710;Ne;0;1;0;1
15392;Vieversys;Žirniukai;5576923685;Ne;0;2;0;2
15393;Vieversys;Žirniukai;7309040730;Ne;0;6;0;6
15394;Vieversys;Žirniukai;3575906273;Ne;3;1;0;4
15395;Vieversys;Žirniukai;1724543625;Taip;4;0;0;4
15396;Vieversys;Žirniukai;2242368843;Ne;0;1;0;1
15397;Vieversys;Žirniukai;9666764935;Ne;9;0;2;11
15398;Vieversys;Žirniukai;8966020793;Ne;5;0;0;5
15399;Vieversys;Žirniukai;6000875464;Ne;0;0;1;1
15400;Vieversys;Žirniukai;3683573041;Ne;2;0;0;2
15401;Vieversys;Varpelių;9463693741;Ne;4;0;0;4
15402;Vieversys;Varpelių;1924774817;Taip;3;1;0;4
15403;Vieversys;Varpelių;3595005599;Ne;0;4;0;4
15404;Vieversys;Varpelių;9155896981;Ne;0;5;0;5
15405;Vieversys;Varpelių;5160814541;Ne;0;1;0;1
15406;Vieversys;Varpelių;2635722489;Ne;0;1;0;1
15407;Vieversys;Varpelių;3262738994;Ne;4;1;0;5
15408;Vieversys;Varpelių;8350070741;Ne;6;0;0;6
15409;Vieversys;Varpelių;2805682329;Ne;0;1;0;1
15410;Vieversys;Varpelių;2956566201;Ne;0;0;4;4
15411;Vieversys;Varpelių;1727558984;Ne;0;0;18;18
15412;Vieversys;Varpelių;3780226431;Ne;4;0;0;4
15413;Vieversys;Varpelių;3572628491;Taip;3;1;0;4
15414;Vieversys;Varpelių;7611047781;Ne;1;5;0;6
15415;Vieversys;Varpelių;8079885165;Ne;5;0;1;6
15416;Vieversys;Varpelių;4510888337;Ne;0;2;0;2
15417;Vieversys;Kiškučių;6127272124;Ne;0;0;1;1
15418;Vieversys;Kiškučių;4892622551;Ne;1;0;0;1
15419;Vieversys;Kiškučių;3360981720;Taip;0;0;1;1
15420;Vieversys;Kiškučių;9972526744;Ne;3;0;0;3
15421;Vieversys;Kiškučių;9985374057;Ne;2;0;1;3
15422;Vieversys;Kiškučių;9308040716;Ne;0;0;1;1
15423;Vieversys;Kiškučių;4741252829;Ne;0;0;1;1
15424;Vieversys;Kiškučių;2140887757;Ne;0;7;0;7
15425;Vieversys;Kiškučių;3164280186;Ne;0;0;4;4
15426;Vieversys;Kiškučių;1748006118;Ne;0;0;1;1
15427;Vieversys;Kiškučių;7048475906;Ne;1;0;1;2
15428;Vieversys;Kiškučių;4072323869;Ne;10;0;0;10
15429;Vieversys;Kiškučių;2663322242;Ne;0;0;1;1
15430;Vieversys;Kiškučių;7596355010;Ne;0;5;0;5
15431;Vieversys;Kiškučių;9322322737;Ne;6;0;1;7
15432;Vieversys;Kiškučių;9164615794;Ne;0;6;0;6
15433;Vieversys;Pelėdžiukų;3681120339;Ne;0;0;3;3
15434;Vieversys;Pelėdžiukų;7007620994;Ne;7;0;3;10
15435;Vieversys;Pelėdžiukų;3946609345;Ne;5;10;0;15
15436;Vieversys;Pelėdžiukų;9686787125;Taip;0;0;1;1
15437;Vieversys;Pelėdžiukų;3684937630;Ne;2;0;0;2
15438;Vieversys;Pelėdžiukų;6563139211;Ne;0;1;2;3
15439;Vieversys;Pelėdžiukų;4294676988;Ne;6;0;1;7
15440;Vieversys;Pelėdžiukų;4835022593;Ne;3;0;0;3
15441;Vieversys;Pelėdžiukų;3249717073;Taip;0;0;1;1
15442;Vieversys;Pelėdžiukų;7120329258;Ne;0;2;0;2
15443;Vieversys;Pelėdžiukų;9494957750;Ne;0;0;1;1
15444;Vieversys;Pelėdžiukų;9835682858;Ne;0;0;6;6
15445;Vieversys;Pelėdžiukų;5907903394;Ne;9;0;0;9
15446;Vieversys;Pelėdžiukų;5769453869;Ne;3;0;0;3
15447;Vieversys;Saulučių;8492908398;Ne;0;5;0;5
15448;Vieversys;Saulučių;8706336322;Ne;0;0;1;1
15449;Vieversys;Saulučių;5966170543;Ne;0;1;0;1
15450;Vieversys;Saulučių;5210732072;Ne;0;0;1;1
15451;Vieversys;Saulučių;9476611261;Taip;0;21;0;21
15452;Vieversys;Saulučių;9978867863;Ne;0;11;1;12
15453;Vieversys;Saulučių;5479620291;Taip;3;0;0;3
15454;Vieversys;Saulučių;3601928285;Ne;2;0;0;2
15455;Vieversys;Saulučių;6839896363;Taip;0;1;1;2
15456;Vieversys;Saulučių;2661027772;Taip;0;0;2;2
15457;Vieversys;Saulučių;4428101863;Ne;0;4;0;4
15458;Vieversys;Saulučių;5417413393;Ne;5;0;0;5
15459;Vieversys;Saulučių;4335653911;Ne;0;2;1;3
15460;Vieversys;Saulučių;9092693925;Taip;0;10;1;11
15461;Vieversys;Kregždučių;3156245273;Taip;0;10;1;11
15462;Vieversys;Kregždučių;5645852451;Taip;0;0;1;1
15463;Vieversys;Kregždučių;9088171869;Ne;0;5;0;5
15464;Vieversys;Kregždučių;7998100115;Ne;2;0;2;4
15465;Vieversys;Kregždučių;9093088054;Ne;0;3;0;3
15466;Vieversys;Kregždučių;2849852593;Ne;11;0;2;13
15467;Vieversys;Kregždučių;6808541662;Ne;1;5;0;6
15468;Vieversys;Kregždučių;2230503026;Ne;1;0;0;1
15469;Vieversys;Kregždučių;8141710663;Ne;1;0;2;3
15470;Vieversys;Kregždučių;6157594693;Ne;0;4;0;4
15471;Vieversys;Kregždučių;9090281352;Ne;0;0;1;1
15472;Vieversys;Kregždučių;4308330177;Ne;7;0;3;10
15473;Vieversys;Kregždučių;4347494053;Ne;0;0;2;2
15474;Vieversys;Kregždučių;3122763958;Ne;5;1;0;6
15475;Vieversys;Boružėlių;4565799599;Ne;0;2;0;2
15476;Vieversys;Boružėlių;7399326463;Ne;10;0;1;11
15477;Vieversys;Boružėlių;4088189914;Ne;1;1;0;2
15478;Vieversys;Boružėlių;8084767846;Ne;0;0;2;2
15479;Vieversys;Boružėlių;9826657384;Ne;0;2;0;2
15480;Vieversys;Boružėlių;3731412573;Ne;0;1;0;1
15481;Vieversys;Boružėlių;7429565381;Ne;0;1;2;3
15482;Vieversys;Boružėlių;4297477514;Ne;0;1;0;1
15483;Vieversys;Boružėlių;2701284187;Ne;0;4;0;4
15484;Vieversys;Boružėlių;6234199996;Ne;6;12;0;18
15485;Vieversys;Boružėlių;4061364544;Ne;6;0;0;6
15486;Vieversys;Boružėlių;8446180685;Ne;5;0;0;5
15487;Vieversys;Bitučių;3529067497;Ne;1;0;0;1
15488;Vieversys;Bitučių;8339300439;Taip;3;0;0;3
15489;Vieversys;Bitučių;6133686703;Ne;5;0;0;5
15490;Vieversys;Bitučių;8916379820;Ne;3;0;0;3
15491;Vieversys;Bitučių;6070871599;Ne;0;11;0;11
15492;Vieversys;Bitučių;5598338574;Taip;5;0;0;5
15493;Vieversys;Bitučių;3798183613;Ne;2;0;0;2
15494;Vieversys;Bitučių;3539906884;Ne;0;21;0;21
15495;Vieversys;Bitučių;5226457473;Ne;0;21;0;21
15496;Vieversys;Bitučių;4138476832;Ne;7;1;0;8
15497;Vieversys;Bitučių;1844718177;Ne;5;0;1;6
15498;Vieversys;Smalsučių;8199984460;Ne;0;0;21;21
15499;Vieversys;Smalsučių;8371839883;Ne;6;0;0;6
15500;Vieversys;Smalsučių;4952182897;Ne;0;0;4;4
15501;Vieversys;Smalsučių;2092872414;Ne;0;0;1;1
15502;Vieversys;Smalsučių;5394635510;Ne;0;0;1;1
15503;Vieversys;Smalsučių;1160455554;Ne;0;0;1;1
15504;Vieversys;Smalsučių;8200432952;Ne;11;0;3;14
15505;Vieversys;Smalsučių;2535992834;Ne;0;0;3;3
15506;Vieversys;Smalsučių;4974924858;Ne;0;0;1;1
15507;Vieversys;Smalsučių;3332069842;Taip;0;1;2;3
15508;Vieversys;Smalsučių;2107000312;Ne;2;0;0;2
15509;Vieversys;Smalsučių;4743593002;Ne;0;0;9;9
15510;Vieversys;Smalsučių;6092848276;Ne;6;0;3;9
15511;Vieversys;Kodėlčiukų;9217208794;Ne;0;16;0;16
15512;Vieversys;Kodėlčiukų;5037806018;Ne;2;0;0;2
15513;Vieversys;Kodėlčiukų;1752359969;Taip;0;1;0;1
15514;Vieversys;Kodėlčiukų;6791121542;Ne;7;0;0;7
15515;Vieversys;Kodėlčiukų;5898422871;Ne;8;4;0;12
15516;Vieversys;Kodėlčiukų;6926960486;Ne;1;2;0;3
15517;Vieversys;Kodėlčiukų;1881076551;Ne;0;1;0;1
15518;Vieversys;Kodėlčiukų;1384388802;Ne;0;5;0;5
15519;Vieversys;Kodėlčiukų;4631238425;Ne;4;0;0;4
15520;Vieversys;Kodėlčiukų;8512643926;Ne;10;5;0;15
15521;Vieversys;Kodėlčiukų;7967372524;Ne;14;0;0;14
15522;Vieversys;NYKŠTUKAI;7778432049;Ne;12;0;1;13
15523;Vieversys;NYKŠTUKAI;6767212393;Ne;2;0;0;2
15524;Vieversys;NYKŠTUKAI;2143285915;Ne;2;0;0;2
15525;Vieversys;NYKŠTUKAI;7340840045;Ne;7;0;2;9
15526;Vieversys;NYKŠTUKAI;3557067985;Ne;6;0;0;6
15527;Vieversys;NYKŠTUKAI;3051432532;Taip;2;0;0;2
15528;Vieversys;NYKŠTUKAI;4051613934;Taip;2;0;0;2
15529;Vieversys;NYKŠTUKAI;9812354315;Ne;1;0;0;1
15530;Vieversys;NYKŠTUKAI;1377293916;Ne;2;0;0;2
15531;Vieversys;NYKŠTUKAI;4482612962;Ne;0;11;0;11
15532;Vieversys;DRUGELIAI;2638813853;Ne;10;1;1;12
15533;Vieversys;DRUGELIAI;7508850558;Ne;0;0;2;2
15534;Vieversys;DRUGELIAI;6669012722;Ne;0;4;0;4
15535;Vieversys;DRUGELIAI;9813883328;Ne;4;0;1;5
15536;Vieversys;DRUGELIAI;7708807923;Ne;0;2;0;2
15537;Vieversys;DRUGELIAI;4129333932;Ne;21;0;0;21
15538;Vieversys;DRUGELIAI;6581002790;Ne;4;0;0;4
15539;Vieversys;DRUGELIAI;1720061988;Taip;2;2;0;4
15540;Vieversys;DRUGELIAI;6014448044;Ne;1;2;0;3
15541;Vieversys;DRUGELIAI;6222790462;Ne;0;0;2;2
15542;Vieversys;DRUGELIAI;1752390411;Taip;0;1;0;1
15543;Vieversys;DRUGELIAI;4743557459;Ne;0;0;1;1
15544;Vieversys;DRUGELIAI;9377014366;Ne;12;0;0;12
15545;Vieversys;DRUGELIAI;8595221658;Ne;0;0;5;5
15546;Žirmūnėliai;SAULUTĖS;1948299433;Ne;6;0;0;6
15547;Žirmūnėliai;SAULUTĖS;4763350308;Ne;1;7;0;8
15548;Žirmūnėliai;SAULUTĖS;5626711530;Ne;0;8;0;8
15549;Žirmūnėliai;SAULUTĖS;3902161368;Ne;0;1;0;1
15550;Žirmūnėliai;SAULUTĖS;4338673048;Ne;0;1;0;1
15551;Žirmūnėliai;SAULUTĖS;4793967980;Ne;0;1;0;1
15552;Žirmūnėliai;SAULUTĖS;8242112212;Ne;4;2;0;6
15553;Žirmūnėliai;SAULUTĖS;1940552890;Ne;0;1;0;1
15554;Žirmūnėliai;SAULUTĖS;2392106040;Ne;0;4;0;4
15555;Žirmūnėliai;SAULUTĖS;4343419766;Ne;0;7;0;7
15556;Žirmūnėliai;SAULUTĖS;9145626116;Ne;11;2;0;13
15557;Žirmūnėliai;SAULUTĖS;7675488865;Ne;9;0;0;9
15558;Žirmūnėliai;SAULUTĖS;8345632807;Ne;0;1;0;1
15559;Žirmūnėliai;SAULUTĖS;8592714547;Ne;13;1;0;14
15560;Žirmūnėliai;SAULUTĖS;8481357052;Ne;8;0;0;8
15561;Žirmūnėliai;GILIUKAI;6430944858;Ne;0;0;2;2
15562;Žirmūnėliai;GILIUKAI;3562689670;Ne;0;1;0;1
15563;Žirmūnėliai;GILIUKAI;3767421827;Ne;3;1;0;4
15564;Žirmūnėliai;GILIUKAI;5104310002;Taip;7;2;4;13
15565;Žirmūnėliai;GILIUKAI;1025809131;Taip;4;2;0;6
15566;Žirmūnėliai;GILIUKAI;6899109664;Ne;8;1;0;9
15567;Žirmūnėliai;GILIUKAI;5089884149;Ne;0;0;3;3
15568;Žirmūnėliai;GILIUKAI;1791977446;Ne;0;2;0;2
15569;Žirmūnėliai;GILIUKAI;6875484657;Ne;0;0;14;14
15570;Žirmūnėliai;GILIUKAI;3532895278;Ne;0;1;0;1
15571;Žirmūnėliai;GILIUKAI;2959090234;Ne;0;0;3;3
15572;Žirmūnėliai;GILIUKAI;8618410295;Ne;8;0;0;8
15573;Žirmūnėliai;GILIUKAI;1941509002;Ne;8;0;2;10
15574;Žirmūnėliai;GILIUKAI;3646039695;Ne;0;2;0;2
15575;Žirmūnėliai;GILIUKAI;2866010286;Ne;0;1;0;1
15576;Žirmūnėliai;GILIUKAI;2904787614;Ne;0;2;0;2
15577;Žirmūnėliai;DRUGELIAI;2802717644;Ne;0;6;0;6
15578;Žirmūnėliai;DRUGELIAI;3029428022;Ne;6;0;0;6
15579;Žirmūnėliai;DRUGELIAI;5281338626;Ne;0;2;0;2
15580;Žirmūnėliai;DRUGELIAI;6892941066;Ne;0;2;0;2
15581;Žirmūnėliai;DRUGELIAI;9280663182;Ne;0;13;0;13
15582;Žirmūnėliai;DRUGELIAI;6427861912;Ne;0;0;5;5
15583;Žirmūnėliai;DRUGELIAI;5892153807;Ne;3;1;0;4
15584;Žirmūnėliai;DRUGELIAI;2870069039;Ne;0;8;0;8
15585;Žirmūnėliai;DRUGELIAI;8271996884;Ne;0;1;0;1
15586;Žirmūnėliai;DRUGELIAI;4291114238;Ne;0;1;0;1
15587;Žirmūnėliai;DRUGELIAI;8782085662;Ne;0;2;0;2
15588;Žirmūnėliai;DRUGELIAI;9472372819;Taip;3;2;0;5
15589;Žirmūnėliai;DRUGELIAI;3174613910;Ne;0;7;0;7
15590;Žirmūnėliai;DRUGELIAI;6812682361;Ne;3;0;0;3
15591;Žirmūnėliai;DRUGELIAI;5668266601;Ne;0;18;0;18
15592;Žirmūnėliai;DRUGELIAI;5616289290;Ne;4;2;0;6
15593;Žirmūnėliai;DRUGELIAI;9908958250;Taip;0;8;0;8
15594;Žirmūnėliai;DRUGELIAI;9978718231;Ne;0;1;0;1
15595;Žirmūnėliai;BORUŽIUKAI;5209700153;Ne;5;0;1;6
15596;Žirmūnėliai;BORUŽIUKAI;4815427530;Ne;0;0;1;1
15597;Žirmūnėliai;BORUŽIUKAI;5316869112;Ne;0;0;4;4
15598;Žirmūnėliai;BORUŽIUKAI;6641667315;Ne;5;2;1;8
15599;Žirmūnėliai;BORUŽIUKAI;1401001989;Ne;0;1;0;1
15600;Žirmūnėliai;BORUŽIUKAI;5154076629;Taip;0;1;0;1
15601;Žirmūnėliai;BORUŽIUKAI;1356219744;Ne;0;1;9;10
15602;Žirmūnėliai;BORUŽIUKAI;2985092368;Ne;5;0;0;5
15603;Žirmūnėliai;BORUŽIUKAI;2841958534;Ne;0;1;0;1
15604;Žirmūnėliai;BORUŽIUKAI;8999160836;Ne;0;1;0;1
15605;Žirmūnėliai;BORUŽIUKAI;9241738140;Ne;8;2;0;10
15606;Žirmūnėliai;BORUŽIUKAI;8607934394;Ne;0;1;0;1
15607;Žirmūnėliai;BORUŽIUKAI;7422544482;Ne;0;0;1;1
15608;Žirmūnėliai;BORUŽIUKAI;5723289396;Ne;0;10;0;10
15609;Žirmūnėliai;BORUŽIUKAI;4336415033;Taip;5;0;0;5
15610;Žirmūnėliai;BORUŽIUKAI;8917966812;Ne;6;0;0;6
15611;Žirmūnėliai;BORUŽIUKAI;8459217612;Ne;5;0;1;6
15612;Žirmūnėliai;BORUŽIUKAI;1473482823;Ne;2;0;1;3
15613;Žirmūnėliai;EŽIUKAI;7011701994;Ne;5;0;1;6
15614;Žirmūnėliai;EŽIUKAI;2661052835;Ne;0;8;0;8
15615;Žirmūnėliai;EŽIUKAI;1655437833;Ne;5;0;1;6
15616;Žirmūnėliai;EŽIUKAI;3640979388;Ne;0;2;0;2
15617;Žirmūnėliai;EŽIUKAI;6878528100;Ne;0;0;5;5
15618;Žirmūnėliai;EŽIUKAI;8440187348;Ne;0;3;0;3
15619;Žirmūnėliai;EŽIUKAI;4968278870;Ne;8;0;0;8
15620;Žirmūnėliai;EŽIUKAI;2693415717;Ne;0;9;3;12
15621;Žirmūnėliai;EŽIUKAI;7953019230;Ne;10;5;0;15
15622;Žirmūnėliai;EŽIUKAI;1832367936;Ne;0;7;1;8
15623;Žirmūnėliai;EŽIUKAI;3180116136;Ne;0;2;0;2
15624;Žirmūnėliai;EŽIUKAI;9759491055;Ne;0;1;0;1
15625;Žirmūnėliai;EŽIUKAI;1127214387;Ne;3;2;0;5
15626;Žirmūnėliai;EŽIUKAI;4101748829;Ne;0;1;0;1
15627;Žirmūnėliai;EŽIUKAI;2379638934;Ne;0;5;0;5
15628;Žirmūnėliai;EŽIUKAI;4710829908;Ne;0;6;0;6
15629;Žirmūnėliai;EŽIUKAI;7996709950;Ne;0;7;0;7
15630;Žirmūnėliai;EŽIUKAI;7580002502;Ne;7;0;2;9
15631;Žirmūnėliai;EŽIUKAI;1977798059;Ne;0;0;7;7
15632;Žirmūnėliai;EŽIUKAI;3458810185;Ne;0;2;0;2
15633;Žirmūnėliai;ŽVIRBLIUKAI;7410921362;Ne;0;10;0;10
15634;Žirmūnėliai;ŽVIRBLIUKAI;8627403283;Ne;0;6;1;7
15635;Žirmūnėliai;ŽVIRBLIUKAI;7020486370;Ne;0;1;0;1
15636;Žirmūnėliai;ŽVIRBLIUKAI;3449815783;Ne;0;2;0;2
15637;Žirmūnėliai;ŽVIRBLIUKAI;7892626521;Ne;0;2;0;2
15638;Žirmūnėliai;ŽVIRBLIUKAI;4778339658;Ne;0;8;0;8
15639;Žirmūnėliai;ŽVIRBLIUKAI;8209309240;Ne;0;3;0;3
15640;Žirmūnėliai;ŽVIRBLIUKAI;2837129621;Ne;0;0;2;2
15641;Žirmūnėliai;ŽVIRBLIUKAI;1273684243;Ne;0;0;2;2
15642;Žirmūnėliai;ŽVIRBLIUKAI;2971175236;Ne;4;1;0;5
15643;Žirmūnėliai;ŽVIRBLIUKAI;9154874729;Ne;0;1;0;1
15644;Žirmūnėliai;ŽVIRBLIUKAI;3795476732;Ne;10;0;0;10
15645;Žirmūnėliai;ŽVIRBLIUKAI;9732291476;Ne;1;0;1;2
15646;Žirmūnėliai;ŽVIRBLIUKAI;7087770068;Ne;0;7;0;7
15647;Žirmūnėliai;ŽVIRBLIUKAI;3766779594;Ne;0;1;0;1
15648;Žirmūnėliai;SPALVELĖS;9936156579;Taip;0;1;0;1
15649;Žirmūnėliai;SPALVELĖS;6259368139;Ne;8;2;1;11
15650;Žirmūnėliai;SPALVELĖS;6934204209;Ne;0;6;0;6
15651;Žirmūnėliai;SPALVELĖS;9306935083;Ne;8;1;0;9
15652;Žirmūnėliai;SPALVELĖS;4807331877;Ne;0;0;2;2
15653;Žirmūnėliai;SPALVELĖS;6817236579;Ne;0;13;0;13
15654;Žirmūnėliai;SPALVELĖS;9042509512;Ne;8;6;0;14
15655;Žirmūnėliai;SPALVELĖS;5076712824;Ne;0;3;0;3
15656;Žirmūnėliai;SPALVELĖS;8444883234;Ne;0;1;0;1
15657;Žirmūnėliai;SPALVELĖS;3977279181;Ne;0;1;0;1
15658;Žirmūnėliai;SPALVELĖS;8002655555;Ne;0;8;0;8
15659;Žirmūnėliai;SPALVELĖS;1116572386;Ne;1;1;0;2
15660;Žirmūnėliai;SPALVELĖS;1255294064;Ne;0;3;0;3
15661;Žirmūnėliai;SPALVELĖS;3520677404;Ne;0;2;1;3
15662;Žirmūnėliai;SPALVELĖS;5646794795;Ne;12;0;2;14
15663;Žirmūnėliai;SPALVELĖS;5901940160;Ne;5;0;0;5
15664;Žirmūnėliai;SPALVELĖS;4641264260;Ne;3;0;0;3
15665;Žirmūnėliai;SPALVELĖS;9858198555;Ne;0;2;1;3
15666;Žirmūnėliai;DEBESĖLIAI;6908512961;Ne;0;4;0;4
15667;Žirmūnėliai;DEBESĖLIAI;4347548125;Ne;21;0;0;21
15668;Žirmūnėliai;DEBESĖLIAI;3330603362;Ne;13;0;0;13
15669;Žirmūnėliai;DEBESĖLIAI;5440814849;Ne;0;2;0;2
15670;Žirmūnėliai;DEBESĖLIAI;7680479258;Ne;2;0;0;2
15671;Žirmūnėliai;DEBESĖLIAI;8136265008;Ne;0;18;0;18
15672;Žirmūnėliai;DEBESĖLIAI;7568228423;Ne;5;0;0;5
15673;Žirmūnėliai;DEBESĖLIAI;9813507899;Ne;13;0;0;13
15674;Žirmūnėliai;DEBESĖLIAI;8687642039;Ne;5;0;0;5
15675;Žirmūnėliai;DEBESĖLIAI;5982848146;Ne;1;0;0;1
15676;Žirmūnėliai;DEBESĖLIAI;5676730437;Ne;6;0;0;6
15677;Žirmūnėliai;DEBESĖLIAI;4653124134;Taip;2;1;1;4
15678;Žirmūnėliai;DEBESĖLIAI;4501490189;Ne;6;0;0;6
15679;Žirmūnėliai;DEBESĖLIAI;8239982682;Taip;2;0;0;2
15680;Žirmūnėliai;DEBESĖLIAI;3641319043;Ne;6;1;0;7
15681;Žirmūnėliai;DEBESĖLIAI;7053321410;Ne;21;0;0;21
15682;Žirmūnėliai;DEBESĖLIAI;4512970900;Ne;0;1;0;1
15683;Žirmūnėliai;VIŠČIUKAI;9688789802;Taip;1;0;1;2
15684;Žirmūnėliai;VIŠČIUKAI;1512873821;Ne;6;0;1;7
15685;Žirmūnėliai;VIŠČIUKAI;5659912057;Taip;2;0;0;2
15686;Žirmūnėliai;VIŠČIUKAI;7517228946;Ne;4;0;0;4
15687;Žirmūnėliai;VIŠČIUKAI;3144841534;Ne;5;0;0;5
15688;Žirmūnėliai;VIŠČIUKAI;6640314231;Ne;5;0;0;5
15689;Žirmūnėliai;VIŠČIUKAI;4464218112;Ne;7;0;0;7
15690;Žirmūnėliai;VIŠČIUKAI;7287108760;Ne;6;0;0;6
15691;Žirmūnėliai;VIŠČIUKAI;2353478333;Ne;1;0;0;1
15692;Žirmūnėliai;VIŠČIUKAI;4260032711;Ne;7;1;0;8
15693;Žirmūnėliai;VIŠČIUKAI;2821518346;Taip;6;0;0;6
15694;Žirmūnėliai;ZUIKUČIŲ;6122934687;Ne;3;0;0;3
15695;Žirmūnėliai;ZUIKUČIŲ;1582955541;Ne;2;0;0;2
15696;Žirmūnėliai;ZUIKUČIŲ;5772120262;Taip;0;0;7;7
15697;Žirmūnėliai;ZUIKUČIŲ;9448915252;Ne;6;0;0;6
15698;Žirmūnėliai;ZUIKUČIŲ;8526701525;Ne;5;0;0;5
15699;Žirmūnėliai;ZUIKUČIŲ;9953641492;Ne;0;2;4;6
15700;Žirmūnėliai;ZUIKUČIŲ;1498162175;Ne;0;2;0;2
15701;Žirmūnėliai;ZUIKUČIŲ;7232606752;Ne;4;0;0;4
15702;Žirmūnėliai;ZUIKUČIŲ;2857408011;Taip;2;0;0;2
15703;Žirmūnėliai;OBUOLIUKAI;4575123456;Ne;1;1;0;2
15704;Žirmūnėliai;OBUOLIUKAI;9002868728;Ne;8;2;3;13
15705;Žirmūnėliai;OBUOLIUKAI;2073922023;Taip;1;0;0;1
15706;Žirmūnėliai;OBUOLIUKAI;7059249540;Ne;9;0;0;9
15707;Žirmūnėliai;OBUOLIUKAI;4999561481;Ne;0;7;0;7
15708;Žirmūnėliai;OBUOLIUKAI;6358006462;Ne;6;0;0;6
15709;Žirmūnėliai;OBUOLIUKAI;2497258407;Ne;5;1;0;6
15710;Žirmūnėliai;OBUOLIUKAI;3949374730;Ne;4;1;0;5
15711;Žirmūnėliai;OBUOLIUKAI;6869102228;Ne;1;2;0;3
15712;Žirmūnėliai;OBUOLIUKAI;9367849317;Ne;0;1;0;1
15713;Žirmūnėliai;OBUOLIUKAI;9892620134;Ne;0;0;3;3
15714;Žirmūnėliai;OBUOLIUKAI;6450412481;Ne;2;1;1;4
15715;Žirmūnėliai;OBUOLIUKAI;9225654910;Ne;5;0;0;5
15716;Žirmūnėliai;OBUOLIUKAI;5483418311;Ne;0;3;0;3
15717;Žirmūnėliai;OBUOLIUKAI;7945713337;Ne;0;1;0;1
15718;Žirmūnėliai;OBUOLIUKAI;8823426998;Ne;0;2;7;9
15719;Žirmūnėliai;OBUOLIUKAI;2263820829;Ne;0;0;1;1
15720;Žirmūnėliai;OBUOLIUKAI;9823124599;Ne;4;0;3;7
15721;Žirmūnėliai;DAINORĖLIAI;8615363279;Ne;6;3;0;9
15722;Žirmūnėliai;DAINORĖLIAI;6397359786;Ne;7;0;2;9
15723;Žirmūnėliai;DAINORĖLIAI;3493835685;Ne;0;3;0;3
15724;Žirmūnėliai;DAINORĖLIAI;9483005892;Ne;5;0;0;5
15725;Žirmūnėliai;DAINORĖLIAI;6258830302;Ne;1;0;0;1
15726;Žirmūnėliai;DAINORĖLIAI;5977682064;Ne;0;0;7;7
15727;Žirmūnėliai;DAINORĖLIAI;1162986139;Ne;4;0;0;4
15728;Žirmūnėliai;DAINORĖLIAI;9220007612;Ne;6;0;0;6
15729;Žirmūnėliai;DAINORĖLIAI;4578525446;Ne;5;0;0;5
15730;Žirmūnėliai;DAINORĖLIAI;3319602277;Taip;15;0;0;15
15731;Žirmūnėliai;DAINORĖLIAI;5750554959;Ne;15;0;0;15
15732;Žirmūnėliai;DAINORĖLIAI;8512701905;Ne;10;0;1;11
15733;"Dainorėliai (Ankštoji g. 11)";ŽIOGELIAI;5591598390;Ne;2;1;0;3
15734;"Dainorėliai (Ankštoji g. 11)";ŽIOGELIAI;5793828922;Ne;4;1;0;5
15735;"Dainorėliai (Ankštoji g. 11)";ŽIOGELIAI;7591953671;Ne;6;3;0;9
15736;"Dainorėliai (Ankštoji g. 11)";ŽIOGELIAI;6169434322;Taip;0;2;0;2
15737;"Dainorėliai (Ankštoji g. 11)";ŽIOGELIAI;2094849111;Ne;9;1;0;10
15738;"Dainorėliai (Ankštoji g. 11)";ŽIOGELIAI;3887433142;Ne;2;2;0;4
15739;"Dainorėliai (Ankštoji g. 11)";ŽIOGELIAI;2541781620;Ne;2;0;0;2
15740;"Dainorėliai (Ankštoji g. 11)";ŽIOGELIAI;7984447187;Ne;4;0;0;4
15741;"Dainorėliai (Ankštoji g. 11)";ŽIOGELIAI;3897725337;Ne;11;0;0;11
15742;"Dainorėliai (Ankštoji g. 11)";ŽIOGELIAI;3592770633;Ne;2;0;0;2
15743;"Dainorėliai (Ankštoji g. 11)";ŽIOGELIAI;3897725337;Ne;11;0;0;11
15744;"Dainorėliai (Ankštoji g. 11)";ŽIOGELIAI;3592770633;Ne;2;0;0;2
15745;"Dainorėliai (Ankštoji g. 11)";ŽIOGELIAI;4973241539;Ne;15;0;0;15
15746;"Dainorėliai (Ankštoji g. 11)";DRUGELIAI;6403389248;Ne;7;0;2;9
15747;"Dainorėliai (Ankštoji g. 11)";DRUGELIAI;2703267758;Ne;3;0;0;3
15748;"Dainorėliai (Ankštoji g. 11)";DRUGELIAI;9976869100;Ne;0;0;3;3
15749;"Dainorėliai (Ankštoji g. 11)";DRUGELIAI;3063825996;Ne;2;0;3;5
15750;"Dainorėliai (Ankštoji g. 11)";DRUGELIAI;5854379630;Ne;2;0;2;4
15751;"Dainorėliai (Ankštoji g. 11)";DRUGELIAI;8088948564;Ne;9;0;5;14
15752;"Dainorėliai (Ankštoji g. 11)";DRUGELIAI;2803571247;Ne;2;0;4;6
15753;"Dainorėliai (Ankštoji g. 11)";DRUGELIAI;5084474142;Ne;1;0;0;1
15754;"Dainorėliai (Ankštoji g. 11)";DRUGELIAI;1332165159;Ne;26;0;0;26
15755;"Dainorėliai (Ankštoji g. 11)";DRUGELIAI;8684975630;Ne;2;0;0;2
15756;"Dainorėliai (Ankštoji g. 11)";DRUGELIAI;2740773904;Ne;3;0;0;3
15757;"Dainorėliai (Ankštoji g. 11)";DRUGELIAI;9303046800;Ne;2;0;2;4
15758;"Dainorėliai (Ankštoji g. 11)";DRUGELIAI;9592384914;Ne;0;0;2;2
15759;"Dainorėliai (Ankštoji g. 11)";DRUGELIAI;3741337791;Ne;1;0;1;2
15760;"Dainorėliai (Ankštoji g. 11)";"1 klasė";4255893222;Ne;2;0;0;2
15761;"Dainorėliai (Ankštoji g. 11)";"2 klasė";2520667095;Ne;0;1;0;1
15762;"Dainorėliai (Ankštoji g. 11)";"2 klasė";1333499160;Ne;20;1;0;21
15763;"Dainorėliai (Ankštoji g. 11)";"2 klasė";50432354832;Ne;0;1;0;1
15764;"Dainorėliai (Ankštoji g. 11)";"2 klasė";1626877066;Ne;0;1;0;1
15765;"Dainorėliai (Ankštoji g. 11)";"2 klasė";1158895670;Ne;0;1;0;1
15766;"Dainorėliai (Ankštoji g. 11)";"2 klasė";73649870571;Ne;7;1;0;8
15767;"Dainorėliai (Ankštoji g. 11)";"2 klasė";1531362555;Ne;0;1;0;1
15768;"Dainorėliai (Ankštoji g. 11)";"2 klasė";19286303769;Ne;0;1;0;1
15769;"Dainorėliai (Ankštoji g. 11)";"2 klasė";73386013083;Ne;3;1;0;4
15770;"Dainorėliai (Ankštoji g. 11)";"2 klasė";27521381629;Ne;6;1;0;7
15771;"Dainorėliai (Ankštoji g. 11)";"2 klasė";53935690864;Ne;0;1;0;1
15772;"Dainorėliai (Ankštoji g. 11)";"2 klasė";2287353933;Ne;1;1;0;2
15773;"Dainorėliai (Ankštoji g. 11)";"2 klasė";1120848949;Ne;0;1;0;1
15774;"Dainorėliai (Ankštoji g. 11)";"2 klasė";36313982965;Ne;2;1;0;3
15775;"Dainorėliai (Ankštoji g. 11)";"2 klasė";86659723162;Ne;2;1;0;3
15776;"Dainorėliai (Ankštoji g. 11)";"2 klasė";6195426672;Ne;0;1;0;1
15777;"Dainorėliai (Ankštoji g. 11)";"2 klasė";5479496104;Ne;0;1;0;1
15778;"Dainorėliai (Ankštoji g. 11)";"2 klasė";94480397292;Ne;0;1;0;1
15779;"Dainorėliai (Ankštoji g. 11)";"2 klasė";6404337541;Ne;1;1;0;2
15780;"Dainorėliai (Ankštoji g. 11)";"2 klasė";49483881135;Ne;0;1;0;1
15781;"Dainorėliai (Ankštoji g. 11)";"2 klasė";86187568203;Ne;1;1;0;2
15782;"Dainorėliai (Ankštoji g. 11)";"2 klasė";1015870220;Ne;5;1;0;6
15783;"Dainorėliai (Ankštoji g. 11)";"2 klasė";1515552402;Ne;3;1;0;4
15784;"Dainorėliai (Ankštoji g. 11)";"2 klasė";7114409929;Ne;5;1;0;6
15785;"Dainorėliai (Ankštoji g. 11)";"2 klasė";1084400276;Ne;0;1;0;1
15786;"Dainorėliai (Ankštoji g. 11)";SAULUTĖS;9130473411;Ne;1;0;0;1
15787;"Dainorėliai (Ankštoji g. 11)";SAULUTĖS;6704354150;Ne;1;0;0;1
15788;"Dainorėliai (Ankštoji g. 11)";SAULUTĖS;5632663846;Ne;0;1;0;1
15789;"Dainorėliai (Ankštoji g. 11)";SAULUTĖS;1547686786;Ne;0;1;0;1
15790;"Dainorėliai (Ankštoji g. 11)";SAULUTĖS;6385439136;Ne;0;1;0;1
15791;"Dainorėliai (Ankštoji g. 11)";SAULUTĖS;1552829080;Ne;0;1;0;1
15792;"Dainorėliai (Ankštoji g. 11)";SAULUTĖS;5410183494;Ne;3;0;0;3
15793;"Dainorėliai (Ankštoji g. 11)";SAULUTĖS;5587907483;Ne;0;12;0;12
15794;"Dainorėliai (Ankštoji g. 11)";SAULUTĖS;2064843848;Ne;0;1;0;1
15795;"Dainorėliai (Ankštoji g. 11)";SAULUTĖS;7804441689;Ne;4;0;0;4
15796;"Dainorėliai (Ankštoji g. 11)";SAULUTĖS;4431804759;Ne;0;1;0;1
15797;"Dainorėliai (Ankštoji g. 11)";SAULUTĖS;6697149560;Ne;1;2;0;3
15798;"Dainorėliai (Ankštoji g. 11)";SAULUTĖS;3762178533;Ne;2;2;0;4
15799;"Dainorėliai (Ankštoji g. 11)";SAULUTĖS;4798415786;Ne;0;3;0;3
15800;"Dainorėliai (Ankštoji g. 11)";SAULUTĖS;4079711515;Taip;6;0;0;6
15801;"Dainorėliai (Ankštoji g. 11)";SAULUTĖS;4798415786;Ne;0;3;0;3
15802;"Dainorėliai (Ankštoji g. 11)";SAULUTĖS;4798415786;Ne;0;3;0;3
15803;Lokiukas;BITUTĖS;4551069961;Ne;0;0;2;2
15804;Lokiukas;BITUTĖS;5217458476;Ne;0;5;2;7
15805;Lokiukas;BITUTĖS;6260486656;Ne;5;6;0;11
15806;Lokiukas;BITUTĖS;9480025132;Ne;0;3;0;3
15807;Lokiukas;BITUTĖS;8334800302;Ne;0;0;1;1
15808;Lokiukas;BITUTĖS;6883994020;Ne;5;0;0;5
15809;Lokiukas;BITUTĖS;1987485885;Ne;0;0;1;1
15810;Lokiukas;BITUTĖS;5794303981;Ne;3;0;7;10
15811;Lokiukas;BITUTĖS;2671053309;Taip;0;5;1;6
15812;Lokiukas;BITUTĖS;1647778939;Ne;0;0;1;1
15813;Lokiukas;BITUTĖS;8994257898;Ne;2;0;2;4
15814;Lokiukas;BITUTĖS;8656751314;Ne;0;0;8;8
15815;Lokiukas;BITUTĖS;2181315008;Ne;9;0;1;10
15816;Lokiukas;BITUTĖS;3896883842;Ne;6;0;0;6
15817;Lokiukas;BITUTĖS;1376124245;Ne;0;21;0;21
15818;Lokiukas;BITUTĖS;3329205450;Ne;1;5;1;7
15819;Lokiukas;"1 B klasė";1210407640;Ne;6;0;0;6
15820;Lokiukas;"1 B klasė";1733486244;Ne;9;0;0;9
15821;Lokiukas;"1 B klasė";6336140882;Ne;3;0;0;3
15822;Lokiukas;"1 B klasė";3485639108;Ne;4;0;0;4
15823;Lokiukas;"1 B klasė";1606617694;Taip;4;0;0;4
15824;Lokiukas;"1 B klasė";8243342948;Ne;7;0;0;7
15825;Lokiukas;"1 B klasė";3991821717;Ne;9;0;0;9
15826;Lokiukas;"1 B klasė";4633366779;Ne;21;0;0;21
15827;Lokiukas;"1 B klasė";1188049956;Ne;1;0;0;1
15828;Lokiukas;"1 B klasė";5446430319;Ne;5;0;0;5
15829;Lokiukas;"1 B klasė";2354942164;Ne;10;0;0;10
15830;Lokiukas;"1 B klasė";35364823312;Ne;5;0;0;5
15831;Lokiukas;"1 B klasė";8687864179;Ne;3;0;0;3
15832;Lokiukas;"1 B klasė";5076773045;Ne;2;0;0;2
15833;Lokiukas;"1 B klasė";1620856143;Ne;9;0;0;9
15834;Lokiukas;"1 B klasė";1604886863;Ne;2;0;0;2
15835;Lokiukas;"1 B klasė";54341630847;Ne;7;0;0;7
15836;Lokiukas;"1 B klasė";8320696048;Ne;1;0;0;1
15837;Lokiukas;"1 B klasė";2701448160;Taip;13;0;0;13
15838;Lokiukas;"1 B klasė";4024866819;Ne;4;0;0;4
15839;Lokiukas;"1 B klasė";2753402906;Ne;3;0;0;3
15840;Lokiukas;"1 B klasė";5275588088;Ne;7;0;0;7
15841;Lokiukas;"1 B klasė";67972824332;Ne;1;0;0;1
15842;Lokiukas;"1 B klasė";9053427316;Ne;5;0;0;5
15843;Lokiukas;"1 B klasė";8189217660;Ne;21;0;0;21
15844;Lokiukas;"1 B klasė";3423529085;Ne;2;0;0;2
15845;Lokiukas;"1 A klasė";2642065594;Ne;11;0;0;11
15846;Lokiukas;"1 A klasė";1025576053;Ne;5;0;0;5
15847;Lokiukas;"1 A klasė";6069516217;Ne;2;0;0;2
15848;Lokiukas;"1 A klasė";34546519642;Ne;3;0;0;3
15849;Lokiukas;"1 A klasė";1752784666;Ne;6;0;0;6
15850;Lokiukas;"1 A klasė";7943213321;Ne;1;0;0;1
15851;Lokiukas;"1 A klasė";8915504279;Ne;5;0;0;5
15852;Lokiukas;"1 A klasė";8796640190;Ne;1;0;0;1
15853;Lokiukas;"1 A klasė";5943412920;Ne;2;0;0;2
15854;Lokiukas;"1 A klasė";3694653020;Ne;10;0;0;10
15855;Lokiukas;"1 A klasė";8902619265;Ne;1;0;0;1
15856;Lokiukas;"1 A klasė";1040288021;Ne;15;0;0;15
15857;Lokiukas;"1 A klasė";8286358519;Ne;12;0;0;12
15858;Lokiukas;"1 A klasė";3744484616;Taip;3;0;0;3
15859;Lokiukas;"1 A klasė";6758550653;Ne;20;0;0;20
15860;Lokiukas;"1 A klasė";5467387832;Ne;5;0;0;5
15861;Lokiukas;"1 A klasė";9336617879;Ne;1;0;0;1
15862;Lokiukas;"1 A klasė";1886540733;Ne;7;0;0;7
15863;Lokiukas;"1 A klasė";7936978436;Ne;5;0;0;5
15864;Lokiukas;"1 A klasė";3843999609;Ne;9;0;0;9
15865;Lokiukas;"1 A klasė";1898004894;Ne;6;0;0;6
15866;Lokiukas;"1 A klasė";2397366916;Taip;10;0;0;10
15867;Lokiukas;"1 A klasė";4985243068;Ne;15;0;0;15
15868;Lokiukas;"1 A klasė";7623203279;Taip;5;0;0;5
15869;Lokiukas;"1 A klasė";7623203279;Taip;5;0;0;5
15870;Lokiukas;GUDRUČIAI;6277388612;Ne;2;0;1;3
15871;Lokiukas;GUDRUČIAI;4919744559;Ne;10;0;1;11
15872;Lokiukas;GUDRUČIAI;1974049743;Ne;0;7;0;7
15873;Lokiukas;GUDRUČIAI;9354491312;Ne;10;3;0;13
15874;Lokiukas;GUDRUČIAI;6091878190;Ne;8;0;0;8
15875;Lokiukas;GUDRUČIAI;3826815202;Ne;0;0;1;1
15876;Lokiukas;GUDRUČIAI;7208757038;Ne;6;0;0;6
15877;Lokiukas;GUDRUČIAI;1586414960;Ne;0;7;0;7
15878;Lokiukas;GUDRUČIAI;7904803011;Ne;0;1;1;2
15879;Lokiukas;GUDRUČIAI;2185853339;Ne;2;0;0;2
15880;Lokiukas;BORUŽĖLĖS;5473316050;Taip;1;1;0;2
15881;Lokiukas;BORUŽĖLĖS;2266747745;Ne;18;0;0;18
15882;Lokiukas;BORUŽĖLĖS;8758248334;Ne;3;1;0;4
15883;Lokiukas;BORUŽĖLĖS;9673257342;Ne;8;0;0;8
15884;Lokiukas;BORUŽĖLĖS;5893844708;Ne;8;4;0;12
15885;Lokiukas;BORUŽĖLĖS;3015119335;Ne;7;1;0;8
15886;Lokiukas;BORUŽĖLĖS;7509043689;Ne;12;1;0;13
15887;Lokiukas;BORUŽĖLĖS;1756658146;Ne;8;0;0;8
15888;Lokiukas;BORUŽĖLĖS;4417116107;Ne;6;2;0;8
15889;Lokiukas;BORUŽĖLĖS;3849212461;Ne;12;1;0;13
15890;Lokiukas;BORUŽĖLĖS;3668903653;Ne;7;0;0;7
15891;Lokiukas;BORUŽĖLĖS;2466354050;Ne;6;0;0;6
15892;Lokiukas;BORUŽĖLĖS;6827710384;Ne;12;0;0;12
15893;Lokiukas;BORUŽĖLĖS;5843699073;Ne;10;0;0;10
15894;Lokiukas;BORUŽĖLĖS;7955048052;Ne;6;11;0;17
15895;Lokiukas;BORUŽĖLĖS;8144936688;Ne;5;7;0;12
15896;Lokiukas;BORUŽĖLĖS;2999594131;Ne;3;5;0;8
15897;Lokiukas;BORUŽĖLĖS;8420913680;Taip;0;21;0;21
15898;Lokiukas;BORUŽĖLĖS;8139809541;Ne;9;0;0;9
15899;Lokiukas;BORUŽĖLĖS;2754009962;Ne;11;0;0;11
15900;Lokiukas;BORUŽĖLĖS;5673557301;Ne;2;1;0;3
15901;Lokiukas;BORUŽĖLĖS;3383354228;Ne;3;11;0;14
15902;Lokiukas;ANČIUKAI;5944620142;Ne;1;1;0;2
15903;Lokiukas;ANČIUKAI;9253014845;Ne;3;6;0;9
15904;Lokiukas;ANČIUKAI;2323620627;Ne;3;6;0;9
15905;Lokiukas;ANČIUKAI;3452792650;Ne;7;4;0;11
15906;Lokiukas;ANČIUKAI;7147146400;Ne;10;3;0;13
15907;Lokiukas;ANČIUKAI;8311551538;Ne;9;7;0;16
15908;Lokiukas;ANČIUKAI;5837961451;Ne;0;2;0;2
15909;Lokiukas;ANČIUKAI;7991284293;Ne;0;21;0;21
15910;Lokiukas;ANČIUKAI;5503888257;Ne;1;1;0;2
15911;Lokiukas;ANČIUKAI;7195614260;Ne;6;8;0;14
15912;Lokiukas;ANČIUKAI;1243077419;Ne;10;2;0;12
15913;Lokiukas;ANČIUKAI;1027917827;Taip;0;21;0;21
15914;Lokiukas;ANČIUKAI;1741109639;Ne;0;21;0;21
15915;Lokiukas;ANČIUKAI;2544400879;Ne;0;21;0;21
15916;Lokiukas;ANČIUKAI;6944809045;Ne;0;21;0;21
15917;Lokiukas;ANČIUKAI;5785049399;Ne;5;1;0;6
15918;Lokiukas;KODĖLČIUKAI;4585621105;Ne;20;0;0;20
15919;Lokiukas;KODĖLČIUKAI;8576418875;Ne;0;6;0;6
15920;Lokiukas;KODĖLČIUKAI;6869785650;Ne;7;1;0;8
15921;Lokiukas;KODĖLČIUKAI;4849031542;Ne;1;0;0;1
15922;Lokiukas;KODĖLČIUKAI;4617372387;Ne;0;1;0;1
15923;Lokiukas;KODĖLČIUKAI;5401463671;Ne;0;15;0;15
15924;Lokiukas;KODĖLČIUKAI;9798351980;Ne;0;0;2;2
15925;Lokiukas;KODĖLČIUKAI;9996442005;Ne;0;15;0;15
15926;Lokiukas;KODĖLČIUKAI;3876368364;Ne;5;0;0;5
15927;Lokiukas;KODĖLČIUKAI;7426579018;Ne;2;0;1;3
15928;Lokiukas;KODĖLČIUKAI;1724976098;Ne;7;0;0;7
15929;Lokiukas;KODĖLČIUKAI;3733581089;Ne;0;2;2;4
15930;Lokiukas;KODĖLČIUKAI;1076719080;Taip;9;1;0;10
15931;Lokiukas;KODĖLČIUKAI;9266061396;Ne;1;1;0;2
15932;Lokiukas;KODĖLČIUKAI;6987657237;Ne;2;0;0;2
15933;Lokiukas;KODĖLČIUKAI;5353687011;Taip;0;2;0;2
15934;Lokiukas;DRUGELIAI;4858829710;Ne;9;1;0;10
15935;Lokiukas;DRUGELIAI;4442073527;Ne;0;1;0;1
15936;Lokiukas;DRUGELIAI;2021477393;Ne;5;0;0;5
15937;Lokiukas;DRUGELIAI;7532603655;Ne;0;15;0;15
15938;Lokiukas;DRUGELIAI;1170293017;Ne;4;6;0;10
15939;Lokiukas;DRUGELIAI;7006828256;Ne;0;2;0;2
15940;Lokiukas;DRUGELIAI;8596706753;Ne;0;2;0;2
15941;Lokiukas;DRUGELIAI;4197547631;Ne;7;3;0;10
15942;Lokiukas;DRUGELIAI;8266708371;Ne;0;1;0;1
15943;Lokiukas;DRUGELIAI;6226281752;Ne;10;0;0;10
15944;Lokiukas;DRUGELIAI;7195184433;Ne;2;0;0;2
15945;Lokiukas;DRUGELIAI;1390586527;Ne;8;2;2;12
15946;Lokiukas;DRUGELIAI;1341265560;Ne;0;1;0;1
15947;Lokiukas;DRUGELIAI;5131662172;Ne;10;1;0;11
15948;Lokiukas;DRUGELIAI;4284574166;Ne;2;1;0;3
15949;Lokiukas;DRUGELIAI;1913742619;Ne;10;1;0;11
15950;Lokiukas;DRUGELIAI;4521556853;Ne;0;1;0;1
15951;Lokiukas;DRUGELIAI;5092095494;Ne;0;1;0;1
15952;Lokiukas;"2 A klasė";1626698185;Ne;1;0;0;1
15953;Lokiukas;"2 A klasė";39222094073;Ne;8;0;0;8
15954;Lokiukas;"2 A klasė";69364831994;Ne;5;0;0;5
15955;Lokiukas;"2 A klasė";74169282323;Ne;1;0;0;1
15956;Lokiukas;"2 A klasė";1625137322;Ne;1;0;0;1
15957;Lokiukas;"2 A klasė";8452600632;Ne;3;0;0;3
15958;Lokiukas;"2 A klasė";35890122494;Ne;1;0;0;1
15959;Lokiukas;"2 A klasė";8270572748;Ne;1;0;0;1
15960;Lokiukas;"2 A klasė";2170176922;Ne;2;0;0;2
15961;Lokiukas;"2 A klasė";8455869600;Ne;1;0;0;1
15962;Lokiukas;"2 A klasė";34800098950;Ne;1;0;0;1
15963;Lokiukas;"2 A klasė";3825101647;Ne;21;0;0;21
15964;Lokiukas;"2 A klasė";8618280811;Taip;7;0;0;7
15965;Lokiukas;"2 A klasė";8323172347;Ne;2;0;0;2
15966;Lokiukas;"2 A klasė";7844351275;Ne;1;0;0;1
15967;Lokiukas;"2 A klasė";2045735700;Ne;7;0;0;7
15968;Lokiukas;"2 A klasė";3981653153;Ne;1;0;0;1
15969;Lokiukas;"2 A klasė";6318538591;Ne;1;0;0;1
15970;Lokiukas;"2 A klasė";43500434912;Ne;3;0;0;3
15971;Lokiukas;"2 A klasė";25141529581;Ne;3;0;0;3
15972;Lokiukas;"2 A klasė";3369746590;Ne;4;0;0;4
15973;Lokiukas;"2 A klasė";3004895246;Ne;3;0;0;3
15974;Lokiukas;"2 A klasė";3061816821;Ne;1;0;0;1
15975;Lokiukas;"2 A klasė";56069293343;Ne;3;0;0;3
15976;Lokiukas;"2 A klasė";4677444685;Ne;1;0;0;1
15977;Lokiukas;"2 B klasė";14605095801;Ne;4;0;0;4
15978;Lokiukas;"2 B klasė";39975872119;Ne;2;0;0;2
15979;Lokiukas;"2 B klasė";8568285232;Ne;6;0;0;6
15980;Lokiukas;"2 B klasė";5453470660;Ne;2;0;0;2
15981;Lokiukas;"2 B klasė";5879386524;Ne;3;0;0;3
15982;Lokiukas;"2 B klasė";7591418969;Ne;4;0;0;4
15983;Lokiukas;"2 B klasė";8036643654;Ne;6;0;0;6
15984;Lokiukas;"2 B klasė";2548712970;Ne;2;0;0;2
15985;Lokiukas;"2 B klasė";4427448272;Ne;21;0;0;21
15986;Lokiukas;"2 B klasė";4580716838;Ne;7;0;0;7
15987;Lokiukas;"2 B klasė";2673522432;Ne;21;0;0;21
15988;Lokiukas;"2 B klasė";8399364170;Ne;5;0;0;5
15989;Lokiukas;"2 B klasė";9625041533;Ne;2;0;0;2
15990;Lokiukas;"2 B klasė";2476231041;Ne;4;0;0;4
15991;Lokiukas;"2 B klasė";5943583254;Ne;2;0;0;2
15992;Lokiukas;"2 B klasė";5437008837;Ne;4;0;0;4
15993;Lokiukas;"2 B klasė";4569798381;Ne;14;0;0;14
15994;Lokiukas;"2 B klasė";97284171512;Ne;2;0;0;2
15995;Lokiukas;"2 B klasė";3070998871;Ne;5;0;0;5
15996;Lokiukas;"2 B klasė";9501202273;Ne;3;0;0;3
15997;Lokiukas;"2 B klasė";20659573470;Ne;21;0;0;21
15998;Lokiukas;"2 B klasė";8943496964;Ne;10;0;0;10
15999;Lokiukas;"2 B klasė";3505492809;Ne;3;0;0;3
16000;Lokiukas;"3 A klasė";83086633109;Ne;3;0;0;3
16001;Lokiukas;"3 A klasė";131300206;Ne;2;0;0;2
16002;Lokiukas;"3 A klasė";82025637099;Ne;5;0;0;5
16003;Lokiukas;"3 A klasė";73515179103;Ne;4;0;0;4
16004;Lokiukas;"3 A klasė";73696992182;Ne;2;0;0;2
16005;Lokiukas;"3 A klasė";8240261104;Ne;2;0;0;2
16006;Lokiukas;"3 A klasė";83528495608;Ne;2;0;0;2
16007;Lokiukas;"3 A klasė";8846527481;Ne;3;0;0;3
16008;Lokiukas;"3 A klasė";67133709394;Ne;7;0;0;7
16009;Lokiukas;"3 A klasė";66528256040;Ne;2;0;0;2
16010;Lokiukas;"3 A klasė";36677665098;Ne;3;0;0;3
16011;Lokiukas;"3 A klasė";1056075876;Ne;3;0;0;3
16012;Lokiukas;"3 A klasė";52940830874;Ne;4;0;0;4
16013;Lokiukas;"3 A klasė";1201125655;Ne;3;0;0;3
16014;Lokiukas;"3 A klasė";38884246104;Ne;3;0;0;3
16015;Lokiukas;"3 A klasė";2502465398;Ne;3;0;0;3
16016;Lokiukas;"3 A klasė";9890308887;Ne;4;0;0;4
16017;Lokiukas;"3 A klasė";77512682081;Ne;2;0;0;2
16018;Lokiukas;"3 A klasė";86120193313;Ne;3;0;0;3
16019;Lokiukas;"3 A klasė";45028887854;Ne;4;0;0;4
16020;Lokiukas;"3 A klasė";51237034253;Ne;3;0;0;3
16021;Lokiukas;"3 A klasė";27403835292;Ne;2;0;0;2
16022;Lokiukas;"3 A klasė";4989577303;Ne;2;0;0;2
16023;Lokiukas;"3 A klasė";1106442860;Ne;3;0;0;3
16024;Lokiukas;"3 B klasė";61807094999;Ne;1;0;0;1
16025;Lokiukas;"3 B klasė";51059574159;Ne;21;0;0;21
16026;Lokiukas;"3 B klasė";32714964224;Ne;1;0;0;1
16027;Lokiukas;"3 B klasė";8920359311;Ne;1;0;0;1
16028;Lokiukas;"3 B klasė";2959877846;Ne;21;0;0;21
16029;Lokiukas;"3 B klasė";57505829630;Ne;1;0;0;1
16030;Lokiukas;"3 B klasė";1072148409;Ne;5;0;0;5
16031;Lokiukas;"3 B klasė";7130407913;Ne;10;0;0;10
16032;Lokiukas;"3 B klasė";7235277422;Ne;21;0;0;21
16033;Lokiukas;"3 B klasė";1133294157;Ne;1;0;0;1
16034;Lokiukas;"3 B klasė";7334971595;Ne;1;0;0;1
16035;Lokiukas;"3 B klasė";92373834478;Ne;1;0;0;1
16036;Lokiukas;"3 B klasė";2054450461;Ne;1;0;0;1
16037;Lokiukas;"3 B klasė";14234831040;Ne;2;0;0;2
16038;Lokiukas;"3 B klasė";4662981914;Ne;1;0;0;1
16039;Lokiukas;"3 B klasė";6414861823;Ne;4;0;0;4
16040;Lokiukas;"3 B klasė";98045145204;Ne;21;0;0;21
16041;Lokiukas;"3 B klasė";68390568000;Ne;3;0;0;3
16042;Lokiukas;"3 B klasė";14937983736;Ne;1;0;0;1
16043;Lokiukas;"3 B klasė";8996622650;Ne;1;0;0;1
16044;Lokiukas;"3 B klasė";2078673522;Ne;6;0;0;6
16045;Lokiukas;"3 B klasė";40006848965;Ne;1;0;0;1
16046;Lokiukas;"3 B klasė";3255141230;Ne;5;0;0;5
16047;Lokiukas;"3 B klasė";3255141230;Ne;5;0;0;5
16048;Lokiukas;"3 B klasė";8980902068;Ne;1;0;0;1
16049;Lokiukas;"3 B klasė";4164426360;Ne;1;0;0;1
16050;Lokiukas;"3 B klasė";38001876942;Ne;1;0;0;1
16051;Lokiukas;"4 A klasė";15406362908;Ne;1;0;0;1
16052;Lokiukas;"4 A klasė";45122233067;Ne;2;0;0;2
16053;Lokiukas;"4 A klasė";10948160841;Ne;21;0;0;21
16054;Lokiukas;"4 A klasė";21802863853;Ne;1;0;0;1
16055;Lokiukas;"4 A klasė";22979689191;Ne;5;0;0;5
16056;Lokiukas;"4 A klasė";80754592972;Ne;8;0;0;8
16057;Lokiukas;"4 A klasė";14903100496;Ne;1;0;0;1
16058;Lokiukas;"4 A klasė";4608275224;Ne;4;0;0;4
16059;Lokiukas;"4 A klasė";99706061553;Ne;5;0;0;5
16060;Lokiukas;"4 A klasė";7785940412;Ne;1;0;0;1
16061;Lokiukas;"4 A klasė";72092394330;Ne;1;0;0;1
16062;Lokiukas;"4 A klasė";35769782473;Ne;17;0;0;17
16063;Lokiukas;"4 A klasė";38531751377;Ne;1;0;0;1
16064;Lokiukas;"4 A klasė";59840033826;Ne;2;0;0;2
16065;Lokiukas;"4 A klasė";80793623068;Ne;4;0;0;4
16066;Lokiukas;"4 A klasė";43070670534;Ne;2;0;0;2
16067;Lokiukas;"4 A klasė";5198408183;Ne;7;0;0;7
16068;Lokiukas;"4 A klasė";24099693663;Ne;21;0;0;21
16069;Lokiukas;"4 A klasė";9747265775;Ne;21;0;0;21
16070;Lokiukas;"4 A klasė";93374754851;Ne;10;0;0;10
16071;Lokiukas;"4 A klasė";25170045140;Ne;21;0;0;21
16072;Lokiukas;"4 A klasė";84273668685;Ne;1;0;0;1
16073;Lokiukas;"4 A klasė";15685936471;Ne;1;0;0;1
16074;Lokiukas;"4 A klasė";97609897018;Ne;2;0;0;2
16075;Lokiukas;"4 A klasė";23688235312;Ne;3;0;0;3
16076;Lokiukas;"4 A klasė";15574258138;Ne;1;0;0;1
16077;Lokiukas;"4 A klasė";9077016953;Ne;1;0;0;1
16078;Lokiukas;"4 A klasė";24523198513;Ne;21;0;0;21
16079;Lokiukas;"4 A klasė";29577495646;Ne;2;0;0;2
16080;Lokiukas;"4 B klasė";32506466236;Ne;4;0;0;4
16081;Lokiukas;"4 B klasė";7324496782;Ne;12;0;0;12
16082;Lokiukas;"4 B klasė";10811780420;Ne;10;0;0;10
16083;Lokiukas;"4 B klasė";28796727185;Ne;21;0;0;21
16084;Lokiukas;"4 B klasė";88415635113;Ne;13;0;0;13
16085;Lokiukas;"4 B klasė";95910336503;Ne;8;0;0;8
16086;Lokiukas;"4 B klasė";7903535850;Ne;6;0;0;6
16087;Lokiukas;"4 B klasė";7497324442;Ne;21;0;0;21
16088;Lokiukas;"4 B klasė";96046361641;Ne;1;0;0;1
16089;Lokiukas;"4 B klasė";18646642032;Ne;1;0;0;1
16090;Lokiukas;"4 B klasė";79109699217;Ne;1;0;0;1
16091;Lokiukas;"4 B klasė";61890775725;Ne;13;0;0;13
16092;Lokiukas;"4 B klasė";24221829774;Ne;8;0;0;8
16093;Lokiukas;"4 B klasė";58513885211;Ne;6;0;0;6
16094;Lokiukas;"4 B klasė";50713289266;Ne;21;0;0;21
16095;Lokiukas;"4 B klasė";20231469825;Ne;7;0;0;7
16096;Lokiukas;"4 B klasė";1146878499;Ne;3;0;0;3
16097;Lokiukas;"4 B klasė";46587243900;Ne;2;0;0;2
16098;Lokiukas;"4 B klasė";9141446821;Ne;4;0;0;4
16099;Lokiukas;"4 B klasė";75507005694;Ne;10;0;0;10
16100;Lokiukas;"4 B klasė";73426072972;Ne;16;0;0;16
16101;Lokiukas;"4 B klasė";59913848400;Ne;9;0;0;9
16102;Lokiukas;"4 B klasė";18336619115;Ne;4;0;0;4
16103;Lokiukas;"4 B klasė";62268017779;Ne;7;0;0;7
16104;Lokiukas;"4 B klasė";2105377652;Ne;2;0;0;2
16105;Lokiukas;"4 B klasė";39867459515;Ne;13;0;0;13
16106;Lokiukas;"4 B klasė";5311341721;Ne;21;0;0;21
16107;Lokiukas;"4 B klasė";9516336072;Ne;10;0;0;10
16108;Šaltinėlis;Ančiukų;3901200729;Ne;0;0;1;1
16109;Šaltinėlis;Ančiukų;1312785137;Taip;5;2;0;7
16110;Šaltinėlis;Ančiukų;9209105445;Ne;0;5;0;5
16111;Šaltinėlis;Ančiukų;9112527921;Ne;4;1;0;5
16112;Šaltinėlis;Ančiukų;2027779524;Ne;0;1;0;1
16113;Šaltinėlis;Ančiukų;5498764523;Ne;0;1;0;1
16114;Šaltinėlis;Ančiukų;4226929875;Ne;1;1;0;2
16115;Šaltinėlis;Ančiukų;5005394548;Ne;0;6;3;9
16116;Šaltinėlis;Ančiukų;1742421427;Ne;0;5;1;6
16117;Šaltinėlis;Ančiukų;9581384663;Ne;0;3;0;3
16118;Šaltinėlis;Ančiukų;9465174636;Ne;0;10;0;10
16119;Šaltinėlis;Ančiukų;8034195267;Ne;0;2;0;2
16120;Šaltinėlis;Ančiukų;5455997139;Ne;0;12;0;12
16121;Šaltinėlis;Ančiukų;9588260206;Ne;15;1;0;16
16122;Šaltinėlis;Ančiukų;8116985061;Ne;0;19;0;19
16123;Šaltinėlis;Ančiukų;6371994202;Ne;6;3;0;9
16124;Šaltinėlis;Ančiukų;6244924079;Ne;3;2;0;5
16125;Šaltinėlis;Ančiukų;3806267811;Ne;11;0;0;11
16126;Šaltinėlis;Bitučių;7311831014;Ne;1;0;0;1
16127;Šaltinėlis;Bitučių;5854723120;Ne;0;5;0;5
16128;Šaltinėlis;Bitučių;1678450741;Ne;4;0;0;4
16129;Šaltinėlis;Bitučių;5833136956;Ne;0;2;0;2
16130;Šaltinėlis;Bitučių;3483756240;Ne;0;1;0;1
16131;Šaltinėlis;Bitučių;6380346298;Ne;2;1;0;3
16132;Šaltinėlis;Bitučių;5799032398;Ne;4;0;0;4
16133;Šaltinėlis;Bitučių;5525740049;Ne;0;1;0;1
16134;Šaltinėlis;Bitučių;5343279219;Ne;1;0;0;1
16135;Šaltinėlis;Bitučių;7118672118;Ne;7;0;0;7
16136;Šaltinėlis;Bitučių;8950694484;Ne;0;11;0;11
16137;Šaltinėlis;Bitučių;2465009553;Ne;3;0;0;3
16138;Šaltinėlis;Bitučių;5382567842;Ne;0;2;0;2
16139;Šaltinėlis;Bitučių;4681460322;Ne;0;9;0;9
16140;Šaltinėlis;Bitučių;3968514430;Ne;0;4;0;4
16141;Šaltinėlis;Bitučių;6721510313;Ne;1;0;0;1
16142;Šaltinėlis;Bitučių;1978469605;Ne;0;2;0;2
16143;Šaltinėlis;Bitučių;5774391181;Ne;2;0;0;2
16144;Šaltinėlis;Bitučių;2499890317;Ne;2;0;0;2
16145;Šaltinėlis;Bitučių;7650840990;Ne;3;0;0;3
16146;Šaltinėlis;Bitučių;5345738219;Ne;1;0;0;1
16147;Šaltinėlis;Bitučių;3579974049;Ne;0;0;4;4
16148;Šaltinėlis;Bitučių;4743907195;Ne;0;1;0;1
16149;Šaltinėlis;Bitučių;1287205292;Ne;5;0;0;5
16150;Šaltinėlis;Bitučių;7973137015;Ne;8;0;0;8
16151;Šaltinėlis;Bitučių;7519967594;Ne;15;0;0;15
16152;Šaltinėlis;Bitučių;3017437426;Ne;4;0;0;4
16153;Šaltinėlis;Bitučių;9983153464;Ne;6;0;0;6
16154;Šaltinėlis;Saulutės;3159555258;Ne;9;0;0;9
16155;Šaltinėlis;Saulutės;9753396159;Ne;3;1;0;4
16156;Šaltinėlis;Saulutės;6774300104;Ne;18;2;0;20
16157;Šaltinėlis;Saulutės;8258039377;Ne;7;0;0;7
16158;Šaltinėlis;Saulutės;2550355455;Taip;0;1;0;1
16159;Šaltinėlis;Saulutės;3448242910;Ne;4;7;0;11
16160;Šaltinėlis;Saulutės;8147526528;Ne;0;4;0;4
16161;Šaltinėlis;Saulutės;6109197821;Ne;0;8;0;8
16162;Šaltinėlis;Saulutės;8439306703;Ne;3;1;0;4
16163;Šaltinėlis;Saulutės;3505001330;Ne;0;6;0;6
16164;Šaltinėlis;Saulutės;8973369897;Ne;0;2;0;2
16165;Šaltinėlis;Saulutės;6145605567;Ne;0;4;0;4
16166;Šaltinėlis;Saulutės;3780870805;Ne;8;2;0;10
16167;Šaltinėlis;Saulutės;2157520281;Ne;5;2;0;7
16168;Šaltinėlis;Saulutės;5996579651;Ne;1;1;0;2
16169;Šaltinėlis;Saulutės;9613234759;Ne;1;0;0;1
16170;Šaltinėlis;Saulutės;9218436977;Ne;1;1;0;2
16171;Šaltinėlis;Meškiukų;6915625306;Ne;4;3;0;7
16172;Šaltinėlis;Meškiukų;6645807642;Ne;0;1;0;1
16173;Šaltinėlis;Meškiukų;4664741207;Ne;8;1;0;9
16174;Šaltinėlis;Meškiukų;1400918201;Ne;8;1;0;9
16175;Šaltinėlis;Meškiukų;1656674673;Ne;3;3;0;6
16176;Šaltinėlis;Meškiukų;4248763165;Ne;3;2;0;5
16177;Šaltinėlis;Meškiukų;5982018366;Ne;5;2;0;7
16178;Šaltinėlis;Meškiukų;9922223978;Ne;1;0;0;1
16179;Šaltinėlis;Meškiukų;8995077908;Ne;2;0;0;2
16180;Šaltinėlis;Meškiukų;6586783795;Ne;2;1;0;3
16181;Šaltinėlis;Meškiukų;4064231806;Ne;2;1;0;3
16182;Šaltinėlis;Meškiukų;6688536661;Ne;1;0;0;1
16183;Šaltinėlis;Meškiukų;8880659539;Ne;4;0;0;4
16184;Šaltinėlis;Meškiukų;3228788999;Ne;0;1;0;1
16185;Šaltinėlis;Meškiukų;5905345563;Ne;8;0;0;8
16186;Šaltinėlis;Meškiukų;4936982698;Ne;0;1;0;1
16187;Šaltinėlis;Nykštukai;9766640995;Ne;15;0;0;15
16188;Šaltinėlis;Nykštukai;3356138058;Ne;3;0;0;3
16189;Šaltinėlis;Nykštukai;5434349511;Taip;9;0;0;9
16190;Šaltinėlis;Nykštukai;4226068669;Ne;6;0;0;6
16191;Šaltinėlis;Nykštukai;2976773344;Ne;8;0;0;8
16192;Šaltinėlis;Nykštukai;3687243030;Ne;4;0;0;4
16193;Šaltinėlis;Nykštukai;9333013048;Taip;18;0;0;18
16194;Šaltinėlis;Nykštukai;4029616063;Ne;1;0;0;1
16195;Šaltinėlis;Nykštukai;7534585887;Taip;12;0;0;12
16196;Šaltinėlis;Nykštukai;8977029692;Ne;1;0;0;1
16197;Šaltinėlis;Nykštukai;7120592596;Ne;1;0;0;1
16198;Šaltinėlis;Nykštukai;3497881408;Ne;2;0;0;2
16199;Šaltinėlis;Nykštukai;6383844995;Ne;1;0;0;1
16200;Šaltinėlis;Nykštukai;1441937630;Ne;1;0;0;1
16201;Šaltinėlis;Nykštukai;4742849747;Ne;3;0;0;3
16202;Šaltinėlis;Nykštukai;5593692486;Ne;11;0;0;11
16203;Šaltinėlis;Nykštukai;1496105338;Ne;2;0;0;2
16204;Šaltinėlis;Nykštukai;7432957835;Ne;3;0;0;3
16205;Šaltinėlis;Perliukų;2825412170;Ne;2;0;0;2
16206;Šaltinėlis;Perliukų;1686009371;Ne;7;0;0;7
16207;Šaltinėlis;Perliukų;7068058767;Ne;4;0;0;4
16208;Šaltinėlis;Perliukų;2189112609;Ne;6;0;0;6
16209;Šaltinėlis;Perliukų;8914777163;Ne;0;9;0;9
16210;Šaltinėlis;Perliukų;9674923143;Ne;8;0;0;8
16211;Šaltinėlis;Perliukų;3073692882;Ne;0;16;0;16
16212;Šaltinėlis;Perliukų;5325974488;Ne;2;0;0;2
16213;Šaltinėlis;Perliukų;2022956307;Ne;8;0;0;8
16214;Šaltinėlis;Perliukų;2126751248;Ne;2;0;0;2
16215;Šaltinėlis;Perliukų;3271931810;Ne;17;0;0;17
16216;Šaltinėlis;Perliukų;1445108285;Ne;1;0;0;1
16217;Šaltinėlis;Perliukų;7133044918;Ne;10;0;0;10
16218;Šaltinėlis;Perliukų;2806453623;Ne;2;0;0;2
16219;Šaltinėlis;Perliukų;8695191968;Ne;0;5;0;5
16220;Šaltinėlis;BORUŽĖLĖS;2222188915;Ne;11;0;2;13
16221;Šaltinėlis;BORUŽĖLĖS;8289348049;Ne;21;0;0;21
16222;Šaltinėlis;BORUŽĖLĖS;1012869495;Ne;8;0;0;8
16223;Šaltinėlis;BORUŽĖLĖS;7007255432;Ne;0;2;0;2
16224;Šaltinėlis;BORUŽĖLĖS;2704220005;Ne;9;0;0;9
16225;Šaltinėlis;BORUŽĖLĖS;7074953363;Ne;9;0;0;9
16226;Šaltinėlis;BORUŽĖLĖS;1283839856;Ne;5;0;0;5
16227;Šaltinėlis;BORUŽĖLĖS;4754031495;Ne;0;1;0;1
16228;Šaltinėlis;BORUŽĖLĖS;8806353914;Ne;0;2;0;2
16229;Šaltinėlis;BORUŽĖLĖS;5943247739;Ne;18;0;0;18
16230;Šaltinėlis;BORUŽĖLĖS;9258088219;Ne;3;1;0;4
16231;Šaltinėlis;BORUŽĖLĖS;4825400376;Ne;3;2;0;5
16232;Šaltinėlis;BORUŽĖLĖS;8979939577;Ne;11;2;0;13
16233;Šaltinėlis;BORUŽĖLĖS;2053262491;Ne;12;0;0;12
16234;Šaltinėlis;BORUŽĖLĖS;6833995338;Ne;10;0;0;10
16235;Šaltinėlis;BORUŽĖLĖS;2856977335;Ne;9;0;0;9
16236;Šaltinėlis;"4B klasė";93256161233;Ne;0;3;0;3
16237;Šaltinėlis;"4B klasė";83173349544;Ne;0;3;0;3
16238;Šaltinėlis;"4B klasė";39088869084;Ne;0;5;0;5
16239;Šaltinėlis;"4B klasė";1422035829;Ne;0;4;0;4
16240;Šaltinėlis;"4B klasė";7711903999;Ne;0;10;0;10
16241;Šaltinėlis;"4B klasė";95542489944;Ne;0;3;0;3
16242;Šaltinėlis;"4B klasė";3072314714;Ne;0;7;0;7
16243;Šaltinėlis;"4B klasė";1220687492;Ne;0;3;0;3
16244;Šaltinėlis;"4B klasė";74337710550;Ne;0;3;0;3
16245;Šaltinėlis;"4B klasė";35401075864;Ne;0;3;0;3
16246;Šaltinėlis;"4B klasė";19630605543;Ne;0;3;0;3
16247;Šaltinėlis;"4B klasė";84522552145;Ne;0;3;0;3
16248;Šaltinėlis;"4B klasė";3626545396;Ne;0;3;0;3
16249;Šaltinėlis;"4B klasė";6317111400;Ne;0;3;0;3
16250;Šaltinėlis;"4B klasė";4762756751;Ne;0;3;0;3
16251;Šaltinėlis;"4B klasė";72372808270;Ne;0;3;0;3
16252;Šaltinėlis;"4B klasė";1924418657;Ne;0;4;0;4
16253;Šaltinėlis;"4B klasė";77194317310;Ne;0;6;0;6
16254;Šaltinėlis;"4B klasė";57847832778;Ne;0;4;0;4
16255;Šaltinėlis;"4B klasė";2099800744;Ne;0;8;0;8
16256;Šaltinėlis;"4B klasė";70315400705;Ne;0;4;0;4
16257;Šaltinėlis;"4B klasė";81082410620;Ne;0;3;0;3
16258;Šaltinėlis;1A;9762392403;Ne;0;2;0;2
16259;Šaltinėlis;1A;6487378225;Ne;0;3;0;3
16260;Šaltinėlis;1A;56396772538;Ne;0;21;0;21
16261;Šaltinėlis;1A;5251390843;Ne;0;2;0;2
16262;Šaltinėlis;1A;8500790262;Ne;0;2;0;2
16263;Šaltinėlis;1A;4332884673;Ne;0;2;0;2
16264;Šaltinėlis;1A;3493429067;Ne;0;2;0;2
16265;Šaltinėlis;1A;9362495172;Ne;0;2;0;2
16266;Šaltinėlis;1A;6462738640;Ne;0;2;0;2
16267;Šaltinėlis;1A;77872075694;Ne;0;2;0;2
16268;Šaltinėlis;1A;7133143923;Ne;0;2;0;2
16269;Šaltinėlis;1A;6887838949;Ne;0;21;0;21
16270;Šaltinėlis;1A;1543331408;Ne;0;2;0;2
16271;Šaltinėlis;1A;2630875135;Ne;0;4;0;4
16272;Šaltinėlis;1A;9218883174;Ne;0;2;0;2
16273;Šaltinėlis;1A;2973820849;Ne;0;2;0;2
16274;Šaltinėlis;1A;7737797979;Ne;0;2;0;2
16275;Šaltinėlis;1A;9820788524;Ne;0;2;0;2
16276;Šaltinėlis;1A;2646901307;Ne;0;2;0;2
16277;Šaltinėlis;1A;9274165569;Ne;0;2;0;2
16278;Šaltinėlis;1A;3691635011;Ne;0;2;0;2
16279;Šaltinėlis;"2A klasė";1580090516;Ne;0;2;0;2
16280;Šaltinėlis;"2A klasė";2034838765;Ne;0;3;0;3
16281;Šaltinėlis;"2A klasė";2105963102;Ne;0;2;0;2
16282;Šaltinėlis;"2A klasė";3582666579;Ne;0;9;0;9
16283;Šaltinėlis;"2A klasė";46569341613;Ne;0;2;0;2
16284;Šaltinėlis;"2A klasė";2801321116;Ne;0;2;0;2
16285;Šaltinėlis;"2A klasė";1091056386;Ne;0;2;0;2
16286;Šaltinėlis;"2A klasė";52142182972;Ne;0;21;0;21
16287;Šaltinėlis;"2A klasė";6880337593;Ne;0;5;0;5
16288;Šaltinėlis;"2A klasė";9188065549;Ne;0;2;0;2
16289;Šaltinėlis;"2A klasė";9305706589;Taip;0;2;0;2
16290;Šaltinėlis;"2A klasė";3516760367;Ne;0;2;0;2
16291;Šaltinėlis;"2A klasė";56542341895;Ne;0;2;0;2
16292;Šaltinėlis;"2A klasė";5077603802;Ne;0;8;0;8
16293;Šaltinėlis;"2A klasė";1910670134;Ne;0;7;0;7
16294;Šaltinėlis;"2A klasė";9595350871;Ne;0;2;0;2
16295;Šaltinėlis;"2A klasė";15925823621;Ne;0;2;0;2
16296;Šaltinėlis;"2A klasė";8902634958;Ne;0;2;0;2
16297;Šaltinėlis;"2A klasė";9757246434;Ne;0;9;0;9
16298;Šaltinėlis;"2A klasė";7262120071;Ne;0;2;0;2
16299;Šaltinėlis;"2A klasė";1004445904;Ne;0;2;0;2
16300;Šaltinėlis;"2B klasė";84494627465;Ne;0;3;0;3
16301;Šaltinėlis;"2B klasė";2146141461;Ne;0;2;0;2
16302;Šaltinėlis;"2B klasė";6068980312;Ne;0;2;0;2
16303;Šaltinėlis;"2B klasė";9425353041;Ne;0;3;0;3
16304;Šaltinėlis;"2B klasė";17147527171;Ne;0;8;0;8
16305;Šaltinėlis;"2B klasė";1716801722;Ne;0;2;0;2
16306;Šaltinėlis;"2B klasė";2333071711;Ne;0;5;0;5
16307;Šaltinėlis;"2B klasė";23301579810;Ne;0;2;0;2
16308;Šaltinėlis;"2B klasė";526307704;Ne;0;3;0;3
16309;Šaltinėlis;"2B klasė";1958647188;Ne;0;2;0;2
16310;Šaltinėlis;"2B klasė";1583520894;Ne;0;3;0;3
16311;Šaltinėlis;"2B klasė";11083638216;Ne;0;3;0;3
16312;Šaltinėlis;"2B klasė";1023238509;Ne;0;3;0;3
16313;Šaltinėlis;"3A klasė";32264290873;Ne;0;2;0;2
16314;Šaltinėlis;"3A klasė";1767635282;Ne;0;3;0;3
16315;Šaltinėlis;"3A klasė";1390316465;Ne;0;4;0;4
16316;Šaltinėlis;"3A klasė";5442943843;Ne;0;2;0;2
16317;Šaltinėlis;"3A klasė";6764006747;Ne;0;2;0;2
16318;Šaltinėlis;"3A klasė";1658370782;Ne;0;2;0;2
16319;Šaltinėlis;"3A klasė";10918276041;Taip;0;2;0;2
16320;Šaltinėlis;"3A klasė";66575684640;Ne;0;2;0;2
16321;Šaltinėlis;"3A klasė";13808708760;Ne;0;2;0;2
16322;Šaltinėlis;"3A klasė";1614411921;Ne;0;2;0;2
16323;Šaltinėlis;"3A klasė";79406746980;Ne;0;3;0;3
16324;Šaltinėlis;"3A klasė";3577137327;Ne;0;2;0;2
16325;Šaltinėlis;"3A klasė";1224027643;Ne;0;2;0;2
16326;Šaltinėlis;"3A klasė";48525545812;Ne;0;3;0;3
16327;Šaltinėlis;"3A klasė";3022926855;Ne;0;2;0;2
16328;Šaltinėlis;"3A klasė";1190394855;Ne;0;2;0;2
16329;Šaltinėlis;"3A klasė";40186714037;Ne;0;2;0;2
16330;Šaltinėlis;"3A klasė";1456486363;Ne;0;2;0;2
16331;Šaltinėlis;"3A klasė";32949623652;Ne;0;4;0;4
16332;Šaltinėlis;"4A klasė";14213856824;Ne;0;2;0;2
16333;Šaltinėlis;"4A klasė";80649337160;Ne;0;4;0;4
16334;Šaltinėlis;"4A klasė";92958012146;Ne;0;2;0;2
16335;Šaltinėlis;"4A klasė";84656960510;Ne;0;3;0;3
16336;Šaltinėlis;"4A klasė";83621946293;Ne;0;21;0;21
16337;Šaltinėlis;"4A klasė";67808618878;Ne;0;21;0;21
16338;Šaltinėlis;"4A klasė";1278910777;Ne;0;3;0;3
16339;Šaltinėlis;"4A klasė";9647785988;Ne;0;3;0;3
16340;Šaltinėlis;"4A klasė";82671662416;Ne;0;2;0;2
16341;Šaltinėlis;"4A klasė";54025577281;Taip;0;4;0;4
16342;Šaltinėlis;"4A klasė";488285764;Ne;0;6;0;6
16343;Šaltinėlis;"4A klasė";29482180151;Ne;0;3;0;3
16344;Šaltinėlis;"4A klasė";54753218491;Ne;0;2;0;2
16345;Šaltinėlis;"4A klasė";86029472773;Ne;0;2;0;2
16346;Šaltinėlis;"4A klasė";64821172553;Ne;0;8;0;8
16347;Šaltinėlis;"4A klasė";5744976843;Ne;0;2;0;2
16348;Šaltinėlis;"4A klasė";25459069972;Ne;0;2;0;2
16349;Šaltinėlis;"4A klasė";6669392157;Ne;0;6;0;6
16350;Šaltinėlis;"4A klasė";89358384113;Ne;0;11;0;11
16351;Šaltinėlis;"4A klasė";28956971978;Ne;0;2;0;2
16352;Šaltinėlis;"4A klasė";4050444191;Ne;0;2;0;2
16353;Šaltinėlis;"4A klasė";89093437170;Ne;0;2;0;2
16354;Šaltinėlis;"4A klasė";51872331010;Ne;0;2;0;2
16355;Šaltinėlis;1B;7723290276;Ne;0;2;0;2
16356;Šaltinėlis;1B;3660687688;Ne;0;6;0;6
16357;Šaltinėlis;1B;1348724947;Ne;0;21;0;21
16358;Šaltinėlis;1B;2230403251;Ne;0;2;0;2
16359;Šaltinėlis;1B;4387568448;Ne;0;8;0;8
16360;Šaltinėlis;1B;2658414287;Ne;0;2;0;2
16361;Šaltinėlis;1B;7918995181;Taip;0;3;0;3
16362;Šaltinėlis;1B;3638565578;Ne;0;2;0;2
16363;Šaltinėlis;1B;1367082230;Ne;0;5;0;5
16364;Šaltinėlis;1B;5869977541;Ne;0;2;0;2
16365;Šaltinėlis;1B;5099997904;Ne;0;3;0;3
16366;Šaltinėlis;1B;8721116918;Ne;0;2;0;2
16367;Šaltinėlis;1B;3609939325;Ne;0;2;0;2
16368;Šaltinėlis;1B;7211267255;Ne;0;2;0;2
16369;Šaltinėlis;1B;9108653045;Ne;0;2;0;2
16370;Šaltinėlis;1B;2084451705;Ne;0;2;0;2
16371;Šaltinėlis;1B;6816346946;Ne;0;2;0;2
16372;Šaltinėlis;1B;5495098615;Ne;0;2;0;2
16373;Šaltinėlis;1B;5495098615;Ne;0;2;0;2
16374;Gabijėlė;GANDRIUKŲ;4498088417;Ne;1;2;0;3
16375;Gabijėlė;GANDRIUKŲ;8994076883;Ne;1;0;0;1
16376;Gabijėlė;GANDRIUKŲ;7087892822;Ne;10;0;1;11
16377;Gabijėlė;GANDRIUKŲ;5057272847;Ne;2;3;1;6
16378;Gabijėlė;GANDRIUKŲ;3532989398;Ne;3;1;0;4
16379;Gabijėlė;GANDRIUKŲ;2215880644;Ne;0;2;0;2
16380;Gabijėlė;GANDRIUKŲ;3799003783;Ne;8;2;0;10
16381;Gabijėlė;GANDRIUKŲ;6004026516;Ne;0;1;0;1
16382;Gabijėlė;GANDRIUKŲ;4634029418;Ne;1;3;0;4
16383;Gabijėlė;GANDRIUKŲ;9706026832;Ne;0;3;0;3
16384;Gabijėlė;GANDRIUKŲ;2491503656;Ne;0;6;0;6
16385;Gabijėlė;GANDRIUKŲ;8904768332;Ne;0;2;0;2
16386;Gabijėlė;GANDRIUKŲ;5715645968;Ne;7;0;1;8
16387;Gabijėlė;GANDRIUKŲ;8572833698;Ne;0;1;0;1
16388;Gabijėlė;GANDRIUKŲ;5054419205;Taip;2;5;0;7
16389;Gabijėlė;GANDRIUKŲ;9929652398;Ne;2;0;0;2
16390;Gabijėlė;GANDRIUKŲ;7530976246;Ne;0;0;2;2
16391;Gabijėlė;GANDRIUKŲ;2682112101;Ne;0;1;0;1
16392;Gabijėlė;LAKŠTINGALIUKŲ;7019425859;Ne;0;0;1;1
16393;Gabijėlė;LAKŠTINGALIUKŲ;1611004144;Taip;0;2;0;2
16394;Gabijėlė;LAKŠTINGALIUKŲ;5862882027;Ne;0;0;1;1
16395;Gabijėlė;LAKŠTINGALIUKŲ;8798786098;Ne;0;0;1;1
16396;Gabijėlė;LAKŠTINGALIUKŲ;8035360208;Ne;0;2;0;2
16397;Gabijėlė;LAKŠTINGALIUKŲ;2384469423;Taip;5;0;1;6
16398;Gabijėlė;LAKŠTINGALIUKŲ;8167646385;Ne;0;0;2;2
16399;Gabijėlė;LAKŠTINGALIUKŲ;8926268619;Ne;13;0;1;14
16400;Gabijėlė;LAKŠTINGALIUKŲ;3215569531;Taip;2;8;0;10
16401;Gabijėlė;LAKŠTINGALIUKŲ;9116943443;Ne;0;1;3;4
16402;Gabijėlė;LAKŠTINGALIUKŲ;6927730664;Ne;3;0;1;4
16403;Gabijėlė;LAKŠTINGALIUKŲ;7444385669;Ne;0;0;1;1
16404;Gabijėlė;LAKŠTINGALIUKŲ;9398722388;Ne;0;1;0;1
16405;Gabijėlė;LAKŠTINGALIUKŲ;9491327802;Taip;0;0;6;6
16406;Gabijėlė;LAKŠTINGALIUKŲ;6730947751;Ne;0;0;1;1
16407;Gabijėlė;LAKŠTINGALIUKŲ;2550300871;Ne;0;2;0;2
16408;Gabijėlė;LAKŠTINGALIUKŲ;9324498850;Ne;0;6;2;8
16409;Gabijėlė;LAKŠTINGALIUKŲ;8314088016;Ne;2;6;0;8
16410;Gabijėlė;LAKŠTINGALIUKŲ;6295299651;Ne;2;6;0;8
16411;Gabijėlė;LAKŠTINGALIUKŲ;9694544564;Ne;0;0;2;2
16412;Gabijėlė;ŽVIRBLIUKŲ;7043775905;Taip;0;1;0;1
16413;Gabijėlė;ŽVIRBLIUKŲ;4475530177;Ne;4;0;1;5
16414;Gabijėlė;ŽVIRBLIUKŲ;5743861607;Ne;5;0;0;5
16415;Gabijėlė;ŽVIRBLIUKŲ;7410541320;Ne;0;0;8;8
16416;Gabijėlė;ŽVIRBLIUKŲ;4493192224;Ne;13;0;0;13
16417;Gabijėlė;ŽVIRBLIUKŲ;3268231136;Ne;0;0;5;5
16418;Gabijėlė;ŽVIRBLIUKŲ;5332825339;Taip;0;0;3;3
16419;Gabijėlė;ŽVIRBLIUKŲ;2264669298;Ne;0;10;0;10
16420;Gabijėlė;ŽVIRBLIUKŲ;5942625633;Ne;1;0;1;2
16421;Gabijėlė;ŽVIRBLIUKŲ;3155403180;Ne;0;0;7;7
16422;Gabijėlė;ŽVIRBLIUKŲ;1158461185;Ne;0;0;6;6
16423;Gabijėlė;ŽVIRBLIUKŲ;3218415151;Ne;0;0;3;3
16424;Gabijėlė;ŽVIRBLIUKŲ;8823299212;Ne;0;0;1;1
16425;Gabijėlė;ŽVIRBLIUKŲ;8879972953;Ne;0;0;6;6
16426;Gabijėlė;ŽVIRBLIUKŲ;9627906252;Taip;2;0;4;6
16427;Gabijėlė;ŽVIRBLIUKŲ;1725665169;Ne;0;0;1;1
16428;Gabijėlė;ŽVIRBLIUKŲ;4146051969;Ne;8;0;0;8
16429;Gabijėlė;ŽVIRBLIUKŲ;6604681536;Ne;1;0;0;1
16430;Gabijėlė;ŽVIRBLIUKŲ;1273722177;Taip;0;0;8;8
16431;Gabijėlė;ŽVIRBLIUKŲ;6310234092;Ne;5;0;0;5
16432;Gabijėlė;ŽVIRBLIUKŲ;6154378055;Ne;2;0;1;3
16433;Gabijėlė;ŽVIRBLIUKŲ;9259673720;Taip;1;1;0;2
16434;Gabijėlė;ŽVIRBLIUKŲ;8292463617;Ne;0;0;2;2
16435;Gabijėlė;GENIUKŲ;9215101617;Ne;2;0;0;2
16436;Gabijėlė;GENIUKŲ;4827797140;Ne;0;5;0;5
16437;Gabijėlė;GENIUKŲ;6931780900;Taip;13;0;1;14
16438;Gabijėlė;GENIUKŲ;2030555139;Ne;5;2;0;7
16439;Gabijėlė;GENIUKŲ;6923511443;Ne;10;4;0;14
16440;Gabijėlė;GENIUKŲ;8384795164;Ne;0;0;1;1
16441;Gabijėlė;GENIUKŲ;3209491491;Taip;13;0;1;14
16442;Gabijėlė;GENIUKŲ;8185042446;Ne;5;0;2;7
16443;Gabijėlė;GENIUKŲ;9413654318;Ne;1;0;0;1
16444;Gabijėlė;GENIUKŲ;4664011011;Ne;12;2;0;14
16445;Gabijėlė;GENIUKŲ;4490619514;Ne;11;0;1;12
16446;Gabijėlė;GENIUKŲ;1021920133;Taip;5;0;0;5
16447;Gabijėlė;GENIUKŲ;1345747441;Taip;5;0;1;6
16448;Gabijėlė;GENIUKŲ;6469409776;Ne;1;0;0;1
16449;Gabijėlė;GENIUKŲ;6539078572;Ne;0;5;0;5
16450;Gabijėlė;GENIUKŲ;7509112343;Taip;8;0;3;11
16451;Gabijėlė;DAGILIUKŲ;9783343968;Ne;0;5;0;5
16452;Gabijėlė;DAGILIUKŲ;4462129182;Ne;0;1;0;1
16453;Gabijėlė;DAGILIUKŲ;9503639471;Taip;0;0;2;2
16454;Gabijėlė;DAGILIUKŲ;1988597157;Ne;5;0;1;6
16455;Gabijėlė;DAGILIUKŲ;9895518740;Ne;0;0;3;3
16456;Gabijėlė;DAGILIUKŲ;9449023766;Ne;0;1;0;1
16457;Gabijėlė;DAGILIUKŲ;1286688629;Taip;0;0;2;2
16458;Gabijėlė;DAGILIUKŲ;8864190314;Ne;0;0;1;1
16459;Gabijėlė;DAGILIUKŲ;1455856766;Ne;0;0;2;2
16460;Gabijėlė;DAGILIUKŲ;6438144206;Taip;0;0;1;1
16461;Gabijėlė;DAGILIUKŲ;8662914262;Ne;0;5;0;5
16462;Gabijėlė;DAGILIUKŲ;9280283478;Ne;8;0;0;8
16463;Gabijėlė;DAGILIUKŲ;2254104149;Ne;0;1;0;1
16464;Gabijėlė;DAGILIUKŲ;2386980295;Ne;4;0;5;9
16465;Gabijėlė;DAGILIUKŲ;9581539166;Ne;6;0;2;8
16466;Gabijėlė;DAGILIUKŲ;3548399391;Ne;0;0;2;2
16467;Gabijėlė;DAGILIUKŲ;4328252445;Ne;4;0;0;4
16468;Gabijėlė;DAGILIUKŲ;9893869150;Ne;0;10;0;10
16469;Gabijėlė;PELEDŽIUKŲ;4170105224;Ne;1;2;0;3
16470;Gabijėlė;PELEDŽIUKŲ;5675574534;Taip;2;0;1;3
16471;Gabijėlė;PELEDŽIUKŲ;5163460269;Ne;0;0;1;1
16472;Gabijėlė;PELEDŽIUKŲ;9451897367;Ne;9;0;0;9
16473;Gabijėlė;PELEDŽIUKŲ;1583034900;Ne;0;0;1;1
16474;Gabijėlė;PELEDŽIUKŲ;2128428173;Ne;3;0;1;4
16475;Gabijėlė;PELEDŽIUKŲ;7028670164;Ne;0;0;9;9
16476;Gabijėlė;PELEDŽIUKŲ;5481472116;Ne;0;0;1;1
16477;Gabijėlė;PELEDŽIUKŲ;2885913045;Ne;0;0;1;1
16478;Gabijėlė;PELEDŽIUKŲ;5869580147;Ne;0;1;3;4
16479;Gabijėlė;PELEDŽIUKŲ;7096789623;Ne;0;0;1;1
16480;Gabijėlė;PELEDŽIUKŲ;4724322463;Ne;0;2;0;2
16481;Gabijėlė;PELEDŽIUKŲ;1810898809;Taip;1;0;1;2
16482;Gabijėlė;PELEDŽIUKŲ;5801792404;Ne;1;8;0;9
16483;Gabijėlė;PELEDŽIUKŲ;5579070948;Ne;0;4;0;4
16484;Gabijėlė;PELEDŽIUKŲ;8549800358;Taip;6;0;0;6
16485;Gabijėlė;PELEDŽIUKŲ;8133131896;Taip;5;0;1;6
16486;Gabijėlė;PELEDŽIUKŲ;8088806507;Ne;5;3;0;8
16487;Gabijėlė;PELEDŽIUKŲ;6728495961;Ne;3;0;0;3
16488;Gabijėlė;KREGZDŽIUKŲ;1759118326;Ne;0;8;0;8
16489;Gabijėlė;KREGZDŽIUKŲ;9533325351;Ne;0;8;0;8
16490;Gabijėlė;KREGZDŽIUKŲ;5407565441;Ne;2;0;0;2
16491;Gabijėlė;KREGZDŽIUKŲ;6845038692;Ne;0;1;0;1
16492;Gabijėlė;KREGZDŽIUKŲ;9683202312;Ne;0;0;1;1
16493;Gabijėlė;KREGZDŽIUKŲ;2357515455;Ne;5;0;3;8
16494;Gabijėlė;KREGZDŽIUKŲ;1574272380;Ne;0;10;0;10
16495;Gabijėlė;KREGZDŽIUKŲ;2634722171;Ne;0;2;0;2
16496;Gabijėlė;KREGZDŽIUKŲ;4317708029;Ne;0;5;0;5
16497;Gabijėlė;KREGZDŽIUKŲ;8555272917;Ne;0;5;0;5
16498;Gabijėlė;KREGZDŽIUKŲ;1142939183;Ne;0;2;0;2
16499;Gabijėlė;KREGZDŽIUKŲ;9676186208;Ne;0;2;0;2
16500;Gabijėlė;KREGZDŽIUKŲ;3584692524;Ne;0;1;0;1
16501;Gabijėlė;KREGZDŽIUKŲ;8613821848;Ne;5;0;0;5
16502;Gabijėlė;KREGZDŽIUKŲ;7038167942;Ne;0;10;0;10
16503;Gabijėlė;KREGZDŽIUKŲ;6570702235;Ne;9;0;0;9
16504;Gabijėlė;KREGZDŽIUKŲ;9528783892;Ne;0;5;0;5
16505;Gabijėlė;KREGZDŽIUKŲ;9358478209;Ne;0;0;1;1
16506;Gabijėlė;KREGZDŽIUKŲ;9030890792;Ne;4;0;0;4
16507;Gabijėlė;KREGZDŽIUKŲ;9116153981;Ne;8;0;0;8
16508;Gabijėlė;KREGZDŽIUKŲ;4575230225;Taip;0;16;0;16
16509;Gabijėlė;ZYLIUKŲ;7700700293;Taip;0;0;12;12
16510;Gabijėlė;ZYLIUKŲ;6759447513;Ne;0;6;0;6
16511;Gabijėlė;ZYLIUKŲ;1090635644;Ne;0;0;4;4
16512;Gabijėlė;ZYLIUKŲ;2764185879;Ne;0;0;2;2
16513;Gabijėlė;ZYLIUKŲ;7921467223;Ne;1;0;0;1
16514;Gabijėlė;ZYLIUKŲ;6562965816;Ne;0;0;1;1
16515;Gabijėlė;ZYLIUKŲ;4376486874;Ne;0;5;0;5
16516;Gabijėlė;ZYLIUKŲ;7047606048;Ne;0;0;3;3
16517;Gabijėlė;ZYLIUKŲ;6983092888;Ne;2;0;0;2
16518;Gabijėlė;ZYLIUKŲ;4907669556;Ne;0;10;0;10
16519;Gabijėlė;ZYLIUKŲ;1947898190;Ne;0;10;0;10
16520;Gabijėlė;ZYLIUKŲ;2384174631;Taip;0;0;2;2
16521;Gabijėlė;ZYLIUKŲ;5736012194;Taip;0;0;3;3
16522;Gabijėlė;ZYLIUKŲ;4712780337;Taip;0;1;1;2
16523;Gabijėlė;ZYLIUKŲ;7180444215;Ne;0;0;4;4
16524;Gabijėlė;ZYLIUKŲ;6446842432;Ne;0;0;3;3
16525;Gabijėlė;VOLUNGĖLIŲ;2099510027;Ne;3;0;1;4
16526;Gabijėlė;VOLUNGĖLIŲ;6842537434;Ne;0;2;0;2
16527;Gabijėlė;VOLUNGĖLIŲ;6956030813;Ne;5;1;0;6
16528;Gabijėlė;VOLUNGĖLIŲ;3902737481;Ne;0;1;0;1
16529;Gabijėlė;VOLUNGĖLIŲ;8733551230;Ne;0;1;3;4
16530;Gabijėlė;VOLUNGĖLIŲ;3763595874;Ne;5;1;0;6
16531;Gabijėlė;VOLUNGĖLIŲ;5360985745;Ne;2;0;0;2
16532;Gabijėlė;VOLUNGĖLIŲ;5737066080;Ne;3;1;1;5
16533;Gabijėlė;VOLUNGĖLIŲ;5972136800;Ne;0;5;0;5
16534;Gabijėlė;VOLUNGĖLIŲ;8312753333;Ne;0;1;0;1
16535;Gabijėlė;VOLUNGĖLIŲ;2523400466;Ne;0;1;0;1
16536;Gabijėlė;VOLUNGĖLIŲ;8327903800;Ne;0;1;0;1
16537;Gabijėlė;VOLUNGĖLIŲ;6960725029;Ne;5;1;0;6
16538;Gabijėlė;VOLUNGĖLIŲ;3098846537;Ne;0;1;0;1
16539;Gabijėlė;VOLUNGĖLIŲ;3995459990;Ne;0;2;0;2
16540;Gabijėlė;VOLUNGĖLIŲ;4304012457;Ne;9;0;0;9
16541;Gabijėlė;VOLUNGĖLIŲ;3324631994;Ne;6;0;0;6
16542;Gabijėlė;ANČIUKŲ;2107898976;Ne;0;10;0;10
16543;Gabijėlė;ANČIUKŲ;2831569080;Ne;5;1;0;6
16544;Gabijėlė;ANČIUKŲ;7178485867;Ne;9;0;0;9
16545;Gabijėlė;ANČIUKŲ;4000838897;Ne;3;2;0;5
16546;Gabijėlė;ANČIUKŲ;5060265729;Ne;0;17;1;18
16547;Gabijėlė;ANČIUKŲ;3972933727;Taip;0;7;1;8
16548;Gabijėlė;ANČIUKŲ;9657713903;Taip;3;1;0;4
16549;Gabijėlė;ANČIUKŲ;4278783863;Ne;3;0;0;3
16550;Gabijėlė;ANČIUKŲ;4087903129;Ne;0;1;0;1
16551;Gabijėlė;ANČIUKŲ;2398441433;Ne;0;3;0;3
16552;Gabijėlė;ANČIUKŲ;7049399327;Taip;5;6;1;12
16553;Gabijėlė;ANČIUKŲ;8611258788;Ne;5;2;0;7
16554;Gabijėlė;ANČIUKŲ;8834028360;Taip;4;0;0;4
16555;Gabijėlė;ANČIUKŲ;1002680245;Taip;10;0;0;10
16556;Gabijėlė;ANČIUKŲ;6393256426;Ne;0;10;2;12
16557;Gabijėlė;ANČIUKŲ;4692161807;Ne;4;0;1;5
16558;Gabijėlė;ANČIUKŲ;6040818549;Ne;5;0;0;5
16559;Gabijėlė;ANČIUKŲ;6481368028;Taip;10;0;0;10
16560;Gabijėlė;ANČIUKŲ;7590725504;Ne;0;6;0;6
16561;Gabijėlė;ANČIUKŲ;1230236612;Ne;5;0;1;6
16562;Gabijėlė;ANČIUKŲ;1525969706;Ne;4;0;0;4
16563;Gabijėlė;BALANDŽIUKŲ;3652632748;Ne;0;0;3;3
16564;Gabijėlė;BALANDŽIUKŲ;6795173519;Ne;6;0;1;7
16565;Gabijėlė;BALANDŽIUKŲ;6748378606;Ne;0;4;3;7
16566;Gabijėlė;BALANDŽIUKŲ;7558307454;Ne;0;2;0;2
16567;Gabijėlė;BALANDŽIUKŲ;1612957739;Ne;10;0;1;11
16568;Gabijėlė;BALANDŽIUKŲ;5310270057;Taip;5;0;2;7
16569;Gabijėlė;BALANDŽIUKŲ;8388297947;Ne;0;0;3;3
16570;Gabijėlė;BALANDŽIUKŲ;7888013969;Taip;0;0;4;4
16571;Gabijėlė;BALANDŽIUKŲ;5788152675;Ne;14;0;0;14
16572;Gabijėlė;BALANDŽIUKŲ;6296983654;Ne;0;0;1;1
16573;Gabijėlė;BALANDŽIUKŲ;2462497997;Ne;0;0;1;1
16574;Gabijėlė;BALANDŽIUKŲ;4160646449;Ne;0;5;0;5
16575;Gabijėlė;BALANDŽIUKŲ;1467864178;Ne;0;0;5;5
16576;Gabijėlė;BALANDŽIUKŲ;2185615215;Ne;0;0;1;1
16577;Gabijėlė;BALANDŽIUKŲ;4959332778;Ne;0;0;1;1
16578;Gabijėlė;BALANDŽIUKŲ;9279727778;Ne;0;0;2;2
16579;Gabijėlė;BALANDŽIUKŲ;7224216275;Taip;0;0;1;1
16580;Gabijėlė;BALANDŽIUKŲ;7447079902;Ne;9;0;1;10
16581;Gabijėlė;BALANDŽIUKŲ;2289016022;Taip;7;0;0;7
16582;Gabijėlė;BALANDŽIUKŲ;8698788528;Ne;5;0;1;6
16583;Gabijėlė;BALANDŽIUKŲ;8965185578;Ne;0;0;2;2
16584;Gabijėlė;VYTURIUKŲ;6131649116;Ne;9;0;2;11
16585;Gabijėlė;VYTURIUKŲ;8461048184;Ne;4;0;0;4
16586;Gabijėlė;VYTURIUKŲ;7894667201;Ne;2;0;1;3
16587;Gabijėlė;VYTURIUKŲ;3960795412;Ne;5;0;0;5
16588;Gabijėlė;VYTURIUKŲ;9628900843;Ne;0;7;0;7
16589;Gabijėlė;VYTURIUKŲ;5769331689;Ne;0;0;4;4
16590;Gabijėlė;VYTURIUKŲ;5652244967;Ne;4;1;2;7
16591;Gabijėlė;VYTURIUKŲ;3343196830;Ne;0;10;5;15
16592;Gabijėlė;VYTURIUKŲ;9021225516;Taip;5;0;0;5
16593;Gabijėlė;VYTURIUKŲ;1523190444;Ne;8;0;0;8
16594;Gabijėlė;VYTURIUKŲ;7295985579;Ne;0;0;8;8
16595;Gabijėlė;VYTURIUKŲ;6834871835;Ne;0;10;1;11
16596;Gabijėlė;VYTURIUKŲ;1185216449;Ne;1;10;1;12
16597;Gabijėlė;VYTURIUKŲ;6107630313;Ne;7;0;1;8
16598;Gabijėlė;VYTURIUKŲ;4248856615;Ne;0;9;0;9
16599;Gabijėlė;VYTURIUKŲ;4355537090;Ne;0;0;4;4
16600;Saulėgrąža;Bitutės;8660677159;Ne;0;0;5;5
16601;Saulėgrąža;Bitutės;9437387272;Ne;11;0;1;12
16602;Saulėgrąža;Bitutės;5940167166;Ne;5;0;1;6
16603;Saulėgrąža;Bitutės;4380287979;Ne;0;0;2;2
16604;Saulėgrąža;Bitutės;6641588877;Ne;4;0;0;4
16605;Saulėgrąža;Bitutės;8505655534;Ne;0;7;6;13
16606;Saulėgrąža;Bitutės;2809788049;Ne;8;0;1;9
16607;Saulėgrąža;Bitutės;4733063461;Ne;0;0;1;1
16608;Saulėgrąža;Bitutės;3899237871;Ne;0;1;0;1
16609;Saulėgrąža;Bitutės;1381240000;Ne;0;0;1;1
16610;Saulėgrąža;Bitutės;8766433391;Ne;0;9;4;13
16611;Saulėgrąža;Bitutės;7283302671;Ne;0;0;6;6
16612;Saulėgrąža;Bitutės;4265356484;Ne;0;0;1;1
16613;Saulėgrąža;Bitutės;2042826101;Ne;0;0;1;1
16614;Saulėgrąža;Bitutės;4471740960;Ne;0;0;1;1
16615;Saulėgrąža;Bitutės;1345079291;Ne;0;3;4;7
16616;Saulėgrąža;Bitutės;3319538368;Taip;5;0;3;8
16617;Saulėgrąža;Bitutės;7387477589;Ne;4;1;0;5
16618;Saulėgrąža;Bitutės;5221286194;Ne;3;0;5;8
16619;Saulėgrąža;Bitutės;8531862400;Ne;0;0;3;3
16620;Saulėgrąža;Bitutės;8384708422;Ne;0;0;1;1
16621;Saulėgrąža;Bitutės;9481319116;Ne;0;0;1;1
16622;Saulėgrąža;Žiogeliai;7400016718;Ne;0;9;4;13
16623;Saulėgrąža;Žiogeliai;8518372931;Ne;0;1;1;2
16624;Saulėgrąža;Žiogeliai;3540590993;Ne;9;0;0;9
16625;Saulėgrąža;Žiogeliai;7881751334;Ne;0;4;0;4
16626;Saulėgrąža;Žiogeliai;5360973768;Ne;1;0;2;3
16627;Saulėgrąža;Žiogeliai;7329004031;Taip;2;0;1;3
16628;"Pilaitukas (I. Kanto al. 7A)";BITUTĖS;7011500012;Ne;5;0;1;6
16629;"Pilaitukas (I. Kanto al. 7A)";BITUTĖS;8943142551;Ne;4;0;0;4
16630;"Pilaitukas (I. Kanto al. 7A)";BITUTĖS;6225968272;Ne;4;0;0;4
16631;"Pilaitukas (I. Kanto al. 7A)";BITUTĖS;2892275540;Ne;0;1;0;1
16632;"Pilaitukas (I. Kanto al. 7A)";BITUTĖS;5904710385;Ne;5;0;0;5
16633;"Pilaitukas (I. Kanto al. 7A)";BITUTĖS;1486895496;Ne;5;0;0;5
16634;"Pilaitukas (I. Kanto al. 7A)";BITUTĖS;1746050808;Ne;11;0;1;12
16635;"Pilaitukas (I. Kanto al. 7A)";BITUTĖS;7555601497;Ne;0;0;1;1
16636;"Pilaitukas (I. Kanto al. 7A)";BITUTĖS;5979852431;Ne;11;0;1;12
16637;"Pilaitukas (I. Kanto al. 7A)";BITUTĖS;9950619644;Ne;0;0;1;1
16638;"Pilaitukas (I. Kanto al. 7A)";BITUTĖS;2633256935;Ne;8;0;1;9
16639;"Pilaitukas (I. Kanto al. 7A)";BITUTĖS;8747053041;Ne;9;0;1;10
16640;"Pilaitukas (I. Kanto al. 7A)";BITUTĖS;6271751691;Ne;6;9;0;15
16641;"Pilaitukas (I. Kanto al. 7A)";BITUTĖS;9306169443;Ne;0;1;0;1
16642;"Pilaitukas (I. Kanto al. 7A)";BITUTĖS;1568651642;Ne;10;0;0;10
16643;"Pilaitukas (I. Kanto al. 7A)";BITUTĖS;5155899628;Ne;5;1;0;6
16644;"Pilaitukas (I. Kanto al. 7A)";BITUTĖS;5340877261;Ne;5;1;0;6
16645;"Pilaitukas (I. Kanto al. 7A)";BITUTĖS;6064545501;Ne;6;1;0;7
16646;"Pilaitukas (I. Kanto al. 7A)";BITUTĖS;1040103641;Ne;1;0;0;1
16647;"Pilaitukas (I. Kanto al. 7A)";ZUIKUČIAI;4118652467;Ne;3;0;0;3
16648;"Pilaitukas (I. Kanto al. 7A)";ZUIKUČIAI;1841240800;Ne;5;1;0;6
16649;"Pilaitukas (I. Kanto al. 7A)";ZUIKUČIAI;4710865219;Ne;5;1;0;6
16650;"Pilaitukas (I. Kanto al. 7A)";ZUIKUČIAI;6054821801;Ne;0;3;0;3
16651;"Pilaitukas (I. Kanto al. 7A)";ZUIKUČIAI;5691854235;Ne;4;0;0;4
16652;"Pilaitukas (I. Kanto al. 7A)";ZUIKUČIAI;3952708917;Ne;2;0;0;2
16653;"Pilaitukas (I. Kanto al. 7A)";ZUIKUČIAI;6337917448;Ne;6;0;0;6
16654;"Pilaitukas (I. Kanto al. 7A)";ZUIKUČIAI;3636976107;Ne;6;0;0;6
16655;"Pilaitukas (I. Kanto al. 7A)";ZUIKUČIAI;5026344198;Ne;9;0;0;9
16656;"Pilaitukas (I. Kanto al. 7A)";ZUIKUČIAI;8207648026;Ne;19;0;0;19
16657;"Pilaitukas (I. Kanto al. 7A)";ZUIKUČIAI;3921932673;Ne;19;0;0;19
16658;"Pilaitukas (I. Kanto al. 7A)";ZUIKUČIAI;5682244165;Ne;6;0;0;6
16659;"Pilaitukas (I. Kanto al. 7A)";ZUIKUČIAI;1290017967;Ne;6;3;0;9
16660;"Pilaitukas (I. Kanto al. 7A)";ZUIKUČIAI;5564784922;Ne;0;2;1;3
16661;"Pilaitukas (I. Kanto al. 7A)";ZUIKUČIAI;9327651233;Ne;0;7;0;7
16662;"Pilaitukas (I. Kanto al. 7A)";ZUIKUČIAI;6238537739;Ne;6;0;0;6
16663;"Pilaitukas (I. Kanto al. 7A)";ANČIUKAI;7773318230;Ne;8;0;0;8
16664;"Pilaitukas (I. Kanto al. 7A)";ANČIUKAI;8620858011;Ne;5;5;0;10
16665;"Pilaitukas (I. Kanto al. 7A)";ANČIUKAI;3761827714;Ne;2;0;0;2
16666;"Pilaitukas (I. Kanto al. 7A)";ANČIUKAI;8643066116;Ne;2;0;0;2
16667;"Pilaitukas (I. Kanto al. 7A)";ANČIUKAI;6888607864;Ne;4;0;0;4
16668;"Pilaitukas (I. Kanto al. 7A)";ANČIUKAI;7876850509;Ne;3;1;0;4
16669;"Pilaitukas (I. Kanto al. 7A)";ANČIUKAI;3035456834;Ne;5;0;0;5
16670;"Pilaitukas (I. Kanto al. 7A)";ANČIUKAI;2476942319;Ne;4;0;0;4
16671;"Pilaitukas (I. Kanto al. 7A)";ANČIUKAI;8033540052;Ne;3;6;0;9
16672;"Pilaitukas (I. Kanto al. 7A)";ANČIUKAI;1781762820;Ne;1;0;0;1
16673;"Pilaitukas (I. Kanto al. 7A)";ANČIUKAI;9332831979;Ne;4;0;0;4
16674;"Pilaitukas (I. Kanto al. 7A)";ANČIUKAI;5706918634;Taip;16;0;0;16
16675;"Pilaitukas (I. Kanto al. 7A)";ANČIUKAI;8954370321;Ne;0;0;2;2
16676;"Pilaitukas (I. Kanto al. 7A)";ANČIUKAI;1660462256;Ne;4;3;0;7
16677;"Pilaitukas (I. Kanto al. 7A)";MEŠKIUKAI;8577357264;Ne;0;12;0;12
16678;"Pilaitukas (I. Kanto al. 7A)";MEŠKIUKAI;8268790017;Ne;2;0;0;2
16679;"Pilaitukas (I. Kanto al. 7A)";MEŠKIUKAI;9742268665;Ne;6;0;0;6
16680;"Pilaitukas (I. Kanto al. 7A)";MEŠKIUKAI;8322980583;Ne;16;0;0;16
16681;"Pilaitukas (I. Kanto al. 7A)";MEŠKIUKAI;9670329628;Ne;0;3;0;3
16682;"Pilaitukas (I. Kanto al. 7A)";MEŠKIUKAI;9187961584;Ne;3;0;0;3
16683;"Pilaitukas (I. Kanto al. 7A)";MEŠKIUKAI;6807166920;Ne;1;0;0;1
16684;"Pilaitukas (I. Kanto al. 7A)";MEŠKIUKAI;1591276987;Ne;0;10;0;10
16685;"Pilaitukas (I. Kanto al. 7A)";MEŠKIUKAI;9930306085;Ne;17;0;0;17
16686;"Pilaitukas (I. Kanto al. 7A)";ŽUVYTĖS;2317213283;Ne;4;0;0;4
16687;"Pilaitukas (I. Kanto al. 7A)";ŽUVYTĖS;4353195155;Ne;0;9;0;9
16688;"Pilaitukas (I. Kanto al. 7A)";ŽUVYTĖS;8913709682;Ne;0;3;0;3
16689;"Pilaitukas (I. Kanto al. 7A)";ŽUVYTĖS;8207194955;Ne;2;0;0;2
16690;"Pilaitukas (I. Kanto al. 7A)";ŽUVYTĖS;5640802570;Ne;1;11;0;12
16691;"Pilaitukas (I. Kanto al. 7A)";ŽUVYTĖS;9260893320;Ne;0;1;0;1
16692;"Pilaitukas (I. Kanto al. 7A)";ŽUVYTĖS;5710747769;Ne;0;1;0;1
16693;"Pilaitukas (I. Kanto al. 7A)";ŽUVYTĖS;5206637809;Ne;0;2;0;2
16694;"Pilaitukas (I. Kanto al. 7A)";ŽUVYTĖS;5288784331;Ne;0;0;1;1
16695;"Pilaitukas (I. Kanto al. 7A)";ŽUVYTĖS;9688421636;Ne;0;0;1;1
16696;"Pilaitukas (I. Kanto al. 7A)";ŽUVYTĖS;1704055907;Ne;0;0;5;5
16697;"Pilaitukas (I. Kanto al. 7A)";ŽUVYTĖS;8255398803;Ne;4;0;0;4
16698;"Pilaitukas (I. Kanto al. 7A)";ŽUVYTĖS;6426415533;Ne;2;0;0;2
16699;"Pilaitukas (I. Kanto al. 7A)";ŽUVYTĖS;1607454890;Taip;0;0;2;2
16700;"Pilaitukas (I. Kanto al. 7A)";PAUKŠTELIAI;1295215465;Ne;0;2;0;2
16701;"Pilaitukas (I. Kanto al. 7A)";PAUKŠTELIAI;7082099968;Ne;0;7;0;7
16702;"Pilaitukas (I. Kanto al. 7A)";PAUKŠTELIAI;1253300093;Ne;0;1;0;1
16703;"Pilaitukas (I. Kanto al. 7A)";PAUKŠTELIAI;3037850837;Ne;0;1;0;1
16704;"Pilaitukas (I. Kanto al. 7A)";PAUKŠTELIAI;1729494874;Ne;4;7;0;11
16705;"Pilaitukas (I. Kanto al. 7A)";PAUKŠTELIAI;4082490488;Ne;6;1;0;7
16706;"Pilaitukas (I. Kanto al. 7A)";PAUKŠTELIAI;3913169122;Ne;0;1;0;1
16707;"Pilaitukas (I. Kanto al. 7A)";PAUKŠTELIAI;5740951665;Ne;4;4;0;8
16708;"Pilaitukas (I. Kanto al. 7A)";PAUKŠTELIAI;4591799893;Ne;2;0;0;2
16709;"Pilaitukas (I. Kanto al. 7A)";PAUKŠTELIAI;6308557885;Ne;2;0;0;2
16710;"Pilaitukas (I. Kanto al. 7A)";PAUKŠTELIAI;6514731102;Ne;2;0;0;2
16711;"Pilaitukas (I. Kanto al. 7A)";PAUKŠTELIAI;5331915157;Taip;0;1;0;1
16712;"Pilaitukas (I. Kanto al. 7A)";PAUKŠTELIAI;8169484415;Ne;0;10;0;10
16713;"Pilaitukas (I. Kanto al. 7A)";PAUKŠTELIAI;3159733673;Ne;7;1;0;8
16714;"Pilaitukas (I. Kanto al. 7A)";BORUŽĖLĖS;9898379569;Ne;0;0;3;3
16715;"Pilaitukas (I. Kanto al. 7A)";BORUŽĖLĖS;5185051301;Ne;7;0;0;7
16716;"Pilaitukas (I. Kanto al. 7A)";BORUŽĖLĖS;1731106179;Ne;0;9;0;9
16717;"Pilaitukas (I. Kanto al. 7A)";BORUŽĖLĖS;3784944532;Ne;0;0;20;20
16718;"Pilaitukas (I. Kanto al. 7A)";BORUŽĖLĖS;5186675623;Ne;3;0;0;3
16719;"Pilaitukas (I. Kanto al. 7A)";BORUŽĖLĖS;4589130143;Ne;5;0;1;6
16720;"Pilaitukas (I. Kanto al. 7A)";BORUŽĖLĖS;1944443723;Taip;5;0;0;5
16721;"Pilaitukas (I. Kanto al. 7A)";BORUŽĖLĖS;8380819975;Ne;16;0;0;16
16722;"Pilaitukas (I. Kanto al. 7A)";BORUŽĖLĖS;3849247594;Ne;8;0;0;8
16723;"Pilaitukas (I. Kanto al. 7A)";BORUŽĖLĖS;5201301769;Ne;5;0;2;7
16724;"Pilaitukas (I. Kanto al. 7A)";BORUŽĖLĖS;5066594124;Ne;3;0;0;3
16725;"Pilaitukas (I. Kanto al. 7A)";BORUŽĖLĖS;2336933998;Ne;4;0;0;4
16726;"Pilaitukas (I. Kanto al. 7A)";BORUŽĖLĖS;8047683859;Ne;14;0;1;15
16727;"Pilaitukas (I. Kanto al. 7A)";BORUŽĖLĖS;8694369154;Ne;14;0;1;15
16728;"Pilaitukas (I. Kanto al. 7A)";BORUŽĖLĖS;9587140991;Ne;12;0;1;13
16729;"Pilaitukas (I. Kanto al. 7A)";BORUŽĖLĖS;9405479859;Ne;4;0;0;4
16730;"Pilaitukas (I. Kanto al. 7A)";DRUGELIAI;2917197418;Ne;7;0;0;7
16731;"Pilaitukas (I. Kanto al. 7A)";DRUGELIAI;6280870972;Ne;7;0;2;9
16732;"Pilaitukas (I. Kanto al. 7A)";DRUGELIAI;9741985709;Ne;10;0;2;12
16733;"Pilaitukas (I. Kanto al. 7A)";DRUGELIAI;7807341574;Ne;6;0;2;8
16734;"Pilaitukas (I. Kanto al. 7A)";DRUGELIAI;5215800828;Ne;0;4;0;4
16735;"Pilaitukas (I. Kanto al. 7A)";DRUGELIAI;2414941263;Ne;0;10;3;13
16736;"Pilaitukas (I. Kanto al. 7A)";DRUGELIAI;7830059468;Ne;1;0;2;3
16737;"Pilaitukas (I. Kanto al. 7A)";DRUGELIAI;8710069256;Ne;7;0;0;7
16738;"Pilaitukas (I. Kanto al. 7A)";DRUGELIAI;3609692114;Ne;9;0;0;9
16739;"Pilaitukas (I. Kanto al. 7A)";DRUGELIAI;9601295632;Ne;6;0;0;6
16740;"Pilaitukas (I. Kanto al. 7A)";DRUGELIAI;2768655540;Ne;0;0;1;1
16741;"Pilaitukas (I. Kanto al. 7A)";DRUGELIAI;1052452915;Ne;13;0;0;13
16742;"Pilaitukas (I. Kanto al. 7A)";DRUGELIAI;7478616628;Ne;0;12;2;14
16743;"Pilaitukas (I. Kanto al. 7A)";DRUGELIAI;1134083816;Ne;12;0;2;14
16744;"Pilaitukas (I. Kanto al. 7A)";PELIUKAI;9246925227;Taip;18;0;0;18
16745;"Pilaitukas (I. Kanto al. 7A)";PELIUKAI;8501376663;Ne;0;4;0;4
16746;"Pilaitukas (I. Kanto al. 7A)";PELIUKAI;5421602723;Ne;0;2;0;2
16747;"Pilaitukas (I. Kanto al. 7A)";PELIUKAI;6754825353;Ne;0;4;0;4
16748;"Pilaitukas (I. Kanto al. 7A)";PELIUKAI;8168228529;Ne;0;1;0;1
16749;"Pilaitukas (I. Kanto al. 7A)";PELIUKAI;6833933586;Ne;3;5;0;8
16750;"Pilaitukas (I. Kanto al. 7A)";PELIUKAI;1270365948;Ne;4;1;0;5
16751;"Pilaitukas (I. Kanto al. 7A)";PELIUKAI;7604004800;Taip;5;5;0;10
16752;"Pilaitukas (I. Kanto al. 7A)";PELIUKAI;3954210452;Ne;0;3;0;3
16753;"Pilaitukas (I. Kanto al. 7A)";PELIUKAI;3651140874;Ne;0;0;1;1
16754;"Pilaitukas (I. Kanto al. 7A)";PELIUKAI;2823859128;Ne;0;0;1;1
16755;"Pilaitukas (I. Kanto al. 7A)";PELIUKAI;7750936973;Ne;8;0;0;8
16756;"Pilaitukas (I. Kanto al. 7A)";PELIUKAI;6185954940;Ne;0;1;0;1
16757;"Pilaitukas (I. Kanto al. 7A)";PELIUKAI;1781241002;Ne;3;0;0;3
16758;"Pilaitukas (I. Kanto al. 7A)";KAČIUKAI;3080014745;Ne;5;4;0;9
16759;"Pilaitukas (I. Kanto al. 7A)";KAČIUKAI;8009040109;Ne;2;0;0;2
16760;"Pilaitukas (I. Kanto al. 7A)";KAČIUKAI;2105380328;Ne;3;0;0;3
16761;"Pilaitukas (I. Kanto al. 7A)";KAČIUKAI;5326689274;Ne;1;6;1;8
16762;"Pilaitukas (I. Kanto al. 7A)";KAČIUKAI;9653647227;Ne;1;6;1;8
16763;"Pilaitukas (I. Kanto al. 7A)";KAČIUKAI;4022543517;Ne;0;2;0;2
16764;"Pilaitukas (I. Kanto al. 7A)";KAČIUKAI;3825942473;Ne;0;9;0;9
16765;"Pilaitukas (I. Kanto al. 7A)";KAČIUKAI;1611371690;Ne;16;0;0;16
16766;"Pilaitukas (I. Kanto al. 7A)";KAČIUKAI;9247501721;Ne;0;0;3;3
16767;"Pilaitukas (I. Kanto al. 7A)";KAČIUKAI;9974310580;Ne;4;0;0;4
16768;"Pilaitukas (I. Kanto al. 7A)";KAČIUKAI;6235375235;Ne;1;0;0;1
16769;"Pilaitukas (I. Kanto al. 7A)";KAČIUKAI;9914575692;Ne;1;0;0;1
16770;"Pilaitukas (I. Kanto al. 7A)";SAULUTĖS;2110996493;Ne;0;2;1;3
16771;"Pilaitukas (I. Kanto al. 7A)";SAULUTĖS;8306015313;Ne;0;8;0;8
16772;"Pilaitukas (I. Kanto al. 7A)";SAULUTĖS;8801358120;Ne;0;0;1;1
16773;"Pilaitukas (I. Kanto al. 7A)";SAULUTĖS;3927713632;Ne;7;0;1;8
16774;"Pilaitukas (I. Kanto al. 7A)";SAULUTĖS;1970389617;Ne;2;0;1;3
16775;"Pilaitukas (I. Kanto al. 7A)";SAULUTĖS;1351676866;Ne;0;0;2;2
16776;"Pilaitukas (I. Kanto al. 7A)";SAULUTĖS;4947536980;Ne;5;0;0;5
16777;"Pilaitukas (I. Kanto al. 7A)";SAULUTĖS;8586082743;Ne;2;0;0;2
16778;"Pilaitukas (I. Kanto al. 7A)";SAULUTĖS;8693322790;Ne;5;0;2;7
16779;"Pilaitukas (I. Kanto al. 7A)";MENULIUKAI;1620231835;Ne;3;0;0;3
16780;"Pilaitukas (I. Kanto al. 7A)";MENULIUKAI;8873155277;Ne;7;0;0;7
16781;"Pilaitukas (I. Kanto al. 7A)";MENULIUKAI;1532252453;Ne;5;2;0;7
16782;"Pilaitukas (I. Kanto al. 7A)";MENULIUKAI;8225571149;Ne;7;1;0;8
16783;"Pilaitukas (I. Kanto al. 7A)";MENULIUKAI;7855892595;Ne;10;0;0;10
16784;"Pilaitukas (I. Kanto al. 7A)";MENULIUKAI;8058057477;Ne;11;0;0;11
16785;"Pilaitukas (I. Kanto al. 7A)";MENULIUKAI;7369920743;Ne;2;0;0;2
16786;"Pilaitukas (I. Kanto al. 7A)";MENULIUKAI;9106756175;Ne;1;0;0;1
16787;"Pilaitukas (I. Kanto al. 7A)";MENULIUKAI;5213352941;Ne;10;0;0;10
16788;"Pilaitukas (I. Kanto al. 7A)";MENULIUKAI;4811066607;Ne;0;0;1;1
16789;"Pilaitukas (I. Kanto al. 7A)";MENULIUKAI;3258857371;Ne;0;0;1;1
16790;"Pilaitukas (I. Kanto al. 7A)";MENULIUKAI;1025359287;Ne;0;0;1;1
16791;"Pilaitukas (I. Kanto al. 7A)";MENULIUKAI;4917076546;Ne;2;0;1;3
16792;"Pilaitukas (I. Kanto al. 7A)";MENULIUKAI;9800474455;Taip;0;4;0;4
16793;"Pilaitukas (I. Kanto al. 7A)";MENULIUKAI;2215317686;Ne;0;10;0;10
16794;"Pilaitukas (I. Kanto al. 7A)";ĖŽIUKAI;6019760696;Ne;0;2;0;2
16795;"Pilaitukas (I. Kanto al. 7A)";ĖŽIUKAI;3283178614;Ne;0;2;0;2
16796;"Pilaitukas (I. Kanto al. 7A)";ĖŽIUKAI;4577941964;Ne;4;0;0;4
16797;"Pilaitukas (I. Kanto al. 7A)";ĖŽIUKAI;9099718179;Ne;0;0;1;1
16798;"Pilaitukas (I. Kanto al. 7A)";ĖŽIUKAI;8312146534;Ne;4;4;0;8
16799;"Pilaitukas (I. Kanto al. 7A)";ĖŽIUKAI;3437303302;Ne;2;0;0;2
16800;"Pilaitukas (I. Kanto al. 7A)";ĖŽIUKAI;1955352672;Ne;2;0;0;2
16801;"Pilaitukas (I. Kanto al. 7A)";ĖŽIUKAI;2982393064;Ne;0;0;3;3
16802;"Pilaitukas (I. Kanto al. 7A)";ĖŽIUKAI;2717071397;Ne;0;0;6;6
16803;Švelnukas;Pelėdžiukai;8016531082;Ne;5;0;0;5
16804;Švelnukas;Pelėdžiukai;8219071968;Ne;2;0;0;2
16805;Švelnukas;Pelėdžiukai;9008722163;Ne;8;0;0;8
16806;Švelnukas;Pelėdžiukai;5699300764;Ne;6;0;0;6
16807;Švelnukas;Pelėdžiukai;1116279011;Ne;1;0;0;1
16808;Švelnukas;Pelėdžiukai;3892058023;Ne;1;0;0;1
16809;Švelnukas;Pelėdžiukai;8589226595;Ne;3;0;1;4
16810;Švelnukas;Pelėdžiukai;3804532959;Ne;0;1;0;1
16811;Švelnukas;Pelėdžiukai;1409803554;Ne;0;3;0;3
16812;Švelnukas;Pelėdžiukai;1991507109;Ne;5;6;0;11
16813;Švelnukas;Pelėdžiukai;9808833734;Ne;13;0;1;14
16814;Švelnukas;Pelėdžiukai;6069027553;Ne;3;0;0;3
16815;Švelnukas;Pelėdžiukai;9814032171;Ne;2;0;0;2
16816;Švelnukas;Pelėdžiukai;7489142128;Ne;1;0;0;1
16817;Švelnukas;Ežiukai;4711482287;Ne;0;1;0;1
16818;Švelnukas;Ežiukai;2892176166;Ne;0;0;2;2
16819;Švelnukas;Ežiukai;2400781175;Ne;0;0;1;1
16820;Švelnukas;Ežiukai;6209334207;Ne;0;0;1;1
16821;Švelnukas;Ežiukai;1201550386;Ne;0;0;1;1
16822;Švelnukas;Ežiukai;2348752207;Taip;0;21;0;21
16823;Švelnukas;Ežiukai;3645855145;Ne;10;0;0;10
16824;Švelnukas;Ežiukai;9402567487;Ne;11;0;0;11
16825;Švelnukas;Ežiukai;8569985034;Ne;0;0;2;2
16826;Švelnukas;Ežiukai;3235768013;Taip;6;1;1;8
16827;Švelnukas;Ežiukai;3832011837;Ne;5;0;0;5
16828;Švelnukas;Ežiukai;9829912750;Ne;0;0;1;1
16829;Švelnukas;Ežiukai;9394816723;Ne;6;0;0;6
16830;Švelnukas;Ežiukai;6658530716;Ne;5;8;0;13
16831;Švelnukas;Ežiukai;6004580752;Ne;0;0;2;2
16832;Švelnukas;Ežiukai;4035050422;Ne;3;0;0;3
16833;Švelnukas;Ežiukai;4048599050;Ne;3;0;0;3
16834;Švelnukas;Ežiukai;9712567632;Ne;0;1;0;1
16835;Švelnukas;Ežiukai;2106591525;Ne;0;0;1;1
16836;Švelnukas;Švelnukai;4681584014;Ne;7;0;1;8
16837;Švelnukas;Švelnukai;6607578153;Ne;3;0;0;3
16838;Švelnukas;Švelnukai;8847738918;Ne;0;1;0;1
16839;Švelnukas;Švelnukai;1982267458;Ne;0;0;1;1
16840;Švelnukas;Švelnukai;9766734938;Ne;0;2;0;2
16841;Švelnukas;Švelnukai;3020524039;Ne;0;0;2;2
16842;Švelnukas;Švelnukai;1411710913;Ne;0;0;1;1
16843;Švelnukas;Švelnukai;2464467471;Ne;6;0;0;6
16844;Švelnukas;Švelnukai;5032829856;Ne;0;0;1;1
16845;Švelnukas;Švelnukai;5213589179;Ne;0;8;0;8
16846;Švelnukas;Švelnukai;1963518457;Ne;5;0;1;6
16847;Švelnukas;Švelnukai;4194249709;Ne;0;0;5;5
16848;Švelnukas;Švelnukai;5936821902;Ne;0;0;2;2
16849;Švelnukas;Švelnukai;4629757899;Taip;0;2;0;2
16850;Švelnukas;Švelnukai;8951810066;Ne;1;0;0;1
16851;Švelnukas;Švelnukai;6204286255;Ne;0;10;1;11
16852;Švelnukas;Švelnukai;5960966542;Ne;1;1;0;2
16853;Švelnukas;Boružiukai;1951447127;Ne;0;0;8;8
16854;Švelnukas;Boružiukai;3849957906;Taip;0;0;2;2
16855;Švelnukas;Boružiukai;5550841477;Ne;0;0;1;1
16856;Švelnukas;Boružiukai;1264256177;Ne;0;1;0;1
16857;Švelnukas;Boružiukai;8787505507;Ne;0;1;0;1
16858;Švelnukas;Boružiukai;4134678301;Ne;0;0;1;1
16859;Švelnukas;Boružiukai;8458233793;Ne;0;5;0;5
16860;Švelnukas;Boružiukai;4990399144;Ne;0;5;0;5
16861;Švelnukas;Boružiukai;9575767514;Ne;4;0;5;9
16862;Švelnukas;Boružiukai;6282137936;Ne;0;6;0;6
16863;Švelnukas;Boružiukai;9479536507;Ne;2;0;0;2
16864;Švelnukas;Boružiukai;2077614498;Ne;0;0;1;1
16865;Švelnukas;Boružiukai;4404904322;Ne;0;0;2;2
16866;Švelnukas;Boružiukai;3561920685;Ne;0;0;2;2
16867;Švelnukas;Boružiukai;4961854528;Ne;0;0;1;1
16868;Švelnukas;Smalsučiai;5554625346;Ne;0;1;0;1
16869;Švelnukas;Smalsučiai;3282020958;Ne;0;1;0;1
16870;Švelnukas;Smalsučiai;2730288544;Ne;0;0;1;1
16871;Švelnukas;Smalsučiai;8193690277;Ne;1;1;0;2
16872;Švelnukas;Smalsučiai;3472774028;Ne;7;0;0;7
16873;Švelnukas;Smalsučiai;6764222588;Ne;0;0;14;14
16874;Švelnukas;Smalsučiai;1840752560;Ne;0;1;0;1
16875;Švelnukas;Smalsučiai;8268391509;Taip;0;0;1;1
16876;Švelnukas;Smalsučiai;4467095100;Ne;0;10;1;11
16877;Švelnukas;Smalsučiai;7125883267;Ne;2;0;6;8
16878;Švelnukas;Smalsučiai;8210720087;Ne;0;0;2;2
16879;Švelnukas;Smalsučiai;1836913588;Ne;3;0;0;3
16880;Švelnukas;Smalsučiai;6155098464;Ne;0;0;5;5
16881;Švelnukas;Smalsučiai;1100719254;Ne;0;0;2;2
16882;Švelnukas;Smalsučiai;8829819783;Ne;9;0;4;13
16883;Švelnukas;Nykštukai;1058623863;Ne;1;0;0;1
16884;Švelnukas;Nykštukai;7987715134;Ne;0;0;1;1
16885;Švelnukas;Nykštukai;3455801077;Ne;0;0;8;8
16886;Švelnukas;Nykštukai;9371102717;Ne;0;21;0;21
16887;Švelnukas;Nykštukai;3576731010;Ne;8;0;0;8
16888;Švelnukas;Nykštukai;6714948468;Ne;2;0;1;3
16889;Švelnukas;Nykštukai;5969852813;Ne;5;6;0;11
16890;Švelnukas;Nykštukai;5483481191;Taip;12;0;0;12
16891;Švelnukas;Nykštukai;5097880045;Ne;0;1;6;7
16892;Švelnukas;Nykštukai;8572664468;Ne;0;0;2;2
16893;Švelnukas;Nykštukai;1983560609;Ne;4;0;1;5
16894;Švelnukas;Nykštukai;6135073159;Ne;10;0;1;11
16895;Švelnukas;Nykštukai;6731324414;Ne;0;1;0;1
16896;Švelnukas;Nykštukai;5066121542;Taip;3;0;2;5
16897;Švelnukas;Nykštukai;3173070733;Ne;0;2;0;2
16898;Boružėlė;"Nykštukai gudručiai";7736917485;Ne;0;21;0;21
16899;Boružėlė;"Nykštukai gudručiai";9520696660;Taip;0;10;0;10
16900;Boružėlė;"Nykštukai gudručiai";9193273478;Ne;0;1;1;2
16901;Boružėlė;"Nykštukai gudručiai";8359957290;Ne;6;2;0;8
16902;Boružėlė;"Nykštukai gudručiai";8141240094;Ne;0;2;9;11
16903;Boružėlė;"Nykštukai gudručiai";1894170218;Taip;3;1;0;4
16904;Boružėlė;"Nykštukai gudručiai";3509512899;Ne;0;2;1;3
16905;Boružėlė;"Nykštukai gudručiai";8888151470;Ne;0;2;1;3
16906;Boružėlė;"Nykštukai gudručiai";3430953692;Ne;0;15;0;15
16907;Boružėlė;"Nykštukai gudručiai";8365962523;Ne;0;1;2;3
16908;Boružėlė;"Nykštukai gudručiai";3592853535;Ne;0;1;0;1
16909;Boružėlė;"Nykštukai gudručiai";6876323023;Ne;0;1;0;1
16910;Boružėlė;"Nykštukai gudručiai";2744894565;Ne;0;2;4;6
16911;Boružėlė;"Nykštukai gudručiai";6590829182;Ne;3;2;1;6
16912;Boružėlė;"Nykštukai gudručiai";3129825206;Ne;0;8;0;8
16913;Boružėlė;"Nykštukai gudručiai";9771767352;Ne;10;0;0;10
16914;Boružėlė;"Nykštukai gudručiai";9078805020;Ne;0;5;0;5
16915;Boružėlė;"Saulės zuikučiai";4554260776;Ne;3;2;0;5
16916;Boružėlė;"Saulės zuikučiai";5298170118;Ne;3;2;0;5
16917;Boružėlė;"Saulės zuikučiai";1116012068;Ne;0;2;0;2
16918;Boružėlė;"Saulės zuikučiai";1292298259;Ne;1;0;0;1
16919;Boružėlė;"Saulės zuikučiai";3130977416;Ne;0;3;0;3
16920;Boružėlė;"Saulės zuikučiai";7256396576;Ne;0;1;0;1
16921;Boružėlė;"Saulės zuikučiai";4323998138;Ne;0;0;1;1
16922;Boružėlė;"Saulės zuikučiai";2087238951;Ne;0;2;0;2
16923;Boružėlė;"Saulės zuikučiai";4509233532;Ne;0;1;0;1
16924;Boružėlė;"Saulės zuikučiai";5516103398;Ne;9;0;0;9
16925;Boružėlė;"Saulės zuikučiai";8259586236;Ne;0;1;0;1
16926;Boružėlė;"Saulės zuikučiai";3955841578;Ne;0;1;0;1
16927;Boružėlė;"Saulės zuikučiai";1583223569;Ne;0;1;0;1
16928;Boružėlė;"Saulės zuikučiai";4433248526;Ne;0;2;0;2
16929;Boružėlė;"Saulės zuikučiai";1547802140;Ne;7;0;0;7
16930;Boružėlė;"Saulės zuikučiai";4020348640;Ne;4;0;0;4
16931;Boružėlė;"Saulės zuikučiai";2842256033;Ne;0;1;0;1
16932;Boružėlė;"Saulės zuikučiai";2561969142;Taip;21;0;0;21
16933;Boružėlė;"Saulės zuikučiai";6527254253;Ne;1;3;0;4
16934;Boružėlė;"Saulės zuikučiai";7942043844;Ne;0;2;0;2
16935;Boružėlė;"Saulės zuikučiai";2515608520;Ne;4;0;0;4
16936;Boružėlė;Gėlytės;3288141024;Ne;0;1;4;5
16937;Boružėlė;Gėlytės;7956982615;Ne;0;1;0;1
16938;Boružėlė;Gėlytės;4637656311;Ne;0;0;3;3
16939;Boružėlė;Gėlytės;6070356395;Ne;6;1;0;7
16940;Boružėlė;Gėlytės;4180537253;Ne;0;5;0;5
16941;Boružėlė;Gėlytės;6722353853;Ne;2;1;0;3
16942;Boružėlė;Gėlytės;8376436755;Ne;0;0;2;2
16943;Boružėlė;Gėlytės;3300678477;Ne;5;0;0;5
16944;Boružėlė;Gėlytės;7763958937;Ne;6;6;0;12
16945;Boružėlė;Gėlytės;9855354210;Ne;11;1;0;12
16946;Boružėlė;Gėlytės;3354291446;Ne;0;0;3;3
16947;Boružėlė;Gėlytės;8520403894;Ne;4;1;0;5
16948;Boružėlė;Gėlytės;4268486154;Ne;0;6;0;6
16949;Boružėlė;Gėlytės;7614216150;Ne;2;0;0;2
16950;Boružėlė;Gėlytės;4448964310;Ne;0;1;0;1
16951;Boružėlė;Gėlytės;8205706322;Ne;3;1;0;4
16952;Boružėlė;Gėlytės;8834231529;Ne;16;0;0;16
16953;Boružėlė;Gėlytės;8929444125;Ne;0;4;2;6
16954;Boružėlė;Gėlytės;3604658753;Ne;0;0;4;4
16955;Boružėlė;Gėlytės;9255292099;Ne;0;2;0;2
16956;Boružėlė;Smalsutis;9615931888;Ne;1;0;4;5
16957;Boružėlė;Smalsutis;9993823313;Ne;0;2;0;2
16958;Boružėlė;Smalsutis;4606274286;Ne;4;0;0;4
16959;Boružėlė;Smalsutis;8239372270;Taip;0;2;6;8
16960;Boružėlė;Smalsutis;6057263329;Ne;0;0;2;2
16961;Boružėlė;Smalsutis;6367963436;Ne;0;0;1;1
16962;Boružėlė;Smalsutis;1969793682;Ne;0;0;1;1
16963;Boružėlė;Smalsutis;6767206150;Taip;8;0;2;10
16964;Boružėlė;Smalsutis;6430695398;Ne;0;0;10;10
16965;Boružėlė;Smalsutis;4859297816;Ne;0;0;2;2
16966;Boružėlė;Smalsutis;6599359132;Ne;4;0;0;4
16967;Boružėlė;Smalsutis;7089148766;Ne;0;2;0;2
16968;Boružėlė;Drugeliai;8357946299;Ne;0;2;0;2
16969;Boružėlė;Drugeliai;1130980139;Ne;0;2;1;3
16970;Boružėlė;Drugeliai;6463583187;Ne;4;2;0;6
16971;Boružėlė;Drugeliai;3136028536;Ne;14;1;0;15
16972;Boružėlė;Drugeliai;2211576663;Ne;0;4;0;4
16973;Boružėlė;Drugeliai;1559001916;Ne;0;2;1;3
16974;Boružėlė;Drugeliai;4233602822;Ne;0;1;0;1
16975;Boružėlė;Drugeliai;9463322491;Ne;0;1;0;1
16976;Boružėlė;Drugeliai;3108758436;Ne;0;2;0;2
16977;Boružėlė;Drugeliai;8482813204;Ne;0;2;0;2
16978;Boružėlė;Drugeliai;6902130914;Ne;0;1;0;1
16979;Boružėlė;Drugeliai;3459207879;Taip;0;5;0;5
16980;Boružėlė;Drugeliai;6980022864;Ne;0;2;0;2
16981;Boružėlė;Drugeliai;7756929745;Ne;0;1;0;1
16982;Boružėlė;Drugeliai;5726187445;Ne;3;12;0;15
16983;Boružėlė;Drugeliai;2308405580;Ne;0;0;2;2
16984;Boružėlė;Drugeliai;3331238309;Ne;5;0;0;5
16985;Boružėlė;Drugeliai;2783338563;Ne;0;2;0;2
16986;Boružėlė;Drugeliai;3271262071;Ne;0;2;0;2
16987;Boružėlė;Vyturėliai;7934628014;Ne;0;0;4;4
16988;Boružėlė;Vyturėliai;6233993159;Ne;0;0;7;7
16989;Boružėlė;Vyturėliai;3991218067;Ne;11;2;4;17
16990;Boružėlė;Vyturėliai;8377410278;Ne;5;1;0;6
16991;Boružėlė;Vyturėliai;4928818565;Ne;0;6;0;6
16992;Boružėlė;Vyturėliai;5619719965;Ne;0;2;0;2
16993;Boružėlė;Vyturėliai;8073918985;Taip;6;0;0;6
16994;Boružėlė;Vyturėliai;3595998843;Ne;0;1;0;1
16995;Boružėlė;Vyturėliai;1929202434;Ne;8;0;2;10
16996;Boružėlė;Vyturėliai;4217116059;Ne;0;2;0;2
16997;Boružėlė;Vyturėliai;8165748779;Taip;9;0;0;9
16998;Boružėlė;Vyturėliai;7068409148;Ne;7;1;0;8
16999;Boružėlė;Vyturėliai;8434178580;Ne;6;1;0;7
17000;Boružėlė;Vyturėliai;1551933321;Taip;0;5;0;5
17001;Boružėlė;Vyturėliai;2084361709;Ne;0;1;0;1
17002;Boružėlė;Žvaigždutės;9838823214;Ne;3;0;0;3
17003;Boružėlė;Žvaigždutės;3140264242;Ne;0;1;0;1
17004;Boružėlė;Žvaigždutės;8916241914;Ne;0;9;0;9
17005;Boružėlė;Žvaigždutės;6724101421;Ne;0;2;0;2
17006;Boružėlė;Žvaigždutės;8820827882;Ne;2;3;0;5
17007;Boružėlė;Žvaigždutės;1799882790;Ne;0;4;0;4
17008;Boružėlė;Žvaigždutės;5420788580;Ne;0;2;4;6
17009;Boružėlė;Žvaigždutės;2075050639;Ne;6;0;0;6
17010;Boružėlė;Ąžuoliukai;1874865061;Taip;0;1;9;10
17011;Boružėlė;Ąžuoliukai;6820122408;Ne;0;1;0;1
17012;Boružėlė;Ąžuoliukai;6708666819;Ne;0;10;6;16
17013;Boružėlė;Ąžuoliukai;9818317963;Ne;0;0;1;1
17014;Boružėlė;Ąžuoliukai;1237441386;Ne;0;0;3;3
17015;Boružėlė;Ąžuoliukai;6297693776;Ne;5;0;0;5
17016;Boružėlė;Ąžuoliukai;5401338963;Ne;0;2;4;6
17017;Boružėlė;Ąžuoliukai;8734782540;Ne;0;1;15;16
17018;Boružėlė;Ąžuoliukai;7065907155;Ne;3;4;5;12
17019;Boružėlė;Ąžuoliukai;4113917886;Ne;0;0;5;5
17020;Boružėlė;Ąžuoliukai;1608652924;Ne;1;0;4;5
17021;Boružėlė;Ąžuoliukai;3005601935;Ne;0;4;15;19
17022;Boružėlė;Ąžuoliukai;8752343077;Ne;0;2;0;2
17023;Boružėlė;Ąžuoliukai;4727351240;Ne;11;2;0;13
17024;Boružėlė;Ąžuoliukai;4497753570;Ne;0;0;14;14
17025;Boružėlė;Ąžuoliukai;1865891989;Ne;0;2;1;3
17026;Boružėlė;Ąžuoliukai;8739264310;Taip;5;0;3;8
17027;Boružėlė;Ąžuoliukai;3097874340;Taip;0;1;1;2
17028;Boružėlė;Ąžuoliukai;7149439740;Ne;0;1;0;1
17029;Boružėlė;Ąžuoliukai;1630903587;Ne;0;0;6;6
17030;Boružėlė;Saulutės;9492548829;Ne;1;2;0;3
17031;Boružėlė;Saulutės;5437943626;Ne;4;0;0;4
17032;Boružėlė;Saulutės;3503931241;Ne;4;0;0;4
17033;Boružėlė;Saulutės;2999335505;Ne;0;0;1;1
17034;Boružėlė;Saulutės;6265279517;Ne;6;2;0;8
17035;Boružėlė;Saulutės;6275425512;Ne;4;0;0;4
17036;Boružėlė;Saulutės;2879726579;Ne;8;1;0;9
17037;Boružėlė;Saulutės;8804878419;Ne;0;3;0;3
17038;Boružėlė;Saulutės;3871593172;Ne;0;3;0;3
17039;Boružėlė;Saulutės;3953507461;Ne;0;2;7;9
17040;Boružėlė;Saulutės;1492091211;Ne;0;1;0;1
17041;Boružėlė;Saulutės;1830043506;Ne;0;1;0;1
17042;Boružėlė;Saulutės;5680510186;Ne;0;8;2;10
17043;Boružėlė;Saulutės;1152697871;Ne;0;1;0;1
17044;Boružėlė;Saulutės;7652740249;Ne;0;3;0;3
17045;Boružėlė;Saulutės;7260471712;Ne;0;2;0;2
17046;Boružėlė;Ežiukai;9342498392;Taip;0;2;1;3
17047;Boružėlė;Ežiukai;8195442951;Ne;0;2;5;7
17048;Boružėlė;Ežiukai;6448688592;Ne;0;2;0;2
17049;Boružėlė;Ežiukai;2429696310;Ne;0;2;0;2
17050;Boružėlė;Ežiukai;9893643199;Ne;0;4;0;4
17051;Boružėlė;Ežiukai;5394149649;Ne;0;2;0;2
17052;Boružėlė;Ežiukai;9391811395;Ne;0;1;0;1
17053;Boružėlė;Ežiukai;5825164520;Ne;0;0;10;10
17054;Boružėlė;Ežiukai;7190980006;Ne;0;1;0;1
17055;Boružėlė;Ežiukai;7459531236;Ne;0;2;1;3
17056;Boružėlė;Ežiukai;8818358360;Ne;0;2;1;3
17057;Boružėlė;Ežiukai;2926620929;Ne;2;0;0;2
17058;Boružėlė;Ežiukai;6609156790;Ne;0;1;0;1
17059;Boružėlė;Ežiukai;8291389794;Ne;0;1;0;1
17060;Boružėlė;Ežiukai;5492228053;Ne;2;1;0;3
17061;Boružėlė;Ežiukai;6087811262;Ne;0;1;0;1
17062;Boružėlė;Boružiukai;8944790932;Ne;3;1;0;4
17063;Boružėlė;Boružiukai;2298750617;Ne;5;0;0;5
17064;Boružėlė;Boružiukai;3097217902;Ne;0;2;0;2
17065;Boružėlė;Boružiukai;6026505923;Ne;6;1;0;7
17066;Boružėlė;Boružiukai;4771951587;Ne;5;2;0;7
17067;Boružėlė;Boružiukai;6856426845;Ne;4;0;1;5
17068;Boružėlė;Boružiukai;8512180544;Ne;7;1;0;8
17069;Boružėlė;Boružiukai;3209486458;Ne;0;2;0;2
17070;Boružėlė;Boružiukai;3972950428;Ne;5;1;0;6
17071;Boružėlė;Boružiukai;6010385301;Ne;0;2;2;4
17072;Boružėlė;Boružiukai;2304719318;Ne;3;0;0;3
17073;Boružėlė;Nykštukai;1966066642;Ne;5;1;0;6
17074;Boružėlė;Nykštukai;6267999965;Ne;0;1;0;1
17075;Boružėlė;Nykštukai;6776735311;Ne;0;0;10;10
17076;Boružėlė;Nykštukai;6221965115;Ne;3;0;1;4
17077;Boružėlė;Nykštukai;2657554726;Ne;0;4;16;20
17078;Boružėlė;Nykštukai;6529896335;Ne;0;2;3;5
17079;Boružėlė;Nykštukai;6273128752;Taip;5;1;0;6
17080;Boružėlė;Nykštukai;6733644286;Ne;0;0;3;3
17081;Boružėlė;Nykštukai;2984478360;Ne;0;0;10;10
17082;Boružėlė;Nykštukai;3471567359;Ne;3;0;0;3
17083;Žaliakalnio;Drugeliai;9106286038;Ne;3;0;1;4
17084;Žaliakalnio;Drugeliai;1004188539;Ne;1;0;4;5
17085;Žaliakalnio;Drugeliai;9762481841;Ne;1;0;0;1
17086;Žaliakalnio;Drugeliai;9710185940;Ne;9;0;1;10
17087;Žaliakalnio;Drugeliai;5626776693;Ne;0;4;0;4
17088;Žaliakalnio;Drugeliai;4945570058;Ne;0;0;2;2
17089;Žaliakalnio;Drugeliai;6521902343;Ne;0;1;0;1
17090;Žaliakalnio;Drugeliai;9790375448;Ne;9;0;0;9
17091;Žaliakalnio;Drugeliai;7078689014;Ne;0;9;1;10
17092;Žaliakalnio;Drugeliai;8852165484;Taip;0;0;4;4
17093;Žaliakalnio;Drugeliai;9167631614;Ne;3;0;0;3
17094;Žaliakalnio;Drugeliai;6166482260;Taip;6;0;0;6
17095;Žaliakalnio;Boružėlių;5843020412;Ne;0;2;0;2
17096;Žaliakalnio;Boružėlių;7087535800;Ne;0;2;0;2
17097;Žaliakalnio;Boružėlių;1528111839;Ne;0;4;0;4
17098;Žaliakalnio;Boružėlių;7023886811;Ne;0;1;0;1
17099;Žaliakalnio;Boružėlių;2284465378;Ne;10;0;0;10
17100;Žaliakalnio;Boružėlių;2808776865;Ne;5;0;0;5
17101;Žaliakalnio;Boružėlių;2278681435;Ne;0;0;3;3
17102;Žaliakalnio;Boružėlių;9421259943;Ne;0;0;2;2
17103;Žaliakalnio;Boružėlių;8052539476;Ne;7;5;0;12
17104;Žaliakalnio;Boružėlių;6590016097;Ne;0;8;0;8
17105;Žaliakalnio;Boružėlių;8304431519;Ne;15;0;1;16
17106;Žaliakalnio;Boružėlių;5488964606;Ne;5;0;0;5
17107;Žaliakalnio;Boružėlių;8429135626;Ne;5;1;0;6
17108;Žaliakalnio;Boružėlių;8073554707;Ne;0;0;1;1
17109;Žaliakalnio;Boružėlių;2987217910;Ne;0;6;0;6
17110;Žaliakalnio;Boružėlių;9032003195;Ne;10;0;0;10
17111;Žaliakalnio;Boružėlių;4961762841;Ne;5;0;0;5
17112;Žaliakalnio;Boružėlių;3027735957;Ne;0;0;1;1
17113;Žaliakalnio;Zuikučiai;9382616403;Ne;6;0;0;6
17114;Žaliakalnio;Zuikučiai;2111418502;Ne;5;3;0;8
17115;Žaliakalnio;Zuikučiai;8576412247;Ne;13;0;0;13
17116;Žaliakalnio;Zuikučiai;9317649996;Ne;0;2;0;2
17117;Žaliakalnio;Zuikučiai;6872615333;Ne;5;0;0;5
17118;Žaliakalnio;Zuikučiai;5645294219;Ne;3;0;0;3
17119;Žaliakalnio;Zuikučiai;7258677907;Ne;0;4;0;4
17120;Žaliakalnio;Zuikučiai;5939383017;Ne;10;1;0;11
17121;Žaliakalnio;Zuikučiai;4231316753;Ne;7;1;0;8
17122;Žaliakalnio;Zuikučiai;9478722760;Ne;0;2;0;2
17123;Žaliakalnio;Zuikučiai;9378617562;Ne;5;0;0;5
17124;Žaliakalnio;Zuikučiai;7047556229;Ne;5;0;0;5
17125;Žaliakalnio;Zuikučiai;4563419248;Ne;8;1;0;9
17126;Žaliakalnio;Zuikučiai;7495990953;Taip;4;0;0;4
17127;Žaliakalnio;Zuikučiai;5566009966;Ne;11;1;0;12
17128;Žaliakalnio;Bitutė;5744370516;Ne;0;5;0;5
17129;Žaliakalnio;Bitutė;3619817569;Ne;0;1;0;1
17130;Žaliakalnio;Bitutė;3905448562;Ne;7;1;0;8
17131;Žaliakalnio;Bitutė;8481665290;Ne;0;2;0;2
17132;Žaliakalnio;Bitutė;8950583202;Ne;0;0;2;2
17133;Žaliakalnio;Bitutė;6324315523;Ne;0;1;0;1
17134;Žaliakalnio;Bitutė;2280683252;Ne;1;2;0;3
17135;Žaliakalnio;Bitutė;7711347723;Ne;1;12;0;13
17136;Žaliakalnio;Bitutė;4561672875;Ne;0;1;0;1
17137;Žaliakalnio;Bitutė;8185190219;Taip;2;1;4;7
17138;Žaliakalnio;Bitutė;7830692152;Ne;0;1;0;1
17139;Žaliakalnio;Bitutė;1423481154;Ne;0;3;0;3
17140;Žaliakalnio;Bitutė;4928400872;Ne;0;2;0;2
17141;Žaliakalnio;Bitutė;1343293430;Ne;0;1;0;1
17142;Žaliakalnio;Bitutė;3721878250;Ne;0;0;6;6
17143;Žaliakalnio;Bitutė;6291287113;Ne;0;4;0;4
17144;Žaliakalnio;Bitutė;1173977434;Ne;21;0;0;21
17145;Žaliakalnio;Bitutė;9485995178;Ne;0;6;0;6
17146;Žaliakalnio;Bitutė;1309236035;Ne;0;2;1;3
17147;Žaliakalnio;Bitutė;8534973941;Ne;0;13;0;13
17148;Žaliakalnio;Nykštukų;9069518153;Ne;0;11;0;11
17149;Žaliakalnio;Nykštukų;8142435757;Ne;3;1;0;4
17150;Žaliakalnio;Nykštukų;3446593135;Ne;0;1;0;1
17151;Žaliakalnio;Nykštukų;1064854294;Taip;7;2;0;9
17152;Žaliakalnio;Nykštukų;4891656355;Ne;0;1;0;1
17153;Žaliakalnio;Nykštukų;1632465983;Ne;6;0;0;6
17154;Žaliakalnio;Nykštukų;8472945857;Ne;0;2;0;2
17155;Žaliakalnio;Nykštukų;9521104462;Taip;15;0;0;15
17156;Žaliakalnio;Nykštukų;5565027085;Ne;0;2;0;2
17157;Žaliakalnio;Nykštukų;2242604156;Ne;0;1;0;1
17158;Žaliakalnio;Nykštukų;9801618806;Ne;0;1;0;1
17159;Žaliakalnio;Nykštukų;2225778044;Ne;0;1;0;1
17160;Žaliakalnio;Nykštukų;4255734788;Ne;1;1;0;2
17161;Žaliakalnio;Nykštukų;7793937917;Ne;1;0;0;1
17162;Žaliakalnio;Nykštukų;8117013474;Ne;0;1;0;1
17163;Žaliakalnio;Nykštukų;7205368281;Ne;0;3;0;3
17164;Žaliakalnio;Nykštukų;4036239701;Ne;0;9;0;9
17165;Žaliakalnio;Nykštukų;5258266970;Ne;1;0;0;1
17166;Žaliakalnio;Nykštukų;3041002600;Ne;2;1;0;3
17167;Žaliakalnio;Nykštukų;7636933790;Ne;3;0;0;3
17168;Žaliakalnio;Nykštukų;2155412338;Ne;2;2;0;4
17169;Žaliakalnio;Nykštukų;1511302012;Ne;0;1;0;1
17170;Žaliakalnio;ŽIOGELIAI;2426844621;Ne;0;2;0;2
17171;Žaliakalnio;ŽIOGELIAI;5752912101;Ne;3;0;0;3
17172;Žaliakalnio;ŽIOGELIAI;9967098834;Ne;3;1;0;4
17173;Žaliakalnio;ŽIOGELIAI;1133557422;Ne;4;1;0;5
17174;Žaliakalnio;ŽIOGELIAI;3464935314;Ne;6;0;0;6
17175;Žaliakalnio;ŽIOGELIAI;7648422668;Ne;5;1;0;6
17176;Žaliakalnio;ŽIOGELIAI;4702470511;Ne;0;4;0;4
17177;Žaliakalnio;ŽIOGELIAI;2272043654;Ne;0;3;0;3
17178;Žaliakalnio;ŽIOGELIAI;8518422934;Ne;0;1;0;1
17179;Žaliakalnio;ŽIOGELIAI;8245784590;Ne;16;0;0;16
17180;Žaliakalnio;ŽIOGELIAI;8383425712;Ne;0;0;2;2
17181;Žaliakalnio;ŽIOGELIAI;7025195076;Ne;1;0;0;1
17182;Žaliakalnio;ŽIOGELIAI;2514763739;Ne;0;1;0;1
17183;Žaliakalnio;ŽIOGELIAI;6294045755;Ne;0;3;0;3
17184;Žaliakalnio;ŽIOGELIAI;8232697563;Ne;8;2;0;10
17185;Žaliakalnio;ŽIOGELIAI;2694424532;Ne;6;6;0;12
17186;Žaliakalnio;ŽIOGELIAI;6136717862;Ne;3;0;0;3
17187;Žaliakalnio;ŽIOGELIAI;8568306789;Ne;0;0;1;1
17188;Žaliakalnio;ŽIOGELIAI;9383567339;Ne;0;6;0;6
17189;Žaliakalnio;SAULUTĖS;1253655689;Ne;3;0;0;3
17190;Žaliakalnio;SAULUTĖS;3016537413;Ne;0;3;0;3
17191;Žaliakalnio;SAULUTĖS;6795532166;Ne;4;0;0;4
17192;Žaliakalnio;SAULUTĖS;7913029369;Ne;10;0;0;10
17193;Žaliakalnio;SAULUTĖS;7793917852;Ne;5;2;0;7
17194;Žaliakalnio;SAULUTĖS;3018398546;Ne;0;7;0;7
17195;Žaliakalnio;SAULUTĖS;8765159796;Ne;0;9;0;9
17196;Žaliakalnio;SAULUTĖS;3028921540;Ne;0;2;0;2
17197;Žaliakalnio;SAULUTĖS;4355433666;Ne;0;1;0;1
17198;Žaliakalnio;SAULUTĖS;1975313368;Ne;0;10;0;10
17199;Žaliakalnio;SAULUTĖS;9016032548;Ne;2;0;0;2
17200;Žaliakalnio;SAULUTĖS;1715385224;Ne;16;0;0;16
17201;Žaliakalnio;SAULUTĖS;3304186400;Taip;6;9;0;15
17202;Žaliakalnio;SAULUTĖS;3832291926;Ne;0;3;0;3
17203;Žaliakalnio;SAULUTĖS;7071209465;Ne;12;0;0;12
17204;Žaliakalnio;SAULUTĖS;7543073516;Ne;0;2;0;2
17205;Žaliakalnio;SAULUTĖS;9379373983;Ne;3;1;0;4
17206;Žaliakalnio;SAULUTĖS;2806386840;Ne;4;0;0;4
17207;Žaliakalnio;SAULUTĖS;9267349375;Taip;0;1;0;1
17208;Žaliakalnio;SAULUTĖS;7989372873;Ne;0;1;1;2
17209;Žaliakalnio;SAULUTĖS;4412760433;Ne;0;2;0;2
17210;Volungė;Bitutės;5791161943;Ne;0;0;1;1
17211;Volungė;Bitutės;3307326410;Ne;9;1;2;12
17212;Volungė;Bitutės;5300334761;Ne;3;0;0;3
17213;Volungė;Bitutės;6755366051;Ne;0;0;1;1
17214;Volungė;Bitutės;4013639324;Ne;0;5;5;10
17215;Volungė;Bitutės;2599441104;Ne;7;0;3;10
17216;Volungė;Bitutės;5892600735;Ne;0;0;13;13
17217;Volungė;Bitutės;1902122510;Ne;0;0;1;1
17218;Volungė;Bitutės;1752817125;Ne;5;1;0;6
17219;Volungė;Bitutės;3515725398;Ne;0;0;1;1
17220;Volungė;Bitutės;3666364101;Ne;0;0;1;1
17221;Volungė;Bitutės;7151952679;Ne;0;0;4;4
17222;Volungė;Bitutės;5960027749;Ne;0;0;2;2
17223;Volungė;Bitutės;9842009354;Ne;8;0;0;8
17224;Volungė;Bitutės;9933980783;Ne;0;0;2;2
17225;Volungė;Bitutės;4685227759;Ne;0;0;1;1
17226;Volungė;Boružiukai;8218322764;Ne;0;4;0;4
17227;Volungė;Boružiukai;3346193393;Taip;0;0;2;2
17228;Volungė;Boružiukai;6445614647;Taip;0;0;2;2
17229;Volungė;Boružiukai;1125730734;Ne;0;0;5;5
17230;Volungė;Boružiukai;6127398531;Ne;0;0;1;1
17231;Volungė;Boružiukai;5588544003;Ne;0;0;3;3
17232;Volungė;Boružiukai;3758750922;Ne;0;0;19;19
17233;Volungė;Boružiukai;5561683986;Ne;0;0;2;2
17234;Volungė;Boružiukai;9562426487;Ne;0;0;4;4
17235;Volungė;Boružiukai;4136178027;Ne;0;0;2;2
17236;Volungė;Boružiukai;4664635246;Taip;4;0;0;4
17237;Volungė;Boružiukai;8987748481;Ne;3;0;9;12
17238;Volungė;Boružiukai;5882826586;Ne;0;12;0;12
17239;Volungė;Boružiukai;6969633765;Ne;0;0;11;11
17240;Volungė;Boružiukai;5338942678;Ne;0;0;2;2
17241;Volungė;Žvirbliukai;2360026330;Ne;0;0;2;2
17242;Volungė;Žvirbliukai;8414351815;Ne;0;0;4;4
17243;Volungė;Žvirbliukai;2051410463;Taip;0;0;4;4
17244;Volungė;Žvirbliukai;5074093178;Ne;0;0;9;9
17245;Volungė;Žvirbliukai;5750385275;Taip;4;0;3;7
17246;Volungė;Žvirbliukai;9575894080;Taip;0;0;4;4
17247;Volungė;Žvirbliukai;8927595898;Ne;3;0;1;4
17248;Volungė;Žvirbliukai;9384821249;Ne;3;0;0;3
17249;Volungė;Žvirbliukai;5361410157;Ne;3;0;5;8
17250;Volungė;Žvirbliukai;4235842588;Ne;0;0;1;1
17251;Volungė;Žvirbliukai;3028611395;Taip;0;0;9;9
17252;Volungė;Žvirbliukai;2949033093;Ne;0;0;3;3
17253;Volungė;Žvirbliukai;2159667991;Ne;0;0;1;1
17254;Volungė;Žvirbliukai;5470252589;Ne;0;0;11;11
17255;Volungė;Žvirbliukai;7923029388;Ne;0;0;2;2
17256;Volungė;Žvirbliukai;1293494284;Ne;3;0;2;5
17257;Volungė;Žvirbliukai;1022606584;Ne;6;0;2;8
17258;Volungė;Žvirbliukai;8894121428;Ne;0;0;2;2
17259;Volungė;Žvirbliukai;9139746132;Ne;0;0;3;3
17260;Volungė;Žiogeliai;4856240879;Ne;0;0;4;4
17261;Volungė;Žiogeliai;9816038480;Taip;0;0;2;2
17262;Volungė;Žiogeliai;8640511964;Ne;0;5;2;7
17263;Volungė;Žiogeliai;8421730419;Ne;0;0;13;13
17264;Volungė;Žiogeliai;6532202782;Ne;0;17;0;17
17265;Volungė;Žiogeliai;2246291631;Ne;1;5;0;6
17266;Volungė;Žiogeliai;2456643081;Ne;0;6;1;7
17267;Volungė;Žiogeliai;8299305464;Ne;4;0;6;10
17268;Volungė;Žiogeliai;1781838937;Ne;0;6;1;7
17269;Volungė;Žiogeliai;1988082807;Ne;0;0;1;1
17270;Volungė;Žiogeliai;3091641738;Ne;0;0;2;2
17271;Volungė;Žiogeliai;8578521969;Ne;7;0;1;8
17272;Volungė;Žiogeliai;5710662590;Ne;0;0;1;1
17273;Volungė;Žiogeliai;4839484528;Ne;0;0;1;1
17274;Volungė;Žiogeliai;5174427959;Ne;0;0;5;5
17275;Volungė;Žiogeliai;7281448136;Ne;2;0;3;5
17276;Volungė;Pelėdžiukai;6431477042;Ne;0;0;3;3
17277;Volungė;Pelėdžiukai;3528581949;Ne;0;0;10;10
17278;Volungė;Pelėdžiukai;1137713075;Ne;0;4;0;4
17279;Volungė;Pelėdžiukai;2322594823;Ne;0;4;0;4
17280;Volungė;Pelėdžiukai;7965601199;Ne;0;0;1;1
17281;Volungė;Pelėdžiukai;2603335248;Taip;0;0;3;3
17282;Volungė;Pelėdžiukai;3746978206;Ne;0;0;3;3
17283;Volungė;Pelėdžiukai;1974650443;Ne;0;0;1;1
17284;Volungė;Pelėdžiukai;2068447339;Ne;0;21;0;21
17285;Volungė;Pelėdžiukai;9188994935;Ne;0;10;5;15
17286;Volungė;Pelėdžiukai;1757041481;Ne;0;0;7;7
17287;Volungė;Pelėdžiukai;8285309230;Ne;0;0;1;1
17288;Volungė;Pelėdžiukai;7149986415;Ne;0;0;4;4
17289;Volungė;Pelėdžiukai;4598763851;Ne;0;0;3;3
17290;Volungė;Pelėdžiukai;2627555750;Ne;0;0;3;3
17291;Volungė;Pelėdžiukai;7867741556;Ne;0;0;4;4
17292;Volungė;Pelėdžiukai;7971287899;Ne;0;0;13;13
17293;Volungė;Pelėdžiukai;9729285419;Ne;0;0;10;10
17294;Volungė;Pelėdžiukai;8459167833;Ne;0;0;1;1
17295;Volungė;Drugeliai;6280208510;Ne;5;0;1;6
17296;Volungė;Drugeliai;4032261812;Ne;0;4;2;6
17297;Volungė;Drugeliai;6488473384;Ne;0;6;3;9
17298;Volungė;Drugeliai;8045459660;Ne;6;0;2;8
17299;Volungė;Drugeliai;1402200673;Ne;6;0;2;8
17300;Volungė;Drugeliai;7574856429;Ne;0;0;1;1
17301;Volungė;Drugeliai;5284011092;Ne;0;0;1;1
17302;Volungė;Drugeliai;4427076715;Ne;0;0;1;1
17303;Volungė;Drugeliai;9973604148;Ne;0;0;3;3
17304;Volungė;Drugeliai;8905401944;Ne;0;0;4;4
17305;Volungė;Drugeliai;6782622442;Ne;0;0;1;1
17306;Volungė;Drugeliai;3020629341;Ne;0;0;5;5
17307;Volungė;Drugeliai;2530804242;Ne;0;0;5;5
17308;Volungė;Drugeliai;5354511593;Ne;3;0;0;3
17309;Volungė;Drugeliai;3150532451;Ne;0;0;5;5
17310;Volungė;Drugeliai;4745609424;Taip;0;0;1;1
17311;Volungė;Drugeliai;7584598377;Ne;0;0;2;2
17312;Volungė;"SKRUZDĖLIUKAI ";3394646139;Ne;6;6;2;14
17313;Volungė;"SKRUZDĖLIUKAI ";4223287277;Ne;2;0;1;3
17314;Volungė;"SKRUZDĖLIUKAI ";6464890465;Ne;6;10;1;17
17315;Volungė;"SKRUZDĖLIUKAI ";2493541457;Ne;0;0;10;10
17316;Volungė;"SKRUZDĖLIUKAI ";5332306628;Ne;0;0;1;1
17317;Volungė;"SKRUZDĖLIUKAI ";9319825151;Taip;8;0;2;10
17318;Volungė;"SKRUZDĖLIUKAI ";6370584522;Ne;0;3;0;3
17319;Volungė;"SKRUZDĖLIUKAI ";8168630107;Ne;3;0;1;4
17320;Volungė;"SKRUZDĖLIUKAI ";8992514683;Ne;9;1;0;10
17321;Volungė;"SKRUZDĖLIUKAI ";5994884455;Ne;0;0;1;1
17322;Volungė;"SKRUZDĖLIUKAI ";3818924175;Ne;0;6;4;10
17323;Volungė;"SKRUZDĖLIUKAI ";8244731771;Ne;0;0;1;1
17324;Volungė;"SKRUZDĖLIUKAI ";6110117105;Ne;0;0;7;7
17325;Volungė;"SKRUZDĖLIUKAI ";4944556574;Ne;0;2;5;7
17326;Volungė;"SKRUZDĖLIUKAI ";2212423676;Ne;0;0;1;1
17327;Volungė;"SKRUZDĖLIUKAI ";5942497397;Ne;0;0;1;1
17328;Volungė;"SKRUZDĖLIUKAI ";4991465781;Ne;0;5;0;5
17329;Volungė;"SKRUZDĖLIUKAI ";8613580206;Ne;5;0;1;6
17330;Volungė;Zylutės;6715770777;Ne;0;0;1;1
17331;Volungė;Zylutės;2874194121;Ne;6;0;0;6
17332;Volungė;Zylutės;9005691348;Ne;5;0;0;5
17333;Volungė;Zylutės;2765042584;Ne;6;0;0;6
17334;Volungė;Zylutės;7754202158;Taip;5;0;0;5
17335;Volungė;Zylutės;3042694602;Ne;0;0;1;1
17336;Giliukas;SMALSUČIAI;9462634699;Ne;10;0;0;10
17337;Giliukas;SMALSUČIAI;7646966187;Ne;4;0;0;4
17338;Giliukas;SMALSUČIAI;3274313536;Taip;0;4;0;4
17339;Giliukas;SMALSUČIAI;9287193955;Ne;22;2;0;24
17340;Giliukas;SMALSUČIAI;7944198886;Ne;4;0;0;4
17341;Giliukas;SMALSUČIAI;5527212334;Ne;6;0;0;6
17342;Giliukas;SMALSUČIAI;9499591494;Ne;0;2;0;2
17343;Giliukas;SMALSUČIAI;2099575372;Ne;9;3;0;12
17344;Giliukas;SMALSUČIAI;7195772641;Ne;10;0;0;10
17345;Giliukas;SMALSUČIAI;4258921446;Ne;4;2;0;6
17346;Giliukas;SMALSUČIAI;1439350058;Ne;1;0;0;1
17347;Giliukas;SMALSUČIAI;4843920452;Ne;1;0;0;1
17348;Giliukas;SMALSUČIAI;2004782696;Taip;1;0;0;1
17349;Giliukas;SMALSUČIAI;8977247073;Ne;3;0;0;3
17350;Giliukas;SMALSUČIAI;9475918013;Ne;3;0;0;3
17351;Giliukas;SMALSUČIAI;9229086918;Ne;9;2;0;11
17352;Giliukas;SMALSUČIAI;8147492951;Ne;3;7;0;10
17353;Giliukas;SMALSUČIAI;2349166172;Ne;11;0;0;11
17354;Giliukas;SMALSUČIAI;8241215831;Ne;14;0;0;14
17355;Giliukas;GUDRUČIAI;4960232685;Ne;1;2;0;3
17356;Giliukas;GUDRUČIAI;9458262379;Ne;6;0;0;6
17357;Giliukas;GUDRUČIAI;6148883070;Ne;11;0;0;11
17358;Giliukas;GUDRUČIAI;7425654504;Ne;2;1;0;3
17359;Giliukas;GUDRUČIAI;7130696530;Ne;4;0;0;4
17360;Giliukas;GUDRUČIAI;6422178450;Ne;0;1;0;1
17361;Giliukas;GUDRUČIAI;3150981084;Ne;10;1;0;11
17362;Giliukas;GUDRUČIAI;6134554678;Ne;12;4;0;16
17363;Giliukas;GUDRUČIAI;3137768675;Ne;10;1;0;11
17364;Giliukas;GUDRUČIAI;2064182165;Ne;6;0;0;6
17365;Giliukas;GUDRUČIAI;6956862865;Ne;0;2;0;2
17366;Giliukas;GUDRUČIAI;9617542456;Ne;8;2;0;10
17367;Giliukas;GUDRUČIAI;9274289812;Ne;2;0;0;2
17368;Giliukas;GUDRUČIAI;3718774263;Ne;7;0;0;7
17369;Giliukas;GUDRUČIAI;9152432124;Ne;6;0;0;6
17370;Giliukas;GUDRUČIAI;4854370266;Ne;7;0;0;7
17371;Giliukas;GUDRUČIAI;6338583515;Ne;2;2;0;4
17372;Giliukas;GUDRUČIAI;6703080106;Ne;1;2;0;3
17373;Giliukas;GUDRUČIAI;4347883309;Ne;0;1;0;1
17374;Giliukas;PABIRUČIAI;4183026763;Ne;5;0;0;5
17375;Giliukas;PABIRUČIAI;4247090684;Ne;6;0;0;6
17376;Giliukas;PABIRUČIAI;2379370477;Ne;6;6;0;12
17377;Giliukas;PABIRUČIAI;3054591644;Ne;5;0;0;5
17378;Giliukas;PABIRUČIAI;3870143024;Ne;12;0;0;12
17379;Giliukas;PABIRUČIAI;6914013230;Ne;13;0;1;14
17380;Giliukas;PABIRUČIAI;7013767174;Ne;4;0;0;4
17381;Giliukas;PABIRUČIAI;4810236703;Ne;10;0;0;10
17382;Giliukas;PABIRUČIAI;4105974682;Ne;5;10;0;15
17383;Giliukas;PABIRUČIAI;8874804636;Ne;10;0;0;10
17384;Giliukas;PABIRUČIAI;8626920684;Taip;8;0;0;8
17385;Giliukas;PABIRUČIAI;7012272912;Ne;4;0;0;4
17386;Giliukas;PABIRUČIAI;2229737837;Taip;5;0;0;5
17387;Giliukas;PABIRUČIAI;1075275967;Ne;21;5;0;26
17388;Giliukas;PABIRUČIAI;3268682615;Ne;2;0;0;2
17389;Giliukas;PABIRUČIAI;4838600191;Ne;0;5;0;5
17390;Giliukas;PABIRUČIAI;1395779355;Ne;3;0;0;3
17391;Giliukas;PABIRUČIAI;7541075946;Ne;12;0;0;12
17392;Giliukas;ŠVELNUKAI;9224387185;Ne;2;0;0;2
17393;Giliukas;ŠVELNUKAI;9360994563;Ne;6;0;0;6
17394;Giliukas;ŠVELNUKAI;7402797271;Ne;6;0;0;6
17395;Giliukas;ŠVELNUKAI;2012365132;Ne;7;0;0;7
17396;Giliukas;ŠVELNUKAI;4565216956;Ne;8;10;0;18
17397;Giliukas;ŠVELNUKAI;5834233526;Ne;3;1;0;4
17398;Giliukas;ŠVELNUKAI;5000654626;Ne;4;0;0;4
17399;Giliukas;ŠVELNUKAI;8973584424;Ne;8;0;0;8
17400;Giliukas;ŠVELNUKAI;9679421414;Ne;14;0;1;15
17401;Giliukas;ŠVELNUKAI;2881704755;Ne;4;5;0;9
17402;Giliukas;ŠVELNUKAI;3238820351;Ne;7;0;0;7
17403;Giliukas;ŠVELNUKAI;4340602792;Taip;3;1;0;4
17404;Giliukas;ŠVELNUKAI;6563305502;Ne;10;1;0;11
17405;Giliukas;ŠVELNUKAI;4301950538;Ne;13;0;0;13
17406;Giliukas;ŠVELNUKAI;7657935162;Ne;1;0;0;1
17407;Giliukas;ŽINIUKAI;2502801547;Ne;6;2;0;8
17408;Giliukas;ŽINIUKAI;2562809633;Ne;11;2;0;13
17409;Giliukas;ŽINIUKAI;5326178821;Ne;18;0;0;18
17410;Giliukas;ŽINIUKAI;5201020765;Ne;10;2;0;12
17411;Giliukas;ŽINIUKAI;2801731379;Ne;5;2;0;7
17412;Giliukas;ŽINIUKAI;8499893356;Ne;0;11;0;11
17413;Giliukas;ŽINIUKAI;9205911152;Ne;4;0;0;4
17414;Giliukas;ŽINIUKAI;3720032249;Ne;5;0;0;5
17415;Giliukas;ŽINIUKAI;3659105022;Ne;0;2;0;2
17416;Giliukas;ŽINIUKAI;8491008130;Taip;7;2;0;9
17417;Giliukas;ŽINIUKAI;4163383707;Ne;4;1;0;5
17418;Giliukas;ŽINIUKAI;1332725572;Ne;0;3;0;3
17419;Giliukas;ŽINIUKAI;1915809569;Ne;4;2;0;6
17420;Giliukas;ŽINIUKAI;2787116787;Ne;4;4;0;8
17421;Giliukas;MYLIMUKAI;7481387658;Ne;6;0;0;6
17422;Giliukas;MYLIMUKAI;7290236898;Ne;3;0;0;3
17423;Giliukas;MYLIMUKAI;8786230522;Ne;1;0;0;1
17424;Giliukas;MYLIMUKAI;7406406981;Ne;7;0;0;7
17425;Giliukas;MYLIMUKAI;2169949712;Ne;5;0;0;5
17426;Giliukas;MYLIMUKAI;5467076457;Ne;1;0;0;1
17427;Giliukas;MYLIMUKAI;2109668106;Ne;8;0;0;8
17428;Giliukas;MYLIMUKAI;6650117646;Ne;1;0;0;1
17429;Giliukas;MYLIMUKAI;5199968458;Ne;4;0;0;4
17430;Giliukas;MYLIMUKAI;3185622470;Ne;1;0;0;1
17431;Giliukas;MYLIMUKAI;8414652507;Ne;11;0;0;11
17432;Giliukas;MYLIMUKAI;7560774044;Ne;6;0;0;6
17433;Giliukas;ČIAUŠKUČIAI;8701216181;Ne;4;0;0;4
17434;Giliukas;ČIAUŠKUČIAI;6742406486;Ne;8;0;0;8
17435;Giliukas;ČIAUŠKUČIAI;2840410579;Ne;7;3;0;10
17436;Giliukas;ČIAUŠKUČIAI;2378721717;Ne;2;0;0;2
17437;Giliukas;ČIAUŠKUČIAI;7316126011;Ne;3;0;0;3
17438;Giliukas;ČIAUŠKUČIAI;9134734376;Ne;4;0;0;4
17439;Giliukas;ČIAUŠKUČIAI;3728323646;Ne;13;0;0;13
17440;Giliukas;ČIAUŠKUČIAI;1710286878;Ne;14;0;0;14
17441;Giliukas;ČIAUŠKUČIAI;6203352124;Taip;1;1;1;3
17442;Giliukas;ČIAUŠKUČIAI;9704885611;Ne;1;1;0;2
17443;Giliukas;ČIAUŠKUČIAI;7993049824;Ne;9;0;0;9
17444;Giliukas;ČIAUŠKUČIAI;2700296404;Ne;7;0;0;7
17445;Giliukas;ČIAUŠKUČIAI;7412960823;Taip;0;2;0;2
17446;Giliukas;ČIAUŠKUČIAI;9160815037;Taip;0;1;0;1
17447;Giliukas;ČIAUŠKUČIAI;1221640023;Ne;1;2;1;4
17448;Giliukas;ČIAUŠKUČIAI;2298554837;Ne;2;0;2;4
17449;Giliukas;ČIAUŠKUČIAI;6489845832;Ne;5;0;0;5
17450;Giliukas;ŠNEKUČIAI;1762536884;Ne;0;2;0;2
17451;Giliukas;ŠNEKUČIAI;2612551188;Ne;2;0;0;2
17452;Giliukas;ŠNEKUČIAI;9366734581;Taip;0;2;0;2
17453;Giliukas;ŠNEKUČIAI;7053406257;Ne;6;0;0;6
17454;Giliukas;ŠNEKUČIAI;2226855971;Ne;5;2;0;7
17455;Giliukas;ŠNEKUČIAI;2742106493;Ne;3;6;0;9
17456;Giliukas;ŠNEKUČIAI;3726149759;Ne;0;1;0;1
17457;Giliukas;ŠNEKUČIAI;6953123617;Ne;0;2;0;2
17458;Giliukas;ŠNEKUČIAI;4581414740;Taip;11;1;0;12
17459;Giliukas;ŠNEKUČIAI;7431116067;Ne;3;0;0;3
17460;Giliukas;ŠNEKUČIAI;7205807049;Ne;5;10;0;15
17461;Giliukas;ŠNEKUČIAI;1165810193;Ne;5;10;0;15
17462;Giliukas;ŠNEKUČIAI;1916905497;Ne;7;0;0;7
17463;Giliukas;ŠNEKUČIAI;4207939009;Ne;7;0;1;8
17464;Giliukas;ŠNEKUČIAI;5625404051;Ne;4;2;1;7
17465;"Lazdynų mokykla (Žėručio g. 4)";LEPG;7487278074;Ne;0;0;2;2
17466;"Lazdynų mokykla (Žėručio g. 4)";LEPG;7320049068;Ne;0;0;2;2
17467;"Lazdynų mokykla (Žėručio g. 4)";LEPG;1396367371;Ne;0;0;1;1
17468;"Lazdynų mokykla (Žėručio g. 4)";LEPG;7324846434;Ne;0;0;1;1
17469;"Lazdynų mokykla (Žėručio g. 4)";LEPG;7659209862;Ne;8;0;1;9
17470;"Lazdynų mokykla (Žėručio g. 4)";LEPG;3435025978;Ne;0;0;2;2
17471;"Lazdynų mokykla (Žėručio g. 4)";LEPG;1738732866;Ne;0;0;1;1
17472;"Lazdynų mokykla (Žėručio g. 4)";LEPG;3268305561;Ne;3;0;0;3
17473;"Lazdynų mokykla (Žėručio g. 4)";LEPG;4562536818;Taip;0;0;1;1
17474;"Lazdynų mokykla (Žėručio g. 4)";LEPG;2666441234;Ne;3;0;0;3
17475;"Lazdynų mokykla (Žėručio g. 4)";LEPG;9382900638;Ne;14;0;0;14
17476;"Lazdynų mokykla (Žėručio g. 4)";LEPG;1624578455;Ne;14;0;0;14
17477;"Lazdynų mokykla (Žėručio g. 4)";RUPG-1;4776074273;Ne;5;0;0;5
17478;"Lazdynų mokykla (Žėručio g. 4)";RUPG-1;2004786841;Ne;0;20;0;20
17479;"Lazdynų mokykla (Žėručio g. 4)";RUPG-1;7647195979;Ne;2;0;0;2
17480;"Lazdynų mokykla (Žėručio g. 4)";RUPG-1;4715171946;Ne;11;0;0;11
17481;"Lazdynų mokykla (Žėručio g. 4)";RUPG-1;2700475528;Ne;1;0;0;1
17482;"Lazdynų mokykla (Žėručio g. 4)";RUPG-1;5015519090;Ne;4;0;0;4
17483;"Lazdynų mokykla (Žėručio g. 4)";RUPG-1;9968637187;Ne;4;0;0;4
17484;"Lazdynų mokykla (Žėručio g. 4)";RUPG-1;8886654664;Ne;7;0;0;7
17485;"Lazdynų mokykla (Žėručio g. 4)";RUPG-1;1351714626;Ne;1;0;0;1
17486;"Lazdynų mokykla (Žėručio g. 4)";RUPG-1;2035060922;Ne;2;0;0;2
17487;"Lazdynų mokykla (Žėručio g. 4)";RUPG-2;8720878006;Ne;0;20;0;20
17488;"Lazdynų mokykla (Žėručio g. 4)";RUPG-2;8675089149;Ne;0;0;1;1
17489;"Lazdynų mokykla (Žėručio g. 4)";RUPG-2;7963866641;Ne;0;0;3;3
17490;"Lazdynų mokykla (Žėručio g. 4)";RUPG-2;9982496951;Ne;0;0;2;2
17491;"Lazdynų mokykla (Žėručio g. 4)";RUPG-2;8229454863;Taip;0;0;1;1
17492;"Lazdynų mokykla (Žėručio g. 4)";RUPG-2;1118653070;Ne;0;1;0;1
17493;"Lazdynų mokykla (Žėručio g. 4)";RUPG-2;5806696915;Ne;5;0;0;5
17494;"Lazdynų mokykla (Žėručio g. 4)";RUPG-2;5770044886;Ne;5;2;0;7
17495;"Lazdynų mokykla (Žėručio g. 4)";RUPG-2;2539006620;Ne;0;20;0;20
17496;"Lazdynų mokykla (Žėručio g. 4)";RUPG-2;8757701456;Ne;3;2;0;5
17497;"Lazdynų mokykla (Žėručio g. 4)";RUPG-2;4165354124;Ne;0;3;0;3
17498;"„Atžalyno” mokykla-darželis";Giliukai;1961428224;Ne;5;20;0;25
17499;"„Atžalyno” mokykla-darželis";Giliukai;9101301819;Ne;15;0;1;16
17500;"„Atžalyno” mokykla-darželis";Giliukai;8320161812;Ne;16;0;0;16
17501;"„Atžalyno” mokykla-darželis";Giliukai;4784990018;Ne;2;0;1;3
17502;"„Atžalyno” mokykla-darželis";Giliukai;2462839180;Ne;4;0;1;5
17503;"„Atžalyno” mokykla-darželis";Giliukai;8070499557;Ne;4;0;3;7
17504;"„Atžalyno” mokykla-darželis";Giliukai;1915676392;Ne;2;0;0;2
17505;"„Atžalyno” mokykla-darželis";Giliukai;9913048992;Ne;6;0;0;6
17506;"„Atžalyno” mokykla-darželis";Giliukai;5335059675;Ne;5;0;1;6
17507;"„Atžalyno” mokykla-darželis";Giliukai;9690554753;Ne;15;0;2;17
17508;"„Atžalyno” mokykla-darželis";Giliukai;7579781779;Ne;10;0;0;10
17509;"„Atžalyno” mokykla-darželis";Giliukai;7883570492;Ne;3;0;1;4
17510;"„Atžalyno” mokykla-darželis";Giliukai;4616870552;Ne;7;0;2;9
17511;"„Atžalyno” mokykla-darželis";Giliukai;5986664970;Ne;4;0;5;9
17512;"„Atžalyno” mokykla-darželis";Giliukai;6903825217;Ne;9;0;1;10
17513;"„Atžalyno” mokykla-darželis";Riešutėliai;4360099345;Ne;11;3;0;14
17514;"„Atžalyno” mokykla-darželis";Riešutėliai;5947938371;Ne;11;0;2;13
17515;"„Atžalyno” mokykla-darželis";Riešutėliai;5384245347;Ne;7;7;0;14
17516;"„Atžalyno” mokykla-darželis";Riešutėliai;4246430352;Ne;20;0;0;20
17517;"„Atžalyno” mokykla-darželis";Riešutėliai;8574494664;Ne;12;5;0;17
17518;"„Atžalyno” mokykla-darželis";Riešutėliai;5815412814;Ne;0;0;4;4
17519;"„Atžalyno” mokykla-darželis";Riešutėliai;8942132574;Ne;9;2;0;11
17520;"„Atžalyno” mokykla-darželis";Riešutėliai;3564781987;Ne;0;1;0;1
17521;"„Atžalyno” mokykla-darželis";Riešutėliai;7368616441;Taip;8;0;4;12
17522;"„Atžalyno” mokykla-darželis";Riešutėliai;5242752663;Ne;16;0;0;16
17523;"„Atžalyno” mokykla-darželis";Riešutėliai;5709028342;Ne;10;0;0;10
17524;"„Atžalyno” mokykla-darželis";Riešutėliai;5994983369;Ne;0;9;0;9
17525;"„Atžalyno” mokykla-darželis";Riešutėliai;7676614240;Ne;0;1;1;2
17526;"„Atžalyno” mokykla-darželis";Riešutėliai;3751729666;Ne;7;0;3;10
17527;"„Atžalyno” mokykla-darželis";Riešutėliai;3441950153;Ne;0;10;0;10
17528;"„Atžalyno” mokykla-darželis";Riešutėliai;4223591454;Ne;0;1;0;1
17529;"„Atžalyno” mokykla-darželis";Riešutėliai;8625074554;Ne;0;4;0;4
17530;"„Atžalyno” mokykla-darželis";Riešutėliai;6307949550;Ne;24;0;0;24
17531;"„Atžalyno” mokykla-darželis";Riešutėliai;7625074947;Ne;19;0;1;20
17532;"„Atžalyno” mokykla-darželis";Žirniukai;9737568538;Ne;1;0;1;2
17533;"„Atžalyno” mokykla-darželis";Žirniukai;3312254613;Ne;0;2;0;2
17534;"„Atžalyno” mokykla-darželis";Žirniukai;1443004141;Ne;0;0;7;7
17535;"„Atžalyno” mokykla-darželis";Žirniukai;5406800599;Ne;5;9;0;14
17536;"„Atžalyno” mokykla-darželis";Žirniukai;2849915655;Ne;0;1;0;1
17537;"„Atžalyno” mokykla-darželis";Žirniukai;6120955217;Taip;21;2;0;23
17538;"„Atžalyno” mokykla-darželis";Žirniukai;1787256844;Ne;15;1;0;16
17539;"„Atžalyno” mokykla-darželis";Žirniukai;2547003287;Ne;15;1;0;16
17540;"„Atžalyno” mokykla-darželis";Žirniukai;4503448206;Ne;0;0;1;1
17541;"„Atžalyno” mokykla-darželis";Žirniukai;3664056583;Ne;3;7;0;10
17542;"„Atžalyno” mokykla-darželis";Žirniukai;5456248305;Taip;5;0;0;5
17543;"„Atžalyno” mokykla-darželis";Žirniukai;3719072139;Ne;10;0;0;10
17544;"„Atžalyno” mokykla-darželis";Žirniukai;9245994735;Ne;20;2;0;22
17545;"„Atžalyno” mokykla-darželis";Žirniukai;2000352986;Ne;0;2;0;2
17546;"„Atžalyno” mokykla-darželis";Žirniukai;2177213062;Ne;3;0;0;3
17547;"„Atžalyno” mokykla-darželis";Žirniukai;4635394632;Ne;3;0;1;4
17548;"„Atžalyno” mokykla-darželis";Žirniukai;3524131672;Ne;9;0;0;9
17549;"„Atžalyno” mokykla-darželis";Žirniukai;4840490901;Ne;20;0;1;21
17550;"„Atžalyno” mokykla-darželis";Žirniukai;4796052680;Ne;10;0;1;11
17551;"„Atžalyno” mokykla-darželis";Žirniukai;3181675972;Ne;6;0;0;6
17552;"„Atžalyno” mokykla-darželis";Žirniukai;8163063211;Ne;0;0;4;4
17553;"„Atžalyno” mokykla-darželis";Žirniukai;4431437971;Ne;0;1;1;2
17554;"„Atžalyno” mokykla-darželis";VYŠNIUKAI;3770167696;Ne;5;0;7;12
17555;"„Atžalyno” mokykla-darželis";VYŠNIUKAI;9216535506;Ne;26;0;0;26
17556;"„Atžalyno” mokykla-darželis";VYŠNIUKAI;6960661098;Ne;21;0;0;21
17557;"„Atžalyno” mokykla-darželis";VYŠNIUKAI;1059756637;Ne;19;0;2;21
17558;"„Atžalyno” mokykla-darželis";VYŠNIUKAI;7999992997;Ne;24;0;0;24
17559;"„Atžalyno” mokykla-darželis";VYŠNIUKAI;8872288787;Ne;17;2;2;21
17560;"„Atžalyno” mokykla-darželis";VYŠNIUKAI;5410469885;Ne;8;0;0;8
17561;"„Atžalyno” mokykla-darželis";VYŠNIUKAI;5878874414;Ne;2;3;0;5
17562;"„Atžalyno” mokykla-darželis";VYŠNIUKAI;3930056490;Ne;12;0;0;12
17563;"„Atžalyno” mokykla-darželis";VYŠNIUKAI;6984404118;Ne;10;0;0;10
17564;"„Atžalyno” mokykla-darželis";VYŠNIUKAI;6939741360;Ne;12;1;0;13
17565;"„Atžalyno” mokykla-darželis";VYŠNIUKAI;5398871923;Ne;15;0;0;15
17566;"„Atžalyno” mokykla-darželis";VYŠNIUKAI;3046953980;Ne;10;0;0;10
17567;"„Atžalyno” mokykla-darželis";VYŠNIUKAI;2825064244;Ne;20;1;0;21
17568;"„Atžalyno” mokykla-darželis";VYŠNIUKAI;3768908704;Ne;14;0;2;16
17569;"„Atžalyno” mokykla-darželis";VYŠNIUKAI;6959131424;Ne;4;1;0;5
17570;"„Atžalyno” mokykla-darželis";VYŠNIUKAI;1851189680;Ne;4;0;0;4
17571;"„Atžalyno” mokykla-darželis";VYŠNIUKAI;5562429493;Ne;8;0;0;8
17572;"„Atžalyno” mokykla-darželis";PIPIRIUKAI;8357021249;Ne;5;0;0;5
17573;"„Atžalyno” mokykla-darželis";PIPIRIUKAI;4785607785;Ne;5;0;0;5
17574;"„Atžalyno” mokykla-darželis";PIPIRIUKAI;5615246040;Ne;0;0;4;4
17575;"„Atžalyno” mokykla-darželis";PIPIRIUKAI;1988657552;Ne;17;0;8;25
17576;"„Atžalyno” mokykla-darželis";PIPIRIUKAI;6721771665;Taip;2;0;4;6
17577;"„Atžalyno” mokykla-darželis";PIPIRIUKAI;2921181385;Ne;0;0;4;4
17578;"„Atžalyno” mokykla-darželis";PIPIRIUKAI;2108706876;Ne;6;0;0;6
17579;"„Atžalyno” mokykla-darželis";PIPIRIUKAI;1228919159;Ne;5;5;0;10
17580;"„Atžalyno” mokykla-darželis";PIPIRIUKAI;3919301151;Ne;0;0;3;3
17581;"„Atžalyno” mokykla-darželis";PIPIRIUKAI;3624299098;Ne;0;1;0;1
17582;"„Atžalyno” mokykla-darželis";PIPIRIUKAI;2537063401;Ne;0;0;4;4
17583;"„Atžalyno” mokykla-darželis";PIPIRIUKAI;8372179128;Ne;0;0;1;1
17584;"„Atžalyno” mokykla-darželis";PIPIRIUKAI;3204191459;Ne;10;4;0;14
17585;"„Atžalyno” mokykla-darželis";PIPIRIUKAI;5321475187;Ne;3;1;1;5
17586;"„Atžalyno” mokykla-darželis";PIPIRIUKAI;3015863723;Ne;6;3;0;9
17587;"„Atžalyno” mokykla-darželis";PIPIRIUKAI;3323233525;Ne;8;1;0;9
17588;"„Atžalyno” mokykla-darželis";PIPIRIUKAI;4596770586;Ne;11;0;1;12
17589;"„Atžalyno” mokykla-darželis";PIPIRIUKAI;1664011018;Ne;23;0;1;24
17590;"„Atžalyno” mokykla-darželis";PIPIRIUKAI;3555868198;Ne;3;0;4;7
17591;"„Atžalyno” mokykla-darželis";PIPIRIUKAI;1866452425;Ne;0;0;2;2
17592;"Vilniaus Naujininkų mokykla";"SAULĖS ZUIKUČIAI";9856315057;Taip;7;1;0;8
17593;"Vilniaus Naujininkų mokykla";"SAULĖS ZUIKUČIAI";1901250406;Ne;0;3;0;3
17594;"Vilniaus Naujininkų mokykla";"SAULĖS ZUIKUČIAI";9411054207;Ne;2;0;0;2
17595;"Vilniaus Naujininkų mokykla";"SAULĖS ZUIKUČIAI";9544088525;Ne;0;2;0;2
17596;"Vilniaus Naujininkų mokykla";"SAULĖS ZUIKUČIAI";9488762308;Ne;16;0;0;16
17597;"Vilniaus Naujininkų mokykla";"SAULĖS ZUIKUČIAI";3929956703;Ne;12;0;0;12
17598;"Vilniaus Naujininkų mokykla";"SAULĖS ZUIKUČIAI";4675274695;Ne;11;0;0;11
17599;"Vilniaus Naujininkų mokykla";"SAULĖS ZUIKUČIAI";3243090025;Ne;8;0;0;8
17600;"Vilniaus Naujininkų mokykla";"SAULĖS ZUIKUČIAI";9786654519;Ne;4;0;0;4
17601;"Vilniaus Naujininkų mokykla";"SAULĖS ZUIKUČIAI";6235626283;Ne;5;0;0;5
17602;"Vilniaus Naujininkų mokykla";"SAULĖS ZUIKUČIAI";9699407871;Ne;0;1;0;1
17603;"Vilniaus Naujininkų mokykla";SMALSUČIAI;3654667879;Ne;1;0;0;1
17604;"Vilniaus Naujininkų mokykla";SMALSUČIAI;5236782382;Ne;15;0;0;15
17605;"Vilniaus Naujininkų mokykla";SMALSUČIAI;7020599764;Ne;0;0;1;1
17606;"Vilniaus Naujininkų mokykla";SMALSUČIAI;3192556582;Ne;0;6;0;6
17607;"Vilniaus Naujininkų mokykla";SMALSUČIAI;1460027521;Ne;0;0;2;2
17608;"Vilniaus Naujininkų mokykla";SMALSUČIAI;9993335478;Ne;3;0;1;4
17609;"Vilniaus Naujininkų mokykla";SMALSUČIAI;9990953133;Ne;0;0;1;1
17610;"Vilniaus Naujininkų mokykla";SMALSUČIAI;1306106945;Ne;2;0;1;3
17611;"Vilniaus Naujininkų mokykla";SMALSUČIAI;8555610571;Ne;6;0;1;7
17612;"Vilniaus Naujininkų mokykla";SMALSUČIAI;8637047688;Ne;2;0;1;3
17613;"Vilniaus Naujininkų mokykla";SMALSUČIAI;6417648753;Ne;0;0;1;1
17614;"Vilniaus Naujininkų mokykla";SMALSUČIAI;7407987673;Ne;0;1;0;1
17615;"Vilniaus Naujininkų mokykla";SMALSUČIAI;8935072613;Ne;8;0;1;9
17616;"Vilniaus Naujininkų mokykla";SMALSUČIAI;8352550813;Ne;3;0;1;4
17617;"Vilniaus Naujininkų mokykla";SMALSUČIAI;5512321795;Ne;0;2;0;2
17618;"Vilniaus Naujininkų mokykla";SMALSUČIAI;3810550099;Ne;0;1;0;1
17619;"Vilniaus Naujininkų mokykla";SMALSUČIAI;1096474672;Ne;7;0;0;7
17620;"Vilniaus karaliaus Mindaugo mokykla";"PUG 2";3170928052;Ne;4;0;0;4
17621;"Vilniaus karaliaus Mindaugo mokykla";"PUG 2";7615716438;Ne;0;2;0;2
17622;"Vilniaus karaliaus Mindaugo mokykla";"PUG 2";8229593318;Ne;0;1;0;1
17623;"Vilniaus karaliaus Mindaugo mokykla";"PUG 2";4143844589;Ne;2;0;0;2
17624;"Vilniaus karaliaus Mindaugo mokykla";"PUG 2";7236658561;Taip;2;0;0;2
17625;"Vilniaus karaliaus Mindaugo mokykla";"PUG 2";6384832317;Ne;4;0;0;4
17626;"Vilniaus karaliaus Mindaugo mokykla";"PUG 2";9670205249;Ne;1;0;0;1
17627;"Vilniaus karaliaus Mindaugo mokykla";"PUG 2";3741784446;Ne;5;16;0;21
17628;"Vilniaus karaliaus Mindaugo mokykla";"PUG 2";8578903763;Ne;1;0;0;1
17629;"Vilniaus karaliaus Mindaugo mokykla";"PUG 2";3281475303;Ne;1;0;0;1
17630;"Vilniaus karaliaus Mindaugo mokykla";"PUG 2";4920263429;Taip;2;0;0;2
17631;"Vilniaus karaliaus Mindaugo mokykla";"PUG 1";7043125057;Ne;0;0;9;9
17632;"Vilniaus karaliaus Mindaugo mokykla";"PUG 1";1998073387;Ne;8;0;1;9
17633;"Vilniaus karaliaus Mindaugo mokykla";"PUG 1";4405567649;Ne;0;0;1;1
17634;"Vilniaus karaliaus Mindaugo mokykla";"PUG 1";5752454925;Ne;0;0;1;1
17635;"Vilniaus karaliaus Mindaugo mokykla";"PUG 1";5946007985;Ne;0;0;1;1
17636;"Vilniaus karaliaus Mindaugo mokykla";"PUG 1";3953844737;Ne;0;5;0;5
17637;"Vilniaus karaliaus Mindaugo mokykla";"PUG 1";9651789217;Ne;0;0;5;5
17638;"Vilniaus karaliaus Mindaugo mokykla";"PUG 1";2926077771;Ne;0;6;0;6
17639;"Vilniaus karaliaus Mindaugo mokykla";"PUG 1";2361829423;Ne;5;0;0;5
17640;"Vilniaus karaliaus Mindaugo mokykla";"PUG 3";6406285034;Ne;0;3;7;10
17641;"Vilniaus karaliaus Mindaugo mokykla";"PUG 3";7433354196;Ne;0;0;4;4
17642;"Vilniaus karaliaus Mindaugo mokykla";"PUG 3";3252419072;Ne;0;0;1;1
17643;"Vilniaus karaliaus Mindaugo mokykla";"PUG 3";9056468879;Ne;0;0;1;1
17644;"Vilniaus karaliaus Mindaugo mokykla";"PUG 3";2044795759;Ne;12;0;0;12
17645;"Vilniaus karaliaus Mindaugo mokykla";"PUG 3";5613442667;Ne;0;0;2;2
17646;"Vilniaus karaliaus Mindaugo mokykla";"PUG 3";7149197796;Ne;0;21;0;21
17647;"Vilniaus karaliaus Mindaugo mokykla";"PUG 3";6762306583;Ne;2;0;2;4
17648;"Vilniaus Liepkalnio Pagrindinė Mokykla";Bitutės;3144718477;Ne;0;0;2;2
17649;"Vilniaus Liepkalnio Pagrindinė Mokykla";Bitutės;5682528849;Ne;3;0;0;3
17650;"Vilniaus Liepkalnio Pagrindinė Mokykla";Bitutės;8723898832;Ne;0;0;1;1
17651;"Vilniaus Liepkalnio Pagrindinė Mokykla";Bitutės;8080492986;Ne;11;0;0;11
17652;"Vilniaus Liepkalnio Pagrindinė Mokykla";Bitutės;3239288878;Ne;5;0;0;5
17653;"Vilniaus Liepkalnio Pagrindinė Mokykla";Bitutės;6829438486;Ne;4;0;2;6
17654;"Vilniaus Liepkalnio Pagrindinė Mokykla";Bitutės;3369970611;Ne;7;0;1;8
17655;"Vilniaus Liepkalnio Pagrindinė Mokykla";Bitutės;4344780723;Ne;0;0;9;9
17656;"Vilniaus Pranciškaus Skorinos gimnazija";SAULYTĖ;8946940285;Ne;0;0;6;6
17657;"Vilniaus Pranciškaus Skorinos gimnazija";SAULYTĖ;2978563798;Ne;0;10;0;10
17658;"Vilniaus Pranciškaus Skorinos gimnazija";SAULYTĖ;2347857813;Ne;2;0;1;3
17659;"Vilniaus Pranciškaus Skorinos gimnazija";SAULYTĖ;2220506064;Ne;4;3;0;7
17660;"Vilniaus Pranciškaus Skorinos gimnazija";SAULYTĖ;1797706575;Ne;0;3;1;4
17661;"Vilniaus Pranciškaus Skorinos gimnazija";SAULYTĖ;9424930375;Ne;1;3;1;5
17662;"Vilniaus Pranciškaus Skorinos gimnazija";SAULYTĖ;3558729735;Ne;4;0;1;5
17663;"Vilniaus Pranciškaus Skorinos gimnazija";SAULYTĖ;2290343066;Ne;0;29;0;29
17664;"Vilniaus Pranciškaus Skorinos gimnazija";SAULYTĖ;4500542668;Ne;0;0;1;1
17665;"Vilniaus Pranciškaus Skorinos gimnazija";SAULYTĖ;4719223490;Ne;1;0;0;1
17666;"Vilniaus Pranciškaus Skorinos gimnazija";SAULYTĖ;6892006495;Ne;0;5;0;5
17667;"Vilniaus Simono Konarskio mokykla";"1 GR.";9988467124;Ne;10;0;0;10
17668;"Vilniaus Simono Konarskio mokykla";"1 GR.";4029765504;Taip;3;0;0;3
17669;"Vilniaus Simono Konarskio mokykla";"1 GR.";4713033873;Ne;10;0;0;10
17670;"Vilniaus Simono Konarskio mokykla";"1 GR.";1532248269;Ne;2;0;0;2
17671;"Vilniaus Simono Konarskio mokykla";"1 GR.";3675401775;Ne;2;0;0;2
17672;"Vilniaus Simono Konarskio mokykla";"1 GR.";3641822841;Ne;6;0;0;6
17673;"Vilniaus Simono Konarskio mokykla";"1 GR.";4858617162;Ne;6;0;0;6
17674;"Vilniaus Simono Konarskio mokykla";"1 GR.";9205217788;Ne;3;0;0;3
17675;"Vilniaus Simono Konarskio mokykla";"1 GR.";9065848425;Ne;4;0;0;4
17676;"Vilniaus Trakų Vokės gimnazija";DRUGELIAI;8874384610;Ne;12;0;1;13
17677;"Vilniaus Trakų Vokės gimnazija";DRUGELIAI;4535167417;Ne;0;0;1;1
17678;"Vilniaus Trakų Vokės gimnazija";DRUGELIAI;2453791555;Ne;18;0;2;20
17679;"Vilniaus Trakų Vokės gimnazija";DRUGELIAI;4854440884;Ne;12;0;1;13
17680;"Vilniaus Trakų Vokės gimnazija";DRUGELIAI;2761614687;Ne;13;0;1;14
17681;"Vilniaus Trakų Vokės gimnazija";DRUGELIAI;8706990390;Ne;0;0;1;1
17682;"Vilniaus Trakų Vokės gimnazija";DRUGELIAI;9094930495;Ne;0;0;1;1
17683;"Vilniaus Trakų Vokės gimnazija";DRUGELIAI;9483709021;Ne;0;8;0;8
17684;"Vilniaus Trakų Vokės gimnazija";DRUGELIAI;2880299812;Ne;10;0;0;10
17685;"Vilniaus Trakų Vokės gimnazija";DRUGELIAI;9506008651;Ne;13;0;0;13
17686;"Vilniaus Trakų Vokės gimnazija";DRUGELIAI;1360046096;Ne;6;0;1;7
17687;"Vilniaus Trakų Vokės gimnazija";DRUGELIAI;2503382218;Ne;0;4;0;4
17688;"Vilniaus Trakų Vokės gimnazija";DRUGELIAI;3278842582;Ne;0;0;1;1
17689;"Vilniaus Trakų Vokės gimnazija";DRUGELIAI;3611639112;Ne;0;0;1;1
17690;"Vilniaus Trakų Vokės gimnazija";DRUGELIAI;8605461082;Ne;7;0;0;7
17691;"Vilniaus Trakų Vokės gimnazija";DRUGELIAI;3328527700;Ne;1;0;0;1
17692;"Vilniaus Trakų Vokės gimnazija";DRUGELIAI;5206616285;Ne;0;0;1;1
17693;"Vilniaus Trakų Vokės gimnazija";DRUGELIAI;8929514493;Ne;1;0;0;1
17694;"Vilniaus Trakų Vokės gimnazija";DRUGELIAI;9233090228;Ne;0;0;3;3
17695;"Vilniaus Trakų Vokės gimnazija";VOVERIUKAI;1088928094;Ne;3;0;0;3
17696;"Vilniaus Trakų Vokės gimnazija";VOVERIUKAI;7318458282;Ne;0;1;0;1
17697;"Vilniaus Trakų Vokės gimnazija";VOVERIUKAI;1080300137;Ne;0;7;0;7
17698;"Vilniaus Trakų Vokės gimnazija";VOVERIUKAI;2469340933;Ne;2;1;0;3
17699;"Vilniaus Trakų Vokės gimnazija";VOVERIUKAI;6908913934;Ne;13;1;0;14
17700;"Vilniaus Trakų Vokės gimnazija";VOVERIUKAI;4362066941;Ne;0;3;0;3
17701;"Vilniaus Trakų Vokės gimnazija";VOVERIUKAI;3209594216;Ne;1;0;0;1
17702;"Vilniaus Trakų Vokės gimnazija";VOVERIUKAI;3555513755;Ne;1;0;3;4
17703;"Vilniaus Trakų Vokės gimnazija";VOVERIUKAI;5338798362;Ne;8;0;0;8
17704;"Vilniaus Trakų Vokės gimnazija";VOVERIUKAI;9582511053;Ne;0;9;0;9
17705;"Vilniaus Trakų Vokės gimnazija";VOVERIUKAI;1039690987;Ne;1;0;0;1
17706;"Vilniaus Trakų Vokės gimnazija";VOVERIUKAI;6908487075;Ne;5;0;1;6
17707;"Vilniaus Trakų Vokės gimnazija";VOVERIUKAI;1910363787;Ne;2;1;0;3
17708;"Vilniaus Trakų Vokės gimnazija";VOVERIUKAI;7858812338;Ne;1;4;0;5
17709;"Vilniaus Trakų Vokės gimnazija";VOVERIUKAI;3913623741;Ne;2;0;0;2
17710;"Vilniaus Trakų Vokės gimnazija";VOVERIUKAI;4520091712;Ne;8;0;1;9
17711;"Vilniaus Trakų Vokės gimnazija";VOVERIUKAI;8168960897;Ne;3;4;0;7
17712;"Vilniaus Trakų Vokės gimnazija";VOVERIUKAI;1057189769;Ne;5;3;2;10
17713;"Vilniaus Trakų Vokės gimnazija";VOVERIUKAI;4014027030;Ne;3;0;1;4
17714;"Vilniaus Trakų Vokės gimnazija";VOVERIUKAI;7660240598;Ne;0;15;0;15
17715;"Vilniaus Trakų Vokės gimnazija";VOVERIUKAI;4438127190;Ne;22;0;1;23
17716;"Vilniaus Trakų Vokės gimnazija";VOVERIUKAI;2388817616;Ne;4;7;0;11
17717;"Vilniaus Trakų Vokės gimnazija";VOVERIUKAI;8472834181;Ne;2;1;0;3
17718;"Vilniaus Trakų Vokės gimnazija";BITUTĖS;6369848950;Ne;6;0;1;7
17719;"Vilniaus Trakų Vokės gimnazija";BITUTĖS;6732422645;Taip;0;0;5;5
17720;"Vilniaus Trakų Vokės gimnazija";BITUTĖS;7909596435;Ne;2;0;0;2
17721;"Vilniaus Trakų Vokės gimnazija";BITUTĖS;6751625456;Ne;13;0;0;13
17722;"Vilniaus Trakų Vokės gimnazija";BITUTĖS;7752786907;Ne;12;0;0;12
17723;"Vilniaus Trakų Vokės gimnazija";BITUTĖS;9819489467;Ne;7;0;0;7
17724;"Vilniaus Trakų Vokės gimnazija";BITUTĖS;2571561865;Ne;2;0;3;5
17725;"Vilniaus Trakų Vokės gimnazija";BITUTĖS;4601374629;Ne;5;0;0;5
17726;"Vilniaus Trakų Vokės gimnazija";BITUTĖS;9051697544;Ne;7;0;0;7
17727;"Vilniaus Trakų Vokės gimnazija";BITUTĖS;3346395516;Ne;0;0;2;2
17728;"Vilniaus Trakų Vokės gimnazija";BITUTĖS;9453317084;Ne;3;0;4;7
17729;"Vilniaus Trakų Vokės gimnazija";BITUTĖS;2869217654;Taip;0;2;1;3
17730;"Vilniaus Trakų Vokės gimnazija";BITUTĖS;7508070996;Ne;21;0;0;21
17731;"Vilniaus Trakų Vokės gimnazija";BITUTĖS;1602352855;Ne;0;0;3;3
17732;"Vilniaus Trakų Vokės gimnazija";BITUTĖS;5695160925;Ne;16;0;2;18
17733;"Vilniaus Trakų Vokės gimnazija";BITUTĖS;9668538340;Ne;0;1;0;1
17734;"Vilniaus Trakų Vokės gimnazija";BITUTĖS;3449317958;Ne;2;0;5;7
17735;"Vilniaus Trakų Vokės gimnazija";BITUTĖS;1398572100;Ne;7;0;2;9
17736;"Vilniaus Trakų Vokės gimnazija";BITUTĖS;2469486746;Ne;5;0;1;6
17737;"Vilniaus Ryto progimnazija";RYTUKAI;3397350274;Ne;4;0;0;4
17738;"Vilniaus Ryto progimnazija";RYTUKAI;4822495270;Ne;0;0;3;3
17739;"Vilniaus Ryto progimnazija";RYTUKAI;3235523199;Ne;4;0;0;4
17740;"Vilniaus Ryto progimnazija";RYTUKAI;2537442505;Taip;0;0;1;1
17741;"Vilniaus Ryto progimnazija";RYTUKAI;7365398150;Ne;0;0;2;2
17742;"Vilniaus Ryto progimnazija";RYTUKAI;3461165182;Ne;8;0;2;10
17743;"Vilniaus Ryto progimnazija";RYTUKAI;7638618099;Ne;0;3;3;6
17744;"Vilniaus Ryto progimnazija";RYTUKAI;5494350183;Taip;0;0;3;3
17745;"Vilniaus Ryto progimnazija";RYTUKAI;5148002236;Ne;4;0;0;4
17746;"Vilniaus Ryto progimnazija";RYTUKAI;2921485707;Ne;7;0;0;7
17747;"Vilniaus Salininkų gimnazija";"Priešmokyklinė A";8995565864;Ne;0;4;0;4
17748;"Vilniaus Salininkų gimnazija";"Priešmokyklinė A";6327046935;Ne;4;0;0;4
17749;"Vilniaus Salininkų gimnazija";"Priešmokyklinė A";4425748908;Ne;0;1;0;1
17750;"Vilniaus Salininkų gimnazija";"Priešmokyklinė A";6155979185;Ne;0;2;0;2
17751;"Vilniaus Salininkų gimnazija";"Priešmokyklinė A";7737045952;Ne;0;4;0;4
17752;"Vilniaus Salininkų gimnazija";"PRIEŠMOKYKLINĖ B";5427013789;Ne;2;1;0;3
17753;"Vilniaus Salininkų gimnazija";"PRIEŠMOKYKLINĖ B";3100499807;Ne;2;1;0;3
17754;"Vilniaus Salininkų gimnazija";"PRIEŠMOKYKLINĖ B";5867676844;Ne;3;0;0;3
17755;"Vilniaus Salininkų gimnazija";"PRIEŠMOKYKLINĖ B";1658695150;Ne;1;0;0;1
17756;"Vilniaus Salininkų gimnazija";"PRIEŠMOKYKLINĖ B";2808778763;Taip;3;0;0;3
17757;"Vilniaus Salininkų gimnazija";"PRIEŠMOKYKLINĖ B";8189699392;Ne;1;0;0;1
17758;"Vilniaus Salininkų gimnazija";"PRIEŠMOKYKLINĖ B";3739751121;Ne;1;0;0;1
17759;"Vilniaus Salininkų gimnazija";"PRIEŠMOKYKLINĖ B";7403996266;Taip;1;0;0;1
17760;"Vilniaus Salininkų gimnazija";"PRIEŠMOKYKLINĖ B";2495718547;Ne;3;0;1;4
17761;"Vilniaus Salininkų gimnazija";"PRIEŠMOKYKLINĖ B";9813360176;Ne;2;1;0;3
17762;"Vilniaus Salininkų gimnazija";"PRIEŠMOKYKLINĖ B";6656578271;Ne;1;0;0;1
17763;"Vilniaus Salininkų gimnazija";"PRIEŠMOKYKLINĖ B";6266609965;Ne;2;2;0;4
17764;"Vilniaus Salininkų gimnazija";"PRIEŠMOKYKLINĖ B";3196285660;Ne;2;0;0;2
17765;"Vilniaus Salininkų gimnazija";"PRIEŠMOKYKLINĖ B";4771867627;Ne;3;0;0;3
17766;"Vilniaus „Spindulio“ progimnazija";PM2;8440546956;Ne;3;0;0;3
17767;"Vilniaus „Spindulio“ progimnazija";PM2;1200205376;Ne;2;0;0;2
17768;"Vilniaus „Spindulio“ progimnazija";PM2;1455509576;Ne;2;0;0;2
17769;"Vilniaus „Spindulio“ progimnazija";PM2;6935992202;Ne;5;0;0;5
17770;"Vilniaus „Spindulio“ progimnazija";PM2;4678970810;Ne;3;0;0;3
17771;"Vilniaus „Spindulio“ progimnazija";PM2;3985610575;Taip;1;0;0;1
17772;"Vilniaus „Spindulio“ progimnazija";PM2;4179507316;Ne;2;0;0;2
17773;"Vilniaus „Spindulio“ progimnazija";PM2;8936645508;Taip;0;2;0;2
17774;"Vilniaus „Spindulio“ progimnazija";PM2;3284212595;Ne;1;0;0;1
17775;"Vilniaus „Spindulio“ progimnazija";PM2;8728791932;Ne;6;0;0;6
17776;"Vilniaus „Spindulio“ progimnazija";PM1;8160982025;Ne;2;1;0;3
17777;"Vilniaus „Spindulio“ progimnazija";PM1;5835209357;Ne;1;0;0;1
17778;"Vilniaus „Spindulio“ progimnazija";PM1;6578506861;Ne;2;0;0;2
17779;"Vilniaus „Spindulio“ progimnazija";PM1;9628317328;Ne;0;5;0;5
17780;"Vilniaus „Spindulio“ progimnazija";PM1;6577214344;Ne;10;0;1;11
17781;"Vilniaus „Spindulio“ progimnazija";PM1;5327627748;Ne;2;3;0;5
17782;"Vilniaus „Spindulio“ progimnazija";PM1;6575909478;Ne;0;1;0;1
17783;"Vilniaus „Spindulio“ progimnazija";PM1;6047881184;Ne;0;0;1;1
17784;"Vilniaus „Spindulio“ progimnazija";PM1;6826790492;Ne;0;1;0;1
17785;"Vilniaus „Spindulio“ progimnazija";PM1;2945894661;Ne;2;0;0;2
17786;"Vilniaus „Spindulio“ progimnazija";PM1;1392036584;Ne;2;0;0;2
17787;"Vilniaus „Spindulio“ progimnazija";PM1;8448546818;Ne;0;21;0;21
17788;"Vilniaus „Spindulio“ progimnazija";PM1;4713803167;Ne;1;3;0;4
17789;"Vilniaus „Spindulio“ progimnazija";PM1;9074294473;Taip;5;0;1;6
17790;"Vilniaus Vladislavo Sirokomlės gimnazija";Nykštukai;1588062393;Ne;0;2;0;2
17791;"Vilniaus Vladislavo Sirokomlės gimnazija";Nykštukai;4715704693;Ne;0;5;0;5
17792;"Vilniaus Vladislavo Sirokomlės gimnazija";Nykštukai;6451722893;Ne;7;1;0;8
17793;"Vilniaus Vladislavo Sirokomlės gimnazija";Nykštukai;2923698853;Ne;13;4;0;17
17794;"Vilniaus Vladislavo Sirokomlės gimnazija";Nykštukai;7364698713;Ne;0;2;0;2
17795;"Vilniaus Vladislavo Sirokomlės gimnazija";Nykštukai;6613003059;Ne;0;1;0;1
17796;"Vilniaus Vladislavo Sirokomlės gimnazija";Nykštukai;7113970557;Ne;2;0;0;2
17797;"Vilniaus Vladislavo Sirokomlės gimnazija";Nykštukai;1698478530;Ne;0;2;0;2
17798;"Vilniaus Vladislavo Sirokomlės gimnazija";Nykštukai;7413098580;Ne;2;4;0;6
17799;"Vilniaus Vladislavo Sirokomlės gimnazija";Nykštukai;6843262303;Ne;2;1;0;3
17800;"Vilniaus Vladislavo Sirokomlės gimnazija";Nykštukai;5150028968;Ne;0;1;0;1
17801;"Vilniaus Vladislavo Sirokomlės gimnazija";Nykštukai;5999318972;Ne;4;1;0;5
17802;"Vilniaus Vladislavo Sirokomlės gimnazija";Nykštukai;2092319455;Ne;0;1;0;1
17803;"Vilniaus Vladislavo Sirokomlės gimnazija";Nykštukai;5822045625;Ne;3;0;0;3
17804;"Vilniaus Vladislavo Sirokomlės gimnazija";Nykštukai;2373600520;Ne;2;0;0;2
17805;"Vilniaus Vladislavo Sirokomlės gimnazija";Nykštukai;1272758839;Taip;17;0;0;17
17806;"Vilniaus Vladislavo Sirokomlės gimnazija";Smurfai;2262586409;Ne;0;32;0;32
17807;"Vilniaus Vladislavo Sirokomlės gimnazija";Smurfai;9457457032;Ne;5;0;0;5
17808;"Vilniaus Vladislavo Sirokomlės gimnazija";Smurfai;5041189990;Ne;0;1;0;1
17809;"Vilniaus Vladislavo Sirokomlės gimnazija";Smurfai;7429739147;Ne;4;2;0;6
17810;"Vilniaus Vladislavo Sirokomlės gimnazija";Smurfai;4415030161;Ne;2;2;0;4
17811;"Vilniaus Vladislavo Sirokomlės gimnazija";Smurfai;1386916991;Ne;2;2;0;4
17812;"Vilniaus Vladislavo Sirokomlės gimnazija";Smurfai;2999425729;Ne;0;3;0;3
17813;"Vilniaus Vladislavo Sirokomlės gimnazija";Smurfai;7334310944;Ne;0;1;0;1
17814;"Vilniaus Vladislavo Sirokomlės gimnazija";Smurfai;6385918522;Ne;0;1;0;1
17815;"Vilniaus Vladislavo Sirokomlės gimnazija";Smurfai;3810261864;Ne;7;2;0;9
17816;"Vilniaus Vladislavo Sirokomlės gimnazija";Smurfai;4658530212;Ne;0;4;0;4
17817;"Vilniaus Vladislavo Sirokomlės gimnazija";Smurfai;4191386053;Ne;0;1;0;1
17818;"Vilniaus Vladislavo Sirokomlės gimnazija";Smurfai;3316897176;Ne;2;4;0;6
17819;"Vilniaus „Pelėdos” pradinė mokykla";BITUTĖS;1540892686;Ne;4;0;1;5
17820;"Vilniaus „Pelėdos” pradinė mokykla";BITUTĖS;3247532201;Ne;8;0;1;9
17821;"Vilniaus „Pelėdos” pradinė mokykla";BITUTĖS;5490544278;Ne;0;5;0;5
17822;"Vilniaus „Pelėdos” pradinė mokykla";BITUTĖS;2737277656;Ne;7;0;0;7
17823;"Vilniaus „Pelėdos” pradinė mokykla";BITUTĖS;6191899254;Taip;2;1;0;3
17824;"Vilniaus „Pelėdos” pradinė mokykla";BITUTĖS;6191427974;Ne;2;0;0;2
17825;"Vilniaus „Pelėdos” pradinė mokykla";BITUTĖS;8650379074;Ne;7;0;0;7
17826;"Vilniaus „Pelėdos” pradinė mokykla";BITUTĖS;3318222372;Ne;2;0;0;2
17827;"Vilniaus „Pelėdos” pradinė mokykla";BITUTĖS;5061655822;Ne;1;0;2;3
17828;"Vilniaus „Pelėdos” pradinė mokykla";BITUTĖS;4324931449;Ne;5;0;0;5
17829;"Vilniaus Joachimo Lelevelio inžinerijos mokykla";0A;7508357392;Ne;11;0;0;11
17830;"Vilniaus Joachimo Lelevelio inžinerijos mokykla";0A;9106152447;Ne;0;2;0;2
17831;"Vilniaus Joachimo Lelevelio inžinerijos mokykla";0A;4033866425;Ne;0;1;0;1
17832;"Vilniaus Joachimo Lelevelio inžinerijos mokykla";0A;3649329598;Ne;4;7;0;11
17833;"Vilniaus Joachimo Lelevelio inžinerijos mokykla";0A;7307307882;Ne;0;5;0;5
17834;"Vilniaus Joachimo Lelevelio inžinerijos mokykla";0B;9965517774;Ne;6;6;0;12
17835;"Vilniaus Joachimo Lelevelio inžinerijos mokykla";0B;7138581709;Ne;5;9;0;14
17836;"Vilniaus Joachimo Lelevelio inžinerijos mokykla";0B;7911007041;Taip;0;2;0;2
17837;"Vilniaus Joachimo Lelevelio inžinerijos mokykla";0B;2125410714;Ne;0;2;0;2
17838;"Vilniaus Joachimo Lelevelio inžinerijos mokykla";0B;7956422880;Ne;5;1;0;6
17839;"Vilniaus Joachimo Lelevelio inžinerijos mokykla";0B;8446233414;Ne;1;4;0;5
17840;"Vilniaus Joachimo Lelevelio inžinerijos mokykla";0B;5689369492;Ne;0;1;0;1
17841;"Vilniaus Joachimo Lelevelio inžinerijos mokykla";0B;8797584508;Ne;4;1;0;5
17842;"Vilniaus Joachimo Lelevelio inžinerijos mokykla";0B;7553024183;Ne;11;1;0;12
17843;"Vilniaus Joachimo Lelevelio inžinerijos mokykla";0B;6861062723;Ne;0;11;0;11
17844;"Vilniaus Joachimo Lelevelio inžinerijos mokykla";0B;8703116268;Ne;0;4;0;4
17845;"Vilniaus Joachimo Lelevelio inžinerijos mokykla";0B;4312062240;Ne;3;1;0;4
17846;"Vilniaus Juzefo Ignacijaus Kraševskio gimnazija";DRUGĖLIAI;5157814568;Ne;3;0;0;3
17847;"Vilniaus Juzefo Ignacijaus Kraševskio gimnazija";DRUGĖLIAI;7502911642;Ne;7;0;0;7
17848;"Vilniaus Juzefo Ignacijaus Kraševskio gimnazija";DRUGĖLIAI;6403149921;Ne;5;0;0;5
17849;"Vilniaus Juzefo Ignacijaus Kraševskio gimnazija";DRUGĖLIAI;4257115650;Ne;5;0;0;5
17850;"Vilniaus Juzefo Ignacijaus Kraševskio gimnazija";DRUGĖLIAI;8521846076;Ne;0;5;0;5
17851;"Vilniaus Juzefo Ignacijaus Kraševskio gimnazija";DRUGĖLIAI;6427289718;Ne;7;0;0;7
17852;"Vilniaus Juzefo Ignacijaus Kraševskio gimnazija";DRUGĖLIAI;7685428258;Ne;7;0;0;7
17853;"Vilniaus Juzefo Ignacijaus Kraševskio gimnazija";DRUGĖLIAI;6781303455;Ne;0;1;0;1
17854;"Vilniaus Juzefo Ignacijaus Kraševskio gimnazija";DRUGĖLIAI;6417545510;Taip;2;0;0;2
17855;"Vilniaus Juzefo Ignacijaus Kraševskio gimnazija";DRUGĖLIAI;7841179083;Ne;2;0;0;2
17856;"Vilniaus Juzefo Ignacijaus Kraševskio gimnazija";DRUGĖLIAI;4845049639;Ne;13;0;0;13
17857;"Vilniaus Juzefo Ignacijaus Kraševskio gimnazija";DRUGĖLIAI;3522200752;Ne;8;0;0;8
17858;"Vilniaus Juzefo Ignacijaus Kraševskio gimnazija";DRUGĖLIAI;8808382134;Ne;12;0;0;12
17859;"Vilniaus Juzefo Ignacijaus Kraševskio gimnazija";DRUGĖLIAI;9333766622;Ne;4;5;0;9
17860;"Vilniaus Juzefo Ignacijaus Kraševskio gimnazija";DRUGĖLIAI;3698808100;Ne;0;3;0;3
17861;"Vilniaus Jono Pauliaus II progimnazija";Nykštukai;2493612905;Ne;0;1;0;1
17862;"Vilniaus Jono Pauliaus II progimnazija";Nykštukai;6742119549;Ne;0;7;0;7
17863;"Vilniaus Jono Pauliaus II progimnazija";Nykštukai;8047799576;Ne;0;2;0;2
17864;"Vilniaus Jono Pauliaus II progimnazija";Nykštukai;1381191703;Ne;0;21;0;21
17865;"Vilniaus Jono Pauliaus II progimnazija";Nykštukai;9042329808;Ne;0;1;0;1
17866;"Vilniaus Jono Pauliaus II progimnazija";Nykštukai;5909697341;Ne;0;2;0;2
17867;"Vilniaus Jono Pauliaus II progimnazija";Nykštukai;2948716989;Ne;2;1;0;3
17868;"Vilniaus Jono Pauliaus II progimnazija";Nykštukai;6525761466;Ne;1;0;0;1
17869;"Vilniaus Jono Pauliaus II progimnazija";Nykštukai;1254369602;Ne;1;10;0;11
17870;"Vilniaus Jono Pauliaus II progimnazija";Nykštukai;3346154143;Ne;1;0;0;1
17871;"Vilniaus Jono Pauliaus II progimnazija";Nykštukai;5734602455;Taip;2;0;0;2
17872;"Vilniaus Jono Pauliaus II progimnazija";Nykštukai;8054114720;Ne;0;2;0;2
17873;"Vilniaus Jono Pauliaus II progimnazija";Nykštukai;2190583964;Ne;0;2;0;2
17874;"Vilniaus Jono Pauliaus II progimnazija";Nykštukai;3920229653;Ne;1;0;0;1
17875;"Vilniaus Jono Pauliaus II progimnazija";Nykštukai;8092890260;Ne;0;4;0;4
17876;"Vilniaus Jono Pauliaus II progimnazija";Nykštukai;1795510797;Ne;0;1;0;1
17877;"Vilniaus Jono Pauliaus II progimnazija";Nykštukai;3998988004;Ne;0;5;0;5
17878;"Vilniaus Jono Pauliaus II progimnazija";Nykštukai;6756184787;Ne;0;1;0;1
17879;"Vilniaus Jono Pauliaus II progimnazija";Nykštukai;5768470608;Ne;8;0;0;8
17880;"Vilniaus Jono Pauliaus II progimnazija";Nykštukai;3584347608;Ne;2;1;0;3
17881;"Vilniaus Jono Pauliaus II progimnazija";Žiniukai;3687735991;Ne;1;1;0;2
17882;"Vilniaus Jono Pauliaus II progimnazija";Žiniukai;8678437720;Ne;5;1;0;6
17883;"Vilniaus Jono Pauliaus II progimnazija";Žiniukai;4543822765;Ne;13;1;0;14
17884;"Vilniaus Jono Pauliaus II progimnazija";Žiniukai;7459673719;Ne;0;3;0;3
17885;"Vilniaus Jono Pauliaus II progimnazija";Žiniukai;4566817285;Ne;0;1;0;1
17886;"Vilniaus Jono Pauliaus II progimnazija";Žiniukai;3332865242;Ne;1;0;0;1
17887;"Vilniaus Jono Pauliaus II progimnazija";Žiniukai;5978993456;Ne;2;1;0;3
17888;"Vilniaus Jono Pauliaus II progimnazija";Žiniukai;4288487063;Ne;0;1;0;1
17889;"Vilniaus Jono Pauliaus II progimnazija";Žiniukai;9522524163;Ne;1;1;0;2
17890;"Vilniaus Jono Pauliaus II progimnazija";Žiniukai;6712878938;Ne;2;1;0;3
17891;"Vilniaus Jono Pauliaus II progimnazija";Žiniukai;9414051187;Ne;4;0;1;5
17892;"Vilniaus Jono Pauliaus II progimnazija";Žiniukai;8812316692;Ne;1;0;0;1
17893;"Vilniaus Jono Pauliaus II progimnazija";Žiniukai;9357757604;Ne;5;2;0;7
17894;"Vilniaus Jono Pauliaus II progimnazija";Žiniukai;4291690659;Ne;0;1;0;1
17895;"Vilniaus Jono Pauliaus II progimnazija";Žiniukai;3489127587;Ne;4;5;0;9
17896;"Vilniaus Jono Pauliaus II progimnazija";Žiniukai;3772830210;Ne;7;0;0;7
17897;"Vilniaus Jono Pauliaus II progimnazija";Žiniukai;5043122065;Ne;0;9;0;9
17898;"Vilniaus Jono Pauliaus II progimnazija";Žiniukai;3349199472;Ne;0;2;0;2
17899;"Vilniaus Jono Pauliaus II progimnazija";Žiniukai;2654794460;Ne;6;1;0;7
17900;"Vilniaus Jono Pauliaus II progimnazija";Žiniukai;6478873536;Ne;6;1;0;7
17901;"Vilniaus Jono Pauliaus II progimnazija";Spindulėlis;5492437864;Ne;7;1;0;8
17902;"Vilniaus Jono Pauliaus II progimnazija";Spindulėlis;3269357241;Ne;0;2;0;2
17903;"Vilniaus Jono Pauliaus II progimnazija";Spindulėlis;2840112908;Ne;1;2;0;3
17904;"Vilniaus Jono Pauliaus II progimnazija";Spindulėlis;4433799070;Ne;0;2;0;2
17905;"Vilniaus Jono Pauliaus II progimnazija";Spindulėlis;5440679175;Ne;0;3;0;3
17906;"Vilniaus Jono Pauliaus II progimnazija";Spindulėlis;7178844364;Ne;9;1;0;10
17907;"Vilniaus Jono Pauliaus II progimnazija";Spindulėlis;4426643908;Ne;0;2;0;2
17908;"Vilniaus Jono Pauliaus II progimnazija";Spindulėlis;6281687751;Ne;0;1;0;1
17909;"Vilniaus Jono Pauliaus II progimnazija";Spindulėlis;6996900411;Taip;4;3;0;7
17910;"Vilniaus Jono Pauliaus II progimnazija";Spindulėlis;2090334618;Ne;6;1;1;8
17911;"Vilniaus Jono Pauliaus II progimnazija";Spindulėlis;8753972322;Ne;0;1;1;2
17912;"Vilniaus Jono Pauliaus II progimnazija";Spindulėlis;6435612222;Ne;3;10;1;14
17913;"Vilniaus Jono Pauliaus II progimnazija";Spindulėlis;1583038469;Ne;9;1;0;10
17914;"Vilniaus Jono Pauliaus II progimnazija";Spindulėlis;9226214856;Ne;0;1;0;1
17915;"Vilniaus Jono Pauliaus II progimnazija";Spindulėlis;3121251271;Ne;0;3;1;4
17916;"Vilniaus Jono Pauliaus II progimnazija";Spindulėlis;4189943614;Ne;0;2;0;2
17917;"Vilniaus Jono Pauliaus II progimnazija";Spindulėlis;2515028280;Ne;13;1;0;14
17918;"Vilniaus Jono Pauliaus II progimnazija";Spindulėlis;5987294293;Ne;2;3;1;6
17919;"Vilniaus Jono Pauliaus II progimnazija";Spindulėlis;9531574134;Ne;0;1;0;1
17920;"Vilniaus Jono Pauliaus II progimnazija";Spindulėlis;8043493934;Ne;0;1;0;1
17921;"Vilniaus Jono Pauliaus II progimnazija";Uogytės;3502278745;Ne;5;0;0;5
17922;"Vilniaus Jono Pauliaus II progimnazija";Uogytės;3445649442;Ne;0;1;0;1
17923;"Vilniaus Jono Pauliaus II progimnazija";Uogytės;3900091129;Ne;1;1;0;2
17924;"Vilniaus Jono Pauliaus II progimnazija";Uogytės;6367875352;Ne;0;1;0;1
17925;"Vilniaus Jono Pauliaus II progimnazija";Uogytės;2843328732;Ne;2;0;0;2
17926;"Vilniaus Jono Pauliaus II progimnazija";Uogytės;1440531672;Ne;1;1;0;2
17927;"Vilniaus Jono Pauliaus II progimnazija";Uogytės;1502013942;Ne;0;7;0;7
17928;"Vilniaus Jono Pauliaus II progimnazija";Uogytės;2205400512;Ne;1;0;0;1
17929;"Vilniaus Jono Pauliaus II progimnazija";Uogytės;4969561425;Ne;0;1;0;1
17930;"Vilniaus Jono Pauliaus II progimnazija";Uogytės;4726351175;Ne;0;1;0;1
17931;"Vilniaus Jono Pauliaus II progimnazija";Uogytės;5028510873;Ne;0;1;0;1
17932;"Vilniaus Jono Pauliaus II progimnazija";Uogytės;4335378625;Ne;1;1;0;2
17933;"Vilniaus Jono Pauliaus II progimnazija";Uogytės;5600979545;Ne;1;0;0;1
17934;"Vilniaus Jono Pauliaus II progimnazija";Uogytės;8459980712;Ne;0;1;0;1
17935;"Vilniaus Jono Pauliaus II progimnazija";Uogytės;7089883250;Ne;0;1;0;1
17936;"Vilniaus Jono Pauliaus II progimnazija";Uogytės;4733227215;Ne;0;1;0;1
17937;"Vilniaus Jono Pauliaus II progimnazija";Uogytės;1290248125;Ne;0;1;0;1
17938;"Vilniaus Jono Pauliaus II progimnazija";Uogytės;9037835899;Ne;4;0;0;4
17939;Gluosnis;KIŠKUČIAI;2984134115;Ne;0;0;1;1
17940;Gluosnis;KIŠKUČIAI;6955695422;Ne;0;0;10;10
17941;Gluosnis;KIŠKUČIAI;1305651237;Ne;20;0;0;20
17942;Gluosnis;KIŠKUČIAI;4285562600;Ne;0;3;0;3
17943;Gluosnis;KIŠKUČIAI;8009719622;Ne;0;5;0;5
17944;Gluosnis;KIŠKUČIAI;6883663577;Ne;0;10;0;10
17945;Gluosnis;KIŠKUČIAI;1512855055;Ne;6;0;0;6
17946;Gluosnis;KIŠKUČIAI;4632419177;Ne;5;0;0;5
17947;Gluosnis;KIŠKUČIAI;7769522093;Ne;6;0;0;6
17948;Gluosnis;KIŠKUČIAI;9993638596;Ne;0;6;0;6
17949;Gluosnis;KIŠKUČIAI;6994005000;Ne;0;1;0;1
17950;Gluosnis;KIŠKUČIAI;9221983318;Ne;0;0;3;3
17951;Gluosnis;KIŠKUČIAI;2187312618;Ne;4;0;2;6
17952;Gluosnis;KIŠKUČIAI;7073637619;Taip;6;0;0;6
17953;Gluosnis;KIŠKUČIAI;1391404073;Ne;0;10;0;10
17954;Gluosnis;KIŠKUČIAI;4591550636;Ne;9;1;0;10
17955;Gluosnis;KIŠKUČIAI;6212693015;Ne;3;4;0;7
17956;Gluosnis;EŽIUKAI;4153713911;Ne;4;0;2;6
17957;Gluosnis;EŽIUKAI;5350702449;Ne;4;0;6;10
17958;Gluosnis;EŽIUKAI;6622415563;Ne;0;1;0;1
17959;Gluosnis;EŽIUKAI;3988305400;Ne;0;3;0;3
17960;Gluosnis;EŽIUKAI;9788278155;Ne;3;2;0;5
17961;Gluosnis;EŽIUKAI;7974944779;Ne;0;5;0;5
17962;Gluosnis;EŽIUKAI;7526020668;Ne;0;1;0;1
17963;Gluosnis;EŽIUKAI;5522411084;Ne;7;0;1;8
17964;Gluosnis;EŽIUKAI;5392759654;Taip;0;8;2;10
17965;Gluosnis;EŽIUKAI;6681653921;Ne;0;9;0;9
17966;Gluosnis;EŽIUKAI;4902627153;Taip;0;0;3;3
17967;Gluosnis;EŽIUKAI;2525780494;Ne;0;5;0;5
17968;Gluosnis;EŽIUKAI;9389736360;Ne;0;1;0;1
17969;Gluosnis;EŽIUKAI;2707855273;Ne;4;2;0;6
17970;Gluosnis;EŽIUKAI;7523459118;Ne;5;1;2;8
17971;Gluosnis;EŽIUKAI;2794163383;Ne;0;0;1;1
17972;Gluosnis;EŽIUKAI;7264550578;Ne;0;0;4;4
17973;Gluosnis;EŽIUKAI;5368171142;Ne;0;8;0;8
17974;Gluosnis;EŽIUKAI;9888037899;Ne;7;0;5;12
17975;Gluosnis;MEŠKIUKAI;8981904827;Ne;5;0;0;5
17976;Gluosnis;MEŠKIUKAI;8998776286;Ne;0;1;0;1
17977;Gluosnis;MEŠKIUKAI;1846499141;Ne;3;9;0;12
17978;Gluosnis;MEŠKIUKAI;7935750427;Ne;5;0;3;8
17979;Gluosnis;MEŠKIUKAI;9102081648;Taip;5;0;1;6
17980;Gluosnis;MEŠKIUKAI;4498429439;Ne;6;0;0;6
17981;Gluosnis;MEŠKIUKAI;8259160584;Ne;0;8;0;8
17982;Gluosnis;MEŠKIUKAI;1235091885;Ne;0;9;0;9
17983;Gluosnis;MEŠKIUKAI;1165636758;Ne;0;6;3;9
17984;Gluosnis;MEŠKIUKAI;8499748544;Ne;0;3;0;3
17985;Gluosnis;MEŠKIUKAI;9699577397;Ne;3;0;2;5
17986;Gluosnis;MEŠKIUKAI;7995558671;Ne;6;2;0;8
17987;Gluosnis;MEŠKIUKAI;1602556462;Ne;0;0;2;2
17988;Gluosnis;MEŠKIUKAI;6428753580;Taip;4;0;0;4
17989;Gluosnis;MEŠKIUKAI;3323237449;Ne;0;2;0;2
17990;Gluosnis;MEŠKIUKAI;6246512101;Ne;0;1;1;2
17991;Gluosnis;MEŠKIUKAI;3038732180;Ne;9;0;8;17
17992;Gluosnis;MEŠKIUKAI;1712795835;Ne;0;6;0;6
17993;Gluosnis;BORUŽĖLĖS;8840658383;Ne;0;0;1;1
17994;Gluosnis;BORUŽĖLĖS;1102935178;Ne;0;0;1;1
17995;Gluosnis;BORUŽĖLĖS;2167312808;Ne;0;0;1;1
17996;Gluosnis;BORUŽĖLĖS;4204797742;Ne;0;6;0;6
17997;Gluosnis;BORUŽĖLĖS;6302765948;Ne;5;0;1;6
17998;Gluosnis;BORUŽĖLĖS;9938235476;Ne;0;3;0;3
17999;Gluosnis;BORUŽĖLĖS;2945796648;Ne;0;5;0;5
18000;Gluosnis;BORUŽĖLĖS;4237053702;Ne;0;0;1;1
18001;Gluosnis;BORUŽĖLĖS;6320411660;Ne;0;3;0;3
18002;Gluosnis;BORUŽĖLĖS;8502947568;Ne;0;0;1;1
18003;Gluosnis;BORUŽĖLĖS;1335152703;Ne;0;0;2;2
18004;Gluosnis;BORUŽĖLĖS;1314992969;Taip;0;2;0;2
18005;Gluosnis;BORUŽĖLĖS;7833136455;Ne;9;0;0;9
18006;Gluosnis;BORUŽĖLĖS;5556821953;Taip;0;8;0;8
18007;Gluosnis;BORUŽĖLĖS;2515646510;Ne;0;1;1;2
18008;Gluosnis;BORUŽĖLĖS;6086258054;Ne;6;0;3;9
18009;Gluosnis;BORUŽĖLĖS;1351519995;Ne;10;2;1;13
18010;Gluosnis;BORUŽĖLĖS;6960673767;Taip;10;3;0;13
18011;Gluosnis;LAPIUKAI;7025815772;Ne;0;5;0;5
18012;Gluosnis;LAPIUKAI;5266206726;Ne;7;0;0;7
18013;Gluosnis;LAPIUKAI;2968946946;Ne;5;0;0;5
18014;Gluosnis;LAPIUKAI;8976032500;Ne;7;0;0;7
18015;Gluosnis;LAPIUKAI;3190331209;Taip;9;0;0;9
18016;Gluosnis;LAPIUKAI;5376108804;Ne;10;0;1;11
18017;Gluosnis;LAPIUKAI;9386396460;Ne;9;2;0;11
18018;Gluosnis;LAPIUKAI;1664508998;Ne;6;1;5;12
18019;Gluosnis;LAPIUKAI;1296975213;Ne;5;0;0;5
18020;Gluosnis;LAPIUKAI;4146877525;Taip;6;6;0;12
18021;Gluosnis;LAPIUKAI;4616132460;Ne;8;1;0;9
18022;Gluosnis;LAPIUKAI;7090336454;Ne;0;1;0;1
18023;Gluosnis;LAPIUKAI;2889837198;Ne;10;0;2;12
18024;Gluosnis;PELĖDŽIUKAI;5633386146;Taip;0;0;2;2
18025;Gluosnis;PELĖDŽIUKAI;4280829038;Taip;0;0;21;21
18026;Gluosnis;PELĖDŽIUKAI;1144177849;Ne;3;1;0;4
18027;Gluosnis;PELĖDŽIUKAI;6729016081;Ne;5;1;0;6
18028;Gluosnis;PELĖDŽIUKAI;4069584911;Ne;0;0;1;1
18029;Gluosnis;PELĖDŽIUKAI;2423433989;Ne;0;1;0;1
18030;Gluosnis;PELĖDŽIUKAI;1263019496;Ne;0;4;0;4
18031;Gluosnis;PELĖDŽIUKAI;8109714321;Taip;0;0;2;2
18032;Gluosnis;PELĖDŽIUKAI;2794080237;Ne;6;1;0;7
18033;Gluosnis;PELĖDŽIUKAI;4564193030;Ne;10;1;1;12
18034;Gluosnis;PELĖDŽIUKAI;5623135790;Ne;3;11;0;14
18035;Gluosnis;PELĖDŽIUKAI;2310874591;Ne;0;11;0;11
18036;Gluosnis;PELĖDŽIUKAI;5210930032;Taip;0;0;3;3
18037;Gluosnis;PELĖDŽIUKAI;5008836118;Ne;5;0;0;5
18038;Gluosnis;PELĖDŽIUKAI;4224637208;Ne;0;2;0;2
18039;Gluosnis;PELĖDŽIUKAI;4361177196;Ne;0;3;0;3
18040;Gluosnis;PELĖDŽIUKAI;9484423786;Taip;6;0;1;7
18041;Gluosnis;PELĖDŽIUKAI;9423229931;Ne;5;0;1;6
18042;Gluosnis;PELĖDŽIUKAI;3578467708;Ne;0;0;1;1
18043;Gluosnis;VOVERIUKAI;4798207493;Ne;2;0;0;2
18044;Gluosnis;VOVERIUKAI;5822836262;Ne;6;1;0;7
18045;Gluosnis;VOVERIUKAI;8374694200;Ne;5;0;0;5
18046;Gluosnis;VOVERIUKAI;3014153561;Ne;9;0;0;9
18047;Gluosnis;VOVERIUKAI;6617408330;Ne;1;0;0;1
18048;Gluosnis;VOVERIUKAI;5850079627;Ne;7;0;0;7
18049;Gluosnis;VOVERIUKAI;8904254546;Ne;2;0;0;2
18050;Gluosnis;VOVERIUKAI;8310409721;Ne;9;0;0;9
18051;Gluosnis;VOVERIUKAI;2746499687;Ne;1;0;0;1
18052;Gluosnis;VOVERIUKAI;1636516971;Taip;1;3;0;4
18053;Gluosnis;DRUGELIAI;1716235604;Ne;0;2;0;2
18054;Gluosnis;DRUGELIAI;7642311375;Ne;0;5;0;5
18055;Gluosnis;DRUGELIAI;8430102757;Ne;0;3;1;4
18056;Gluosnis;DRUGELIAI;4125830926;Taip;6;1;0;7
18057;Gluosnis;DRUGELIAI;6358187113;Taip;0;0;4;4
18058;Gluosnis;DRUGELIAI;4940563623;Ne;2;4;0;6
18059;Gluosnis;DRUGELIAI;1113731535;Ne;0;1;0;1
18060;Gluosnis;DRUGELIAI;4653963373;Ne;3;2;0;5
18061;Gluosnis;DRUGELIAI;4220504133;Ne;18;0;0;18
18062;Gluosnis;DRUGELIAI;9931766935;Ne;0;0;5;5
18063;Gluosnis;DRUGELIAI;3527418865;Ne;0;0;1;1
18064;Gluosnis;DRUGELIAI;6914171069;Ne;0;2;0;2
18065;Gluosnis;DRUGELIAI;5943955268;Ne;5;0;5;10
18066;Gluosnis;DRUGELIAI;8690911930;Ne;0;0;1;1
18067;Gluosnis;DRUGELIAI;1543842220;Ne;4;0;0;4
18068;Gluosnis;DRUGELIAI;1787206205;Ne;4;2;0;6
18069;Gluosnis;BITUTĖS;2554790908;Ne;0;2;0;2
18070;Gluosnis;BITUTĖS;8281499182;Ne;5;0;1;6
18071;Gluosnis;BITUTĖS;2403029153;Ne;0;1;0;1
18072;Gluosnis;BITUTĖS;9542889575;Ne;1;0;0;1
18073;Gluosnis;BITUTĖS;5889360726;Ne;1;0;0;1
18074;Gluosnis;BITUTĖS;3362089746;Ne;0;0;2;2
18075;Gluosnis;BITUTĖS;7390361159;Ne;0;2;0;2
18076;Gluosnis;BITUTĖS;8380310240;Ne;0;10;0;10
18077;Gluosnis;BITUTĖS;4481544177;Taip;0;0;3;3
18078;Gluosnis;BITUTĖS;1306381382;Ne;1;0;0;1
18079;Gluosnis;BITUTĖS;6197840105;Ne;10;1;0;11
18080;Gluosnis;BITUTĖS;5204445760;Taip;0;1;0;1
18081;Gluosnis;BITUTĖS;5432102004;Ne;0;0;3;3
18082;"Vilniaus Simono Stanevičiaus progimnazija";BITUTĖS;7528014407;Ne;2;0;0;2
18083;"Vilniaus Simono Stanevičiaus progimnazija";BITUTĖS;6700169944;Ne;2;0;0;2
18084;"Vilniaus Simono Stanevičiaus progimnazija";BITUTĖS;5733610359;Ne;6;0;10;16
18085;"Vilniaus Simono Stanevičiaus progimnazija";BITUTĖS;2021296978;Ne;2;0;0;2
18086;"Vilniaus Simono Stanevičiaus progimnazija";BITUTĖS;1566011843;Ne;2;0;0;2
18087;"Vilniaus Simono Stanevičiaus progimnazija";BITUTĖS;9331479613;Ne;6;0;0;6
18088;"Vilniaus Simono Stanevičiaus progimnazija";BITUTĖS;4586098882;Ne;8;0;0;8
18089;"Vilniaus Simono Stanevičiaus progimnazija";BITUTĖS;8378295683;Taip;4;0;0;4
18090;"Vilniaus Simono Stanevičiaus progimnazija";BITUTĖS;8866490265;Taip;6;0;0;6
18091;"Vilniaus Simono Stanevičiaus progimnazija";BITUTĖS;3678796113;Ne;7;0;0;7
18092;"Vilniaus Simono Stanevičiaus progimnazija";BITUTĖS;7251592439;Ne;8;0;0;8
18093;"Vilniaus Simono Stanevičiaus progimnazija";BITUTĖS;7335784416;Ne;3;0;0;3
18094;"Vilniaus Simono Stanevičiaus progimnazija";BITUTĖS;6259640492;Ne;5;0;0;5
18095;"Vilniaus Simono Stanevičiaus progimnazija";BITUTĖS;6800864033;Ne;0;3;1;4
18096;"Vilniaus Simono Stanevičiaus progimnazija";KATINĖLIAI;2487784714;Ne;0;1;0;1
18097;"Vilniaus Simono Stanevičiaus progimnazija";KATINĖLIAI;7991650887;Ne;1;0;1;2
18098;"Vilniaus Simono Stanevičiaus progimnazija";KATINĖLIAI;4682659878;Ne;0;0;10;10
18099;"Vilniaus Simono Stanevičiaus progimnazija";KATINĖLIAI;1051805733;Ne;1;0;0;1
18100;"Vilniaus Simono Stanevičiaus progimnazija";KATINĖLIAI;4973969827;Ne;0;0;7;7
18101;"Vilniaus Simono Stanevičiaus progimnazija";KATINĖLIAI;1569084597;Ne;0;0;3;3
18102;"Vilniaus Simono Stanevičiaus progimnazija";KATINĖLIAI;1166282379;Ne;1;2;0;3
18103;"Vilniaus Simono Stanevičiaus progimnazija";KATINĖLIAI;6073971598;Taip;1;6;0;7
18104;"Vilniaus Simono Stanevičiaus progimnazija";KATINĖLIAI;2734024890;Ne;5;0;0;5
18105;"Vilniaus Simono Stanevičiaus progimnazija";KATINĖLIAI;2483957349;Ne;0;4;0;4
18106;"Vilniaus Simono Stanevičiaus progimnazija";KATINĖLIAI;8799003374;Ne;1;0;0;1
18107;"Vilniaus Simono Stanevičiaus progimnazija";KATINĖLIAI;7367485961;Taip;1;0;0;1
18108;"Vilniaus Saulėtekio mokykla-daugiafunkcinis centras";"PRIEŠMOKYKLINĖ 2";7903833413;Ne;1;0;0;1
18109;"Vilniaus Saulėtekio mokykla-daugiafunkcinis centras";"PRIEŠMOKYKLINĖ 2";3499348606;Ne;0;0;3;3
18110;"Vilniaus Saulėtekio mokykla-daugiafunkcinis centras";"PRIEŠMOKYKLINĖ 2";4730746531;Ne;12;0;0;12
18111;"Vilniaus Saulėtekio mokykla-daugiafunkcinis centras";"PRIEŠMOKYKLINĖ 2";9471880764;Ne;3;0;4;7
18112;"Vilniaus Saulėtekio mokykla-daugiafunkcinis centras";"PRIEŠMOKYKLINĖ 2";8012122042;Ne;0;0;1;1
18113;"Vilniaus Saulėtekio mokykla-daugiafunkcinis centras";"PRIEŠMOKYKLINĖ 2";2034007263;Ne;6;0;4;10
18114;"Vilniaus Saulėtekio mokykla-daugiafunkcinis centras";"PRIEŠMOKYKLINĖ 2";3928697936;Ne;14;0;14;28
18115;"Vilniaus Saulėtekio mokykla-daugiafunkcinis centras";"PRIEŠMOKYKLINĖ 2";3080668107;Ne;8;0;0;8
18116;"Vilniaus Saulėtekio mokykla-daugiafunkcinis centras";"PRIEŠMOKYKLINĖ 2";6080664872;Ne;0;0;5;5
18117;"Vilniaus Saulėtekio mokykla-daugiafunkcinis centras";"PRIEŠMOKYKLINĖ 2";3873345138;Ne;3;0;12;15
18118;"Vilniaus Saulėtekio mokykla-daugiafunkcinis centras";"PRIEŠMOKYKLINĖ 2";6702207851;Ne;6;0;0;6
18119;"Vilniaus Saulėtekio mokykla-daugiafunkcinis centras";"PRIEŠMOKYKLINĖ 2";5551184248;Ne;0;0;30;30
18120;"Vilniaus Saulėtekio mokykla-daugiafunkcinis centras";"PRIEŠMOKYKLINĖ 2";2631120189;Taip;17;0;0;17
18121;"Vilniaus Saulėtekio mokykla-daugiafunkcinis centras";"PRIEŠMOKYKLINĖ 2";4402503971;Ne;1;0;0;1
18122;"Vilniaus Saulėtekio mokykla-daugiafunkcinis centras";"PRIEŠMOKYKLINĖ 2";5998344519;Ne;0;0;1;1
18123;"Vilniaus Saulėtekio mokykla-daugiafunkcinis centras";"PRIEŠMOKYKLINĖ 2";1825755877;Ne;1;0;0;1
18124;"Vilniaus Saulėtekio mokykla-daugiafunkcinis centras";"PRIEŠMOKYKLINĖ  1";4234425668;Ne;0;4;0;4
18125;"Vilniaus Saulėtekio mokykla-daugiafunkcinis centras";"PRIEŠMOKYKLINĖ  1";4852738818;Ne;2;0;0;2
18126;"Vilniaus Saulėtekio mokykla-daugiafunkcinis centras";"PRIEŠMOKYKLINĖ  1";5399981203;Ne;0;2;0;2
18127;"Vilniaus Saulėtekio mokykla-daugiafunkcinis centras";"PRIEŠMOKYKLINĖ  1";8997525194;Ne;1;0;0;1
18128;"Vilniaus Saulėtekio mokykla-daugiafunkcinis centras";"PRIEŠMOKYKLINĖ  1";5532685692;Ne;5;0;0;5
18129;"Vilniaus Saulėtekio mokykla-daugiafunkcinis centras";"PRIEŠMOKYKLINĖ  1";5817562139;Ne;8;0;4;12
18130;"Vilniaus Saulėtekio mokykla-daugiafunkcinis centras";"PRIEŠMOKYKLINĖ  1";1625321820;Ne;0;0;1;1
18131;"Vilniaus Saulėtekio mokykla-daugiafunkcinis centras";"PRIEŠMOKYKLINĖ  1";9099285081;Ne;5;0;0;5
18132;"Vilniaus Saulėtekio mokykla-daugiafunkcinis centras";"PRIEŠMOKYKLINĖ  1";5586871557;Ne;5;0;0;5
18133;"Vilniaus Saulėtekio mokykla-daugiafunkcinis centras";"PRIEŠMOKYKLINĖ  1";2429527586;Ne;0;0;4;4
18134;"Vilniaus Maironio progimnazija";"1 PU";1603752483;Ne;5;0;0;5
18135;"Vilniaus Maironio progimnazija";"1 PU";5022388487;Taip;0;10;0;10
18136;"Vilniaus Maironio progimnazija";"1 PU";1024337077;Ne;0;2;0;2
18137;"Vilniaus Maironio progimnazija";"1 PU";6176234300;Ne;1;4;0;5
18138;"Vilniaus Maironio progimnazija";"1 PU";1339850717;Ne;12;0;0;12
18139;"Vilniaus Maironio progimnazija";"1 PU";6266095782;Ne;5;0;0;5
18140;"Vilniaus Maironio progimnazija";"1 PU";5322766823;Ne;0;1;0;1
18141;"Vilniaus Maironio progimnazija";"1 PU";9803206596;Ne;4;0;0;4
18142;"Vilniaus Maironio progimnazija";"1 PU";4917910801;Ne;0;1;0;1
18143;"Vilniaus Maironio progimnazija";"1 PU";3347146751;Ne;0;1;0;1
18144;"Vilniaus Maironio progimnazija";"1 PU";8393893311;Taip;1;0;0;1
18145;"Vilniaus Maironio progimnazija";"1 PU";2443856355;Ne;6;1;0;7
18146;"Vilniaus Maironio progimnazija";"2 PU";7395477522;Ne;5;0;0;5
18147;"Vilniaus Maironio progimnazija";"2 PU";8768526171;Ne;2;0;0;2
18148;"Vilniaus Maironio progimnazija";"2 PU";6949120693;Ne;6;0;0;6
18149;"Vilniaus Maironio progimnazija";"2 PU";7080578299;Ne;1;0;0;1
18150;"Vilniaus Maironio progimnazija";"2 PU";9968072478;Taip;5;2;0;7
18151;"Vilniaus Maironio progimnazija";"2 PU";8480891793;Ne;3;0;0;3
18152;"Vilniaus Maironio progimnazija";"2 PU";8946678515;Ne;2;0;0;2
18153;"Vilniaus Maironio progimnazija";"2 PU";3320524073;Ne;0;1;0;1
18154;"Vilniaus Maironio progimnazija";"2 PU";3895256591;Ne;0;6;0;6
18155;"Vilniaus Maironio progimnazija";"2 PU";1827752731;Ne;5;0;0;5
18156;"Vilniaus Maironio progimnazija";"2 PU";7252265838;Ne;7;1;0;8
18157;"Vilniaus Maironio progimnazija";"2 PU";5883751305;Ne;7;0;0;7
18158;"Vilniaus Maironio progimnazija";"2 PU";2868899342;Ne;5;0;0;5
18159;"Vilniaus Maironio progimnazija";"2 PU";8606551477;Ne;3;0;0;3
18160;"Vilniaus Maironio progimnazija";"2 PU";9978625382;Ne;9;0;0;9
18161;"Vilniaus kunigaikščio Gedimino progimnazija";NYKŠTUKAI;5909584565;Ne;0;1;0;1
18162;"Vilniaus kunigaikščio Gedimino progimnazija";NYKŠTUKAI;6234943180;Ne;0;1;0;1
18163;"Vilniaus kunigaikščio Gedimino progimnazija";NYKŠTUKAI;2406183145;Ne;0;5;0;5
18164;"Vilniaus kunigaikščio Gedimino progimnazija";NYKŠTUKAI;2379660463;Ne;0;5;0;5
18165;"Vilniaus kunigaikščio Gedimino progimnazija";NYKŠTUKAI;3363824185;Ne;0;1;0;1
18166;"Vilniaus kunigaikščio Gedimino progimnazija";NYKŠTUKAI;9408948207;Ne;0;1;0;1
18167;"Vilniaus kunigaikščio Gedimino progimnazija";NYKŠTUKAI;6942029629;Ne;4;5;0;9
18168;"Vilniaus kunigaikščio Gedimino progimnazija";NYKŠTUKAI;7161727352;Ne;1;1;0;2
18169;"Vilniaus kunigaikščio Gedimino progimnazija";NYKŠTUKAI;5695333666;Ne;0;1;0;1
18170;"Vilniaus kunigaikščio Gedimino progimnazija";NYKŠTUKAI;8061678477;Ne;5;1;0;6
18171;"Vilniaus kunigaikščio Gedimino progimnazija";NYKŠTUKAI;4635123721;Ne;0;1;0;1
18172;"Vilniaus kunigaikščio Gedimino progimnazija";NYKŠTUKAI;6574415196;Ne;0;1;0;1
18173;"Vilniaus kunigaikščio Gedimino progimnazija";NYKŠTUKAI;3149966189;Ne;0;2;0;2
18174;"Vilniaus kunigaikščio Gedimino progimnazija";NYKŠTUKAI;9777202512;Ne;0;5;0;5
18175;"Vilniaus kunigaikščio Gedimino progimnazija";NYKŠTUKAI;5187411500;Ne;0;1;0;1
18176;"Vilniaus kunigaikščio Gedimino progimnazija";NYKŠTUKAI;1420438624;Ne;0;1;0;1
18177;"Vilniaus kunigaikščio Gedimino progimnazija";NYKŠTUKAI;4681686872;Ne;0;2;0;2
18178;"Pušynėlis (A. Mickevičiaus g. 21)";DAIGIUKAI;5512586591;Ne;1;0;3;4
18179;"Pušynėlis (A. Mickevičiaus g. 21)";DAIGIUKAI;8668906624;Ne;4;1;0;5
18180;"Pušynėlis (A. Mickevičiaus g. 21)";DAIGIUKAI;9835049161;Ne;0;1;0;1
18181;"Pušynėlis (A. Mickevičiaus g. 21)";DAIGIUKAI;9710499937;Ne;0;11;0;11
18182;"Pušynėlis (A. Mickevičiaus g. 21)";DAIGIUKAI;8473976622;Ne;4;1;0;5
18183;"Pušynėlis (A. Mickevičiaus g. 21)";DAIGIUKAI;6630085270;Ne;5;0;0;5
18184;"Pušynėlis (A. Mickevičiaus g. 21)";DAIGIUKAI;2065121473;Ne;6;0;0;6
18185;"Pušynėlis (A. Mickevičiaus g. 21)";DAIGIUKAI;5601877137;Ne;6;0;0;6
18186;"Pušynėlis (A. Mickevičiaus g. 21)";DAIGIUKAI;7825721993;Ne;3;0;0;3
18187;"Pušynėlis (A. Mickevičiaus g. 21)";DAIGIUKAI;2543730165;Ne;2;0;1;3
18188;"Pušynėlis (A. Mickevičiaus g. 21)";NYKŠTUKAI;8820865805;Taip;0;17;0;17
18189;"Pušynėlis (A. Mickevičiaus g. 21)";NYKŠTUKAI;9520423020;Ne;0;4;4;8
18190;"Pušynėlis (A. Mickevičiaus g. 21)";NYKŠTUKAI;9450347140;Ne;0;2;0;2
18191;"Pušynėlis (A. Mickevičiaus g. 21)";NYKŠTUKAI;3574446664;Taip;0;1;0;1
18192;"Pušynėlis (A. Mickevičiaus g. 21)";NYKŠTUKAI;8512699165;Ne;0;4;0;4
18193;"Pušynėlis (A. Mickevičiaus g. 21)";NYKŠTUKAI;5364537212;Ne;5;2;0;7
18194;"Pušynėlis (A. Mickevičiaus g. 21)";NYKŠTUKAI;8327830781;Ne;0;2;0;2
18195;"Pušynėlis (A. Mickevičiaus g. 21)";NYKŠTUKAI;7172604103;Ne;0;0;5;5
18196;"Pušynėlis (A. Mickevičiaus g. 21)";NYKŠTUKAI;5317547220;Ne;10;0;1;11
18197;"Pušynėlis (A. Mickevičiaus g. 21)";NYKŠTUKAI;9025539389;Ne;0;0;8;8
18198;"Pušynėlis (A. Mickevičiaus g. 21)";NYKŠTUKAI;6594473055;Ne;0;2;0;2
18199;"Pušynėlis (A. Mickevičiaus g. 21)";NYKŠTUKAI;2763762463;Taip;1;3;0;4
18200;"Pušynėlis (A. Mickevičiaus g. 21)";NYKŠTUKAI;8211464695;Ne;0;2;0;2
18201;"Pušynėlis (A. Mickevičiaus g. 21)";NYKŠTUKAI;1085678424;Taip;6;0;1;7
18202;"Pušynėlis (A. Mickevičiaus g. 21)";NYKŠTUKAI;6270870180;Taip;7;0;0;7
18203;"Pušynėlis (A. Mickevičiaus g. 21)";NYKŠTUKAI;6573189496;Ne;0;4;17;21
18204;"Pušynėlis (A. Mickevičiaus g. 21)";NYKŠTUKAI;4685125111;Taip;0;0;1;1
18205;"Pušynėlis (A. Mickevičiaus g. 21)";NYKŠTUKAI;9717473430;Ne;0;8;0;8
18206;"Pušynėlis (A. Mickevičiaus g. 21)";GILIUKAI;9517319856;Ne;0;0;2;2
18207;"Pušynėlis (A. Mickevičiaus g. 21)";GILIUKAI;2825756894;Ne;2;0;3;5
18208;"Pušynėlis (A. Mickevičiaus g. 21)";GILIUKAI;4997004998;Ne;0;2;0;2
18209;"Pušynėlis (A. Mickevičiaus g. 21)";GILIUKAI;2712755125;Taip;0;0;2;2
18210;"Pušynėlis (A. Mickevičiaus g. 21)";GILIUKAI;3301741162;Ne;0;1;0;1
18211;"Pušynėlis (A. Mickevičiaus g. 21)";GILIUKAI;8298368128;Ne;4;1;0;5
18212;"Pušynėlis (A. Mickevičiaus g. 21)";GILIUKAI;8712141140;Ne;0;0;1;1
18213;"Pušynėlis (A. Mickevičiaus g. 21)";GILIUKAI;9220344337;Taip;10;0;0;10
18214;"Pušynėlis (A. Mickevičiaus g. 21)";GILIUKAI;1050710006;Taip;0;0;3;3
18215;"Pušynėlis (A. Mickevičiaus g. 21)";GILIUKAI;2222790161;Taip;7;2;2;11
18216;"Pušynėlis (A. Mickevičiaus g. 21)";GILIUKAI;7596876368;Taip;3;6;3;12
18217;"Pušynėlis (A. Mickevičiaus g. 21)";GILIUKAI;1758632291;Taip;13;0;0;13
18218;"Pušynėlis (A. Mickevičiaus g. 21)";GILIUKAI;8839614928;Ne;0;4;17;21
18219;"Pušynėlis (A. Mickevičiaus g. 21)";GILIUKAI;2892213973;Ne;0;2;3;5
18220;"Pušynėlis (A. Mickevičiaus g. 21)";GILIUKAI;7429853563;Taip;0;7;0;7
18221;"Pušynėlis (A. Mickevičiaus g. 21)";GILIUKAI;8464672994;Ne;5;0;1;6
18222;"Pušynėlis (A. Mickevičiaus g. 21)";GILIUKAI;9055713601;Ne;0;1;0;1
18223;"Pušynėlis (A. Mickevičiaus g. 21)";GILIUKAI;8699085292;Ne;0;1;0;1
18224;"Pušynėlis (A. Mickevičiaus g. 21)";LINELIS;3189188757;Ne;0;4;0;4
18225;"Pušynėlis (A. Mickevičiaus g. 21)";LINELIS;3682550072;Ne;0;2;2;4
18226;"Pušynėlis (A. Mickevičiaus g. 21)";LINELIS;8654487151;Taip;0;2;0;2
18227;"Pušynėlis (A. Mickevičiaus g. 21)";LINELIS;8837847094;Ne;5;2;0;7
18228;"Pušynėlis (A. Mickevičiaus g. 21)";LINELIS;9216703884;Ne;3;0;0;3
18229;"Pušynėlis (A. Mickevičiaus g. 21)";LINELIS;5668765825;Ne;0;2;3;5
18230;"Pušynėlis (A. Mickevičiaus g. 21)";LINELIS;7685809238;Ne;0;4;6;10
18231;"Pušynėlis (A. Mickevičiaus g. 21)";LINELIS;6735037523;Ne;0;2;2;4
18232;"Pušynėlis (A. Mickevičiaus g. 21)";LINELIS;9401101407;Ne;0;2;0;2
18233;"Pušynėlis (A. Mickevičiaus g. 21)";LINELIS;9147558926;Ne;3;2;0;5
18234;"Pušynėlis (A. Mickevičiaus g. 21)";LINELIS;7881263225;Ne;0;6;0;6
18235;"Pušynėlis (A. Mickevičiaus g. 21)";LINELIS;1612049897;Ne;0;2;0;2
18236;"Pušynėlis (A. Mickevičiaus g. 21)";LINELIS;4898147530;Ne;0;7;1;8
18237;"Pušynėlis (A. Mickevičiaus g. 21)";LINELIS;2228682366;Ne;0;11;0;11
18238;"Pušynėlis (A. Mickevičiaus g. 21)";LINELIS;4464615995;Ne;0;2;1;3
18239;"Naminukas (Klinikų g. 5)";VARPELIAI;3683089217;Ne;0;11;0;11
18240;"Naminukas (Klinikų g. 5)";VARPELIAI;7328682222;Taip;0;0;13;13
18241;"Naminukas (Klinikų g. 5)";VARPELIAI;1086919259;Ne;6;12;0;18
18242;"Naminukas (Klinikų g. 5)";VARPELIAI;2576516583;Ne;0;12;0;12
18243;"Naminukas (Klinikų g. 5)";VARPELIAI;8694425584;Ne;2;0;4;6
18244;"Naminukas (Klinikų g. 5)";VARPELIAI;7555926818;Ne;9;0;4;13
18245;"Naminukas (Klinikų g. 5)";VARPELIAI;6834388512;Ne;7;0;0;7
18246;"Naminukas (Klinikų g. 5)";VARPELIAI;8212264128;Ne;0;0;4;4
18247;"Naminukas (Klinikų g. 5)";VARPELIAI;8659342548;Ne;0;0;4;4
18248;"Naminukas (Klinikų g. 5)";VARPELIAI;1415188327;Ne;6;0;0;6
18249;"Naminukas (Klinikų g. 5)";VARPELIAI;5154177047;Ne;6;0;0;6
18250;"Naminukas (Klinikų g. 5)";SAULUTĖS;7947598191;Ne;0;0;1;1
18251;"Naminukas (Klinikų g. 5)";SAULUTĖS;2516513740;Ne;2;1;0;3
18252;"Naminukas (Klinikų g. 5)";SAULUTĖS;2721723305;Ne;4;3;0;7
18253;"Naminukas (Klinikų g. 5)";SAULUTĖS;8052458976;Ne;8;0;1;9
18254;"Naminukas (Klinikų g. 5)";SAULUTĖS;1170148403;Ne;0;0;3;3
18255;"Naminukas (Klinikų g. 5)";SAULUTĖS;1828220049;Ne;0;1;0;1
18256;"Naminukas (Klinikų g. 5)";SAULUTĖS;5172385044;Taip;5;1;10;16
18257;"Naminukas (Klinikų g. 5)";SAULUTĖS;7772300667;Ne;8;0;2;10
18258;"Naminukas (Klinikų g. 5)";SAULUTĖS;3497829075;Ne;4;15;0;19
18259;"Naminukas (Klinikų g. 5)";SAULUTĖS;6515021073;Ne;10;0;11;21
18260;"Naminukas (Klinikų g. 5)";SAULUTĖS;9894306360;Ne;9;1;0;10
18261;"Naminukas (Klinikų g. 5)";SAULUTĖS;5991261279;Ne;6;0;0;6
18262;"Naminukas (Klinikų g. 5)";SAULUTĖS;9537360943;Ne;3;0;2;5
18263;"Naminukas (Klinikų g. 5)";DRUGELIAI;7033053271;Ne;6;0;2;8
18264;"Naminukas (Klinikų g. 5)";DRUGELIAI;8432194383;Ne;0;10;0;10
18265;"Naminukas (Klinikų g. 5)";DRUGELIAI;9835701381;Ne;1;0;0;1
18266;"Naminukas (Klinikų g. 5)";DRUGELIAI;3911352454;Ne;3;15;0;18
18267;"Naminukas (Klinikų g. 5)";DRUGELIAI;7107337857;Ne;2;0;1;3
18268;"Naminukas (Klinikų g. 5)";DRUGELIAI;9212800864;Ne;0;3;0;3
18269;"Naminukas (Klinikų g. 5)";DRUGELIAI;2336627398;Ne;6;0;0;6
18270;"Naminukas (Klinikų g. 5)";DRUGELIAI;1879925655;Ne;2;0;1;3
18271;"Naminukas (Klinikų g. 5)";DRUGELIAI;2881576194;Ne;0;0;4;4
18272;"Naminukas (Klinikų g. 5)";DRUGELIAI;4836599508;Ne;0;8;0;8
18273;"Naminukas (Klinikų g. 5)";DRUGELIAI;4709625816;Ne;0;0;1;1
18274;"Naminukas (Klinikų g. 5)";DRUGELIAI;6471277755;Ne;0;0;1;1
18275;"Naminukas (Klinikų g. 5)";DRUGELIAI;1932169696;Ne;10;0;0;10
18276;"Naminukas (Klinikų g. 5)";BITUTĖS;6592057292;Ne;10;1;0;11
18277;"Naminukas (Klinikų g. 5)";BITUTĖS;5578151523;Ne;1;0;0;1
18278;"Naminukas (Klinikų g. 5)";BITUTĖS;5288557629;Ne;3;4;0;7
18279;"Naminukas (Klinikų g. 5)";BITUTĖS;3791118736;Ne;5;0;2;7
18280;"Naminukas (Klinikų g. 5)";BITUTĖS;7099787230;Ne;0;5;0;5
18281;"Naminukas (Klinikų g. 5)";BITUTĖS;3088386659;Ne;0;1;0;1
18282;"Naminukas (Klinikų g. 5)";BITUTĖS;3276656641;Ne;0;0;6;6
18283;"Naminukas (Klinikų g. 5)";BITUTĖS;2004615252;Ne;2;1;0;3
18284;"Naminukas (Klinikų g. 5)";BITUTĖS;6633031473;Ne;1;0;0;1
18285;"Naminukas (Klinikų g. 5)";BITUTĖS;2339599448;Ne;0;3;0;3
18286;"Naminukas (Klinikų g. 5)";BITUTĖS;4077985773;Ne;0;7;0;7
18287;"Naminukas (Klinikų g. 5)";BITUTĖS;6949857110;Ne;2;0;0;2
18288;"Naminukas (Klinikų g. 5)";BITUTĖS;8039086094;Ne;3;3;0;6
18289;"Naminukas (Klinikų g. 5)";BITUTĖS;7463647806;Ne;4;0;0;4
18290;"Naminukas (Klinikų g. 5)";BITUTĖS;4171789569;Ne;0;3;0;3
18291;"Gervelė (Stadiono g. 5)";BORUŽĖLĖS;2696708010;Ne;3;0;0;3
18292;"Gervelė (Stadiono g. 5)";BORUŽĖLĖS;2136541073;Ne;2;0;1;3
18293;"Gervelė (Stadiono g. 5)";BORUŽĖLĖS;5138349405;Ne;8;0;0;8
18294;"Gervelė (Stadiono g. 5)";BORUŽĖLĖS;4354544070;Ne;8;0;1;9
18295;"Gervelė (Stadiono g. 5)";BORUŽĖLĖS;7948249597;Ne;5;0;0;5
18296;"Gervelė (Stadiono g. 5)";BORUŽĖLĖS;3448452820;Ne;9;0;0;9
18297;"Gervelė (Stadiono g. 5)";BORUŽĖLĖS;2794943031;Taip;10;0;1;11
18298;"Gervelė (Stadiono g. 5)";BORUŽĖLĖS;2863499888;Ne;10;0;0;10
18299;"Gervelė (Stadiono g. 5)";BORUŽĖLĖS;6340371637;Ne;1;0;0;1
18300;"Gervelė (Stadiono g. 5)";PAUKŠTELIAI;7959839478;Ne;2;0;0;2
18301;"Gervelė (Stadiono g. 5)";PAUKŠTELIAI;2892214705;Ne;0;7;0;7
18302;"Gervelė (Stadiono g. 5)";PAUKŠTELIAI;9154032804;Ne;1;0;0;1
18303;"Gervelė (Stadiono g. 5)";PAUKŠTELIAI;7843800194;Ne;2;9;0;11
18304;"Gervelė (Stadiono g. 5)";PAUKŠTELIAI;4588890423;Taip;5;7;0;12
18305;"Gervelė (Stadiono g. 5)";PAUKŠTELIAI;7847393041;Ne;12;0;0;12
18306;"Gervelė (Stadiono g. 5)";PAUKŠTELIAI;6427072260;Ne;5;0;0;5
18307;"Gervelė (Stadiono g. 5)";PAUKŠTELIAI;5285868851;Ne;4;0;0;4
18308;"Gervelė (Stadiono g. 5)";PAUKŠTELIAI;2770635568;Ne;1;0;0;1
18309;"Gervelė (Stadiono g. 5)";PAUKŠTELIAI;2622183564;Ne;9;5;0;14
18310;"Gervelė (Stadiono g. 5)";PAUKŠTELIAI;1006720360;Ne;5;0;0;5
18311;"Gervelė (Stadiono g. 5)";PAUKŠTELIAI;8190190100;Ne;5;2;0;7
18312;"Gervelė (Stadiono g. 5)";PAUKŠTELIAI;2712133300;Ne;3;0;0;3
18313;"Gervelė (Stadiono g. 5)";SPINDULĖLIAI;4051246539;Ne;0;0;1;1
18314;"Gervelė (Stadiono g. 5)";SPINDULĖLIAI;5705915729;Ne;0;5;0;5
18315;"Gervelė (Stadiono g. 5)";SPINDULĖLIAI;6241611652;Ne;0;9;0;9
18316;"Gervelė (Stadiono g. 5)";SPINDULĖLIAI;1204513844;Ne;0;1;1;2
18317;"Gervelė (Stadiono g. 5)";SPINDULĖLIAI;8710469480;Ne;11;1;0;12
18318;"Gervelė (Stadiono g. 5)";SPINDULĖLIAI;9777308731;Ne;0;0;1;1
18319;"Gervelė (Stadiono g. 5)";SPINDULĖLIAI;6573919007;Ne;0;0;4;4
18320;"Gervelė (Stadiono g. 5)";SPINDULĖLIAI;3676856569;Ne;7;6;0;13
18321;"Gervelė (Stadiono g. 5)";SPINDULĖLIAI;3567687304;Ne;0;0;6;6
18322;"Gervelė (Stadiono g. 5)";SPINDULĖLIAI;5818430690;Taip;0;0;2;2
18323;"Gervelė (Stadiono g. 5)";SPINDULĖLIAI;1515920896;Taip;0;0;3;3
18324;"Gervelė (Stadiono g. 5)";SPINDULĖLIAI;2031118410;Ne;0;0;4;4
18325;"Gervelė (Stadiono g. 5)";GĖLYTĖS;7115198351;Ne;7;0;0;7
18326;"Gervelė (Stadiono g. 5)";GĖLYTĖS;4832348492;Ne;0;0;1;1
18327;"Gervelė (Stadiono g. 5)";GĖLYTĖS;7855598075;Ne;0;4;0;4
18328;"Gervelė (Stadiono g. 5)";GĖLYTĖS;6488139414;Ne;5;0;1;6
18329;"Gervelė (Stadiono g. 5)";GĖLYTĖS;3216423543;Ne;8;0;1;9
18330;"Gervelė (Stadiono g. 5)";GĖLYTĖS;4925983616;Ne;3;0;1;4
18331;"Gervelė (Stadiono g. 5)";GĖLYTĖS;8423813651;Ne;4;0;0;4
18332;"Gervelė (Stadiono g. 5)";GĖLYTĖS;7952102572;Ne;0;0;7;7
18333;"Gervelė (Stadiono g. 5)";GĖLYTĖS;5966215998;Ne;7;0;0;7
18334;"Gervelė (Stadiono g. 5)";GĖLYTĖS;7463376031;Ne;4;2;0;6
18335;"Gervelė (Stadiono g. 5)";GĖLYTĖS;1751440418;Ne;3;1;0;4
18336;"Gervelė (Stadiono g. 5)";GĖLYTĖS;9100411947;Taip;3;0;0;3
18337;"Kūlverstukas (Mindaugo g. 7)";ZAIČIATA;8994705290;Ne;7;5;0;12
18338;"Kūlverstukas (Mindaugo g. 7)";ZAIČIATA;2494202134;Ne;0;2;0;2
18339;"Kūlverstukas (Mindaugo g. 7)";ZAIČIATA;4998847820;Ne;1;0;0;1
18340;"Kūlverstukas (Mindaugo g. 7)";ZAIČIATA;3660002342;Ne;7;0;0;7
18341;"Kūlverstukas (Mindaugo g. 7)";ZAIČIATA;3835070633;Ne;3;0;0;3
18342;"Kūlverstukas (Mindaugo g. 7)";ZAIČIATA;7883325884;Ne;5;0;0;5
18343;"Kūlverstukas (Mindaugo g. 7)";ZAIČIATA;6621027840;Ne;8;0;0;8
18344;"Kūlverstukas (Mindaugo g. 7)";ZAIČIATA;6090797103;Ne;1;0;0;1
18345;"Kūlverstukas (Mindaugo g. 7)";ZAIČIATA;6872789727;Ne;1;0;0;1
18346;"Kūlverstukas (Mindaugo g. 7)";ZAIČIATA;9596978613;Ne;0;2;0;2
18347;"Kūlverstukas (Mindaugo g. 7)";ZAIČIATA;8841423764;Ne;5;0;0;5
18348;"Vilniaus Pavilnio pagrindinė mokykla";"PRIEŠMOKYKLINĖ RU";6537464526;Ne;4;0;0;4
18349;"Vilniaus Pavilnio pagrindinė mokykla";"PRIEŠMOKYKLINĖ RU";1509519996;Ne;3;0;0;3
18350;"Vilniaus Pavilnio pagrindinė mokykla";"PRIEŠMOKYKLINĖ RU";5706671963;Ne;7;0;0;7
18351;"Vilniaus Pavilnio pagrindinė mokykla";"PRIEŠMOKYKLINĖ RU";1035890284;Ne;0;0;1;1
18352;"Vilniaus Pavilnio pagrindinė mokykla";"PRIEŠMOKYKLINĖ RU";4602268315;Ne;1;1;0;2
18353;"Vilniaus Pavilnio pagrindinė mokykla";"PRIEŠMOKYKLINĖ RU";4676626786;Ne;0;1;12;13
18354;"Vilniaus Pavilnio pagrindinė mokykla";"PRIEŠMOKYKLINĖ RU";1107633909;Ne;3;1;0;4
18355;"Vilniaus Pavilnio pagrindinė mokykla";"PRIEŠMOKYKLINĖ RU";1344983194;Taip;0;0;3;3
18356;"Vilniaus Pavilnio pagrindinė mokykla";"PRIEŠMOKYKLINĖ RU";8684207189;Ne;0;20;0;20
18357;"Vilniaus Pavilnio pagrindinė mokykla";"PRIEŠMOKYKLINĖ RU";4516507512;Ne;3;0;0;3
18358;"Vilniaus Pavilnio pagrindinė mokykla";"PRIEŠMOKYKLINĖ PL";4038279267;Ne;9;0;0;9
18359;"Vilniaus Pavilnio pagrindinė mokykla";"PRIEŠMOKYKLINĖ PL";9533901360;Ne;6;0;0;6
18360;"Vilniaus Pavilnio pagrindinė mokykla";"PRIEŠMOKYKLINĖ PL";6716558946;Ne;0;0;4;4
18361;"Lazdynų mokykla (Liudvinavo g.128)";DRUGELIAI;7524849851;Ne;7;2;0;9
18362;"Lazdynų mokykla (Liudvinavo g.128)";DRUGELIAI;8650496265;Ne;6;0;0;6
18363;"Lazdynų mokykla (Liudvinavo g.128)";DRUGELIAI;9309081745;Taip;0;2;0;2
18364;"Lazdynų mokykla (Liudvinavo g.128)";DRUGELIAI;1951041742;Ne;7;0;1;8
18365;"Lazdynų mokykla (Liudvinavo g.128)";DRUGELIAI;9196184984;Ne;6;1;0;7
18366;"Lazdynų mokykla (Liudvinavo g.128)";DRUGELIAI;2767732459;Ne;0;6;0;6
18367;"Lazdynų mokykla (Liudvinavo g.128)";DRUGELIAI;6394098306;Ne;5;0;1;6
18368;"Lazdynų mokykla (Liudvinavo g.128)";DRUGELIAI;7074859809;Taip;16;2;0;18
18369;"Lazdynų mokykla (Liudvinavo g.128)";DRUGELIAI;4097980299;Ne;2;4;0;6
18370;"Lazdynų mokykla (Liudvinavo g.128)";DRUGELIAI;8001610972;Ne;2;4;0;6
18371;"Lazdynų mokykla (Liudvinavo g.128)";DRUGELIAI;5902104981;Ne;0;6;0;6
18372;"Lazdynų mokykla (Liudvinavo g.128)";DRUGELIAI;7590111138;Ne;0;2;0;2
18373;"Lazdynų mokykla (Liudvinavo g.128)";DRUGELIAI;2027751624;Ne;1;0;1;2
18374;"Lazdynų mokykla (Liudvinavo g.128)";ZUIKUČIAI;4166599533;Taip;7;0;0;7
18375;"Lazdynų mokykla (Liudvinavo g.128)";ZUIKUČIAI;3715070791;Ne;2;2;0;4
18376;"Lazdynų mokykla (Liudvinavo g.128)";ZUIKUČIAI;3265099747;Ne;6;0;0;6
18377;"Lazdynų mokykla (Liudvinavo g.128)";ZUIKUČIAI;3302443490;Taip;0;2;0;2
18378;"Lazdynų mokykla (Liudvinavo g.128)";ZUIKUČIAI;7000921682;Ne;0;10;0;10
18379;"Lazdynų mokykla (Liudvinavo g.128)";ZUIKUČIAI;3535244441;Ne;9;0;0;9
18380;"Lazdynų mokykla (Liudvinavo g.128)";ZUIKUČIAI;7594978836;Ne;1;2;0;3
18381;"Lazdynų mokykla (Liudvinavo g.128)";ZUIKUČIAI;5465094647;Ne;0;9;0;9
18382;"Lazdynų mokykla (Liudvinavo g.128)";ZUIKUČIAI;1044630813;Ne;0;3;0;3
18383;"Lazdynų mokykla (Liudvinavo g.128)";ZUIKUČIAI;7229926614;Ne;6;0;0;6
18384;"Lazdynų mokykla (Liudvinavo g.128)";ZUIKUČIAI;8899186547;Ne;6;0;0;6
18385;"Lazdynų mokykla (Liudvinavo g.128)";ZUIKUČIAI;5181200460;Ne;3;0;0;3
18386;"Vilniaus Šilo mokykla";Boružėlės;7122041826;Ne;16;0;0;16
18387;"Vilniaus Šilo mokykla";Boružėlės;9967276147;Ne;2;0;0;2
18388;"Vilniaus Šilo mokykla";Boružėlės;5962551687;Taip;10;0;0;10
18389;"Vilniaus Šilo mokykla";Boružėlės;1196172221;Ne;14;0;0;14
18390;"Vilniaus Šilo mokykla";Boružėlės;1538635985;Ne;8;0;0;8
18391;"Vilniaus Šilo mokykla";Boružėlės;6136087920;Ne;1;20;0;21
18392;"Vilniaus Šilo mokykla";Boružėlės;4544126354;Ne;14;0;0;14
18393;"Vilniaus Šilo mokykla";Boružėlės;8897729962;Ne;2;0;0;2
18394;"Vilniaus Šilo mokykla";"3 spec.";73899364649;Ne;1;0;0;1
18395;"Vilniaus Šilo mokykla";"3 spec.";1417978731;Ne;6;0;0;6
18396;"Vilniaus Šilo mokykla";"3 spec.";28814860843;Ne;1;20;0;21
18397;"Vilniaus Šilo mokykla";"3 spec.";93519259505;Ne;2;0;0;2
18398;"Vilniaus Šilo mokykla";"3 spec.";63472451321;Ne;2;0;0;2
18399;"Vilniaus Šilo mokykla";"3 spec.";3473596157;Ne;1;0;0;1
18400;"Vilniaus Šilo mokykla";"3 spec.";1475766630;Ne;1;20;0;21
18401;"Vilniaus Šilo mokykla";"7-10 spec.";9944901942;Ne;2;0;0;2
18402;"Vilniaus Šilo mokykla";"7-10 spec.";3333634089;Ne;1;20;0;21
18403;"Vilniaus Šilo mokykla";"7-10 spec.";8548722736;Ne;1;0;0;1
18404;"Vilniaus Šilo mokykla";"7-10 spec.";5255365063;Ne;5;0;0;5
18405;"Vilniaus Šilo mokykla";"7-10 spec.";6452740859;Ne;6;0;0;6
18406;"Vilniaus Šilo mokykla";"7-10 spec.";60608633947;Ne;2;0;0;2
18407;"Vilniaus Šilo mokykla";"7-10 spec.";4906175269;Ne;3;0;0;3
18408;"Vilniaus Šilo mokykla";"7-10 spec.";9264140610;Ne;1;0;0;1
18409;"Vilniaus Šilo mokykla";"7-10 lav.";92425322676;Ne;1;0;0;1
18410;"Vilniaus Šilo mokykla";"7-10 lav.";5905008395;Ne;1;0;0;1
18411;"Vilniaus Šilo mokykla";"7-10 lav.";4738867530;Ne;1;0;0;1
18412;"Vilniaus Šilo mokykla";"7-10 lav.";8490224829;Ne;1;0;0;1
18413;"Vilniaus Šilo mokykla";"7-10 lav.";81654551230;Ne;5;0;0;5
18414;"Vilniaus Šilo mokykla";"7-10 lav.";7740504510;Ne;1;0;0;1
18415;"Vilniaus Šilo mokykla";"7-10 lav.";5388697695;Ne;1;0;0;1
18416;"Vilniaus Šilo mokykla";"7-10 lav.";20604410476;Ne;1;0;0;1
18417;"Vilniaus Šilo mokykla";"7-10 lav.";6868265902;Ne;1;20;0;21
18418;"Vilniaus Šilo mokykla";"7-10 lav.";2234931428;Ne;1;20;0;21
18419;"Vilniaus Šilo mokykla";"SĮ A";6954467869;Ne;1;20;0;21
18420;"Vilniaus Šilo mokykla";"SĮ A";9354191217;Ne;14;0;0;14
18421;"Vilniaus Šilo mokykla";"SĮ A";9471629029;Ne;2;0;0;2
18422;"Vilniaus Šilo mokykla";"SĮ A";6088433049;Ne;3;0;0;3
18423;"Vilniaus Šilo mokykla";"SĮ A";1819519275;Ne;1;0;0;1
18424;"Vilniaus Šilo mokykla";"SĮ A";9845575989;Ne;7;0;0;7
18425;"Vilniaus Šilo mokykla";"SĮ A";3308772529;Ne;6;0;0;6
18426;"Vilniaus Šilo mokykla";"SĮ A";1726056983;Ne;7;0;0;7
18427;"Vilniaus Šilo mokykla";"SĮ A";3442250711;Ne;11;0;0;11
18428;"Vilniaus Šilo mokykla";"SĮ A";2755910347;Ne;4;0;0;4
18429;"Vilniaus Šilo mokykla";"SĮ C";1322335360;Ne;1;0;0;1
18430;"Vilniaus Šilo mokykla";"SĮ C";8642665550;Ne;1;0;0;1
18431;"Vilniaus Šilo mokykla";"SĮ C";5309862220;Ne;1;20;0;21
18432;"Vilniaus Šilo mokykla";"SĮ C";1010885560;Ne;1;0;0;1
18433;"Vilniaus Šilo mokykla";"SĮ C";2501187241;Ne;3;0;0;3
18434;"Vilniaus Šilo mokykla";"SĮ C";2681438925;Ne;1;0;0;1
18435;"Vilniaus Šilo mokykla";"8 spec.";948748525;Ne;1;0;0;1
18436;"Vilniaus Šilo mokykla";"8 spec.";1422218905;Ne;1;20;0;21
18437;"Vilniaus Šilo mokykla";"8 spec.";1177826873;Ne;1;0;0;1
18438;"Vilniaus Šilo mokykla";"8 spec.";3776046409;Ne;3;0;0;3
18439;"Vilniaus Šilo mokykla";"8 spec.";9784624648;Ne;8;0;0;8
18440;"Vilniaus Šilo mokykla";"8 spec.";3621978449;Ne;1;0;0;1
18441;"Vilniaus Šilo mokykla";"8 spec.";5186364504;Ne;1;0;0;1
18442;"Vilniaus Šilo mokykla";"8 spec.";9277299634;Taip;2;0;0;2
18443;"Vilniaus Šilo mokykla";"8 spec.";2672192094;Ne;3;0;0;3
18444;"Vilniaus Šilo mokykla";"8 spec.";2672192094;Ne;3;0;0;3
18445;"Vilniaus Šilo mokykla";"8-10 lav.";2020417997;Ne;7;0;0;7
18446;"Vilniaus Šilo mokykla";"8-10 lav.";1298624014;Ne;1;0;0;1
18447;"Vilniaus Šilo mokykla";"8-10 lav.";8926954085;Ne;5;0;0;5
18448;"Vilniaus Šilo mokykla";"8-10 lav.";1742331213;Ne;1;0;0;1
18449;"Vilniaus Šilo mokykla";"8-10 lav.";7040253931;Ne;1;0;0;1
18450;"Vilniaus Šilo mokykla";"8-10 lav.";8276932013;Ne;14;0;0;14
18451;"Vilniaus Šilo mokykla";"7 lav.";3612746646;Ne;6;0;0;6
18452;"Vilniaus Šilo mokykla";"7 lav.";9054390753;Ne;3;0;0;3
18453;"Vilniaus Šilo mokykla";"7 lav.";29353956408;Ne;8;0;0;8
18454;"Vilniaus Šilo mokykla";"7 lav.";83007167743;Ne;1;0;0;1
18455;"Vilniaus Šilo mokykla";"7 lav.";2862598950;Ne;1;0;0;1
18456;"Vilniaus Šilo mokykla";"7 lav.";67989956617;Ne;1;20;0;21
18457;"Vilniaus Šilo mokykla";"7 lav.";49892720109;Ne;1;0;0;1
18458;"Vilniaus Šilo mokykla";"7-8 lav.";4081645294;Ne;8;0;0;8
18459;"Vilniaus Šilo mokykla";"7-8 lav.";1705610089;Ne;1;20;0;21
18460;"Vilniaus Šilo mokykla";"7-8 lav.";62142659591;Ne;1;0;0;1
18461;"Vilniaus Šilo mokykla";"7-8 lav.";8566222716;Ne;18;0;0;18
18462;"Vilniaus Šilo mokykla";"7-8 lav.";7056277395;Ne;1;20;0;21
18463;"Vilniaus Šilo mokykla";"7-8 lav.";74897451962;Ne;2;0;0;2
18464;"Vilniaus Šilo mokykla";"7-8 lav.";6700004229;Ne;1;0;0;1
18465;"Vilniaus Šilo mokykla";"7-8 lav.";50288610995;Ne;12;0;0;12
18466;"Vilniaus Šilo mokykla";"7-8 lav.";4416954354;Ne;10;0;0;10
18467;"Vilniaus Šilo mokykla";"6-9 spec.";4887033681;Ne;2;0;0;2
18468;"Vilniaus Šilo mokykla";"6-9 spec.";61123788986;Ne;1;20;0;21
18469;"Vilniaus Šilo mokykla";"6-9 spec.";2631958308;Ne;10;0;0;10
18470;"Vilniaus Šilo mokykla";"6-9 spec.";73335629450;Ne;1;0;0;1
18471;"Vilniaus Šilo mokykla";"6-9 spec.";6695507703;Ne;1;0;0;1
18472;"Vilniaus Šilo mokykla";"6-9 spec.";94126055953;Ne;2;0;0;2
18473;"Vilniaus Šilo mokykla";"5-10 lav.";6356218442;Ne;1;0;0;1
18474;"Vilniaus Šilo mokykla";"5-10 lav.";88721781220;Ne;1;0;0;1
18475;"Vilniaus Šilo mokykla";"5-10 lav.";4990112920;Ne;1;0;0;1
18476;"Vilniaus Šilo mokykla";"5-10 lav.";9057435844;Ne;1;0;0;1
18477;"Vilniaus Šilo mokykla";"5-10 lav.";7354905114;Ne;2;0;0;2
18478;"Vilniaus Šilo mokykla";"5-10 lav.";4890362155;Ne;1;0;0;1
18479;"Vilniaus Šilo mokykla";"5-10 lav.";2000234311;Ne;1;0;0;1
18480;"Vilniaus Šilo mokykla";"5-10 lav.";63508565206;Ne;1;0;0;1
18481;"Vilniaus Šilo mokykla";"5-6 spec. RU";3419495275;Ne;2;0;0;2
18482;"Vilniaus Šilo mokykla";"5-6 spec. RU";9789373884;Ne;1;20;0;21
18483;"Vilniaus Šilo mokykla";"5-6 spec. RU";1989565075;Ne;1;20;0;21
18484;"Vilniaus Šilo mokykla";"5-6 spec. RU";11529512484;Ne;1;0;0;1
18485;"Vilniaus Šilo mokykla";"5-6 spec. RU";13277011762;Ne;1;0;0;1
18486;"Vilniaus Šilo mokykla";"5-6 spec. RU";34463714051;Ne;1;0;0;1
18487;"Vilniaus Šilo mokykla";"5-6 lav.";7329254454;Ne;1;20;0;21
18488;"Vilniaus Šilo mokykla";"5-6 lav.";1535004699;Ne;17;0;0;17
18489;"Vilniaus Šilo mokykla";"5-6 lav.";3194974747;Ne;1;0;0;1
18490;"Vilniaus Šilo mokykla";"5-6 lav.";26052502707;Ne;3;0;0;3
18491;"Vilniaus Šilo mokykla";"5-6 lav.";74782962545;Ne;1;20;0;21
18492;"Vilniaus Šilo mokykla";"5-6 lav.";72751441075;Ne;7;0;0;7
18493;"Vilniaus Šilo mokykla";"5-6 lav.";87692349348;Ne;1;20;0;21
18494;"Vilniaus Šilo mokykla";"3-4 spec. LT";5835827997;Ne;1;20;0;21
18495;"Vilniaus Šilo mokykla";"3-4 spec. LT";17920063762;Ne;1;0;0;1
18496;"Vilniaus Šilo mokykla";"3-4 spec. LT";7418149721;Ne;8;0;0;8
18497;"Vilniaus Šilo mokykla";"3-4 spec. LT";7418149721;Ne;8;0;0;8
18498;"Vilniaus Šilo mokykla";"3-4 spec. LT";19739614989;Ne;1;0;0;1
18499;"Vilniaus Šilo mokykla";"3-4 spec. LT";3366848846;Ne;2;0;0;2
18500;"Vilniaus Šilo mokykla";"3-4 spec. LT";78634860827;Ne;1;0;0;1
18501;"Vilniaus Šilo mokykla";"3-4 spec. LT";67103811533;Ne;3;0;0;3
18502;"Vilniaus Šilo mokykla";"3-4 spec. LT";30738331224;Ne;1;0;0;1
18503;"Vilniaus Šilo mokykla";"1 spec. B";3237698420;Ne;1;0;0;1
18504;"Vilniaus Šilo mokykla";"1 spec. B";3055294324;Ne;2;0;0;2
18505;"Vilniaus Šilo mokykla";"1 spec. B";1739403100;Ne;0;21;0;21
18506;"Vilniaus Šilo mokykla";"1 spec. B";8500010303;Ne;0;21;0;21
18507;"Vilniaus Šilo mokykla";"2-4 spec. RU";4908579339;Ne;2;0;0;2
18508;"Vilniaus Šilo mokykla";"2-4 spec. RU";2401287472;Ne;21;0;0;21
18509;"Vilniaus Šilo mokykla";"2-4 spec. RU";8817950372;Ne;1;0;0;1
18510;"Vilniaus Šilo mokykla";"2-4 spec. RU";8817950372;Ne;1;0;0;1
18511;"Vilniaus Šilo mokykla";"2-4 spec. RU";70678189213;Ne;1;0;0;1
18512;"Vilniaus Šilo mokykla";"2-4 spec. RU";4078721064;Ne;2;0;0;2
18513;"Vilniaus Šilo mokykla";"2-4 spec. RU";4574965127;Ne;4;0;0;4
18514;"Vilniaus Šilo mokykla";"2 spec.";1153167430;Ne;6;0;0;6
18515;"Vilniaus Šilo mokykla";"2 spec.";4438939800;Ne;3;0;0;3
18516;"Vilniaus Šilo mokykla";"2 spec.";1971717759;Ne;5;0;0;5
18517;"Vilniaus Šilo mokykla";"2 spec.";2290889395;Ne;1;0;0;1
18518;"Vilniaus Šilo mokykla";"2 spec.";1180183091;Ne;0;21;0;21
18519;"Vilniaus Šilo mokykla";"2 spec.";8863021708;Ne;2;0;0;2
18520;"Vilniaus Šilo mokykla";"3-4 lav. ";3127870635;Ne;6;0;0;6
18521;"Vilniaus Šilo mokykla";"3-4 lav. ";1505697405;Ne;1;0;0;1
18522;"Vilniaus Šilo mokykla";"3-4 lav. ";1999375828;Ne;1;20;0;21
18523;"Vilniaus Šilo mokykla";"3-4 lav. ";3748420427;Ne;6;0;0;6
18524;"Vilniaus Šilo mokykla";"3-4 lav. ";2954393415;Ne;7;0;0;7
18525;"Vilniaus Šilo mokykla";"1 spec. A";5311183877;Taip;12;0;0;12
18526;"Vilniaus Šilo mokykla";"1 spec. A";1675384533;Ne;1;0;0;1
18527;"Vilniaus Šilo mokykla";"1 spec. A";2070454339;Ne;0;21;0;21
18528;"Vilniaus Šilo mokykla";"1 spec. A";8915901727;Ne;1;0;0;1
18529;"Vilniaus Šilo mokykla";"1 spec. A";7966574791;Ne;0;21;0;21
18530;"Vilniaus Šilo mokykla";"1 spec. A";2048595572;Ne;13;0;0;13
18531;"Vilniaus Šilo mokykla";"1 spec. A";30383556768;Ne;0;21;0;21
18532;"Vilniaus Šilo mokykla";"5-6 spec. ";90363704660;Ne;3;0;0;3
18533;"Vilniaus Šilo mokykla";"5-6 spec. ";3120638166;Ne;2;0;0;2
18534;"Vilniaus Šilo mokykla";"5-6 spec. ";1079077463;Ne;12;0;0;12
18535;"Vilniaus Šilo mokykla";"5-6 spec. ";2321953405;Ne;12;0;0;12
18536;"Vilniaus Šilo mokykla";"5-6 spec. ";2093680385;Ne;5;0;0;5
18537;"Vilniaus Šilo mokykla";"5-6 spec. ";3352991548;Ne;1;0;0;1
18538;"Vilniaus Šilo mokykla";"5-6 spec. ";1340301492;Taip;5;0;0;5
18539;"Vilniaus Šilo mokykla";"5-6 spec. ";987829287;Ne;1;0;0;1
18540;"Vilniaus Šilo mokykla";"5-6 spec. ";99943424821;Ne;2;0;0;2
18541;Malūnėlis;BITUTĖS;1001575740;Ne;0;0;4;4
18542;Malūnėlis;BITUTĖS;8618778205;Ne;0;4;0;4
18543;Malūnėlis;BITUTĖS;2545930114;Ne;2;0;0;2
18544;Malūnėlis;BITUTĖS;3329510128;Ne;8;0;0;8
18545;Malūnėlis;BITUTĖS;5402027714;Ne;0;4;0;4
18546;Malūnėlis;BITUTĖS;7144098762;Ne;11;0;0;11
18547;Malūnėlis;BITUTĖS;1146723570;Taip;2;1;0;3
18548;Malūnėlis;BITUTĖS;9891418762;Taip;8;4;0;12
18549;Malūnėlis;BITUTĖS;5959610426;Taip;4;0;0;4
18550;Malūnėlis;BITUTĖS;4367009696;Ne;0;9;0;9
18551;Malūnėlis;BITUTĖS;9936144392;Ne;0;0;2;2
18552;Malūnėlis;BITUTĖS;8643210289;Taip;6;1;0;7
18553;Malūnėlis;BITUTĖS;8440160819;Ne;4;0;0;4
18554;Malūnėlis;BITUTĖS;1528972517;Ne;0;12;0;12
18555;Malūnėlis;BITUTĖS;4202723476;Taip;0;1;0;1
18556;Malūnėlis;BITUTĖS;8007350745;Ne;4;0;0;4
18557;Malūnėlis;BITUTĖS;3402561453;Ne;3;8;0;11
18558;Malūnėlis;BITUTĖS;6805587761;Ne;14;0;0;14
18559;Malūnėlis;BITUTĖS;2495112045;Ne;9;0;2;11
18560;Malūnėlis;BITUTĖS;4802771311;Ne;6;0;0;6
18561;Malūnėlis;BITUTĖS;3935474148;Ne;0;2;0;2
18562;Malūnėlis;VOVERIUKAI;3293082023;Ne;10;0;0;10
18563;Malūnėlis;VOVERIUKAI;2029506037;Ne;3;1;0;4
18564;Malūnėlis;VOVERIUKAI;2246526281;Ne;0;6;0;6
18565;Malūnėlis;VOVERIUKAI;2192305527;Ne;14;0;0;14
18566;Malūnėlis;VOVERIUKAI;5061720786;Ne;8;6;2;16
18567;Malūnėlis;VOVERIUKAI;3898518306;Ne;0;21;0;21
18568;Malūnėlis;VOVERIUKAI;1770049356;Ne;4;5;0;9
18569;Malūnėlis;VOVERIUKAI;6081634102;Ne;8;2;0;10
18570;Malūnėlis;VOVERIUKAI;5540120728;Ne;0;19;0;19
18571;Malūnėlis;VOVERIUKAI;7556990784;Ne;0;5;1;6
18572;Malūnėlis;VOVERIUKAI;2525923211;Ne;10;0;0;10
18573;Malūnėlis;VOVERIUKAI;1574941416;Ne;0;1;0;1
18574;Malūnėlis;VOVERIUKAI;6928976717;Taip;0;0;3;3
18575;Malūnėlis;VOVERIUKAI;6531364407;Taip;3;2;0;5
18576;Malūnėlis;VOVERIUKAI;5727725132;Ne;0;2;0;2
18577;Malūnėlis;VOVERIUKAI;8277245773;Ne;9;0;0;9
18578;Malūnėlis;VOVERIUKAI;5686301875;Taip;6;1;0;7
18579;Malūnėlis;BORUŽĖLĖS;8551271848;Ne;0;1;4;5
18580;Malūnėlis;BORUŽĖLĖS;4787212056;Ne;3;3;0;6
18581;Malūnėlis;BORUŽĖLĖS;9185138453;Ne;18;1;0;19
18582;Malūnėlis;BORUŽĖLĖS;7350160970;Ne;6;5;0;11
18583;Malūnėlis;BORUŽĖLĖS;5722497620;Ne;5;5;0;10
18584;Malūnėlis;BORUŽĖLĖS;3364355098;Ne;6;0;0;6
18585;Malūnėlis;BORUŽĖLĖS;1523505295;Ne;0;0;2;2
18586;Malūnėlis;BORUŽĖLĖS;7756102926;Ne;0;0;2;2
18587;Malūnėlis;BORUŽĖLĖS;4164843364;Ne;2;0;1;3
18588;Malūnėlis;BORUŽĖLĖS;3504339452;Ne;2;2;0;4
18589;Malūnėlis;BORUŽĖLĖS;5197527972;Ne;6;0;0;6
18590;Malūnėlis;BORUŽĖLĖS;4288943715;Ne;0;0;4;4
18591;Malūnėlis;Skruzdėliukų;9798968369;Ne;10;0;0;10
18592;Malūnėlis;Skruzdėliukų;4859886340;Ne;15;0;2;17
18593;Malūnėlis;Skruzdėliukų;1213476648;Ne;4;0;1;5
18594;Malūnėlis;Skruzdėliukų;9300944734;Ne;8;2;0;10
18595;Malūnėlis;Skruzdėliukų;5877882690;Ne;0;7;0;7
18596;Malūnėlis;Skruzdėliukų;9153589128;Ne;17;0;0;17
18597;Malūnėlis;Skruzdėliukų;5474437579;Ne;0;3;1;4
18598;Malūnėlis;Skruzdėliukų;1549241453;Ne;15;0;0;15
18599;Malūnėlis;Skruzdėliukų;5478561852;Taip;4;0;0;4
18600;Malūnėlis;Skruzdėliukų;9207327884;Ne;11;3;0;14
18601;Malūnėlis;Skruzdėliukų;6609446450;Ne;2;0;0;2
18602;Malūnėlis;Skruzdėliukų;5687585794;Ne;8;0;0;8
18603;Malūnėlis;Skruzdėliukų;8076487157;Ne;1;0;0;1
18604;Malūnėlis;Skruzdėliukų;8751365673;Ne;5;0;1;6
18605;Malūnėlis;Skruzdėliukų;4307232411;Taip;5;2;0;7
18606;Malūnėlis;Skruzdėliukų;6575258889;Taip;7;5;0;12
18607;Malūnėlis;Skruzdėliukų;1003043129;Taip;15;0;0;15
18608;Malūnėlis;Skruzdėliukų;7983537913;Taip;6;1;0;7
18609;Malūnėlis;Skruzdėliukų;9894452403;Ne;1;10;0;11
18610;Malūnėlis;Skruzdėliukų;9342720464;Ne;0;11;0;11
18611;Malūnėlis;Skruzdėliukų;5232728972;Ne;8;0;0;8
18612;Malūnėlis;Skruzdėliukų;2574604828;Ne;5;3;0;8
18613;Malūnėlis;Skruzdėliukų;5909022614;Taip;8;0;1;9
18614;Malūnėlis;Žirniukų;3791873303;Ne;0;5;0;5
18615;Malūnėlis;Žirniukų;3031849277;Taip;0;0;2;2
18616;Malūnėlis;Žirniukų;6747286787;Ne;0;1;6;7
18617;Malūnėlis;Žirniukų;4539998453;Ne;0;0;6;6
18618;Malūnėlis;Žirniukų;6943968536;Ne;0;4;0;4
18619;Malūnėlis;Žirniukų;4841028952;Ne;0;0;17;17
18620;Malūnėlis;Žirniukų;7097858329;Ne;0;1;4;5
18621;Malūnėlis;Žirniukų;5893575540;Ne;0;0;7;7
18622;Malūnėlis;Žirniukų;1398391534;Ne;0;0;3;3
18623;Malūnėlis;Žirniukų;2961972215;Ne;0;0;8;8
18624;Malūnėlis;Žirniukų;3315571256;Ne;0;0;2;2
18625;Malūnėlis;Žirniukų;3315571256;Ne;0;0;2;2
18626;Malūnėlis;Žirniukų;3315571256;Ne;0;0;2;2
18627;Malūnėlis;Žirniukų;9941335615;Ne;0;0;6;6
18628;Malūnėlis;Žirniukų;3464224841;Ne;0;5;0;5
18629;Malūnėlis;Žirniukų;6047042736;Ne;0;0;9;9
18630;Malūnėlis;Žirniukų;4875859413;Ne;0;0;9;9
18631;Malūnėlis;Žirniukų;6647872886;Taip;0;0;2;2
18632;Malūnėlis;Žirniukų;9559372808;Taip;0;5;1;6
18633;Malūnėlis;Žirniukų;1407908511;Taip;0;0;1;1
18634;Malūnėlis;Žirniukų;7740957549;Ne;0;0;7;7
18635;"Dainorėliai (Goštauto g. 4)";PUMPURĖLIAI;6132543858;Ne;2;0;0;2
18636;"Dainorėliai (Goštauto g. 4)";PUMPURĖLIAI;4560328911;Ne;9;2;4;15
18637;"Dainorėliai (Goštauto g. 4)";PUMPURĖLIAI;4435310580;Ne;11;1;9;21
18638;"Dainorėliai (Goštauto g. 4)";PUMPURĖLIAI;7197089520;Ne;5;2;1;8
18639;"Dainorėliai (Goštauto g. 4)";PUMPURĖLIAI;5534783929;Ne;2;0;0;2
18640;"Dainorėliai (Goštauto g. 4)";PUMPURĖLIAI;4848146301;Ne;6;0;0;6
18641;"Dainorėliai (Goštauto g. 4)";PUMPURĖLIAI;1030872812;Ne;0;3;0;3
18642;"Dainorėliai (Goštauto g. 4)";DEBESĖLIŲ;6513417505;Ne;8;1;0;9
18643;"Dainorėliai (Goštauto g. 4)";DEBESĖLIŲ;4286864865;Ne;0;0;2;2
18644;"Dainorėliai (Goštauto g. 4)";DEBESĖLIŲ;1554081754;Ne;0;0;1;1
18645;"Dainorėliai (Goštauto g. 4)";DEBESĖLIŲ;4033317616;Ne;9;1;0;10
18646;"Dainorėliai (Goštauto g. 4)";DEBESĖLIŲ;6284140548;Taip;0;4;3;7
18647;"Dainorėliai (Goštauto g. 4)";DEBESĖLIŲ;6362265057;Ne;3;0;0;3
18648;"Krivūlė (Vokiečių g. 1)";PABIRUČIAI;9011102232;Ne;0;0;2;2
18649;"Krivūlė (Vokiečių g. 1)";PABIRUČIAI;1944288576;Ne;0;0;2;2
18650;"Krivūlė (Vokiečių g. 1)";PABIRUČIAI;3696403149;Taip;5;0;1;6
18651;"Krivūlė (Vokiečių g. 1)";PABIRUČIAI;5721252419;Ne;0;21;0;21
18652;"Krivūlė (Vokiečių g. 1)";PABIRUČIAI;4600688626;Ne;0;0;1;1
18653;"Krivūlė (Vokiečių g. 1)";PABIRUČIAI;4608957977;Ne;0;0;1;1
18654;"Krivūlė (Vokiečių g. 1)";PABIRUČIAI;7308968772;Ne;11;0;0;11
18655;"Krivūlė (Vokiečių g. 1)";PABIRUČIAI;4884789671;Ne;0;8;1;9
18656;"Krivūlė (Vokiečių g. 1)";PABIRUČIAI;8678565710;Taip;6;0;3;9
18657;"Krivūlė (Vokiečių g. 1)";PABIRUČIAI;3976974038;Ne;0;0;1;1
18658;"Krivūlė (Vokiečių g. 1)";PABIRUČIAI;2259139771;Ne;3;0;0;3
18659;"Krivūlė (Vokiečių g. 1)";PABIRUČIAI;3138555448;Ne;11;0;3;14
18660;"Krivūlė (Vokiečių g. 1)";PABIRUČIAI;3227555647;Ne;0;1;4;5
18661;"Krivūlė (Vokiečių g. 1)";PABIRUČIAI;4261770381;Ne;5;0;5;10
18662;"Krivūlė (Vokiečių g. 1)";PABIRUČIAI;6632875947;Ne;0;6;0;6
18663;"Krivūlė (Vokiečių g. 1)";PABIRUČIAI;7556723960;Ne;0;0;1;1
18664;"Krivūlė (Vokiečių g. 1)";PABIRUČIAI;6422534805;Ne;2;0;0;2
18665;"Krivūlė (Vokiečių g. 1)";PABIRUČIAI;3209201717;Ne;6;0;0;6
18666;"Krivūlė (Vokiečių g. 1)";SMALSUČIAI;5304221329;Ne;0;0;3;3
18667;"Krivūlė (Vokiečių g. 1)";SMALSUČIAI;7997564406;Ne;0;4;0;4
18668;"Krivūlė (Vokiečių g. 1)";SMALSUČIAI;4491462086;Taip;2;0;1;3
18669;"Krivūlė (Vokiečių g. 1)";SMALSUČIAI;4773564048;Taip;0;0;3;3
18670;"Krivūlė (Vokiečių g. 1)";SMALSUČIAI;3324090723;Ne;4;0;0;4
18671;"Krivūlė (Vokiečių g. 1)";SMALSUČIAI;4094383258;Ne;3;0;0;3
18672;"Krivūlė (Vokiečių g. 1)";SMALSUČIAI;8042469720;Ne;0;3;0;3
18673;"Krivūlė (Vokiečių g. 1)";SMALSUČIAI;4845066055;Ne;0;0;15;15
18674;"Krivūlė (Vokiečių g. 1)";SMALSUČIAI;9328365491;Ne;0;0;2;2
18675;"Krivūlė (Vokiečių g. 1)";SMALSUČIAI;7528273082;Ne;5;0;0;5
18676;"Krivūlė (Vokiečių g. 1)";SMALSUČIAI;6521798502;Ne;0;0;2;2
18677;"Krivūlė (Vokiečių g. 1)";GUDRUČIAI;8520470321;Ne;0;0;4;4
18678;"Krivūlė (Vokiečių g. 1)";GUDRUČIAI;5753204752;Ne;0;0;2;2
18679;"Krivūlė (Vokiečių g. 1)";GUDRUČIAI;2659604299;Ne;0;0;2;2
18680;"Krivūlė (Vokiečių g. 1)";GUDRUČIAI;2536472220;Ne;0;6;0;6
18681;"Krivūlė (Vokiečių g. 1)";GUDRUČIAI;7436569684;Ne;11;0;0;11
18682;"Krivūlė (Vokiečių g. 1)";GUDRUČIAI;7727246187;Ne;0;1;0;1
18683;"Krivūlė (Vokiečių g. 1)";GUDRUČIAI;6072261879;Ne;5;0;1;6
18684;"Krivūlė (Vokiečių g. 1)";GUDRUČIAI;7904390075;Ne;0;6;1;7
18685;"Krivūlė (Vokiečių g. 1)";GUDRUČIAI;6931566125;Ne;0;0;1;1
18686;"Krivūlė (Vokiečių g. 1)";GUDRUČIAI;5149419581;Ne;0;0;4;4
18687;"Krivūlė (Vokiečių g. 1)";GUDRUČIAI;7789605738;Ne;0;0;2;2
18688;"Krivūlė (Vokiečių g. 1)";GUDRUČIAI;9693693101;Ne;7;0;1;8
18689;"Krivūlė (Vokiečių g. 1)";GUDRUČIAI;5462491857;Ne;0;1;0;1
18690;"Krivūlė (Vokiečių g. 1)";GUDRUČIAI;8871794542;Ne;2;0;0;2
18691;"Pumpurėlis (Trinapolio g. 11)";GUDRUČIAI;9353403057;Ne;0;0;1;1
18692;"Pumpurėlis (Trinapolio g. 11)";GUDRUČIAI;9353403057;Ne;0;0;1;1
18693;"Pumpurėlis (Trinapolio g. 11)";GUDRUČIAI;5187890514;Ne;0;0;4;4
18694;"Pumpurėlis (Trinapolio g. 11)";GUDRUČIAI;3387386473;Ne;0;4;0;4
18695;"Pumpurėlis (Trinapolio g. 11)";GUDRUČIAI;7177681927;Taip;10;0;1;11
18696;"Pumpurėlis (Trinapolio g. 11)";GUDRUČIAI;2130008026;Ne;0;0;10;10
18697;"Pumpurėlis (Trinapolio g. 11)";GUDRUČIAI;8475215020;Ne;0;0;1;1
18698;"Pumpurėlis (Trinapolio g. 11)";GUDRUČIAI;3333547914;Taip;13;0;2;15
18699;"Pumpurėlis (Trinapolio g. 11)";GUDRUČIAI;9550967420;Ne;5;0;6;11
18700;"Pumpurėlis (Trinapolio g. 11)";GUDRUČIAI;1750311606;Ne;0;0;4;4
18701;"Pumpurėlis (Trinapolio g. 11)";GUDRUČIAI;1682281017;Ne;0;0;2;2
18702;"Pumpurėlis (Trinapolio g. 11)";GUDRUČIAI;9154835447;Ne;0;0;3;3
18703;"Pumpurėlis (Trinapolio g. 11)";GUDRUČIAI;3546444707;Ne;3;8;0;11
18704;"Pumpurėlis (Trinapolio g. 11)";GUDRUČIAI;2071687578;Ne;4;0;2;6
18705;"Pumpurėlis (Trinapolio g. 11)";GUDRUČIAI;8090926450;Ne;0;0;11;11
18706;"Pumpurėlis (Trinapolio g. 11)";GUDRUČIAI;6459621192;Ne;0;0;6;6
18707;"Pumpurėlis (Trinapolio g. 11)";GUDRUČIAI;6766514486;Taip;0;0;1;1
18708;"Pumpurėlis (Trinapolio g. 11)";GUDRUČIAI;4337389152;Taip;3;0;1;4
18709;"Pumpurėlis (Trinapolio g. 11)";PABIRUČIAI;9824315755;Ne;15;0;0;15
18710;"Pumpurėlis (Trinapolio g. 11)";PABIRUČIAI;4565317498;Ne;0;0;1;1
18711;"Pumpurėlis (Trinapolio g. 11)";PABIRUČIAI;7910361194;Ne;7;0;3;10
18712;"Pumpurėlis (Trinapolio g. 11)";PABIRUČIAI;5249717804;Ne;0;0;1;1
18713;"Pumpurėlis (Trinapolio g. 11)";PABIRUČIAI;5403012236;Ne;2;0;0;2
18714;"Pumpurėlis (Trinapolio g. 11)";PABIRUČIAI;4955734206;Ne;11;0;0;11
18715;"Pumpurėlis (Trinapolio g. 11)";PABIRUČIAI;8704865319;Ne;6;3;0;9
18716;"Pumpurėlis (Trinapolio g. 11)";PABIRUČIAI;8207951541;Ne;6;0;1;7
18717;"Pumpurėlis (Trinapolio g. 11)";PABIRUČIAI;4696006714;Taip;6;0;0;6
18718;"Pumpurėlis (Trinapolio g. 11)";PABIRUČIAI;2187090934;Ne;0;0;1;1
18719;"Pumpurėlis (Trinapolio g. 11)";PABIRUČIAI;1222204689;Taip;21;0;0;21
18720;"Pumpurėlis (Trinapolio g. 11)";PABIRUČIAI;6920353753;Taip;0;2;1;3
18721;"Pumpurėlis (Trinapolio g. 11)";PABIRUČIAI;6920353753;Taip;0;2;1;3
18722;"Pumpurėlis (Trinapolio g. 11)";PABIRUČIAI;3841134563;Ne;0;15;0;15
18723;"Pumpurėlis (Trinapolio g. 11)";PABIRUČIAI;3841134563;Ne;0;15;0;15
18724;"Pumpurėlis (Trinapolio g. 11)";PABIRUČIAI;3841134563;Ne;0;15;0;15
18725;"Pumpurėlis (Trinapolio g. 11)";PABIRUČIAI;6732130591;Ne;6;0;0;6
18726;"Pumpurėlis (Trinapolio g. 11)";PABIRUČIAI;7145050820;Ne;0;0;2;2
18727;"Pumpurėlis (Trinapolio g. 11)";PABIRUČIAI;3464806589;Ne;0;0;4;4
18728;"Pumpurėlis (Trinapolio g. 11)";PABIRUČIAI;5703275497;Ne;3;0;0;3
18729;"Gilužis (Įsruties g. 30)";AITVARIUKŲ;3612834040;Taip;1;0;1;2
18730;"Gilužis (Įsruties g. 30)";AITVARIUKŲ;6279641042;Ne;1;0;0;1
18731;"Gilužis (Įsruties g. 30)";AITVARIUKŲ;6430615720;Ne;10;0;0;10
18732;"Gilužis (Įsruties g. 30)";AITVARIUKŲ;4351997862;Ne;7;0;0;7
18733;"Gilužis (Įsruties g. 30)";AITVARIUKŲ;6020457766;Ne;0;2;3;5
18734;"Gilužis (Įsruties g. 30)";AITVARIUKŲ;8950433662;Ne;4;0;0;4
18735;"Gilužis (Įsruties g. 30)";AITVARIUKŲ;1766021430;Ne;5;0;0;5
18736;"Gilužis (Įsruties g. 30)";AITVARIUKŲ;2401999477;Ne;5;0;0;5
18737;"Gilužis (Įsruties g. 30)";AITVARIUKŲ;8268273217;Ne;4;0;0;4
18738;"Gilužis (Įsruties g. 30)";AITVARIUKŲ;4731369089;Ne;13;0;0;13
18739;"Gilužis (Įsruties g. 30)";AITVARIUKŲ;2614683353;Ne;11;0;0;11
18740;"Gilužis (Įsruties g. 30)";AITVARIUKŲ;2657805562;Ne;12;0;0;12
18741;"Gilužis (Įsruties g. 30)";AITVARIUKŲ;6713383000;Ne;4;0;0;4
18742;"Gilužis (Įsruties g. 30)";SPINDULIUKŲ;8951766269;Taip;0;0;4;4
18743;"Gilužis (Įsruties g. 30)";SPINDULIUKŲ;8712363813;Ne;6;0;0;6
18744;"Gilužis (Įsruties g. 30)";SPINDULIUKŲ;8499650174;Ne;0;0;2;2
18745;"Gilužis (Įsruties g. 30)";SPINDULIUKŲ;4939683067;Ne;6;0;0;6
18746;"Gilužis (Įsruties g. 30)";SPINDULIUKŲ;4483309790;Ne;4;0;0;4
18747;"Gilužis (Įsruties g. 30)";SPINDULIUKŲ;6582408024;Ne;6;0;1;7
18748;"Gilužis (Įsruties g. 30)";SPINDULIUKŲ;8238801880;Ne;6;0;0;6
18749;"Gilužis (Įsruties g. 30)";SPINDULIUKŲ;9352644751;Ne;15;0;0;15
18750;"Gilužis (Įsruties g. 30)";SPINDULIUKŲ;9689776829;Ne;0;0;2;2
18751;"Gilužis (Įsruties g. 30)";SPINDULIUKŲ;9807489364;Ne;0;0;1;1
18752;"Gilužis (Įsruties g. 30)";ŽIRNIUKŲ;1660797528;Ne;5;0;0;5
18753;"Gilužis (Įsruties g. 30)";ŽIRNIUKŲ;1584356386;Ne;12;0;0;12
18754;"Gilužis (Įsruties g. 30)";ŽIRNIUKŲ;8845494720;Ne;6;0;0;6
18755;"Gilužis (Įsruties g. 30)";ŽIRNIUKŲ;3355341868;Ne;3;0;1;4
18756;"Gilužis (Įsruties g. 30)";ŽIRNIUKŲ;1710906417;Ne;12;0;0;12
18757;"Gilužis (Įsruties g. 30)";ŽIRNIUKŲ;2831924292;Ne;7;1;0;8
18758;"Gilužis (Įsruties g. 30)";ŽIRNIUKŲ;3250662431;Ne;4;1;0;5
18759;"Gilužis (Įsruties g. 30)";ŽIRNIUKŲ;8078194153;Ne;0;1;0;1
18760;"Gilužis (Įsruties g. 30)";ŽIRNIUKŲ;3224917490;Ne;3;0;1;4
18761;"Gilužis (Įsruties g. 30)";ŽIRNIUKŲ;3272561030;Ne;6;0;0;6
18762;"Gilužis (Įsruties g. 30)";ŽIRNIUKŲ;7620828905;Ne;5;5;0;10
18763;"Gilužis (Įsruties g. 30)";ŽIRNIUKŲ;1173529743;Ne;2;5;0;7
18764;"Pilaitukas (Įsruties g. 27)";ŠNEKUČIAI;1859101624;Ne;1;1;4;6
18765;"Pilaitukas (Įsruties g. 27)";ŠNEKUČIAI;7224121082;Ne;5;6;0;11
18766;"Pilaitukas (Įsruties g. 27)";ŠNEKUČIAI;9115588495;Taip;5;5;0;10
18767;"Pilaitukas (Įsruties g. 27)";ŠNEKUČIAI;1082342063;Ne;4;0;0;4
18768;"Pilaitukas (Įsruties g. 27)";ŠNEKUČIAI;8801482035;Ne;17;0;0;17
18769;"Pilaitukas (Įsruties g. 27)";ŠNEKUČIAI;9622989196;Ne;11;0;0;11
18770;"Pilaitukas (Įsruties g. 27)";ŠNEKUČIAI;1356473379;Ne;0;21;0;21
18771;"Pilaitukas (Įsruties g. 27)";ŠNEKUČIAI;2883122532;Ne;0;1;3;4
18772;"Pilaitukas (Įsruties g. 27)";ŠNEKUČIAI;2883122532;Ne;0;1;3;4
18773;"Pilaitukas (Įsruties g. 27)";ŠNEKUČIAI;2883122532;Ne;0;1;3;4
18774;"Pilaitukas (Įsruties g. 27)";ŠNEKUČIAI;6092611227;Taip;5;0;0;5
18775;"Pilaitukas (Įsruties g. 27)";ŠNEKUČIAI;4567479900;Ne;0;6;0;6
18776;"Pilaitukas (Įsruties g. 27)";ŠNEKUČIAI;7933780448;Ne;1;0;0;1
18777;"Pilaitukas (Įsruties g. 27)";SMALSUČIAI;1815311248;Ne;1;0;0;1
18778;"Pilaitukas (Įsruties g. 27)";SMALSUČIAI;1414751236;Ne;3;0;0;3
18779;"Pilaitukas (Įsruties g. 27)";SMALSUČIAI;3215689222;Taip;1;0;0;1
18780;"Pilaitukas (Įsruties g. 27)";SMALSUČIAI;8755603496;Ne;5;0;0;5
18781;"Pilaitukas (Įsruties g. 27)";SMALSUČIAI;1974429718;Ne;16;0;0;16
18782;"Pilaitukas (Įsruties g. 27)";SMALSUČIAI;4544849086;Ne;7;0;0;7
18783;"Pilaitukas (Įsruties g. 27)";SMALSUČIAI;6934677745;Ne;3;0;0;3
18784;"Pilaitukas (Įsruties g. 27)";SMALSUČIAI;6496708020;Taip;2;0;0;2
18785;"Pilaitukas (Įsruties g. 27)";SMALSUČIAI;4608105047;Ne;14;0;0;14
18786;"Pilaitukas (Įsruties g. 27)";SMALSUČIAI;8698639192;Ne;2;1;0;3
18787;"Pilaitukas (Įsruties g. 27)";SMALSUČIAI;3273127718;Ne;9;0;0;9
18788;"Pilaitukas (Įsruties g. 27)";SMALSUČIAI;3501783231;Ne;4;0;0;4
18789;"Pilaitukas (Įsruties g. 27)";SMALSUČIAI;4898803794;Ne;7;0;0;7
18790;"Pilaitukas (Įsruties g. 27)";SMALSUČIAI;3544734838;Taip;2;0;0;2
18791;"Pilaitukas (Įsruties g. 27)";SMALSUČIAI;7034013577;Ne;4;0;0;4
18792;"Pilaitukas (Įsruties g. 27)";SMALSUČIAI;1793393776;Taip;11;1;0;12
18793;"Pilaitukas (Įsruties g. 27)";SMALSUČIAI;2210253038;Taip;8;0;0;8
18794;"Pilaitukas (Įsruties g. 27)";SMALSUČIAI;5490465905;Ne;0;6;0;6
18795;"Pilaitukas (Įsruties g. 27)";" GUDRUČIAI";3068325053;Ne;7;0;0;7
18796;"Pilaitukas (Įsruties g. 27)";" GUDRUČIAI";1571691020;Ne;7;0;0;7
18797;"Pilaitukas (Įsruties g. 27)";" GUDRUČIAI";9186679454;Ne;0;6;1;7
18798;"Pilaitukas (Įsruties g. 27)";" GUDRUČIAI";3621245783;Ne;0;0;2;2
18799;"Pilaitukas (Įsruties g. 27)";" GUDRUČIAI";3927118900;Ne;0;0;2;2
18800;"Pilaitukas (Įsruties g. 27)";" GUDRUČIAI";5464065587;Ne;5;2;0;7
18801;"Pilaitukas (Įsruties g. 27)";" GUDRUČIAI";6844500395;Ne;4;0;0;4
18802;"Pilaitukas (Įsruties g. 27)";" GUDRUČIAI";4810825253;Ne;1;1;0;2
18803;"Pilaitukas (Įsruties g. 27)";" GUDRUČIAI";3395656390;Ne;9;0;0;9
18804;"Pilaitukas (Įsruties g. 27)";" GUDRUČIAI";9774222130;Ne;3;9;0;12
18805;"Pilaitukas (Įsruties g. 27)";" GUDRUČIAI";5407354218;Ne;5;0;1;6
18806;"Pilaitukas (Įsruties g. 27)";" GUDRUČIAI";5326258755;Ne;0;12;7;19
